Link KawalPemilu,Nama Kelurahan,Nomor TPS,Suara 01,Suara 02,Suara Sah
https://kawalpemilu.org#53244,"BALER BALE AGUNG, NEGARA, JEMBRANA, BALI",1,190,42,232
https://kawalpemilu.org#53244,"BALER BALE AGUNG, NEGARA, JEMBRANA, BALI",2,187,30,217
https://kawalpemilu.org#53244,"BALER BALE AGUNG, NEGARA, JEMBRANA, BALI",3,179,48,227
https://kawalpemilu.org#53244,"BALER BALE AGUNG, NEGARA, JEMBRANA, BALI",4,171,31,202
https://kawalpemilu.org#53244,"BALER BALE AGUNG, NEGARA, JEMBRANA, BALI",5,177,29,206
https://kawalpemilu.org#53244,"BALER BALE AGUNG, NEGARA, JEMBRANA, BALI",6,177,39,216
https://kawalpemilu.org#53244,"BALER BALE AGUNG, NEGARA, JEMBRANA, BALI",7,209,20,229
https://kawalpemilu.org#53244,"BALER BALE AGUNG, NEGARA, JEMBRANA, BALI",8,229,26,255
https://kawalpemilu.org#53244,"BALER BALE AGUNG, NEGARA, JEMBRANA, BALI",9,188,33,221
https://kawalpemilu.org#53244,"BALER BALE AGUNG, NEGARA, JEMBRANA, BALI",10,219,12,231
https://kawalpemilu.org#53244,"BALER BALE AGUNG, NEGARA, JEMBRANA, BALI",11,216,13,229
https://kawalpemilu.org#53244,"BALER BALE AGUNG, NEGARA, JEMBRANA, BALI",12,174,32,206
https://kawalpemilu.org#53244,"BALER BALE AGUNG, NEGARA, JEMBRANA, BALI",13,196,32,228
https://kawalpemilu.org#53244,"BALER BALE AGUNG, NEGARA, JEMBRANA, BALI",14,173,21,194
https://kawalpemilu.org#53244,"BALER BALE AGUNG, NEGARA, JEMBRANA, BALI",15,190,45,235
https://kawalpemilu.org#53244,"BALER BALE AGUNG, NEGARA, JEMBRANA, BALI",16,207,25,232
https://kawalpemilu.org#53244,"BALER BALE AGUNG, NEGARA, JEMBRANA, BALI",17,180,33,213
https://kawalpemilu.org#53244,"BALER BALE AGUNG, NEGARA, JEMBRANA, BALI",18,220,6,226
https://kawalpemilu.org#53244,"BALER BALE AGUNG, NEGARA, JEMBRANA, BALI",19,206,18,224
https://kawalpemilu.org#53244,"BALER BALE AGUNG, NEGARA, JEMBRANA, BALI",20,156,62,218
https://kawalpemilu.org#53244,"BALER BALE AGUNG, NEGARA, JEMBRANA, BALI",21,124,64,188
https://kawalpemilu.org#53244,"BALER BALE AGUNG, NEGARA, JEMBRANA, BALI",22,128,58,186
https://kawalpemilu.org#53244,"BALER BALE AGUNG, NEGARA, JEMBRANA, BALI",23,155,59,214
https://kawalpemilu.org#53244,"BALER BALE AGUNG, NEGARA, JEMBRANA, BALI",24,137,53,190
https://kawalpemilu.org#53244,"BALER BALE AGUNG, NEGARA, JEMBRANA, BALI",25,139,48,187
https://kawalpemilu.org#53244,"BALER BALE AGUNG, NEGARA, JEMBRANA, BALI",26,199,14,213
https://kawalpemilu.org#53244,"BALER BALE AGUNG, NEGARA, JEMBRANA, BALI",27,206,12,218
https://kawalpemilu.org#53244,"BALER BALE AGUNG, NEGARA, JEMBRANA, BALI",28,198,12,210
https://kawalpemilu.org#53244,"BALER BALE AGUNG, NEGARA, JEMBRANA, BALI",29,221,24,245
https://kawalpemilu.org#53244,"BALER BALE AGUNG, NEGARA, JEMBRANA, BALI",30,197,28,225
https://kawalpemilu.org#53244,"BALER BALE AGUNG, NEGARA, JEMBRANA, BALI",31,208,24,232
https://kawalpemilu.org#53244,"BALER BALE AGUNG, NEGARA, JEMBRANA, BALI",32,76,38,114
https://kawalpemilu.org#53245,"BANJAR TENGAH, NEGARA, JEMBRANA, BALI",1,219,13,232
https://kawalpemilu.org#53245,"BANJAR TENGAH, NEGARA, JEMBRANA, BALI",2,185,26,211
https://kawalpemilu.org#53245,"BANJAR TENGAH, NEGARA, JEMBRANA, BALI",3,210,16,226
https://kawalpemilu.org#53245,"BANJAR TENGAH, NEGARA, JEMBRANA, BALI",4,230,24,254
https://kawalpemilu.org#53245,"BANJAR TENGAH, NEGARA, JEMBRANA, BALI",5,234,16,250
https://kawalpemilu.org#53245,"BANJAR TENGAH, NEGARA, JEMBRANA, BALI",6,197,18,215
https://kawalpemilu.org#53245,"BANJAR TENGAH, NEGARA, JEMBRANA, BALI",7,189,35,224
https://kawalpemilu.org#53245,"BANJAR TENGAH, NEGARA, JEMBRANA, BALI",8,190,22,212
https://kawalpemilu.org#53245,"BANJAR TENGAH, NEGARA, JEMBRANA, BALI",9,194,22,216
https://kawalpemilu.org#53245,"BANJAR TENGAH, NEGARA, JEMBRANA, BALI",10,154,56,210
https://kawalpemilu.org#53245,"BANJAR TENGAH, NEGARA, JEMBRANA, BALI",11,228,45,273
https://kawalpemilu.org#53245,"BANJAR TENGAH, NEGARA, JEMBRANA, BALI",12,102,114,216
https://kawalpemilu.org#53246,"LELATENG, NEGARA, JEMBRANA, BALI",1,132,25,157
https://kawalpemilu.org#53246,"LELATENG, NEGARA, JEMBRANA, BALI",2,226,5,231
https://kawalpemilu.org#53246,"LELATENG, NEGARA, JEMBRANA, BALI",4,199,16,215
https://kawalpemilu.org#53246,"LELATENG, NEGARA, JEMBRANA, BALI",5,217,11,228
https://kawalpemilu.org#53246,"LELATENG, NEGARA, JEMBRANA, BALI",6,208,42,250
https://kawalpemilu.org#53246,"LELATENG, NEGARA, JEMBRANA, BALI",7,212,36,248
https://kawalpemilu.org#53246,"LELATENG, NEGARA, JEMBRANA, BALI",8,184,39,223
https://kawalpemilu.org#53246,"LELATENG, NEGARA, JEMBRANA, BALI",9,207,36,243
https://kawalpemilu.org#53246,"LELATENG, NEGARA, JEMBRANA, BALI",10,214,20,234
https://kawalpemilu.org#53246,"LELATENG, NEGARA, JEMBRANA, BALI",11,111,111,222
https://kawalpemilu.org#53246,"LELATENG, NEGARA, JEMBRANA, BALI",12,116,101,217
https://kawalpemilu.org#53246,"LELATENG, NEGARA, JEMBRANA, BALI",13,165,49,214
https://kawalpemilu.org#53246,"LELATENG, NEGARA, JEMBRANA, BALI",14,199,44,243
https://kawalpemilu.org#53246,"LELATENG, NEGARA, JEMBRANA, BALI",15,197,35,232
https://kawalpemilu.org#53246,"LELATENG, NEGARA, JEMBRANA, BALI",16,109,92,192
https://kawalpemilu.org#53246,"LELATENG, NEGARA, JEMBRANA, BALI",17,110,88,198
https://kawalpemilu.org#53246,"LELATENG, NEGARA, JEMBRANA, BALI",19,132,25,157
https://kawalpemilu.org#53246,"LELATENG, NEGARA, JEMBRANA, BALI",20,122,46,168
https://kawalpemilu.org#53246,"LELATENG, NEGARA, JEMBRANA, BALI",21,138,48,186
https://kawalpemilu.org#53246,"LELATENG, NEGARA, JEMBRANA, BALI",23,164,48,212
https://kawalpemilu.org#53246,"LELATENG, NEGARA, JEMBRANA, BALI",24,172,62,234
https://kawalpemilu.org#53246,"LELATENG, NEGARA, JEMBRANA, BALI",25,171,37,208
https://kawalpemilu.org#53246,"LELATENG, NEGARA, JEMBRANA, BALI",26,155,56,211
https://kawalpemilu.org#53246,"LELATENG, NEGARA, JEMBRANA, BALI",27,152,51,203
https://kawalpemilu.org#53246,"LELATENG, NEGARA, JEMBRANA, BALI",28,90,44,134
https://kawalpemilu.org#53247,"LOLOAN BARAT, NEGARA, JEMBRANA, BALI",1,94,144,238
https://kawalpemilu.org#53247,"LOLOAN BARAT, NEGARA, JEMBRANA, BALI",2,97,146,243
https://kawalpemilu.org#53247,"LOLOAN BARAT, NEGARA, JEMBRANA, BALI",3,75,162,237
https://kawalpemilu.org#53247,"LOLOAN BARAT, NEGARA, JEMBRANA, BALI",4,74,147,221
https://kawalpemilu.org#53247,"LOLOAN BARAT, NEGARA, JEMBRANA, BALI",5,58,158,216
https://kawalpemilu.org#53247,"LOLOAN BARAT, NEGARA, JEMBRANA, BALI",6,57,156,213
https://kawalpemilu.org#53247,"LOLOAN BARAT, NEGARA, JEMBRANA, BALI",7,62,143,205
https://kawalpemilu.org#53247,"LOLOAN BARAT, NEGARA, JEMBRANA, BALI",8,115,118,233
https://kawalpemilu.org#53247,"LOLOAN BARAT, NEGARA, JEMBRANA, BALI",9,69,149,218
https://kawalpemilu.org#53247,"LOLOAN BARAT, NEGARA, JEMBRANA, BALI",10,84,161,245
https://kawalpemilu.org#53247,"LOLOAN BARAT, NEGARA, JEMBRANA, BALI",11,71,160,231
https://kawalpemilu.org#53247,"LOLOAN BARAT, NEGARA, JEMBRANA, BALI",12,44,66,110
https://kawalpemilu.org#53248,"CUPEL, NEGARA, JEMBRANA, BALI",1,136,96,232
https://kawalpemilu.org#53248,"CUPEL, NEGARA, JEMBRANA, BALI",2,153,76,229
https://kawalpemilu.org#53248,"CUPEL, NEGARA, JEMBRANA, BALI",3,101,135,236
https://kawalpemilu.org#53248,"CUPEL, NEGARA, JEMBRANA, BALI",4,105,137,242
https://kawalpemilu.org#53248,"CUPEL, NEGARA, JEMBRANA, BALI",5,100,119,219
https://kawalpemilu.org#53248,"CUPEL, NEGARA, JEMBRANA, BALI",6,132,101,233
https://kawalpemilu.org#53248,"CUPEL, NEGARA, JEMBRANA, BALI",7,90,141,231
https://kawalpemilu.org#53248,"CUPEL, NEGARA, JEMBRANA, BALI",8,98,96,194
https://kawalpemilu.org#53248,"CUPEL, NEGARA, JEMBRANA, BALI",9,93,119,212
https://kawalpemilu.org#53248,"CUPEL, NEGARA, JEMBRANA, BALI",10,108,112,220
https://kawalpemilu.org#53248,"CUPEL, NEGARA, JEMBRANA, BALI",11,57,137,194
https://kawalpemilu.org#53248,"CUPEL, NEGARA, JEMBRANA, BALI",12,128,102,230
https://kawalpemilu.org#53249,"BALUK, NEGARA, JEMBRANA, BALI",1,161,11,172
https://kawalpemilu.org#53249,"BALUK, NEGARA, JEMBRANA, BALI",2,161,25,186
https://kawalpemilu.org#53249,"BALUK, NEGARA, JEMBRANA, BALI",3,206,10,216
https://kawalpemilu.org#53249,"BALUK, NEGARA, JEMBRANA, BALI",4,238,21,259
https://kawalpemilu.org#53249,"BALUK, NEGARA, JEMBRANA, BALI",5,0,0,0
https://kawalpemilu.org#53249,"BALUK, NEGARA, JEMBRANA, BALI",6,115,132,247
https://kawalpemilu.org#53249,"BALUK, NEGARA, JEMBRANA, BALI",7,219,21,240
https://kawalpemilu.org#53249,"BALUK, NEGARA, JEMBRANA, BALI",8,203,24,227
https://kawalpemilu.org#53249,"BALUK, NEGARA, JEMBRANA, BALI",9,204,20,224
https://kawalpemilu.org#53249,"BALUK, NEGARA, JEMBRANA, BALI",10,186,10,196
https://kawalpemilu.org#53249,"BALUK, NEGARA, JEMBRANA, BALI",11,176,10,186
https://kawalpemilu.org#53249,"BALUK, NEGARA, JEMBRANA, BALI",12,224,4,228
https://kawalpemilu.org#53249,"BALUK, NEGARA, JEMBRANA, BALI",13,225,12,237
https://kawalpemilu.org#53249,"BALUK, NEGARA, JEMBRANA, BALI",14,225,10,235
https://kawalpemilu.org#53249,"BALUK, NEGARA, JEMBRANA, BALI",15,239,9,248
https://kawalpemilu.org#53249,"BALUK, NEGARA, JEMBRANA, BALI",16,175,14,189
https://kawalpemilu.org#53249,"BALUK, NEGARA, JEMBRANA, BALI",17,184,14,198
https://kawalpemilu.org#53249,"BALUK, NEGARA, JEMBRANA, BALI",18,182,11,193
https://kawalpemilu.org#53249,"BALUK, NEGARA, JEMBRANA, BALI",19,233,18,251
https://kawalpemilu.org#53249,"BALUK, NEGARA, JEMBRANA, BALI",20,192,21,213
https://kawalpemilu.org#53250,"BANYUBIRU, NEGARA, JEMBRANA, BALI",1,66,180,246
https://kawalpemilu.org#53250,"BANYUBIRU, NEGARA, JEMBRANA, BALI",2,201,35,236
https://kawalpemilu.org#53250,"BANYUBIRU, NEGARA, JEMBRANA, BALI",3,197,37,234
https://kawalpemilu.org#53250,"BANYUBIRU, NEGARA, JEMBRANA, BALI",4,129,13,142
https://kawalpemilu.org#53250,"BANYUBIRU, NEGARA, JEMBRANA, BALI",5,173,3,176
https://kawalpemilu.org#53250,"BANYUBIRU, NEGARA, JEMBRANA, BALI",6,115,134,249
https://kawalpemilu.org#53250,"BANYUBIRU, NEGARA, JEMBRANA, BALI",7,82,129,211
https://kawalpemilu.org#53250,"BANYUBIRU, NEGARA, JEMBRANA, BALI",8,90,117,207
https://kawalpemilu.org#53250,"BANYUBIRU, NEGARA, JEMBRANA, BALI",9,148,73,221
https://kawalpemilu.org#53250,"BANYUBIRU, NEGARA, JEMBRANA, BALI",10,119,99,218
https://kawalpemilu.org#53250,"BANYUBIRU, NEGARA, JEMBRANA, BALI",11,0,0,0
https://kawalpemilu.org#53250,"BANYUBIRU, NEGARA, JEMBRANA, BALI",12,66,180,246
https://kawalpemilu.org#53250,"BANYUBIRU, NEGARA, JEMBRANA, BALI",13,54,178,232
https://kawalpemilu.org#53250,"BANYUBIRU, NEGARA, JEMBRANA, BALI",14,194,52,246
https://kawalpemilu.org#53250,"BANYUBIRU, NEGARA, JEMBRANA, BALI",15,208,42,250
https://kawalpemilu.org#53250,"BANYUBIRU, NEGARA, JEMBRANA, BALI",16,124,106,230
https://kawalpemilu.org#53250,"BANYUBIRU, NEGARA, JEMBRANA, BALI",17,156,43,199
https://kawalpemilu.org#53250,"BANYUBIRU, NEGARA, JEMBRANA, BALI",18,222,13,235
https://kawalpemilu.org#53250,"BANYUBIRU, NEGARA, JEMBRANA, BALI",19,95,129,224
https://kawalpemilu.org#53250,"BANYUBIRU, NEGARA, JEMBRANA, BALI",20,94,118,212
https://kawalpemilu.org#53250,"BANYUBIRU, NEGARA, JEMBRANA, BALI",21,127,84,211
https://kawalpemilu.org#53250,"BANYUBIRU, NEGARA, JEMBRANA, BALI",22,125,91,216
https://kawalpemilu.org#53250,"BANYUBIRU, NEGARA, JEMBRANA, BALI",23,107,33,140
https://kawalpemilu.org#53250,"BANYUBIRU, NEGARA, JEMBRANA, BALI",24,111,136,247
https://kawalpemilu.org#53250,"BANYUBIRU, NEGARA, JEMBRANA, BALI",25,47,194,241
https://kawalpemilu.org#53251,"KALIAKAH, NEGARA, JEMBRANA, BALI",1,230,17,247
https://kawalpemilu.org#53251,"KALIAKAH, NEGARA, JEMBRANA, BALI",2,242,4,246
https://kawalpemilu.org#53251,"KALIAKAH, NEGARA, JEMBRANA, BALI",4,209,16,225
https://kawalpemilu.org#53251,"KALIAKAH, NEGARA, JEMBRANA, BALI",6,224,14,238
https://kawalpemilu.org#53251,"KALIAKAH, NEGARA, JEMBRANA, BALI",7,218,31,249
https://kawalpemilu.org#53251,"KALIAKAH, NEGARA, JEMBRANA, BALI",9,200,40,240
https://kawalpemilu.org#53251,"KALIAKAH, NEGARA, JEMBRANA, BALI",10,204,38,242
https://kawalpemilu.org#53251,"KALIAKAH, NEGARA, JEMBRANA, BALI",11,198,28,226
https://kawalpemilu.org#53251,"KALIAKAH, NEGARA, JEMBRANA, BALI",12,192,43,235
https://kawalpemilu.org#53251,"KALIAKAH, NEGARA, JEMBRANA, BALI",13,243,26,269
https://kawalpemilu.org#53251,"KALIAKAH, NEGARA, JEMBRANA, BALI",14,213,29,242
https://kawalpemilu.org#53251,"KALIAKAH, NEGARA, JEMBRANA, BALI",16,199,28,227
https://kawalpemilu.org#53251,"KALIAKAH, NEGARA, JEMBRANA, BALI",17,163,62,225
https://kawalpemilu.org#53251,"KALIAKAH, NEGARA, JEMBRANA, BALI",18,173,37,210
https://kawalpemilu.org#53251,"KALIAKAH, NEGARA, JEMBRANA, BALI",19,150,55,205
https://kawalpemilu.org#53251,"KALIAKAH, NEGARA, JEMBRANA, BALI",20,193,19,212
https://kawalpemilu.org#53251,"KALIAKAH, NEGARA, JEMBRANA, BALI",21,130,108,238
https://kawalpemilu.org#53251,"KALIAKAH, NEGARA, JEMBRANA, BALI",22,155,59,214
https://kawalpemilu.org#53251,"KALIAKAH, NEGARA, JEMBRANA, BALI",23,148,41,189
https://kawalpemilu.org#53251,"KALIAKAH, NEGARA, JEMBRANA, BALI",24,187,18,205
https://kawalpemilu.org#53252,"BERANGBANG, NEGARA, JEMBRANA, BALI",1,189,27,216
https://kawalpemilu.org#53252,"BERANGBANG, NEGARA, JEMBRANA, BALI",2,175,38,213
https://kawalpemilu.org#53252,"BERANGBANG, NEGARA, JEMBRANA, BALI",3,192,24,216
https://kawalpemilu.org#53252,"BERANGBANG, NEGARA, JEMBRANA, BALI",4,165,22,187
https://kawalpemilu.org#53252,"BERANGBANG, NEGARA, JEMBRANA, BALI",5,172,10,182
https://kawalpemilu.org#53252,"BERANGBANG, NEGARA, JEMBRANA, BALI",6,158,25,183
https://kawalpemilu.org#53252,"BERANGBANG, NEGARA, JEMBRANA, BALI",7,158,21,179
https://kawalpemilu.org#53252,"BERANGBANG, NEGARA, JEMBRANA, BALI",8,164,25,189
https://kawalpemilu.org#53252,"BERANGBANG, NEGARA, JEMBRANA, BALI",9,171,13,184
https://kawalpemilu.org#53252,"BERANGBANG, NEGARA, JEMBRANA, BALI",10,159,24,183
https://kawalpemilu.org#53252,"BERANGBANG, NEGARA, JEMBRANA, BALI",11,169,17,186
https://kawalpemilu.org#53252,"BERANGBANG, NEGARA, JEMBRANA, BALI",13,162,17,179
https://kawalpemilu.org#53252,"BERANGBANG, NEGARA, JEMBRANA, BALI",14,189,39,228
https://kawalpemilu.org#53252,"BERANGBANG, NEGARA, JEMBRANA, BALI",15,172,47,219
https://kawalpemilu.org#53252,"BERANGBANG, NEGARA, JEMBRANA, BALI",16,161,42,203
https://kawalpemilu.org#53252,"BERANGBANG, NEGARA, JEMBRANA, BALI",17,214,24,238
https://kawalpemilu.org#53252,"BERANGBANG, NEGARA, JEMBRANA, BALI",18,226,12,238
https://kawalpemilu.org#53252,"BERANGBANG, NEGARA, JEMBRANA, BALI",19,218,9,227
https://kawalpemilu.org#53252,"BERANGBANG, NEGARA, JEMBRANA, BALI",20,228,25,253
https://kawalpemilu.org#53252,"BERANGBANG, NEGARA, JEMBRANA, BALI",21,243,27,270
https://kawalpemilu.org#53253,"TEGALBADENG TIMUR, NEGARA, JEMBRANA, BALI",1,119,101,220
https://kawalpemilu.org#53253,"TEGALBADENG TIMUR, NEGARA, JEMBRANA, BALI",2,166,48,214
https://kawalpemilu.org#53253,"TEGALBADENG TIMUR, NEGARA, JEMBRANA, BALI",3,208,14,222
https://kawalpemilu.org#53253,"TEGALBADENG TIMUR, NEGARA, JEMBRANA, BALI",4,177,22,199
https://kawalpemilu.org#53253,"TEGALBADENG TIMUR, NEGARA, JEMBRANA, BALI",5,134,69,203
https://kawalpemilu.org#53253,"TEGALBADENG TIMUR, NEGARA, JEMBRANA, BALI",6,174,66,240
https://kawalpemilu.org#53253,"TEGALBADENG TIMUR, NEGARA, JEMBRANA, BALI",7,88,144,232
https://kawalpemilu.org#53253,"TEGALBADENG TIMUR, NEGARA, JEMBRANA, BALI",8,93,142,235
https://kawalpemilu.org#53253,"TEGALBADENG TIMUR, NEGARA, JEMBRANA, BALI",9,107,113,220
https://kawalpemilu.org#53253,"TEGALBADENG TIMUR, NEGARA, JEMBRANA, BALI",10,110,133,243
https://kawalpemilu.org#53253,"TEGALBADENG TIMUR, NEGARA, JEMBRANA, BALI",11,112,120,232
https://kawalpemilu.org#53253,"TEGALBADENG TIMUR, NEGARA, JEMBRANA, BALI",12,230,9,239
https://kawalpemilu.org#53254,"TEGALBADENG BARAT, NEGARA, JEMBRANA, BALI",1,206,38,244
https://kawalpemilu.org#53254,"TEGALBADENG BARAT, NEGARA, JEMBRANA, BALI",2,226,34,260
https://kawalpemilu.org#53254,"TEGALBADENG BARAT, NEGARA, JEMBRANA, BALI",3,184,56,240
https://kawalpemilu.org#53254,"TEGALBADENG BARAT, NEGARA, JEMBRANA, BALI",4,238,17,255
https://kawalpemilu.org#53254,"TEGALBADENG BARAT, NEGARA, JEMBRANA, BALI",5,200,50,250
https://kawalpemilu.org#53254,"TEGALBADENG BARAT, NEGARA, JEMBRANA, BALI",6,146,89,235
https://kawalpemilu.org#53254,"TEGALBADENG BARAT, NEGARA, JEMBRANA, BALI",7,152,65,217
https://kawalpemilu.org#53254,"TEGALBADENG BARAT, NEGARA, JEMBRANA, BALI",8,121,79,200
https://kawalpemilu.org#53254,"TEGALBADENG BARAT, NEGARA, JEMBRANA, BALI",10,233,35,268
https://kawalpemilu.org#53254,"TEGALBADENG BARAT, NEGARA, JEMBRANA, BALI",12,167,71,238
https://kawalpemilu.org#53254,"TEGALBADENG BARAT, NEGARA, JEMBRANA, BALI",13,178,56,234
https://kawalpemilu.org#53254,"TEGALBADENG BARAT, NEGARA, JEMBRANA, BALI",14,189,65,254
https://kawalpemilu.org#53254,"TEGALBADENG BARAT, NEGARA, JEMBRANA, BALI",15,198,51,249
https://kawalpemilu.org#53255,"PENGAMBENGAN, NEGARA, JEMBRANA, BALI",1,124,104,228
https://kawalpemilu.org#53255,"PENGAMBENGAN, NEGARA, JEMBRANA, BALI",2,117,108,225
https://kawalpemilu.org#53255,"PENGAMBENGAN, NEGARA, JEMBRANA, BALI",3,118,118,236
https://kawalpemilu.org#53255,"PENGAMBENGAN, NEGARA, JEMBRANA, BALI",4,123,105,228
https://kawalpemilu.org#53255,"PENGAMBENGAN, NEGARA, JEMBRANA, BALI",5,99,158,257
https://kawalpemilu.org#53255,"PENGAMBENGAN, NEGARA, JEMBRANA, BALI",7,134,105,239
https://kawalpemilu.org#53255,"PENGAMBENGAN, NEGARA, JEMBRANA, BALI",8,156,95,251
https://kawalpemilu.org#53255,"PENGAMBENGAN, NEGARA, JEMBRANA, BALI",9,139,91,230
https://kawalpemilu.org#53255,"PENGAMBENGAN, NEGARA, JEMBRANA, BALI",10,115,126,241
https://kawalpemilu.org#53255,"PENGAMBENGAN, NEGARA, JEMBRANA, BALI",11,132,88,220
https://kawalpemilu.org#53255,"PENGAMBENGAN, NEGARA, JEMBRANA, BALI",12,148,75,223
https://kawalpemilu.org#53255,"PENGAMBENGAN, NEGARA, JEMBRANA, BALI",13,156,89,245
https://kawalpemilu.org#53255,"PENGAMBENGAN, NEGARA, JEMBRANA, BALI",14,117,115,232
https://kawalpemilu.org#53255,"PENGAMBENGAN, NEGARA, JEMBRANA, BALI",15,116,134,250
https://kawalpemilu.org#53255,"PENGAMBENGAN, NEGARA, JEMBRANA, BALI",16,130,119,249
https://kawalpemilu.org#53255,"PENGAMBENGAN, NEGARA, JEMBRANA, BALI",17,132,106,238
https://kawalpemilu.org#53255,"PENGAMBENGAN, NEGARA, JEMBRANA, BALI",18,125,115,240
https://kawalpemilu.org#53255,"PENGAMBENGAN, NEGARA, JEMBRANA, BALI",19,137,105,242
https://kawalpemilu.org#53255,"PENGAMBENGAN, NEGARA, JEMBRANA, BALI",20,157,83,240
https://kawalpemilu.org#53255,"PENGAMBENGAN, NEGARA, JEMBRANA, BALI",21,116,111,227
https://kawalpemilu.org#53255,"PENGAMBENGAN, NEGARA, JEMBRANA, BALI",22,136,91,227
https://kawalpemilu.org#53255,"PENGAMBENGAN, NEGARA, JEMBRANA, BALI",23,121,100,221
https://kawalpemilu.org#53255,"PENGAMBENGAN, NEGARA, JEMBRANA, BALI",24,135,88,243
https://kawalpemilu.org#53255,"PENGAMBENGAN, NEGARA, JEMBRANA, BALI",25,137,98,235
https://kawalpemilu.org#53255,"PENGAMBENGAN, NEGARA, JEMBRANA, BALI",26,95,123,253
https://kawalpemilu.org#53255,"PENGAMBENGAN, NEGARA, JEMBRANA, BALI",27,103,129,232
https://kawalpemilu.org#53255,"PENGAMBENGAN, NEGARA, JEMBRANA, BALI",28,169,64,233
https://kawalpemilu.org#53255,"PENGAMBENGAN, NEGARA, JEMBRANA, BALI",29,140,96,236
https://kawalpemilu.org#53255,"PENGAMBENGAN, NEGARA, JEMBRANA, BALI",30,153,88,241
https://kawalpemilu.org#53255,"PENGAMBENGAN, NEGARA, JEMBRANA, BALI",31,141,83,224
https://kawalpemilu.org#53257,"MENDOYO DAUH TUKAD, MENDOYO, JEMBRANA, BALI",1,172,6,178
https://kawalpemilu.org#53257,"MENDOYO DAUH TUKAD, MENDOYO, JEMBRANA, BALI",2,204,10,214
https://kawalpemilu.org#53257,"MENDOYO DAUH TUKAD, MENDOYO, JEMBRANA, BALI",3,164,13,177
https://kawalpemilu.org#53257,"MENDOYO DAUH TUKAD, MENDOYO, JEMBRANA, BALI",4,214,7,221
https://kawalpemilu.org#53257,"MENDOYO DAUH TUKAD, MENDOYO, JEMBRANA, BALI",5,186,12,198
https://kawalpemilu.org#53257,"MENDOYO DAUH TUKAD, MENDOYO, JEMBRANA, BALI",6,191,7,198
https://kawalpemilu.org#53257,"MENDOYO DAUH TUKAD, MENDOYO, JEMBRANA, BALI",7,197,11,208
https://kawalpemilu.org#53257,"MENDOYO DAUH TUKAD, MENDOYO, JEMBRANA, BALI",8,85,2,87
https://kawalpemilu.org#53257,"MENDOYO DAUH TUKAD, MENDOYO, JEMBRANA, BALI",9,200,1,201
https://kawalpemilu.org#53257,"MENDOYO DAUH TUKAD, MENDOYO, JEMBRANA, BALI",10,245,5,250
https://kawalpemilu.org#53257,"MENDOYO DAUH TUKAD, MENDOYO, JEMBRANA, BALI",11,232,4,236
https://kawalpemilu.org#53257,"MENDOYO DAUH TUKAD, MENDOYO, JEMBRANA, BALI",12,195,5,200
https://kawalpemilu.org#53257,"MENDOYO DAUH TUKAD, MENDOYO, JEMBRANA, BALI",13,215,8,223
https://kawalpemilu.org#53257,"MENDOYO DAUH TUKAD, MENDOYO, JEMBRANA, BALI",14,229,9,4
https://kawalpemilu.org#53257,"MENDOYO DAUH TUKAD, MENDOYO, JEMBRANA, BALI",15,241,5,246
https://kawalpemilu.org#53257,"MENDOYO DAUH TUKAD, MENDOYO, JEMBRANA, BALI",16,234,11,245
https://kawalpemilu.org#53257,"MENDOYO DAUH TUKAD, MENDOYO, JEMBRANA, BALI",17,163,14,177
https://kawalpemilu.org#53257,"MENDOYO DAUH TUKAD, MENDOYO, JEMBRANA, BALI",18,179,13,192
https://kawalpemilu.org#53258,"POHSANTEN, MENDOYO, JEMBRANA, BALI",1,207,9,216
https://kawalpemilu.org#53258,"POHSANTEN, MENDOYO, JEMBRANA, BALI",3,154,24,178
https://kawalpemilu.org#53258,"POHSANTEN, MENDOYO, JEMBRANA, BALI",4,180,12,192
https://kawalpemilu.org#53258,"POHSANTEN, MENDOYO, JEMBRANA, BALI",5,141,20,161
https://kawalpemilu.org#53258,"POHSANTEN, MENDOYO, JEMBRANA, BALI",6,146,23,169
https://kawalpemilu.org#53258,"POHSANTEN, MENDOYO, JEMBRANA, BALI",7,168,14,182
https://kawalpemilu.org#53258,"POHSANTEN, MENDOYO, JEMBRANA, BALI",8,194,18,212
https://kawalpemilu.org#53258,"POHSANTEN, MENDOYO, JEMBRANA, BALI",9,210,25,235
https://kawalpemilu.org#53258,"POHSANTEN, MENDOYO, JEMBRANA, BALI",10,194,34,228
https://kawalpemilu.org#53258,"POHSANTEN, MENDOYO, JEMBRANA, BALI",11,198,18,216
https://kawalpemilu.org#53258,"POHSANTEN, MENDOYO, JEMBRANA, BALI",12,191,11,202
https://kawalpemilu.org#53258,"POHSANTEN, MENDOYO, JEMBRANA, BALI",13,183,15,198
https://kawalpemilu.org#53258,"POHSANTEN, MENDOYO, JEMBRANA, BALI",14,206,20,226
https://kawalpemilu.org#53258,"POHSANTEN, MENDOYO, JEMBRANA, BALI",15,202,3,205
https://kawalpemilu.org#53258,"POHSANTEN, MENDOYO, JEMBRANA, BALI",16,201,18,219
https://kawalpemilu.org#53258,"POHSANTEN, MENDOYO, JEMBRANA, BALI",17,203,13,216
https://kawalpemilu.org#53258,"POHSANTEN, MENDOYO, JEMBRANA, BALI",18,204,12,216
https://kawalpemilu.org#53258,"POHSANTEN, MENDOYO, JEMBRANA, BALI",19,138,5,143
https://kawalpemilu.org#53258,"POHSANTEN, MENDOYO, JEMBRANA, BALI",20,110,6,116
https://kawalpemilu.org#53258,"POHSANTEN, MENDOYO, JEMBRANA, BALI",21,156,19,175
https://kawalpemilu.org#53258,"POHSANTEN, MENDOYO, JEMBRANA, BALI",22,225,8,233
https://kawalpemilu.org#53259,"MENDOYO DANGIN TUKAD, MENDOYO, JEMBRANA, BALI",1,207,10,217
https://kawalpemilu.org#53259,"MENDOYO DANGIN TUKAD, MENDOYO, JEMBRANA, BALI",2,203,9,212
https://kawalpemilu.org#53259,"MENDOYO DANGIN TUKAD, MENDOYO, JEMBRANA, BALI",4,209,7,216
https://kawalpemilu.org#53259,"MENDOYO DANGIN TUKAD, MENDOYO, JEMBRANA, BALI",5,225,14,239
https://kawalpemilu.org#53259,"MENDOYO DANGIN TUKAD, MENDOYO, JEMBRANA, BALI",6,205,14,219
https://kawalpemilu.org#53259,"MENDOYO DANGIN TUKAD, MENDOYO, JEMBRANA, BALI",7,229,4,233
https://kawalpemilu.org#53259,"MENDOYO DANGIN TUKAD, MENDOYO, JEMBRANA, BALI",8,224,6,230
https://kawalpemilu.org#53259,"MENDOYO DANGIN TUKAD, MENDOYO, JEMBRANA, BALI",9,219,10,229
https://kawalpemilu.org#53260,"PERGUNG, MENDOYO, JEMBRANA, BALI",1,129,2,131
https://kawalpemilu.org#53260,"PERGUNG, MENDOYO, JEMBRANA, BALI",2,147,6,153
https://kawalpemilu.org#53260,"PERGUNG, MENDOYO, JEMBRANA, BALI",3,200,23,223
https://kawalpemilu.org#53260,"PERGUNG, MENDOYO, JEMBRANA, BALI",4,156,6,162
https://kawalpemilu.org#53260,"PERGUNG, MENDOYO, JEMBRANA, BALI",5,163,12,175
https://kawalpemilu.org#53260,"PERGUNG, MENDOYO, JEMBRANA, BALI",6,138,18,156
https://kawalpemilu.org#53260,"PERGUNG, MENDOYO, JEMBRANA, BALI",7,200,24,224
https://kawalpemilu.org#53260,"PERGUNG, MENDOYO, JEMBRANA, BALI",8,172,18,190
https://kawalpemilu.org#53260,"PERGUNG, MENDOYO, JEMBRANA, BALI",9,175,22,197
https://kawalpemilu.org#53260,"PERGUNG, MENDOYO, JEMBRANA, BALI",10,172,12,184
https://kawalpemilu.org#53260,"PERGUNG, MENDOYO, JEMBRANA, BALI",11,178,15,193
https://kawalpemilu.org#53260,"PERGUNG, MENDOYO, JEMBRANA, BALI",12,161,23,184
https://kawalpemilu.org#53260,"PERGUNG, MENDOYO, JEMBRANA, BALI",13,175,11,186
https://kawalpemilu.org#53260,"PERGUNG, MENDOYO, JEMBRANA, BALI",14,148,7,155
https://kawalpemilu.org#53260,"PERGUNG, MENDOYO, JEMBRANA, BALI",15,173,6,179
https://kawalpemilu.org#53260,"PERGUNG, MENDOYO, JEMBRANA, BALI",16,163,10,173
https://kawalpemilu.org#53260,"PERGUNG, MENDOYO, JEMBRANA, BALI",17,189,4,193
https://kawalpemilu.org#53261,"DELODBRAWAH, MENDOYO, JEMBRANA, BALI",1,220,3,223
https://kawalpemilu.org#53261,"DELODBRAWAH, MENDOYO, JEMBRANA, BALI",2,216,4,220
https://kawalpemilu.org#53261,"DELODBRAWAH, MENDOYO, JEMBRANA, BALI",3,183,23,206
https://kawalpemilu.org#53261,"DELODBRAWAH, MENDOYO, JEMBRANA, BALI",4,217,12,229
https://kawalpemilu.org#53261,"DELODBRAWAH, MENDOYO, JEMBRANA, BALI",5,123,4,127
https://kawalpemilu.org#53261,"DELODBRAWAH, MENDOYO, JEMBRANA, BALI",6,195,22,217
https://kawalpemilu.org#53261,"DELODBRAWAH, MENDOYO, JEMBRANA, BALI",7,189,11,200
https://kawalpemilu.org#53262,"TEGALCANGKRING, MENDOYO, JEMBRANA, BALI",1,172,16,188
https://kawalpemilu.org#53262,"TEGALCANGKRING, MENDOYO, JEMBRANA, BALI",2,179,7,186
https://kawalpemilu.org#53262,"TEGALCANGKRING, MENDOYO, JEMBRANA, BALI",3,165,8,173
https://kawalpemilu.org#53262,"TEGALCANGKRING, MENDOYO, JEMBRANA, BALI",4,178,3,181
https://kawalpemilu.org#53262,"TEGALCANGKRING, MENDOYO, JEMBRANA, BALI",5,169,22,191
https://kawalpemilu.org#53262,"TEGALCANGKRING, MENDOYO, JEMBRANA, BALI",6,182,17,199
https://kawalpemilu.org#53262,"TEGALCANGKRING, MENDOYO, JEMBRANA, BALI",7,177,29,206
https://kawalpemilu.org#53262,"TEGALCANGKRING, MENDOYO, JEMBRANA, BALI",8,177,12,189
https://kawalpemilu.org#53262,"TEGALCANGKRING, MENDOYO, JEMBRANA, BALI",9,177,8,185
https://kawalpemilu.org#53262,"TEGALCANGKRING, MENDOYO, JEMBRANA, BALI",10,201,11,212
https://kawalpemilu.org#53262,"TEGALCANGKRING, MENDOYO, JEMBRANA, BALI",11,173,17,190
https://kawalpemilu.org#53262,"TEGALCANGKRING, MENDOYO, JEMBRANA, BALI",12,191,14,205
https://kawalpemilu.org#53262,"TEGALCANGKRING, MENDOYO, JEMBRANA, BALI",13,184,6,190
https://kawalpemilu.org#53262,"TEGALCANGKRING, MENDOYO, JEMBRANA, BALI",14,216,11,223
https://kawalpemilu.org#53262,"TEGALCANGKRING, MENDOYO, JEMBRANA, BALI",15,209,6,215
https://kawalpemilu.org#53262,"TEGALCANGKRING, MENDOYO, JEMBRANA, BALI",16,177,9,186
https://kawalpemilu.org#53262,"TEGALCANGKRING, MENDOYO, JEMBRANA, BALI",17,182,15,197
https://kawalpemilu.org#53262,"TEGALCANGKRING, MENDOYO, JEMBRANA, BALI",18,162,8,170
https://kawalpemilu.org#53262,"TEGALCANGKRING, MENDOYO, JEMBRANA, BALI",19,236,6,242
https://kawalpemilu.org#53262,"TEGALCANGKRING, MENDOYO, JEMBRANA, BALI",20,213,9,222
https://kawalpemilu.org#53262,"TEGALCANGKRING, MENDOYO, JEMBRANA, BALI",21,216,21,237
https://kawalpemilu.org#53262,"TEGALCANGKRING, MENDOYO, JEMBRANA, BALI",22,209,14,223
https://kawalpemilu.org#53262,"TEGALCANGKRING, MENDOYO, JEMBRANA, BALI",23,193,22,215
https://kawalpemilu.org#53262,"TEGALCANGKRING, MENDOYO, JEMBRANA, BALI",24,175,30,205
https://kawalpemilu.org#53263,"PENYARINGAN, MENDOYO, JEMBRANA, BALI",1,167,8,175
https://kawalpemilu.org#53263,"PENYARINGAN, MENDOYO, JEMBRANA, BALI",2,162,7,169
https://kawalpemilu.org#53263,"PENYARINGAN, MENDOYO, JEMBRANA, BALI",3,227,3,230
https://kawalpemilu.org#53263,"PENYARINGAN, MENDOYO, JEMBRANA, BALI",4,221,5,226
https://kawalpemilu.org#53263,"PENYARINGAN, MENDOYO, JEMBRANA, BALI",5,180,6,186
https://kawalpemilu.org#53263,"PENYARINGAN, MENDOYO, JEMBRANA, BALI",6,148,7,155
https://kawalpemilu.org#53263,"PENYARINGAN, MENDOYO, JEMBRANA, BALI",7,159,18,177
https://kawalpemilu.org#53263,"PENYARINGAN, MENDOYO, JEMBRANA, BALI",8,180,7,187
https://kawalpemilu.org#53263,"PENYARINGAN, MENDOYO, JEMBRANA, BALI",9,182,10,192
https://kawalpemilu.org#53263,"PENYARINGAN, MENDOYO, JEMBRANA, BALI",10,173,8,181
https://kawalpemilu.org#53263,"PENYARINGAN, MENDOYO, JEMBRANA, BALI",11,145,7,152
https://kawalpemilu.org#53263,"PENYARINGAN, MENDOYO, JEMBRANA, BALI",12,189,10,199
https://kawalpemilu.org#53263,"PENYARINGAN, MENDOYO, JEMBRANA, BALI",13,189,4,193
https://kawalpemilu.org#53263,"PENYARINGAN, MENDOYO, JEMBRANA, BALI",14,182,16,198
https://kawalpemilu.org#53263,"PENYARINGAN, MENDOYO, JEMBRANA, BALI",15,160,3,163
https://kawalpemilu.org#53263,"PENYARINGAN, MENDOYO, JEMBRANA, BALI",16,179,9,188
https://kawalpemilu.org#53263,"PENYARINGAN, MENDOYO, JEMBRANA, BALI",17,199,4,203
https://kawalpemilu.org#53263,"PENYARINGAN, MENDOYO, JEMBRANA, BALI",18,181,4,185
https://kawalpemilu.org#53263,"PENYARINGAN, MENDOYO, JEMBRANA, BALI",19,193,4,197
https://kawalpemilu.org#53263,"PENYARINGAN, MENDOYO, JEMBRANA, BALI",20,234,3,237
https://kawalpemilu.org#53263,"PENYARINGAN, MENDOYO, JEMBRANA, BALI",21,99,0,99
https://kawalpemilu.org#53263,"PENYARINGAN, MENDOYO, JEMBRANA, BALI",22,133,3,136
https://kawalpemilu.org#53263,"PENYARINGAN, MENDOYO, JEMBRANA, BALI",23,177,0,177
https://kawalpemilu.org#53263,"PENYARINGAN, MENDOYO, JEMBRANA, BALI",24,199,8,207
https://kawalpemilu.org#53263,"PENYARINGAN, MENDOYO, JEMBRANA, BALI",25,197,6,203
https://kawalpemilu.org#53263,"PENYARINGAN, MENDOYO, JEMBRANA, BALI",26,199,3,202
https://kawalpemilu.org#53263,"PENYARINGAN, MENDOYO, JEMBRANA, BALI",27,234,2,236
https://kawalpemilu.org#53263,"PENYARINGAN, MENDOYO, JEMBRANA, BALI",28,236,11,247
https://kawalpemilu.org#53263,"PENYARINGAN, MENDOYO, JEMBRANA, BALI",29,160,8,168
https://kawalpemilu.org#53263,"PENYARINGAN, MENDOYO, JEMBRANA, BALI",30,244,13,257
https://kawalpemilu.org#53263,"PENYARINGAN, MENDOYO, JEMBRANA, BALI",31,188,16,204
https://kawalpemilu.org#53263,"PENYARINGAN, MENDOYO, JEMBRANA, BALI",32,140,5,145
https://kawalpemilu.org#53263,"PENYARINGAN, MENDOYO, JEMBRANA, BALI",33,216,7,223
https://kawalpemilu.org#53264,"YEHEMBANG, MENDOYO, JEMBRANA, BALI",1,176,18,194
https://kawalpemilu.org#53264,"YEHEMBANG, MENDOYO, JEMBRANA, BALI",2,169,20,189
https://kawalpemilu.org#53264,"YEHEMBANG, MENDOYO, JEMBRANA, BALI",3,185,28,213
https://kawalpemilu.org#53264,"YEHEMBANG, MENDOYO, JEMBRANA, BALI",4,161,12,173
https://kawalpemilu.org#53264,"YEHEMBANG, MENDOYO, JEMBRANA, BALI",5,184,14,198
https://kawalpemilu.org#53264,"YEHEMBANG, MENDOYO, JEMBRANA, BALI",6,196,11,207
https://kawalpemilu.org#53264,"YEHEMBANG, MENDOYO, JEMBRANA, BALI",7,182,13,195
https://kawalpemilu.org#53264,"YEHEMBANG, MENDOYO, JEMBRANA, BALI",8,141,5,146
https://kawalpemilu.org#53264,"YEHEMBANG, MENDOYO, JEMBRANA, BALI",9,197,26,223
https://kawalpemilu.org#53264,"YEHEMBANG, MENDOYO, JEMBRANA, BALI",10,174,13,187
https://kawalpemilu.org#53264,"YEHEMBANG, MENDOYO, JEMBRANA, BALI",11,195,25,220
https://kawalpemilu.org#53264,"YEHEMBANG, MENDOYO, JEMBRANA, BALI",12,141,7,148
https://kawalpemilu.org#53264,"YEHEMBANG, MENDOYO, JEMBRANA, BALI",13,134,23,157
https://kawalpemilu.org#53264,"YEHEMBANG, MENDOYO, JEMBRANA, BALI",15,215,10,225
https://kawalpemilu.org#53264,"YEHEMBANG, MENDOYO, JEMBRANA, BALI",16,186,18,204
https://kawalpemilu.org#53264,"YEHEMBANG, MENDOYO, JEMBRANA, BALI",17,180,14,194
https://kawalpemilu.org#53264,"YEHEMBANG, MENDOYO, JEMBRANA, BALI",18,181,12,193
https://kawalpemilu.org#53264,"YEHEMBANG, MENDOYO, JEMBRANA, BALI",19,209,19,228
https://kawalpemilu.org#53264,"YEHEMBANG, MENDOYO, JEMBRANA, BALI",20,163,10,173
https://kawalpemilu.org#53264,"YEHEMBANG, MENDOYO, JEMBRANA, BALI",21,162,18,180
https://kawalpemilu.org#53264,"YEHEMBANG, MENDOYO, JEMBRANA, BALI",22,154,16,170
https://kawalpemilu.org#53264,"YEHEMBANG, MENDOYO, JEMBRANA, BALI",23,143,14,157
https://kawalpemilu.org#53264,"YEHEMBANG, MENDOYO, JEMBRANA, BALI",24,153,10,163
https://kawalpemilu.org#53264,"YEHEMBANG, MENDOYO, JEMBRANA, BALI",25,175,8,183
https://kawalpemilu.org#53264,"YEHEMBANG, MENDOYO, JEMBRANA, BALI",26,142,2,144
https://kawalpemilu.org#53264,"YEHEMBANG, MENDOYO, JEMBRANA, BALI",27,149,22,171
https://kawalpemilu.org#53265,"YEHSUMBUL, MENDOYO, JEMBRANA, BALI",1,102,84,186
https://kawalpemilu.org#53265,"YEHSUMBUL, MENDOYO, JEMBRANA, BALI",2,83,139,222
https://kawalpemilu.org#53265,"YEHSUMBUL, MENDOYO, JEMBRANA, BALI",3,80,171,251
https://kawalpemilu.org#53265,"YEHSUMBUL, MENDOYO, JEMBRANA, BALI",4,53,130,183
https://kawalpemilu.org#53265,"YEHSUMBUL, MENDOYO, JEMBRANA, BALI",5,72,151,223
https://kawalpemilu.org#53265,"YEHSUMBUL, MENDOYO, JEMBRANA, BALI",6,70,135,205
https://kawalpemilu.org#53265,"YEHSUMBUL, MENDOYO, JEMBRANA, BALI",7,66,167,233
https://kawalpemilu.org#53265,"YEHSUMBUL, MENDOYO, JEMBRANA, BALI",8,49,185,234
https://kawalpemilu.org#53265,"YEHSUMBUL, MENDOYO, JEMBRANA, BALI",9,90,139,229
https://kawalpemilu.org#53265,"YEHSUMBUL, MENDOYO, JEMBRANA, BALI",10,158,76,234
https://kawalpemilu.org#53265,"YEHSUMBUL, MENDOYO, JEMBRANA, BALI",11,111,106,217
https://kawalpemilu.org#53265,"YEHSUMBUL, MENDOYO, JEMBRANA, BALI",12,143,56,199
https://kawalpemilu.org#53265,"YEHSUMBUL, MENDOYO, JEMBRANA, BALI",13,195,33,228
https://kawalpemilu.org#53265,"YEHSUMBUL, MENDOYO, JEMBRANA, BALI",14,144,76,220
https://kawalpemilu.org#53265,"YEHSUMBUL, MENDOYO, JEMBRANA, BALI",15,137,87,224
https://kawalpemilu.org#53265,"YEHSUMBUL, MENDOYO, JEMBRANA, BALI",16,193,18,211
https://kawalpemilu.org#53265,"YEHSUMBUL, MENDOYO, JEMBRANA, BALI",17,207,7,214
https://kawalpemilu.org#53265,"YEHSUMBUL, MENDOYO, JEMBRANA, BALI",18,163,5,168
https://kawalpemilu.org#53265,"YEHSUMBUL, MENDOYO, JEMBRANA, BALI",19,234,19,253
https://kawalpemilu.org#53265,"YEHSUMBUL, MENDOYO, JEMBRANA, BALI",20,200,9,209
https://kawalpemilu.org#53265,"YEHSUMBUL, MENDOYO, JEMBRANA, BALI",21,190,6,196
https://kawalpemilu.org#53266,"YEHEMBANG KAUH, MENDOYO, JEMBRANA, BALI",1,175,17,192
https://kawalpemilu.org#53266,"YEHEMBANG KAUH, MENDOYO, JEMBRANA, BALI",2,161,20,181
https://kawalpemilu.org#53266,"YEHEMBANG KAUH, MENDOYO, JEMBRANA, BALI",3,240,15,255
https://kawalpemilu.org#53266,"YEHEMBANG KAUH, MENDOYO, JEMBRANA, BALI",4,224,15,239
https://kawalpemilu.org#53266,"YEHEMBANG KAUH, MENDOYO, JEMBRANA, BALI",5,219,3,222
https://kawalpemilu.org#53266,"YEHEMBANG KAUH, MENDOYO, JEMBRANA, BALI",6,213,13,226
https://kawalpemilu.org#53266,"YEHEMBANG KAUH, MENDOYO, JEMBRANA, BALI",7,133,6,139
https://kawalpemilu.org#53266,"YEHEMBANG KAUH, MENDOYO, JEMBRANA, BALI",8,204,7,211
https://kawalpemilu.org#53266,"YEHEMBANG KAUH, MENDOYO, JEMBRANA, BALI",9,190,11,201
https://kawalpemilu.org#53266,"YEHEMBANG KAUH, MENDOYO, JEMBRANA, BALI",10,151,19,170
https://kawalpemilu.org#53266,"YEHEMBANG KAUH, MENDOYO, JEMBRANA, BALI",11,164,23,187
https://kawalpemilu.org#53266,"YEHEMBANG KAUH, MENDOYO, JEMBRANA, BALI",12,191,15,206
https://kawalpemilu.org#53266,"YEHEMBANG KAUH, MENDOYO, JEMBRANA, BALI",13,179,18,197
https://kawalpemilu.org#53266,"YEHEMBANG KAUH, MENDOYO, JEMBRANA, BALI",14,206,7,213
https://kawalpemilu.org#53266,"YEHEMBANG KAUH, MENDOYO, JEMBRANA, BALI",15,232,23,255
https://kawalpemilu.org#53266,"YEHEMBANG KAUH, MENDOYO, JEMBRANA, BALI",16,219,4,223
https://kawalpemilu.org#53266,"YEHEMBANG KAUH, MENDOYO, JEMBRANA, BALI",17,183,1,184
https://kawalpemilu.org#53267,"YEHEMBANG KANGIN, MENDOYO, JEMBRANA, BALI",1,188,25,213
https://kawalpemilu.org#53267,"YEHEMBANG KANGIN, MENDOYO, JEMBRANA, BALI",3,187,14,201
https://kawalpemilu.org#53267,"YEHEMBANG KANGIN, MENDOYO, JEMBRANA, BALI",4,152,20,172
https://kawalpemilu.org#53267,"YEHEMBANG KANGIN, MENDOYO, JEMBRANA, BALI",5,163,24,187
https://kawalpemilu.org#53267,"YEHEMBANG KANGIN, MENDOYO, JEMBRANA, BALI",6,210,14,224
https://kawalpemilu.org#53267,"YEHEMBANG KANGIN, MENDOYO, JEMBRANA, BALI",7,147,6,153
https://kawalpemilu.org#53267,"YEHEMBANG KANGIN, MENDOYO, JEMBRANA, BALI",8,156,21,177
https://kawalpemilu.org#53267,"YEHEMBANG KANGIN, MENDOYO, JEMBRANA, BALI",9,149,34,228
https://kawalpemilu.org#53267,"YEHEMBANG KANGIN, MENDOYO, JEMBRANA, BALI",10,190,25,215
https://kawalpemilu.org#53267,"YEHEMBANG KANGIN, MENDOYO, JEMBRANA, BALI",11,208,26,234
https://kawalpemilu.org#53267,"YEHEMBANG KANGIN, MENDOYO, JEMBRANA, BALI",12,199,37,236
https://kawalpemilu.org#53267,"YEHEMBANG KANGIN, MENDOYO, JEMBRANA, BALI",13,121,5,126
https://kawalpemilu.org#53267,"YEHEMBANG KANGIN, MENDOYO, JEMBRANA, BALI",14,122,7,129
https://kawalpemilu.org#53269,"MEDEWI, PEKUTATAN, JEMBRANA, BALI",1,48,160,208
https://kawalpemilu.org#53269,"MEDEWI, PEKUTATAN, JEMBRANA, BALI",2,41,161,202
https://kawalpemilu.org#53269,"MEDEWI, PEKUTATAN, JEMBRANA, BALI",3,56,144,200
https://kawalpemilu.org#53269,"MEDEWI, PEKUTATAN, JEMBRANA, BALI",4,48,160,208
https://kawalpemilu.org#53269,"MEDEWI, PEKUTATAN, JEMBRANA, BALI",5,104,130,234
https://kawalpemilu.org#53269,"MEDEWI, PEKUTATAN, JEMBRANA, BALI",6,110,121,231
https://kawalpemilu.org#53269,"MEDEWI, PEKUTATAN, JEMBRANA, BALI",7,198,25,223
https://kawalpemilu.org#53269,"MEDEWI, PEKUTATAN, JEMBRANA, BALI",8,162,29,191
https://kawalpemilu.org#53269,"MEDEWI, PEKUTATAN, JEMBRANA, BALI",9,191,25,216
https://kawalpemilu.org#53269,"MEDEWI, PEKUTATAN, JEMBRANA, BALI",10,222,21,243
https://kawalpemilu.org#53269,"MEDEWI, PEKUTATAN, JEMBRANA, BALI",11,205,24,229
https://kawalpemilu.org#53269,"MEDEWI, PEKUTATAN, JEMBRANA, BALI",12,227,19,246
https://kawalpemilu.org#53269,"MEDEWI, PEKUTATAN, JEMBRANA, BALI",13,169,18,187
https://kawalpemilu.org#53269,"MEDEWI, PEKUTATAN, JEMBRANA, BALI",14,176,46,222
https://kawalpemilu.org#53269,"MEDEWI, PEKUTATAN, JEMBRANA, BALI",15,43,150,193
https://kawalpemilu.org#53270,"PULUKAN, PEKUTATAN, JEMBRANA, BALI",1,93,123,216
https://kawalpemilu.org#53270,"PULUKAN, PEKUTATAN, JEMBRANA, BALI",2,105,120,225
https://kawalpemilu.org#53270,"PULUKAN, PEKUTATAN, JEMBRANA, BALI",3,126,94,220
https://kawalpemilu.org#53270,"PULUKAN, PEKUTATAN, JEMBRANA, BALI",4,146,57,203
https://kawalpemilu.org#53270,"PULUKAN, PEKUTATAN, JEMBRANA, BALI",5,108,90,198
https://kawalpemilu.org#53270,"PULUKAN, PEKUTATAN, JEMBRANA, BALI",6,150,56,206
https://kawalpemilu.org#53270,"PULUKAN, PEKUTATAN, JEMBRANA, BALI",7,171,42,213
https://kawalpemilu.org#53270,"PULUKAN, PEKUTATAN, JEMBRANA, BALI",8,168,21,189
https://kawalpemilu.org#53270,"PULUKAN, PEKUTATAN, JEMBRANA, BALI",9,166,27,193
https://kawalpemilu.org#53270,"PULUKAN, PEKUTATAN, JEMBRANA, BALI",10,144,32,176
https://kawalpemilu.org#53270,"PULUKAN, PEKUTATAN, JEMBRANA, BALI",11,191,34,225
https://kawalpemilu.org#53270,"PULUKAN, PEKUTATAN, JEMBRANA, BALI",12,213,14,227
https://kawalpemilu.org#53270,"PULUKAN, PEKUTATAN, JEMBRANA, BALI",13,236,1,237
https://kawalpemilu.org#53271,"ASAHDUREN, PEKUTATAN, JEMBRANA, BALI",1,167,29,196
https://kawalpemilu.org#53271,"ASAHDUREN, PEKUTATAN, JEMBRANA, BALI",2,184,18,202
https://kawalpemilu.org#53271,"ASAHDUREN, PEKUTATAN, JEMBRANA, BALI",3,178,19,197
https://kawalpemilu.org#53271,"ASAHDUREN, PEKUTATAN, JEMBRANA, BALI",4,250,16,266
https://kawalpemilu.org#53271,"ASAHDUREN, PEKUTATAN, JEMBRANA, BALI",5,234,15,249
https://kawalpemilu.org#53271,"ASAHDUREN, PEKUTATAN, JEMBRANA, BALI",6,213,27,240
https://kawalpemilu.org#53271,"ASAHDUREN, PEKUTATAN, JEMBRANA, BALI",7,235,12,247
https://kawalpemilu.org#53271,"ASAHDUREN, PEKUTATAN, JEMBRANA, BALI",8,223,28,251
https://kawalpemilu.org#53271,"ASAHDUREN, PEKUTATAN, JEMBRANA, BALI",9,240,19,259
https://kawalpemilu.org#53271,"ASAHDUREN, PEKUTATAN, JEMBRANA, BALI",10,145,25,170
https://kawalpemilu.org#53271,"ASAHDUREN, PEKUTATAN, JEMBRANA, BALI",11,158,26,184
https://kawalpemilu.org#53272,"PEKUTATAN, PEKUTATAN, JEMBRANA, BALI",1,211,9,220
https://kawalpemilu.org#53272,"PEKUTATAN, PEKUTATAN, JEMBRANA, BALI",2,206,14,220
https://kawalpemilu.org#53272,"PEKUTATAN, PEKUTATAN, JEMBRANA, BALI",3,147,11,158
https://kawalpemilu.org#53272,"PEKUTATAN, PEKUTATAN, JEMBRANA, BALI",4,167,14,181
https://kawalpemilu.org#53272,"PEKUTATAN, PEKUTATAN, JEMBRANA, BALI",5,176,11,187
https://kawalpemilu.org#53272,"PEKUTATAN, PEKUTATAN, JEMBRANA, BALI",6,208,14,222
https://kawalpemilu.org#53272,"PEKUTATAN, PEKUTATAN, JEMBRANA, BALI",7,179,67,246
https://kawalpemilu.org#53272,"PEKUTATAN, PEKUTATAN, JEMBRANA, BALI",8,230,22,252
https://kawalpemilu.org#53272,"PEKUTATAN, PEKUTATAN, JEMBRANA, BALI",9,136,79,215
https://kawalpemilu.org#53272,"PEKUTATAN, PEKUTATAN, JEMBRANA, BALI",10,214,18,232
https://kawalpemilu.org#53272,"PEKUTATAN, PEKUTATAN, JEMBRANA, BALI",11,173,16,189
https://kawalpemilu.org#53272,"PEKUTATAN, PEKUTATAN, JEMBRANA, BALI",12,215,25,240
https://kawalpemilu.org#53272,"PEKUTATAN, PEKUTATAN, JEMBRANA, BALI",13,173,19,192
https://kawalpemilu.org#53272,"PEKUTATAN, PEKUTATAN, JEMBRANA, BALI",14,142,16,158
https://kawalpemilu.org#53272,"PEKUTATAN, PEKUTATAN, JEMBRANA, BALI",15,232,8,240
https://kawalpemilu.org#53272,"PEKUTATAN, PEKUTATAN, JEMBRANA, BALI",16,172,19,191
https://kawalpemilu.org#53272,"PEKUTATAN, PEKUTATAN, JEMBRANA, BALI",17,142,7,149
https://kawalpemilu.org#53273,"PANGYANGAN, PEKUTATAN, JEMBRANA, BALI",1,220,8,228
https://kawalpemilu.org#53273,"PANGYANGAN, PEKUTATAN, JEMBRANA, BALI",2,185,3,188
https://kawalpemilu.org#53273,"PANGYANGAN, PEKUTATAN, JEMBRANA, BALI",3,235,6,241
https://kawalpemilu.org#53273,"PANGYANGAN, PEKUTATAN, JEMBRANA, BALI",4,235,8,243
https://kawalpemilu.org#53273,"PANGYANGAN, PEKUTATAN, JEMBRANA, BALI",5,258,7,265
https://kawalpemilu.org#53274,"GUMBRIH, PEKUTATAN, JEMBRANA, BALI",1,245,17,262
https://kawalpemilu.org#53274,"GUMBRIH, PEKUTATAN, JEMBRANA, BALI",2,241,6,247
https://kawalpemilu.org#53274,"GUMBRIH, PEKUTATAN, JEMBRANA, BALI",3,218,11,229
https://kawalpemilu.org#53274,"GUMBRIH, PEKUTATAN, JEMBRANA, BALI",4,210,6,216
https://kawalpemilu.org#53274,"GUMBRIH, PEKUTATAN, JEMBRANA, BALI",5,218,6,224
https://kawalpemilu.org#53274,"GUMBRIH, PEKUTATAN, JEMBRANA, BALI",6,145,7,152
https://kawalpemilu.org#53274,"GUMBRIH, PEKUTATAN, JEMBRANA, BALI",7,132,8,140
https://kawalpemilu.org#53274,"GUMBRIH, PEKUTATAN, JEMBRANA, BALI",8,169,19,188
https://kawalpemilu.org#53274,"GUMBRIH, PEKUTATAN, JEMBRANA, BALI",9,168,28,196
https://kawalpemilu.org#53275,"MANGGISSARI, PEKUTATAN, JEMBRANA, BALI",1,150,6,156
https://kawalpemilu.org#53275,"MANGGISSARI, PEKUTATAN, JEMBRANA, BALI",2,155,11,166
https://kawalpemilu.org#53275,"MANGGISSARI, PEKUTATAN, JEMBRANA, BALI",3,225,11,236
https://kawalpemilu.org#53275,"MANGGISSARI, PEKUTATAN, JEMBRANA, BALI",4,218,10,228
https://kawalpemilu.org#53275,"MANGGISSARI, PEKUTATAN, JEMBRANA, BALI",5,209,15,224
https://kawalpemilu.org#53275,"MANGGISSARI, PEKUTATAN, JEMBRANA, BALI",6,200,9,209
https://kawalpemilu.org#53275,"MANGGISSARI, PEKUTATAN, JEMBRANA, BALI",7,188,14,202
https://kawalpemilu.org#53276,"PENGERAGOAN, PEKUTATAN, JEMBRANA, BALI",1,222,14,236
https://kawalpemilu.org#53276,"PENGERAGOAN, PEKUTATAN, JEMBRANA, BALI",2,202,13,215
https://kawalpemilu.org#53276,"PENGERAGOAN, PEKUTATAN, JEMBRANA, BALI",3,185,10,195
https://kawalpemilu.org#53276,"PENGERAGOAN, PEKUTATAN, JEMBRANA, BALI",4,194,18,212
https://kawalpemilu.org#53276,"PENGERAGOAN, PEKUTATAN, JEMBRANA, BALI",5,191,27,218
https://kawalpemilu.org#53276,"PENGERAGOAN, PEKUTATAN, JEMBRANA, BALI",6,212,33,245
https://kawalpemilu.org#53276,"PENGERAGOAN, PEKUTATAN, JEMBRANA, BALI",7,195,48,243
https://kawalpemilu.org#53276,"PENGERAGOAN, PEKUTATAN, JEMBRANA, BALI",8,178,47,225
https://kawalpemilu.org#53276,"PENGERAGOAN, PEKUTATAN, JEMBRANA, BALI",9,198,32,230
https://kawalpemilu.org#53276,"PENGERAGOAN, PEKUTATAN, JEMBRANA, BALI",10,179,12,191
https://kawalpemilu.org#53276,"PENGERAGOAN, PEKUTATAN, JEMBRANA, BALI",11,190,15,205
https://kawalpemilu.org#53276,"PENGERAGOAN, PEKUTATAN, JEMBRANA, BALI",12,253,2,255
https://kawalpemilu.org#53278,"GILIMANUK, MELAYA, JEMBRANA, BALI",1,206,4,210
https://kawalpemilu.org#53278,"GILIMANUK, MELAYA, JEMBRANA, BALI",2,223,10,233
https://kawalpemilu.org#53278,"GILIMANUK, MELAYA, JEMBRANA, BALI",3,191,39,230
https://kawalpemilu.org#53278,"GILIMANUK, MELAYA, JEMBRANA, BALI",4,189,33,222
https://kawalpemilu.org#53278,"GILIMANUK, MELAYA, JEMBRANA, BALI",5,193,40,233
https://kawalpemilu.org#53278,"GILIMANUK, MELAYA, JEMBRANA, BALI",6,194,39,233
https://kawalpemilu.org#53278,"GILIMANUK, MELAYA, JEMBRANA, BALI",7,202,14,216
https://kawalpemilu.org#53278,"GILIMANUK, MELAYA, JEMBRANA, BALI",8,149,72,221
https://kawalpemilu.org#53278,"GILIMANUK, MELAYA, JEMBRANA, BALI",9,157,71,228
https://kawalpemilu.org#53278,"GILIMANUK, MELAYA, JEMBRANA, BALI",10,194,41,235
https://kawalpemilu.org#53278,"GILIMANUK, MELAYA, JEMBRANA, BALI",11,127,75,202
https://kawalpemilu.org#53278,"GILIMANUK, MELAYA, JEMBRANA, BALI",12,126,94,220
https://kawalpemilu.org#53278,"GILIMANUK, MELAYA, JEMBRANA, BALI",13,155,39,194
https://kawalpemilu.org#53278,"GILIMANUK, MELAYA, JEMBRANA, BALI",14,159,46,205
https://kawalpemilu.org#53278,"GILIMANUK, MELAYA, JEMBRANA, BALI",15,155,58,213
https://kawalpemilu.org#53278,"GILIMANUK, MELAYA, JEMBRANA, BALI",16,145,76,221
https://kawalpemilu.org#53278,"GILIMANUK, MELAYA, JEMBRANA, BALI",17,177,54,231
https://kawalpemilu.org#53278,"GILIMANUK, MELAYA, JEMBRANA, BALI",18,183,23,206
https://kawalpemilu.org#53278,"GILIMANUK, MELAYA, JEMBRANA, BALI",19,196,28,224
https://kawalpemilu.org#53278,"GILIMANUK, MELAYA, JEMBRANA, BALI",20,186,36,222
https://kawalpemilu.org#53278,"GILIMANUK, MELAYA, JEMBRANA, BALI",21,151,38,189
https://kawalpemilu.org#53278,"GILIMANUK, MELAYA, JEMBRANA, BALI",22,174,33,207
https://kawalpemilu.org#53278,"GILIMANUK, MELAYA, JEMBRANA, BALI",23,192,36,228
https://kawalpemilu.org#53278,"GILIMANUK, MELAYA, JEMBRANA, BALI",24,110,28,138
https://kawalpemilu.org#53279,"MELAYA, MELAYA, JEMBRANA, BALI",1,206,29,235
https://kawalpemilu.org#53279,"MELAYA, MELAYA, JEMBRANA, BALI",2,210,25,235
https://kawalpemilu.org#53279,"MELAYA, MELAYA, JEMBRANA, BALI",3,172,53,225
https://kawalpemilu.org#53279,"MELAYA, MELAYA, JEMBRANA, BALI",4,179,56,235
https://kawalpemilu.org#53279,"MELAYA, MELAYA, JEMBRANA, BALI",5,197,30,227
https://kawalpemilu.org#53279,"MELAYA, MELAYA, JEMBRANA, BALI",6,228,1,229
https://kawalpemilu.org#53279,"MELAYA, MELAYA, JEMBRANA, BALI",7,208,29,237
https://kawalpemilu.org#53279,"MELAYA, MELAYA, JEMBRANA, BALI",8,135,64,199
https://kawalpemilu.org#53279,"MELAYA, MELAYA, JEMBRANA, BALI",9,138,77,215
https://kawalpemilu.org#53279,"MELAYA, MELAYA, JEMBRANA, BALI",10,125,71,196
https://kawalpemilu.org#53279,"MELAYA, MELAYA, JEMBRANA, BALI",11,151,58,209
https://kawalpemilu.org#53279,"MELAYA, MELAYA, JEMBRANA, BALI",12,164,39,203
https://kawalpemilu.org#53279,"MELAYA, MELAYA, JEMBRANA, BALI",13,193,23,216
https://kawalpemilu.org#53279,"MELAYA, MELAYA, JEMBRANA, BALI",14,216,12,228
https://kawalpemilu.org#53279,"MELAYA, MELAYA, JEMBRANA, BALI",15,206,14,220
https://kawalpemilu.org#53279,"MELAYA, MELAYA, JEMBRANA, BALI",16,196,35,231
https://kawalpemilu.org#53279,"MELAYA, MELAYA, JEMBRANA, BALI",17,184,32,216
https://kawalpemilu.org#53279,"MELAYA, MELAYA, JEMBRANA, BALI",18,188,31,219
https://kawalpemilu.org#53279,"MELAYA, MELAYA, JEMBRANA, BALI",19,181,36,217
https://kawalpemilu.org#53279,"MELAYA, MELAYA, JEMBRANA, BALI",20,185,28,213
https://kawalpemilu.org#53279,"MELAYA, MELAYA, JEMBRANA, BALI",21,175,25,200
https://kawalpemilu.org#53279,"MELAYA, MELAYA, JEMBRANA, BALI",22,201,30,231
https://kawalpemilu.org#53279,"MELAYA, MELAYA, JEMBRANA, BALI",23,173,34,207
https://kawalpemilu.org#53279,"MELAYA, MELAYA, JEMBRANA, BALI",24,109,86,195
https://kawalpemilu.org#53279,"MELAYA, MELAYA, JEMBRANA, BALI",25,153,71,6
https://kawalpemilu.org#53279,"MELAYA, MELAYA, JEMBRANA, BALI",26,150,72,222
https://kawalpemilu.org#53279,"MELAYA, MELAYA, JEMBRANA, BALI",27,112,86,198
https://kawalpemilu.org#53279,"MELAYA, MELAYA, JEMBRANA, BALI",28,207,17,224
https://kawalpemilu.org#53279,"MELAYA, MELAYA, JEMBRANA, BALI",29,222,19,241
https://kawalpemilu.org#53279,"MELAYA, MELAYA, JEMBRANA, BALI",30,202,15,217
https://kawalpemilu.org#53279,"MELAYA, MELAYA, JEMBRANA, BALI",31,206,16,222
https://kawalpemilu.org#53279,"MELAYA, MELAYA, JEMBRANA, BALI",32,219,16,235
https://kawalpemilu.org#53279,"MELAYA, MELAYA, JEMBRANA, BALI",33,77,28,105
https://kawalpemilu.org#53280,"BLIMBINGSARI, MELAYA, JEMBRANA, BALI",1,227,0,227
https://kawalpemilu.org#53280,"BLIMBINGSARI, MELAYA, JEMBRANA, BALI",2,221,3,224
https://kawalpemilu.org#53280,"BLIMBINGSARI, MELAYA, JEMBRANA, BALI",3,168,0,168
https://kawalpemilu.org#53281,"EKASARI, MELAYA, JEMBRANA, BALI",1,216,30,246
https://kawalpemilu.org#53281,"EKASARI, MELAYA, JEMBRANA, BALI",2,219,5,224
https://kawalpemilu.org#53281,"EKASARI, MELAYA, JEMBRANA, BALI",3,191,1,192
https://kawalpemilu.org#53281,"EKASARI, MELAYA, JEMBRANA, BALI",4,238,0,238
https://kawalpemilu.org#53281,"EKASARI, MELAYA, JEMBRANA, BALI",5,229,9,238
https://kawalpemilu.org#53281,"EKASARI, MELAYA, JEMBRANA, BALI",6,231,6,237
https://kawalpemilu.org#53281,"EKASARI, MELAYA, JEMBRANA, BALI",7,224,9,233
https://kawalpemilu.org#53281,"EKASARI, MELAYA, JEMBRANA, BALI",8,229,12,241
https://kawalpemilu.org#53281,"EKASARI, MELAYA, JEMBRANA, BALI",9,241,6,247
https://kawalpemilu.org#53281,"EKASARI, MELAYA, JEMBRANA, BALI",10,225,9,234
https://kawalpemilu.org#53281,"EKASARI, MELAYA, JEMBRANA, BALI",11,223,10,233
https://kawalpemilu.org#53281,"EKASARI, MELAYA, JEMBRANA, BALI",12,247,3,250
https://kawalpemilu.org#53281,"EKASARI, MELAYA, JEMBRANA, BALI",13,193,3,196
https://kawalpemilu.org#53282,"NUSASARI, MELAYA, JEMBRANA, BALI",1,214,9,223
https://kawalpemilu.org#53282,"NUSASARI, MELAYA, JEMBRANA, BALI",2,232,1,233
https://kawalpemilu.org#53282,"NUSASARI, MELAYA, JEMBRANA, BALI",3,215,10,225
https://kawalpemilu.org#53282,"NUSASARI, MELAYA, JEMBRANA, BALI",4,209,14,223
https://kawalpemilu.org#53282,"NUSASARI, MELAYA, JEMBRANA, BALI",5,207,14,221
https://kawalpemilu.org#53282,"NUSASARI, MELAYA, JEMBRANA, BALI",6,194,24,218
https://kawalpemilu.org#53282,"NUSASARI, MELAYA, JEMBRANA, BALI",7,246,1,247
https://kawalpemilu.org#53282,"NUSASARI, MELAYA, JEMBRANA, BALI",8,232,3,235
https://kawalpemilu.org#53282,"NUSASARI, MELAYA, JEMBRANA, BALI",9,249,1,250
https://kawalpemilu.org#53282,"NUSASARI, MELAYA, JEMBRANA, BALI",10,224,4,228
https://kawalpemilu.org#53283,"WARNASARI, MELAYA, JEMBRANA, BALI",1,226,17,243
https://kawalpemilu.org#53283,"WARNASARI, MELAYA, JEMBRANA, BALI",2,224,15,239
https://kawalpemilu.org#53283,"WARNASARI, MELAYA, JEMBRANA, BALI",3,186,31,217
https://kawalpemilu.org#53283,"WARNASARI, MELAYA, JEMBRANA, BALI",4,165,10,175
https://kawalpemilu.org#53283,"WARNASARI, MELAYA, JEMBRANA, BALI",5,121,0,121
https://kawalpemilu.org#53283,"WARNASARI, MELAYA, JEMBRANA, BALI",6,201,16,217
https://kawalpemilu.org#53283,"WARNASARI, MELAYA, JEMBRANA, BALI",7,203,20,223
https://kawalpemilu.org#53284,"CANDIKUSUMA, MELAYA, JEMBRANA, BALI",1,175,46,221
https://kawalpemilu.org#53284,"CANDIKUSUMA, MELAYA, JEMBRANA, BALI",2,127,74,201
https://kawalpemilu.org#53284,"CANDIKUSUMA, MELAYA, JEMBRANA, BALI",3,98,50,148
https://kawalpemilu.org#53284,"CANDIKUSUMA, MELAYA, JEMBRANA, BALI",4,113,79,192
https://kawalpemilu.org#53284,"CANDIKUSUMA, MELAYA, JEMBRANA, BALI",5,139,68,207
https://kawalpemilu.org#53284,"CANDIKUSUMA, MELAYA, JEMBRANA, BALI",6,130,100,230
https://kawalpemilu.org#53284,"CANDIKUSUMA, MELAYA, JEMBRANA, BALI",7,136,96,232
https://kawalpemilu.org#53284,"CANDIKUSUMA, MELAYA, JEMBRANA, BALI",8,175,22,197
https://kawalpemilu.org#53284,"CANDIKUSUMA, MELAYA, JEMBRANA, BALI",9,219,20,239
https://kawalpemilu.org#53284,"CANDIKUSUMA, MELAYA, JEMBRANA, BALI",11,217,15,232
https://kawalpemilu.org#53284,"CANDIKUSUMA, MELAYA, JEMBRANA, BALI",12,195,21,216
https://kawalpemilu.org#53284,"CANDIKUSUMA, MELAYA, JEMBRANA, BALI",14,196,21,217
https://kawalpemilu.org#53284,"CANDIKUSUMA, MELAYA, JEMBRANA, BALI",15,172,22,194
https://kawalpemilu.org#53285,"TUWED, MELAYA, JEMBRANA, BALI",1,241,13,254
https://kawalpemilu.org#53285,"TUWED, MELAYA, JEMBRANA, BALI",2,209,13,222
https://kawalpemilu.org#53285,"TUWED, MELAYA, JEMBRANA, BALI",3,193,55,248
https://kawalpemilu.org#53285,"TUWED, MELAYA, JEMBRANA, BALI",4,207,32,239
https://kawalpemilu.org#53285,"TUWED, MELAYA, JEMBRANA, BALI",5,213,36,249
https://kawalpemilu.org#53285,"TUWED, MELAYA, JEMBRANA, BALI",6,167,50,217
https://kawalpemilu.org#53285,"TUWED, MELAYA, JEMBRANA, BALI",7,150,66,216
https://kawalpemilu.org#53285,"TUWED, MELAYA, JEMBRANA, BALI",8,106,88,194
https://kawalpemilu.org#53285,"TUWED, MELAYA, JEMBRANA, BALI",9,134,42,176
https://kawalpemilu.org#53285,"TUWED, MELAYA, JEMBRANA, BALI",10,55,179,234
https://kawalpemilu.org#53285,"TUWED, MELAYA, JEMBRANA, BALI",11,63,188,251
https://kawalpemilu.org#53285,"TUWED, MELAYA, JEMBRANA, BALI",12,86,138,224
https://kawalpemilu.org#53285,"TUWED, MELAYA, JEMBRANA, BALI",13,127,93,220
https://kawalpemilu.org#53286,"TUKADAYA, MELAYA, JEMBRANA, BALI",1,96,119,215
https://kawalpemilu.org#53286,"TUKADAYA, MELAYA, JEMBRANA, BALI",2,217,24,241
https://kawalpemilu.org#53286,"TUKADAYA, MELAYA, JEMBRANA, BALI",3,171,29,200
https://kawalpemilu.org#53286,"TUKADAYA, MELAYA, JEMBRANA, BALI",4,211,36,247
https://kawalpemilu.org#53286,"TUKADAYA, MELAYA, JEMBRANA, BALI",5,219,17,236
https://kawalpemilu.org#53286,"TUKADAYA, MELAYA, JEMBRANA, BALI",6,217,32,249
https://kawalpemilu.org#53286,"TUKADAYA, MELAYA, JEMBRANA, BALI",7,185,41,226
https://kawalpemilu.org#53286,"TUKADAYA, MELAYA, JEMBRANA, BALI",8,190,19,209
https://kawalpemilu.org#53286,"TUKADAYA, MELAYA, JEMBRANA, BALI",9,249,3,252
https://kawalpemilu.org#53286,"TUKADAYA, MELAYA, JEMBRANA, BALI",10,225,18,243
https://kawalpemilu.org#53286,"TUKADAYA, MELAYA, JEMBRANA, BALI",11,222,15,237
https://kawalpemilu.org#53286,"TUKADAYA, MELAYA, JEMBRANA, BALI",12,217,25,242
https://kawalpemilu.org#53286,"TUKADAYA, MELAYA, JEMBRANA, BALI",13,219,25,244
https://kawalpemilu.org#53286,"TUKADAYA, MELAYA, JEMBRANA, BALI",14,209,13,222
https://kawalpemilu.org#53286,"TUKADAYA, MELAYA, JEMBRANA, BALI",15,236,11,247
https://kawalpemilu.org#53286,"TUKADAYA, MELAYA, JEMBRANA, BALI",16,228,3,231
https://kawalpemilu.org#53286,"TUKADAYA, MELAYA, JEMBRANA, BALI",17,187,21,208
https://kawalpemilu.org#53286,"TUKADAYA, MELAYA, JEMBRANA, BALI",18,230,10,240
https://kawalpemilu.org#53286,"TUKADAYA, MELAYA, JEMBRANA, BALI",19,240,14,254
https://kawalpemilu.org#53287,"MANISTUTU, MELAYA, JEMBRANA, BALI",2,193,50,243
https://kawalpemilu.org#53287,"MANISTUTU, MELAYA, JEMBRANA, BALI",3,209,31,240
https://kawalpemilu.org#53287,"MANISTUTU, MELAYA, JEMBRANA, BALI",4,240,16,256
https://kawalpemilu.org#53287,"MANISTUTU, MELAYA, JEMBRANA, BALI",5,227,26,253
https://kawalpemilu.org#53287,"MANISTUTU, MELAYA, JEMBRANA, BALI",6,201,55,256
https://kawalpemilu.org#53287,"MANISTUTU, MELAYA, JEMBRANA, BALI",7,242,18,260
https://kawalpemilu.org#53287,"MANISTUTU, MELAYA, JEMBRANA, BALI",8,216,44,260
https://kawalpemilu.org#53287,"MANISTUTU, MELAYA, JEMBRANA, BALI",9,201,23,224
https://kawalpemilu.org#53287,"MANISTUTU, MELAYA, JEMBRANA, BALI",10,214,31,245
https://kawalpemilu.org#53287,"MANISTUTU, MELAYA, JEMBRANA, BALI",11,154,65,219
https://kawalpemilu.org#53287,"MANISTUTU, MELAYA, JEMBRANA, BALI",12,177,44,221
https://kawalpemilu.org#53287,"MANISTUTU, MELAYA, JEMBRANA, BALI",13,160,40,200
https://kawalpemilu.org#53287,"MANISTUTU, MELAYA, JEMBRANA, BALI",14,190,45,235
https://kawalpemilu.org#53287,"MANISTUTU, MELAYA, JEMBRANA, BALI",15,195,45,240
https://kawalpemilu.org#53287,"MANISTUTU, MELAYA, JEMBRANA, BALI",16,215,18,233
https://kawalpemilu.org#53287,"MANISTUTU, MELAYA, JEMBRANA, BALI",17,228,21,249
https://kawalpemilu.org#53287,"MANISTUTU, MELAYA, JEMBRANA, BALI",18,212,26,238
https://kawalpemilu.org#53287,"MANISTUTU, MELAYA, JEMBRANA, BALI",19,213,21,234
https://kawalpemilu.org#53287,"MANISTUTU, MELAYA, JEMBRANA, BALI",20,234,32,266
https://kawalpemilu.org#53287,"MANISTUTU, MELAYA, JEMBRANA, BALI",21,233,32,265
https://kawalpemilu.org#53287,"MANISTUTU, MELAYA, JEMBRANA, BALI",22,69,6,75
https://kawalpemilu.org#53289,"PENDEM, JEMBRANA, JEMBRANA, BALI",1,190,17,207
https://kawalpemilu.org#53289,"PENDEM, JEMBRANA, JEMBRANA, BALI",2,140,44,184
https://kawalpemilu.org#53289,"PENDEM, JEMBRANA, JEMBRANA, BALI",3,124,27,151
https://kawalpemilu.org#53289,"PENDEM, JEMBRANA, JEMBRANA, BALI",4,171,8,179
https://kawalpemilu.org#53289,"PENDEM, JEMBRANA, JEMBRANA, BALI",5,160,22,182
https://kawalpemilu.org#53289,"PENDEM, JEMBRANA, JEMBRANA, BALI",6,161,32,193
https://kawalpemilu.org#53289,"PENDEM, JEMBRANA, JEMBRANA, BALI",7,153,26,179
https://kawalpemilu.org#53289,"PENDEM, JEMBRANA, JEMBRANA, BALI",8,170,16,186
https://kawalpemilu.org#53289,"PENDEM, JEMBRANA, JEMBRANA, BALI",9,126,79,205
https://kawalpemilu.org#53289,"PENDEM, JEMBRANA, JEMBRANA, BALI",10,170,15,185
https://kawalpemilu.org#53289,"PENDEM, JEMBRANA, JEMBRANA, BALI",11,178,7,185
https://kawalpemilu.org#53289,"PENDEM, JEMBRANA, JEMBRANA, BALI",12,174,25,199
https://kawalpemilu.org#53289,"PENDEM, JEMBRANA, JEMBRANA, BALI",13,159,18,177
https://kawalpemilu.org#53289,"PENDEM, JEMBRANA, JEMBRANA, BALI",14,175,19,194
https://kawalpemilu.org#53289,"PENDEM, JEMBRANA, JEMBRANA, BALI",15,151,19,170
https://kawalpemilu.org#53289,"PENDEM, JEMBRANA, JEMBRANA, BALI",16,172,16,188
https://kawalpemilu.org#53289,"PENDEM, JEMBRANA, JEMBRANA, BALI",17,169,59,227
https://kawalpemilu.org#53289,"PENDEM, JEMBRANA, JEMBRANA, BALI",18,229,19,248
https://kawalpemilu.org#53289,"PENDEM, JEMBRANA, JEMBRANA, BALI",19,164,16,180
https://kawalpemilu.org#53289,"PENDEM, JEMBRANA, JEMBRANA, BALI",20,135,22,157
https://kawalpemilu.org#53289,"PENDEM, JEMBRANA, JEMBRANA, BALI",21,163,24,187
https://kawalpemilu.org#53289,"PENDEM, JEMBRANA, JEMBRANA, BALI",22,206,27,233
https://kawalpemilu.org#53289,"PENDEM, JEMBRANA, JEMBRANA, BALI",23,170,22,192
https://kawalpemilu.org#53289,"PENDEM, JEMBRANA, JEMBRANA, BALI",24,183,10,193
https://kawalpemilu.org#53289,"PENDEM, JEMBRANA, JEMBRANA, BALI",25,202,28,230
https://kawalpemilu.org#53289,"PENDEM, JEMBRANA, JEMBRANA, BALI",26,170,46,216
https://kawalpemilu.org#53289,"PENDEM, JEMBRANA, JEMBRANA, BALI",27,154,3,157
https://kawalpemilu.org#53289,"PENDEM, JEMBRANA, JEMBRANA, BALI",28,175,6,181
https://kawalpemilu.org#53289,"PENDEM, JEMBRANA, JEMBRANA, BALI",29,211,26,237
https://kawalpemilu.org#53289,"PENDEM, JEMBRANA, JEMBRANA, BALI",30,159,25,184
https://kawalpemilu.org#53289,"PENDEM, JEMBRANA, JEMBRANA, BALI",31,231,14,245
https://kawalpemilu.org#53289,"PENDEM, JEMBRANA, JEMBRANA, BALI",32,210,13,223
https://kawalpemilu.org#53289,"PENDEM, JEMBRANA, JEMBRANA, BALI",33,172,33,205
https://kawalpemilu.org#53289,"PENDEM, JEMBRANA, JEMBRANA, BALI",34,167,30,197
https://kawalpemilu.org#53289,"PENDEM, JEMBRANA, JEMBRANA, BALI",35,140,36,176
https://kawalpemilu.org#53290,"LOLOAN TIMUR, JEMBRANA, JEMBRANA, BALI",1,138,82,220
https://kawalpemilu.org#53290,"LOLOAN TIMUR, JEMBRANA, JEMBRANA, BALI",2,132,80,212
https://kawalpemilu.org#53290,"LOLOAN TIMUR, JEMBRANA, JEMBRANA, BALI",3,114,115,229
https://kawalpemilu.org#53290,"LOLOAN TIMUR, JEMBRANA, JEMBRANA, BALI",4,91,67,158
https://kawalpemilu.org#53290,"LOLOAN TIMUR, JEMBRANA, JEMBRANA, BALI",6,117,104,221
https://kawalpemilu.org#53290,"LOLOAN TIMUR, JEMBRANA, JEMBRANA, BALI",7,142,82,224
https://kawalpemilu.org#53290,"LOLOAN TIMUR, JEMBRANA, JEMBRANA, BALI",8,126,107,233
https://kawalpemilu.org#53290,"LOLOAN TIMUR, JEMBRANA, JEMBRANA, BALI",9,86,150,236
https://kawalpemilu.org#53290,"LOLOAN TIMUR, JEMBRANA, JEMBRANA, BALI",10,99,129,228
https://kawalpemilu.org#53290,"LOLOAN TIMUR, JEMBRANA, JEMBRANA, BALI",11,90,126,216
https://kawalpemilu.org#53290,"LOLOAN TIMUR, JEMBRANA, JEMBRANA, BALI",12,66,160,226
https://kawalpemilu.org#53290,"LOLOAN TIMUR, JEMBRANA, JEMBRANA, BALI",13,60,183,243
https://kawalpemilu.org#53290,"LOLOAN TIMUR, JEMBRANA, JEMBRANA, BALI",15,210,24,234
https://kawalpemilu.org#53290,"LOLOAN TIMUR, JEMBRANA, JEMBRANA, BALI",16,129,95,224
https://kawalpemilu.org#53290,"LOLOAN TIMUR, JEMBRANA, JEMBRANA, BALI",17,162,24,186
https://kawalpemilu.org#53290,"LOLOAN TIMUR, JEMBRANA, JEMBRANA, BALI",19,139,89,228
https://kawalpemilu.org#53291,"DAUHWARU, JEMBRANA, JEMBRANA, BALI",1,211,8,219
https://kawalpemilu.org#53291,"DAUHWARU, JEMBRANA, JEMBRANA, BALI",2,242,2,244
https://kawalpemilu.org#53291,"DAUHWARU, JEMBRANA, JEMBRANA, BALI",3,209,20,229
https://kawalpemilu.org#53291,"DAUHWARU, JEMBRANA, JEMBRANA, BALI",4,207,10,217
https://kawalpemilu.org#53291,"DAUHWARU, JEMBRANA, JEMBRANA, BALI",5,206,20,226
https://kawalpemilu.org#53291,"DAUHWARU, JEMBRANA, JEMBRANA, BALI",6,174,5,179
https://kawalpemilu.org#53291,"DAUHWARU, JEMBRANA, JEMBRANA, BALI",7,177,9,186
https://kawalpemilu.org#53291,"DAUHWARU, JEMBRANA, JEMBRANA, BALI",8,175,10,185
https://kawalpemilu.org#53291,"DAUHWARU, JEMBRANA, JEMBRANA, BALI",9,189,13,202
https://kawalpemilu.org#53291,"DAUHWARU, JEMBRANA, JEMBRANA, BALI",10,188,4,192
https://kawalpemilu.org#53291,"DAUHWARU, JEMBRANA, JEMBRANA, BALI",11,189,10,199
https://kawalpemilu.org#53291,"DAUHWARU, JEMBRANA, JEMBRANA, BALI",12,177,20,197
https://kawalpemilu.org#53291,"DAUHWARU, JEMBRANA, JEMBRANA, BALI",13,194,13,207
https://kawalpemilu.org#53291,"DAUHWARU, JEMBRANA, JEMBRANA, BALI",14,178,16,194
https://kawalpemilu.org#53291,"DAUHWARU, JEMBRANA, JEMBRANA, BALI",15,191,10,201
https://kawalpemilu.org#53291,"DAUHWARU, JEMBRANA, JEMBRANA, BALI",16,180,7,187
https://kawalpemilu.org#53291,"DAUHWARU, JEMBRANA, JEMBRANA, BALI",17,204,11,215
https://kawalpemilu.org#53291,"DAUHWARU, JEMBRANA, JEMBRANA, BALI",18,197,11,208
https://kawalpemilu.org#53291,"DAUHWARU, JEMBRANA, JEMBRANA, BALI",19,209,18,227
https://kawalpemilu.org#53291,"DAUHWARU, JEMBRANA, JEMBRANA, BALI",20,185,8,193
https://kawalpemilu.org#53291,"DAUHWARU, JEMBRANA, JEMBRANA, BALI",21,171,8,181
https://kawalpemilu.org#53291,"DAUHWARU, JEMBRANA, JEMBRANA, BALI",22,179,19,198
https://kawalpemilu.org#53291,"DAUHWARU, JEMBRANA, JEMBRANA, BALI",23,174,33,207
https://kawalpemilu.org#53291,"DAUHWARU, JEMBRANA, JEMBRANA, BALI",24,146,20,166
https://kawalpemilu.org#53291,"DAUHWARU, JEMBRANA, JEMBRANA, BALI",25,167,44,211
https://kawalpemilu.org#53291,"DAUHWARU, JEMBRANA, JEMBRANA, BALI",26,161,36,197
https://kawalpemilu.org#53291,"DAUHWARU, JEMBRANA, JEMBRANA, BALI",27,158,32,190
https://kawalpemilu.org#53291,"DAUHWARU, JEMBRANA, JEMBRANA, BALI",28,185,14,199
https://kawalpemilu.org#53291,"DAUHWARU, JEMBRANA, JEMBRANA, BALI",30,173,20,193
https://kawalpemilu.org#53292,"SANGKARAGUNG, JEMBRANA, JEMBRANA, BALI",1,196,20,216
https://kawalpemilu.org#53292,"SANGKARAGUNG, JEMBRANA, JEMBRANA, BALI",2,196,25,221
https://kawalpemilu.org#53292,"SANGKARAGUNG, JEMBRANA, JEMBRANA, BALI",3,204,18,222
https://kawalpemilu.org#53292,"SANGKARAGUNG, JEMBRANA, JEMBRANA, BALI",4,190,31,221
https://kawalpemilu.org#53292,"SANGKARAGUNG, JEMBRANA, JEMBRANA, BALI",5,218,7,225
https://kawalpemilu.org#53292,"SANGKARAGUNG, JEMBRANA, JEMBRANA, BALI",6,213,21,234
https://kawalpemilu.org#53292,"SANGKARAGUNG, JEMBRANA, JEMBRANA, BALI",7,196,21,217
https://kawalpemilu.org#53292,"SANGKARAGUNG, JEMBRANA, JEMBRANA, BALI",8,172,18,190
https://kawalpemilu.org#53292,"SANGKARAGUNG, JEMBRANA, JEMBRANA, BALI",9,194,13,207
https://kawalpemilu.org#53292,"SANGKARAGUNG, JEMBRANA, JEMBRANA, BALI",10,186,17,203
https://kawalpemilu.org#53293,"PERANCAK, JEMBRANA, JEMBRANA, BALI",1,211,14,225
https://kawalpemilu.org#53293,"PERANCAK, JEMBRANA, JEMBRANA, BALI",2,208,13,221
https://kawalpemilu.org#53293,"PERANCAK, JEMBRANA, JEMBRANA, BALI",3,208,15,223
https://kawalpemilu.org#53293,"PERANCAK, JEMBRANA, JEMBRANA, BALI",4,219,25,244
https://kawalpemilu.org#53293,"PERANCAK, JEMBRANA, JEMBRANA, BALI",5,225,5,230
https://kawalpemilu.org#53293,"PERANCAK, JEMBRANA, JEMBRANA, BALI",6,242,8,250
https://kawalpemilu.org#53293,"PERANCAK, JEMBRANA, JEMBRANA, BALI",7,209,4,213
https://kawalpemilu.org#53293,"PERANCAK, JEMBRANA, JEMBRANA, BALI",8,242,9,251
https://kawalpemilu.org#53293,"PERANCAK, JEMBRANA, JEMBRANA, BALI",9,202,20,222
https://kawalpemilu.org#53293,"PERANCAK, JEMBRANA, JEMBRANA, BALI",10,230,16,246
https://kawalpemilu.org#53293,"PERANCAK, JEMBRANA, JEMBRANA, BALI",11,205,18,223
https://kawalpemilu.org#53294,"BATUAGUNG, JEMBRANA, JEMBRANA, BALI",1,205,13,218
https://kawalpemilu.org#53294,"BATUAGUNG, JEMBRANA, JEMBRANA, BALI",2,187,14,201
https://kawalpemilu.org#53294,"BATUAGUNG, JEMBRANA, JEMBRANA, BALI",3,189,5,194
https://kawalpemilu.org#53294,"BATUAGUNG, JEMBRANA, JEMBRANA, BALI",4,205,9,214
https://kawalpemilu.org#53294,"BATUAGUNG, JEMBRANA, JEMBRANA, BALI",5,213,7,220
https://kawalpemilu.org#53294,"BATUAGUNG, JEMBRANA, JEMBRANA, BALI",6,199,12,211
https://kawalpemilu.org#53294,"BATUAGUNG, JEMBRANA, JEMBRANA, BALI",7,207,13,220
https://kawalpemilu.org#53294,"BATUAGUNG, JEMBRANA, JEMBRANA, BALI",8,232,6,238
https://kawalpemilu.org#53294,"BATUAGUNG, JEMBRANA, JEMBRANA, BALI",9,232,11,243
https://kawalpemilu.org#53294,"BATUAGUNG, JEMBRANA, JEMBRANA, BALI",10,227,12,239
https://kawalpemilu.org#53294,"BATUAGUNG, JEMBRANA, JEMBRANA, BALI",11,226,4,230
https://kawalpemilu.org#53294,"BATUAGUNG, JEMBRANA, JEMBRANA, BALI",12,215,10,225
https://kawalpemilu.org#53294,"BATUAGUNG, JEMBRANA, JEMBRANA, BALI",13,220,14,234
https://kawalpemilu.org#53294,"BATUAGUNG, JEMBRANA, JEMBRANA, BALI",14,204,5,209
https://kawalpemilu.org#53294,"BATUAGUNG, JEMBRANA, JEMBRANA, BALI",15,223,8,231
https://kawalpemilu.org#53294,"BATUAGUNG, JEMBRANA, JEMBRANA, BALI",16,211,25,236
https://kawalpemilu.org#53294,"BATUAGUNG, JEMBRANA, JEMBRANA, BALI",17,214,22,236
https://kawalpemilu.org#53294,"BATUAGUNG, JEMBRANA, JEMBRANA, BALI",18,222,12,234
https://kawalpemilu.org#53294,"BATUAGUNG, JEMBRANA, JEMBRANA, BALI",19,199,9,208
https://kawalpemilu.org#53294,"BATUAGUNG, JEMBRANA, JEMBRANA, BALI",20,199,20,219
https://kawalpemilu.org#53294,"BATUAGUNG, JEMBRANA, JEMBRANA, BALI",21,209,14,223
https://kawalpemilu.org#53294,"BATUAGUNG, JEMBRANA, JEMBRANA, BALI",22,224,21,245
https://kawalpemilu.org#53294,"BATUAGUNG, JEMBRANA, JEMBRANA, BALI",23,190,50,240
https://kawalpemilu.org#53294,"BATUAGUNG, JEMBRANA, JEMBRANA, BALI",24,216,34,250
https://kawalpemilu.org#53294,"BATUAGUNG, JEMBRANA, JEMBRANA, BALI",25,211,30,241
https://kawalpemilu.org#53295,"BUDENG, JEMBRANA, JEMBRANA, BALI",1,204,10,214
https://kawalpemilu.org#53295,"BUDENG, JEMBRANA, JEMBRANA, BALI",2,192,29,221
https://kawalpemilu.org#53295,"BUDENG, JEMBRANA, JEMBRANA, BALI",3,229,12,241
https://kawalpemilu.org#53295,"BUDENG, JEMBRANA, JEMBRANA, BALI",4,208,22,230
https://kawalpemilu.org#53295,"BUDENG, JEMBRANA, JEMBRANA, BALI",5,198,18,216
https://kawalpemilu.org#53296,"AIRKUNING, JEMBRANA, JEMBRANA, BALI",1,82,158,240
https://kawalpemilu.org#53296,"AIRKUNING, JEMBRANA, JEMBRANA, BALI",2,105,134,239
https://kawalpemilu.org#53296,"AIRKUNING, JEMBRANA, JEMBRANA, BALI",3,70,131,201
https://kawalpemilu.org#53296,"AIRKUNING, JEMBRANA, JEMBRANA, BALI",4,104,80,184
https://kawalpemilu.org#53296,"AIRKUNING, JEMBRANA, JEMBRANA, BALI",5,61,182,243
https://kawalpemilu.org#53296,"AIRKUNING, JEMBRANA, JEMBRANA, BALI",6,45,197,242
https://kawalpemilu.org#53296,"AIRKUNING, JEMBRANA, JEMBRANA, BALI",7,80,162,242
https://kawalpemilu.org#53296,"AIRKUNING, JEMBRANA, JEMBRANA, BALI",8,0,0,0
https://kawalpemilu.org#53296,"AIRKUNING, JEMBRANA, JEMBRANA, BALI",9,72,150,222
https://kawalpemilu.org#53296,"AIRKUNING, JEMBRANA, JEMBRANA, BALI",10,55,153,208
https://kawalpemilu.org#53296,"AIRKUNING, JEMBRANA, JEMBRANA, BALI",11,39,196,235
https://kawalpemilu.org#53296,"AIRKUNING, JEMBRANA, JEMBRANA, BALI",12,48,171,219
https://kawalpemilu.org#53296,"AIRKUNING, JEMBRANA, JEMBRANA, BALI",13,85,144,229
https://kawalpemilu.org#53297,"YEHKUNING, JEMBRANA, JEMBRANA, BALI",1,199,33,232
https://kawalpemilu.org#53297,"YEHKUNING, JEMBRANA, JEMBRANA, BALI",2,162,41,203
https://kawalpemilu.org#53297,"YEHKUNING, JEMBRANA, JEMBRANA, BALI",3,191,18,209
https://kawalpemilu.org#53297,"YEHKUNING, JEMBRANA, JEMBRANA, BALI",4,200,7,207
https://kawalpemilu.org#53297,"YEHKUNING, JEMBRANA, JEMBRANA, BALI",5,170,22,192
https://kawalpemilu.org#53297,"YEHKUNING, JEMBRANA, JEMBRANA, BALI",6,171,5,176
https://kawalpemilu.org#53297,"YEHKUNING, JEMBRANA, JEMBRANA, BALI",7,177,8,185
https://kawalpemilu.org#53297,"YEHKUNING, JEMBRANA, JEMBRANA, BALI",8,212,3,215
https://kawalpemilu.org#53297,"YEHKUNING, JEMBRANA, JEMBRANA, BALI",9,183,5,188
https://kawalpemilu.org#53298,"DANGINTUKADAYA, JEMBRANA, JEMBRANA, BALI",1,186,16,202
https://kawalpemilu.org#53298,"DANGINTUKADAYA, JEMBRANA, JEMBRANA, BALI",2,202,11,213
https://kawalpemilu.org#53298,"DANGINTUKADAYA, JEMBRANA, JEMBRANA, BALI",3,171,22,193
https://kawalpemilu.org#53298,"DANGINTUKADAYA, JEMBRANA, JEMBRANA, BALI",4,181,22,203
https://kawalpemilu.org#53298,"DANGINTUKADAYA, JEMBRANA, JEMBRANA, BALI",5,128,6,134
https://kawalpemilu.org#53298,"DANGINTUKADAYA, JEMBRANA, JEMBRANA, BALI",6,233,12,245
https://kawalpemilu.org#53298,"DANGINTUKADAYA, JEMBRANA, JEMBRANA, BALI",8,187,12,199
https://kawalpemilu.org#53298,"DANGINTUKADAYA, JEMBRANA, JEMBRANA, BALI",10,161,11,172
https://kawalpemilu.org#53298,"DANGINTUKADAYA, JEMBRANA, JEMBRANA, BALI",11,227,19,246
https://kawalpemilu.org#53298,"DANGINTUKADAYA, JEMBRANA, JEMBRANA, BALI",12,192,4,196
https://kawalpemilu.org#53298,"DANGINTUKADAYA, JEMBRANA, JEMBRANA, BALI",13,204,1,205
https://kawalpemilu.org#53298,"DANGINTUKADAYA, JEMBRANA, JEMBRANA, BALI",14,193,15,208
https://kawalpemilu.org#53298,"DANGINTUKADAYA, JEMBRANA, JEMBRANA, BALI",15,233,23,256
https://kawalpemilu.org#53298,"DANGINTUKADAYA, JEMBRANA, JEMBRANA, BALI",16,135,7,142
https://kawalpemilu.org#53298,"DANGINTUKADAYA, JEMBRANA, JEMBRANA, BALI",17,151,4,155
https://kawalpemilu.org#53301,"BAJERA, SELEMADEG, TABANAN, BALI",1,256,12,268
https://kawalpemilu.org#53301,"BAJERA, SELEMADEG, TABANAN, BALI",2,233,3,236
https://kawalpemilu.org#53301,"BAJERA, SELEMADEG, TABANAN, BALI",3,185,5,190
https://kawalpemilu.org#53301,"BAJERA, SELEMADEG, TABANAN, BALI",4,183,12,195
https://kawalpemilu.org#53301,"BAJERA, SELEMADEG, TABANAN, BALI",5,181,6,187
https://kawalpemilu.org#53301,"BAJERA, SELEMADEG, TABANAN, BALI",6,181,20,201
https://kawalpemilu.org#53301,"BAJERA, SELEMADEG, TABANAN, BALI",7,214,3,217
https://kawalpemilu.org#53301,"BAJERA, SELEMADEG, TABANAN, BALI",8,192,12,204
https://kawalpemilu.org#53301,"BAJERA, SELEMADEG, TABANAN, BALI",9,231,7,238
https://kawalpemilu.org#53301,"BAJERA, SELEMADEG, TABANAN, BALI",10,190,5,195
https://kawalpemilu.org#53301,"BAJERA, SELEMADEG, TABANAN, BALI",11,263,4,267
https://kawalpemilu.org#53301,"BAJERA, SELEMADEG, TABANAN, BALI",12,247,11,258
https://kawalpemilu.org#53301,"BAJERA, SELEMADEG, TABANAN, BALI",13,218,37,255
https://kawalpemilu.org#53301,"BAJERA, SELEMADEG, TABANAN, BALI",14,215,21,236
https://kawalpemilu.org#53302,"WANAGIRI, SELEMADEG, TABANAN, BALI",1,207,26,233
https://kawalpemilu.org#53302,"WANAGIRI, SELEMADEG, TABANAN, BALI",2,187,25,212
https://kawalpemilu.org#53302,"WANAGIRI, SELEMADEG, TABANAN, BALI",3,238,3,241
https://kawalpemilu.org#53302,"WANAGIRI, SELEMADEG, TABANAN, BALI",4,206,11,217
https://kawalpemilu.org#53302,"WANAGIRI, SELEMADEG, TABANAN, BALI",5,208,13,221
https://kawalpemilu.org#53302,"WANAGIRI, SELEMADEG, TABANAN, BALI",6,197,3,200
https://kawalpemilu.org#53302,"WANAGIRI, SELEMADEG, TABANAN, BALI",7,218,4,222
https://kawalpemilu.org#53302,"WANAGIRI, SELEMADEG, TABANAN, BALI",8,131,18,149
https://kawalpemilu.org#53303,"PUPUAN SAWAH, SELEMADEG, TABANAN, BALI",1,263,19,282
https://kawalpemilu.org#53303,"PUPUAN SAWAH, SELEMADEG, TABANAN, BALI",2,284,8,292
https://kawalpemilu.org#53303,"PUPUAN SAWAH, SELEMADEG, TABANAN, BALI",3,224,0,224
https://kawalpemilu.org#53304,"BEREMBENG, SELEMADEG, TABANAN, BALI",1,160,9,169
https://kawalpemilu.org#53304,"BEREMBENG, SELEMADEG, TABANAN, BALI",2,171,9,180
https://kawalpemilu.org#53304,"BEREMBENG, SELEMADEG, TABANAN, BALI",3,248,6,254
https://kawalpemilu.org#53304,"BEREMBENG, SELEMADEG, TABANAN, BALI",4,180,4,184
https://kawalpemilu.org#53304,"BEREMBENG, SELEMADEG, TABANAN, BALI",5,229,18,247
https://kawalpemilu.org#53304,"BEREMBENG, SELEMADEG, TABANAN, BALI",6,176,22,198
https://kawalpemilu.org#53304,"BEREMBENG, SELEMADEG, TABANAN, BALI",7,185,2,187
https://kawalpemilu.org#53304,"BEREMBENG, SELEMADEG, TABANAN, BALI",8,170,1,171
https://kawalpemilu.org#53304,"BEREMBENG, SELEMADEG, TABANAN, BALI",9,155,6,161
https://kawalpemilu.org#53305,"SELEMADEG, SELEMADEG, TABANAN, BALI",1,199,4,203
https://kawalpemilu.org#53305,"SELEMADEG, SELEMADEG, TABANAN, BALI",2,198,3,201
https://kawalpemilu.org#53305,"SELEMADEG, SELEMADEG, TABANAN, BALI",3,196,3,199
https://kawalpemilu.org#53305,"SELEMADEG, SELEMADEG, TABANAN, BALI",4,192,1,193
https://kawalpemilu.org#53305,"SELEMADEG, SELEMADEG, TABANAN, BALI",5,247,6,253
https://kawalpemilu.org#53305,"SELEMADEG, SELEMADEG, TABANAN, BALI",6,163,0,163
https://kawalpemilu.org#53305,"SELEMADEG, SELEMADEG, TABANAN, BALI",7,155,3,158
https://kawalpemilu.org#53305,"SELEMADEG, SELEMADEG, TABANAN, BALI",8,184,0,184
https://kawalpemilu.org#53305,"SELEMADEG, SELEMADEG, TABANAN, BALI",9,182,0,182
https://kawalpemilu.org#53305,"SELEMADEG, SELEMADEG, TABANAN, BALI",10,137,0,137
https://kawalpemilu.org#53305,"SELEMADEG, SELEMADEG, TABANAN, BALI",11,162,0,162
https://kawalpemilu.org#53306,"SERAMPINGAN, SELEMADEG, TABANAN, BALI",1,217,4,221
https://kawalpemilu.org#53306,"SERAMPINGAN, SELEMADEG, TABANAN, BALI",2,260,4,264
https://kawalpemilu.org#53306,"SERAMPINGAN, SELEMADEG, TABANAN, BALI",3,161,1,162
https://kawalpemilu.org#53306,"SERAMPINGAN, SELEMADEG, TABANAN, BALI",4,143,0,143
https://kawalpemilu.org#53306,"SERAMPINGAN, SELEMADEG, TABANAN, BALI",5,182,5,187
https://kawalpemilu.org#53306,"SERAMPINGAN, SELEMADEG, TABANAN, BALI",6,164,61,225
https://kawalpemilu.org#53307,"ANTAP, SELEMADEG, TABANAN, BALI",1,256,9,265
https://kawalpemilu.org#53307,"ANTAP, SELEMADEG, TABANAN, BALI",2,253,7,260
https://kawalpemilu.org#53307,"ANTAP, SELEMADEG, TABANAN, BALI",3,202,40,242
https://kawalpemilu.org#53307,"ANTAP, SELEMADEG, TABANAN, BALI",4,226,26,252
https://kawalpemilu.org#53307,"ANTAP, SELEMADEG, TABANAN, BALI",5,255,2,257
https://kawalpemilu.org#53307,"ANTAP, SELEMADEG, TABANAN, BALI",6,211,5,216
https://kawalpemilu.org#53307,"ANTAP, SELEMADEG, TABANAN, BALI",7,199,2,201
https://kawalpemilu.org#53307,"ANTAP, SELEMADEG, TABANAN, BALI",8,179,6,185
https://kawalpemilu.org#53307,"ANTAP, SELEMADEG, TABANAN, BALI",9,191,8,199
https://kawalpemilu.org#53308,"WANAGIRI KAUH, SELEMADEG, TABANAN, BALI",1,181,21,202
https://kawalpemilu.org#53308,"WANAGIRI KAUH, SELEMADEG, TABANAN, BALI",2,191,9,200
https://kawalpemilu.org#53308,"WANAGIRI KAUH, SELEMADEG, TABANAN, BALI",3,231,3,234
https://kawalpemilu.org#53308,"WANAGIRI KAUH, SELEMADEG, TABANAN, BALI",4,177,3,180
https://kawalpemilu.org#53308,"WANAGIRI KAUH, SELEMADEG, TABANAN, BALI",5,171,5,176
https://kawalpemilu.org#53308,"WANAGIRI KAUH, SELEMADEG, TABANAN, BALI",6,223,15,238
https://kawalpemilu.org#53308,"WANAGIRI KAUH, SELEMADEG, TABANAN, BALI",7,245,1,246
https://kawalpemilu.org#53308,"WANAGIRI KAUH, SELEMADEG, TABANAN, BALI",8,131,2,133
https://kawalpemilu.org#53309,"MANIKYANG, SELEMADEG, TABANAN, BALI",1,286,2,288
https://kawalpemilu.org#53309,"MANIKYANG, SELEMADEG, TABANAN, BALI",2,220,2,222
https://kawalpemilu.org#53309,"MANIKYANG, SELEMADEG, TABANAN, BALI",3,256,8,264
https://kawalpemilu.org#53310,"BAJERA UTARA, SELEMADEG, TABANAN, BALI",1,239,1,240
https://kawalpemilu.org#53310,"BAJERA UTARA, SELEMADEG, TABANAN, BALI",2,199,6,205
https://kawalpemilu.org#53310,"BAJERA UTARA, SELEMADEG, TABANAN, BALI",3,241,4,245
https://kawalpemilu.org#53310,"BAJERA UTARA, SELEMADEG, TABANAN, BALI",4,195,0,195
https://kawalpemilu.org#53312,"GUNUNG SALAK, SELEMADEG TIMUR, TABANAN, BALI",1,164,7,171
https://kawalpemilu.org#53312,"GUNUNG SALAK, SELEMADEG TIMUR, TABANAN, BALI",2,168,2,170
https://kawalpemilu.org#53312,"GUNUNG SALAK, SELEMADEG TIMUR, TABANAN, BALI",3,96,36,132
https://kawalpemilu.org#53312,"GUNUNG SALAK, SELEMADEG TIMUR, TABANAN, BALI",4,114,21,135
https://kawalpemilu.org#53312,"GUNUNG SALAK, SELEMADEG TIMUR, TABANAN, BALI",5,129,17,146
https://kawalpemilu.org#53312,"GUNUNG SALAK, SELEMADEG TIMUR, TABANAN, BALI",6,117,4,121
https://kawalpemilu.org#53312,"GUNUNG SALAK, SELEMADEG TIMUR, TABANAN, BALI",7,126,7,133
https://kawalpemilu.org#53312,"GUNUNG SALAK, SELEMADEG TIMUR, TABANAN, BALI",8,175,8,183
https://kawalpemilu.org#53313,"GADUNGAN, SELEMADEG TIMUR, TABANAN, BALI",1,191,6,197
https://kawalpemilu.org#53313,"GADUNGAN, SELEMADEG TIMUR, TABANAN, BALI",2,217,1,218
https://kawalpemilu.org#53313,"GADUNGAN, SELEMADEG TIMUR, TABANAN, BALI",3,176,7,183
https://kawalpemilu.org#53313,"GADUNGAN, SELEMADEG TIMUR, TABANAN, BALI",4,142,1,143
https://kawalpemilu.org#53313,"GADUNGAN, SELEMADEG TIMUR, TABANAN, BALI",5,123,4,127
https://kawalpemilu.org#53313,"GADUNGAN, SELEMADEG TIMUR, TABANAN, BALI",6,195,9,204
https://kawalpemilu.org#53313,"GADUNGAN, SELEMADEG TIMUR, TABANAN, BALI",7,214,8,222
https://kawalpemilu.org#53313,"GADUNGAN, SELEMADEG TIMUR, TABANAN, BALI",8,135,6,141
https://kawalpemilu.org#53313,"GADUNGAN, SELEMADEG TIMUR, TABANAN, BALI",9,133,13,146
https://kawalpemilu.org#53313,"GADUNGAN, SELEMADEG TIMUR, TABANAN, BALI",10,239,15,254
https://kawalpemilu.org#53313,"GADUNGAN, SELEMADEG TIMUR, TABANAN, BALI",11,211,5,216
https://kawalpemilu.org#53313,"GADUNGAN, SELEMADEG TIMUR, TABANAN, BALI",12,127,1,128
https://kawalpemilu.org#53314,"BANTAS, SELEMADEG TIMUR, TABANAN, BALI",1,190,10,200
https://kawalpemilu.org#53314,"BANTAS, SELEMADEG TIMUR, TABANAN, BALI",2,187,9,196
https://kawalpemilu.org#53314,"BANTAS, SELEMADEG TIMUR, TABANAN, BALI",3,142,6,148
https://kawalpemilu.org#53314,"BANTAS, SELEMADEG TIMUR, TABANAN, BALI",4,165,2,167
https://kawalpemilu.org#53314,"BANTAS, SELEMADEG TIMUR, TABANAN, BALI",5,150,4,154
https://kawalpemilu.org#53314,"BANTAS, SELEMADEG TIMUR, TABANAN, BALI",6,155,3,158
https://kawalpemilu.org#53314,"BANTAS, SELEMADEG TIMUR, TABANAN, BALI",7,225,22,247
https://kawalpemilu.org#53314,"BANTAS, SELEMADEG TIMUR, TABANAN, BALI",8,230,12,242
https://kawalpemilu.org#53314,"BANTAS, SELEMADEG TIMUR, TABANAN, BALI",9,256,9,265
https://kawalpemilu.org#53314,"BANTAS, SELEMADEG TIMUR, TABANAN, BALI",10,235,15,250
https://kawalpemilu.org#53314,"BANTAS, SELEMADEG TIMUR, TABANAN, BALI",11,212,11,223
https://kawalpemilu.org#53315,"MAMBANG, SELEMADEG TIMUR, TABANAN, BALI",1,205,2,207
https://kawalpemilu.org#53315,"MAMBANG, SELEMADEG TIMUR, TABANAN, BALI",2,202,4,206
https://kawalpemilu.org#53315,"MAMBANG, SELEMADEG TIMUR, TABANAN, BALI",3,182,8,190
https://kawalpemilu.org#53315,"MAMBANG, SELEMADEG TIMUR, TABANAN, BALI",4,178,5,183
https://kawalpemilu.org#53315,"MAMBANG, SELEMADEG TIMUR, TABANAN, BALI",5,207,1,208
https://kawalpemilu.org#53315,"MAMBANG, SELEMADEG TIMUR, TABANAN, BALI",6,145,0,145
https://kawalpemilu.org#53315,"MAMBANG, SELEMADEG TIMUR, TABANAN, BALI",7,102,0,102
https://kawalpemilu.org#53315,"MAMBANG, SELEMADEG TIMUR, TABANAN, BALI",8,156,1,157
https://kawalpemilu.org#53315,"MAMBANG, SELEMADEG TIMUR, TABANAN, BALI",9,155,0,155
https://kawalpemilu.org#53315,"MAMBANG, SELEMADEG TIMUR, TABANAN, BALI",10,166,0,166
https://kawalpemilu.org#53315,"MAMBANG, SELEMADEG TIMUR, TABANAN, BALI",11,221,1,222
https://kawalpemilu.org#53315,"MAMBANG, SELEMADEG TIMUR, TABANAN, BALI",12,293,0,293
https://kawalpemilu.org#53315,"MAMBANG, SELEMADEG TIMUR, TABANAN, BALI",13,234,0,234
https://kawalpemilu.org#53315,"MAMBANG, SELEMADEG TIMUR, TABANAN, BALI",14,131,0,131
https://kawalpemilu.org#53316,"MEGATI, SELEMADEG TIMUR, TABANAN, BALI",1,214,4,218
https://kawalpemilu.org#53316,"MEGATI, SELEMADEG TIMUR, TABANAN, BALI",2,200,14,214
https://kawalpemilu.org#53316,"MEGATI, SELEMADEG TIMUR, TABANAN, BALI",3,176,29,205
https://kawalpemilu.org#53316,"MEGATI, SELEMADEG TIMUR, TABANAN, BALI",4,221,14,235
https://kawalpemilu.org#53316,"MEGATI, SELEMADEG TIMUR, TABANAN, BALI",5,237,1,238
https://kawalpemilu.org#53316,"MEGATI, SELEMADEG TIMUR, TABANAN, BALI",6,132,11,143
https://kawalpemilu.org#53316,"MEGATI, SELEMADEG TIMUR, TABANAN, BALI",7,151,8,159
https://kawalpemilu.org#53316,"MEGATI, SELEMADEG TIMUR, TABANAN, BALI",8,196,20,216
https://kawalpemilu.org#53316,"MEGATI, SELEMADEG TIMUR, TABANAN, BALI",9,91,14,105
https://kawalpemilu.org#53316,"MEGATI, SELEMADEG TIMUR, TABANAN, BALI",10,160,14,174
https://kawalpemilu.org#53316,"MEGATI, SELEMADEG TIMUR, TABANAN, BALI",11,150,1,151
https://kawalpemilu.org#53317,"TANGGUNTITI, SELEMADEG TIMUR, TABANAN, BALI",1,197,0,197
https://kawalpemilu.org#53317,"TANGGUNTITI, SELEMADEG TIMUR, TABANAN, BALI",2,197,0,197
https://kawalpemilu.org#53317,"TANGGUNTITI, SELEMADEG TIMUR, TABANAN, BALI",3,145,1,146
https://kawalpemilu.org#53317,"TANGGUNTITI, SELEMADEG TIMUR, TABANAN, BALI",4,94,10,104
https://kawalpemilu.org#53317,"TANGGUNTITI, SELEMADEG TIMUR, TABANAN, BALI",6,131,20,151
https://kawalpemilu.org#53317,"TANGGUNTITI, SELEMADEG TIMUR, TABANAN, BALI",7,136,5,141
https://kawalpemilu.org#53317,"TANGGUNTITI, SELEMADEG TIMUR, TABANAN, BALI",8,153,3,156
https://kawalpemilu.org#53317,"TANGGUNTITI, SELEMADEG TIMUR, TABANAN, BALI",9,149,2,151
https://kawalpemilu.org#53317,"TANGGUNTITI, SELEMADEG TIMUR, TABANAN, BALI",10,185,1,186
https://kawalpemilu.org#53317,"TANGGUNTITI, SELEMADEG TIMUR, TABANAN, BALI",11,177,2,179
https://kawalpemilu.org#53318,"BERABAN, SELEMADEG TIMUR, TABANAN, BALI",1,243,1,244
https://kawalpemilu.org#53318,"BERABAN, SELEMADEG TIMUR, TABANAN, BALI",2,185,1,186
https://kawalpemilu.org#53318,"BERABAN, SELEMADEG TIMUR, TABANAN, BALI",3,180,2,182
https://kawalpemilu.org#53318,"BERABAN, SELEMADEG TIMUR, TABANAN, BALI",4,220,1,221
https://kawalpemilu.org#53318,"BERABAN, SELEMADEG TIMUR, TABANAN, BALI",5,230,2,232
https://kawalpemilu.org#53318,"BERABAN, SELEMADEG TIMUR, TABANAN, BALI",6,212,0,212
https://kawalpemilu.org#53319,"TEGAL MENGKEB, SELEMADEG TIMUR, TABANAN, BALI",1,208,3,211
https://kawalpemilu.org#53319,"TEGAL MENGKEB, SELEMADEG TIMUR, TABANAN, BALI",2,98,5,103
https://kawalpemilu.org#53319,"TEGAL MENGKEB, SELEMADEG TIMUR, TABANAN, BALI",3,169,2,171
https://kawalpemilu.org#53319,"TEGAL MENGKEB, SELEMADEG TIMUR, TABANAN, BALI",4,134,6,140
https://kawalpemilu.org#53319,"TEGAL MENGKEB, SELEMADEG TIMUR, TABANAN, BALI",5,148,0,148
https://kawalpemilu.org#53319,"TEGAL MENGKEB, SELEMADEG TIMUR, TABANAN, BALI",6,159,0,159
https://kawalpemilu.org#53319,"TEGAL MENGKEB, SELEMADEG TIMUR, TABANAN, BALI",7,155,2,157
https://kawalpemilu.org#53319,"TEGAL MENGKEB, SELEMADEG TIMUR, TABANAN, BALI",8,157,0,157
https://kawalpemilu.org#53319,"TEGAL MENGKEB, SELEMADEG TIMUR, TABANAN, BALI",9,135,4,139
https://kawalpemilu.org#53319,"TEGAL MENGKEB, SELEMADEG TIMUR, TABANAN, BALI",10,145,0,145
https://kawalpemilu.org#53319,"TEGAL MENGKEB, SELEMADEG TIMUR, TABANAN, BALI",11,206,8,214
https://kawalpemilu.org#53319,"TEGAL MENGKEB, SELEMADEG TIMUR, TABANAN, BALI",12,189,8,197
https://kawalpemilu.org#53320,"DALANG, SELEMADEG TIMUR, TABANAN, BALI",1,184,14,198
https://kawalpemilu.org#53320,"DALANG, SELEMADEG TIMUR, TABANAN, BALI",2,204,28,232
https://kawalpemilu.org#53320,"DALANG, SELEMADEG TIMUR, TABANAN, BALI",3,190,2,192
https://kawalpemilu.org#53320,"DALANG, SELEMADEG TIMUR, TABANAN, BALI",4,143,1,144
https://kawalpemilu.org#53320,"DALANG, SELEMADEG TIMUR, TABANAN, BALI",5,192,12,204
https://kawalpemilu.org#53320,"DALANG, SELEMADEG TIMUR, TABANAN, BALI",6,109,25,134
https://kawalpemilu.org#53320,"DALANG, SELEMADEG TIMUR, TABANAN, BALI",7,238,10,248
https://kawalpemilu.org#53320,"DALANG, SELEMADEG TIMUR, TABANAN, BALI",8,147,7,154
https://kawalpemilu.org#53321,"GADUNGSARI, SELEMADEG TIMUR, TABANAN, BALI",1,240,9,249
https://kawalpemilu.org#53321,"GADUNGSARI, SELEMADEG TIMUR, TABANAN, BALI",2,156,7,163
https://kawalpemilu.org#53321,"GADUNGSARI, SELEMADEG TIMUR, TABANAN, BALI",3,143,12,155
https://kawalpemilu.org#53321,"GADUNGSARI, SELEMADEG TIMUR, TABANAN, BALI",4,210,13,223
https://kawalpemilu.org#53323,"MUNDEH, SELEMADEG BARAT, TABANAN, BALI",1,210,7,217
https://kawalpemilu.org#53323,"MUNDEH, SELEMADEG BARAT, TABANAN, BALI",2,120,5,125
https://kawalpemilu.org#53323,"MUNDEH, SELEMADEG BARAT, TABANAN, BALI",3,129,7,136
https://kawalpemilu.org#53323,"MUNDEH, SELEMADEG BARAT, TABANAN, BALI",4,199,18,217
https://kawalpemilu.org#53323,"MUNDEH, SELEMADEG BARAT, TABANAN, BALI",5,112,9,121
https://kawalpemilu.org#53323,"MUNDEH, SELEMADEG BARAT, TABANAN, BALI",6,159,1,159
https://kawalpemilu.org#53323,"MUNDEH, SELEMADEG BARAT, TABANAN, BALI",7,183,5,188
https://kawalpemilu.org#53323,"MUNDEH, SELEMADEG BARAT, TABANAN, BALI",8,130,11,141
https://kawalpemilu.org#53323,"MUNDEH, SELEMADEG BARAT, TABANAN, BALI",9,240,5,245
https://kawalpemilu.org#53323,"MUNDEH, SELEMADEG BARAT, TABANAN, BALI",10,130,4,134
https://kawalpemilu.org#53323,"MUNDEH, SELEMADEG BARAT, TABANAN, BALI",11,203,21,224
https://kawalpemilu.org#53324,"MUNDEH KANGIN, SELEMADEG BARAT, TABANAN, BALI",1,173,2,175
https://kawalpemilu.org#53324,"MUNDEH KANGIN, SELEMADEG BARAT, TABANAN, BALI",2,208,8,216
https://kawalpemilu.org#53324,"MUNDEH KANGIN, SELEMADEG BARAT, TABANAN, BALI",3,233,4,237
https://kawalpemilu.org#53324,"MUNDEH KANGIN, SELEMADEG BARAT, TABANAN, BALI",4,230,2,232
https://kawalpemilu.org#53324,"MUNDEH KANGIN, SELEMADEG BARAT, TABANAN, BALI",5,153,1,154
https://kawalpemilu.org#53324,"MUNDEH KANGIN, SELEMADEG BARAT, TABANAN, BALI",6,115,3,118
https://kawalpemilu.org#53324,"MUNDEH KANGIN, SELEMADEG BARAT, TABANAN, BALI",7,260,4,264
https://kawalpemilu.org#53325,"LALANGLINGGAH, SELEMADEG BARAT, TABANAN, BALI",1,109,57,166
https://kawalpemilu.org#53325,"LALANGLINGGAH, SELEMADEG BARAT, TABANAN, BALI",2,64,98,162
https://kawalpemilu.org#53325,"LALANGLINGGAH, SELEMADEG BARAT, TABANAN, BALI",3,118,6,124
https://kawalpemilu.org#53325,"LALANGLINGGAH, SELEMADEG BARAT, TABANAN, BALI",4,128,11,139
https://kawalpemilu.org#53325,"LALANGLINGGAH, SELEMADEG BARAT, TABANAN, BALI",5,168,32,200
https://kawalpemilu.org#53325,"LALANGLINGGAH, SELEMADEG BARAT, TABANAN, BALI",6,152,3,155
https://kawalpemilu.org#53325,"LALANGLINGGAH, SELEMADEG BARAT, TABANAN, BALI",7,155,2,157
https://kawalpemilu.org#53325,"LALANGLINGGAH, SELEMADEG BARAT, TABANAN, BALI",8,149,2,151
https://kawalpemilu.org#53325,"LALANGLINGGAH, SELEMADEG BARAT, TABANAN, BALI",9,149,4,153
https://kawalpemilu.org#53325,"LALANGLINGGAH, SELEMADEG BARAT, TABANAN, BALI",10,191,13,204
https://kawalpemilu.org#53325,"LALANGLINGGAH, SELEMADEG BARAT, TABANAN, BALI",11,218,4,222
https://kawalpemilu.org#53325,"LALANGLINGGAH, SELEMADEG BARAT, TABANAN, BALI",12,135,16,151
https://kawalpemilu.org#53325,"LALANGLINGGAH, SELEMADEG BARAT, TABANAN, BALI",13,158,4,162
https://kawalpemilu.org#53325,"LALANGLINGGAH, SELEMADEG BARAT, TABANAN, BALI",14,163,7,170
https://kawalpemilu.org#53325,"LALANGLINGGAH, SELEMADEG BARAT, TABANAN, BALI",15,173,3,176
https://kawalpemilu.org#53325,"LALANGLINGGAH, SELEMADEG BARAT, TABANAN, BALI",16,253,3,256
https://kawalpemilu.org#53326,"ANTOSARI, SELEMADEG BARAT, TABANAN, BALI",1,99,14,113
https://kawalpemilu.org#53326,"ANTOSARI, SELEMADEG BARAT, TABANAN, BALI",2,142,1,143
https://kawalpemilu.org#53326,"ANTOSARI, SELEMADEG BARAT, TABANAN, BALI",3,151,3,154
https://kawalpemilu.org#53326,"ANTOSARI, SELEMADEG BARAT, TABANAN, BALI",4,197,22,219
https://kawalpemilu.org#53326,"ANTOSARI, SELEMADEG BARAT, TABANAN, BALI",5,138,2,140
https://kawalpemilu.org#53326,"ANTOSARI, SELEMADEG BARAT, TABANAN, BALI",6,129,5,134
https://kawalpemilu.org#53326,"ANTOSARI, SELEMADEG BARAT, TABANAN, BALI",7,123,13,136
https://kawalpemilu.org#53326,"ANTOSARI, SELEMADEG BARAT, TABANAN, BALI",8,121,13,134
https://kawalpemilu.org#53326,"ANTOSARI, SELEMADEG BARAT, TABANAN, BALI",9,82,0,82
https://kawalpemilu.org#53326,"ANTOSARI, SELEMADEG BARAT, TABANAN, BALI",10,95,0,95
https://kawalpemilu.org#53327,"LUMBUNG, SELEMADEG BARAT, TABANAN, BALI",1,222,1,223
https://kawalpemilu.org#53327,"LUMBUNG, SELEMADEG BARAT, TABANAN, BALI",2,247,0,247
https://kawalpemilu.org#53327,"LUMBUNG, SELEMADEG BARAT, TABANAN, BALI",3,157,0,157
https://kawalpemilu.org#53327,"LUMBUNG, SELEMADEG BARAT, TABANAN, BALI",4,208,1,209
https://kawalpemilu.org#53327,"LUMBUNG, SELEMADEG BARAT, TABANAN, BALI",5,70,0,70
https://kawalpemilu.org#53327,"LUMBUNG, SELEMADEG BARAT, TABANAN, BALI",6,142,0,142
https://kawalpemilu.org#53327,"LUMBUNG, SELEMADEG BARAT, TABANAN, BALI",7,172,23,195
https://kawalpemilu.org#53327,"LUMBUNG, SELEMADEG BARAT, TABANAN, BALI",8,134,0,134
https://kawalpemilu.org#53328,"LUMBUNG KAUH, SELEMADEG BARAT, TABANAN, BALI",1,69,3,72
https://kawalpemilu.org#53328,"LUMBUNG KAUH, SELEMADEG BARAT, TABANAN, BALI",2,154,1,155
https://kawalpemilu.org#53328,"LUMBUNG KAUH, SELEMADEG BARAT, TABANAN, BALI",3,107,5,112
https://kawalpemilu.org#53328,"LUMBUNG KAUH, SELEMADEG BARAT, TABANAN, BALI",4,176,0,176
https://kawalpemilu.org#53328,"LUMBUNG KAUH, SELEMADEG BARAT, TABANAN, BALI",5,132,18,150
https://kawalpemilu.org#53328,"LUMBUNG KAUH, SELEMADEG BARAT, TABANAN, BALI",6,113,20,133
https://kawalpemilu.org#53329,"TIYING GADING, SELEMADEG BARAT, TABANAN, BALI",1,188,0,188
https://kawalpemilu.org#53329,"TIYING GADING, SELEMADEG BARAT, TABANAN, BALI",2,174,0,174
https://kawalpemilu.org#53329,"TIYING GADING, SELEMADEG BARAT, TABANAN, BALI",3,218,8,226
https://kawalpemilu.org#53329,"TIYING GADING, SELEMADEG BARAT, TABANAN, BALI",4,175,17,192
https://kawalpemilu.org#53329,"TIYING GADING, SELEMADEG BARAT, TABANAN, BALI",5,171,8,179
https://kawalpemilu.org#53329,"TIYING GADING, SELEMADEG BARAT, TABANAN, BALI",6,113,2,115
https://kawalpemilu.org#53329,"TIYING GADING, SELEMADEG BARAT, TABANAN, BALI",7,256,7,263
https://kawalpemilu.org#53329,"TIYING GADING, SELEMADEG BARAT, TABANAN, BALI",8,145,1,146
https://kawalpemilu.org#53329,"TIYING GADING, SELEMADEG BARAT, TABANAN, BALI",9,150,4,154
https://kawalpemilu.org#53330,"MUNDEH KAUH, SELEMADEG BARAT, TABANAN, BALI",2,163,83,246
https://kawalpemilu.org#53330,"MUNDEH KAUH, SELEMADEG BARAT, TABANAN, BALI",3,229,6,235
https://kawalpemilu.org#53330,"MUNDEH KAUH, SELEMADEG BARAT, TABANAN, BALI",4,269,1,270
https://kawalpemilu.org#53330,"MUNDEH KAUH, SELEMADEG BARAT, TABANAN, BALI",5,172,22,194
https://kawalpemilu.org#53331,"ANGKAH, SELEMADEG BARAT, TABANAN, BALI",1,127,8,135
https://kawalpemilu.org#53331,"ANGKAH, SELEMADEG BARAT, TABANAN, BALI",2,154,3,157
https://kawalpemilu.org#53331,"ANGKAH, SELEMADEG BARAT, TABANAN, BALI",3,153,3,156
https://kawalpemilu.org#53331,"ANGKAH, SELEMADEG BARAT, TABANAN, BALI",4,167,0,167
https://kawalpemilu.org#53331,"ANGKAH, SELEMADEG BARAT, TABANAN, BALI",5,161,47,208
https://kawalpemilu.org#53331,"ANGKAH, SELEMADEG BARAT, TABANAN, BALI",6,199,17,216
https://kawalpemilu.org#53331,"ANGKAH, SELEMADEG BARAT, TABANAN, BALI",7,159,3,162
https://kawalpemilu.org#53331,"ANGKAH, SELEMADEG BARAT, TABANAN, BALI",8,188,3,191
https://kawalpemilu.org#53331,"ANGKAH, SELEMADEG BARAT, TABANAN, BALI",9,81,0,81
https://kawalpemilu.org#84992,"SELABIH, SELEMADEG BARAT, TABANAN, BALI",1,168,22,190
https://kawalpemilu.org#84992,"SELABIH, SELEMADEG BARAT, TABANAN, BALI",2,183,16,199
https://kawalpemilu.org#84992,"SELABIH, SELEMADEG BARAT, TABANAN, BALI",3,181,11,192
https://kawalpemilu.org#84992,"SELABIH, SELEMADEG BARAT, TABANAN, BALI",4,205,34,239
https://kawalpemilu.org#84992,"SELABIH, SELEMADEG BARAT, TABANAN, BALI",5,142,26,168
https://kawalpemilu.org#84992,"SELABIH, SELEMADEG BARAT, TABANAN, BALI",6,156,7,163
https://kawalpemilu.org#84993,"BENGKEL SARI, SELEMADEG BARAT, TABANAN, BALI",1,238,4,242
https://kawalpemilu.org#84993,"BENGKEL SARI, SELEMADEG BARAT, TABANAN, BALI",2,138,8,146
https://kawalpemilu.org#84993,"BENGKEL SARI, SELEMADEG BARAT, TABANAN, BALI",3,141,7,148
https://kawalpemilu.org#84993,"BENGKEL SARI, SELEMADEG BARAT, TABANAN, BALI",4,126,4,130
https://kawalpemilu.org#84993,"BENGKEL SARI, SELEMADEG BARAT, TABANAN, BALI",5,238,4,242
https://kawalpemilu.org#53333,"TIBU BIU, KERAMBITAN, TABANAN, BALI",1,152,19,171
https://kawalpemilu.org#53333,"TIBU BIU, KERAMBITAN, TABANAN, BALI",2,149,24,173
https://kawalpemilu.org#53333,"TIBU BIU, KERAMBITAN, TABANAN, BALI",3,134,17,151
https://kawalpemilu.org#53333,"TIBU BIU, KERAMBITAN, TABANAN, BALI",4,263,13,276
https://kawalpemilu.org#53333,"TIBU BIU, KERAMBITAN, TABANAN, BALI",5,247,22,269
https://kawalpemilu.org#53333,"TIBU BIU, KERAMBITAN, TABANAN, BALI",6,184,25,209
https://kawalpemilu.org#53334,"KELATING, KERAMBITAN, TABANAN, BALI",1,220,24,244
https://kawalpemilu.org#53334,"KELATING, KERAMBITAN, TABANAN, BALI",2,191,15,206
https://kawalpemilu.org#53334,"KELATING, KERAMBITAN, TABANAN, BALI",3,184,10,194
https://kawalpemilu.org#53334,"KELATING, KERAMBITAN, TABANAN, BALI",4,241,8,249
https://kawalpemilu.org#53334,"KELATING, KERAMBITAN, TABANAN, BALI",5,206,2,208
https://kawalpemilu.org#53334,"KELATING, KERAMBITAN, TABANAN, BALI",6,234,23,257
https://kawalpemilu.org#53334,"KELATING, KERAMBITAN, TABANAN, BALI",7,231,13,244
https://kawalpemilu.org#53334,"KELATING, KERAMBITAN, TABANAN, BALI",8,238,24,262
https://kawalpemilu.org#53335,"PENARUKAN, KERAMBITAN, TABANAN, BALI",1,199,2,201
https://kawalpemilu.org#53335,"PENARUKAN, KERAMBITAN, TABANAN, BALI",2,195,4,199
https://kawalpemilu.org#53335,"PENARUKAN, KERAMBITAN, TABANAN, BALI",3,201,13,214
https://kawalpemilu.org#53335,"PENARUKAN, KERAMBITAN, TABANAN, BALI",4,180,16,196
https://kawalpemilu.org#53335,"PENARUKAN, KERAMBITAN, TABANAN, BALI",5,191,14,205
https://kawalpemilu.org#53335,"PENARUKAN, KERAMBITAN, TABANAN, BALI",6,205,10,215
https://kawalpemilu.org#53335,"PENARUKAN, KERAMBITAN, TABANAN, BALI",7,231,20,251
https://kawalpemilu.org#53335,"PENARUKAN, KERAMBITAN, TABANAN, BALI",8,269,5,274
https://kawalpemilu.org#53335,"PENARUKAN, KERAMBITAN, TABANAN, BALI",9,258,7,265
https://kawalpemilu.org#53335,"PENARUKAN, KERAMBITAN, TABANAN, BALI",10,193,0,193
https://kawalpemilu.org#53336,"BELUMBANG, KERAMBITAN, TABANAN, BALI",1,276,9,285
https://kawalpemilu.org#53336,"BELUMBANG, KERAMBITAN, TABANAN, BALI",2,234,13,247
https://kawalpemilu.org#53336,"BELUMBANG, KERAMBITAN, TABANAN, BALI",3,192,13,205
https://kawalpemilu.org#53336,"BELUMBANG, KERAMBITAN, TABANAN, BALI",4,234,12,246
https://kawalpemilu.org#53336,"BELUMBANG, KERAMBITAN, TABANAN, BALI",5,192,19,211
https://kawalpemilu.org#53336,"BELUMBANG, KERAMBITAN, TABANAN, BALI",6,111,35,146
https://kawalpemilu.org#53336,"BELUMBANG, KERAMBITAN, TABANAN, BALI",7,89,4,93
https://kawalpemilu.org#53336,"BELUMBANG, KERAMBITAN, TABANAN, BALI",8,118,11,129
https://kawalpemilu.org#53337,"TISTA, KERAMBITAN, TABANAN, BALI",1,209,5,214
https://kawalpemilu.org#53337,"TISTA, KERAMBITAN, TABANAN, BALI",2,204,20,224
https://kawalpemilu.org#53337,"TISTA, KERAMBITAN, TABANAN, BALI",3,249,4,253
https://kawalpemilu.org#53337,"TISTA, KERAMBITAN, TABANAN, BALI",4,181,16,197
https://kawalpemilu.org#53337,"TISTA, KERAMBITAN, TABANAN, BALI",5,182,10,192
https://kawalpemilu.org#53337,"TISTA, KERAMBITAN, TABANAN, BALI",6,212,12,224
https://kawalpemilu.org#53338,"KERAMBITAN, KERAMBITAN, TABANAN, BALI",1,250,15,265
https://kawalpemilu.org#53338,"KERAMBITAN, KERAMBITAN, TABANAN, BALI",2,207,16,223
https://kawalpemilu.org#53338,"KERAMBITAN, KERAMBITAN, TABANAN, BALI",3,196,4,200
https://kawalpemilu.org#53338,"KERAMBITAN, KERAMBITAN, TABANAN, BALI",4,196,14,210
https://kawalpemilu.org#53338,"KERAMBITAN, KERAMBITAN, TABANAN, BALI",5,231,21,252
https://kawalpemilu.org#53338,"KERAMBITAN, KERAMBITAN, TABANAN, BALI",6,212,17,229
https://kawalpemilu.org#53338,"KERAMBITAN, KERAMBITAN, TABANAN, BALI",7,226,5,231
https://kawalpemilu.org#53338,"KERAMBITAN, KERAMBITAN, TABANAN, BALI",8,215,7,222
https://kawalpemilu.org#53338,"KERAMBITAN, KERAMBITAN, TABANAN, BALI",9,234,4,238
https://kawalpemilu.org#53338,"KERAMBITAN, KERAMBITAN, TABANAN, BALI",10,251,1,252
https://kawalpemilu.org#53339,"PANGKUNG KARUNG, KERAMBITAN, TABANAN, BALI",1,236,21,257
https://kawalpemilu.org#53339,"PANGKUNG KARUNG, KERAMBITAN, TABANAN, BALI",2,229,21,250
https://kawalpemilu.org#53339,"PANGKUNG KARUNG, KERAMBITAN, TABANAN, BALI",3,156,2,158
https://kawalpemilu.org#53339,"PANGKUNG KARUNG, KERAMBITAN, TABANAN, BALI",4,155,6,161
https://kawalpemilu.org#53339,"PANGKUNG KARUNG, KERAMBITAN, TABANAN, BALI",5,207,0,207
https://kawalpemilu.org#53339,"PANGKUNG KARUNG, KERAMBITAN, TABANAN, BALI",6,207,8,215
https://kawalpemilu.org#53339,"PANGKUNG KARUNG, KERAMBITAN, TABANAN, BALI",7,193,20,213
https://kawalpemilu.org#53339,"PANGKUNG KARUNG, KERAMBITAN, TABANAN, BALI",8,206,4,210
https://kawalpemilu.org#53339,"PANGKUNG KARUNG, KERAMBITAN, TABANAN, BALI",9,203,5,208
https://kawalpemilu.org#53339,"PANGKUNG KARUNG, KERAMBITAN, TABANAN, BALI",10,220,2,222
https://kawalpemilu.org#53340,"SAMSAM, KERAMBITAN, TABANAN, BALI",1,159,13,172
https://kawalpemilu.org#53340,"SAMSAM, KERAMBITAN, TABANAN, BALI",2,157,22,179
https://kawalpemilu.org#53340,"SAMSAM, KERAMBITAN, TABANAN, BALI",3,210,27,237
https://kawalpemilu.org#53340,"SAMSAM, KERAMBITAN, TABANAN, BALI",4,210,32,242
https://kawalpemilu.org#53340,"SAMSAM, KERAMBITAN, TABANAN, BALI",5,259,14,273
https://kawalpemilu.org#53340,"SAMSAM, KERAMBITAN, TABANAN, BALI",6,248,20,268
https://kawalpemilu.org#53340,"SAMSAM, KERAMBITAN, TABANAN, BALI",7,200,34,234
https://kawalpemilu.org#53340,"SAMSAM, KERAMBITAN, TABANAN, BALI",8,199,31,230
https://kawalpemilu.org#53340,"SAMSAM, KERAMBITAN, TABANAN, BALI",9,213,33,246
https://kawalpemilu.org#53340,"SAMSAM, KERAMBITAN, TABANAN, BALI",10,198,18,216
https://kawalpemilu.org#53340,"SAMSAM, KERAMBITAN, TABANAN, BALI",11,241,4,245
https://kawalpemilu.org#53341,"KUKUH, KERAMBITAN, TABANAN, BALI",1,214,5,219
https://kawalpemilu.org#53341,"KUKUH, KERAMBITAN, TABANAN, BALI",2,164,1,165
https://kawalpemilu.org#53341,"KUKUH, KERAMBITAN, TABANAN, BALI",3,228,1,229
https://kawalpemilu.org#53341,"KUKUH, KERAMBITAN, TABANAN, BALI",4,137,28,165
https://kawalpemilu.org#53341,"KUKUH, KERAMBITAN, TABANAN, BALI",5,137,9,146
https://kawalpemilu.org#53341,"KUKUH, KERAMBITAN, TABANAN, BALI",6,161,16,177
https://kawalpemilu.org#53341,"KUKUH, KERAMBITAN, TABANAN, BALI",7,153,21,174
https://kawalpemilu.org#53341,"KUKUH, KERAMBITAN, TABANAN, BALI",8,186,29,215
https://kawalpemilu.org#53341,"KUKUH, KERAMBITAN, TABANAN, BALI",9,173,49,222
https://kawalpemilu.org#53342,"BATURITI, KERAMBITAN, TABANAN, BALI",1,184,7,191
https://kawalpemilu.org#53342,"BATURITI, KERAMBITAN, TABANAN, BALI",2,260,20,280
https://kawalpemilu.org#53342,"BATURITI, KERAMBITAN, TABANAN, BALI",3,249,7,256
https://kawalpemilu.org#53342,"BATURITI, KERAMBITAN, TABANAN, BALI",4,202,13,215
https://kawalpemilu.org#53342,"BATURITI, KERAMBITAN, TABANAN, BALI",5,206,17,223
https://kawalpemilu.org#53342,"BATURITI, KERAMBITAN, TABANAN, BALI",6,218,11,229
https://kawalpemilu.org#53342,"BATURITI, KERAMBITAN, TABANAN, BALI",7,205,5,210
https://kawalpemilu.org#53342,"BATURITI, KERAMBITAN, TABANAN, BALI",8,250,7,257
https://kawalpemilu.org#53342,"BATURITI, KERAMBITAN, TABANAN, BALI",9,186,0,186
https://kawalpemilu.org#53342,"BATURITI, KERAMBITAN, TABANAN, BALI",10,134,1,135
https://kawalpemilu.org#53343,"MELILING, KERAMBITAN, TABANAN, BALI",1,262,4,266
https://kawalpemilu.org#53343,"MELILING, KERAMBITAN, TABANAN, BALI",2,276,0,276
https://kawalpemilu.org#53343,"MELILING, KERAMBITAN, TABANAN, BALI",3,173,26,199
https://kawalpemilu.org#53343,"MELILING, KERAMBITAN, TABANAN, BALI",4,185,23,208
https://kawalpemilu.org#53343,"MELILING, KERAMBITAN, TABANAN, BALI",5,185,7,192
https://kawalpemilu.org#53343,"MELILING, KERAMBITAN, TABANAN, BALI",6,167,20,187
https://kawalpemilu.org#53343,"MELILING, KERAMBITAN, TABANAN, BALI",7,194,8,202
https://kawalpemilu.org#53343,"MELILING, KERAMBITAN, TABANAN, BALI",8,130,20,150
https://kawalpemilu.org#53343,"MELILING, KERAMBITAN, TABANAN, BALI",9,144,5,149
https://kawalpemilu.org#53344,"SEMBUNG GEDE, KERAMBITAN, TABANAN, BALI",1,268,1,269
https://kawalpemilu.org#53344,"SEMBUNG GEDE, KERAMBITAN, TABANAN, BALI",2,218,1,219
https://kawalpemilu.org#53344,"SEMBUNG GEDE, KERAMBITAN, TABANAN, BALI",3,175,9,184
https://kawalpemilu.org#53344,"SEMBUNG GEDE, KERAMBITAN, TABANAN, BALI",4,183,7,190
https://kawalpemilu.org#53344,"SEMBUNG GEDE, KERAMBITAN, TABANAN, BALI",5,203,8,211
https://kawalpemilu.org#53344,"SEMBUNG GEDE, KERAMBITAN, TABANAN, BALI",6,172,16,188
https://kawalpemilu.org#53344,"SEMBUNG GEDE, KERAMBITAN, TABANAN, BALI",7,177,6,183
https://kawalpemilu.org#53344,"SEMBUNG GEDE, KERAMBITAN, TABANAN, BALI",8,142,32,174
https://kawalpemilu.org#53344,"SEMBUNG GEDE, KERAMBITAN, TABANAN, BALI",9,150,22,172
https://kawalpemilu.org#53344,"SEMBUNG GEDE, KERAMBITAN, TABANAN, BALI",10,168,20,188
https://kawalpemilu.org#53344,"SEMBUNG GEDE, KERAMBITAN, TABANAN, BALI",11,166,14,180
https://kawalpemilu.org#53344,"SEMBUNG GEDE, KERAMBITAN, TABANAN, BALI",12,232,13,245
https://kawalpemilu.org#53344,"SEMBUNG GEDE, KERAMBITAN, TABANAN, BALI",13,163,0,163
https://kawalpemilu.org#53344,"SEMBUNG GEDE, KERAMBITAN, TABANAN, BALI",14,147,0,147
https://kawalpemilu.org#53344,"SEMBUNG GEDE, KERAMBITAN, TABANAN, BALI",15,183,4,187
https://kawalpemilu.org#53344,"SEMBUNG GEDE, KERAMBITAN, TABANAN, BALI",16,177,13,190
https://kawalpemilu.org#53345,"BATUAJI, KERAMBITAN, TABANAN, BALI",1,177,4,185
https://kawalpemilu.org#53345,"BATUAJI, KERAMBITAN, TABANAN, BALI",2,175,4,179
https://kawalpemilu.org#53345,"BATUAJI, KERAMBITAN, TABANAN, BALI",3,195,13,208
https://kawalpemilu.org#53345,"BATUAJI, KERAMBITAN, TABANAN, BALI",4,214,4,218
https://kawalpemilu.org#53345,"BATUAJI, KERAMBITAN, TABANAN, BALI",5,203,5,208
https://kawalpemilu.org#53345,"BATUAJI, KERAMBITAN, TABANAN, BALI",6,248,30,278
https://kawalpemilu.org#53345,"BATUAJI, KERAMBITAN, TABANAN, BALI",7,262,1,262
https://kawalpemilu.org#53345,"BATUAJI, KERAMBITAN, TABANAN, BALI",8,225,5,230
https://kawalpemilu.org#53346,"KESIUT, KERAMBITAN, TABANAN, BALI",1,162,7,169
https://kawalpemilu.org#53346,"KESIUT, KERAMBITAN, TABANAN, BALI",2,141,9,150
https://kawalpemilu.org#53346,"KESIUT, KERAMBITAN, TABANAN, BALI",3,245,7,252
https://kawalpemilu.org#53346,"KESIUT, KERAMBITAN, TABANAN, BALI",4,214,2,216
https://kawalpemilu.org#53346,"KESIUT, KERAMBITAN, TABANAN, BALI",5,162,4,166
https://kawalpemilu.org#53346,"KESIUT, KERAMBITAN, TABANAN, BALI",6,150,1,151
https://kawalpemilu.org#53346,"KESIUT, KERAMBITAN, TABANAN, BALI",7,178,1,179
https://kawalpemilu.org#53346,"KESIUT, KERAMBITAN, TABANAN, BALI",8,235,1,236
https://kawalpemilu.org#53347,"TIMPAG, KERAMBITAN, TABANAN, BALI",1,256,2,258
https://kawalpemilu.org#53347,"TIMPAG, KERAMBITAN, TABANAN, BALI",2,204,6,210
https://kawalpemilu.org#53347,"TIMPAG, KERAMBITAN, TABANAN, BALI",3,139,4,143
https://kawalpemilu.org#53347,"TIMPAG, KERAMBITAN, TABANAN, BALI",4,259,3,262
https://kawalpemilu.org#53347,"TIMPAG, KERAMBITAN, TABANAN, BALI",5,152,2,154
https://kawalpemilu.org#53347,"TIMPAG, KERAMBITAN, TABANAN, BALI",6,156,0,156
https://kawalpemilu.org#53347,"TIMPAG, KERAMBITAN, TABANAN, BALI",7,277,0,277
https://kawalpemilu.org#53347,"TIMPAG, KERAMBITAN, TABANAN, BALI",8,201,2,203
https://kawalpemilu.org#53347,"TIMPAG, KERAMBITAN, TABANAN, BALI",9,170,1,171
https://kawalpemilu.org#53347,"TIMPAG, KERAMBITAN, TABANAN, BALI",10,162,1,163
https://kawalpemilu.org#53347,"TIMPAG, KERAMBITAN, TABANAN, BALI",11,202,0,202
https://kawalpemilu.org#53347,"TIMPAG, KERAMBITAN, TABANAN, BALI",12,206,4,210
https://kawalpemilu.org#53347,"TIMPAG, KERAMBITAN, TABANAN, BALI",13,209,4,213
https://kawalpemilu.org#53349,"SUDIMARA, TABANAN, TABANAN, BALI",1,180,0,180
https://kawalpemilu.org#53349,"SUDIMARA, TABANAN, TABANAN, BALI",2,229,3,232
https://kawalpemilu.org#53349,"SUDIMARA, TABANAN, TABANAN, BALI",3,239,3,242
https://kawalpemilu.org#53349,"SUDIMARA, TABANAN, TABANAN, BALI",4,242,1,243
https://kawalpemilu.org#53349,"SUDIMARA, TABANAN, TABANAN, BALI",5,241,0,241
https://kawalpemilu.org#53349,"SUDIMARA, TABANAN, TABANAN, BALI",6,221,1,222
https://kawalpemilu.org#53349,"SUDIMARA, TABANAN, TABANAN, BALI",7,222,3,225
https://kawalpemilu.org#53349,"SUDIMARA, TABANAN, TABANAN, BALI",8,241,6,247
https://kawalpemilu.org#53349,"SUDIMARA, TABANAN, TABANAN, BALI",9,248,1,249
https://kawalpemilu.org#53349,"SUDIMARA, TABANAN, TABANAN, BALI",10,244,6,250
https://kawalpemilu.org#53349,"SUDIMARA, TABANAN, TABANAN, BALI",11,263,6,269
https://kawalpemilu.org#53349,"SUDIMARA, TABANAN, TABANAN, BALI",12,240,4,244
https://kawalpemilu.org#53349,"SUDIMARA, TABANAN, TABANAN, BALI",13,226,2,228
https://kawalpemilu.org#53349,"SUDIMARA, TABANAN, TABANAN, BALI",14,229,4,233
https://kawalpemilu.org#53349,"SUDIMARA, TABANAN, TABANAN, BALI",15,226,0,226
https://kawalpemilu.org#53349,"SUDIMARA, TABANAN, TABANAN, BALI",16,226,0,226
https://kawalpemilu.org#53349,"SUDIMARA, TABANAN, TABANAN, BALI",17,206,0,206
https://kawalpemilu.org#53349,"SUDIMARA, TABANAN, TABANAN, BALI",18,204,0,204
https://kawalpemilu.org#53349,"SUDIMARA, TABANAN, TABANAN, BALI",19,192,9,201
https://kawalpemilu.org#53349,"SUDIMARA, TABANAN, TABANAN, BALI",20,187,6,193
https://kawalpemilu.org#53349,"SUDIMARA, TABANAN, TABANAN, BALI",21,177,25,202
https://kawalpemilu.org#53349,"SUDIMARA, TABANAN, TABANAN, BALI",22,155,37,192
https://kawalpemilu.org#53350,"GUBUG, TABANAN, TABANAN, BALI",1,203,20,223
https://kawalpemilu.org#53350,"GUBUG, TABANAN, TABANAN, BALI",2,237,18,255
https://kawalpemilu.org#53350,"GUBUG, TABANAN, TABANAN, BALI",3,162,23,185
https://kawalpemilu.org#53350,"GUBUG, TABANAN, TABANAN, BALI",4,251,19,270
https://kawalpemilu.org#53350,"GUBUG, TABANAN, TABANAN, BALI",5,282,4,286
https://kawalpemilu.org#53350,"GUBUG, TABANAN, TABANAN, BALI",6,228,4,232
https://kawalpemilu.org#53350,"GUBUG, TABANAN, TABANAN, BALI",7,226,5,231
https://kawalpemilu.org#53350,"GUBUG, TABANAN, TABANAN, BALI",8,269,10,279
https://kawalpemilu.org#53350,"GUBUG, TABANAN, TABANAN, BALI",9,184,2,186
https://kawalpemilu.org#53350,"GUBUG, TABANAN, TABANAN, BALI",10,177,4,181
https://kawalpemilu.org#53350,"GUBUG, TABANAN, TABANAN, BALI",11,172,0,172
https://kawalpemilu.org#53350,"GUBUG, TABANAN, TABANAN, BALI",12,157,2,159
https://kawalpemilu.org#53350,"GUBUG, TABANAN, TABANAN, BALI",13,266,0,266
https://kawalpemilu.org#53350,"GUBUG, TABANAN, TABANAN, BALI",14,212,0,212
https://kawalpemilu.org#53350,"GUBUG, TABANAN, TABANAN, BALI",15,246,11,257
https://kawalpemilu.org#53350,"GUBUG, TABANAN, TABANAN, BALI",16,250,10,260
https://kawalpemilu.org#53351,"BONGAN, TABANAN, TABANAN, BALI",1,224,20,244
https://kawalpemilu.org#53351,"BONGAN, TABANAN, TABANAN, BALI",2,209,6,215
https://kawalpemilu.org#53351,"BONGAN, TABANAN, TABANAN, BALI",3,186,15,201
https://kawalpemilu.org#53351,"BONGAN, TABANAN, TABANAN, BALI",4,185,13,198
https://kawalpemilu.org#53351,"BONGAN, TABANAN, TABANAN, BALI",5,237,0,237
https://kawalpemilu.org#53351,"BONGAN, TABANAN, TABANAN, BALI",6,228,6,234
https://kawalpemilu.org#53351,"BONGAN, TABANAN, TABANAN, BALI",7,148,15,163
https://kawalpemilu.org#53351,"BONGAN, TABANAN, TABANAN, BALI",8,146,1,147
https://kawalpemilu.org#53351,"BONGAN, TABANAN, TABANAN, BALI",9,288,12,240
https://kawalpemilu.org#53351,"BONGAN, TABANAN, TABANAN, BALI",10,229,16,245
https://kawalpemilu.org#53351,"BONGAN, TABANAN, TABANAN, BALI",11,245,7,252
https://kawalpemilu.org#53351,"BONGAN, TABANAN, TABANAN, BALI",12,242,8,250
https://kawalpemilu.org#53351,"BONGAN, TABANAN, TABANAN, BALI",13,255,3,258
https://kawalpemilu.org#53351,"BONGAN, TABANAN, TABANAN, BALI",14,198,14,212
https://kawalpemilu.org#53351,"BONGAN, TABANAN, TABANAN, BALI",15,180,19,199
https://kawalpemilu.org#53351,"BONGAN, TABANAN, TABANAN, BALI",16,161,17,178
https://kawalpemilu.org#53351,"BONGAN, TABANAN, TABANAN, BALI",17,259,11,270
https://kawalpemilu.org#53351,"BONGAN, TABANAN, TABANAN, BALI",18,235,13,248
https://kawalpemilu.org#53351,"BONGAN, TABANAN, TABANAN, BALI",19,201,11,212
https://kawalpemilu.org#53351,"BONGAN, TABANAN, TABANAN, BALI",20,217,14,231
https://kawalpemilu.org#53351,"BONGAN, TABANAN, TABANAN, BALI",21,215,16,231
https://kawalpemilu.org#53351,"BONGAN, TABANAN, TABANAN, BALI",22,215,16,231
https://kawalpemilu.org#53351,"BONGAN, TABANAN, TABANAN, BALI",23,222,0,222
https://kawalpemilu.org#53352,"DELOD PEKEN, TABANAN, TABANAN, BALI",1,253,22,275
https://kawalpemilu.org#53352,"DELOD PEKEN, TABANAN, TABANAN, BALI",2,218,29,247
https://kawalpemilu.org#53352,"DELOD PEKEN, TABANAN, TABANAN, BALI",3,232,6,238
https://kawalpemilu.org#53352,"DELOD PEKEN, TABANAN, TABANAN, BALI",4,230,10,240
https://kawalpemilu.org#53352,"DELOD PEKEN, TABANAN, TABANAN, BALI",5,240,5,245
https://kawalpemilu.org#53352,"DELOD PEKEN, TABANAN, TABANAN, BALI",6,245,10,255
https://kawalpemilu.org#53352,"DELOD PEKEN, TABANAN, TABANAN, BALI",7,214,16,230
https://kawalpemilu.org#53352,"DELOD PEKEN, TABANAN, TABANAN, BALI",8,242,13,255
https://kawalpemilu.org#53352,"DELOD PEKEN, TABANAN, TABANAN, BALI",9,214,27,241
https://kawalpemilu.org#53352,"DELOD PEKEN, TABANAN, TABANAN, BALI",10,215,16,231
https://kawalpemilu.org#53352,"DELOD PEKEN, TABANAN, TABANAN, BALI",11,237,16,253
https://kawalpemilu.org#53352,"DELOD PEKEN, TABANAN, TABANAN, BALI",12,219,25,244
https://kawalpemilu.org#53352,"DELOD PEKEN, TABANAN, TABANAN, BALI",13,242,14,256
https://kawalpemilu.org#53352,"DELOD PEKEN, TABANAN, TABANAN, BALI",14,196,11,207
https://kawalpemilu.org#53352,"DELOD PEKEN, TABANAN, TABANAN, BALI",15,183,17,200
https://kawalpemilu.org#53352,"DELOD PEKEN, TABANAN, TABANAN, BALI",16,159,12,171
https://kawalpemilu.org#53352,"DELOD PEKEN, TABANAN, TABANAN, BALI",17,199,21,220
https://kawalpemilu.org#53352,"DELOD PEKEN, TABANAN, TABANAN, BALI",18,207,32,239
https://kawalpemilu.org#53352,"DELOD PEKEN, TABANAN, TABANAN, BALI",19,181,36,217
https://kawalpemilu.org#53352,"DELOD PEKEN, TABANAN, TABANAN, BALI",20,241,12,253
https://kawalpemilu.org#53352,"DELOD PEKEN, TABANAN, TABANAN, BALI",21,214,26,240
https://kawalpemilu.org#53352,"DELOD PEKEN, TABANAN, TABANAN, BALI",22,158,52,210
https://kawalpemilu.org#53352,"DELOD PEKEN, TABANAN, TABANAN, BALI",23,186,47,233
https://kawalpemilu.org#53352,"DELOD PEKEN, TABANAN, TABANAN, BALI",24,235,21,256
https://kawalpemilu.org#53352,"DELOD PEKEN, TABANAN, TABANAN, BALI",25,221,34,255
https://kawalpemilu.org#53352,"DELOD PEKEN, TABANAN, TABANAN, BALI",26,243,21,264
https://kawalpemilu.org#53352,"DELOD PEKEN, TABANAN, TABANAN, BALI",27,189,9,198
https://kawalpemilu.org#53352,"DELOD PEKEN, TABANAN, TABANAN, BALI",28,205,5,210
https://kawalpemilu.org#53352,"DELOD PEKEN, TABANAN, TABANAN, BALI",29,221,1,222
https://kawalpemilu.org#53353,"DAUH PEKEN, TABANAN, TABANAN, BALI",1,284,0,284
https://kawalpemilu.org#53353,"DAUH PEKEN, TABANAN, TABANAN, BALI",2,271,9,280
https://kawalpemilu.org#53353,"DAUH PEKEN, TABANAN, TABANAN, BALI",3,240,16,256
https://kawalpemilu.org#53353,"DAUH PEKEN, TABANAN, TABANAN, BALI",4,247,4,251
https://kawalpemilu.org#53353,"DAUH PEKEN, TABANAN, TABANAN, BALI",5,240,8,248
https://kawalpemilu.org#53353,"DAUH PEKEN, TABANAN, TABANAN, BALI",6,263,6,269
https://kawalpemilu.org#53353,"DAUH PEKEN, TABANAN, TABANAN, BALI",7,275,3,278
https://kawalpemilu.org#53353,"DAUH PEKEN, TABANAN, TABANAN, BALI",8,287,0,287
https://kawalpemilu.org#53353,"DAUH PEKEN, TABANAN, TABANAN, BALI",9,276,0,276
https://kawalpemilu.org#53353,"DAUH PEKEN, TABANAN, TABANAN, BALI",10,234,1,235
https://kawalpemilu.org#53353,"DAUH PEKEN, TABANAN, TABANAN, BALI",11,258,6,264
https://kawalpemilu.org#53353,"DAUH PEKEN, TABANAN, TABANAN, BALI",12,230,4,234
https://kawalpemilu.org#53353,"DAUH PEKEN, TABANAN, TABANAN, BALI",13,190,10,200
https://kawalpemilu.org#53353,"DAUH PEKEN, TABANAN, TABANAN, BALI",14,189,22,211
https://kawalpemilu.org#53353,"DAUH PEKEN, TABANAN, TABANAN, BALI",15,191,12,203
https://kawalpemilu.org#53353,"DAUH PEKEN, TABANAN, TABANAN, BALI",16,177,9,186
https://kawalpemilu.org#53353,"DAUH PEKEN, TABANAN, TABANAN, BALI",17,194,11,205
https://kawalpemilu.org#53353,"DAUH PEKEN, TABANAN, TABANAN, BALI",18,244,4,248
https://kawalpemilu.org#53353,"DAUH PEKEN, TABANAN, TABANAN, BALI",19,245,12,257
https://kawalpemilu.org#53353,"DAUH PEKEN, TABANAN, TABANAN, BALI",20,247,12,259
https://kawalpemilu.org#53353,"DAUH PEKEN, TABANAN, TABANAN, BALI",21,223,28,251
https://kawalpemilu.org#53353,"DAUH PEKEN, TABANAN, TABANAN, BALI",22,201,23,224
https://kawalpemilu.org#53353,"DAUH PEKEN, TABANAN, TABANAN, BALI",23,220,12,232
https://kawalpemilu.org#53353,"DAUH PEKEN, TABANAN, TABANAN, BALI",24,254,7,261
https://kawalpemilu.org#53353,"DAUH PEKEN, TABANAN, TABANAN, BALI",25,203,41,243
https://kawalpemilu.org#53353,"DAUH PEKEN, TABANAN, TABANAN, BALI",26,213,3,216
https://kawalpemilu.org#53353,"DAUH PEKEN, TABANAN, TABANAN, BALI",27,170,35,205
https://kawalpemilu.org#53353,"DAUH PEKEN, TABANAN, TABANAN, BALI",28,147,70,217
https://kawalpemilu.org#53353,"DAUH PEKEN, TABANAN, TABANAN, BALI",29,93,32,125
https://kawalpemilu.org#53353,"DAUH PEKEN, TABANAN, TABANAN, BALI",30,133,88,221
https://kawalpemilu.org#53353,"DAUH PEKEN, TABANAN, TABANAN, BALI",31,171,90,261
https://kawalpemilu.org#53353,"DAUH PEKEN, TABANAN, TABANAN, BALI",32,111,59,170
https://kawalpemilu.org#53353,"DAUH PEKEN, TABANAN, TABANAN, BALI",33,165,84,249
https://kawalpemilu.org#53353,"DAUH PEKEN, TABANAN, TABANAN, BALI",34,134,89,223
https://kawalpemilu.org#53353,"DAUH PEKEN, TABANAN, TABANAN, BALI",35,146,103,249
https://kawalpemilu.org#53353,"DAUH PEKEN, TABANAN, TABANAN, BALI",36,90,77,167
https://kawalpemilu.org#53354,"DAJAN PEKEN, TABANAN, TABANAN, BALI",1,198,11,209
https://kawalpemilu.org#53354,"DAJAN PEKEN, TABANAN, TABANAN, BALI",2,198,11,209
https://kawalpemilu.org#53354,"DAJAN PEKEN, TABANAN, TABANAN, BALI",3,165,12,177
https://kawalpemilu.org#53354,"DAJAN PEKEN, TABANAN, TABANAN, BALI",4,185,3,188
https://kawalpemilu.org#53354,"DAJAN PEKEN, TABANAN, TABANAN, BALI",5,0,0,0
https://kawalpemilu.org#53354,"DAJAN PEKEN, TABANAN, TABANAN, BALI",6,183,3,186
https://kawalpemilu.org#53354,"DAJAN PEKEN, TABANAN, TABANAN, BALI",7,161,9,170
https://kawalpemilu.org#53354,"DAJAN PEKEN, TABANAN, TABANAN, BALI",8,179,10,189
https://kawalpemilu.org#53354,"DAJAN PEKEN, TABANAN, TABANAN, BALI",9,168,12,180
https://kawalpemilu.org#53354,"DAJAN PEKEN, TABANAN, TABANAN, BALI",10,195,9,204
https://kawalpemilu.org#53354,"DAJAN PEKEN, TABANAN, TABANAN, BALI",11,180,7,187
https://kawalpemilu.org#53354,"DAJAN PEKEN, TABANAN, TABANAN, BALI",12,232,12,244
https://kawalpemilu.org#53354,"DAJAN PEKEN, TABANAN, TABANAN, BALI",13,236,9,245
https://kawalpemilu.org#53354,"DAJAN PEKEN, TABANAN, TABANAN, BALI",14,131,27,158
https://kawalpemilu.org#53354,"DAJAN PEKEN, TABANAN, TABANAN, BALI",15,151,24,175
https://kawalpemilu.org#53354,"DAJAN PEKEN, TABANAN, TABANAN, BALI",16,243,8,251
https://kawalpemilu.org#53354,"DAJAN PEKEN, TABANAN, TABANAN, BALI",17,214,6,220
https://kawalpemilu.org#53354,"DAJAN PEKEN, TABANAN, TABANAN, BALI",18,239,16,255
https://kawalpemilu.org#53354,"DAJAN PEKEN, TABANAN, TABANAN, BALI",19,232,20,252
https://kawalpemilu.org#53354,"DAJAN PEKEN, TABANAN, TABANAN, BALI",20,217,19,236
https://kawalpemilu.org#53354,"DAJAN PEKEN, TABANAN, TABANAN, BALI",21,219,8,227
https://kawalpemilu.org#53354,"DAJAN PEKEN, TABANAN, TABANAN, BALI",22,155,25,180
https://kawalpemilu.org#53354,"DAJAN PEKEN, TABANAN, TABANAN, BALI",23,142,22,164
https://kawalpemilu.org#53354,"DAJAN PEKEN, TABANAN, TABANAN, BALI",24,156,25,181
https://kawalpemilu.org#53354,"DAJAN PEKEN, TABANAN, TABANAN, BALI",25,157,15,172
https://kawalpemilu.org#53354,"DAJAN PEKEN, TABANAN, TABANAN, BALI",26,145,24,169
https://kawalpemilu.org#53354,"DAJAN PEKEN, TABANAN, TABANAN, BALI",27,165,16,181
https://kawalpemilu.org#53354,"DAJAN PEKEN, TABANAN, TABANAN, BALI",28,178,22,200
https://kawalpemilu.org#53354,"DAJAN PEKEN, TABANAN, TABANAN, BALI",29,172,14,186
https://kawalpemilu.org#53354,"DAJAN PEKEN, TABANAN, TABANAN, BALI",30,192,5,197
https://kawalpemilu.org#53354,"DAJAN PEKEN, TABANAN, TABANAN, BALI",31,177,9,186
https://kawalpemilu.org#53354,"DAJAN PEKEN, TABANAN, TABANAN, BALI",32,50,27,77
https://kawalpemilu.org#53355,"DENBANTAS, TABANAN, TABANAN, BALI",1,235,7,242
https://kawalpemilu.org#53355,"DENBANTAS, TABANAN, TABANAN, BALI",2,210,14,224
https://kawalpemilu.org#53355,"DENBANTAS, TABANAN, TABANAN, BALI",3,197,12,209
https://kawalpemilu.org#53355,"DENBANTAS, TABANAN, TABANAN, BALI",4,191,18,4
https://kawalpemilu.org#53355,"DENBANTAS, TABANAN, TABANAN, BALI",6,193,20,213
https://kawalpemilu.org#53355,"DENBANTAS, TABANAN, TABANAN, BALI",7,145,1,146
https://kawalpemilu.org#53355,"DENBANTAS, TABANAN, TABANAN, BALI",8,147,3,150
https://kawalpemilu.org#53355,"DENBANTAS, TABANAN, TABANAN, BALI",9,201,15,216
https://kawalpemilu.org#53355,"DENBANTAS, TABANAN, TABANAN, BALI",10,174,13,187
https://kawalpemilu.org#53355,"DENBANTAS, TABANAN, TABANAN, BALI",11,219,9,228
https://kawalpemilu.org#53355,"DENBANTAS, TABANAN, TABANAN, BALI",12,186,13,199
https://kawalpemilu.org#53355,"DENBANTAS, TABANAN, TABANAN, BALI",13,177,8,185
https://kawalpemilu.org#53355,"DENBANTAS, TABANAN, TABANAN, BALI",14,155,7,162
https://kawalpemilu.org#53355,"DENBANTAS, TABANAN, TABANAN, BALI",15,189,7,196
https://kawalpemilu.org#53355,"DENBANTAS, TABANAN, TABANAN, BALI",16,183,2,185
https://kawalpemilu.org#53355,"DENBANTAS, TABANAN, TABANAN, BALI",17,180,6,186
https://kawalpemilu.org#53355,"DENBANTAS, TABANAN, TABANAN, BALI",18,176,12,188
https://kawalpemilu.org#53355,"DENBANTAS, TABANAN, TABANAN, BALI",19,173,14,187
https://kawalpemilu.org#53355,"DENBANTAS, TABANAN, TABANAN, BALI",20,141,10,151
https://kawalpemilu.org#53355,"DENBANTAS, TABANAN, TABANAN, BALI",21,119,15,134
https://kawalpemilu.org#53355,"DENBANTAS, TABANAN, TABANAN, BALI",22,176,17,193
https://kawalpemilu.org#53356,"SUBAMIA, TABANAN, TABANAN, BALI",1,262,4,266
https://kawalpemilu.org#53356,"SUBAMIA, TABANAN, TABANAN, BALI",2,113,2,215
https://kawalpemilu.org#53356,"SUBAMIA, TABANAN, TABANAN, BALI",3,196,1,197
https://kawalpemilu.org#53356,"SUBAMIA, TABANAN, TABANAN, BALI",4,221,8,229
https://kawalpemilu.org#53356,"SUBAMIA, TABANAN, TABANAN, BALI",5,235,6,241
https://kawalpemilu.org#53356,"SUBAMIA, TABANAN, TABANAN, BALI",6,198,8,206
https://kawalpemilu.org#53356,"SUBAMIA, TABANAN, TABANAN, BALI",7,194,14,208
https://kawalpemilu.org#53357,"WANASARI, TABANAN, TABANAN, BALI",1,235,6,241
https://kawalpemilu.org#53357,"WANASARI, TABANAN, TABANAN, BALI",2,231,10,241
https://kawalpemilu.org#53357,"WANASARI, TABANAN, TABANAN, BALI",3,227,7,234
https://kawalpemilu.org#53357,"WANASARI, TABANAN, TABANAN, BALI",4,231,14,245
https://kawalpemilu.org#53357,"WANASARI, TABANAN, TABANAN, BALI",5,179,11,190
https://kawalpemilu.org#53357,"WANASARI, TABANAN, TABANAN, BALI",6,193,8,201
https://kawalpemilu.org#53357,"WANASARI, TABANAN, TABANAN, BALI",7,200,0,200
https://kawalpemilu.org#53357,"WANASARI, TABANAN, TABANAN, BALI",8,216,8,224
https://kawalpemilu.org#53358,"TUNJUK, TABANAN, TABANAN, BALI",1,214,4,218
https://kawalpemilu.org#53358,"TUNJUK, TABANAN, TABANAN, BALI",2,134,2,136
https://kawalpemilu.org#53358,"TUNJUK, TABANAN, TABANAN, BALI",3,196,11,207
https://kawalpemilu.org#53358,"TUNJUK, TABANAN, TABANAN, BALI",4,204,4,208
https://kawalpemilu.org#53358,"TUNJUK, TABANAN, TABANAN, BALI",5,189,5,194
https://kawalpemilu.org#53358,"TUNJUK, TABANAN, TABANAN, BALI",6,213,1,214
https://kawalpemilu.org#53358,"TUNJUK, TABANAN, TABANAN, BALI",7,181,9,190
https://kawalpemilu.org#53358,"TUNJUK, TABANAN, TABANAN, BALI",8,236,9,245
https://kawalpemilu.org#53358,"TUNJUK, TABANAN, TABANAN, BALI",9,181,17,198
https://kawalpemilu.org#53358,"TUNJUK, TABANAN, TABANAN, BALI",10,202,10,212
https://kawalpemilu.org#53358,"TUNJUK, TABANAN, TABANAN, BALI",11,196,21,217
https://kawalpemilu.org#53358,"TUNJUK, TABANAN, TABANAN, BALI",12,205,25,230
https://kawalpemilu.org#53358,"TUNJUK, TABANAN, TABANAN, BALI",13,238,13,251
https://kawalpemilu.org#53358,"TUNJUK, TABANAN, TABANAN, BALI",14,260,3,263
https://kawalpemilu.org#53358,"TUNJUK, TABANAN, TABANAN, BALI",15,239,17,256
https://kawalpemilu.org#53358,"TUNJUK, TABANAN, TABANAN, BALI",16,256,6,262
https://kawalpemilu.org#53359,"BUAHAN, TABANAN, TABANAN, BALI",1,219,10,229
https://kawalpemilu.org#53359,"BUAHAN, TABANAN, TABANAN, BALI",2,216,13,229
https://kawalpemilu.org#53359,"BUAHAN, TABANAN, TABANAN, BALI",3,201,15,216
https://kawalpemilu.org#53359,"BUAHAN, TABANAN, TABANAN, BALI",4,223,8,231
https://kawalpemilu.org#53359,"BUAHAN, TABANAN, TABANAN, BALI",5,211,12,223
https://kawalpemilu.org#53359,"BUAHAN, TABANAN, TABANAN, BALI",6,215,21,236
https://kawalpemilu.org#53359,"BUAHAN, TABANAN, TABANAN, BALI",7,215,8,223
https://kawalpemilu.org#53359,"BUAHAN, TABANAN, TABANAN, BALI",8,223,7,230
https://kawalpemilu.org#53360,"SESANDAN, TABANAN, TABANAN, BALI",1,209,3,212
https://kawalpemilu.org#53360,"SESANDAN, TABANAN, TABANAN, BALI",2,201,8,209
https://kawalpemilu.org#53360,"SESANDAN, TABANAN, TABANAN, BALI",3,232,11,243
https://kawalpemilu.org#53360,"SESANDAN, TABANAN, TABANAN, BALI",4,203,6,209
https://kawalpemilu.org#53360,"SESANDAN, TABANAN, TABANAN, BALI",5,160,3,163
https://kawalpemilu.org#53360,"SESANDAN, TABANAN, TABANAN, BALI",6,164,7,171
https://kawalpemilu.org#53360,"SESANDAN, TABANAN, TABANAN, BALI",7,217,10,227
https://kawalpemilu.org#53360,"SESANDAN, TABANAN, TABANAN, BALI",8,226,4,230
https://kawalpemilu.org#53362,"BENGKEL, KEDIRI, TABANAN, BALI",1,222,7,229
https://kawalpemilu.org#53362,"BENGKEL, KEDIRI, TABANAN, BALI",2,219,4,223
https://kawalpemilu.org#53362,"BENGKEL, KEDIRI, TABANAN, BALI",3,215,12,227
https://kawalpemilu.org#53362,"BENGKEL, KEDIRI, TABANAN, BALI",4,197,11,208
https://kawalpemilu.org#53362,"BENGKEL, KEDIRI, TABANAN, BALI",5,295,0,295
https://kawalpemilu.org#53362,"BENGKEL, KEDIRI, TABANAN, BALI",6,296,0,296
https://kawalpemilu.org#53362,"BENGKEL, KEDIRI, TABANAN, BALI",7,275,4,279
https://kawalpemilu.org#53363,"PANGKUNG TIBAH, KEDIRI, TABANAN, BALI",1,267,2,269
https://kawalpemilu.org#53363,"PANGKUNG TIBAH, KEDIRI, TABANAN, BALI",2,274,1,275
https://kawalpemilu.org#53363,"PANGKUNG TIBAH, KEDIRI, TABANAN, BALI",3,227,6,233
https://kawalpemilu.org#53363,"PANGKUNG TIBAH, KEDIRI, TABANAN, BALI",4,188,2,190
https://kawalpemilu.org#53364,"BELALANG, KEDIRI, TABANAN, BALI",1,246,11,257
https://kawalpemilu.org#53364,"BELALANG, KEDIRI, TABANAN, BALI",2,243,7,250
https://kawalpemilu.org#53364,"BELALANG, KEDIRI, TABANAN, BALI",3,240,23,263
https://kawalpemilu.org#53364,"BELALANG, KEDIRI, TABANAN, BALI",4,252,19,271
https://kawalpemilu.org#53364,"BELALANG, KEDIRI, TABANAN, BALI",5,239,31,270
https://kawalpemilu.org#53364,"BELALANG, KEDIRI, TABANAN, BALI",6,219,26,245
https://kawalpemilu.org#53364,"BELALANG, KEDIRI, TABANAN, BALI",7,224,8,232
https://kawalpemilu.org#53364,"BELALANG, KEDIRI, TABANAN, BALI",8,194,3,197
https://kawalpemilu.org#53365,"BERABAN, KEDIRI, TABANAN, BALI",1,212,37,249
https://kawalpemilu.org#53365,"BERABAN, KEDIRI, TABANAN, BALI",2,198,40,238
https://kawalpemilu.org#53365,"BERABAN, KEDIRI, TABANAN, BALI",3,201,23,224
https://kawalpemilu.org#53365,"BERABAN, KEDIRI, TABANAN, BALI",4,198,20,218
https://kawalpemilu.org#53365,"BERABAN, KEDIRI, TABANAN, BALI",5,206,9,215
https://kawalpemilu.org#53365,"BERABAN, KEDIRI, TABANAN, BALI",6,208,2,210
https://kawalpemilu.org#53365,"BERABAN, KEDIRI, TABANAN, BALI",7,188,9,197
https://kawalpemilu.org#53365,"BERABAN, KEDIRI, TABANAN, BALI",8,202,11,213
https://kawalpemilu.org#53365,"BERABAN, KEDIRI, TABANAN, BALI",9,217,12,229
https://kawalpemilu.org#53365,"BERABAN, KEDIRI, TABANAN, BALI",10,234,4,238
https://kawalpemilu.org#53365,"BERABAN, KEDIRI, TABANAN, BALI",11,215,11,226
https://kawalpemilu.org#53365,"BERABAN, KEDIRI, TABANAN, BALI",12,221,1,222
https://kawalpemilu.org#53365,"BERABAN, KEDIRI, TABANAN, BALI",13,204,4,208
https://kawalpemilu.org#53365,"BERABAN, KEDIRI, TABANAN, BALI",14,243,2,245
https://kawalpemilu.org#53365,"BERABAN, KEDIRI, TABANAN, BALI",15,258,4,262
https://kawalpemilu.org#53365,"BERABAN, KEDIRI, TABANAN, BALI",16,273,1,274
https://kawalpemilu.org#53365,"BERABAN, KEDIRI, TABANAN, BALI",17,247,0,247
https://kawalpemilu.org#53365,"BERABAN, KEDIRI, TABANAN, BALI",18,239,7,246
https://kawalpemilu.org#53365,"BERABAN, KEDIRI, TABANAN, BALI",19,217,1,218
https://kawalpemilu.org#53365,"BERABAN, KEDIRI, TABANAN, BALI",20,183,2,185
https://kawalpemilu.org#53365,"BERABAN, KEDIRI, TABANAN, BALI",21,199,3,202
https://kawalpemilu.org#53366,"BUWIT, KEDIRI, TABANAN, BALI",1,212,17,229
https://kawalpemilu.org#53366,"BUWIT, KEDIRI, TABANAN, BALI",2,150,13,163
https://kawalpemilu.org#53366,"BUWIT, KEDIRI, TABANAN, BALI",3,147,10,157
https://kawalpemilu.org#53366,"BUWIT, KEDIRI, TABANAN, BALI",4,156,5,161
https://kawalpemilu.org#53366,"BUWIT, KEDIRI, TABANAN, BALI",5,171,20,191
https://kawalpemilu.org#53366,"BUWIT, KEDIRI, TABANAN, BALI",6,183,1,184
https://kawalpemilu.org#53366,"BUWIT, KEDIRI, TABANAN, BALI",7,186,2,188
https://kawalpemilu.org#53366,"BUWIT, KEDIRI, TABANAN, BALI",8,220,1,221
https://kawalpemilu.org#53366,"BUWIT, KEDIRI, TABANAN, BALI",9,221,4,225
https://kawalpemilu.org#53367,"CEPAKA, KEDIRI, TABANAN, BALI",1,261,2,263
https://kawalpemilu.org#53367,"CEPAKA, KEDIRI, TABANAN, BALI",2,238,10,248
https://kawalpemilu.org#53367,"CEPAKA, KEDIRI, TABANAN, BALI",3,234,11,245
https://kawalpemilu.org#53367,"CEPAKA, KEDIRI, TABANAN, BALI",4,249,20,269
https://kawalpemilu.org#53367,"CEPAKA, KEDIRI, TABANAN, BALI",5,247,9,256
https://kawalpemilu.org#53367,"CEPAKA, KEDIRI, TABANAN, BALI",6,259,8,267
https://kawalpemilu.org#53368,"KABA KABA, KEDIRI, TABANAN, BALI",1,273,4,277
https://kawalpemilu.org#53368,"KABA KABA, KEDIRI, TABANAN, BALI",2,269,5,274
https://kawalpemilu.org#53368,"KABA KABA, KEDIRI, TABANAN, BALI",3,251,10,261
https://kawalpemilu.org#53368,"KABA KABA, KEDIRI, TABANAN, BALI",4,277,1,278
https://kawalpemilu.org#53368,"KABA KABA, KEDIRI, TABANAN, BALI",5,268,2,270
https://kawalpemilu.org#53368,"KABA KABA, KEDIRI, TABANAN, BALI",6,194,0,194
https://kawalpemilu.org#53368,"KABA KABA, KEDIRI, TABANAN, BALI",7,245,7,252
https://kawalpemilu.org#53368,"KABA KABA, KEDIRI, TABANAN, BALI",8,179,0,179
https://kawalpemilu.org#53368,"KABA KABA, KEDIRI, TABANAN, BALI",9,175,3,178
https://kawalpemilu.org#53368,"KABA KABA, KEDIRI, TABANAN, BALI",10,190,0,190
https://kawalpemilu.org#53368,"KABA KABA, KEDIRI, TABANAN, BALI",11,182,0,182
https://kawalpemilu.org#53368,"KABA KABA, KEDIRI, TABANAN, BALI",12,163,2,165
https://kawalpemilu.org#53368,"KABA KABA, KEDIRI, TABANAN, BALI",13,185,1,186
https://kawalpemilu.org#53368,"KABA KABA, KEDIRI, TABANAN, BALI",14,248,0,248
https://kawalpemilu.org#53368,"KABA KABA, KEDIRI, TABANAN, BALI",15,245,0,245
https://kawalpemilu.org#53368,"KABA KABA, KEDIRI, TABANAN, BALI",16,213,4,217
https://kawalpemilu.org#53368,"KABA KABA, KEDIRI, TABANAN, BALI",17,237,1,238
https://kawalpemilu.org#53368,"KABA KABA, KEDIRI, TABANAN, BALI",18,143,1,144
https://kawalpemilu.org#53368,"KABA KABA, KEDIRI, TABANAN, BALI",19,191,3,194
https://kawalpemilu.org#53368,"KABA KABA, KEDIRI, TABANAN, BALI",20,159,1,160
https://kawalpemilu.org#53368,"KABA KABA, KEDIRI, TABANAN, BALI",21,272,10,282
https://kawalpemilu.org#53368,"KABA KABA, KEDIRI, TABANAN, BALI",22,258,13,271
https://kawalpemilu.org#53368,"KABA KABA, KEDIRI, TABANAN, BALI",23,272,9,281
https://kawalpemilu.org#53368,"KABA KABA, KEDIRI, TABANAN, BALI",24,208,11,219
https://kawalpemilu.org#53369,"NYAMBU, KEDIRI, TABANAN, BALI",1,244,9,253
https://kawalpemilu.org#53369,"NYAMBU, KEDIRI, TABANAN, BALI",2,274,0,274
https://kawalpemilu.org#53369,"NYAMBU, KEDIRI, TABANAN, BALI",3,263,3,266
https://kawalpemilu.org#53369,"NYAMBU, KEDIRI, TABANAN, BALI",4,252,2,254
https://kawalpemilu.org#53369,"NYAMBU, KEDIRI, TABANAN, BALI",5,228,10,238
https://kawalpemilu.org#53369,"NYAMBU, KEDIRI, TABANAN, BALI",6,222,9,231
https://kawalpemilu.org#53369,"NYAMBU, KEDIRI, TABANAN, BALI",7,229,12,241
https://kawalpemilu.org#53369,"NYAMBU, KEDIRI, TABANAN, BALI",8,243,9,252
https://kawalpemilu.org#53369,"NYAMBU, KEDIRI, TABANAN, BALI",9,202,9,211
https://kawalpemilu.org#53369,"NYAMBU, KEDIRI, TABANAN, BALI",10,197,16,213
https://kawalpemilu.org#53370,"PANDAK BANDUNG, KEDIRI, TABANAN, BALI",1,168,20,188
https://kawalpemilu.org#53370,"PANDAK BANDUNG, KEDIRI, TABANAN, BALI",2,197,11,208
https://kawalpemilu.org#53370,"PANDAK BANDUNG, KEDIRI, TABANAN, BALI",3,156,16,172
https://kawalpemilu.org#53370,"PANDAK BANDUNG, KEDIRI, TABANAN, BALI",4,183,9,192
https://kawalpemilu.org#53370,"PANDAK BANDUNG, KEDIRI, TABANAN, BALI",5,189,2,191
https://kawalpemilu.org#53370,"PANDAK BANDUNG, KEDIRI, TABANAN, BALI",6,185,7,192
https://kawalpemilu.org#53370,"PANDAK BANDUNG, KEDIRI, TABANAN, BALI",7,240,7,247
https://kawalpemilu.org#53370,"PANDAK BANDUNG, KEDIRI, TABANAN, BALI",8,259,5,264
https://kawalpemilu.org#53370,"PANDAK BANDUNG, KEDIRI, TABANAN, BALI",9,238,6,244
https://kawalpemilu.org#53371,"PANDAK GEDE, KEDIRI, TABANAN, BALI",1,254,10,264
https://kawalpemilu.org#53371,"PANDAK GEDE, KEDIRI, TABANAN, BALI",2,246,9,255
https://kawalpemilu.org#53371,"PANDAK GEDE, KEDIRI, TABANAN, BALI",3,257,22,279
https://kawalpemilu.org#53371,"PANDAK GEDE, KEDIRI, TABANAN, BALI",4,168,11,179
https://kawalpemilu.org#53371,"PANDAK GEDE, KEDIRI, TABANAN, BALI",5,166,5,171
https://kawalpemilu.org#53371,"PANDAK GEDE, KEDIRI, TABANAN, BALI",6,135,4,139
https://kawalpemilu.org#53371,"PANDAK GEDE, KEDIRI, TABANAN, BALI",7,181,4,185
https://kawalpemilu.org#53371,"PANDAK GEDE, KEDIRI, TABANAN, BALI",8,163,4,167
https://kawalpemilu.org#53371,"PANDAK GEDE, KEDIRI, TABANAN, BALI",9,201,1,202
https://kawalpemilu.org#53371,"PANDAK GEDE, KEDIRI, TABANAN, BALI",10,196,0,196
https://kawalpemilu.org#53371,"PANDAK GEDE, KEDIRI, TABANAN, BALI",11,239,15,254
https://kawalpemilu.org#53371,"PANDAK GEDE, KEDIRI, TABANAN, BALI",12,226,13,239
https://kawalpemilu.org#53371,"PANDAK GEDE, KEDIRI, TABANAN, BALI",13,189,4,193
https://kawalpemilu.org#53371,"PANDAK GEDE, KEDIRI, TABANAN, BALI",14,179,11,190
https://kawalpemilu.org#53371,"PANDAK GEDE, KEDIRI, TABANAN, BALI",15,204,3,207
https://kawalpemilu.org#53371,"PANDAK GEDE, KEDIRI, TABANAN, BALI",16,222,9,231
https://kawalpemilu.org#53371,"PANDAK GEDE, KEDIRI, TABANAN, BALI",17,218,13,231
https://kawalpemilu.org#53371,"PANDAK GEDE, KEDIRI, TABANAN, BALI",18,206,13,219
https://kawalpemilu.org#53371,"PANDAK GEDE, KEDIRI, TABANAN, BALI",19,226,11,237
https://kawalpemilu.org#53371,"PANDAK GEDE, KEDIRI, TABANAN, BALI",20,254,10,264
https://kawalpemilu.org#53372,"NYITDAH, KEDIRI, TABANAN, BALI",1,213,14,227
https://kawalpemilu.org#53372,"NYITDAH, KEDIRI, TABANAN, BALI",2,189,22,211
https://kawalpemilu.org#53372,"NYITDAH, KEDIRI, TABANAN, BALI",3,225,12,237
https://kawalpemilu.org#53372,"NYITDAH, KEDIRI, TABANAN, BALI",4,227,18,245
https://kawalpemilu.org#53372,"NYITDAH, KEDIRI, TABANAN, BALI",5,253,31,284
https://kawalpemilu.org#53372,"NYITDAH, KEDIRI, TABANAN, BALI",6,283,2,285
https://kawalpemilu.org#53372,"NYITDAH, KEDIRI, TABANAN, BALI",7,283,9,0
https://kawalpemilu.org#53372,"NYITDAH, KEDIRI, TABANAN, BALI",9,246,5,251
https://kawalpemilu.org#53372,"NYITDAH, KEDIRI, TABANAN, BALI",10,258,12,270
https://kawalpemilu.org#53372,"NYITDAH, KEDIRI, TABANAN, BALI",11,255,0,0
https://kawalpemilu.org#53372,"NYITDAH, KEDIRI, TABANAN, BALI",12,240,5,245
https://kawalpemilu.org#53372,"NYITDAH, KEDIRI, TABANAN, BALI",13,260,10,270
https://kawalpemilu.org#53373,"PEJATEN, KEDIRI, TABANAN, BALI",1,272,3,275
https://kawalpemilu.org#53373,"PEJATEN, KEDIRI, TABANAN, BALI",2,253,7,261
https://kawalpemilu.org#53373,"PEJATEN, KEDIRI, TABANAN, BALI",3,213,10,223
https://kawalpemilu.org#53373,"PEJATEN, KEDIRI, TABANAN, BALI",4,213,8,221
https://kawalpemilu.org#53373,"PEJATEN, KEDIRI, TABANAN, BALI",5,257,5,262
https://kawalpemilu.org#53373,"PEJATEN, KEDIRI, TABANAN, BALI",6,163,0,163
https://kawalpemilu.org#53373,"PEJATEN, KEDIRI, TABANAN, BALI",7,268,7,275
https://kawalpemilu.org#53373,"PEJATEN, KEDIRI, TABANAN, BALI",8,195,7,202
https://kawalpemilu.org#53373,"PEJATEN, KEDIRI, TABANAN, BALI",9,235,6,241
https://kawalpemilu.org#53373,"PEJATEN, KEDIRI, TABANAN, BALI",10,240,4,244
https://kawalpemilu.org#53373,"PEJATEN, KEDIRI, TABANAN, BALI",11,257,5,262
https://kawalpemilu.org#53373,"PEJATEN, KEDIRI, TABANAN, BALI",12,237,6,243
https://kawalpemilu.org#53373,"PEJATEN, KEDIRI, TABANAN, BALI",13,252,6,258
https://kawalpemilu.org#53374,"KEDIRI, KEDIRI, TABANAN, BALI",1,164,16,180
https://kawalpemilu.org#53374,"KEDIRI, KEDIRI, TABANAN, BALI",2,195,24,219
https://kawalpemilu.org#53374,"KEDIRI, KEDIRI, TABANAN, BALI",3,177,17,194
https://kawalpemilu.org#53374,"KEDIRI, KEDIRI, TABANAN, BALI",4,139,18,157
https://kawalpemilu.org#53374,"KEDIRI, KEDIRI, TABANAN, BALI",5,164,6,170
https://kawalpemilu.org#53374,"KEDIRI, KEDIRI, TABANAN, BALI",6,171,18,189
https://kawalpemilu.org#53374,"KEDIRI, KEDIRI, TABANAN, BALI",7,185,33,218
https://kawalpemilu.org#53374,"KEDIRI, KEDIRI, TABANAN, BALI",8,218,7,225
https://kawalpemilu.org#53374,"KEDIRI, KEDIRI, TABANAN, BALI",9,153,35,188
https://kawalpemilu.org#53374,"KEDIRI, KEDIRI, TABANAN, BALI",10,182,16,198
https://kawalpemilu.org#53374,"KEDIRI, KEDIRI, TABANAN, BALI",11,224,11,235
https://kawalpemilu.org#53374,"KEDIRI, KEDIRI, TABANAN, BALI",12,211,16,227
https://kawalpemilu.org#53374,"KEDIRI, KEDIRI, TABANAN, BALI",13,212,13,225
https://kawalpemilu.org#53374,"KEDIRI, KEDIRI, TABANAN, BALI",14,225,7,232
https://kawalpemilu.org#53374,"KEDIRI, KEDIRI, TABANAN, BALI",15,216,8,224
https://kawalpemilu.org#53374,"KEDIRI, KEDIRI, TABANAN, BALI",16,223,6,229
https://kawalpemilu.org#53374,"KEDIRI, KEDIRI, TABANAN, BALI",17,174,4,178
https://kawalpemilu.org#53374,"KEDIRI, KEDIRI, TABANAN, BALI",18,175,7,182
https://kawalpemilu.org#53374,"KEDIRI, KEDIRI, TABANAN, BALI",19,194,8,202
https://kawalpemilu.org#53374,"KEDIRI, KEDIRI, TABANAN, BALI",20,198,6,204
https://kawalpemilu.org#53374,"KEDIRI, KEDIRI, TABANAN, BALI",21,190,3,193
https://kawalpemilu.org#53374,"KEDIRI, KEDIRI, TABANAN, BALI",22,212,15,227
https://kawalpemilu.org#53374,"KEDIRI, KEDIRI, TABANAN, BALI",23,204,7,211
https://kawalpemilu.org#53374,"KEDIRI, KEDIRI, TABANAN, BALI",24,183,14,197
https://kawalpemilu.org#53374,"KEDIRI, KEDIRI, TABANAN, BALI",25,175,12,187
https://kawalpemilu.org#53374,"KEDIRI, KEDIRI, TABANAN, BALI",26,202,9,211
https://kawalpemilu.org#53374,"KEDIRI, KEDIRI, TABANAN, BALI",27,204,9,213
https://kawalpemilu.org#53374,"KEDIRI, KEDIRI, TABANAN, BALI",28,232,4,236
https://kawalpemilu.org#53374,"KEDIRI, KEDIRI, TABANAN, BALI",29,236,4,240
https://kawalpemilu.org#53374,"KEDIRI, KEDIRI, TABANAN, BALI",30,233,5,238
https://kawalpemilu.org#53375,"ABIAN TUWUNG, KEDIRI, TABANAN, BALI",1,235,4,239
https://kawalpemilu.org#53375,"ABIAN TUWUNG, KEDIRI, TABANAN, BALI",2,260,3,263
https://kawalpemilu.org#53375,"ABIAN TUWUNG, KEDIRI, TABANAN, BALI",3,253,6,259
https://kawalpemilu.org#53375,"ABIAN TUWUNG, KEDIRI, TABANAN, BALI",4,192,4,196
https://kawalpemilu.org#53375,"ABIAN TUWUNG, KEDIRI, TABANAN, BALI",5,228,3,231
https://kawalpemilu.org#53375,"ABIAN TUWUNG, KEDIRI, TABANAN, BALI",6,254,4,258
https://kawalpemilu.org#53375,"ABIAN TUWUNG, KEDIRI, TABANAN, BALI",7,227,13,240
https://kawalpemilu.org#53375,"ABIAN TUWUNG, KEDIRI, TABANAN, BALI",8,188,24,212
https://kawalpemilu.org#53375,"ABIAN TUWUNG, KEDIRI, TABANAN, BALI",9,226,17,243
https://kawalpemilu.org#53375,"ABIAN TUWUNG, KEDIRI, TABANAN, BALI",10,251,5,256
https://kawalpemilu.org#53375,"ABIAN TUWUNG, KEDIRI, TABANAN, BALI",11,229,7,236
https://kawalpemilu.org#53375,"ABIAN TUWUNG, KEDIRI, TABANAN, BALI",12,159,2,161
https://kawalpemilu.org#53375,"ABIAN TUWUNG, KEDIRI, TABANAN, BALI",13,233,8,241
https://kawalpemilu.org#53375,"ABIAN TUWUNG, KEDIRI, TABANAN, BALI",14,152,17,169
https://kawalpemilu.org#53375,"ABIAN TUWUNG, KEDIRI, TABANAN, BALI",15,213,8,221
https://kawalpemilu.org#53375,"ABIAN TUWUNG, KEDIRI, TABANAN, BALI",16,230,4,234
https://kawalpemilu.org#53375,"ABIAN TUWUNG, KEDIRI, TABANAN, BALI",17,253,6,259
https://kawalpemilu.org#53375,"ABIAN TUWUNG, KEDIRI, TABANAN, BALI",18,146,1,147
https://kawalpemilu.org#53375,"ABIAN TUWUNG, KEDIRI, TABANAN, BALI",19,250,5,255
https://kawalpemilu.org#53375,"ABIAN TUWUNG, KEDIRI, TABANAN, BALI",20,186,7,193
https://kawalpemilu.org#53375,"ABIAN TUWUNG, KEDIRI, TABANAN, BALI",21,218,10,228
https://kawalpemilu.org#53375,"ABIAN TUWUNG, KEDIRI, TABANAN, BALI",22,226,4,230
https://kawalpemilu.org#53375,"ABIAN TUWUNG, KEDIRI, TABANAN, BALI",23,205,23,228
https://kawalpemilu.org#53375,"ABIAN TUWUNG, KEDIRI, TABANAN, BALI",24,167,23,190
https://kawalpemilu.org#53375,"ABIAN TUWUNG, KEDIRI, TABANAN, BALI",25,167,19,186
https://kawalpemilu.org#53375,"ABIAN TUWUNG, KEDIRI, TABANAN, BALI",26,151,55,206
https://kawalpemilu.org#53375,"ABIAN TUWUNG, KEDIRI, TABANAN, BALI",27,221,19,240
https://kawalpemilu.org#53375,"ABIAN TUWUNG, KEDIRI, TABANAN, BALI",28,235,16,251
https://kawalpemilu.org#53375,"ABIAN TUWUNG, KEDIRI, TABANAN, BALI",29,195,21,216
https://kawalpemilu.org#53375,"ABIAN TUWUNG, KEDIRI, TABANAN, BALI",30,136,7,143
https://kawalpemilu.org#53375,"ABIAN TUWUNG, KEDIRI, TABANAN, BALI",31,161,80,241
https://kawalpemilu.org#53375,"ABIAN TUWUNG, KEDIRI, TABANAN, BALI",32,143,101,244
https://kawalpemilu.org#53375,"ABIAN TUWUNG, KEDIRI, TABANAN, BALI",33,106,61,167
https://kawalpemilu.org#53375,"ABIAN TUWUNG, KEDIRI, TABANAN, BALI",34,165,88,253
https://kawalpemilu.org#53376,"BANJAR ANYAR, KEDIRI, TABANAN, BALI",1,202,37,239
https://kawalpemilu.org#53376,"BANJAR ANYAR, KEDIRI, TABANAN, BALI",2,211,27,238
https://kawalpemilu.org#53376,"BANJAR ANYAR, KEDIRI, TABANAN, BALI",3,200,41,241
https://kawalpemilu.org#53376,"BANJAR ANYAR, KEDIRI, TABANAN, BALI",4,170,34,204
https://kawalpemilu.org#53376,"BANJAR ANYAR, KEDIRI, TABANAN, BALI",5,190,29,219
https://kawalpemilu.org#53376,"BANJAR ANYAR, KEDIRI, TABANAN, BALI",6,202,24,226
https://kawalpemilu.org#53376,"BANJAR ANYAR, KEDIRI, TABANAN, BALI",7,215,23,238
https://kawalpemilu.org#53376,"BANJAR ANYAR, KEDIRI, TABANAN, BALI",8,156,34,190
https://kawalpemilu.org#53376,"BANJAR ANYAR, KEDIRI, TABANAN, BALI",9,163,16,179
https://kawalpemilu.org#53376,"BANJAR ANYAR, KEDIRI, TABANAN, BALI",10,152,68,220
https://kawalpemilu.org#53376,"BANJAR ANYAR, KEDIRI, TABANAN, BALI",11,167,54,221
https://kawalpemilu.org#53376,"BANJAR ANYAR, KEDIRI, TABANAN, BALI",12,141,65,206
https://kawalpemilu.org#53376,"BANJAR ANYAR, KEDIRI, TABANAN, BALI",13,83,116,199
https://kawalpemilu.org#53376,"BANJAR ANYAR, KEDIRI, TABANAN, BALI",14,209,48,257
https://kawalpemilu.org#53376,"BANJAR ANYAR, KEDIRI, TABANAN, BALI",15,176,42,218
https://kawalpemilu.org#53376,"BANJAR ANYAR, KEDIRI, TABANAN, BALI",16,151,52,203
https://kawalpemilu.org#53376,"BANJAR ANYAR, KEDIRI, TABANAN, BALI",17,158,69,227
https://kawalpemilu.org#53376,"BANJAR ANYAR, KEDIRI, TABANAN, BALI",18,182,17,199
https://kawalpemilu.org#53376,"BANJAR ANYAR, KEDIRI, TABANAN, BALI",19,152,20,172
https://kawalpemilu.org#53376,"BANJAR ANYAR, KEDIRI, TABANAN, BALI",20,163,8,171
https://kawalpemilu.org#53376,"BANJAR ANYAR, KEDIRI, TABANAN, BALI",21,200,44,244
https://kawalpemilu.org#53376,"BANJAR ANYAR, KEDIRI, TABANAN, BALI",22,194,31,225
https://kawalpemilu.org#53376,"BANJAR ANYAR, KEDIRI, TABANAN, BALI",23,247,8,255
https://kawalpemilu.org#53376,"BANJAR ANYAR, KEDIRI, TABANAN, BALI",24,242,20,262
https://kawalpemilu.org#53376,"BANJAR ANYAR, KEDIRI, TABANAN, BALI",25,225,3,228
https://kawalpemilu.org#53376,"BANJAR ANYAR, KEDIRI, TABANAN, BALI",26,198,45,243
https://kawalpemilu.org#53376,"BANJAR ANYAR, KEDIRI, TABANAN, BALI",27,180,23,203
https://kawalpemilu.org#53376,"BANJAR ANYAR, KEDIRI, TABANAN, BALI",28,174,34,208
https://kawalpemilu.org#53376,"BANJAR ANYAR, KEDIRI, TABANAN, BALI",29,172,47,219
https://kawalpemilu.org#53376,"BANJAR ANYAR, KEDIRI, TABANAN, BALI",30,158,38,196
https://kawalpemilu.org#53376,"BANJAR ANYAR, KEDIRI, TABANAN, BALI",31,149,33,182
https://kawalpemilu.org#53376,"BANJAR ANYAR, KEDIRI, TABANAN, BALI",32,187,4,191
https://kawalpemilu.org#53376,"BANJAR ANYAR, KEDIRI, TABANAN, BALI",33,178,4,182
https://kawalpemilu.org#53376,"BANJAR ANYAR, KEDIRI, TABANAN, BALI",34,177,11,188
https://kawalpemilu.org#53376,"BANJAR ANYAR, KEDIRI, TABANAN, BALI",35,135,88,223
https://kawalpemilu.org#53376,"BANJAR ANYAR, KEDIRI, TABANAN, BALI",36,115,49,164
https://kawalpemilu.org#53376,"BANJAR ANYAR, KEDIRI, TABANAN, BALI",37,111,29,140
https://kawalpemilu.org#53376,"BANJAR ANYAR, KEDIRI, TABANAN, BALI",38,146,42,188
https://kawalpemilu.org#53376,"BANJAR ANYAR, KEDIRI, TABANAN, BALI",39,138,86,224
https://kawalpemilu.org#53376,"BANJAR ANYAR, KEDIRI, TABANAN, BALI",40,185,66,251
https://kawalpemilu.org#53376,"BANJAR ANYAR, KEDIRI, TABANAN, BALI",41,148,42,190
https://kawalpemilu.org#53376,"BANJAR ANYAR, KEDIRI, TABANAN, BALI",42,266,7,273
https://kawalpemilu.org#53376,"BANJAR ANYAR, KEDIRI, TABANAN, BALI",43,236,6,242
https://kawalpemilu.org#53376,"BANJAR ANYAR, KEDIRI, TABANAN, BALI",44,213,25,238
https://kawalpemilu.org#53376,"BANJAR ANYAR, KEDIRI, TABANAN, BALI",45,236,14,250
https://kawalpemilu.org#53376,"BANJAR ANYAR, KEDIRI, TABANAN, BALI",46,249,19,268
https://kawalpemilu.org#53378,"KUKUH, MARGA, TABANAN, BALI",1,242,17,259
https://kawalpemilu.org#53378,"KUKUH, MARGA, TABANAN, BALI",2,256,14,270
https://kawalpemilu.org#53378,"KUKUH, MARGA, TABANAN, BALI",3,249,10,259
https://kawalpemilu.org#53378,"KUKUH, MARGA, TABANAN, BALI",4,193,22,215
https://kawalpemilu.org#53378,"KUKUH, MARGA, TABANAN, BALI",5,213,10,223
https://kawalpemilu.org#53378,"KUKUH, MARGA, TABANAN, BALI",6,168,11,179
https://kawalpemilu.org#53378,"KUKUH, MARGA, TABANAN, BALI",7,215,7,222
https://kawalpemilu.org#53378,"KUKUH, MARGA, TABANAN, BALI",8,202,3,205
https://kawalpemilu.org#53378,"KUKUH, MARGA, TABANAN, BALI",9,210,6,216
https://kawalpemilu.org#53378,"KUKUH, MARGA, TABANAN, BALI",10,235,7,242
https://kawalpemilu.org#53378,"KUKUH, MARGA, TABANAN, BALI",11,198,6,204
https://kawalpemilu.org#53378,"KUKUH, MARGA, TABANAN, BALI",12,208,6,214
https://kawalpemilu.org#53378,"KUKUH, MARGA, TABANAN, BALI",13,199,12,211
https://kawalpemilu.org#53378,"KUKUH, MARGA, TABANAN, BALI",14,202,6,208
https://kawalpemilu.org#53378,"KUKUH, MARGA, TABANAN, BALI",15,216,5,221
https://kawalpemilu.org#53378,"KUKUH, MARGA, TABANAN, BALI",16,189,16,205
https://kawalpemilu.org#53378,"KUKUH, MARGA, TABANAN, BALI",17,189,20,209
https://kawalpemilu.org#53378,"KUKUH, MARGA, TABANAN, BALI",18,206,12,218
https://kawalpemilu.org#53378,"KUKUH, MARGA, TABANAN, BALI",19,156,43,199
https://kawalpemilu.org#53379,"BERINGKIT, MARGA, TABANAN, BALI",1,224,1,225
https://kawalpemilu.org#53379,"BERINGKIT, MARGA, TABANAN, BALI",2,211,4,215
https://kawalpemilu.org#53379,"BERINGKIT, MARGA, TABANAN, BALI",3,215,3,218
https://kawalpemilu.org#53379,"BERINGKIT, MARGA, TABANAN, BALI",4,275,15,290
https://kawalpemilu.org#53379,"BERINGKIT, MARGA, TABANAN, BALI",5,284,10,294
https://kawalpemilu.org#53379,"BERINGKIT, MARGA, TABANAN, BALI",6,153,0,153
https://kawalpemilu.org#53379,"BERINGKIT, MARGA, TABANAN, BALI",7,158,0,158
https://kawalpemilu.org#53379,"BERINGKIT, MARGA, TABANAN, BALI",8,128,0,128
https://kawalpemilu.org#53380,"PEKEN BELAYU, MARGA, TABANAN, BALI",1,237,0,237
https://kawalpemilu.org#53380,"PEKEN BELAYU, MARGA, TABANAN, BALI",2,230,0,230
https://kawalpemilu.org#53380,"PEKEN BELAYU, MARGA, TABANAN, BALI",3,137,9,146
https://kawalpemilu.org#53380,"PEKEN BELAYU, MARGA, TABANAN, BALI",4,227,14,241
https://kawalpemilu.org#53380,"PEKEN BELAYU, MARGA, TABANAN, BALI",5,229,8,237
https://kawalpemilu.org#53380,"PEKEN BELAYU, MARGA, TABANAN, BALI",6,231,3,234
https://kawalpemilu.org#53380,"PEKEN BELAYU, MARGA, TABANAN, BALI",7,211,10,221
https://kawalpemilu.org#53380,"PEKEN BELAYU, MARGA, TABANAN, BALI",8,223,4,227
https://kawalpemilu.org#53380,"PEKEN BELAYU, MARGA, TABANAN, BALI",9,226,3,229
https://kawalpemilu.org#53380,"PEKEN BELAYU, MARGA, TABANAN, BALI",10,160,0,160
https://kawalpemilu.org#53380,"PEKEN BELAYU, MARGA, TABANAN, BALI",11,165,5,170
https://kawalpemilu.org#53381,"BATANNYUH, MARGA, TABANAN, BALI",1,297,0,297
https://kawalpemilu.org#53381,"BATANNYUH, MARGA, TABANAN, BALI",2,296,1,297
https://kawalpemilu.org#53381,"BATANNYUH, MARGA, TABANAN, BALI",3,297,1,298
https://kawalpemilu.org#53381,"BATANNYUH, MARGA, TABANAN, BALI",4,192,0,192
https://kawalpemilu.org#53381,"BATANNYUH, MARGA, TABANAN, BALI",5,199,0,199
https://kawalpemilu.org#53381,"BATANNYUH, MARGA, TABANAN, BALI",6,196,0,196
https://kawalpemilu.org#53381,"BATANNYUH, MARGA, TABANAN, BALI",7,253,0,253
https://kawalpemilu.org#53381,"BATANNYUH, MARGA, TABANAN, BALI",8,265,1,266
https://kawalpemilu.org#53382,"TEGALJADI, MARGA, TABANAN, BALI",1,243,1,244
https://kawalpemilu.org#53382,"TEGALJADI, MARGA, TABANAN, BALI",2,245,2,247
https://kawalpemilu.org#53382,"TEGALJADI, MARGA, TABANAN, BALI",3,234,1,235
https://kawalpemilu.org#53382,"TEGALJADI, MARGA, TABANAN, BALI",4,161,68,229
https://kawalpemilu.org#53382,"TEGALJADI, MARGA, TABANAN, BALI",5,184,0,184
https://kawalpemilu.org#53382,"TEGALJADI, MARGA, TABANAN, BALI",6,182,1,183
https://kawalpemilu.org#53382,"TEGALJADI, MARGA, TABANAN, BALI",7,201,4,205
https://kawalpemilu.org#53382,"TEGALJADI, MARGA, TABANAN, BALI",8,199,1,200
https://kawalpemilu.org#53383,"KUWUM, MARGA, TABANAN, BALI",1,176,7,183
https://kawalpemilu.org#53383,"KUWUM, MARGA, TABANAN, BALI",2,181,11,192
https://kawalpemilu.org#53383,"KUWUM, MARGA, TABANAN, BALI",3,178,15,193
https://kawalpemilu.org#53383,"KUWUM, MARGA, TABANAN, BALI",4,189,21,210
https://kawalpemilu.org#53383,"KUWUM, MARGA, TABANAN, BALI",5,190,14,204
https://kawalpemilu.org#53383,"KUWUM, MARGA, TABANAN, BALI",7,219,7,226
https://kawalpemilu.org#53383,"KUWUM, MARGA, TABANAN, BALI",8,212,6,218
https://kawalpemilu.org#53383,"KUWUM, MARGA, TABANAN, BALI",9,214,5,219
https://kawalpemilu.org#53383,"KUWUM, MARGA, TABANAN, BALI",10,238,2,240
https://kawalpemilu.org#53384,"SELANBAWAK, MARGA, TABANAN, BALI",1,232,2,234
https://kawalpemilu.org#53384,"SELANBAWAK, MARGA, TABANAN, BALI",2,230,0,230
https://kawalpemilu.org#53384,"SELANBAWAK, MARGA, TABANAN, BALI",3,201,6,207
https://kawalpemilu.org#53384,"SELANBAWAK, MARGA, TABANAN, BALI",4,193,4,197
https://kawalpemilu.org#53384,"SELANBAWAK, MARGA, TABANAN, BALI",5,188,35,223
https://kawalpemilu.org#53384,"SELANBAWAK, MARGA, TABANAN, BALI",6,186,33,219
https://kawalpemilu.org#53384,"SELANBAWAK, MARGA, TABANAN, BALI",7,237,11,248
https://kawalpemilu.org#53384,"SELANBAWAK, MARGA, TABANAN, BALI",8,245,18,263
https://kawalpemilu.org#53384,"SELANBAWAK, MARGA, TABANAN, BALI",9,188,27,215
https://kawalpemilu.org#53384,"SELANBAWAK, MARGA, TABANAN, BALI",10,214,19,233
https://kawalpemilu.org#53384,"SELANBAWAK, MARGA, TABANAN, BALI",11,198,22,220
https://kawalpemilu.org#53385,"MARGA, MARGA, TABANAN, BALI",1,248,3,251
https://kawalpemilu.org#53385,"MARGA, MARGA, TABANAN, BALI",2,259,0,259
https://kawalpemilu.org#53385,"MARGA, MARGA, TABANAN, BALI",3,264,0,264
https://kawalpemilu.org#53385,"MARGA, MARGA, TABANAN, BALI",4,212,5,217
https://kawalpemilu.org#53385,"MARGA, MARGA, TABANAN, BALI",5,211,4,215
https://kawalpemilu.org#53385,"MARGA, MARGA, TABANAN, BALI",6,222,1,223
https://kawalpemilu.org#53385,"MARGA, MARGA, TABANAN, BALI",7,201,1,202
https://kawalpemilu.org#53385,"MARGA, MARGA, TABANAN, BALI",8,200,5,205
https://kawalpemilu.org#53385,"MARGA, MARGA, TABANAN, BALI",9,216,14,230
https://kawalpemilu.org#53385,"MARGA, MARGA, TABANAN, BALI",10,235,8,243
https://kawalpemilu.org#53386,"PETIGA, MARGA, TABANAN, BALI",1,178,4,182
https://kawalpemilu.org#53386,"PETIGA, MARGA, TABANAN, BALI",2,180,1,181
https://kawalpemilu.org#53386,"PETIGA, MARGA, TABANAN, BALI",3,205,23,228
https://kawalpemilu.org#53386,"PETIGA, MARGA, TABANAN, BALI",4,213,11,224
https://kawalpemilu.org#53386,"PETIGA, MARGA, TABANAN, BALI",5,236,20,256
https://kawalpemilu.org#53386,"PETIGA, MARGA, TABANAN, BALI",6,255,18,273
https://kawalpemilu.org#53387,"CAU BELAYU, MARGA, TABANAN, BALI",1,199,13,212
https://kawalpemilu.org#53387,"CAU BELAYU, MARGA, TABANAN, BALI",2,200,13,213
https://kawalpemilu.org#53387,"CAU BELAYU, MARGA, TABANAN, BALI",3,173,21,194
https://kawalpemilu.org#53387,"CAU BELAYU, MARGA, TABANAN, BALI",4,179,16,195
https://kawalpemilu.org#53387,"CAU BELAYU, MARGA, TABANAN, BALI",5,193,4,197
https://kawalpemilu.org#53387,"CAU BELAYU, MARGA, TABANAN, BALI",6,179,9,188
https://kawalpemilu.org#53387,"CAU BELAYU, MARGA, TABANAN, BALI",7,177,2,179
https://kawalpemilu.org#53387,"CAU BELAYU, MARGA, TABANAN, BALI",8,168,7,175
https://kawalpemilu.org#53387,"CAU BELAYU, MARGA, TABANAN, BALI",9,199,5,204
https://kawalpemilu.org#53387,"CAU BELAYU, MARGA, TABANAN, BALI",10,202,1,203
https://kawalpemilu.org#53388,"TUA, MARGA, TABANAN, BALI",1,186,2,188
https://kawalpemilu.org#53388,"TUA, MARGA, TABANAN, BALI",2,181,1,182
https://kawalpemilu.org#53388,"TUA, MARGA, TABANAN, BALI",4,186,8,194
https://kawalpemilu.org#53388,"TUA, MARGA, TABANAN, BALI",5,173,16,189
https://kawalpemilu.org#53388,"TUA, MARGA, TABANAN, BALI",7,229,5,234
https://kawalpemilu.org#53388,"TUA, MARGA, TABANAN, BALI",8,254,3,257
https://kawalpemilu.org#53388,"TUA, MARGA, TABANAN, BALI",9,238,11,249
https://kawalpemilu.org#53389,"PAYANGAN, MARGA, TABANAN, BALI",1,225,0,225
https://kawalpemilu.org#53389,"PAYANGAN, MARGA, TABANAN, BALI",2,225,2,227
https://kawalpemilu.org#53389,"PAYANGAN, MARGA, TABANAN, BALI",3,145,4,149
https://kawalpemilu.org#53389,"PAYANGAN, MARGA, TABANAN, BALI",4,151,4,155
https://kawalpemilu.org#53389,"PAYANGAN, MARGA, TABANAN, BALI",5,230,3,233
https://kawalpemilu.org#53389,"PAYANGAN, MARGA, TABANAN, BALI",6,218,4,222
https://kawalpemilu.org#53389,"PAYANGAN, MARGA, TABANAN, BALI",7,210,27,237
https://kawalpemilu.org#53389,"PAYANGAN, MARGA, TABANAN, BALI",8,133,6,139
https://kawalpemilu.org#53389,"PAYANGAN, MARGA, TABANAN, BALI",9,227,20,247
https://kawalpemilu.org#53389,"PAYANGAN, MARGA, TABANAN, BALI",10,171,1,172
https://kawalpemilu.org#53389,"PAYANGAN, MARGA, TABANAN, BALI",11,161,0,161
https://kawalpemilu.org#53389,"PAYANGAN, MARGA, TABANAN, BALI",12,211,21,232
https://kawalpemilu.org#53390,"MARGA DAJAN PURI, MARGA, TABANAN, BALI",1,170,4,174
https://kawalpemilu.org#53390,"MARGA DAJAN PURI, MARGA, TABANAN, BALI",2,168,4,172
https://kawalpemilu.org#53390,"MARGA DAJAN PURI, MARGA, TABANAN, BALI",3,174,23,197
https://kawalpemilu.org#53390,"MARGA DAJAN PURI, MARGA, TABANAN, BALI",4,191,21,212
https://kawalpemilu.org#53390,"MARGA DAJAN PURI, MARGA, TABANAN, BALI",5,208,7,215
https://kawalpemilu.org#53390,"MARGA DAJAN PURI, MARGA, TABANAN, BALI",6,190,7,197
https://kawalpemilu.org#53390,"MARGA DAJAN PURI, MARGA, TABANAN, BALI",7,133,3,136
https://kawalpemilu.org#53390,"MARGA DAJAN PURI, MARGA, TABANAN, BALI",8,115,6,121
https://kawalpemilu.org#53391,"MARGA DAUH PURI, MARGA, TABANAN, BALI",1,227,2,229
https://kawalpemilu.org#53391,"MARGA DAUH PURI, MARGA, TABANAN, BALI",2,225,0,225
https://kawalpemilu.org#53391,"MARGA DAUH PURI, MARGA, TABANAN, BALI",3,224,4,228
https://kawalpemilu.org#53391,"MARGA DAUH PURI, MARGA, TABANAN, BALI",4,194,12,206
https://kawalpemilu.org#53391,"MARGA DAUH PURI, MARGA, TABANAN, BALI",5,189,25,214
https://kawalpemilu.org#53391,"MARGA DAUH PURI, MARGA, TABANAN, BALI",6,204,13,217
https://kawalpemilu.org#53391,"MARGA DAUH PURI, MARGA, TABANAN, BALI",7,194,5,199
https://kawalpemilu.org#53392,"GELUNTUNG, MARGA, TABANAN, BALI",1,199,3,202
https://kawalpemilu.org#53392,"GELUNTUNG, MARGA, TABANAN, BALI",3,174,4,178
https://kawalpemilu.org#53392,"GELUNTUNG, MARGA, TABANAN, BALI",4,254,9,263
https://kawalpemilu.org#53392,"GELUNTUNG, MARGA, TABANAN, BALI",5,250,3,253
https://kawalpemilu.org#92044,"BARU, MARGA, TABANAN, BALI",1,218,12,230
https://kawalpemilu.org#92044,"BARU, MARGA, TABANAN, BALI",2,210,21,231
https://kawalpemilu.org#92044,"BARU, MARGA, TABANAN, BALI",3,111,0,111
https://kawalpemilu.org#92044,"BARU, MARGA, TABANAN, BALI",4,233,2,235
https://kawalpemilu.org#92044,"BARU, MARGA, TABANAN, BALI",5,221,4,225
https://kawalpemilu.org#92044,"BARU, MARGA, TABANAN, BALI",6,182,3,185
https://kawalpemilu.org#92044,"BARU, MARGA, TABANAN, BALI",7,190,0,190
https://kawalpemilu.org#53394,"REJASA, PENEBEL, TABANAN, BALI",1,171,0,171
https://kawalpemilu.org#53394,"REJASA, PENEBEL, TABANAN, BALI",2,143,28,171
https://kawalpemilu.org#53394,"REJASA, PENEBEL, TABANAN, BALI",3,140,23,163
https://kawalpemilu.org#53394,"REJASA, PENEBEL, TABANAN, BALI",4,171,17,188
https://kawalpemilu.org#53394,"REJASA, PENEBEL, TABANAN, BALI",5,157,25,182
https://kawalpemilu.org#53394,"REJASA, PENEBEL, TABANAN, BALI",6,241,15,256
https://kawalpemilu.org#53395,"JEGU, PENEBEL, TABANAN, BALI",1,214,15,229
https://kawalpemilu.org#53395,"JEGU, PENEBEL, TABANAN, BALI",2,184,9,193
https://kawalpemilu.org#53395,"JEGU, PENEBEL, TABANAN, BALI",3,177,15,192
https://kawalpemilu.org#53395,"JEGU, PENEBEL, TABANAN, BALI",4,138,10,148
https://kawalpemilu.org#53395,"JEGU, PENEBEL, TABANAN, BALI",5,223,23,246
https://kawalpemilu.org#53395,"JEGU, PENEBEL, TABANAN, BALI",6,186,25,211
https://kawalpemilu.org#53395,"JEGU, PENEBEL, TABANAN, BALI",7,172,12,184
https://kawalpemilu.org#53395,"JEGU, PENEBEL, TABANAN, BALI",8,159,10,169
https://kawalpemilu.org#53395,"JEGU, PENEBEL, TABANAN, BALI",9,173,15,188
https://kawalpemilu.org#53395,"JEGU, PENEBEL, TABANAN, BALI",10,181,7,188
https://kawalpemilu.org#53395,"JEGU, PENEBEL, TABANAN, BALI",11,184,0,184
https://kawalpemilu.org#53395,"JEGU, PENEBEL, TABANAN, BALI",12,200,1,201
https://kawalpemilu.org#53395,"JEGU, PENEBEL, TABANAN, BALI",13,209,3,212
https://kawalpemilu.org#53396,"RIANG GEDE, PENEBEL, TABANAN, BALI",1,226,18,244
https://kawalpemilu.org#53396,"RIANG GEDE, PENEBEL, TABANAN, BALI",2,216,19,235
https://kawalpemilu.org#53396,"RIANG GEDE, PENEBEL, TABANAN, BALI",3,225,14,239
https://kawalpemilu.org#53396,"RIANG GEDE, PENEBEL, TABANAN, BALI",4,237,2,239
https://kawalpemilu.org#53396,"RIANG GEDE, PENEBEL, TABANAN, BALI",5,175,4,179
https://kawalpemilu.org#53396,"RIANG GEDE, PENEBEL, TABANAN, BALI",6,273,1,274
https://kawalpemilu.org#53396,"RIANG GEDE, PENEBEL, TABANAN, BALI",7,264,4,268
https://kawalpemilu.org#53396,"RIANG GEDE, PENEBEL, TABANAN, BALI",8,212,0,212
https://kawalpemilu.org#53396,"RIANG GEDE, PENEBEL, TABANAN, BALI",9,77,0,77
https://kawalpemilu.org#53396,"RIANG GEDE, PENEBEL, TABANAN, BALI",10,160,2,162
https://kawalpemilu.org#53397,"BURUAN, PENEBEL, TABANAN, BALI",1,234,12,246
https://kawalpemilu.org#53397,"BURUAN, PENEBEL, TABANAN, BALI",2,240,9,249
https://kawalpemilu.org#53397,"BURUAN, PENEBEL, TABANAN, BALI",3,246,9,255
https://kawalpemilu.org#53397,"BURUAN, PENEBEL, TABANAN, BALI",4,250,11,261
https://kawalpemilu.org#53397,"BURUAN, PENEBEL, TABANAN, BALI",5,163,11,174
https://kawalpemilu.org#53397,"BURUAN, PENEBEL, TABANAN, BALI",6,227,8,235
https://kawalpemilu.org#53398,"BIAUNG, PENEBEL, TABANAN, BALI",1,187,13,200
https://kawalpemilu.org#53398,"BIAUNG, PENEBEL, TABANAN, BALI",2,129,23,152
https://kawalpemilu.org#53398,"BIAUNG, PENEBEL, TABANAN, BALI",3,113,23,136
https://kawalpemilu.org#53398,"BIAUNG, PENEBEL, TABANAN, BALI",4,139,22,161
https://kawalpemilu.org#53398,"BIAUNG, PENEBEL, TABANAN, BALI",5,145,12,157
https://kawalpemilu.org#53398,"BIAUNG, PENEBEL, TABANAN, BALI",6,184,4,188
https://kawalpemilu.org#53398,"BIAUNG, PENEBEL, TABANAN, BALI",7,173,2,175
https://kawalpemilu.org#53398,"BIAUNG, PENEBEL, TABANAN, BALI",8,251,1,252
https://kawalpemilu.org#53398,"BIAUNG, PENEBEL, TABANAN, BALI",9,227,2,229
https://kawalpemilu.org#53398,"BIAUNG, PENEBEL, TABANAN, BALI",10,223,0,223
https://kawalpemilu.org#53399,"PITRA, PENEBEL, TABANAN, BALI",1,230,15,245
https://kawalpemilu.org#53399,"PITRA, PENEBEL, TABANAN, BALI",2,150,7,157
https://kawalpemilu.org#53399,"PITRA, PENEBEL, TABANAN, BALI",3,171,4,175
https://kawalpemilu.org#53399,"PITRA, PENEBEL, TABANAN, BALI",4,157,5,162
https://kawalpemilu.org#53399,"PITRA, PENEBEL, TABANAN, BALI",5,177,5,182
https://kawalpemilu.org#53399,"PITRA, PENEBEL, TABANAN, BALI",6,220,14,234
https://kawalpemilu.org#53399,"PITRA, PENEBEL, TABANAN, BALI",7,156,1,157
https://kawalpemilu.org#53399,"PITRA, PENEBEL, TABANAN, BALI",8,120,4,124
https://kawalpemilu.org#53400,"PENATAHAN, PENEBEL, TABANAN, BALI",1,182,2,184
https://kawalpemilu.org#53400,"PENATAHAN, PENEBEL, TABANAN, BALI",2,208,6,214
https://kawalpemilu.org#53400,"PENATAHAN, PENEBEL, TABANAN, BALI",3,204,14,218
https://kawalpemilu.org#53400,"PENATAHAN, PENEBEL, TABANAN, BALI",4,211,8,219
https://kawalpemilu.org#53400,"PENATAHAN, PENEBEL, TABANAN, BALI",5,181,22,203
https://kawalpemilu.org#53400,"PENATAHAN, PENEBEL, TABANAN, BALI",6,173,35,208
https://kawalpemilu.org#53400,"PENATAHAN, PENEBEL, TABANAN, BALI",7,197,7,204
https://kawalpemilu.org#53400,"PENATAHAN, PENEBEL, TABANAN, BALI",8,170,5,175
https://kawalpemilu.org#53400,"PENATAHAN, PENEBEL, TABANAN, BALI",9,140,9,149
https://kawalpemilu.org#53400,"PENATAHAN, PENEBEL, TABANAN, BALI",10,156,7,163
https://kawalpemilu.org#53401,"TENGKUDAK, PENEBEL, TABANAN, BALI",1,283,6,289
https://kawalpemilu.org#53401,"TENGKUDAK, PENEBEL, TABANAN, BALI",2,260,7,267
https://kawalpemilu.org#53401,"TENGKUDAK, PENEBEL, TABANAN, BALI",3,244,6,250
https://kawalpemilu.org#53401,"TENGKUDAK, PENEBEL, TABANAN, BALI",4,175,13,188
https://kawalpemilu.org#53401,"TENGKUDAK, PENEBEL, TABANAN, BALI",5,180,7,187
https://kawalpemilu.org#53401,"TENGKUDAK, PENEBEL, TABANAN, BALI",6,207,13,220
https://kawalpemilu.org#53401,"TENGKUDAK, PENEBEL, TABANAN, BALI",7,228,11,239
https://kawalpemilu.org#53401,"TENGKUDAK, PENEBEL, TABANAN, BALI",8,205,3,208
https://kawalpemilu.org#53402,"MENGESTA, PENEBEL, TABANAN, BALI",1,188,16,204
https://kawalpemilu.org#53402,"MENGESTA, PENEBEL, TABANAN, BALI",2,185,16,201
https://kawalpemilu.org#53402,"MENGESTA, PENEBEL, TABANAN, BALI",3,144,7,151
https://kawalpemilu.org#53402,"MENGESTA, PENEBEL, TABANAN, BALI",4,130,6,136
https://kawalpemilu.org#53402,"MENGESTA, PENEBEL, TABANAN, BALI",5,172,6,178
https://kawalpemilu.org#53402,"MENGESTA, PENEBEL, TABANAN, BALI",6,155,9,164
https://kawalpemilu.org#53402,"MENGESTA, PENEBEL, TABANAN, BALI",7,170,5,175
https://kawalpemilu.org#53402,"MENGESTA, PENEBEL, TABANAN, BALI",8,172,7,179
https://kawalpemilu.org#53402,"MENGESTA, PENEBEL, TABANAN, BALI",9,281,1,282
https://kawalpemilu.org#53402,"MENGESTA, PENEBEL, TABANAN, BALI",10,204,1,205
https://kawalpemilu.org#53402,"MENGESTA, PENEBEL, TABANAN, BALI",11,186,0,186
https://kawalpemilu.org#53402,"MENGESTA, PENEBEL, TABANAN, BALI",12,169,0,169
https://kawalpemilu.org#53402,"MENGESTA, PENEBEL, TABANAN, BALI",13,166,1,167
https://kawalpemilu.org#53403,"PENEBEL, PENEBEL, TABANAN, BALI",1,128,7,135
https://kawalpemilu.org#53403,"PENEBEL, PENEBEL, TABANAN, BALI",2,117,14,131
https://kawalpemilu.org#53403,"PENEBEL, PENEBEL, TABANAN, BALI",3,175,19,194
https://kawalpemilu.org#53403,"PENEBEL, PENEBEL, TABANAN, BALI",4,163,23,186
https://kawalpemilu.org#53403,"PENEBEL, PENEBEL, TABANAN, BALI",5,140,14,154
https://kawalpemilu.org#53403,"PENEBEL, PENEBEL, TABANAN, BALI",6,133,9,142
https://kawalpemilu.org#53403,"PENEBEL, PENEBEL, TABANAN, BALI",7,170,9,179
https://kawalpemilu.org#53403,"PENEBEL, PENEBEL, TABANAN, BALI",8,165,6,171
https://kawalpemilu.org#53403,"PENEBEL, PENEBEL, TABANAN, BALI",9,166,7,173
https://kawalpemilu.org#53403,"PENEBEL, PENEBEL, TABANAN, BALI",10,168,7,175
https://kawalpemilu.org#53403,"PENEBEL, PENEBEL, TABANAN, BALI",11,214,8,222
https://kawalpemilu.org#53403,"PENEBEL, PENEBEL, TABANAN, BALI",12,226,6,232
https://kawalpemilu.org#53403,"PENEBEL, PENEBEL, TABANAN, BALI",13,224,19,243
https://kawalpemilu.org#53403,"PENEBEL, PENEBEL, TABANAN, BALI",14,132,18,150
https://kawalpemilu.org#53403,"PENEBEL, PENEBEL, TABANAN, BALI",15,161,18,179
https://kawalpemilu.org#53403,"PENEBEL, PENEBEL, TABANAN, BALI",16,175,17,192
https://kawalpemilu.org#53404,"BABAHAN, PENEBEL, TABANAN, BALI",1,132,22,154
https://kawalpemilu.org#53404,"BABAHAN, PENEBEL, TABANAN, BALI",2,151,16,167
https://kawalpemilu.org#53404,"BABAHAN, PENEBEL, TABANAN, BALI",3,218,11,229
https://kawalpemilu.org#53404,"BABAHAN, PENEBEL, TABANAN, BALI",4,198,11,209
https://kawalpemilu.org#53404,"BABAHAN, PENEBEL, TABANAN, BALI",5,237,15,252
https://kawalpemilu.org#53404,"BABAHAN, PENEBEL, TABANAN, BALI",6,239,11,250
https://kawalpemilu.org#53404,"BABAHAN, PENEBEL, TABANAN, BALI",8,248,9,257
https://kawalpemilu.org#53404,"BABAHAN, PENEBEL, TABANAN, BALI",9,200,23,223
https://kawalpemilu.org#53404,"BABAHAN, PENEBEL, TABANAN, BALI",10,194,7,201
https://kawalpemilu.org#53404,"BABAHAN, PENEBEL, TABANAN, BALI",11,165,4,169
https://kawalpemilu.org#53404,"BABAHAN, PENEBEL, TABANAN, BALI",12,156,3,159
https://kawalpemilu.org#53405,"SENGANAN, PENEBEL, TABANAN, BALI",1,158,5,163
https://kawalpemilu.org#53405,"SENGANAN, PENEBEL, TABANAN, BALI",2,149,8,157
https://kawalpemilu.org#53405,"SENGANAN, PENEBEL, TABANAN, BALI",3,167,36,203
https://kawalpemilu.org#53405,"SENGANAN, PENEBEL, TABANAN, BALI",4,178,18,196
https://kawalpemilu.org#53405,"SENGANAN, PENEBEL, TABANAN, BALI",5,177,8,185
https://kawalpemilu.org#53405,"SENGANAN, PENEBEL, TABANAN, BALI",6,180,7,187
https://kawalpemilu.org#53405,"SENGANAN, PENEBEL, TABANAN, BALI",7,165,10,175
https://kawalpemilu.org#53405,"SENGANAN, PENEBEL, TABANAN, BALI",8,159,3,162
https://kawalpemilu.org#53405,"SENGANAN, PENEBEL, TABANAN, BALI",9,112,3,115
https://kawalpemilu.org#53405,"SENGANAN, PENEBEL, TABANAN, BALI",10,227,17,244
https://kawalpemilu.org#53405,"SENGANAN, PENEBEL, TABANAN, BALI",11,210,13,223
https://kawalpemilu.org#53405,"SENGANAN, PENEBEL, TABANAN, BALI",12,222,2,224
https://kawalpemilu.org#53405,"SENGANAN, PENEBEL, TABANAN, BALI",13,213,21,234
https://kawalpemilu.org#53405,"SENGANAN, PENEBEL, TABANAN, BALI",14,68,6,125
https://kawalpemilu.org#53405,"SENGANAN, PENEBEL, TABANAN, BALI",15,145,7,152
https://kawalpemilu.org#53405,"SENGANAN, PENEBEL, TABANAN, BALI",16,199,6,205
https://kawalpemilu.org#53405,"SENGANAN, PENEBEL, TABANAN, BALI",17,202,8,210
https://kawalpemilu.org#53405,"SENGANAN, PENEBEL, TABANAN, BALI",18,250,1,251
https://kawalpemilu.org#53405,"SENGANAN, PENEBEL, TABANAN, BALI",19,206,4,210
https://kawalpemilu.org#53405,"SENGANAN, PENEBEL, TABANAN, BALI",20,148,8,156
https://kawalpemilu.org#53405,"SENGANAN, PENEBEL, TABANAN, BALI",21,148,6,154
https://kawalpemilu.org#53405,"SENGANAN, PENEBEL, TABANAN, BALI",22,200,18,218
https://kawalpemilu.org#53405,"SENGANAN, PENEBEL, TABANAN, BALI",23,122,6,128
https://kawalpemilu.org#53405,"SENGANAN, PENEBEL, TABANAN, BALI",24,97,13,110
https://kawalpemilu.org#53406,"JATILUWIH, PENEBEL, TABANAN, BALI",1,179,5,184
https://kawalpemilu.org#53406,"JATILUWIH, PENEBEL, TABANAN, BALI",2,170,6,176
https://kawalpemilu.org#53406,"JATILUWIH, PENEBEL, TABANAN, BALI",3,165,23,188
https://kawalpemilu.org#53406,"JATILUWIH, PENEBEL, TABANAN, BALI",4,169,14,183
https://kawalpemilu.org#53406,"JATILUWIH, PENEBEL, TABANAN, BALI",5,171,10,181
https://kawalpemilu.org#53406,"JATILUWIH, PENEBEL, TABANAN, BALI",6,168,12,180
https://kawalpemilu.org#53406,"JATILUWIH, PENEBEL, TABANAN, BALI",7,163,4,167
https://kawalpemilu.org#53406,"JATILUWIH, PENEBEL, TABANAN, BALI",8,144,11,155
https://kawalpemilu.org#53406,"JATILUWIH, PENEBEL, TABANAN, BALI",9,215,4,219
https://kawalpemilu.org#53406,"JATILUWIH, PENEBEL, TABANAN, BALI",10,203,18,221
https://kawalpemilu.org#53407,"WONGAYA GEDE, PENEBEL, TABANAN, BALI",1,208,20,228
https://kawalpemilu.org#53407,"WONGAYA GEDE, PENEBEL, TABANAN, BALI",2,141,0,141
https://kawalpemilu.org#53407,"WONGAYA GEDE, PENEBEL, TABANAN, BALI",3,117,13,130
https://kawalpemilu.org#53407,"WONGAYA GEDE, PENEBEL, TABANAN, BALI",4,125,11,136
https://kawalpemilu.org#53407,"WONGAYA GEDE, PENEBEL, TABANAN, BALI",5,152,4,156
https://kawalpemilu.org#53407,"WONGAYA GEDE, PENEBEL, TABANAN, BALI",6,205,5,210
https://kawalpemilu.org#53407,"WONGAYA GEDE, PENEBEL, TABANAN, BALI",7,182,19,201
https://kawalpemilu.org#53407,"WONGAYA GEDE, PENEBEL, TABANAN, BALI",8,181,6,187
https://kawalpemilu.org#53407,"WONGAYA GEDE, PENEBEL, TABANAN, BALI",9,127,10,137
https://kawalpemilu.org#53407,"WONGAYA GEDE, PENEBEL, TABANAN, BALI",10,116,11,127
https://kawalpemilu.org#53407,"WONGAYA GEDE, PENEBEL, TABANAN, BALI",11,227,16,243
https://kawalpemilu.org#53407,"WONGAYA GEDE, PENEBEL, TABANAN, BALI",12,219,24,243
https://kawalpemilu.org#53407,"WONGAYA GEDE, PENEBEL, TABANAN, BALI",13,151,17,168
https://kawalpemilu.org#53407,"WONGAYA GEDE, PENEBEL, TABANAN, BALI",14,159,8,167
https://kawalpemilu.org#53408,"TAJEN, PENEBEL, TABANAN, BALI",1,171,14,185
https://kawalpemilu.org#53408,"TAJEN, PENEBEL, TABANAN, BALI",2,183,12,195
https://kawalpemilu.org#53408,"TAJEN, PENEBEL, TABANAN, BALI",3,186,4,190
https://kawalpemilu.org#53408,"TAJEN, PENEBEL, TABANAN, BALI",4,212,8,220
https://kawalpemilu.org#53408,"TAJEN, PENEBEL, TABANAN, BALI",5,201,6,207
https://kawalpemilu.org#53408,"TAJEN, PENEBEL, TABANAN, BALI",6,185,13,198
https://kawalpemilu.org#53408,"TAJEN, PENEBEL, TABANAN, BALI",7,211,31,242
https://kawalpemilu.org#53408,"TAJEN, PENEBEL, TABANAN, BALI",8,227,15,242
https://kawalpemilu.org#53408,"TAJEN, PENEBEL, TABANAN, BALI",9,224,7,231
https://kawalpemilu.org#53409,"TEGALLINGGAH, PENEBEL, TABANAN, BALI",1,221,18,239
https://kawalpemilu.org#53409,"TEGALLINGGAH, PENEBEL, TABANAN, BALI",2,155,30,185
https://kawalpemilu.org#53409,"TEGALLINGGAH, PENEBEL, TABANAN, BALI",3,187,25,212
https://kawalpemilu.org#53409,"TEGALLINGGAH, PENEBEL, TABANAN, BALI",4,172,22,194
https://kawalpemilu.org#53409,"TEGALLINGGAH, PENEBEL, TABANAN, BALI",5,182,5,187
https://kawalpemilu.org#53410,"PESAGI, PENEBEL, TABANAN, BALI",1,115,4,119
https://kawalpemilu.org#53410,"PESAGI, PENEBEL, TABANAN, BALI",2,138,2,140
https://kawalpemilu.org#53410,"PESAGI, PENEBEL, TABANAN, BALI",3,147,24,171
https://kawalpemilu.org#53410,"PESAGI, PENEBEL, TABANAN, BALI",4,202,10,212
https://kawalpemilu.org#53410,"PESAGI, PENEBEL, TABANAN, BALI",5,251,2,253
https://kawalpemilu.org#53410,"PESAGI, PENEBEL, TABANAN, BALI",6,151,6,157
https://kawalpemilu.org#53410,"PESAGI, PENEBEL, TABANAN, BALI",7,223,8,231
https://kawalpemilu.org#53411,"SANGKETAN, PENEBEL, TABANAN, BALI",1,201,10,211
https://kawalpemilu.org#53411,"SANGKETAN, PENEBEL, TABANAN, BALI",2,214,8,222
https://kawalpemilu.org#53411,"SANGKETAN, PENEBEL, TABANAN, BALI",3,226,16,242
https://kawalpemilu.org#53411,"SANGKETAN, PENEBEL, TABANAN, BALI",4,259,6,265
https://kawalpemilu.org#53411,"SANGKETAN, PENEBEL, TABANAN, BALI",5,187,2,189
https://kawalpemilu.org#53411,"SANGKETAN, PENEBEL, TABANAN, BALI",6,121,0,121
https://kawalpemilu.org#53411,"SANGKETAN, PENEBEL, TABANAN, BALI",7,156,6,162
https://kawalpemilu.org#53411,"SANGKETAN, PENEBEL, TABANAN, BALI",8,79,0,79
https://kawalpemilu.org#53413,"PEREAN, BATURITI, TABANAN, BALI",1,253,2,255
https://kawalpemilu.org#53413,"PEREAN, BATURITI, TABANAN, BALI",2,248,5,253
https://kawalpemilu.org#53413,"PEREAN, BATURITI, TABANAN, BALI",3,230,9,239
https://kawalpemilu.org#53413,"PEREAN, BATURITI, TABANAN, BALI",4,225,9,234
https://kawalpemilu.org#53413,"PEREAN, BATURITI, TABANAN, BALI",5,224,4,228
https://kawalpemilu.org#53413,"PEREAN, BATURITI, TABANAN, BALI",6,289,0,289
https://kawalpemilu.org#53413,"PEREAN, BATURITI, TABANAN, BALI",7,281,2,283
https://kawalpemilu.org#53413,"PEREAN, BATURITI, TABANAN, BALI",8,264,3,267
https://kawalpemilu.org#53413,"PEREAN, BATURITI, TABANAN, BALI",9,269,3,272
https://kawalpemilu.org#53413,"PEREAN, BATURITI, TABANAN, BALI",10,266,1,267
https://kawalpemilu.org#53413,"PEREAN, BATURITI, TABANAN, BALI",11,165,2,167
https://kawalpemilu.org#53413,"PEREAN, BATURITI, TABANAN, BALI",12,170,9,179
https://kawalpemilu.org#53414,"LUWUS, BATURITI, TABANAN, BALI",1,165,27,192
https://kawalpemilu.org#53414,"LUWUS, BATURITI, TABANAN, BALI",2,174,29,203
https://kawalpemilu.org#53414,"LUWUS, BATURITI, TABANAN, BALI",3,190,20,210
https://kawalpemilu.org#53414,"LUWUS, BATURITI, TABANAN, BALI",4,162,16,178
https://kawalpemilu.org#53414,"LUWUS, BATURITI, TABANAN, BALI",5,204,29,233
https://kawalpemilu.org#53414,"LUWUS, BATURITI, TABANAN, BALI",6,206,28,234
https://kawalpemilu.org#53414,"LUWUS, BATURITI, TABANAN, BALI",7,176,30,206
https://kawalpemilu.org#53414,"LUWUS, BATURITI, TABANAN, BALI",8,225,13,238
https://kawalpemilu.org#53414,"LUWUS, BATURITI, TABANAN, BALI",9,233,4,237
https://kawalpemilu.org#53414,"LUWUS, BATURITI, TABANAN, BALI",10,228,8,236
https://kawalpemilu.org#53414,"LUWUS, BATURITI, TABANAN, BALI",11,221,12,233
https://kawalpemilu.org#53414,"LUWUS, BATURITI, TABANAN, BALI",12,242,12,254
https://kawalpemilu.org#53414,"LUWUS, BATURITI, TABANAN, BALI",13,243,5,248
https://kawalpemilu.org#53415,"APUAN, BATURITI, TABANAN, BALI",1,199,11,210
https://kawalpemilu.org#53415,"APUAN, BATURITI, TABANAN, BALI",2,216,7,223
https://kawalpemilu.org#53415,"APUAN, BATURITI, TABANAN, BALI",3,211,5,216
https://kawalpemilu.org#53415,"APUAN, BATURITI, TABANAN, BALI",4,199,23,222
https://kawalpemilu.org#53415,"APUAN, BATURITI, TABANAN, BALI",5,119,33,224
https://kawalpemilu.org#53415,"APUAN, BATURITI, TABANAN, BALI",6,192,26,218
https://kawalpemilu.org#53415,"APUAN, BATURITI, TABANAN, BALI",7,210,9,219
https://kawalpemilu.org#53415,"APUAN, BATURITI, TABANAN, BALI",8,194,1,195
https://kawalpemilu.org#53415,"APUAN, BATURITI, TABANAN, BALI",9,201,2,203
https://kawalpemilu.org#53415,"APUAN, BATURITI, TABANAN, BALI",10,193,6,199
https://kawalpemilu.org#53415,"APUAN, BATURITI, TABANAN, BALI",11,209,18,227
https://kawalpemilu.org#53415,"APUAN, BATURITI, TABANAN, BALI",12,232,24,256
https://kawalpemilu.org#53416,"ANGSERI, BATURITI, TABANAN, BALI",1,205,7,212
https://kawalpemilu.org#53416,"ANGSERI, BATURITI, TABANAN, BALI",2,151,7,158
https://kawalpemilu.org#53416,"ANGSERI, BATURITI, TABANAN, BALI",3,153,5,158
https://kawalpemilu.org#53416,"ANGSERI, BATURITI, TABANAN, BALI",4,161,10,171
https://kawalpemilu.org#53416,"ANGSERI, BATURITI, TABANAN, BALI",5,170,7,177
https://kawalpemilu.org#53416,"ANGSERI, BATURITI, TABANAN, BALI",6,132,10,142
https://kawalpemilu.org#53416,"ANGSERI, BATURITI, TABANAN, BALI",7,128,11,139
https://kawalpemilu.org#53416,"ANGSERI, BATURITI, TABANAN, BALI",8,153,9,162
https://kawalpemilu.org#53416,"ANGSERI, BATURITI, TABANAN, BALI",9,148,8,165
https://kawalpemilu.org#53416,"ANGSERI, BATURITI, TABANAN, BALI",10,150,5,155
https://kawalpemilu.org#53416,"ANGSERI, BATURITI, TABANAN, BALI",11,130,11,141
https://kawalpemilu.org#53416,"ANGSERI, BATURITI, TABANAN, BALI",12,236,0,236
https://kawalpemilu.org#53416,"ANGSERI, BATURITI, TABANAN, BALI",13,250,0,250
https://kawalpemilu.org#53416,"ANGSERI, BATURITI, TABANAN, BALI",14,265,1,266
https://kawalpemilu.org#53416,"ANGSERI, BATURITI, TABANAN, BALI",15,0,0,0
https://kawalpemilu.org#53417,"BANGLI, BATURITI, TABANAN, BALI",1,218,6,224
https://kawalpemilu.org#53417,"BANGLI, BATURITI, TABANAN, BALI",2,208,10,218
https://kawalpemilu.org#53417,"BANGLI, BATURITI, TABANAN, BALI",3,167,11,178
https://kawalpemilu.org#53417,"BANGLI, BATURITI, TABANAN, BALI",4,181,11,192
https://kawalpemilu.org#53417,"BANGLI, BATURITI, TABANAN, BALI",5,141,1,142
https://kawalpemilu.org#53417,"BANGLI, BATURITI, TABANAN, BALI",6,124,0,124
https://kawalpemilu.org#53417,"BANGLI, BATURITI, TABANAN, BALI",7,183,6,189
https://kawalpemilu.org#53417,"BANGLI, BATURITI, TABANAN, BALI",8,166,6,172
https://kawalpemilu.org#53417,"BANGLI, BATURITI, TABANAN, BALI",9,174,4,178
https://kawalpemilu.org#53417,"BANGLI, BATURITI, TABANAN, BALI",10,173,2,175
https://kawalpemilu.org#53417,"BANGLI, BATURITI, TABANAN, BALI",11,204,3,207
https://kawalpemilu.org#53417,"BANGLI, BATURITI, TABANAN, BALI",12,212,4,216
https://kawalpemilu.org#53417,"BANGLI, BATURITI, TABANAN, BALI",13,201,2,203
https://kawalpemilu.org#53417,"BANGLI, BATURITI, TABANAN, BALI",14,199,2,201
https://kawalpemilu.org#53417,"BANGLI, BATURITI, TABANAN, BALI",15,197,5,202
https://kawalpemilu.org#53417,"BANGLI, BATURITI, TABANAN, BALI",16,193,4,197
https://kawalpemilu.org#53418,"BATURITI, BATURITI, TABANAN, BALI",1,118,12,130
https://kawalpemilu.org#53418,"BATURITI, BATURITI, TABANAN, BALI",2,172,27,199
https://kawalpemilu.org#53418,"BATURITI, BATURITI, TABANAN, BALI",3,180,22,202
https://kawalpemilu.org#53418,"BATURITI, BATURITI, TABANAN, BALI",4,171,22,193
https://kawalpemilu.org#53418,"BATURITI, BATURITI, TABANAN, BALI",5,175,24,199
https://kawalpemilu.org#53418,"BATURITI, BATURITI, TABANAN, BALI",6,175,26,201
https://kawalpemilu.org#53418,"BATURITI, BATURITI, TABANAN, BALI",7,156,24,180
https://kawalpemilu.org#53418,"BATURITI, BATURITI, TABANAN, BALI",10,164,14,178
https://kawalpemilu.org#53418,"BATURITI, BATURITI, TABANAN, BALI",11,161,20,181
https://kawalpemilu.org#53418,"BATURITI, BATURITI, TABANAN, BALI",12,158,10,168
https://kawalpemilu.org#53418,"BATURITI, BATURITI, TABANAN, BALI",13,188,11,200
https://kawalpemilu.org#53418,"BATURITI, BATURITI, TABANAN, BALI",14,178,16,194
https://kawalpemilu.org#53418,"BATURITI, BATURITI, TABANAN, BALI",15,158,10,168
https://kawalpemilu.org#53418,"BATURITI, BATURITI, TABANAN, BALI",16,156,6,162
https://kawalpemilu.org#53418,"BATURITI, BATURITI, TABANAN, BALI",17,133,6,139
https://kawalpemilu.org#53418,"BATURITI, BATURITI, TABANAN, BALI",18,173,5,178
https://kawalpemilu.org#53418,"BATURITI, BATURITI, TABANAN, BALI",19,183,8,191
https://kawalpemilu.org#53418,"BATURITI, BATURITI, TABANAN, BALI",20,253,18,271
https://kawalpemilu.org#53418,"BATURITI, BATURITI, TABANAN, BALI",21,228,28,256
https://kawalpemilu.org#53418,"BATURITI, BATURITI, TABANAN, BALI",22,164,29,193
https://kawalpemilu.org#53418,"BATURITI, BATURITI, TABANAN, BALI",23,177,36,213
https://kawalpemilu.org#53418,"BATURITI, BATURITI, TABANAN, BALI",24,241,10,251
https://kawalpemilu.org#53419,"ANTAPAN, BATURITI, TABANAN, BALI",1,192,23,215
https://kawalpemilu.org#53419,"ANTAPAN, BATURITI, TABANAN, BALI",2,206,33,239
https://kawalpemilu.org#53419,"ANTAPAN, BATURITI, TABANAN, BALI",3,171,20,191
https://kawalpemilu.org#53419,"ANTAPAN, BATURITI, TABANAN, BALI",4,197,18,215
https://kawalpemilu.org#53419,"ANTAPAN, BATURITI, TABANAN, BALI",5,185,7,192
https://kawalpemilu.org#53419,"ANTAPAN, BATURITI, TABANAN, BALI",6,211,11,222
https://kawalpemilu.org#53419,"ANTAPAN, BATURITI, TABANAN, BALI",7,190,10,200
https://kawalpemilu.org#53419,"ANTAPAN, BATURITI, TABANAN, BALI",8,205,4,209
https://kawalpemilu.org#53419,"ANTAPAN, BATURITI, TABANAN, BALI",9,208,2,210
https://kawalpemilu.org#53419,"ANTAPAN, BATURITI, TABANAN, BALI",10,199,3,202
https://kawalpemilu.org#53419,"ANTAPAN, BATURITI, TABANAN, BALI",11,199,3,202
https://kawalpemilu.org#53419,"ANTAPAN, BATURITI, TABANAN, BALI",12,108,11,119
https://kawalpemilu.org#53420,"CANDIKUNING, BATURITI, TABANAN, BALI",1,205,1,206
https://kawalpemilu.org#53420,"CANDIKUNING, BATURITI, TABANAN, BALI",2,189,1,190
https://kawalpemilu.org#53420,"CANDIKUNING, BATURITI, TABANAN, BALI",3,223,5,228
https://kawalpemilu.org#53420,"CANDIKUNING, BATURITI, TABANAN, BALI",4,218,2,220
https://kawalpemilu.org#53420,"CANDIKUNING, BATURITI, TABANAN, BALI",5,262,1,263
https://kawalpemilu.org#53420,"CANDIKUNING, BATURITI, TABANAN, BALI",6,272,2,274
https://kawalpemilu.org#53420,"CANDIKUNING, BATURITI, TABANAN, BALI",7,98,131,229
https://kawalpemilu.org#53420,"CANDIKUNING, BATURITI, TABANAN, BALI",8,48,145,193
https://kawalpemilu.org#53420,"CANDIKUNING, BATURITI, TABANAN, BALI",9,68,148,216
https://kawalpemilu.org#53420,"CANDIKUNING, BATURITI, TABANAN, BALI",10,69,157,226
https://kawalpemilu.org#53420,"CANDIKUNING, BATURITI, TABANAN, BALI",11,60,131,191
https://kawalpemilu.org#53420,"CANDIKUNING, BATURITI, TABANAN, BALI",12,66,157,223
https://kawalpemilu.org#53420,"CANDIKUNING, BATURITI, TABANAN, BALI",13,76,145,221
https://kawalpemilu.org#53420,"CANDIKUNING, BATURITI, TABANAN, BALI",14,61,150,211
https://kawalpemilu.org#53420,"CANDIKUNING, BATURITI, TABANAN, BALI",15,202,9,211
https://kawalpemilu.org#53420,"CANDIKUNING, BATURITI, TABANAN, BALI",16,200,6,206
https://kawalpemilu.org#53420,"CANDIKUNING, BATURITI, TABANAN, BALI",17,212,7,219
https://kawalpemilu.org#53420,"CANDIKUNING, BATURITI, TABANAN, BALI",18,217,7,224
https://kawalpemilu.org#53420,"CANDIKUNING, BATURITI, TABANAN, BALI",19,213,5,218
https://kawalpemilu.org#53420,"CANDIKUNING, BATURITI, TABANAN, BALI",20,204,9,213
https://kawalpemilu.org#53420,"CANDIKUNING, BATURITI, TABANAN, BALI",21,204,9,213
https://kawalpemilu.org#53420,"CANDIKUNING, BATURITI, TABANAN, BALI",22,214,4,218
https://kawalpemilu.org#53420,"CANDIKUNING, BATURITI, TABANAN, BALI",23,213,4,217
https://kawalpemilu.org#53420,"CANDIKUNING, BATURITI, TABANAN, BALI",24,226,4,230
https://kawalpemilu.org#53421,"MEKARSARI, BATURITI, TABANAN, BALI",1,175,10,185
https://kawalpemilu.org#53421,"MEKARSARI, BATURITI, TABANAN, BALI",2,198,7,205
https://kawalpemilu.org#53421,"MEKARSARI, BATURITI, TABANAN, BALI",3,194,3,197
https://kawalpemilu.org#53421,"MEKARSARI, BATURITI, TABANAN, BALI",4,266,8,274
https://kawalpemilu.org#53421,"MEKARSARI, BATURITI, TABANAN, BALI",5,248,5,253
https://kawalpemilu.org#53421,"MEKARSARI, BATURITI, TABANAN, BALI",6,240,2,242
https://kawalpemilu.org#53421,"MEKARSARI, BATURITI, TABANAN, BALI",7,221,8,229
https://kawalpemilu.org#53421,"MEKARSARI, BATURITI, TABANAN, BALI",8,145,8,153
https://kawalpemilu.org#53421,"MEKARSARI, BATURITI, TABANAN, BALI",9,154,15,169
https://kawalpemilu.org#53421,"MEKARSARI, BATURITI, TABANAN, BALI",10,151,9,160
https://kawalpemilu.org#53421,"MEKARSARI, BATURITI, TABANAN, BALI",11,154,5,159
https://kawalpemilu.org#53421,"MEKARSARI, BATURITI, TABANAN, BALI",12,160,7,167
https://kawalpemilu.org#53421,"MEKARSARI, BATURITI, TABANAN, BALI",13,145,17,162
https://kawalpemilu.org#53421,"MEKARSARI, BATURITI, TABANAN, BALI",14,176,16,192
https://kawalpemilu.org#53421,"MEKARSARI, BATURITI, TABANAN, BALI",15,138,4,142
https://kawalpemilu.org#53421,"MEKARSARI, BATURITI, TABANAN, BALI",16,112,6,118
https://kawalpemilu.org#53422,"BATUNYA, BATURITI, TABANAN, BALI",1,209,17,226
https://kawalpemilu.org#53422,"BATUNYA, BATURITI, TABANAN, BALI",2,219,12,231
https://kawalpemilu.org#53422,"BATUNYA, BATURITI, TABANAN, BALI",3,202,8,210
https://kawalpemilu.org#53422,"BATUNYA, BATURITI, TABANAN, BALI",4,263,6,269
https://kawalpemilu.org#53422,"BATUNYA, BATURITI, TABANAN, BALI",5,244,8,252
https://kawalpemilu.org#53422,"BATUNYA, BATURITI, TABANAN, BALI",6,254,8,262
https://kawalpemilu.org#53422,"BATUNYA, BATURITI, TABANAN, BALI",7,247,2,249
https://kawalpemilu.org#53422,"BATUNYA, BATURITI, TABANAN, BALI",8,267,17,284
https://kawalpemilu.org#53422,"BATUNYA, BATURITI, TABANAN, BALI",9,272,8,280
https://kawalpemilu.org#53422,"BATUNYA, BATURITI, TABANAN, BALI",10,167,3,170
https://kawalpemilu.org#53423,"PEREAN TENGAH, BATURITI, TABANAN, BALI",1,232,3,235
https://kawalpemilu.org#53423,"PEREAN TENGAH, BATURITI, TABANAN, BALI",2,215,20,235
https://kawalpemilu.org#53423,"PEREAN TENGAH, BATURITI, TABANAN, BALI",3,200,15,215
https://kawalpemilu.org#53423,"PEREAN TENGAH, BATURITI, TABANAN, BALI",4,221,8,229
https://kawalpemilu.org#53423,"PEREAN TENGAH, BATURITI, TABANAN, BALI",5,216,8,224
https://kawalpemilu.org#53423,"PEREAN TENGAH, BATURITI, TABANAN, BALI",6,226,13,239
https://kawalpemilu.org#53423,"PEREAN TENGAH, BATURITI, TABANAN, BALI",7,261,2,263
https://kawalpemilu.org#53424,"PEREAN KANGIN, BATURITI, TABANAN, BALI",1,246,5,251
https://kawalpemilu.org#53424,"PEREAN KANGIN, BATURITI, TABANAN, BALI",2,259,5,264
https://kawalpemilu.org#53424,"PEREAN KANGIN, BATURITI, TABANAN, BALI",3,169,2,171
https://kawalpemilu.org#53424,"PEREAN KANGIN, BATURITI, TABANAN, BALI",4,231,14,245
https://kawalpemilu.org#53424,"PEREAN KANGIN, BATURITI, TABANAN, BALI",5,234,6,240
https://kawalpemilu.org#53424,"PEREAN KANGIN, BATURITI, TABANAN, BALI",6,237,8,245
https://kawalpemilu.org#53424,"PEREAN KANGIN, BATURITI, TABANAN, BALI",7,251,10,261
https://kawalpemilu.org#53424,"PEREAN KANGIN, BATURITI, TABANAN, BALI",8,219,13,232
https://kawalpemilu.org#53424,"PEREAN KANGIN, BATURITI, TABANAN, BALI",9,233,11,244
https://kawalpemilu.org#53426,"BELIMBING, PUPUAN, TABANAN, BALI",1,219,29,248
https://kawalpemilu.org#53426,"BELIMBING, PUPUAN, TABANAN, BALI",2,190,40,230
https://kawalpemilu.org#53426,"BELIMBING, PUPUAN, TABANAN, BALI",3,246,44,290
https://kawalpemilu.org#53426,"BELIMBING, PUPUAN, TABANAN, BALI",4,191,14,205
https://kawalpemilu.org#53426,"BELIMBING, PUPUAN, TABANAN, BALI",5,165,9,174
https://kawalpemilu.org#53426,"BELIMBING, PUPUAN, TABANAN, BALI",6,251,4,255
https://kawalpemilu.org#53426,"BELIMBING, PUPUAN, TABANAN, BALI",7,186,13,199
https://kawalpemilu.org#53426,"BELIMBING, PUPUAN, TABANAN, BALI",8,231,44,275
https://kawalpemilu.org#53426,"BELIMBING, PUPUAN, TABANAN, BALI",9,232,39,271
https://kawalpemilu.org#53426,"BELIMBING, PUPUAN, TABANAN, BALI",10,269,4,273
https://kawalpemilu.org#53426,"BELIMBING, PUPUAN, TABANAN, BALI",11,263,7,270
https://kawalpemilu.org#53426,"BELIMBING, PUPUAN, TABANAN, BALI",12,239,5,244
https://kawalpemilu.org#53426,"BELIMBING, PUPUAN, TABANAN, BALI",13,225,4,229
https://kawalpemilu.org#53426,"BELIMBING, PUPUAN, TABANAN, BALI",14,238,1,239
https://kawalpemilu.org#53426,"BELIMBING, PUPUAN, TABANAN, BALI",15,235,3,238
https://kawalpemilu.org#53427,"SANDA, PUPUAN, TABANAN, BALI",1,162,14,176
https://kawalpemilu.org#53427,"SANDA, PUPUAN, TABANAN, BALI",2,154,11,165
https://kawalpemilu.org#53427,"SANDA, PUPUAN, TABANAN, BALI",3,164,9,173
https://kawalpemilu.org#53427,"SANDA, PUPUAN, TABANAN, BALI",4,162,11,173
https://kawalpemilu.org#53427,"SANDA, PUPUAN, TABANAN, BALI",5,165,13,178
https://kawalpemilu.org#53427,"SANDA, PUPUAN, TABANAN, BALI",6,159,16,175
https://kawalpemilu.org#53428,"BATUNGSEL, PUPUAN, TABANAN, BALI",1,228,9,237
https://kawalpemilu.org#53428,"BATUNGSEL, PUPUAN, TABANAN, BALI",2,220,6,226
https://kawalpemilu.org#53428,"BATUNGSEL, PUPUAN, TABANAN, BALI",3,183,11,194
https://kawalpemilu.org#53428,"BATUNGSEL, PUPUAN, TABANAN, BALI",4,189,24,213
https://kawalpemilu.org#53428,"BATUNGSEL, PUPUAN, TABANAN, BALI",5,155,27,182
https://kawalpemilu.org#53428,"BATUNGSEL, PUPUAN, TABANAN, BALI",6,176,9,185
https://kawalpemilu.org#53428,"BATUNGSEL, PUPUAN, TABANAN, BALI",7,160,18,178
https://kawalpemilu.org#53428,"BATUNGSEL, PUPUAN, TABANAN, BALI",8,162,15,177
https://kawalpemilu.org#53428,"BATUNGSEL, PUPUAN, TABANAN, BALI",9,177,16,193
https://kawalpemilu.org#53428,"BATUNGSEL, PUPUAN, TABANAN, BALI",10,195,7,202
https://kawalpemilu.org#53428,"BATUNGSEL, PUPUAN, TABANAN, BALI",11,150,23,173
https://kawalpemilu.org#53428,"BATUNGSEL, PUPUAN, TABANAN, BALI",12,162,18,180
https://kawalpemilu.org#53429,"KEBON PADANGAN, PUPUAN, TABANAN, BALI",1,151,2,153
https://kawalpemilu.org#53429,"KEBON PADANGAN, PUPUAN, TABANAN, BALI",2,141,0,141
https://kawalpemilu.org#53429,"KEBON PADANGAN, PUPUAN, TABANAN, BALI",3,163,0,163
https://kawalpemilu.org#53429,"KEBON PADANGAN, PUPUAN, TABANAN, BALI",4,178,1,179
https://kawalpemilu.org#53429,"KEBON PADANGAN, PUPUAN, TABANAN, BALI",5,225,1,226
https://kawalpemilu.org#53429,"KEBON PADANGAN, PUPUAN, TABANAN, BALI",6,186,7,193
https://kawalpemilu.org#53429,"KEBON PADANGAN, PUPUAN, TABANAN, BALI",7,151,5,156
https://kawalpemilu.org#53429,"KEBON PADANGAN, PUPUAN, TABANAN, BALI",8,144,2,146
https://kawalpemilu.org#53429,"KEBON PADANGAN, PUPUAN, TABANAN, BALI",9,168,4,172
https://kawalpemilu.org#53429,"KEBON PADANGAN, PUPUAN, TABANAN, BALI",10,159,6,165
https://kawalpemilu.org#53429,"KEBON PADANGAN, PUPUAN, TABANAN, BALI",11,159,8,167
https://kawalpemilu.org#53429,"KEBON PADANGAN, PUPUAN, TABANAN, BALI",12,172,1,173
https://kawalpemilu.org#53429,"KEBON PADANGAN, PUPUAN, TABANAN, BALI",13,157,5,162
https://kawalpemilu.org#53430,"MUNDUK TEMU, PUPUAN, TABANAN, BALI",1,219,1,220
https://kawalpemilu.org#53430,"MUNDUK TEMU, PUPUAN, TABANAN, BALI",2,196,0,196
https://kawalpemilu.org#53430,"MUNDUK TEMU, PUPUAN, TABANAN, BALI",3,211,2,213
https://kawalpemilu.org#53430,"MUNDUK TEMU, PUPUAN, TABANAN, BALI",4,224,0,224
https://kawalpemilu.org#53430,"MUNDUK TEMU, PUPUAN, TABANAN, BALI",5,200,23,223
https://kawalpemilu.org#53430,"MUNDUK TEMU, PUPUAN, TABANAN, BALI",6,192,21,213
https://kawalpemilu.org#53430,"MUNDUK TEMU, PUPUAN, TABANAN, BALI",7,195,22,217
https://kawalpemilu.org#53430,"MUNDUK TEMU, PUPUAN, TABANAN, BALI",8,182,22,204
https://kawalpemilu.org#53430,"MUNDUK TEMU, PUPUAN, TABANAN, BALI",9,169,11,180
https://kawalpemilu.org#53430,"MUNDUK TEMU, PUPUAN, TABANAN, BALI",10,170,12,182
https://kawalpemilu.org#53430,"MUNDUK TEMU, PUPUAN, TABANAN, BALI",11,159,9,161
https://kawalpemilu.org#53430,"MUNDUK TEMU, PUPUAN, TABANAN, BALI",12,149,7,156
https://kawalpemilu.org#53431,"PUJUNGAN, PUPUAN, TABANAN, BALI",1,197,6,203
https://kawalpemilu.org#53431,"PUJUNGAN, PUPUAN, TABANAN, BALI",2,224,5,229
https://kawalpemilu.org#53431,"PUJUNGAN, PUPUAN, TABANAN, BALI",3,208,4,212
https://kawalpemilu.org#53431,"PUJUNGAN, PUPUAN, TABANAN, BALI",4,198,7,205
https://kawalpemilu.org#53431,"PUJUNGAN, PUPUAN, TABANAN, BALI",5,217,9,226
https://kawalpemilu.org#53431,"PUJUNGAN, PUPUAN, TABANAN, BALI",6,202,2,204
https://kawalpemilu.org#53431,"PUJUNGAN, PUPUAN, TABANAN, BALI",7,196,8,204
https://kawalpemilu.org#53431,"PUJUNGAN, PUPUAN, TABANAN, BALI",8,178,5,183
https://kawalpemilu.org#53431,"PUJUNGAN, PUPUAN, TABANAN, BALI",9,213,10,223
https://kawalpemilu.org#53431,"PUJUNGAN, PUPUAN, TABANAN, BALI",10,195,7,202
https://kawalpemilu.org#53431,"PUJUNGAN, PUPUAN, TABANAN, BALI",11,236,7,243
https://kawalpemilu.org#53431,"PUJUNGAN, PUPUAN, TABANAN, BALI",12,238,6,244
https://kawalpemilu.org#53431,"PUJUNGAN, PUPUAN, TABANAN, BALI",13,237,9,246
https://kawalpemilu.org#53431,"PUJUNGAN, PUPUAN, TABANAN, BALI",14,235,9,244
https://kawalpemilu.org#53431,"PUJUNGAN, PUPUAN, TABANAN, BALI",15,236,5,241
https://kawalpemilu.org#53431,"PUJUNGAN, PUPUAN, TABANAN, BALI",16,228,7,235
https://kawalpemilu.org#53431,"PUJUNGAN, PUPUAN, TABANAN, BALI",17,214,5,219
https://kawalpemilu.org#53431,"PUJUNGAN, PUPUAN, TABANAN, BALI",18,204,11,215
https://kawalpemilu.org#53431,"PUJUNGAN, PUPUAN, TABANAN, BALI",19,237,9,246
https://kawalpemilu.org#53431,"PUJUNGAN, PUPUAN, TABANAN, BALI",20,251,8,259
https://kawalpemilu.org#53432,"PUPUAN, PUPUAN, TABANAN, BALI",1,224,3,227
https://kawalpemilu.org#53432,"PUPUAN, PUPUAN, TABANAN, BALI",2,224,2,226
https://kawalpemilu.org#53432,"PUPUAN, PUPUAN, TABANAN, BALI",3,181,2,183
https://kawalpemilu.org#53432,"PUPUAN, PUPUAN, TABANAN, BALI",4,200,11,211
https://kawalpemilu.org#53432,"PUPUAN, PUPUAN, TABANAN, BALI",5,193,6,199
https://kawalpemilu.org#53432,"PUPUAN, PUPUAN, TABANAN, BALI",6,227,9,236
https://kawalpemilu.org#53432,"PUPUAN, PUPUAN, TABANAN, BALI",7,226,6,232
https://kawalpemilu.org#53432,"PUPUAN, PUPUAN, TABANAN, BALI",8,167,7,174
https://kawalpemilu.org#53432,"PUPUAN, PUPUAN, TABANAN, BALI",9,162,37,199
https://kawalpemilu.org#53432,"PUPUAN, PUPUAN, TABANAN, BALI",10,174,24,198
https://kawalpemilu.org#53433,"BANTIRAN, PUPUAN, TABANAN, BALI",1,263,6,269
https://kawalpemilu.org#53433,"BANTIRAN, PUPUAN, TABANAN, BALI",2,179,3,182
https://kawalpemilu.org#53433,"BANTIRAN, PUPUAN, TABANAN, BALI",3,180,2,182
https://kawalpemilu.org#53433,"BANTIRAN, PUPUAN, TABANAN, BALI",4,189,9,198
https://kawalpemilu.org#53433,"BANTIRAN, PUPUAN, TABANAN, BALI",5,249,2,251
https://kawalpemilu.org#53433,"BANTIRAN, PUPUAN, TABANAN, BALI",6,261,2,263
https://kawalpemilu.org#53433,"BANTIRAN, PUPUAN, TABANAN, BALI",7,260,4,264
https://kawalpemilu.org#53433,"BANTIRAN, PUPUAN, TABANAN, BALI",8,198,4,202
https://kawalpemilu.org#53433,"BANTIRAN, PUPUAN, TABANAN, BALI",9,279,2,281
https://kawalpemilu.org#53433,"BANTIRAN, PUPUAN, TABANAN, BALI",10,240,4,244
https://kawalpemilu.org#53433,"BANTIRAN, PUPUAN, TABANAN, BALI",11,266,1,267
https://kawalpemilu.org#53433,"BANTIRAN, PUPUAN, TABANAN, BALI",12,179,0,179
https://kawalpemilu.org#53433,"BANTIRAN, PUPUAN, TABANAN, BALI",13,248,8,256
https://kawalpemilu.org#53433,"BANTIRAN, PUPUAN, TABANAN, BALI",14,238,0,238
https://kawalpemilu.org#53434,"PADANGAN, PUPUAN, TABANAN, BALI",1,195,0,195
https://kawalpemilu.org#53434,"PADANGAN, PUPUAN, TABANAN, BALI",2,195,4,199
https://kawalpemilu.org#53434,"PADANGAN, PUPUAN, TABANAN, BALI",3,190,2,192
https://kawalpemilu.org#53434,"PADANGAN, PUPUAN, TABANAN, BALI",4,180,0,180
https://kawalpemilu.org#53434,"PADANGAN, PUPUAN, TABANAN, BALI",5,192,5,197
https://kawalpemilu.org#53434,"PADANGAN, PUPUAN, TABANAN, BALI",6,180,4,184
https://kawalpemilu.org#53434,"PADANGAN, PUPUAN, TABANAN, BALI",7,251,2,253
https://kawalpemilu.org#53434,"PADANGAN, PUPUAN, TABANAN, BALI",8,226,0,226
https://kawalpemilu.org#53435,"JELIJIH PUNGGANG, PUPUAN, TABANAN, BALI",1,141,1,142
https://kawalpemilu.org#53435,"JELIJIH PUNGGANG, PUPUAN, TABANAN, BALI",2,137,1,138
https://kawalpemilu.org#53435,"JELIJIH PUNGGANG, PUPUAN, TABANAN, BALI",3,222,2,224
https://kawalpemilu.org#53435,"JELIJIH PUNGGANG, PUPUAN, TABANAN, BALI",4,206,6,212
https://kawalpemilu.org#53435,"JELIJIH PUNGGANG, PUPUAN, TABANAN, BALI",5,161,0,161
https://kawalpemilu.org#53435,"JELIJIH PUNGGANG, PUPUAN, TABANAN, BALI",6,171,1,172
https://kawalpemilu.org#53436,"BELATUNGAN, PUPUAN, TABANAN, BALI",1,156,9,165
https://kawalpemilu.org#53436,"BELATUNGAN, PUPUAN, TABANAN, BALI",2,141,14,155
https://kawalpemilu.org#53436,"BELATUNGAN, PUPUAN, TABANAN, BALI",3,201,7,208
https://kawalpemilu.org#53436,"BELATUNGAN, PUPUAN, TABANAN, BALI",4,206,5,211
https://kawalpemilu.org#53436,"BELATUNGAN, PUPUAN, TABANAN, BALI",5,137,17,154
https://kawalpemilu.org#53436,"BELATUNGAN, PUPUAN, TABANAN, BALI",6,130,9,139
https://kawalpemilu.org#53436,"BELATUNGAN, PUPUAN, TABANAN, BALI",7,147,1,148
https://kawalpemilu.org#53436,"BELATUNGAN, PUPUAN, TABANAN, BALI",8,142,5,147
https://kawalpemilu.org#53436,"BELATUNGAN, PUPUAN, TABANAN, BALI",9,143,1,144
https://kawalpemilu.org#53436,"BELATUNGAN, PUPUAN, TABANAN, BALI",10,133,4,135
https://kawalpemilu.org#53436,"BELATUNGAN, PUPUAN, TABANAN, BALI",11,144,4,148
https://kawalpemilu.org#53437,"PAJAHAN, PUPUAN, TABANAN, BALI",1,178,0,178
https://kawalpemilu.org#53437,"PAJAHAN, PUPUAN, TABANAN, BALI",2,178,1,179
https://kawalpemilu.org#53437,"PAJAHAN, PUPUAN, TABANAN, BALI",3,161,4,165
https://kawalpemilu.org#53437,"PAJAHAN, PUPUAN, TABANAN, BALI",4,158,0,158
https://kawalpemilu.org#53437,"PAJAHAN, PUPUAN, TABANAN, BALI",5,158,3,161
https://kawalpemilu.org#53437,"PAJAHAN, PUPUAN, TABANAN, BALI",6,150,3,153
https://kawalpemilu.org#53437,"PAJAHAN, PUPUAN, TABANAN, BALI",7,188,1,189
https://kawalpemilu.org#53437,"PAJAHAN, PUPUAN, TABANAN, BALI",8,223,1,224
https://kawalpemilu.org#53437,"PAJAHAN, PUPUAN, TABANAN, BALI",9,180,1,181
https://kawalpemilu.org#53437,"PAJAHAN, PUPUAN, TABANAN, BALI",10,165,2,167
https://kawalpemilu.org#53438,"KARYA SARI, PUPUAN, TABANAN, BALI",1,239,8,247
https://kawalpemilu.org#53438,"KARYA SARI, PUPUAN, TABANAN, BALI",2,227,17,244
https://kawalpemilu.org#53438,"KARYA SARI, PUPUAN, TABANAN, BALI",3,227,12,239
https://kawalpemilu.org#53438,"KARYA SARI, PUPUAN, TABANAN, BALI",4,235,10,245
https://kawalpemilu.org#53438,"KARYA SARI, PUPUAN, TABANAN, BALI",5,234,0,234
https://kawalpemilu.org#53438,"KARYA SARI, PUPUAN, TABANAN, BALI",6,233,4,237
https://kawalpemilu.org#84077,"SAI, PUPUAN, TABANAN, BALI",1,185,8,11
https://kawalpemilu.org#84077,"SAI, PUPUAN, TABANAN, BALI",2,190,7,197
https://kawalpemilu.org#84077,"SAI, PUPUAN, TABANAN, BALI",3,193,6,199
https://kawalpemilu.org#84077,"SAI, PUPUAN, TABANAN, BALI",4,186,4,190
https://kawalpemilu.org#84077,"SAI, PUPUAN, TABANAN, BALI",5,206,3,209
https://kawalpemilu.org#84077,"SAI, PUPUAN, TABANAN, BALI",6,196,9,205
https://kawalpemilu.org#53441,"TUBAN, KUTA, BADUNG, BALI",1,173,35,208
https://kawalpemilu.org#53441,"TUBAN, KUTA, BADUNG, BALI",2,141,48,189
https://kawalpemilu.org#53441,"TUBAN, KUTA, BADUNG, BALI",3,147,46,193
https://kawalpemilu.org#53441,"TUBAN, KUTA, BADUNG, BALI",4,166,59,225
https://kawalpemilu.org#53441,"TUBAN, KUTA, BADUNG, BALI",5,139,61,200
https://kawalpemilu.org#53441,"TUBAN, KUTA, BADUNG, BALI",6,163,51,214
https://kawalpemilu.org#53441,"TUBAN, KUTA, BADUNG, BALI",7,168,42,210
https://kawalpemilu.org#53441,"TUBAN, KUTA, BADUNG, BALI",8,153,39,192
https://kawalpemilu.org#53441,"TUBAN, KUTA, BADUNG, BALI",9,110,50,160
https://kawalpemilu.org#53441,"TUBAN, KUTA, BADUNG, BALI",10,165,25,190
https://kawalpemilu.org#53441,"TUBAN, KUTA, BADUNG, BALI",11,119,45,164
https://kawalpemilu.org#53441,"TUBAN, KUTA, BADUNG, BALI",12,137,73,210
https://kawalpemilu.org#53441,"TUBAN, KUTA, BADUNG, BALI",13,104,77,181
https://kawalpemilu.org#53441,"TUBAN, KUTA, BADUNG, BALI",14,84,96,180
https://kawalpemilu.org#53441,"TUBAN, KUTA, BADUNG, BALI",15,91,74,165
https://kawalpemilu.org#53441,"TUBAN, KUTA, BADUNG, BALI",16,175,20,195
https://kawalpemilu.org#53441,"TUBAN, KUTA, BADUNG, BALI",17,126,52,178
https://kawalpemilu.org#53441,"TUBAN, KUTA, BADUNG, BALI",18,110,48,158
https://kawalpemilu.org#53441,"TUBAN, KUTA, BADUNG, BALI",19,95,67,162
https://kawalpemilu.org#53441,"TUBAN, KUTA, BADUNG, BALI",20,92,73,165
https://kawalpemilu.org#53441,"TUBAN, KUTA, BADUNG, BALI",21,113,53,166
https://kawalpemilu.org#53441,"TUBAN, KUTA, BADUNG, BALI",22,124,61,185
https://kawalpemilu.org#53441,"TUBAN, KUTA, BADUNG, BALI",23,290,90,290
https://kawalpemilu.org#53441,"TUBAN, KUTA, BADUNG, BALI",24,214,54,268
https://kawalpemilu.org#53441,"TUBAN, KUTA, BADUNG, BALI",25,249,35,284
https://kawalpemilu.org#53441,"TUBAN, KUTA, BADUNG, BALI",26,235,37,272
https://kawalpemilu.org#53441,"TUBAN, KUTA, BADUNG, BALI",27,232,16,248
https://kawalpemilu.org#53441,"TUBAN, KUTA, BADUNG, BALI",28,203,38,241
https://kawalpemilu.org#53441,"TUBAN, KUTA, BADUNG, BALI",29,211,76,287
https://kawalpemilu.org#53441,"TUBAN, KUTA, BADUNG, BALI",30,251,21,272
https://kawalpemilu.org#53441,"TUBAN, KUTA, BADUNG, BALI",31,177,89,266
https://kawalpemilu.org#53441,"TUBAN, KUTA, BADUNG, BALI",33,235,33,268
https://kawalpemilu.org#53441,"TUBAN, KUTA, BADUNG, BALI",34,136,77,213
https://kawalpemilu.org#53441,"TUBAN, KUTA, BADUNG, BALI",35,113,68,181
https://kawalpemilu.org#53441,"TUBAN, KUTA, BADUNG, BALI",36,94,51,145
https://kawalpemilu.org#53441,"TUBAN, KUTA, BADUNG, BALI",37,98,38,136
https://kawalpemilu.org#53441,"TUBAN, KUTA, BADUNG, BALI",38,121,81,202
https://kawalpemilu.org#53441,"TUBAN, KUTA, BADUNG, BALI",39,192,61,253
https://kawalpemilu.org#53441,"TUBAN, KUTA, BADUNG, BALI",40,116,57,173
https://kawalpemilu.org#53441,"TUBAN, KUTA, BADUNG, BALI",41,125,78,203
https://kawalpemilu.org#53441,"TUBAN, KUTA, BADUNG, BALI",42,123,58,181
https://kawalpemilu.org#53441,"TUBAN, KUTA, BADUNG, BALI",43,105,83,188
https://kawalpemilu.org#53441,"TUBAN, KUTA, BADUNG, BALI",44,109,89,198
https://kawalpemilu.org#53441,"TUBAN, KUTA, BADUNG, BALI",45,105,80,185
https://kawalpemilu.org#53441,"TUBAN, KUTA, BADUNG, BALI",46,115,84,199
https://kawalpemilu.org#53441,"TUBAN, KUTA, BADUNG, BALI",47,101,98,189
https://kawalpemilu.org#53441,"TUBAN, KUTA, BADUNG, BALI",48,115,72,187
https://kawalpemilu.org#53441,"TUBAN, KUTA, BADUNG, BALI",49,117,69,186
https://kawalpemilu.org#53441,"TUBAN, KUTA, BADUNG, BALI",50,121,104,225
https://kawalpemilu.org#53441,"TUBAN, KUTA, BADUNG, BALI",51,167,101,268
https://kawalpemilu.org#53441,"TUBAN, KUTA, BADUNG, BALI",52,103,92,195
https://kawalpemilu.org#53441,"TUBAN, KUTA, BADUNG, BALI",53,208,63,271
https://kawalpemilu.org#53442,"KUTA, KUTA, BADUNG, BALI",1,226,25,251
https://kawalpemilu.org#53442,"KUTA, KUTA, BADUNG, BALI",2,230,33,263
https://kawalpemilu.org#53442,"KUTA, KUTA, BADUNG, BALI",4,261,10,271
https://kawalpemilu.org#53442,"KUTA, KUTA, BADUNG, BALI",6,186,23,209
https://kawalpemilu.org#53442,"KUTA, KUTA, BADUNG, BALI",7,274,3,277
https://kawalpemilu.org#53442,"KUTA, KUTA, BADUNG, BALI",9,233,11,244
https://kawalpemilu.org#53442,"KUTA, KUTA, BADUNG, BALI",10,208,10,218
https://kawalpemilu.org#53442,"KUTA, KUTA, BADUNG, BALI",11,223,6,229
https://kawalpemilu.org#53442,"KUTA, KUTA, BADUNG, BALI",12,220,13,233
https://kawalpemilu.org#53442,"KUTA, KUTA, BADUNG, BALI",13,216,18,234
https://kawalpemilu.org#53442,"KUTA, KUTA, BADUNG, BALI",14,212,13,225
https://kawalpemilu.org#53442,"KUTA, KUTA, BADUNG, BALI",15,227,12,239
https://kawalpemilu.org#53442,"KUTA, KUTA, BADUNG, BALI",16,228,4,232
https://kawalpemilu.org#53442,"KUTA, KUTA, BADUNG, BALI",17,230,6,236
https://kawalpemilu.org#53442,"KUTA, KUTA, BADUNG, BALI",18,219,8,227
https://kawalpemilu.org#53442,"KUTA, KUTA, BADUNG, BALI",20,211,15,226
https://kawalpemilu.org#53442,"KUTA, KUTA, BADUNG, BALI",21,216,3,219
https://kawalpemilu.org#53442,"KUTA, KUTA, BADUNG, BALI",22,208,8,216
https://kawalpemilu.org#53442,"KUTA, KUTA, BADUNG, BALI",23,211,6,217
https://kawalpemilu.org#53442,"KUTA, KUTA, BADUNG, BALI",24,217,5,222
https://kawalpemilu.org#53442,"KUTA, KUTA, BADUNG, BALI",25,213,11,224
https://kawalpemilu.org#53442,"KUTA, KUTA, BADUNG, BALI",26,247,7,254
https://kawalpemilu.org#53442,"KUTA, KUTA, BADUNG, BALI",27,234,14,248
https://kawalpemilu.org#53442,"KUTA, KUTA, BADUNG, BALI",28,230,17,247
https://kawalpemilu.org#53442,"KUTA, KUTA, BADUNG, BALI",29,207,3,210
https://kawalpemilu.org#53442,"KUTA, KUTA, BADUNG, BALI",30,203,1,204
https://kawalpemilu.org#53442,"KUTA, KUTA, BADUNG, BALI",31,193,2,195
https://kawalpemilu.org#53442,"KUTA, KUTA, BADUNG, BALI",32,214,11,225
https://kawalpemilu.org#53442,"KUTA, KUTA, BADUNG, BALI",33,238,12,250
https://kawalpemilu.org#53442,"KUTA, KUTA, BADUNG, BALI",34,171,25,196
https://kawalpemilu.org#53442,"KUTA, KUTA, BADUNG, BALI",35,195,35,230
https://kawalpemilu.org#53442,"KUTA, KUTA, BADUNG, BALI",36,240,63,303
https://kawalpemilu.org#53442,"KUTA, KUTA, BADUNG, BALI",37,196,22,218
https://kawalpemilu.org#53442,"KUTA, KUTA, BADUNG, BALI",38,181,36,217
https://kawalpemilu.org#53442,"KUTA, KUTA, BADUNG, BALI",40,223,22,245
https://kawalpemilu.org#53442,"KUTA, KUTA, BADUNG, BALI",41,231,6,237
https://kawalpemilu.org#53442,"KUTA, KUTA, BADUNG, BALI",42,247,8,255
https://kawalpemilu.org#53442,"KUTA, KUTA, BADUNG, BALI",43,215,16,231
https://kawalpemilu.org#53442,"KUTA, KUTA, BADUNG, BALI",44,196,28,224
https://kawalpemilu.org#53442,"KUTA, KUTA, BADUNG, BALI",45,200,21,221
https://kawalpemilu.org#53442,"KUTA, KUTA, BADUNG, BALI",46,142,32,174
https://kawalpemilu.org#53442,"KUTA, KUTA, BADUNG, BALI",47,186,41,227
https://kawalpemilu.org#53442,"KUTA, KUTA, BADUNG, BALI",48,207,12,219
https://kawalpemilu.org#53442,"KUTA, KUTA, BADUNG, BALI",49,176,37,213
https://kawalpemilu.org#53442,"KUTA, KUTA, BADUNG, BALI",50,177,26,203
https://kawalpemilu.org#53442,"KUTA, KUTA, BADUNG, BALI",51,226,35,261
https://kawalpemilu.org#53442,"KUTA, KUTA, BADUNG, BALI",52,181,28,209
https://kawalpemilu.org#53442,"KUTA, KUTA, BADUNG, BALI",53,180,20,200
https://kawalpemilu.org#53442,"KUTA, KUTA, BADUNG, BALI",54,147,51,198
https://kawalpemilu.org#53442,"KUTA, KUTA, BADUNG, BALI",55,143,57,200
https://kawalpemilu.org#53442,"KUTA, KUTA, BADUNG, BALI",57,161,37,198
https://kawalpemilu.org#53443,"KEDONGANAN, KUTA, BADUNG, BALI",1,243,36,279
https://kawalpemilu.org#53443,"KEDONGANAN, KUTA, BADUNG, BALI",2,256,15,271
https://kawalpemilu.org#53443,"KEDONGANAN, KUTA, BADUNG, BALI",3,249,46,295
https://kawalpemilu.org#53443,"KEDONGANAN, KUTA, BADUNG, BALI",4,244,33,277
https://kawalpemilu.org#53443,"KEDONGANAN, KUTA, BADUNG, BALI",5,239,25,264
https://kawalpemilu.org#53443,"KEDONGANAN, KUTA, BADUNG, BALI",6,234,44,278
https://kawalpemilu.org#53443,"KEDONGANAN, KUTA, BADUNG, BALI",7,262,16,278
https://kawalpemilu.org#53443,"KEDONGANAN, KUTA, BADUNG, BALI",8,252,19,271
https://kawalpemilu.org#53443,"KEDONGANAN, KUTA, BADUNG, BALI",9,260,10,270
https://kawalpemilu.org#53443,"KEDONGANAN, KUTA, BADUNG, BALI",10,0,0,249
https://kawalpemilu.org#53443,"KEDONGANAN, KUTA, BADUNG, BALI",11,239,11,250
https://kawalpemilu.org#53443,"KEDONGANAN, KUTA, BADUNG, BALI",12,276,20,296
https://kawalpemilu.org#53443,"KEDONGANAN, KUTA, BADUNG, BALI",13,237,22,259
https://kawalpemilu.org#53443,"KEDONGANAN, KUTA, BADUNG, BALI",14,217,26,243
https://kawalpemilu.org#53443,"KEDONGANAN, KUTA, BADUNG, BALI",15,262,10,272
https://kawalpemilu.org#53443,"KEDONGANAN, KUTA, BADUNG, BALI",16,249,6,255
https://kawalpemilu.org#53443,"KEDONGANAN, KUTA, BADUNG, BALI",17,247,24,271
https://kawalpemilu.org#53443,"KEDONGANAN, KUTA, BADUNG, BALI",18,151,48,199
https://kawalpemilu.org#53443,"KEDONGANAN, KUTA, BADUNG, BALI",19,159,62,221
https://kawalpemilu.org#53444,"LEGIAN, KUTA, BADUNG, BALI",1,250,11,261
https://kawalpemilu.org#53444,"LEGIAN, KUTA, BADUNG, BALI",2,238,6,244
https://kawalpemilu.org#53444,"LEGIAN, KUTA, BADUNG, BALI",3,241,5,246
https://kawalpemilu.org#53444,"LEGIAN, KUTA, BADUNG, BALI",4,238,2,240
https://kawalpemilu.org#53444,"LEGIAN, KUTA, BADUNG, BALI",5,108,32,140
https://kawalpemilu.org#53444,"LEGIAN, KUTA, BADUNG, BALI",7,249,5,254
https://kawalpemilu.org#53444,"LEGIAN, KUTA, BADUNG, BALI",8,137,65,202
https://kawalpemilu.org#53444,"LEGIAN, KUTA, BADUNG, BALI",9,248,13,261
https://kawalpemilu.org#53444,"LEGIAN, KUTA, BADUNG, BALI",10,262,4,266
https://kawalpemilu.org#53444,"LEGIAN, KUTA, BADUNG, BALI",11,271,5,276
https://kawalpemilu.org#53444,"LEGIAN, KUTA, BADUNG, BALI",12,183,44,227
https://kawalpemilu.org#53444,"LEGIAN, KUTA, BADUNG, BALI",13,128,59,187
https://kawalpemilu.org#53445,"SEMINYAK, KUTA, BADUNG, BALI",1,245,16,261
https://kawalpemilu.org#53445,"SEMINYAK, KUTA, BADUNG, BALI",2,240,6,246
https://kawalpemilu.org#53445,"SEMINYAK, KUTA, BADUNG, BALI",3,223,4,227
https://kawalpemilu.org#53445,"SEMINYAK, KUTA, BADUNG, BALI",4,242,5,247
https://kawalpemilu.org#53445,"SEMINYAK, KUTA, BADUNG, BALI",5,229,14,243
https://kawalpemilu.org#53445,"SEMINYAK, KUTA, BADUNG, BALI",6,231,6,237
https://kawalpemilu.org#53445,"SEMINYAK, KUTA, BADUNG, BALI",7,251,5,256
https://kawalpemilu.org#53445,"SEMINYAK, KUTA, BADUNG, BALI",8,185,8,193
https://kawalpemilu.org#53445,"SEMINYAK, KUTA, BADUNG, BALI",9,217,7,224
https://kawalpemilu.org#53445,"SEMINYAK, KUTA, BADUNG, BALI",10,248,6,254
https://kawalpemilu.org#53445,"SEMINYAK, KUTA, BADUNG, BALI",11,203,17,220
https://kawalpemilu.org#53447,"KAPAL, MENGWI, BADUNG, BALI",1,259,2,261
https://kawalpemilu.org#53447,"KAPAL, MENGWI, BADUNG, BALI",2,226,3,229
https://kawalpemilu.org#53447,"KAPAL, MENGWI, BADUNG, BALI",3,236,6,242
https://kawalpemilu.org#53447,"KAPAL, MENGWI, BADUNG, BALI",4,274,14,288
https://kawalpemilu.org#53447,"KAPAL, MENGWI, BADUNG, BALI",5,253,18,271
https://kawalpemilu.org#53447,"KAPAL, MENGWI, BADUNG, BALI",6,217,6,223
https://kawalpemilu.org#53447,"KAPAL, MENGWI, BADUNG, BALI",7,216,11,227
https://kawalpemilu.org#53447,"KAPAL, MENGWI, BADUNG, BALI",8,224,2,226
https://kawalpemilu.org#53447,"KAPAL, MENGWI, BADUNG, BALI",9,221,3,224
https://kawalpemilu.org#53447,"KAPAL, MENGWI, BADUNG, BALI",10,266,18,284
https://kawalpemilu.org#53447,"KAPAL, MENGWI, BADUNG, BALI",11,265,10,275
https://kawalpemilu.org#53447,"KAPAL, MENGWI, BADUNG, BALI",12,199,16,215
https://kawalpemilu.org#53447,"KAPAL, MENGWI, BADUNG, BALI",13,202,8,210
https://kawalpemilu.org#53447,"KAPAL, MENGWI, BADUNG, BALI",14,216,8,224
https://kawalpemilu.org#53447,"KAPAL, MENGWI, BADUNG, BALI",15,238,5,243
https://kawalpemilu.org#53447,"KAPAL, MENGWI, BADUNG, BALI",16,230,11,241
https://kawalpemilu.org#53447,"KAPAL, MENGWI, BADUNG, BALI",17,238,18,256
https://kawalpemilu.org#53447,"KAPAL, MENGWI, BADUNG, BALI",18,235,7,242
https://kawalpemilu.org#53447,"KAPAL, MENGWI, BADUNG, BALI",19,267,7,274
https://kawalpemilu.org#53447,"KAPAL, MENGWI, BADUNG, BALI",20,259,6,265
https://kawalpemilu.org#53447,"KAPAL, MENGWI, BADUNG, BALI",21,173,3,176
https://kawalpemilu.org#53447,"KAPAL, MENGWI, BADUNG, BALI",22,169,3,172
https://kawalpemilu.org#53447,"KAPAL, MENGWI, BADUNG, BALI",23,273,8,281
https://kawalpemilu.org#53447,"KAPAL, MENGWI, BADUNG, BALI",24,251,5,256
https://kawalpemilu.org#53447,"KAPAL, MENGWI, BADUNG, BALI",25,266,5,271
https://kawalpemilu.org#53447,"KAPAL, MENGWI, BADUNG, BALI",26,261,4,265
https://kawalpemilu.org#53447,"KAPAL, MENGWI, BADUNG, BALI",27,243,3,246
https://kawalpemilu.org#53447,"KAPAL, MENGWI, BADUNG, BALI",28,234,6,240
https://kawalpemilu.org#53447,"KAPAL, MENGWI, BADUNG, BALI",29,273,7,283
https://kawalpemilu.org#53447,"KAPAL, MENGWI, BADUNG, BALI",30,258,9,267
https://kawalpemilu.org#53447,"KAPAL, MENGWI, BADUNG, BALI",31,234,4,238
https://kawalpemilu.org#53447,"KAPAL, MENGWI, BADUNG, BALI",32,256,0,256
https://kawalpemilu.org#53447,"KAPAL, MENGWI, BADUNG, BALI",33,179,15,194
https://kawalpemilu.org#53447,"KAPAL, MENGWI, BADUNG, BALI",34,194,8,202
https://kawalpemilu.org#53447,"KAPAL, MENGWI, BADUNG, BALI",35,202,15,217
https://kawalpemilu.org#53448,"SEMPIDI, MENGWI, BADUNG, BALI",1,238,11,249
https://kawalpemilu.org#53448,"SEMPIDI, MENGWI, BADUNG, BALI",3,241,13,254
https://kawalpemilu.org#53448,"SEMPIDI, MENGWI, BADUNG, BALI",4,255,5,260
https://kawalpemilu.org#53448,"SEMPIDI, MENGWI, BADUNG, BALI",5,264,9,273
https://kawalpemilu.org#53448,"SEMPIDI, MENGWI, BADUNG, BALI",6,263,12,275
https://kawalpemilu.org#53448,"SEMPIDI, MENGWI, BADUNG, BALI",7,265,11,276
https://kawalpemilu.org#53448,"SEMPIDI, MENGWI, BADUNG, BALI",8,195,3,198
https://kawalpemilu.org#53448,"SEMPIDI, MENGWI, BADUNG, BALI",9,194,3,197
https://kawalpemilu.org#53448,"SEMPIDI, MENGWI, BADUNG, BALI",10,276,8,284
https://kawalpemilu.org#53448,"SEMPIDI, MENGWI, BADUNG, BALI",11,274,4,278
https://kawalpemilu.org#53448,"SEMPIDI, MENGWI, BADUNG, BALI",12,169,10,179
https://kawalpemilu.org#53448,"SEMPIDI, MENGWI, BADUNG, BALI",13,199,4,203
https://kawalpemilu.org#53448,"SEMPIDI, MENGWI, BADUNG, BALI",15,238,2,240
https://kawalpemilu.org#53448,"SEMPIDI, MENGWI, BADUNG, BALI",16,233,7,240
https://kawalpemilu.org#53448,"SEMPIDI, MENGWI, BADUNG, BALI",17,222,7,229
https://kawalpemilu.org#53448,"SEMPIDI, MENGWI, BADUNG, BALI",18,263,3,266
https://kawalpemilu.org#53448,"SEMPIDI, MENGWI, BADUNG, BALI",19,268,3,271
https://kawalpemilu.org#53449,"ABIANBASE, MENGWI, BADUNG, BALI",1,234,9,243
https://kawalpemilu.org#53449,"ABIANBASE, MENGWI, BADUNG, BALI",2,212,7,219
https://kawalpemilu.org#53449,"ABIANBASE, MENGWI, BADUNG, BALI",3,189,11,200
https://kawalpemilu.org#53449,"ABIANBASE, MENGWI, BADUNG, BALI",4,244,9,253
https://kawalpemilu.org#53449,"ABIANBASE, MENGWI, BADUNG, BALI",5,241,10,251
https://kawalpemilu.org#53449,"ABIANBASE, MENGWI, BADUNG, BALI",6,264,7,271
https://kawalpemilu.org#53449,"ABIANBASE, MENGWI, BADUNG, BALI",7,229,6,235
https://kawalpemilu.org#53449,"ABIANBASE, MENGWI, BADUNG, BALI",8,218,6,224
https://kawalpemilu.org#53449,"ABIANBASE, MENGWI, BADUNG, BALI",9,223,16,239
https://kawalpemilu.org#53449,"ABIANBASE, MENGWI, BADUNG, BALI",10,215,11,226
https://kawalpemilu.org#53449,"ABIANBASE, MENGWI, BADUNG, BALI",11,239,10,249
https://kawalpemilu.org#53449,"ABIANBASE, MENGWI, BADUNG, BALI",12,182,12,194
https://kawalpemilu.org#53449,"ABIANBASE, MENGWI, BADUNG, BALI",13,208,6,214
https://kawalpemilu.org#53449,"ABIANBASE, MENGWI, BADUNG, BALI",14,174,5,179
https://kawalpemilu.org#53449,"ABIANBASE, MENGWI, BADUNG, BALI",15,232,6,238
https://kawalpemilu.org#53449,"ABIANBASE, MENGWI, BADUNG, BALI",16,221,9,230
https://kawalpemilu.org#53449,"ABIANBASE, MENGWI, BADUNG, BALI",17,227,1,228
https://kawalpemilu.org#53449,"ABIANBASE, MENGWI, BADUNG, BALI",18,208,10,218
https://kawalpemilu.org#53449,"ABIANBASE, MENGWI, BADUNG, BALI",19,194,7,201
https://kawalpemilu.org#53449,"ABIANBASE, MENGWI, BADUNG, BALI",20,190,6,196
https://kawalpemilu.org#53449,"ABIANBASE, MENGWI, BADUNG, BALI",21,186,1,187
https://kawalpemilu.org#53450,"SADING, MENGWI, BADUNG, BALI",1,263,2,265
https://kawalpemilu.org#53450,"SADING, MENGWI, BADUNG, BALI",2,227,7,234
https://kawalpemilu.org#53450,"SADING, MENGWI, BADUNG, BALI",3,259,29,288
https://kawalpemilu.org#53450,"SADING, MENGWI, BADUNG, BALI",4,231,6,237
https://kawalpemilu.org#53450,"SADING, MENGWI, BADUNG, BALI",5,144,10,154
https://kawalpemilu.org#53450,"SADING, MENGWI, BADUNG, BALI",6,262,3,265
https://kawalpemilu.org#53450,"SADING, MENGWI, BADUNG, BALI",7,228,8,236
https://kawalpemilu.org#53450,"SADING, MENGWI, BADUNG, BALI",8,219,9,228
https://kawalpemilu.org#53450,"SADING, MENGWI, BADUNG, BALI",9,223,19,242
https://kawalpemilu.org#53450,"SADING, MENGWI, BADUNG, BALI",10,259,11,270
https://kawalpemilu.org#53450,"SADING, MENGWI, BADUNG, BALI",11,217,11,228
https://kawalpemilu.org#53450,"SADING, MENGWI, BADUNG, BALI",12,281,5,286
https://kawalpemilu.org#53450,"SADING, MENGWI, BADUNG, BALI",13,271,22,293
https://kawalpemilu.org#53450,"SADING, MENGWI, BADUNG, BALI",15,255,3,258
https://kawalpemilu.org#53450,"SADING, MENGWI, BADUNG, BALI",16,167,13,180
https://kawalpemilu.org#53450,"SADING, MENGWI, BADUNG, BALI",17,266,11,277
https://kawalpemilu.org#53450,"SADING, MENGWI, BADUNG, BALI",18,202,14,216
https://kawalpemilu.org#53450,"SADING, MENGWI, BADUNG, BALI",19,182,25,207
https://kawalpemilu.org#53450,"SADING, MENGWI, BADUNG, BALI",20,220,33,253
https://kawalpemilu.org#53450,"SADING, MENGWI, BADUNG, BALI",21,226,5,231
https://kawalpemilu.org#53450,"SADING, MENGWI, BADUNG, BALI",22,268,1,269
https://kawalpemilu.org#53450,"SADING, MENGWI, BADUNG, BALI",23,285,3,288
https://kawalpemilu.org#53451,"LUKLUK, MENGWI, BADUNG, BALI",1,273,14,287
https://kawalpemilu.org#53451,"LUKLUK, MENGWI, BADUNG, BALI",2,279,6,285
https://kawalpemilu.org#53451,"LUKLUK, MENGWI, BADUNG, BALI",3,283,5,288
https://kawalpemilu.org#53451,"LUKLUK, MENGWI, BADUNG, BALI",4,281,18,299
https://kawalpemilu.org#53451,"LUKLUK, MENGWI, BADUNG, BALI",5,274,2,276
https://kawalpemilu.org#53451,"LUKLUK, MENGWI, BADUNG, BALI",6,281,20,301
https://kawalpemilu.org#53451,"LUKLUK, MENGWI, BADUNG, BALI",7,275,16,291
https://kawalpemilu.org#53451,"LUKLUK, MENGWI, BADUNG, BALI",8,195,13,208
https://kawalpemilu.org#53451,"LUKLUK, MENGWI, BADUNG, BALI",9,258,5,263
https://kawalpemilu.org#53451,"LUKLUK, MENGWI, BADUNG, BALI",10,275,5,280
https://kawalpemilu.org#53451,"LUKLUK, MENGWI, BADUNG, BALI",11,248,6,254
https://kawalpemilu.org#53451,"LUKLUK, MENGWI, BADUNG, BALI",12,221,2,223
https://kawalpemilu.org#53451,"LUKLUK, MENGWI, BADUNG, BALI",13,227,3,230
https://kawalpemilu.org#53451,"LUKLUK, MENGWI, BADUNG, BALI",14,220,4,224
https://kawalpemilu.org#53451,"LUKLUK, MENGWI, BADUNG, BALI",15,274,5,279
https://kawalpemilu.org#53451,"LUKLUK, MENGWI, BADUNG, BALI",16,264,4,268
https://kawalpemilu.org#53451,"LUKLUK, MENGWI, BADUNG, BALI",17,189,7,196
https://kawalpemilu.org#53451,"LUKLUK, MENGWI, BADUNG, BALI",18,195,3,198
https://kawalpemilu.org#53451,"LUKLUK, MENGWI, BADUNG, BALI",19,203,6,209
https://kawalpemilu.org#53451,"LUKLUK, MENGWI, BADUNG, BALI",20,232,50,282
https://kawalpemilu.org#53451,"LUKLUK, MENGWI, BADUNG, BALI",21,212,54,266
https://kawalpemilu.org#53452,"MUNGGU, MENGWI, BADUNG, BALI",1,275,4,279
https://kawalpemilu.org#53452,"MUNGGU, MENGWI, BADUNG, BALI",2,225,2,227
https://kawalpemilu.org#53452,"MUNGGU, MENGWI, BADUNG, BALI",3,271,7,278
https://kawalpemilu.org#53452,"MUNGGU, MENGWI, BADUNG, BALI",4,259,14,273
https://kawalpemilu.org#53452,"MUNGGU, MENGWI, BADUNG, BALI",5,268,9,277
https://kawalpemilu.org#53452,"MUNGGU, MENGWI, BADUNG, BALI",7,278,3,281
https://kawalpemilu.org#53452,"MUNGGU, MENGWI, BADUNG, BALI",8,268,5,273
https://kawalpemilu.org#53452,"MUNGGU, MENGWI, BADUNG, BALI",9,272,7,279
https://kawalpemilu.org#53452,"MUNGGU, MENGWI, BADUNG, BALI",10,272,1,273
https://kawalpemilu.org#53452,"MUNGGU, MENGWI, BADUNG, BALI",11,252,3,255
https://kawalpemilu.org#53452,"MUNGGU, MENGWI, BADUNG, BALI",12,215,4,219
https://kawalpemilu.org#53452,"MUNGGU, MENGWI, BADUNG, BALI",13,258,9,267
https://kawalpemilu.org#53452,"MUNGGU, MENGWI, BADUNG, BALI",14,277,11,288
https://kawalpemilu.org#53452,"MUNGGU, MENGWI, BADUNG, BALI",15,174,16,190
https://kawalpemilu.org#53452,"MUNGGU, MENGWI, BADUNG, BALI",16,186,11,197
https://kawalpemilu.org#53452,"MUNGGU, MENGWI, BADUNG, BALI",17,221,6,227
https://kawalpemilu.org#53452,"MUNGGU, MENGWI, BADUNG, BALI",18,226,6,232
https://kawalpemilu.org#53452,"MUNGGU, MENGWI, BADUNG, BALI",19,211,4,215
https://kawalpemilu.org#53452,"MUNGGU, MENGWI, BADUNG, BALI",20,240,4,244
https://kawalpemilu.org#53452,"MUNGGU, MENGWI, BADUNG, BALI",21,206,3,209
https://kawalpemilu.org#53453,"BUDUK, MENGWI, BADUNG, BALI",1,272,7,279
https://kawalpemilu.org#53453,"BUDUK, MENGWI, BADUNG, BALI",2,246,17,263
https://kawalpemilu.org#53453,"BUDUK, MENGWI, BADUNG, BALI",3,239,14,253
https://kawalpemilu.org#53453,"BUDUK, MENGWI, BADUNG, BALI",4,202,16,218
https://kawalpemilu.org#53453,"BUDUK, MENGWI, BADUNG, BALI",5,188,24,212
https://kawalpemilu.org#53453,"BUDUK, MENGWI, BADUNG, BALI",6,214,20,234
https://kawalpemilu.org#53453,"BUDUK, MENGWI, BADUNG, BALI",7,200,23,223
https://kawalpemilu.org#53453,"BUDUK, MENGWI, BADUNG, BALI",8,201,58,259
https://kawalpemilu.org#53453,"BUDUK, MENGWI, BADUNG, BALI",9,236,28,264
https://kawalpemilu.org#53453,"BUDUK, MENGWI, BADUNG, BALI",10,241,11,252
https://kawalpemilu.org#53453,"BUDUK, MENGWI, BADUNG, BALI",11,225,26,251
https://kawalpemilu.org#53453,"BUDUK, MENGWI, BADUNG, BALI",12,231,17,248
https://kawalpemilu.org#53453,"BUDUK, MENGWI, BADUNG, BALI",13,196,20,216
https://kawalpemilu.org#53453,"BUDUK, MENGWI, BADUNG, BALI",14,242,34,276
https://kawalpemilu.org#53453,"BUDUK, MENGWI, BADUNG, BALI",15,261,12,273
https://kawalpemilu.org#53453,"BUDUK, MENGWI, BADUNG, BALI",16,265,10,275
https://kawalpemilu.org#53453,"BUDUK, MENGWI, BADUNG, BALI",17,205,3,208
https://kawalpemilu.org#53453,"BUDUK, MENGWI, BADUNG, BALI",18,213,3,216
https://kawalpemilu.org#53453,"BUDUK, MENGWI, BADUNG, BALI",19,256,18,274
https://kawalpemilu.org#53453,"BUDUK, MENGWI, BADUNG, BALI",20,240,14,254
https://kawalpemilu.org#53453,"BUDUK, MENGWI, BADUNG, BALI",21,267,8,275
https://kawalpemilu.org#53453,"BUDUK, MENGWI, BADUNG, BALI",22,196,12,208
https://kawalpemilu.org#53454,"MENGWITANI, MENGWI, BADUNG, BALI",1,290,2,292
https://kawalpemilu.org#53454,"MENGWITANI, MENGWI, BADUNG, BALI",2,233,15,248
https://kawalpemilu.org#53454,"MENGWITANI, MENGWI, BADUNG, BALI",3,187,9,196
https://kawalpemilu.org#53454,"MENGWITANI, MENGWI, BADUNG, BALI",4,223,9,232
https://kawalpemilu.org#53454,"MENGWITANI, MENGWI, BADUNG, BALI",5,268,8,276
https://kawalpemilu.org#53454,"MENGWITANI, MENGWI, BADUNG, BALI",6,297,1,298
https://kawalpemilu.org#53454,"MENGWITANI, MENGWI, BADUNG, BALI",7,239,12,251
https://kawalpemilu.org#53454,"MENGWITANI, MENGWI, BADUNG, BALI",8,275,13,288
https://kawalpemilu.org#53454,"MENGWITANI, MENGWI, BADUNG, BALI",9,232,11,243
https://kawalpemilu.org#53454,"MENGWITANI, MENGWI, BADUNG, BALI",10,273,9,282
https://kawalpemilu.org#53454,"MENGWITANI, MENGWI, BADUNG, BALI",11,235,14,249
https://kawalpemilu.org#53454,"MENGWITANI, MENGWI, BADUNG, BALI",12,266,6,272
https://kawalpemilu.org#53454,"MENGWITANI, MENGWI, BADUNG, BALI",13,243,3,246
https://kawalpemilu.org#53454,"MENGWITANI, MENGWI, BADUNG, BALI",14,256,4,260
https://kawalpemilu.org#53454,"MENGWITANI, MENGWI, BADUNG, BALI",15,286,1,287
https://kawalpemilu.org#53454,"MENGWITANI, MENGWI, BADUNG, BALI",16,239,14,253
https://kawalpemilu.org#53454,"MENGWITANI, MENGWI, BADUNG, BALI",17,258,3,261
https://kawalpemilu.org#53454,"MENGWITANI, MENGWI, BADUNG, BALI",18,246,5,251
https://kawalpemilu.org#53454,"MENGWITANI, MENGWI, BADUNG, BALI",19,275,2,277
https://kawalpemilu.org#53454,"MENGWITANI, MENGWI, BADUNG, BALI",20,189,3,192
https://kawalpemilu.org#53454,"MENGWITANI, MENGWI, BADUNG, BALI",21,267,14,281
https://kawalpemilu.org#53454,"MENGWITANI, MENGWI, BADUNG, BALI",22,265,10,275
https://kawalpemilu.org#53455,"PENARUNGAN, MENGWI, BADUNG, BALI",1,273,9,282
https://kawalpemilu.org#53455,"PENARUNGAN, MENGWI, BADUNG, BALI",2,235,11,246
https://kawalpemilu.org#53455,"PENARUNGAN, MENGWI, BADUNG, BALI",3,270,9,279
https://kawalpemilu.org#53455,"PENARUNGAN, MENGWI, BADUNG, BALI",4,278,6,284
https://kawalpemilu.org#53455,"PENARUNGAN, MENGWI, BADUNG, BALI",5,279,12,291
https://kawalpemilu.org#53455,"PENARUNGAN, MENGWI, BADUNG, BALI",6,248,12,260
https://kawalpemilu.org#53455,"PENARUNGAN, MENGWI, BADUNG, BALI",7,226,8,234
https://kawalpemilu.org#53455,"PENARUNGAN, MENGWI, BADUNG, BALI",8,210,11,221
https://kawalpemilu.org#53455,"PENARUNGAN, MENGWI, BADUNG, BALI",9,198,8,206
https://kawalpemilu.org#53455,"PENARUNGAN, MENGWI, BADUNG, BALI",10,247,8,255
https://kawalpemilu.org#53455,"PENARUNGAN, MENGWI, BADUNG, BALI",11,249,11,260
https://kawalpemilu.org#53455,"PENARUNGAN, MENGWI, BADUNG, BALI",12,235,12,247
https://kawalpemilu.org#53455,"PENARUNGAN, MENGWI, BADUNG, BALI",13,278,4,282
https://kawalpemilu.org#53455,"PENARUNGAN, MENGWI, BADUNG, BALI",14,267,15,282
https://kawalpemilu.org#53455,"PENARUNGAN, MENGWI, BADUNG, BALI",15,253,6,259
https://kawalpemilu.org#53455,"PENARUNGAN, MENGWI, BADUNG, BALI",16,275,4,279
https://kawalpemilu.org#53455,"PENARUNGAN, MENGWI, BADUNG, BALI",17,286,2,288
https://kawalpemilu.org#53455,"PENARUNGAN, MENGWI, BADUNG, BALI",18,232,0,232
https://kawalpemilu.org#53455,"PENARUNGAN, MENGWI, BADUNG, BALI",19,287,1,288
https://kawalpemilu.org#53455,"PENARUNGAN, MENGWI, BADUNG, BALI",20,290,1,291
https://kawalpemilu.org#53456,"SEMBUNG, MENGWI, BADUNG, BALI",1,221,7,228
https://kawalpemilu.org#53456,"SEMBUNG, MENGWI, BADUNG, BALI",2,226,13,239
https://kawalpemilu.org#53456,"SEMBUNG, MENGWI, BADUNG, BALI",3,261,9,270
https://kawalpemilu.org#53456,"SEMBUNG, MENGWI, BADUNG, BALI",4,193,1,194
https://kawalpemilu.org#53456,"SEMBUNG, MENGWI, BADUNG, BALI",5,245,9,254
https://kawalpemilu.org#53456,"SEMBUNG, MENGWI, BADUNG, BALI",6,196,4,200
https://kawalpemilu.org#53456,"SEMBUNG, MENGWI, BADUNG, BALI",7,193,5,198
https://kawalpemilu.org#53456,"SEMBUNG, MENGWI, BADUNG, BALI",8,180,13,193
https://kawalpemilu.org#53456,"SEMBUNG, MENGWI, BADUNG, BALI",9,161,16,177
https://kawalpemilu.org#53456,"SEMBUNG, MENGWI, BADUNG, BALI",10,153,13,166
https://kawalpemilu.org#53456,"SEMBUNG, MENGWI, BADUNG, BALI",11,184,5,189
https://kawalpemilu.org#53456,"SEMBUNG, MENGWI, BADUNG, BALI",12,259,8,267
https://kawalpemilu.org#53456,"SEMBUNG, MENGWI, BADUNG, BALI",13,251,3,254
https://kawalpemilu.org#53456,"SEMBUNG, MENGWI, BADUNG, BALI",14,200,7,207
https://kawalpemilu.org#53456,"SEMBUNG, MENGWI, BADUNG, BALI",15,226,6,232
https://kawalpemilu.org#53456,"SEMBUNG, MENGWI, BADUNG, BALI",16,192,8,200
https://kawalpemilu.org#53456,"SEMBUNG, MENGWI, BADUNG, BALI",17,207,2,209
https://kawalpemilu.org#53456,"SEMBUNG, MENGWI, BADUNG, BALI",18,131,3,134
https://kawalpemilu.org#53456,"SEMBUNG, MENGWI, BADUNG, BALI",19,126,17,143
https://kawalpemilu.org#53456,"SEMBUNG, MENGWI, BADUNG, BALI",20,155,7,162
https://kawalpemilu.org#53457,"BAHA, MENGWI, BADUNG, BALI",1,224,10,234
https://kawalpemilu.org#53457,"BAHA, MENGWI, BADUNG, BALI",2,236,13,249
https://kawalpemilu.org#53457,"BAHA, MENGWI, BADUNG, BALI",3,202,14,216
https://kawalpemilu.org#53457,"BAHA, MENGWI, BADUNG, BALI",4,204,7,211
https://kawalpemilu.org#53457,"BAHA, MENGWI, BADUNG, BALI",5,229,13,242
https://kawalpemilu.org#53457,"BAHA, MENGWI, BADUNG, BALI",6,238,14,252
https://kawalpemilu.org#53457,"BAHA, MENGWI, BADUNG, BALI",7,244,14,258
https://kawalpemilu.org#53457,"BAHA, MENGWI, BADUNG, BALI",8,256,8,264
https://kawalpemilu.org#53457,"BAHA, MENGWI, BADUNG, BALI",9,222,14,236
https://kawalpemilu.org#53457,"BAHA, MENGWI, BADUNG, BALI",10,147,18,165
https://kawalpemilu.org#53457,"BAHA, MENGWI, BADUNG, BALI",11,161,20,181
https://kawalpemilu.org#53457,"BAHA, MENGWI, BADUNG, BALI",12,178,5,183
https://kawalpemilu.org#53458,"MENGWI, MENGWI, BADUNG, BALI",1,240,3,243
https://kawalpemilu.org#53458,"MENGWI, MENGWI, BADUNG, BALI",2,229,3,232
https://kawalpemilu.org#53458,"MENGWI, MENGWI, BADUNG, BALI",3,220,7,227
https://kawalpemilu.org#53458,"MENGWI, MENGWI, BADUNG, BALI",4,238,6,244
https://kawalpemilu.org#53458,"MENGWI, MENGWI, BADUNG, BALI",5,243,11,254
https://kawalpemilu.org#53458,"MENGWI, MENGWI, BADUNG, BALI",6,240,13,253
https://kawalpemilu.org#53458,"MENGWI, MENGWI, BADUNG, BALI",7,270,3,273
https://kawalpemilu.org#53458,"MENGWI, MENGWI, BADUNG, BALI",8,283,10,293
https://kawalpemilu.org#53458,"MENGWI, MENGWI, BADUNG, BALI",9,229,6,235
https://kawalpemilu.org#53458,"MENGWI, MENGWI, BADUNG, BALI",10,231,5,236
https://kawalpemilu.org#53458,"MENGWI, MENGWI, BADUNG, BALI",11,214,1,215
https://kawalpemilu.org#53458,"MENGWI, MENGWI, BADUNG, BALI",12,217,4,221
https://kawalpemilu.org#53458,"MENGWI, MENGWI, BADUNG, BALI",13,239,4,241
https://kawalpemilu.org#53458,"MENGWI, MENGWI, BADUNG, BALI",14,232,4,236
https://kawalpemilu.org#53458,"MENGWI, MENGWI, BADUNG, BALI",15,228,10,238
https://kawalpemilu.org#53458,"MENGWI, MENGWI, BADUNG, BALI",16,239,8,247
https://kawalpemilu.org#53458,"MENGWI, MENGWI, BADUNG, BALI",17,228,10,238
https://kawalpemilu.org#53458,"MENGWI, MENGWI, BADUNG, BALI",18,239,7,246
https://kawalpemilu.org#53458,"MENGWI, MENGWI, BADUNG, BALI",19,228,7,235
https://kawalpemilu.org#53458,"MENGWI, MENGWI, BADUNG, BALI",20,267,13,280
https://kawalpemilu.org#53458,"MENGWI, MENGWI, BADUNG, BALI",21,250,16,266
https://kawalpemilu.org#53458,"MENGWI, MENGWI, BADUNG, BALI",22,253,9,262
https://kawalpemilu.org#53458,"MENGWI, MENGWI, BADUNG, BALI",23,202,3,205
https://kawalpemilu.org#53458,"MENGWI, MENGWI, BADUNG, BALI",24,194,6,200
https://kawalpemilu.org#53459,"KEKERAN, MENGWI, BADUNG, BALI",1,279,8,287
https://kawalpemilu.org#53459,"KEKERAN, MENGWI, BADUNG, BALI",2,276,5,281
https://kawalpemilu.org#53459,"KEKERAN, MENGWI, BADUNG, BALI",3,276,5,281
https://kawalpemilu.org#53459,"KEKERAN, MENGWI, BADUNG, BALI",4,273,8,281
https://kawalpemilu.org#53459,"KEKERAN, MENGWI, BADUNG, BALI",5,269,8,277
https://kawalpemilu.org#53459,"KEKERAN, MENGWI, BADUNG, BALI",6,275,16,291
https://kawalpemilu.org#53459,"KEKERAN, MENGWI, BADUNG, BALI",7,280,3,283
https://kawalpemilu.org#53459,"KEKERAN, MENGWI, BADUNG, BALI",8,241,5,246
https://kawalpemilu.org#53459,"KEKERAN, MENGWI, BADUNG, BALI",9,193,2,195
https://kawalpemilu.org#53459,"KEKERAN, MENGWI, BADUNG, BALI",10,201,2,203
https://kawalpemilu.org#53459,"KEKERAN, MENGWI, BADUNG, BALI",11,265,2,267
https://kawalpemilu.org#53460,"SOBANGAN, MENGWI, BADUNG, BALI",1,226,16,242
https://kawalpemilu.org#53460,"SOBANGAN, MENGWI, BADUNG, BALI",2,241,15,256
https://kawalpemilu.org#53460,"SOBANGAN, MENGWI, BADUNG, BALI",3,283,9,292
https://kawalpemilu.org#53460,"SOBANGAN, MENGWI, BADUNG, BALI",4,263,21,284
https://kawalpemilu.org#53460,"SOBANGAN, MENGWI, BADUNG, BALI",5,245,10,255
https://kawalpemilu.org#53460,"SOBANGAN, MENGWI, BADUNG, BALI",6,262,15,277
https://kawalpemilu.org#53460,"SOBANGAN, MENGWI, BADUNG, BALI",7,258,16,274
https://kawalpemilu.org#53460,"SOBANGAN, MENGWI, BADUNG, BALI",8,250,15,265
https://kawalpemilu.org#53460,"SOBANGAN, MENGWI, BADUNG, BALI",9,268,11,279
https://kawalpemilu.org#53460,"SOBANGAN, MENGWI, BADUNG, BALI",10,269,8,277
https://kawalpemilu.org#53461,"GULINGAN, MENGWI, BADUNG, BALI",1,253,18,271
https://kawalpemilu.org#53461,"GULINGAN, MENGWI, BADUNG, BALI",2,243,15,258
https://kawalpemilu.org#53461,"GULINGAN, MENGWI, BADUNG, BALI",3,241,17,258
https://kawalpemilu.org#53461,"GULINGAN, MENGWI, BADUNG, BALI",4,248,27,275
https://kawalpemilu.org#53461,"GULINGAN, MENGWI, BADUNG, BALI",5,206,19,225
https://kawalpemilu.org#53461,"GULINGAN, MENGWI, BADUNG, BALI",6,231,10,241
https://kawalpemilu.org#53461,"GULINGAN, MENGWI, BADUNG, BALI",7,211,12,223
https://kawalpemilu.org#53461,"GULINGAN, MENGWI, BADUNG, BALI",8,244,14,258
https://kawalpemilu.org#53461,"GULINGAN, MENGWI, BADUNG, BALI",9,243,5,248
https://kawalpemilu.org#53461,"GULINGAN, MENGWI, BADUNG, BALI",10,247,6,253
https://kawalpemilu.org#53461,"GULINGAN, MENGWI, BADUNG, BALI",11,242,11,253
https://kawalpemilu.org#53461,"GULINGAN, MENGWI, BADUNG, BALI",12,243,22,265
https://kawalpemilu.org#53461,"GULINGAN, MENGWI, BADUNG, BALI",13,205,10,215
https://kawalpemilu.org#53461,"GULINGAN, MENGWI, BADUNG, BALI",14,265,13,278
https://kawalpemilu.org#53461,"GULINGAN, MENGWI, BADUNG, BALI",15,206,4,210
https://kawalpemilu.org#53461,"GULINGAN, MENGWI, BADUNG, BALI",16,183,8,191
https://kawalpemilu.org#53461,"GULINGAN, MENGWI, BADUNG, BALI",17,225,11,236
https://kawalpemilu.org#53461,"GULINGAN, MENGWI, BADUNG, BALI",18,198,2,200
https://kawalpemilu.org#53461,"GULINGAN, MENGWI, BADUNG, BALI",19,241,7,248
https://kawalpemilu.org#53461,"GULINGAN, MENGWI, BADUNG, BALI",20,226,8,234
https://kawalpemilu.org#53461,"GULINGAN, MENGWI, BADUNG, BALI",21,237,4,241
https://kawalpemilu.org#53461,"GULINGAN, MENGWI, BADUNG, BALI",22,177,3,180
https://kawalpemilu.org#53461,"GULINGAN, MENGWI, BADUNG, BALI",23,186,15,201
https://kawalpemilu.org#53461,"GULINGAN, MENGWI, BADUNG, BALI",24,243,8,251
https://kawalpemilu.org#53462,"WERDI BHUANA, MENGWI, BADUNG, BALI",1,282,7,289
https://kawalpemilu.org#53462,"WERDI BHUANA, MENGWI, BADUNG, BALI",2,150,0,150
https://kawalpemilu.org#53462,"WERDI BHUANA, MENGWI, BADUNG, BALI",3,276,10,286
https://kawalpemilu.org#53462,"WERDI BHUANA, MENGWI, BADUNG, BALI",4,248,18,266
https://kawalpemilu.org#53462,"WERDI BHUANA, MENGWI, BADUNG, BALI",5,265,12,277
https://kawalpemilu.org#53462,"WERDI BHUANA, MENGWI, BADUNG, BALI",6,276,9,285
https://kawalpemilu.org#53462,"WERDI BHUANA, MENGWI, BADUNG, BALI",7,264,19,283
https://kawalpemilu.org#53462,"WERDI BHUANA, MENGWI, BADUNG, BALI",8,272,8,280
https://kawalpemilu.org#53462,"WERDI BHUANA, MENGWI, BADUNG, BALI",9,253,11,264
https://kawalpemilu.org#53462,"WERDI BHUANA, MENGWI, BADUNG, BALI",10,268,14,282
https://kawalpemilu.org#53462,"WERDI BHUANA, MENGWI, BADUNG, BALI",11,272,13,285
https://kawalpemilu.org#53462,"WERDI BHUANA, MENGWI, BADUNG, BALI",12,249,12,261
https://kawalpemilu.org#53462,"WERDI BHUANA, MENGWI, BADUNG, BALI",13,260,17,277
https://kawalpemilu.org#53462,"WERDI BHUANA, MENGWI, BADUNG, BALI",14,256,8,264
https://kawalpemilu.org#53463,"CEMAGI, MENGWI, BADUNG, BALI",1,263,2,265
https://kawalpemilu.org#53463,"CEMAGI, MENGWI, BADUNG, BALI",2,246,7,253
https://kawalpemilu.org#53463,"CEMAGI, MENGWI, BADUNG, BALI",3,273,0,273
https://kawalpemilu.org#53463,"CEMAGI, MENGWI, BADUNG, BALI",4,251,8,259
https://kawalpemilu.org#53463,"CEMAGI, MENGWI, BADUNG, BALI",5,275,7,282
https://kawalpemilu.org#53463,"CEMAGI, MENGWI, BADUNG, BALI",6,258,8,266
https://kawalpemilu.org#53463,"CEMAGI, MENGWI, BADUNG, BALI",7,247,8,255
https://kawalpemilu.org#53463,"CEMAGI, MENGWI, BADUNG, BALI",9,255,8,263
https://kawalpemilu.org#53463,"CEMAGI, MENGWI, BADUNG, BALI",10,264,6,270
https://kawalpemilu.org#53463,"CEMAGI, MENGWI, BADUNG, BALI",11,250,4,254
https://kawalpemilu.org#53463,"CEMAGI, MENGWI, BADUNG, BALI",12,249,1,250
https://kawalpemilu.org#53463,"CEMAGI, MENGWI, BADUNG, BALI",13,223,5,228
https://kawalpemilu.org#53463,"CEMAGI, MENGWI, BADUNG, BALI",14,275,6,281
https://kawalpemilu.org#53463,"CEMAGI, MENGWI, BADUNG, BALI",15,256,12,268
https://kawalpemilu.org#53464,"PERERENAN, MENGWI, BADUNG, BALI",1,253,8,261
https://kawalpemilu.org#53464,"PERERENAN, MENGWI, BADUNG, BALI",2,273,7,280
https://kawalpemilu.org#53464,"PERERENAN, MENGWI, BADUNG, BALI",3,198,3,201
https://kawalpemilu.org#53464,"PERERENAN, MENGWI, BADUNG, BALI",4,259,7,266
https://kawalpemilu.org#53464,"PERERENAN, MENGWI, BADUNG, BALI",5,268,8,276
https://kawalpemilu.org#53464,"PERERENAN, MENGWI, BADUNG, BALI",7,259,12,271
https://kawalpemilu.org#53464,"PERERENAN, MENGWI, BADUNG, BALI",8,220,7,227
https://kawalpemilu.org#53464,"PERERENAN, MENGWI, BADUNG, BALI",9,225,8,233
https://kawalpemilu.org#53465,"TUMBAKBAYUH, MENGWI, BADUNG, BALI",1,291,4,295
https://kawalpemilu.org#53465,"TUMBAKBAYUH, MENGWI, BADUNG, BALI",2,251,4,255
https://kawalpemilu.org#53465,"TUMBAKBAYUH, MENGWI, BADUNG, BALI",3,266,14,280
https://kawalpemilu.org#53465,"TUMBAKBAYUH, MENGWI, BADUNG, BALI",4,284,5,289
https://kawalpemilu.org#53465,"TUMBAKBAYUH, MENGWI, BADUNG, BALI",5,246,3,249
https://kawalpemilu.org#53465,"TUMBAKBAYUH, MENGWI, BADUNG, BALI",6,210,1,211
https://kawalpemilu.org#53465,"TUMBAKBAYUH, MENGWI, BADUNG, BALI",7,199,8,207
https://kawalpemilu.org#53465,"TUMBAKBAYUH, MENGWI, BADUNG, BALI",8,243,0,243
https://kawalpemilu.org#53465,"TUMBAKBAYUH, MENGWI, BADUNG, BALI",9,294,1,295
https://kawalpemilu.org#53465,"TUMBAKBAYUH, MENGWI, BADUNG, BALI",10,231,3,234
https://kawalpemilu.org#53466,"KUWUM, MENGWI, BADUNG, BALI",1,275,10,285
https://kawalpemilu.org#53466,"KUWUM, MENGWI, BADUNG, BALI",2,281,9,290
https://kawalpemilu.org#53466,"KUWUM, MENGWI, BADUNG, BALI",3,273,11,284
https://kawalpemilu.org#53466,"KUWUM, MENGWI, BADUNG, BALI",4,255,12,267
https://kawalpemilu.org#53466,"KUWUM, MENGWI, BADUNG, BALI",5,214,5,219
https://kawalpemilu.org#53466,"KUWUM, MENGWI, BADUNG, BALI",6,225,9,234
https://kawalpemilu.org#53466,"KUWUM, MENGWI, BADUNG, BALI",7,205,9,214
https://kawalpemilu.org#53466,"KUWUM, MENGWI, BADUNG, BALI",8,225,3,228
https://kawalpemilu.org#53466,"KUWUM, MENGWI, BADUNG, BALI",9,217,3,220
https://kawalpemilu.org#53468,"DARMASABA, ABIANSEMAL, BADUNG, BALI",1,288,5,293
https://kawalpemilu.org#53468,"DARMASABA, ABIANSEMAL, BADUNG, BALI",2,282,2,284
https://kawalpemilu.org#53468,"DARMASABA, ABIANSEMAL, BADUNG, BALI",3,249,7,256
https://kawalpemilu.org#53468,"DARMASABA, ABIANSEMAL, BADUNG, BALI",4,279,8,287
https://kawalpemilu.org#53468,"DARMASABA, ABIANSEMAL, BADUNG, BALI",5,292,4,296
https://kawalpemilu.org#53468,"DARMASABA, ABIANSEMAL, BADUNG, BALI",6,226,53,279
https://kawalpemilu.org#53468,"DARMASABA, ABIANSEMAL, BADUNG, BALI",7,278,19,297
https://kawalpemilu.org#53468,"DARMASABA, ABIANSEMAL, BADUNG, BALI",8,274,13,287
https://kawalpemilu.org#53468,"DARMASABA, ABIANSEMAL, BADUNG, BALI",9,282,8,290
https://kawalpemilu.org#53468,"DARMASABA, ABIANSEMAL, BADUNG, BALI",10,245,8,253
https://kawalpemilu.org#53468,"DARMASABA, ABIANSEMAL, BADUNG, BALI",11,295,4,299
https://kawalpemilu.org#53468,"DARMASABA, ABIANSEMAL, BADUNG, BALI",12,300,0,300
https://kawalpemilu.org#53468,"DARMASABA, ABIANSEMAL, BADUNG, BALI",13,296,1,297
https://kawalpemilu.org#53468,"DARMASABA, ABIANSEMAL, BADUNG, BALI",14,240,4,244
https://kawalpemilu.org#53468,"DARMASABA, ABIANSEMAL, BADUNG, BALI",15,233,2,235
https://kawalpemilu.org#53468,"DARMASABA, ABIANSEMAL, BADUNG, BALI",17,286,2,288
https://kawalpemilu.org#53468,"DARMASABA, ABIANSEMAL, BADUNG, BALI",18,291,2,293
https://kawalpemilu.org#53468,"DARMASABA, ABIANSEMAL, BADUNG, BALI",19,277,5,282
https://kawalpemilu.org#53468,"DARMASABA, ABIANSEMAL, BADUNG, BALI",20,267,3,270
https://kawalpemilu.org#53468,"DARMASABA, ABIANSEMAL, BADUNG, BALI",21,274,7,281
https://kawalpemilu.org#53468,"DARMASABA, ABIANSEMAL, BADUNG, BALI",22,234,8,242
https://kawalpemilu.org#53468,"DARMASABA, ABIANSEMAL, BADUNG, BALI",23,265,11,276
https://kawalpemilu.org#53468,"DARMASABA, ABIANSEMAL, BADUNG, BALI",24,228,9,237
https://kawalpemilu.org#53468,"DARMASABA, ABIANSEMAL, BADUNG, BALI",25,266,3,269
https://kawalpemilu.org#53468,"DARMASABA, ABIANSEMAL, BADUNG, BALI",26,264,1,265
https://kawalpemilu.org#53469,"SIBANGKAJA, ABIANSEMAL, BADUNG, BALI",1,242,15,257
https://kawalpemilu.org#53469,"SIBANGKAJA, ABIANSEMAL, BADUNG, BALI",2,236,30,266
https://kawalpemilu.org#53469,"SIBANGKAJA, ABIANSEMAL, BADUNG, BALI",3,204,22,226
https://kawalpemilu.org#53469,"SIBANGKAJA, ABIANSEMAL, BADUNG, BALI",4,268,11,279
https://kawalpemilu.org#53469,"SIBANGKAJA, ABIANSEMAL, BADUNG, BALI",5,248,11,259
https://kawalpemilu.org#53469,"SIBANGKAJA, ABIANSEMAL, BADUNG, BALI",6,274,7,281
https://kawalpemilu.org#53469,"SIBANGKAJA, ABIANSEMAL, BADUNG, BALI",7,275,4,279
https://kawalpemilu.org#53469,"SIBANGKAJA, ABIANSEMAL, BADUNG, BALI",8,260,9,269
https://kawalpemilu.org#53469,"SIBANGKAJA, ABIANSEMAL, BADUNG, BALI",9,228,22,250
https://kawalpemilu.org#53469,"SIBANGKAJA, ABIANSEMAL, BADUNG, BALI",10,169,22,191
https://kawalpemilu.org#53469,"SIBANGKAJA, ABIANSEMAL, BADUNG, BALI",11,258,22,280
https://kawalpemilu.org#53469,"SIBANGKAJA, ABIANSEMAL, BADUNG, BALI",12,265,9,274
https://kawalpemilu.org#53469,"SIBANGKAJA, ABIANSEMAL, BADUNG, BALI",13,254,10,264
https://kawalpemilu.org#53469,"SIBANGKAJA, ABIANSEMAL, BADUNG, BALI",15,266,9,275
https://kawalpemilu.org#53469,"SIBANGKAJA, ABIANSEMAL, BADUNG, BALI",16,276,5,281
https://kawalpemilu.org#53469,"SIBANGKAJA, ABIANSEMAL, BADUNG, BALI",17,278,7,285
https://kawalpemilu.org#53470,"SIBANGGEDE, ABIANSEMAL, BADUNG, BALI",1,265,10,275
https://kawalpemilu.org#53470,"SIBANGGEDE, ABIANSEMAL, BADUNG, BALI",2,261,8,269
https://kawalpemilu.org#53470,"SIBANGGEDE, ABIANSEMAL, BADUNG, BALI",3,229,7,236
https://kawalpemilu.org#53470,"SIBANGGEDE, ABIANSEMAL, BADUNG, BALI",4,224,12,236
https://kawalpemilu.org#53470,"SIBANGGEDE, ABIANSEMAL, BADUNG, BALI",5,255,8,263
https://kawalpemilu.org#53470,"SIBANGGEDE, ABIANSEMAL, BADUNG, BALI",6,224,4,228
https://kawalpemilu.org#53470,"SIBANGGEDE, ABIANSEMAL, BADUNG, BALI",8,235,16,251
https://kawalpemilu.org#53470,"SIBANGGEDE, ABIANSEMAL, BADUNG, BALI",9,269,10,279
https://kawalpemilu.org#53470,"SIBANGGEDE, ABIANSEMAL, BADUNG, BALI",10,260,12,272
https://kawalpemilu.org#53470,"SIBANGGEDE, ABIANSEMAL, BADUNG, BALI",11,263,5,268
https://kawalpemilu.org#53470,"SIBANGGEDE, ABIANSEMAL, BADUNG, BALI",12,248,16,264
https://kawalpemilu.org#53470,"SIBANGGEDE, ABIANSEMAL, BADUNG, BALI",13,277,4,281
https://kawalpemilu.org#53470,"SIBANGGEDE, ABIANSEMAL, BADUNG, BALI",14,281,4,285
https://kawalpemilu.org#53470,"SIBANGGEDE, ABIANSEMAL, BADUNG, BALI",15,264,6,270
https://kawalpemilu.org#53470,"SIBANGGEDE, ABIANSEMAL, BADUNG, BALI",16,268,12,280
https://kawalpemilu.org#53470,"SIBANGGEDE, ABIANSEMAL, BADUNG, BALI",17,190,13,203
https://kawalpemilu.org#53470,"SIBANGGEDE, ABIANSEMAL, BADUNG, BALI",18,217,11,228
https://kawalpemilu.org#53470,"SIBANGGEDE, ABIANSEMAL, BADUNG, BALI",19,202,11,213
https://kawalpemilu.org#53470,"SIBANGGEDE, ABIANSEMAL, BADUNG, BALI",20,265,11,276
https://kawalpemilu.org#53471,"JAGAPATI, ABIANSEMAL, BADUNG, BALI",1,223,11,234
https://kawalpemilu.org#53471,"JAGAPATI, ABIANSEMAL, BADUNG, BALI",2,210,8,218
https://kawalpemilu.org#53471,"JAGAPATI, ABIANSEMAL, BADUNG, BALI",3,207,13,220
https://kawalpemilu.org#53471,"JAGAPATI, ABIANSEMAL, BADUNG, BALI",4,223,9,232
https://kawalpemilu.org#53471,"JAGAPATI, ABIANSEMAL, BADUNG, BALI",5,219,8,227
https://kawalpemilu.org#53471,"JAGAPATI, ABIANSEMAL, BADUNG, BALI",6,212,22,234
https://kawalpemilu.org#53471,"JAGAPATI, ABIANSEMAL, BADUNG, BALI",7,216,18,234
https://kawalpemilu.org#53471,"JAGAPATI, ABIANSEMAL, BADUNG, BALI",8,211,10,221
https://kawalpemilu.org#53471,"JAGAPATI, ABIANSEMAL, BADUNG, BALI",9,223,5,228
https://kawalpemilu.org#53471,"JAGAPATI, ABIANSEMAL, BADUNG, BALI",10,262,11,273
https://kawalpemilu.org#53471,"JAGAPATI, ABIANSEMAL, BADUNG, BALI",11,262,7,269
https://kawalpemilu.org#53472,"ANGANTAKA, ABIANSEMAL, BADUNG, BALI",1,196,10,206
https://kawalpemilu.org#53472,"ANGANTAKA, ABIANSEMAL, BADUNG, BALI",2,197,17,214
https://kawalpemilu.org#53472,"ANGANTAKA, ABIANSEMAL, BADUNG, BALI",3,170,22,192
https://kawalpemilu.org#53472,"ANGANTAKA, ABIANSEMAL, BADUNG, BALI",4,245,17,262
https://kawalpemilu.org#53472,"ANGANTAKA, ABIANSEMAL, BADUNG, BALI",5,226,14,240
https://kawalpemilu.org#53472,"ANGANTAKA, ABIANSEMAL, BADUNG, BALI",6,235,23,258
https://kawalpemilu.org#53472,"ANGANTAKA, ABIANSEMAL, BADUNG, BALI",7,205,9,214
https://kawalpemilu.org#53472,"ANGANTAKA, ABIANSEMAL, BADUNG, BALI",8,208,10,218
https://kawalpemilu.org#53472,"ANGANTAKA, ABIANSEMAL, BADUNG, BALI",9,227,11,238
https://kawalpemilu.org#53472,"ANGANTAKA, ABIANSEMAL, BADUNG, BALI",10,197,7,204
https://kawalpemilu.org#53472,"ANGANTAKA, ABIANSEMAL, BADUNG, BALI",11,222,16,238
https://kawalpemilu.org#53472,"ANGANTAKA, ABIANSEMAL, BADUNG, BALI",12,233,16,249
https://kawalpemilu.org#53473,"SEDANG, ABIANSEMAL, BADUNG, BALI",1,269,19,288
https://kawalpemilu.org#53473,"SEDANG, ABIANSEMAL, BADUNG, BALI",2,271,18,289
https://kawalpemilu.org#53473,"SEDANG, ABIANSEMAL, BADUNG, BALI",3,271,18,289
https://kawalpemilu.org#53473,"SEDANG, ABIANSEMAL, BADUNG, BALI",4,238,10,248
https://kawalpemilu.org#53473,"SEDANG, ABIANSEMAL, BADUNG, BALI",5,217,15,232
https://kawalpemilu.org#53473,"SEDANG, ABIANSEMAL, BADUNG, BALI",6,196,8,204
https://kawalpemilu.org#53473,"SEDANG, ABIANSEMAL, BADUNG, BALI",7,192,14,206
https://kawalpemilu.org#53473,"SEDANG, ABIANSEMAL, BADUNG, BALI",8,270,13,283
https://kawalpemilu.org#53473,"SEDANG, ABIANSEMAL, BADUNG, BALI",9,215,20,235
https://kawalpemilu.org#53473,"SEDANG, ABIANSEMAL, BADUNG, BALI",10,249,13,262
https://kawalpemilu.org#53473,"SEDANG, ABIANSEMAL, BADUNG, BALI",11,210,4,214
https://kawalpemilu.org#53473,"SEDANG, ABIANSEMAL, BADUNG, BALI",12,216,34,250
https://kawalpemilu.org#53474,"MAMBAL, ABIANSEMAL, BADUNG, BALI",1,266,7,273
https://kawalpemilu.org#53474,"MAMBAL, ABIANSEMAL, BADUNG, BALI",2,162,4,166
https://kawalpemilu.org#53474,"MAMBAL, ABIANSEMAL, BADUNG, BALI",3,265,13,278
https://kawalpemilu.org#53474,"MAMBAL, ABIANSEMAL, BADUNG, BALI",4,167,6,173
https://kawalpemilu.org#53474,"MAMBAL, ABIANSEMAL, BADUNG, BALI",5,256,4,260
https://kawalpemilu.org#53474,"MAMBAL, ABIANSEMAL, BADUNG, BALI",6,206,5,211
https://kawalpemilu.org#53474,"MAMBAL, ABIANSEMAL, BADUNG, BALI",8,173,7,180
https://kawalpemilu.org#53474,"MAMBAL, ABIANSEMAL, BADUNG, BALI",9,225,32,257
https://kawalpemilu.org#53474,"MAMBAL, ABIANSEMAL, BADUNG, BALI",10,216,34,250
https://kawalpemilu.org#53474,"MAMBAL, ABIANSEMAL, BADUNG, BALI",11,265,9,274
https://kawalpemilu.org#53474,"MAMBAL, ABIANSEMAL, BADUNG, BALI",12,161,10,171
https://kawalpemilu.org#53474,"MAMBAL, ABIANSEMAL, BADUNG, BALI",13,265,8,273
https://kawalpemilu.org#53474,"MAMBAL, ABIANSEMAL, BADUNG, BALI",14,136,3,139
https://kawalpemilu.org#53474,"MAMBAL, ABIANSEMAL, BADUNG, BALI",15,260,13,273
https://kawalpemilu.org#53474,"MAMBAL, ABIANSEMAL, BADUNG, BALI",16,264,13,277
https://kawalpemilu.org#53475,"ABIANSEMAL, ABIANSEMAL, BADUNG, BALI",1,271,12,283
https://kawalpemilu.org#53475,"ABIANSEMAL, ABIANSEMAL, BADUNG, BALI",2,252,24,276
https://kawalpemilu.org#53475,"ABIANSEMAL, ABIANSEMAL, BADUNG, BALI",3,196,9,205
https://kawalpemilu.org#53475,"ABIANSEMAL, ABIANSEMAL, BADUNG, BALI",4,265,6,271
https://kawalpemilu.org#53475,"ABIANSEMAL, ABIANSEMAL, BADUNG, BALI",5,257,12,269
https://kawalpemilu.org#53475,"ABIANSEMAL, ABIANSEMAL, BADUNG, BALI",6,270,7,277
https://kawalpemilu.org#53475,"ABIANSEMAL, ABIANSEMAL, BADUNG, BALI",7,273,5,278
https://kawalpemilu.org#53475,"ABIANSEMAL, ABIANSEMAL, BADUNG, BALI",8,263,11,274
https://kawalpemilu.org#53475,"ABIANSEMAL, ABIANSEMAL, BADUNG, BALI",9,194,10,204
https://kawalpemilu.org#53475,"ABIANSEMAL, ABIANSEMAL, BADUNG, BALI",10,255,0,255
https://kawalpemilu.org#53475,"ABIANSEMAL, ABIANSEMAL, BADUNG, BALI",11,274,4,278
https://kawalpemilu.org#53475,"ABIANSEMAL, ABIANSEMAL, BADUNG, BALI",12,268,4,272
https://kawalpemilu.org#53475,"ABIANSEMAL, ABIANSEMAL, BADUNG, BALI",13,273,1,274
https://kawalpemilu.org#53475,"ABIANSEMAL, ABIANSEMAL, BADUNG, BALI",14,274,3,277
https://kawalpemilu.org#53475,"ABIANSEMAL, ABIANSEMAL, BADUNG, BALI",15,230,29,259
https://kawalpemilu.org#53475,"ABIANSEMAL, ABIANSEMAL, BADUNG, BALI",16,290,0,290
https://kawalpemilu.org#53475,"ABIANSEMAL, ABIANSEMAL, BADUNG, BALI",17,287,2,289
https://kawalpemilu.org#53475,"ABIANSEMAL, ABIANSEMAL, BADUNG, BALI",18,272,10,282
https://kawalpemilu.org#53475,"ABIANSEMAL, ABIANSEMAL, BADUNG, BALI",19,292,9,301
https://kawalpemilu.org#53475,"ABIANSEMAL, ABIANSEMAL, BADUNG, BALI",20,223,5,228
https://kawalpemilu.org#53476,"BONGKASA, ABIANSEMAL, BADUNG, BALI",1,215,16,231
https://kawalpemilu.org#53476,"BONGKASA, ABIANSEMAL, BADUNG, BALI",2,235,8,243
https://kawalpemilu.org#53476,"BONGKASA, ABIANSEMAL, BADUNG, BALI",4,276,2,278
https://kawalpemilu.org#53476,"BONGKASA, ABIANSEMAL, BADUNG, BALI",5,230,7,237
https://kawalpemilu.org#53476,"BONGKASA, ABIANSEMAL, BADUNG, BALI",6,225,8,233
https://kawalpemilu.org#53476,"BONGKASA, ABIANSEMAL, BADUNG, BALI",7,278,1,279
https://kawalpemilu.org#53476,"BONGKASA, ABIANSEMAL, BADUNG, BALI",8,267,6,273
https://kawalpemilu.org#53476,"BONGKASA, ABIANSEMAL, BADUNG, BALI",9,210,5,215
https://kawalpemilu.org#53476,"BONGKASA, ABIANSEMAL, BADUNG, BALI",11,251,7,258
https://kawalpemilu.org#53476,"BONGKASA, ABIANSEMAL, BADUNG, BALI",12,234,11,245
https://kawalpemilu.org#53476,"BONGKASA, ABIANSEMAL, BADUNG, BALI",13,271,5,276
https://kawalpemilu.org#53476,"BONGKASA, ABIANSEMAL, BADUNG, BALI",14,265,3,268
https://kawalpemilu.org#53476,"BONGKASA, ABIANSEMAL, BADUNG, BALI",15,230,0,230
https://kawalpemilu.org#53476,"BONGKASA, ABIANSEMAL, BADUNG, BALI",17,259,10,269
https://kawalpemilu.org#53476,"BONGKASA, ABIANSEMAL, BADUNG, BALI",18,73,1,74
https://kawalpemilu.org#53477,"TAMAN, ABIANSEMAL, BADUNG, BALI",1,246,1,247
https://kawalpemilu.org#53477,"TAMAN, ABIANSEMAL, BADUNG, BALI",2,158,0,158
https://kawalpemilu.org#53477,"TAMAN, ABIANSEMAL, BADUNG, BALI",3,205,4,209
https://kawalpemilu.org#53477,"TAMAN, ABIANSEMAL, BADUNG, BALI",4,200,1,201
https://kawalpemilu.org#53477,"TAMAN, ABIANSEMAL, BADUNG, BALI",5,215,4,219
https://kawalpemilu.org#53477,"TAMAN, ABIANSEMAL, BADUNG, BALI",6,210,5,215
https://kawalpemilu.org#53477,"TAMAN, ABIANSEMAL, BADUNG, BALI",7,282,2,284
https://kawalpemilu.org#53477,"TAMAN, ABIANSEMAL, BADUNG, BALI",8,264,7,271
https://kawalpemilu.org#53477,"TAMAN, ABIANSEMAL, BADUNG, BALI",9,264,7,271
https://kawalpemilu.org#53477,"TAMAN, ABIANSEMAL, BADUNG, BALI",10,215,11,226
https://kawalpemilu.org#53477,"TAMAN, ABIANSEMAL, BADUNG, BALI",11,218,18,236
https://kawalpemilu.org#53477,"TAMAN, ABIANSEMAL, BADUNG, BALI",12,205,15,220
https://kawalpemilu.org#53477,"TAMAN, ABIANSEMAL, BADUNG, BALI",13,189,18,207
https://kawalpemilu.org#53477,"TAMAN, ABIANSEMAL, BADUNG, BALI",14,161,21,182
https://kawalpemilu.org#53477,"TAMAN, ABIANSEMAL, BADUNG, BALI",15,261,11,272
https://kawalpemilu.org#53477,"TAMAN, ABIANSEMAL, BADUNG, BALI",16,193,10,203
https://kawalpemilu.org#53477,"TAMAN, ABIANSEMAL, BADUNG, BALI",17,201,4,205
https://kawalpemilu.org#53477,"TAMAN, ABIANSEMAL, BADUNG, BALI",18,196,12,208
https://kawalpemilu.org#53477,"TAMAN, ABIANSEMAL, BADUNG, BALI",19,203,9,212
https://kawalpemilu.org#53477,"TAMAN, ABIANSEMAL, BADUNG, BALI",20,179,3,182
https://kawalpemilu.org#53477,"TAMAN, ABIANSEMAL, BADUNG, BALI",21,163,4,167
https://kawalpemilu.org#53477,"TAMAN, ABIANSEMAL, BADUNG, BALI",22,213,11,224
https://kawalpemilu.org#53477,"TAMAN, ABIANSEMAL, BADUNG, BALI",23,210,9,219
https://kawalpemilu.org#53478,"BLAHKIUH, ABIANSEMAL, BADUNG, BALI",1,261,17,278
https://kawalpemilu.org#53478,"BLAHKIUH, ABIANSEMAL, BADUNG, BALI",2,239,18,257
https://kawalpemilu.org#53478,"BLAHKIUH, ABIANSEMAL, BADUNG, BALI",3,236,22,258
https://kawalpemilu.org#53478,"BLAHKIUH, ABIANSEMAL, BADUNG, BALI",4,256,13,269
https://kawalpemilu.org#53478,"BLAHKIUH, ABIANSEMAL, BADUNG, BALI",5,257,13,270
https://kawalpemilu.org#53478,"BLAHKIUH, ABIANSEMAL, BADUNG, BALI",6,273,9,282
https://kawalpemilu.org#53478,"BLAHKIUH, ABIANSEMAL, BADUNG, BALI",7,259,5,264
https://kawalpemilu.org#53478,"BLAHKIUH, ABIANSEMAL, BADUNG, BALI",8,259,13,272
https://kawalpemilu.org#53478,"BLAHKIUH, ABIANSEMAL, BADUNG, BALI",9,241,7,248
https://kawalpemilu.org#53478,"BLAHKIUH, ABIANSEMAL, BADUNG, BALI",10,290,7,297
https://kawalpemilu.org#53478,"BLAHKIUH, ABIANSEMAL, BADUNG, BALI",11,266,7,273
https://kawalpemilu.org#53478,"BLAHKIUH, ABIANSEMAL, BADUNG, BALI",12,260,14,274
https://kawalpemilu.org#53478,"BLAHKIUH, ABIANSEMAL, BADUNG, BALI",13,249,11,260
https://kawalpemilu.org#53478,"BLAHKIUH, ABIANSEMAL, BADUNG, BALI",14,245,7,252
https://kawalpemilu.org#53478,"BLAHKIUH, ABIANSEMAL, BADUNG, BALI",15,249,9,258
https://kawalpemilu.org#53478,"BLAHKIUH, ABIANSEMAL, BADUNG, BALI",16,233,12,245
https://kawalpemilu.org#53479,"AYUNAN, ABIANSEMAL, BADUNG, BALI",1,200,19,219
https://kawalpemilu.org#53479,"AYUNAN, ABIANSEMAL, BADUNG, BALI",2,195,12,207
https://kawalpemilu.org#53479,"AYUNAN, ABIANSEMAL, BADUNG, BALI",3,211,7,218
https://kawalpemilu.org#53479,"AYUNAN, ABIANSEMAL, BADUNG, BALI",4,231,15,246
https://kawalpemilu.org#53479,"AYUNAN, ABIANSEMAL, BADUNG, BALI",5,240,4,244
https://kawalpemilu.org#53479,"AYUNAN, ABIANSEMAL, BADUNG, BALI",6,215,9,224
https://kawalpemilu.org#53479,"AYUNAN, ABIANSEMAL, BADUNG, BALI",7,182,3,185
https://kawalpemilu.org#53479,"AYUNAN, ABIANSEMAL, BADUNG, BALI",8,186,3,189
https://kawalpemilu.org#53480,"SANGEH, ABIANSEMAL, BADUNG, BALI",1,224,2,226
https://kawalpemilu.org#53480,"SANGEH, ABIANSEMAL, BADUNG, BALI",2,243,4,247
https://kawalpemilu.org#53480,"SANGEH, ABIANSEMAL, BADUNG, BALI",3,210,11,221
https://kawalpemilu.org#53480,"SANGEH, ABIANSEMAL, BADUNG, BALI",4,238,6,244
https://kawalpemilu.org#53480,"SANGEH, ABIANSEMAL, BADUNG, BALI",5,232,8,240
https://kawalpemilu.org#53480,"SANGEH, ABIANSEMAL, BADUNG, BALI",6,220,12,232
https://kawalpemilu.org#53480,"SANGEH, ABIANSEMAL, BADUNG, BALI",7,198,4,202
https://kawalpemilu.org#53480,"SANGEH, ABIANSEMAL, BADUNG, BALI",8,263,5,268
https://kawalpemilu.org#53480,"SANGEH, ABIANSEMAL, BADUNG, BALI",9,195,3,198
https://kawalpemilu.org#53480,"SANGEH, ABIANSEMAL, BADUNG, BALI",10,202,0,202
https://kawalpemilu.org#53480,"SANGEH, ABIANSEMAL, BADUNG, BALI",11,252,10,262
https://kawalpemilu.org#53480,"SANGEH, ABIANSEMAL, BADUNG, BALI",12,216,7,223
https://kawalpemilu.org#53480,"SANGEH, ABIANSEMAL, BADUNG, BALI",13,217,2,219
https://kawalpemilu.org#53480,"SANGEH, ABIANSEMAL, BADUNG, BALI",14,193,0,193
https://kawalpemilu.org#53481,"PUNGGUL, ABIANSEMAL, BADUNG, BALI",1,258,8,266
https://kawalpemilu.org#53481,"PUNGGUL, ABIANSEMAL, BADUNG, BALI",2,257,13,270
https://kawalpemilu.org#53481,"PUNGGUL, ABIANSEMAL, BADUNG, BALI",3,272,3,275
https://kawalpemilu.org#53481,"PUNGGUL, ABIANSEMAL, BADUNG, BALI",4,275,10,285
https://kawalpemilu.org#53481,"PUNGGUL, ABIANSEMAL, BADUNG, BALI",5,198,8,206
https://kawalpemilu.org#53481,"PUNGGUL, ABIANSEMAL, BADUNG, BALI",6,219,6,225
https://kawalpemilu.org#53481,"PUNGGUL, ABIANSEMAL, BADUNG, BALI",7,257,4,261
https://kawalpemilu.org#53481,"PUNGGUL, ABIANSEMAL, BADUNG, BALI",8,248,13,261
https://kawalpemilu.org#53481,"PUNGGUL, ABIANSEMAL, BADUNG, BALI",9,174,2,176
https://kawalpemilu.org#53482,"MEKAR BHUANA, ABIANSEMAL, BADUNG, BALI",1,244,8,252
https://kawalpemilu.org#53482,"MEKAR BHUANA, ABIANSEMAL, BADUNG, BALI",2,247,9,256
https://kawalpemilu.org#53482,"MEKAR BHUANA, ABIANSEMAL, BADUNG, BALI",3,252,3,255
https://kawalpemilu.org#53482,"MEKAR BHUANA, ABIANSEMAL, BADUNG, BALI",4,239,3,242
https://kawalpemilu.org#53482,"MEKAR BHUANA, ABIANSEMAL, BADUNG, BALI",6,245,8,253
https://kawalpemilu.org#53482,"MEKAR BHUANA, ABIANSEMAL, BADUNG, BALI",8,224,13,237
https://kawalpemilu.org#53482,"MEKAR BHUANA, ABIANSEMAL, BADUNG, BALI",9,197,10,207
https://kawalpemilu.org#53482,"MEKAR BHUANA, ABIANSEMAL, BADUNG, BALI",10,195,4,199
https://kawalpemilu.org#53482,"MEKAR BHUANA, ABIANSEMAL, BADUNG, BALI",11,191,10,201
https://kawalpemilu.org#53482,"MEKAR BHUANA, ABIANSEMAL, BADUNG, BALI",12,231,11,242
https://kawalpemilu.org#53482,"MEKAR BHUANA, ABIANSEMAL, BADUNG, BALI",13,221,15,236
https://kawalpemilu.org#53482,"MEKAR BHUANA, ABIANSEMAL, BADUNG, BALI",14,226,10,236
https://kawalpemilu.org#53482,"MEKAR BHUANA, ABIANSEMAL, BADUNG, BALI",15,216,16,232
https://kawalpemilu.org#53483,"DAUH YEH CANI, ABIANSEMAL, BADUNG, BALI",1,260,13,273
https://kawalpemilu.org#53483,"DAUH YEH CANI, ABIANSEMAL, BADUNG, BALI",2,263,16,279
https://kawalpemilu.org#53483,"DAUH YEH CANI, ABIANSEMAL, BADUNG, BALI",3,274,10,284
https://kawalpemilu.org#53483,"DAUH YEH CANI, ABIANSEMAL, BADUNG, BALI",4,255,15,270
https://kawalpemilu.org#53483,"DAUH YEH CANI, ABIANSEMAL, BADUNG, BALI",5,272,11,283
https://kawalpemilu.org#53483,"DAUH YEH CANI, ABIANSEMAL, BADUNG, BALI",6,277,15,292
https://kawalpemilu.org#53483,"DAUH YEH CANI, ABIANSEMAL, BADUNG, BALI",7,274,4,278
https://kawalpemilu.org#53483,"DAUH YEH CANI, ABIANSEMAL, BADUNG, BALI",9,278,6,284
https://kawalpemilu.org#53483,"DAUH YEH CANI, ABIANSEMAL, BADUNG, BALI",10,271,8,279
https://kawalpemilu.org#53483,"DAUH YEH CANI, ABIANSEMAL, BADUNG, BALI",11,226,7,233
https://kawalpemilu.org#53483,"DAUH YEH CANI, ABIANSEMAL, BADUNG, BALI",12,275,11,286
https://kawalpemilu.org#53483,"DAUH YEH CANI, ABIANSEMAL, BADUNG, BALI",13,248,15,263
https://kawalpemilu.org#53483,"DAUH YEH CANI, ABIANSEMAL, BADUNG, BALI",14,255,8,263
https://kawalpemilu.org#53483,"DAUH YEH CANI, ABIANSEMAL, BADUNG, BALI",15,253,13,266
https://kawalpemilu.org#53483,"DAUH YEH CANI, ABIANSEMAL, BADUNG, BALI",16,246,18,264
https://kawalpemilu.org#53484,"SELAT, ABIANSEMAL, BADUNG, BALI",1,255,15,270
https://kawalpemilu.org#53484,"SELAT, ABIANSEMAL, BADUNG, BALI",2,245,23,268
https://kawalpemilu.org#53484,"SELAT, ABIANSEMAL, BADUNG, BALI",3,201,12,213
https://kawalpemilu.org#53484,"SELAT, ABIANSEMAL, BADUNG, BALI",4,183,16,199
https://kawalpemilu.org#53484,"SELAT, ABIANSEMAL, BADUNG, BALI",5,215,11,226
https://kawalpemilu.org#53484,"SELAT, ABIANSEMAL, BADUNG, BALI",6,215,12,227
https://kawalpemilu.org#53484,"SELAT, ABIANSEMAL, BADUNG, BALI",7,216,7,223
https://kawalpemilu.org#53485,"BONGKASA PERTIWI, ABIANSEMAL, BADUNG, BALI",1,261,5,266
https://kawalpemilu.org#53485,"BONGKASA PERTIWI, ABIANSEMAL, BADUNG, BALI",2,255,3,258
https://kawalpemilu.org#53485,"BONGKASA PERTIWI, ABIANSEMAL, BADUNG, BALI",3,266,0,266
https://kawalpemilu.org#53485,"BONGKASA PERTIWI, ABIANSEMAL, BADUNG, BALI",4,258,7,265
https://kawalpemilu.org#53485,"BONGKASA PERTIWI, ABIANSEMAL, BADUNG, BALI",5,249,7,256
https://kawalpemilu.org#53485,"BONGKASA PERTIWI, ABIANSEMAL, BADUNG, BALI",6,261,5,266
https://kawalpemilu.org#53485,"BONGKASA PERTIWI, ABIANSEMAL, BADUNG, BALI",7,211,4,215
https://kawalpemilu.org#53487,"CARANGSARI, PETANG, BADUNG, BALI",1,243,5,248
https://kawalpemilu.org#53487,"CARANGSARI, PETANG, BADUNG, BALI",2,249,5,254
https://kawalpemilu.org#53487,"CARANGSARI, PETANG, BADUNG, BALI",3,179,6,185
https://kawalpemilu.org#53487,"CARANGSARI, PETANG, BADUNG, BALI",4,222,5,227
https://kawalpemilu.org#53487,"CARANGSARI, PETANG, BADUNG, BALI",5,216,10,226
https://kawalpemilu.org#53487,"CARANGSARI, PETANG, BADUNG, BALI",6,242,11,253
https://kawalpemilu.org#53487,"CARANGSARI, PETANG, BADUNG, BALI",7,243,13,256
https://kawalpemilu.org#53487,"CARANGSARI, PETANG, BADUNG, BALI",8,226,14,240
https://kawalpemilu.org#53487,"CARANGSARI, PETANG, BADUNG, BALI",9,226,32,258
https://kawalpemilu.org#53487,"CARANGSARI, PETANG, BADUNG, BALI",10,190,19,209
https://kawalpemilu.org#53487,"CARANGSARI, PETANG, BADUNG, BALI",11,161,25,186
https://kawalpemilu.org#53487,"CARANGSARI, PETANG, BADUNG, BALI",12,254,15,269
https://kawalpemilu.org#53487,"CARANGSARI, PETANG, BADUNG, BALI",13,216,11,227
https://kawalpemilu.org#53487,"CARANGSARI, PETANG, BADUNG, BALI",14,240,19,259
https://kawalpemilu.org#53487,"CARANGSARI, PETANG, BADUNG, BALI",15,227,26,253
https://kawalpemilu.org#53487,"CARANGSARI, PETANG, BADUNG, BALI",16,233,11,244
https://kawalpemilu.org#53488,"PETANG, PETANG, BADUNG, BALI",1,259,19,278
https://kawalpemilu.org#53488,"PETANG, PETANG, BADUNG, BALI",2,274,11,285
https://kawalpemilu.org#53488,"PETANG, PETANG, BADUNG, BALI",3,238,27,265
https://kawalpemilu.org#53488,"PETANG, PETANG, BADUNG, BALI",4,243,19,262
https://kawalpemilu.org#53488,"PETANG, PETANG, BADUNG, BALI",5,254,16,270
https://kawalpemilu.org#53488,"PETANG, PETANG, BADUNG, BALI",6,236,15,251
https://kawalpemilu.org#53488,"PETANG, PETANG, BADUNG, BALI",7,247,16,263
https://kawalpemilu.org#53488,"PETANG, PETANG, BADUNG, BALI",8,127,20,147
https://kawalpemilu.org#53488,"PETANG, PETANG, BADUNG, BALI",9,182,2,184
https://kawalpemilu.org#53488,"PETANG, PETANG, BADUNG, BALI",10,263,9,272
https://kawalpemilu.org#53488,"PETANG, PETANG, BADUNG, BALI",11,175,87,262
https://kawalpemilu.org#53488,"PETANG, PETANG, BADUNG, BALI",12,147,105,252
https://kawalpemilu.org#53489,"BELOK SIDAN, PETANG, BADUNG, BALI",1,193,2,195
https://kawalpemilu.org#53489,"BELOK SIDAN, PETANG, BADUNG, BALI",2,195,1,196
https://kawalpemilu.org#53489,"BELOK SIDAN, PETANG, BADUNG, BALI",3,199,9,208
https://kawalpemilu.org#53489,"BELOK SIDAN, PETANG, BADUNG, BALI",4,170,18,188
https://kawalpemilu.org#53489,"BELOK SIDAN, PETANG, BADUNG, BALI",5,258,14,272
https://kawalpemilu.org#53489,"BELOK SIDAN, PETANG, BADUNG, BALI",6,243,6,249
https://kawalpemilu.org#53489,"BELOK SIDAN, PETANG, BADUNG, BALI",7,152,2,154
https://kawalpemilu.org#53489,"BELOK SIDAN, PETANG, BADUNG, BALI",8,165,0,165
https://kawalpemilu.org#53489,"BELOK SIDAN, PETANG, BADUNG, BALI",9,176,8,184
https://kawalpemilu.org#53489,"BELOK SIDAN, PETANG, BADUNG, BALI",10,172,11,183
https://kawalpemilu.org#53489,"BELOK SIDAN, PETANG, BADUNG, BALI",11,221,3,224
https://kawalpemilu.org#53489,"BELOK SIDAN, PETANG, BADUNG, BALI",12,210,2,212
https://kawalpemilu.org#53489,"BELOK SIDAN, PETANG, BADUNG, BALI",13,244,13,257
https://kawalpemilu.org#53489,"BELOK SIDAN, PETANG, BADUNG, BALI",14,259,3,262
https://kawalpemilu.org#53489,"BELOK SIDAN, PETANG, BADUNG, BALI",15,207,7,214
https://kawalpemilu.org#53489,"BELOK SIDAN, PETANG, BADUNG, BALI",16,217,8,225
https://kawalpemilu.org#53489,"BELOK SIDAN, PETANG, BADUNG, BALI",17,241,6,247
https://kawalpemilu.org#53489,"BELOK SIDAN, PETANG, BADUNG, BALI",18,226,12,238
https://kawalpemilu.org#53490,"PELAGA, PETANG, BADUNG, BALI",1,209,0,209
https://kawalpemilu.org#53490,"PELAGA, PETANG, BADUNG, BALI",2,202,2,204
https://kawalpemilu.org#53490,"PELAGA, PETANG, BADUNG, BALI",3,205,1,206
https://kawalpemilu.org#53490,"PELAGA, PETANG, BADUNG, BALI",5,172,19,191
https://kawalpemilu.org#53490,"PELAGA, PETANG, BADUNG, BALI",6,185,16,201
https://kawalpemilu.org#53490,"PELAGA, PETANG, BADUNG, BALI",7,191,18,209
https://kawalpemilu.org#53490,"PELAGA, PETANG, BADUNG, BALI",8,201,12,213
https://kawalpemilu.org#53490,"PELAGA, PETANG, BADUNG, BALI",9,184,12,196
https://kawalpemilu.org#53490,"PELAGA, PETANG, BADUNG, BALI",10,182,15,197
https://kawalpemilu.org#53490,"PELAGA, PETANG, BADUNG, BALI",11,168,21,189
https://kawalpemilu.org#53490,"PELAGA, PETANG, BADUNG, BALI",12,194,22,216
https://kawalpemilu.org#53490,"PELAGA, PETANG, BADUNG, BALI",13,225,12,237
https://kawalpemilu.org#53490,"PELAGA, PETANG, BADUNG, BALI",14,227,10,237
https://kawalpemilu.org#53490,"PELAGA, PETANG, BADUNG, BALI",15,229,4,233
https://kawalpemilu.org#53490,"PELAGA, PETANG, BADUNG, BALI",16,226,13,239
https://kawalpemilu.org#53490,"PELAGA, PETANG, BADUNG, BALI",17,263,18,281
https://kawalpemilu.org#53490,"PELAGA, PETANG, BADUNG, BALI",18,241,9,250
https://kawalpemilu.org#53490,"PELAGA, PETANG, BADUNG, BALI",19,244,16,260
https://kawalpemilu.org#53490,"PELAGA, PETANG, BADUNG, BALI",20,255,8,263
https://kawalpemilu.org#53490,"PELAGA, PETANG, BADUNG, BALI",21,163,8,171
https://kawalpemilu.org#53490,"PELAGA, PETANG, BADUNG, BALI",22,143,12,155
https://kawalpemilu.org#53491,"GETASAN, PETANG, BADUNG, BALI",1,234,10,244
https://kawalpemilu.org#53491,"GETASAN, PETANG, BADUNG, BALI",2,268,3,271
https://kawalpemilu.org#53491,"GETASAN, PETANG, BADUNG, BALI",3,214,16,230
https://kawalpemilu.org#53491,"GETASAN, PETANG, BADUNG, BALI",4,227,13,240
https://kawalpemilu.org#53491,"GETASAN, PETANG, BADUNG, BALI",5,252,2,254
https://kawalpemilu.org#53491,"GETASAN, PETANG, BADUNG, BALI",6,205,11,216
https://kawalpemilu.org#53492,"PANGSAN, PETANG, BADUNG, BALI",1,239,7,246
https://kawalpemilu.org#53492,"PANGSAN, PETANG, BADUNG, BALI",2,250,12,262
https://kawalpemilu.org#53492,"PANGSAN, PETANG, BADUNG, BALI",3,204,17,221
https://kawalpemilu.org#53492,"PANGSAN, PETANG, BADUNG, BALI",4,223,18,241
https://kawalpemilu.org#53492,"PANGSAN, PETANG, BADUNG, BALI",5,231,11,242
https://kawalpemilu.org#53492,"PANGSAN, PETANG, BADUNG, BALI",6,249,6,255
https://kawalpemilu.org#53492,"PANGSAN, PETANG, BADUNG, BALI",7,208,7,215
https://kawalpemilu.org#53492,"PANGSAN, PETANG, BADUNG, BALI",8,211,4,215
https://kawalpemilu.org#53493,"SULANGAI, PETANG, BADUNG, BALI",1,269,3,272
https://kawalpemilu.org#53493,"SULANGAI, PETANG, BADUNG, BALI",3,273,4,277
https://kawalpemilu.org#53493,"SULANGAI, PETANG, BADUNG, BALI",4,259,4,263
https://kawalpemilu.org#53493,"SULANGAI, PETANG, BADUNG, BALI",5,266,4,270
https://kawalpemilu.org#53493,"SULANGAI, PETANG, BADUNG, BALI",6,264,2,266
https://kawalpemilu.org#53493,"SULANGAI, PETANG, BADUNG, BALI",7,245,9,254
https://kawalpemilu.org#53493,"SULANGAI, PETANG, BADUNG, BALI",8,252,8,260
https://kawalpemilu.org#53493,"SULANGAI, PETANG, BADUNG, BALI",9,254,8,262
https://kawalpemilu.org#53493,"SULANGAI, PETANG, BADUNG, BALI",10,247,13,260
https://kawalpemilu.org#53493,"SULANGAI, PETANG, BADUNG, BALI",11,155,2,157
https://kawalpemilu.org#53493,"SULANGAI, PETANG, BADUNG, BALI",12,231,14,245
https://kawalpemilu.org#53493,"SULANGAI, PETANG, BADUNG, BALI",13,170,7,177
https://kawalpemilu.org#53495,"BENOA, KUTA SELATAN, BADUNG, BALI",1,238,15,253
https://kawalpemilu.org#53495,"BENOA, KUTA SELATAN, BADUNG, BALI",2,236,5,241
https://kawalpemilu.org#53495,"BENOA, KUTA SELATAN, BADUNG, BALI",3,231,8,239
https://kawalpemilu.org#53495,"BENOA, KUTA SELATAN, BADUNG, BALI",4,184,10,194
https://kawalpemilu.org#53495,"BENOA, KUTA SELATAN, BADUNG, BALI",5,181,34,215
https://kawalpemilu.org#53495,"BENOA, KUTA SELATAN, BADUNG, BALI",6,223,13,236
https://kawalpemilu.org#53495,"BENOA, KUTA SELATAN, BADUNG, BALI",7,219,16,235
https://kawalpemilu.org#53495,"BENOA, KUTA SELATAN, BADUNG, BALI",8,162,19,181
https://kawalpemilu.org#53495,"BENOA, KUTA SELATAN, BADUNG, BALI",9,193,19,212
https://kawalpemilu.org#53495,"BENOA, KUTA SELATAN, BADUNG, BALI",10,257,5,262
https://kawalpemilu.org#53495,"BENOA, KUTA SELATAN, BADUNG, BALI",11,266,2,268
https://kawalpemilu.org#53495,"BENOA, KUTA SELATAN, BADUNG, BALI",12,250,3,253
https://kawalpemilu.org#53495,"BENOA, KUTA SELATAN, BADUNG, BALI",13,270,9,279
https://kawalpemilu.org#53495,"BENOA, KUTA SELATAN, BADUNG, BALI",14,249,16,265
https://kawalpemilu.org#53495,"BENOA, KUTA SELATAN, BADUNG, BALI",15,258,6,264
https://kawalpemilu.org#53495,"BENOA, KUTA SELATAN, BADUNG, BALI",16,233,20,253
https://kawalpemilu.org#53495,"BENOA, KUTA SELATAN, BADUNG, BALI",17,216,25,241
https://kawalpemilu.org#53495,"BENOA, KUTA SELATAN, BADUNG, BALI",18,233,19,252
https://kawalpemilu.org#53495,"BENOA, KUTA SELATAN, BADUNG, BALI",19,250,16,266
https://kawalpemilu.org#53495,"BENOA, KUTA SELATAN, BADUNG, BALI",20,239,16,255
https://kawalpemilu.org#53495,"BENOA, KUTA SELATAN, BADUNG, BALI",21,250,12,262
https://kawalpemilu.org#53495,"BENOA, KUTA SELATAN, BADUNG, BALI",22,249,14,263
https://kawalpemilu.org#53495,"BENOA, KUTA SELATAN, BADUNG, BALI",23,265,4,269
https://kawalpemilu.org#53495,"BENOA, KUTA SELATAN, BADUNG, BALI",24,263,9,272
https://kawalpemilu.org#53495,"BENOA, KUTA SELATAN, BADUNG, BALI",25,227,7,234
https://kawalpemilu.org#53495,"BENOA, KUTA SELATAN, BADUNG, BALI",26,219,6,225
https://kawalpemilu.org#53495,"BENOA, KUTA SELATAN, BADUNG, BALI",27,228,3,231
https://kawalpemilu.org#53495,"BENOA, KUTA SELATAN, BADUNG, BALI",28,230,4,234
https://kawalpemilu.org#53495,"BENOA, KUTA SELATAN, BADUNG, BALI",29,219,3,222
https://kawalpemilu.org#53495,"BENOA, KUTA SELATAN, BADUNG, BALI",30,238,8,246
https://kawalpemilu.org#53495,"BENOA, KUTA SELATAN, BADUNG, BALI",31,236,28,264
https://kawalpemilu.org#53495,"BENOA, KUTA SELATAN, BADUNG, BALI",32,245,19,264
https://kawalpemilu.org#53495,"BENOA, KUTA SELATAN, BADUNG, BALI",33,234,21,255
https://kawalpemilu.org#53495,"BENOA, KUTA SELATAN, BADUNG, BALI",34,237,22,259
https://kawalpemilu.org#53495,"BENOA, KUTA SELATAN, BADUNG, BALI",35,191,25,216
https://kawalpemilu.org#53495,"BENOA, KUTA SELATAN, BADUNG, BALI",36,207,8,215
https://kawalpemilu.org#53495,"BENOA, KUTA SELATAN, BADUNG, BALI",37,195,20,215
https://kawalpemilu.org#53495,"BENOA, KUTA SELATAN, BADUNG, BALI",38,219,9,228
https://kawalpemilu.org#53495,"BENOA, KUTA SELATAN, BADUNG, BALI",39,151,12,163
https://kawalpemilu.org#53495,"BENOA, KUTA SELATAN, BADUNG, BALI",40,181,24,205
https://kawalpemilu.org#53495,"BENOA, KUTA SELATAN, BADUNG, BALI",41,204,24,228
https://kawalpemilu.org#53495,"BENOA, KUTA SELATAN, BADUNG, BALI",42,180,27,207
https://kawalpemilu.org#53495,"BENOA, KUTA SELATAN, BADUNG, BALI",43,226,16,242
https://kawalpemilu.org#53495,"BENOA, KUTA SELATAN, BADUNG, BALI",44,194,27,221
https://kawalpemilu.org#53495,"BENOA, KUTA SELATAN, BADUNG, BALI",45,212,17,229
https://kawalpemilu.org#53495,"BENOA, KUTA SELATAN, BADUNG, BALI",46,190,14,204
https://kawalpemilu.org#53495,"BENOA, KUTA SELATAN, BADUNG, BALI",47,180,20,200
https://kawalpemilu.org#53495,"BENOA, KUTA SELATAN, BADUNG, BALI",48,208,19,227
https://kawalpemilu.org#53495,"BENOA, KUTA SELATAN, BADUNG, BALI",49,237,12,249
https://kawalpemilu.org#53495,"BENOA, KUTA SELATAN, BADUNG, BALI",50,239,13,252
https://kawalpemilu.org#53495,"BENOA, KUTA SELATAN, BADUNG, BALI",51,225,13,238
https://kawalpemilu.org#53495,"BENOA, KUTA SELATAN, BADUNG, BALI",52,221,15,236
https://kawalpemilu.org#53495,"BENOA, KUTA SELATAN, BADUNG, BALI",53,185,11,196
https://kawalpemilu.org#53495,"BENOA, KUTA SELATAN, BADUNG, BALI",54,180,5,185
https://kawalpemilu.org#53495,"BENOA, KUTA SELATAN, BADUNG, BALI",55,202,34,236
https://kawalpemilu.org#53495,"BENOA, KUTA SELATAN, BADUNG, BALI",56,231,12,243
https://kawalpemilu.org#53495,"BENOA, KUTA SELATAN, BADUNG, BALI",57,254,15,269
https://kawalpemilu.org#53495,"BENOA, KUTA SELATAN, BADUNG, BALI",58,241,34,275
https://kawalpemilu.org#53495,"BENOA, KUTA SELATAN, BADUNG, BALI",59,268,26,294
https://kawalpemilu.org#53495,"BENOA, KUTA SELATAN, BADUNG, BALI",60,218,23,241
https://kawalpemilu.org#53495,"BENOA, KUTA SELATAN, BADUNG, BALI",61,224,14,238
https://kawalpemilu.org#53495,"BENOA, KUTA SELATAN, BADUNG, BALI",62,229,14,243
https://kawalpemilu.org#53495,"BENOA, KUTA SELATAN, BADUNG, BALI",63,217,15,232
https://kawalpemilu.org#53495,"BENOA, KUTA SELATAN, BADUNG, BALI",64,216,19,235
https://kawalpemilu.org#53495,"BENOA, KUTA SELATAN, BADUNG, BALI",65,261,12,273
https://kawalpemilu.org#53495,"BENOA, KUTA SELATAN, BADUNG, BALI",66,201,19,220
https://kawalpemilu.org#53495,"BENOA, KUTA SELATAN, BADUNG, BALI",67,185,25,210
https://kawalpemilu.org#53495,"BENOA, KUTA SELATAN, BADUNG, BALI",68,212,15,227
https://kawalpemilu.org#53495,"BENOA, KUTA SELATAN, BADUNG, BALI",69,209,30,239
https://kawalpemilu.org#53495,"BENOA, KUTA SELATAN, BADUNG, BALI",70,227,20,247
https://kawalpemilu.org#53495,"BENOA, KUTA SELATAN, BADUNG, BALI",71,240,30,270
https://kawalpemilu.org#53495,"BENOA, KUTA SELATAN, BADUNG, BALI",72,224,38,262
https://kawalpemilu.org#53495,"BENOA, KUTA SELATAN, BADUNG, BALI",73,211,35,246
https://kawalpemilu.org#53495,"BENOA, KUTA SELATAN, BADUNG, BALI",74,181,29,210
https://kawalpemilu.org#53495,"BENOA, KUTA SELATAN, BADUNG, BALI",75,205,17,222
https://kawalpemilu.org#53495,"BENOA, KUTA SELATAN, BADUNG, BALI",76,184,11,195
https://kawalpemilu.org#53495,"BENOA, KUTA SELATAN, BADUNG, BALI",77,255,32,287
https://kawalpemilu.org#53495,"BENOA, KUTA SELATAN, BADUNG, BALI",78,173,8,181
https://kawalpemilu.org#53495,"BENOA, KUTA SELATAN, BADUNG, BALI",79,145,12,157
https://kawalpemilu.org#53495,"BENOA, KUTA SELATAN, BADUNG, BALI",80,191,13,204
https://kawalpemilu.org#53495,"BENOA, KUTA SELATAN, BADUNG, BALI",81,230,22,252
https://kawalpemilu.org#53495,"BENOA, KUTA SELATAN, BADUNG, BALI",82,249,12,261
https://kawalpemilu.org#53495,"BENOA, KUTA SELATAN, BADUNG, BALI",83,184,12,196
https://kawalpemilu.org#53495,"BENOA, KUTA SELATAN, BADUNG, BALI",84,184,11,195
https://kawalpemilu.org#53495,"BENOA, KUTA SELATAN, BADUNG, BALI",85,176,8,184
https://kawalpemilu.org#53495,"BENOA, KUTA SELATAN, BADUNG, BALI",86,124,15,139
https://kawalpemilu.org#53495,"BENOA, KUTA SELATAN, BADUNG, BALI",87,132,14,146
https://kawalpemilu.org#53495,"BENOA, KUTA SELATAN, BADUNG, BALI",89,181,27,208
https://kawalpemilu.org#53495,"BENOA, KUTA SELATAN, BADUNG, BALI",90,152,22,174
https://kawalpemilu.org#53495,"BENOA, KUTA SELATAN, BADUNG, BALI",91,171,9,180
https://kawalpemilu.org#53495,"BENOA, KUTA SELATAN, BADUNG, BALI",92,168,11,179
https://kawalpemilu.org#53495,"BENOA, KUTA SELATAN, BADUNG, BALI",93,184,16,200
https://kawalpemilu.org#53495,"BENOA, KUTA SELATAN, BADUNG, BALI",94,138,15,153
https://kawalpemilu.org#53495,"BENOA, KUTA SELATAN, BADUNG, BALI",95,120,14,134
https://kawalpemilu.org#53496,"TANJUNG BENOA, KUTA SELATAN, BADUNG, BALI",1,184,14,198
https://kawalpemilu.org#53496,"TANJUNG BENOA, KUTA SELATAN, BADUNG, BALI",2,194,14,208
https://kawalpemilu.org#53496,"TANJUNG BENOA, KUTA SELATAN, BADUNG, BALI",3,221,31,252
https://kawalpemilu.org#53496,"TANJUNG BENOA, KUTA SELATAN, BADUNG, BALI",4,204,32,236
https://kawalpemilu.org#53496,"TANJUNG BENOA, KUTA SELATAN, BADUNG, BALI",5,221,21,242
https://kawalpemilu.org#53496,"TANJUNG BENOA, KUTA SELATAN, BADUNG, BALI",6,226,40,266
https://kawalpemilu.org#53496,"TANJUNG BENOA, KUTA SELATAN, BADUNG, BALI",7,225,37,262
https://kawalpemilu.org#53496,"TANJUNG BENOA, KUTA SELATAN, BADUNG, BALI",8,197,23,220
https://kawalpemilu.org#53496,"TANJUNG BENOA, KUTA SELATAN, BADUNG, BALI",9,89,147,236
https://kawalpemilu.org#53496,"TANJUNG BENOA, KUTA SELATAN, BADUNG, BALI",10,95,134,229
https://kawalpemilu.org#53496,"TANJUNG BENOA, KUTA SELATAN, BADUNG, BALI",11,191,37,228
https://kawalpemilu.org#53496,"TANJUNG BENOA, KUTA SELATAN, BADUNG, BALI",12,169,45,214
https://kawalpemilu.org#53496,"TANJUNG BENOA, KUTA SELATAN, BADUNG, BALI",13,195,28,223
https://kawalpemilu.org#53496,"TANJUNG BENOA, KUTA SELATAN, BADUNG, BALI",14,208,25,233
https://kawalpemilu.org#53496,"TANJUNG BENOA, KUTA SELATAN, BADUNG, BALI",15,203,27,230
https://kawalpemilu.org#53496,"TANJUNG BENOA, KUTA SELATAN, BADUNG, BALI",16,222,17,239
https://kawalpemilu.org#53497,"JIMBARAN, KUTA SELATAN, BADUNG, BALI",1,241,14,255
https://kawalpemilu.org#53497,"JIMBARAN, KUTA SELATAN, BADUNG, BALI",2,255,7,262
https://kawalpemilu.org#53497,"JIMBARAN, KUTA SELATAN, BADUNG, BALI",3,215,18,233
https://kawalpemilu.org#53497,"JIMBARAN, KUTA SELATAN, BADUNG, BALI",4,179,14,193
https://kawalpemilu.org#53497,"JIMBARAN, KUTA SELATAN, BADUNG, BALI",5,203,16,219
https://kawalpemilu.org#53497,"JIMBARAN, KUTA SELATAN, BADUNG, BALI",6,141,24,165
https://kawalpemilu.org#53497,"JIMBARAN, KUTA SELATAN, BADUNG, BALI",7,197,8,205
https://kawalpemilu.org#53497,"JIMBARAN, KUTA SELATAN, BADUNG, BALI",8,199,19,218
https://kawalpemilu.org#53497,"JIMBARAN, KUTA SELATAN, BADUNG, BALI",9,226,14,240
https://kawalpemilu.org#53497,"JIMBARAN, KUTA SELATAN, BADUNG, BALI",10,208,8,216
https://kawalpemilu.org#53497,"JIMBARAN, KUTA SELATAN, BADUNG, BALI",11,183,9,192
https://kawalpemilu.org#53497,"JIMBARAN, KUTA SELATAN, BADUNG, BALI",12,164,17,181
https://kawalpemilu.org#53497,"JIMBARAN, KUTA SELATAN, BADUNG, BALI",13,189,7,196
https://kawalpemilu.org#53497,"JIMBARAN, KUTA SELATAN, BADUNG, BALI",14,173,9,182
https://kawalpemilu.org#53497,"JIMBARAN, KUTA SELATAN, BADUNG, BALI",15,197,17,214
https://kawalpemilu.org#53497,"JIMBARAN, KUTA SELATAN, BADUNG, BALI",16,159,9,168
https://kawalpemilu.org#53497,"JIMBARAN, KUTA SELATAN, BADUNG, BALI",17,135,16,151
https://kawalpemilu.org#53497,"JIMBARAN, KUTA SELATAN, BADUNG, BALI",18,133,36,169
https://kawalpemilu.org#53497,"JIMBARAN, KUTA SELATAN, BADUNG, BALI",19,172,21,193
https://kawalpemilu.org#53497,"JIMBARAN, KUTA SELATAN, BADUNG, BALI",20,131,35,166
https://kawalpemilu.org#53497,"JIMBARAN, KUTA SELATAN, BADUNG, BALI",21,151,36,187
https://kawalpemilu.org#53497,"JIMBARAN, KUTA SELATAN, BADUNG, BALI",22,155,36,191
https://kawalpemilu.org#53497,"JIMBARAN, KUTA SELATAN, BADUNG, BALI",23,158,28,186
https://kawalpemilu.org#53497,"JIMBARAN, KUTA SELATAN, BADUNG, BALI",24,181,7,188
https://kawalpemilu.org#53497,"JIMBARAN, KUTA SELATAN, BADUNG, BALI",25,171,19,190
https://kawalpemilu.org#53497,"JIMBARAN, KUTA SELATAN, BADUNG, BALI",26,166,23,189
https://kawalpemilu.org#53497,"JIMBARAN, KUTA SELATAN, BADUNG, BALI",27,175,26,201
https://kawalpemilu.org#53497,"JIMBARAN, KUTA SELATAN, BADUNG, BALI",28,159,9,168
https://kawalpemilu.org#53497,"JIMBARAN, KUTA SELATAN, BADUNG, BALI",29,184,15,199
https://kawalpemilu.org#53497,"JIMBARAN, KUTA SELATAN, BADUNG, BALI",30,161,34,195
https://kawalpemilu.org#53497,"JIMBARAN, KUTA SELATAN, BADUNG, BALI",31,167,23,190
https://kawalpemilu.org#53497,"JIMBARAN, KUTA SELATAN, BADUNG, BALI",32,182,20,202
https://kawalpemilu.org#53497,"JIMBARAN, KUTA SELATAN, BADUNG, BALI",33,157,17,174
https://kawalpemilu.org#53497,"JIMBARAN, KUTA SELATAN, BADUNG, BALI",34,159,22,181
https://kawalpemilu.org#53497,"JIMBARAN, KUTA SELATAN, BADUNG, BALI",35,162,18,180
https://kawalpemilu.org#53497,"JIMBARAN, KUTA SELATAN, BADUNG, BALI",36,142,30,172
https://kawalpemilu.org#53497,"JIMBARAN, KUTA SELATAN, BADUNG, BALI",37,149,13,162
https://kawalpemilu.org#53497,"JIMBARAN, KUTA SELATAN, BADUNG, BALI",38,162,32,194
https://kawalpemilu.org#53497,"JIMBARAN, KUTA SELATAN, BADUNG, BALI",39,122,27,149
https://kawalpemilu.org#53497,"JIMBARAN, KUTA SELATAN, BADUNG, BALI",40,136,23,159
https://kawalpemilu.org#53497,"JIMBARAN, KUTA SELATAN, BADUNG, BALI",41,172,20,192
https://kawalpemilu.org#53497,"JIMBARAN, KUTA SELATAN, BADUNG, BALI",42,171,10,181
https://kawalpemilu.org#53497,"JIMBARAN, KUTA SELATAN, BADUNG, BALI",43,127,25,152
https://kawalpemilu.org#53497,"JIMBARAN, KUTA SELATAN, BADUNG, BALI",44,147,13,160
https://kawalpemilu.org#53497,"JIMBARAN, KUTA SELATAN, BADUNG, BALI",45,155,22,177
https://kawalpemilu.org#53497,"JIMBARAN, KUTA SELATAN, BADUNG, BALI",46,137,27,164
https://kawalpemilu.org#53497,"JIMBARAN, KUTA SELATAN, BADUNG, BALI",47,155,28,183
https://kawalpemilu.org#53497,"JIMBARAN, KUTA SELATAN, BADUNG, BALI",48,153,14,167
https://kawalpemilu.org#53497,"JIMBARAN, KUTA SELATAN, BADUNG, BALI",49,135,22,157
https://kawalpemilu.org#53497,"JIMBARAN, KUTA SELATAN, BADUNG, BALI",50,204,17,221
https://kawalpemilu.org#53497,"JIMBARAN, KUTA SELATAN, BADUNG, BALI",51,182,17,199
https://kawalpemilu.org#53497,"JIMBARAN, KUTA SELATAN, BADUNG, BALI",52,196,9,205
https://kawalpemilu.org#53497,"JIMBARAN, KUTA SELATAN, BADUNG, BALI",53,187,21,208
https://kawalpemilu.org#53497,"JIMBARAN, KUTA SELATAN, BADUNG, BALI",54,179,16,195
https://kawalpemilu.org#53497,"JIMBARAN, KUTA SELATAN, BADUNG, BALI",55,191,14,205
https://kawalpemilu.org#53497,"JIMBARAN, KUTA SELATAN, BADUNG, BALI",56,161,11,172
https://kawalpemilu.org#53497,"JIMBARAN, KUTA SELATAN, BADUNG, BALI",57,191,16,207
https://kawalpemilu.org#53497,"JIMBARAN, KUTA SELATAN, BADUNG, BALI",58,169,22,191
https://kawalpemilu.org#53497,"JIMBARAN, KUTA SELATAN, BADUNG, BALI",59,190,10,200
https://kawalpemilu.org#53497,"JIMBARAN, KUTA SELATAN, BADUNG, BALI",60,179,10,189
https://kawalpemilu.org#53497,"JIMBARAN, KUTA SELATAN, BADUNG, BALI",61,183,10,193
https://kawalpemilu.org#53497,"JIMBARAN, KUTA SELATAN, BADUNG, BALI",62,181,27,208
https://kawalpemilu.org#53497,"JIMBARAN, KUTA SELATAN, BADUNG, BALI",63,197,25,222
https://kawalpemilu.org#53497,"JIMBARAN, KUTA SELATAN, BADUNG, BALI",64,197,16,213
https://kawalpemilu.org#53497,"JIMBARAN, KUTA SELATAN, BADUNG, BALI",65,152,21,173
https://kawalpemilu.org#53497,"JIMBARAN, KUTA SELATAN, BADUNG, BALI",66,150,13,163
https://kawalpemilu.org#53497,"JIMBARAN, KUTA SELATAN, BADUNG, BALI",67,186,9,195
https://kawalpemilu.org#53497,"JIMBARAN, KUTA SELATAN, BADUNG, BALI",68,172,16,188
https://kawalpemilu.org#53497,"JIMBARAN, KUTA SELATAN, BADUNG, BALI",69,160,13,173
https://kawalpemilu.org#53497,"JIMBARAN, KUTA SELATAN, BADUNG, BALI",70,153,21,174
https://kawalpemilu.org#53497,"JIMBARAN, KUTA SELATAN, BADUNG, BALI",71,223,15,238
https://kawalpemilu.org#53497,"JIMBARAN, KUTA SELATAN, BADUNG, BALI",72,203,31,234
https://kawalpemilu.org#53497,"JIMBARAN, KUTA SELATAN, BADUNG, BALI",73,173,22,195
https://kawalpemilu.org#53497,"JIMBARAN, KUTA SELATAN, BADUNG, BALI",74,186,23,209
https://kawalpemilu.org#53497,"JIMBARAN, KUTA SELATAN, BADUNG, BALI",75,150,29,179
https://kawalpemilu.org#53497,"JIMBARAN, KUTA SELATAN, BADUNG, BALI",76,177,19,196
https://kawalpemilu.org#53497,"JIMBARAN, KUTA SELATAN, BADUNG, BALI",77,181,26,207
https://kawalpemilu.org#53497,"JIMBARAN, KUTA SELATAN, BADUNG, BALI",78,134,25,159
https://kawalpemilu.org#53497,"JIMBARAN, KUTA SELATAN, BADUNG, BALI",79,211,14,225
https://kawalpemilu.org#53497,"JIMBARAN, KUTA SELATAN, BADUNG, BALI",80,188,22,210
https://kawalpemilu.org#53497,"JIMBARAN, KUTA SELATAN, BADUNG, BALI",81,176,17,193
https://kawalpemilu.org#53497,"JIMBARAN, KUTA SELATAN, BADUNG, BALI",82,148,128,276
https://kawalpemilu.org#53497,"JIMBARAN, KUTA SELATAN, BADUNG, BALI",83,161,24,185
https://kawalpemilu.org#53497,"JIMBARAN, KUTA SELATAN, BADUNG, BALI",84,178,28,206
https://kawalpemilu.org#53497,"JIMBARAN, KUTA SELATAN, BADUNG, BALI",85,178,27,205
https://kawalpemilu.org#53497,"JIMBARAN, KUTA SELATAN, BADUNG, BALI",86,179,23,202
https://kawalpemilu.org#53497,"JIMBARAN, KUTA SELATAN, BADUNG, BALI",87,146,23,169
https://kawalpemilu.org#53497,"JIMBARAN, KUTA SELATAN, BADUNG, BALI",88,183,12,195
https://kawalpemilu.org#53497,"JIMBARAN, KUTA SELATAN, BADUNG, BALI",89,157,25,182
https://kawalpemilu.org#53497,"JIMBARAN, KUTA SELATAN, BADUNG, BALI",90,162,20,182
https://kawalpemilu.org#53497,"JIMBARAN, KUTA SELATAN, BADUNG, BALI",91,161,19,180
https://kawalpemilu.org#53497,"JIMBARAN, KUTA SELATAN, BADUNG, BALI",92,151,18,169
https://kawalpemilu.org#53497,"JIMBARAN, KUTA SELATAN, BADUNG, BALI",93,219,28,247
https://kawalpemilu.org#53497,"JIMBARAN, KUTA SELATAN, BADUNG, BALI",94,195,28,223
https://kawalpemilu.org#53497,"JIMBARAN, KUTA SELATAN, BADUNG, BALI",95,185,19,204
https://kawalpemilu.org#53497,"JIMBARAN, KUTA SELATAN, BADUNG, BALI",96,172,22,194
https://kawalpemilu.org#53497,"JIMBARAN, KUTA SELATAN, BADUNG, BALI",97,190,36,226
https://kawalpemilu.org#53497,"JIMBARAN, KUTA SELATAN, BADUNG, BALI",98,208,27,235
https://kawalpemilu.org#53497,"JIMBARAN, KUTA SELATAN, BADUNG, BALI",99,183,23,206
https://kawalpemilu.org#53497,"JIMBARAN, KUTA SELATAN, BADUNG, BALI",100,182,35,217
https://kawalpemilu.org#53497,"JIMBARAN, KUTA SELATAN, BADUNG, BALI",101,195,16,211
https://kawalpemilu.org#53497,"JIMBARAN, KUTA SELATAN, BADUNG, BALI",102,161,32,193
https://kawalpemilu.org#53497,"JIMBARAN, KUTA SELATAN, BADUNG, BALI",103,200,14,214
https://kawalpemilu.org#53497,"JIMBARAN, KUTA SELATAN, BADUNG, BALI",104,165,31,196
https://kawalpemilu.org#53497,"JIMBARAN, KUTA SELATAN, BADUNG, BALI",105,178,27,205
https://kawalpemilu.org#53497,"JIMBARAN, KUTA SELATAN, BADUNG, BALI",106,188,33,221
https://kawalpemilu.org#53497,"JIMBARAN, KUTA SELATAN, BADUNG, BALI",107,163,33,196
https://kawalpemilu.org#53497,"JIMBARAN, KUTA SELATAN, BADUNG, BALI",108,182,28,210
https://kawalpemilu.org#53497,"JIMBARAN, KUTA SELATAN, BADUNG, BALI",109,207,21,228
https://kawalpemilu.org#53497,"JIMBARAN, KUTA SELATAN, BADUNG, BALI",110,173,22,195
https://kawalpemilu.org#53497,"JIMBARAN, KUTA SELATAN, BADUNG, BALI",111,228,19,247
https://kawalpemilu.org#53497,"JIMBARAN, KUTA SELATAN, BADUNG, BALI",112,177,22,199
https://kawalpemilu.org#53497,"JIMBARAN, KUTA SELATAN, BADUNG, BALI",113,175,28,203
https://kawalpemilu.org#53497,"JIMBARAN, KUTA SELATAN, BADUNG, BALI",114,184,24,208
https://kawalpemilu.org#53497,"JIMBARAN, KUTA SELATAN, BADUNG, BALI",115,158,19,177
https://kawalpemilu.org#53497,"JIMBARAN, KUTA SELATAN, BADUNG, BALI",116,172,12,184
https://kawalpemilu.org#53497,"JIMBARAN, KUTA SELATAN, BADUNG, BALI",117,158,20,178
https://kawalpemilu.org#53497,"JIMBARAN, KUTA SELATAN, BADUNG, BALI",118,165,45,210
https://kawalpemilu.org#53497,"JIMBARAN, KUTA SELATAN, BADUNG, BALI",119,168,31,199
https://kawalpemilu.org#53497,"JIMBARAN, KUTA SELATAN, BADUNG, BALI",120,202,31,233
https://kawalpemilu.org#53497,"JIMBARAN, KUTA SELATAN, BADUNG, BALI",121,178,38,216
https://kawalpemilu.org#53497,"JIMBARAN, KUTA SELATAN, BADUNG, BALI",122,173,35,208
https://kawalpemilu.org#53497,"JIMBARAN, KUTA SELATAN, BADUNG, BALI",123,216,31,247
https://kawalpemilu.org#53497,"JIMBARAN, KUTA SELATAN, BADUNG, BALI",124,193,31,224
https://kawalpemilu.org#53497,"JIMBARAN, KUTA SELATAN, BADUNG, BALI",125,191,18,209
https://kawalpemilu.org#53498,"PECATU, KUTA SELATAN, BADUNG, BALI",1,248,23,271
https://kawalpemilu.org#53498,"PECATU, KUTA SELATAN, BADUNG, BALI",2,220,41,261
https://kawalpemilu.org#53498,"PECATU, KUTA SELATAN, BADUNG, BALI",3,187,16,203
https://kawalpemilu.org#53498,"PECATU, KUTA SELATAN, BADUNG, BALI",4,227,29,256
https://kawalpemilu.org#53498,"PECATU, KUTA SELATAN, BADUNG, BALI",5,169,18,187
https://kawalpemilu.org#53498,"PECATU, KUTA SELATAN, BADUNG, BALI",6,231,34,265
https://kawalpemilu.org#53498,"PECATU, KUTA SELATAN, BADUNG, BALI",7,227,43,270
https://kawalpemilu.org#53498,"PECATU, KUTA SELATAN, BADUNG, BALI",8,225,34,259
https://kawalpemilu.org#53498,"PECATU, KUTA SELATAN, BADUNG, BALI",9,241,14,255
https://kawalpemilu.org#53498,"PECATU, KUTA SELATAN, BADUNG, BALI",10,172,32,204
https://kawalpemilu.org#53498,"PECATU, KUTA SELATAN, BADUNG, BALI",11,241,34,275
https://kawalpemilu.org#53498,"PECATU, KUTA SELATAN, BADUNG, BALI",12,238,26,264
https://kawalpemilu.org#53498,"PECATU, KUTA SELATAN, BADUNG, BALI",13,171,17,188
https://kawalpemilu.org#53498,"PECATU, KUTA SELATAN, BADUNG, BALI",14,218,29,247
https://kawalpemilu.org#53498,"PECATU, KUTA SELATAN, BADUNG, BALI",15,231,15,246
https://kawalpemilu.org#53498,"PECATU, KUTA SELATAN, BADUNG, BALI",16,254,14,268
https://kawalpemilu.org#53498,"PECATU, KUTA SELATAN, BADUNG, BALI",17,247,19,266
https://kawalpemilu.org#53498,"PECATU, KUTA SELATAN, BADUNG, BALI",18,200,19,219
https://kawalpemilu.org#53498,"PECATU, KUTA SELATAN, BADUNG, BALI",19,253,34,287
https://kawalpemilu.org#53498,"PECATU, KUTA SELATAN, BADUNG, BALI",20,264,31,295
https://kawalpemilu.org#53498,"PECATU, KUTA SELATAN, BADUNG, BALI",21,139,10,149
https://kawalpemilu.org#53498,"PECATU, KUTA SELATAN, BADUNG, BALI",22,251,28,279
https://kawalpemilu.org#53498,"PECATU, KUTA SELATAN, BADUNG, BALI",23,255,23,278
https://kawalpemilu.org#53499,"UNGASAN, KUTA SELATAN, BADUNG, BALI",1,193,28,221
https://kawalpemilu.org#53499,"UNGASAN, KUTA SELATAN, BADUNG, BALI",2,182,43,225
https://kawalpemilu.org#53499,"UNGASAN, KUTA SELATAN, BADUNG, BALI",3,197,18,215
https://kawalpemilu.org#53499,"UNGASAN, KUTA SELATAN, BADUNG, BALI",4,159,31,190
https://kawalpemilu.org#53499,"UNGASAN, KUTA SELATAN, BADUNG, BALI",5,166,15,181
https://kawalpemilu.org#53499,"UNGASAN, KUTA SELATAN, BADUNG, BALI",6,260,29,289
https://kawalpemilu.org#53499,"UNGASAN, KUTA SELATAN, BADUNG, BALI",7,229,34,263
https://kawalpemilu.org#53499,"UNGASAN, KUTA SELATAN, BADUNG, BALI",8,209,27,236
https://kawalpemilu.org#53499,"UNGASAN, KUTA SELATAN, BADUNG, BALI",9,240,38,278
https://kawalpemilu.org#53499,"UNGASAN, KUTA SELATAN, BADUNG, BALI",10,226,30,256
https://kawalpemilu.org#53499,"UNGASAN, KUTA SELATAN, BADUNG, BALI",11,164,45,209
https://kawalpemilu.org#53499,"UNGASAN, KUTA SELATAN, BADUNG, BALI",12,181,29,210
https://kawalpemilu.org#53499,"UNGASAN, KUTA SELATAN, BADUNG, BALI",13,134,44,178
https://kawalpemilu.org#53499,"UNGASAN, KUTA SELATAN, BADUNG, BALI",14,205,57,262
https://kawalpemilu.org#53499,"UNGASAN, KUTA SELATAN, BADUNG, BALI",15,201,44,245
https://kawalpemilu.org#53499,"UNGASAN, KUTA SELATAN, BADUNG, BALI",16,205,27,232
https://kawalpemilu.org#53499,"UNGASAN, KUTA SELATAN, BADUNG, BALI",17,205,35,240
https://kawalpemilu.org#53499,"UNGASAN, KUTA SELATAN, BADUNG, BALI",18,207,40,247
https://kawalpemilu.org#53499,"UNGASAN, KUTA SELATAN, BADUNG, BALI",19,191,22,213
https://kawalpemilu.org#53499,"UNGASAN, KUTA SELATAN, BADUNG, BALI",20,252,14,266
https://kawalpemilu.org#53499,"UNGASAN, KUTA SELATAN, BADUNG, BALI",21,228,24,252
https://kawalpemilu.org#53499,"UNGASAN, KUTA SELATAN, BADUNG, BALI",22,222,15,237
https://kawalpemilu.org#53499,"UNGASAN, KUTA SELATAN, BADUNG, BALI",23,212,10,222
https://kawalpemilu.org#53499,"UNGASAN, KUTA SELATAN, BADUNG, BALI",24,206,16,222
https://kawalpemilu.org#53499,"UNGASAN, KUTA SELATAN, BADUNG, BALI",25,182,33,215
https://kawalpemilu.org#53499,"UNGASAN, KUTA SELATAN, BADUNG, BALI",26,205,40,245
https://kawalpemilu.org#53499,"UNGASAN, KUTA SELATAN, BADUNG, BALI",27,210,29,239
https://kawalpemilu.org#53499,"UNGASAN, KUTA SELATAN, BADUNG, BALI",28,199,43,242
https://kawalpemilu.org#53499,"UNGASAN, KUTA SELATAN, BADUNG, BALI",29,195,55,250
https://kawalpemilu.org#53499,"UNGASAN, KUTA SELATAN, BADUNG, BALI",30,221,47,268
https://kawalpemilu.org#53499,"UNGASAN, KUTA SELATAN, BADUNG, BALI",31,205,56,261
https://kawalpemilu.org#53499,"UNGASAN, KUTA SELATAN, BADUNG, BALI",32,159,44,203
https://kawalpemilu.org#53499,"UNGASAN, KUTA SELATAN, BADUNG, BALI",33,165,43,208
https://kawalpemilu.org#53499,"UNGASAN, KUTA SELATAN, BADUNG, BALI",34,145,52,197
https://kawalpemilu.org#53499,"UNGASAN, KUTA SELATAN, BADUNG, BALI",35,185,25,210
https://kawalpemilu.org#53499,"UNGASAN, KUTA SELATAN, BADUNG, BALI",36,206,16,222
https://kawalpemilu.org#53499,"UNGASAN, KUTA SELATAN, BADUNG, BALI",37,221,7,228
https://kawalpemilu.org#53499,"UNGASAN, KUTA SELATAN, BADUNG, BALI",38,207,12,219
https://kawalpemilu.org#53499,"UNGASAN, KUTA SELATAN, BADUNG, BALI",39,167,33,200
https://kawalpemilu.org#53499,"UNGASAN, KUTA SELATAN, BADUNG, BALI",40,152,59,211
https://kawalpemilu.org#53499,"UNGASAN, KUTA SELATAN, BADUNG, BALI",41,155,49,204
https://kawalpemilu.org#53500,"KUTUH, KUTA SELATAN, BADUNG, BALI",1,249,19,268
https://kawalpemilu.org#53500,"KUTUH, KUTA SELATAN, BADUNG, BALI",2,245,15,260
https://kawalpemilu.org#53500,"KUTUH, KUTA SELATAN, BADUNG, BALI",3,180,20,200
https://kawalpemilu.org#53500,"KUTUH, KUTA SELATAN, BADUNG, BALI",4,219,17,236
https://kawalpemilu.org#53500,"KUTUH, KUTA SELATAN, BADUNG, BALI",5,215,15,230
https://kawalpemilu.org#53500,"KUTUH, KUTA SELATAN, BADUNG, BALI",7,273,20,293
https://kawalpemilu.org#53500,"KUTUH, KUTA SELATAN, BADUNG, BALI",8,243,16,259
https://kawalpemilu.org#53500,"KUTUH, KUTA SELATAN, BADUNG, BALI",9,230,13,243
https://kawalpemilu.org#53500,"KUTUH, KUTA SELATAN, BADUNG, BALI",10,258,19,277
https://kawalpemilu.org#53500,"KUTUH, KUTA SELATAN, BADUNG, BALI",11,233,33,266
https://kawalpemilu.org#53500,"KUTUH, KUTA SELATAN, BADUNG, BALI",12,170,14,184
https://kawalpemilu.org#53500,"KUTUH, KUTA SELATAN, BADUNG, BALI",13,149,7,156
https://kawalpemilu.org#53502,"KEROBOKAN KELOD, KUTA UTARA, BADUNG, BALI",1,244,9,253
https://kawalpemilu.org#53502,"KEROBOKAN KELOD, KUTA UTARA, BADUNG, BALI",2,259,4,263
https://kawalpemilu.org#53502,"KEROBOKAN KELOD, KUTA UTARA, BADUNG, BALI",3,171,6,177
https://kawalpemilu.org#53502,"KEROBOKAN KELOD, KUTA UTARA, BADUNG, BALI",4,259,5,264
https://kawalpemilu.org#53502,"KEROBOKAN KELOD, KUTA UTARA, BADUNG, BALI",5,229,16,245
https://kawalpemilu.org#53502,"KEROBOKAN KELOD, KUTA UTARA, BADUNG, BALI",6,234,13,247
https://kawalpemilu.org#53502,"KEROBOKAN KELOD, KUTA UTARA, BADUNG, BALI",7,212,6,218
https://kawalpemilu.org#53502,"KEROBOKAN KELOD, KUTA UTARA, BADUNG, BALI",8,256,13,269
https://kawalpemilu.org#53502,"KEROBOKAN KELOD, KUTA UTARA, BADUNG, BALI",9,247,7,254
https://kawalpemilu.org#53502,"KEROBOKAN KELOD, KUTA UTARA, BADUNG, BALI",10,238,17,255
https://kawalpemilu.org#53502,"KEROBOKAN KELOD, KUTA UTARA, BADUNG, BALI",11,263,7,270
https://kawalpemilu.org#53502,"KEROBOKAN KELOD, KUTA UTARA, BADUNG, BALI",12,225,15,240
https://kawalpemilu.org#53502,"KEROBOKAN KELOD, KUTA UTARA, BADUNG, BALI",13,0,0,0
https://kawalpemilu.org#53502,"KEROBOKAN KELOD, KUTA UTARA, BADUNG, BALI",14,260,3,263
https://kawalpemilu.org#53502,"KEROBOKAN KELOD, KUTA UTARA, BADUNG, BALI",15,213,10,223
https://kawalpemilu.org#53502,"KEROBOKAN KELOD, KUTA UTARA, BADUNG, BALI",16,239,13,252
https://kawalpemilu.org#53502,"KEROBOKAN KELOD, KUTA UTARA, BADUNG, BALI",17,249,3,252
https://kawalpemilu.org#53502,"KEROBOKAN KELOD, KUTA UTARA, BADUNG, BALI",18,241,12,253
https://kawalpemilu.org#53502,"KEROBOKAN KELOD, KUTA UTARA, BADUNG, BALI",19,165,9,174
https://kawalpemilu.org#53502,"KEROBOKAN KELOD, KUTA UTARA, BADUNG, BALI",20,251,3,254
https://kawalpemilu.org#53502,"KEROBOKAN KELOD, KUTA UTARA, BADUNG, BALI",21,223,15,238
https://kawalpemilu.org#53502,"KEROBOKAN KELOD, KUTA UTARA, BADUNG, BALI",22,247,7,254
https://kawalpemilu.org#53502,"KEROBOKAN KELOD, KUTA UTARA, BADUNG, BALI",23,227,14,241
https://kawalpemilu.org#53502,"KEROBOKAN KELOD, KUTA UTARA, BADUNG, BALI",24,230,10,240
https://kawalpemilu.org#53502,"KEROBOKAN KELOD, KUTA UTARA, BADUNG, BALI",25,184,19,203
https://kawalpemilu.org#53502,"KEROBOKAN KELOD, KUTA UTARA, BADUNG, BALI",26,214,15,229
https://kawalpemilu.org#53502,"KEROBOKAN KELOD, KUTA UTARA, BADUNG, BALI",27,229,8,237
https://kawalpemilu.org#53502,"KEROBOKAN KELOD, KUTA UTARA, BADUNG, BALI",28,191,8,199
https://kawalpemilu.org#53502,"KEROBOKAN KELOD, KUTA UTARA, BADUNG, BALI",29,241,19,260
https://kawalpemilu.org#53502,"KEROBOKAN KELOD, KUTA UTARA, BADUNG, BALI",30,196,25,221
https://kawalpemilu.org#53502,"KEROBOKAN KELOD, KUTA UTARA, BADUNG, BALI",31,201,36,237
https://kawalpemilu.org#53502,"KEROBOKAN KELOD, KUTA UTARA, BADUNG, BALI",32,134,46,180
https://kawalpemilu.org#53502,"KEROBOKAN KELOD, KUTA UTARA, BADUNG, BALI",33,87,38,125
https://kawalpemilu.org#53503,"KEROBOKAN, KUTA UTARA, BADUNG, BALI",1,243,11,254
https://kawalpemilu.org#53503,"KEROBOKAN, KUTA UTARA, BADUNG, BALI",2,194,30,224
https://kawalpemilu.org#53503,"KEROBOKAN, KUTA UTARA, BADUNG, BALI",3,197,13,210
https://kawalpemilu.org#53503,"KEROBOKAN, KUTA UTARA, BADUNG, BALI",4,194,23,217
https://kawalpemilu.org#53503,"KEROBOKAN, KUTA UTARA, BADUNG, BALI",5,222,18,240
https://kawalpemilu.org#53503,"KEROBOKAN, KUTA UTARA, BADUNG, BALI",7,257,24,281
https://kawalpemilu.org#53503,"KEROBOKAN, KUTA UTARA, BADUNG, BALI",8,273,12,285
https://kawalpemilu.org#53503,"KEROBOKAN, KUTA UTARA, BADUNG, BALI",9,258,14,272
https://kawalpemilu.org#53503,"KEROBOKAN, KUTA UTARA, BADUNG, BALI",10,264,15,279
https://kawalpemilu.org#53503,"KEROBOKAN, KUTA UTARA, BADUNG, BALI",11,258,4,262
https://kawalpemilu.org#53503,"KEROBOKAN, KUTA UTARA, BADUNG, BALI",12,256,4,260
https://kawalpemilu.org#53503,"KEROBOKAN, KUTA UTARA, BADUNG, BALI",13,264,9,273
https://kawalpemilu.org#53503,"KEROBOKAN, KUTA UTARA, BADUNG, BALI",14,263,9,272
https://kawalpemilu.org#53503,"KEROBOKAN, KUTA UTARA, BADUNG, BALI",15,254,16,270
https://kawalpemilu.org#53503,"KEROBOKAN, KUTA UTARA, BADUNG, BALI",16,259,11,270
https://kawalpemilu.org#53503,"KEROBOKAN, KUTA UTARA, BADUNG, BALI",17,259,1,260
https://kawalpemilu.org#53503,"KEROBOKAN, KUTA UTARA, BADUNG, BALI",18,222,14,236
https://kawalpemilu.org#53503,"KEROBOKAN, KUTA UTARA, BADUNG, BALI",19,229,17,246
https://kawalpemilu.org#53503,"KEROBOKAN, KUTA UTARA, BADUNG, BALI",20,193,19,212
https://kawalpemilu.org#53503,"KEROBOKAN, KUTA UTARA, BADUNG, BALI",21,228,14,242
https://kawalpemilu.org#53503,"KEROBOKAN, KUTA UTARA, BADUNG, BALI",22,196,14,210
https://kawalpemilu.org#53503,"KEROBOKAN, KUTA UTARA, BADUNG, BALI",23,240,9,249
https://kawalpemilu.org#53503,"KEROBOKAN, KUTA UTARA, BADUNG, BALI",24,236,8,244
https://kawalpemilu.org#53503,"KEROBOKAN, KUTA UTARA, BADUNG, BALI",25,227,16,243
https://kawalpemilu.org#53503,"KEROBOKAN, KUTA UTARA, BADUNG, BALI",26,237,13,250
https://kawalpemilu.org#53503,"KEROBOKAN, KUTA UTARA, BADUNG, BALI",27,242,3,245
https://kawalpemilu.org#53503,"KEROBOKAN, KUTA UTARA, BADUNG, BALI",28,249,8,257
https://kawalpemilu.org#53504,"KEROBOKAN KAJA, KUTA UTARA, BADUNG, BALI",1,242,64,306
https://kawalpemilu.org#53504,"KEROBOKAN KAJA, KUTA UTARA, BADUNG, BALI",2,256,21,277
https://kawalpemilu.org#53504,"KEROBOKAN KAJA, KUTA UTARA, BADUNG, BALI",3,256,14,270
https://kawalpemilu.org#53504,"KEROBOKAN KAJA, KUTA UTARA, BADUNG, BALI",4,270,10,280
https://kawalpemilu.org#53504,"KEROBOKAN KAJA, KUTA UTARA, BADUNG, BALI",5,268,9,277
https://kawalpemilu.org#53504,"KEROBOKAN KAJA, KUTA UTARA, BADUNG, BALI",6,187,28,215
https://kawalpemilu.org#53504,"KEROBOKAN KAJA, KUTA UTARA, BADUNG, BALI",7,224,26,250
https://kawalpemilu.org#53504,"KEROBOKAN KAJA, KUTA UTARA, BADUNG, BALI",8,218,16,234
https://kawalpemilu.org#53504,"KEROBOKAN KAJA, KUTA UTARA, BADUNG, BALI",9,218,17,235
https://kawalpemilu.org#53504,"KEROBOKAN KAJA, KUTA UTARA, BADUNG, BALI",10,178,12,190
https://kawalpemilu.org#53504,"KEROBOKAN KAJA, KUTA UTARA, BADUNG, BALI",11,207,17,224
https://kawalpemilu.org#53504,"KEROBOKAN KAJA, KUTA UTARA, BADUNG, BALI",12,264,6,270
https://kawalpemilu.org#53504,"KEROBOKAN KAJA, KUTA UTARA, BADUNG, BALI",13,213,21,234
https://kawalpemilu.org#53504,"KEROBOKAN KAJA, KUTA UTARA, BADUNG, BALI",14,241,21,262
https://kawalpemilu.org#53504,"KEROBOKAN KAJA, KUTA UTARA, BADUNG, BALI",15,227,29,256
https://kawalpemilu.org#53504,"KEROBOKAN KAJA, KUTA UTARA, BADUNG, BALI",16,225,17,242
https://kawalpemilu.org#53504,"KEROBOKAN KAJA, KUTA UTARA, BADUNG, BALI",17,269,17,286
https://kawalpemilu.org#53504,"KEROBOKAN KAJA, KUTA UTARA, BADUNG, BALI",18,255,10,265
https://kawalpemilu.org#53504,"KEROBOKAN KAJA, KUTA UTARA, BADUNG, BALI",19,0,0,0
https://kawalpemilu.org#53504,"KEROBOKAN KAJA, KUTA UTARA, BADUNG, BALI",20,253,6,259
https://kawalpemilu.org#53504,"KEROBOKAN KAJA, KUTA UTARA, BADUNG, BALI",21,256,11,267
https://kawalpemilu.org#53504,"KEROBOKAN KAJA, KUTA UTARA, BADUNG, BALI",22,264,4,268
https://kawalpemilu.org#53504,"KEROBOKAN KAJA, KUTA UTARA, BADUNG, BALI",23,280,7,287
https://kawalpemilu.org#53504,"KEROBOKAN KAJA, KUTA UTARA, BADUNG, BALI",24,268,17,285
https://kawalpemilu.org#53504,"KEROBOKAN KAJA, KUTA UTARA, BADUNG, BALI",25,252,21,273
https://kawalpemilu.org#53504,"KEROBOKAN KAJA, KUTA UTARA, BADUNG, BALI",26,261,10,271
https://kawalpemilu.org#53504,"KEROBOKAN KAJA, KUTA UTARA, BADUNG, BALI",27,262,8,270
https://kawalpemilu.org#53504,"KEROBOKAN KAJA, KUTA UTARA, BADUNG, BALI",28,0,0,0
https://kawalpemilu.org#53504,"KEROBOKAN KAJA, KUTA UTARA, BADUNG, BALI",29,269,12,281
https://kawalpemilu.org#53504,"KEROBOKAN KAJA, KUTA UTARA, BADUNG, BALI",30,239,32,271
https://kawalpemilu.org#53504,"KEROBOKAN KAJA, KUTA UTARA, BADUNG, BALI",31,241,24,265
https://kawalpemilu.org#53504,"KEROBOKAN KAJA, KUTA UTARA, BADUNG, BALI",32,246,37,283
https://kawalpemilu.org#53504,"KEROBOKAN KAJA, KUTA UTARA, BADUNG, BALI",33,200,16,216
https://kawalpemilu.org#53504,"KEROBOKAN KAJA, KUTA UTARA, BADUNG, BALI",34,222,21,243
https://kawalpemilu.org#53504,"KEROBOKAN KAJA, KUTA UTARA, BADUNG, BALI",35,196,19,215
https://kawalpemilu.org#53504,"KEROBOKAN KAJA, KUTA UTARA, BADUNG, BALI",36,218,43,261
https://kawalpemilu.org#53504,"KEROBOKAN KAJA, KUTA UTARA, BADUNG, BALI",37,210,38,248
https://kawalpemilu.org#53504,"KEROBOKAN KAJA, KUTA UTARA, BADUNG, BALI",38,252,24,276
https://kawalpemilu.org#53504,"KEROBOKAN KAJA, KUTA UTARA, BADUNG, BALI",39,217,30,247
https://kawalpemilu.org#53504,"KEROBOKAN KAJA, KUTA UTARA, BADUNG, BALI",40,247,28,275
https://kawalpemilu.org#53504,"KEROBOKAN KAJA, KUTA UTARA, BADUNG, BALI",41,223,34,257
https://kawalpemilu.org#53504,"KEROBOKAN KAJA, KUTA UTARA, BADUNG, BALI",42,273,9,282
https://kawalpemilu.org#53504,"KEROBOKAN KAJA, KUTA UTARA, BADUNG, BALI",43,214,35,249
https://kawalpemilu.org#53504,"KEROBOKAN KAJA, KUTA UTARA, BADUNG, BALI",44,185,16,201
https://kawalpemilu.org#53505,"TIBUBENENG, KUTA UTARA, BADUNG, BALI",1,261,16,277
https://kawalpemilu.org#53505,"TIBUBENENG, KUTA UTARA, BADUNG, BALI",2,222,35,257
https://kawalpemilu.org#53505,"TIBUBENENG, KUTA UTARA, BADUNG, BALI",3,262,19,281
https://kawalpemilu.org#53505,"TIBUBENENG, KUTA UTARA, BADUNG, BALI",4,243,24,267
https://kawalpemilu.org#53505,"TIBUBENENG, KUTA UTARA, BADUNG, BALI",5,264,19,283
https://kawalpemilu.org#53505,"TIBUBENENG, KUTA UTARA, BADUNG, BALI",6,250,20,270
https://kawalpemilu.org#53505,"TIBUBENENG, KUTA UTARA, BADUNG, BALI",7,270,24,294
https://kawalpemilu.org#53505,"TIBUBENENG, KUTA UTARA, BADUNG, BALI",8,279,11,290
https://kawalpemilu.org#53505,"TIBUBENENG, KUTA UTARA, BADUNG, BALI",9,269,1,270
https://kawalpemilu.org#53505,"TIBUBENENG, KUTA UTARA, BADUNG, BALI",10,246,19,265
https://kawalpemilu.org#53505,"TIBUBENENG, KUTA UTARA, BADUNG, BALI",11,286,11,297
https://kawalpemilu.org#53505,"TIBUBENENG, KUTA UTARA, BADUNG, BALI",12,245,16,261
https://kawalpemilu.org#53505,"TIBUBENENG, KUTA UTARA, BADUNG, BALI",13,246,16,262
https://kawalpemilu.org#53505,"TIBUBENENG, KUTA UTARA, BADUNG, BALI",14,258,19,277
https://kawalpemilu.org#53505,"TIBUBENENG, KUTA UTARA, BADUNG, BALI",15,242,26,268
https://kawalpemilu.org#53505,"TIBUBENENG, KUTA UTARA, BADUNG, BALI",17,241,26,267
https://kawalpemilu.org#53505,"TIBUBENENG, KUTA UTARA, BADUNG, BALI",18,233,34,267
https://kawalpemilu.org#53505,"TIBUBENENG, KUTA UTARA, BADUNG, BALI",19,141,50,191
https://kawalpemilu.org#53505,"TIBUBENENG, KUTA UTARA, BADUNG, BALI",20,183,79,262
https://kawalpemilu.org#53505,"TIBUBENENG, KUTA UTARA, BADUNG, BALI",21,206,66,272
https://kawalpemilu.org#53505,"TIBUBENENG, KUTA UTARA, BADUNG, BALI",22,196,56,252
https://kawalpemilu.org#53505,"TIBUBENENG, KUTA UTARA, BADUNG, BALI",23,177,67,244
https://kawalpemilu.org#53505,"TIBUBENENG, KUTA UTARA, BADUNG, BALI",24,207,64,271
https://kawalpemilu.org#53505,"TIBUBENENG, KUTA UTARA, BADUNG, BALI",25,252,5,257
https://kawalpemilu.org#53505,"TIBUBENENG, KUTA UTARA, BADUNG, BALI",26,227,32,259
https://kawalpemilu.org#53505,"TIBUBENENG, KUTA UTARA, BADUNG, BALI",27,174,15,189
https://kawalpemilu.org#53505,"TIBUBENENG, KUTA UTARA, BADUNG, BALI",28,273,5,278
https://kawalpemilu.org#53505,"TIBUBENENG, KUTA UTARA, BADUNG, BALI",29,276,1,277
https://kawalpemilu.org#53505,"TIBUBENENG, KUTA UTARA, BADUNG, BALI",30,244,15,259
https://kawalpemilu.org#53506,"CANGGU, KUTA UTARA, BADUNG, BALI",1,259,2,261
https://kawalpemilu.org#53506,"CANGGU, KUTA UTARA, BADUNG, BALI",2,257,5,262
https://kawalpemilu.org#53506,"CANGGU, KUTA UTARA, BADUNG, BALI",3,269,4,273
https://kawalpemilu.org#53506,"CANGGU, KUTA UTARA, BADUNG, BALI",4,249,3,252
https://kawalpemilu.org#53506,"CANGGU, KUTA UTARA, BADUNG, BALI",5,249,4,253
https://kawalpemilu.org#53506,"CANGGU, KUTA UTARA, BADUNG, BALI",6,264,3,267
https://kawalpemilu.org#53506,"CANGGU, KUTA UTARA, BADUNG, BALI",7,252,20,272
https://kawalpemilu.org#53506,"CANGGU, KUTA UTARA, BADUNG, BALI",8,206,29,235
https://kawalpemilu.org#53506,"CANGGU, KUTA UTARA, BADUNG, BALI",9,278,19,297
https://kawalpemilu.org#53506,"CANGGU, KUTA UTARA, BADUNG, BALI",10,247,32,279
https://kawalpemilu.org#53506,"CANGGU, KUTA UTARA, BADUNG, BALI",11,239,28,267
https://kawalpemilu.org#53506,"CANGGU, KUTA UTARA, BADUNG, BALI",12,270,9,279
https://kawalpemilu.org#53506,"CANGGU, KUTA UTARA, BADUNG, BALI",13,268,11,279
https://kawalpemilu.org#53506,"CANGGU, KUTA UTARA, BADUNG, BALI",14,214,14,228
https://kawalpemilu.org#53506,"CANGGU, KUTA UTARA, BADUNG, BALI",15,254,11,265
https://kawalpemilu.org#53506,"CANGGU, KUTA UTARA, BADUNG, BALI",16,247,4,251
https://kawalpemilu.org#53506,"CANGGU, KUTA UTARA, BADUNG, BALI",17,281,3,284
https://kawalpemilu.org#53506,"CANGGU, KUTA UTARA, BADUNG, BALI",18,245,4,249
https://kawalpemilu.org#53507,"DALUNG, KUTA UTARA, BADUNG, BALI",1,279,1,280
https://kawalpemilu.org#53507,"DALUNG, KUTA UTARA, BADUNG, BALI",2,271,25,296
https://kawalpemilu.org#53507,"DALUNG, KUTA UTARA, BADUNG, BALI",3,258,26,284
https://kawalpemilu.org#53507,"DALUNG, KUTA UTARA, BADUNG, BALI",4,271,4,275
https://kawalpemilu.org#53507,"DALUNG, KUTA UTARA, BADUNG, BALI",5,241,4,245
https://kawalpemilu.org#53507,"DALUNG, KUTA UTARA, BADUNG, BALI",6,230,6,236
https://kawalpemilu.org#53507,"DALUNG, KUTA UTARA, BADUNG, BALI",7,226,14,240
https://kawalpemilu.org#53507,"DALUNG, KUTA UTARA, BADUNG, BALI",8,245,8,253
https://kawalpemilu.org#53507,"DALUNG, KUTA UTARA, BADUNG, BALI",9,268,3,271
https://kawalpemilu.org#53507,"DALUNG, KUTA UTARA, BADUNG, BALI",10,213,6,219
https://kawalpemilu.org#53507,"DALUNG, KUTA UTARA, BADUNG, BALI",11,223,19,242
https://kawalpemilu.org#53507,"DALUNG, KUTA UTARA, BADUNG, BALI",12,223,23,246
https://kawalpemilu.org#53507,"DALUNG, KUTA UTARA, BADUNG, BALI",14,277,4,281
https://kawalpemilu.org#53507,"DALUNG, KUTA UTARA, BADUNG, BALI",15,216,20,236
https://kawalpemilu.org#53507,"DALUNG, KUTA UTARA, BADUNG, BALI",16,230,15,245
https://kawalpemilu.org#53507,"DALUNG, KUTA UTARA, BADUNG, BALI",18,235,16,251
https://kawalpemilu.org#53507,"DALUNG, KUTA UTARA, BADUNG, BALI",19,234,8,242
https://kawalpemilu.org#53507,"DALUNG, KUTA UTARA, BADUNG, BALI",20,247,9,256
https://kawalpemilu.org#53507,"DALUNG, KUTA UTARA, BADUNG, BALI",21,202,20,222
https://kawalpemilu.org#53507,"DALUNG, KUTA UTARA, BADUNG, BALI",22,228,17,245
https://kawalpemilu.org#53507,"DALUNG, KUTA UTARA, BADUNG, BALI",23,221,14,235
https://kawalpemilu.org#53507,"DALUNG, KUTA UTARA, BADUNG, BALI",24,201,20,221
https://kawalpemilu.org#53507,"DALUNG, KUTA UTARA, BADUNG, BALI",25,235,5,240
https://kawalpemilu.org#53507,"DALUNG, KUTA UTARA, BADUNG, BALI",26,261,7,268
https://kawalpemilu.org#53507,"DALUNG, KUTA UTARA, BADUNG, BALI",28,190,19,209
https://kawalpemilu.org#53507,"DALUNG, KUTA UTARA, BADUNG, BALI",29,200,6,206
https://kawalpemilu.org#53507,"DALUNG, KUTA UTARA, BADUNG, BALI",30,261,6,267
https://kawalpemilu.org#53507,"DALUNG, KUTA UTARA, BADUNG, BALI",31,246,9,255
https://kawalpemilu.org#53507,"DALUNG, KUTA UTARA, BADUNG, BALI",32,246,15,261
https://kawalpemilu.org#53507,"DALUNG, KUTA UTARA, BADUNG, BALI",33,205,8,213
https://kawalpemilu.org#53507,"DALUNG, KUTA UTARA, BADUNG, BALI",34,207,7,214
https://kawalpemilu.org#53507,"DALUNG, KUTA UTARA, BADUNG, BALI",35,232,8,240
https://kawalpemilu.org#53507,"DALUNG, KUTA UTARA, BADUNG, BALI",36,164,31,195
https://kawalpemilu.org#53507,"DALUNG, KUTA UTARA, BADUNG, BALI",37,195,32,227
https://kawalpemilu.org#53507,"DALUNG, KUTA UTARA, BADUNG, BALI",38,204,29,233
https://kawalpemilu.org#53507,"DALUNG, KUTA UTARA, BADUNG, BALI",39,248,13,261
https://kawalpemilu.org#53507,"DALUNG, KUTA UTARA, BADUNG, BALI",40,249,2,251
https://kawalpemilu.org#53507,"DALUNG, KUTA UTARA, BADUNG, BALI",41,234,11,245
https://kawalpemilu.org#53507,"DALUNG, KUTA UTARA, BADUNG, BALI",42,229,10,239
https://kawalpemilu.org#53507,"DALUNG, KUTA UTARA, BADUNG, BALI",43,256,6,262
https://kawalpemilu.org#53507,"DALUNG, KUTA UTARA, BADUNG, BALI",44,261,8,269
https://kawalpemilu.org#53507,"DALUNG, KUTA UTARA, BADUNG, BALI",45,251,10,261
https://kawalpemilu.org#53507,"DALUNG, KUTA UTARA, BADUNG, BALI",46,215,3,218
https://kawalpemilu.org#53507,"DALUNG, KUTA UTARA, BADUNG, BALI",47,203,9,212
https://kawalpemilu.org#53507,"DALUNG, KUTA UTARA, BADUNG, BALI",48,242,12,254
https://kawalpemilu.org#53507,"DALUNG, KUTA UTARA, BADUNG, BALI",49,248,7,255
https://kawalpemilu.org#53507,"DALUNG, KUTA UTARA, BADUNG, BALI",50,239,9,248
https://kawalpemilu.org#53507,"DALUNG, KUTA UTARA, BADUNG, BALI",51,236,22,258
https://kawalpemilu.org#53507,"DALUNG, KUTA UTARA, BADUNG, BALI",52,237,19,256
https://kawalpemilu.org#53507,"DALUNG, KUTA UTARA, BADUNG, BALI",53,192,31,223
https://kawalpemilu.org#53507,"DALUNG, KUTA UTARA, BADUNG, BALI",54,193,21,214
https://kawalpemilu.org#53507,"DALUNG, KUTA UTARA, BADUNG, BALI",55,178,33,211
https://kawalpemilu.org#53507,"DALUNG, KUTA UTARA, BADUNG, BALI",56,171,62,233
https://kawalpemilu.org#53507,"DALUNG, KUTA UTARA, BADUNG, BALI",57,149,59,208
https://kawalpemilu.org#53507,"DALUNG, KUTA UTARA, BADUNG, BALI",58,201,41,242
https://kawalpemilu.org#53507,"DALUNG, KUTA UTARA, BADUNG, BALI",59,175,46,221
https://kawalpemilu.org#53507,"DALUNG, KUTA UTARA, BADUNG, BALI",60,189,21,210
https://kawalpemilu.org#53507,"DALUNG, KUTA UTARA, BADUNG, BALI",61,181,22,203
https://kawalpemilu.org#53507,"DALUNG, KUTA UTARA, BADUNG, BALI",62,200,29,229
https://kawalpemilu.org#53507,"DALUNG, KUTA UTARA, BADUNG, BALI",63,200,24,224
https://kawalpemilu.org#53507,"DALUNG, KUTA UTARA, BADUNG, BALI",64,226,22,248
https://kawalpemilu.org#53507,"DALUNG, KUTA UTARA, BADUNG, BALI",65,231,29,260
https://kawalpemilu.org#53507,"DALUNG, KUTA UTARA, BADUNG, BALI",67,234,36,270
https://kawalpemilu.org#53507,"DALUNG, KUTA UTARA, BADUNG, BALI",68,225,50,275
https://kawalpemilu.org#53510,"BATUBULAN, SUKAWATI, GIANYAR, BALI",1,168,5,191
https://kawalpemilu.org#53510,"BATUBULAN, SUKAWATI, GIANYAR, BALI",2,172,7,179
https://kawalpemilu.org#53510,"BATUBULAN, SUKAWATI, GIANYAR, BALI",3,175,12,187
https://kawalpemilu.org#53510,"BATUBULAN, SUKAWATI, GIANYAR, BALI",4,204,3,207
https://kawalpemilu.org#53510,"BATUBULAN, SUKAWATI, GIANYAR, BALI",5,196,8,204
https://kawalpemilu.org#53510,"BATUBULAN, SUKAWATI, GIANYAR, BALI",6,204,0,204
https://kawalpemilu.org#53510,"BATUBULAN, SUKAWATI, GIANYAR, BALI",7,198,10,208
https://kawalpemilu.org#53510,"BATUBULAN, SUKAWATI, GIANYAR, BALI",8,224,5,229
https://kawalpemilu.org#53510,"BATUBULAN, SUKAWATI, GIANYAR, BALI",9,210,4,214
https://kawalpemilu.org#53510,"BATUBULAN, SUKAWATI, GIANYAR, BALI",10,254,8,262
https://kawalpemilu.org#53510,"BATUBULAN, SUKAWATI, GIANYAR, BALI",11,253,9,262
https://kawalpemilu.org#53510,"BATUBULAN, SUKAWATI, GIANYAR, BALI",12,142,8,150
https://kawalpemilu.org#53510,"BATUBULAN, SUKAWATI, GIANYAR, BALI",13,153,8,161
https://kawalpemilu.org#53510,"BATUBULAN, SUKAWATI, GIANYAR, BALI",14,240,6,246
https://kawalpemilu.org#53510,"BATUBULAN, SUKAWATI, GIANYAR, BALI",15,216,6,222
https://kawalpemilu.org#53510,"BATUBULAN, SUKAWATI, GIANYAR, BALI",16,180,8,188
https://kawalpemilu.org#53510,"BATUBULAN, SUKAWATI, GIANYAR, BALI",17,172,5,177
https://kawalpemilu.org#53510,"BATUBULAN, SUKAWATI, GIANYAR, BALI",18,194,12,206
https://kawalpemilu.org#53510,"BATUBULAN, SUKAWATI, GIANYAR, BALI",19,186,14,200
https://kawalpemilu.org#53510,"BATUBULAN, SUKAWATI, GIANYAR, BALI",20,172,7,179
https://kawalpemilu.org#53510,"BATUBULAN, SUKAWATI, GIANYAR, BALI",21,159,3,162
https://kawalpemilu.org#53510,"BATUBULAN, SUKAWATI, GIANYAR, BALI",22,148,7,155
https://kawalpemilu.org#53510,"BATUBULAN, SUKAWATI, GIANYAR, BALI",23,233,9,242
https://kawalpemilu.org#53510,"BATUBULAN, SUKAWATI, GIANYAR, BALI",24,238,7,245
https://kawalpemilu.org#53510,"BATUBULAN, SUKAWATI, GIANYAR, BALI",25,234,7,241
https://kawalpemilu.org#53510,"BATUBULAN, SUKAWATI, GIANYAR, BALI",26,248,11,259
https://kawalpemilu.org#53510,"BATUBULAN, SUKAWATI, GIANYAR, BALI",27,249,12,261
https://kawalpemilu.org#53510,"BATUBULAN, SUKAWATI, GIANYAR, BALI",28,213,2,215
https://kawalpemilu.org#53510,"BATUBULAN, SUKAWATI, GIANYAR, BALI",29,211,6,217
https://kawalpemilu.org#53510,"BATUBULAN, SUKAWATI, GIANYAR, BALI",30,216,3,219
https://kawalpemilu.org#53510,"BATUBULAN, SUKAWATI, GIANYAR, BALI",31,228,14,242
https://kawalpemilu.org#53510,"BATUBULAN, SUKAWATI, GIANYAR, BALI",32,95,4,99
https://kawalpemilu.org#53510,"BATUBULAN, SUKAWATI, GIANYAR, BALI",33,95,11,106
https://kawalpemilu.org#53510,"BATUBULAN, SUKAWATI, GIANYAR, BALI",34,237,5,242
https://kawalpemilu.org#53510,"BATUBULAN, SUKAWATI, GIANYAR, BALI",35,218,2,220
https://kawalpemilu.org#53510,"BATUBULAN, SUKAWATI, GIANYAR, BALI",36,212,6,218
https://kawalpemilu.org#53510,"BATUBULAN, SUKAWATI, GIANYAR, BALI",37,222,5,227
https://kawalpemilu.org#53510,"BATUBULAN, SUKAWATI, GIANYAR, BALI",38,224,11,235
https://kawalpemilu.org#53510,"BATUBULAN, SUKAWATI, GIANYAR, BALI",40,237,9,246
https://kawalpemilu.org#53510,"BATUBULAN, SUKAWATI, GIANYAR, BALI",41,246,6,252
https://kawalpemilu.org#53510,"BATUBULAN, SUKAWATI, GIANYAR, BALI",42,219,1,220
https://kawalpemilu.org#53510,"BATUBULAN, SUKAWATI, GIANYAR, BALI",43,249,8,249
https://kawalpemilu.org#53510,"BATUBULAN, SUKAWATI, GIANYAR, BALI",45,169,7,176
https://kawalpemilu.org#53510,"BATUBULAN, SUKAWATI, GIANYAR, BALI",46,192,3,195
https://kawalpemilu.org#53510,"BATUBULAN, SUKAWATI, GIANYAR, BALI",47,164,12,176
https://kawalpemilu.org#53510,"BATUBULAN, SUKAWATI, GIANYAR, BALI",48,179,10,189
https://kawalpemilu.org#53510,"BATUBULAN, SUKAWATI, GIANYAR, BALI",49,175,11,186
https://kawalpemilu.org#53510,"BATUBULAN, SUKAWATI, GIANYAR, BALI",50,170,8,178
https://kawalpemilu.org#53510,"BATUBULAN, SUKAWATI, GIANYAR, BALI",52,177,6,183
https://kawalpemilu.org#53510,"BATUBULAN, SUKAWATI, GIANYAR, BALI",53,210,8,218
https://kawalpemilu.org#53510,"BATUBULAN, SUKAWATI, GIANYAR, BALI",54,184,10,194
https://kawalpemilu.org#53510,"BATUBULAN, SUKAWATI, GIANYAR, BALI",55,184,8,192
https://kawalpemilu.org#53510,"BATUBULAN, SUKAWATI, GIANYAR, BALI",56,227,11,238
https://kawalpemilu.org#53510,"BATUBULAN, SUKAWATI, GIANYAR, BALI",57,209,2,211
https://kawalpemilu.org#53510,"BATUBULAN, SUKAWATI, GIANYAR, BALI",58,227,26,253
https://kawalpemilu.org#53510,"BATUBULAN, SUKAWATI, GIANYAR, BALI",59,189,50,239
https://kawalpemilu.org#53510,"BATUBULAN, SUKAWATI, GIANYAR, BALI",60,238,19,257
https://kawalpemilu.org#53511,"KETEWEL, SUKAWATI, GIANYAR, BALI",1,204,18,222
https://kawalpemilu.org#53511,"KETEWEL, SUKAWATI, GIANYAR, BALI",2,185,28,213
https://kawalpemilu.org#53511,"KETEWEL, SUKAWATI, GIANYAR, BALI",3,193,28,221
https://kawalpemilu.org#53511,"KETEWEL, SUKAWATI, GIANYAR, BALI",4,140,7,147
https://kawalpemilu.org#53511,"KETEWEL, SUKAWATI, GIANYAR, BALI",5,153,3,156
https://kawalpemilu.org#53511,"KETEWEL, SUKAWATI, GIANYAR, BALI",6,210,14,224
https://kawalpemilu.org#53511,"KETEWEL, SUKAWATI, GIANYAR, BALI",7,185,12,197
https://kawalpemilu.org#53511,"KETEWEL, SUKAWATI, GIANYAR, BALI",8,202,9,211
https://kawalpemilu.org#53511,"KETEWEL, SUKAWATI, GIANYAR, BALI",9,205,9,214
https://kawalpemilu.org#53511,"KETEWEL, SUKAWATI, GIANYAR, BALI",10,198,10,208
https://kawalpemilu.org#53511,"KETEWEL, SUKAWATI, GIANYAR, BALI",11,183,14,197
https://kawalpemilu.org#53511,"KETEWEL, SUKAWATI, GIANYAR, BALI",12,190,15,205
https://kawalpemilu.org#53511,"KETEWEL, SUKAWATI, GIANYAR, BALI",13,178,5,183
https://kawalpemilu.org#53511,"KETEWEL, SUKAWATI, GIANYAR, BALI",14,225,4,229
https://kawalpemilu.org#53511,"KETEWEL, SUKAWATI, GIANYAR, BALI",16,212,3,215
https://kawalpemilu.org#53511,"KETEWEL, SUKAWATI, GIANYAR, BALI",17,209,8,217
https://kawalpemilu.org#53511,"KETEWEL, SUKAWATI, GIANYAR, BALI",18,192,12,204
https://kawalpemilu.org#53511,"KETEWEL, SUKAWATI, GIANYAR, BALI",19,161,0,161
https://kawalpemilu.org#53511,"KETEWEL, SUKAWATI, GIANYAR, BALI",20,150,4,154
https://kawalpemilu.org#53511,"KETEWEL, SUKAWATI, GIANYAR, BALI",21,158,0,158
https://kawalpemilu.org#53511,"KETEWEL, SUKAWATI, GIANYAR, BALI",22,155,2,157
https://kawalpemilu.org#53511,"KETEWEL, SUKAWATI, GIANYAR, BALI",23,186,17,203
https://kawalpemilu.org#53511,"KETEWEL, SUKAWATI, GIANYAR, BALI",24,166,17,183
https://kawalpemilu.org#53511,"KETEWEL, SUKAWATI, GIANYAR, BALI",25,194,4,198
https://kawalpemilu.org#53511,"KETEWEL, SUKAWATI, GIANYAR, BALI",26,170,29,199
https://kawalpemilu.org#53511,"KETEWEL, SUKAWATI, GIANYAR, BALI",27,168,17,185
https://kawalpemilu.org#53511,"KETEWEL, SUKAWATI, GIANYAR, BALI",28,204,4,208
https://kawalpemilu.org#53511,"KETEWEL, SUKAWATI, GIANYAR, BALI",29,202,9,211
https://kawalpemilu.org#53511,"KETEWEL, SUKAWATI, GIANYAR, BALI",30,181,12,193
https://kawalpemilu.org#53511,"KETEWEL, SUKAWATI, GIANYAR, BALI",31,173,7,180
https://kawalpemilu.org#53511,"KETEWEL, SUKAWATI, GIANYAR, BALI",32,238,8,246
https://kawalpemilu.org#53511,"KETEWEL, SUKAWATI, GIANYAR, BALI",33,235,2,237
https://kawalpemilu.org#53511,"KETEWEL, SUKAWATI, GIANYAR, BALI",34,190,3,193
https://kawalpemilu.org#53511,"KETEWEL, SUKAWATI, GIANYAR, BALI",35,182,3,185
https://kawalpemilu.org#53511,"KETEWEL, SUKAWATI, GIANYAR, BALI",36,247,8,255
https://kawalpemilu.org#53511,"KETEWEL, SUKAWATI, GIANYAR, BALI",37,236,8,244
https://kawalpemilu.org#53511,"KETEWEL, SUKAWATI, GIANYAR, BALI",38,266,7,233
https://kawalpemilu.org#53512,"GUWANG, SUKAWATI, GIANYAR, BALI",1,271,4,275
https://kawalpemilu.org#53512,"GUWANG, SUKAWATI, GIANYAR, BALI",2,275,6,281
https://kawalpemilu.org#53512,"GUWANG, SUKAWATI, GIANYAR, BALI",3,247,12,259
https://kawalpemilu.org#53512,"GUWANG, SUKAWATI, GIANYAR, BALI",4,251,15,266
https://kawalpemilu.org#53512,"GUWANG, SUKAWATI, GIANYAR, BALI",5,245,17,262
https://kawalpemilu.org#53512,"GUWANG, SUKAWATI, GIANYAR, BALI",6,225,11,236
https://kawalpemilu.org#53512,"GUWANG, SUKAWATI, GIANYAR, BALI",7,233,11,244
https://kawalpemilu.org#53512,"GUWANG, SUKAWATI, GIANYAR, BALI",8,230,4,234
https://kawalpemilu.org#53512,"GUWANG, SUKAWATI, GIANYAR, BALI",9,224,9,233
https://kawalpemilu.org#53512,"GUWANG, SUKAWATI, GIANYAR, BALI",10,200,5,205
https://kawalpemilu.org#53512,"GUWANG, SUKAWATI, GIANYAR, BALI",11,202,13,215
https://kawalpemilu.org#53512,"GUWANG, SUKAWATI, GIANYAR, BALI",12,253,14,267
https://kawalpemilu.org#53512,"GUWANG, SUKAWATI, GIANYAR, BALI",13,256,9,265
https://kawalpemilu.org#53512,"GUWANG, SUKAWATI, GIANYAR, BALI",14,246,9,255
https://kawalpemilu.org#53512,"GUWANG, SUKAWATI, GIANYAR, BALI",15,227,12,239
https://kawalpemilu.org#53512,"GUWANG, SUKAWATI, GIANYAR, BALI",16,253,6,259
https://kawalpemilu.org#53512,"GUWANG, SUKAWATI, GIANYAR, BALI",17,265,7,272
https://kawalpemilu.org#53513,"SUKAWATI, SUKAWATI, GIANYAR, BALI",1,241,9,250
https://kawalpemilu.org#53513,"SUKAWATI, SUKAWATI, GIANYAR, BALI",2,202,5,207
https://kawalpemilu.org#53513,"SUKAWATI, SUKAWATI, GIANYAR, BALI",3,221,4,225
https://kawalpemilu.org#53513,"SUKAWATI, SUKAWATI, GIANYAR, BALI",4,236,5,241
https://kawalpemilu.org#53513,"SUKAWATI, SUKAWATI, GIANYAR, BALI",5,241,10,251
https://kawalpemilu.org#53513,"SUKAWATI, SUKAWATI, GIANYAR, BALI",6,201,8,209
https://kawalpemilu.org#53513,"SUKAWATI, SUKAWATI, GIANYAR, BALI",7,228,0,228
https://kawalpemilu.org#53513,"SUKAWATI, SUKAWATI, GIANYAR, BALI",8,229,7,236
https://kawalpemilu.org#53513,"SUKAWATI, SUKAWATI, GIANYAR, BALI",9,228,0,228
https://kawalpemilu.org#53513,"SUKAWATI, SUKAWATI, GIANYAR, BALI",10,227,5,232
https://kawalpemilu.org#53513,"SUKAWATI, SUKAWATI, GIANYAR, BALI",11,197,5,202
https://kawalpemilu.org#53513,"SUKAWATI, SUKAWATI, GIANYAR, BALI",12,190,2,192
https://kawalpemilu.org#53513,"SUKAWATI, SUKAWATI, GIANYAR, BALI",13,193,2,195
https://kawalpemilu.org#53513,"SUKAWATI, SUKAWATI, GIANYAR, BALI",14,165,5,170
https://kawalpemilu.org#53513,"SUKAWATI, SUKAWATI, GIANYAR, BALI",15,213,2,215
https://kawalpemilu.org#53513,"SUKAWATI, SUKAWATI, GIANYAR, BALI",16,206,3,209
https://kawalpemilu.org#53513,"SUKAWATI, SUKAWATI, GIANYAR, BALI",17,192,5,197
https://kawalpemilu.org#53513,"SUKAWATI, SUKAWATI, GIANYAR, BALI",18,205,2,207
https://kawalpemilu.org#53513,"SUKAWATI, SUKAWATI, GIANYAR, BALI",19,194,4,198
https://kawalpemilu.org#53513,"SUKAWATI, SUKAWATI, GIANYAR, BALI",20,206,5,211
https://kawalpemilu.org#53513,"SUKAWATI, SUKAWATI, GIANYAR, BALI",21,183,2,185
https://kawalpemilu.org#53513,"SUKAWATI, SUKAWATI, GIANYAR, BALI",22,197,0,197
https://kawalpemilu.org#53513,"SUKAWATI, SUKAWATI, GIANYAR, BALI",23,186,5,191
https://kawalpemilu.org#53513,"SUKAWATI, SUKAWATI, GIANYAR, BALI",24,171,6,177
https://kawalpemilu.org#53513,"SUKAWATI, SUKAWATI, GIANYAR, BALI",25,186,7,193
https://kawalpemilu.org#53513,"SUKAWATI, SUKAWATI, GIANYAR, BALI",26,168,6,174
https://kawalpemilu.org#53513,"SUKAWATI, SUKAWATI, GIANYAR, BALI",27,169,2,171
https://kawalpemilu.org#53513,"SUKAWATI, SUKAWATI, GIANYAR, BALI",28,168,3,171
https://kawalpemilu.org#53513,"SUKAWATI, SUKAWATI, GIANYAR, BALI",29,200,3,203
https://kawalpemilu.org#53513,"SUKAWATI, SUKAWATI, GIANYAR, BALI",30,175,10,185
https://kawalpemilu.org#53513,"SUKAWATI, SUKAWATI, GIANYAR, BALI",31,205,6,211
https://kawalpemilu.org#53513,"SUKAWATI, SUKAWATI, GIANYAR, BALI",32,208,5,208
https://kawalpemilu.org#53513,"SUKAWATI, SUKAWATI, GIANYAR, BALI",33,172,1,173
https://kawalpemilu.org#53513,"SUKAWATI, SUKAWATI, GIANYAR, BALI",34,155,4,159
https://kawalpemilu.org#53513,"SUKAWATI, SUKAWATI, GIANYAR, BALI",35,164,2,166
https://kawalpemilu.org#53513,"SUKAWATI, SUKAWATI, GIANYAR, BALI",36,196,20,216
https://kawalpemilu.org#53513,"SUKAWATI, SUKAWATI, GIANYAR, BALI",37,205,15,220
https://kawalpemilu.org#53513,"SUKAWATI, SUKAWATI, GIANYAR, BALI",38,194,25,219
https://kawalpemilu.org#53513,"SUKAWATI, SUKAWATI, GIANYAR, BALI",39,175,22,197
https://kawalpemilu.org#53513,"SUKAWATI, SUKAWATI, GIANYAR, BALI",40,228,12,240
https://kawalpemilu.org#53513,"SUKAWATI, SUKAWATI, GIANYAR, BALI",41,236,1,237
https://kawalpemilu.org#53514,"CELUK, SUKAWATI, GIANYAR, BALI",1,246,15,261
https://kawalpemilu.org#53514,"CELUK, SUKAWATI, GIANYAR, BALI",2,246,13,259
https://kawalpemilu.org#53514,"CELUK, SUKAWATI, GIANYAR, BALI",3,254,2,256
https://kawalpemilu.org#53514,"CELUK, SUKAWATI, GIANYAR, BALI",4,267,1,268
https://kawalpemilu.org#53514,"CELUK, SUKAWATI, GIANYAR, BALI",5,256,4,260
https://kawalpemilu.org#53514,"CELUK, SUKAWATI, GIANYAR, BALI",6,252,5,257
https://kawalpemilu.org#53514,"CELUK, SUKAWATI, GIANYAR, BALI",7,213,6,219
https://kawalpemilu.org#53514,"CELUK, SUKAWATI, GIANYAR, BALI",8,232,9,241
https://kawalpemilu.org#53514,"CELUK, SUKAWATI, GIANYAR, BALI",9,231,19,250
https://kawalpemilu.org#53514,"CELUK, SUKAWATI, GIANYAR, BALI",10,243,9,252
https://kawalpemilu.org#53514,"CELUK, SUKAWATI, GIANYAR, BALI",11,239,13,252
https://kawalpemilu.org#53514,"CELUK, SUKAWATI, GIANYAR, BALI",12,158,3,161
https://kawalpemilu.org#53515,"SINGAPADU, SUKAWATI, GIANYAR, BALI",1,224,1,225
https://kawalpemilu.org#53515,"SINGAPADU, SUKAWATI, GIANYAR, BALI",2,223,5,228
https://kawalpemilu.org#53515,"SINGAPADU, SUKAWATI, GIANYAR, BALI",4,218,2,220
https://kawalpemilu.org#53515,"SINGAPADU, SUKAWATI, GIANYAR, BALI",5,239,3,242
https://kawalpemilu.org#53515,"SINGAPADU, SUKAWATI, GIANYAR, BALI",6,239,3,242
https://kawalpemilu.org#53515,"SINGAPADU, SUKAWATI, GIANYAR, BALI",7,233,0,233
https://kawalpemilu.org#53515,"SINGAPADU, SUKAWATI, GIANYAR, BALI",8,232,4,236
https://kawalpemilu.org#53515,"SINGAPADU, SUKAWATI, GIANYAR, BALI",9,220,17,237
https://kawalpemilu.org#53515,"SINGAPADU, SUKAWATI, GIANYAR, BALI",10,245,2,247
https://kawalpemilu.org#53515,"SINGAPADU, SUKAWATI, GIANYAR, BALI",11,213,11,224
https://kawalpemilu.org#53515,"SINGAPADU, SUKAWATI, GIANYAR, BALI",12,232,17,249
https://kawalpemilu.org#53515,"SINGAPADU, SUKAWATI, GIANYAR, BALI",13,221,3,224
https://kawalpemilu.org#53515,"SINGAPADU, SUKAWATI, GIANYAR, BALI",14,222,3,225
https://kawalpemilu.org#53515,"SINGAPADU, SUKAWATI, GIANYAR, BALI",15,217,4,221
https://kawalpemilu.org#53515,"SINGAPADU, SUKAWATI, GIANYAR, BALI",16,232,5,237
https://kawalpemilu.org#53515,"SINGAPADU, SUKAWATI, GIANYAR, BALI",18,160,2,162
https://kawalpemilu.org#53515,"SINGAPADU, SUKAWATI, GIANYAR, BALI",19,150,7,157
https://kawalpemilu.org#53516,"BATUAN, SUKAWATI, GIANYAR, BALI",1,240,5,245
https://kawalpemilu.org#53516,"BATUAN, SUKAWATI, GIANYAR, BALI",2,243,1,244
https://kawalpemilu.org#53516,"BATUAN, SUKAWATI, GIANYAR, BALI",3,275,1,276
https://kawalpemilu.org#53516,"BATUAN, SUKAWATI, GIANYAR, BALI",4,220,0,220
https://kawalpemilu.org#53516,"BATUAN, SUKAWATI, GIANYAR, BALI",5,219,2,221
https://kawalpemilu.org#53516,"BATUAN, SUKAWATI, GIANYAR, BALI",6,212,8,220
https://kawalpemilu.org#53516,"BATUAN, SUKAWATI, GIANYAR, BALI",7,192,6,198
https://kawalpemilu.org#53516,"BATUAN, SUKAWATI, GIANYAR, BALI",8,201,12,213
https://kawalpemilu.org#53516,"BATUAN, SUKAWATI, GIANYAR, BALI",9,213,9,222
https://kawalpemilu.org#53516,"BATUAN, SUKAWATI, GIANYAR, BALI",10,248,6,254
https://kawalpemilu.org#53516,"BATUAN, SUKAWATI, GIANYAR, BALI",11,189,14,203
https://kawalpemilu.org#53516,"BATUAN, SUKAWATI, GIANYAR, BALI",12,255,5,260
https://kawalpemilu.org#53516,"BATUAN, SUKAWATI, GIANYAR, BALI",13,235,3,238
https://kawalpemilu.org#53516,"BATUAN, SUKAWATI, GIANYAR, BALI",14,219,0,219
https://kawalpemilu.org#53516,"BATUAN, SUKAWATI, GIANYAR, BALI",15,211,0,211
https://kawalpemilu.org#53516,"BATUAN, SUKAWATI, GIANYAR, BALI",16,233,4,237
https://kawalpemilu.org#53516,"BATUAN, SUKAWATI, GIANYAR, BALI",17,244,4,248
https://kawalpemilu.org#53516,"BATUAN, SUKAWATI, GIANYAR, BALI",18,240,0,240
https://kawalpemilu.org#53516,"BATUAN, SUKAWATI, GIANYAR, BALI",19,253,1,254
https://kawalpemilu.org#53516,"BATUAN, SUKAWATI, GIANYAR, BALI",20,238,30,268
https://kawalpemilu.org#53516,"BATUAN, SUKAWATI, GIANYAR, BALI",21,226,10,236
https://kawalpemilu.org#53516,"BATUAN, SUKAWATI, GIANYAR, BALI",22,179,6,185
https://kawalpemilu.org#53516,"BATUAN, SUKAWATI, GIANYAR, BALI",23,223,9,232
https://kawalpemilu.org#53516,"BATUAN, SUKAWATI, GIANYAR, BALI",24,232,6,238
https://kawalpemilu.org#53516,"BATUAN, SUKAWATI, GIANYAR, BALI",25,257,3,260
https://kawalpemilu.org#53516,"BATUAN, SUKAWATI, GIANYAR, BALI",26,215,9,224
https://kawalpemilu.org#53517,"KEMENUH, SUKAWATI, GIANYAR, BALI",1,139,6,145
https://kawalpemilu.org#53517,"KEMENUH, SUKAWATI, GIANYAR, BALI",2,149,6,155
https://kawalpemilu.org#53517,"KEMENUH, SUKAWATI, GIANYAR, BALI",3,208,6,214
https://kawalpemilu.org#53517,"KEMENUH, SUKAWATI, GIANYAR, BALI",4,207,3,210
https://kawalpemilu.org#53517,"KEMENUH, SUKAWATI, GIANYAR, BALI",5,196,9,205
https://kawalpemilu.org#53517,"KEMENUH, SUKAWATI, GIANYAR, BALI",6,205,3,208
https://kawalpemilu.org#53517,"KEMENUH, SUKAWATI, GIANYAR, BALI",7,204,6,210
https://kawalpemilu.org#53517,"KEMENUH, SUKAWATI, GIANYAR, BALI",8,219,1,220
https://kawalpemilu.org#53517,"KEMENUH, SUKAWATI, GIANYAR, BALI",9,236,6,242
https://kawalpemilu.org#53517,"KEMENUH, SUKAWATI, GIANYAR, BALI",10,228,12,240
https://kawalpemilu.org#53517,"KEMENUH, SUKAWATI, GIANYAR, BALI",11,235,5,240
https://kawalpemilu.org#53517,"KEMENUH, SUKAWATI, GIANYAR, BALI",12,196,6,202
https://kawalpemilu.org#53517,"KEMENUH, SUKAWATI, GIANYAR, BALI",13,279,15,294
https://kawalpemilu.org#53517,"KEMENUH, SUKAWATI, GIANYAR, BALI",14,289,1,290
https://kawalpemilu.org#53517,"KEMENUH, SUKAWATI, GIANYAR, BALI",15,251,3,254
https://kawalpemilu.org#53517,"KEMENUH, SUKAWATI, GIANYAR, BALI",16,253,2,255
https://kawalpemilu.org#53517,"KEMENUH, SUKAWATI, GIANYAR, BALI",17,255,13,268
https://kawalpemilu.org#53517,"KEMENUH, SUKAWATI, GIANYAR, BALI",18,258,7,265
https://kawalpemilu.org#53517,"KEMENUH, SUKAWATI, GIANYAR, BALI",19,270,1,271
https://kawalpemilu.org#53517,"KEMENUH, SUKAWATI, GIANYAR, BALI",20,230,1,231
https://kawalpemilu.org#53517,"KEMENUH, SUKAWATI, GIANYAR, BALI",21,235,3,238
https://kawalpemilu.org#53517,"KEMENUH, SUKAWATI, GIANYAR, BALI",22,241,8,249
https://kawalpemilu.org#53517,"KEMENUH, SUKAWATI, GIANYAR, BALI",23,255,5,260
https://kawalpemilu.org#53517,"KEMENUH, SUKAWATI, GIANYAR, BALI",24,259,16,275
https://kawalpemilu.org#53517,"KEMENUH, SUKAWATI, GIANYAR, BALI",25,244,10,254
https://kawalpemilu.org#53517,"KEMENUH, SUKAWATI, GIANYAR, BALI",26,246,5,251
https://kawalpemilu.org#53517,"KEMENUH, SUKAWATI, GIANYAR, BALI",27,242,8,250
https://kawalpemilu.org#53517,"KEMENUH, SUKAWATI, GIANYAR, BALI",28,245,11,256
https://kawalpemilu.org#53518,"BATUBULAN KANGIN, SUKAWATI, GIANYAR, BALI",1,272,2,274
https://kawalpemilu.org#53518,"BATUBULAN KANGIN, SUKAWATI, GIANYAR, BALI",2,267,0,267
https://kawalpemilu.org#53518,"BATUBULAN KANGIN, SUKAWATI, GIANYAR, BALI",3,292,2,294
https://kawalpemilu.org#53518,"BATUBULAN KANGIN, SUKAWATI, GIANYAR, BALI",4,278,7,285
https://kawalpemilu.org#53518,"BATUBULAN KANGIN, SUKAWATI, GIANYAR, BALI",5,205,3,208
https://kawalpemilu.org#53518,"BATUBULAN KANGIN, SUKAWATI, GIANYAR, BALI",6,214,3,217
https://kawalpemilu.org#53518,"BATUBULAN KANGIN, SUKAWATI, GIANYAR, BALI",7,209,1,210
https://kawalpemilu.org#53518,"BATUBULAN KANGIN, SUKAWATI, GIANYAR, BALI",8,272,11,283
https://kawalpemilu.org#53518,"BATUBULAN KANGIN, SUKAWATI, GIANYAR, BALI",9,287,7,294
https://kawalpemilu.org#53518,"BATUBULAN KANGIN, SUKAWATI, GIANYAR, BALI",10,265,3,268
https://kawalpemilu.org#53518,"BATUBULAN KANGIN, SUKAWATI, GIANYAR, BALI",11,195,7,202
https://kawalpemilu.org#53518,"BATUBULAN KANGIN, SUKAWATI, GIANYAR, BALI",12,239,5,244
https://kawalpemilu.org#53518,"BATUBULAN KANGIN, SUKAWATI, GIANYAR, BALI",13,263,9,272
https://kawalpemilu.org#53518,"BATUBULAN KANGIN, SUKAWATI, GIANYAR, BALI",14,215,2,217
https://kawalpemilu.org#53518,"BATUBULAN KANGIN, SUKAWATI, GIANYAR, BALI",15,232,3,235
https://kawalpemilu.org#53518,"BATUBULAN KANGIN, SUKAWATI, GIANYAR, BALI",16,212,4,216
https://kawalpemilu.org#53518,"BATUBULAN KANGIN, SUKAWATI, GIANYAR, BALI",17,212,5,217
https://kawalpemilu.org#53518,"BATUBULAN KANGIN, SUKAWATI, GIANYAR, BALI",18,257,12,269
https://kawalpemilu.org#53518,"BATUBULAN KANGIN, SUKAWATI, GIANYAR, BALI",19,262,7,269
https://kawalpemilu.org#53518,"BATUBULAN KANGIN, SUKAWATI, GIANYAR, BALI",20,157,13,170
https://kawalpemilu.org#53518,"BATUBULAN KANGIN, SUKAWATI, GIANYAR, BALI",21,165,7,172
https://kawalpemilu.org#53518,"BATUBULAN KANGIN, SUKAWATI, GIANYAR, BALI",22,239,2,241
https://kawalpemilu.org#53518,"BATUBULAN KANGIN, SUKAWATI, GIANYAR, BALI",23,241,4,245
https://kawalpemilu.org#53518,"BATUBULAN KANGIN, SUKAWATI, GIANYAR, BALI",24,245,6,251
https://kawalpemilu.org#53518,"BATUBULAN KANGIN, SUKAWATI, GIANYAR, BALI",25,229,10,239
https://kawalpemilu.org#53518,"BATUBULAN KANGIN, SUKAWATI, GIANYAR, BALI",26,233,3,236
https://kawalpemilu.org#53519,"SINGAPADU TENGAH, SUKAWATI, GIANYAR, BALI",2,247,6,253
https://kawalpemilu.org#53519,"SINGAPADU TENGAH, SUKAWATI, GIANYAR, BALI",3,243,11,254
https://kawalpemilu.org#53519,"SINGAPADU TENGAH, SUKAWATI, GIANYAR, BALI",4,266,2,268
https://kawalpemilu.org#53519,"SINGAPADU TENGAH, SUKAWATI, GIANYAR, BALI",5,248,6,254
https://kawalpemilu.org#53519,"SINGAPADU TENGAH, SUKAWATI, GIANYAR, BALI",6,198,0,198
https://kawalpemilu.org#53519,"SINGAPADU TENGAH, SUKAWATI, GIANYAR, BALI",7,265,0,265
https://kawalpemilu.org#53519,"SINGAPADU TENGAH, SUKAWATI, GIANYAR, BALI",8,278,0,278
https://kawalpemilu.org#53519,"SINGAPADU TENGAH, SUKAWATI, GIANYAR, BALI",9,197,0,197
https://kawalpemilu.org#53519,"SINGAPADU TENGAH, SUKAWATI, GIANYAR, BALI",10,257,0,257
https://kawalpemilu.org#53519,"SINGAPADU TENGAH, SUKAWATI, GIANYAR, BALI",11,255,5,260
https://kawalpemilu.org#53519,"SINGAPADU TENGAH, SUKAWATI, GIANYAR, BALI",13,201,0,201
https://kawalpemilu.org#53519,"SINGAPADU TENGAH, SUKAWATI, GIANYAR, BALI",14,206,0,206
https://kawalpemilu.org#53520,"SINGAPADU KALER, SUKAWATI, GIANYAR, BALI",1,197,5,202
https://kawalpemilu.org#53520,"SINGAPADU KALER, SUKAWATI, GIANYAR, BALI",2,205,3,208
https://kawalpemilu.org#53520,"SINGAPADU KALER, SUKAWATI, GIANYAR, BALI",3,180,8,188
https://kawalpemilu.org#53520,"SINGAPADU KALER, SUKAWATI, GIANYAR, BALI",4,235,8,243
https://kawalpemilu.org#53520,"SINGAPADU KALER, SUKAWATI, GIANYAR, BALI",5,236,4,240
https://kawalpemilu.org#53520,"SINGAPADU KALER, SUKAWATI, GIANYAR, BALI",6,221,11,232
https://kawalpemilu.org#53520,"SINGAPADU KALER, SUKAWATI, GIANYAR, BALI",7,259,6,265
https://kawalpemilu.org#53520,"SINGAPADU KALER, SUKAWATI, GIANYAR, BALI",8,242,3,245
https://kawalpemilu.org#53520,"SINGAPADU KALER, SUKAWATI, GIANYAR, BALI",9,279,0,279
https://kawalpemilu.org#53520,"SINGAPADU KALER, SUKAWATI, GIANYAR, BALI",10,273,0,273
https://kawalpemilu.org#53520,"SINGAPADU KALER, SUKAWATI, GIANYAR, BALI",11,268,1,269
https://kawalpemilu.org#53520,"SINGAPADU KALER, SUKAWATI, GIANYAR, BALI",12,165,3,168
https://kawalpemilu.org#53520,"SINGAPADU KALER, SUKAWATI, GIANYAR, BALI",14,281,3,284
https://kawalpemilu.org#53520,"SINGAPADU KALER, SUKAWATI, GIANYAR, BALI",15,278,3,281
https://kawalpemilu.org#53520,"SINGAPADU KALER, SUKAWATI, GIANYAR, BALI",16,261,11,272
https://kawalpemilu.org#53520,"SINGAPADU KALER, SUKAWATI, GIANYAR, BALI",17,280,4,284
https://kawalpemilu.org#53520,"SINGAPADU KALER, SUKAWATI, GIANYAR, BALI",18,275,3,278
https://kawalpemilu.org#53521,"BATUAN KALER, SUKAWATI, GIANYAR, BALI",1,129,8,137
https://kawalpemilu.org#53521,"BATUAN KALER, SUKAWATI, GIANYAR, BALI",2,183,10,193
https://kawalpemilu.org#53521,"BATUAN KALER, SUKAWATI, GIANYAR, BALI",3,195,5,200
https://kawalpemilu.org#53521,"BATUAN KALER, SUKAWATI, GIANYAR, BALI",4,190,7,197
https://kawalpemilu.org#53521,"BATUAN KALER, SUKAWATI, GIANYAR, BALI",5,248,8,256
https://kawalpemilu.org#53521,"BATUAN KALER, SUKAWATI, GIANYAR, BALI",6,234,3,237
https://kawalpemilu.org#53521,"BATUAN KALER, SUKAWATI, GIANYAR, BALI",7,208,17,225
https://kawalpemilu.org#53521,"BATUAN KALER, SUKAWATI, GIANYAR, BALI",8,220,4,224
https://kawalpemilu.org#53521,"BATUAN KALER, SUKAWATI, GIANYAR, BALI",9,207,2,209
https://kawalpemilu.org#53521,"BATUAN KALER, SUKAWATI, GIANYAR, BALI",10,220,7,227
https://kawalpemilu.org#53521,"BATUAN KALER, SUKAWATI, GIANYAR, BALI",11,210,4,214
https://kawalpemilu.org#53523,"SABA, BLAHBATUH, GIANYAR, BALI",1,270,8,278
https://kawalpemilu.org#53523,"SABA, BLAHBATUH, GIANYAR, BALI",2,255,8,263
https://kawalpemilu.org#53523,"SABA, BLAHBATUH, GIANYAR, BALI",3,249,10,259
https://kawalpemilu.org#53523,"SABA, BLAHBATUH, GIANYAR, BALI",4,258,4,262
https://kawalpemilu.org#53523,"SABA, BLAHBATUH, GIANYAR, BALI",5,246,7,253
https://kawalpemilu.org#53523,"SABA, BLAHBATUH, GIANYAR, BALI",6,250,1,251
https://kawalpemilu.org#53523,"SABA, BLAHBATUH, GIANYAR, BALI",7,253,3,265
https://kawalpemilu.org#53523,"SABA, BLAHBATUH, GIANYAR, BALI",8,241,1,242
https://kawalpemilu.org#53523,"SABA, BLAHBATUH, GIANYAR, BALI",9,175,11,186
https://kawalpemilu.org#53523,"SABA, BLAHBATUH, GIANYAR, BALI",10,160,12,172
https://kawalpemilu.org#53523,"SABA, BLAHBATUH, GIANYAR, BALI",11,182,2,184
https://kawalpemilu.org#53523,"SABA, BLAHBATUH, GIANYAR, BALI",12,171,1,172
https://kawalpemilu.org#53523,"SABA, BLAHBATUH, GIANYAR, BALI",13,185,4,189
https://kawalpemilu.org#53523,"SABA, BLAHBATUH, GIANYAR, BALI",14,181,0,181
https://kawalpemilu.org#53523,"SABA, BLAHBATUH, GIANYAR, BALI",15,245,18,263
https://kawalpemilu.org#53523,"SABA, BLAHBATUH, GIANYAR, BALI",16,234,15,249
https://kawalpemilu.org#53523,"SABA, BLAHBATUH, GIANYAR, BALI",17,218,9,227
https://kawalpemilu.org#53523,"SABA, BLAHBATUH, GIANYAR, BALI",18,246,21,267
https://kawalpemilu.org#53523,"SABA, BLAHBATUH, GIANYAR, BALI",19,241,16,257
https://kawalpemilu.org#53523,"SABA, BLAHBATUH, GIANYAR, BALI",20,213,3,216
https://kawalpemilu.org#53523,"SABA, BLAHBATUH, GIANYAR, BALI",21,207,0,2
https://kawalpemilu.org#53523,"SABA, BLAHBATUH, GIANYAR, BALI",22,181,7,188
https://kawalpemilu.org#53523,"SABA, BLAHBATUH, GIANYAR, BALI",23,249,9,258
https://kawalpemilu.org#53523,"SABA, BLAHBATUH, GIANYAR, BALI",24,199,17,216
https://kawalpemilu.org#53523,"SABA, BLAHBATUH, GIANYAR, BALI",25,232,19,251
https://kawalpemilu.org#53523,"SABA, BLAHBATUH, GIANYAR, BALI",26,208,19,227
https://kawalpemilu.org#53523,"SABA, BLAHBATUH, GIANYAR, BALI",27,235,15,250
https://kawalpemilu.org#53524,"PERING, BLAHBATUH, GIANYAR, BALI",1,270,4,274
https://kawalpemilu.org#53524,"PERING, BLAHBATUH, GIANYAR, BALI",2,273,7,280
https://kawalpemilu.org#53524,"PERING, BLAHBATUH, GIANYAR, BALI",3,247,8,255
https://kawalpemilu.org#53524,"PERING, BLAHBATUH, GIANYAR, BALI",4,226,8,234
https://kawalpemilu.org#53524,"PERING, BLAHBATUH, GIANYAR, BALI",5,225,9,234
https://kawalpemilu.org#53524,"PERING, BLAHBATUH, GIANYAR, BALI",6,218,11,229
https://kawalpemilu.org#53524,"PERING, BLAHBATUH, GIANYAR, BALI",7,197,41,238
https://kawalpemilu.org#53524,"PERING, BLAHBATUH, GIANYAR, BALI",8,217,9,226
https://kawalpemilu.org#53524,"PERING, BLAHBATUH, GIANYAR, BALI",9,198,32,230
https://kawalpemilu.org#53524,"PERING, BLAHBATUH, GIANYAR, BALI",10,232,9,241
https://kawalpemilu.org#53524,"PERING, BLAHBATUH, GIANYAR, BALI",11,199,26,225
https://kawalpemilu.org#53524,"PERING, BLAHBATUH, GIANYAR, BALI",12,199,14,213
https://kawalpemilu.org#53524,"PERING, BLAHBATUH, GIANYAR, BALI",13,177,18,195
https://kawalpemilu.org#53524,"PERING, BLAHBATUH, GIANYAR, BALI",14,199,20,219
https://kawalpemilu.org#53524,"PERING, BLAHBATUH, GIANYAR, BALI",15,145,10,155
https://kawalpemilu.org#53524,"PERING, BLAHBATUH, GIANYAR, BALI",16,171,19,190
https://kawalpemilu.org#53524,"PERING, BLAHBATUH, GIANYAR, BALI",17,219,21,240
https://kawalpemilu.org#53524,"PERING, BLAHBATUH, GIANYAR, BALI",18,232,17,249
https://kawalpemilu.org#53524,"PERING, BLAHBATUH, GIANYAR, BALI",19,195,28,223
https://kawalpemilu.org#53524,"PERING, BLAHBATUH, GIANYAR, BALI",20,190,29,219
https://kawalpemilu.org#53524,"PERING, BLAHBATUH, GIANYAR, BALI",21,95,29,124
https://kawalpemilu.org#53524,"PERING, BLAHBATUH, GIANYAR, BALI",22,154,14,168
https://kawalpemilu.org#53524,"PERING, BLAHBATUH, GIANYAR, BALI",23,225,7,232
https://kawalpemilu.org#53524,"PERING, BLAHBATUH, GIANYAR, BALI",24,234,3,237
https://kawalpemilu.org#53524,"PERING, BLAHBATUH, GIANYAR, BALI",25,231,2,233
https://kawalpemilu.org#53524,"PERING, BLAHBATUH, GIANYAR, BALI",26,215,8,223
https://kawalpemilu.org#53525,"KERAMAS, BLAHBATUH, GIANYAR, BALI",1,199,14,213
https://kawalpemilu.org#53525,"KERAMAS, BLAHBATUH, GIANYAR, BALI",2,221,11,232
https://kawalpemilu.org#53525,"KERAMAS, BLAHBATUH, GIANYAR, BALI",3,222,12,234
https://kawalpemilu.org#53525,"KERAMAS, BLAHBATUH, GIANYAR, BALI",4,181,22,203
https://kawalpemilu.org#53525,"KERAMAS, BLAHBATUH, GIANYAR, BALI",5,183,7,190
https://kawalpemilu.org#53525,"KERAMAS, BLAHBATUH, GIANYAR, BALI",6,212,17,229
https://kawalpemilu.org#53525,"KERAMAS, BLAHBATUH, GIANYAR, BALI",7,213,13,226
https://kawalpemilu.org#53525,"KERAMAS, BLAHBATUH, GIANYAR, BALI",8,189,22,211
https://kawalpemilu.org#53525,"KERAMAS, BLAHBATUH, GIANYAR, BALI",9,217,7,224
https://kawalpemilu.org#53525,"KERAMAS, BLAHBATUH, GIANYAR, BALI",10,195,3,198
https://kawalpemilu.org#53525,"KERAMAS, BLAHBATUH, GIANYAR, BALI",11,223,4,227
https://kawalpemilu.org#53525,"KERAMAS, BLAHBATUH, GIANYAR, BALI",12,183,11,194
https://kawalpemilu.org#53525,"KERAMAS, BLAHBATUH, GIANYAR, BALI",13,192,6,198
https://kawalpemilu.org#53525,"KERAMAS, BLAHBATUH, GIANYAR, BALI",14,208,6,214
https://kawalpemilu.org#53525,"KERAMAS, BLAHBATUH, GIANYAR, BALI",15,190,10,197
https://kawalpemilu.org#53525,"KERAMAS, BLAHBATUH, GIANYAR, BALI",18,169,5,174
https://kawalpemilu.org#53525,"KERAMAS, BLAHBATUH, GIANYAR, BALI",19,206,30,236
https://kawalpemilu.org#53525,"KERAMAS, BLAHBATUH, GIANYAR, BALI",20,206,17,223
https://kawalpemilu.org#53525,"KERAMAS, BLAHBATUH, GIANYAR, BALI",21,211,18,229
https://kawalpemilu.org#53525,"KERAMAS, BLAHBATUH, GIANYAR, BALI",22,199,4,203
https://kawalpemilu.org#53525,"KERAMAS, BLAHBATUH, GIANYAR, BALI",23,208,6,214
https://kawalpemilu.org#53525,"KERAMAS, BLAHBATUH, GIANYAR, BALI",24,232,8,240
https://kawalpemilu.org#53525,"KERAMAS, BLAHBATUH, GIANYAR, BALI",25,187,16,203
https://kawalpemilu.org#53525,"KERAMAS, BLAHBATUH, GIANYAR, BALI",26,190,10,200
https://kawalpemilu.org#53525,"KERAMAS, BLAHBATUH, GIANYAR, BALI",27,184,6,190
https://kawalpemilu.org#53526,"BELEGA, BLAHBATUH, GIANYAR, BALI",1,238,5,243
https://kawalpemilu.org#53526,"BELEGA, BLAHBATUH, GIANYAR, BALI",2,222,7,229
https://kawalpemilu.org#53526,"BELEGA, BLAHBATUH, GIANYAR, BALI",3,227,4,231
https://kawalpemilu.org#53526,"BELEGA, BLAHBATUH, GIANYAR, BALI",4,216,5,221
https://kawalpemilu.org#53526,"BELEGA, BLAHBATUH, GIANYAR, BALI",5,225,5,230
https://kawalpemilu.org#53526,"BELEGA, BLAHBATUH, GIANYAR, BALI",6,211,8,219
https://kawalpemilu.org#53526,"BELEGA, BLAHBATUH, GIANYAR, BALI",7,238,7,245
https://kawalpemilu.org#53526,"BELEGA, BLAHBATUH, GIANYAR, BALI",8,222,9,231
https://kawalpemilu.org#53526,"BELEGA, BLAHBATUH, GIANYAR, BALI",9,211,4,215
https://kawalpemilu.org#53526,"BELEGA, BLAHBATUH, GIANYAR, BALI",10,234,4,238
https://kawalpemilu.org#53526,"BELEGA, BLAHBATUH, GIANYAR, BALI",11,206,2,208
https://kawalpemilu.org#53526,"BELEGA, BLAHBATUH, GIANYAR, BALI",12,187,2,189
https://kawalpemilu.org#53526,"BELEGA, BLAHBATUH, GIANYAR, BALI",13,171,26,197
https://kawalpemilu.org#53526,"BELEGA, BLAHBATUH, GIANYAR, BALI",14,207,9,216
https://kawalpemilu.org#53526,"BELEGA, BLAHBATUH, GIANYAR, BALI",15,187,26,213
https://kawalpemilu.org#53527,"BLAHBATUH, BLAHBATUH, GIANYAR, BALI",1,172,6,178
https://kawalpemilu.org#53527,"BLAHBATUH, BLAHBATUH, GIANYAR, BALI",2,153,5,158
https://kawalpemilu.org#53527,"BLAHBATUH, BLAHBATUH, GIANYAR, BALI",3,171,7,178
https://kawalpemilu.org#53527,"BLAHBATUH, BLAHBATUH, GIANYAR, BALI",4,231,2,233
https://kawalpemilu.org#53527,"BLAHBATUH, BLAHBATUH, GIANYAR, BALI",5,224,4,228
https://kawalpemilu.org#53527,"BLAHBATUH, BLAHBATUH, GIANYAR, BALI",6,187,7,194
https://kawalpemilu.org#53527,"BLAHBATUH, BLAHBATUH, GIANYAR, BALI",7,192,2,194
https://kawalpemilu.org#53527,"BLAHBATUH, BLAHBATUH, GIANYAR, BALI",8,177,8,185
https://kawalpemilu.org#53527,"BLAHBATUH, BLAHBATUH, GIANYAR, BALI",9,187,14,201
https://kawalpemilu.org#53527,"BLAHBATUH, BLAHBATUH, GIANYAR, BALI",10,177,10,187
https://kawalpemilu.org#53527,"BLAHBATUH, BLAHBATUH, GIANYAR, BALI",11,214,11,225
https://kawalpemilu.org#53527,"BLAHBATUH, BLAHBATUH, GIANYAR, BALI",12,208,16,224
https://kawalpemilu.org#53527,"BLAHBATUH, BLAHBATUH, GIANYAR, BALI",13,185,10,195
https://kawalpemilu.org#53527,"BLAHBATUH, BLAHBATUH, GIANYAR, BALI",14,179,10,189
https://kawalpemilu.org#53527,"BLAHBATUH, BLAHBATUH, GIANYAR, BALI",15,211,11,222
https://kawalpemilu.org#53527,"BLAHBATUH, BLAHBATUH, GIANYAR, BALI",16,175,13,188
https://kawalpemilu.org#53527,"BLAHBATUH, BLAHBATUH, GIANYAR, BALI",17,202,8,210
https://kawalpemilu.org#53527,"BLAHBATUH, BLAHBATUH, GIANYAR, BALI",18,194,9,203
https://kawalpemilu.org#53527,"BLAHBATUH, BLAHBATUH, GIANYAR, BALI",19,199,7,206
https://kawalpemilu.org#53527,"BLAHBATUH, BLAHBATUH, GIANYAR, BALI",20,194,21,215
https://kawalpemilu.org#53527,"BLAHBATUH, BLAHBATUH, GIANYAR, BALI",21,200,7,207
https://kawalpemilu.org#53527,"BLAHBATUH, BLAHBATUH, GIANYAR, BALI",22,211,2,213
https://kawalpemilu.org#53527,"BLAHBATUH, BLAHBATUH, GIANYAR, BALI",23,213,5,218
https://kawalpemilu.org#53527,"BLAHBATUH, BLAHBATUH, GIANYAR, BALI",24,201,3,204
https://kawalpemilu.org#53527,"BLAHBATUH, BLAHBATUH, GIANYAR, BALI",25,199,9,208
https://kawalpemilu.org#53527,"BLAHBATUH, BLAHBATUH, GIANYAR, BALI",26,203,8,211
https://kawalpemilu.org#53527,"BLAHBATUH, BLAHBATUH, GIANYAR, BALI",27,197,10,207
https://kawalpemilu.org#53527,"BLAHBATUH, BLAHBATUH, GIANYAR, BALI",28,227,9,236
https://kawalpemilu.org#53527,"BLAHBATUH, BLAHBATUH, GIANYAR, BALI",29,187,4,191
https://kawalpemilu.org#53527,"BLAHBATUH, BLAHBATUH, GIANYAR, BALI",30,179,2,181
https://kawalpemilu.org#53527,"BLAHBATUH, BLAHBATUH, GIANYAR, BALI",31,182,28,210
https://kawalpemilu.org#53527,"BLAHBATUH, BLAHBATUH, GIANYAR, BALI",32,177,32,209
https://kawalpemilu.org#53527,"BLAHBATUH, BLAHBATUH, GIANYAR, BALI",33,143,5,148
https://kawalpemilu.org#53528,"BURUAN, BLAHBATUH, GIANYAR, BALI",1,184,8,192
https://kawalpemilu.org#53528,"BURUAN, BLAHBATUH, GIANYAR, BALI",2,146,2,148
https://kawalpemilu.org#53528,"BURUAN, BLAHBATUH, GIANYAR, BALI",3,144,3,147
https://kawalpemilu.org#53528,"BURUAN, BLAHBATUH, GIANYAR, BALI",4,224,18,242
https://kawalpemilu.org#53528,"BURUAN, BLAHBATUH, GIANYAR, BALI",5,238,24,262
https://kawalpemilu.org#53528,"BURUAN, BLAHBATUH, GIANYAR, BALI",6,234,9,243
https://kawalpemilu.org#53528,"BURUAN, BLAHBATUH, GIANYAR, BALI",7,234,12,246
https://kawalpemilu.org#53528,"BURUAN, BLAHBATUH, GIANYAR, BALI",8,238,11,249
https://kawalpemilu.org#53528,"BURUAN, BLAHBATUH, GIANYAR, BALI",9,228,15,243
https://kawalpemilu.org#53528,"BURUAN, BLAHBATUH, GIANYAR, BALI",10,256,9,265
https://kawalpemilu.org#53528,"BURUAN, BLAHBATUH, GIANYAR, BALI",11,238,9,247
https://kawalpemilu.org#53528,"BURUAN, BLAHBATUH, GIANYAR, BALI",12,218,22,240
https://kawalpemilu.org#53528,"BURUAN, BLAHBATUH, GIANYAR, BALI",13,263,1,264
https://kawalpemilu.org#53528,"BURUAN, BLAHBATUH, GIANYAR, BALI",14,259,4,263
https://kawalpemilu.org#53528,"BURUAN, BLAHBATUH, GIANYAR, BALI",15,268,1,269
https://kawalpemilu.org#53528,"BURUAN, BLAHBATUH, GIANYAR, BALI",16,209,13,222
https://kawalpemilu.org#53528,"BURUAN, BLAHBATUH, GIANYAR, BALI",17,193,14,207
https://kawalpemilu.org#53528,"BURUAN, BLAHBATUH, GIANYAR, BALI",18,136,4,140
https://kawalpemilu.org#53528,"BURUAN, BLAHBATUH, GIANYAR, BALI",20,173,14,187
https://kawalpemilu.org#53528,"BURUAN, BLAHBATUH, GIANYAR, BALI",21,157,17,174
https://kawalpemilu.org#53529,"BEDULU, BLAHBATUH, GIANYAR, BALI",1,71,93,164
https://kawalpemilu.org#53529,"BEDULU, BLAHBATUH, GIANYAR, BALI",2,167,47,214
https://kawalpemilu.org#53529,"BEDULU, BLAHBATUH, GIANYAR, BALI",3,159,32,191
https://kawalpemilu.org#53529,"BEDULU, BLAHBATUH, GIANYAR, BALI",4,79,75,154
https://kawalpemilu.org#53529,"BEDULU, BLAHBATUH, GIANYAR, BALI",5,233,3,236
https://kawalpemilu.org#53529,"BEDULU, BLAHBATUH, GIANYAR, BALI",6,226,7,233
https://kawalpemilu.org#53529,"BEDULU, BLAHBATUH, GIANYAR, BALI",7,247,2,249
https://kawalpemilu.org#53529,"BEDULU, BLAHBATUH, GIANYAR, BALI",8,239,4,243
https://kawalpemilu.org#53529,"BEDULU, BLAHBATUH, GIANYAR, BALI",9,211,14,225
https://kawalpemilu.org#53529,"BEDULU, BLAHBATUH, GIANYAR, BALI",10,244,2,246
https://kawalpemilu.org#53529,"BEDULU, BLAHBATUH, GIANYAR, BALI",11,217,11,228
https://kawalpemilu.org#53529,"BEDULU, BLAHBATUH, GIANYAR, BALI",12,202,4,206
https://kawalpemilu.org#53529,"BEDULU, BLAHBATUH, GIANYAR, BALI",13,192,4,196
https://kawalpemilu.org#53529,"BEDULU, BLAHBATUH, GIANYAR, BALI",14,189,1,190
https://kawalpemilu.org#53529,"BEDULU, BLAHBATUH, GIANYAR, BALI",15,205,4,209
https://kawalpemilu.org#53529,"BEDULU, BLAHBATUH, GIANYAR, BALI",16,188,19,207
https://kawalpemilu.org#53529,"BEDULU, BLAHBATUH, GIANYAR, BALI",17,203,8,211
https://kawalpemilu.org#53529,"BEDULU, BLAHBATUH, GIANYAR, BALI",18,204,6,210
https://kawalpemilu.org#53529,"BEDULU, BLAHBATUH, GIANYAR, BALI",19,211,10,221
https://kawalpemilu.org#53529,"BEDULU, BLAHBATUH, GIANYAR, BALI",20,222,17,239
https://kawalpemilu.org#53529,"BEDULU, BLAHBATUH, GIANYAR, BALI",21,201,11,212
https://kawalpemilu.org#53529,"BEDULU, BLAHBATUH, GIANYAR, BALI",22,183,9,192
https://kawalpemilu.org#53529,"BEDULU, BLAHBATUH, GIANYAR, BALI",23,239,13,252
https://kawalpemilu.org#53529,"BEDULU, BLAHBATUH, GIANYAR, BALI",24,238,13,251
https://kawalpemilu.org#53529,"BEDULU, BLAHBATUH, GIANYAR, BALI",25,212,3,215
https://kawalpemilu.org#53529,"BEDULU, BLAHBATUH, GIANYAR, BALI",26,195,7,202
https://kawalpemilu.org#53529,"BEDULU, BLAHBATUH, GIANYAR, BALI",27,235,12,247
https://kawalpemilu.org#53529,"BEDULU, BLAHBATUH, GIANYAR, BALI",28,251,4,255
https://kawalpemilu.org#53529,"BEDULU, BLAHBATUH, GIANYAR, BALI",29,231,6,237
https://kawalpemilu.org#53529,"BEDULU, BLAHBATUH, GIANYAR, BALI",30,212,9,221
https://kawalpemilu.org#53529,"BEDULU, BLAHBATUH, GIANYAR, BALI",31,233,6,239
https://kawalpemilu.org#53529,"BEDULU, BLAHBATUH, GIANYAR, BALI",32,172,6,178
https://kawalpemilu.org#53529,"BEDULU, BLAHBATUH, GIANYAR, BALI",33,176,11,187
https://kawalpemilu.org#53530,"MEDAHAN, BLAHBATUH, GIANYAR, BALI",1,218,14,232
https://kawalpemilu.org#53530,"MEDAHAN, BLAHBATUH, GIANYAR, BALI",2,224,10,234
https://kawalpemilu.org#53530,"MEDAHAN, BLAHBATUH, GIANYAR, BALI",3,195,18,213
https://kawalpemilu.org#53530,"MEDAHAN, BLAHBATUH, GIANYAR, BALI",4,220,7,227
https://kawalpemilu.org#53530,"MEDAHAN, BLAHBATUH, GIANYAR, BALI",5,220,15,235
https://kawalpemilu.org#53530,"MEDAHAN, BLAHBATUH, GIANYAR, BALI",6,211,10,221
https://kawalpemilu.org#53530,"MEDAHAN, BLAHBATUH, GIANYAR, BALI",7,216,9,225
https://kawalpemilu.org#53530,"MEDAHAN, BLAHBATUH, GIANYAR, BALI",8,229,7,236
https://kawalpemilu.org#53530,"MEDAHAN, BLAHBATUH, GIANYAR, BALI",9,211,9,220
https://kawalpemilu.org#53530,"MEDAHAN, BLAHBATUH, GIANYAR, BALI",10,177,18,195
https://kawalpemilu.org#53530,"MEDAHAN, BLAHBATUH, GIANYAR, BALI",11,217,9,226
https://kawalpemilu.org#53530,"MEDAHAN, BLAHBATUH, GIANYAR, BALI",12,214,8,222
https://kawalpemilu.org#53530,"MEDAHAN, BLAHBATUH, GIANYAR, BALI",13,197,11,208
https://kawalpemilu.org#53530,"MEDAHAN, BLAHBATUH, GIANYAR, BALI",14,189,14,203
https://kawalpemilu.org#53530,"MEDAHAN, BLAHBATUH, GIANYAR, BALI",15,211,7,218
https://kawalpemilu.org#53530,"MEDAHAN, BLAHBATUH, GIANYAR, BALI",16,195,10,205
https://kawalpemilu.org#53530,"MEDAHAN, BLAHBATUH, GIANYAR, BALI",17,128,9,137
https://kawalpemilu.org#53531,"BONA, BLAHBATUH, GIANYAR, BALI",1,254,12,266
https://kawalpemilu.org#53531,"BONA, BLAHBATUH, GIANYAR, BALI",2,273,8,281
https://kawalpemilu.org#53531,"BONA, BLAHBATUH, GIANYAR, BALI",3,250,15,265
https://kawalpemilu.org#53531,"BONA, BLAHBATUH, GIANYAR, BALI",4,255,16,271
https://kawalpemilu.org#53531,"BONA, BLAHBATUH, GIANYAR, BALI",5,264,5,269
https://kawalpemilu.org#53531,"BONA, BLAHBATUH, GIANYAR, BALI",6,256,2,258
https://kawalpemilu.org#53531,"BONA, BLAHBATUH, GIANYAR, BALI",7,246,24,270
https://kawalpemilu.org#53531,"BONA, BLAHBATUH, GIANYAR, BALI",8,239,15,254
https://kawalpemilu.org#53531,"BONA, BLAHBATUH, GIANYAR, BALI",9,228,11,239
https://kawalpemilu.org#53531,"BONA, BLAHBATUH, GIANYAR, BALI",10,222,15,237
https://kawalpemilu.org#53531,"BONA, BLAHBATUH, GIANYAR, BALI",11,286,1,287
https://kawalpemilu.org#53531,"BONA, BLAHBATUH, GIANYAR, BALI",12,271,1,272
https://kawalpemilu.org#53533,"SAMPLANGAN, GIANYAR, GIANYAR, BALI",1,248,7,255
https://kawalpemilu.org#53533,"SAMPLANGAN, GIANYAR, GIANYAR, BALI",2,252,14,266
https://kawalpemilu.org#53533,"SAMPLANGAN, GIANYAR, GIANYAR, BALI",3,222,18,240
https://kawalpemilu.org#53533,"SAMPLANGAN, GIANYAR, GIANYAR, BALI",4,228,20,248
https://kawalpemilu.org#53533,"SAMPLANGAN, GIANYAR, GIANYAR, BALI",5,204,21,225
https://kawalpemilu.org#53533,"SAMPLANGAN, GIANYAR, GIANYAR, BALI",6,226,19,245
https://kawalpemilu.org#53533,"SAMPLANGAN, GIANYAR, GIANYAR, BALI",7,219,16,235
https://kawalpemilu.org#53533,"SAMPLANGAN, GIANYAR, GIANYAR, BALI",8,217,18,235
https://kawalpemilu.org#53533,"SAMPLANGAN, GIANYAR, GIANYAR, BALI",9,194,20,214
https://kawalpemilu.org#53533,"SAMPLANGAN, GIANYAR, GIANYAR, BALI",10,185,16,199
https://kawalpemilu.org#53533,"SAMPLANGAN, GIANYAR, GIANYAR, BALI",11,181,19,200
https://kawalpemilu.org#53533,"SAMPLANGAN, GIANYAR, GIANYAR, BALI",12,188,13,201
https://kawalpemilu.org#53533,"SAMPLANGAN, GIANYAR, GIANYAR, BALI",13,160,9,169
https://kawalpemilu.org#53533,"SAMPLANGAN, GIANYAR, GIANYAR, BALI",14,208,2,210
https://kawalpemilu.org#53533,"SAMPLANGAN, GIANYAR, GIANYAR, BALI",15,187,5,192
https://kawalpemilu.org#53533,"SAMPLANGAN, GIANYAR, GIANYAR, BALI",16,139,11,150
https://kawalpemilu.org#53534,"ABIANBASE, GIANYAR, GIANYAR, BALI",1,212,7,219
https://kawalpemilu.org#53534,"ABIANBASE, GIANYAR, GIANYAR, BALI",2,208,4,212
https://kawalpemilu.org#53534,"ABIANBASE, GIANYAR, GIANYAR, BALI",3,199,5,204
https://kawalpemilu.org#53534,"ABIANBASE, GIANYAR, GIANYAR, BALI",4,171,11,182
https://kawalpemilu.org#53534,"ABIANBASE, GIANYAR, GIANYAR, BALI",5,156,19,175
https://kawalpemilu.org#53534,"ABIANBASE, GIANYAR, GIANYAR, BALI",6,144,14,158
https://kawalpemilu.org#53534,"ABIANBASE, GIANYAR, GIANYAR, BALI",7,188,10,198
https://kawalpemilu.org#53534,"ABIANBASE, GIANYAR, GIANYAR, BALI",8,184,7,191
https://kawalpemilu.org#53534,"ABIANBASE, GIANYAR, GIANYAR, BALI",9,188,4,192
https://kawalpemilu.org#53534,"ABIANBASE, GIANYAR, GIANYAR, BALI",10,208,10,218
https://kawalpemilu.org#53534,"ABIANBASE, GIANYAR, GIANYAR, BALI",11,179,18,197
https://kawalpemilu.org#53534,"ABIANBASE, GIANYAR, GIANYAR, BALI",12,235,12,247
https://kawalpemilu.org#53534,"ABIANBASE, GIANYAR, GIANYAR, BALI",13,230,14,244
https://kawalpemilu.org#53534,"ABIANBASE, GIANYAR, GIANYAR, BALI",14,231,7,238
https://kawalpemilu.org#53534,"ABIANBASE, GIANYAR, GIANYAR, BALI",15,214,10,224
https://kawalpemilu.org#53534,"ABIANBASE, GIANYAR, GIANYAR, BALI",16,206,18,224
https://kawalpemilu.org#53534,"ABIANBASE, GIANYAR, GIANYAR, BALI",17,214,8,222
https://kawalpemilu.org#53534,"ABIANBASE, GIANYAR, GIANYAR, BALI",18,191,11,202
https://kawalpemilu.org#53534,"ABIANBASE, GIANYAR, GIANYAR, BALI",19,194,12,206
https://kawalpemilu.org#53534,"ABIANBASE, GIANYAR, GIANYAR, BALI",20,193,12,205
https://kawalpemilu.org#53535,"GIANYAR, GIANYAR, GIANYAR, BALI",1,162,20,182
https://kawalpemilu.org#53535,"GIANYAR, GIANYAR, GIANYAR, BALI",2,187,20,207
https://kawalpemilu.org#53535,"GIANYAR, GIANYAR, GIANYAR, BALI",3,189,20,209
https://kawalpemilu.org#53535,"GIANYAR, GIANYAR, GIANYAR, BALI",4,166,30,196
https://kawalpemilu.org#53535,"GIANYAR, GIANYAR, GIANYAR, BALI",5,177,20,197
https://kawalpemilu.org#53535,"GIANYAR, GIANYAR, GIANYAR, BALI",6,207,23,230
https://kawalpemilu.org#53535,"GIANYAR, GIANYAR, GIANYAR, BALI",7,186,12,198
https://kawalpemilu.org#53535,"GIANYAR, GIANYAR, GIANYAR, BALI",8,189,21,210
https://kawalpemilu.org#53535,"GIANYAR, GIANYAR, GIANYAR, BALI",9,194,7,201
https://kawalpemilu.org#53535,"GIANYAR, GIANYAR, GIANYAR, BALI",10,169,14,183
https://kawalpemilu.org#53535,"GIANYAR, GIANYAR, GIANYAR, BALI",11,181,11,192
https://kawalpemilu.org#53535,"GIANYAR, GIANYAR, GIANYAR, BALI",12,128,82,210
https://kawalpemilu.org#53535,"GIANYAR, GIANYAR, GIANYAR, BALI",13,203,25,228
https://kawalpemilu.org#53535,"GIANYAR, GIANYAR, GIANYAR, BALI",14,210,21,231
https://kawalpemilu.org#53535,"GIANYAR, GIANYAR, GIANYAR, BALI",15,201,26,227
https://kawalpemilu.org#53535,"GIANYAR, GIANYAR, GIANYAR, BALI",16,208,18,226
https://kawalpemilu.org#53535,"GIANYAR, GIANYAR, GIANYAR, BALI",17,217,10,227
https://kawalpemilu.org#53535,"GIANYAR, GIANYAR, GIANYAR, BALI",18,222,6,228
https://kawalpemilu.org#53535,"GIANYAR, GIANYAR, GIANYAR, BALI",19,230,2,232
https://kawalpemilu.org#53535,"GIANYAR, GIANYAR, GIANYAR, BALI",20,230,3,233
https://kawalpemilu.org#53535,"GIANYAR, GIANYAR, GIANYAR, BALI",21,170,10,180
https://kawalpemilu.org#53535,"GIANYAR, GIANYAR, GIANYAR, BALI",22,202,9,211
https://kawalpemilu.org#53535,"GIANYAR, GIANYAR, GIANYAR, BALI",23,210,20,230
https://kawalpemilu.org#53535,"GIANYAR, GIANYAR, GIANYAR, BALI",24,178,17,195
https://kawalpemilu.org#53535,"GIANYAR, GIANYAR, GIANYAR, BALI",25,210,13,223
https://kawalpemilu.org#53535,"GIANYAR, GIANYAR, GIANYAR, BALI",26,191,7,198
https://kawalpemilu.org#53535,"GIANYAR, GIANYAR, GIANYAR, BALI",27,205,9,214
https://kawalpemilu.org#53535,"GIANYAR, GIANYAR, GIANYAR, BALI",28,197,31,228
https://kawalpemilu.org#53535,"GIANYAR, GIANYAR, GIANYAR, BALI",29,189,41,230
https://kawalpemilu.org#53535,"GIANYAR, GIANYAR, GIANYAR, BALI",30,157,31,188
https://kawalpemilu.org#53535,"GIANYAR, GIANYAR, GIANYAR, BALI",31,176,23,199
https://kawalpemilu.org#53535,"GIANYAR, GIANYAR, GIANYAR, BALI",32,192,43,235
https://kawalpemilu.org#53535,"GIANYAR, GIANYAR, GIANYAR, BALI",33,204,40,244
https://kawalpemilu.org#53535,"GIANYAR, GIANYAR, GIANYAR, BALI",34,157,48,205
https://kawalpemilu.org#53535,"GIANYAR, GIANYAR, GIANYAR, BALI",35,174,29,203
https://kawalpemilu.org#53535,"GIANYAR, GIANYAR, GIANYAR, BALI",36,144,36,180
https://kawalpemilu.org#53535,"GIANYAR, GIANYAR, GIANYAR, BALI",37,134,22,156
https://kawalpemilu.org#53535,"GIANYAR, GIANYAR, GIANYAR, BALI",38,25,20,45
https://kawalpemilu.org#53536,"BITERA, GIANYAR, GIANYAR, BALI",1,236,9,245
https://kawalpemilu.org#53536,"BITERA, GIANYAR, GIANYAR, BALI",2,224,20,244
https://kawalpemilu.org#53536,"BITERA, GIANYAR, GIANYAR, BALI",3,225,7,232
https://kawalpemilu.org#53536,"BITERA, GIANYAR, GIANYAR, BALI",4,239,15,254
https://kawalpemilu.org#53536,"BITERA, GIANYAR, GIANYAR, BALI",5,245,9,254
https://kawalpemilu.org#53536,"BITERA, GIANYAR, GIANYAR, BALI",6,225,21,246
https://kawalpemilu.org#53536,"BITERA, GIANYAR, GIANYAR, BALI",7,249,3,252
https://kawalpemilu.org#53536,"BITERA, GIANYAR, GIANYAR, BALI",8,194,23,217
https://kawalpemilu.org#53536,"BITERA, GIANYAR, GIANYAR, BALI",9,180,30,210
https://kawalpemilu.org#53536,"BITERA, GIANYAR, GIANYAR, BALI",10,174,17,191
https://kawalpemilu.org#53536,"BITERA, GIANYAR, GIANYAR, BALI",11,193,22,215
https://kawalpemilu.org#53536,"BITERA, GIANYAR, GIANYAR, BALI",12,209,8,217
https://kawalpemilu.org#53536,"BITERA, GIANYAR, GIANYAR, BALI",13,199,6,205
https://kawalpemilu.org#53536,"BITERA, GIANYAR, GIANYAR, BALI",14,232,13,245
https://kawalpemilu.org#53536,"BITERA, GIANYAR, GIANYAR, BALI",15,217,21,238
https://kawalpemilu.org#53536,"BITERA, GIANYAR, GIANYAR, BALI",16,191,12,203
https://kawalpemilu.org#53536,"BITERA, GIANYAR, GIANYAR, BALI",17,202,12,214
https://kawalpemilu.org#53536,"BITERA, GIANYAR, GIANYAR, BALI",18,205,10,215
https://kawalpemilu.org#53536,"BITERA, GIANYAR, GIANYAR, BALI",19,173,18,191
https://kawalpemilu.org#53536,"BITERA, GIANYAR, GIANYAR, BALI",20,201,6,207
https://kawalpemilu.org#53536,"BITERA, GIANYAR, GIANYAR, BALI",21,186,10,196
https://kawalpemilu.org#53536,"BITERA, GIANYAR, GIANYAR, BALI",22,190,16,206
https://kawalpemilu.org#53536,"BITERA, GIANYAR, GIANYAR, BALI",23,178,15,193
https://kawalpemilu.org#53536,"BITERA, GIANYAR, GIANYAR, BALI",24,147,25,172
https://kawalpemilu.org#53537,"TULIKUP, GIANYAR, GIANYAR, BALI",1,190,11,201
https://kawalpemilu.org#53537,"TULIKUP, GIANYAR, GIANYAR, BALI",3,227,20,247
https://kawalpemilu.org#53537,"TULIKUP, GIANYAR, GIANYAR, BALI",4,219,23,242
https://kawalpemilu.org#53537,"TULIKUP, GIANYAR, GIANYAR, BALI",5,219,25,244
https://kawalpemilu.org#53537,"TULIKUP, GIANYAR, GIANYAR, BALI",6,187,11,198
https://kawalpemilu.org#53537,"TULIKUP, GIANYAR, GIANYAR, BALI",7,198,13,211
https://kawalpemilu.org#53537,"TULIKUP, GIANYAR, GIANYAR, BALI",8,188,9,197
https://kawalpemilu.org#53537,"TULIKUP, GIANYAR, GIANYAR, BALI",9,132,15,147
https://kawalpemilu.org#53537,"TULIKUP, GIANYAR, GIANYAR, BALI",10,236,6,242
https://kawalpemilu.org#53537,"TULIKUP, GIANYAR, GIANYAR, BALI",11,222,6,228
https://kawalpemilu.org#53537,"TULIKUP, GIANYAR, GIANYAR, BALI",12,232,13,245
https://kawalpemilu.org#53537,"TULIKUP, GIANYAR, GIANYAR, BALI",13,184,10,194
https://kawalpemilu.org#53537,"TULIKUP, GIANYAR, GIANYAR, BALI",14,246,13,259
https://kawalpemilu.org#53537,"TULIKUP, GIANYAR, GIANYAR, BALI",15,228,6,234
https://kawalpemilu.org#53537,"TULIKUP, GIANYAR, GIANYAR, BALI",16,181,12,193
https://kawalpemilu.org#53537,"TULIKUP, GIANYAR, GIANYAR, BALI",17,232,13,245
https://kawalpemilu.org#53537,"TULIKUP, GIANYAR, GIANYAR, BALI",18,230,5,235
https://kawalpemilu.org#53537,"TULIKUP, GIANYAR, GIANYAR, BALI",19,211,2,213
https://kawalpemilu.org#53537,"TULIKUP, GIANYAR, GIANYAR, BALI",20,195,4,199
https://kawalpemilu.org#53537,"TULIKUP, GIANYAR, GIANYAR, BALI",21,256,4,260
https://kawalpemilu.org#53537,"TULIKUP, GIANYAR, GIANYAR, BALI",22,211,3,214
https://kawalpemilu.org#53537,"TULIKUP, GIANYAR, GIANYAR, BALI",23,232,10,242
https://kawalpemilu.org#53537,"TULIKUP, GIANYAR, GIANYAR, BALI",24,184,4,187
https://kawalpemilu.org#53537,"TULIKUP, GIANYAR, GIANYAR, BALI",25,199,0,199
https://kawalpemilu.org#53537,"TULIKUP, GIANYAR, GIANYAR, BALI",26,167,1,168
https://kawalpemilu.org#53538,"SIDAN, GIANYAR, GIANYAR, BALI",1,210,12,222
https://kawalpemilu.org#53538,"SIDAN, GIANYAR, GIANYAR, BALI",2,195,10,205
https://kawalpemilu.org#53538,"SIDAN, GIANYAR, GIANYAR, BALI",3,197,8,205
https://kawalpemilu.org#53538,"SIDAN, GIANYAR, GIANYAR, BALI",4,206,6,212
https://kawalpemilu.org#53538,"SIDAN, GIANYAR, GIANYAR, BALI",5,183,6,189
https://kawalpemilu.org#53538,"SIDAN, GIANYAR, GIANYAR, BALI",6,176,4,180
https://kawalpemilu.org#53538,"SIDAN, GIANYAR, GIANYAR, BALI",7,190,5,195
https://kawalpemilu.org#53538,"SIDAN, GIANYAR, GIANYAR, BALI",8,160,10,170
https://kawalpemilu.org#53538,"SIDAN, GIANYAR, GIANYAR, BALI",9,166,7,173
https://kawalpemilu.org#53538,"SIDAN, GIANYAR, GIANYAR, BALI",10,136,5,141
https://kawalpemilu.org#53538,"SIDAN, GIANYAR, GIANYAR, BALI",11,163,7,171
https://kawalpemilu.org#53538,"SIDAN, GIANYAR, GIANYAR, BALI",12,168,0,168
https://kawalpemilu.org#53538,"SIDAN, GIANYAR, GIANYAR, BALI",14,150,3,153
https://kawalpemilu.org#53538,"SIDAN, GIANYAR, GIANYAR, BALI",15,262,0,262
https://kawalpemilu.org#53538,"SIDAN, GIANYAR, GIANYAR, BALI",16,254,2,256
https://kawalpemilu.org#53538,"SIDAN, GIANYAR, GIANYAR, BALI",17,213,7,220
https://kawalpemilu.org#53538,"SIDAN, GIANYAR, GIANYAR, BALI",18,242,4,246
https://kawalpemilu.org#53539,"LEBIH, GIANYAR, GIANYAR, BALI",1,223,3,226
https://kawalpemilu.org#53539,"LEBIH, GIANYAR, GIANYAR, BALI",2,209,7,216
https://kawalpemilu.org#53539,"LEBIH, GIANYAR, GIANYAR, BALI",3,198,9,207
https://kawalpemilu.org#53539,"LEBIH, GIANYAR, GIANYAR, BALI",4,229,4,233
https://kawalpemilu.org#53539,"LEBIH, GIANYAR, GIANYAR, BALI",5,213,8,221
https://kawalpemilu.org#53539,"LEBIH, GIANYAR, GIANYAR, BALI",6,262,1,263
https://kawalpemilu.org#53539,"LEBIH, GIANYAR, GIANYAR, BALI",7,274,0,274
https://kawalpemilu.org#53539,"LEBIH, GIANYAR, GIANYAR, BALI",8,258,3,261
https://kawalpemilu.org#53539,"LEBIH, GIANYAR, GIANYAR, BALI",9,256,1,257
https://kawalpemilu.org#53539,"LEBIH, GIANYAR, GIANYAR, BALI",10,267,4,271
https://kawalpemilu.org#53539,"LEBIH, GIANYAR, GIANYAR, BALI",11,237,2,239
https://kawalpemilu.org#53539,"LEBIH, GIANYAR, GIANYAR, BALI",12,251,0,251
https://kawalpemilu.org#53539,"LEBIH, GIANYAR, GIANYAR, BALI",13,255,1,256
https://kawalpemilu.org#53539,"LEBIH, GIANYAR, GIANYAR, BALI",14,261,3,264
https://kawalpemilu.org#53539,"LEBIH, GIANYAR, GIANYAR, BALI",16,269,5,274
https://kawalpemilu.org#53539,"LEBIH, GIANYAR, GIANYAR, BALI",17,234,4,238
https://kawalpemilu.org#53539,"LEBIH, GIANYAR, GIANYAR, BALI",18,253,2,255
https://kawalpemilu.org#53539,"LEBIH, GIANYAR, GIANYAR, BALI",19,263,1,264
https://kawalpemilu.org#53539,"LEBIH, GIANYAR, GIANYAR, BALI",20,234,4,238
https://kawalpemilu.org#53539,"LEBIH, GIANYAR, GIANYAR, BALI",21,257,11,268
https://kawalpemilu.org#53540,"BENG, GIANYAR, GIANYAR, BALI",1,242,9,251
https://kawalpemilu.org#53540,"BENG, GIANYAR, GIANYAR, BALI",2,238,9,247
https://kawalpemilu.org#53540,"BENG, GIANYAR, GIANYAR, BALI",3,231,5,236
https://kawalpemilu.org#53540,"BENG, GIANYAR, GIANYAR, BALI",4,203,15,218
https://kawalpemilu.org#53540,"BENG, GIANYAR, GIANYAR, BALI",5,241,20,261
https://kawalpemilu.org#53540,"BENG, GIANYAR, GIANYAR, BALI",6,200,21,221
https://kawalpemilu.org#53540,"BENG, GIANYAR, GIANYAR, BALI",7,170,8,178
https://kawalpemilu.org#53540,"BENG, GIANYAR, GIANYAR, BALI",8,187,6,193
https://kawalpemilu.org#53540,"BENG, GIANYAR, GIANYAR, BALI",9,239,17,256
https://kawalpemilu.org#53540,"BENG, GIANYAR, GIANYAR, BALI",10,250,27,277
https://kawalpemilu.org#53540,"BENG, GIANYAR, GIANYAR, BALI",11,193,11,204
https://kawalpemilu.org#53540,"BENG, GIANYAR, GIANYAR, BALI",12,208,8,216
https://kawalpemilu.org#53540,"BENG, GIANYAR, GIANYAR, BALI",13,204,10,214
https://kawalpemilu.org#53541,"BAKBAKAN, GIANYAR, GIANYAR, BALI",1,191,3,194
https://kawalpemilu.org#53541,"BAKBAKAN, GIANYAR, GIANYAR, BALI",2,181,2,183
https://kawalpemilu.org#53541,"BAKBAKAN, GIANYAR, GIANYAR, BALI",3,197,5,202
https://kawalpemilu.org#53541,"BAKBAKAN, GIANYAR, GIANYAR, BALI",4,186,0,186
https://kawalpemilu.org#53541,"BAKBAKAN, GIANYAR, GIANYAR, BALI",5,187,5,191
https://kawalpemilu.org#53541,"BAKBAKAN, GIANYAR, GIANYAR, BALI",6,232,5,237
https://kawalpemilu.org#53541,"BAKBAKAN, GIANYAR, GIANYAR, BALI",7,217,5,222
https://kawalpemilu.org#53541,"BAKBAKAN, GIANYAR, GIANYAR, BALI",8,184,1,185
https://kawalpemilu.org#53541,"BAKBAKAN, GIANYAR, GIANYAR, BALI",9,162,7,169
https://kawalpemilu.org#53541,"BAKBAKAN, GIANYAR, GIANYAR, BALI",10,163,3,166
https://kawalpemilu.org#53541,"BAKBAKAN, GIANYAR, GIANYAR, BALI",11,163,4,167
https://kawalpemilu.org#53541,"BAKBAKAN, GIANYAR, GIANYAR, BALI",12,219,4,223
https://kawalpemilu.org#53541,"BAKBAKAN, GIANYAR, GIANYAR, BALI",13,196,4,200
https://kawalpemilu.org#53541,"BAKBAKAN, GIANYAR, GIANYAR, BALI",14,158,8,166
https://kawalpemilu.org#53541,"BAKBAKAN, GIANYAR, GIANYAR, BALI",15,183,2,185
https://kawalpemilu.org#53541,"BAKBAKAN, GIANYAR, GIANYAR, BALI",16,178,3,181
https://kawalpemilu.org#53541,"BAKBAKAN, GIANYAR, GIANYAR, BALI",17,159,7,166
https://kawalpemilu.org#53541,"BAKBAKAN, GIANYAR, GIANYAR, BALI",18,145,5,150
https://kawalpemilu.org#53541,"BAKBAKAN, GIANYAR, GIANYAR, BALI",19,200,18,218
https://kawalpemilu.org#53541,"BAKBAKAN, GIANYAR, GIANYAR, BALI",20,185,15,200
https://kawalpemilu.org#53542,"SIANGAN, GIANYAR, GIANYAR, BALI",1,214,5,219
https://kawalpemilu.org#53542,"SIANGAN, GIANYAR, GIANYAR, BALI",2,192,4,196
https://kawalpemilu.org#53542,"SIANGAN, GIANYAR, GIANYAR, BALI",3,210,2,212
https://kawalpemilu.org#53542,"SIANGAN, GIANYAR, GIANYAR, BALI",4,191,10,201
https://kawalpemilu.org#53542,"SIANGAN, GIANYAR, GIANYAR, BALI",5,194,6,200
https://kawalpemilu.org#53542,"SIANGAN, GIANYAR, GIANYAR, BALI",6,131,6,137
https://kawalpemilu.org#53542,"SIANGAN, GIANYAR, GIANYAR, BALI",7,216,5,221
https://kawalpemilu.org#53542,"SIANGAN, GIANYAR, GIANYAR, BALI",8,254,14,268
https://kawalpemilu.org#53542,"SIANGAN, GIANYAR, GIANYAR, BALI",9,181,17,198
https://kawalpemilu.org#53542,"SIANGAN, GIANYAR, GIANYAR, BALI",10,170,21,191
https://kawalpemilu.org#53542,"SIANGAN, GIANYAR, GIANYAR, BALI",11,149,23,172
https://kawalpemilu.org#53542,"SIANGAN, GIANYAR, GIANYAR, BALI",12,205,14,219
https://kawalpemilu.org#53542,"SIANGAN, GIANYAR, GIANYAR, BALI",13,205,8,213
https://kawalpemilu.org#53542,"SIANGAN, GIANYAR, GIANYAR, BALI",14,167,6,173
https://kawalpemilu.org#53542,"SIANGAN, GIANYAR, GIANYAR, BALI",15,155,11,166
https://kawalpemilu.org#53542,"SIANGAN, GIANYAR, GIANYAR, BALI",16,160,9,169
https://kawalpemilu.org#53542,"SIANGAN, GIANYAR, GIANYAR, BALI",17,99,0,99
https://kawalpemilu.org#53542,"SIANGAN, GIANYAR, GIANYAR, BALI",18,187,9,196
https://kawalpemilu.org#53542,"SIANGAN, GIANYAR, GIANYAR, BALI",19,156,8,164
https://kawalpemilu.org#53542,"SIANGAN, GIANYAR, GIANYAR, BALI",20,142,18,160
https://kawalpemilu.org#53542,"SIANGAN, GIANYAR, GIANYAR, BALI",21,149,7,156
https://kawalpemilu.org#53542,"SIANGAN, GIANYAR, GIANYAR, BALI",22,150,12,162
https://kawalpemilu.org#53542,"SIANGAN, GIANYAR, GIANYAR, BALI",23,140,2,142
https://kawalpemilu.org#53543,"SUWAT, GIANYAR, GIANYAR, BALI",1,174,3,177
https://kawalpemilu.org#53543,"SUWAT, GIANYAR, GIANYAR, BALI",2,187,22,209
https://kawalpemilu.org#53543,"SUWAT, GIANYAR, GIANYAR, BALI",3,233,4,237
https://kawalpemilu.org#53543,"SUWAT, GIANYAR, GIANYAR, BALI",4,221,24,245
https://kawalpemilu.org#53543,"SUWAT, GIANYAR, GIANYAR, BALI",5,156,10,166
https://kawalpemilu.org#53544,"PETAK, GIANYAR, GIANYAR, BALI",1,149,4,153
https://kawalpemilu.org#53544,"PETAK, GIANYAR, GIANYAR, BALI",2,193,6,199
https://kawalpemilu.org#53544,"PETAK, GIANYAR, GIANYAR, BALI",3,209,4,213
https://kawalpemilu.org#53544,"PETAK, GIANYAR, GIANYAR, BALI",4,215,10,225
https://kawalpemilu.org#53544,"PETAK, GIANYAR, GIANYAR, BALI",5,205,2,207
https://kawalpemilu.org#53544,"PETAK, GIANYAR, GIANYAR, BALI",6,156,8,164
https://kawalpemilu.org#53544,"PETAK, GIANYAR, GIANYAR, BALI",7,172,5,177
https://kawalpemilu.org#53544,"PETAK, GIANYAR, GIANYAR, BALI",8,173,5,178
https://kawalpemilu.org#53544,"PETAK, GIANYAR, GIANYAR, BALI",9,156,9,165
https://kawalpemilu.org#53544,"PETAK, GIANYAR, GIANYAR, BALI",10,166,2,168
https://kawalpemilu.org#53544,"PETAK, GIANYAR, GIANYAR, BALI",11,234,7,241
https://kawalpemilu.org#53544,"PETAK, GIANYAR, GIANYAR, BALI",12,194,9,203
https://kawalpemilu.org#53544,"PETAK, GIANYAR, GIANYAR, BALI",13,209,6,215
https://kawalpemilu.org#53544,"PETAK, GIANYAR, GIANYAR, BALI",14,187,5,192
https://kawalpemilu.org#53545,"SERONGGA, GIANYAR, GIANYAR, BALI",1,187,14,201
https://kawalpemilu.org#53545,"SERONGGA, GIANYAR, GIANYAR, BALI",2,183,13,196
https://kawalpemilu.org#53545,"SERONGGA, GIANYAR, GIANYAR, BALI",3,193,5,198
https://kawalpemilu.org#53545,"SERONGGA, GIANYAR, GIANYAR, BALI",4,182,12,194
https://kawalpemilu.org#53545,"SERONGGA, GIANYAR, GIANYAR, BALI",5,203,13,216
https://kawalpemilu.org#53545,"SERONGGA, GIANYAR, GIANYAR, BALI",6,202,10,212
https://kawalpemilu.org#53545,"SERONGGA, GIANYAR, GIANYAR, BALI",7,194,20,214
https://kawalpemilu.org#53545,"SERONGGA, GIANYAR, GIANYAR, BALI",8,238,17,255
https://kawalpemilu.org#53545,"SERONGGA, GIANYAR, GIANYAR, BALI",9,234,7,241
https://kawalpemilu.org#53545,"SERONGGA, GIANYAR, GIANYAR, BALI",10,211,12,223
https://kawalpemilu.org#53545,"SERONGGA, GIANYAR, GIANYAR, BALI",11,250,8,258
https://kawalpemilu.org#53545,"SERONGGA, GIANYAR, GIANYAR, BALI",12,230,7,237
https://kawalpemilu.org#53545,"SERONGGA, GIANYAR, GIANYAR, BALI",13,253,14,267
https://kawalpemilu.org#53545,"SERONGGA, GIANYAR, GIANYAR, BALI",14,237,7,244
https://kawalpemilu.org#53545,"SERONGGA, GIANYAR, GIANYAR, BALI",15,239,11,250
https://kawalpemilu.org#53546,"PETAK KAJA, GIANYAR, GIANYAR, BALI",1,206,1,207
https://kawalpemilu.org#53546,"PETAK KAJA, GIANYAR, GIANYAR, BALI",2,171,4,175
https://kawalpemilu.org#53546,"PETAK KAJA, GIANYAR, GIANYAR, BALI",3,199,5,204
https://kawalpemilu.org#53546,"PETAK KAJA, GIANYAR, GIANYAR, BALI",4,183,2,185
https://kawalpemilu.org#53546,"PETAK KAJA, GIANYAR, GIANYAR, BALI",5,201,4,205
https://kawalpemilu.org#53546,"PETAK KAJA, GIANYAR, GIANYAR, BALI",6,173,2,175
https://kawalpemilu.org#53546,"PETAK KAJA, GIANYAR, GIANYAR, BALI",7,202,1,203
https://kawalpemilu.org#53546,"PETAK KAJA, GIANYAR, GIANYAR, BALI",8,189,2,191
https://kawalpemilu.org#53546,"PETAK KAJA, GIANYAR, GIANYAR, BALI",9,213,6,219
https://kawalpemilu.org#53546,"PETAK KAJA, GIANYAR, GIANYAR, BALI",10,196,9,205
https://kawalpemilu.org#53546,"PETAK KAJA, GIANYAR, GIANYAR, BALI",11,203,6,209
https://kawalpemilu.org#53546,"PETAK KAJA, GIANYAR, GIANYAR, BALI",12,227,6,233
https://kawalpemilu.org#53546,"PETAK KAJA, GIANYAR, GIANYAR, BALI",13,140,6,146
https://kawalpemilu.org#53547,"TEMESI, GIANYAR, GIANYAR, BALI",1,224,17,241
https://kawalpemilu.org#53547,"TEMESI, GIANYAR, GIANYAR, BALI",2,224,6,230
https://kawalpemilu.org#53547,"TEMESI, GIANYAR, GIANYAR, BALI",3,201,5,206
https://kawalpemilu.org#53547,"TEMESI, GIANYAR, GIANYAR, BALI",4,229,3,232
https://kawalpemilu.org#53547,"TEMESI, GIANYAR, GIANYAR, BALI",5,177,8,185
https://kawalpemilu.org#53547,"TEMESI, GIANYAR, GIANYAR, BALI",6,246,11,257
https://kawalpemilu.org#53547,"TEMESI, GIANYAR, GIANYAR, BALI",7,224,12,236
https://kawalpemilu.org#53547,"TEMESI, GIANYAR, GIANYAR, BALI",8,243,26,243
https://kawalpemilu.org#53547,"TEMESI, GIANYAR, GIANYAR, BALI",9,203,6,209
https://kawalpemilu.org#53547,"TEMESI, GIANYAR, GIANYAR, BALI",10,250,13,263
https://kawalpemilu.org#53547,"TEMESI, GIANYAR, GIANYAR, BALI",11,243,12,255
https://kawalpemilu.org#53548,"SUMITA, GIANYAR, GIANYAR, BALI",1,208,6,214
https://kawalpemilu.org#53548,"SUMITA, GIANYAR, GIANYAR, BALI",2,206,18,224
https://kawalpemilu.org#53548,"SUMITA, GIANYAR, GIANYAR, BALI",3,193,8,201
https://kawalpemilu.org#53548,"SUMITA, GIANYAR, GIANYAR, BALI",4,87,8,95
https://kawalpemilu.org#53548,"SUMITA, GIANYAR, GIANYAR, BALI",5,219,13,232
https://kawalpemilu.org#53548,"SUMITA, GIANYAR, GIANYAR, BALI",6,208,18,226
https://kawalpemilu.org#53548,"SUMITA, GIANYAR, GIANYAR, BALI",7,246,6,252
https://kawalpemilu.org#53548,"SUMITA, GIANYAR, GIANYAR, BALI",8,134,15,149
https://kawalpemilu.org#53548,"SUMITA, GIANYAR, GIANYAR, BALI",9,134,16,150
https://kawalpemilu.org#53549,"TEGAL TUGU, GIANYAR, GIANYAR, BALI",1,207,16,223
https://kawalpemilu.org#53549,"TEGAL TUGU, GIANYAR, GIANYAR, BALI",2,219,7,226
https://kawalpemilu.org#53549,"TEGAL TUGU, GIANYAR, GIANYAR, BALI",3,222,10,232
https://kawalpemilu.org#53549,"TEGAL TUGU, GIANYAR, GIANYAR, BALI",4,213,11,224
https://kawalpemilu.org#53549,"TEGAL TUGU, GIANYAR, GIANYAR, BALI",5,225,12,0
https://kawalpemilu.org#53549,"TEGAL TUGU, GIANYAR, GIANYAR, BALI",6,221,10,231
https://kawalpemilu.org#53549,"TEGAL TUGU, GIANYAR, GIANYAR, BALI",7,228,11,239
https://kawalpemilu.org#53549,"TEGAL TUGU, GIANYAR, GIANYAR, BALI",8,221,10,231
https://kawalpemilu.org#53551,"PEJENG, TAMPAKSIRING, GIANYAR, BALI",2,223,8,231
https://kawalpemilu.org#53551,"PEJENG, TAMPAKSIRING, GIANYAR, BALI",3,203,10,213
https://kawalpemilu.org#53551,"PEJENG, TAMPAKSIRING, GIANYAR, BALI",4,187,9,196
https://kawalpemilu.org#53551,"PEJENG, TAMPAKSIRING, GIANYAR, BALI",5,214,6,220
https://kawalpemilu.org#53551,"PEJENG, TAMPAKSIRING, GIANYAR, BALI",6,250,12,262
https://kawalpemilu.org#53551,"PEJENG, TAMPAKSIRING, GIANYAR, BALI",7,259,11,270
https://kawalpemilu.org#53551,"PEJENG, TAMPAKSIRING, GIANYAR, BALI",8,201,16,217
https://kawalpemilu.org#53551,"PEJENG, TAMPAKSIRING, GIANYAR, BALI",9,209,15,224
https://kawalpemilu.org#53551,"PEJENG, TAMPAKSIRING, GIANYAR, BALI",10,201,2,203
https://kawalpemilu.org#53551,"PEJENG, TAMPAKSIRING, GIANYAR, BALI",11,202,14,216
https://kawalpemilu.org#53551,"PEJENG, TAMPAKSIRING, GIANYAR, BALI",12,168,27,195
https://kawalpemilu.org#53551,"PEJENG, TAMPAKSIRING, GIANYAR, BALI",13,181,15,196
https://kawalpemilu.org#53551,"PEJENG, TAMPAKSIRING, GIANYAR, BALI",14,201,12,213
https://kawalpemilu.org#53551,"PEJENG, TAMPAKSIRING, GIANYAR, BALI",15,182,25,207
https://kawalpemilu.org#53551,"PEJENG, TAMPAKSIRING, GIANYAR, BALI",16,201,6,207
https://kawalpemilu.org#53551,"PEJENG, TAMPAKSIRING, GIANYAR, BALI",17,214,4,218
https://kawalpemilu.org#53551,"PEJENG, TAMPAKSIRING, GIANYAR, BALI",18,209,15,224
https://kawalpemilu.org#53552,"SANDING, TAMPAKSIRING, GIANYAR, BALI",1,189,32,221
https://kawalpemilu.org#53552,"SANDING, TAMPAKSIRING, GIANYAR, BALI",2,219,20,239
https://kawalpemilu.org#53552,"SANDING, TAMPAKSIRING, GIANYAR, BALI",3,211,10,221
https://kawalpemilu.org#53552,"SANDING, TAMPAKSIRING, GIANYAR, BALI",4,208,17,225
https://kawalpemilu.org#53552,"SANDING, TAMPAKSIRING, GIANYAR, BALI",5,207,12,219
https://kawalpemilu.org#53552,"SANDING, TAMPAKSIRING, GIANYAR, BALI",6,244,9,253
https://kawalpemilu.org#53552,"SANDING, TAMPAKSIRING, GIANYAR, BALI",7,182,12,194
https://kawalpemilu.org#53552,"SANDING, TAMPAKSIRING, GIANYAR, BALI",8,130,4,134
https://kawalpemilu.org#53552,"SANDING, TAMPAKSIRING, GIANYAR, BALI",9,128,2,130
https://kawalpemilu.org#53552,"SANDING, TAMPAKSIRING, GIANYAR, BALI",10,262,6,268
https://kawalpemilu.org#53552,"SANDING, TAMPAKSIRING, GIANYAR, BALI",11,163,3,166
https://kawalpemilu.org#53552,"SANDING, TAMPAKSIRING, GIANYAR, BALI",12,165,4,169
https://kawalpemilu.org#53553,"TAMPAKSIRING, TAMPAKSIRING, GIANYAR, BALI",1,248,5,253
https://kawalpemilu.org#53553,"TAMPAKSIRING, TAMPAKSIRING, GIANYAR, BALI",2,213,5,218
https://kawalpemilu.org#53553,"TAMPAKSIRING, TAMPAKSIRING, GIANYAR, BALI",3,182,5,187
https://kawalpemilu.org#53553,"TAMPAKSIRING, TAMPAKSIRING, GIANYAR, BALI",4,263,3,266
https://kawalpemilu.org#53553,"TAMPAKSIRING, TAMPAKSIRING, GIANYAR, BALI",5,203,2,205
https://kawalpemilu.org#53553,"TAMPAKSIRING, TAMPAKSIRING, GIANYAR, BALI",6,255,14,269
https://kawalpemilu.org#53553,"TAMPAKSIRING, TAMPAKSIRING, GIANYAR, BALI",7,249,10,259
https://kawalpemilu.org#53553,"TAMPAKSIRING, TAMPAKSIRING, GIANYAR, BALI",8,170,5,175
https://kawalpemilu.org#53553,"TAMPAKSIRING, TAMPAKSIRING, GIANYAR, BALI",9,253,12,265
https://kawalpemilu.org#53553,"TAMPAKSIRING, TAMPAKSIRING, GIANYAR, BALI",10,244,19,263
https://kawalpemilu.org#53553,"TAMPAKSIRING, TAMPAKSIRING, GIANYAR, BALI",11,229,17,246
https://kawalpemilu.org#53553,"TAMPAKSIRING, TAMPAKSIRING, GIANYAR, BALI",12,231,17,248
https://kawalpemilu.org#53553,"TAMPAKSIRING, TAMPAKSIRING, GIANYAR, BALI",13,211,14,225
https://kawalpemilu.org#53553,"TAMPAKSIRING, TAMPAKSIRING, GIANYAR, BALI",14,269,2,271
https://kawalpemilu.org#53553,"TAMPAKSIRING, TAMPAKSIRING, GIANYAR, BALI",15,216,4,220
https://kawalpemilu.org#53553,"TAMPAKSIRING, TAMPAKSIRING, GIANYAR, BALI",16,231,2,233
https://kawalpemilu.org#53553,"TAMPAKSIRING, TAMPAKSIRING, GIANYAR, BALI",17,178,5,183
https://kawalpemilu.org#53553,"TAMPAKSIRING, TAMPAKSIRING, GIANYAR, BALI",18,268,5,273
https://kawalpemilu.org#53553,"TAMPAKSIRING, TAMPAKSIRING, GIANYAR, BALI",19,258,14,272
https://kawalpemilu.org#53553,"TAMPAKSIRING, TAMPAKSIRING, GIANYAR, BALI",20,230,17,247
https://kawalpemilu.org#53553,"TAMPAKSIRING, TAMPAKSIRING, GIANYAR, BALI",21,228,9,237
https://kawalpemilu.org#53553,"TAMPAKSIRING, TAMPAKSIRING, GIANYAR, BALI",22,167,3,170
https://kawalpemilu.org#53553,"TAMPAKSIRING, TAMPAKSIRING, GIANYAR, BALI",23,243,6,249
https://kawalpemilu.org#53553,"TAMPAKSIRING, TAMPAKSIRING, GIANYAR, BALI",24,154,4,158
https://kawalpemilu.org#53553,"TAMPAKSIRING, TAMPAKSIRING, GIANYAR, BALI",25,218,20,238
https://kawalpemilu.org#53553,"TAMPAKSIRING, TAMPAKSIRING, GIANYAR, BALI",26,194,23,217
https://kawalpemilu.org#53553,"TAMPAKSIRING, TAMPAKSIRING, GIANYAR, BALI",27,133,4,137
https://kawalpemilu.org#53553,"TAMPAKSIRING, TAMPAKSIRING, GIANYAR, BALI",28,254,3,257
https://kawalpemilu.org#53553,"TAMPAKSIRING, TAMPAKSIRING, GIANYAR, BALI",29,252,10,262
https://kawalpemilu.org#53553,"TAMPAKSIRING, TAMPAKSIRING, GIANYAR, BALI",30,236,3,239
https://kawalpemilu.org#53553,"TAMPAKSIRING, TAMPAKSIRING, GIANYAR, BALI",31,234,4,238
https://kawalpemilu.org#53553,"TAMPAKSIRING, TAMPAKSIRING, GIANYAR, BALI",32,177,3,180
https://kawalpemilu.org#53554,"MANUKAYA, TAMPAKSIRING, GIANYAR, BALI",1,231,8,239
https://kawalpemilu.org#53554,"MANUKAYA, TAMPAKSIRING, GIANYAR, BALI",2,222,9,231
https://kawalpemilu.org#53554,"MANUKAYA, TAMPAKSIRING, GIANYAR, BALI",3,227,6,233
https://kawalpemilu.org#53554,"MANUKAYA, TAMPAKSIRING, GIANYAR, BALI",4,261,1,262
https://kawalpemilu.org#53554,"MANUKAYA, TAMPAKSIRING, GIANYAR, BALI",5,261,4,265
https://kawalpemilu.org#53554,"MANUKAYA, TAMPAKSIRING, GIANYAR, BALI",6,250,5,255
https://kawalpemilu.org#53554,"MANUKAYA, TAMPAKSIRING, GIANYAR, BALI",7,187,9,196
https://kawalpemilu.org#53554,"MANUKAYA, TAMPAKSIRING, GIANYAR, BALI",8,192,3,195
https://kawalpemilu.org#53554,"MANUKAYA, TAMPAKSIRING, GIANYAR, BALI",9,231,9,240
https://kawalpemilu.org#53554,"MANUKAYA, TAMPAKSIRING, GIANYAR, BALI",10,233,11,244
https://kawalpemilu.org#53554,"MANUKAYA, TAMPAKSIRING, GIANYAR, BALI",11,192,34,226
https://kawalpemilu.org#53554,"MANUKAYA, TAMPAKSIRING, GIANYAR, BALI",12,214,12,226
https://kawalpemilu.org#53554,"MANUKAYA, TAMPAKSIRING, GIANYAR, BALI",13,207,10,217
https://kawalpemilu.org#53554,"MANUKAYA, TAMPAKSIRING, GIANYAR, BALI",14,211,6,217
https://kawalpemilu.org#53554,"MANUKAYA, TAMPAKSIRING, GIANYAR, BALI",15,210,2,212
https://kawalpemilu.org#53554,"MANUKAYA, TAMPAKSIRING, GIANYAR, BALI",16,206,10,216
https://kawalpemilu.org#53554,"MANUKAYA, TAMPAKSIRING, GIANYAR, BALI",17,197,4,201
https://kawalpemilu.org#53554,"MANUKAYA, TAMPAKSIRING, GIANYAR, BALI",18,234,5,239
https://kawalpemilu.org#53554,"MANUKAYA, TAMPAKSIRING, GIANYAR, BALI",19,250,5,255
https://kawalpemilu.org#53554,"MANUKAYA, TAMPAKSIRING, GIANYAR, BALI",20,254,3,257
https://kawalpemilu.org#53554,"MANUKAYA, TAMPAKSIRING, GIANYAR, BALI",21,217,6,223
https://kawalpemilu.org#53554,"MANUKAYA, TAMPAKSIRING, GIANYAR, BALI",22,210,14,224
https://kawalpemilu.org#53554,"MANUKAYA, TAMPAKSIRING, GIANYAR, BALI",23,200,5,205
https://kawalpemilu.org#53554,"MANUKAYA, TAMPAKSIRING, GIANYAR, BALI",24,202,2,204
https://kawalpemilu.org#53554,"MANUKAYA, TAMPAKSIRING, GIANYAR, BALI",25,208,4,212
https://kawalpemilu.org#53554,"MANUKAYA, TAMPAKSIRING, GIANYAR, BALI",26,224,6,230
https://kawalpemilu.org#53554,"MANUKAYA, TAMPAKSIRING, GIANYAR, BALI",27,217,5,222
https://kawalpemilu.org#53554,"MANUKAYA, TAMPAKSIRING, GIANYAR, BALI",28,197,5,202
https://kawalpemilu.org#53554,"MANUKAYA, TAMPAKSIRING, GIANYAR, BALI",29,211,3,214
https://kawalpemilu.org#53554,"MANUKAYA, TAMPAKSIRING, GIANYAR, BALI",30,177,6,183
https://kawalpemilu.org#53554,"MANUKAYA, TAMPAKSIRING, GIANYAR, BALI",31,168,6,174
https://kawalpemilu.org#53554,"MANUKAYA, TAMPAKSIRING, GIANYAR, BALI",32,248,5,253
https://kawalpemilu.org#53554,"MANUKAYA, TAMPAKSIRING, GIANYAR, BALI",33,239,5,244
https://kawalpemilu.org#53554,"MANUKAYA, TAMPAKSIRING, GIANYAR, BALI",34,219,5,224
https://kawalpemilu.org#53554,"MANUKAYA, TAMPAKSIRING, GIANYAR, BALI",35,218,3,221
https://kawalpemilu.org#53554,"MANUKAYA, TAMPAKSIRING, GIANYAR, BALI",36,191,4,195
https://kawalpemilu.org#53554,"MANUKAYA, TAMPAKSIRING, GIANYAR, BALI",37,214,8,222
https://kawalpemilu.org#53555,"PEJENG KAWAN, TAMPAKSIRING, GIANYAR, BALI",1,224,4,228
https://kawalpemilu.org#53555,"PEJENG KAWAN, TAMPAKSIRING, GIANYAR, BALI",2,218,11,229
https://kawalpemilu.org#53555,"PEJENG KAWAN, TAMPAKSIRING, GIANYAR, BALI",3,224,8,232
https://kawalpemilu.org#53555,"PEJENG KAWAN, TAMPAKSIRING, GIANYAR, BALI",4,251,2,253
https://kawalpemilu.org#53555,"PEJENG KAWAN, TAMPAKSIRING, GIANYAR, BALI",6,231,0,231
https://kawalpemilu.org#53555,"PEJENG KAWAN, TAMPAKSIRING, GIANYAR, BALI",7,185,2,187
https://kawalpemilu.org#53555,"PEJENG KAWAN, TAMPAKSIRING, GIANYAR, BALI",8,191,1,192
https://kawalpemilu.org#53555,"PEJENG KAWAN, TAMPAKSIRING, GIANYAR, BALI",9,183,1,184
https://kawalpemilu.org#53555,"PEJENG KAWAN, TAMPAKSIRING, GIANYAR, BALI",10,169,0,169
https://kawalpemilu.org#53555,"PEJENG KAWAN, TAMPAKSIRING, GIANYAR, BALI",11,163,3,166
https://kawalpemilu.org#53555,"PEJENG KAWAN, TAMPAKSIRING, GIANYAR, BALI",12,207,11,218
https://kawalpemilu.org#53555,"PEJENG KAWAN, TAMPAKSIRING, GIANYAR, BALI",13,205,13,218
https://kawalpemilu.org#53556,"PEJENG KAJA, TAMPAKSIRING, GIANYAR, BALI",1,145,1,146
https://kawalpemilu.org#53556,"PEJENG KAJA, TAMPAKSIRING, GIANYAR, BALI",2,151,0,151
https://kawalpemilu.org#53556,"PEJENG KAJA, TAMPAKSIRING, GIANYAR, BALI",3,164,1,165
https://kawalpemilu.org#53556,"PEJENG KAJA, TAMPAKSIRING, GIANYAR, BALI",4,167,5,172
https://kawalpemilu.org#53556,"PEJENG KAJA, TAMPAKSIRING, GIANYAR, BALI",5,209,4,213
https://kawalpemilu.org#53556,"PEJENG KAJA, TAMPAKSIRING, GIANYAR, BALI",6,221,1,222
https://kawalpemilu.org#53556,"PEJENG KAJA, TAMPAKSIRING, GIANYAR, BALI",7,192,8,200
https://kawalpemilu.org#53556,"PEJENG KAJA, TAMPAKSIRING, GIANYAR, BALI",8,188,2,190
https://kawalpemilu.org#53556,"PEJENG KAJA, TAMPAKSIRING, GIANYAR, BALI",9,185,2,187
https://kawalpemilu.org#53556,"PEJENG KAJA, TAMPAKSIRING, GIANYAR, BALI",10,188,6,194
https://kawalpemilu.org#53556,"PEJENG KAJA, TAMPAKSIRING, GIANYAR, BALI",11,212,4,216
https://kawalpemilu.org#53556,"PEJENG KAJA, TAMPAKSIRING, GIANYAR, BALI",12,210,1,211
https://kawalpemilu.org#53556,"PEJENG KAJA, TAMPAKSIRING, GIANYAR, BALI",13,159,3,162
https://kawalpemilu.org#53556,"PEJENG KAJA, TAMPAKSIRING, GIANYAR, BALI",14,159,4,163
https://kawalpemilu.org#53556,"PEJENG KAJA, TAMPAKSIRING, GIANYAR, BALI",15,200,6,206
https://kawalpemilu.org#53556,"PEJENG KAJA, TAMPAKSIRING, GIANYAR, BALI",16,220,3,223
https://kawalpemilu.org#53556,"PEJENG KAJA, TAMPAKSIRING, GIANYAR, BALI",17,171,1,172
https://kawalpemilu.org#53556,"PEJENG KAJA, TAMPAKSIRING, GIANYAR, BALI",18,171,3,174
https://kawalpemilu.org#53556,"PEJENG KAJA, TAMPAKSIRING, GIANYAR, BALI",19,161,0,161
https://kawalpemilu.org#53556,"PEJENG KAJA, TAMPAKSIRING, GIANYAR, BALI",20,143,5,148
https://kawalpemilu.org#53557,"PEJENG KANGIN, TAMPAKSIRING, GIANYAR, BALI",1,196,2,198
https://kawalpemilu.org#53557,"PEJENG KANGIN, TAMPAKSIRING, GIANYAR, BALI",2,187,10,197
https://kawalpemilu.org#53557,"PEJENG KANGIN, TAMPAKSIRING, GIANYAR, BALI",3,187,7,194
https://kawalpemilu.org#53557,"PEJENG KANGIN, TAMPAKSIRING, GIANYAR, BALI",4,190,5,195
https://kawalpemilu.org#53557,"PEJENG KANGIN, TAMPAKSIRING, GIANYAR, BALI",5,171,5,176
https://kawalpemilu.org#53557,"PEJENG KANGIN, TAMPAKSIRING, GIANYAR, BALI",6,172,4,176
https://kawalpemilu.org#53557,"PEJENG KANGIN, TAMPAKSIRING, GIANYAR, BALI",7,180,1,181
https://kawalpemilu.org#53557,"PEJENG KANGIN, TAMPAKSIRING, GIANYAR, BALI",8,219,1,220
https://kawalpemilu.org#53557,"PEJENG KANGIN, TAMPAKSIRING, GIANYAR, BALI",9,214,1,215
https://kawalpemilu.org#53557,"PEJENG KANGIN, TAMPAKSIRING, GIANYAR, BALI",10,165,5,170
https://kawalpemilu.org#53557,"PEJENG KANGIN, TAMPAKSIRING, GIANYAR, BALI",11,186,0,186
https://kawalpemilu.org#53557,"PEJENG KANGIN, TAMPAKSIRING, GIANYAR, BALI",12,188,7,195
https://kawalpemilu.org#53557,"PEJENG KANGIN, TAMPAKSIRING, GIANYAR, BALI",13,144,0,144
https://kawalpemilu.org#53557,"PEJENG KANGIN, TAMPAKSIRING, GIANYAR, BALI",14,129,0,129
https://kawalpemilu.org#53557,"PEJENG KANGIN, TAMPAKSIRING, GIANYAR, BALI",15,199,22,221
https://kawalpemilu.org#53557,"PEJENG KANGIN, TAMPAKSIRING, GIANYAR, BALI",16,202,6,208
https://kawalpemilu.org#53557,"PEJENG KANGIN, TAMPAKSIRING, GIANYAR, BALI",17,194,7,201
https://kawalpemilu.org#53557,"PEJENG KANGIN, TAMPAKSIRING, GIANYAR, BALI",18,206,7,213
https://kawalpemilu.org#53557,"PEJENG KANGIN, TAMPAKSIRING, GIANYAR, BALI",19,210,2,212
https://kawalpemilu.org#53558,"PEJENG KELOD, TAMPAKSIRING, GIANYAR, BALI",1,139,1,140
https://kawalpemilu.org#53558,"PEJENG KELOD, TAMPAKSIRING, GIANYAR, BALI",2,142,1,143
https://kawalpemilu.org#53558,"PEJENG KELOD, TAMPAKSIRING, GIANYAR, BALI",3,244,0,244
https://kawalpemilu.org#53558,"PEJENG KELOD, TAMPAKSIRING, GIANYAR, BALI",4,203,12,215
https://kawalpemilu.org#53558,"PEJENG KELOD, TAMPAKSIRING, GIANYAR, BALI",5,205,7,212
https://kawalpemilu.org#53558,"PEJENG KELOD, TAMPAKSIRING, GIANYAR, BALI",6,168,11,179
https://kawalpemilu.org#53558,"PEJENG KELOD, TAMPAKSIRING, GIANYAR, BALI",7,165,3,168
https://kawalpemilu.org#53558,"PEJENG KELOD, TAMPAKSIRING, GIANYAR, BALI",8,128,4,132
https://kawalpemilu.org#53558,"PEJENG KELOD, TAMPAKSIRING, GIANYAR, BALI",9,121,9,130
https://kawalpemilu.org#53558,"PEJENG KELOD, TAMPAKSIRING, GIANYAR, BALI",10,165,6,171
https://kawalpemilu.org#53558,"PEJENG KELOD, TAMPAKSIRING, GIANYAR, BALI",11,160,18,178
https://kawalpemilu.org#53558,"PEJENG KELOD, TAMPAKSIRING, GIANYAR, BALI",12,236,3,239
https://kawalpemilu.org#53560,"UBUD, UBUD, GIANYAR, BALI",1,237,14,251
https://kawalpemilu.org#53560,"UBUD, UBUD, GIANYAR, BALI",2,219,11,230
https://kawalpemilu.org#53560,"UBUD, UBUD, GIANYAR, BALI",3,248,8,256
https://kawalpemilu.org#53560,"UBUD, UBUD, GIANYAR, BALI",4,238,12,250
https://kawalpemilu.org#53560,"UBUD, UBUD, GIANYAR, BALI",5,236,4,240
https://kawalpemilu.org#53560,"UBUD, UBUD, GIANYAR, BALI",6,208,1,209
https://kawalpemilu.org#53560,"UBUD, UBUD, GIANYAR, BALI",7,250,7,257
https://kawalpemilu.org#53560,"UBUD, UBUD, GIANYAR, BALI",8,254,6,260
https://kawalpemilu.org#53560,"UBUD, UBUD, GIANYAR, BALI",9,210,3,213
https://kawalpemilu.org#53560,"UBUD, UBUD, GIANYAR, BALI",10,255,9,264
https://kawalpemilu.org#53560,"UBUD, UBUD, GIANYAR, BALI",11,256,4,260
https://kawalpemilu.org#53560,"UBUD, UBUD, GIANYAR, BALI",12,198,3,201
https://kawalpemilu.org#53560,"UBUD, UBUD, GIANYAR, BALI",13,204,2,207
https://kawalpemilu.org#53560,"UBUD, UBUD, GIANYAR, BALI",14,206,9,215
https://kawalpemilu.org#53560,"UBUD, UBUD, GIANYAR, BALI",15,208,3,211
https://kawalpemilu.org#53560,"UBUD, UBUD, GIANYAR, BALI",16,192,15,207
https://kawalpemilu.org#53560,"UBUD, UBUD, GIANYAR, BALI",17,222,6,228
https://kawalpemilu.org#53560,"UBUD, UBUD, GIANYAR, BALI",18,246,13,259
https://kawalpemilu.org#53560,"UBUD, UBUD, GIANYAR, BALI",19,210,6,216
https://kawalpemilu.org#53560,"UBUD, UBUD, GIANYAR, BALI",20,243,1,244
https://kawalpemilu.org#53560,"UBUD, UBUD, GIANYAR, BALI",21,243,3,246
https://kawalpemilu.org#53560,"UBUD, UBUD, GIANYAR, BALI",22,140,1,141
https://kawalpemilu.org#53560,"UBUD, UBUD, GIANYAR, BALI",23,257,4,261
https://kawalpemilu.org#53560,"UBUD, UBUD, GIANYAR, BALI",24,245,8,253
https://kawalpemilu.org#53560,"UBUD, UBUD, GIANYAR, BALI",25,245,1,246
https://kawalpemilu.org#53560,"UBUD, UBUD, GIANYAR, BALI",26,244,8,252
https://kawalpemilu.org#53560,"UBUD, UBUD, GIANYAR, BALI",27,235,8,243
https://kawalpemilu.org#53560,"UBUD, UBUD, GIANYAR, BALI",28,185,2,187
https://kawalpemilu.org#53560,"UBUD, UBUD, GIANYAR, BALI",29,194,6,200
https://kawalpemilu.org#53560,"UBUD, UBUD, GIANYAR, BALI",30,250,10,260
https://kawalpemilu.org#53560,"UBUD, UBUD, GIANYAR, BALI",31,264,0,264
https://kawalpemilu.org#53560,"UBUD, UBUD, GIANYAR, BALI",32,256,2,258
https://kawalpemilu.org#53560,"UBUD, UBUD, GIANYAR, BALI",33,264,4,268
https://kawalpemilu.org#53560,"UBUD, UBUD, GIANYAR, BALI",34,192,3,195
https://kawalpemilu.org#53560,"UBUD, UBUD, GIANYAR, BALI",35,175,17,192
https://kawalpemilu.org#53561,"LODTUNDUH, UBUD, GIANYAR, BALI",1,159,5,164
https://kawalpemilu.org#53561,"LODTUNDUH, UBUD, GIANYAR, BALI",2,161,8,169
https://kawalpemilu.org#53561,"LODTUNDUH, UBUD, GIANYAR, BALI",3,201,15,216
https://kawalpemilu.org#53561,"LODTUNDUH, UBUD, GIANYAR, BALI",4,199,7,206
https://kawalpemilu.org#53561,"LODTUNDUH, UBUD, GIANYAR, BALI",5,197,6,203
https://kawalpemilu.org#53561,"LODTUNDUH, UBUD, GIANYAR, BALI",6,263,5,268
https://kawalpemilu.org#53561,"LODTUNDUH, UBUD, GIANYAR, BALI",7,198,3,201
https://kawalpemilu.org#53561,"LODTUNDUH, UBUD, GIANYAR, BALI",8,194,1,195
https://kawalpemilu.org#53561,"LODTUNDUH, UBUD, GIANYAR, BALI",9,245,6,251
https://kawalpemilu.org#53561,"LODTUNDUH, UBUD, GIANYAR, BALI",10,228,4,232
https://kawalpemilu.org#53561,"LODTUNDUH, UBUD, GIANYAR, BALI",11,221,4,225
https://kawalpemilu.org#53561,"LODTUNDUH, UBUD, GIANYAR, BALI",12,227,3,230
https://kawalpemilu.org#53561,"LODTUNDUH, UBUD, GIANYAR, BALI",14,244,0,244
https://kawalpemilu.org#53561,"LODTUNDUH, UBUD, GIANYAR, BALI",15,237,0,237
https://kawalpemilu.org#53561,"LODTUNDUH, UBUD, GIANYAR, BALI",16,201,7,208
https://kawalpemilu.org#53561,"LODTUNDUH, UBUD, GIANYAR, BALI",17,178,21,199
https://kawalpemilu.org#53561,"LODTUNDUH, UBUD, GIANYAR, BALI",18,239,9,248
https://kawalpemilu.org#53561,"LODTUNDUH, UBUD, GIANYAR, BALI",19,249,6,255
https://kawalpemilu.org#53561,"LODTUNDUH, UBUD, GIANYAR, BALI",20,238,7,245
https://kawalpemilu.org#53561,"LODTUNDUH, UBUD, GIANYAR, BALI",21,239,4,243
https://kawalpemilu.org#53561,"LODTUNDUH, UBUD, GIANYAR, BALI",22,223,11,234
https://kawalpemilu.org#53561,"LODTUNDUH, UBUD, GIANYAR, BALI",23,230,13,243
https://kawalpemilu.org#53561,"LODTUNDUH, UBUD, GIANYAR, BALI",24,223,5,228
https://kawalpemilu.org#53562,"MAS, UBUD, GIANYAR, BALI",1,205,10,215
https://kawalpemilu.org#53562,"MAS, UBUD, GIANYAR, BALI",2,198,6,204
https://kawalpemilu.org#53562,"MAS, UBUD, GIANYAR, BALI",3,194,10,204
https://kawalpemilu.org#53562,"MAS, UBUD, GIANYAR, BALI",4,244,4,248
https://kawalpemilu.org#53562,"MAS, UBUD, GIANYAR, BALI",5,246,4,250
https://kawalpemilu.org#53562,"MAS, UBUD, GIANYAR, BALI",6,251,6,257
https://kawalpemilu.org#53562,"MAS, UBUD, GIANYAR, BALI",7,240,3,243
https://kawalpemilu.org#53562,"MAS, UBUD, GIANYAR, BALI",8,241,6,247
https://kawalpemilu.org#53562,"MAS, UBUD, GIANYAR, BALI",9,247,5,252
https://kawalpemilu.org#53562,"MAS, UBUD, GIANYAR, BALI",10,253,4,257
https://kawalpemilu.org#53562,"MAS, UBUD, GIANYAR, BALI",11,240,7,247
https://kawalpemilu.org#53562,"MAS, UBUD, GIANYAR, BALI",12,248,9,257
https://kawalpemilu.org#53562,"MAS, UBUD, GIANYAR, BALI",13,264,7,271
https://kawalpemilu.org#53562,"MAS, UBUD, GIANYAR, BALI",14,261,11,272
https://kawalpemilu.org#53562,"MAS, UBUD, GIANYAR, BALI",15,202,6,208
https://kawalpemilu.org#53562,"MAS, UBUD, GIANYAR, BALI",16,209,0,209
https://kawalpemilu.org#53562,"MAS, UBUD, GIANYAR, BALI",17,215,1,216
https://kawalpemilu.org#53562,"MAS, UBUD, GIANYAR, BALI",18,212,5,217
https://kawalpemilu.org#53562,"MAS, UBUD, GIANYAR, BALI",19,224,1,225
https://kawalpemilu.org#53562,"MAS, UBUD, GIANYAR, BALI",20,231,5,236
https://kawalpemilu.org#53562,"MAS, UBUD, GIANYAR, BALI",21,228,0,228
https://kawalpemilu.org#53562,"MAS, UBUD, GIANYAR, BALI",22,232,3,235
https://kawalpemilu.org#53562,"MAS, UBUD, GIANYAR, BALI",23,234,5,239
https://kawalpemilu.org#53562,"MAS, UBUD, GIANYAR, BALI",24,220,0,220
https://kawalpemilu.org#53562,"MAS, UBUD, GIANYAR, BALI",25,242,6,248
https://kawalpemilu.org#53562,"MAS, UBUD, GIANYAR, BALI",26,230,7,237
https://kawalpemilu.org#53562,"MAS, UBUD, GIANYAR, BALI",27,229,8,237
https://kawalpemilu.org#53562,"MAS, UBUD, GIANYAR, BALI",28,227,8,235
https://kawalpemilu.org#53562,"MAS, UBUD, GIANYAR, BALI",29,195,3,198
https://kawalpemilu.org#53562,"MAS, UBUD, GIANYAR, BALI",30,200,4,204
https://kawalpemilu.org#53562,"MAS, UBUD, GIANYAR, BALI",31,197,6,203
https://kawalpemilu.org#53562,"MAS, UBUD, GIANYAR, BALI",32,179,9,188
https://kawalpemilu.org#53562,"MAS, UBUD, GIANYAR, BALI",33,180,5,185
https://kawalpemilu.org#53562,"MAS, UBUD, GIANYAR, BALI",34,176,5,181
https://kawalpemilu.org#53562,"MAS, UBUD, GIANYAR, BALI",35,239,3,242
https://kawalpemilu.org#53562,"MAS, UBUD, GIANYAR, BALI",36,219,9,228
https://kawalpemilu.org#53562,"MAS, UBUD, GIANYAR, BALI",37,165,3,168
https://kawalpemilu.org#53562,"MAS, UBUD, GIANYAR, BALI",38,152,5,157
https://kawalpemilu.org#53563,"SINGAKERTA, UBUD, GIANYAR, BALI",1,214,6,220
https://kawalpemilu.org#53563,"SINGAKERTA, UBUD, GIANYAR, BALI",2,223,6,229
https://kawalpemilu.org#53563,"SINGAKERTA, UBUD, GIANYAR, BALI",3,211,6,217
https://kawalpemilu.org#53563,"SINGAKERTA, UBUD, GIANYAR, BALI",4,221,7,228
https://kawalpemilu.org#53563,"SINGAKERTA, UBUD, GIANYAR, BALI",5,163,4,167
https://kawalpemilu.org#53563,"SINGAKERTA, UBUD, GIANYAR, BALI",6,158,2,160
https://kawalpemilu.org#53563,"SINGAKERTA, UBUD, GIANYAR, BALI",7,164,2,166
https://kawalpemilu.org#53563,"SINGAKERTA, UBUD, GIANYAR, BALI",8,229,0,229
https://kawalpemilu.org#53563,"SINGAKERTA, UBUD, GIANYAR, BALI",9,228,1,229
https://kawalpemilu.org#53563,"SINGAKERTA, UBUD, GIANYAR, BALI",10,225,1,226
https://kawalpemilu.org#53563,"SINGAKERTA, UBUD, GIANYAR, BALI",11,227,4,231
https://kawalpemilu.org#53563,"SINGAKERTA, UBUD, GIANYAR, BALI",12,197,11,208
https://kawalpemilu.org#53563,"SINGAKERTA, UBUD, GIANYAR, BALI",13,183,2,185
https://kawalpemilu.org#53563,"SINGAKERTA, UBUD, GIANYAR, BALI",14,190,3,193
https://kawalpemilu.org#53563,"SINGAKERTA, UBUD, GIANYAR, BALI",15,173,10,183
https://kawalpemilu.org#53563,"SINGAKERTA, UBUD, GIANYAR, BALI",16,277,2,279
https://kawalpemilu.org#53563,"SINGAKERTA, UBUD, GIANYAR, BALI",17,235,0,235
https://kawalpemilu.org#53563,"SINGAKERTA, UBUD, GIANYAR, BALI",18,228,8,236
https://kawalpemilu.org#53563,"SINGAKERTA, UBUD, GIANYAR, BALI",19,234,0,234
https://kawalpemilu.org#53563,"SINGAKERTA, UBUD, GIANYAR, BALI",20,226,2,228
https://kawalpemilu.org#53563,"SINGAKERTA, UBUD, GIANYAR, BALI",21,222,5,227
https://kawalpemilu.org#53563,"SINGAKERTA, UBUD, GIANYAR, BALI",22,219,7,226
https://kawalpemilu.org#53563,"SINGAKERTA, UBUD, GIANYAR, BALI",23,279,1,280
https://kawalpemilu.org#53563,"SINGAKERTA, UBUD, GIANYAR, BALI",24,274,4,278
https://kawalpemilu.org#53563,"SINGAKERTA, UBUD, GIANYAR, BALI",25,255,0,255
https://kawalpemilu.org#53563,"SINGAKERTA, UBUD, GIANYAR, BALI",26,274,0,274
https://kawalpemilu.org#53563,"SINGAKERTA, UBUD, GIANYAR, BALI",27,201,4,205
https://kawalpemilu.org#53563,"SINGAKERTA, UBUD, GIANYAR, BALI",28,204,0,204
https://kawalpemilu.org#53563,"SINGAKERTA, UBUD, GIANYAR, BALI",29,223,3,226
https://kawalpemilu.org#53563,"SINGAKERTA, UBUD, GIANYAR, BALI",30,230,3,233
https://kawalpemilu.org#53563,"SINGAKERTA, UBUD, GIANYAR, BALI",31,230,2,232
https://kawalpemilu.org#53563,"SINGAKERTA, UBUD, GIANYAR, BALI",32,233,3,236
https://kawalpemilu.org#53563,"SINGAKERTA, UBUD, GIANYAR, BALI",33,229,5,234
https://kawalpemilu.org#53564,"KEDEWATAN, UBUD, GIANYAR, BALI",1,278,8,286
https://kawalpemilu.org#53564,"KEDEWATAN, UBUD, GIANYAR, BALI",2,287,2,289
https://kawalpemilu.org#53564,"KEDEWATAN, UBUD, GIANYAR, BALI",3,258,8,266
https://kawalpemilu.org#53564,"KEDEWATAN, UBUD, GIANYAR, BALI",4,264,6,270
https://kawalpemilu.org#53564,"KEDEWATAN, UBUD, GIANYAR, BALI",5,248,3,251
https://kawalpemilu.org#53564,"KEDEWATAN, UBUD, GIANYAR, BALI",6,255,5,260
https://kawalpemilu.org#53564,"KEDEWATAN, UBUD, GIANYAR, BALI",7,221,9,230
https://kawalpemilu.org#53564,"KEDEWATAN, UBUD, GIANYAR, BALI",8,222,8,230
https://kawalpemilu.org#53564,"KEDEWATAN, UBUD, GIANYAR, BALI",9,209,10,219
https://kawalpemilu.org#53564,"KEDEWATAN, UBUD, GIANYAR, BALI",10,230,6,236
https://kawalpemilu.org#53564,"KEDEWATAN, UBUD, GIANYAR, BALI",11,212,5,217
https://kawalpemilu.org#53564,"KEDEWATAN, UBUD, GIANYAR, BALI",12,223,3,226
https://kawalpemilu.org#53564,"KEDEWATAN, UBUD, GIANYAR, BALI",13,188,5,193
https://kawalpemilu.org#53564,"KEDEWATAN, UBUD, GIANYAR, BALI",14,162,1,163
https://kawalpemilu.org#53564,"KEDEWATAN, UBUD, GIANYAR, BALI",15,222,8,230
https://kawalpemilu.org#53564,"KEDEWATAN, UBUD, GIANYAR, BALI",16,232,6,238
https://kawalpemilu.org#53564,"KEDEWATAN, UBUD, GIANYAR, BALI",17,241,2,243
https://kawalpemilu.org#53564,"KEDEWATAN, UBUD, GIANYAR, BALI",18,223,7,230
https://kawalpemilu.org#53564,"KEDEWATAN, UBUD, GIANYAR, BALI",19,246,1,247
https://kawalpemilu.org#53564,"KEDEWATAN, UBUD, GIANYAR, BALI",20,243,2,245
https://kawalpemilu.org#53565,"PELIATAN, UBUD, GIANYAR, BALI",1,247,9,256
https://kawalpemilu.org#53565,"PELIATAN, UBUD, GIANYAR, BALI",2,234,7,241
https://kawalpemilu.org#53565,"PELIATAN, UBUD, GIANYAR, BALI",3,248,8,256
https://kawalpemilu.org#53565,"PELIATAN, UBUD, GIANYAR, BALI",4,218,1,219
https://kawalpemilu.org#53565,"PELIATAN, UBUD, GIANYAR, BALI",5,213,7,220
https://kawalpemilu.org#53565,"PELIATAN, UBUD, GIANYAR, BALI",6,202,9,211
https://kawalpemilu.org#53565,"PELIATAN, UBUD, GIANYAR, BALI",7,180,4,184
https://kawalpemilu.org#53565,"PELIATAN, UBUD, GIANYAR, BALI",8,179,3,182
https://kawalpemilu.org#53565,"PELIATAN, UBUD, GIANYAR, BALI",9,231,11,242
https://kawalpemilu.org#53565,"PELIATAN, UBUD, GIANYAR, BALI",10,233,14,247
https://kawalpemilu.org#53565,"PELIATAN, UBUD, GIANYAR, BALI",11,164,11,175
https://kawalpemilu.org#53565,"PELIATAN, UBUD, GIANYAR, BALI",12,255,14,269
https://kawalpemilu.org#53565,"PELIATAN, UBUD, GIANYAR, BALI",13,258,9,267
https://kawalpemilu.org#53565,"PELIATAN, UBUD, GIANYAR, BALI",14,208,2,210
https://kawalpemilu.org#53565,"PELIATAN, UBUD, GIANYAR, BALI",15,242,2,244
https://kawalpemilu.org#53565,"PELIATAN, UBUD, GIANYAR, BALI",16,229,7,236
https://kawalpemilu.org#53565,"PELIATAN, UBUD, GIANYAR, BALI",17,234,6,240
https://kawalpemilu.org#53565,"PELIATAN, UBUD, GIANYAR, BALI",18,273,3,276
https://kawalpemilu.org#53565,"PELIATAN, UBUD, GIANYAR, BALI",19,263,4,267
https://kawalpemilu.org#53565,"PELIATAN, UBUD, GIANYAR, BALI",20,244,3,247
https://kawalpemilu.org#53565,"PELIATAN, UBUD, GIANYAR, BALI",21,221,4,225
https://kawalpemilu.org#53565,"PELIATAN, UBUD, GIANYAR, BALI",22,226,7,233
https://kawalpemilu.org#53565,"PELIATAN, UBUD, GIANYAR, BALI",23,210,3,213
https://kawalpemilu.org#53565,"PELIATAN, UBUD, GIANYAR, BALI",24,182,2,184
https://kawalpemilu.org#53565,"PELIATAN, UBUD, GIANYAR, BALI",25,201,2,203
https://kawalpemilu.org#53565,"PELIATAN, UBUD, GIANYAR, BALI",26,197,5,202
https://kawalpemilu.org#53566,"PETULU, UBUD, GIANYAR, BALI",1,212,1,213
https://kawalpemilu.org#53566,"PETULU, UBUD, GIANYAR, BALI",2,213,1,214
https://kawalpemilu.org#53566,"PETULU, UBUD, GIANYAR, BALI",3,219,3,222
https://kawalpemilu.org#53566,"PETULU, UBUD, GIANYAR, BALI",4,197,2,199
https://kawalpemilu.org#53566,"PETULU, UBUD, GIANYAR, BALI",5,198,4,202
https://kawalpemilu.org#53566,"PETULU, UBUD, GIANYAR, BALI",6,196,2,198
https://kawalpemilu.org#53566,"PETULU, UBUD, GIANYAR, BALI",7,259,8,267
https://kawalpemilu.org#53566,"PETULU, UBUD, GIANYAR, BALI",8,232,30,262
https://kawalpemilu.org#53566,"PETULU, UBUD, GIANYAR, BALI",9,217,6,223
https://kawalpemilu.org#53566,"PETULU, UBUD, GIANYAR, BALI",10,245,3,248
https://kawalpemilu.org#53566,"PETULU, UBUD, GIANYAR, BALI",11,235,9,244
https://kawalpemilu.org#53566,"PETULU, UBUD, GIANYAR, BALI",12,221,11,232
https://kawalpemilu.org#53566,"PETULU, UBUD, GIANYAR, BALI",13,203,1,204
https://kawalpemilu.org#53566,"PETULU, UBUD, GIANYAR, BALI",14,197,7,204
https://kawalpemilu.org#53566,"PETULU, UBUD, GIANYAR, BALI",15,231,16,247
https://kawalpemilu.org#53566,"PETULU, UBUD, GIANYAR, BALI",16,231,13,244
https://kawalpemilu.org#53566,"PETULU, UBUD, GIANYAR, BALI",17,235,11,246
https://kawalpemilu.org#53567,"SAYAN, UBUD, GIANYAR, BALI",1,148,1,149
https://kawalpemilu.org#53567,"SAYAN, UBUD, GIANYAR, BALI",2,143,7,150
https://kawalpemilu.org#53567,"SAYAN, UBUD, GIANYAR, BALI",3,255,15,270
https://kawalpemilu.org#53567,"SAYAN, UBUD, GIANYAR, BALI",4,261,13,274
https://kawalpemilu.org#53567,"SAYAN, UBUD, GIANYAR, BALI",5,261,6,267
https://kawalpemilu.org#53567,"SAYAN, UBUD, GIANYAR, BALI",6,239,34,273
https://kawalpemilu.org#53567,"SAYAN, UBUD, GIANYAR, BALI",7,262,24,286
https://kawalpemilu.org#53567,"SAYAN, UBUD, GIANYAR, BALI",8,190,12,202
https://kawalpemilu.org#53567,"SAYAN, UBUD, GIANYAR, BALI",9,210,8,218
https://kawalpemilu.org#53567,"SAYAN, UBUD, GIANYAR, BALI",10,211,1,212
https://kawalpemilu.org#53567,"SAYAN, UBUD, GIANYAR, BALI",11,213,10,223
https://kawalpemilu.org#53567,"SAYAN, UBUD, GIANYAR, BALI",12,218,4,222
https://kawalpemilu.org#53567,"SAYAN, UBUD, GIANYAR, BALI",13,208,7,215
https://kawalpemilu.org#53567,"SAYAN, UBUD, GIANYAR, BALI",14,217,12,229
https://kawalpemilu.org#53567,"SAYAN, UBUD, GIANYAR, BALI",15,214,6,220
https://kawalpemilu.org#53567,"SAYAN, UBUD, GIANYAR, BALI",16,217,2,219
https://kawalpemilu.org#53567,"SAYAN, UBUD, GIANYAR, BALI",18,271,5,276
https://kawalpemilu.org#53567,"SAYAN, UBUD, GIANYAR, BALI",19,283,2,285
https://kawalpemilu.org#53567,"SAYAN, UBUD, GIANYAR, BALI",20,262,3,265
https://kawalpemilu.org#53567,"SAYAN, UBUD, GIANYAR, BALI",21,291,2,293
https://kawalpemilu.org#53567,"SAYAN, UBUD, GIANYAR, BALI",22,273,2,275
https://kawalpemilu.org#53567,"SAYAN, UBUD, GIANYAR, BALI",23,268,3,271
https://kawalpemilu.org#53569,"KELIKI, TEGALALLANG, GIANYAR, BALI",1,246,8,254
https://kawalpemilu.org#53569,"KELIKI, TEGALALLANG, GIANYAR, BALI",2,244,6,250
https://kawalpemilu.org#53569,"KELIKI, TEGALALLANG, GIANYAR, BALI",3,240,3,243
https://kawalpemilu.org#53569,"KELIKI, TEGALALLANG, GIANYAR, BALI",4,182,4,186
https://kawalpemilu.org#53569,"KELIKI, TEGALALLANG, GIANYAR, BALI",5,190,11,201
https://kawalpemilu.org#53569,"KELIKI, TEGALALLANG, GIANYAR, BALI",6,173,14,187
https://kawalpemilu.org#53569,"KELIKI, TEGALALLANG, GIANYAR, BALI",7,196,5,201
https://kawalpemilu.org#53569,"KELIKI, TEGALALLANG, GIANYAR, BALI",8,233,6,239
https://kawalpemilu.org#53569,"KELIKI, TEGALALLANG, GIANYAR, BALI",9,235,17,252
https://kawalpemilu.org#53569,"KELIKI, TEGALALLANG, GIANYAR, BALI",10,182,6,188
https://kawalpemilu.org#53569,"KELIKI, TEGALALLANG, GIANYAR, BALI",11,177,3,180
https://kawalpemilu.org#53569,"KELIKI, TEGALALLANG, GIANYAR, BALI",12,153,10,163
https://kawalpemilu.org#53569,"KELIKI, TEGALALLANG, GIANYAR, BALI",13,158,10,168
https://kawalpemilu.org#53569,"KELIKI, TEGALALLANG, GIANYAR, BALI",14,192,5,197
https://kawalpemilu.org#53570,"TEGALLALANG, TEGALALLANG, GIANYAR, BALI",1,277,9,286
https://kawalpemilu.org#53570,"TEGALLALANG, TEGALALLANG, GIANYAR, BALI",2,265,9,274
https://kawalpemilu.org#53570,"TEGALLALANG, TEGALALLANG, GIANYAR, BALI",3,265,2,267
https://kawalpemilu.org#53570,"TEGALLALANG, TEGALALLANG, GIANYAR, BALI",4,257,7,264
https://kawalpemilu.org#53570,"TEGALLALANG, TEGALALLANG, GIANYAR, BALI",5,243,10,253
https://kawalpemilu.org#53570,"TEGALLALANG, TEGALALLANG, GIANYAR, BALI",6,156,2,158
https://kawalpemilu.org#53570,"TEGALLALANG, TEGALALLANG, GIANYAR, BALI",7,145,11,156
https://kawalpemilu.org#53570,"TEGALLALANG, TEGALALLANG, GIANYAR, BALI",8,207,11,218
https://kawalpemilu.org#53570,"TEGALLALANG, TEGALALLANG, GIANYAR, BALI",9,208,7,215
https://kawalpemilu.org#53570,"TEGALLALANG, TEGALALLANG, GIANYAR, BALI",10,213,4,217
https://kawalpemilu.org#53570,"TEGALLALANG, TEGALALLANG, GIANYAR, BALI",11,207,4,211
https://kawalpemilu.org#53570,"TEGALLALANG, TEGALALLANG, GIANYAR, BALI",12,271,6,277
https://kawalpemilu.org#53570,"TEGALLALANG, TEGALALLANG, GIANYAR, BALI",13,276,2,278
https://kawalpemilu.org#53570,"TEGALLALANG, TEGALALLANG, GIANYAR, BALI",14,263,2,265
https://kawalpemilu.org#53570,"TEGALLALANG, TEGALALLANG, GIANYAR, BALI",16,222,6,228
https://kawalpemilu.org#53570,"TEGALLALANG, TEGALALLANG, GIANYAR, BALI",17,222,2,224
https://kawalpemilu.org#53570,"TEGALLALANG, TEGALALLANG, GIANYAR, BALI",18,259,12,271
https://kawalpemilu.org#53570,"TEGALLALANG, TEGALALLANG, GIANYAR, BALI",19,270,6,276
https://kawalpemilu.org#53570,"TEGALLALANG, TEGALALLANG, GIANYAR, BALI",20,254,7,261
https://kawalpemilu.org#53570,"TEGALLALANG, TEGALALLANG, GIANYAR, BALI",21,224,6,230
https://kawalpemilu.org#53570,"TEGALLALANG, TEGALALLANG, GIANYAR, BALI",22,228,6,234
https://kawalpemilu.org#53570,"TEGALLALANG, TEGALALLANG, GIANYAR, BALI",23,270,4,274
https://kawalpemilu.org#53570,"TEGALLALANG, TEGALALLANG, GIANYAR, BALI",24,251,8,259
https://kawalpemilu.org#53570,"TEGALLALANG, TEGALALLANG, GIANYAR, BALI",25,202,3,205
https://kawalpemilu.org#53570,"TEGALLALANG, TEGALALLANG, GIANYAR, BALI",26,193,8,201
https://kawalpemilu.org#53570,"TEGALLALANG, TEGALALLANG, GIANYAR, BALI",27,231,7,238
https://kawalpemilu.org#53570,"TEGALLALANG, TEGALALLANG, GIANYAR, BALI",28,239,2,241
https://kawalpemilu.org#53570,"TEGALLALANG, TEGALALLANG, GIANYAR, BALI",29,235,1,236
https://kawalpemilu.org#53571,"KENDERAN, TEGALALLANG, GIANYAR, BALI",1,217,5,222
https://kawalpemilu.org#53571,"KENDERAN, TEGALALLANG, GIANYAR, BALI",2,221,6,227
https://kawalpemilu.org#53571,"KENDERAN, TEGALALLANG, GIANYAR, BALI",3,183,8,191
https://kawalpemilu.org#53571,"KENDERAN, TEGALALLANG, GIANYAR, BALI",4,193,6,199
https://kawalpemilu.org#53571,"KENDERAN, TEGALALLANG, GIANYAR, BALI",5,215,1,216
https://kawalpemilu.org#53571,"KENDERAN, TEGALALLANG, GIANYAR, BALI",6,185,5,190
https://kawalpemilu.org#53571,"KENDERAN, TEGALALLANG, GIANYAR, BALI",7,252,10,262
https://kawalpemilu.org#53571,"KENDERAN, TEGALALLANG, GIANYAR, BALI",8,209,17,226
https://kawalpemilu.org#53571,"KENDERAN, TEGALALLANG, GIANYAR, BALI",9,229,5,234
https://kawalpemilu.org#53571,"KENDERAN, TEGALALLANG, GIANYAR, BALI",10,223,13,236
https://kawalpemilu.org#53571,"KENDERAN, TEGALALLANG, GIANYAR, BALI",11,190,3,193
https://kawalpemilu.org#53571,"KENDERAN, TEGALALLANG, GIANYAR, BALI",12,182,0,182
https://kawalpemilu.org#53571,"KENDERAN, TEGALALLANG, GIANYAR, BALI",13,260,1,261
https://kawalpemilu.org#53571,"KENDERAN, TEGALALLANG, GIANYAR, BALI",14,243,9,252
https://kawalpemilu.org#53571,"KENDERAN, TEGALALLANG, GIANYAR, BALI",15,265,5,270
https://kawalpemilu.org#53571,"KENDERAN, TEGALALLANG, GIANYAR, BALI",16,229,14,243
https://kawalpemilu.org#53571,"KENDERAN, TEGALALLANG, GIANYAR, BALI",17,271,5,276
https://kawalpemilu.org#53572,"KEDISAN, TEGALALLANG, GIANYAR, BALI",2,173,0,173
https://kawalpemilu.org#53572,"KEDISAN, TEGALALLANG, GIANYAR, BALI",3,162,8,170
https://kawalpemilu.org#53572,"KEDISAN, TEGALALLANG, GIANYAR, BALI",4,248,6,254
https://kawalpemilu.org#53572,"KEDISAN, TEGALALLANG, GIANYAR, BALI",5,245,8,253
https://kawalpemilu.org#53572,"KEDISAN, TEGALALLANG, GIANYAR, BALI",7,231,2,233
https://kawalpemilu.org#53572,"KEDISAN, TEGALALLANG, GIANYAR, BALI",8,215,7,222
https://kawalpemilu.org#53572,"KEDISAN, TEGALALLANG, GIANYAR, BALI",9,218,9,227
https://kawalpemilu.org#53572,"KEDISAN, TEGALALLANG, GIANYAR, BALI",10,214,11,225
https://kawalpemilu.org#53572,"KEDISAN, TEGALALLANG, GIANYAR, BALI",11,247,8,255
https://kawalpemilu.org#53572,"KEDISAN, TEGALALLANG, GIANYAR, BALI",12,249,4,253
https://kawalpemilu.org#53572,"KEDISAN, TEGALALLANG, GIANYAR, BALI",13,250,13,263
https://kawalpemilu.org#53572,"KEDISAN, TEGALALLANG, GIANYAR, BALI",14,222,7,229
https://kawalpemilu.org#53572,"KEDISAN, TEGALALLANG, GIANYAR, BALI",15,265,14,279
https://kawalpemilu.org#53572,"KEDISAN, TEGALALLANG, GIANYAR, BALI",16,279,8,287
https://kawalpemilu.org#53572,"KEDISAN, TEGALALLANG, GIANYAR, BALI",17,211,8,219
https://kawalpemilu.org#53572,"KEDISAN, TEGALALLANG, GIANYAR, BALI",18,261,4,265
https://kawalpemilu.org#53573,"PUPUAN, TEGALALLANG, GIANYAR, BALI",1,262,12,274
https://kawalpemilu.org#53573,"PUPUAN, TEGALALLANG, GIANYAR, BALI",2,275,9,284
https://kawalpemilu.org#53573,"PUPUAN, TEGALALLANG, GIANYAR, BALI",3,258,8,266
https://kawalpemilu.org#53573,"PUPUAN, TEGALALLANG, GIANYAR, BALI",4,264,14,278
https://kawalpemilu.org#53573,"PUPUAN, TEGALALLANG, GIANYAR, BALI",5,154,31,185
https://kawalpemilu.org#53573,"PUPUAN, TEGALALLANG, GIANYAR, BALI",6,160,22,182
https://kawalpemilu.org#53573,"PUPUAN, TEGALALLANG, GIANYAR, BALI",7,207,4,211
https://kawalpemilu.org#53573,"PUPUAN, TEGALALLANG, GIANYAR, BALI",8,204,3,207
https://kawalpemilu.org#53573,"PUPUAN, TEGALALLANG, GIANYAR, BALI",9,151,30,181
https://kawalpemilu.org#53573,"PUPUAN, TEGALALLANG, GIANYAR, BALI",10,162,15,177
https://kawalpemilu.org#53573,"PUPUAN, TEGALALLANG, GIANYAR, BALI",11,210,1,211
https://kawalpemilu.org#53573,"PUPUAN, TEGALALLANG, GIANYAR, BALI",12,195,1,196
https://kawalpemilu.org#53573,"PUPUAN, TEGALALLANG, GIANYAR, BALI",13,237,6,243
https://kawalpemilu.org#53573,"PUPUAN, TEGALALLANG, GIANYAR, BALI",14,231,7,238
https://kawalpemilu.org#53573,"PUPUAN, TEGALALLANG, GIANYAR, BALI",15,237,2,239
https://kawalpemilu.org#53573,"PUPUAN, TEGALALLANG, GIANYAR, BALI",16,240,9,249
https://kawalpemilu.org#53573,"PUPUAN, TEGALALLANG, GIANYAR, BALI",17,228,6,234
https://kawalpemilu.org#53573,"PUPUAN, TEGALALLANG, GIANYAR, BALI",18,241,10,251
https://kawalpemilu.org#53573,"PUPUAN, TEGALALLANG, GIANYAR, BALI",19,231,7,238
https://kawalpemilu.org#53573,"PUPUAN, TEGALALLANG, GIANYAR, BALI",20,245,9,254
https://kawalpemilu.org#53573,"PUPUAN, TEGALALLANG, GIANYAR, BALI",21,224,23,247
https://kawalpemilu.org#53574,"SEBATU, TEGALALLANG, GIANYAR, BALI",1,238,6,244
https://kawalpemilu.org#53574,"SEBATU, TEGALALLANG, GIANYAR, BALI",2,256,1,257
https://kawalpemilu.org#53574,"SEBATU, TEGALALLANG, GIANYAR, BALI",3,224,2,226
https://kawalpemilu.org#53574,"SEBATU, TEGALALLANG, GIANYAR, BALI",4,217,3,220
https://kawalpemilu.org#53574,"SEBATU, TEGALALLANG, GIANYAR, BALI",5,216,4,220
https://kawalpemilu.org#53574,"SEBATU, TEGALALLANG, GIANYAR, BALI",6,264,10,274
https://kawalpemilu.org#53574,"SEBATU, TEGALALLANG, GIANYAR, BALI",7,247,29,276
https://kawalpemilu.org#53574,"SEBATU, TEGALALLANG, GIANYAR, BALI",8,247,24,271
https://kawalpemilu.org#53574,"SEBATU, TEGALALLANG, GIANYAR, BALI",9,258,18,276
https://kawalpemilu.org#53574,"SEBATU, TEGALALLANG, GIANYAR, BALI",10,261,10,271
https://kawalpemilu.org#53574,"SEBATU, TEGALALLANG, GIANYAR, BALI",11,166,10,176
https://kawalpemilu.org#53574,"SEBATU, TEGALALLANG, GIANYAR, BALI",12,142,12,154
https://kawalpemilu.org#53574,"SEBATU, TEGALALLANG, GIANYAR, BALI",13,280,2,282
https://kawalpemilu.org#53574,"SEBATU, TEGALALLANG, GIANYAR, BALI",14,200,0,200
https://kawalpemilu.org#53574,"SEBATU, TEGALALLANG, GIANYAR, BALI",15,204,14,218
https://kawalpemilu.org#53574,"SEBATU, TEGALALLANG, GIANYAR, BALI",16,217,11,228
https://kawalpemilu.org#53574,"SEBATU, TEGALALLANG, GIANYAR, BALI",17,216,9,225
https://kawalpemilu.org#53574,"SEBATU, TEGALALLANG, GIANYAR, BALI",18,226,10,236
https://kawalpemilu.org#53574,"SEBATU, TEGALALLANG, GIANYAR, BALI",19,159,11,170
https://kawalpemilu.org#53574,"SEBATU, TEGALALLANG, GIANYAR, BALI",20,174,19,193
https://kawalpemilu.org#53574,"SEBATU, TEGALALLANG, GIANYAR, BALI",21,180,15,195
https://kawalpemilu.org#53574,"SEBATU, TEGALALLANG, GIANYAR, BALI",22,222,6,228
https://kawalpemilu.org#53574,"SEBATU, TEGALALLANG, GIANYAR, BALI",23,220,3,223
https://kawalpemilu.org#53574,"SEBATU, TEGALALLANG, GIANYAR, BALI",24,223,4,227
https://kawalpemilu.org#53574,"SEBATU, TEGALALLANG, GIANYAR, BALI",25,209,1,210
https://kawalpemilu.org#53574,"SEBATU, TEGALALLANG, GIANYAR, BALI",26,225,1,226
https://kawalpemilu.org#53574,"SEBATU, TEGALALLANG, GIANYAR, BALI",27,215,2,217
https://kawalpemilu.org#53574,"SEBATU, TEGALALLANG, GIANYAR, BALI",28,146,0,146
https://kawalpemilu.org#53575,"TARO, TEGALALLANG, GIANYAR, BALI",1,257,13,270
https://kawalpemilu.org#53575,"TARO, TEGALALLANG, GIANYAR, BALI",2,277,5,282
https://kawalpemilu.org#53575,"TARO, TEGALALLANG, GIANYAR, BALI",3,214,24,238
https://kawalpemilu.org#53575,"TARO, TEGALALLANG, GIANYAR, BALI",4,197,16,213
https://kawalpemilu.org#53575,"TARO, TEGALALLANG, GIANYAR, BALI",5,189,27,216
https://kawalpemilu.org#53575,"TARO, TEGALALLANG, GIANYAR, BALI",6,205,23,228
https://kawalpemilu.org#53575,"TARO, TEGALALLANG, GIANYAR, BALI",7,225,14,239
https://kawalpemilu.org#53575,"TARO, TEGALALLANG, GIANYAR, BALI",8,222,6,228
https://kawalpemilu.org#53575,"TARO, TEGALALLANG, GIANYAR, BALI",9,242,13,255
https://kawalpemilu.org#53575,"TARO, TEGALALLANG, GIANYAR, BALI",10,225,12,237
https://kawalpemilu.org#53575,"TARO, TEGALALLANG, GIANYAR, BALI",11,239,3,242
https://kawalpemilu.org#53575,"TARO, TEGALALLANG, GIANYAR, BALI",12,225,11,236
https://kawalpemilu.org#53575,"TARO, TEGALALLANG, GIANYAR, BALI",13,237,7,244
https://kawalpemilu.org#53575,"TARO, TEGALALLANG, GIANYAR, BALI",14,221,17,238
https://kawalpemilu.org#53575,"TARO, TEGALALLANG, GIANYAR, BALI",15,244,8,252
https://kawalpemilu.org#53575,"TARO, TEGALALLANG, GIANYAR, BALI",16,215,18,237
https://kawalpemilu.org#53575,"TARO, TEGALALLANG, GIANYAR, BALI",17,249,1,250
https://kawalpemilu.org#53575,"TARO, TEGALALLANG, GIANYAR, BALI",18,236,0,236
https://kawalpemilu.org#53575,"TARO, TEGALALLANG, GIANYAR, BALI",19,159,21,130
https://kawalpemilu.org#53575,"TARO, TEGALALLANG, GIANYAR, BALI",20,191,12,203
https://kawalpemilu.org#53575,"TARO, TEGALALLANG, GIANYAR, BALI",21,274,14,288
https://kawalpemilu.org#53575,"TARO, TEGALALLANG, GIANYAR, BALI",22,271,16,287
https://kawalpemilu.org#53575,"TARO, TEGALALLANG, GIANYAR, BALI",23,220,7,227
https://kawalpemilu.org#53575,"TARO, TEGALALLANG, GIANYAR, BALI",24,203,23,226
https://kawalpemilu.org#53575,"TARO, TEGALALLANG, GIANYAR, BALI",25,163,5,168
https://kawalpemilu.org#53575,"TARO, TEGALALLANG, GIANYAR, BALI",26,159,3,162
https://kawalpemilu.org#53575,"TARO, TEGALALLANG, GIANYAR, BALI",27,163,5,168
https://kawalpemilu.org#53575,"TARO, TEGALALLANG, GIANYAR, BALI",28,142,9,151
https://kawalpemilu.org#53575,"TARO, TEGALALLANG, GIANYAR, BALI",29,153,17,170
https://kawalpemilu.org#53575,"TARO, TEGALALLANG, GIANYAR, BALI",30,179,2,181
https://kawalpemilu.org#53575,"TARO, TEGALALLANG, GIANYAR, BALI",31,198,36,234
https://kawalpemilu.org#53575,"TARO, TEGALALLANG, GIANYAR, BALI",32,203,17,220
https://kawalpemilu.org#53575,"TARO, TEGALALLANG, GIANYAR, BALI",33,190,0,190
https://kawalpemilu.org#53575,"TARO, TEGALALLANG, GIANYAR, BALI",34,179,15,194
https://kawalpemilu.org#53577,"MELINGGIH, PAYANGAN, GIANYAR, BALI",1,267,7,274
https://kawalpemilu.org#53577,"MELINGGIH, PAYANGAN, GIANYAR, BALI",2,272,2,274
https://kawalpemilu.org#53577,"MELINGGIH, PAYANGAN, GIANYAR, BALI",3,255,4,259
https://kawalpemilu.org#53577,"MELINGGIH, PAYANGAN, GIANYAR, BALI",4,261,5,266
https://kawalpemilu.org#53577,"MELINGGIH, PAYANGAN, GIANYAR, BALI",5,281,3,284
https://kawalpemilu.org#53577,"MELINGGIH, PAYANGAN, GIANYAR, BALI",6,231,4,235
https://kawalpemilu.org#53577,"MELINGGIH, PAYANGAN, GIANYAR, BALI",7,233,2,235
https://kawalpemilu.org#53577,"MELINGGIH, PAYANGAN, GIANYAR, BALI",8,224,3,227
https://kawalpemilu.org#53577,"MELINGGIH, PAYANGAN, GIANYAR, BALI",9,226,1,227
https://kawalpemilu.org#53577,"MELINGGIH, PAYANGAN, GIANYAR, BALI",10,234,0,234
https://kawalpemilu.org#53577,"MELINGGIH, PAYANGAN, GIANYAR, BALI",12,241,1,242
https://kawalpemilu.org#53577,"MELINGGIH, PAYANGAN, GIANYAR, BALI",13,239,0,239
https://kawalpemilu.org#53577,"MELINGGIH, PAYANGAN, GIANYAR, BALI",14,237,1,238
https://kawalpemilu.org#53577,"MELINGGIH, PAYANGAN, GIANYAR, BALI",15,238,7,245
https://kawalpemilu.org#53577,"MELINGGIH, PAYANGAN, GIANYAR, BALI",16,213,16,229
https://kawalpemilu.org#53577,"MELINGGIH, PAYANGAN, GIANYAR, BALI",17,208,9,217
https://kawalpemilu.org#53577,"MELINGGIH, PAYANGAN, GIANYAR, BALI",18,207,19,226
https://kawalpemilu.org#53577,"MELINGGIH, PAYANGAN, GIANYAR, BALI",19,217,8,225
https://kawalpemilu.org#53577,"MELINGGIH, PAYANGAN, GIANYAR, BALI",20,227,18,245
https://kawalpemilu.org#53577,"MELINGGIH, PAYANGAN, GIANYAR, BALI",21,219,6,225
https://kawalpemilu.org#53577,"MELINGGIH, PAYANGAN, GIANYAR, BALI",22,203,20,223
https://kawalpemilu.org#53578,"KELUSA, PAYANGAN, GIANYAR, BALI",1,229,4,233
https://kawalpemilu.org#53578,"KELUSA, PAYANGAN, GIANYAR, BALI",2,226,3,229
https://kawalpemilu.org#53578,"KELUSA, PAYANGAN, GIANYAR, BALI",3,169,6,175
https://kawalpemilu.org#53578,"KELUSA, PAYANGAN, GIANYAR, BALI",4,162,10,172
https://kawalpemilu.org#53578,"KELUSA, PAYANGAN, GIANYAR, BALI",5,196,4,200
https://kawalpemilu.org#53578,"KELUSA, PAYANGAN, GIANYAR, BALI",6,189,7,196
https://kawalpemilu.org#53578,"KELUSA, PAYANGAN, GIANYAR, BALI",7,199,2,201
https://kawalpemilu.org#53578,"KELUSA, PAYANGAN, GIANYAR, BALI",8,202,2,204
https://kawalpemilu.org#53578,"KELUSA, PAYANGAN, GIANYAR, BALI",9,255,7,262
https://kawalpemilu.org#53578,"KELUSA, PAYANGAN, GIANYAR, BALI",10,239,2,241
https://kawalpemilu.org#53578,"KELUSA, PAYANGAN, GIANYAR, BALI",11,234,10,244
https://kawalpemilu.org#53578,"KELUSA, PAYANGAN, GIANYAR, BALI",12,203,10,213
https://kawalpemilu.org#53578,"KELUSA, PAYANGAN, GIANYAR, BALI",13,197,15,212
https://kawalpemilu.org#53578,"KELUSA, PAYANGAN, GIANYAR, BALI",14,208,12,220
https://kawalpemilu.org#53578,"KELUSA, PAYANGAN, GIANYAR, BALI",15,215,12,227
https://kawalpemilu.org#53579,"BUKIAN, PAYANGAN, GIANYAR, BALI",1,209,23,232
https://kawalpemilu.org#53579,"BUKIAN, PAYANGAN, GIANYAR, BALI",2,220,8,228
https://kawalpemilu.org#53579,"BUKIAN, PAYANGAN, GIANYAR, BALI",3,257,9,266
https://kawalpemilu.org#53579,"BUKIAN, PAYANGAN, GIANYAR, BALI",4,253,1,254
https://kawalpemilu.org#53579,"BUKIAN, PAYANGAN, GIANYAR, BALI",5,263,12,279
https://kawalpemilu.org#53579,"BUKIAN, PAYANGAN, GIANYAR, BALI",6,277,2,279
https://kawalpemilu.org#53579,"BUKIAN, PAYANGAN, GIANYAR, BALI",7,258,5,263
https://kawalpemilu.org#53579,"BUKIAN, PAYANGAN, GIANYAR, BALI",8,282,1,283
https://kawalpemilu.org#53579,"BUKIAN, PAYANGAN, GIANYAR, BALI",9,193,2,195
https://kawalpemilu.org#53579,"BUKIAN, PAYANGAN, GIANYAR, BALI",10,240,8,248
https://kawalpemilu.org#53579,"BUKIAN, PAYANGAN, GIANYAR, BALI",11,231,4,235
https://kawalpemilu.org#53579,"BUKIAN, PAYANGAN, GIANYAR, BALI",12,132,3,135
https://kawalpemilu.org#53579,"BUKIAN, PAYANGAN, GIANYAR, BALI",13,261,3,264
https://kawalpemilu.org#53579,"BUKIAN, PAYANGAN, GIANYAR, BALI",14,138,4,142
https://kawalpemilu.org#53579,"BUKIAN, PAYANGAN, GIANYAR, BALI",15,245,3,248
https://kawalpemilu.org#53579,"BUKIAN, PAYANGAN, GIANYAR, BALI",16,244,6,250
https://kawalpemilu.org#53579,"BUKIAN, PAYANGAN, GIANYAR, BALI",17,237,3,240
https://kawalpemilu.org#53579,"BUKIAN, PAYANGAN, GIANYAR, BALI",18,265,2,267
https://kawalpemilu.org#53579,"BUKIAN, PAYANGAN, GIANYAR, BALI",19,247,19,266
https://kawalpemilu.org#53579,"BUKIAN, PAYANGAN, GIANYAR, BALI",20,209,11,220
https://kawalpemilu.org#53580,"PUHU, PAYANGAN, GIANYAR, BALI",1,209,5,214
https://kawalpemilu.org#53580,"PUHU, PAYANGAN, GIANYAR, BALI",2,173,4,177
https://kawalpemilu.org#53580,"PUHU, PAYANGAN, GIANYAR, BALI",3,203,5,208
https://kawalpemilu.org#53580,"PUHU, PAYANGAN, GIANYAR, BALI",4,144,3,147
https://kawalpemilu.org#53580,"PUHU, PAYANGAN, GIANYAR, BALI",5,179,0,179
https://kawalpemilu.org#53580,"PUHU, PAYANGAN, GIANYAR, BALI",6,203,12,215
https://kawalpemilu.org#53580,"PUHU, PAYANGAN, GIANYAR, BALI",7,208,9,217
https://kawalpemilu.org#53580,"PUHU, PAYANGAN, GIANYAR, BALI",8,179,10,189
https://kawalpemilu.org#53580,"PUHU, PAYANGAN, GIANYAR, BALI",9,229,8,237
https://kawalpemilu.org#53580,"PUHU, PAYANGAN, GIANYAR, BALI",10,246,6,252
https://kawalpemilu.org#53580,"PUHU, PAYANGAN, GIANYAR, BALI",11,194,14,208
https://kawalpemilu.org#53580,"PUHU, PAYANGAN, GIANYAR, BALI",12,195,10,0
https://kawalpemilu.org#53580,"PUHU, PAYANGAN, GIANYAR, BALI",13,185,5,190
https://kawalpemilu.org#53580,"PUHU, PAYANGAN, GIANYAR, BALI",14,141,5,146
https://kawalpemilu.org#53580,"PUHU, PAYANGAN, GIANYAR, BALI",15,267,0,267
https://kawalpemilu.org#53580,"PUHU, PAYANGAN, GIANYAR, BALI",16,210,8,218
https://kawalpemilu.org#53580,"PUHU, PAYANGAN, GIANYAR, BALI",17,190,13,203
https://kawalpemilu.org#53580,"PUHU, PAYANGAN, GIANYAR, BALI",18,181,1,182
https://kawalpemilu.org#53580,"PUHU, PAYANGAN, GIANYAR, BALI",19,193,8,201
https://kawalpemilu.org#53580,"PUHU, PAYANGAN, GIANYAR, BALI",20,215,7,222
https://kawalpemilu.org#53581,"BUAHAN, PAYANGAN, GIANYAR, BALI",1,215,7,222
https://kawalpemilu.org#53581,"BUAHAN, PAYANGAN, GIANYAR, BALI",2,208,8,216
https://kawalpemilu.org#53581,"BUAHAN, PAYANGAN, GIANYAR, BALI",3,203,9,212
https://kawalpemilu.org#53581,"BUAHAN, PAYANGAN, GIANYAR, BALI",4,250,3,253
https://kawalpemilu.org#53581,"BUAHAN, PAYANGAN, GIANYAR, BALI",5,220,23,243
https://kawalpemilu.org#53581,"BUAHAN, PAYANGAN, GIANYAR, BALI",6,212,23,235
https://kawalpemilu.org#53581,"BUAHAN, PAYANGAN, GIANYAR, BALI",7,224,17,241
https://kawalpemilu.org#53581,"BUAHAN, PAYANGAN, GIANYAR, BALI",8,218,20,238
https://kawalpemilu.org#53581,"BUAHAN, PAYANGAN, GIANYAR, BALI",9,243,9,252
https://kawalpemilu.org#53581,"BUAHAN, PAYANGAN, GIANYAR, BALI",10,234,7,241
https://kawalpemilu.org#53581,"BUAHAN, PAYANGAN, GIANYAR, BALI",11,207,10,217
https://kawalpemilu.org#53582,"KERTA, PAYANGAN, GIANYAR, BALI",1,170,9,179
https://kawalpemilu.org#53582,"KERTA, PAYANGAN, GIANYAR, BALI",2,175,3,178
https://kawalpemilu.org#53582,"KERTA, PAYANGAN, GIANYAR, BALI",3,190,7,197
https://kawalpemilu.org#53582,"KERTA, PAYANGAN, GIANYAR, BALI",4,191,4,195
https://kawalpemilu.org#53582,"KERTA, PAYANGAN, GIANYAR, BALI",5,173,81,254
https://kawalpemilu.org#53582,"KERTA, PAYANGAN, GIANYAR, BALI",6,226,4,230
https://kawalpemilu.org#53582,"KERTA, PAYANGAN, GIANYAR, BALI",7,221,8,229
https://kawalpemilu.org#53582,"KERTA, PAYANGAN, GIANYAR, BALI",8,207,19,226
https://kawalpemilu.org#53582,"KERTA, PAYANGAN, GIANYAR, BALI",9,254,1,257
https://kawalpemilu.org#53582,"KERTA, PAYANGAN, GIANYAR, BALI",10,238,12,250
https://kawalpemilu.org#53582,"KERTA, PAYANGAN, GIANYAR, BALI",11,236,10,246
https://kawalpemilu.org#53582,"KERTA, PAYANGAN, GIANYAR, BALI",12,219,3,222
https://kawalpemilu.org#53582,"KERTA, PAYANGAN, GIANYAR, BALI",13,224,4,228
https://kawalpemilu.org#53582,"KERTA, PAYANGAN, GIANYAR, BALI",14,218,9,227
https://kawalpemilu.org#53582,"KERTA, PAYANGAN, GIANYAR, BALI",15,260,3,263
https://kawalpemilu.org#53582,"KERTA, PAYANGAN, GIANYAR, BALI",16,180,39,219
https://kawalpemilu.org#53582,"KERTA, PAYANGAN, GIANYAR, BALI",17,270,5,275
https://kawalpemilu.org#53582,"KERTA, PAYANGAN, GIANYAR, BALI",18,255,6,261
https://kawalpemilu.org#53582,"KERTA, PAYANGAN, GIANYAR, BALI",19,205,0,205
https://kawalpemilu.org#53583,"MELINGGIH KELOD, PAYANGAN, GIANYAR, BALI",1,215,4,219
https://kawalpemilu.org#53583,"MELINGGIH KELOD, PAYANGAN, GIANYAR, BALI",2,220,2,222
https://kawalpemilu.org#53583,"MELINGGIH KELOD, PAYANGAN, GIANYAR, BALI",3,215,3,218
https://kawalpemilu.org#53583,"MELINGGIH KELOD, PAYANGAN, GIANYAR, BALI",4,150,7,157
https://kawalpemilu.org#53583,"MELINGGIH KELOD, PAYANGAN, GIANYAR, BALI",5,146,4,150
https://kawalpemilu.org#53583,"MELINGGIH KELOD, PAYANGAN, GIANYAR, BALI",6,241,11,252
https://kawalpemilu.org#53583,"MELINGGIH KELOD, PAYANGAN, GIANYAR, BALI",7,225,18,243
https://kawalpemilu.org#53583,"MELINGGIH KELOD, PAYANGAN, GIANYAR, BALI",8,265,1,266
https://kawalpemilu.org#53583,"MELINGGIH KELOD, PAYANGAN, GIANYAR, BALI",9,240,2,242
https://kawalpemilu.org#53583,"MELINGGIH KELOD, PAYANGAN, GIANYAR, BALI",10,235,7,242
https://kawalpemilu.org#53583,"MELINGGIH KELOD, PAYANGAN, GIANYAR, BALI",11,231,1,232
https://kawalpemilu.org#53583,"MELINGGIH KELOD, PAYANGAN, GIANYAR, BALI",12,219,5,224
https://kawalpemilu.org#53583,"MELINGGIH KELOD, PAYANGAN, GIANYAR, BALI",13,240,6,246
https://kawalpemilu.org#53583,"MELINGGIH KELOD, PAYANGAN, GIANYAR, BALI",14,241,5,246
https://kawalpemilu.org#53584,"BUAHAN KAJA, PAYANGAN, GIANYAR, BALI",1,224,7,231
https://kawalpemilu.org#53584,"BUAHAN KAJA, PAYANGAN, GIANYAR, BALI",2,226,3,229
https://kawalpemilu.org#53584,"BUAHAN KAJA, PAYANGAN, GIANYAR, BALI",3,246,4,250
https://kawalpemilu.org#53584,"BUAHAN KAJA, PAYANGAN, GIANYAR, BALI",4,232,0,232
https://kawalpemilu.org#53584,"BUAHAN KAJA, PAYANGAN, GIANYAR, BALI",5,172,11,183
https://kawalpemilu.org#53584,"BUAHAN KAJA, PAYANGAN, GIANYAR, BALI",6,166,4,170
https://kawalpemilu.org#53584,"BUAHAN KAJA, PAYANGAN, GIANYAR, BALI",7,165,4,169
https://kawalpemilu.org#53584,"BUAHAN KAJA, PAYANGAN, GIANYAR, BALI",8,280,3,283
https://kawalpemilu.org#53584,"BUAHAN KAJA, PAYANGAN, GIANYAR, BALI",9,285,0,285
https://kawalpemilu.org#53584,"BUAHAN KAJA, PAYANGAN, GIANYAR, BALI",10,197,7,204
https://kawalpemilu.org#53584,"BUAHAN KAJA, PAYANGAN, GIANYAR, BALI",11,144,7,151
https://kawalpemilu.org#53584,"BUAHAN KAJA, PAYANGAN, GIANYAR, BALI",12,141,3,144
https://kawalpemilu.org#53584,"BUAHAN KAJA, PAYANGAN, GIANYAR, BALI",13,186,0,186
https://kawalpemilu.org#53584,"BUAHAN KAJA, PAYANGAN, GIANYAR, BALI",14,180,1,181
https://kawalpemilu.org#53584,"BUAHAN KAJA, PAYANGAN, GIANYAR, BALI",15,234,5,239
https://kawalpemilu.org#53584,"BUAHAN KAJA, PAYANGAN, GIANYAR, BALI",16,252,1,253
https://kawalpemilu.org#53585,"BRESELA, PAYANGAN, GIANYAR, BALI",1,238,18,256
https://kawalpemilu.org#53585,"BRESELA, PAYANGAN, GIANYAR, BALI",2,226,21,247
https://kawalpemilu.org#53585,"BRESELA, PAYANGAN, GIANYAR, BALI",3,265,9,274
https://kawalpemilu.org#53585,"BRESELA, PAYANGAN, GIANYAR, BALI",4,168,1,169
https://kawalpemilu.org#53585,"BRESELA, PAYANGAN, GIANYAR, BALI",5,156,10,166
https://kawalpemilu.org#53585,"BRESELA, PAYANGAN, GIANYAR, BALI",6,218,6,224
https://kawalpemilu.org#53585,"BRESELA, PAYANGAN, GIANYAR, BALI",7,218,16,234
https://kawalpemilu.org#53585,"BRESELA, PAYANGAN, GIANYAR, BALI",8,243,7,250
https://kawalpemilu.org#53588,"SAKTI, NUSA PENIDA, KLUNGKUNG, BALI",1,157,3,160
https://kawalpemilu.org#53588,"SAKTI, NUSA PENIDA, KLUNGKUNG, BALI",2,154,12,166
https://kawalpemilu.org#53588,"SAKTI, NUSA PENIDA, KLUNGKUNG, BALI",3,195,2,197
https://kawalpemilu.org#53588,"SAKTI, NUSA PENIDA, KLUNGKUNG, BALI",4,187,7,194
https://kawalpemilu.org#53588,"SAKTI, NUSA PENIDA, KLUNGKUNG, BALI",5,133,13,146
https://kawalpemilu.org#53588,"SAKTI, NUSA PENIDA, KLUNGKUNG, BALI",6,141,21,135
https://kawalpemilu.org#53588,"SAKTI, NUSA PENIDA, KLUNGKUNG, BALI",7,42,209,251
https://kawalpemilu.org#53588,"SAKTI, NUSA PENIDA, KLUNGKUNG, BALI",8,0,0,0
https://kawalpemilu.org#53588,"SAKTI, NUSA PENIDA, KLUNGKUNG, BALI",9,133,2,135
https://kawalpemilu.org#53588,"SAKTI, NUSA PENIDA, KLUNGKUNG, BALI",10,138,5,143
https://kawalpemilu.org#53588,"SAKTI, NUSA PENIDA, KLUNGKUNG, BALI",11,219,6,225
https://kawalpemilu.org#53588,"SAKTI, NUSA PENIDA, KLUNGKUNG, BALI",12,190,17,207
https://kawalpemilu.org#53588,"SAKTI, NUSA PENIDA, KLUNGKUNG, BALI",13,155,7,162
https://kawalpemilu.org#53588,"SAKTI, NUSA PENIDA, KLUNGKUNG, BALI",14,192,9,201
https://kawalpemilu.org#53589,"BATUMADEG, NUSA PENIDA, KLUNGKUNG, BALI",1,236,13,249
https://kawalpemilu.org#53589,"BATUMADEG, NUSA PENIDA, KLUNGKUNG, BALI",2,198,5,203
https://kawalpemilu.org#53589,"BATUMADEG, NUSA PENIDA, KLUNGKUNG, BALI",3,168,38,206
https://kawalpemilu.org#53589,"BATUMADEG, NUSA PENIDA, KLUNGKUNG, BALI",4,155,35,190
https://kawalpemilu.org#53589,"BATUMADEG, NUSA PENIDA, KLUNGKUNG, BALI",5,199,17,216
https://kawalpemilu.org#53589,"BATUMADEG, NUSA PENIDA, KLUNGKUNG, BALI",6,197,0,179
https://kawalpemilu.org#53589,"BATUMADEG, NUSA PENIDA, KLUNGKUNG, BALI",7,199,23,222
https://kawalpemilu.org#53589,"BATUMADEG, NUSA PENIDA, KLUNGKUNG, BALI",8,209,0,209
https://kawalpemilu.org#53590,"KLUMPU, NUSA PENIDA, KLUNGKUNG, BALI",1,231,7,238
https://kawalpemilu.org#53590,"KLUMPU, NUSA PENIDA, KLUNGKUNG, BALI",2,194,19,213
https://kawalpemilu.org#53590,"KLUMPU, NUSA PENIDA, KLUNGKUNG, BALI",3,67,86,153
https://kawalpemilu.org#53590,"KLUMPU, NUSA PENIDA, KLUNGKUNG, BALI",4,60,91,151
https://kawalpemilu.org#53590,"KLUMPU, NUSA PENIDA, KLUNGKUNG, BALI",5,198,34,232
https://kawalpemilu.org#53590,"KLUMPU, NUSA PENIDA, KLUNGKUNG, BALI",6,154,15,169
https://kawalpemilu.org#53590,"KLUMPU, NUSA PENIDA, KLUNGKUNG, BALI",7,136,4,140
https://kawalpemilu.org#53590,"KLUMPU, NUSA PENIDA, KLUNGKUNG, BALI",8,145,5,150
https://kawalpemilu.org#53590,"KLUMPU, NUSA PENIDA, KLUNGKUNG, BALI",9,216,0,216
https://kawalpemilu.org#53590,"KLUMPU, NUSA PENIDA, KLUNGKUNG, BALI",10,217,1,218
https://kawalpemilu.org#53590,"KLUMPU, NUSA PENIDA, KLUNGKUNG, BALI",11,115,72,187
https://kawalpemilu.org#53590,"KLUMPU, NUSA PENIDA, KLUNGKUNG, BALI",12,211,13,224
https://kawalpemilu.org#53590,"KLUMPU, NUSA PENIDA, KLUNGKUNG, BALI",13,243,18,261
https://kawalpemilu.org#53590,"KLUMPU, NUSA PENIDA, KLUNGKUNG, BALI",14,253,4,257
https://kawalpemilu.org#53591,"BATUKANDIK, NUSA PENIDA, KLUNGKUNG, BALI",1,171,9,180
https://kawalpemilu.org#53591,"BATUKANDIK, NUSA PENIDA, KLUNGKUNG, BALI",2,150,13,163
https://kawalpemilu.org#53591,"BATUKANDIK, NUSA PENIDA, KLUNGKUNG, BALI",3,153,7,160
https://kawalpemilu.org#53591,"BATUKANDIK, NUSA PENIDA, KLUNGKUNG, BALI",4,148,6,154
https://kawalpemilu.org#53591,"BATUKANDIK, NUSA PENIDA, KLUNGKUNG, BALI",5,191,3,194
https://kawalpemilu.org#53591,"BATUKANDIK, NUSA PENIDA, KLUNGKUNG, BALI",6,149,5,154
https://kawalpemilu.org#53591,"BATUKANDIK, NUSA PENIDA, KLUNGKUNG, BALI",7,152,54,206
https://kawalpemilu.org#53591,"BATUKANDIK, NUSA PENIDA, KLUNGKUNG, BALI",8,160,42,202
https://kawalpemilu.org#53591,"BATUKANDIK, NUSA PENIDA, KLUNGKUNG, BALI",9,226,30,256
https://kawalpemilu.org#53591,"BATUKANDIK, NUSA PENIDA, KLUNGKUNG, BALI",10,229,5,234
https://kawalpemilu.org#53591,"BATUKANDIK, NUSA PENIDA, KLUNGKUNG, BALI",11,203,33,236
https://kawalpemilu.org#53591,"BATUKANDIK, NUSA PENIDA, KLUNGKUNG, BALI",12,241,17,258
https://kawalpemilu.org#53591,"BATUKANDIK, NUSA PENIDA, KLUNGKUNG, BALI",13,113,37,150
https://kawalpemilu.org#53591,"BATUKANDIK, NUSA PENIDA, KLUNGKUNG, BALI",14,126,34,160
https://kawalpemilu.org#53591,"BATUKANDIK, NUSA PENIDA, KLUNGKUNG, BALI",15,88,56,144
https://kawalpemilu.org#53591,"BATUKANDIK, NUSA PENIDA, KLUNGKUNG, BALI",16,84,42,126
https://kawalpemilu.org#53591,"BATUKANDIK, NUSA PENIDA, KLUNGKUNG, BALI",17,137,4,141
https://kawalpemilu.org#53591,"BATUKANDIK, NUSA PENIDA, KLUNGKUNG, BALI",18,138,5,143
https://kawalpemilu.org#53592,"SEKARTAJI, NUSA PENIDA, KLUNGKUNG, BALI",1,73,0,73
https://kawalpemilu.org#53592,"SEKARTAJI, NUSA PENIDA, KLUNGKUNG, BALI",2,159,29,179
https://kawalpemilu.org#53592,"SEKARTAJI, NUSA PENIDA, KLUNGKUNG, BALI",3,193,17,210
https://kawalpemilu.org#53592,"SEKARTAJI, NUSA PENIDA, KLUNGKUNG, BALI",4,222,44,266
https://kawalpemilu.org#53592,"SEKARTAJI, NUSA PENIDA, KLUNGKUNG, BALI",5,221,36,257
https://kawalpemilu.org#53592,"SEKARTAJI, NUSA PENIDA, KLUNGKUNG, BALI",6,183,18,201
https://kawalpemilu.org#53593,"TANGLAD, NUSA PENIDA, KLUNGKUNG, BALI",1,144,24,168
https://kawalpemilu.org#53593,"TANGLAD, NUSA PENIDA, KLUNGKUNG, BALI",2,150,67,217
https://kawalpemilu.org#53593,"TANGLAD, NUSA PENIDA, KLUNGKUNG, BALI",3,164,19,183
https://kawalpemilu.org#53593,"TANGLAD, NUSA PENIDA, KLUNGKUNG, BALI",4,148,46,194
https://kawalpemilu.org#53593,"TANGLAD, NUSA PENIDA, KLUNGKUNG, BALI",5,171,12,183
https://kawalpemilu.org#53593,"TANGLAD, NUSA PENIDA, KLUNGKUNG, BALI",6,181,21,202
https://kawalpemilu.org#53593,"TANGLAD, NUSA PENIDA, KLUNGKUNG, BALI",7,182,8,190
https://kawalpemilu.org#53593,"TANGLAD, NUSA PENIDA, KLUNGKUNG, BALI",8,121,42,163
https://kawalpemilu.org#53594,"SUANA, NUSA PENIDA, KLUNGKUNG, BALI",1,245,2,247
https://kawalpemilu.org#53594,"SUANA, NUSA PENIDA, KLUNGKUNG, BALI",2,236,4,240
https://kawalpemilu.org#53594,"SUANA, NUSA PENIDA, KLUNGKUNG, BALI",3,205,1,206
https://kawalpemilu.org#53594,"SUANA, NUSA PENIDA, KLUNGKUNG, BALI",4,211,0,211
https://kawalpemilu.org#53594,"SUANA, NUSA PENIDA, KLUNGKUNG, BALI",5,203,3,206
https://kawalpemilu.org#53594,"SUANA, NUSA PENIDA, KLUNGKUNG, BALI",6,233,5,238
https://kawalpemilu.org#53594,"SUANA, NUSA PENIDA, KLUNGKUNG, BALI",7,236,4,240
https://kawalpemilu.org#53594,"SUANA, NUSA PENIDA, KLUNGKUNG, BALI",8,206,19,225
https://kawalpemilu.org#53594,"SUANA, NUSA PENIDA, KLUNGKUNG, BALI",9,148,18,166
https://kawalpemilu.org#53594,"SUANA, NUSA PENIDA, KLUNGKUNG, BALI",10,139,7,146
https://kawalpemilu.org#53594,"SUANA, NUSA PENIDA, KLUNGKUNG, BALI",11,159,7,166
https://kawalpemilu.org#53594,"SUANA, NUSA PENIDA, KLUNGKUNG, BALI",12,194,24,218
https://kawalpemilu.org#53594,"SUANA, NUSA PENIDA, KLUNGKUNG, BALI",13,209,17,226
https://kawalpemilu.org#53594,"SUANA, NUSA PENIDA, KLUNGKUNG, BALI",14,206,16,222
https://kawalpemilu.org#53595,"BATUNUNGGUL, NUSA PENIDA, KLUNGKUNG, BALI",1,188,12,200
https://kawalpemilu.org#53595,"BATUNUNGGUL, NUSA PENIDA, KLUNGKUNG, BALI",2,182,12,194
https://kawalpemilu.org#53595,"BATUNUNGGUL, NUSA PENIDA, KLUNGKUNG, BALI",3,165,25,190
https://kawalpemilu.org#53595,"BATUNUNGGUL, NUSA PENIDA, KLUNGKUNG, BALI",4,174,22,196
https://kawalpemilu.org#53595,"BATUNUNGGUL, NUSA PENIDA, KLUNGKUNG, BALI",5,187,10,197
https://kawalpemilu.org#53595,"BATUNUNGGUL, NUSA PENIDA, KLUNGKUNG, BALI",6,183,10,193
https://kawalpemilu.org#53595,"BATUNUNGGUL, NUSA PENIDA, KLUNGKUNG, BALI",7,224,9,233
https://kawalpemilu.org#53595,"BATUNUNGGUL, NUSA PENIDA, KLUNGKUNG, BALI",8,194,16,210
https://kawalpemilu.org#53595,"BATUNUNGGUL, NUSA PENIDA, KLUNGKUNG, BALI",9,247,17,264
https://kawalpemilu.org#53595,"BATUNUNGGUL, NUSA PENIDA, KLUNGKUNG, BALI",10,127,16,143
https://kawalpemilu.org#53595,"BATUNUNGGUL, NUSA PENIDA, KLUNGKUNG, BALI",11,132,5,137
https://kawalpemilu.org#53595,"BATUNUNGGUL, NUSA PENIDA, KLUNGKUNG, BALI",12,119,2,121
https://kawalpemilu.org#53595,"BATUNUNGGUL, NUSA PENIDA, KLUNGKUNG, BALI",13,125,4,129
https://kawalpemilu.org#53595,"BATUNUNGGUL, NUSA PENIDA, KLUNGKUNG, BALI",14,238,4,242
https://kawalpemilu.org#53595,"BATUNUNGGUL, NUSA PENIDA, KLUNGKUNG, BALI",15,250,5,255
https://kawalpemilu.org#53595,"BATUNUNGGUL, NUSA PENIDA, KLUNGKUNG, BALI",16,185,13,198
https://kawalpemilu.org#53595,"BATUNUNGGUL, NUSA PENIDA, KLUNGKUNG, BALI",17,177,7,184
https://kawalpemilu.org#53596,"KUTAMPI, NUSA PENIDA, KLUNGKUNG, BALI",1,187,10,197
https://kawalpemilu.org#53596,"KUTAMPI, NUSA PENIDA, KLUNGKUNG, BALI",2,197,12,209
https://kawalpemilu.org#53596,"KUTAMPI, NUSA PENIDA, KLUNGKUNG, BALI",3,249,7,256
https://kawalpemilu.org#53596,"KUTAMPI, NUSA PENIDA, KLUNGKUNG, BALI",4,272,1,273
https://kawalpemilu.org#53596,"KUTAMPI, NUSA PENIDA, KLUNGKUNG, BALI",5,185,17,202
https://kawalpemilu.org#53596,"KUTAMPI, NUSA PENIDA, KLUNGKUNG, BALI",6,158,8,166
https://kawalpemilu.org#53596,"KUTAMPI, NUSA PENIDA, KLUNGKUNG, BALI",7,157,12,169
https://kawalpemilu.org#53596,"KUTAMPI, NUSA PENIDA, KLUNGKUNG, BALI",8,267,9,276
https://kawalpemilu.org#53596,"KUTAMPI, NUSA PENIDA, KLUNGKUNG, BALI",9,111,7,118
https://kawalpemilu.org#53596,"KUTAMPI, NUSA PENIDA, KLUNGKUNG, BALI",10,120,3,123
https://kawalpemilu.org#53596,"KUTAMPI, NUSA PENIDA, KLUNGKUNG, BALI",11,234,8,242
https://kawalpemilu.org#53597,"PED, NUSA PENIDA, KLUNGKUNG, BALI",1,214,17,231
https://kawalpemilu.org#53597,"PED, NUSA PENIDA, KLUNGKUNG, BALI",2,219,19,238
https://kawalpemilu.org#53597,"PED, NUSA PENIDA, KLUNGKUNG, BALI",3,196,17,213
https://kawalpemilu.org#53597,"PED, NUSA PENIDA, KLUNGKUNG, BALI",4,198,21,219
https://kawalpemilu.org#53597,"PED, NUSA PENIDA, KLUNGKUNG, BALI",5,167,5,172
https://kawalpemilu.org#53597,"PED, NUSA PENIDA, KLUNGKUNG, BALI",6,157,3,160
https://kawalpemilu.org#53597,"PED, NUSA PENIDA, KLUNGKUNG, BALI",7,123,0,123
https://kawalpemilu.org#53597,"PED, NUSA PENIDA, KLUNGKUNG, BALI",8,142,12,154
https://kawalpemilu.org#53597,"PED, NUSA PENIDA, KLUNGKUNG, BALI",9,227,7,234
https://kawalpemilu.org#53597,"PED, NUSA PENIDA, KLUNGKUNG, BALI",10,153,4,157
https://kawalpemilu.org#53597,"PED, NUSA PENIDA, KLUNGKUNG, BALI",11,153,12,165
https://kawalpemilu.org#53597,"PED, NUSA PENIDA, KLUNGKUNG, BALI",12,163,6,169
https://kawalpemilu.org#53597,"PED, NUSA PENIDA, KLUNGKUNG, BALI",13,122,22,144
https://kawalpemilu.org#53597,"PED, NUSA PENIDA, KLUNGKUNG, BALI",14,201,10,211
https://kawalpemilu.org#53597,"PED, NUSA PENIDA, KLUNGKUNG, BALI",15,172,11,183
https://kawalpemilu.org#53597,"PED, NUSA PENIDA, KLUNGKUNG, BALI",16,164,1,165
https://kawalpemilu.org#53597,"PED, NUSA PENIDA, KLUNGKUNG, BALI",17,168,0,168
https://kawalpemilu.org#53598,"KAMPUNG TOYAPAKEH, NUSA PENIDA, KLUNGKUNG, BALI",1,77,151,228
https://kawalpemilu.org#53598,"KAMPUNG TOYAPAKEH, NUSA PENIDA, KLUNGKUNG, BALI",2,60,152,212
https://kawalpemilu.org#53599,"LEMBONGAN, NUSA PENIDA, KLUNGKUNG, BALI",1,203,5,208
https://kawalpemilu.org#53599,"LEMBONGAN, NUSA PENIDA, KLUNGKUNG, BALI",2,220,9,229
https://kawalpemilu.org#53599,"LEMBONGAN, NUSA PENIDA, KLUNGKUNG, BALI",3,206,5,211
https://kawalpemilu.org#53599,"LEMBONGAN, NUSA PENIDA, KLUNGKUNG, BALI",4,230,7,237
https://kawalpemilu.org#53599,"LEMBONGAN, NUSA PENIDA, KLUNGKUNG, BALI",5,212,3,215
https://kawalpemilu.org#53599,"LEMBONGAN, NUSA PENIDA, KLUNGKUNG, BALI",6,222,4,226
https://kawalpemilu.org#53599,"LEMBONGAN, NUSA PENIDA, KLUNGKUNG, BALI",7,230,7,237
https://kawalpemilu.org#53599,"LEMBONGAN, NUSA PENIDA, KLUNGKUNG, BALI",8,216,4,220
https://kawalpemilu.org#53599,"LEMBONGAN, NUSA PENIDA, KLUNGKUNG, BALI",9,149,7,156
https://kawalpemilu.org#53599,"LEMBONGAN, NUSA PENIDA, KLUNGKUNG, BALI",10,150,8,158
https://kawalpemilu.org#53599,"LEMBONGAN, NUSA PENIDA, KLUNGKUNG, BALI",11,210,9,219
https://kawalpemilu.org#53599,"LEMBONGAN, NUSA PENIDA, KLUNGKUNG, BALI",12,178,30,208
https://kawalpemilu.org#53599,"LEMBONGAN, NUSA PENIDA, KLUNGKUNG, BALI",13,203,9,212
https://kawalpemilu.org#53599,"LEMBONGAN, NUSA PENIDA, KLUNGKUNG, BALI",14,198,11,209
https://kawalpemilu.org#53600,"JUNGUTBATU, NUSA PENIDA, KLUNGKUNG, BALI",1,208,6,214
https://kawalpemilu.org#53600,"JUNGUTBATU, NUSA PENIDA, KLUNGKUNG, BALI",2,173,22,195
https://kawalpemilu.org#53600,"JUNGUTBATU, NUSA PENIDA, KLUNGKUNG, BALI",3,202,4,206
https://kawalpemilu.org#53600,"JUNGUTBATU, NUSA PENIDA, KLUNGKUNG, BALI",4,215,12,227
https://kawalpemilu.org#53600,"JUNGUTBATU, NUSA PENIDA, KLUNGKUNG, BALI",5,220,9,229
https://kawalpemilu.org#53600,"JUNGUTBATU, NUSA PENIDA, KLUNGKUNG, BALI",6,197,1,198
https://kawalpemilu.org#53600,"JUNGUTBATU, NUSA PENIDA, KLUNGKUNG, BALI",7,203,7,210
https://kawalpemilu.org#53600,"JUNGUTBATU, NUSA PENIDA, KLUNGKUNG, BALI",8,179,15,194
https://kawalpemilu.org#53600,"JUNGUTBATU, NUSA PENIDA, KLUNGKUNG, BALI",9,172,4,176
https://kawalpemilu.org#53600,"JUNGUTBATU, NUSA PENIDA, KLUNGKUNG, BALI",10,177,11,188
https://kawalpemilu.org#53600,"JUNGUTBATU, NUSA PENIDA, KLUNGKUNG, BALI",11,161,6,167
https://kawalpemilu.org#53600,"JUNGUTBATU, NUSA PENIDA, KLUNGKUNG, BALI",12,181,6,187
https://kawalpemilu.org#53601,"PEJUKUTAN, NUSA PENIDA, KLUNGKUNG, BALI",1,178,43,221
https://kawalpemilu.org#53601,"PEJUKUTAN, NUSA PENIDA, KLUNGKUNG, BALI",2,197,19,216
https://kawalpemilu.org#53601,"PEJUKUTAN, NUSA PENIDA, KLUNGKUNG, BALI",3,187,8,195
https://kawalpemilu.org#53601,"PEJUKUTAN, NUSA PENIDA, KLUNGKUNG, BALI",4,148,147,295
https://kawalpemilu.org#53601,"PEJUKUTAN, NUSA PENIDA, KLUNGKUNG, BALI",5,197,91,288
https://kawalpemilu.org#53601,"PEJUKUTAN, NUSA PENIDA, KLUNGKUNG, BALI",6,148,42,190
https://kawalpemilu.org#53601,"PEJUKUTAN, NUSA PENIDA, KLUNGKUNG, BALI",7,168,24,192
https://kawalpemilu.org#53601,"PEJUKUTAN, NUSA PENIDA, KLUNGKUNG, BALI",8,164,10,174
https://kawalpemilu.org#53601,"PEJUKUTAN, NUSA PENIDA, KLUNGKUNG, BALI",9,169,34,203
https://kawalpemilu.org#53601,"PEJUKUTAN, NUSA PENIDA, KLUNGKUNG, BALI",10,200,8,208
https://kawalpemilu.org#53601,"PEJUKUTAN, NUSA PENIDA, KLUNGKUNG, BALI",11,177,12,189
https://kawalpemilu.org#53601,"PEJUKUTAN, NUSA PENIDA, KLUNGKUNG, BALI",12,177,22,199
https://kawalpemilu.org#53601,"PEJUKUTAN, NUSA PENIDA, KLUNGKUNG, BALI",13,152,39,191
https://kawalpemilu.org#53602,"KUTAMPI KALER, NUSA PENIDA, KLUNGKUNG, BALI",1,264,12,276
https://kawalpemilu.org#53602,"KUTAMPI KALER, NUSA PENIDA, KLUNGKUNG, BALI",2,236,6,242
https://kawalpemilu.org#53602,"KUTAMPI KALER, NUSA PENIDA, KLUNGKUNG, BALI",3,261,6,267
https://kawalpemilu.org#53602,"KUTAMPI KALER, NUSA PENIDA, KLUNGKUNG, BALI",4,241,5,246
https://kawalpemilu.org#53602,"KUTAMPI KALER, NUSA PENIDA, KLUNGKUNG, BALI",5,167,5,172
https://kawalpemilu.org#53602,"KUTAMPI KALER, NUSA PENIDA, KLUNGKUNG, BALI",6,177,4,181
https://kawalpemilu.org#53602,"KUTAMPI KALER, NUSA PENIDA, KLUNGKUNG, BALI",7,195,1,196
https://kawalpemilu.org#53602,"KUTAMPI KALER, NUSA PENIDA, KLUNGKUNG, BALI",8,209,7,216
https://kawalpemilu.org#53602,"KUTAMPI KALER, NUSA PENIDA, KLUNGKUNG, BALI",9,188,10,198
https://kawalpemilu.org#53602,"KUTAMPI KALER, NUSA PENIDA, KLUNGKUNG, BALI",10,180,5,185
https://kawalpemilu.org#53603,"BUNGA MEKAR, NUSA PENIDA, KLUNGKUNG, BALI",1,182,15,197
https://kawalpemilu.org#53603,"BUNGA MEKAR, NUSA PENIDA, KLUNGKUNG, BALI",2,168,13,181
https://kawalpemilu.org#53603,"BUNGA MEKAR, NUSA PENIDA, KLUNGKUNG, BALI",3,123,40,163
https://kawalpemilu.org#53603,"BUNGA MEKAR, NUSA PENIDA, KLUNGKUNG, BALI",4,128,55,183
https://kawalpemilu.org#53603,"BUNGA MEKAR, NUSA PENIDA, KLUNGKUNG, BALI",5,171,5,176
https://kawalpemilu.org#53603,"BUNGA MEKAR, NUSA PENIDA, KLUNGKUNG, BALI",6,192,1,193
https://kawalpemilu.org#53603,"BUNGA MEKAR, NUSA PENIDA, KLUNGKUNG, BALI",7,90,19,109
https://kawalpemilu.org#53603,"BUNGA MEKAR, NUSA PENIDA, KLUNGKUNG, BALI",8,87,7,94
https://kawalpemilu.org#53603,"BUNGA MEKAR, NUSA PENIDA, KLUNGKUNG, BALI",9,151,11,162
https://kawalpemilu.org#53603,"BUNGA MEKAR, NUSA PENIDA, KLUNGKUNG, BALI",10,208,9,217
https://kawalpemilu.org#53603,"BUNGA MEKAR, NUSA PENIDA, KLUNGKUNG, BALI",11,168,3,171
https://kawalpemilu.org#53603,"BUNGA MEKAR, NUSA PENIDA, KLUNGKUNG, BALI",12,154,1,155
https://kawalpemilu.org#53605,"NEGARI, BANJARANGKAN, KLUNGKUNG, BALI",1,249,6,255
https://kawalpemilu.org#53605,"NEGARI, BANJARANGKAN, KLUNGKUNG, BALI",2,234,7,241
https://kawalpemilu.org#53605,"NEGARI, BANJARANGKAN, KLUNGKUNG, BALI",3,195,14,209
https://kawalpemilu.org#53605,"NEGARI, BANJARANGKAN, KLUNGKUNG, BALI",4,225,33,258
https://kawalpemilu.org#53605,"NEGARI, BANJARANGKAN, KLUNGKUNG, BALI",5,229,14,243
https://kawalpemilu.org#53605,"NEGARI, BANJARANGKAN, KLUNGKUNG, BALI",6,206,12,218
https://kawalpemilu.org#53605,"NEGARI, BANJARANGKAN, KLUNGKUNG, BALI",7,213,22,235
https://kawalpemilu.org#53605,"NEGARI, BANJARANGKAN, KLUNGKUNG, BALI",8,202,22,224
https://kawalpemilu.org#53606,"TAKMUNG, BANJARANGKAN, KLUNGKUNG, BALI",1,194,11,205
https://kawalpemilu.org#53606,"TAKMUNG, BANJARANGKAN, KLUNGKUNG, BALI",2,200,9,209
https://kawalpemilu.org#53606,"TAKMUNG, BANJARANGKAN, KLUNGKUNG, BALI",3,227,3,230
https://kawalpemilu.org#53606,"TAKMUNG, BANJARANGKAN, KLUNGKUNG, BALI",4,223,19,242
https://kawalpemilu.org#53606,"TAKMUNG, BANJARANGKAN, KLUNGKUNG, BALI",5,198,22,220
https://kawalpemilu.org#53606,"TAKMUNG, BANJARANGKAN, KLUNGKUNG, BALI",6,244,15,259
https://kawalpemilu.org#53606,"TAKMUNG, BANJARANGKAN, KLUNGKUNG, BALI",7,237,7,244
https://kawalpemilu.org#53606,"TAKMUNG, BANJARANGKAN, KLUNGKUNG, BALI",8,219,12,231
https://kawalpemilu.org#53606,"TAKMUNG, BANJARANGKAN, KLUNGKUNG, BALI",9,177,27,204
https://kawalpemilu.org#53606,"TAKMUNG, BANJARANGKAN, KLUNGKUNG, BALI",10,238,7,245
https://kawalpemilu.org#53606,"TAKMUNG, BANJARANGKAN, KLUNGKUNG, BALI",11,231,11,242
https://kawalpemilu.org#53606,"TAKMUNG, BANJARANGKAN, KLUNGKUNG, BALI",12,226,6,232
https://kawalpemilu.org#53606,"TAKMUNG, BANJARANGKAN, KLUNGKUNG, BALI",13,237,9,246
https://kawalpemilu.org#53606,"TAKMUNG, BANJARANGKAN, KLUNGKUNG, BALI",14,197,10,207
https://kawalpemilu.org#53607,"BANJARANGKAN, BANJARANGKAN, KLUNGKUNG, BALI",1,207,7,214
https://kawalpemilu.org#53607,"BANJARANGKAN, BANJARANGKAN, KLUNGKUNG, BALI",2,221,2,223
https://kawalpemilu.org#53607,"BANJARANGKAN, BANJARANGKAN, KLUNGKUNG, BALI",3,201,8,209
https://kawalpemilu.org#53607,"BANJARANGKAN, BANJARANGKAN, KLUNGKUNG, BALI",4,209,7,216
https://kawalpemilu.org#53607,"BANJARANGKAN, BANJARANGKAN, KLUNGKUNG, BALI",5,199,6,205
https://kawalpemilu.org#53607,"BANJARANGKAN, BANJARANGKAN, KLUNGKUNG, BALI",6,216,9,225
https://kawalpemilu.org#53607,"BANJARANGKAN, BANJARANGKAN, KLUNGKUNG, BALI",7,211,6,217
https://kawalpemilu.org#53607,"BANJARANGKAN, BANJARANGKAN, KLUNGKUNG, BALI",8,208,6,214
https://kawalpemilu.org#53607,"BANJARANGKAN, BANJARANGKAN, KLUNGKUNG, BALI",9,195,7,202
https://kawalpemilu.org#53607,"BANJARANGKAN, BANJARANGKAN, KLUNGKUNG, BALI",10,186,13,199
https://kawalpemilu.org#53607,"BANJARANGKAN, BANJARANGKAN, KLUNGKUNG, BALI",11,231,11,242
https://kawalpemilu.org#53607,"BANJARANGKAN, BANJARANGKAN, KLUNGKUNG, BALI",12,223,7,230
https://kawalpemilu.org#53607,"BANJARANGKAN, BANJARANGKAN, KLUNGKUNG, BALI",13,210,11,221
https://kawalpemilu.org#53607,"BANJARANGKAN, BANJARANGKAN, KLUNGKUNG, BALI",14,223,9,232
https://kawalpemilu.org#53607,"BANJARANGKAN, BANJARANGKAN, KLUNGKUNG, BALI",15,224,12,236
https://kawalpemilu.org#53608,"TUSAN, BANJARANGKAN, KLUNGKUNG, BALI",1,209,18,227
https://kawalpemilu.org#53608,"TUSAN, BANJARANGKAN, KLUNGKUNG, BALI",2,188,9,197
https://kawalpemilu.org#53608,"TUSAN, BANJARANGKAN, KLUNGKUNG, BALI",3,200,5,205
https://kawalpemilu.org#53608,"TUSAN, BANJARANGKAN, KLUNGKUNG, BALI",4,208,14,222
https://kawalpemilu.org#53608,"TUSAN, BANJARANGKAN, KLUNGKUNG, BALI",5,211,4,215
https://kawalpemilu.org#53608,"TUSAN, BANJARANGKAN, KLUNGKUNG, BALI",6,218,11,229
https://kawalpemilu.org#53608,"TUSAN, BANJARANGKAN, KLUNGKUNG, BALI",7,195,13,208
https://kawalpemilu.org#53608,"TUSAN, BANJARANGKAN, KLUNGKUNG, BALI",8,190,7,197
https://kawalpemilu.org#53608,"TUSAN, BANJARANGKAN, KLUNGKUNG, BALI",9,190,11,201
https://kawalpemilu.org#53608,"TUSAN, BANJARANGKAN, KLUNGKUNG, BALI",10,197,14,211
https://kawalpemilu.org#53608,"TUSAN, BANJARANGKAN, KLUNGKUNG, BALI",11,179,13,192
https://kawalpemilu.org#53608,"TUSAN, BANJARANGKAN, KLUNGKUNG, BALI",12,174,5,179
https://kawalpemilu.org#53609,"BAKAS, BANJARANGKAN, KLUNGKUNG, BALI",1,207,3,210
https://kawalpemilu.org#53609,"BAKAS, BANJARANGKAN, KLUNGKUNG, BALI",2,200,4,204
https://kawalpemilu.org#53609,"BAKAS, BANJARANGKAN, KLUNGKUNG, BALI",3,188,6,194
https://kawalpemilu.org#53609,"BAKAS, BANJARANGKAN, KLUNGKUNG, BALI",4,207,11,218
https://kawalpemilu.org#53609,"BAKAS, BANJARANGKAN, KLUNGKUNG, BALI",5,201,5,206
https://kawalpemilu.org#53609,"BAKAS, BANJARANGKAN, KLUNGKUNG, BALI",6,194,12,206
https://kawalpemilu.org#53609,"BAKAS, BANJARANGKAN, KLUNGKUNG, BALI",7,191,6,197
https://kawalpemilu.org#53610,"GETAKAN, BANJARANGKAN, KLUNGKUNG, BALI",1,175,7,182
https://kawalpemilu.org#53610,"GETAKAN, BANJARANGKAN, KLUNGKUNG, BALI",2,184,11,195
https://kawalpemilu.org#53610,"GETAKAN, BANJARANGKAN, KLUNGKUNG, BALI",3,174,7,181
https://kawalpemilu.org#53610,"GETAKAN, BANJARANGKAN, KLUNGKUNG, BALI",4,179,10,189
https://kawalpemilu.org#53610,"GETAKAN, BANJARANGKAN, KLUNGKUNG, BALI",5,218,9,227
https://kawalpemilu.org#53610,"GETAKAN, BANJARANGKAN, KLUNGKUNG, BALI",6,208,10,218
https://kawalpemilu.org#53610,"GETAKAN, BANJARANGKAN, KLUNGKUNG, BALI",7,199,14,213
https://kawalpemilu.org#53610,"GETAKAN, BANJARANGKAN, KLUNGKUNG, BALI",8,259,9,268
https://kawalpemilu.org#53610,"GETAKAN, BANJARANGKAN, KLUNGKUNG, BALI",9,232,10,242
https://kawalpemilu.org#53610,"GETAKAN, BANJARANGKAN, KLUNGKUNG, BALI",10,214,11,225
https://kawalpemilu.org#53611,"TIHINGAN, BANJARANGKAN, KLUNGKUNG, BALI",1,221,8,229
https://kawalpemilu.org#53611,"TIHINGAN, BANJARANGKAN, KLUNGKUNG, BALI",2,235,3,238
https://kawalpemilu.org#53611,"TIHINGAN, BANJARANGKAN, KLUNGKUNG, BALI",3,199,12,211
https://kawalpemilu.org#53611,"TIHINGAN, BANJARANGKAN, KLUNGKUNG, BALI",4,202,16,218
https://kawalpemilu.org#53611,"TIHINGAN, BANJARANGKAN, KLUNGKUNG, BALI",5,201,5,206
https://kawalpemilu.org#53611,"TIHINGAN, BANJARANGKAN, KLUNGKUNG, BALI",6,180,8,188
https://kawalpemilu.org#53611,"TIHINGAN, BANJARANGKAN, KLUNGKUNG, BALI",7,260,8,268
https://kawalpemilu.org#53611,"TIHINGAN, BANJARANGKAN, KLUNGKUNG, BALI",8,232,12,244
https://kawalpemilu.org#53611,"TIHINGAN, BANJARANGKAN, KLUNGKUNG, BALI",9,227,4,231
https://kawalpemilu.org#53611,"TIHINGAN, BANJARANGKAN, KLUNGKUNG, BALI",10,233,9,242
https://kawalpemilu.org#53611,"TIHINGAN, BANJARANGKAN, KLUNGKUNG, BALI",11,221,7,228
https://kawalpemilu.org#53612,"AAN, BANJARANGKAN, KLUNGKUNG, BALI",1,175,23,198
https://kawalpemilu.org#53612,"AAN, BANJARANGKAN, KLUNGKUNG, BALI",2,209,16,225
https://kawalpemilu.org#53612,"AAN, BANJARANGKAN, KLUNGKUNG, BALI",3,185,18,203
https://kawalpemilu.org#53612,"AAN, BANJARANGKAN, KLUNGKUNG, BALI",4,196,12,208
https://kawalpemilu.org#53612,"AAN, BANJARANGKAN, KLUNGKUNG, BALI",5,207,19,226
https://kawalpemilu.org#53612,"AAN, BANJARANGKAN, KLUNGKUNG, BALI",6,193,21,214
https://kawalpemilu.org#53612,"AAN, BANJARANGKAN, KLUNGKUNG, BALI",7,210,21,231
https://kawalpemilu.org#53612,"AAN, BANJARANGKAN, KLUNGKUNG, BALI",8,155,37,192
https://kawalpemilu.org#53612,"AAN, BANJARANGKAN, KLUNGKUNG, BALI",9,182,17,199
https://kawalpemilu.org#53613,"NYALIAN, BANJARANGKAN, KLUNGKUNG, BALI",1,230,12,242
https://kawalpemilu.org#53613,"NYALIAN, BANJARANGKAN, KLUNGKUNG, BALI",2,209,7,216
https://kawalpemilu.org#53613,"NYALIAN, BANJARANGKAN, KLUNGKUNG, BALI",3,223,7,230
https://kawalpemilu.org#53613,"NYALIAN, BANJARANGKAN, KLUNGKUNG, BALI",4,213,18,231
https://kawalpemilu.org#53613,"NYALIAN, BANJARANGKAN, KLUNGKUNG, BALI",5,216,13,229
https://kawalpemilu.org#53613,"NYALIAN, BANJARANGKAN, KLUNGKUNG, BALI",6,191,12,203
https://kawalpemilu.org#53613,"NYALIAN, BANJARANGKAN, KLUNGKUNG, BALI",7,224,10,234
https://kawalpemilu.org#53613,"NYALIAN, BANJARANGKAN, KLUNGKUNG, BALI",8,215,4,219
https://kawalpemilu.org#53613,"NYALIAN, BANJARANGKAN, KLUNGKUNG, BALI",9,223,2,225
https://kawalpemilu.org#53613,"NYALIAN, BANJARANGKAN, KLUNGKUNG, BALI",10,279,1,280
https://kawalpemilu.org#53613,"NYALIAN, BANJARANGKAN, KLUNGKUNG, BALI",11,277,8,285
https://kawalpemilu.org#53613,"NYALIAN, BANJARANGKAN, KLUNGKUNG, BALI",12,242,19,261
https://kawalpemilu.org#53613,"NYALIAN, BANJARANGKAN, KLUNGKUNG, BALI",13,217,8,225
https://kawalpemilu.org#53613,"NYALIAN, BANJARANGKAN, KLUNGKUNG, BALI",14,170,5,175
https://kawalpemilu.org#53613,"NYALIAN, BANJARANGKAN, KLUNGKUNG, BALI",15,188,4,192
https://kawalpemilu.org#53614,"BUNGBUNGAN, BANJARANGKAN, KLUNGKUNG, BALI",1,207,9,216
https://kawalpemilu.org#53614,"BUNGBUNGAN, BANJARANGKAN, KLUNGKUNG, BALI",2,170,8,178
https://kawalpemilu.org#53614,"BUNGBUNGAN, BANJARANGKAN, KLUNGKUNG, BALI",3,215,9,224
https://kawalpemilu.org#53614,"BUNGBUNGAN, BANJARANGKAN, KLUNGKUNG, BALI",4,191,6,197
https://kawalpemilu.org#53614,"BUNGBUNGAN, BANJARANGKAN, KLUNGKUNG, BALI",5,205,15,220
https://kawalpemilu.org#53614,"BUNGBUNGAN, BANJARANGKAN, KLUNGKUNG, BALI",6,198,16,214
https://kawalpemilu.org#53614,"BUNGBUNGAN, BANJARANGKAN, KLUNGKUNG, BALI",7,197,6,203
https://kawalpemilu.org#53614,"BUNGBUNGAN, BANJARANGKAN, KLUNGKUNG, BALI",8,191,14,205
https://kawalpemilu.org#53614,"BUNGBUNGAN, BANJARANGKAN, KLUNGKUNG, BALI",9,186,11,197
https://kawalpemilu.org#53614,"BUNGBUNGAN, BANJARANGKAN, KLUNGKUNG, BALI",10,171,11,182
https://kawalpemilu.org#53615,"TIMUHUN, BANJARANGKAN, KLUNGKUNG, BALI",1,205,16,221
https://kawalpemilu.org#53615,"TIMUHUN, BANJARANGKAN, KLUNGKUNG, BALI",2,200,4,204
https://kawalpemilu.org#53615,"TIMUHUN, BANJARANGKAN, KLUNGKUNG, BALI",3,208,3,211
https://kawalpemilu.org#53615,"TIMUHUN, BANJARANGKAN, KLUNGKUNG, BALI",4,208,6,214
https://kawalpemilu.org#53615,"TIMUHUN, BANJARANGKAN, KLUNGKUNG, BALI",5,220,3,223
https://kawalpemilu.org#53615,"TIMUHUN, BANJARANGKAN, KLUNGKUNG, BALI",6,223,3,226
https://kawalpemilu.org#53615,"TIMUHUN, BANJARANGKAN, KLUNGKUNG, BALI",7,230,8,238
https://kawalpemilu.org#53615,"TIMUHUN, BANJARANGKAN, KLUNGKUNG, BALI",8,214,4,218
https://kawalpemilu.org#53615,"TIMUHUN, BANJARANGKAN, KLUNGKUNG, BALI",9,232,4,236
https://kawalpemilu.org#53616,"NYANGLAN, BANJARANGKAN, KLUNGKUNG, BALI",1,213,2,215
https://kawalpemilu.org#53616,"NYANGLAN, BANJARANGKAN, KLUNGKUNG, BALI",2,214,13,227
https://kawalpemilu.org#53616,"NYANGLAN, BANJARANGKAN, KLUNGKUNG, BALI",3,220,8,228
https://kawalpemilu.org#53616,"NYANGLAN, BANJARANGKAN, KLUNGKUNG, BALI",4,210,18,228
https://kawalpemilu.org#53617,"TOHPATI, BANJARANGKAN, KLUNGKUNG, BALI",1,179,7,186
https://kawalpemilu.org#53617,"TOHPATI, BANJARANGKAN, KLUNGKUNG, BALI",2,159,19,171
https://kawalpemilu.org#53617,"TOHPATI, BANJARANGKAN, KLUNGKUNG, BALI",3,190,10,200
https://kawalpemilu.org#53617,"TOHPATI, BANJARANGKAN, KLUNGKUNG, BALI",4,194,9,203
https://kawalpemilu.org#53617,"TOHPATI, BANJARANGKAN, KLUNGKUNG, BALI",5,190,8,198
https://kawalpemilu.org#53619,"SEMARAPURA KAJA, KLUNGKUNG, KLUNGKUNG, BALI",1,220,31,251
https://kawalpemilu.org#53619,"SEMARAPURA KAJA, KLUNGKUNG, KLUNGKUNG, BALI",2,238,12,250
https://kawalpemilu.org#53619,"SEMARAPURA KAJA, KLUNGKUNG, KLUNGKUNG, BALI",3,218,27,245
https://kawalpemilu.org#53619,"SEMARAPURA KAJA, KLUNGKUNG, KLUNGKUNG, BALI",4,205,13,218
https://kawalpemilu.org#53619,"SEMARAPURA KAJA, KLUNGKUNG, KLUNGKUNG, BALI",5,189,5,194
https://kawalpemilu.org#53619,"SEMARAPURA KAJA, KLUNGKUNG, KLUNGKUNG, BALI",6,220,18,238
https://kawalpemilu.org#53620,"SEMARAPURA KAUH, KLUNGKUNG, KLUNGKUNG, BALI",1,227,11,238
https://kawalpemilu.org#53620,"SEMARAPURA KAUH, KLUNGKUNG, KLUNGKUNG, BALI",2,231,8,239
https://kawalpemilu.org#53620,"SEMARAPURA KAUH, KLUNGKUNG, KLUNGKUNG, BALI",3,185,6,191
https://kawalpemilu.org#53620,"SEMARAPURA KAUH, KLUNGKUNG, KLUNGKUNG, BALI",4,175,7,182
https://kawalpemilu.org#53620,"SEMARAPURA KAUH, KLUNGKUNG, KLUNGKUNG, BALI",5,154,8,162
https://kawalpemilu.org#53620,"SEMARAPURA KAUH, KLUNGKUNG, KLUNGKUNG, BALI",6,200,8,208
https://kawalpemilu.org#53620,"SEMARAPURA KAUH, KLUNGKUNG, KLUNGKUNG, BALI",7,183,4,187
https://kawalpemilu.org#53621,"SEMARAPURA TENGAH, KLUNGKUNG, KLUNGKUNG, BALI",1,196,26,222
https://kawalpemilu.org#53621,"SEMARAPURA TENGAH, KLUNGKUNG, KLUNGKUNG, BALI",2,161,40,201
https://kawalpemilu.org#53621,"SEMARAPURA TENGAH, KLUNGKUNG, KLUNGKUNG, BALI",3,157,47,204
https://kawalpemilu.org#53621,"SEMARAPURA TENGAH, KLUNGKUNG, KLUNGKUNG, BALI",4,182,45,227
https://kawalpemilu.org#53621,"SEMARAPURA TENGAH, KLUNGKUNG, KLUNGKUNG, BALI",5,192,9,201
https://kawalpemilu.org#53621,"SEMARAPURA TENGAH, KLUNGKUNG, KLUNGKUNG, BALI",6,181,14,195
https://kawalpemilu.org#53621,"SEMARAPURA TENGAH, KLUNGKUNG, KLUNGKUNG, BALI",7,174,13,187
https://kawalpemilu.org#53621,"SEMARAPURA TENGAH, KLUNGKUNG, KLUNGKUNG, BALI",8,143,31,174
https://kawalpemilu.org#53621,"SEMARAPURA TENGAH, KLUNGKUNG, KLUNGKUNG, BALI",9,169,22,191
https://kawalpemilu.org#53621,"SEMARAPURA TENGAH, KLUNGKUNG, KLUNGKUNG, BALI",10,150,34,184
https://kawalpemilu.org#53621,"SEMARAPURA TENGAH, KLUNGKUNG, KLUNGKUNG, BALI",11,168,10,178
https://kawalpemilu.org#53621,"SEMARAPURA TENGAH, KLUNGKUNG, KLUNGKUNG, BALI",12,156,14,170
https://kawalpemilu.org#53622,"SEMARAPURA KANGIN, KLUNGKUNG, KLUNGKUNG, BALI",1,133,47,180
https://kawalpemilu.org#53622,"SEMARAPURA KANGIN, KLUNGKUNG, KLUNGKUNG, BALI",2,129,33,162
https://kawalpemilu.org#53622,"SEMARAPURA KANGIN, KLUNGKUNG, KLUNGKUNG, BALI",3,166,26,192
https://kawalpemilu.org#53622,"SEMARAPURA KANGIN, KLUNGKUNG, KLUNGKUNG, BALI",4,143,49,192
https://kawalpemilu.org#53622,"SEMARAPURA KANGIN, KLUNGKUNG, KLUNGKUNG, BALI",5,187,9,196
https://kawalpemilu.org#53622,"SEMARAPURA KANGIN, KLUNGKUNG, KLUNGKUNG, BALI",6,185,9,194
https://kawalpemilu.org#53622,"SEMARAPURA KANGIN, KLUNGKUNG, KLUNGKUNG, BALI",7,195,12,207
https://kawalpemilu.org#53622,"SEMARAPURA KANGIN, KLUNGKUNG, KLUNGKUNG, BALI",8,172,3,175
https://kawalpemilu.org#53622,"SEMARAPURA KANGIN, KLUNGKUNG, KLUNGKUNG, BALI",9,177,16,193
https://kawalpemilu.org#53622,"SEMARAPURA KANGIN, KLUNGKUNG, KLUNGKUNG, BALI",10,103,107,210
https://kawalpemilu.org#53622,"SEMARAPURA KANGIN, KLUNGKUNG, KLUNGKUNG, BALI",11,40,163,203
https://kawalpemilu.org#53622,"SEMARAPURA KANGIN, KLUNGKUNG, KLUNGKUNG, BALI",12,198,24,222
https://kawalpemilu.org#53622,"SEMARAPURA KANGIN, KLUNGKUNG, KLUNGKUNG, BALI",13,131,58,189
https://kawalpemilu.org#53623,"SEMARAPURA KELOD KANGIN, KLUNGKUNG, KLUNGKUNG, BALI",1,198,46,244
https://kawalpemilu.org#53623,"SEMARAPURA KELOD KANGIN, KLUNGKUNG, KLUNGKUNG, BALI",2,199,37,236
https://kawalpemilu.org#53623,"SEMARAPURA KELOD KANGIN, KLUNGKUNG, KLUNGKUNG, BALI",3,176,26,202
https://kawalpemilu.org#53623,"SEMARAPURA KELOD KANGIN, KLUNGKUNG, KLUNGKUNG, BALI",4,190,23,213
https://kawalpemilu.org#53623,"SEMARAPURA KELOD KANGIN, KLUNGKUNG, KLUNGKUNG, BALI",5,194,27,221
https://kawalpemilu.org#53623,"SEMARAPURA KELOD KANGIN, KLUNGKUNG, KLUNGKUNG, BALI",6,161,53,214
https://kawalpemilu.org#53623,"SEMARAPURA KELOD KANGIN, KLUNGKUNG, KLUNGKUNG, BALI",7,154,74,228
https://kawalpemilu.org#53623,"SEMARAPURA KELOD KANGIN, KLUNGKUNG, KLUNGKUNG, BALI",8,96,138,234
https://kawalpemilu.org#53623,"SEMARAPURA KELOD KANGIN, KLUNGKUNG, KLUNGKUNG, BALI",9,174,68,242
https://kawalpemilu.org#53623,"SEMARAPURA KELOD KANGIN, KLUNGKUNG, KLUNGKUNG, BALI",10,168,76,244
https://kawalpemilu.org#53623,"SEMARAPURA KELOD KANGIN, KLUNGKUNG, KLUNGKUNG, BALI",11,175,67,242
https://kawalpemilu.org#53623,"SEMARAPURA KELOD KANGIN, KLUNGKUNG, KLUNGKUNG, BALI",12,141,93,234
https://kawalpemilu.org#53623,"SEMARAPURA KELOD KANGIN, KLUNGKUNG, KLUNGKUNG, BALI",13,148,87,235
https://kawalpemilu.org#53623,"SEMARAPURA KELOD KANGIN, KLUNGKUNG, KLUNGKUNG, BALI",14,178,54,232
https://kawalpemilu.org#53623,"SEMARAPURA KELOD KANGIN, KLUNGKUNG, KLUNGKUNG, BALI",15,145,85,230
https://kawalpemilu.org#53623,"SEMARAPURA KELOD KANGIN, KLUNGKUNG, KLUNGKUNG, BALI",16,199,53,252
https://kawalpemilu.org#53624,"SEMARAPURA KELOD, KLUNGKUNG, KLUNGKUNG, BALI",1,203,36,239
https://kawalpemilu.org#53624,"SEMARAPURA KELOD, KLUNGKUNG, KLUNGKUNG, BALI",2,199,5,204
https://kawalpemilu.org#53624,"SEMARAPURA KELOD, KLUNGKUNG, KLUNGKUNG, BALI",3,226,20,246
https://kawalpemilu.org#53624,"SEMARAPURA KELOD, KLUNGKUNG, KLUNGKUNG, BALI",4,243,14,257
https://kawalpemilu.org#53624,"SEMARAPURA KELOD, KLUNGKUNG, KLUNGKUNG, BALI",5,166,54,220
https://kawalpemilu.org#53624,"SEMARAPURA KELOD, KLUNGKUNG, KLUNGKUNG, BALI",6,240,7,247
https://kawalpemilu.org#53624,"SEMARAPURA KELOD, KLUNGKUNG, KLUNGKUNG, BALI",7,198,19,217
https://kawalpemilu.org#53624,"SEMARAPURA KELOD, KLUNGKUNG, KLUNGKUNG, BALI",8,247,10,257
https://kawalpemilu.org#53624,"SEMARAPURA KELOD, KLUNGKUNG, KLUNGKUNG, BALI",9,210,19,229
https://kawalpemilu.org#53624,"SEMARAPURA KELOD, KLUNGKUNG, KLUNGKUNG, BALI",10,65,2,67
https://kawalpemilu.org#53624,"SEMARAPURA KELOD, KLUNGKUNG, KLUNGKUNG, BALI",11,202,17,219
https://kawalpemilu.org#53624,"SEMARAPURA KELOD, KLUNGKUNG, KLUNGKUNG, BALI",12,216,10,226
https://kawalpemilu.org#53624,"SEMARAPURA KELOD, KLUNGKUNG, KLUNGKUNG, BALI",13,247,17,264
https://kawalpemilu.org#53624,"SEMARAPURA KELOD, KLUNGKUNG, KLUNGKUNG, BALI",14,186,19,205
https://kawalpemilu.org#53625,"SATRA, KLUNGKUNG, KLUNGKUNG, BALI",1,186,29,215
https://kawalpemilu.org#53625,"SATRA, KLUNGKUNG, KLUNGKUNG, BALI",2,209,19,228
https://kawalpemilu.org#53625,"SATRA, KLUNGKUNG, KLUNGKUNG, BALI",3,210,13,223
https://kawalpemilu.org#53625,"SATRA, KLUNGKUNG, KLUNGKUNG, BALI",4,190,26,216
https://kawalpemilu.org#53626,"TOJAN, KLUNGKUNG, KLUNGKUNG, BALI",1,231,12,243
https://kawalpemilu.org#53626,"TOJAN, KLUNGKUNG, KLUNGKUNG, BALI",2,204,10,214
https://kawalpemilu.org#53626,"TOJAN, KLUNGKUNG, KLUNGKUNG, BALI",3,213,7,220
https://kawalpemilu.org#53626,"TOJAN, KLUNGKUNG, KLUNGKUNG, BALI",4,209,15,224
https://kawalpemilu.org#53626,"TOJAN, KLUNGKUNG, KLUNGKUNG, BALI",5,233,15,248
https://kawalpemilu.org#53626,"TOJAN, KLUNGKUNG, KLUNGKUNG, BALI",6,227,15,242
https://kawalpemilu.org#53626,"TOJAN, KLUNGKUNG, KLUNGKUNG, BALI",7,222,5,227
https://kawalpemilu.org#53626,"TOJAN, KLUNGKUNG, KLUNGKUNG, BALI",8,214,3,217
https://kawalpemilu.org#53627,"GELGEL, KLUNGKUNG, KLUNGKUNG, BALI",1,224,13,237
https://kawalpemilu.org#53627,"GELGEL, KLUNGKUNG, KLUNGKUNG, BALI",2,212,19,231
https://kawalpemilu.org#53627,"GELGEL, KLUNGKUNG, KLUNGKUNG, BALI",3,202,4,206
https://kawalpemilu.org#53627,"GELGEL, KLUNGKUNG, KLUNGKUNG, BALI",4,221,16,237
https://kawalpemilu.org#53627,"GELGEL, KLUNGKUNG, KLUNGKUNG, BALI",5,212,14,226
https://kawalpemilu.org#53627,"GELGEL, KLUNGKUNG, KLUNGKUNG, BALI",6,177,34,211
https://kawalpemilu.org#53627,"GELGEL, KLUNGKUNG, KLUNGKUNG, BALI",7,216,15,231
https://kawalpemilu.org#53627,"GELGEL, KLUNGKUNG, KLUNGKUNG, BALI",8,138,6,144
https://kawalpemilu.org#53627,"GELGEL, KLUNGKUNG, KLUNGKUNG, BALI",9,211,7,218
https://kawalpemilu.org#53627,"GELGEL, KLUNGKUNG, KLUNGKUNG, BALI",10,182,6,188
https://kawalpemilu.org#53627,"GELGEL, KLUNGKUNG, KLUNGKUNG, BALI",11,182,8,190
https://kawalpemilu.org#53627,"GELGEL, KLUNGKUNG, KLUNGKUNG, BALI",12,185,10,195
https://kawalpemilu.org#53627,"GELGEL, KLUNGKUNG, KLUNGKUNG, BALI",13,190,12,202
https://kawalpemilu.org#53627,"GELGEL, KLUNGKUNG, KLUNGKUNG, BALI",14,237,4,241
https://kawalpemilu.org#53627,"GELGEL, KLUNGKUNG, KLUNGKUNG, BALI",15,130,13,143
https://kawalpemilu.org#53628,"KAMPUNG GELGEL, KLUNGKUNG, KLUNGKUNG, BALI",1,67,185,252
https://kawalpemilu.org#53628,"KAMPUNG GELGEL, KLUNGKUNG, KLUNGKUNG, BALI",2,61,178,239
https://kawalpemilu.org#53628,"KAMPUNG GELGEL, KLUNGKUNG, KLUNGKUNG, BALI",3,40,213,253
https://kawalpemilu.org#53629,"JUMPAI, KLUNGKUNG, KLUNGKUNG, BALI",1,184,18,202
https://kawalpemilu.org#53629,"JUMPAI, KLUNGKUNG, KLUNGKUNG, BALI",2,176,14,190
https://kawalpemilu.org#53629,"JUMPAI, KLUNGKUNG, KLUNGKUNG, BALI",3,207,16,223
https://kawalpemilu.org#53629,"JUMPAI, KLUNGKUNG, KLUNGKUNG, BALI",4,188,8,196
https://kawalpemilu.org#53629,"JUMPAI, KLUNGKUNG, KLUNGKUNG, BALI",5,185,21,206
https://kawalpemilu.org#53629,"JUMPAI, KLUNGKUNG, KLUNGKUNG, BALI",6,198,14,212
https://kawalpemilu.org#53630,"TANGKAS, KLUNGKUNG, KLUNGKUNG, BALI",1,220,11,231
https://kawalpemilu.org#53630,"TANGKAS, KLUNGKUNG, KLUNGKUNG, BALI",2,212,10,222
https://kawalpemilu.org#53630,"TANGKAS, KLUNGKUNG, KLUNGKUNG, BALI",3,182,11,193
https://kawalpemilu.org#53630,"TANGKAS, KLUNGKUNG, KLUNGKUNG, BALI",4,197,9,206
https://kawalpemilu.org#53630,"TANGKAS, KLUNGKUNG, KLUNGKUNG, BALI",5,200,7,207
https://kawalpemilu.org#53630,"TANGKAS, KLUNGKUNG, KLUNGKUNG, BALI",6,192,8,200
https://kawalpemilu.org#53630,"TANGKAS, KLUNGKUNG, KLUNGKUNG, BALI",7,166,12,178
https://kawalpemilu.org#53630,"TANGKAS, KLUNGKUNG, KLUNGKUNG, BALI",8,204,11,215
https://kawalpemilu.org#53630,"TANGKAS, KLUNGKUNG, KLUNGKUNG, BALI",9,207,15,222
https://kawalpemilu.org#53630,"TANGKAS, KLUNGKUNG, KLUNGKUNG, BALI",10,205,5,210
https://kawalpemilu.org#53631,"KAMASAN, KLUNGKUNG, KLUNGKUNG, BALI",1,218,9,227
https://kawalpemilu.org#53631,"KAMASAN, KLUNGKUNG, KLUNGKUNG, BALI",2,214,9,223
https://kawalpemilu.org#53631,"KAMASAN, KLUNGKUNG, KLUNGKUNG, BALI",3,223,3,226
https://kawalpemilu.org#53631,"KAMASAN, KLUNGKUNG, KLUNGKUNG, BALI",4,182,4,186
https://kawalpemilu.org#53631,"KAMASAN, KLUNGKUNG, KLUNGKUNG, BALI",5,210,13,223
https://kawalpemilu.org#53631,"KAMASAN, KLUNGKUNG, KLUNGKUNG, BALI",6,208,11,219
https://kawalpemilu.org#53631,"KAMASAN, KLUNGKUNG, KLUNGKUNG, BALI",7,236,28,264
https://kawalpemilu.org#53631,"KAMASAN, KLUNGKUNG, KLUNGKUNG, BALI",8,213,9,222
https://kawalpemilu.org#53631,"KAMASAN, KLUNGKUNG, KLUNGKUNG, BALI",9,181,23,204
https://kawalpemilu.org#53631,"KAMASAN, KLUNGKUNG, KLUNGKUNG, BALI",10,225,19,244
https://kawalpemilu.org#53631,"KAMASAN, KLUNGKUNG, KLUNGKUNG, BALI",11,212,9,221
https://kawalpemilu.org#53631,"KAMASAN, KLUNGKUNG, KLUNGKUNG, BALI",12,167,11,178
https://kawalpemilu.org#53632,"AKAH, KLUNGKUNG, KLUNGKUNG, BALI",1,201,7,208
https://kawalpemilu.org#53632,"AKAH, KLUNGKUNG, KLUNGKUNG, BALI",2,205,11,216
https://kawalpemilu.org#53632,"AKAH, KLUNGKUNG, KLUNGKUNG, BALI",3,217,7,224
https://kawalpemilu.org#53632,"AKAH, KLUNGKUNG, KLUNGKUNG, BALI",4,196,6,212
https://kawalpemilu.org#53632,"AKAH, KLUNGKUNG, KLUNGKUNG, BALI",5,203,5,208
https://kawalpemilu.org#53632,"AKAH, KLUNGKUNG, KLUNGKUNG, BALI",6,186,9,195
https://kawalpemilu.org#53632,"AKAH, KLUNGKUNG, KLUNGKUNG, BALI",7,202,8,210
https://kawalpemilu.org#53632,"AKAH, KLUNGKUNG, KLUNGKUNG, BALI",8,191,13,204
https://kawalpemilu.org#53632,"AKAH, KLUNGKUNG, KLUNGKUNG, BALI",9,234,11,245
https://kawalpemilu.org#53632,"AKAH, KLUNGKUNG, KLUNGKUNG, BALI",10,214,15,229
https://kawalpemilu.org#53632,"AKAH, KLUNGKUNG, KLUNGKUNG, BALI",11,201,17,218
https://kawalpemilu.org#53632,"AKAH, KLUNGKUNG, KLUNGKUNG, BALI",12,179,44,223
https://kawalpemilu.org#53632,"AKAH, KLUNGKUNG, KLUNGKUNG, BALI",13,190,50,240
https://kawalpemilu.org#53632,"AKAH, KLUNGKUNG, KLUNGKUNG, BALI",14,195,12,207
https://kawalpemilu.org#53632,"AKAH, KLUNGKUNG, KLUNGKUNG, BALI",15,195,16,211
https://kawalpemilu.org#53632,"AKAH, KLUNGKUNG, KLUNGKUNG, BALI",16,206,13,219
https://kawalpemilu.org#53633,"MANDUANG, KLUNGKUNG, KLUNGKUNG, BALI",1,195,13,208
https://kawalpemilu.org#53633,"MANDUANG, KLUNGKUNG, KLUNGKUNG, BALI",2,187,26,213
https://kawalpemilu.org#53633,"MANDUANG, KLUNGKUNG, KLUNGKUNG, BALI",3,188,7,195
https://kawalpemilu.org#53633,"MANDUANG, KLUNGKUNG, KLUNGKUNG, BALI",4,180,25,205
https://kawalpemilu.org#53633,"MANDUANG, KLUNGKUNG, KLUNGKUNG, BALI",5,177,29,206
https://kawalpemilu.org#53633,"MANDUANG, KLUNGKUNG, KLUNGKUNG, BALI",6,189,20,209
https://kawalpemilu.org#53634,"SELAT, KLUNGKUNG, KLUNGKUNG, BALI",1,214,7,221
https://kawalpemilu.org#53634,"SELAT, KLUNGKUNG, KLUNGKUNG, BALI",2,185,16,201
https://kawalpemilu.org#53634,"SELAT, KLUNGKUNG, KLUNGKUNG, BALI",3,120,5,125
https://kawalpemilu.org#53634,"SELAT, KLUNGKUNG, KLUNGKUNG, BALI",4,116,6,122
https://kawalpemilu.org#53634,"SELAT, KLUNGKUNG, KLUNGKUNG, BALI",5,156,13,169
https://kawalpemilu.org#53634,"SELAT, KLUNGKUNG, KLUNGKUNG, BALI",6,147,8,147
https://kawalpemilu.org#53634,"SELAT, KLUNGKUNG, KLUNGKUNG, BALI",7,166,2,168
https://kawalpemilu.org#53634,"SELAT, KLUNGKUNG, KLUNGKUNG, BALI",8,161,9,170
https://kawalpemilu.org#53634,"SELAT, KLUNGKUNG, KLUNGKUNG, BALI",9,166,3,169
https://kawalpemilu.org#53634,"SELAT, KLUNGKUNG, KLUNGKUNG, BALI",10,128,3,131
https://kawalpemilu.org#53634,"SELAT, KLUNGKUNG, KLUNGKUNG, BALI",11,140,5,145
https://kawalpemilu.org#53634,"SELAT, KLUNGKUNG, KLUNGKUNG, BALI",12,209,3,212
https://kawalpemilu.org#53634,"SELAT, KLUNGKUNG, KLUNGKUNG, BALI",13,212,7,219
https://kawalpemilu.org#53634,"SELAT, KLUNGKUNG, KLUNGKUNG, BALI",14,250,9,259
https://kawalpemilu.org#53634,"SELAT, KLUNGKUNG, KLUNGKUNG, BALI",15,246,14,260
https://kawalpemilu.org#53634,"SELAT, KLUNGKUNG, KLUNGKUNG, BALI",16,190,3,193
https://kawalpemilu.org#53634,"SELAT, KLUNGKUNG, KLUNGKUNG, BALI",17,177,3,180
https://kawalpemilu.org#53634,"SELAT, KLUNGKUNG, KLUNGKUNG, BALI",18,183,3,186
https://kawalpemilu.org#53635,"TEGAK, KLUNGKUNG, KLUNGKUNG, BALI",1,244,5,249
https://kawalpemilu.org#53635,"TEGAK, KLUNGKUNG, KLUNGKUNG, BALI",2,264,3,267
https://kawalpemilu.org#53635,"TEGAK, KLUNGKUNG, KLUNGKUNG, BALI",3,201,9,210
https://kawalpemilu.org#53635,"TEGAK, KLUNGKUNG, KLUNGKUNG, BALI",4,200,10,210
https://kawalpemilu.org#53635,"TEGAK, KLUNGKUNG, KLUNGKUNG, BALI",5,213,13,226
https://kawalpemilu.org#53635,"TEGAK, KLUNGKUNG, KLUNGKUNG, BALI",6,186,7,193
https://kawalpemilu.org#53635,"TEGAK, KLUNGKUNG, KLUNGKUNG, BALI",7,193,9,202
https://kawalpemilu.org#53635,"TEGAK, KLUNGKUNG, KLUNGKUNG, BALI",8,217,9,226
https://kawalpemilu.org#53635,"TEGAK, KLUNGKUNG, KLUNGKUNG, BALI",9,198,5,203
https://kawalpemilu.org#53635,"TEGAK, KLUNGKUNG, KLUNGKUNG, BALI",10,196,16,212
https://kawalpemilu.org#53635,"TEGAK, KLUNGKUNG, KLUNGKUNG, BALI",11,192,20,212
https://kawalpemilu.org#53635,"TEGAK, KLUNGKUNG, KLUNGKUNG, BALI",12,182,12,194
https://kawalpemilu.org#53636,"SELISIHAN, KLUNGKUNG, KLUNGKUNG, BALI",1,192,18,210
https://kawalpemilu.org#53636,"SELISIHAN, KLUNGKUNG, KLUNGKUNG, BALI",2,204,10,214
https://kawalpemilu.org#53636,"SELISIHAN, KLUNGKUNG, KLUNGKUNG, BALI",3,176,15,191
https://kawalpemilu.org#53636,"SELISIHAN, KLUNGKUNG, KLUNGKUNG, BALI",4,160,21,181
https://kawalpemilu.org#53638,"PAKSEBALI, DAWAN, KLUNGKUNG, BALI",1,227,8,235
https://kawalpemilu.org#53638,"PAKSEBALI, DAWAN, KLUNGKUNG, BALI",2,202,16,218
https://kawalpemilu.org#53638,"PAKSEBALI, DAWAN, KLUNGKUNG, BALI",3,214,12,226
https://kawalpemilu.org#53638,"PAKSEBALI, DAWAN, KLUNGKUNG, BALI",4,204,8,212
https://kawalpemilu.org#53638,"PAKSEBALI, DAWAN, KLUNGKUNG, BALI",5,221,6,227
https://kawalpemilu.org#53638,"PAKSEBALI, DAWAN, KLUNGKUNG, BALI",6,181,13,194
https://kawalpemilu.org#53638,"PAKSEBALI, DAWAN, KLUNGKUNG, BALI",7,221,6,227
https://kawalpemilu.org#53638,"PAKSEBALI, DAWAN, KLUNGKUNG, BALI",8,213,8,221
https://kawalpemilu.org#53638,"PAKSEBALI, DAWAN, KLUNGKUNG, BALI",9,209,10,219
https://kawalpemilu.org#53638,"PAKSEBALI, DAWAN, KLUNGKUNG, BALI",10,213,9,222
https://kawalpemilu.org#53638,"PAKSEBALI, DAWAN, KLUNGKUNG, BALI",11,196,9,205
https://kawalpemilu.org#53638,"PAKSEBALI, DAWAN, KLUNGKUNG, BALI",12,196,10,206
https://kawalpemilu.org#53638,"PAKSEBALI, DAWAN, KLUNGKUNG, BALI",13,205,8,213
https://kawalpemilu.org#53638,"PAKSEBALI, DAWAN, KLUNGKUNG, BALI",14,200,6,206
https://kawalpemilu.org#53638,"PAKSEBALI, DAWAN, KLUNGKUNG, BALI",15,208,16,224
https://kawalpemilu.org#53639,"SAMPALAN TENGAH, DAWAN, KLUNGKUNG, BALI",1,233,7,240
https://kawalpemilu.org#53639,"SAMPALAN TENGAH, DAWAN, KLUNGKUNG, BALI",2,184,12,196
https://kawalpemilu.org#53639,"SAMPALAN TENGAH, DAWAN, KLUNGKUNG, BALI",3,167,10,177
https://kawalpemilu.org#53639,"SAMPALAN TENGAH, DAWAN, KLUNGKUNG, BALI",4,180,10,190
https://kawalpemilu.org#53639,"SAMPALAN TENGAH, DAWAN, KLUNGKUNG, BALI",5,188,15,203
https://kawalpemilu.org#53639,"SAMPALAN TENGAH, DAWAN, KLUNGKUNG, BALI",6,188,5,193
https://kawalpemilu.org#53640,"SAMPALAN KELOD, DAWAN, KLUNGKUNG, BALI",1,203,9,212
https://kawalpemilu.org#53640,"SAMPALAN KELOD, DAWAN, KLUNGKUNG, BALI",2,187,20,207
https://kawalpemilu.org#53640,"SAMPALAN KELOD, DAWAN, KLUNGKUNG, BALI",3,210,8,218
https://kawalpemilu.org#53640,"SAMPALAN KELOD, DAWAN, KLUNGKUNG, BALI",4,194,7,201
https://kawalpemilu.org#53640,"SAMPALAN KELOD, DAWAN, KLUNGKUNG, BALI",5,194,7,201
https://kawalpemilu.org#53640,"SAMPALAN KELOD, DAWAN, KLUNGKUNG, BALI",6,189,12,201
https://kawalpemilu.org#53640,"SAMPALAN KELOD, DAWAN, KLUNGKUNG, BALI",7,190,12,202
https://kawalpemilu.org#53640,"SAMPALAN KELOD, DAWAN, KLUNGKUNG, BALI",8,209,14,223
https://kawalpemilu.org#53640,"SAMPALAN KELOD, DAWAN, KLUNGKUNG, BALI",9,213,13,226
https://kawalpemilu.org#53641,"SULANG, DAWAN, KLUNGKUNG, BALI",1,222,6,228
https://kawalpemilu.org#53641,"SULANG, DAWAN, KLUNGKUNG, BALI",2,206,7,213
https://kawalpemilu.org#53641,"SULANG, DAWAN, KLUNGKUNG, BALI",3,190,7,197
https://kawalpemilu.org#53642,"GUNAKSA, DAWAN, KLUNGKUNG, BALI",1,193,10,203
https://kawalpemilu.org#53642,"GUNAKSA, DAWAN, KLUNGKUNG, BALI",2,191,23,214
https://kawalpemilu.org#53642,"GUNAKSA, DAWAN, KLUNGKUNG, BALI",3,218,17,235
https://kawalpemilu.org#53642,"GUNAKSA, DAWAN, KLUNGKUNG, BALI",4,212,17,229
https://kawalpemilu.org#53642,"GUNAKSA, DAWAN, KLUNGKUNG, BALI",5,213,17,230
https://kawalpemilu.org#53642,"GUNAKSA, DAWAN, KLUNGKUNG, BALI",6,203,12,215
https://kawalpemilu.org#53642,"GUNAKSA, DAWAN, KLUNGKUNG, BALI",7,200,20,220
https://kawalpemilu.org#53642,"GUNAKSA, DAWAN, KLUNGKUNG, BALI",8,188,19,207
https://kawalpemilu.org#53642,"GUNAKSA, DAWAN, KLUNGKUNG, BALI",9,182,20,202
https://kawalpemilu.org#53642,"GUNAKSA, DAWAN, KLUNGKUNG, BALI",10,206,20,226
https://kawalpemilu.org#53642,"GUNAKSA, DAWAN, KLUNGKUNG, BALI",11,197,18,215
https://kawalpemilu.org#53642,"GUNAKSA, DAWAN, KLUNGKUNG, BALI",12,194,20,214
https://kawalpemilu.org#53642,"GUNAKSA, DAWAN, KLUNGKUNG, BALI",13,214,16,230
https://kawalpemilu.org#53642,"GUNAKSA, DAWAN, KLUNGKUNG, BALI",14,215,16,231
https://kawalpemilu.org#53642,"GUNAKSA, DAWAN, KLUNGKUNG, BALI",15,184,20,204
https://kawalpemilu.org#53643,"KUSAMBA, DAWAN, KLUNGKUNG, BALI",1,238,3,241
https://kawalpemilu.org#53643,"KUSAMBA, DAWAN, KLUNGKUNG, BALI",2,234,6,240
https://kawalpemilu.org#53643,"KUSAMBA, DAWAN, KLUNGKUNG, BALI",3,230,7,237
https://kawalpemilu.org#53643,"KUSAMBA, DAWAN, KLUNGKUNG, BALI",4,228,5,233
https://kawalpemilu.org#53643,"KUSAMBA, DAWAN, KLUNGKUNG, BALI",5,216,5,221
https://kawalpemilu.org#53643,"KUSAMBA, DAWAN, KLUNGKUNG, BALI",6,193,9,202
https://kawalpemilu.org#53643,"KUSAMBA, DAWAN, KLUNGKUNG, BALI",7,221,3,224
https://kawalpemilu.org#53643,"KUSAMBA, DAWAN, KLUNGKUNG, BALI",8,202,5,207
https://kawalpemilu.org#53643,"KUSAMBA, DAWAN, KLUNGKUNG, BALI",9,212,7,219
https://kawalpemilu.org#53643,"KUSAMBA, DAWAN, KLUNGKUNG, BALI",10,203,6,209
https://kawalpemilu.org#53643,"KUSAMBA, DAWAN, KLUNGKUNG, BALI",11,199,9,208
https://kawalpemilu.org#53643,"KUSAMBA, DAWAN, KLUNGKUNG, BALI",12,191,11,202
https://kawalpemilu.org#53643,"KUSAMBA, DAWAN, KLUNGKUNG, BALI",13,190,6,196
https://kawalpemilu.org#53643,"KUSAMBA, DAWAN, KLUNGKUNG, BALI",14,205,8,213
https://kawalpemilu.org#53643,"KUSAMBA, DAWAN, KLUNGKUNG, BALI",15,189,18,207
https://kawalpemilu.org#53643,"KUSAMBA, DAWAN, KLUNGKUNG, BALI",16,213,6,219
https://kawalpemilu.org#53643,"KUSAMBA, DAWAN, KLUNGKUNG, BALI",17,198,10,208
https://kawalpemilu.org#53643,"KUSAMBA, DAWAN, KLUNGKUNG, BALI",18,238,1,239
https://kawalpemilu.org#53643,"KUSAMBA, DAWAN, KLUNGKUNG, BALI",19,210,11,221
https://kawalpemilu.org#53643,"KUSAMBA, DAWAN, KLUNGKUNG, BALI",20,152,7,159
https://kawalpemilu.org#53643,"KUSAMBA, DAWAN, KLUNGKUNG, BALI",21,146,3,149
https://kawalpemilu.org#53644,"KAMPUNG KUSAMBA, DAWAN, KLUNGKUNG, BALI",1,77,143,220
https://kawalpemilu.org#53644,"KAMPUNG KUSAMBA, DAWAN, KLUNGKUNG, BALI",2,90,116,206
https://kawalpemilu.org#53645,"PESINGGAHAN, DAWAN, KLUNGKUNG, BALI",1,202,21,223
https://kawalpemilu.org#53645,"PESINGGAHAN, DAWAN, KLUNGKUNG, BALI",2,180,19,199
https://kawalpemilu.org#53645,"PESINGGAHAN, DAWAN, KLUNGKUNG, BALI",3,207,11,218
https://kawalpemilu.org#53645,"PESINGGAHAN, DAWAN, KLUNGKUNG, BALI",4,206,7,213
https://kawalpemilu.org#53645,"PESINGGAHAN, DAWAN, KLUNGKUNG, BALI",5,194,6,200
https://kawalpemilu.org#53645,"PESINGGAHAN, DAWAN, KLUNGKUNG, BALI",6,205,1,206
https://kawalpemilu.org#53645,"PESINGGAHAN, DAWAN, KLUNGKUNG, BALI",7,211,4,215
https://kawalpemilu.org#53645,"PESINGGAHAN, DAWAN, KLUNGKUNG, BALI",8,238,5,243
https://kawalpemilu.org#53645,"PESINGGAHAN, DAWAN, KLUNGKUNG, BALI",9,209,7,216
https://kawalpemilu.org#53645,"PESINGGAHAN, DAWAN, KLUNGKUNG, BALI",10,206,4,210
https://kawalpemilu.org#53645,"PESINGGAHAN, DAWAN, KLUNGKUNG, BALI",11,179,7,186
https://kawalpemilu.org#53645,"PESINGGAHAN, DAWAN, KLUNGKUNG, BALI",12,172,6,178
https://kawalpemilu.org#53645,"PESINGGAHAN, DAWAN, KLUNGKUNG, BALI",13,195,10,205
https://kawalpemilu.org#53646,"DAWAN KELOD, DAWAN, KLUNGKUNG, BALI",1,258,5,263
https://kawalpemilu.org#53646,"DAWAN KELOD, DAWAN, KLUNGKUNG, BALI",2,238,9,247
https://kawalpemilu.org#53646,"DAWAN KELOD, DAWAN, KLUNGKUNG, BALI",3,228,4,232
https://kawalpemilu.org#53646,"DAWAN KELOD, DAWAN, KLUNGKUNG, BALI",4,218,15,233
https://kawalpemilu.org#53646,"DAWAN KELOD, DAWAN, KLUNGKUNG, BALI",5,236,7,243
https://kawalpemilu.org#53646,"DAWAN KELOD, DAWAN, KLUNGKUNG, BALI",6,218,17,235
https://kawalpemilu.org#53646,"DAWAN KELOD, DAWAN, KLUNGKUNG, BALI",7,234,22,256
https://kawalpemilu.org#53647,"PIKAT, DAWAN, KLUNGKUNG, BALI",1,196,12,208
https://kawalpemilu.org#53647,"PIKAT, DAWAN, KLUNGKUNG, BALI",2,168,10,178
https://kawalpemilu.org#53647,"PIKAT, DAWAN, KLUNGKUNG, BALI",3,180,14,194
https://kawalpemilu.org#53647,"PIKAT, DAWAN, KLUNGKUNG, BALI",4,137,0,137
https://kawalpemilu.org#53647,"PIKAT, DAWAN, KLUNGKUNG, BALI",5,172,11,183
https://kawalpemilu.org#53647,"PIKAT, DAWAN, KLUNGKUNG, BALI",6,169,10,179
https://kawalpemilu.org#53647,"PIKAT, DAWAN, KLUNGKUNG, BALI",7,190,6,196
https://kawalpemilu.org#53647,"PIKAT, DAWAN, KLUNGKUNG, BALI",8,200,3,203
https://kawalpemilu.org#53647,"PIKAT, DAWAN, KLUNGKUNG, BALI",9,163,22,185
https://kawalpemilu.org#53647,"PIKAT, DAWAN, KLUNGKUNG, BALI",10,200,18,218
https://kawalpemilu.org#53647,"PIKAT, DAWAN, KLUNGKUNG, BALI",11,175,5,180
https://kawalpemilu.org#53647,"PIKAT, DAWAN, KLUNGKUNG, BALI",12,170,10,180
https://kawalpemilu.org#53648,"DAWAN KALER, DAWAN, KLUNGKUNG, BALI",1,183,10,193
https://kawalpemilu.org#53648,"DAWAN KALER, DAWAN, KLUNGKUNG, BALI",2,195,14,209
https://kawalpemilu.org#53648,"DAWAN KALER, DAWAN, KLUNGKUNG, BALI",3,219,12,231
https://kawalpemilu.org#53648,"DAWAN KALER, DAWAN, KLUNGKUNG, BALI",4,213,15,228
https://kawalpemilu.org#53648,"DAWAN KALER, DAWAN, KLUNGKUNG, BALI",5,204,8,212
https://kawalpemilu.org#53648,"DAWAN KALER, DAWAN, KLUNGKUNG, BALI",6,187,13,200
https://kawalpemilu.org#53648,"DAWAN KALER, DAWAN, KLUNGKUNG, BALI",7,192,22,214
https://kawalpemilu.org#53648,"DAWAN KALER, DAWAN, KLUNGKUNG, BALI",8,212,6,218
https://kawalpemilu.org#53649,"BESAN, DAWAN, KLUNGKUNG, BALI",1,182,24,206
https://kawalpemilu.org#53649,"BESAN, DAWAN, KLUNGKUNG, BALI",2,198,8,206
https://kawalpemilu.org#53649,"BESAN, DAWAN, KLUNGKUNG, BALI",3,229,16,245
https://kawalpemilu.org#53649,"BESAN, DAWAN, KLUNGKUNG, BALI",4,194,17,211
https://kawalpemilu.org#53649,"BESAN, DAWAN, KLUNGKUNG, BALI",5,214,8,222
https://kawalpemilu.org#53649,"BESAN, DAWAN, KLUNGKUNG, BALI",6,201,3,204
https://kawalpemilu.org#53649,"BESAN, DAWAN, KLUNGKUNG, BALI",7,212,17,229
https://kawalpemilu.org#53652,"APUAN, SUSUT, BANGLI, BALI",1,178,6,184
https://kawalpemilu.org#53652,"APUAN, SUSUT, BANGLI, BALI",2,163,12,175
https://kawalpemilu.org#53652,"APUAN, SUSUT, BANGLI, BALI",3,152,6,158
https://kawalpemilu.org#53652,"APUAN, SUSUT, BANGLI, BALI",4,176,6,182
https://kawalpemilu.org#53652,"APUAN, SUSUT, BANGLI, BALI",5,194,4,198
https://kawalpemilu.org#53652,"APUAN, SUSUT, BANGLI, BALI",6,179,8,187
https://kawalpemilu.org#53652,"APUAN, SUSUT, BANGLI, BALI",7,172,10,182
https://kawalpemilu.org#53652,"APUAN, SUSUT, BANGLI, BALI",8,187,16,203
https://kawalpemilu.org#53652,"APUAN, SUSUT, BANGLI, BALI",9,189,2,191
https://kawalpemilu.org#53652,"APUAN, SUSUT, BANGLI, BALI",10,186,6,192
https://kawalpemilu.org#53652,"APUAN, SUSUT, BANGLI, BALI",11,183,7,190
https://kawalpemilu.org#53652,"APUAN, SUSUT, BANGLI, BALI",12,192,3,195
https://kawalpemilu.org#53652,"APUAN, SUSUT, BANGLI, BALI",13,204,3,207
https://kawalpemilu.org#53652,"APUAN, SUSUT, BANGLI, BALI",14,165,11,176
https://kawalpemilu.org#53652,"APUAN, SUSUT, BANGLI, BALI",15,192,9,201
https://kawalpemilu.org#53653,"DEMULIH, SUSUT, BANGLI, BALI",1,194,16,210
https://kawalpemilu.org#53653,"DEMULIH, SUSUT, BANGLI, BALI",2,191,10,201
https://kawalpemilu.org#53653,"DEMULIH, SUSUT, BANGLI, BALI",3,167,23,190
https://kawalpemilu.org#53653,"DEMULIH, SUSUT, BANGLI, BALI",4,187,18,205
https://kawalpemilu.org#53653,"DEMULIH, SUSUT, BANGLI, BALI",5,95,14,109
https://kawalpemilu.org#53653,"DEMULIH, SUSUT, BANGLI, BALI",6,181,14,195
https://kawalpemilu.org#53653,"DEMULIH, SUSUT, BANGLI, BALI",7,186,16,202
https://kawalpemilu.org#53653,"DEMULIH, SUSUT, BANGLI, BALI",8,184,14,198
https://kawalpemilu.org#53653,"DEMULIH, SUSUT, BANGLI, BALI",9,189,6,195
https://kawalpemilu.org#53653,"DEMULIH, SUSUT, BANGLI, BALI",10,195,6,201
https://kawalpemilu.org#53653,"DEMULIH, SUSUT, BANGLI, BALI",11,199,3,202
https://kawalpemilu.org#53653,"DEMULIH, SUSUT, BANGLI, BALI",12,175,9,184
https://kawalpemilu.org#53653,"DEMULIH, SUSUT, BANGLI, BALI",13,186,14,200
https://kawalpemilu.org#53653,"DEMULIH, SUSUT, BANGLI, BALI",14,178,13,191
https://kawalpemilu.org#53653,"DEMULIH, SUSUT, BANGLI, BALI",15,79,15,94
https://kawalpemilu.org#53654,"ABUAN, SUSUT, BANGLI, BALI",1,214,3,217
https://kawalpemilu.org#53654,"ABUAN, SUSUT, BANGLI, BALI",2,207,8,215
https://kawalpemilu.org#53654,"ABUAN, SUSUT, BANGLI, BALI",3,219,9,228
https://kawalpemilu.org#53654,"ABUAN, SUSUT, BANGLI, BALI",4,214,14,228
https://kawalpemilu.org#53654,"ABUAN, SUSUT, BANGLI, BALI",5,205,12,217
https://kawalpemilu.org#53654,"ABUAN, SUSUT, BANGLI, BALI",6,194,7,201
https://kawalpemilu.org#53654,"ABUAN, SUSUT, BANGLI, BALI",7,183,4,187
https://kawalpemilu.org#53654,"ABUAN, SUSUT, BANGLI, BALI",8,169,3,172
https://kawalpemilu.org#53654,"ABUAN, SUSUT, BANGLI, BALI",9,164,11,175
https://kawalpemilu.org#53654,"ABUAN, SUSUT, BANGLI, BALI",10,160,7,167
https://kawalpemilu.org#53654,"ABUAN, SUSUT, BANGLI, BALI",11,162,4,166
https://kawalpemilu.org#53654,"ABUAN, SUSUT, BANGLI, BALI",12,174,2,176
https://kawalpemilu.org#53654,"ABUAN, SUSUT, BANGLI, BALI",13,166,13,179
https://kawalpemilu.org#53654,"ABUAN, SUSUT, BANGLI, BALI",14,172,17,189
https://kawalpemilu.org#53654,"ABUAN, SUSUT, BANGLI, BALI",15,153,31,184
https://kawalpemilu.org#53654,"ABUAN, SUSUT, BANGLI, BALI",16,165,19,184
https://kawalpemilu.org#53654,"ABUAN, SUSUT, BANGLI, BALI",17,151,29,180
https://kawalpemilu.org#53654,"ABUAN, SUSUT, BANGLI, BALI",18,161,17,178
https://kawalpemilu.org#53654,"ABUAN, SUSUT, BANGLI, BALI",19,166,23,189
https://kawalpemilu.org#53654,"ABUAN, SUSUT, BANGLI, BALI",20,149,34,183
https://kawalpemilu.org#53654,"ABUAN, SUSUT, BANGLI, BALI",21,142,29,171
https://kawalpemilu.org#53655,"SUSUT, SUSUT, BANGLI, BALI",1,133,27,160
https://kawalpemilu.org#53655,"SUSUT, SUSUT, BANGLI, BALI",2,152,28,180
https://kawalpemilu.org#53655,"SUSUT, SUSUT, BANGLI, BALI",3,180,8,188
https://kawalpemilu.org#53655,"SUSUT, SUSUT, BANGLI, BALI",4,185,10,195
https://kawalpemilu.org#53655,"SUSUT, SUSUT, BANGLI, BALI",5,155,14,169
https://kawalpemilu.org#53655,"SUSUT, SUSUT, BANGLI, BALI",6,162,14,176
https://kawalpemilu.org#53655,"SUSUT, SUSUT, BANGLI, BALI",7,199,14,7
https://kawalpemilu.org#53655,"SUSUT, SUSUT, BANGLI, BALI",8,86,7,93
https://kawalpemilu.org#53655,"SUSUT, SUSUT, BANGLI, BALI",9,182,8,190
https://kawalpemilu.org#53655,"SUSUT, SUSUT, BANGLI, BALI",10,235,9,244
https://kawalpemilu.org#53655,"SUSUT, SUSUT, BANGLI, BALI",11,226,7,233
https://kawalpemilu.org#53655,"SUSUT, SUSUT, BANGLI, BALI",12,226,8,234
https://kawalpemilu.org#53655,"SUSUT, SUSUT, BANGLI, BALI",13,183,5,188
https://kawalpemilu.org#53655,"SUSUT, SUSUT, BANGLI, BALI",14,161,19,180
https://kawalpemilu.org#53655,"SUSUT, SUSUT, BANGLI, BALI",15,190,15,205
https://kawalpemilu.org#53655,"SUSUT, SUSUT, BANGLI, BALI",16,182,15,197
https://kawalpemilu.org#53655,"SUSUT, SUSUT, BANGLI, BALI",17,189,18,207
https://kawalpemilu.org#53655,"SUSUT, SUSUT, BANGLI, BALI",18,203,11,214
https://kawalpemilu.org#53655,"SUSUT, SUSUT, BANGLI, BALI",19,191,18,209
https://kawalpemilu.org#53655,"SUSUT, SUSUT, BANGLI, BALI",20,215,39,254
https://kawalpemilu.org#53656,"SULAHAN, SUSUT, BANGLI, BALI",1,185,23,208
https://kawalpemilu.org#53656,"SULAHAN, SUSUT, BANGLI, BALI",2,175,13,188
https://kawalpemilu.org#53656,"SULAHAN, SUSUT, BANGLI, BALI",3,189,16,205
https://kawalpemilu.org#53656,"SULAHAN, SUSUT, BANGLI, BALI",4,175,11,186
https://kawalpemilu.org#53656,"SULAHAN, SUSUT, BANGLI, BALI",5,188,16,204
https://kawalpemilu.org#53656,"SULAHAN, SUSUT, BANGLI, BALI",6,185,16,201
https://kawalpemilu.org#53656,"SULAHAN, SUSUT, BANGLI, BALI",7,183,10,193
https://kawalpemilu.org#53656,"SULAHAN, SUSUT, BANGLI, BALI",8,229,11,240
https://kawalpemilu.org#53656,"SULAHAN, SUSUT, BANGLI, BALI",9,226,9,235
https://kawalpemilu.org#53656,"SULAHAN, SUSUT, BANGLI, BALI",10,217,11,228
https://kawalpemilu.org#53656,"SULAHAN, SUSUT, BANGLI, BALI",11,213,15,228
https://kawalpemilu.org#53656,"SULAHAN, SUSUT, BANGLI, BALI",12,216,11,227
https://kawalpemilu.org#53656,"SULAHAN, SUSUT, BANGLI, BALI",13,225,11,236
https://kawalpemilu.org#53656,"SULAHAN, SUSUT, BANGLI, BALI",14,211,6,217
https://kawalpemilu.org#53656,"SULAHAN, SUSUT, BANGLI, BALI",15,201,11,212
https://kawalpemilu.org#53656,"SULAHAN, SUSUT, BANGLI, BALI",16,243,9,252
https://kawalpemilu.org#53656,"SULAHAN, SUSUT, BANGLI, BALI",17,238,1,239
https://kawalpemilu.org#53656,"SULAHAN, SUSUT, BANGLI, BALI",18,234,6,240
https://kawalpemilu.org#53656,"SULAHAN, SUSUT, BANGLI, BALI",19,247,10,257
https://kawalpemilu.org#53656,"SULAHAN, SUSUT, BANGLI, BALI",20,246,10,256
https://kawalpemilu.org#53656,"SULAHAN, SUSUT, BANGLI, BALI",21,139,5,144
https://kawalpemilu.org#53656,"SULAHAN, SUSUT, BANGLI, BALI",22,124,6,130
https://kawalpemilu.org#53656,"SULAHAN, SUSUT, BANGLI, BALI",23,200,16,216
https://kawalpemilu.org#53656,"SULAHAN, SUSUT, BANGLI, BALI",24,206,11,217
https://kawalpemilu.org#53656,"SULAHAN, SUSUT, BANGLI, BALI",25,121,1,122
https://kawalpemilu.org#53656,"SULAHAN, SUSUT, BANGLI, BALI",26,132,2,134
https://kawalpemilu.org#53656,"SULAHAN, SUSUT, BANGLI, BALI",27,200,9,209
https://kawalpemilu.org#53657,"PENGLUMBARAN, SUSUT, BANGLI, BALI",1,231,12,243
https://kawalpemilu.org#53657,"PENGLUMBARAN, SUSUT, BANGLI, BALI",2,263,11,274
https://kawalpemilu.org#53657,"PENGLUMBARAN, SUSUT, BANGLI, BALI",3,148,6,154
https://kawalpemilu.org#53657,"PENGLUMBARAN, SUSUT, BANGLI, BALI",4,147,6,153
https://kawalpemilu.org#53657,"PENGLUMBARAN, SUSUT, BANGLI, BALI",5,234,5,239
https://kawalpemilu.org#53657,"PENGLUMBARAN, SUSUT, BANGLI, BALI",6,225,2,227
https://kawalpemilu.org#53657,"PENGLUMBARAN, SUSUT, BANGLI, BALI",7,201,12,213
https://kawalpemilu.org#53657,"PENGLUMBARAN, SUSUT, BANGLI, BALI",8,210,4,214
https://kawalpemilu.org#53657,"PENGLUMBARAN, SUSUT, BANGLI, BALI",9,182,7,189
https://kawalpemilu.org#53657,"PENGLUMBARAN, SUSUT, BANGLI, BALI",10,182,8,190
https://kawalpemilu.org#53657,"PENGLUMBARAN, SUSUT, BANGLI, BALI",11,170,8,178
https://kawalpemilu.org#53657,"PENGLUMBARAN, SUSUT, BANGLI, BALI",12,108,28,136
https://kawalpemilu.org#53657,"PENGLUMBARAN, SUSUT, BANGLI, BALI",13,135,34,169
https://kawalpemilu.org#53658,"TIGA, SUSUT, BANGLI, BALI",1,205,12,217
https://kawalpemilu.org#53658,"TIGA, SUSUT, BANGLI, BALI",2,190,11,201
https://kawalpemilu.org#53658,"TIGA, SUSUT, BANGLI, BALI",3,206,10,216
https://kawalpemilu.org#53658,"TIGA, SUSUT, BANGLI, BALI",4,200,14,214
https://kawalpemilu.org#53658,"TIGA, SUSUT, BANGLI, BALI",5,179,16,195
https://kawalpemilu.org#53658,"TIGA, SUSUT, BANGLI, BALI",6,189,0,189
https://kawalpemilu.org#53658,"TIGA, SUSUT, BANGLI, BALI",7,228,3,231
https://kawalpemilu.org#53658,"TIGA, SUSUT, BANGLI, BALI",8,214,2,216
https://kawalpemilu.org#53658,"TIGA, SUSUT, BANGLI, BALI",9,0,0,0
https://kawalpemilu.org#53658,"TIGA, SUSUT, BANGLI, BALI",10,0,0,0
https://kawalpemilu.org#53658,"TIGA, SUSUT, BANGLI, BALI",11,246,6,252
https://kawalpemilu.org#53658,"TIGA, SUSUT, BANGLI, BALI",12,228,16,244
https://kawalpemilu.org#53658,"TIGA, SUSUT, BANGLI, BALI",13,204,14,218
https://kawalpemilu.org#53658,"TIGA, SUSUT, BANGLI, BALI",14,202,12,214
https://kawalpemilu.org#53658,"TIGA, SUSUT, BANGLI, BALI",15,207,4,211
https://kawalpemilu.org#53658,"TIGA, SUSUT, BANGLI, BALI",16,202,6,208
https://kawalpemilu.org#53658,"TIGA, SUSUT, BANGLI, BALI",17,198,39,237
https://kawalpemilu.org#53658,"TIGA, SUSUT, BANGLI, BALI",18,188,31,219
https://kawalpemilu.org#53658,"TIGA, SUSUT, BANGLI, BALI",19,191,39,230
https://kawalpemilu.org#53658,"TIGA, SUSUT, BANGLI, BALI",20,182,31,213
https://kawalpemilu.org#53658,"TIGA, SUSUT, BANGLI, BALI",21,128,5,133
https://kawalpemilu.org#53658,"TIGA, SUSUT, BANGLI, BALI",22,123,12,135
https://kawalpemilu.org#53658,"TIGA, SUSUT, BANGLI, BALI",23,170,3,173
https://kawalpemilu.org#53658,"TIGA, SUSUT, BANGLI, BALI",24,146,8,154
https://kawalpemilu.org#53658,"TIGA, SUSUT, BANGLI, BALI",25,22,21,43
https://kawalpemilu.org#53658,"TIGA, SUSUT, BANGLI, BALI",26,21,33,54
https://kawalpemilu.org#53659,"SELAT, SUSUT, BANGLI, BALI",1,207,3,210
https://kawalpemilu.org#53659,"SELAT, SUSUT, BANGLI, BALI",2,188,5,193
https://kawalpemilu.org#53659,"SELAT, SUSUT, BANGLI, BALI",3,170,13,183
https://kawalpemilu.org#53659,"SELAT, SUSUT, BANGLI, BALI",4,174,8,182
https://kawalpemilu.org#53659,"SELAT, SUSUT, BANGLI, BALI",5,189,2,191
https://kawalpemilu.org#53659,"SELAT, SUSUT, BANGLI, BALI",6,173,6,179
https://kawalpemilu.org#53659,"SELAT, SUSUT, BANGLI, BALI",7,211,4,215
https://kawalpemilu.org#53659,"SELAT, SUSUT, BANGLI, BALI",8,228,4,232
https://kawalpemilu.org#53659,"SELAT, SUSUT, BANGLI, BALI",9,174,6,180
https://kawalpemilu.org#53659,"SELAT, SUSUT, BANGLI, BALI",10,184,4,188
https://kawalpemilu.org#53659,"SELAT, SUSUT, BANGLI, BALI",11,175,16,191
https://kawalpemilu.org#53660,"PENGIANGAN, SUSUT, BANGLI, BALI",1,213,8,221
https://kawalpemilu.org#53660,"PENGIANGAN, SUSUT, BANGLI, BALI",2,200,4,204
https://kawalpemilu.org#53660,"PENGIANGAN, SUSUT, BANGLI, BALI",3,208,5,213
https://kawalpemilu.org#53660,"PENGIANGAN, SUSUT, BANGLI, BALI",4,170,7,177
https://kawalpemilu.org#53660,"PENGIANGAN, SUSUT, BANGLI, BALI",5,198,3,201
https://kawalpemilu.org#53660,"PENGIANGAN, SUSUT, BANGLI, BALI",6,189,7,196
https://kawalpemilu.org#53660,"PENGIANGAN, SUSUT, BANGLI, BALI",8,213,10,223
https://kawalpemilu.org#53660,"PENGIANGAN, SUSUT, BANGLI, BALI",9,176,6,182
https://kawalpemilu.org#53660,"PENGIANGAN, SUSUT, BANGLI, BALI",10,174,5,179
https://kawalpemilu.org#53662,"BEBALANG, BANGLI, BANGLI, BALI",1,238,2,240
https://kawalpemilu.org#53662,"BEBALANG, BANGLI, BANGLI, BALI",2,225,8,233
https://kawalpemilu.org#53662,"BEBALANG, BANGLI, BANGLI, BALI",3,244,1,245
https://kawalpemilu.org#53662,"BEBALANG, BANGLI, BANGLI, BALI",4,223,9,232
https://kawalpemilu.org#53662,"BEBALANG, BANGLI, BANGLI, BALI",5,212,4,216
https://kawalpemilu.org#53662,"BEBALANG, BANGLI, BANGLI, BALI",6,233,15,248
https://kawalpemilu.org#53662,"BEBALANG, BANGLI, BANGLI, BALI",7,232,16,246
https://kawalpemilu.org#53662,"BEBALANG, BANGLI, BANGLI, BALI",8,205,31,236
https://kawalpemilu.org#53662,"BEBALANG, BANGLI, BANGLI, BALI",10,220,16,236
https://kawalpemilu.org#53662,"BEBALANG, BANGLI, BANGLI, BALI",11,223,16,239
https://kawalpemilu.org#53662,"BEBALANG, BANGLI, BANGLI, BALI",12,218,15,233
https://kawalpemilu.org#53662,"BEBALANG, BANGLI, BANGLI, BALI",13,218,6,224
https://kawalpemilu.org#53662,"BEBALANG, BANGLI, BANGLI, BALI",14,185,5,190
https://kawalpemilu.org#53662,"BEBALANG, BANGLI, BANGLI, BALI",15,143,3,146
https://kawalpemilu.org#53662,"BEBALANG, BANGLI, BANGLI, BALI",16,133,8,141
https://kawalpemilu.org#53662,"BEBALANG, BANGLI, BANGLI, BALI",17,194,12,206
https://kawalpemilu.org#53662,"BEBALANG, BANGLI, BANGLI, BALI",18,184,9,193
https://kawalpemilu.org#53662,"BEBALANG, BANGLI, BANGLI, BALI",19,209,3,212
https://kawalpemilu.org#53663,"KAWAN, BANGLI, BANGLI, BALI",1,172,13,185
https://kawalpemilu.org#53663,"KAWAN, BANGLI, BANGLI, BALI",2,192,6,198
https://kawalpemilu.org#53663,"KAWAN, BANGLI, BANGLI, BALI",3,129,30,159
https://kawalpemilu.org#53663,"KAWAN, BANGLI, BANGLI, BALI",5,166,17,183
https://kawalpemilu.org#53663,"KAWAN, BANGLI, BANGLI, BALI",6,145,4,149
https://kawalpemilu.org#53663,"KAWAN, BANGLI, BANGLI, BALI",7,163,8,171
https://kawalpemilu.org#53663,"KAWAN, BANGLI, BANGLI, BALI",8,136,9,145
https://kawalpemilu.org#53663,"KAWAN, BANGLI, BANGLI, BALI",9,198,9,207
https://kawalpemilu.org#53663,"KAWAN, BANGLI, BANGLI, BALI",10,198,7,205
https://kawalpemilu.org#53663,"KAWAN, BANGLI, BANGLI, BALI",11,189,21,210
https://kawalpemilu.org#53663,"KAWAN, BANGLI, BANGLI, BALI",12,173,24,197
https://kawalpemilu.org#53663,"KAWAN, BANGLI, BANGLI, BALI",13,168,29,197
https://kawalpemilu.org#53663,"KAWAN, BANGLI, BANGLI, BALI",14,203,13,216
https://kawalpemilu.org#53663,"KAWAN, BANGLI, BANGLI, BALI",15,203,5,208
https://kawalpemilu.org#53663,"KAWAN, BANGLI, BANGLI, BALI",16,202,14,216
https://kawalpemilu.org#53663,"KAWAN, BANGLI, BANGLI, BALI",17,225,15,240
https://kawalpemilu.org#53663,"KAWAN, BANGLI, BANGLI, BALI",18,213,18,231
https://kawalpemilu.org#53663,"KAWAN, BANGLI, BANGLI, BALI",19,220,10,230
https://kawalpemilu.org#53663,"KAWAN, BANGLI, BANGLI, BALI",20,201,10,211
https://kawalpemilu.org#53663,"KAWAN, BANGLI, BANGLI, BALI",21,204,17,221
https://kawalpemilu.org#53663,"KAWAN, BANGLI, BANGLI, BALI",22,196,18,214
https://kawalpemilu.org#53663,"KAWAN, BANGLI, BANGLI, BALI",23,162,6,168
https://kawalpemilu.org#53663,"KAWAN, BANGLI, BANGLI, BALI",24,138,1,139
https://kawalpemilu.org#53663,"KAWAN, BANGLI, BANGLI, BALI",25,242,6,248
https://kawalpemilu.org#53663,"KAWAN, BANGLI, BANGLI, BALI",26,131,10,141
https://kawalpemilu.org#53663,"KAWAN, BANGLI, BANGLI, BALI",27,161,9,170
https://kawalpemilu.org#53663,"KAWAN, BANGLI, BANGLI, BALI",28,151,6,157
https://kawalpemilu.org#53663,"KAWAN, BANGLI, BANGLI, BALI",29,158,7,165
https://kawalpemilu.org#53663,"KAWAN, BANGLI, BANGLI, BALI",31,199,7,206
https://kawalpemilu.org#53663,"KAWAN, BANGLI, BANGLI, BALI",33,27,4,31
https://kawalpemilu.org#53664,"CEMPAGA, BANGLI, BANGLI, BALI",1,249,8,257
https://kawalpemilu.org#53664,"CEMPAGA, BANGLI, BANGLI, BALI",2,160,8,168
https://kawalpemilu.org#53664,"CEMPAGA, BANGLI, BANGLI, BALI",3,205,4,209
https://kawalpemilu.org#53664,"CEMPAGA, BANGLI, BANGLI, BALI",4,201,19,220
https://kawalpemilu.org#53664,"CEMPAGA, BANGLI, BANGLI, BALI",5,200,17,217
https://kawalpemilu.org#53664,"CEMPAGA, BANGLI, BANGLI, BALI",6,206,13,219
https://kawalpemilu.org#53664,"CEMPAGA, BANGLI, BANGLI, BALI",7,255,2,257
https://kawalpemilu.org#53664,"CEMPAGA, BANGLI, BANGLI, BALI",8,138,11,149
https://kawalpemilu.org#53664,"CEMPAGA, BANGLI, BANGLI, BALI",9,203,4,207
https://kawalpemilu.org#53664,"CEMPAGA, BANGLI, BANGLI, BALI",10,197,7,204
https://kawalpemilu.org#53664,"CEMPAGA, BANGLI, BANGLI, BALI",11,191,9,200
https://kawalpemilu.org#53664,"CEMPAGA, BANGLI, BANGLI, BALI",12,199,12,211
https://kawalpemilu.org#53664,"CEMPAGA, BANGLI, BANGLI, BALI",13,220,18,238
https://kawalpemilu.org#53664,"CEMPAGA, BANGLI, BANGLI, BALI",14,231,14,245
https://kawalpemilu.org#53664,"CEMPAGA, BANGLI, BANGLI, BALI",15,160,8,168
https://kawalpemilu.org#53664,"CEMPAGA, BANGLI, BANGLI, BALI",16,233,2,235
https://kawalpemilu.org#53664,"CEMPAGA, BANGLI, BANGLI, BALI",17,232,7,239
https://kawalpemilu.org#53664,"CEMPAGA, BANGLI, BANGLI, BALI",18,222,9,231
https://kawalpemilu.org#53664,"CEMPAGA, BANGLI, BANGLI, BALI",19,164,13,177
https://kawalpemilu.org#53664,"CEMPAGA, BANGLI, BANGLI, BALI",20,190,9,199
https://kawalpemilu.org#53664,"CEMPAGA, BANGLI, BANGLI, BALI",21,168,13,181
https://kawalpemilu.org#53664,"CEMPAGA, BANGLI, BANGLI, BALI",22,160,12,172
https://kawalpemilu.org#53664,"CEMPAGA, BANGLI, BANGLI, BALI",23,195,4,199
https://kawalpemilu.org#53664,"CEMPAGA, BANGLI, BANGLI, BALI",24,164,12,176
https://kawalpemilu.org#53664,"CEMPAGA, BANGLI, BANGLI, BALI",25,173,9,182
https://kawalpemilu.org#53664,"CEMPAGA, BANGLI, BANGLI, BALI",26,162,10,172
https://kawalpemilu.org#53664,"CEMPAGA, BANGLI, BANGLI, BALI",27,173,7,180
https://kawalpemilu.org#53664,"CEMPAGA, BANGLI, BANGLI, BALI",28,170,6,176
https://kawalpemilu.org#53665,"KUBU, BANGLI, BANGLI, BALI",1,156,8,164
https://kawalpemilu.org#53665,"KUBU, BANGLI, BANGLI, BALI",2,176,11,187
https://kawalpemilu.org#53665,"KUBU, BANGLI, BANGLI, BALI",3,165,10,175
https://kawalpemilu.org#53665,"KUBU, BANGLI, BANGLI, BALI",4,155,12,167
https://kawalpemilu.org#53665,"KUBU, BANGLI, BANGLI, BALI",5,172,5,177
https://kawalpemilu.org#53665,"KUBU, BANGLI, BANGLI, BALI",6,175,3,178
https://kawalpemilu.org#53665,"KUBU, BANGLI, BANGLI, BALI",7,177,9,186
https://kawalpemilu.org#53665,"KUBU, BANGLI, BANGLI, BALI",8,168,2,170
https://kawalpemilu.org#53665,"KUBU, BANGLI, BANGLI, BALI",9,174,3,177
https://kawalpemilu.org#53665,"KUBU, BANGLI, BANGLI, BALI",10,164,8,172
https://kawalpemilu.org#53665,"KUBU, BANGLI, BANGLI, BALI",11,203,21,224
https://kawalpemilu.org#53665,"KUBU, BANGLI, BANGLI, BALI",12,197,12,209
https://kawalpemilu.org#53665,"KUBU, BANGLI, BANGLI, BALI",13,201,7,208
https://kawalpemilu.org#53665,"KUBU, BANGLI, BANGLI, BALI",14,174,7,181
https://kawalpemilu.org#53665,"KUBU, BANGLI, BANGLI, BALI",15,175,2,177
https://kawalpemilu.org#53666,"BUNUTIN, BANGLI, BANGLI, BALI",1,225,14,239
https://kawalpemilu.org#53666,"BUNUTIN, BANGLI, BANGLI, BALI",2,233,9,242
https://kawalpemilu.org#53666,"BUNUTIN, BANGLI, BANGLI, BALI",3,234,19,253
https://kawalpemilu.org#53666,"BUNUTIN, BANGLI, BANGLI, BALI",4,219,13,232
https://kawalpemilu.org#53666,"BUNUTIN, BANGLI, BANGLI, BALI",5,191,20,211
https://kawalpemilu.org#53666,"BUNUTIN, BANGLI, BANGLI, BALI",6,202,10,212
https://kawalpemilu.org#53666,"BUNUTIN, BANGLI, BANGLI, BALI",7,162,1,163
https://kawalpemilu.org#53666,"BUNUTIN, BANGLI, BANGLI, BALI",8,145,4,149
https://kawalpemilu.org#53666,"BUNUTIN, BANGLI, BANGLI, BALI",9,209,1,210
https://kawalpemilu.org#53666,"BUNUTIN, BANGLI, BANGLI, BALI",10,200,12,212
https://kawalpemilu.org#53666,"BUNUTIN, BANGLI, BANGLI, BALI",11,205,12,217
https://kawalpemilu.org#53666,"BUNUTIN, BANGLI, BANGLI, BALI",12,193,9,202
https://kawalpemilu.org#53667,"TAMANBALI, BANGLI, BANGLI, BALI",1,186,8,194
https://kawalpemilu.org#53667,"TAMANBALI, BANGLI, BANGLI, BALI",2,177,11,188
https://kawalpemilu.org#53667,"TAMANBALI, BANGLI, BANGLI, BALI",3,155,8,163
https://kawalpemilu.org#53667,"TAMANBALI, BANGLI, BANGLI, BALI",4,157,6,163
https://kawalpemilu.org#53667,"TAMANBALI, BANGLI, BANGLI, BALI",5,152,9,161
https://kawalpemilu.org#53667,"TAMANBALI, BANGLI, BANGLI, BALI",6,168,4,172
https://kawalpemilu.org#53667,"TAMANBALI, BANGLI, BANGLI, BALI",7,159,7,166
https://kawalpemilu.org#53667,"TAMANBALI, BANGLI, BANGLI, BALI",8,132,9,141
https://kawalpemilu.org#53667,"TAMANBALI, BANGLI, BANGLI, BALI",9,103,14,117
https://kawalpemilu.org#53667,"TAMANBALI, BANGLI, BANGLI, BALI",10,225,20,245
https://kawalpemilu.org#53667,"TAMANBALI, BANGLI, BANGLI, BALI",11,216,19,235
https://kawalpemilu.org#53667,"TAMANBALI, BANGLI, BANGLI, BALI",12,213,8,221
https://kawalpemilu.org#53667,"TAMANBALI, BANGLI, BANGLI, BALI",13,148,6,154
https://kawalpemilu.org#53667,"TAMANBALI, BANGLI, BANGLI, BALI",14,142,11,153
https://kawalpemilu.org#53667,"TAMANBALI, BANGLI, BANGLI, BALI",15,122,14,136
https://kawalpemilu.org#53667,"TAMANBALI, BANGLI, BANGLI, BALI",16,207,9,216
https://kawalpemilu.org#53667,"TAMANBALI, BANGLI, BANGLI, BALI",17,199,6,205
https://kawalpemilu.org#53667,"TAMANBALI, BANGLI, BANGLI, BALI",18,195,4,199
https://kawalpemilu.org#53667,"TAMANBALI, BANGLI, BANGLI, BALI",19,186,9,195
https://kawalpemilu.org#53667,"TAMANBALI, BANGLI, BANGLI, BALI",20,174,1,175
https://kawalpemilu.org#53667,"TAMANBALI, BANGLI, BANGLI, BALI",21,171,3,174
https://kawalpemilu.org#53667,"TAMANBALI, BANGLI, BANGLI, BALI",22,142,10,152
https://kawalpemilu.org#53667,"TAMANBALI, BANGLI, BANGLI, BALI",23,144,3,147
https://kawalpemilu.org#53667,"TAMANBALI, BANGLI, BANGLI, BALI",24,138,6,144
https://kawalpemilu.org#53667,"TAMANBALI, BANGLI, BANGLI, BALI",25,140,4,144
https://kawalpemilu.org#53667,"TAMANBALI, BANGLI, BANGLI, BALI",26,159,10,169
https://kawalpemilu.org#53668,"KAYUBIHI, BANGLI, BANGLI, BALI",1,213,7,220
https://kawalpemilu.org#53668,"KAYUBIHI, BANGLI, BANGLI, BALI",2,210,5,215
https://kawalpemilu.org#53668,"KAYUBIHI, BANGLI, BANGLI, BALI",3,165,9,174
https://kawalpemilu.org#53668,"KAYUBIHI, BANGLI, BANGLI, BALI",4,176,8,184
https://kawalpemilu.org#53668,"KAYUBIHI, BANGLI, BANGLI, BALI",5,238,9,247
https://kawalpemilu.org#53668,"KAYUBIHI, BANGLI, BANGLI, BALI",6,187,12,199
https://kawalpemilu.org#53668,"KAYUBIHI, BANGLI, BANGLI, BALI",7,175,6,181
https://kawalpemilu.org#53668,"KAYUBIHI, BANGLI, BANGLI, BALI",8,185,22,207
https://kawalpemilu.org#53668,"KAYUBIHI, BANGLI, BANGLI, BALI",9,220,25,245
https://kawalpemilu.org#53668,"KAYUBIHI, BANGLI, BANGLI, BALI",10,278,9,287
https://kawalpemilu.org#53668,"KAYUBIHI, BANGLI, BANGLI, BALI",11,265,2,267
https://kawalpemilu.org#53668,"KAYUBIHI, BANGLI, BANGLI, BALI",12,144,10,154
https://kawalpemilu.org#53668,"KAYUBIHI, BANGLI, BANGLI, BALI",13,129,12,141
https://kawalpemilu.org#53668,"KAYUBIHI, BANGLI, BANGLI, BALI",14,173,5,178
https://kawalpemilu.org#53668,"KAYUBIHI, BANGLI, BANGLI, BALI",15,161,6,167
https://kawalpemilu.org#53668,"KAYUBIHI, BANGLI, BANGLI, BALI",16,171,6,177
https://kawalpemilu.org#53668,"KAYUBIHI, BANGLI, BANGLI, BALI",17,180,17,197
https://kawalpemilu.org#53668,"KAYUBIHI, BANGLI, BANGLI, BALI",18,189,8,197
https://kawalpemilu.org#53668,"KAYUBIHI, BANGLI, BANGLI, BALI",19,186,13,199
https://kawalpemilu.org#53669,"PENGOTAN, BANGLI, BANGLI, BALI",1,189,18,207
https://kawalpemilu.org#53669,"PENGOTAN, BANGLI, BANGLI, BALI",2,179,35,214
https://kawalpemilu.org#53669,"PENGOTAN, BANGLI, BANGLI, BALI",3,157,13,170
https://kawalpemilu.org#53669,"PENGOTAN, BANGLI, BANGLI, BALI",4,150,10,160
https://kawalpemilu.org#53669,"PENGOTAN, BANGLI, BANGLI, BALI",5,137,4,141
https://kawalpemilu.org#53669,"PENGOTAN, BANGLI, BANGLI, BALI",6,142,10,152
https://kawalpemilu.org#53669,"PENGOTAN, BANGLI, BANGLI, BALI",7,140,7,147
https://kawalpemilu.org#53669,"PENGOTAN, BANGLI, BANGLI, BALI",8,131,2,133
https://kawalpemilu.org#53669,"PENGOTAN, BANGLI, BANGLI, BALI",9,131,5,136
https://kawalpemilu.org#53669,"PENGOTAN, BANGLI, BANGLI, BALI",10,121,10,131
https://kawalpemilu.org#53669,"PENGOTAN, BANGLI, BANGLI, BALI",11,111,11,122
https://kawalpemilu.org#53669,"PENGOTAN, BANGLI, BANGLI, BALI",12,129,11,140
https://kawalpemilu.org#53669,"PENGOTAN, BANGLI, BANGLI, BALI",13,108,6,114
https://kawalpemilu.org#53669,"PENGOTAN, BANGLI, BANGLI, BALI",14,144,4,148
https://kawalpemilu.org#53669,"PENGOTAN, BANGLI, BANGLI, BALI",15,133,10,143
https://kawalpemilu.org#53669,"PENGOTAN, BANGLI, BANGLI, BALI",16,187,14,201
https://kawalpemilu.org#53669,"PENGOTAN, BANGLI, BANGLI, BALI",17,167,22,189
https://kawalpemilu.org#53670,"LANDIH, BANGLI, BANGLI, BALI",1,231,12,243
https://kawalpemilu.org#53670,"LANDIH, BANGLI, BANGLI, BALI",2,234,16,250
https://kawalpemilu.org#53670,"LANDIH, BANGLI, BANGLI, BALI",3,226,11,237
https://kawalpemilu.org#53670,"LANDIH, BANGLI, BANGLI, BALI",4,159,34,193
https://kawalpemilu.org#53670,"LANDIH, BANGLI, BANGLI, BALI",5,159,29,188
https://kawalpemilu.org#53670,"LANDIH, BANGLI, BANGLI, BALI",6,176,20,196
https://kawalpemilu.org#53670,"LANDIH, BANGLI, BANGLI, BALI",7,205,3,208
https://kawalpemilu.org#53670,"LANDIH, BANGLI, BANGLI, BALI",8,192,6,198
https://kawalpemilu.org#53670,"LANDIH, BANGLI, BANGLI, BALI",9,182,4,186
https://kawalpemilu.org#53670,"LANDIH, BANGLI, BANGLI, BALI",10,155,46,201
https://kawalpemilu.org#53670,"LANDIH, BANGLI, BANGLI, BALI",11,151,46,197
https://kawalpemilu.org#53670,"LANDIH, BANGLI, BANGLI, BALI",12,193,5,198
https://kawalpemilu.org#53670,"LANDIH, BANGLI, BANGLI, BALI",13,189,12,201
https://kawalpemilu.org#53672,"JEHEM, TEMBUKU, BANGLI, BALI",1,203,22,225
https://kawalpemilu.org#53672,"JEHEM, TEMBUKU, BANGLI, BALI",2,131,4,135
https://kawalpemilu.org#53672,"JEHEM, TEMBUKU, BANGLI, BALI",3,181,16,197
https://kawalpemilu.org#53672,"JEHEM, TEMBUKU, BANGLI, BALI",4,183,7,190
https://kawalpemilu.org#53672,"JEHEM, TEMBUKU, BANGLI, BALI",5,227,13,240
https://kawalpemilu.org#53672,"JEHEM, TEMBUKU, BANGLI, BALI",6,201,9,210
https://kawalpemilu.org#53672,"JEHEM, TEMBUKU, BANGLI, BALI",7,201,14,215
https://kawalpemilu.org#53672,"JEHEM, TEMBUKU, BANGLI, BALI",8,180,17,197
https://kawalpemilu.org#53672,"JEHEM, TEMBUKU, BANGLI, BALI",9,179,17,196
https://kawalpemilu.org#53672,"JEHEM, TEMBUKU, BANGLI, BALI",10,178,28,206
https://kawalpemilu.org#53672,"JEHEM, TEMBUKU, BANGLI, BALI",11,190,16,206
https://kawalpemilu.org#53672,"JEHEM, TEMBUKU, BANGLI, BALI",12,176,23,199
https://kawalpemilu.org#53672,"JEHEM, TEMBUKU, BANGLI, BALI",13,165,23,188
https://kawalpemilu.org#53672,"JEHEM, TEMBUKU, BANGLI, BALI",14,163,16,179
https://kawalpemilu.org#53672,"JEHEM, TEMBUKU, BANGLI, BALI",15,167,20,187
https://kawalpemilu.org#53672,"JEHEM, TEMBUKU, BANGLI, BALI",16,172,1,173
https://kawalpemilu.org#53672,"JEHEM, TEMBUKU, BANGLI, BALI",17,177,5,182
https://kawalpemilu.org#53672,"JEHEM, TEMBUKU, BANGLI, BALI",18,171,10,181
https://kawalpemilu.org#53672,"JEHEM, TEMBUKU, BANGLI, BALI",19,166,8,174
https://kawalpemilu.org#53672,"JEHEM, TEMBUKU, BANGLI, BALI",20,188,3,191
https://kawalpemilu.org#53672,"JEHEM, TEMBUKU, BANGLI, BALI",21,176,7,183
https://kawalpemilu.org#53672,"JEHEM, TEMBUKU, BANGLI, BALI",22,271,11,282
https://kawalpemilu.org#53672,"JEHEM, TEMBUKU, BANGLI, BALI",23,170,17,187
https://kawalpemilu.org#53672,"JEHEM, TEMBUKU, BANGLI, BALI",24,161,26,187
https://kawalpemilu.org#53672,"JEHEM, TEMBUKU, BANGLI, BALI",25,164,17,181
https://kawalpemilu.org#53672,"JEHEM, TEMBUKU, BANGLI, BALI",26,146,3,149
https://kawalpemilu.org#53672,"JEHEM, TEMBUKU, BANGLI, BALI",27,139,11,150
https://kawalpemilu.org#53672,"JEHEM, TEMBUKU, BANGLI, BALI",28,110,11,121
https://kawalpemilu.org#53673,"TEMBUKU, TEMBUKU, BANGLI, BALI",1,187,6,193
https://kawalpemilu.org#53673,"TEMBUKU, TEMBUKU, BANGLI, BALI",2,196,5,201
https://kawalpemilu.org#53673,"TEMBUKU, TEMBUKU, BANGLI, BALI",3,258,2,260
https://kawalpemilu.org#53673,"TEMBUKU, TEMBUKU, BANGLI, BALI",4,171,11,182
https://kawalpemilu.org#53673,"TEMBUKU, TEMBUKU, BANGLI, BALI",5,196,5,201
https://kawalpemilu.org#53673,"TEMBUKU, TEMBUKU, BANGLI, BALI",6,147,7,154
https://kawalpemilu.org#53673,"TEMBUKU, TEMBUKU, BANGLI, BALI",7,136,6,142
https://kawalpemilu.org#53673,"TEMBUKU, TEMBUKU, BANGLI, BALI",8,197,7,204
https://kawalpemilu.org#53673,"TEMBUKU, TEMBUKU, BANGLI, BALI",9,181,15,196
https://kawalpemilu.org#53673,"TEMBUKU, TEMBUKU, BANGLI, BALI",10,172,12,184
https://kawalpemilu.org#53673,"TEMBUKU, TEMBUKU, BANGLI, BALI",11,160,16,176
https://kawalpemilu.org#53673,"TEMBUKU, TEMBUKU, BANGLI, BALI",12,123,7,130
https://kawalpemilu.org#53673,"TEMBUKU, TEMBUKU, BANGLI, BALI",13,122,9,131
https://kawalpemilu.org#53673,"TEMBUKU, TEMBUKU, BANGLI, BALI",14,203,21,224
https://kawalpemilu.org#53673,"TEMBUKU, TEMBUKU, BANGLI, BALI",15,202,7,209
https://kawalpemilu.org#53673,"TEMBUKU, TEMBUKU, BANGLI, BALI",16,204,5,209
https://kawalpemilu.org#53673,"TEMBUKU, TEMBUKU, BANGLI, BALI",17,216,13,229
https://kawalpemilu.org#53673,"TEMBUKU, TEMBUKU, BANGLI, BALI",18,147,3,150
https://kawalpemilu.org#53673,"TEMBUKU, TEMBUKU, BANGLI, BALI",19,141,1,142
https://kawalpemilu.org#53674,"YANGAPI, TEMBUKU, BANGLI, BALI",1,235,11,246
https://kawalpemilu.org#53674,"YANGAPI, TEMBUKU, BANGLI, BALI",2,237,10,247
https://kawalpemilu.org#53674,"YANGAPI, TEMBUKU, BANGLI, BALI",3,186,16,202
https://kawalpemilu.org#53674,"YANGAPI, TEMBUKU, BANGLI, BALI",4,196,19,215
https://kawalpemilu.org#53674,"YANGAPI, TEMBUKU, BANGLI, BALI",5,157,0,157
https://kawalpemilu.org#53674,"YANGAPI, TEMBUKU, BANGLI, BALI",6,152,0,152
https://kawalpemilu.org#53674,"YANGAPI, TEMBUKU, BANGLI, BALI",7,132,12,144
https://kawalpemilu.org#53674,"YANGAPI, TEMBUKU, BANGLI, BALI",8,129,13,142
https://kawalpemilu.org#53674,"YANGAPI, TEMBUKU, BANGLI, BALI",9,163,4,167
https://kawalpemilu.org#53674,"YANGAPI, TEMBUKU, BANGLI, BALI",10,174,4,178
https://kawalpemilu.org#53674,"YANGAPI, TEMBUKU, BANGLI, BALI",11,165,11,176
https://kawalpemilu.org#53674,"YANGAPI, TEMBUKU, BANGLI, BALI",12,167,16,183
https://kawalpemilu.org#53674,"YANGAPI, TEMBUKU, BANGLI, BALI",13,161,7,168
https://kawalpemilu.org#53674,"YANGAPI, TEMBUKU, BANGLI, BALI",14,158,12,170
https://kawalpemilu.org#53674,"YANGAPI, TEMBUKU, BANGLI, BALI",15,211,2,213
https://kawalpemilu.org#53674,"YANGAPI, TEMBUKU, BANGLI, BALI",16,205,7,212
https://kawalpemilu.org#53674,"YANGAPI, TEMBUKU, BANGLI, BALI",17,193,13,206
https://kawalpemilu.org#53674,"YANGAPI, TEMBUKU, BANGLI, BALI",18,181,19,200
https://kawalpemilu.org#53674,"YANGAPI, TEMBUKU, BANGLI, BALI",19,204,13,217
https://kawalpemilu.org#53674,"YANGAPI, TEMBUKU, BANGLI, BALI",20,180,3,183
https://kawalpemilu.org#53674,"YANGAPI, TEMBUKU, BANGLI, BALI",21,188,13,201
https://kawalpemilu.org#53674,"YANGAPI, TEMBUKU, BANGLI, BALI",22,166,16,182
https://kawalpemilu.org#53674,"YANGAPI, TEMBUKU, BANGLI, BALI",23,209,9,218
https://kawalpemilu.org#53674,"YANGAPI, TEMBUKU, BANGLI, BALI",24,199,8,207
https://kawalpemilu.org#53674,"YANGAPI, TEMBUKU, BANGLI, BALI",25,206,14,220
https://kawalpemilu.org#53674,"YANGAPI, TEMBUKU, BANGLI, BALI",26,217,12,229
https://kawalpemilu.org#53674,"YANGAPI, TEMBUKU, BANGLI, BALI",27,223,3,226
https://kawalpemilu.org#53674,"YANGAPI, TEMBUKU, BANGLI, BALI",28,216,5,221
https://kawalpemilu.org#53674,"YANGAPI, TEMBUKU, BANGLI, BALI",29,161,2,163
https://kawalpemilu.org#53674,"YANGAPI, TEMBUKU, BANGLI, BALI",30,70,0,70
https://kawalpemilu.org#53675,"UNDISAN, TEMBUKU, BANGLI, BALI",1,168,11,179
https://kawalpemilu.org#53675,"UNDISAN, TEMBUKU, BANGLI, BALI",2,188,12,200
https://kawalpemilu.org#53675,"UNDISAN, TEMBUKU, BANGLI, BALI",3,163,3,166
https://kawalpemilu.org#53675,"UNDISAN, TEMBUKU, BANGLI, BALI",4,166,11,177
https://kawalpemilu.org#53675,"UNDISAN, TEMBUKU, BANGLI, BALI",5,179,8,187
https://kawalpemilu.org#53675,"UNDISAN, TEMBUKU, BANGLI, BALI",6,171,7,178
https://kawalpemilu.org#53675,"UNDISAN, TEMBUKU, BANGLI, BALI",7,154,9,163
https://kawalpemilu.org#53675,"UNDISAN, TEMBUKU, BANGLI, BALI",8,178,11,189
https://kawalpemilu.org#53675,"UNDISAN, TEMBUKU, BANGLI, BALI",9,167,6,173
https://kawalpemilu.org#53675,"UNDISAN, TEMBUKU, BANGLI, BALI",10,206,13,219
https://kawalpemilu.org#53675,"UNDISAN, TEMBUKU, BANGLI, BALI",11,153,21,174
https://kawalpemilu.org#53675,"UNDISAN, TEMBUKU, BANGLI, BALI",12,153,21,174
https://kawalpemilu.org#53675,"UNDISAN, TEMBUKU, BANGLI, BALI",13,162,1,163
https://kawalpemilu.org#53675,"UNDISAN, TEMBUKU, BANGLI, BALI",14,135,10,145
https://kawalpemilu.org#53675,"UNDISAN, TEMBUKU, BANGLI, BALI",15,143,4,147
https://kawalpemilu.org#53676,"BANGBANG, TEMBUKU, BANGLI, BALI",1,148,2,150
https://kawalpemilu.org#53676,"BANGBANG, TEMBUKU, BANGLI, BALI",2,140,2,142
https://kawalpemilu.org#53676,"BANGBANG, TEMBUKU, BANGLI, BALI",3,169,4,173
https://kawalpemilu.org#53676,"BANGBANG, TEMBUKU, BANGLI, BALI",4,172,4,176
https://kawalpemilu.org#53676,"BANGBANG, TEMBUKU, BANGLI, BALI",5,156,2,158
https://kawalpemilu.org#53676,"BANGBANG, TEMBUKU, BANGLI, BALI",6,140,4,144
https://kawalpemilu.org#53676,"BANGBANG, TEMBUKU, BANGLI, BALI",7,172,8,180
https://kawalpemilu.org#53676,"BANGBANG, TEMBUKU, BANGLI, BALI",8,178,7,185
https://kawalpemilu.org#53676,"BANGBANG, TEMBUKU, BANGLI, BALI",9,133,4,137
https://kawalpemilu.org#53676,"BANGBANG, TEMBUKU, BANGLI, BALI",10,140,3,143
https://kawalpemilu.org#53676,"BANGBANG, TEMBUKU, BANGLI, BALI",11,239,2,241
https://kawalpemilu.org#53676,"BANGBANG, TEMBUKU, BANGLI, BALI",12,156,7,163
https://kawalpemilu.org#53676,"BANGBANG, TEMBUKU, BANGLI, BALI",13,152,7,159
https://kawalpemilu.org#53676,"BANGBANG, TEMBUKU, BANGLI, BALI",14,159,7,166
https://kawalpemilu.org#53676,"BANGBANG, TEMBUKU, BANGLI, BALI",15,133,6,139
https://kawalpemilu.org#53676,"BANGBANG, TEMBUKU, BANGLI, BALI",16,180,4,184
https://kawalpemilu.org#53676,"BANGBANG, TEMBUKU, BANGLI, BALI",17,178,5,183
https://kawalpemilu.org#53676,"BANGBANG, TEMBUKU, BANGLI, BALI",18,198,0,198
https://kawalpemilu.org#53676,"BANGBANG, TEMBUKU, BANGLI, BALI",19,198,4,202
https://kawalpemilu.org#53677,"PENINJOAN, TEMBUKU, BANGLI, BALI",1,122,2,124
https://kawalpemilu.org#53677,"PENINJOAN, TEMBUKU, BANGLI, BALI",2,153,3,156
https://kawalpemilu.org#53677,"PENINJOAN, TEMBUKU, BANGLI, BALI",3,202,10,212
https://kawalpemilu.org#53677,"PENINJOAN, TEMBUKU, BANGLI, BALI",4,205,11,216
https://kawalpemilu.org#53677,"PENINJOAN, TEMBUKU, BANGLI, BALI",5,221,27,248
https://kawalpemilu.org#53677,"PENINJOAN, TEMBUKU, BANGLI, BALI",6,205,20,225
https://kawalpemilu.org#53677,"PENINJOAN, TEMBUKU, BANGLI, BALI",7,168,1,169
https://kawalpemilu.org#53677,"PENINJOAN, TEMBUKU, BANGLI, BALI",8,152,2,154
https://kawalpemilu.org#53677,"PENINJOAN, TEMBUKU, BANGLI, BALI",9,140,7,147
https://kawalpemilu.org#53677,"PENINJOAN, TEMBUKU, BANGLI, BALI",10,140,6,146
https://kawalpemilu.org#53677,"PENINJOAN, TEMBUKU, BANGLI, BALI",11,226,2,228
https://kawalpemilu.org#53677,"PENINJOAN, TEMBUKU, BANGLI, BALI",12,227,5,232
https://kawalpemilu.org#53677,"PENINJOAN, TEMBUKU, BANGLI, BALI",13,221,1,222
https://kawalpemilu.org#53677,"PENINJOAN, TEMBUKU, BANGLI, BALI",14,205,7,212
https://kawalpemilu.org#53677,"PENINJOAN, TEMBUKU, BANGLI, BALI",15,201,7,208
https://kawalpemilu.org#53677,"PENINJOAN, TEMBUKU, BANGLI, BALI",16,194,7,201
https://kawalpemilu.org#53677,"PENINJOAN, TEMBUKU, BANGLI, BALI",17,180,10,190
https://kawalpemilu.org#53677,"PENINJOAN, TEMBUKU, BANGLI, BALI",18,171,36,207
https://kawalpemilu.org#53677,"PENINJOAN, TEMBUKU, BANGLI, BALI",19,157,27,184
https://kawalpemilu.org#53677,"PENINJOAN, TEMBUKU, BANGLI, BALI",20,152,38,190
https://kawalpemilu.org#53677,"PENINJOAN, TEMBUKU, BANGLI, BALI",21,147,32,179
https://kawalpemilu.org#53677,"PENINJOAN, TEMBUKU, BANGLI, BALI",22,172,7,179
https://kawalpemilu.org#53677,"PENINJOAN, TEMBUKU, BANGLI, BALI",23,157,6,163
https://kawalpemilu.org#53677,"PENINJOAN, TEMBUKU, BANGLI, BALI",24,141,6,147
https://kawalpemilu.org#53677,"PENINJOAN, TEMBUKU, BANGLI, BALI",25,140,6,146
https://kawalpemilu.org#53677,"PENINJOAN, TEMBUKU, BANGLI, BALI",26,276,10,286
https://kawalpemilu.org#53677,"PENINJOAN, TEMBUKU, BANGLI, BALI",27,139,20,159
https://kawalpemilu.org#53677,"PENINJOAN, TEMBUKU, BANGLI, BALI",28,135,20,155
https://kawalpemilu.org#53677,"PENINJOAN, TEMBUKU, BANGLI, BALI",29,174,11,185
https://kawalpemilu.org#53677,"PENINJOAN, TEMBUKU, BANGLI, BALI",30,178,8,186
https://kawalpemilu.org#53677,"PENINJOAN, TEMBUKU, BANGLI, BALI",31,184,15,199
https://kawalpemilu.org#53677,"PENINJOAN, TEMBUKU, BANGLI, BALI",32,167,7,174
https://kawalpemilu.org#53677,"PENINJOAN, TEMBUKU, BANGLI, BALI",33,203,19,222
https://kawalpemilu.org#53679,"MENGANI, KINTAMANI, BANGLI, BALI",1,166,8,174
https://kawalpemilu.org#53679,"MENGANI, KINTAMANI, BANGLI, BALI",2,163,12,175
https://kawalpemilu.org#53679,"MENGANI, KINTAMANI, BANGLI, BALI",3,124,12,136
https://kawalpemilu.org#53679,"MENGANI, KINTAMANI, BANGLI, BALI",4,125,17,142
https://kawalpemilu.org#53680,"BINYAN, KINTAMANI, BANGLI, BALI",1,200,10,210
https://kawalpemilu.org#53681,"ULIAN, KINTAMANI, BANGLI, BALI",1,206,13,219
https://kawalpemilu.org#53681,"ULIAN, KINTAMANI, BANGLI, BALI",2,235,5,240
https://kawalpemilu.org#53681,"ULIAN, KINTAMANI, BANGLI, BALI",3,221,14,235
https://kawalpemilu.org#53682,"BUNUTIN, KINTAMANI, BANGLI, BALI",1,166,4,170
https://kawalpemilu.org#53682,"BUNUTIN, KINTAMANI, BANGLI, BALI",3,163,1,164
https://kawalpemilu.org#53682,"BUNUTIN, KINTAMANI, BANGLI, BALI",4,170,1,171
https://kawalpemilu.org#53683,"LANGGAHAN, KINTAMANI, BANGLI, BALI",1,260,6,266
https://kawalpemilu.org#53683,"LANGGAHAN, KINTAMANI, BANGLI, BALI",2,148,0,148
https://kawalpemilu.org#53683,"LANGGAHAN, KINTAMANI, BANGLI, BALI",3,140,5,145
https://kawalpemilu.org#53683,"LANGGAHAN, KINTAMANI, BANGLI, BALI",4,134,0,134
https://kawalpemilu.org#53683,"LANGGAHAN, KINTAMANI, BANGLI, BALI",5,129,4,133
https://kawalpemilu.org#53684,"LEMBEAN, KINTAMANI, BANGLI, BALI",1,161,15,176
https://kawalpemilu.org#53684,"LEMBEAN, KINTAMANI, BANGLI, BALI",2,133,24,157
https://kawalpemilu.org#53684,"LEMBEAN, KINTAMANI, BANGLI, BALI",3,164,15,179
https://kawalpemilu.org#53685,"MANIKLIYU, KINTAMANI, BANGLI, BALI",1,195,7,202
https://kawalpemilu.org#53685,"MANIKLIYU, KINTAMANI, BANGLI, BALI",2,188,11,199
https://kawalpemilu.org#53685,"MANIKLIYU, KINTAMANI, BANGLI, BALI",3,194,7,201
https://kawalpemilu.org#53685,"MANIKLIYU, KINTAMANI, BANGLI, BALI",4,182,7,189
https://kawalpemilu.org#53685,"MANIKLIYU, KINTAMANI, BANGLI, BALI",5,241,8,249
https://kawalpemilu.org#53686,"BAYUNG CERIK, KINTAMANI, BANGLI, BALI",1,170,8,178
https://kawalpemilu.org#53686,"BAYUNG CERIK, KINTAMANI, BANGLI, BALI",2,172,9,181
https://kawalpemilu.org#53686,"BAYUNG CERIK, KINTAMANI, BANGLI, BALI",3,147,9,156
https://kawalpemilu.org#53686,"BAYUNG CERIK, KINTAMANI, BANGLI, BALI",4,241,7,248
https://kawalpemilu.org#53687,"MANGGUH, KINTAMANI, BANGLI, BALI",1,172,2,174
https://kawalpemilu.org#53687,"MANGGUH, KINTAMANI, BANGLI, BALI",3,162,2,164
https://kawalpemilu.org#53688,"BELANCAN, KINTAMANI, BANGLI, BALI",1,235,19,254
https://kawalpemilu.org#53688,"BELANCAN, KINTAMANI, BANGLI, BALI",2,200,6,206
https://kawalpemilu.org#53688,"BELANCAN, KINTAMANI, BANGLI, BALI",3,220,4,224
https://kawalpemilu.org#53688,"BELANCAN, KINTAMANI, BANGLI, BALI",4,180,3,183
https://kawalpemilu.org#53688,"BELANCAN, KINTAMANI, BANGLI, BALI",5,164,15,179
https://kawalpemilu.org#53688,"BELANCAN, KINTAMANI, BANGLI, BALI",6,175,10,185
https://kawalpemilu.org#53688,"BELANCAN, KINTAMANI, BANGLI, BALI",7,172,9,181
https://kawalpemilu.org#53689,"KATUNG, KINTAMANI, BANGLI, BALI",1,187,9,196
https://kawalpemilu.org#53689,"KATUNG, KINTAMANI, BANGLI, BALI",2,174,16,190
https://kawalpemilu.org#53689,"KATUNG, KINTAMANI, BANGLI, BALI",3,195,6,201
https://kawalpemilu.org#53689,"KATUNG, KINTAMANI, BANGLI, BALI",4,190,12,202
https://kawalpemilu.org#53689,"KATUNG, KINTAMANI, BANGLI, BALI",5,164,12,176
https://kawalpemilu.org#53689,"KATUNG, KINTAMANI, BANGLI, BALI",6,173,15,188
https://kawalpemilu.org#53690,"BANUA, KINTAMANI, BANGLI, BALI",1,252,5,257
https://kawalpemilu.org#53690,"BANUA, KINTAMANI, BANGLI, BALI",2,244,9,253
https://kawalpemilu.org#53691,"ABUAN, KINTAMANI, BANGLI, BALI",1,204,8,212
https://kawalpemilu.org#53691,"ABUAN, KINTAMANI, BANGLI, BALI",2,189,17,206
https://kawalpemilu.org#53691,"ABUAN, KINTAMANI, BANGLI, BALI",3,197,5,202
https://kawalpemilu.org#53691,"ABUAN, KINTAMANI, BANGLI, BALI",4,229,15,244
https://kawalpemilu.org#53691,"ABUAN, KINTAMANI, BANGLI, BALI",5,220,23,243
https://kawalpemilu.org#53692,"BONYOH, KINTAMANI, BANGLI, BALI",1,197,11,208
https://kawalpemilu.org#53692,"BONYOH, KINTAMANI, BANGLI, BALI",2,200,4,204
https://kawalpemilu.org#53692,"BONYOH, KINTAMANI, BANGLI, BALI",3,207,8,215
https://kawalpemilu.org#53692,"BONYOH, KINTAMANI, BANGLI, BALI",4,205,7,212
https://kawalpemilu.org#53693,"SEKAAN, KINTAMANI, BANGLI, BALI",1,183,2,185
https://kawalpemilu.org#53693,"SEKAAN, KINTAMANI, BANGLI, BALI",2,187,5,192
https://kawalpemilu.org#53693,"SEKAAN, KINTAMANI, BANGLI, BALI",3,185,6,191
https://kawalpemilu.org#53693,"SEKAAN, KINTAMANI, BANGLI, BALI",4,231,4,235
https://kawalpemilu.org#53693,"SEKAAN, KINTAMANI, BANGLI, BALI",5,230,3,233
https://kawalpemilu.org#53693,"SEKAAN, KINTAMANI, BANGLI, BALI",6,191,8,199
https://kawalpemilu.org#53694,"BAYUNG GEDE, KINTAMANI, BANGLI, BALI",2,182,3,190
https://kawalpemilu.org#53694,"BAYUNG GEDE, KINTAMANI, BANGLI, BALI",3,244,6,250
https://kawalpemilu.org#53694,"BAYUNG GEDE, KINTAMANI, BANGLI, BALI",4,251,3,254
https://kawalpemilu.org#53694,"BAYUNG GEDE, KINTAMANI, BANGLI, BALI",5,245,3,248
https://kawalpemilu.org#53694,"BAYUNG GEDE, KINTAMANI, BANGLI, BALI",6,90,5,95
https://kawalpemilu.org#53694,"BAYUNG GEDE, KINTAMANI, BANGLI, BALI",7,152,16,168
https://kawalpemilu.org#53694,"BAYUNG GEDE, KINTAMANI, BANGLI, BALI",8,55,2,57
https://kawalpemilu.org#53695,"SEKARDADI, KINTAMANI, BANGLI, BALI",1,206,6,212
https://kawalpemilu.org#53695,"SEKARDADI, KINTAMANI, BANGLI, BALI",2,179,9,188
https://kawalpemilu.org#53695,"SEKARDADI, KINTAMANI, BANGLI, BALI",3,186,9,195
https://kawalpemilu.org#53695,"SEKARDADI, KINTAMANI, BANGLI, BALI",4,205,7,212
https://kawalpemilu.org#53695,"SEKARDADI, KINTAMANI, BANGLI, BALI",5,218,7,225
https://kawalpemilu.org#53695,"SEKARDADI, KINTAMANI, BANGLI, BALI",6,212,4,216
https://kawalpemilu.org#53696,"KEDISAN, KINTAMANI, BANGLI, BALI",1,142,13,155
https://kawalpemilu.org#53696,"KEDISAN, KINTAMANI, BANGLI, BALI",2,133,9,142
https://kawalpemilu.org#53696,"KEDISAN, KINTAMANI, BANGLI, BALI",3,174,4,178
https://kawalpemilu.org#53696,"KEDISAN, KINTAMANI, BANGLI, BALI",4,202,4,206
https://kawalpemilu.org#53696,"KEDISAN, KINTAMANI, BANGLI, BALI",5,208,9,217
https://kawalpemilu.org#53696,"KEDISAN, KINTAMANI, BANGLI, BALI",6,153,1,154
https://kawalpemilu.org#53697,"BUAHAN, KINTAMANI, BANGLI, BALI",1,166,17,183
https://kawalpemilu.org#53697,"BUAHAN, KINTAMANI, BANGLI, BALI",2,95,7,102
https://kawalpemilu.org#53697,"BUAHAN, KINTAMANI, BANGLI, BALI",3,174,8,182
https://kawalpemilu.org#53697,"BUAHAN, KINTAMANI, BANGLI, BALI",4,148,4,152
https://kawalpemilu.org#53697,"BUAHAN, KINTAMANI, BANGLI, BALI",5,183,13,196
https://kawalpemilu.org#53697,"BUAHAN, KINTAMANI, BANGLI, BALI",6,179,29,203
https://kawalpemilu.org#53697,"BUAHAN, KINTAMANI, BANGLI, BALI",7,175,8,183
https://kawalpemilu.org#53698,"ABANGSONGAN, KINTAMANI, BANGLI, BALI",1,199,15,214
https://kawalpemilu.org#53698,"ABANGSONGAN, KINTAMANI, BANGLI, BALI",2,179,14,193
https://kawalpemilu.org#53698,"ABANGSONGAN, KINTAMANI, BANGLI, BALI",3,192,0,192
https://kawalpemilu.org#53698,"ABANGSONGAN, KINTAMANI, BANGLI, BALI",4,142,1,143
https://kawalpemilu.org#53698,"ABANGSONGAN, KINTAMANI, BANGLI, BALI",5,102,1,103
https://kawalpemilu.org#53699,"SUTER, KINTAMANI, BANGLI, BALI",1,90,15,105
https://kawalpemilu.org#53699,"SUTER, KINTAMANI, BANGLI, BALI",2,143,15,158
https://kawalpemilu.org#53699,"SUTER, KINTAMANI, BANGLI, BALI",3,144,14,158
https://kawalpemilu.org#53699,"SUTER, KINTAMANI, BANGLI, BALI",4,105,5,110
https://kawalpemilu.org#53699,"SUTER, KINTAMANI, BANGLI, BALI",5,172,3,175
https://kawalpemilu.org#53699,"SUTER, KINTAMANI, BANGLI, BALI",6,170,0,170
https://kawalpemilu.org#53699,"SUTER, KINTAMANI, BANGLI, BALI",7,192,19,211
https://kawalpemilu.org#53699,"SUTER, KINTAMANI, BANGLI, BALI",8,170,25,195
https://kawalpemilu.org#53700,"ABANG BATUDINDING, KINTAMANI, BANGLI, BALI",1,235,1,236
https://kawalpemilu.org#53700,"ABANG BATUDINDING, KINTAMANI, BANGLI, BALI",2,213,7,220
https://kawalpemilu.org#53700,"ABANG BATUDINDING, KINTAMANI, BANGLI, BALI",3,155,1,156
https://kawalpemilu.org#53700,"ABANG BATUDINDING, KINTAMANI, BANGLI, BALI",4,152,2,154
https://kawalpemilu.org#53700,"ABANG BATUDINDING, KINTAMANI, BANGLI, BALI",5,88,0,88
https://kawalpemilu.org#53700,"ABANG BATUDINDING, KINTAMANI, BANGLI, BALI",6,226,6,232
https://kawalpemilu.org#53700,"ABANG BATUDINDING, KINTAMANI, BANGLI, BALI",7,201,14,215
https://kawalpemilu.org#53700,"ABANG BATUDINDING, KINTAMANI, BANGLI, BALI",8,195,16,211
https://kawalpemilu.org#53700,"ABANG BATUDINDING, KINTAMANI, BANGLI, BALI",9,238,7,245
https://kawalpemilu.org#53701,"TERUNYAN, KINTAMANI, BANGLI, BALI",1,189,9,198
https://kawalpemilu.org#53701,"TERUNYAN, KINTAMANI, BANGLI, BALI",2,180,9,189
https://kawalpemilu.org#53701,"TERUNYAN, KINTAMANI, BANGLI, BALI",3,183,12,195
https://kawalpemilu.org#53701,"TERUNYAN, KINTAMANI, BANGLI, BALI",4,181,10,191
https://kawalpemilu.org#53701,"TERUNYAN, KINTAMANI, BANGLI, BALI",5,158,13,171
https://kawalpemilu.org#53701,"TERUNYAN, KINTAMANI, BANGLI, BALI",7,136,2,138
https://kawalpemilu.org#53701,"TERUNYAN, KINTAMANI, BANGLI, BALI",8,150,3,153
https://kawalpemilu.org#53701,"TERUNYAN, KINTAMANI, BANGLI, BALI",9,121,3,124
https://kawalpemilu.org#53701,"TERUNYAN, KINTAMANI, BANGLI, BALI",10,137,7,144
https://kawalpemilu.org#53701,"TERUNYAN, KINTAMANI, BANGLI, BALI",11,117,9,126
https://kawalpemilu.org#53702,"SONGAN A, KINTAMANI, BANGLI, BALI",1,199,24,223
https://kawalpemilu.org#53702,"SONGAN A, KINTAMANI, BANGLI, BALI",3,122,8,130
https://kawalpemilu.org#53702,"SONGAN A, KINTAMANI, BANGLI, BALI",4,215,34,249
https://kawalpemilu.org#53702,"SONGAN A, KINTAMANI, BANGLI, BALI",5,159,20,179
https://kawalpemilu.org#53702,"SONGAN A, KINTAMANI, BANGLI, BALI",6,165,12,177
https://kawalpemilu.org#53702,"SONGAN A, KINTAMANI, BANGLI, BALI",7,207,10,217
https://kawalpemilu.org#53702,"SONGAN A, KINTAMANI, BANGLI, BALI",8,179,19,198
https://kawalpemilu.org#53702,"SONGAN A, KINTAMANI, BANGLI, BALI",9,112,7,119
https://kawalpemilu.org#53702,"SONGAN A, KINTAMANI, BANGLI, BALI",10,253,28,281
https://kawalpemilu.org#53702,"SONGAN A, KINTAMANI, BANGLI, BALI",11,211,20,231
https://kawalpemilu.org#53702,"SONGAN A, KINTAMANI, BANGLI, BALI",12,174,12,186
https://kawalpemilu.org#53702,"SONGAN A, KINTAMANI, BANGLI, BALI",13,226,13,239
https://kawalpemilu.org#53702,"SONGAN A, KINTAMANI, BANGLI, BALI",14,181,18,199
https://kawalpemilu.org#53702,"SONGAN A, KINTAMANI, BANGLI, BALI",15,124,4,128
https://kawalpemilu.org#53702,"SONGAN A, KINTAMANI, BANGLI, BALI",16,158,9,167
https://kawalpemilu.org#53702,"SONGAN A, KINTAMANI, BANGLI, BALI",17,126,4,130
https://kawalpemilu.org#53702,"SONGAN A, KINTAMANI, BANGLI, BALI",18,210,16,226
https://kawalpemilu.org#53702,"SONGAN A, KINTAMANI, BANGLI, BALI",19,209,12,221
https://kawalpemilu.org#53702,"SONGAN A, KINTAMANI, BANGLI, BALI",20,84,6,90
https://kawalpemilu.org#53702,"SONGAN A, KINTAMANI, BANGLI, BALI",21,200,45,245
https://kawalpemilu.org#53702,"SONGAN A, KINTAMANI, BANGLI, BALI",22,170,21,191
https://kawalpemilu.org#53703,"SONGAN B, KINTAMANI, BANGLI, BALI",1,177,34,211
https://kawalpemilu.org#53703,"SONGAN B, KINTAMANI, BANGLI, BALI",2,156,25,181
https://kawalpemilu.org#53703,"SONGAN B, KINTAMANI, BANGLI, BALI",3,159,52,211
https://kawalpemilu.org#53703,"SONGAN B, KINTAMANI, BANGLI, BALI",4,161,55,216
https://kawalpemilu.org#53703,"SONGAN B, KINTAMANI, BANGLI, BALI",5,230,23,253
https://kawalpemilu.org#53703,"SONGAN B, KINTAMANI, BANGLI, BALI",6,138,16,154
https://kawalpemilu.org#53703,"SONGAN B, KINTAMANI, BANGLI, BALI",7,183,8,191
https://kawalpemilu.org#53703,"SONGAN B, KINTAMANI, BANGLI, BALI",8,137,8,145
https://kawalpemilu.org#53703,"SONGAN B, KINTAMANI, BANGLI, BALI",9,151,20,171
https://kawalpemilu.org#53703,"SONGAN B, KINTAMANI, BANGLI, BALI",10,143,22,165
https://kawalpemilu.org#53703,"SONGAN B, KINTAMANI, BANGLI, BALI",11,105,22,127
https://kawalpemilu.org#53703,"SONGAN B, KINTAMANI, BANGLI, BALI",12,123,11,134
https://kawalpemilu.org#53703,"SONGAN B, KINTAMANI, BANGLI, BALI",13,221,28,249
https://kawalpemilu.org#53703,"SONGAN B, KINTAMANI, BANGLI, BALI",14,146,20,166
https://kawalpemilu.org#53703,"SONGAN B, KINTAMANI, BANGLI, BALI",15,136,20,156
https://kawalpemilu.org#53703,"SONGAN B, KINTAMANI, BANGLI, BALI",16,196,5,201
https://kawalpemilu.org#53703,"SONGAN B, KINTAMANI, BANGLI, BALI",17,136,31,167
https://kawalpemilu.org#53703,"SONGAN B, KINTAMANI, BANGLI, BALI",18,235,36,271
https://kawalpemilu.org#53703,"SONGAN B, KINTAMANI, BANGLI, BALI",19,250,21,271
https://kawalpemilu.org#53703,"SONGAN B, KINTAMANI, BANGLI, BALI",20,186,40,226
https://kawalpemilu.org#53703,"SONGAN B, KINTAMANI, BANGLI, BALI",21,177,51,228
https://kawalpemilu.org#53703,"SONGAN B, KINTAMANI, BANGLI, BALI",22,190,13,203
https://kawalpemilu.org#53703,"SONGAN B, KINTAMANI, BANGLI, BALI",23,166,8,174
https://kawalpemilu.org#53703,"SONGAN B, KINTAMANI, BANGLI, BALI",24,225,18,243
https://kawalpemilu.org#53703,"SONGAN B, KINTAMANI, BANGLI, BALI",25,145,11,156
https://kawalpemilu.org#53703,"SONGAN B, KINTAMANI, BANGLI, BALI",26,149,14,163
https://kawalpemilu.org#53703,"SONGAN B, KINTAMANI, BANGLI, BALI",27,139,27,166
https://kawalpemilu.org#53703,"SONGAN B, KINTAMANI, BANGLI, BALI",28,111,17,128
https://kawalpemilu.org#53703,"SONGAN B, KINTAMANI, BANGLI, BALI",29,173,13,186
https://kawalpemilu.org#53703,"SONGAN B, KINTAMANI, BANGLI, BALI",30,166,8,174
https://kawalpemilu.org#53703,"SONGAN B, KINTAMANI, BANGLI, BALI",31,204,8,212
https://kawalpemilu.org#53704,"BATUR SELATAN, KINTAMANI, BANGLI, BALI",1,129,11,140
https://kawalpemilu.org#53704,"BATUR SELATAN, KINTAMANI, BANGLI, BALI",2,121,15,136
https://kawalpemilu.org#53704,"BATUR SELATAN, KINTAMANI, BANGLI, BALI",3,179,16,195
https://kawalpemilu.org#53704,"BATUR SELATAN, KINTAMANI, BANGLI, BALI",4,169,17,186
https://kawalpemilu.org#53704,"BATUR SELATAN, KINTAMANI, BANGLI, BALI",5,175,19,194
https://kawalpemilu.org#53704,"BATUR SELATAN, KINTAMANI, BANGLI, BALI",6,138,11,149
https://kawalpemilu.org#53704,"BATUR SELATAN, KINTAMANI, BANGLI, BALI",7,140,11,151
https://kawalpemilu.org#53704,"BATUR SELATAN, KINTAMANI, BANGLI, BALI",8,148,15,163
https://kawalpemilu.org#53704,"BATUR SELATAN, KINTAMANI, BANGLI, BALI",9,135,18,153
https://kawalpemilu.org#53704,"BATUR SELATAN, KINTAMANI, BANGLI, BALI",10,209,13,222
https://kawalpemilu.org#53704,"BATUR SELATAN, KINTAMANI, BANGLI, BALI",11,131,16,147
https://kawalpemilu.org#53704,"BATUR SELATAN, KINTAMANI, BANGLI, BALI",12,129,11,140
https://kawalpemilu.org#53704,"BATUR SELATAN, KINTAMANI, BANGLI, BALI",13,166,11,177
https://kawalpemilu.org#53704,"BATUR SELATAN, KINTAMANI, BANGLI, BALI",14,162,10,172
https://kawalpemilu.org#53704,"BATUR SELATAN, KINTAMANI, BANGLI, BALI",15,198,13,211
https://kawalpemilu.org#53704,"BATUR SELATAN, KINTAMANI, BANGLI, BALI",16,197,18,215
https://kawalpemilu.org#53704,"BATUR SELATAN, KINTAMANI, BANGLI, BALI",17,117,13,130
https://kawalpemilu.org#53704,"BATUR SELATAN, KINTAMANI, BANGLI, BALI",18,115,20,135
https://kawalpemilu.org#53704,"BATUR SELATAN, KINTAMANI, BANGLI, BALI",19,169,16,185
https://kawalpemilu.org#53704,"BATUR SELATAN, KINTAMANI, BANGLI, BALI",20,156,16,172
https://kawalpemilu.org#53704,"BATUR SELATAN, KINTAMANI, BANGLI, BALI",21,126,19,145
https://kawalpemilu.org#53704,"BATUR SELATAN, KINTAMANI, BANGLI, BALI",22,125,27,152
https://kawalpemilu.org#53704,"BATUR SELATAN, KINTAMANI, BANGLI, BALI",23,137,31,168
https://kawalpemilu.org#53704,"BATUR SELATAN, KINTAMANI, BANGLI, BALI",24,167,16,183
https://kawalpemilu.org#53705,"BATUR TENGAH, KINTAMANI, BANGLI, BALI",1,178,13,191
https://kawalpemilu.org#53705,"BATUR TENGAH, KINTAMANI, BANGLI, BALI",2,180,18,198
https://kawalpemilu.org#53705,"BATUR TENGAH, KINTAMANI, BANGLI, BALI",3,168,26,194
https://kawalpemilu.org#53705,"BATUR TENGAH, KINTAMANI, BANGLI, BALI",4,134,13,147
https://kawalpemilu.org#53705,"BATUR TENGAH, KINTAMANI, BANGLI, BALI",5,131,14,145
https://kawalpemilu.org#53705,"BATUR TENGAH, KINTAMANI, BANGLI, BALI",6,191,23,214
https://kawalpemilu.org#53705,"BATUR TENGAH, KINTAMANI, BANGLI, BALI",7,121,10,131
https://kawalpemilu.org#53705,"BATUR TENGAH, KINTAMANI, BANGLI, BALI",8,132,6,138
https://kawalpemilu.org#53705,"BATUR TENGAH, KINTAMANI, BANGLI, BALI",9,136,7,143
https://kawalpemilu.org#53705,"BATUR TENGAH, KINTAMANI, BANGLI, BALI",10,133,5,138
https://kawalpemilu.org#53705,"BATUR TENGAH, KINTAMANI, BANGLI, BALI",11,125,10,135
https://kawalpemilu.org#53705,"BATUR TENGAH, KINTAMANI, BANGLI, BALI",12,117,11,128
https://kawalpemilu.org#53705,"BATUR TENGAH, KINTAMANI, BANGLI, BALI",13,155,5,160
https://kawalpemilu.org#53706,"BATUR UTARA, KINTAMANI, BANGLI, BALI",1,172,15,187
https://kawalpemilu.org#53706,"BATUR UTARA, KINTAMANI, BANGLI, BALI",2,160,15,175
https://kawalpemilu.org#53706,"BATUR UTARA, KINTAMANI, BANGLI, BALI",3,197,7,204
https://kawalpemilu.org#53706,"BATUR UTARA, KINTAMANI, BANGLI, BALI",4,162,19,181
https://kawalpemilu.org#53706,"BATUR UTARA, KINTAMANI, BANGLI, BALI",5,145,15,160
https://kawalpemilu.org#53706,"BATUR UTARA, KINTAMANI, BANGLI, BALI",6,187,12,199
https://kawalpemilu.org#53707,"KINTAMANI, KINTAMANI, BANGLI, BALI",1,161,8,169
https://kawalpemilu.org#53707,"KINTAMANI, KINTAMANI, BANGLI, BALI",3,164,15,179
https://kawalpemilu.org#53707,"KINTAMANI, KINTAMANI, BANGLI, BALI",4,202,7,209
https://kawalpemilu.org#53707,"KINTAMANI, KINTAMANI, BANGLI, BALI",5,182,3,185
https://kawalpemilu.org#53707,"KINTAMANI, KINTAMANI, BANGLI, BALI",6,186,3,189
https://kawalpemilu.org#53707,"KINTAMANI, KINTAMANI, BANGLI, BALI",7,202,3,205
https://kawalpemilu.org#53707,"KINTAMANI, KINTAMANI, BANGLI, BALI",8,210,7,217
https://kawalpemilu.org#53707,"KINTAMANI, KINTAMANI, BANGLI, BALI",9,184,2,186
https://kawalpemilu.org#53707,"KINTAMANI, KINTAMANI, BANGLI, BALI",10,172,1,173
https://kawalpemilu.org#53707,"KINTAMANI, KINTAMANI, BANGLI, BALI",11,169,6,175
https://kawalpemilu.org#53707,"KINTAMANI, KINTAMANI, BANGLI, BALI",12,162,7,169
https://kawalpemilu.org#53707,"KINTAMANI, KINTAMANI, BANGLI, BALI",13,144,5,149
https://kawalpemilu.org#53707,"KINTAMANI, KINTAMANI, BANGLI, BALI",14,166,11,177
https://kawalpemilu.org#53707,"KINTAMANI, KINTAMANI, BANGLI, BALI",15,181,1,182
https://kawalpemilu.org#53707,"KINTAMANI, KINTAMANI, BANGLI, BALI",16,150,7,157
https://kawalpemilu.org#53707,"KINTAMANI, KINTAMANI, BANGLI, BALI",17,152,5,157
https://kawalpemilu.org#53707,"KINTAMANI, KINTAMANI, BANGLI, BALI",18,152,56,208
https://kawalpemilu.org#53707,"KINTAMANI, KINTAMANI, BANGLI, BALI",19,145,62,207
https://kawalpemilu.org#53707,"KINTAMANI, KINTAMANI, BANGLI, BALI",20,191,8,199
https://kawalpemilu.org#53707,"KINTAMANI, KINTAMANI, BANGLI, BALI",21,201,3,204
https://kawalpemilu.org#53707,"KINTAMANI, KINTAMANI, BANGLI, BALI",22,168,6,174
https://kawalpemilu.org#53707,"KINTAMANI, KINTAMANI, BANGLI, BALI",23,162,9,171
https://kawalpemilu.org#53708,"SERAI, KINTAMANI, BANGLI, BALI",1,168,3,171
https://kawalpemilu.org#53708,"SERAI, KINTAMANI, BANGLI, BALI",2,170,5,175
https://kawalpemilu.org#53708,"SERAI, KINTAMANI, BANGLI, BALI",3,154,8,162
https://kawalpemilu.org#53708,"SERAI, KINTAMANI, BANGLI, BALI",4,174,12,186
https://kawalpemilu.org#53709,"DAUP, KINTAMANI, BANGLI, BALI",1,238,5,243
https://kawalpemilu.org#53709,"DAUP, KINTAMANI, BANGLI, BALI",2,242,7,249
https://kawalpemilu.org#53710,"AWAN, KINTAMANI, BANGLI, BALI",1,156,1,157
https://kawalpemilu.org#53710,"AWAN, KINTAMANI, BANGLI, BALI",2,171,0,171
https://kawalpemilu.org#53710,"AWAN, KINTAMANI, BANGLI, BALI",3,275,2,277
https://kawalpemilu.org#53710,"AWAN, KINTAMANI, BANGLI, BALI",4,263,4,267
https://kawalpemilu.org#53711,"GUNUNGBAU, KINTAMANI, BANGLI, BALI",1,217,8,225
https://kawalpemilu.org#53711,"GUNUNGBAU, KINTAMANI, BANGLI, BALI",2,227,3,230
https://kawalpemilu.org#53712,"BELANGA, KINTAMANI, BANGLI, BALI",1,201,1,202
https://kawalpemilu.org#53712,"BELANGA, KINTAMANI, BANGLI, BALI",2,183,2,185
https://kawalpemilu.org#53713,"BATUKAANG, KINTAMANI, BANGLI, BALI",1,199,23,222
https://kawalpemilu.org#53713,"BATUKAANG, KINTAMANI, BANGLI, BALI",2,199,23,222
https://kawalpemilu.org#53714,"BELANTIH, KINTAMANI, BANGLI, BALI",1,211,15,226
https://kawalpemilu.org#53714,"BELANTIH, KINTAMANI, BANGLI, BALI",2,204,12,216
https://kawalpemilu.org#53714,"BELANTIH, KINTAMANI, BANGLI, BALI",3,176,7,183
https://kawalpemilu.org#53714,"BELANTIH, KINTAMANI, BANGLI, BALI",4,230,6,236
https://kawalpemilu.org#53714,"BELANTIH, KINTAMANI, BANGLI, BALI",5,124,12,136
https://kawalpemilu.org#53714,"BELANTIH, KINTAMANI, BANGLI, BALI",6,142,11,153
https://kawalpemilu.org#53714,"BELANTIH, KINTAMANI, BANGLI, BALI",7,231,6,237
https://kawalpemilu.org#53714,"BELANTIH, KINTAMANI, BANGLI, BALI",8,201,18,219
https://kawalpemilu.org#53714,"BELANTIH, KINTAMANI, BANGLI, BALI",9,191,10,201
https://kawalpemilu.org#53715,"CATUR, KINTAMANI, BANGLI, BALI",1,176,4,180
https://kawalpemilu.org#53715,"CATUR, KINTAMANI, BANGLI, BALI",2,169,3,172
https://kawalpemilu.org#53715,"CATUR, KINTAMANI, BANGLI, BALI",3,156,8,164
https://kawalpemilu.org#53715,"CATUR, KINTAMANI, BANGLI, BALI",4,170,9,179
https://kawalpemilu.org#53715,"CATUR, KINTAMANI, BANGLI, BALI",5,183,8,191
https://kawalpemilu.org#53715,"CATUR, KINTAMANI, BANGLI, BALI",6,226,3,229
https://kawalpemilu.org#53715,"CATUR, KINTAMANI, BANGLI, BALI",7,192,4,196
https://kawalpemilu.org#53716,"PENGEJARAN, KINTAMANI, BANGLI, BALI",1,149,20,169
https://kawalpemilu.org#53716,"PENGEJARAN, KINTAMANI, BANGLI, BALI",2,101,18,119
https://kawalpemilu.org#53716,"PENGEJARAN, KINTAMANI, BANGLI, BALI",3,200,8,208
https://kawalpemilu.org#53717,"SELULUNG, KINTAMANI, BANGLI, BALI",1,139,19,158
https://kawalpemilu.org#53717,"SELULUNG, KINTAMANI, BANGLI, BALI",2,188,16,204
https://kawalpemilu.org#53717,"SELULUNG, KINTAMANI, BANGLI, BALI",3,190,4,194
https://kawalpemilu.org#53717,"SELULUNG, KINTAMANI, BANGLI, BALI",4,143,4,147
https://kawalpemilu.org#53717,"SELULUNG, KINTAMANI, BANGLI, BALI",5,145,1,146
https://kawalpemilu.org#53717,"SELULUNG, KINTAMANI, BANGLI, BALI",6,185,13,198
https://kawalpemilu.org#53717,"SELULUNG, KINTAMANI, BANGLI, BALI",7,182,6,188
https://kawalpemilu.org#53717,"SELULUNG, KINTAMANI, BANGLI, BALI",8,125,9,134
https://kawalpemilu.org#53717,"SELULUNG, KINTAMANI, BANGLI, BALI",9,195,0,195
https://kawalpemilu.org#53718,"SATRA, KINTAMANI, BANGLI, BALI",1,146,6,152
https://kawalpemilu.org#53718,"SATRA, KINTAMANI, BANGLI, BALI",2,132,3,135
https://kawalpemilu.org#53718,"SATRA, KINTAMANI, BANGLI, BALI",3,164,4,168
https://kawalpemilu.org#53718,"SATRA, KINTAMANI, BANGLI, BALI",4,160,4,164
https://kawalpemilu.org#53718,"SATRA, KINTAMANI, BANGLI, BALI",5,129,1,130
https://kawalpemilu.org#53718,"SATRA, KINTAMANI, BANGLI, BALI",6,129,2,131
https://kawalpemilu.org#53718,"SATRA, KINTAMANI, BANGLI, BALI",7,123,7,130
https://kawalpemilu.org#53718,"SATRA, KINTAMANI, BANGLI, BALI",8,122,17,139
https://kawalpemilu.org#53718,"SATRA, KINTAMANI, BANGLI, BALI",9,182,5,187
https://kawalpemilu.org#53718,"SATRA, KINTAMANI, BANGLI, BALI",10,192,2,194
https://kawalpemilu.org#53718,"SATRA, KINTAMANI, BANGLI, BALI",11,169,5,174
https://kawalpemilu.org#53718,"SATRA, KINTAMANI, BANGLI, BALI",12,165,1,166
https://kawalpemilu.org#53718,"SATRA, KINTAMANI, BANGLI, BALI",13,157,4,161
https://kawalpemilu.org#53718,"SATRA, KINTAMANI, BANGLI, BALI",14,201,5,206
https://kawalpemilu.org#53718,"SATRA, KINTAMANI, BANGLI, BALI",16,228,4,232
https://kawalpemilu.org#53719,"DAUSA, KINTAMANI, BANGLI, BALI",1,161,1,162
https://kawalpemilu.org#53719,"DAUSA, KINTAMANI, BANGLI, BALI",2,179,1,180
https://kawalpemilu.org#53719,"DAUSA, KINTAMANI, BANGLI, BALI",3,119,6,125
https://kawalpemilu.org#53719,"DAUSA, KINTAMANI, BANGLI, BALI",4,142,2,144
https://kawalpemilu.org#53719,"DAUSA, KINTAMANI, BANGLI, BALI",5,152,0,152
https://kawalpemilu.org#53719,"DAUSA, KINTAMANI, BANGLI, BALI",6,194,6,200
https://kawalpemilu.org#53719,"DAUSA, KINTAMANI, BANGLI, BALI",7,220,3,223
https://kawalpemilu.org#53719,"DAUSA, KINTAMANI, BANGLI, BALI",8,207,7,214
https://kawalpemilu.org#53719,"DAUSA, KINTAMANI, BANGLI, BALI",9,149,0,149
https://kawalpemilu.org#53719,"DAUSA, KINTAMANI, BANGLI, BALI",10,72,4,76
https://kawalpemilu.org#53720,"BANTANG, KINTAMANI, BANGLI, BALI",1,197,6,203
https://kawalpemilu.org#53720,"BANTANG, KINTAMANI, BANGLI, BALI",2,184,6,190
https://kawalpemilu.org#53720,"BANTANG, KINTAMANI, BANGLI, BALI",3,179,5,184
https://kawalpemilu.org#53720,"BANTANG, KINTAMANI, BANGLI, BALI",4,171,3,174
https://kawalpemilu.org#53720,"BANTANG, KINTAMANI, BANGLI, BALI",5,152,10,162
https://kawalpemilu.org#53721,"SUKAWANA, KINTAMANI, BANGLI, BALI",1,184,4,188
https://kawalpemilu.org#53721,"SUKAWANA, KINTAMANI, BANGLI, BALI",2,164,8,172
https://kawalpemilu.org#53721,"SUKAWANA, KINTAMANI, BANGLI, BALI",3,159,4,163
https://kawalpemilu.org#53721,"SUKAWANA, KINTAMANI, BANGLI, BALI",4,248,5,253
https://kawalpemilu.org#53721,"SUKAWANA, KINTAMANI, BANGLI, BALI",5,215,3,218
https://kawalpemilu.org#53721,"SUKAWANA, KINTAMANI, BANGLI, BALI",6,229,8,237
https://kawalpemilu.org#53721,"SUKAWANA, KINTAMANI, BANGLI, BALI",7,144,21,165
https://kawalpemilu.org#53721,"SUKAWANA, KINTAMANI, BANGLI, BALI",8,106,7,113
https://kawalpemilu.org#53721,"SUKAWANA, KINTAMANI, BANGLI, BALI",9,139,6,145
https://kawalpemilu.org#53721,"SUKAWANA, KINTAMANI, BANGLI, BALI",10,152,7,159
https://kawalpemilu.org#53721,"SUKAWANA, KINTAMANI, BANGLI, BALI",11,133,3,136
https://kawalpemilu.org#53721,"SUKAWANA, KINTAMANI, BANGLI, BALI",12,206,1,207
https://kawalpemilu.org#53721,"SUKAWANA, KINTAMANI, BANGLI, BALI",13,135,6,141
https://kawalpemilu.org#53721,"SUKAWANA, KINTAMANI, BANGLI, BALI",14,177,7,184
https://kawalpemilu.org#53721,"SUKAWANA, KINTAMANI, BANGLI, BALI",15,132,9,141
https://kawalpemilu.org#53721,"SUKAWANA, KINTAMANI, BANGLI, BALI",16,148,6,154
https://kawalpemilu.org#53721,"SUKAWANA, KINTAMANI, BANGLI, BALI",17,120,8,128
https://kawalpemilu.org#53721,"SUKAWANA, KINTAMANI, BANGLI, BALI",18,235,6,241
https://kawalpemilu.org#53721,"SUKAWANA, KINTAMANI, BANGLI, BALI",19,176,7,183
https://kawalpemilu.org#53721,"SUKAWANA, KINTAMANI, BANGLI, BALI",20,197,10,207
https://kawalpemilu.org#53722,"KUTUH, KINTAMANI, BANGLI, BALI",1,176,7,183
https://kawalpemilu.org#53722,"KUTUH, KINTAMANI, BANGLI, BALI",2,189,15,204
https://kawalpemilu.org#53722,"KUTUH, KINTAMANI, BANGLI, BALI",4,194,11,205
https://kawalpemilu.org#53723,"SUBAYA, KINTAMANI, BANGLI, BALI",1,177,15,192
https://kawalpemilu.org#53723,"SUBAYA, KINTAMANI, BANGLI, BALI",2,159,14,173
https://kawalpemilu.org#53723,"SUBAYA, KINTAMANI, BANGLI, BALI",3,136,11,147
https://kawalpemilu.org#53723,"SUBAYA, KINTAMANI, BANGLI, BALI",4,145,13,158
https://kawalpemilu.org#53724,"SIAKIN, KINTAMANI, BANGLI, BALI",1,226,7,233
https://kawalpemilu.org#53724,"SIAKIN, KINTAMANI, BANGLI, BALI",2,209,15,224
https://kawalpemilu.org#53724,"SIAKIN, KINTAMANI, BANGLI, BALI",3,174,16,190
https://kawalpemilu.org#53724,"SIAKIN, KINTAMANI, BANGLI, BALI",4,205,12,217
https://kawalpemilu.org#53724,"SIAKIN, KINTAMANI, BANGLI, BALI",5,133,12,145
https://kawalpemilu.org#53724,"SIAKIN, KINTAMANI, BANGLI, BALI",6,141,10,151
https://kawalpemilu.org#53725,"PINGGAN, KINTAMANI, BANGLI, BALI",1,256,5,261
https://kawalpemilu.org#53725,"PINGGAN, KINTAMANI, BANGLI, BALI",2,252,8,260
https://kawalpemilu.org#53725,"PINGGAN, KINTAMANI, BANGLI, BALI",3,223,6,229
https://kawalpemilu.org#53725,"PINGGAN, KINTAMANI, BANGLI, BALI",4,234,10,244
https://kawalpemilu.org#53725,"PINGGAN, KINTAMANI, BANGLI, BALI",5,174,6,110
https://kawalpemilu.org#53725,"PINGGAN, KINTAMANI, BANGLI, BALI",6,94,2,96
https://kawalpemilu.org#53726,"BELANDINGAN, KINTAMANI, BANGLI, BALI",1,144,8,152
https://kawalpemilu.org#53726,"BELANDINGAN, KINTAMANI, BANGLI, BALI",2,227,17,244
https://kawalpemilu.org#53729,"NONGAN, RENDANG, KARANGASEM, BALI",1,197,7,204
https://kawalpemilu.org#53729,"NONGAN, RENDANG, KARANGASEM, BALI",2,173,14,187
https://kawalpemilu.org#53729,"NONGAN, RENDANG, KARANGASEM, BALI",3,179,6,185
https://kawalpemilu.org#53729,"NONGAN, RENDANG, KARANGASEM, BALI",4,230,6,236
https://kawalpemilu.org#53729,"NONGAN, RENDANG, KARANGASEM, BALI",5,190,3,193
https://kawalpemilu.org#53729,"NONGAN, RENDANG, KARANGASEM, BALI",6,203,6,209
https://kawalpemilu.org#53729,"NONGAN, RENDANG, KARANGASEM, BALI",7,193,12,205
https://kawalpemilu.org#53729,"NONGAN, RENDANG, KARANGASEM, BALI",8,192,6,198
https://kawalpemilu.org#53729,"NONGAN, RENDANG, KARANGASEM, BALI",9,142,4,146
https://kawalpemilu.org#53729,"NONGAN, RENDANG, KARANGASEM, BALI",10,123,3,126
https://kawalpemilu.org#53729,"NONGAN, RENDANG, KARANGASEM, BALI",11,221,9,230
https://kawalpemilu.org#53729,"NONGAN, RENDANG, KARANGASEM, BALI",12,245,5,250
https://kawalpemilu.org#53729,"NONGAN, RENDANG, KARANGASEM, BALI",13,204,6,210
https://kawalpemilu.org#53729,"NONGAN, RENDANG, KARANGASEM, BALI",14,114,6,120
https://kawalpemilu.org#53729,"NONGAN, RENDANG, KARANGASEM, BALI",15,110,7,117
https://kawalpemilu.org#53729,"NONGAN, RENDANG, KARANGASEM, BALI",16,223,2,225
https://kawalpemilu.org#53729,"NONGAN, RENDANG, KARANGASEM, BALI",17,141,8,149
https://kawalpemilu.org#53729,"NONGAN, RENDANG, KARANGASEM, BALI",18,140,4,144
https://kawalpemilu.org#53729,"NONGAN, RENDANG, KARANGASEM, BALI",19,104,10,114
https://kawalpemilu.org#53729,"NONGAN, RENDANG, KARANGASEM, BALI",20,114,5,119
https://kawalpemilu.org#53729,"NONGAN, RENDANG, KARANGASEM, BALI",21,124,2,126
https://kawalpemilu.org#53729,"NONGAN, RENDANG, KARANGASEM, BALI",22,214,11,225
https://kawalpemilu.org#53730,"RENDANG, RENDANG, KARANGASEM, BALI",1,171,17,188
https://kawalpemilu.org#53730,"RENDANG, RENDANG, KARANGASEM, BALI",2,193,12,205
https://kawalpemilu.org#53730,"RENDANG, RENDANG, KARANGASEM, BALI",3,222,7,229
https://kawalpemilu.org#53730,"RENDANG, RENDANG, KARANGASEM, BALI",4,212,2,214
https://kawalpemilu.org#53730,"RENDANG, RENDANG, KARANGASEM, BALI",5,197,4,201
https://kawalpemilu.org#53730,"RENDANG, RENDANG, KARANGASEM, BALI",6,186,6,192
https://kawalpemilu.org#53730,"RENDANG, RENDANG, KARANGASEM, BALI",7,184,4,188
https://kawalpemilu.org#53730,"RENDANG, RENDANG, KARANGASEM, BALI",8,199,13,212
https://kawalpemilu.org#53730,"RENDANG, RENDANG, KARANGASEM, BALI",9,202,4,206
https://kawalpemilu.org#53730,"RENDANG, RENDANG, KARANGASEM, BALI",10,161,3,164
https://kawalpemilu.org#53730,"RENDANG, RENDANG, KARANGASEM, BALI",11,147,2,149
https://kawalpemilu.org#53730,"RENDANG, RENDANG, KARANGASEM, BALI",12,130,5,135
https://kawalpemilu.org#53730,"RENDANG, RENDANG, KARANGASEM, BALI",13,240,1,241
https://kawalpemilu.org#53730,"RENDANG, RENDANG, KARANGASEM, BALI",14,110,0,110
https://kawalpemilu.org#53730,"RENDANG, RENDANG, KARANGASEM, BALI",15,226,5,231
https://kawalpemilu.org#53730,"RENDANG, RENDANG, KARANGASEM, BALI",16,199,3,202
https://kawalpemilu.org#53730,"RENDANG, RENDANG, KARANGASEM, BALI",17,175,1,176
https://kawalpemilu.org#53730,"RENDANG, RENDANG, KARANGASEM, BALI",18,183,3,186
https://kawalpemilu.org#53730,"RENDANG, RENDANG, KARANGASEM, BALI",19,166,3,169
https://kawalpemilu.org#53730,"RENDANG, RENDANG, KARANGASEM, BALI",20,118,10,128
https://kawalpemilu.org#53730,"RENDANG, RENDANG, KARANGASEM, BALI",21,131,3,134
https://kawalpemilu.org#53730,"RENDANG, RENDANG, KARANGASEM, BALI",22,193,14,207
https://kawalpemilu.org#53730,"RENDANG, RENDANG, KARANGASEM, BALI",23,200,10,210
https://kawalpemilu.org#53730,"RENDANG, RENDANG, KARANGASEM, BALI",24,186,3,189
https://kawalpemilu.org#53730,"RENDANG, RENDANG, KARANGASEM, BALI",25,215,1,216
https://kawalpemilu.org#53731,"MENANGA, RENDANG, KARANGASEM, BALI",1,241,3,244
https://kawalpemilu.org#53731,"MENANGA, RENDANG, KARANGASEM, BALI",2,216,5,221
https://kawalpemilu.org#53731,"MENANGA, RENDANG, KARANGASEM, BALI",3,206,3,209
https://kawalpemilu.org#53731,"MENANGA, RENDANG, KARANGASEM, BALI",4,217,2,219
https://kawalpemilu.org#53731,"MENANGA, RENDANG, KARANGASEM, BALI",5,173,0,173
https://kawalpemilu.org#53731,"MENANGA, RENDANG, KARANGASEM, BALI",6,178,4,182
https://kawalpemilu.org#53731,"MENANGA, RENDANG, KARANGASEM, BALI",7,171,2,173
https://kawalpemilu.org#53731,"MENANGA, RENDANG, KARANGASEM, BALI",8,143,10,153
https://kawalpemilu.org#53731,"MENANGA, RENDANG, KARANGASEM, BALI",9,160,9,169
https://kawalpemilu.org#53731,"MENANGA, RENDANG, KARANGASEM, BALI",10,198,1,199
https://kawalpemilu.org#53731,"MENANGA, RENDANG, KARANGASEM, BALI",11,183,12,195
https://kawalpemilu.org#53731,"MENANGA, RENDANG, KARANGASEM, BALI",12,196,5,201
https://kawalpemilu.org#53731,"MENANGA, RENDANG, KARANGASEM, BALI",14,199,3,202
https://kawalpemilu.org#53731,"MENANGA, RENDANG, KARANGASEM, BALI",15,211,5,216
https://kawalpemilu.org#53731,"MENANGA, RENDANG, KARANGASEM, BALI",16,190,9,199
https://kawalpemilu.org#53731,"MENANGA, RENDANG, KARANGASEM, BALI",17,182,10,192
https://kawalpemilu.org#53731,"MENANGA, RENDANG, KARANGASEM, BALI",18,202,5,207
https://kawalpemilu.org#53731,"MENANGA, RENDANG, KARANGASEM, BALI",19,165,6,171
https://kawalpemilu.org#53731,"MENANGA, RENDANG, KARANGASEM, BALI",20,170,14,184
https://kawalpemilu.org#53731,"MENANGA, RENDANG, KARANGASEM, BALI",21,164,5,169
https://kawalpemilu.org#53731,"MENANGA, RENDANG, KARANGASEM, BALI",22,230,1,231
https://kawalpemilu.org#53732,"BESAKIH, RENDANG, KARANGASEM, BALI",1,162,6,168
https://kawalpemilu.org#53732,"BESAKIH, RENDANG, KARANGASEM, BALI",2,176,12,188
https://kawalpemilu.org#53732,"BESAKIH, RENDANG, KARANGASEM, BALI",3,166,5,171
https://kawalpemilu.org#53732,"BESAKIH, RENDANG, KARANGASEM, BALI",4,173,10,183
https://kawalpemilu.org#53732,"BESAKIH, RENDANG, KARANGASEM, BALI",5,203,7,210
https://kawalpemilu.org#53732,"BESAKIH, RENDANG, KARANGASEM, BALI",6,194,14,208
https://kawalpemilu.org#53732,"BESAKIH, RENDANG, KARANGASEM, BALI",7,172,3,175
https://kawalpemilu.org#53732,"BESAKIH, RENDANG, KARANGASEM, BALI",8,160,9,169
https://kawalpemilu.org#53732,"BESAKIH, RENDANG, KARANGASEM, BALI",9,156,10,166
https://kawalpemilu.org#53732,"BESAKIH, RENDANG, KARANGASEM, BALI",10,263,20,283
https://kawalpemilu.org#53732,"BESAKIH, RENDANG, KARANGASEM, BALI",11,234,6,240
https://kawalpemilu.org#53732,"BESAKIH, RENDANG, KARANGASEM, BALI",12,230,8,238
https://kawalpemilu.org#53732,"BESAKIH, RENDANG, KARANGASEM, BALI",13,152,6,158
https://kawalpemilu.org#53732,"BESAKIH, RENDANG, KARANGASEM, BALI",14,138,5,143
https://kawalpemilu.org#53732,"BESAKIH, RENDANG, KARANGASEM, BALI",15,156,8,164
https://kawalpemilu.org#53732,"BESAKIH, RENDANG, KARANGASEM, BALI",16,160,7,167
https://kawalpemilu.org#53732,"BESAKIH, RENDANG, KARANGASEM, BALI",17,219,3,222
https://kawalpemilu.org#53732,"BESAKIH, RENDANG, KARANGASEM, BALI",18,205,0,205
https://kawalpemilu.org#53732,"BESAKIH, RENDANG, KARANGASEM, BALI",19,163,30,193
https://kawalpemilu.org#53732,"BESAKIH, RENDANG, KARANGASEM, BALI",20,178,25,203
https://kawalpemilu.org#53732,"BESAKIH, RENDANG, KARANGASEM, BALI",21,216,2,218
https://kawalpemilu.org#53732,"BESAKIH, RENDANG, KARANGASEM, BALI",22,174,1,175
https://kawalpemilu.org#53732,"BESAKIH, RENDANG, KARANGASEM, BALI",23,230,5,235
https://kawalpemilu.org#53732,"BESAKIH, RENDANG, KARANGASEM, BALI",24,188,1,189
https://kawalpemilu.org#53732,"BESAKIH, RENDANG, KARANGASEM, BALI",25,191,0,191
https://kawalpemilu.org#53733,"PEMPATAN, RENDANG, KARANGASEM, BALI",1,269,3,272
https://kawalpemilu.org#53733,"PEMPATAN, RENDANG, KARANGASEM, BALI",2,267,5,272
https://kawalpemilu.org#53733,"PEMPATAN, RENDANG, KARANGASEM, BALI",3,252,3,255
https://kawalpemilu.org#53733,"PEMPATAN, RENDANG, KARANGASEM, BALI",4,202,11,213
https://kawalpemilu.org#53733,"PEMPATAN, RENDANG, KARANGASEM, BALI",5,212,11,223
https://kawalpemilu.org#53733,"PEMPATAN, RENDANG, KARANGASEM, BALI",6,173,3,176
https://kawalpemilu.org#53733,"PEMPATAN, RENDANG, KARANGASEM, BALI",7,176,3,179
https://kawalpemilu.org#53733,"PEMPATAN, RENDANG, KARANGASEM, BALI",8,179,5,184
https://kawalpemilu.org#53733,"PEMPATAN, RENDANG, KARANGASEM, BALI",9,144,5,149
https://kawalpemilu.org#53733,"PEMPATAN, RENDANG, KARANGASEM, BALI",10,207,8,215
https://kawalpemilu.org#53733,"PEMPATAN, RENDANG, KARANGASEM, BALI",11,189,12,201
https://kawalpemilu.org#53733,"PEMPATAN, RENDANG, KARANGASEM, BALI",12,180,9,189
https://kawalpemilu.org#53733,"PEMPATAN, RENDANG, KARANGASEM, BALI",13,200,4,204
https://kawalpemilu.org#53733,"PEMPATAN, RENDANG, KARANGASEM, BALI",14,188,18,206
https://kawalpemilu.org#53733,"PEMPATAN, RENDANG, KARANGASEM, BALI",15,180,6,186
https://kawalpemilu.org#53733,"PEMPATAN, RENDANG, KARANGASEM, BALI",16,196,26,222
https://kawalpemilu.org#53733,"PEMPATAN, RENDANG, KARANGASEM, BALI",17,170,25,195
https://kawalpemilu.org#53733,"PEMPATAN, RENDANG, KARANGASEM, BALI",18,154,26,180
https://kawalpemilu.org#53733,"PEMPATAN, RENDANG, KARANGASEM, BALI",19,180,17,200
https://kawalpemilu.org#53733,"PEMPATAN, RENDANG, KARANGASEM, BALI",20,139,13,152
https://kawalpemilu.org#53733,"PEMPATAN, RENDANG, KARANGASEM, BALI",21,180,9,189
https://kawalpemilu.org#53733,"PEMPATAN, RENDANG, KARANGASEM, BALI",22,191,6,197
https://kawalpemilu.org#53733,"PEMPATAN, RENDANG, KARANGASEM, BALI",23,238,22,260
https://kawalpemilu.org#53733,"PEMPATAN, RENDANG, KARANGASEM, BALI",24,219,38,257
https://kawalpemilu.org#53733,"PEMPATAN, RENDANG, KARANGASEM, BALI",25,215,24,239
https://kawalpemilu.org#53733,"PEMPATAN, RENDANG, KARANGASEM, BALI",27,172,24,196
https://kawalpemilu.org#53733,"PEMPATAN, RENDANG, KARANGASEM, BALI",28,225,14,239
https://kawalpemilu.org#53733,"PEMPATAN, RENDANG, KARANGASEM, BALI",29,231,14,245
https://kawalpemilu.org#53733,"PEMPATAN, RENDANG, KARANGASEM, BALI",30,231,9,240
https://kawalpemilu.org#53733,"PEMPATAN, RENDANG, KARANGASEM, BALI",31,232,8,240
https://kawalpemilu.org#53733,"PEMPATAN, RENDANG, KARANGASEM, BALI",32,164,9,173
https://kawalpemilu.org#53734,"PESABAN, RENDANG, KARANGASEM, BALI",1,175,3,178
https://kawalpemilu.org#53734,"PESABAN, RENDANG, KARANGASEM, BALI",2,162,1,163
https://kawalpemilu.org#53734,"PESABAN, RENDANG, KARANGASEM, BALI",3,140,5,145
https://kawalpemilu.org#53734,"PESABAN, RENDANG, KARANGASEM, BALI",4,148,5,153
https://kawalpemilu.org#53734,"PESABAN, RENDANG, KARANGASEM, BALI",5,183,4,187
https://kawalpemilu.org#53734,"PESABAN, RENDANG, KARANGASEM, BALI",6,172,4,176
https://kawalpemilu.org#53734,"PESABAN, RENDANG, KARANGASEM, BALI",7,188,5,193
https://kawalpemilu.org#53734,"PESABAN, RENDANG, KARANGASEM, BALI",8,187,2,189
https://kawalpemilu.org#53734,"PESABAN, RENDANG, KARANGASEM, BALI",9,163,7,170
https://kawalpemilu.org#53736,"TANGKUP, SIDEMEN, KARANGASEM, BALI",1,234,1,235
https://kawalpemilu.org#53736,"TANGKUP, SIDEMEN, KARANGASEM, BALI",2,217,5,222
https://kawalpemilu.org#53736,"TANGKUP, SIDEMEN, KARANGASEM, BALI",3,205,8,213
https://kawalpemilu.org#53736,"TANGKUP, SIDEMEN, KARANGASEM, BALI",4,226,1,227
https://kawalpemilu.org#53736,"TANGKUP, SIDEMEN, KARANGASEM, BALI",5,201,1,202
https://kawalpemilu.org#53736,"TANGKUP, SIDEMEN, KARANGASEM, BALI",6,219,2,221
https://kawalpemilu.org#53736,"TANGKUP, SIDEMEN, KARANGASEM, BALI",7,217,1,218
https://kawalpemilu.org#53736,"TANGKUP, SIDEMEN, KARANGASEM, BALI",8,226,2,228
https://kawalpemilu.org#53736,"TANGKUP, SIDEMEN, KARANGASEM, BALI",9,167,22,189
https://kawalpemilu.org#53736,"TANGKUP, SIDEMEN, KARANGASEM, BALI",10,192,14,206
https://kawalpemilu.org#53737,"TALIBENG, SIDEMEN, KARANGASEM, BALI",1,232,2,234
https://kawalpemilu.org#53737,"TALIBENG, SIDEMEN, KARANGASEM, BALI",2,218,4,222
https://kawalpemilu.org#53737,"TALIBENG, SIDEMEN, KARANGASEM, BALI",3,201,7,208
https://kawalpemilu.org#53737,"TALIBENG, SIDEMEN, KARANGASEM, BALI",4,142,3,145
https://kawalpemilu.org#53737,"TALIBENG, SIDEMEN, KARANGASEM, BALI",5,142,3,145
https://kawalpemilu.org#53737,"TALIBENG, SIDEMEN, KARANGASEM, BALI",6,197,2,199
https://kawalpemilu.org#53737,"TALIBENG, SIDEMEN, KARANGASEM, BALI",7,179,3,182
https://kawalpemilu.org#53737,"TALIBENG, SIDEMEN, KARANGASEM, BALI",8,253,0,253
https://kawalpemilu.org#53737,"TALIBENG, SIDEMEN, KARANGASEM, BALI",9,219,3,222
https://kawalpemilu.org#53737,"TALIBENG, SIDEMEN, KARANGASEM, BALI",10,216,3,219
https://kawalpemilu.org#53737,"TALIBENG, SIDEMEN, KARANGASEM, BALI",11,136,6,142
https://kawalpemilu.org#53737,"TALIBENG, SIDEMEN, KARANGASEM, BALI",12,123,8,131
https://kawalpemilu.org#53737,"TALIBENG, SIDEMEN, KARANGASEM, BALI",13,124,0,124
https://kawalpemilu.org#53738,"SIDEMEN, SIDEMEN, KARANGASEM, BALI",1,243,27,270
https://kawalpemilu.org#53738,"SIDEMEN, SIDEMEN, KARANGASEM, BALI",2,225,15,240
https://kawalpemilu.org#53738,"SIDEMEN, SIDEMEN, KARANGASEM, BALI",3,213,7,220
https://kawalpemilu.org#53738,"SIDEMEN, SIDEMEN, KARANGASEM, BALI",4,199,5,204
https://kawalpemilu.org#53738,"SIDEMEN, SIDEMEN, KARANGASEM, BALI",5,177,16,193
https://kawalpemilu.org#53738,"SIDEMEN, SIDEMEN, KARANGASEM, BALI",6,179,7,186
https://kawalpemilu.org#53738,"SIDEMEN, SIDEMEN, KARANGASEM, BALI",7,189,15,204
https://kawalpemilu.org#53738,"SIDEMEN, SIDEMEN, KARANGASEM, BALI",8,205,2,207
https://kawalpemilu.org#53738,"SIDEMEN, SIDEMEN, KARANGASEM, BALI",9,221,11,232
https://kawalpemilu.org#53738,"SIDEMEN, SIDEMEN, KARANGASEM, BALI",10,181,6,187
https://kawalpemilu.org#53738,"SIDEMEN, SIDEMEN, KARANGASEM, BALI",11,175,5,180
https://kawalpemilu.org#53738,"SIDEMEN, SIDEMEN, KARANGASEM, BALI",12,172,0,172
https://kawalpemilu.org#53738,"SIDEMEN, SIDEMEN, KARANGASEM, BALI",13,162,3,165
https://kawalpemilu.org#53739,"SANGKAN GUNUNG, SIDEMEN, KARANGASEM, BALI",1,179,8,187
https://kawalpemilu.org#53739,"SANGKAN GUNUNG, SIDEMEN, KARANGASEM, BALI",2,177,6,183
https://kawalpemilu.org#53739,"SANGKAN GUNUNG, SIDEMEN, KARANGASEM, BALI",3,146,9,155
https://kawalpemilu.org#53739,"SANGKAN GUNUNG, SIDEMEN, KARANGASEM, BALI",4,192,20,212
https://kawalpemilu.org#53739,"SANGKAN GUNUNG, SIDEMEN, KARANGASEM, BALI",5,201,10,211
https://kawalpemilu.org#53739,"SANGKAN GUNUNG, SIDEMEN, KARANGASEM, BALI",6,153,5,158
https://kawalpemilu.org#53739,"SANGKAN GUNUNG, SIDEMEN, KARANGASEM, BALI",7,172,8,180
https://kawalpemilu.org#53739,"SANGKAN GUNUNG, SIDEMEN, KARANGASEM, BALI",8,155,13,168
https://kawalpemilu.org#53739,"SANGKAN GUNUNG, SIDEMEN, KARANGASEM, BALI",9,148,5,153
https://kawalpemilu.org#53739,"SANGKAN GUNUNG, SIDEMEN, KARANGASEM, BALI",10,177,43,220
https://kawalpemilu.org#53739,"SANGKAN GUNUNG, SIDEMEN, KARANGASEM, BALI",11,190,28,218
https://kawalpemilu.org#53739,"SANGKAN GUNUNG, SIDEMEN, KARANGASEM, BALI",12,188,30,218
https://kawalpemilu.org#53739,"SANGKAN GUNUNG, SIDEMEN, KARANGASEM, BALI",13,217,8,225
https://kawalpemilu.org#53739,"SANGKAN GUNUNG, SIDEMEN, KARANGASEM, BALI",14,220,5,225
https://kawalpemilu.org#53739,"SANGKAN GUNUNG, SIDEMEN, KARANGASEM, BALI",15,227,8,235
https://kawalpemilu.org#53739,"SANGKAN GUNUNG, SIDEMEN, KARANGASEM, BALI",16,194,9,203
https://kawalpemilu.org#53739,"SANGKAN GUNUNG, SIDEMEN, KARANGASEM, BALI",17,193,3,196
https://kawalpemilu.org#53739,"SANGKAN GUNUNG, SIDEMEN, KARANGASEM, BALI",18,202,7,209
https://kawalpemilu.org#53739,"SANGKAN GUNUNG, SIDEMEN, KARANGASEM, BALI",19,201,5,206
https://kawalpemilu.org#53739,"SANGKAN GUNUNG, SIDEMEN, KARANGASEM, BALI",20,174,5,179
https://kawalpemilu.org#53739,"SANGKAN GUNUNG, SIDEMEN, KARANGASEM, BALI",21,273,6,279
https://kawalpemilu.org#53739,"SANGKAN GUNUNG, SIDEMEN, KARANGASEM, BALI",22,255,1,256
https://kawalpemilu.org#53739,"SANGKAN GUNUNG, SIDEMEN, KARANGASEM, BALI",23,239,0,239
https://kawalpemilu.org#53739,"SANGKAN GUNUNG, SIDEMEN, KARANGASEM, BALI",24,209,3,212
https://kawalpemilu.org#53739,"SANGKAN GUNUNG, SIDEMEN, KARANGASEM, BALI",25,216,2,218
https://kawalpemilu.org#53740,"TELAGA TAWANG, SIDEMEN, KARANGASEM, BALI",1,136,0,136
https://kawalpemilu.org#53740,"TELAGA TAWANG, SIDEMEN, KARANGASEM, BALI",2,121,3,124
https://kawalpemilu.org#53740,"TELAGA TAWANG, SIDEMEN, KARANGASEM, BALI",3,196,3,199
https://kawalpemilu.org#53740,"TELAGA TAWANG, SIDEMEN, KARANGASEM, BALI",4,183,9,192
https://kawalpemilu.org#53740,"TELAGA TAWANG, SIDEMEN, KARANGASEM, BALI",5,241,8,249
https://kawalpemilu.org#53740,"TELAGA TAWANG, SIDEMEN, KARANGASEM, BALI",6,206,2,208
https://kawalpemilu.org#53740,"TELAGA TAWANG, SIDEMEN, KARANGASEM, BALI",7,242,4,246
https://kawalpemilu.org#53740,"TELAGA TAWANG, SIDEMEN, KARANGASEM, BALI",8,258,6,264
https://kawalpemilu.org#53740,"TELAGA TAWANG, SIDEMEN, KARANGASEM, BALI",9,178,4,182
https://kawalpemilu.org#53740,"TELAGA TAWANG, SIDEMEN, KARANGASEM, BALI",10,183,8,191
https://kawalpemilu.org#53741,"SINDUWATI, SIDEMEN, KARANGASEM, BALI",1,135,3,138
https://kawalpemilu.org#53741,"SINDUWATI, SIDEMEN, KARANGASEM, BALI",2,189,7,196
https://kawalpemilu.org#53741,"SINDUWATI, SIDEMEN, KARANGASEM, BALI",3,157,6,163
https://kawalpemilu.org#53741,"SINDUWATI, SIDEMEN, KARANGASEM, BALI",4,167,4,171
https://kawalpemilu.org#53741,"SINDUWATI, SIDEMEN, KARANGASEM, BALI",5,159,3,162
https://kawalpemilu.org#53741,"SINDUWATI, SIDEMEN, KARANGASEM, BALI",7,228,6,234
https://kawalpemilu.org#53741,"SINDUWATI, SIDEMEN, KARANGASEM, BALI",8,170,7,177
https://kawalpemilu.org#53741,"SINDUWATI, SIDEMEN, KARANGASEM, BALI",9,183,8,191
https://kawalpemilu.org#53741,"SINDUWATI, SIDEMEN, KARANGASEM, BALI",10,211,3,214
https://kawalpemilu.org#53741,"SINDUWATI, SIDEMEN, KARANGASEM, BALI",11,168,2,170
https://kawalpemilu.org#53741,"SINDUWATI, SIDEMEN, KARANGASEM, BALI",12,50,119,169
https://kawalpemilu.org#53741,"SINDUWATI, SIDEMEN, KARANGASEM, BALI",13,60,104,164
https://kawalpemilu.org#53741,"SINDUWATI, SIDEMEN, KARANGASEM, BALI",14,80,96,176
https://kawalpemilu.org#53741,"SINDUWATI, SIDEMEN, KARANGASEM, BALI",15,123,0,123
https://kawalpemilu.org#53741,"SINDUWATI, SIDEMEN, KARANGASEM, BALI",16,126,1,127
https://kawalpemilu.org#53742,"TRI EKA BUANA, SIDEMEN, KARANGASEM, BALI",1,230,2,232
https://kawalpemilu.org#53742,"TRI EKA BUANA, SIDEMEN, KARANGASEM, BALI",2,212,25,237
https://kawalpemilu.org#53742,"TRI EKA BUANA, SIDEMEN, KARANGASEM, BALI",3,178,33,211
https://kawalpemilu.org#53742,"TRI EKA BUANA, SIDEMEN, KARANGASEM, BALI",4,207,9,216
https://kawalpemilu.org#53742,"TRI EKA BUANA, SIDEMEN, KARANGASEM, BALI",5,177,8,185
https://kawalpemilu.org#53742,"TRI EKA BUANA, SIDEMEN, KARANGASEM, BALI",6,218,4,222
https://kawalpemilu.org#53742,"TRI EKA BUANA, SIDEMEN, KARANGASEM, BALI",7,172,8,180
https://kawalpemilu.org#53742,"TRI EKA BUANA, SIDEMEN, KARANGASEM, BALI",8,173,2,175
https://kawalpemilu.org#53743,"KERTA BUANA, SIDEMEN, KARANGASEM, BALI",1,143,5,148
https://kawalpemilu.org#53743,"KERTA BUANA, SIDEMEN, KARANGASEM, BALI",2,141,6,147
https://kawalpemilu.org#53743,"KERTA BUANA, SIDEMEN, KARANGASEM, BALI",3,182,9,191
https://kawalpemilu.org#53743,"KERTA BUANA, SIDEMEN, KARANGASEM, BALI",4,169,9,178
https://kawalpemilu.org#53743,"KERTA BUANA, SIDEMEN, KARANGASEM, BALI",5,179,8,187
https://kawalpemilu.org#53743,"KERTA BUANA, SIDEMEN, KARANGASEM, BALI",7,173,7,180
https://kawalpemilu.org#53743,"KERTA BUANA, SIDEMEN, KARANGASEM, BALI",8,216,7,223
https://kawalpemilu.org#53743,"KERTA BUANA, SIDEMEN, KARANGASEM, BALI",9,204,13,217
https://kawalpemilu.org#53743,"KERTA BUANA, SIDEMEN, KARANGASEM, BALI",10,235,9,244
https://kawalpemilu.org#53744,"LOKASARI, SIDEMEN, KARANGASEM, BALI",1,136,1,137
https://kawalpemilu.org#53744,"LOKASARI, SIDEMEN, KARANGASEM, BALI",2,152,3,152
https://kawalpemilu.org#53744,"LOKASARI, SIDEMEN, KARANGASEM, BALI",3,159,0,159
https://kawalpemilu.org#53744,"LOKASARI, SIDEMEN, KARANGASEM, BALI",4,114,6,120
https://kawalpemilu.org#53744,"LOKASARI, SIDEMEN, KARANGASEM, BALI",5,111,10,121
https://kawalpemilu.org#53744,"LOKASARI, SIDEMEN, KARANGASEM, BALI",6,120,9,129
https://kawalpemilu.org#53744,"LOKASARI, SIDEMEN, KARANGASEM, BALI",7,126,7,133
https://kawalpemilu.org#53744,"LOKASARI, SIDEMEN, KARANGASEM, BALI",8,183,10,193
https://kawalpemilu.org#53744,"LOKASARI, SIDEMEN, KARANGASEM, BALI",9,196,3,199
https://kawalpemilu.org#53744,"LOKASARI, SIDEMEN, KARANGASEM, BALI",10,151,2,153
https://kawalpemilu.org#53745,"WISMAKERTA, SIDEMEN, KARANGASEM, BALI",1,191,15,206
https://kawalpemilu.org#53745,"WISMAKERTA, SIDEMEN, KARANGASEM, BALI",2,119,118,217
https://kawalpemilu.org#53745,"WISMAKERTA, SIDEMEN, KARANGASEM, BALI",3,182,4,186
https://kawalpemilu.org#53745,"WISMAKERTA, SIDEMEN, KARANGASEM, BALI",4,152,2,154
https://kawalpemilu.org#53745,"WISMAKERTA, SIDEMEN, KARANGASEM, BALI",5,186,4,190
https://kawalpemilu.org#53745,"WISMAKERTA, SIDEMEN, KARANGASEM, BALI",6,181,7,188
https://kawalpemilu.org#53745,"WISMAKERTA, SIDEMEN, KARANGASEM, BALI",7,161,3,164
https://kawalpemilu.org#53745,"WISMAKERTA, SIDEMEN, KARANGASEM, BALI",8,146,5,151
https://kawalpemilu.org#53745,"WISMAKERTA, SIDEMEN, KARANGASEM, BALI",9,149,5,154
https://kawalpemilu.org#53745,"WISMAKERTA, SIDEMEN, KARANGASEM, BALI",10,157,2,159
https://kawalpemilu.org#53745,"WISMAKERTA, SIDEMEN, KARANGASEM, BALI",11,144,8,152
https://kawalpemilu.org#53747,"GEGELANG, MANGGIS, KARANGASEM, BALI",1,148,3,151
https://kawalpemilu.org#53747,"GEGELANG, MANGGIS, KARANGASEM, BALI",2,170,5,175
https://kawalpemilu.org#53747,"GEGELANG, MANGGIS, KARANGASEM, BALI",3,172,4,176
https://kawalpemilu.org#53747,"GEGELANG, MANGGIS, KARANGASEM, BALI",4,98,5,103
https://kawalpemilu.org#53747,"GEGELANG, MANGGIS, KARANGASEM, BALI",5,132,2,134
https://kawalpemilu.org#53747,"GEGELANG, MANGGIS, KARANGASEM, BALI",6,118,4,122
https://kawalpemilu.org#53747,"GEGELANG, MANGGIS, KARANGASEM, BALI",7,137,4,141
https://kawalpemilu.org#53747,"GEGELANG, MANGGIS, KARANGASEM, BALI",8,117,5,122
https://kawalpemilu.org#53747,"GEGELANG, MANGGIS, KARANGASEM, BALI",9,156,1,157
https://kawalpemilu.org#53747,"GEGELANG, MANGGIS, KARANGASEM, BALI",10,153,2,155
https://kawalpemilu.org#53747,"GEGELANG, MANGGIS, KARANGASEM, BALI",11,129,4,133
https://kawalpemilu.org#53747,"GEGELANG, MANGGIS, KARANGASEM, BALI",12,146,6,152
https://kawalpemilu.org#53747,"GEGELANG, MANGGIS, KARANGASEM, BALI",13,125,10,135
https://kawalpemilu.org#53747,"GEGELANG, MANGGIS, KARANGASEM, BALI",14,143,5,148
https://kawalpemilu.org#53747,"GEGELANG, MANGGIS, KARANGASEM, BALI",15,135,6,141
https://kawalpemilu.org#53747,"GEGELANG, MANGGIS, KARANGASEM, BALI",16,132,5,137
https://kawalpemilu.org#53747,"GEGELANG, MANGGIS, KARANGASEM, BALI",17,111,7,118
https://kawalpemilu.org#53747,"GEGELANG, MANGGIS, KARANGASEM, BALI",18,113,4,117
https://kawalpemilu.org#53747,"GEGELANG, MANGGIS, KARANGASEM, BALI",19,125,4,129
https://kawalpemilu.org#53747,"GEGELANG, MANGGIS, KARANGASEM, BALI",20,108,5,113
https://kawalpemilu.org#53747,"GEGELANG, MANGGIS, KARANGASEM, BALI",21,96,7,103
https://kawalpemilu.org#53747,"GEGELANG, MANGGIS, KARANGASEM, BALI",22,112,7,119
https://kawalpemilu.org#53747,"GEGELANG, MANGGIS, KARANGASEM, BALI",23,118,9,127
https://kawalpemilu.org#53747,"GEGELANG, MANGGIS, KARANGASEM, BALI",24,74,8,82
https://kawalpemilu.org#53747,"GEGELANG, MANGGIS, KARANGASEM, BALI",25,124,19,143
https://kawalpemilu.org#53747,"GEGELANG, MANGGIS, KARANGASEM, BALI",26,89,13,102
https://kawalpemilu.org#53747,"GEGELANG, MANGGIS, KARANGASEM, BALI",27,136,12,148
https://kawalpemilu.org#53747,"GEGELANG, MANGGIS, KARANGASEM, BALI",28,119,5,124
https://kawalpemilu.org#53747,"GEGELANG, MANGGIS, KARANGASEM, BALI",29,61,6,67
https://kawalpemilu.org#53747,"GEGELANG, MANGGIS, KARANGASEM, BALI",30,89,2,91
https://kawalpemilu.org#53748,"ANTIGA, MANGGIS, KARANGASEM, BALI",1,139,4,143
https://kawalpemilu.org#53748,"ANTIGA, MANGGIS, KARANGASEM, BALI",2,118,5,123
https://kawalpemilu.org#53748,"ANTIGA, MANGGIS, KARANGASEM, BALI",3,122,8,130
https://kawalpemilu.org#53748,"ANTIGA, MANGGIS, KARANGASEM, BALI",4,179,15,194
https://kawalpemilu.org#53748,"ANTIGA, MANGGIS, KARANGASEM, BALI",5,217,7,224
https://kawalpemilu.org#53748,"ANTIGA, MANGGIS, KARANGASEM, BALI",6,169,7,176
https://kawalpemilu.org#53748,"ANTIGA, MANGGIS, KARANGASEM, BALI",7,173,7,180
https://kawalpemilu.org#53748,"ANTIGA, MANGGIS, KARANGASEM, BALI",8,174,2,176
https://kawalpemilu.org#53748,"ANTIGA, MANGGIS, KARANGASEM, BALI",9,207,5,212
https://kawalpemilu.org#53748,"ANTIGA, MANGGIS, KARANGASEM, BALI",10,194,4,198
https://kawalpemilu.org#53748,"ANTIGA, MANGGIS, KARANGASEM, BALI",11,175,4,179
https://kawalpemilu.org#53748,"ANTIGA, MANGGIS, KARANGASEM, BALI",12,155,8,163
https://kawalpemilu.org#53748,"ANTIGA, MANGGIS, KARANGASEM, BALI",13,132,8,140
https://kawalpemilu.org#53748,"ANTIGA, MANGGIS, KARANGASEM, BALI",14,134,11,145
https://kawalpemilu.org#53748,"ANTIGA, MANGGIS, KARANGASEM, BALI",15,153,3,156
https://kawalpemilu.org#53748,"ANTIGA, MANGGIS, KARANGASEM, BALI",16,194,6,200
https://kawalpemilu.org#53748,"ANTIGA, MANGGIS, KARANGASEM, BALI",17,184,3,187
https://kawalpemilu.org#53748,"ANTIGA, MANGGIS, KARANGASEM, BALI",18,206,6,212
https://kawalpemilu.org#53748,"ANTIGA, MANGGIS, KARANGASEM, BALI",19,177,3,180
https://kawalpemilu.org#53748,"ANTIGA, MANGGIS, KARANGASEM, BALI",20,113,7,120
https://kawalpemilu.org#53748,"ANTIGA, MANGGIS, KARANGASEM, BALI",21,185,4,189
https://kawalpemilu.org#53748,"ANTIGA, MANGGIS, KARANGASEM, BALI",22,159,6,165
https://kawalpemilu.org#53749,"ULAKAN, MANGGIS, KARANGASEM, BALI",1,142,2,144
https://kawalpemilu.org#53749,"ULAKAN, MANGGIS, KARANGASEM, BALI",2,166,9,175
https://kawalpemilu.org#53749,"ULAKAN, MANGGIS, KARANGASEM, BALI",3,185,5,190
https://kawalpemilu.org#53749,"ULAKAN, MANGGIS, KARANGASEM, BALI",4,177,1,178
https://kawalpemilu.org#53749,"ULAKAN, MANGGIS, KARANGASEM, BALI",5,149,4,153
https://kawalpemilu.org#53749,"ULAKAN, MANGGIS, KARANGASEM, BALI",6,150,1,151
https://kawalpemilu.org#53749,"ULAKAN, MANGGIS, KARANGASEM, BALI",8,134,5,139
https://kawalpemilu.org#53749,"ULAKAN, MANGGIS, KARANGASEM, BALI",9,161,2,163
https://kawalpemilu.org#53749,"ULAKAN, MANGGIS, KARANGASEM, BALI",10,117,7,124
https://kawalpemilu.org#53749,"ULAKAN, MANGGIS, KARANGASEM, BALI",11,133,3,136
https://kawalpemilu.org#53749,"ULAKAN, MANGGIS, KARANGASEM, BALI",12,163,2,165
https://kawalpemilu.org#53749,"ULAKAN, MANGGIS, KARANGASEM, BALI",13,218,11,229
https://kawalpemilu.org#53749,"ULAKAN, MANGGIS, KARANGASEM, BALI",14,191,5,196
https://kawalpemilu.org#53749,"ULAKAN, MANGGIS, KARANGASEM, BALI",15,198,12,210
https://kawalpemilu.org#53749,"ULAKAN, MANGGIS, KARANGASEM, BALI",16,219,9,228
https://kawalpemilu.org#53749,"ULAKAN, MANGGIS, KARANGASEM, BALI",17,210,10,220
https://kawalpemilu.org#53749,"ULAKAN, MANGGIS, KARANGASEM, BALI",18,141,6,147
https://kawalpemilu.org#53749,"ULAKAN, MANGGIS, KARANGASEM, BALI",19,153,8,161
https://kawalpemilu.org#53750,"MANGGIS, MANGGIS, KARANGASEM, BALI",1,159,3,162
https://kawalpemilu.org#53750,"MANGGIS, MANGGIS, KARANGASEM, BALI",2,145,8,153
https://kawalpemilu.org#53750,"MANGGIS, MANGGIS, KARANGASEM, BALI",3,124,2,126
https://kawalpemilu.org#53750,"MANGGIS, MANGGIS, KARANGASEM, BALI",4,143,2,145
https://kawalpemilu.org#53750,"MANGGIS, MANGGIS, KARANGASEM, BALI",5,189,13,202
https://kawalpemilu.org#53750,"MANGGIS, MANGGIS, KARANGASEM, BALI",6,135,2,137
https://kawalpemilu.org#53750,"MANGGIS, MANGGIS, KARANGASEM, BALI",7,115,6,121
https://kawalpemilu.org#53750,"MANGGIS, MANGGIS, KARANGASEM, BALI",8,125,6,131
https://kawalpemilu.org#53750,"MANGGIS, MANGGIS, KARANGASEM, BALI",9,145,3,148
https://kawalpemilu.org#53750,"MANGGIS, MANGGIS, KARANGASEM, BALI",10,216,3,219
https://kawalpemilu.org#53750,"MANGGIS, MANGGIS, KARANGASEM, BALI",11,187,5,192
https://kawalpemilu.org#53750,"MANGGIS, MANGGIS, KARANGASEM, BALI",12,190,8,198
https://kawalpemilu.org#53750,"MANGGIS, MANGGIS, KARANGASEM, BALI",13,227,1,228
https://kawalpemilu.org#53750,"MANGGIS, MANGGIS, KARANGASEM, BALI",14,229,10,239
https://kawalpemilu.org#53750,"MANGGIS, MANGGIS, KARANGASEM, BALI",15,130,46,176
https://kawalpemilu.org#53750,"MANGGIS, MANGGIS, KARANGASEM, BALI",16,158,24,182
https://kawalpemilu.org#53750,"MANGGIS, MANGGIS, KARANGASEM, BALI",17,178,7,185
https://kawalpemilu.org#53750,"MANGGIS, MANGGIS, KARANGASEM, BALI",18,191,0,191
https://kawalpemilu.org#53750,"MANGGIS, MANGGIS, KARANGASEM, BALI",19,166,11,177
https://kawalpemilu.org#53750,"MANGGIS, MANGGIS, KARANGASEM, BALI",20,179,4,183
https://kawalpemilu.org#53750,"MANGGIS, MANGGIS, KARANGASEM, BALI",21,174,8,182
https://kawalpemilu.org#53750,"MANGGIS, MANGGIS, KARANGASEM, BALI",22,158,3,161
https://kawalpemilu.org#53750,"MANGGIS, MANGGIS, KARANGASEM, BALI",23,165,1,166
https://kawalpemilu.org#53750,"MANGGIS, MANGGIS, KARANGASEM, BALI",24,150,8,158
https://kawalpemilu.org#53751,"NYUH TEBEL, MANGGIS, KARANGASEM, BALI",1,200,3,203
https://kawalpemilu.org#53751,"NYUH TEBEL, MANGGIS, KARANGASEM, BALI",2,191,5,196
https://kawalpemilu.org#53751,"NYUH TEBEL, MANGGIS, KARANGASEM, BALI",3,159,5,164
https://kawalpemilu.org#53751,"NYUH TEBEL, MANGGIS, KARANGASEM, BALI",4,151,4,155
https://kawalpemilu.org#53751,"NYUH TEBEL, MANGGIS, KARANGASEM, BALI",5,214,2,216
https://kawalpemilu.org#53751,"NYUH TEBEL, MANGGIS, KARANGASEM, BALI",6,208,5,213
https://kawalpemilu.org#53751,"NYUH TEBEL, MANGGIS, KARANGASEM, BALI",7,164,7,171
https://kawalpemilu.org#53751,"NYUH TEBEL, MANGGIS, KARANGASEM, BALI",8,152,15,167
https://kawalpemilu.org#53751,"NYUH TEBEL, MANGGIS, KARANGASEM, BALI",9,139,5,144
https://kawalpemilu.org#53751,"NYUH TEBEL, MANGGIS, KARANGASEM, BALI",10,138,6,144
https://kawalpemilu.org#53752,"TENGANAN, MANGGIS, KARANGASEM, BALI",1,228,7,234
https://kawalpemilu.org#53752,"TENGANAN, MANGGIS, KARANGASEM, BALI",2,237,5,242
https://kawalpemilu.org#53752,"TENGANAN, MANGGIS, KARANGASEM, BALI",3,236,15,251
https://kawalpemilu.org#53752,"TENGANAN, MANGGIS, KARANGASEM, BALI",4,256,3,259
https://kawalpemilu.org#53752,"TENGANAN, MANGGIS, KARANGASEM, BALI",5,248,6,254
https://kawalpemilu.org#53752,"TENGANAN, MANGGIS, KARANGASEM, BALI",6,207,10,217
https://kawalpemilu.org#53752,"TENGANAN, MANGGIS, KARANGASEM, BALI",7,230,19,249
https://kawalpemilu.org#53752,"TENGANAN, MANGGIS, KARANGASEM, BALI",8,225,9,234
https://kawalpemilu.org#53752,"TENGANAN, MANGGIS, KARANGASEM, BALI",9,215,0,215
https://kawalpemilu.org#53752,"TENGANAN, MANGGIS, KARANGASEM, BALI",10,201,8,209
https://kawalpemilu.org#53752,"TENGANAN, MANGGIS, KARANGASEM, BALI",11,223,2,225
https://kawalpemilu.org#53752,"TENGANAN, MANGGIS, KARANGASEM, BALI",12,203,12,215
https://kawalpemilu.org#53753,"NGIS, MANGGIS, KARANGASEM, BALI",1,201,1,202
https://kawalpemilu.org#53753,"NGIS, MANGGIS, KARANGASEM, BALI",2,202,8,210
https://kawalpemilu.org#53753,"NGIS, MANGGIS, KARANGASEM, BALI",3,190,4,194
https://kawalpemilu.org#53753,"NGIS, MANGGIS, KARANGASEM, BALI",4,177,3,180
https://kawalpemilu.org#53753,"NGIS, MANGGIS, KARANGASEM, BALI",5,187,5,192
https://kawalpemilu.org#53753,"NGIS, MANGGIS, KARANGASEM, BALI",6,201,5,206
https://kawalpemilu.org#53753,"NGIS, MANGGIS, KARANGASEM, BALI",7,184,8,192
https://kawalpemilu.org#53753,"NGIS, MANGGIS, KARANGASEM, BALI",8,184,5,189
https://kawalpemilu.org#53754,"SELUMBUNG, MANGGIS, KARANGASEM, BALI",1,121,3,124
https://kawalpemilu.org#53754,"SELUMBUNG, MANGGIS, KARANGASEM, BALI",2,111,8,119
https://kawalpemilu.org#53754,"SELUMBUNG, MANGGIS, KARANGASEM, BALI",3,109,3,112
https://kawalpemilu.org#53754,"SELUMBUNG, MANGGIS, KARANGASEM, BALI",4,176,3,179
https://kawalpemilu.org#53754,"SELUMBUNG, MANGGIS, KARANGASEM, BALI",5,162,10,172
https://kawalpemilu.org#53754,"SELUMBUNG, MANGGIS, KARANGASEM, BALI",6,175,4,179
https://kawalpemilu.org#53754,"SELUMBUNG, MANGGIS, KARANGASEM, BALI",7,149,8,157
https://kawalpemilu.org#53754,"SELUMBUNG, MANGGIS, KARANGASEM, BALI",8,124,9,133
https://kawalpemilu.org#53754,"SELUMBUNG, MANGGIS, KARANGASEM, BALI",9,152,6,158
https://kawalpemilu.org#53754,"SELUMBUNG, MANGGIS, KARANGASEM, BALI",10,167,8,175
https://kawalpemilu.org#53754,"SELUMBUNG, MANGGIS, KARANGASEM, BALI",11,164,4,168
https://kawalpemilu.org#53754,"SELUMBUNG, MANGGIS, KARANGASEM, BALI",12,193,6,199
https://kawalpemilu.org#53754,"SELUMBUNG, MANGGIS, KARANGASEM, BALI",13,194,1,195
https://kawalpemilu.org#53755,"PADANGBAI, MANGGIS, KARANGASEM, BALI",1,180,11,191
https://kawalpemilu.org#53755,"PADANGBAI, MANGGIS, KARANGASEM, BALI",2,176,13,189
https://kawalpemilu.org#53755,"PADANGBAI, MANGGIS, KARANGASEM, BALI",3,157,5,162
https://kawalpemilu.org#53755,"PADANGBAI, MANGGIS, KARANGASEM, BALI",4,161,2,163
https://kawalpemilu.org#53755,"PADANGBAI, MANGGIS, KARANGASEM, BALI",5,143,5,148
https://kawalpemilu.org#53755,"PADANGBAI, MANGGIS, KARANGASEM, BALI",6,143,7,150
https://kawalpemilu.org#53755,"PADANGBAI, MANGGIS, KARANGASEM, BALI",7,206,10,216
https://kawalpemilu.org#53755,"PADANGBAI, MANGGIS, KARANGASEM, BALI",8,187,8,195
https://kawalpemilu.org#53755,"PADANGBAI, MANGGIS, KARANGASEM, BALI",9,182,5,187
https://kawalpemilu.org#53755,"PADANGBAI, MANGGIS, KARANGASEM, BALI",10,170,6,176
https://kawalpemilu.org#53755,"PADANGBAI, MANGGIS, KARANGASEM, BALI",11,152,5,157
https://kawalpemilu.org#53755,"PADANGBAI, MANGGIS, KARANGASEM, BALI",12,116,5,121
https://kawalpemilu.org#53755,"PADANGBAI, MANGGIS, KARANGASEM, BALI",13,119,4,123
https://kawalpemilu.org#53756,"SENGKIDU, MANGGIS, KARANGASEM, BALI",1,159,5,164
https://kawalpemilu.org#53756,"SENGKIDU, MANGGIS, KARANGASEM, BALI",2,157,1,158
https://kawalpemilu.org#53756,"SENGKIDU, MANGGIS, KARANGASEM, BALI",3,153,6,159
https://kawalpemilu.org#53756,"SENGKIDU, MANGGIS, KARANGASEM, BALI",4,146,2,148
https://kawalpemilu.org#53756,"SENGKIDU, MANGGIS, KARANGASEM, BALI",5,165,8,173
https://kawalpemilu.org#53756,"SENGKIDU, MANGGIS, KARANGASEM, BALI",6,156,2,158
https://kawalpemilu.org#53756,"SENGKIDU, MANGGIS, KARANGASEM, BALI",7,141,5,146
https://kawalpemilu.org#53756,"SENGKIDU, MANGGIS, KARANGASEM, BALI",8,137,5,142
https://kawalpemilu.org#53756,"SENGKIDU, MANGGIS, KARANGASEM, BALI",9,159,4,163
https://kawalpemilu.org#53756,"SENGKIDU, MANGGIS, KARANGASEM, BALI",10,167,5,172
https://kawalpemilu.org#53757,"PASEDAHAN, MANGGIS, KARANGASEM, BALI",1,193,20,213
https://kawalpemilu.org#53757,"PASEDAHAN, MANGGIS, KARANGASEM, BALI",3,203,16,219
https://kawalpemilu.org#53757,"PASEDAHAN, MANGGIS, KARANGASEM, BALI",4,185,18,203
https://kawalpemilu.org#53757,"PASEDAHAN, MANGGIS, KARANGASEM, BALI",5,159,9,168
https://kawalpemilu.org#53757,"PASEDAHAN, MANGGIS, KARANGASEM, BALI",6,168,7,175
https://kawalpemilu.org#53758,"ANTIGA KELOD, MANGGIS, KARANGASEM, BALI",1,171,12,183
https://kawalpemilu.org#53758,"ANTIGA KELOD, MANGGIS, KARANGASEM, BALI",2,176,5,181
https://kawalpemilu.org#53758,"ANTIGA KELOD, MANGGIS, KARANGASEM, BALI",3,147,9,156
https://kawalpemilu.org#53758,"ANTIGA KELOD, MANGGIS, KARANGASEM, BALI",4,169,19,188
https://kawalpemilu.org#53758,"ANTIGA KELOD, MANGGIS, KARANGASEM, BALI",5,147,2,149
https://kawalpemilu.org#53758,"ANTIGA KELOD, MANGGIS, KARANGASEM, BALI",6,193,3,196
https://kawalpemilu.org#53758,"ANTIGA KELOD, MANGGIS, KARANGASEM, BALI",7,169,0,169
https://kawalpemilu.org#53758,"ANTIGA KELOD, MANGGIS, KARANGASEM, BALI",8,150,4,154
https://kawalpemilu.org#53758,"ANTIGA KELOD, MANGGIS, KARANGASEM, BALI",9,178,3,181
https://kawalpemilu.org#53758,"ANTIGA KELOD, MANGGIS, KARANGASEM, BALI",10,190,5,195
https://kawalpemilu.org#53758,"ANTIGA KELOD, MANGGIS, KARANGASEM, BALI",11,188,9,197
https://kawalpemilu.org#53758,"ANTIGA KELOD, MANGGIS, KARANGASEM, BALI",12,200,6,206
https://kawalpemilu.org#53758,"ANTIGA KELOD, MANGGIS, KARANGASEM, BALI",13,187,3,190
https://kawalpemilu.org#53758,"ANTIGA KELOD, MANGGIS, KARANGASEM, BALI",14,188,4,192
https://kawalpemilu.org#53758,"ANTIGA KELOD, MANGGIS, KARANGASEM, BALI",15,149,3,152
https://kawalpemilu.org#53758,"ANTIGA KELOD, MANGGIS, KARANGASEM, BALI",16,151,2,153
https://kawalpemilu.org#53758,"ANTIGA KELOD, MANGGIS, KARANGASEM, BALI",17,116,3,119
https://kawalpemilu.org#53760,"SUBAGAN, KARANGASEM, KARANGASEM, BALI",1,146,8,154
https://kawalpemilu.org#53760,"SUBAGAN, KARANGASEM, KARANGASEM, BALI",2,124,6,130
https://kawalpemilu.org#53760,"SUBAGAN, KARANGASEM, KARANGASEM, BALI",3,189,15,204
https://kawalpemilu.org#53760,"SUBAGAN, KARANGASEM, KARANGASEM, BALI",4,203,4,207
https://kawalpemilu.org#53760,"SUBAGAN, KARANGASEM, KARANGASEM, BALI",5,225,4,229
https://kawalpemilu.org#53760,"SUBAGAN, KARANGASEM, KARANGASEM, BALI",6,223,3,226
https://kawalpemilu.org#53760,"SUBAGAN, KARANGASEM, KARANGASEM, BALI",7,148,7,155
https://kawalpemilu.org#53760,"SUBAGAN, KARANGASEM, KARANGASEM, BALI",8,178,0,178
https://kawalpemilu.org#53760,"SUBAGAN, KARANGASEM, KARANGASEM, BALI",9,115,6,121
https://kawalpemilu.org#53760,"SUBAGAN, KARANGASEM, KARANGASEM, BALI",10,144,4,148
https://kawalpemilu.org#53760,"SUBAGAN, KARANGASEM, KARANGASEM, BALI",11,194,4,198
https://kawalpemilu.org#53760,"SUBAGAN, KARANGASEM, KARANGASEM, BALI",12,206,4,210
https://kawalpemilu.org#53760,"SUBAGAN, KARANGASEM, KARANGASEM, BALI",13,175,3,178
https://kawalpemilu.org#53760,"SUBAGAN, KARANGASEM, KARANGASEM, BALI",14,163,0,163
https://kawalpemilu.org#53760,"SUBAGAN, KARANGASEM, KARANGASEM, BALI",15,152,3,155
https://kawalpemilu.org#53760,"SUBAGAN, KARANGASEM, KARANGASEM, BALI",16,121,8,129
https://kawalpemilu.org#53760,"SUBAGAN, KARANGASEM, KARANGASEM, BALI",17,181,6,187
https://kawalpemilu.org#53760,"SUBAGAN, KARANGASEM, KARANGASEM, BALI",18,173,7,180
https://kawalpemilu.org#53760,"SUBAGAN, KARANGASEM, KARANGASEM, BALI",19,115,6,121
https://kawalpemilu.org#53760,"SUBAGAN, KARANGASEM, KARANGASEM, BALI",20,197,21,218
https://kawalpemilu.org#53760,"SUBAGAN, KARANGASEM, KARANGASEM, BALI",21,240,4,244
https://kawalpemilu.org#53760,"SUBAGAN, KARANGASEM, KARANGASEM, BALI",22,158,4,162
https://kawalpemilu.org#53760,"SUBAGAN, KARANGASEM, KARANGASEM, BALI",23,176,16,192
https://kawalpemilu.org#53760,"SUBAGAN, KARANGASEM, KARANGASEM, BALI",24,188,36,224
https://kawalpemilu.org#53760,"SUBAGAN, KARANGASEM, KARANGASEM, BALI",25,201,9,210
https://kawalpemilu.org#53760,"SUBAGAN, KARANGASEM, KARANGASEM, BALI",26,204,3,207
https://kawalpemilu.org#53760,"SUBAGAN, KARANGASEM, KARANGASEM, BALI",27,238,11,249
https://kawalpemilu.org#53760,"SUBAGAN, KARANGASEM, KARANGASEM, BALI",28,160,16,176
https://kawalpemilu.org#53760,"SUBAGAN, KARANGASEM, KARANGASEM, BALI",29,135,6,141
https://kawalpemilu.org#53760,"SUBAGAN, KARANGASEM, KARANGASEM, BALI",30,147,15,162
https://kawalpemilu.org#53760,"SUBAGAN, KARANGASEM, KARANGASEM, BALI",31,182,5,187
https://kawalpemilu.org#53760,"SUBAGAN, KARANGASEM, KARANGASEM, BALI",32,171,20,191
https://kawalpemilu.org#53760,"SUBAGAN, KARANGASEM, KARANGASEM, BALI",33,152,14,166
https://kawalpemilu.org#53760,"SUBAGAN, KARANGASEM, KARANGASEM, BALI",34,206,6,212
https://kawalpemilu.org#53760,"SUBAGAN, KARANGASEM, KARANGASEM, BALI",35,143,4,147
https://kawalpemilu.org#53760,"SUBAGAN, KARANGASEM, KARANGASEM, BALI",36,138,4,142
https://kawalpemilu.org#53760,"SUBAGAN, KARANGASEM, KARANGASEM, BALI",37,148,76,224
https://kawalpemilu.org#53760,"SUBAGAN, KARANGASEM, KARANGASEM, BALI",38,21,161,182
https://kawalpemilu.org#53760,"SUBAGAN, KARANGASEM, KARANGASEM, BALI",39,20,166,186
https://kawalpemilu.org#53760,"SUBAGAN, KARANGASEM, KARANGASEM, BALI",40,32,125,157
https://kawalpemilu.org#53760,"SUBAGAN, KARANGASEM, KARANGASEM, BALI",41,55,108,163
https://kawalpemilu.org#53760,"SUBAGAN, KARANGASEM, KARANGASEM, BALI",42,64,109,173
https://kawalpemilu.org#53760,"SUBAGAN, KARANGASEM, KARANGASEM, BALI",43,53,84,137
https://kawalpemilu.org#53760,"SUBAGAN, KARANGASEM, KARANGASEM, BALI",44,66,128,194
https://kawalpemilu.org#53760,"SUBAGAN, KARANGASEM, KARANGASEM, BALI",45,73,111,184
https://kawalpemilu.org#53760,"SUBAGAN, KARANGASEM, KARANGASEM, BALI",46,47,132,179
https://kawalpemilu.org#53760,"SUBAGAN, KARANGASEM, KARANGASEM, BALI",47,146,18,164
https://kawalpemilu.org#53760,"SUBAGAN, KARANGASEM, KARANGASEM, BALI",48,165,29,194
https://kawalpemilu.org#53760,"SUBAGAN, KARANGASEM, KARANGASEM, BALI",49,134,9,143
https://kawalpemilu.org#53760,"SUBAGAN, KARANGASEM, KARANGASEM, BALI",50,142,16,158
https://kawalpemilu.org#53760,"SUBAGAN, KARANGASEM, KARANGASEM, BALI",51,141,15,156
https://kawalpemilu.org#53760,"SUBAGAN, KARANGASEM, KARANGASEM, BALI",52,149,15,164
https://kawalpemilu.org#53760,"SUBAGAN, KARANGASEM, KARANGASEM, BALI",53,158,20,178
https://kawalpemilu.org#53760,"SUBAGAN, KARANGASEM, KARANGASEM, BALI",54,183,17,200
https://kawalpemilu.org#53760,"SUBAGAN, KARANGASEM, KARANGASEM, BALI",55,206,4,210
https://kawalpemilu.org#53760,"SUBAGAN, KARANGASEM, KARANGASEM, BALI",56,116,4,120
https://kawalpemilu.org#53760,"SUBAGAN, KARANGASEM, KARANGASEM, BALI",57,111,5,116
https://kawalpemilu.org#53761,"PADANG KERTA, KARANGASEM, KARANGASEM, BALI",1,127,4,131
https://kawalpemilu.org#53761,"PADANG KERTA, KARANGASEM, KARANGASEM, BALI",2,118,5,123
https://kawalpemilu.org#53761,"PADANG KERTA, KARANGASEM, KARANGASEM, BALI",3,159,2,161
https://kawalpemilu.org#53761,"PADANG KERTA, KARANGASEM, KARANGASEM, BALI",4,129,3,132
https://kawalpemilu.org#53761,"PADANG KERTA, KARANGASEM, KARANGASEM, BALI",5,212,2,214
https://kawalpemilu.org#53761,"PADANG KERTA, KARANGASEM, KARANGASEM, BALI",6,111,8,119
https://kawalpemilu.org#53761,"PADANG KERTA, KARANGASEM, KARANGASEM, BALI",7,108,15,123
https://kawalpemilu.org#53761,"PADANG KERTA, KARANGASEM, KARANGASEM, BALI",8,213,3,216
https://kawalpemilu.org#53761,"PADANG KERTA, KARANGASEM, KARANGASEM, BALI",9,139,12,151
https://kawalpemilu.org#53761,"PADANG KERTA, KARANGASEM, KARANGASEM, BALI",10,125,12,137
https://kawalpemilu.org#53761,"PADANG KERTA, KARANGASEM, KARANGASEM, BALI",11,174,7,181
https://kawalpemilu.org#53761,"PADANG KERTA, KARANGASEM, KARANGASEM, BALI",12,145,12,157
https://kawalpemilu.org#53761,"PADANG KERTA, KARANGASEM, KARANGASEM, BALI",13,152,15,167
https://kawalpemilu.org#53761,"PADANG KERTA, KARANGASEM, KARANGASEM, BALI",14,166,3,169
https://kawalpemilu.org#53761,"PADANG KERTA, KARANGASEM, KARANGASEM, BALI",15,133,13,146
https://kawalpemilu.org#53761,"PADANG KERTA, KARANGASEM, KARANGASEM, BALI",16,140,3,143
https://kawalpemilu.org#53761,"PADANG KERTA, KARANGASEM, KARANGASEM, BALI",17,153,4,157
https://kawalpemilu.org#53761,"PADANG KERTA, KARANGASEM, KARANGASEM, BALI",18,138,4,142
https://kawalpemilu.org#53761,"PADANG KERTA, KARANGASEM, KARANGASEM, BALI",19,210,13,223
https://kawalpemilu.org#53761,"PADANG KERTA, KARANGASEM, KARANGASEM, BALI",20,195,11,206
https://kawalpemilu.org#53761,"PADANG KERTA, KARANGASEM, KARANGASEM, BALI",21,184,7,191
https://kawalpemilu.org#53761,"PADANG KERTA, KARANGASEM, KARANGASEM, BALI",22,188,7,195
https://kawalpemilu.org#53761,"PADANG KERTA, KARANGASEM, KARANGASEM, BALI",23,173,28,201
https://kawalpemilu.org#53761,"PADANG KERTA, KARANGASEM, KARANGASEM, BALI",24,118,11,129
https://kawalpemilu.org#53761,"PADANG KERTA, KARANGASEM, KARANGASEM, BALI",25,151,13,164
https://kawalpemilu.org#53761,"PADANG KERTA, KARANGASEM, KARANGASEM, BALI",26,88,31,119
https://kawalpemilu.org#53761,"PADANG KERTA, KARANGASEM, KARANGASEM, BALI",27,125,18,143
https://kawalpemilu.org#53761,"PADANG KERTA, KARANGASEM, KARANGASEM, BALI",28,167,4,171
https://kawalpemilu.org#53761,"PADANG KERTA, KARANGASEM, KARANGASEM, BALI",29,194,4,198
https://kawalpemilu.org#53761,"PADANG KERTA, KARANGASEM, KARANGASEM, BALI",30,156,21,177
https://kawalpemilu.org#53761,"PADANG KERTA, KARANGASEM, KARANGASEM, BALI",31,107,11,118
https://kawalpemilu.org#53761,"PADANG KERTA, KARANGASEM, KARANGASEM, BALI",32,116,10,126
https://kawalpemilu.org#53761,"PADANG KERTA, KARANGASEM, KARANGASEM, BALI",33,148,8,156
https://kawalpemilu.org#53761,"PADANG KERTA, KARANGASEM, KARANGASEM, BALI",34,69,3,72
https://kawalpemilu.org#53762,"KARANG ASEM, KARANGASEM, KARANGASEM, BALI",1,185,17,202
https://kawalpemilu.org#53762,"KARANG ASEM, KARANGASEM, KARANGASEM, BALI",2,189,8,197
https://kawalpemilu.org#53762,"KARANG ASEM, KARANGASEM, KARANGASEM, BALI",3,116,0,116
https://kawalpemilu.org#53762,"KARANG ASEM, KARANGASEM, KARANGASEM, BALI",4,105,5,110
https://kawalpemilu.org#53762,"KARANG ASEM, KARANGASEM, KARANGASEM, BALI",5,64,195,259
https://kawalpemilu.org#53762,"KARANG ASEM, KARANGASEM, KARANGASEM, BALI",6,240,11,251
https://kawalpemilu.org#53762,"KARANG ASEM, KARANGASEM, KARANGASEM, BALI",7,176,64,240
https://kawalpemilu.org#53762,"KARANG ASEM, KARANGASEM, KARANGASEM, BALI",8,223,25,248
https://kawalpemilu.org#53762,"KARANG ASEM, KARANGASEM, KARANGASEM, BALI",9,210,4,214
https://kawalpemilu.org#53762,"KARANG ASEM, KARANGASEM, KARANGASEM, BALI",10,167,2,169
https://kawalpemilu.org#53762,"KARANG ASEM, KARANGASEM, KARANGASEM, BALI",11,179,52,231
https://kawalpemilu.org#53762,"KARANG ASEM, KARANGASEM, KARANGASEM, BALI",12,192,45,237
https://kawalpemilu.org#53762,"KARANG ASEM, KARANGASEM, KARANGASEM, BALI",13,210,14,224
https://kawalpemilu.org#53762,"KARANG ASEM, KARANGASEM, KARANGASEM, BALI",14,224,7,231
https://kawalpemilu.org#53762,"KARANG ASEM, KARANGASEM, KARANGASEM, BALI",15,211,48,259
https://kawalpemilu.org#53762,"KARANG ASEM, KARANGASEM, KARANGASEM, BALI",16,157,102,259
https://kawalpemilu.org#53762,"KARANG ASEM, KARANGASEM, KARANGASEM, BALI",17,239,12,251
https://kawalpemilu.org#53762,"KARANG ASEM, KARANGASEM, KARANGASEM, BALI",18,239,6,245
https://kawalpemilu.org#53762,"KARANG ASEM, KARANGASEM, KARANGASEM, BALI",19,148,18,166
https://kawalpemilu.org#53762,"KARANG ASEM, KARANGASEM, KARANGASEM, BALI",20,153,10,163
https://kawalpemilu.org#53762,"KARANG ASEM, KARANGASEM, KARANGASEM, BALI",21,252,9,261
https://kawalpemilu.org#53762,"KARANG ASEM, KARANGASEM, KARANGASEM, BALI",22,48,193,241
https://kawalpemilu.org#53762,"KARANG ASEM, KARANGASEM, KARANGASEM, BALI",23,42,195,237
https://kawalpemilu.org#53762,"KARANG ASEM, KARANGASEM, KARANGASEM, BALI",24,54,139,193
https://kawalpemilu.org#53762,"KARANG ASEM, KARANGASEM, KARANGASEM, BALI",25,38,167,205
https://kawalpemilu.org#53762,"KARANG ASEM, KARANGASEM, KARANGASEM, BALI",26,204,32,236
https://kawalpemilu.org#53762,"KARANG ASEM, KARANGASEM, KARANGASEM, BALI",27,212,4,216
https://kawalpemilu.org#53762,"KARANG ASEM, KARANGASEM, KARANGASEM, BALI",28,212,5,217
https://kawalpemilu.org#53762,"KARANG ASEM, KARANGASEM, KARANGASEM, BALI",29,231,7,238
https://kawalpemilu.org#53762,"KARANG ASEM, KARANGASEM, KARANGASEM, BALI",30,131,3,134
https://kawalpemilu.org#53762,"KARANG ASEM, KARANGASEM, KARANGASEM, BALI",31,207,4,211
https://kawalpemilu.org#53762,"KARANG ASEM, KARANGASEM, KARANGASEM, BALI",32,57,165,222
https://kawalpemilu.org#53762,"KARANG ASEM, KARANGASEM, KARANGASEM, BALI",33,79,137,216
https://kawalpemilu.org#53762,"KARANG ASEM, KARANGASEM, KARANGASEM, BALI",34,73,135,208
https://kawalpemilu.org#53762,"KARANG ASEM, KARANGASEM, KARANGASEM, BALI",35,56,144,200
https://kawalpemilu.org#53762,"KARANG ASEM, KARANGASEM, KARANGASEM, BALI",36,195,24,219
https://kawalpemilu.org#53762,"KARANG ASEM, KARANGASEM, KARANGASEM, BALI",37,194,17,211
https://kawalpemilu.org#53762,"KARANG ASEM, KARANGASEM, KARANGASEM, BALI",38,148,10,158
https://kawalpemilu.org#53762,"KARANG ASEM, KARANGASEM, KARANGASEM, BALI",39,146,11,157
https://kawalpemilu.org#53762,"KARANG ASEM, KARANGASEM, KARANGASEM, BALI",40,12,247,259
https://kawalpemilu.org#53762,"KARANG ASEM, KARANGASEM, KARANGASEM, BALI",41,32,233,265
https://kawalpemilu.org#53762,"KARANG ASEM, KARANGASEM, KARANGASEM, BALI",42,210,6,216
https://kawalpemilu.org#53762,"KARANG ASEM, KARANGASEM, KARANGASEM, BALI",43,52,111,163
https://kawalpemilu.org#53762,"KARANG ASEM, KARANGASEM, KARANGASEM, BALI",44,152,6,158
https://kawalpemilu.org#53762,"KARANG ASEM, KARANGASEM, KARANGASEM, BALI",45,28,164,192
https://kawalpemilu.org#53762,"KARANG ASEM, KARANGASEM, KARANGASEM, BALI",46,232,8,240
https://kawalpemilu.org#53762,"KARANG ASEM, KARANGASEM, KARANGASEM, BALI",47,135,4,139
https://kawalpemilu.org#53762,"KARANG ASEM, KARANGASEM, KARANGASEM, BALI",48,140,2,142
https://kawalpemilu.org#53762,"KARANG ASEM, KARANGASEM, KARANGASEM, BALI",49,71,76,147
https://kawalpemilu.org#53762,"KARANG ASEM, KARANGASEM, KARANGASEM, BALI",50,10,246,256
https://kawalpemilu.org#53762,"KARANG ASEM, KARANGASEM, KARANGASEM, BALI",51,140,27,167
https://kawalpemilu.org#53762,"KARANG ASEM, KARANGASEM, KARANGASEM, BALI",52,191,58,249
https://kawalpemilu.org#53762,"KARANG ASEM, KARANGASEM, KARANGASEM, BALI",53,158,7,165
https://kawalpemilu.org#53762,"KARANG ASEM, KARANGASEM, KARANGASEM, BALI",54,171,4,175
https://kawalpemilu.org#53762,"KARANG ASEM, KARANGASEM, KARANGASEM, BALI",55,141,7,148
https://kawalpemilu.org#53762,"KARANG ASEM, KARANGASEM, KARANGASEM, BALI",56,176,17,193
https://kawalpemilu.org#53762,"KARANG ASEM, KARANGASEM, KARANGASEM, BALI",57,185,12,197
https://kawalpemilu.org#53762,"KARANG ASEM, KARANGASEM, KARANGASEM, BALI",58,79,46,125
https://kawalpemilu.org#53763,"BUGBUG, KARANGASEM, KARANGASEM, BALI",1,181,2,183
https://kawalpemilu.org#53763,"BUGBUG, KARANGASEM, KARANGASEM, BALI",2,176,7,183
https://kawalpemilu.org#53763,"BUGBUG, KARANGASEM, KARANGASEM, BALI",3,123,4,127
https://kawalpemilu.org#53763,"BUGBUG, KARANGASEM, KARANGASEM, BALI",4,137,3,140
https://kawalpemilu.org#53763,"BUGBUG, KARANGASEM, KARANGASEM, BALI",5,144,3,147
https://kawalpemilu.org#53763,"BUGBUG, KARANGASEM, KARANGASEM, BALI",6,110,2,112
https://kawalpemilu.org#53763,"BUGBUG, KARANGASEM, KARANGASEM, BALI",7,120,1,121
https://kawalpemilu.org#53763,"BUGBUG, KARANGASEM, KARANGASEM, BALI",8,100,2,102
https://kawalpemilu.org#53763,"BUGBUG, KARANGASEM, KARANGASEM, BALI",9,188,2,190
https://kawalpemilu.org#53763,"BUGBUG, KARANGASEM, KARANGASEM, BALI",10,81,1,82
https://kawalpemilu.org#53763,"BUGBUG, KARANGASEM, KARANGASEM, BALI",11,160,4,164
https://kawalpemilu.org#53763,"BUGBUG, KARANGASEM, KARANGASEM, BALI",12,232,2,235
https://kawalpemilu.org#53763,"BUGBUG, KARANGASEM, KARANGASEM, BALI",13,227,2,229
https://kawalpemilu.org#53763,"BUGBUG, KARANGASEM, KARANGASEM, BALI",14,258,3,261
https://kawalpemilu.org#53763,"BUGBUG, KARANGASEM, KARANGASEM, BALI",15,230,3,233
https://kawalpemilu.org#53763,"BUGBUG, KARANGASEM, KARANGASEM, BALI",16,151,1,152
https://kawalpemilu.org#53763,"BUGBUG, KARANGASEM, KARANGASEM, BALI",17,143,3,146
https://kawalpemilu.org#53763,"BUGBUG, KARANGASEM, KARANGASEM, BALI",18,247,5,252
https://kawalpemilu.org#53763,"BUGBUG, KARANGASEM, KARANGASEM, BALI",19,235,7,242
https://kawalpemilu.org#53763,"BUGBUG, KARANGASEM, KARANGASEM, BALI",20,194,9,203
https://kawalpemilu.org#53763,"BUGBUG, KARANGASEM, KARANGASEM, BALI",21,205,1,206
https://kawalpemilu.org#53763,"BUGBUG, KARANGASEM, KARANGASEM, BALI",22,179,1,180
https://kawalpemilu.org#53763,"BUGBUG, KARANGASEM, KARANGASEM, BALI",23,173,6,179
https://kawalpemilu.org#53763,"BUGBUG, KARANGASEM, KARANGASEM, BALI",24,211,1,212
https://kawalpemilu.org#53763,"BUGBUG, KARANGASEM, KARANGASEM, BALI",25,179,1,180
https://kawalpemilu.org#53763,"BUGBUG, KARANGASEM, KARANGASEM, BALI",26,172,1,173
https://kawalpemilu.org#53763,"BUGBUG, KARANGASEM, KARANGASEM, BALI",27,172,1,173
https://kawalpemilu.org#53763,"BUGBUG, KARANGASEM, KARANGASEM, BALI",28,140,1,141
https://kawalpemilu.org#53763,"BUGBUG, KARANGASEM, KARANGASEM, BALI",29,118,2,120
https://kawalpemilu.org#53763,"BUGBUG, KARANGASEM, KARANGASEM, BALI",30,204,1,205
https://kawalpemilu.org#53763,"BUGBUG, KARANGASEM, KARANGASEM, BALI",31,182,2,184
https://kawalpemilu.org#53763,"BUGBUG, KARANGASEM, KARANGASEM, BALI",32,183,1,184
https://kawalpemilu.org#53763,"BUGBUG, KARANGASEM, KARANGASEM, BALI",33,168,3,171
https://kawalpemilu.org#53763,"BUGBUG, KARANGASEM, KARANGASEM, BALI",34,206,0,206
https://kawalpemilu.org#53763,"BUGBUG, KARANGASEM, KARANGASEM, BALI",35,139,1,140
https://kawalpemilu.org#53763,"BUGBUG, KARANGASEM, KARANGASEM, BALI",36,113,1,114
https://kawalpemilu.org#53763,"BUGBUG, KARANGASEM, KARANGASEM, BALI",37,134,1,135
https://kawalpemilu.org#53763,"BUGBUG, KARANGASEM, KARANGASEM, BALI",38,131,1,132
https://kawalpemilu.org#53764,"TUMBU, KARANGASEM, KARANGASEM, BALI",1,171,11,182
https://kawalpemilu.org#53764,"TUMBU, KARANGASEM, KARANGASEM, BALI",2,159,11,170
https://kawalpemilu.org#53764,"TUMBU, KARANGASEM, KARANGASEM, BALI",3,180,6,186
https://kawalpemilu.org#53764,"TUMBU, KARANGASEM, KARANGASEM, BALI",4,177,4,181
https://kawalpemilu.org#53764,"TUMBU, KARANGASEM, KARANGASEM, BALI",5,150,15,165
https://kawalpemilu.org#53764,"TUMBU, KARANGASEM, KARANGASEM, BALI",6,161,12,173
https://kawalpemilu.org#53764,"TUMBU, KARANGASEM, KARANGASEM, BALI",7,140,7,147
https://kawalpemilu.org#53764,"TUMBU, KARANGASEM, KARANGASEM, BALI",8,95,2,97
https://kawalpemilu.org#53764,"TUMBU, KARANGASEM, KARANGASEM, BALI",9,157,0,157
https://kawalpemilu.org#53764,"TUMBU, KARANGASEM, KARANGASEM, BALI",10,166,1,167
https://kawalpemilu.org#53764,"TUMBU, KARANGASEM, KARANGASEM, BALI",11,184,2,186
https://kawalpemilu.org#53764,"TUMBU, KARANGASEM, KARANGASEM, BALI",12,182,1,183
https://kawalpemilu.org#53764,"TUMBU, KARANGASEM, KARANGASEM, BALI",13,33,163,196
https://kawalpemilu.org#53764,"TUMBU, KARANGASEM, KARANGASEM, BALI",14,26,161,187
https://kawalpemilu.org#53764,"TUMBU, KARANGASEM, KARANGASEM, BALI",15,22,168,190
https://kawalpemilu.org#53765,"SERAYA, KARANGASEM, KARANGASEM, BALI",1,169,6,175
https://kawalpemilu.org#53765,"SERAYA, KARANGASEM, KARANGASEM, BALI",2,177,5,182
https://kawalpemilu.org#53765,"SERAYA, KARANGASEM, KARANGASEM, BALI",3,205,4,209
https://kawalpemilu.org#53765,"SERAYA, KARANGASEM, KARANGASEM, BALI",4,0,0,0
https://kawalpemilu.org#53765,"SERAYA, KARANGASEM, KARANGASEM, BALI",5,202,0,202
https://kawalpemilu.org#53765,"SERAYA, KARANGASEM, KARANGASEM, BALI",6,186,3,189
https://kawalpemilu.org#53765,"SERAYA, KARANGASEM, KARANGASEM, BALI",7,144,3,147
https://kawalpemilu.org#53765,"SERAYA, KARANGASEM, KARANGASEM, BALI",8,155,5,160
https://kawalpemilu.org#53765,"SERAYA, KARANGASEM, KARANGASEM, BALI",9,128,2,130
https://kawalpemilu.org#53765,"SERAYA, KARANGASEM, KARANGASEM, BALI",10,152,14,166
https://kawalpemilu.org#53765,"SERAYA, KARANGASEM, KARANGASEM, BALI",11,141,12,153
https://kawalpemilu.org#53765,"SERAYA, KARANGASEM, KARANGASEM, BALI",12,129,4,133
https://kawalpemilu.org#53765,"SERAYA, KARANGASEM, KARANGASEM, BALI",13,149,2,151
https://kawalpemilu.org#53765,"SERAYA, KARANGASEM, KARANGASEM, BALI",14,157,1,158
https://kawalpemilu.org#53765,"SERAYA, KARANGASEM, KARANGASEM, BALI",15,155,3,158
https://kawalpemilu.org#53765,"SERAYA, KARANGASEM, KARANGASEM, BALI",16,169,12,181
https://kawalpemilu.org#53765,"SERAYA, KARANGASEM, KARANGASEM, BALI",17,179,4,183
https://kawalpemilu.org#53765,"SERAYA, KARANGASEM, KARANGASEM, BALI",18,146,4,150
https://kawalpemilu.org#53765,"SERAYA, KARANGASEM, KARANGASEM, BALI",19,134,3,137
https://kawalpemilu.org#53765,"SERAYA, KARANGASEM, KARANGASEM, BALI",20,164,3,167
https://kawalpemilu.org#53765,"SERAYA, KARANGASEM, KARANGASEM, BALI",21,169,3,172
https://kawalpemilu.org#53765,"SERAYA, KARANGASEM, KARANGASEM, BALI",23,146,8,154
https://kawalpemilu.org#53765,"SERAYA, KARANGASEM, KARANGASEM, BALI",24,155,1,156
https://kawalpemilu.org#53765,"SERAYA, KARANGASEM, KARANGASEM, BALI",25,149,4,153
https://kawalpemilu.org#53765,"SERAYA, KARANGASEM, KARANGASEM, BALI",26,132,6,138
https://kawalpemilu.org#53765,"SERAYA, KARANGASEM, KARANGASEM, BALI",27,125,7,132
https://kawalpemilu.org#53765,"SERAYA, KARANGASEM, KARANGASEM, BALI",28,146,4,150
https://kawalpemilu.org#53765,"SERAYA, KARANGASEM, KARANGASEM, BALI",29,171,4,175
https://kawalpemilu.org#53765,"SERAYA, KARANGASEM, KARANGASEM, BALI",30,174,5,179
https://kawalpemilu.org#53765,"SERAYA, KARANGASEM, KARANGASEM, BALI",31,126,4,130
https://kawalpemilu.org#53765,"SERAYA, KARANGASEM, KARANGASEM, BALI",32,155,5,160
https://kawalpemilu.org#53765,"SERAYA, KARANGASEM, KARANGASEM, BALI",33,144,3,147
https://kawalpemilu.org#53765,"SERAYA, KARANGASEM, KARANGASEM, BALI",34,156,6,162
https://kawalpemilu.org#53765,"SERAYA, KARANGASEM, KARANGASEM, BALI",35,155,2,157
https://kawalpemilu.org#53765,"SERAYA, KARANGASEM, KARANGASEM, BALI",36,131,2,133
https://kawalpemilu.org#53765,"SERAYA, KARANGASEM, KARANGASEM, BALI",37,135,2,137
https://kawalpemilu.org#53765,"SERAYA, KARANGASEM, KARANGASEM, BALI",38,135,2,137
https://kawalpemilu.org#53765,"SERAYA, KARANGASEM, KARANGASEM, BALI",39,126,3,129
https://kawalpemilu.org#53766,"SERAYA BARAT, KARANGASEM, KARANGASEM, BALI",1,137,8,145
https://kawalpemilu.org#53766,"SERAYA BARAT, KARANGASEM, KARANGASEM, BALI",2,153,5,158
https://kawalpemilu.org#53766,"SERAYA BARAT, KARANGASEM, KARANGASEM, BALI",3,203,6,209
https://kawalpemilu.org#53766,"SERAYA BARAT, KARANGASEM, KARANGASEM, BALI",4,193,4,197
https://kawalpemilu.org#53766,"SERAYA BARAT, KARANGASEM, KARANGASEM, BALI",5,189,4,193
https://kawalpemilu.org#53766,"SERAYA BARAT, KARANGASEM, KARANGASEM, BALI",6,168,3,171
https://kawalpemilu.org#53766,"SERAYA BARAT, KARANGASEM, KARANGASEM, BALI",7,147,5,152
https://kawalpemilu.org#53766,"SERAYA BARAT, KARANGASEM, KARANGASEM, BALI",8,171,7,178
https://kawalpemilu.org#53766,"SERAYA BARAT, KARANGASEM, KARANGASEM, BALI",9,161,5,166
https://kawalpemilu.org#53766,"SERAYA BARAT, KARANGASEM, KARANGASEM, BALI",10,133,5,138
https://kawalpemilu.org#53766,"SERAYA BARAT, KARANGASEM, KARANGASEM, BALI",11,145,5,150
https://kawalpemilu.org#53766,"SERAYA BARAT, KARANGASEM, KARANGASEM, BALI",12,154,2,156
https://kawalpemilu.org#53766,"SERAYA BARAT, KARANGASEM, KARANGASEM, BALI",13,152,1,153
https://kawalpemilu.org#53766,"SERAYA BARAT, KARANGASEM, KARANGASEM, BALI",14,234,7,241
https://kawalpemilu.org#53766,"SERAYA BARAT, KARANGASEM, KARANGASEM, BALI",15,170,3,173
https://kawalpemilu.org#53766,"SERAYA BARAT, KARANGASEM, KARANGASEM, BALI",16,169,3,172
https://kawalpemilu.org#53766,"SERAYA BARAT, KARANGASEM, KARANGASEM, BALI",17,171,2,173
https://kawalpemilu.org#53766,"SERAYA BARAT, KARANGASEM, KARANGASEM, BALI",18,186,8,194
https://kawalpemilu.org#53766,"SERAYA BARAT, KARANGASEM, KARANGASEM, BALI",19,201,8,209
https://kawalpemilu.org#53766,"SERAYA BARAT, KARANGASEM, KARANGASEM, BALI",20,157,3,160
https://kawalpemilu.org#53766,"SERAYA BARAT, KARANGASEM, KARANGASEM, BALI",21,176,2,178
https://kawalpemilu.org#53767,"SERAYA TIMUR, KARANGASEM, KARANGASEM, BALI",1,164,1,165
https://kawalpemilu.org#53767,"SERAYA TIMUR, KARANGASEM, KARANGASEM, BALI",2,265,2,267
https://kawalpemilu.org#53767,"SERAYA TIMUR, KARANGASEM, KARANGASEM, BALI",3,267,2,269
https://kawalpemilu.org#53767,"SERAYA TIMUR, KARANGASEM, KARANGASEM, BALI",4,235,0,235
https://kawalpemilu.org#53767,"SERAYA TIMUR, KARANGASEM, KARANGASEM, BALI",5,228,1,229
https://kawalpemilu.org#53767,"SERAYA TIMUR, KARANGASEM, KARANGASEM, BALI",6,220,1,221
https://kawalpemilu.org#53767,"SERAYA TIMUR, KARANGASEM, KARANGASEM, BALI",7,163,6,169
https://kawalpemilu.org#53767,"SERAYA TIMUR, KARANGASEM, KARANGASEM, BALI",8,179,8,187
https://kawalpemilu.org#53767,"SERAYA TIMUR, KARANGASEM, KARANGASEM, BALI",9,168,7,175
https://kawalpemilu.org#53767,"SERAYA TIMUR, KARANGASEM, KARANGASEM, BALI",10,179,1,180
https://kawalpemilu.org#53767,"SERAYA TIMUR, KARANGASEM, KARANGASEM, BALI",11,197,2,199
https://kawalpemilu.org#53767,"SERAYA TIMUR, KARANGASEM, KARANGASEM, BALI",12,255,10,265
https://kawalpemilu.org#53767,"SERAYA TIMUR, KARANGASEM, KARANGASEM, BALI",13,249,5,254
https://kawalpemilu.org#53767,"SERAYA TIMUR, KARANGASEM, KARANGASEM, BALI",14,258,3,261
https://kawalpemilu.org#53767,"SERAYA TIMUR, KARANGASEM, KARANGASEM, BALI",15,220,2,222
https://kawalpemilu.org#53767,"SERAYA TIMUR, KARANGASEM, KARANGASEM, BALI",16,202,9,211
https://kawalpemilu.org#53767,"SERAYA TIMUR, KARANGASEM, KARANGASEM, BALI",17,168,3,171
https://kawalpemilu.org#53767,"SERAYA TIMUR, KARANGASEM, KARANGASEM, BALI",18,122,5,127
https://kawalpemilu.org#53767,"SERAYA TIMUR, KARANGASEM, KARANGASEM, BALI",19,167,11,178
https://kawalpemilu.org#53767,"SERAYA TIMUR, KARANGASEM, KARANGASEM, BALI",20,173,14,187
https://kawalpemilu.org#53767,"SERAYA TIMUR, KARANGASEM, KARANGASEM, BALI",21,174,10,184
https://kawalpemilu.org#53767,"SERAYA TIMUR, KARANGASEM, KARANGASEM, BALI",22,184,8,192
https://kawalpemilu.org#53767,"SERAYA TIMUR, KARANGASEM, KARANGASEM, BALI",23,171,18,189
https://kawalpemilu.org#53768,"PERTIMA, KARANGASEM, KARANGASEM, BALI",1,137,18,155
https://kawalpemilu.org#53768,"PERTIMA, KARANGASEM, KARANGASEM, BALI",2,156,17,173
https://kawalpemilu.org#53768,"PERTIMA, KARANGASEM, KARANGASEM, BALI",3,139,20,159
https://kawalpemilu.org#53768,"PERTIMA, KARANGASEM, KARANGASEM, BALI",4,166,9,175
https://kawalpemilu.org#53768,"PERTIMA, KARANGASEM, KARANGASEM, BALI",5,174,3,177
https://kawalpemilu.org#53768,"PERTIMA, KARANGASEM, KARANGASEM, BALI",6,172,0,172
https://kawalpemilu.org#53768,"PERTIMA, KARANGASEM, KARANGASEM, BALI",7,169,7,176
https://kawalpemilu.org#53768,"PERTIMA, KARANGASEM, KARANGASEM, BALI",8,198,9,207
https://kawalpemilu.org#53768,"PERTIMA, KARANGASEM, KARANGASEM, BALI",9,135,4,139
https://kawalpemilu.org#53768,"PERTIMA, KARANGASEM, KARANGASEM, BALI",10,148,11,159
https://kawalpemilu.org#53768,"PERTIMA, KARANGASEM, KARANGASEM, BALI",11,161,9,170
https://kawalpemilu.org#53768,"PERTIMA, KARANGASEM, KARANGASEM, BALI",12,145,9,154
https://kawalpemilu.org#53768,"PERTIMA, KARANGASEM, KARANGASEM, BALI",13,153,3,156
https://kawalpemilu.org#53768,"PERTIMA, KARANGASEM, KARANGASEM, BALI",14,135,4,139
https://kawalpemilu.org#53768,"PERTIMA, KARANGASEM, KARANGASEM, BALI",15,99,11,110
https://kawalpemilu.org#53768,"PERTIMA, KARANGASEM, KARANGASEM, BALI",16,104,0,104
https://kawalpemilu.org#53768,"PERTIMA, KARANGASEM, KARANGASEM, BALI",17,155,11,166
https://kawalpemilu.org#53768,"PERTIMA, KARANGASEM, KARANGASEM, BALI",18,184,1,185
https://kawalpemilu.org#53768,"PERTIMA, KARANGASEM, KARANGASEM, BALI",19,104,8,112
https://kawalpemilu.org#53768,"PERTIMA, KARANGASEM, KARANGASEM, BALI",20,110,2,112
https://kawalpemilu.org#53768,"PERTIMA, KARANGASEM, KARANGASEM, BALI",21,137,14,151
https://kawalpemilu.org#53768,"PERTIMA, KARANGASEM, KARANGASEM, BALI",22,111,9,120
https://kawalpemilu.org#53768,"PERTIMA, KARANGASEM, KARANGASEM, BALI",23,112,8,120
https://kawalpemilu.org#53768,"PERTIMA, KARANGASEM, KARANGASEM, BALI",24,108,10,118
https://kawalpemilu.org#53768,"PERTIMA, KARANGASEM, KARANGASEM, BALI",25,177,17,194
https://kawalpemilu.org#53768,"PERTIMA, KARANGASEM, KARANGASEM, BALI",26,178,6,184
https://kawalpemilu.org#53769,"TEGALINGGAH, KARANGASEM, KARANGASEM, BALI",1,36,117,153
https://kawalpemilu.org#53769,"TEGALINGGAH, KARANGASEM, KARANGASEM, BALI",2,49,107,156
https://kawalpemilu.org#53769,"TEGALINGGAH, KARANGASEM, KARANGASEM, BALI",3,35,224,259
https://kawalpemilu.org#53769,"TEGALINGGAH, KARANGASEM, KARANGASEM, BALI",4,166,2,168
https://kawalpemilu.org#53769,"TEGALINGGAH, KARANGASEM, KARANGASEM, BALI",5,163,2,165
https://kawalpemilu.org#53769,"TEGALINGGAH, KARANGASEM, KARANGASEM, BALI",6,160,1,161
https://kawalpemilu.org#53769,"TEGALINGGAH, KARANGASEM, KARANGASEM, BALI",7,161,3,164
https://kawalpemilu.org#53769,"TEGALINGGAH, KARANGASEM, KARANGASEM, BALI",8,169,1,170
https://kawalpemilu.org#53769,"TEGALINGGAH, KARANGASEM, KARANGASEM, BALI",9,243,7,250
https://kawalpemilu.org#53769,"TEGALINGGAH, KARANGASEM, KARANGASEM, BALI",10,160,4,164
https://kawalpemilu.org#53769,"TEGALINGGAH, KARANGASEM, KARANGASEM, BALI",11,129,1,130
https://kawalpemilu.org#53770,"BUKIT, KARANGASEM, KARANGASEM, BALI",1,26,184,210
https://kawalpemilu.org#53770,"BUKIT, KARANGASEM, KARANGASEM, BALI",2,154,5,159
https://kawalpemilu.org#53770,"BUKIT, KARANGASEM, KARANGASEM, BALI",3,135,11,146
https://kawalpemilu.org#53770,"BUKIT, KARANGASEM, KARANGASEM, BALI",4,21,103,124
https://kawalpemilu.org#53770,"BUKIT, KARANGASEM, KARANGASEM, BALI",5,117,6,123
https://kawalpemilu.org#53770,"BUKIT, KARANGASEM, KARANGASEM, BALI",6,31,95,126
https://kawalpemilu.org#53770,"BUKIT, KARANGASEM, KARANGASEM, BALI",7,30,99,129
https://kawalpemilu.org#53770,"BUKIT, KARANGASEM, KARANGASEM, BALI",8,163,7,170
https://kawalpemilu.org#53770,"BUKIT, KARANGASEM, KARANGASEM, BALI",9,149,9,158
https://kawalpemilu.org#53770,"BUKIT, KARANGASEM, KARANGASEM, BALI",10,161,15,176
https://kawalpemilu.org#53770,"BUKIT, KARANGASEM, KARANGASEM, BALI",11,177,7,184
https://kawalpemilu.org#53770,"BUKIT, KARANGASEM, KARANGASEM, BALI",12,162,3,165
https://kawalpemilu.org#53770,"BUKIT, KARANGASEM, KARANGASEM, BALI",13,118,51,169
https://kawalpemilu.org#53770,"BUKIT, KARANGASEM, KARANGASEM, BALI",14,96,71,167
https://kawalpemilu.org#53770,"BUKIT, KARANGASEM, KARANGASEM, BALI",15,149,3,152
https://kawalpemilu.org#53770,"BUKIT, KARANGASEM, KARANGASEM, BALI",16,84,74,158
https://kawalpemilu.org#53770,"BUKIT, KARANGASEM, KARANGASEM, BALI",17,168,1,169
https://kawalpemilu.org#53770,"BUKIT, KARANGASEM, KARANGASEM, BALI",18,151,1,152
https://kawalpemilu.org#53770,"BUKIT, KARANGASEM, KARANGASEM, BALI",19,163,0,163
https://kawalpemilu.org#53772,"ABABI, ABANG, KARANGASEM, BALI",1,126,0,126
https://kawalpemilu.org#53772,"ABABI, ABANG, KARANGASEM, BALI",2,225,6,231
https://kawalpemilu.org#53772,"ABABI, ABANG, KARANGASEM, BALI",3,226,2,228
https://kawalpemilu.org#53772,"ABABI, ABANG, KARANGASEM, BALI",4,237,5,242
https://kawalpemilu.org#53772,"ABABI, ABANG, KARANGASEM, BALI",5,246,7,253
https://kawalpemilu.org#53772,"ABABI, ABANG, KARANGASEM, BALI",6,211,2,213
https://kawalpemilu.org#53772,"ABABI, ABANG, KARANGASEM, BALI",7,204,13,217
https://kawalpemilu.org#53772,"ABABI, ABANG, KARANGASEM, BALI",8,208,3,211
https://kawalpemilu.org#53772,"ABABI, ABANG, KARANGASEM, BALI",9,211,6,217
https://kawalpemilu.org#53772,"ABABI, ABANG, KARANGASEM, BALI",10,212,5,217
https://kawalpemilu.org#53772,"ABABI, ABANG, KARANGASEM, BALI",11,203,13,216
https://kawalpemilu.org#53772,"ABABI, ABANG, KARANGASEM, BALI",12,202,16,218
https://kawalpemilu.org#53772,"ABABI, ABANG, KARANGASEM, BALI",13,225,10,235
https://kawalpemilu.org#53772,"ABABI, ABANG, KARANGASEM, BALI",14,182,11,193
https://kawalpemilu.org#53772,"ABABI, ABANG, KARANGASEM, BALI",15,139,1,140
https://kawalpemilu.org#53772,"ABABI, ABANG, KARANGASEM, BALI",16,136,3,139
https://kawalpemilu.org#53772,"ABABI, ABANG, KARANGASEM, BALI",17,198,14,212
https://kawalpemilu.org#53772,"ABABI, ABANG, KARANGASEM, BALI",18,203,6,209
https://kawalpemilu.org#53772,"ABABI, ABANG, KARANGASEM, BALI",19,160,9,169
https://kawalpemilu.org#53772,"ABABI, ABANG, KARANGASEM, BALI",20,191,6,197
https://kawalpemilu.org#53772,"ABABI, ABANG, KARANGASEM, BALI",21,114,2,116
https://kawalpemilu.org#53772,"ABABI, ABANG, KARANGASEM, BALI",22,163,9,172
https://kawalpemilu.org#53772,"ABABI, ABANG, KARANGASEM, BALI",23,179,3,182
https://kawalpemilu.org#53772,"ABABI, ABANG, KARANGASEM, BALI",24,177,5,182
https://kawalpemilu.org#53772,"ABABI, ABANG, KARANGASEM, BALI",25,137,8,145
https://kawalpemilu.org#53772,"ABABI, ABANG, KARANGASEM, BALI",26,168,5,173
https://kawalpemilu.org#53772,"ABABI, ABANG, KARANGASEM, BALI",27,160,7,167
https://kawalpemilu.org#53772,"ABABI, ABANG, KARANGASEM, BALI",28,156,7,163
https://kawalpemilu.org#53772,"ABABI, ABANG, KARANGASEM, BALI",29,179,6,185
https://kawalpemilu.org#53772,"ABABI, ABANG, KARANGASEM, BALI",30,137,0,137
https://kawalpemilu.org#53772,"ABABI, ABANG, KARANGASEM, BALI",31,142,2,144
https://kawalpemilu.org#53773,"TIYING TALI, ABANG, KARANGASEM, BALI",1,228,0,228
https://kawalpemilu.org#53773,"TIYING TALI, ABANG, KARANGASEM, BALI",3,165,12,177
https://kawalpemilu.org#53773,"TIYING TALI, ABANG, KARANGASEM, BALI",4,140,14,154
https://kawalpemilu.org#53773,"TIYING TALI, ABANG, KARANGASEM, BALI",5,129,14,143
https://kawalpemilu.org#53773,"TIYING TALI, ABANG, KARANGASEM, BALI",6,237,10,247
https://kawalpemilu.org#53773,"TIYING TALI, ABANG, KARANGASEM, BALI",7,241,8,249
https://kawalpemilu.org#53773,"TIYING TALI, ABANG, KARANGASEM, BALI",8,232,5,237
https://kawalpemilu.org#53773,"TIYING TALI, ABANG, KARANGASEM, BALI",9,202,2,204
https://kawalpemilu.org#53773,"TIYING TALI, ABANG, KARANGASEM, BALI",10,112,5,117
https://kawalpemilu.org#53773,"TIYING TALI, ABANG, KARANGASEM, BALI",11,253,6,259
https://kawalpemilu.org#53773,"TIYING TALI, ABANG, KARANGASEM, BALI",12,204,4,208
https://kawalpemilu.org#53773,"TIYING TALI, ABANG, KARANGASEM, BALI",13,228,5,233
https://kawalpemilu.org#53773,"TIYING TALI, ABANG, KARANGASEM, BALI",14,69,21,90
https://kawalpemilu.org#53774,"BUNUTAN, ABANG, KARANGASEM, BALI",1,186,18,204
https://kawalpemilu.org#53774,"BUNUTAN, ABANG, KARANGASEM, BALI",2,163,21,184
https://kawalpemilu.org#53774,"BUNUTAN, ABANG, KARANGASEM, BALI",3,168,15,183
https://kawalpemilu.org#53774,"BUNUTAN, ABANG, KARANGASEM, BALI",4,158,25,183
https://kawalpemilu.org#53774,"BUNUTAN, ABANG, KARANGASEM, BALI",5,147,16,163
https://kawalpemilu.org#53774,"BUNUTAN, ABANG, KARANGASEM, BALI",6,197,6,203
https://kawalpemilu.org#53774,"BUNUTAN, ABANG, KARANGASEM, BALI",7,190,7,197
https://kawalpemilu.org#53774,"BUNUTAN, ABANG, KARANGASEM, BALI",8,177,7,184
https://kawalpemilu.org#53774,"BUNUTAN, ABANG, KARANGASEM, BALI",9,153,3,156
https://kawalpemilu.org#53774,"BUNUTAN, ABANG, KARANGASEM, BALI",10,186,4,190
https://kawalpemilu.org#53774,"BUNUTAN, ABANG, KARANGASEM, BALI",11,198,9,207
https://kawalpemilu.org#53774,"BUNUTAN, ABANG, KARANGASEM, BALI",12,164,5,169
https://kawalpemilu.org#53774,"BUNUTAN, ABANG, KARANGASEM, BALI",13,167,3,170
https://kawalpemilu.org#53774,"BUNUTAN, ABANG, KARANGASEM, BALI",14,170,11,181
https://kawalpemilu.org#53774,"BUNUTAN, ABANG, KARANGASEM, BALI",15,166,10,176
https://kawalpemilu.org#53774,"BUNUTAN, ABANG, KARANGASEM, BALI",17,152,5,157
https://kawalpemilu.org#53774,"BUNUTAN, ABANG, KARANGASEM, BALI",18,196,4,200
https://kawalpemilu.org#53774,"BUNUTAN, ABANG, KARANGASEM, BALI",19,122,5,127
https://kawalpemilu.org#53774,"BUNUTAN, ABANG, KARANGASEM, BALI",20,139,7,146
https://kawalpemilu.org#53774,"BUNUTAN, ABANG, KARANGASEM, BALI",21,178,7,185
https://kawalpemilu.org#53774,"BUNUTAN, ABANG, KARANGASEM, BALI",22,157,5,162
https://kawalpemilu.org#53774,"BUNUTAN, ABANG, KARANGASEM, BALI",23,129,8,137
https://kawalpemilu.org#53774,"BUNUTAN, ABANG, KARANGASEM, BALI",24,112,6,118
https://kawalpemilu.org#53774,"BUNUTAN, ABANG, KARANGASEM, BALI",25,153,8,161
https://kawalpemilu.org#53774,"BUNUTAN, ABANG, KARANGASEM, BALI",26,151,3,154
https://kawalpemilu.org#53774,"BUNUTAN, ABANG, KARANGASEM, BALI",27,200,14,214
https://kawalpemilu.org#53774,"BUNUTAN, ABANG, KARANGASEM, BALI",28,171,4,175
https://kawalpemilu.org#53774,"BUNUTAN, ABANG, KARANGASEM, BALI",29,161,4,165
https://kawalpemilu.org#53774,"BUNUTAN, ABANG, KARANGASEM, BALI",30,143,10,153
https://kawalpemilu.org#53774,"BUNUTAN, ABANG, KARANGASEM, BALI",31,112,11,123
https://kawalpemilu.org#53774,"BUNUTAN, ABANG, KARANGASEM, BALI",32,110,16,126
https://kawalpemilu.org#53774,"BUNUTAN, ABANG, KARANGASEM, BALI",33,161,19,180
https://kawalpemilu.org#53774,"BUNUTAN, ABANG, KARANGASEM, BALI",34,135,8,143
https://kawalpemilu.org#53774,"BUNUTAN, ABANG, KARANGASEM, BALI",35,174,6,180
https://kawalpemilu.org#53774,"BUNUTAN, ABANG, KARANGASEM, BALI",36,183,3,186
https://kawalpemilu.org#53774,"BUNUTAN, ABANG, KARANGASEM, BALI",37,233,6,239
https://kawalpemilu.org#53774,"BUNUTAN, ABANG, KARANGASEM, BALI",38,120,7,127
https://kawalpemilu.org#53774,"BUNUTAN, ABANG, KARANGASEM, BALI",39,125,6,131
https://kawalpemilu.org#53775,"TISTA, ABANG, KARANGASEM, BALI",1,166,9,175
https://kawalpemilu.org#53775,"TISTA, ABANG, KARANGASEM, BALI",2,106,5,111
https://kawalpemilu.org#53775,"TISTA, ABANG, KARANGASEM, BALI",3,173,8,181
https://kawalpemilu.org#53775,"TISTA, ABANG, KARANGASEM, BALI",4,152,2,154
https://kawalpemilu.org#53775,"TISTA, ABANG, KARANGASEM, BALI",5,146,3,149
https://kawalpemilu.org#53775,"TISTA, ABANG, KARANGASEM, BALI",6,113,2,115
https://kawalpemilu.org#53775,"TISTA, ABANG, KARANGASEM, BALI",7,151,3,154
https://kawalpemilu.org#53775,"TISTA, ABANG, KARANGASEM, BALI",8,142,8,150
https://kawalpemilu.org#53775,"TISTA, ABANG, KARANGASEM, BALI",9,120,5,125
https://kawalpemilu.org#53775,"TISTA, ABANG, KARANGASEM, BALI",10,95,3,98
https://kawalpemilu.org#53775,"TISTA, ABANG, KARANGASEM, BALI",11,199,11,210
https://kawalpemilu.org#53775,"TISTA, ABANG, KARANGASEM, BALI",12,181,8,189
https://kawalpemilu.org#53775,"TISTA, ABANG, KARANGASEM, BALI",13,187,9,196
https://kawalpemilu.org#53775,"TISTA, ABANG, KARANGASEM, BALI",14,155,1,156
https://kawalpemilu.org#53775,"TISTA, ABANG, KARANGASEM, BALI",15,132,5,137
https://kawalpemilu.org#53775,"TISTA, ABANG, KARANGASEM, BALI",16,127,3,130
https://kawalpemilu.org#53775,"TISTA, ABANG, KARANGASEM, BALI",17,221,3,224
https://kawalpemilu.org#53775,"TISTA, ABANG, KARANGASEM, BALI",18,214,1,215
https://kawalpemilu.org#53775,"TISTA, ABANG, KARANGASEM, BALI",19,168,3,171
https://kawalpemilu.org#53775,"TISTA, ABANG, KARANGASEM, BALI",20,160,6,166
https://kawalpemilu.org#53775,"TISTA, ABANG, KARANGASEM, BALI",21,138,21,159
https://kawalpemilu.org#53776,"ABANG, ABANG, KARANGASEM, BALI",1,193,13,206
https://kawalpemilu.org#53776,"ABANG, ABANG, KARANGASEM, BALI",2,189,7,196
https://kawalpemilu.org#53776,"ABANG, ABANG, KARANGASEM, BALI",3,108,7,115
https://kawalpemilu.org#53776,"ABANG, ABANG, KARANGASEM, BALI",4,199,1,200
https://kawalpemilu.org#53776,"ABANG, ABANG, KARANGASEM, BALI",5,160,8,168
https://kawalpemilu.org#53776,"ABANG, ABANG, KARANGASEM, BALI",6,142,3,145
https://kawalpemilu.org#53776,"ABANG, ABANG, KARANGASEM, BALI",7,211,0,211
https://kawalpemilu.org#53776,"ABANG, ABANG, KARANGASEM, BALI",8,194,0,194
https://kawalpemilu.org#53776,"ABANG, ABANG, KARANGASEM, BALI",9,150,4,154
https://kawalpemilu.org#53776,"ABANG, ABANG, KARANGASEM, BALI",10,160,3,163
https://kawalpemilu.org#53776,"ABANG, ABANG, KARANGASEM, BALI",11,131,8,139
https://kawalpemilu.org#53776,"ABANG, ABANG, KARANGASEM, BALI",12,240,10,250
https://kawalpemilu.org#53776,"ABANG, ABANG, KARANGASEM, BALI",13,189,16,205
https://kawalpemilu.org#53777,"PIDPID, ABANG, KARANGASEM, BALI",1,254,4,258
https://kawalpemilu.org#53777,"PIDPID, ABANG, KARANGASEM, BALI",2,157,0,157
https://kawalpemilu.org#53777,"PIDPID, ABANG, KARANGASEM, BALI",3,152,0,152
https://kawalpemilu.org#53777,"PIDPID, ABANG, KARANGASEM, BALI",4,127,5,132
https://kawalpemilu.org#53777,"PIDPID, ABANG, KARANGASEM, BALI",5,105,0,105
https://kawalpemilu.org#53777,"PIDPID, ABANG, KARANGASEM, BALI",6,165,2,167
https://kawalpemilu.org#53777,"PIDPID, ABANG, KARANGASEM, BALI",7,113,1,114
https://kawalpemilu.org#53777,"PIDPID, ABANG, KARANGASEM, BALI",8,199,3,202
https://kawalpemilu.org#53777,"PIDPID, ABANG, KARANGASEM, BALI",9,168,1,169
https://kawalpemilu.org#53777,"PIDPID, ABANG, KARANGASEM, BALI",10,170,2,172
https://kawalpemilu.org#53777,"PIDPID, ABANG, KARANGASEM, BALI",11,132,6,138
https://kawalpemilu.org#53777,"PIDPID, ABANG, KARANGASEM, BALI",12,171,9,180
https://kawalpemilu.org#53777,"PIDPID, ABANG, KARANGASEM, BALI",13,135,5,140
https://kawalpemilu.org#53777,"PIDPID, ABANG, KARANGASEM, BALI",14,120,4,124
https://kawalpemilu.org#53778,"DATAH, ABANG, KARANGASEM, BALI",1,221,0,221
https://kawalpemilu.org#53778,"DATAH, ABANG, KARANGASEM, BALI",2,158,2,160
https://kawalpemilu.org#53778,"DATAH, ABANG, KARANGASEM, BALI",3,148,8,168
https://kawalpemilu.org#53778,"DATAH, ABANG, KARANGASEM, BALI",4,125,6,131
https://kawalpemilu.org#53778,"DATAH, ABANG, KARANGASEM, BALI",5,155,4,119
https://kawalpemilu.org#53778,"DATAH, ABANG, KARANGASEM, BALI",6,149,5,154
https://kawalpemilu.org#53778,"DATAH, ABANG, KARANGASEM, BALI",7,176,7,183
https://kawalpemilu.org#53778,"DATAH, ABANG, KARANGASEM, BALI",8,173,4,177
https://kawalpemilu.org#53778,"DATAH, ABANG, KARANGASEM, BALI",9,136,11,147
https://kawalpemilu.org#53778,"DATAH, ABANG, KARANGASEM, BALI",10,143,8,151
https://kawalpemilu.org#53778,"DATAH, ABANG, KARANGASEM, BALI",11,205,8,213
https://kawalpemilu.org#53778,"DATAH, ABANG, KARANGASEM, BALI",12,206,2,208
https://kawalpemilu.org#53778,"DATAH, ABANG, KARANGASEM, BALI",13,195,4,199
https://kawalpemilu.org#53778,"DATAH, ABANG, KARANGASEM, BALI",14,99,5,104
https://kawalpemilu.org#53778,"DATAH, ABANG, KARANGASEM, BALI",15,105,4,109
https://kawalpemilu.org#53778,"DATAH, ABANG, KARANGASEM, BALI",16,182,5,187
https://kawalpemilu.org#53778,"DATAH, ABANG, KARANGASEM, BALI",17,128,0,128
https://kawalpemilu.org#53778,"DATAH, ABANG, KARANGASEM, BALI",19,145,2,147
https://kawalpemilu.org#53778,"DATAH, ABANG, KARANGASEM, BALI",20,154,6,160
https://kawalpemilu.org#53778,"DATAH, ABANG, KARANGASEM, BALI",21,114,7,121
https://kawalpemilu.org#53778,"DATAH, ABANG, KARANGASEM, BALI",22,163,4,167
https://kawalpemilu.org#53778,"DATAH, ABANG, KARANGASEM, BALI",23,210,4,214
https://kawalpemilu.org#53778,"DATAH, ABANG, KARANGASEM, BALI",24,157,8,165
https://kawalpemilu.org#53778,"DATAH, ABANG, KARANGASEM, BALI",25,128,8,136
https://kawalpemilu.org#53778,"DATAH, ABANG, KARANGASEM, BALI",26,117,13,130
https://kawalpemilu.org#53778,"DATAH, ABANG, KARANGASEM, BALI",27,116,5,121
https://kawalpemilu.org#53778,"DATAH, ABANG, KARANGASEM, BALI",28,111,8,119
https://kawalpemilu.org#53778,"DATAH, ABANG, KARANGASEM, BALI",29,113,5,118
https://kawalpemilu.org#53778,"DATAH, ABANG, KARANGASEM, BALI",30,138,5,143
https://kawalpemilu.org#53778,"DATAH, ABANG, KARANGASEM, BALI",31,119,2,121
https://kawalpemilu.org#53778,"DATAH, ABANG, KARANGASEM, BALI",32,80,4,84
https://kawalpemilu.org#53778,"DATAH, ABANG, KARANGASEM, BALI",33,106,3,109
https://kawalpemilu.org#53778,"DATAH, ABANG, KARANGASEM, BALI",34,56,2,58
https://kawalpemilu.org#53778,"DATAH, ABANG, KARANGASEM, BALI",35,132,9,141
https://kawalpemilu.org#53778,"DATAH, ABANG, KARANGASEM, BALI",36,119,2,121
https://kawalpemilu.org#53778,"DATAH, ABANG, KARANGASEM, BALI",37,96,4,100
https://kawalpemilu.org#53778,"DATAH, ABANG, KARANGASEM, BALI",38,82,3,85
https://kawalpemilu.org#53778,"DATAH, ABANG, KARANGASEM, BALI",39,140,7,147
https://kawalpemilu.org#53778,"DATAH, ABANG, KARANGASEM, BALI",40,117,3,120
https://kawalpemilu.org#53778,"DATAH, ABANG, KARANGASEM, BALI",41,147,11,158
https://kawalpemilu.org#53778,"DATAH, ABANG, KARANGASEM, BALI",42,165,5,170
https://kawalpemilu.org#53778,"DATAH, ABANG, KARANGASEM, BALI",43,152,8,160
https://kawalpemilu.org#53778,"DATAH, ABANG, KARANGASEM, BALI",44,125,7,132
https://kawalpemilu.org#53778,"DATAH, ABANG, KARANGASEM, BALI",45,147,1,148
https://kawalpemilu.org#53778,"DATAH, ABANG, KARANGASEM, BALI",46,131,6,137
https://kawalpemilu.org#53779,"CULIK, ABANG, KARANGASEM, BALI",1,170,7,177
https://kawalpemilu.org#53779,"CULIK, ABANG, KARANGASEM, BALI",2,163,8,171
https://kawalpemilu.org#53779,"CULIK, ABANG, KARANGASEM, BALI",3,121,7,128
https://kawalpemilu.org#53779,"CULIK, ABANG, KARANGASEM, BALI",4,122,3,125
https://kawalpemilu.org#53779,"CULIK, ABANG, KARANGASEM, BALI",5,147,2,149
https://kawalpemilu.org#53779,"CULIK, ABANG, KARANGASEM, BALI",6,149,7,156
https://kawalpemilu.org#53779,"CULIK, ABANG, KARANGASEM, BALI",7,169,1,170
https://kawalpemilu.org#53779,"CULIK, ABANG, KARANGASEM, BALI",8,119,6,125
https://kawalpemilu.org#53779,"CULIK, ABANG, KARANGASEM, BALI",9,153,5,158
https://kawalpemilu.org#53779,"CULIK, ABANG, KARANGASEM, BALI",10,142,5,147
https://kawalpemilu.org#53779,"CULIK, ABANG, KARANGASEM, BALI",11,181,10,191
https://kawalpemilu.org#53779,"CULIK, ABANG, KARANGASEM, BALI",12,190,15,205
https://kawalpemilu.org#53779,"CULIK, ABANG, KARANGASEM, BALI",13,208,6,214
https://kawalpemilu.org#53779,"CULIK, ABANG, KARANGASEM, BALI",14,200,8,208
https://kawalpemilu.org#53780,"PURWAKERTI, ABANG, KARANGASEM, BALI",1,168,5,173
https://kawalpemilu.org#53780,"PURWAKERTI, ABANG, KARANGASEM, BALI",2,157,0,157
https://kawalpemilu.org#53780,"PURWAKERTI, ABANG, KARANGASEM, BALI",3,155,1,156
https://kawalpemilu.org#53780,"PURWAKERTI, ABANG, KARANGASEM, BALI",4,144,2,146
https://kawalpemilu.org#53780,"PURWAKERTI, ABANG, KARANGASEM, BALI",5,188,8,196
https://kawalpemilu.org#53780,"PURWAKERTI, ABANG, KARANGASEM, BALI",6,185,3,188
https://kawalpemilu.org#53780,"PURWAKERTI, ABANG, KARANGASEM, BALI",7,138,2,140
https://kawalpemilu.org#53780,"PURWAKERTI, ABANG, KARANGASEM, BALI",8,118,2,120
https://kawalpemilu.org#53780,"PURWAKERTI, ABANG, KARANGASEM, BALI",9,133,7,140
https://kawalpemilu.org#53780,"PURWAKERTI, ABANG, KARANGASEM, BALI",10,107,6,113
https://kawalpemilu.org#53780,"PURWAKERTI, ABANG, KARANGASEM, BALI",11,125,1,126
https://kawalpemilu.org#53780,"PURWAKERTI, ABANG, KARANGASEM, BALI",12,86,3,89
https://kawalpemilu.org#53780,"PURWAKERTI, ABANG, KARANGASEM, BALI",13,198,7,205
https://kawalpemilu.org#53780,"PURWAKERTI, ABANG, KARANGASEM, BALI",14,179,8,187
https://kawalpemilu.org#53780,"PURWAKERTI, ABANG, KARANGASEM, BALI",15,168,11,179
https://kawalpemilu.org#53780,"PURWAKERTI, ABANG, KARANGASEM, BALI",16,182,9,191
https://kawalpemilu.org#53780,"PURWAKERTI, ABANG, KARANGASEM, BALI",17,166,9,175
https://kawalpemilu.org#53780,"PURWAKERTI, ABANG, KARANGASEM, BALI",18,168,5,173
https://kawalpemilu.org#53780,"PURWAKERTI, ABANG, KARANGASEM, BALI",19,164,3,167
https://kawalpemilu.org#53780,"PURWAKERTI, ABANG, KARANGASEM, BALI",20,201,7,208
https://kawalpemilu.org#53780,"PURWAKERTI, ABANG, KARANGASEM, BALI",21,194,8,202
https://kawalpemilu.org#53781,"KERTA MANDALA, ABANG, KARANGASEM, BALI",1,177,9,186
https://kawalpemilu.org#53781,"KERTA MANDALA, ABANG, KARANGASEM, BALI",2,154,10,164
https://kawalpemilu.org#53781,"KERTA MANDALA, ABANG, KARANGASEM, BALI",3,146,6,152
https://kawalpemilu.org#53781,"KERTA MANDALA, ABANG, KARANGASEM, BALI",4,160,6,166
https://kawalpemilu.org#53781,"KERTA MANDALA, ABANG, KARANGASEM, BALI",5,139,5,144
https://kawalpemilu.org#53781,"KERTA MANDALA, ABANG, KARANGASEM, BALI",6,152,7,159
https://kawalpemilu.org#53781,"KERTA MANDALA, ABANG, KARANGASEM, BALI",7,166,14,180
https://kawalpemilu.org#53781,"KERTA MANDALA, ABANG, KARANGASEM, BALI",8,201,6,207
https://kawalpemilu.org#53781,"KERTA MANDALA, ABANG, KARANGASEM, BALI",9,188,6,194
https://kawalpemilu.org#53781,"KERTA MANDALA, ABANG, KARANGASEM, BALI",10,158,6,164
https://kawalpemilu.org#53781,"KERTA MANDALA, ABANG, KARANGASEM, BALI",11,133,7,140
https://kawalpemilu.org#53781,"KERTA MANDALA, ABANG, KARANGASEM, BALI",12,230,21,251
https://kawalpemilu.org#53781,"KERTA MANDALA, ABANG, KARANGASEM, BALI",13,212,16,228
https://kawalpemilu.org#53781,"KERTA MANDALA, ABANG, KARANGASEM, BALI",14,198,2,200
https://kawalpemilu.org#53781,"KERTA MANDALA, ABANG, KARANGASEM, BALI",15,175,13,188
https://kawalpemilu.org#53782,"LABASARI, ABANG, KARANGASEM, BALI",1,160,9,169
https://kawalpemilu.org#53782,"LABASARI, ABANG, KARANGASEM, BALI",2,159,2,161
https://kawalpemilu.org#53782,"LABASARI, ABANG, KARANGASEM, BALI",3,185,6,191
https://kawalpemilu.org#53782,"LABASARI, ABANG, KARANGASEM, BALI",4,157,4,161
https://kawalpemilu.org#53782,"LABASARI, ABANG, KARANGASEM, BALI",5,135,1,136
https://kawalpemilu.org#53782,"LABASARI, ABANG, KARANGASEM, BALI",6,132,12,144
https://kawalpemilu.org#53782,"LABASARI, ABANG, KARANGASEM, BALI",7,201,5,206
https://kawalpemilu.org#53782,"LABASARI, ABANG, KARANGASEM, BALI",8,154,7,161
https://kawalpemilu.org#53782,"LABASARI, ABANG, KARANGASEM, BALI",9,112,4,116
https://kawalpemilu.org#53782,"LABASARI, ABANG, KARANGASEM, BALI",10,123,4,127
https://kawalpemilu.org#53782,"LABASARI, ABANG, KARANGASEM, BALI",11,217,1,218
https://kawalpemilu.org#53782,"LABASARI, ABANG, KARANGASEM, BALI",12,183,1,184
https://kawalpemilu.org#53782,"LABASARI, ABANG, KARANGASEM, BALI",13,143,3,146
https://kawalpemilu.org#53782,"LABASARI, ABANG, KARANGASEM, BALI",14,117,6,123
https://kawalpemilu.org#53783,"NAWA KERTI, ABANG, KARANGASEM, BALI",1,125,8,133
https://kawalpemilu.org#53783,"NAWA KERTI, ABANG, KARANGASEM, BALI",2,115,4,119
https://kawalpemilu.org#53783,"NAWA KERTI, ABANG, KARANGASEM, BALI",3,150,5,155
https://kawalpemilu.org#53783,"NAWA KERTI, ABANG, KARANGASEM, BALI",4,129,6,135
https://kawalpemilu.org#53783,"NAWA KERTI, ABANG, KARANGASEM, BALI",5,161,8,169
https://kawalpemilu.org#53783,"NAWA KERTI, ABANG, KARANGASEM, BALI",6,143,4,147
https://kawalpemilu.org#53783,"NAWA KERTI, ABANG, KARANGASEM, BALI",7,103,9,112
https://kawalpemilu.org#53783,"NAWA KERTI, ABANG, KARANGASEM, BALI",8,103,5,108
https://kawalpemilu.org#53783,"NAWA KERTI, ABANG, KARANGASEM, BALI",9,109,6,115
https://kawalpemilu.org#53783,"NAWA KERTI, ABANG, KARANGASEM, BALI",10,102,3,105
https://kawalpemilu.org#53783,"NAWA KERTI, ABANG, KARANGASEM, BALI",11,153,9,162
https://kawalpemilu.org#53783,"NAWA KERTI, ABANG, KARANGASEM, BALI",12,131,7,138
https://kawalpemilu.org#53783,"NAWA KERTI, ABANG, KARANGASEM, BALI",13,141,1,142
https://kawalpemilu.org#53783,"NAWA KERTI, ABANG, KARANGASEM, BALI",14,98,5,103
https://kawalpemilu.org#53784,"KESIMPAR, ABANG, KARANGASEM, BALI",1,146,6,152
https://kawalpemilu.org#53784,"KESIMPAR, ABANG, KARANGASEM, BALI",2,128,13,141
https://kawalpemilu.org#53784,"KESIMPAR, ABANG, KARANGASEM, BALI",3,147,4,151
https://kawalpemilu.org#53784,"KESIMPAR, ABANG, KARANGASEM, BALI",4,150,9,159
https://kawalpemilu.org#53784,"KESIMPAR, ABANG, KARANGASEM, BALI",5,174,7,181
https://kawalpemilu.org#53784,"KESIMPAR, ABANG, KARANGASEM, BALI",6,145,12,157
https://kawalpemilu.org#53784,"KESIMPAR, ABANG, KARANGASEM, BALI",7,115,14,129
https://kawalpemilu.org#53784,"KESIMPAR, ABANG, KARANGASEM, BALI",8,118,12,130
https://kawalpemilu.org#53784,"KESIMPAR, ABANG, KARANGASEM, BALI",9,109,5,114
https://kawalpemilu.org#53785,"TRIBUANA, ABANG, KARANGASEM, BALI",1,230,4,234
https://kawalpemilu.org#53785,"TRIBUANA, ABANG, KARANGASEM, BALI",2,199,7,206
https://kawalpemilu.org#53785,"TRIBUANA, ABANG, KARANGASEM, BALI",3,164,6,170
https://kawalpemilu.org#53785,"TRIBUANA, ABANG, KARANGASEM, BALI",4,155,4,159
https://kawalpemilu.org#53785,"TRIBUANA, ABANG, KARANGASEM, BALI",5,137,2,139
https://kawalpemilu.org#53785,"TRIBUANA, ABANG, KARANGASEM, BALI",6,134,2,136
https://kawalpemilu.org#53785,"TRIBUANA, ABANG, KARANGASEM, BALI",7,129,3,132
https://kawalpemilu.org#53785,"TRIBUANA, ABANG, KARANGASEM, BALI",8,123,4,127
https://kawalpemilu.org#53785,"TRIBUANA, ABANG, KARANGASEM, BALI",9,169,7,176
https://kawalpemilu.org#53785,"TRIBUANA, ABANG, KARANGASEM, BALI",10,151,7,158
https://kawalpemilu.org#53785,"TRIBUANA, ABANG, KARANGASEM, BALI",11,155,3,158
https://kawalpemilu.org#53785,"TRIBUANA, ABANG, KARANGASEM, BALI",12,222,6,228
https://kawalpemilu.org#53785,"TRIBUANA, ABANG, KARANGASEM, BALI",13,218,2,220
https://kawalpemilu.org#53785,"TRIBUANA, ABANG, KARANGASEM, BALI",14,169,4,173
https://kawalpemilu.org#53785,"TRIBUANA, ABANG, KARANGASEM, BALI",15,174,5,179
https://kawalpemilu.org#53785,"TRIBUANA, ABANG, KARANGASEM, BALI",16,134,4,138
https://kawalpemilu.org#53785,"TRIBUANA, ABANG, KARANGASEM, BALI",17,122,2,124
https://kawalpemilu.org#53787,"BUNGAYA, BEBANDEM, KARANGASEM, BALI",1,236,18,254
https://kawalpemilu.org#53787,"BUNGAYA, BEBANDEM, KARANGASEM, BALI",2,202,11,213
https://kawalpemilu.org#53787,"BUNGAYA, BEBANDEM, KARANGASEM, BALI",3,171,7,178
https://kawalpemilu.org#53787,"BUNGAYA, BEBANDEM, KARANGASEM, BALI",4,161,8,169
https://kawalpemilu.org#53787,"BUNGAYA, BEBANDEM, KARANGASEM, BALI",5,196,5,201
https://kawalpemilu.org#53787,"BUNGAYA, BEBANDEM, KARANGASEM, BALI",6,168,7,175
https://kawalpemilu.org#53787,"BUNGAYA, BEBANDEM, KARANGASEM, BALI",7,217,12,229
https://kawalpemilu.org#53787,"BUNGAYA, BEBANDEM, KARANGASEM, BALI",8,179,29,208
https://kawalpemilu.org#53787,"BUNGAYA, BEBANDEM, KARANGASEM, BALI",9,145,9,154
https://kawalpemilu.org#53787,"BUNGAYA, BEBANDEM, KARANGASEM, BALI",10,140,4,144
https://kawalpemilu.org#53787,"BUNGAYA, BEBANDEM, KARANGASEM, BALI",11,139,5,144
https://kawalpemilu.org#53787,"BUNGAYA, BEBANDEM, KARANGASEM, BALI",12,124,3,127
https://kawalpemilu.org#53787,"BUNGAYA, BEBANDEM, KARANGASEM, BALI",13,218,13,231
https://kawalpemilu.org#53787,"BUNGAYA, BEBANDEM, KARANGASEM, BALI",14,205,1,206
https://kawalpemilu.org#53787,"BUNGAYA, BEBANDEM, KARANGASEM, BALI",16,68,112,180
https://kawalpemilu.org#53787,"BUNGAYA, BEBANDEM, KARANGASEM, BALI",17,172,8,180
https://kawalpemilu.org#53787,"BUNGAYA, BEBANDEM, KARANGASEM, BALI",18,157,6,163
https://kawalpemilu.org#53787,"BUNGAYA, BEBANDEM, KARANGASEM, BALI",19,135,5,140
https://kawalpemilu.org#53788,"BUDEKELING, BEBANDEM, KARANGASEM, BALI",1,170,9,179
https://kawalpemilu.org#53788,"BUDEKELING, BEBANDEM, KARANGASEM, BALI",2,147,7,154
https://kawalpemilu.org#53788,"BUDEKELING, BEBANDEM, KARANGASEM, BALI",3,170,6,176
https://kawalpemilu.org#53788,"BUDEKELING, BEBANDEM, KARANGASEM, BALI",4,190,7,199
https://kawalpemilu.org#53788,"BUDEKELING, BEBANDEM, KARANGASEM, BALI",5,150,7,157
https://kawalpemilu.org#53788,"BUDEKELING, BEBANDEM, KARANGASEM, BALI",6,123,4,127
https://kawalpemilu.org#53788,"BUDEKELING, BEBANDEM, KARANGASEM, BALI",7,192,7,199
https://kawalpemilu.org#53788,"BUDEKELING, BEBANDEM, KARANGASEM, BALI",8,202,9,211
https://kawalpemilu.org#53788,"BUDEKELING, BEBANDEM, KARANGASEM, BALI",9,121,3,124
https://kawalpemilu.org#53788,"BUDEKELING, BEBANDEM, KARANGASEM, BALI",10,162,12,174
https://kawalpemilu.org#53788,"BUDEKELING, BEBANDEM, KARANGASEM, BALI",11,190,14,204
https://kawalpemilu.org#53788,"BUDEKELING, BEBANDEM, KARANGASEM, BALI",12,176,10,186
https://kawalpemilu.org#53788,"BUDEKELING, BEBANDEM, KARANGASEM, BALI",13,205,5,210
https://kawalpemilu.org#53788,"BUDEKELING, BEBANDEM, KARANGASEM, BALI",14,204,6,210
https://kawalpemilu.org#53788,"BUDEKELING, BEBANDEM, KARANGASEM, BALI",15,29,136,165
https://kawalpemilu.org#53788,"BUDEKELING, BEBANDEM, KARANGASEM, BALI",16,31,123,154
https://kawalpemilu.org#53789,"BEBANDEM, BEBANDEM, KARANGASEM, BALI",1,165,3,168
https://kawalpemilu.org#53789,"BEBANDEM, BEBANDEM, KARANGASEM, BALI",2,162,4,166
https://kawalpemilu.org#53789,"BEBANDEM, BEBANDEM, KARANGASEM, BALI",3,155,3,158
https://kawalpemilu.org#53789,"BEBANDEM, BEBANDEM, KARANGASEM, BALI",4,169,2,171
https://kawalpemilu.org#53789,"BEBANDEM, BEBANDEM, KARANGASEM, BALI",5,152,6,158
https://kawalpemilu.org#53789,"BEBANDEM, BEBANDEM, KARANGASEM, BALI",6,133,10,143
https://kawalpemilu.org#53789,"BEBANDEM, BEBANDEM, KARANGASEM, BALI",7,184,8,192
https://kawalpemilu.org#53789,"BEBANDEM, BEBANDEM, KARANGASEM, BALI",8,179,2,181
https://kawalpemilu.org#53789,"BEBANDEM, BEBANDEM, KARANGASEM, BALI",9,236,8,244
https://kawalpemilu.org#53789,"BEBANDEM, BEBANDEM, KARANGASEM, BALI",10,250,12,252
https://kawalpemilu.org#53789,"BEBANDEM, BEBANDEM, KARANGASEM, BALI",11,172,11,183
https://kawalpemilu.org#53789,"BEBANDEM, BEBANDEM, KARANGASEM, BALI",12,162,7,169
https://kawalpemilu.org#53789,"BEBANDEM, BEBANDEM, KARANGASEM, BALI",13,198,15,213
https://kawalpemilu.org#53789,"BEBANDEM, BEBANDEM, KARANGASEM, BALI",14,173,4,177
https://kawalpemilu.org#53789,"BEBANDEM, BEBANDEM, KARANGASEM, BALI",15,169,4,173
https://kawalpemilu.org#53789,"BEBANDEM, BEBANDEM, KARANGASEM, BALI",16,152,7,159
https://kawalpemilu.org#53789,"BEBANDEM, BEBANDEM, KARANGASEM, BALI",17,0,0,0
https://kawalpemilu.org#53789,"BEBANDEM, BEBANDEM, KARANGASEM, BALI",18,239,21,260
https://kawalpemilu.org#53789,"BEBANDEM, BEBANDEM, KARANGASEM, BALI",19,176,12,188
https://kawalpemilu.org#53789,"BEBANDEM, BEBANDEM, KARANGASEM, BALI",20,160,8,168
https://kawalpemilu.org#53789,"BEBANDEM, BEBANDEM, KARANGASEM, BALI",21,135,2,137
https://kawalpemilu.org#53789,"BEBANDEM, BEBANDEM, KARANGASEM, BALI",22,194,6,200
https://kawalpemilu.org#53789,"BEBANDEM, BEBANDEM, KARANGASEM, BALI",23,162,6,168
https://kawalpemilu.org#53789,"BEBANDEM, BEBANDEM, KARANGASEM, BALI",24,189,2,191
https://kawalpemilu.org#53789,"BEBANDEM, BEBANDEM, KARANGASEM, BALI",25,171,1,172
https://kawalpemilu.org#53789,"BEBANDEM, BEBANDEM, KARANGASEM, BALI",26,160,16,176
https://kawalpemilu.org#53789,"BEBANDEM, BEBANDEM, KARANGASEM, BALI",27,158,20,178
https://kawalpemilu.org#53789,"BEBANDEM, BEBANDEM, KARANGASEM, BALI",28,111,12,123
https://kawalpemilu.org#53789,"BEBANDEM, BEBANDEM, KARANGASEM, BALI",29,119,12,131
https://kawalpemilu.org#53789,"BEBANDEM, BEBANDEM, KARANGASEM, BALI",30,186,11,197
https://kawalpemilu.org#53789,"BEBANDEM, BEBANDEM, KARANGASEM, BALI",31,164,5,169
https://kawalpemilu.org#53789,"BEBANDEM, BEBANDEM, KARANGASEM, BALI",32,159,12,171
https://kawalpemilu.org#53789,"BEBANDEM, BEBANDEM, KARANGASEM, BALI",33,171,10,181
https://kawalpemilu.org#53789,"BEBANDEM, BEBANDEM, KARANGASEM, BALI",34,182,13,195
https://kawalpemilu.org#53789,"BEBANDEM, BEBANDEM, KARANGASEM, BALI",35,161,13,174
https://kawalpemilu.org#53789,"BEBANDEM, BEBANDEM, KARANGASEM, BALI",36,111,4,115
https://kawalpemilu.org#53789,"BEBANDEM, BEBANDEM, KARANGASEM, BALI",37,118,14,132
https://kawalpemilu.org#53789,"BEBANDEM, BEBANDEM, KARANGASEM, BALI",38,206,9,215
https://kawalpemilu.org#53789,"BEBANDEM, BEBANDEM, KARANGASEM, BALI",39,191,21,212
https://kawalpemilu.org#53790,"SIBETAN, BEBANDEM, KARANGASEM, BALI",1,134,4,138
https://kawalpemilu.org#53790,"SIBETAN, BEBANDEM, KARANGASEM, BALI",2,144,2,146
https://kawalpemilu.org#53790,"SIBETAN, BEBANDEM, KARANGASEM, BALI",3,127,6,133
https://kawalpemilu.org#53790,"SIBETAN, BEBANDEM, KARANGASEM, BALI",4,236,14,250
https://kawalpemilu.org#53790,"SIBETAN, BEBANDEM, KARANGASEM, BALI",5,171,3,174
https://kawalpemilu.org#53790,"SIBETAN, BEBANDEM, KARANGASEM, BALI",7,119,7,126
https://kawalpemilu.org#53790,"SIBETAN, BEBANDEM, KARANGASEM, BALI",8,183,2,185
https://kawalpemilu.org#53790,"SIBETAN, BEBANDEM, KARANGASEM, BALI",9,156,6,162
https://kawalpemilu.org#53790,"SIBETAN, BEBANDEM, KARANGASEM, BALI",10,138,6,144
https://kawalpemilu.org#53790,"SIBETAN, BEBANDEM, KARANGASEM, BALI",11,111,3,114
https://kawalpemilu.org#53790,"SIBETAN, BEBANDEM, KARANGASEM, BALI",12,96,7,103
https://kawalpemilu.org#53790,"SIBETAN, BEBANDEM, KARANGASEM, BALI",13,193,11,204
https://kawalpemilu.org#53790,"SIBETAN, BEBANDEM, KARANGASEM, BALI",14,172,7,179
https://kawalpemilu.org#53790,"SIBETAN, BEBANDEM, KARANGASEM, BALI",15,163,7,170
https://kawalpemilu.org#53790,"SIBETAN, BEBANDEM, KARANGASEM, BALI",16,142,4,146
https://kawalpemilu.org#53790,"SIBETAN, BEBANDEM, KARANGASEM, BALI",17,240,11,251
https://kawalpemilu.org#53790,"SIBETAN, BEBANDEM, KARANGASEM, BALI",18,221,6,227
https://kawalpemilu.org#53790,"SIBETAN, BEBANDEM, KARANGASEM, BALI",19,181,8,189
https://kawalpemilu.org#53790,"SIBETAN, BEBANDEM, KARANGASEM, BALI",21,166,5,171
https://kawalpemilu.org#53790,"SIBETAN, BEBANDEM, KARANGASEM, BALI",22,172,7,179
https://kawalpemilu.org#53790,"SIBETAN, BEBANDEM, KARANGASEM, BALI",23,216,6,222
https://kawalpemilu.org#53790,"SIBETAN, BEBANDEM, KARANGASEM, BALI",24,164,4,168
https://kawalpemilu.org#53790,"SIBETAN, BEBANDEM, KARANGASEM, BALI",25,200,11,211
https://kawalpemilu.org#53790,"SIBETAN, BEBANDEM, KARANGASEM, BALI",26,213,4,217
https://kawalpemilu.org#53790,"SIBETAN, BEBANDEM, KARANGASEM, BALI",27,193,3,196
https://kawalpemilu.org#53790,"SIBETAN, BEBANDEM, KARANGASEM, BALI",28,168,4,172
https://kawalpemilu.org#53790,"SIBETAN, BEBANDEM, KARANGASEM, BALI",29,169,7,176
https://kawalpemilu.org#53790,"SIBETAN, BEBANDEM, KARANGASEM, BALI",30,169,10,179
https://kawalpemilu.org#53790,"SIBETAN, BEBANDEM, KARANGASEM, BALI",31,164,6,170
https://kawalpemilu.org#53790,"SIBETAN, BEBANDEM, KARANGASEM, BALI",32,165,3,168
https://kawalpemilu.org#53790,"SIBETAN, BEBANDEM, KARANGASEM, BALI",33,150,2,152
https://kawalpemilu.org#53790,"SIBETAN, BEBANDEM, KARANGASEM, BALI",34,135,6,141
https://kawalpemilu.org#53791,"JUNGUTAN, BEBANDEM, KARANGASEM, BALI",1,166,13,179
https://kawalpemilu.org#53791,"JUNGUTAN, BEBANDEM, KARANGASEM, BALI",2,180,13,193
https://kawalpemilu.org#53791,"JUNGUTAN, BEBANDEM, KARANGASEM, BALI",3,192,2,194
https://kawalpemilu.org#53791,"JUNGUTAN, BEBANDEM, KARANGASEM, BALI",4,158,11,169
https://kawalpemilu.org#53791,"JUNGUTAN, BEBANDEM, KARANGASEM, BALI",5,197,5,202
https://kawalpemilu.org#53791,"JUNGUTAN, BEBANDEM, KARANGASEM, BALI",6,207,5,212
https://kawalpemilu.org#53791,"JUNGUTAN, BEBANDEM, KARANGASEM, BALI",7,214,4,218
https://kawalpemilu.org#53791,"JUNGUTAN, BEBANDEM, KARANGASEM, BALI",8,204,9,213
https://kawalpemilu.org#53791,"JUNGUTAN, BEBANDEM, KARANGASEM, BALI",9,167,5,172
https://kawalpemilu.org#53791,"JUNGUTAN, BEBANDEM, KARANGASEM, BALI",10,126,3,129
https://kawalpemilu.org#53791,"JUNGUTAN, BEBANDEM, KARANGASEM, BALI",11,129,6,135
https://kawalpemilu.org#53791,"JUNGUTAN, BEBANDEM, KARANGASEM, BALI",12,120,3,123
https://kawalpemilu.org#53791,"JUNGUTAN, BEBANDEM, KARANGASEM, BALI",13,123,6,129
https://kawalpemilu.org#53791,"JUNGUTAN, BEBANDEM, KARANGASEM, BALI",14,110,5,115
https://kawalpemilu.org#53791,"JUNGUTAN, BEBANDEM, KARANGASEM, BALI",15,121,1,122
https://kawalpemilu.org#53791,"JUNGUTAN, BEBANDEM, KARANGASEM, BALI",16,127,2,129
https://kawalpemilu.org#53791,"JUNGUTAN, BEBANDEM, KARANGASEM, BALI",17,123,6,129
https://kawalpemilu.org#53791,"JUNGUTAN, BEBANDEM, KARANGASEM, BALI",18,136,4,140
https://kawalpemilu.org#53791,"JUNGUTAN, BEBANDEM, KARANGASEM, BALI",19,139,0,139
https://kawalpemilu.org#53791,"JUNGUTAN, BEBANDEM, KARANGASEM, BALI",20,179,4,183
https://kawalpemilu.org#53791,"JUNGUTAN, BEBANDEM, KARANGASEM, BALI",21,179,3,182
https://kawalpemilu.org#53791,"JUNGUTAN, BEBANDEM, KARANGASEM, BALI",23,177,14,191
https://kawalpemilu.org#53791,"JUNGUTAN, BEBANDEM, KARANGASEM, BALI",24,128,8,136
https://kawalpemilu.org#53791,"JUNGUTAN, BEBANDEM, KARANGASEM, BALI",25,148,12,160
https://kawalpemilu.org#53791,"JUNGUTAN, BEBANDEM, KARANGASEM, BALI",26,199,1,200
https://kawalpemilu.org#53791,"JUNGUTAN, BEBANDEM, KARANGASEM, BALI",27,183,5,188
https://kawalpemilu.org#53791,"JUNGUTAN, BEBANDEM, KARANGASEM, BALI",28,199,7,206
https://kawalpemilu.org#53791,"JUNGUTAN, BEBANDEM, KARANGASEM, BALI",29,203,13,216
https://kawalpemilu.org#53792,"BUNGAYA KANGIN, BEBANDEM, KARANGASEM, BALI",1,144,9,153
https://kawalpemilu.org#53792,"BUNGAYA KANGIN, BEBANDEM, KARANGASEM, BALI",2,143,4,147
https://kawalpemilu.org#53792,"BUNGAYA KANGIN, BEBANDEM, KARANGASEM, BALI",3,164,9,173
https://kawalpemilu.org#53792,"BUNGAYA KANGIN, BEBANDEM, KARANGASEM, BALI",4,165,12,177
https://kawalpemilu.org#53792,"BUNGAYA KANGIN, BEBANDEM, KARANGASEM, BALI",5,134,7,141
https://kawalpemilu.org#53792,"BUNGAYA KANGIN, BEBANDEM, KARANGASEM, BALI",6,134,17,151
https://kawalpemilu.org#53792,"BUNGAYA KANGIN, BEBANDEM, KARANGASEM, BALI",7,105,8,113
https://kawalpemilu.org#53792,"BUNGAYA KANGIN, BEBANDEM, KARANGASEM, BALI",8,51,100,151
https://kawalpemilu.org#53792,"BUNGAYA KANGIN, BEBANDEM, KARANGASEM, BALI",9,24,143,167
https://kawalpemilu.org#53792,"BUNGAYA KANGIN, BEBANDEM, KARANGASEM, BALI",10,18,257,275
https://kawalpemilu.org#53792,"BUNGAYA KANGIN, BEBANDEM, KARANGASEM, BALI",11,15,234,249
https://kawalpemilu.org#53792,"BUNGAYA KANGIN, BEBANDEM, KARANGASEM, BALI",12,21,163,184
https://kawalpemilu.org#53792,"BUNGAYA KANGIN, BEBANDEM, KARANGASEM, BALI",13,19,208,227
https://kawalpemilu.org#53792,"BUNGAYA KANGIN, BEBANDEM, KARANGASEM, BALI",14,30,165,195
https://kawalpemilu.org#53792,"BUNGAYA KANGIN, BEBANDEM, KARANGASEM, BALI",15,24,222,246
https://kawalpemilu.org#53792,"BUNGAYA KANGIN, BEBANDEM, KARANGASEM, BALI",16,12,263,275
https://kawalpemilu.org#53792,"BUNGAYA KANGIN, BEBANDEM, KARANGASEM, BALI",17,60,162,222
https://kawalpemilu.org#53792,"BUNGAYA KANGIN, BEBANDEM, KARANGASEM, BALI",18,52,146,198
https://kawalpemilu.org#53792,"BUNGAYA KANGIN, BEBANDEM, KARANGASEM, BALI",19,32,140,172
https://kawalpemilu.org#53792,"BUNGAYA KANGIN, BEBANDEM, KARANGASEM, BALI",20,126,19,139
https://kawalpemilu.org#53792,"BUNGAYA KANGIN, BEBANDEM, KARANGASEM, BALI",21,127,12,139
https://kawalpemilu.org#53792,"BUNGAYA KANGIN, BEBANDEM, KARANGASEM, BALI",22,139,5,144
https://kawalpemilu.org#53792,"BUNGAYA KANGIN, BEBANDEM, KARANGASEM, BALI",23,137,2,139
https://kawalpemilu.org#53792,"BUNGAYA KANGIN, BEBANDEM, KARANGASEM, BALI",24,196,8,204
https://kawalpemilu.org#53793,"BUANA GIRI, BEBANDEM, KARANGASEM, BALI",1,157,0,157
https://kawalpemilu.org#53793,"BUANA GIRI, BEBANDEM, KARANGASEM, BALI",2,152,1,153
https://kawalpemilu.org#53793,"BUANA GIRI, BEBANDEM, KARANGASEM, BALI",3,145,2,147
https://kawalpemilu.org#53793,"BUANA GIRI, BEBANDEM, KARANGASEM, BALI",4,134,0,134
https://kawalpemilu.org#53793,"BUANA GIRI, BEBANDEM, KARANGASEM, BALI",5,280,1,281
https://kawalpemilu.org#53793,"BUANA GIRI, BEBANDEM, KARANGASEM, BALI",6,251,6,257
https://kawalpemilu.org#53793,"BUANA GIRI, BEBANDEM, KARANGASEM, BALI",7,192,2,194
https://kawalpemilu.org#53793,"BUANA GIRI, BEBANDEM, KARANGASEM, BALI",8,206,11,217
https://kawalpemilu.org#53793,"BUANA GIRI, BEBANDEM, KARANGASEM, BALI",9,206,6,212
https://kawalpemilu.org#53793,"BUANA GIRI, BEBANDEM, KARANGASEM, BALI",10,145,2,147
https://kawalpemilu.org#53793,"BUANA GIRI, BEBANDEM, KARANGASEM, BALI",11,149,6,155
https://kawalpemilu.org#53793,"BUANA GIRI, BEBANDEM, KARANGASEM, BALI",12,236,3,239
https://kawalpemilu.org#53793,"BUANA GIRI, BEBANDEM, KARANGASEM, BALI",13,241,14,255
https://kawalpemilu.org#53793,"BUANA GIRI, BEBANDEM, KARANGASEM, BALI",14,248,5,253
https://kawalpemilu.org#53793,"BUANA GIRI, BEBANDEM, KARANGASEM, BALI",15,155,25,180
https://kawalpemilu.org#53793,"BUANA GIRI, BEBANDEM, KARANGASEM, BALI",16,196,2,198
https://kawalpemilu.org#53793,"BUANA GIRI, BEBANDEM, KARANGASEM, BALI",17,244,9,253
https://kawalpemilu.org#53793,"BUANA GIRI, BEBANDEM, KARANGASEM, BALI",18,167,2,169
https://kawalpemilu.org#53793,"BUANA GIRI, BEBANDEM, KARANGASEM, BALI",19,122,4,126
https://kawalpemilu.org#53793,"BUANA GIRI, BEBANDEM, KARANGASEM, BALI",20,279,5,284
https://kawalpemilu.org#53793,"BUANA GIRI, BEBANDEM, KARANGASEM, BALI",21,219,6,225
https://kawalpemilu.org#53793,"BUANA GIRI, BEBANDEM, KARANGASEM, BALI",22,123,1,124
https://kawalpemilu.org#53793,"BUANA GIRI, BEBANDEM, KARANGASEM, BALI",23,192,10,202
https://kawalpemilu.org#53793,"BUANA GIRI, BEBANDEM, KARANGASEM, BALI",24,131,3,134
https://kawalpemilu.org#53793,"BUANA GIRI, BEBANDEM, KARANGASEM, BALI",25,192,3,195
https://kawalpemilu.org#53793,"BUANA GIRI, BEBANDEM, KARANGASEM, BALI",26,250,4,254
https://kawalpemilu.org#53794,"MACANG, BEBANDEM, KARANGASEM, BALI",1,236,1,237
https://kawalpemilu.org#53794,"MACANG, BEBANDEM, KARANGASEM, BALI",2,217,8,225
https://kawalpemilu.org#53794,"MACANG, BEBANDEM, KARANGASEM, BALI",3,225,6,231
https://kawalpemilu.org#53794,"MACANG, BEBANDEM, KARANGASEM, BALI",4,203,8,211
https://kawalpemilu.org#53796,"MUNCAN, SELAT, KARANGASEM, BALI",1,158,4,162
https://kawalpemilu.org#53796,"MUNCAN, SELAT, KARANGASEM, BALI",2,142,14,156
https://kawalpemilu.org#53796,"MUNCAN, SELAT, KARANGASEM, BALI",3,105,7,112
https://kawalpemilu.org#53796,"MUNCAN, SELAT, KARANGASEM, BALI",4,185,7,192
https://kawalpemilu.org#53796,"MUNCAN, SELAT, KARANGASEM, BALI",5,206,11,217
https://kawalpemilu.org#53796,"MUNCAN, SELAT, KARANGASEM, BALI",6,176,20,196
https://kawalpemilu.org#53796,"MUNCAN, SELAT, KARANGASEM, BALI",7,151,12,163
https://kawalpemilu.org#53796,"MUNCAN, SELAT, KARANGASEM, BALI",8,157,9,166
https://kawalpemilu.org#53796,"MUNCAN, SELAT, KARANGASEM, BALI",9,163,3,166
https://kawalpemilu.org#53796,"MUNCAN, SELAT, KARANGASEM, BALI",10,124,6,130
https://kawalpemilu.org#53796,"MUNCAN, SELAT, KARANGASEM, BALI",11,114,4,118
https://kawalpemilu.org#53796,"MUNCAN, SELAT, KARANGASEM, BALI",12,222,5,227
https://kawalpemilu.org#53796,"MUNCAN, SELAT, KARANGASEM, BALI",13,173,5,178
https://kawalpemilu.org#53796,"MUNCAN, SELAT, KARANGASEM, BALI",14,160,3,163
https://kawalpemilu.org#53796,"MUNCAN, SELAT, KARANGASEM, BALI",15,143,2,145
https://kawalpemilu.org#53796,"MUNCAN, SELAT, KARANGASEM, BALI",16,194,4,198
https://kawalpemilu.org#53796,"MUNCAN, SELAT, KARANGASEM, BALI",17,173,10,183
https://kawalpemilu.org#53796,"MUNCAN, SELAT, KARANGASEM, BALI",18,197,13,210
https://kawalpemilu.org#53796,"MUNCAN, SELAT, KARANGASEM, BALI",19,181,11,192
https://kawalpemilu.org#53796,"MUNCAN, SELAT, KARANGASEM, BALI",20,151,4,155
https://kawalpemilu.org#53796,"MUNCAN, SELAT, KARANGASEM, BALI",21,137,7,144
https://kawalpemilu.org#53796,"MUNCAN, SELAT, KARANGASEM, BALI",22,171,10,181
https://kawalpemilu.org#53796,"MUNCAN, SELAT, KARANGASEM, BALI",23,143,14,157
https://kawalpemilu.org#53796,"MUNCAN, SELAT, KARANGASEM, BALI",24,209,5,214
https://kawalpemilu.org#53796,"MUNCAN, SELAT, KARANGASEM, BALI",25,154,9,163
https://kawalpemilu.org#53796,"MUNCAN, SELAT, KARANGASEM, BALI",26,152,1,153
https://kawalpemilu.org#53796,"MUNCAN, SELAT, KARANGASEM, BALI",27,156,0,156
https://kawalpemilu.org#53797,"SELAT, SELAT, KARANGASEM, BALI",1,142,3,145
https://kawalpemilu.org#53797,"SELAT, SELAT, KARANGASEM, BALI",2,120,2,122
https://kawalpemilu.org#53797,"SELAT, SELAT, KARANGASEM, BALI",3,126,2,128
https://kawalpemilu.org#53797,"SELAT, SELAT, KARANGASEM, BALI",4,180,1,181
https://kawalpemilu.org#53797,"SELAT, SELAT, KARANGASEM, BALI",5,154,4,158
https://kawalpemilu.org#53797,"SELAT, SELAT, KARANGASEM, BALI",6,167,4,171
https://kawalpemilu.org#53797,"SELAT, SELAT, KARANGASEM, BALI",7,157,8,165
https://kawalpemilu.org#53797,"SELAT, SELAT, KARANGASEM, BALI",8,180,7,187
https://kawalpemilu.org#53797,"SELAT, SELAT, KARANGASEM, BALI",9,181,6,187
https://kawalpemilu.org#53797,"SELAT, SELAT, KARANGASEM, BALI",10,209,4,213
https://kawalpemilu.org#53797,"SELAT, SELAT, KARANGASEM, BALI",11,187,5,192
https://kawalpemilu.org#53798,"DUDA, SELAT, KARANGASEM, BALI",1,217,3,220
https://kawalpemilu.org#53798,"DUDA, SELAT, KARANGASEM, BALI",2,206,4,210
https://kawalpemilu.org#53798,"DUDA, SELAT, KARANGASEM, BALI",3,189,0,189
https://kawalpemilu.org#53798,"DUDA, SELAT, KARANGASEM, BALI",4,185,6,191
https://kawalpemilu.org#53798,"DUDA, SELAT, KARANGASEM, BALI",5,206,4,210
https://kawalpemilu.org#53798,"DUDA, SELAT, KARANGASEM, BALI",6,192,5,197
https://kawalpemilu.org#53798,"DUDA, SELAT, KARANGASEM, BALI",7,180,5,185
https://kawalpemilu.org#53798,"DUDA, SELAT, KARANGASEM, BALI",8,180,5,185
https://kawalpemilu.org#53798,"DUDA, SELAT, KARANGASEM, BALI",9,177,3,180
https://kawalpemilu.org#53798,"DUDA, SELAT, KARANGASEM, BALI",10,227,5,232
https://kawalpemilu.org#53798,"DUDA, SELAT, KARANGASEM, BALI",11,206,0,206
https://kawalpemilu.org#53798,"DUDA, SELAT, KARANGASEM, BALI",12,224,3,227
https://kawalpemilu.org#53798,"DUDA, SELAT, KARANGASEM, BALI",13,228,5,233
https://kawalpemilu.org#53798,"DUDA, SELAT, KARANGASEM, BALI",14,243,5,248
https://kawalpemilu.org#53798,"DUDA, SELAT, KARANGASEM, BALI",15,225,6,231
https://kawalpemilu.org#53798,"DUDA, SELAT, KARANGASEM, BALI",16,241,1,242
https://kawalpemilu.org#53798,"DUDA, SELAT, KARANGASEM, BALI",17,220,3,223
https://kawalpemilu.org#53799,"SEBUDI, SELAT, KARANGASEM, BALI",1,167,1,168
https://kawalpemilu.org#53799,"SEBUDI, SELAT, KARANGASEM, BALI",2,127,4,131
https://kawalpemilu.org#53799,"SEBUDI, SELAT, KARANGASEM, BALI",3,290,1,291
https://kawalpemilu.org#53799,"SEBUDI, SELAT, KARANGASEM, BALI",5,135,0,135
https://kawalpemilu.org#53799,"SEBUDI, SELAT, KARANGASEM, BALI",6,154,19,173
https://kawalpemilu.org#53799,"SEBUDI, SELAT, KARANGASEM, BALI",7,117,58,175
https://kawalpemilu.org#53799,"SEBUDI, SELAT, KARANGASEM, BALI",8,133,12,145
https://kawalpemilu.org#53799,"SEBUDI, SELAT, KARANGASEM, BALI",9,145,5,150
https://kawalpemilu.org#53799,"SEBUDI, SELAT, KARANGASEM, BALI",10,213,18,231
https://kawalpemilu.org#53799,"SEBUDI, SELAT, KARANGASEM, BALI",11,205,15,220
https://kawalpemilu.org#53799,"SEBUDI, SELAT, KARANGASEM, BALI",12,147,5,152
https://kawalpemilu.org#53799,"SEBUDI, SELAT, KARANGASEM, BALI",13,141,2,143
https://kawalpemilu.org#53799,"SEBUDI, SELAT, KARANGASEM, BALI",14,159,7,166
https://kawalpemilu.org#53799,"SEBUDI, SELAT, KARANGASEM, BALI",15,148,0,148
https://kawalpemilu.org#53799,"SEBUDI, SELAT, KARANGASEM, BALI",16,177,30,207
https://kawalpemilu.org#53799,"SEBUDI, SELAT, KARANGASEM, BALI",17,144,34,178
https://kawalpemilu.org#53799,"SEBUDI, SELAT, KARANGASEM, BALI",18,132,41,173
https://kawalpemilu.org#53799,"SEBUDI, SELAT, KARANGASEM, BALI",19,167,40,207
https://kawalpemilu.org#53799,"SEBUDI, SELAT, KARANGASEM, BALI",20,157,46,203
https://kawalpemilu.org#53799,"SEBUDI, SELAT, KARANGASEM, BALI",21,142,11,153
https://kawalpemilu.org#53799,"SEBUDI, SELAT, KARANGASEM, BALI",22,80,1,81
https://kawalpemilu.org#53800,"DUDA UTARA, SELAT, KARANGASEM, BALI",1,203,4,207
https://kawalpemilu.org#53800,"DUDA UTARA, SELAT, KARANGASEM, BALI",2,222,3,225
https://kawalpemilu.org#53800,"DUDA UTARA, SELAT, KARANGASEM, BALI",3,116,3,119
https://kawalpemilu.org#53800,"DUDA UTARA, SELAT, KARANGASEM, BALI",4,138,3,141
https://kawalpemilu.org#53800,"DUDA UTARA, SELAT, KARANGASEM, BALI",5,241,18,259
https://kawalpemilu.org#53800,"DUDA UTARA, SELAT, KARANGASEM, BALI",6,248,16,264
https://kawalpemilu.org#53800,"DUDA UTARA, SELAT, KARANGASEM, BALI",7,150,2,152
https://kawalpemilu.org#53800,"DUDA UTARA, SELAT, KARANGASEM, BALI",8,143,7,150
https://kawalpemilu.org#53800,"DUDA UTARA, SELAT, KARANGASEM, BALI",10,169,5,174
https://kawalpemilu.org#53800,"DUDA UTARA, SELAT, KARANGASEM, BALI",11,182,12,194
https://kawalpemilu.org#53800,"DUDA UTARA, SELAT, KARANGASEM, BALI",12,188,14,202
https://kawalpemilu.org#53800,"DUDA UTARA, SELAT, KARANGASEM, BALI",13,173,7,180
https://kawalpemilu.org#53800,"DUDA UTARA, SELAT, KARANGASEM, BALI",14,226,6,232
https://kawalpemilu.org#53800,"DUDA UTARA, SELAT, KARANGASEM, BALI",15,204,8,212
https://kawalpemilu.org#53800,"DUDA UTARA, SELAT, KARANGASEM, BALI",16,191,18,209
https://kawalpemilu.org#53800,"DUDA UTARA, SELAT, KARANGASEM, BALI",17,195,3,198
https://kawalpemilu.org#53800,"DUDA UTARA, SELAT, KARANGASEM, BALI",18,206,0,206
https://kawalpemilu.org#53800,"DUDA UTARA, SELAT, KARANGASEM, BALI",19,203,1,204
https://kawalpemilu.org#53800,"DUDA UTARA, SELAT, KARANGASEM, BALI",20,147,9,156
https://kawalpemilu.org#53800,"DUDA UTARA, SELAT, KARANGASEM, BALI",21,152,15,167
https://kawalpemilu.org#53800,"DUDA UTARA, SELAT, KARANGASEM, BALI",22,171,11,182
https://kawalpemilu.org#53800,"DUDA UTARA, SELAT, KARANGASEM, BALI",23,177,13,190
https://kawalpemilu.org#53800,"DUDA UTARA, SELAT, KARANGASEM, BALI",24,140,16,156
https://kawalpemilu.org#53800,"DUDA UTARA, SELAT, KARANGASEM, BALI",25,195,13,208
https://kawalpemilu.org#53801,"DUDA TIMUR, SELAT, KARANGASEM, BALI",1,222,11,233
https://kawalpemilu.org#53801,"DUDA TIMUR, SELAT, KARANGASEM, BALI",2,222,4,226
https://kawalpemilu.org#53801,"DUDA TIMUR, SELAT, KARANGASEM, BALI",3,159,8,167
https://kawalpemilu.org#53801,"DUDA TIMUR, SELAT, KARANGASEM, BALI",4,193,4,197
https://kawalpemilu.org#53801,"DUDA TIMUR, SELAT, KARANGASEM, BALI",5,174,2,176
https://kawalpemilu.org#53801,"DUDA TIMUR, SELAT, KARANGASEM, BALI",6,129,1,130
https://kawalpemilu.org#53801,"DUDA TIMUR, SELAT, KARANGASEM, BALI",7,181,7,188
https://kawalpemilu.org#53801,"DUDA TIMUR, SELAT, KARANGASEM, BALI",8,173,14,187
https://kawalpemilu.org#53801,"DUDA TIMUR, SELAT, KARANGASEM, BALI",10,190,3,193
https://kawalpemilu.org#53801,"DUDA TIMUR, SELAT, KARANGASEM, BALI",11,176,3,179
https://kawalpemilu.org#53801,"DUDA TIMUR, SELAT, KARANGASEM, BALI",12,193,5,198
https://kawalpemilu.org#53801,"DUDA TIMUR, SELAT, KARANGASEM, BALI",13,214,7,221
https://kawalpemilu.org#53801,"DUDA TIMUR, SELAT, KARANGASEM, BALI",14,174,2,176
https://kawalpemilu.org#53801,"DUDA TIMUR, SELAT, KARANGASEM, BALI",15,227,3,230
https://kawalpemilu.org#53801,"DUDA TIMUR, SELAT, KARANGASEM, BALI",16,249,4,253
https://kawalpemilu.org#53801,"DUDA TIMUR, SELAT, KARANGASEM, BALI",17,180,7,187
https://kawalpemilu.org#53801,"DUDA TIMUR, SELAT, KARANGASEM, BALI",18,265,4,269
https://kawalpemilu.org#53801,"DUDA TIMUR, SELAT, KARANGASEM, BALI",19,266,1,267
https://kawalpemilu.org#53801,"DUDA TIMUR, SELAT, KARANGASEM, BALI",20,185,6,191
https://kawalpemilu.org#53801,"DUDA TIMUR, SELAT, KARANGASEM, BALI",21,110,1,111
https://kawalpemilu.org#53802,"PERING SARI, SELAT, KARANGASEM, BALI",1,180,9,189
https://kawalpemilu.org#53802,"PERING SARI, SELAT, KARANGASEM, BALI",2,199,6,205
https://kawalpemilu.org#53802,"PERING SARI, SELAT, KARANGASEM, BALI",3,183,5,188
https://kawalpemilu.org#53802,"PERING SARI, SELAT, KARANGASEM, BALI",4,177,4,181
https://kawalpemilu.org#53802,"PERING SARI, SELAT, KARANGASEM, BALI",5,162,3,165
https://kawalpemilu.org#53802,"PERING SARI, SELAT, KARANGASEM, BALI",6,211,2,213
https://kawalpemilu.org#53802,"PERING SARI, SELAT, KARANGASEM, BALI",7,188,2,190
https://kawalpemilu.org#53802,"PERING SARI, SELAT, KARANGASEM, BALI",8,161,9,170
https://kawalpemilu.org#53802,"PERING SARI, SELAT, KARANGASEM, BALI",9,197,3,200
https://kawalpemilu.org#53802,"PERING SARI, SELAT, KARANGASEM, BALI",10,164,3,167
https://kawalpemilu.org#53802,"PERING SARI, SELAT, KARANGASEM, BALI",11,192,13,205
https://kawalpemilu.org#53802,"PERING SARI, SELAT, KARANGASEM, BALI",12,172,10,182
https://kawalpemilu.org#53802,"PERING SARI, SELAT, KARANGASEM, BALI",13,171,14,185
https://kawalpemilu.org#53802,"PERING SARI, SELAT, KARANGASEM, BALI",14,208,19,227
https://kawalpemilu.org#53802,"PERING SARI, SELAT, KARANGASEM, BALI",15,201,18,219
https://kawalpemilu.org#53802,"PERING SARI, SELAT, KARANGASEM, BALI",16,226,4,230
https://kawalpemilu.org#53802,"PERING SARI, SELAT, KARANGASEM, BALI",17,120,2,122
https://kawalpemilu.org#53802,"PERING SARI, SELAT, KARANGASEM, BALI",18,139,4,143
https://kawalpemilu.org#53802,"PERING SARI, SELAT, KARANGASEM, BALI",19,137,0,137
https://kawalpemilu.org#53802,"PERING SARI, SELAT, KARANGASEM, BALI",20,147,10,157
https://kawalpemilu.org#53802,"PERING SARI, SELAT, KARANGASEM, BALI",21,137,12,149
https://kawalpemilu.org#53802,"PERING SARI, SELAT, KARANGASEM, BALI",22,124,0,124
https://kawalpemilu.org#53803,"AMERTA BHUANA, SELAT, KARANGASEM, BALI",1,189,3,192
https://kawalpemilu.org#53803,"AMERTA BHUANA, SELAT, KARANGASEM, BALI",2,180,6,186
https://kawalpemilu.org#53803,"AMERTA BHUANA, SELAT, KARANGASEM, BALI",3,187,6,193
https://kawalpemilu.org#53803,"AMERTA BHUANA, SELAT, KARANGASEM, BALI",4,178,5,183
https://kawalpemilu.org#53803,"AMERTA BHUANA, SELAT, KARANGASEM, BALI",5,207,12,219
https://kawalpemilu.org#53803,"AMERTA BHUANA, SELAT, KARANGASEM, BALI",6,191,10,201
https://kawalpemilu.org#53803,"AMERTA BHUANA, SELAT, KARANGASEM, BALI",7,171,10,181
https://kawalpemilu.org#53803,"AMERTA BHUANA, SELAT, KARANGASEM, BALI",8,164,8,172
https://kawalpemilu.org#53803,"AMERTA BHUANA, SELAT, KARANGASEM, BALI",9,148,7,155
https://kawalpemilu.org#53803,"AMERTA BHUANA, SELAT, KARANGASEM, BALI",10,141,10,151
https://kawalpemilu.org#53803,"AMERTA BHUANA, SELAT, KARANGASEM, BALI",11,143,8,151
https://kawalpemilu.org#53803,"AMERTA BHUANA, SELAT, KARANGASEM, BALI",12,132,6,138
https://kawalpemilu.org#53805,"BAN, KUBU, KARANGASEM, BALI",1,154,3,157
https://kawalpemilu.org#53805,"BAN, KUBU, KARANGASEM, BALI",2,164,3,167
https://kawalpemilu.org#53805,"BAN, KUBU, KARANGASEM, BALI",3,153,9,162
https://kawalpemilu.org#53805,"BAN, KUBU, KARANGASEM, BALI",4,185,1,186
https://kawalpemilu.org#53805,"BAN, KUBU, KARANGASEM, BALI",5,197,7,204
https://kawalpemilu.org#53805,"BAN, KUBU, KARANGASEM, BALI",6,128,43,171
https://kawalpemilu.org#53805,"BAN, KUBU, KARANGASEM, BALI",7,123,46,169
https://kawalpemilu.org#53805,"BAN, KUBU, KARANGASEM, BALI",8,229,10,239
https://kawalpemilu.org#53805,"BAN, KUBU, KARANGASEM, BALI",9,152,5,157
https://kawalpemilu.org#53805,"BAN, KUBU, KARANGASEM, BALI",10,226,25,251
https://kawalpemilu.org#53805,"BAN, KUBU, KARANGASEM, BALI",11,153,7,160
https://kawalpemilu.org#53805,"BAN, KUBU, KARANGASEM, BALI",12,143,32,175
https://kawalpemilu.org#53805,"BAN, KUBU, KARANGASEM, BALI",13,144,21,165
https://kawalpemilu.org#53805,"BAN, KUBU, KARANGASEM, BALI",14,131,3,134
https://kawalpemilu.org#53805,"BAN, KUBU, KARANGASEM, BALI",15,140,4,144
https://kawalpemilu.org#53805,"BAN, KUBU, KARANGASEM, BALI",16,137,9,146
https://kawalpemilu.org#53805,"BAN, KUBU, KARANGASEM, BALI",17,142,5,147
https://kawalpemilu.org#53805,"BAN, KUBU, KARANGASEM, BALI",18,131,11,142
https://kawalpemilu.org#53805,"BAN, KUBU, KARANGASEM, BALI",19,127,7,134
https://kawalpemilu.org#53805,"BAN, KUBU, KARANGASEM, BALI",20,132,4,136
https://kawalpemilu.org#53805,"BAN, KUBU, KARANGASEM, BALI",21,141,1,142
https://kawalpemilu.org#53805,"BAN, KUBU, KARANGASEM, BALI",22,171,1,172
https://kawalpemilu.org#53805,"BAN, KUBU, KARANGASEM, BALI",23,224,7,231
https://kawalpemilu.org#53805,"BAN, KUBU, KARANGASEM, BALI",24,126,14,140
https://kawalpemilu.org#53805,"BAN, KUBU, KARANGASEM, BALI",25,103,12,115
https://kawalpemilu.org#53805,"BAN, KUBU, KARANGASEM, BALI",26,137,12,149
https://kawalpemilu.org#53805,"BAN, KUBU, KARANGASEM, BALI",27,128,5,133
https://kawalpemilu.org#53805,"BAN, KUBU, KARANGASEM, BALI",29,118,9,127
https://kawalpemilu.org#53805,"BAN, KUBU, KARANGASEM, BALI",30,99,5,104
https://kawalpemilu.org#53805,"BAN, KUBU, KARANGASEM, BALI",31,188,21,209
https://kawalpemilu.org#53805,"BAN, KUBU, KARANGASEM, BALI",32,132,15,147
https://kawalpemilu.org#53805,"BAN, KUBU, KARANGASEM, BALI",33,130,9,139
https://kawalpemilu.org#53805,"BAN, KUBU, KARANGASEM, BALI",34,125,3,128
https://kawalpemilu.org#53805,"BAN, KUBU, KARANGASEM, BALI",35,116,2,118
https://kawalpemilu.org#53805,"BAN, KUBU, KARANGASEM, BALI",36,118,5,123
https://kawalpemilu.org#53805,"BAN, KUBU, KARANGASEM, BALI",37,111,11,122
https://kawalpemilu.org#53805,"BAN, KUBU, KARANGASEM, BALI",38,126,0,126
https://kawalpemilu.org#53805,"BAN, KUBU, KARANGASEM, BALI",39,119,0,119
https://kawalpemilu.org#53805,"BAN, KUBU, KARANGASEM, BALI",40,123,4,127
https://kawalpemilu.org#53805,"BAN, KUBU, KARANGASEM, BALI",41,130,4,134
https://kawalpemilu.org#53805,"BAN, KUBU, KARANGASEM, BALI",42,122,7,129
https://kawalpemilu.org#53805,"BAN, KUBU, KARANGASEM, BALI",43,143,1,144
https://kawalpemilu.org#53805,"BAN, KUBU, KARANGASEM, BALI",44,129,4,133
https://kawalpemilu.org#53805,"BAN, KUBU, KARANGASEM, BALI",45,124,2,126
https://kawalpemilu.org#53805,"BAN, KUBU, KARANGASEM, BALI",46,147,3,150
https://kawalpemilu.org#53805,"BAN, KUBU, KARANGASEM, BALI",47,146,6,152
https://kawalpemilu.org#53805,"BAN, KUBU, KARANGASEM, BALI",48,107,5,112
https://kawalpemilu.org#53806,"DUKUH, KUBU, KARANGASEM, BALI",1,148,19,167
https://kawalpemilu.org#53806,"DUKUH, KUBU, KARANGASEM, BALI",2,150,18,168
https://kawalpemilu.org#53806,"DUKUH, KUBU, KARANGASEM, BALI",3,184,28,212
https://kawalpemilu.org#53806,"DUKUH, KUBU, KARANGASEM, BALI",4,177,39,216
https://kawalpemilu.org#53806,"DUKUH, KUBU, KARANGASEM, BALI",5,154,48,202
https://kawalpemilu.org#53806,"DUKUH, KUBU, KARANGASEM, BALI",6,153,19,172
https://kawalpemilu.org#53806,"DUKUH, KUBU, KARANGASEM, BALI",7,122,20,142
https://kawalpemilu.org#53806,"DUKUH, KUBU, KARANGASEM, BALI",8,132,9,141
https://kawalpemilu.org#53806,"DUKUH, KUBU, KARANGASEM, BALI",9,190,8,198
https://kawalpemilu.org#53806,"DUKUH, KUBU, KARANGASEM, BALI",10,191,12,203
https://kawalpemilu.org#53806,"DUKUH, KUBU, KARANGASEM, BALI",11,100,64,164
https://kawalpemilu.org#53806,"DUKUH, KUBU, KARANGASEM, BALI",12,96,40,136
https://kawalpemilu.org#53806,"DUKUH, KUBU, KARANGASEM, BALI",13,89,46,135
https://kawalpemilu.org#53806,"DUKUH, KUBU, KARANGASEM, BALI",14,97,19,116
https://kawalpemilu.org#53806,"DUKUH, KUBU, KARANGASEM, BALI",15,76,14,90
https://kawalpemilu.org#53806,"DUKUH, KUBU, KARANGASEM, BALI",16,183,6,189
https://kawalpemilu.org#53807,"KUBU, KUBU, KARANGASEM, BALI",1,168,9,177
https://kawalpemilu.org#53807,"KUBU, KUBU, KARANGASEM, BALI",2,170,14,184
https://kawalpemilu.org#53807,"KUBU, KUBU, KARANGASEM, BALI",3,187,3,190
https://kawalpemilu.org#53807,"KUBU, KUBU, KARANGASEM, BALI",4,180,9,189
https://kawalpemilu.org#53807,"KUBU, KUBU, KARANGASEM, BALI",5,171,10,181
https://kawalpemilu.org#53807,"KUBU, KUBU, KARANGASEM, BALI",6,121,7,128
https://kawalpemilu.org#53807,"KUBU, KUBU, KARANGASEM, BALI",7,119,9,128
https://kawalpemilu.org#53807,"KUBU, KUBU, KARANGASEM, BALI",8,193,4,197
https://kawalpemilu.org#53807,"KUBU, KUBU, KARANGASEM, BALI",9,189,3,192
https://kawalpemilu.org#53807,"KUBU, KUBU, KARANGASEM, BALI",10,179,6,185
https://kawalpemilu.org#53807,"KUBU, KUBU, KARANGASEM, BALI",11,192,10,202
https://kawalpemilu.org#53807,"KUBU, KUBU, KARANGASEM, BALI",12,213,9,222
https://kawalpemilu.org#53807,"KUBU, KUBU, KARANGASEM, BALI",13,202,3,205
https://kawalpemilu.org#53807,"KUBU, KUBU, KARANGASEM, BALI",14,214,1,215
https://kawalpemilu.org#53808,"TIANYAR, KUBU, KARANGASEM, BALI",1,191,1,192
https://kawalpemilu.org#53808,"TIANYAR, KUBU, KARANGASEM, BALI",2,179,2,181
https://kawalpemilu.org#53808,"TIANYAR, KUBU, KARANGASEM, BALI",3,119,4,123
https://kawalpemilu.org#53808,"TIANYAR, KUBU, KARANGASEM, BALI",4,102,9,111
https://kawalpemilu.org#53808,"TIANYAR, KUBU, KARANGASEM, BALI",5,85,8,93
https://kawalpemilu.org#53808,"TIANYAR, KUBU, KARANGASEM, BALI",6,99,5,104
https://kawalpemilu.org#53808,"TIANYAR, KUBU, KARANGASEM, BALI",7,172,5,177
https://kawalpemilu.org#53808,"TIANYAR, KUBU, KARANGASEM, BALI",8,163,8,171
https://kawalpemilu.org#53808,"TIANYAR, KUBU, KARANGASEM, BALI",9,86,4,90
https://kawalpemilu.org#53808,"TIANYAR, KUBU, KARANGASEM, BALI",10,105,3,108
https://kawalpemilu.org#53808,"TIANYAR, KUBU, KARANGASEM, BALI",11,111,2,113
https://kawalpemilu.org#53808,"TIANYAR, KUBU, KARANGASEM, BALI",12,156,2,158
https://kawalpemilu.org#53808,"TIANYAR, KUBU, KARANGASEM, BALI",13,93,1,94
https://kawalpemilu.org#53808,"TIANYAR, KUBU, KARANGASEM, BALI",14,132,3,135
https://kawalpemilu.org#53808,"TIANYAR, KUBU, KARANGASEM, BALI",15,143,2,145
https://kawalpemilu.org#53808,"TIANYAR, KUBU, KARANGASEM, BALI",16,112,4,116
https://kawalpemilu.org#53808,"TIANYAR, KUBU, KARANGASEM, BALI",17,85,1,86
https://kawalpemilu.org#53808,"TIANYAR, KUBU, KARANGASEM, BALI",18,104,2,106
https://kawalpemilu.org#53808,"TIANYAR, KUBU, KARANGASEM, BALI",19,101,2,103
https://kawalpemilu.org#53808,"TIANYAR, KUBU, KARANGASEM, BALI",20,119,4,123
https://kawalpemilu.org#53808,"TIANYAR, KUBU, KARANGASEM, BALI",21,128,5,133
https://kawalpemilu.org#53808,"TIANYAR, KUBU, KARANGASEM, BALI",22,147,9,156
https://kawalpemilu.org#53808,"TIANYAR, KUBU, KARANGASEM, BALI",23,47,2,49
https://kawalpemilu.org#53808,"TIANYAR, KUBU, KARANGASEM, BALI",24,150,1,151
https://kawalpemilu.org#53808,"TIANYAR, KUBU, KARANGASEM, BALI",25,112,2,114
https://kawalpemilu.org#53808,"TIANYAR, KUBU, KARANGASEM, BALI",26,102,3,105
https://kawalpemilu.org#53808,"TIANYAR, KUBU, KARANGASEM, BALI",28,108,13,121
https://kawalpemilu.org#53808,"TIANYAR, KUBU, KARANGASEM, BALI",29,104,5,109
https://kawalpemilu.org#53808,"TIANYAR, KUBU, KARANGASEM, BALI",30,105,4,109
https://kawalpemilu.org#53808,"TIANYAR, KUBU, KARANGASEM, BALI",31,105,6,111
https://kawalpemilu.org#53808,"TIANYAR, KUBU, KARANGASEM, BALI",32,144,9,153
https://kawalpemilu.org#53808,"TIANYAR, KUBU, KARANGASEM, BALI",33,93,4,97
https://kawalpemilu.org#53808,"TIANYAR, KUBU, KARANGASEM, BALI",34,85,6,91
https://kawalpemilu.org#53808,"TIANYAR, KUBU, KARANGASEM, BALI",35,135,3,138
https://kawalpemilu.org#53808,"TIANYAR, KUBU, KARANGASEM, BALI",36,133,4,137
https://kawalpemilu.org#53808,"TIANYAR, KUBU, KARANGASEM, BALI",37,87,4,91
https://kawalpemilu.org#53808,"TIANYAR, KUBU, KARANGASEM, BALI",38,117,6,123
https://kawalpemilu.org#53808,"TIANYAR, KUBU, KARANGASEM, BALI",39,49,7,56
https://kawalpemilu.org#53808,"TIANYAR, KUBU, KARANGASEM, BALI",40,91,2,93
https://kawalpemilu.org#53808,"TIANYAR, KUBU, KARANGASEM, BALI",41,92,3,95
https://kawalpemilu.org#53808,"TIANYAR, KUBU, KARANGASEM, BALI",42,106,5,111
https://kawalpemilu.org#53808,"TIANYAR, KUBU, KARANGASEM, BALI",43,80,0,80
https://kawalpemilu.org#53808,"TIANYAR, KUBU, KARANGASEM, BALI",44,86,4,90
https://kawalpemilu.org#53808,"TIANYAR, KUBU, KARANGASEM, BALI",45,89,5,94
https://kawalpemilu.org#53808,"TIANYAR, KUBU, KARANGASEM, BALI",46,162,1,163
https://kawalpemilu.org#53808,"TIANYAR, KUBU, KARANGASEM, BALI",47,136,10,146
https://kawalpemilu.org#53808,"TIANYAR, KUBU, KARANGASEM, BALI",48,133,12,145
https://kawalpemilu.org#53808,"TIANYAR, KUBU, KARANGASEM, BALI",49,139,8,147
https://kawalpemilu.org#53808,"TIANYAR, KUBU, KARANGASEM, BALI",50,111,0,111
https://kawalpemilu.org#53808,"TIANYAR, KUBU, KARANGASEM, BALI",51,96,3,99
https://kawalpemilu.org#53808,"TIANYAR, KUBU, KARANGASEM, BALI",52,111,8,119
https://kawalpemilu.org#53808,"TIANYAR, KUBU, KARANGASEM, BALI",53,101,13,114
https://kawalpemilu.org#53808,"TIANYAR, KUBU, KARANGASEM, BALI",54,127,12,139
https://kawalpemilu.org#53808,"TIANYAR, KUBU, KARANGASEM, BALI",55,132,8,140
https://kawalpemilu.org#53809,"TIANYAR BARAT, KUBU, KARANGASEM, BALI",1,143,3,146
https://kawalpemilu.org#53809,"TIANYAR BARAT, KUBU, KARANGASEM, BALI",2,138,3,141
https://kawalpemilu.org#53809,"TIANYAR BARAT, KUBU, KARANGASEM, BALI",3,126,7,133
https://kawalpemilu.org#53809,"TIANYAR BARAT, KUBU, KARANGASEM, BALI",4,96,0,96
https://kawalpemilu.org#53809,"TIANYAR BARAT, KUBU, KARANGASEM, BALI",5,103,3,106
https://kawalpemilu.org#53809,"TIANYAR BARAT, KUBU, KARANGASEM, BALI",6,82,2,84
https://kawalpemilu.org#53809,"TIANYAR BARAT, KUBU, KARANGASEM, BALI",7,70,4,74
https://kawalpemilu.org#53809,"TIANYAR BARAT, KUBU, KARANGASEM, BALI",8,105,4,109
https://kawalpemilu.org#53809,"TIANYAR BARAT, KUBU, KARANGASEM, BALI",9,92,1,93
https://kawalpemilu.org#53809,"TIANYAR BARAT, KUBU, KARANGASEM, BALI",10,145,2,147
https://kawalpemilu.org#53809,"TIANYAR BARAT, KUBU, KARANGASEM, BALI",11,76,4,80
https://kawalpemilu.org#53809,"TIANYAR BARAT, KUBU, KARANGASEM, BALI",12,126,5,131
https://kawalpemilu.org#53809,"TIANYAR BARAT, KUBU, KARANGASEM, BALI",13,130,6,136
https://kawalpemilu.org#53809,"TIANYAR BARAT, KUBU, KARANGASEM, BALI",14,122,10,132
https://kawalpemilu.org#53809,"TIANYAR BARAT, KUBU, KARANGASEM, BALI",15,132,5,137
https://kawalpemilu.org#53809,"TIANYAR BARAT, KUBU, KARANGASEM, BALI",16,160,2,162
https://kawalpemilu.org#53809,"TIANYAR BARAT, KUBU, KARANGASEM, BALI",17,135,3,138
https://kawalpemilu.org#53809,"TIANYAR BARAT, KUBU, KARANGASEM, BALI",18,183,0,183
https://kawalpemilu.org#53809,"TIANYAR BARAT, KUBU, KARANGASEM, BALI",19,127,2,129
https://kawalpemilu.org#53809,"TIANYAR BARAT, KUBU, KARANGASEM, BALI",20,134,0,134
https://kawalpemilu.org#53809,"TIANYAR BARAT, KUBU, KARANGASEM, BALI",21,117,2,119
https://kawalpemilu.org#53809,"TIANYAR BARAT, KUBU, KARANGASEM, BALI",22,151,3,154
https://kawalpemilu.org#53809,"TIANYAR BARAT, KUBU, KARANGASEM, BALI",23,111,19,130
https://kawalpemilu.org#53809,"TIANYAR BARAT, KUBU, KARANGASEM, BALI",24,102,3,105
https://kawalpemilu.org#53809,"TIANYAR BARAT, KUBU, KARANGASEM, BALI",25,86,1,87
https://kawalpemilu.org#53809,"TIANYAR BARAT, KUBU, KARANGASEM, BALI",26,130,6,136
https://kawalpemilu.org#53809,"TIANYAR BARAT, KUBU, KARANGASEM, BALI",27,139,5,144
https://kawalpemilu.org#53809,"TIANYAR BARAT, KUBU, KARANGASEM, BALI",28,154,5,159
https://kawalpemilu.org#53809,"TIANYAR BARAT, KUBU, KARANGASEM, BALI",29,148,6,154
https://kawalpemilu.org#53809,"TIANYAR BARAT, KUBU, KARANGASEM, BALI",30,99,1,100
https://kawalpemilu.org#53809,"TIANYAR BARAT, KUBU, KARANGASEM, BALI",31,97,5,102
https://kawalpemilu.org#53809,"TIANYAR BARAT, KUBU, KARANGASEM, BALI",32,118,5,123
https://kawalpemilu.org#53809,"TIANYAR BARAT, KUBU, KARANGASEM, BALI",33,156,16,172
https://kawalpemilu.org#53809,"TIANYAR BARAT, KUBU, KARANGASEM, BALI",34,195,29,224
https://kawalpemilu.org#53809,"TIANYAR BARAT, KUBU, KARANGASEM, BALI",35,175,13,188
https://kawalpemilu.org#53809,"TIANYAR BARAT, KUBU, KARANGASEM, BALI",37,203,12,215
https://kawalpemilu.org#53809,"TIANYAR BARAT, KUBU, KARANGASEM, BALI",38,134,14,148
https://kawalpemilu.org#53809,"TIANYAR BARAT, KUBU, KARANGASEM, BALI",39,98,10,108
https://kawalpemilu.org#53809,"TIANYAR BARAT, KUBU, KARANGASEM, BALI",40,176,26,202
https://kawalpemilu.org#53809,"TIANYAR BARAT, KUBU, KARANGASEM, BALI",41,230,36,266
https://kawalpemilu.org#53809,"TIANYAR BARAT, KUBU, KARANGASEM, BALI",42,165,11,176
https://kawalpemilu.org#53809,"TIANYAR BARAT, KUBU, KARANGASEM, BALI",43,144,30,174
https://kawalpemilu.org#53809,"TIANYAR BARAT, KUBU, KARANGASEM, BALI",44,102,23,125
https://kawalpemilu.org#53809,"TIANYAR BARAT, KUBU, KARANGASEM, BALI",45,139,4,143
https://kawalpemilu.org#53809,"TIANYAR BARAT, KUBU, KARANGASEM, BALI",46,130,2,132
https://kawalpemilu.org#53809,"TIANYAR BARAT, KUBU, KARANGASEM, BALI",47,146,12,158
https://kawalpemilu.org#53809,"TIANYAR BARAT, KUBU, KARANGASEM, BALI",48,128,3,131
https://kawalpemilu.org#53809,"TIANYAR BARAT, KUBU, KARANGASEM, BALI",49,149,10,159
https://kawalpemilu.org#53809,"TIANYAR BARAT, KUBU, KARANGASEM, BALI",50,155,4,159
https://kawalpemilu.org#53810,"TIANYAR TENGAH, KUBU, KARANGASEM, BALI",1,191,17,208
https://kawalpemilu.org#53810,"TIANYAR TENGAH, KUBU, KARANGASEM, BALI",2,183,7,190
https://kawalpemilu.org#53810,"TIANYAR TENGAH, KUBU, KARANGASEM, BALI",3,173,10,183
https://kawalpemilu.org#53810,"TIANYAR TENGAH, KUBU, KARANGASEM, BALI",4,156,10,166
https://kawalpemilu.org#53810,"TIANYAR TENGAH, KUBU, KARANGASEM, BALI",5,159,14,173
https://kawalpemilu.org#53810,"TIANYAR TENGAH, KUBU, KARANGASEM, BALI",6,200,2,202
https://kawalpemilu.org#53810,"TIANYAR TENGAH, KUBU, KARANGASEM, BALI",7,190,4,194
https://kawalpemilu.org#53810,"TIANYAR TENGAH, KUBU, KARANGASEM, BALI",8,160,40,200
https://kawalpemilu.org#53810,"TIANYAR TENGAH, KUBU, KARANGASEM, BALI",9,186,18,204
https://kawalpemilu.org#53810,"TIANYAR TENGAH, KUBU, KARANGASEM, BALI",10,131,8,139
https://kawalpemilu.org#53810,"TIANYAR TENGAH, KUBU, KARANGASEM, BALI",11,112,13,125
https://kawalpemilu.org#53810,"TIANYAR TENGAH, KUBU, KARANGASEM, BALI",12,108,10,118
https://kawalpemilu.org#53810,"TIANYAR TENGAH, KUBU, KARANGASEM, BALI",13,129,10,139
https://kawalpemilu.org#53810,"TIANYAR TENGAH, KUBU, KARANGASEM, BALI",14,137,4,141
https://kawalpemilu.org#53810,"TIANYAR TENGAH, KUBU, KARANGASEM, BALI",15,103,6,109
https://kawalpemilu.org#53810,"TIANYAR TENGAH, KUBU, KARANGASEM, BALI",16,123,19,142
https://kawalpemilu.org#53810,"TIANYAR TENGAH, KUBU, KARANGASEM, BALI",17,123,3,126
https://kawalpemilu.org#53810,"TIANYAR TENGAH, KUBU, KARANGASEM, BALI",18,113,5,118
https://kawalpemilu.org#53810,"TIANYAR TENGAH, KUBU, KARANGASEM, BALI",19,146,6,152
https://kawalpemilu.org#53810,"TIANYAR TENGAH, KUBU, KARANGASEM, BALI",20,120,4,124
https://kawalpemilu.org#53810,"TIANYAR TENGAH, KUBU, KARANGASEM, BALI",21,97,3,100
https://kawalpemilu.org#53810,"TIANYAR TENGAH, KUBU, KARANGASEM, BALI",22,162,21,183
https://kawalpemilu.org#53810,"TIANYAR TENGAH, KUBU, KARANGASEM, BALI",23,120,11,131
https://kawalpemilu.org#53810,"TIANYAR TENGAH, KUBU, KARANGASEM, BALI",24,103,15,118
https://kawalpemilu.org#53810,"TIANYAR TENGAH, KUBU, KARANGASEM, BALI",25,90,5,95
https://kawalpemilu.org#53810,"TIANYAR TENGAH, KUBU, KARANGASEM, BALI",26,110,3,113
https://kawalpemilu.org#53810,"TIANYAR TENGAH, KUBU, KARANGASEM, BALI",27,135,7,142
https://kawalpemilu.org#53810,"TIANYAR TENGAH, KUBU, KARANGASEM, BALI",28,135,13,148
https://kawalpemilu.org#53810,"TIANYAR TENGAH, KUBU, KARANGASEM, BALI",29,125,11,136
https://kawalpemilu.org#53810,"TIANYAR TENGAH, KUBU, KARANGASEM, BALI",30,106,9,115
https://kawalpemilu.org#53810,"TIANYAR TENGAH, KUBU, KARANGASEM, BALI",31,110,2,112
https://kawalpemilu.org#53811,"TULAMBEN, KUBU, KARANGASEM, BALI",1,171,4,175
https://kawalpemilu.org#53811,"TULAMBEN, KUBU, KARANGASEM, BALI",2,161,7,168
https://kawalpemilu.org#53811,"TULAMBEN, KUBU, KARANGASEM, BALI",3,197,7,204
https://kawalpemilu.org#53811,"TULAMBEN, KUBU, KARANGASEM, BALI",4,186,11,197
https://kawalpemilu.org#53811,"TULAMBEN, KUBU, KARANGASEM, BALI",5,182,15,197
https://kawalpemilu.org#53811,"TULAMBEN, KUBU, KARANGASEM, BALI",6,182,11,193
https://kawalpemilu.org#53811,"TULAMBEN, KUBU, KARANGASEM, BALI",7,192,20,212
https://kawalpemilu.org#53811,"TULAMBEN, KUBU, KARANGASEM, BALI",8,103,17,120
https://kawalpemilu.org#53811,"TULAMBEN, KUBU, KARANGASEM, BALI",9,113,9,122
https://kawalpemilu.org#53811,"TULAMBEN, KUBU, KARANGASEM, BALI",10,144,7,151
https://kawalpemilu.org#53811,"TULAMBEN, KUBU, KARANGASEM, BALI",11,145,6,151
https://kawalpemilu.org#53811,"TULAMBEN, KUBU, KARANGASEM, BALI",12,126,9,135
https://kawalpemilu.org#53811,"TULAMBEN, KUBU, KARANGASEM, BALI",13,112,7,119
https://kawalpemilu.org#53811,"TULAMBEN, KUBU, KARANGASEM, BALI",14,146,5,151
https://kawalpemilu.org#53811,"TULAMBEN, KUBU, KARANGASEM, BALI",15,123,3,126
https://kawalpemilu.org#53811,"TULAMBEN, KUBU, KARANGASEM, BALI",16,182,7,189
https://kawalpemilu.org#53811,"TULAMBEN, KUBU, KARANGASEM, BALI",17,159,5,164
https://kawalpemilu.org#53811,"TULAMBEN, KUBU, KARANGASEM, BALI",18,163,3,166
https://kawalpemilu.org#53811,"TULAMBEN, KUBU, KARANGASEM, BALI",19,165,11,176
https://kawalpemilu.org#53811,"TULAMBEN, KUBU, KARANGASEM, BALI",20,203,1,204
https://kawalpemilu.org#53811,"TULAMBEN, KUBU, KARANGASEM, BALI",21,177,4,181
https://kawalpemilu.org#53811,"TULAMBEN, KUBU, KARANGASEM, BALI",22,154,13,167
https://kawalpemilu.org#53811,"TULAMBEN, KUBU, KARANGASEM, BALI",23,148,6,154
https://kawalpemilu.org#53811,"TULAMBEN, KUBU, KARANGASEM, BALI",24,182,4,186
https://kawalpemilu.org#53811,"TULAMBEN, KUBU, KARANGASEM, BALI",25,148,6,154
https://kawalpemilu.org#53811,"TULAMBEN, KUBU, KARANGASEM, BALI",26,117,3,120
https://kawalpemilu.org#53811,"TULAMBEN, KUBU, KARANGASEM, BALI",27,147,4,151
https://kawalpemilu.org#53811,"TULAMBEN, KUBU, KARANGASEM, BALI",28,211,4,215
https://kawalpemilu.org#53811,"TULAMBEN, KUBU, KARANGASEM, BALI",30,143,1,144
https://kawalpemilu.org#53811,"TULAMBEN, KUBU, KARANGASEM, BALI",31,128,5,133
https://kawalpemilu.org#53811,"TULAMBEN, KUBU, KARANGASEM, BALI",32,166,10,176
https://kawalpemilu.org#53811,"TULAMBEN, KUBU, KARANGASEM, BALI",33,149,1,150
https://kawalpemilu.org#53811,"TULAMBEN, KUBU, KARANGASEM, BALI",34,138,7,145
https://kawalpemilu.org#53811,"TULAMBEN, KUBU, KARANGASEM, BALI",35,165,5,170
https://kawalpemilu.org#53811,"TULAMBEN, KUBU, KARANGASEM, BALI",36,183,13,196
https://kawalpemilu.org#53812,"BATURINGGIT, KUBU, KARANGASEM, BALI",1,143,7,150
https://kawalpemilu.org#53812,"BATURINGGIT, KUBU, KARANGASEM, BALI",2,151,3,154
https://kawalpemilu.org#53812,"BATURINGGIT, KUBU, KARANGASEM, BALI",3,146,2,148
https://kawalpemilu.org#53812,"BATURINGGIT, KUBU, KARANGASEM, BALI",4,157,12,169
https://kawalpemilu.org#53812,"BATURINGGIT, KUBU, KARANGASEM, BALI",5,145,5,150
https://kawalpemilu.org#53812,"BATURINGGIT, KUBU, KARANGASEM, BALI",6,166,2,168
https://kawalpemilu.org#53812,"BATURINGGIT, KUBU, KARANGASEM, BALI",7,123,8,131
https://kawalpemilu.org#53812,"BATURINGGIT, KUBU, KARANGASEM, BALI",8,140,6,146
https://kawalpemilu.org#53812,"BATURINGGIT, KUBU, KARANGASEM, BALI",9,116,3,119
https://kawalpemilu.org#53812,"BATURINGGIT, KUBU, KARANGASEM, BALI",10,102,4,106
https://kawalpemilu.org#53812,"BATURINGGIT, KUBU, KARANGASEM, BALI",11,264,6,270
https://kawalpemilu.org#53812,"BATURINGGIT, KUBU, KARANGASEM, BALI",12,245,2,247
https://kawalpemilu.org#53812,"BATURINGGIT, KUBU, KARANGASEM, BALI",13,242,8,250
https://kawalpemilu.org#53812,"BATURINGGIT, KUBU, KARANGASEM, BALI",14,234,0,234
https://kawalpemilu.org#53812,"BATURINGGIT, KUBU, KARANGASEM, BALI",15,246,6,252
https://kawalpemilu.org#53812,"BATURINGGIT, KUBU, KARANGASEM, BALI",16,242,8,250
https://kawalpemilu.org#53812,"BATURINGGIT, KUBU, KARANGASEM, BALI",17,230,5,235
https://kawalpemilu.org#53813,"SUKADANA, KUBU, KARANGASEM, BALI",1,218,20,238
https://kawalpemilu.org#53813,"SUKADANA, KUBU, KARANGASEM, BALI",2,216,12,228
https://kawalpemilu.org#53813,"SUKADANA, KUBU, KARANGASEM, BALI",3,217,14,231
https://kawalpemilu.org#53813,"SUKADANA, KUBU, KARANGASEM, BALI",4,169,12,181
https://kawalpemilu.org#53813,"SUKADANA, KUBU, KARANGASEM, BALI",5,147,13,160
https://kawalpemilu.org#53813,"SUKADANA, KUBU, KARANGASEM, BALI",6,133,4,137
https://kawalpemilu.org#53813,"SUKADANA, KUBU, KARANGASEM, BALI",7,159,7,166
https://kawalpemilu.org#53813,"SUKADANA, KUBU, KARANGASEM, BALI",8,241,4,245
https://kawalpemilu.org#53813,"SUKADANA, KUBU, KARANGASEM, BALI",9,200,4,200
https://kawalpemilu.org#53813,"SUKADANA, KUBU, KARANGASEM, BALI",10,169,11,180
https://kawalpemilu.org#53813,"SUKADANA, KUBU, KARANGASEM, BALI",11,127,26,153
https://kawalpemilu.org#53813,"SUKADANA, KUBU, KARANGASEM, BALI",12,166,5,171
https://kawalpemilu.org#53813,"SUKADANA, KUBU, KARANGASEM, BALI",13,127,4,131
https://kawalpemilu.org#53813,"SUKADANA, KUBU, KARANGASEM, BALI",14,129,7,5
https://kawalpemilu.org#53813,"SUKADANA, KUBU, KARANGASEM, BALI",15,209,6,215
https://kawalpemilu.org#53813,"SUKADANA, KUBU, KARANGASEM, BALI",16,185,4,189
https://kawalpemilu.org#53813,"SUKADANA, KUBU, KARANGASEM, BALI",17,183,6,189
https://kawalpemilu.org#53813,"SUKADANA, KUBU, KARANGASEM, BALI",18,183,4,187
https://kawalpemilu.org#53813,"SUKADANA, KUBU, KARANGASEM, BALI",19,187,3,190
https://kawalpemilu.org#53813,"SUKADANA, KUBU, KARANGASEM, BALI",20,167,6,173
https://kawalpemilu.org#53813,"SUKADANA, KUBU, KARANGASEM, BALI",21,117,3,220
https://kawalpemilu.org#53813,"SUKADANA, KUBU, KARANGASEM, BALI",22,232,9,241
https://kawalpemilu.org#53816,"SUMBERKLAMPOK, GEROKGAK, BULELENG, BALI",1,154,70,224
https://kawalpemilu.org#53816,"SUMBERKLAMPOK, GEROKGAK, BULELENG, BALI",2,178,40,218
https://kawalpemilu.org#53816,"SUMBERKLAMPOK, GEROKGAK, BULELENG, BALI",3,175,7,182
https://kawalpemilu.org#53816,"SUMBERKLAMPOK, GEROKGAK, BULELENG, BALI",4,197,29,226
https://kawalpemilu.org#53816,"SUMBERKLAMPOK, GEROKGAK, BULELENG, BALI",5,230,1,231
https://kawalpemilu.org#53816,"SUMBERKLAMPOK, GEROKGAK, BULELENG, BALI",6,225,1,226
https://kawalpemilu.org#53816,"SUMBERKLAMPOK, GEROKGAK, BULELENG, BALI",8,220,15,235
https://kawalpemilu.org#53817,"PEJARAKAN, GEROKGAK, BULELENG, BALI",1,188,6,194
https://kawalpemilu.org#53817,"PEJARAKAN, GEROKGAK, BULELENG, BALI",2,201,9,210
https://kawalpemilu.org#53817,"PEJARAKAN, GEROKGAK, BULELENG, BALI",3,191,3,194
https://kawalpemilu.org#53817,"PEJARAKAN, GEROKGAK, BULELENG, BALI",4,198,8,206
https://kawalpemilu.org#53817,"PEJARAKAN, GEROKGAK, BULELENG, BALI",5,163,7,170
https://kawalpemilu.org#53817,"PEJARAKAN, GEROKGAK, BULELENG, BALI",6,206,9,215
https://kawalpemilu.org#53817,"PEJARAKAN, GEROKGAK, BULELENG, BALI",7,197,6,203
https://kawalpemilu.org#53817,"PEJARAKAN, GEROKGAK, BULELENG, BALI",8,217,7,224
https://kawalpemilu.org#53817,"PEJARAKAN, GEROKGAK, BULELENG, BALI",9,241,3,244
https://kawalpemilu.org#53817,"PEJARAKAN, GEROKGAK, BULELENG, BALI",10,180,7,187
https://kawalpemilu.org#53817,"PEJARAKAN, GEROKGAK, BULELENG, BALI",11,184,6,190
https://kawalpemilu.org#53817,"PEJARAKAN, GEROKGAK, BULELENG, BALI",12,187,10,197
https://kawalpemilu.org#53817,"PEJARAKAN, GEROKGAK, BULELENG, BALI",13,231,6,237
https://kawalpemilu.org#53817,"PEJARAKAN, GEROKGAK, BULELENG, BALI",14,234,6,240
https://kawalpemilu.org#53817,"PEJARAKAN, GEROKGAK, BULELENG, BALI",15,235,3,238
https://kawalpemilu.org#53817,"PEJARAKAN, GEROKGAK, BULELENG, BALI",16,217,2,219
https://kawalpemilu.org#53817,"PEJARAKAN, GEROKGAK, BULELENG, BALI",17,225,1,226
https://kawalpemilu.org#53817,"PEJARAKAN, GEROKGAK, BULELENG, BALI",18,234,2,236
https://kawalpemilu.org#53817,"PEJARAKAN, GEROKGAK, BULELENG, BALI",19,216,8,224
https://kawalpemilu.org#53817,"PEJARAKAN, GEROKGAK, BULELENG, BALI",20,189,1,190
https://kawalpemilu.org#53817,"PEJARAKAN, GEROKGAK, BULELENG, BALI",21,140,52,192
https://kawalpemilu.org#53817,"PEJARAKAN, GEROKGAK, BULELENG, BALI",22,116,53,169
https://kawalpemilu.org#53817,"PEJARAKAN, GEROKGAK, BULELENG, BALI",23,176,50,226
https://kawalpemilu.org#53817,"PEJARAKAN, GEROKGAK, BULELENG, BALI",24,169,38,207
https://kawalpemilu.org#53817,"PEJARAKAN, GEROKGAK, BULELENG, BALI",25,207,15,222
https://kawalpemilu.org#53817,"PEJARAKAN, GEROKGAK, BULELENG, BALI",26,222,9,231
https://kawalpemilu.org#53817,"PEJARAKAN, GEROKGAK, BULELENG, BALI",27,191,48,239
https://kawalpemilu.org#53817,"PEJARAKAN, GEROKGAK, BULELENG, BALI",28,179,45,224
https://kawalpemilu.org#53817,"PEJARAKAN, GEROKGAK, BULELENG, BALI",29,210,10,220
https://kawalpemilu.org#53817,"PEJARAKAN, GEROKGAK, BULELENG, BALI",30,171,18,189
https://kawalpemilu.org#53817,"PEJARAKAN, GEROKGAK, BULELENG, BALI",31,180,17,197
https://kawalpemilu.org#53818,"SUMBERKIMA, GEROKGAK, BULELENG, BALI",1,145,79,224
https://kawalpemilu.org#53818,"SUMBERKIMA, GEROKGAK, BULELENG, BALI",2,64,149,213
https://kawalpemilu.org#53818,"SUMBERKIMA, GEROKGAK, BULELENG, BALI",3,71,127,198
https://kawalpemilu.org#53818,"SUMBERKIMA, GEROKGAK, BULELENG, BALI",4,51,178,229
https://kawalpemilu.org#53818,"SUMBERKIMA, GEROKGAK, BULELENG, BALI",5,101,156,257
https://kawalpemilu.org#53818,"SUMBERKIMA, GEROKGAK, BULELENG, BALI",6,109,149,258
https://kawalpemilu.org#53818,"SUMBERKIMA, GEROKGAK, BULELENG, BALI",7,140,104,244
https://kawalpemilu.org#53818,"SUMBERKIMA, GEROKGAK, BULELENG, BALI",8,64,133,197
https://kawalpemilu.org#53818,"SUMBERKIMA, GEROKGAK, BULELENG, BALI",9,190,76,226
https://kawalpemilu.org#53818,"SUMBERKIMA, GEROKGAK, BULELENG, BALI",10,104,132,236
https://kawalpemilu.org#53818,"SUMBERKIMA, GEROKGAK, BULELENG, BALI",11,112,109,221
https://kawalpemilu.org#53818,"SUMBERKIMA, GEROKGAK, BULELENG, BALI",12,199,35,234
https://kawalpemilu.org#53818,"SUMBERKIMA, GEROKGAK, BULELENG, BALI",13,190,35,225
https://kawalpemilu.org#53818,"SUMBERKIMA, GEROKGAK, BULELENG, BALI",14,244,10,254
https://kawalpemilu.org#53818,"SUMBERKIMA, GEROKGAK, BULELENG, BALI",15,241,3,244
https://kawalpemilu.org#53818,"SUMBERKIMA, GEROKGAK, BULELENG, BALI",16,230,19,249
https://kawalpemilu.org#53818,"SUMBERKIMA, GEROKGAK, BULELENG, BALI",17,217,12,229
https://kawalpemilu.org#53818,"SUMBERKIMA, GEROKGAK, BULELENG, BALI",18,249,9,258
https://kawalpemilu.org#53818,"SUMBERKIMA, GEROKGAK, BULELENG, BALI",19,242,17,259
https://kawalpemilu.org#53818,"SUMBERKIMA, GEROKGAK, BULELENG, BALI",20,245,4,249
https://kawalpemilu.org#53818,"SUMBERKIMA, GEROKGAK, BULELENG, BALI",21,189,32,221
https://kawalpemilu.org#53818,"SUMBERKIMA, GEROKGAK, BULELENG, BALI",22,202,27,229
https://kawalpemilu.org#53819,"PEMUTERAN, GEROKGAK, BULELENG, BALI",1,203,27,230
https://kawalpemilu.org#53819,"PEMUTERAN, GEROKGAK, BULELENG, BALI",2,195,44,239
https://kawalpemilu.org#53819,"PEMUTERAN, GEROKGAK, BULELENG, BALI",3,194,45,239
https://kawalpemilu.org#53819,"PEMUTERAN, GEROKGAK, BULELENG, BALI",4,170,64,234
https://kawalpemilu.org#53819,"PEMUTERAN, GEROKGAK, BULELENG, BALI",5,186,61,247
https://kawalpemilu.org#53819,"PEMUTERAN, GEROKGAK, BULELENG, BALI",6,204,44,248
https://kawalpemilu.org#53819,"PEMUTERAN, GEROKGAK, BULELENG, BALI",7,229,17,246
https://kawalpemilu.org#53819,"PEMUTERAN, GEROKGAK, BULELENG, BALI",8,245,16,261
https://kawalpemilu.org#53819,"PEMUTERAN, GEROKGAK, BULELENG, BALI",9,238,9,247
https://kawalpemilu.org#53819,"PEMUTERAN, GEROKGAK, BULELENG, BALI",10,233,12,245
https://kawalpemilu.org#53819,"PEMUTERAN, GEROKGAK, BULELENG, BALI",11,243,6,249
https://kawalpemilu.org#53819,"PEMUTERAN, GEROKGAK, BULELENG, BALI",13,212,13,225
https://kawalpemilu.org#53819,"PEMUTERAN, GEROKGAK, BULELENG, BALI",14,225,18,243
https://kawalpemilu.org#53819,"PEMUTERAN, GEROKGAK, BULELENG, BALI",15,206,16,222
https://kawalpemilu.org#53819,"PEMUTERAN, GEROKGAK, BULELENG, BALI",16,228,7,235
https://kawalpemilu.org#53819,"PEMUTERAN, GEROKGAK, BULELENG, BALI",17,259,13,272
https://kawalpemilu.org#53819,"PEMUTERAN, GEROKGAK, BULELENG, BALI",18,244,10,254
https://kawalpemilu.org#53819,"PEMUTERAN, GEROKGAK, BULELENG, BALI",19,219,20,239
https://kawalpemilu.org#53819,"PEMUTERAN, GEROKGAK, BULELENG, BALI",20,120,97,217
https://kawalpemilu.org#53819,"PEMUTERAN, GEROKGAK, BULELENG, BALI",21,113,100,213
https://kawalpemilu.org#53819,"PEMUTERAN, GEROKGAK, BULELENG, BALI",22,151,67,218
https://kawalpemilu.org#53819,"PEMUTERAN, GEROKGAK, BULELENG, BALI",23,141,80,221
https://kawalpemilu.org#53819,"PEMUTERAN, GEROKGAK, BULELENG, BALI",24,91,27,118
https://kawalpemilu.org#53820,"BANYUPOH, GEROKGAK, BULELENG, BALI",1,196,31,227
https://kawalpemilu.org#53820,"BANYUPOH, GEROKGAK, BULELENG, BALI",2,213,17,230
https://kawalpemilu.org#53820,"BANYUPOH, GEROKGAK, BULELENG, BALI",3,147,71,218
https://kawalpemilu.org#53820,"BANYUPOH, GEROKGAK, BULELENG, BALI",4,180,53,233
https://kawalpemilu.org#53820,"BANYUPOH, GEROKGAK, BULELENG, BALI",5,222,15,237
https://kawalpemilu.org#53820,"BANYUPOH, GEROKGAK, BULELENG, BALI",6,208,11,219
https://kawalpemilu.org#53820,"BANYUPOH, GEROKGAK, BULELENG, BALI",7,253,9,262
https://kawalpemilu.org#53820,"BANYUPOH, GEROKGAK, BULELENG, BALI",8,233,10,243
https://kawalpemilu.org#53820,"BANYUPOH, GEROKGAK, BULELENG, BALI",9,205,18,223
https://kawalpemilu.org#53820,"BANYUPOH, GEROKGAK, BULELENG, BALI",10,214,11,225
https://kawalpemilu.org#53820,"BANYUPOH, GEROKGAK, BULELENG, BALI",11,116,117,233
https://kawalpemilu.org#53820,"BANYUPOH, GEROKGAK, BULELENG, BALI",12,207,20,227
https://kawalpemilu.org#53820,"BANYUPOH, GEROKGAK, BULELENG, BALI",13,72,13,85
https://kawalpemilu.org#53821,"PENYABANGAN, GEROKGAK, BULELENG, BALI",1,216,9,225
https://kawalpemilu.org#53821,"PENYABANGAN, GEROKGAK, BULELENG, BALI",2,197,4,201
https://kawalpemilu.org#53821,"PENYABANGAN, GEROKGAK, BULELENG, BALI",3,215,8,223
https://kawalpemilu.org#53821,"PENYABANGAN, GEROKGAK, BULELENG, BALI",4,203,18,221
https://kawalpemilu.org#53821,"PENYABANGAN, GEROKGAK, BULELENG, BALI",5,172,21,193
https://kawalpemilu.org#53821,"PENYABANGAN, GEROKGAK, BULELENG, BALI",6,191,39,230
https://kawalpemilu.org#53821,"PENYABANGAN, GEROKGAK, BULELENG, BALI",7,197,22,219
https://kawalpemilu.org#53821,"PENYABANGAN, GEROKGAK, BULELENG, BALI",8,165,38,203
https://kawalpemilu.org#53821,"PENYABANGAN, GEROKGAK, BULELENG, BALI",9,82,157,239
https://kawalpemilu.org#53821,"PENYABANGAN, GEROKGAK, BULELENG, BALI",10,79,123,202
https://kawalpemilu.org#53821,"PENYABANGAN, GEROKGAK, BULELENG, BALI",11,86,109,195
https://kawalpemilu.org#53821,"PENYABANGAN, GEROKGAK, BULELENG, BALI",12,102,163,265
https://kawalpemilu.org#53821,"PENYABANGAN, GEROKGAK, BULELENG, BALI",13,92,140,232
https://kawalpemilu.org#53821,"PENYABANGAN, GEROKGAK, BULELENG, BALI",14,68,144,212
https://kawalpemilu.org#53821,"PENYABANGAN, GEROKGAK, BULELENG, BALI",15,71,47,118
https://kawalpemilu.org#53822,"MUSI, GEROKGAK, BULELENG, BALI",1,142,82,224
https://kawalpemilu.org#53822,"MUSI, GEROKGAK, BULELENG, BALI",2,201,37,238
https://kawalpemilu.org#53822,"MUSI, GEROKGAK, BULELENG, BALI",3,45,189,234
https://kawalpemilu.org#53822,"MUSI, GEROKGAK, BULELENG, BALI",5,197,16,213
https://kawalpemilu.org#53822,"MUSI, GEROKGAK, BULELENG, BALI",6,193,10,203
https://kawalpemilu.org#53822,"MUSI, GEROKGAK, BULELENG, BALI",7,227,16,243
https://kawalpemilu.org#53822,"MUSI, GEROKGAK, BULELENG, BALI",8,202,8,210
https://kawalpemilu.org#53822,"MUSI, GEROKGAK, BULELENG, BALI",9,224,16,240
https://kawalpemilu.org#53823,"SANGGALANGIT, GEROKGAK, BULELENG, BALI",1,178,42,220
https://kawalpemilu.org#53823,"SANGGALANGIT, GEROKGAK, BULELENG, BALI",2,154,56,210
https://kawalpemilu.org#53823,"SANGGALANGIT, GEROKGAK, BULELENG, BALI",3,174,15,189
https://kawalpemilu.org#53823,"SANGGALANGIT, GEROKGAK, BULELENG, BALI",4,195,7,202
https://kawalpemilu.org#53823,"SANGGALANGIT, GEROKGAK, BULELENG, BALI",5,217,10,227
https://kawalpemilu.org#53823,"SANGGALANGIT, GEROKGAK, BULELENG, BALI",6,184,2,186
https://kawalpemilu.org#53823,"SANGGALANGIT, GEROKGAK, BULELENG, BALI",7,202,9,211
https://kawalpemilu.org#53823,"SANGGALANGIT, GEROKGAK, BULELENG, BALI",8,191,7,198
https://kawalpemilu.org#53823,"SANGGALANGIT, GEROKGAK, BULELENG, BALI",9,199,8,207
https://kawalpemilu.org#53823,"SANGGALANGIT, GEROKGAK, BULELENG, BALI",10,230,15,245
https://kawalpemilu.org#53823,"SANGGALANGIT, GEROKGAK, BULELENG, BALI",11,184,14,198
https://kawalpemilu.org#53823,"SANGGALANGIT, GEROKGAK, BULELENG, BALI",12,151,32,183
https://kawalpemilu.org#53823,"SANGGALANGIT, GEROKGAK, BULELENG, BALI",13,193,30,223
https://kawalpemilu.org#53823,"SANGGALANGIT, GEROKGAK, BULELENG, BALI",14,176,19,195
https://kawalpemilu.org#53823,"SANGGALANGIT, GEROKGAK, BULELENG, BALI",15,166,29,195
https://kawalpemilu.org#53824,"GEROKGAK, GEROKGAK, BULELENG, BALI",1,164,50,214
https://kawalpemilu.org#53824,"GEROKGAK, GEROKGAK, BULELENG, BALI",2,183,28,211
https://kawalpemilu.org#53824,"GEROKGAK, GEROKGAK, BULELENG, BALI",3,171,38,209
https://kawalpemilu.org#53824,"GEROKGAK, GEROKGAK, BULELENG, BALI",4,196,31,227
https://kawalpemilu.org#53824,"GEROKGAK, GEROKGAK, BULELENG, BALI",5,212,17,229
https://kawalpemilu.org#53824,"GEROKGAK, GEROKGAK, BULELENG, BALI",6,200,18,218
https://kawalpemilu.org#53824,"GEROKGAK, GEROKGAK, BULELENG, BALI",7,204,14,218
https://kawalpemilu.org#53824,"GEROKGAK, GEROKGAK, BULELENG, BALI",9,219,7,226
https://kawalpemilu.org#53824,"GEROKGAK, GEROKGAK, BULELENG, BALI",10,213,20,233
https://kawalpemilu.org#53824,"GEROKGAK, GEROKGAK, BULELENG, BALI",11,188,51,239
https://kawalpemilu.org#53824,"GEROKGAK, GEROKGAK, BULELENG, BALI",12,205,35,240
https://kawalpemilu.org#53824,"GEROKGAK, GEROKGAK, BULELENG, BALI",13,207,10,217
https://kawalpemilu.org#53824,"GEROKGAK, GEROKGAK, BULELENG, BALI",14,184,25,209
https://kawalpemilu.org#53824,"GEROKGAK, GEROKGAK, BULELENG, BALI",15,184,20,204
https://kawalpemilu.org#53824,"GEROKGAK, GEROKGAK, BULELENG, BALI",16,82,102,184
https://kawalpemilu.org#53824,"GEROKGAK, GEROKGAK, BULELENG, BALI",17,116,99,215
https://kawalpemilu.org#53824,"GEROKGAK, GEROKGAK, BULELENG, BALI",18,109,96,205
https://kawalpemilu.org#53824,"GEROKGAK, GEROKGAK, BULELENG, BALI",19,84,116,203
https://kawalpemilu.org#53825,"PATAS, GEROKGAK, BULELENG, BALI",1,243,2,245
https://kawalpemilu.org#53825,"PATAS, GEROKGAK, BULELENG, BALI",2,206,7,213
https://kawalpemilu.org#53825,"PATAS, GEROKGAK, BULELENG, BALI",3,215,7,222
https://kawalpemilu.org#53825,"PATAS, GEROKGAK, BULELENG, BALI",4,222,13,235
https://kawalpemilu.org#53825,"PATAS, GEROKGAK, BULELENG, BALI",5,215,24,239
https://kawalpemilu.org#53825,"PATAS, GEROKGAK, BULELENG, BALI",6,193,30,223
https://kawalpemilu.org#53825,"PATAS, GEROKGAK, BULELENG, BALI",7,148,76,224
https://kawalpemilu.org#53825,"PATAS, GEROKGAK, BULELENG, BALI",8,166,62,228
https://kawalpemilu.org#53825,"PATAS, GEROKGAK, BULELENG, BALI",9,198,39,237
https://kawalpemilu.org#53825,"PATAS, GEROKGAK, BULELENG, BALI",10,199,23,222
https://kawalpemilu.org#53825,"PATAS, GEROKGAK, BULELENG, BALI",11,229,12,241
https://kawalpemilu.org#53825,"PATAS, GEROKGAK, BULELENG, BALI",12,171,44,215
https://kawalpemilu.org#53825,"PATAS, GEROKGAK, BULELENG, BALI",13,186,34,220
https://kawalpemilu.org#53825,"PATAS, GEROKGAK, BULELENG, BALI",14,148,74,222
https://kawalpemilu.org#53825,"PATAS, GEROKGAK, BULELENG, BALI",15,103,121,224
https://kawalpemilu.org#53825,"PATAS, GEROKGAK, BULELENG, BALI",16,135,85,220
https://kawalpemilu.org#53825,"PATAS, GEROKGAK, BULELENG, BALI",17,214,28,242
https://kawalpemilu.org#53825,"PATAS, GEROKGAK, BULELENG, BALI",18,202,29,231
https://kawalpemilu.org#53825,"PATAS, GEROKGAK, BULELENG, BALI",19,120,95,215
https://kawalpemilu.org#53825,"PATAS, GEROKGAK, BULELENG, BALI",20,79,105,184
https://kawalpemilu.org#53825,"PATAS, GEROKGAK, BULELENG, BALI",21,44,173,217
https://kawalpemilu.org#53825,"PATAS, GEROKGAK, BULELENG, BALI",22,53,168,221
https://kawalpemilu.org#53825,"PATAS, GEROKGAK, BULELENG, BALI",23,40,177,217
https://kawalpemilu.org#53825,"PATAS, GEROKGAK, BULELENG, BALI",24,44,179,223
https://kawalpemilu.org#53825,"PATAS, GEROKGAK, BULELENG, BALI",25,210,21,231
https://kawalpemilu.org#53825,"PATAS, GEROKGAK, BULELENG, BALI",26,221,16,237
https://kawalpemilu.org#53825,"PATAS, GEROKGAK, BULELENG, BALI",27,94,28,122
https://kawalpemilu.org#53825,"PATAS, GEROKGAK, BULELENG, BALI",28,71,91,162
https://kawalpemilu.org#53826,"PENGULON, GEROKGAK, BULELENG, BALI",1,60,151,211
https://kawalpemilu.org#53826,"PENGULON, GEROKGAK, BULELENG, BALI",2,51,157,208
https://kawalpemilu.org#53826,"PENGULON, GEROKGAK, BULELENG, BALI",3,79,107,186
https://kawalpemilu.org#53826,"PENGULON, GEROKGAK, BULELENG, BALI",4,150,51,201
https://kawalpemilu.org#53826,"PENGULON, GEROKGAK, BULELENG, BALI",6,205,9,214
https://kawalpemilu.org#53826,"PENGULON, GEROKGAK, BULELENG, BALI",7,196,19,215
https://kawalpemilu.org#53826,"PENGULON, GEROKGAK, BULELENG, BALI",8,161,44,205
https://kawalpemilu.org#53826,"PENGULON, GEROKGAK, BULELENG, BALI",9,162,40,202
https://kawalpemilu.org#53826,"PENGULON, GEROKGAK, BULELENG, BALI",10,214,15,229
https://kawalpemilu.org#53826,"PENGULON, GEROKGAK, BULELENG, BALI",11,187,19,206
https://kawalpemilu.org#53827,"TINGA-TINGA, GEROKGAK, BULELENG, BALI",1,221,13,234
https://kawalpemilu.org#53827,"TINGA-TINGA, GEROKGAK, BULELENG, BALI",2,237,17,254
https://kawalpemilu.org#53827,"TINGA-TINGA, GEROKGAK, BULELENG, BALI",3,231,9,240
https://kawalpemilu.org#53827,"TINGA-TINGA, GEROKGAK, BULELENG, BALI",4,197,22,219
https://kawalpemilu.org#53827,"TINGA-TINGA, GEROKGAK, BULELENG, BALI",5,208,15,223
https://kawalpemilu.org#53827,"TINGA-TINGA, GEROKGAK, BULELENG, BALI",6,213,10,223
https://kawalpemilu.org#53827,"TINGA-TINGA, GEROKGAK, BULELENG, BALI",7,228,15,243
https://kawalpemilu.org#53827,"TINGA-TINGA, GEROKGAK, BULELENG, BALI",8,201,23,224
https://kawalpemilu.org#53827,"TINGA-TINGA, GEROKGAK, BULELENG, BALI",9,242,9,251
https://kawalpemilu.org#53827,"TINGA-TINGA, GEROKGAK, BULELENG, BALI",10,189,16,205
https://kawalpemilu.org#53827,"TINGA-TINGA, GEROKGAK, BULELENG, BALI",11,179,9,188
https://kawalpemilu.org#53827,"TINGA-TINGA, GEROKGAK, BULELENG, BALI",12,185,16,201
https://kawalpemilu.org#53827,"TINGA-TINGA, GEROKGAK, BULELENG, BALI",13,220,3,223
https://kawalpemilu.org#53827,"TINGA-TINGA, GEROKGAK, BULELENG, BALI",14,64,4,68
https://kawalpemilu.org#53828,"CELUKANBAWANG, GEROKGAK, BULELENG, BALI",1,236,7,243
https://kawalpemilu.org#53828,"CELUKANBAWANG, GEROKGAK, BULELENG, BALI",2,208,13,221
https://kawalpemilu.org#53828,"CELUKANBAWANG, GEROKGAK, BULELENG, BALI",3,74,152,226
https://kawalpemilu.org#53828,"CELUKANBAWANG, GEROKGAK, BULELENG, BALI",4,206,33,239
https://kawalpemilu.org#53828,"CELUKANBAWANG, GEROKGAK, BULELENG, BALI",5,57,170,227
https://kawalpemilu.org#53828,"CELUKANBAWANG, GEROKGAK, BULELENG, BALI",6,29,188,217
https://kawalpemilu.org#53828,"CELUKANBAWANG, GEROKGAK, BULELENG, BALI",7,35,162,197
https://kawalpemilu.org#53828,"CELUKANBAWANG, GEROKGAK, BULELENG, BALI",8,48,170,218
https://kawalpemilu.org#53828,"CELUKANBAWANG, GEROKGAK, BULELENG, BALI",9,64,190,254
https://kawalpemilu.org#53828,"CELUKANBAWANG, GEROKGAK, BULELENG, BALI",10,71,168,239
https://kawalpemilu.org#53828,"CELUKANBAWANG, GEROKGAK, BULELENG, BALI",11,78,166,244
https://kawalpemilu.org#53828,"CELUKANBAWANG, GEROKGAK, BULELENG, BALI",12,97,157,254
https://kawalpemilu.org#53828,"CELUKANBAWANG, GEROKGAK, BULELENG, BALI",13,73,155,228
https://kawalpemilu.org#53828,"CELUKANBAWANG, GEROKGAK, BULELENG, BALI",14,78,49,127
https://kawalpemilu.org#53829,"TUKADSUMAGA, GEROKGAK, BULELENG, BALI",1,243,9,252
https://kawalpemilu.org#53829,"TUKADSUMAGA, GEROKGAK, BULELENG, BALI",2,231,13,244
https://kawalpemilu.org#53829,"TUKADSUMAGA, GEROKGAK, BULELENG, BALI",3,195,48,243
https://kawalpemilu.org#53829,"TUKADSUMAGA, GEROKGAK, BULELENG, BALI",4,232,45,277
https://kawalpemilu.org#53829,"TUKADSUMAGA, GEROKGAK, BULELENG, BALI",5,219,33,252
https://kawalpemilu.org#53829,"TUKADSUMAGA, GEROKGAK, BULELENG, BALI",6,252,4,256
https://kawalpemilu.org#53829,"TUKADSUMAGA, GEROKGAK, BULELENG, BALI",7,198,38,236
https://kawalpemilu.org#53829,"TUKADSUMAGA, GEROKGAK, BULELENG, BALI",8,203,26,229
https://kawalpemilu.org#53829,"TUKADSUMAGA, GEROKGAK, BULELENG, BALI",9,213,26,239
https://kawalpemilu.org#53829,"TUKADSUMAGA, GEROKGAK, BULELENG, BALI",10,207,28,235
https://kawalpemilu.org#53829,"TUKADSUMAGA, GEROKGAK, BULELENG, BALI",11,211,27,238
https://kawalpemilu.org#53829,"TUKADSUMAGA, GEROKGAK, BULELENG, BALI",12,190,24,214
https://kawalpemilu.org#53829,"TUKADSUMAGA, GEROKGAK, BULELENG, BALI",13,188,45,233
https://kawalpemilu.org#53829,"TUKADSUMAGA, GEROKGAK, BULELENG, BALI",14,208,39,247
https://kawalpemilu.org#53829,"TUKADSUMAGA, GEROKGAK, BULELENG, BALI",15,217,24,241
https://kawalpemilu.org#53829,"TUKADSUMAGA, GEROKGAK, BULELENG, BALI",16,211,8,219
https://kawalpemilu.org#53829,"TUKADSUMAGA, GEROKGAK, BULELENG, BALI",17,228,8,236
https://kawalpemilu.org#53829,"TUKADSUMAGA, GEROKGAK, BULELENG, BALI",18,28,3,31
https://kawalpemilu.org#53831,"SERIRIT, SERIRIT, BULELENG, BALI",1,171,20,191
https://kawalpemilu.org#53831,"SERIRIT, SERIRIT, BULELENG, BALI",2,173,15,188
https://kawalpemilu.org#53831,"SERIRIT, SERIRIT, BULELENG, BALI",3,151,22,173
https://kawalpemilu.org#53831,"SERIRIT, SERIRIT, BULELENG, BALI",4,159,39,198
https://kawalpemilu.org#53831,"SERIRIT, SERIRIT, BULELENG, BALI",5,167,36,203
https://kawalpemilu.org#53831,"SERIRIT, SERIRIT, BULELENG, BALI",6,139,28,167
https://kawalpemilu.org#53831,"SERIRIT, SERIRIT, BULELENG, BALI",7,165,21,186
https://kawalpemilu.org#53831,"SERIRIT, SERIRIT, BULELENG, BALI",8,109,64,173
https://kawalpemilu.org#53831,"SERIRIT, SERIRIT, BULELENG, BALI",9,93,112,205
https://kawalpemilu.org#53831,"SERIRIT, SERIRIT, BULELENG, BALI",10,76,112,188
https://kawalpemilu.org#53831,"SERIRIT, SERIRIT, BULELENG, BALI",11,188,22,210
https://kawalpemilu.org#53831,"SERIRIT, SERIRIT, BULELENG, BALI",12,179,30,209
https://kawalpemilu.org#53831,"SERIRIT, SERIRIT, BULELENG, BALI",13,142,38,180
https://kawalpemilu.org#53831,"SERIRIT, SERIRIT, BULELENG, BALI",14,42,138,180
https://kawalpemilu.org#53831,"SERIRIT, SERIRIT, BULELENG, BALI",15,44,166,210
https://kawalpemilu.org#53831,"SERIRIT, SERIRIT, BULELENG, BALI",16,70,140,210
https://kawalpemilu.org#53831,"SERIRIT, SERIRIT, BULELENG, BALI",17,148,39,187
https://kawalpemilu.org#53831,"SERIRIT, SERIRIT, BULELENG, BALI",18,143,41,184
https://kawalpemilu.org#53831,"SERIRIT, SERIRIT, BULELENG, BALI",19,121,83,204
https://kawalpemilu.org#53831,"SERIRIT, SERIRIT, BULELENG, BALI",20,127,69,196
https://kawalpemilu.org#53831,"SERIRIT, SERIRIT, BULELENG, BALI",21,107,98,205
https://kawalpemilu.org#53832,"UNGGAHAN, SERIRIT, BULELENG, BALI",1,236,16,252
https://kawalpemilu.org#53832,"UNGGAHAN, SERIRIT, BULELENG, BALI",2,199,13,212
https://kawalpemilu.org#53832,"UNGGAHAN, SERIRIT, BULELENG, BALI",3,202,18,220
https://kawalpemilu.org#53832,"UNGGAHAN, SERIRIT, BULELENG, BALI",4,211,16,227
https://kawalpemilu.org#53832,"UNGGAHAN, SERIRIT, BULELENG, BALI",5,223,23,246
https://kawalpemilu.org#53832,"UNGGAHAN, SERIRIT, BULELENG, BALI",6,234,15,249
https://kawalpemilu.org#53832,"UNGGAHAN, SERIRIT, BULELENG, BALI",7,224,24,248
https://kawalpemilu.org#53832,"UNGGAHAN, SERIRIT, BULELENG, BALI",8,233,25,258
https://kawalpemilu.org#53833,"ULARAN, SERIRIT, BULELENG, BALI",1,225,8,233
https://kawalpemilu.org#53833,"ULARAN, SERIRIT, BULELENG, BALI",2,206,21,227
https://kawalpemilu.org#53833,"ULARAN, SERIRIT, BULELENG, BALI",3,193,22,215
https://kawalpemilu.org#53833,"ULARAN, SERIRIT, BULELENG, BALI",4,213,12,225
https://kawalpemilu.org#53833,"ULARAN, SERIRIT, BULELENG, BALI",5,192,15,207
https://kawalpemilu.org#53833,"ULARAN, SERIRIT, BULELENG, BALI",6,186,10,196
https://kawalpemilu.org#53834,"RINGDIKIT, SERIRIT, BULELENG, BALI",1,170,17,187
https://kawalpemilu.org#53834,"RINGDIKIT, SERIRIT, BULELENG, BALI",2,190,22,212
https://kawalpemilu.org#53834,"RINGDIKIT, SERIRIT, BULELENG, BALI",3,190,15,205
https://kawalpemilu.org#53834,"RINGDIKIT, SERIRIT, BULELENG, BALI",4,184,15,199
https://kawalpemilu.org#53834,"RINGDIKIT, SERIRIT, BULELENG, BALI",5,146,8,154
https://kawalpemilu.org#53834,"RINGDIKIT, SERIRIT, BULELENG, BALI",6,132,3,135
https://kawalpemilu.org#53834,"RINGDIKIT, SERIRIT, BULELENG, BALI",7,140,13,153
https://kawalpemilu.org#53834,"RINGDIKIT, SERIRIT, BULELENG, BALI",8,189,12,201
https://kawalpemilu.org#53834,"RINGDIKIT, SERIRIT, BULELENG, BALI",9,160,9,169
https://kawalpemilu.org#53834,"RINGDIKIT, SERIRIT, BULELENG, BALI",10,188,9,197
https://kawalpemilu.org#53834,"RINGDIKIT, SERIRIT, BULELENG, BALI",11,152,11,163
https://kawalpemilu.org#53834,"RINGDIKIT, SERIRIT, BULELENG, BALI",12,182,6,188
https://kawalpemilu.org#53834,"RINGDIKIT, SERIRIT, BULELENG, BALI",13,187,14,201
https://kawalpemilu.org#53835,"RANGDU, SERIRIT, BULELENG, BALI",1,156,17,173
https://kawalpemilu.org#53835,"RANGDU, SERIRIT, BULELENG, BALI",2,156,15,171
https://kawalpemilu.org#53835,"RANGDU, SERIRIT, BULELENG, BALI",3,141,9,150
https://kawalpemilu.org#53835,"RANGDU, SERIRIT, BULELENG, BALI",4,122,10,132
https://kawalpemilu.org#53836,"MAYONG, SERIRIT, BULELENG, BALI",1,170,17,187
https://kawalpemilu.org#53836,"MAYONG, SERIRIT, BULELENG, BALI",2,181,22,203
https://kawalpemilu.org#53836,"MAYONG, SERIRIT, BULELENG, BALI",3,179,20,199
https://kawalpemilu.org#53836,"MAYONG, SERIRIT, BULELENG, BALI",4,179,15,194
https://kawalpemilu.org#53836,"MAYONG, SERIRIT, BULELENG, BALI",5,184,14,198
https://kawalpemilu.org#53836,"MAYONG, SERIRIT, BULELENG, BALI",6,181,17,198
https://kawalpemilu.org#53836,"MAYONG, SERIRIT, BULELENG, BALI",7,180,22,202
https://kawalpemilu.org#53836,"MAYONG, SERIRIT, BULELENG, BALI",8,157,15,172
https://kawalpemilu.org#53836,"MAYONG, SERIRIT, BULELENG, BALI",9,169,20,189
https://kawalpemilu.org#53836,"MAYONG, SERIRIT, BULELENG, BALI",10,162,25,187
https://kawalpemilu.org#53836,"MAYONG, SERIRIT, BULELENG, BALI",11,187,21,208
https://kawalpemilu.org#53836,"MAYONG, SERIRIT, BULELENG, BALI",12,193,19,212
https://kawalpemilu.org#53836,"MAYONG, SERIRIT, BULELENG, BALI",13,207,17,224
https://kawalpemilu.org#53837,"GUNUNG SARI, SERIRIT, BULELENG, BALI",1,172,9,181
https://kawalpemilu.org#53837,"GUNUNG SARI, SERIRIT, BULELENG, BALI",2,165,7,172
https://kawalpemilu.org#53837,"GUNUNG SARI, SERIRIT, BULELENG, BALI",3,154,8,162
https://kawalpemilu.org#53837,"GUNUNG SARI, SERIRIT, BULELENG, BALI",4,172,10,182
https://kawalpemilu.org#53837,"GUNUNG SARI, SERIRIT, BULELENG, BALI",5,161,5,166
https://kawalpemilu.org#53837,"GUNUNG SARI, SERIRIT, BULELENG, BALI",6,166,13,179
https://kawalpemilu.org#53837,"GUNUNG SARI, SERIRIT, BULELENG, BALI",7,162,11,173
https://kawalpemilu.org#53837,"GUNUNG SARI, SERIRIT, BULELENG, BALI",8,178,12,190
https://kawalpemilu.org#53837,"GUNUNG SARI, SERIRIT, BULELENG, BALI",9,159,6,165
https://kawalpemilu.org#53837,"GUNUNG SARI, SERIRIT, BULELENG, BALI",10,171,9,180
https://kawalpemilu.org#53838,"MUNDUK BESTALA, SERIRIT, BULELENG, BALI",1,207,19,226
https://kawalpemilu.org#53838,"MUNDUK BESTALA, SERIRIT, BULELENG, BALI",2,215,11,226
https://kawalpemilu.org#53838,"MUNDUK BESTALA, SERIRIT, BULELENG, BALI",3,215,8,223
https://kawalpemilu.org#53839,"BESTALA, SERIRIT, BULELENG, BALI",1,187,26,213
https://kawalpemilu.org#53839,"BESTALA, SERIRIT, BULELENG, BALI",2,197,8,205
https://kawalpemilu.org#53839,"BESTALA, SERIRIT, BULELENG, BALI",3,169,22,191
https://kawalpemilu.org#53839,"BESTALA, SERIRIT, BULELENG, BALI",4,170,17,187
https://kawalpemilu.org#53840,"KALIANGET, SERIRIT, BULELENG, BALI",1,196,12,208
https://kawalpemilu.org#53840,"KALIANGET, SERIRIT, BULELENG, BALI",2,199,9,208
https://kawalpemilu.org#53840,"KALIANGET, SERIRIT, BULELENG, BALI",3,199,26,225
https://kawalpemilu.org#53840,"KALIANGET, SERIRIT, BULELENG, BALI",4,200,23,223
https://kawalpemilu.org#53840,"KALIANGET, SERIRIT, BULELENG, BALI",5,174,18,192
https://kawalpemilu.org#53840,"KALIANGET, SERIRIT, BULELENG, BALI",6,159,21,180
https://kawalpemilu.org#53840,"KALIANGET, SERIRIT, BULELENG, BALI",7,201,12,213
https://kawalpemilu.org#53840,"KALIANGET, SERIRIT, BULELENG, BALI",8,219,7,226
https://kawalpemilu.org#53840,"KALIANGET, SERIRIT, BULELENG, BALI",9,198,7,205
https://kawalpemilu.org#53840,"KALIANGET, SERIRIT, BULELENG, BALI",10,190,21,211
https://kawalpemilu.org#53840,"KALIANGET, SERIRIT, BULELENG, BALI",11,215,7,222
https://kawalpemilu.org#53840,"KALIANGET, SERIRIT, BULELENG, BALI",12,225,8,223
https://kawalpemilu.org#53841,"JOANYAR, SERIRIT, BULELENG, BALI",1,169,13,182
https://kawalpemilu.org#53841,"JOANYAR, SERIRIT, BULELENG, BALI",2,148,10,158
https://kawalpemilu.org#53841,"JOANYAR, SERIRIT, BULELENG, BALI",3,157,10,167
https://kawalpemilu.org#53841,"JOANYAR, SERIRIT, BULELENG, BALI",4,183,9,192
https://kawalpemilu.org#53841,"JOANYAR, SERIRIT, BULELENG, BALI",5,181,7,188
https://kawalpemilu.org#53841,"JOANYAR, SERIRIT, BULELENG, BALI",6,152,12,164
https://kawalpemilu.org#53841,"JOANYAR, SERIRIT, BULELENG, BALI",7,179,2,181
https://kawalpemilu.org#53841,"JOANYAR, SERIRIT, BULELENG, BALI",8,187,10,197
https://kawalpemilu.org#53841,"JOANYAR, SERIRIT, BULELENG, BALI",9,192,4,196
https://kawalpemilu.org#53842,"TANGGUWISIA, SERIRIT, BULELENG, BALI",1,155,14,169
https://kawalpemilu.org#53842,"TANGGUWISIA, SERIRIT, BULELENG, BALI",2,161,9,170
https://kawalpemilu.org#53842,"TANGGUWISIA, SERIRIT, BULELENG, BALI",3,154,19,173
https://kawalpemilu.org#53842,"TANGGUWISIA, SERIRIT, BULELENG, BALI",4,166,13,179
https://kawalpemilu.org#53842,"TANGGUWISIA, SERIRIT, BULELENG, BALI",5,132,5,137
https://kawalpemilu.org#53842,"TANGGUWISIA, SERIRIT, BULELENG, BALI",6,152,4,156
https://kawalpemilu.org#53842,"TANGGUWISIA, SERIRIT, BULELENG, BALI",7,184,8,192
https://kawalpemilu.org#53842,"TANGGUWISIA, SERIRIT, BULELENG, BALI",8,60,1,61
https://kawalpemilu.org#53843,"SULANYAH, SERIRIT, BULELENG, BALI",1,154,25,179
https://kawalpemilu.org#53843,"SULANYAH, SERIRIT, BULELENG, BALI",2,165,12,177
https://kawalpemilu.org#53843,"SULANYAH, SERIRIT, BULELENG, BALI",3,160,15,175
https://kawalpemilu.org#53843,"SULANYAH, SERIRIT, BULELENG, BALI",5,165,15,180
https://kawalpemilu.org#53843,"SULANYAH, SERIRIT, BULELENG, BALI",6,160,23,183
https://kawalpemilu.org#53843,"SULANYAH, SERIRIT, BULELENG, BALI",7,101,10,111
https://kawalpemilu.org#53844,"BUBUNAN, SERIRIT, BULELENG, BALI",1,183,8,191
https://kawalpemilu.org#53844,"BUBUNAN, SERIRIT, BULELENG, BALI",2,201,17,218
https://kawalpemilu.org#53844,"BUBUNAN, SERIRIT, BULELENG, BALI",3,173,7,180
https://kawalpemilu.org#53844,"BUBUNAN, SERIRIT, BULELENG, BALI",4,206,10,216
https://kawalpemilu.org#53844,"BUBUNAN, SERIRIT, BULELENG, BALI",5,193,9,202
https://kawalpemilu.org#53844,"BUBUNAN, SERIRIT, BULELENG, BALI",6,176,7,183
https://kawalpemilu.org#53844,"BUBUNAN, SERIRIT, BULELENG, BALI",7,184,10,194
https://kawalpemilu.org#53844,"BUBUNAN, SERIRIT, BULELENG, BALI",8,177,4,181
https://kawalpemilu.org#53844,"BUBUNAN, SERIRIT, BULELENG, BALI",9,205,7,212
https://kawalpemilu.org#53844,"BUBUNAN, SERIRIT, BULELENG, BALI",10,183,7,190
https://kawalpemilu.org#53844,"BUBUNAN, SERIRIT, BULELENG, BALI",11,212,12,224
https://kawalpemilu.org#53844,"BUBUNAN, SERIRIT, BULELENG, BALI",12,210,17,227
https://kawalpemilu.org#53845,"PATEMON, SERIRIT, BULELENG, BALI",1,191,28,219
https://kawalpemilu.org#53845,"PATEMON, SERIRIT, BULELENG, BALI",2,161,30,191
https://kawalpemilu.org#53845,"PATEMON, SERIRIT, BULELENG, BALI",3,177,29,206
https://kawalpemilu.org#53845,"PATEMON, SERIRIT, BULELENG, BALI",4,202,11,213
https://kawalpemilu.org#53845,"PATEMON, SERIRIT, BULELENG, BALI",5,180,17,197
https://kawalpemilu.org#53845,"PATEMON, SERIRIT, BULELENG, BALI",6,184,21,205
https://kawalpemilu.org#53845,"PATEMON, SERIRIT, BULELENG, BALI",7,222,22,244
https://kawalpemilu.org#53845,"PATEMON, SERIRIT, BULELENG, BALI",8,175,21,196
https://kawalpemilu.org#53845,"PATEMON, SERIRIT, BULELENG, BALI",9,162,30,192
https://kawalpemilu.org#53845,"PATEMON, SERIRIT, BULELENG, BALI",10,113,39,152
https://kawalpemilu.org#53845,"PATEMON, SERIRIT, BULELENG, BALI",11,213,47,260
https://kawalpemilu.org#53845,"PATEMON, SERIRIT, BULELENG, BALI",12,177,13,190
https://kawalpemilu.org#53845,"PATEMON, SERIRIT, BULELENG, BALI",13,200,4,204
https://kawalpemilu.org#53845,"PATEMON, SERIRIT, BULELENG, BALI",14,186,13,199
https://kawalpemilu.org#53845,"PATEMON, SERIRIT, BULELENG, BALI",15,195,9,204
https://kawalpemilu.org#53845,"PATEMON, SERIRIT, BULELENG, BALI",16,209,4,213
https://kawalpemilu.org#53845,"PATEMON, SERIRIT, BULELENG, BALI",17,128,36,164
https://kawalpemilu.org#53845,"PATEMON, SERIRIT, BULELENG, BALI",18,148,29,177
https://kawalpemilu.org#53845,"PATEMON, SERIRIT, BULELENG, BALI",19,169,24,193
https://kawalpemilu.org#53845,"PATEMON, SERIRIT, BULELENG, BALI",20,187,15,202
https://kawalpemilu.org#53845,"PATEMON, SERIRIT, BULELENG, BALI",21,164,23,187
https://kawalpemilu.org#53845,"PATEMON, SERIRIT, BULELENG, BALI",22,189,13,202
https://kawalpemilu.org#53845,"PATEMON, SERIRIT, BULELENG, BALI",23,198,34,232
https://kawalpemilu.org#53846,"PENGASTULAN, SERIRIT, BULELENG, BALI",1,162,21,183
https://kawalpemilu.org#53846,"PENGASTULAN, SERIRIT, BULELENG, BALI",2,171,7,178
https://kawalpemilu.org#53846,"PENGASTULAN, SERIRIT, BULELENG, BALI",3,135,29,164
https://kawalpemilu.org#53846,"PENGASTULAN, SERIRIT, BULELENG, BALI",4,152,39,191
https://kawalpemilu.org#53846,"PENGASTULAN, SERIRIT, BULELENG, BALI",5,140,22,170
https://kawalpemilu.org#53846,"PENGASTULAN, SERIRIT, BULELENG, BALI",6,196,8,204
https://kawalpemilu.org#53846,"PENGASTULAN, SERIRIT, BULELENG, BALI",7,193,23,216
https://kawalpemilu.org#53846,"PENGASTULAN, SERIRIT, BULELENG, BALI",8,58,176,234
https://kawalpemilu.org#53846,"PENGASTULAN, SERIRIT, BULELENG, BALI",9,38,212,250
https://kawalpemilu.org#53846,"PENGASTULAN, SERIRIT, BULELENG, BALI",10,145,75,220
https://kawalpemilu.org#53846,"PENGASTULAN, SERIRIT, BULELENG, BALI",11,208,12,220
https://kawalpemilu.org#53846,"PENGASTULAN, SERIRIT, BULELENG, BALI",12,173,65,238
https://kawalpemilu.org#53846,"PENGASTULAN, SERIRIT, BULELENG, BALI",13,66,161,227
https://kawalpemilu.org#53847,"LOKAPAKSA, SERIRIT, BULELENG, BALI",1,218,6,224
https://kawalpemilu.org#53847,"LOKAPAKSA, SERIRIT, BULELENG, BALI",2,154,11,165
https://kawalpemilu.org#53847,"LOKAPAKSA, SERIRIT, BULELENG, BALI",3,150,10,160
https://kawalpemilu.org#53847,"LOKAPAKSA, SERIRIT, BULELENG, BALI",4,183,4,187
https://kawalpemilu.org#53847,"LOKAPAKSA, SERIRIT, BULELENG, BALI",5,161,9,170
https://kawalpemilu.org#53847,"LOKAPAKSA, SERIRIT, BULELENG, BALI",6,204,5,209
https://kawalpemilu.org#53847,"LOKAPAKSA, SERIRIT, BULELENG, BALI",7,164,8,172
https://kawalpemilu.org#53847,"LOKAPAKSA, SERIRIT, BULELENG, BALI",8,234,10,244
https://kawalpemilu.org#53847,"LOKAPAKSA, SERIRIT, BULELENG, BALI",9,231,8,239
https://kawalpemilu.org#53847,"LOKAPAKSA, SERIRIT, BULELENG, BALI",10,247,4,251
https://kawalpemilu.org#53847,"LOKAPAKSA, SERIRIT, BULELENG, BALI",11,251,12,263
https://kawalpemilu.org#53847,"LOKAPAKSA, SERIRIT, BULELENG, BALI",12,258,10,268
https://kawalpemilu.org#53847,"LOKAPAKSA, SERIRIT, BULELENG, BALI",13,274,4,278
https://kawalpemilu.org#53847,"LOKAPAKSA, SERIRIT, BULELENG, BALI",14,259,20,279
https://kawalpemilu.org#53847,"LOKAPAKSA, SERIRIT, BULELENG, BALI",15,236,26,262
https://kawalpemilu.org#53847,"LOKAPAKSA, SERIRIT, BULELENG, BALI",16,210,29,239
https://kawalpemilu.org#53847,"LOKAPAKSA, SERIRIT, BULELENG, BALI",17,218,28,246
https://kawalpemilu.org#53847,"LOKAPAKSA, SERIRIT, BULELENG, BALI",18,189,11,200
https://kawalpemilu.org#53847,"LOKAPAKSA, SERIRIT, BULELENG, BALI",19,203,8,211
https://kawalpemilu.org#53847,"LOKAPAKSA, SERIRIT, BULELENG, BALI",20,195,5,200
https://kawalpemilu.org#53847,"LOKAPAKSA, SERIRIT, BULELENG, BALI",21,184,4,188
https://kawalpemilu.org#53847,"LOKAPAKSA, SERIRIT, BULELENG, BALI",22,171,8,179
https://kawalpemilu.org#53847,"LOKAPAKSA, SERIRIT, BULELENG, BALI",23,231,11,242
https://kawalpemilu.org#53847,"LOKAPAKSA, SERIRIT, BULELENG, BALI",24,235,9,244
https://kawalpemilu.org#53847,"LOKAPAKSA, SERIRIT, BULELENG, BALI",25,233,7,240
https://kawalpemilu.org#53847,"LOKAPAKSA, SERIRIT, BULELENG, BALI",26,250,22,272
https://kawalpemilu.org#53847,"LOKAPAKSA, SERIRIT, BULELENG, BALI",27,244,43,287
https://kawalpemilu.org#53847,"LOKAPAKSA, SERIRIT, BULELENG, BALI",28,213,7,220
https://kawalpemilu.org#53847,"LOKAPAKSA, SERIRIT, BULELENG, BALI",29,170,7,177
https://kawalpemilu.org#53847,"LOKAPAKSA, SERIRIT, BULELENG, BALI",30,54,3,57
https://kawalpemilu.org#53847,"LOKAPAKSA, SERIRIT, BULELENG, BALI",31,130,9,139
https://kawalpemilu.org#53847,"LOKAPAKSA, SERIRIT, BULELENG, BALI",32,124,4,128
https://kawalpemilu.org#53848,"PANGKUNG PARUK, SERIRIT, BULELENG, BALI",1,286,7,293
https://kawalpemilu.org#53848,"PANGKUNG PARUK, SERIRIT, BULELENG, BALI",2,259,28,287
https://kawalpemilu.org#53848,"PANGKUNG PARUK, SERIRIT, BULELENG, BALI",3,201,21,222
https://kawalpemilu.org#53848,"PANGKUNG PARUK, SERIRIT, BULELENG, BALI",4,173,17,190
https://kawalpemilu.org#53848,"PANGKUNG PARUK, SERIRIT, BULELENG, BALI",5,161,19,180
https://kawalpemilu.org#53848,"PANGKUNG PARUK, SERIRIT, BULELENG, BALI",6,184,15,199
https://kawalpemilu.org#53848,"PANGKUNG PARUK, SERIRIT, BULELENG, BALI",7,151,13,164
https://kawalpemilu.org#53848,"PANGKUNG PARUK, SERIRIT, BULELENG, BALI",8,206,14,8
https://kawalpemilu.org#53848,"PANGKUNG PARUK, SERIRIT, BULELENG, BALI",9,195,11,206
https://kawalpemilu.org#53848,"PANGKUNG PARUK, SERIRIT, BULELENG, BALI",10,212,15,227
https://kawalpemilu.org#53848,"PANGKUNG PARUK, SERIRIT, BULELENG, BALI",11,204,12,216
https://kawalpemilu.org#53848,"PANGKUNG PARUK, SERIRIT, BULELENG, BALI",12,240,10,250
https://kawalpemilu.org#53848,"PANGKUNG PARUK, SERIRIT, BULELENG, BALI",13,228,17,245
https://kawalpemilu.org#53848,"PANGKUNG PARUK, SERIRIT, BULELENG, BALI",14,207,26,233
https://kawalpemilu.org#53848,"PANGKUNG PARUK, SERIRIT, BULELENG, BALI",15,258,14,266
https://kawalpemilu.org#53848,"PANGKUNG PARUK, SERIRIT, BULELENG, BALI",16,181,12,193
https://kawalpemilu.org#53848,"PANGKUNG PARUK, SERIRIT, BULELENG, BALI",17,176,7,183
https://kawalpemilu.org#53848,"PANGKUNG PARUK, SERIRIT, BULELENG, BALI",18,232,22,254
https://kawalpemilu.org#53848,"PANGKUNG PARUK, SERIRIT, BULELENG, BALI",19,220,13,233
https://kawalpemilu.org#53849,"BANJARASEM, SERIRIT, BULELENG, BALI",1,192,8,200
https://kawalpemilu.org#53849,"BANJARASEM, SERIRIT, BULELENG, BALI",2,183,7,190
https://kawalpemilu.org#53849,"BANJARASEM, SERIRIT, BULELENG, BALI",3,193,10,203
https://kawalpemilu.org#53849,"BANJARASEM, SERIRIT, BULELENG, BALI",4,197,9,206
https://kawalpemilu.org#53849,"BANJARASEM, SERIRIT, BULELENG, BALI",5,184,10,194
https://kawalpemilu.org#53849,"BANJARASEM, SERIRIT, BULELENG, BALI",6,186,21,207
https://kawalpemilu.org#53849,"BANJARASEM, SERIRIT, BULELENG, BALI",7,161,5,166
https://kawalpemilu.org#53849,"BANJARASEM, SERIRIT, BULELENG, BALI",8,160,12,172
https://kawalpemilu.org#53849,"BANJARASEM, SERIRIT, BULELENG, BALI",9,141,3,144
https://kawalpemilu.org#53849,"BANJARASEM, SERIRIT, BULELENG, BALI",10,164,6,170
https://kawalpemilu.org#53849,"BANJARASEM, SERIRIT, BULELENG, BALI",11,122,5,127
https://kawalpemilu.org#53849,"BANJARASEM, SERIRIT, BULELENG, BALI",12,133,26,159
https://kawalpemilu.org#53849,"BANJARASEM, SERIRIT, BULELENG, BALI",13,183,11,194
https://kawalpemilu.org#53849,"BANJARASEM, SERIRIT, BULELENG, BALI",14,134,34,168
https://kawalpemilu.org#53849,"BANJARASEM, SERIRIT, BULELENG, BALI",15,200,15,21
https://kawalpemilu.org#53849,"BANJARASEM, SERIRIT, BULELENG, BALI",16,173,4,177
https://kawalpemilu.org#53849,"BANJARASEM, SERIRIT, BULELENG, BALI",17,131,45,176
https://kawalpemilu.org#53850,"KALISADA, SERIRIT, BULELENG, BALI",1,214,6,220
https://kawalpemilu.org#53850,"KALISADA, SERIRIT, BULELENG, BALI",2,221,8,229
https://kawalpemilu.org#53850,"KALISADA, SERIRIT, BULELENG, BALI",3,217,4,221
https://kawalpemilu.org#53850,"KALISADA, SERIRIT, BULELENG, BALI",4,225,3,228
https://kawalpemilu.org#53850,"KALISADA, SERIRIT, BULELENG, BALI",5,220,14,234
https://kawalpemilu.org#53850,"KALISADA, SERIRIT, BULELENG, BALI",6,195,27,222
https://kawalpemilu.org#53850,"KALISADA, SERIRIT, BULELENG, BALI",7,188,14,202
https://kawalpemilu.org#53850,"KALISADA, SERIRIT, BULELENG, BALI",8,176,32,208
https://kawalpemilu.org#53851,"UMEANYAR, SERIRIT, BULELENG, BALI",1,201,13,214
https://kawalpemilu.org#53851,"UMEANYAR, SERIRIT, BULELENG, BALI",2,179,12,191
https://kawalpemilu.org#53851,"UMEANYAR, SERIRIT, BULELENG, BALI",3,179,11,190
https://kawalpemilu.org#53851,"UMEANYAR, SERIRIT, BULELENG, BALI",4,197,22,219
https://kawalpemilu.org#53851,"UMEANYAR, SERIRIT, BULELENG, BALI",5,178,9,187
https://kawalpemilu.org#53853,"SEPANG, BUSUNG BIU, BULELENG, BALI",1,141,8,149
https://kawalpemilu.org#53853,"SEPANG, BUSUNG BIU, BULELENG, BALI",2,192,21,213
https://kawalpemilu.org#53853,"SEPANG, BUSUNG BIU, BULELENG, BALI",3,142,22,238
https://kawalpemilu.org#53853,"SEPANG, BUSUNG BIU, BULELENG, BALI",4,146,14,160
https://kawalpemilu.org#53853,"SEPANG, BUSUNG BIU, BULELENG, BALI",5,159,22,181
https://kawalpemilu.org#53853,"SEPANG, BUSUNG BIU, BULELENG, BALI",6,164,12,176
https://kawalpemilu.org#53853,"SEPANG, BUSUNG BIU, BULELENG, BALI",7,169,10,179
https://kawalpemilu.org#53853,"SEPANG, BUSUNG BIU, BULELENG, BALI",8,197,12,209
https://kawalpemilu.org#53853,"SEPANG, BUSUNG BIU, BULELENG, BALI",9,193,5,198
https://kawalpemilu.org#53853,"SEPANG, BUSUNG BIU, BULELENG, BALI",10,153,24,177
https://kawalpemilu.org#53853,"SEPANG, BUSUNG BIU, BULELENG, BALI",11,161,26,187
https://kawalpemilu.org#53853,"SEPANG, BUSUNG BIU, BULELENG, BALI",12,170,18,188
https://kawalpemilu.org#53853,"SEPANG, BUSUNG BIU, BULELENG, BALI",13,188,28,216
https://kawalpemilu.org#53853,"SEPANG, BUSUNG BIU, BULELENG, BALI",14,161,29,190
https://kawalpemilu.org#53853,"SEPANG, BUSUNG BIU, BULELENG, BALI",15,125,20,145
https://kawalpemilu.org#53854,"TISTA, BUSUNG BIU, BULELENG, BALI",1,172,16,188
https://kawalpemilu.org#53854,"TISTA, BUSUNG BIU, BULELENG, BALI",2,164,18,182
https://kawalpemilu.org#53854,"TISTA, BUSUNG BIU, BULELENG, BALI",3,164,10,174
https://kawalpemilu.org#53854,"TISTA, BUSUNG BIU, BULELENG, BALI",4,169,18,187
https://kawalpemilu.org#53854,"TISTA, BUSUNG BIU, BULELENG, BALI",5,166,4,170
https://kawalpemilu.org#53854,"TISTA, BUSUNG BIU, BULELENG, BALI",6,175,9,184
https://kawalpemilu.org#53854,"TISTA, BUSUNG BIU, BULELENG, BALI",7,191,7,198
https://kawalpemilu.org#53854,"TISTA, BUSUNG BIU, BULELENG, BALI",8,229,5,234
https://kawalpemilu.org#53854,"TISTA, BUSUNG BIU, BULELENG, BALI",9,222,10,232
https://kawalpemilu.org#53854,"TISTA, BUSUNG BIU, BULELENG, BALI",10,200,16,216
https://kawalpemilu.org#53854,"TISTA, BUSUNG BIU, BULELENG, BALI",11,171,11,182
https://kawalpemilu.org#53854,"TISTA, BUSUNG BIU, BULELENG, BALI",12,150,21,171
https://kawalpemilu.org#53854,"TISTA, BUSUNG BIU, BULELENG, BALI",13,138,13,151
https://kawalpemilu.org#53855,"BONGANCINA, BUSUNG BIU, BULELENG, BALI",1,184,9,193
https://kawalpemilu.org#53855,"BONGANCINA, BUSUNG BIU, BULELENG, BALI",2,199,9,208
https://kawalpemilu.org#53855,"BONGANCINA, BUSUNG BIU, BULELENG, BALI",3,178,5,183
https://kawalpemilu.org#53855,"BONGANCINA, BUSUNG BIU, BULELENG, BALI",4,186,12,198
https://kawalpemilu.org#53856,"PUCAKSARI, BUSUNG BIU, BULELENG, BALI",1,223,15,238
https://kawalpemilu.org#53856,"PUCAKSARI, BUSUNG BIU, BULELENG, BALI",2,195,17,212
https://kawalpemilu.org#53856,"PUCAKSARI, BUSUNG BIU, BULELENG, BALI",3,181,10,191
https://kawalpemilu.org#53856,"PUCAKSARI, BUSUNG BIU, BULELENG, BALI",4,151,5,156
https://kawalpemilu.org#53856,"PUCAKSARI, BUSUNG BIU, BULELENG, BALI",5,134,6,140
https://kawalpemilu.org#53856,"PUCAKSARI, BUSUNG BIU, BULELENG, BALI",6,186,5,191
https://kawalpemilu.org#53856,"PUCAKSARI, BUSUNG BIU, BULELENG, BALI",7,176,5,181
https://kawalpemilu.org#53856,"PUCAKSARI, BUSUNG BIU, BULELENG, BALI",8,195,11,206
https://kawalpemilu.org#53856,"PUCAKSARI, BUSUNG BIU, BULELENG, BALI",9,196,4,200
https://kawalpemilu.org#53857,"TELAGA, BUSUNG BIU, BULELENG, BALI",1,175,20,195
https://kawalpemilu.org#53857,"TELAGA, BUSUNG BIU, BULELENG, BALI",3,201,16,217
https://kawalpemilu.org#53857,"TELAGA, BUSUNG BIU, BULELENG, BALI",4,189,11,200
https://kawalpemilu.org#53858,"TITAB, BUSUNG BIU, BULELENG, BALI",1,198,22,220
https://kawalpemilu.org#53858,"TITAB, BUSUNG BIU, BULELENG, BALI",2,214,7,221
https://kawalpemilu.org#53858,"TITAB, BUSUNG BIU, BULELENG, BALI",3,227,7,234
https://kawalpemilu.org#53859,"SUBUK, BUSUNG BIU, BULELENG, BALI",1,178,11,189
https://kawalpemilu.org#53859,"SUBUK, BUSUNG BIU, BULELENG, BALI",2,152,15,167
https://kawalpemilu.org#53859,"SUBUK, BUSUNG BIU, BULELENG, BALI",3,168,3,171
https://kawalpemilu.org#53859,"SUBUK, BUSUNG BIU, BULELENG, BALI",4,174,10,184
https://kawalpemilu.org#53859,"SUBUK, BUSUNG BIU, BULELENG, BALI",5,170,11,181
https://kawalpemilu.org#53860,"TINGGARSARI, BUSUNG BIU, BULELENG, BALI",1,185,14,199
https://kawalpemilu.org#53860,"TINGGARSARI, BUSUNG BIU, BULELENG, BALI",2,203,10,213
https://kawalpemilu.org#53860,"TINGGARSARI, BUSUNG BIU, BULELENG, BALI",3,191,5,196
https://kawalpemilu.org#53860,"TINGGARSARI, BUSUNG BIU, BULELENG, BALI",4,208,6,214
https://kawalpemilu.org#53860,"TINGGARSARI, BUSUNG BIU, BULELENG, BALI",5,199,10,209
https://kawalpemilu.org#53860,"TINGGARSARI, BUSUNG BIU, BULELENG, BALI",6,177,11,188
https://kawalpemilu.org#53860,"TINGGARSARI, BUSUNG BIU, BULELENG, BALI",7,251,9,260
https://kawalpemilu.org#53860,"TINGGARSARI, BUSUNG BIU, BULELENG, BALI",8,194,7,201
https://kawalpemilu.org#53860,"TINGGARSARI, BUSUNG BIU, BULELENG, BALI",9,231,7,238
https://kawalpemilu.org#53861,"KEDIS, BUSUNG BIU, BULELENG, BALI",1,181,25,206
https://kawalpemilu.org#53861,"KEDIS, BUSUNG BIU, BULELENG, BALI",2,176,23,199
https://kawalpemilu.org#53861,"KEDIS, BUSUNG BIU, BULELENG, BALI",3,153,11,164
https://kawalpemilu.org#53861,"KEDIS, BUSUNG BIU, BULELENG, BALI",4,147,13,160
https://kawalpemilu.org#53861,"KEDIS, BUSUNG BIU, BULELENG, BALI",5,170,27,197
https://kawalpemilu.org#53861,"KEDIS, BUSUNG BIU, BULELENG, BALI",6,149,23,172
https://kawalpemilu.org#53861,"KEDIS, BUSUNG BIU, BULELENG, BALI",7,175,12,187
https://kawalpemilu.org#53861,"KEDIS, BUSUNG BIU, BULELENG, BALI",8,158,27,185
https://kawalpemilu.org#53861,"KEDIS, BUSUNG BIU, BULELENG, BALI",9,135,20,155
https://kawalpemilu.org#53861,"KEDIS, BUSUNG BIU, BULELENG, BALI",10,129,17,146
https://kawalpemilu.org#53862,"KEKERAN, BUSUNG BIU, BULELENG, BALI",1,186,8,194
https://kawalpemilu.org#53862,"KEKERAN, BUSUNG BIU, BULELENG, BALI",2,192,7,199
https://kawalpemilu.org#53862,"KEKERAN, BUSUNG BIU, BULELENG, BALI",3,207,4,211
https://kawalpemilu.org#53862,"KEKERAN, BUSUNG BIU, BULELENG, BALI",4,191,9,200
https://kawalpemilu.org#53862,"KEKERAN, BUSUNG BIU, BULELENG, BALI",5,184,5,189
https://kawalpemilu.org#53862,"KEKERAN, BUSUNG BIU, BULELENG, BALI",6,176,5,181
https://kawalpemilu.org#53862,"KEKERAN, BUSUNG BIU, BULELENG, BALI",7,196,8,204
https://kawalpemilu.org#53862,"KEKERAN, BUSUNG BIU, BULELENG, BALI",8,195,5,200
https://kawalpemilu.org#53863,"BUSUNGBIU, BUSUNG BIU, BULELENG, BALI",1,195,9,204
https://kawalpemilu.org#53863,"BUSUNGBIU, BUSUNG BIU, BULELENG, BALI",2,205,8,213
https://kawalpemilu.org#53863,"BUSUNGBIU, BUSUNG BIU, BULELENG, BALI",3,215,10,225
https://kawalpemilu.org#53863,"BUSUNGBIU, BUSUNG BIU, BULELENG, BALI",4,216,7,223
https://kawalpemilu.org#53863,"BUSUNGBIU, BUSUNG BIU, BULELENG, BALI",5,253,2,255
https://kawalpemilu.org#53863,"BUSUNGBIU, BUSUNG BIU, BULELENG, BALI",6,234,7,241
https://kawalpemilu.org#53863,"BUSUNGBIU, BUSUNG BIU, BULELENG, BALI",7,231,8,239
https://kawalpemilu.org#53863,"BUSUNGBIU, BUSUNG BIU, BULELENG, BALI",8,217,8,225
https://kawalpemilu.org#53863,"BUSUNGBIU, BUSUNG BIU, BULELENG, BALI",9,208,20,228
https://kawalpemilu.org#53863,"BUSUNGBIU, BUSUNG BIU, BULELENG, BALI",10,212,9,221
https://kawalpemilu.org#53863,"BUSUNGBIU, BUSUNG BIU, BULELENG, BALI",11,211,17,228
https://kawalpemilu.org#53863,"BUSUNGBIU, BUSUNG BIU, BULELENG, BALI",12,226,2,228
https://kawalpemilu.org#53863,"BUSUNGBIU, BUSUNG BIU, BULELENG, BALI",13,232,9,241
https://kawalpemilu.org#53863,"BUSUNGBIU, BUSUNG BIU, BULELENG, BALI",14,195,16,211
https://kawalpemilu.org#53863,"BUSUNGBIU, BUSUNG BIU, BULELENG, BALI",15,214,11,225
https://kawalpemilu.org#53863,"BUSUNGBIU, BUSUNG BIU, BULELENG, BALI",16,201,15,216
https://kawalpemilu.org#53863,"BUSUNGBIU, BUSUNG BIU, BULELENG, BALI",17,218,13,231
https://kawalpemilu.org#53863,"BUSUNGBIU, BUSUNG BIU, BULELENG, BALI",18,218,14,232
https://kawalpemilu.org#53863,"BUSUNGBIU, BUSUNG BIU, BULELENG, BALI",19,222,17,239
https://kawalpemilu.org#53863,"BUSUNGBIU, BUSUNG BIU, BULELENG, BALI",20,222,3,225
https://kawalpemilu.org#53863,"BUSUNGBIU, BUSUNG BIU, BULELENG, BALI",21,230,9,239
https://kawalpemilu.org#53863,"BUSUNGBIU, BUSUNG BIU, BULELENG, BALI",22,212,7,219
https://kawalpemilu.org#53863,"BUSUNGBIU, BUSUNG BIU, BULELENG, BALI",23,207,10,217
https://kawalpemilu.org#53863,"BUSUNGBIU, BUSUNG BIU, BULELENG, BALI",24,196,7,203
https://kawalpemilu.org#53863,"BUSUNGBIU, BUSUNG BIU, BULELENG, BALI",25,211,16,227
https://kawalpemilu.org#53864,"PELAPUAN, BUSUNG BIU, BULELENG, BALI",1,187,4,191
https://kawalpemilu.org#53864,"PELAPUAN, BUSUNG BIU, BULELENG, BALI",2,213,9,222
https://kawalpemilu.org#53864,"PELAPUAN, BUSUNG BIU, BULELENG, BALI",3,155,20,175
https://kawalpemilu.org#53864,"PELAPUAN, BUSUNG BIU, BULELENG, BALI",4,160,36,196
https://kawalpemilu.org#53864,"PELAPUAN, BUSUNG BIU, BULELENG, BALI",5,179,36,215
https://kawalpemilu.org#53864,"PELAPUAN, BUSUNG BIU, BULELENG, BALI",6,152,37,189
https://kawalpemilu.org#53864,"PELAPUAN, BUSUNG BIU, BULELENG, BALI",7,148,48,196
https://kawalpemilu.org#53864,"PELAPUAN, BUSUNG BIU, BULELENG, BALI",8,156,34,190
https://kawalpemilu.org#53864,"PELAPUAN, BUSUNG BIU, BULELENG, BALI",9,166,19,185
https://kawalpemilu.org#53864,"PELAPUAN, BUSUNG BIU, BULELENG, BALI",10,173,21,194
https://kawalpemilu.org#53865,"BENGKEL, BUSUNG BIU, BULELENG, BALI",1,179,12,191
https://kawalpemilu.org#53865,"BENGKEL, BUSUNG BIU, BULELENG, BALI",2,186,13,199
https://kawalpemilu.org#53865,"BENGKEL, BUSUNG BIU, BULELENG, BALI",3,177,5,182
https://kawalpemilu.org#53865,"BENGKEL, BUSUNG BIU, BULELENG, BALI",4,188,13,201
https://kawalpemilu.org#53865,"BENGKEL, BUSUNG BIU, BULELENG, BALI",5,190,10,200
https://kawalpemilu.org#53865,"BENGKEL, BUSUNG BIU, BULELENG, BALI",6,168,11,179
https://kawalpemilu.org#53865,"BENGKEL, BUSUNG BIU, BULELENG, BALI",7,185,5,190
https://kawalpemilu.org#53865,"BENGKEL, BUSUNG BIU, BULELENG, BALI",8,210,11,221
https://kawalpemilu.org#53865,"BENGKEL, BUSUNG BIU, BULELENG, BALI",9,191,2,193
https://kawalpemilu.org#53865,"BENGKEL, BUSUNG BIU, BULELENG, BALI",10,210,3,213
https://kawalpemilu.org#53866,"UMEJERO, BUSUNG BIU, BULELENG, BALI",1,171,16,187
https://kawalpemilu.org#53866,"UMEJERO, BUSUNG BIU, BULELENG, BALI",2,204,14,218
https://kawalpemilu.org#53866,"UMEJERO, BUSUNG BIU, BULELENG, BALI",3,205,6,211
https://kawalpemilu.org#53866,"UMEJERO, BUSUNG BIU, BULELENG, BALI",5,232,5,237
https://kawalpemilu.org#53866,"UMEJERO, BUSUNG BIU, BULELENG, BALI",6,202,15,217
https://kawalpemilu.org#53866,"UMEJERO, BUSUNG BIU, BULELENG, BALI",7,197,9,206
https://kawalpemilu.org#53866,"UMEJERO, BUSUNG BIU, BULELENG, BALI",9,223,2,225
https://kawalpemilu.org#53867,"SEPANG KELOD, BUSUNG BIU, BULELENG, BALI",1,136,33,169
https://kawalpemilu.org#53867,"SEPANG KELOD, BUSUNG BIU, BULELENG, BALI",2,160,8,168
https://kawalpemilu.org#53867,"SEPANG KELOD, BUSUNG BIU, BULELENG, BALI",3,140,20,160
https://kawalpemilu.org#53867,"SEPANG KELOD, BUSUNG BIU, BULELENG, BALI",4,146,18,164
https://kawalpemilu.org#53867,"SEPANG KELOD, BUSUNG BIU, BULELENG, BALI",5,158,11,169
https://kawalpemilu.org#53867,"SEPANG KELOD, BUSUNG BIU, BULELENG, BALI",6,187,4,191
https://kawalpemilu.org#53867,"SEPANG KELOD, BUSUNG BIU, BULELENG, BALI",7,175,10,185
https://kawalpemilu.org#53867,"SEPANG KELOD, BUSUNG BIU, BULELENG, BALI",8,181,5,186
https://kawalpemilu.org#53867,"SEPANG KELOD, BUSUNG BIU, BULELENG, BALI",9,207,15,222
https://kawalpemilu.org#53867,"SEPANG KELOD, BUSUNG BIU, BULELENG, BALI",10,180,13,193
https://kawalpemilu.org#53867,"SEPANG KELOD, BUSUNG BIU, BULELENG, BALI",11,213,6,219
https://kawalpemilu.org#53867,"SEPANG KELOD, BUSUNG BIU, BULELENG, BALI",12,202,3,205
https://kawalpemilu.org#53869,"BANYUSERI, BANJAR, BULELENG, BALI",1,182,27,209
https://kawalpemilu.org#53869,"BANYUSERI, BANJAR, BULELENG, BALI",2,158,41,199
https://kawalpemilu.org#53869,"BANYUSERI, BANJAR, BULELENG, BALI",3,161,23,184
https://kawalpemilu.org#53869,"BANYUSERI, BANJAR, BULELENG, BALI",4,175,22,197
https://kawalpemilu.org#53869,"BANYUSERI, BANJAR, BULELENG, BALI",5,196,28,224
https://kawalpemilu.org#53870,"TIRTASARI, BANJAR, BULELENG, BALI",1,211,19,230
https://kawalpemilu.org#53870,"TIRTASARI, BANJAR, BULELENG, BALI",2,203,18,121
https://kawalpemilu.org#53870,"TIRTASARI, BANJAR, BULELENG, BALI",3,192,17,209
https://kawalpemilu.org#53870,"TIRTASARI, BANJAR, BULELENG, BALI",4,199,16,215
https://kawalpemilu.org#53870,"TIRTASARI, BANJAR, BULELENG, BALI",5,207,23,230
https://kawalpemilu.org#53871,"KAYUPUTIH, BANJAR, BULELENG, BALI",1,149,13,162
https://kawalpemilu.org#53871,"KAYUPUTIH, BANJAR, BULELENG, BALI",2,139,10,149
https://kawalpemilu.org#53871,"KAYUPUTIH, BANJAR, BULELENG, BALI",4,167,9,176
https://kawalpemilu.org#53871,"KAYUPUTIH, BANJAR, BULELENG, BALI",5,166,13,179
https://kawalpemilu.org#53871,"KAYUPUTIH, BANJAR, BULELENG, BALI",6,141,12,153
https://kawalpemilu.org#53871,"KAYUPUTIH, BANJAR, BULELENG, BALI",7,171,12,183
https://kawalpemilu.org#53871,"KAYUPUTIH, BANJAR, BULELENG, BALI",8,182,13,195
https://kawalpemilu.org#53871,"KAYUPUTIH, BANJAR, BULELENG, BALI",9,208,17,225
https://kawalpemilu.org#53871,"KAYUPUTIH, BANJAR, BULELENG, BALI",10,157,54,211
https://kawalpemilu.org#53871,"KAYUPUTIH, BANJAR, BULELENG, BALI",11,155,6,161
https://kawalpemilu.org#53871,"KAYUPUTIH, BANJAR, BULELENG, BALI",12,197,10,207
https://kawalpemilu.org#53871,"KAYUPUTIH, BANJAR, BULELENG, BALI",13,185,7,192
https://kawalpemilu.org#53871,"KAYUPUTIH, BANJAR, BULELENG, BALI",14,164,6,170
https://kawalpemilu.org#53871,"KAYUPUTIH, BANJAR, BULELENG, BALI",15,224,3,227
https://kawalpemilu.org#53871,"KAYUPUTIH, BANJAR, BULELENG, BALI",16,222,12,234
https://kawalpemilu.org#53872,"BANYUATIS, BANJAR, BULELENG, BALI",1,131,2,133
https://kawalpemilu.org#53872,"BANYUATIS, BANJAR, BULELENG, BALI",2,154,12,166
https://kawalpemilu.org#53872,"BANYUATIS, BANJAR, BULELENG, BALI",3,155,11,166
https://kawalpemilu.org#53872,"BANYUATIS, BANJAR, BULELENG, BALI",4,183,12,195
https://kawalpemilu.org#53872,"BANYUATIS, BANJAR, BULELENG, BALI",5,200,8,208
https://kawalpemilu.org#53872,"BANYUATIS, BANJAR, BULELENG, BALI",6,212,4,216
https://kawalpemilu.org#53872,"BANYUATIS, BANJAR, BULELENG, BALI",7,211,13,224
https://kawalpemilu.org#53872,"BANYUATIS, BANJAR, BULELENG, BALI",8,207,10,217
https://kawalpemilu.org#53872,"BANYUATIS, BANJAR, BULELENG, BALI",9,207,12,219
https://kawalpemilu.org#53873,"GESING, BANJAR, BULELENG, BALI",1,181,14,195
https://kawalpemilu.org#53873,"GESING, BANJAR, BULELENG, BALI",2,191,11,202
https://kawalpemilu.org#53873,"GESING, BANJAR, BULELENG, BALI",3,214,20,234
https://kawalpemilu.org#53873,"GESING, BANJAR, BULELENG, BALI",4,184,30,214
https://kawalpemilu.org#53873,"GESING, BANJAR, BULELENG, BALI",5,162,12,174
https://kawalpemilu.org#53873,"GESING, BANJAR, BULELENG, BALI",6,177,18,195
https://kawalpemilu.org#53873,"GESING, BANJAR, BULELENG, BALI",7,197,12,209
https://kawalpemilu.org#53873,"GESING, BANJAR, BULELENG, BALI",8,184,21,205
https://kawalpemilu.org#53873,"GESING, BANJAR, BULELENG, BALI",9,145,11,156
https://kawalpemilu.org#53873,"GESING, BANJAR, BULELENG, BALI",11,177,12,189
https://kawalpemilu.org#53873,"GESING, BANJAR, BULELENG, BALI",12,179,18,197
https://kawalpemilu.org#53874,"MUNDUK, BANJAR, BULELENG, BALI",1,194,13,207
https://kawalpemilu.org#53874,"MUNDUK, BANJAR, BULELENG, BALI",2,223,5,228
https://kawalpemilu.org#53874,"MUNDUK, BANJAR, BULELENG, BALI",3,217,10,227
https://kawalpemilu.org#53874,"MUNDUK, BANJAR, BULELENG, BALI",4,200,9,209
https://kawalpemilu.org#53874,"MUNDUK, BANJAR, BULELENG, BALI",5,177,6,183
https://kawalpemilu.org#53874,"MUNDUK, BANJAR, BULELENG, BALI",6,182,2,184
https://kawalpemilu.org#53874,"MUNDUK, BANJAR, BULELENG, BALI",7,167,1,168
https://kawalpemilu.org#53874,"MUNDUK, BANJAR, BULELENG, BALI",8,178,7,185
https://kawalpemilu.org#53874,"MUNDUK, BANJAR, BULELENG, BALI",9,158,4,162
https://kawalpemilu.org#53874,"MUNDUK, BANJAR, BULELENG, BALI",10,179,5,184
https://kawalpemilu.org#53874,"MUNDUK, BANJAR, BULELENG, BALI",11,159,10,169
https://kawalpemilu.org#53874,"MUNDUK, BANJAR, BULELENG, BALI",12,163,6,169
https://kawalpemilu.org#53874,"MUNDUK, BANJAR, BULELENG, BALI",13,197,2,199
https://kawalpemilu.org#53874,"MUNDUK, BANJAR, BULELENG, BALI",14,155,5,160
https://kawalpemilu.org#53874,"MUNDUK, BANJAR, BULELENG, BALI",15,205,4,209
https://kawalpemilu.org#53874,"MUNDUK, BANJAR, BULELENG, BALI",16,227,11,238
https://kawalpemilu.org#53874,"MUNDUK, BANJAR, BULELENG, BALI",17,214,3,217
https://kawalpemilu.org#53874,"MUNDUK, BANJAR, BULELENG, BALI",18,211,5,216
https://kawalpemilu.org#53874,"MUNDUK, BANJAR, BULELENG, BALI",19,225,5,230
https://kawalpemilu.org#53875,"GOBLEG, BANJAR, BULELENG, BALI",1,196,14,210
https://kawalpemilu.org#53875,"GOBLEG, BANJAR, BULELENG, BALI",2,176,20,196
https://kawalpemilu.org#53875,"GOBLEG, BANJAR, BULELENG, BALI",3,176,2,178
https://kawalpemilu.org#53875,"GOBLEG, BANJAR, BULELENG, BALI",4,164,3,167
https://kawalpemilu.org#53875,"GOBLEG, BANJAR, BULELENG, BALI",5,214,6,220
https://kawalpemilu.org#53875,"GOBLEG, BANJAR, BULELENG, BALI",6,213,3,216
https://kawalpemilu.org#53875,"GOBLEG, BANJAR, BULELENG, BALI",7,196,14,210
https://kawalpemilu.org#53875,"GOBLEG, BANJAR, BULELENG, BALI",8,196,7,203
https://kawalpemilu.org#53875,"GOBLEG, BANJAR, BULELENG, BALI",9,203,12,215
https://kawalpemilu.org#53875,"GOBLEG, BANJAR, BULELENG, BALI",10,202,8,210
https://kawalpemilu.org#53875,"GOBLEG, BANJAR, BULELENG, BALI",11,229,9,238
https://kawalpemilu.org#53875,"GOBLEG, BANJAR, BULELENG, BALI",12,195,13,208
https://kawalpemilu.org#53875,"GOBLEG, BANJAR, BULELENG, BALI",13,179,9,188
https://kawalpemilu.org#53875,"GOBLEG, BANJAR, BULELENG, BALI",14,190,6,196
https://kawalpemilu.org#53875,"GOBLEG, BANJAR, BULELENG, BALI",15,198,8,206
https://kawalpemilu.org#53875,"GOBLEG, BANJAR, BULELENG, BALI",16,235,6,241
https://kawalpemilu.org#53875,"GOBLEG, BANJAR, BULELENG, BALI",17,223,4,227
https://kawalpemilu.org#53875,"GOBLEG, BANJAR, BULELENG, BALI",18,194,6,200
https://kawalpemilu.org#53875,"GOBLEG, BANJAR, BULELENG, BALI",19,207,8,215
https://kawalpemilu.org#53875,"GOBLEG, BANJAR, BULELENG, BALI",20,231,9,240
https://kawalpemilu.org#53876,"PEDAWA, BANJAR, BULELENG, BALI",1,194,53,247
https://kawalpemilu.org#53876,"PEDAWA, BANJAR, BULELENG, BALI",2,190,38,228
https://kawalpemilu.org#53876,"PEDAWA, BANJAR, BULELENG, BALI",3,197,21,218
https://kawalpemilu.org#53876,"PEDAWA, BANJAR, BULELENG, BALI",4,212,29,241
https://kawalpemilu.org#53876,"PEDAWA, BANJAR, BULELENG, BALI",5,154,48,202
https://kawalpemilu.org#53876,"PEDAWA, BANJAR, BULELENG, BALI",6,186,43,229
https://kawalpemilu.org#53876,"PEDAWA, BANJAR, BULELENG, BALI",7,131,34,165
https://kawalpemilu.org#53876,"PEDAWA, BANJAR, BULELENG, BALI",8,153,16,169
https://kawalpemilu.org#53876,"PEDAWA, BANJAR, BULELENG, BALI",9,145,46,191
https://kawalpemilu.org#53876,"PEDAWA, BANJAR, BULELENG, BALI",10,159,36,195
https://kawalpemilu.org#53876,"PEDAWA, BANJAR, BULELENG, BALI",11,169,49,218
https://kawalpemilu.org#53876,"PEDAWA, BANJAR, BULELENG, BALI",12,161,70,231
https://kawalpemilu.org#53876,"PEDAWA, BANJAR, BULELENG, BALI",13,137,83,220
https://kawalpemilu.org#53876,"PEDAWA, BANJAR, BULELENG, BALI",14,183,34,217
https://kawalpemilu.org#53876,"PEDAWA, BANJAR, BULELENG, BALI",15,198,29,227
https://kawalpemilu.org#53877,"CEMPAGA, BANJAR, BULELENG, BALI",1,187,49,236
https://kawalpemilu.org#53877,"CEMPAGA, BANJAR, BULELENG, BALI",2,177,77,254
https://kawalpemilu.org#53877,"CEMPAGA, BANJAR, BULELENG, BALI",3,175,80,255
https://kawalpemilu.org#53877,"CEMPAGA, BANJAR, BULELENG, BALI",4,147,99,246
https://kawalpemilu.org#53877,"CEMPAGA, BANJAR, BULELENG, BALI",5,138,72,210
https://kawalpemilu.org#53877,"CEMPAGA, BANJAR, BULELENG, BALI",6,172,51,223
https://kawalpemilu.org#53877,"CEMPAGA, BANJAR, BULELENG, BALI",7,179,60,239
https://kawalpemilu.org#53877,"CEMPAGA, BANJAR, BULELENG, BALI",8,171,25,196
https://kawalpemilu.org#53878,"SIDETAPA, BANJAR, BULELENG, BALI",1,116,123,239
https://kawalpemilu.org#53878,"SIDETAPA, BANJAR, BULELENG, BALI",2,107,138,245
https://kawalpemilu.org#53878,"SIDETAPA, BANJAR, BULELENG, BALI",3,130,126,256
https://kawalpemilu.org#53878,"SIDETAPA, BANJAR, BULELENG, BALI",4,139,124,263
https://kawalpemilu.org#53878,"SIDETAPA, BANJAR, BULELENG, BALI",5,128,130,258
https://kawalpemilu.org#53878,"SIDETAPA, BANJAR, BULELENG, BALI",6,104,128,232
https://kawalpemilu.org#53878,"SIDETAPA, BANJAR, BULELENG, BALI",7,137,107,244
https://kawalpemilu.org#53878,"SIDETAPA, BANJAR, BULELENG, BALI",8,111,151,262
https://kawalpemilu.org#53878,"SIDETAPA, BANJAR, BULELENG, BALI",9,147,125,272
https://kawalpemilu.org#53878,"SIDETAPA, BANJAR, BULELENG, BALI",10,134,132,266
https://kawalpemilu.org#53878,"SIDETAPA, BANJAR, BULELENG, BALI",11,170,91,261
https://kawalpemilu.org#53878,"SIDETAPA, BANJAR, BULELENG, BALI",12,191,61,252
https://kawalpemilu.org#53878,"SIDETAPA, BANJAR, BULELENG, BALI",13,181,73,254
https://kawalpemilu.org#53878,"SIDETAPA, BANJAR, BULELENG, BALI",14,201,54,255
https://kawalpemilu.org#53878,"SIDETAPA, BANJAR, BULELENG, BALI",15,196,45,241
https://kawalpemilu.org#53879,"TAMPEKAN, BANJAR, BULELENG, BALI",1,176,37,213
https://kawalpemilu.org#53879,"TAMPEKAN, BANJAR, BULELENG, BALI",2,193,16,209
https://kawalpemilu.org#53879,"TAMPEKAN, BANJAR, BULELENG, BALI",3,152,37,189
https://kawalpemilu.org#53880,"BANJAR TEGEHA, BANJAR, BULELENG, BALI",1,210,13,223
https://kawalpemilu.org#53880,"BANJAR TEGEHA, BANJAR, BULELENG, BALI",2,193,18,211
https://kawalpemilu.org#53880,"BANJAR TEGEHA, BANJAR, BULELENG, BALI",3,190,15,205
https://kawalpemilu.org#53880,"BANJAR TEGEHA, BANJAR, BULELENG, BALI",4,178,25,203
https://kawalpemilu.org#53880,"BANJAR TEGEHA, BANJAR, BULELENG, BALI",5,179,15,194
https://kawalpemilu.org#53880,"BANJAR TEGEHA, BANJAR, BULELENG, BALI",6,176,8,184
https://kawalpemilu.org#53880,"BANJAR TEGEHA, BANJAR, BULELENG, BALI",7,168,14,182
https://kawalpemilu.org#53880,"BANJAR TEGEHA, BANJAR, BULELENG, BALI",8,164,13,177
https://kawalpemilu.org#53881,"BANJAR, BANJAR, BULELENG, BALI",1,190,15,205
https://kawalpemilu.org#53881,"BANJAR, BANJAR, BULELENG, BALI",2,199,9,208
https://kawalpemilu.org#53881,"BANJAR, BANJAR, BULELENG, BALI",3,167,15,182
https://kawalpemilu.org#53881,"BANJAR, BANJAR, BULELENG, BALI",4,194,9,203
https://kawalpemilu.org#53881,"BANJAR, BANJAR, BULELENG, BALI",5,161,7,168
https://kawalpemilu.org#53881,"BANJAR, BANJAR, BULELENG, BALI",6,147,6,153
https://kawalpemilu.org#53881,"BANJAR, BANJAR, BULELENG, BALI",7,170,6,176
https://kawalpemilu.org#53881,"BANJAR, BANJAR, BULELENG, BALI",8,166,9,175
https://kawalpemilu.org#53881,"BANJAR, BANJAR, BULELENG, BALI",9,175,6,181
https://kawalpemilu.org#53881,"BANJAR, BANJAR, BULELENG, BALI",10,200,3,203
https://kawalpemilu.org#53881,"BANJAR, BANJAR, BULELENG, BALI",11,213,5,218
https://kawalpemilu.org#53881,"BANJAR, BANJAR, BULELENG, BALI",12,179,14,193
https://kawalpemilu.org#53881,"BANJAR, BANJAR, BULELENG, BALI",13,178,9,187
https://kawalpemilu.org#53881,"BANJAR, BANJAR, BULELENG, BALI",14,197,6,203
https://kawalpemilu.org#53881,"BANJAR, BANJAR, BULELENG, BALI",15,213,7,220
https://kawalpemilu.org#53881,"BANJAR, BANJAR, BULELENG, BALI",16,173,15,188
https://kawalpemilu.org#53881,"BANJAR, BANJAR, BULELENG, BALI",17,179,10,189
https://kawalpemilu.org#53881,"BANJAR, BANJAR, BULELENG, BALI",18,174,8,182
https://kawalpemilu.org#53881,"BANJAR, BANJAR, BULELENG, BALI",19,151,9,160
https://kawalpemilu.org#53881,"BANJAR, BANJAR, BULELENG, BALI",20,176,6,182
https://kawalpemilu.org#53881,"BANJAR, BANJAR, BULELENG, BALI",21,156,6,162
https://kawalpemilu.org#53881,"BANJAR, BANJAR, BULELENG, BALI",22,171,10,181
https://kawalpemilu.org#53881,"BANJAR, BANJAR, BULELENG, BALI",23,169,10,179
https://kawalpemilu.org#53881,"BANJAR, BANJAR, BULELENG, BALI",24,142,5,147
https://kawalpemilu.org#53881,"BANJAR, BANJAR, BULELENG, BALI",25,187,5,192
https://kawalpemilu.org#53881,"BANJAR, BANJAR, BULELENG, BALI",26,150,18,168
https://kawalpemilu.org#53881,"BANJAR, BANJAR, BULELENG, BALI",27,159,9,168
https://kawalpemilu.org#53881,"BANJAR, BANJAR, BULELENG, BALI",28,216,12,228
https://kawalpemilu.org#53881,"BANJAR, BANJAR, BULELENG, BALI",29,230,9,239
https://kawalpemilu.org#53881,"BANJAR, BANJAR, BULELENG, BALI",30,200,5,205
https://kawalpemilu.org#53881,"BANJAR, BANJAR, BULELENG, BALI",31,213,10,223
https://kawalpemilu.org#53881,"BANJAR, BANJAR, BULELENG, BALI",32,229,10,239
https://kawalpemilu.org#53881,"BANJAR, BANJAR, BULELENG, BALI",33,73,0,73
https://kawalpemilu.org#53882,"DENCARIK, BANJAR, BULELENG, BALI",1,199,14,213
https://kawalpemilu.org#53882,"DENCARIK, BANJAR, BULELENG, BALI",2,213,23,236
https://kawalpemilu.org#53882,"DENCARIK, BANJAR, BULELENG, BALI",3,181,17,198
https://kawalpemilu.org#53882,"DENCARIK, BANJAR, BULELENG, BALI",4,206,9,215
https://kawalpemilu.org#53882,"DENCARIK, BANJAR, BULELENG, BALI",5,229,6,235
https://kawalpemilu.org#53882,"DENCARIK, BANJAR, BULELENG, BALI",6,197,10,207
https://kawalpemilu.org#53882,"DENCARIK, BANJAR, BULELENG, BALI",7,206,16,222
https://kawalpemilu.org#53882,"DENCARIK, BANJAR, BULELENG, BALI",8,214,11,225
https://kawalpemilu.org#53882,"DENCARIK, BANJAR, BULELENG, BALI",9,183,6,189
https://kawalpemilu.org#53882,"DENCARIK, BANJAR, BULELENG, BALI",10,179,14,193
https://kawalpemilu.org#53882,"DENCARIK, BANJAR, BULELENG, BALI",11,177,8,185
https://kawalpemilu.org#53882,"DENCARIK, BANJAR, BULELENG, BALI",12,222,7,229
https://kawalpemilu.org#53882,"DENCARIK, BANJAR, BULELENG, BALI",13,203,20,223
https://kawalpemilu.org#53883,"TEMUKUS, BANJAR, BULELENG, BALI",1,0,0,0
https://kawalpemilu.org#53883,"TEMUKUS, BANJAR, BULELENG, BALI",2,173,32,205
https://kawalpemilu.org#53883,"TEMUKUS, BANJAR, BULELENG, BALI",3,199,14,213
https://kawalpemilu.org#53883,"TEMUKUS, BANJAR, BULELENG, BALI",4,137,18,155
https://kawalpemilu.org#53883,"TEMUKUS, BANJAR, BULELENG, BALI",5,153,19,172
https://kawalpemilu.org#53883,"TEMUKUS, BANJAR, BULELENG, BALI",6,143,15,158
https://kawalpemilu.org#53883,"TEMUKUS, BANJAR, BULELENG, BALI",7,182,13,195
https://kawalpemilu.org#53883,"TEMUKUS, BANJAR, BULELENG, BALI",9,189,16,205
https://kawalpemilu.org#53883,"TEMUKUS, BANJAR, BULELENG, BALI",10,191,12,203
https://kawalpemilu.org#53883,"TEMUKUS, BANJAR, BULELENG, BALI",11,178,3,181
https://kawalpemilu.org#53883,"TEMUKUS, BANJAR, BULELENG, BALI",12,205,23,228
https://kawalpemilu.org#53883,"TEMUKUS, BANJAR, BULELENG, BALI",13,215,16,234
https://kawalpemilu.org#53883,"TEMUKUS, BANJAR, BULELENG, BALI",14,217,22,239
https://kawalpemilu.org#53883,"TEMUKUS, BANJAR, BULELENG, BALI",15,162,28,190
https://kawalpemilu.org#53883,"TEMUKUS, BANJAR, BULELENG, BALI",16,181,24,205
https://kawalpemilu.org#53883,"TEMUKUS, BANJAR, BULELENG, BALI",17,126,63,189
https://kawalpemilu.org#53883,"TEMUKUS, BANJAR, BULELENG, BALI",18,144,55,199
https://kawalpemilu.org#53883,"TEMUKUS, BANJAR, BULELENG, BALI",19,149,53,202
https://kawalpemilu.org#53883,"TEMUKUS, BANJAR, BULELENG, BALI",20,145,37,182
https://kawalpemilu.org#53884,"TIGAWASA, BANJAR, BULELENG, BALI",1,172,26,198
https://kawalpemilu.org#53884,"TIGAWASA, BANJAR, BULELENG, BALI",2,183,26,209
https://kawalpemilu.org#53884,"TIGAWASA, BANJAR, BULELENG, BALI",3,207,49,256
https://kawalpemilu.org#53884,"TIGAWASA, BANJAR, BULELENG, BALI",4,157,67,224
https://kawalpemilu.org#53884,"TIGAWASA, BANJAR, BULELENG, BALI",5,205,25,230
https://kawalpemilu.org#53884,"TIGAWASA, BANJAR, BULELENG, BALI",6,185,28,213
https://kawalpemilu.org#53884,"TIGAWASA, BANJAR, BULELENG, BALI",7,198,28,226
https://kawalpemilu.org#53884,"TIGAWASA, BANJAR, BULELENG, BALI",8,220,16,236
https://kawalpemilu.org#53884,"TIGAWASA, BANJAR, BULELENG, BALI",9,235,27,262
https://kawalpemilu.org#53884,"TIGAWASA, BANJAR, BULELENG, BALI",10,251,7,258
https://kawalpemilu.org#53884,"TIGAWASA, BANJAR, BULELENG, BALI",11,220,40,260
https://kawalpemilu.org#53884,"TIGAWASA, BANJAR, BULELENG, BALI",12,205,43,248
https://kawalpemilu.org#53884,"TIGAWASA, BANJAR, BULELENG, BALI",13,159,82,241
https://kawalpemilu.org#53884,"TIGAWASA, BANJAR, BULELENG, BALI",14,172,30,202
https://kawalpemilu.org#53884,"TIGAWASA, BANJAR, BULELENG, BALI",15,208,61,269
https://kawalpemilu.org#53885,"KALIASEM, BANJAR, BULELENG, BALI",1,133,102,235
https://kawalpemilu.org#53885,"KALIASEM, BANJAR, BULELENG, BALI",2,125,116,241
https://kawalpemilu.org#53885,"KALIASEM, BANJAR, BULELENG, BALI",3,146,62,208
https://kawalpemilu.org#53885,"KALIASEM, BANJAR, BULELENG, BALI",4,238,10,248
https://kawalpemilu.org#53885,"KALIASEM, BANJAR, BULELENG, BALI",5,254,8,262
https://kawalpemilu.org#53885,"KALIASEM, BANJAR, BULELENG, BALI",6,235,9,244
https://kawalpemilu.org#53885,"KALIASEM, BANJAR, BULELENG, BALI",7,221,9,230
https://kawalpemilu.org#53885,"KALIASEM, BANJAR, BULELENG, BALI",8,226,6,232
https://kawalpemilu.org#53885,"KALIASEM, BANJAR, BULELENG, BALI",9,254,4,258
https://kawalpemilu.org#53885,"KALIASEM, BANJAR, BULELENG, BALI",10,208,5,213
https://kawalpemilu.org#53885,"KALIASEM, BANJAR, BULELENG, BALI",11,183,7,190
https://kawalpemilu.org#53885,"KALIASEM, BANJAR, BULELENG, BALI",12,201,7,208
https://kawalpemilu.org#53885,"KALIASEM, BANJAR, BULELENG, BALI",13,202,18,220
https://kawalpemilu.org#53885,"KALIASEM, BANJAR, BULELENG, BALI",14,218,10,228
https://kawalpemilu.org#53885,"KALIASEM, BANJAR, BULELENG, BALI",15,155,9,164
https://kawalpemilu.org#53885,"KALIASEM, BANJAR, BULELENG, BALI",16,161,2,163
https://kawalpemilu.org#53885,"KALIASEM, BANJAR, BULELENG, BALI",17,192,18,210
https://kawalpemilu.org#53885,"KALIASEM, BANJAR, BULELENG, BALI",18,190,12,202
https://kawalpemilu.org#53885,"KALIASEM, BANJAR, BULELENG, BALI",19,204,16,220
https://kawalpemilu.org#53887,"SUKASADA, SUKASADA, BULELENG, BALI",1,163,18,181
https://kawalpemilu.org#53887,"SUKASADA, SUKASADA, BULELENG, BALI",2,154,16,170
https://kawalpemilu.org#53887,"SUKASADA, SUKASADA, BULELENG, BALI",3,155,15,170
https://kawalpemilu.org#53887,"SUKASADA, SUKASADA, BULELENG, BALI",4,156,19,175
https://kawalpemilu.org#53887,"SUKASADA, SUKASADA, BULELENG, BALI",5,177,20,197
https://kawalpemilu.org#53887,"SUKASADA, SUKASADA, BULELENG, BALI",6,167,28,195
https://kawalpemilu.org#53887,"SUKASADA, SUKASADA, BULELENG, BALI",7,171,41,212
https://kawalpemilu.org#53887,"SUKASADA, SUKASADA, BULELENG, BALI",8,165,26,191
https://kawalpemilu.org#53887,"SUKASADA, SUKASADA, BULELENG, BALI",9,151,22,173
https://kawalpemilu.org#53887,"SUKASADA, SUKASADA, BULELENG, BALI",10,202,9,211
https://kawalpemilu.org#53887,"SUKASADA, SUKASADA, BULELENG, BALI",11,208,7,215
https://kawalpemilu.org#53887,"SUKASADA, SUKASADA, BULELENG, BALI",12,180,9,189
https://kawalpemilu.org#53887,"SUKASADA, SUKASADA, BULELENG, BALI",13,208,10,218
https://kawalpemilu.org#53887,"SUKASADA, SUKASADA, BULELENG, BALI",14,163,15,178
https://kawalpemilu.org#53887,"SUKASADA, SUKASADA, BULELENG, BALI",15,181,8,189
https://kawalpemilu.org#53887,"SUKASADA, SUKASADA, BULELENG, BALI",16,187,5,192
https://kawalpemilu.org#53887,"SUKASADA, SUKASADA, BULELENG, BALI",17,192,9,201
https://kawalpemilu.org#53887,"SUKASADA, SUKASADA, BULELENG, BALI",18,184,10,194
https://kawalpemilu.org#53887,"SUKASADA, SUKASADA, BULELENG, BALI",19,155,17,172
https://kawalpemilu.org#53887,"SUKASADA, SUKASADA, BULELENG, BALI",20,185,5,190
https://kawalpemilu.org#53887,"SUKASADA, SUKASADA, BULELENG, BALI",21,201,8,209
https://kawalpemilu.org#53887,"SUKASADA, SUKASADA, BULELENG, BALI",22,177,19,196
https://kawalpemilu.org#53887,"SUKASADA, SUKASADA, BULELENG, BALI",23,192,23,215
https://kawalpemilu.org#53888,"PANCASARI, SUKASADA, BULELENG, BALI",1,226,6,232
https://kawalpemilu.org#53888,"PANCASARI, SUKASADA, BULELENG, BALI",2,160,37,197
https://kawalpemilu.org#53888,"PANCASARI, SUKASADA, BULELENG, BALI",3,185,25,210
https://kawalpemilu.org#53888,"PANCASARI, SUKASADA, BULELENG, BALI",4,237,4,241
https://kawalpemilu.org#53888,"PANCASARI, SUKASADA, BULELENG, BALI",5,246,4,250
https://kawalpemilu.org#53888,"PANCASARI, SUKASADA, BULELENG, BALI",6,261,3,219
https://kawalpemilu.org#53888,"PANCASARI, SUKASADA, BULELENG, BALI",7,229,10,239
https://kawalpemilu.org#53888,"PANCASARI, SUKASADA, BULELENG, BALI",8,254,8,262
https://kawalpemilu.org#53888,"PANCASARI, SUKASADA, BULELENG, BALI",9,229,15,244
https://kawalpemilu.org#53888,"PANCASARI, SUKASADA, BULELENG, BALI",10,270,3,273
https://kawalpemilu.org#53888,"PANCASARI, SUKASADA, BULELENG, BALI",11,265,5,270
https://kawalpemilu.org#53888,"PANCASARI, SUKASADA, BULELENG, BALI",12,234,14,248
https://kawalpemilu.org#53888,"PANCASARI, SUKASADA, BULELENG, BALI",13,234,24,258
https://kawalpemilu.org#53888,"PANCASARI, SUKASADA, BULELENG, BALI",14,200,35,235
https://kawalpemilu.org#53889,"WANAGIRI, SUKASADA, BULELENG, BALI",1,229,4,233
https://kawalpemilu.org#53889,"WANAGIRI, SUKASADA, BULELENG, BALI",2,231,2,233
https://kawalpemilu.org#53889,"WANAGIRI, SUKASADA, BULELENG, BALI",3,239,3,242
https://kawalpemilu.org#53889,"WANAGIRI, SUKASADA, BULELENG, BALI",4,219,14,233
https://kawalpemilu.org#53889,"WANAGIRI, SUKASADA, BULELENG, BALI",5,229,5,234
https://kawalpemilu.org#53889,"WANAGIRI, SUKASADA, BULELENG, BALI",6,218,1,229
https://kawalpemilu.org#53889,"WANAGIRI, SUKASADA, BULELENG, BALI",7,250,14,264
https://kawalpemilu.org#53889,"WANAGIRI, SUKASADA, BULELENG, BALI",8,248,1,249
https://kawalpemilu.org#53889,"WANAGIRI, SUKASADA, BULELENG, BALI",9,262,4,266
https://kawalpemilu.org#53889,"WANAGIRI, SUKASADA, BULELENG, BALI",10,219,7,226
https://kawalpemilu.org#53890,"AMBENGAN, SUKASADA, BULELENG, BALI",1,166,28,194
https://kawalpemilu.org#53890,"AMBENGAN, SUKASADA, BULELENG, BALI",2,148,19,167
https://kawalpemilu.org#53890,"AMBENGAN, SUKASADA, BULELENG, BALI",3,135,31,166
https://kawalpemilu.org#53890,"AMBENGAN, SUKASADA, BULELENG, BALI",4,188,23,211
https://kawalpemilu.org#53890,"AMBENGAN, SUKASADA, BULELENG, BALI",5,193,30,223
https://kawalpemilu.org#53890,"AMBENGAN, SUKASADA, BULELENG, BALI",6,194,29,223
https://kawalpemilu.org#53890,"AMBENGAN, SUKASADA, BULELENG, BALI",7,182,19,201
https://kawalpemilu.org#53890,"AMBENGAN, SUKASADA, BULELENG, BALI",8,171,37,208
https://kawalpemilu.org#53890,"AMBENGAN, SUKASADA, BULELENG, BALI",9,151,42,193
https://kawalpemilu.org#53890,"AMBENGAN, SUKASADA, BULELENG, BALI",10,158,34,192
https://kawalpemilu.org#53890,"AMBENGAN, SUKASADA, BULELENG, BALI",11,172,35,207
https://kawalpemilu.org#53890,"AMBENGAN, SUKASADA, BULELENG, BALI",12,178,36,214
https://kawalpemilu.org#53891,"GITGIT, SUKASADA, BULELENG, BALI",1,231,8,239
https://kawalpemilu.org#53891,"GITGIT, SUKASADA, BULELENG, BALI",2,235,12,247
https://kawalpemilu.org#53891,"GITGIT, SUKASADA, BULELENG, BALI",3,222,8,230
https://kawalpemilu.org#53891,"GITGIT, SUKASADA, BULELENG, BALI",4,225,5,230
https://kawalpemilu.org#53891,"GITGIT, SUKASADA, BULELENG, BALI",5,164,8,172
https://kawalpemilu.org#53891,"GITGIT, SUKASADA, BULELENG, BALI",6,232,12,244
https://kawalpemilu.org#53891,"GITGIT, SUKASADA, BULELENG, BALI",7,205,15,220
https://kawalpemilu.org#53891,"GITGIT, SUKASADA, BULELENG, BALI",8,195,1,196
https://kawalpemilu.org#53891,"GITGIT, SUKASADA, BULELENG, BALI",9,142,4,146
https://kawalpemilu.org#53891,"GITGIT, SUKASADA, BULELENG, BALI",10,148,10,158
https://kawalpemilu.org#53892,"PEGAYAMAN, SUKASADA, BULELENG, BALI",1,25,118,143
https://kawalpemilu.org#53892,"PEGAYAMAN, SUKASADA, BULELENG, BALI",2,31,120,151
https://kawalpemilu.org#53892,"PEGAYAMAN, SUKASADA, BULELENG, BALI",3,28,142,170
https://kawalpemilu.org#53892,"PEGAYAMAN, SUKASADA, BULELENG, BALI",4,20,181,201
https://kawalpemilu.org#53892,"PEGAYAMAN, SUKASADA, BULELENG, BALI",5,36,155,191
https://kawalpemilu.org#53892,"PEGAYAMAN, SUKASADA, BULELENG, BALI",6,43,140,183
https://kawalpemilu.org#53892,"PEGAYAMAN, SUKASADA, BULELENG, BALI",7,35,141,176
https://kawalpemilu.org#53892,"PEGAYAMAN, SUKASADA, BULELENG, BALI",8,32,114,146
https://kawalpemilu.org#53892,"PEGAYAMAN, SUKASADA, BULELENG, BALI",9,72,102,174
https://kawalpemilu.org#53892,"PEGAYAMAN, SUKASADA, BULELENG, BALI",10,48,112,160
https://kawalpemilu.org#53892,"PEGAYAMAN, SUKASADA, BULELENG, BALI",11,48,147,195
https://kawalpemilu.org#53892,"PEGAYAMAN, SUKASADA, BULELENG, BALI",12,57,113,170
https://kawalpemilu.org#53892,"PEGAYAMAN, SUKASADA, BULELENG, BALI",13,51,95,146
https://kawalpemilu.org#53892,"PEGAYAMAN, SUKASADA, BULELENG, BALI",14,54,68,122
https://kawalpemilu.org#53892,"PEGAYAMAN, SUKASADA, BULELENG, BALI",15,84,86,170
https://kawalpemilu.org#53892,"PEGAYAMAN, SUKASADA, BULELENG, BALI",16,98,86,184
https://kawalpemilu.org#53892,"PEGAYAMAN, SUKASADA, BULELENG, BALI",17,50,89,139
https://kawalpemilu.org#53892,"PEGAYAMAN, SUKASADA, BULELENG, BALI",18,96,18,114
https://kawalpemilu.org#53892,"PEGAYAMAN, SUKASADA, BULELENG, BALI",19,98,8,106
https://kawalpemilu.org#53892,"PEGAYAMAN, SUKASADA, BULELENG, BALI",20,159,47,206
https://kawalpemilu.org#53893,"SILANGJANA, SUKASADA, BULELENG, BALI",1,194,18,212
https://kawalpemilu.org#53893,"SILANGJANA, SUKASADA, BULELENG, BALI",2,198,16,214
https://kawalpemilu.org#53893,"SILANGJANA, SUKASADA, BULELENG, BALI",3,208,15,223
https://kawalpemilu.org#53893,"SILANGJANA, SUKASADA, BULELENG, BALI",4,204,14,218
https://kawalpemilu.org#53893,"SILANGJANA, SUKASADA, BULELENG, BALI",5,171,12,183
https://kawalpemilu.org#53893,"SILANGJANA, SUKASADA, BULELENG, BALI",6,189,11,200
https://kawalpemilu.org#53893,"SILANGJANA, SUKASADA, BULELENG, BALI",7,168,4,172
https://kawalpemilu.org#53894,"PEGADUNGAN, SUKASADA, BULELENG, BALI",1,175,6,181
https://kawalpemilu.org#53894,"PEGADUNGAN, SUKASADA, BULELENG, BALI",2,169,4,173
https://kawalpemilu.org#53894,"PEGADUNGAN, SUKASADA, BULELENG, BALI",3,163,2,165
https://kawalpemilu.org#53894,"PEGADUNGAN, SUKASADA, BULELENG, BALI",4,134,3,137
https://kawalpemilu.org#53894,"PEGADUNGAN, SUKASADA, BULELENG, BALI",5,171,22,193
https://kawalpemilu.org#53894,"PEGADUNGAN, SUKASADA, BULELENG, BALI",6,183,1,184
https://kawalpemilu.org#53894,"PEGADUNGAN, SUKASADA, BULELENG, BALI",7,179,2,181
https://kawalpemilu.org#53894,"PEGADUNGAN, SUKASADA, BULELENG, BALI",9,216,8,224
https://kawalpemilu.org#53894,"PEGADUNGAN, SUKASADA, BULELENG, BALI",10,155,1,156
https://kawalpemilu.org#53895,"PADANGBULIA, SUKASADA, BULELENG, BALI",1,191,41,232
https://kawalpemilu.org#53895,"PADANGBULIA, SUKASADA, BULELENG, BALI",2,201,27,228
https://kawalpemilu.org#53895,"PADANGBULIA, SUKASADA, BULELENG, BALI",3,215,6,221
https://kawalpemilu.org#53895,"PADANGBULIA, SUKASADA, BULELENG, BALI",4,224,14,238
https://kawalpemilu.org#53895,"PADANGBULIA, SUKASADA, BULELENG, BALI",5,184,17,201
https://kawalpemilu.org#53895,"PADANGBULIA, SUKASADA, BULELENG, BALI",6,169,12,181
https://kawalpemilu.org#53895,"PADANGBULIA, SUKASADA, BULELENG, BALI",7,162,18,180
https://kawalpemilu.org#53895,"PADANGBULIA, SUKASADA, BULELENG, BALI",8,189,4,193
https://kawalpemilu.org#53895,"PADANGBULIA, SUKASADA, BULELENG, BALI",9,203,12,215
https://kawalpemilu.org#53895,"PADANGBULIA, SUKASADA, BULELENG, BALI",10,163,13,176
https://kawalpemilu.org#53895,"PADANGBULIA, SUKASADA, BULELENG, BALI",11,168,45,213
https://kawalpemilu.org#53896,"SAMBANGAN, SUKASADA, BULELENG, BALI",1,195,10,205
https://kawalpemilu.org#53896,"SAMBANGAN, SUKASADA, BULELENG, BALI",2,186,14,200
https://kawalpemilu.org#53896,"SAMBANGAN, SUKASADA, BULELENG, BALI",3,134,17,151
https://kawalpemilu.org#53896,"SAMBANGAN, SUKASADA, BULELENG, BALI",4,209,23,232
https://kawalpemilu.org#53896,"SAMBANGAN, SUKASADA, BULELENG, BALI",5,182,9,191
https://kawalpemilu.org#53896,"SAMBANGAN, SUKASADA, BULELENG, BALI",6,208,11,219
https://kawalpemilu.org#53896,"SAMBANGAN, SUKASADA, BULELENG, BALI",7,212,10,222
https://kawalpemilu.org#53896,"SAMBANGAN, SUKASADA, BULELENG, BALI",8,191,25,216
https://kawalpemilu.org#53896,"SAMBANGAN, SUKASADA, BULELENG, BALI",9,156,11,167
https://kawalpemilu.org#53896,"SAMBANGAN, SUKASADA, BULELENG, BALI",10,213,21,234
https://kawalpemilu.org#53896,"SAMBANGAN, SUKASADA, BULELENG, BALI",11,159,10,169
https://kawalpemilu.org#53896,"SAMBANGAN, SUKASADA, BULELENG, BALI",12,195,18,213
https://kawalpemilu.org#53896,"SAMBANGAN, SUKASADA, BULELENG, BALI",13,190,7,197
https://kawalpemilu.org#53896,"SAMBANGAN, SUKASADA, BULELENG, BALI",14,189,18,207
https://kawalpemilu.org#53896,"SAMBANGAN, SUKASADA, BULELENG, BALI",15,227,10,237
https://kawalpemilu.org#53896,"SAMBANGAN, SUKASADA, BULELENG, BALI",16,195,3,198
https://kawalpemilu.org#53897,"PANJI, SUKASADA, BULELENG, BALI",1,187,18,205
https://kawalpemilu.org#53897,"PANJI, SUKASADA, BULELENG, BALI",2,195,9,204
https://kawalpemilu.org#53897,"PANJI, SUKASADA, BULELENG, BALI",3,198,18,216
https://kawalpemilu.org#53897,"PANJI, SUKASADA, BULELENG, BALI",4,214,19,233
https://kawalpemilu.org#53897,"PANJI, SUKASADA, BULELENG, BALI",5,222,19,241
https://kawalpemilu.org#53897,"PANJI, SUKASADA, BULELENG, BALI",6,214,14,228
https://kawalpemilu.org#53897,"PANJI, SUKASADA, BULELENG, BALI",7,159,15,174
https://kawalpemilu.org#53897,"PANJI, SUKASADA, BULELENG, BALI",8,200,8,208
https://kawalpemilu.org#53897,"PANJI, SUKASADA, BULELENG, BALI",9,199,10,209
https://kawalpemilu.org#53897,"PANJI, SUKASADA, BULELENG, BALI",10,218,12,230
https://kawalpemilu.org#53897,"PANJI, SUKASADA, BULELENG, BALI",11,188,17,205
https://kawalpemilu.org#53897,"PANJI, SUKASADA, BULELENG, BALI",12,191,13,204
https://kawalpemilu.org#53897,"PANJI, SUKASADA, BULELENG, BALI",13,209,4,213
https://kawalpemilu.org#53897,"PANJI, SUKASADA, BULELENG, BALI",14,184,8,192
https://kawalpemilu.org#53897,"PANJI, SUKASADA, BULELENG, BALI",15,201,13,214
https://kawalpemilu.org#53897,"PANJI, SUKASADA, BULELENG, BALI",16,195,15,210
https://kawalpemilu.org#53897,"PANJI, SUKASADA, BULELENG, BALI",17,208,5,213
https://kawalpemilu.org#53897,"PANJI, SUKASADA, BULELENG, BALI",18,160,8,168
https://kawalpemilu.org#53897,"PANJI, SUKASADA, BULELENG, BALI",19,237,9,246
https://kawalpemilu.org#53897,"PANJI, SUKASADA, BULELENG, BALI",20,195,21,216
https://kawalpemilu.org#53897,"PANJI, SUKASADA, BULELENG, BALI",21,202,40,242
https://kawalpemilu.org#53897,"PANJI, SUKASADA, BULELENG, BALI",22,192,15,207
https://kawalpemilu.org#53897,"PANJI, SUKASADA, BULELENG, BALI",23,163,26,189
https://kawalpemilu.org#53897,"PANJI, SUKASADA, BULELENG, BALI",24,145,27,172
https://kawalpemilu.org#53897,"PANJI, SUKASADA, BULELENG, BALI",25,138,13,151
https://kawalpemilu.org#53897,"PANJI, SUKASADA, BULELENG, BALI",26,162,15,177
https://kawalpemilu.org#53897,"PANJI, SUKASADA, BULELENG, BALI",27,169,3,172
https://kawalpemilu.org#53897,"PANJI, SUKASADA, BULELENG, BALI",28,191,23,214
https://kawalpemilu.org#53897,"PANJI, SUKASADA, BULELENG, BALI",29,217,15,232
https://kawalpemilu.org#53898,"PANJI ANOM, SUKASADA, BULELENG, BALI",1,185,11,196
https://kawalpemilu.org#53898,"PANJI ANOM, SUKASADA, BULELENG, BALI",2,173,9,182
https://kawalpemilu.org#53898,"PANJI ANOM, SUKASADA, BULELENG, BALI",3,185,14,199
https://kawalpemilu.org#53898,"PANJI ANOM, SUKASADA, BULELENG, BALI",4,168,25,193
https://kawalpemilu.org#53898,"PANJI ANOM, SUKASADA, BULELENG, BALI",5,190,7,197
https://kawalpemilu.org#53898,"PANJI ANOM, SUKASADA, BULELENG, BALI",6,187,5,192
https://kawalpemilu.org#53898,"PANJI ANOM, SUKASADA, BULELENG, BALI",7,180,10,190
https://kawalpemilu.org#53898,"PANJI ANOM, SUKASADA, BULELENG, BALI",8,169,19,188
https://kawalpemilu.org#53898,"PANJI ANOM, SUKASADA, BULELENG, BALI",9,169,14,183
https://kawalpemilu.org#53898,"PANJI ANOM, SUKASADA, BULELENG, BALI",10,181,35,216
https://kawalpemilu.org#53898,"PANJI ANOM, SUKASADA, BULELENG, BALI",11,185,54,239
https://kawalpemilu.org#53898,"PANJI ANOM, SUKASADA, BULELENG, BALI",12,174,37,211
https://kawalpemilu.org#53898,"PANJI ANOM, SUKASADA, BULELENG, BALI",13,209,20,229
https://kawalpemilu.org#53898,"PANJI ANOM, SUKASADA, BULELENG, BALI",14,178,37,215
https://kawalpemilu.org#53898,"PANJI ANOM, SUKASADA, BULELENG, BALI",15,149,52,201
https://kawalpemilu.org#53898,"PANJI ANOM, SUKASADA, BULELENG, BALI",16,200,34,234
https://kawalpemilu.org#53898,"PANJI ANOM, SUKASADA, BULELENG, BALI",17,171,24,195
https://kawalpemilu.org#53898,"PANJI ANOM, SUKASADA, BULELENG, BALI",18,167,44,211
https://kawalpemilu.org#53899,"TEGALLINGGAH, SUKASADA, BULELENG, BALI",1,163,9,172
https://kawalpemilu.org#53899,"TEGALLINGGAH, SUKASADA, BULELENG, BALI",2,155,5,160
https://kawalpemilu.org#53899,"TEGALLINGGAH, SUKASADA, BULELENG, BALI",3,165,4,169
https://kawalpemilu.org#53899,"TEGALLINGGAH, SUKASADA, BULELENG, BALI",4,61,190,251
https://kawalpemilu.org#53899,"TEGALLINGGAH, SUKASADA, BULELENG, BALI",5,167,15,182
https://kawalpemilu.org#53899,"TEGALLINGGAH, SUKASADA, BULELENG, BALI",6,82,104,186
https://kawalpemilu.org#53899,"TEGALLINGGAH, SUKASADA, BULELENG, BALI",7,130,67,197
https://kawalpemilu.org#53899,"TEGALLINGGAH, SUKASADA, BULELENG, BALI",8,149,10,159
https://kawalpemilu.org#53899,"TEGALLINGGAH, SUKASADA, BULELENG, BALI",9,245,18,263
https://kawalpemilu.org#53899,"TEGALLINGGAH, SUKASADA, BULELENG, BALI",10,75,159,234
https://kawalpemilu.org#53899,"TEGALLINGGAH, SUKASADA, BULELENG, BALI",11,119,91,210
https://kawalpemilu.org#53899,"TEGALLINGGAH, SUKASADA, BULELENG, BALI",12,70,156,226
https://kawalpemilu.org#53899,"TEGALLINGGAH, SUKASADA, BULELENG, BALI",13,65,185,250
https://kawalpemilu.org#53899,"TEGALLINGGAH, SUKASADA, BULELENG, BALI",14,45,150,195
https://kawalpemilu.org#53899,"TEGALLINGGAH, SUKASADA, BULELENG, BALI",15,48,107,155
https://kawalpemilu.org#53899,"TEGALLINGGAH, SUKASADA, BULELENG, BALI",16,60,109,169
https://kawalpemilu.org#53899,"TEGALLINGGAH, SUKASADA, BULELENG, BALI",17,197,6,203
https://kawalpemilu.org#53899,"TEGALLINGGAH, SUKASADA, BULELENG, BALI",18,151,16,167
https://kawalpemilu.org#53899,"TEGALLINGGAH, SUKASADA, BULELENG, BALI",19,215,11,226
https://kawalpemilu.org#53899,"TEGALLINGGAH, SUKASADA, BULELENG, BALI",20,178,15,193
https://kawalpemilu.org#53899,"TEGALLINGGAH, SUKASADA, BULELENG, BALI",21,113,14,127
https://kawalpemilu.org#53900,"SELAT, SUKASADA, BULELENG, BALI",1,251,6,257
https://kawalpemilu.org#53900,"SELAT, SUKASADA, BULELENG, BALI",2,228,9,237
https://kawalpemilu.org#53900,"SELAT, SUKASADA, BULELENG, BALI",3,219,16,235
https://kawalpemilu.org#53900,"SELAT, SUKASADA, BULELENG, BALI",4,219,12,231
https://kawalpemilu.org#53900,"SELAT, SUKASADA, BULELENG, BALI",5,206,20,226
https://kawalpemilu.org#53900,"SELAT, SUKASADA, BULELENG, BALI",6,235,7,242
https://kawalpemilu.org#53900,"SELAT, SUKASADA, BULELENG, BALI",7,213,9,222
https://kawalpemilu.org#53900,"SELAT, SUKASADA, BULELENG, BALI",8,224,8,232
https://kawalpemilu.org#53900,"SELAT, SUKASADA, BULELENG, BALI",9,172,13,185
https://kawalpemilu.org#53900,"SELAT, SUKASADA, BULELENG, BALI",10,162,4,166
https://kawalpemilu.org#53900,"SELAT, SUKASADA, BULELENG, BALI",11,199,15,214
https://kawalpemilu.org#53900,"SELAT, SUKASADA, BULELENG, BALI",12,169,14,183
https://kawalpemilu.org#53900,"SELAT, SUKASADA, BULELENG, BALI",13,149,23,172
https://kawalpemilu.org#53900,"SELAT, SUKASADA, BULELENG, BALI",14,164,24,188
https://kawalpemilu.org#53900,"SELAT, SUKASADA, BULELENG, BALI",15,161,23,184
https://kawalpemilu.org#53900,"SELAT, SUKASADA, BULELENG, BALI",16,128,23,151
https://kawalpemilu.org#53900,"SELAT, SUKASADA, BULELENG, BALI",17,185,9,194
https://kawalpemilu.org#53900,"SELAT, SUKASADA, BULELENG, BALI",18,187,15,202
https://kawalpemilu.org#53900,"SELAT, SUKASADA, BULELENG, BALI",19,188,4,192
https://kawalpemilu.org#53900,"SELAT, SUKASADA, BULELENG, BALI",20,190,26,216
https://kawalpemilu.org#53900,"SELAT, SUKASADA, BULELENG, BALI",21,217,20,237
https://kawalpemilu.org#53900,"SELAT, SUKASADA, BULELENG, BALI",22,204,33,237
https://kawalpemilu.org#53900,"SELAT, SUKASADA, BULELENG, BALI",23,148,8,156
https://kawalpemilu.org#53900,"SELAT, SUKASADA, BULELENG, BALI",24,146,4,150
https://kawalpemilu.org#53901,"KAYU PUTIH, SUKASADA, BULELENG, BALI",1,214,5,219
https://kawalpemilu.org#53901,"KAYU PUTIH, SUKASADA, BULELENG, BALI",2,186,7,193
https://kawalpemilu.org#53901,"KAYU PUTIH, SUKASADA, BULELENG, BALI",3,208,5,213
https://kawalpemilu.org#53901,"KAYU PUTIH, SUKASADA, BULELENG, BALI",4,171,11,182
https://kawalpemilu.org#53901,"KAYU PUTIH, SUKASADA, BULELENG, BALI",5,171,5,176
https://kawalpemilu.org#53901,"KAYU PUTIH, SUKASADA, BULELENG, BALI",6,201,8,209
https://kawalpemilu.org#53901,"KAYU PUTIH, SUKASADA, BULELENG, BALI",7,182,6,188
https://kawalpemilu.org#53901,"KAYU PUTIH, SUKASADA, BULELENG, BALI",8,182,2,184
https://kawalpemilu.org#53901,"KAYU PUTIH, SUKASADA, BULELENG, BALI",9,214,4,218
https://kawalpemilu.org#53901,"KAYU PUTIH, SUKASADA, BULELENG, BALI",10,180,2,182
https://kawalpemilu.org#53901,"KAYU PUTIH, SUKASADA, BULELENG, BALI",11,188,7,195
https://kawalpemilu.org#53901,"KAYU PUTIH, SUKASADA, BULELENG, BALI",12,167,11,178
https://kawalpemilu.org#53901,"KAYU PUTIH, SUKASADA, BULELENG, BALI",13,160,10,170
https://kawalpemilu.org#53901,"KAYU PUTIH, SUKASADA, BULELENG, BALI",14,181,7,188
https://kawalpemilu.org#53901,"KAYU PUTIH, SUKASADA, BULELENG, BALI",15,205,4,209
https://kawalpemilu.org#53903,"BANYUASRI, BULELENG, BULELENG, BALI",1,206,44,250
https://kawalpemilu.org#53903,"BANYUASRI, BULELENG, BULELENG, BALI",2,225,12,237
https://kawalpemilu.org#53903,"BANYUASRI, BULELENG, BULELENG, BALI",3,277,8,285
https://kawalpemilu.org#53903,"BANYUASRI, BULELENG, BULELENG, BALI",4,223,29,252
https://kawalpemilu.org#53903,"BANYUASRI, BULELENG, BULELENG, BALI",5,220,32,252
https://kawalpemilu.org#53903,"BANYUASRI, BULELENG, BULELENG, BALI",6,271,0,271
https://kawalpemilu.org#53903,"BANYUASRI, BULELENG, BULELENG, BALI",7,210,21,231
https://kawalpemilu.org#53903,"BANYUASRI, BULELENG, BULELENG, BALI",8,183,33,216
https://kawalpemilu.org#53903,"BANYUASRI, BULELENG, BULELENG, BALI",9,139,39,178
https://kawalpemilu.org#53903,"BANYUASRI, BULELENG, BULELENG, BALI",10,133,22,155
https://kawalpemilu.org#53903,"BANYUASRI, BULELENG, BULELENG, BALI",11,126,40,166
https://kawalpemilu.org#53903,"BANYUASRI, BULELENG, BULELENG, BALI",12,146,45,191
https://kawalpemilu.org#53903,"BANYUASRI, BULELENG, BULELENG, BALI",13,146,24,170
https://kawalpemilu.org#53903,"BANYUASRI, BULELENG, BULELENG, BALI",14,195,23,218
https://kawalpemilu.org#53903,"BANYUASRI, BULELENG, BULELENG, BALI",15,229,23,252
https://kawalpemilu.org#53903,"BANYUASRI, BULELENG, BULELENG, BALI",16,145,90,235
https://kawalpemilu.org#53903,"BANYUASRI, BULELENG, BULELENG, BALI",17,131,61,192
https://kawalpemilu.org#53903,"BANYUASRI, BULELENG, BULELENG, BALI",18,106,68,174
https://kawalpemilu.org#53903,"BANYUASRI, BULELENG, BULELENG, BALI",19,144,114,258
https://kawalpemilu.org#53903,"BANYUASRI, BULELENG, BULELENG, BALI",20,129,84,213
https://kawalpemilu.org#53903,"BANYUASRI, BULELENG, BULELENG, BALI",21,163,108,271
https://kawalpemilu.org#53904,"BANJAR TEGAL, BULELENG, BULELENG, BALI",1,213,27,240
https://kawalpemilu.org#53904,"BANJAR TEGAL, BULELENG, BULELENG, BALI",2,220,9,229
https://kawalpemilu.org#53904,"BANJAR TEGAL, BULELENG, BULELENG, BALI",3,235,8,243
https://kawalpemilu.org#53904,"BANJAR TEGAL, BULELENG, BULELENG, BALI",4,227,11,238
https://kawalpemilu.org#53904,"BANJAR TEGAL, BULELENG, BULELENG, BALI",5,248,28,276
https://kawalpemilu.org#53904,"BANJAR TEGAL, BULELENG, BULELENG, BALI",6,212,24,236
https://kawalpemilu.org#53904,"BANJAR TEGAL, BULELENG, BULELENG, BALI",7,200,16,216
https://kawalpemilu.org#53904,"BANJAR TEGAL, BULELENG, BULELENG, BALI",8,199,15,214
https://kawalpemilu.org#53904,"BANJAR TEGAL, BULELENG, BULELENG, BALI",9,228,11,239
https://kawalpemilu.org#53904,"BANJAR TEGAL, BULELENG, BULELENG, BALI",10,223,10,233
https://kawalpemilu.org#53905,"KENDRAN, BULELENG, BULELENG, BALI",1,190,21,211
https://kawalpemilu.org#53905,"KENDRAN, BULELENG, BULELENG, BALI",2,223,7,230
https://kawalpemilu.org#53905,"KENDRAN, BULELENG, BULELENG, BALI",3,187,20,207
https://kawalpemilu.org#53905,"KENDRAN, BULELENG, BULELENG, BALI",4,181,4,185
https://kawalpemilu.org#53905,"KENDRAN, BULELENG, BULELENG, BALI",5,175,5,180
https://kawalpemilu.org#53905,"KENDRAN, BULELENG, BULELENG, BALI",6,223,10,233
https://kawalpemilu.org#53905,"KENDRAN, BULELENG, BULELENG, BALI",7,167,2,169
https://kawalpemilu.org#53905,"KENDRAN, BULELENG, BULELENG, BALI",8,160,19,179
https://kawalpemilu.org#53906,"PAKET AGUNG, BULELENG, BULELENG, BALI",1,199,9,208
https://kawalpemilu.org#53906,"PAKET AGUNG, BULELENG, BULELENG, BALI",2,188,9,197
https://kawalpemilu.org#53906,"PAKET AGUNG, BULELENG, BULELENG, BALI",3,201,9,210
https://kawalpemilu.org#53906,"PAKET AGUNG, BULELENG, BULELENG, BALI",4,205,8,213
https://kawalpemilu.org#53906,"PAKET AGUNG, BULELENG, BULELENG, BALI",5,200,12,212
https://kawalpemilu.org#53906,"PAKET AGUNG, BULELENG, BULELENG, BALI",6,252,1,253
https://kawalpemilu.org#53906,"PAKET AGUNG, BULELENG, BULELENG, BALI",7,182,13,195
https://kawalpemilu.org#53906,"PAKET AGUNG, BULELENG, BULELENG, BALI",8,127,66,193
https://kawalpemilu.org#53907,"KAMPUNG SINGARAJA, BULELENG, BULELENG, BALI",1,83,102,185
https://kawalpemilu.org#53907,"KAMPUNG SINGARAJA, BULELENG, BULELENG, BALI",2,80,163,243
https://kawalpemilu.org#53907,"KAMPUNG SINGARAJA, BULELENG, BULELENG, BALI",3,54,174,228
https://kawalpemilu.org#53908,"LILIGUNDI, BULELENG, BULELENG, BALI",1,181,18,199
https://kawalpemilu.org#53908,"LILIGUNDI, BULELENG, BULELENG, BALI",2,162,6,160
https://kawalpemilu.org#53908,"LILIGUNDI, BULELENG, BULELENG, BALI",3,168,19,187
https://kawalpemilu.org#53908,"LILIGUNDI, BULELENG, BULELENG, BALI",4,168,8,176
https://kawalpemilu.org#53908,"LILIGUNDI, BULELENG, BULELENG, BALI",5,155,5,160
https://kawalpemilu.org#53908,"LILIGUNDI, BULELENG, BULELENG, BALI",6,155,11,166
https://kawalpemilu.org#53909,"BERATAN, BULELENG, BULELENG, BALI",1,172,6,178
https://kawalpemilu.org#53909,"BERATAN, BULELENG, BULELENG, BALI",2,181,3,184
https://kawalpemilu.org#53909,"BERATAN, BULELENG, BULELENG, BALI",3,185,4,189
https://kawalpemilu.org#53910,"BANYUNING, BULELENG, BULELENG, BALI",1,185,31,216
https://kawalpemilu.org#53910,"BANYUNING, BULELENG, BULELENG, BALI",2,210,15,225
https://kawalpemilu.org#53910,"BANYUNING, BULELENG, BULELENG, BALI",3,208,6,214
https://kawalpemilu.org#53910,"BANYUNING, BULELENG, BULELENG, BALI",4,163,15,178
https://kawalpemilu.org#53910,"BANYUNING, BULELENG, BULELENG, BALI",5,179,8,187
https://kawalpemilu.org#53910,"BANYUNING, BULELENG, BULELENG, BALI",6,166,10,176
https://kawalpemilu.org#53910,"BANYUNING, BULELENG, BULELENG, BALI",7,181,9,190
https://kawalpemilu.org#53910,"BANYUNING, BULELENG, BULELENG, BALI",8,212,8,220
https://kawalpemilu.org#53910,"BANYUNING, BULELENG, BULELENG, BALI",9,221,13,234
https://kawalpemilu.org#53910,"BANYUNING, BULELENG, BULELENG, BALI",10,153,17,170
https://kawalpemilu.org#53910,"BANYUNING, BULELENG, BULELENG, BALI",11,172,3,175
https://kawalpemilu.org#53910,"BANYUNING, BULELENG, BULELENG, BALI",12,185,5,190
https://kawalpemilu.org#53910,"BANYUNING, BULELENG, BULELENG, BALI",13,141,5,146
https://kawalpemilu.org#53910,"BANYUNING, BULELENG, BULELENG, BALI",14,171,5,176
https://kawalpemilu.org#53910,"BANYUNING, BULELENG, BULELENG, BALI",15,174,3,177
https://kawalpemilu.org#53910,"BANYUNING, BULELENG, BULELENG, BALI",16,167,6,173
https://kawalpemilu.org#53910,"BANYUNING, BULELENG, BULELENG, BALI",17,168,4,172
https://kawalpemilu.org#53910,"BANYUNING, BULELENG, BULELENG, BALI",18,151,11,162
https://kawalpemilu.org#53910,"BANYUNING, BULELENG, BULELENG, BALI",19,155,13,168
https://kawalpemilu.org#53910,"BANYUNING, BULELENG, BULELENG, BALI",20,188,4,192
https://kawalpemilu.org#53910,"BANYUNING, BULELENG, BULELENG, BALI",21,179,52,231
https://kawalpemilu.org#53910,"BANYUNING, BULELENG, BULELENG, BALI",22,145,40,185
https://kawalpemilu.org#53910,"BANYUNING, BULELENG, BULELENG, BALI",23,124,35,159
https://kawalpemilu.org#53910,"BANYUNING, BULELENG, BULELENG, BALI",24,164,18,182
https://kawalpemilu.org#53910,"BANYUNING, BULELENG, BULELENG, BALI",25,150,3,153
https://kawalpemilu.org#53910,"BANYUNING, BULELENG, BULELENG, BALI",26,162,9,171
https://kawalpemilu.org#53910,"BANYUNING, BULELENG, BULELENG, BALI",27,178,9,187
https://kawalpemilu.org#53910,"BANYUNING, BULELENG, BULELENG, BALI",28,186,10,196
https://kawalpemilu.org#53910,"BANYUNING, BULELENG, BULELENG, BALI",29,160,13,173
https://kawalpemilu.org#53910,"BANYUNING, BULELENG, BULELENG, BALI",30,161,12,173
https://kawalpemilu.org#53910,"BANYUNING, BULELENG, BULELENG, BALI",31,166,8,174
https://kawalpemilu.org#53910,"BANYUNING, BULELENG, BULELENG, BALI",32,148,11,159
https://kawalpemilu.org#53910,"BANYUNING, BULELENG, BULELENG, BALI",33,163,7,170
https://kawalpemilu.org#53910,"BANYUNING, BULELENG, BULELENG, BALI",34,174,4,178
https://kawalpemilu.org#53910,"BANYUNING, BULELENG, BULELENG, BALI",35,163,11,174
https://kawalpemilu.org#53910,"BANYUNING, BULELENG, BULELENG, BALI",36,149,2,151
https://kawalpemilu.org#53910,"BANYUNING, BULELENG, BULELENG, BALI",37,147,4,151
https://kawalpemilu.org#53910,"BANYUNING, BULELENG, BULELENG, BALI",38,177,4,181
https://kawalpemilu.org#53910,"BANYUNING, BULELENG, BULELENG, BALI",39,195,4,199
https://kawalpemilu.org#53910,"BANYUNING, BULELENG, BULELENG, BALI",40,187,7,194
https://kawalpemilu.org#53910,"BANYUNING, BULELENG, BULELENG, BALI",41,161,6,167
https://kawalpemilu.org#53910,"BANYUNING, BULELENG, BULELENG, BALI",42,156,23,179
https://kawalpemilu.org#53910,"BANYUNING, BULELENG, BULELENG, BALI",43,140,17,157
https://kawalpemilu.org#53910,"BANYUNING, BULELENG, BULELENG, BALI",44,124,8,132
https://kawalpemilu.org#53910,"BANYUNING, BULELENG, BULELENG, BALI",45,142,10,152
https://kawalpemilu.org#53910,"BANYUNING, BULELENG, BULELENG, BALI",46,159,6,165
https://kawalpemilu.org#53910,"BANYUNING, BULELENG, BULELENG, BALI",47,151,22,173
https://kawalpemilu.org#53910,"BANYUNING, BULELENG, BULELENG, BALI",48,156,0,156
https://kawalpemilu.org#53910,"BANYUNING, BULELENG, BULELENG, BALI",49,154,22,176
https://kawalpemilu.org#53910,"BANYUNING, BULELENG, BULELENG, BALI",50,139,9,148
https://kawalpemilu.org#53910,"BANYUNING, BULELENG, BULELENG, BALI",51,45,100,145
https://kawalpemilu.org#53911,"PENARUKAN, BULELENG, BULELENG, BALI",1,160,10,170
https://kawalpemilu.org#53911,"PENARUKAN, BULELENG, BULELENG, BALI",2,146,10,156
https://kawalpemilu.org#53911,"PENARUKAN, BULELENG, BULELENG, BALI",3,127,10,137
https://kawalpemilu.org#53911,"PENARUKAN, BULELENG, BULELENG, BALI",4,161,6,167
https://kawalpemilu.org#53911,"PENARUKAN, BULELENG, BULELENG, BALI",5,154,18,172
https://kawalpemilu.org#53911,"PENARUKAN, BULELENG, BULELENG, BALI",6,141,11,152
https://kawalpemilu.org#53911,"PENARUKAN, BULELENG, BULELENG, BALI",7,152,9,161
https://kawalpemilu.org#53911,"PENARUKAN, BULELENG, BULELENG, BALI",8,175,8,183
https://kawalpemilu.org#53911,"PENARUKAN, BULELENG, BULELENG, BALI",9,165,4,169
https://kawalpemilu.org#53911,"PENARUKAN, BULELENG, BULELENG, BALI",10,129,16,145
https://kawalpemilu.org#53911,"PENARUKAN, BULELENG, BULELENG, BALI",12,144,12,156
https://kawalpemilu.org#53911,"PENARUKAN, BULELENG, BULELENG, BALI",13,146,6,152
https://kawalpemilu.org#53911,"PENARUKAN, BULELENG, BULELENG, BALI",14,161,12,173
https://kawalpemilu.org#53911,"PENARUKAN, BULELENG, BULELENG, BALI",15,161,6,167
https://kawalpemilu.org#53911,"PENARUKAN, BULELENG, BULELENG, BALI",16,135,5,140
https://kawalpemilu.org#53911,"PENARUKAN, BULELENG, BULELENG, BALI",17,159,5,164
https://kawalpemilu.org#53911,"PENARUKAN, BULELENG, BULELENG, BALI",18,156,9,165
https://kawalpemilu.org#53911,"PENARUKAN, BULELENG, BULELENG, BALI",20,113,5,118
https://kawalpemilu.org#53911,"PENARUKAN, BULELENG, BULELENG, BALI",22,163,15,178
https://kawalpemilu.org#53911,"PENARUKAN, BULELENG, BULELENG, BALI",23,142,18,160
https://kawalpemilu.org#53911,"PENARUKAN, BULELENG, BULELENG, BALI",24,163,10,173
https://kawalpemilu.org#53911,"PENARUKAN, BULELENG, BULELENG, BALI",25,160,8,168
https://kawalpemilu.org#53911,"PENARUKAN, BULELENG, BULELENG, BALI",26,173,17,190
https://kawalpemilu.org#53911,"PENARUKAN, BULELENG, BULELENG, BALI",27,165,10,175
https://kawalpemilu.org#53911,"PENARUKAN, BULELENG, BULELENG, BALI",28,142,21,163
https://kawalpemilu.org#53911,"PENARUKAN, BULELENG, BULELENG, BALI",29,163,3,166
https://kawalpemilu.org#53911,"PENARUKAN, BULELENG, BULELENG, BALI",30,46,109,155
https://kawalpemilu.org#53911,"PENARUKAN, BULELENG, BULELENG, BALI",31,65,116,181
https://kawalpemilu.org#53911,"PENARUKAN, BULELENG, BULELENG, BALI",32,142,35,177
https://kawalpemilu.org#53911,"PENARUKAN, BULELENG, BULELENG, BALI",33,130,57,187
https://kawalpemilu.org#53911,"PENARUKAN, BULELENG, BULELENG, BALI",34,154,15,169
https://kawalpemilu.org#53911,"PENARUKAN, BULELENG, BULELENG, BALI",35,144,7,151
https://kawalpemilu.org#53911,"PENARUKAN, BULELENG, BULELENG, BALI",36,138,8,146
https://kawalpemilu.org#53911,"PENARUKAN, BULELENG, BULELENG, BALI",37,136,9,145
https://kawalpemilu.org#53911,"PENARUKAN, BULELENG, BULELENG, BALI",38,136,14,150
https://kawalpemilu.org#53911,"PENARUKAN, BULELENG, BULELENG, BALI",39,179,12,191
https://kawalpemilu.org#53912,"KAMPUNG KAJANAN, BULELENG, BULELENG, BALI",1,111,105,216
https://kawalpemilu.org#53912,"KAMPUNG KAJANAN, BULELENG, BULELENG, BALI",2,97,105,202
https://kawalpemilu.org#53912,"KAMPUNG KAJANAN, BULELENG, BULELENG, BALI",3,73,105,178
https://kawalpemilu.org#53912,"KAMPUNG KAJANAN, BULELENG, BULELENG, BALI",4,67,149,216
https://kawalpemilu.org#53912,"KAMPUNG KAJANAN, BULELENG, BULELENG, BALI",5,68,136,204
https://kawalpemilu.org#53912,"KAMPUNG KAJANAN, BULELENG, BULELENG, BALI",6,86,161,247
https://kawalpemilu.org#53912,"KAMPUNG KAJANAN, BULELENG, BULELENG, BALI",7,55,170,225
https://kawalpemilu.org#53912,"KAMPUNG KAJANAN, BULELENG, BULELENG, BALI",8,64,109,173
https://kawalpemilu.org#53912,"KAMPUNG KAJANAN, BULELENG, BULELENG, BALI",9,50,178,228
https://kawalpemilu.org#53912,"KAMPUNG KAJANAN, BULELENG, BULELENG, BALI",10,95,122,217
https://kawalpemilu.org#53912,"KAMPUNG KAJANAN, BULELENG, BULELENG, BALI",11,104,103,207
https://kawalpemilu.org#53912,"KAMPUNG KAJANAN, BULELENG, BULELENG, BALI",12,103,70,173
https://kawalpemilu.org#53912,"KAMPUNG KAJANAN, BULELENG, BULELENG, BALI",13,93,103,196
https://kawalpemilu.org#53913,"ASTINA, BULELENG, BULELENG, BALI",1,212,15,227
https://kawalpemilu.org#53913,"ASTINA, BULELENG, BULELENG, BALI",2,169,20,189
https://kawalpemilu.org#53913,"ASTINA, BULELENG, BULELENG, BALI",3,191,13,204
https://kawalpemilu.org#53913,"ASTINA, BULELENG, BULELENG, BALI",4,231,11,242
https://kawalpemilu.org#53913,"ASTINA, BULELENG, BULELENG, BALI",5,201,8,209
https://kawalpemilu.org#53913,"ASTINA, BULELENG, BULELENG, BALI",6,190,33,223
https://kawalpemilu.org#53914,"BANJAR JAWA, BULELENG, BULELENG, BALI",1,241,9,250
https://kawalpemilu.org#53914,"BANJAR JAWA, BULELENG, BULELENG, BALI",2,203,13,216
https://kawalpemilu.org#53914,"BANJAR JAWA, BULELENG, BULELENG, BALI",3,251,17,268
https://kawalpemilu.org#53914,"BANJAR JAWA, BULELENG, BULELENG, BALI",4,206,5,211
https://kawalpemilu.org#53914,"BANJAR JAWA, BULELENG, BULELENG, BALI",5,219,13,232
https://kawalpemilu.org#53914,"BANJAR JAWA, BULELENG, BULELENG, BALI",6,186,23,209
https://kawalpemilu.org#53914,"BANJAR JAWA, BULELENG, BULELENG, BALI",7,215,23,238
https://kawalpemilu.org#53914,"BANJAR JAWA, BULELENG, BULELENG, BALI",8,217,24,241
https://kawalpemilu.org#53914,"BANJAR JAWA, BULELENG, BULELENG, BALI",9,219,9,228
https://kawalpemilu.org#53914,"BANJAR JAWA, BULELENG, BULELENG, BALI",10,174,12,186
https://kawalpemilu.org#53914,"BANJAR JAWA, BULELENG, BULELENG, BALI",11,197,9,206
https://kawalpemilu.org#53915,"KALIUNTU, BULELENG, BULELENG, BALI",1,234,21,255
https://kawalpemilu.org#53915,"KALIUNTU, BULELENG, BULELENG, BALI",2,192,25,217
https://kawalpemilu.org#53915,"KALIUNTU, BULELENG, BULELENG, BALI",3,182,7,189
https://kawalpemilu.org#53915,"KALIUNTU, BULELENG, BULELENG, BALI",4,175,6,181
https://kawalpemilu.org#53915,"KALIUNTU, BULELENG, BULELENG, BALI",5,158,23,181
https://kawalpemilu.org#53915,"KALIUNTU, BULELENG, BULELENG, BALI",6,171,9,180
https://kawalpemilu.org#53915,"KALIUNTU, BULELENG, BULELENG, BALI",7,144,4,148
https://kawalpemilu.org#53915,"KALIUNTU, BULELENG, BULELENG, BALI",8,157,9,166
https://kawalpemilu.org#53915,"KALIUNTU, BULELENG, BULELENG, BALI",9,172,19,191
https://kawalpemilu.org#53915,"KALIUNTU, BULELENG, BULELENG, BALI",10,209,10,219
https://kawalpemilu.org#53915,"KALIUNTU, BULELENG, BULELENG, BALI",11,193,13,206
https://kawalpemilu.org#53915,"KALIUNTU, BULELENG, BULELENG, BALI",12,193,38,231
https://kawalpemilu.org#53915,"KALIUNTU, BULELENG, BULELENG, BALI",13,216,29,245
https://kawalpemilu.org#53916,"KAMPUNG  ANYAR, BULELENG, BULELENG, BALI",1,197,21,218
https://kawalpemilu.org#53916,"KAMPUNG  ANYAR, BULELENG, BULELENG, BALI",2,202,1,203
https://kawalpemilu.org#53916,"KAMPUNG  ANYAR, BULELENG, BULELENG, BALI",3,203,3,206
https://kawalpemilu.org#53916,"KAMPUNG  ANYAR, BULELENG, BULELENG, BALI",4,225,16,241
https://kawalpemilu.org#53916,"KAMPUNG  ANYAR, BULELENG, BULELENG, BALI",5,217,3,220
https://kawalpemilu.org#53916,"KAMPUNG  ANYAR, BULELENG, BULELENG, BALI",6,221,4,225
https://kawalpemilu.org#53916,"KAMPUNG  ANYAR, BULELENG, BULELENG, BALI",7,210,8,218
https://kawalpemilu.org#53916,"KAMPUNG  ANYAR, BULELENG, BULELENG, BALI",8,212,13,225
https://kawalpemilu.org#53916,"KAMPUNG  ANYAR, BULELENG, BULELENG, BALI",9,170,28,198
https://kawalpemilu.org#53916,"KAMPUNG  ANYAR, BULELENG, BULELENG, BALI",10,123,49,172
https://kawalpemilu.org#53916,"KAMPUNG  ANYAR, BULELENG, BULELENG, BALI",11,179,28,207
https://kawalpemilu.org#53916,"KAMPUNG  ANYAR, BULELENG, BULELENG, BALI",12,183,24,207
https://kawalpemilu.org#53916,"KAMPUNG  ANYAR, BULELENG, BULELENG, BALI",13,176,26,202
https://kawalpemilu.org#53916,"KAMPUNG  ANYAR, BULELENG, BULELENG, BALI",14,161,46,207
https://kawalpemilu.org#53916,"KAMPUNG  ANYAR, BULELENG, BULELENG, BALI",15,187,32,219
https://kawalpemilu.org#53916,"KAMPUNG  ANYAR, BULELENG, BULELENG, BALI",16,116,84,200
https://kawalpemilu.org#53916,"KAMPUNG  ANYAR, BULELENG, BULELENG, BALI",17,137,53,190
https://kawalpemilu.org#53917,"KAMPUNG BUGIS, BULELENG, BULELENG, BALI",1,157,55,212
https://kawalpemilu.org#53917,"KAMPUNG BUGIS, BULELENG, BULELENG, BALI",2,61,165,226
https://kawalpemilu.org#53917,"KAMPUNG BUGIS, BULELENG, BULELENG, BALI",3,35,208,243
https://kawalpemilu.org#53917,"KAMPUNG BUGIS, BULELENG, BULELENG, BALI",4,57,173,230
https://kawalpemilu.org#53917,"KAMPUNG BUGIS, BULELENG, BULELENG, BALI",5,66,155,221
https://kawalpemilu.org#53917,"KAMPUNG BUGIS, BULELENG, BULELENG, BALI",6,99,127,226
https://kawalpemilu.org#53917,"KAMPUNG BUGIS, BULELENG, BULELENG, BALI",7,53,158,211
https://kawalpemilu.org#53917,"KAMPUNG BUGIS, BULELENG, BULELENG, BALI",8,51,181,232
https://kawalpemilu.org#53917,"KAMPUNG BUGIS, BULELENG, BULELENG, BALI",9,77,116,193
https://kawalpemilu.org#53918,"BANJAR BALI, BULELENG, BULELENG, BALI",1,280,0,280
https://kawalpemilu.org#53918,"BANJAR BALI, BULELENG, BULELENG, BALI",2,268,2,270
https://kawalpemilu.org#53918,"BANJAR BALI, BULELENG, BULELENG, BALI",3,260,0,260
https://kawalpemilu.org#53918,"BANJAR BALI, BULELENG, BULELENG, BALI",4,258,4,262
https://kawalpemilu.org#53918,"BANJAR BALI, BULELENG, BULELENG, BALI",5,223,19,242
https://kawalpemilu.org#53918,"BANJAR BALI, BULELENG, BULELENG, BALI",6,230,20,250
https://kawalpemilu.org#53919,"KAMPUNG BARU, BULELENG, BULELENG, BALI",1,170,27,197
https://kawalpemilu.org#53919,"KAMPUNG BARU, BULELENG, BULELENG, BALI",2,166,26,192
https://kawalpemilu.org#53919,"KAMPUNG BARU, BULELENG, BULELENG, BALI",3,168,34,202
https://kawalpemilu.org#53919,"KAMPUNG BARU, BULELENG, BULELENG, BALI",4,141,35,176
https://kawalpemilu.org#53919,"KAMPUNG BARU, BULELENG, BULELENG, BALI",5,142,41,183
https://kawalpemilu.org#53919,"KAMPUNG BARU, BULELENG, BULELENG, BALI",7,76,52,128
https://kawalpemilu.org#53919,"KAMPUNG BARU, BULELENG, BULELENG, BALI",8,87,64,151
https://kawalpemilu.org#53919,"KAMPUNG BARU, BULELENG, BULELENG, BALI",9,113,51,164
https://kawalpemilu.org#53919,"KAMPUNG BARU, BULELENG, BULELENG, BALI",10,159,3,162
https://kawalpemilu.org#53919,"KAMPUNG BARU, BULELENG, BULELENG, BALI",11,167,1,168
https://kawalpemilu.org#53919,"KAMPUNG BARU, BULELENG, BULELENG, BALI",12,186,2,188
https://kawalpemilu.org#53919,"KAMPUNG BARU, BULELENG, BULELENG, BALI",13,169,5,174
https://kawalpemilu.org#53919,"KAMPUNG BARU, BULELENG, BULELENG, BALI",14,195,2,197
https://kawalpemilu.org#53919,"KAMPUNG BARU, BULELENG, BULELENG, BALI",15,188,4,192
https://kawalpemilu.org#53919,"KAMPUNG BARU, BULELENG, BULELENG, BALI",16,203,5,208
https://kawalpemilu.org#53919,"KAMPUNG BARU, BULELENG, BULELENG, BALI",17,171,7,178
https://kawalpemilu.org#53919,"KAMPUNG BARU, BULELENG, BULELENG, BALI",18,169,10,179
https://kawalpemilu.org#53919,"KAMPUNG BARU, BULELENG, BULELENG, BALI",19,171,4,175
https://kawalpemilu.org#53919,"KAMPUNG BARU, BULELENG, BULELENG, BALI",20,158,3,161
https://kawalpemilu.org#53919,"KAMPUNG BARU, BULELENG, BULELENG, BALI",21,171,4,175
https://kawalpemilu.org#53919,"KAMPUNG BARU, BULELENG, BULELENG, BALI",22,171,10,181
https://kawalpemilu.org#53919,"KAMPUNG BARU, BULELENG, BULELENG, BALI",23,158,8,166
https://kawalpemilu.org#53919,"KAMPUNG BARU, BULELENG, BULELENG, BALI",24,161,21,182
https://kawalpemilu.org#53919,"KAMPUNG BARU, BULELENG, BULELENG, BALI",25,175,11,186
https://kawalpemilu.org#53919,"KAMPUNG BARU, BULELENG, BULELENG, BALI",26,161,14,175
https://kawalpemilu.org#53920,"KALIBUKBUK, BULELENG, BULELENG, BALI",1,225,8,233
https://kawalpemilu.org#53920,"KALIBUKBUK, BULELENG, BULELENG, BALI",2,226,7,233
https://kawalpemilu.org#53920,"KALIBUKBUK, BULELENG, BULELENG, BALI",3,237,7,244
https://kawalpemilu.org#53920,"KALIBUKBUK, BULELENG, BULELENG, BALI",4,219,11,230
https://kawalpemilu.org#53920,"KALIBUKBUK, BULELENG, BULELENG, BALI",5,204,5,209
https://kawalpemilu.org#53920,"KALIBUKBUK, BULELENG, BULELENG, BALI",6,203,9,212
https://kawalpemilu.org#53920,"KALIBUKBUK, BULELENG, BULELENG, BALI",7,193,5,198
https://kawalpemilu.org#53920,"KALIBUKBUK, BULELENG, BULELENG, BALI",8,235,10,245
https://kawalpemilu.org#53920,"KALIBUKBUK, BULELENG, BULELENG, BALI",9,221,9,230
https://kawalpemilu.org#53920,"KALIBUKBUK, BULELENG, BULELENG, BALI",10,224,18,242
https://kawalpemilu.org#53920,"KALIBUKBUK, BULELENG, BULELENG, BALI",11,240,9,249
https://kawalpemilu.org#53920,"KALIBUKBUK, BULELENG, BULELENG, BALI",12,227,12,239
https://kawalpemilu.org#53920,"KALIBUKBUK, BULELENG, BULELENG, BALI",13,227,5,232
https://kawalpemilu.org#53920,"KALIBUKBUK, BULELENG, BULELENG, BALI",15,202,14,216
https://kawalpemilu.org#53920,"KALIBUKBUK, BULELENG, BULELENG, BALI",16,192,14,206
https://kawalpemilu.org#53920,"KALIBUKBUK, BULELENG, BULELENG, BALI",17,190,21,211
https://kawalpemilu.org#53921,"ANTURAN, BULELENG, BULELENG, BALI",1,124,14,138
https://kawalpemilu.org#53921,"ANTURAN, BULELENG, BULELENG, BALI",2,125,9,134
https://kawalpemilu.org#53921,"ANTURAN, BULELENG, BULELENG, BALI",3,119,3,122
https://kawalpemilu.org#53921,"ANTURAN, BULELENG, BULELENG, BALI",4,160,11,171
https://kawalpemilu.org#53921,"ANTURAN, BULELENG, BULELENG, BALI",5,145,11,156
https://kawalpemilu.org#53921,"ANTURAN, BULELENG, BULELENG, BALI",7,183,9,192
https://kawalpemilu.org#53921,"ANTURAN, BULELENG, BULELENG, BALI",8,160,22,182
https://kawalpemilu.org#53921,"ANTURAN, BULELENG, BULELENG, BALI",9,162,17,179
https://kawalpemilu.org#53921,"ANTURAN, BULELENG, BULELENG, BALI",10,142,18,160
https://kawalpemilu.org#53921,"ANTURAN, BULELENG, BULELENG, BALI",11,135,20,155
https://kawalpemilu.org#53921,"ANTURAN, BULELENG, BULELENG, BALI",12,101,14,115
https://kawalpemilu.org#53921,"ANTURAN, BULELENG, BULELENG, BALI",13,118,20,138
https://kawalpemilu.org#53921,"ANTURAN, BULELENG, BULELENG, BALI",14,126,15,141
https://kawalpemilu.org#53921,"ANTURAN, BULELENG, BULELENG, BALI",15,116,30,146
https://kawalpemilu.org#53921,"ANTURAN, BULELENG, BULELENG, BALI",16,158,25,183
https://kawalpemilu.org#53921,"ANTURAN, BULELENG, BULELENG, BALI",17,146,31,177
https://kawalpemilu.org#53921,"ANTURAN, BULELENG, BULELENG, BALI",18,133,40,173
https://kawalpemilu.org#53921,"ANTURAN, BULELENG, BULELENG, BALI",19,146,25,171
https://kawalpemilu.org#53921,"ANTURAN, BULELENG, BULELENG, BALI",21,164,29,193
https://kawalpemilu.org#53922,"TUKAD MUNGGA, BULELENG, BULELENG, BALI",1,200,16,216
https://kawalpemilu.org#53922,"TUKAD MUNGGA, BULELENG, BULELENG, BALI",2,173,23,196
https://kawalpemilu.org#53922,"TUKAD MUNGGA, BULELENG, BULELENG, BALI",3,154,29,183
https://kawalpemilu.org#53922,"TUKAD MUNGGA, BULELENG, BULELENG, BALI",4,191,8,199
https://kawalpemilu.org#53922,"TUKAD MUNGGA, BULELENG, BULELENG, BALI",5,211,11,222
https://kawalpemilu.org#53922,"TUKAD MUNGGA, BULELENG, BULELENG, BALI",6,188,18,206
https://kawalpemilu.org#53922,"TUKAD MUNGGA, BULELENG, BULELENG, BALI",7,156,14,170
https://kawalpemilu.org#53922,"TUKAD MUNGGA, BULELENG, BULELENG, BALI",8,145,6,151
https://kawalpemilu.org#53922,"TUKAD MUNGGA, BULELENG, BULELENG, BALI",9,123,16,139
https://kawalpemilu.org#53922,"TUKAD MUNGGA, BULELENG, BULELENG, BALI",10,210,3,213
https://kawalpemilu.org#53922,"TUKAD MUNGGA, BULELENG, BULELENG, BALI",11,187,5,192
https://kawalpemilu.org#53922,"TUKAD MUNGGA, BULELENG, BULELENG, BALI",12,173,9,182
https://kawalpemilu.org#53922,"TUKAD MUNGGA, BULELENG, BULELENG, BALI",13,206,11,217
https://kawalpemilu.org#53922,"TUKAD MUNGGA, BULELENG, BULELENG, BALI",14,147,18,165
https://kawalpemilu.org#53923,"PEMARON, BULELENG, BULELENG, BALI",1,182,21,203
https://kawalpemilu.org#53923,"PEMARON, BULELENG, BULELENG, BALI",2,180,22,202
https://kawalpemilu.org#53923,"PEMARON, BULELENG, BULELENG, BALI",3,201,8,209
https://kawalpemilu.org#53923,"PEMARON, BULELENG, BULELENG, BALI",4,210,7,217
https://kawalpemilu.org#53923,"PEMARON, BULELENG, BULELENG, BALI",5,192,9,201
https://kawalpemilu.org#53923,"PEMARON, BULELENG, BULELENG, BALI",6,183,13,196
https://kawalpemilu.org#53923,"PEMARON, BULELENG, BULELENG, BALI",7,161,23,184
https://kawalpemilu.org#53923,"PEMARON, BULELENG, BULELENG, BALI",8,174,16,190
https://kawalpemilu.org#53923,"PEMARON, BULELENG, BULELENG, BALI",9,194,14,208
https://kawalpemilu.org#53923,"PEMARON, BULELENG, BULELENG, BALI",10,193,28,221
https://kawalpemilu.org#53923,"PEMARON, BULELENG, BULELENG, BALI",11,195,7,202
https://kawalpemilu.org#53923,"PEMARON, BULELENG, BULELENG, BALI",12,207,16,223
https://kawalpemilu.org#53923,"PEMARON, BULELENG, BULELENG, BALI",13,167,36,203
https://kawalpemilu.org#53923,"PEMARON, BULELENG, BULELENG, BALI",14,179,25,204
https://kawalpemilu.org#53924,"BAKTI SERAGA, BULELENG, BULELENG, BALI",1,188,11,199
https://kawalpemilu.org#53924,"BAKTI SERAGA, BULELENG, BULELENG, BALI",2,178,18,196
https://kawalpemilu.org#53924,"BAKTI SERAGA, BULELENG, BULELENG, BALI",3,175,17,192
https://kawalpemilu.org#53924,"BAKTI SERAGA, BULELENG, BULELENG, BALI",4,180,12,192
https://kawalpemilu.org#53924,"BAKTI SERAGA, BULELENG, BULELENG, BALI",5,165,10,175
https://kawalpemilu.org#53924,"BAKTI SERAGA, BULELENG, BULELENG, BALI",6,197,13,210
https://kawalpemilu.org#53924,"BAKTI SERAGA, BULELENG, BULELENG, BALI",7,164,21,185
https://kawalpemilu.org#53924,"BAKTI SERAGA, BULELENG, BULELENG, BALI",8,213,14,227
https://kawalpemilu.org#53924,"BAKTI SERAGA, BULELENG, BULELENG, BALI",9,198,12,210
https://kawalpemilu.org#53924,"BAKTI SERAGA, BULELENG, BULELENG, BALI",10,158,35,193
https://kawalpemilu.org#53924,"BAKTI SERAGA, BULELENG, BULELENG, BALI",11,186,17,203
https://kawalpemilu.org#53924,"BAKTI SERAGA, BULELENG, BULELENG, BALI",12,154,20,174
https://kawalpemilu.org#53924,"BAKTI SERAGA, BULELENG, BULELENG, BALI",13,147,15,162
https://kawalpemilu.org#53924,"BAKTI SERAGA, BULELENG, BULELENG, BALI",14,191,14,205
https://kawalpemilu.org#53924,"BAKTI SERAGA, BULELENG, BULELENG, BALI",15,178,6,184
https://kawalpemilu.org#53924,"BAKTI SERAGA, BULELENG, BULELENG, BALI",16,156,20,176
https://kawalpemilu.org#53924,"BAKTI SERAGA, BULELENG, BULELENG, BALI",17,165,32,197
https://kawalpemilu.org#53924,"BAKTI SERAGA, BULELENG, BULELENG, BALI",18,182,21,203
https://kawalpemilu.org#53925,"SARIMEKAR, BULELENG, BULELENG, BALI",1,197,11,208
https://kawalpemilu.org#53925,"SARIMEKAR, BULELENG, BULELENG, BALI",2,214,9,223
https://kawalpemilu.org#53925,"SARIMEKAR, BULELENG, BULELENG, BALI",3,197,8,205
https://kawalpemilu.org#53925,"SARIMEKAR, BULELENG, BULELENG, BALI",4,220,16,236
https://kawalpemilu.org#53925,"SARIMEKAR, BULELENG, BULELENG, BALI",5,206,9,215
https://kawalpemilu.org#53925,"SARIMEKAR, BULELENG, BULELENG, BALI",6,199,11,210
https://kawalpemilu.org#53925,"SARIMEKAR, BULELENG, BULELENG, BALI",7,202,9,211
https://kawalpemilu.org#53925,"SARIMEKAR, BULELENG, BULELENG, BALI",8,193,20,213
https://kawalpemilu.org#53925,"SARIMEKAR, BULELENG, BULELENG, BALI",9,171,11,182
https://kawalpemilu.org#53925,"SARIMEKAR, BULELENG, BULELENG, BALI",10,184,16,200
https://kawalpemilu.org#53925,"SARIMEKAR, BULELENG, BULELENG, BALI",11,166,19,185
https://kawalpemilu.org#53926,"NAGA SEPAHA, BULELENG, BULELENG, BALI",1,225,22,247
https://kawalpemilu.org#53926,"NAGA SEPAHA, BULELENG, BULELENG, BALI",2,228,20,248
https://kawalpemilu.org#53926,"NAGA SEPAHA, BULELENG, BULELENG, BALI",3,217,32,249
https://kawalpemilu.org#53926,"NAGA SEPAHA, BULELENG, BULELENG, BALI",4,214,27,241
https://kawalpemilu.org#53926,"NAGA SEPAHA, BULELENG, BULELENG, BALI",5,176,25,201
https://kawalpemilu.org#53927,"PETANDAKAN, BULELENG, BULELENG, BALI",1,209,3,212
https://kawalpemilu.org#53927,"PETANDAKAN, BULELENG, BULELENG, BALI",2,203,7,210
https://kawalpemilu.org#53927,"PETANDAKAN, BULELENG, BULELENG, BALI",3,222,4,226
https://kawalpemilu.org#53927,"PETANDAKAN, BULELENG, BULELENG, BALI",5,195,11,206
https://kawalpemilu.org#53927,"PETANDAKAN, BULELENG, BULELENG, BALI",6,204,4,208
https://kawalpemilu.org#53927,"PETANDAKAN, BULELENG, BULELENG, BALI",7,195,3,198
https://kawalpemilu.org#53928,"ALASANGKER, BULELENG, BULELENG, BALI",1,214,18,232
https://kawalpemilu.org#53928,"ALASANGKER, BULELENG, BULELENG, BALI",2,233,4,237
https://kawalpemilu.org#53928,"ALASANGKER, BULELENG, BULELENG, BALI",3,208,3,211
https://kawalpemilu.org#53928,"ALASANGKER, BULELENG, BULELENG, BALI",4,174,16,190
https://kawalpemilu.org#53928,"ALASANGKER, BULELENG, BULELENG, BALI",5,201,18,219
https://kawalpemilu.org#53928,"ALASANGKER, BULELENG, BULELENG, BALI",6,172,27,199
https://kawalpemilu.org#53928,"ALASANGKER, BULELENG, BULELENG, BALI",7,205,21,226
https://kawalpemilu.org#53928,"ALASANGKER, BULELENG, BULELENG, BALI",8,233,4,237
https://kawalpemilu.org#53928,"ALASANGKER, BULELENG, BULELENG, BALI",9,203,32,235
https://kawalpemilu.org#53928,"ALASANGKER, BULELENG, BULELENG, BALI",10,225,20,245
https://kawalpemilu.org#53928,"ALASANGKER, BULELENG, BULELENG, BALI",11,220,10,230
https://kawalpemilu.org#53928,"ALASANGKER, BULELENG, BULELENG, BALI",12,197,7,204
https://kawalpemilu.org#53928,"ALASANGKER, BULELENG, BULELENG, BALI",13,177,13,190
https://kawalpemilu.org#53928,"ALASANGKER, BULELENG, BULELENG, BALI",14,197,6,203
https://kawalpemilu.org#53928,"ALASANGKER, BULELENG, BULELENG, BALI",15,173,9,182
https://kawalpemilu.org#53928,"ALASANGKER, BULELENG, BULELENG, BALI",16,223,7,230
https://kawalpemilu.org#53929,"POH BERGONG, BULELENG, BULELENG, BALI",1,170,12,182
https://kawalpemilu.org#53929,"POH BERGONG, BULELENG, BULELENG, BALI",2,198,15,213
https://kawalpemilu.org#53929,"POH BERGONG, BULELENG, BULELENG, BALI",3,162,11,173
https://kawalpemilu.org#53929,"POH BERGONG, BULELENG, BULELENG, BALI",4,166,26,192
https://kawalpemilu.org#53929,"POH BERGONG, BULELENG, BULELENG, BALI",5,179,13,192
https://kawalpemilu.org#53929,"POH BERGONG, BULELENG, BULELENG, BALI",6,176,10,186
https://kawalpemilu.org#53929,"POH BERGONG, BULELENG, BULELENG, BALI",7,179,20,199
https://kawalpemilu.org#53929,"POH BERGONG, BULELENG, BULELENG, BALI",8,189,11,200
https://kawalpemilu.org#53929,"POH BERGONG, BULELENG, BULELENG, BALI",9,184,16,200
https://kawalpemilu.org#53930,"JINENG DALEM, BULELENG, BULELENG, BALI",1,199,5,204
https://kawalpemilu.org#53930,"JINENG DALEM, BULELENG, BULELENG, BALI",2,170,6,176
https://kawalpemilu.org#53930,"JINENG DALEM, BULELENG, BULELENG, BALI",3,180,5,185
https://kawalpemilu.org#53930,"JINENG DALEM, BULELENG, BULELENG, BALI",4,176,8,184
https://kawalpemilu.org#53930,"JINENG DALEM, BULELENG, BULELENG, BALI",5,167,9,176
https://kawalpemilu.org#53930,"JINENG DALEM, BULELENG, BULELENG, BALI",6,193,15,208
https://kawalpemilu.org#53930,"JINENG DALEM, BULELENG, BULELENG, BALI",7,169,13,182
https://kawalpemilu.org#53930,"JINENG DALEM, BULELENG, BULELENG, BALI",8,185,3,188
https://kawalpemilu.org#53930,"JINENG DALEM, BULELENG, BULELENG, BALI",9,153,6,159
https://kawalpemilu.org#53930,"JINENG DALEM, BULELENG, BULELENG, BALI",10,148,8,156
https://kawalpemilu.org#53930,"JINENG DALEM, BULELENG, BULELENG, BALI",11,141,3,144
https://kawalpemilu.org#53930,"JINENG DALEM, BULELENG, BULELENG, BALI",12,171,4,175
https://kawalpemilu.org#53930,"JINENG DALEM, BULELENG, BULELENG, BALI",13,218,14,232
https://kawalpemilu.org#53930,"JINENG DALEM, BULELENG, BULELENG, BALI",14,193,4,197
https://kawalpemilu.org#53930,"JINENG DALEM, BULELENG, BULELENG, BALI",15,211,11,222
https://kawalpemilu.org#53930,"JINENG DALEM, BULELENG, BULELENG, BALI",16,0,0,0
https://kawalpemilu.org#53930,"JINENG DALEM, BULELENG, BULELENG, BALI",17,195,8,203
https://kawalpemilu.org#53931,"PENGELATAN, BULELENG, BULELENG, BALI",1,211,2,213
https://kawalpemilu.org#53931,"PENGELATAN, BULELENG, BULELENG, BALI",2,229,5,234
https://kawalpemilu.org#53931,"PENGELATAN, BULELENG, BULELENG, BALI",3,195,10,205
https://kawalpemilu.org#53931,"PENGELATAN, BULELENG, BULELENG, BALI",4,218,17,235
https://kawalpemilu.org#53931,"PENGELATAN, BULELENG, BULELENG, BALI",5,196,39,235
https://kawalpemilu.org#53931,"PENGELATAN, BULELENG, BULELENG, BALI",6,219,20,239
https://kawalpemilu.org#53931,"PENGELATAN, BULELENG, BULELENG, BALI",7,208,21,229
https://kawalpemilu.org#53931,"PENGELATAN, BULELENG, BULELENG, BALI",8,217,12,229
https://kawalpemilu.org#53931,"PENGELATAN, BULELENG, BULELENG, BALI",10,231,18,249
https://kawalpemilu.org#53931,"PENGELATAN, BULELENG, BULELENG, BALI",11,207,5,212
https://kawalpemilu.org#53931,"PENGELATAN, BULELENG, BULELENG, BALI",12,231,11,242
https://kawalpemilu.org#53933,"LEMUKIH, SAWAN, BULELENG, BALI",1,206,12,218
https://kawalpemilu.org#53933,"LEMUKIH, SAWAN, BULELENG, BALI",2,229,7,236
https://kawalpemilu.org#53933,"LEMUKIH, SAWAN, BULELENG, BALI",3,241,6,247
https://kawalpemilu.org#53933,"LEMUKIH, SAWAN, BULELENG, BALI",4,204,3,207
https://kawalpemilu.org#53933,"LEMUKIH, SAWAN, BULELENG, BALI",5,219,4,223
https://kawalpemilu.org#53933,"LEMUKIH, SAWAN, BULELENG, BALI",6,206,8,214
https://kawalpemilu.org#53933,"LEMUKIH, SAWAN, BULELENG, BALI",7,226,1,227
https://kawalpemilu.org#53933,"LEMUKIH, SAWAN, BULELENG, BALI",8,209,6,215
https://kawalpemilu.org#53933,"LEMUKIH, SAWAN, BULELENG, BALI",9,203,13,216
https://kawalpemilu.org#53933,"LEMUKIH, SAWAN, BULELENG, BALI",10,161,6,167
https://kawalpemilu.org#53933,"LEMUKIH, SAWAN, BULELENG, BALI",11,206,7,213
https://kawalpemilu.org#53934,"GALUNGAN, SAWAN, BULELENG, BALI",1,230,3,233
https://kawalpemilu.org#53934,"GALUNGAN, SAWAN, BULELENG, BALI",2,221,5,226
https://kawalpemilu.org#53934,"GALUNGAN, SAWAN, BULELENG, BALI",3,230,0,230
https://kawalpemilu.org#53934,"GALUNGAN, SAWAN, BULELENG, BALI",4,237,5,242
https://kawalpemilu.org#53934,"GALUNGAN, SAWAN, BULELENG, BALI",5,138,1,139
https://kawalpemilu.org#53934,"GALUNGAN, SAWAN, BULELENG, BALI",6,130,0,130
https://kawalpemilu.org#53935,"SEKUMPUL, SAWAN, BULELENG, BALI",1,215,11,226
https://kawalpemilu.org#53935,"SEKUMPUL, SAWAN, BULELENG, BALI",2,228,4,232
https://kawalpemilu.org#53935,"SEKUMPUL, SAWAN, BULELENG, BALI",3,212,2,214
https://kawalpemilu.org#53935,"SEKUMPUL, SAWAN, BULELENG, BALI",4,202,1,203
https://kawalpemilu.org#53936,"BEBETIN, SAWAN, BULELENG, BALI",1,239,0,239
https://kawalpemilu.org#53936,"BEBETIN, SAWAN, BULELENG, BALI",2,239,1,240
https://kawalpemilu.org#53936,"BEBETIN, SAWAN, BULELENG, BALI",3,216,0,216
https://kawalpemilu.org#53936,"BEBETIN, SAWAN, BULELENG, BALI",4,209,0,209
https://kawalpemilu.org#53936,"BEBETIN, SAWAN, BULELENG, BALI",5,147,3,150
https://kawalpemilu.org#53936,"BEBETIN, SAWAN, BULELENG, BALI",6,188,10,198
https://kawalpemilu.org#53936,"BEBETIN, SAWAN, BULELENG, BALI",7,182,2,184
https://kawalpemilu.org#53936,"BEBETIN, SAWAN, BULELENG, BALI",8,182,3,185
https://kawalpemilu.org#53936,"BEBETIN, SAWAN, BULELENG, BALI",9,183,6,189
https://kawalpemilu.org#53936,"BEBETIN, SAWAN, BULELENG, BALI",10,156,2,158
https://kawalpemilu.org#53936,"BEBETIN, SAWAN, BULELENG, BALI",11,106,2,108
https://kawalpemilu.org#53936,"BEBETIN, SAWAN, BULELENG, BALI",12,179,3,182
https://kawalpemilu.org#53936,"BEBETIN, SAWAN, BULELENG, BALI",13,224,1,225
https://kawalpemilu.org#53936,"BEBETIN, SAWAN, BULELENG, BALI",14,218,6,224
https://kawalpemilu.org#53936,"BEBETIN, SAWAN, BULELENG, BALI",15,185,9,194
https://kawalpemilu.org#53936,"BEBETIN, SAWAN, BULELENG, BALI",16,200,17,217
https://kawalpemilu.org#53936,"BEBETIN, SAWAN, BULELENG, BALI",17,193,13,206
https://kawalpemilu.org#53936,"BEBETIN, SAWAN, BULELENG, BALI",18,228,5,233
https://kawalpemilu.org#53936,"BEBETIN, SAWAN, BULELENG, BALI",19,210,7,217
https://kawalpemilu.org#53936,"BEBETIN, SAWAN, BULELENG, BALI",20,159,9,168
https://kawalpemilu.org#53936,"BEBETIN, SAWAN, BULELENG, BALI",21,165,13,178
https://kawalpemilu.org#53936,"BEBETIN, SAWAN, BULELENG, BALI",22,101,2,103
https://kawalpemilu.org#53937,"SUDAJI, SAWAN, BULELENG, BALI",1,195,4,199
https://kawalpemilu.org#53937,"SUDAJI, SAWAN, BULELENG, BALI",2,181,11,192
https://kawalpemilu.org#53937,"SUDAJI, SAWAN, BULELENG, BALI",3,181,6,187
https://kawalpemilu.org#53937,"SUDAJI, SAWAN, BULELENG, BALI",4,158,16,174
https://kawalpemilu.org#53937,"SUDAJI, SAWAN, BULELENG, BALI",5,178,5,183
https://kawalpemilu.org#53937,"SUDAJI, SAWAN, BULELENG, BALI",6,185,1,186
https://kawalpemilu.org#53937,"SUDAJI, SAWAN, BULELENG, BALI",7,169,5,174
https://kawalpemilu.org#53937,"SUDAJI, SAWAN, BULELENG, BALI",8,204,1,205
https://kawalpemilu.org#53937,"SUDAJI, SAWAN, BULELENG, BALI",9,177,4,181
https://kawalpemilu.org#53937,"SUDAJI, SAWAN, BULELENG, BALI",10,142,3,145
https://kawalpemilu.org#53937,"SUDAJI, SAWAN, BULELENG, BALI",11,153,1,154
https://kawalpemilu.org#53937,"SUDAJI, SAWAN, BULELENG, BALI",12,133,1,134
https://kawalpemilu.org#53937,"SUDAJI, SAWAN, BULELENG, BALI",13,130,2,132
https://kawalpemilu.org#53937,"SUDAJI, SAWAN, BULELENG, BALI",14,95,1,96
https://kawalpemilu.org#53937,"SUDAJI, SAWAN, BULELENG, BALI",15,90,1,91
https://kawalpemilu.org#53937,"SUDAJI, SAWAN, BULELENG, BALI",16,156,5,161
https://kawalpemilu.org#53937,"SUDAJI, SAWAN, BULELENG, BALI",17,151,2,153
https://kawalpemilu.org#53937,"SUDAJI, SAWAN, BULELENG, BALI",18,137,8,145
https://kawalpemilu.org#53937,"SUDAJI, SAWAN, BULELENG, BALI",19,134,4,138
https://kawalpemilu.org#53937,"SUDAJI, SAWAN, BULELENG, BALI",20,149,10,159
https://kawalpemilu.org#53937,"SUDAJI, SAWAN, BULELENG, BALI",21,148,5,153
https://kawalpemilu.org#53937,"SUDAJI, SAWAN, BULELENG, BALI",22,149,6,155
https://kawalpemilu.org#53937,"SUDAJI, SAWAN, BULELENG, BALI",23,154,7,161
https://kawalpemilu.org#53937,"SUDAJI, SAWAN, BULELENG, BALI",24,157,8,165
https://kawalpemilu.org#53937,"SUDAJI, SAWAN, BULELENG, BALI",25,161,6,167
https://kawalpemilu.org#53937,"SUDAJI, SAWAN, BULELENG, BALI",26,168,8,176
https://kawalpemilu.org#53937,"SUDAJI, SAWAN, BULELENG, BALI",27,169,5,174
https://kawalpemilu.org#53937,"SUDAJI, SAWAN, BULELENG, BALI",28,134,6,140
https://kawalpemilu.org#53937,"SUDAJI, SAWAN, BULELENG, BALI",29,130,14,144
https://kawalpemilu.org#53937,"SUDAJI, SAWAN, BULELENG, BALI",30,159,4,163
https://kawalpemilu.org#53938,"SAWAN, SAWAN, BULELENG, BALI",1,203,12,215
https://kawalpemilu.org#53938,"SAWAN, SAWAN, BULELENG, BALI",2,178,12,190
https://kawalpemilu.org#53938,"SAWAN, SAWAN, BULELENG, BALI",3,192,7,199
https://kawalpemilu.org#53938,"SAWAN, SAWAN, BULELENG, BALI",4,196,6,202
https://kawalpemilu.org#53938,"SAWAN, SAWAN, BULELENG, BALI",5,181,7,188
https://kawalpemilu.org#53938,"SAWAN, SAWAN, BULELENG, BALI",6,185,4,189
https://kawalpemilu.org#53938,"SAWAN, SAWAN, BULELENG, BALI",8,202,1,203
https://kawalpemilu.org#53939,"MENYALI, SAWAN, BULELENG, BALI",1,181,9,190
https://kawalpemilu.org#53939,"MENYALI, SAWAN, BULELENG, BALI",2,191,7,198
https://kawalpemilu.org#53939,"MENYALI, SAWAN, BULELENG, BALI",3,180,8,188
https://kawalpemilu.org#53939,"MENYALI, SAWAN, BULELENG, BALI",4,176,7,183
https://kawalpemilu.org#53939,"MENYALI, SAWAN, BULELENG, BALI",5,159,7,166
https://kawalpemilu.org#53939,"MENYALI, SAWAN, BULELENG, BALI",6,191,7,198
https://kawalpemilu.org#53939,"MENYALI, SAWAN, BULELENG, BALI",7,183,7,190
https://kawalpemilu.org#53939,"MENYALI, SAWAN, BULELENG, BALI",8,197,4,201
https://kawalpemilu.org#53939,"MENYALI, SAWAN, BULELENG, BALI",9,169,14,183
https://kawalpemilu.org#53939,"MENYALI, SAWAN, BULELENG, BALI",10,159,7,166
https://kawalpemilu.org#53939,"MENYALI, SAWAN, BULELENG, BALI",11,173,8,181
https://kawalpemilu.org#53939,"MENYALI, SAWAN, BULELENG, BALI",12,115,5,120
https://kawalpemilu.org#53939,"MENYALI, SAWAN, BULELENG, BALI",13,211,6,217
https://kawalpemilu.org#53940,"SUWUG, SAWAN, BULELENG, BALI",2,91,4,95
https://kawalpemilu.org#53940,"SUWUG, SAWAN, BULELENG, BALI",3,119,2,121
https://kawalpemilu.org#53940,"SUWUG, SAWAN, BULELENG, BALI",4,136,0,136
https://kawalpemilu.org#53940,"SUWUG, SAWAN, BULELENG, BALI",5,142,8,150
https://kawalpemilu.org#53940,"SUWUG, SAWAN, BULELENG, BALI",6,106,3,109
https://kawalpemilu.org#53940,"SUWUG, SAWAN, BULELENG, BALI",7,124,6,130
https://kawalpemilu.org#53940,"SUWUG, SAWAN, BULELENG, BALI",8,119,5,124
https://kawalpemilu.org#53940,"SUWUG, SAWAN, BULELENG, BALI",9,132,5,137
https://kawalpemilu.org#53940,"SUWUG, SAWAN, BULELENG, BALI",10,129,3,132
https://kawalpemilu.org#53940,"SUWUG, SAWAN, BULELENG, BALI",11,97,4,101
https://kawalpemilu.org#53940,"SUWUG, SAWAN, BULELENG, BALI",12,139,3,142
https://kawalpemilu.org#53940,"SUWUG, SAWAN, BULELENG, BALI",13,116,4,120
https://kawalpemilu.org#53940,"SUWUG, SAWAN, BULELENG, BALI",14,146,11,157
https://kawalpemilu.org#53940,"SUWUG, SAWAN, BULELENG, BALI",15,162,5,167
https://kawalpemilu.org#53940,"SUWUG, SAWAN, BULELENG, BALI",16,132,17,149
https://kawalpemilu.org#53940,"SUWUG, SAWAN, BULELENG, BALI",17,157,3,160
https://kawalpemilu.org#53940,"SUWUG, SAWAN, BULELENG, BALI",18,140,7,147
https://kawalpemilu.org#53940,"SUWUG, SAWAN, BULELENG, BALI",19,130,10,140
https://kawalpemilu.org#53940,"SUWUG, SAWAN, BULELENG, BALI",20,119,7,126
https://kawalpemilu.org#53940,"SUWUG, SAWAN, BULELENG, BALI",21,115,11,126
https://kawalpemilu.org#53940,"SUWUG, SAWAN, BULELENG, BALI",22,141,4,145
https://kawalpemilu.org#53941,"JAGARAGA, SAWAN, BULELENG, BALI",1,213,2,215
https://kawalpemilu.org#53941,"JAGARAGA, SAWAN, BULELENG, BALI",2,193,27,220
https://kawalpemilu.org#53941,"JAGARAGA, SAWAN, BULELENG, BALI",3,191,17,208
https://kawalpemilu.org#53941,"JAGARAGA, SAWAN, BULELENG, BALI",4,196,15,211
https://kawalpemilu.org#53941,"JAGARAGA, SAWAN, BULELENG, BALI",5,205,10,215
https://kawalpemilu.org#53941,"JAGARAGA, SAWAN, BULELENG, BALI",6,173,28,201
https://kawalpemilu.org#53941,"JAGARAGA, SAWAN, BULELENG, BALI",7,196,23,219
https://kawalpemilu.org#53941,"JAGARAGA, SAWAN, BULELENG, BALI",8,197,21,218
https://kawalpemilu.org#53941,"JAGARAGA, SAWAN, BULELENG, BALI",9,157,10,167
https://kawalpemilu.org#53941,"JAGARAGA, SAWAN, BULELENG, BALI",10,148,19,167
https://kawalpemilu.org#53942,"SINABUN, SAWAN, BULELENG, BALI",1,179,5,184
https://kawalpemilu.org#53942,"SINABUN, SAWAN, BULELENG, BALI",2,195,7,202
https://kawalpemilu.org#53942,"SINABUN, SAWAN, BULELENG, BALI",3,192,9,201
https://kawalpemilu.org#53942,"SINABUN, SAWAN, BULELENG, BALI",4,178,3,181
https://kawalpemilu.org#53942,"SINABUN, SAWAN, BULELENG, BALI",5,169,11,180
https://kawalpemilu.org#53942,"SINABUN, SAWAN, BULELENG, BALI",6,188,8,196
https://kawalpemilu.org#53942,"SINABUN, SAWAN, BULELENG, BALI",7,177,9,186
https://kawalpemilu.org#53942,"SINABUN, SAWAN, BULELENG, BALI",8,215,9,224
https://kawalpemilu.org#53942,"SINABUN, SAWAN, BULELENG, BALI",9,188,21,209
https://kawalpemilu.org#53942,"SINABUN, SAWAN, BULELENG, BALI",10,218,7,225
https://kawalpemilu.org#53942,"SINABUN, SAWAN, BULELENG, BALI",11,182,12,194
https://kawalpemilu.org#53942,"SINABUN, SAWAN, BULELENG, BALI",12,187,5,192
https://kawalpemilu.org#53942,"SINABUN, SAWAN, BULELENG, BALI",13,198,12,210
https://kawalpemilu.org#53942,"SINABUN, SAWAN, BULELENG, BALI",14,184,20,204
https://kawalpemilu.org#53942,"SINABUN, SAWAN, BULELENG, BALI",15,202,8,210
https://kawalpemilu.org#53943,"KEROBOKAN, SAWAN, BULELENG, BALI",1,196,6,202
https://kawalpemilu.org#53943,"KEROBOKAN, SAWAN, BULELENG, BALI",2,193,22,215
https://kawalpemilu.org#53943,"KEROBOKAN, SAWAN, BULELENG, BALI",3,177,12,189
https://kawalpemilu.org#53943,"KEROBOKAN, SAWAN, BULELENG, BALI",4,172,22,194
https://kawalpemilu.org#53943,"KEROBOKAN, SAWAN, BULELENG, BALI",5,215,9,224
https://kawalpemilu.org#53943,"KEROBOKAN, SAWAN, BULELENG, BALI",6,205,20,225
https://kawalpemilu.org#53943,"KEROBOKAN, SAWAN, BULELENG, BALI",7,193,10,203
https://kawalpemilu.org#53943,"KEROBOKAN, SAWAN, BULELENG, BALI",8,189,11,200
https://kawalpemilu.org#53944,"SANGSIT, SAWAN, BULELENG, BALI",1,109,72,181
https://kawalpemilu.org#53944,"SANGSIT, SAWAN, BULELENG, BALI",2,115,72,187
https://kawalpemilu.org#53944,"SANGSIT, SAWAN, BULELENG, BALI",3,175,24,199
https://kawalpemilu.org#53944,"SANGSIT, SAWAN, BULELENG, BALI",4,169,14,183
https://kawalpemilu.org#53944,"SANGSIT, SAWAN, BULELENG, BALI",5,180,12,192
https://kawalpemilu.org#53944,"SANGSIT, SAWAN, BULELENG, BALI",6,179,6,185
https://kawalpemilu.org#53944,"SANGSIT, SAWAN, BULELENG, BALI",7,190,10,200
https://kawalpemilu.org#53944,"SANGSIT, SAWAN, BULELENG, BALI",8,146,15,161
https://kawalpemilu.org#53944,"SANGSIT, SAWAN, BULELENG, BALI",9,201,15,216
https://kawalpemilu.org#53944,"SANGSIT, SAWAN, BULELENG, BALI",10,161,11,172
https://kawalpemilu.org#53944,"SANGSIT, SAWAN, BULELENG, BALI",11,163,17,180
https://kawalpemilu.org#53944,"SANGSIT, SAWAN, BULELENG, BALI",12,174,13,187
https://kawalpemilu.org#53944,"SANGSIT, SAWAN, BULELENG, BALI",13,154,17,171
https://kawalpemilu.org#53944,"SANGSIT, SAWAN, BULELENG, BALI",14,198,8,206
https://kawalpemilu.org#53944,"SANGSIT, SAWAN, BULELENG, BALI",15,192,16,208
https://kawalpemilu.org#53944,"SANGSIT, SAWAN, BULELENG, BALI",16,196,10,206
https://kawalpemilu.org#53944,"SANGSIT, SAWAN, BULELENG, BALI",17,201,12,213
https://kawalpemilu.org#53944,"SANGSIT, SAWAN, BULELENG, BALI",18,200,9,209
https://kawalpemilu.org#53944,"SANGSIT, SAWAN, BULELENG, BALI",19,199,7,206
https://kawalpemilu.org#53944,"SANGSIT, SAWAN, BULELENG, BALI",20,214,14,228
https://kawalpemilu.org#53944,"SANGSIT, SAWAN, BULELENG, BALI",21,197,7,204
https://kawalpemilu.org#53944,"SANGSIT, SAWAN, BULELENG, BALI",22,189,22,211
https://kawalpemilu.org#53944,"SANGSIT, SAWAN, BULELENG, BALI",23,182,18,200
https://kawalpemilu.org#53944,"SANGSIT, SAWAN, BULELENG, BALI",24,194,11,205
https://kawalpemilu.org#53944,"SANGSIT, SAWAN, BULELENG, BALI",25,195,5,200
https://kawalpemilu.org#53944,"SANGSIT, SAWAN, BULELENG, BALI",26,206,12,218
https://kawalpemilu.org#53944,"SANGSIT, SAWAN, BULELENG, BALI",27,219,16,235
https://kawalpemilu.org#53944,"SANGSIT, SAWAN, BULELENG, BALI",28,208,22,230
https://kawalpemilu.org#53944,"SANGSIT, SAWAN, BULELENG, BALI",29,207,15,222
https://kawalpemilu.org#53945,"BUNGKULAN, SAWAN, BULELENG, BALI",1,246,16,262
https://kawalpemilu.org#53945,"BUNGKULAN, SAWAN, BULELENG, BALI",2,132,16,148
https://kawalpemilu.org#53945,"BUNGKULAN, SAWAN, BULELENG, BALI",3,124,6,130
https://kawalpemilu.org#53945,"BUNGKULAN, SAWAN, BULELENG, BALI",4,164,11,175
https://kawalpemilu.org#53945,"BUNGKULAN, SAWAN, BULELENG, BALI",5,213,23,236
https://kawalpemilu.org#53945,"BUNGKULAN, SAWAN, BULELENG, BALI",6,164,2,166
https://kawalpemilu.org#53945,"BUNGKULAN, SAWAN, BULELENG, BALI",7,189,1,190
https://kawalpemilu.org#53945,"BUNGKULAN, SAWAN, BULELENG, BALI",8,269,12,281
https://kawalpemilu.org#53945,"BUNGKULAN, SAWAN, BULELENG, BALI",9,223,9,232
https://kawalpemilu.org#53945,"BUNGKULAN, SAWAN, BULELENG, BALI",10,139,11,150
https://kawalpemilu.org#53945,"BUNGKULAN, SAWAN, BULELENG, BALI",11,227,18,245
https://kawalpemilu.org#53945,"BUNGKULAN, SAWAN, BULELENG, BALI",12,231,6,237
https://kawalpemilu.org#53945,"BUNGKULAN, SAWAN, BULELENG, BALI",13,267,15,282
https://kawalpemilu.org#53945,"BUNGKULAN, SAWAN, BULELENG, BALI",14,287,0,287
https://kawalpemilu.org#53945,"BUNGKULAN, SAWAN, BULELENG, BALI",15,233,8,241
https://kawalpemilu.org#53945,"BUNGKULAN, SAWAN, BULELENG, BALI",16,281,18,299
https://kawalpemilu.org#53945,"BUNGKULAN, SAWAN, BULELENG, BALI",17,163,23,186
https://kawalpemilu.org#53945,"BUNGKULAN, SAWAN, BULELENG, BALI",18,190,8,198
https://kawalpemilu.org#53945,"BUNGKULAN, SAWAN, BULELENG, BALI",19,182,24,206
https://kawalpemilu.org#53945,"BUNGKULAN, SAWAN, BULELENG, BALI",20,160,42,202
https://kawalpemilu.org#53945,"BUNGKULAN, SAWAN, BULELENG, BALI",21,233,27,260
https://kawalpemilu.org#53945,"BUNGKULAN, SAWAN, BULELENG, BALI",22,208,24,232
https://kawalpemilu.org#53945,"BUNGKULAN, SAWAN, BULELENG, BALI",23,254,39,293
https://kawalpemilu.org#53945,"BUNGKULAN, SAWAN, BULELENG, BALI",25,176,54,230
https://kawalpemilu.org#53945,"BUNGKULAN, SAWAN, BULELENG, BALI",26,154,25,179
https://kawalpemilu.org#53945,"BUNGKULAN, SAWAN, BULELENG, BALI",27,237,44,281
https://kawalpemilu.org#53945,"BUNGKULAN, SAWAN, BULELENG, BALI",28,185,42,227
https://kawalpemilu.org#53945,"BUNGKULAN, SAWAN, BULELENG, BALI",29,165,21,186
https://kawalpemilu.org#53945,"BUNGKULAN, SAWAN, BULELENG, BALI",30,254,8,262
https://kawalpemilu.org#53945,"BUNGKULAN, SAWAN, BULELENG, BALI",31,260,30,290
https://kawalpemilu.org#53945,"BUNGKULAN, SAWAN, BULELENG, BALI",32,200,8,208
https://kawalpemilu.org#53945,"BUNGKULAN, SAWAN, BULELENG, BALI",33,166,18,184
https://kawalpemilu.org#53945,"BUNGKULAN, SAWAN, BULELENG, BALI",34,188,16,204
https://kawalpemilu.org#53945,"BUNGKULAN, SAWAN, BULELENG, BALI",35,276,5,281
https://kawalpemilu.org#53945,"BUNGKULAN, SAWAN, BULELENG, BALI",36,205,15,220
https://kawalpemilu.org#53945,"BUNGKULAN, SAWAN, BULELENG, BALI",37,235,12,247
https://kawalpemilu.org#53945,"BUNGKULAN, SAWAN, BULELENG, BALI",38,258,9,267
https://kawalpemilu.org#53945,"BUNGKULAN, SAWAN, BULELENG, BALI",39,171,17,188
https://kawalpemilu.org#53945,"BUNGKULAN, SAWAN, BULELENG, BALI",40,176,11,187
https://kawalpemilu.org#53945,"BUNGKULAN, SAWAN, BULELENG, BALI",41,153,7,160
https://kawalpemilu.org#53946,"GIRI EMAS, SAWAN, BULELENG, BALI",1,176,19,195
https://kawalpemilu.org#53946,"GIRI EMAS, SAWAN, BULELENG, BALI",2,218,11,229
https://kawalpemilu.org#53946,"GIRI EMAS, SAWAN, BULELENG, BALI",3,176,17,193
https://kawalpemilu.org#53946,"GIRI EMAS, SAWAN, BULELENG, BALI",4,179,8,187
https://kawalpemilu.org#53946,"GIRI EMAS, SAWAN, BULELENG, BALI",5,186,12,198
https://kawalpemilu.org#53946,"GIRI EMAS, SAWAN, BULELENG, BALI",6,169,11,180
https://kawalpemilu.org#53946,"GIRI EMAS, SAWAN, BULELENG, BALI",7,192,6,198
https://kawalpemilu.org#53946,"GIRI EMAS, SAWAN, BULELENG, BALI",8,149,15,164
https://kawalpemilu.org#53948,"TAMBAKAN, KUBUTAMBAHAN, BULELENG, BALI",1,215,7,222
https://kawalpemilu.org#53948,"TAMBAKAN, KUBUTAMBAHAN, BULELENG, BALI",2,186,5,191
https://kawalpemilu.org#53948,"TAMBAKAN, KUBUTAMBAHAN, BULELENG, BALI",3,194,3,197
https://kawalpemilu.org#53948,"TAMBAKAN, KUBUTAMBAHAN, BULELENG, BALI",4,204,6,210
https://kawalpemilu.org#53948,"TAMBAKAN, KUBUTAMBAHAN, BULELENG, BALI",5,201,6,207
https://kawalpemilu.org#53948,"TAMBAKAN, KUBUTAMBAHAN, BULELENG, BALI",6,190,8,198
https://kawalpemilu.org#53948,"TAMBAKAN, KUBUTAMBAHAN, BULELENG, BALI",7,142,9,151
https://kawalpemilu.org#53948,"TAMBAKAN, KUBUTAMBAHAN, BULELENG, BALI",8,170,12,182
https://kawalpemilu.org#53948,"TAMBAKAN, KUBUTAMBAHAN, BULELENG, BALI",9,164,8,172
https://kawalpemilu.org#53948,"TAMBAKAN, KUBUTAMBAHAN, BULELENG, BALI",10,153,11,164
https://kawalpemilu.org#53949,"PAKISAN, KUBUTAMBAHAN, BULELENG, BALI",1,143,5,148
https://kawalpemilu.org#53949,"PAKISAN, KUBUTAMBAHAN, BULELENG, BALI",2,142,6,148
https://kawalpemilu.org#53949,"PAKISAN, KUBUTAMBAHAN, BULELENG, BALI",3,198,9,207
https://kawalpemilu.org#53949,"PAKISAN, KUBUTAMBAHAN, BULELENG, BALI",4,207,10,217
https://kawalpemilu.org#53949,"PAKISAN, KUBUTAMBAHAN, BULELENG, BALI",5,117,5,122
https://kawalpemilu.org#53949,"PAKISAN, KUBUTAMBAHAN, BULELENG, BALI",6,225,13,238
https://kawalpemilu.org#53949,"PAKISAN, KUBUTAMBAHAN, BULELENG, BALI",7,236,3,239
https://kawalpemilu.org#53949,"PAKISAN, KUBUTAMBAHAN, BULELENG, BALI",8,208,25,233
https://kawalpemilu.org#53949,"PAKISAN, KUBUTAMBAHAN, BULELENG, BALI",9,233,10,243
https://kawalpemilu.org#53949,"PAKISAN, KUBUTAMBAHAN, BULELENG, BALI",10,198,26,224
https://kawalpemilu.org#53949,"PAKISAN, KUBUTAMBAHAN, BULELENG, BALI",11,168,19,184
https://kawalpemilu.org#53949,"PAKISAN, KUBUTAMBAHAN, BULELENG, BALI",12,189,8,197
https://kawalpemilu.org#53949,"PAKISAN, KUBUTAMBAHAN, BULELENG, BALI",13,181,6,187
https://kawalpemilu.org#53949,"PAKISAN, KUBUTAMBAHAN, BULELENG, BALI",14,204,7,211
https://kawalpemilu.org#53949,"PAKISAN, KUBUTAMBAHAN, BULELENG, BALI",15,196,9,205
https://kawalpemilu.org#53949,"PAKISAN, KUBUTAMBAHAN, BULELENG, BALI",16,137,5,142
https://kawalpemilu.org#53950,"BONTIHING, KUBUTAMBAHAN, BULELENG, BALI",1,207,7,214
https://kawalpemilu.org#53950,"BONTIHING, KUBUTAMBAHAN, BULELENG, BALI",2,213,14,227
https://kawalpemilu.org#53950,"BONTIHING, KUBUTAMBAHAN, BULELENG, BALI",3,230,8,238
https://kawalpemilu.org#53950,"BONTIHING, KUBUTAMBAHAN, BULELENG, BALI",4,205,8,213
https://kawalpemilu.org#53950,"BONTIHING, KUBUTAMBAHAN, BULELENG, BALI",5,202,8,210
https://kawalpemilu.org#53950,"BONTIHING, KUBUTAMBAHAN, BULELENG, BALI",6,202,7,209
https://kawalpemilu.org#53950,"BONTIHING, KUBUTAMBAHAN, BULELENG, BALI",7,199,4,203
https://kawalpemilu.org#53950,"BONTIHING, KUBUTAMBAHAN, BULELENG, BALI",8,188,11,199
https://kawalpemilu.org#53950,"BONTIHING, KUBUTAMBAHAN, BULELENG, BALI",9,180,14,194
https://kawalpemilu.org#53950,"BONTIHING, KUBUTAMBAHAN, BULELENG, BALI",10,209,8,217
https://kawalpemilu.org#53950,"BONTIHING, KUBUTAMBAHAN, BULELENG, BALI",11,186,9,195
https://kawalpemilu.org#53950,"BONTIHING, KUBUTAMBAHAN, BULELENG, BALI",12,191,1,192
https://kawalpemilu.org#53950,"BONTIHING, KUBUTAMBAHAN, BULELENG, BALI",13,229,6,237
https://kawalpemilu.org#53950,"BONTIHING, KUBUTAMBAHAN, BULELENG, BALI",14,201,4,205
https://kawalpemilu.org#53950,"BONTIHING, KUBUTAMBAHAN, BULELENG, BALI",15,216,4,220
https://kawalpemilu.org#53951,"TAJUN, KUBUTAMBAHAN, BULELENG, BALI",1,171,11,182
https://kawalpemilu.org#53951,"TAJUN, KUBUTAMBAHAN, BULELENG, BALI",2,168,4,172
https://kawalpemilu.org#53951,"TAJUN, KUBUTAMBAHAN, BULELENG, BALI",3,169,11,180
https://kawalpemilu.org#53951,"TAJUN, KUBUTAMBAHAN, BULELENG, BALI",4,174,6,180
https://kawalpemilu.org#53951,"TAJUN, KUBUTAMBAHAN, BULELENG, BALI",5,173,11,184
https://kawalpemilu.org#53951,"TAJUN, KUBUTAMBAHAN, BULELENG, BALI",6,186,4,190
https://kawalpemilu.org#53951,"TAJUN, KUBUTAMBAHAN, BULELENG, BALI",7,207,4,211
https://kawalpemilu.org#53951,"TAJUN, KUBUTAMBAHAN, BULELENG, BALI",8,182,11,193
https://kawalpemilu.org#53951,"TAJUN, KUBUTAMBAHAN, BULELENG, BALI",9,207,12,219
https://kawalpemilu.org#53951,"TAJUN, KUBUTAMBAHAN, BULELENG, BALI",10,185,11,196
https://kawalpemilu.org#53951,"TAJUN, KUBUTAMBAHAN, BULELENG, BALI",11,150,6,156
https://kawalpemilu.org#53951,"TAJUN, KUBUTAMBAHAN, BULELENG, BALI",12,163,12,175
https://kawalpemilu.org#53951,"TAJUN, KUBUTAMBAHAN, BULELENG, BALI",13,151,10,161
https://kawalpemilu.org#53951,"TAJUN, KUBUTAMBAHAN, BULELENG, BALI",14,149,19,168
https://kawalpemilu.org#53951,"TAJUN, KUBUTAMBAHAN, BULELENG, BALI",15,176,3,179
https://kawalpemilu.org#53951,"TAJUN, KUBUTAMBAHAN, BULELENG, BALI",16,178,1,179
https://kawalpemilu.org#53951,"TAJUN, KUBUTAMBAHAN, BULELENG, BALI",17,146,7,153
https://kawalpemilu.org#53951,"TAJUN, KUBUTAMBAHAN, BULELENG, BALI",18,138,8,146
https://kawalpemilu.org#53951,"TAJUN, KUBUTAMBAHAN, BULELENG, BALI",19,159,5,164
https://kawalpemilu.org#53951,"TAJUN, KUBUTAMBAHAN, BULELENG, BALI",20,97,10,107
https://kawalpemilu.org#53952,"TUNJUNG, KUBUTAMBAHAN, BULELENG, BALI",1,182,38,220
https://kawalpemilu.org#53952,"TUNJUNG, KUBUTAMBAHAN, BULELENG, BALI",2,174,34,208
https://kawalpemilu.org#53952,"TUNJUNG, KUBUTAMBAHAN, BULELENG, BALI",3,181,27,208
https://kawalpemilu.org#53952,"TUNJUNG, KUBUTAMBAHAN, BULELENG, BALI",4,209,16,225
https://kawalpemilu.org#53952,"TUNJUNG, KUBUTAMBAHAN, BULELENG, BALI",5,206,19,225
https://kawalpemilu.org#53952,"TUNJUNG, KUBUTAMBAHAN, BULELENG, BALI",6,202,5,207
https://kawalpemilu.org#53952,"TUNJUNG, KUBUTAMBAHAN, BULELENG, BALI",7,189,10,199
https://kawalpemilu.org#53952,"TUNJUNG, KUBUTAMBAHAN, BULELENG, BALI",8,190,3,193
https://kawalpemilu.org#53952,"TUNJUNG, KUBUTAMBAHAN, BULELENG, BALI",9,173,10,183
https://kawalpemilu.org#53952,"TUNJUNG, KUBUTAMBAHAN, BULELENG, BALI",10,196,14,210
https://kawalpemilu.org#53952,"TUNJUNG, KUBUTAMBAHAN, BULELENG, BALI",11,147,15,162
https://kawalpemilu.org#53952,"TUNJUNG, KUBUTAMBAHAN, BULELENG, BALI",12,179,10,189
https://kawalpemilu.org#53953,"DEPEHE, KUBUTAMBAHAN, BULELENG, BALI",1,142,12,154
https://kawalpemilu.org#53953,"DEPEHE, KUBUTAMBAHAN, BULELENG, BALI",2,170,8,178
https://kawalpemilu.org#53953,"DEPEHE, KUBUTAMBAHAN, BULELENG, BALI",3,137,10,147
https://kawalpemilu.org#53953,"DEPEHE, KUBUTAMBAHAN, BULELENG, BALI",4,158,15,173
https://kawalpemilu.org#53953,"DEPEHE, KUBUTAMBAHAN, BULELENG, BALI",6,165,19,184
https://kawalpemilu.org#53953,"DEPEHE, KUBUTAMBAHAN, BULELENG, BALI",7,227,22,249
https://kawalpemilu.org#53953,"DEPEHE, KUBUTAMBAHAN, BULELENG, BALI",8,236,10,246
https://kawalpemilu.org#53953,"DEPEHE, KUBUTAMBAHAN, BULELENG, BALI",9,216,13,229
https://kawalpemilu.org#53953,"DEPEHE, KUBUTAMBAHAN, BULELENG, BALI",10,188,5,193
https://kawalpemilu.org#53953,"DEPEHE, KUBUTAMBAHAN, BULELENG, BALI",11,170,7,177
https://kawalpemilu.org#53953,"DEPEHE, KUBUTAMBAHAN, BULELENG, BALI",12,177,6,183
https://kawalpemilu.org#53953,"DEPEHE, KUBUTAMBAHAN, BULELENG, BALI",13,187,10,197
https://kawalpemilu.org#53953,"DEPEHE, KUBUTAMBAHAN, BULELENG, BALI",14,188,21,209
https://kawalpemilu.org#53953,"DEPEHE, KUBUTAMBAHAN, BULELENG, BALI",15,128,6,134
https://kawalpemilu.org#53953,"DEPEHE, KUBUTAMBAHAN, BULELENG, BALI",16,152,19,171
https://kawalpemilu.org#53953,"DEPEHE, KUBUTAMBAHAN, BULELENG, BALI",17,142,15,157
https://kawalpemilu.org#53953,"DEPEHE, KUBUTAMBAHAN, BULELENG, BALI",18,151,23,174
https://kawalpemilu.org#53954,"TAMBLANG, KUBUTAMBAHAN, BULELENG, BALI",1,212,4,216
https://kawalpemilu.org#53954,"TAMBLANG, KUBUTAMBAHAN, BULELENG, BALI",2,208,4,212
https://kawalpemilu.org#53954,"TAMBLANG, KUBUTAMBAHAN, BULELENG, BALI",3,203,1,204
https://kawalpemilu.org#53954,"TAMBLANG, KUBUTAMBAHAN, BULELENG, BALI",4,174,5,179
https://kawalpemilu.org#53954,"TAMBLANG, KUBUTAMBAHAN, BULELENG, BALI",5,186,3,189
https://kawalpemilu.org#53954,"TAMBLANG, KUBUTAMBAHAN, BULELENG, BALI",6,180,7,187
https://kawalpemilu.org#53954,"TAMBLANG, KUBUTAMBAHAN, BULELENG, BALI",7,190,11,201
https://kawalpemilu.org#53954,"TAMBLANG, KUBUTAMBAHAN, BULELENG, BALI",8,168,11,179
https://kawalpemilu.org#53954,"TAMBLANG, KUBUTAMBAHAN, BULELENG, BALI",9,209,4,213
https://kawalpemilu.org#53954,"TAMBLANG, KUBUTAMBAHAN, BULELENG, BALI",10,212,6,218
https://kawalpemilu.org#53954,"TAMBLANG, KUBUTAMBAHAN, BULELENG, BALI",11,197,14,211
https://kawalpemilu.org#53954,"TAMBLANG, KUBUTAMBAHAN, BULELENG, BALI",12,191,6,197
https://kawalpemilu.org#53954,"TAMBLANG, KUBUTAMBAHAN, BULELENG, BALI",13,186,12,198
https://kawalpemilu.org#53954,"TAMBLANG, KUBUTAMBAHAN, BULELENG, BALI",14,217,10,227
https://kawalpemilu.org#53954,"TAMBLANG, KUBUTAMBAHAN, BULELENG, BALI",15,193,1,194
https://kawalpemilu.org#53954,"TAMBLANG, KUBUTAMBAHAN, BULELENG, BALI",16,210,5,215
https://kawalpemilu.org#53954,"TAMBLANG, KUBUTAMBAHAN, BULELENG, BALI",17,216,11,227
https://kawalpemilu.org#53954,"TAMBLANG, KUBUTAMBAHAN, BULELENG, BALI",18,226,7,233
https://kawalpemilu.org#53954,"TAMBLANG, KUBUTAMBAHAN, BULELENG, BALI",19,196,15,211
https://kawalpemilu.org#53954,"TAMBLANG, KUBUTAMBAHAN, BULELENG, BALI",20,215,8,223
https://kawalpemilu.org#53955,"BULIAN, KUBUTAMBAHAN, BULELENG, BALI",1,208,14,222
https://kawalpemilu.org#53955,"BULIAN, KUBUTAMBAHAN, BULELENG, BALI",2,170,15,185
https://kawalpemilu.org#53955,"BULIAN, KUBUTAMBAHAN, BULELENG, BALI",3,192,19,211
https://kawalpemilu.org#53955,"BULIAN, KUBUTAMBAHAN, BULELENG, BALI",4,186,10,196
https://kawalpemilu.org#53955,"BULIAN, KUBUTAMBAHAN, BULELENG, BALI",5,189,7,196
https://kawalpemilu.org#53955,"BULIAN, KUBUTAMBAHAN, BULELENG, BALI",6,193,15,208
https://kawalpemilu.org#53955,"BULIAN, KUBUTAMBAHAN, BULELENG, BALI",7,207,7,214
https://kawalpemilu.org#53955,"BULIAN, KUBUTAMBAHAN, BULELENG, BALI",8,202,5,207
https://kawalpemilu.org#53955,"BULIAN, KUBUTAMBAHAN, BULELENG, BALI",9,180,23,203
https://kawalpemilu.org#53955,"BULIAN, KUBUTAMBAHAN, BULELENG, BALI",10,185,10,195
https://kawalpemilu.org#53955,"BULIAN, KUBUTAMBAHAN, BULELENG, BALI",11,193,7,200
https://kawalpemilu.org#53956,"BILA, KUBUTAMBAHAN, BULELENG, BALI",1,170,11,181
https://kawalpemilu.org#53956,"BILA, KUBUTAMBAHAN, BULELENG, BALI",2,166,10,176
https://kawalpemilu.org#53956,"BILA, KUBUTAMBAHAN, BULELENG, BALI",3,179,13,192
https://kawalpemilu.org#53956,"BILA, KUBUTAMBAHAN, BULELENG, BALI",4,185,7,192
https://kawalpemilu.org#53956,"BILA, KUBUTAMBAHAN, BULELENG, BALI",5,199,10,209
https://kawalpemilu.org#53956,"BILA, KUBUTAMBAHAN, BULELENG, BALI",6,175,2,177
https://kawalpemilu.org#53956,"BILA, KUBUTAMBAHAN, BULELENG, BALI",7,162,2,164
https://kawalpemilu.org#53956,"BILA, KUBUTAMBAHAN, BULELENG, BALI",8,98,5,103
https://kawalpemilu.org#53956,"BILA, KUBUTAMBAHAN, BULELENG, BALI",9,108,4,112
https://kawalpemilu.org#53957,"BENGKALA, KUBUTAMBAHAN, BULELENG, BALI",1,170,36,206
https://kawalpemilu.org#53957,"BENGKALA, KUBUTAMBAHAN, BULELENG, BALI",2,198,34,232
https://kawalpemilu.org#53957,"BENGKALA, KUBUTAMBAHAN, BULELENG, BALI",3,183,45,228
https://kawalpemilu.org#53957,"BENGKALA, KUBUTAMBAHAN, BULELENG, BALI",4,0,0,216
https://kawalpemilu.org#53957,"BENGKALA, KUBUTAMBAHAN, BULELENG, BALI",5,170,25,195
https://kawalpemilu.org#53957,"BENGKALA, KUBUTAMBAHAN, BULELENG, BALI",6,217,19,236
https://kawalpemilu.org#53957,"BENGKALA, KUBUTAMBAHAN, BULELENG, BALI",7,185,19,204
https://kawalpemilu.org#53957,"BENGKALA, KUBUTAMBAHAN, BULELENG, BALI",8,203,0,203
https://kawalpemilu.org#53958,"KUBUTAMBAHAN, KUBUTAMBAHAN, BULELENG, BALI",1,200,10,210
https://kawalpemilu.org#53958,"KUBUTAMBAHAN, KUBUTAMBAHAN, BULELENG, BALI",2,206,19,225
https://kawalpemilu.org#53958,"KUBUTAMBAHAN, KUBUTAMBAHAN, BULELENG, BALI",3,195,10,205
https://kawalpemilu.org#53958,"KUBUTAMBAHAN, KUBUTAMBAHAN, BULELENG, BALI",4,203,12,215
https://kawalpemilu.org#53958,"KUBUTAMBAHAN, KUBUTAMBAHAN, BULELENG, BALI",5,218,13,231
https://kawalpemilu.org#53958,"KUBUTAMBAHAN, KUBUTAMBAHAN, BULELENG, BALI",6,229,13,242
https://kawalpemilu.org#53958,"KUBUTAMBAHAN, KUBUTAMBAHAN, BULELENG, BALI",7,210,21,231
https://kawalpemilu.org#53958,"KUBUTAMBAHAN, KUBUTAMBAHAN, BULELENG, BALI",8,197,9,206
https://kawalpemilu.org#53958,"KUBUTAMBAHAN, KUBUTAMBAHAN, BULELENG, BALI",9,206,12,218
https://kawalpemilu.org#53958,"KUBUTAMBAHAN, KUBUTAMBAHAN, BULELENG, BALI",10,208,12,220
https://kawalpemilu.org#53958,"KUBUTAMBAHAN, KUBUTAMBAHAN, BULELENG, BALI",11,190,13,203
https://kawalpemilu.org#53958,"KUBUTAMBAHAN, KUBUTAMBAHAN, BULELENG, BALI",12,186,9,195
https://kawalpemilu.org#53958,"KUBUTAMBAHAN, KUBUTAMBAHAN, BULELENG, BALI",13,192,17,209
https://kawalpemilu.org#53958,"KUBUTAMBAHAN, KUBUTAMBAHAN, BULELENG, BALI",14,203,5,208
https://kawalpemilu.org#53958,"KUBUTAMBAHAN, KUBUTAMBAHAN, BULELENG, BALI",15,171,12,183
https://kawalpemilu.org#53958,"KUBUTAMBAHAN, KUBUTAMBAHAN, BULELENG, BALI",16,198,10,208
https://kawalpemilu.org#53958,"KUBUTAMBAHAN, KUBUTAMBAHAN, BULELENG, BALI",17,191,26,217
https://kawalpemilu.org#53958,"KUBUTAMBAHAN, KUBUTAMBAHAN, BULELENG, BALI",18,253,5,258
https://kawalpemilu.org#53958,"KUBUTAMBAHAN, KUBUTAMBAHAN, BULELENG, BALI",19,254,10,264
https://kawalpemilu.org#53958,"KUBUTAMBAHAN, KUBUTAMBAHAN, BULELENG, BALI",21,253,5,258
https://kawalpemilu.org#53958,"KUBUTAMBAHAN, KUBUTAMBAHAN, BULELENG, BALI",22,226,9,235
https://kawalpemilu.org#53958,"KUBUTAMBAHAN, KUBUTAMBAHAN, BULELENG, BALI",23,220,10,230
https://kawalpemilu.org#53958,"KUBUTAMBAHAN, KUBUTAMBAHAN, BULELENG, BALI",24,212,9,221
https://kawalpemilu.org#53958,"KUBUTAMBAHAN, KUBUTAMBAHAN, BULELENG, BALI",25,201,9,210
https://kawalpemilu.org#53958,"KUBUTAMBAHAN, KUBUTAMBAHAN, BULELENG, BALI",26,172,3,175
https://kawalpemilu.org#53958,"KUBUTAMBAHAN, KUBUTAMBAHAN, BULELENG, BALI",27,191,5,196
https://kawalpemilu.org#53958,"KUBUTAMBAHAN, KUBUTAMBAHAN, BULELENG, BALI",28,222,5,227
https://kawalpemilu.org#53958,"KUBUTAMBAHAN, KUBUTAMBAHAN, BULELENG, BALI",29,226,16,242
https://kawalpemilu.org#53958,"KUBUTAMBAHAN, KUBUTAMBAHAN, BULELENG, BALI",30,231,30,261
https://kawalpemilu.org#53958,"KUBUTAMBAHAN, KUBUTAMBAHAN, BULELENG, BALI",31,187,35,222
https://kawalpemilu.org#53958,"KUBUTAMBAHAN, KUBUTAMBAHAN, BULELENG, BALI",32,167,49,216
https://kawalpemilu.org#53959,"BUKTI, KUBUTAMBAHAN, BULELENG, BALI",1,137,49,186
https://kawalpemilu.org#53959,"BUKTI, KUBUTAMBAHAN, BULELENG, BALI",2,144,29,173
https://kawalpemilu.org#53959,"BUKTI, KUBUTAMBAHAN, BULELENG, BALI",3,180,2,182
https://kawalpemilu.org#53959,"BUKTI, KUBUTAMBAHAN, BULELENG, BALI",4,187,7,194
https://kawalpemilu.org#53959,"BUKTI, KUBUTAMBAHAN, BULELENG, BALI",5,180,3,183
https://kawalpemilu.org#53959,"BUKTI, KUBUTAMBAHAN, BULELENG, BALI",6,177,6,183
https://kawalpemilu.org#53959,"BUKTI, KUBUTAMBAHAN, BULELENG, BALI",7,169,9,178
https://kawalpemilu.org#53959,"BUKTI, KUBUTAMBAHAN, BULELENG, BALI",8,165,0,165
https://kawalpemilu.org#53959,"BUKTI, KUBUTAMBAHAN, BULELENG, BALI",9,158,1,159
https://kawalpemilu.org#53959,"BUKTI, KUBUTAMBAHAN, BULELENG, BALI",10,178,2,180
https://kawalpemilu.org#53959,"BUKTI, KUBUTAMBAHAN, BULELENG, BALI",11,170,15,185
https://kawalpemilu.org#53959,"BUKTI, KUBUTAMBAHAN, BULELENG, BALI",12,188,4,192
https://kawalpemilu.org#53959,"BUKTI, KUBUTAMBAHAN, BULELENG, BALI",13,164,7,171
https://kawalpemilu.org#53960,"MENGENING, KUBUTAMBAHAN, BULELENG, BALI",1,228,4,232
https://kawalpemilu.org#53960,"MENGENING, KUBUTAMBAHAN, BULELENG, BALI",2,232,11,243
https://kawalpemilu.org#53960,"MENGENING, KUBUTAMBAHAN, BULELENG, BALI",3,224,8,232
https://kawalpemilu.org#53960,"MENGENING, KUBUTAMBAHAN, BULELENG, BALI",4,221,5,226
https://kawalpemilu.org#53960,"MENGENING, KUBUTAMBAHAN, BULELENG, BALI",5,204,5,209
https://kawalpemilu.org#53962,"SEMBIRAN, TEJAKULA, BULELENG, BALI",1,173,4,177
https://kawalpemilu.org#53962,"SEMBIRAN, TEJAKULA, BULELENG, BALI",2,161,6,167
https://kawalpemilu.org#53962,"SEMBIRAN, TEJAKULA, BULELENG, BALI",3,171,4,175
https://kawalpemilu.org#53962,"SEMBIRAN, TEJAKULA, BULELENG, BALI",4,185,5,190
https://kawalpemilu.org#53962,"SEMBIRAN, TEJAKULA, BULELENG, BALI",5,168,3,171
https://kawalpemilu.org#53962,"SEMBIRAN, TEJAKULA, BULELENG, BALI",6,148,1,149
https://kawalpemilu.org#53962,"SEMBIRAN, TEJAKULA, BULELENG, BALI",7,155,4,159
https://kawalpemilu.org#53962,"SEMBIRAN, TEJAKULA, BULELENG, BALI",8,156,3,159
https://kawalpemilu.org#53962,"SEMBIRAN, TEJAKULA, BULELENG, BALI",9,207,5,212
https://kawalpemilu.org#53962,"SEMBIRAN, TEJAKULA, BULELENG, BALI",10,213,2,215
https://kawalpemilu.org#53962,"SEMBIRAN, TEJAKULA, BULELENG, BALI",11,228,2,230
https://kawalpemilu.org#53962,"SEMBIRAN, TEJAKULA, BULELENG, BALI",12,226,1,227
https://kawalpemilu.org#53962,"SEMBIRAN, TEJAKULA, BULELENG, BALI",13,239,2,241
https://kawalpemilu.org#53962,"SEMBIRAN, TEJAKULA, BULELENG, BALI",14,247,6,0
https://kawalpemilu.org#53962,"SEMBIRAN, TEJAKULA, BULELENG, BALI",15,221,4,225
https://kawalpemilu.org#53962,"SEMBIRAN, TEJAKULA, BULELENG, BALI",16,227,6,233
https://kawalpemilu.org#53963,"PACUNG, TEJAKULA, BULELENG, BALI",1,158,6,164
https://kawalpemilu.org#53963,"PACUNG, TEJAKULA, BULELENG, BALI",2,183,9,192
https://kawalpemilu.org#53963,"PACUNG, TEJAKULA, BULELENG, BALI",3,157,6,163
https://kawalpemilu.org#53963,"PACUNG, TEJAKULA, BULELENG, BALI",4,183,9,192
https://kawalpemilu.org#53963,"PACUNG, TEJAKULA, BULELENG, BALI",5,201,5,206
https://kawalpemilu.org#53963,"PACUNG, TEJAKULA, BULELENG, BALI",6,188,7,195
https://kawalpemilu.org#53963,"PACUNG, TEJAKULA, BULELENG, BALI",7,173,32,205
https://kawalpemilu.org#53963,"PACUNG, TEJAKULA, BULELENG, BALI",8,209,6,215
https://kawalpemilu.org#53963,"PACUNG, TEJAKULA, BULELENG, BALI",9,209,7,216
https://kawalpemilu.org#53963,"PACUNG, TEJAKULA, BULELENG, BALI",10,227,11,238
https://kawalpemilu.org#53964,"JULAH, TEJAKULA, BULELENG, BALI",1,137,4,141
https://kawalpemilu.org#53964,"JULAH, TEJAKULA, BULELENG, BALI",2,163,6,169
https://kawalpemilu.org#53964,"JULAH, TEJAKULA, BULELENG, BALI",3,139,5,144
https://kawalpemilu.org#53964,"JULAH, TEJAKULA, BULELENG, BALI",4,126,11,137
https://kawalpemilu.org#53964,"JULAH, TEJAKULA, BULELENG, BALI",5,145,9,154
https://kawalpemilu.org#53964,"JULAH, TEJAKULA, BULELENG, BALI",6,133,10,143
https://kawalpemilu.org#53964,"JULAH, TEJAKULA, BULELENG, BALI",7,141,11,152
https://kawalpemilu.org#53964,"JULAH, TEJAKULA, BULELENG, BALI",8,137,5,142
https://kawalpemilu.org#53964,"JULAH, TEJAKULA, BULELENG, BALI",9,98,68,166
https://kawalpemilu.org#53964,"JULAH, TEJAKULA, BULELENG, BALI",10,115,40,155
https://kawalpemilu.org#53964,"JULAH, TEJAKULA, BULELENG, BALI",11,81,80,161
https://kawalpemilu.org#53964,"JULAH, TEJAKULA, BULELENG, BALI",12,112,49,161
https://kawalpemilu.org#53965,"MADENAN, TEJAKULA, BULELENG, BALI",1,152,28,180
https://kawalpemilu.org#53965,"MADENAN, TEJAKULA, BULELENG, BALI",2,165,7,172
https://kawalpemilu.org#53965,"MADENAN, TEJAKULA, BULELENG, BALI",3,169,9,178
https://kawalpemilu.org#53965,"MADENAN, TEJAKULA, BULELENG, BALI",4,160,11,171
https://kawalpemilu.org#53965,"MADENAN, TEJAKULA, BULELENG, BALI",5,141,3,144
https://kawalpemilu.org#53965,"MADENAN, TEJAKULA, BULELENG, BALI",6,164,9,173
https://kawalpemilu.org#53965,"MADENAN, TEJAKULA, BULELENG, BALI",7,208,4,212
https://kawalpemilu.org#53965,"MADENAN, TEJAKULA, BULELENG, BALI",8,178,9,187
https://kawalpemilu.org#53965,"MADENAN, TEJAKULA, BULELENG, BALI",9,159,3,162
https://kawalpemilu.org#53965,"MADENAN, TEJAKULA, BULELENG, BALI",10,145,0,145
https://kawalpemilu.org#53965,"MADENAN, TEJAKULA, BULELENG, BALI",11,172,3,175
https://kawalpemilu.org#53965,"MADENAN, TEJAKULA, BULELENG, BALI",12,178,3,181
https://kawalpemilu.org#53965,"MADENAN, TEJAKULA, BULELENG, BALI",13,171,8,179
https://kawalpemilu.org#53965,"MADENAN, TEJAKULA, BULELENG, BALI",14,179,0,179
https://kawalpemilu.org#53965,"MADENAN, TEJAKULA, BULELENG, BALI",15,200,2,202
https://kawalpemilu.org#53965,"MADENAN, TEJAKULA, BULELENG, BALI",16,215,4,219
https://kawalpemilu.org#53966,"BONDALEM, TEJAKULA, BULELENG, BALI",1,156,1,157
https://kawalpemilu.org#53966,"BONDALEM, TEJAKULA, BULELENG, BALI",2,157,4,161
https://kawalpemilu.org#53966,"BONDALEM, TEJAKULA, BULELENG, BALI",4,152,2,154
https://kawalpemilu.org#53966,"BONDALEM, TEJAKULA, BULELENG, BALI",5,163,4,167
https://kawalpemilu.org#53966,"BONDALEM, TEJAKULA, BULELENG, BALI",6,174,5,179
https://kawalpemilu.org#53966,"BONDALEM, TEJAKULA, BULELENG, BALI",7,145,2,147
https://kawalpemilu.org#53966,"BONDALEM, TEJAKULA, BULELENG, BALI",8,144,3,147
https://kawalpemilu.org#53966,"BONDALEM, TEJAKULA, BULELENG, BALI",10,135,1,136
https://kawalpemilu.org#53966,"BONDALEM, TEJAKULA, BULELENG, BALI",11,153,1,154
https://kawalpemilu.org#53966,"BONDALEM, TEJAKULA, BULELENG, BALI",12,140,1,141
https://kawalpemilu.org#53966,"BONDALEM, TEJAKULA, BULELENG, BALI",13,167,2,169
https://kawalpemilu.org#53966,"BONDALEM, TEJAKULA, BULELENG, BALI",14,173,1,174
https://kawalpemilu.org#53966,"BONDALEM, TEJAKULA, BULELENG, BALI",15,150,0,150
https://kawalpemilu.org#53966,"BONDALEM, TEJAKULA, BULELENG, BALI",16,157,3,160
https://kawalpemilu.org#53966,"BONDALEM, TEJAKULA, BULELENG, BALI",17,190,2,192
https://kawalpemilu.org#53966,"BONDALEM, TEJAKULA, BULELENG, BALI",18,167,2,169
https://kawalpemilu.org#53966,"BONDALEM, TEJAKULA, BULELENG, BALI",19,184,1,185
https://kawalpemilu.org#53966,"BONDALEM, TEJAKULA, BULELENG, BALI",20,170,2,172
https://kawalpemilu.org#53966,"BONDALEM, TEJAKULA, BULELENG, BALI",21,176,3,179
https://kawalpemilu.org#53966,"BONDALEM, TEJAKULA, BULELENG, BALI",22,184,1,185
https://kawalpemilu.org#53966,"BONDALEM, TEJAKULA, BULELENG, BALI",23,159,10,169
https://kawalpemilu.org#53966,"BONDALEM, TEJAKULA, BULELENG, BALI",24,175,1,176
https://kawalpemilu.org#53966,"BONDALEM, TEJAKULA, BULELENG, BALI",25,156,5,161
https://kawalpemilu.org#53966,"BONDALEM, TEJAKULA, BULELENG, BALI",26,169,2,171
https://kawalpemilu.org#53966,"BONDALEM, TEJAKULA, BULELENG, BALI",27,141,3,144
https://kawalpemilu.org#53966,"BONDALEM, TEJAKULA, BULELENG, BALI",28,129,0,129
https://kawalpemilu.org#53966,"BONDALEM, TEJAKULA, BULELENG, BALI",29,148,2,150
https://kawalpemilu.org#53966,"BONDALEM, TEJAKULA, BULELENG, BALI",30,165,3,168
https://kawalpemilu.org#53966,"BONDALEM, TEJAKULA, BULELENG, BALI",31,127,1,128
https://kawalpemilu.org#53966,"BONDALEM, TEJAKULA, BULELENG, BALI",32,156,3,159
https://kawalpemilu.org#53966,"BONDALEM, TEJAKULA, BULELENG, BALI",33,134,0,134
https://kawalpemilu.org#53966,"BONDALEM, TEJAKULA, BULELENG, BALI",34,145,4,149
https://kawalpemilu.org#53966,"BONDALEM, TEJAKULA, BULELENG, BALI",35,142,4,146
https://kawalpemilu.org#53966,"BONDALEM, TEJAKULA, BULELENG, BALI",36,162,2,164
https://kawalpemilu.org#53966,"BONDALEM, TEJAKULA, BULELENG, BALI",37,141,1,142
https://kawalpemilu.org#53966,"BONDALEM, TEJAKULA, BULELENG, BALI",38,127,4,131
https://kawalpemilu.org#53966,"BONDALEM, TEJAKULA, BULELENG, BALI",39,148,3,151
https://kawalpemilu.org#53966,"BONDALEM, TEJAKULA, BULELENG, BALI",40,93,4,97
https://kawalpemilu.org#53966,"BONDALEM, TEJAKULA, BULELENG, BALI",41,56,1,57
https://kawalpemilu.org#53966,"BONDALEM, TEJAKULA, BULELENG, BALI",42,129,7,136
https://kawalpemilu.org#53966,"BONDALEM, TEJAKULA, BULELENG, BALI",43,128,3,131
https://kawalpemilu.org#53966,"BONDALEM, TEJAKULA, BULELENG, BALI",44,123,0,123
https://kawalpemilu.org#53967,"TEJAKULA, TEJAKULA, BULELENG, BALI",1,160,0,160
https://kawalpemilu.org#53967,"TEJAKULA, TEJAKULA, BULELENG, BALI",2,148,3,151
https://kawalpemilu.org#53967,"TEJAKULA, TEJAKULA, BULELENG, BALI",3,140,4,144
https://kawalpemilu.org#53967,"TEJAKULA, TEJAKULA, BULELENG, BALI",4,156,1,157
https://kawalpemilu.org#53967,"TEJAKULA, TEJAKULA, BULELENG, BALI",5,149,5,154
https://kawalpemilu.org#53967,"TEJAKULA, TEJAKULA, BULELENG, BALI",6,163,2,165
https://kawalpemilu.org#53967,"TEJAKULA, TEJAKULA, BULELENG, BALI",7,149,4,153
https://kawalpemilu.org#53967,"TEJAKULA, TEJAKULA, BULELENG, BALI",8,130,3,133
https://kawalpemilu.org#53967,"TEJAKULA, TEJAKULA, BULELENG, BALI",9,145,8,153
https://kawalpemilu.org#53967,"TEJAKULA, TEJAKULA, BULELENG, BALI",10,154,5,159
https://kawalpemilu.org#53967,"TEJAKULA, TEJAKULA, BULELENG, BALI",11,168,16,184
https://kawalpemilu.org#53967,"TEJAKULA, TEJAKULA, BULELENG, BALI",12,186,6,192
https://kawalpemilu.org#53967,"TEJAKULA, TEJAKULA, BULELENG, BALI",13,214,6,220
https://kawalpemilu.org#53967,"TEJAKULA, TEJAKULA, BULELENG, BALI",14,210,8,218
https://kawalpemilu.org#53967,"TEJAKULA, TEJAKULA, BULELENG, BALI",15,177,12,189
https://kawalpemilu.org#53967,"TEJAKULA, TEJAKULA, BULELENG, BALI",16,156,6,162
https://kawalpemilu.org#53967,"TEJAKULA, TEJAKULA, BULELENG, BALI",17,186,7,193
https://kawalpemilu.org#53967,"TEJAKULA, TEJAKULA, BULELENG, BALI",18,181,9,190
https://kawalpemilu.org#53967,"TEJAKULA, TEJAKULA, BULELENG, BALI",19,164,4,174
https://kawalpemilu.org#53967,"TEJAKULA, TEJAKULA, BULELENG, BALI",20,171,5,176
https://kawalpemilu.org#53967,"TEJAKULA, TEJAKULA, BULELENG, BALI",21,143,4,147
https://kawalpemilu.org#53967,"TEJAKULA, TEJAKULA, BULELENG, BALI",22,204,4,208
https://kawalpemilu.org#53967,"TEJAKULA, TEJAKULA, BULELENG, BALI",23,212,6,218
https://kawalpemilu.org#53967,"TEJAKULA, TEJAKULA, BULELENG, BALI",24,215,4,219
https://kawalpemilu.org#53967,"TEJAKULA, TEJAKULA, BULELENG, BALI",25,194,2,196
https://kawalpemilu.org#53967,"TEJAKULA, TEJAKULA, BULELENG, BALI",26,209,9,218
https://kawalpemilu.org#53967,"TEJAKULA, TEJAKULA, BULELENG, BALI",27,187,7,194
https://kawalpemilu.org#53967,"TEJAKULA, TEJAKULA, BULELENG, BALI",28,175,8,183
https://kawalpemilu.org#53967,"TEJAKULA, TEJAKULA, BULELENG, BALI",29,187,5,192
https://kawalpemilu.org#53967,"TEJAKULA, TEJAKULA, BULELENG, BALI",30,149,6,155
https://kawalpemilu.org#53967,"TEJAKULA, TEJAKULA, BULELENG, BALI",31,161,6,167
https://kawalpemilu.org#53967,"TEJAKULA, TEJAKULA, BULELENG, BALI",32,153,8,161
https://kawalpemilu.org#53967,"TEJAKULA, TEJAKULA, BULELENG, BALI",33,148,2,150
https://kawalpemilu.org#53967,"TEJAKULA, TEJAKULA, BULELENG, BALI",34,183,7,190
https://kawalpemilu.org#53967,"TEJAKULA, TEJAKULA, BULELENG, BALI",35,193,10,203
https://kawalpemilu.org#53967,"TEJAKULA, TEJAKULA, BULELENG, BALI",36,208,2,210
https://kawalpemilu.org#53967,"TEJAKULA, TEJAKULA, BULELENG, BALI",37,187,7,194
https://kawalpemilu.org#53967,"TEJAKULA, TEJAKULA, BULELENG, BALI",38,175,7,182
https://kawalpemilu.org#53967,"TEJAKULA, TEJAKULA, BULELENG, BALI",39,171,8,179
https://kawalpemilu.org#53968,"LES, TEJAKULA, BULELENG, BALI",1,170,1,171
https://kawalpemilu.org#53968,"LES, TEJAKULA, BULELENG, BALI",2,160,1,161
https://kawalpemilu.org#53968,"LES, TEJAKULA, BULELENG, BALI",3,192,4,196
https://kawalpemilu.org#53968,"LES, TEJAKULA, BULELENG, BALI",4,179,6,185
https://kawalpemilu.org#53968,"LES, TEJAKULA, BULELENG, BALI",5,153,10,163
https://kawalpemilu.org#53968,"LES, TEJAKULA, BULELENG, BALI",6,180,8,188
https://kawalpemilu.org#53968,"LES, TEJAKULA, BULELENG, BALI",7,202,10,212
https://kawalpemilu.org#53968,"LES, TEJAKULA, BULELENG, BALI",8,194,5,199
https://kawalpemilu.org#53968,"LES, TEJAKULA, BULELENG, BALI",9,0,0,0
https://kawalpemilu.org#53968,"LES, TEJAKULA, BULELENG, BALI",10,192,12,204
https://kawalpemilu.org#53968,"LES, TEJAKULA, BULELENG, BALI",11,181,6,187
https://kawalpemilu.org#53968,"LES, TEJAKULA, BULELENG, BALI",12,212,3,215
https://kawalpemilu.org#53968,"LES, TEJAKULA, BULELENG, BALI",13,207,5,212
https://kawalpemilu.org#53968,"LES, TEJAKULA, BULELENG, BALI",14,200,3,203
https://kawalpemilu.org#53968,"LES, TEJAKULA, BULELENG, BALI",15,219,15,234
https://kawalpemilu.org#53968,"LES, TEJAKULA, BULELENG, BALI",16,223,9,232
https://kawalpemilu.org#53968,"LES, TEJAKULA, BULELENG, BALI",17,227,2,229
https://kawalpemilu.org#53968,"LES, TEJAKULA, BULELENG, BALI",18,218,2,220
https://kawalpemilu.org#53968,"LES, TEJAKULA, BULELENG, BALI",19,203,1,204
https://kawalpemilu.org#53968,"LES, TEJAKULA, BULELENG, BALI",20,200,6,206
https://kawalpemilu.org#53968,"LES, TEJAKULA, BULELENG, BALI",21,208,5,213
https://kawalpemilu.org#53968,"LES, TEJAKULA, BULELENG, BALI",22,170,2,172
https://kawalpemilu.org#53968,"LES, TEJAKULA, BULELENG, BALI",23,170,2,172
https://kawalpemilu.org#53968,"LES, TEJAKULA, BULELENG, BALI",24,160,0,160
https://kawalpemilu.org#53969,"PENUKTUKAN, TEJAKULA, BULELENG, BALI",1,202,6,208
https://kawalpemilu.org#53969,"PENUKTUKAN, TEJAKULA, BULELENG, BALI",2,217,8,225
https://kawalpemilu.org#53969,"PENUKTUKAN, TEJAKULA, BULELENG, BALI",3,214,7,221
https://kawalpemilu.org#53969,"PENUKTUKAN, TEJAKULA, BULELENG, BALI",4,216,8,224
https://kawalpemilu.org#53969,"PENUKTUKAN, TEJAKULA, BULELENG, BALI",5,176,4,180
https://kawalpemilu.org#53969,"PENUKTUKAN, TEJAKULA, BULELENG, BALI",6,205,7,212
https://kawalpemilu.org#53969,"PENUKTUKAN, TEJAKULA, BULELENG, BALI",7,193,0,193
https://kawalpemilu.org#53969,"PENUKTUKAN, TEJAKULA, BULELENG, BALI",8,169,4,173
https://kawalpemilu.org#53969,"PENUKTUKAN, TEJAKULA, BULELENG, BALI",9,207,10,217
https://kawalpemilu.org#53969,"PENUKTUKAN, TEJAKULA, BULELENG, BALI",10,184,8,192
https://kawalpemilu.org#53969,"PENUKTUKAN, TEJAKULA, BULELENG, BALI",11,226,7,233
https://kawalpemilu.org#53969,"PENUKTUKAN, TEJAKULA, BULELENG, BALI",12,212,10,222
https://kawalpemilu.org#53969,"PENUKTUKAN, TEJAKULA, BULELENG, BALI",13,216,2,218
https://kawalpemilu.org#53969,"PENUKTUKAN, TEJAKULA, BULELENG, BALI",14,212,3,215
https://kawalpemilu.org#53970,"SAMBIRENTENG, TEJAKULA, BULELENG, BALI",1,193,10,203
https://kawalpemilu.org#53970,"SAMBIRENTENG, TEJAKULA, BULELENG, BALI",2,195,7,202
https://kawalpemilu.org#53970,"SAMBIRENTENG, TEJAKULA, BULELENG, BALI",3,188,2,190
https://kawalpemilu.org#53970,"SAMBIRENTENG, TEJAKULA, BULELENG, BALI",4,183,4,187
https://kawalpemilu.org#53970,"SAMBIRENTENG, TEJAKULA, BULELENG, BALI",5,215,9,224
https://kawalpemilu.org#53970,"SAMBIRENTENG, TEJAKULA, BULELENG, BALI",6,194,11,205
https://kawalpemilu.org#53970,"SAMBIRENTENG, TEJAKULA, BULELENG, BALI",7,196,5,201
https://kawalpemilu.org#53970,"SAMBIRENTENG, TEJAKULA, BULELENG, BALI",8,201,8,209
https://kawalpemilu.org#53970,"SAMBIRENTENG, TEJAKULA, BULELENG, BALI",9,185,7,192
https://kawalpemilu.org#53970,"SAMBIRENTENG, TEJAKULA, BULELENG, BALI",10,229,6,235
https://kawalpemilu.org#53970,"SAMBIRENTENG, TEJAKULA, BULELENG, BALI",11,192,1,193
https://kawalpemilu.org#53970,"SAMBIRENTENG, TEJAKULA, BULELENG, BALI",12,199,1,200
https://kawalpemilu.org#53970,"SAMBIRENTENG, TEJAKULA, BULELENG, BALI",13,182,3,185
https://kawalpemilu.org#53970,"SAMBIRENTENG, TEJAKULA, BULELENG, BALI",14,170,9,179
https://kawalpemilu.org#53971,"TEMBOK, TEJAKULA, BULELENG, BALI",1,185,5,190
https://kawalpemilu.org#53971,"TEMBOK, TEJAKULA, BULELENG, BALI",2,205,3,208
https://kawalpemilu.org#53971,"TEMBOK, TEJAKULA, BULELENG, BALI",3,214,2,216
https://kawalpemilu.org#53971,"TEMBOK, TEJAKULA, BULELENG, BALI",4,202,5,207
https://kawalpemilu.org#53971,"TEMBOK, TEJAKULA, BULELENG, BALI",5,218,4,222
https://kawalpemilu.org#53971,"TEMBOK, TEJAKULA, BULELENG, BALI",6,198,2,200
https://kawalpemilu.org#53971,"TEMBOK, TEJAKULA, BULELENG, BALI",7,245,8,253
https://kawalpemilu.org#53971,"TEMBOK, TEJAKULA, BULELENG, BALI",8,225,4,229
https://kawalpemilu.org#53971,"TEMBOK, TEJAKULA, BULELENG, BALI",9,238,18,256
https://kawalpemilu.org#53971,"TEMBOK, TEJAKULA, BULELENG, BALI",10,201,9,210
https://kawalpemilu.org#53971,"TEMBOK, TEJAKULA, BULELENG, BALI",11,175,60,235
https://kawalpemilu.org#53971,"TEMBOK, TEJAKULA, BULELENG, BALI",12,178,68,246
https://kawalpemilu.org#53971,"TEMBOK, TEJAKULA, BULELENG, BALI",13,252,21,273
https://kawalpemilu.org#53971,"TEMBOK, TEJAKULA, BULELENG, BALI",14,248,16,264
https://kawalpemilu.org#53971,"TEMBOK, TEJAKULA, BULELENG, BALI",15,285,1,286
https://kawalpemilu.org#53971,"TEMBOK, TEJAKULA, BULELENG, BALI",16,285,1,286
https://kawalpemilu.org#53971,"TEMBOK, TEJAKULA, BULELENG, BALI",17,230,9,239
https://kawalpemilu.org#53971,"TEMBOK, TEJAKULA, BULELENG, BALI",18,231,4,235
https://kawalpemilu.org#53971,"TEMBOK, TEJAKULA, BULELENG, BALI",19,213,35,248
https://kawalpemilu.org#53974,"SERANGAN, DENPASAR SELATAN, KOTA DENPASAR, BALI",1,224,24,248
https://kawalpemilu.org#53974,"SERANGAN, DENPASAR SELATAN, KOTA DENPASAR, BALI",2,226,13,239
https://kawalpemilu.org#53974,"SERANGAN, DENPASAR SELATAN, KOTA DENPASAR, BALI",3,211,8,219
https://kawalpemilu.org#53974,"SERANGAN, DENPASAR SELATAN, KOTA DENPASAR, BALI",4,228,29,257
https://kawalpemilu.org#53974,"SERANGAN, DENPASAR SELATAN, KOTA DENPASAR, BALI",5,232,31,263
https://kawalpemilu.org#53974,"SERANGAN, DENPASAR SELATAN, KOTA DENPASAR, BALI",6,210,0,210
https://kawalpemilu.org#53974,"SERANGAN, DENPASAR SELATAN, KOTA DENPASAR, BALI",7,217,3,220
https://kawalpemilu.org#53974,"SERANGAN, DENPASAR SELATAN, KOTA DENPASAR, BALI",8,226,20,246
https://kawalpemilu.org#53974,"SERANGAN, DENPASAR SELATAN, KOTA DENPASAR, BALI",9,202,12,214
https://kawalpemilu.org#53974,"SERANGAN, DENPASAR SELATAN, KOTA DENPASAR, BALI",10,255,4,259
https://kawalpemilu.org#53974,"SERANGAN, DENPASAR SELATAN, KOTA DENPASAR, BALI",11,52,191,243
https://kawalpemilu.org#53975,"PEDUNGAN, DENPASAR SELATAN, KOTA DENPASAR, BALI",1,190,15,205
https://kawalpemilu.org#53975,"PEDUNGAN, DENPASAR SELATAN, KOTA DENPASAR, BALI",2,164,33,197
https://kawalpemilu.org#53975,"PEDUNGAN, DENPASAR SELATAN, KOTA DENPASAR, BALI",3,184,21,205
https://kawalpemilu.org#53975,"PEDUNGAN, DENPASAR SELATAN, KOTA DENPASAR, BALI",4,198,24,222
https://kawalpemilu.org#53975,"PEDUNGAN, DENPASAR SELATAN, KOTA DENPASAR, BALI",5,245,18,263
https://kawalpemilu.org#53975,"PEDUNGAN, DENPASAR SELATAN, KOTA DENPASAR, BALI",6,223,20,243
https://kawalpemilu.org#53975,"PEDUNGAN, DENPASAR SELATAN, KOTA DENPASAR, BALI",7,247,17,264
https://kawalpemilu.org#53975,"PEDUNGAN, DENPASAR SELATAN, KOTA DENPASAR, BALI",8,211,24,235
https://kawalpemilu.org#53975,"PEDUNGAN, DENPASAR SELATAN, KOTA DENPASAR, BALI",9,227,17,244
https://kawalpemilu.org#53975,"PEDUNGAN, DENPASAR SELATAN, KOTA DENPASAR, BALI",10,210,19,229
https://kawalpemilu.org#53975,"PEDUNGAN, DENPASAR SELATAN, KOTA DENPASAR, BALI",11,219,15,234
https://kawalpemilu.org#53975,"PEDUNGAN, DENPASAR SELATAN, KOTA DENPASAR, BALI",12,251,16,267
https://kawalpemilu.org#53975,"PEDUNGAN, DENPASAR SELATAN, KOTA DENPASAR, BALI",13,206,37,243
https://kawalpemilu.org#53975,"PEDUNGAN, DENPASAR SELATAN, KOTA DENPASAR, BALI",14,233,19,252
https://kawalpemilu.org#53975,"PEDUNGAN, DENPASAR SELATAN, KOTA DENPASAR, BALI",15,183,19,202
https://kawalpemilu.org#53975,"PEDUNGAN, DENPASAR SELATAN, KOTA DENPASAR, BALI",16,206,22,228
https://kawalpemilu.org#53975,"PEDUNGAN, DENPASAR SELATAN, KOTA DENPASAR, BALI",17,209,17,226
https://kawalpemilu.org#53975,"PEDUNGAN, DENPASAR SELATAN, KOTA DENPASAR, BALI",18,201,15,216
https://kawalpemilu.org#53975,"PEDUNGAN, DENPASAR SELATAN, KOTA DENPASAR, BALI",19,198,25,223
https://kawalpemilu.org#53975,"PEDUNGAN, DENPASAR SELATAN, KOTA DENPASAR, BALI",20,213,18,231
https://kawalpemilu.org#53975,"PEDUNGAN, DENPASAR SELATAN, KOTA DENPASAR, BALI",21,203,24,227
https://kawalpemilu.org#53975,"PEDUNGAN, DENPASAR SELATAN, KOTA DENPASAR, BALI",22,193,19,212
https://kawalpemilu.org#53975,"PEDUNGAN, DENPASAR SELATAN, KOTA DENPASAR, BALI",23,226,15,241
https://kawalpemilu.org#53975,"PEDUNGAN, DENPASAR SELATAN, KOTA DENPASAR, BALI",24,229,13,242
https://kawalpemilu.org#53975,"PEDUNGAN, DENPASAR SELATAN, KOTA DENPASAR, BALI",25,216,22,238
https://kawalpemilu.org#53975,"PEDUNGAN, DENPASAR SELATAN, KOTA DENPASAR, BALI",26,226,14,240
https://kawalpemilu.org#53975,"PEDUNGAN, DENPASAR SELATAN, KOTA DENPASAR, BALI",27,210,20,230
https://kawalpemilu.org#53975,"PEDUNGAN, DENPASAR SELATAN, KOTA DENPASAR, BALI",28,254,6,260
https://kawalpemilu.org#53975,"PEDUNGAN, DENPASAR SELATAN, KOTA DENPASAR, BALI",29,251,4,255
https://kawalpemilu.org#53975,"PEDUNGAN, DENPASAR SELATAN, KOTA DENPASAR, BALI",30,241,12,253
https://kawalpemilu.org#53975,"PEDUNGAN, DENPASAR SELATAN, KOTA DENPASAR, BALI",31,218,14,232
https://kawalpemilu.org#53975,"PEDUNGAN, DENPASAR SELATAN, KOTA DENPASAR, BALI",32,237,8,245
https://kawalpemilu.org#53975,"PEDUNGAN, DENPASAR SELATAN, KOTA DENPASAR, BALI",33,238,8,246
https://kawalpemilu.org#53975,"PEDUNGAN, DENPASAR SELATAN, KOTA DENPASAR, BALI",34,213,11,224
https://kawalpemilu.org#53975,"PEDUNGAN, DENPASAR SELATAN, KOTA DENPASAR, BALI",35,215,12,227
https://kawalpemilu.org#53975,"PEDUNGAN, DENPASAR SELATAN, KOTA DENPASAR, BALI",36,208,11,219
https://kawalpemilu.org#53975,"PEDUNGAN, DENPASAR SELATAN, KOTA DENPASAR, BALI",37,205,14,219
https://kawalpemilu.org#53975,"PEDUNGAN, DENPASAR SELATAN, KOTA DENPASAR, BALI",38,215,12,227
https://kawalpemilu.org#53975,"PEDUNGAN, DENPASAR SELATAN, KOTA DENPASAR, BALI",39,236,13,249
https://kawalpemilu.org#53975,"PEDUNGAN, DENPASAR SELATAN, KOTA DENPASAR, BALI",40,216,9,225
https://kawalpemilu.org#53975,"PEDUNGAN, DENPASAR SELATAN, KOTA DENPASAR, BALI",41,194,16,210
https://kawalpemilu.org#53975,"PEDUNGAN, DENPASAR SELATAN, KOTA DENPASAR, BALI",42,244,6,250
https://kawalpemilu.org#53975,"PEDUNGAN, DENPASAR SELATAN, KOTA DENPASAR, BALI",43,250,17,267
https://kawalpemilu.org#53975,"PEDUNGAN, DENPASAR SELATAN, KOTA DENPASAR, BALI",44,209,21,230
https://kawalpemilu.org#53975,"PEDUNGAN, DENPASAR SELATAN, KOTA DENPASAR, BALI",45,226,12,238
https://kawalpemilu.org#53975,"PEDUNGAN, DENPASAR SELATAN, KOTA DENPASAR, BALI",46,199,16,215
https://kawalpemilu.org#53975,"PEDUNGAN, DENPASAR SELATAN, KOTA DENPASAR, BALI",47,203,21,224
https://kawalpemilu.org#53975,"PEDUNGAN, DENPASAR SELATAN, KOTA DENPASAR, BALI",48,168,12,180
https://kawalpemilu.org#53975,"PEDUNGAN, DENPASAR SELATAN, KOTA DENPASAR, BALI",49,210,17,227
https://kawalpemilu.org#53975,"PEDUNGAN, DENPASAR SELATAN, KOTA DENPASAR, BALI",50,196,29,225
https://kawalpemilu.org#53975,"PEDUNGAN, DENPASAR SELATAN, KOTA DENPASAR, BALI",51,177,36,213
https://kawalpemilu.org#53975,"PEDUNGAN, DENPASAR SELATAN, KOTA DENPASAR, BALI",52,148,26,174
https://kawalpemilu.org#53975,"PEDUNGAN, DENPASAR SELATAN, KOTA DENPASAR, BALI",53,185,14,199
https://kawalpemilu.org#53975,"PEDUNGAN, DENPASAR SELATAN, KOTA DENPASAR, BALI",54,177,24,201
https://kawalpemilu.org#53975,"PEDUNGAN, DENPASAR SELATAN, KOTA DENPASAR, BALI",55,183,24,207
https://kawalpemilu.org#53975,"PEDUNGAN, DENPASAR SELATAN, KOTA DENPASAR, BALI",56,199,13,212
https://kawalpemilu.org#53975,"PEDUNGAN, DENPASAR SELATAN, KOTA DENPASAR, BALI",57,165,24,189
https://kawalpemilu.org#53975,"PEDUNGAN, DENPASAR SELATAN, KOTA DENPASAR, BALI",58,206,16,222
https://kawalpemilu.org#53975,"PEDUNGAN, DENPASAR SELATAN, KOTA DENPASAR, BALI",59,218,11,229
https://kawalpemilu.org#53975,"PEDUNGAN, DENPASAR SELATAN, KOTA DENPASAR, BALI",60,202,17,219
https://kawalpemilu.org#53975,"PEDUNGAN, DENPASAR SELATAN, KOTA DENPASAR, BALI",61,211,15,226
https://kawalpemilu.org#53975,"PEDUNGAN, DENPASAR SELATAN, KOTA DENPASAR, BALI",62,152,25,177
https://kawalpemilu.org#53975,"PEDUNGAN, DENPASAR SELATAN, KOTA DENPASAR, BALI",63,242,26,268
https://kawalpemilu.org#53975,"PEDUNGAN, DENPASAR SELATAN, KOTA DENPASAR, BALI",64,249,17,266
https://kawalpemilu.org#53975,"PEDUNGAN, DENPASAR SELATAN, KOTA DENPASAR, BALI",65,179,13,192
https://kawalpemilu.org#53975,"PEDUNGAN, DENPASAR SELATAN, KOTA DENPASAR, BALI",66,173,23,196
https://kawalpemilu.org#53976,"SESETAN, DENPASAR SELATAN, KOTA DENPASAR, BALI",1,246,39,285
https://kawalpemilu.org#53976,"SESETAN, DENPASAR SELATAN, KOTA DENPASAR, BALI",2,215,12,227
https://kawalpemilu.org#53976,"SESETAN, DENPASAR SELATAN, KOTA DENPASAR, BALI",3,224,12,236
https://kawalpemilu.org#53976,"SESETAN, DENPASAR SELATAN, KOTA DENPASAR, BALI",4,229,15,244
https://kawalpemilu.org#53976,"SESETAN, DENPASAR SELATAN, KOTA DENPASAR, BALI",5,258,13,271
https://kawalpemilu.org#53976,"SESETAN, DENPASAR SELATAN, KOTA DENPASAR, BALI",6,222,27,249
https://kawalpemilu.org#53976,"SESETAN, DENPASAR SELATAN, KOTA DENPASAR, BALI",7,243,29,272
https://kawalpemilu.org#53976,"SESETAN, DENPASAR SELATAN, KOTA DENPASAR, BALI",8,241,15,256
https://kawalpemilu.org#53976,"SESETAN, DENPASAR SELATAN, KOTA DENPASAR, BALI",9,201,18,219
https://kawalpemilu.org#53976,"SESETAN, DENPASAR SELATAN, KOTA DENPASAR, BALI",10,205,15,220
https://kawalpemilu.org#53976,"SESETAN, DENPASAR SELATAN, KOTA DENPASAR, BALI",11,208,16,224
https://kawalpemilu.org#53976,"SESETAN, DENPASAR SELATAN, KOTA DENPASAR, BALI",12,199,20,219
https://kawalpemilu.org#53976,"SESETAN, DENPASAR SELATAN, KOTA DENPASAR, BALI",13,222,23,245
https://kawalpemilu.org#53976,"SESETAN, DENPASAR SELATAN, KOTA DENPASAR, BALI",14,212,22,234
https://kawalpemilu.org#53976,"SESETAN, DENPASAR SELATAN, KOTA DENPASAR, BALI",15,206,28,234
https://kawalpemilu.org#53976,"SESETAN, DENPASAR SELATAN, KOTA DENPASAR, BALI",16,243,23,266
https://kawalpemilu.org#53976,"SESETAN, DENPASAR SELATAN, KOTA DENPASAR, BALI",17,210,29,239
https://kawalpemilu.org#53976,"SESETAN, DENPASAR SELATAN, KOTA DENPASAR, BALI",18,216,28,244
https://kawalpemilu.org#53976,"SESETAN, DENPASAR SELATAN, KOTA DENPASAR, BALI",19,217,16,233
https://kawalpemilu.org#53976,"SESETAN, DENPASAR SELATAN, KOTA DENPASAR, BALI",20,220,23,243
https://kawalpemilu.org#53976,"SESETAN, DENPASAR SELATAN, KOTA DENPASAR, BALI",21,236,28,264
https://kawalpemilu.org#53976,"SESETAN, DENPASAR SELATAN, KOTA DENPASAR, BALI",22,211,28,239
https://kawalpemilu.org#53976,"SESETAN, DENPASAR SELATAN, KOTA DENPASAR, BALI",23,151,41,192
https://kawalpemilu.org#53976,"SESETAN, DENPASAR SELATAN, KOTA DENPASAR, BALI",24,201,29,230
https://kawalpemilu.org#53976,"SESETAN, DENPASAR SELATAN, KOTA DENPASAR, BALI",25,215,18,233
https://kawalpemilu.org#53976,"SESETAN, DENPASAR SELATAN, KOTA DENPASAR, BALI",26,217,14,231
https://kawalpemilu.org#53976,"SESETAN, DENPASAR SELATAN, KOTA DENPASAR, BALI",27,216,25,241
https://kawalpemilu.org#53976,"SESETAN, DENPASAR SELATAN, KOTA DENPASAR, BALI",28,193,31,224
https://kawalpemilu.org#53976,"SESETAN, DENPASAR SELATAN, KOTA DENPASAR, BALI",29,176,12,188
https://kawalpemilu.org#53976,"SESETAN, DENPASAR SELATAN, KOTA DENPASAR, BALI",30,163,16,179
https://kawalpemilu.org#53976,"SESETAN, DENPASAR SELATAN, KOTA DENPASAR, BALI",31,177,13,190
https://kawalpemilu.org#53976,"SESETAN, DENPASAR SELATAN, KOTA DENPASAR, BALI",32,174,15,189
https://kawalpemilu.org#53976,"SESETAN, DENPASAR SELATAN, KOTA DENPASAR, BALI",33,206,14,220
https://kawalpemilu.org#53976,"SESETAN, DENPASAR SELATAN, KOTA DENPASAR, BALI",34,195,18,213
https://kawalpemilu.org#53976,"SESETAN, DENPASAR SELATAN, KOTA DENPASAR, BALI",35,197,17,214
https://kawalpemilu.org#53976,"SESETAN, DENPASAR SELATAN, KOTA DENPASAR, BALI",36,187,24,211
https://kawalpemilu.org#53976,"SESETAN, DENPASAR SELATAN, KOTA DENPASAR, BALI",37,159,21,180
https://kawalpemilu.org#53976,"SESETAN, DENPASAR SELATAN, KOTA DENPASAR, BALI",38,174,19,193
https://kawalpemilu.org#53976,"SESETAN, DENPASAR SELATAN, KOTA DENPASAR, BALI",39,225,7,232
https://kawalpemilu.org#53976,"SESETAN, DENPASAR SELATAN, KOTA DENPASAR, BALI",40,208,8,216
https://kawalpemilu.org#53976,"SESETAN, DENPASAR SELATAN, KOTA DENPASAR, BALI",41,202,12,214
https://kawalpemilu.org#53976,"SESETAN, DENPASAR SELATAN, KOTA DENPASAR, BALI",42,207,20,227
https://kawalpemilu.org#53976,"SESETAN, DENPASAR SELATAN, KOTA DENPASAR, BALI",43,204,12,216
https://kawalpemilu.org#53976,"SESETAN, DENPASAR SELATAN, KOTA DENPASAR, BALI",44,193,18,211
https://kawalpemilu.org#53976,"SESETAN, DENPASAR SELATAN, KOTA DENPASAR, BALI",45,210,10,220
https://kawalpemilu.org#53976,"SESETAN, DENPASAR SELATAN, KOTA DENPASAR, BALI",46,205,21,226
https://kawalpemilu.org#53976,"SESETAN, DENPASAR SELATAN, KOTA DENPASAR, BALI",47,198,17,215
https://kawalpemilu.org#53976,"SESETAN, DENPASAR SELATAN, KOTA DENPASAR, BALI",48,210,13,223
https://kawalpemilu.org#53976,"SESETAN, DENPASAR SELATAN, KOTA DENPASAR, BALI",49,209,18,227
https://kawalpemilu.org#53976,"SESETAN, DENPASAR SELATAN, KOTA DENPASAR, BALI",50,207,20,227
https://kawalpemilu.org#53976,"SESETAN, DENPASAR SELATAN, KOTA DENPASAR, BALI",51,206,12,218
https://kawalpemilu.org#53976,"SESETAN, DENPASAR SELATAN, KOTA DENPASAR, BALI",52,236,18,254
https://kawalpemilu.org#53976,"SESETAN, DENPASAR SELATAN, KOTA DENPASAR, BALI",53,231,8,239
https://kawalpemilu.org#53976,"SESETAN, DENPASAR SELATAN, KOTA DENPASAR, BALI",54,206,21,227
https://kawalpemilu.org#53976,"SESETAN, DENPASAR SELATAN, KOTA DENPASAR, BALI",55,198,16,214
https://kawalpemilu.org#53976,"SESETAN, DENPASAR SELATAN, KOTA DENPASAR, BALI",56,199,14,213
https://kawalpemilu.org#53976,"SESETAN, DENPASAR SELATAN, KOTA DENPASAR, BALI",57,221,16,237
https://kawalpemilu.org#53976,"SESETAN, DENPASAR SELATAN, KOTA DENPASAR, BALI",58,200,28,228
https://kawalpemilu.org#53976,"SESETAN, DENPASAR SELATAN, KOTA DENPASAR, BALI",59,228,29,257
https://kawalpemilu.org#53976,"SESETAN, DENPASAR SELATAN, KOTA DENPASAR, BALI",60,185,24,209
https://kawalpemilu.org#53976,"SESETAN, DENPASAR SELATAN, KOTA DENPASAR, BALI",61,251,15,266
https://kawalpemilu.org#53976,"SESETAN, DENPASAR SELATAN, KOTA DENPASAR, BALI",62,222,6,228
https://kawalpemilu.org#53976,"SESETAN, DENPASAR SELATAN, KOTA DENPASAR, BALI",63,203,42,245
https://kawalpemilu.org#53976,"SESETAN, DENPASAR SELATAN, KOTA DENPASAR, BALI",64,201,30,231
https://kawalpemilu.org#53976,"SESETAN, DENPASAR SELATAN, KOTA DENPASAR, BALI",65,159,29,188
https://kawalpemilu.org#53976,"SESETAN, DENPASAR SELATAN, KOTA DENPASAR, BALI",66,203,25,228
https://kawalpemilu.org#53976,"SESETAN, DENPASAR SELATAN, KOTA DENPASAR, BALI",67,207,18,215
https://kawalpemilu.org#53976,"SESETAN, DENPASAR SELATAN, KOTA DENPASAR, BALI",68,204,23,227
https://kawalpemilu.org#53976,"SESETAN, DENPASAR SELATAN, KOTA DENPASAR, BALI",69,204,51,255
https://kawalpemilu.org#53976,"SESETAN, DENPASAR SELATAN, KOTA DENPASAR, BALI",70,210,20,230
https://kawalpemilu.org#53976,"SESETAN, DENPASAR SELATAN, KOTA DENPASAR, BALI",71,211,23,234
https://kawalpemilu.org#53976,"SESETAN, DENPASAR SELATAN, KOTA DENPASAR, BALI",72,174,22,196
https://kawalpemilu.org#53976,"SESETAN, DENPASAR SELATAN, KOTA DENPASAR, BALI",73,134,27,161
https://kawalpemilu.org#53976,"SESETAN, DENPASAR SELATAN, KOTA DENPASAR, BALI",74,170,20,190
https://kawalpemilu.org#53976,"SESETAN, DENPASAR SELATAN, KOTA DENPASAR, BALI",75,149,20,169
https://kawalpemilu.org#53976,"SESETAN, DENPASAR SELATAN, KOTA DENPASAR, BALI",76,177,6,183
https://kawalpemilu.org#53976,"SESETAN, DENPASAR SELATAN, KOTA DENPASAR, BALI",77,186,5,191
https://kawalpemilu.org#53976,"SESETAN, DENPASAR SELATAN, KOTA DENPASAR, BALI",78,128,35,163
https://kawalpemilu.org#53976,"SESETAN, DENPASAR SELATAN, KOTA DENPASAR, BALI",79,125,40,165
https://kawalpemilu.org#53976,"SESETAN, DENPASAR SELATAN, KOTA DENPASAR, BALI",80,214,19,233
https://kawalpemilu.org#53976,"SESETAN, DENPASAR SELATAN, KOTA DENPASAR, BALI",81,158,34,192
https://kawalpemilu.org#53976,"SESETAN, DENPASAR SELATAN, KOTA DENPASAR, BALI",82,142,23,165
https://kawalpemilu.org#53976,"SESETAN, DENPASAR SELATAN, KOTA DENPASAR, BALI",83,153,23,176
https://kawalpemilu.org#53976,"SESETAN, DENPASAR SELATAN, KOTA DENPASAR, BALI",84,169,38,207
https://kawalpemilu.org#53976,"SESETAN, DENPASAR SELATAN, KOTA DENPASAR, BALI",85,147,23,166
https://kawalpemilu.org#53976,"SESETAN, DENPASAR SELATAN, KOTA DENPASAR, BALI",86,168,11,179
https://kawalpemilu.org#53976,"SESETAN, DENPASAR SELATAN, KOTA DENPASAR, BALI",87,107,15,122
https://kawalpemilu.org#53976,"SESETAN, DENPASAR SELATAN, KOTA DENPASAR, BALI",88,139,14,153
https://kawalpemilu.org#53976,"SESETAN, DENPASAR SELATAN, KOTA DENPASAR, BALI",89,164,7,171
https://kawalpemilu.org#53976,"SESETAN, DENPASAR SELATAN, KOTA DENPASAR, BALI",90,160,23,183
https://kawalpemilu.org#53976,"SESETAN, DENPASAR SELATAN, KOTA DENPASAR, BALI",91,100,21,121
https://kawalpemilu.org#53976,"SESETAN, DENPASAR SELATAN, KOTA DENPASAR, BALI",92,145,15,160
https://kawalpemilu.org#53976,"SESETAN, DENPASAR SELATAN, KOTA DENPASAR, BALI",93,103,25,128
https://kawalpemilu.org#53976,"SESETAN, DENPASAR SELATAN, KOTA DENPASAR, BALI",94,124,18,142
https://kawalpemilu.org#53976,"SESETAN, DENPASAR SELATAN, KOTA DENPASAR, BALI",95,157,22,179
https://kawalpemilu.org#53976,"SESETAN, DENPASAR SELATAN, KOTA DENPASAR, BALI",96,151,31,182
https://kawalpemilu.org#53976,"SESETAN, DENPASAR SELATAN, KOTA DENPASAR, BALI",97,131,11,142
https://kawalpemilu.org#53976,"SESETAN, DENPASAR SELATAN, KOTA DENPASAR, BALI",98,145,17,162
https://kawalpemilu.org#53976,"SESETAN, DENPASAR SELATAN, KOTA DENPASAR, BALI",99,149,26,175
https://kawalpemilu.org#53976,"SESETAN, DENPASAR SELATAN, KOTA DENPASAR, BALI",100,113,19,132
https://kawalpemilu.org#53976,"SESETAN, DENPASAR SELATAN, KOTA DENPASAR, BALI",101,163,30,193
https://kawalpemilu.org#53976,"SESETAN, DENPASAR SELATAN, KOTA DENPASAR, BALI",102,105,10,115
https://kawalpemilu.org#53976,"SESETAN, DENPASAR SELATAN, KOTA DENPASAR, BALI",103,99,13,112
https://kawalpemilu.org#53977,"PANJER, DENPASAR SELATAN, KOTA DENPASAR, BALI",1,179,21,200
https://kawalpemilu.org#53977,"PANJER, DENPASAR SELATAN, KOTA DENPASAR, BALI",2,220,15,235
https://kawalpemilu.org#53977,"PANJER, DENPASAR SELATAN, KOTA DENPASAR, BALI",3,208,10,218
https://kawalpemilu.org#53977,"PANJER, DENPASAR SELATAN, KOTA DENPASAR, BALI",4,190,10,200
https://kawalpemilu.org#53977,"PANJER, DENPASAR SELATAN, KOTA DENPASAR, BALI",6,184,26,210
https://kawalpemilu.org#53977,"PANJER, DENPASAR SELATAN, KOTA DENPASAR, BALI",7,199,11,210
https://kawalpemilu.org#53977,"PANJER, DENPASAR SELATAN, KOTA DENPASAR, BALI",8,202,8,210
https://kawalpemilu.org#53977,"PANJER, DENPASAR SELATAN, KOTA DENPASAR, BALI",9,171,8,179
https://kawalpemilu.org#53977,"PANJER, DENPASAR SELATAN, KOTA DENPASAR, BALI",10,245,13,258
https://kawalpemilu.org#53977,"PANJER, DENPASAR SELATAN, KOTA DENPASAR, BALI",11,238,20,258
https://kawalpemilu.org#53977,"PANJER, DENPASAR SELATAN, KOTA DENPASAR, BALI",12,221,12,233
https://kawalpemilu.org#53977,"PANJER, DENPASAR SELATAN, KOTA DENPASAR, BALI",13,200,16,216
https://kawalpemilu.org#53977,"PANJER, DENPASAR SELATAN, KOTA DENPASAR, BALI",14,197,15,212
https://kawalpemilu.org#53977,"PANJER, DENPASAR SELATAN, KOTA DENPASAR, BALI",15,177,14,191
https://kawalpemilu.org#53977,"PANJER, DENPASAR SELATAN, KOTA DENPASAR, BALI",16,224,16,240
https://kawalpemilu.org#53977,"PANJER, DENPASAR SELATAN, KOTA DENPASAR, BALI",17,212,23,235
https://kawalpemilu.org#53977,"PANJER, DENPASAR SELATAN, KOTA DENPASAR, BALI",18,216,8,224
https://kawalpemilu.org#53977,"PANJER, DENPASAR SELATAN, KOTA DENPASAR, BALI",19,197,34,231
https://kawalpemilu.org#53977,"PANJER, DENPASAR SELATAN, KOTA DENPASAR, BALI",20,244,17,261
https://kawalpemilu.org#53977,"PANJER, DENPASAR SELATAN, KOTA DENPASAR, BALI",21,193,23,216
https://kawalpemilu.org#53977,"PANJER, DENPASAR SELATAN, KOTA DENPASAR, BALI",22,193,15,208
https://kawalpemilu.org#53977,"PANJER, DENPASAR SELATAN, KOTA DENPASAR, BALI",23,197,28,225
https://kawalpemilu.org#53977,"PANJER, DENPASAR SELATAN, KOTA DENPASAR, BALI",24,237,27,264
https://kawalpemilu.org#53977,"PANJER, DENPASAR SELATAN, KOTA DENPASAR, BALI",25,239,11,250
https://kawalpemilu.org#53977,"PANJER, DENPASAR SELATAN, KOTA DENPASAR, BALI",26,228,16,244
https://kawalpemilu.org#53977,"PANJER, DENPASAR SELATAN, KOTA DENPASAR, BALI",27,233,26,259
https://kawalpemilu.org#53977,"PANJER, DENPASAR SELATAN, KOTA DENPASAR, BALI",28,230,15,245
https://kawalpemilu.org#53977,"PANJER, DENPASAR SELATAN, KOTA DENPASAR, BALI",29,232,8,240
https://kawalpemilu.org#53977,"PANJER, DENPASAR SELATAN, KOTA DENPASAR, BALI",30,218,10,228
https://kawalpemilu.org#53977,"PANJER, DENPASAR SELATAN, KOTA DENPASAR, BALI",31,216,17,233
https://kawalpemilu.org#53977,"PANJER, DENPASAR SELATAN, KOTA DENPASAR, BALI",32,209,16,225
https://kawalpemilu.org#53977,"PANJER, DENPASAR SELATAN, KOTA DENPASAR, BALI",33,215,23,238
https://kawalpemilu.org#53977,"PANJER, DENPASAR SELATAN, KOTA DENPASAR, BALI",34,214,13,227
https://kawalpemilu.org#53977,"PANJER, DENPASAR SELATAN, KOTA DENPASAR, BALI",35,198,31,229
https://kawalpemilu.org#53977,"PANJER, DENPASAR SELATAN, KOTA DENPASAR, BALI",36,217,8,225
https://kawalpemilu.org#53977,"PANJER, DENPASAR SELATAN, KOTA DENPASAR, BALI",37,214,19,233
https://kawalpemilu.org#53977,"PANJER, DENPASAR SELATAN, KOTA DENPASAR, BALI",38,214,34,248
https://kawalpemilu.org#53977,"PANJER, DENPASAR SELATAN, KOTA DENPASAR, BALI",39,217,47,264
https://kawalpemilu.org#53977,"PANJER, DENPASAR SELATAN, KOTA DENPASAR, BALI",40,244,32,276
https://kawalpemilu.org#53977,"PANJER, DENPASAR SELATAN, KOTA DENPASAR, BALI",41,220,31,251
https://kawalpemilu.org#53977,"PANJER, DENPASAR SELATAN, KOTA DENPASAR, BALI",42,227,18,245
https://kawalpemilu.org#53977,"PANJER, DENPASAR SELATAN, KOTA DENPASAR, BALI",43,182,37,219
https://kawalpemilu.org#53977,"PANJER, DENPASAR SELATAN, KOTA DENPASAR, BALI",44,208,23,231
https://kawalpemilu.org#53977,"PANJER, DENPASAR SELATAN, KOTA DENPASAR, BALI",45,196,35,231
https://kawalpemilu.org#53977,"PANJER, DENPASAR SELATAN, KOTA DENPASAR, BALI",46,211,25,236
https://kawalpemilu.org#53977,"PANJER, DENPASAR SELATAN, KOTA DENPASAR, BALI",47,228,15,243
https://kawalpemilu.org#53977,"PANJER, DENPASAR SELATAN, KOTA DENPASAR, BALI",48,223,17,240
https://kawalpemilu.org#53977,"PANJER, DENPASAR SELATAN, KOTA DENPASAR, BALI",49,201,22,223
https://kawalpemilu.org#53977,"PANJER, DENPASAR SELATAN, KOTA DENPASAR, BALI",50,225,8,233
https://kawalpemilu.org#53977,"PANJER, DENPASAR SELATAN, KOTA DENPASAR, BALI",51,211,14,225
https://kawalpemilu.org#53977,"PANJER, DENPASAR SELATAN, KOTA DENPASAR, BALI",52,219,11,230
https://kawalpemilu.org#53977,"PANJER, DENPASAR SELATAN, KOTA DENPASAR, BALI",53,197,25,222
https://kawalpemilu.org#53977,"PANJER, DENPASAR SELATAN, KOTA DENPASAR, BALI",54,202,22,224
https://kawalpemilu.org#53977,"PANJER, DENPASAR SELATAN, KOTA DENPASAR, BALI",55,187,24,211
https://kawalpemilu.org#53977,"PANJER, DENPASAR SELATAN, KOTA DENPASAR, BALI",56,185,27,212
https://kawalpemilu.org#53977,"PANJER, DENPASAR SELATAN, KOTA DENPASAR, BALI",57,181,9,190
https://kawalpemilu.org#53977,"PANJER, DENPASAR SELATAN, KOTA DENPASAR, BALI",58,175,30,205
https://kawalpemilu.org#53977,"PANJER, DENPASAR SELATAN, KOTA DENPASAR, BALI",59,180,38,218
https://kawalpemilu.org#53977,"PANJER, DENPASAR SELATAN, KOTA DENPASAR, BALI",60,172,25,197
https://kawalpemilu.org#53978,"RENON, DENPASAR SELATAN, KOTA DENPASAR, BALI",1,188,34,222
https://kawalpemilu.org#53978,"RENON, DENPASAR SELATAN, KOTA DENPASAR, BALI",2,235,24,259
https://kawalpemilu.org#53978,"RENON, DENPASAR SELATAN, KOTA DENPASAR, BALI",3,243,18,261
https://kawalpemilu.org#53978,"RENON, DENPASAR SELATAN, KOTA DENPASAR, BALI",4,221,11,232
https://kawalpemilu.org#53978,"RENON, DENPASAR SELATAN, KOTA DENPASAR, BALI",5,193,14,207
https://kawalpemilu.org#53978,"RENON, DENPASAR SELATAN, KOTA DENPASAR, BALI",6,196,17,213
https://kawalpemilu.org#53978,"RENON, DENPASAR SELATAN, KOTA DENPASAR, BALI",7,208,21,229
https://kawalpemilu.org#53978,"RENON, DENPASAR SELATAN, KOTA DENPASAR, BALI",8,188,17,205
https://kawalpemilu.org#53978,"RENON, DENPASAR SELATAN, KOTA DENPASAR, BALI",9,212,26,238
https://kawalpemilu.org#53978,"RENON, DENPASAR SELATAN, KOTA DENPASAR, BALI",10,206,35,241
https://kawalpemilu.org#53978,"RENON, DENPASAR SELATAN, KOTA DENPASAR, BALI",11,164,30,194
https://kawalpemilu.org#53978,"RENON, DENPASAR SELATAN, KOTA DENPASAR, BALI",12,229,19,248
https://kawalpemilu.org#53978,"RENON, DENPASAR SELATAN, KOTA DENPASAR, BALI",13,191,21,212
https://kawalpemilu.org#53978,"RENON, DENPASAR SELATAN, KOTA DENPASAR, BALI",14,200,24,224
https://kawalpemilu.org#53978,"RENON, DENPASAR SELATAN, KOTA DENPASAR, BALI",15,186,11,197
https://kawalpemilu.org#53978,"RENON, DENPASAR SELATAN, KOTA DENPASAR, BALI",16,184,9,193
https://kawalpemilu.org#53978,"RENON, DENPASAR SELATAN, KOTA DENPASAR, BALI",17,203,20,223
https://kawalpemilu.org#53978,"RENON, DENPASAR SELATAN, KOTA DENPASAR, BALI",18,217,13,230
https://kawalpemilu.org#53978,"RENON, DENPASAR SELATAN, KOTA DENPASAR, BALI",19,202,10,212
https://kawalpemilu.org#53978,"RENON, DENPASAR SELATAN, KOTA DENPASAR, BALI",20,204,20,224
https://kawalpemilu.org#53978,"RENON, DENPASAR SELATAN, KOTA DENPASAR, BALI",21,203,37,240
https://kawalpemilu.org#53978,"RENON, DENPASAR SELATAN, KOTA DENPASAR, BALI",22,215,17,232
https://kawalpemilu.org#53978,"RENON, DENPASAR SELATAN, KOTA DENPASAR, BALI",23,232,21,253
https://kawalpemilu.org#53978,"RENON, DENPASAR SELATAN, KOTA DENPASAR, BALI",24,214,27,241
https://kawalpemilu.org#53978,"RENON, DENPASAR SELATAN, KOTA DENPASAR, BALI",25,211,16,227
https://kawalpemilu.org#53978,"RENON, DENPASAR SELATAN, KOTA DENPASAR, BALI",26,204,21,225
https://kawalpemilu.org#53978,"RENON, DENPASAR SELATAN, KOTA DENPASAR, BALI",27,202,34,236
https://kawalpemilu.org#53978,"RENON, DENPASAR SELATAN, KOTA DENPASAR, BALI",28,201,24,225
https://kawalpemilu.org#53978,"RENON, DENPASAR SELATAN, KOTA DENPASAR, BALI",29,211,36,247
https://kawalpemilu.org#53978,"RENON, DENPASAR SELATAN, KOTA DENPASAR, BALI",30,211,31,242
https://kawalpemilu.org#53979,"SANUR, DENPASAR SELATAN, KOTA DENPASAR, BALI",1,218,5,223
https://kawalpemilu.org#53979,"SANUR, DENPASAR SELATAN, KOTA DENPASAR, BALI",2,178,14,192
https://kawalpemilu.org#53979,"SANUR, DENPASAR SELATAN, KOTA DENPASAR, BALI",3,209,9,218
https://kawalpemilu.org#53979,"SANUR, DENPASAR SELATAN, KOTA DENPASAR, BALI",4,172,6,178
https://kawalpemilu.org#53979,"SANUR, DENPASAR SELATAN, KOTA DENPASAR, BALI",5,207,8,215
https://kawalpemilu.org#53979,"SANUR, DENPASAR SELATAN, KOTA DENPASAR, BALI",6,164,6,170
https://kawalpemilu.org#53979,"SANUR, DENPASAR SELATAN, KOTA DENPASAR, BALI",7,202,35,237
https://kawalpemilu.org#53979,"SANUR, DENPASAR SELATAN, KOTA DENPASAR, BALI",8,205,32,237
https://kawalpemilu.org#53979,"SANUR, DENPASAR SELATAN, KOTA DENPASAR, BALI",9,210,13,223
https://kawalpemilu.org#53979,"SANUR, DENPASAR SELATAN, KOTA DENPASAR, BALI",10,216,7,223
https://kawalpemilu.org#53979,"SANUR, DENPASAR SELATAN, KOTA DENPASAR, BALI",11,161,15,176
https://kawalpemilu.org#53979,"SANUR, DENPASAR SELATAN, KOTA DENPASAR, BALI",12,201,5,206
https://kawalpemilu.org#53979,"SANUR, DENPASAR SELATAN, KOTA DENPASAR, BALI",13,185,10,195
https://kawalpemilu.org#53979,"SANUR, DENPASAR SELATAN, KOTA DENPASAR, BALI",14,147,4,151
https://kawalpemilu.org#53979,"SANUR, DENPASAR SELATAN, KOTA DENPASAR, BALI",15,211,12,223
https://kawalpemilu.org#53979,"SANUR, DENPASAR SELATAN, KOTA DENPASAR, BALI",16,211,3,214
https://kawalpemilu.org#53979,"SANUR, DENPASAR SELATAN, KOTA DENPASAR, BALI",17,145,3,148
https://kawalpemilu.org#53979,"SANUR, DENPASAR SELATAN, KOTA DENPASAR, BALI",18,207,3,210
https://kawalpemilu.org#53979,"SANUR, DENPASAR SELATAN, KOTA DENPASAR, BALI",19,155,10,165
https://kawalpemilu.org#53979,"SANUR, DENPASAR SELATAN, KOTA DENPASAR, BALI",20,199,13,212
https://kawalpemilu.org#53979,"SANUR, DENPASAR SELATAN, KOTA DENPASAR, BALI",21,142,7,149
https://kawalpemilu.org#53979,"SANUR, DENPASAR SELATAN, KOTA DENPASAR, BALI",22,209,5,214
https://kawalpemilu.org#53979,"SANUR, DENPASAR SELATAN, KOTA DENPASAR, BALI",23,199,9,208
https://kawalpemilu.org#53979,"SANUR, DENPASAR SELATAN, KOTA DENPASAR, BALI",24,187,12,199
https://kawalpemilu.org#53979,"SANUR, DENPASAR SELATAN, KOTA DENPASAR, BALI",25,192,8,200
https://kawalpemilu.org#53979,"SANUR, DENPASAR SELATAN, KOTA DENPASAR, BALI",26,151,7,158
https://kawalpemilu.org#53979,"SANUR, DENPASAR SELATAN, KOTA DENPASAR, BALI",27,187,8,195
https://kawalpemilu.org#53979,"SANUR, DENPASAR SELATAN, KOTA DENPASAR, BALI",28,148,16,164
https://kawalpemilu.org#53979,"SANUR, DENPASAR SELATAN, KOTA DENPASAR, BALI",29,184,8,192
https://kawalpemilu.org#53979,"SANUR, DENPASAR SELATAN, KOTA DENPASAR, BALI",30,194,13,207
https://kawalpemilu.org#53979,"SANUR, DENPASAR SELATAN, KOTA DENPASAR, BALI",31,180,9,189
https://kawalpemilu.org#53980,"SIDAKARYA, DENPASAR SELATAN, KOTA DENPASAR, BALI",1,198,21,219
https://kawalpemilu.org#53980,"SIDAKARYA, DENPASAR SELATAN, KOTA DENPASAR, BALI",2,195,19,214
https://kawalpemilu.org#53980,"SIDAKARYA, DENPASAR SELATAN, KOTA DENPASAR, BALI",3,223,1,224
https://kawalpemilu.org#53980,"SIDAKARYA, DENPASAR SELATAN, KOTA DENPASAR, BALI",4,213,14,227
https://kawalpemilu.org#53980,"SIDAKARYA, DENPASAR SELATAN, KOTA DENPASAR, BALI",5,231,26,257
https://kawalpemilu.org#53980,"SIDAKARYA, DENPASAR SELATAN, KOTA DENPASAR, BALI",6,224,17,241
https://kawalpemilu.org#53980,"SIDAKARYA, DENPASAR SELATAN, KOTA DENPASAR, BALI",7,205,25,230
https://kawalpemilu.org#53980,"SIDAKARYA, DENPASAR SELATAN, KOTA DENPASAR, BALI",8,224,25,249
https://kawalpemilu.org#53980,"SIDAKARYA, DENPASAR SELATAN, KOTA DENPASAR, BALI",9,217,18,235
https://kawalpemilu.org#53980,"SIDAKARYA, DENPASAR SELATAN, KOTA DENPASAR, BALI",10,221,19,240
https://kawalpemilu.org#53980,"SIDAKARYA, DENPASAR SELATAN, KOTA DENPASAR, BALI",11,210,10,220
https://kawalpemilu.org#53980,"SIDAKARYA, DENPASAR SELATAN, KOTA DENPASAR, BALI",12,192,15,207
https://kawalpemilu.org#53980,"SIDAKARYA, DENPASAR SELATAN, KOTA DENPASAR, BALI",13,173,41,214
https://kawalpemilu.org#53980,"SIDAKARYA, DENPASAR SELATAN, KOTA DENPASAR, BALI",14,215,14,229
https://kawalpemilu.org#53980,"SIDAKARYA, DENPASAR SELATAN, KOTA DENPASAR, BALI",15,203,20,223
https://kawalpemilu.org#53980,"SIDAKARYA, DENPASAR SELATAN, KOTA DENPASAR, BALI",16,223,20,243
https://kawalpemilu.org#53980,"SIDAKARYA, DENPASAR SELATAN, KOTA DENPASAR, BALI",17,227,15,242
https://kawalpemilu.org#53980,"SIDAKARYA, DENPASAR SELATAN, KOTA DENPASAR, BALI",18,208,16,224
https://kawalpemilu.org#53980,"SIDAKARYA, DENPASAR SELATAN, KOTA DENPASAR, BALI",19,199,22,221
https://kawalpemilu.org#53980,"SIDAKARYA, DENPASAR SELATAN, KOTA DENPASAR, BALI",20,185,25,210
https://kawalpemilu.org#53980,"SIDAKARYA, DENPASAR SELATAN, KOTA DENPASAR, BALI",21,184,31,215
https://kawalpemilu.org#53980,"SIDAKARYA, DENPASAR SELATAN, KOTA DENPASAR, BALI",22,192,31,223
https://kawalpemilu.org#53980,"SIDAKARYA, DENPASAR SELATAN, KOTA DENPASAR, BALI",23,196,19,215
https://kawalpemilu.org#53980,"SIDAKARYA, DENPASAR SELATAN, KOTA DENPASAR, BALI",24,136,43,179
https://kawalpemilu.org#53980,"SIDAKARYA, DENPASAR SELATAN, KOTA DENPASAR, BALI",25,172,20,192
https://kawalpemilu.org#53980,"SIDAKARYA, DENPASAR SELATAN, KOTA DENPASAR, BALI",26,167,21,188
https://kawalpemilu.org#53980,"SIDAKARYA, DENPASAR SELATAN, KOTA DENPASAR, BALI",27,175,28,203
https://kawalpemilu.org#53980,"SIDAKARYA, DENPASAR SELATAN, KOTA DENPASAR, BALI",28,184,30,214
https://kawalpemilu.org#53980,"SIDAKARYA, DENPASAR SELATAN, KOTA DENPASAR, BALI",29,184,21,205
https://kawalpemilu.org#53980,"SIDAKARYA, DENPASAR SELATAN, KOTA DENPASAR, BALI",30,189,51,240
https://kawalpemilu.org#53980,"SIDAKARYA, DENPASAR SELATAN, KOTA DENPASAR, BALI",31,181,44,225
https://kawalpemilu.org#53980,"SIDAKARYA, DENPASAR SELATAN, KOTA DENPASAR, BALI",32,211,23,234
https://kawalpemilu.org#53980,"SIDAKARYA, DENPASAR SELATAN, KOTA DENPASAR, BALI",33,220,33,253
https://kawalpemilu.org#53980,"SIDAKARYA, DENPASAR SELATAN, KOTA DENPASAR, BALI",34,158,32,190
https://kawalpemilu.org#53980,"SIDAKARYA, DENPASAR SELATAN, KOTA DENPASAR, BALI",35,178,47,225
https://kawalpemilu.org#53980,"SIDAKARYA, DENPASAR SELATAN, KOTA DENPASAR, BALI",36,184,28,212
https://kawalpemilu.org#53980,"SIDAKARYA, DENPASAR SELATAN, KOTA DENPASAR, BALI",37,163,40,203
https://kawalpemilu.org#53980,"SIDAKARYA, DENPASAR SELATAN, KOTA DENPASAR, BALI",38,170,30,200
https://kawalpemilu.org#53980,"SIDAKARYA, DENPASAR SELATAN, KOTA DENPASAR, BALI",39,172,29,201
https://kawalpemilu.org#53980,"SIDAKARYA, DENPASAR SELATAN, KOTA DENPASAR, BALI",40,172,39,211
https://kawalpemilu.org#53980,"SIDAKARYA, DENPASAR SELATAN, KOTA DENPASAR, BALI",41,196,26,222
https://kawalpemilu.org#53980,"SIDAKARYA, DENPASAR SELATAN, KOTA DENPASAR, BALI",42,208,30,238
https://kawalpemilu.org#53980,"SIDAKARYA, DENPASAR SELATAN, KOTA DENPASAR, BALI",43,99,25,124
https://kawalpemilu.org#53980,"SIDAKARYA, DENPASAR SELATAN, KOTA DENPASAR, BALI",44,151,26,177
https://kawalpemilu.org#53980,"SIDAKARYA, DENPASAR SELATAN, KOTA DENPASAR, BALI",45,134,34,168
https://kawalpemilu.org#53981,"PEMOGAN, DENPASAR SELATAN, KOTA DENPASAR, BALI",1,161,12,173
https://kawalpemilu.org#53981,"PEMOGAN, DENPASAR SELATAN, KOTA DENPASAR, BALI",2,213,10,223
https://kawalpemilu.org#53981,"PEMOGAN, DENPASAR SELATAN, KOTA DENPASAR, BALI",3,198,7,205
https://kawalpemilu.org#53981,"PEMOGAN, DENPASAR SELATAN, KOTA DENPASAR, BALI",4,210,7,217
https://kawalpemilu.org#53981,"PEMOGAN, DENPASAR SELATAN, KOTA DENPASAR, BALI",5,216,7,223
https://kawalpemilu.org#53981,"PEMOGAN, DENPASAR SELATAN, KOTA DENPASAR, BALI",6,168,19,187
https://kawalpemilu.org#53981,"PEMOGAN, DENPASAR SELATAN, KOTA DENPASAR, BALI",7,177,18,195
https://kawalpemilu.org#53981,"PEMOGAN, DENPASAR SELATAN, KOTA DENPASAR, BALI",8,165,16,181
https://kawalpemilu.org#53981,"PEMOGAN, DENPASAR SELATAN, KOTA DENPASAR, BALI",9,186,11,197
https://kawalpemilu.org#53981,"PEMOGAN, DENPASAR SELATAN, KOTA DENPASAR, BALI",10,172,6,178
https://kawalpemilu.org#53981,"PEMOGAN, DENPASAR SELATAN, KOTA DENPASAR, BALI",11,195,30,225
https://kawalpemilu.org#53981,"PEMOGAN, DENPASAR SELATAN, KOTA DENPASAR, BALI",12,202,30,232
https://kawalpemilu.org#53981,"PEMOGAN, DENPASAR SELATAN, KOTA DENPASAR, BALI",13,193,26,219
https://kawalpemilu.org#53981,"PEMOGAN, DENPASAR SELATAN, KOTA DENPASAR, BALI",14,177,37,214
https://kawalpemilu.org#53981,"PEMOGAN, DENPASAR SELATAN, KOTA DENPASAR, BALI",15,187,31,218
https://kawalpemilu.org#53981,"PEMOGAN, DENPASAR SELATAN, KOTA DENPASAR, BALI",16,187,29,216
https://kawalpemilu.org#53981,"PEMOGAN, DENPASAR SELATAN, KOTA DENPASAR, BALI",17,58,146,204
https://kawalpemilu.org#53981,"PEMOGAN, DENPASAR SELATAN, KOTA DENPASAR, BALI",18,67,137,204
https://kawalpemilu.org#53981,"PEMOGAN, DENPASAR SELATAN, KOTA DENPASAR, BALI",19,72,125,200
https://kawalpemilu.org#53981,"PEMOGAN, DENPASAR SELATAN, KOTA DENPASAR, BALI",20,75,165,240
https://kawalpemilu.org#53981,"PEMOGAN, DENPASAR SELATAN, KOTA DENPASAR, BALI",21,175,31,206
https://kawalpemilu.org#53981,"PEMOGAN, DENPASAR SELATAN, KOTA DENPASAR, BALI",22,163,45,208
https://kawalpemilu.org#53981,"PEMOGAN, DENPASAR SELATAN, KOTA DENPASAR, BALI",23,158,48,206
https://kawalpemilu.org#53981,"PEMOGAN, DENPASAR SELATAN, KOTA DENPASAR, BALI",24,169,38,207
https://kawalpemilu.org#53981,"PEMOGAN, DENPASAR SELATAN, KOTA DENPASAR, BALI",25,137,44,181
https://kawalpemilu.org#53981,"PEMOGAN, DENPASAR SELATAN, KOTA DENPASAR, BALI",26,179,47,226
https://kawalpemilu.org#53981,"PEMOGAN, DENPASAR SELATAN, KOTA DENPASAR, BALI",27,205,21,226
https://kawalpemilu.org#53981,"PEMOGAN, DENPASAR SELATAN, KOTA DENPASAR, BALI",28,209,32,231
https://kawalpemilu.org#53981,"PEMOGAN, DENPASAR SELATAN, KOTA DENPASAR, BALI",29,195,24,219
https://kawalpemilu.org#53981,"PEMOGAN, DENPASAR SELATAN, KOTA DENPASAR, BALI",30,178,25,203
https://kawalpemilu.org#53981,"PEMOGAN, DENPASAR SELATAN, KOTA DENPASAR, BALI",31,191,40,231
https://kawalpemilu.org#53981,"PEMOGAN, DENPASAR SELATAN, KOTA DENPASAR, BALI",32,187,33,220
https://kawalpemilu.org#53981,"PEMOGAN, DENPASAR SELATAN, KOTA DENPASAR, BALI",33,188,33,221
https://kawalpemilu.org#53981,"PEMOGAN, DENPASAR SELATAN, KOTA DENPASAR, BALI",34,187,33,220
https://kawalpemilu.org#53981,"PEMOGAN, DENPASAR SELATAN, KOTA DENPASAR, BALI",35,215,30,245
https://kawalpemilu.org#53981,"PEMOGAN, DENPASAR SELATAN, KOTA DENPASAR, BALI",36,203,17,220
https://kawalpemilu.org#53981,"PEMOGAN, DENPASAR SELATAN, KOTA DENPASAR, BALI",37,205,15,220
https://kawalpemilu.org#53981,"PEMOGAN, DENPASAR SELATAN, KOTA DENPASAR, BALI",38,200,10,210
https://kawalpemilu.org#53981,"PEMOGAN, DENPASAR SELATAN, KOTA DENPASAR, BALI",39,199,7,206
https://kawalpemilu.org#53981,"PEMOGAN, DENPASAR SELATAN, KOTA DENPASAR, BALI",40,196,5,201
https://kawalpemilu.org#53981,"PEMOGAN, DENPASAR SELATAN, KOTA DENPASAR, BALI",41,65,165,230
https://kawalpemilu.org#53981,"PEMOGAN, DENPASAR SELATAN, KOTA DENPASAR, BALI",42,82,151,233
https://kawalpemilu.org#53981,"PEMOGAN, DENPASAR SELATAN, KOTA DENPASAR, BALI",43,65,155,220
https://kawalpemilu.org#53981,"PEMOGAN, DENPASAR SELATAN, KOTA DENPASAR, BALI",44,72,175,247
https://kawalpemilu.org#53981,"PEMOGAN, DENPASAR SELATAN, KOTA DENPASAR, BALI",45,90,151,241
https://kawalpemilu.org#53981,"PEMOGAN, DENPASAR SELATAN, KOTA DENPASAR, BALI",46,184,14,198
https://kawalpemilu.org#53981,"PEMOGAN, DENPASAR SELATAN, KOTA DENPASAR, BALI",47,197,5,202
https://kawalpemilu.org#53981,"PEMOGAN, DENPASAR SELATAN, KOTA DENPASAR, BALI",48,168,33,201
https://kawalpemilu.org#53981,"PEMOGAN, DENPASAR SELATAN, KOTA DENPASAR, BALI",49,176,21,197
https://kawalpemilu.org#53981,"PEMOGAN, DENPASAR SELATAN, KOTA DENPASAR, BALI",50,195,20,215
https://kawalpemilu.org#53981,"PEMOGAN, DENPASAR SELATAN, KOTA DENPASAR, BALI",51,183,23,206
https://kawalpemilu.org#53981,"PEMOGAN, DENPASAR SELATAN, KOTA DENPASAR, BALI",52,187,26,213
https://kawalpemilu.org#53981,"PEMOGAN, DENPASAR SELATAN, KOTA DENPASAR, BALI",53,205,45,250
https://kawalpemilu.org#53981,"PEMOGAN, DENPASAR SELATAN, KOTA DENPASAR, BALI",54,169,42,211
https://kawalpemilu.org#53981,"PEMOGAN, DENPASAR SELATAN, KOTA DENPASAR, BALI",55,217,28,245
https://kawalpemilu.org#53981,"PEMOGAN, DENPASAR SELATAN, KOTA DENPASAR, BALI",56,207,34,241
https://kawalpemilu.org#53981,"PEMOGAN, DENPASAR SELATAN, KOTA DENPASAR, BALI",57,210,22,232
https://kawalpemilu.org#53981,"PEMOGAN, DENPASAR SELATAN, KOTA DENPASAR, BALI",58,224,15,239
https://kawalpemilu.org#53981,"PEMOGAN, DENPASAR SELATAN, KOTA DENPASAR, BALI",60,210,15,225
https://kawalpemilu.org#53981,"PEMOGAN, DENPASAR SELATAN, KOTA DENPASAR, BALI",61,184,43,227
https://kawalpemilu.org#53981,"PEMOGAN, DENPASAR SELATAN, KOTA DENPASAR, BALI",62,201,16,217
https://kawalpemilu.org#53981,"PEMOGAN, DENPASAR SELATAN, KOTA DENPASAR, BALI",63,211,21,232
https://kawalpemilu.org#53981,"PEMOGAN, DENPASAR SELATAN, KOTA DENPASAR, BALI",64,212,20,232
https://kawalpemilu.org#53981,"PEMOGAN, DENPASAR SELATAN, KOTA DENPASAR, BALI",65,222,23,245
https://kawalpemilu.org#53981,"PEMOGAN, DENPASAR SELATAN, KOTA DENPASAR, BALI",66,223,31,254
https://kawalpemilu.org#53981,"PEMOGAN, DENPASAR SELATAN, KOTA DENPASAR, BALI",67,207,19,226
https://kawalpemilu.org#53981,"PEMOGAN, DENPASAR SELATAN, KOTA DENPASAR, BALI",68,200,28,228
https://kawalpemilu.org#53981,"PEMOGAN, DENPASAR SELATAN, KOTA DENPASAR, BALI",69,201,33,234
https://kawalpemilu.org#53981,"PEMOGAN, DENPASAR SELATAN, KOTA DENPASAR, BALI",70,220,19,239
https://kawalpemilu.org#53981,"PEMOGAN, DENPASAR SELATAN, KOTA DENPASAR, BALI",71,167,45,212
https://kawalpemilu.org#53981,"PEMOGAN, DENPASAR SELATAN, KOTA DENPASAR, BALI",72,52,125,177
https://kawalpemilu.org#53981,"PEMOGAN, DENPASAR SELATAN, KOTA DENPASAR, BALI",73,130,43,173
https://kawalpemilu.org#53981,"PEMOGAN, DENPASAR SELATAN, KOTA DENPASAR, BALI",74,161,35,196
https://kawalpemilu.org#53981,"PEMOGAN, DENPASAR SELATAN, KOTA DENPASAR, BALI",75,63,104,167
https://kawalpemilu.org#53981,"PEMOGAN, DENPASAR SELATAN, KOTA DENPASAR, BALI",76,70,99,169
https://kawalpemilu.org#53982,"SANUR KAJA, DENPASAR SELATAN, KOTA DENPASAR, BALI",1,237,24,261
https://kawalpemilu.org#53982,"SANUR KAJA, DENPASAR SELATAN, KOTA DENPASAR, BALI",2,248,16,264
https://kawalpemilu.org#53982,"SANUR KAJA, DENPASAR SELATAN, KOTA DENPASAR, BALI",3,242,15,257
https://kawalpemilu.org#53982,"SANUR KAJA, DENPASAR SELATAN, KOTA DENPASAR, BALI",4,229,8,237
https://kawalpemilu.org#53982,"SANUR KAJA, DENPASAR SELATAN, KOTA DENPASAR, BALI",5,229,5,234
https://kawalpemilu.org#53982,"SANUR KAJA, DENPASAR SELATAN, KOTA DENPASAR, BALI",6,200,10,210
https://kawalpemilu.org#53982,"SANUR KAJA, DENPASAR SELATAN, KOTA DENPASAR, BALI",7,216,12,228
https://kawalpemilu.org#53982,"SANUR KAJA, DENPASAR SELATAN, KOTA DENPASAR, BALI",8,212,7,219
https://kawalpemilu.org#53982,"SANUR KAJA, DENPASAR SELATAN, KOTA DENPASAR, BALI",9,241,7,248
https://kawalpemilu.org#53982,"SANUR KAJA, DENPASAR SELATAN, KOTA DENPASAR, BALI",10,225,16,241
https://kawalpemilu.org#53982,"SANUR KAJA, DENPASAR SELATAN, KOTA DENPASAR, BALI",11,217,6,223
https://kawalpemilu.org#53982,"SANUR KAJA, DENPASAR SELATAN, KOTA DENPASAR, BALI",12,253,4,257
https://kawalpemilu.org#53982,"SANUR KAJA, DENPASAR SELATAN, KOTA DENPASAR, BALI",13,184,72,256
https://kawalpemilu.org#53982,"SANUR KAJA, DENPASAR SELATAN, KOTA DENPASAR, BALI",14,170,90,260
https://kawalpemilu.org#53982,"SANUR KAJA, DENPASAR SELATAN, KOTA DENPASAR, BALI",15,191,40,231
https://kawalpemilu.org#53982,"SANUR KAJA, DENPASAR SELATAN, KOTA DENPASAR, BALI",16,242,19,261
https://kawalpemilu.org#53982,"SANUR KAJA, DENPASAR SELATAN, KOTA DENPASAR, BALI",17,210,8,218
https://kawalpemilu.org#53982,"SANUR KAJA, DENPASAR SELATAN, KOTA DENPASAR, BALI",18,239,11,250
https://kawalpemilu.org#53982,"SANUR KAJA, DENPASAR SELATAN, KOTA DENPASAR, BALI",19,212,17,229
https://kawalpemilu.org#53982,"SANUR KAJA, DENPASAR SELATAN, KOTA DENPASAR, BALI",20,139,9,148
https://kawalpemilu.org#53983,"SANUR KAUH, DENPASAR SELATAN, KOTA DENPASAR, BALI",1,226,7,233
https://kawalpemilu.org#53983,"SANUR KAUH, DENPASAR SELATAN, KOTA DENPASAR, BALI",2,213,6,219
https://kawalpemilu.org#53983,"SANUR KAUH, DENPASAR SELATAN, KOTA DENPASAR, BALI",3,224,23,247
https://kawalpemilu.org#53983,"SANUR KAUH, DENPASAR SELATAN, KOTA DENPASAR, BALI",4,218,19,237
https://kawalpemilu.org#53983,"SANUR KAUH, DENPASAR SELATAN, KOTA DENPASAR, BALI",5,235,11,246
https://kawalpemilu.org#53983,"SANUR KAUH, DENPASAR SELATAN, KOTA DENPASAR, BALI",6,214,23,237
https://kawalpemilu.org#53983,"SANUR KAUH, DENPASAR SELATAN, KOTA DENPASAR, BALI",7,163,6,169
https://kawalpemilu.org#53983,"SANUR KAUH, DENPASAR SELATAN, KOTA DENPASAR, BALI",8,242,11,253
https://kawalpemilu.org#53983,"SANUR KAUH, DENPASAR SELATAN, KOTA DENPASAR, BALI",9,216,30,246
https://kawalpemilu.org#53983,"SANUR KAUH, DENPASAR SELATAN, KOTA DENPASAR, BALI",10,242,7,249
https://kawalpemilu.org#53983,"SANUR KAUH, DENPASAR SELATAN, KOTA DENPASAR, BALI",11,244,17,261
https://kawalpemilu.org#53983,"SANUR KAUH, DENPASAR SELATAN, KOTA DENPASAR, BALI",12,210,11,221
https://kawalpemilu.org#53983,"SANUR KAUH, DENPASAR SELATAN, KOTA DENPASAR, BALI",13,227,11,238
https://kawalpemilu.org#53983,"SANUR KAUH, DENPASAR SELATAN, KOTA DENPASAR, BALI",14,247,7,254
https://kawalpemilu.org#53983,"SANUR KAUH, DENPASAR SELATAN, KOTA DENPASAR, BALI",15,226,0,226
https://kawalpemilu.org#53983,"SANUR KAUH, DENPASAR SELATAN, KOTA DENPASAR, BALI",16,236,11,247
https://kawalpemilu.org#53983,"SANUR KAUH, DENPASAR SELATAN, KOTA DENPASAR, BALI",17,253,11,264
https://kawalpemilu.org#53983,"SANUR KAUH, DENPASAR SELATAN, KOTA DENPASAR, BALI",18,240,18,258
https://kawalpemilu.org#53983,"SANUR KAUH, DENPASAR SELATAN, KOTA DENPASAR, BALI",19,231,10,241
https://kawalpemilu.org#53983,"SANUR KAUH, DENPASAR SELATAN, KOTA DENPASAR, BALI",20,230,13,243
https://kawalpemilu.org#53983,"SANUR KAUH, DENPASAR SELATAN, KOTA DENPASAR, BALI",21,228,17,245
https://kawalpemilu.org#53983,"SANUR KAUH, DENPASAR SELATAN, KOTA DENPASAR, BALI",22,232,13,245
https://kawalpemilu.org#53983,"SANUR KAUH, DENPASAR SELATAN, KOTA DENPASAR, BALI",23,169,8,177
https://kawalpemilu.org#53983,"SANUR KAUH, DENPASAR SELATAN, KOTA DENPASAR, BALI",24,210,14,224
https://kawalpemilu.org#53983,"SANUR KAUH, DENPASAR SELATAN, KOTA DENPASAR, BALI",25,204,20,224
https://kawalpemilu.org#53983,"SANUR KAUH, DENPASAR SELATAN, KOTA DENPASAR, BALI",26,220,11,231
https://kawalpemilu.org#53983,"SANUR KAUH, DENPASAR SELATAN, KOTA DENPASAR, BALI",27,215,20,235
https://kawalpemilu.org#53983,"SANUR KAUH, DENPASAR SELATAN, KOTA DENPASAR, BALI",28,187,14,201
https://kawalpemilu.org#53983,"SANUR KAUH, DENPASAR SELATAN, KOTA DENPASAR, BALI",29,171,13,184
https://kawalpemilu.org#53985,"KESIMAN, DENPASAR TIMUR, KOTA DENPASAR, BALI",1,218,20,238
https://kawalpemilu.org#53985,"KESIMAN, DENPASAR TIMUR, KOTA DENPASAR, BALI",2,231,12,243
https://kawalpemilu.org#53985,"KESIMAN, DENPASAR TIMUR, KOTA DENPASAR, BALI",4,220,12,232
https://kawalpemilu.org#53985,"KESIMAN, DENPASAR TIMUR, KOTA DENPASAR, BALI",5,257,12,269
https://kawalpemilu.org#53985,"KESIMAN, DENPASAR TIMUR, KOTA DENPASAR, BALI",6,239,7,246
https://kawalpemilu.org#53985,"KESIMAN, DENPASAR TIMUR, KOTA DENPASAR, BALI",7,246,16,262
https://kawalpemilu.org#53985,"KESIMAN, DENPASAR TIMUR, KOTA DENPASAR, BALI",8,235,8,243
https://kawalpemilu.org#53985,"KESIMAN, DENPASAR TIMUR, KOTA DENPASAR, BALI",9,216,8,224
https://kawalpemilu.org#53985,"KESIMAN, DENPASAR TIMUR, KOTA DENPASAR, BALI",10,209,17,226
https://kawalpemilu.org#53985,"KESIMAN, DENPASAR TIMUR, KOTA DENPASAR, BALI",11,227,20,247
https://kawalpemilu.org#53985,"KESIMAN, DENPASAR TIMUR, KOTA DENPASAR, BALI",12,195,7,202
https://kawalpemilu.org#53985,"KESIMAN, DENPASAR TIMUR, KOTA DENPASAR, BALI",13,192,13,205
https://kawalpemilu.org#53985,"KESIMAN, DENPASAR TIMUR, KOTA DENPASAR, BALI",14,182,17,199
https://kawalpemilu.org#53985,"KESIMAN, DENPASAR TIMUR, KOTA DENPASAR, BALI",15,213,7,220
https://kawalpemilu.org#53985,"KESIMAN, DENPASAR TIMUR, KOTA DENPASAR, BALI",16,226,16,242
https://kawalpemilu.org#53985,"KESIMAN, DENPASAR TIMUR, KOTA DENPASAR, BALI",17,217,8,225
https://kawalpemilu.org#53985,"KESIMAN, DENPASAR TIMUR, KOTA DENPASAR, BALI",18,227,14,241
https://kawalpemilu.org#53985,"KESIMAN, DENPASAR TIMUR, KOTA DENPASAR, BALI",19,236,10,246
https://kawalpemilu.org#53985,"KESIMAN, DENPASAR TIMUR, KOTA DENPASAR, BALI",20,233,7,240
https://kawalpemilu.org#53985,"KESIMAN, DENPASAR TIMUR, KOTA DENPASAR, BALI",21,236,16,252
https://kawalpemilu.org#53985,"KESIMAN, DENPASAR TIMUR, KOTA DENPASAR, BALI",22,221,15,236
https://kawalpemilu.org#53985,"KESIMAN, DENPASAR TIMUR, KOTA DENPASAR, BALI",23,225,6,231
https://kawalpemilu.org#53985,"KESIMAN, DENPASAR TIMUR, KOTA DENPASAR, BALI",24,219,6,225
https://kawalpemilu.org#53985,"KESIMAN, DENPASAR TIMUR, KOTA DENPASAR, BALI",25,240,8,248
https://kawalpemilu.org#53985,"KESIMAN, DENPASAR TIMUR, KOTA DENPASAR, BALI",26,219,21,240
https://kawalpemilu.org#53985,"KESIMAN, DENPASAR TIMUR, KOTA DENPASAR, BALI",27,234,4,238
https://kawalpemilu.org#53985,"KESIMAN, DENPASAR TIMUR, KOTA DENPASAR, BALI",28,238,17,255
https://kawalpemilu.org#53985,"KESIMAN, DENPASAR TIMUR, KOTA DENPASAR, BALI",29,244,10,254
https://kawalpemilu.org#53985,"KESIMAN, DENPASAR TIMUR, KOTA DENPASAR, BALI",30,259,12,271
https://kawalpemilu.org#53985,"KESIMAN, DENPASAR TIMUR, KOTA DENPASAR, BALI",31,229,13,242
https://kawalpemilu.org#53985,"KESIMAN, DENPASAR TIMUR, KOTA DENPASAR, BALI",32,172,11,183
https://kawalpemilu.org#53985,"KESIMAN, DENPASAR TIMUR, KOTA DENPASAR, BALI",33,139,17,156
https://kawalpemilu.org#53986,"SUMERTA, DENPASAR TIMUR, KOTA DENPASAR, BALI",1,219,10,229
https://kawalpemilu.org#53986,"SUMERTA, DENPASAR TIMUR, KOTA DENPASAR, BALI",2,235,8,243
https://kawalpemilu.org#53986,"SUMERTA, DENPASAR TIMUR, KOTA DENPASAR, BALI",3,234,11,245
https://kawalpemilu.org#53986,"SUMERTA, DENPASAR TIMUR, KOTA DENPASAR, BALI",4,198,14,212
https://kawalpemilu.org#53986,"SUMERTA, DENPASAR TIMUR, KOTA DENPASAR, BALI",5,211,11,222
https://kawalpemilu.org#53986,"SUMERTA, DENPASAR TIMUR, KOTA DENPASAR, BALI",6,208,12,220
https://kawalpemilu.org#53986,"SUMERTA, DENPASAR TIMUR, KOTA DENPASAR, BALI",7,220,3,223
https://kawalpemilu.org#53986,"SUMERTA, DENPASAR TIMUR, KOTA DENPASAR, BALI",8,201,3,204
https://kawalpemilu.org#53986,"SUMERTA, DENPASAR TIMUR, KOTA DENPASAR, BALI",9,201,5,206
https://kawalpemilu.org#53986,"SUMERTA, DENPASAR TIMUR, KOTA DENPASAR, BALI",10,217,3,220
https://kawalpemilu.org#53986,"SUMERTA, DENPASAR TIMUR, KOTA DENPASAR, BALI",11,185,5,190
https://kawalpemilu.org#53986,"SUMERTA, DENPASAR TIMUR, KOTA DENPASAR, BALI",12,216,6,222
https://kawalpemilu.org#53986,"SUMERTA, DENPASAR TIMUR, KOTA DENPASAR, BALI",13,213,13,226
https://kawalpemilu.org#53986,"SUMERTA, DENPASAR TIMUR, KOTA DENPASAR, BALI",14,233,11,244
https://kawalpemilu.org#53986,"SUMERTA, DENPASAR TIMUR, KOTA DENPASAR, BALI",15,224,9,233
https://kawalpemilu.org#53986,"SUMERTA, DENPASAR TIMUR, KOTA DENPASAR, BALI",16,213,10,223
https://kawalpemilu.org#53986,"SUMERTA, DENPASAR TIMUR, KOTA DENPASAR, BALI",17,213,9,222
https://kawalpemilu.org#53986,"SUMERTA, DENPASAR TIMUR, KOTA DENPASAR, BALI",18,204,20,224
https://kawalpemilu.org#53986,"SUMERTA, DENPASAR TIMUR, KOTA DENPASAR, BALI",19,208,22,230
https://kawalpemilu.org#53986,"SUMERTA, DENPASAR TIMUR, KOTA DENPASAR, BALI",20,220,26,246
https://kawalpemilu.org#53986,"SUMERTA, DENPASAR TIMUR, KOTA DENPASAR, BALI",21,212,35,247
https://kawalpemilu.org#53987,"DANGIN PURI, DENPASAR TIMUR, KOTA DENPASAR, BALI",1,225,11,236
https://kawalpemilu.org#53987,"DANGIN PURI, DENPASAR TIMUR, KOTA DENPASAR, BALI",2,221,8,229
https://kawalpemilu.org#53987,"DANGIN PURI, DENPASAR TIMUR, KOTA DENPASAR, BALI",3,229,12,241
https://kawalpemilu.org#53987,"DANGIN PURI, DENPASAR TIMUR, KOTA DENPASAR, BALI",4,236,21,257
https://kawalpemilu.org#53987,"DANGIN PURI, DENPASAR TIMUR, KOTA DENPASAR, BALI",5,245,11,256
https://kawalpemilu.org#53987,"DANGIN PURI, DENPASAR TIMUR, KOTA DENPASAR, BALI",6,240,12,252
https://kawalpemilu.org#53987,"DANGIN PURI, DENPASAR TIMUR, KOTA DENPASAR, BALI",7,226,9,235
https://kawalpemilu.org#53987,"DANGIN PURI, DENPASAR TIMUR, KOTA DENPASAR, BALI",8,239,17,256
https://kawalpemilu.org#53987,"DANGIN PURI, DENPASAR TIMUR, KOTA DENPASAR, BALI",9,203,21,224
https://kawalpemilu.org#53987,"DANGIN PURI, DENPASAR TIMUR, KOTA DENPASAR, BALI",10,193,34,227
https://kawalpemilu.org#53987,"DANGIN PURI, DENPASAR TIMUR, KOTA DENPASAR, BALI",11,195,45,240
https://kawalpemilu.org#53987,"DANGIN PURI, DENPASAR TIMUR, KOTA DENPASAR, BALI",12,0,0,0
https://kawalpemilu.org#53987,"DANGIN PURI, DENPASAR TIMUR, KOTA DENPASAR, BALI",13,220,13,233
https://kawalpemilu.org#53987,"DANGIN PURI, DENPASAR TIMUR, KOTA DENPASAR, BALI",14,224,12,236
https://kawalpemilu.org#53987,"DANGIN PURI, DENPASAR TIMUR, KOTA DENPASAR, BALI",15,226,14,240
https://kawalpemilu.org#53987,"DANGIN PURI, DENPASAR TIMUR, KOTA DENPASAR, BALI",16,240,12,252
https://kawalpemilu.org#53987,"DANGIN PURI, DENPASAR TIMUR, KOTA DENPASAR, BALI",17,209,16,225
https://kawalpemilu.org#53987,"DANGIN PURI, DENPASAR TIMUR, KOTA DENPASAR, BALI",18,229,20,249
https://kawalpemilu.org#53987,"DANGIN PURI, DENPASAR TIMUR, KOTA DENPASAR, BALI",19,234,27,261
https://kawalpemilu.org#53987,"DANGIN PURI, DENPASAR TIMUR, KOTA DENPASAR, BALI",20,245,25,270
https://kawalpemilu.org#53987,"DANGIN PURI, DENPASAR TIMUR, KOTA DENPASAR, BALI",21,144,12,156
https://kawalpemilu.org#53987,"DANGIN PURI, DENPASAR TIMUR, KOTA DENPASAR, BALI",22,166,25,191
https://kawalpemilu.org#53988,"PENATIH, DENPASAR TIMUR, KOTA DENPASAR, BALI",1,200,11,211
https://kawalpemilu.org#53988,"PENATIH, DENPASAR TIMUR, KOTA DENPASAR, BALI",2,195,7,202
https://kawalpemilu.org#53988,"PENATIH, DENPASAR TIMUR, KOTA DENPASAR, BALI",3,190,4,194
https://kawalpemilu.org#53988,"PENATIH, DENPASAR TIMUR, KOTA DENPASAR, BALI",4,178,15,193
https://kawalpemilu.org#53988,"PENATIH, DENPASAR TIMUR, KOTA DENPASAR, BALI",5,241,4,245
https://kawalpemilu.org#53988,"PENATIH, DENPASAR TIMUR, KOTA DENPASAR, BALI",6,245,3,248
https://kawalpemilu.org#53988,"PENATIH, DENPASAR TIMUR, KOTA DENPASAR, BALI",7,272,7,279
https://kawalpemilu.org#53988,"PENATIH, DENPASAR TIMUR, KOTA DENPASAR, BALI",8,221,16,237
https://kawalpemilu.org#53988,"PENATIH, DENPASAR TIMUR, KOTA DENPASAR, BALI",9,225,28,253
https://kawalpemilu.org#53988,"PENATIH, DENPASAR TIMUR, KOTA DENPASAR, BALI",10,230,19,249
https://kawalpemilu.org#53988,"PENATIH, DENPASAR TIMUR, KOTA DENPASAR, BALI",11,197,21,218
https://kawalpemilu.org#53988,"PENATIH, DENPASAR TIMUR, KOTA DENPASAR, BALI",12,212,11,223
https://kawalpemilu.org#53988,"PENATIH, DENPASAR TIMUR, KOTA DENPASAR, BALI",13,206,17,223
https://kawalpemilu.org#53988,"PENATIH, DENPASAR TIMUR, KOTA DENPASAR, BALI",14,221,13,234
https://kawalpemilu.org#53988,"PENATIH, DENPASAR TIMUR, KOTA DENPASAR, BALI",15,164,5,169
https://kawalpemilu.org#53988,"PENATIH, DENPASAR TIMUR, KOTA DENPASAR, BALI",16,161,6,167
https://kawalpemilu.org#53988,"PENATIH, DENPASAR TIMUR, KOTA DENPASAR, BALI",17,197,3,200
https://kawalpemilu.org#53988,"PENATIH, DENPASAR TIMUR, KOTA DENPASAR, BALI",18,246,3,249
https://kawalpemilu.org#53988,"PENATIH, DENPASAR TIMUR, KOTA DENPASAR, BALI",19,227,2,229
https://kawalpemilu.org#53988,"PENATIH, DENPASAR TIMUR, KOTA DENPASAR, BALI",20,208,5,213
https://kawalpemilu.org#53988,"PENATIH, DENPASAR TIMUR, KOTA DENPASAR, BALI",21,205,6,211
https://kawalpemilu.org#53988,"PENATIH, DENPASAR TIMUR, KOTA DENPASAR, BALI",22,197,9,206
https://kawalpemilu.org#53988,"PENATIH, DENPASAR TIMUR, KOTA DENPASAR, BALI",23,182,6,188
https://kawalpemilu.org#53988,"PENATIH, DENPASAR TIMUR, KOTA DENPASAR, BALI",24,202,5,207
https://kawalpemilu.org#53988,"PENATIH, DENPASAR TIMUR, KOTA DENPASAR, BALI",25,196,1,197
https://kawalpemilu.org#53988,"PENATIH, DENPASAR TIMUR, KOTA DENPASAR, BALI",26,181,4,185
https://kawalpemilu.org#53988,"PENATIH, DENPASAR TIMUR, KOTA DENPASAR, BALI",27,174,7,181
https://kawalpemilu.org#53988,"PENATIH, DENPASAR TIMUR, KOTA DENPASAR, BALI",28,169,5,174
https://kawalpemilu.org#53988,"PENATIH, DENPASAR TIMUR, KOTA DENPASAR, BALI",29,159,10,169
https://kawalpemilu.org#53988,"PENATIH, DENPASAR TIMUR, KOTA DENPASAR, BALI",30,151,8,159
https://kawalpemilu.org#53988,"PENATIH, DENPASAR TIMUR, KOTA DENPASAR, BALI",31,174,6,180
https://kawalpemilu.org#53989,"DANGIN PURI KELOD, DENPASAR TIMUR, KOTA DENPASAR, BALI",1,125,120,245
https://kawalpemilu.org#53989,"DANGIN PURI KELOD, DENPASAR TIMUR, KOTA DENPASAR, BALI",2,97,117,214
https://kawalpemilu.org#53989,"DANGIN PURI KELOD, DENPASAR TIMUR, KOTA DENPASAR, BALI",3,201,27,228
https://kawalpemilu.org#53989,"DANGIN PURI KELOD, DENPASAR TIMUR, KOTA DENPASAR, BALI",4,182,41,223
https://kawalpemilu.org#53989,"DANGIN PURI KELOD, DENPASAR TIMUR, KOTA DENPASAR, BALI",5,175,24,199
https://kawalpemilu.org#53989,"DANGIN PURI KELOD, DENPASAR TIMUR, KOTA DENPASAR, BALI",6,187,33,220
https://kawalpemilu.org#53989,"DANGIN PURI KELOD, DENPASAR TIMUR, KOTA DENPASAR, BALI",7,188,20,208
https://kawalpemilu.org#53989,"DANGIN PURI KELOD, DENPASAR TIMUR, KOTA DENPASAR, BALI",8,211,33,244
https://kawalpemilu.org#53989,"DANGIN PURI KELOD, DENPASAR TIMUR, KOTA DENPASAR, BALI",9,194,32,226
https://kawalpemilu.org#53989,"DANGIN PURI KELOD, DENPASAR TIMUR, KOTA DENPASAR, BALI",10,195,27,222
https://kawalpemilu.org#53989,"DANGIN PURI KELOD, DENPASAR TIMUR, KOTA DENPASAR, BALI",11,195,18,213
https://kawalpemilu.org#53989,"DANGIN PURI KELOD, DENPASAR TIMUR, KOTA DENPASAR, BALI",12,170,23,193
https://kawalpemilu.org#53989,"DANGIN PURI KELOD, DENPASAR TIMUR, KOTA DENPASAR, BALI",13,182,17,199
https://kawalpemilu.org#53989,"DANGIN PURI KELOD, DENPASAR TIMUR, KOTA DENPASAR, BALI",14,148,52,200
https://kawalpemilu.org#53989,"DANGIN PURI KELOD, DENPASAR TIMUR, KOTA DENPASAR, BALI",15,158,63,221
https://kawalpemilu.org#53989,"DANGIN PURI KELOD, DENPASAR TIMUR, KOTA DENPASAR, BALI",16,170,55,225
https://kawalpemilu.org#53989,"DANGIN PURI KELOD, DENPASAR TIMUR, KOTA DENPASAR, BALI",17,176,49,225
https://kawalpemilu.org#53989,"DANGIN PURI KELOD, DENPASAR TIMUR, KOTA DENPASAR, BALI",18,149,79,228
https://kawalpemilu.org#53989,"DANGIN PURI KELOD, DENPASAR TIMUR, KOTA DENPASAR, BALI",19,176,19,195
https://kawalpemilu.org#53989,"DANGIN PURI KELOD, DENPASAR TIMUR, KOTA DENPASAR, BALI",20,219,28,247
https://kawalpemilu.org#53989,"DANGIN PURI KELOD, DENPASAR TIMUR, KOTA DENPASAR, BALI",21,193,27,220
https://kawalpemilu.org#53989,"DANGIN PURI KELOD, DENPASAR TIMUR, KOTA DENPASAR, BALI",22,213,19,232
https://kawalpemilu.org#53989,"DANGIN PURI KELOD, DENPASAR TIMUR, KOTA DENPASAR, BALI",23,187,26,213
https://kawalpemilu.org#53989,"DANGIN PURI KELOD, DENPASAR TIMUR, KOTA DENPASAR, BALI",24,215,54,269
https://kawalpemilu.org#53989,"DANGIN PURI KELOD, DENPASAR TIMUR, KOTA DENPASAR, BALI",25,229,53,282
https://kawalpemilu.org#53989,"DANGIN PURI KELOD, DENPASAR TIMUR, KOTA DENPASAR, BALI",26,148,39,187
https://kawalpemilu.org#53989,"DANGIN PURI KELOD, DENPASAR TIMUR, KOTA DENPASAR, BALI",28,190,24,214
https://kawalpemilu.org#53989,"DANGIN PURI KELOD, DENPASAR TIMUR, KOTA DENPASAR, BALI",29,168,27,195
https://kawalpemilu.org#53989,"DANGIN PURI KELOD, DENPASAR TIMUR, KOTA DENPASAR, BALI",30,109,18,127
https://kawalpemilu.org#53989,"DANGIN PURI KELOD, DENPASAR TIMUR, KOTA DENPASAR, BALI",31,150,30,180
https://kawalpemilu.org#53990,"SUMERTA KELOD, DENPASAR TIMUR, KOTA DENPASAR, BALI",1,144,16,160
https://kawalpemilu.org#53990,"SUMERTA KELOD, DENPASAR TIMUR, KOTA DENPASAR, BALI",2,138,14,152
https://kawalpemilu.org#53990,"SUMERTA KELOD, DENPASAR TIMUR, KOTA DENPASAR, BALI",3,150,18,168
https://kawalpemilu.org#53990,"SUMERTA KELOD, DENPASAR TIMUR, KOTA DENPASAR, BALI",4,184,27,211
https://kawalpemilu.org#53990,"SUMERTA KELOD, DENPASAR TIMUR, KOTA DENPASAR, BALI",5,167,37,204
https://kawalpemilu.org#53990,"SUMERTA KELOD, DENPASAR TIMUR, KOTA DENPASAR, BALI",6,164,42,206
https://kawalpemilu.org#53990,"SUMERTA KELOD, DENPASAR TIMUR, KOTA DENPASAR, BALI",7,175,25,200
https://kawalpemilu.org#53990,"SUMERTA KELOD, DENPASAR TIMUR, KOTA DENPASAR, BALI",8,175,26,201
https://kawalpemilu.org#53990,"SUMERTA KELOD, DENPASAR TIMUR, KOTA DENPASAR, BALI",9,194,7,201
https://kawalpemilu.org#53990,"SUMERTA KELOD, DENPASAR TIMUR, KOTA DENPASAR, BALI",10,192,9,201
https://kawalpemilu.org#53990,"SUMERTA KELOD, DENPASAR TIMUR, KOTA DENPASAR, BALI",11,192,6,198
https://kawalpemilu.org#53990,"SUMERTA KELOD, DENPASAR TIMUR, KOTA DENPASAR, BALI",12,205,13,218
https://kawalpemilu.org#53990,"SUMERTA KELOD, DENPASAR TIMUR, KOTA DENPASAR, BALI",13,219,11,230
https://kawalpemilu.org#53990,"SUMERTA KELOD, DENPASAR TIMUR, KOTA DENPASAR, BALI",14,217,14,231
https://kawalpemilu.org#53990,"SUMERTA KELOD, DENPASAR TIMUR, KOTA DENPASAR, BALI",15,214,12,3
https://kawalpemilu.org#53990,"SUMERTA KELOD, DENPASAR TIMUR, KOTA DENPASAR, BALI",16,213,14,227
https://kawalpemilu.org#53990,"SUMERTA KELOD, DENPASAR TIMUR, KOTA DENPASAR, BALI",17,210,16,226
https://kawalpemilu.org#53990,"SUMERTA KELOD, DENPASAR TIMUR, KOTA DENPASAR, BALI",18,225,13,238
https://kawalpemilu.org#53990,"SUMERTA KELOD, DENPASAR TIMUR, KOTA DENPASAR, BALI",19,215,9,224
https://kawalpemilu.org#53990,"SUMERTA KELOD, DENPASAR TIMUR, KOTA DENPASAR, BALI",20,170,20,190
https://kawalpemilu.org#53990,"SUMERTA KELOD, DENPASAR TIMUR, KOTA DENPASAR, BALI",21,133,26,159
https://kawalpemilu.org#53990,"SUMERTA KELOD, DENPASAR TIMUR, KOTA DENPASAR, BALI",22,210,19,229
https://kawalpemilu.org#53990,"SUMERTA KELOD, DENPASAR TIMUR, KOTA DENPASAR, BALI",23,219,15,234
https://kawalpemilu.org#53990,"SUMERTA KELOD, DENPASAR TIMUR, KOTA DENPASAR, BALI",24,164,9,173
https://kawalpemilu.org#53990,"SUMERTA KELOD, DENPASAR TIMUR, KOTA DENPASAR, BALI",25,167,14,181
https://kawalpemilu.org#53990,"SUMERTA KELOD, DENPASAR TIMUR, KOTA DENPASAR, BALI",26,155,17,172
https://kawalpemilu.org#53990,"SUMERTA KELOD, DENPASAR TIMUR, KOTA DENPASAR, BALI",27,167,12,179
https://kawalpemilu.org#53990,"SUMERTA KELOD, DENPASAR TIMUR, KOTA DENPASAR, BALI",28,186,12,198
https://kawalpemilu.org#53990,"SUMERTA KELOD, DENPASAR TIMUR, KOTA DENPASAR, BALI",29,192,10,202
https://kawalpemilu.org#53990,"SUMERTA KELOD, DENPASAR TIMUR, KOTA DENPASAR, BALI",30,179,20,199
https://kawalpemilu.org#53990,"SUMERTA KELOD, DENPASAR TIMUR, KOTA DENPASAR, BALI",31,207,16,223
https://kawalpemilu.org#53990,"SUMERTA KELOD, DENPASAR TIMUR, KOTA DENPASAR, BALI",32,197,14,211
https://kawalpemilu.org#53990,"SUMERTA KELOD, DENPASAR TIMUR, KOTA DENPASAR, BALI",33,146,10,156
https://kawalpemilu.org#53990,"SUMERTA KELOD, DENPASAR TIMUR, KOTA DENPASAR, BALI",34,154,14,168
https://kawalpemilu.org#53990,"SUMERTA KELOD, DENPASAR TIMUR, KOTA DENPASAR, BALI",35,155,14,169
https://kawalpemilu.org#53990,"SUMERTA KELOD, DENPASAR TIMUR, KOTA DENPASAR, BALI",36,180,28,208
https://kawalpemilu.org#53990,"SUMERTA KELOD, DENPASAR TIMUR, KOTA DENPASAR, BALI",37,197,14,211
https://kawalpemilu.org#53990,"SUMERTA KELOD, DENPASAR TIMUR, KOTA DENPASAR, BALI",38,174,30,204
https://kawalpemilu.org#53990,"SUMERTA KELOD, DENPASAR TIMUR, KOTA DENPASAR, BALI",39,138,18,156
https://kawalpemilu.org#53991,"KESIMAN PETILAN, DENPASAR TIMUR, KOTA DENPASAR, BALI",1,222,9,231
https://kawalpemilu.org#53991,"KESIMAN PETILAN, DENPASAR TIMUR, KOTA DENPASAR, BALI",2,209,4,213
https://kawalpemilu.org#53991,"KESIMAN PETILAN, DENPASAR TIMUR, KOTA DENPASAR, BALI",3,256,3,259
https://kawalpemilu.org#53991,"KESIMAN PETILAN, DENPASAR TIMUR, KOTA DENPASAR, BALI",4,209,11,220
https://kawalpemilu.org#53991,"KESIMAN PETILAN, DENPASAR TIMUR, KOTA DENPASAR, BALI",5,238,6,244
https://kawalpemilu.org#53991,"KESIMAN PETILAN, DENPASAR TIMUR, KOTA DENPASAR, BALI",6,216,10,226
https://kawalpemilu.org#53991,"KESIMAN PETILAN, DENPASAR TIMUR, KOTA DENPASAR, BALI",7,221,15,236
https://kawalpemilu.org#53991,"KESIMAN PETILAN, DENPASAR TIMUR, KOTA DENPASAR, BALI",8,230,6,236
https://kawalpemilu.org#53991,"KESIMAN PETILAN, DENPASAR TIMUR, KOTA DENPASAR, BALI",9,225,4,229
https://kawalpemilu.org#53991,"KESIMAN PETILAN, DENPASAR TIMUR, KOTA DENPASAR, BALI",10,235,5,240
https://kawalpemilu.org#53991,"KESIMAN PETILAN, DENPASAR TIMUR, KOTA DENPASAR, BALI",11,242,9,251
https://kawalpemilu.org#53991,"KESIMAN PETILAN, DENPASAR TIMUR, KOTA DENPASAR, BALI",12,179,19,198
https://kawalpemilu.org#53991,"KESIMAN PETILAN, DENPASAR TIMUR, KOTA DENPASAR, BALI",13,202,13,215
https://kawalpemilu.org#53991,"KESIMAN PETILAN, DENPASAR TIMUR, KOTA DENPASAR, BALI",14,263,5,268
https://kawalpemilu.org#53991,"KESIMAN PETILAN, DENPASAR TIMUR, KOTA DENPASAR, BALI",15,257,5,262
https://kawalpemilu.org#53991,"KESIMAN PETILAN, DENPASAR TIMUR, KOTA DENPASAR, BALI",16,190,14,204
https://kawalpemilu.org#53991,"KESIMAN PETILAN, DENPASAR TIMUR, KOTA DENPASAR, BALI",17,193,11,204
https://kawalpemilu.org#53991,"KESIMAN PETILAN, DENPASAR TIMUR, KOTA DENPASAR, BALI",18,199,11,210
https://kawalpemilu.org#53991,"KESIMAN PETILAN, DENPASAR TIMUR, KOTA DENPASAR, BALI",19,217,5,222
https://kawalpemilu.org#53991,"KESIMAN PETILAN, DENPASAR TIMUR, KOTA DENPASAR, BALI",20,195,10,205
https://kawalpemilu.org#53991,"KESIMAN PETILAN, DENPASAR TIMUR, KOTA DENPASAR, BALI",21,207,6,213
https://kawalpemilu.org#53991,"KESIMAN PETILAN, DENPASAR TIMUR, KOTA DENPASAR, BALI",22,206,10,216
https://kawalpemilu.org#53991,"KESIMAN PETILAN, DENPASAR TIMUR, KOTA DENPASAR, BALI",23,206,11,217
https://kawalpemilu.org#53991,"KESIMAN PETILAN, DENPASAR TIMUR, KOTA DENPASAR, BALI",24,210,1,211
https://kawalpemilu.org#53991,"KESIMAN PETILAN, DENPASAR TIMUR, KOTA DENPASAR, BALI",25,205,3,208
https://kawalpemilu.org#53991,"KESIMAN PETILAN, DENPASAR TIMUR, KOTA DENPASAR, BALI",26,220,10,230
https://kawalpemilu.org#53991,"KESIMAN PETILAN, DENPASAR TIMUR, KOTA DENPASAR, BALI",27,215,7,222
https://kawalpemilu.org#53991,"KESIMAN PETILAN, DENPASAR TIMUR, KOTA DENPASAR, BALI",28,224,4,228
https://kawalpemilu.org#53991,"KESIMAN PETILAN, DENPASAR TIMUR, KOTA DENPASAR, BALI",29,135,16,151
https://kawalpemilu.org#53992,"KESIMAN KERTALANGU, DENPASAR TIMUR, KOTA DENPASAR, BALI",1,256,16,272
https://kawalpemilu.org#53992,"KESIMAN KERTALANGU, DENPASAR TIMUR, KOTA DENPASAR, BALI",2,242,12,254
https://kawalpemilu.org#53992,"KESIMAN KERTALANGU, DENPASAR TIMUR, KOTA DENPASAR, BALI",3,242,5,247
https://kawalpemilu.org#53992,"KESIMAN KERTALANGU, DENPASAR TIMUR, KOTA DENPASAR, BALI",4,231,15,246
https://kawalpemilu.org#53992,"KESIMAN KERTALANGU, DENPASAR TIMUR, KOTA DENPASAR, BALI",5,219,12,231
https://kawalpemilu.org#53992,"KESIMAN KERTALANGU, DENPASAR TIMUR, KOTA DENPASAR, BALI",6,192,24,216
https://kawalpemilu.org#53992,"KESIMAN KERTALANGU, DENPASAR TIMUR, KOTA DENPASAR, BALI",7,209,21,230
https://kawalpemilu.org#53992,"KESIMAN KERTALANGU, DENPASAR TIMUR, KOTA DENPASAR, BALI",8,227,4,231
https://kawalpemilu.org#53992,"KESIMAN KERTALANGU, DENPASAR TIMUR, KOTA DENPASAR, BALI",9,189,15,204
https://kawalpemilu.org#53992,"KESIMAN KERTALANGU, DENPASAR TIMUR, KOTA DENPASAR, BALI",10,196,10,206
https://kawalpemilu.org#53992,"KESIMAN KERTALANGU, DENPASAR TIMUR, KOTA DENPASAR, BALI",11,192,6,198
https://kawalpemilu.org#53992,"KESIMAN KERTALANGU, DENPASAR TIMUR, KOTA DENPASAR, BALI",12,187,8,195
https://kawalpemilu.org#53992,"KESIMAN KERTALANGU, DENPASAR TIMUR, KOTA DENPASAR, BALI",13,210,17,227
https://kawalpemilu.org#53992,"KESIMAN KERTALANGU, DENPASAR TIMUR, KOTA DENPASAR, BALI",14,193,17,210
https://kawalpemilu.org#53992,"KESIMAN KERTALANGU, DENPASAR TIMUR, KOTA DENPASAR, BALI",15,199,8,207
https://kawalpemilu.org#53992,"KESIMAN KERTALANGU, DENPASAR TIMUR, KOTA DENPASAR, BALI",16,211,5,216
https://kawalpemilu.org#53992,"KESIMAN KERTALANGU, DENPASAR TIMUR, KOTA DENPASAR, BALI",17,190,9,199
https://kawalpemilu.org#53992,"KESIMAN KERTALANGU, DENPASAR TIMUR, KOTA DENPASAR, BALI",18,187,7,194
https://kawalpemilu.org#53992,"KESIMAN KERTALANGU, DENPASAR TIMUR, KOTA DENPASAR, BALI",19,167,7,174
https://kawalpemilu.org#53992,"KESIMAN KERTALANGU, DENPASAR TIMUR, KOTA DENPASAR, BALI",20,211,4,215
https://kawalpemilu.org#53992,"KESIMAN KERTALANGU, DENPASAR TIMUR, KOTA DENPASAR, BALI",21,208,2,210
https://kawalpemilu.org#53992,"KESIMAN KERTALANGU, DENPASAR TIMUR, KOTA DENPASAR, BALI",22,193,5,198
https://kawalpemilu.org#53992,"KESIMAN KERTALANGU, DENPASAR TIMUR, KOTA DENPASAR, BALI",23,207,17,224
https://kawalpemilu.org#53992,"KESIMAN KERTALANGU, DENPASAR TIMUR, KOTA DENPASAR, BALI",24,212,8,220
https://kawalpemilu.org#53992,"KESIMAN KERTALANGU, DENPASAR TIMUR, KOTA DENPASAR, BALI",25,226,10,236
https://kawalpemilu.org#53992,"KESIMAN KERTALANGU, DENPASAR TIMUR, KOTA DENPASAR, BALI",26,174,13,187
https://kawalpemilu.org#53992,"KESIMAN KERTALANGU, DENPASAR TIMUR, KOTA DENPASAR, BALI",27,196,12,208
https://kawalpemilu.org#53992,"KESIMAN KERTALANGU, DENPASAR TIMUR, KOTA DENPASAR, BALI",28,211,14,225
https://kawalpemilu.org#53992,"KESIMAN KERTALANGU, DENPASAR TIMUR, KOTA DENPASAR, BALI",29,217,28,245
https://kawalpemilu.org#53992,"KESIMAN KERTALANGU, DENPASAR TIMUR, KOTA DENPASAR, BALI",30,236,22,258
https://kawalpemilu.org#53992,"KESIMAN KERTALANGU, DENPASAR TIMUR, KOTA DENPASAR, BALI",31,212,16,228
https://kawalpemilu.org#53992,"KESIMAN KERTALANGU, DENPASAR TIMUR, KOTA DENPASAR, BALI",32,223,21,244
https://kawalpemilu.org#53992,"KESIMAN KERTALANGU, DENPASAR TIMUR, KOTA DENPASAR, BALI",33,231,19,250
https://kawalpemilu.org#53992,"KESIMAN KERTALANGU, DENPASAR TIMUR, KOTA DENPASAR, BALI",34,213,24,237
https://kawalpemilu.org#53992,"KESIMAN KERTALANGU, DENPASAR TIMUR, KOTA DENPASAR, BALI",35,216,14,230
https://kawalpemilu.org#53992,"KESIMAN KERTALANGU, DENPASAR TIMUR, KOTA DENPASAR, BALI",36,204,24,228
https://kawalpemilu.org#53992,"KESIMAN KERTALANGU, DENPASAR TIMUR, KOTA DENPASAR, BALI",37,234,12,246
https://kawalpemilu.org#53992,"KESIMAN KERTALANGU, DENPASAR TIMUR, KOTA DENPASAR, BALI",38,205,15,220
https://kawalpemilu.org#53992,"KESIMAN KERTALANGU, DENPASAR TIMUR, KOTA DENPASAR, BALI",39,222,21,243
https://kawalpemilu.org#53992,"KESIMAN KERTALANGU, DENPASAR TIMUR, KOTA DENPASAR, BALI",40,218,21,239
https://kawalpemilu.org#53992,"KESIMAN KERTALANGU, DENPASAR TIMUR, KOTA DENPASAR, BALI",41,235,11,246
https://kawalpemilu.org#53992,"KESIMAN KERTALANGU, DENPASAR TIMUR, KOTA DENPASAR, BALI",42,240,14,254
https://kawalpemilu.org#53992,"KESIMAN KERTALANGU, DENPASAR TIMUR, KOTA DENPASAR, BALI",43,244,10,254
https://kawalpemilu.org#53992,"KESIMAN KERTALANGU, DENPASAR TIMUR, KOTA DENPASAR, BALI",44,261,9,270
https://kawalpemilu.org#53992,"KESIMAN KERTALANGU, DENPASAR TIMUR, KOTA DENPASAR, BALI",45,159,29,188
https://kawalpemilu.org#53992,"KESIMAN KERTALANGU, DENPASAR TIMUR, KOTA DENPASAR, BALI",46,112,8,120
https://kawalpemilu.org#53992,"KESIMAN KERTALANGU, DENPASAR TIMUR, KOTA DENPASAR, BALI",47,155,25,180
https://kawalpemilu.org#53993,"SUMERTA KAJA, DENPASAR TIMUR, KOTA DENPASAR, BALI",1,205,2,207
https://kawalpemilu.org#53993,"SUMERTA KAJA, DENPASAR TIMUR, KOTA DENPASAR, BALI",2,215,12,227
https://kawalpemilu.org#53993,"SUMERTA KAJA, DENPASAR TIMUR, KOTA DENPASAR, BALI",3,205,6,211
https://kawalpemilu.org#53993,"SUMERTA KAJA, DENPASAR TIMUR, KOTA DENPASAR, BALI",4,204,5,209
https://kawalpemilu.org#53993,"SUMERTA KAJA, DENPASAR TIMUR, KOTA DENPASAR, BALI",5,212,13,225
https://kawalpemilu.org#53993,"SUMERTA KAJA, DENPASAR TIMUR, KOTA DENPASAR, BALI",6,222,7,229
https://kawalpemilu.org#53993,"SUMERTA KAJA, DENPASAR TIMUR, KOTA DENPASAR, BALI",7,209,9,218
https://kawalpemilu.org#53993,"SUMERTA KAJA, DENPASAR TIMUR, KOTA DENPASAR, BALI",8,197,6,203
https://kawalpemilu.org#53993,"SUMERTA KAJA, DENPASAR TIMUR, KOTA DENPASAR, BALI",9,212,4,216
https://kawalpemilu.org#53993,"SUMERTA KAJA, DENPASAR TIMUR, KOTA DENPASAR, BALI",10,190,11,201
https://kawalpemilu.org#53993,"SUMERTA KAJA, DENPASAR TIMUR, KOTA DENPASAR, BALI",11,190,11,201
https://kawalpemilu.org#53993,"SUMERTA KAJA, DENPASAR TIMUR, KOTA DENPASAR, BALI",12,227,13,240
https://kawalpemilu.org#53993,"SUMERTA KAJA, DENPASAR TIMUR, KOTA DENPASAR, BALI",13,221,6,227
https://kawalpemilu.org#53993,"SUMERTA KAJA, DENPASAR TIMUR, KOTA DENPASAR, BALI",14,215,8,223
https://kawalpemilu.org#53993,"SUMERTA KAJA, DENPASAR TIMUR, KOTA DENPASAR, BALI",15,198,9,207
https://kawalpemilu.org#53993,"SUMERTA KAJA, DENPASAR TIMUR, KOTA DENPASAR, BALI",16,217,5,222
https://kawalpemilu.org#53993,"SUMERTA KAJA, DENPASAR TIMUR, KOTA DENPASAR, BALI",17,207,7,214
https://kawalpemilu.org#53993,"SUMERTA KAJA, DENPASAR TIMUR, KOTA DENPASAR, BALI",18,191,5,196
https://kawalpemilu.org#53993,"SUMERTA KAJA, DENPASAR TIMUR, KOTA DENPASAR, BALI",19,197,3,200
https://kawalpemilu.org#53993,"SUMERTA KAJA, DENPASAR TIMUR, KOTA DENPASAR, BALI",20,203,11,214
https://kawalpemilu.org#53993,"SUMERTA KAJA, DENPASAR TIMUR, KOTA DENPASAR, BALI",21,175,6,181
https://kawalpemilu.org#53993,"SUMERTA KAJA, DENPASAR TIMUR, KOTA DENPASAR, BALI",22,243,9,252
https://kawalpemilu.org#53993,"SUMERTA KAJA, DENPASAR TIMUR, KOTA DENPASAR, BALI",23,248,5,253
https://kawalpemilu.org#53994,"SUMERTA KAUH, DENPASAR TIMUR, KOTA DENPASAR, BALI",1,194,19,213
https://kawalpemilu.org#53994,"SUMERTA KAUH, DENPASAR TIMUR, KOTA DENPASAR, BALI",2,166,21,187
https://kawalpemilu.org#53994,"SUMERTA KAUH, DENPASAR TIMUR, KOTA DENPASAR, BALI",3,188,23,211
https://kawalpemilu.org#53994,"SUMERTA KAUH, DENPASAR TIMUR, KOTA DENPASAR, BALI",4,232,26,258
https://kawalpemilu.org#53994,"SUMERTA KAUH, DENPASAR TIMUR, KOTA DENPASAR, BALI",5,217,26,243
https://kawalpemilu.org#53994,"SUMERTA KAUH, DENPASAR TIMUR, KOTA DENPASAR, BALI",6,232,25,257
https://kawalpemilu.org#53994,"SUMERTA KAUH, DENPASAR TIMUR, KOTA DENPASAR, BALI",7,209,38,247
https://kawalpemilu.org#53994,"SUMERTA KAUH, DENPASAR TIMUR, KOTA DENPASAR, BALI",8,223,28,251
https://kawalpemilu.org#53994,"SUMERTA KAUH, DENPASAR TIMUR, KOTA DENPASAR, BALI",9,211,20,231
https://kawalpemilu.org#53994,"SUMERTA KAUH, DENPASAR TIMUR, KOTA DENPASAR, BALI",10,225,21,246
https://kawalpemilu.org#53994,"SUMERTA KAUH, DENPASAR TIMUR, KOTA DENPASAR, BALI",11,215,16,231
https://kawalpemilu.org#53994,"SUMERTA KAUH, DENPASAR TIMUR, KOTA DENPASAR, BALI",12,231,7,238
https://kawalpemilu.org#53994,"SUMERTA KAUH, DENPASAR TIMUR, KOTA DENPASAR, BALI",13,225,14,239
https://kawalpemilu.org#53994,"SUMERTA KAUH, DENPASAR TIMUR, KOTA DENPASAR, BALI",14,220,7,227
https://kawalpemilu.org#53994,"SUMERTA KAUH, DENPASAR TIMUR, KOTA DENPASAR, BALI",15,200,2,202
https://kawalpemilu.org#53994,"SUMERTA KAUH, DENPASAR TIMUR, KOTA DENPASAR, BALI",16,173,12,185
https://kawalpemilu.org#53994,"SUMERTA KAUH, DENPASAR TIMUR, KOTA DENPASAR, BALI",17,186,7,193
https://kawalpemilu.org#53994,"SUMERTA KAUH, DENPASAR TIMUR, KOTA DENPASAR, BALI",18,193,13,206
https://kawalpemilu.org#53994,"SUMERTA KAUH, DENPASAR TIMUR, KOTA DENPASAR, BALI",19,202,5,207
https://kawalpemilu.org#53995,"PENATIH DANGIN PURI, DENPASAR TIMUR, KOTA DENPASAR, BALI",1,249,14,263
https://kawalpemilu.org#53995,"PENATIH DANGIN PURI, DENPASAR TIMUR, KOTA DENPASAR, BALI",2,244,12,256
https://kawalpemilu.org#53995,"PENATIH DANGIN PURI, DENPASAR TIMUR, KOTA DENPASAR, BALI",3,236,11,247
https://kawalpemilu.org#53995,"PENATIH DANGIN PURI, DENPASAR TIMUR, KOTA DENPASAR, BALI",4,235,23,258
https://kawalpemilu.org#53995,"PENATIH DANGIN PURI, DENPASAR TIMUR, KOTA DENPASAR, BALI",5,226,16,242
https://kawalpemilu.org#53995,"PENATIH DANGIN PURI, DENPASAR TIMUR, KOTA DENPASAR, BALI",6,229,23,252
https://kawalpemilu.org#53995,"PENATIH DANGIN PURI, DENPASAR TIMUR, KOTA DENPASAR, BALI",7,234,14,248
https://kawalpemilu.org#53995,"PENATIH DANGIN PURI, DENPASAR TIMUR, KOTA DENPASAR, BALI",8,229,28,257
https://kawalpemilu.org#53995,"PENATIH DANGIN PURI, DENPASAR TIMUR, KOTA DENPASAR, BALI",9,232,23,255
https://kawalpemilu.org#53995,"PENATIH DANGIN PURI, DENPASAR TIMUR, KOTA DENPASAR, BALI",10,240,15,255
https://kawalpemilu.org#53995,"PENATIH DANGIN PURI, DENPASAR TIMUR, KOTA DENPASAR, BALI",11,235,18,253
https://kawalpemilu.org#53995,"PENATIH DANGIN PURI, DENPASAR TIMUR, KOTA DENPASAR, BALI",12,192,14,206
https://kawalpemilu.org#53995,"PENATIH DANGIN PURI, DENPASAR TIMUR, KOTA DENPASAR, BALI",13,192,5,197
https://kawalpemilu.org#53995,"PENATIH DANGIN PURI, DENPASAR TIMUR, KOTA DENPASAR, BALI",14,225,3,228
https://kawalpemilu.org#53995,"PENATIH DANGIN PURI, DENPASAR TIMUR, KOTA DENPASAR, BALI",15,223,4,227
https://kawalpemilu.org#53995,"PENATIH DANGIN PURI, DENPASAR TIMUR, KOTA DENPASAR, BALI",16,217,10,227
https://kawalpemilu.org#53995,"PENATIH DANGIN PURI, DENPASAR TIMUR, KOTA DENPASAR, BALI",17,219,14,233
https://kawalpemilu.org#53995,"PENATIH DANGIN PURI, DENPASAR TIMUR, KOTA DENPASAR, BALI",18,240,4,244
https://kawalpemilu.org#53995,"PENATIH DANGIN PURI, DENPASAR TIMUR, KOTA DENPASAR, BALI",19,206,10,216
https://kawalpemilu.org#53995,"PENATIH DANGIN PURI, DENPASAR TIMUR, KOTA DENPASAR, BALI",20,98,9,107
https://kawalpemilu.org#53997,"PADANGSAMBIAN KELOD, DENPASAR BARAT, KOTA DENPASAR, BALI",1,177,14,191
https://kawalpemilu.org#53997,"PADANGSAMBIAN KELOD, DENPASAR BARAT, KOTA DENPASAR, BALI",2,198,17,215
https://kawalpemilu.org#53997,"PADANGSAMBIAN KELOD, DENPASAR BARAT, KOTA DENPASAR, BALI",3,177,21,198
https://kawalpemilu.org#53997,"PADANGSAMBIAN KELOD, DENPASAR BARAT, KOTA DENPASAR, BALI",4,163,22,185
https://kawalpemilu.org#53997,"PADANGSAMBIAN KELOD, DENPASAR BARAT, KOTA DENPASAR, BALI",5,179,16,195
https://kawalpemilu.org#53997,"PADANGSAMBIAN KELOD, DENPASAR BARAT, KOTA DENPASAR, BALI",6,155,27,182
https://kawalpemilu.org#53997,"PADANGSAMBIAN KELOD, DENPASAR BARAT, KOTA DENPASAR, BALI",7,177,22,199
https://kawalpemilu.org#53997,"PADANGSAMBIAN KELOD, DENPASAR BARAT, KOTA DENPASAR, BALI",8,152,22,174
https://kawalpemilu.org#53997,"PADANGSAMBIAN KELOD, DENPASAR BARAT, KOTA DENPASAR, BALI",9,138,83,221
https://kawalpemilu.org#53997,"PADANGSAMBIAN KELOD, DENPASAR BARAT, KOTA DENPASAR, BALI",10,160,49,209
https://kawalpemilu.org#53997,"PADANGSAMBIAN KELOD, DENPASAR BARAT, KOTA DENPASAR, BALI",11,167,59,226
https://kawalpemilu.org#53997,"PADANGSAMBIAN KELOD, DENPASAR BARAT, KOTA DENPASAR, BALI",12,157,35,192
https://kawalpemilu.org#53997,"PADANGSAMBIAN KELOD, DENPASAR BARAT, KOTA DENPASAR, BALI",13,147,31,178
https://kawalpemilu.org#53997,"PADANGSAMBIAN KELOD, DENPASAR BARAT, KOTA DENPASAR, BALI",14,230,15,245
https://kawalpemilu.org#53997,"PADANGSAMBIAN KELOD, DENPASAR BARAT, KOTA DENPASAR, BALI",15,223,27,250
https://kawalpemilu.org#53997,"PADANGSAMBIAN KELOD, DENPASAR BARAT, KOTA DENPASAR, BALI",16,230,11,241
https://kawalpemilu.org#53997,"PADANGSAMBIAN KELOD, DENPASAR BARAT, KOTA DENPASAR, BALI",17,238,24,262
https://kawalpemilu.org#53997,"PADANGSAMBIAN KELOD, DENPASAR BARAT, KOTA DENPASAR, BALI",18,224,20,244
https://kawalpemilu.org#53997,"PADANGSAMBIAN KELOD, DENPASAR BARAT, KOTA DENPASAR, BALI",19,232,17,249
https://kawalpemilu.org#53997,"PADANGSAMBIAN KELOD, DENPASAR BARAT, KOTA DENPASAR, BALI",20,208,26,234
https://kawalpemilu.org#53997,"PADANGSAMBIAN KELOD, DENPASAR BARAT, KOTA DENPASAR, BALI",21,210,13,223
https://kawalpemilu.org#53997,"PADANGSAMBIAN KELOD, DENPASAR BARAT, KOTA DENPASAR, BALI",22,217,16,233
https://kawalpemilu.org#53997,"PADANGSAMBIAN KELOD, DENPASAR BARAT, KOTA DENPASAR, BALI",23,184,14,198
https://kawalpemilu.org#53997,"PADANGSAMBIAN KELOD, DENPASAR BARAT, KOTA DENPASAR, BALI",24,174,18,192
https://kawalpemilu.org#53997,"PADANGSAMBIAN KELOD, DENPASAR BARAT, KOTA DENPASAR, BALI",25,203,15,218
https://kawalpemilu.org#53997,"PADANGSAMBIAN KELOD, DENPASAR BARAT, KOTA DENPASAR, BALI",26,193,15,208
https://kawalpemilu.org#53997,"PADANGSAMBIAN KELOD, DENPASAR BARAT, KOTA DENPASAR, BALI",27,202,25,227
https://kawalpemilu.org#53997,"PADANGSAMBIAN KELOD, DENPASAR BARAT, KOTA DENPASAR, BALI",28,187,21,208
https://kawalpemilu.org#53997,"PADANGSAMBIAN KELOD, DENPASAR BARAT, KOTA DENPASAR, BALI",29,202,23,225
https://kawalpemilu.org#53997,"PADANGSAMBIAN KELOD, DENPASAR BARAT, KOTA DENPASAR, BALI",30,183,12,195
https://kawalpemilu.org#53997,"PADANGSAMBIAN KELOD, DENPASAR BARAT, KOTA DENPASAR, BALI",31,225,26,251
https://kawalpemilu.org#53997,"PADANGSAMBIAN KELOD, DENPASAR BARAT, KOTA DENPASAR, BALI",32,228,13,241
https://kawalpemilu.org#53997,"PADANGSAMBIAN KELOD, DENPASAR BARAT, KOTA DENPASAR, BALI",33,193,25,218
https://kawalpemilu.org#53997,"PADANGSAMBIAN KELOD, DENPASAR BARAT, KOTA DENPASAR, BALI",34,181,19,200
https://kawalpemilu.org#53997,"PADANGSAMBIAN KELOD, DENPASAR BARAT, KOTA DENPASAR, BALI",35,226,9,235
https://kawalpemilu.org#53997,"PADANGSAMBIAN KELOD, DENPASAR BARAT, KOTA DENPASAR, BALI",36,210,14,224
https://kawalpemilu.org#53997,"PADANGSAMBIAN KELOD, DENPASAR BARAT, KOTA DENPASAR, BALI",37,197,16,213
https://kawalpemilu.org#53997,"PADANGSAMBIAN KELOD, DENPASAR BARAT, KOTA DENPASAR, BALI",38,214,25,239
https://kawalpemilu.org#53997,"PADANGSAMBIAN KELOD, DENPASAR BARAT, KOTA DENPASAR, BALI",39,216,20,236
https://kawalpemilu.org#53997,"PADANGSAMBIAN KELOD, DENPASAR BARAT, KOTA DENPASAR, BALI",40,234,37,271
https://kawalpemilu.org#53997,"PADANGSAMBIAN KELOD, DENPASAR BARAT, KOTA DENPASAR, BALI",41,202,22,224
https://kawalpemilu.org#53997,"PADANGSAMBIAN KELOD, DENPASAR BARAT, KOTA DENPASAR, BALI",42,182,21,203
https://kawalpemilu.org#53997,"PADANGSAMBIAN KELOD, DENPASAR BARAT, KOTA DENPASAR, BALI",43,190,10,200
https://kawalpemilu.org#53997,"PADANGSAMBIAN KELOD, DENPASAR BARAT, KOTA DENPASAR, BALI",44,197,33,230
https://kawalpemilu.org#53997,"PADANGSAMBIAN KELOD, DENPASAR BARAT, KOTA DENPASAR, BALI",45,204,29,233
https://kawalpemilu.org#53997,"PADANGSAMBIAN KELOD, DENPASAR BARAT, KOTA DENPASAR, BALI",46,173,11,184
https://kawalpemilu.org#53997,"PADANGSAMBIAN KELOD, DENPASAR BARAT, KOTA DENPASAR, BALI",47,192,10,202
https://kawalpemilu.org#53997,"PADANGSAMBIAN KELOD, DENPASAR BARAT, KOTA DENPASAR, BALI",48,158,29,187
https://kawalpemilu.org#53997,"PADANGSAMBIAN KELOD, DENPASAR BARAT, KOTA DENPASAR, BALI",49,157,23,180
https://kawalpemilu.org#53997,"PADANGSAMBIAN KELOD, DENPASAR BARAT, KOTA DENPASAR, BALI",50,230,3,233
https://kawalpemilu.org#53997,"PADANGSAMBIAN KELOD, DENPASAR BARAT, KOTA DENPASAR, BALI",51,197,14,211
https://kawalpemilu.org#53997,"PADANGSAMBIAN KELOD, DENPASAR BARAT, KOTA DENPASAR, BALI",52,184,18,202
https://kawalpemilu.org#53997,"PADANGSAMBIAN KELOD, DENPASAR BARAT, KOTA DENPASAR, BALI",53,204,19,223
https://kawalpemilu.org#53997,"PADANGSAMBIAN KELOD, DENPASAR BARAT, KOTA DENPASAR, BALI",54,196,19,215
https://kawalpemilu.org#53997,"PADANGSAMBIAN KELOD, DENPASAR BARAT, KOTA DENPASAR, BALI",55,89,16,105
https://kawalpemilu.org#53997,"PADANGSAMBIAN KELOD, DENPASAR BARAT, KOTA DENPASAR, BALI",56,160,15,175
https://kawalpemilu.org#53997,"PADANGSAMBIAN KELOD, DENPASAR BARAT, KOTA DENPASAR, BALI",57,103,19,122
https://kawalpemilu.org#53998,"PEMECUTAN KELOD, DENPASAR BARAT, KOTA DENPASAR, BALI",1,193,29,222
https://kawalpemilu.org#53998,"PEMECUTAN KELOD, DENPASAR BARAT, KOTA DENPASAR, BALI",2,185,43,228
https://kawalpemilu.org#53998,"PEMECUTAN KELOD, DENPASAR BARAT, KOTA DENPASAR, BALI",3,242,13,255
https://kawalpemilu.org#53998,"PEMECUTAN KELOD, DENPASAR BARAT, KOTA DENPASAR, BALI",4,193,15,208
https://kawalpemilu.org#53998,"PEMECUTAN KELOD, DENPASAR BARAT, KOTA DENPASAR, BALI",5,206,9,215
https://kawalpemilu.org#53998,"PEMECUTAN KELOD, DENPASAR BARAT, KOTA DENPASAR, BALI",6,177,16,193
https://kawalpemilu.org#53998,"PEMECUTAN KELOD, DENPASAR BARAT, KOTA DENPASAR, BALI",7,150,18,168
https://kawalpemilu.org#53998,"PEMECUTAN KELOD, DENPASAR BARAT, KOTA DENPASAR, BALI",8,210,10,220
https://kawalpemilu.org#53998,"PEMECUTAN KELOD, DENPASAR BARAT, KOTA DENPASAR, BALI",9,187,19,206
https://kawalpemilu.org#53998,"PEMECUTAN KELOD, DENPASAR BARAT, KOTA DENPASAR, BALI",10,189,22,211
https://kawalpemilu.org#53998,"PEMECUTAN KELOD, DENPASAR BARAT, KOTA DENPASAR, BALI",11,235,18,253
https://kawalpemilu.org#53998,"PEMECUTAN KELOD, DENPASAR BARAT, KOTA DENPASAR, BALI",12,216,24,240
https://kawalpemilu.org#53998,"PEMECUTAN KELOD, DENPASAR BARAT, KOTA DENPASAR, BALI",13,206,41,247
https://kawalpemilu.org#53998,"PEMECUTAN KELOD, DENPASAR BARAT, KOTA DENPASAR, BALI",14,208,40,248
https://kawalpemilu.org#53998,"PEMECUTAN KELOD, DENPASAR BARAT, KOTA DENPASAR, BALI",15,194,34,228
https://kawalpemilu.org#53998,"PEMECUTAN KELOD, DENPASAR BARAT, KOTA DENPASAR, BALI",16,204,37,241
https://kawalpemilu.org#53998,"PEMECUTAN KELOD, DENPASAR BARAT, KOTA DENPASAR, BALI",17,204,37,241
https://kawalpemilu.org#53998,"PEMECUTAN KELOD, DENPASAR BARAT, KOTA DENPASAR, BALI",18,214,16,230
https://kawalpemilu.org#53998,"PEMECUTAN KELOD, DENPASAR BARAT, KOTA DENPASAR, BALI",19,174,31,205
https://kawalpemilu.org#53998,"PEMECUTAN KELOD, DENPASAR BARAT, KOTA DENPASAR, BALI",20,158,21,179
https://kawalpemilu.org#53998,"PEMECUTAN KELOD, DENPASAR BARAT, KOTA DENPASAR, BALI",21,165,28,193
https://kawalpemilu.org#53998,"PEMECUTAN KELOD, DENPASAR BARAT, KOTA DENPASAR, BALI",22,177,55,232
https://kawalpemilu.org#53998,"PEMECUTAN KELOD, DENPASAR BARAT, KOTA DENPASAR, BALI",23,180,66,246
https://kawalpemilu.org#53998,"PEMECUTAN KELOD, DENPASAR BARAT, KOTA DENPASAR, BALI",24,167,33,200
https://kawalpemilu.org#53998,"PEMECUTAN KELOD, DENPASAR BARAT, KOTA DENPASAR, BALI",25,176,38,214
https://kawalpemilu.org#53998,"PEMECUTAN KELOD, DENPASAR BARAT, KOTA DENPASAR, BALI",26,168,49,217
https://kawalpemilu.org#53998,"PEMECUTAN KELOD, DENPASAR BARAT, KOTA DENPASAR, BALI",27,145,42,187
https://kawalpemilu.org#53998,"PEMECUTAN KELOD, DENPASAR BARAT, KOTA DENPASAR, BALI",28,137,45,182
https://kawalpemilu.org#53998,"PEMECUTAN KELOD, DENPASAR BARAT, KOTA DENPASAR, BALI",29,142,27,169
https://kawalpemilu.org#53998,"PEMECUTAN KELOD, DENPASAR BARAT, KOTA DENPASAR, BALI",30,142,51,193
https://kawalpemilu.org#53998,"PEMECUTAN KELOD, DENPASAR BARAT, KOTA DENPASAR, BALI",31,174,33,207
https://kawalpemilu.org#53998,"PEMECUTAN KELOD, DENPASAR BARAT, KOTA DENPASAR, BALI",32,210,44,254
https://kawalpemilu.org#53998,"PEMECUTAN KELOD, DENPASAR BARAT, KOTA DENPASAR, BALI",33,213,47,260
https://kawalpemilu.org#53998,"PEMECUTAN KELOD, DENPASAR BARAT, KOTA DENPASAR, BALI",34,183,46,229
https://kawalpemilu.org#53998,"PEMECUTAN KELOD, DENPASAR BARAT, KOTA DENPASAR, BALI",35,185,54,239
https://kawalpemilu.org#53998,"PEMECUTAN KELOD, DENPASAR BARAT, KOTA DENPASAR, BALI",36,202,38,240
https://kawalpemilu.org#53998,"PEMECUTAN KELOD, DENPASAR BARAT, KOTA DENPASAR, BALI",37,202,38,240
https://kawalpemilu.org#53998,"PEMECUTAN KELOD, DENPASAR BARAT, KOTA DENPASAR, BALI",38,183,13,196
https://kawalpemilu.org#53998,"PEMECUTAN KELOD, DENPASAR BARAT, KOTA DENPASAR, BALI",39,168,13,181
https://kawalpemilu.org#53998,"PEMECUTAN KELOD, DENPASAR BARAT, KOTA DENPASAR, BALI",40,148,18,166
https://kawalpemilu.org#53998,"PEMECUTAN KELOD, DENPASAR BARAT, KOTA DENPASAR, BALI",41,147,35,182
https://kawalpemilu.org#53998,"PEMECUTAN KELOD, DENPASAR BARAT, KOTA DENPASAR, BALI",42,157,25,182
https://kawalpemilu.org#53998,"PEMECUTAN KELOD, DENPASAR BARAT, KOTA DENPASAR, BALI",43,234,22,256
https://kawalpemilu.org#53998,"PEMECUTAN KELOD, DENPASAR BARAT, KOTA DENPASAR, BALI",44,186,30,216
https://kawalpemilu.org#53998,"PEMECUTAN KELOD, DENPASAR BARAT, KOTA DENPASAR, BALI",45,163,26,189
https://kawalpemilu.org#53998,"PEMECUTAN KELOD, DENPASAR BARAT, KOTA DENPASAR, BALI",46,211,15,226
https://kawalpemilu.org#53998,"PEMECUTAN KELOD, DENPASAR BARAT, KOTA DENPASAR, BALI",47,180,47,227
https://kawalpemilu.org#53998,"PEMECUTAN KELOD, DENPASAR BARAT, KOTA DENPASAR, BALI",48,144,73,217
https://kawalpemilu.org#53998,"PEMECUTAN KELOD, DENPASAR BARAT, KOTA DENPASAR, BALI",49,159,43,202
https://kawalpemilu.org#53998,"PEMECUTAN KELOD, DENPASAR BARAT, KOTA DENPASAR, BALI",50,180,33,213
https://kawalpemilu.org#53998,"PEMECUTAN KELOD, DENPASAR BARAT, KOTA DENPASAR, BALI",51,216,36,252
https://kawalpemilu.org#53998,"PEMECUTAN KELOD, DENPASAR BARAT, KOTA DENPASAR, BALI",52,214,46,260
https://kawalpemilu.org#53998,"PEMECUTAN KELOD, DENPASAR BARAT, KOTA DENPASAR, BALI",53,149,44,193
https://kawalpemilu.org#53998,"PEMECUTAN KELOD, DENPASAR BARAT, KOTA DENPASAR, BALI",54,169,60,229
https://kawalpemilu.org#53998,"PEMECUTAN KELOD, DENPASAR BARAT, KOTA DENPASAR, BALI",55,175,30,205
https://kawalpemilu.org#53998,"PEMECUTAN KELOD, DENPASAR BARAT, KOTA DENPASAR, BALI",56,174,26,200
https://kawalpemilu.org#53998,"PEMECUTAN KELOD, DENPASAR BARAT, KOTA DENPASAR, BALI",57,232,15,247
https://kawalpemilu.org#53998,"PEMECUTAN KELOD, DENPASAR BARAT, KOTA DENPASAR, BALI",58,214,16,230
https://kawalpemilu.org#53998,"PEMECUTAN KELOD, DENPASAR BARAT, KOTA DENPASAR, BALI",59,158,34,192
https://kawalpemilu.org#53998,"PEMECUTAN KELOD, DENPASAR BARAT, KOTA DENPASAR, BALI",60,154,47,201
https://kawalpemilu.org#53998,"PEMECUTAN KELOD, DENPASAR BARAT, KOTA DENPASAR, BALI",61,177,36,213
https://kawalpemilu.org#53998,"PEMECUTAN KELOD, DENPASAR BARAT, KOTA DENPASAR, BALI",62,175,50,225
https://kawalpemilu.org#53998,"PEMECUTAN KELOD, DENPASAR BARAT, KOTA DENPASAR, BALI",63,173,51,224
https://kawalpemilu.org#53998,"PEMECUTAN KELOD, DENPASAR BARAT, KOTA DENPASAR, BALI",64,196,22,218
https://kawalpemilu.org#53998,"PEMECUTAN KELOD, DENPASAR BARAT, KOTA DENPASAR, BALI",65,218,10,228
https://kawalpemilu.org#53998,"PEMECUTAN KELOD, DENPASAR BARAT, KOTA DENPASAR, BALI",66,252,15,267
https://kawalpemilu.org#53998,"PEMECUTAN KELOD, DENPASAR BARAT, KOTA DENPASAR, BALI",67,230,3,233
https://kawalpemilu.org#53998,"PEMECUTAN KELOD, DENPASAR BARAT, KOTA DENPASAR, BALI",68,241,4,245
https://kawalpemilu.org#53998,"PEMECUTAN KELOD, DENPASAR BARAT, KOTA DENPASAR, BALI",69,251,3,254
https://kawalpemilu.org#53998,"PEMECUTAN KELOD, DENPASAR BARAT, KOTA DENPASAR, BALI",70,194,26,220
https://kawalpemilu.org#53998,"PEMECUTAN KELOD, DENPASAR BARAT, KOTA DENPASAR, BALI",71,213,33,246
https://kawalpemilu.org#53998,"PEMECUTAN KELOD, DENPASAR BARAT, KOTA DENPASAR, BALI",72,217,14,231
https://kawalpemilu.org#53998,"PEMECUTAN KELOD, DENPASAR BARAT, KOTA DENPASAR, BALI",73,215,14,219
https://kawalpemilu.org#53998,"PEMECUTAN KELOD, DENPASAR BARAT, KOTA DENPASAR, BALI",74,197,29,226
https://kawalpemilu.org#53998,"PEMECUTAN KELOD, DENPASAR BARAT, KOTA DENPASAR, BALI",75,213,38,251
https://kawalpemilu.org#53998,"PEMECUTAN KELOD, DENPASAR BARAT, KOTA DENPASAR, BALI",76,153,50,203
https://kawalpemilu.org#53998,"PEMECUTAN KELOD, DENPASAR BARAT, KOTA DENPASAR, BALI",77,146,43,189
https://kawalpemilu.org#53998,"PEMECUTAN KELOD, DENPASAR BARAT, KOTA DENPASAR, BALI",79,195,42,237
https://kawalpemilu.org#53998,"PEMECUTAN KELOD, DENPASAR BARAT, KOTA DENPASAR, BALI",80,130,30,160
https://kawalpemilu.org#53998,"PEMECUTAN KELOD, DENPASAR BARAT, KOTA DENPASAR, BALI",81,161,78,239
https://kawalpemilu.org#53998,"PEMECUTAN KELOD, DENPASAR BARAT, KOTA DENPASAR, BALI",82,129,37,166
https://kawalpemilu.org#53998,"PEMECUTAN KELOD, DENPASAR BARAT, KOTA DENPASAR, BALI",83,155,35,190
https://kawalpemilu.org#53999,"DAUH PURI KAUH, DENPASAR BARAT, KOTA DENPASAR, BALI",1,139,46,185
https://kawalpemilu.org#53999,"DAUH PURI KAUH, DENPASAR BARAT, KOTA DENPASAR, BALI",2,137,28,165
https://kawalpemilu.org#53999,"DAUH PURI KAUH, DENPASAR BARAT, KOTA DENPASAR, BALI",3,141,30,171
https://kawalpemilu.org#53999,"DAUH PURI KAUH, DENPASAR BARAT, KOTA DENPASAR, BALI",4,148,19,167
https://kawalpemilu.org#53999,"DAUH PURI KAUH, DENPASAR BARAT, KOTA DENPASAR, BALI",5,197,9,206
https://kawalpemilu.org#53999,"DAUH PURI KAUH, DENPASAR BARAT, KOTA DENPASAR, BALI",6,135,44,179
https://kawalpemilu.org#53999,"DAUH PURI KAUH, DENPASAR BARAT, KOTA DENPASAR, BALI",7,129,32,161
https://kawalpemilu.org#53999,"DAUH PURI KAUH, DENPASAR BARAT, KOTA DENPASAR, BALI",8,150,42,192
https://kawalpemilu.org#53999,"DAUH PURI KAUH, DENPASAR BARAT, KOTA DENPASAR, BALI",9,187,28,215
https://kawalpemilu.org#53999,"DAUH PURI KAUH, DENPASAR BARAT, KOTA DENPASAR, BALI",10,207,33,240
https://kawalpemilu.org#53999,"DAUH PURI KAUH, DENPASAR BARAT, KOTA DENPASAR, BALI",11,218,23,241
https://kawalpemilu.org#53999,"DAUH PURI KAUH, DENPASAR BARAT, KOTA DENPASAR, BALI",12,216,26,242
https://kawalpemilu.org#53999,"DAUH PURI KAUH, DENPASAR BARAT, KOTA DENPASAR, BALI",13,191,30,221
https://kawalpemilu.org#53999,"DAUH PURI KAUH, DENPASAR BARAT, KOTA DENPASAR, BALI",14,237,16,253
https://kawalpemilu.org#53999,"DAUH PURI KAUH, DENPASAR BARAT, KOTA DENPASAR, BALI",15,221,19,240
https://kawalpemilu.org#53999,"DAUH PURI KAUH, DENPASAR BARAT, KOTA DENPASAR, BALI",16,205,32,237
https://kawalpemilu.org#53999,"DAUH PURI KAUH, DENPASAR BARAT, KOTA DENPASAR, BALI",17,214,10,224
https://kawalpemilu.org#53999,"DAUH PURI KAUH, DENPASAR BARAT, KOTA DENPASAR, BALI",18,203,20,223
https://kawalpemilu.org#53999,"DAUH PURI KAUH, DENPASAR BARAT, KOTA DENPASAR, BALI",19,220,37,257
https://kawalpemilu.org#53999,"DAUH PURI KAUH, DENPASAR BARAT, KOTA DENPASAR, BALI",20,152,61,213
https://kawalpemilu.org#53999,"DAUH PURI KAUH, DENPASAR BARAT, KOTA DENPASAR, BALI",21,205,36,241
https://kawalpemilu.org#53999,"DAUH PURI KAUH, DENPASAR BARAT, KOTA DENPASAR, BALI",22,240,15,255
https://kawalpemilu.org#53999,"DAUH PURI KAUH, DENPASAR BARAT, KOTA DENPASAR, BALI",23,212,37,249
https://kawalpemilu.org#53999,"DAUH PURI KAUH, DENPASAR BARAT, KOTA DENPASAR, BALI",24,219,35,254
https://kawalpemilu.org#53999,"DAUH PURI KAUH, DENPASAR BARAT, KOTA DENPASAR, BALI",25,201,29,230
https://kawalpemilu.org#53999,"DAUH PURI KAUH, DENPASAR BARAT, KOTA DENPASAR, BALI",26,192,30,222
https://kawalpemilu.org#53999,"DAUH PURI KAUH, DENPASAR BARAT, KOTA DENPASAR, BALI",27,184,32,216
https://kawalpemilu.org#53999,"DAUH PURI KAUH, DENPASAR BARAT, KOTA DENPASAR, BALI",28,226,22,248
https://kawalpemilu.org#53999,"DAUH PURI KAUH, DENPASAR BARAT, KOTA DENPASAR, BALI",29,203,27,230
https://kawalpemilu.org#53999,"DAUH PURI KAUH, DENPASAR BARAT, KOTA DENPASAR, BALI",30,192,30,222
https://kawalpemilu.org#53999,"DAUH PURI KAUH, DENPASAR BARAT, KOTA DENPASAR, BALI",31,213,33,246
https://kawalpemilu.org#53999,"DAUH PURI KAUH, DENPASAR BARAT, KOTA DENPASAR, BALI",32,194,29,223
https://kawalpemilu.org#53999,"DAUH PURI KAUH, DENPASAR BARAT, KOTA DENPASAR, BALI",33,237,23,260
https://kawalpemilu.org#53999,"DAUH PURI KAUH, DENPASAR BARAT, KOTA DENPASAR, BALI",34,210,37,247
https://kawalpemilu.org#53999,"DAUH PURI KAUH, DENPASAR BARAT, KOTA DENPASAR, BALI",35,208,23,231
https://kawalpemilu.org#53999,"DAUH PURI KAUH, DENPASAR BARAT, KOTA DENPASAR, BALI",36,200,19,219
https://kawalpemilu.org#54000,"DAUH PURI KELOD, DENPASAR BARAT, KOTA DENPASAR, BALI",1,171,49,220
https://kawalpemilu.org#54000,"DAUH PURI KELOD, DENPASAR BARAT, KOTA DENPASAR, BALI",2,190,39,229
https://kawalpemilu.org#54000,"DAUH PURI KELOD, DENPASAR BARAT, KOTA DENPASAR, BALI",3,181,42,223
https://kawalpemilu.org#54000,"DAUH PURI KELOD, DENPASAR BARAT, KOTA DENPASAR, BALI",4,183,44,227
https://kawalpemilu.org#54000,"DAUH PURI KELOD, DENPASAR BARAT, KOTA DENPASAR, BALI",5,164,57,221
https://kawalpemilu.org#54000,"DAUH PURI KELOD, DENPASAR BARAT, KOTA DENPASAR, BALI",6,170,58,228
https://kawalpemilu.org#54000,"DAUH PURI KELOD, DENPASAR BARAT, KOTA DENPASAR, BALI",7,155,55,210
https://kawalpemilu.org#54000,"DAUH PURI KELOD, DENPASAR BARAT, KOTA DENPASAR, BALI",8,154,31,185
https://kawalpemilu.org#54000,"DAUH PURI KELOD, DENPASAR BARAT, KOTA DENPASAR, BALI",9,164,28,192
https://kawalpemilu.org#54000,"DAUH PURI KELOD, DENPASAR BARAT, KOTA DENPASAR, BALI",10,139,31,170
https://kawalpemilu.org#54000,"DAUH PURI KELOD, DENPASAR BARAT, KOTA DENPASAR, BALI",11,155,32,187
https://kawalpemilu.org#54000,"DAUH PURI KELOD, DENPASAR BARAT, KOTA DENPASAR, BALI",12,230,16,246
https://kawalpemilu.org#54000,"DAUH PURI KELOD, DENPASAR BARAT, KOTA DENPASAR, BALI",13,224,14,238
https://kawalpemilu.org#54000,"DAUH PURI KELOD, DENPASAR BARAT, KOTA DENPASAR, BALI",14,241,24,265
https://kawalpemilu.org#54000,"DAUH PURI KELOD, DENPASAR BARAT, KOTA DENPASAR, BALI",15,215,27,242
https://kawalpemilu.org#54000,"DAUH PURI KELOD, DENPASAR BARAT, KOTA DENPASAR, BALI",16,183,3,186
https://kawalpemilu.org#54000,"DAUH PURI KELOD, DENPASAR BARAT, KOTA DENPASAR, BALI",17,192,15,207
https://kawalpemilu.org#54000,"DAUH PURI KELOD, DENPASAR BARAT, KOTA DENPASAR, BALI",18,178,19,197
https://kawalpemilu.org#54000,"DAUH PURI KELOD, DENPASAR BARAT, KOTA DENPASAR, BALI",19,175,27,202
https://kawalpemilu.org#54000,"DAUH PURI KELOD, DENPASAR BARAT, KOTA DENPASAR, BALI",20,226,34,260
https://kawalpemilu.org#54000,"DAUH PURI KELOD, DENPASAR BARAT, KOTA DENPASAR, BALI",21,219,53,272
https://kawalpemilu.org#54000,"DAUH PURI KELOD, DENPASAR BARAT, KOTA DENPASAR, BALI",22,196,39,235
https://kawalpemilu.org#54000,"DAUH PURI KELOD, DENPASAR BARAT, KOTA DENPASAR, BALI",23,177,30,207
https://kawalpemilu.org#54000,"DAUH PURI KELOD, DENPASAR BARAT, KOTA DENPASAR, BALI",24,176,36,212
https://kawalpemilu.org#54000,"DAUH PURI KELOD, DENPASAR BARAT, KOTA DENPASAR, BALI",25,192,47,239
https://kawalpemilu.org#54000,"DAUH PURI KELOD, DENPASAR BARAT, KOTA DENPASAR, BALI",26,110,144,254
https://kawalpemilu.org#54000,"DAUH PURI KELOD, DENPASAR BARAT, KOTA DENPASAR, BALI",27,118,123,241
https://kawalpemilu.org#54000,"DAUH PURI KELOD, DENPASAR BARAT, KOTA DENPASAR, BALI",28,209,30,239
https://kawalpemilu.org#54000,"DAUH PURI KELOD, DENPASAR BARAT, KOTA DENPASAR, BALI",29,211,18,229
https://kawalpemilu.org#54000,"DAUH PURI KELOD, DENPASAR BARAT, KOTA DENPASAR, BALI",30,168,57,225
https://kawalpemilu.org#54000,"DAUH PURI KELOD, DENPASAR BARAT, KOTA DENPASAR, BALI",31,174,29,203
https://kawalpemilu.org#54000,"DAUH PURI KELOD, DENPASAR BARAT, KOTA DENPASAR, BALI",32,184,19,203
https://kawalpemilu.org#54000,"DAUH PURI KELOD, DENPASAR BARAT, KOTA DENPASAR, BALI",33,178,38,216
https://kawalpemilu.org#54001,"DAUH PURI, DENPASAR BARAT, KOTA DENPASAR, BALI",1,86,124,210
https://kawalpemilu.org#54001,"DAUH PURI, DENPASAR BARAT, KOTA DENPASAR, BALI",2,86,119,205
https://kawalpemilu.org#54001,"DAUH PURI, DENPASAR BARAT, KOTA DENPASAR, BALI",3,75,95,170
https://kawalpemilu.org#54001,"DAUH PURI, DENPASAR BARAT, KOTA DENPASAR, BALI",4,75,94,169
https://kawalpemilu.org#54001,"DAUH PURI, DENPASAR BARAT, KOTA DENPASAR, BALI",5,66,74,140
https://kawalpemilu.org#54001,"DAUH PURI, DENPASAR BARAT, KOTA DENPASAR, BALI",6,88,80,172
https://kawalpemilu.org#54001,"DAUH PURI, DENPASAR BARAT, KOTA DENPASAR, BALI",7,103,110,213
https://kawalpemilu.org#54001,"DAUH PURI, DENPASAR BARAT, KOTA DENPASAR, BALI",8,91,113,204
https://kawalpemilu.org#54001,"DAUH PURI, DENPASAR BARAT, KOTA DENPASAR, BALI",9,69,109,178
https://kawalpemilu.org#54001,"DAUH PURI, DENPASAR BARAT, KOTA DENPASAR, BALI",10,143,36,179
https://kawalpemilu.org#54001,"DAUH PURI, DENPASAR BARAT, KOTA DENPASAR, BALI",11,168,27,195
https://kawalpemilu.org#54001,"DAUH PURI, DENPASAR BARAT, KOTA DENPASAR, BALI",12,154,42,196
https://kawalpemilu.org#54001,"DAUH PURI, DENPASAR BARAT, KOTA DENPASAR, BALI",13,80,102,182
https://kawalpemilu.org#54001,"DAUH PURI, DENPASAR BARAT, KOTA DENPASAR, BALI",14,174,31,205
https://kawalpemilu.org#54001,"DAUH PURI, DENPASAR BARAT, KOTA DENPASAR, BALI",15,201,18,219
https://kawalpemilu.org#54001,"DAUH PURI, DENPASAR BARAT, KOTA DENPASAR, BALI",16,145,65,210
https://kawalpemilu.org#54001,"DAUH PURI, DENPASAR BARAT, KOTA DENPASAR, BALI",17,129,60,189
https://kawalpemilu.org#54001,"DAUH PURI, DENPASAR BARAT, KOTA DENPASAR, BALI",18,124,69,193
https://kawalpemilu.org#54001,"DAUH PURI, DENPASAR BARAT, KOTA DENPASAR, BALI",19,185,12,197
https://kawalpemilu.org#54001,"DAUH PURI, DENPASAR BARAT, KOTA DENPASAR, BALI",20,182,6,188
https://kawalpemilu.org#54001,"DAUH PURI, DENPASAR BARAT, KOTA DENPASAR, BALI",21,176,2,178
https://kawalpemilu.org#54001,"DAUH PURI, DENPASAR BARAT, KOTA DENPASAR, BALI",22,157,0,157
https://kawalpemilu.org#54001,"DAUH PURI, DENPASAR BARAT, KOTA DENPASAR, BALI",23,184,7,191
https://kawalpemilu.org#54001,"DAUH PURI, DENPASAR BARAT, KOTA DENPASAR, BALI",24,182,12,194
https://kawalpemilu.org#54001,"DAUH PURI, DENPASAR BARAT, KOTA DENPASAR, BALI",25,98,113,211
https://kawalpemilu.org#54001,"DAUH PURI, DENPASAR BARAT, KOTA DENPASAR, BALI",26,129,67,196
https://kawalpemilu.org#54002,"DAUH PURI KANGIN, DENPASAR BARAT, KOTA DENPASAR, BALI",1,241,10,251
https://kawalpemilu.org#54002,"DAUH PURI KANGIN, DENPASAR BARAT, KOTA DENPASAR, BALI",2,219,12,231
https://kawalpemilu.org#54002,"DAUH PURI KANGIN, DENPASAR BARAT, KOTA DENPASAR, BALI",3,224,4,228
https://kawalpemilu.org#54002,"DAUH PURI KANGIN, DENPASAR BARAT, KOTA DENPASAR, BALI",4,214,4,218
https://kawalpemilu.org#54002,"DAUH PURI KANGIN, DENPASAR BARAT, KOTA DENPASAR, BALI",5,180,6,186
https://kawalpemilu.org#54002,"DAUH PURI KANGIN, DENPASAR BARAT, KOTA DENPASAR, BALI",6,189,13,202
https://kawalpemilu.org#54002,"DAUH PURI KANGIN, DENPASAR BARAT, KOTA DENPASAR, BALI",7,166,12,178
https://kawalpemilu.org#54002,"DAUH PURI KANGIN, DENPASAR BARAT, KOTA DENPASAR, BALI",8,176,2,178
https://kawalpemilu.org#54002,"DAUH PURI KANGIN, DENPASAR BARAT, KOTA DENPASAR, BALI",9,160,4,164
https://kawalpemilu.org#54002,"DAUH PURI KANGIN, DENPASAR BARAT, KOTA DENPASAR, BALI",10,190,15,205
https://kawalpemilu.org#54002,"DAUH PURI KANGIN, DENPASAR BARAT, KOTA DENPASAR, BALI",11,197,5,202
https://kawalpemilu.org#54002,"DAUH PURI KANGIN, DENPASAR BARAT, KOTA DENPASAR, BALI",12,154,6,160
https://kawalpemilu.org#54002,"DAUH PURI KANGIN, DENPASAR BARAT, KOTA DENPASAR, BALI",13,79,55,134
https://kawalpemilu.org#54002,"DAUH PURI KANGIN, DENPASAR BARAT, KOTA DENPASAR, BALI",14,74,74,148
https://kawalpemilu.org#54003,"PEMECUTAN, DENPASAR BARAT, KOTA DENPASAR, BALI",1,158,3,161
https://kawalpemilu.org#54003,"PEMECUTAN, DENPASAR BARAT, KOTA DENPASAR, BALI",2,175,9,184
https://kawalpemilu.org#54003,"PEMECUTAN, DENPASAR BARAT, KOTA DENPASAR, BALI",3,164,12,176
https://kawalpemilu.org#54003,"PEMECUTAN, DENPASAR BARAT, KOTA DENPASAR, BALI",4,168,16,184
https://kawalpemilu.org#54003,"PEMECUTAN, DENPASAR BARAT, KOTA DENPASAR, BALI",5,160,3,163
https://kawalpemilu.org#54003,"PEMECUTAN, DENPASAR BARAT, KOTA DENPASAR, BALI",6,184,2,186
https://kawalpemilu.org#54003,"PEMECUTAN, DENPASAR BARAT, KOTA DENPASAR, BALI",7,177,7,184
https://kawalpemilu.org#54003,"PEMECUTAN, DENPASAR BARAT, KOTA DENPASAR, BALI",8,187,5,192
https://kawalpemilu.org#54003,"PEMECUTAN, DENPASAR BARAT, KOTA DENPASAR, BALI",9,185,6,191
https://kawalpemilu.org#54003,"PEMECUTAN, DENPASAR BARAT, KOTA DENPASAR, BALI",10,193,13,206
https://kawalpemilu.org#54003,"PEMECUTAN, DENPASAR BARAT, KOTA DENPASAR, BALI",11,215,16,231
https://kawalpemilu.org#54003,"PEMECUTAN, DENPASAR BARAT, KOTA DENPASAR, BALI",12,195,29,224
https://kawalpemilu.org#54003,"PEMECUTAN, DENPASAR BARAT, KOTA DENPASAR, BALI",13,167,36,203
https://kawalpemilu.org#54003,"PEMECUTAN, DENPASAR BARAT, KOTA DENPASAR, BALI",14,197,19,216
https://kawalpemilu.org#54003,"PEMECUTAN, DENPASAR BARAT, KOTA DENPASAR, BALI",15,163,24,187
https://kawalpemilu.org#54003,"PEMECUTAN, DENPASAR BARAT, KOTA DENPASAR, BALI",16,166,22,188
https://kawalpemilu.org#54003,"PEMECUTAN, DENPASAR BARAT, KOTA DENPASAR, BALI",17,172,30,202
https://kawalpemilu.org#54003,"PEMECUTAN, DENPASAR BARAT, KOTA DENPASAR, BALI",18,158,31,189
https://kawalpemilu.org#54003,"PEMECUTAN, DENPASAR BARAT, KOTA DENPASAR, BALI",19,164,29,193
https://kawalpemilu.org#54003,"PEMECUTAN, DENPASAR BARAT, KOTA DENPASAR, BALI",20,146,42,188
https://kawalpemilu.org#54003,"PEMECUTAN, DENPASAR BARAT, KOTA DENPASAR, BALI",21,157,39,196
https://kawalpemilu.org#54003,"PEMECUTAN, DENPASAR BARAT, KOTA DENPASAR, BALI",22,157,39,196
https://kawalpemilu.org#54003,"PEMECUTAN, DENPASAR BARAT, KOTA DENPASAR, BALI",23,168,12,5
https://kawalpemilu.org#54003,"PEMECUTAN, DENPASAR BARAT, KOTA DENPASAR, BALI",24,171,23,194
https://kawalpemilu.org#54003,"PEMECUTAN, DENPASAR BARAT, KOTA DENPASAR, BALI",25,153,28,181
https://kawalpemilu.org#54003,"PEMECUTAN, DENPASAR BARAT, KOTA DENPASAR, BALI",26,156,35,191
https://kawalpemilu.org#54003,"PEMECUTAN, DENPASAR BARAT, KOTA DENPASAR, BALI",27,163,26,183
https://kawalpemilu.org#54003,"PEMECUTAN, DENPASAR BARAT, KOTA DENPASAR, BALI",28,156,30,186
https://kawalpemilu.org#54003,"PEMECUTAN, DENPASAR BARAT, KOTA DENPASAR, BALI",29,159,30,190
https://kawalpemilu.org#54003,"PEMECUTAN, DENPASAR BARAT, KOTA DENPASAR, BALI",30,180,27,207
https://kawalpemilu.org#54003,"PEMECUTAN, DENPASAR BARAT, KOTA DENPASAR, BALI",31,178,28,206
https://kawalpemilu.org#54003,"PEMECUTAN, DENPASAR BARAT, KOTA DENPASAR, BALI",32,167,14,181
https://kawalpemilu.org#54003,"PEMECUTAN, DENPASAR BARAT, KOTA DENPASAR, BALI",33,177,17,194
https://kawalpemilu.org#54003,"PEMECUTAN, DENPASAR BARAT, KOTA DENPASAR, BALI",34,189,18,207
https://kawalpemilu.org#54003,"PEMECUTAN, DENPASAR BARAT, KOTA DENPASAR, BALI",35,197,8,205
https://kawalpemilu.org#54003,"PEMECUTAN, DENPASAR BARAT, KOTA DENPASAR, BALI",36,185,16,201
https://kawalpemilu.org#54003,"PEMECUTAN, DENPASAR BARAT, KOTA DENPASAR, BALI",37,179,4,183
https://kawalpemilu.org#54003,"PEMECUTAN, DENPASAR BARAT, KOTA DENPASAR, BALI",38,187,6,193
https://kawalpemilu.org#54003,"PEMECUTAN, DENPASAR BARAT, KOTA DENPASAR, BALI",39,123,43,166
https://kawalpemilu.org#54003,"PEMECUTAN, DENPASAR BARAT, KOTA DENPASAR, BALI",40,128,35,163
https://kawalpemilu.org#54003,"PEMECUTAN, DENPASAR BARAT, KOTA DENPASAR, BALI",41,126,28,154
https://kawalpemilu.org#54003,"PEMECUTAN, DENPASAR BARAT, KOTA DENPASAR, BALI",42,121,49,170
https://kawalpemilu.org#54003,"PEMECUTAN, DENPASAR BARAT, KOTA DENPASAR, BALI",43,104,41,145
https://kawalpemilu.org#54003,"PEMECUTAN, DENPASAR BARAT, KOTA DENPASAR, BALI",44,106,18,124
https://kawalpemilu.org#54003,"PEMECUTAN, DENPASAR BARAT, KOTA DENPASAR, BALI",45,136,26,162
https://kawalpemilu.org#54003,"PEMECUTAN, DENPASAR BARAT, KOTA DENPASAR, BALI",46,120,58,178
https://kawalpemilu.org#54003,"PEMECUTAN, DENPASAR BARAT, KOTA DENPASAR, BALI",47,112,35,147
https://kawalpemilu.org#54003,"PEMECUTAN, DENPASAR BARAT, KOTA DENPASAR, BALI",48,174,36,210
https://kawalpemilu.org#54003,"PEMECUTAN, DENPASAR BARAT, KOTA DENPASAR, BALI",49,187,33,220
https://kawalpemilu.org#54003,"PEMECUTAN, DENPASAR BARAT, KOTA DENPASAR, BALI",50,161,37,198
https://kawalpemilu.org#54003,"PEMECUTAN, DENPASAR BARAT, KOTA DENPASAR, BALI",51,175,7,182
https://kawalpemilu.org#54003,"PEMECUTAN, DENPASAR BARAT, KOTA DENPASAR, BALI",52,175,9,184
https://kawalpemilu.org#54003,"PEMECUTAN, DENPASAR BARAT, KOTA DENPASAR, BALI",53,199,7,206
https://kawalpemilu.org#54003,"PEMECUTAN, DENPASAR BARAT, KOTA DENPASAR, BALI",54,220,5,225
https://kawalpemilu.org#54003,"PEMECUTAN, DENPASAR BARAT, KOTA DENPASAR, BALI",55,177,7,184
https://kawalpemilu.org#54003,"PEMECUTAN, DENPASAR BARAT, KOTA DENPASAR, BALI",56,183,16,199
https://kawalpemilu.org#54003,"PEMECUTAN, DENPASAR BARAT, KOTA DENPASAR, BALI",57,211,13,224
https://kawalpemilu.org#54003,"PEMECUTAN, DENPASAR BARAT, KOTA DENPASAR, BALI",58,184,12,196
https://kawalpemilu.org#54003,"PEMECUTAN, DENPASAR BARAT, KOTA DENPASAR, BALI",59,190,5,195
https://kawalpemilu.org#54003,"PEMECUTAN, DENPASAR BARAT, KOTA DENPASAR, BALI",60,190,23,213
https://kawalpemilu.org#54003,"PEMECUTAN, DENPASAR BARAT, KOTA DENPASAR, BALI",61,203,19,222
https://kawalpemilu.org#54003,"PEMECUTAN, DENPASAR BARAT, KOTA DENPASAR, BALI",62,174,14,188
https://kawalpemilu.org#54003,"PEMECUTAN, DENPASAR BARAT, KOTA DENPASAR, BALI",63,149,12,161
https://kawalpemilu.org#54003,"PEMECUTAN, DENPASAR BARAT, KOTA DENPASAR, BALI",64,155,19,174
https://kawalpemilu.org#54003,"PEMECUTAN, DENPASAR BARAT, KOTA DENPASAR, BALI",65,181,29,210
https://kawalpemilu.org#54003,"PEMECUTAN, DENPASAR BARAT, KOTA DENPASAR, BALI",66,156,29,185
https://kawalpemilu.org#54003,"PEMECUTAN, DENPASAR BARAT, KOTA DENPASAR, BALI",67,175,10,185
https://kawalpemilu.org#54003,"PEMECUTAN, DENPASAR BARAT, KOTA DENPASAR, BALI",68,177,16,193
https://kawalpemilu.org#54003,"PEMECUTAN, DENPASAR BARAT, KOTA DENPASAR, BALI",69,186,23,209
https://kawalpemilu.org#54003,"PEMECUTAN, DENPASAR BARAT, KOTA DENPASAR, BALI",70,182,23,205
https://kawalpemilu.org#54004,"TEGAL HARUM, DENPASAR BARAT, KOTA DENPASAR, BALI",1,160,54,214
https://kawalpemilu.org#54004,"TEGAL HARUM, DENPASAR BARAT, KOTA DENPASAR, BALI",2,168,49,217
https://kawalpemilu.org#54004,"TEGAL HARUM, DENPASAR BARAT, KOTA DENPASAR, BALI",3,132,66,198
https://kawalpemilu.org#54004,"TEGAL HARUM, DENPASAR BARAT, KOTA DENPASAR, BALI",4,145,45,190
https://kawalpemilu.org#54004,"TEGAL HARUM, DENPASAR BARAT, KOTA DENPASAR, BALI",5,183,60,243
https://kawalpemilu.org#54004,"TEGAL HARUM, DENPASAR BARAT, KOTA DENPASAR, BALI",6,175,76,251
https://kawalpemilu.org#54004,"TEGAL HARUM, DENPASAR BARAT, KOTA DENPASAR, BALI",7,172,75,247
https://kawalpemilu.org#54004,"TEGAL HARUM, DENPASAR BARAT, KOTA DENPASAR, BALI",8,206,50,256
https://kawalpemilu.org#54004,"TEGAL HARUM, DENPASAR BARAT, KOTA DENPASAR, BALI",9,183,63,246
https://kawalpemilu.org#54004,"TEGAL HARUM, DENPASAR BARAT, KOTA DENPASAR, BALI",10,165,40,205
https://kawalpemilu.org#54004,"TEGAL HARUM, DENPASAR BARAT, KOTA DENPASAR, BALI",11,175,45,220
https://kawalpemilu.org#54004,"TEGAL HARUM, DENPASAR BARAT, KOTA DENPASAR, BALI",12,177,29,206
https://kawalpemilu.org#54004,"TEGAL HARUM, DENPASAR BARAT, KOTA DENPASAR, BALI",13,128,42,170
https://kawalpemilu.org#54004,"TEGAL HARUM, DENPASAR BARAT, KOTA DENPASAR, BALI",14,139,40,179
https://kawalpemilu.org#54004,"TEGAL HARUM, DENPASAR BARAT, KOTA DENPASAR, BALI",15,132,51,183
https://kawalpemilu.org#54004,"TEGAL HARUM, DENPASAR BARAT, KOTA DENPASAR, BALI",16,121,45,166
https://kawalpemilu.org#54004,"TEGAL HARUM, DENPASAR BARAT, KOTA DENPASAR, BALI",17,132,35,167
https://kawalpemilu.org#54004,"TEGAL HARUM, DENPASAR BARAT, KOTA DENPASAR, BALI",18,197,10,207
https://kawalpemilu.org#54004,"TEGAL HARUM, DENPASAR BARAT, KOTA DENPASAR, BALI",19,190,21,211
https://kawalpemilu.org#54004,"TEGAL HARUM, DENPASAR BARAT, KOTA DENPASAR, BALI",20,210,14,224
https://kawalpemilu.org#54004,"TEGAL HARUM, DENPASAR BARAT, KOTA DENPASAR, BALI",21,212,25,237
https://kawalpemilu.org#54004,"TEGAL HARUM, DENPASAR BARAT, KOTA DENPASAR, BALI",22,159,28,187
https://kawalpemilu.org#54004,"TEGAL HARUM, DENPASAR BARAT, KOTA DENPASAR, BALI",23,204,17,221
https://kawalpemilu.org#54004,"TEGAL HARUM, DENPASAR BARAT, KOTA DENPASAR, BALI",24,192,13,205
https://kawalpemilu.org#54004,"TEGAL HARUM, DENPASAR BARAT, KOTA DENPASAR, BALI",25,189,15,204
https://kawalpemilu.org#54004,"TEGAL HARUM, DENPASAR BARAT, KOTA DENPASAR, BALI",26,189,37,226
https://kawalpemilu.org#54004,"TEGAL HARUM, DENPASAR BARAT, KOTA DENPASAR, BALI",27,175,27,202
https://kawalpemilu.org#54004,"TEGAL HARUM, DENPASAR BARAT, KOTA DENPASAR, BALI",28,192,41,233
https://kawalpemilu.org#54004,"TEGAL HARUM, DENPASAR BARAT, KOTA DENPASAR, BALI",29,210,37,247
https://kawalpemilu.org#54004,"TEGAL HARUM, DENPASAR BARAT, KOTA DENPASAR, BALI",30,195,44,239
https://kawalpemilu.org#54004,"TEGAL HARUM, DENPASAR BARAT, KOTA DENPASAR, BALI",31,204,30,234
https://kawalpemilu.org#54004,"TEGAL HARUM, DENPASAR BARAT, KOTA DENPASAR, BALI",32,191,36,227
https://kawalpemilu.org#54004,"TEGAL HARUM, DENPASAR BARAT, KOTA DENPASAR, BALI",33,176,58,234
https://kawalpemilu.org#54004,"TEGAL HARUM, DENPASAR BARAT, KOTA DENPASAR, BALI",34,185,55,240
https://kawalpemilu.org#54005,"TEGAL KERTHA, DENPASAR BARAT, KOTA DENPASAR, BALI",1,161,65,226
https://kawalpemilu.org#54005,"TEGAL KERTHA, DENPASAR BARAT, KOTA DENPASAR, BALI",2,150,66,216
https://kawalpemilu.org#54005,"TEGAL KERTHA, DENPASAR BARAT, KOTA DENPASAR, BALI",3,123,73,196
https://kawalpemilu.org#54005,"TEGAL KERTHA, DENPASAR BARAT, KOTA DENPASAR, BALI",4,120,100,220
https://kawalpemilu.org#54005,"TEGAL KERTHA, DENPASAR BARAT, KOTA DENPASAR, BALI",5,175,81,256
https://kawalpemilu.org#54005,"TEGAL KERTHA, DENPASAR BARAT, KOTA DENPASAR, BALI",6,138,92,230
https://kawalpemilu.org#54005,"TEGAL KERTHA, DENPASAR BARAT, KOTA DENPASAR, BALI",7,177,69,246
https://kawalpemilu.org#54005,"TEGAL KERTHA, DENPASAR BARAT, KOTA DENPASAR, BALI",8,133,94,227
https://kawalpemilu.org#54005,"TEGAL KERTHA, DENPASAR BARAT, KOTA DENPASAR, BALI",9,126,111,237
https://kawalpemilu.org#54005,"TEGAL KERTHA, DENPASAR BARAT, KOTA DENPASAR, BALI",10,178,65,243
https://kawalpemilu.org#54005,"TEGAL KERTHA, DENPASAR BARAT, KOTA DENPASAR, BALI",11,151,71,222
https://kawalpemilu.org#54005,"TEGAL KERTHA, DENPASAR BARAT, KOTA DENPASAR, BALI",12,153,64,217
https://kawalpemilu.org#54005,"TEGAL KERTHA, DENPASAR BARAT, KOTA DENPASAR, BALI",13,166,65,231
https://kawalpemilu.org#54005,"TEGAL KERTHA, DENPASAR BARAT, KOTA DENPASAR, BALI",14,144,65,209
https://kawalpemilu.org#54005,"TEGAL KERTHA, DENPASAR BARAT, KOTA DENPASAR, BALI",15,146,65,211
https://kawalpemilu.org#54005,"TEGAL KERTHA, DENPASAR BARAT, KOTA DENPASAR, BALI",16,145,53,198
https://kawalpemilu.org#54005,"TEGAL KERTHA, DENPASAR BARAT, KOTA DENPASAR, BALI",17,164,75,239
https://kawalpemilu.org#54005,"TEGAL KERTHA, DENPASAR BARAT, KOTA DENPASAR, BALI",18,181,71,252
https://kawalpemilu.org#54005,"TEGAL KERTHA, DENPASAR BARAT, KOTA DENPASAR, BALI",19,173,78,251
https://kawalpemilu.org#54005,"TEGAL KERTHA, DENPASAR BARAT, KOTA DENPASAR, BALI",20,158,88,246
https://kawalpemilu.org#54005,"TEGAL KERTHA, DENPASAR BARAT, KOTA DENPASAR, BALI",21,180,66,246
https://kawalpemilu.org#54005,"TEGAL KERTHA, DENPASAR BARAT, KOTA DENPASAR, BALI",22,173,40,213
https://kawalpemilu.org#54005,"TEGAL KERTHA, DENPASAR BARAT, KOTA DENPASAR, BALI",23,165,50,215
https://kawalpemilu.org#54005,"TEGAL KERTHA, DENPASAR BARAT, KOTA DENPASAR, BALI",24,175,28,203
https://kawalpemilu.org#54005,"TEGAL KERTHA, DENPASAR BARAT, KOTA DENPASAR, BALI",25,157,71,228
https://kawalpemilu.org#54005,"TEGAL KERTHA, DENPASAR BARAT, KOTA DENPASAR, BALI",26,166,70,236
https://kawalpemilu.org#54005,"TEGAL KERTHA, DENPASAR BARAT, KOTA DENPASAR, BALI",27,155,66,221
https://kawalpemilu.org#54005,"TEGAL KERTHA, DENPASAR BARAT, KOTA DENPASAR, BALI",28,191,56,247
https://kawalpemilu.org#54005,"TEGAL KERTHA, DENPASAR BARAT, KOTA DENPASAR, BALI",29,142,77,219
https://kawalpemilu.org#54005,"TEGAL KERTHA, DENPASAR BARAT, KOTA DENPASAR, BALI",30,156,81,237
https://kawalpemilu.org#54005,"TEGAL KERTHA, DENPASAR BARAT, KOTA DENPASAR, BALI",31,191,33,224
https://kawalpemilu.org#54005,"TEGAL KERTHA, DENPASAR BARAT, KOTA DENPASAR, BALI",32,158,60,218
https://kawalpemilu.org#54005,"TEGAL KERTHA, DENPASAR BARAT, KOTA DENPASAR, BALI",33,186,45,231
https://kawalpemilu.org#54005,"TEGAL KERTHA, DENPASAR BARAT, KOTA DENPASAR, BALI",34,168,45,213
https://kawalpemilu.org#54005,"TEGAL KERTHA, DENPASAR BARAT, KOTA DENPASAR, BALI",35,251,8,259
https://kawalpemilu.org#54005,"TEGAL KERTHA, DENPASAR BARAT, KOTA DENPASAR, BALI",36,238,7,245
https://kawalpemilu.org#54005,"TEGAL KERTHA, DENPASAR BARAT, KOTA DENPASAR, BALI",37,230,10,240
https://kawalpemilu.org#54005,"TEGAL KERTHA, DENPASAR BARAT, KOTA DENPASAR, BALI",38,202,10,212
https://kawalpemilu.org#54005,"TEGAL KERTHA, DENPASAR BARAT, KOTA DENPASAR, BALI",39,196,20,216
https://kawalpemilu.org#54005,"TEGAL KERTHA, DENPASAR BARAT, KOTA DENPASAR, BALI",40,140,21,161
https://kawalpemilu.org#54005,"TEGAL KERTHA, DENPASAR BARAT, KOTA DENPASAR, BALI",41,106,62,168
https://kawalpemilu.org#54006,"PADANGSAMBIAN, DENPASAR BARAT, KOTA DENPASAR, BALI",1,238,4,242
https://kawalpemilu.org#54006,"PADANGSAMBIAN, DENPASAR BARAT, KOTA DENPASAR, BALI",2,220,15,235
https://kawalpemilu.org#54006,"PADANGSAMBIAN, DENPASAR BARAT, KOTA DENPASAR, BALI",3,235,8,243
https://kawalpemilu.org#54006,"PADANGSAMBIAN, DENPASAR BARAT, KOTA DENPASAR, BALI",4,227,12,239
https://kawalpemilu.org#54006,"PADANGSAMBIAN, DENPASAR BARAT, KOTA DENPASAR, BALI",5,234,19,253
https://kawalpemilu.org#54006,"PADANGSAMBIAN, DENPASAR BARAT, KOTA DENPASAR, BALI",6,204,18,222
https://kawalpemilu.org#54006,"PADANGSAMBIAN, DENPASAR BARAT, KOTA DENPASAR, BALI",7,189,9,198
https://kawalpemilu.org#54006,"PADANGSAMBIAN, DENPASAR BARAT, KOTA DENPASAR, BALI",8,197,11,208
https://kawalpemilu.org#54006,"PADANGSAMBIAN, DENPASAR BARAT, KOTA DENPASAR, BALI",9,174,21,195
https://kawalpemilu.org#54006,"PADANGSAMBIAN, DENPASAR BARAT, KOTA DENPASAR, BALI",10,179,13,192
https://kawalpemilu.org#54006,"PADANGSAMBIAN, DENPASAR BARAT, KOTA DENPASAR, BALI",11,201,19,220
https://kawalpemilu.org#54006,"PADANGSAMBIAN, DENPASAR BARAT, KOTA DENPASAR, BALI",12,229,25,254
https://kawalpemilu.org#54006,"PADANGSAMBIAN, DENPASAR BARAT, KOTA DENPASAR, BALI",13,234,42,276
https://kawalpemilu.org#54006,"PADANGSAMBIAN, DENPASAR BARAT, KOTA DENPASAR, BALI",14,214,25,239
https://kawalpemilu.org#54006,"PADANGSAMBIAN, DENPASAR BARAT, KOTA DENPASAR, BALI",15,205,24,229
https://kawalpemilu.org#54006,"PADANGSAMBIAN, DENPASAR BARAT, KOTA DENPASAR, BALI",16,242,11,253
https://kawalpemilu.org#54006,"PADANGSAMBIAN, DENPASAR BARAT, KOTA DENPASAR, BALI",17,238,7,245
https://kawalpemilu.org#54006,"PADANGSAMBIAN, DENPASAR BARAT, KOTA DENPASAR, BALI",18,218,18,236
https://kawalpemilu.org#54006,"PADANGSAMBIAN, DENPASAR BARAT, KOTA DENPASAR, BALI",19,221,12,233
https://kawalpemilu.org#54006,"PADANGSAMBIAN, DENPASAR BARAT, KOTA DENPASAR, BALI",20,208,18,226
https://kawalpemilu.org#54006,"PADANGSAMBIAN, DENPASAR BARAT, KOTA DENPASAR, BALI",21,229,8,237
https://kawalpemilu.org#54006,"PADANGSAMBIAN, DENPASAR BARAT, KOTA DENPASAR, BALI",22,193,16,209
https://kawalpemilu.org#54006,"PADANGSAMBIAN, DENPASAR BARAT, KOTA DENPASAR, BALI",23,192,17,209
https://kawalpemilu.org#54006,"PADANGSAMBIAN, DENPASAR BARAT, KOTA DENPASAR, BALI",24,147,10,157
https://kawalpemilu.org#54006,"PADANGSAMBIAN, DENPASAR BARAT, KOTA DENPASAR, BALI",25,138,18,156
https://kawalpemilu.org#54006,"PADANGSAMBIAN, DENPASAR BARAT, KOTA DENPASAR, BALI",26,151,39,190
https://kawalpemilu.org#54006,"PADANGSAMBIAN, DENPASAR BARAT, KOTA DENPASAR, BALI",27,133,29,162
https://kawalpemilu.org#54006,"PADANGSAMBIAN, DENPASAR BARAT, KOTA DENPASAR, BALI",28,167,33,200
https://kawalpemilu.org#54006,"PADANGSAMBIAN, DENPASAR BARAT, KOTA DENPASAR, BALI",29,211,20,231
https://kawalpemilu.org#54006,"PADANGSAMBIAN, DENPASAR BARAT, KOTA DENPASAR, BALI",30,199,17,216
https://kawalpemilu.org#54006,"PADANGSAMBIAN, DENPASAR BARAT, KOTA DENPASAR, BALI",31,206,11,217
https://kawalpemilu.org#54006,"PADANGSAMBIAN, DENPASAR BARAT, KOTA DENPASAR, BALI",32,218,17,235
https://kawalpemilu.org#54006,"PADANGSAMBIAN, DENPASAR BARAT, KOTA DENPASAR, BALI",33,168,31,199
https://kawalpemilu.org#54006,"PADANGSAMBIAN, DENPASAR BARAT, KOTA DENPASAR, BALI",34,189,34,223
https://kawalpemilu.org#54006,"PADANGSAMBIAN, DENPASAR BARAT, KOTA DENPASAR, BALI",35,191,34,225
https://kawalpemilu.org#54006,"PADANGSAMBIAN, DENPASAR BARAT, KOTA DENPASAR, BALI",36,215,10,225
https://kawalpemilu.org#54006,"PADANGSAMBIAN, DENPASAR BARAT, KOTA DENPASAR, BALI",37,204,21,225
https://kawalpemilu.org#54006,"PADANGSAMBIAN, DENPASAR BARAT, KOTA DENPASAR, BALI",38,214,21,235
https://kawalpemilu.org#54006,"PADANGSAMBIAN, DENPASAR BARAT, KOTA DENPASAR, BALI",39,184,11,195
https://kawalpemilu.org#54006,"PADANGSAMBIAN, DENPASAR BARAT, KOTA DENPASAR, BALI",40,246,15,261
https://kawalpemilu.org#54006,"PADANGSAMBIAN, DENPASAR BARAT, KOTA DENPASAR, BALI",41,194,21,215
https://kawalpemilu.org#54006,"PADANGSAMBIAN, DENPASAR BARAT, KOTA DENPASAR, BALI",42,201,30,231
https://kawalpemilu.org#54006,"PADANGSAMBIAN, DENPASAR BARAT, KOTA DENPASAR, BALI",43,162,16,178
https://kawalpemilu.org#54006,"PADANGSAMBIAN, DENPASAR BARAT, KOTA DENPASAR, BALI",44,197,45,242
https://kawalpemilu.org#54006,"PADANGSAMBIAN, DENPASAR BARAT, KOTA DENPASAR, BALI",45,161,49,210
https://kawalpemilu.org#54006,"PADANGSAMBIAN, DENPASAR BARAT, KOTA DENPASAR, BALI",46,189,31,220
https://kawalpemilu.org#54006,"PADANGSAMBIAN, DENPASAR BARAT, KOTA DENPASAR, BALI",47,189,47,236
https://kawalpemilu.org#54006,"PADANGSAMBIAN, DENPASAR BARAT, KOTA DENPASAR, BALI",48,185,22,207
https://kawalpemilu.org#54006,"PADANGSAMBIAN, DENPASAR BARAT, KOTA DENPASAR, BALI",49,179,12,191
https://kawalpemilu.org#54006,"PADANGSAMBIAN, DENPASAR BARAT, KOTA DENPASAR, BALI",50,149,31,180
https://kawalpemilu.org#54006,"PADANGSAMBIAN, DENPASAR BARAT, KOTA DENPASAR, BALI",51,168,31,199
https://kawalpemilu.org#54006,"PADANGSAMBIAN, DENPASAR BARAT, KOTA DENPASAR, BALI",52,139,39,178
https://kawalpemilu.org#54006,"PADANGSAMBIAN, DENPASAR BARAT, KOTA DENPASAR, BALI",53,214,21,235
https://kawalpemilu.org#54006,"PADANGSAMBIAN, DENPASAR BARAT, KOTA DENPASAR, BALI",54,194,36,230
https://kawalpemilu.org#54006,"PADANGSAMBIAN, DENPASAR BARAT, KOTA DENPASAR, BALI",55,196,26,222
https://kawalpemilu.org#54006,"PADANGSAMBIAN, DENPASAR BARAT, KOTA DENPASAR, BALI",56,195,29,224
https://kawalpemilu.org#54006,"PADANGSAMBIAN, DENPASAR BARAT, KOTA DENPASAR, BALI",57,169,29,198
https://kawalpemilu.org#54006,"PADANGSAMBIAN, DENPASAR BARAT, KOTA DENPASAR, BALI",58,169,22,191
https://kawalpemilu.org#54006,"PADANGSAMBIAN, DENPASAR BARAT, KOTA DENPASAR, BALI",59,214,17,231
https://kawalpemilu.org#54006,"PADANGSAMBIAN, DENPASAR BARAT, KOTA DENPASAR, BALI",60,227,15,242
https://kawalpemilu.org#54006,"PADANGSAMBIAN, DENPASAR BARAT, KOTA DENPASAR, BALI",61,177,32,209
https://kawalpemilu.org#54006,"PADANGSAMBIAN, DENPASAR BARAT, KOTA DENPASAR, BALI",62,147,29,176
https://kawalpemilu.org#54006,"PADANGSAMBIAN, DENPASAR BARAT, KOTA DENPASAR, BALI",63,145,36,181
https://kawalpemilu.org#54006,"PADANGSAMBIAN, DENPASAR BARAT, KOTA DENPASAR, BALI",64,205,14,219
https://kawalpemilu.org#54006,"PADANGSAMBIAN, DENPASAR BARAT, KOTA DENPASAR, BALI",65,214,21,235
https://kawalpemilu.org#54006,"PADANGSAMBIAN, DENPASAR BARAT, KOTA DENPASAR, BALI",66,212,16,228
https://kawalpemilu.org#54006,"PADANGSAMBIAN, DENPASAR BARAT, KOTA DENPASAR, BALI",67,198,19,217
https://kawalpemilu.org#54006,"PADANGSAMBIAN, DENPASAR BARAT, KOTA DENPASAR, BALI",68,178,14,192
https://kawalpemilu.org#54006,"PADANGSAMBIAN, DENPASAR BARAT, KOTA DENPASAR, BALI",69,185,16,201
https://kawalpemilu.org#54006,"PADANGSAMBIAN, DENPASAR BARAT, KOTA DENPASAR, BALI",70,187,8,195
https://kawalpemilu.org#54006,"PADANGSAMBIAN, DENPASAR BARAT, KOTA DENPASAR, BALI",71,154,24,178
https://kawalpemilu.org#54006,"PADANGSAMBIAN, DENPASAR BARAT, KOTA DENPASAR, BALI",72,172,24,196
https://kawalpemilu.org#54006,"PADANGSAMBIAN, DENPASAR BARAT, KOTA DENPASAR, BALI",73,173,39,212
https://kawalpemilu.org#54006,"PADANGSAMBIAN, DENPASAR BARAT, KOTA DENPASAR, BALI",74,125,17,142
https://kawalpemilu.org#54006,"PADANGSAMBIAN, DENPASAR BARAT, KOTA DENPASAR, BALI",75,115,47,162
https://kawalpemilu.org#54006,"PADANGSAMBIAN, DENPASAR BARAT, KOTA DENPASAR, BALI",76,148,46,194
https://kawalpemilu.org#54006,"PADANGSAMBIAN, DENPASAR BARAT, KOTA DENPASAR, BALI",77,137,16,153
https://kawalpemilu.org#54006,"PADANGSAMBIAN, DENPASAR BARAT, KOTA DENPASAR, BALI",78,163,36,199
https://kawalpemilu.org#54006,"PADANGSAMBIAN, DENPASAR BARAT, KOTA DENPASAR, BALI",79,149,16,165
https://kawalpemilu.org#54007,"PADANGSAMBIAN KAJA, DENPASAR BARAT, KOTA DENPASAR, BALI",1,200,24,224
https://kawalpemilu.org#54007,"PADANGSAMBIAN KAJA, DENPASAR BARAT, KOTA DENPASAR, BALI",2,191,22,213
https://kawalpemilu.org#54007,"PADANGSAMBIAN KAJA, DENPASAR BARAT, KOTA DENPASAR, BALI",3,185,20,205
https://kawalpemilu.org#54007,"PADANGSAMBIAN KAJA, DENPASAR BARAT, KOTA DENPASAR, BALI",4,178,36,214
https://kawalpemilu.org#54007,"PADANGSAMBIAN KAJA, DENPASAR BARAT, KOTA DENPASAR, BALI",6,199,22,221
https://kawalpemilu.org#54007,"PADANGSAMBIAN KAJA, DENPASAR BARAT, KOTA DENPASAR, BALI",7,195,24,219
https://kawalpemilu.org#54007,"PADANGSAMBIAN KAJA, DENPASAR BARAT, KOTA DENPASAR, BALI",8,217,6,223
https://kawalpemilu.org#54007,"PADANGSAMBIAN KAJA, DENPASAR BARAT, KOTA DENPASAR, BALI",9,198,10,208
https://kawalpemilu.org#54007,"PADANGSAMBIAN KAJA, DENPASAR BARAT, KOTA DENPASAR, BALI",10,221,14,235
https://kawalpemilu.org#54007,"PADANGSAMBIAN KAJA, DENPASAR BARAT, KOTA DENPASAR, BALI",11,212,15,227
https://kawalpemilu.org#54007,"PADANGSAMBIAN KAJA, DENPASAR BARAT, KOTA DENPASAR, BALI",12,200,17,217
https://kawalpemilu.org#54007,"PADANGSAMBIAN KAJA, DENPASAR BARAT, KOTA DENPASAR, BALI",13,208,21,229
https://kawalpemilu.org#54007,"PADANGSAMBIAN KAJA, DENPASAR BARAT, KOTA DENPASAR, BALI",14,219,26,245
https://kawalpemilu.org#54007,"PADANGSAMBIAN KAJA, DENPASAR BARAT, KOTA DENPASAR, BALI",15,226,24,250
https://kawalpemilu.org#54007,"PADANGSAMBIAN KAJA, DENPASAR BARAT, KOTA DENPASAR, BALI",16,216,15,231
https://kawalpemilu.org#54007,"PADANGSAMBIAN KAJA, DENPASAR BARAT, KOTA DENPASAR, BALI",17,223,23,246
https://kawalpemilu.org#54007,"PADANGSAMBIAN KAJA, DENPASAR BARAT, KOTA DENPASAR, BALI",18,222,13,235
https://kawalpemilu.org#54007,"PADANGSAMBIAN KAJA, DENPASAR BARAT, KOTA DENPASAR, BALI",19,192,20,212
https://kawalpemilu.org#54007,"PADANGSAMBIAN KAJA, DENPASAR BARAT, KOTA DENPASAR, BALI",20,184,31,215
https://kawalpemilu.org#54007,"PADANGSAMBIAN KAJA, DENPASAR BARAT, KOTA DENPASAR, BALI",21,206,8,214
https://kawalpemilu.org#54007,"PADANGSAMBIAN KAJA, DENPASAR BARAT, KOTA DENPASAR, BALI",22,190,16,206
https://kawalpemilu.org#54007,"PADANGSAMBIAN KAJA, DENPASAR BARAT, KOTA DENPASAR, BALI",23,184,30,214
https://kawalpemilu.org#54007,"PADANGSAMBIAN KAJA, DENPASAR BARAT, KOTA DENPASAR, BALI",24,215,20,235
https://kawalpemilu.org#54007,"PADANGSAMBIAN KAJA, DENPASAR BARAT, KOTA DENPASAR, BALI",26,217,22,239
https://kawalpemilu.org#54007,"PADANGSAMBIAN KAJA, DENPASAR BARAT, KOTA DENPASAR, BALI",27,187,29,216
https://kawalpemilu.org#54007,"PADANGSAMBIAN KAJA, DENPASAR BARAT, KOTA DENPASAR, BALI",28,192,16,208
https://kawalpemilu.org#54007,"PADANGSAMBIAN KAJA, DENPASAR BARAT, KOTA DENPASAR, BALI",29,190,24,214
https://kawalpemilu.org#54007,"PADANGSAMBIAN KAJA, DENPASAR BARAT, KOTA DENPASAR, BALI",30,182,12,194
https://kawalpemilu.org#54007,"PADANGSAMBIAN KAJA, DENPASAR BARAT, KOTA DENPASAR, BALI",31,171,24,195
https://kawalpemilu.org#54007,"PADANGSAMBIAN KAJA, DENPASAR BARAT, KOTA DENPASAR, BALI",32,209,19,228
https://kawalpemilu.org#54007,"PADANGSAMBIAN KAJA, DENPASAR BARAT, KOTA DENPASAR, BALI",33,214,22,236
https://kawalpemilu.org#54007,"PADANGSAMBIAN KAJA, DENPASAR BARAT, KOTA DENPASAR, BALI",34,241,7,248
https://kawalpemilu.org#54007,"PADANGSAMBIAN KAJA, DENPASAR BARAT, KOTA DENPASAR, BALI",35,199,18,217
https://kawalpemilu.org#54007,"PADANGSAMBIAN KAJA, DENPASAR BARAT, KOTA DENPASAR, BALI",36,200,26,226
https://kawalpemilu.org#54007,"PADANGSAMBIAN KAJA, DENPASAR BARAT, KOTA DENPASAR, BALI",37,219,12,231
https://kawalpemilu.org#54007,"PADANGSAMBIAN KAJA, DENPASAR BARAT, KOTA DENPASAR, BALI",38,222,17,239
https://kawalpemilu.org#54007,"PADANGSAMBIAN KAJA, DENPASAR BARAT, KOTA DENPASAR, BALI",39,203,15,218
https://kawalpemilu.org#54007,"PADANGSAMBIAN KAJA, DENPASAR BARAT, KOTA DENPASAR, BALI",40,203,15,218
https://kawalpemilu.org#54007,"PADANGSAMBIAN KAJA, DENPASAR BARAT, KOTA DENPASAR, BALI",41,203,14,217
https://kawalpemilu.org#54007,"PADANGSAMBIAN KAJA, DENPASAR BARAT, KOTA DENPASAR, BALI",42,164,12,176
https://kawalpemilu.org#54007,"PADANGSAMBIAN KAJA, DENPASAR BARAT, KOTA DENPASAR, BALI",43,156,36,192
https://kawalpemilu.org#54007,"PADANGSAMBIAN KAJA, DENPASAR BARAT, KOTA DENPASAR, BALI",44,138,22,160
https://kawalpemilu.org#54009,"TONJA, DENPASAR UTARA, KOTA DENPASAR, BALI",1,232,9,241
https://kawalpemilu.org#54009,"TONJA, DENPASAR UTARA, KOTA DENPASAR, BALI",2,238,14,252
https://kawalpemilu.org#54009,"TONJA, DENPASAR UTARA, KOTA DENPASAR, BALI",3,219,6,225
https://kawalpemilu.org#54009,"TONJA, DENPASAR UTARA, KOTA DENPASAR, BALI",4,243,8,251
https://kawalpemilu.org#54009,"TONJA, DENPASAR UTARA, KOTA DENPASAR, BALI",5,224,2,226
https://kawalpemilu.org#54009,"TONJA, DENPASAR UTARA, KOTA DENPASAR, BALI",6,237,10,247
https://kawalpemilu.org#54009,"TONJA, DENPASAR UTARA, KOTA DENPASAR, BALI",7,209,6,215
https://kawalpemilu.org#54009,"TONJA, DENPASAR UTARA, KOTA DENPASAR, BALI",8,244,9,253
https://kawalpemilu.org#54009,"TONJA, DENPASAR UTARA, KOTA DENPASAR, BALI",9,229,9,238
https://kawalpemilu.org#54009,"TONJA, DENPASAR UTARA, KOTA DENPASAR, BALI",10,207,9,216
https://kawalpemilu.org#54009,"TONJA, DENPASAR UTARA, KOTA DENPASAR, BALI",11,199,13,212
https://kawalpemilu.org#54009,"TONJA, DENPASAR UTARA, KOTA DENPASAR, BALI",12,222,10,232
https://kawalpemilu.org#54009,"TONJA, DENPASAR UTARA, KOTA DENPASAR, BALI",13,236,8,244
https://kawalpemilu.org#54009,"TONJA, DENPASAR UTARA, KOTA DENPASAR, BALI",14,212,5,217
https://kawalpemilu.org#54009,"TONJA, DENPASAR UTARA, KOTA DENPASAR, BALI",15,191,7,198
https://kawalpemilu.org#54009,"TONJA, DENPASAR UTARA, KOTA DENPASAR, BALI",16,218,10,228
https://kawalpemilu.org#54009,"TONJA, DENPASAR UTARA, KOTA DENPASAR, BALI",17,202,19,221
https://kawalpemilu.org#54009,"TONJA, DENPASAR UTARA, KOTA DENPASAR, BALI",18,222,18,240
https://kawalpemilu.org#54009,"TONJA, DENPASAR UTARA, KOTA DENPASAR, BALI",19,192,11,203
https://kawalpemilu.org#54009,"TONJA, DENPASAR UTARA, KOTA DENPASAR, BALI",20,186,17,203
https://kawalpemilu.org#54009,"TONJA, DENPASAR UTARA, KOTA DENPASAR, BALI",21,192,14,206
https://kawalpemilu.org#54009,"TONJA, DENPASAR UTARA, KOTA DENPASAR, BALI",22,193,16,209
https://kawalpemilu.org#54009,"TONJA, DENPASAR UTARA, KOTA DENPASAR, BALI",23,210,15,225
https://kawalpemilu.org#54009,"TONJA, DENPASAR UTARA, KOTA DENPASAR, BALI",24,224,6,230
https://kawalpemilu.org#54009,"TONJA, DENPASAR UTARA, KOTA DENPASAR, BALI",25,229,14,243
https://kawalpemilu.org#54009,"TONJA, DENPASAR UTARA, KOTA DENPASAR, BALI",26,210,24,234
https://kawalpemilu.org#54009,"TONJA, DENPASAR UTARA, KOTA DENPASAR, BALI",27,213,7,220
https://kawalpemilu.org#54009,"TONJA, DENPASAR UTARA, KOTA DENPASAR, BALI",28,217,12,229
https://kawalpemilu.org#54009,"TONJA, DENPASAR UTARA, KOTA DENPASAR, BALI",29,199,19,218
https://kawalpemilu.org#54009,"TONJA, DENPASAR UTARA, KOTA DENPASAR, BALI",30,231,14,245
https://kawalpemilu.org#54009,"TONJA, DENPASAR UTARA, KOTA DENPASAR, BALI",31,212,9,221
https://kawalpemilu.org#54009,"TONJA, DENPASAR UTARA, KOTA DENPASAR, BALI",32,221,17,238
https://kawalpemilu.org#54009,"TONJA, DENPASAR UTARA, KOTA DENPASAR, BALI",33,206,22,228
https://kawalpemilu.org#54009,"TONJA, DENPASAR UTARA, KOTA DENPASAR, BALI",34,225,12,237
https://kawalpemilu.org#54009,"TONJA, DENPASAR UTARA, KOTA DENPASAR, BALI",35,213,11,224
https://kawalpemilu.org#54009,"TONJA, DENPASAR UTARA, KOTA DENPASAR, BALI",36,215,19,234
https://kawalpemilu.org#54009,"TONJA, DENPASAR UTARA, KOTA DENPASAR, BALI",37,205,11,216
https://kawalpemilu.org#54009,"TONJA, DENPASAR UTARA, KOTA DENPASAR, BALI",38,200,11,211
https://kawalpemilu.org#54009,"TONJA, DENPASAR UTARA, KOTA DENPASAR, BALI",39,178,14,192
https://kawalpemilu.org#54010,"UBUNG, DENPASAR UTARA, KOTA DENPASAR, BALI",1,167,28,195
https://kawalpemilu.org#54010,"UBUNG, DENPASAR UTARA, KOTA DENPASAR, BALI",2,204,11,215
https://kawalpemilu.org#54010,"UBUNG, DENPASAR UTARA, KOTA DENPASAR, BALI",3,190,34,224
https://kawalpemilu.org#54010,"UBUNG, DENPASAR UTARA, KOTA DENPASAR, BALI",4,195,23,218
https://kawalpemilu.org#54010,"UBUNG, DENPASAR UTARA, KOTA DENPASAR, BALI",5,196,25,221
https://kawalpemilu.org#54010,"UBUNG, DENPASAR UTARA, KOTA DENPASAR, BALI",6,198,11,209
https://kawalpemilu.org#54010,"UBUNG, DENPASAR UTARA, KOTA DENPASAR, BALI",7,182,16,198
https://kawalpemilu.org#54010,"UBUNG, DENPASAR UTARA, KOTA DENPASAR, BALI",8,152,23,175
https://kawalpemilu.org#54010,"UBUNG, DENPASAR UTARA, KOTA DENPASAR, BALI",9,155,19,174
https://kawalpemilu.org#54010,"UBUNG, DENPASAR UTARA, KOTA DENPASAR, BALI",10,223,15,238
https://kawalpemilu.org#54010,"UBUNG, DENPASAR UTARA, KOTA DENPASAR, BALI",11,212,12,224
https://kawalpemilu.org#54010,"UBUNG, DENPASAR UTARA, KOTA DENPASAR, BALI",12,179,22,201
https://kawalpemilu.org#54010,"UBUNG, DENPASAR UTARA, KOTA DENPASAR, BALI",13,172,20,192
https://kawalpemilu.org#54010,"UBUNG, DENPASAR UTARA, KOTA DENPASAR, BALI",14,218,10,228
https://kawalpemilu.org#54010,"UBUNG, DENPASAR UTARA, KOTA DENPASAR, BALI",15,220,18,238
https://kawalpemilu.org#54010,"UBUNG, DENPASAR UTARA, KOTA DENPASAR, BALI",16,199,20,219
https://kawalpemilu.org#54010,"UBUNG, DENPASAR UTARA, KOTA DENPASAR, BALI",17,204,15,219
https://kawalpemilu.org#54010,"UBUNG, DENPASAR UTARA, KOTA DENPASAR, BALI",18,171,39,210
https://kawalpemilu.org#54010,"UBUNG, DENPASAR UTARA, KOTA DENPASAR, BALI",19,199,18,217
https://kawalpemilu.org#54010,"UBUNG, DENPASAR UTARA, KOTA DENPASAR, BALI",20,194,29,223
https://kawalpemilu.org#54010,"UBUNG, DENPASAR UTARA, KOTA DENPASAR, BALI",21,128,21,149
https://kawalpemilu.org#54010,"UBUNG, DENPASAR UTARA, KOTA DENPASAR, BALI",22,155,19,174
https://kawalpemilu.org#54010,"UBUNG, DENPASAR UTARA, KOTA DENPASAR, BALI",23,238,27,265
https://kawalpemilu.org#54011,"PEGUYANGAN, DENPASAR UTARA, KOTA DENPASAR, BALI",1,177,9,186
https://kawalpemilu.org#54011,"PEGUYANGAN, DENPASAR UTARA, KOTA DENPASAR, BALI",2,158,7,165
https://kawalpemilu.org#54011,"PEGUYANGAN, DENPASAR UTARA, KOTA DENPASAR, BALI",3,199,10,209
https://kawalpemilu.org#54011,"PEGUYANGAN, DENPASAR UTARA, KOTA DENPASAR, BALI",4,178,21,199
https://kawalpemilu.org#54011,"PEGUYANGAN, DENPASAR UTARA, KOTA DENPASAR, BALI",5,198,11,209
https://kawalpemilu.org#54011,"PEGUYANGAN, DENPASAR UTARA, KOTA DENPASAR, BALI",6,195,6,201
https://kawalpemilu.org#54011,"PEGUYANGAN, DENPASAR UTARA, KOTA DENPASAR, BALI",7,212,18,230
https://kawalpemilu.org#54011,"PEGUYANGAN, DENPASAR UTARA, KOTA DENPASAR, BALI",8,222,6,228
https://kawalpemilu.org#54011,"PEGUYANGAN, DENPASAR UTARA, KOTA DENPASAR, BALI",9,257,11,268
https://kawalpemilu.org#54011,"PEGUYANGAN, DENPASAR UTARA, KOTA DENPASAR, BALI",10,280,1,281
https://kawalpemilu.org#54011,"PEGUYANGAN, DENPASAR UTARA, KOTA DENPASAR, BALI",11,217,9,226
https://kawalpemilu.org#54011,"PEGUYANGAN, DENPASAR UTARA, KOTA DENPASAR, BALI",12,218,16,234
https://kawalpemilu.org#54011,"PEGUYANGAN, DENPASAR UTARA, KOTA DENPASAR, BALI",13,203,23,226
https://kawalpemilu.org#54011,"PEGUYANGAN, DENPASAR UTARA, KOTA DENPASAR, BALI",14,216,20,236
https://kawalpemilu.org#54011,"PEGUYANGAN, DENPASAR UTARA, KOTA DENPASAR, BALI",15,216,17,233
https://kawalpemilu.org#54011,"PEGUYANGAN, DENPASAR UTARA, KOTA DENPASAR, BALI",16,226,7,233
https://kawalpemilu.org#54011,"PEGUYANGAN, DENPASAR UTARA, KOTA DENPASAR, BALI",17,254,6,260
https://kawalpemilu.org#54011,"PEGUYANGAN, DENPASAR UTARA, KOTA DENPASAR, BALI",18,215,12,227
https://kawalpemilu.org#54011,"PEGUYANGAN, DENPASAR UTARA, KOTA DENPASAR, BALI",19,223,12,235
https://kawalpemilu.org#54011,"PEGUYANGAN, DENPASAR UTARA, KOTA DENPASAR, BALI",20,235,11,246
https://kawalpemilu.org#54011,"PEGUYANGAN, DENPASAR UTARA, KOTA DENPASAR, BALI",21,214,10,224
https://kawalpemilu.org#54011,"PEGUYANGAN, DENPASAR UTARA, KOTA DENPASAR, BALI",22,229,7,236
https://kawalpemilu.org#54011,"PEGUYANGAN, DENPASAR UTARA, KOTA DENPASAR, BALI",23,195,11,206
https://kawalpemilu.org#54011,"PEGUYANGAN, DENPASAR UTARA, KOTA DENPASAR, BALI",24,172,23,195
https://kawalpemilu.org#54011,"PEGUYANGAN, DENPASAR UTARA, KOTA DENPASAR, BALI",25,192,6,198
https://kawalpemilu.org#54011,"PEGUYANGAN, DENPASAR UTARA, KOTA DENPASAR, BALI",27,176,14,190
https://kawalpemilu.org#54011,"PEGUYANGAN, DENPASAR UTARA, KOTA DENPASAR, BALI",28,179,21,200
https://kawalpemilu.org#54011,"PEGUYANGAN, DENPASAR UTARA, KOTA DENPASAR, BALI",29,211,4,215
https://kawalpemilu.org#54011,"PEGUYANGAN, DENPASAR UTARA, KOTA DENPASAR, BALI",30,216,7,223
https://kawalpemilu.org#54011,"PEGUYANGAN, DENPASAR UTARA, KOTA DENPASAR, BALI",31,0,0,0
https://kawalpemilu.org#54011,"PEGUYANGAN, DENPASAR UTARA, KOTA DENPASAR, BALI",32,233,7,240
https://kawalpemilu.org#54011,"PEGUYANGAN, DENPASAR UTARA, KOTA DENPASAR, BALI",33,216,10,226
https://kawalpemilu.org#54011,"PEGUYANGAN, DENPASAR UTARA, KOTA DENPASAR, BALI",34,214,11,225
https://kawalpemilu.org#54011,"PEGUYANGAN, DENPASAR UTARA, KOTA DENPASAR, BALI",35,214,17,231
https://kawalpemilu.org#54011,"PEGUYANGAN, DENPASAR UTARA, KOTA DENPASAR, BALI",36,229,10,239
https://kawalpemilu.org#54011,"PEGUYANGAN, DENPASAR UTARA, KOTA DENPASAR, BALI",37,215,18,233
https://kawalpemilu.org#54011,"PEGUYANGAN, DENPASAR UTARA, KOTA DENPASAR, BALI",38,200,7,207
https://kawalpemilu.org#54011,"PEGUYANGAN, DENPASAR UTARA, KOTA DENPASAR, BALI",39,212,18,230
https://kawalpemilu.org#54012,"PEGUYANGAN KAJA, DENPASAR UTARA, KOTA DENPASAR, BALI",1,259,15,274
https://kawalpemilu.org#54012,"PEGUYANGAN KAJA, DENPASAR UTARA, KOTA DENPASAR, BALI",2,243,20,263
https://kawalpemilu.org#54012,"PEGUYANGAN KAJA, DENPASAR UTARA, KOTA DENPASAR, BALI",3,248,6,254
https://kawalpemilu.org#54012,"PEGUYANGAN KAJA, DENPASAR UTARA, KOTA DENPASAR, BALI",4,206,6,212
https://kawalpemilu.org#54012,"PEGUYANGAN KAJA, DENPASAR UTARA, KOTA DENPASAR, BALI",5,176,15,191
https://kawalpemilu.org#54012,"PEGUYANGAN KAJA, DENPASAR UTARA, KOTA DENPASAR, BALI",6,215,12,227
https://kawalpemilu.org#54012,"PEGUYANGAN KAJA, DENPASAR UTARA, KOTA DENPASAR, BALI",7,177,10,187
https://kawalpemilu.org#54012,"PEGUYANGAN KAJA, DENPASAR UTARA, KOTA DENPASAR, BALI",8,218,6,224
https://kawalpemilu.org#54012,"PEGUYANGAN KAJA, DENPASAR UTARA, KOTA DENPASAR, BALI",9,219,14,233
https://kawalpemilu.org#54012,"PEGUYANGAN KAJA, DENPASAR UTARA, KOTA DENPASAR, BALI",10,253,10,263
https://kawalpemilu.org#54012,"PEGUYANGAN KAJA, DENPASAR UTARA, KOTA DENPASAR, BALI",11,221,11,232
https://kawalpemilu.org#54012,"PEGUYANGAN KAJA, DENPASAR UTARA, KOTA DENPASAR, BALI",12,277,7,284
https://kawalpemilu.org#54012,"PEGUYANGAN KAJA, DENPASAR UTARA, KOTA DENPASAR, BALI",13,254,20,274
https://kawalpemilu.org#54012,"PEGUYANGAN KAJA, DENPASAR UTARA, KOTA DENPASAR, BALI",14,234,23,257
https://kawalpemilu.org#54012,"PEGUYANGAN KAJA, DENPASAR UTARA, KOTA DENPASAR, BALI",15,267,5,272
https://kawalpemilu.org#54012,"PEGUYANGAN KAJA, DENPASAR UTARA, KOTA DENPASAR, BALI",16,255,11,266
https://kawalpemilu.org#54012,"PEGUYANGAN KAJA, DENPASAR UTARA, KOTA DENPASAR, BALI",17,295,10,265
https://kawalpemilu.org#54012,"PEGUYANGAN KAJA, DENPASAR UTARA, KOTA DENPASAR, BALI",18,283,11,294
https://kawalpemilu.org#54012,"PEGUYANGAN KAJA, DENPASAR UTARA, KOTA DENPASAR, BALI",19,243,14,257
https://kawalpemilu.org#54012,"PEGUYANGAN KAJA, DENPASAR UTARA, KOTA DENPASAR, BALI",20,210,15,225
https://kawalpemilu.org#54012,"PEGUYANGAN KAJA, DENPASAR UTARA, KOTA DENPASAR, BALI",21,242,15,257
https://kawalpemilu.org#54012,"PEGUYANGAN KAJA, DENPASAR UTARA, KOTA DENPASAR, BALI",22,230,10,240
https://kawalpemilu.org#54013,"PEGUYANGAN KANGIN, DENPASAR UTARA, KOTA DENPASAR, BALI",1,204,11,215
https://kawalpemilu.org#54013,"PEGUYANGAN KANGIN, DENPASAR UTARA, KOTA DENPASAR, BALI",2,198,14,212
https://kawalpemilu.org#54013,"PEGUYANGAN KANGIN, DENPASAR UTARA, KOTA DENPASAR, BALI",3,221,11,232
https://kawalpemilu.org#54013,"PEGUYANGAN KANGIN, DENPASAR UTARA, KOTA DENPASAR, BALI",4,188,20,208
https://kawalpemilu.org#54013,"PEGUYANGAN KANGIN, DENPASAR UTARA, KOTA DENPASAR, BALI",5,176,9,185
https://kawalpemilu.org#54013,"PEGUYANGAN KANGIN, DENPASAR UTARA, KOTA DENPASAR, BALI",6,188,7,195
https://kawalpemilu.org#54013,"PEGUYANGAN KANGIN, DENPASAR UTARA, KOTA DENPASAR, BALI",7,205,12,217
https://kawalpemilu.org#54013,"PEGUYANGAN KANGIN, DENPASAR UTARA, KOTA DENPASAR, BALI",8,197,18,215
https://kawalpemilu.org#54013,"PEGUYANGAN KANGIN, DENPASAR UTARA, KOTA DENPASAR, BALI",9,198,12,210
https://kawalpemilu.org#54013,"PEGUYANGAN KANGIN, DENPASAR UTARA, KOTA DENPASAR, BALI",10,203,17,220
https://kawalpemilu.org#54013,"PEGUYANGAN KANGIN, DENPASAR UTARA, KOTA DENPASAR, BALI",11,220,8,228
https://kawalpemilu.org#54013,"PEGUYANGAN KANGIN, DENPASAR UTARA, KOTA DENPASAR, BALI",12,208,13,221
https://kawalpemilu.org#54013,"PEGUYANGAN KANGIN, DENPASAR UTARA, KOTA DENPASAR, BALI",13,226,11,237
https://kawalpemilu.org#54013,"PEGUYANGAN KANGIN, DENPASAR UTARA, KOTA DENPASAR, BALI",14,225,13,238
https://kawalpemilu.org#54013,"PEGUYANGAN KANGIN, DENPASAR UTARA, KOTA DENPASAR, BALI",15,231,9,240
https://kawalpemilu.org#54013,"PEGUYANGAN KANGIN, DENPASAR UTARA, KOTA DENPASAR, BALI",16,204,10,214
https://kawalpemilu.org#54013,"PEGUYANGAN KANGIN, DENPASAR UTARA, KOTA DENPASAR, BALI",17,197,13,210
https://kawalpemilu.org#54013,"PEGUYANGAN KANGIN, DENPASAR UTARA, KOTA DENPASAR, BALI",18,197,6,203
https://kawalpemilu.org#54013,"PEGUYANGAN KANGIN, DENPASAR UTARA, KOTA DENPASAR, BALI",19,193,21,214
https://kawalpemilu.org#54013,"PEGUYANGAN KANGIN, DENPASAR UTARA, KOTA DENPASAR, BALI",20,219,21,240
https://kawalpemilu.org#54013,"PEGUYANGAN KANGIN, DENPASAR UTARA, KOTA DENPASAR, BALI",21,220,8,228
https://kawalpemilu.org#54013,"PEGUYANGAN KANGIN, DENPASAR UTARA, KOTA DENPASAR, BALI",22,208,19,227
https://kawalpemilu.org#54013,"PEGUYANGAN KANGIN, DENPASAR UTARA, KOTA DENPASAR, BALI",23,220,10,230
https://kawalpemilu.org#54013,"PEGUYANGAN KANGIN, DENPASAR UTARA, KOTA DENPASAR, BALI",24,211,3,214
https://kawalpemilu.org#54013,"PEGUYANGAN KANGIN, DENPASAR UTARA, KOTA DENPASAR, BALI",25,205,12,217
https://kawalpemilu.org#54013,"PEGUYANGAN KANGIN, DENPASAR UTARA, KOTA DENPASAR, BALI",26,179,14,193
https://kawalpemilu.org#54013,"PEGUYANGAN KANGIN, DENPASAR UTARA, KOTA DENPASAR, BALI",27,214,4,218
https://kawalpemilu.org#54013,"PEGUYANGAN KANGIN, DENPASAR UTARA, KOTA DENPASAR, BALI",28,204,12,216
https://kawalpemilu.org#54013,"PEGUYANGAN KANGIN, DENPASAR UTARA, KOTA DENPASAR, BALI",29,216,12,228
https://kawalpemilu.org#54013,"PEGUYANGAN KANGIN, DENPASAR UTARA, KOTA DENPASAR, BALI",30,233,10,243
https://kawalpemilu.org#54013,"PEGUYANGAN KANGIN, DENPASAR UTARA, KOTA DENPASAR, BALI",31,216,8,224
https://kawalpemilu.org#54013,"PEGUYANGAN KANGIN, DENPASAR UTARA, KOTA DENPASAR, BALI",32,211,4,215
https://kawalpemilu.org#54013,"PEGUYANGAN KANGIN, DENPASAR UTARA, KOTA DENPASAR, BALI",33,203,5,208
https://kawalpemilu.org#54013,"PEGUYANGAN KANGIN, DENPASAR UTARA, KOTA DENPASAR, BALI",34,209,1,210
https://kawalpemilu.org#54013,"PEGUYANGAN KANGIN, DENPASAR UTARA, KOTA DENPASAR, BALI",35,193,8,201
https://kawalpemilu.org#54013,"PEGUYANGAN KANGIN, DENPASAR UTARA, KOTA DENPASAR, BALI",36,203,10,213
https://kawalpemilu.org#54013,"PEGUYANGAN KANGIN, DENPASAR UTARA, KOTA DENPASAR, BALI",37,215,11,226
https://kawalpemilu.org#54013,"PEGUYANGAN KANGIN, DENPASAR UTARA, KOTA DENPASAR, BALI",38,236,12,248
https://kawalpemilu.org#54013,"PEGUYANGAN KANGIN, DENPASAR UTARA, KOTA DENPASAR, BALI",39,240,8,248
https://kawalpemilu.org#54013,"PEGUYANGAN KANGIN, DENPASAR UTARA, KOTA DENPASAR, BALI",40,241,19,260
https://kawalpemilu.org#54013,"PEGUYANGAN KANGIN, DENPASAR UTARA, KOTA DENPASAR, BALI",41,227,11,238
https://kawalpemilu.org#54013,"PEGUYANGAN KANGIN, DENPASAR UTARA, KOTA DENPASAR, BALI",42,214,21,235
https://kawalpemilu.org#54013,"PEGUYANGAN KANGIN, DENPASAR UTARA, KOTA DENPASAR, BALI",43,238,22,260
https://kawalpemilu.org#54013,"PEGUYANGAN KANGIN, DENPASAR UTARA, KOTA DENPASAR, BALI",44,218,19,237
https://kawalpemilu.org#54013,"PEGUYANGAN KANGIN, DENPASAR UTARA, KOTA DENPASAR, BALI",45,246,16,262
https://kawalpemilu.org#54013,"PEGUYANGAN KANGIN, DENPASAR UTARA, KOTA DENPASAR, BALI",46,245,11,256
https://kawalpemilu.org#54013,"PEGUYANGAN KANGIN, DENPASAR UTARA, KOTA DENPASAR, BALI",47,160,6,166
https://kawalpemilu.org#54014,"DANGIN PURI KANGIN, DENPASAR UTARA, KOTA DENPASAR, BALI",1,288,17,305
https://kawalpemilu.org#54014,"DANGIN PURI KANGIN, DENPASAR UTARA, KOTA DENPASAR, BALI",2,185,17,202
https://kawalpemilu.org#54014,"DANGIN PURI KANGIN, DENPASAR UTARA, KOTA DENPASAR, BALI",3,209,23,232
https://kawalpemilu.org#54014,"DANGIN PURI KANGIN, DENPASAR UTARA, KOTA DENPASAR, BALI",4,185,21,206
https://kawalpemilu.org#54014,"DANGIN PURI KANGIN, DENPASAR UTARA, KOTA DENPASAR, BALI",5,228,11,239
https://kawalpemilu.org#54014,"DANGIN PURI KANGIN, DENPASAR UTARA, KOTA DENPASAR, BALI",6,208,12,220
https://kawalpemilu.org#54014,"DANGIN PURI KANGIN, DENPASAR UTARA, KOTA DENPASAR, BALI",7,224,17,241
https://kawalpemilu.org#54014,"DANGIN PURI KANGIN, DENPASAR UTARA, KOTA DENPASAR, BALI",8,215,9,224
https://kawalpemilu.org#54014,"DANGIN PURI KANGIN, DENPASAR UTARA, KOTA DENPASAR, BALI",9,215,8,223
https://kawalpemilu.org#54014,"DANGIN PURI KANGIN, DENPASAR UTARA, KOTA DENPASAR, BALI",10,200,10,210
https://kawalpemilu.org#54014,"DANGIN PURI KANGIN, DENPASAR UTARA, KOTA DENPASAR, BALI",11,214,16,230
https://kawalpemilu.org#54014,"DANGIN PURI KANGIN, DENPASAR UTARA, KOTA DENPASAR, BALI",12,252,16,268
https://kawalpemilu.org#54014,"DANGIN PURI KANGIN, DENPASAR UTARA, KOTA DENPASAR, BALI",13,271,11,282
https://kawalpemilu.org#54014,"DANGIN PURI KANGIN, DENPASAR UTARA, KOTA DENPASAR, BALI",14,250,16,266
https://kawalpemilu.org#54014,"DANGIN PURI KANGIN, DENPASAR UTARA, KOTA DENPASAR, BALI",16,200,10,210
https://kawalpemilu.org#54014,"DANGIN PURI KANGIN, DENPASAR UTARA, KOTA DENPASAR, BALI",17,191,11,202
https://kawalpemilu.org#54014,"DANGIN PURI KANGIN, DENPASAR UTARA, KOTA DENPASAR, BALI",18,231,9,240
https://kawalpemilu.org#54014,"DANGIN PURI KANGIN, DENPASAR UTARA, KOTA DENPASAR, BALI",19,211,19,230
https://kawalpemilu.org#54014,"DANGIN PURI KANGIN, DENPASAR UTARA, KOTA DENPASAR, BALI",20,211,12,223
https://kawalpemilu.org#54014,"DANGIN PURI KANGIN, DENPASAR UTARA, KOTA DENPASAR, BALI",21,207,10,217
https://kawalpemilu.org#54014,"DANGIN PURI KANGIN, DENPASAR UTARA, KOTA DENPASAR, BALI",22,210,7,217
https://kawalpemilu.org#54015,"DANGIN PURI KAUH, DENPASAR UTARA, KOTA DENPASAR, BALI",1,207,7,214
https://kawalpemilu.org#54015,"DANGIN PURI KAUH, DENPASAR UTARA, KOTA DENPASAR, BALI",2,200,5,205
https://kawalpemilu.org#54015,"DANGIN PURI KAUH, DENPASAR UTARA, KOTA DENPASAR, BALI",3,200,3,203
https://kawalpemilu.org#54015,"DANGIN PURI KAUH, DENPASAR UTARA, KOTA DENPASAR, BALI",4,188,7,195
https://kawalpemilu.org#54015,"DANGIN PURI KAUH, DENPASAR UTARA, KOTA DENPASAR, BALI",5,197,6,203
https://kawalpemilu.org#54015,"DANGIN PURI KAUH, DENPASAR UTARA, KOTA DENPASAR, BALI",6,178,8,186
https://kawalpemilu.org#54015,"DANGIN PURI KAUH, DENPASAR UTARA, KOTA DENPASAR, BALI",7,247,5,252
https://kawalpemilu.org#54015,"DANGIN PURI KAUH, DENPASAR UTARA, KOTA DENPASAR, BALI",8,238,4,242
https://kawalpemilu.org#54015,"DANGIN PURI KAUH, DENPASAR UTARA, KOTA DENPASAR, BALI",9,238,9,247
https://kawalpemilu.org#54015,"DANGIN PURI KAUH, DENPASAR UTARA, KOTA DENPASAR, BALI",10,208,9,217
https://kawalpemilu.org#54015,"DANGIN PURI KAUH, DENPASAR UTARA, KOTA DENPASAR, BALI",11,234,4,238
https://kawalpemilu.org#54015,"DANGIN PURI KAUH, DENPASAR UTARA, KOTA DENPASAR, BALI",12,238,2,240
https://kawalpemilu.org#54015,"DANGIN PURI KAUH, DENPASAR UTARA, KOTA DENPASAR, BALI",13,240,7,247
https://kawalpemilu.org#54015,"DANGIN PURI KAUH, DENPASAR UTARA, KOTA DENPASAR, BALI",14,171,3,174
https://kawalpemilu.org#54015,"DANGIN PURI KAUH, DENPASAR UTARA, KOTA DENPASAR, BALI",15,179,1,180
https://kawalpemilu.org#54015,"DANGIN PURI KAUH, DENPASAR UTARA, KOTA DENPASAR, BALI",16,168,6,174
https://kawalpemilu.org#54015,"DANGIN PURI KAUH, DENPASAR UTARA, KOTA DENPASAR, BALI",17,209,6,215
https://kawalpemilu.org#54015,"DANGIN PURI KAUH, DENPASAR UTARA, KOTA DENPASAR, BALI",18,200,13,213
https://kawalpemilu.org#54015,"DANGIN PURI KAUH, DENPASAR UTARA, KOTA DENPASAR, BALI",19,197,9,206
https://kawalpemilu.org#54015,"DANGIN PURI KAUH, DENPASAR UTARA, KOTA DENPASAR, BALI",20,199,10,209
https://kawalpemilu.org#54015,"DANGIN PURI KAUH, DENPASAR UTARA, KOTA DENPASAR, BALI",21,186,12,198
https://kawalpemilu.org#54016,"DANGIN PURI KAJA, DENPASAR UTARA, KOTA DENPASAR, BALI",1,245,7,252
https://kawalpemilu.org#54016,"DANGIN PURI KAJA, DENPASAR UTARA, KOTA DENPASAR, BALI",2,239,7,246
https://kawalpemilu.org#54016,"DANGIN PURI KAJA, DENPASAR UTARA, KOTA DENPASAR, BALI",3,224,15,239
https://kawalpemilu.org#54016,"DANGIN PURI KAJA, DENPASAR UTARA, KOTA DENPASAR, BALI",4,224,10,234
https://kawalpemilu.org#54016,"DANGIN PURI KAJA, DENPASAR UTARA, KOTA DENPASAR, BALI",5,228,3,231
https://kawalpemilu.org#54016,"DANGIN PURI KAJA, DENPASAR UTARA, KOTA DENPASAR, BALI",6,214,11,225
https://kawalpemilu.org#54016,"DANGIN PURI KAJA, DENPASAR UTARA, KOTA DENPASAR, BALI",7,212,20,232
https://kawalpemilu.org#54016,"DANGIN PURI KAJA, DENPASAR UTARA, KOTA DENPASAR, BALI",8,229,10,239
https://kawalpemilu.org#54016,"DANGIN PURI KAJA, DENPASAR UTARA, KOTA DENPASAR, BALI",9,229,8,237
https://kawalpemilu.org#54016,"DANGIN PURI KAJA, DENPASAR UTARA, KOTA DENPASAR, BALI",10,195,9,204
https://kawalpemilu.org#54016,"DANGIN PURI KAJA, DENPASAR UTARA, KOTA DENPASAR, BALI",11,156,8,164
https://kawalpemilu.org#54016,"DANGIN PURI KAJA, DENPASAR UTARA, KOTA DENPASAR, BALI",12,201,14,215
https://kawalpemilu.org#54016,"DANGIN PURI KAJA, DENPASAR UTARA, KOTA DENPASAR, BALI",13,221,12,233
https://kawalpemilu.org#54016,"DANGIN PURI KAJA, DENPASAR UTARA, KOTA DENPASAR, BALI",14,228,14,242
https://kawalpemilu.org#54016,"DANGIN PURI KAJA, DENPASAR UTARA, KOTA DENPASAR, BALI",15,202,15,217
https://kawalpemilu.org#54016,"DANGIN PURI KAJA, DENPASAR UTARA, KOTA DENPASAR, BALI",16,192,11,203
https://kawalpemilu.org#54016,"DANGIN PURI KAJA, DENPASAR UTARA, KOTA DENPASAR, BALI",17,221,12,233
https://kawalpemilu.org#54016,"DANGIN PURI KAJA, DENPASAR UTARA, KOTA DENPASAR, BALI",18,200,6,206
https://kawalpemilu.org#54016,"DANGIN PURI KAJA, DENPASAR UTARA, KOTA DENPASAR, BALI",19,211,11,222
https://kawalpemilu.org#54016,"DANGIN PURI KAJA, DENPASAR UTARA, KOTA DENPASAR, BALI",20,203,4,207
https://kawalpemilu.org#54016,"DANGIN PURI KAJA, DENPASAR UTARA, KOTA DENPASAR, BALI",21,188,7,195
https://kawalpemilu.org#54016,"DANGIN PURI KAJA, DENPASAR UTARA, KOTA DENPASAR, BALI",22,180,13,193
https://kawalpemilu.org#54016,"DANGIN PURI KAJA, DENPASAR UTARA, KOTA DENPASAR, BALI",23,198,7,205
https://kawalpemilu.org#54016,"DANGIN PURI KAJA, DENPASAR UTARA, KOTA DENPASAR, BALI",24,197,10,207
https://kawalpemilu.org#54016,"DANGIN PURI KAJA, DENPASAR UTARA, KOTA DENPASAR, BALI",25,193,8,201
https://kawalpemilu.org#54016,"DANGIN PURI KAJA, DENPASAR UTARA, KOTA DENPASAR, BALI",26,199,12,211
https://kawalpemilu.org#54016,"DANGIN PURI KAJA, DENPASAR UTARA, KOTA DENPASAR, BALI",27,186,21,207
https://kawalpemilu.org#54016,"DANGIN PURI KAJA, DENPASAR UTARA, KOTA DENPASAR, BALI",28,177,7,184
https://kawalpemilu.org#54016,"DANGIN PURI KAJA, DENPASAR UTARA, KOTA DENPASAR, BALI",29,142,9,151
https://kawalpemilu.org#54016,"DANGIN PURI KAJA, DENPASAR UTARA, KOTA DENPASAR, BALI",30,196,5,201
https://kawalpemilu.org#54016,"DANGIN PURI KAJA, DENPASAR UTARA, KOTA DENPASAR, BALI",31,213,11,224
https://kawalpemilu.org#54016,"DANGIN PURI KAJA, DENPASAR UTARA, KOTA DENPASAR, BALI",32,185,6,191
https://kawalpemilu.org#54016,"DANGIN PURI KAJA, DENPASAR UTARA, KOTA DENPASAR, BALI",33,178,2,180
https://kawalpemilu.org#54016,"DANGIN PURI KAJA, DENPASAR UTARA, KOTA DENPASAR, BALI",34,162,4,166
https://kawalpemilu.org#54016,"DANGIN PURI KAJA, DENPASAR UTARA, KOTA DENPASAR, BALI",35,177,7,184
https://kawalpemilu.org#54016,"DANGIN PURI KAJA, DENPASAR UTARA, KOTA DENPASAR, BALI",36,164,13,177
https://kawalpemilu.org#54016,"DANGIN PURI KAJA, DENPASAR UTARA, KOTA DENPASAR, BALI",37,151,7,158
https://kawalpemilu.org#54016,"DANGIN PURI KAJA, DENPASAR UTARA, KOTA DENPASAR, BALI",38,140,8,148
https://kawalpemilu.org#54016,"DANGIN PURI KAJA, DENPASAR UTARA, KOTA DENPASAR, BALI",39,80,8,88
https://kawalpemilu.org#54016,"DANGIN PURI KAJA, DENPASAR UTARA, KOTA DENPASAR, BALI",40,141,7,148
https://kawalpemilu.org#54017,"PEMECUTAN KAJA, DENPASAR UTARA, KOTA DENPASAR, BALI",1,180,12,192
https://kawalpemilu.org#54017,"PEMECUTAN KAJA, DENPASAR UTARA, KOTA DENPASAR, BALI",2,196,14,210
https://kawalpemilu.org#54017,"PEMECUTAN KAJA, DENPASAR UTARA, KOTA DENPASAR, BALI",3,198,15,213
https://kawalpemilu.org#54017,"PEMECUTAN KAJA, DENPASAR UTARA, KOTA DENPASAR, BALI",4,221,7,228
https://kawalpemilu.org#54017,"PEMECUTAN KAJA, DENPASAR UTARA, KOTA DENPASAR, BALI",5,225,9,234
https://kawalpemilu.org#54017,"PEMECUTAN KAJA, DENPASAR UTARA, KOTA DENPASAR, BALI",6,202,8,210
https://kawalpemilu.org#54017,"PEMECUTAN KAJA, DENPASAR UTARA, KOTA DENPASAR, BALI",7,172,21,193
https://kawalpemilu.org#54017,"PEMECUTAN KAJA, DENPASAR UTARA, KOTA DENPASAR, BALI",8,194,11,205
https://kawalpemilu.org#54017,"PEMECUTAN KAJA, DENPASAR UTARA, KOTA DENPASAR, BALI",9,221,16,237
https://kawalpemilu.org#54017,"PEMECUTAN KAJA, DENPASAR UTARA, KOTA DENPASAR, BALI",10,199,12,211
https://kawalpemilu.org#54017,"PEMECUTAN KAJA, DENPASAR UTARA, KOTA DENPASAR, BALI",11,229,1,230
https://kawalpemilu.org#54017,"PEMECUTAN KAJA, DENPASAR UTARA, KOTA DENPASAR, BALI",12,236,5,241
https://kawalpemilu.org#54017,"PEMECUTAN KAJA, DENPASAR UTARA, KOTA DENPASAR, BALI",13,258,13,271
https://kawalpemilu.org#54017,"PEMECUTAN KAJA, DENPASAR UTARA, KOTA DENPASAR, BALI",14,230,10,240
https://kawalpemilu.org#54017,"PEMECUTAN KAJA, DENPASAR UTARA, KOTA DENPASAR, BALI",15,207,15,222
https://kawalpemilu.org#54017,"PEMECUTAN KAJA, DENPASAR UTARA, KOTA DENPASAR, BALI",16,193,15,208
https://kawalpemilu.org#54017,"PEMECUTAN KAJA, DENPASAR UTARA, KOTA DENPASAR, BALI",17,207,7,214
https://kawalpemilu.org#54017,"PEMECUTAN KAJA, DENPASAR UTARA, KOTA DENPASAR, BALI",18,187,6,193
https://kawalpemilu.org#54017,"PEMECUTAN KAJA, DENPASAR UTARA, KOTA DENPASAR, BALI",19,213,5,218
https://kawalpemilu.org#54017,"PEMECUTAN KAJA, DENPASAR UTARA, KOTA DENPASAR, BALI",20,211,4,215
https://kawalpemilu.org#54017,"PEMECUTAN KAJA, DENPASAR UTARA, KOTA DENPASAR, BALI",21,202,10,212
https://kawalpemilu.org#54017,"PEMECUTAN KAJA, DENPASAR UTARA, KOTA DENPASAR, BALI",22,201,8,209
https://kawalpemilu.org#54017,"PEMECUTAN KAJA, DENPASAR UTARA, KOTA DENPASAR, BALI",23,196,6,202
https://kawalpemilu.org#54017,"PEMECUTAN KAJA, DENPASAR UTARA, KOTA DENPASAR, BALI",24,175,11,186
https://kawalpemilu.org#54017,"PEMECUTAN KAJA, DENPASAR UTARA, KOTA DENPASAR, BALI",25,192,6,198
https://kawalpemilu.org#54017,"PEMECUTAN KAJA, DENPASAR UTARA, KOTA DENPASAR, BALI",26,178,11,189
https://kawalpemilu.org#54017,"PEMECUTAN KAJA, DENPASAR UTARA, KOTA DENPASAR, BALI",27,172,3,175
https://kawalpemilu.org#54017,"PEMECUTAN KAJA, DENPASAR UTARA, KOTA DENPASAR, BALI",28,178,15,193
https://kawalpemilu.org#54017,"PEMECUTAN KAJA, DENPASAR UTARA, KOTA DENPASAR, BALI",29,196,12,208
https://kawalpemilu.org#54017,"PEMECUTAN KAJA, DENPASAR UTARA, KOTA DENPASAR, BALI",30,212,15,227
https://kawalpemilu.org#54017,"PEMECUTAN KAJA, DENPASAR UTARA, KOTA DENPASAR, BALI",31,202,22,224
https://kawalpemilu.org#54017,"PEMECUTAN KAJA, DENPASAR UTARA, KOTA DENPASAR, BALI",32,197,18,215
https://kawalpemilu.org#54017,"PEMECUTAN KAJA, DENPASAR UTARA, KOTA DENPASAR, BALI",33,201,22,223
https://kawalpemilu.org#54017,"PEMECUTAN KAJA, DENPASAR UTARA, KOTA DENPASAR, BALI",34,221,20,241
https://kawalpemilu.org#54017,"PEMECUTAN KAJA, DENPASAR UTARA, KOTA DENPASAR, BALI",35,191,17,208
https://kawalpemilu.org#54017,"PEMECUTAN KAJA, DENPASAR UTARA, KOTA DENPASAR, BALI",36,220,12,232
https://kawalpemilu.org#54017,"PEMECUTAN KAJA, DENPASAR UTARA, KOTA DENPASAR, BALI",37,217,20,237
https://kawalpemilu.org#54017,"PEMECUTAN KAJA, DENPASAR UTARA, KOTA DENPASAR, BALI",38,218,15,233
https://kawalpemilu.org#54017,"PEMECUTAN KAJA, DENPASAR UTARA, KOTA DENPASAR, BALI",39,192,24,216
https://kawalpemilu.org#54017,"PEMECUTAN KAJA, DENPASAR UTARA, KOTA DENPASAR, BALI",40,184,27,211
https://kawalpemilu.org#54017,"PEMECUTAN KAJA, DENPASAR UTARA, KOTA DENPASAR, BALI",41,180,37,217
https://kawalpemilu.org#54017,"PEMECUTAN KAJA, DENPASAR UTARA, KOTA DENPASAR, BALI",42,197,28,225
https://kawalpemilu.org#54017,"PEMECUTAN KAJA, DENPASAR UTARA, KOTA DENPASAR, BALI",43,177,18,195
https://kawalpemilu.org#54017,"PEMECUTAN KAJA, DENPASAR UTARA, KOTA DENPASAR, BALI",44,181,22,203
https://kawalpemilu.org#54017,"PEMECUTAN KAJA, DENPASAR UTARA, KOTA DENPASAR, BALI",45,237,6,243
https://kawalpemilu.org#54017,"PEMECUTAN KAJA, DENPASAR UTARA, KOTA DENPASAR, BALI",46,216,2,218
https://kawalpemilu.org#54017,"PEMECUTAN KAJA, DENPASAR UTARA, KOTA DENPASAR, BALI",47,193,10,203
https://kawalpemilu.org#54017,"PEMECUTAN KAJA, DENPASAR UTARA, KOTA DENPASAR, BALI",48,219,4,223
https://kawalpemilu.org#54017,"PEMECUTAN KAJA, DENPASAR UTARA, KOTA DENPASAR, BALI",49,227,1,228
https://kawalpemilu.org#54017,"PEMECUTAN KAJA, DENPASAR UTARA, KOTA DENPASAR, BALI",50,202,5,207
https://kawalpemilu.org#54017,"PEMECUTAN KAJA, DENPASAR UTARA, KOTA DENPASAR, BALI",51,217,8,225
https://kawalpemilu.org#54017,"PEMECUTAN KAJA, DENPASAR UTARA, KOTA DENPASAR, BALI",52,219,6,225
https://kawalpemilu.org#54017,"PEMECUTAN KAJA, DENPASAR UTARA, KOTA DENPASAR, BALI",53,232,14,246
https://kawalpemilu.org#54017,"PEMECUTAN KAJA, DENPASAR UTARA, KOTA DENPASAR, BALI",54,230,7,237
https://kawalpemilu.org#54017,"PEMECUTAN KAJA, DENPASAR UTARA, KOTA DENPASAR, BALI",55,248,5,253
https://kawalpemilu.org#54017,"PEMECUTAN KAJA, DENPASAR UTARA, KOTA DENPASAR, BALI",56,232,11,243
https://kawalpemilu.org#54017,"PEMECUTAN KAJA, DENPASAR UTARA, KOTA DENPASAR, BALI",57,231,11,242
https://kawalpemilu.org#54017,"PEMECUTAN KAJA, DENPASAR UTARA, KOTA DENPASAR, BALI",58,235,9,244
https://kawalpemilu.org#54017,"PEMECUTAN KAJA, DENPASAR UTARA, KOTA DENPASAR, BALI",59,232,5,237
https://kawalpemilu.org#54017,"PEMECUTAN KAJA, DENPASAR UTARA, KOTA DENPASAR, BALI",60,238,10,248
https://kawalpemilu.org#54017,"PEMECUTAN KAJA, DENPASAR UTARA, KOTA DENPASAR, BALI",61,225,3,228
https://kawalpemilu.org#54017,"PEMECUTAN KAJA, DENPASAR UTARA, KOTA DENPASAR, BALI",62,217,10,227
https://kawalpemilu.org#54017,"PEMECUTAN KAJA, DENPASAR UTARA, KOTA DENPASAR, BALI",63,217,11,228
https://kawalpemilu.org#54017,"PEMECUTAN KAJA, DENPASAR UTARA, KOTA DENPASAR, BALI",64,211,8,219
https://kawalpemilu.org#54017,"PEMECUTAN KAJA, DENPASAR UTARA, KOTA DENPASAR, BALI",65,215,2,217
https://kawalpemilu.org#54017,"PEMECUTAN KAJA, DENPASAR UTARA, KOTA DENPASAR, BALI",66,208,3,211
https://kawalpemilu.org#54017,"PEMECUTAN KAJA, DENPASAR UTARA, KOTA DENPASAR, BALI",67,226,3,229
https://kawalpemilu.org#54017,"PEMECUTAN KAJA, DENPASAR UTARA, KOTA DENPASAR, BALI",68,238,3,241
https://kawalpemilu.org#54017,"PEMECUTAN KAJA, DENPASAR UTARA, KOTA DENPASAR, BALI",69,199,6,205
https://kawalpemilu.org#54017,"PEMECUTAN KAJA, DENPASAR UTARA, KOTA DENPASAR, BALI",70,226,4,230
https://kawalpemilu.org#54017,"PEMECUTAN KAJA, DENPASAR UTARA, KOTA DENPASAR, BALI",71,212,4,216
https://kawalpemilu.org#54017,"PEMECUTAN KAJA, DENPASAR UTARA, KOTA DENPASAR, BALI",72,226,2,228
https://kawalpemilu.org#54017,"PEMECUTAN KAJA, DENPASAR UTARA, KOTA DENPASAR, BALI",73,215,7,222
https://kawalpemilu.org#54017,"PEMECUTAN KAJA, DENPASAR UTARA, KOTA DENPASAR, BALI",74,156,10,166
https://kawalpemilu.org#54018,"DAUH PURI KAJA, DENPASAR UTARA, KOTA DENPASAR, BALI",1,199,12,211
https://kawalpemilu.org#54018,"DAUH PURI KAJA, DENPASAR UTARA, KOTA DENPASAR, BALI",2,197,24,221
https://kawalpemilu.org#54018,"DAUH PURI KAJA, DENPASAR UTARA, KOTA DENPASAR, BALI",3,194,12,206
https://kawalpemilu.org#54018,"DAUH PURI KAJA, DENPASAR UTARA, KOTA DENPASAR, BALI",4,247,4,251
https://kawalpemilu.org#54018,"DAUH PURI KAJA, DENPASAR UTARA, KOTA DENPASAR, BALI",5,233,9,242
https://kawalpemilu.org#54018,"DAUH PURI KAJA, DENPASAR UTARA, KOTA DENPASAR, BALI",6,241,4,245
https://kawalpemilu.org#54018,"DAUH PURI KAJA, DENPASAR UTARA, KOTA DENPASAR, BALI",7,250,5,255
https://kawalpemilu.org#54018,"DAUH PURI KAJA, DENPASAR UTARA, KOTA DENPASAR, BALI",8,250,7,257
https://kawalpemilu.org#54018,"DAUH PURI KAJA, DENPASAR UTARA, KOTA DENPASAR, BALI",9,248,5,253
https://kawalpemilu.org#54018,"DAUH PURI KAJA, DENPASAR UTARA, KOTA DENPASAR, BALI",10,206,10,216
https://kawalpemilu.org#54018,"DAUH PURI KAJA, DENPASAR UTARA, KOTA DENPASAR, BALI",11,221,4,225
https://kawalpemilu.org#54018,"DAUH PURI KAJA, DENPASAR UTARA, KOTA DENPASAR, BALI",12,202,6,208
https://kawalpemilu.org#54018,"DAUH PURI KAJA, DENPASAR UTARA, KOTA DENPASAR, BALI",13,208,2,210
https://kawalpemilu.org#54018,"DAUH PURI KAJA, DENPASAR UTARA, KOTA DENPASAR, BALI",14,206,7,213
https://kawalpemilu.org#54018,"DAUH PURI KAJA, DENPASAR UTARA, KOTA DENPASAR, BALI",15,216,15,231
https://kawalpemilu.org#54018,"DAUH PURI KAJA, DENPASAR UTARA, KOTA DENPASAR, BALI",16,199,23,222
https://kawalpemilu.org#54018,"DAUH PURI KAJA, DENPASAR UTARA, KOTA DENPASAR, BALI",17,218,19,237
https://kawalpemilu.org#54018,"DAUH PURI KAJA, DENPASAR UTARA, KOTA DENPASAR, BALI",18,218,12,230
https://kawalpemilu.org#54018,"DAUH PURI KAJA, DENPASAR UTARA, KOTA DENPASAR, BALI",19,228,25,253
https://kawalpemilu.org#54018,"DAUH PURI KAJA, DENPASAR UTARA, KOTA DENPASAR, BALI",20,223,22,245
https://kawalpemilu.org#54018,"DAUH PURI KAJA, DENPASAR UTARA, KOTA DENPASAR, BALI",21,188,38,226
https://kawalpemilu.org#54018,"DAUH PURI KAJA, DENPASAR UTARA, KOTA DENPASAR, BALI",22,207,30,237
https://kawalpemilu.org#54018,"DAUH PURI KAJA, DENPASAR UTARA, KOTA DENPASAR, BALI",23,148,24,172
https://kawalpemilu.org#54018,"DAUH PURI KAJA, DENPASAR UTARA, KOTA DENPASAR, BALI",24,165,32,197
https://kawalpemilu.org#54018,"DAUH PURI KAJA, DENPASAR UTARA, KOTA DENPASAR, BALI",25,145,17,162
https://kawalpemilu.org#54018,"DAUH PURI KAJA, DENPASAR UTARA, KOTA DENPASAR, BALI",26,125,76,201
https://kawalpemilu.org#54018,"DAUH PURI KAJA, DENPASAR UTARA, KOTA DENPASAR, BALI",27,109,89,198
https://kawalpemilu.org#54018,"DAUH PURI KAJA, DENPASAR UTARA, KOTA DENPASAR, BALI",28,127,78,205
https://kawalpemilu.org#54018,"DAUH PURI KAJA, DENPASAR UTARA, KOTA DENPASAR, BALI",29,78,141,219
https://kawalpemilu.org#54018,"DAUH PURI KAJA, DENPASAR UTARA, KOTA DENPASAR, BALI",30,98,126,224
https://kawalpemilu.org#54018,"DAUH PURI KAJA, DENPASAR UTARA, KOTA DENPASAR, BALI",31,90,101,191
https://kawalpemilu.org#54018,"DAUH PURI KAJA, DENPASAR UTARA, KOTA DENPASAR, BALI",32,130,112,242
https://kawalpemilu.org#54018,"DAUH PURI KAJA, DENPASAR UTARA, KOTA DENPASAR, BALI",33,93,133,226
https://kawalpemilu.org#54018,"DAUH PURI KAJA, DENPASAR UTARA, KOTA DENPASAR, BALI",34,85,120,205
https://kawalpemilu.org#54018,"DAUH PURI KAJA, DENPASAR UTARA, KOTA DENPASAR, BALI",35,66,133,199
https://kawalpemilu.org#54018,"DAUH PURI KAJA, DENPASAR UTARA, KOTA DENPASAR, BALI",36,43,151,194
https://kawalpemilu.org#54018,"DAUH PURI KAJA, DENPASAR UTARA, KOTA DENPASAR, BALI",37,55,132,187
https://kawalpemilu.org#54018,"DAUH PURI KAJA, DENPASAR UTARA, KOTA DENPASAR, BALI",38,75,110,186
https://kawalpemilu.org#54018,"DAUH PURI KAJA, DENPASAR UTARA, KOTA DENPASAR, BALI",39,73,97,170
https://kawalpemilu.org#54018,"DAUH PURI KAJA, DENPASAR UTARA, KOTA DENPASAR, BALI",40,70,113,183
https://kawalpemilu.org#54018,"DAUH PURI KAJA, DENPASAR UTARA, KOTA DENPASAR, BALI",41,88,64,152
https://kawalpemilu.org#54018,"DAUH PURI KAJA, DENPASAR UTARA, KOTA DENPASAR, BALI",42,84,78,162
https://kawalpemilu.org#54018,"DAUH PURI KAJA, DENPASAR UTARA, KOTA DENPASAR, BALI",43,61,72,133
https://kawalpemilu.org#54018,"DAUH PURI KAJA, DENPASAR UTARA, KOTA DENPASAR, BALI",44,143,72,215
https://kawalpemilu.org#54018,"DAUH PURI KAJA, DENPASAR UTARA, KOTA DENPASAR, BALI",45,122,84,206
https://kawalpemilu.org#54018,"DAUH PURI KAJA, DENPASAR UTARA, KOTA DENPASAR, BALI",46,140,58,198
https://kawalpemilu.org#54018,"DAUH PURI KAJA, DENPASAR UTARA, KOTA DENPASAR, BALI",47,116,72,2
https://kawalpemilu.org#54018,"DAUH PURI KAJA, DENPASAR UTARA, KOTA DENPASAR, BALI",48,120,51,171
https://kawalpemilu.org#54018,"DAUH PURI KAJA, DENPASAR UTARA, KOTA DENPASAR, BALI",49,85,33,118
https://kawalpemilu.org#54019,"UBUNG KAJA, DENPASAR UTARA, KOTA DENPASAR, BALI",1,195,8,203
https://kawalpemilu.org#54019,"UBUNG KAJA, DENPASAR UTARA, KOTA DENPASAR, BALI",2,192,13,205
https://kawalpemilu.org#54019,"UBUNG KAJA, DENPASAR UTARA, KOTA DENPASAR, BALI",3,199,17,216
https://kawalpemilu.org#54019,"UBUNG KAJA, DENPASAR UTARA, KOTA DENPASAR, BALI",4,285,8,293
https://kawalpemilu.org#54019,"UBUNG KAJA, DENPASAR UTARA, KOTA DENPASAR, BALI",5,280,4,284
https://kawalpemilu.org#54019,"UBUNG KAJA, DENPASAR UTARA, KOTA DENPASAR, BALI",6,150,13,163
https://kawalpemilu.org#54019,"UBUNG KAJA, DENPASAR UTARA, KOTA DENPASAR, BALI",7,149,8,157
https://kawalpemilu.org#54019,"UBUNG KAJA, DENPASAR UTARA, KOTA DENPASAR, BALI",8,216,27,243
https://kawalpemilu.org#54019,"UBUNG KAJA, DENPASAR UTARA, KOTA DENPASAR, BALI",9,212,20,232
https://kawalpemilu.org#54019,"UBUNG KAJA, DENPASAR UTARA, KOTA DENPASAR, BALI",10,234,14,248
https://kawalpemilu.org#54019,"UBUNG KAJA, DENPASAR UTARA, KOTA DENPASAR, BALI",11,222,21,243
https://kawalpemilu.org#54019,"UBUNG KAJA, DENPASAR UTARA, KOTA DENPASAR, BALI",12,237,12,249
https://kawalpemilu.org#54019,"UBUNG KAJA, DENPASAR UTARA, KOTA DENPASAR, BALI",13,235,11,246
https://kawalpemilu.org#54019,"UBUNG KAJA, DENPASAR UTARA, KOTA DENPASAR, BALI",14,201,9,210
https://kawalpemilu.org#54019,"UBUNG KAJA, DENPASAR UTARA, KOTA DENPASAR, BALI",15,212,14,226
https://kawalpemilu.org#54019,"UBUNG KAJA, DENPASAR UTARA, KOTA DENPASAR, BALI",16,238,21,259
https://kawalpemilu.org#54019,"UBUNG KAJA, DENPASAR UTARA, KOTA DENPASAR, BALI",17,163,8,171
https://kawalpemilu.org#54019,"UBUNG KAJA, DENPASAR UTARA, KOTA DENPASAR, BALI",18,203,28,231
https://kawalpemilu.org#54019,"UBUNG KAJA, DENPASAR UTARA, KOTA DENPASAR, BALI",19,188,38,226
https://kawalpemilu.org#54019,"UBUNG KAJA, DENPASAR UTARA, KOTA DENPASAR, BALI",20,210,49,259
https://kawalpemilu.org#54019,"UBUNG KAJA, DENPASAR UTARA, KOTA DENPASAR, BALI",21,206,39,245
https://kawalpemilu.org#54019,"UBUNG KAJA, DENPASAR UTARA, KOTA DENPASAR, BALI",22,221,15,236
https://kawalpemilu.org#54019,"UBUNG KAJA, DENPASAR UTARA, KOTA DENPASAR, BALI",23,243,8,251
https://kawalpemilu.org#54019,"UBUNG KAJA, DENPASAR UTARA, KOTA DENPASAR, BALI",24,210,21,231
https://kawalpemilu.org#54019,"UBUNG KAJA, DENPASAR UTARA, KOTA DENPASAR, BALI",25,195,19,214
https://kawalpemilu.org#54019,"UBUNG KAJA, DENPASAR UTARA, KOTA DENPASAR, BALI",26,234,27,261
https://kawalpemilu.org#54019,"UBUNG KAJA, DENPASAR UTARA, KOTA DENPASAR, BALI",27,213,21,234
https://kawalpemilu.org#54019,"UBUNG KAJA, DENPASAR UTARA, KOTA DENPASAR, BALI",28,199,19,218
https://kawalpemilu.org#54019,"UBUNG KAJA, DENPASAR UTARA, KOTA DENPASAR, BALI",29,221,17,238
https://kawalpemilu.org#54019,"UBUNG KAJA, DENPASAR UTARA, KOTA DENPASAR, BALI",30,235,14,249
https://kawalpemilu.org#54019,"UBUNG KAJA, DENPASAR UTARA, KOTA DENPASAR, BALI",31,222,21,243
https://kawalpemilu.org#54019,"UBUNG KAJA, DENPASAR UTARA, KOTA DENPASAR, BALI",32,215,22,237
https://kawalpemilu.org#54019,"UBUNG KAJA, DENPASAR UTARA, KOTA DENPASAR, BALI",33,194,16,210
https://kawalpemilu.org#54019,"UBUNG KAJA, DENPASAR UTARA, KOTA DENPASAR, BALI",34,232,11,243
https://kawalpemilu.org#54019,"UBUNG KAJA, DENPASAR UTARA, KOTA DENPASAR, BALI",35,197,20,217
https://kawalpemilu.org#54019,"UBUNG KAJA, DENPASAR UTARA, KOTA DENPASAR, BALI",36,226,13,239
https://kawalpemilu.org#54019,"UBUNG KAJA, DENPASAR UTARA, KOTA DENPASAR, BALI",37,237,11,248
https://kawalpemilu.org#54019,"UBUNG KAJA, DENPASAR UTARA, KOTA DENPASAR, BALI",38,179,14,193
https://kawalpemilu.org#54019,"UBUNG KAJA, DENPASAR UTARA, KOTA DENPASAR, BALI",39,182,19,201
https://kawalpemilu.org#54019,"UBUNG KAJA, DENPASAR UTARA, KOTA DENPASAR, BALI",40,166,12,178
https://kawalpemilu.org#54019,"UBUNG KAJA, DENPASAR UTARA, KOTA DENPASAR, BALI",41,186,14,200
https://kawalpemilu.org#54019,"UBUNG KAJA, DENPASAR UTARA, KOTA DENPASAR, BALI",42,202,19,221
https://kawalpemilu.org#54019,"UBUNG KAJA, DENPASAR UTARA, KOTA DENPASAR, BALI",43,205,8,213
https://kawalpemilu.org#54019,"UBUNG KAJA, DENPASAR UTARA, KOTA DENPASAR, BALI",44,210,13,223
https://kawalpemilu.org#54019,"UBUNG KAJA, DENPASAR UTARA, KOTA DENPASAR, BALI",45,216,37,253
https://kawalpemilu.org#54019,"UBUNG KAJA, DENPASAR UTARA, KOTA DENPASAR, BALI",46,228,12,240
https://kawalpemilu.org#54019,"UBUNG KAJA, DENPASAR UTARA, KOTA DENPASAR, BALI",47,192,27,219
https://kawalpemilu.org#54019,"UBUNG KAJA, DENPASAR UTARA, KOTA DENPASAR, BALI",48,185,28,213
https://kawalpemilu.org#54019,"UBUNG KAJA, DENPASAR UTARA, KOTA DENPASAR, BALI",49,180,22,202
https://kawalpemilu.org#54019,"UBUNG KAJA, DENPASAR UTARA, KOTA DENPASAR, BALI",50,162,35,197
https://kawalpemilu.org#54019,"UBUNG KAJA, DENPASAR UTARA, KOTA DENPASAR, BALI",51,150,26,176
https://kawalpemilu.org#54019,"UBUNG KAJA, DENPASAR UTARA, KOTA DENPASAR, BALI",52,177,27,204
https://kawalpemilu.org#54019,"UBUNG KAJA, DENPASAR UTARA, KOTA DENPASAR, BALI",53,201,17,218
https://kawalpemilu.org#54019,"UBUNG KAJA, DENPASAR UTARA, KOTA DENPASAR, BALI",54,166,31,197
https://kawalpemilu.org#54019,"UBUNG KAJA, DENPASAR UTARA, KOTA DENPASAR, BALI",55,136,22,158
https://kawalpemilu.org#54019,"UBUNG KAJA, DENPASAR UTARA, KOTA DENPASAR, BALI",56,143,25,168
https://kawalpemilu.org#54019,"UBUNG KAJA, DENPASAR UTARA, KOTA DENPASAR, BALI",57,122,16,138
https://kawalpemilu.org#54019,"UBUNG KAJA, DENPASAR UTARA, KOTA DENPASAR, BALI",58,188,13,201
