Link KawalPemilu,Nama Kelurahan,Nomor TPS,Suara 01,Suara 02,Suara Sah
https://kawalpemilu.org#51581,"SUMBERJAYA, SUMUR, PANDEGLANG, BANTEN",1,27,131,158
https://kawalpemilu.org#51581,"SUMBERJAYA, SUMUR, PANDEGLANG, BANTEN",2,26,79,105
https://kawalpemilu.org#51581,"SUMBERJAYA, SUMUR, PANDEGLANG, BANTEN",3,74,123,197
https://kawalpemilu.org#51581,"SUMBERJAYA, SUMUR, PANDEGLANG, BANTEN",4,71,112,183
https://kawalpemilu.org#51581,"SUMBERJAYA, SUMUR, PANDEGLANG, BANTEN",5,49,122,171
https://kawalpemilu.org#51581,"SUMBERJAYA, SUMUR, PANDEGLANG, BANTEN",6,68,137,205
https://kawalpemilu.org#51581,"SUMBERJAYA, SUMUR, PANDEGLANG, BANTEN",7,98,147,245
https://kawalpemilu.org#51581,"SUMBERJAYA, SUMUR, PANDEGLANG, BANTEN",8,95,133,228
https://kawalpemilu.org#51581,"SUMBERJAYA, SUMUR, PANDEGLANG, BANTEN",9,97,111,208
https://kawalpemilu.org#51581,"SUMBERJAYA, SUMUR, PANDEGLANG, BANTEN",10,68,96,164
https://kawalpemilu.org#51581,"SUMBERJAYA, SUMUR, PANDEGLANG, BANTEN",11,52,93,145
https://kawalpemilu.org#51581,"SUMBERJAYA, SUMUR, PANDEGLANG, BANTEN",12,98,83,181
https://kawalpemilu.org#51581,"SUMBERJAYA, SUMUR, PANDEGLANG, BANTEN",13,103,72,175
https://kawalpemilu.org#51582,"KERTAJAYA, SUMUR, PANDEGLANG, BANTEN",1,135,107,242
https://kawalpemilu.org#51582,"KERTAJAYA, SUMUR, PANDEGLANG, BANTEN",2,105,134,239
https://kawalpemilu.org#51582,"KERTAJAYA, SUMUR, PANDEGLANG, BANTEN",3,118,98,216
https://kawalpemilu.org#51582,"KERTAJAYA, SUMUR, PANDEGLANG, BANTEN",4,38,185,223
https://kawalpemilu.org#51582,"KERTAJAYA, SUMUR, PANDEGLANG, BANTEN",5,107,102,209
https://kawalpemilu.org#51582,"KERTAJAYA, SUMUR, PANDEGLANG, BANTEN",6,69,141,210
https://kawalpemilu.org#51582,"KERTAJAYA, SUMUR, PANDEGLANG, BANTEN",7,117,100,217
https://kawalpemilu.org#51582,"KERTAJAYA, SUMUR, PANDEGLANG, BANTEN",8,101,103,204
https://kawalpemilu.org#51582,"KERTAJAYA, SUMUR, PANDEGLANG, BANTEN",10,69,94,163
https://kawalpemilu.org#51582,"KERTAJAYA, SUMUR, PANDEGLANG, BANTEN",11,97,101,198
https://kawalpemilu.org#51583,"KERTAMUKTI, SUMUR, PANDEGLANG, BANTEN",1,106,67,173
https://kawalpemilu.org#51583,"KERTAMUKTI, SUMUR, PANDEGLANG, BANTEN",2,0,0,0
https://kawalpemilu.org#51583,"KERTAMUKTI, SUMUR, PANDEGLANG, BANTEN",3,125,83,208
https://kawalpemilu.org#51583,"KERTAMUKTI, SUMUR, PANDEGLANG, BANTEN",4,116,78,194
https://kawalpemilu.org#51583,"KERTAMUKTI, SUMUR, PANDEGLANG, BANTEN",5,75,136,211
https://kawalpemilu.org#51583,"KERTAMUKTI, SUMUR, PANDEGLANG, BANTEN",6,86,75,161
https://kawalpemilu.org#51583,"KERTAMUKTI, SUMUR, PANDEGLANG, BANTEN",7,95,90,185
https://kawalpemilu.org#51583,"KERTAMUKTI, SUMUR, PANDEGLANG, BANTEN",8,86,120,206
https://kawalpemilu.org#51583,"KERTAMUKTI, SUMUR, PANDEGLANG, BANTEN",9,114,34,148
https://kawalpemilu.org#51583,"KERTAMUKTI, SUMUR, PANDEGLANG, BANTEN",10,94,46,140
https://kawalpemilu.org#51584,"TUNGGALJAYA, SUMUR, PANDEGLANG, BANTEN",1,89,122,211
https://kawalpemilu.org#51584,"TUNGGALJAYA, SUMUR, PANDEGLANG, BANTEN",2,103,63,166
https://kawalpemilu.org#51584,"TUNGGALJAYA, SUMUR, PANDEGLANG, BANTEN",3,103,23,126
https://kawalpemilu.org#51584,"TUNGGALJAYA, SUMUR, PANDEGLANG, BANTEN",4,145,75,220
https://kawalpemilu.org#51584,"TUNGGALJAYA, SUMUR, PANDEGLANG, BANTEN",5,105,112,217
https://kawalpemilu.org#51584,"TUNGGALJAYA, SUMUR, PANDEGLANG, BANTEN",6,124,82,206
https://kawalpemilu.org#51584,"TUNGGALJAYA, SUMUR, PANDEGLANG, BANTEN",7,129,86,215
https://kawalpemilu.org#51584,"TUNGGALJAYA, SUMUR, PANDEGLANG, BANTEN",8,88,124,212
https://kawalpemilu.org#51584,"TUNGGALJAYA, SUMUR, PANDEGLANG, BANTEN",9,108,110,218
https://kawalpemilu.org#51585,"CIGORONDONG, SUMUR, PANDEGLANG, BANTEN",1,106,29,135
https://kawalpemilu.org#51585,"CIGORONDONG, SUMUR, PANDEGLANG, BANTEN",2,105,9,114
https://kawalpemilu.org#51585,"CIGORONDONG, SUMUR, PANDEGLANG, BANTEN",3,97,96,193
https://kawalpemilu.org#51585,"CIGORONDONG, SUMUR, PANDEGLANG, BANTEN",4,105,25,130
https://kawalpemilu.org#51585,"CIGORONDONG, SUMUR, PANDEGLANG, BANTEN",5,80,100,180
https://kawalpemilu.org#51585,"CIGORONDONG, SUMUR, PANDEGLANG, BANTEN",7,115,123,238
https://kawalpemilu.org#51585,"CIGORONDONG, SUMUR, PANDEGLANG, BANTEN",8,79,80,159
https://kawalpemilu.org#51586,"TAMANJAYA, SUMUR, PANDEGLANG, BANTEN",1,66,102,168
https://kawalpemilu.org#51586,"TAMANJAYA, SUMUR, PANDEGLANG, BANTEN",2,66,140,206
https://kawalpemilu.org#51586,"TAMANJAYA, SUMUR, PANDEGLANG, BANTEN",3,135,73,208
https://kawalpemilu.org#51586,"TAMANJAYA, SUMUR, PANDEGLANG, BANTEN",4,129,44,173
https://kawalpemilu.org#51586,"TAMANJAYA, SUMUR, PANDEGLANG, BANTEN",5,171,17,188
https://kawalpemilu.org#51586,"TAMANJAYA, SUMUR, PANDEGLANG, BANTEN",6,66,131,197
https://kawalpemilu.org#51586,"TAMANJAYA, SUMUR, PANDEGLANG, BANTEN",7,111,13,124
https://kawalpemilu.org#51586,"TAMANJAYA, SUMUR, PANDEGLANG, BANTEN",8,116,16,132
https://kawalpemilu.org#51586,"TAMANJAYA, SUMUR, PANDEGLANG, BANTEN",9,166,45,211
https://kawalpemilu.org#51587,"UJUNGJAYA, SUMUR, PANDEGLANG, BANTEN",1,121,30,151
https://kawalpemilu.org#51587,"UJUNGJAYA, SUMUR, PANDEGLANG, BANTEN",2,169,26,195
https://kawalpemilu.org#51587,"UJUNGJAYA, SUMUR, PANDEGLANG, BANTEN",3,137,31,168
https://kawalpemilu.org#51587,"UJUNGJAYA, SUMUR, PANDEGLANG, BANTEN",4,158,29,187
https://kawalpemilu.org#51587,"UJUNGJAYA, SUMUR, PANDEGLANG, BANTEN",5,167,44,211
https://kawalpemilu.org#51587,"UJUNGJAYA, SUMUR, PANDEGLANG, BANTEN",6,163,37,200
https://kawalpemilu.org#51587,"UJUNGJAYA, SUMUR, PANDEGLANG, BANTEN",7,61,62,123
https://kawalpemilu.org#51587,"UJUNGJAYA, SUMUR, PANDEGLANG, BANTEN",8,134,35,169
https://kawalpemilu.org#51587,"UJUNGJAYA, SUMUR, PANDEGLANG, BANTEN",9,124,28,152
https://kawalpemilu.org#51587,"UJUNGJAYA, SUMUR, PANDEGLANG, BANTEN",10,167,19,186
https://kawalpemilu.org#51587,"UJUNGJAYA, SUMUR, PANDEGLANG, BANTEN",11,48,75,123
https://kawalpemilu.org#51587,"UJUNGJAYA, SUMUR, PANDEGLANG, BANTEN",12,90,97,187
https://kawalpemilu.org#51587,"UJUNGJAYA, SUMUR, PANDEGLANG, BANTEN",13,90,75,165
https://kawalpemilu.org#51589,"RANCAPINANG, CIMANGGU, PANDEGLANG, BANTEN",1,145,39,184
https://kawalpemilu.org#51589,"RANCAPINANG, CIMANGGU, PANDEGLANG, BANTEN",2,129,44,173
https://kawalpemilu.org#51589,"RANCAPINANG, CIMANGGU, PANDEGLANG, BANTEN",3,122,96,218
https://kawalpemilu.org#51589,"RANCAPINANG, CIMANGGU, PANDEGLANG, BANTEN",4,108,74,182
https://kawalpemilu.org#51589,"RANCAPINANG, CIMANGGU, PANDEGLANG, BANTEN",5,56,114,170
https://kawalpemilu.org#51589,"RANCAPINANG, CIMANGGU, PANDEGLANG, BANTEN",6,57,101,158
https://kawalpemilu.org#51589,"RANCAPINANG, CIMANGGU, PANDEGLANG, BANTEN",7,103,69,172
https://kawalpemilu.org#51589,"RANCAPINANG, CIMANGGU, PANDEGLANG, BANTEN",9,171,45,216
https://kawalpemilu.org#51589,"RANCAPINANG, CIMANGGU, PANDEGLANG, BANTEN",10,178,53,231
https://kawalpemilu.org#51589,"RANCAPINANG, CIMANGGU, PANDEGLANG, BANTEN",11,154,42,196
https://kawalpemilu.org#51589,"RANCAPINANG, CIMANGGU, PANDEGLANG, BANTEN",12,154,39,193
https://kawalpemilu.org#51590,"CIBADAK, CIMANGGU, PANDEGLANG, BANTEN",1,84,80,164
https://kawalpemilu.org#51590,"CIBADAK, CIMANGGU, PANDEGLANG, BANTEN",2,104,73,177
https://kawalpemilu.org#51590,"CIBADAK, CIMANGGU, PANDEGLANG, BANTEN",3,44,40,84
https://kawalpemilu.org#51590,"CIBADAK, CIMANGGU, PANDEGLANG, BANTEN",4,109,82,191
https://kawalpemilu.org#51590,"CIBADAK, CIMANGGU, PANDEGLANG, BANTEN",5,103,80,183
https://kawalpemilu.org#51590,"CIBADAK, CIMANGGU, PANDEGLANG, BANTEN",6,139,78,217
https://kawalpemilu.org#51590,"CIBADAK, CIMANGGU, PANDEGLANG, BANTEN",7,191,48,239
https://kawalpemilu.org#51590,"CIBADAK, CIMANGGU, PANDEGLANG, BANTEN",8,162,40,202
https://kawalpemilu.org#51590,"CIBADAK, CIMANGGU, PANDEGLANG, BANTEN",9,97,35,132
https://kawalpemilu.org#51590,"CIBADAK, CIMANGGU, PANDEGLANG, BANTEN",10,138,18,156
https://kawalpemilu.org#51591,"TUGU, CIMANGGU, PANDEGLANG, BANTEN",1,107,108,215
https://kawalpemilu.org#51591,"TUGU, CIMANGGU, PANDEGLANG, BANTEN",2,74,67,141
https://kawalpemilu.org#51591,"TUGU, CIMANGGU, PANDEGLANG, BANTEN",3,127,44,171
https://kawalpemilu.org#51591,"TUGU, CIMANGGU, PANDEGLANG, BANTEN",4,107,78,185
https://kawalpemilu.org#51591,"TUGU, CIMANGGU, PANDEGLANG, BANTEN",5,126,20,146
https://kawalpemilu.org#51592,"BATUHIDEUNG, CIMANGGU, PANDEGLANG, BANTEN",1,33,116,149
https://kawalpemilu.org#51592,"BATUHIDEUNG, CIMANGGU, PANDEGLANG, BANTEN",2,28,144,172
https://kawalpemilu.org#51592,"BATUHIDEUNG, CIMANGGU, PANDEGLANG, BANTEN",3,154,49,203
https://kawalpemilu.org#51592,"BATUHIDEUNG, CIMANGGU, PANDEGLANG, BANTEN",4,145,32,176
https://kawalpemilu.org#51592,"BATUHIDEUNG, CIMANGGU, PANDEGLANG, BANTEN",5,73,81,154
https://kawalpemilu.org#51592,"BATUHIDEUNG, CIMANGGU, PANDEGLANG, BANTEN",6,124,34,158
https://kawalpemilu.org#51592,"BATUHIDEUNG, CIMANGGU, PANDEGLANG, BANTEN",7,92,39,131
https://kawalpemilu.org#51592,"BATUHIDEUNG, CIMANGGU, PANDEGLANG, BANTEN",8,119,34,153
https://kawalpemilu.org#51592,"BATUHIDEUNG, CIMANGGU, PANDEGLANG, BANTEN",9,112,15,127
https://kawalpemilu.org#51592,"BATUHIDEUNG, CIMANGGU, PANDEGLANG, BANTEN",10,115,62,77
https://kawalpemilu.org#51592,"BATUHIDEUNG, CIMANGGU, PANDEGLANG, BANTEN",11,96,72,168
https://kawalpemilu.org#51592,"BATUHIDEUNG, CIMANGGU, PANDEGLANG, BANTEN",12,91,50,141
https://kawalpemilu.org#51592,"BATUHIDEUNG, CIMANGGU, PANDEGLANG, BANTEN",13,71,24,95
https://kawalpemilu.org#51592,"BATUHIDEUNG, CIMANGGU, PANDEGLANG, BANTEN",14,88,32,120
https://kawalpemilu.org#51593,"PADASUKA, CIMANGGU, PANDEGLANG, BANTEN",1,101,137,238
https://kawalpemilu.org#51593,"PADASUKA, CIMANGGU, PANDEGLANG, BANTEN",2,135,114,249
https://kawalpemilu.org#51593,"PADASUKA, CIMANGGU, PANDEGLANG, BANTEN",3,86,108,194
https://kawalpemilu.org#51593,"PADASUKA, CIMANGGU, PANDEGLANG, BANTEN",4,125,108,233
https://kawalpemilu.org#51593,"PADASUKA, CIMANGGU, PANDEGLANG, BANTEN",5,86,31,117
https://kawalpemilu.org#51593,"PADASUKA, CIMANGGU, PANDEGLANG, BANTEN",6,47,124,171
https://kawalpemilu.org#51593,"PADASUKA, CIMANGGU, PANDEGLANG, BANTEN",7,151,66,217
https://kawalpemilu.org#51593,"PADASUKA, CIMANGGU, PANDEGLANG, BANTEN",8,116,92,208
https://kawalpemilu.org#51593,"PADASUKA, CIMANGGU, PANDEGLANG, BANTEN",9,111,118,229
https://kawalpemilu.org#51593,"PADASUKA, CIMANGGU, PANDEGLANG, BANTEN",10,163,24,187
https://kawalpemilu.org#51593,"PADASUKA, CIMANGGU, PANDEGLANG, BANTEN",11,133,33,166
https://kawalpemilu.org#51593,"PADASUKA, CIMANGGU, PANDEGLANG, BANTEN",12,70,46,116
https://kawalpemilu.org#51594,"CIBURIAL, CIMANGGU, PANDEGLANG, BANTEN",1,119,121,240
https://kawalpemilu.org#51594,"CIBURIAL, CIMANGGU, PANDEGLANG, BANTEN",2,81,126,207
https://kawalpemilu.org#51594,"CIBURIAL, CIMANGGU, PANDEGLANG, BANTEN",3,79,111,190
https://kawalpemilu.org#51594,"CIBURIAL, CIMANGGU, PANDEGLANG, BANTEN",4,87,123,210
https://kawalpemilu.org#51594,"CIBURIAL, CIMANGGU, PANDEGLANG, BANTEN",5,127,98,225
https://kawalpemilu.org#51594,"CIBURIAL, CIMANGGU, PANDEGLANG, BANTEN",6,113,103,216
https://kawalpemilu.org#51594,"CIBURIAL, CIMANGGU, PANDEGLANG, BANTEN",7,68,39,107
https://kawalpemilu.org#51594,"CIBURIAL, CIMANGGU, PANDEGLANG, BANTEN",8,61,71,132
https://kawalpemilu.org#51594,"CIBURIAL, CIMANGGU, PANDEGLANG, BANTEN",9,67,44,111
https://kawalpemilu.org#51594,"CIBURIAL, CIMANGGU, PANDEGLANG, BANTEN",10,87,47,134
https://kawalpemilu.org#51594,"CIBURIAL, CIMANGGU, PANDEGLANG, BANTEN",11,27,174,201
https://kawalpemilu.org#51594,"CIBURIAL, CIMANGGU, PANDEGLANG, BANTEN",12,93,123,216
https://kawalpemilu.org#51594,"CIBURIAL, CIMANGGU, PANDEGLANG, BANTEN",13,76,84,160
https://kawalpemilu.org#51594,"CIBURIAL, CIMANGGU, PANDEGLANG, BANTEN",14,110,95,205
https://kawalpemilu.org#51594,"CIBURIAL, CIMANGGU, PANDEGLANG, BANTEN",15,32,33,65
https://kawalpemilu.org#51594,"CIBURIAL, CIMANGGU, PANDEGLANG, BANTEN",16,51,44,95
https://kawalpemilu.org#51594,"CIBURIAL, CIMANGGU, PANDEGLANG, BANTEN",17,65,130,195
https://kawalpemilu.org#51594,"CIBURIAL, CIMANGGU, PANDEGLANG, BANTEN",18,67,101,168
https://kawalpemilu.org#51595,"CIJARALANG, CIMANGGU, PANDEGLANG, BANTEN",1,132,91,223
https://kawalpemilu.org#51595,"CIJARALANG, CIMANGGU, PANDEGLANG, BANTEN",2,133,68,201
https://kawalpemilu.org#51595,"CIJARALANG, CIMANGGU, PANDEGLANG, BANTEN",3,139,73,212
https://kawalpemilu.org#51595,"CIJARALANG, CIMANGGU, PANDEGLANG, BANTEN",4,119,35,154
https://kawalpemilu.org#51595,"CIJARALANG, CIMANGGU, PANDEGLANG, BANTEN",5,146,50,196
https://kawalpemilu.org#51595,"CIJARALANG, CIMANGGU, PANDEGLANG, BANTEN",6,153,37,190
https://kawalpemilu.org#51595,"CIJARALANG, CIMANGGU, PANDEGLANG, BANTEN",7,118,107,225
https://kawalpemilu.org#51595,"CIJARALANG, CIMANGGU, PANDEGLANG, BANTEN",8,116,43,159
https://kawalpemilu.org#51595,"CIJARALANG, CIMANGGU, PANDEGLANG, BANTEN",9,96,44,140
https://kawalpemilu.org#51596,"CIMANGGU, CIMANGGU, PANDEGLANG, BANTEN",1,75,133,208
https://kawalpemilu.org#51596,"CIMANGGU, CIMANGGU, PANDEGLANG, BANTEN",2,112,77,189
https://kawalpemilu.org#51596,"CIMANGGU, CIMANGGU, PANDEGLANG, BANTEN",3,59,126,185
https://kawalpemilu.org#51596,"CIMANGGU, CIMANGGU, PANDEGLANG, BANTEN",4,34,138,172
https://kawalpemilu.org#51596,"CIMANGGU, CIMANGGU, PANDEGLANG, BANTEN",5,28,170,198
https://kawalpemilu.org#51596,"CIMANGGU, CIMANGGU, PANDEGLANG, BANTEN",6,62,160,222
https://kawalpemilu.org#51596,"CIMANGGU, CIMANGGU, PANDEGLANG, BANTEN",7,89,93,182
https://kawalpemilu.org#51596,"CIMANGGU, CIMANGGU, PANDEGLANG, BANTEN",8,100,80,180
https://kawalpemilu.org#51596,"CIMANGGU, CIMANGGU, PANDEGLANG, BANTEN",9,60,46,106
https://kawalpemilu.org#51597,"MANGKUALAM, CIMANGGU, PANDEGLANG, BANTEN",1,110,155,265
https://kawalpemilu.org#51597,"MANGKUALAM, CIMANGGU, PANDEGLANG, BANTEN",2,109,85,194
https://kawalpemilu.org#51597,"MANGKUALAM, CIMANGGU, PANDEGLANG, BANTEN",3,127,120,247
https://kawalpemilu.org#51597,"MANGKUALAM, CIMANGGU, PANDEGLANG, BANTEN",4,96,22,118
https://kawalpemilu.org#51597,"MANGKUALAM, CIMANGGU, PANDEGLANG, BANTEN",5,89,58,147
https://kawalpemilu.org#51597,"MANGKUALAM, CIMANGGU, PANDEGLANG, BANTEN",6,120,45,165
https://kawalpemilu.org#51597,"MANGKUALAM, CIMANGGU, PANDEGLANG, BANTEN",8,99,99,198
https://kawalpemilu.org#51598,"TANGKIL SARI, CIMANGGU, PANDEGLANG, BANTEN",1,40,183,223
https://kawalpemilu.org#51598,"TANGKIL SARI, CIMANGGU, PANDEGLANG, BANTEN",2,75,127,202
https://kawalpemilu.org#51598,"TANGKIL SARI, CIMANGGU, PANDEGLANG, BANTEN",3,82,120,202
https://kawalpemilu.org#51598,"TANGKIL SARI, CIMANGGU, PANDEGLANG, BANTEN",4,74,93,167
https://kawalpemilu.org#51598,"TANGKIL SARI, CIMANGGU, PANDEGLANG, BANTEN",5,45,65,108
https://kawalpemilu.org#51598,"TANGKIL SARI, CIMANGGU, PANDEGLANG, BANTEN",6,110,80,190
https://kawalpemilu.org#51598,"TANGKIL SARI, CIMANGGU, PANDEGLANG, BANTEN",7,84,92,176
https://kawalpemilu.org#51598,"TANGKIL SARI, CIMANGGU, PANDEGLANG, BANTEN",8,44,42,86
https://kawalpemilu.org#51598,"TANGKIL SARI, CIMANGGU, PANDEGLANG, BANTEN",9,85,83,168
https://kawalpemilu.org#51598,"TANGKIL SARI, CIMANGGU, PANDEGLANG, BANTEN",10,104,89,193
https://kawalpemilu.org#51598,"TANGKIL SARI, CIMANGGU, PANDEGLANG, BANTEN",11,42,45,87
https://kawalpemilu.org#51598,"TANGKIL SARI, CIMANGGU, PANDEGLANG, BANTEN",12,74,93,167
https://kawalpemilu.org#51599,"WARINGIN KURUNG, CIMANGGU, PANDEGLANG, BANTEN",1,66,138,204
https://kawalpemilu.org#51599,"WARINGIN KURUNG, CIMANGGU, PANDEGLANG, BANTEN",2,97,90,187
https://kawalpemilu.org#51599,"WARINGIN KURUNG, CIMANGGU, PANDEGLANG, BANTEN",3,75,118,193
https://kawalpemilu.org#51599,"WARINGIN KURUNG, CIMANGGU, PANDEGLANG, BANTEN",4,91,135,226
https://kawalpemilu.org#51599,"WARINGIN KURUNG, CIMANGGU, PANDEGLANG, BANTEN",5,87,74,161
https://kawalpemilu.org#51599,"WARINGIN KURUNG, CIMANGGU, PANDEGLANG, BANTEN",6,79,67,146
https://kawalpemilu.org#51599,"WARINGIN KURUNG, CIMANGGU, PANDEGLANG, BANTEN",7,61,36,97
https://kawalpemilu.org#51599,"WARINGIN KURUNG, CIMANGGU, PANDEGLANG, BANTEN",8,90,71,161
https://kawalpemilu.org#51599,"WARINGIN KURUNG, CIMANGGU, PANDEGLANG, BANTEN",9,98,44,142
https://kawalpemilu.org#51600,"KRAMATJAYA, CIMANGGU, PANDEGLANG, BANTEN",1,111,62,173
https://kawalpemilu.org#51600,"KRAMATJAYA, CIMANGGU, PANDEGLANG, BANTEN",2,67,61,128
https://kawalpemilu.org#51600,"KRAMATJAYA, CIMANGGU, PANDEGLANG, BANTEN",4,116,83,199
https://kawalpemilu.org#51600,"KRAMATJAYA, CIMANGGU, PANDEGLANG, BANTEN",5,83,74,157
https://kawalpemilu.org#51600,"KRAMATJAYA, CIMANGGU, PANDEGLANG, BANTEN",6,70,95,165
https://kawalpemilu.org#51600,"KRAMATJAYA, CIMANGGU, PANDEGLANG, BANTEN",7,107,83,190
https://kawalpemilu.org#51600,"KRAMATJAYA, CIMANGGU, PANDEGLANG, BANTEN",8,92,77,169
https://kawalpemilu.org#51600,"KRAMATJAYA, CIMANGGU, PANDEGLANG, BANTEN",9,76,92,168
https://kawalpemilu.org#51602,"MENDUNG, CIBALIUNG, PANDEGLANG, BANTEN",1,55,116,171
https://kawalpemilu.org#51602,"MENDUNG, CIBALIUNG, PANDEGLANG, BANTEN",2,98,112,210
https://kawalpemilu.org#51602,"MENDUNG, CIBALIUNG, PANDEGLANG, BANTEN",3,105,89,194
https://kawalpemilu.org#51602,"MENDUNG, CIBALIUNG, PANDEGLANG, BANTEN",4,80,76,156
https://kawalpemilu.org#51602,"MENDUNG, CIBALIUNG, PANDEGLANG, BANTEN",5,113,100,213
https://kawalpemilu.org#51602,"MENDUNG, CIBALIUNG, PANDEGLANG, BANTEN",6,112,110,222
https://kawalpemilu.org#51602,"MENDUNG, CIBALIUNG, PANDEGLANG, BANTEN",7,80,108,188
https://kawalpemilu.org#51602,"MENDUNG, CIBALIUNG, PANDEGLANG, BANTEN",9,51,136,187
https://kawalpemilu.org#51602,"MENDUNG, CIBALIUNG, PANDEGLANG, BANTEN",10,130,37,167
https://kawalpemilu.org#51603,"SUDIMANIK, CIBALIUNG, PANDEGLANG, BANTEN",1,35,141,176
https://kawalpemilu.org#51603,"SUDIMANIK, CIBALIUNG, PANDEGLANG, BANTEN",2,44,116,160
https://kawalpemilu.org#51603,"SUDIMANIK, CIBALIUNG, PANDEGLANG, BANTEN",3,82,111,193
https://kawalpemilu.org#51603,"SUDIMANIK, CIBALIUNG, PANDEGLANG, BANTEN",4,103,59,162
https://kawalpemilu.org#51603,"SUDIMANIK, CIBALIUNG, PANDEGLANG, BANTEN",5,87,104,191
https://kawalpemilu.org#51603,"SUDIMANIK, CIBALIUNG, PANDEGLANG, BANTEN",6,55,113,168
https://kawalpemilu.org#51603,"SUDIMANIK, CIBALIUNG, PANDEGLANG, BANTEN",7,81,49,130
https://kawalpemilu.org#51604,"CURUG, CIBALIUNG, PANDEGLANG, BANTEN",1,67,106,173
https://kawalpemilu.org#51604,"CURUG, CIBALIUNG, PANDEGLANG, BANTEN",2,121,61,182
https://kawalpemilu.org#51604,"CURUG, CIBALIUNG, PANDEGLANG, BANTEN",3,49,150,199
https://kawalpemilu.org#51604,"CURUG, CIBALIUNG, PANDEGLANG, BANTEN",4,78,101,179
https://kawalpemilu.org#51604,"CURUG, CIBALIUNG, PANDEGLANG, BANTEN",5,148,46,194
https://kawalpemilu.org#51605,"CIBINGBIN, CIBALIUNG, PANDEGLANG, BANTEN",1,98,99,197
https://kawalpemilu.org#51605,"CIBINGBIN, CIBALIUNG, PANDEGLANG, BANTEN",2,164,12,176
https://kawalpemilu.org#51605,"CIBINGBIN, CIBALIUNG, PANDEGLANG, BANTEN",3,140,92,232
https://kawalpemilu.org#51605,"CIBINGBIN, CIBALIUNG, PANDEGLANG, BANTEN",4,71,113,184
https://kawalpemilu.org#51605,"CIBINGBIN, CIBALIUNG, PANDEGLANG, BANTEN",5,106,59,165
https://kawalpemilu.org#51605,"CIBINGBIN, CIBALIUNG, PANDEGLANG, BANTEN",6,138,20,158
https://kawalpemilu.org#51605,"CIBINGBIN, CIBALIUNG, PANDEGLANG, BANTEN",7,107,75,182
https://kawalpemilu.org#51605,"CIBINGBIN, CIBALIUNG, PANDEGLANG, BANTEN",8,132,103,235
https://kawalpemilu.org#51605,"CIBINGBIN, CIBALIUNG, PANDEGLANG, BANTEN",9,107,51,158
https://kawalpemilu.org#51606,"SUKAJADI, CIBALIUNG, PANDEGLANG, BANTEN",1,133,75,208
https://kawalpemilu.org#51606,"SUKAJADI, CIBALIUNG, PANDEGLANG, BANTEN",2,120,113,233
https://kawalpemilu.org#51606,"SUKAJADI, CIBALIUNG, PANDEGLANG, BANTEN",3,81,92,173
https://kawalpemilu.org#51606,"SUKAJADI, CIBALIUNG, PANDEGLANG, BANTEN",4,57,126,183
https://kawalpemilu.org#51606,"SUKAJADI, CIBALIUNG, PANDEGLANG, BANTEN",5,82,141,223
https://kawalpemilu.org#51606,"SUKAJADI, CIBALIUNG, PANDEGLANG, BANTEN",6,86,125,211
https://kawalpemilu.org#51606,"SUKAJADI, CIBALIUNG, PANDEGLANG, BANTEN",7,35,193,228
https://kawalpemilu.org#51606,"SUKAJADI, CIBALIUNG, PANDEGLANG, BANTEN",8,49,162,211
https://kawalpemilu.org#51606,"SUKAJADI, CIBALIUNG, PANDEGLANG, BANTEN",9,38,131,169
https://kawalpemilu.org#51606,"SUKAJADI, CIBALIUNG, PANDEGLANG, BANTEN",10,71,178,249
https://kawalpemilu.org#51606,"SUKAJADI, CIBALIUNG, PANDEGLANG, BANTEN",11,67,128,195
https://kawalpemilu.org#51606,"SUKAJADI, CIBALIUNG, PANDEGLANG, BANTEN",12,93,91,184
https://kawalpemilu.org#51606,"SUKAJADI, CIBALIUNG, PANDEGLANG, BANTEN",13,65,100,165
https://kawalpemilu.org#51606,"SUKAJADI, CIBALIUNG, PANDEGLANG, BANTEN",14,51,176,227
https://kawalpemilu.org#51606,"SUKAJADI, CIBALIUNG, PANDEGLANG, BANTEN",15,63,131,194
https://kawalpemilu.org#51606,"SUKAJADI, CIBALIUNG, PANDEGLANG, BANTEN",16,71,170,241
https://kawalpemilu.org#51606,"SUKAJADI, CIBALIUNG, PANDEGLANG, BANTEN",17,91,136,227
https://kawalpemilu.org#51606,"SUKAJADI, CIBALIUNG, PANDEGLANG, BANTEN",18,74,136,210
https://kawalpemilu.org#51607,"MAHENDRA, CIBALIUNG, PANDEGLANG, BANTEN",1,129,98,227
https://kawalpemilu.org#51607,"MAHENDRA, CIBALIUNG, PANDEGLANG, BANTEN",2,105,120,225
https://kawalpemilu.org#51607,"MAHENDRA, CIBALIUNG, PANDEGLANG, BANTEN",3,124,69,193
https://kawalpemilu.org#51607,"MAHENDRA, CIBALIUNG, PANDEGLANG, BANTEN",5,112,115,227
https://kawalpemilu.org#51607,"MAHENDRA, CIBALIUNG, PANDEGLANG, BANTEN",6,141,89,230
https://kawalpemilu.org#51607,"MAHENDRA, CIBALIUNG, PANDEGLANG, BANTEN",7,100,126,226
https://kawalpemilu.org#51607,"MAHENDRA, CIBALIUNG, PANDEGLANG, BANTEN",8,104,24,128
https://kawalpemilu.org#51608,"CIBALIUNG, CIBALIUNG, PANDEGLANG, BANTEN",1,35,131,166
https://kawalpemilu.org#51608,"CIBALIUNG, CIBALIUNG, PANDEGLANG, BANTEN",2,29,96,125
https://kawalpemilu.org#51608,"CIBALIUNG, CIBALIUNG, PANDEGLANG, BANTEN",3,123,58,181
https://kawalpemilu.org#51608,"CIBALIUNG, CIBALIUNG, PANDEGLANG, BANTEN",4,48,99,147
https://kawalpemilu.org#51608,"CIBALIUNG, CIBALIUNG, PANDEGLANG, BANTEN",5,78,50,128
https://kawalpemilu.org#51608,"CIBALIUNG, CIBALIUNG, PANDEGLANG, BANTEN",6,105,80,185
https://kawalpemilu.org#51608,"CIBALIUNG, CIBALIUNG, PANDEGLANG, BANTEN",7,117,58,175
https://kawalpemilu.org#51608,"CIBALIUNG, CIBALIUNG, PANDEGLANG, BANTEN",8,140,25,165
https://kawalpemilu.org#51608,"CIBALIUNG, CIBALIUNG, PANDEGLANG, BANTEN",9,87,84,171
https://kawalpemilu.org#51608,"CIBALIUNG, CIBALIUNG, PANDEGLANG, BANTEN",10,82,75,157
https://kawalpemilu.org#51608,"CIBALIUNG, CIBALIUNG, PANDEGLANG, BANTEN",11,123,58,181
https://kawalpemilu.org#51608,"CIBALIUNG, CIBALIUNG, PANDEGLANG, BANTEN",12,101,26,127
https://kawalpemilu.org#51608,"CIBALIUNG, CIBALIUNG, PANDEGLANG, BANTEN",13,180,29,209
https://kawalpemilu.org#51609,"CIHANJUANG, CIBALIUNG, PANDEGLANG, BANTEN",1,117,52,169
https://kawalpemilu.org#51609,"CIHANJUANG, CIBALIUNG, PANDEGLANG, BANTEN",3,142,67,209
https://kawalpemilu.org#51609,"CIHANJUANG, CIBALIUNG, PANDEGLANG, BANTEN",4,125,78,203
https://kawalpemilu.org#51609,"CIHANJUANG, CIBALIUNG, PANDEGLANG, BANTEN",5,69,141,210
https://kawalpemilu.org#51609,"CIHANJUANG, CIBALIUNG, PANDEGLANG, BANTEN",6,61,142,203
https://kawalpemilu.org#51609,"CIHANJUANG, CIBALIUNG, PANDEGLANG, BANTEN",7,50,188,238
https://kawalpemilu.org#51609,"CIHANJUANG, CIBALIUNG, PANDEGLANG, BANTEN",8,99,88,187
https://kawalpemilu.org#51609,"CIHANJUANG, CIBALIUNG, PANDEGLANG, BANTEN",9,155,72,227
https://kawalpemilu.org#51609,"CIHANJUANG, CIBALIUNG, PANDEGLANG, BANTEN",10,157,23,180
https://kawalpemilu.org#51610,"SORONGAN, CIBALIUNG, PANDEGLANG, BANTEN",1,95,90,185
https://kawalpemilu.org#51610,"SORONGAN, CIBALIUNG, PANDEGLANG, BANTEN",2,64,104,168
https://kawalpemilu.org#51610,"SORONGAN, CIBALIUNG, PANDEGLANG, BANTEN",3,86,113,199
https://kawalpemilu.org#51610,"SORONGAN, CIBALIUNG, PANDEGLANG, BANTEN",4,88,104,192
https://kawalpemilu.org#51610,"SORONGAN, CIBALIUNG, PANDEGLANG, BANTEN",5,137,19,156
https://kawalpemilu.org#51610,"SORONGAN, CIBALIUNG, PANDEGLANG, BANTEN",6,59,76,135
https://kawalpemilu.org#51610,"SORONGAN, CIBALIUNG, PANDEGLANG, BANTEN",7,127,32,159
https://kawalpemilu.org#51612,"TANJUNGAN, CIKEUSIK, PANDEGLANG, BANTEN",1,99,109,208
https://kawalpemilu.org#51612,"TANJUNGAN, CIKEUSIK, PANDEGLANG, BANTEN",2,82,66,148
https://kawalpemilu.org#51612,"TANJUNGAN, CIKEUSIK, PANDEGLANG, BANTEN",3,77,59,136
https://kawalpemilu.org#51612,"TANJUNGAN, CIKEUSIK, PANDEGLANG, BANTEN",4,80,78,158
https://kawalpemilu.org#51612,"TANJUNGAN, CIKEUSIK, PANDEGLANG, BANTEN",5,116,22,138
https://kawalpemilu.org#51612,"TANJUNGAN, CIKEUSIK, PANDEGLANG, BANTEN",6,108,47,155
https://kawalpemilu.org#51612,"TANJUNGAN, CIKEUSIK, PANDEGLANG, BANTEN",7,105,26,131
https://kawalpemilu.org#51612,"TANJUNGAN, CIKEUSIK, PANDEGLANG, BANTEN",8,95,98,193
https://kawalpemilu.org#51612,"TANJUNGAN, CIKEUSIK, PANDEGLANG, BANTEN",9,104,54,158
https://kawalpemilu.org#51612,"TANJUNGAN, CIKEUSIK, PANDEGLANG, BANTEN",10,168,37,205
https://kawalpemilu.org#51612,"TANJUNGAN, CIKEUSIK, PANDEGLANG, BANTEN",11,164,31,195
https://kawalpemilu.org#51612,"TANJUNGAN, CIKEUSIK, PANDEGLANG, BANTEN",12,98,15,113
https://kawalpemilu.org#51612,"TANJUNGAN, CIKEUSIK, PANDEGLANG, BANTEN",13,124,44,168
https://kawalpemilu.org#51612,"TANJUNGAN, CIKEUSIK, PANDEGLANG, BANTEN",14,118,38,156
https://kawalpemilu.org#51612,"TANJUNGAN, CIKEUSIK, PANDEGLANG, BANTEN",15,117,21,138
https://kawalpemilu.org#51612,"TANJUNGAN, CIKEUSIK, PANDEGLANG, BANTEN",16,125,18,143
https://kawalpemilu.org#51612,"TANJUNGAN, CIKEUSIK, PANDEGLANG, BANTEN",17,121,40,161
https://kawalpemilu.org#51612,"TANJUNGAN, CIKEUSIK, PANDEGLANG, BANTEN",18,58,98,156
https://kawalpemilu.org#51612,"TANJUNGAN, CIKEUSIK, PANDEGLANG, BANTEN",19,44,83,127
https://kawalpemilu.org#51612,"TANJUNGAN, CIKEUSIK, PANDEGLANG, BANTEN",20,87,56,143
https://kawalpemilu.org#51612,"TANJUNGAN, CIKEUSIK, PANDEGLANG, BANTEN",21,35,98,133
https://kawalpemilu.org#51612,"TANJUNGAN, CIKEUSIK, PANDEGLANG, BANTEN",22,143,77,220
https://kawalpemilu.org#51612,"TANJUNGAN, CIKEUSIK, PANDEGLANG, BANTEN",23,105,70,175
https://kawalpemilu.org#51612,"TANJUNGAN, CIKEUSIK, PANDEGLANG, BANTEN",24,132,82,214
https://kawalpemilu.org#51613,"SUMURBATU, CIKEUSIK, PANDEGLANG, BANTEN",1,72,138,210
https://kawalpemilu.org#51613,"SUMURBATU, CIKEUSIK, PANDEGLANG, BANTEN",2,48,107,155
https://kawalpemilu.org#51613,"SUMURBATU, CIKEUSIK, PANDEGLANG, BANTEN",3,54,112,166
https://kawalpemilu.org#51613,"SUMURBATU, CIKEUSIK, PANDEGLANG, BANTEN",4,12,88,100
https://kawalpemilu.org#51613,"SUMURBATU, CIKEUSIK, PANDEGLANG, BANTEN",5,33,87,120
https://kawalpemilu.org#51613,"SUMURBATU, CIKEUSIK, PANDEGLANG, BANTEN",7,55,28,83
https://kawalpemilu.org#51613,"SUMURBATU, CIKEUSIK, PANDEGLANG, BANTEN",8,73,77,150
https://kawalpemilu.org#51613,"SUMURBATU, CIKEUSIK, PANDEGLANG, BANTEN",9,70,68,138
https://kawalpemilu.org#51613,"SUMURBATU, CIKEUSIK, PANDEGLANG, BANTEN",10,49,80,129
https://kawalpemilu.org#51613,"SUMURBATU, CIKEUSIK, PANDEGLANG, BANTEN",11,114,56,170
https://kawalpemilu.org#51613,"SUMURBATU, CIKEUSIK, PANDEGLANG, BANTEN",12,133,30,163
https://kawalpemilu.org#51613,"SUMURBATU, CIKEUSIK, PANDEGLANG, BANTEN",13,0,0,0
https://kawalpemilu.org#51613,"SUMURBATU, CIKEUSIK, PANDEGLANG, BANTEN",14,82,125,207
https://kawalpemilu.org#51613,"SUMURBATU, CIKEUSIK, PANDEGLANG, BANTEN",15,140,88,228
https://kawalpemilu.org#51613,"SUMURBATU, CIKEUSIK, PANDEGLANG, BANTEN",16,118,40,158
https://kawalpemilu.org#51613,"SUMURBATU, CIKEUSIK, PANDEGLANG, BANTEN",17,132,53,185
https://kawalpemilu.org#51614,"SUKAWARIS, CIKEUSIK, PANDEGLANG, BANTEN",1,59,78,137
https://kawalpemilu.org#51614,"SUKAWARIS, CIKEUSIK, PANDEGLANG, BANTEN",2,70,49,119
https://kawalpemilu.org#51614,"SUKAWARIS, CIKEUSIK, PANDEGLANG, BANTEN",3,115,72,187
https://kawalpemilu.org#51614,"SUKAWARIS, CIKEUSIK, PANDEGLANG, BANTEN",4,55,112,167
https://kawalpemilu.org#51614,"SUKAWARIS, CIKEUSIK, PANDEGLANG, BANTEN",5,59,77,136
https://kawalpemilu.org#51614,"SUKAWARIS, CIKEUSIK, PANDEGLANG, BANTEN",6,92,73,165
https://kawalpemilu.org#51614,"SUKAWARIS, CIKEUSIK, PANDEGLANG, BANTEN",8,141,62,203
https://kawalpemilu.org#51614,"SUKAWARIS, CIKEUSIK, PANDEGLANG, BANTEN",9,113,62,175
https://kawalpemilu.org#51614,"SUKAWARIS, CIKEUSIK, PANDEGLANG, BANTEN",10,111,93,204
https://kawalpemilu.org#51614,"SUKAWARIS, CIKEUSIK, PANDEGLANG, BANTEN",11,94,108,202
https://kawalpemilu.org#51615,"RANCASENENG, CIKEUSIK, PANDEGLANG, BANTEN",1,133,84,217
https://kawalpemilu.org#51615,"RANCASENENG, CIKEUSIK, PANDEGLANG, BANTEN",2,157,43,200
https://kawalpemilu.org#51615,"RANCASENENG, CIKEUSIK, PANDEGLANG, BANTEN",3,92,24,116
https://kawalpemilu.org#51615,"RANCASENENG, CIKEUSIK, PANDEGLANG, BANTEN",4,117,24,141
https://kawalpemilu.org#51615,"RANCASENENG, CIKEUSIK, PANDEGLANG, BANTEN",5,81,18,99
https://kawalpemilu.org#51615,"RANCASENENG, CIKEUSIK, PANDEGLANG, BANTEN",6,83,14,97
https://kawalpemilu.org#51615,"RANCASENENG, CIKEUSIK, PANDEGLANG, BANTEN",7,93,38,131
https://kawalpemilu.org#51615,"RANCASENENG, CIKEUSIK, PANDEGLANG, BANTEN",9,68,109,177
https://kawalpemilu.org#51615,"RANCASENENG, CIKEUSIK, PANDEGLANG, BANTEN",10,20,62,82
https://kawalpemilu.org#51615,"RANCASENENG, CIKEUSIK, PANDEGLANG, BANTEN",11,139,18,157
https://kawalpemilu.org#51616,"PARUNGKOKOSAN, CIKEUSIK, PANDEGLANG, BANTEN",1,33,131,164
https://kawalpemilu.org#51616,"PARUNGKOKOSAN, CIKEUSIK, PANDEGLANG, BANTEN",2,38,132,170
https://kawalpemilu.org#51616,"PARUNGKOKOSAN, CIKEUSIK, PANDEGLANG, BANTEN",3,36,150,186
https://kawalpemilu.org#51616,"PARUNGKOKOSAN, CIKEUSIK, PANDEGLANG, BANTEN",4,45,134,179
https://kawalpemilu.org#51616,"PARUNGKOKOSAN, CIKEUSIK, PANDEGLANG, BANTEN",5,122,75,197
https://kawalpemilu.org#51616,"PARUNGKOKOSAN, CIKEUSIK, PANDEGLANG, BANTEN",6,74,112,186
https://kawalpemilu.org#51616,"PARUNGKOKOSAN, CIKEUSIK, PANDEGLANG, BANTEN",7,82,66,148
https://kawalpemilu.org#51616,"PARUNGKOKOSAN, CIKEUSIK, PANDEGLANG, BANTEN",8,94,12,106
https://kawalpemilu.org#51617,"NANGGALA, CIKEUSIK, PANDEGLANG, BANTEN",1,32,154,186
https://kawalpemilu.org#51617,"NANGGALA, CIKEUSIK, PANDEGLANG, BANTEN",2,84,133,217
https://kawalpemilu.org#51617,"NANGGALA, CIKEUSIK, PANDEGLANG, BANTEN",3,101,87,188
https://kawalpemilu.org#51617,"NANGGALA, CIKEUSIK, PANDEGLANG, BANTEN",4,130,83,213
https://kawalpemilu.org#51617,"NANGGALA, CIKEUSIK, PANDEGLANG, BANTEN",6,117,41,158
https://kawalpemilu.org#51617,"NANGGALA, CIKEUSIK, PANDEGLANG, BANTEN",7,83,71,154
https://kawalpemilu.org#51617,"NANGGALA, CIKEUSIK, PANDEGLANG, BANTEN",8,72,84,156
https://kawalpemilu.org#51617,"NANGGALA, CIKEUSIK, PANDEGLANG, BANTEN",9,131,97,228
https://kawalpemilu.org#51617,"NANGGALA, CIKEUSIK, PANDEGLANG, BANTEN",10,87,114,201
https://kawalpemilu.org#51617,"NANGGALA, CIKEUSIK, PANDEGLANG, BANTEN",11,103,88,191
https://kawalpemilu.org#51617,"NANGGALA, CIKEUSIK, PANDEGLANG, BANTEN",12,112,88,200
https://kawalpemilu.org#51617,"NANGGALA, CIKEUSIK, PANDEGLANG, BANTEN",13,88,95,183
https://kawalpemilu.org#51617,"NANGGALA, CIKEUSIK, PANDEGLANG, BANTEN",14,124,65,189
https://kawalpemilu.org#51617,"NANGGALA, CIKEUSIK, PANDEGLANG, BANTEN",15,99,54,153
https://kawalpemilu.org#51617,"NANGGALA, CIKEUSIK, PANDEGLANG, BANTEN",16,98,16,114
https://kawalpemilu.org#51618,"CIKEUSIK, CIKEUSIK, PANDEGLANG, BANTEN",1,94,70,164
https://kawalpemilu.org#51618,"CIKEUSIK, CIKEUSIK, PANDEGLANG, BANTEN",2,84,100,184
https://kawalpemilu.org#51618,"CIKEUSIK, CIKEUSIK, PANDEGLANG, BANTEN",3,93,81,174
https://kawalpemilu.org#51618,"CIKEUSIK, CIKEUSIK, PANDEGLANG, BANTEN",4,28,101,129
https://kawalpemilu.org#51618,"CIKEUSIK, CIKEUSIK, PANDEGLANG, BANTEN",5,54,92,146
https://kawalpemilu.org#51618,"CIKEUSIK, CIKEUSIK, PANDEGLANG, BANTEN",6,23,154,177
https://kawalpemilu.org#51618,"CIKEUSIK, CIKEUSIK, PANDEGLANG, BANTEN",7,74,46,120
https://kawalpemilu.org#51618,"CIKEUSIK, CIKEUSIK, PANDEGLANG, BANTEN",8,52,69,121
https://kawalpemilu.org#51618,"CIKEUSIK, CIKEUSIK, PANDEGLANG, BANTEN",9,81,99,180
https://kawalpemilu.org#51618,"CIKEUSIK, CIKEUSIK, PANDEGLANG, BANTEN",10,87,31,118
https://kawalpemilu.org#51618,"CIKEUSIK, CIKEUSIK, PANDEGLANG, BANTEN",11,83,71,154
https://kawalpemilu.org#51618,"CIKEUSIK, CIKEUSIK, PANDEGLANG, BANTEN",12,108,69,177
https://kawalpemilu.org#51618,"CIKEUSIK, CIKEUSIK, PANDEGLANG, BANTEN",13,77,30,107
https://kawalpemilu.org#51618,"CIKEUSIK, CIKEUSIK, PANDEGLANG, BANTEN",14,118,56,174
https://kawalpemilu.org#51618,"CIKEUSIK, CIKEUSIK, PANDEGLANG, BANTEN",15,126,48,174
https://kawalpemilu.org#51618,"CIKEUSIK, CIKEUSIK, PANDEGLANG, BANTEN",16,90,68,158
https://kawalpemilu.org#51618,"CIKEUSIK, CIKEUSIK, PANDEGLANG, BANTEN",17,97,38,135
https://kawalpemilu.org#51618,"CIKEUSIK, CIKEUSIK, PANDEGLANG, BANTEN",18,65,37,102
https://kawalpemilu.org#51618,"CIKEUSIK, CIKEUSIK, PANDEGLANG, BANTEN",19,71,56,127
https://kawalpemilu.org#51618,"CIKEUSIK, CIKEUSIK, PANDEGLANG, BANTEN",20,93,39,132
https://kawalpemilu.org#51619,"CIKADONGDONG, CIKEUSIK, PANDEGLANG, BANTEN",1,51,108,159
https://kawalpemilu.org#51619,"CIKADONGDONG, CIKEUSIK, PANDEGLANG, BANTEN",2,23,103,126
https://kawalpemilu.org#51619,"CIKADONGDONG, CIKEUSIK, PANDEGLANG, BANTEN",3,79,76,155
https://kawalpemilu.org#51619,"CIKADONGDONG, CIKEUSIK, PANDEGLANG, BANTEN",5,80,48,128
https://kawalpemilu.org#51619,"CIKADONGDONG, CIKEUSIK, PANDEGLANG, BANTEN",6,85,43,128
https://kawalpemilu.org#51619,"CIKADONGDONG, CIKEUSIK, PANDEGLANG, BANTEN",7,93,39,132
https://kawalpemilu.org#51619,"CIKADONGDONG, CIKEUSIK, PANDEGLANG, BANTEN",8,79,46,125
https://kawalpemilu.org#51619,"CIKADONGDONG, CIKEUSIK, PANDEGLANG, BANTEN",9,75,66,141
https://kawalpemilu.org#51619,"CIKADONGDONG, CIKEUSIK, PANDEGLANG, BANTEN",10,54,67,121
https://kawalpemilu.org#51619,"CIKADONGDONG, CIKEUSIK, PANDEGLANG, BANTEN",11,97,49,146
https://kawalpemilu.org#51620,"CURUGCIUNG, CIKEUSIK, PANDEGLANG, BANTEN",1,76,92,168
https://kawalpemilu.org#51620,"CURUGCIUNG, CIKEUSIK, PANDEGLANG, BANTEN",2,46,149,195
https://kawalpemilu.org#51620,"CURUGCIUNG, CIKEUSIK, PANDEGLANG, BANTEN",3,49,115,164
https://kawalpemilu.org#51620,"CURUGCIUNG, CIKEUSIK, PANDEGLANG, BANTEN",4,29,72,101
https://kawalpemilu.org#51620,"CURUGCIUNG, CIKEUSIK, PANDEGLANG, BANTEN",5,102,89,191
https://kawalpemilu.org#51620,"CURUGCIUNG, CIKEUSIK, PANDEGLANG, BANTEN",6,102,86,188
https://kawalpemilu.org#51620,"CURUGCIUNG, CIKEUSIK, PANDEGLANG, BANTEN",7,54,110,164
https://kawalpemilu.org#51620,"CURUGCIUNG, CIKEUSIK, PANDEGLANG, BANTEN",8,90,89,179
https://kawalpemilu.org#51620,"CURUGCIUNG, CIKEUSIK, PANDEGLANG, BANTEN",9,54,65,119
https://kawalpemilu.org#51621,"LEUWIBALANG, CIKEUSIK, PANDEGLANG, BANTEN",1,62,90,152
https://kawalpemilu.org#51621,"LEUWIBALANG, CIKEUSIK, PANDEGLANG, BANTEN",2,131,68,199
https://kawalpemilu.org#51621,"LEUWIBALANG, CIKEUSIK, PANDEGLANG, BANTEN",3,99,14,113
https://kawalpemilu.org#51621,"LEUWIBALANG, CIKEUSIK, PANDEGLANG, BANTEN",4,106,105,211
https://kawalpemilu.org#51621,"LEUWIBALANG, CIKEUSIK, PANDEGLANG, BANTEN",5,149,32,181
https://kawalpemilu.org#51622,"SUKASENENG, CIKEUSIK, PANDEGLANG, BANTEN",1,131,18,149
https://kawalpemilu.org#51622,"SUKASENENG, CIKEUSIK, PANDEGLANG, BANTEN",2,126,7,133
https://kawalpemilu.org#51622,"SUKASENENG, CIKEUSIK, PANDEGLANG, BANTEN",3,77,67,144
https://kawalpemilu.org#51622,"SUKASENENG, CIKEUSIK, PANDEGLANG, BANTEN",4,74,90,164
https://kawalpemilu.org#51622,"SUKASENENG, CIKEUSIK, PANDEGLANG, BANTEN",5,102,48,150
https://kawalpemilu.org#51622,"SUKASENENG, CIKEUSIK, PANDEGLANG, BANTEN",6,38,168,206
https://kawalpemilu.org#51622,"SUKASENENG, CIKEUSIK, PANDEGLANG, BANTEN",7,74,129,203
https://kawalpemilu.org#51622,"SUKASENENG, CIKEUSIK, PANDEGLANG, BANTEN",8,54,125,179
https://kawalpemilu.org#51622,"SUKASENENG, CIKEUSIK, PANDEGLANG, BANTEN",9,123,38,161
https://kawalpemilu.org#51622,"SUKASENENG, CIKEUSIK, PANDEGLANG, BANTEN",10,93,54,147
https://kawalpemilu.org#51622,"SUKASENENG, CIKEUSIK, PANDEGLANG, BANTEN",11,95,59,154
https://kawalpemilu.org#51622,"SUKASENENG, CIKEUSIK, PANDEGLANG, BANTEN",12,100,43,143
https://kawalpemilu.org#51623,"SUKAMULYA, CIKEUSIK, PANDEGLANG, BANTEN",1,90,54,144
https://kawalpemilu.org#51623,"SUKAMULYA, CIKEUSIK, PANDEGLANG, BANTEN",2,99,56,155
https://kawalpemilu.org#51623,"SUKAMULYA, CIKEUSIK, PANDEGLANG, BANTEN",3,34,131,165
https://kawalpemilu.org#51623,"SUKAMULYA, CIKEUSIK, PANDEGLANG, BANTEN",4,57,148,205
https://kawalpemilu.org#51623,"SUKAMULYA, CIKEUSIK, PANDEGLANG, BANTEN",5,61,120,181
https://kawalpemilu.org#51623,"SUKAMULYA, CIKEUSIK, PANDEGLANG, BANTEN",6,137,48,185
https://kawalpemilu.org#51623,"SUKAMULYA, CIKEUSIK, PANDEGLANG, BANTEN",7,98,17,115
https://kawalpemilu.org#51623,"SUKAMULYA, CIKEUSIK, PANDEGLANG, BANTEN",8,124,15,139
https://kawalpemilu.org#51623,"SUKAMULYA, CIKEUSIK, PANDEGLANG, BANTEN",9,150,29,179
https://kawalpemilu.org#51623,"SUKAMULYA, CIKEUSIK, PANDEGLANG, BANTEN",10,90,34,124
https://kawalpemilu.org#51623,"SUKAMULYA, CIKEUSIK, PANDEGLANG, BANTEN",11,37,47,84
https://kawalpemilu.org#51623,"SUKAMULYA, CIKEUSIK, PANDEGLANG, BANTEN",12,64,31,95
https://kawalpemilu.org#51624,"UMBULAN, CIKEUSIK, PANDEGLANG, BANTEN",1,75,130,205
https://kawalpemilu.org#51624,"UMBULAN, CIKEUSIK, PANDEGLANG, BANTEN",2,41,105,146
https://kawalpemilu.org#51624,"UMBULAN, CIKEUSIK, PANDEGLANG, BANTEN",3,54,145,199
https://kawalpemilu.org#51624,"UMBULAN, CIKEUSIK, PANDEGLANG, BANTEN",4,65,60,125
https://kawalpemilu.org#51624,"UMBULAN, CIKEUSIK, PANDEGLANG, BANTEN",5,36,69,105
https://kawalpemilu.org#51624,"UMBULAN, CIKEUSIK, PANDEGLANG, BANTEN",6,59,65,124
https://kawalpemilu.org#51624,"UMBULAN, CIKEUSIK, PANDEGLANG, BANTEN",7,80,39,119
https://kawalpemilu.org#51624,"UMBULAN, CIKEUSIK, PANDEGLANG, BANTEN",9,89,39,128
https://kawalpemilu.org#51624,"UMBULAN, CIKEUSIK, PANDEGLANG, BANTEN",10,115,26,141
https://kawalpemilu.org#51624,"UMBULAN, CIKEUSIK, PANDEGLANG, BANTEN",11,76,60,136
https://kawalpemilu.org#51624,"UMBULAN, CIKEUSIK, PANDEGLANG, BANTEN",12,71,24,95
https://kawalpemilu.org#51624,"UMBULAN, CIKEUSIK, PANDEGLANG, BANTEN",13,60,40,100
https://kawalpemilu.org#51624,"UMBULAN, CIKEUSIK, PANDEGLANG, BANTEN",14,70,31,101
https://kawalpemilu.org#51624,"UMBULAN, CIKEUSIK, PANDEGLANG, BANTEN",15,67,77,144
https://kawalpemilu.org#51625,"CIKIRUHWETAN, CIKEUSIK, PANDEGLANG, BANTEN",2,100,48,148
https://kawalpemilu.org#51625,"CIKIRUHWETAN, CIKEUSIK, PANDEGLANG, BANTEN",3,98,63,161
https://kawalpemilu.org#51625,"CIKIRUHWETAN, CIKEUSIK, PANDEGLANG, BANTEN",4,74,65,139
https://kawalpemilu.org#51625,"CIKIRUHWETAN, CIKEUSIK, PANDEGLANG, BANTEN",5,122,78,200
https://kawalpemilu.org#51625,"CIKIRUHWETAN, CIKEUSIK, PANDEGLANG, BANTEN",6,73,158,231
https://kawalpemilu.org#51625,"CIKIRUHWETAN, CIKEUSIK, PANDEGLANG, BANTEN",7,70,143,213
https://kawalpemilu.org#51625,"CIKIRUHWETAN, CIKEUSIK, PANDEGLANG, BANTEN",8,65,157,222
https://kawalpemilu.org#51625,"CIKIRUHWETAN, CIKEUSIK, PANDEGLANG, BANTEN",9,140,62,202
https://kawalpemilu.org#51625,"CIKIRUHWETAN, CIKEUSIK, PANDEGLANG, BANTEN",10,110,77,187
https://kawalpemilu.org#51625,"CIKIRUHWETAN, CIKEUSIK, PANDEGLANG, BANTEN",11,101,97,198
https://kawalpemilu.org#51625,"CIKIRUHWETAN, CIKEUSIK, PANDEGLANG, BANTEN",12,50,80,130
https://kawalpemilu.org#51625,"CIKIRUHWETAN, CIKEUSIK, PANDEGLANG, BANTEN",13,70,134,204
https://kawalpemilu.org#51625,"CIKIRUHWETAN, CIKEUSIK, PANDEGLANG, BANTEN",15,78,84,162
https://kawalpemilu.org#51625,"CIKIRUHWETAN, CIKEUSIK, PANDEGLANG, BANTEN",17,85,80,165
https://kawalpemilu.org#51627,"KARANGBOLONG, CIGEULIS, PANDEGLANG, BANTEN",1,36,75,111
https://kawalpemilu.org#51627,"KARANGBOLONG, CIGEULIS, PANDEGLANG, BANTEN",2,36,78,114
https://kawalpemilu.org#51627,"KARANGBOLONG, CIGEULIS, PANDEGLANG, BANTEN",3,64,41,105
https://kawalpemilu.org#51627,"KARANGBOLONG, CIGEULIS, PANDEGLANG, BANTEN",4,52,117,169
https://kawalpemilu.org#51627,"KARANGBOLONG, CIGEULIS, PANDEGLANG, BANTEN",5,39,48,87
https://kawalpemilu.org#51627,"KARANGBOLONG, CIGEULIS, PANDEGLANG, BANTEN",6,120,76,196
https://kawalpemilu.org#51627,"KARANGBOLONG, CIGEULIS, PANDEGLANG, BANTEN",7,96,66,162
https://kawalpemilu.org#51627,"KARANGBOLONG, CIGEULIS, PANDEGLANG, BANTEN",8,121,28,149
https://kawalpemilu.org#51627,"KARANGBOLONG, CIGEULIS, PANDEGLANG, BANTEN",9,80,23,103
https://kawalpemilu.org#51627,"KARANGBOLONG, CIGEULIS, PANDEGLANG, BANTEN",10,99,24,123
https://kawalpemilu.org#51627,"KARANGBOLONG, CIGEULIS, PANDEGLANG, BANTEN",11,92,17,109
https://kawalpemilu.org#51627,"KARANGBOLONG, CIGEULIS, PANDEGLANG, BANTEN",12,75,22,97
https://kawalpemilu.org#51627,"KARANGBOLONG, CIGEULIS, PANDEGLANG, BANTEN",13,143,22,165
https://kawalpemilu.org#51627,"KARANGBOLONG, CIGEULIS, PANDEGLANG, BANTEN",14,101,23,124
https://kawalpemilu.org#51627,"KARANGBOLONG, CIGEULIS, PANDEGLANG, BANTEN",15,79,68,147
https://kawalpemilu.org#51627,"KARANGBOLONG, CIGEULIS, PANDEGLANG, BANTEN",16,57,85,142
https://kawalpemilu.org#51627,"KARANGBOLONG, CIGEULIS, PANDEGLANG, BANTEN",17,58,54,112
https://kawalpemilu.org#51628,"KATUMBIRI, CIGEULIS, PANDEGLANG, BANTEN",1,103,112,215
https://kawalpemilu.org#51628,"KATUMBIRI, CIGEULIS, PANDEGLANG, BANTEN",2,100,98,198
https://kawalpemilu.org#51628,"KATUMBIRI, CIGEULIS, PANDEGLANG, BANTEN",3,55,66,121
https://kawalpemilu.org#51628,"KATUMBIRI, CIGEULIS, PANDEGLANG, BANTEN",4,56,115,171
https://kawalpemilu.org#51628,"KATUMBIRI, CIGEULIS, PANDEGLANG, BANTEN",5,77,127,204
https://kawalpemilu.org#51628,"KATUMBIRI, CIGEULIS, PANDEGLANG, BANTEN",6,84,123,207
https://kawalpemilu.org#51628,"KATUMBIRI, CIGEULIS, PANDEGLANG, BANTEN",7,82,78,160
https://kawalpemilu.org#51628,"KATUMBIRI, CIGEULIS, PANDEGLANG, BANTEN",8,103,51,154
https://kawalpemilu.org#51628,"KATUMBIRI, CIGEULIS, PANDEGLANG, BANTEN",9,121,34,155
https://kawalpemilu.org#51629,"WARINGINJAYA, CIGEULIS, PANDEGLANG, BANTEN",1,44,150,194
https://kawalpemilu.org#51629,"WARINGINJAYA, CIGEULIS, PANDEGLANG, BANTEN",2,48,86,134
https://kawalpemilu.org#51629,"WARINGINJAYA, CIGEULIS, PANDEGLANG, BANTEN",3,81,94,175
https://kawalpemilu.org#51629,"WARINGINJAYA, CIGEULIS, PANDEGLANG, BANTEN",4,52,129,181
https://kawalpemilu.org#51629,"WARINGINJAYA, CIGEULIS, PANDEGLANG, BANTEN",5,89,109,198
https://kawalpemilu.org#51629,"WARINGINJAYA, CIGEULIS, PANDEGLANG, BANTEN",6,67,76,143
https://kawalpemilu.org#51629,"WARINGINJAYA, CIGEULIS, PANDEGLANG, BANTEN",7,120,53,173
https://kawalpemilu.org#51629,"WARINGINJAYA, CIGEULIS, PANDEGLANG, BANTEN",8,81,41,122
https://kawalpemilu.org#51629,"WARINGINJAYA, CIGEULIS, PANDEGLANG, BANTEN",9,134,49,183
https://kawalpemilu.org#51629,"WARINGINJAYA, CIGEULIS, PANDEGLANG, BANTEN",10,203,32,235
https://kawalpemilu.org#51629,"WARINGINJAYA, CIGEULIS, PANDEGLANG, BANTEN",11,114,22,136
https://kawalpemilu.org#51629,"WARINGINJAYA, CIGEULIS, PANDEGLANG, BANTEN",12,139,42,181
https://kawalpemilu.org#51629,"WARINGINJAYA, CIGEULIS, PANDEGLANG, BANTEN",13,143,35,178
https://kawalpemilu.org#51629,"WARINGINJAYA, CIGEULIS, PANDEGLANG, BANTEN",14,121,44,165
https://kawalpemilu.org#51629,"WARINGINJAYA, CIGEULIS, PANDEGLANG, BANTEN",15,107,23,130
https://kawalpemilu.org#51629,"WARINGINJAYA, CIGEULIS, PANDEGLANG, BANTEN",16,69,55,124
https://kawalpemilu.org#51629,"WARINGINJAYA, CIGEULIS, PANDEGLANG, BANTEN",17,115,26,141
https://kawalpemilu.org#51630,"KARYABUANA, CIGEULIS, PANDEGLANG, BANTEN",1,77,132,209
https://kawalpemilu.org#51630,"KARYABUANA, CIGEULIS, PANDEGLANG, BANTEN",2,55,126,181
https://kawalpemilu.org#51630,"KARYABUANA, CIGEULIS, PANDEGLANG, BANTEN",3,66,145,211
https://kawalpemilu.org#51630,"KARYABUANA, CIGEULIS, PANDEGLANG, BANTEN",4,90,113,203
https://kawalpemilu.org#51630,"KARYABUANA, CIGEULIS, PANDEGLANG, BANTEN",5,65,83,148
https://kawalpemilu.org#51630,"KARYABUANA, CIGEULIS, PANDEGLANG, BANTEN",6,88,106,194
https://kawalpemilu.org#51630,"KARYABUANA, CIGEULIS, PANDEGLANG, BANTEN",7,84,75,159
https://kawalpemilu.org#51630,"KARYABUANA, CIGEULIS, PANDEGLANG, BANTEN",8,86,86,172
https://kawalpemilu.org#51630,"KARYABUANA, CIGEULIS, PANDEGLANG, BANTEN",9,85,100,185
https://kawalpemilu.org#51630,"KARYABUANA, CIGEULIS, PANDEGLANG, BANTEN",10,89,126,215
https://kawalpemilu.org#51630,"KARYABUANA, CIGEULIS, PANDEGLANG, BANTEN",11,75,36,111
https://kawalpemilu.org#51630,"KARYABUANA, CIGEULIS, PANDEGLANG, BANTEN",12,104,134,238
https://kawalpemilu.org#51630,"KARYABUANA, CIGEULIS, PANDEGLANG, BANTEN",13,70,88,158
https://kawalpemilu.org#51630,"KARYABUANA, CIGEULIS, PANDEGLANG, BANTEN",14,111,70,181
https://kawalpemilu.org#51630,"KARYABUANA, CIGEULIS, PANDEGLANG, BANTEN",15,116,121,237
https://kawalpemilu.org#51631,"TARUMANAGARA, CIGEULIS, PANDEGLANG, BANTEN",1,110,34,144
https://kawalpemilu.org#51631,"TARUMANAGARA, CIGEULIS, PANDEGLANG, BANTEN",3,105,76,181
https://kawalpemilu.org#51631,"TARUMANAGARA, CIGEULIS, PANDEGLANG, BANTEN",4,114,94,208
https://kawalpemilu.org#51631,"TARUMANAGARA, CIGEULIS, PANDEGLANG, BANTEN",5,82,122,204
https://kawalpemilu.org#51631,"TARUMANAGARA, CIGEULIS, PANDEGLANG, BANTEN",6,50,83,133
https://kawalpemilu.org#51631,"TARUMANAGARA, CIGEULIS, PANDEGLANG, BANTEN",7,78,85,163
https://kawalpemilu.org#51631,"TARUMANAGARA, CIGEULIS, PANDEGLANG, BANTEN",8,112,43,155
https://kawalpemilu.org#51631,"TARUMANAGARA, CIGEULIS, PANDEGLANG, BANTEN",9,192,37,229
https://kawalpemilu.org#51631,"TARUMANAGARA, CIGEULIS, PANDEGLANG, BANTEN",10,121,104,225
https://kawalpemilu.org#51631,"TARUMANAGARA, CIGEULIS, PANDEGLANG, BANTEN",11,83,134,217
https://kawalpemilu.org#51632,"CISEUREUHEUN, CIGEULIS, PANDEGLANG, BANTEN",1,39,181,220
https://kawalpemilu.org#51632,"CISEUREUHEUN, CIGEULIS, PANDEGLANG, BANTEN",2,35,149,184
https://kawalpemilu.org#51632,"CISEUREUHEUN, CIGEULIS, PANDEGLANG, BANTEN",3,132,78,210
https://kawalpemilu.org#51632,"CISEUREUHEUN, CIGEULIS, PANDEGLANG, BANTEN",4,37,101,138
https://kawalpemilu.org#51632,"CISEUREUHEUN, CIGEULIS, PANDEGLANG, BANTEN",5,32,98,130
https://kawalpemilu.org#51632,"CISEUREUHEUN, CIGEULIS, PANDEGLANG, BANTEN",6,74,45,119
https://kawalpemilu.org#51632,"CISEUREUHEUN, CIGEULIS, PANDEGLANG, BANTEN",7,46,165,211
https://kawalpemilu.org#51632,"CISEUREUHEUN, CIGEULIS, PANDEGLANG, BANTEN",8,152,56,208
https://kawalpemilu.org#51632,"CISEUREUHEUN, CIGEULIS, PANDEGLANG, BANTEN",9,128,67,195
https://kawalpemilu.org#51632,"CISEUREUHEUN, CIGEULIS, PANDEGLANG, BANTEN",10,91,94,185
https://kawalpemilu.org#51632,"CISEUREUHEUN, CIGEULIS, PANDEGLANG, BANTEN",11,107,94,201
https://kawalpemilu.org#51632,"CISEUREUHEUN, CIGEULIS, PANDEGLANG, BANTEN",12,136,78,214
https://kawalpemilu.org#51632,"CISEUREUHEUN, CIGEULIS, PANDEGLANG, BANTEN",13,113,81,194
https://kawalpemilu.org#51633,"BANYUASIH, CIGEULIS, PANDEGLANG, BANTEN",1,72,58,130
https://kawalpemilu.org#51633,"BANYUASIH, CIGEULIS, PANDEGLANG, BANTEN",2,103,77,180
https://kawalpemilu.org#51633,"BANYUASIH, CIGEULIS, PANDEGLANG, BANTEN",3,134,62,196
https://kawalpemilu.org#51633,"BANYUASIH, CIGEULIS, PANDEGLANG, BANTEN",4,103,72,175
https://kawalpemilu.org#51633,"BANYUASIH, CIGEULIS, PANDEGLANG, BANTEN",5,77,109,186
https://kawalpemilu.org#51633,"BANYUASIH, CIGEULIS, PANDEGLANG, BANTEN",6,123,60,183
https://kawalpemilu.org#51633,"BANYUASIH, CIGEULIS, PANDEGLANG, BANTEN",7,146,49,195
https://kawalpemilu.org#51633,"BANYUASIH, CIGEULIS, PANDEGLANG, BANTEN",8,195,23,218
https://kawalpemilu.org#51633,"BANYUASIH, CIGEULIS, PANDEGLANG, BANTEN",9,88,55,143
https://kawalpemilu.org#51633,"BANYUASIH, CIGEULIS, PANDEGLANG, BANTEN",10,100,60,160
https://kawalpemilu.org#51633,"BANYUASIH, CIGEULIS, PANDEGLANG, BANTEN",11,89,32,121
https://kawalpemilu.org#51633,"BANYUASIH, CIGEULIS, PANDEGLANG, BANTEN",12,94,20,114
https://kawalpemilu.org#51633,"BANYUASIH, CIGEULIS, PANDEGLANG, BANTEN",13,155,46,201
https://kawalpemilu.org#51633,"BANYUASIH, CIGEULIS, PANDEGLANG, BANTEN",14,146,28,174
https://kawalpemilu.org#51634,"CIGEULIS, CIGEULIS, PANDEGLANG, BANTEN",1,53,177,230
https://kawalpemilu.org#51634,"CIGEULIS, CIGEULIS, PANDEGLANG, BANTEN",2,92,90,182
https://kawalpemilu.org#51634,"CIGEULIS, CIGEULIS, PANDEGLANG, BANTEN",4,138,104,242
https://kawalpemilu.org#51634,"CIGEULIS, CIGEULIS, PANDEGLANG, BANTEN",5,114,32,146
https://kawalpemilu.org#51634,"CIGEULIS, CIGEULIS, PANDEGLANG, BANTEN",6,61,132,193
https://kawalpemilu.org#51634,"CIGEULIS, CIGEULIS, PANDEGLANG, BANTEN",7,83,82,165
https://kawalpemilu.org#51634,"CIGEULIS, CIGEULIS, PANDEGLANG, BANTEN",8,65,105,170
https://kawalpemilu.org#51634,"CIGEULIS, CIGEULIS, PANDEGLANG, BANTEN",9,150,63,213
https://kawalpemilu.org#51634,"CIGEULIS, CIGEULIS, PANDEGLANG, BANTEN",10,103,70,173
https://kawalpemilu.org#51635,"SINARJAYA, CIGEULIS, PANDEGLANG, BANTEN",1,100,86,186
https://kawalpemilu.org#51635,"SINARJAYA, CIGEULIS, PANDEGLANG, BANTEN",2,172,40,212
https://kawalpemilu.org#51635,"SINARJAYA, CIGEULIS, PANDEGLANG, BANTEN",3,141,48,189
https://kawalpemilu.org#51635,"SINARJAYA, CIGEULIS, PANDEGLANG, BANTEN",4,65,77,142
https://kawalpemilu.org#51635,"SINARJAYA, CIGEULIS, PANDEGLANG, BANTEN",5,98,78,176
https://kawalpemilu.org#51635,"SINARJAYA, CIGEULIS, PANDEGLANG, BANTEN",6,110,58,168
https://kawalpemilu.org#51635,"SINARJAYA, CIGEULIS, PANDEGLANG, BANTEN",7,87,86,173
https://kawalpemilu.org#51635,"SINARJAYA, CIGEULIS, PANDEGLANG, BANTEN",8,98,116,214
https://kawalpemilu.org#51635,"SINARJAYA, CIGEULIS, PANDEGLANG, BANTEN",9,122,56,178
https://kawalpemilu.org#51635,"SINARJAYA, CIGEULIS, PANDEGLANG, BANTEN",10,136,28,164
https://kawalpemilu.org#51635,"SINARJAYA, CIGEULIS, PANDEGLANG, BANTEN",11,129,37,166
https://kawalpemilu.org#51637,"PANIMBANGJAYA, PANIMBANG, PANDEGLANG, BANTEN",1,167,50,217
https://kawalpemilu.org#51637,"PANIMBANGJAYA, PANIMBANG, PANDEGLANG, BANTEN",2,191,41,232
https://kawalpemilu.org#51637,"PANIMBANGJAYA, PANIMBANG, PANDEGLANG, BANTEN",3,172,72,244
https://kawalpemilu.org#51637,"PANIMBANGJAYA, PANIMBANG, PANDEGLANG, BANTEN",4,115,116,231
https://kawalpemilu.org#51637,"PANIMBANGJAYA, PANIMBANG, PANDEGLANG, BANTEN",6,162,41,203
https://kawalpemilu.org#51637,"PANIMBANGJAYA, PANIMBANG, PANDEGLANG, BANTEN",7,138,99,237
https://kawalpemilu.org#51637,"PANIMBANGJAYA, PANIMBANG, PANDEGLANG, BANTEN",8,100,90,190
https://kawalpemilu.org#51637,"PANIMBANGJAYA, PANIMBANG, PANDEGLANG, BANTEN",9,126,64,190
https://kawalpemilu.org#51637,"PANIMBANGJAYA, PANIMBANG, PANDEGLANG, BANTEN",10,205,22,227
https://kawalpemilu.org#51637,"PANIMBANGJAYA, PANIMBANG, PANDEGLANG, BANTEN",11,134,99,233
https://kawalpemilu.org#51637,"PANIMBANGJAYA, PANIMBANG, PANDEGLANG, BANTEN",12,107,71,178
https://kawalpemilu.org#51637,"PANIMBANGJAYA, PANIMBANG, PANDEGLANG, BANTEN",13,71,74,145
https://kawalpemilu.org#51637,"PANIMBANGJAYA, PANIMBANG, PANDEGLANG, BANTEN",14,161,51,212
https://kawalpemilu.org#51637,"PANIMBANGJAYA, PANIMBANG, PANDEGLANG, BANTEN",15,152,39,191
https://kawalpemilu.org#51637,"PANIMBANGJAYA, PANIMBANG, PANDEGLANG, BANTEN",16,107,66,173
https://kawalpemilu.org#51637,"PANIMBANGJAYA, PANIMBANG, PANDEGLANG, BANTEN",17,60,54,114
https://kawalpemilu.org#51637,"PANIMBANGJAYA, PANIMBANG, PANDEGLANG, BANTEN",18,103,95,198
https://kawalpemilu.org#51637,"PANIMBANGJAYA, PANIMBANG, PANDEGLANG, BANTEN",19,112,82,194
https://kawalpemilu.org#51637,"PANIMBANGJAYA, PANIMBANG, PANDEGLANG, BANTEN",20,136,75,211
https://kawalpemilu.org#51637,"PANIMBANGJAYA, PANIMBANG, PANDEGLANG, BANTEN",21,201,57,258
https://kawalpemilu.org#51637,"PANIMBANGJAYA, PANIMBANG, PANDEGLANG, BANTEN",22,203,55,258
https://kawalpemilu.org#51637,"PANIMBANGJAYA, PANIMBANG, PANDEGLANG, BANTEN",23,163,67,230
https://kawalpemilu.org#51637,"PANIMBANGJAYA, PANIMBANG, PANDEGLANG, BANTEN",24,157,73,230
https://kawalpemilu.org#51637,"PANIMBANGJAYA, PANIMBANG, PANDEGLANG, BANTEN",25,139,56,195
https://kawalpemilu.org#51637,"PANIMBANGJAYA, PANIMBANG, PANDEGLANG, BANTEN",26,93,61,154
https://kawalpemilu.org#51637,"PANIMBANGJAYA, PANIMBANG, PANDEGLANG, BANTEN",27,144,77,221
https://kawalpemilu.org#51637,"PANIMBANGJAYA, PANIMBANG, PANDEGLANG, BANTEN",28,118,39,157
https://kawalpemilu.org#51637,"PANIMBANGJAYA, PANIMBANG, PANDEGLANG, BANTEN",29,148,77,225
https://kawalpemilu.org#51637,"PANIMBANGJAYA, PANIMBANG, PANDEGLANG, BANTEN",30,108,100,208
https://kawalpemilu.org#51637,"PANIMBANGJAYA, PANIMBANG, PANDEGLANG, BANTEN",31,87,82,169
https://kawalpemilu.org#51637,"PANIMBANGJAYA, PANIMBANG, PANDEGLANG, BANTEN",32,140,79,219
https://kawalpemilu.org#51637,"PANIMBANGJAYA, PANIMBANG, PANDEGLANG, BANTEN",33,124,52,176
https://kawalpemilu.org#51637,"PANIMBANGJAYA, PANIMBANG, PANDEGLANG, BANTEN",34,143,89,232
https://kawalpemilu.org#51637,"PANIMBANGJAYA, PANIMBANG, PANDEGLANG, BANTEN",35,144,52,196
https://kawalpemilu.org#51637,"PANIMBANGJAYA, PANIMBANG, PANDEGLANG, BANTEN",36,142,70,212
https://kawalpemilu.org#51637,"PANIMBANGJAYA, PANIMBANG, PANDEGLANG, BANTEN",37,150,102,252
https://kawalpemilu.org#51637,"PANIMBANGJAYA, PANIMBANG, PANDEGLANG, BANTEN",38,90,68,158
https://kawalpemilu.org#51637,"PANIMBANGJAYA, PANIMBANG, PANDEGLANG, BANTEN",39,84,107,191
https://kawalpemilu.org#51637,"PANIMBANGJAYA, PANIMBANG, PANDEGLANG, BANTEN",40,156,73,229
https://kawalpemilu.org#51637,"PANIMBANGJAYA, PANIMBANG, PANDEGLANG, BANTEN",41,130,73,203
https://kawalpemilu.org#51637,"PANIMBANGJAYA, PANIMBANG, PANDEGLANG, BANTEN",42,140,24,164
https://kawalpemilu.org#51638,"MEKARJAYA, PANIMBANG, PANDEGLANG, BANTEN",2,122,80,202
https://kawalpemilu.org#51638,"MEKARJAYA, PANIMBANG, PANDEGLANG, BANTEN",3,119,51,170
https://kawalpemilu.org#51638,"MEKARJAYA, PANIMBANG, PANDEGLANG, BANTEN",4,148,64,212
https://kawalpemilu.org#51638,"MEKARJAYA, PANIMBANG, PANDEGLANG, BANTEN",5,124,69,193
https://kawalpemilu.org#51638,"MEKARJAYA, PANIMBANG, PANDEGLANG, BANTEN",6,126,72,198
https://kawalpemilu.org#51638,"MEKARJAYA, PANIMBANG, PANDEGLANG, BANTEN",7,116,51,167
https://kawalpemilu.org#51638,"MEKARJAYA, PANIMBANG, PANDEGLANG, BANTEN",8,142,79,221
https://kawalpemilu.org#51638,"MEKARJAYA, PANIMBANG, PANDEGLANG, BANTEN",9,90,54,144
https://kawalpemilu.org#51638,"MEKARJAYA, PANIMBANG, PANDEGLANG, BANTEN",10,112,37,149
https://kawalpemilu.org#51638,"MEKARJAYA, PANIMBANG, PANDEGLANG, BANTEN",11,82,57,139
https://kawalpemilu.org#51638,"MEKARJAYA, PANIMBANG, PANDEGLANG, BANTEN",12,91,45,136
https://kawalpemilu.org#51638,"MEKARJAYA, PANIMBANG, PANDEGLANG, BANTEN",13,142,46,188
https://kawalpemilu.org#51638,"MEKARJAYA, PANIMBANG, PANDEGLANG, BANTEN",14,125,52,177
https://kawalpemilu.org#51638,"MEKARJAYA, PANIMBANG, PANDEGLANG, BANTEN",15,148,85,233
https://kawalpemilu.org#51639,"GOMBONG, PANIMBANG, PANDEGLANG, BANTEN",1,126,74,200
https://kawalpemilu.org#51639,"GOMBONG, PANIMBANG, PANDEGLANG, BANTEN",2,152,56,208
https://kawalpemilu.org#51639,"GOMBONG, PANIMBANG, PANDEGLANG, BANTEN",3,156,67,223
https://kawalpemilu.org#51639,"GOMBONG, PANIMBANG, PANDEGLANG, BANTEN",4,194,36,230
https://kawalpemilu.org#51639,"GOMBONG, PANIMBANG, PANDEGLANG, BANTEN",5,76,107,183
https://kawalpemilu.org#51639,"GOMBONG, PANIMBANG, PANDEGLANG, BANTEN",6,92,54,146
https://kawalpemilu.org#51639,"GOMBONG, PANIMBANG, PANDEGLANG, BANTEN",7,80,102,182
https://kawalpemilu.org#51639,"GOMBONG, PANIMBANG, PANDEGLANG, BANTEN",8,79,129,208
https://kawalpemilu.org#51639,"GOMBONG, PANIMBANG, PANDEGLANG, BANTEN",9,97,112,209
https://kawalpemilu.org#51639,"GOMBONG, PANIMBANG, PANDEGLANG, BANTEN",10,94,55,149
https://kawalpemilu.org#51639,"GOMBONG, PANIMBANG, PANDEGLANG, BANTEN",11,110,19,129
https://kawalpemilu.org#51639,"GOMBONG, PANIMBANG, PANDEGLANG, BANTEN",12,155,20,175
https://kawalpemilu.org#51640,"MEKARSARI, PANIMBANG, PANDEGLANG, BANTEN",1,129,73,200
https://kawalpemilu.org#51640,"MEKARSARI, PANIMBANG, PANDEGLANG, BANTEN",2,113,115,228
https://kawalpemilu.org#51640,"MEKARSARI, PANIMBANG, PANDEGLANG, BANTEN",3,142,43,185
https://kawalpemilu.org#51640,"MEKARSARI, PANIMBANG, PANDEGLANG, BANTEN",4,137,46,183
https://kawalpemilu.org#51640,"MEKARSARI, PANIMBANG, PANDEGLANG, BANTEN",5,114,91,205
https://kawalpemilu.org#51640,"MEKARSARI, PANIMBANG, PANDEGLANG, BANTEN",6,84,84,168
https://kawalpemilu.org#51640,"MEKARSARI, PANIMBANG, PANDEGLANG, BANTEN",7,142,85,227
https://kawalpemilu.org#51640,"MEKARSARI, PANIMBANG, PANDEGLANG, BANTEN",8,121,71,192
https://kawalpemilu.org#51640,"MEKARSARI, PANIMBANG, PANDEGLANG, BANTEN",9,110,94,204
https://kawalpemilu.org#51640,"MEKARSARI, PANIMBANG, PANDEGLANG, BANTEN",10,146,102,248
https://kawalpemilu.org#51640,"MEKARSARI, PANIMBANG, PANDEGLANG, BANTEN",11,118,90,208
https://kawalpemilu.org#51640,"MEKARSARI, PANIMBANG, PANDEGLANG, BANTEN",12,109,61,170
https://kawalpemilu.org#51640,"MEKARSARI, PANIMBANG, PANDEGLANG, BANTEN",13,114,24,138
https://kawalpemilu.org#51640,"MEKARSARI, PANIMBANG, PANDEGLANG, BANTEN",14,106,7,113
https://kawalpemilu.org#51640,"MEKARSARI, PANIMBANG, PANDEGLANG, BANTEN",15,151,47,198
https://kawalpemilu.org#51640,"MEKARSARI, PANIMBANG, PANDEGLANG, BANTEN",16,75,29,104
https://kawalpemilu.org#51640,"MEKARSARI, PANIMBANG, PANDEGLANG, BANTEN",17,115,78,193
https://kawalpemilu.org#51640,"MEKARSARI, PANIMBANG, PANDEGLANG, BANTEN",18,83,156,239
https://kawalpemilu.org#51640,"MEKARSARI, PANIMBANG, PANDEGLANG, BANTEN",19,132,54,186
https://kawalpemilu.org#51640,"MEKARSARI, PANIMBANG, PANDEGLANG, BANTEN",20,127,70,197
https://kawalpemilu.org#51640,"MEKARSARI, PANIMBANG, PANDEGLANG, BANTEN",21,109,28,137
https://kawalpemilu.org#51640,"MEKARSARI, PANIMBANG, PANDEGLANG, BANTEN",22,130,34,164
https://kawalpemilu.org#51640,"MEKARSARI, PANIMBANG, PANDEGLANG, BANTEN",23,104,59,163
https://kawalpemilu.org#51640,"MEKARSARI, PANIMBANG, PANDEGLANG, BANTEN",24,129,93,222
https://kawalpemilu.org#51640,"MEKARSARI, PANIMBANG, PANDEGLANG, BANTEN",25,180,96,276
https://kawalpemilu.org#51640,"MEKARSARI, PANIMBANG, PANDEGLANG, BANTEN",26,124,73,197
https://kawalpemilu.org#51640,"MEKARSARI, PANIMBANG, PANDEGLANG, BANTEN",27,138,21,159
https://kawalpemilu.org#51640,"MEKARSARI, PANIMBANG, PANDEGLANG, BANTEN",28,170,69,239
https://kawalpemilu.org#51640,"MEKARSARI, PANIMBANG, PANDEGLANG, BANTEN",29,115,52,167
https://kawalpemilu.org#51640,"MEKARSARI, PANIMBANG, PANDEGLANG, BANTEN",30,170,35,205
https://kawalpemilu.org#51640,"MEKARSARI, PANIMBANG, PANDEGLANG, BANTEN",31,148,78,226
https://kawalpemilu.org#51641,"CITEUREUP, PANIMBANG, PANDEGLANG, BANTEN",1,33,94,127
https://kawalpemilu.org#51641,"CITEUREUP, PANIMBANG, PANDEGLANG, BANTEN",2,36,83,119
https://kawalpemilu.org#51641,"CITEUREUP, PANIMBANG, PANDEGLANG, BANTEN",3,87,96,183
https://kawalpemilu.org#51641,"CITEUREUP, PANIMBANG, PANDEGLANG, BANTEN",4,89,88,177
https://kawalpemilu.org#51641,"CITEUREUP, PANIMBANG, PANDEGLANG, BANTEN",5,44,61,105
https://kawalpemilu.org#51641,"CITEUREUP, PANIMBANG, PANDEGLANG, BANTEN",6,110,80,193
https://kawalpemilu.org#51641,"CITEUREUP, PANIMBANG, PANDEGLANG, BANTEN",7,54,78,132
https://kawalpemilu.org#51641,"CITEUREUP, PANIMBANG, PANDEGLANG, BANTEN",8,46,103,149
https://kawalpemilu.org#51641,"CITEUREUP, PANIMBANG, PANDEGLANG, BANTEN",9,89,40,129
https://kawalpemilu.org#51641,"CITEUREUP, PANIMBANG, PANDEGLANG, BANTEN",10,88,131,219
https://kawalpemilu.org#51641,"CITEUREUP, PANIMBANG, PANDEGLANG, BANTEN",11,119,74,193
https://kawalpemilu.org#51641,"CITEUREUP, PANIMBANG, PANDEGLANG, BANTEN",12,94,90,184
https://kawalpemilu.org#51641,"CITEUREUP, PANIMBANG, PANDEGLANG, BANTEN",13,64,63,127
https://kawalpemilu.org#51641,"CITEUREUP, PANIMBANG, PANDEGLANG, BANTEN",14,58,34,92
https://kawalpemilu.org#51641,"CITEUREUP, PANIMBANG, PANDEGLANG, BANTEN",16,100,82,182
https://kawalpemilu.org#51641,"CITEUREUP, PANIMBANG, PANDEGLANG, BANTEN",17,90,83,173
https://kawalpemilu.org#51641,"CITEUREUP, PANIMBANG, PANDEGLANG, BANTEN",18,91,39,130
https://kawalpemilu.org#51641,"CITEUREUP, PANIMBANG, PANDEGLANG, BANTEN",19,133,38,171
https://kawalpemilu.org#51641,"CITEUREUP, PANIMBANG, PANDEGLANG, BANTEN",20,75,32,107
https://kawalpemilu.org#51641,"CITEUREUP, PANIMBANG, PANDEGLANG, BANTEN",21,109,28,137
https://kawalpemilu.org#51641,"CITEUREUP, PANIMBANG, PANDEGLANG, BANTEN",22,115,65,180
https://kawalpemilu.org#51641,"CITEUREUP, PANIMBANG, PANDEGLANG, BANTEN",23,153,37,190
https://kawalpemilu.org#51641,"CITEUREUP, PANIMBANG, PANDEGLANG, BANTEN",24,109,44,153
https://kawalpemilu.org#51641,"CITEUREUP, PANIMBANG, PANDEGLANG, BANTEN",25,76,60,136
https://kawalpemilu.org#51641,"CITEUREUP, PANIMBANG, PANDEGLANG, BANTEN",26,128,38,166
https://kawalpemilu.org#51641,"CITEUREUP, PANIMBANG, PANDEGLANG, BANTEN",27,75,29,104
https://kawalpemilu.org#51641,"CITEUREUP, PANIMBANG, PANDEGLANG, BANTEN",28,92,34,0
https://kawalpemilu.org#51641,"CITEUREUP, PANIMBANG, PANDEGLANG, BANTEN",29,135,33,168
https://kawalpemilu.org#51642,"TANJUNGJAYA, PANIMBANG, PANDEGLANG, BANTEN",1,123,80,203
https://kawalpemilu.org#51642,"TANJUNGJAYA, PANIMBANG, PANDEGLANG, BANTEN",2,133,98,231
https://kawalpemilu.org#51642,"TANJUNGJAYA, PANIMBANG, PANDEGLANG, BANTEN",3,119,55,174
https://kawalpemilu.org#51642,"TANJUNGJAYA, PANIMBANG, PANDEGLANG, BANTEN",4,123,97,220
https://kawalpemilu.org#51642,"TANJUNGJAYA, PANIMBANG, PANDEGLANG, BANTEN",5,111,49,160
https://kawalpemilu.org#51642,"TANJUNGJAYA, PANIMBANG, PANDEGLANG, BANTEN",6,118,59,177
https://kawalpemilu.org#51642,"TANJUNGJAYA, PANIMBANG, PANDEGLANG, BANTEN",7,138,61,199
https://kawalpemilu.org#51642,"TANJUNGJAYA, PANIMBANG, PANDEGLANG, BANTEN",8,140,62,202
https://kawalpemilu.org#51642,"TANJUNGJAYA, PANIMBANG, PANDEGLANG, BANTEN",9,126,76,202
https://kawalpemilu.org#51642,"TANJUNGJAYA, PANIMBANG, PANDEGLANG, BANTEN",10,119,47,166
https://kawalpemilu.org#51642,"TANJUNGJAYA, PANIMBANG, PANDEGLANG, BANTEN",11,145,37,182
https://kawalpemilu.org#51642,"TANJUNGJAYA, PANIMBANG, PANDEGLANG, BANTEN",12,179,27,206
https://kawalpemilu.org#51642,"TANJUNGJAYA, PANIMBANG, PANDEGLANG, BANTEN",13,162,55,217
https://kawalpemilu.org#51642,"TANJUNGJAYA, PANIMBANG, PANDEGLANG, BANTEN",14,164,65,229
https://kawalpemilu.org#51642,"TANJUNGJAYA, PANIMBANG, PANDEGLANG, BANTEN",15,135,47,182
https://kawalpemilu.org#51642,"TANJUNGJAYA, PANIMBANG, PANDEGLANG, BANTEN",18,115,52,167
https://kawalpemilu.org#51642,"TANJUNGJAYA, PANIMBANG, PANDEGLANG, BANTEN",19,110,27,137
https://kawalpemilu.org#51642,"TANJUNGJAYA, PANIMBANG, PANDEGLANG, BANTEN",20,119,35,154
https://kawalpemilu.org#51644,"ANGSANA, ANGSANA, PANDEGLANG, BANTEN",1,93,131,224
https://kawalpemilu.org#51644,"ANGSANA, ANGSANA, PANDEGLANG, BANTEN",2,117,95,212
https://kawalpemilu.org#51644,"ANGSANA, ANGSANA, PANDEGLANG, BANTEN",3,134,56,190
https://kawalpemilu.org#51644,"ANGSANA, ANGSANA, PANDEGLANG, BANTEN",4,90,62,152
https://kawalpemilu.org#51644,"ANGSANA, ANGSANA, PANDEGLANG, BANTEN",5,40,63,103
https://kawalpemilu.org#51644,"ANGSANA, ANGSANA, PANDEGLANG, BANTEN",6,140,53,193
https://kawalpemilu.org#51644,"ANGSANA, ANGSANA, PANDEGLANG, BANTEN",7,78,77,155
https://kawalpemilu.org#51644,"ANGSANA, ANGSANA, PANDEGLANG, BANTEN",8,74,129,203
https://kawalpemilu.org#51644,"ANGSANA, ANGSANA, PANDEGLANG, BANTEN",9,85,175,260
https://kawalpemilu.org#51644,"ANGSANA, ANGSANA, PANDEGLANG, BANTEN",10,64,127,191
https://kawalpemilu.org#51644,"ANGSANA, ANGSANA, PANDEGLANG, BANTEN",11,42,72,114
https://kawalpemilu.org#51644,"ANGSANA, ANGSANA, PANDEGLANG, BANTEN",12,73,147,220
https://kawalpemilu.org#51644,"ANGSANA, ANGSANA, PANDEGLANG, BANTEN",13,63,144,207
https://kawalpemilu.org#51645,"PADAHERANG, ANGSANA, PANDEGLANG, BANTEN",1,77,111,188
https://kawalpemilu.org#51645,"PADAHERANG, ANGSANA, PANDEGLANG, BANTEN",2,52,101,153
https://kawalpemilu.org#51645,"PADAHERANG, ANGSANA, PANDEGLANG, BANTEN",3,97,67,164
https://kawalpemilu.org#51645,"PADAHERANG, ANGSANA, PANDEGLANG, BANTEN",4,199,66,185
https://kawalpemilu.org#51645,"PADAHERANG, ANGSANA, PANDEGLANG, BANTEN",5,125,11,136
https://kawalpemilu.org#51645,"PADAHERANG, ANGSANA, PANDEGLANG, BANTEN",6,113,71,184
https://kawalpemilu.org#51645,"PADAHERANG, ANGSANA, PANDEGLANG, BANTEN",7,104,86,190
https://kawalpemilu.org#51645,"PADAHERANG, ANGSANA, PANDEGLANG, BANTEN",8,84,85,169
https://kawalpemilu.org#51646,"PADAMULYA, ANGSANA, PANDEGLANG, BANTEN",1,39,157,196
https://kawalpemilu.org#51646,"PADAMULYA, ANGSANA, PANDEGLANG, BANTEN",2,50,161,211
https://kawalpemilu.org#51646,"PADAMULYA, ANGSANA, PANDEGLANG, BANTEN",3,104,78,182
https://kawalpemilu.org#51646,"PADAMULYA, ANGSANA, PANDEGLANG, BANTEN",4,128,101,129
https://kawalpemilu.org#51646,"PADAMULYA, ANGSANA, PANDEGLANG, BANTEN",5,53,129,182
https://kawalpemilu.org#51646,"PADAMULYA, ANGSANA, PANDEGLANG, BANTEN",6,127,94,221
https://kawalpemilu.org#51646,"PADAMULYA, ANGSANA, PANDEGLANG, BANTEN",7,50,130,180
https://kawalpemilu.org#51647,"KARANGSARI, ANGSANA, PANDEGLANG, BANTEN",1,133,60,193
https://kawalpemilu.org#51647,"KARANGSARI, ANGSANA, PANDEGLANG, BANTEN",2,122,104,226
https://kawalpemilu.org#51647,"KARANGSARI, ANGSANA, PANDEGLANG, BANTEN",3,82,75,157
https://kawalpemilu.org#51647,"KARANGSARI, ANGSANA, PANDEGLANG, BANTEN",4,109,75,184
https://kawalpemilu.org#51647,"KARANGSARI, ANGSANA, PANDEGLANG, BANTEN",5,121,84,205
https://kawalpemilu.org#51647,"KARANGSARI, ANGSANA, PANDEGLANG, BANTEN",6,85,106,191
https://kawalpemilu.org#51647,"KARANGSARI, ANGSANA, PANDEGLANG, BANTEN",7,76,77,153
https://kawalpemilu.org#51647,"KARANGSARI, ANGSANA, PANDEGLANG, BANTEN",8,102,74,176
https://kawalpemilu.org#51647,"KARANGSARI, ANGSANA, PANDEGLANG, BANTEN",9,90,56,146
https://kawalpemilu.org#51647,"KARANGSARI, ANGSANA, PANDEGLANG, BANTEN",10,112,30,142
https://kawalpemilu.org#51648,"CIKAYAS, ANGSANA, PANDEGLANG, BANTEN",1,64,95,159
https://kawalpemilu.org#51648,"CIKAYAS, ANGSANA, PANDEGLANG, BANTEN",2,37,127,164
https://kawalpemilu.org#51648,"CIKAYAS, ANGSANA, PANDEGLANG, BANTEN",3,23,123,146
https://kawalpemilu.org#51648,"CIKAYAS, ANGSANA, PANDEGLANG, BANTEN",4,32,162,194
https://kawalpemilu.org#51648,"CIKAYAS, ANGSANA, PANDEGLANG, BANTEN",5,29,122,151
https://kawalpemilu.org#51648,"CIKAYAS, ANGSANA, PANDEGLANG, BANTEN",6,40,113,153
https://kawalpemilu.org#51648,"CIKAYAS, ANGSANA, PANDEGLANG, BANTEN",7,77,135,213
https://kawalpemilu.org#51648,"CIKAYAS, ANGSANA, PANDEGLANG, BANTEN",8,54,122,176
https://kawalpemilu.org#51648,"CIKAYAS, ANGSANA, PANDEGLANG, BANTEN",9,65,118,183
https://kawalpemilu.org#51648,"CIKAYAS, ANGSANA, PANDEGLANG, BANTEN",10,37,191,228
https://kawalpemilu.org#51648,"CIKAYAS, ANGSANA, PANDEGLANG, BANTEN",11,46,195,241
https://kawalpemilu.org#51649,"SUMURLABAN, ANGSANA, PANDEGLANG, BANTEN",1,138,75,213
https://kawalpemilu.org#51649,"SUMURLABAN, ANGSANA, PANDEGLANG, BANTEN",2,80,138,218
https://kawalpemilu.org#51649,"SUMURLABAN, ANGSANA, PANDEGLANG, BANTEN",3,79,130,209
https://kawalpemilu.org#51649,"SUMURLABAN, ANGSANA, PANDEGLANG, BANTEN",4,89,107,196
https://kawalpemilu.org#51649,"SUMURLABAN, ANGSANA, PANDEGLANG, BANTEN",5,66,130,196
https://kawalpemilu.org#51649,"SUMURLABAN, ANGSANA, PANDEGLANG, BANTEN",6,50,151,201
https://kawalpemilu.org#51649,"SUMURLABAN, ANGSANA, PANDEGLANG, BANTEN",7,40,146,186
https://kawalpemilu.org#51649,"SUMURLABAN, ANGSANA, PANDEGLANG, BANTEN",8,83,65,148
https://kawalpemilu.org#51649,"SUMURLABAN, ANGSANA, PANDEGLANG, BANTEN",9,85,101,186
https://kawalpemilu.org#51650,"KADUBADAK, ANGSANA, PANDEGLANG, BANTEN",1,64,126,190
https://kawalpemilu.org#51650,"KADUBADAK, ANGSANA, PANDEGLANG, BANTEN",2,71,93,164
https://kawalpemilu.org#51650,"KADUBADAK, ANGSANA, PANDEGLANG, BANTEN",3,76,120,196
https://kawalpemilu.org#51650,"KADUBADAK, ANGSANA, PANDEGLANG, BANTEN",4,88,70,158
https://kawalpemilu.org#51650,"KADUBADAK, ANGSANA, PANDEGLANG, BANTEN",5,109,67,176
https://kawalpemilu.org#51650,"KADUBADAK, ANGSANA, PANDEGLANG, BANTEN",6,56,50,106
https://kawalpemilu.org#51651,"CIPINANG, ANGSANA, PANDEGLANG, BANTEN",1,41,189,230
https://kawalpemilu.org#51651,"CIPINANG, ANGSANA, PANDEGLANG, BANTEN",2,31,199,230
https://kawalpemilu.org#51651,"CIPINANG, ANGSANA, PANDEGLANG, BANTEN",3,74,160,234
https://kawalpemilu.org#51651,"CIPINANG, ANGSANA, PANDEGLANG, BANTEN",4,91,121,212
https://kawalpemilu.org#51651,"CIPINANG, ANGSANA, PANDEGLANG, BANTEN",5,63,125,188
https://kawalpemilu.org#51651,"CIPINANG, ANGSANA, PANDEGLANG, BANTEN",6,63,109,172
https://kawalpemilu.org#51651,"CIPINANG, ANGSANA, PANDEGLANG, BANTEN",7,74,91,165
https://kawalpemilu.org#51651,"CIPINANG, ANGSANA, PANDEGLANG, BANTEN",8,15,98,113
https://kawalpemilu.org#51651,"CIPINANG, ANGSANA, PANDEGLANG, BANTEN",9,80,93,173
https://kawalpemilu.org#51651,"CIPINANG, ANGSANA, PANDEGLANG, BANTEN",10,83,52,135
https://kawalpemilu.org#51651,"CIPINANG, ANGSANA, PANDEGLANG, BANTEN",11,103,129,232
https://kawalpemilu.org#51651,"CIPINANG, ANGSANA, PANDEGLANG, BANTEN",12,87,91,178
https://kawalpemilu.org#51651,"CIPINANG, ANGSANA, PANDEGLANG, BANTEN",13,60,110,170
https://kawalpemilu.org#51652,"KRAMATMANIK, ANGSANA, PANDEGLANG, BANTEN",1,111,43,154
https://kawalpemilu.org#51652,"KRAMATMANIK, ANGSANA, PANDEGLANG, BANTEN",2,50,86,136
https://kawalpemilu.org#51652,"KRAMATMANIK, ANGSANA, PANDEGLANG, BANTEN",3,65,115,180
https://kawalpemilu.org#51652,"KRAMATMANIK, ANGSANA, PANDEGLANG, BANTEN",4,39,145,184
https://kawalpemilu.org#51652,"KRAMATMANIK, ANGSANA, PANDEGLANG, BANTEN",5,27,136,163
https://kawalpemilu.org#51652,"KRAMATMANIK, ANGSANA, PANDEGLANG, BANTEN",6,38,110,148
https://kawalpemilu.org#51652,"KRAMATMANIK, ANGSANA, PANDEGLANG, BANTEN",7,57,132,189
https://kawalpemilu.org#51652,"KRAMATMANIK, ANGSANA, PANDEGLANG, BANTEN",8,48,129,177
https://kawalpemilu.org#51654,"PASANGGRAHAN, MUNJUL, PANDEGLANG, BANTEN",1,77,123,200
https://kawalpemilu.org#51654,"PASANGGRAHAN, MUNJUL, PANDEGLANG, BANTEN",2,44,140,184
https://kawalpemilu.org#51654,"PASANGGRAHAN, MUNJUL, PANDEGLANG, BANTEN",3,75,151,226
https://kawalpemilu.org#51654,"PASANGGRAHAN, MUNJUL, PANDEGLANG, BANTEN",4,60,153,213
https://kawalpemilu.org#51654,"PASANGGRAHAN, MUNJUL, PANDEGLANG, BANTEN",5,27,117,144
https://kawalpemilu.org#51654,"PASANGGRAHAN, MUNJUL, PANDEGLANG, BANTEN",6,54,173,227
https://kawalpemilu.org#51654,"PASANGGRAHAN, MUNJUL, PANDEGLANG, BANTEN",7,81,138,219
https://kawalpemilu.org#51655,"SUKASABA, MUNJUL, PANDEGLANG, BANTEN",1,81,114,195
https://kawalpemilu.org#51655,"SUKASABA, MUNJUL, PANDEGLANG, BANTEN",2,80,124,204
https://kawalpemilu.org#51655,"SUKASABA, MUNJUL, PANDEGLANG, BANTEN",3,93,115,208
https://kawalpemilu.org#51655,"SUKASABA, MUNJUL, PANDEGLANG, BANTEN",4,33,181,214
https://kawalpemilu.org#51655,"SUKASABA, MUNJUL, PANDEGLANG, BANTEN",5,86,50,136
https://kawalpemilu.org#51655,"SUKASABA, MUNJUL, PANDEGLANG, BANTEN",6,99,74,173
https://kawalpemilu.org#51655,"SUKASABA, MUNJUL, PANDEGLANG, BANTEN",7,66,91,157
https://kawalpemilu.org#51655,"SUKASABA, MUNJUL, PANDEGLANG, BANTEN",8,48,64,112
https://kawalpemilu.org#51655,"SUKASABA, MUNJUL, PANDEGLANG, BANTEN",9,29,136,165
https://kawalpemilu.org#51655,"SUKASABA, MUNJUL, PANDEGLANG, BANTEN",10,63,131,194
https://kawalpemilu.org#51655,"SUKASABA, MUNJUL, PANDEGLANG, BANTEN",11,54,126,180
https://kawalpemilu.org#51655,"SUKASABA, MUNJUL, PANDEGLANG, BANTEN",12,39,150,189
https://kawalpemilu.org#51655,"SUKASABA, MUNJUL, PANDEGLANG, BANTEN",13,103,109,212
https://kawalpemilu.org#51656,"GUNUNGBATU, MUNJUL, PANDEGLANG, BANTEN",1,147,77,224
https://kawalpemilu.org#51656,"GUNUNGBATU, MUNJUL, PANDEGLANG, BANTEN",2,133,94,227
https://kawalpemilu.org#51656,"GUNUNGBATU, MUNJUL, PANDEGLANG, BANTEN",3,80,108,188
https://kawalpemilu.org#51656,"GUNUNGBATU, MUNJUL, PANDEGLANG, BANTEN",4,53,54,107
https://kawalpemilu.org#51656,"GUNUNGBATU, MUNJUL, PANDEGLANG, BANTEN",5,93,139,232
https://kawalpemilu.org#51656,"GUNUNGBATU, MUNJUL, PANDEGLANG, BANTEN",6,104,118,222
https://kawalpemilu.org#51656,"GUNUNGBATU, MUNJUL, PANDEGLANG, BANTEN",7,73,68,141
https://kawalpemilu.org#51656,"GUNUNGBATU, MUNJUL, PANDEGLANG, BANTEN",8,102,49,151
https://kawalpemilu.org#51656,"GUNUNGBATU, MUNJUL, PANDEGLANG, BANTEN",9,53,77,130
https://kawalpemilu.org#51656,"GUNUNGBATU, MUNJUL, PANDEGLANG, BANTEN",10,49,130,179
https://kawalpemilu.org#51656,"GUNUNGBATU, MUNJUL, PANDEGLANG, BANTEN",11,49,109,158
https://kawalpemilu.org#51656,"GUNUNGBATU, MUNJUL, PANDEGLANG, BANTEN",12,76,77,153
https://kawalpemilu.org#51657,"PANACARAN, MUNJUL, PANDEGLANG, BANTEN",1,86,131,217
https://kawalpemilu.org#51657,"PANACARAN, MUNJUL, PANDEGLANG, BANTEN",2,44,110,154
https://kawalpemilu.org#51657,"PANACARAN, MUNJUL, PANDEGLANG, BANTEN",3,80,121,201
https://kawalpemilu.org#51657,"PANACARAN, MUNJUL, PANDEGLANG, BANTEN",4,41,73,114
https://kawalpemilu.org#51657,"PANACARAN, MUNJUL, PANDEGLANG, BANTEN",5,29,71,100
https://kawalpemilu.org#51657,"PANACARAN, MUNJUL, PANDEGLANG, BANTEN",6,80,73,153
https://kawalpemilu.org#51657,"PANACARAN, MUNJUL, PANDEGLANG, BANTEN",7,42,118,160
https://kawalpemilu.org#51657,"PANACARAN, MUNJUL, PANDEGLANG, BANTEN",8,47,94,141
https://kawalpemilu.org#51657,"PANACARAN, MUNJUL, PANDEGLANG, BANTEN",9,31,94,125
https://kawalpemilu.org#51657,"PANACARAN, MUNJUL, PANDEGLANG, BANTEN",10,34,95,129
https://kawalpemilu.org#51657,"PANACARAN, MUNJUL, PANDEGLANG, BANTEN",11,42,135,177
https://kawalpemilu.org#51658,"CURUGLANGLANG, MUNJUL, PANDEGLANG, BANTEN",1,41,134,175
https://kawalpemilu.org#51658,"CURUGLANGLANG, MUNJUL, PANDEGLANG, BANTEN",2,29,163,192
https://kawalpemilu.org#51658,"CURUGLANGLANG, MUNJUL, PANDEGLANG, BANTEN",3,20,176,196
https://kawalpemilu.org#51658,"CURUGLANGLANG, MUNJUL, PANDEGLANG, BANTEN",4,6,156,162
https://kawalpemilu.org#51658,"CURUGLANGLANG, MUNJUL, PANDEGLANG, BANTEN",5,24,133,157
https://kawalpemilu.org#51658,"CURUGLANGLANG, MUNJUL, PANDEGLANG, BANTEN",6,5,95,100
https://kawalpemilu.org#51658,"CURUGLANGLANG, MUNJUL, PANDEGLANG, BANTEN",7,28,100,128
https://kawalpemilu.org#51658,"CURUGLANGLANG, MUNJUL, PANDEGLANG, BANTEN",8,30,89,119
https://kawalpemilu.org#51659,"MUNJUL, MUNJUL, PANDEGLANG, BANTEN",1,67,94,161
https://kawalpemilu.org#51659,"MUNJUL, MUNJUL, PANDEGLANG, BANTEN",2,40,177,217
https://kawalpemilu.org#51659,"MUNJUL, MUNJUL, PANDEGLANG, BANTEN",3,58,145,203
https://kawalpemilu.org#51659,"MUNJUL, MUNJUL, PANDEGLANG, BANTEN",4,29,193,222
https://kawalpemilu.org#51659,"MUNJUL, MUNJUL, PANDEGLANG, BANTEN",5,33,128,161
https://kawalpemilu.org#51659,"MUNJUL, MUNJUL, PANDEGLANG, BANTEN",6,61,130,191
https://kawalpemilu.org#51659,"MUNJUL, MUNJUL, PANDEGLANG, BANTEN",7,72,120,192
https://kawalpemilu.org#51659,"MUNJUL, MUNJUL, PANDEGLANG, BANTEN",8,91,90,181
https://kawalpemilu.org#51659,"MUNJUL, MUNJUL, PANDEGLANG, BANTEN",9,62,49,111
https://kawalpemilu.org#51660,"CIBITUNG, MUNJUL, PANDEGLANG, BANTEN",1,49,126,175
https://kawalpemilu.org#51660,"CIBITUNG, MUNJUL, PANDEGLANG, BANTEN",2,43,158,201
https://kawalpemilu.org#51660,"CIBITUNG, MUNJUL, PANDEGLANG, BANTEN",3,31,141,172
https://kawalpemilu.org#51660,"CIBITUNG, MUNJUL, PANDEGLANG, BANTEN",4,47,143,190
https://kawalpemilu.org#51660,"CIBITUNG, MUNJUL, PANDEGLANG, BANTEN",5,47,152,199
https://kawalpemilu.org#51660,"CIBITUNG, MUNJUL, PANDEGLANG, BANTEN",6,80,117,197
https://kawalpemilu.org#51660,"CIBITUNG, MUNJUL, PANDEGLANG, BANTEN",7,85,78,163
https://kawalpemilu.org#51660,"CIBITUNG, MUNJUL, PANDEGLANG, BANTEN",8,69,88,157
https://kawalpemilu.org#51661,"KOTADUKUH, MUNJUL, PANDEGLANG, BANTEN",1,22,72,94
https://kawalpemilu.org#51661,"KOTADUKUH, MUNJUL, PANDEGLANG, BANTEN",2,30,112,142
https://kawalpemilu.org#51661,"KOTADUKUH, MUNJUL, PANDEGLANG, BANTEN",3,54,148,202
https://kawalpemilu.org#51661,"KOTADUKUH, MUNJUL, PANDEGLANG, BANTEN",4,36,150,186
https://kawalpemilu.org#51661,"KOTADUKUH, MUNJUL, PANDEGLANG, BANTEN",5,87,82,169
https://kawalpemilu.org#51661,"KOTADUKUH, MUNJUL, PANDEGLANG, BANTEN",6,88,52,140
https://kawalpemilu.org#51661,"KOTADUKUH, MUNJUL, PANDEGLANG, BANTEN",7,95,80,175
https://kawalpemilu.org#51662,"LEBAK, MUNJUL, PANDEGLANG, BANTEN",1,48,100,148
https://kawalpemilu.org#51662,"LEBAK, MUNJUL, PANDEGLANG, BANTEN",2,46,155,201
https://kawalpemilu.org#51662,"LEBAK, MUNJUL, PANDEGLANG, BANTEN",3,100,118,218
https://kawalpemilu.org#51662,"LEBAK, MUNJUL, PANDEGLANG, BANTEN",4,53,119,172
https://kawalpemilu.org#51662,"LEBAK, MUNJUL, PANDEGLANG, BANTEN",5,140,64,204
https://kawalpemilu.org#51662,"LEBAK, MUNJUL, PANDEGLANG, BANTEN",6,133,121,254
https://kawalpemilu.org#51662,"LEBAK, MUNJUL, PANDEGLANG, BANTEN",7,150,101,251
https://kawalpemilu.org#51664,"SUKADAME, PAGELARAN, PANDEGLANG, BANTEN",1,103,85,188
https://kawalpemilu.org#51664,"SUKADAME, PAGELARAN, PANDEGLANG, BANTEN",2,84,118,202
https://kawalpemilu.org#51664,"SUKADAME, PAGELARAN, PANDEGLANG, BANTEN",3,82,108,190
https://kawalpemilu.org#51664,"SUKADAME, PAGELARAN, PANDEGLANG, BANTEN",4,70,78,148
https://kawalpemilu.org#51664,"SUKADAME, PAGELARAN, PANDEGLANG, BANTEN",5,50,76,126
https://kawalpemilu.org#51664,"SUKADAME, PAGELARAN, PANDEGLANG, BANTEN",6,47,96,143
https://kawalpemilu.org#51664,"SUKADAME, PAGELARAN, PANDEGLANG, BANTEN",7,50,71,121
https://kawalpemilu.org#51664,"SUKADAME, PAGELARAN, PANDEGLANG, BANTEN",8,54,95,149
https://kawalpemilu.org#51664,"SUKADAME, PAGELARAN, PANDEGLANG, BANTEN",9,60,104,164
https://kawalpemilu.org#51665,"PAGELARAN, PAGELARAN, PANDEGLANG, BANTEN",1,81,120,201
https://kawalpemilu.org#51665,"PAGELARAN, PAGELARAN, PANDEGLANG, BANTEN",2,115,95,210
https://kawalpemilu.org#51665,"PAGELARAN, PAGELARAN, PANDEGLANG, BANTEN",3,68,153,221
https://kawalpemilu.org#51665,"PAGELARAN, PAGELARAN, PANDEGLANG, BANTEN",4,51,149,200
https://kawalpemilu.org#51665,"PAGELARAN, PAGELARAN, PANDEGLANG, BANTEN",5,49,113,162
https://kawalpemilu.org#51665,"PAGELARAN, PAGELARAN, PANDEGLANG, BANTEN",6,32,98,130
https://kawalpemilu.org#51665,"PAGELARAN, PAGELARAN, PANDEGLANG, BANTEN",7,46,204,250
https://kawalpemilu.org#51665,"PAGELARAN, PAGELARAN, PANDEGLANG, BANTEN",8,36,138,174
https://kawalpemilu.org#51665,"PAGELARAN, PAGELARAN, PANDEGLANG, BANTEN",9,119,90,209
https://kawalpemilu.org#51665,"PAGELARAN, PAGELARAN, PANDEGLANG, BANTEN",10,81,104,185
https://kawalpemilu.org#51665,"PAGELARAN, PAGELARAN, PANDEGLANG, BANTEN",11,50,91,141
https://kawalpemilu.org#51665,"PAGELARAN, PAGELARAN, PANDEGLANG, BANTEN",12,54,82,136
https://kawalpemilu.org#51666,"SURAKARTA, PAGELARAN, PANDEGLANG, BANTEN",1,45,140,185
https://kawalpemilu.org#51666,"SURAKARTA, PAGELARAN, PANDEGLANG, BANTEN",2,35,128,163
https://kawalpemilu.org#51666,"SURAKARTA, PAGELARAN, PANDEGLANG, BANTEN",3,43,110,153
https://kawalpemilu.org#51666,"SURAKARTA, PAGELARAN, PANDEGLANG, BANTEN",4,92,66,158
https://kawalpemilu.org#51666,"SURAKARTA, PAGELARAN, PANDEGLANG, BANTEN",5,50,97,147
https://kawalpemilu.org#51666,"SURAKARTA, PAGELARAN, PANDEGLANG, BANTEN",6,58,136,194
https://kawalpemilu.org#51666,"SURAKARTA, PAGELARAN, PANDEGLANG, BANTEN",7,84,106,190
https://kawalpemilu.org#51667,"MONTOR, PAGELARAN, PANDEGLANG, BANTEN",1,43,137,180
https://kawalpemilu.org#51667,"MONTOR, PAGELARAN, PANDEGLANG, BANTEN",2,72,120,192
https://kawalpemilu.org#51667,"MONTOR, PAGELARAN, PANDEGLANG, BANTEN",3,94,124,218
https://kawalpemilu.org#51667,"MONTOR, PAGELARAN, PANDEGLANG, BANTEN",4,41,129,170
https://kawalpemilu.org#51667,"MONTOR, PAGELARAN, PANDEGLANG, BANTEN",5,100,103,203
https://kawalpemilu.org#51667,"MONTOR, PAGELARAN, PANDEGLANG, BANTEN",6,51,123,174
https://kawalpemilu.org#51667,"MONTOR, PAGELARAN, PANDEGLANG, BANTEN",7,84,102,186
https://kawalpemilu.org#51667,"MONTOR, PAGELARAN, PANDEGLANG, BANTEN",8,92,119,211
https://kawalpemilu.org#51667,"MONTOR, PAGELARAN, PANDEGLANG, BANTEN",9,71,124,195
https://kawalpemilu.org#51667,"MONTOR, PAGELARAN, PANDEGLANG, BANTEN",10,78,86,164
https://kawalpemilu.org#51667,"MONTOR, PAGELARAN, PANDEGLANG, BANTEN",11,69,61,130
https://kawalpemilu.org#51667,"MONTOR, PAGELARAN, PANDEGLANG, BANTEN",12,82,102,184
https://kawalpemilu.org#51668,"KERTASANA, PAGELARAN, PANDEGLANG, BANTEN",1,83,119,202
https://kawalpemilu.org#51668,"KERTASANA, PAGELARAN, PANDEGLANG, BANTEN",2,55,136,191
https://kawalpemilu.org#51668,"KERTASANA, PAGELARAN, PANDEGLANG, BANTEN",3,48,145,193
https://kawalpemilu.org#51668,"KERTASANA, PAGELARAN, PANDEGLANG, BANTEN",4,58,150,208
https://kawalpemilu.org#51668,"KERTASANA, PAGELARAN, PANDEGLANG, BANTEN",5,49,160,209
https://kawalpemilu.org#51668,"KERTASANA, PAGELARAN, PANDEGLANG, BANTEN",6,74,101,175
https://kawalpemilu.org#51669,"BAMA, PAGELARAN, PANDEGLANG, BANTEN",1,35,93,128
https://kawalpemilu.org#51669,"BAMA, PAGELARAN, PANDEGLANG, BANTEN",2,37,126,163
https://kawalpemilu.org#51669,"BAMA, PAGELARAN, PANDEGLANG, BANTEN",3,27,154,181
https://kawalpemilu.org#51669,"BAMA, PAGELARAN, PANDEGLANG, BANTEN",4,54,157,211
https://kawalpemilu.org#51669,"BAMA, PAGELARAN, PANDEGLANG, BANTEN",5,26,146,172
https://kawalpemilu.org#51669,"BAMA, PAGELARAN, PANDEGLANG, BANTEN",6,43,168,211
https://kawalpemilu.org#51669,"BAMA, PAGELARAN, PANDEGLANG, BANTEN",7,33,177,210
https://kawalpemilu.org#51669,"BAMA, PAGELARAN, PANDEGLANG, BANTEN",8,79,80,159
https://kawalpemilu.org#51669,"BAMA, PAGELARAN, PANDEGLANG, BANTEN",9,66,144,210
https://kawalpemilu.org#51670,"MARGASANA, PAGELARAN, PANDEGLANG, BANTEN",1,113,77,190
https://kawalpemilu.org#51670,"MARGASANA, PAGELARAN, PANDEGLANG, BANTEN",2,77,107,184
https://kawalpemilu.org#51670,"MARGASANA, PAGELARAN, PANDEGLANG, BANTEN",3,57,108,165
https://kawalpemilu.org#51670,"MARGASANA, PAGELARAN, PANDEGLANG, BANTEN",4,62,108,170
https://kawalpemilu.org#51670,"MARGASANA, PAGELARAN, PANDEGLANG, BANTEN",5,65,136,201
https://kawalpemilu.org#51670,"MARGASANA, PAGELARAN, PANDEGLANG, BANTEN",6,64,109,173
https://kawalpemilu.org#51670,"MARGASANA, PAGELARAN, PANDEGLANG, BANTEN",7,57,116,173
https://kawalpemilu.org#51670,"MARGASANA, PAGELARAN, PANDEGLANG, BANTEN",8,58,147,205
https://kawalpemilu.org#51670,"MARGASANA, PAGELARAN, PANDEGLANG, BANTEN",9,63,120,183
https://kawalpemilu.org#51670,"MARGASANA, PAGELARAN, PANDEGLANG, BANTEN",10,36,94,130
https://kawalpemilu.org#51670,"MARGASANA, PAGELARAN, PANDEGLANG, BANTEN",11,60,93,153
https://kawalpemilu.org#51670,"MARGASANA, PAGELARAN, PANDEGLANG, BANTEN",12,81,133,214
https://kawalpemilu.org#51671,"SINDANGLAYA, PAGELARAN, PANDEGLANG, BANTEN",1,93,114,207
https://kawalpemilu.org#51671,"SINDANGLAYA, PAGELARAN, PANDEGLANG, BANTEN",2,67,134,201
https://kawalpemilu.org#51671,"SINDANGLAYA, PAGELARAN, PANDEGLANG, BANTEN",3,56,96,152
https://kawalpemilu.org#51671,"SINDANGLAYA, PAGELARAN, PANDEGLANG, BANTEN",4,76,146,222
https://kawalpemilu.org#51671,"SINDANGLAYA, PAGELARAN, PANDEGLANG, BANTEN",5,106,91,197
https://kawalpemilu.org#51671,"SINDANGLAYA, PAGELARAN, PANDEGLANG, BANTEN",6,71,63,134
https://kawalpemilu.org#51671,"SINDANGLAYA, PAGELARAN, PANDEGLANG, BANTEN",7,61,94,155
https://kawalpemilu.org#51672,"TEGALPAPAK, PAGELARAN, PANDEGLANG, BANTEN",1,87,38,125
https://kawalpemilu.org#51672,"TEGALPAPAK, PAGELARAN, PANDEGLANG, BANTEN",2,142,94,236
https://kawalpemilu.org#51672,"TEGALPAPAK, PAGELARAN, PANDEGLANG, BANTEN",3,126,74,200
https://kawalpemilu.org#51672,"TEGALPAPAK, PAGELARAN, PANDEGLANG, BANTEN",4,114,115,229
https://kawalpemilu.org#51672,"TEGALPAPAK, PAGELARAN, PANDEGLANG, BANTEN",5,95,74,169
https://kawalpemilu.org#51672,"TEGALPAPAK, PAGELARAN, PANDEGLANG, BANTEN",6,66,110,176
https://kawalpemilu.org#51672,"TEGALPAPAK, PAGELARAN, PANDEGLANG, BANTEN",7,43,154,197
https://kawalpemilu.org#51672,"TEGALPAPAK, PAGELARAN, PANDEGLANG, BANTEN",8,118,73,191
https://kawalpemilu.org#51672,"TEGALPAPAK, PAGELARAN, PANDEGLANG, BANTEN",9,70,85,155
https://kawalpemilu.org#51673,"BULAGOR, PAGELARAN, PANDEGLANG, BANTEN",1,87,49,136
https://kawalpemilu.org#51673,"BULAGOR, PAGELARAN, PANDEGLANG, BANTEN",2,44,75,119
https://kawalpemilu.org#51673,"BULAGOR, PAGELARAN, PANDEGLANG, BANTEN",3,51,74,125
https://kawalpemilu.org#51673,"BULAGOR, PAGELARAN, PANDEGLANG, BANTEN",4,46,83,129
https://kawalpemilu.org#51673,"BULAGOR, PAGELARAN, PANDEGLANG, BANTEN",5,51,69,120
https://kawalpemilu.org#51673,"BULAGOR, PAGELARAN, PANDEGLANG, BANTEN",6,88,101,189
https://kawalpemilu.org#51673,"BULAGOR, PAGELARAN, PANDEGLANG, BANTEN",7,118,78,196
https://kawalpemilu.org#51673,"BULAGOR, PAGELARAN, PANDEGLANG, BANTEN",8,62,81,143
https://kawalpemilu.org#51673,"BULAGOR, PAGELARAN, PANDEGLANG, BANTEN",9,97,63,160
https://kawalpemilu.org#51673,"BULAGOR, PAGELARAN, PANDEGLANG, BANTEN",11,29,113,142
https://kawalpemilu.org#51674,"HARAPANKARYA, PAGELARAN, PANDEGLANG, BANTEN",1,45,125,170
https://kawalpemilu.org#51674,"HARAPANKARYA, PAGELARAN, PANDEGLANG, BANTEN",2,81,106,187
https://kawalpemilu.org#51674,"HARAPANKARYA, PAGELARAN, PANDEGLANG, BANTEN",3,71,95,166
https://kawalpemilu.org#51674,"HARAPANKARYA, PAGELARAN, PANDEGLANG, BANTEN",4,84,125,209
https://kawalpemilu.org#51674,"HARAPANKARYA, PAGELARAN, PANDEGLANG, BANTEN",5,60,64,124
https://kawalpemilu.org#51674,"HARAPANKARYA, PAGELARAN, PANDEGLANG, BANTEN",6,33,102,135
https://kawalpemilu.org#51675,"SENANGSARI, PAGELARAN, PANDEGLANG, BANTEN",1,87,60,147
https://kawalpemilu.org#51675,"SENANGSARI, PAGELARAN, PANDEGLANG, BANTEN",2,60,110,170
https://kawalpemilu.org#51675,"SENANGSARI, PAGELARAN, PANDEGLANG, BANTEN",3,54,100,154
https://kawalpemilu.org#51675,"SENANGSARI, PAGELARAN, PANDEGLANG, BANTEN",4,45,159,204
https://kawalpemilu.org#51675,"SENANGSARI, PAGELARAN, PANDEGLANG, BANTEN",5,55,150,205
https://kawalpemilu.org#51675,"SENANGSARI, PAGELARAN, PANDEGLANG, BANTEN",6,76,129,205
https://kawalpemilu.org#51675,"SENANGSARI, PAGELARAN, PANDEGLANG, BANTEN",7,78,150,228
https://kawalpemilu.org#51675,"SENANGSARI, PAGELARAN, PANDEGLANG, BANTEN",8,94,144,238
https://kawalpemilu.org#51676,"MARGAGIRI, PAGELARAN, PANDEGLANG, BANTEN",1,71,158,229
https://kawalpemilu.org#51676,"MARGAGIRI, PAGELARAN, PANDEGLANG, BANTEN",2,34,171,205
https://kawalpemilu.org#51676,"MARGAGIRI, PAGELARAN, PANDEGLANG, BANTEN",3,41,144,185
https://kawalpemilu.org#51676,"MARGAGIRI, PAGELARAN, PANDEGLANG, BANTEN",4,53,116,169
https://kawalpemilu.org#51676,"MARGAGIRI, PAGELARAN, PANDEGLANG, BANTEN",5,40,147,187
https://kawalpemilu.org#51676,"MARGAGIRI, PAGELARAN, PANDEGLANG, BANTEN",6,45,133,178
https://kawalpemilu.org#51676,"MARGAGIRI, PAGELARAN, PANDEGLANG, BANTEN",7,38,107,145
https://kawalpemilu.org#51676,"MARGAGIRI, PAGELARAN, PANDEGLANG, BANTEN",8,65,107,172
https://kawalpemilu.org#51676,"MARGAGIRI, PAGELARAN, PANDEGLANG, BANTEN",9,43,112,155
https://kawalpemilu.org#51676,"MARGAGIRI, PAGELARAN, PANDEGLANG, BANTEN",10,89,98,187
https://kawalpemilu.org#51676,"MARGAGIRI, PAGELARAN, PANDEGLANG, BANTEN",11,61,95,156
https://kawalpemilu.org#51676,"MARGAGIRI, PAGELARAN, PANDEGLANG, BANTEN",12,80,85,165
https://kawalpemilu.org#51676,"MARGAGIRI, PAGELARAN, PANDEGLANG, BANTEN",13,117,70,187
https://kawalpemilu.org#51676,"MARGAGIRI, PAGELARAN, PANDEGLANG, BANTEN",14,139,67,206
https://kawalpemilu.org#51678,"MEKARSARI, BOJONG, PANDEGLANG, BANTEN",1,24,212,236
https://kawalpemilu.org#51678,"MEKARSARI, BOJONG, PANDEGLANG, BANTEN",2,40,162,202
https://kawalpemilu.org#51678,"MEKARSARI, BOJONG, PANDEGLANG, BANTEN",3,48,164,212
https://kawalpemilu.org#51678,"MEKARSARI, BOJONG, PANDEGLANG, BANTEN",4,62,124,186
https://kawalpemilu.org#51678,"MEKARSARI, BOJONG, PANDEGLANG, BANTEN",5,59,153,212
https://kawalpemilu.org#51678,"MEKARSARI, BOJONG, PANDEGLANG, BANTEN",6,58,138,196
https://kawalpemilu.org#51678,"MEKARSARI, BOJONG, PANDEGLANG, BANTEN",7,51,127,178
https://kawalpemilu.org#51678,"MEKARSARI, BOJONG, PANDEGLANG, BANTEN",8,36,115,151
https://kawalpemilu.org#51678,"MEKARSARI, BOJONG, PANDEGLANG, BANTEN",9,48,99,147
https://kawalpemilu.org#51678,"MEKARSARI, BOJONG, PANDEGLANG, BANTEN",10,46,143,189
https://kawalpemilu.org#51678,"MEKARSARI, BOJONG, PANDEGLANG, BANTEN",11,70,101,171
https://kawalpemilu.org#51678,"MEKARSARI, BOJONG, PANDEGLANG, BANTEN",12,121,52,178
https://kawalpemilu.org#51678,"MEKARSARI, BOJONG, PANDEGLANG, BANTEN",13,71,79,150
https://kawalpemilu.org#51678,"MEKARSARI, BOJONG, PANDEGLANG, BANTEN",14,53,118,171
https://kawalpemilu.org#51678,"MEKARSARI, BOJONG, PANDEGLANG, BANTEN",15,54,99,153
https://kawalpemilu.org#51679,"CIJAKAN, BOJONG, PANDEGLANG, BANTEN",1,56,161,217
https://kawalpemilu.org#51679,"CIJAKAN, BOJONG, PANDEGLANG, BANTEN",2,69,115,184
https://kawalpemilu.org#51679,"CIJAKAN, BOJONG, PANDEGLANG, BANTEN",3,47,182,229
https://kawalpemilu.org#51679,"CIJAKAN, BOJONG, PANDEGLANG, BANTEN",4,98,112,210
https://kawalpemilu.org#51679,"CIJAKAN, BOJONG, PANDEGLANG, BANTEN",5,86,113,199
https://kawalpemilu.org#51679,"CIJAKAN, BOJONG, PANDEGLANG, BANTEN",6,76,126,202
https://kawalpemilu.org#51679,"CIJAKAN, BOJONG, PANDEGLANG, BANTEN",7,89,123,212
https://kawalpemilu.org#51679,"CIJAKAN, BOJONG, PANDEGLANG, BANTEN",8,78,146,224
https://kawalpemilu.org#51679,"CIJAKAN, BOJONG, PANDEGLANG, BANTEN",9,97,135,232
https://kawalpemilu.org#51680,"GEREDUG, BOJONG, PANDEGLANG, BANTEN",1,79,152,231
https://kawalpemilu.org#51680,"GEREDUG, BOJONG, PANDEGLANG, BANTEN",2,31,150,181
https://kawalpemilu.org#51680,"GEREDUG, BOJONG, PANDEGLANG, BANTEN",3,40,152,192
https://kawalpemilu.org#51680,"GEREDUG, BOJONG, PANDEGLANG, BANTEN",4,36,175,211
https://kawalpemilu.org#51680,"GEREDUG, BOJONG, PANDEGLANG, BANTEN",5,42,137,179
https://kawalpemilu.org#51680,"GEREDUG, BOJONG, PANDEGLANG, BANTEN",6,29,168,197
https://kawalpemilu.org#51680,"GEREDUG, BOJONG, PANDEGLANG, BANTEN",7,33,162,195
https://kawalpemilu.org#51680,"GEREDUG, BOJONG, PANDEGLANG, BANTEN",8,58,162,220
https://kawalpemilu.org#51680,"GEREDUG, BOJONG, PANDEGLANG, BANTEN",9,56,162,218
https://kawalpemilu.org#51681,"BOJONG, BOJONG, PANDEGLANG, BANTEN",1,38,178,216
https://kawalpemilu.org#51681,"BOJONG, BOJONG, PANDEGLANG, BANTEN",2,49,149,195
https://kawalpemilu.org#51681,"BOJONG, BOJONG, PANDEGLANG, BANTEN",3,76,109,185
https://kawalpemilu.org#51681,"BOJONG, BOJONG, PANDEGLANG, BANTEN",4,71,146,217
https://kawalpemilu.org#51681,"BOJONG, BOJONG, PANDEGLANG, BANTEN",5,88,121,209
https://kawalpemilu.org#51681,"BOJONG, BOJONG, PANDEGLANG, BANTEN",6,76,115,191
https://kawalpemilu.org#51681,"BOJONG, BOJONG, PANDEGLANG, BANTEN",7,60,106,166
https://kawalpemilu.org#51681,"BOJONG, BOJONG, PANDEGLANG, BANTEN",8,48,99,147
https://kawalpemilu.org#51681,"BOJONG, BOJONG, PANDEGLANG, BANTEN",9,47,200,247
https://kawalpemilu.org#51681,"BOJONG, BOJONG, PANDEGLANG, BANTEN",10,57,150,207
https://kawalpemilu.org#51681,"BOJONG, BOJONG, PANDEGLANG, BANTEN",11,88,111,199
https://kawalpemilu.org#51681,"BOJONG, BOJONG, PANDEGLANG, BANTEN",12,112,111,223
https://kawalpemilu.org#51681,"BOJONG, BOJONG, PANDEGLANG, BANTEN",13,72,140,212
https://kawalpemilu.org#51681,"BOJONG, BOJONG, PANDEGLANG, BANTEN",14,71,135,206
https://kawalpemilu.org#51681,"BOJONG, BOJONG, PANDEGLANG, BANTEN",15,84,73,157
https://kawalpemilu.org#51681,"BOJONG, BOJONG, PANDEGLANG, BANTEN",16,65,134,199
https://kawalpemilu.org#51681,"BOJONG, BOJONG, PANDEGLANG, BANTEN",17,69,124,193
https://kawalpemilu.org#51681,"BOJONG, BOJONG, PANDEGLANG, BANTEN",18,67,132,199
https://kawalpemilu.org#51681,"BOJONG, BOJONG, PANDEGLANG, BANTEN",19,102,113,215
https://kawalpemilu.org#51681,"BOJONG, BOJONG, PANDEGLANG, BANTEN",20,48,99,147
https://kawalpemilu.org#51681,"BOJONG, BOJONG, PANDEGLANG, BANTEN",21,44,144,188
https://kawalpemilu.org#51681,"BOJONG, BOJONG, PANDEGLANG, BANTEN",22,27,132,159
https://kawalpemilu.org#51681,"BOJONG, BOJONG, PANDEGLANG, BANTEN",23,32,123,155
https://kawalpemilu.org#51682,"BANYUMAS, BOJONG, PANDEGLANG, BANTEN",1,54,117,171
https://kawalpemilu.org#51682,"BANYUMAS, BOJONG, PANDEGLANG, BANTEN",2,78,130,208
https://kawalpemilu.org#51682,"BANYUMAS, BOJONG, PANDEGLANG, BANTEN",3,69,125,194
https://kawalpemilu.org#51682,"BANYUMAS, BOJONG, PANDEGLANG, BANTEN",4,75,96,171
https://kawalpemilu.org#51682,"BANYUMAS, BOJONG, PANDEGLANG, BANTEN",5,57,160,217
https://kawalpemilu.org#51682,"BANYUMAS, BOJONG, PANDEGLANG, BANTEN",6,73,119,192
https://kawalpemilu.org#51682,"BANYUMAS, BOJONG, PANDEGLANG, BANTEN",7,57,137,194
https://kawalpemilu.org#51682,"BANYUMAS, BOJONG, PANDEGLANG, BANTEN",8,62,106,168
https://kawalpemilu.org#51682,"BANYUMAS, BOJONG, PANDEGLANG, BANTEN",9,42,108,150
https://kawalpemilu.org#51682,"BANYUMAS, BOJONG, PANDEGLANG, BANTEN",10,68,93,161
https://kawalpemilu.org#51682,"BANYUMAS, BOJONG, PANDEGLANG, BANTEN",11,57,101,158
https://kawalpemilu.org#51682,"BANYUMAS, BOJONG, PANDEGLANG, BANTEN",12,90,104,194
https://kawalpemilu.org#51683,"CITUMENGGUNG, BOJONG, PANDEGLANG, BANTEN",1,66,150,216
https://kawalpemilu.org#51683,"CITUMENGGUNG, BOJONG, PANDEGLANG, BANTEN",2,46,134,180
https://kawalpemilu.org#51683,"CITUMENGGUNG, BOJONG, PANDEGLANG, BANTEN",3,66,145,211
https://kawalpemilu.org#51683,"CITUMENGGUNG, BOJONG, PANDEGLANG, BANTEN",4,22,207,229
https://kawalpemilu.org#51683,"CITUMENGGUNG, BOJONG, PANDEGLANG, BANTEN",5,19,189,208
https://kawalpemilu.org#51683,"CITUMENGGUNG, BOJONG, PANDEGLANG, BANTEN",6,49,170,219
https://kawalpemilu.org#51683,"CITUMENGGUNG, BOJONG, PANDEGLANG, BANTEN",7,17,165,182
https://kawalpemilu.org#51683,"CITUMENGGUNG, BOJONG, PANDEGLANG, BANTEN",8,25,157,182
https://kawalpemilu.org#51683,"CITUMENGGUNG, BOJONG, PANDEGLANG, BANTEN",9,59,139,198
https://kawalpemilu.org#51683,"CITUMENGGUNG, BOJONG, PANDEGLANG, BANTEN",10,56,131,187
https://kawalpemilu.org#51683,"CITUMENGGUNG, BOJONG, PANDEGLANG, BANTEN",11,23,135,158
https://kawalpemilu.org#51683,"CITUMENGGUNG, BOJONG, PANDEGLANG, BANTEN",12,55,129,184
https://kawalpemilu.org#51684,"MANGGUNGJAYA, BOJONG, PANDEGLANG, BANTEN",1,48,159,207
https://kawalpemilu.org#51684,"MANGGUNGJAYA, BOJONG, PANDEGLANG, BANTEN",2,51,169,220
https://kawalpemilu.org#51684,"MANGGUNGJAYA, BOJONG, PANDEGLANG, BANTEN",3,73,143,216
https://kawalpemilu.org#51684,"MANGGUNGJAYA, BOJONG, PANDEGLANG, BANTEN",4,50,167,217
https://kawalpemilu.org#51684,"MANGGUNGJAYA, BOJONG, PANDEGLANG, BANTEN",5,78,110,188
https://kawalpemilu.org#51684,"MANGGUNGJAYA, BOJONG, PANDEGLANG, BANTEN",6,30,156,186
https://kawalpemilu.org#51684,"MANGGUNGJAYA, BOJONG, PANDEGLANG, BANTEN",7,72,132,204
https://kawalpemilu.org#51684,"MANGGUNGJAYA, BOJONG, PANDEGLANG, BANTEN",8,88,100,188
https://kawalpemilu.org#51684,"MANGGUNGJAYA, BOJONG, PANDEGLANG, BANTEN",9,66,110,176
https://kawalpemilu.org#51684,"MANGGUNGJAYA, BOJONG, PANDEGLANG, BANTEN",10,61,121,182
https://kawalpemilu.org#51685,"CAHAYAMEKAR, BOJONG, PANDEGLANG, BANTEN",1,39,116,155
https://kawalpemilu.org#51685,"CAHAYAMEKAR, BOJONG, PANDEGLANG, BANTEN",2,33,136,169
https://kawalpemilu.org#51685,"CAHAYAMEKAR, BOJONG, PANDEGLANG, BANTEN",3,53,152,205
https://kawalpemilu.org#51685,"CAHAYAMEKAR, BOJONG, PANDEGLANG, BANTEN",4,63,134,197
https://kawalpemilu.org#51685,"CAHAYAMEKAR, BOJONG, PANDEGLANG, BANTEN",5,36,111,147
https://kawalpemilu.org#51685,"CAHAYAMEKAR, BOJONG, PANDEGLANG, BANTEN",6,43,84,127
https://kawalpemilu.org#51685,"CAHAYAMEKAR, BOJONG, PANDEGLANG, BANTEN",7,87,142,229
https://kawalpemilu.org#51685,"CAHAYAMEKAR, BOJONG, PANDEGLANG, BANTEN",8,31,112,143
https://kawalpemilu.org#51685,"CAHAYAMEKAR, BOJONG, PANDEGLANG, BANTEN",9,66,122,188
https://kawalpemilu.org#51685,"CAHAYAMEKAR, BOJONG, PANDEGLANG, BANTEN",10,62,190,252
https://kawalpemilu.org#51685,"CAHAYAMEKAR, BOJONG, PANDEGLANG, BANTEN",11,59,157,216
https://kawalpemilu.org#51685,"CAHAYAMEKAR, BOJONG, PANDEGLANG, BANTEN",12,56,126,182
https://kawalpemilu.org#51687,"PASIRSEDANG, PICUNG, PANDEGLANG, BANTEN",1,75,128,203
https://kawalpemilu.org#51687,"PASIRSEDANG, PICUNG, PANDEGLANG, BANTEN",2,51,113,164
https://kawalpemilu.org#51687,"PASIRSEDANG, PICUNG, PANDEGLANG, BANTEN",3,96,118,214
https://kawalpemilu.org#51687,"PASIRSEDANG, PICUNG, PANDEGLANG, BANTEN",4,110,79,189
https://kawalpemilu.org#51687,"PASIRSEDANG, PICUNG, PANDEGLANG, BANTEN",5,64,106,170
https://kawalpemilu.org#51687,"PASIRSEDANG, PICUNG, PANDEGLANG, BANTEN",6,54,166,220
https://kawalpemilu.org#51687,"PASIRSEDANG, PICUNG, PANDEGLANG, BANTEN",7,76,124,200
https://kawalpemilu.org#51687,"PASIRSEDANG, PICUNG, PANDEGLANG, BANTEN",8,48,131,179
https://kawalpemilu.org#51687,"PASIRSEDANG, PICUNG, PANDEGLANG, BANTEN",9,45,172,217
https://kawalpemilu.org#51687,"PASIRSEDANG, PICUNG, PANDEGLANG, BANTEN",10,35,175,210
https://kawalpemilu.org#51687,"PASIRSEDANG, PICUNG, PANDEGLANG, BANTEN",11,96,94,190
https://kawalpemilu.org#51687,"PASIRSEDANG, PICUNG, PANDEGLANG, BANTEN",12,62,82,144
https://kawalpemilu.org#51687,"PASIRSEDANG, PICUNG, PANDEGLANG, BANTEN",13,45,155,200
https://kawalpemilu.org#51687,"PASIRSEDANG, PICUNG, PANDEGLANG, BANTEN",14,31,90,121
https://kawalpemilu.org#51687,"PASIRSEDANG, PICUNG, PANDEGLANG, BANTEN",15,57,123,180
https://kawalpemilu.org#51687,"PASIRSEDANG, PICUNG, PANDEGLANG, BANTEN",16,123,88,211
https://kawalpemilu.org#51687,"PASIRSEDANG, PICUNG, PANDEGLANG, BANTEN",17,55,149,204
https://kawalpemilu.org#51688,"CILILITAN, PICUNG, PANDEGLANG, BANTEN",1,109,83,192
https://kawalpemilu.org#51688,"CILILITAN, PICUNG, PANDEGLANG, BANTEN",2,20,102,122
https://kawalpemilu.org#51688,"CILILITAN, PICUNG, PANDEGLANG, BANTEN",3,31,150,181
https://kawalpemilu.org#51688,"CILILITAN, PICUNG, PANDEGLANG, BANTEN",4,37,137,174
https://kawalpemilu.org#51688,"CILILITAN, PICUNG, PANDEGLANG, BANTEN",5,85,140,225
https://kawalpemilu.org#51688,"CILILITAN, PICUNG, PANDEGLANG, BANTEN",6,37,203,240
https://kawalpemilu.org#51688,"CILILITAN, PICUNG, PANDEGLANG, BANTEN",7,40,139,179
https://kawalpemilu.org#51688,"CILILITAN, PICUNG, PANDEGLANG, BANTEN",8,64,150,214
https://kawalpemilu.org#51688,"CILILITAN, PICUNG, PANDEGLANG, BANTEN",9,99,149,248
https://kawalpemilu.org#51688,"CILILITAN, PICUNG, PANDEGLANG, BANTEN",10,79,95,174
https://kawalpemilu.org#51688,"CILILITAN, PICUNG, PANDEGLANG, BANTEN",11,114,94,208
https://kawalpemilu.org#51688,"CILILITAN, PICUNG, PANDEGLANG, BANTEN",12,146,65,211
https://kawalpemilu.org#51688,"CILILITAN, PICUNG, PANDEGLANG, BANTEN",13,102,114,216
https://kawalpemilu.org#51688,"CILILITAN, PICUNG, PANDEGLANG, BANTEN",14,72,127,199
https://kawalpemilu.org#51688,"CILILITAN, PICUNG, PANDEGLANG, BANTEN",15,134,27,161
https://kawalpemilu.org#51689,"KADUPANDAK, PICUNG, PANDEGLANG, BANTEN",1,101,108,209
https://kawalpemilu.org#51689,"KADUPANDAK, PICUNG, PANDEGLANG, BANTEN",2,113,120,233
https://kawalpemilu.org#51689,"KADUPANDAK, PICUNG, PANDEGLANG, BANTEN",3,57,118,175
https://kawalpemilu.org#51689,"KADUPANDAK, PICUNG, PANDEGLANG, BANTEN",4,82,109,191
https://kawalpemilu.org#51689,"KADUPANDAK, PICUNG, PANDEGLANG, BANTEN",5,95,103,198
https://kawalpemilu.org#51689,"KADUPANDAK, PICUNG, PANDEGLANG, BANTEN",6,91,82,173
https://kawalpemilu.org#51689,"KADUPANDAK, PICUNG, PANDEGLANG, BANTEN",7,52,109,161
https://kawalpemilu.org#51689,"KADUPANDAK, PICUNG, PANDEGLANG, BANTEN",8,64,122,186
https://kawalpemilu.org#51689,"KADUPANDAK, PICUNG, PANDEGLANG, BANTEN",9,105,94,199
https://kawalpemilu.org#51689,"KADUPANDAK, PICUNG, PANDEGLANG, BANTEN",10,76,97,173
https://kawalpemilu.org#51689,"KADUPANDAK, PICUNG, PANDEGLANG, BANTEN",11,24,99,123
https://kawalpemilu.org#51689,"KADUPANDAK, PICUNG, PANDEGLANG, BANTEN",12,14,101,115
https://kawalpemilu.org#51690,"KOLELET, PICUNG, PANDEGLANG, BANTEN",1,47,144,191
https://kawalpemilu.org#51690,"KOLELET, PICUNG, PANDEGLANG, BANTEN",2,59,102,161
https://kawalpemilu.org#51690,"KOLELET, PICUNG, PANDEGLANG, BANTEN",3,94,77,171
https://kawalpemilu.org#51690,"KOLELET, PICUNG, PANDEGLANG, BANTEN",4,50,97,147
https://kawalpemilu.org#51690,"KOLELET, PICUNG, PANDEGLANG, BANTEN",5,72,106,178
https://kawalpemilu.org#51690,"KOLELET, PICUNG, PANDEGLANG, BANTEN",6,54,105,159
https://kawalpemilu.org#51690,"KOLELET, PICUNG, PANDEGLANG, BANTEN",7,96,56,152
https://kawalpemilu.org#51690,"KOLELET, PICUNG, PANDEGLANG, BANTEN",8,59,143,202
https://kawalpemilu.org#51690,"KOLELET, PICUNG, PANDEGLANG, BANTEN",9,57,131,188
https://kawalpemilu.org#51690,"KOLELET, PICUNG, PANDEGLANG, BANTEN",10,82,86,168
https://kawalpemilu.org#51690,"KOLELET, PICUNG, PANDEGLANG, BANTEN",11,79,95,174
https://kawalpemilu.org#51690,"KOLELET, PICUNG, PANDEGLANG, BANTEN",12,85,93,178
https://kawalpemilu.org#51690,"KOLELET, PICUNG, PANDEGLANG, BANTEN",13,71,125,196
https://kawalpemilu.org#51690,"KOLELET, PICUNG, PANDEGLANG, BANTEN",14,80,17,97
https://kawalpemilu.org#51691,"CIHERANG, PICUNG, PANDEGLANG, BANTEN",1,22,141,163
https://kawalpemilu.org#51691,"CIHERANG, PICUNG, PANDEGLANG, BANTEN",2,26,147,173
https://kawalpemilu.org#51691,"CIHERANG, PICUNG, PANDEGLANG, BANTEN",3,57,149,206
https://kawalpemilu.org#51691,"CIHERANG, PICUNG, PANDEGLANG, BANTEN",4,67,133,200
https://kawalpemilu.org#51691,"CIHERANG, PICUNG, PANDEGLANG, BANTEN",5,88,114,202
https://kawalpemilu.org#51691,"CIHERANG, PICUNG, PANDEGLANG, BANTEN",6,62,119,181
https://kawalpemilu.org#51691,"CIHERANG, PICUNG, PANDEGLANG, BANTEN",7,48,117,165
https://kawalpemilu.org#51691,"CIHERANG, PICUNG, PANDEGLANG, BANTEN",8,45,131,176
https://kawalpemilu.org#51691,"CIHERANG, PICUNG, PANDEGLANG, BANTEN",9,84,136,220
https://kawalpemilu.org#51691,"CIHERANG, PICUNG, PANDEGLANG, BANTEN",10,143,43,186
https://kawalpemilu.org#51691,"CIHERANG, PICUNG, PANDEGLANG, BANTEN",11,86,65,151
https://kawalpemilu.org#51691,"CIHERANG, PICUNG, PANDEGLANG, BANTEN",12,40,88,128
https://kawalpemilu.org#51691,"CIHERANG, PICUNG, PANDEGLANG, BANTEN",13,59,133,192
https://kawalpemilu.org#51691,"CIHERANG, PICUNG, PANDEGLANG, BANTEN",14,80,62,142
https://kawalpemilu.org#51692,"BUNGURCOPONG, PICUNG, PANDEGLANG, BANTEN",1,61,155,216
https://kawalpemilu.org#51692,"BUNGURCOPONG, PICUNG, PANDEGLANG, BANTEN",2,94,125,219
https://kawalpemilu.org#51692,"BUNGURCOPONG, PICUNG, PANDEGLANG, BANTEN",3,126,74,200
https://kawalpemilu.org#51692,"BUNGURCOPONG, PICUNG, PANDEGLANG, BANTEN",4,97,54,151
https://kawalpemilu.org#51692,"BUNGURCOPONG, PICUNG, PANDEGLANG, BANTEN",5,60,95,155
https://kawalpemilu.org#51692,"BUNGURCOPONG, PICUNG, PANDEGLANG, BANTEN",6,37,82,119
https://kawalpemilu.org#51692,"BUNGURCOPONG, PICUNG, PANDEGLANG, BANTEN",7,54,131,185
https://kawalpemilu.org#51692,"BUNGURCOPONG, PICUNG, PANDEGLANG, BANTEN",8,65,107,172
https://kawalpemilu.org#51692,"BUNGURCOPONG, PICUNG, PANDEGLANG, BANTEN",9,48,100,148
https://kawalpemilu.org#51693,"PASIRPANJANG, PICUNG, PANDEGLANG, BANTEN",1,33,124,157
https://kawalpemilu.org#51693,"PASIRPANJANG, PICUNG, PANDEGLANG, BANTEN",2,57,160,217
https://kawalpemilu.org#51693,"PASIRPANJANG, PICUNG, PANDEGLANG, BANTEN",3,90,82,172
https://kawalpemilu.org#51693,"PASIRPANJANG, PICUNG, PANDEGLANG, BANTEN",4,84,90,174
https://kawalpemilu.org#51693,"PASIRPANJANG, PICUNG, PANDEGLANG, BANTEN",5,59,79,138
https://kawalpemilu.org#51693,"PASIRPANJANG, PICUNG, PANDEGLANG, BANTEN",6,73,55,128
https://kawalpemilu.org#51693,"PASIRPANJANG, PICUNG, PANDEGLANG, BANTEN",7,80,36,116
https://kawalpemilu.org#51693,"PASIRPANJANG, PICUNG, PANDEGLANG, BANTEN",8,46,98,144
https://kawalpemilu.org#51693,"PASIRPANJANG, PICUNG, PANDEGLANG, BANTEN",9,39,97,136
https://kawalpemilu.org#51694,"KADUBERA, PICUNG, PANDEGLANG, BANTEN",1,91,87,178
https://kawalpemilu.org#51694,"KADUBERA, PICUNG, PANDEGLANG, BANTEN",2,78,54,132
https://kawalpemilu.org#51694,"KADUBERA, PICUNG, PANDEGLANG, BANTEN",3,67,99,166
https://kawalpemilu.org#51694,"KADUBERA, PICUNG, PANDEGLANG, BANTEN",4,85,97,182
https://kawalpemilu.org#51694,"KADUBERA, PICUNG, PANDEGLANG, BANTEN",5,91,87,178
https://kawalpemilu.org#51694,"KADUBERA, PICUNG, PANDEGLANG, BANTEN",6,107,103,210
https://kawalpemilu.org#51694,"KADUBERA, PICUNG, PANDEGLANG, BANTEN",7,80,82,162
https://kawalpemilu.org#51694,"KADUBERA, PICUNG, PANDEGLANG, BANTEN",8,64,49,113
https://kawalpemilu.org#51694,"KADUBERA, PICUNG, PANDEGLANG, BANTEN",9,126,70,196
https://kawalpemilu.org#51694,"KADUBERA, PICUNG, PANDEGLANG, BANTEN",10,134,87,221
https://kawalpemilu.org#51694,"KADUBERA, PICUNG, PANDEGLANG, BANTEN",11,111,119,230
https://kawalpemilu.org#51694,"KADUBERA, PICUNG, PANDEGLANG, BANTEN",12,70,99,169
https://kawalpemilu.org#51694,"KADUBERA, PICUNG, PANDEGLANG, BANTEN",13,71,98,169
https://kawalpemilu.org#51694,"KADUBERA, PICUNG, PANDEGLANG, BANTEN",14,56,126,180
https://kawalpemilu.org#51694,"KADUBERA, PICUNG, PANDEGLANG, BANTEN",15,52,101,153
https://kawalpemilu.org#51694,"KADUBERA, PICUNG, PANDEGLANG, BANTEN",16,111,119,230
https://kawalpemilu.org#51694,"KADUBERA, PICUNG, PANDEGLANG, BANTEN",17,79,63,142
https://kawalpemilu.org#84967,"GANGGAENG, PICUNG, PANDEGLANG, BANTEN",1,96,57,153
https://kawalpemilu.org#84967,"GANGGAENG, PICUNG, PANDEGLANG, BANTEN",2,93,48,141
https://kawalpemilu.org#84967,"GANGGAENG, PICUNG, PANDEGLANG, BANTEN",3,79,49,128
https://kawalpemilu.org#84967,"GANGGAENG, PICUNG, PANDEGLANG, BANTEN",4,72,88,160
https://kawalpemilu.org#84967,"GANGGAENG, PICUNG, PANDEGLANG, BANTEN",5,51,95,146
https://kawalpemilu.org#84967,"GANGGAENG, PICUNG, PANDEGLANG, BANTEN",6,41,100,141
https://kawalpemilu.org#84967,"GANGGAENG, PICUNG, PANDEGLANG, BANTEN",7,40,147,187
https://kawalpemilu.org#84967,"GANGGAENG, PICUNG, PANDEGLANG, BANTEN",8,51,105,156
https://kawalpemilu.org#51696,"RANCATEUREUP, LABUAN, PANDEGLANG, BANTEN",1,51,130,181
https://kawalpemilu.org#51696,"RANCATEUREUP, LABUAN, PANDEGLANG, BANTEN",2,77,144,221
https://kawalpemilu.org#51696,"RANCATEUREUP, LABUAN, PANDEGLANG, BANTEN",3,69,120,189
https://kawalpemilu.org#51696,"RANCATEUREUP, LABUAN, PANDEGLANG, BANTEN",4,106,136,242
https://kawalpemilu.org#51696,"RANCATEUREUP, LABUAN, PANDEGLANG, BANTEN",5,59,161,220
https://kawalpemilu.org#51696,"RANCATEUREUP, LABUAN, PANDEGLANG, BANTEN",6,51,105,156
https://kawalpemilu.org#51696,"RANCATEUREUP, LABUAN, PANDEGLANG, BANTEN",7,70,113,183
https://kawalpemilu.org#51696,"RANCATEUREUP, LABUAN, PANDEGLANG, BANTEN",8,87,146,233
https://kawalpemilu.org#51697,"LABUAN, LABUAN, PANDEGLANG, BANTEN",1,92,148,240
https://kawalpemilu.org#51697,"LABUAN, LABUAN, PANDEGLANG, BANTEN",2,71,107,178
https://kawalpemilu.org#51697,"LABUAN, LABUAN, PANDEGLANG, BANTEN",3,112,113,225
https://kawalpemilu.org#51697,"LABUAN, LABUAN, PANDEGLANG, BANTEN",4,44,90,134
https://kawalpemilu.org#51697,"LABUAN, LABUAN, PANDEGLANG, BANTEN",5,101,70,171
https://kawalpemilu.org#51697,"LABUAN, LABUAN, PANDEGLANG, BANTEN",6,50,158,208
https://kawalpemilu.org#51697,"LABUAN, LABUAN, PANDEGLANG, BANTEN",7,55,110,165
https://kawalpemilu.org#51697,"LABUAN, LABUAN, PANDEGLANG, BANTEN",8,73,159,232
https://kawalpemilu.org#51697,"LABUAN, LABUAN, PANDEGLANG, BANTEN",9,65,136,201
https://kawalpemilu.org#51697,"LABUAN, LABUAN, PANDEGLANG, BANTEN",10,74,119,193
https://kawalpemilu.org#51697,"LABUAN, LABUAN, PANDEGLANG, BANTEN",11,63,139,202
https://kawalpemilu.org#51697,"LABUAN, LABUAN, PANDEGLANG, BANTEN",12,74,131,205
https://kawalpemilu.org#51697,"LABUAN, LABUAN, PANDEGLANG, BANTEN",13,97,102,199
https://kawalpemilu.org#51697,"LABUAN, LABUAN, PANDEGLANG, BANTEN",14,77,128,205
https://kawalpemilu.org#51697,"LABUAN, LABUAN, PANDEGLANG, BANTEN",15,82,131,213
https://kawalpemilu.org#51697,"LABUAN, LABUAN, PANDEGLANG, BANTEN",16,83,126,209
https://kawalpemilu.org#51697,"LABUAN, LABUAN, PANDEGLANG, BANTEN",17,74,137,211
https://kawalpemilu.org#51697,"LABUAN, LABUAN, PANDEGLANG, BANTEN",18,98,118,216
https://kawalpemilu.org#51697,"LABUAN, LABUAN, PANDEGLANG, BANTEN",19,81,108,189
https://kawalpemilu.org#51697,"LABUAN, LABUAN, PANDEGLANG, BANTEN",20,32,159,191
https://kawalpemilu.org#51697,"LABUAN, LABUAN, PANDEGLANG, BANTEN",21,89,124,213
https://kawalpemilu.org#51697,"LABUAN, LABUAN, PANDEGLANG, BANTEN",22,62,144,206
https://kawalpemilu.org#51697,"LABUAN, LABUAN, PANDEGLANG, BANTEN",23,31,153,184
https://kawalpemilu.org#51697,"LABUAN, LABUAN, PANDEGLANG, BANTEN",24,52,162,214
https://kawalpemilu.org#51697,"LABUAN, LABUAN, PANDEGLANG, BANTEN",25,51,95,146
https://kawalpemilu.org#51697,"LABUAN, LABUAN, PANDEGLANG, BANTEN",26,101,129,230
https://kawalpemilu.org#51697,"LABUAN, LABUAN, PANDEGLANG, BANTEN",27,80,113,193
https://kawalpemilu.org#51697,"LABUAN, LABUAN, PANDEGLANG, BANTEN",28,62,77,139
https://kawalpemilu.org#51697,"LABUAN, LABUAN, PANDEGLANG, BANTEN",29,77,105,185
https://kawalpemilu.org#51697,"LABUAN, LABUAN, PANDEGLANG, BANTEN",30,54,112,166
https://kawalpemilu.org#51697,"LABUAN, LABUAN, PANDEGLANG, BANTEN",31,79,118,197
https://kawalpemilu.org#51697,"LABUAN, LABUAN, PANDEGLANG, BANTEN",32,56,182,238
https://kawalpemilu.org#51698,"BANYUBIRU, LABUAN, PANDEGLANG, BANTEN",2,90,88,178
https://kawalpemilu.org#51698,"BANYUBIRU, LABUAN, PANDEGLANG, BANTEN",3,67,77,144
https://kawalpemilu.org#51698,"BANYUBIRU, LABUAN, PANDEGLANG, BANTEN",4,66,94,160
https://kawalpemilu.org#51698,"BANYUBIRU, LABUAN, PANDEGLANG, BANTEN",5,40,145,185
https://kawalpemilu.org#51698,"BANYUBIRU, LABUAN, PANDEGLANG, BANTEN",6,89,100,189
https://kawalpemilu.org#51698,"BANYUBIRU, LABUAN, PANDEGLANG, BANTEN",8,36,153,189
https://kawalpemilu.org#51699,"CARINGIN, LABUAN, PANDEGLANG, BANTEN",1,95,104,199
https://kawalpemilu.org#51699,"CARINGIN, LABUAN, PANDEGLANG, BANTEN",2,96,105,201
https://kawalpemilu.org#51699,"CARINGIN, LABUAN, PANDEGLANG, BANTEN",3,89,103,192
https://kawalpemilu.org#51699,"CARINGIN, LABUAN, PANDEGLANG, BANTEN",4,85,85,170
https://kawalpemilu.org#51699,"CARINGIN, LABUAN, PANDEGLANG, BANTEN",5,78,97,175
https://kawalpemilu.org#51699,"CARINGIN, LABUAN, PANDEGLANG, BANTEN",6,102,57,159
https://kawalpemilu.org#51699,"CARINGIN, LABUAN, PANDEGLANG, BANTEN",7,80,118,198
https://kawalpemilu.org#51699,"CARINGIN, LABUAN, PANDEGLANG, BANTEN",8,90,123,213
https://kawalpemilu.org#51699,"CARINGIN, LABUAN, PANDEGLANG, BANTEN",9,109,78,187
https://kawalpemilu.org#51699,"CARINGIN, LABUAN, PANDEGLANG, BANTEN",10,91,119,210
https://kawalpemilu.org#51699,"CARINGIN, LABUAN, PANDEGLANG, BANTEN",11,55,128,183
https://kawalpemilu.org#51699,"CARINGIN, LABUAN, PANDEGLANG, BANTEN",12,56,98,154
https://kawalpemilu.org#51699,"CARINGIN, LABUAN, PANDEGLANG, BANTEN",13,49,167,216
https://kawalpemilu.org#51699,"CARINGIN, LABUAN, PANDEGLANG, BANTEN",14,40,152,192
https://kawalpemilu.org#51699,"CARINGIN, LABUAN, PANDEGLANG, BANTEN",15,46,151,197
https://kawalpemilu.org#51699,"CARINGIN, LABUAN, PANDEGLANG, BANTEN",16,40,154,194
https://kawalpemilu.org#51699,"CARINGIN, LABUAN, PANDEGLANG, BANTEN",17,102,147,249
https://kawalpemilu.org#51699,"CARINGIN, LABUAN, PANDEGLANG, BANTEN",18,68,100,168
https://kawalpemilu.org#51699,"CARINGIN, LABUAN, PANDEGLANG, BANTEN",19,114,112,226
https://kawalpemilu.org#51699,"CARINGIN, LABUAN, PANDEGLANG, BANTEN",20,75,143,218
https://kawalpemilu.org#51700,"TELUK, LABUAN, PANDEGLANG, BANTEN",1,94,149,243
https://kawalpemilu.org#51700,"TELUK, LABUAN, PANDEGLANG, BANTEN",2,65,122,187
https://kawalpemilu.org#51700,"TELUK, LABUAN, PANDEGLANG, BANTEN",3,50,59,109
https://kawalpemilu.org#51700,"TELUK, LABUAN, PANDEGLANG, BANTEN",4,86,85,171
https://kawalpemilu.org#51700,"TELUK, LABUAN, PANDEGLANG, BANTEN",5,98,102,200
https://kawalpemilu.org#51700,"TELUK, LABUAN, PANDEGLANG, BANTEN",6,111,149,260
https://kawalpemilu.org#51700,"TELUK, LABUAN, PANDEGLANG, BANTEN",7,154,78,232
https://kawalpemilu.org#51700,"TELUK, LABUAN, PANDEGLANG, BANTEN",8,58,120,178
https://kawalpemilu.org#51700,"TELUK, LABUAN, PANDEGLANG, BANTEN",9,114,98,212
https://kawalpemilu.org#51700,"TELUK, LABUAN, PANDEGLANG, BANTEN",10,169,93,262
https://kawalpemilu.org#51700,"TELUK, LABUAN, PANDEGLANG, BANTEN",11,44,71,115
https://kawalpemilu.org#51700,"TELUK, LABUAN, PANDEGLANG, BANTEN",12,179,75,254
https://kawalpemilu.org#51700,"TELUK, LABUAN, PANDEGLANG, BANTEN",13,56,145,201
https://kawalpemilu.org#51700,"TELUK, LABUAN, PANDEGLANG, BANTEN",14,53,119,172
https://kawalpemilu.org#51700,"TELUK, LABUAN, PANDEGLANG, BANTEN",15,97,91,188
https://kawalpemilu.org#51700,"TELUK, LABUAN, PANDEGLANG, BANTEN",16,103,87,190
https://kawalpemilu.org#51700,"TELUK, LABUAN, PANDEGLANG, BANTEN",18,94,178,272
https://kawalpemilu.org#51700,"TELUK, LABUAN, PANDEGLANG, BANTEN",19,67,115,182
https://kawalpemilu.org#51700,"TELUK, LABUAN, PANDEGLANG, BANTEN",20,79,71,150
https://kawalpemilu.org#51700,"TELUK, LABUAN, PANDEGLANG, BANTEN",21,122,70,192
https://kawalpemilu.org#51700,"TELUK, LABUAN, PANDEGLANG, BANTEN",22,93,71,164
https://kawalpemilu.org#51700,"TELUK, LABUAN, PANDEGLANG, BANTEN",23,169,63,232
https://kawalpemilu.org#51700,"TELUK, LABUAN, PANDEGLANG, BANTEN",24,123,57,180
https://kawalpemilu.org#51700,"TELUK, LABUAN, PANDEGLANG, BANTEN",25,145,48,193
https://kawalpemilu.org#51700,"TELUK, LABUAN, PANDEGLANG, BANTEN",26,163,43,206
https://kawalpemilu.org#51700,"TELUK, LABUAN, PANDEGLANG, BANTEN",27,94,15,109
https://kawalpemilu.org#51700,"TELUK, LABUAN, PANDEGLANG, BANTEN",28,139,57,196
https://kawalpemilu.org#51700,"TELUK, LABUAN, PANDEGLANG, BANTEN",29,163,54,217
https://kawalpemilu.org#51700,"TELUK, LABUAN, PANDEGLANG, BANTEN",30,43,27,70
https://kawalpemilu.org#51700,"TELUK, LABUAN, PANDEGLANG, BANTEN",31,102,99,201
https://kawalpemilu.org#51700,"TELUK, LABUAN, PANDEGLANG, BANTEN",32,54,106,160
https://kawalpemilu.org#51700,"TELUK, LABUAN, PANDEGLANG, BANTEN",33,74,163,237
https://kawalpemilu.org#51701,"CIGONDANG, LABUAN, PANDEGLANG, BANTEN",1,136,105,241
https://kawalpemilu.org#51701,"CIGONDANG, LABUAN, PANDEGLANG, BANTEN",2,126,105,231
https://kawalpemilu.org#51701,"CIGONDANG, LABUAN, PANDEGLANG, BANTEN",3,106,108,214
https://kawalpemilu.org#51701,"CIGONDANG, LABUAN, PANDEGLANG, BANTEN",4,75,88,163
https://kawalpemilu.org#51701,"CIGONDANG, LABUAN, PANDEGLANG, BANTEN",5,72,110,182
https://kawalpemilu.org#51701,"CIGONDANG, LABUAN, PANDEGLANG, BANTEN",6,74,121,195
https://kawalpemilu.org#51701,"CIGONDANG, LABUAN, PANDEGLANG, BANTEN",7,94,116,210
https://kawalpemilu.org#51701,"CIGONDANG, LABUAN, PANDEGLANG, BANTEN",8,128,119,247
https://kawalpemilu.org#51701,"CIGONDANG, LABUAN, PANDEGLANG, BANTEN",9,81,126,207
https://kawalpemilu.org#51701,"CIGONDANG, LABUAN, PANDEGLANG, BANTEN",10,51,93,144
https://kawalpemilu.org#51701,"CIGONDANG, LABUAN, PANDEGLANG, BANTEN",11,77,146,223
https://kawalpemilu.org#51701,"CIGONDANG, LABUAN, PANDEGLANG, BANTEN",12,89,134,223
https://kawalpemilu.org#51701,"CIGONDANG, LABUAN, PANDEGLANG, BANTEN",13,149,78,227
https://kawalpemilu.org#51701,"CIGONDANG, LABUAN, PANDEGLANG, BANTEN",14,126,105,231
https://kawalpemilu.org#51701,"CIGONDANG, LABUAN, PANDEGLANG, BANTEN",15,128,87,215
https://kawalpemilu.org#51701,"CIGONDANG, LABUAN, PANDEGLANG, BANTEN",16,115,72,187
https://kawalpemilu.org#51701,"CIGONDANG, LABUAN, PANDEGLANG, BANTEN",17,108,66,174
https://kawalpemilu.org#51701,"CIGONDANG, LABUAN, PANDEGLANG, BANTEN",18,116,128,244
https://kawalpemilu.org#51701,"CIGONDANG, LABUAN, PANDEGLANG, BANTEN",19,108,79,187
https://kawalpemilu.org#51701,"CIGONDANG, LABUAN, PANDEGLANG, BANTEN",20,121,98,219
https://kawalpemilu.org#51701,"CIGONDANG, LABUAN, PANDEGLANG, BANTEN",21,114,84,198
https://kawalpemilu.org#51701,"CIGONDANG, LABUAN, PANDEGLANG, BANTEN",22,90,118,208
https://kawalpemilu.org#51702,"KALANGANYAR, LABUAN, PANDEGLANG, BANTEN",1,123,104,227
https://kawalpemilu.org#51702,"KALANGANYAR, LABUAN, PANDEGLANG, BANTEN",2,31,60,91
https://kawalpemilu.org#51702,"KALANGANYAR, LABUAN, PANDEGLANG, BANTEN",3,124,105,229
https://kawalpemilu.org#51702,"KALANGANYAR, LABUAN, PANDEGLANG, BANTEN",4,103,60,163
https://kawalpemilu.org#51702,"KALANGANYAR, LABUAN, PANDEGLANG, BANTEN",5,79,31,110
https://kawalpemilu.org#51702,"KALANGANYAR, LABUAN, PANDEGLANG, BANTEN",6,120,143,263
https://kawalpemilu.org#51702,"KALANGANYAR, LABUAN, PANDEGLANG, BANTEN",7,132,78,210
https://kawalpemilu.org#51702,"KALANGANYAR, LABUAN, PANDEGLANG, BANTEN",8,109,56,165
https://kawalpemilu.org#51702,"KALANGANYAR, LABUAN, PANDEGLANG, BANTEN",9,59,119,178
https://kawalpemilu.org#51702,"KALANGANYAR, LABUAN, PANDEGLANG, BANTEN",10,47,88,135
https://kawalpemilu.org#51702,"KALANGANYAR, LABUAN, PANDEGLANG, BANTEN",11,34,43,77
https://kawalpemilu.org#51702,"KALANGANYAR, LABUAN, PANDEGLANG, BANTEN",12,144,81,225
https://kawalpemilu.org#51702,"KALANGANYAR, LABUAN, PANDEGLANG, BANTEN",13,158,61,219
https://kawalpemilu.org#51702,"KALANGANYAR, LABUAN, PANDEGLANG, BANTEN",14,123,104,227
https://kawalpemilu.org#51702,"KALANGANYAR, LABUAN, PANDEGLANG, BANTEN",15,125,96,221
https://kawalpemilu.org#51702,"KALANGANYAR, LABUAN, PANDEGLANG, BANTEN",16,89,96,185
https://kawalpemilu.org#51702,"KALANGANYAR, LABUAN, PANDEGLANG, BANTEN",17,136,100,236
https://kawalpemilu.org#51702,"KALANGANYAR, LABUAN, PANDEGLANG, BANTEN",18,133,77,210
https://kawalpemilu.org#51702,"KALANGANYAR, LABUAN, PANDEGLANG, BANTEN",19,110,84,194
https://kawalpemilu.org#51702,"KALANGANYAR, LABUAN, PANDEGLANG, BANTEN",20,72,116,188
https://kawalpemilu.org#51702,"KALANGANYAR, LABUAN, PANDEGLANG, BANTEN",21,38,62,100
https://kawalpemilu.org#51702,"KALANGANYAR, LABUAN, PANDEGLANG, BANTEN",22,111,112,223
https://kawalpemilu.org#51702,"KALANGANYAR, LABUAN, PANDEGLANG, BANTEN",23,64,119,183
https://kawalpemilu.org#51703,"SUKAMAJU, LABUAN, PANDEGLANG, BANTEN",1,74,170,244
https://kawalpemilu.org#51703,"SUKAMAJU, LABUAN, PANDEGLANG, BANTEN",2,44,131,175
https://kawalpemilu.org#51703,"SUKAMAJU, LABUAN, PANDEGLANG, BANTEN",3,78,188,266
https://kawalpemilu.org#51703,"SUKAMAJU, LABUAN, PANDEGLANG, BANTEN",4,60,174,234
https://kawalpemilu.org#51703,"SUKAMAJU, LABUAN, PANDEGLANG, BANTEN",5,76,132,208
https://kawalpemilu.org#51703,"SUKAMAJU, LABUAN, PANDEGLANG, BANTEN",6,49,126,175
https://kawalpemilu.org#51703,"SUKAMAJU, LABUAN, PANDEGLANG, BANTEN",7,70,104,174
https://kawalpemilu.org#51703,"SUKAMAJU, LABUAN, PANDEGLANG, BANTEN",8,68,140,208
https://kawalpemilu.org#51703,"SUKAMAJU, LABUAN, PANDEGLANG, BANTEN",9,47,121,168
https://kawalpemilu.org#51703,"SUKAMAJU, LABUAN, PANDEGLANG, BANTEN",10,57,119,176
https://kawalpemilu.org#51704,"BANYUMEKAR, LABUAN, PANDEGLANG, BANTEN",1,54,199,253
https://kawalpemilu.org#51704,"BANYUMEKAR, LABUAN, PANDEGLANG, BANTEN",2,32,179,211
https://kawalpemilu.org#51704,"BANYUMEKAR, LABUAN, PANDEGLANG, BANTEN",3,45,141,186
https://kawalpemilu.org#51704,"BANYUMEKAR, LABUAN, PANDEGLANG, BANTEN",4,53,98,151
https://kawalpemilu.org#51704,"BANYUMEKAR, LABUAN, PANDEGLANG, BANTEN",5,65,58,123
https://kawalpemilu.org#51704,"BANYUMEKAR, LABUAN, PANDEGLANG, BANTEN",6,60,122,182
https://kawalpemilu.org#51706,"ALASWANGI, MENES, PANDEGLANG, BANTEN",1,43,198,241
https://kawalpemilu.org#51706,"ALASWANGI, MENES, PANDEGLANG, BANTEN",2,65,183,248
https://kawalpemilu.org#51706,"ALASWANGI, MENES, PANDEGLANG, BANTEN",3,31,108,139
https://kawalpemilu.org#51706,"ALASWANGI, MENES, PANDEGLANG, BANTEN",4,17,116,133
https://kawalpemilu.org#51706,"ALASWANGI, MENES, PANDEGLANG, BANTEN",5,74,170,244
https://kawalpemilu.org#51706,"ALASWANGI, MENES, PANDEGLANG, BANTEN",6,44,169,213
https://kawalpemilu.org#51706,"ALASWANGI, MENES, PANDEGLANG, BANTEN",7,34,205,239
https://kawalpemilu.org#51706,"ALASWANGI, MENES, PANDEGLANG, BANTEN",8,53,207,260
https://kawalpemilu.org#51707,"TEGALWANGI, MENES, PANDEGLANG, BANTEN",1,74,212,286
https://kawalpemilu.org#51707,"TEGALWANGI, MENES, PANDEGLANG, BANTEN",2,84,178,262
https://kawalpemilu.org#51707,"TEGALWANGI, MENES, PANDEGLANG, BANTEN",3,44,202,246
https://kawalpemilu.org#51707,"TEGALWANGI, MENES, PANDEGLANG, BANTEN",4,45,277,272
https://kawalpemilu.org#51707,"TEGALWANGI, MENES, PANDEGLANG, BANTEN",5,55,154,209
https://kawalpemilu.org#51707,"TEGALWANGI, MENES, PANDEGLANG, BANTEN",6,54,101,155
https://kawalpemilu.org#51707,"TEGALWANGI, MENES, PANDEGLANG, BANTEN",7,32,132,164
https://kawalpemilu.org#51708,"KANANGA, MENES, PANDEGLANG, BANTEN",1,69,129,198
https://kawalpemilu.org#51708,"KANANGA, MENES, PANDEGLANG, BANTEN",2,28,106,134
https://kawalpemilu.org#51708,"KANANGA, MENES, PANDEGLANG, BANTEN",3,57,100,157
https://kawalpemilu.org#51708,"KANANGA, MENES, PANDEGLANG, BANTEN",4,48,162,210
https://kawalpemilu.org#51708,"KANANGA, MENES, PANDEGLANG, BANTEN",5,64,79,143
https://kawalpemilu.org#51708,"KANANGA, MENES, PANDEGLANG, BANTEN",6,13,125,138
https://kawalpemilu.org#51708,"KANANGA, MENES, PANDEGLANG, BANTEN",7,59,90,149
https://kawalpemilu.org#51708,"KANANGA, MENES, PANDEGLANG, BANTEN",8,78,128,206
https://kawalpemilu.org#51709,"CIGANDENG, MENES, PANDEGLANG, BANTEN",1,30,184,214
https://kawalpemilu.org#51709,"CIGANDENG, MENES, PANDEGLANG, BANTEN",2,55,115,170
https://kawalpemilu.org#51709,"CIGANDENG, MENES, PANDEGLANG, BANTEN",3,52,152,204
https://kawalpemilu.org#51709,"CIGANDENG, MENES, PANDEGLANG, BANTEN",4,39,120,159
https://kawalpemilu.org#51709,"CIGANDENG, MENES, PANDEGLANG, BANTEN",5,31,116,147
https://kawalpemilu.org#51709,"CIGANDENG, MENES, PANDEGLANG, BANTEN",6,53,140,193
https://kawalpemilu.org#51709,"CIGANDENG, MENES, PANDEGLANG, BANTEN",7,67,179,246
https://kawalpemilu.org#51709,"CIGANDENG, MENES, PANDEGLANG, BANTEN",8,34,143,177
https://kawalpemilu.org#51710,"MENES, MENES, PANDEGLANG, BANTEN",1,28,182,210
https://kawalpemilu.org#51710,"MENES, MENES, PANDEGLANG, BANTEN",2,37,184,221
https://kawalpemilu.org#51710,"MENES, MENES, PANDEGLANG, BANTEN",3,45,172,217
https://kawalpemilu.org#51710,"MENES, MENES, PANDEGLANG, BANTEN",4,33,209,242
https://kawalpemilu.org#51710,"MENES, MENES, PANDEGLANG, BANTEN",5,45,202,247
https://kawalpemilu.org#51710,"MENES, MENES, PANDEGLANG, BANTEN",6,25,187,212
https://kawalpemilu.org#51710,"MENES, MENES, PANDEGLANG, BANTEN",7,34,208,242
https://kawalpemilu.org#51710,"MENES, MENES, PANDEGLANG, BANTEN",8,16,162,178
https://kawalpemilu.org#51710,"MENES, MENES, PANDEGLANG, BANTEN",9,21,235,256
https://kawalpemilu.org#51710,"MENES, MENES, PANDEGLANG, BANTEN",10,33,165,198
https://kawalpemilu.org#51710,"MENES, MENES, PANDEGLANG, BANTEN",11,41,189,230
https://kawalpemilu.org#51710,"MENES, MENES, PANDEGLANG, BANTEN",12,38,126,164
https://kawalpemilu.org#51710,"MENES, MENES, PANDEGLANG, BANTEN",13,37,180,217
https://kawalpemilu.org#51710,"MENES, MENES, PANDEGLANG, BANTEN",14,56,161,217
https://kawalpemilu.org#51710,"MENES, MENES, PANDEGLANG, BANTEN",15,41,185,226
https://kawalpemilu.org#51710,"MENES, MENES, PANDEGLANG, BANTEN",16,37,196,233
https://kawalpemilu.org#51710,"MENES, MENES, PANDEGLANG, BANTEN",17,67,172,239
https://kawalpemilu.org#51710,"MENES, MENES, PANDEGLANG, BANTEN",18,30,132,162
https://kawalpemilu.org#51711,"MURUY, MENES, PANDEGLANG, BANTEN",1,52,148,200
https://kawalpemilu.org#51711,"MURUY, MENES, PANDEGLANG, BANTEN",2,70,122,192
https://kawalpemilu.org#51711,"MURUY, MENES, PANDEGLANG, BANTEN",3,30,104,134
https://kawalpemilu.org#51711,"MURUY, MENES, PANDEGLANG, BANTEN",4,91,68,159
https://kawalpemilu.org#51711,"MURUY, MENES, PANDEGLANG, BANTEN",5,81,127,208
https://kawalpemilu.org#51711,"MURUY, MENES, PANDEGLANG, BANTEN",6,38,135,173
https://kawalpemilu.org#51711,"MURUY, MENES, PANDEGLANG, BANTEN",7,71,106,177
https://kawalpemilu.org#51711,"MURUY, MENES, PANDEGLANG, BANTEN",8,51,146,197
https://kawalpemilu.org#51712,"SUKAMANAH, MENES, PANDEGLANG, BANTEN",1,23,62,85
https://kawalpemilu.org#51712,"SUKAMANAH, MENES, PANDEGLANG, BANTEN",2,133,68,201
https://kawalpemilu.org#51712,"SUKAMANAH, MENES, PANDEGLANG, BANTEN",3,57,106,163
https://kawalpemilu.org#51712,"SUKAMANAH, MENES, PANDEGLANG, BANTEN",4,62,98,160
https://kawalpemilu.org#51712,"SUKAMANAH, MENES, PANDEGLANG, BANTEN",5,87,81,168
https://kawalpemilu.org#51712,"SUKAMANAH, MENES, PANDEGLANG, BANTEN",6,99,99,198
https://kawalpemilu.org#51712,"SUKAMANAH, MENES, PANDEGLANG, BANTEN",7,40,176,216
https://kawalpemilu.org#51712,"SUKAMANAH, MENES, PANDEGLANG, BANTEN",8,30,152,182
https://kawalpemilu.org#51712,"SUKAMANAH, MENES, PANDEGLANG, BANTEN",9,80,133,213
https://kawalpemilu.org#51712,"SUKAMANAH, MENES, PANDEGLANG, BANTEN",10,73,107,180
https://kawalpemilu.org#51712,"SUKAMANAH, MENES, PANDEGLANG, BANTEN",11,44,169,213
https://kawalpemilu.org#51712,"SUKAMANAH, MENES, PANDEGLANG, BANTEN",12,46,55,101
https://kawalpemilu.org#51713,"PURWARAJA, MENES, PANDEGLANG, BANTEN",1,40,115,155
https://kawalpemilu.org#51713,"PURWARAJA, MENES, PANDEGLANG, BANTEN",2,49,125,174
https://kawalpemilu.org#51713,"PURWARAJA, MENES, PANDEGLANG, BANTEN",3,76,121,197
https://kawalpemilu.org#51713,"PURWARAJA, MENES, PANDEGLANG, BANTEN",4,62,131,193
https://kawalpemilu.org#51713,"PURWARAJA, MENES, PANDEGLANG, BANTEN",5,34,139,173
https://kawalpemilu.org#51713,"PURWARAJA, MENES, PANDEGLANG, BANTEN",6,26,166,192
https://kawalpemilu.org#51713,"PURWARAJA, MENES, PANDEGLANG, BANTEN",7,59,114,173
https://kawalpemilu.org#51713,"PURWARAJA, MENES, PANDEGLANG, BANTEN",8,61,130,191
https://kawalpemilu.org#51713,"PURWARAJA, MENES, PANDEGLANG, BANTEN",9,64,142,206
https://kawalpemilu.org#51713,"PURWARAJA, MENES, PANDEGLANG, BANTEN",10,51,151,202
https://kawalpemilu.org#51713,"PURWARAJA, MENES, PANDEGLANG, BANTEN",11,31,91,122
https://kawalpemilu.org#51713,"PURWARAJA, MENES, PANDEGLANG, BANTEN",12,28,148,176
https://kawalpemilu.org#51713,"PURWARAJA, MENES, PANDEGLANG, BANTEN",13,36,124,160
https://kawalpemilu.org#51713,"PURWARAJA, MENES, PANDEGLANG, BANTEN",14,46,133,179
https://kawalpemilu.org#51713,"PURWARAJA, MENES, PANDEGLANG, BANTEN",15,59,197,256
https://kawalpemilu.org#51713,"PURWARAJA, MENES, PANDEGLANG, BANTEN",16,37,161,198
https://kawalpemilu.org#51713,"PURWARAJA, MENES, PANDEGLANG, BANTEN",17,49,181,230
https://kawalpemilu.org#51713,"PURWARAJA, MENES, PANDEGLANG, BANTEN",18,58,126,184
https://kawalpemilu.org#51713,"PURWARAJA, MENES, PANDEGLANG, BANTEN",19,73,146,219
https://kawalpemilu.org#51713,"PURWARAJA, MENES, PANDEGLANG, BANTEN",20,14,152,166
https://kawalpemilu.org#51713,"PURWARAJA, MENES, PANDEGLANG, BANTEN",21,33,39,72
https://kawalpemilu.org#51713,"PURWARAJA, MENES, PANDEGLANG, BANTEN",22,13,78,91
https://kawalpemilu.org#51714,"SINDANGKARYA, MENES, PANDEGLANG, BANTEN",1,31,176,207
https://kawalpemilu.org#51714,"SINDANGKARYA, MENES, PANDEGLANG, BANTEN",2,58,105,163
https://kawalpemilu.org#51714,"SINDANGKARYA, MENES, PANDEGLANG, BANTEN",3,32,164,196
https://kawalpemilu.org#51714,"SINDANGKARYA, MENES, PANDEGLANG, BANTEN",4,59,143,202
https://kawalpemilu.org#51714,"SINDANGKARYA, MENES, PANDEGLANG, BANTEN",5,54,137,191
https://kawalpemilu.org#51714,"SINDANGKARYA, MENES, PANDEGLANG, BANTEN",6,41,149,190
https://kawalpemilu.org#51714,"SINDANGKARYA, MENES, PANDEGLANG, BANTEN",7,33,155,188
https://kawalpemilu.org#51714,"SINDANGKARYA, MENES, PANDEGLANG, BANTEN",8,24,188,212
https://kawalpemilu.org#51714,"SINDANGKARYA, MENES, PANDEGLANG, BANTEN",9,28,140,168
https://kawalpemilu.org#51715,"CILABANBULAN, MENES, PANDEGLANG, BANTEN",1,41,113,154
https://kawalpemilu.org#51715,"CILABANBULAN, MENES, PANDEGLANG, BANTEN",2,30,148,178
https://kawalpemilu.org#51715,"CILABANBULAN, MENES, PANDEGLANG, BANTEN",3,78,104,182
https://kawalpemilu.org#51715,"CILABANBULAN, MENES, PANDEGLANG, BANTEN",4,33,73,106
https://kawalpemilu.org#51715,"CILABANBULAN, MENES, PANDEGLANG, BANTEN",5,57,44,101
https://kawalpemilu.org#51715,"CILABANBULAN, MENES, PANDEGLANG, BANTEN",6,30,144,174
https://kawalpemilu.org#51715,"CILABANBULAN, MENES, PANDEGLANG, BANTEN",7,62,132,194
https://kawalpemilu.org#51715,"CILABANBULAN, MENES, PANDEGLANG, BANTEN",8,34,160,194
https://kawalpemilu.org#51716,"KADUPAYUNG, MENES, PANDEGLANG, BANTEN",1,75,164,239
https://kawalpemilu.org#51716,"KADUPAYUNG, MENES, PANDEGLANG, BANTEN",2,57,106,163
https://kawalpemilu.org#51716,"KADUPAYUNG, MENES, PANDEGLANG, BANTEN",3,84,142,226
https://kawalpemilu.org#51716,"KADUPAYUNG, MENES, PANDEGLANG, BANTEN",4,58,140,198
https://kawalpemilu.org#51716,"KADUPAYUNG, MENES, PANDEGLANG, BANTEN",5,33,73,106
https://kawalpemilu.org#84968,"RAMAYA, MENES, PANDEGLANG, BANTEN",1,23,153,176
https://kawalpemilu.org#84968,"RAMAYA, MENES, PANDEGLANG, BANTEN",2,42,162,204
https://kawalpemilu.org#84968,"RAMAYA, MENES, PANDEGLANG, BANTEN",3,8,170,178
https://kawalpemilu.org#84968,"RAMAYA, MENES, PANDEGLANG, BANTEN",4,14,172,186
https://kawalpemilu.org#84968,"RAMAYA, MENES, PANDEGLANG, BANTEN",5,32,130,162
https://kawalpemilu.org#51718,"LANGENSARI, SAKETI, PANDEGLANG, BANTEN",1,68,119,187
https://kawalpemilu.org#51718,"LANGENSARI, SAKETI, PANDEGLANG, BANTEN",2,53,145,198
https://kawalpemilu.org#51718,"LANGENSARI, SAKETI, PANDEGLANG, BANTEN",3,43,183,226
https://kawalpemilu.org#51718,"LANGENSARI, SAKETI, PANDEGLANG, BANTEN",4,64,151,215
https://kawalpemilu.org#51718,"LANGENSARI, SAKETI, PANDEGLANG, BANTEN",5,119,85,204
https://kawalpemilu.org#51718,"LANGENSARI, SAKETI, PANDEGLANG, BANTEN",7,46,172,218
https://kawalpemilu.org#51719,"MEDALSARI, SAKETI, PANDEGLANG, BANTEN",1,126,86,212
https://kawalpemilu.org#51719,"MEDALSARI, SAKETI, PANDEGLANG, BANTEN",2,91,114,205
https://kawalpemilu.org#51719,"MEDALSARI, SAKETI, PANDEGLANG, BANTEN",3,55,137,192
https://kawalpemilu.org#51719,"MEDALSARI, SAKETI, PANDEGLANG, BANTEN",4,128,75,203
https://kawalpemilu.org#51719,"MEDALSARI, SAKETI, PANDEGLANG, BANTEN",5,88,130,218
https://kawalpemilu.org#51719,"MEDALSARI, SAKETI, PANDEGLANG, BANTEN",6,91,89,180
https://kawalpemilu.org#51719,"MEDALSARI, SAKETI, PANDEGLANG, BANTEN",7,84,79,163
https://kawalpemilu.org#51719,"MEDALSARI, SAKETI, PANDEGLANG, BANTEN",8,38,61,99
https://kawalpemilu.org#51720,"MAJAU, SAKETI, PANDEGLANG, BANTEN",2,40,143,183
https://kawalpemilu.org#51720,"MAJAU, SAKETI, PANDEGLANG, BANTEN",3,50,144,194
https://kawalpemilu.org#51720,"MAJAU, SAKETI, PANDEGLANG, BANTEN",4,49,127,176
https://kawalpemilu.org#51720,"MAJAU, SAKETI, PANDEGLANG, BANTEN",5,55,137,192
https://kawalpemilu.org#51720,"MAJAU, SAKETI, PANDEGLANG, BANTEN",6,62,142,204
https://kawalpemilu.org#51720,"MAJAU, SAKETI, PANDEGLANG, BANTEN",7,36,180,216
https://kawalpemilu.org#51720,"MAJAU, SAKETI, PANDEGLANG, BANTEN",8,20,132,152
https://kawalpemilu.org#51720,"MAJAU, SAKETI, PANDEGLANG, BANTEN",9,23,140,163
https://kawalpemilu.org#51720,"MAJAU, SAKETI, PANDEGLANG, BANTEN",10,33,172,205
https://kawalpemilu.org#51720,"MAJAU, SAKETI, PANDEGLANG, BANTEN",11,152,70,222
https://kawalpemilu.org#51721,"SODONG, SAKETI, PANDEGLANG, BANTEN",1,29,167,196
https://kawalpemilu.org#51721,"SODONG, SAKETI, PANDEGLANG, BANTEN",2,31,182,213
https://kawalpemilu.org#51721,"SODONG, SAKETI, PANDEGLANG, BANTEN",3,24,165,189
https://kawalpemilu.org#51721,"SODONG, SAKETI, PANDEGLANG, BANTEN",4,49,135,184
https://kawalpemilu.org#51721,"SODONG, SAKETI, PANDEGLANG, BANTEN",5,57,129,186
https://kawalpemilu.org#51721,"SODONG, SAKETI, PANDEGLANG, BANTEN",6,49,155,204
https://kawalpemilu.org#51721,"SODONG, SAKETI, PANDEGLANG, BANTEN",7,89,132,221
https://kawalpemilu.org#51721,"SODONG, SAKETI, PANDEGLANG, BANTEN",8,51,171,222
https://kawalpemilu.org#51721,"SODONG, SAKETI, PANDEGLANG, BANTEN",9,51,109,160
https://kawalpemilu.org#51721,"SODONG, SAKETI, PANDEGLANG, BANTEN",10,57,145,202
https://kawalpemilu.org#51721,"SODONG, SAKETI, PANDEGLANG, BANTEN",11,57,145,202
https://kawalpemilu.org#51721,"SODONG, SAKETI, PANDEGLANG, BANTEN",12,24,165,189
https://kawalpemilu.org#51722,"TALAGASARI, SAKETI, PANDEGLANG, BANTEN",1,41,187,228
https://kawalpemilu.org#51722,"TALAGASARI, SAKETI, PANDEGLANG, BANTEN",2,46,196,242
https://kawalpemilu.org#51722,"TALAGASARI, SAKETI, PANDEGLANG, BANTEN",3,51,177,228
https://kawalpemilu.org#51722,"TALAGASARI, SAKETI, PANDEGLANG, BANTEN",4,19,153,172
https://kawalpemilu.org#51722,"TALAGASARI, SAKETI, PANDEGLANG, BANTEN",5,23,207,230
https://kawalpemilu.org#51722,"TALAGASARI, SAKETI, PANDEGLANG, BANTEN",6,21,75,96
https://kawalpemilu.org#51722,"TALAGASARI, SAKETI, PANDEGLANG, BANTEN",7,30,148,178
https://kawalpemilu.org#51723,"CIANDUR, SAKETI, PANDEGLANG, BANTEN",1,60,154,214
https://kawalpemilu.org#51723,"CIANDUR, SAKETI, PANDEGLANG, BANTEN",2,37,143,180
https://kawalpemilu.org#51723,"CIANDUR, SAKETI, PANDEGLANG, BANTEN",3,51,140,191
https://kawalpemilu.org#51723,"CIANDUR, SAKETI, PANDEGLANG, BANTEN",4,40,143,183
https://kawalpemilu.org#51723,"CIANDUR, SAKETI, PANDEGLANG, BANTEN",5,37,142,179
https://kawalpemilu.org#51723,"CIANDUR, SAKETI, PANDEGLANG, BANTEN",6,45,177,222
https://kawalpemilu.org#51723,"CIANDUR, SAKETI, PANDEGLANG, BANTEN",7,10,126,136
https://kawalpemilu.org#51723,"CIANDUR, SAKETI, PANDEGLANG, BANTEN",8,55,160,215
https://kawalpemilu.org#51724,"KADUDAMPIT, SAKETI, PANDEGLANG, BANTEN",1,45,140,185
https://kawalpemilu.org#51724,"KADUDAMPIT, SAKETI, PANDEGLANG, BANTEN",2,49,144,193
https://kawalpemilu.org#51724,"KADUDAMPIT, SAKETI, PANDEGLANG, BANTEN",3,54,139,193
https://kawalpemilu.org#51724,"KADUDAMPIT, SAKETI, PANDEGLANG, BANTEN",4,63,175,238
https://kawalpemilu.org#51724,"KADUDAMPIT, SAKETI, PANDEGLANG, BANTEN",5,62,158,220
https://kawalpemilu.org#51724,"KADUDAMPIT, SAKETI, PANDEGLANG, BANTEN",6,50,156,206
https://kawalpemilu.org#51724,"KADUDAMPIT, SAKETI, PANDEGLANG, BANTEN",7,82,148,230
https://kawalpemilu.org#51724,"KADUDAMPIT, SAKETI, PANDEGLANG, BANTEN",8,49,175,224
https://kawalpemilu.org#51724,"KADUDAMPIT, SAKETI, PANDEGLANG, BANTEN",9,52,180,232
https://kawalpemilu.org#51724,"KADUDAMPIT, SAKETI, PANDEGLANG, BANTEN",10,55,157,212
https://kawalpemilu.org#51724,"KADUDAMPIT, SAKETI, PANDEGLANG, BANTEN",11,72,128,200
https://kawalpemilu.org#51724,"KADUDAMPIT, SAKETI, PANDEGLANG, BANTEN",12,133,87,220
https://kawalpemilu.org#51724,"KADUDAMPIT, SAKETI, PANDEGLANG, BANTEN",13,89,111,200
https://kawalpemilu.org#51724,"KADUDAMPIT, SAKETI, PANDEGLANG, BANTEN",14,117,92,209
https://kawalpemilu.org#51725,"WANAGIRI, SAKETI, PANDEGLANG, BANTEN",1,39,133,172
https://kawalpemilu.org#51725,"WANAGIRI, SAKETI, PANDEGLANG, BANTEN",2,62,129,191
https://kawalpemilu.org#51725,"WANAGIRI, SAKETI, PANDEGLANG, BANTEN",3,62,138,200
https://kawalpemilu.org#51725,"WANAGIRI, SAKETI, PANDEGLANG, BANTEN",4,42,168,210
https://kawalpemilu.org#51725,"WANAGIRI, SAKETI, PANDEGLANG, BANTEN",5,54,91,145
https://kawalpemilu.org#51726,"PARIGI, SAKETI, PANDEGLANG, BANTEN",1,47,167,214
https://kawalpemilu.org#51726,"PARIGI, SAKETI, PANDEGLANG, BANTEN",2,28,163,191
https://kawalpemilu.org#51726,"PARIGI, SAKETI, PANDEGLANG, BANTEN",3,49,150,199
https://kawalpemilu.org#51726,"PARIGI, SAKETI, PANDEGLANG, BANTEN",4,50,126,176
https://kawalpemilu.org#51726,"PARIGI, SAKETI, PANDEGLANG, BANTEN",5,38,119,157
https://kawalpemilu.org#51726,"PARIGI, SAKETI, PANDEGLANG, BANTEN",6,49,167,216
https://kawalpemilu.org#51726,"PARIGI, SAKETI, PANDEGLANG, BANTEN",7,43,132,175
https://kawalpemilu.org#51726,"PARIGI, SAKETI, PANDEGLANG, BANTEN",8,67,114,181
https://kawalpemilu.org#51726,"PARIGI, SAKETI, PANDEGLANG, BANTEN",9,44,140,184
https://kawalpemilu.org#51726,"PARIGI, SAKETI, PANDEGLANG, BANTEN",10,42,133,175
https://kawalpemilu.org#51727,"MEKARWANGI, SAKETI, PANDEGLANG, BANTEN",1,70,139,209
https://kawalpemilu.org#51727,"MEKARWANGI, SAKETI, PANDEGLANG, BANTEN",2,58,158,216
https://kawalpemilu.org#51727,"MEKARWANGI, SAKETI, PANDEGLANG, BANTEN",3,50,149,199
https://kawalpemilu.org#51727,"MEKARWANGI, SAKETI, PANDEGLANG, BANTEN",5,46,164,210
https://kawalpemilu.org#51727,"MEKARWANGI, SAKETI, PANDEGLANG, BANTEN",6,79,84,163
https://kawalpemilu.org#51727,"MEKARWANGI, SAKETI, PANDEGLANG, BANTEN",7,77,124,201
https://kawalpemilu.org#51727,"MEKARWANGI, SAKETI, PANDEGLANG, BANTEN",8,68,132,200
https://kawalpemilu.org#51728,"SAKETI, SAKETI, PANDEGLANG, BANTEN",1,48,150,198
https://kawalpemilu.org#51728,"SAKETI, SAKETI, PANDEGLANG, BANTEN",2,44,182,226
https://kawalpemilu.org#51728,"SAKETI, SAKETI, PANDEGLANG, BANTEN",3,35,180,215
https://kawalpemilu.org#51728,"SAKETI, SAKETI, PANDEGLANG, BANTEN",4,65,169,234
https://kawalpemilu.org#51728,"SAKETI, SAKETI, PANDEGLANG, BANTEN",5,60,119,179
https://kawalpemilu.org#51728,"SAKETI, SAKETI, PANDEGLANG, BANTEN",6,64,122,186
https://kawalpemilu.org#51728,"SAKETI, SAKETI, PANDEGLANG, BANTEN",7,47,128,175
https://kawalpemilu.org#51728,"SAKETI, SAKETI, PANDEGLANG, BANTEN",8,44,137,181
https://kawalpemilu.org#51728,"SAKETI, SAKETI, PANDEGLANG, BANTEN",9,41,161,202
https://kawalpemilu.org#51728,"SAKETI, SAKETI, PANDEGLANG, BANTEN",10,45,121,166
https://kawalpemilu.org#51728,"SAKETI, SAKETI, PANDEGLANG, BANTEN",11,43,169,212
https://kawalpemilu.org#51728,"SAKETI, SAKETI, PANDEGLANG, BANTEN",12,73,144,217
https://kawalpemilu.org#51728,"SAKETI, SAKETI, PANDEGLANG, BANTEN",13,70,104,174
https://kawalpemilu.org#51729,"GIRIJAYA, SAKETI, PANDEGLANG, BANTEN",1,63,147,210
https://kawalpemilu.org#51729,"GIRIJAYA, SAKETI, PANDEGLANG, BANTEN",2,98,117,215
https://kawalpemilu.org#51729,"GIRIJAYA, SAKETI, PANDEGLANG, BANTEN",3,64,166,230
https://kawalpemilu.org#51729,"GIRIJAYA, SAKETI, PANDEGLANG, BANTEN",4,40,123,163
https://kawalpemilu.org#51729,"GIRIJAYA, SAKETI, PANDEGLANG, BANTEN",5,61,156,217
https://kawalpemilu.org#51729,"GIRIJAYA, SAKETI, PANDEGLANG, BANTEN",6,39,103,142
https://kawalpemilu.org#51729,"GIRIJAYA, SAKETI, PANDEGLANG, BANTEN",7,70,147,217
https://kawalpemilu.org#51730,"SINDANGHAYU, SAKETI, PANDEGLANG, BANTEN",1,84,97,181
https://kawalpemilu.org#51730,"SINDANGHAYU, SAKETI, PANDEGLANG, BANTEN",2,37,194,231
https://kawalpemilu.org#51730,"SINDANGHAYU, SAKETI, PANDEGLANG, BANTEN",3,51,170,221
https://kawalpemilu.org#51730,"SINDANGHAYU, SAKETI, PANDEGLANG, BANTEN",4,67,171,238
https://kawalpemilu.org#51730,"SINDANGHAYU, SAKETI, PANDEGLANG, BANTEN",5,30,162,192
https://kawalpemilu.org#51730,"SINDANGHAYU, SAKETI, PANDEGLANG, BANTEN",6,63,148,211
https://kawalpemilu.org#51730,"SINDANGHAYU, SAKETI, PANDEGLANG, BANTEN",7,43,189,232
https://kawalpemilu.org#51730,"SINDANGHAYU, SAKETI, PANDEGLANG, BANTEN",8,44,139,183
https://kawalpemilu.org#51730,"SINDANGHAYU, SAKETI, PANDEGLANG, BANTEN",9,61,144,205
https://kawalpemilu.org#51730,"SINDANGHAYU, SAKETI, PANDEGLANG, BANTEN",10,38,208,246
https://kawalpemilu.org#51730,"SINDANGHAYU, SAKETI, PANDEGLANG, BANTEN",11,44,123,167
https://kawalpemilu.org#51730,"SINDANGHAYU, SAKETI, PANDEGLANG, BANTEN",12,51,160,211
https://kawalpemilu.org#51731,"SUKALANGU, SAKETI, PANDEGLANG, BANTEN",1,36,149,185
https://kawalpemilu.org#51731,"SUKALANGU, SAKETI, PANDEGLANG, BANTEN",2,38,183,221
https://kawalpemilu.org#51731,"SUKALANGU, SAKETI, PANDEGLANG, BANTEN",3,21,129,150
https://kawalpemilu.org#51731,"SUKALANGU, SAKETI, PANDEGLANG, BANTEN",4,33,150,183
https://kawalpemilu.org#51731,"SUKALANGU, SAKETI, PANDEGLANG, BANTEN",5,26,168,194
https://kawalpemilu.org#51731,"SUKALANGU, SAKETI, PANDEGLANG, BANTEN",6,24,136,160
https://kawalpemilu.org#51731,"SUKALANGU, SAKETI, PANDEGLANG, BANTEN",7,35,114,5
https://kawalpemilu.org#51731,"SUKALANGU, SAKETI, PANDEGLANG, BANTEN",8,130,89,219
https://kawalpemilu.org#51731,"SUKALANGU, SAKETI, PANDEGLANG, BANTEN",9,75,67,142
https://kawalpemilu.org#51733,"PALANYAR, CIPEUCANG, PANDEGLANG, BANTEN",1,33,165,198
https://kawalpemilu.org#51733,"PALANYAR, CIPEUCANG, PANDEGLANG, BANTEN",2,57,104,161
https://kawalpemilu.org#51733,"PALANYAR, CIPEUCANG, PANDEGLANG, BANTEN",3,42,102,144
https://kawalpemilu.org#51733,"PALANYAR, CIPEUCANG, PANDEGLANG, BANTEN",4,51,139,190
https://kawalpemilu.org#51733,"PALANYAR, CIPEUCANG, PANDEGLANG, BANTEN",5,65,180,245
https://kawalpemilu.org#51733,"PALANYAR, CIPEUCANG, PANDEGLANG, BANTEN",6,43,183,226
https://kawalpemilu.org#51733,"PALANYAR, CIPEUCANG, PANDEGLANG, BANTEN",7,44,194,238
https://kawalpemilu.org#51733,"PALANYAR, CIPEUCANG, PANDEGLANG, BANTEN",8,42,128,170
https://kawalpemilu.org#51733,"PALANYAR, CIPEUCANG, PANDEGLANG, BANTEN",9,53,193,246
https://kawalpemilu.org#51733,"PALANYAR, CIPEUCANG, PANDEGLANG, BANTEN",10,48,147,195
https://kawalpemilu.org#51733,"PALANYAR, CIPEUCANG, PANDEGLANG, BANTEN",11,25,122,147
https://kawalpemilu.org#51733,"PALANYAR, CIPEUCANG, PANDEGLANG, BANTEN",12,78,109,187
https://kawalpemilu.org#51733,"PALANYAR, CIPEUCANG, PANDEGLANG, BANTEN",13,59,170,229
https://kawalpemilu.org#51734,"BATURANJANG, CIPEUCANG, PANDEGLANG, BANTEN",2,59,128,187
https://kawalpemilu.org#51734,"BATURANJANG, CIPEUCANG, PANDEGLANG, BANTEN",3,65,160,225
https://kawalpemilu.org#51734,"BATURANJANG, CIPEUCANG, PANDEGLANG, BANTEN",4,63,132,195
https://kawalpemilu.org#51734,"BATURANJANG, CIPEUCANG, PANDEGLANG, BANTEN",5,40,214,254
https://kawalpemilu.org#51734,"BATURANJANG, CIPEUCANG, PANDEGLANG, BANTEN",6,46,197,243
https://kawalpemilu.org#51734,"BATURANJANG, CIPEUCANG, PANDEGLANG, BANTEN",7,24,112,136
https://kawalpemilu.org#51734,"BATURANJANG, CIPEUCANG, PANDEGLANG, BANTEN",8,24,165,189
https://kawalpemilu.org#51735,"CIKADUEUN, CIPEUCANG, PANDEGLANG, BANTEN",1,60,141,201
https://kawalpemilu.org#51735,"CIKADUEUN, CIPEUCANG, PANDEGLANG, BANTEN",2,46,162,208
https://kawalpemilu.org#51735,"CIKADUEUN, CIPEUCANG, PANDEGLANG, BANTEN",3,62,153,215
https://kawalpemilu.org#51735,"CIKADUEUN, CIPEUCANG, PANDEGLANG, BANTEN",4,41,187,228
https://kawalpemilu.org#51735,"CIKADUEUN, CIPEUCANG, PANDEGLANG, BANTEN",5,63,69,132
https://kawalpemilu.org#51735,"CIKADUEUN, CIPEUCANG, PANDEGLANG, BANTEN",6,84,108,192
https://kawalpemilu.org#51735,"CIKADUEUN, CIPEUCANG, PANDEGLANG, BANTEN",7,60,163,223
https://kawalpemilu.org#51735,"CIKADUEUN, CIPEUCANG, PANDEGLANG, BANTEN",8,36,132,168
https://kawalpemilu.org#51736,"KONCANG, CIPEUCANG, PANDEGLANG, BANTEN",2,47,114,161
https://kawalpemilu.org#51736,"KONCANG, CIPEUCANG, PANDEGLANG, BANTEN",3,50,154,204
https://kawalpemilu.org#51736,"KONCANG, CIPEUCANG, PANDEGLANG, BANTEN",4,46,202,248
https://kawalpemilu.org#51736,"KONCANG, CIPEUCANG, PANDEGLANG, BANTEN",5,16,218,234
https://kawalpemilu.org#51736,"KONCANG, CIPEUCANG, PANDEGLANG, BANTEN",6,51,104,155
https://kawalpemilu.org#51736,"KONCANG, CIPEUCANG, PANDEGLANG, BANTEN",7,75,59,134
https://kawalpemilu.org#51737,"KADUGADUNG, CIPEUCANG, PANDEGLANG, BANTEN",1,67,153,220
https://kawalpemilu.org#51737,"KADUGADUNG, CIPEUCANG, PANDEGLANG, BANTEN",2,46,180,226
https://kawalpemilu.org#51737,"KADUGADUNG, CIPEUCANG, PANDEGLANG, BANTEN",3,69,113,182
https://kawalpemilu.org#51737,"KADUGADUNG, CIPEUCANG, PANDEGLANG, BANTEN",4,63,173,236
https://kawalpemilu.org#51737,"KADUGADUNG, CIPEUCANG, PANDEGLANG, BANTEN",5,20,208,228
https://kawalpemilu.org#51737,"KADUGADUNG, CIPEUCANG, PANDEGLANG, BANTEN",6,24,172,196
https://kawalpemilu.org#51738,"PARUMASAN, CIPEUCANG, PANDEGLANG, BANTEN",1,40,95,135
https://kawalpemilu.org#51738,"PARUMASAN, CIPEUCANG, PANDEGLANG, BANTEN",2,15,90,105
https://kawalpemilu.org#51738,"PARUMASAN, CIPEUCANG, PANDEGLANG, BANTEN",3,29,152,181
https://kawalpemilu.org#51738,"PARUMASAN, CIPEUCANG, PANDEGLANG, BANTEN",4,44,112,156
https://kawalpemilu.org#51738,"PARUMASAN, CIPEUCANG, PANDEGLANG, BANTEN",5,30,127,157
https://kawalpemilu.org#51738,"PARUMASAN, CIPEUCANG, PANDEGLANG, BANTEN",6,51,148,199
https://kawalpemilu.org#51738,"PARUMASAN, CIPEUCANG, PANDEGLANG, BANTEN",7,45,143,188
https://kawalpemilu.org#51738,"PARUMASAN, CIPEUCANG, PANDEGLANG, BANTEN",8,107,65,172
https://kawalpemilu.org#51739,"CURUGBARANG, CIPEUCANG, PANDEGLANG, BANTEN",1,45,157,202
https://kawalpemilu.org#51739,"CURUGBARANG, CIPEUCANG, PANDEGLANG, BANTEN",2,32,130,162
https://kawalpemilu.org#51739,"CURUGBARANG, CIPEUCANG, PANDEGLANG, BANTEN",3,6,92,98
https://kawalpemilu.org#51739,"CURUGBARANG, CIPEUCANG, PANDEGLANG, BANTEN",4,37,172,209
https://kawalpemilu.org#51739,"CURUGBARANG, CIPEUCANG, PANDEGLANG, BANTEN",5,19,116,135
https://kawalpemilu.org#51739,"CURUGBARANG, CIPEUCANG, PANDEGLANG, BANTEN",6,37,102,139
https://kawalpemilu.org#51739,"CURUGBARANG, CIPEUCANG, PANDEGLANG, BANTEN",7,45,173,218
https://kawalpemilu.org#51739,"CURUGBARANG, CIPEUCANG, PANDEGLANG, BANTEN",8,42,130,172
https://kawalpemilu.org#51739,"CURUGBARANG, CIPEUCANG, PANDEGLANG, BANTEN",9,18,99,117
https://kawalpemilu.org#51739,"CURUGBARANG, CIPEUCANG, PANDEGLANG, BANTEN",10,38,156,194
https://kawalpemilu.org#51739,"CURUGBARANG, CIPEUCANG, PANDEGLANG, BANTEN",11,13,204,217
https://kawalpemilu.org#51739,"CURUGBARANG, CIPEUCANG, PANDEGLANG, BANTEN",12,22,167,189
https://kawalpemilu.org#51739,"CURUGBARANG, CIPEUCANG, PANDEGLANG, BANTEN",13,27,94,121
https://kawalpemilu.org#51739,"CURUGBARANG, CIPEUCANG, PANDEGLANG, BANTEN",14,27,127,154
https://kawalpemilu.org#51740,"KALANGGUNUNG, CIPEUCANG, PANDEGLANG, BANTEN",1,28,170,198
https://kawalpemilu.org#51740,"KALANGGUNUNG, CIPEUCANG, PANDEGLANG, BANTEN",2,56,151,207
https://kawalpemilu.org#51740,"KALANGGUNUNG, CIPEUCANG, PANDEGLANG, BANTEN",3,44,160,204
https://kawalpemilu.org#51740,"KALANGGUNUNG, CIPEUCANG, PANDEGLANG, BANTEN",4,30,201,231
https://kawalpemilu.org#51740,"KALANGGUNUNG, CIPEUCANG, PANDEGLANG, BANTEN",5,60,115,175
https://kawalpemilu.org#51740,"KALANGGUNUNG, CIPEUCANG, PANDEGLANG, BANTEN",6,42,92,134
https://kawalpemilu.org#51741,"PASIREURIH, CIPEUCANG, PANDEGLANG, BANTEN",1,32,113,145
https://kawalpemilu.org#51741,"PASIREURIH, CIPEUCANG, PANDEGLANG, BANTEN",2,47,143,190
https://kawalpemilu.org#51741,"PASIREURIH, CIPEUCANG, PANDEGLANG, BANTEN",3,67,163,230
https://kawalpemilu.org#51741,"PASIREURIH, CIPEUCANG, PANDEGLANG, BANTEN",4,22,177,199
https://kawalpemilu.org#51741,"PASIREURIH, CIPEUCANG, PANDEGLANG, BANTEN",5,44,169,213
https://kawalpemilu.org#51741,"PASIREURIH, CIPEUCANG, PANDEGLANG, BANTEN",6,27,160,187
https://kawalpemilu.org#51741,"PASIREURIH, CIPEUCANG, PANDEGLANG, BANTEN",7,18,163,181
https://kawalpemilu.org#51741,"PASIREURIH, CIPEUCANG, PANDEGLANG, BANTEN",8,32,119,151
https://kawalpemilu.org#51741,"PASIREURIH, CIPEUCANG, PANDEGLANG, BANTEN",9,12,114,126
https://kawalpemilu.org#51741,"PASIREURIH, CIPEUCANG, PANDEGLANG, BANTEN",10,13,141,154
https://kawalpemilu.org#51741,"PASIREURIH, CIPEUCANG, PANDEGLANG, BANTEN",11,33,157,190
https://kawalpemilu.org#51741,"PASIREURIH, CIPEUCANG, PANDEGLANG, BANTEN",12,48,113,161
https://kawalpemilu.org#51741,"PASIREURIH, CIPEUCANG, PANDEGLANG, BANTEN",13,19,173,192
https://kawalpemilu.org#51742,"PASIRMAE, CIPEUCANG, PANDEGLANG, BANTEN",1,84,139,223
https://kawalpemilu.org#51742,"PASIRMAE, CIPEUCANG, PANDEGLANG, BANTEN",2,53,108,161
https://kawalpemilu.org#51742,"PASIRMAE, CIPEUCANG, PANDEGLANG, BANTEN",3,52,128,180
https://kawalpemilu.org#51742,"PASIRMAE, CIPEUCANG, PANDEGLANG, BANTEN",4,20,136,156
https://kawalpemilu.org#51742,"PASIRMAE, CIPEUCANG, PANDEGLANG, BANTEN",5,45,119,164
https://kawalpemilu.org#51742,"PASIRMAE, CIPEUCANG, PANDEGLANG, BANTEN",6,44,126,170
https://kawalpemilu.org#51742,"PASIRMAE, CIPEUCANG, PANDEGLANG, BANTEN",7,66,105,171
https://kawalpemilu.org#51744,"PAMARAYAN, JIPUT, PANDEGLANG, BANTEN",1,43,107,150
https://kawalpemilu.org#51744,"PAMARAYAN, JIPUT, PANDEGLANG, BANTEN",2,37,123,160
https://kawalpemilu.org#51744,"PAMARAYAN, JIPUT, PANDEGLANG, BANTEN",3,40,151,191
https://kawalpemilu.org#51744,"PAMARAYAN, JIPUT, PANDEGLANG, BANTEN",4,37,138,175
https://kawalpemilu.org#51744,"PAMARAYAN, JIPUT, PANDEGLANG, BANTEN",5,40,165,205
https://kawalpemilu.org#51744,"PAMARAYAN, JIPUT, PANDEGLANG, BANTEN",6,51,146,197
https://kawalpemilu.org#51744,"PAMARAYAN, JIPUT, PANDEGLANG, BANTEN",7,78,114,192
https://kawalpemilu.org#51744,"PAMARAYAN, JIPUT, PANDEGLANG, BANTEN",8,56,107,163
https://kawalpemilu.org#51745,"JIPUT, JIPUT, PANDEGLANG, BANTEN",1,36,192,228
https://kawalpemilu.org#51745,"JIPUT, JIPUT, PANDEGLANG, BANTEN",2,30,152,182
https://kawalpemilu.org#51745,"JIPUT, JIPUT, PANDEGLANG, BANTEN",3,21,115,136
https://kawalpemilu.org#51745,"JIPUT, JIPUT, PANDEGLANG, BANTEN",4,51,162,213
https://kawalpemilu.org#51745,"JIPUT, JIPUT, PANDEGLANG, BANTEN",5,52,185,237
https://kawalpemilu.org#51745,"JIPUT, JIPUT, PANDEGLANG, BANTEN",6,21,217,238
https://kawalpemilu.org#51745,"JIPUT, JIPUT, PANDEGLANG, BANTEN",7,19,150,169
https://kawalpemilu.org#51745,"JIPUT, JIPUT, PANDEGLANG, BANTEN",8,10,149,159
https://kawalpemilu.org#51745,"JIPUT, JIPUT, PANDEGLANG, BANTEN",9,31,153,184
https://kawalpemilu.org#51745,"JIPUT, JIPUT, PANDEGLANG, BANTEN",10,36,129,165
https://kawalpemilu.org#51745,"JIPUT, JIPUT, PANDEGLANG, BANTEN",11,51,137,188
https://kawalpemilu.org#51745,"JIPUT, JIPUT, PANDEGLANG, BANTEN",12,60,133,193
https://kawalpemilu.org#51745,"JIPUT, JIPUT, PANDEGLANG, BANTEN",13,31,162,193
https://kawalpemilu.org#51745,"JIPUT, JIPUT, PANDEGLANG, BANTEN",14,140,112,252
https://kawalpemilu.org#51745,"JIPUT, JIPUT, PANDEGLANG, BANTEN",15,98,98,196
https://kawalpemilu.org#51745,"JIPUT, JIPUT, PANDEGLANG, BANTEN",16,66,132,198
https://kawalpemilu.org#51746,"SUKACAI, JIPUT, PANDEGLANG, BANTEN",1,65,114,179
https://kawalpemilu.org#51746,"SUKACAI, JIPUT, PANDEGLANG, BANTEN",2,73,115,188
https://kawalpemilu.org#51746,"SUKACAI, JIPUT, PANDEGLANG, BANTEN",3,100,75,175
https://kawalpemilu.org#51746,"SUKACAI, JIPUT, PANDEGLANG, BANTEN",4,114,106,220
https://kawalpemilu.org#51746,"SUKACAI, JIPUT, PANDEGLANG, BANTEN",5,84,123,207
https://kawalpemilu.org#51746,"SUKACAI, JIPUT, PANDEGLANG, BANTEN",6,68,123,191
https://kawalpemilu.org#51746,"SUKACAI, JIPUT, PANDEGLANG, BANTEN",7,71,99,170
https://kawalpemilu.org#51746,"SUKACAI, JIPUT, PANDEGLANG, BANTEN",8,14,24,38
https://kawalpemilu.org#51747,"TENJOLAHANG, JIPUT, PANDEGLANG, BANTEN",1,57,124,181
https://kawalpemilu.org#51747,"TENJOLAHANG, JIPUT, PANDEGLANG, BANTEN",2,42,97,139
https://kawalpemilu.org#51747,"TENJOLAHANG, JIPUT, PANDEGLANG, BANTEN",3,110,98,208
https://kawalpemilu.org#51747,"TENJOLAHANG, JIPUT, PANDEGLANG, BANTEN",4,88,70,158
https://kawalpemilu.org#51747,"TENJOLAHANG, JIPUT, PANDEGLANG, BANTEN",5,36,93,129
https://kawalpemilu.org#51747,"TENJOLAHANG, JIPUT, PANDEGLANG, BANTEN",6,45,118,163
https://kawalpemilu.org#51747,"TENJOLAHANG, JIPUT, PANDEGLANG, BANTEN",7,53,106,159
https://kawalpemilu.org#51748,"JANAKA, JIPUT, PANDEGLANG, BANTEN",1,83,87,170
https://kawalpemilu.org#51748,"JANAKA, JIPUT, PANDEGLANG, BANTEN",2,105,70,175
https://kawalpemilu.org#51748,"JANAKA, JIPUT, PANDEGLANG, BANTEN",3,29,164,193
https://kawalpemilu.org#51748,"JANAKA, JIPUT, PANDEGLANG, BANTEN",4,71,152,223
https://kawalpemilu.org#51748,"JANAKA, JIPUT, PANDEGLANG, BANTEN",6,64,109,173
https://kawalpemilu.org#51748,"JANAKA, JIPUT, PANDEGLANG, BANTEN",7,42,111,153
https://kawalpemilu.org#51748,"JANAKA, JIPUT, PANDEGLANG, BANTEN",8,65,114,179
https://kawalpemilu.org#51748,"JANAKA, JIPUT, PANDEGLANG, BANTEN",9,71,54,125
https://kawalpemilu.org#51749,"SIKULAN, JIPUT, PANDEGLANG, BANTEN",1,75,166,241
https://kawalpemilu.org#51749,"SIKULAN, JIPUT, PANDEGLANG, BANTEN",2,19,100,119
https://kawalpemilu.org#51749,"SIKULAN, JIPUT, PANDEGLANG, BANTEN",3,17,123,140
https://kawalpemilu.org#51749,"SIKULAN, JIPUT, PANDEGLANG, BANTEN",4,13,105,118
https://kawalpemilu.org#51749,"SIKULAN, JIPUT, PANDEGLANG, BANTEN",5,24,128,152
https://kawalpemilu.org#51749,"SIKULAN, JIPUT, PANDEGLANG, BANTEN",6,31,153,184
https://kawalpemilu.org#51749,"SIKULAN, JIPUT, PANDEGLANG, BANTEN",7,33,190,223
https://kawalpemilu.org#51749,"SIKULAN, JIPUT, PANDEGLANG, BANTEN",8,97,147,244
https://kawalpemilu.org#51749,"SIKULAN, JIPUT, PANDEGLANG, BANTEN",9,70,146,216
https://kawalpemilu.org#51750,"CITAMAN, JIPUT, PANDEGLANG, BANTEN",1,7,180,187
https://kawalpemilu.org#51750,"CITAMAN, JIPUT, PANDEGLANG, BANTEN",2,16,108,124
https://kawalpemilu.org#51750,"CITAMAN, JIPUT, PANDEGLANG, BANTEN",3,29,155,184
https://kawalpemilu.org#51750,"CITAMAN, JIPUT, PANDEGLANG, BANTEN",4,24,182,206
https://kawalpemilu.org#51750,"CITAMAN, JIPUT, PANDEGLANG, BANTEN",5,25,143,168
https://kawalpemilu.org#51751,"JAYAMEKAR, JIPUT, PANDEGLANG, BANTEN",1,28,143,171
https://kawalpemilu.org#51751,"JAYAMEKAR, JIPUT, PANDEGLANG, BANTEN",2,20,150,170
https://kawalpemilu.org#51751,"JAYAMEKAR, JIPUT, PANDEGLANG, BANTEN",3,16,138,154
https://kawalpemilu.org#51751,"JAYAMEKAR, JIPUT, PANDEGLANG, BANTEN",4,28,128,156
https://kawalpemilu.org#51751,"JAYAMEKAR, JIPUT, PANDEGLANG, BANTEN",5,36,118,154
https://kawalpemilu.org#51751,"JAYAMEKAR, JIPUT, PANDEGLANG, BANTEN",6,24,122,146
https://kawalpemilu.org#51751,"JAYAMEKAR, JIPUT, PANDEGLANG, BANTEN",7,18,111,129
https://kawalpemilu.org#51752,"SUKAMANAH, JIPUT, PANDEGLANG, BANTEN",1,29,108,137
https://kawalpemilu.org#51752,"SUKAMANAH, JIPUT, PANDEGLANG, BANTEN",2,27,136,163
https://kawalpemilu.org#51752,"SUKAMANAH, JIPUT, PANDEGLANG, BANTEN",3,24,123,147
https://kawalpemilu.org#51752,"SUKAMANAH, JIPUT, PANDEGLANG, BANTEN",4,31,141,172
https://kawalpemilu.org#51752,"SUKAMANAH, JIPUT, PANDEGLANG, BANTEN",5,20,172,192
https://kawalpemilu.org#51752,"SUKAMANAH, JIPUT, PANDEGLANG, BANTEN",6,47,129,176
https://kawalpemilu.org#51752,"SUKAMANAH, JIPUT, PANDEGLANG, BANTEN",7,54,121,175
https://kawalpemilu.org#51752,"SUKAMANAH, JIPUT, PANDEGLANG, BANTEN",8,22,114,136
https://kawalpemilu.org#51752,"SUKAMANAH, JIPUT, PANDEGLANG, BANTEN",9,27,101,128
https://kawalpemilu.org#51752,"SUKAMANAH, JIPUT, PANDEGLANG, BANTEN",10,30,153,183
https://kawalpemilu.org#51753,"SALAPRAYA, JIPUT, PANDEGLANG, BANTEN",1,78,99,177
https://kawalpemilu.org#51753,"SALAPRAYA, JIPUT, PANDEGLANG, BANTEN",2,27,162,189
https://kawalpemilu.org#51753,"SALAPRAYA, JIPUT, PANDEGLANG, BANTEN",3,10,127,137
https://kawalpemilu.org#51753,"SALAPRAYA, JIPUT, PANDEGLANG, BANTEN",4,15,128,143
https://kawalpemilu.org#51753,"SALAPRAYA, JIPUT, PANDEGLANG, BANTEN",5,30,107,137
https://kawalpemilu.org#51753,"SALAPRAYA, JIPUT, PANDEGLANG, BANTEN",6,37,176,213
https://kawalpemilu.org#51753,"SALAPRAYA, JIPUT, PANDEGLANG, BANTEN",7,41,179,220
https://kawalpemilu.org#51753,"SALAPRAYA, JIPUT, PANDEGLANG, BANTEN",8,84,169,253
https://kawalpemilu.org#51754,"BANYURESMI, JIPUT, PANDEGLANG, BANTEN",1,96,111,207
https://kawalpemilu.org#51754,"BANYURESMI, JIPUT, PANDEGLANG, BANTEN",2,91,103,194
https://kawalpemilu.org#51754,"BANYURESMI, JIPUT, PANDEGLANG, BANTEN",3,76,132,208
https://kawalpemilu.org#51754,"BANYURESMI, JIPUT, PANDEGLANG, BANTEN",5,43,122,165
https://kawalpemilu.org#51754,"BANYURESMI, JIPUT, PANDEGLANG, BANTEN",6,27,180,207
https://kawalpemilu.org#51754,"BANYURESMI, JIPUT, PANDEGLANG, BANTEN",7,26,126,152
https://kawalpemilu.org#51754,"BANYURESMI, JIPUT, PANDEGLANG, BANTEN",8,14,181,195
https://kawalpemilu.org#51754,"BANYURESMI, JIPUT, PANDEGLANG, BANTEN",9,51,114,165
https://kawalpemilu.org#51754,"BANYURESMI, JIPUT, PANDEGLANG, BANTEN",10,52,133,185
https://kawalpemilu.org#51755,"SAMPANG BITUNG, JIPUT, PANDEGLANG, BANTEN",1,23,141,164
https://kawalpemilu.org#51755,"SAMPANG BITUNG, JIPUT, PANDEGLANG, BANTEN",2,31,170,201
https://kawalpemilu.org#51755,"SAMPANG BITUNG, JIPUT, PANDEGLANG, BANTEN",3,88,84,172
https://kawalpemilu.org#51755,"SAMPANG BITUNG, JIPUT, PANDEGLANG, BANTEN",4,27,146,173
https://kawalpemilu.org#51755,"SAMPANG BITUNG, JIPUT, PANDEGLANG, BANTEN",5,34,126,160
https://kawalpemilu.org#51755,"SAMPANG BITUNG, JIPUT, PANDEGLANG, BANTEN",6,65,105,170
https://kawalpemilu.org#51755,"SAMPANG BITUNG, JIPUT, PANDEGLANG, BANTEN",7,23,154,177
https://kawalpemilu.org#51756,"BABADSARI, JIPUT, PANDEGLANG, BANTEN",1,97,103,200
https://kawalpemilu.org#51756,"BABADSARI, JIPUT, PANDEGLANG, BANTEN",2,85,108,193
https://kawalpemilu.org#51756,"BABADSARI, JIPUT, PANDEGLANG, BANTEN",3,57,135,192
https://kawalpemilu.org#51756,"BABADSARI, JIPUT, PANDEGLANG, BANTEN",4,74,107,181
https://kawalpemilu.org#51758,"PANDAT, MANDALAWANGI, PANDEGLANG, BANTEN",1,22,123,145
https://kawalpemilu.org#51758,"PANDAT, MANDALAWANGI, PANDEGLANG, BANTEN",2,36,133,169
https://kawalpemilu.org#51758,"PANDAT, MANDALAWANGI, PANDEGLANG, BANTEN",3,37,136,173
https://kawalpemilu.org#51758,"PANDAT, MANDALAWANGI, PANDEGLANG, BANTEN",4,42,174,216
https://kawalpemilu.org#51758,"PANDAT, MANDALAWANGI, PANDEGLANG, BANTEN",5,51,160,211
https://kawalpemilu.org#51758,"PANDAT, MANDALAWANGI, PANDEGLANG, BANTEN",6,26,143,169
https://kawalpemilu.org#51758,"PANDAT, MANDALAWANGI, PANDEGLANG, BANTEN",7,35,109,144
https://kawalpemilu.org#51758,"PANDAT, MANDALAWANGI, PANDEGLANG, BANTEN",8,19,129,148
https://kawalpemilu.org#51758,"PANDAT, MANDALAWANGI, PANDEGLANG, BANTEN",10,41,130,171
https://kawalpemilu.org#51758,"PANDAT, MANDALAWANGI, PANDEGLANG, BANTEN",11,46,152,198
https://kawalpemilu.org#51758,"PANDAT, MANDALAWANGI, PANDEGLANG, BANTEN",12,36,112,148
https://kawalpemilu.org#51758,"PANDAT, MANDALAWANGI, PANDEGLANG, BANTEN",13,42,106,148
https://kawalpemilu.org#51758,"PANDAT, MANDALAWANGI, PANDEGLANG, BANTEN",14,50,92,142
https://kawalpemilu.org#51759,"CIKONENG, MANDALAWANGI, PANDEGLANG, BANTEN",1,63,142,205
https://kawalpemilu.org#51759,"CIKONENG, MANDALAWANGI, PANDEGLANG, BANTEN",2,76,128,204
https://kawalpemilu.org#51759,"CIKONENG, MANDALAWANGI, PANDEGLANG, BANTEN",3,80,131,211
https://kawalpemilu.org#51759,"CIKONENG, MANDALAWANGI, PANDEGLANG, BANTEN",4,83,116,199
https://kawalpemilu.org#51759,"CIKONENG, MANDALAWANGI, PANDEGLANG, BANTEN",5,81,121,202
https://kawalpemilu.org#51759,"CIKONENG, MANDALAWANGI, PANDEGLANG, BANTEN",6,91,149,240
https://kawalpemilu.org#51759,"CIKONENG, MANDALAWANGI, PANDEGLANG, BANTEN",7,76,97,173
https://kawalpemilu.org#51759,"CIKONENG, MANDALAWANGI, PANDEGLANG, BANTEN",9,90,85,175
https://kawalpemilu.org#51759,"CIKONENG, MANDALAWANGI, PANDEGLANG, BANTEN",10,79,119,198
https://kawalpemilu.org#51759,"CIKONENG, MANDALAWANGI, PANDEGLANG, BANTEN",11,59,117,176
https://kawalpemilu.org#51759,"CIKONENG, MANDALAWANGI, PANDEGLANG, BANTEN",12,54,136,190
https://kawalpemilu.org#51760,"NEMBOL, MANDALAWANGI, PANDEGLANG, BANTEN",1,46,162,208
https://kawalpemilu.org#51760,"NEMBOL, MANDALAWANGI, PANDEGLANG, BANTEN",2,29,165,194
https://kawalpemilu.org#51760,"NEMBOL, MANDALAWANGI, PANDEGLANG, BANTEN",3,59,129,188
https://kawalpemilu.org#51760,"NEMBOL, MANDALAWANGI, PANDEGLANG, BANTEN",4,36,170,206
https://kawalpemilu.org#51760,"NEMBOL, MANDALAWANGI, PANDEGLANG, BANTEN",5,46,130,176
https://kawalpemilu.org#51760,"NEMBOL, MANDALAWANGI, PANDEGLANG, BANTEN",6,53,83,136
https://kawalpemilu.org#51760,"NEMBOL, MANDALAWANGI, PANDEGLANG, BANTEN",7,28,128,156
https://kawalpemilu.org#51760,"NEMBOL, MANDALAWANGI, PANDEGLANG, BANTEN",8,37,166,203
https://kawalpemilu.org#51760,"NEMBOL, MANDALAWANGI, PANDEGLANG, BANTEN",9,36,138,174
https://kawalpemilu.org#51760,"NEMBOL, MANDALAWANGI, PANDEGLANG, BANTEN",10,46,105,151
https://kawalpemilu.org#51760,"NEMBOL, MANDALAWANGI, PANDEGLANG, BANTEN",11,25,104,129
https://kawalpemilu.org#51760,"NEMBOL, MANDALAWANGI, PANDEGLANG, BANTEN",12,44,91,135
https://kawalpemilu.org#51760,"NEMBOL, MANDALAWANGI, PANDEGLANG, BANTEN",13,38,179,217
https://kawalpemilu.org#51760,"NEMBOL, MANDALAWANGI, PANDEGLANG, BANTEN",14,42,140,182
https://kawalpemilu.org#51761,"KURUNGKAMBING, MANDALAWANGI, PANDEGLANG, BANTEN",1,69,107,176
https://kawalpemilu.org#51761,"KURUNGKAMBING, MANDALAWANGI, PANDEGLANG, BANTEN",2,61,150,211
https://kawalpemilu.org#51761,"KURUNGKAMBING, MANDALAWANGI, PANDEGLANG, BANTEN",3,32,134,166
https://kawalpemilu.org#51761,"KURUNGKAMBING, MANDALAWANGI, PANDEGLANG, BANTEN",4,60,103,163
https://kawalpemilu.org#51761,"KURUNGKAMBING, MANDALAWANGI, PANDEGLANG, BANTEN",5,46,148,194
https://kawalpemilu.org#51761,"KURUNGKAMBING, MANDALAWANGI, PANDEGLANG, BANTEN",6,54,92,146
https://kawalpemilu.org#51761,"KURUNGKAMBING, MANDALAWANGI, PANDEGLANG, BANTEN",7,49,113,162
https://kawalpemilu.org#51761,"KURUNGKAMBING, MANDALAWANGI, PANDEGLANG, BANTEN",8,33,133,166
https://kawalpemilu.org#51762,"MANDALAWANGI, MANDALAWANGI, PANDEGLANG, BANTEN",1,37,180,217
https://kawalpemilu.org#51762,"MANDALAWANGI, MANDALAWANGI, PANDEGLANG, BANTEN",2,48,175,223
https://kawalpemilu.org#51762,"MANDALAWANGI, MANDALAWANGI, PANDEGLANG, BANTEN",3,69,167,236
https://kawalpemilu.org#51762,"MANDALAWANGI, MANDALAWANGI, PANDEGLANG, BANTEN",4,34,192,226
https://kawalpemilu.org#51762,"MANDALAWANGI, MANDALAWANGI, PANDEGLANG, BANTEN",5,52,139,191
https://kawalpemilu.org#51762,"MANDALAWANGI, MANDALAWANGI, PANDEGLANG, BANTEN",6,60,91,151
https://kawalpemilu.org#51762,"MANDALAWANGI, MANDALAWANGI, PANDEGLANG, BANTEN",7,71,117,188
https://kawalpemilu.org#51762,"MANDALAWANGI, MANDALAWANGI, PANDEGLANG, BANTEN",8,74,145,219
https://kawalpemilu.org#51762,"MANDALAWANGI, MANDALAWANGI, PANDEGLANG, BANTEN",9,43,204,247
https://kawalpemilu.org#51762,"MANDALAWANGI, MANDALAWANGI, PANDEGLANG, BANTEN",10,41,88,129
https://kawalpemilu.org#51763,"SINARJAYA, MANDALAWANGI, PANDEGLANG, BANTEN",1,59,121,180
https://kawalpemilu.org#51763,"SINARJAYA, MANDALAWANGI, PANDEGLANG, BANTEN",2,35,152,187
https://kawalpemilu.org#51763,"SINARJAYA, MANDALAWANGI, PANDEGLANG, BANTEN",4,23,132,155
https://kawalpemilu.org#51763,"SINARJAYA, MANDALAWANGI, PANDEGLANG, BANTEN",5,42,102,144
https://kawalpemilu.org#51763,"SINARJAYA, MANDALAWANGI, PANDEGLANG, BANTEN",6,36,132,168
https://kawalpemilu.org#51763,"SINARJAYA, MANDALAWANGI, PANDEGLANG, BANTEN",7,59,116,175
https://kawalpemilu.org#51763,"SINARJAYA, MANDALAWANGI, PANDEGLANG, BANTEN",8,69,89,158
https://kawalpemilu.org#51763,"SINARJAYA, MANDALAWANGI, PANDEGLANG, BANTEN",9,25,133,158
https://kawalpemilu.org#51763,"SINARJAYA, MANDALAWANGI, PANDEGLANG, BANTEN",10,44,140,184
https://kawalpemilu.org#51763,"SINARJAYA, MANDALAWANGI, PANDEGLANG, BANTEN",11,31,168,199
https://kawalpemilu.org#51763,"SINARJAYA, MANDALAWANGI, PANDEGLANG, BANTEN",12,39,156,195
https://kawalpemilu.org#51763,"SINARJAYA, MANDALAWANGI, PANDEGLANG, BANTEN",13,45,73,118
https://kawalpemilu.org#51763,"SINARJAYA, MANDALAWANGI, PANDEGLANG, BANTEN",14,53,76,129
https://kawalpemilu.org#51764,"SIRNAGALIH, MANDALAWANGI, PANDEGLANG, BANTEN",1,23,154,177
https://kawalpemilu.org#51764,"SIRNAGALIH, MANDALAWANGI, PANDEGLANG, BANTEN",2,24,145,169
https://kawalpemilu.org#51764,"SIRNAGALIH, MANDALAWANGI, PANDEGLANG, BANTEN",3,53,152,205
https://kawalpemilu.org#51764,"SIRNAGALIH, MANDALAWANGI, PANDEGLANG, BANTEN",4,70,136,206
https://kawalpemilu.org#51764,"SIRNAGALIH, MANDALAWANGI, PANDEGLANG, BANTEN",5,49,92,141
https://kawalpemilu.org#51764,"SIRNAGALIH, MANDALAWANGI, PANDEGLANG, BANTEN",6,57,132,189
https://kawalpemilu.org#51764,"SIRNAGALIH, MANDALAWANGI, PANDEGLANG, BANTEN",7,85,166,251
https://kawalpemilu.org#51764,"SIRNAGALIH, MANDALAWANGI, PANDEGLANG, BANTEN",8,39,137,176
https://kawalpemilu.org#51764,"SIRNAGALIH, MANDALAWANGI, PANDEGLANG, BANTEN",9,43,122,165
https://kawalpemilu.org#51764,"SIRNAGALIH, MANDALAWANGI, PANDEGLANG, BANTEN",10,53,110,163
https://kawalpemilu.org#51765,"CIKUMBUEN, MANDALAWANGI, PANDEGLANG, BANTEN",1,52,112,164
https://kawalpemilu.org#51765,"CIKUMBUEN, MANDALAWANGI, PANDEGLANG, BANTEN",2,67,135,202
https://kawalpemilu.org#51765,"CIKUMBUEN, MANDALAWANGI, PANDEGLANG, BANTEN",3,79,125,204
https://kawalpemilu.org#51765,"CIKUMBUEN, MANDALAWANGI, PANDEGLANG, BANTEN",4,59,117,176
https://kawalpemilu.org#51765,"CIKUMBUEN, MANDALAWANGI, PANDEGLANG, BANTEN",5,71,136,207
https://kawalpemilu.org#51765,"CIKUMBUEN, MANDALAWANGI, PANDEGLANG, BANTEN",6,23,146,169
https://kawalpemilu.org#51765,"CIKUMBUEN, MANDALAWANGI, PANDEGLANG, BANTEN",7,45,81,126
https://kawalpemilu.org#51765,"CIKUMBUEN, MANDALAWANGI, PANDEGLANG, BANTEN",8,39,119,158
https://kawalpemilu.org#51765,"CIKUMBUEN, MANDALAWANGI, PANDEGLANG, BANTEN",9,63,113,176
https://kawalpemilu.org#51765,"CIKUMBUEN, MANDALAWANGI, PANDEGLANG, BANTEN",10,36,138,174
https://kawalpemilu.org#51765,"CIKUMBUEN, MANDALAWANGI, PANDEGLANG, BANTEN",11,67,59,126
https://kawalpemilu.org#51765,"CIKUMBUEN, MANDALAWANGI, PANDEGLANG, BANTEN",12,72,64,136
https://kawalpemilu.org#51766,"RAMEA, MANDALAWANGI, PANDEGLANG, BANTEN",1,58,147,205
https://kawalpemilu.org#51766,"RAMEA, MANDALAWANGI, PANDEGLANG, BANTEN",2,19,176,195
https://kawalpemilu.org#51766,"RAMEA, MANDALAWANGI, PANDEGLANG, BANTEN",3,24,149,173
https://kawalpemilu.org#51766,"RAMEA, MANDALAWANGI, PANDEGLANG, BANTEN",4,30,165,195
https://kawalpemilu.org#51766,"RAMEA, MANDALAWANGI, PANDEGLANG, BANTEN",5,29,170,199
https://kawalpemilu.org#51766,"RAMEA, MANDALAWANGI, PANDEGLANG, BANTEN",6,34,149,183
https://kawalpemilu.org#51766,"RAMEA, MANDALAWANGI, PANDEGLANG, BANTEN",7,24,119,143
https://kawalpemilu.org#51766,"RAMEA, MANDALAWANGI, PANDEGLANG, BANTEN",8,36,102,138
https://kawalpemilu.org#51766,"RAMEA, MANDALAWANGI, PANDEGLANG, BANTEN",9,63,91,154
https://kawalpemilu.org#51766,"RAMEA, MANDALAWANGI, PANDEGLANG, BANTEN",11,36,173,209
https://kawalpemilu.org#51767,"GUNUNGSARI, MANDALAWANGI, PANDEGLANG, BANTEN",1,17,128,145
https://kawalpemilu.org#51767,"GUNUNGSARI, MANDALAWANGI, PANDEGLANG, BANTEN",2,62,148,210
https://kawalpemilu.org#51767,"GUNUNGSARI, MANDALAWANGI, PANDEGLANG, BANTEN",3,19,155,174
https://kawalpemilu.org#51767,"GUNUNGSARI, MANDALAWANGI, PANDEGLANG, BANTEN",4,21,162,183
https://kawalpemilu.org#51767,"GUNUNGSARI, MANDALAWANGI, PANDEGLANG, BANTEN",5,33,142,175
https://kawalpemilu.org#51767,"GUNUNGSARI, MANDALAWANGI, PANDEGLANG, BANTEN",6,22,156,178
https://kawalpemilu.org#51767,"GUNUNGSARI, MANDALAWANGI, PANDEGLANG, BANTEN",7,22,163,185
https://kawalpemilu.org#51767,"GUNUNGSARI, MANDALAWANGI, PANDEGLANG, BANTEN",8,56,156,212
https://kawalpemilu.org#51767,"GUNUNGSARI, MANDALAWANGI, PANDEGLANG, BANTEN",9,43,182,225
https://kawalpemilu.org#51767,"GUNUNGSARI, MANDALAWANGI, PANDEGLANG, BANTEN",10,58,134,192
https://kawalpemilu.org#51768,"PANJANGJAYA, MANDALAWANGI, PANDEGLANG, BANTEN",1,26,140,166
https://kawalpemilu.org#51768,"PANJANGJAYA, MANDALAWANGI, PANDEGLANG, BANTEN",2,24,131,155
https://kawalpemilu.org#51768,"PANJANGJAYA, MANDALAWANGI, PANDEGLANG, BANTEN",3,30,81,111
https://kawalpemilu.org#51768,"PANJANGJAYA, MANDALAWANGI, PANDEGLANG, BANTEN",4,39,126,165
https://kawalpemilu.org#51768,"PANJANGJAYA, MANDALAWANGI, PANDEGLANG, BANTEN",5,83,109,192
https://kawalpemilu.org#51768,"PANJANGJAYA, MANDALAWANGI, PANDEGLANG, BANTEN",6,18,129,147
https://kawalpemilu.org#51768,"PANJANGJAYA, MANDALAWANGI, PANDEGLANG, BANTEN",7,26,113,139
https://kawalpemilu.org#51768,"PANJANGJAYA, MANDALAWANGI, PANDEGLANG, BANTEN",8,68,136,204
https://kawalpemilu.org#51768,"PANJANGJAYA, MANDALAWANGI, PANDEGLANG, BANTEN",9,38,152,190
https://kawalpemilu.org#51768,"PANJANGJAYA, MANDALAWANGI, PANDEGLANG, BANTEN",10,43,77,120
https://kawalpemilu.org#51769,"GIRIPAWANA, MANDALAWANGI, PANDEGLANG, BANTEN",1,38,204,242
https://kawalpemilu.org#51769,"GIRIPAWANA, MANDALAWANGI, PANDEGLANG, BANTEN",2,26,146,172
https://kawalpemilu.org#51769,"GIRIPAWANA, MANDALAWANGI, PANDEGLANG, BANTEN",3,37,135,172
https://kawalpemilu.org#51769,"GIRIPAWANA, MANDALAWANGI, PANDEGLANG, BANTEN",4,18,135,153
https://kawalpemilu.org#51769,"GIRIPAWANA, MANDALAWANGI, PANDEGLANG, BANTEN",5,25,123,148
https://kawalpemilu.org#51769,"GIRIPAWANA, MANDALAWANGI, PANDEGLANG, BANTEN",6,65,100,165
https://kawalpemilu.org#51769,"GIRIPAWANA, MANDALAWANGI, PANDEGLANG, BANTEN",7,45,161,206
https://kawalpemilu.org#51769,"GIRIPAWANA, MANDALAWANGI, PANDEGLANG, BANTEN",8,26,123,149
https://kawalpemilu.org#51769,"GIRIPAWANA, MANDALAWANGI, PANDEGLANG, BANTEN",9,39,118,157
https://kawalpemilu.org#51769,"GIRIPAWANA, MANDALAWANGI, PANDEGLANG, BANTEN",10,43,98,141
https://kawalpemilu.org#51769,"GIRIPAWANA, MANDALAWANGI, PANDEGLANG, BANTEN",11,46,164,210
https://kawalpemilu.org#51770,"MANDALASARI, MANDALAWANGI, PANDEGLANG, BANTEN",1,15,151,166
https://kawalpemilu.org#51770,"MANDALASARI, MANDALAWANGI, PANDEGLANG, BANTEN",2,31,159,190
https://kawalpemilu.org#51770,"MANDALASARI, MANDALAWANGI, PANDEGLANG, BANTEN",3,52,128,180
https://kawalpemilu.org#51770,"MANDALASARI, MANDALAWANGI, PANDEGLANG, BANTEN",4,23,171,194
https://kawalpemilu.org#51770,"MANDALASARI, MANDALAWANGI, PANDEGLANG, BANTEN",5,33,166,199
https://kawalpemilu.org#51770,"MANDALASARI, MANDALAWANGI, PANDEGLANG, BANTEN",6,27,172,199
https://kawalpemilu.org#51770,"MANDALASARI, MANDALAWANGI, PANDEGLANG, BANTEN",7,74,102,176
https://kawalpemilu.org#51770,"MANDALASARI, MANDALAWANGI, PANDEGLANG, BANTEN",8,34,185,219
https://kawalpemilu.org#51771,"CURUGLEMO, MANDALAWANGI, PANDEGLANG, BANTEN",1,44,166,210
https://kawalpemilu.org#51771,"CURUGLEMO, MANDALAWANGI, PANDEGLANG, BANTEN",2,37,156,193
https://kawalpemilu.org#51771,"CURUGLEMO, MANDALAWANGI, PANDEGLANG, BANTEN",3,64,145,209
https://kawalpemilu.org#51771,"CURUGLEMO, MANDALAWANGI, PANDEGLANG, BANTEN",4,59,113,172
https://kawalpemilu.org#51771,"CURUGLEMO, MANDALAWANGI, PANDEGLANG, BANTEN",5,28,147,175
https://kawalpemilu.org#51771,"CURUGLEMO, MANDALAWANGI, PANDEGLANG, BANTEN",6,45,96,141
https://kawalpemilu.org#51771,"CURUGLEMO, MANDALAWANGI, PANDEGLANG, BANTEN",7,41,144,185
https://kawalpemilu.org#51771,"CURUGLEMO, MANDALAWANGI, PANDEGLANG, BANTEN",8,37,105,142
https://kawalpemilu.org#51772,"PARI, MANDALAWANGI, PANDEGLANG, BANTEN",1,58,167,225
https://kawalpemilu.org#51772,"PARI, MANDALAWANGI, PANDEGLANG, BANTEN",2,84,153,237
https://kawalpemilu.org#51772,"PARI, MANDALAWANGI, PANDEGLANG, BANTEN",3,31,198,229
https://kawalpemilu.org#51772,"PARI, MANDALAWANGI, PANDEGLANG, BANTEN",4,17,143,160
https://kawalpemilu.org#51772,"PARI, MANDALAWANGI, PANDEGLANG, BANTEN",5,33,162,195
https://kawalpemilu.org#51772,"PARI, MANDALAWANGI, PANDEGLANG, BANTEN",6,29,156,185
https://kawalpemilu.org#51772,"PARI, MANDALAWANGI, PANDEGLANG, BANTEN",7,20,170,190
https://kawalpemilu.org#51772,"PARI, MANDALAWANGI, PANDEGLANG, BANTEN",8,24,200,224
https://kawalpemilu.org#51772,"PARI, MANDALAWANGI, PANDEGLANG, BANTEN",9,39,177,216
https://kawalpemilu.org#51772,"PARI, MANDALAWANGI, PANDEGLANG, BANTEN",10,60,137,197
https://kawalpemilu.org#51774,"CIMANUK, CIMANUK, PANDEGLANG, BANTEN",1,37,161,198
https://kawalpemilu.org#51774,"CIMANUK, CIMANUK, PANDEGLANG, BANTEN",2,25,195,220
https://kawalpemilu.org#51774,"CIMANUK, CIMANUK, PANDEGLANG, BANTEN",3,42,184,226
https://kawalpemilu.org#51774,"CIMANUK, CIMANUK, PANDEGLANG, BANTEN",4,46,162,208
https://kawalpemilu.org#51774,"CIMANUK, CIMANUK, PANDEGLANG, BANTEN",5,48,141,189
https://kawalpemilu.org#51774,"CIMANUK, CIMANUK, PANDEGLANG, BANTEN",6,21,148,169
https://kawalpemilu.org#51774,"CIMANUK, CIMANUK, PANDEGLANG, BANTEN",7,51,126,177
https://kawalpemilu.org#51774,"CIMANUK, CIMANUK, PANDEGLANG, BANTEN",8,27,152,179
https://kawalpemilu.org#51774,"CIMANUK, CIMANUK, PANDEGLANG, BANTEN",9,35,96,131
https://kawalpemilu.org#51774,"CIMANUK, CIMANUK, PANDEGLANG, BANTEN",10,77,133,210
https://kawalpemilu.org#51774,"CIMANUK, CIMANUK, PANDEGLANG, BANTEN",11,18,138,156
https://kawalpemilu.org#51774,"CIMANUK, CIMANUK, PANDEGLANG, BANTEN",12,76,91,167
https://kawalpemilu.org#51774,"CIMANUK, CIMANUK, PANDEGLANG, BANTEN",13,62,98,160
https://kawalpemilu.org#51774,"CIMANUK, CIMANUK, PANDEGLANG, BANTEN",14,70,134,204
https://kawalpemilu.org#51774,"CIMANUK, CIMANUK, PANDEGLANG, BANTEN",15,83,56,139
https://kawalpemilu.org#51774,"CIMANUK, CIMANUK, PANDEGLANG, BANTEN",16,62,131,193
https://kawalpemilu.org#51775,"BATUBANTAR, CIMANUK, PANDEGLANG, BANTEN",1,45,164,209
https://kawalpemilu.org#51775,"BATUBANTAR, CIMANUK, PANDEGLANG, BANTEN",2,28,157,185
https://kawalpemilu.org#51775,"BATUBANTAR, CIMANUK, PANDEGLANG, BANTEN",3,34,188,222
https://kawalpemilu.org#51775,"BATUBANTAR, CIMANUK, PANDEGLANG, BANTEN",4,31,126,157
https://kawalpemilu.org#51775,"BATUBANTAR, CIMANUK, PANDEGLANG, BANTEN",5,48,173,221
https://kawalpemilu.org#51775,"BATUBANTAR, CIMANUK, PANDEGLANG, BANTEN",6,50,147,197
https://kawalpemilu.org#51775,"BATUBANTAR, CIMANUK, PANDEGLANG, BANTEN",7,37,179,216
https://kawalpemilu.org#51775,"BATUBANTAR, CIMANUK, PANDEGLANG, BANTEN",8,17,171,188
https://kawalpemilu.org#51775,"BATUBANTAR, CIMANUK, PANDEGLANG, BANTEN",9,18,157,175
https://kawalpemilu.org#51775,"BATUBANTAR, CIMANUK, PANDEGLANG, BANTEN",10,16,196,212
https://kawalpemilu.org#51775,"BATUBANTAR, CIMANUK, PANDEGLANG, BANTEN",11,28,132,160
https://kawalpemilu.org#51775,"BATUBANTAR, CIMANUK, PANDEGLANG, BANTEN",12,21,141,162
https://kawalpemilu.org#51775,"BATUBANTAR, CIMANUK, PANDEGLANG, BANTEN",13,49,189,238
https://kawalpemilu.org#51775,"BATUBANTAR, CIMANUK, PANDEGLANG, BANTEN",14,38,110,148
https://kawalpemilu.org#51776,"KADUBUNGBANG, CIMANUK, PANDEGLANG, BANTEN",1,40,191,231
https://kawalpemilu.org#51776,"KADUBUNGBANG, CIMANUK, PANDEGLANG, BANTEN",2,64,169,233
https://kawalpemilu.org#51776,"KADUBUNGBANG, CIMANUK, PANDEGLANG, BANTEN",3,53,130,183
https://kawalpemilu.org#51776,"KADUBUNGBANG, CIMANUK, PANDEGLANG, BANTEN",4,28,146,174
https://kawalpemilu.org#51776,"KADUBUNGBANG, CIMANUK, PANDEGLANG, BANTEN",5,33,145,178
https://kawalpemilu.org#51776,"KADUBUNGBANG, CIMANUK, PANDEGLANG, BANTEN",6,17,186,203
https://kawalpemilu.org#51776,"KADUBUNGBANG, CIMANUK, PANDEGLANG, BANTEN",7,11,181,192
https://kawalpemilu.org#51776,"KADUBUNGBANG, CIMANUK, PANDEGLANG, BANTEN",8,19,199,218
https://kawalpemilu.org#51776,"KADUBUNGBANG, CIMANUK, PANDEGLANG, BANTEN",9,25,179,204
https://kawalpemilu.org#51776,"KADUBUNGBANG, CIMANUK, PANDEGLANG, BANTEN",10,21,153,174
https://kawalpemilu.org#51776,"KADUBUNGBANG, CIMANUK, PANDEGLANG, BANTEN",11,37,157,194
https://kawalpemilu.org#51776,"KADUBUNGBANG, CIMANUK, PANDEGLANG, BANTEN",12,74,136,210
https://kawalpemilu.org#51776,"KADUBUNGBANG, CIMANUK, PANDEGLANG, BANTEN",13,41,156,197
https://kawalpemilu.org#51776,"KADUBUNGBANG, CIMANUK, PANDEGLANG, BANTEN",14,33,183,216
https://kawalpemilu.org#51776,"KADUBUNGBANG, CIMANUK, PANDEGLANG, BANTEN",15,21,118,139
https://kawalpemilu.org#51777,"KUPAHANDAP, CIMANUK, PANDEGLANG, BANTEN",1,13,110,123
https://kawalpemilu.org#51777,"KUPAHANDAP, CIMANUK, PANDEGLANG, BANTEN",2,14,96,110
https://kawalpemilu.org#51777,"KUPAHANDAP, CIMANUK, PANDEGLANG, BANTEN",3,21,136,157
https://kawalpemilu.org#51777,"KUPAHANDAP, CIMANUK, PANDEGLANG, BANTEN",4,15,91,106
https://kawalpemilu.org#51777,"KUPAHANDAP, CIMANUK, PANDEGLANG, BANTEN",5,13,108,121
https://kawalpemilu.org#51777,"KUPAHANDAP, CIMANUK, PANDEGLANG, BANTEN",6,18,115,133
https://kawalpemilu.org#51777,"KUPAHANDAP, CIMANUK, PANDEGLANG, BANTEN",8,21,159,180
https://kawalpemilu.org#51777,"KUPAHANDAP, CIMANUK, PANDEGLANG, BANTEN",9,11,124,135
https://kawalpemilu.org#51777,"KUPAHANDAP, CIMANUK, PANDEGLANG, BANTEN",10,46,182,228
https://kawalpemilu.org#51777,"KUPAHANDAP, CIMANUK, PANDEGLANG, BANTEN",11,12,130,142
https://kawalpemilu.org#51777,"KUPAHANDAP, CIMANUK, PANDEGLANG, BANTEN",12,11,128,139
https://kawalpemilu.org#51778,"DALEMBALAR, CIMANUK, PANDEGLANG, BANTEN",1,29,214,243
https://kawalpemilu.org#51778,"DALEMBALAR, CIMANUK, PANDEGLANG, BANTEN",2,33,205,238
https://kawalpemilu.org#51778,"DALEMBALAR, CIMANUK, PANDEGLANG, BANTEN",3,15,104,119
https://kawalpemilu.org#51778,"DALEMBALAR, CIMANUK, PANDEGLANG, BANTEN",4,27,169,196
https://kawalpemilu.org#51778,"DALEMBALAR, CIMANUK, PANDEGLANG, BANTEN",5,30,189,219
https://kawalpemilu.org#51778,"DALEMBALAR, CIMANUK, PANDEGLANG, BANTEN",6,17,129,146
https://kawalpemilu.org#51778,"DALEMBALAR, CIMANUK, PANDEGLANG, BANTEN",7,24,146,170
https://kawalpemilu.org#51778,"DALEMBALAR, CIMANUK, PANDEGLANG, BANTEN",8,13,129,142
https://kawalpemilu.org#51778,"DALEMBALAR, CIMANUK, PANDEGLANG, BANTEN",9,20,136,156
https://kawalpemilu.org#51778,"DALEMBALAR, CIMANUK, PANDEGLANG, BANTEN",10,25,105,130
https://kawalpemilu.org#51778,"DALEMBALAR, CIMANUK, PANDEGLANG, BANTEN",11,16,104,120
https://kawalpemilu.org#51778,"DALEMBALAR, CIMANUK, PANDEGLANG, BANTEN",12,29,132,161
https://kawalpemilu.org#51779,"KADUMADANG, CIMANUK, PANDEGLANG, BANTEN",1,23,217,240
https://kawalpemilu.org#51779,"KADUMADANG, CIMANUK, PANDEGLANG, BANTEN",2,21,208,229
https://kawalpemilu.org#51779,"KADUMADANG, CIMANUK, PANDEGLANG, BANTEN",3,21,204,225
https://kawalpemilu.org#51779,"KADUMADANG, CIMANUK, PANDEGLANG, BANTEN",4,24,206,230
https://kawalpemilu.org#51779,"KADUMADANG, CIMANUK, PANDEGLANG, BANTEN",5,25,160,185
https://kawalpemilu.org#51779,"KADUMADANG, CIMANUK, PANDEGLANG, BANTEN",6,16,219,235
https://kawalpemilu.org#51779,"KADUMADANG, CIMANUK, PANDEGLANG, BANTEN",7,27,133,160
https://kawalpemilu.org#51779,"KADUMADANG, CIMANUK, PANDEGLANG, BANTEN",8,29,178,207
https://kawalpemilu.org#51779,"KADUMADANG, CIMANUK, PANDEGLANG, BANTEN",9,23,171,194
https://kawalpemilu.org#51779,"KADUMADANG, CIMANUK, PANDEGLANG, BANTEN",10,19,194,213
https://kawalpemilu.org#51779,"KADUMADANG, CIMANUK, PANDEGLANG, BANTEN",11,8,178,186
https://kawalpemilu.org#51779,"KADUMADANG, CIMANUK, PANDEGLANG, BANTEN",12,12,159,171
https://kawalpemilu.org#51780,"ROCEK, CIMANUK, PANDEGLANG, BANTEN",1,94,135,229
https://kawalpemilu.org#51780,"ROCEK, CIMANUK, PANDEGLANG, BANTEN",2,44,181,225
https://kawalpemilu.org#51780,"ROCEK, CIMANUK, PANDEGLANG, BANTEN",3,57,168,225
https://kawalpemilu.org#51780,"ROCEK, CIMANUK, PANDEGLANG, BANTEN",4,55,144,199
https://kawalpemilu.org#51780,"ROCEK, CIMANUK, PANDEGLANG, BANTEN",5,38,137,175
https://kawalpemilu.org#51780,"ROCEK, CIMANUK, PANDEGLANG, BANTEN",6,48,137,185
https://kawalpemilu.org#51780,"ROCEK, CIMANUK, PANDEGLANG, BANTEN",7,49,168,217
https://kawalpemilu.org#51780,"ROCEK, CIMANUK, PANDEGLANG, BANTEN",8,16,142,158
https://kawalpemilu.org#51780,"ROCEK, CIMANUK, PANDEGLANG, BANTEN",9,28,163,191
https://kawalpemilu.org#51780,"ROCEK, CIMANUK, PANDEGLANG, BANTEN",10,55,117,172
https://kawalpemilu.org#51780,"ROCEK, CIMANUK, PANDEGLANG, BANTEN",11,44,198,242
https://kawalpemilu.org#51780,"ROCEK, CIMANUK, PANDEGLANG, BANTEN",12,31,191,222
https://kawalpemilu.org#51781,"KADUDODOL, CIMANUK, PANDEGLANG, BANTEN",1,50,135,185
https://kawalpemilu.org#51781,"KADUDODOL, CIMANUK, PANDEGLANG, BANTEN",2,42,142,184
https://kawalpemilu.org#51781,"KADUDODOL, CIMANUK, PANDEGLANG, BANTEN",3,63,158,221
https://kawalpemilu.org#51781,"KADUDODOL, CIMANUK, PANDEGLANG, BANTEN",4,34,138,172
https://kawalpemilu.org#51781,"KADUDODOL, CIMANUK, PANDEGLANG, BANTEN",5,48,112,160
https://kawalpemilu.org#51781,"KADUDODOL, CIMANUK, PANDEGLANG, BANTEN",6,73,98,171
https://kawalpemilu.org#51781,"KADUDODOL, CIMANUK, PANDEGLANG, BANTEN",7,22,135,157
https://kawalpemilu.org#51781,"KADUDODOL, CIMANUK, PANDEGLANG, BANTEN",8,87,150,237
https://kawalpemilu.org#51781,"KADUDODOL, CIMANUK, PANDEGLANG, BANTEN",9,56,153,209
https://kawalpemilu.org#51781,"KADUDODOL, CIMANUK, PANDEGLANG, BANTEN",10,54,130,184
https://kawalpemilu.org#51782,"GUNUNGDATAR, CIMANUK, PANDEGLANG, BANTEN",1,36,147,183
https://kawalpemilu.org#51782,"GUNUNGDATAR, CIMANUK, PANDEGLANG, BANTEN",2,34,138,172
https://kawalpemilu.org#51782,"GUNUNGDATAR, CIMANUK, PANDEGLANG, BANTEN",3,80,131,211
https://kawalpemilu.org#51782,"GUNUNGDATAR, CIMANUK, PANDEGLANG, BANTEN",4,71,93,164
https://kawalpemilu.org#51782,"GUNUNGDATAR, CIMANUK, PANDEGLANG, BANTEN",5,54,86,140
https://kawalpemilu.org#51782,"GUNUNGDATAR, CIMANUK, PANDEGLANG, BANTEN",6,37,121,158
https://kawalpemilu.org#51782,"GUNUNGDATAR, CIMANUK, PANDEGLANG, BANTEN",7,70,164,234
https://kawalpemilu.org#51782,"GUNUNGDATAR, CIMANUK, PANDEGLANG, BANTEN",8,34,151,185
https://kawalpemilu.org#51783,"SEKONG, CIMANUK, PANDEGLANG, BANTEN",1,20,116,136
https://kawalpemilu.org#51783,"SEKONG, CIMANUK, PANDEGLANG, BANTEN",2,49,159,208
https://kawalpemilu.org#51783,"SEKONG, CIMANUK, PANDEGLANG, BANTEN",3,40,120,160
https://kawalpemilu.org#51783,"SEKONG, CIMANUK, PANDEGLANG, BANTEN",4,28,88,116
https://kawalpemilu.org#51783,"SEKONG, CIMANUK, PANDEGLANG, BANTEN",5,32,171,203
https://kawalpemilu.org#51783,"SEKONG, CIMANUK, PANDEGLANG, BANTEN",6,36,134,170
https://kawalpemilu.org#51783,"SEKONG, CIMANUK, PANDEGLANG, BANTEN",7,30,146,176
https://kawalpemilu.org#51783,"SEKONG, CIMANUK, PANDEGLANG, BANTEN",8,18,124,142
https://kawalpemilu.org#51784,"GUNUNGCUPU, CIMANUK, PANDEGLANG, BANTEN",1,77,63,140
https://kawalpemilu.org#51784,"GUNUNGCUPU, CIMANUK, PANDEGLANG, BANTEN",2,27,88,115
https://kawalpemilu.org#51784,"GUNUNGCUPU, CIMANUK, PANDEGLANG, BANTEN",3,51,107,158
https://kawalpemilu.org#51784,"GUNUNGCUPU, CIMANUK, PANDEGLANG, BANTEN",4,64,43,107
https://kawalpemilu.org#51784,"GUNUNGCUPU, CIMANUK, PANDEGLANG, BANTEN",5,47,121,168
https://kawalpemilu.org#51784,"GUNUNGCUPU, CIMANUK, PANDEGLANG, BANTEN",6,64,76,140
https://kawalpemilu.org#51784,"GUNUNGCUPU, CIMANUK, PANDEGLANG, BANTEN",7,69,55,124
https://kawalpemilu.org#51784,"GUNUNGCUPU, CIMANUK, PANDEGLANG, BANTEN",8,58,77,135
https://kawalpemilu.org#51784,"GUNUNGCUPU, CIMANUK, PANDEGLANG, BANTEN",9,67,46,113
https://kawalpemilu.org#51786,"CAMPAKA, KADUHEJO, PANDEGLANG, BANTEN",1,87,97,184
https://kawalpemilu.org#51786,"CAMPAKA, KADUHEJO, PANDEGLANG, BANTEN",2,76,167,243
https://kawalpemilu.org#51786,"CAMPAKA, KADUHEJO, PANDEGLANG, BANTEN",3,43,143,186
https://kawalpemilu.org#51786,"CAMPAKA, KADUHEJO, PANDEGLANG, BANTEN",4,50,155,205
https://kawalpemilu.org#51786,"CAMPAKA, KADUHEJO, PANDEGLANG, BANTEN",5,42,132,174
https://kawalpemilu.org#51786,"CAMPAKA, KADUHEJO, PANDEGLANG, BANTEN",6,61,107,168
https://kawalpemilu.org#51786,"CAMPAKA, KADUHEJO, PANDEGLANG, BANTEN",7,28,171,199
https://kawalpemilu.org#51786,"CAMPAKA, KADUHEJO, PANDEGLANG, BANTEN",8,37,206,243
https://kawalpemilu.org#51786,"CAMPAKA, KADUHEJO, PANDEGLANG, BANTEN",9,16,179,195
https://kawalpemilu.org#51786,"CAMPAKA, KADUHEJO, PANDEGLANG, BANTEN",10,20,185,205
https://kawalpemilu.org#51787,"BANYUMUNDU, KADUHEJO, PANDEGLANG, BANTEN",1,49,145,194
https://kawalpemilu.org#51787,"BANYUMUNDU, KADUHEJO, PANDEGLANG, BANTEN",2,40,133,173
https://kawalpemilu.org#51787,"BANYUMUNDU, KADUHEJO, PANDEGLANG, BANTEN",3,6,95,101
https://kawalpemilu.org#51787,"BANYUMUNDU, KADUHEJO, PANDEGLANG, BANTEN",4,58,125,183
https://kawalpemilu.org#51787,"BANYUMUNDU, KADUHEJO, PANDEGLANG, BANTEN",5,29,157,187
https://kawalpemilu.org#51787,"BANYUMUNDU, KADUHEJO, PANDEGLANG, BANTEN",6,44,164,208
https://kawalpemilu.org#51788,"MANDALASARI, KADUHEJO, PANDEGLANG, BANTEN",1,39,174,213
https://kawalpemilu.org#51788,"MANDALASARI, KADUHEJO, PANDEGLANG, BANTEN",2,10,138,148
https://kawalpemilu.org#51788,"MANDALASARI, KADUHEJO, PANDEGLANG, BANTEN",3,22,153,175
https://kawalpemilu.org#51788,"MANDALASARI, KADUHEJO, PANDEGLANG, BANTEN",4,21,105,126
https://kawalpemilu.org#51788,"MANDALASARI, KADUHEJO, PANDEGLANG, BANTEN",5,48,194,242
https://kawalpemilu.org#51788,"MANDALASARI, KADUHEJO, PANDEGLANG, BANTEN",6,55,184,239
https://kawalpemilu.org#51788,"MANDALASARI, KADUHEJO, PANDEGLANG, BANTEN",7,58,146,204
https://kawalpemilu.org#51788,"MANDALASARI, KADUHEJO, PANDEGLANG, BANTEN",8,26,160,186
https://kawalpemilu.org#51788,"MANDALASARI, KADUHEJO, PANDEGLANG, BANTEN",9,46,83,129
https://kawalpemilu.org#51788,"MANDALASARI, KADUHEJO, PANDEGLANG, BANTEN",10,31,121,152
https://kawalpemilu.org#51788,"MANDALASARI, KADUHEJO, PANDEGLANG, BANTEN",11,38,139,177
https://kawalpemilu.org#51788,"MANDALASARI, KADUHEJO, PANDEGLANG, BANTEN",12,24,103,127
https://kawalpemilu.org#51788,"MANDALASARI, KADUHEJO, PANDEGLANG, BANTEN",13,38,118,156
https://kawalpemilu.org#51788,"MANDALASARI, KADUHEJO, PANDEGLANG, BANTEN",14,40,113,153
https://kawalpemilu.org#51788,"MANDALASARI, KADUHEJO, PANDEGLANG, BANTEN",15,43,110,153
https://kawalpemilu.org#51788,"MANDALASARI, KADUHEJO, PANDEGLANG, BANTEN",16,21,161,182
https://kawalpemilu.org#51788,"MANDALASARI, KADUHEJO, PANDEGLANG, BANTEN",17,15,80,95
https://kawalpemilu.org#51789,"SUKASARI, KADUHEJO, PANDEGLANG, BANTEN",1,40,140,180
https://kawalpemilu.org#51789,"SUKASARI, KADUHEJO, PANDEGLANG, BANTEN",2,90,118,208
https://kawalpemilu.org#51789,"SUKASARI, KADUHEJO, PANDEGLANG, BANTEN",3,32,95,127
https://kawalpemilu.org#51789,"SUKASARI, KADUHEJO, PANDEGLANG, BANTEN",4,40,107,147
https://kawalpemilu.org#51789,"SUKASARI, KADUHEJO, PANDEGLANG, BANTEN",5,41,156,197
https://kawalpemilu.org#51789,"SUKASARI, KADUHEJO, PANDEGLANG, BANTEN",6,41,152,193
https://kawalpemilu.org#51789,"SUKASARI, KADUHEJO, PANDEGLANG, BANTEN",7,36,142,178
https://kawalpemilu.org#51789,"SUKASARI, KADUHEJO, PANDEGLANG, BANTEN",8,43,137,180
https://kawalpemilu.org#51789,"SUKASARI, KADUHEJO, PANDEGLANG, BANTEN",9,45,127,172
https://kawalpemilu.org#51789,"SUKASARI, KADUHEJO, PANDEGLANG, BANTEN",10,32,203,235
https://kawalpemilu.org#51789,"SUKASARI, KADUHEJO, PANDEGLANG, BANTEN",11,28,164,192
https://kawalpemilu.org#51789,"SUKASARI, KADUHEJO, PANDEGLANG, BANTEN",12,49,143,192
https://kawalpemilu.org#51789,"SUKASARI, KADUHEJO, PANDEGLANG, BANTEN",13,30,117,147
https://kawalpemilu.org#51789,"SUKASARI, KADUHEJO, PANDEGLANG, BANTEN",14,41,122,163
https://kawalpemilu.org#51789,"SUKASARI, KADUHEJO, PANDEGLANG, BANTEN",15,22,103,125
https://kawalpemilu.org#51789,"SUKASARI, KADUHEJO, PANDEGLANG, BANTEN",16,32,131,163
https://kawalpemilu.org#51789,"SUKASARI, KADUHEJO, PANDEGLANG, BANTEN",17,22,104,126
https://kawalpemilu.org#51789,"SUKASARI, KADUHEJO, PANDEGLANG, BANTEN",18,33,116,149
https://kawalpemilu.org#51789,"SUKASARI, KADUHEJO, PANDEGLANG, BANTEN",19,18,136,154
https://kawalpemilu.org#51789,"SUKASARI, KADUHEJO, PANDEGLANG, BANTEN",20,28,157,185
https://kawalpemilu.org#51790,"SANINTEN, KADUHEJO, PANDEGLANG, BANTEN",1,30,188,218
https://kawalpemilu.org#51790,"SANINTEN, KADUHEJO, PANDEGLANG, BANTEN",2,49,68,117
https://kawalpemilu.org#51790,"SANINTEN, KADUHEJO, PANDEGLANG, BANTEN",3,16,88,104
https://kawalpemilu.org#51790,"SANINTEN, KADUHEJO, PANDEGLANG, BANTEN",4,131,111,242
https://kawalpemilu.org#51790,"SANINTEN, KADUHEJO, PANDEGLANG, BANTEN",5,52,143,195
https://kawalpemilu.org#51790,"SANINTEN, KADUHEJO, PANDEGLANG, BANTEN",6,16,173,189
https://kawalpemilu.org#51790,"SANINTEN, KADUHEJO, PANDEGLANG, BANTEN",7,34,142,176
https://kawalpemilu.org#51790,"SANINTEN, KADUHEJO, PANDEGLANG, BANTEN",8,20,164,184
https://kawalpemilu.org#51790,"SANINTEN, KADUHEJO, PANDEGLANG, BANTEN",9,27,181,208
https://kawalpemilu.org#51790,"SANINTEN, KADUHEJO, PANDEGLANG, BANTEN",10,23,180,203
https://kawalpemilu.org#51790,"SANINTEN, KADUHEJO, PANDEGLANG, BANTEN",11,18,197,215
https://kawalpemilu.org#51790,"SANINTEN, KADUHEJO, PANDEGLANG, BANTEN",12,14,159,173
https://kawalpemilu.org#51790,"SANINTEN, KADUHEJO, PANDEGLANG, BANTEN",13,27,158,185
https://kawalpemilu.org#51790,"SANINTEN, KADUHEJO, PANDEGLANG, BANTEN",14,55,166,221
https://kawalpemilu.org#51790,"SANINTEN, KADUHEJO, PANDEGLANG, BANTEN",15,49,162,211
https://kawalpemilu.org#51790,"SANINTEN, KADUHEJO, PANDEGLANG, BANTEN",16,47,92,139
https://kawalpemilu.org#51790,"SANINTEN, KADUHEJO, PANDEGLANG, BANTEN",17,21,188,209
https://kawalpemilu.org#51790,"SANINTEN, KADUHEJO, PANDEGLANG, BANTEN",18,66,188,254
https://kawalpemilu.org#51791,"PALURAHAN, KADUHEJO, PANDEGLANG, BANTEN",1,46,142,188
https://kawalpemilu.org#51791,"PALURAHAN, KADUHEJO, PANDEGLANG, BANTEN",2,16,121,137
https://kawalpemilu.org#51791,"PALURAHAN, KADUHEJO, PANDEGLANG, BANTEN",3,41,162,203
https://kawalpemilu.org#51791,"PALURAHAN, KADUHEJO, PANDEGLANG, BANTEN",4,44,164,208
https://kawalpemilu.org#51791,"PALURAHAN, KADUHEJO, PANDEGLANG, BANTEN",5,26,157,183
https://kawalpemilu.org#51791,"PALURAHAN, KADUHEJO, PANDEGLANG, BANTEN",6,15,75,90
https://kawalpemilu.org#51791,"PALURAHAN, KADUHEJO, PANDEGLANG, BANTEN",7,31,185,216
https://kawalpemilu.org#51791,"PALURAHAN, KADUHEJO, PANDEGLANG, BANTEN",8,28,103,131
https://kawalpemilu.org#51791,"PALURAHAN, KADUHEJO, PANDEGLANG, BANTEN",9,30,171,201
https://kawalpemilu.org#51791,"PALURAHAN, KADUHEJO, PANDEGLANG, BANTEN",10,20,149,169
https://kawalpemilu.org#51791,"PALURAHAN, KADUHEJO, PANDEGLANG, BANTEN",11,16,144,160
https://kawalpemilu.org#51791,"PALURAHAN, KADUHEJO, PANDEGLANG, BANTEN",12,23,152,175
https://kawalpemilu.org#51791,"PALURAHAN, KADUHEJO, PANDEGLANG, BANTEN",13,35,109,144
https://kawalpemilu.org#51792,"SUKAMANAH, KADUHEJO, PANDEGLANG, BANTEN",1,15,107,122
https://kawalpemilu.org#51792,"SUKAMANAH, KADUHEJO, PANDEGLANG, BANTEN",2,26,116,142
https://kawalpemilu.org#51792,"SUKAMANAH, KADUHEJO, PANDEGLANG, BANTEN",3,25,107,132
https://kawalpemilu.org#51792,"SUKAMANAH, KADUHEJO, PANDEGLANG, BANTEN",4,33,152,185
https://kawalpemilu.org#51792,"SUKAMANAH, KADUHEJO, PANDEGLANG, BANTEN",5,39,174,213
https://kawalpemilu.org#51792,"SUKAMANAH, KADUHEJO, PANDEGLANG, BANTEN",6,18,130,148
https://kawalpemilu.org#51792,"SUKAMANAH, KADUHEJO, PANDEGLANG, BANTEN",7,24,118,142
https://kawalpemilu.org#51792,"SUKAMANAH, KADUHEJO, PANDEGLANG, BANTEN",8,69,181,250
https://kawalpemilu.org#51792,"SUKAMANAH, KADUHEJO, PANDEGLANG, BANTEN",9,71,146,217
https://kawalpemilu.org#51792,"SUKAMANAH, KADUHEJO, PANDEGLANG, BANTEN",10,23,159,182
https://kawalpemilu.org#51792,"SUKAMANAH, KADUHEJO, PANDEGLANG, BANTEN",11,32,124,156
https://kawalpemilu.org#51792,"SUKAMANAH, KADUHEJO, PANDEGLANG, BANTEN",12,48,135,183
https://kawalpemilu.org#51792,"SUKAMANAH, KADUHEJO, PANDEGLANG, BANTEN",13,43,124,167
https://kawalpemilu.org#51792,"SUKAMANAH, KADUHEJO, PANDEGLANG, BANTEN",14,57,151,208
https://kawalpemilu.org#51792,"SUKAMANAH, KADUHEJO, PANDEGLANG, BANTEN",15,44,188,232
https://kawalpemilu.org#51793,"KADUGEMBLO, KADUHEJO, PANDEGLANG, BANTEN",1,55,129,184
https://kawalpemilu.org#51793,"KADUGEMBLO, KADUHEJO, PANDEGLANG, BANTEN",2,34,148,182
https://kawalpemilu.org#51793,"KADUGEMBLO, KADUHEJO, PANDEGLANG, BANTEN",3,70,126,196
https://kawalpemilu.org#51793,"KADUGEMBLO, KADUHEJO, PANDEGLANG, BANTEN",4,43,145,188
https://kawalpemilu.org#51793,"KADUGEMBLO, KADUHEJO, PANDEGLANG, BANTEN",5,32,92,124
https://kawalpemilu.org#51793,"KADUGEMBLO, KADUHEJO, PANDEGLANG, BANTEN",6,62,96,158
https://kawalpemilu.org#51793,"KADUGEMBLO, KADUHEJO, PANDEGLANG, BANTEN",7,35,146,181
https://kawalpemilu.org#51793,"KADUGEMBLO, KADUHEJO, PANDEGLANG, BANTEN",8,0,0,0
https://kawalpemilu.org#51794,"BANJARSARI, KADUHEJO, PANDEGLANG, BANTEN",1,40,99,139
https://kawalpemilu.org#51794,"BANJARSARI, KADUHEJO, PANDEGLANG, BANTEN",2,31,97,128
https://kawalpemilu.org#51794,"BANJARSARI, KADUHEJO, PANDEGLANG, BANTEN",3,27,125,152
https://kawalpemilu.org#51794,"BANJARSARI, KADUHEJO, PANDEGLANG, BANTEN",4,38,79,117
https://kawalpemilu.org#51794,"BANJARSARI, KADUHEJO, PANDEGLANG, BANTEN",5,54,123,177
https://kawalpemilu.org#51794,"BANJARSARI, KADUHEJO, PANDEGLANG, BANTEN",6,40,141,181
https://kawalpemilu.org#51794,"BANJARSARI, KADUHEJO, PANDEGLANG, BANTEN",7,28,152,180
https://kawalpemilu.org#51794,"BANJARSARI, KADUHEJO, PANDEGLANG, BANTEN",8,45,104,149
https://kawalpemilu.org#51795,"CIPUTRI, KADUHEJO, PANDEGLANG, BANTEN",1,18,151,169
https://kawalpemilu.org#51795,"CIPUTRI, KADUHEJO, PANDEGLANG, BANTEN",2,61,129,190
https://kawalpemilu.org#51795,"CIPUTRI, KADUHEJO, PANDEGLANG, BANTEN",3,53,116,169
https://kawalpemilu.org#51795,"CIPUTRI, KADUHEJO, PANDEGLANG, BANTEN",4,58,121,179
https://kawalpemilu.org#51795,"CIPUTRI, KADUHEJO, PANDEGLANG, BANTEN",5,56,156,212
https://kawalpemilu.org#51795,"CIPUTRI, KADUHEJO, PANDEGLANG, BANTEN",6,48,125,173
https://kawalpemilu.org#51795,"CIPUTRI, KADUHEJO, PANDEGLANG, BANTEN",7,21,127,148
https://kawalpemilu.org#51795,"CIPUTRI, KADUHEJO, PANDEGLANG, BANTEN",8,52,137,189
https://kawalpemilu.org#51795,"CIPUTRI, KADUHEJO, PANDEGLANG, BANTEN",9,57,133,190
https://kawalpemilu.org#51795,"CIPUTRI, KADUHEJO, PANDEGLANG, BANTEN",10,33,188,221
https://kawalpemilu.org#51795,"CIPUTRI, KADUHEJO, PANDEGLANG, BANTEN",11,51,137,188
https://kawalpemilu.org#51795,"CIPUTRI, KADUHEJO, PANDEGLANG, BANTEN",12,57,125,182
https://kawalpemilu.org#51795,"CIPUTRI, KADUHEJO, PANDEGLANG, BANTEN",13,34,103,137
https://kawalpemilu.org#51795,"CIPUTRI, KADUHEJO, PANDEGLANG, BANTEN",14,16,209,225
https://kawalpemilu.org#51795,"CIPUTRI, KADUHEJO, PANDEGLANG, BANTEN",15,32,168,200
https://kawalpemilu.org#51795,"CIPUTRI, KADUHEJO, PANDEGLANG, BANTEN",16,80,145,225
https://kawalpemilu.org#51797,"CITALAHAB, BANJAR, PANDEGLANG, BANTEN",1,60,133,193
https://kawalpemilu.org#51797,"CITALAHAB, BANJAR, PANDEGLANG, BANTEN",2,61,161,222
https://kawalpemilu.org#51797,"CITALAHAB, BANJAR, PANDEGLANG, BANTEN",3,62,144,206
https://kawalpemilu.org#51797,"CITALAHAB, BANJAR, PANDEGLANG, BANTEN",4,62,143,205
https://kawalpemilu.org#51797,"CITALAHAB, BANJAR, PANDEGLANG, BANTEN",5,60,141,201
https://kawalpemilu.org#51797,"CITALAHAB, BANJAR, PANDEGLANG, BANTEN",6,37,122,159
https://kawalpemilu.org#51797,"CITALAHAB, BANJAR, PANDEGLANG, BANTEN",7,63,116,179
https://kawalpemilu.org#51797,"CITALAHAB, BANJAR, PANDEGLANG, BANTEN",8,76,113,189
https://kawalpemilu.org#51797,"CITALAHAB, BANJAR, PANDEGLANG, BANTEN",9,34,202,236
https://kawalpemilu.org#51797,"CITALAHAB, BANJAR, PANDEGLANG, BANTEN",10,24,190,214
https://kawalpemilu.org#51797,"CITALAHAB, BANJAR, PANDEGLANG, BANTEN",11,69,120,189
https://kawalpemilu.org#51797,"CITALAHAB, BANJAR, PANDEGLANG, BANTEN",13,112,97,209
https://kawalpemilu.org#51798,"KADULIMUS, BANJAR, PANDEGLANG, BANTEN",1,41,153,194
https://kawalpemilu.org#51798,"KADULIMUS, BANJAR, PANDEGLANG, BANTEN",2,36,173,209
https://kawalpemilu.org#51798,"KADULIMUS, BANJAR, PANDEGLANG, BANTEN",3,87,118,205
https://kawalpemilu.org#51798,"KADULIMUS, BANJAR, PANDEGLANG, BANTEN",4,21,197,218
https://kawalpemilu.org#51798,"KADULIMUS, BANJAR, PANDEGLANG, BANTEN",5,74,112,186
https://kawalpemilu.org#51798,"KADULIMUS, BANJAR, PANDEGLANG, BANTEN",6,91,103,194
https://kawalpemilu.org#51798,"KADULIMUS, BANJAR, PANDEGLANG, BANTEN",7,50,120,170
https://kawalpemilu.org#51798,"KADULIMUS, BANJAR, PANDEGLANG, BANTEN",8,28,140,168
https://kawalpemilu.org#51798,"KADULIMUS, BANJAR, PANDEGLANG, BANTEN",9,11,95,106
https://kawalpemilu.org#51798,"KADULIMUS, BANJAR, PANDEGLANG, BANTEN",10,27,104,131
https://kawalpemilu.org#51798,"KADULIMUS, BANJAR, PANDEGLANG, BANTEN",11,53,135,188
https://kawalpemilu.org#51798,"KADULIMUS, BANJAR, PANDEGLANG, BANTEN",12,66,144,210
https://kawalpemilu.org#51798,"KADULIMUS, BANJAR, PANDEGLANG, BANTEN",13,84,132,216
https://kawalpemilu.org#51799,"BANDUNG, BANJAR, PANDEGLANG, BANTEN",1,117,117,234
https://kawalpemilu.org#51799,"BANDUNG, BANJAR, PANDEGLANG, BANTEN",2,89,102,191
https://kawalpemilu.org#51799,"BANDUNG, BANJAR, PANDEGLANG, BANTEN",3,22,190,212
https://kawalpemilu.org#51799,"BANDUNG, BANJAR, PANDEGLANG, BANTEN",4,104,124,228
https://kawalpemilu.org#51799,"BANDUNG, BANJAR, PANDEGLANG, BANTEN",5,28,103,131
https://kawalpemilu.org#51800,"MOGANA, BANJAR, PANDEGLANG, BANTEN",1,31,112,143
https://kawalpemilu.org#51800,"MOGANA, BANJAR, PANDEGLANG, BANTEN",2,41,135,176
https://kawalpemilu.org#51800,"MOGANA, BANJAR, PANDEGLANG, BANTEN",3,74,146,220
https://kawalpemilu.org#51800,"MOGANA, BANJAR, PANDEGLANG, BANTEN",4,16,130,146
https://kawalpemilu.org#51800,"MOGANA, BANJAR, PANDEGLANG, BANTEN",5,75,108,183
https://kawalpemilu.org#51800,"MOGANA, BANJAR, PANDEGLANG, BANTEN",6,69,76,145
https://kawalpemilu.org#51800,"MOGANA, BANJAR, PANDEGLANG, BANTEN",7,40,179,219
https://kawalpemilu.org#51801,"BANJAR, BANJAR, PANDEGLANG, BANTEN",1,32,186,218
https://kawalpemilu.org#51801,"BANJAR, BANJAR, PANDEGLANG, BANTEN",2,31,111,142
https://kawalpemilu.org#51801,"BANJAR, BANJAR, PANDEGLANG, BANTEN",3,55,120,175
https://kawalpemilu.org#51801,"BANJAR, BANJAR, PANDEGLANG, BANTEN",4,39,119,158
https://kawalpemilu.org#51801,"BANJAR, BANJAR, PANDEGLANG, BANTEN",5,41,146,187
https://kawalpemilu.org#51801,"BANJAR, BANJAR, PANDEGLANG, BANTEN",6,51,142,193
https://kawalpemilu.org#51801,"BANJAR, BANJAR, PANDEGLANG, BANTEN",7,48,112,160
https://kawalpemilu.org#51801,"BANJAR, BANJAR, PANDEGLANG, BANTEN",8,53,159,212
https://kawalpemilu.org#51801,"BANJAR, BANJAR, PANDEGLANG, BANTEN",9,51,149,200
https://kawalpemilu.org#51801,"BANJAR, BANJAR, PANDEGLANG, BANTEN",10,43,194,237
https://kawalpemilu.org#51801,"BANJAR, BANJAR, PANDEGLANG, BANTEN",11,52,139,191
https://kawalpemilu.org#51801,"BANJAR, BANJAR, PANDEGLANG, BANTEN",12,54,123,177
https://kawalpemilu.org#51801,"BANJAR, BANJAR, PANDEGLANG, BANTEN",13,17,144,161
https://kawalpemilu.org#51801,"BANJAR, BANJAR, PANDEGLANG, BANTEN",14,51,132,183
https://kawalpemilu.org#51801,"BANJAR, BANJAR, PANDEGLANG, BANTEN",15,30,122,152
https://kawalpemilu.org#51801,"BANJAR, BANJAR, PANDEGLANG, BANTEN",16,36,92,128
https://kawalpemilu.org#51802,"GUNUNGPUTRI, BANJAR, PANDEGLANG, BANTEN",1,39,151,190
https://kawalpemilu.org#51802,"GUNUNGPUTRI, BANJAR, PANDEGLANG, BANTEN",2,46,113,159
https://kawalpemilu.org#51802,"GUNUNGPUTRI, BANJAR, PANDEGLANG, BANTEN",3,42,112,154
https://kawalpemilu.org#51802,"GUNUNGPUTRI, BANJAR, PANDEGLANG, BANTEN",4,45,99,144
https://kawalpemilu.org#51802,"GUNUNGPUTRI, BANJAR, PANDEGLANG, BANTEN",5,57,127,184
https://kawalpemilu.org#51802,"GUNUNGPUTRI, BANJAR, PANDEGLANG, BANTEN",6,59,125,184
https://kawalpemilu.org#51802,"GUNUNGPUTRI, BANJAR, PANDEGLANG, BANTEN",7,60,115,175
https://kawalpemilu.org#51802,"GUNUNGPUTRI, BANJAR, PANDEGLANG, BANTEN",8,31,101,132
https://kawalpemilu.org#51802,"GUNUNGPUTRI, BANJAR, PANDEGLANG, BANTEN",9,46,113,159
https://kawalpemilu.org#51802,"GUNUNGPUTRI, BANJAR, PANDEGLANG, BANTEN",10,64,109,173
https://kawalpemilu.org#51802,"GUNUNGPUTRI, BANJAR, PANDEGLANG, BANTEN",11,79,95,174
https://kawalpemilu.org#51802,"GUNUNGPUTRI, BANJAR, PANDEGLANG, BANTEN",12,15,153,168
https://kawalpemilu.org#51802,"GUNUNGPUTRI, BANJAR, PANDEGLANG, BANTEN",13,34,146,180
https://kawalpemilu.org#51802,"GUNUNGPUTRI, BANJAR, PANDEGLANG, BANTEN",14,16,117,133
https://kawalpemilu.org#51803,"CIBODAS, BANJAR, PANDEGLANG, BANTEN",1,59,142,201
https://kawalpemilu.org#51803,"CIBODAS, BANJAR, PANDEGLANG, BANTEN",2,27,191,218
https://kawalpemilu.org#51803,"CIBODAS, BANJAR, PANDEGLANG, BANTEN",3,82,135,217
https://kawalpemilu.org#51803,"CIBODAS, BANJAR, PANDEGLANG, BANTEN",4,70,134,204
https://kawalpemilu.org#51803,"CIBODAS, BANJAR, PANDEGLANG, BANTEN",5,89,108,197
https://kawalpemilu.org#51803,"CIBODAS, BANJAR, PANDEGLANG, BANTEN",6,94,110,204
https://kawalpemilu.org#51803,"CIBODAS, BANJAR, PANDEGLANG, BANTEN",7,51,151,202
https://kawalpemilu.org#51804,"KADUBALE, BANJAR, PANDEGLANG, BANTEN",1,31,155,186
https://kawalpemilu.org#51804,"KADUBALE, BANJAR, PANDEGLANG, BANTEN",2,33,138,171
https://kawalpemilu.org#51804,"KADUBALE, BANJAR, PANDEGLANG, BANTEN",3,48,136,184
https://kawalpemilu.org#51804,"KADUBALE, BANJAR, PANDEGLANG, BANTEN",4,47,107,154
https://kawalpemilu.org#51804,"KADUBALE, BANJAR, PANDEGLANG, BANTEN",5,39,64,103
https://kawalpemilu.org#51804,"KADUBALE, BANJAR, PANDEGLANG, BANTEN",6,43,38,81
https://kawalpemilu.org#51804,"KADUBALE, BANJAR, PANDEGLANG, BANTEN",7,56,152,208
https://kawalpemilu.org#51804,"KADUBALE, BANJAR, PANDEGLANG, BANTEN",8,42,146,188
https://kawalpemilu.org#51804,"KADUBALE, BANJAR, PANDEGLANG, BANTEN",9,24,120,144
https://kawalpemilu.org#51804,"KADUBALE, BANJAR, PANDEGLANG, BANTEN",10,31,140,171
https://kawalpemilu.org#51804,"KADUBALE, BANJAR, PANDEGLANG, BANTEN",11,38,163,201
https://kawalpemilu.org#51805,"CIBEUREUM, BANJAR, PANDEGLANG, BANTEN",1,52,124,176
https://kawalpemilu.org#51805,"CIBEUREUM, BANJAR, PANDEGLANG, BANTEN",2,43,133,176
https://kawalpemilu.org#51805,"CIBEUREUM, BANJAR, PANDEGLANG, BANTEN",3,77,83,160
https://kawalpemilu.org#51805,"CIBEUREUM, BANJAR, PANDEGLANG, BANTEN",4,42,132,174
https://kawalpemilu.org#51805,"CIBEUREUM, BANJAR, PANDEGLANG, BANTEN",5,30,127,157
https://kawalpemilu.org#51805,"CIBEUREUM, BANJAR, PANDEGLANG, BANTEN",6,71,120,191
https://kawalpemilu.org#51805,"CIBEUREUM, BANJAR, PANDEGLANG, BANTEN",7,56,71,127
https://kawalpemilu.org#51806,"KADUMANEUH, BANJAR, PANDEGLANG, BANTEN",1,26,153,179
https://kawalpemilu.org#51806,"KADUMANEUH, BANJAR, PANDEGLANG, BANTEN",2,53,113,166
https://kawalpemilu.org#51806,"KADUMANEUH, BANJAR, PANDEGLANG, BANTEN",3,60,147,207
https://kawalpemilu.org#51806,"KADUMANEUH, BANJAR, PANDEGLANG, BANTEN",4,39,82,121
https://kawalpemilu.org#51806,"KADUMANEUH, BANJAR, PANDEGLANG, BANTEN",5,60,106,166
https://kawalpemilu.org#51806,"KADUMANEUH, BANJAR, PANDEGLANG, BANTEN",6,77,90,167
https://kawalpemilu.org#51806,"KADUMANEUH, BANJAR, PANDEGLANG, BANTEN",7,83,108,191
https://kawalpemilu.org#51806,"KADUMANEUH, BANJAR, PANDEGLANG, BANTEN",8,37,73,110
https://kawalpemilu.org#51806,"KADUMANEUH, BANJAR, PANDEGLANG, BANTEN",9,64,81,145
https://kawalpemilu.org#51807,"PASIRAWI, BANJAR, PANDEGLANG, BANTEN",1,71,122,193
https://kawalpemilu.org#51807,"PASIRAWI, BANJAR, PANDEGLANG, BANTEN",2,65,118,183
https://kawalpemilu.org#51807,"PASIRAWI, BANJAR, PANDEGLANG, BANTEN",3,41,86,127
https://kawalpemilu.org#51807,"PASIRAWI, BANJAR, PANDEGLANG, BANTEN",4,78,110,188
https://kawalpemilu.org#51807,"PASIRAWI, BANJAR, PANDEGLANG, BANTEN",5,37,81,118
https://kawalpemilu.org#51807,"PASIRAWI, BANJAR, PANDEGLANG, BANTEN",6,107,98,205
https://kawalpemilu.org#51809,"KADOMAS, PANDEGLANG, PANDEGLANG, BANTEN",1,33,183,216
https://kawalpemilu.org#51809,"KADOMAS, PANDEGLANG, PANDEGLANG, BANTEN",2,45,127,172
https://kawalpemilu.org#51809,"KADOMAS, PANDEGLANG, PANDEGLANG, BANTEN",3,53,186,239
https://kawalpemilu.org#51809,"KADOMAS, PANDEGLANG, PANDEGLANG, BANTEN",4,62,157,219
https://kawalpemilu.org#51809,"KADOMAS, PANDEGLANG, PANDEGLANG, BANTEN",5,27,129,156
https://kawalpemilu.org#51809,"KADOMAS, PANDEGLANG, PANDEGLANG, BANTEN",6,80,107,187
https://kawalpemilu.org#51809,"KADOMAS, PANDEGLANG, PANDEGLANG, BANTEN",7,28,94,122
https://kawalpemilu.org#51809,"KADOMAS, PANDEGLANG, PANDEGLANG, BANTEN",8,57,81,138
https://kawalpemilu.org#51809,"KADOMAS, PANDEGLANG, PANDEGLANG, BANTEN",9,35,136,171
https://kawalpemilu.org#51809,"KADOMAS, PANDEGLANG, PANDEGLANG, BANTEN",10,52,152,204
https://kawalpemilu.org#51809,"KADOMAS, PANDEGLANG, PANDEGLANG, BANTEN",11,31,110,141
https://kawalpemilu.org#51809,"KADOMAS, PANDEGLANG, PANDEGLANG, BANTEN",12,79,138,217
https://kawalpemilu.org#51809,"KADOMAS, PANDEGLANG, PANDEGLANG, BANTEN",13,41,136,177
https://kawalpemilu.org#51809,"KADOMAS, PANDEGLANG, PANDEGLANG, BANTEN",14,38,154,192
https://kawalpemilu.org#51809,"KADOMAS, PANDEGLANG, PANDEGLANG, BANTEN",15,73,135,208
https://kawalpemilu.org#51809,"KADOMAS, PANDEGLANG, PANDEGLANG, BANTEN",16,49,155,204
https://kawalpemilu.org#51809,"KADOMAS, PANDEGLANG, PANDEGLANG, BANTEN",17,48,104,152
https://kawalpemilu.org#51809,"KADOMAS, PANDEGLANG, PANDEGLANG, BANTEN",18,32,160,192
https://kawalpemilu.org#51809,"KADOMAS, PANDEGLANG, PANDEGLANG, BANTEN",19,26,106,132
https://kawalpemilu.org#51809,"KADOMAS, PANDEGLANG, PANDEGLANG, BANTEN",20,31,157,188
https://kawalpemilu.org#51809,"KADOMAS, PANDEGLANG, PANDEGLANG, BANTEN",21,49,110,159
https://kawalpemilu.org#51809,"KADOMAS, PANDEGLANG, PANDEGLANG, BANTEN",22,33,128,161
https://kawalpemilu.org#51810,"BABAKAN KALANGANYAR, PANDEGLANG, PANDEGLANG, BANTEN",1,58,106,164
https://kawalpemilu.org#51810,"BABAKAN KALANGANYAR, PANDEGLANG, PANDEGLANG, BANTEN",2,44,128,172
https://kawalpemilu.org#51810,"BABAKAN KALANGANYAR, PANDEGLANG, PANDEGLANG, BANTEN",3,53,173,226
https://kawalpemilu.org#51810,"BABAKAN KALANGANYAR, PANDEGLANG, PANDEGLANG, BANTEN",4,32,177,209
https://kawalpemilu.org#51810,"BABAKAN KALANGANYAR, PANDEGLANG, PANDEGLANG, BANTEN",5,79,135,214
https://kawalpemilu.org#51810,"BABAKAN KALANGANYAR, PANDEGLANG, PANDEGLANG, BANTEN",6,34,124,158
https://kawalpemilu.org#51810,"BABAKAN KALANGANYAR, PANDEGLANG, PANDEGLANG, BANTEN",7,28,94,122
https://kawalpemilu.org#51810,"BABAKAN KALANGANYAR, PANDEGLANG, PANDEGLANG, BANTEN",8,62,131,193
https://kawalpemilu.org#51810,"BABAKAN KALANGANYAR, PANDEGLANG, PANDEGLANG, BANTEN",9,82,140,222
https://kawalpemilu.org#51810,"BABAKAN KALANGANYAR, PANDEGLANG, PANDEGLANG, BANTEN",10,52,143,195
https://kawalpemilu.org#51810,"BABAKAN KALANGANYAR, PANDEGLANG, PANDEGLANG, BANTEN",11,64,85,149
https://kawalpemilu.org#51810,"BABAKAN KALANGANYAR, PANDEGLANG, PANDEGLANG, BANTEN",12,91,54,145
https://kawalpemilu.org#51810,"BABAKAN KALANGANYAR, PANDEGLANG, PANDEGLANG, BANTEN",13,36,147,183
https://kawalpemilu.org#51810,"BABAKAN KALANGANYAR, PANDEGLANG, PANDEGLANG, BANTEN",14,41,62,103
https://kawalpemilu.org#51810,"BABAKAN KALANGANYAR, PANDEGLANG, PANDEGLANG, BANTEN",15,69,124,193
https://kawalpemilu.org#51810,"BABAKAN KALANGANYAR, PANDEGLANG, PANDEGLANG, BANTEN",16,35,71,106
https://kawalpemilu.org#51810,"BABAKAN KALANGANYAR, PANDEGLANG, PANDEGLANG, BANTEN",17,35,105,140
https://kawalpemilu.org#51810,"BABAKAN KALANGANYAR, PANDEGLANG, PANDEGLANG, BANTEN",18,45,105,150
https://kawalpemilu.org#51810,"BABAKAN KALANGANYAR, PANDEGLANG, PANDEGLANG, BANTEN",19,49,69,118
https://kawalpemilu.org#51811,"KABAYAN, PANDEGLANG, PANDEGLANG, BANTEN",1,56,194,250
https://kawalpemilu.org#51811,"KABAYAN, PANDEGLANG, PANDEGLANG, BANTEN",2,40,176,216
https://kawalpemilu.org#51811,"KABAYAN, PANDEGLANG, PANDEGLANG, BANTEN",3,36,187,223
https://kawalpemilu.org#51811,"KABAYAN, PANDEGLANG, PANDEGLANG, BANTEN",4,44,193,237
https://kawalpemilu.org#51811,"KABAYAN, PANDEGLANG, PANDEGLANG, BANTEN",5,66,111,177
https://kawalpemilu.org#51811,"KABAYAN, PANDEGLANG, PANDEGLANG, BANTEN",6,56,142,198
https://kawalpemilu.org#51811,"KABAYAN, PANDEGLANG, PANDEGLANG, BANTEN",7,39,165,204
https://kawalpemilu.org#51811,"KABAYAN, PANDEGLANG, PANDEGLANG, BANTEN",8,40,138,178
https://kawalpemilu.org#51811,"KABAYAN, PANDEGLANG, PANDEGLANG, BANTEN",9,52,171,223
https://kawalpemilu.org#51811,"KABAYAN, PANDEGLANG, PANDEGLANG, BANTEN",10,30,161,191
https://kawalpemilu.org#51811,"KABAYAN, PANDEGLANG, PANDEGLANG, BANTEN",11,46,91,137
https://kawalpemilu.org#51811,"KABAYAN, PANDEGLANG, PANDEGLANG, BANTEN",12,38,147,185
https://kawalpemilu.org#51811,"KABAYAN, PANDEGLANG, PANDEGLANG, BANTEN",13,52,195,247
https://kawalpemilu.org#51811,"KABAYAN, PANDEGLANG, PANDEGLANG, BANTEN",14,40,150,190
https://kawalpemilu.org#51811,"KABAYAN, PANDEGLANG, PANDEGLANG, BANTEN",15,40,126,166
https://kawalpemilu.org#51811,"KABAYAN, PANDEGLANG, PANDEGLANG, BANTEN",16,37,107,144
https://kawalpemilu.org#51811,"KABAYAN, PANDEGLANG, PANDEGLANG, BANTEN",17,55,173,228
https://kawalpemilu.org#51811,"KABAYAN, PANDEGLANG, PANDEGLANG, BANTEN",18,25,111,136
https://kawalpemilu.org#51811,"KABAYAN, PANDEGLANG, PANDEGLANG, BANTEN",19,30,157,187
https://kawalpemilu.org#51811,"KABAYAN, PANDEGLANG, PANDEGLANG, BANTEN",20,36,119,155
https://kawalpemilu.org#51811,"KABAYAN, PANDEGLANG, PANDEGLANG, BANTEN",21,48,146,194
https://kawalpemilu.org#51811,"KABAYAN, PANDEGLANG, PANDEGLANG, BANTEN",22,16,88,104
https://kawalpemilu.org#51811,"KABAYAN, PANDEGLANG, PANDEGLANG, BANTEN",23,60,163,223
https://kawalpemilu.org#51811,"KABAYAN, PANDEGLANG, PANDEGLANG, BANTEN",24,64,121,185
https://kawalpemilu.org#51811,"KABAYAN, PANDEGLANG, PANDEGLANG, BANTEN",25,42,145,187
https://kawalpemilu.org#51811,"KABAYAN, PANDEGLANG, PANDEGLANG, BANTEN",26,34,139,173
https://kawalpemilu.org#51811,"KABAYAN, PANDEGLANG, PANDEGLANG, BANTEN",27,31,207,238
https://kawalpemilu.org#51811,"KABAYAN, PANDEGLANG, PANDEGLANG, BANTEN",28,43,138,181
https://kawalpemilu.org#51811,"KABAYAN, PANDEGLANG, PANDEGLANG, BANTEN",29,38,136,174
https://kawalpemilu.org#51811,"KABAYAN, PANDEGLANG, PANDEGLANG, BANTEN",30,70,92,162
https://kawalpemilu.org#51811,"KABAYAN, PANDEGLANG, PANDEGLANG, BANTEN",31,24,65,89
https://kawalpemilu.org#51811,"KABAYAN, PANDEGLANG, PANDEGLANG, BANTEN",32,50,90,140
https://kawalpemilu.org#51811,"KABAYAN, PANDEGLANG, PANDEGLANG, BANTEN",33,76,129,205
https://kawalpemilu.org#51811,"KABAYAN, PANDEGLANG, PANDEGLANG, BANTEN",34,39,221,260
https://kawalpemilu.org#51812,"PANDEGLANG, PANDEGLANG, PANDEGLANG, BANTEN",1,49,92,141
https://kawalpemilu.org#51812,"PANDEGLANG, PANDEGLANG, PANDEGLANG, BANTEN",2,62,130,192
https://kawalpemilu.org#51812,"PANDEGLANG, PANDEGLANG, PANDEGLANG, BANTEN",3,57,114,171
https://kawalpemilu.org#51812,"PANDEGLANG, PANDEGLANG, PANDEGLANG, BANTEN",4,41,133,174
https://kawalpemilu.org#51812,"PANDEGLANG, PANDEGLANG, PANDEGLANG, BANTEN",5,33,141,174
https://kawalpemilu.org#51812,"PANDEGLANG, PANDEGLANG, PANDEGLANG, BANTEN",6,63,135,198
https://kawalpemilu.org#51812,"PANDEGLANG, PANDEGLANG, PANDEGLANG, BANTEN",7,99,119,218
https://kawalpemilu.org#51812,"PANDEGLANG, PANDEGLANG, PANDEGLANG, BANTEN",8,67,117,184
https://kawalpemilu.org#51812,"PANDEGLANG, PANDEGLANG, PANDEGLANG, BANTEN",9,55,143,198
https://kawalpemilu.org#51812,"PANDEGLANG, PANDEGLANG, PANDEGLANG, BANTEN",10,70,182,252
https://kawalpemilu.org#51812,"PANDEGLANG, PANDEGLANG, PANDEGLANG, BANTEN",11,59,165,224
https://kawalpemilu.org#51812,"PANDEGLANG, PANDEGLANG, PANDEGLANG, BANTEN",12,58,168,226
https://kawalpemilu.org#51812,"PANDEGLANG, PANDEGLANG, PANDEGLANG, BANTEN",13,69,143,212
https://kawalpemilu.org#51812,"PANDEGLANG, PANDEGLANG, PANDEGLANG, BANTEN",14,41,106,147
https://kawalpemilu.org#51812,"PANDEGLANG, PANDEGLANG, PANDEGLANG, BANTEN",15,59,167,226
https://kawalpemilu.org#51812,"PANDEGLANG, PANDEGLANG, PANDEGLANG, BANTEN",16,58,75,133
https://kawalpemilu.org#51812,"PANDEGLANG, PANDEGLANG, PANDEGLANG, BANTEN",17,30,132,162
https://kawalpemilu.org#51812,"PANDEGLANG, PANDEGLANG, PANDEGLANG, BANTEN",18,47,133,180
https://kawalpemilu.org#51812,"PANDEGLANG, PANDEGLANG, PANDEGLANG, BANTEN",19,44,209,253
https://kawalpemilu.org#51812,"PANDEGLANG, PANDEGLANG, PANDEGLANG, BANTEN",20,85,180,265
https://kawalpemilu.org#51812,"PANDEGLANG, PANDEGLANG, PANDEGLANG, BANTEN",21,49,162,211
https://kawalpemilu.org#51812,"PANDEGLANG, PANDEGLANG, PANDEGLANG, BANTEN",22,52,152,204
https://kawalpemilu.org#51812,"PANDEGLANG, PANDEGLANG, PANDEGLANG, BANTEN",23,49,162,211
https://kawalpemilu.org#51812,"PANDEGLANG, PANDEGLANG, PANDEGLANG, BANTEN",24,54,190,244
https://kawalpemilu.org#51812,"PANDEGLANG, PANDEGLANG, PANDEGLANG, BANTEN",25,37,207,244
https://kawalpemilu.org#51812,"PANDEGLANG, PANDEGLANG, PANDEGLANG, BANTEN",26,67,166,233
https://kawalpemilu.org#51812,"PANDEGLANG, PANDEGLANG, PANDEGLANG, BANTEN",27,66,163,229
https://kawalpemilu.org#51812,"PANDEGLANG, PANDEGLANG, PANDEGLANG, BANTEN",28,51,208,259
https://kawalpemilu.org#51812,"PANDEGLANG, PANDEGLANG, PANDEGLANG, BANTEN",29,88,116,204
https://kawalpemilu.org#51812,"PANDEGLANG, PANDEGLANG, PANDEGLANG, BANTEN",30,69,175,244
https://kawalpemilu.org#51812,"PANDEGLANG, PANDEGLANG, PANDEGLANG, BANTEN",31,27,72,99
https://kawalpemilu.org#51812,"PANDEGLANG, PANDEGLANG, PANDEGLANG, BANTEN",32,52,153,205
https://kawalpemilu.org#51812,"PANDEGLANG, PANDEGLANG, PANDEGLANG, BANTEN",33,44,97,141
https://kawalpemilu.org#51812,"PANDEGLANG, PANDEGLANG, PANDEGLANG, BANTEN",34,42,103,145
https://kawalpemilu.org#51812,"PANDEGLANG, PANDEGLANG, PANDEGLANG, BANTEN",35,34,93,127
https://kawalpemilu.org#51812,"PANDEGLANG, PANDEGLANG, PANDEGLANG, BANTEN",36,92,164,256
https://kawalpemilu.org#51812,"PANDEGLANG, PANDEGLANG, PANDEGLANG, BANTEN",37,74,171,245
https://kawalpemilu.org#51812,"PANDEGLANG, PANDEGLANG, PANDEGLANG, BANTEN",38,78,145,223
https://kawalpemilu.org#51812,"PANDEGLANG, PANDEGLANG, PANDEGLANG, BANTEN",39,65,222,287
https://kawalpemilu.org#51812,"PANDEGLANG, PANDEGLANG, PANDEGLANG, BANTEN",40,55,133,188
https://kawalpemilu.org#51812,"PANDEGLANG, PANDEGLANG, PANDEGLANG, BANTEN",41,47,195,242
https://kawalpemilu.org#51812,"PANDEGLANG, PANDEGLANG, PANDEGLANG, BANTEN",42,58,212,270
https://kawalpemilu.org#51812,"PANDEGLANG, PANDEGLANG, PANDEGLANG, BANTEN",43,21,190,211
https://kawalpemilu.org#51812,"PANDEGLANG, PANDEGLANG, PANDEGLANG, BANTEN",44,44,188,232
https://kawalpemilu.org#51812,"PANDEGLANG, PANDEGLANG, PANDEGLANG, BANTEN",45,20,110,130
https://kawalpemilu.org#51812,"PANDEGLANG, PANDEGLANG, PANDEGLANG, BANTEN",46,75,186,261
https://kawalpemilu.org#51812,"PANDEGLANG, PANDEGLANG, PANDEGLANG, BANTEN",47,65,160,225
https://kawalpemilu.org#51812,"PANDEGLANG, PANDEGLANG, PANDEGLANG, BANTEN",48,21,81,102
https://kawalpemilu.org#51812,"PANDEGLANG, PANDEGLANG, PANDEGLANG, BANTEN",49,32,175,207
https://kawalpemilu.org#51812,"PANDEGLANG, PANDEGLANG, PANDEGLANG, BANTEN",50,29,164,193
https://kawalpemilu.org#51812,"PANDEGLANG, PANDEGLANG, PANDEGLANG, BANTEN",51,64,151,215
https://kawalpemilu.org#51812,"PANDEGLANG, PANDEGLANG, PANDEGLANG, BANTEN",52,68,140,208
https://kawalpemilu.org#51812,"PANDEGLANG, PANDEGLANG, PANDEGLANG, BANTEN",53,61,119,180
https://kawalpemilu.org#51812,"PANDEGLANG, PANDEGLANG, PANDEGLANG, BANTEN",54,64,149,213
https://kawalpemilu.org#51812,"PANDEGLANG, PANDEGLANG, PANDEGLANG, BANTEN",55,29,65,94
https://kawalpemilu.org#51812,"PANDEGLANG, PANDEGLANG, PANDEGLANG, BANTEN",56,45,199,244
https://kawalpemilu.org#51812,"PANDEGLANG, PANDEGLANG, PANDEGLANG, BANTEN",57,63,154,217
https://kawalpemilu.org#51812,"PANDEGLANG, PANDEGLANG, PANDEGLANG, BANTEN",58,72,179,251
https://kawalpemilu.org#51812,"PANDEGLANG, PANDEGLANG, PANDEGLANG, BANTEN",59,48,100,148
https://kawalpemilu.org#51812,"PANDEGLANG, PANDEGLANG, PANDEGLANG, BANTEN",60,37,126,163
https://kawalpemilu.org#51814,"KADUENGANG, CADASARI, PANDEGLANG, BANTEN",1,48,62,110
https://kawalpemilu.org#51814,"KADUENGANG, CADASARI, PANDEGLANG, BANTEN",2,62,76,138
https://kawalpemilu.org#51814,"KADUENGANG, CADASARI, PANDEGLANG, BANTEN",3,50,119,169
https://kawalpemilu.org#51814,"KADUENGANG, CADASARI, PANDEGLANG, BANTEN",4,50,153,203
https://kawalpemilu.org#51814,"KADUENGANG, CADASARI, PANDEGLANG, BANTEN",5,131,46,177
https://kawalpemilu.org#51814,"KADUENGANG, CADASARI, PANDEGLANG, BANTEN",6,48,157,205
https://kawalpemilu.org#51814,"KADUENGANG, CADASARI, PANDEGLANG, BANTEN",7,64,131,195
https://kawalpemilu.org#51814,"KADUENGANG, CADASARI, PANDEGLANG, BANTEN",8,62,129,191
https://kawalpemilu.org#51815,"PASIRPEUTEUY, CADASARI, PANDEGLANG, BANTEN",1,24,198,222
https://kawalpemilu.org#51815,"PASIRPEUTEUY, CADASARI, PANDEGLANG, BANTEN",2,42,163,205
https://kawalpemilu.org#51815,"PASIRPEUTEUY, CADASARI, PANDEGLANG, BANTEN",5,77,85,162
https://kawalpemilu.org#51815,"PASIRPEUTEUY, CADASARI, PANDEGLANG, BANTEN",6,66,118,184
https://kawalpemilu.org#51816,"KURUNGDAHU, CADASARI, PANDEGLANG, BANTEN",1,39,174,213
https://kawalpemilu.org#51816,"KURUNGDAHU, CADASARI, PANDEGLANG, BANTEN",2,31,176,207
https://kawalpemilu.org#51816,"KURUNGDAHU, CADASARI, PANDEGLANG, BANTEN",3,28,150,178
https://kawalpemilu.org#51816,"KURUNGDAHU, CADASARI, PANDEGLANG, BANTEN",4,35,123,158
https://kawalpemilu.org#51816,"KURUNGDAHU, CADASARI, PANDEGLANG, BANTEN",5,42,171,213
https://kawalpemilu.org#51816,"KURUNGDAHU, CADASARI, PANDEGLANG, BANTEN",6,72,66,138
https://kawalpemilu.org#51817,"KADUELA, CADASARI, PANDEGLANG, BANTEN",1,95,91,186
https://kawalpemilu.org#51817,"KADUELA, CADASARI, PANDEGLANG, BANTEN",2,84,104,188
https://kawalpemilu.org#51817,"KADUELA, CADASARI, PANDEGLANG, BANTEN",3,80,125,205
https://kawalpemilu.org#51817,"KADUELA, CADASARI, PANDEGLANG, BANTEN",4,26,105,131
https://kawalpemilu.org#51817,"KADUELA, CADASARI, PANDEGLANG, BANTEN",5,54,100,154
https://kawalpemilu.org#51818,"KORANJI, CADASARI, PANDEGLANG, BANTEN",1,37,145,182
https://kawalpemilu.org#51818,"KORANJI, CADASARI, PANDEGLANG, BANTEN",2,27,125,152
https://kawalpemilu.org#51818,"KORANJI, CADASARI, PANDEGLANG, BANTEN",3,49,180,229
https://kawalpemilu.org#51818,"KORANJI, CADASARI, PANDEGLANG, BANTEN",4,0,0,0
https://kawalpemilu.org#51818,"KORANJI, CADASARI, PANDEGLANG, BANTEN",5,51,160,211
https://kawalpemilu.org#51818,"KORANJI, CADASARI, PANDEGLANG, BANTEN",6,25,204,229
https://kawalpemilu.org#51818,"KORANJI, CADASARI, PANDEGLANG, BANTEN",7,44,145,189
https://kawalpemilu.org#51818,"KORANJI, CADASARI, PANDEGLANG, BANTEN",8,28,65,93
https://kawalpemilu.org#51819,"TAPOS, CADASARI, PANDEGLANG, BANTEN",1,42,196,238
https://kawalpemilu.org#51819,"TAPOS, CADASARI, PANDEGLANG, BANTEN",2,51,173,224
https://kawalpemilu.org#51819,"TAPOS, CADASARI, PANDEGLANG, BANTEN",3,19,140,159
https://kawalpemilu.org#51819,"TAPOS, CADASARI, PANDEGLANG, BANTEN",4,23,121,144
https://kawalpemilu.org#51819,"TAPOS, CADASARI, PANDEGLANG, BANTEN",5,17,199,216
https://kawalpemilu.org#51819,"TAPOS, CADASARI, PANDEGLANG, BANTEN",6,26,118,144
https://kawalpemilu.org#51819,"TAPOS, CADASARI, PANDEGLANG, BANTEN",7,40,119,159
https://kawalpemilu.org#51819,"TAPOS, CADASARI, PANDEGLANG, BANTEN",8,26,166,192
https://kawalpemilu.org#51819,"TAPOS, CADASARI, PANDEGLANG, BANTEN",9,33,175,208
https://kawalpemilu.org#51819,"TAPOS, CADASARI, PANDEGLANG, BANTEN",10,13,218,231
https://kawalpemilu.org#51819,"TAPOS, CADASARI, PANDEGLANG, BANTEN",11,9,264,273
https://kawalpemilu.org#51820,"CADASARI, CADASARI, PANDEGLANG, BANTEN",1,51,132,183
https://kawalpemilu.org#51820,"CADASARI, CADASARI, PANDEGLANG, BANTEN",2,25,198,223
https://kawalpemilu.org#51820,"CADASARI, CADASARI, PANDEGLANG, BANTEN",3,51,187,238
https://kawalpemilu.org#51820,"CADASARI, CADASARI, PANDEGLANG, BANTEN",4,58,124,182
https://kawalpemilu.org#51820,"CADASARI, CADASARI, PANDEGLANG, BANTEN",5,41,128,169
https://kawalpemilu.org#51820,"CADASARI, CADASARI, PANDEGLANG, BANTEN",6,31,133,164
https://kawalpemilu.org#51820,"CADASARI, CADASARI, PANDEGLANG, BANTEN",7,44,191,235
https://kawalpemilu.org#51820,"CADASARI, CADASARI, PANDEGLANG, BANTEN",8,43,173,216
https://kawalpemilu.org#51820,"CADASARI, CADASARI, PANDEGLANG, BANTEN",9,36,174,210
https://kawalpemilu.org#51820,"CADASARI, CADASARI, PANDEGLANG, BANTEN",10,51,130,181
https://kawalpemilu.org#51820,"CADASARI, CADASARI, PANDEGLANG, BANTEN",11,59,117,176
https://kawalpemilu.org#51820,"CADASARI, CADASARI, PANDEGLANG, BANTEN",12,38,181,219
https://kawalpemilu.org#51820,"CADASARI, CADASARI, PANDEGLANG, BANTEN",13,38,170,208
https://kawalpemilu.org#51820,"CADASARI, CADASARI, PANDEGLANG, BANTEN",14,29,138,167
https://kawalpemilu.org#51820,"CADASARI, CADASARI, PANDEGLANG, BANTEN",15,44,135,179
https://kawalpemilu.org#51820,"CADASARI, CADASARI, PANDEGLANG, BANTEN",16,92,135,227
https://kawalpemilu.org#51820,"CADASARI, CADASARI, PANDEGLANG, BANTEN",17,35,166,201
https://kawalpemilu.org#51820,"CADASARI, CADASARI, PANDEGLANG, BANTEN",18,40,181,221
https://kawalpemilu.org#51820,"CADASARI, CADASARI, PANDEGLANG, BANTEN",19,18,143,161
https://kawalpemilu.org#51820,"CADASARI, CADASARI, PANDEGLANG, BANTEN",20,14,101,115
https://kawalpemilu.org#51820,"CADASARI, CADASARI, PANDEGLANG, BANTEN",21,69,180,249
https://kawalpemilu.org#51821,"CIINJUK, CADASARI, PANDEGLANG, BANTEN",1,49,168,217
https://kawalpemilu.org#51821,"CIINJUK, CADASARI, PANDEGLANG, BANTEN",2,72,176,248
https://kawalpemilu.org#51821,"CIINJUK, CADASARI, PANDEGLANG, BANTEN",3,77,119,196
https://kawalpemilu.org#51821,"CIINJUK, CADASARI, PANDEGLANG, BANTEN",4,62,162,224
https://kawalpemilu.org#51821,"CIINJUK, CADASARI, PANDEGLANG, BANTEN",5,67,143,210
https://kawalpemilu.org#51821,"CIINJUK, CADASARI, PANDEGLANG, BANTEN",6,39,150,189
https://kawalpemilu.org#51821,"CIINJUK, CADASARI, PANDEGLANG, BANTEN",7,33,189,222
https://kawalpemilu.org#51821,"CIINJUK, CADASARI, PANDEGLANG, BANTEN",8,14,173,214
https://kawalpemilu.org#51821,"CIINJUK, CADASARI, PANDEGLANG, BANTEN",9,84,132,216
https://kawalpemilu.org#51821,"CIINJUK, CADASARI, PANDEGLANG, BANTEN",10,65,145,210
https://kawalpemilu.org#51821,"CIINJUK, CADASARI, PANDEGLANG, BANTEN",11,64,171,235
https://kawalpemilu.org#51821,"CIINJUK, CADASARI, PANDEGLANG, BANTEN",12,70,182,252
https://kawalpemilu.org#51821,"CIINJUK, CADASARI, PANDEGLANG, BANTEN",13,64,107,171
https://kawalpemilu.org#51822,"KAUNGCAANG, CADASARI, PANDEGLANG, BANTEN",1,72,79,151
https://kawalpemilu.org#51822,"KAUNGCAANG, CADASARI, PANDEGLANG, BANTEN",2,65,96,161
https://kawalpemilu.org#51822,"KAUNGCAANG, CADASARI, PANDEGLANG, BANTEN",3,64,132,196
https://kawalpemilu.org#51822,"KAUNGCAANG, CADASARI, PANDEGLANG, BANTEN",4,49,153,202
https://kawalpemilu.org#51822,"KAUNGCAANG, CADASARI, PANDEGLANG, BANTEN",5,61,130,191
https://kawalpemilu.org#51822,"KAUNGCAANG, CADASARI, PANDEGLANG, BANTEN",6,62,167,229
https://kawalpemilu.org#51822,"KAUNGCAANG, CADASARI, PANDEGLANG, BANTEN",7,69,142,211
https://kawalpemilu.org#51822,"KAUNGCAANG, CADASARI, PANDEGLANG, BANTEN",8,51,143,194
https://kawalpemilu.org#51822,"KAUNGCAANG, CADASARI, PANDEGLANG, BANTEN",9,61,104,165
https://kawalpemilu.org#51822,"KAUNGCAANG, CADASARI, PANDEGLANG, BANTEN",10,41,161,202
https://kawalpemilu.org#51823,"CIKENTRUNG, CADASARI, PANDEGLANG, BANTEN",1,80,144,224
https://kawalpemilu.org#51823,"CIKENTRUNG, CADASARI, PANDEGLANG, BANTEN",2,104,114,218
https://kawalpemilu.org#51823,"CIKENTRUNG, CADASARI, PANDEGLANG, BANTEN",3,36,62,98
https://kawalpemilu.org#51823,"CIKENTRUNG, CADASARI, PANDEGLANG, BANTEN",4,73,98,171
https://kawalpemilu.org#51823,"CIKENTRUNG, CADASARI, PANDEGLANG, BANTEN",5,62,143,205
https://kawalpemilu.org#51823,"CIKENTRUNG, CADASARI, PANDEGLANG, BANTEN",6,90,133,223
https://kawalpemilu.org#51823,"CIKENTRUNG, CADASARI, PANDEGLANG, BANTEN",7,49,148,197
https://kawalpemilu.org#51824,"TANAGARA, CADASARI, PANDEGLANG, BANTEN",1,56,73,129
https://kawalpemilu.org#51824,"TANAGARA, CADASARI, PANDEGLANG, BANTEN",2,44,100,144
https://kawalpemilu.org#51824,"TANAGARA, CADASARI, PANDEGLANG, BANTEN",3,115,140,255
https://kawalpemilu.org#51824,"TANAGARA, CADASARI, PANDEGLANG, BANTEN",4,69,86,155
https://kawalpemilu.org#51824,"TANAGARA, CADASARI, PANDEGLANG, BANTEN",5,105,113,218
https://kawalpemilu.org#51824,"TANAGARA, CADASARI, PANDEGLANG, BANTEN",6,84,122,206
https://kawalpemilu.org#51824,"TANAGARA, CADASARI, PANDEGLANG, BANTEN",7,59,69,128
https://kawalpemilu.org#51824,"TANAGARA, CADASARI, PANDEGLANG, BANTEN",8,53,166,219
https://kawalpemilu.org#51824,"TANAGARA, CADASARI, PANDEGLANG, BANTEN",9,56,185,241
https://kawalpemilu.org#51826,"RAWASARI, CISATA, PANDEGLANG, BANTEN",1,37,147,184
https://kawalpemilu.org#51826,"RAWASARI, CISATA, PANDEGLANG, BANTEN",2,58,116,174
https://kawalpemilu.org#51826,"RAWASARI, CISATA, PANDEGLANG, BANTEN",3,84,127,211
https://kawalpemilu.org#51826,"RAWASARI, CISATA, PANDEGLANG, BANTEN",4,87,82,169
https://kawalpemilu.org#51826,"RAWASARI, CISATA, PANDEGLANG, BANTEN",5,92,76,168
https://kawalpemilu.org#51826,"RAWASARI, CISATA, PANDEGLANG, BANTEN",6,73,85,158
https://kawalpemilu.org#51827,"PASIREURIH, CISATA, PANDEGLANG, BANTEN",1,43,168,211
https://kawalpemilu.org#51827,"PASIREURIH, CISATA, PANDEGLANG, BANTEN",2,25,151,176
https://kawalpemilu.org#51827,"PASIREURIH, CISATA, PANDEGLANG, BANTEN",3,38,126,164
https://kawalpemilu.org#51827,"PASIREURIH, CISATA, PANDEGLANG, BANTEN",4,55,122,177
https://kawalpemilu.org#51827,"PASIREURIH, CISATA, PANDEGLANG, BANTEN",5,84,146,230
https://kawalpemilu.org#51827,"PASIREURIH, CISATA, PANDEGLANG, BANTEN",6,85,157,242
https://kawalpemilu.org#51827,"PASIREURIH, CISATA, PANDEGLANG, BANTEN",7,75,97,172
https://kawalpemilu.org#51827,"PASIREURIH, CISATA, PANDEGLANG, BANTEN",8,42,192,234
https://kawalpemilu.org#51827,"PASIREURIH, CISATA, PANDEGLANG, BANTEN",9,48,128,176
https://kawalpemilu.org#51827,"PASIREURIH, CISATA, PANDEGLANG, BANTEN",10,36,125,161
https://kawalpemilu.org#51827,"PASIREURIH, CISATA, PANDEGLANG, BANTEN",11,83,151,234
https://kawalpemilu.org#51827,"PASIREURIH, CISATA, PANDEGLANG, BANTEN",12,41,164,205
https://kawalpemilu.org#51827,"PASIREURIH, CISATA, PANDEGLANG, BANTEN",13,52,159,211
https://kawalpemilu.org#51827,"PASIREURIH, CISATA, PANDEGLANG, BANTEN",14,31,157,188
https://kawalpemilu.org#51827,"PASIREURIH, CISATA, PANDEGLANG, BANTEN",15,44,158,202
https://kawalpemilu.org#51828,"KADURONYOK, CISATA, PANDEGLANG, BANTEN",1,23,196,219
https://kawalpemilu.org#51828,"KADURONYOK, CISATA, PANDEGLANG, BANTEN",2,41,161,202
https://kawalpemilu.org#51828,"KADURONYOK, CISATA, PANDEGLANG, BANTEN",3,24,198,222
https://kawalpemilu.org#51828,"KADURONYOK, CISATA, PANDEGLANG, BANTEN",4,78,128,206
https://kawalpemilu.org#51828,"KADURONYOK, CISATA, PANDEGLANG, BANTEN",5,19,131,150
https://kawalpemilu.org#51828,"KADURONYOK, CISATA, PANDEGLANG, BANTEN",6,42,134,176
https://kawalpemilu.org#51828,"KADURONYOK, CISATA, PANDEGLANG, BANTEN",7,37,132,169
https://kawalpemilu.org#51829,"CIBARANI, CISATA, PANDEGLANG, BANTEN",1,75,116,191
https://kawalpemilu.org#51829,"CIBARANI, CISATA, PANDEGLANG, BANTEN",2,59,158,8
https://kawalpemilu.org#51829,"CIBARANI, CISATA, PANDEGLANG, BANTEN",3,54,145,199
https://kawalpemilu.org#51829,"CIBARANI, CISATA, PANDEGLANG, BANTEN",4,56,134,190
https://kawalpemilu.org#51829,"CIBARANI, CISATA, PANDEGLANG, BANTEN",5,31,124,155
https://kawalpemilu.org#51829,"CIBARANI, CISATA, PANDEGLANG, BANTEN",6,28,150,178
https://kawalpemilu.org#51829,"CIBARANI, CISATA, PANDEGLANG, BANTEN",7,32,156,188
https://kawalpemilu.org#51829,"CIBARANI, CISATA, PANDEGLANG, BANTEN",8,44,153,197
https://kawalpemilu.org#51829,"CIBARANI, CISATA, PANDEGLANG, BANTEN",9,37,149,186
https://kawalpemilu.org#51829,"CIBARANI, CISATA, PANDEGLANG, BANTEN",10,43,130,173
https://kawalpemilu.org#51829,"CIBARANI, CISATA, PANDEGLANG, BANTEN",11,26,197,223
https://kawalpemilu.org#51829,"CIBARANI, CISATA, PANDEGLANG, BANTEN",12,41,171,212
https://kawalpemilu.org#51830,"CISEREH, CISATA, PANDEGLANG, BANTEN",1,21,162,183
https://kawalpemilu.org#51830,"CISEREH, CISATA, PANDEGLANG, BANTEN",2,29,148,177
https://kawalpemilu.org#51830,"CISEREH, CISATA, PANDEGLANG, BANTEN",3,41,126,167
https://kawalpemilu.org#51830,"CISEREH, CISATA, PANDEGLANG, BANTEN",4,60,111,171
https://kawalpemilu.org#51830,"CISEREH, CISATA, PANDEGLANG, BANTEN",5,33,164,197
https://kawalpemilu.org#51830,"CISEREH, CISATA, PANDEGLANG, BANTEN",6,25,152,177
https://kawalpemilu.org#51831,"KUBANGKONDANG, CISATA, PANDEGLANG, BANTEN",1,31,174,205
https://kawalpemilu.org#51831,"KUBANGKONDANG, CISATA, PANDEGLANG, BANTEN",2,36,144,180
https://kawalpemilu.org#51831,"KUBANGKONDANG, CISATA, PANDEGLANG, BANTEN",3,35,175,210
https://kawalpemilu.org#51831,"KUBANGKONDANG, CISATA, PANDEGLANG, BANTEN",4,57,137,194
https://kawalpemilu.org#51831,"KUBANGKONDANG, CISATA, PANDEGLANG, BANTEN",5,75,113,188
https://kawalpemilu.org#51831,"KUBANGKONDANG, CISATA, PANDEGLANG, BANTEN",6,10,160,170
https://kawalpemilu.org#51831,"KUBANGKONDANG, CISATA, PANDEGLANG, BANTEN",7,39,163,202
https://kawalpemilu.org#51831,"KUBANGKONDANG, CISATA, PANDEGLANG, BANTEN",8,13,161,174
https://kawalpemilu.org#51831,"KUBANGKONDANG, CISATA, PANDEGLANG, BANTEN",9,14,177,191
https://kawalpemilu.org#51831,"KUBANGKONDANG, CISATA, PANDEGLANG, BANTEN",10,10,156,166
https://kawalpemilu.org#51831,"KUBANGKONDANG, CISATA, PANDEGLANG, BANTEN",11,23,165,188
https://kawalpemilu.org#51831,"KUBANGKONDANG, CISATA, PANDEGLANG, BANTEN",12,37,141,178
https://kawalpemilu.org#51832,"KONDANGJAYA, CISATA, PANDEGLANG, BANTEN",1,90,86,176
https://kawalpemilu.org#51832,"KONDANGJAYA, CISATA, PANDEGLANG, BANTEN",2,48,110,158
https://kawalpemilu.org#51832,"KONDANGJAYA, CISATA, PANDEGLANG, BANTEN",3,16,99,115
https://kawalpemilu.org#51832,"KONDANGJAYA, CISATA, PANDEGLANG, BANTEN",4,12,150,162
https://kawalpemilu.org#51832,"KONDANGJAYA, CISATA, PANDEGLANG, BANTEN",5,10,173,183
https://kawalpemilu.org#51832,"KONDANGJAYA, CISATA, PANDEGLANG, BANTEN",6,30,206,236
https://kawalpemilu.org#51832,"KONDANGJAYA, CISATA, PANDEGLANG, BANTEN",7,19,204,223
https://kawalpemilu.org#51832,"KONDANGJAYA, CISATA, PANDEGLANG, BANTEN",8,35,174,209
https://kawalpemilu.org#51832,"KONDANGJAYA, CISATA, PANDEGLANG, BANTEN",9,74,134,208
https://kawalpemilu.org#51833,"CIHERANGJAYA, CISATA, PANDEGLANG, BANTEN",1,32,166,198
https://kawalpemilu.org#51833,"CIHERANGJAYA, CISATA, PANDEGLANG, BANTEN",2,46,157,203
https://kawalpemilu.org#51833,"CIHERANGJAYA, CISATA, PANDEGLANG, BANTEN",3,38,137,175
https://kawalpemilu.org#51833,"CIHERANGJAYA, CISATA, PANDEGLANG, BANTEN",4,23,156,179
https://kawalpemilu.org#51833,"CIHERANGJAYA, CISATA, PANDEGLANG, BANTEN",5,15,128,143
https://kawalpemilu.org#51833,"CIHERANGJAYA, CISATA, PANDEGLANG, BANTEN",6,22,144,166
https://kawalpemilu.org#51834,"PALEMBANG, CISATA, PANDEGLANG, BANTEN",1,45,135,180
https://kawalpemilu.org#51834,"PALEMBANG, CISATA, PANDEGLANG, BANTEN",2,46,103,149
https://kawalpemilu.org#51834,"PALEMBANG, CISATA, PANDEGLANG, BANTEN",3,19,142,161
https://kawalpemilu.org#51834,"PALEMBANG, CISATA, PANDEGLANG, BANTEN",4,78,96,174
https://kawalpemilu.org#51834,"PALEMBANG, CISATA, PANDEGLANG, BANTEN",5,60,93,153
https://kawalpemilu.org#51834,"PALEMBANG, CISATA, PANDEGLANG, BANTEN",6,68,134,202
https://kawalpemilu.org#51836,"TURUS, PATIA, PANDEGLANG, BANTEN",1,114,99,213
https://kawalpemilu.org#51836,"TURUS, PATIA, PANDEGLANG, BANTEN",2,94,90,184
https://kawalpemilu.org#51836,"TURUS, PATIA, PANDEGLANG, BANTEN",3,101,70,171
https://kawalpemilu.org#51836,"TURUS, PATIA, PANDEGLANG, BANTEN",4,61,70,131
https://kawalpemilu.org#51836,"TURUS, PATIA, PANDEGLANG, BANTEN",5,68,85,153
https://kawalpemilu.org#51836,"TURUS, PATIA, PANDEGLANG, BANTEN",6,62,151,213
https://kawalpemilu.org#51836,"TURUS, PATIA, PANDEGLANG, BANTEN",7,124,96,220
https://kawalpemilu.org#51836,"TURUS, PATIA, PANDEGLANG, BANTEN",8,88,140,228
https://kawalpemilu.org#51837,"PATIA, PATIA, PANDEGLANG, BANTEN",1,63,83,146
https://kawalpemilu.org#51837,"PATIA, PATIA, PANDEGLANG, BANTEN",2,59,145,204
https://kawalpemilu.org#51837,"PATIA, PATIA, PANDEGLANG, BANTEN",4,93,125,218
https://kawalpemilu.org#51837,"PATIA, PATIA, PANDEGLANG, BANTEN",5,115,88,203
https://kawalpemilu.org#51837,"PATIA, PATIA, PANDEGLANG, BANTEN",6,43,101,144
https://kawalpemilu.org#51837,"PATIA, PATIA, PANDEGLANG, BANTEN",7,65,67,132
https://kawalpemilu.org#51837,"PATIA, PATIA, PANDEGLANG, BANTEN",8,117,121,238
https://kawalpemilu.org#51837,"PATIA, PATIA, PANDEGLANG, BANTEN",9,68,80,148
https://kawalpemilu.org#51837,"PATIA, PATIA, PANDEGLANG, BANTEN",10,141,62,203
https://kawalpemilu.org#51837,"PATIA, PATIA, PANDEGLANG, BANTEN",11,28,87,115
https://kawalpemilu.org#51837,"PATIA, PATIA, PANDEGLANG, BANTEN",12,34,109,143
https://kawalpemilu.org#51838,"PASIRGADUNG, PATIA, PANDEGLANG, BANTEN",1,114,75,189
https://kawalpemilu.org#51838,"PASIRGADUNG, PATIA, PANDEGLANG, BANTEN",2,50,141,191
https://kawalpemilu.org#51838,"PASIRGADUNG, PATIA, PANDEGLANG, BANTEN",3,45,153,198
https://kawalpemilu.org#51838,"PASIRGADUNG, PATIA, PANDEGLANG, BANTEN",4,44,130,174
https://kawalpemilu.org#51838,"PASIRGADUNG, PATIA, PANDEGLANG, BANTEN",5,37,145,182
https://kawalpemilu.org#51838,"PASIRGADUNG, PATIA, PANDEGLANG, BANTEN",6,63,115,178
https://kawalpemilu.org#51838,"PASIRGADUNG, PATIA, PANDEGLANG, BANTEN",7,44,168,212
https://kawalpemilu.org#51838,"PASIRGADUNG, PATIA, PANDEGLANG, BANTEN",8,37,139,176
https://kawalpemilu.org#51838,"PASIRGADUNG, PATIA, PANDEGLANG, BANTEN",9,90,112,202
https://kawalpemilu.org#51839,"CIMOYAN, PATIA, PANDEGLANG, BANTEN",1,65,111,176
https://kawalpemilu.org#51839,"CIMOYAN, PATIA, PANDEGLANG, BANTEN",2,50,116,166
https://kawalpemilu.org#51839,"CIMOYAN, PATIA, PANDEGLANG, BANTEN",3,43,99,142
https://kawalpemilu.org#51839,"CIMOYAN, PATIA, PANDEGLANG, BANTEN",4,60,70,130
https://kawalpemilu.org#51839,"CIMOYAN, PATIA, PANDEGLANG, BANTEN",5,42,102,144
https://kawalpemilu.org#51839,"CIMOYAN, PATIA, PANDEGLANG, BANTEN",6,75,83,158
https://kawalpemilu.org#51839,"CIMOYAN, PATIA, PANDEGLANG, BANTEN",7,72,77,149
https://kawalpemilu.org#51839,"CIMOYAN, PATIA, PANDEGLANG, BANTEN",9,48,95,143
https://kawalpemilu.org#51839,"CIMOYAN, PATIA, PANDEGLANG, BANTEN",10,29,133,162
https://kawalpemilu.org#51839,"CIMOYAN, PATIA, PANDEGLANG, BANTEN",11,38,104,142
https://kawalpemilu.org#51839,"CIMOYAN, PATIA, PANDEGLANG, BANTEN",12,89,56,145
https://kawalpemilu.org#51839,"CIMOYAN, PATIA, PANDEGLANG, BANTEN",13,141,19,160
https://kawalpemilu.org#51840,"IDAMAN, PATIA, PANDEGLANG, BANTEN",1,49,63,112
https://kawalpemilu.org#51840,"IDAMAN, PATIA, PANDEGLANG, BANTEN",2,49,108,157
https://kawalpemilu.org#51840,"IDAMAN, PATIA, PANDEGLANG, BANTEN",3,13,121,134
https://kawalpemilu.org#51840,"IDAMAN, PATIA, PANDEGLANG, BANTEN",4,62,106,168
https://kawalpemilu.org#51840,"IDAMAN, PATIA, PANDEGLANG, BANTEN",5,79,100,179
https://kawalpemilu.org#51840,"IDAMAN, PATIA, PANDEGLANG, BANTEN",6,49,120,169
https://kawalpemilu.org#51840,"IDAMAN, PATIA, PANDEGLANG, BANTEN",7,67,130,197
https://kawalpemilu.org#51841,"BABAKANKEUSIK, PATIA, PANDEGLANG, BANTEN",1,100,105,205
https://kawalpemilu.org#51841,"BABAKANKEUSIK, PATIA, PANDEGLANG, BANTEN",2,125,105,230
https://kawalpemilu.org#51841,"BABAKANKEUSIK, PATIA, PANDEGLANG, BANTEN",3,59,70,129
https://kawalpemilu.org#51841,"BABAKANKEUSIK, PATIA, PANDEGLANG, BANTEN",4,106,122,228
https://kawalpemilu.org#51841,"BABAKANKEUSIK, PATIA, PANDEGLANG, BANTEN",5,76,95,171
https://kawalpemilu.org#51841,"BABAKANKEUSIK, PATIA, PANDEGLANG, BANTEN",6,52,118,170
https://kawalpemilu.org#51841,"BABAKANKEUSIK, PATIA, PANDEGLANG, BANTEN",7,52,78,130
https://kawalpemilu.org#51841,"BABAKANKEUSIK, PATIA, PANDEGLANG, BANTEN",8,86,115,201
https://kawalpemilu.org#51841,"BABAKANKEUSIK, PATIA, PANDEGLANG, BANTEN",9,60,81,141
https://kawalpemilu.org#51841,"BABAKANKEUSIK, PATIA, PANDEGLANG, BANTEN",10,134,31,165
https://kawalpemilu.org#51841,"BABAKANKEUSIK, PATIA, PANDEGLANG, BANTEN",11,11,85,96
https://kawalpemilu.org#51842,"SURIANEUN, PATIA, PANDEGLANG, BANTEN",1,66,101,167
https://kawalpemilu.org#51842,"SURIANEUN, PATIA, PANDEGLANG, BANTEN",2,107,76,183
https://kawalpemilu.org#51842,"SURIANEUN, PATIA, PANDEGLANG, BANTEN",3,101,73,174
https://kawalpemilu.org#51842,"SURIANEUN, PATIA, PANDEGLANG, BANTEN",4,85,71,156
https://kawalpemilu.org#51842,"SURIANEUN, PATIA, PANDEGLANG, BANTEN",5,61,100,161
https://kawalpemilu.org#51842,"SURIANEUN, PATIA, PANDEGLANG, BANTEN",6,113,80,193
https://kawalpemilu.org#51842,"SURIANEUN, PATIA, PANDEGLANG, BANTEN",7,33,82,115
https://kawalpemilu.org#51842,"SURIANEUN, PATIA, PANDEGLANG, BANTEN",8,28,158,186
https://kawalpemilu.org#51842,"SURIANEUN, PATIA, PANDEGLANG, BANTEN",9,39,146,185
https://kawalpemilu.org#51842,"SURIANEUN, PATIA, PANDEGLANG, BANTEN",10,39,131,170
https://kawalpemilu.org#51842,"SURIANEUN, PATIA, PANDEGLANG, BANTEN",11,50,92,142
https://kawalpemilu.org#51842,"SURIANEUN, PATIA, PANDEGLANG, BANTEN",12,52,102,154
https://kawalpemilu.org#51842,"SURIANEUN, PATIA, PANDEGLANG, BANTEN",13,59,115,174
https://kawalpemilu.org#51843,"RAHAYU, PATIA, PANDEGLANG, BANTEN",1,77,75,152
https://kawalpemilu.org#51843,"RAHAYU, PATIA, PANDEGLANG, BANTEN",2,78,80,158
https://kawalpemilu.org#51843,"RAHAYU, PATIA, PANDEGLANG, BANTEN",3,88,80,168
https://kawalpemilu.org#51843,"RAHAYU, PATIA, PANDEGLANG, BANTEN",4,50,131,181
https://kawalpemilu.org#51843,"RAHAYU, PATIA, PANDEGLANG, BANTEN",5,89,86,175
https://kawalpemilu.org#51843,"RAHAYU, PATIA, PANDEGLANG, BANTEN",6,64,105,169
https://kawalpemilu.org#51843,"RAHAYU, PATIA, PANDEGLANG, BANTEN",7,55,110,165
https://kawalpemilu.org#51844,"CIAWI, PATIA, PANDEGLANG, BANTEN",1,110,57,167
https://kawalpemilu.org#51844,"CIAWI, PATIA, PANDEGLANG, BANTEN",2,120,82,202
https://kawalpemilu.org#51844,"CIAWI, PATIA, PANDEGLANG, BANTEN",3,52,125,177
https://kawalpemilu.org#51844,"CIAWI, PATIA, PANDEGLANG, BANTEN",4,37,88,125
https://kawalpemilu.org#51844,"CIAWI, PATIA, PANDEGLANG, BANTEN",5,85,97,182
https://kawalpemilu.org#51844,"CIAWI, PATIA, PANDEGLANG, BANTEN",6,23,109,132
https://kawalpemilu.org#51844,"CIAWI, PATIA, PANDEGLANG, BANTEN",7,129,97,226
https://kawalpemilu.org#51844,"CIAWI, PATIA, PANDEGLANG, BANTEN",8,98,95,193
https://kawalpemilu.org#84969,"SIMPANGTIGA, PATIA, PANDEGLANG, BANTEN",1,66,104,170
https://kawalpemilu.org#84969,"SIMPANGTIGA, PATIA, PANDEGLANG, BANTEN",2,44,104,148
https://kawalpemilu.org#84969,"SIMPANGTIGA, PATIA, PANDEGLANG, BANTEN",3,96,97,193
https://kawalpemilu.org#84969,"SIMPANGTIGA, PATIA, PANDEGLANG, BANTEN",4,86,101,187
https://kawalpemilu.org#84969,"SIMPANGTIGA, PATIA, PANDEGLANG, BANTEN",5,83,95,178
https://kawalpemilu.org#84969,"SIMPANGTIGA, PATIA, PANDEGLANG, BANTEN",6,45,103,148
https://kawalpemilu.org#84969,"SIMPANGTIGA, PATIA, PANDEGLANG, BANTEN",7,48,134,182
https://kawalpemilu.org#51846,"KADUMERAK, KARANG TANJUNG, PANDEGLANG, BANTEN",1,71,126,197
https://kawalpemilu.org#51846,"KADUMERAK, KARANG TANJUNG, PANDEGLANG, BANTEN",2,46,161,207
https://kawalpemilu.org#51846,"KADUMERAK, KARANG TANJUNG, PANDEGLANG, BANTEN",3,52,157,209
https://kawalpemilu.org#51846,"KADUMERAK, KARANG TANJUNG, PANDEGLANG, BANTEN",4,40,72,112
https://kawalpemilu.org#51846,"KADUMERAK, KARANG TANJUNG, PANDEGLANG, BANTEN",5,28,149,177
https://kawalpemilu.org#51846,"KADUMERAK, KARANG TANJUNG, PANDEGLANG, BANTEN",6,39,116,155
https://kawalpemilu.org#51846,"KADUMERAK, KARANG TANJUNG, PANDEGLANG, BANTEN",7,26,84,110
https://kawalpemilu.org#51846,"KADUMERAK, KARANG TANJUNG, PANDEGLANG, BANTEN",8,49,156,205
https://kawalpemilu.org#51846,"KADUMERAK, KARANG TANJUNG, PANDEGLANG, BANTEN",9,38,88,126
https://kawalpemilu.org#51846,"KADUMERAK, KARANG TANJUNG, PANDEGLANG, BANTEN",10,36,143,179
https://kawalpemilu.org#51846,"KADUMERAK, KARANG TANJUNG, PANDEGLANG, BANTEN",11,38,100,138
https://kawalpemilu.org#51846,"KADUMERAK, KARANG TANJUNG, PANDEGLANG, BANTEN",12,31,156,187
https://kawalpemilu.org#51846,"KADUMERAK, KARANG TANJUNG, PANDEGLANG, BANTEN",13,8,90,98
https://kawalpemilu.org#51846,"KADUMERAK, KARANG TANJUNG, PANDEGLANG, BANTEN",14,17,92,109
https://kawalpemilu.org#51846,"KADUMERAK, KARANG TANJUNG, PANDEGLANG, BANTEN",15,22,83,105
https://kawalpemilu.org#51846,"KADUMERAK, KARANG TANJUNG, PANDEGLANG, BANTEN",16,19,119,138
https://kawalpemilu.org#51846,"KADUMERAK, KARANG TANJUNG, PANDEGLANG, BANTEN",17,17,126,143
https://kawalpemilu.org#51846,"KADUMERAK, KARANG TANJUNG, PANDEGLANG, BANTEN",18,45,94,139
https://kawalpemilu.org#51846,"KADUMERAK, KARANG TANJUNG, PANDEGLANG, BANTEN",19,45,69,114
https://kawalpemilu.org#51846,"KADUMERAK, KARANG TANJUNG, PANDEGLANG, BANTEN",20,47,151,198
https://kawalpemilu.org#51846,"KADUMERAK, KARANG TANJUNG, PANDEGLANG, BANTEN",21,63,147,210
https://kawalpemilu.org#51846,"KADUMERAK, KARANG TANJUNG, PANDEGLANG, BANTEN",22,63,115,178
https://kawalpemilu.org#51846,"KADUMERAK, KARANG TANJUNG, PANDEGLANG, BANTEN",23,91,70,161
https://kawalpemilu.org#51846,"KADUMERAK, KARANG TANJUNG, PANDEGLANG, BANTEN",24,10,53,63
https://kawalpemilu.org#51846,"KADUMERAK, KARANG TANJUNG, PANDEGLANG, BANTEN",25,13,29,42
https://kawalpemilu.org#51846,"KADUMERAK, KARANG TANJUNG, PANDEGLANG, BANTEN",26,22,103,125
https://kawalpemilu.org#51846,"KADUMERAK, KARANG TANJUNG, PANDEGLANG, BANTEN",27,37,93,130
https://kawalpemilu.org#51846,"KADUMERAK, KARANG TANJUNG, PANDEGLANG, BANTEN",28,58,175,233
https://kawalpemilu.org#51846,"KADUMERAK, KARANG TANJUNG, PANDEGLANG, BANTEN",29,38,88,126
https://kawalpemilu.org#51846,"KADUMERAK, KARANG TANJUNG, PANDEGLANG, BANTEN",30,13,73,86
https://kawalpemilu.org#51846,"KADUMERAK, KARANG TANJUNG, PANDEGLANG, BANTEN",31,22,93,115
https://kawalpemilu.org#51846,"KADUMERAK, KARANG TANJUNG, PANDEGLANG, BANTEN",32,37,100,137
https://kawalpemilu.org#51847,"CIGADUNG, KARANG TANJUNG, PANDEGLANG, BANTEN",1,47,151,198
https://kawalpemilu.org#51847,"CIGADUNG, KARANG TANJUNG, PANDEGLANG, BANTEN",2,11,33,44
https://kawalpemilu.org#51847,"CIGADUNG, KARANG TANJUNG, PANDEGLANG, BANTEN",3,68,159,227
https://kawalpemilu.org#51847,"CIGADUNG, KARANG TANJUNG, PANDEGLANG, BANTEN",4,24,134,158
https://kawalpemilu.org#51847,"CIGADUNG, KARANG TANJUNG, PANDEGLANG, BANTEN",5,38,78,116
https://kawalpemilu.org#51847,"CIGADUNG, KARANG TANJUNG, PANDEGLANG, BANTEN",6,61,177,238
https://kawalpemilu.org#51847,"CIGADUNG, KARANG TANJUNG, PANDEGLANG, BANTEN",7,22,112,134
https://kawalpemilu.org#51847,"CIGADUNG, KARANG TANJUNG, PANDEGLANG, BANTEN",8,90,110,200
https://kawalpemilu.org#51847,"CIGADUNG, KARANG TANJUNG, PANDEGLANG, BANTEN",9,58,111,169
https://kawalpemilu.org#51847,"CIGADUNG, KARANG TANJUNG, PANDEGLANG, BANTEN",10,74,121,195
https://kawalpemilu.org#51847,"CIGADUNG, KARANG TANJUNG, PANDEGLANG, BANTEN",11,59,132,191
https://kawalpemilu.org#51847,"CIGADUNG, KARANG TANJUNG, PANDEGLANG, BANTEN",12,61,112,173
https://kawalpemilu.org#51847,"CIGADUNG, KARANG TANJUNG, PANDEGLANG, BANTEN",13,52,127,179
https://kawalpemilu.org#51847,"CIGADUNG, KARANG TANJUNG, PANDEGLANG, BANTEN",14,39,127,166
https://kawalpemilu.org#51847,"CIGADUNG, KARANG TANJUNG, PANDEGLANG, BANTEN",15,35,155,190
https://kawalpemilu.org#51847,"CIGADUNG, KARANG TANJUNG, PANDEGLANG, BANTEN",16,45,151,196
https://kawalpemilu.org#51847,"CIGADUNG, KARANG TANJUNG, PANDEGLANG, BANTEN",17,43,226,269
https://kawalpemilu.org#51847,"CIGADUNG, KARANG TANJUNG, PANDEGLANG, BANTEN",18,35,147,182
https://kawalpemilu.org#51847,"CIGADUNG, KARANG TANJUNG, PANDEGLANG, BANTEN",19,29,114,143
https://kawalpemilu.org#51847,"CIGADUNG, KARANG TANJUNG, PANDEGLANG, BANTEN",20,132,97,229
https://kawalpemilu.org#51847,"CIGADUNG, KARANG TANJUNG, PANDEGLANG, BANTEN",21,72,60,132
https://kawalpemilu.org#51847,"CIGADUNG, KARANG TANJUNG, PANDEGLANG, BANTEN",22,103,108,211
https://kawalpemilu.org#51847,"CIGADUNG, KARANG TANJUNG, PANDEGLANG, BANTEN",23,54,183,237
https://kawalpemilu.org#51847,"CIGADUNG, KARANG TANJUNG, PANDEGLANG, BANTEN",24,67,119,186
https://kawalpemilu.org#51847,"CIGADUNG, KARANG TANJUNG, PANDEGLANG, BANTEN",25,57,123,180
https://kawalpemilu.org#51847,"CIGADUNG, KARANG TANJUNG, PANDEGLANG, BANTEN",26,19,95,114
https://kawalpemilu.org#51847,"CIGADUNG, KARANG TANJUNG, PANDEGLANG, BANTEN",27,65,134,199
https://kawalpemilu.org#51847,"CIGADUNG, KARANG TANJUNG, PANDEGLANG, BANTEN",28,65,147,212
https://kawalpemilu.org#51847,"CIGADUNG, KARANG TANJUNG, PANDEGLANG, BANTEN",29,72,109,181
https://kawalpemilu.org#51847,"CIGADUNG, KARANG TANJUNG, PANDEGLANG, BANTEN",30,45,105,150
https://kawalpemilu.org#51847,"CIGADUNG, KARANG TANJUNG, PANDEGLANG, BANTEN",31,32,96,128
https://kawalpemilu.org#51847,"CIGADUNG, KARANG TANJUNG, PANDEGLANG, BANTEN",32,47,150,197
https://kawalpemilu.org#51847,"CIGADUNG, KARANG TANJUNG, PANDEGLANG, BANTEN",33,28,61,89
https://kawalpemilu.org#51847,"CIGADUNG, KARANG TANJUNG, PANDEGLANG, BANTEN",34,22,57,79
https://kawalpemilu.org#51847,"CIGADUNG, KARANG TANJUNG, PANDEGLANG, BANTEN",35,11,48,59
https://kawalpemilu.org#51847,"CIGADUNG, KARANG TANJUNG, PANDEGLANG, BANTEN",36,76,147,223
https://kawalpemilu.org#51847,"CIGADUNG, KARANG TANJUNG, PANDEGLANG, BANTEN",37,72,149,221
https://kawalpemilu.org#51847,"CIGADUNG, KARANG TANJUNG, PANDEGLANG, BANTEN",38,55,133,188
https://kawalpemilu.org#51847,"CIGADUNG, KARANG TANJUNG, PANDEGLANG, BANTEN",39,40,115,155
https://kawalpemilu.org#51847,"CIGADUNG, KARANG TANJUNG, PANDEGLANG, BANTEN",40,55,165,220
https://kawalpemilu.org#51847,"CIGADUNG, KARANG TANJUNG, PANDEGLANG, BANTEN",41,55,124,179
https://kawalpemilu.org#51847,"CIGADUNG, KARANG TANJUNG, PANDEGLANG, BANTEN",42,50,140,190
https://kawalpemilu.org#51847,"CIGADUNG, KARANG TANJUNG, PANDEGLANG, BANTEN",43,53,168,221
https://kawalpemilu.org#51848,"PAGADUNGAN, KARANG TANJUNG, PANDEGLANG, BANTEN",1,68,116,184
https://kawalpemilu.org#51848,"PAGADUNGAN, KARANG TANJUNG, PANDEGLANG, BANTEN",2,37,166,203
https://kawalpemilu.org#51848,"PAGADUNGAN, KARANG TANJUNG, PANDEGLANG, BANTEN",3,39,196,235
https://kawalpemilu.org#51848,"PAGADUNGAN, KARANG TANJUNG, PANDEGLANG, BANTEN",4,43,138,181
https://kawalpemilu.org#51848,"PAGADUNGAN, KARANG TANJUNG, PANDEGLANG, BANTEN",5,59,119,178
https://kawalpemilu.org#51848,"PAGADUNGAN, KARANG TANJUNG, PANDEGLANG, BANTEN",6,46,132,178
https://kawalpemilu.org#51848,"PAGADUNGAN, KARANG TANJUNG, PANDEGLANG, BANTEN",7,52,165,217
https://kawalpemilu.org#51848,"PAGADUNGAN, KARANG TANJUNG, PANDEGLANG, BANTEN",8,63,189,252
https://kawalpemilu.org#51848,"PAGADUNGAN, KARANG TANJUNG, PANDEGLANG, BANTEN",9,69,87,156
https://kawalpemilu.org#51848,"PAGADUNGAN, KARANG TANJUNG, PANDEGLANG, BANTEN",10,78,166,244
https://kawalpemilu.org#51848,"PAGADUNGAN, KARANG TANJUNG, PANDEGLANG, BANTEN",11,39,105,144
https://kawalpemilu.org#51848,"PAGADUNGAN, KARANG TANJUNG, PANDEGLANG, BANTEN",12,58,161,219
https://kawalpemilu.org#51848,"PAGADUNGAN, KARANG TANJUNG, PANDEGLANG, BANTEN",13,53,175,228
https://kawalpemilu.org#51848,"PAGADUNGAN, KARANG TANJUNG, PANDEGLANG, BANTEN",14,73,135,208
https://kawalpemilu.org#51848,"PAGADUNGAN, KARANG TANJUNG, PANDEGLANG, BANTEN",15,53,179,232
https://kawalpemilu.org#51848,"PAGADUNGAN, KARANG TANJUNG, PANDEGLANG, BANTEN",16,54,170,224
https://kawalpemilu.org#51848,"PAGADUNGAN, KARANG TANJUNG, PANDEGLANG, BANTEN",17,61,152,213
https://kawalpemilu.org#51848,"PAGADUNGAN, KARANG TANJUNG, PANDEGLANG, BANTEN",18,39,101,140
https://kawalpemilu.org#51848,"PAGADUNGAN, KARANG TANJUNG, PANDEGLANG, BANTEN",19,26,165,191
https://kawalpemilu.org#51848,"PAGADUNGAN, KARANG TANJUNG, PANDEGLANG, BANTEN",20,66,107,173
https://kawalpemilu.org#51848,"PAGADUNGAN, KARANG TANJUNG, PANDEGLANG, BANTEN",21,58,108,166
https://kawalpemilu.org#51849,"JUHUT, KARANG TANJUNG, PANDEGLANG, BANTEN",1,51,174,225
https://kawalpemilu.org#51849,"JUHUT, KARANG TANJUNG, PANDEGLANG, BANTEN",2,35,111,146
https://kawalpemilu.org#51849,"JUHUT, KARANG TANJUNG, PANDEGLANG, BANTEN",3,41,179,220
https://kawalpemilu.org#51849,"JUHUT, KARANG TANJUNG, PANDEGLANG, BANTEN",4,40,171,211
https://kawalpemilu.org#51849,"JUHUT, KARANG TANJUNG, PANDEGLANG, BANTEN",5,35,164,199
https://kawalpemilu.org#51849,"JUHUT, KARANG TANJUNG, PANDEGLANG, BANTEN",6,59,96,155
https://kawalpemilu.org#51849,"JUHUT, KARANG TANJUNG, PANDEGLANG, BANTEN",7,46,134,180
https://kawalpemilu.org#51849,"JUHUT, KARANG TANJUNG, PANDEGLANG, BANTEN",8,45,125,170
https://kawalpemilu.org#51849,"JUHUT, KARANG TANJUNG, PANDEGLANG, BANTEN",9,47,163,210
https://kawalpemilu.org#51849,"JUHUT, KARANG TANJUNG, PANDEGLANG, BANTEN",10,26,129,155
https://kawalpemilu.org#51849,"JUHUT, KARANG TANJUNG, PANDEGLANG, BANTEN",11,27,147,174
https://kawalpemilu.org#51849,"JUHUT, KARANG TANJUNG, PANDEGLANG, BANTEN",12,36,133,169
https://kawalpemilu.org#51849,"JUHUT, KARANG TANJUNG, PANDEGLANG, BANTEN",13,47,121,168
https://kawalpemilu.org#51849,"JUHUT, KARANG TANJUNG, PANDEGLANG, BANTEN",14,44,124,168
https://kawalpemilu.org#51849,"JUHUT, KARANG TANJUNG, PANDEGLANG, BANTEN",15,35,180,215
https://kawalpemilu.org#51849,"JUHUT, KARANG TANJUNG, PANDEGLANG, BANTEN",16,108,93,201
https://kawalpemilu.org#51849,"JUHUT, KARANG TANJUNG, PANDEGLANG, BANTEN",17,97,78,175
https://kawalpemilu.org#51849,"JUHUT, KARANG TANJUNG, PANDEGLANG, BANTEN",18,95,123,218
https://kawalpemilu.org#51849,"JUHUT, KARANG TANJUNG, PANDEGLANG, BANTEN",19,58,121,179
https://kawalpemilu.org#51849,"JUHUT, KARANG TANJUNG, PANDEGLANG, BANTEN",20,85,113,198
https://kawalpemilu.org#51849,"JUHUT, KARANG TANJUNG, PANDEGLANG, BANTEN",21,42,207,249
https://kawalpemilu.org#51849,"JUHUT, KARANG TANJUNG, PANDEGLANG, BANTEN",22,69,160,229
https://kawalpemilu.org#51849,"JUHUT, KARANG TANJUNG, PANDEGLANG, BANTEN",23,53,138,191
https://kawalpemilu.org#51849,"JUHUT, KARANG TANJUNG, PANDEGLANG, BANTEN",24,67,67,134
https://kawalpemilu.org#51851,"KARYASARI, CIKEDAL, PANDEGLANG, BANTEN",1,43,111,154
https://kawalpemilu.org#51851,"KARYASARI, CIKEDAL, PANDEGLANG, BANTEN",2,22,152,174
https://kawalpemilu.org#51851,"KARYASARI, CIKEDAL, PANDEGLANG, BANTEN",3,51,96,147
https://kawalpemilu.org#51851,"KARYASARI, CIKEDAL, PANDEGLANG, BANTEN",4,69,172,241
https://kawalpemilu.org#51851,"KARYASARI, CIKEDAL, PANDEGLANG, BANTEN",5,53,114,167
https://kawalpemilu.org#51851,"KARYASARI, CIKEDAL, PANDEGLANG, BANTEN",6,62,111,173
https://kawalpemilu.org#51851,"KARYASARI, CIKEDAL, PANDEGLANG, BANTEN",7,34,135,169
https://kawalpemilu.org#51851,"KARYASARI, CIKEDAL, PANDEGLANG, BANTEN",8,27,154,181
https://kawalpemilu.org#51851,"KARYASARI, CIKEDAL, PANDEGLANG, BANTEN",9,45,49,94
https://kawalpemilu.org#51851,"KARYASARI, CIKEDAL, PANDEGLANG, BANTEN",10,79,114,193
https://kawalpemilu.org#51851,"KARYASARI, CIKEDAL, PANDEGLANG, BANTEN",11,49,75,124
https://kawalpemilu.org#51851,"KARYASARI, CIKEDAL, PANDEGLANG, BANTEN",12,89,123,212
https://kawalpemilu.org#51851,"KARYASARI, CIKEDAL, PANDEGLANG, BANTEN",13,61,143,204
https://kawalpemilu.org#51851,"KARYASARI, CIKEDAL, PANDEGLANG, BANTEN",14,78,116,194
https://kawalpemilu.org#51851,"KARYASARI, CIKEDAL, PANDEGLANG, BANTEN",15,42,90,132
https://kawalpemilu.org#51851,"KARYASARI, CIKEDAL, PANDEGLANG, BANTEN",16,36,81,117
https://kawalpemilu.org#51852,"TEGAL, CIKEDAL, PANDEGLANG, BANTEN",1,45,173,218
https://kawalpemilu.org#51852,"TEGAL, CIKEDAL, PANDEGLANG, BANTEN",2,36,159,195
https://kawalpemilu.org#51852,"TEGAL, CIKEDAL, PANDEGLANG, BANTEN",3,43,187,230
https://kawalpemilu.org#51852,"TEGAL, CIKEDAL, PANDEGLANG, BANTEN",4,30,144,174
https://kawalpemilu.org#51852,"TEGAL, CIKEDAL, PANDEGLANG, BANTEN",5,110,97,207
https://kawalpemilu.org#51852,"TEGAL, CIKEDAL, PANDEGLANG, BANTEN",6,84,122,206
https://kawalpemilu.org#51852,"TEGAL, CIKEDAL, PANDEGLANG, BANTEN",7,28,186,214
https://kawalpemilu.org#51853,"CIPICUNG, CIKEDAL, PANDEGLANG, BANTEN",1,75,171,246
https://kawalpemilu.org#51853,"CIPICUNG, CIKEDAL, PANDEGLANG, BANTEN",2,74,137,211
https://kawalpemilu.org#51853,"CIPICUNG, CIKEDAL, PANDEGLANG, BANTEN",3,107,141,248
https://kawalpemilu.org#51853,"CIPICUNG, CIKEDAL, PANDEGLANG, BANTEN",4,94,149,243
https://kawalpemilu.org#51853,"CIPICUNG, CIKEDAL, PANDEGLANG, BANTEN",5,62,140,202
https://kawalpemilu.org#51853,"CIPICUNG, CIKEDAL, PANDEGLANG, BANTEN",6,81,173,254
https://kawalpemilu.org#51853,"CIPICUNG, CIKEDAL, PANDEGLANG, BANTEN",8,50,193,243
https://kawalpemilu.org#51853,"CIPICUNG, CIKEDAL, PANDEGLANG, BANTEN",9,87,115,202
https://kawalpemilu.org#51853,"CIPICUNG, CIKEDAL, PANDEGLANG, BANTEN",10,67,103,170
https://kawalpemilu.org#51853,"CIPICUNG, CIKEDAL, PANDEGLANG, BANTEN",11,72,104,176
https://kawalpemilu.org#51853,"CIPICUNG, CIKEDAL, PANDEGLANG, BANTEN",12,71,158,229
https://kawalpemilu.org#51853,"CIPICUNG, CIKEDAL, PANDEGLANG, BANTEN",13,55,116,171
https://kawalpemilu.org#51853,"CIPICUNG, CIKEDAL, PANDEGLANG, BANTEN",14,58,152,210
https://kawalpemilu.org#51853,"CIPICUNG, CIKEDAL, PANDEGLANG, BANTEN",15,35,116,151
https://kawalpemilu.org#51854,"DAHU, CIKEDAL, PANDEGLANG, BANTEN",1,29,170,199
https://kawalpemilu.org#51854,"DAHU, CIKEDAL, PANDEGLANG, BANTEN",2,45,125,170
https://kawalpemilu.org#51854,"DAHU, CIKEDAL, PANDEGLANG, BANTEN",3,64,135,199
https://kawalpemilu.org#51854,"DAHU, CIKEDAL, PANDEGLANG, BANTEN",4,61,71,132
https://kawalpemilu.org#51854,"DAHU, CIKEDAL, PANDEGLANG, BANTEN",5,54,123,177
https://kawalpemilu.org#51854,"DAHU, CIKEDAL, PANDEGLANG, BANTEN",6,46,107,153
https://kawalpemilu.org#51854,"DAHU, CIKEDAL, PANDEGLANG, BANTEN",7,96,100,196
https://kawalpemilu.org#51854,"DAHU, CIKEDAL, PANDEGLANG, BANTEN",8,72,69,141
https://kawalpemilu.org#51854,"DAHU, CIKEDAL, PANDEGLANG, BANTEN",9,58,85,143
https://kawalpemilu.org#51854,"DAHU, CIKEDAL, PANDEGLANG, BANTEN",10,102,60,162
https://kawalpemilu.org#51854,"DAHU, CIKEDAL, PANDEGLANG, BANTEN",11,82,59,141
https://kawalpemilu.org#51855,"BABAKANLOR, CIKEDAL, PANDEGLANG, BANTEN",1,100,92,192
https://kawalpemilu.org#51855,"BABAKANLOR, CIKEDAL, PANDEGLANG, BANTEN",2,101,106,207
https://kawalpemilu.org#51855,"BABAKANLOR, CIKEDAL, PANDEGLANG, BANTEN",3,99,120,219
https://kawalpemilu.org#51855,"BABAKANLOR, CIKEDAL, PANDEGLANG, BANTEN",4,71,159,230
https://kawalpemilu.org#51855,"BABAKANLOR, CIKEDAL, PANDEGLANG, BANTEN",5,48,141,189
https://kawalpemilu.org#51855,"BABAKANLOR, CIKEDAL, PANDEGLANG, BANTEN",6,51,149,200
https://kawalpemilu.org#51855,"BABAKANLOR, CIKEDAL, PANDEGLANG, BANTEN",7,45,135,180
https://kawalpemilu.org#51855,"BABAKANLOR, CIKEDAL, PANDEGLANG, BANTEN",8,46,108,154
https://kawalpemilu.org#51855,"BABAKANLOR, CIKEDAL, PANDEGLANG, BANTEN",9,69,154,223
https://kawalpemilu.org#51855,"BABAKANLOR, CIKEDAL, PANDEGLANG, BANTEN",10,52,114,166
https://kawalpemilu.org#51855,"BABAKANLOR, CIKEDAL, PANDEGLANG, BANTEN",11,48,95,143
https://kawalpemilu.org#51855,"BABAKANLOR, CIKEDAL, PANDEGLANG, BANTEN",12,60,133,193
https://kawalpemilu.org#51855,"BABAKANLOR, CIKEDAL, PANDEGLANG, BANTEN",13,44,119,163
https://kawalpemilu.org#51855,"BABAKANLOR, CIKEDAL, PANDEGLANG, BANTEN",14,36,130,166
https://kawalpemilu.org#51855,"BABAKANLOR, CIKEDAL, PANDEGLANG, BANTEN",15,63,125,188
https://kawalpemilu.org#51855,"BABAKANLOR, CIKEDAL, PANDEGLANG, BANTEN",16,67,96,163
https://kawalpemilu.org#51855,"BABAKANLOR, CIKEDAL, PANDEGLANG, BANTEN",17,100,98,198
https://kawalpemilu.org#51856,"KARYAUTAMA, CIKEDAL, PANDEGLANG, BANTEN",1,84,154,238
https://kawalpemilu.org#51856,"KARYAUTAMA, CIKEDAL, PANDEGLANG, BANTEN",2,67,195,262
https://kawalpemilu.org#51856,"KARYAUTAMA, CIKEDAL, PANDEGLANG, BANTEN",3,55,149,204
https://kawalpemilu.org#51856,"KARYAUTAMA, CIKEDAL, PANDEGLANG, BANTEN",4,40,105,145
https://kawalpemilu.org#51856,"KARYAUTAMA, CIKEDAL, PANDEGLANG, BANTEN",5,35,175,210
https://kawalpemilu.org#51856,"KARYAUTAMA, CIKEDAL, PANDEGLANG, BANTEN",6,39,186,225
https://kawalpemilu.org#51856,"KARYAUTAMA, CIKEDAL, PANDEGLANG, BANTEN",7,60,134,194
https://kawalpemilu.org#51856,"KARYAUTAMA, CIKEDAL, PANDEGLANG, BANTEN",8,51,98,149
https://kawalpemilu.org#51856,"KARYAUTAMA, CIKEDAL, PANDEGLANG, BANTEN",9,78,109,187
https://kawalpemilu.org#51856,"KARYAUTAMA, CIKEDAL, PANDEGLANG, BANTEN",10,49,80,129
https://kawalpemilu.org#51857,"MEKARJAYA, CIKEDAL, PANDEGLANG, BANTEN",1,58,77,135
https://kawalpemilu.org#51857,"MEKARJAYA, CIKEDAL, PANDEGLANG, BANTEN",2,39,122,161
https://kawalpemilu.org#51857,"MEKARJAYA, CIKEDAL, PANDEGLANG, BANTEN",3,44,143,187
https://kawalpemilu.org#51857,"MEKARJAYA, CIKEDAL, PANDEGLANG, BANTEN",4,43,136,179
https://kawalpemilu.org#51857,"MEKARJAYA, CIKEDAL, PANDEGLANG, BANTEN",5,51,80,131
https://kawalpemilu.org#51857,"MEKARJAYA, CIKEDAL, PANDEGLANG, BANTEN",6,28,84,112
https://kawalpemilu.org#51857,"MEKARJAYA, CIKEDAL, PANDEGLANG, BANTEN",7,28,79,107
https://kawalpemilu.org#51857,"MEKARJAYA, CIKEDAL, PANDEGLANG, BANTEN",8,107,38,145
https://kawalpemilu.org#51858,"PADAHAYU, CIKEDAL, PANDEGLANG, BANTEN",1,207,34,241
https://kawalpemilu.org#51858,"PADAHAYU, CIKEDAL, PANDEGLANG, BANTEN",2,156,67,223
https://kawalpemilu.org#51858,"PADAHAYU, CIKEDAL, PANDEGLANG, BANTEN",3,141,130,271
https://kawalpemilu.org#51858,"PADAHAYU, CIKEDAL, PANDEGLANG, BANTEN",4,56,98,154
https://kawalpemilu.org#51858,"PADAHAYU, CIKEDAL, PANDEGLANG, BANTEN",5,82,148,230
https://kawalpemilu.org#51858,"PADAHAYU, CIKEDAL, PANDEGLANG, BANTEN",6,75,185,260
https://kawalpemilu.org#51858,"PADAHAYU, CIKEDAL, PANDEGLANG, BANTEN",7,126,137,263
https://kawalpemilu.org#51859,"CENING, CIKEDAL, PANDEGLANG, BANTEN",1,127,89,216
https://kawalpemilu.org#51859,"CENING, CIKEDAL, PANDEGLANG, BANTEN",2,74,66,140
https://kawalpemilu.org#51859,"CENING, CIKEDAL, PANDEGLANG, BANTEN",3,59,129,188
https://kawalpemilu.org#51859,"CENING, CIKEDAL, PANDEGLANG, BANTEN",4,32,114,146
https://kawalpemilu.org#51859,"CENING, CIKEDAL, PANDEGLANG, BANTEN",5,32,125,157
https://kawalpemilu.org#51859,"CENING, CIKEDAL, PANDEGLANG, BANTEN",6,23,145,168
https://kawalpemilu.org#51859,"CENING, CIKEDAL, PANDEGLANG, BANTEN",7,63,144,207
https://kawalpemilu.org#51859,"CENING, CIKEDAL, PANDEGLANG, BANTEN",8,47,140,187
https://kawalpemilu.org#51859,"CENING, CIKEDAL, PANDEGLANG, BANTEN",9,42,102,144
https://kawalpemilu.org#51859,"CENING, CIKEDAL, PANDEGLANG, BANTEN",10,41,174,215
https://kawalpemilu.org#51860,"BANGKUYUNG, CIKEDAL, PANDEGLANG, BANTEN",1,34,111,145
https://kawalpemilu.org#51860,"BANGKUYUNG, CIKEDAL, PANDEGLANG, BANTEN",2,19,139,158
https://kawalpemilu.org#51860,"BANGKUYUNG, CIKEDAL, PANDEGLANG, BANTEN",3,29,160,189
https://kawalpemilu.org#51860,"BANGKUYUNG, CIKEDAL, PANDEGLANG, BANTEN",4,63,159,222
https://kawalpemilu.org#51860,"BANGKUYUNG, CIKEDAL, PANDEGLANG, BANTEN",5,49,119,168
https://kawalpemilu.org#51860,"BANGKUYUNG, CIKEDAL, PANDEGLANG, BANTEN",6,63,98,161
https://kawalpemilu.org#51860,"BANGKUYUNG, CIKEDAL, PANDEGLANG, BANTEN",7,56,116,172
https://kawalpemilu.org#51860,"BANGKUYUNG, CIKEDAL, PANDEGLANG, BANTEN",8,42,135,177
https://kawalpemilu.org#51862,"CIKALONG, CIBITUNG, PANDEGLANG, BANTEN",1,95,104,199
https://kawalpemilu.org#51862,"CIKALONG, CIBITUNG, PANDEGLANG, BANTEN",2,80,141,221
https://kawalpemilu.org#51862,"CIKALONG, CIBITUNG, PANDEGLANG, BANTEN",3,90,106,196
https://kawalpemilu.org#51862,"CIKALONG, CIBITUNG, PANDEGLANG, BANTEN",4,114,67,181
https://kawalpemilu.org#51862,"CIKALONG, CIBITUNG, PANDEGLANG, BANTEN",5,50,69,119
https://kawalpemilu.org#51862,"CIKALONG, CIBITUNG, PANDEGLANG, BANTEN",6,90,32,122
https://kawalpemilu.org#51863,"CIKADU, CIBITUNG, PANDEGLANG, BANTEN",1,33,164,197
https://kawalpemilu.org#51863,"CIKADU, CIBITUNG, PANDEGLANG, BANTEN",2,35,138,173
https://kawalpemilu.org#51863,"CIKADU, CIBITUNG, PANDEGLANG, BANTEN",3,21,134,155
https://kawalpemilu.org#51863,"CIKADU, CIBITUNG, PANDEGLANG, BANTEN",4,83,108,191
https://kawalpemilu.org#51863,"CIKADU, CIBITUNG, PANDEGLANG, BANTEN",5,102,80,182
https://kawalpemilu.org#51863,"CIKADU, CIBITUNG, PANDEGLANG, BANTEN",6,23,210,233
https://kawalpemilu.org#51863,"CIKADU, CIBITUNG, PANDEGLANG, BANTEN",7,21,143,164
https://kawalpemilu.org#51863,"CIKADU, CIBITUNG, PANDEGLANG, BANTEN",8,33,158,191
https://kawalpemilu.org#51863,"CIKADU, CIBITUNG, PANDEGLANG, BANTEN",9,47,158,205
https://kawalpemilu.org#51863,"CIKADU, CIBITUNG, PANDEGLANG, BANTEN",10,78,49,127
https://kawalpemilu.org#51864,"MALANGNENGAH, CIBITUNG, PANDEGLANG, BANTEN",1,106,50,156
https://kawalpemilu.org#51864,"MALANGNENGAH, CIBITUNG, PANDEGLANG, BANTEN",2,94,102,196
https://kawalpemilu.org#51864,"MALANGNENGAH, CIBITUNG, PANDEGLANG, BANTEN",3,126,87,213
https://kawalpemilu.org#51864,"MALANGNENGAH, CIBITUNG, PANDEGLANG, BANTEN",4,88,42,130
https://kawalpemilu.org#51864,"MALANGNENGAH, CIBITUNG, PANDEGLANG, BANTEN",5,97,68,165
https://kawalpemilu.org#51865,"KIARAPAYUNG, CIBITUNG, PANDEGLANG, BANTEN",1,23,191,214
https://kawalpemilu.org#51865,"KIARAPAYUNG, CIBITUNG, PANDEGLANG, BANTEN",2,40,150,190
https://kawalpemilu.org#51865,"KIARAPAYUNG, CIBITUNG, PANDEGLANG, BANTEN",3,87,102,189
https://kawalpemilu.org#51865,"KIARAPAYUNG, CIBITUNG, PANDEGLANG, BANTEN",4,33,181,214
https://kawalpemilu.org#51865,"KIARAPAYUNG, CIBITUNG, PANDEGLANG, BANTEN",5,47,158,205
https://kawalpemilu.org#51865,"KIARAPAYUNG, CIBITUNG, PANDEGLANG, BANTEN",6,83,120,203
https://kawalpemilu.org#51866,"MANGLID, CIBITUNG, PANDEGLANG, BANTEN",1,47,125,172
https://kawalpemilu.org#51866,"MANGLID, CIBITUNG, PANDEGLANG, BANTEN",3,37,165,202
https://kawalpemilu.org#51866,"MANGLID, CIBITUNG, PANDEGLANG, BANTEN",4,21,182,203
https://kawalpemilu.org#51866,"MANGLID, CIBITUNG, PANDEGLANG, BANTEN",5,17,118,135
https://kawalpemilu.org#51866,"MANGLID, CIBITUNG, PANDEGLANG, BANTEN",6,58,116,174
https://kawalpemilu.org#51866,"MANGLID, CIBITUNG, PANDEGLANG, BANTEN",7,25,110,135
https://kawalpemilu.org#51866,"MANGLID, CIBITUNG, PANDEGLANG, BANTEN",8,33,162,195
https://kawalpemilu.org#51866,"MANGLID, CIBITUNG, PANDEGLANG, BANTEN",9,74,148,222
https://kawalpemilu.org#51867,"CITELUK, CIBITUNG, PANDEGLANG, BANTEN",1,42,130,172
https://kawalpemilu.org#51867,"CITELUK, CIBITUNG, PANDEGLANG, BANTEN",2,30,146,176
https://kawalpemilu.org#51867,"CITELUK, CIBITUNG, PANDEGLANG, BANTEN",3,56,85,141
https://kawalpemilu.org#51867,"CITELUK, CIBITUNG, PANDEGLANG, BANTEN",4,86,63,149
https://kawalpemilu.org#51867,"CITELUK, CIBITUNG, PANDEGLANG, BANTEN",5,128,67,195
https://kawalpemilu.org#51867,"CITELUK, CIBITUNG, PANDEGLANG, BANTEN",6,100,86,186
https://kawalpemilu.org#51867,"CITELUK, CIBITUNG, PANDEGLANG, BANTEN",7,59,103,162
https://kawalpemilu.org#51868,"SINDANGKERTA, CIBITUNG, PANDEGLANG, BANTEN",1,54,122,176
https://kawalpemilu.org#51868,"SINDANGKERTA, CIBITUNG, PANDEGLANG, BANTEN",2,96,70,166
https://kawalpemilu.org#51868,"SINDANGKERTA, CIBITUNG, PANDEGLANG, BANTEN",3,154,36,190
https://kawalpemilu.org#51868,"SINDANGKERTA, CIBITUNG, PANDEGLANG, BANTEN",4,111,35,146
https://kawalpemilu.org#51868,"SINDANGKERTA, CIBITUNG, PANDEGLANG, BANTEN",5,75,112,187
https://kawalpemilu.org#51869,"KIARAJANGKUNG, CIBITUNG, PANDEGLANG, BANTEN",1,73,91,164
https://kawalpemilu.org#51869,"KIARAJANGKUNG, CIBITUNG, PANDEGLANG, BANTEN",2,64,144,208
https://kawalpemilu.org#51869,"KIARAJANGKUNG, CIBITUNG, PANDEGLANG, BANTEN",3,62,127,189
https://kawalpemilu.org#51869,"KIARAJANGKUNG, CIBITUNG, PANDEGLANG, BANTEN",4,81,82,163
https://kawalpemilu.org#51869,"KIARAJANGKUNG, CIBITUNG, PANDEGLANG, BANTEN",5,110,54,164
https://kawalpemilu.org#51870,"KUTAKARANG, CIBITUNG, PANDEGLANG, BANTEN",2,54,82,136
https://kawalpemilu.org#51870,"KUTAKARANG, CIBITUNG, PANDEGLANG, BANTEN",3,73,129,202
https://kawalpemilu.org#51870,"KUTAKARANG, CIBITUNG, PANDEGLANG, BANTEN",4,142,74,216
https://kawalpemilu.org#51870,"KUTAKARANG, CIBITUNG, PANDEGLANG, BANTEN",5,73,104,177
https://kawalpemilu.org#51870,"KUTAKARANG, CIBITUNG, PANDEGLANG, BANTEN",6,121,77,198
https://kawalpemilu.org#51870,"KUTAKARANG, CIBITUNG, PANDEGLANG, BANTEN",7,123,11,134
https://kawalpemilu.org#51870,"KUTAKARANG, CIBITUNG, PANDEGLANG, BANTEN",8,86,80,166
https://kawalpemilu.org#51870,"KUTAKARANG, CIBITUNG, PANDEGLANG, BANTEN",9,137,27,164
https://kawalpemilu.org#51870,"KUTAKARANG, CIBITUNG, PANDEGLANG, BANTEN",10,144,24,168
https://kawalpemilu.org#51871,"CIKIRUH, CIBITUNG, PANDEGLANG, BANTEN",1,95,116,211
https://kawalpemilu.org#51871,"CIKIRUH, CIBITUNG, PANDEGLANG, BANTEN",2,83,144,227
https://kawalpemilu.org#51871,"CIKIRUH, CIBITUNG, PANDEGLANG, BANTEN",3,150,21,171
https://kawalpemilu.org#51871,"CIKIRUH, CIBITUNG, PANDEGLANG, BANTEN",4,94,46,139
https://kawalpemilu.org#51871,"CIKIRUH, CIBITUNG, PANDEGLANG, BANTEN",5,95,39,134
https://kawalpemilu.org#51871,"CIKIRUH, CIBITUNG, PANDEGLANG, BANTEN",6,143,19,162
https://kawalpemilu.org#51871,"CIKIRUH, CIBITUNG, PANDEGLANG, BANTEN",7,159,24,183
https://kawalpemilu.org#51873,"PEJAMBEN, CARITA, PANDEGLANG, BANTEN",1,67,114,181
https://kawalpemilu.org#51873,"PEJAMBEN, CARITA, PANDEGLANG, BANTEN",2,93,122,215
https://kawalpemilu.org#51873,"PEJAMBEN, CARITA, PANDEGLANG, BANTEN",3,131,113,244
https://kawalpemilu.org#51873,"PEJAMBEN, CARITA, PANDEGLANG, BANTEN",4,57,124,181
https://kawalpemilu.org#51873,"PEJAMBEN, CARITA, PANDEGLANG, BANTEN",5,64,151,215
https://kawalpemilu.org#51873,"PEJAMBEN, CARITA, PANDEGLANG, BANTEN",6,57,135,192
https://kawalpemilu.org#51873,"PEJAMBEN, CARITA, PANDEGLANG, BANTEN",7,53,161,214
https://kawalpemilu.org#51873,"PEJAMBEN, CARITA, PANDEGLANG, BANTEN",8,46,152,198
https://kawalpemilu.org#51873,"PEJAMBEN, CARITA, PANDEGLANG, BANTEN",9,108,112,220
https://kawalpemilu.org#51873,"PEJAMBEN, CARITA, PANDEGLANG, BANTEN",10,94,91,185
https://kawalpemilu.org#51873,"PEJAMBEN, CARITA, PANDEGLANG, BANTEN",11,132,96,228
https://kawalpemilu.org#51873,"PEJAMBEN, CARITA, PANDEGLANG, BANTEN",12,84,80,164
https://kawalpemilu.org#51874,"BANJARMASIN, CARITA, PANDEGLANG, BANTEN",2,42,100,142
https://kawalpemilu.org#51874,"BANJARMASIN, CARITA, PANDEGLANG, BANTEN",3,44,100,144
https://kawalpemilu.org#51874,"BANJARMASIN, CARITA, PANDEGLANG, BANTEN",4,41,166,207
https://kawalpemilu.org#51874,"BANJARMASIN, CARITA, PANDEGLANG, BANTEN",5,86,139,225
https://kawalpemilu.org#51874,"BANJARMASIN, CARITA, PANDEGLANG, BANTEN",6,144,106,250
https://kawalpemilu.org#51874,"BANJARMASIN, CARITA, PANDEGLANG, BANTEN",7,146,114,260
https://kawalpemilu.org#51874,"BANJARMASIN, CARITA, PANDEGLANG, BANTEN",8,76,68,144
https://kawalpemilu.org#51874,"BANJARMASIN, CARITA, PANDEGLANG, BANTEN",9,0,0,0
https://kawalpemilu.org#51874,"BANJARMASIN, CARITA, PANDEGLANG, BANTEN",10,0,0,0
https://kawalpemilu.org#51874,"BANJARMASIN, CARITA, PANDEGLANG, BANTEN",11,80,107,187
https://kawalpemilu.org#51874,"BANJARMASIN, CARITA, PANDEGLANG, BANTEN",12,76,116,192
https://kawalpemilu.org#51875,"TEMBONG, CARITA, PANDEGLANG, BANTEN",1,79,123,202
https://kawalpemilu.org#51875,"TEMBONG, CARITA, PANDEGLANG, BANTEN",2,27,169,196
https://kawalpemilu.org#51875,"TEMBONG, CARITA, PANDEGLANG, BANTEN",3,69,97,166
https://kawalpemilu.org#51875,"TEMBONG, CARITA, PANDEGLANG, BANTEN",4,33,113,146
https://kawalpemilu.org#51875,"TEMBONG, CARITA, PANDEGLANG, BANTEN",5,93,86,179
https://kawalpemilu.org#51875,"TEMBONG, CARITA, PANDEGLANG, BANTEN",6,18,61,79
https://kawalpemilu.org#51876,"CARITA, CARITA, PANDEGLANG, BANTEN",1,115,65,180
https://kawalpemilu.org#51876,"CARITA, CARITA, PANDEGLANG, BANTEN",2,147,48,195
https://kawalpemilu.org#51876,"CARITA, CARITA, PANDEGLANG, BANTEN",3,132,55,187
https://kawalpemilu.org#51876,"CARITA, CARITA, PANDEGLANG, BANTEN",4,175,57,232
https://kawalpemilu.org#51876,"CARITA, CARITA, PANDEGLANG, BANTEN",5,107,59,166
https://kawalpemilu.org#51876,"CARITA, CARITA, PANDEGLANG, BANTEN",6,121,46,167
https://kawalpemilu.org#51876,"CARITA, CARITA, PANDEGLANG, BANTEN",7,128,68,196
https://kawalpemilu.org#51876,"CARITA, CARITA, PANDEGLANG, BANTEN",8,130,104,234
https://kawalpemilu.org#51876,"CARITA, CARITA, PANDEGLANG, BANTEN",9,104,104,208
https://kawalpemilu.org#51876,"CARITA, CARITA, PANDEGLANG, BANTEN",10,82,71,153
https://kawalpemilu.org#51876,"CARITA, CARITA, PANDEGLANG, BANTEN",11,68,90,158
https://kawalpemilu.org#51876,"CARITA, CARITA, PANDEGLANG, BANTEN",12,68,72,140
https://kawalpemilu.org#51877,"SUKAJADI, CARITA, PANDEGLANG, BANTEN",1,111,140,251
https://kawalpemilu.org#51877,"SUKAJADI, CARITA, PANDEGLANG, BANTEN",2,92,156,248
https://kawalpemilu.org#51877,"SUKAJADI, CARITA, PANDEGLANG, BANTEN",3,119,126,245
https://kawalpemilu.org#51877,"SUKAJADI, CARITA, PANDEGLANG, BANTEN",4,125,71,196
https://kawalpemilu.org#51877,"SUKAJADI, CARITA, PANDEGLANG, BANTEN",6,144,70,214
https://kawalpemilu.org#51877,"SUKAJADI, CARITA, PANDEGLANG, BANTEN",7,132,80,212
https://kawalpemilu.org#51877,"SUKAJADI, CARITA, PANDEGLANG, BANTEN",8,144,76,220
https://kawalpemilu.org#51877,"SUKAJADI, CARITA, PANDEGLANG, BANTEN",9,133,78,211
https://kawalpemilu.org#51877,"SUKAJADI, CARITA, PANDEGLANG, BANTEN",10,125,126,251
https://kawalpemilu.org#51878,"SINDANGLAUT, CARITA, PANDEGLANG, BANTEN",1,82,109,191
https://kawalpemilu.org#51878,"SINDANGLAUT, CARITA, PANDEGLANG, BANTEN",3,44,100,144
https://kawalpemilu.org#51878,"SINDANGLAUT, CARITA, PANDEGLANG, BANTEN",4,41,166,208
https://kawalpemilu.org#51878,"SINDANGLAUT, CARITA, PANDEGLANG, BANTEN",5,86,139,225
https://kawalpemilu.org#51878,"SINDANGLAUT, CARITA, PANDEGLANG, BANTEN",6,127,92,219
https://kawalpemilu.org#51878,"SINDANGLAUT, CARITA, PANDEGLANG, BANTEN",7,103,108,211
https://kawalpemilu.org#51878,"SINDANGLAUT, CARITA, PANDEGLANG, BANTEN",8,72,138,210
https://kawalpemilu.org#51878,"SINDANGLAUT, CARITA, PANDEGLANG, BANTEN",9,57,106,163
https://kawalpemilu.org#51878,"SINDANGLAUT, CARITA, PANDEGLANG, BANTEN",10,61,135,196
https://kawalpemilu.org#51879,"SUKARAME, CARITA, PANDEGLANG, BANTEN",1,89,113,202
https://kawalpemilu.org#51879,"SUKARAME, CARITA, PANDEGLANG, BANTEN",2,46,141,187
https://kawalpemilu.org#51879,"SUKARAME, CARITA, PANDEGLANG, BANTEN",3,67,95,162
https://kawalpemilu.org#51879,"SUKARAME, CARITA, PANDEGLANG, BANTEN",4,71,107,178
https://kawalpemilu.org#51879,"SUKARAME, CARITA, PANDEGLANG, BANTEN",5,67,166,233
https://kawalpemilu.org#51879,"SUKARAME, CARITA, PANDEGLANG, BANTEN",6,67,108,175
https://kawalpemilu.org#51879,"SUKARAME, CARITA, PANDEGLANG, BANTEN",7,117,101,218
https://kawalpemilu.org#51879,"SUKARAME, CARITA, PANDEGLANG, BANTEN",8,86,123,209
https://kawalpemilu.org#51879,"SUKARAME, CARITA, PANDEGLANG, BANTEN",9,100,99,199
https://kawalpemilu.org#51879,"SUKARAME, CARITA, PANDEGLANG, BANTEN",10,99,111,210
https://kawalpemilu.org#51879,"SUKARAME, CARITA, PANDEGLANG, BANTEN",11,94,102,196
https://kawalpemilu.org#51879,"SUKARAME, CARITA, PANDEGLANG, BANTEN",12,88,155,243
https://kawalpemilu.org#51879,"SUKARAME, CARITA, PANDEGLANG, BANTEN",13,81,135,216
https://kawalpemilu.org#51879,"SUKARAME, CARITA, PANDEGLANG, BANTEN",14,87,156,243
https://kawalpemilu.org#51879,"SUKARAME, CARITA, PANDEGLANG, BANTEN",15,78,100,178
https://kawalpemilu.org#51879,"SUKARAME, CARITA, PANDEGLANG, BANTEN",16,88,115,203
https://kawalpemilu.org#51880,"SUKANAGARA, CARITA, PANDEGLANG, BANTEN",1,86,92,178
https://kawalpemilu.org#51880,"SUKANAGARA, CARITA, PANDEGLANG, BANTEN",2,94,72,166
https://kawalpemilu.org#51880,"SUKANAGARA, CARITA, PANDEGLANG, BANTEN",3,105,109,214
https://kawalpemilu.org#51880,"SUKANAGARA, CARITA, PANDEGLANG, BANTEN",4,86,137,223
https://kawalpemilu.org#51880,"SUKANAGARA, CARITA, PANDEGLANG, BANTEN",5,103,116,219
https://kawalpemilu.org#51880,"SUKANAGARA, CARITA, PANDEGLANG, BANTEN",6,101,106,207
https://kawalpemilu.org#51880,"SUKANAGARA, CARITA, PANDEGLANG, BANTEN",7,86,119,205
https://kawalpemilu.org#51880,"SUKANAGARA, CARITA, PANDEGLANG, BANTEN",8,85,109,194
https://kawalpemilu.org#51880,"SUKANAGARA, CARITA, PANDEGLANG, BANTEN",9,90,104,194
https://kawalpemilu.org#51880,"SUKANAGARA, CARITA, PANDEGLANG, BANTEN",10,104,104,208
https://kawalpemilu.org#51880,"SUKANAGARA, CARITA, PANDEGLANG, BANTEN",11,58,80,136
https://kawalpemilu.org#51880,"SUKANAGARA, CARITA, PANDEGLANG, BANTEN",12,69,73,142
https://kawalpemilu.org#51880,"SUKANAGARA, CARITA, PANDEGLANG, BANTEN",13,97,82,179
https://kawalpemilu.org#51881,"KAWOYANG, CARITA, PANDEGLANG, BANTEN",1,66,107,173
https://kawalpemilu.org#51881,"KAWOYANG, CARITA, PANDEGLANG, BANTEN",2,96,130,226
https://kawalpemilu.org#51881,"KAWOYANG, CARITA, PANDEGLANG, BANTEN",3,93,114,207
https://kawalpemilu.org#51881,"KAWOYANG, CARITA, PANDEGLANG, BANTEN",4,48,117,165
https://kawalpemilu.org#51881,"KAWOYANG, CARITA, PANDEGLANG, BANTEN",5,79,146,225
https://kawalpemilu.org#51881,"KAWOYANG, CARITA, PANDEGLANG, BANTEN",6,41,71,112
https://kawalpemilu.org#51881,"KAWOYANG, CARITA, PANDEGLANG, BANTEN",7,85,103,188
https://kawalpemilu.org#51882,"CINOYONG, CARITA, PANDEGLANG, BANTEN",1,92,83,175
https://kawalpemilu.org#51882,"CINOYONG, CARITA, PANDEGLANG, BANTEN",2,81,119,12
https://kawalpemilu.org#51882,"CINOYONG, CARITA, PANDEGLANG, BANTEN",3,31,157,188
https://kawalpemilu.org#51882,"CINOYONG, CARITA, PANDEGLANG, BANTEN",4,32,138,170
https://kawalpemilu.org#51882,"CINOYONG, CARITA, PANDEGLANG, BANTEN",5,42,136,178
https://kawalpemilu.org#51882,"CINOYONG, CARITA, PANDEGLANG, BANTEN",6,23,164,187
https://kawalpemilu.org#51882,"CINOYONG, CARITA, PANDEGLANG, BANTEN",7,82,131,213
https://kawalpemilu.org#51884,"SEUSEUPAN, SUKARESMI, PANDEGLANG, BANTEN",1,136,41,177
https://kawalpemilu.org#51884,"SEUSEUPAN, SUKARESMI, PANDEGLANG, BANTEN",2,109,71,180
https://kawalpemilu.org#51884,"SEUSEUPAN, SUKARESMI, PANDEGLANG, BANTEN",3,154,41,195
https://kawalpemilu.org#51884,"SEUSEUPAN, SUKARESMI, PANDEGLANG, BANTEN",4,112,53,165
https://kawalpemilu.org#51884,"SEUSEUPAN, SUKARESMI, PANDEGLANG, BANTEN",5,141,45,186
https://kawalpemilu.org#51885,"KARYASARI, SUKARESMI, PANDEGLANG, BANTEN",1,91,120,211
https://kawalpemilu.org#51885,"KARYASARI, SUKARESMI, PANDEGLANG, BANTEN",2,39,162,201
https://kawalpemilu.org#51885,"KARYASARI, SUKARESMI, PANDEGLANG, BANTEN",3,109,59,168
https://kawalpemilu.org#51885,"KARYASARI, SUKARESMI, PANDEGLANG, BANTEN",4,93,74,167
https://kawalpemilu.org#51885,"KARYASARI, SUKARESMI, PANDEGLANG, BANTEN",5,64,104,168
https://kawalpemilu.org#51885,"KARYASARI, SUKARESMI, PANDEGLANG, BANTEN",6,92,78,170
https://kawalpemilu.org#51885,"KARYASARI, SUKARESMI, PANDEGLANG, BANTEN",7,37,174,211
https://kawalpemilu.org#51885,"KARYASARI, SUKARESMI, PANDEGLANG, BANTEN",8,51,92,143
https://kawalpemilu.org#51886,"PERDANA, SUKARESMI, PANDEGLANG, BANTEN",1,89,113,202
https://kawalpemilu.org#51886,"PERDANA, SUKARESMI, PANDEGLANG, BANTEN",2,38,114,152
https://kawalpemilu.org#51886,"PERDANA, SUKARESMI, PANDEGLANG, BANTEN",3,79,103,182
https://kawalpemilu.org#51886,"PERDANA, SUKARESMI, PANDEGLANG, BANTEN",4,74,58,132
https://kawalpemilu.org#51886,"PERDANA, SUKARESMI, PANDEGLANG, BANTEN",5,126,48,174
https://kawalpemilu.org#51886,"PERDANA, SUKARESMI, PANDEGLANG, BANTEN",6,122,63,185
https://kawalpemilu.org#51886,"PERDANA, SUKARESMI, PANDEGLANG, BANTEN",7,68,73,141
https://kawalpemilu.org#51886,"PERDANA, SUKARESMI, PANDEGLANG, BANTEN",8,49,85,134
https://kawalpemilu.org#51887,"SUKARESMI, SUKARESMI, PANDEGLANG, BANTEN",1,126,75,201
https://kawalpemilu.org#51887,"SUKARESMI, SUKARESMI, PANDEGLANG, BANTEN",2,100,126,226
https://kawalpemilu.org#51887,"SUKARESMI, SUKARESMI, PANDEGLANG, BANTEN",3,76,103,179
https://kawalpemilu.org#51887,"SUKARESMI, SUKARESMI, PANDEGLANG, BANTEN",4,93,46,139
https://kawalpemilu.org#51887,"SUKARESMI, SUKARESMI, PANDEGLANG, BANTEN",5,83,35,118
https://kawalpemilu.org#51887,"SUKARESMI, SUKARESMI, PANDEGLANG, BANTEN",6,106,29,135
https://kawalpemilu.org#51887,"SUKARESMI, SUKARESMI, PANDEGLANG, BANTEN",7,86,27,113
https://kawalpemilu.org#51887,"SUKARESMI, SUKARESMI, PANDEGLANG, BANTEN",8,129,76,205
https://kawalpemilu.org#51887,"SUKARESMI, SUKARESMI, PANDEGLANG, BANTEN",9,113,52,165
https://kawalpemilu.org#51887,"SUKARESMI, SUKARESMI, PANDEGLANG, BANTEN",10,114,31,145
https://kawalpemilu.org#51887,"SUKARESMI, SUKARESMI, PANDEGLANG, BANTEN",11,70,75,145
https://kawalpemilu.org#51887,"SUKARESMI, SUKARESMI, PANDEGLANG, BANTEN",12,108,39,147
https://kawalpemilu.org#51888,"PASIRKADU, SUKARESMI, PANDEGLANG, BANTEN",1,61,162,223
https://kawalpemilu.org#51888,"PASIRKADU, SUKARESMI, PANDEGLANG, BANTEN",2,38,168,206
https://kawalpemilu.org#51888,"PASIRKADU, SUKARESMI, PANDEGLANG, BANTEN",3,121,82,203
https://kawalpemilu.org#51888,"PASIRKADU, SUKARESMI, PANDEGLANG, BANTEN",4,79,132,211
https://kawalpemilu.org#51888,"PASIRKADU, SUKARESMI, PANDEGLANG, BANTEN",5,67,122,189
https://kawalpemilu.org#51888,"PASIRKADU, SUKARESMI, PANDEGLANG, BANTEN",7,99,37,136
https://kawalpemilu.org#51888,"PASIRKADU, SUKARESMI, PANDEGLANG, BANTEN",8,137,39,176
https://kawalpemilu.org#51888,"PASIRKADU, SUKARESMI, PANDEGLANG, BANTEN",9,80,148,228
https://kawalpemilu.org#51888,"PASIRKADU, SUKARESMI, PANDEGLANG, BANTEN",10,85,101,186
https://kawalpemilu.org#51888,"PASIRKADU, SUKARESMI, PANDEGLANG, BANTEN",11,67,50,117
https://kawalpemilu.org#51888,"PASIRKADU, SUKARESMI, PANDEGLANG, BANTEN",12,92,92,184
https://kawalpemilu.org#51888,"PASIRKADU, SUKARESMI, PANDEGLANG, BANTEN",13,68,86,154
https://kawalpemilu.org#51889,"KUBANGKAMPIL, SUKARESMI, PANDEGLANG, BANTEN",1,85,112,197
https://kawalpemilu.org#51889,"KUBANGKAMPIL, SUKARESMI, PANDEGLANG, BANTEN",2,84,91,175
https://kawalpemilu.org#51889,"KUBANGKAMPIL, SUKARESMI, PANDEGLANG, BANTEN",3,84,86,170
https://kawalpemilu.org#51889,"KUBANGKAMPIL, SUKARESMI, PANDEGLANG, BANTEN",4,56,137,193
https://kawalpemilu.org#51889,"KUBANGKAMPIL, SUKARESMI, PANDEGLANG, BANTEN",5,73,84,157
https://kawalpemilu.org#51889,"KUBANGKAMPIL, SUKARESMI, PANDEGLANG, BANTEN",6,93,127,220
https://kawalpemilu.org#51889,"KUBANGKAMPIL, SUKARESMI, PANDEGLANG, BANTEN",7,81,105,186
https://kawalpemilu.org#51889,"KUBANGKAMPIL, SUKARESMI, PANDEGLANG, BANTEN",8,78,76,154
https://kawalpemilu.org#51889,"KUBANGKAMPIL, SUKARESMI, PANDEGLANG, BANTEN",9,79,91,170
https://kawalpemilu.org#51889,"KUBANGKAMPIL, SUKARESMI, PANDEGLANG, BANTEN",10,45,121,166
https://kawalpemilu.org#51889,"KUBANGKAMPIL, SUKARESMI, PANDEGLANG, BANTEN",11,58,104,162
https://kawalpemilu.org#51890,"SIDAMUKTI, SUKARESMI, PANDEGLANG, BANTEN",1,142,40,182
https://kawalpemilu.org#51890,"SIDAMUKTI, SUKARESMI, PANDEGLANG, BANTEN",2,86,57,143
https://kawalpemilu.org#51890,"SIDAMUKTI, SUKARESMI, PANDEGLANG, BANTEN",3,125,87,212
https://kawalpemilu.org#51890,"SIDAMUKTI, SUKARESMI, PANDEGLANG, BANTEN",4,101,69,170
https://kawalpemilu.org#51890,"SIDAMUKTI, SUKARESMI, PANDEGLANG, BANTEN",5,147,89,236
https://kawalpemilu.org#51890,"SIDAMUKTI, SUKARESMI, PANDEGLANG, BANTEN",6,116,83,199
https://kawalpemilu.org#51890,"SIDAMUKTI, SUKARESMI, PANDEGLANG, BANTEN",7,159,54,213
https://kawalpemilu.org#51890,"SIDAMUKTI, SUKARESMI, PANDEGLANG, BANTEN",8,133,115,248
https://kawalpemilu.org#51890,"SIDAMUKTI, SUKARESMI, PANDEGLANG, BANTEN",9,95,94,189
https://kawalpemilu.org#51890,"SIDAMUKTI, SUKARESMI, PANDEGLANG, BANTEN",10,117,61,178
https://kawalpemilu.org#51890,"SIDAMUKTI, SUKARESMI, PANDEGLANG, BANTEN",11,111,150,261
https://kawalpemilu.org#51890,"SIDAMUKTI, SUKARESMI, PANDEGLANG, BANTEN",12,148,126,274
https://kawalpemilu.org#51890,"SIDAMUKTI, SUKARESMI, PANDEGLANG, BANTEN",13,93,62,155
https://kawalpemilu.org#51890,"SIDAMUKTI, SUKARESMI, PANDEGLANG, BANTEN",14,47,83,130
https://kawalpemilu.org#51890,"SIDAMUKTI, SUKARESMI, PANDEGLANG, BANTEN",15,56,74,130
https://kawalpemilu.org#51890,"SIDAMUKTI, SUKARESMI, PANDEGLANG, BANTEN",16,98,88,186
https://kawalpemilu.org#51890,"SIDAMUKTI, SUKARESMI, PANDEGLANG, BANTEN",17,136,110,246
https://kawalpemilu.org#51890,"SIDAMUKTI, SUKARESMI, PANDEGLANG, BANTEN",18,145,80,225
https://kawalpemilu.org#51891,"CIBUNGUR, SUKARESMI, PANDEGLANG, BANTEN",1,58,116,174
https://kawalpemilu.org#51891,"CIBUNGUR, SUKARESMI, PANDEGLANG, BANTEN",2,110,99,209
https://kawalpemilu.org#51891,"CIBUNGUR, SUKARESMI, PANDEGLANG, BANTEN",3,51,88,139
https://kawalpemilu.org#51891,"CIBUNGUR, SUKARESMI, PANDEGLANG, BANTEN",4,143,111,254
https://kawalpemilu.org#51891,"CIBUNGUR, SUKARESMI, PANDEGLANG, BANTEN",5,109,78,187
https://kawalpemilu.org#51891,"CIBUNGUR, SUKARESMI, PANDEGLANG, BANTEN",6,102,56,158
https://kawalpemilu.org#51891,"CIBUNGUR, SUKARESMI, PANDEGLANG, BANTEN",7,149,23,172
https://kawalpemilu.org#51891,"CIBUNGUR, SUKARESMI, PANDEGLANG, BANTEN",8,97,110,207
https://kawalpemilu.org#51891,"CIBUNGUR, SUKARESMI, PANDEGLANG, BANTEN",9,76,73,149
https://kawalpemilu.org#51891,"CIBUNGUR, SUKARESMI, PANDEGLANG, BANTEN",10,123,79,4
https://kawalpemilu.org#51891,"CIBUNGUR, SUKARESMI, PANDEGLANG, BANTEN",11,104,99,203
https://kawalpemilu.org#51891,"CIBUNGUR, SUKARESMI, PANDEGLANG, BANTEN",12,111,93,204
https://kawalpemilu.org#51891,"CIBUNGUR, SUKARESMI, PANDEGLANG, BANTEN",13,97,45,142
https://kawalpemilu.org#51891,"CIBUNGUR, SUKARESMI, PANDEGLANG, BANTEN",14,109,174,183
https://kawalpemilu.org#51891,"CIBUNGUR, SUKARESMI, PANDEGLANG, BANTEN",15,75,141,216
https://kawalpemilu.org#51891,"CIBUNGUR, SUKARESMI, PANDEGLANG, BANTEN",16,125,117,242
https://kawalpemilu.org#51891,"CIBUNGUR, SUKARESMI, PANDEGLANG, BANTEN",17,151,66,217
https://kawalpemilu.org#51892,"WERU, SUKARESMI, PANDEGLANG, BANTEN",1,72,119,191
https://kawalpemilu.org#51892,"WERU, SUKARESMI, PANDEGLANG, BANTEN",2,108,110,218
https://kawalpemilu.org#51892,"WERU, SUKARESMI, PANDEGLANG, BANTEN",4,28,151,179
https://kawalpemilu.org#51892,"WERU, SUKARESMI, PANDEGLANG, BANTEN",5,75,63,138
https://kawalpemilu.org#51892,"WERU, SUKARESMI, PANDEGLANG, BANTEN",6,112,121,233
https://kawalpemilu.org#51893,"CIKUYA, SUKARESMI, PANDEGLANG, BANTEN",1,57,108,165
https://kawalpemilu.org#51893,"CIKUYA, SUKARESMI, PANDEGLANG, BANTEN",2,56,141,197
https://kawalpemilu.org#51893,"CIKUYA, SUKARESMI, PANDEGLANG, BANTEN",3,58,106,164
https://kawalpemilu.org#51893,"CIKUYA, SUKARESMI, PANDEGLANG, BANTEN",4,60,98,158
https://kawalpemilu.org#51893,"CIKUYA, SUKARESMI, PANDEGLANG, BANTEN",5,79,121,200
https://kawalpemilu.org#51893,"CIKUYA, SUKARESMI, PANDEGLANG, BANTEN",6,36,127,163
https://kawalpemilu.org#51893,"CIKUYA, SUKARESMI, PANDEGLANG, BANTEN",7,27,110,137
https://kawalpemilu.org#51893,"CIKUYA, SUKARESMI, PANDEGLANG, BANTEN",8,24,81,105
https://kawalpemilu.org#51893,"CIKUYA, SUKARESMI, PANDEGLANG, BANTEN",9,82,129,211
https://kawalpemilu.org#51893,"CIKUYA, SUKARESMI, PANDEGLANG, BANTEN",10,43,190,233
https://kawalpemilu.org#51893,"CIKUYA, SUKARESMI, PANDEGLANG, BANTEN",11,102,38,140
https://kawalpemilu.org#51893,"CIKUYA, SUKARESMI, PANDEGLANG, BANTEN",12,59,87,146
https://kawalpemilu.org#51895,"KADUBELANG, MEKARJAYA, PANDEGLANG, BANTEN",1,42,89,131
https://kawalpemilu.org#51895,"KADUBELANG, MEKARJAYA, PANDEGLANG, BANTEN",2,59,130,189
https://kawalpemilu.org#51895,"KADUBELANG, MEKARJAYA, PANDEGLANG, BANTEN",3,67,70,137
https://kawalpemilu.org#51895,"KADUBELANG, MEKARJAYA, PANDEGLANG, BANTEN",4,71,114,185
https://kawalpemilu.org#51895,"KADUBELANG, MEKARJAYA, PANDEGLANG, BANTEN",5,40,115,155
https://kawalpemilu.org#51895,"KADUBELANG, MEKARJAYA, PANDEGLANG, BANTEN",6,55,95,150
https://kawalpemilu.org#51895,"KADUBELANG, MEKARJAYA, PANDEGLANG, BANTEN",7,70,70,140
https://kawalpemilu.org#51895,"KADUBELANG, MEKARJAYA, PANDEGLANG, BANTEN",8,58,108,166
https://kawalpemilu.org#51895,"KADUBELANG, MEKARJAYA, PANDEGLANG, BANTEN",9,52,114,166
https://kawalpemilu.org#51895,"KADUBELANG, MEKARJAYA, PANDEGLANG, BANTEN",10,46,96,142
https://kawalpemilu.org#51895,"KADUBELANG, MEKARJAYA, PANDEGLANG, BANTEN",11,82,77,159
https://kawalpemilu.org#51895,"KADUBELANG, MEKARJAYA, PANDEGLANG, BANTEN",12,52,85,137
https://kawalpemilu.org#51895,"KADUBELANG, MEKARJAYA, PANDEGLANG, BANTEN",13,79,138,217
https://kawalpemilu.org#51896,"PAREANG, MEKARJAYA, PANDEGLANG, BANTEN",1,40,99,139
https://kawalpemilu.org#51896,"PAREANG, MEKARJAYA, PANDEGLANG, BANTEN",2,76,94,170
https://kawalpemilu.org#51896,"PAREANG, MEKARJAYA, PANDEGLANG, BANTEN",3,50,129,179
https://kawalpemilu.org#51896,"PAREANG, MEKARJAYA, PANDEGLANG, BANTEN",4,52,99,151
https://kawalpemilu.org#51896,"PAREANG, MEKARJAYA, PANDEGLANG, BANTEN",5,79,88,167
https://kawalpemilu.org#51896,"PAREANG, MEKARJAYA, PANDEGLANG, BANTEN",6,50,122,172
https://kawalpemilu.org#51896,"PAREANG, MEKARJAYA, PANDEGLANG, BANTEN",7,64,112,176
https://kawalpemilu.org#51896,"PAREANG, MEKARJAYA, PANDEGLANG, BANTEN",8,64,91,155
https://kawalpemilu.org#51896,"PAREANG, MEKARJAYA, PANDEGLANG, BANTEN",9,48,70,118
https://kawalpemilu.org#51896,"PAREANG, MEKARJAYA, PANDEGLANG, BANTEN",10,69,80,149
https://kawalpemilu.org#51896,"PAREANG, MEKARJAYA, PANDEGLANG, BANTEN",11,39,126,165
https://kawalpemilu.org#51897,"WIRASINGA, MEKARJAYA, PANDEGLANG, BANTEN",1,56,115,171
https://kawalpemilu.org#51897,"WIRASINGA, MEKARJAYA, PANDEGLANG, BANTEN",2,79,87,166
https://kawalpemilu.org#51897,"WIRASINGA, MEKARJAYA, PANDEGLANG, BANTEN",3,22,123,145
https://kawalpemilu.org#51897,"WIRASINGA, MEKARJAYA, PANDEGLANG, BANTEN",4,25,100,125
https://kawalpemilu.org#51897,"WIRASINGA, MEKARJAYA, PANDEGLANG, BANTEN",5,65,79,144
https://kawalpemilu.org#51897,"WIRASINGA, MEKARJAYA, PANDEGLANG, BANTEN",6,52,100,152
https://kawalpemilu.org#51897,"WIRASINGA, MEKARJAYA, PANDEGLANG, BANTEN",7,62,93,161
https://kawalpemilu.org#51897,"WIRASINGA, MEKARJAYA, PANDEGLANG, BANTEN",8,79,59,138
https://kawalpemilu.org#51897,"WIRASINGA, MEKARJAYA, PANDEGLANG, BANTEN",9,54,75,129
https://kawalpemilu.org#51897,"WIRASINGA, MEKARJAYA, PANDEGLANG, BANTEN",10,34,137,171
https://kawalpemilu.org#51897,"WIRASINGA, MEKARJAYA, PANDEGLANG, BANTEN",11,55,86,141
https://kawalpemilu.org#51898,"RANCABUGEL, MEKARJAYA, PANDEGLANG, BANTEN",1,39,136,175
https://kawalpemilu.org#51898,"RANCABUGEL, MEKARJAYA, PANDEGLANG, BANTEN",2,35,82,117
https://kawalpemilu.org#51898,"RANCABUGEL, MEKARJAYA, PANDEGLANG, BANTEN",3,36,112,148
https://kawalpemilu.org#51898,"RANCABUGEL, MEKARJAYA, PANDEGLANG, BANTEN",4,102,77,179
https://kawalpemilu.org#51898,"RANCABUGEL, MEKARJAYA, PANDEGLANG, BANTEN",5,66,64,130
https://kawalpemilu.org#51898,"RANCABUGEL, MEKARJAYA, PANDEGLANG, BANTEN",6,27,141,168
https://kawalpemilu.org#51898,"RANCABUGEL, MEKARJAYA, PANDEGLANG, BANTEN",7,62,93,155
https://kawalpemilu.org#51899,"KADUJANGKUNG, MEKARJAYA, PANDEGLANG, BANTEN",1,51,84,135
https://kawalpemilu.org#51899,"KADUJANGKUNG, MEKARJAYA, PANDEGLANG, BANTEN",2,120,41,161
https://kawalpemilu.org#51899,"KADUJANGKUNG, MEKARJAYA, PANDEGLANG, BANTEN",3,56,51,107
https://kawalpemilu.org#51899,"KADUJANGKUNG, MEKARJAYA, PANDEGLANG, BANTEN",4,73,61,134
https://kawalpemilu.org#51899,"KADUJANGKUNG, MEKARJAYA, PANDEGLANG, BANTEN",6,31,101,132
https://kawalpemilu.org#51899,"KADUJANGKUNG, MEKARJAYA, PANDEGLANG, BANTEN",7,64,69,133
https://kawalpemilu.org#51900,"MEDONG, MEKARJAYA, PANDEGLANG, BANTEN",1,26,103,129
https://kawalpemilu.org#51900,"MEDONG, MEKARJAYA, PANDEGLANG, BANTEN",2,67,121,188
https://kawalpemilu.org#51900,"MEDONG, MEKARJAYA, PANDEGLANG, BANTEN",3,49,120,169
https://kawalpemilu.org#51900,"MEDONG, MEKARJAYA, PANDEGLANG, BANTEN",4,54,146,200
https://kawalpemilu.org#51900,"MEDONG, MEKARJAYA, PANDEGLANG, BANTEN",5,54,109,163
https://kawalpemilu.org#51900,"MEDONG, MEKARJAYA, PANDEGLANG, BANTEN",6,56,103,159
https://kawalpemilu.org#51900,"MEDONG, MEKARJAYA, PANDEGLANG, BANTEN",7,64,106,170
https://kawalpemilu.org#51900,"MEDONG, MEKARJAYA, PANDEGLANG, BANTEN",8,69,100,169
https://kawalpemilu.org#51900,"MEDONG, MEKARJAYA, PANDEGLANG, BANTEN",9,92,57,149
https://kawalpemilu.org#51900,"MEDONG, MEKARJAYA, PANDEGLANG, BANTEN",10,87,71,158
https://kawalpemilu.org#51900,"MEDONG, MEKARJAYA, PANDEGLANG, BANTEN",11,79,118,197
https://kawalpemilu.org#51901,"SUKAMULYA, MEKARJAYA, PANDEGLANG, BANTEN",1,55,121,176
https://kawalpemilu.org#51901,"SUKAMULYA, MEKARJAYA, PANDEGLANG, BANTEN",2,84,58,142
https://kawalpemilu.org#51901,"SUKAMULYA, MEKARJAYA, PANDEGLANG, BANTEN",3,87,89,176
https://kawalpemilu.org#51901,"SUKAMULYA, MEKARJAYA, PANDEGLANG, BANTEN",4,49,104,153
https://kawalpemilu.org#51901,"SUKAMULYA, MEKARJAYA, PANDEGLANG, BANTEN",5,66,128,194
https://kawalpemilu.org#51901,"SUKAMULYA, MEKARJAYA, PANDEGLANG, BANTEN",6,41,134,175
https://kawalpemilu.org#51902,"MEKARJAYA, MEKARJAYA, PANDEGLANG, BANTEN",1,75,76,151
https://kawalpemilu.org#51902,"MEKARJAYA, MEKARJAYA, PANDEGLANG, BANTEN",2,17,137,154
https://kawalpemilu.org#51902,"MEKARJAYA, MEKARJAYA, PANDEGLANG, BANTEN",3,33,134,167
https://kawalpemilu.org#51902,"MEKARJAYA, MEKARJAYA, PANDEGLANG, BANTEN",4,84,115,199
https://kawalpemilu.org#51902,"MEKARJAYA, MEKARJAYA, PANDEGLANG, BANTEN",5,36,109,145
https://kawalpemilu.org#51902,"MEKARJAYA, MEKARJAYA, PANDEGLANG, BANTEN",6,62,93,155
https://kawalpemilu.org#51902,"MEKARJAYA, MEKARJAYA, PANDEGLANG, BANTEN",7,38,118,156
https://kawalpemilu.org#51902,"MEKARJAYA, MEKARJAYA, PANDEGLANG, BANTEN",8,73,69,142
https://kawalpemilu.org#51904,"CIODENG, SINDANGRESMI, PANDEGLANG, BANTEN",1,43,163,206
https://kawalpemilu.org#51904,"CIODENG, SINDANGRESMI, PANDEGLANG, BANTEN",2,66,116,182
https://kawalpemilu.org#51904,"CIODENG, SINDANGRESMI, PANDEGLANG, BANTEN",3,84,124,208
https://kawalpemilu.org#51904,"CIODENG, SINDANGRESMI, PANDEGLANG, BANTEN",4,102,83,185
https://kawalpemilu.org#51904,"CIODENG, SINDANGRESMI, PANDEGLANG, BANTEN",5,74,130,204
https://kawalpemilu.org#51904,"CIODENG, SINDANGRESMI, PANDEGLANG, BANTEN",6,72,131,203
https://kawalpemilu.org#51904,"CIODENG, SINDANGRESMI, PANDEGLANG, BANTEN",7,110,74,184
https://kawalpemilu.org#51904,"CIODENG, SINDANGRESMI, PANDEGLANG, BANTEN",8,42,124,166
https://kawalpemilu.org#51904,"CIODENG, SINDANGRESMI, PANDEGLANG, BANTEN",9,62,57,119
https://kawalpemilu.org#51904,"CIODENG, SINDANGRESMI, PANDEGLANG, BANTEN",10,33,69,102
https://kawalpemilu.org#51904,"CIODENG, SINDANGRESMI, PANDEGLANG, BANTEN",11,55,101,156
https://kawalpemilu.org#51905,"PASIRTENJO, SINDANGRESMI, PANDEGLANG, BANTEN",1,43,174,217
https://kawalpemilu.org#51905,"PASIRTENJO, SINDANGRESMI, PANDEGLANG, BANTEN",2,72,157,229
https://kawalpemilu.org#51905,"PASIRTENJO, SINDANGRESMI, PANDEGLANG, BANTEN",3,98,123,221
https://kawalpemilu.org#51905,"PASIRTENJO, SINDANGRESMI, PANDEGLANG, BANTEN",4,57,169,226
https://kawalpemilu.org#51905,"PASIRTENJO, SINDANGRESMI, PANDEGLANG, BANTEN",5,81,113,194
https://kawalpemilu.org#51905,"PASIRTENJO, SINDANGRESMI, PANDEGLANG, BANTEN",6,44,139,183
https://kawalpemilu.org#51905,"PASIRTENJO, SINDANGRESMI, PANDEGLANG, BANTEN",7,70,84,154
https://kawalpemilu.org#51905,"PASIRTENJO, SINDANGRESMI, PANDEGLANG, BANTEN",8,188,66,184
https://kawalpemilu.org#51905,"PASIRTENJO, SINDANGRESMI, PANDEGLANG, BANTEN",9,101,70,171
https://kawalpemilu.org#51905,"PASIRTENJO, SINDANGRESMI, PANDEGLANG, BANTEN",10,37,85,122
https://kawalpemilu.org#51905,"PASIRTENJO, SINDANGRESMI, PANDEGLANG, BANTEN",11,53,94,147
https://kawalpemilu.org#51906,"BOJONGMANIK, SINDANGRESMI, PANDEGLANG, BANTEN",1,100,107,207
https://kawalpemilu.org#51906,"BOJONGMANIK, SINDANGRESMI, PANDEGLANG, BANTEN",3,60,87,147
https://kawalpemilu.org#51906,"BOJONGMANIK, SINDANGRESMI, PANDEGLANG, BANTEN",4,43,164,207
https://kawalpemilu.org#51906,"BOJONGMANIK, SINDANGRESMI, PANDEGLANG, BANTEN",5,48,115,163
https://kawalpemilu.org#51906,"BOJONGMANIK, SINDANGRESMI, PANDEGLANG, BANTEN",6,78,123,201
https://kawalpemilu.org#51906,"BOJONGMANIK, SINDANGRESMI, PANDEGLANG, BANTEN",7,46,174,220
https://kawalpemilu.org#51906,"BOJONGMANIK, SINDANGRESMI, PANDEGLANG, BANTEN",8,43,144,187
https://kawalpemilu.org#51906,"BOJONGMANIK, SINDANGRESMI, PANDEGLANG, BANTEN",9,41,185,226
https://kawalpemilu.org#51906,"BOJONGMANIK, SINDANGRESMI, PANDEGLANG, BANTEN",10,62,89,151
https://kawalpemilu.org#51906,"BOJONGMANIK, SINDANGRESMI, PANDEGLANG, BANTEN",11,67,82,149
https://kawalpemilu.org#51907,"CEMPAKAWARNA, SINDANGRESMI, PANDEGLANG, BANTEN",1,20,104,124
https://kawalpemilu.org#51907,"CEMPAKAWARNA, SINDANGRESMI, PANDEGLANG, BANTEN",2,45,78,123
https://kawalpemilu.org#51907,"CEMPAKAWARNA, SINDANGRESMI, PANDEGLANG, BANTEN",3,59,79,138
https://kawalpemilu.org#51907,"CEMPAKAWARNA, SINDANGRESMI, PANDEGLANG, BANTEN",4,101,84,185
https://kawalpemilu.org#51907,"CEMPAKAWARNA, SINDANGRESMI, PANDEGLANG, BANTEN",5,78,90,168
https://kawalpemilu.org#51907,"CEMPAKAWARNA, SINDANGRESMI, PANDEGLANG, BANTEN",6,61,93,154
https://kawalpemilu.org#51907,"CEMPAKAWARNA, SINDANGRESMI, PANDEGLANG, BANTEN",7,44,100,144
https://kawalpemilu.org#51908,"PASIRLOA, SINDANGRESMI, PANDEGLANG, BANTEN",1,36,125,161
https://kawalpemilu.org#51908,"PASIRLOA, SINDANGRESMI, PANDEGLANG, BANTEN",2,48,107,155
https://kawalpemilu.org#51908,"PASIRLOA, SINDANGRESMI, PANDEGLANG, BANTEN",3,26,142,168
https://kawalpemilu.org#51908,"PASIRLOA, SINDANGRESMI, PANDEGLANG, BANTEN",4,91,110,201
https://kawalpemilu.org#51908,"PASIRLOA, SINDANGRESMI, PANDEGLANG, BANTEN",5,66,81,147
https://kawalpemilu.org#51908,"PASIRLOA, SINDANGRESMI, PANDEGLANG, BANTEN",6,78,41,119
https://kawalpemilu.org#51908,"PASIRLOA, SINDANGRESMI, PANDEGLANG, BANTEN",7,74,50,124
https://kawalpemilu.org#51909,"PASIRLANCAR, SINDANGRESMI, PANDEGLANG, BANTEN",1,33,111,144
https://kawalpemilu.org#51909,"PASIRLANCAR, SINDANGRESMI, PANDEGLANG, BANTEN",2,55,111,166
https://kawalpemilu.org#51909,"PASIRLANCAR, SINDANGRESMI, PANDEGLANG, BANTEN",3,24,126,150
https://kawalpemilu.org#51909,"PASIRLANCAR, SINDANGRESMI, PANDEGLANG, BANTEN",4,63,65,128
https://kawalpemilu.org#51909,"PASIRLANCAR, SINDANGRESMI, PANDEGLANG, BANTEN",5,62,113,175
https://kawalpemilu.org#51909,"PASIRLANCAR, SINDANGRESMI, PANDEGLANG, BANTEN",6,52,79,131
https://kawalpemilu.org#51909,"PASIRLANCAR, SINDANGRESMI, PANDEGLANG, BANTEN",7,37,185,222
https://kawalpemilu.org#51909,"PASIRLANCAR, SINDANGRESMI, PANDEGLANG, BANTEN",8,46,157,203
https://kawalpemilu.org#51909,"PASIRLANCAR, SINDANGRESMI, PANDEGLANG, BANTEN",9,62,114,176
https://kawalpemilu.org#51910,"SIDANGRESMI, SINDANGRESMI, PANDEGLANG, BANTEN",1,52,142,194
https://kawalpemilu.org#51910,"SIDANGRESMI, SINDANGRESMI, PANDEGLANG, BANTEN",2,57,104,161
https://kawalpemilu.org#51910,"SIDANGRESMI, SINDANGRESMI, PANDEGLANG, BANTEN",3,120,62,182
https://kawalpemilu.org#51910,"SIDANGRESMI, SINDANGRESMI, PANDEGLANG, BANTEN",4,70,71,141
https://kawalpemilu.org#51910,"SIDANGRESMI, SINDANGRESMI, PANDEGLANG, BANTEN",5,80,101,181
https://kawalpemilu.org#51910,"SIDANGRESMI, SINDANGRESMI, PANDEGLANG, BANTEN",6,91,63,154
https://kawalpemilu.org#51910,"SIDANGRESMI, SINDANGRESMI, PANDEGLANG, BANTEN",7,24,68,92
https://kawalpemilu.org#51910,"SIDANGRESMI, SINDANGRESMI, PANDEGLANG, BANTEN",8,40,63,103
https://kawalpemilu.org#51911,"PASIRDURUNG, SINDANGRESMI, PANDEGLANG, BANTEN",1,49,85,134
https://kawalpemilu.org#51911,"PASIRDURUNG, SINDANGRESMI, PANDEGLANG, BANTEN",2,58,69,127
https://kawalpemilu.org#51911,"PASIRDURUNG, SINDANGRESMI, PANDEGLANG, BANTEN",3,97,94,191
https://kawalpemilu.org#51911,"PASIRDURUNG, SINDANGRESMI, PANDEGLANG, BANTEN",4,33,166,199
https://kawalpemilu.org#51911,"PASIRDURUNG, SINDANGRESMI, PANDEGLANG, BANTEN",5,136,66,202
https://kawalpemilu.org#51911,"PASIRDURUNG, SINDANGRESMI, PANDEGLANG, BANTEN",6,155,47,202
https://kawalpemilu.org#51911,"PASIRDURUNG, SINDANGRESMI, PANDEGLANG, BANTEN",7,72,70,142
https://kawalpemilu.org#51912,"KADUMALATI, SINDANGRESMI, PANDEGLANG, BANTEN",1,103,45,148
https://kawalpemilu.org#51912,"KADUMALATI, SINDANGRESMI, PANDEGLANG, BANTEN",2,85,84,169
https://kawalpemilu.org#51912,"KADUMALATI, SINDANGRESMI, PANDEGLANG, BANTEN",3,111,49,160
https://kawalpemilu.org#51912,"KADUMALATI, SINDANGRESMI, PANDEGLANG, BANTEN",4,42,82,124
https://kawalpemilu.org#51912,"KADUMALATI, SINDANGRESMI, PANDEGLANG, BANTEN",5,56,92,148
https://kawalpemilu.org#51912,"KADUMALATI, SINDANGRESMI, PANDEGLANG, BANTEN",6,55,82,137
https://kawalpemilu.org#51912,"KADUMALATI, SINDANGRESMI, PANDEGLANG, BANTEN",7,29,109,138
https://kawalpemilu.org#51912,"KADUMALATI, SINDANGRESMI, PANDEGLANG, BANTEN",8,30,71,101
https://kawalpemilu.org#51912,"KADUMALATI, SINDANGRESMI, PANDEGLANG, BANTEN",9,50,137,187
https://kawalpemilu.org#84970,"SANGHIANGDENGDEK, PULOSARI, PANDEGLANG, BANTEN",1,22,142,164
https://kawalpemilu.org#84970,"SANGHIANGDENGDEK, PULOSARI, PANDEGLANG, BANTEN",2,61,119,180
https://kawalpemilu.org#84970,"SANGHIANGDENGDEK, PULOSARI, PANDEGLANG, BANTEN",3,56,127,183
https://kawalpemilu.org#84970,"SANGHIANGDENGDEK, PULOSARI, PANDEGLANG, BANTEN",4,134,53,187
https://kawalpemilu.org#84970,"SANGHIANGDENGDEK, PULOSARI, PANDEGLANG, BANTEN",5,68,101,169
https://kawalpemilu.org#84970,"SANGHIANGDENGDEK, PULOSARI, PANDEGLANG, BANTEN",6,53,89,142
https://kawalpemilu.org#84970,"SANGHIANGDENGDEK, PULOSARI, PANDEGLANG, BANTEN",7,61,106,167
https://kawalpemilu.org#84970,"SANGHIANGDENGDEK, PULOSARI, PANDEGLANG, BANTEN",8,65,147,212
https://kawalpemilu.org#84971,"CILENTUNG, PULOSARI, PANDEGLANG, BANTEN",1,38,154,192
https://kawalpemilu.org#84971,"CILENTUNG, PULOSARI, PANDEGLANG, BANTEN",2,42,129,171
https://kawalpemilu.org#84971,"CILENTUNG, PULOSARI, PANDEGLANG, BANTEN",3,76,148,224
https://kawalpemilu.org#84971,"CILENTUNG, PULOSARI, PANDEGLANG, BANTEN",4,76,92,168
https://kawalpemilu.org#84971,"CILENTUNG, PULOSARI, PANDEGLANG, BANTEN",5,32,117,149
https://kawalpemilu.org#84971,"CILENTUNG, PULOSARI, PANDEGLANG, BANTEN",6,58,101,159
https://kawalpemilu.org#84971,"CILENTUNG, PULOSARI, PANDEGLANG, BANTEN",7,104,45,149
https://kawalpemilu.org#84971,"CILENTUNG, PULOSARI, PANDEGLANG, BANTEN",8,51,127,178
https://kawalpemilu.org#84971,"CILENTUNG, PULOSARI, PANDEGLANG, BANTEN",9,16,159,175
https://kawalpemilu.org#84971,"CILENTUNG, PULOSARI, PANDEGLANG, BANTEN",10,16,179,195
https://kawalpemilu.org#89659,"KORANJI, PULOSARI, PANDEGLANG, BANTEN",1,48,134,182
https://kawalpemilu.org#89659,"KORANJI, PULOSARI, PANDEGLANG, BANTEN",2,24,130,154
https://kawalpemilu.org#89659,"KORANJI, PULOSARI, PANDEGLANG, BANTEN",3,43,146,189
https://kawalpemilu.org#89659,"KORANJI, PULOSARI, PANDEGLANG, BANTEN",4,49,157,206
https://kawalpemilu.org#89659,"KORANJI, PULOSARI, PANDEGLANG, BANTEN",5,62,155,217
https://kawalpemilu.org#89659,"KORANJI, PULOSARI, PANDEGLANG, BANTEN",6,60,124,184
https://kawalpemilu.org#89659,"KORANJI, PULOSARI, PANDEGLANG, BANTEN",7,70,53,123
https://kawalpemilu.org#89659,"KORANJI, PULOSARI, PANDEGLANG, BANTEN",8,20,170,190
https://kawalpemilu.org#89659,"KORANJI, PULOSARI, PANDEGLANG, BANTEN",9,71,146,217
https://kawalpemilu.org#89659,"KORANJI, PULOSARI, PANDEGLANG, BANTEN",10,48,171,219
https://kawalpemilu.org#89659,"KORANJI, PULOSARI, PANDEGLANG, BANTEN",11,13,148,161
https://kawalpemilu.org#89659,"KORANJI, PULOSARI, PANDEGLANG, BANTEN",12,20,91,111
https://kawalpemilu.org#89659,"KORANJI, PULOSARI, PANDEGLANG, BANTEN",13,40,151,191
https://kawalpemilu.org#89659,"KORANJI, PULOSARI, PANDEGLANG, BANTEN",14,11,161,172
https://kawalpemilu.org#89660,"BANJARWANGI, PULOSARI, PANDEGLANG, BANTEN",1,52,132,184
https://kawalpemilu.org#89660,"BANJARWANGI, PULOSARI, PANDEGLANG, BANTEN",2,48,85,133
https://kawalpemilu.org#89660,"BANJARWANGI, PULOSARI, PANDEGLANG, BANTEN",3,63,73,136
https://kawalpemilu.org#89660,"BANJARWANGI, PULOSARI, PANDEGLANG, BANTEN",4,84,114,198
https://kawalpemilu.org#89660,"BANJARWANGI, PULOSARI, PANDEGLANG, BANTEN",5,35,145,180
https://kawalpemilu.org#89660,"BANJARWANGI, PULOSARI, PANDEGLANG, BANTEN",6,33,142,175
https://kawalpemilu.org#89660,"BANJARWANGI, PULOSARI, PANDEGLANG, BANTEN",7,20,174,194
https://kawalpemilu.org#89660,"BANJARWANGI, PULOSARI, PANDEGLANG, BANTEN",8,35,121,156
https://kawalpemilu.org#89660,"BANJARWANGI, PULOSARI, PANDEGLANG, BANTEN",9,28,137,165
https://kawalpemilu.org#89660,"BANJARWANGI, PULOSARI, PANDEGLANG, BANTEN",10,30,157,187
https://kawalpemilu.org#89660,"BANJARWANGI, PULOSARI, PANDEGLANG, BANTEN",11,17,149,166
https://kawalpemilu.org#89660,"BANJARWANGI, PULOSARI, PANDEGLANG, BANTEN",12,43,132,175
https://kawalpemilu.org#89660,"BANJARWANGI, PULOSARI, PANDEGLANG, BANTEN",13,41,103,144
https://kawalpemilu.org#89661,"SUKASARI, PULOSARI, PANDEGLANG, BANTEN",1,74,146,220
https://kawalpemilu.org#89661,"SUKASARI, PULOSARI, PANDEGLANG, BANTEN",2,49,96,145
https://kawalpemilu.org#89661,"SUKASARI, PULOSARI, PANDEGLANG, BANTEN",3,56,171,227
https://kawalpemilu.org#89661,"SUKASARI, PULOSARI, PANDEGLANG, BANTEN",4,30,206,236
https://kawalpemilu.org#89661,"SUKASARI, PULOSARI, PANDEGLANG, BANTEN",5,46,133,179
https://kawalpemilu.org#89661,"SUKASARI, PULOSARI, PANDEGLANG, BANTEN",6,52,101,153
https://kawalpemilu.org#89661,"SUKASARI, PULOSARI, PANDEGLANG, BANTEN",7,54,118,172
https://kawalpemilu.org#89661,"SUKASARI, PULOSARI, PANDEGLANG, BANTEN",8,71,94,165
https://kawalpemilu.org#89661,"SUKASARI, PULOSARI, PANDEGLANG, BANTEN",9,32,172,204
https://kawalpemilu.org#89661,"SUKASARI, PULOSARI, PANDEGLANG, BANTEN",10,53,149,202
https://kawalpemilu.org#89661,"SUKASARI, PULOSARI, PANDEGLANG, BANTEN",11,25,131,156
https://kawalpemilu.org#89661,"SUKASARI, PULOSARI, PANDEGLANG, BANTEN",13,13,130,143
https://kawalpemilu.org#89661,"SUKASARI, PULOSARI, PANDEGLANG, BANTEN",14,21,177,198
https://kawalpemilu.org#89661,"SUKASARI, PULOSARI, PANDEGLANG, BANTEN",15,15,177,192
https://kawalpemilu.org#89662,"KARYAWANGI, PULOSARI, PANDEGLANG, BANTEN",1,46,134,180
https://kawalpemilu.org#89662,"KARYAWANGI, PULOSARI, PANDEGLANG, BANTEN",2,34,131,165
https://kawalpemilu.org#89662,"KARYAWANGI, PULOSARI, PANDEGLANG, BANTEN",3,32,142,174
https://kawalpemilu.org#89662,"KARYAWANGI, PULOSARI, PANDEGLANG, BANTEN",4,29,114,143
https://kawalpemilu.org#89662,"KARYAWANGI, PULOSARI, PANDEGLANG, BANTEN",5,37,114,151
https://kawalpemilu.org#89662,"KARYAWANGI, PULOSARI, PANDEGLANG, BANTEN",6,27,134,161
https://kawalpemilu.org#89662,"KARYAWANGI, PULOSARI, PANDEGLANG, BANTEN",7,34,127,161
https://kawalpemilu.org#89662,"KARYAWANGI, PULOSARI, PANDEGLANG, BANTEN",8,14,147,161
https://kawalpemilu.org#89662,"KARYAWANGI, PULOSARI, PANDEGLANG, BANTEN",9,25,148,173
https://kawalpemilu.org#89662,"KARYAWANGI, PULOSARI, PANDEGLANG, BANTEN",10,12,195,207
https://kawalpemilu.org#89663,"SUKARAJA, PULOSARI, PANDEGLANG, BANTEN",1,57,110,167
https://kawalpemilu.org#89663,"SUKARAJA, PULOSARI, PANDEGLANG, BANTEN",2,23,164,187
https://kawalpemilu.org#89663,"SUKARAJA, PULOSARI, PANDEGLANG, BANTEN",3,25,138,163
https://kawalpemilu.org#89663,"SUKARAJA, PULOSARI, PANDEGLANG, BANTEN",4,42,98,140
https://kawalpemilu.org#89663,"SUKARAJA, PULOSARI, PANDEGLANG, BANTEN",5,35,155,190
https://kawalpemilu.org#89663,"SUKARAJA, PULOSARI, PANDEGLANG, BANTEN",6,43,131,174
https://kawalpemilu.org#89663,"SUKARAJA, PULOSARI, PANDEGLANG, BANTEN",7,53,107,160
https://kawalpemilu.org#89663,"SUKARAJA, PULOSARI, PANDEGLANG, BANTEN",8,53,99,152
https://kawalpemilu.org#89663,"SUKARAJA, PULOSARI, PANDEGLANG, BANTEN",9,35,113,148
https://kawalpemilu.org#89663,"SUKARAJA, PULOSARI, PANDEGLANG, BANTEN",10,45,120,165
https://kawalpemilu.org#89663,"SUKARAJA, PULOSARI, PANDEGLANG, BANTEN",11,64,142,206
https://kawalpemilu.org#89663,"SUKARAJA, PULOSARI, PANDEGLANG, BANTEN",12,63,148,211
https://kawalpemilu.org#89663,"SUKARAJA, PULOSARI, PANDEGLANG, BANTEN",13,94,86,180
https://kawalpemilu.org#89664,"KADUHEJO, PULOSARI, PANDEGLANG, BANTEN",1,69,113,182
https://kawalpemilu.org#89664,"KADUHEJO, PULOSARI, PANDEGLANG, BANTEN",2,103,68,171
https://kawalpemilu.org#89664,"KADUHEJO, PULOSARI, PANDEGLANG, BANTEN",3,50,78,128
https://kawalpemilu.org#89664,"KADUHEJO, PULOSARI, PANDEGLANG, BANTEN",4,13,93,106
https://kawalpemilu.org#89664,"KADUHEJO, PULOSARI, PANDEGLANG, BANTEN",5,49,122,171
https://kawalpemilu.org#89664,"KADUHEJO, PULOSARI, PANDEGLANG, BANTEN",6,56,144,200
https://kawalpemilu.org#89664,"KADUHEJO, PULOSARI, PANDEGLANG, BANTEN",7,37,111,148
https://kawalpemilu.org#89664,"KADUHEJO, PULOSARI, PANDEGLANG, BANTEN",8,54,116,170
https://kawalpemilu.org#89665,"BANJARNEGARA, PULOSARI, PANDEGLANG, BANTEN",1,81,106,187
https://kawalpemilu.org#89665,"BANJARNEGARA, PULOSARI, PANDEGLANG, BANTEN",2,67,127,194
https://kawalpemilu.org#89665,"BANJARNEGARA, PULOSARI, PANDEGLANG, BANTEN",3,77,111,188
https://kawalpemilu.org#89665,"BANJARNEGARA, PULOSARI, PANDEGLANG, BANTEN",4,41,84,125
https://kawalpemilu.org#89665,"BANJARNEGARA, PULOSARI, PANDEGLANG, BANTEN",5,52,91,143
https://kawalpemilu.org#89665,"BANJARNEGARA, PULOSARI, PANDEGLANG, BANTEN",7,96,53,149
https://kawalpemilu.org#89665,"BANJARNEGARA, PULOSARI, PANDEGLANG, BANTEN",8,102,85,187
https://kawalpemilu.org#89665,"BANJARNEGARA, PULOSARI, PANDEGLANG, BANTEN",9,100,32,132
https://kawalpemilu.org#84972,"AWILEGA, KORONCONG, PANDEGLANG, BANTEN",1,66,102,168
https://kawalpemilu.org#84972,"AWILEGA, KORONCONG, PANDEGLANG, BANTEN",2,68,121,189
https://kawalpemilu.org#84972,"AWILEGA, KORONCONG, PANDEGLANG, BANTEN",3,157,55,212
https://kawalpemilu.org#84972,"AWILEGA, KORONCONG, PANDEGLANG, BANTEN",4,90,90,180
https://kawalpemilu.org#84973,"GERENDONG, KORONCONG, PANDEGLANG, BANTEN",1,29,182,211
https://kawalpemilu.org#84973,"GERENDONG, KORONCONG, PANDEGLANG, BANTEN",2,93,120,213
https://kawalpemilu.org#84973,"GERENDONG, KORONCONG, PANDEGLANG, BANTEN",3,34,104,138
https://kawalpemilu.org#84973,"GERENDONG, KORONCONG, PANDEGLANG, BANTEN",4,39,148,187
https://kawalpemilu.org#84974,"PAKULURAN, KORONCONG, PANDEGLANG, BANTEN",1,56,183,239
https://kawalpemilu.org#84974,"PAKULURAN, KORONCONG, PANDEGLANG, BANTEN",2,116,116,232
https://kawalpemilu.org#84974,"PAKULURAN, KORONCONG, PANDEGLANG, BANTEN",3,91,120,211
https://kawalpemilu.org#84974,"PAKULURAN, KORONCONG, PANDEGLANG, BANTEN",4,41,158,199
https://kawalpemilu.org#84974,"PAKULURAN, KORONCONG, PANDEGLANG, BANTEN",5,47,132,179
https://kawalpemilu.org#84974,"PAKULURAN, KORONCONG, PANDEGLANG, BANTEN",6,57,116,173
https://kawalpemilu.org#84974,"PAKULURAN, KORONCONG, PANDEGLANG, BANTEN",7,85,152,238
https://kawalpemilu.org#84975,"SETRAJAYA, KORONCONG, PANDEGLANG, BANTEN",1,48,122,170
https://kawalpemilu.org#84975,"SETRAJAYA, KORONCONG, PANDEGLANG, BANTEN",2,68,132,200
https://kawalpemilu.org#84975,"SETRAJAYA, KORONCONG, PANDEGLANG, BANTEN",3,49,176,225
https://kawalpemilu.org#84975,"SETRAJAYA, KORONCONG, PANDEGLANG, BANTEN",4,28,142,170
https://kawalpemilu.org#84975,"SETRAJAYA, KORONCONG, PANDEGLANG, BANTEN",5,30,83,113
https://kawalpemilu.org#84975,"SETRAJAYA, KORONCONG, PANDEGLANG, BANTEN",6,62,125,187
https://kawalpemilu.org#84975,"SETRAJAYA, KORONCONG, PANDEGLANG, BANTEN",7,50,73,123
https://kawalpemilu.org#84975,"SETRAJAYA, KORONCONG, PANDEGLANG, BANTEN",8,35,59,94
https://kawalpemilu.org#84976,"KARANGSETRA, KORONCONG, PANDEGLANG, BANTEN",1,69,149,218
https://kawalpemilu.org#84976,"KARANGSETRA, KORONCONG, PANDEGLANG, BANTEN",2,37,198,235
https://kawalpemilu.org#84976,"KARANGSETRA, KORONCONG, PANDEGLANG, BANTEN",3,26,165,191
https://kawalpemilu.org#84976,"KARANGSETRA, KORONCONG, PANDEGLANG, BANTEN",4,22,148,170
https://kawalpemilu.org#84977,"BANGKONOL, KORONCONG, PANDEGLANG, BANTEN",1,56,162,218
https://kawalpemilu.org#84977,"BANGKONOL, KORONCONG, PANDEGLANG, BANTEN",2,46,166,212
https://kawalpemilu.org#84977,"BANGKONOL, KORONCONG, PANDEGLANG, BANTEN",3,43,113,156
https://kawalpemilu.org#84977,"BANGKONOL, KORONCONG, PANDEGLANG, BANTEN",4,39,193,232
https://kawalpemilu.org#84977,"BANGKONOL, KORONCONG, PANDEGLANG, BANTEN",5,45,129,174
https://kawalpemilu.org#84977,"BANGKONOL, KORONCONG, PANDEGLANG, BANTEN",6,27,208,235
https://kawalpemilu.org#84977,"BANGKONOL, KORONCONG, PANDEGLANG, BANTEN",7,33,205,238
https://kawalpemilu.org#84978,"PASIRJAKSA, KORONCONG, PANDEGLANG, BANTEN",1,49,182,231
https://kawalpemilu.org#84978,"PASIRJAKSA, KORONCONG, PANDEGLANG, BANTEN",2,63,142,205
https://kawalpemilu.org#84978,"PASIRJAKSA, KORONCONG, PANDEGLANG, BANTEN",3,46,186,232
https://kawalpemilu.org#84979,"PASIRKARAG, KORONCONG, PANDEGLANG, BANTEN",1,27,189,216
https://kawalpemilu.org#84979,"PASIRKARAG, KORONCONG, PANDEGLANG, BANTEN",2,46,136,182
https://kawalpemilu.org#84979,"PASIRKARAG, KORONCONG, PANDEGLANG, BANTEN",3,46,123,5
https://kawalpemilu.org#84979,"PASIRKARAG, KORONCONG, PANDEGLANG, BANTEN",4,54,121,175
https://kawalpemilu.org#84980,"TEGALONGOK, KORONCONG, PANDEGLANG, BANTEN",1,49,155,204
https://kawalpemilu.org#84980,"TEGALONGOK, KORONCONG, PANDEGLANG, BANTEN",2,44,193,237
https://kawalpemilu.org#84980,"TEGALONGOK, KORONCONG, PANDEGLANG, BANTEN",3,37,175,212
https://kawalpemilu.org#89656,"SUKAJAYA, KORONCONG, PANDEGLANG, BANTEN",1,70,150,220
https://kawalpemilu.org#89656,"SUKAJAYA, KORONCONG, PANDEGLANG, BANTEN",2,57,154,211
https://kawalpemilu.org#89656,"SUKAJAYA, KORONCONG, PANDEGLANG, BANTEN",3,86,163,249
https://kawalpemilu.org#89656,"SUKAJAYA, KORONCONG, PANDEGLANG, BANTEN",4,50,182,232
https://kawalpemilu.org#89656,"SUKAJAYA, KORONCONG, PANDEGLANG, BANTEN",5,43,117,160
https://kawalpemilu.org#89657,"KORONCONG, KORONCONG, PANDEGLANG, BANTEN",1,36,160,196
https://kawalpemilu.org#89657,"KORONCONG, KORONCONG, PANDEGLANG, BANTEN",2,32,189,221
https://kawalpemilu.org#89657,"KORONCONG, KORONCONG, PANDEGLANG, BANTEN",3,44,129,173
https://kawalpemilu.org#89657,"KORONCONG, KORONCONG, PANDEGLANG, BANTEN",4,62,140,202
https://kawalpemilu.org#89657,"KORONCONG, KORONCONG, PANDEGLANG, BANTEN",5,47,131,178
https://kawalpemilu.org#89658,"PANIIS, KORONCONG, PANDEGLANG, BANTEN",1,59,87,146
https://kawalpemilu.org#89658,"PANIIS, KORONCONG, PANDEGLANG, BANTEN",2,84,120,204
https://kawalpemilu.org#89658,"PANIIS, KORONCONG, PANDEGLANG, BANTEN",3,86,134,220
https://kawalpemilu.org#89658,"PANIIS, KORONCONG, PANDEGLANG, BANTEN",4,118,84,202
https://kawalpemilu.org#89658,"PANIIS, KORONCONG, PANDEGLANG, BANTEN",5,91,121,212
https://kawalpemilu.org#89658,"PANIIS, KORONCONG, PANDEGLANG, BANTEN",6,84,153,237
https://kawalpemilu.org#84981,"SUKARATU, MAJASARI, PANDEGLANG, BANTEN",1,34,146,2
https://kawalpemilu.org#84981,"SUKARATU, MAJASARI, PANDEGLANG, BANTEN",2,34,162,196
https://kawalpemilu.org#84981,"SUKARATU, MAJASARI, PANDEGLANG, BANTEN",3,48,171,219
https://kawalpemilu.org#84981,"SUKARATU, MAJASARI, PANDEGLANG, BANTEN",4,49,161,210
https://kawalpemilu.org#84981,"SUKARATU, MAJASARI, PANDEGLANG, BANTEN",5,34,186,220
https://kawalpemilu.org#84981,"SUKARATU, MAJASARI, PANDEGLANG, BANTEN",6,38,141,179
https://kawalpemilu.org#84981,"SUKARATU, MAJASARI, PANDEGLANG, BANTEN",7,45,239,284
https://kawalpemilu.org#84981,"SUKARATU, MAJASARI, PANDEGLANG, BANTEN",8,46,204,250
https://kawalpemilu.org#84981,"SUKARATU, MAJASARI, PANDEGLANG, BANTEN",9,54,163,6
https://kawalpemilu.org#84981,"SUKARATU, MAJASARI, PANDEGLANG, BANTEN",10,33,195,228
https://kawalpemilu.org#84981,"SUKARATU, MAJASARI, PANDEGLANG, BANTEN",11,38,206,244
https://kawalpemilu.org#84981,"SUKARATU, MAJASARI, PANDEGLANG, BANTEN",12,10,83,0
https://kawalpemilu.org#84981,"SUKARATU, MAJASARI, PANDEGLANG, BANTEN",13,19,70,89
https://kawalpemilu.org#84981,"SUKARATU, MAJASARI, PANDEGLANG, BANTEN",14,25,135,160
https://kawalpemilu.org#84981,"SUKARATU, MAJASARI, PANDEGLANG, BANTEN",15,36,134,170
https://kawalpemilu.org#84981,"SUKARATU, MAJASARI, PANDEGLANG, BANTEN",16,50,158,208
https://kawalpemilu.org#84981,"SUKARATU, MAJASARI, PANDEGLANG, BANTEN",17,23,93,116
https://kawalpemilu.org#84981,"SUKARATU, MAJASARI, PANDEGLANG, BANTEN",18,28,93,121
https://kawalpemilu.org#84981,"SUKARATU, MAJASARI, PANDEGLANG, BANTEN",19,32,120,152
https://kawalpemilu.org#84981,"SUKARATU, MAJASARI, PANDEGLANG, BANTEN",20,31,89,120
https://kawalpemilu.org#84981,"SUKARATU, MAJASARI, PANDEGLANG, BANTEN",21,55,107,162
https://kawalpemilu.org#84981,"SUKARATU, MAJASARI, PANDEGLANG, BANTEN",22,40,117,157
https://kawalpemilu.org#84981,"SUKARATU, MAJASARI, PANDEGLANG, BANTEN",23,40,150,190
https://kawalpemilu.org#84981,"SUKARATU, MAJASARI, PANDEGLANG, BANTEN",24,31,163,194
https://kawalpemilu.org#84981,"SUKARATU, MAJASARI, PANDEGLANG, BANTEN",25,33,157,190
https://kawalpemilu.org#84981,"SUKARATU, MAJASARI, PANDEGLANG, BANTEN",26,21,107,128
https://kawalpemilu.org#84981,"SUKARATU, MAJASARI, PANDEGLANG, BANTEN",27,14,81,95
https://kawalpemilu.org#84981,"SUKARATU, MAJASARI, PANDEGLANG, BANTEN",28,37,108,145
https://kawalpemilu.org#84981,"SUKARATU, MAJASARI, PANDEGLANG, BANTEN",29,32,99,131
https://kawalpemilu.org#84981,"SUKARATU, MAJASARI, PANDEGLANG, BANTEN",30,51,182,233
https://kawalpemilu.org#84981,"SUKARATU, MAJASARI, PANDEGLANG, BANTEN",31,58,176,234
https://kawalpemilu.org#84981,"SUKARATU, MAJASARI, PANDEGLANG, BANTEN",32,49,126,175
https://kawalpemilu.org#84981,"SUKARATU, MAJASARI, PANDEGLANG, BANTEN",33,50,128,178
https://kawalpemilu.org#84981,"SUKARATU, MAJASARI, PANDEGLANG, BANTEN",34,22,99,121
https://kawalpemilu.org#84981,"SUKARATU, MAJASARI, PANDEGLANG, BANTEN",35,29,93,122
https://kawalpemilu.org#84981,"SUKARATU, MAJASARI, PANDEGLANG, BANTEN",36,30,91,121
https://kawalpemilu.org#84981,"SUKARATU, MAJASARI, PANDEGLANG, BANTEN",37,28,137,165
https://kawalpemilu.org#84981,"SUKARATU, MAJASARI, PANDEGLANG, BANTEN",38,66,77,143
https://kawalpemilu.org#84981,"SUKARATU, MAJASARI, PANDEGLANG, BANTEN",39,44,52,96
https://kawalpemilu.org#84981,"SUKARATU, MAJASARI, PANDEGLANG, BANTEN",40,45,139,184
https://kawalpemilu.org#84982,"KARATON, MAJASARI, PANDEGLANG, BANTEN",1,45,161,206
https://kawalpemilu.org#84982,"KARATON, MAJASARI, PANDEGLANG, BANTEN",2,63,161,224
https://kawalpemilu.org#84982,"KARATON, MAJASARI, PANDEGLANG, BANTEN",3,29,153,182
https://kawalpemilu.org#84982,"KARATON, MAJASARI, PANDEGLANG, BANTEN",4,62,128,190
https://kawalpemilu.org#84982,"KARATON, MAJASARI, PANDEGLANG, BANTEN",5,50,184,234
https://kawalpemilu.org#84982,"KARATON, MAJASARI, PANDEGLANG, BANTEN",6,40,139,179
https://kawalpemilu.org#84982,"KARATON, MAJASARI, PANDEGLANG, BANTEN",7,28,89,117
https://kawalpemilu.org#84982,"KARATON, MAJASARI, PANDEGLANG, BANTEN",8,43,150,193
https://kawalpemilu.org#84982,"KARATON, MAJASARI, PANDEGLANG, BANTEN",9,31,142,173
https://kawalpemilu.org#84982,"KARATON, MAJASARI, PANDEGLANG, BANTEN",10,47,164,211
https://kawalpemilu.org#84982,"KARATON, MAJASARI, PANDEGLANG, BANTEN",11,27,128,155
https://kawalpemilu.org#84982,"KARATON, MAJASARI, PANDEGLANG, BANTEN",12,41,115,156
https://kawalpemilu.org#84982,"KARATON, MAJASARI, PANDEGLANG, BANTEN",13,29,115,144
https://kawalpemilu.org#84982,"KARATON, MAJASARI, PANDEGLANG, BANTEN",14,28,172,200
https://kawalpemilu.org#84982,"KARATON, MAJASARI, PANDEGLANG, BANTEN",15,42,164,206
https://kawalpemilu.org#84982,"KARATON, MAJASARI, PANDEGLANG, BANTEN",16,25,189,214
https://kawalpemilu.org#84982,"KARATON, MAJASARI, PANDEGLANG, BANTEN",17,70,148,218
https://kawalpemilu.org#84982,"KARATON, MAJASARI, PANDEGLANG, BANTEN",18,57,153,210
https://kawalpemilu.org#84982,"KARATON, MAJASARI, PANDEGLANG, BANTEN",19,31,122,153
https://kawalpemilu.org#84982,"KARATON, MAJASARI, PANDEGLANG, BANTEN",20,23,153,176
https://kawalpemilu.org#84982,"KARATON, MAJASARI, PANDEGLANG, BANTEN",21,19,139,158
https://kawalpemilu.org#84982,"KARATON, MAJASARI, PANDEGLANG, BANTEN",22,41,140,181
https://kawalpemilu.org#84982,"KARATON, MAJASARI, PANDEGLANG, BANTEN",23,32,118,150
https://kawalpemilu.org#84982,"KARATON, MAJASARI, PANDEGLANG, BANTEN",24,19,133,152
https://kawalpemilu.org#84982,"KARATON, MAJASARI, PANDEGLANG, BANTEN",25,14,78,92
https://kawalpemilu.org#84982,"KARATON, MAJASARI, PANDEGLANG, BANTEN",26,56,152,208
https://kawalpemilu.org#84982,"KARATON, MAJASARI, PANDEGLANG, BANTEN",27,50,160,210
https://kawalpemilu.org#84982,"KARATON, MAJASARI, PANDEGLANG, BANTEN",28,30,168,198
https://kawalpemilu.org#84982,"KARATON, MAJASARI, PANDEGLANG, BANTEN",29,38,129,167
https://kawalpemilu.org#84983,"CILAJA, MAJASARI, PANDEGLANG, BANTEN",1,19,203,222
https://kawalpemilu.org#84983,"CILAJA, MAJASARI, PANDEGLANG, BANTEN",2,17,128,145
https://kawalpemilu.org#84983,"CILAJA, MAJASARI, PANDEGLANG, BANTEN",3,20,203,223
https://kawalpemilu.org#84983,"CILAJA, MAJASARI, PANDEGLANG, BANTEN",4,17,243,260
https://kawalpemilu.org#84983,"CILAJA, MAJASARI, PANDEGLANG, BANTEN",5,40,164,204
https://kawalpemilu.org#84983,"CILAJA, MAJASARI, PANDEGLANG, BANTEN",6,22,187,209
https://kawalpemilu.org#84983,"CILAJA, MAJASARI, PANDEGLANG, BANTEN",7,30,188,218
https://kawalpemilu.org#84983,"CILAJA, MAJASARI, PANDEGLANG, BANTEN",8,25,191,216
https://kawalpemilu.org#84983,"CILAJA, MAJASARI, PANDEGLANG, BANTEN",9,39,166,205
https://kawalpemilu.org#84983,"CILAJA, MAJASARI, PANDEGLANG, BANTEN",10,28,195,223
https://kawalpemilu.org#84983,"CILAJA, MAJASARI, PANDEGLANG, BANTEN",11,19,129,148
https://kawalpemilu.org#84983,"CILAJA, MAJASARI, PANDEGLANG, BANTEN",12,12,93,105
https://kawalpemilu.org#84983,"CILAJA, MAJASARI, PANDEGLANG, BANTEN",13,32,174,206
https://kawalpemilu.org#84983,"CILAJA, MAJASARI, PANDEGLANG, BANTEN",14,14,207,221
https://kawalpemilu.org#84983,"CILAJA, MAJASARI, PANDEGLANG, BANTEN",15,30,173,203
https://kawalpemilu.org#84983,"CILAJA, MAJASARI, PANDEGLANG, BANTEN",16,45,111,156
https://kawalpemilu.org#84983,"CILAJA, MAJASARI, PANDEGLANG, BANTEN",17,36,201,237
https://kawalpemilu.org#84983,"CILAJA, MAJASARI, PANDEGLANG, BANTEN",18,53,144,197
https://kawalpemilu.org#84983,"CILAJA, MAJASARI, PANDEGLANG, BANTEN",19,24,144,168
https://kawalpemilu.org#84983,"CILAJA, MAJASARI, PANDEGLANG, BANTEN",20,21,151,172
https://kawalpemilu.org#84983,"CILAJA, MAJASARI, PANDEGLANG, BANTEN",21,47,137,184
https://kawalpemilu.org#84983,"CILAJA, MAJASARI, PANDEGLANG, BANTEN",22,44,176,220
https://kawalpemilu.org#89654,"SARUNI, MAJASARI, PANDEGLANG, BANTEN",1,50,161,211
https://kawalpemilu.org#89654,"SARUNI, MAJASARI, PANDEGLANG, BANTEN",2,47,126,173
https://kawalpemilu.org#89654,"SARUNI, MAJASARI, PANDEGLANG, BANTEN",3,45,149,194
https://kawalpemilu.org#89654,"SARUNI, MAJASARI, PANDEGLANG, BANTEN",4,34,165,199
https://kawalpemilu.org#89654,"SARUNI, MAJASARI, PANDEGLANG, BANTEN",5,41,207,248
https://kawalpemilu.org#89654,"SARUNI, MAJASARI, PANDEGLANG, BANTEN",6,45,178,223
https://kawalpemilu.org#89654,"SARUNI, MAJASARI, PANDEGLANG, BANTEN",7,53,186,239
https://kawalpemilu.org#89654,"SARUNI, MAJASARI, PANDEGLANG, BANTEN",8,21,184,205
https://kawalpemilu.org#89654,"SARUNI, MAJASARI, PANDEGLANG, BANTEN",9,20,162,182
https://kawalpemilu.org#89654,"SARUNI, MAJASARI, PANDEGLANG, BANTEN",10,37,152,189
https://kawalpemilu.org#89654,"SARUNI, MAJASARI, PANDEGLANG, BANTEN",11,20,112,132
https://kawalpemilu.org#89654,"SARUNI, MAJASARI, PANDEGLANG, BANTEN",12,12,111,123
https://kawalpemilu.org#89654,"SARUNI, MAJASARI, PANDEGLANG, BANTEN",13,21,155,176
https://kawalpemilu.org#89654,"SARUNI, MAJASARI, PANDEGLANG, BANTEN",14,43,146,189
https://kawalpemilu.org#89654,"SARUNI, MAJASARI, PANDEGLANG, BANTEN",15,49,172,221
https://kawalpemilu.org#89654,"SARUNI, MAJASARI, PANDEGLANG, BANTEN",16,47,182,229
https://kawalpemilu.org#89654,"SARUNI, MAJASARI, PANDEGLANG, BANTEN",17,59,170,229
https://kawalpemilu.org#89654,"SARUNI, MAJASARI, PANDEGLANG, BANTEN",18,30,113,143
https://kawalpemilu.org#89654,"SARUNI, MAJASARI, PANDEGLANG, BANTEN",19,10,79,89
https://kawalpemilu.org#89654,"SARUNI, MAJASARI, PANDEGLANG, BANTEN",20,40,124,164
https://kawalpemilu.org#89654,"SARUNI, MAJASARI, PANDEGLANG, BANTEN",21,44,150,194
https://kawalpemilu.org#89654,"SARUNI, MAJASARI, PANDEGLANG, BANTEN",22,54,138,192
https://kawalpemilu.org#89654,"SARUNI, MAJASARI, PANDEGLANG, BANTEN",23,60,153,213
https://kawalpemilu.org#89654,"SARUNI, MAJASARI, PANDEGLANG, BANTEN",24,45,137,182
https://kawalpemilu.org#89654,"SARUNI, MAJASARI, PANDEGLANG, BANTEN",25,55,112,167
https://kawalpemilu.org#89654,"SARUNI, MAJASARI, PANDEGLANG, BANTEN",26,81,115,196
https://kawalpemilu.org#89654,"SARUNI, MAJASARI, PANDEGLANG, BANTEN",27,96,80,176
https://kawalpemilu.org#89654,"SARUNI, MAJASARI, PANDEGLANG, BANTEN",28,61,148,209
https://kawalpemilu.org#89654,"SARUNI, MAJASARI, PANDEGLANG, BANTEN",29,39,131,170
https://kawalpemilu.org#89654,"SARUNI, MAJASARI, PANDEGLANG, BANTEN",30,51,145,196
https://kawalpemilu.org#89654,"SARUNI, MAJASARI, PANDEGLANG, BANTEN",31,47,162,209
https://kawalpemilu.org#89654,"SARUNI, MAJASARI, PANDEGLANG, BANTEN",32,28,178,206
https://kawalpemilu.org#89654,"SARUNI, MAJASARI, PANDEGLANG, BANTEN",33,63,178,241
https://kawalpemilu.org#89654,"SARUNI, MAJASARI, PANDEGLANG, BANTEN",34,46,198,244
https://kawalpemilu.org#89654,"SARUNI, MAJASARI, PANDEGLANG, BANTEN",35,45,119,164
https://kawalpemilu.org#89654,"SARUNI, MAJASARI, PANDEGLANG, BANTEN",36,38,142,180
https://kawalpemilu.org#89654,"SARUNI, MAJASARI, PANDEGLANG, BANTEN",37,36,92,128
https://kawalpemilu.org#89654,"SARUNI, MAJASARI, PANDEGLANG, BANTEN",38,19,114,133
https://kawalpemilu.org#89654,"SARUNI, MAJASARI, PANDEGLANG, BANTEN",39,34,169,203
https://kawalpemilu.org#89654,"SARUNI, MAJASARI, PANDEGLANG, BANTEN",40,21,92,113
https://kawalpemilu.org#89654,"SARUNI, MAJASARI, PANDEGLANG, BANTEN",41,39,111,150
https://kawalpemilu.org#89655,"PAGERBATU, MAJASARI, PANDEGLANG, BANTEN",1,20,132,152
https://kawalpemilu.org#89655,"PAGERBATU, MAJASARI, PANDEGLANG, BANTEN",2,42,111,153
https://kawalpemilu.org#89655,"PAGERBATU, MAJASARI, PANDEGLANG, BANTEN",3,26,133,159
https://kawalpemilu.org#89655,"PAGERBATU, MAJASARI, PANDEGLANG, BANTEN",4,26,161,187
https://kawalpemilu.org#89655,"PAGERBATU, MAJASARI, PANDEGLANG, BANTEN",5,43,169,212
https://kawalpemilu.org#89655,"PAGERBATU, MAJASARI, PANDEGLANG, BANTEN",6,43,169,212
https://kawalpemilu.org#89655,"PAGERBATU, MAJASARI, PANDEGLANG, BANTEN",7,40,162,202
https://kawalpemilu.org#89655,"PAGERBATU, MAJASARI, PANDEGLANG, BANTEN",9,55,101,156
https://kawalpemilu.org#89655,"PAGERBATU, MAJASARI, PANDEGLANG, BANTEN",10,42,143,185
https://kawalpemilu.org#89655,"PAGERBATU, MAJASARI, PANDEGLANG, BANTEN",11,51,84,135
https://kawalpemilu.org#89655,"PAGERBATU, MAJASARI, PANDEGLANG, BANTEN",12,29,125,154
https://kawalpemilu.org#89655,"PAGERBATU, MAJASARI, PANDEGLANG, BANTEN",13,36,146,176
https://kawalpemilu.org#89655,"PAGERBATU, MAJASARI, PANDEGLANG, BANTEN",14,136,115,251
https://kawalpemilu.org#89655,"PAGERBATU, MAJASARI, PANDEGLANG, BANTEN",15,33,98,131
https://kawalpemilu.org#89655,"PAGERBATU, MAJASARI, PANDEGLANG, BANTEN",16,69,108,177
https://kawalpemilu.org#89655,"PAGERBATU, MAJASARI, PANDEGLANG, BANTEN",17,62,126,188
https://kawalpemilu.org#89655,"PAGERBATU, MAJASARI, PANDEGLANG, BANTEN",18,29,135,164
https://kawalpemilu.org#89655,"PAGERBATU, MAJASARI, PANDEGLANG, BANTEN",19,31,204,235
https://kawalpemilu.org#89655,"PAGERBATU, MAJASARI, PANDEGLANG, BANTEN",20,60,146,206
https://kawalpemilu.org#89655,"PAGERBATU, MAJASARI, PANDEGLANG, BANTEN",21,27,152,179
https://kawalpemilu.org#89655,"PAGERBATU, MAJASARI, PANDEGLANG, BANTEN",22,79,44,123
https://kawalpemilu.org#89655,"PAGERBATU, MAJASARI, PANDEGLANG, BANTEN",23,89,117,206
https://kawalpemilu.org#89655,"PAGERBATU, MAJASARI, PANDEGLANG, BANTEN",24,26,139,165
https://kawalpemilu.org#89655,"PAGERBATU, MAJASARI, PANDEGLANG, BANTEN",25,14,227,241
https://kawalpemilu.org#89655,"PAGERBATU, MAJASARI, PANDEGLANG, BANTEN",26,23,94,117
https://kawalpemilu.org#89655,"PAGERBATU, MAJASARI, PANDEGLANG, BANTEN",28,45,200,245
https://kawalpemilu.org#84984,"KUTAMEKAR, SOBANG, PANDEGLANG, BANTEN",1,169,46,215
https://kawalpemilu.org#84984,"KUTAMEKAR, SOBANG, PANDEGLANG, BANTEN",2,114,90,204
https://kawalpemilu.org#84984,"KUTAMEKAR, SOBANG, PANDEGLANG, BANTEN",3,59,108,167
https://kawalpemilu.org#84984,"KUTAMEKAR, SOBANG, PANDEGLANG, BANTEN",4,115,109,224
https://kawalpemilu.org#84984,"KUTAMEKAR, SOBANG, PANDEGLANG, BANTEN",5,76,103,179
https://kawalpemilu.org#84984,"KUTAMEKAR, SOBANG, PANDEGLANG, BANTEN",6,143,53,196
https://kawalpemilu.org#84984,"KUTAMEKAR, SOBANG, PANDEGLANG, BANTEN",7,89,29,118
https://kawalpemilu.org#84984,"KUTAMEKAR, SOBANG, PANDEGLANG, BANTEN",8,202,24,226
https://kawalpemilu.org#84984,"KUTAMEKAR, SOBANG, PANDEGLANG, BANTEN",9,120,30,150
https://kawalpemilu.org#84984,"KUTAMEKAR, SOBANG, PANDEGLANG, BANTEN",10,96,50,146
https://kawalpemilu.org#84984,"KUTAMEKAR, SOBANG, PANDEGLANG, BANTEN",11,96,60,156
https://kawalpemilu.org#84984,"KUTAMEKAR, SOBANG, PANDEGLANG, BANTEN",12,185,31,216
https://kawalpemilu.org#84984,"KUTAMEKAR, SOBANG, PANDEGLANG, BANTEN",13,140,61,201
https://kawalpemilu.org#84984,"KUTAMEKAR, SOBANG, PANDEGLANG, BANTEN",14,117,40,157
https://kawalpemilu.org#84985,"TELUKLADA, SOBANG, PANDEGLANG, BANTEN",1,49,60,109
https://kawalpemilu.org#84985,"TELUKLADA, SOBANG, PANDEGLANG, BANTEN",2,43,147,190
https://kawalpemilu.org#84985,"TELUKLADA, SOBANG, PANDEGLANG, BANTEN",3,57,100,157
https://kawalpemilu.org#84985,"TELUKLADA, SOBANG, PANDEGLANG, BANTEN",4,46,122,168
https://kawalpemilu.org#84985,"TELUKLADA, SOBANG, PANDEGLANG, BANTEN",5,93,83,176
https://kawalpemilu.org#84985,"TELUKLADA, SOBANG, PANDEGLANG, BANTEN",6,75,56,131
https://kawalpemilu.org#84985,"TELUKLADA, SOBANG, PANDEGLANG, BANTEN",7,119,44,163
https://kawalpemilu.org#84985,"TELUKLADA, SOBANG, PANDEGLANG, BANTEN",8,93,60,153
https://kawalpemilu.org#84985,"TELUKLADA, SOBANG, PANDEGLANG, BANTEN",9,154,82,236
https://kawalpemilu.org#84985,"TELUKLADA, SOBANG, PANDEGLANG, BANTEN",10,110,83,193
https://kawalpemilu.org#84985,"TELUKLADA, SOBANG, PANDEGLANG, BANTEN",11,184,51,235
https://kawalpemilu.org#84985,"TELUKLADA, SOBANG, PANDEGLANG, BANTEN",12,137,44,181
https://kawalpemilu.org#84985,"TELUKLADA, SOBANG, PANDEGLANG, BANTEN",13,203,18,221
https://kawalpemilu.org#84985,"TELUKLADA, SOBANG, PANDEGLANG, BANTEN",14,157,38,195
https://kawalpemilu.org#84986,"BOJEN, SOBANG, PANDEGLANG, BANTEN",1,127,62,189
https://kawalpemilu.org#84986,"BOJEN, SOBANG, PANDEGLANG, BANTEN",2,166,34,200
https://kawalpemilu.org#84986,"BOJEN, SOBANG, PANDEGLANG, BANTEN",3,162,62,224
https://kawalpemilu.org#84986,"BOJEN, SOBANG, PANDEGLANG, BANTEN",4,97,66,163
https://kawalpemilu.org#84986,"BOJEN, SOBANG, PANDEGLANG, BANTEN",5,108,43,151
https://kawalpemilu.org#84986,"BOJEN, SOBANG, PANDEGLANG, BANTEN",6,102,54,156
https://kawalpemilu.org#84986,"BOJEN, SOBANG, PANDEGLANG, BANTEN",7,145,45,190
https://kawalpemilu.org#84986,"BOJEN, SOBANG, PANDEGLANG, BANTEN",8,156,35,191
https://kawalpemilu.org#84986,"BOJEN, SOBANG, PANDEGLANG, BANTEN",9,139,78,217
https://kawalpemilu.org#84986,"BOJEN, SOBANG, PANDEGLANG, BANTEN",10,106,58,164
https://kawalpemilu.org#84986,"BOJEN, SOBANG, PANDEGLANG, BANTEN",11,110,40,150
https://kawalpemilu.org#84986,"BOJEN, SOBANG, PANDEGLANG, BANTEN",12,115,28,143
https://kawalpemilu.org#84986,"BOJEN, SOBANG, PANDEGLANG, BANTEN",13,79,100,179
https://kawalpemilu.org#84986,"BOJEN, SOBANG, PANDEGLANG, BANTEN",14,53,33,86
https://kawalpemilu.org#84987,"BOJENWETAN, SOBANG, PANDEGLANG, BANTEN",1,103,77,180
https://kawalpemilu.org#84987,"BOJENWETAN, SOBANG, PANDEGLANG, BANTEN",2,132,65,197
https://kawalpemilu.org#84987,"BOJENWETAN, SOBANG, PANDEGLANG, BANTEN",3,124,28,152
https://kawalpemilu.org#84987,"BOJENWETAN, SOBANG, PANDEGLANG, BANTEN",4,155,41,194
https://kawalpemilu.org#84987,"BOJENWETAN, SOBANG, PANDEGLANG, BANTEN",5,125,57,182
https://kawalpemilu.org#84987,"BOJENWETAN, SOBANG, PANDEGLANG, BANTEN",6,155,45,200
https://kawalpemilu.org#84987,"BOJENWETAN, SOBANG, PANDEGLANG, BANTEN",7,160,28,188
https://kawalpemilu.org#84987,"BOJENWETAN, SOBANG, PANDEGLANG, BANTEN",8,156,51,207
https://kawalpemilu.org#84987,"BOJENWETAN, SOBANG, PANDEGLANG, BANTEN",9,146,35,181
https://kawalpemilu.org#84987,"BOJENWETAN, SOBANG, PANDEGLANG, BANTEN",10,132,23,155
https://kawalpemilu.org#89650,"CIMANIS, SOBANG, PANDEGLANG, BANTEN",1,131,108,239
https://kawalpemilu.org#89650,"CIMANIS, SOBANG, PANDEGLANG, BANTEN",2,149,60,209
https://kawalpemilu.org#89650,"CIMANIS, SOBANG, PANDEGLANG, BANTEN",3,135,13,148
https://kawalpemilu.org#89650,"CIMANIS, SOBANG, PANDEGLANG, BANTEN",4,151,38,189
https://kawalpemilu.org#89650,"CIMANIS, SOBANG, PANDEGLANG, BANTEN",5,139,22,161
https://kawalpemilu.org#89650,"CIMANIS, SOBANG, PANDEGLANG, BANTEN",6,73,10,83
https://kawalpemilu.org#89650,"CIMANIS, SOBANG, PANDEGLANG, BANTEN",7,87,32,119
https://kawalpemilu.org#89650,"CIMANIS, SOBANG, PANDEGLANG, BANTEN",8,113,20,133
https://kawalpemilu.org#89650,"CIMANIS, SOBANG, PANDEGLANG, BANTEN",9,111,44,155
https://kawalpemilu.org#89650,"CIMANIS, SOBANG, PANDEGLANG, BANTEN",10,113,35,148
https://kawalpemilu.org#89650,"CIMANIS, SOBANG, PANDEGLANG, BANTEN",11,150,25,175
https://kawalpemilu.org#89650,"CIMANIS, SOBANG, PANDEGLANG, BANTEN",12,137,72,209
https://kawalpemilu.org#89650,"CIMANIS, SOBANG, PANDEGLANG, BANTEN",13,116,30,146
https://kawalpemilu.org#89650,"CIMANIS, SOBANG, PANDEGLANG, BANTEN",14,156,43,199
https://kawalpemilu.org#89650,"CIMANIS, SOBANG, PANDEGLANG, BANTEN",15,143,49,192
https://kawalpemilu.org#89650,"CIMANIS, SOBANG, PANDEGLANG, BANTEN",16,74,103,177
https://kawalpemilu.org#89650,"CIMANIS, SOBANG, PANDEGLANG, BANTEN",17,86,70,156
https://kawalpemilu.org#89650,"CIMANIS, SOBANG, PANDEGLANG, BANTEN",18,77,18,95
https://kawalpemilu.org#89650,"CIMANIS, SOBANG, PANDEGLANG, BANTEN",19,172,27,199
https://kawalpemilu.org#89650,"CIMANIS, SOBANG, PANDEGLANG, BANTEN",20,118,66,184
https://kawalpemilu.org#89651,"KERTARAHARJA, SOBANG, PANDEGLANG, BANTEN",1,101,127,228
https://kawalpemilu.org#89651,"KERTARAHARJA, SOBANG, PANDEGLANG, BANTEN",2,76,117,193
https://kawalpemilu.org#89651,"KERTARAHARJA, SOBANG, PANDEGLANG, BANTEN",3,72,124,196
https://kawalpemilu.org#89651,"KERTARAHARJA, SOBANG, PANDEGLANG, BANTEN",4,71,130,201
https://kawalpemilu.org#89651,"KERTARAHARJA, SOBANG, PANDEGLANG, BANTEN",5,123,102,225
https://kawalpemilu.org#89651,"KERTARAHARJA, SOBANG, PANDEGLANG, BANTEN",6,169,45,214
https://kawalpemilu.org#89651,"KERTARAHARJA, SOBANG, PANDEGLANG, BANTEN",7,104,110,214
https://kawalpemilu.org#89651,"KERTARAHARJA, SOBANG, PANDEGLANG, BANTEN",8,134,25,159
https://kawalpemilu.org#89651,"KERTARAHARJA, SOBANG, PANDEGLANG, BANTEN",9,79,18,97
https://kawalpemilu.org#89651,"KERTARAHARJA, SOBANG, PANDEGLANG, BANTEN",10,50,65,115
https://kawalpemilu.org#89652,"SOBANG, SOBANG, PANDEGLANG, BANTEN",1,88,62,150
https://kawalpemilu.org#89652,"SOBANG, SOBANG, PANDEGLANG, BANTEN",2,183,38,221
https://kawalpemilu.org#89652,"SOBANG, SOBANG, PANDEGLANG, BANTEN",3,121,65,186
https://kawalpemilu.org#89652,"SOBANG, SOBANG, PANDEGLANG, BANTEN",4,135,75,210
https://kawalpemilu.org#89652,"SOBANG, SOBANG, PANDEGLANG, BANTEN",5,147,62,3
https://kawalpemilu.org#89652,"SOBANG, SOBANG, PANDEGLANG, BANTEN",6,101,101,202
https://kawalpemilu.org#89652,"SOBANG, SOBANG, PANDEGLANG, BANTEN",7,170,66,236
https://kawalpemilu.org#89652,"SOBANG, SOBANG, PANDEGLANG, BANTEN",8,170,49,219
https://kawalpemilu.org#89652,"SOBANG, SOBANG, PANDEGLANG, BANTEN",9,175,30,205
https://kawalpemilu.org#89652,"SOBANG, SOBANG, PANDEGLANG, BANTEN",10,179,17,196
https://kawalpemilu.org#89652,"SOBANG, SOBANG, PANDEGLANG, BANTEN",11,162,41,203
https://kawalpemilu.org#89652,"SOBANG, SOBANG, PANDEGLANG, BANTEN",12,147,58,205
https://kawalpemilu.org#89652,"SOBANG, SOBANG, PANDEGLANG, BANTEN",13,128,41,169
https://kawalpemilu.org#89652,"SOBANG, SOBANG, PANDEGLANG, BANTEN",14,141,20,161
https://kawalpemilu.org#89653,"PANGKALAN, SOBANG, PANDEGLANG, BANTEN",1,154,42,196
https://kawalpemilu.org#89653,"PANGKALAN, SOBANG, PANDEGLANG, BANTEN",2,113,54,167
https://kawalpemilu.org#89653,"PANGKALAN, SOBANG, PANDEGLANG, BANTEN",3,136,76,212
https://kawalpemilu.org#89653,"PANGKALAN, SOBANG, PANDEGLANG, BANTEN",4,142,58,200
https://kawalpemilu.org#89653,"PANGKALAN, SOBANG, PANDEGLANG, BANTEN",5,147,62,209
https://kawalpemilu.org#89653,"PANGKALAN, SOBANG, PANDEGLANG, BANTEN",6,130,33,163
https://kawalpemilu.org#89653,"PANGKALAN, SOBANG, PANDEGLANG, BANTEN",7,126,80,206
https://kawalpemilu.org#89653,"PANGKALAN, SOBANG, PANDEGLANG, BANTEN",8,112,46,158
https://kawalpemilu.org#89653,"PANGKALAN, SOBANG, PANDEGLANG, BANTEN",9,117,73,190
https://kawalpemilu.org#89653,"PANGKALAN, SOBANG, PANDEGLANG, BANTEN",10,123,52,175
https://kawalpemilu.org#89653,"PANGKALAN, SOBANG, PANDEGLANG, BANTEN",12,110,88,198
https://kawalpemilu.org#89653,"PANGKALAN, SOBANG, PANDEGLANG, BANTEN",13,151,63,214
https://kawalpemilu.org#89653,"PANGKALAN, SOBANG, PANDEGLANG, BANTEN",14,115,98,213
https://kawalpemilu.org#89653,"PANGKALAN, SOBANG, PANDEGLANG, BANTEN",15,198,70,268
https://kawalpemilu.org#89653,"PANGKALAN, SOBANG, PANDEGLANG, BANTEN",16,66,98,164
https://kawalpemilu.org#89653,"PANGKALAN, SOBANG, PANDEGLANG, BANTEN",17,107,29,136
https://kawalpemilu.org#89653,"PANGKALAN, SOBANG, PANDEGLANG, BANTEN",18,97,52,149
https://kawalpemilu.org#89653,"PANGKALAN, SOBANG, PANDEGLANG, BANTEN",19,107,45,152
https://kawalpemilu.org#89653,"PANGKALAN, SOBANG, PANDEGLANG, BANTEN",20,110,57,167
https://kawalpemilu.org#51915,"CILANGKAHAN, MALINGPING, LEBAK, BANTEN",1,70,131,201
https://kawalpemilu.org#51915,"CILANGKAHAN, MALINGPING, LEBAK, BANTEN",2,63,132,195
https://kawalpemilu.org#51915,"CILANGKAHAN, MALINGPING, LEBAK, BANTEN",3,33,120,153
https://kawalpemilu.org#51915,"CILANGKAHAN, MALINGPING, LEBAK, BANTEN",4,84,91,175
https://kawalpemilu.org#51915,"CILANGKAHAN, MALINGPING, LEBAK, BANTEN",5,59,53,112
https://kawalpemilu.org#51915,"CILANGKAHAN, MALINGPING, LEBAK, BANTEN",6,36,113,149
https://kawalpemilu.org#51915,"CILANGKAHAN, MALINGPING, LEBAK, BANTEN",7,59,96,155
https://kawalpemilu.org#51915,"CILANGKAHAN, MALINGPING, LEBAK, BANTEN",8,32,116,148
https://kawalpemilu.org#51915,"CILANGKAHAN, MALINGPING, LEBAK, BANTEN",9,88,130,218
https://kawalpemilu.org#51915,"CILANGKAHAN, MALINGPING, LEBAK, BANTEN",10,66,79,145
https://kawalpemilu.org#51915,"CILANGKAHAN, MALINGPING, LEBAK, BANTEN",11,76,55,131
https://kawalpemilu.org#51915,"CILANGKAHAN, MALINGPING, LEBAK, BANTEN",12,79,91,170
https://kawalpemilu.org#51915,"CILANGKAHAN, MALINGPING, LEBAK, BANTEN",13,48,44,92
https://kawalpemilu.org#51915,"CILANGKAHAN, MALINGPING, LEBAK, BANTEN",14,74,65,139
https://kawalpemilu.org#51916,"PAGELARAN, MALINGPING, LEBAK, BANTEN",1,51,109,160
https://kawalpemilu.org#51916,"PAGELARAN, MALINGPING, LEBAK, BANTEN",2,31,141,172
https://kawalpemilu.org#51916,"PAGELARAN, MALINGPING, LEBAK, BANTEN",3,47,158,205
https://kawalpemilu.org#51916,"PAGELARAN, MALINGPING, LEBAK, BANTEN",4,49,124,173
https://kawalpemilu.org#51916,"PAGELARAN, MALINGPING, LEBAK, BANTEN",5,61,61,122
https://kawalpemilu.org#51916,"PAGELARAN, MALINGPING, LEBAK, BANTEN",6,86,62,148
https://kawalpemilu.org#51916,"PAGELARAN, MALINGPING, LEBAK, BANTEN",7,49,94,143
https://kawalpemilu.org#51916,"PAGELARAN, MALINGPING, LEBAK, BANTEN",8,59,125,184
https://kawalpemilu.org#51916,"PAGELARAN, MALINGPING, LEBAK, BANTEN",9,80,44,124
https://kawalpemilu.org#51916,"PAGELARAN, MALINGPING, LEBAK, BANTEN",10,28,96,124
https://kawalpemilu.org#51916,"PAGELARAN, MALINGPING, LEBAK, BANTEN",11,38,124,162
https://kawalpemilu.org#51916,"PAGELARAN, MALINGPING, LEBAK, BANTEN",12,103,108,211
https://kawalpemilu.org#51916,"PAGELARAN, MALINGPING, LEBAK, BANTEN",13,42,164,206
https://kawalpemilu.org#51916,"PAGELARAN, MALINGPING, LEBAK, BANTEN",14,67,77,144
https://kawalpemilu.org#51916,"PAGELARAN, MALINGPING, LEBAK, BANTEN",15,66,55,121
https://kawalpemilu.org#51916,"PAGELARAN, MALINGPING, LEBAK, BANTEN",16,69,64,133
https://kawalpemilu.org#51916,"PAGELARAN, MALINGPING, LEBAK, BANTEN",17,51,90,141
https://kawalpemilu.org#51916,"PAGELARAN, MALINGPING, LEBAK, BANTEN",18,50,101,151
https://kawalpemilu.org#51916,"PAGELARAN, MALINGPING, LEBAK, BANTEN",19,51,95,146
https://kawalpemilu.org#51916,"PAGELARAN, MALINGPING, LEBAK, BANTEN",20,61,98,159
https://kawalpemilu.org#51916,"PAGELARAN, MALINGPING, LEBAK, BANTEN",21,70,39,109
https://kawalpemilu.org#51917,"SUKARAJA, MALINGPING, LEBAK, BANTEN",1,81,119,200
https://kawalpemilu.org#51917,"SUKARAJA, MALINGPING, LEBAK, BANTEN",2,75,165,239
https://kawalpemilu.org#51917,"SUKARAJA, MALINGPING, LEBAK, BANTEN",3,90,127,217
https://kawalpemilu.org#51917,"SUKARAJA, MALINGPING, LEBAK, BANTEN",4,100,104,204
https://kawalpemilu.org#51917,"SUKARAJA, MALINGPING, LEBAK, BANTEN",5,67,131,198
https://kawalpemilu.org#51917,"SUKARAJA, MALINGPING, LEBAK, BANTEN",6,36,115,151
https://kawalpemilu.org#51917,"SUKARAJA, MALINGPING, LEBAK, BANTEN",7,145,72,217
https://kawalpemilu.org#51917,"SUKARAJA, MALINGPING, LEBAK, BANTEN",8,44,141,185
https://kawalpemilu.org#51917,"SUKARAJA, MALINGPING, LEBAK, BANTEN",9,91,82,173
https://kawalpemilu.org#51917,"SUKARAJA, MALINGPING, LEBAK, BANTEN",10,25,100,125
https://kawalpemilu.org#51917,"SUKARAJA, MALINGPING, LEBAK, BANTEN",11,58,113,171
https://kawalpemilu.org#51917,"SUKARAJA, MALINGPING, LEBAK, BANTEN",12,55,108,163
https://kawalpemilu.org#51917,"SUKARAJA, MALINGPING, LEBAK, BANTEN",13,109,132,241
https://kawalpemilu.org#51917,"SUKARAJA, MALINGPING, LEBAK, BANTEN",14,84,73,157
https://kawalpemilu.org#51917,"SUKARAJA, MALINGPING, LEBAK, BANTEN",15,97,137,234
https://kawalpemilu.org#51917,"SUKARAJA, MALINGPING, LEBAK, BANTEN",16,52,118,170
https://kawalpemilu.org#51917,"SUKARAJA, MALINGPING, LEBAK, BANTEN",17,56,180,236
https://kawalpemilu.org#51917,"SUKARAJA, MALINGPING, LEBAK, BANTEN",18,48,161,209
https://kawalpemilu.org#51917,"SUKARAJA, MALINGPING, LEBAK, BANTEN",19,77,87,164
https://kawalpemilu.org#51917,"SUKARAJA, MALINGPING, LEBAK, BANTEN",20,54,166,220
https://kawalpemilu.org#51917,"SUKARAJA, MALINGPING, LEBAK, BANTEN",21,72,104,176
https://kawalpemilu.org#51917,"SUKARAJA, MALINGPING, LEBAK, BANTEN",22,47,156,203
https://kawalpemilu.org#51917,"SUKARAJA, MALINGPING, LEBAK, BANTEN",23,62,96,158
https://kawalpemilu.org#51918,"MALINGPING UTARA, MALINGPING, LEBAK, BANTEN",1,131,113,244
https://kawalpemilu.org#51918,"MALINGPING UTARA, MALINGPING, LEBAK, BANTEN",2,98,98,196
https://kawalpemilu.org#51918,"MALINGPING UTARA, MALINGPING, LEBAK, BANTEN",3,72,105,177
https://kawalpemilu.org#51918,"MALINGPING UTARA, MALINGPING, LEBAK, BANTEN",4,107,116,223
https://kawalpemilu.org#51918,"MALINGPING UTARA, MALINGPING, LEBAK, BANTEN",5,61,121,182
https://kawalpemilu.org#51918,"MALINGPING UTARA, MALINGPING, LEBAK, BANTEN",6,105,118,223
https://kawalpemilu.org#51918,"MALINGPING UTARA, MALINGPING, LEBAK, BANTEN",7,98,53,151
https://kawalpemilu.org#51918,"MALINGPING UTARA, MALINGPING, LEBAK, BANTEN",8,90,76,166
https://kawalpemilu.org#51918,"MALINGPING UTARA, MALINGPING, LEBAK, BANTEN",9,112,21,133
https://kawalpemilu.org#51918,"MALINGPING UTARA, MALINGPING, LEBAK, BANTEN",10,138,94,232
https://kawalpemilu.org#51918,"MALINGPING UTARA, MALINGPING, LEBAK, BANTEN",11,98,107,205
https://kawalpemilu.org#51918,"MALINGPING UTARA, MALINGPING, LEBAK, BANTEN",12,70,86,156
https://kawalpemilu.org#51918,"MALINGPING UTARA, MALINGPING, LEBAK, BANTEN",13,81,92,173
https://kawalpemilu.org#51918,"MALINGPING UTARA, MALINGPING, LEBAK, BANTEN",14,63,117,180
https://kawalpemilu.org#51918,"MALINGPING UTARA, MALINGPING, LEBAK, BANTEN",15,60,107,167
https://kawalpemilu.org#51918,"MALINGPING UTARA, MALINGPING, LEBAK, BANTEN",16,90,99,189
https://kawalpemilu.org#51918,"MALINGPING UTARA, MALINGPING, LEBAK, BANTEN",17,126,41,167
https://kawalpemilu.org#51918,"MALINGPING UTARA, MALINGPING, LEBAK, BANTEN",18,76,66,142
https://kawalpemilu.org#51918,"MALINGPING UTARA, MALINGPING, LEBAK, BANTEN",19,121,47,168
https://kawalpemilu.org#51919,"BOLANG, MALINGPING, LEBAK, BANTEN",1,102,91,193
https://kawalpemilu.org#51919,"BOLANG, MALINGPING, LEBAK, BANTEN",2,114,71,185
https://kawalpemilu.org#51919,"BOLANG, MALINGPING, LEBAK, BANTEN",3,100,111,211
https://kawalpemilu.org#51919,"BOLANG, MALINGPING, LEBAK, BANTEN",4,65,56,121
https://kawalpemilu.org#51919,"BOLANG, MALINGPING, LEBAK, BANTEN",5,83,123,206
https://kawalpemilu.org#51919,"BOLANG, MALINGPING, LEBAK, BANTEN",6,75,82,157
https://kawalpemilu.org#51919,"BOLANG, MALINGPING, LEBAK, BANTEN",7,92,92,184
https://kawalpemilu.org#51919,"BOLANG, MALINGPING, LEBAK, BANTEN",8,74,54,128
https://kawalpemilu.org#51919,"BOLANG, MALINGPING, LEBAK, BANTEN",9,89,87,176
https://kawalpemilu.org#51919,"BOLANG, MALINGPING, LEBAK, BANTEN",10,132,67,199
https://kawalpemilu.org#51919,"BOLANG, MALINGPING, LEBAK, BANTEN",11,91,92,183
https://kawalpemilu.org#51919,"BOLANG, MALINGPING, LEBAK, BANTEN",12,111,111,222
https://kawalpemilu.org#51919,"BOLANG, MALINGPING, LEBAK, BANTEN",13,86,75,161
https://kawalpemilu.org#51919,"BOLANG, MALINGPING, LEBAK, BANTEN",14,67,66,133
https://kawalpemilu.org#51919,"BOLANG, MALINGPING, LEBAK, BANTEN",15,90,79,169
https://kawalpemilu.org#51919,"BOLANG, MALINGPING, LEBAK, BANTEN",16,81,95,176
https://kawalpemilu.org#51920,"CIPEUNDEUY, MALINGPING, LEBAK, BANTEN",1,87,81,168
https://kawalpemilu.org#51920,"CIPEUNDEUY, MALINGPING, LEBAK, BANTEN",2,90,89,179
https://kawalpemilu.org#51920,"CIPEUNDEUY, MALINGPING, LEBAK, BANTEN",3,55,131,186
https://kawalpemilu.org#51920,"CIPEUNDEUY, MALINGPING, LEBAK, BANTEN",4,128,78,206
https://kawalpemilu.org#51920,"CIPEUNDEUY, MALINGPING, LEBAK, BANTEN",5,78,121,199
https://kawalpemilu.org#51920,"CIPEUNDEUY, MALINGPING, LEBAK, BANTEN",6,116,91,207
https://kawalpemilu.org#51920,"CIPEUNDEUY, MALINGPING, LEBAK, BANTEN",7,61,51,112
https://kawalpemilu.org#51920,"CIPEUNDEUY, MALINGPING, LEBAK, BANTEN",8,94,74,168
https://kawalpemilu.org#51920,"CIPEUNDEUY, MALINGPING, LEBAK, BANTEN",9,59,132,191
https://kawalpemilu.org#51920,"CIPEUNDEUY, MALINGPING, LEBAK, BANTEN",10,63,120,183
https://kawalpemilu.org#51920,"CIPEUNDEUY, MALINGPING, LEBAK, BANTEN",11,39,49,88
https://kawalpemilu.org#51921,"RAHONG, MALINGPING, LEBAK, BANTEN",1,73,137,210
https://kawalpemilu.org#51921,"RAHONG, MALINGPING, LEBAK, BANTEN",2,94,83,177
https://kawalpemilu.org#51921,"RAHONG, MALINGPING, LEBAK, BANTEN",3,89,101,190
https://kawalpemilu.org#51921,"RAHONG, MALINGPING, LEBAK, BANTEN",4,98,101,199
https://kawalpemilu.org#51921,"RAHONG, MALINGPING, LEBAK, BANTEN",5,92,91,183
https://kawalpemilu.org#51921,"RAHONG, MALINGPING, LEBAK, BANTEN",6,85,72,157
https://kawalpemilu.org#51921,"RAHONG, MALINGPING, LEBAK, BANTEN",7,68,126,194
https://kawalpemilu.org#51921,"RAHONG, MALINGPING, LEBAK, BANTEN",8,83,99,182
https://kawalpemilu.org#51921,"RAHONG, MALINGPING, LEBAK, BANTEN",9,100,67,167
https://kawalpemilu.org#51921,"RAHONG, MALINGPING, LEBAK, BANTEN",10,89,118,207
https://kawalpemilu.org#51921,"RAHONG, MALINGPING, LEBAK, BANTEN",11,103,81,184
https://kawalpemilu.org#51921,"RAHONG, MALINGPING, LEBAK, BANTEN",12,63,118,181
https://kawalpemilu.org#51921,"RAHONG, MALINGPING, LEBAK, BANTEN",13,121,73,194
https://kawalpemilu.org#51922,"KADUJAJAR, MALINGPING, LEBAK, BANTEN",1,84,167,251
https://kawalpemilu.org#51922,"KADUJAJAR, MALINGPING, LEBAK, BANTEN",2,92,125,217
https://kawalpemilu.org#51922,"KADUJAJAR, MALINGPING, LEBAK, BANTEN",3,110,108,218
https://kawalpemilu.org#51922,"KADUJAJAR, MALINGPING, LEBAK, BANTEN",4,160,79,239
https://kawalpemilu.org#51922,"KADUJAJAR, MALINGPING, LEBAK, BANTEN",5,64,107,171
https://kawalpemilu.org#51922,"KADUJAJAR, MALINGPING, LEBAK, BANTEN",6,43,155,198
https://kawalpemilu.org#51922,"KADUJAJAR, MALINGPING, LEBAK, BANTEN",7,63,135,198
https://kawalpemilu.org#51922,"KADUJAJAR, MALINGPING, LEBAK, BANTEN",8,66,72,138
https://kawalpemilu.org#51922,"KADUJAJAR, MALINGPING, LEBAK, BANTEN",9,111,111,222
https://kawalpemilu.org#51922,"KADUJAJAR, MALINGPING, LEBAK, BANTEN",10,122,62,184
https://kawalpemilu.org#51922,"KADUJAJAR, MALINGPING, LEBAK, BANTEN",11,58,160,218
https://kawalpemilu.org#51922,"KADUJAJAR, MALINGPING, LEBAK, BANTEN",12,83,138,221
https://kawalpemilu.org#51922,"KADUJAJAR, MALINGPING, LEBAK, BANTEN",13,84,128,212
https://kawalpemilu.org#51922,"KADUJAJAR, MALINGPING, LEBAK, BANTEN",14,88,166,254
https://kawalpemilu.org#51922,"KADUJAJAR, MALINGPING, LEBAK, BANTEN",15,118,131,249
https://kawalpemilu.org#51922,"KADUJAJAR, MALINGPING, LEBAK, BANTEN",16,56,179,235
https://kawalpemilu.org#51922,"KADUJAJAR, MALINGPING, LEBAK, BANTEN",17,69,146,215
https://kawalpemilu.org#51923,"KERSARATU, MALINGPING, LEBAK, BANTEN",1,88,130,218
https://kawalpemilu.org#51923,"KERSARATU, MALINGPING, LEBAK, BANTEN",2,44,174,218
https://kawalpemilu.org#51923,"KERSARATU, MALINGPING, LEBAK, BANTEN",3,15,126,141
https://kawalpemilu.org#51923,"KERSARATU, MALINGPING, LEBAK, BANTEN",4,146,69,215
https://kawalpemilu.org#51923,"KERSARATU, MALINGPING, LEBAK, BANTEN",5,144,52,196
https://kawalpemilu.org#51923,"KERSARATU, MALINGPING, LEBAK, BANTEN",6,29,137,166
https://kawalpemilu.org#51923,"KERSARATU, MALINGPING, LEBAK, BANTEN",7,38,150,188
https://kawalpemilu.org#51924,"MALINGPING SELATAN, MALINGPING, LEBAK, BANTEN",1,52,86,138
https://kawalpemilu.org#51924,"MALINGPING SELATAN, MALINGPING, LEBAK, BANTEN",2,33,120,153
https://kawalpemilu.org#51924,"MALINGPING SELATAN, MALINGPING, LEBAK, BANTEN",3,43,84,127
https://kawalpemilu.org#51924,"MALINGPING SELATAN, MALINGPING, LEBAK, BANTEN",4,31,116,147
https://kawalpemilu.org#51924,"MALINGPING SELATAN, MALINGPING, LEBAK, BANTEN",5,88,111,199
https://kawalpemilu.org#51924,"MALINGPING SELATAN, MALINGPING, LEBAK, BANTEN",6,117,136,253
https://kawalpemilu.org#51924,"MALINGPING SELATAN, MALINGPING, LEBAK, BANTEN",7,83,152,235
https://kawalpemilu.org#51924,"MALINGPING SELATAN, MALINGPING, LEBAK, BANTEN",8,37,53,90
https://kawalpemilu.org#51924,"MALINGPING SELATAN, MALINGPING, LEBAK, BANTEN",9,54,155,209
https://kawalpemilu.org#51924,"MALINGPING SELATAN, MALINGPING, LEBAK, BANTEN",10,53,122,175
https://kawalpemilu.org#51924,"MALINGPING SELATAN, MALINGPING, LEBAK, BANTEN",11,79,112,191
https://kawalpemilu.org#51924,"MALINGPING SELATAN, MALINGPING, LEBAK, BANTEN",12,77,139,216
https://kawalpemilu.org#51924,"MALINGPING SELATAN, MALINGPING, LEBAK, BANTEN",13,64,88,152
https://kawalpemilu.org#51924,"MALINGPING SELATAN, MALINGPING, LEBAK, BANTEN",14,45,97,142
https://kawalpemilu.org#51925,"SUMBERWARAS, MALINGPING, LEBAK, BANTEN",1,48,96,144
https://kawalpemilu.org#51925,"SUMBERWARAS, MALINGPING, LEBAK, BANTEN",2,54,112,166
https://kawalpemilu.org#51925,"SUMBERWARAS, MALINGPING, LEBAK, BANTEN",3,57,96,153
https://kawalpemilu.org#51925,"SUMBERWARAS, MALINGPING, LEBAK, BANTEN",4,87,106,193
https://kawalpemilu.org#51925,"SUMBERWARAS, MALINGPING, LEBAK, BANTEN",5,55,73,128
https://kawalpemilu.org#51925,"SUMBERWARAS, MALINGPING, LEBAK, BANTEN",6,94,118,212
https://kawalpemilu.org#51925,"SUMBERWARAS, MALINGPING, LEBAK, BANTEN",7,74,133,207
https://kawalpemilu.org#51925,"SUMBERWARAS, MALINGPING, LEBAK, BANTEN",8,94,69,163
https://kawalpemilu.org#51925,"SUMBERWARAS, MALINGPING, LEBAK, BANTEN",9,67,75,142
https://kawalpemilu.org#51925,"SUMBERWARAS, MALINGPING, LEBAK, BANTEN",10,112,56,168
https://kawalpemilu.org#51925,"SUMBERWARAS, MALINGPING, LEBAK, BANTEN",11,116,83,199
https://kawalpemilu.org#51925,"SUMBERWARAS, MALINGPING, LEBAK, BANTEN",12,61,65,126
https://kawalpemilu.org#51925,"SUMBERWARAS, MALINGPING, LEBAK, BANTEN",13,96,98,194
https://kawalpemilu.org#51925,"SUMBERWARAS, MALINGPING, LEBAK, BANTEN",14,95,73,168
https://kawalpemilu.org#51925,"SUMBERWARAS, MALINGPING, LEBAK, BANTEN",15,43,48,91
https://kawalpemilu.org#51925,"SUMBERWARAS, MALINGPING, LEBAK, BANTEN",16,62,117,179
https://kawalpemilu.org#51925,"SUMBERWARAS, MALINGPING, LEBAK, BANTEN",17,31,68,99
https://kawalpemilu.org#51925,"SUMBERWARAS, MALINGPING, LEBAK, BANTEN",18,62,95,157
https://kawalpemilu.org#51925,"SUMBERWARAS, MALINGPING, LEBAK, BANTEN",19,62,51,113
https://kawalpemilu.org#51925,"SUMBERWARAS, MALINGPING, LEBAK, BANTEN",20,130,47,177
https://kawalpemilu.org#51926,"SUKAMANAH, MALINGPING, LEBAK, BANTEN",1,62,148,210
https://kawalpemilu.org#51926,"SUKAMANAH, MALINGPING, LEBAK, BANTEN",2,67,155,222
https://kawalpemilu.org#51926,"SUKAMANAH, MALINGPING, LEBAK, BANTEN",3,43,77,120
https://kawalpemilu.org#51926,"SUKAMANAH, MALINGPING, LEBAK, BANTEN",4,38,193,231
https://kawalpemilu.org#51926,"SUKAMANAH, MALINGPING, LEBAK, BANTEN",5,47,157,204
https://kawalpemilu.org#51926,"SUKAMANAH, MALINGPING, LEBAK, BANTEN",6,76,118,194
https://kawalpemilu.org#51926,"SUKAMANAH, MALINGPING, LEBAK, BANTEN",7,66,112,178
https://kawalpemilu.org#51926,"SUKAMANAH, MALINGPING, LEBAK, BANTEN",8,57,126,183
https://kawalpemilu.org#51926,"SUKAMANAH, MALINGPING, LEBAK, BANTEN",9,116,62,178
https://kawalpemilu.org#51926,"SUKAMANAH, MALINGPING, LEBAK, BANTEN",10,144,89,233
https://kawalpemilu.org#51926,"SUKAMANAH, MALINGPING, LEBAK, BANTEN",11,138,56,194
https://kawalpemilu.org#51926,"SUKAMANAH, MALINGPING, LEBAK, BANTEN",12,167,58,225
https://kawalpemilu.org#51926,"SUKAMANAH, MALINGPING, LEBAK, BANTEN",13,79,132,211
https://kawalpemilu.org#51926,"SUKAMANAH, MALINGPING, LEBAK, BANTEN",14,49,56,105
https://kawalpemilu.org#51926,"SUKAMANAH, MALINGPING, LEBAK, BANTEN",15,42,79,121
https://kawalpemilu.org#51926,"SUKAMANAH, MALINGPING, LEBAK, BANTEN",16,28,60,88
https://kawalpemilu.org#51926,"SUKAMANAH, MALINGPING, LEBAK, BANTEN",17,74,41,115
https://kawalpemilu.org#51927,"SENANGHATI, MALINGPING, LEBAK, BANTEN",1,99,33,132
https://kawalpemilu.org#51927,"SENANGHATI, MALINGPING, LEBAK, BANTEN",2,137,28,165
https://kawalpemilu.org#51927,"SENANGHATI, MALINGPING, LEBAK, BANTEN",3,100,53,153
https://kawalpemilu.org#51927,"SENANGHATI, MALINGPING, LEBAK, BANTEN",4,150,70,220
https://kawalpemilu.org#51927,"SENANGHATI, MALINGPING, LEBAK, BANTEN",5,95,48,143
https://kawalpemilu.org#51927,"SENANGHATI, MALINGPING, LEBAK, BANTEN",6,54,27,81
https://kawalpemilu.org#51927,"SENANGHATI, MALINGPING, LEBAK, BANTEN",7,95,48,143
https://kawalpemilu.org#51927,"SENANGHATI, MALINGPING, LEBAK, BANTEN",8,87,33,120
https://kawalpemilu.org#51928,"SANGIANG, MALINGPING, LEBAK, BANTEN",1,98,101,199
https://kawalpemilu.org#51928,"SANGIANG, MALINGPING, LEBAK, BANTEN",2,149,52,201
https://kawalpemilu.org#51928,"SANGIANG, MALINGPING, LEBAK, BANTEN",3,122,67,189
https://kawalpemilu.org#51928,"SANGIANG, MALINGPING, LEBAK, BANTEN",4,80,109,189
https://kawalpemilu.org#51928,"SANGIANG, MALINGPING, LEBAK, BANTEN",5,114,67,181
https://kawalpemilu.org#51928,"SANGIANG, MALINGPING, LEBAK, BANTEN",7,146,83,229
https://kawalpemilu.org#51928,"SANGIANG, MALINGPING, LEBAK, BANTEN",8,37,138,175
https://kawalpemilu.org#51928,"SANGIANG, MALINGPING, LEBAK, BANTEN",9,64,50,114
https://kawalpemilu.org#51930,"PANGGARANGAN, PANGGARANGAN, LEBAK, BANTEN",1,64,121,185
https://kawalpemilu.org#51930,"PANGGARANGAN, PANGGARANGAN, LEBAK, BANTEN",2,33,170,203
https://kawalpemilu.org#51930,"PANGGARANGAN, PANGGARANGAN, LEBAK, BANTEN",3,29,164,193
https://kawalpemilu.org#51930,"PANGGARANGAN, PANGGARANGAN, LEBAK, BANTEN",4,32,102,134
https://kawalpemilu.org#51930,"PANGGARANGAN, PANGGARANGAN, LEBAK, BANTEN",5,87,105,192
https://kawalpemilu.org#51930,"PANGGARANGAN, PANGGARANGAN, LEBAK, BANTEN",6,76,117,193
https://kawalpemilu.org#51930,"PANGGARANGAN, PANGGARANGAN, LEBAK, BANTEN",7,87,92,179
https://kawalpemilu.org#51930,"PANGGARANGAN, PANGGARANGAN, LEBAK, BANTEN",8,85,72,157
https://kawalpemilu.org#51930,"PANGGARANGAN, PANGGARANGAN, LEBAK, BANTEN",9,55,136,191
https://kawalpemilu.org#51930,"PANGGARANGAN, PANGGARANGAN, LEBAK, BANTEN",10,73,131,204
https://kawalpemilu.org#51930,"PANGGARANGAN, PANGGARANGAN, LEBAK, BANTEN",11,44,143,187
https://kawalpemilu.org#51930,"PANGGARANGAN, PANGGARANGAN, LEBAK, BANTEN",12,117,104,221
https://kawalpemilu.org#51931,"JATAKE, PANGGARANGAN, LEBAK, BANTEN",1,70,125,195
https://kawalpemilu.org#51931,"JATAKE, PANGGARANGAN, LEBAK, BANTEN",2,102,80,182
https://kawalpemilu.org#51931,"JATAKE, PANGGARANGAN, LEBAK, BANTEN",3,80,91,171
https://kawalpemilu.org#51931,"JATAKE, PANGGARANGAN, LEBAK, BANTEN",4,111,55,166
https://kawalpemilu.org#51931,"JATAKE, PANGGARANGAN, LEBAK, BANTEN",5,102,124,226
https://kawalpemilu.org#51931,"JATAKE, PANGGARANGAN, LEBAK, BANTEN",6,63,127,190
https://kawalpemilu.org#51931,"JATAKE, PANGGARANGAN, LEBAK, BANTEN",7,84,146,230
https://kawalpemilu.org#51931,"JATAKE, PANGGARANGAN, LEBAK, BANTEN",8,147,6,153
https://kawalpemilu.org#51931,"JATAKE, PANGGARANGAN, LEBAK, BANTEN",9,57,115,172
https://kawalpemilu.org#51931,"JATAKE, PANGGARANGAN, LEBAK, BANTEN",10,68,109,177
https://kawalpemilu.org#51932,"SOGONG, PANGGARANGAN, LEBAK, BANTEN",1,79,78,157
https://kawalpemilu.org#51932,"SOGONG, PANGGARANGAN, LEBAK, BANTEN",2,79,91,170
https://kawalpemilu.org#51932,"SOGONG, PANGGARANGAN, LEBAK, BANTEN",3,66,111,177
https://kawalpemilu.org#51932,"SOGONG, PANGGARANGAN, LEBAK, BANTEN",4,72,118,190
https://kawalpemilu.org#51932,"SOGONG, PANGGARANGAN, LEBAK, BANTEN",5,148,60,208
https://kawalpemilu.org#51932,"SOGONG, PANGGARANGAN, LEBAK, BANTEN",6,117,50,167
https://kawalpemilu.org#51932,"SOGONG, PANGGARANGAN, LEBAK, BANTEN",7,135,47,182
https://kawalpemilu.org#51932,"SOGONG, PANGGARANGAN, LEBAK, BANTEN",8,135,20,155
https://kawalpemilu.org#51932,"SOGONG, PANGGARANGAN, LEBAK, BANTEN",9,59,103,162
https://kawalpemilu.org#51933,"CIMANDIRI, PANGGARANGAN, LEBAK, BANTEN",1,62,141,203
https://kawalpemilu.org#51933,"CIMANDIRI, PANGGARANGAN, LEBAK, BANTEN",2,57,163,220
https://kawalpemilu.org#51933,"CIMANDIRI, PANGGARANGAN, LEBAK, BANTEN",3,121,104,225
https://kawalpemilu.org#51933,"CIMANDIRI, PANGGARANGAN, LEBAK, BANTEN",4,129,82,211
https://kawalpemilu.org#51933,"CIMANDIRI, PANGGARANGAN, LEBAK, BANTEN",5,174,40,214
https://kawalpemilu.org#51933,"CIMANDIRI, PANGGARANGAN, LEBAK, BANTEN",6,147,40,187
https://kawalpemilu.org#51933,"CIMANDIRI, PANGGARANGAN, LEBAK, BANTEN",7,102,105,207
https://kawalpemilu.org#51933,"CIMANDIRI, PANGGARANGAN, LEBAK, BANTEN",8,99,117,216
https://kawalpemilu.org#51933,"CIMANDIRI, PANGGARANGAN, LEBAK, BANTEN",9,57,181,238
https://kawalpemilu.org#51933,"CIMANDIRI, PANGGARANGAN, LEBAK, BANTEN",10,71,128,199
https://kawalpemilu.org#51933,"CIMANDIRI, PANGGARANGAN, LEBAK, BANTEN",11,183,48,231
https://kawalpemilu.org#51933,"CIMANDIRI, PANGGARANGAN, LEBAK, BANTEN",12,86,18,104
https://kawalpemilu.org#51934,"GUNUNGGEDE, PANGGARANGAN, LEBAK, BANTEN",1,164,52,216
https://kawalpemilu.org#51934,"GUNUNGGEDE, PANGGARANGAN, LEBAK, BANTEN",2,71,107,178
https://kawalpemilu.org#51934,"GUNUNGGEDE, PANGGARANGAN, LEBAK, BANTEN",3,78,88,166
https://kawalpemilu.org#51934,"GUNUNGGEDE, PANGGARANGAN, LEBAK, BANTEN",4,197,31,228
https://kawalpemilu.org#51934,"GUNUNGGEDE, PANGGARANGAN, LEBAK, BANTEN",5,112,9,121
https://kawalpemilu.org#51934,"GUNUNGGEDE, PANGGARANGAN, LEBAK, BANTEN",6,129,12,141
https://kawalpemilu.org#51934,"GUNUNGGEDE, PANGGARANGAN, LEBAK, BANTEN",7,178,52,230
https://kawalpemilu.org#51934,"GUNUNGGEDE, PANGGARANGAN, LEBAK, BANTEN",8,153,15,168
https://kawalpemilu.org#51934,"GUNUNGGEDE, PANGGARANGAN, LEBAK, BANTEN",9,118,11,129
https://kawalpemilu.org#51934,"GUNUNGGEDE, PANGGARANGAN, LEBAK, BANTEN",10,164,32,196
https://kawalpemilu.org#51935,"SITUREGEN, PANGGARANGAN, LEBAK, BANTEN",1,57,149,206
https://kawalpemilu.org#51935,"SITUREGEN, PANGGARANGAN, LEBAK, BANTEN",2,66,131,197
https://kawalpemilu.org#51935,"SITUREGEN, PANGGARANGAN, LEBAK, BANTEN",3,64,114,178
https://kawalpemilu.org#51935,"SITUREGEN, PANGGARANGAN, LEBAK, BANTEN",4,49,122,171
https://kawalpemilu.org#51935,"SITUREGEN, PANGGARANGAN, LEBAK, BANTEN",5,56,175,231
https://kawalpemilu.org#51935,"SITUREGEN, PANGGARANGAN, LEBAK, BANTEN",6,43,172,215
https://kawalpemilu.org#51935,"SITUREGEN, PANGGARANGAN, LEBAK, BANTEN",7,25,147,172
https://kawalpemilu.org#51935,"SITUREGEN, PANGGARANGAN, LEBAK, BANTEN",8,24,165,189
https://kawalpemilu.org#51935,"SITUREGEN, PANGGARANGAN, LEBAK, BANTEN",9,35,160,195
https://kawalpemilu.org#51935,"SITUREGEN, PANGGARANGAN, LEBAK, BANTEN",10,85,75,160
https://kawalpemilu.org#51935,"SITUREGEN, PANGGARANGAN, LEBAK, BANTEN",11,67,111,178
https://kawalpemilu.org#51935,"SITUREGEN, PANGGARANGAN, LEBAK, BANTEN",12,59,97,156
https://kawalpemilu.org#51935,"SITUREGEN, PANGGARANGAN, LEBAK, BANTEN",13,128,78,206
https://kawalpemilu.org#51935,"SITUREGEN, PANGGARANGAN, LEBAK, BANTEN",14,162,43,205
https://kawalpemilu.org#51936,"MEKARJAYA, PANGGARANGAN, LEBAK, BANTEN",1,37,137,174
https://kawalpemilu.org#51936,"MEKARJAYA, PANGGARANGAN, LEBAK, BANTEN",2,19,136,155
https://kawalpemilu.org#51936,"MEKARJAYA, PANGGARANGAN, LEBAK, BANTEN",3,38,181,219
https://kawalpemilu.org#51936,"MEKARJAYA, PANGGARANGAN, LEBAK, BANTEN",4,45,156,201
https://kawalpemilu.org#51936,"MEKARJAYA, PANGGARANGAN, LEBAK, BANTEN",5,40,132,172
https://kawalpemilu.org#51936,"MEKARJAYA, PANGGARANGAN, LEBAK, BANTEN",6,55,94,149
https://kawalpemilu.org#51936,"MEKARJAYA, PANGGARANGAN, LEBAK, BANTEN",7,27,172,199
https://kawalpemilu.org#51936,"MEKARJAYA, PANGGARANGAN, LEBAK, BANTEN",8,37,169,206
https://kawalpemilu.org#51936,"MEKARJAYA, PANGGARANGAN, LEBAK, BANTEN",9,63,151,214
https://kawalpemilu.org#51936,"MEKARJAYA, PANGGARANGAN, LEBAK, BANTEN",10,85,111,196
https://kawalpemilu.org#51936,"MEKARJAYA, PANGGARANGAN, LEBAK, BANTEN",11,84,109,193
https://kawalpemilu.org#51936,"MEKARJAYA, PANGGARANGAN, LEBAK, BANTEN",12,124,108,232
https://kawalpemilu.org#51936,"MEKARJAYA, PANGGARANGAN, LEBAK, BANTEN",13,59,153,212
https://kawalpemilu.org#51936,"MEKARJAYA, PANGGARANGAN, LEBAK, BANTEN",14,86,87,173
https://kawalpemilu.org#51937,"SINDANGRATU, PANGGARANGAN, LEBAK, BANTEN",1,157,66,223
https://kawalpemilu.org#51937,"SINDANGRATU, PANGGARANGAN, LEBAK, BANTEN",2,96,120,216
https://kawalpemilu.org#51937,"SINDANGRATU, PANGGARANGAN, LEBAK, BANTEN",3,168,71,239
https://kawalpemilu.org#51937,"SINDANGRATU, PANGGARANGAN, LEBAK, BANTEN",4,117,83,200
https://kawalpemilu.org#51937,"SINDANGRATU, PANGGARANGAN, LEBAK, BANTEN",5,131,97,228
https://kawalpemilu.org#51937,"SINDANGRATU, PANGGARANGAN, LEBAK, BANTEN",6,99,33,132
https://kawalpemilu.org#51937,"SINDANGRATU, PANGGARANGAN, LEBAK, BANTEN",7,121,102,223
https://kawalpemilu.org#51937,"SINDANGRATU, PANGGARANGAN, LEBAK, BANTEN",8,43,162,205
https://kawalpemilu.org#51937,"SINDANGRATU, PANGGARANGAN, LEBAK, BANTEN",9,88,141,229
https://kawalpemilu.org#51937,"SINDANGRATU, PANGGARANGAN, LEBAK, BANTEN",10,51,143,194
https://kawalpemilu.org#51937,"SINDANGRATU, PANGGARANGAN, LEBAK, BANTEN",11,77,114,191
https://kawalpemilu.org#51937,"SINDANGRATU, PANGGARANGAN, LEBAK, BANTEN",12,43,126,169
https://kawalpemilu.org#51937,"SINDANGRATU, PANGGARANGAN, LEBAK, BANTEN",13,21,178,199
https://kawalpemilu.org#51938,"HEGARMANAH, PANGGARANGAN, LEBAK, BANTEN",1,14,133,147
https://kawalpemilu.org#51938,"HEGARMANAH, PANGGARANGAN, LEBAK, BANTEN",2,18,112,130
https://kawalpemilu.org#51938,"HEGARMANAH, PANGGARANGAN, LEBAK, BANTEN",3,24,115,139
https://kawalpemilu.org#51938,"HEGARMANAH, PANGGARANGAN, LEBAK, BANTEN",4,34,102,136
https://kawalpemilu.org#51938,"HEGARMANAH, PANGGARANGAN, LEBAK, BANTEN",5,56,128,184
https://kawalpemilu.org#51938,"HEGARMANAH, PANGGARANGAN, LEBAK, BANTEN",6,74,94,168
https://kawalpemilu.org#51938,"HEGARMANAH, PANGGARANGAN, LEBAK, BANTEN",7,50,83,133
https://kawalpemilu.org#51939,"SUKAJADI, PANGGARANGAN, LEBAK, BANTEN",1,32,149,181
https://kawalpemilu.org#51939,"SUKAJADI, PANGGARANGAN, LEBAK, BANTEN",2,52,111,163
https://kawalpemilu.org#51939,"SUKAJADI, PANGGARANGAN, LEBAK, BANTEN",3,60,107,167
https://kawalpemilu.org#51939,"SUKAJADI, PANGGARANGAN, LEBAK, BANTEN",4,111,55,166
https://kawalpemilu.org#51939,"SUKAJADI, PANGGARANGAN, LEBAK, BANTEN",5,23,165,188
https://kawalpemilu.org#51939,"SUKAJADI, PANGGARANGAN, LEBAK, BANTEN",6,52,160,212
https://kawalpemilu.org#51939,"SUKAJADI, PANGGARANGAN, LEBAK, BANTEN",7,74,142,216
https://kawalpemilu.org#51939,"SUKAJADI, PANGGARANGAN, LEBAK, BANTEN",8,64,132,196
https://kawalpemilu.org#51939,"SUKAJADI, PANGGARANGAN, LEBAK, BANTEN",9,52,142,194
https://kawalpemilu.org#51939,"SUKAJADI, PANGGARANGAN, LEBAK, BANTEN",10,29,122,151
https://kawalpemilu.org#51940,"CIBARENGKOK, PANGGARANGAN, LEBAK, BANTEN",1,144,73,217
https://kawalpemilu.org#51940,"CIBARENGKOK, PANGGARANGAN, LEBAK, BANTEN",2,112,71,183
https://kawalpemilu.org#51940,"CIBARENGKOK, PANGGARANGAN, LEBAK, BANTEN",3,47,99,146
https://kawalpemilu.org#51940,"CIBARENGKOK, PANGGARANGAN, LEBAK, BANTEN",4,83,123,206
https://kawalpemilu.org#51940,"CIBARENGKOK, PANGGARANGAN, LEBAK, BANTEN",5,122,92,214
https://kawalpemilu.org#51940,"CIBARENGKOK, PANGGARANGAN, LEBAK, BANTEN",6,36,139,175
https://kawalpemilu.org#51940,"CIBARENGKOK, PANGGARANGAN, LEBAK, BANTEN",7,134,55,189
https://kawalpemilu.org#51940,"CIBARENGKOK, PANGGARANGAN, LEBAK, BANTEN",8,121,29,150
https://kawalpemilu.org#51940,"CIBARENGKOK, PANGGARANGAN, LEBAK, BANTEN",9,38,113,151
https://kawalpemilu.org#51942,"BAYAH BARAT, BAYAH, LEBAK, BANTEN",1,48,106,154
https://kawalpemilu.org#51942,"BAYAH BARAT, BAYAH, LEBAK, BANTEN",2,51,144,195
https://kawalpemilu.org#51942,"BAYAH BARAT, BAYAH, LEBAK, BANTEN",3,71,135,206
https://kawalpemilu.org#51942,"BAYAH BARAT, BAYAH, LEBAK, BANTEN",4,105,126,231
https://kawalpemilu.org#51942,"BAYAH BARAT, BAYAH, LEBAK, BANTEN",5,96,109,205
https://kawalpemilu.org#51942,"BAYAH BARAT, BAYAH, LEBAK, BANTEN",6,62,134,196
https://kawalpemilu.org#51942,"BAYAH BARAT, BAYAH, LEBAK, BANTEN",7,65,146,211
https://kawalpemilu.org#51942,"BAYAH BARAT, BAYAH, LEBAK, BANTEN",8,37,127,164
https://kawalpemilu.org#51942,"BAYAH BARAT, BAYAH, LEBAK, BANTEN",9,76,143,219
https://kawalpemilu.org#51942,"BAYAH BARAT, BAYAH, LEBAK, BANTEN",10,78,130,208
https://kawalpemilu.org#51942,"BAYAH BARAT, BAYAH, LEBAK, BANTEN",11,29,73,102
https://kawalpemilu.org#51942,"BAYAH BARAT, BAYAH, LEBAK, BANTEN",12,59,155,214
https://kawalpemilu.org#51942,"BAYAH BARAT, BAYAH, LEBAK, BANTEN",13,71,111,182
https://kawalpemilu.org#51942,"BAYAH BARAT, BAYAH, LEBAK, BANTEN",14,68,150,218
https://kawalpemilu.org#51942,"BAYAH BARAT, BAYAH, LEBAK, BANTEN",15,45,139,184
https://kawalpemilu.org#51942,"BAYAH BARAT, BAYAH, LEBAK, BANTEN",16,48,152,200
https://kawalpemilu.org#51942,"BAYAH BARAT, BAYAH, LEBAK, BANTEN",17,59,122,181
https://kawalpemilu.org#51942,"BAYAH BARAT, BAYAH, LEBAK, BANTEN",18,40,135,175
https://kawalpemilu.org#51942,"BAYAH BARAT, BAYAH, LEBAK, BANTEN",19,33,148,181
https://kawalpemilu.org#51942,"BAYAH BARAT, BAYAH, LEBAK, BANTEN",20,58,133,191
https://kawalpemilu.org#51942,"BAYAH BARAT, BAYAH, LEBAK, BANTEN",21,0,0,196
https://kawalpemilu.org#51942,"BAYAH BARAT, BAYAH, LEBAK, BANTEN",22,98,98,196
https://kawalpemilu.org#51943,"SAWARNA, BAYAH, LEBAK, BANTEN",1,44,117,161
https://kawalpemilu.org#51943,"SAWARNA, BAYAH, LEBAK, BANTEN",2,79,83,162
https://kawalpemilu.org#51943,"SAWARNA, BAYAH, LEBAK, BANTEN",3,133,80,213
https://kawalpemilu.org#51943,"SAWARNA, BAYAH, LEBAK, BANTEN",4,142,66,208
https://kawalpemilu.org#51943,"SAWARNA, BAYAH, LEBAK, BANTEN",5,126,31,157
https://kawalpemilu.org#51943,"SAWARNA, BAYAH, LEBAK, BANTEN",6,167,57,224
https://kawalpemilu.org#51943,"SAWARNA, BAYAH, LEBAK, BANTEN",7,129,42,171
https://kawalpemilu.org#51943,"SAWARNA, BAYAH, LEBAK, BANTEN",8,166,63,229
https://kawalpemilu.org#51943,"SAWARNA, BAYAH, LEBAK, BANTEN",9,102,87,189
https://kawalpemilu.org#51943,"SAWARNA, BAYAH, LEBAK, BANTEN",10,92,111,203
https://kawalpemilu.org#51943,"SAWARNA, BAYAH, LEBAK, BANTEN",11,125,51,176
https://kawalpemilu.org#51943,"SAWARNA, BAYAH, LEBAK, BANTEN",12,89,102,191
https://kawalpemilu.org#51943,"SAWARNA, BAYAH, LEBAK, BANTEN",13,139,45,184
https://kawalpemilu.org#51943,"SAWARNA, BAYAH, LEBAK, BANTEN",14,74,36,110
https://kawalpemilu.org#51943,"SAWARNA, BAYAH, LEBAK, BANTEN",15,79,95,174
https://kawalpemilu.org#51944,"CIDIKIT, BAYAH, LEBAK, BANTEN",1,40,209,249
https://kawalpemilu.org#51944,"CIDIKIT, BAYAH, LEBAK, BANTEN",2,84,151,235
https://kawalpemilu.org#51944,"CIDIKIT, BAYAH, LEBAK, BANTEN",3,46,189,235
https://kawalpemilu.org#51944,"CIDIKIT, BAYAH, LEBAK, BANTEN",4,45,166,211
https://kawalpemilu.org#51944,"CIDIKIT, BAYAH, LEBAK, BANTEN",5,22,146,168
https://kawalpemilu.org#51944,"CIDIKIT, BAYAH, LEBAK, BANTEN",6,22,155,177
https://kawalpemilu.org#51944,"CIDIKIT, BAYAH, LEBAK, BANTEN",7,47,73,120
https://kawalpemilu.org#51944,"CIDIKIT, BAYAH, LEBAK, BANTEN",8,83,171,254
https://kawalpemilu.org#51944,"CIDIKIT, BAYAH, LEBAK, BANTEN",9,110,137,247
https://kawalpemilu.org#51944,"CIDIKIT, BAYAH, LEBAK, BANTEN",10,102,36,138
https://kawalpemilu.org#51944,"CIDIKIT, BAYAH, LEBAK, BANTEN",11,133,24,157
https://kawalpemilu.org#51944,"CIDIKIT, BAYAH, LEBAK, BANTEN",12,184,18,202
https://kawalpemilu.org#51944,"CIDIKIT, BAYAH, LEBAK, BANTEN",13,62,97,159
https://kawalpemilu.org#51944,"CIDIKIT, BAYAH, LEBAK, BANTEN",14,50,107,157
https://kawalpemilu.org#51945,"SUWAKAN, BAYAH, LEBAK, BANTEN",1,23,144,167
https://kawalpemilu.org#51945,"SUWAKAN, BAYAH, LEBAK, BANTEN",2,30,173,203
https://kawalpemilu.org#51945,"SUWAKAN, BAYAH, LEBAK, BANTEN",3,31,148,179
https://kawalpemilu.org#51945,"SUWAKAN, BAYAH, LEBAK, BANTEN",4,29,123,152
https://kawalpemilu.org#51945,"SUWAKAN, BAYAH, LEBAK, BANTEN",5,55,89,144
https://kawalpemilu.org#51945,"SUWAKAN, BAYAH, LEBAK, BANTEN",6,48,128,176
https://kawalpemilu.org#51945,"SUWAKAN, BAYAH, LEBAK, BANTEN",7,44,207,251
https://kawalpemilu.org#51945,"SUWAKAN, BAYAH, LEBAK, BANTEN",8,65,134,199
https://kawalpemilu.org#51945,"SUWAKAN, BAYAH, LEBAK, BANTEN",9,74,108,182
https://kawalpemilu.org#51945,"SUWAKAN, BAYAH, LEBAK, BANTEN",10,55,154,209
https://kawalpemilu.org#51945,"SUWAKAN, BAYAH, LEBAK, BANTEN",11,48,187,235
https://kawalpemilu.org#51946,"CIMANCAK, BAYAH, LEBAK, BANTEN",1,48,160,208
https://kawalpemilu.org#51946,"CIMANCAK, BAYAH, LEBAK, BANTEN",2,31,179,210
https://kawalpemilu.org#51946,"CIMANCAK, BAYAH, LEBAK, BANTEN",3,77,122,199
https://kawalpemilu.org#51946,"CIMANCAK, BAYAH, LEBAK, BANTEN",4,20,193,213
https://kawalpemilu.org#51946,"CIMANCAK, BAYAH, LEBAK, BANTEN",5,45,152,197
https://kawalpemilu.org#51946,"CIMANCAK, BAYAH, LEBAK, BANTEN",6,49,124,173
https://kawalpemilu.org#51946,"CIMANCAK, BAYAH, LEBAK, BANTEN",7,18,131,149
https://kawalpemilu.org#51946,"CIMANCAK, BAYAH, LEBAK, BANTEN",8,51,127,178
https://kawalpemilu.org#51946,"CIMANCAK, BAYAH, LEBAK, BANTEN",9,59,136,195
https://kawalpemilu.org#51946,"CIMANCAK, BAYAH, LEBAK, BANTEN",10,46,118,164
https://kawalpemilu.org#51946,"CIMANCAK, BAYAH, LEBAK, BANTEN",11,93,128,221
https://kawalpemilu.org#51946,"CIMANCAK, BAYAH, LEBAK, BANTEN",12,45,153,198
https://kawalpemilu.org#51947,"DARMASARI, BAYAH, LEBAK, BANTEN",1,107,112,219
https://kawalpemilu.org#51947,"DARMASARI, BAYAH, LEBAK, BANTEN",2,116,85,201
https://kawalpemilu.org#51947,"DARMASARI, BAYAH, LEBAK, BANTEN",3,119,68,187
https://kawalpemilu.org#51947,"DARMASARI, BAYAH, LEBAK, BANTEN",4,95,92,187
https://kawalpemilu.org#51947,"DARMASARI, BAYAH, LEBAK, BANTEN",5,114,96,210
https://kawalpemilu.org#51947,"DARMASARI, BAYAH, LEBAK, BANTEN",6,126,68,194
https://kawalpemilu.org#51947,"DARMASARI, BAYAH, LEBAK, BANTEN",7,119,82,201
https://kawalpemilu.org#51947,"DARMASARI, BAYAH, LEBAK, BANTEN",8,128,100,228
https://kawalpemilu.org#51947,"DARMASARI, BAYAH, LEBAK, BANTEN",9,140,86,226
https://kawalpemilu.org#51948,"BAYAH TIMUR, BAYAH, LEBAK, BANTEN",1,59,146,205
https://kawalpemilu.org#51948,"BAYAH TIMUR, BAYAH, LEBAK, BANTEN",2,61,128,189
https://kawalpemilu.org#51948,"BAYAH TIMUR, BAYAH, LEBAK, BANTEN",3,45,170,215
https://kawalpemilu.org#51948,"BAYAH TIMUR, BAYAH, LEBAK, BANTEN",4,70,121,191
https://kawalpemilu.org#51948,"BAYAH TIMUR, BAYAH, LEBAK, BANTEN",5,77,141,218
https://kawalpemilu.org#51948,"BAYAH TIMUR, BAYAH, LEBAK, BANTEN",6,20,183,203
https://kawalpemilu.org#51948,"BAYAH TIMUR, BAYAH, LEBAK, BANTEN",7,86,112,198
https://kawalpemilu.org#51948,"BAYAH TIMUR, BAYAH, LEBAK, BANTEN",8,56,153,209
https://kawalpemilu.org#51948,"BAYAH TIMUR, BAYAH, LEBAK, BANTEN",9,39,161,200
https://kawalpemilu.org#51948,"BAYAH TIMUR, BAYAH, LEBAK, BANTEN",10,47,112,159
https://kawalpemilu.org#51948,"BAYAH TIMUR, BAYAH, LEBAK, BANTEN",11,30,156,186
https://kawalpemilu.org#51948,"BAYAH TIMUR, BAYAH, LEBAK, BANTEN",12,56,130,186
https://kawalpemilu.org#51948,"BAYAH TIMUR, BAYAH, LEBAK, BANTEN",13,62,115,177
https://kawalpemilu.org#51948,"BAYAH TIMUR, BAYAH, LEBAK, BANTEN",14,97,111,208
https://kawalpemilu.org#51948,"BAYAH TIMUR, BAYAH, LEBAK, BANTEN",15,61,154,215
https://kawalpemilu.org#51948,"BAYAH TIMUR, BAYAH, LEBAK, BANTEN",16,30,197,227
https://kawalpemilu.org#51948,"BAYAH TIMUR, BAYAH, LEBAK, BANTEN",17,87,103,190
https://kawalpemilu.org#51949,"CISUREN, BAYAH, LEBAK, BANTEN",1,96,104,200
https://kawalpemilu.org#51949,"CISUREN, BAYAH, LEBAK, BANTEN",2,113,91,204
https://kawalpemilu.org#51949,"CISUREN, BAYAH, LEBAK, BANTEN",3,83,112,195
https://kawalpemilu.org#51949,"CISUREN, BAYAH, LEBAK, BANTEN",4,73,133,206
https://kawalpemilu.org#51949,"CISUREN, BAYAH, LEBAK, BANTEN",5,50,97,147
https://kawalpemilu.org#51949,"CISUREN, BAYAH, LEBAK, BANTEN",6,38,110,148
https://kawalpemilu.org#51949,"CISUREN, BAYAH, LEBAK, BANTEN",7,39,117,156
https://kawalpemilu.org#51949,"CISUREN, BAYAH, LEBAK, BANTEN",8,93,125,218
https://kawalpemilu.org#51949,"CISUREN, BAYAH, LEBAK, BANTEN",9,114,117,231
https://kawalpemilu.org#51949,"CISUREN, BAYAH, LEBAK, BANTEN",10,146,73,219
https://kawalpemilu.org#51950,"PASIRGOMBONG, BAYAH, LEBAK, BANTEN",1,94,78,172
https://kawalpemilu.org#51950,"PASIRGOMBONG, BAYAH, LEBAK, BANTEN",2,92,97,189
https://kawalpemilu.org#51950,"PASIRGOMBONG, BAYAH, LEBAK, BANTEN",3,55,140,195
https://kawalpemilu.org#51950,"PASIRGOMBONG, BAYAH, LEBAK, BANTEN",4,36,157,193
https://kawalpemilu.org#51950,"PASIRGOMBONG, BAYAH, LEBAK, BANTEN",5,34,150,184
https://kawalpemilu.org#51950,"PASIRGOMBONG, BAYAH, LEBAK, BANTEN",6,64,97,161
https://kawalpemilu.org#51950,"PASIRGOMBONG, BAYAH, LEBAK, BANTEN",7,45,131,176
https://kawalpemilu.org#51950,"PASIRGOMBONG, BAYAH, LEBAK, BANTEN",8,58,83,141
https://kawalpemilu.org#51951,"SAWARNA TIMUR, BAYAH, LEBAK, BANTEN",1,89,108,197
https://kawalpemilu.org#51951,"SAWARNA TIMUR, BAYAH, LEBAK, BANTEN",2,92,85,177
https://kawalpemilu.org#51951,"SAWARNA TIMUR, BAYAH, LEBAK, BANTEN",3,109,62,171
https://kawalpemilu.org#51951,"SAWARNA TIMUR, BAYAH, LEBAK, BANTEN",4,163,32,195
https://kawalpemilu.org#51951,"SAWARNA TIMUR, BAYAH, LEBAK, BANTEN",5,118,51,169
https://kawalpemilu.org#51951,"SAWARNA TIMUR, BAYAH, LEBAK, BANTEN",6,98,63,161
https://kawalpemilu.org#51951,"SAWARNA TIMUR, BAYAH, LEBAK, BANTEN",7,129,61,190
https://kawalpemilu.org#51952,"PAMUBULAN, BAYAH, LEBAK, BANTEN",1,60,142,202
https://kawalpemilu.org#51952,"PAMUBULAN, BAYAH, LEBAK, BANTEN",2,83,103,186
https://kawalpemilu.org#51952,"PAMUBULAN, BAYAH, LEBAK, BANTEN",3,62,122,184
https://kawalpemilu.org#51952,"PAMUBULAN, BAYAH, LEBAK, BANTEN",4,109,62,171
https://kawalpemilu.org#51952,"PAMUBULAN, BAYAH, LEBAK, BANTEN",5,118,75,193
https://kawalpemilu.org#51952,"PAMUBULAN, BAYAH, LEBAK, BANTEN",6,92,121,213
https://kawalpemilu.org#51952,"PAMUBULAN, BAYAH, LEBAK, BANTEN",7,72,114,186
https://kawalpemilu.org#51952,"PAMUBULAN, BAYAH, LEBAK, BANTEN",8,73,110,183
https://kawalpemilu.org#51952,"PAMUBULAN, BAYAH, LEBAK, BANTEN",9,141,88,229
https://kawalpemilu.org#51952,"PAMUBULAN, BAYAH, LEBAK, BANTEN",10,109,115,224
https://kawalpemilu.org#51952,"PAMUBULAN, BAYAH, LEBAK, BANTEN",11,134,71,205
https://kawalpemilu.org#51952,"PAMUBULAN, BAYAH, LEBAK, BANTEN",12,127,76,203
https://kawalpemilu.org#51952,"PAMUBULAN, BAYAH, LEBAK, BANTEN",13,154,54,208
https://kawalpemilu.org#51954,"CIPANAS, CIPANAS, LEBAK, BANTEN",1,55,179,234
https://kawalpemilu.org#51954,"CIPANAS, CIPANAS, LEBAK, BANTEN",2,25,225,250
https://kawalpemilu.org#51954,"CIPANAS, CIPANAS, LEBAK, BANTEN",3,31,181,212
https://kawalpemilu.org#51954,"CIPANAS, CIPANAS, LEBAK, BANTEN",4,24,178,202
https://kawalpemilu.org#51954,"CIPANAS, CIPANAS, LEBAK, BANTEN",5,36,136,172
https://kawalpemilu.org#51954,"CIPANAS, CIPANAS, LEBAK, BANTEN",6,31,141,172
https://kawalpemilu.org#51954,"CIPANAS, CIPANAS, LEBAK, BANTEN",7,38,191,229
https://kawalpemilu.org#51954,"CIPANAS, CIPANAS, LEBAK, BANTEN",8,39,214,253
https://kawalpemilu.org#51954,"CIPANAS, CIPANAS, LEBAK, BANTEN",9,22,173,195
https://kawalpemilu.org#51954,"CIPANAS, CIPANAS, LEBAK, BANTEN",10,41,138,179
https://kawalpemilu.org#51954,"CIPANAS, CIPANAS, LEBAK, BANTEN",11,27,151,178
https://kawalpemilu.org#51954,"CIPANAS, CIPANAS, LEBAK, BANTEN",12,34,131,165
https://kawalpemilu.org#51955,"GIRILAYA, CIPANAS, LEBAK, BANTEN",1,59,102,161
https://kawalpemilu.org#51955,"GIRILAYA, CIPANAS, LEBAK, BANTEN",2,55,111,166
https://kawalpemilu.org#51955,"GIRILAYA, CIPANAS, LEBAK, BANTEN",3,46,142,188
https://kawalpemilu.org#51955,"GIRILAYA, CIPANAS, LEBAK, BANTEN",4,39,165,204
https://kawalpemilu.org#51955,"GIRILAYA, CIPANAS, LEBAK, BANTEN",5,69,98,167
https://kawalpemilu.org#51955,"GIRILAYA, CIPANAS, LEBAK, BANTEN",6,69,102,171
https://kawalpemilu.org#51955,"GIRILAYA, CIPANAS, LEBAK, BANTEN",7,73,88,161
https://kawalpemilu.org#51955,"GIRILAYA, CIPANAS, LEBAK, BANTEN",8,90,94,184
https://kawalpemilu.org#51955,"GIRILAYA, CIPANAS, LEBAK, BANTEN",9,33,167,200
https://kawalpemilu.org#51955,"GIRILAYA, CIPANAS, LEBAK, BANTEN",10,33,150,183
https://kawalpemilu.org#51955,"GIRILAYA, CIPANAS, LEBAK, BANTEN",11,67,138,205
https://kawalpemilu.org#51956,"MALANGSARI, CIPANAS, LEBAK, BANTEN",1,40,177,217
https://kawalpemilu.org#51956,"MALANGSARI, CIPANAS, LEBAK, BANTEN",2,50,120,170
https://kawalpemilu.org#51956,"MALANGSARI, CIPANAS, LEBAK, BANTEN",3,42,142,184
https://kawalpemilu.org#51956,"MALANGSARI, CIPANAS, LEBAK, BANTEN",4,40,179,219
https://kawalpemilu.org#51956,"MALANGSARI, CIPANAS, LEBAK, BANTEN",5,53,137,190
https://kawalpemilu.org#51956,"MALANGSARI, CIPANAS, LEBAK, BANTEN",6,53,108,161
https://kawalpemilu.org#51956,"MALANGSARI, CIPANAS, LEBAK, BANTEN",7,47,115,162
https://kawalpemilu.org#51957,"BINTANGRESMI, CIPANAS, LEBAK, BANTEN",1,47,172,219
https://kawalpemilu.org#51957,"BINTANGRESMI, CIPANAS, LEBAK, BANTEN",2,46,171,217
https://kawalpemilu.org#51957,"BINTANGRESMI, CIPANAS, LEBAK, BANTEN",3,28,200,228
https://kawalpemilu.org#51957,"BINTANGRESMI, CIPANAS, LEBAK, BANTEN",4,21,207,228
https://kawalpemilu.org#51957,"BINTANGRESMI, CIPANAS, LEBAK, BANTEN",5,47,164,211
https://kawalpemilu.org#51957,"BINTANGRESMI, CIPANAS, LEBAK, BANTEN",6,35,166,201
https://kawalpemilu.org#51957,"BINTANGRESMI, CIPANAS, LEBAK, BANTEN",7,44,172,216
https://kawalpemilu.org#51957,"BINTANGRESMI, CIPANAS, LEBAK, BANTEN",8,79,142,221
https://kawalpemilu.org#51957,"BINTANGRESMI, CIPANAS, LEBAK, BANTEN",9,16,171,187
https://kawalpemilu.org#51957,"BINTANGRESMI, CIPANAS, LEBAK, BANTEN",10,25,201,226
https://kawalpemilu.org#51958,"TALAGAHIYANG, CIPANAS, LEBAK, BANTEN",1,35,179,214
https://kawalpemilu.org#51958,"TALAGAHIYANG, CIPANAS, LEBAK, BANTEN",2,30,171,201
https://kawalpemilu.org#51958,"TALAGAHIYANG, CIPANAS, LEBAK, BANTEN",3,46,171,217
https://kawalpemilu.org#51958,"TALAGAHIYANG, CIPANAS, LEBAK, BANTEN",4,28,171,199
https://kawalpemilu.org#51958,"TALAGAHIYANG, CIPANAS, LEBAK, BANTEN",5,14,192,206
https://kawalpemilu.org#51958,"TALAGAHIYANG, CIPANAS, LEBAK, BANTEN",6,19,110,129
https://kawalpemilu.org#51959,"LUHURJAYA, CIPANAS, LEBAK, BANTEN",1,95,131,226
https://kawalpemilu.org#51959,"LUHURJAYA, CIPANAS, LEBAK, BANTEN",2,47,133,180
https://kawalpemilu.org#51959,"LUHURJAYA, CIPANAS, LEBAK, BANTEN",4,16,163,179
https://kawalpemilu.org#51959,"LUHURJAYA, CIPANAS, LEBAK, BANTEN",5,22,207,229
https://kawalpemilu.org#51959,"LUHURJAYA, CIPANAS, LEBAK, BANTEN",6,42,134,176
https://kawalpemilu.org#51959,"LUHURJAYA, CIPANAS, LEBAK, BANTEN",7,40,137,177
https://kawalpemilu.org#51959,"LUHURJAYA, CIPANAS, LEBAK, BANTEN",8,108,120,228
https://kawalpemilu.org#51959,"LUHURJAYA, CIPANAS, LEBAK, BANTEN",9,45,129,174
https://kawalpemilu.org#51959,"LUHURJAYA, CIPANAS, LEBAK, BANTEN",10,58,208,266
https://kawalpemilu.org#51959,"LUHURJAYA, CIPANAS, LEBAK, BANTEN",11,16,153,169
https://kawalpemilu.org#51959,"LUHURJAYA, CIPANAS, LEBAK, BANTEN",12,35,183,218
https://kawalpemilu.org#51959,"LUHURJAYA, CIPANAS, LEBAK, BANTEN",13,52,119,171
https://kawalpemilu.org#51959,"LUHURJAYA, CIPANAS, LEBAK, BANTEN",14,51,121,172
https://kawalpemilu.org#51959,"LUHURJAYA, CIPANAS, LEBAK, BANTEN",15,46,146,192
https://kawalpemilu.org#51960,"HAURGAJRUG, CIPANAS, LEBAK, BANTEN",1,60,178,238
https://kawalpemilu.org#51960,"HAURGAJRUG, CIPANAS, LEBAK, BANTEN",2,56,197,253
https://kawalpemilu.org#51960,"HAURGAJRUG, CIPANAS, LEBAK, BANTEN",3,51,149,200
https://kawalpemilu.org#51960,"HAURGAJRUG, CIPANAS, LEBAK, BANTEN",4,58,98,156
https://kawalpemilu.org#51960,"HAURGAJRUG, CIPANAS, LEBAK, BANTEN",5,102,93,193
https://kawalpemilu.org#51960,"HAURGAJRUG, CIPANAS, LEBAK, BANTEN",6,18,166,184
https://kawalpemilu.org#51960,"HAURGAJRUG, CIPANAS, LEBAK, BANTEN",7,60,173,233
https://kawalpemilu.org#51960,"HAURGAJRUG, CIPANAS, LEBAK, BANTEN",8,58,190,248
https://kawalpemilu.org#51960,"HAURGAJRUG, CIPANAS, LEBAK, BANTEN",9,45,133,178
https://kawalpemilu.org#51960,"HAURGAJRUG, CIPANAS, LEBAK, BANTEN",10,39,133,172
https://kawalpemilu.org#51960,"HAURGAJRUG, CIPANAS, LEBAK, BANTEN",11,110,63,173
https://kawalpemilu.org#51960,"HAURGAJRUG, CIPANAS, LEBAK, BANTEN",12,90,85,175
https://kawalpemilu.org#51960,"HAURGAJRUG, CIPANAS, LEBAK, BANTEN",13,27,188,215
https://kawalpemilu.org#51960,"HAURGAJRUG, CIPANAS, LEBAK, BANTEN",14,35,91,126
https://kawalpemilu.org#51961,"GIRIHARJA, CIPANAS, LEBAK, BANTEN",1,29,143,172
https://kawalpemilu.org#51961,"GIRIHARJA, CIPANAS, LEBAK, BANTEN",2,31,205,236
https://kawalpemilu.org#51961,"GIRIHARJA, CIPANAS, LEBAK, BANTEN",3,55,196,251
https://kawalpemilu.org#51961,"GIRIHARJA, CIPANAS, LEBAK, BANTEN",4,23,169,192
https://kawalpemilu.org#51961,"GIRIHARJA, CIPANAS, LEBAK, BANTEN",5,8,154,162
https://kawalpemilu.org#51961,"GIRIHARJA, CIPANAS, LEBAK, BANTEN",6,24,144,168
https://kawalpemilu.org#51961,"GIRIHARJA, CIPANAS, LEBAK, BANTEN",7,29,152,181
https://kawalpemilu.org#51961,"GIRIHARJA, CIPANAS, LEBAK, BANTEN",8,36,215,251
https://kawalpemilu.org#51961,"GIRIHARJA, CIPANAS, LEBAK, BANTEN",9,50,173,223
https://kawalpemilu.org#51961,"GIRIHARJA, CIPANAS, LEBAK, BANTEN",10,15,175,190
https://kawalpemilu.org#51961,"GIRIHARJA, CIPANAS, LEBAK, BANTEN",11,11,147,158
https://kawalpemilu.org#51962,"SUKASARI, CIPANAS, LEBAK, BANTEN",1,108,129,237
https://kawalpemilu.org#51962,"SUKASARI, CIPANAS, LEBAK, BANTEN",2,35,133,168
https://kawalpemilu.org#51962,"SUKASARI, CIPANAS, LEBAK, BANTEN",3,53,141,194
https://kawalpemilu.org#51962,"SUKASARI, CIPANAS, LEBAK, BANTEN",4,41,125,166
https://kawalpemilu.org#51962,"SUKASARI, CIPANAS, LEBAK, BANTEN",5,21,162,183
https://kawalpemilu.org#51962,"SUKASARI, CIPANAS, LEBAK, BANTEN",6,29,161,190
https://kawalpemilu.org#51962,"SUKASARI, CIPANAS, LEBAK, BANTEN",7,69,98,167
https://kawalpemilu.org#51962,"SUKASARI, CIPANAS, LEBAK, BANTEN",8,70,143,213
https://kawalpemilu.org#51962,"SUKASARI, CIPANAS, LEBAK, BANTEN",9,76,105,181
https://kawalpemilu.org#51962,"SUKASARI, CIPANAS, LEBAK, BANTEN",10,26,144,170
https://kawalpemilu.org#51962,"SUKASARI, CIPANAS, LEBAK, BANTEN",11,34,125,159
https://kawalpemilu.org#51962,"SUKASARI, CIPANAS, LEBAK, BANTEN",13,52,119,171
https://kawalpemilu.org#51962,"SUKASARI, CIPANAS, LEBAK, BANTEN",14,41,130,171
https://kawalpemilu.org#51962,"SUKASARI, CIPANAS, LEBAK, BANTEN",15,23,189,212
https://kawalpemilu.org#51962,"SUKASARI, CIPANAS, LEBAK, BANTEN",16,38,170,208
https://kawalpemilu.org#51963,"JAYAPURA, CIPANAS, LEBAK, BANTEN",1,67,116,183
https://kawalpemilu.org#51963,"JAYAPURA, CIPANAS, LEBAK, BANTEN",2,104,92,196
https://kawalpemilu.org#51963,"JAYAPURA, CIPANAS, LEBAK, BANTEN",3,126,68,194
https://kawalpemilu.org#51963,"JAYAPURA, CIPANAS, LEBAK, BANTEN",4,100,56,156
https://kawalpemilu.org#51963,"JAYAPURA, CIPANAS, LEBAK, BANTEN",5,86,117,203
https://kawalpemilu.org#51963,"JAYAPURA, CIPANAS, LEBAK, BANTEN",6,93,97,190
https://kawalpemilu.org#51963,"JAYAPURA, CIPANAS, LEBAK, BANTEN",7,114,68,182
https://kawalpemilu.org#51963,"JAYAPURA, CIPANAS, LEBAK, BANTEN",8,102,53,155
https://kawalpemilu.org#51963,"JAYAPURA, CIPANAS, LEBAK, BANTEN",9,82,80,162
https://kawalpemilu.org#51964,"SIPAYUNG, CIPANAS, LEBAK, BANTEN",1,53,169,222
https://kawalpemilu.org#51964,"SIPAYUNG, CIPANAS, LEBAK, BANTEN",2,70,151,221
https://kawalpemilu.org#51964,"SIPAYUNG, CIPANAS, LEBAK, BANTEN",3,36,130,166
https://kawalpemilu.org#51964,"SIPAYUNG, CIPANAS, LEBAK, BANTEN",4,28,208,236
https://kawalpemilu.org#51964,"SIPAYUNG, CIPANAS, LEBAK, BANTEN",5,23,170,193
https://kawalpemilu.org#51964,"SIPAYUNG, CIPANAS, LEBAK, BANTEN",6,45,163,208
https://kawalpemilu.org#51964,"SIPAYUNG, CIPANAS, LEBAK, BANTEN",7,64,166,230
https://kawalpemilu.org#51964,"SIPAYUNG, CIPANAS, LEBAK, BANTEN",8,28,155,183
https://kawalpemilu.org#51964,"SIPAYUNG, CIPANAS, LEBAK, BANTEN",9,33,149,182
https://kawalpemilu.org#51964,"SIPAYUNG, CIPANAS, LEBAK, BANTEN",10,17,225,242
https://kawalpemilu.org#51964,"SIPAYUNG, CIPANAS, LEBAK, BANTEN",11,41,163,204
https://kawalpemilu.org#51965,"BINTANGSARI, CIPANAS, LEBAK, BANTEN",1,38,144,182
https://kawalpemilu.org#51965,"BINTANGSARI, CIPANAS, LEBAK, BANTEN",2,7,133,140
https://kawalpemilu.org#51965,"BINTANGSARI, CIPANAS, LEBAK, BANTEN",3,34,145,179
https://kawalpemilu.org#51965,"BINTANGSARI, CIPANAS, LEBAK, BANTEN",4,28,124,152
https://kawalpemilu.org#51965,"BINTANGSARI, CIPANAS, LEBAK, BANTEN",5,25,147,172
https://kawalpemilu.org#51965,"BINTANGSARI, CIPANAS, LEBAK, BANTEN",6,15,140,155
https://kawalpemilu.org#51965,"BINTANGSARI, CIPANAS, LEBAK, BANTEN",7,50,130,180
https://kawalpemilu.org#51965,"BINTANGSARI, CIPANAS, LEBAK, BANTEN",8,50,110,160
https://kawalpemilu.org#51966,"PASIRHAUR, CIPANAS, LEBAK, BANTEN",1,31,161,192
https://kawalpemilu.org#51966,"PASIRHAUR, CIPANAS, LEBAK, BANTEN",2,39,139,178
https://kawalpemilu.org#51966,"PASIRHAUR, CIPANAS, LEBAK, BANTEN",3,28,92,120
https://kawalpemilu.org#51966,"PASIRHAUR, CIPANAS, LEBAK, BANTEN",4,36,165,201
https://kawalpemilu.org#51966,"PASIRHAUR, CIPANAS, LEBAK, BANTEN",5,19,157,176
https://kawalpemilu.org#51966,"PASIRHAUR, CIPANAS, LEBAK, BANTEN",6,58,111,169
https://kawalpemilu.org#51966,"PASIRHAUR, CIPANAS, LEBAK, BANTEN",7,48,95,143
https://kawalpemilu.org#51966,"PASIRHAUR, CIPANAS, LEBAK, BANTEN",8,68,130,198
https://kawalpemilu.org#51966,"PASIRHAUR, CIPANAS, LEBAK, BANTEN",9,57,153,210
https://kawalpemilu.org#51966,"PASIRHAUR, CIPANAS, LEBAK, BANTEN",10,94,94,188
https://kawalpemilu.org#51967,"HARUMSARI, CIPANAS, LEBAK, BANTEN",1,44,179,223
https://kawalpemilu.org#51967,"HARUMSARI, CIPANAS, LEBAK, BANTEN",2,40,120,160
https://kawalpemilu.org#51967,"HARUMSARI, CIPANAS, LEBAK, BANTEN",3,54,146,200
https://kawalpemilu.org#51967,"HARUMSARI, CIPANAS, LEBAK, BANTEN",4,47,161,208
https://kawalpemilu.org#51967,"HARUMSARI, CIPANAS, LEBAK, BANTEN",5,43,100,143
https://kawalpemilu.org#51967,"HARUMSARI, CIPANAS, LEBAK, BANTEN",6,33,114,147
https://kawalpemilu.org#51967,"HARUMSARI, CIPANAS, LEBAK, BANTEN",7,57,165,222
https://kawalpemilu.org#51969,"PASIREURIH, MUNCANG, LEBAK, BANTEN",1,38,130,168
https://kawalpemilu.org#51969,"PASIREURIH, MUNCANG, LEBAK, BANTEN",2,47,120,167
https://kawalpemilu.org#51969,"PASIREURIH, MUNCANG, LEBAK, BANTEN",3,76,111,187
https://kawalpemilu.org#51969,"PASIREURIH, MUNCANG, LEBAK, BANTEN",4,96,92,188
https://kawalpemilu.org#51969,"PASIREURIH, MUNCANG, LEBAK, BANTEN",5,76,126,202
https://kawalpemilu.org#51969,"PASIREURIH, MUNCANG, LEBAK, BANTEN",6,59,124,183
https://kawalpemilu.org#51969,"PASIREURIH, MUNCANG, LEBAK, BANTEN",7,52,84,136
https://kawalpemilu.org#51969,"PASIREURIH, MUNCANG, LEBAK, BANTEN",8,31,85,116
https://kawalpemilu.org#51969,"PASIREURIH, MUNCANG, LEBAK, BANTEN",9,11,143,154
https://kawalpemilu.org#51970,"CIMINYAK, MUNCANG, LEBAK, BANTEN",1,67,143,210
https://kawalpemilu.org#51970,"CIMINYAK, MUNCANG, LEBAK, BANTEN",2,64,132,196
https://kawalpemilu.org#51970,"CIMINYAK, MUNCANG, LEBAK, BANTEN",3,72,118,190
https://kawalpemilu.org#51970,"CIMINYAK, MUNCANG, LEBAK, BANTEN",4,55,137,192
https://kawalpemilu.org#51970,"CIMINYAK, MUNCANG, LEBAK, BANTEN",5,31,171,202
https://kawalpemilu.org#51970,"CIMINYAK, MUNCANG, LEBAK, BANTEN",6,35,141,176
https://kawalpemilu.org#51970,"CIMINYAK, MUNCANG, LEBAK, BANTEN",7,34,145,179
https://kawalpemilu.org#51970,"CIMINYAK, MUNCANG, LEBAK, BANTEN",8,42,148,190
https://kawalpemilu.org#51970,"CIMINYAK, MUNCANG, LEBAK, BANTEN",9,17,157,174
https://kawalpemilu.org#51970,"CIMINYAK, MUNCANG, LEBAK, BANTEN",10,13,175,188
https://kawalpemilu.org#51970,"CIMINYAK, MUNCANG, LEBAK, BANTEN",11,11,157,168
https://kawalpemilu.org#51970,"CIMINYAK, MUNCANG, LEBAK, BANTEN",12,11,140,151
https://kawalpemilu.org#51971,"MUNCANG, MUNCANG, LEBAK, BANTEN",1,75,117,192
https://kawalpemilu.org#51971,"MUNCANG, MUNCANG, LEBAK, BANTEN",2,69,108,177
https://kawalpemilu.org#51971,"MUNCANG, MUNCANG, LEBAK, BANTEN",3,38,164,202
https://kawalpemilu.org#51971,"MUNCANG, MUNCANG, LEBAK, BANTEN",4,45,131,176
https://kawalpemilu.org#51971,"MUNCANG, MUNCANG, LEBAK, BANTEN",5,31,133,164
https://kawalpemilu.org#51971,"MUNCANG, MUNCANG, LEBAK, BANTEN",6,31,163,194
https://kawalpemilu.org#51971,"MUNCANG, MUNCANG, LEBAK, BANTEN",7,44,81,125
https://kawalpemilu.org#51971,"MUNCANG, MUNCANG, LEBAK, BANTEN",8,59,117,176
https://kawalpemilu.org#51971,"MUNCANG, MUNCANG, LEBAK, BANTEN",9,40,140,180
https://kawalpemilu.org#51971,"MUNCANG, MUNCANG, LEBAK, BANTEN",10,35,140,175
https://kawalpemilu.org#51971,"MUNCANG, MUNCANG, LEBAK, BANTEN",11,47,127,174
https://kawalpemilu.org#51972,"LEUWICOO, MUNCANG, LEBAK, BANTEN",1,102,107,209
https://kawalpemilu.org#51972,"LEUWICOO, MUNCANG, LEBAK, BANTEN",2,83,124,207
https://kawalpemilu.org#51972,"LEUWICOO, MUNCANG, LEBAK, BANTEN",3,64,125,189
https://kawalpemilu.org#51972,"LEUWICOO, MUNCANG, LEBAK, BANTEN",4,84,106,190
https://kawalpemilu.org#51972,"LEUWICOO, MUNCANG, LEBAK, BANTEN",5,74,130,204
https://kawalpemilu.org#51972,"LEUWICOO, MUNCANG, LEBAK, BANTEN",6,80,116,196
https://kawalpemilu.org#51972,"LEUWICOO, MUNCANG, LEBAK, BANTEN",7,77,119,196
https://kawalpemilu.org#51972,"LEUWICOO, MUNCANG, LEBAK, BANTEN",8,83,96,179
https://kawalpemilu.org#51972,"LEUWICOO, MUNCANG, LEBAK, BANTEN",9,46,27,73
https://kawalpemilu.org#51973,"SINDANGWANGI, MUNCANG, LEBAK, BANTEN",1,13,145,158
https://kawalpemilu.org#51973,"SINDANGWANGI, MUNCANG, LEBAK, BANTEN",2,13,138,151
https://kawalpemilu.org#51973,"SINDANGWANGI, MUNCANG, LEBAK, BANTEN",3,34,111,145
https://kawalpemilu.org#51973,"SINDANGWANGI, MUNCANG, LEBAK, BANTEN",4,29,133,162
https://kawalpemilu.org#51973,"SINDANGWANGI, MUNCANG, LEBAK, BANTEN",5,16,159,175
https://kawalpemilu.org#51973,"SINDANGWANGI, MUNCANG, LEBAK, BANTEN",6,21,149,170
https://kawalpemilu.org#51973,"SINDANGWANGI, MUNCANG, LEBAK, BANTEN",7,20,148,168
https://kawalpemilu.org#51973,"SINDANGWANGI, MUNCANG, LEBAK, BANTEN",8,26,95,121
https://kawalpemilu.org#51973,"SINDANGWANGI, MUNCANG, LEBAK, BANTEN",9,38,120,164
https://kawalpemilu.org#51974,"CIKARANG, MUNCANG, LEBAK, BANTEN",1,72,103,175
https://kawalpemilu.org#51974,"CIKARANG, MUNCANG, LEBAK, BANTEN",2,80,139,219
https://kawalpemilu.org#51974,"CIKARANG, MUNCANG, LEBAK, BANTEN",3,42,91,133
https://kawalpemilu.org#51974,"CIKARANG, MUNCANG, LEBAK, BANTEN",4,34,122,156
https://kawalpemilu.org#51974,"CIKARANG, MUNCANG, LEBAK, BANTEN",5,54,158,212
https://kawalpemilu.org#51974,"CIKARANG, MUNCANG, LEBAK, BANTEN",6,69,54,123
https://kawalpemilu.org#51974,"CIKARANG, MUNCANG, LEBAK, BANTEN",7,140,73,213
https://kawalpemilu.org#51974,"CIKARANG, MUNCANG, LEBAK, BANTEN",8,37,109,146
https://kawalpemilu.org#51974,"CIKARANG, MUNCANG, LEBAK, BANTEN",9,15,113,128
https://kawalpemilu.org#51974,"CIKARANG, MUNCANG, LEBAK, BANTEN",10,7,110,117
https://kawalpemilu.org#51974,"CIKARANG, MUNCANG, LEBAK, BANTEN",11,18,102,120
https://kawalpemilu.org#51975,"SUKANAGARA, MUNCANG, LEBAK, BANTEN",1,50,118,168
https://kawalpemilu.org#51975,"SUKANAGARA, MUNCANG, LEBAK, BANTEN",2,44,142,186
https://kawalpemilu.org#51975,"SUKANAGARA, MUNCANG, LEBAK, BANTEN",3,50,160,210
https://kawalpemilu.org#51975,"SUKANAGARA, MUNCANG, LEBAK, BANTEN",4,44,129,173
https://kawalpemilu.org#51975,"SUKANAGARA, MUNCANG, LEBAK, BANTEN",5,33,126,159
https://kawalpemilu.org#51975,"SUKANAGARA, MUNCANG, LEBAK, BANTEN",6,39,131,170
https://kawalpemilu.org#51975,"SUKANAGARA, MUNCANG, LEBAK, BANTEN",7,61,97,158
https://kawalpemilu.org#51975,"SUKANAGARA, MUNCANG, LEBAK, BANTEN",8,37,154,191
https://kawalpemilu.org#51975,"SUKANAGARA, MUNCANG, LEBAK, BANTEN",9,63,134,197
https://kawalpemilu.org#51975,"SUKANAGARA, MUNCANG, LEBAK, BANTEN",10,6,115,121
https://kawalpemilu.org#51975,"SUKANAGARA, MUNCANG, LEBAK, BANTEN",11,10,95,105
https://kawalpemilu.org#51976,"PASIRNANGKA, MUNCANG, LEBAK, BANTEN",1,73,121,194
https://kawalpemilu.org#51976,"PASIRNANGKA, MUNCANG, LEBAK, BANTEN",2,76,125,201
https://kawalpemilu.org#51976,"PASIRNANGKA, MUNCANG, LEBAK, BANTEN",3,38,86,124
https://kawalpemilu.org#51976,"PASIRNANGKA, MUNCANG, LEBAK, BANTEN",4,48,144,192
https://kawalpemilu.org#51976,"PASIRNANGKA, MUNCANG, LEBAK, BANTEN",5,55,136,191
https://kawalpemilu.org#51976,"PASIRNANGKA, MUNCANG, LEBAK, BANTEN",6,49,127,176
https://kawalpemilu.org#51976,"PASIRNANGKA, MUNCANG, LEBAK, BANTEN",7,75,83,158
https://kawalpemilu.org#51976,"PASIRNANGKA, MUNCANG, LEBAK, BANTEN",8,73,112,185
https://kawalpemilu.org#51976,"PASIRNANGKA, MUNCANG, LEBAK, BANTEN",9,51,126,177
https://kawalpemilu.org#51977,"JAGARAKSA, MUNCANG, LEBAK, BANTEN",1,119,78,197
https://kawalpemilu.org#51977,"JAGARAKSA, MUNCANG, LEBAK, BANTEN",2,116,91,207
https://kawalpemilu.org#51977,"JAGARAKSA, MUNCANG, LEBAK, BANTEN",3,95,100,195
https://kawalpemilu.org#51977,"JAGARAKSA, MUNCANG, LEBAK, BANTEN",4,103,115,218
https://kawalpemilu.org#51977,"JAGARAKSA, MUNCANG, LEBAK, BANTEN",5,110,87,197
https://kawalpemilu.org#51977,"JAGARAKSA, MUNCANG, LEBAK, BANTEN",6,93,81,174
https://kawalpemilu.org#51977,"JAGARAKSA, MUNCANG, LEBAK, BANTEN",7,66,98,164
https://kawalpemilu.org#51977,"JAGARAKSA, MUNCANG, LEBAK, BANTEN",8,118,94,212
https://kawalpemilu.org#51978,"TANJUNGWANGI, MUNCANG, LEBAK, BANTEN",1,55,118,173
https://kawalpemilu.org#51978,"TANJUNGWANGI, MUNCANG, LEBAK, BANTEN",2,41,124,165
https://kawalpemilu.org#51978,"TANJUNGWANGI, MUNCANG, LEBAK, BANTEN",3,37,133,170
https://kawalpemilu.org#51978,"TANJUNGWANGI, MUNCANG, LEBAK, BANTEN",4,42,179,221
https://kawalpemilu.org#51978,"TANJUNGWANGI, MUNCANG, LEBAK, BANTEN",5,36,172,208
https://kawalpemilu.org#51978,"TANJUNGWANGI, MUNCANG, LEBAK, BANTEN",6,24,192,216
https://kawalpemilu.org#51978,"TANJUNGWANGI, MUNCANG, LEBAK, BANTEN",7,15,160,175
https://kawalpemilu.org#51978,"TANJUNGWANGI, MUNCANG, LEBAK, BANTEN",8,37,143,180
https://kawalpemilu.org#51979,"MEKARWANGI, MUNCANG, LEBAK, BANTEN",1,25,130,155
https://kawalpemilu.org#51979,"MEKARWANGI, MUNCANG, LEBAK, BANTEN",2,20,144,164
https://kawalpemilu.org#51979,"MEKARWANGI, MUNCANG, LEBAK, BANTEN",3,31,138,169
https://kawalpemilu.org#51979,"MEKARWANGI, MUNCANG, LEBAK, BANTEN",4,63,87,150
https://kawalpemilu.org#51979,"MEKARWANGI, MUNCANG, LEBAK, BANTEN",5,47,83,130
https://kawalpemilu.org#51979,"MEKARWANGI, MUNCANG, LEBAK, BANTEN",6,33,66,99
https://kawalpemilu.org#51979,"MEKARWANGI, MUNCANG, LEBAK, BANTEN",7,26,86,112
https://kawalpemilu.org#51979,"MEKARWANGI, MUNCANG, LEBAK, BANTEN",8,20,95,115
https://kawalpemilu.org#51979,"MEKARWANGI, MUNCANG, LEBAK, BANTEN",9,48,149,197
https://kawalpemilu.org#51979,"MEKARWANGI, MUNCANG, LEBAK, BANTEN",10,39,107,146
https://kawalpemilu.org#51979,"MEKARWANGI, MUNCANG, LEBAK, BANTEN",11,49,82,131
https://kawalpemilu.org#51979,"MEKARWANGI, MUNCANG, LEBAK, BANTEN",12,33,130,163
https://kawalpemilu.org#51979,"MEKARWANGI, MUNCANG, LEBAK, BANTEN",13,18,106,124
https://kawalpemilu.org#51980,"GIRIJAGABAYA, MUNCANG, LEBAK, BANTEN",1,51,103,154
https://kawalpemilu.org#51980,"GIRIJAGABAYA, MUNCANG, LEBAK, BANTEN",2,44,86,130
https://kawalpemilu.org#51980,"GIRIJAGABAYA, MUNCANG, LEBAK, BANTEN",3,37,112,149
https://kawalpemilu.org#51980,"GIRIJAGABAYA, MUNCANG, LEBAK, BANTEN",4,28,117,145
https://kawalpemilu.org#51980,"GIRIJAGABAYA, MUNCANG, LEBAK, BANTEN",5,11,91,102
https://kawalpemilu.org#51980,"GIRIJAGABAYA, MUNCANG, LEBAK, BANTEN",6,26,144,170
https://kawalpemilu.org#51980,"GIRIJAGABAYA, MUNCANG, LEBAK, BANTEN",7,38,161,199
https://kawalpemilu.org#51980,"GIRIJAGABAYA, MUNCANG, LEBAK, BANTEN",8,37,115,152
https://kawalpemilu.org#51982,"KANEKES, LEUWIDAMAR, LEBAK, BANTEN",1,109,57,166
https://kawalpemilu.org#51982,"KANEKES, LEUWIDAMAR, LEBAK, BANTEN",2,122,41,163
https://kawalpemilu.org#51982,"KANEKES, LEUWIDAMAR, LEBAK, BANTEN",3,173,56,229
https://kawalpemilu.org#51982,"KANEKES, LEUWIDAMAR, LEBAK, BANTEN",4,113,24,137
https://kawalpemilu.org#51982,"KANEKES, LEUWIDAMAR, LEBAK, BANTEN",5,208,48,256
https://kawalpemilu.org#51982,"KANEKES, LEUWIDAMAR, LEBAK, BANTEN",6,155,26,181
https://kawalpemilu.org#51982,"KANEKES, LEUWIDAMAR, LEBAK, BANTEN",7,122,41,163
https://kawalpemilu.org#51982,"KANEKES, LEUWIDAMAR, LEBAK, BANTEN",8,168,49,217
https://kawalpemilu.org#51982,"KANEKES, LEUWIDAMAR, LEBAK, BANTEN",9,90,50,140
https://kawalpemilu.org#51982,"KANEKES, LEUWIDAMAR, LEBAK, BANTEN",10,150,55,205
https://kawalpemilu.org#51982,"KANEKES, LEUWIDAMAR, LEBAK, BANTEN",11,137,28,165
https://kawalpemilu.org#51982,"KANEKES, LEUWIDAMAR, LEBAK, BANTEN",12,105,25,130
https://kawalpemilu.org#51982,"KANEKES, LEUWIDAMAR, LEBAK, BANTEN",13,146,27,173
https://kawalpemilu.org#51982,"KANEKES, LEUWIDAMAR, LEBAK, BANTEN",14,108,56,166
https://kawalpemilu.org#51982,"KANEKES, LEUWIDAMAR, LEBAK, BANTEN",15,157,23,180
https://kawalpemilu.org#51982,"KANEKES, LEUWIDAMAR, LEBAK, BANTEN",16,138,36,174
https://kawalpemilu.org#51982,"KANEKES, LEUWIDAMAR, LEBAK, BANTEN",17,26,9,35
https://kawalpemilu.org#51982,"KANEKES, LEUWIDAMAR, LEBAK, BANTEN",18,44,92,136
https://kawalpemilu.org#51982,"KANEKES, LEUWIDAMAR, LEBAK, BANTEN",19,39,47,86
https://kawalpemilu.org#51982,"KANEKES, LEUWIDAMAR, LEBAK, BANTEN",20,38,41,79
https://kawalpemilu.org#51982,"KANEKES, LEUWIDAMAR, LEBAK, BANTEN",21,85,152,237
https://kawalpemilu.org#51982,"KANEKES, LEUWIDAMAR, LEBAK, BANTEN",22,109,91,200
https://kawalpemilu.org#51982,"KANEKES, LEUWIDAMAR, LEBAK, BANTEN",23,71,121,192
https://kawalpemilu.org#51982,"KANEKES, LEUWIDAMAR, LEBAK, BANTEN",24,69,122,191
https://kawalpemilu.org#51982,"KANEKES, LEUWIDAMAR, LEBAK, BANTEN",25,63,62,125
https://kawalpemilu.org#51982,"KANEKES, LEUWIDAMAR, LEBAK, BANTEN",26,175,85,261
https://kawalpemilu.org#51982,"KANEKES, LEUWIDAMAR, LEBAK, BANTEN",27,58,121,179
https://kawalpemilu.org#51983,"CISIMEUT, LEUWIDAMAR, LEBAK, BANTEN",1,41,119,160
https://kawalpemilu.org#51983,"CISIMEUT, LEUWIDAMAR, LEBAK, BANTEN",2,37,124,161
https://kawalpemilu.org#51983,"CISIMEUT, LEUWIDAMAR, LEBAK, BANTEN",3,37,135,172
https://kawalpemilu.org#51983,"CISIMEUT, LEUWIDAMAR, LEBAK, BANTEN",4,32,119,151
https://kawalpemilu.org#51983,"CISIMEUT, LEUWIDAMAR, LEBAK, BANTEN",5,38,176,214
https://kawalpemilu.org#51983,"CISIMEUT, LEUWIDAMAR, LEBAK, BANTEN",6,15,155,170
https://kawalpemilu.org#51983,"CISIMEUT, LEUWIDAMAR, LEBAK, BANTEN",7,61,117,178
https://kawalpemilu.org#51983,"CISIMEUT, LEUWIDAMAR, LEBAK, BANTEN",8,35,175,210
https://kawalpemilu.org#51983,"CISIMEUT, LEUWIDAMAR, LEBAK, BANTEN",9,33,116,149
https://kawalpemilu.org#51983,"CISIMEUT, LEUWIDAMAR, LEBAK, BANTEN",10,65,102,167
https://kawalpemilu.org#51983,"CISIMEUT, LEUWIDAMAR, LEBAK, BANTEN",11,26,152,178
https://kawalpemilu.org#51983,"CISIMEUT, LEUWIDAMAR, LEBAK, BANTEN",12,61,135,196
https://kawalpemilu.org#51983,"CISIMEUT, LEUWIDAMAR, LEBAK, BANTEN",13,43,137,180
https://kawalpemilu.org#51983,"CISIMEUT, LEUWIDAMAR, LEBAK, BANTEN",14,20,141,161
https://kawalpemilu.org#51983,"CISIMEUT, LEUWIDAMAR, LEBAK, BANTEN",15,55,152,207
https://kawalpemilu.org#51983,"CISIMEUT, LEUWIDAMAR, LEBAK, BANTEN",16,66,100,166
https://kawalpemilu.org#51983,"CISIMEUT, LEUWIDAMAR, LEBAK, BANTEN",17,38,130,168
https://kawalpemilu.org#51984,"CIBUNGUR, LEUWIDAMAR, LEBAK, BANTEN",1,48,148,196
https://kawalpemilu.org#51984,"CIBUNGUR, LEUWIDAMAR, LEBAK, BANTEN",2,44,152,196
https://kawalpemilu.org#51984,"CIBUNGUR, LEUWIDAMAR, LEBAK, BANTEN",3,38,129,167
https://kawalpemilu.org#51984,"CIBUNGUR, LEUWIDAMAR, LEBAK, BANTEN",4,54,82,136
https://kawalpemilu.org#51984,"CIBUNGUR, LEUWIDAMAR, LEBAK, BANTEN",5,104,119,223
https://kawalpemilu.org#51984,"CIBUNGUR, LEUWIDAMAR, LEBAK, BANTEN",6,87,110,197
https://kawalpemilu.org#51984,"CIBUNGUR, LEUWIDAMAR, LEBAK, BANTEN",7,87,110,197
https://kawalpemilu.org#51984,"CIBUNGUR, LEUWIDAMAR, LEBAK, BANTEN",8,26,128,154
https://kawalpemilu.org#51984,"CIBUNGUR, LEUWIDAMAR, LEBAK, BANTEN",9,79,99,178
https://kawalpemilu.org#51984,"CIBUNGUR, LEUWIDAMAR, LEBAK, BANTEN",10,48,79,127
https://kawalpemilu.org#51984,"CIBUNGUR, LEUWIDAMAR, LEBAK, BANTEN",11,59,113,172
https://kawalpemilu.org#51984,"CIBUNGUR, LEUWIDAMAR, LEBAK, BANTEN",12,137,129,166
https://kawalpemilu.org#51984,"CIBUNGUR, LEUWIDAMAR, LEBAK, BANTEN",13,33,154,187
https://kawalpemilu.org#51984,"CIBUNGUR, LEUWIDAMAR, LEBAK, BANTEN",14,71,124,195
https://kawalpemilu.org#51984,"CIBUNGUR, LEUWIDAMAR, LEBAK, BANTEN",15,40,102,142
https://kawalpemilu.org#51984,"CIBUNGUR, LEUWIDAMAR, LEBAK, BANTEN",16,45,80,125
https://kawalpemilu.org#51985,"LEUWIDAMAR, LEUWIDAMAR, LEBAK, BANTEN",1,63,127,190
https://kawalpemilu.org#51985,"LEUWIDAMAR, LEUWIDAMAR, LEBAK, BANTEN",2,45,80,125
https://kawalpemilu.org#51985,"LEUWIDAMAR, LEUWIDAMAR, LEBAK, BANTEN",3,47,128,175
https://kawalpemilu.org#51985,"LEUWIDAMAR, LEUWIDAMAR, LEBAK, BANTEN",4,90,109,199
https://kawalpemilu.org#51985,"LEUWIDAMAR, LEUWIDAMAR, LEBAK, BANTEN",5,110,86,196
https://kawalpemilu.org#51985,"LEUWIDAMAR, LEUWIDAMAR, LEBAK, BANTEN",6,72,129,201
https://kawalpemilu.org#51985,"LEUWIDAMAR, LEUWIDAMAR, LEBAK, BANTEN",7,70,61,131
https://kawalpemilu.org#51985,"LEUWIDAMAR, LEUWIDAMAR, LEBAK, BANTEN",8,43,79,122
https://kawalpemilu.org#51985,"LEUWIDAMAR, LEUWIDAMAR, LEBAK, BANTEN",9,75,84,159
https://kawalpemilu.org#51985,"LEUWIDAMAR, LEUWIDAMAR, LEBAK, BANTEN",10,63,92,155
https://kawalpemilu.org#51985,"LEUWIDAMAR, LEUWIDAMAR, LEBAK, BANTEN",11,60,171,231
https://kawalpemilu.org#51985,"LEUWIDAMAR, LEUWIDAMAR, LEBAK, BANTEN",12,78,113,191
https://kawalpemilu.org#51985,"LEUWIDAMAR, LEUWIDAMAR, LEBAK, BANTEN",13,89,102,191
https://kawalpemilu.org#51986,"LEBAKPARAHIANG, LEUWIDAMAR, LEBAK, BANTEN",1,70,120,190
https://kawalpemilu.org#51986,"LEBAKPARAHIANG, LEUWIDAMAR, LEBAK, BANTEN",2,63,116,179
https://kawalpemilu.org#51986,"LEBAKPARAHIANG, LEUWIDAMAR, LEBAK, BANTEN",3,62,137,199
https://kawalpemilu.org#51986,"LEBAKPARAHIANG, LEUWIDAMAR, LEBAK, BANTEN",4,62,143,205
https://kawalpemilu.org#51986,"LEBAKPARAHIANG, LEUWIDAMAR, LEBAK, BANTEN",5,71,160,231
https://kawalpemilu.org#51986,"LEBAKPARAHIANG, LEUWIDAMAR, LEBAK, BANTEN",6,57,112,169
https://kawalpemilu.org#51986,"LEBAKPARAHIANG, LEUWIDAMAR, LEBAK, BANTEN",7,79,90,169
https://kawalpemilu.org#51986,"LEBAKPARAHIANG, LEUWIDAMAR, LEBAK, BANTEN",8,102,101,203
https://kawalpemilu.org#51986,"LEBAKPARAHIANG, LEUWIDAMAR, LEBAK, BANTEN",9,91,80,171
https://kawalpemilu.org#51987,"SANGKANWANGI, LEUWIDAMAR, LEBAK, BANTEN",1,54,157,211
https://kawalpemilu.org#51987,"SANGKANWANGI, LEUWIDAMAR, LEBAK, BANTEN",2,43,163,206
https://kawalpemilu.org#51987,"SANGKANWANGI, LEUWIDAMAR, LEBAK, BANTEN",3,40,133,173
https://kawalpemilu.org#51987,"SANGKANWANGI, LEUWIDAMAR, LEBAK, BANTEN",4,33,141,174
https://kawalpemilu.org#51987,"SANGKANWANGI, LEUWIDAMAR, LEBAK, BANTEN",5,13,141,154
https://kawalpemilu.org#51987,"SANGKANWANGI, LEUWIDAMAR, LEBAK, BANTEN",6,33,124,157
https://kawalpemilu.org#51987,"SANGKANWANGI, LEUWIDAMAR, LEBAK, BANTEN",7,40,120,160
https://kawalpemilu.org#51987,"SANGKANWANGI, LEUWIDAMAR, LEBAK, BANTEN",8,25,122,147
https://kawalpemilu.org#51987,"SANGKANWANGI, LEUWIDAMAR, LEBAK, BANTEN",9,72,107,179
https://kawalpemilu.org#51987,"SANGKANWANGI, LEUWIDAMAR, LEBAK, BANTEN",10,52,106,158
https://kawalpemilu.org#51988,"NAYAGATI, LEUWIDAMAR, LEBAK, BANTEN",1,18,128,146
https://kawalpemilu.org#51988,"NAYAGATI, LEUWIDAMAR, LEBAK, BANTEN",2,31,112,143
https://kawalpemilu.org#51988,"NAYAGATI, LEUWIDAMAR, LEBAK, BANTEN",3,36,135,171
https://kawalpemilu.org#51988,"NAYAGATI, LEUWIDAMAR, LEBAK, BANTEN",4,40,106,146
https://kawalpemilu.org#51988,"NAYAGATI, LEUWIDAMAR, LEBAK, BANTEN",5,46,84,130
https://kawalpemilu.org#51988,"NAYAGATI, LEUWIDAMAR, LEBAK, BANTEN",6,52,91,143
https://kawalpemilu.org#51988,"NAYAGATI, LEUWIDAMAR, LEBAK, BANTEN",7,7,108,115
https://kawalpemilu.org#51988,"NAYAGATI, LEUWIDAMAR, LEBAK, BANTEN",8,8,108,116
https://kawalpemilu.org#51988,"NAYAGATI, LEUWIDAMAR, LEBAK, BANTEN",9,43,142,185
https://kawalpemilu.org#51988,"NAYAGATI, LEUWIDAMAR, LEBAK, BANTEN",10,91,83,174
https://kawalpemilu.org#51988,"NAYAGATI, LEUWIDAMAR, LEBAK, BANTEN",11,60,122,182
https://kawalpemilu.org#51988,"NAYAGATI, LEUWIDAMAR, LEBAK, BANTEN",12,73,86,159
https://kawalpemilu.org#51988,"NAYAGATI, LEUWIDAMAR, LEBAK, BANTEN",13,19,131,150
https://kawalpemilu.org#51988,"NAYAGATI, LEUWIDAMAR, LEBAK, BANTEN",14,13,147,160
https://kawalpemilu.org#51988,"NAYAGATI, LEUWIDAMAR, LEBAK, BANTEN",15,43,67,110
https://kawalpemilu.org#51988,"NAYAGATI, LEUWIDAMAR, LEBAK, BANTEN",16,36,76,112
https://kawalpemilu.org#51988,"NAYAGATI, LEUWIDAMAR, LEBAK, BANTEN",17,42,107,149
https://kawalpemilu.org#51988,"NAYAGATI, LEUWIDAMAR, LEBAK, BANTEN",18,78,53,131
https://kawalpemilu.org#51989,"BOJONGMENTENG, LEUWIDAMAR, LEBAK, BANTEN",1,64,151,215
https://kawalpemilu.org#51989,"BOJONGMENTENG, LEUWIDAMAR, LEBAK, BANTEN",2,65,152,217
https://kawalpemilu.org#51989,"BOJONGMENTENG, LEUWIDAMAR, LEBAK, BANTEN",3,60,108,168
https://kawalpemilu.org#51989,"BOJONGMENTENG, LEUWIDAMAR, LEBAK, BANTEN",4,25,82,107
https://kawalpemilu.org#51989,"BOJONGMENTENG, LEUWIDAMAR, LEBAK, BANTEN",5,34,112,146
https://kawalpemilu.org#51989,"BOJONGMENTENG, LEUWIDAMAR, LEBAK, BANTEN",6,78,92,170
https://kawalpemilu.org#51989,"BOJONGMENTENG, LEUWIDAMAR, LEBAK, BANTEN",7,61,105,166
https://kawalpemilu.org#51989,"BOJONGMENTENG, LEUWIDAMAR, LEBAK, BANTEN",8,53,98,151
https://kawalpemilu.org#51989,"BOJONGMENTENG, LEUWIDAMAR, LEBAK, BANTEN",9,47,102,149
https://kawalpemilu.org#51989,"BOJONGMENTENG, LEUWIDAMAR, LEBAK, BANTEN",10,36,109,145
https://kawalpemilu.org#51989,"BOJONGMENTENG, LEUWIDAMAR, LEBAK, BANTEN",11,78,108,186
https://kawalpemilu.org#51989,"BOJONGMENTENG, LEUWIDAMAR, LEBAK, BANTEN",12,43,140,183
https://kawalpemilu.org#51989,"BOJONGMENTENG, LEUWIDAMAR, LEBAK, BANTEN",13,38,132,170
https://kawalpemilu.org#51990,"MARGAWANGI, LEUWIDAMAR, LEBAK, BANTEN",1,64,123,187
https://kawalpemilu.org#51990,"MARGAWANGI, LEUWIDAMAR, LEBAK, BANTEN",2,48,162,210
https://kawalpemilu.org#51990,"MARGAWANGI, LEUWIDAMAR, LEBAK, BANTEN",3,20,179,199
https://kawalpemilu.org#51990,"MARGAWANGI, LEUWIDAMAR, LEBAK, BANTEN",4,36,156,192
https://kawalpemilu.org#51990,"MARGAWANGI, LEUWIDAMAR, LEBAK, BANTEN",5,35,158,193
https://kawalpemilu.org#51991,"WANTISARI, LEUWIDAMAR, LEBAK, BANTEN",1,59,153,202
https://kawalpemilu.org#51991,"WANTISARI, LEUWIDAMAR, LEBAK, BANTEN",2,55,126,181
https://kawalpemilu.org#51991,"WANTISARI, LEUWIDAMAR, LEBAK, BANTEN",3,61,171,232
https://kawalpemilu.org#51991,"WANTISARI, LEUWIDAMAR, LEBAK, BANTEN",4,42,163,205
https://kawalpemilu.org#51991,"WANTISARI, LEUWIDAMAR, LEBAK, BANTEN",5,53,152,205
https://kawalpemilu.org#51991,"WANTISARI, LEUWIDAMAR, LEBAK, BANTEN",6,58,137,195
https://kawalpemilu.org#51991,"WANTISARI, LEUWIDAMAR, LEBAK, BANTEN",7,67,168,235
https://kawalpemilu.org#51991,"WANTISARI, LEUWIDAMAR, LEBAK, BANTEN",8,91,136,227
https://kawalpemilu.org#51991,"WANTISARI, LEUWIDAMAR, LEBAK, BANTEN",9,78,116,194
https://kawalpemilu.org#51991,"WANTISARI, LEUWIDAMAR, LEBAK, BANTEN",10,101,82,183
https://kawalpemilu.org#51991,"WANTISARI, LEUWIDAMAR, LEBAK, BANTEN",11,109,69,178
https://kawalpemilu.org#51992,"JALUPANGMULYA, LEUWIDAMAR, LEBAK, BANTEN",1,54,181,235
https://kawalpemilu.org#51992,"JALUPANGMULYA, LEUWIDAMAR, LEBAK, BANTEN",2,39,168,207
https://kawalpemilu.org#51992,"JALUPANGMULYA, LEUWIDAMAR, LEBAK, BANTEN",3,42,172,214
https://kawalpemilu.org#51992,"JALUPANGMULYA, LEUWIDAMAR, LEBAK, BANTEN",4,15,172,187
https://kawalpemilu.org#51992,"JALUPANGMULYA, LEUWIDAMAR, LEBAK, BANTEN",5,39,99,138
https://kawalpemilu.org#51992,"JALUPANGMULYA, LEUWIDAMAR, LEBAK, BANTEN",6,18,119,137
https://kawalpemilu.org#51992,"JALUPANGMULYA, LEUWIDAMAR, LEBAK, BANTEN",7,27,157,184
https://kawalpemilu.org#51992,"JALUPANGMULYA, LEUWIDAMAR, LEBAK, BANTEN",8,46,173,219
https://kawalpemilu.org#51992,"JALUPANGMULYA, LEUWIDAMAR, LEBAK, BANTEN",9,34,157,191
https://kawalpemilu.org#51992,"JALUPANGMULYA, LEUWIDAMAR, LEBAK, BANTEN",10,18,157,175
https://kawalpemilu.org#51993,"CISIMEUT RAYA, LEUWIDAMAR, LEBAK, BANTEN",1,60,120,180
https://kawalpemilu.org#51993,"CISIMEUT RAYA, LEUWIDAMAR, LEBAK, BANTEN",2,53,93,146
https://kawalpemilu.org#51993,"CISIMEUT RAYA, LEUWIDAMAR, LEBAK, BANTEN",3,103,66,169
https://kawalpemilu.org#51993,"CISIMEUT RAYA, LEUWIDAMAR, LEBAK, BANTEN",4,94,97,191
https://kawalpemilu.org#51993,"CISIMEUT RAYA, LEUWIDAMAR, LEBAK, BANTEN",5,39,162,201
https://kawalpemilu.org#51993,"CISIMEUT RAYA, LEUWIDAMAR, LEBAK, BANTEN",6,59,153,212
https://kawalpemilu.org#51993,"CISIMEUT RAYA, LEUWIDAMAR, LEBAK, BANTEN",7,39,175,214
https://kawalpemilu.org#51993,"CISIMEUT RAYA, LEUWIDAMAR, LEBAK, BANTEN",8,49,130,179
https://kawalpemilu.org#51993,"CISIMEUT RAYA, LEUWIDAMAR, LEBAK, BANTEN",9,46,176,222
https://kawalpemilu.org#51993,"CISIMEUT RAYA, LEUWIDAMAR, LEBAK, BANTEN",10,31,153,184
https://kawalpemilu.org#51993,"CISIMEUT RAYA, LEUWIDAMAR, LEBAK, BANTEN",11,23,151,174
https://kawalpemilu.org#51993,"CISIMEUT RAYA, LEUWIDAMAR, LEBAK, BANTEN",12,68,96,164
https://kawalpemilu.org#51995,"BOJONGMANIK, BOJONGMANIK, LEBAK, BANTEN",1,76,137,213
https://kawalpemilu.org#51995,"BOJONGMANIK, BOJONGMANIK, LEBAK, BANTEN",2,45,159,204
https://kawalpemilu.org#51995,"BOJONGMANIK, BOJONGMANIK, LEBAK, BANTEN",3,93,96,189
https://kawalpemilu.org#51995,"BOJONGMANIK, BOJONGMANIK, LEBAK, BANTEN",4,85,85,170
https://kawalpemilu.org#51995,"BOJONGMANIK, BOJONGMANIK, LEBAK, BANTEN",5,55,132,187
https://kawalpemilu.org#51995,"BOJONGMANIK, BOJONGMANIK, LEBAK, BANTEN",6,41,117,158
https://kawalpemilu.org#51995,"BOJONGMANIK, BOJONGMANIK, LEBAK, BANTEN",7,49,139,188
https://kawalpemilu.org#51995,"BOJONGMANIK, BOJONGMANIK, LEBAK, BANTEN",8,48,157,205
https://kawalpemilu.org#51996,"HARJAWANA, BOJONGMANIK, LEBAK, BANTEN",1,109,117,226
https://kawalpemilu.org#51996,"HARJAWANA, BOJONGMANIK, LEBAK, BANTEN",2,58,142,200
https://kawalpemilu.org#51996,"HARJAWANA, BOJONGMANIK, LEBAK, BANTEN",3,160,131,291
https://kawalpemilu.org#51996,"HARJAWANA, BOJONGMANIK, LEBAK, BANTEN",4,39,143,182
https://kawalpemilu.org#51996,"HARJAWANA, BOJONGMANIK, LEBAK, BANTEN",5,112,83,195
https://kawalpemilu.org#51996,"HARJAWANA, BOJONGMANIK, LEBAK, BANTEN",6,69,125,194
https://kawalpemilu.org#51996,"HARJAWANA, BOJONGMANIK, LEBAK, BANTEN",7,42,158,200
https://kawalpemilu.org#51996,"HARJAWANA, BOJONGMANIK, LEBAK, BANTEN",8,107,88,195
https://kawalpemilu.org#51996,"HARJAWANA, BOJONGMANIK, LEBAK, BANTEN",9,54,104,158
https://kawalpemilu.org#51997,"KADURAHAYU, BOJONGMANIK, LEBAK, BANTEN",1,25,202,227
https://kawalpemilu.org#51997,"KADURAHAYU, BOJONGMANIK, LEBAK, BANTEN",2,54,181,235
https://kawalpemilu.org#51997,"KADURAHAYU, BOJONGMANIK, LEBAK, BANTEN",3,84,115,199
https://kawalpemilu.org#51997,"KADURAHAYU, BOJONGMANIK, LEBAK, BANTEN",4,64,176,240
https://kawalpemilu.org#51997,"KADURAHAYU, BOJONGMANIK, LEBAK, BANTEN",5,36,118,154
https://kawalpemilu.org#51998,"CIMAYANG, BOJONGMANIK, LEBAK, BANTEN",1,44,150,194
https://kawalpemilu.org#51998,"CIMAYANG, BOJONGMANIK, LEBAK, BANTEN",2,46,173,219
https://kawalpemilu.org#51998,"CIMAYANG, BOJONGMANIK, LEBAK, BANTEN",3,44,159,203
https://kawalpemilu.org#51998,"CIMAYANG, BOJONGMANIK, LEBAK, BANTEN",4,65,114,179
https://kawalpemilu.org#51998,"CIMAYANG, BOJONGMANIK, LEBAK, BANTEN",5,56,141,197
https://kawalpemilu.org#51998,"CIMAYANG, BOJONGMANIK, LEBAK, BANTEN",6,29,159,188
https://kawalpemilu.org#51998,"CIMAYANG, BOJONGMANIK, LEBAK, BANTEN",7,31,132,163
https://kawalpemilu.org#51998,"CIMAYANG, BOJONGMANIK, LEBAK, BANTEN",8,26,138,164
https://kawalpemilu.org#51998,"CIMAYANG, BOJONGMANIK, LEBAK, BANTEN",9,44,65,109
https://kawalpemilu.org#51999,"PARAKANBEUSI, BOJONGMANIK, LEBAK, BANTEN",1,36,134,170
https://kawalpemilu.org#51999,"PARAKANBEUSI, BOJONGMANIK, LEBAK, BANTEN",2,51,150,201
https://kawalpemilu.org#51999,"PARAKANBEUSI, BOJONGMANIK, LEBAK, BANTEN",3,78,100,178
https://kawalpemilu.org#51999,"PARAKANBEUSI, BOJONGMANIK, LEBAK, BANTEN",4,61,166,227
https://kawalpemilu.org#51999,"PARAKANBEUSI, BOJONGMANIK, LEBAK, BANTEN",5,76,143,219
https://kawalpemilu.org#51999,"PARAKANBEUSI, BOJONGMANIK, LEBAK, BANTEN",6,78,102,180
https://kawalpemilu.org#51999,"PARAKANBEUSI, BOJONGMANIK, LEBAK, BANTEN",7,112,91,203
https://kawalpemilu.org#51999,"PARAKANBEUSI, BOJONGMANIK, LEBAK, BANTEN",8,29,168,197
https://kawalpemilu.org#51999,"PARAKANBEUSI, BOJONGMANIK, LEBAK, BANTEN",9,59,150,209
https://kawalpemilu.org#51999,"PARAKANBEUSI, BOJONGMANIK, LEBAK, BANTEN",10,68,59,127
https://kawalpemilu.org#51999,"PARAKANBEUSI, BOJONGMANIK, LEBAK, BANTEN",11,74,124,198
https://kawalpemilu.org#51999,"PARAKANBEUSI, BOJONGMANIK, LEBAK, BANTEN",12,47,57,104
https://kawalpemilu.org#51999,"PARAKANBEUSI, BOJONGMANIK, LEBAK, BANTEN",13,86,88,174
https://kawalpemilu.org#52000,"KEBONCAU, BOJONGMANIK, LEBAK, BANTEN",1,61,127,188
https://kawalpemilu.org#52000,"KEBONCAU, BOJONGMANIK, LEBAK, BANTEN",2,148,68,216
https://kawalpemilu.org#52000,"KEBONCAU, BOJONGMANIK, LEBAK, BANTEN",3,33,177,210
https://kawalpemilu.org#52000,"KEBONCAU, BOJONGMANIK, LEBAK, BANTEN",4,158,62,220
https://kawalpemilu.org#52000,"KEBONCAU, BOJONGMANIK, LEBAK, BANTEN",5,58,105,163
https://kawalpemilu.org#52000,"KEBONCAU, BOJONGMANIK, LEBAK, BANTEN",6,90,133,223
https://kawalpemilu.org#52000,"KEBONCAU, BOJONGMANIK, LEBAK, BANTEN",7,93,118,211
https://kawalpemilu.org#52000,"KEBONCAU, BOJONGMANIK, LEBAK, BANTEN",8,96,104,200
https://kawalpemilu.org#52001,"MEKARMANIK, BOJONGMANIK, LEBAK, BANTEN",1,66,126,192
https://kawalpemilu.org#52001,"MEKARMANIK, BOJONGMANIK, LEBAK, BANTEN",2,71,69,140
https://kawalpemilu.org#52001,"MEKARMANIK, BOJONGMANIK, LEBAK, BANTEN",3,117,92,209
https://kawalpemilu.org#52001,"MEKARMANIK, BOJONGMANIK, LEBAK, BANTEN",4,89,120,209
https://kawalpemilu.org#52001,"MEKARMANIK, BOJONGMANIK, LEBAK, BANTEN",5,156,66,222
https://kawalpemilu.org#52001,"MEKARMANIK, BOJONGMANIK, LEBAK, BANTEN",6,103,68,171
https://kawalpemilu.org#52001,"MEKARMANIK, BOJONGMANIK, LEBAK, BANTEN",7,121,39,160
https://kawalpemilu.org#52001,"MEKARMANIK, BOJONGMANIK, LEBAK, BANTEN",8,29,102,131
https://kawalpemilu.org#52002,"MEKAR RAHAYU, BOJONGMANIK, LEBAK, BANTEN",1,44,150,194
https://kawalpemilu.org#52002,"MEKAR RAHAYU, BOJONGMANIK, LEBAK, BANTEN",2,69,134,203
https://kawalpemilu.org#52002,"MEKAR RAHAYU, BOJONGMANIK, LEBAK, BANTEN",3,49,137,186
https://kawalpemilu.org#52002,"MEKAR RAHAYU, BOJONGMANIK, LEBAK, BANTEN",4,47,119,166
https://kawalpemilu.org#52002,"MEKAR RAHAYU, BOJONGMANIK, LEBAK, BANTEN",5,57,96,153
https://kawalpemilu.org#52003,"PASIRBITUNG, BOJONGMANIK, LEBAK, BANTEN",1,96,155,251
https://kawalpemilu.org#52003,"PASIRBITUNG, BOJONGMANIK, LEBAK, BANTEN",2,77,89,166
https://kawalpemilu.org#52003,"PASIRBITUNG, BOJONGMANIK, LEBAK, BANTEN",3,71,91,162
https://kawalpemilu.org#52003,"PASIRBITUNG, BOJONGMANIK, LEBAK, BANTEN",4,86,80,166
https://kawalpemilu.org#52005,"GUNUNGKENCANA, GUNUNGKENCANA, LEBAK, BANTEN",1,59,64,123
https://kawalpemilu.org#52005,"GUNUNGKENCANA, GUNUNGKENCANA, LEBAK, BANTEN",2,47,159,206
https://kawalpemilu.org#52005,"GUNUNGKENCANA, GUNUNGKENCANA, LEBAK, BANTEN",3,77,172,249
https://kawalpemilu.org#52005,"GUNUNGKENCANA, GUNUNGKENCANA, LEBAK, BANTEN",4,66,181,247
https://kawalpemilu.org#52005,"GUNUNGKENCANA, GUNUNGKENCANA, LEBAK, BANTEN",5,31,81,112
https://kawalpemilu.org#52005,"GUNUNGKENCANA, GUNUNGKENCANA, LEBAK, BANTEN",6,78,100,178
https://kawalpemilu.org#52005,"GUNUNGKENCANA, GUNUNGKENCANA, LEBAK, BANTEN",7,42,171,213
https://kawalpemilu.org#52005,"GUNUNGKENCANA, GUNUNGKENCANA, LEBAK, BANTEN",8,67,142,209
https://kawalpemilu.org#52005,"GUNUNGKENCANA, GUNUNGKENCANA, LEBAK, BANTEN",9,59,174,233
https://kawalpemilu.org#52005,"GUNUNGKENCANA, GUNUNGKENCANA, LEBAK, BANTEN",10,61,182,243
https://kawalpemilu.org#52006,"CIMANYANGRAY, GUNUNGKENCANA, LEBAK, BANTEN",1,19,156,175
https://kawalpemilu.org#52006,"CIMANYANGRAY, GUNUNGKENCANA, LEBAK, BANTEN",2,30,148,178
https://kawalpemilu.org#52006,"CIMANYANGRAY, GUNUNGKENCANA, LEBAK, BANTEN",3,51,138,189
https://kawalpemilu.org#52006,"CIMANYANGRAY, GUNUNGKENCANA, LEBAK, BANTEN",4,5,207,212
https://kawalpemilu.org#52006,"CIMANYANGRAY, GUNUNGKENCANA, LEBAK, BANTEN",5,47,140,187
https://kawalpemilu.org#52006,"CIMANYANGRAY, GUNUNGKENCANA, LEBAK, BANTEN",6,45,159,204
https://kawalpemilu.org#52006,"CIMANYANGRAY, GUNUNGKENCANA, LEBAK, BANTEN",7,25,167,192
https://kawalpemilu.org#52006,"CIMANYANGRAY, GUNUNGKENCANA, LEBAK, BANTEN",8,36,148,184
https://kawalpemilu.org#52007,"GUNUNGKENDENG, GUNUNGKENCANA, LEBAK, BANTEN",1,30,142,172
https://kawalpemilu.org#52007,"GUNUNGKENDENG, GUNUNGKENCANA, LEBAK, BANTEN",2,64,89,153
https://kawalpemilu.org#52007,"GUNUNGKENDENG, GUNUNGKENCANA, LEBAK, BANTEN",3,46,87,133
https://kawalpemilu.org#52007,"GUNUNGKENDENG, GUNUNGKENCANA, LEBAK, BANTEN",4,108,46,156
https://kawalpemilu.org#52007,"GUNUNGKENDENG, GUNUNGKENCANA, LEBAK, BANTEN",5,55,112,167
https://kawalpemilu.org#52007,"GUNUNGKENDENG, GUNUNGKENCANA, LEBAK, BANTEN",6,47,78,125
https://kawalpemilu.org#52007,"GUNUNGKENDENG, GUNUNGKENCANA, LEBAK, BANTEN",7,64,87,151
https://kawalpemilu.org#52007,"GUNUNGKENDENG, GUNUNGKENCANA, LEBAK, BANTEN",8,50,70,120
https://kawalpemilu.org#52007,"GUNUNGKENDENG, GUNUNGKENCANA, LEBAK, BANTEN",9,73,41,114
https://kawalpemilu.org#52008,"CISAMPANG, GUNUNGKENCANA, LEBAK, BANTEN",1,74,57,131
https://kawalpemilu.org#52008,"CISAMPANG, GUNUNGKENCANA, LEBAK, BANTEN",2,19,113,132
https://kawalpemilu.org#52008,"CISAMPANG, GUNUNGKENCANA, LEBAK, BANTEN",3,54,118,172
https://kawalpemilu.org#52008,"CISAMPANG, GUNUNGKENCANA, LEBAK, BANTEN",4,50,156,206
https://kawalpemilu.org#52008,"CISAMPANG, GUNUNGKENCANA, LEBAK, BANTEN",5,69,67,136
https://kawalpemilu.org#52008,"CISAMPANG, GUNUNGKENCANA, LEBAK, BANTEN",6,20,68,88
https://kawalpemilu.org#52008,"CISAMPANG, GUNUNGKENCANA, LEBAK, BANTEN",7,71,88,159
https://kawalpemilu.org#52008,"CISAMPANG, GUNUNGKENCANA, LEBAK, BANTEN",8,34,83,117
https://kawalpemilu.org#52008,"CISAMPANG, GUNUNGKENCANA, LEBAK, BANTEN",9,64,145,209
https://kawalpemilu.org#52009,"CIGINGGANG, GUNUNGKENCANA, LEBAK, BANTEN",1,11,205,216
https://kawalpemilu.org#52009,"CIGINGGANG, GUNUNGKENCANA, LEBAK, BANTEN",2,58,48,106
https://kawalpemilu.org#52009,"CIGINGGANG, GUNUNGKENCANA, LEBAK, BANTEN",3,39,120,159
https://kawalpemilu.org#52009,"CIGINGGANG, GUNUNGKENCANA, LEBAK, BANTEN",4,78,106,184
https://kawalpemilu.org#52009,"CIGINGGANG, GUNUNGKENCANA, LEBAK, BANTEN",5,36,166,202
https://kawalpemilu.org#52009,"CIGINGGANG, GUNUNGKENCANA, LEBAK, BANTEN",6,53,70,123
https://kawalpemilu.org#52009,"CIGINGGANG, GUNUNGKENCANA, LEBAK, BANTEN",7,17,176,193
https://kawalpemilu.org#52009,"CIGINGGANG, GUNUNGKENCANA, LEBAK, BANTEN",8,59,99,158
https://kawalpemilu.org#52009,"CIGINGGANG, GUNUNGKENCANA, LEBAK, BANTEN",9,63,49,112
https://kawalpemilu.org#52009,"CIGINGGANG, GUNUNGKENCANA, LEBAK, BANTEN",10,31,124,155
https://kawalpemilu.org#52009,"CIGINGGANG, GUNUNGKENCANA, LEBAK, BANTEN",11,21,144,165
https://kawalpemilu.org#52009,"CIGINGGANG, GUNUNGKENCANA, LEBAK, BANTEN",12,46,94,140
https://kawalpemilu.org#52009,"CIGINGGANG, GUNUNGKENCANA, LEBAK, BANTEN",13,18,108,126
https://kawalpemilu.org#52009,"CIGINGGANG, GUNUNGKENCANA, LEBAK, BANTEN",14,24,158,182
https://kawalpemilu.org#52009,"CIGINGGANG, GUNUNGKENCANA, LEBAK, BANTEN",15,32,164,196
https://kawalpemilu.org#52010,"CIAKAR, GUNUNGKENCANA, LEBAK, BANTEN",1,13,108,121
https://kawalpemilu.org#52010,"CIAKAR, GUNUNGKENCANA, LEBAK, BANTEN",2,22,129,151
https://kawalpemilu.org#52010,"CIAKAR, GUNUNGKENCANA, LEBAK, BANTEN",3,55,152,207
https://kawalpemilu.org#52010,"CIAKAR, GUNUNGKENCANA, LEBAK, BANTEN",4,27,156,183
https://kawalpemilu.org#52010,"CIAKAR, GUNUNGKENCANA, LEBAK, BANTEN",5,31,172,203
https://kawalpemilu.org#52010,"CIAKAR, GUNUNGKENCANA, LEBAK, BANTEN",6,13,117,130
https://kawalpemilu.org#52010,"CIAKAR, GUNUNGKENCANA, LEBAK, BANTEN",7,44,113,157
https://kawalpemilu.org#52010,"CIAKAR, GUNUNGKENCANA, LEBAK, BANTEN",8,70,119,189
https://kawalpemilu.org#52010,"CIAKAR, GUNUNGKENCANA, LEBAK, BANTEN",9,30,86,116
https://kawalpemilu.org#52010,"CIAKAR, GUNUNGKENCANA, LEBAK, BANTEN",10,74,91,165
https://kawalpemilu.org#52010,"CIAKAR, GUNUNGKENCANA, LEBAK, BANTEN",11,9,64,73
https://kawalpemilu.org#52011,"CICARINGIN, GUNUNGKENCANA, LEBAK, BANTEN",1,33,155,188
https://kawalpemilu.org#52011,"CICARINGIN, GUNUNGKENCANA, LEBAK, BANTEN",2,62,115,177
https://kawalpemilu.org#52011,"CICARINGIN, GUNUNGKENCANA, LEBAK, BANTEN",3,45,145,190
https://kawalpemilu.org#52011,"CICARINGIN, GUNUNGKENCANA, LEBAK, BANTEN",4,44,172,216
https://kawalpemilu.org#52011,"CICARINGIN, GUNUNGKENCANA, LEBAK, BANTEN",5,72,99,171
https://kawalpemilu.org#52011,"CICARINGIN, GUNUNGKENCANA, LEBAK, BANTEN",6,20,145,165
https://kawalpemilu.org#52011,"CICARINGIN, GUNUNGKENCANA, LEBAK, BANTEN",7,36,148,184
https://kawalpemilu.org#52011,"CICARINGIN, GUNUNGKENCANA, LEBAK, BANTEN",8,12,79,91
https://kawalpemilu.org#52011,"CICARINGIN, GUNUNGKENCANA, LEBAK, BANTEN",9,34,172,206
https://kawalpemilu.org#52011,"CICARINGIN, GUNUNGKENCANA, LEBAK, BANTEN",10,48,151,199
https://kawalpemilu.org#52012,"BULAKAN, GUNUNGKENCANA, LEBAK, BANTEN",1,217,49,266
https://kawalpemilu.org#52012,"BULAKAN, GUNUNGKENCANA, LEBAK, BANTEN",2,198,10,208
https://kawalpemilu.org#52012,"BULAKAN, GUNUNGKENCANA, LEBAK, BANTEN",3,199,41,240
https://kawalpemilu.org#52012,"BULAKAN, GUNUNGKENCANA, LEBAK, BANTEN",4,138,16,154
https://kawalpemilu.org#52012,"BULAKAN, GUNUNGKENCANA, LEBAK, BANTEN",5,153,30,183
https://kawalpemilu.org#52012,"BULAKAN, GUNUNGKENCANA, LEBAK, BANTEN",6,112,26,138
https://kawalpemilu.org#52012,"BULAKAN, GUNUNGKENCANA, LEBAK, BANTEN",7,149,17,166
https://kawalpemilu.org#52012,"BULAKAN, GUNUNGKENCANA, LEBAK, BANTEN",8,236,31,267
https://kawalpemilu.org#52012,"BULAKAN, GUNUNGKENCANA, LEBAK, BANTEN",9,245,42,287
https://kawalpemilu.org#52012,"BULAKAN, GUNUNGKENCANA, LEBAK, BANTEN",10,129,80,209
https://kawalpemilu.org#52013,"SUKANEGARA, GUNUNGKENCANA, LEBAK, BANTEN",1,54,140,194
https://kawalpemilu.org#52013,"SUKANEGARA, GUNUNGKENCANA, LEBAK, BANTEN",2,110,117,227
https://kawalpemilu.org#52013,"SUKANEGARA, GUNUNGKENCANA, LEBAK, BANTEN",3,47,165,212
https://kawalpemilu.org#52013,"SUKANEGARA, GUNUNGKENCANA, LEBAK, BANTEN",4,29,97,126
https://kawalpemilu.org#52013,"SUKANEGARA, GUNUNGKENCANA, LEBAK, BANTEN",5,41,86,127
https://kawalpemilu.org#52013,"SUKANEGARA, GUNUNGKENCANA, LEBAK, BANTEN",6,70,150,220
https://kawalpemilu.org#52013,"SUKANEGARA, GUNUNGKENCANA, LEBAK, BANTEN",7,27,97,124
https://kawalpemilu.org#52013,"SUKANEGARA, GUNUNGKENCANA, LEBAK, BANTEN",8,11,113,124
https://kawalpemilu.org#52013,"SUKANEGARA, GUNUNGKENCANA, LEBAK, BANTEN",9,18,98,116
https://kawalpemilu.org#52014,"BOJONGKONENG, GUNUNGKENCANA, LEBAK, BANTEN",1,52,134,186
https://kawalpemilu.org#52014,"BOJONGKONENG, GUNUNGKENCANA, LEBAK, BANTEN",2,85,102,187
https://kawalpemilu.org#52014,"BOJONGKONENG, GUNUNGKENCANA, LEBAK, BANTEN",3,39,151,190
https://kawalpemilu.org#52014,"BOJONGKONENG, GUNUNGKENCANA, LEBAK, BANTEN",4,20,139,159
https://kawalpemilu.org#52014,"BOJONGKONENG, GUNUNGKENCANA, LEBAK, BANTEN",5,56,118,174
https://kawalpemilu.org#52014,"BOJONGKONENG, GUNUNGKENCANA, LEBAK, BANTEN",6,31,142,173
https://kawalpemilu.org#52014,"BOJONGKONENG, GUNUNGKENCANA, LEBAK, BANTEN",7,12,98,110
https://kawalpemilu.org#52015,"KRAMATJAYA, GUNUNGKENCANA, LEBAK, BANTEN",1,43,142,185
https://kawalpemilu.org#52015,"KRAMATJAYA, GUNUNGKENCANA, LEBAK, BANTEN",2,46,158,204
https://kawalpemilu.org#52015,"KRAMATJAYA, GUNUNGKENCANA, LEBAK, BANTEN",3,50,172,222
https://kawalpemilu.org#52015,"KRAMATJAYA, GUNUNGKENCANA, LEBAK, BANTEN",4,26,144,170
https://kawalpemilu.org#52015,"KRAMATJAYA, GUNUNGKENCANA, LEBAK, BANTEN",5,39,125,164
https://kawalpemilu.org#52015,"KRAMATJAYA, GUNUNGKENCANA, LEBAK, BANTEN",6,22,144,166
https://kawalpemilu.org#52015,"KRAMATJAYA, GUNUNGKENCANA, LEBAK, BANTEN",7,10,93,103
https://kawalpemilu.org#52015,"KRAMATJAYA, GUNUNGKENCANA, LEBAK, BANTEN",8,47,159,206
https://kawalpemilu.org#52015,"KRAMATJAYA, GUNUNGKENCANA, LEBAK, BANTEN",9,100,120,220
https://kawalpemilu.org#52015,"KRAMATJAYA, GUNUNGKENCANA, LEBAK, BANTEN",10,22,148,170
https://kawalpemilu.org#52015,"KRAMATJAYA, GUNUNGKENCANA, LEBAK, BANTEN",11,43,122,165
https://kawalpemilu.org#52015,"KRAMATJAYA, GUNUNGKENCANA, LEBAK, BANTEN",12,23,139,162
https://kawalpemilu.org#52016,"TANJUNGSARI INDAH, GUNUNGKENCANA, LEBAK, BANTEN",1,89,126,215
https://kawalpemilu.org#52016,"TANJUNGSARI INDAH, GUNUNGKENCANA, LEBAK, BANTEN",2,164,57,221
https://kawalpemilu.org#52016,"TANJUNGSARI INDAH, GUNUNGKENCANA, LEBAK, BANTEN",3,126,118,244
https://kawalpemilu.org#52016,"TANJUNGSARI INDAH, GUNUNGKENCANA, LEBAK, BANTEN",4,106,119,225
https://kawalpemilu.org#52016,"TANJUNGSARI INDAH, GUNUNGKENCANA, LEBAK, BANTEN",5,109,118,227
https://kawalpemilu.org#52016,"TANJUNGSARI INDAH, GUNUNGKENCANA, LEBAK, BANTEN",6,119,99,218
https://kawalpemilu.org#52018,"KERTA, BANJARSARI, LEBAK, BANTEN",1,19,124,143
https://kawalpemilu.org#52018,"KERTA, BANJARSARI, LEBAK, BANTEN",2,124,82,206
https://kawalpemilu.org#52018,"KERTA, BANJARSARI, LEBAK, BANTEN",3,34,141,175
https://kawalpemilu.org#52018,"KERTA, BANJARSARI, LEBAK, BANTEN",4,87,157,244
https://kawalpemilu.org#52018,"KERTA, BANJARSARI, LEBAK, BANTEN",5,99,134,233
https://kawalpemilu.org#52018,"KERTA, BANJARSARI, LEBAK, BANTEN",6,55,172,227
https://kawalpemilu.org#52018,"KERTA, BANJARSARI, LEBAK, BANTEN",7,92,110,202
https://kawalpemilu.org#52018,"KERTA, BANJARSARI, LEBAK, BANTEN",8,43,110,153
https://kawalpemilu.org#52018,"KERTA, BANJARSARI, LEBAK, BANTEN",9,128,93,221
https://kawalpemilu.org#52018,"KERTA, BANJARSARI, LEBAK, BANTEN",10,114,119,233
https://kawalpemilu.org#52019,"BOJONGJURUH, BANJARSARI, LEBAK, BANTEN",1,72,148,220
https://kawalpemilu.org#52019,"BOJONGJURUH, BANJARSARI, LEBAK, BANTEN",2,115,71,186
https://kawalpemilu.org#52019,"BOJONGJURUH, BANJARSARI, LEBAK, BANTEN",3,48,155,203
https://kawalpemilu.org#52019,"BOJONGJURUH, BANJARSARI, LEBAK, BANTEN",4,49,176,225
https://kawalpemilu.org#52019,"BOJONGJURUH, BANJARSARI, LEBAK, BANTEN",5,67,116,183
https://kawalpemilu.org#52019,"BOJONGJURUH, BANJARSARI, LEBAK, BANTEN",6,56,172,228
https://kawalpemilu.org#52020,"LEUWIIPUH, BANJARSARI, LEBAK, BANTEN",1,70,171,241
https://kawalpemilu.org#52020,"LEUWIIPUH, BANJARSARI, LEBAK, BANTEN",2,40,195,235
https://kawalpemilu.org#52020,"LEUWIIPUH, BANJARSARI, LEBAK, BANTEN",3,152,77,229
https://kawalpemilu.org#52020,"LEUWIIPUH, BANJARSARI, LEBAK, BANTEN",4,40,179,219
https://kawalpemilu.org#52020,"LEUWIIPUH, BANJARSARI, LEBAK, BANTEN",5,34,208,242
https://kawalpemilu.org#52020,"LEUWIIPUH, BANJARSARI, LEBAK, BANTEN",6,61,132,193
https://kawalpemilu.org#52020,"LEUWIIPUH, BANJARSARI, LEBAK, BANTEN",7,79,106,185
https://kawalpemilu.org#52020,"LEUWIIPUH, BANJARSARI, LEBAK, BANTEN",8,75,46,121
https://kawalpemilu.org#52020,"LEUWIIPUH, BANJARSARI, LEBAK, BANTEN",9,54,97,151
https://kawalpemilu.org#52021,"LEBAKKEUSIK, BANJARSARI, LEBAK, BANTEN",1,105,84,189
https://kawalpemilu.org#52021,"LEBAKKEUSIK, BANJARSARI, LEBAK, BANTEN",2,117,92,209
https://kawalpemilu.org#52021,"LEBAKKEUSIK, BANJARSARI, LEBAK, BANTEN",3,105,94,199
https://kawalpemilu.org#52021,"LEBAKKEUSIK, BANJARSARI, LEBAK, BANTEN",4,51,83,134
https://kawalpemilu.org#52021,"LEBAKKEUSIK, BANJARSARI, LEBAK, BANTEN",5,93,110,203
https://kawalpemilu.org#52021,"LEBAKKEUSIK, BANJARSARI, LEBAK, BANTEN",6,121,89,210
https://kawalpemilu.org#52021,"LEBAKKEUSIK, BANJARSARI, LEBAK, BANTEN",7,51,99,150
https://kawalpemilu.org#52022,"cilegongilir, BANJARSARI, LEBAK, BANTEN",1,63,110,173
https://kawalpemilu.org#52022,"cilegongilir, BANJARSARI, LEBAK, BANTEN",2,61,120,181
https://kawalpemilu.org#52022,"cilegongilir, BANJARSARI, LEBAK, BANTEN",3,100,107,207
https://kawalpemilu.org#52022,"cilegongilir, BANJARSARI, LEBAK, BANTEN",4,107,106,213
https://kawalpemilu.org#52022,"cilegongilir, BANJARSARI, LEBAK, BANTEN",5,122,102,224
https://kawalpemilu.org#52022,"cilegongilir, BANJARSARI, LEBAK, BANTEN",6,78,103,181
https://kawalpemilu.org#52022,"cilegongilir, BANJARSARI, LEBAK, BANTEN",7,58,133,191
https://kawalpemilu.org#52022,"cilegongilir, BANJARSARI, LEBAK, BANTEN",8,65,129,194
https://kawalpemilu.org#52022,"cilegongilir, BANJARSARI, LEBAK, BANTEN",9,58,160,218
https://kawalpemilu.org#52022,"cilegongilir, BANJARSARI, LEBAK, BANTEN",10,19,205,224
https://kawalpemilu.org#52022,"cilegongilir, BANJARSARI, LEBAK, BANTEN",11,64,122,186
https://kawalpemilu.org#52023,"KEUSIK, BANJARSARI, LEBAK, BANTEN",1,79,118,197
https://kawalpemilu.org#52023,"KEUSIK, BANJARSARI, LEBAK, BANTEN",2,42,123,165
https://kawalpemilu.org#52023,"KEUSIK, BANJARSARI, LEBAK, BANTEN",3,44,136,180
https://kawalpemilu.org#52023,"KEUSIK, BANJARSARI, LEBAK, BANTEN",4,57,131,188
https://kawalpemilu.org#52023,"KEUSIK, BANJARSARI, LEBAK, BANTEN",5,53,113,166
https://kawalpemilu.org#52023,"KEUSIK, BANJARSARI, LEBAK, BANTEN",6,41,154,195
https://kawalpemilu.org#52023,"KEUSIK, BANJARSARI, LEBAK, BANTEN",7,57,106,163
https://kawalpemilu.org#52023,"KEUSIK, BANJARSARI, LEBAK, BANTEN",8,54,99,153
https://kawalpemilu.org#52023,"KEUSIK, BANJARSARI, LEBAK, BANTEN",9,31,109,140
https://kawalpemilu.org#52023,"KEUSIK, BANJARSARI, LEBAK, BANTEN",10,71,77,148
https://kawalpemilu.org#52023,"KEUSIK, BANJARSARI, LEBAK, BANTEN",11,85,93,178
https://kawalpemilu.org#52023,"KEUSIK, BANJARSARI, LEBAK, BANTEN",12,62,144,206
https://kawalpemilu.org#52023,"KEUSIK, BANJARSARI, LEBAK, BANTEN",13,38,132,170
https://kawalpemilu.org#52024,"CIBATURKEUSIK, BANJARSARI, LEBAK, BANTEN",1,93,99,192
https://kawalpemilu.org#52024,"CIBATURKEUSIK, BANJARSARI, LEBAK, BANTEN",2,63,145,208
https://kawalpemilu.org#52024,"CIBATURKEUSIK, BANJARSARI, LEBAK, BANTEN",3,51,150,201
https://kawalpemilu.org#52024,"CIBATURKEUSIK, BANJARSARI, LEBAK, BANTEN",4,35,117,152
https://kawalpemilu.org#52024,"CIBATURKEUSIK, BANJARSARI, LEBAK, BANTEN",5,19,89,108
https://kawalpemilu.org#52024,"CIBATURKEUSIK, BANJARSARI, LEBAK, BANTEN",6,45,152,197
https://kawalpemilu.org#52024,"CIBATURKEUSIK, BANJARSARI, LEBAK, BANTEN",7,76,148,224
https://kawalpemilu.org#52025,"KUMPAY, BANJARSARI, LEBAK, BANTEN",1,38,173,211
https://kawalpemilu.org#52025,"KUMPAY, BANJARSARI, LEBAK, BANTEN",2,26,190,216
https://kawalpemilu.org#52025,"KUMPAY, BANJARSARI, LEBAK, BANTEN",3,10,165,175
https://kawalpemilu.org#52025,"KUMPAY, BANJARSARI, LEBAK, BANTEN",4,9,175,184
https://kawalpemilu.org#52025,"KUMPAY, BANJARSARI, LEBAK, BANTEN",5,92,87,179
https://kawalpemilu.org#52025,"KUMPAY, BANJARSARI, LEBAK, BANTEN",6,28,131,159
https://kawalpemilu.org#52025,"KUMPAY, BANJARSARI, LEBAK, BANTEN",7,56,170,226
https://kawalpemilu.org#52025,"KUMPAY, BANJARSARI, LEBAK, BANTEN",8,20,181,201
https://kawalpemilu.org#52025,"KUMPAY, BANJARSARI, LEBAK, BANTEN",9,16,172,188
https://kawalpemilu.org#52025,"KUMPAY, BANJARSARI, LEBAK, BANTEN",10,103,64,167
https://kawalpemilu.org#52025,"KUMPAY, BANJARSARI, LEBAK, BANTEN",11,104,63,167
https://kawalpemilu.org#52026,"JALUPANGGIRANG, BANJARSARI, LEBAK, BANTEN",1,51,134,185
https://kawalpemilu.org#52026,"JALUPANGGIRANG, BANJARSARI, LEBAK, BANTEN",2,52,137,189
https://kawalpemilu.org#52026,"JALUPANGGIRANG, BANJARSARI, LEBAK, BANTEN",3,90,79,169
https://kawalpemilu.org#52026,"JALUPANGGIRANG, BANJARSARI, LEBAK, BANTEN",4,52,124,176
https://kawalpemilu.org#52026,"JALUPANGGIRANG, BANJARSARI, LEBAK, BANTEN",5,23,164,187
https://kawalpemilu.org#52026,"JALUPANGGIRANG, BANJARSARI, LEBAK, BANTEN",6,56,131,187
https://kawalpemilu.org#52026,"JALUPANGGIRANG, BANJARSARI, LEBAK, BANTEN",7,37,90,127
https://kawalpemilu.org#52027,"BENDUNGAN, BANJARSARI, LEBAK, BANTEN",1,52,138,190
https://kawalpemilu.org#52027,"BENDUNGAN, BANJARSARI, LEBAK, BANTEN",2,33,157,190
https://kawalpemilu.org#52027,"BENDUNGAN, BANJARSARI, LEBAK, BANTEN",3,22,178,200
https://kawalpemilu.org#52027,"BENDUNGAN, BANJARSARI, LEBAK, BANTEN",4,50,152,202
https://kawalpemilu.org#52027,"BENDUNGAN, BANJARSARI, LEBAK, BANTEN",5,80,120,200
https://kawalpemilu.org#52027,"BENDUNGAN, BANJARSARI, LEBAK, BANTEN",6,26,143,169
https://kawalpemilu.org#52027,"BENDUNGAN, BANJARSARI, LEBAK, BANTEN",7,9,81,90
https://kawalpemilu.org#52027,"BENDUNGAN, BANJARSARI, LEBAK, BANTEN",8,38,120,158
https://kawalpemilu.org#52027,"BENDUNGAN, BANJARSARI, LEBAK, BANTEN",9,69,128,197
https://kawalpemilu.org#52027,"BENDUNGAN, BANJARSARI, LEBAK, BANTEN",10,22,78,100
https://kawalpemilu.org#52028,"KERTARAHARJA, BANJARSARI, LEBAK, BANTEN",1,108,91,199
https://kawalpemilu.org#52028,"KERTARAHARJA, BANJARSARI, LEBAK, BANTEN",2,55,117,172
https://kawalpemilu.org#52028,"KERTARAHARJA, BANJARSARI, LEBAK, BANTEN",3,62,72,134
https://kawalpemilu.org#52028,"KERTARAHARJA, BANJARSARI, LEBAK, BANTEN",4,108,89,197
https://kawalpemilu.org#52028,"KERTARAHARJA, BANJARSARI, LEBAK, BANTEN",5,84,113,197
https://kawalpemilu.org#52028,"KERTARAHARJA, BANJARSARI, LEBAK, BANTEN",6,29,123,152
https://kawalpemilu.org#52028,"KERTARAHARJA, BANJARSARI, LEBAK, BANTEN",7,70,143,213
https://kawalpemilu.org#52028,"KERTARAHARJA, BANJARSARI, LEBAK, BANTEN",8,96,81,177
https://kawalpemilu.org#52028,"KERTARAHARJA, BANJARSARI, LEBAK, BANTEN",9,87,98,185
https://kawalpemilu.org#52028,"KERTARAHARJA, BANJARSARI, LEBAK, BANTEN",10,71,108,179
https://kawalpemilu.org#52028,"KERTARAHARJA, BANJARSARI, LEBAK, BANTEN",11,121,62,183
https://kawalpemilu.org#52028,"KERTARAHARJA, BANJARSARI, LEBAK, BANTEN",12,46,78,124
https://kawalpemilu.org#52028,"KERTARAHARJA, BANJARSARI, LEBAK, BANTEN",13,22,106,128
https://kawalpemilu.org#52029,"CISAMPIH, BANJARSARI, LEBAK, BANTEN",1,31,108,139
https://kawalpemilu.org#52029,"CISAMPIH, BANJARSARI, LEBAK, BANTEN",2,67,72,139
https://kawalpemilu.org#52029,"CISAMPIH, BANJARSARI, LEBAK, BANTEN",3,54,128,182
https://kawalpemilu.org#52029,"CISAMPIH, BANJARSARI, LEBAK, BANTEN",4,69,79,148
https://kawalpemilu.org#52029,"CISAMPIH, BANJARSARI, LEBAK, BANTEN",5,36,128,164
https://kawalpemilu.org#52029,"CISAMPIH, BANJARSARI, LEBAK, BANTEN",6,52,84,136
https://kawalpemilu.org#52029,"CISAMPIH, BANJARSARI, LEBAK, BANTEN",7,55,87,142
https://kawalpemilu.org#52029,"CISAMPIH, BANJARSARI, LEBAK, BANTEN",8,126,74,200
https://kawalpemilu.org#52029,"CISAMPIH, BANJARSARI, LEBAK, BANTEN",9,25,143,168
https://kawalpemilu.org#52029,"CISAMPIH, BANJARSARI, LEBAK, BANTEN",10,41,68,109
https://kawalpemilu.org#52029,"CISAMPIH, BANJARSARI, LEBAK, BANTEN",11,86,61,147
https://kawalpemilu.org#52030,"GUNUNGSARI, BANJARSARI, LEBAK, BANTEN",1,52,143,195
https://kawalpemilu.org#52030,"GUNUNGSARI, BANJARSARI, LEBAK, BANTEN",2,49,79,128
https://kawalpemilu.org#52030,"GUNUNGSARI, BANJARSARI, LEBAK, BANTEN",3,50,142,192
https://kawalpemilu.org#52030,"GUNUNGSARI, BANJARSARI, LEBAK, BANTEN",4,96,24,120
https://kawalpemilu.org#52030,"GUNUNGSARI, BANJARSARI, LEBAK, BANTEN",5,85,56,141
https://kawalpemilu.org#52030,"GUNUNGSARI, BANJARSARI, LEBAK, BANTEN",6,54,110,164
https://kawalpemilu.org#52030,"GUNUNGSARI, BANJARSARI, LEBAK, BANTEN",7,48,110,158
https://kawalpemilu.org#52030,"GUNUNGSARI, BANJARSARI, LEBAK, BANTEN",8,24,105,129
https://kawalpemilu.org#52030,"GUNUNGSARI, BANJARSARI, LEBAK, BANTEN",9,105,58,163
https://kawalpemilu.org#52030,"GUNUNGSARI, BANJARSARI, LEBAK, BANTEN",10,129,32,161
https://kawalpemilu.org#52030,"GUNUNGSARI, BANJARSARI, LEBAK, BANTEN",11,112,17,129
https://kawalpemilu.org#52031,"TAMANSARI, BANJARSARI, LEBAK, BANTEN",1,71,160,231
https://kawalpemilu.org#52031,"TAMANSARI, BANJARSARI, LEBAK, BANTEN",2,71,136,207
https://kawalpemilu.org#52031,"TAMANSARI, BANJARSARI, LEBAK, BANTEN",3,64,137,201
https://kawalpemilu.org#52031,"TAMANSARI, BANJARSARI, LEBAK, BANTEN",4,77,155,232
https://kawalpemilu.org#52031,"TAMANSARI, BANJARSARI, LEBAK, BANTEN",5,107,90,197
https://kawalpemilu.org#52031,"TAMANSARI, BANJARSARI, LEBAK, BANTEN",6,55,164,223
https://kawalpemilu.org#52031,"TAMANSARI, BANJARSARI, LEBAK, BANTEN",7,84,92,176
https://kawalpemilu.org#52031,"TAMANSARI, BANJARSARI, LEBAK, BANTEN",8,88,106,194
https://kawalpemilu.org#52031,"TAMANSARI, BANJARSARI, LEBAK, BANTEN",9,41,136,177
https://kawalpemilu.org#52032,"CIDAHU, BANJARSARI, LEBAK, BANTEN",1,55,155,210
https://kawalpemilu.org#52032,"CIDAHU, BANJARSARI, LEBAK, BANTEN",2,54,204,258
https://kawalpemilu.org#52032,"CIDAHU, BANJARSARI, LEBAK, BANTEN",3,41,130,171
https://kawalpemilu.org#52032,"CIDAHU, BANJARSARI, LEBAK, BANTEN",4,85,76,161
https://kawalpemilu.org#52032,"CIDAHU, BANJARSARI, LEBAK, BANTEN",5,57,84,141
https://kawalpemilu.org#52032,"CIDAHU, BANJARSARI, LEBAK, BANTEN",6,50,160,210
https://kawalpemilu.org#52032,"CIDAHU, BANJARSARI, LEBAK, BANTEN",7,72,129,201
https://kawalpemilu.org#52032,"CIDAHU, BANJARSARI, LEBAK, BANTEN",8,53,65,118
https://kawalpemilu.org#52032,"CIDAHU, BANJARSARI, LEBAK, BANTEN",9,59,97,156
https://kawalpemilu.org#52032,"CIDAHU, BANJARSARI, LEBAK, BANTEN",10,76,94,170
https://kawalpemilu.org#52033,"CIRUJI, BANJARSARI, LEBAK, BANTEN",1,125,65,190
https://kawalpemilu.org#52033,"CIRUJI, BANJARSARI, LEBAK, BANTEN",2,101,113,214
https://kawalpemilu.org#52033,"CIRUJI, BANJARSARI, LEBAK, BANTEN",3,93,116,209
https://kawalpemilu.org#52033,"CIRUJI, BANJARSARI, LEBAK, BANTEN",4,95,65,160
https://kawalpemilu.org#52033,"CIRUJI, BANJARSARI, LEBAK, BANTEN",5,110,64,174
https://kawalpemilu.org#52033,"CIRUJI, BANJARSARI, LEBAK, BANTEN",6,106,86,192
https://kawalpemilu.org#52033,"CIRUJI, BANJARSARI, LEBAK, BANTEN",7,109,74,183
https://kawalpemilu.org#52033,"CIRUJI, BANJARSARI, LEBAK, BANTEN",8,72,109,181
https://kawalpemilu.org#52033,"CIRUJI, BANJARSARI, LEBAK, BANTEN",9,117,61,178
https://kawalpemilu.org#52034,"KADUHAUK, BANJARSARI, LEBAK, BANTEN",1,63,81,144
https://kawalpemilu.org#52034,"KADUHAUK, BANJARSARI, LEBAK, BANTEN",2,78,99,177
https://kawalpemilu.org#52034,"KADUHAUK, BANJARSARI, LEBAK, BANTEN",3,69,141,210
https://kawalpemilu.org#52034,"KADUHAUK, BANJARSARI, LEBAK, BANTEN",4,56,114,170
https://kawalpemilu.org#52034,"KADUHAUK, BANJARSARI, LEBAK, BANTEN",5,61,67,128
https://kawalpemilu.org#52034,"KADUHAUK, BANJARSARI, LEBAK, BANTEN",6,53,69,122
https://kawalpemilu.org#52034,"KADUHAUK, BANJARSARI, LEBAK, BANTEN",7,92,80,172
https://kawalpemilu.org#52034,"KADUHAUK, BANJARSARI, LEBAK, BANTEN",8,80,121,201
https://kawalpemilu.org#52034,"KADUHAUK, BANJARSARI, LEBAK, BANTEN",9,95,95,190
https://kawalpemilu.org#52034,"KADUHAUK, BANJARSARI, LEBAK, BANTEN",10,89,64,153
https://kawalpemilu.org#52035,"LABANJAYA, BANJARSARI, LEBAK, BANTEN",1,56,142,198
https://kawalpemilu.org#52035,"LABANJAYA, BANJARSARI, LEBAK, BANTEN",2,84,84,168
https://kawalpemilu.org#52035,"LABANJAYA, BANJARSARI, LEBAK, BANTEN",3,95,80,175
https://kawalpemilu.org#52035,"LABANJAYA, BANJARSARI, LEBAK, BANTEN",4,48,180,228
https://kawalpemilu.org#52035,"LABANJAYA, BANJARSARI, LEBAK, BANTEN",5,42,182,224
https://kawalpemilu.org#52035,"LABANJAYA, BANJARSARI, LEBAK, BANTEN",6,54,33,87
https://kawalpemilu.org#52035,"LABANJAYA, BANJARSARI, LEBAK, BANTEN",7,39,107,146
https://kawalpemilu.org#52036,"UMBULJAYA, BANJARSARI, LEBAK, BANTEN",1,98,105,203
https://kawalpemilu.org#52036,"UMBULJAYA, BANJARSARI, LEBAK, BANTEN",2,76,75,151
https://kawalpemilu.org#52036,"UMBULJAYA, BANJARSARI, LEBAK, BANTEN",3,57,114,171
https://kawalpemilu.org#52036,"UMBULJAYA, BANJARSARI, LEBAK, BANTEN",4,78,122,200
https://kawalpemilu.org#52036,"UMBULJAYA, BANJARSARI, LEBAK, BANTEN",5,65,99,164
https://kawalpemilu.org#52036,"UMBULJAYA, BANJARSARI, LEBAK, BANTEN",6,66,111,177
https://kawalpemilu.org#52037,"KERTARAHAYU, BANJARSARI, LEBAK, BANTEN",1,26,180,206
https://kawalpemilu.org#52037,"KERTARAHAYU, BANJARSARI, LEBAK, BANTEN",2,85,90,175
https://kawalpemilu.org#52037,"KERTARAHAYU, BANJARSARI, LEBAK, BANTEN",3,86,105,191
https://kawalpemilu.org#52037,"KERTARAHAYU, BANJARSARI, LEBAK, BANTEN",4,67,130,197
https://kawalpemilu.org#52039,"PASINDANGAN, CILELES, LEBAK, BANTEN",1,64,131,195
https://kawalpemilu.org#52039,"PASINDANGAN, CILELES, LEBAK, BANTEN",2,59,108,167
https://kawalpemilu.org#52039,"PASINDANGAN, CILELES, LEBAK, BANTEN",3,84,95,179
https://kawalpemilu.org#52039,"PASINDANGAN, CILELES, LEBAK, BANTEN",4,61,135,196
https://kawalpemilu.org#52039,"PASINDANGAN, CILELES, LEBAK, BANTEN",5,31,134,165
https://kawalpemilu.org#52039,"PASINDANGAN, CILELES, LEBAK, BANTEN",6,65,121,186
https://kawalpemilu.org#52039,"PASINDANGAN, CILELES, LEBAK, BANTEN",7,53,138,191
https://kawalpemilu.org#52039,"PASINDANGAN, CILELES, LEBAK, BANTEN",8,74,25,99
https://kawalpemilu.org#52039,"PASINDANGAN, CILELES, LEBAK, BANTEN",9,33,156,189
https://kawalpemilu.org#52039,"PASINDANGAN, CILELES, LEBAK, BANTEN",10,22,101,123
https://kawalpemilu.org#52039,"PASINDANGAN, CILELES, LEBAK, BANTEN",11,47,146,193
https://kawalpemilu.org#52039,"PASINDANGAN, CILELES, LEBAK, BANTEN",12,44,94,138
https://kawalpemilu.org#52040,"PARUNGKUJANG, CILELES, LEBAK, BANTEN",1,21,185,206
https://kawalpemilu.org#52040,"PARUNGKUJANG, CILELES, LEBAK, BANTEN",2,13,111,124
https://kawalpemilu.org#52040,"PARUNGKUJANG, CILELES, LEBAK, BANTEN",3,19,90,109
https://kawalpemilu.org#52040,"PARUNGKUJANG, CILELES, LEBAK, BANTEN",4,13,103,116
https://kawalpemilu.org#52040,"PARUNGKUJANG, CILELES, LEBAK, BANTEN",5,28,192,220
https://kawalpemilu.org#52040,"PARUNGKUJANG, CILELES, LEBAK, BANTEN",6,14,89,103
https://kawalpemilu.org#52040,"PARUNGKUJANG, CILELES, LEBAK, BANTEN",7,44,141,185
https://kawalpemilu.org#52040,"PARUNGKUJANG, CILELES, LEBAK, BANTEN",8,72,47,119
https://kawalpemilu.org#52040,"PARUNGKUJANG, CILELES, LEBAK, BANTEN",9,75,91,166
https://kawalpemilu.org#52040,"PARUNGKUJANG, CILELES, LEBAK, BANTEN",10,30,77,107
https://kawalpemilu.org#52040,"PARUNGKUJANG, CILELES, LEBAK, BANTEN",11,53,62,115
https://kawalpemilu.org#52040,"PARUNGKUJANG, CILELES, LEBAK, BANTEN",12,22,92,114
https://kawalpemilu.org#52040,"PARUNGKUJANG, CILELES, LEBAK, BANTEN",13,21,98,119
https://kawalpemilu.org#52040,"PARUNGKUJANG, CILELES, LEBAK, BANTEN",14,72,103,175
https://kawalpemilu.org#52040,"PARUNGKUJANG, CILELES, LEBAK, BANTEN",15,86,46,132
https://kawalpemilu.org#52041,"CILELES, CILELES, LEBAK, BANTEN",1,60,152,212
https://kawalpemilu.org#52041,"CILELES, CILELES, LEBAK, BANTEN",2,46,109,155
https://kawalpemilu.org#52041,"CILELES, CILELES, LEBAK, BANTEN",3,50,142,192
https://kawalpemilu.org#52041,"CILELES, CILELES, LEBAK, BANTEN",4,77,117,194
https://kawalpemilu.org#52041,"CILELES, CILELES, LEBAK, BANTEN",5,80,99,179
https://kawalpemilu.org#52041,"CILELES, CILELES, LEBAK, BANTEN",6,108,87,195
https://kawalpemilu.org#52041,"CILELES, CILELES, LEBAK, BANTEN",7,113,50,163
https://kawalpemilu.org#52041,"CILELES, CILELES, LEBAK, BANTEN",8,116,70,186
https://kawalpemilu.org#52041,"CILELES, CILELES, LEBAK, BANTEN",9,84,60,144
https://kawalpemilu.org#52041,"CILELES, CILELES, LEBAK, BANTEN",10,58,108,166
https://kawalpemilu.org#52042,"CIKAREO, CILELES, LEBAK, BANTEN",1,53,134,187
https://kawalpemilu.org#52042,"CIKAREO, CILELES, LEBAK, BANTEN",2,39,111,150
https://kawalpemilu.org#52042,"CIKAREO, CILELES, LEBAK, BANTEN",3,28,112,140
https://kawalpemilu.org#52042,"CIKAREO, CILELES, LEBAK, BANTEN",4,46,183,229
https://kawalpemilu.org#52042,"CIKAREO, CILELES, LEBAK, BANTEN",5,81,75,156
https://kawalpemilu.org#52042,"CIKAREO, CILELES, LEBAK, BANTEN",6,90,92,182
https://kawalpemilu.org#52042,"CIKAREO, CILELES, LEBAK, BANTEN",7,16,76,92
https://kawalpemilu.org#52042,"CIKAREO, CILELES, LEBAK, BANTEN",8,31,106,137
https://kawalpemilu.org#52042,"CIKAREO, CILELES, LEBAK, BANTEN",9,29,117,146
https://kawalpemilu.org#52042,"CIKAREO, CILELES, LEBAK, BANTEN",10,60,95,155
https://kawalpemilu.org#52042,"CIKAREO, CILELES, LEBAK, BANTEN",11,40,113,153
https://kawalpemilu.org#52042,"CIKAREO, CILELES, LEBAK, BANTEN",12,52,69,121
https://kawalpemilu.org#52042,"CIKAREO, CILELES, LEBAK, BANTEN",13,48,96,144
https://kawalpemilu.org#52042,"CIKAREO, CILELES, LEBAK, BANTEN",14,19,139,158
https://kawalpemilu.org#52042,"CIKAREO, CILELES, LEBAK, BANTEN",15,21,84,105
https://kawalpemilu.org#52042,"CIKAREO, CILELES, LEBAK, BANTEN",16,22,100,122
https://kawalpemilu.org#52043,"CIPADANG, CILELES, LEBAK, BANTEN",1,88,108,196
https://kawalpemilu.org#52043,"CIPADANG, CILELES, LEBAK, BANTEN",2,85,123,208
https://kawalpemilu.org#52043,"CIPADANG, CILELES, LEBAK, BANTEN",3,57,96,153
https://kawalpemilu.org#52043,"CIPADANG, CILELES, LEBAK, BANTEN",4,23,60,83
https://kawalpemilu.org#52043,"CIPADANG, CILELES, LEBAK, BANTEN",5,74,114,188
https://kawalpemilu.org#52043,"CIPADANG, CILELES, LEBAK, BANTEN",6,63,107,170
https://kawalpemilu.org#52043,"CIPADANG, CILELES, LEBAK, BANTEN",7,74,102,176
https://kawalpemilu.org#52043,"CIPADANG, CILELES, LEBAK, BANTEN",8,53,143,196
https://kawalpemilu.org#52043,"CIPADANG, CILELES, LEBAK, BANTEN",9,45,116,161
https://kawalpemilu.org#52043,"CIPADANG, CILELES, LEBAK, BANTEN",10,48,125,173
https://kawalpemilu.org#52043,"CIPADANG, CILELES, LEBAK, BANTEN",11,57,126,183
https://kawalpemilu.org#52043,"CIPADANG, CILELES, LEBAK, BANTEN",12,58,132,190
https://kawalpemilu.org#52043,"CIPADANG, CILELES, LEBAK, BANTEN",13,45,125,170
https://kawalpemilu.org#52043,"CIPADANG, CILELES, LEBAK, BANTEN",14,84,98,182
https://kawalpemilu.org#52043,"CIPADANG, CILELES, LEBAK, BANTEN",15,107,88,195
https://kawalpemilu.org#52043,"CIPADANG, CILELES, LEBAK, BANTEN",16,42,135,177
https://kawalpemilu.org#52043,"CIPADANG, CILELES, LEBAK, BANTEN",17,6,118,124
https://kawalpemilu.org#52044,"GUMURUH, CILELES, LEBAK, BANTEN",1,72,83,155
https://kawalpemilu.org#52044,"GUMURUH, CILELES, LEBAK, BANTEN",2,68,77,145
https://kawalpemilu.org#52044,"GUMURUH, CILELES, LEBAK, BANTEN",3,61,82,143
https://kawalpemilu.org#52044,"GUMURUH, CILELES, LEBAK, BANTEN",4,25,111,136
https://kawalpemilu.org#52044,"GUMURUH, CILELES, LEBAK, BANTEN",5,46,67,113
https://kawalpemilu.org#52044,"GUMURUH, CILELES, LEBAK, BANTEN",6,83,48,131
https://kawalpemilu.org#52044,"GUMURUH, CILELES, LEBAK, BANTEN",7,69,65,134
https://kawalpemilu.org#52044,"GUMURUH, CILELES, LEBAK, BANTEN",8,24,117,141
https://kawalpemilu.org#52044,"GUMURUH, CILELES, LEBAK, BANTEN",9,24,85,109
https://kawalpemilu.org#52044,"GUMURUH, CILELES, LEBAK, BANTEN",10,112,97,209
https://kawalpemilu.org#52044,"GUMURUH, CILELES, LEBAK, BANTEN",11,77,100,177
https://kawalpemilu.org#52044,"GUMURUH, CILELES, LEBAK, BANTEN",12,34,148,182
https://kawalpemilu.org#52044,"GUMURUH, CILELES, LEBAK, BANTEN",13,62,64,126
https://kawalpemilu.org#52044,"GUMURUH, CILELES, LEBAK, BANTEN",14,137,59,196
https://kawalpemilu.org#52044,"GUMURUH, CILELES, LEBAK, BANTEN",15,100,78,178
https://kawalpemilu.org#52044,"GUMURUH, CILELES, LEBAK, BANTEN",16,55,22,77
https://kawalpemilu.org#52045,"PRABUGANTUNGAN, CILELES, LEBAK, BANTEN",1,89,124,213
https://kawalpemilu.org#52045,"PRABUGANTUNGAN, CILELES, LEBAK, BANTEN",2,84,77,161
https://kawalpemilu.org#52045,"PRABUGANTUNGAN, CILELES, LEBAK, BANTEN",3,95,80,175
https://kawalpemilu.org#52045,"PRABUGANTUNGAN, CILELES, LEBAK, BANTEN",4,88,59,147
https://kawalpemilu.org#52045,"PRABUGANTUNGAN, CILELES, LEBAK, BANTEN",5,133,51,184
https://kawalpemilu.org#52045,"PRABUGANTUNGAN, CILELES, LEBAK, BANTEN",6,93,60,153
https://kawalpemilu.org#52045,"PRABUGANTUNGAN, CILELES, LEBAK, BANTEN",7,106,31,137
https://kawalpemilu.org#52045,"PRABUGANTUNGAN, CILELES, LEBAK, BANTEN",8,38,154,192
https://kawalpemilu.org#52045,"PRABUGANTUNGAN, CILELES, LEBAK, BANTEN",9,78,69,147
https://kawalpemilu.org#52045,"PRABUGANTUNGAN, CILELES, LEBAK, BANTEN",10,55,52,107
https://kawalpemilu.org#52045,"PRABUGANTUNGAN, CILELES, LEBAK, BANTEN",11,98,66,164
https://kawalpemilu.org#52045,"PRABUGANTUNGAN, CILELES, LEBAK, BANTEN",12,60,63,123
https://kawalpemilu.org#52045,"PRABUGANTUNGAN, CILELES, LEBAK, BANTEN",13,18,86,104
https://kawalpemilu.org#52045,"PRABUGANTUNGAN, CILELES, LEBAK, BANTEN",14,47,106,153
https://kawalpemilu.org#52045,"PRABUGANTUNGAN, CILELES, LEBAK, BANTEN",15,42,141,183
https://kawalpemilu.org#52045,"PRABUGANTUNGAN, CILELES, LEBAK, BANTEN",16,127,33,160
https://kawalpemilu.org#52046,"DAROYON, CILELES, LEBAK, BANTEN",1,92,72,164
https://kawalpemilu.org#52046,"DAROYON, CILELES, LEBAK, BANTEN",2,55,88,143
https://kawalpemilu.org#52046,"DAROYON, CILELES, LEBAK, BANTEN",3,58,71,129
https://kawalpemilu.org#52046,"DAROYON, CILELES, LEBAK, BANTEN",4,36,119,155
https://kawalpemilu.org#52046,"DAROYON, CILELES, LEBAK, BANTEN",5,59,104,163
https://kawalpemilu.org#52046,"DAROYON, CILELES, LEBAK, BANTEN",6,95,114,209
https://kawalpemilu.org#52046,"DAROYON, CILELES, LEBAK, BANTEN",7,25,137,162
https://kawalpemilu.org#52046,"DAROYON, CILELES, LEBAK, BANTEN",8,47,108,155
https://kawalpemilu.org#52046,"DAROYON, CILELES, LEBAK, BANTEN",9,81,78,159
https://kawalpemilu.org#52046,"DAROYON, CILELES, LEBAK, BANTEN",10,44,118,162
https://kawalpemilu.org#52046,"DAROYON, CILELES, LEBAK, BANTEN",11,71,108,179
https://kawalpemilu.org#52046,"DAROYON, CILELES, LEBAK, BANTEN",12,43,86,129
https://kawalpemilu.org#52046,"DAROYON, CILELES, LEBAK, BANTEN",13,95,86,181
https://kawalpemilu.org#52047,"MARGAMULYA, CILELES, LEBAK, BANTEN",1,46,140,186
https://kawalpemilu.org#52047,"MARGAMULYA, CILELES, LEBAK, BANTEN",2,76,107,183
https://kawalpemilu.org#52047,"MARGAMULYA, CILELES, LEBAK, BANTEN",3,25,162,187
https://kawalpemilu.org#52047,"MARGAMULYA, CILELES, LEBAK, BANTEN",4,38,152,190
https://kawalpemilu.org#52047,"MARGAMULYA, CILELES, LEBAK, BANTEN",5,39,144,183
https://kawalpemilu.org#52047,"MARGAMULYA, CILELES, LEBAK, BANTEN",6,55,136,191
https://kawalpemilu.org#52047,"MARGAMULYA, CILELES, LEBAK, BANTEN",7,26,166,192
https://kawalpemilu.org#52047,"MARGAMULYA, CILELES, LEBAK, BANTEN",8,27,145,172
https://kawalpemilu.org#52047,"MARGAMULYA, CILELES, LEBAK, BANTEN",9,25,153,178
https://kawalpemilu.org#52047,"MARGAMULYA, CILELES, LEBAK, BANTEN",10,30,142,172
https://kawalpemilu.org#52047,"MARGAMULYA, CILELES, LEBAK, BANTEN",11,26,151,177
https://kawalpemilu.org#52048,"MEKARJAYA, CILELES, LEBAK, BANTEN",1,21,144,165
https://kawalpemilu.org#52048,"MEKARJAYA, CILELES, LEBAK, BANTEN",2,34,122,156
https://kawalpemilu.org#52048,"MEKARJAYA, CILELES, LEBAK, BANTEN",3,12,125,137
https://kawalpemilu.org#52048,"MEKARJAYA, CILELES, LEBAK, BANTEN",4,88,125,213
https://kawalpemilu.org#52048,"MEKARJAYA, CILELES, LEBAK, BANTEN",5,83,106,189
https://kawalpemilu.org#52048,"MEKARJAYA, CILELES, LEBAK, BANTEN",6,47,153,200
https://kawalpemilu.org#52048,"MEKARJAYA, CILELES, LEBAK, BANTEN",7,46,104,150
https://kawalpemilu.org#52048,"MEKARJAYA, CILELES, LEBAK, BANTEN",8,38,89,127
https://kawalpemilu.org#52048,"MEKARJAYA, CILELES, LEBAK, BANTEN",9,74,121,195
https://kawalpemilu.org#52048,"MEKARJAYA, CILELES, LEBAK, BANTEN",10,77,54,131
https://kawalpemilu.org#52049,"KUJANGSARI, CILELES, LEBAK, BANTEN",1,49,138,187
https://kawalpemilu.org#52049,"KUJANGSARI, CILELES, LEBAK, BANTEN",2,25,97,122
https://kawalpemilu.org#52049,"KUJANGSARI, CILELES, LEBAK, BANTEN",3,72,107,179
https://kawalpemilu.org#52049,"KUJANGSARI, CILELES, LEBAK, BANTEN",4,93,131,224
https://kawalpemilu.org#52049,"KUJANGSARI, CILELES, LEBAK, BANTEN",5,82,77,159
https://kawalpemilu.org#52049,"KUJANGSARI, CILELES, LEBAK, BANTEN",6,81,110,191
https://kawalpemilu.org#52049,"KUJANGSARI, CILELES, LEBAK, BANTEN",7,66,122,188
https://kawalpemilu.org#52049,"KUJANGSARI, CILELES, LEBAK, BANTEN",8,52,114,166
https://kawalpemilu.org#52049,"KUJANGSARI, CILELES, LEBAK, BANTEN",9,70,113,183
https://kawalpemilu.org#52049,"KUJANGSARI, CILELES, LEBAK, BANTEN",10,36,134,170
https://kawalpemilu.org#52049,"KUJANGSARI, CILELES, LEBAK, BANTEN",11,43,41,84
https://kawalpemilu.org#52050,"BANJARSARI, CILELES, LEBAK, BANTEN",1,60,92,152
https://kawalpemilu.org#52050,"BANJARSARI, CILELES, LEBAK, BANTEN",2,76,91,167
https://kawalpemilu.org#52050,"BANJARSARI, CILELES, LEBAK, BANTEN",3,63,89,152
https://kawalpemilu.org#52050,"BANJARSARI, CILELES, LEBAK, BANTEN",4,85,40,125
https://kawalpemilu.org#52050,"BANJARSARI, CILELES, LEBAK, BANTEN",5,59,112,171
https://kawalpemilu.org#52050,"BANJARSARI, CILELES, LEBAK, BANTEN",6,29,117,146
https://kawalpemilu.org#52050,"BANJARSARI, CILELES, LEBAK, BANTEN",7,30,116,146
https://kawalpemilu.org#52050,"BANJARSARI, CILELES, LEBAK, BANTEN",8,23,156,179
https://kawalpemilu.org#52050,"BANJARSARI, CILELES, LEBAK, BANTEN",9,64,108,172
https://kawalpemilu.org#52050,"BANJARSARI, CILELES, LEBAK, BANTEN",10,75,74,149
https://kawalpemilu.org#52050,"BANJARSARI, CILELES, LEBAK, BANTEN",11,85,64,149
https://kawalpemilu.org#52050,"BANJARSARI, CILELES, LEBAK, BANTEN",12,60,63,123
https://kawalpemilu.org#52050,"BANJARSARI, CILELES, LEBAK, BANTEN",13,65,101,166
https://kawalpemilu.org#52050,"BANJARSARI, CILELES, LEBAK, BANTEN",14,81,62,143
https://kawalpemilu.org#52050,"BANJARSARI, CILELES, LEBAK, BANTEN",15,55,75,130
https://kawalpemilu.org#52050,"BANJARSARI, CILELES, LEBAK, BANTEN",16,83,51,134
https://kawalpemilu.org#52050,"BANJARSARI, CILELES, LEBAK, BANTEN",17,68,40,108
https://kawalpemilu.org#52050,"BANJARSARI, CILELES, LEBAK, BANTEN",18,55,42,97
https://kawalpemilu.org#52050,"BANJARSARI, CILELES, LEBAK, BANTEN",19,31,102,133
https://kawalpemilu.org#52052,"SARAGENI, CIMARGA, LEBAK, BANTEN",1,126,108,234
https://kawalpemilu.org#52052,"SARAGENI, CIMARGA, LEBAK, BANTEN",2,68,98,166
https://kawalpemilu.org#52052,"SARAGENI, CIMARGA, LEBAK, BANTEN",3,65,109,174
https://kawalpemilu.org#52052,"SARAGENI, CIMARGA, LEBAK, BANTEN",4,59,125,184
https://kawalpemilu.org#52052,"SARAGENI, CIMARGA, LEBAK, BANTEN",5,74,100,174
https://kawalpemilu.org#52052,"SARAGENI, CIMARGA, LEBAK, BANTEN",6,51,111,162
https://kawalpemilu.org#52052,"SARAGENI, CIMARGA, LEBAK, BANTEN",7,89,104,193
https://kawalpemilu.org#52052,"SARAGENI, CIMARGA, LEBAK, BANTEN",8,41,50,91
https://kawalpemilu.org#52052,"SARAGENI, CIMARGA, LEBAK, BANTEN",9,90,39,129
https://kawalpemilu.org#52052,"SARAGENI, CIMARGA, LEBAK, BANTEN",10,64,138,202
https://kawalpemilu.org#52053,"GUNUNGANTEN, CIMARGA, LEBAK, BANTEN",1,47,68,115
https://kawalpemilu.org#52053,"GUNUNGANTEN, CIMARGA, LEBAK, BANTEN",2,55,51,106
https://kawalpemilu.org#52053,"GUNUNGANTEN, CIMARGA, LEBAK, BANTEN",3,79,40,119
https://kawalpemilu.org#52053,"GUNUNGANTEN, CIMARGA, LEBAK, BANTEN",4,49,122,171
https://kawalpemilu.org#52053,"GUNUNGANTEN, CIMARGA, LEBAK, BANTEN",5,42,81,123
https://kawalpemilu.org#52053,"GUNUNGANTEN, CIMARGA, LEBAK, BANTEN",6,45,63,108
https://kawalpemilu.org#52053,"GUNUNGANTEN, CIMARGA, LEBAK, BANTEN",7,39,73,112
https://kawalpemilu.org#52053,"GUNUNGANTEN, CIMARGA, LEBAK, BANTEN",8,37,79,116
https://kawalpemilu.org#52053,"GUNUNGANTEN, CIMARGA, LEBAK, BANTEN",10,36,91,127
https://kawalpemilu.org#52053,"GUNUNGANTEN, CIMARGA, LEBAK, BANTEN",11,44,121,165
https://kawalpemilu.org#52053,"GUNUNGANTEN, CIMARGA, LEBAK, BANTEN",12,31,87,118
https://kawalpemilu.org#52053,"GUNUNGANTEN, CIMARGA, LEBAK, BANTEN",13,61,143,204
https://kawalpemilu.org#52053,"GUNUNGANTEN, CIMARGA, LEBAK, BANTEN",14,48,122,170
https://kawalpemilu.org#52053,"GUNUNGANTEN, CIMARGA, LEBAK, BANTEN",15,47,160,207
https://kawalpemilu.org#52053,"GUNUNGANTEN, CIMARGA, LEBAK, BANTEN",16,48,149,197
https://kawalpemilu.org#52054,"SUDAMANIK, CIMARGA, LEBAK, BANTEN",1,65,107,172
https://kawalpemilu.org#52054,"SUDAMANIK, CIMARGA, LEBAK, BANTEN",2,38,125,163
https://kawalpemilu.org#52054,"SUDAMANIK, CIMARGA, LEBAK, BANTEN",3,56,123,179
https://kawalpemilu.org#52054,"SUDAMANIK, CIMARGA, LEBAK, BANTEN",4,59,124,183
https://kawalpemilu.org#52054,"SUDAMANIK, CIMARGA, LEBAK, BANTEN",5,101,84,185
https://kawalpemilu.org#52054,"SUDAMANIK, CIMARGA, LEBAK, BANTEN",6,34,97,131
https://kawalpemilu.org#52054,"SUDAMANIK, CIMARGA, LEBAK, BANTEN",7,40,113,153
https://kawalpemilu.org#52054,"SUDAMANIK, CIMARGA, LEBAK, BANTEN",8,61,140,201
https://kawalpemilu.org#52054,"SUDAMANIK, CIMARGA, LEBAK, BANTEN",9,54,136,190
https://kawalpemilu.org#52054,"SUDAMANIK, CIMARGA, LEBAK, BANTEN",10,71,136,207
https://kawalpemilu.org#52054,"SUDAMANIK, CIMARGA, LEBAK, BANTEN",11,71,135,206
https://kawalpemilu.org#52054,"SUDAMANIK, CIMARGA, LEBAK, BANTEN",12,64,152,216
https://kawalpemilu.org#52054,"SUDAMANIK, CIMARGA, LEBAK, BANTEN",13,59,75,134
https://kawalpemilu.org#52054,"SUDAMANIK, CIMARGA, LEBAK, BANTEN",14,74,53,127
https://kawalpemilu.org#52054,"SUDAMANIK, CIMARGA, LEBAK, BANTEN",15,80,51,131
https://kawalpemilu.org#52054,"SUDAMANIK, CIMARGA, LEBAK, BANTEN",16,50,66,116
https://kawalpemilu.org#52055,"TAMBAK, CIMARGA, LEBAK, BANTEN",1,47,132,179
https://kawalpemilu.org#52055,"TAMBAK, CIMARGA, LEBAK, BANTEN",2,42,87,129
https://kawalpemilu.org#52055,"TAMBAK, CIMARGA, LEBAK, BANTEN",3,54,102,156
https://kawalpemilu.org#52055,"TAMBAK, CIMARGA, LEBAK, BANTEN",4,64,85,149
https://kawalpemilu.org#52055,"TAMBAK, CIMARGA, LEBAK, BANTEN",5,60,151,211
https://kawalpemilu.org#52055,"TAMBAK, CIMARGA, LEBAK, BANTEN",6,17,105,122
https://kawalpemilu.org#52055,"TAMBAK, CIMARGA, LEBAK, BANTEN",7,86,94,180
https://kawalpemilu.org#52055,"TAMBAK, CIMARGA, LEBAK, BANTEN",8,97,85,182
https://kawalpemilu.org#52055,"TAMBAK, CIMARGA, LEBAK, BANTEN",9,49,118,167
https://kawalpemilu.org#52055,"TAMBAK, CIMARGA, LEBAK, BANTEN",10,35,74,109
https://kawalpemilu.org#52055,"TAMBAK, CIMARGA, LEBAK, BANTEN",11,55,100,155
https://kawalpemilu.org#52055,"TAMBAK, CIMARGA, LEBAK, BANTEN",12,13,78,91
https://kawalpemilu.org#52056,"CIMARGA, CIMARGA, LEBAK, BANTEN",1,64,119,183
https://kawalpemilu.org#52056,"CIMARGA, CIMARGA, LEBAK, BANTEN",2,59,85,144
https://kawalpemilu.org#52056,"CIMARGA, CIMARGA, LEBAK, BANTEN",3,19,79,98
https://kawalpemilu.org#52056,"CIMARGA, CIMARGA, LEBAK, BANTEN",4,64,184,248
https://kawalpemilu.org#52056,"CIMARGA, CIMARGA, LEBAK, BANTEN",5,82,180,262
https://kawalpemilu.org#52056,"CIMARGA, CIMARGA, LEBAK, BANTEN",6,60,113,173
https://kawalpemilu.org#52056,"CIMARGA, CIMARGA, LEBAK, BANTEN",7,105,53,158
https://kawalpemilu.org#52056,"CIMARGA, CIMARGA, LEBAK, BANTEN",8,54,78,132
https://kawalpemilu.org#52056,"CIMARGA, CIMARGA, LEBAK, BANTEN",9,80,124,204
https://kawalpemilu.org#52056,"CIMARGA, CIMARGA, LEBAK, BANTEN",10,53,169,222
https://kawalpemilu.org#52056,"CIMARGA, CIMARGA, LEBAK, BANTEN",11,70,140,210
https://kawalpemilu.org#52056,"CIMARGA, CIMARGA, LEBAK, BANTEN",12,48,75,123
https://kawalpemilu.org#52056,"CIMARGA, CIMARGA, LEBAK, BANTEN",13,98,100,198
https://kawalpemilu.org#52057,"KARYAJAYA, CIMARGA, LEBAK, BANTEN",1,39,130,169
https://kawalpemilu.org#52057,"KARYAJAYA, CIMARGA, LEBAK, BANTEN",2,37,107,144
https://kawalpemilu.org#52057,"KARYAJAYA, CIMARGA, LEBAK, BANTEN",3,84,117,201
https://kawalpemilu.org#52057,"KARYAJAYA, CIMARGA, LEBAK, BANTEN",4,53,156,209
https://kawalpemilu.org#52057,"KARYAJAYA, CIMARGA, LEBAK, BANTEN",5,61,145,206
https://kawalpemilu.org#52057,"KARYAJAYA, CIMARGA, LEBAK, BANTEN",6,70,126,196
https://kawalpemilu.org#52057,"KARYAJAYA, CIMARGA, LEBAK, BANTEN",7,74,130,204
https://kawalpemilu.org#52057,"KARYAJAYA, CIMARGA, LEBAK, BANTEN",8,64,77,141
https://kawalpemilu.org#52057,"KARYAJAYA, CIMARGA, LEBAK, BANTEN",9,20,165,185
https://kawalpemilu.org#52057,"KARYAJAYA, CIMARGA, LEBAK, BANTEN",10,63,138,201
https://kawalpemilu.org#52057,"KARYAJAYA, CIMARGA, LEBAK, BANTEN",11,83,91,174
https://kawalpemilu.org#52057,"KARYAJAYA, CIMARGA, LEBAK, BANTEN",12,34,157,191
https://kawalpemilu.org#52057,"KARYAJAYA, CIMARGA, LEBAK, BANTEN",13,37,139,176
https://kawalpemilu.org#52058,"MARGAJAYA, CIMARGA, LEBAK, BANTEN",1,75,145,220
https://kawalpemilu.org#52058,"MARGAJAYA, CIMARGA, LEBAK, BANTEN",2,64,176,240
https://kawalpemilu.org#52058,"MARGAJAYA, CIMARGA, LEBAK, BANTEN",3,47,184,231
https://kawalpemilu.org#52058,"MARGAJAYA, CIMARGA, LEBAK, BANTEN",4,82,134,216
https://kawalpemilu.org#52058,"MARGAJAYA, CIMARGA, LEBAK, BANTEN",5,103,130,233
https://kawalpemilu.org#52058,"MARGAJAYA, CIMARGA, LEBAK, BANTEN",6,46,170,216
https://kawalpemilu.org#52058,"MARGAJAYA, CIMARGA, LEBAK, BANTEN",7,62,156,218
https://kawalpemilu.org#52058,"MARGAJAYA, CIMARGA, LEBAK, BANTEN",8,56,164,220
https://kawalpemilu.org#52058,"MARGAJAYA, CIMARGA, LEBAK, BANTEN",9,31,128,159
https://kawalpemilu.org#52058,"MARGAJAYA, CIMARGA, LEBAK, BANTEN",10,52,141,193
https://kawalpemilu.org#52058,"MARGAJAYA, CIMARGA, LEBAK, BANTEN",11,35,113,148
https://kawalpemilu.org#52058,"MARGAJAYA, CIMARGA, LEBAK, BANTEN",12,30,183,213
https://kawalpemilu.org#52058,"MARGAJAYA, CIMARGA, LEBAK, BANTEN",13,32,136,168
https://kawalpemilu.org#52058,"MARGAJAYA, CIMARGA, LEBAK, BANTEN",14,34,129,163
https://kawalpemilu.org#52058,"MARGAJAYA, CIMARGA, LEBAK, BANTEN",15,32,103,135
https://kawalpemilu.org#52058,"MARGAJAYA, CIMARGA, LEBAK, BANTEN",16,44,138,182
https://kawalpemilu.org#52058,"MARGAJAYA, CIMARGA, LEBAK, BANTEN",17,61,99,160
https://kawalpemilu.org#52058,"MARGAJAYA, CIMARGA, LEBAK, BANTEN",18,62,92,154
https://kawalpemilu.org#52059,"JAYAMANIK, CIMARGA, LEBAK, BANTEN",1,31,112,143
https://kawalpemilu.org#52059,"JAYAMANIK, CIMARGA, LEBAK, BANTEN",2,41,81,122
https://kawalpemilu.org#52059,"JAYAMANIK, CIMARGA, LEBAK, BANTEN",3,57,145,202
https://kawalpemilu.org#52059,"JAYAMANIK, CIMARGA, LEBAK, BANTEN",4,52,129,181
https://kawalpemilu.org#52059,"JAYAMANIK, CIMARGA, LEBAK, BANTEN",5,24,148,172
https://kawalpemilu.org#52059,"JAYAMANIK, CIMARGA, LEBAK, BANTEN",6,41,130,171
https://kawalpemilu.org#52059,"JAYAMANIK, CIMARGA, LEBAK, BANTEN",7,21,142,163
https://kawalpemilu.org#52059,"JAYAMANIK, CIMARGA, LEBAK, BANTEN",8,65,66,131
https://kawalpemilu.org#52059,"JAYAMANIK, CIMARGA, LEBAK, BANTEN",9,64,78,142
https://kawalpemilu.org#52059,"JAYAMANIK, CIMARGA, LEBAK, BANTEN",10,92,64,156
https://kawalpemilu.org#52059,"JAYAMANIK, CIMARGA, LEBAK, BANTEN",11,30,78,108
https://kawalpemilu.org#52059,"JAYAMANIK, CIMARGA, LEBAK, BANTEN",12,35,99,134
https://kawalpemilu.org#52059,"JAYAMANIK, CIMARGA, LEBAK, BANTEN",13,40,56,96
https://kawalpemilu.org#52059,"JAYAMANIK, CIMARGA, LEBAK, BANTEN",14,27,151,178
https://kawalpemilu.org#52059,"JAYAMANIK, CIMARGA, LEBAK, BANTEN",15,70,60,130
https://kawalpemilu.org#52059,"JAYAMANIK, CIMARGA, LEBAK, BANTEN",16,61,77,138
https://kawalpemilu.org#52060,"MARGALUYU, CIMARGA, LEBAK, BANTEN",1,90,106,196
https://kawalpemilu.org#52060,"MARGALUYU, CIMARGA, LEBAK, BANTEN",2,110,60,170
https://kawalpemilu.org#52060,"MARGALUYU, CIMARGA, LEBAK, BANTEN",3,110,48,158
https://kawalpemilu.org#52060,"MARGALUYU, CIMARGA, LEBAK, BANTEN",4,102,94,196
https://kawalpemilu.org#52060,"MARGALUYU, CIMARGA, LEBAK, BANTEN",5,76,89,165
https://kawalpemilu.org#52060,"MARGALUYU, CIMARGA, LEBAK, BANTEN",6,23,164,187
https://kawalpemilu.org#52060,"MARGALUYU, CIMARGA, LEBAK, BANTEN",7,14,198,212
https://kawalpemilu.org#52060,"MARGALUYU, CIMARGA, LEBAK, BANTEN",8,78,63,141
https://kawalpemilu.org#52060,"MARGALUYU, CIMARGA, LEBAK, BANTEN",9,104,80,184
https://kawalpemilu.org#52060,"MARGALUYU, CIMARGA, LEBAK, BANTEN",10,155,68,223
https://kawalpemilu.org#52061,"MARGATIRTA, CIMARGA, LEBAK, BANTEN",1,35,161,196
https://kawalpemilu.org#52061,"MARGATIRTA, CIMARGA, LEBAK, BANTEN",2,44,136,180
https://kawalpemilu.org#52061,"MARGATIRTA, CIMARGA, LEBAK, BANTEN",3,32,139,171
https://kawalpemilu.org#52061,"MARGATIRTA, CIMARGA, LEBAK, BANTEN",4,33,117,150
https://kawalpemilu.org#52061,"MARGATIRTA, CIMARGA, LEBAK, BANTEN",5,25,94,119
https://kawalpemilu.org#52061,"MARGATIRTA, CIMARGA, LEBAK, BANTEN",6,43,133,176
https://kawalpemilu.org#52061,"MARGATIRTA, CIMARGA, LEBAK, BANTEN",7,29,148,177
https://kawalpemilu.org#52061,"MARGATIRTA, CIMARGA, LEBAK, BANTEN",8,47,131,178
https://kawalpemilu.org#52061,"MARGATIRTA, CIMARGA, LEBAK, BANTEN",9,46,145,191
https://kawalpemilu.org#52061,"MARGATIRTA, CIMARGA, LEBAK, BANTEN",10,60,172,232
https://kawalpemilu.org#52061,"MARGATIRTA, CIMARGA, LEBAK, BANTEN",11,38,157,195
https://kawalpemilu.org#52062,"INTENJAYA, CIMARGA, LEBAK, BANTEN",1,44,157,201
https://kawalpemilu.org#52062,"INTENJAYA, CIMARGA, LEBAK, BANTEN",2,58,58,116
https://kawalpemilu.org#52062,"INTENJAYA, CIMARGA, LEBAK, BANTEN",3,61,104,165
https://kawalpemilu.org#52062,"INTENJAYA, CIMARGA, LEBAK, BANTEN",4,30,184,214
https://kawalpemilu.org#52062,"INTENJAYA, CIMARGA, LEBAK, BANTEN",5,61,126,187
https://kawalpemilu.org#52062,"INTENJAYA, CIMARGA, LEBAK, BANTEN",6,54,66,120
https://kawalpemilu.org#52062,"INTENJAYA, CIMARGA, LEBAK, BANTEN",7,46,110,156
https://kawalpemilu.org#52062,"INTENJAYA, CIMARGA, LEBAK, BANTEN",8,79,50,129
https://kawalpemilu.org#52062,"INTENJAYA, CIMARGA, LEBAK, BANTEN",9,37,94,131
https://kawalpemilu.org#52062,"INTENJAYA, CIMARGA, LEBAK, BANTEN",10,18,183,201
https://kawalpemilu.org#52062,"INTENJAYA, CIMARGA, LEBAK, BANTEN",11,27,141,168
https://kawalpemilu.org#52062,"INTENJAYA, CIMARGA, LEBAK, BANTEN",12,34,72,106
https://kawalpemilu.org#52062,"INTENJAYA, CIMARGA, LEBAK, BANTEN",13,25,156,181
https://kawalpemilu.org#52063,"MEKARJAYA, CIMARGA, LEBAK, BANTEN",1,101,129,230
https://kawalpemilu.org#52063,"MEKARJAYA, CIMARGA, LEBAK, BANTEN",2,59,108,167
https://kawalpemilu.org#52063,"MEKARJAYA, CIMARGA, LEBAK, BANTEN",3,74,53,127
https://kawalpemilu.org#52063,"MEKARJAYA, CIMARGA, LEBAK, BANTEN",4,69,74,143
https://kawalpemilu.org#52063,"MEKARJAYA, CIMARGA, LEBAK, BANTEN",5,62,122,184
https://kawalpemilu.org#52063,"MEKARJAYA, CIMARGA, LEBAK, BANTEN",6,57,113,170
https://kawalpemilu.org#52063,"MEKARJAYA, CIMARGA, LEBAK, BANTEN",7,38,107,145
https://kawalpemilu.org#52063,"MEKARJAYA, CIMARGA, LEBAK, BANTEN",8,54,122,176
https://kawalpemilu.org#52063,"MEKARJAYA, CIMARGA, LEBAK, BANTEN",9,86,76,162
https://kawalpemilu.org#52063,"MEKARJAYA, CIMARGA, LEBAK, BANTEN",10,70,74,144
https://kawalpemilu.org#52063,"MEKARJAYA, CIMARGA, LEBAK, BANTEN",11,54,23,77
https://kawalpemilu.org#52063,"MEKARJAYA, CIMARGA, LEBAK, BANTEN",12,77,113,190
https://kawalpemilu.org#52063,"MEKARJAYA, CIMARGA, LEBAK, BANTEN",13,74,84,158
https://kawalpemilu.org#52064,"JAYASARI, CIMARGA, LEBAK, BANTEN",1,34,136,170
https://kawalpemilu.org#52064,"JAYASARI, CIMARGA, LEBAK, BANTEN",2,43,116,159
https://kawalpemilu.org#52064,"JAYASARI, CIMARGA, LEBAK, BANTEN",3,29,174,203
https://kawalpemilu.org#52064,"JAYASARI, CIMARGA, LEBAK, BANTEN",4,12,138,150
https://kawalpemilu.org#52064,"JAYASARI, CIMARGA, LEBAK, BANTEN",5,83,141,224
https://kawalpemilu.org#52064,"JAYASARI, CIMARGA, LEBAK, BANTEN",6,56,148,204
https://kawalpemilu.org#52064,"JAYASARI, CIMARGA, LEBAK, BANTEN",7,74,121,195
https://kawalpemilu.org#52064,"JAYASARI, CIMARGA, LEBAK, BANTEN",8,64,173,237
https://kawalpemilu.org#52065,"GIRIMUKTI, CIMARGA, LEBAK, BANTEN",1,68,97,165
https://kawalpemilu.org#52065,"GIRIMUKTI, CIMARGA, LEBAK, BANTEN",2,61,125,186
https://kawalpemilu.org#52065,"GIRIMUKTI, CIMARGA, LEBAK, BANTEN",3,78,140,218
https://kawalpemilu.org#52065,"GIRIMUKTI, CIMARGA, LEBAK, BANTEN",4,65,120,185
https://kawalpemilu.org#52065,"GIRIMUKTI, CIMARGA, LEBAK, BANTEN",5,66,135,201
https://kawalpemilu.org#52065,"GIRIMUKTI, CIMARGA, LEBAK, BANTEN",6,115,115,230
https://kawalpemilu.org#52065,"GIRIMUKTI, CIMARGA, LEBAK, BANTEN",7,11,84,95
https://kawalpemilu.org#52065,"GIRIMUKTI, CIMARGA, LEBAK, BANTEN",8,43,75,118
https://kawalpemilu.org#52065,"GIRIMUKTI, CIMARGA, LEBAK, BANTEN",9,65,97,162
https://kawalpemilu.org#52065,"GIRIMUKTI, CIMARGA, LEBAK, BANTEN",10,52,113,165
https://kawalpemilu.org#52065,"GIRIMUKTI, CIMARGA, LEBAK, BANTEN",11,68,121,189
https://kawalpemilu.org#52065,"GIRIMUKTI, CIMARGA, LEBAK, BANTEN",12,128,82,210
https://kawalpemilu.org#52066,"SANGKANMANIK, CIMARGA, LEBAK, BANTEN",1,26,181,207
https://kawalpemilu.org#52066,"SANGKANMANIK, CIMARGA, LEBAK, BANTEN",2,46,158,204
https://kawalpemilu.org#52066,"SANGKANMANIK, CIMARGA, LEBAK, BANTEN",3,40,158,198
https://kawalpemilu.org#52066,"SANGKANMANIK, CIMARGA, LEBAK, BANTEN",4,42,171,213
https://kawalpemilu.org#52066,"SANGKANMANIK, CIMARGA, LEBAK, BANTEN",5,51,146,197
https://kawalpemilu.org#52066,"SANGKANMANIK, CIMARGA, LEBAK, BANTEN",6,21,190,211
https://kawalpemilu.org#52066,"SANGKANMANIK, CIMARGA, LEBAK, BANTEN",7,71,123,194
https://kawalpemilu.org#52066,"SANGKANMANIK, CIMARGA, LEBAK, BANTEN",8,49,127,176
https://kawalpemilu.org#52066,"SANGKANMANIK, CIMARGA, LEBAK, BANTEN",9,103,103,206
https://kawalpemilu.org#52066,"SANGKANMANIK, CIMARGA, LEBAK, BANTEN",10,38,109,147
https://kawalpemilu.org#52067,"SANGIANGJAYA, CIMARGA, LEBAK, BANTEN",1,48,117,165
https://kawalpemilu.org#52067,"SANGIANGJAYA, CIMARGA, LEBAK, BANTEN",2,21,125,146
https://kawalpemilu.org#52067,"SANGIANGJAYA, CIMARGA, LEBAK, BANTEN",3,33,104,137
https://kawalpemilu.org#52067,"SANGIANGJAYA, CIMARGA, LEBAK, BANTEN",4,21,78,99
https://kawalpemilu.org#52067,"SANGIANGJAYA, CIMARGA, LEBAK, BANTEN",5,19,112,131
https://kawalpemilu.org#52067,"SANGIANGJAYA, CIMARGA, LEBAK, BANTEN",6,20,163,183
https://kawalpemilu.org#52067,"SANGIANGJAYA, CIMARGA, LEBAK, BANTEN",7,31,119,150
https://kawalpemilu.org#52067,"SANGIANGJAYA, CIMARGA, LEBAK, BANTEN",8,38,125,163
https://kawalpemilu.org#52067,"SANGIANGJAYA, CIMARGA, LEBAK, BANTEN",9,36,83,119
https://kawalpemilu.org#52067,"SANGIANGJAYA, CIMARGA, LEBAK, BANTEN",10,38,81,119
https://kawalpemilu.org#52067,"SANGIANGJAYA, CIMARGA, LEBAK, BANTEN",11,33,92,125
https://kawalpemilu.org#52067,"SANGIANGJAYA, CIMARGA, LEBAK, BANTEN",12,25,156,181
https://kawalpemilu.org#52068,"MEKARMULYA, CIMARGA, LEBAK, BANTEN",1,31,138,169
https://kawalpemilu.org#52068,"MEKARMULYA, CIMARGA, LEBAK, BANTEN",2,48,114,162
https://kawalpemilu.org#52068,"MEKARMULYA, CIMARGA, LEBAK, BANTEN",3,81,92,173
https://kawalpemilu.org#52068,"MEKARMULYA, CIMARGA, LEBAK, BANTEN",4,67,101,168
https://kawalpemilu.org#52068,"MEKARMULYA, CIMARGA, LEBAK, BANTEN",5,116,82,198
https://kawalpemilu.org#52068,"MEKARMULYA, CIMARGA, LEBAK, BANTEN",6,82,90,172
https://kawalpemilu.org#52068,"MEKARMULYA, CIMARGA, LEBAK, BANTEN",7,41,130,171
https://kawalpemilu.org#52068,"MEKARMULYA, CIMARGA, LEBAK, BANTEN",8,31,119,150
https://kawalpemilu.org#52068,"MEKARMULYA, CIMARGA, LEBAK, BANTEN",9,64,109,173
https://kawalpemilu.org#52068,"MEKARMULYA, CIMARGA, LEBAK, BANTEN",10,71,86,157
https://kawalpemilu.org#52070,"MARAYA, SAJIRA, LEBAK, BANTEN",1,70,103,173
https://kawalpemilu.org#52070,"MARAYA, SAJIRA, LEBAK, BANTEN",2,34,161,195
https://kawalpemilu.org#52070,"MARAYA, SAJIRA, LEBAK, BANTEN",3,43,135,178
https://kawalpemilu.org#52070,"MARAYA, SAJIRA, LEBAK, BANTEN",4,42,119,161
https://kawalpemilu.org#52070,"MARAYA, SAJIRA, LEBAK, BANTEN",5,39,132,171
https://kawalpemilu.org#52070,"MARAYA, SAJIRA, LEBAK, BANTEN",6,30,112,142
https://kawalpemilu.org#52070,"MARAYA, SAJIRA, LEBAK, BANTEN",7,47,137,184
https://kawalpemilu.org#52070,"MARAYA, SAJIRA, LEBAK, BANTEN",8,38,188,226
https://kawalpemilu.org#52070,"MARAYA, SAJIRA, LEBAK, BANTEN",9,34,176,210
https://kawalpemilu.org#52070,"MARAYA, SAJIRA, LEBAK, BANTEN",10,31,200,231
https://kawalpemilu.org#52070,"MARAYA, SAJIRA, LEBAK, BANTEN",11,41,180,221
https://kawalpemilu.org#52070,"MARAYA, SAJIRA, LEBAK, BANTEN",12,77,151,228
https://kawalpemilu.org#52071,"SAJIRA, SAJIRA, LEBAK, BANTEN",1,50,151,201
https://kawalpemilu.org#52071,"SAJIRA, SAJIRA, LEBAK, BANTEN",2,41,179,220
https://kawalpemilu.org#52071,"SAJIRA, SAJIRA, LEBAK, BANTEN",3,38,136,174
https://kawalpemilu.org#52071,"SAJIRA, SAJIRA, LEBAK, BANTEN",4,62,161,223
https://kawalpemilu.org#52071,"SAJIRA, SAJIRA, LEBAK, BANTEN",5,65,142,207
https://kawalpemilu.org#52071,"SAJIRA, SAJIRA, LEBAK, BANTEN",6,29,174,203
https://kawalpemilu.org#52071,"SAJIRA, SAJIRA, LEBAK, BANTEN",7,16,190,206
https://kawalpemilu.org#52071,"SAJIRA, SAJIRA, LEBAK, BANTEN",8,25,183,208
https://kawalpemilu.org#52071,"SAJIRA, SAJIRA, LEBAK, BANTEN",9,28,151,179
https://kawalpemilu.org#52072,"SUKARAME, SAJIRA, LEBAK, BANTEN",1,28,179,207
https://kawalpemilu.org#52072,"SUKARAME, SAJIRA, LEBAK, BANTEN",2,27,165,192
https://kawalpemilu.org#52072,"SUKARAME, SAJIRA, LEBAK, BANTEN",3,28,150,178
https://kawalpemilu.org#52072,"SUKARAME, SAJIRA, LEBAK, BANTEN",4,17,167,184
https://kawalpemilu.org#52072,"SUKARAME, SAJIRA, LEBAK, BANTEN",5,19,124,143
https://kawalpemilu.org#52072,"SUKARAME, SAJIRA, LEBAK, BANTEN",6,35,157,192
https://kawalpemilu.org#52072,"SUKARAME, SAJIRA, LEBAK, BANTEN",7,79,130,209
https://kawalpemilu.org#52072,"SUKARAME, SAJIRA, LEBAK, BANTEN",8,61,162,223
https://kawalpemilu.org#52072,"SUKARAME, SAJIRA, LEBAK, BANTEN",9,101,117,218
https://kawalpemilu.org#52073,"CALUNGBUNGUR, SAJIRA, LEBAK, BANTEN",1,37,119,156
https://kawalpemilu.org#52073,"CALUNGBUNGUR, SAJIRA, LEBAK, BANTEN",2,31,127,158
https://kawalpemilu.org#52073,"CALUNGBUNGUR, SAJIRA, LEBAK, BANTEN",3,38,136,174
https://kawalpemilu.org#52073,"CALUNGBUNGUR, SAJIRA, LEBAK, BANTEN",4,30,156,186
https://kawalpemilu.org#52073,"CALUNGBUNGUR, SAJIRA, LEBAK, BANTEN",5,42,137,179
https://kawalpemilu.org#52073,"CALUNGBUNGUR, SAJIRA, LEBAK, BANTEN",6,40,176,216
https://kawalpemilu.org#52073,"CALUNGBUNGUR, SAJIRA, LEBAK, BANTEN",7,57,86,143
https://kawalpemilu.org#52073,"CALUNGBUNGUR, SAJIRA, LEBAK, BANTEN",8,67,110,177
https://kawalpemilu.org#52073,"CALUNGBUNGUR, SAJIRA, LEBAK, BANTEN",9,48,179,227
https://kawalpemilu.org#52074,"PARUNGSARI, SAJIRA, LEBAK, BANTEN",1,42,177,219
https://kawalpemilu.org#52074,"PARUNGSARI, SAJIRA, LEBAK, BANTEN",2,20,197,217
https://kawalpemilu.org#52074,"PARUNGSARI, SAJIRA, LEBAK, BANTEN",3,29,155,184
https://kawalpemilu.org#52074,"PARUNGSARI, SAJIRA, LEBAK, BANTEN",4,18,172,190
https://kawalpemilu.org#52074,"PARUNGSARI, SAJIRA, LEBAK, BANTEN",5,33,159,192
https://kawalpemilu.org#52074,"PARUNGSARI, SAJIRA, LEBAK, BANTEN",6,53,167,220
https://kawalpemilu.org#52074,"PARUNGSARI, SAJIRA, LEBAK, BANTEN",7,38,184,222
https://kawalpemilu.org#52074,"PARUNGSARI, SAJIRA, LEBAK, BANTEN",8,49,193,242
https://kawalpemilu.org#52074,"PARUNGSARI, SAJIRA, LEBAK, BANTEN",9,27,203,230
https://kawalpemilu.org#52074,"PARUNGSARI, SAJIRA, LEBAK, BANTEN",10,38,184,222
https://kawalpemilu.org#52074,"PARUNGSARI, SAJIRA, LEBAK, BANTEN",11,52,179,231
https://kawalpemilu.org#52074,"PARUNGSARI, SAJIRA, LEBAK, BANTEN",12,58,160,218
https://kawalpemilu.org#52074,"PARUNGSARI, SAJIRA, LEBAK, BANTEN",13,43,173,215
https://kawalpemilu.org#52075,"SINDANGSARI, SAJIRA, LEBAK, BANTEN",1,56,184,240
https://kawalpemilu.org#52075,"SINDANGSARI, SAJIRA, LEBAK, BANTEN",2,87,105,192
https://kawalpemilu.org#52075,"SINDANGSARI, SAJIRA, LEBAK, BANTEN",3,56,143,199
https://kawalpemilu.org#52075,"SINDANGSARI, SAJIRA, LEBAK, BANTEN",4,13,170,183
https://kawalpemilu.org#52075,"SINDANGSARI, SAJIRA, LEBAK, BANTEN",5,32,153,185
https://kawalpemilu.org#52075,"SINDANGSARI, SAJIRA, LEBAK, BANTEN",6,31,154,185
https://kawalpemilu.org#52075,"SINDANGSARI, SAJIRA, LEBAK, BANTEN",7,47,143,190
https://kawalpemilu.org#52075,"SINDANGSARI, SAJIRA, LEBAK, BANTEN",8,24,133,157
https://kawalpemilu.org#52075,"SINDANGSARI, SAJIRA, LEBAK, BANTEN",9,57,152,209
https://kawalpemilu.org#52075,"SINDANGSARI, SAJIRA, LEBAK, BANTEN",10,55,138,193
https://kawalpemilu.org#52076,"MEKARSARI, SAJIRA, LEBAK, BANTEN",1,71,167,238
https://kawalpemilu.org#52076,"MEKARSARI, SAJIRA, LEBAK, BANTEN",2,68,117,185
https://kawalpemilu.org#52076,"MEKARSARI, SAJIRA, LEBAK, BANTEN",3,79,139,218
https://kawalpemilu.org#52076,"MEKARSARI, SAJIRA, LEBAK, BANTEN",4,73,166,239
https://kawalpemilu.org#52076,"MEKARSARI, SAJIRA, LEBAK, BANTEN",5,59,150,209
https://kawalpemilu.org#52076,"MEKARSARI, SAJIRA, LEBAK, BANTEN",6,37,163,200
https://kawalpemilu.org#52076,"MEKARSARI, SAJIRA, LEBAK, BANTEN",7,44,135,179
https://kawalpemilu.org#52076,"MEKARSARI, SAJIRA, LEBAK, BANTEN",8,21,108,129
https://kawalpemilu.org#52076,"MEKARSARI, SAJIRA, LEBAK, BANTEN",9,45,92,137
https://kawalpemilu.org#52077,"SUKAMARGA, SAJIRA, LEBAK, BANTEN",1,44,123,167
https://kawalpemilu.org#52077,"SUKAMARGA, SAJIRA, LEBAK, BANTEN",2,51,130,181
https://kawalpemilu.org#52077,"SUKAMARGA, SAJIRA, LEBAK, BANTEN",3,39,138,177
https://kawalpemilu.org#52077,"SUKAMARGA, SAJIRA, LEBAK, BANTEN",4,45,162,207
https://kawalpemilu.org#52077,"SUKAMARGA, SAJIRA, LEBAK, BANTEN",5,21,178,199
https://kawalpemilu.org#52077,"SUKAMARGA, SAJIRA, LEBAK, BANTEN",6,55,163,218
https://kawalpemilu.org#52077,"SUKAMARGA, SAJIRA, LEBAK, BANTEN",7,45,140,185
https://kawalpemilu.org#52077,"SUKAMARGA, SAJIRA, LEBAK, BANTEN",8,48,145,193
https://kawalpemilu.org#52077,"SUKAMARGA, SAJIRA, LEBAK, BANTEN",9,52,115,167
https://kawalpemilu.org#52077,"SUKAMARGA, SAJIRA, LEBAK, BANTEN",10,67,115,182
https://kawalpemilu.org#52077,"SUKAMARGA, SAJIRA, LEBAK, BANTEN",11,65,98,163
https://kawalpemilu.org#52078,"PAJAGAN, SAJIRA, LEBAK, BANTEN",1,39,182,221
https://kawalpemilu.org#52078,"PAJAGAN, SAJIRA, LEBAK, BANTEN",2,30,181,211
https://kawalpemilu.org#52078,"PAJAGAN, SAJIRA, LEBAK, BANTEN",3,18,153,171
https://kawalpemilu.org#52078,"PAJAGAN, SAJIRA, LEBAK, BANTEN",4,33,153,186
https://kawalpemilu.org#52078,"PAJAGAN, SAJIRA, LEBAK, BANTEN",5,51,157,208
https://kawalpemilu.org#52078,"PAJAGAN, SAJIRA, LEBAK, BANTEN",6,36,165,201
https://kawalpemilu.org#52078,"PAJAGAN, SAJIRA, LEBAK, BANTEN",7,66,178,244
https://kawalpemilu.org#52078,"PAJAGAN, SAJIRA, LEBAK, BANTEN",8,60,121,181
https://kawalpemilu.org#52078,"PAJAGAN, SAJIRA, LEBAK, BANTEN",9,54,156,210
https://kawalpemilu.org#52078,"PAJAGAN, SAJIRA, LEBAK, BANTEN",10,36,148,184
https://kawalpemilu.org#52078,"PAJAGAN, SAJIRA, LEBAK, BANTEN",11,49,140,189
https://kawalpemilu.org#52078,"PAJAGAN, SAJIRA, LEBAK, BANTEN",12,55,140,195
https://kawalpemilu.org#52079,"SUKAJAYA, SAJIRA, LEBAK, BANTEN",1,33,169,202
https://kawalpemilu.org#52079,"SUKAJAYA, SAJIRA, LEBAK, BANTEN",2,29,149,178
https://kawalpemilu.org#52079,"SUKAJAYA, SAJIRA, LEBAK, BANTEN",3,21,166,187
https://kawalpemilu.org#52079,"SUKAJAYA, SAJIRA, LEBAK, BANTEN",4,28,143,171
https://kawalpemilu.org#52079,"SUKAJAYA, SAJIRA, LEBAK, BANTEN",5,39,189,228
https://kawalpemilu.org#52079,"SUKAJAYA, SAJIRA, LEBAK, BANTEN",6,55,167,222
https://kawalpemilu.org#52079,"SUKAJAYA, SAJIRA, LEBAK, BANTEN",7,61,107,168
https://kawalpemilu.org#52079,"SUKAJAYA, SAJIRA, LEBAK, BANTEN",8,23,142,165
https://kawalpemilu.org#52080,"SAJIRA MEKAR, SAJIRA, LEBAK, BANTEN",1,64,173,237
https://kawalpemilu.org#52080,"SAJIRA MEKAR, SAJIRA, LEBAK, BANTEN",2,37,188,225
https://kawalpemilu.org#52080,"SAJIRA MEKAR, SAJIRA, LEBAK, BANTEN",3,75,166,241
https://kawalpemilu.org#52080,"SAJIRA MEKAR, SAJIRA, LEBAK, BANTEN",4,53,141,194
https://kawalpemilu.org#52080,"SAJIRA MEKAR, SAJIRA, LEBAK, BANTEN",5,62,153,215
https://kawalpemilu.org#52080,"SAJIRA MEKAR, SAJIRA, LEBAK, BANTEN",6,48,164,212
https://kawalpemilu.org#52080,"SAJIRA MEKAR, SAJIRA, LEBAK, BANTEN",7,30,73,103
https://kawalpemilu.org#52080,"SAJIRA MEKAR, SAJIRA, LEBAK, BANTEN",8,44,113,157
https://kawalpemilu.org#52080,"SAJIRA MEKAR, SAJIRA, LEBAK, BANTEN",9,76,148,224
https://kawalpemilu.org#52081,"PAJA, SAJIRA, LEBAK, BANTEN",1,96,80,176
https://kawalpemilu.org#52081,"PAJA, SAJIRA, LEBAK, BANTEN",2,49,129,178
https://kawalpemilu.org#52081,"PAJA, SAJIRA, LEBAK, BANTEN",3,32,135,167
https://kawalpemilu.org#52081,"PAJA, SAJIRA, LEBAK, BANTEN",4,46,104,150
https://kawalpemilu.org#52081,"PAJA, SAJIRA, LEBAK, BANTEN",5,22,134,156
https://kawalpemilu.org#52081,"PAJA, SAJIRA, LEBAK, BANTEN",6,34,131,165
https://kawalpemilu.org#52082,"MARGALUYU, SAJIRA, LEBAK, BANTEN",1,72,139,211
https://kawalpemilu.org#52082,"MARGALUYU, SAJIRA, LEBAK, BANTEN",2,61,147,208
https://kawalpemilu.org#52082,"MARGALUYU, SAJIRA, LEBAK, BANTEN",3,51,151,202
https://kawalpemilu.org#52082,"MARGALUYU, SAJIRA, LEBAK, BANTEN",4,46,147,193
https://kawalpemilu.org#52082,"MARGALUYU, SAJIRA, LEBAK, BANTEN",5,65,118,183
https://kawalpemilu.org#52082,"MARGALUYU, SAJIRA, LEBAK, BANTEN",6,32,162,194
https://kawalpemilu.org#52082,"MARGALUYU, SAJIRA, LEBAK, BANTEN",7,43,155,198
https://kawalpemilu.org#52082,"MARGALUYU, SAJIRA, LEBAK, BANTEN",8,64,146,210
https://kawalpemilu.org#52082,"MARGALUYU, SAJIRA, LEBAK, BANTEN",9,45,95,140
https://kawalpemilu.org#52082,"MARGALUYU, SAJIRA, LEBAK, BANTEN",10,47,79,126
https://kawalpemilu.org#52082,"MARGALUYU, SAJIRA, LEBAK, BANTEN",11,58,112,170
https://kawalpemilu.org#52082,"MARGALUYU, SAJIRA, LEBAK, BANTEN",12,50,131,181
https://kawalpemilu.org#52083,"BUNGURMEKAR, SAJIRA, LEBAK, BANTEN",1,42,178,220
https://kawalpemilu.org#52083,"BUNGURMEKAR, SAJIRA, LEBAK, BANTEN",2,60,145,205
https://kawalpemilu.org#52083,"BUNGURMEKAR, SAJIRA, LEBAK, BANTEN",3,89,144,233
https://kawalpemilu.org#52083,"BUNGURMEKAR, SAJIRA, LEBAK, BANTEN",4,26,187,213
https://kawalpemilu.org#52083,"BUNGURMEKAR, SAJIRA, LEBAK, BANTEN",5,53,128,181
https://kawalpemilu.org#52083,"BUNGURMEKAR, SAJIRA, LEBAK, BANTEN",7,51,120,171
https://kawalpemilu.org#52083,"BUNGURMEKAR, SAJIRA, LEBAK, BANTEN",8,55,74,129
https://kawalpemilu.org#52084,"CIUYAH, SAJIRA, LEBAK, BANTEN",1,21,158,179
https://kawalpemilu.org#52084,"CIUYAH, SAJIRA, LEBAK, BANTEN",2,25,174,199
https://kawalpemilu.org#52084,"CIUYAH, SAJIRA, LEBAK, BANTEN",3,41,140,181
https://kawalpemilu.org#52084,"CIUYAH, SAJIRA, LEBAK, BANTEN",4,32,153,185
https://kawalpemilu.org#52084,"CIUYAH, SAJIRA, LEBAK, BANTEN",5,40,149,189
https://kawalpemilu.org#52084,"CIUYAH, SAJIRA, LEBAK, BANTEN",6,23,165,188
https://kawalpemilu.org#52084,"CIUYAH, SAJIRA, LEBAK, BANTEN",7,76,135,211
https://kawalpemilu.org#52084,"CIUYAH, SAJIRA, LEBAK, BANTEN",8,65,113,178
https://kawalpemilu.org#52084,"CIUYAH, SAJIRA, LEBAK, BANTEN",9,75,137,212
https://kawalpemilu.org#52084,"CIUYAH, SAJIRA, LEBAK, BANTEN",10,37,188,225
https://kawalpemilu.org#52084,"CIUYAH, SAJIRA, LEBAK, BANTEN",11,69,198,267
https://kawalpemilu.org#52084,"CIUYAH, SAJIRA, LEBAK, BANTEN",12,58,188,246
https://kawalpemilu.org#52084,"CIUYAH, SAJIRA, LEBAK, BANTEN",13,79,174,253
https://kawalpemilu.org#52084,"CIUYAH, SAJIRA, LEBAK, BANTEN",14,54,150,204
https://kawalpemilu.org#52086,"TANJUNGSARI, MAJA, LEBAK, BANTEN",1,50,98,148
https://kawalpemilu.org#52086,"TANJUNGSARI, MAJA, LEBAK, BANTEN",2,33,129,162
https://kawalpemilu.org#52086,"TANJUNGSARI, MAJA, LEBAK, BANTEN",3,71,84,155
https://kawalpemilu.org#52086,"TANJUNGSARI, MAJA, LEBAK, BANTEN",4,29,156,185
https://kawalpemilu.org#52086,"TANJUNGSARI, MAJA, LEBAK, BANTEN",5,66,89,155
https://kawalpemilu.org#52086,"TANJUNGSARI, MAJA, LEBAK, BANTEN",6,42,106,148
https://kawalpemilu.org#52086,"TANJUNGSARI, MAJA, LEBAK, BANTEN",7,57,130,187
https://kawalpemilu.org#52086,"TANJUNGSARI, MAJA, LEBAK, BANTEN",8,41,127,168
https://kawalpemilu.org#52086,"TANJUNGSARI, MAJA, LEBAK, BANTEN",9,76,76,152
https://kawalpemilu.org#52086,"TANJUNGSARI, MAJA, LEBAK, BANTEN",10,34,119,153
https://kawalpemilu.org#52086,"TANJUNGSARI, MAJA, LEBAK, BANTEN",11,26,153,179
https://kawalpemilu.org#52086,"TANJUNGSARI, MAJA, LEBAK, BANTEN",12,15,165,180
https://kawalpemilu.org#52087,"MAJA, MAJA, LEBAK, BANTEN",1,67,165,232
https://kawalpemilu.org#52087,"MAJA, MAJA, LEBAK, BANTEN",2,87,144,231
https://kawalpemilu.org#52087,"MAJA, MAJA, LEBAK, BANTEN",3,74,139,213
https://kawalpemilu.org#52087,"MAJA, MAJA, LEBAK, BANTEN",4,86,169,255
https://kawalpemilu.org#52087,"MAJA, MAJA, LEBAK, BANTEN",5,45,206,251
https://kawalpemilu.org#52087,"MAJA, MAJA, LEBAK, BANTEN",6,112,137,249
https://kawalpemilu.org#52087,"MAJA, MAJA, LEBAK, BANTEN",7,99,126,225
https://kawalpemilu.org#52087,"MAJA, MAJA, LEBAK, BANTEN",8,62,155,217
https://kawalpemilu.org#52087,"MAJA, MAJA, LEBAK, BANTEN",9,57,162,219
https://kawalpemilu.org#52087,"MAJA, MAJA, LEBAK, BANTEN",10,82,156,238
https://kawalpemilu.org#52087,"MAJA, MAJA, LEBAK, BANTEN",11,70,149,219
https://kawalpemilu.org#52087,"MAJA, MAJA, LEBAK, BANTEN",12,92,113,205
https://kawalpemilu.org#52087,"MAJA, MAJA, LEBAK, BANTEN",13,91,113,204
https://kawalpemilu.org#52087,"MAJA, MAJA, LEBAK, BANTEN",14,88,130,218
https://kawalpemilu.org#52087,"MAJA, MAJA, LEBAK, BANTEN",15,37,51,88
https://kawalpemilu.org#52088,"SANGIANG, MAJA, LEBAK, BANTEN",1,32,191,223
https://kawalpemilu.org#52088,"SANGIANG, MAJA, LEBAK, BANTEN",2,55,168,223
https://kawalpemilu.org#52088,"SANGIANG, MAJA, LEBAK, BANTEN",3,79,124,203
https://kawalpemilu.org#52088,"SANGIANG, MAJA, LEBAK, BANTEN",4,81,127,208
https://kawalpemilu.org#52088,"SANGIANG, MAJA, LEBAK, BANTEN",5,82,117,199
https://kawalpemilu.org#52088,"SANGIANG, MAJA, LEBAK, BANTEN",6,54,133,187
https://kawalpemilu.org#52088,"SANGIANG, MAJA, LEBAK, BANTEN",7,52,147,199
https://kawalpemilu.org#52088,"SANGIANG, MAJA, LEBAK, BANTEN",8,42,159,201
https://kawalpemilu.org#52088,"SANGIANG, MAJA, LEBAK, BANTEN",9,88,121,209
https://kawalpemilu.org#52088,"SANGIANG, MAJA, LEBAK, BANTEN",10,56,100,156
https://kawalpemilu.org#52088,"SANGIANG, MAJA, LEBAK, BANTEN",11,51,112,163
https://kawalpemilu.org#52088,"SANGIANG, MAJA, LEBAK, BANTEN",12,46,88,134
https://kawalpemilu.org#52089,"BINONG, MAJA, LEBAK, BANTEN",1,24,185,209
https://kawalpemilu.org#52089,"BINONG, MAJA, LEBAK, BANTEN",2,23,196,219
https://kawalpemilu.org#52089,"BINONG, MAJA, LEBAK, BANTEN",3,43,167,210
https://kawalpemilu.org#52089,"BINONG, MAJA, LEBAK, BANTEN",4,11,179,190
https://kawalpemilu.org#52089,"BINONG, MAJA, LEBAK, BANTEN",5,17,130,147
https://kawalpemilu.org#52089,"BINONG, MAJA, LEBAK, BANTEN",6,18,193,211
https://kawalpemilu.org#52089,"BINONG, MAJA, LEBAK, BANTEN",7,30,192,222
https://kawalpemilu.org#52089,"BINONG, MAJA, LEBAK, BANTEN",8,46,149,195
https://kawalpemilu.org#52089,"BINONG, MAJA, LEBAK, BANTEN",9,11,181,192
https://kawalpemilu.org#52089,"BINONG, MAJA, LEBAK, BANTEN",10,64,132,196
https://kawalpemilu.org#52089,"BINONG, MAJA, LEBAK, BANTEN",11,32,164,196
https://kawalpemilu.org#52089,"BINONG, MAJA, LEBAK, BANTEN",12,43,154,197
https://kawalpemilu.org#52089,"BINONG, MAJA, LEBAK, BANTEN",13,20,148,168
https://kawalpemilu.org#52090,"GUBUGAN CIBEUREUM, MAJA, LEBAK, BANTEN",1,72,134,206
https://kawalpemilu.org#52090,"GUBUGAN CIBEUREUM, MAJA, LEBAK, BANTEN",2,44,189,233
https://kawalpemilu.org#52090,"GUBUGAN CIBEUREUM, MAJA, LEBAK, BANTEN",3,39,203,242
https://kawalpemilu.org#52090,"GUBUGAN CIBEUREUM, MAJA, LEBAK, BANTEN",4,44,168,212
https://kawalpemilu.org#52090,"GUBUGAN CIBEUREUM, MAJA, LEBAK, BANTEN",5,54,165,219
https://kawalpemilu.org#52090,"GUBUGAN CIBEUREUM, MAJA, LEBAK, BANTEN",6,64,168,232
https://kawalpemilu.org#52090,"GUBUGAN CIBEUREUM, MAJA, LEBAK, BANTEN",7,28,186,214
https://kawalpemilu.org#52090,"GUBUGAN CIBEUREUM, MAJA, LEBAK, BANTEN",8,43,164,207
https://kawalpemilu.org#52091,"MEKARSARI, MAJA, LEBAK, BANTEN",1,41,147,188
https://kawalpemilu.org#52091,"MEKARSARI, MAJA, LEBAK, BANTEN",2,53,137,190
https://kawalpemilu.org#52091,"MEKARSARI, MAJA, LEBAK, BANTEN",3,39,159,198
https://kawalpemilu.org#52091,"MEKARSARI, MAJA, LEBAK, BANTEN",4,39,174,213
https://kawalpemilu.org#52091,"MEKARSARI, MAJA, LEBAK, BANTEN",5,18,175,193
https://kawalpemilu.org#52091,"MEKARSARI, MAJA, LEBAK, BANTEN",6,18,152,170
https://kawalpemilu.org#52091,"MEKARSARI, MAJA, LEBAK, BANTEN",7,35,179,214
https://kawalpemilu.org#52091,"MEKARSARI, MAJA, LEBAK, BANTEN",8,28,164,192
https://kawalpemilu.org#52092,"PADASUKA, MAJA, LEBAK, BANTEN",1,12,160,172
https://kawalpemilu.org#52092,"PADASUKA, MAJA, LEBAK, BANTEN",2,13,132,145
https://kawalpemilu.org#52092,"PADASUKA, MAJA, LEBAK, BANTEN",3,18,205,223
https://kawalpemilu.org#52092,"PADASUKA, MAJA, LEBAK, BANTEN",4,15,205,220
https://kawalpemilu.org#52092,"PADASUKA, MAJA, LEBAK, BANTEN",5,17,205,222
https://kawalpemilu.org#52092,"PADASUKA, MAJA, LEBAK, BANTEN",6,14,154,168
https://kawalpemilu.org#52092,"PADASUKA, MAJA, LEBAK, BANTEN",7,25,147,172
https://kawalpemilu.org#52092,"PADASUKA, MAJA, LEBAK, BANTEN",8,28,133,161
https://kawalpemilu.org#52092,"PADASUKA, MAJA, LEBAK, BANTEN",9,29,128,157
https://kawalpemilu.org#52092,"PADASUKA, MAJA, LEBAK, BANTEN",10,20,168,198
https://kawalpemilu.org#52092,"PADASUKA, MAJA, LEBAK, BANTEN",11,11,197,208
https://kawalpemilu.org#52092,"PADASUKA, MAJA, LEBAK, BANTEN",12,30,174,204
https://kawalpemilu.org#52092,"PADASUKA, MAJA, LEBAK, BANTEN",13,17,176,193
https://kawalpemilu.org#52092,"PADASUKA, MAJA, LEBAK, BANTEN",14,34,180,214
https://kawalpemilu.org#52092,"PADASUKA, MAJA, LEBAK, BANTEN",15,18,206,224
https://kawalpemilu.org#52093,"CURUGBADAK, MAJA, LEBAK, BANTEN",1,44,177,221
https://kawalpemilu.org#52093,"CURUGBADAK, MAJA, LEBAK, BANTEN",2,74,145,219
https://kawalpemilu.org#52093,"CURUGBADAK, MAJA, LEBAK, BANTEN",3,90,122,212
https://kawalpemilu.org#52093,"CURUGBADAK, MAJA, LEBAK, BANTEN",4,73,151,224
https://kawalpemilu.org#52093,"CURUGBADAK, MAJA, LEBAK, BANTEN",5,73,138,211
https://kawalpemilu.org#52093,"CURUGBADAK, MAJA, LEBAK, BANTEN",6,67,150,217
https://kawalpemilu.org#52093,"CURUGBADAK, MAJA, LEBAK, BANTEN",7,76,133,209
https://kawalpemilu.org#52093,"CURUGBADAK, MAJA, LEBAK, BANTEN",8,70,157,227
https://kawalpemilu.org#52093,"CURUGBADAK, MAJA, LEBAK, BANTEN",9,55,143,198
https://kawalpemilu.org#52093,"CURUGBADAK, MAJA, LEBAK, BANTEN",10,66,144,210
https://kawalpemilu.org#52093,"CURUGBADAK, MAJA, LEBAK, BANTEN",11,100,116,216
https://kawalpemilu.org#52093,"CURUGBADAK, MAJA, LEBAK, BANTEN",12,46,147,193
https://kawalpemilu.org#52093,"CURUGBADAK, MAJA, LEBAK, BANTEN",13,45,168,213
https://kawalpemilu.org#52093,"CURUGBADAK, MAJA, LEBAK, BANTEN",14,39,158,197
https://kawalpemilu.org#52093,"CURUGBADAK, MAJA, LEBAK, BANTEN",15,62,138,200
https://kawalpemilu.org#52093,"CURUGBADAK, MAJA, LEBAK, BANTEN",16,41,141,182
https://kawalpemilu.org#52094,"SINDANGMULYA, MAJA, LEBAK, BANTEN",1,77,138,215
https://kawalpemilu.org#52094,"SINDANGMULYA, MAJA, LEBAK, BANTEN",2,31,146,177
https://kawalpemilu.org#52094,"SINDANGMULYA, MAJA, LEBAK, BANTEN",3,67,168,235
https://kawalpemilu.org#52094,"SINDANGMULYA, MAJA, LEBAK, BANTEN",4,46,162,208
https://kawalpemilu.org#52094,"SINDANGMULYA, MAJA, LEBAK, BANTEN",5,46,171,217
https://kawalpemilu.org#52094,"SINDANGMULYA, MAJA, LEBAK, BANTEN",6,75,125,200
https://kawalpemilu.org#52094,"SINDANGMULYA, MAJA, LEBAK, BANTEN",7,50,164,214
https://kawalpemilu.org#52094,"SINDANGMULYA, MAJA, LEBAK, BANTEN",8,29,143,172
https://kawalpemilu.org#52094,"SINDANGMULYA, MAJA, LEBAK, BANTEN",9,29,147,176
https://kawalpemilu.org#52094,"SINDANGMULYA, MAJA, LEBAK, BANTEN",10,33,181,214
https://kawalpemilu.org#52094,"SINDANGMULYA, MAJA, LEBAK, BANTEN",11,43,126,169
https://kawalpemilu.org#52094,"SINDANGMULYA, MAJA, LEBAK, BANTEN",12,61,156,217
https://kawalpemilu.org#52094,"SINDANGMULYA, MAJA, LEBAK, BANTEN",13,64,149,213
https://kawalpemilu.org#52094,"SINDANGMULYA, MAJA, LEBAK, BANTEN",14,66,176,242
https://kawalpemilu.org#52094,"SINDANGMULYA, MAJA, LEBAK, BANTEN",15,77,120,198
https://kawalpemilu.org#52095,"CILANGKAP, MAJA, LEBAK, BANTEN",1,72,111,183
https://kawalpemilu.org#52095,"CILANGKAP, MAJA, LEBAK, BANTEN",2,46,108,154
https://kawalpemilu.org#52095,"CILANGKAP, MAJA, LEBAK, BANTEN",3,39,133,172
https://kawalpemilu.org#52095,"CILANGKAP, MAJA, LEBAK, BANTEN",4,66,94,160
https://kawalpemilu.org#52095,"CILANGKAP, MAJA, LEBAK, BANTEN",5,46,125,171
https://kawalpemilu.org#52095,"CILANGKAP, MAJA, LEBAK, BANTEN",6,81,94,175
https://kawalpemilu.org#52095,"CILANGKAP, MAJA, LEBAK, BANTEN",7,33,162,195
https://kawalpemilu.org#52095,"CILANGKAP, MAJA, LEBAK, BANTEN",8,31,148,179
https://kawalpemilu.org#52095,"CILANGKAP, MAJA, LEBAK, BANTEN",9,56,137,193
https://kawalpemilu.org#52095,"CILANGKAP, MAJA, LEBAK, BANTEN",10,90,89,179
https://kawalpemilu.org#52095,"CILANGKAP, MAJA, LEBAK, BANTEN",11,32,127,159
https://kawalpemilu.org#52096,"PASIRKEMBANG, MAJA, LEBAK, BANTEN",1,52,171,226
https://kawalpemilu.org#52096,"PASIRKEMBANG, MAJA, LEBAK, BANTEN",2,72,128,200
https://kawalpemilu.org#52096,"PASIRKEMBANG, MAJA, LEBAK, BANTEN",3,74,132,206
https://kawalpemilu.org#52096,"PASIRKEMBANG, MAJA, LEBAK, BANTEN",4,49,149,198
https://kawalpemilu.org#52096,"PASIRKEMBANG, MAJA, LEBAK, BANTEN",5,47,171,218
https://kawalpemilu.org#52096,"PASIRKEMBANG, MAJA, LEBAK, BANTEN",6,59,142,201
https://kawalpemilu.org#52096,"PASIRKEMBANG, MAJA, LEBAK, BANTEN",7,50,162,212
https://kawalpemilu.org#52096,"PASIRKEMBANG, MAJA, LEBAK, BANTEN",8,62,135,197
https://kawalpemilu.org#52096,"PASIRKEMBANG, MAJA, LEBAK, BANTEN",9,41,150,191
https://kawalpemilu.org#52096,"PASIRKEMBANG, MAJA, LEBAK, BANTEN",10,57,160,217
https://kawalpemilu.org#52097,"PASIRKECAPI, MAJA, LEBAK, BANTEN",1,67,142,209
https://kawalpemilu.org#52097,"PASIRKECAPI, MAJA, LEBAK, BANTEN",2,41,128,169
https://kawalpemilu.org#52097,"PASIRKECAPI, MAJA, LEBAK, BANTEN",3,79,126,205
https://kawalpemilu.org#52097,"PASIRKECAPI, MAJA, LEBAK, BANTEN",4,68,112,180
https://kawalpemilu.org#52097,"PASIRKECAPI, MAJA, LEBAK, BANTEN",5,67,141,208
https://kawalpemilu.org#52097,"PASIRKECAPI, MAJA, LEBAK, BANTEN",6,38,137,175
https://kawalpemilu.org#52097,"PASIRKECAPI, MAJA, LEBAK, BANTEN",7,43,140,183
https://kawalpemilu.org#52097,"PASIRKECAPI, MAJA, LEBAK, BANTEN",8,71,131,202
https://kawalpemilu.org#52097,"PASIRKECAPI, MAJA, LEBAK, BANTEN",9,86,128,214
https://kawalpemilu.org#52098,"BUYUT MEKAR, MAJA, LEBAK, BANTEN",1,58,131,189
https://kawalpemilu.org#52098,"BUYUT MEKAR, MAJA, LEBAK, BANTEN",2,36,132,168
https://kawalpemilu.org#52098,"BUYUT MEKAR, MAJA, LEBAK, BANTEN",3,15,132,147
https://kawalpemilu.org#52098,"BUYUT MEKAR, MAJA, LEBAK, BANTEN",4,26,160,186
https://kawalpemilu.org#52098,"BUYUT MEKAR, MAJA, LEBAK, BANTEN",5,33,144,177
https://kawalpemilu.org#52098,"BUYUT MEKAR, MAJA, LEBAK, BANTEN",6,22,160,182
https://kawalpemilu.org#52098,"BUYUT MEKAR, MAJA, LEBAK, BANTEN",7,49,83,132
https://kawalpemilu.org#52098,"BUYUT MEKAR, MAJA, LEBAK, BANTEN",8,25,142,167
https://kawalpemilu.org#52098,"BUYUT MEKAR, MAJA, LEBAK, BANTEN",9,18,86,104
https://kawalpemilu.org#52099,"MAJA BARU, MAJA, LEBAK, BANTEN",1,122,110,232
https://kawalpemilu.org#52099,"MAJA BARU, MAJA, LEBAK, BANTEN",2,62,149,211
https://kawalpemilu.org#52099,"MAJA BARU, MAJA, LEBAK, BANTEN",3,92,127,219
https://kawalpemilu.org#52099,"MAJA BARU, MAJA, LEBAK, BANTEN",4,77,157,234
https://kawalpemilu.org#52099,"MAJA BARU, MAJA, LEBAK, BANTEN",5,69,156,225
https://kawalpemilu.org#52099,"MAJA BARU, MAJA, LEBAK, BANTEN",6,80,129,209
https://kawalpemilu.org#52099,"MAJA BARU, MAJA, LEBAK, BANTEN",7,107,98,205
https://kawalpemilu.org#52099,"MAJA BARU, MAJA, LEBAK, BANTEN",8,103,126,229
https://kawalpemilu.org#52099,"MAJA BARU, MAJA, LEBAK, BANTEN",9,114,108,222
https://kawalpemilu.org#52101,"RANGKASBITUNG BARAT, RANGKASBITUNG, LEBAK, BANTEN",1,35,176,211
https://kawalpemilu.org#52101,"RANGKASBITUNG BARAT, RANGKASBITUNG, LEBAK, BANTEN",2,33,208,241
https://kawalpemilu.org#52101,"RANGKASBITUNG BARAT, RANGKASBITUNG, LEBAK, BANTEN",3,55,172,227
https://kawalpemilu.org#52101,"RANGKASBITUNG BARAT, RANGKASBITUNG, LEBAK, BANTEN",4,65,129,194
https://kawalpemilu.org#52101,"RANGKASBITUNG BARAT, RANGKASBITUNG, LEBAK, BANTEN",5,68,152,220
https://kawalpemilu.org#52101,"RANGKASBITUNG BARAT, RANGKASBITUNG, LEBAK, BANTEN",6,49,148,197
https://kawalpemilu.org#52101,"RANGKASBITUNG BARAT, RANGKASBITUNG, LEBAK, BANTEN",7,55,179,234
https://kawalpemilu.org#52101,"RANGKASBITUNG BARAT, RANGKASBITUNG, LEBAK, BANTEN",8,73,141,214
https://kawalpemilu.org#52101,"RANGKASBITUNG BARAT, RANGKASBITUNG, LEBAK, BANTEN",9,58,153,211
https://kawalpemilu.org#52101,"RANGKASBITUNG BARAT, RANGKASBITUNG, LEBAK, BANTEN",10,71,134,205
https://kawalpemilu.org#52101,"RANGKASBITUNG BARAT, RANGKASBITUNG, LEBAK, BANTEN",11,40,148,188
https://kawalpemilu.org#52101,"RANGKASBITUNG BARAT, RANGKASBITUNG, LEBAK, BANTEN",12,52,158,210
https://kawalpemilu.org#52101,"RANGKASBITUNG BARAT, RANGKASBITUNG, LEBAK, BANTEN",13,54,158,212
https://kawalpemilu.org#52101,"RANGKASBITUNG BARAT, RANGKASBITUNG, LEBAK, BANTEN",14,46,180,226
https://kawalpemilu.org#52101,"RANGKASBITUNG BARAT, RANGKASBITUNG, LEBAK, BANTEN",15,82,125,207
https://kawalpemilu.org#52101,"RANGKASBITUNG BARAT, RANGKASBITUNG, LEBAK, BANTEN",16,47,167,214
https://kawalpemilu.org#52101,"RANGKASBITUNG BARAT, RANGKASBITUNG, LEBAK, BANTEN",17,37,166,203
https://kawalpemilu.org#52101,"RANGKASBITUNG BARAT, RANGKASBITUNG, LEBAK, BANTEN",18,62,140,202
https://kawalpemilu.org#52101,"RANGKASBITUNG BARAT, RANGKASBITUNG, LEBAK, BANTEN",19,58,129,187
https://kawalpemilu.org#52101,"RANGKASBITUNG BARAT, RANGKASBITUNG, LEBAK, BANTEN",20,33,155,188
https://kawalpemilu.org#52101,"RANGKASBITUNG BARAT, RANGKASBITUNG, LEBAK, BANTEN",21,45,141,186
https://kawalpemilu.org#52102,"CIJORO LEBAK, RANGKASBITUNG, LEBAK, BANTEN",1,76,138,214
https://kawalpemilu.org#52102,"CIJORO LEBAK, RANGKASBITUNG, LEBAK, BANTEN",2,74,133,207
https://kawalpemilu.org#52102,"CIJORO LEBAK, RANGKASBITUNG, LEBAK, BANTEN",3,47,182,229
https://kawalpemilu.org#52102,"CIJORO LEBAK, RANGKASBITUNG, LEBAK, BANTEN",4,78,133,211
https://kawalpemilu.org#52102,"CIJORO LEBAK, RANGKASBITUNG, LEBAK, BANTEN",5,36,155,191
https://kawalpemilu.org#52102,"CIJORO LEBAK, RANGKASBITUNG, LEBAK, BANTEN",6,57,148,205
https://kawalpemilu.org#52102,"CIJORO LEBAK, RANGKASBITUNG, LEBAK, BANTEN",7,69,162,231
https://kawalpemilu.org#52102,"CIJORO LEBAK, RANGKASBITUNG, LEBAK, BANTEN",8,106,147,253
https://kawalpemilu.org#52102,"CIJORO LEBAK, RANGKASBITUNG, LEBAK, BANTEN",9,96,122,218
https://kawalpemilu.org#52102,"CIJORO LEBAK, RANGKASBITUNG, LEBAK, BANTEN",10,75,147,222
https://kawalpemilu.org#52102,"CIJORO LEBAK, RANGKASBITUNG, LEBAK, BANTEN",11,104,156,260
https://kawalpemilu.org#52102,"CIJORO LEBAK, RANGKASBITUNG, LEBAK, BANTEN",12,67,133,200
https://kawalpemilu.org#52102,"CIJORO LEBAK, RANGKASBITUNG, LEBAK, BANTEN",13,76,159,235
https://kawalpemilu.org#52102,"CIJORO LEBAK, RANGKASBITUNG, LEBAK, BANTEN",14,134,111,245
https://kawalpemilu.org#52102,"CIJORO LEBAK, RANGKASBITUNG, LEBAK, BANTEN",15,91,123,214
https://kawalpemilu.org#52102,"CIJORO LEBAK, RANGKASBITUNG, LEBAK, BANTEN",16,88,127,215
https://kawalpemilu.org#52102,"CIJORO LEBAK, RANGKASBITUNG, LEBAK, BANTEN",17,50,146,196
https://kawalpemilu.org#52102,"CIJORO LEBAK, RANGKASBITUNG, LEBAK, BANTEN",18,45,198,243
https://kawalpemilu.org#52102,"CIJORO LEBAK, RANGKASBITUNG, LEBAK, BANTEN",19,81,142,223
https://kawalpemilu.org#52102,"CIJORO LEBAK, RANGKASBITUNG, LEBAK, BANTEN",20,67,153,220
https://kawalpemilu.org#52102,"CIJORO LEBAK, RANGKASBITUNG, LEBAK, BANTEN",21,29,121,150
https://kawalpemilu.org#52102,"CIJORO LEBAK, RANGKASBITUNG, LEBAK, BANTEN",22,96,157,253
https://kawalpemilu.org#52102,"CIJORO LEBAK, RANGKASBITUNG, LEBAK, BANTEN",23,88,146,234
https://kawalpemilu.org#52102,"CIJORO LEBAK, RANGKASBITUNG, LEBAK, BANTEN",24,87,158,245
https://kawalpemilu.org#52102,"CIJORO LEBAK, RANGKASBITUNG, LEBAK, BANTEN",25,106,136,242
https://kawalpemilu.org#52102,"CIJORO LEBAK, RANGKASBITUNG, LEBAK, BANTEN",26,73,118,191
https://kawalpemilu.org#52102,"CIJORO LEBAK, RANGKASBITUNG, LEBAK, BANTEN",27,89,93,182
https://kawalpemilu.org#52102,"CIJORO LEBAK, RANGKASBITUNG, LEBAK, BANTEN",28,94,83,177
https://kawalpemilu.org#52102,"CIJORO LEBAK, RANGKASBITUNG, LEBAK, BANTEN",29,57,168,225
https://kawalpemilu.org#52102,"CIJORO LEBAK, RANGKASBITUNG, LEBAK, BANTEN",30,57,133,190
https://kawalpemilu.org#52103,"MUARA CIUJUNG BARAT, RANGKASBITUNG, LEBAK, BANTEN",1,51,185,236
https://kawalpemilu.org#52103,"MUARA CIUJUNG BARAT, RANGKASBITUNG, LEBAK, BANTEN",2,59,193,252
https://kawalpemilu.org#52103,"MUARA CIUJUNG BARAT, RANGKASBITUNG, LEBAK, BANTEN",3,78,184,262
https://kawalpemilu.org#52103,"MUARA CIUJUNG BARAT, RANGKASBITUNG, LEBAK, BANTEN",4,105,142,247
https://kawalpemilu.org#52103,"MUARA CIUJUNG BARAT, RANGKASBITUNG, LEBAK, BANTEN",5,91,174,265
https://kawalpemilu.org#52103,"MUARA CIUJUNG BARAT, RANGKASBITUNG, LEBAK, BANTEN",6,94,183,277
https://kawalpemilu.org#52103,"MUARA CIUJUNG BARAT, RANGKASBITUNG, LEBAK, BANTEN",7,105,124,229
https://kawalpemilu.org#52103,"MUARA CIUJUNG BARAT, RANGKASBITUNG, LEBAK, BANTEN",8,133,104,237
https://kawalpemilu.org#52103,"MUARA CIUJUNG BARAT, RANGKASBITUNG, LEBAK, BANTEN",9,108,140,248
https://kawalpemilu.org#52103,"MUARA CIUJUNG BARAT, RANGKASBITUNG, LEBAK, BANTEN",10,75,130,205
https://kawalpemilu.org#52103,"MUARA CIUJUNG BARAT, RANGKASBITUNG, LEBAK, BANTEN",11,66,148,214
https://kawalpemilu.org#52103,"MUARA CIUJUNG BARAT, RANGKASBITUNG, LEBAK, BANTEN",12,68,170,238
https://kawalpemilu.org#52103,"MUARA CIUJUNG BARAT, RANGKASBITUNG, LEBAK, BANTEN",13,62,132,194
https://kawalpemilu.org#52103,"MUARA CIUJUNG BARAT, RANGKASBITUNG, LEBAK, BANTEN",14,129,93,222
https://kawalpemilu.org#52103,"MUARA CIUJUNG BARAT, RANGKASBITUNG, LEBAK, BANTEN",15,55,144,199
https://kawalpemilu.org#52103,"MUARA CIUJUNG BARAT, RANGKASBITUNG, LEBAK, BANTEN",16,73,115,188
https://kawalpemilu.org#52103,"MUARA CIUJUNG BARAT, RANGKASBITUNG, LEBAK, BANTEN",17,73,153,226
https://kawalpemilu.org#52103,"MUARA CIUJUNG BARAT, RANGKASBITUNG, LEBAK, BANTEN",18,78,148,226
https://kawalpemilu.org#52103,"MUARA CIUJUNG BARAT, RANGKASBITUNG, LEBAK, BANTEN",19,77,115,192
https://kawalpemilu.org#52103,"MUARA CIUJUNG BARAT, RANGKASBITUNG, LEBAK, BANTEN",20,51,192,243
https://kawalpemilu.org#52103,"MUARA CIUJUNG BARAT, RANGKASBITUNG, LEBAK, BANTEN",21,66,150,216
https://kawalpemilu.org#52103,"MUARA CIUJUNG BARAT, RANGKASBITUNG, LEBAK, BANTEN",22,64,55,119
https://kawalpemilu.org#52103,"MUARA CIUJUNG BARAT, RANGKASBITUNG, LEBAK, BANTEN",23,63,119,182
https://kawalpemilu.org#52103,"MUARA CIUJUNG BARAT, RANGKASBITUNG, LEBAK, BANTEN",24,83,176,259
https://kawalpemilu.org#52103,"MUARA CIUJUNG BARAT, RANGKASBITUNG, LEBAK, BANTEN",25,77,99,176
https://kawalpemilu.org#52104,"CIJORO PASIR, RANGKASBITUNG, LEBAK, BANTEN",1,53,141,194
https://kawalpemilu.org#52104,"CIJORO PASIR, RANGKASBITUNG, LEBAK, BANTEN",2,34,152,186
https://kawalpemilu.org#52104,"CIJORO PASIR, RANGKASBITUNG, LEBAK, BANTEN",3,82,138,220
https://kawalpemilu.org#52104,"CIJORO PASIR, RANGKASBITUNG, LEBAK, BANTEN",4,67,157,224
https://kawalpemilu.org#52104,"CIJORO PASIR, RANGKASBITUNG, LEBAK, BANTEN",5,81,132,213
https://kawalpemilu.org#52104,"CIJORO PASIR, RANGKASBITUNG, LEBAK, BANTEN",6,59,142,201
https://kawalpemilu.org#52104,"CIJORO PASIR, RANGKASBITUNG, LEBAK, BANTEN",7,51,185,236
https://kawalpemilu.org#52104,"CIJORO PASIR, RANGKASBITUNG, LEBAK, BANTEN",8,49,142,191
https://kawalpemilu.org#52104,"CIJORO PASIR, RANGKASBITUNG, LEBAK, BANTEN",9,54,146,200
https://kawalpemilu.org#52104,"CIJORO PASIR, RANGKASBITUNG, LEBAK, BANTEN",10,66,184,255
https://kawalpemilu.org#52104,"CIJORO PASIR, RANGKASBITUNG, LEBAK, BANTEN",11,51,203,254
https://kawalpemilu.org#52104,"CIJORO PASIR, RANGKASBITUNG, LEBAK, BANTEN",12,76,184,260
https://kawalpemilu.org#52104,"CIJORO PASIR, RANGKASBITUNG, LEBAK, BANTEN",13,52,147,199
https://kawalpemilu.org#52104,"CIJORO PASIR, RANGKASBITUNG, LEBAK, BANTEN",14,113,139,252
https://kawalpemilu.org#52104,"CIJORO PASIR, RANGKASBITUNG, LEBAK, BANTEN",15,110,154,264
https://kawalpemilu.org#52104,"CIJORO PASIR, RANGKASBITUNG, LEBAK, BANTEN",16,52,100,152
https://kawalpemilu.org#52104,"CIJORO PASIR, RANGKASBITUNG, LEBAK, BANTEN",17,56,137,193
https://kawalpemilu.org#52104,"CIJORO PASIR, RANGKASBITUNG, LEBAK, BANTEN",18,36,141,177
https://kawalpemilu.org#52104,"CIJORO PASIR, RANGKASBITUNG, LEBAK, BANTEN",19,23,154,177
https://kawalpemilu.org#52104,"CIJORO PASIR, RANGKASBITUNG, LEBAK, BANTEN",20,64,111,175
https://kawalpemilu.org#52104,"CIJORO PASIR, RANGKASBITUNG, LEBAK, BANTEN",21,45,118,163
https://kawalpemilu.org#52104,"CIJORO PASIR, RANGKASBITUNG, LEBAK, BANTEN",22,69,143,212
https://kawalpemilu.org#52104,"CIJORO PASIR, RANGKASBITUNG, LEBAK, BANTEN",23,52,128,180
https://kawalpemilu.org#52104,"CIJORO PASIR, RANGKASBITUNG, LEBAK, BANTEN",24,64,125,189
https://kawalpemilu.org#52104,"CIJORO PASIR, RANGKASBITUNG, LEBAK, BANTEN",25,37,162,199
https://kawalpemilu.org#52104,"CIJORO PASIR, RANGKASBITUNG, LEBAK, BANTEN",26,42,162,204
https://kawalpemilu.org#52104,"CIJORO PASIR, RANGKASBITUNG, LEBAK, BANTEN",27,51,152,203
https://kawalpemilu.org#52104,"CIJORO PASIR, RANGKASBITUNG, LEBAK, BANTEN",28,83,170,253
https://kawalpemilu.org#52104,"CIJORO PASIR, RANGKASBITUNG, LEBAK, BANTEN",29,48,135,183
https://kawalpemilu.org#52104,"CIJORO PASIR, RANGKASBITUNG, LEBAK, BANTEN",30,98,143,241
https://kawalpemilu.org#52104,"CIJORO PASIR, RANGKASBITUNG, LEBAK, BANTEN",31,52,111,163
https://kawalpemilu.org#52105,"MUARA CIUJUNG TIMUR, RANGKASBITUNG, LEBAK, BANTEN",1,100,156,256
https://kawalpemilu.org#52105,"MUARA CIUJUNG TIMUR, RANGKASBITUNG, LEBAK, BANTEN",2,93,149,242
https://kawalpemilu.org#52105,"MUARA CIUJUNG TIMUR, RANGKASBITUNG, LEBAK, BANTEN",3,74,174,248
https://kawalpemilu.org#52105,"MUARA CIUJUNG TIMUR, RANGKASBITUNG, LEBAK, BANTEN",4,48,191,239
https://kawalpemilu.org#52105,"MUARA CIUJUNG TIMUR, RANGKASBITUNG, LEBAK, BANTEN",5,47,203,250
https://kawalpemilu.org#52105,"MUARA CIUJUNG TIMUR, RANGKASBITUNG, LEBAK, BANTEN",6,82,172,254
https://kawalpemilu.org#52105,"MUARA CIUJUNG TIMUR, RANGKASBITUNG, LEBAK, BANTEN",7,85,170,255
https://kawalpemilu.org#52105,"MUARA CIUJUNG TIMUR, RANGKASBITUNG, LEBAK, BANTEN",8,115,18,133
https://kawalpemilu.org#52105,"MUARA CIUJUNG TIMUR, RANGKASBITUNG, LEBAK, BANTEN",9,75,135,210
https://kawalpemilu.org#52105,"MUARA CIUJUNG TIMUR, RANGKASBITUNG, LEBAK, BANTEN",10,66,193,259
https://kawalpemilu.org#52105,"MUARA CIUJUNG TIMUR, RANGKASBITUNG, LEBAK, BANTEN",11,59,185,244
https://kawalpemilu.org#52105,"MUARA CIUJUNG TIMUR, RANGKASBITUNG, LEBAK, BANTEN",12,83,161,244
https://kawalpemilu.org#52105,"MUARA CIUJUNG TIMUR, RANGKASBITUNG, LEBAK, BANTEN",13,121,185,306
https://kawalpemilu.org#52105,"MUARA CIUJUNG TIMUR, RANGKASBITUNG, LEBAK, BANTEN",14,75,189,264
https://kawalpemilu.org#52105,"MUARA CIUJUNG TIMUR, RANGKASBITUNG, LEBAK, BANTEN",15,90,148,238
https://kawalpemilu.org#52105,"MUARA CIUJUNG TIMUR, RANGKASBITUNG, LEBAK, BANTEN",16,77,167,244
https://kawalpemilu.org#52105,"MUARA CIUJUNG TIMUR, RANGKASBITUNG, LEBAK, BANTEN",17,83,114,197
https://kawalpemilu.org#52105,"MUARA CIUJUNG TIMUR, RANGKASBITUNG, LEBAK, BANTEN",18,62,108,170
https://kawalpemilu.org#52105,"MUARA CIUJUNG TIMUR, RANGKASBITUNG, LEBAK, BANTEN",19,73,194,267
https://kawalpemilu.org#52105,"MUARA CIUJUNG TIMUR, RANGKASBITUNG, LEBAK, BANTEN",20,72,187,259
https://kawalpemilu.org#52105,"MUARA CIUJUNG TIMUR, RANGKASBITUNG, LEBAK, BANTEN",21,115,154,269
https://kawalpemilu.org#52105,"MUARA CIUJUNG TIMUR, RANGKASBITUNG, LEBAK, BANTEN",22,89,139,228
https://kawalpemilu.org#52105,"MUARA CIUJUNG TIMUR, RANGKASBITUNG, LEBAK, BANTEN",23,77,151,228
https://kawalpemilu.org#52105,"MUARA CIUJUNG TIMUR, RANGKASBITUNG, LEBAK, BANTEN",24,70,197,267
https://kawalpemilu.org#52105,"MUARA CIUJUNG TIMUR, RANGKASBITUNG, LEBAK, BANTEN",25,62,171,233
https://kawalpemilu.org#52105,"MUARA CIUJUNG TIMUR, RANGKASBITUNG, LEBAK, BANTEN",26,90,185,275
https://kawalpemilu.org#52105,"MUARA CIUJUNG TIMUR, RANGKASBITUNG, LEBAK, BANTEN",27,99,130,229
https://kawalpemilu.org#52105,"MUARA CIUJUNG TIMUR, RANGKASBITUNG, LEBAK, BANTEN",28,101,131,232
https://kawalpemilu.org#52105,"MUARA CIUJUNG TIMUR, RANGKASBITUNG, LEBAK, BANTEN",29,61,208,269
https://kawalpemilu.org#52105,"MUARA CIUJUNG TIMUR, RANGKASBITUNG, LEBAK, BANTEN",30,64,202,266
https://kawalpemilu.org#52105,"MUARA CIUJUNG TIMUR, RANGKASBITUNG, LEBAK, BANTEN",31,60,195,255
https://kawalpemilu.org#52105,"MUARA CIUJUNG TIMUR, RANGKASBITUNG, LEBAK, BANTEN",32,53,183,236
https://kawalpemilu.org#52105,"MUARA CIUJUNG TIMUR, RANGKASBITUNG, LEBAK, BANTEN",33,87,157,244
https://kawalpemilu.org#52105,"MUARA CIUJUNG TIMUR, RANGKASBITUNG, LEBAK, BANTEN",34,42,153,195
https://kawalpemilu.org#52105,"MUARA CIUJUNG TIMUR, RANGKASBITUNG, LEBAK, BANTEN",35,56,71,127
https://kawalpemilu.org#52105,"MUARA CIUJUNG TIMUR, RANGKASBITUNG, LEBAK, BANTEN",36,74,170,244
https://kawalpemilu.org#52105,"MUARA CIUJUNG TIMUR, RANGKASBITUNG, LEBAK, BANTEN",37,46,158,204
https://kawalpemilu.org#52105,"MUARA CIUJUNG TIMUR, RANGKASBITUNG, LEBAK, BANTEN",38,41,87,128
https://kawalpemilu.org#52105,"MUARA CIUJUNG TIMUR, RANGKASBITUNG, LEBAK, BANTEN",39,108,125,233
https://kawalpemilu.org#52105,"MUARA CIUJUNG TIMUR, RANGKASBITUNG, LEBAK, BANTEN",40,87,130,217
https://kawalpemilu.org#52105,"MUARA CIUJUNG TIMUR, RANGKASBITUNG, LEBAK, BANTEN",41,81,204,285
https://kawalpemilu.org#52105,"MUARA CIUJUNG TIMUR, RANGKASBITUNG, LEBAK, BANTEN",42,44,183,227
https://kawalpemilu.org#52105,"MUARA CIUJUNG TIMUR, RANGKASBITUNG, LEBAK, BANTEN",43,96,130,226
https://kawalpemilu.org#52105,"MUARA CIUJUNG TIMUR, RANGKASBITUNG, LEBAK, BANTEN",44,77,181,258
https://kawalpemilu.org#52105,"MUARA CIUJUNG TIMUR, RANGKASBITUNG, LEBAK, BANTEN",45,52,213,265
https://kawalpemilu.org#52105,"MUARA CIUJUNG TIMUR, RANGKASBITUNG, LEBAK, BANTEN",46,72,154,226
https://kawalpemilu.org#52105,"MUARA CIUJUNG TIMUR, RANGKASBITUNG, LEBAK, BANTEN",47,66,104,170
https://kawalpemilu.org#52105,"MUARA CIUJUNG TIMUR, RANGKASBITUNG, LEBAK, BANTEN",48,54,134,188
https://kawalpemilu.org#52105,"MUARA CIUJUNG TIMUR, RANGKASBITUNG, LEBAK, BANTEN",49,47,132,179
https://kawalpemilu.org#52105,"MUARA CIUJUNG TIMUR, RANGKASBITUNG, LEBAK, BANTEN",50,61,99,160
https://kawalpemilu.org#52105,"MUARA CIUJUNG TIMUR, RANGKASBITUNG, LEBAK, BANTEN",51,34,93,127
https://kawalpemilu.org#52106,"PASIRTANJUNG, RANGKASBITUNG, LEBAK, BANTEN",1,95,137,232
https://kawalpemilu.org#52106,"PASIRTANJUNG, RANGKASBITUNG, LEBAK, BANTEN",2,70,151,221
https://kawalpemilu.org#52106,"PASIRTANJUNG, RANGKASBITUNG, LEBAK, BANTEN",3,114,149,263
https://kawalpemilu.org#52106,"PASIRTANJUNG, RANGKASBITUNG, LEBAK, BANTEN",4,141,86,227
https://kawalpemilu.org#52106,"PASIRTANJUNG, RANGKASBITUNG, LEBAK, BANTEN",5,70,163,233
https://kawalpemilu.org#52106,"PASIRTANJUNG, RANGKASBITUNG, LEBAK, BANTEN",6,126,136,262
https://kawalpemilu.org#52106,"PASIRTANJUNG, RANGKASBITUNG, LEBAK, BANTEN",7,106,152,258
https://kawalpemilu.org#52106,"PASIRTANJUNG, RANGKASBITUNG, LEBAK, BANTEN",8,100,97,197
https://kawalpemilu.org#52106,"PASIRTANJUNG, RANGKASBITUNG, LEBAK, BANTEN",9,82,123,205
https://kawalpemilu.org#52106,"PASIRTANJUNG, RANGKASBITUNG, LEBAK, BANTEN",10,66,111,177
https://kawalpemilu.org#52106,"PASIRTANJUNG, RANGKASBITUNG, LEBAK, BANTEN",11,105,140,245
https://kawalpemilu.org#52106,"PASIRTANJUNG, RANGKASBITUNG, LEBAK, BANTEN",12,44,134,178
https://kawalpemilu.org#52106,"PASIRTANJUNG, RANGKASBITUNG, LEBAK, BANTEN",13,151,83,234
https://kawalpemilu.org#52107,"CITERAS, RANGKASBITUNG, LEBAK, BANTEN",1,74,151,225
https://kawalpemilu.org#52107,"CITERAS, RANGKASBITUNG, LEBAK, BANTEN",2,44,133,177
https://kawalpemilu.org#52107,"CITERAS, RANGKASBITUNG, LEBAK, BANTEN",3,54,185,239
https://kawalpemilu.org#52107,"CITERAS, RANGKASBITUNG, LEBAK, BANTEN",4,75,151,226
https://kawalpemilu.org#52107,"CITERAS, RANGKASBITUNG, LEBAK, BANTEN",5,43,189,232
https://kawalpemilu.org#52107,"CITERAS, RANGKASBITUNG, LEBAK, BANTEN",6,45,115,160
https://kawalpemilu.org#52107,"CITERAS, RANGKASBITUNG, LEBAK, BANTEN",7,30,106,136
https://kawalpemilu.org#52107,"CITERAS, RANGKASBITUNG, LEBAK, BANTEN",8,33,134,167
https://kawalpemilu.org#52107,"CITERAS, RANGKASBITUNG, LEBAK, BANTEN",9,45,196,241
https://kawalpemilu.org#52107,"CITERAS, RANGKASBITUNG, LEBAK, BANTEN",10,44,141,185
https://kawalpemilu.org#52107,"CITERAS, RANGKASBITUNG, LEBAK, BANTEN",11,64,145,209
https://kawalpemilu.org#52107,"CITERAS, RANGKASBITUNG, LEBAK, BANTEN",12,62,203,265
https://kawalpemilu.org#52107,"CITERAS, RANGKASBITUNG, LEBAK, BANTEN",13,31,175,206
https://kawalpemilu.org#52107,"CITERAS, RANGKASBITUNG, LEBAK, BANTEN",14,56,132,188
https://kawalpemilu.org#52107,"CITERAS, RANGKASBITUNG, LEBAK, BANTEN",15,89,144,233
https://kawalpemilu.org#52107,"CITERAS, RANGKASBITUNG, LEBAK, BANTEN",16,82,150,232
https://kawalpemilu.org#52107,"CITERAS, RANGKASBITUNG, LEBAK, BANTEN",17,36,209,245
https://kawalpemilu.org#52107,"CITERAS, RANGKASBITUNG, LEBAK, BANTEN",18,49,193,242
https://kawalpemilu.org#52107,"CITERAS, RANGKASBITUNG, LEBAK, BANTEN",19,40,162,202
https://kawalpemilu.org#52107,"CITERAS, RANGKASBITUNG, LEBAK, BANTEN",20,61,150,212
https://kawalpemilu.org#52107,"CITERAS, RANGKASBITUNG, LEBAK, BANTEN",21,72,162,234
https://kawalpemilu.org#52108,"NAMENG, RANGKASBITUNG, LEBAK, BANTEN",1,21,229,250
https://kawalpemilu.org#52108,"NAMENG, RANGKASBITUNG, LEBAK, BANTEN",2,41,237,278
https://kawalpemilu.org#52108,"NAMENG, RANGKASBITUNG, LEBAK, BANTEN",3,60,203,263
https://kawalpemilu.org#52108,"NAMENG, RANGKASBITUNG, LEBAK, BANTEN",4,37,185,222
https://kawalpemilu.org#52108,"NAMENG, RANGKASBITUNG, LEBAK, BANTEN",5,92,177,269
https://kawalpemilu.org#52108,"NAMENG, RANGKASBITUNG, LEBAK, BANTEN",7,102,143,245
https://kawalpemilu.org#52108,"NAMENG, RANGKASBITUNG, LEBAK, BANTEN",8,91,146,237
https://kawalpemilu.org#52108,"NAMENG, RANGKASBITUNG, LEBAK, BANTEN",9,71,189,260
https://kawalpemilu.org#52108,"NAMENG, RANGKASBITUNG, LEBAK, BANTEN",10,53,109,162
https://kawalpemilu.org#52108,"NAMENG, RANGKASBITUNG, LEBAK, BANTEN",11,41,189,230
https://kawalpemilu.org#52108,"NAMENG, RANGKASBITUNG, LEBAK, BANTEN",12,47,172,219
https://kawalpemilu.org#52108,"NAMENG, RANGKASBITUNG, LEBAK, BANTEN",13,70,190,260
https://kawalpemilu.org#52108,"NAMENG, RANGKASBITUNG, LEBAK, BANTEN",14,43,122,165
https://kawalpemilu.org#52108,"NAMENG, RANGKASBITUNG, LEBAK, BANTEN",15,42,204,246
https://kawalpemilu.org#52108,"NAMENG, RANGKASBITUNG, LEBAK, BANTEN",16,31,162,193
https://kawalpemilu.org#52108,"NAMENG, RANGKASBITUNG, LEBAK, BANTEN",17,77,105,182
https://kawalpemilu.org#52108,"NAMENG, RANGKASBITUNG, LEBAK, BANTEN",18,77,184,261
https://kawalpemilu.org#52108,"NAMENG, RANGKASBITUNG, LEBAK, BANTEN",19,56,108,164
https://kawalpemilu.org#52109,"KOLELET WETAN, RANGKASBITUNG, LEBAK, BANTEN",1,77,158,235
https://kawalpemilu.org#52109,"KOLELET WETAN, RANGKASBITUNG, LEBAK, BANTEN",2,70,143,213
https://kawalpemilu.org#52109,"KOLELET WETAN, RANGKASBITUNG, LEBAK, BANTEN",3,70,145,215
https://kawalpemilu.org#52109,"KOLELET WETAN, RANGKASBITUNG, LEBAK, BANTEN",4,46,164,210
https://kawalpemilu.org#52109,"KOLELET WETAN, RANGKASBITUNG, LEBAK, BANTEN",5,77,148,225
https://kawalpemilu.org#52109,"KOLELET WETAN, RANGKASBITUNG, LEBAK, BANTEN",6,47,176,223
https://kawalpemilu.org#52109,"KOLELET WETAN, RANGKASBITUNG, LEBAK, BANTEN",7,75,168,243
https://kawalpemilu.org#52109,"KOLELET WETAN, RANGKASBITUNG, LEBAK, BANTEN",8,111,91,202
https://kawalpemilu.org#52109,"KOLELET WETAN, RANGKASBITUNG, LEBAK, BANTEN",9,57,165,222
https://kawalpemilu.org#52109,"KOLELET WETAN, RANGKASBITUNG, LEBAK, BANTEN",10,50,164,214
https://kawalpemilu.org#52109,"KOLELET WETAN, RANGKASBITUNG, LEBAK, BANTEN",11,38,111,149
https://kawalpemilu.org#52110,"JATIMULYA, RANGKASBITUNG, LEBAK, BANTEN",1,109,62,171
https://kawalpemilu.org#52110,"JATIMULYA, RANGKASBITUNG, LEBAK, BANTEN",2,73,113,186
https://kawalpemilu.org#52110,"JATIMULYA, RANGKASBITUNG, LEBAK, BANTEN",3,74,120,194
https://kawalpemilu.org#52110,"JATIMULYA, RANGKASBITUNG, LEBAK, BANTEN",4,69,156,225
https://kawalpemilu.org#52110,"JATIMULYA, RANGKASBITUNG, LEBAK, BANTEN",5,57,174,231
https://kawalpemilu.org#52110,"JATIMULYA, RANGKASBITUNG, LEBAK, BANTEN",6,94,129,223
https://kawalpemilu.org#52110,"JATIMULYA, RANGKASBITUNG, LEBAK, BANTEN",7,68,174,242
https://kawalpemilu.org#52110,"JATIMULYA, RANGKASBITUNG, LEBAK, BANTEN",8,94,159,253
https://kawalpemilu.org#52110,"JATIMULYA, RANGKASBITUNG, LEBAK, BANTEN",9,70,156,226
https://kawalpemilu.org#52110,"JATIMULYA, RANGKASBITUNG, LEBAK, BANTEN",10,89,114,203
https://kawalpemilu.org#52110,"JATIMULYA, RANGKASBITUNG, LEBAK, BANTEN",11,76,128,204
https://kawalpemilu.org#52110,"JATIMULYA, RANGKASBITUNG, LEBAK, BANTEN",12,109,83,192
https://kawalpemilu.org#52110,"JATIMULYA, RANGKASBITUNG, LEBAK, BANTEN",13,113,83,196
https://kawalpemilu.org#52110,"JATIMULYA, RANGKASBITUNG, LEBAK, BANTEN",14,116,113,229
https://kawalpemilu.org#52110,"JATIMULYA, RANGKASBITUNG, LEBAK, BANTEN",15,65,87,152
https://kawalpemilu.org#52110,"JATIMULYA, RANGKASBITUNG, LEBAK, BANTEN",16,48,97,145
https://kawalpemilu.org#52110,"JATIMULYA, RANGKASBITUNG, LEBAK, BANTEN",17,54,111,165
https://kawalpemilu.org#52110,"JATIMULYA, RANGKASBITUNG, LEBAK, BANTEN",18,71,74,145
https://kawalpemilu.org#52110,"JATIMULYA, RANGKASBITUNG, LEBAK, BANTEN",19,82,142,224
https://kawalpemilu.org#52110,"JATIMULYA, RANGKASBITUNG, LEBAK, BANTEN",20,96,132,228
https://kawalpemilu.org#52110,"JATIMULYA, RANGKASBITUNG, LEBAK, BANTEN",21,97,122,219
https://kawalpemilu.org#52111,"MEKARSARI, RANGKASBITUNG, LEBAK, BANTEN",1,84,161,245
https://kawalpemilu.org#52111,"MEKARSARI, RANGKASBITUNG, LEBAK, BANTEN",2,83,129,212
https://kawalpemilu.org#52111,"MEKARSARI, RANGKASBITUNG, LEBAK, BANTEN",3,58,196,254
https://kawalpemilu.org#52111,"MEKARSARI, RANGKASBITUNG, LEBAK, BANTEN",4,83,154,237
https://kawalpemilu.org#52111,"MEKARSARI, RANGKASBITUNG, LEBAK, BANTEN",5,41,242,283
https://kawalpemilu.org#52111,"MEKARSARI, RANGKASBITUNG, LEBAK, BANTEN",6,74,160,234
https://kawalpemilu.org#52111,"MEKARSARI, RANGKASBITUNG, LEBAK, BANTEN",7,66,171,237
https://kawalpemilu.org#52111,"MEKARSARI, RANGKASBITUNG, LEBAK, BANTEN",8,45,108,153
https://kawalpemilu.org#52111,"MEKARSARI, RANGKASBITUNG, LEBAK, BANTEN",9,93,153,246
https://kawalpemilu.org#52111,"MEKARSARI, RANGKASBITUNG, LEBAK, BANTEN",10,85,130,215
https://kawalpemilu.org#52111,"MEKARSARI, RANGKASBITUNG, LEBAK, BANTEN",11,87,165,252
https://kawalpemilu.org#52111,"MEKARSARI, RANGKASBITUNG, LEBAK, BANTEN",12,33,157,190
https://kawalpemilu.org#52111,"MEKARSARI, RANGKASBITUNG, LEBAK, BANTEN",13,74,180,254
https://kawalpemilu.org#52111,"MEKARSARI, RANGKASBITUNG, LEBAK, BANTEN",14,73,172,245
https://kawalpemilu.org#52111,"MEKARSARI, RANGKASBITUNG, LEBAK, BANTEN",15,48,180,228
https://kawalpemilu.org#52111,"MEKARSARI, RANGKASBITUNG, LEBAK, BANTEN",16,43,110,153
https://kawalpemilu.org#52112,"PABUARAN, RANGKASBITUNG, LEBAK, BANTEN",1,35,195,230
https://kawalpemilu.org#52112,"PABUARAN, RANGKASBITUNG, LEBAK, BANTEN",2,65,187,252
https://kawalpemilu.org#52112,"PABUARAN, RANGKASBITUNG, LEBAK, BANTEN",3,79,143,222
https://kawalpemilu.org#52112,"PABUARAN, RANGKASBITUNG, LEBAK, BANTEN",4,34,109,143
https://kawalpemilu.org#52112,"PABUARAN, RANGKASBITUNG, LEBAK, BANTEN",5,47,154,201
https://kawalpemilu.org#52112,"PABUARAN, RANGKASBITUNG, LEBAK, BANTEN",6,66,169,235
https://kawalpemilu.org#52112,"PABUARAN, RANGKASBITUNG, LEBAK, BANTEN",7,42,111,153
https://kawalpemilu.org#52112,"PABUARAN, RANGKASBITUNG, LEBAK, BANTEN",8,58,156,214
https://kawalpemilu.org#52112,"PABUARAN, RANGKASBITUNG, LEBAK, BANTEN",9,69,185,254
https://kawalpemilu.org#52112,"PABUARAN, RANGKASBITUNG, LEBAK, BANTEN",10,62,144,206
https://kawalpemilu.org#52112,"PABUARAN, RANGKASBITUNG, LEBAK, BANTEN",11,41,117,158
https://kawalpemilu.org#52112,"PABUARAN, RANGKASBITUNG, LEBAK, BANTEN",12,36,172,208
https://kawalpemilu.org#52112,"PABUARAN, RANGKASBITUNG, LEBAK, BANTEN",13,73,162,235
https://kawalpemilu.org#52112,"PABUARAN, RANGKASBITUNG, LEBAK, BANTEN",14,66,96,162
https://kawalpemilu.org#52113,"RANGKASBITUNG TIMUR, RANGKASBITUNG, LEBAK, BANTEN",1,62,145,207
https://kawalpemilu.org#52113,"RANGKASBITUNG TIMUR, RANGKASBITUNG, LEBAK, BANTEN",2,76,154,230
https://kawalpemilu.org#52113,"RANGKASBITUNG TIMUR, RANGKASBITUNG, LEBAK, BANTEN",3,79,152,231
https://kawalpemilu.org#52113,"RANGKASBITUNG TIMUR, RANGKASBITUNG, LEBAK, BANTEN",4,98,177,275
https://kawalpemilu.org#52113,"RANGKASBITUNG TIMUR, RANGKASBITUNG, LEBAK, BANTEN",5,87,138,225
https://kawalpemilu.org#52113,"RANGKASBITUNG TIMUR, RANGKASBITUNG, LEBAK, BANTEN",6,60,137,197
https://kawalpemilu.org#52113,"RANGKASBITUNG TIMUR, RANGKASBITUNG, LEBAK, BANTEN",7,55,204,259
https://kawalpemilu.org#52113,"RANGKASBITUNG TIMUR, RANGKASBITUNG, LEBAK, BANTEN",8,56,159,215
https://kawalpemilu.org#52113,"RANGKASBITUNG TIMUR, RANGKASBITUNG, LEBAK, BANTEN",9,74,180,254
https://kawalpemilu.org#52113,"RANGKASBITUNG TIMUR, RANGKASBITUNG, LEBAK, BANTEN",10,89,100,189
https://kawalpemilu.org#52113,"RANGKASBITUNG TIMUR, RANGKASBITUNG, LEBAK, BANTEN",11,63,134,197
https://kawalpemilu.org#52113,"RANGKASBITUNG TIMUR, RANGKASBITUNG, LEBAK, BANTEN",12,50,151,201
https://kawalpemilu.org#52113,"RANGKASBITUNG TIMUR, RANGKASBITUNG, LEBAK, BANTEN",13,60,128,188
https://kawalpemilu.org#52113,"RANGKASBITUNG TIMUR, RANGKASBITUNG, LEBAK, BANTEN",14,42,181,223
https://kawalpemilu.org#52113,"RANGKASBITUNG TIMUR, RANGKASBITUNG, LEBAK, BANTEN",15,36,148,184
https://kawalpemilu.org#52113,"RANGKASBITUNG TIMUR, RANGKASBITUNG, LEBAK, BANTEN",16,66,135,201
https://kawalpemilu.org#52113,"RANGKASBITUNG TIMUR, RANGKASBITUNG, LEBAK, BANTEN",17,78,116,194
https://kawalpemilu.org#52113,"RANGKASBITUNG TIMUR, RANGKASBITUNG, LEBAK, BANTEN",18,55,137,192
https://kawalpemilu.org#52113,"RANGKASBITUNG TIMUR, RANGKASBITUNG, LEBAK, BANTEN",19,64,169,233
https://kawalpemilu.org#52113,"RANGKASBITUNG TIMUR, RANGKASBITUNG, LEBAK, BANTEN",20,63,139,202
https://kawalpemilu.org#52113,"RANGKASBITUNG TIMUR, RANGKASBITUNG, LEBAK, BANTEN",21,63,141,204
https://kawalpemilu.org#52113,"RANGKASBITUNG TIMUR, RANGKASBITUNG, LEBAK, BANTEN",22,59,132,191
https://kawalpemilu.org#52113,"RANGKASBITUNG TIMUR, RANGKASBITUNG, LEBAK, BANTEN",23,56,130,186
https://kawalpemilu.org#52113,"RANGKASBITUNG TIMUR, RANGKASBITUNG, LEBAK, BANTEN",24,57,182,239
https://kawalpemilu.org#52113,"RANGKASBITUNG TIMUR, RANGKASBITUNG, LEBAK, BANTEN",25,129,123,252
https://kawalpemilu.org#52113,"RANGKASBITUNG TIMUR, RANGKASBITUNG, LEBAK, BANTEN",26,59,114,173
https://kawalpemilu.org#52113,"RANGKASBITUNG TIMUR, RANGKASBITUNG, LEBAK, BANTEN",27,71,96,167
https://kawalpemilu.org#52113,"RANGKASBITUNG TIMUR, RANGKASBITUNG, LEBAK, BANTEN",28,84,115,199
https://kawalpemilu.org#52113,"RANGKASBITUNG TIMUR, RANGKASBITUNG, LEBAK, BANTEN",29,58,156,214
https://kawalpemilu.org#52113,"RANGKASBITUNG TIMUR, RANGKASBITUNG, LEBAK, BANTEN",30,59,147,206
https://kawalpemilu.org#52114,"SUKAMANAH, RANGKASBITUNG, LEBAK, BANTEN",1,76,179,255
https://kawalpemilu.org#52114,"SUKAMANAH, RANGKASBITUNG, LEBAK, BANTEN",2,101,118,219
https://kawalpemilu.org#52114,"SUKAMANAH, RANGKASBITUNG, LEBAK, BANTEN",3,89,129,218
https://kawalpemilu.org#52114,"SUKAMANAH, RANGKASBITUNG, LEBAK, BANTEN",4,77,170,247
https://kawalpemilu.org#52114,"SUKAMANAH, RANGKASBITUNG, LEBAK, BANTEN",5,42,144,186
https://kawalpemilu.org#52114,"SUKAMANAH, RANGKASBITUNG, LEBAK, BANTEN",6,47,143,190
https://kawalpemilu.org#52114,"SUKAMANAH, RANGKASBITUNG, LEBAK, BANTEN",7,101,125,226
https://kawalpemilu.org#52114,"SUKAMANAH, RANGKASBITUNG, LEBAK, BANTEN",8,83,158,3
https://kawalpemilu.org#52114,"SUKAMANAH, RANGKASBITUNG, LEBAK, BANTEN",9,92,170,262
https://kawalpemilu.org#52114,"SUKAMANAH, RANGKASBITUNG, LEBAK, BANTEN",10,38,143,181
https://kawalpemilu.org#52114,"SUKAMANAH, RANGKASBITUNG, LEBAK, BANTEN",11,43,138,181
https://kawalpemilu.org#52114,"SUKAMANAH, RANGKASBITUNG, LEBAK, BANTEN",12,41,158,199
https://kawalpemilu.org#52114,"SUKAMANAH, RANGKASBITUNG, LEBAK, BANTEN",13,38,173,211
https://kawalpemilu.org#52115,"CIMANGEUNTEUNG, RANGKASBITUNG, LEBAK, BANTEN",1,111,90,201
https://kawalpemilu.org#52115,"CIMANGEUNTEUNG, RANGKASBITUNG, LEBAK, BANTEN",2,73,131,204
https://kawalpemilu.org#52115,"CIMANGEUNTEUNG, RANGKASBITUNG, LEBAK, BANTEN",3,89,135,224
https://kawalpemilu.org#52115,"CIMANGEUNTEUNG, RANGKASBITUNG, LEBAK, BANTEN",4,66,130,196
https://kawalpemilu.org#52115,"CIMANGEUNTEUNG, RANGKASBITUNG, LEBAK, BANTEN",5,106,120,226
https://kawalpemilu.org#52115,"CIMANGEUNTEUNG, RANGKASBITUNG, LEBAK, BANTEN",6,107,99,206
https://kawalpemilu.org#52115,"CIMANGEUNTEUNG, RANGKASBITUNG, LEBAK, BANTEN",7,69,144,213
https://kawalpemilu.org#52115,"CIMANGEUNTEUNG, RANGKASBITUNG, LEBAK, BANTEN",8,95,120,215
https://kawalpemilu.org#52115,"CIMANGEUNTEUNG, RANGKASBITUNG, LEBAK, BANTEN",9,78,98,176
https://kawalpemilu.org#52115,"CIMANGEUNTEUNG, RANGKASBITUNG, LEBAK, BANTEN",11,51,162,213
https://kawalpemilu.org#52115,"CIMANGEUNTEUNG, RANGKASBITUNG, LEBAK, BANTEN",12,68,155,223
https://kawalpemilu.org#52115,"CIMANGEUNTEUNG, RANGKASBITUNG, LEBAK, BANTEN",13,72,120,192
https://kawalpemilu.org#52115,"CIMANGEUNTEUNG, RANGKASBITUNG, LEBAK, BANTEN",14,37,137,174
https://kawalpemilu.org#52115,"CIMANGEUNTEUNG, RANGKASBITUNG, LEBAK, BANTEN",15,47,84,131
https://kawalpemilu.org#52116,"NARIMBANG MULIA, RANGKASBITUNG, LEBAK, BANTEN",1,92,149,241
https://kawalpemilu.org#52116,"NARIMBANG MULIA, RANGKASBITUNG, LEBAK, BANTEN",2,117,131,248
https://kawalpemilu.org#52116,"NARIMBANG MULIA, RANGKASBITUNG, LEBAK, BANTEN",3,66,147,213
https://kawalpemilu.org#52116,"NARIMBANG MULIA, RANGKASBITUNG, LEBAK, BANTEN",4,91,148,239
https://kawalpemilu.org#52116,"NARIMBANG MULIA, RANGKASBITUNG, LEBAK, BANTEN",5,84,97,181
https://kawalpemilu.org#52116,"NARIMBANG MULIA, RANGKASBITUNG, LEBAK, BANTEN",6,54,190,244
https://kawalpemilu.org#52116,"NARIMBANG MULIA, RANGKASBITUNG, LEBAK, BANTEN",7,82,135,217
https://kawalpemilu.org#52116,"NARIMBANG MULIA, RANGKASBITUNG, LEBAK, BANTEN",8,109,157,266
https://kawalpemilu.org#52116,"NARIMBANG MULIA, RANGKASBITUNG, LEBAK, BANTEN",9,80,139,219
https://kawalpemilu.org#52116,"NARIMBANG MULIA, RANGKASBITUNG, LEBAK, BANTEN",10,76,153,229
https://kawalpemilu.org#52116,"NARIMBANG MULIA, RANGKASBITUNG, LEBAK, BANTEN",11,129,105,234
https://kawalpemilu.org#52116,"NARIMBANG MULIA, RANGKASBITUNG, LEBAK, BANTEN",12,62,200,262
https://kawalpemilu.org#52116,"NARIMBANG MULIA, RANGKASBITUNG, LEBAK, BANTEN",13,98,163,261
https://kawalpemilu.org#52116,"NARIMBANG MULIA, RANGKASBITUNG, LEBAK, BANTEN",14,47,156,203
https://kawalpemilu.org#52116,"NARIMBANG MULIA, RANGKASBITUNG, LEBAK, BANTEN",15,68,160,228
https://kawalpemilu.org#52116,"NARIMBANG MULIA, RANGKASBITUNG, LEBAK, BANTEN",16,54,174,228
https://kawalpemilu.org#52116,"NARIMBANG MULIA, RANGKASBITUNG, LEBAK, BANTEN",17,38,76,114
https://kawalpemilu.org#52118,"SUKARENDAH, WARUNGGUNUNG, LEBAK, BANTEN",1,32,119,151
https://kawalpemilu.org#52118,"SUKARENDAH, WARUNGGUNUNG, LEBAK, BANTEN",2,34,102,136
https://kawalpemilu.org#52118,"SUKARENDAH, WARUNGGUNUNG, LEBAK, BANTEN",3,27,127,154
https://kawalpemilu.org#52118,"SUKARENDAH, WARUNGGUNUNG, LEBAK, BANTEN",4,39,158,197
https://kawalpemilu.org#52118,"SUKARENDAH, WARUNGGUNUNG, LEBAK, BANTEN",5,27,112,139
https://kawalpemilu.org#52118,"SUKARENDAH, WARUNGGUNUNG, LEBAK, BANTEN",6,32,122,154
https://kawalpemilu.org#52118,"SUKARENDAH, WARUNGGUNUNG, LEBAK, BANTEN",7,31,84,115
https://kawalpemilu.org#52118,"SUKARENDAH, WARUNGGUNUNG, LEBAK, BANTEN",9,28,98,126
https://kawalpemilu.org#52118,"SUKARENDAH, WARUNGGUNUNG, LEBAK, BANTEN",10,53,124,177
https://kawalpemilu.org#52118,"SUKARENDAH, WARUNGGUNUNG, LEBAK, BANTEN",11,18,78,96
https://kawalpemilu.org#52118,"SUKARENDAH, WARUNGGUNUNG, LEBAK, BANTEN",12,55,139,194
https://kawalpemilu.org#52118,"SUKARENDAH, WARUNGGUNUNG, LEBAK, BANTEN",13,10,86,96
https://kawalpemilu.org#52118,"SUKARENDAH, WARUNGGUNUNG, LEBAK, BANTEN",14,32,93,125
https://kawalpemilu.org#52118,"SUKARENDAH, WARUNGGUNUNG, LEBAK, BANTEN",15,28,166,194
https://kawalpemilu.org#52118,"SUKARENDAH, WARUNGGUNUNG, LEBAK, BANTEN",16,29,81,110
https://kawalpemilu.org#52118,"SUKARENDAH, WARUNGGUNUNG, LEBAK, BANTEN",17,32,125,157
https://kawalpemilu.org#52118,"SUKARENDAH, WARUNGGUNUNG, LEBAK, BANTEN",18,27,103,130
https://kawalpemilu.org#52118,"SUKARENDAH, WARUNGGUNUNG, LEBAK, BANTEN",19,18,81,99
https://kawalpemilu.org#52118,"SUKARENDAH, WARUNGGUNUNG, LEBAK, BANTEN",20,56,143,6
https://kawalpemilu.org#52118,"SUKARENDAH, WARUNGGUNUNG, LEBAK, BANTEN",21,38,75,113
https://kawalpemilu.org#52118,"SUKARENDAH, WARUNGGUNUNG, LEBAK, BANTEN",22,17,121,138
https://kawalpemilu.org#52118,"SUKARENDAH, WARUNGGUNUNG, LEBAK, BANTEN",23,32,105,137
https://kawalpemilu.org#52119,"WARUNGGUNUNG, WARUNGGUNUNG, LEBAK, BANTEN",1,45,213,258
https://kawalpemilu.org#52119,"WARUNGGUNUNG, WARUNGGUNUNG, LEBAK, BANTEN",2,71,188,259
https://kawalpemilu.org#52119,"WARUNGGUNUNG, WARUNGGUNUNG, LEBAK, BANTEN",3,80,144,224
https://kawalpemilu.org#52119,"WARUNGGUNUNG, WARUNGGUNUNG, LEBAK, BANTEN",4,56,176,232
https://kawalpemilu.org#52119,"WARUNGGUNUNG, WARUNGGUNUNG, LEBAK, BANTEN",5,41,177,218
https://kawalpemilu.org#52119,"WARUNGGUNUNG, WARUNGGUNUNG, LEBAK, BANTEN",6,45,184,229
https://kawalpemilu.org#52119,"WARUNGGUNUNG, WARUNGGUNUNG, LEBAK, BANTEN",7,51,179,230
https://kawalpemilu.org#52119,"WARUNGGUNUNG, WARUNGGUNUNG, LEBAK, BANTEN",8,50,127,177
https://kawalpemilu.org#52119,"WARUNGGUNUNG, WARUNGGUNUNG, LEBAK, BANTEN",9,35,194,229
https://kawalpemilu.org#52119,"WARUNGGUNUNG, WARUNGGUNUNG, LEBAK, BANTEN",10,82,150,232
https://kawalpemilu.org#52119,"WARUNGGUNUNG, WARUNGGUNUNG, LEBAK, BANTEN",11,69,116,185
https://kawalpemilu.org#52119,"WARUNGGUNUNG, WARUNGGUNUNG, LEBAK, BANTEN",12,79,113,192
https://kawalpemilu.org#52119,"WARUNGGUNUNG, WARUNGGUNUNG, LEBAK, BANTEN",13,44,69,113
https://kawalpemilu.org#52120,"CIBUAH, WARUNGGUNUNG, LEBAK, BANTEN",1,36,163,199
https://kawalpemilu.org#52120,"CIBUAH, WARUNGGUNUNG, LEBAK, BANTEN",2,30,171,201
https://kawalpemilu.org#52120,"CIBUAH, WARUNGGUNUNG, LEBAK, BANTEN",3,27,130,157
https://kawalpemilu.org#52120,"CIBUAH, WARUNGGUNUNG, LEBAK, BANTEN",4,27,159,186
https://kawalpemilu.org#52120,"CIBUAH, WARUNGGUNUNG, LEBAK, BANTEN",5,31,199,230
https://kawalpemilu.org#52120,"CIBUAH, WARUNGGUNUNG, LEBAK, BANTEN",6,35,170,205
https://kawalpemilu.org#52120,"CIBUAH, WARUNGGUNUNG, LEBAK, BANTEN",7,63,141,204
https://kawalpemilu.org#52120,"CIBUAH, WARUNGGUNUNG, LEBAK, BANTEN",8,43,81,124
https://kawalpemilu.org#52120,"CIBUAH, WARUNGGUNUNG, LEBAK, BANTEN",9,43,104,147
https://kawalpemilu.org#52120,"CIBUAH, WARUNGGUNUNG, LEBAK, BANTEN",10,63,120,183
https://kawalpemilu.org#52120,"CIBUAH, WARUNGGUNUNG, LEBAK, BANTEN",11,55,169,224
https://kawalpemilu.org#52120,"CIBUAH, WARUNGGUNUNG, LEBAK, BANTEN",12,74,143,217
https://kawalpemilu.org#52120,"CIBUAH, WARUNGGUNUNG, LEBAK, BANTEN",13,33,139,172
https://kawalpemilu.org#52120,"CIBUAH, WARUNGGUNUNG, LEBAK, BANTEN",14,61,121,182
https://kawalpemilu.org#52120,"CIBUAH, WARUNGGUNUNG, LEBAK, BANTEN",15,45,136,181
https://kawalpemilu.org#52120,"CIBUAH, WARUNGGUNUNG, LEBAK, BANTEN",16,58,151,209
https://kawalpemilu.org#52120,"CIBUAH, WARUNGGUNUNG, LEBAK, BANTEN",17,65,157,222
https://kawalpemilu.org#52121,"PASIR TANGKIL, WARUNGGUNUNG, LEBAK, BANTEN",1,62,125,187
https://kawalpemilu.org#52121,"PASIR TANGKIL, WARUNGGUNUNG, LEBAK, BANTEN",2,45,162,207
https://kawalpemilu.org#52121,"PASIR TANGKIL, WARUNGGUNUNG, LEBAK, BANTEN",3,43,137,180
https://kawalpemilu.org#52121,"PASIR TANGKIL, WARUNGGUNUNG, LEBAK, BANTEN",4,53,155,208
https://kawalpemilu.org#52121,"PASIR TANGKIL, WARUNGGUNUNG, LEBAK, BANTEN",5,69,113,182
https://kawalpemilu.org#52121,"PASIR TANGKIL, WARUNGGUNUNG, LEBAK, BANTEN",6,49,133,182
https://kawalpemilu.org#52121,"PASIR TANGKIL, WARUNGGUNUNG, LEBAK, BANTEN",7,68,124,192
https://kawalpemilu.org#52121,"PASIR TANGKIL, WARUNGGUNUNG, LEBAK, BANTEN",8,65,124,189
https://kawalpemilu.org#52121,"PASIR TANGKIL, WARUNGGUNUNG, LEBAK, BANTEN",9,69,145,214
https://kawalpemilu.org#52121,"PASIR TANGKIL, WARUNGGUNUNG, LEBAK, BANTEN",10,45,120,165
https://kawalpemilu.org#52121,"PASIR TANGKIL, WARUNGGUNUNG, LEBAK, BANTEN",11,63,129,192
https://kawalpemilu.org#52121,"PASIR TANGKIL, WARUNGGUNUNG, LEBAK, BANTEN",12,56,136,192
https://kawalpemilu.org#52122,"BAROS, WARUNGGUNUNG, LEBAK, BANTEN",1,37,167,204
https://kawalpemilu.org#52122,"BAROS, WARUNGGUNUNG, LEBAK, BANTEN",2,69,74,143
https://kawalpemilu.org#52122,"BAROS, WARUNGGUNUNG, LEBAK, BANTEN",3,52,117,169
https://kawalpemilu.org#52122,"BAROS, WARUNGGUNUNG, LEBAK, BANTEN",4,26,155,181
https://kawalpemilu.org#52122,"BAROS, WARUNGGUNUNG, LEBAK, BANTEN",5,25,162,187
https://kawalpemilu.org#52122,"BAROS, WARUNGGUNUNG, LEBAK, BANTEN",6,66,95,161
https://kawalpemilu.org#52122,"BAROS, WARUNGGUNUNG, LEBAK, BANTEN",7,38,146,184
https://kawalpemilu.org#52122,"BAROS, WARUNGGUNUNG, LEBAK, BANTEN",8,47,99,146
https://kawalpemilu.org#52122,"BAROS, WARUNGGUNUNG, LEBAK, BANTEN",9,88,103,191
https://kawalpemilu.org#52122,"BAROS, WARUNGGUNUNG, LEBAK, BANTEN",10,45,92,137
https://kawalpemilu.org#52122,"BAROS, WARUNGGUNUNG, LEBAK, BANTEN",11,48,129,177
https://kawalpemilu.org#52122,"BAROS, WARUNGGUNUNG, LEBAK, BANTEN",12,30,132,162
https://kawalpemilu.org#52122,"BAROS, WARUNGGUNUNG, LEBAK, BANTEN",13,29,171,200
https://kawalpemilu.org#52123,"BANJARSARI, WARUNGGUNUNG, LEBAK, BANTEN",1,51,133,184
https://kawalpemilu.org#52123,"BANJARSARI, WARUNGGUNUNG, LEBAK, BANTEN",2,40,146,186
https://kawalpemilu.org#52123,"BANJARSARI, WARUNGGUNUNG, LEBAK, BANTEN",3,29,152,181
https://kawalpemilu.org#52123,"BANJARSARI, WARUNGGUNUNG, LEBAK, BANTEN",4,51,122,173
https://kawalpemilu.org#52123,"BANJARSARI, WARUNGGUNUNG, LEBAK, BANTEN",5,60,105,165
https://kawalpemilu.org#52123,"BANJARSARI, WARUNGGUNUNG, LEBAK, BANTEN",6,73,93,166
https://kawalpemilu.org#52123,"BANJARSARI, WARUNGGUNUNG, LEBAK, BANTEN",7,57,132,189
https://kawalpemilu.org#52123,"BANJARSARI, WARUNGGUNUNG, LEBAK, BANTEN",8,58,115,173
https://kawalpemilu.org#52123,"BANJARSARI, WARUNGGUNUNG, LEBAK, BANTEN",9,37,110,147
https://kawalpemilu.org#52123,"BANJARSARI, WARUNGGUNUNG, LEBAK, BANTEN",10,57,123,180
https://kawalpemilu.org#52123,"BANJARSARI, WARUNGGUNUNG, LEBAK, BANTEN",11,55,130,185
https://kawalpemilu.org#52123,"BANJARSARI, WARUNGGUNUNG, LEBAK, BANTEN",12,43,134,177
https://kawalpemilu.org#52123,"BANJARSARI, WARUNGGUNUNG, LEBAK, BANTEN",13,47,113,160
https://kawalpemilu.org#52123,"BANJARSARI, WARUNGGUNUNG, LEBAK, BANTEN",14,66,114,180
https://kawalpemilu.org#52123,"BANJARSARI, WARUNGGUNUNG, LEBAK, BANTEN",15,55,126,181
https://kawalpemilu.org#52123,"BANJARSARI, WARUNGGUNUNG, LEBAK, BANTEN",16,61,137,198
https://kawalpemilu.org#52123,"BANJARSARI, WARUNGGUNUNG, LEBAK, BANTEN",17,69,116,185
https://kawalpemilu.org#52124,"PADASUKA, WARUNGGUNUNG, LEBAK, BANTEN",1,69,141,210
https://kawalpemilu.org#52124,"PADASUKA, WARUNGGUNUNG, LEBAK, BANTEN",2,89,121,210
https://kawalpemilu.org#52124,"PADASUKA, WARUNGGUNUNG, LEBAK, BANTEN",3,83,110,193
https://kawalpemilu.org#52124,"PADASUKA, WARUNGGUNUNG, LEBAK, BANTEN",4,80,120,200
https://kawalpemilu.org#52124,"PADASUKA, WARUNGGUNUNG, LEBAK, BANTEN",5,36,157,193
https://kawalpemilu.org#52124,"PADASUKA, WARUNGGUNUNG, LEBAK, BANTEN",6,95,87,182
https://kawalpemilu.org#52124,"PADASUKA, WARUNGGUNUNG, LEBAK, BANTEN",7,79,99,178
https://kawalpemilu.org#52124,"PADASUKA, WARUNGGUNUNG, LEBAK, BANTEN",8,74,129,203
https://kawalpemilu.org#52124,"PADASUKA, WARUNGGUNUNG, LEBAK, BANTEN",9,50,138,188
https://kawalpemilu.org#52124,"PADASUKA, WARUNGGUNUNG, LEBAK, BANTEN",10,65,117,182
https://kawalpemilu.org#52124,"PADASUKA, WARUNGGUNUNG, LEBAK, BANTEN",11,84,69,153
https://kawalpemilu.org#52124,"PADASUKA, WARUNGGUNUNG, LEBAK, BANTEN",12,21,54,75
https://kawalpemilu.org#52124,"PADASUKA, WARUNGGUNUNG, LEBAK, BANTEN",13,35,81,116
https://kawalpemilu.org#52124,"PADASUKA, WARUNGGUNUNG, LEBAK, BANTEN",14,105,93,198
https://kawalpemilu.org#52124,"PADASUKA, WARUNGGUNUNG, LEBAK, BANTEN",15,74,101,175
https://kawalpemilu.org#52124,"PADASUKA, WARUNGGUNUNG, LEBAK, BANTEN",16,79,84,163
https://kawalpemilu.org#52124,"PADASUKA, WARUNGGUNUNG, LEBAK, BANTEN",17,93,106,199
https://kawalpemilu.org#52124,"PADASUKA, WARUNGGUNUNG, LEBAK, BANTEN",18,70,123,193
https://kawalpemilu.org#52125,"SUKARAJA, WARUNGGUNUNG, LEBAK, BANTEN",1,33,64,97
https://kawalpemilu.org#52125,"SUKARAJA, WARUNGGUNUNG, LEBAK, BANTEN",2,99,86,185
https://kawalpemilu.org#52125,"SUKARAJA, WARUNGGUNUNG, LEBAK, BANTEN",3,88,77,165
https://kawalpemilu.org#52125,"SUKARAJA, WARUNGGUNUNG, LEBAK, BANTEN",4,57,107,164
https://kawalpemilu.org#52125,"SUKARAJA, WARUNGGUNUNG, LEBAK, BANTEN",5,85,69,154
https://kawalpemilu.org#52125,"SUKARAJA, WARUNGGUNUNG, LEBAK, BANTEN",6,46,67,113
https://kawalpemilu.org#52125,"SUKARAJA, WARUNGGUNUNG, LEBAK, BANTEN",7,95,59,154
https://kawalpemilu.org#52125,"SUKARAJA, WARUNGGUNUNG, LEBAK, BANTEN",8,89,84,173
https://kawalpemilu.org#52125,"SUKARAJA, WARUNGGUNUNG, LEBAK, BANTEN",9,61,105,166
https://kawalpemilu.org#52125,"SUKARAJA, WARUNGGUNUNG, LEBAK, BANTEN",10,34,115,149
https://kawalpemilu.org#52125,"SUKARAJA, WARUNGGUNUNG, LEBAK, BANTEN",11,56,83,139
https://kawalpemilu.org#52125,"SUKARAJA, WARUNGGUNUNG, LEBAK, BANTEN",12,21,108,129
https://kawalpemilu.org#52125,"SUKARAJA, WARUNGGUNUNG, LEBAK, BANTEN",13,21,93,114
https://kawalpemilu.org#52125,"SUKARAJA, WARUNGGUNUNG, LEBAK, BANTEN",14,70,59,129
https://kawalpemilu.org#52125,"SUKARAJA, WARUNGGUNUNG, LEBAK, BANTEN",15,30,57,87
https://kawalpemilu.org#52125,"SUKARAJA, WARUNGGUNUNG, LEBAK, BANTEN",16,56,111,167
https://kawalpemilu.org#52125,"SUKARAJA, WARUNGGUNUNG, LEBAK, BANTEN",17,26,122,148
https://kawalpemilu.org#52125,"SUKARAJA, WARUNGGUNUNG, LEBAK, BANTEN",18,40,120,160
https://kawalpemilu.org#52125,"SUKARAJA, WARUNGGUNUNG, LEBAK, BANTEN",19,16,95,111
https://kawalpemilu.org#52125,"SUKARAJA, WARUNGGUNUNG, LEBAK, BANTEN",20,37,111,148
https://kawalpemilu.org#52125,"SUKARAJA, WARUNGGUNUNG, LEBAK, BANTEN",21,15,66,81
https://kawalpemilu.org#52125,"SUKARAJA, WARUNGGUNUNG, LEBAK, BANTEN",22,37,86,123
https://kawalpemilu.org#52126,"JAGABAYA, WARUNGGUNUNG, LEBAK, BANTEN",1,51,145,196
https://kawalpemilu.org#52126,"JAGABAYA, WARUNGGUNUNG, LEBAK, BANTEN",2,63,148,211
https://kawalpemilu.org#52126,"JAGABAYA, WARUNGGUNUNG, LEBAK, BANTEN",3,71,128,199
https://kawalpemilu.org#52126,"JAGABAYA, WARUNGGUNUNG, LEBAK, BANTEN",4,57,153,210
https://kawalpemilu.org#52126,"JAGABAYA, WARUNGGUNUNG, LEBAK, BANTEN",5,67,151,218
https://kawalpemilu.org#52126,"JAGABAYA, WARUNGGUNUNG, LEBAK, BANTEN",6,76,115,191
https://kawalpemilu.org#52126,"JAGABAYA, WARUNGGUNUNG, LEBAK, BANTEN",7,48,187,235
https://kawalpemilu.org#52126,"JAGABAYA, WARUNGGUNUNG, LEBAK, BANTEN",8,69,98,167
https://kawalpemilu.org#52126,"JAGABAYA, WARUNGGUNUNG, LEBAK, BANTEN",9,30,186,216
https://kawalpemilu.org#52126,"JAGABAYA, WARUNGGUNUNG, LEBAK, BANTEN",10,56,171,227
https://kawalpemilu.org#52126,"JAGABAYA, WARUNGGUNUNG, LEBAK, BANTEN",11,56,140,196
https://kawalpemilu.org#52126,"JAGABAYA, WARUNGGUNUNG, LEBAK, BANTEN",12,45,79,124
https://kawalpemilu.org#52126,"JAGABAYA, WARUNGGUNUNG, LEBAK, BANTEN",13,74,98,172
https://kawalpemilu.org#52127,"SELARAJA, WARUNGGUNUNG, LEBAK, BANTEN",1,57,149,206
https://kawalpemilu.org#52127,"SELARAJA, WARUNGGUNUNG, LEBAK, BANTEN",2,35,191,226
https://kawalpemilu.org#52127,"SELARAJA, WARUNGGUNUNG, LEBAK, BANTEN",3,71,151,222
https://kawalpemilu.org#52127,"SELARAJA, WARUNGGUNUNG, LEBAK, BANTEN",4,52,168,220
https://kawalpemilu.org#52127,"SELARAJA, WARUNGGUNUNG, LEBAK, BANTEN",5,40,186,226
https://kawalpemilu.org#52127,"SELARAJA, WARUNGGUNUNG, LEBAK, BANTEN",6,61,162,223
https://kawalpemilu.org#52127,"SELARAJA, WARUNGGUNUNG, LEBAK, BANTEN",7,54,196,250
https://kawalpemilu.org#52127,"SELARAJA, WARUNGGUNUNG, LEBAK, BANTEN",8,40,190,230
https://kawalpemilu.org#52127,"SELARAJA, WARUNGGUNUNG, LEBAK, BANTEN",9,62,162,224
https://kawalpemilu.org#52127,"SELARAJA, WARUNGGUNUNG, LEBAK, BANTEN",10,61,169,230
https://kawalpemilu.org#52127,"SELARAJA, WARUNGGUNUNG, LEBAK, BANTEN",11,84,97,181
https://kawalpemilu.org#52127,"SELARAJA, WARUNGGUNUNG, LEBAK, BANTEN",12,86,134,220
https://kawalpemilu.org#52127,"SELARAJA, WARUNGGUNUNG, LEBAK, BANTEN",13,52,130,182
https://kawalpemilu.org#52128,"CEMPAKA, WARUNGGUNUNG, LEBAK, BANTEN",1,58,155,213
https://kawalpemilu.org#52128,"CEMPAKA, WARUNGGUNUNG, LEBAK, BANTEN",2,72,95,167
https://kawalpemilu.org#52128,"CEMPAKA, WARUNGGUNUNG, LEBAK, BANTEN",3,64,150,214
https://kawalpemilu.org#52128,"CEMPAKA, WARUNGGUNUNG, LEBAK, BANTEN",4,87,143,230
https://kawalpemilu.org#52128,"CEMPAKA, WARUNGGUNUNG, LEBAK, BANTEN",5,82,161,243
https://kawalpemilu.org#52128,"CEMPAKA, WARUNGGUNUNG, LEBAK, BANTEN",6,46,152,198
https://kawalpemilu.org#52128,"CEMPAKA, WARUNGGUNUNG, LEBAK, BANTEN",7,37,150,187
https://kawalpemilu.org#52128,"CEMPAKA, WARUNGGUNUNG, LEBAK, BANTEN",8,47,98,145
https://kawalpemilu.org#52128,"CEMPAKA, WARUNGGUNUNG, LEBAK, BANTEN",9,21,98,119
https://kawalpemilu.org#52128,"CEMPAKA, WARUNGGUNUNG, LEBAK, BANTEN",10,37,126,163
https://kawalpemilu.org#52128,"CEMPAKA, WARUNGGUNUNG, LEBAK, BANTEN",11,27,126,153
https://kawalpemilu.org#52129,"SINDANGSARI, WARUNGGUNUNG, LEBAK, BANTEN",1,65,138,203
https://kawalpemilu.org#52129,"SINDANGSARI, WARUNGGUNUNG, LEBAK, BANTEN",2,110,99,209
https://kawalpemilu.org#52129,"SINDANGSARI, WARUNGGUNUNG, LEBAK, BANTEN",3,71,132,203
https://kawalpemilu.org#52129,"SINDANGSARI, WARUNGGUNUNG, LEBAK, BANTEN",4,59,163,222
https://kawalpemilu.org#52129,"SINDANGSARI, WARUNGGUNUNG, LEBAK, BANTEN",5,45,161,206
https://kawalpemilu.org#52129,"SINDANGSARI, WARUNGGUNUNG, LEBAK, BANTEN",6,85,113,198
https://kawalpemilu.org#52129,"SINDANGSARI, WARUNGGUNUNG, LEBAK, BANTEN",7,34,149,183
https://kawalpemilu.org#52129,"SINDANGSARI, WARUNGGUNUNG, LEBAK, BANTEN",8,41,140,181
https://kawalpemilu.org#52131,"MEKARJAYA, CIJAKU, LEBAK, BANTEN",1,65,113,178
https://kawalpemilu.org#52131,"MEKARJAYA, CIJAKU, LEBAK, BANTEN",2,43,83,126
https://kawalpemilu.org#52131,"MEKARJAYA, CIJAKU, LEBAK, BANTEN",3,63,57,120
https://kawalpemilu.org#52131,"MEKARJAYA, CIJAKU, LEBAK, BANTEN",4,63,116,179
https://kawalpemilu.org#52131,"MEKARJAYA, CIJAKU, LEBAK, BANTEN",5,59,57,116
https://kawalpemilu.org#52131,"MEKARJAYA, CIJAKU, LEBAK, BANTEN",6,66,52,118
https://kawalpemilu.org#52131,"MEKARJAYA, CIJAKU, LEBAK, BANTEN",7,102,101,203
https://kawalpemilu.org#52131,"MEKARJAYA, CIJAKU, LEBAK, BANTEN",8,16,156,172
https://kawalpemilu.org#52131,"MEKARJAYA, CIJAKU, LEBAK, BANTEN",9,33,121,154
https://kawalpemilu.org#52132,"CIPALABUH, CIJAKU, LEBAK, BANTEN",1,50,154,204
https://kawalpemilu.org#52132,"CIPALABUH, CIJAKU, LEBAK, BANTEN",2,24,151,175
https://kawalpemilu.org#52132,"CIPALABUH, CIJAKU, LEBAK, BANTEN",3,23,111,134
https://kawalpemilu.org#52132,"CIPALABUH, CIJAKU, LEBAK, BANTEN",4,71,110,181
https://kawalpemilu.org#52132,"CIPALABUH, CIJAKU, LEBAK, BANTEN",5,73,75,148
https://kawalpemilu.org#52132,"CIPALABUH, CIJAKU, LEBAK, BANTEN",6,22,136,158
https://kawalpemilu.org#52132,"CIPALABUH, CIJAKU, LEBAK, BANTEN",7,35,90,125
https://kawalpemilu.org#52132,"CIPALABUH, CIJAKU, LEBAK, BANTEN",8,62,156,218
https://kawalpemilu.org#52132,"CIPALABUH, CIJAKU, LEBAK, BANTEN",9,42,116,158
https://kawalpemilu.org#52132,"CIPALABUH, CIJAKU, LEBAK, BANTEN",10,55,132,187
https://kawalpemilu.org#52132,"CIPALABUH, CIJAKU, LEBAK, BANTEN",11,34,82,116
https://kawalpemilu.org#52132,"CIPALABUH, CIJAKU, LEBAK, BANTEN",12,57,98,155
https://kawalpemilu.org#52132,"CIPALABUH, CIJAKU, LEBAK, BANTEN",13,64,47,111
https://kawalpemilu.org#52133,"CIJAKU, CIJAKU, LEBAK, BANTEN",1,107,114,221
https://kawalpemilu.org#52133,"CIJAKU, CIJAKU, LEBAK, BANTEN",2,155,89,244
https://kawalpemilu.org#52133,"CIJAKU, CIJAKU, LEBAK, BANTEN",3,58,141,199
https://kawalpemilu.org#52133,"CIJAKU, CIJAKU, LEBAK, BANTEN",4,45,182,227
https://kawalpemilu.org#52133,"CIJAKU, CIJAKU, LEBAK, BANTEN",5,35,178,213
https://kawalpemilu.org#52133,"CIJAKU, CIJAKU, LEBAK, BANTEN",6,89,91,180
https://kawalpemilu.org#52133,"CIJAKU, CIJAKU, LEBAK, BANTEN",7,133,91,224
https://kawalpemilu.org#52133,"CIJAKU, CIJAKU, LEBAK, BANTEN",8,66,116,182
https://kawalpemilu.org#52133,"CIJAKU, CIJAKU, LEBAK, BANTEN",9,49,137,186
https://kawalpemilu.org#52133,"CIJAKU, CIJAKU, LEBAK, BANTEN",10,56,167,223
https://kawalpemilu.org#52134,"CIBEUREUM, CIJAKU, LEBAK, BANTEN",1,114,98,212
https://kawalpemilu.org#52134,"CIBEUREUM, CIJAKU, LEBAK, BANTEN",2,111,77,188
https://kawalpemilu.org#52134,"CIBEUREUM, CIJAKU, LEBAK, BANTEN",3,35,181,216
https://kawalpemilu.org#52134,"CIBEUREUM, CIJAKU, LEBAK, BANTEN",4,71,136,207
https://kawalpemilu.org#52134,"CIBEUREUM, CIJAKU, LEBAK, BANTEN",5,81,52,133
https://kawalpemilu.org#52134,"CIBEUREUM, CIJAKU, LEBAK, BANTEN",6,69,122,191
https://kawalpemilu.org#52134,"CIBEUREUM, CIJAKU, LEBAK, BANTEN",7,80,109,189
https://kawalpemilu.org#52134,"CIBEUREUM, CIJAKU, LEBAK, BANTEN",8,70,103,173
https://kawalpemilu.org#52135,"CIAPUS, CIJAKU, LEBAK, BANTEN",1,14,136,150
https://kawalpemilu.org#52135,"CIAPUS, CIJAKU, LEBAK, BANTEN",2,31,96,127
https://kawalpemilu.org#52135,"CIAPUS, CIJAKU, LEBAK, BANTEN",3,35,111,146
https://kawalpemilu.org#52135,"CIAPUS, CIJAKU, LEBAK, BANTEN",4,63,58,121
https://kawalpemilu.org#52135,"CIAPUS, CIJAKU, LEBAK, BANTEN",5,46,103,149
https://kawalpemilu.org#52135,"CIAPUS, CIJAKU, LEBAK, BANTEN",6,39,120,159
https://kawalpemilu.org#52135,"CIAPUS, CIJAKU, LEBAK, BANTEN",7,22,123,145
https://kawalpemilu.org#52135,"CIAPUS, CIJAKU, LEBAK, BANTEN",8,14,128,142
https://kawalpemilu.org#52135,"CIAPUS, CIJAKU, LEBAK, BANTEN",9,22,103,125
https://kawalpemilu.org#52135,"CIAPUS, CIJAKU, LEBAK, BANTEN",10,46,92,138
https://kawalpemilu.org#52135,"CIAPUS, CIJAKU, LEBAK, BANTEN",11,45,82,127
https://kawalpemilu.org#52136,"KANDANGSAPI, CIJAKU, LEBAK, BANTEN",1,85,108,193
https://kawalpemilu.org#52136,"KANDANGSAPI, CIJAKU, LEBAK, BANTEN",2,57,146,203
https://kawalpemilu.org#52136,"KANDANGSAPI, CIJAKU, LEBAK, BANTEN",3,60,149,209
https://kawalpemilu.org#52136,"KANDANGSAPI, CIJAKU, LEBAK, BANTEN",4,92,111,203
https://kawalpemilu.org#52136,"KANDANGSAPI, CIJAKU, LEBAK, BANTEN",5,88,49,137
https://kawalpemilu.org#52136,"KANDANGSAPI, CIJAKU, LEBAK, BANTEN",6,108,58,166
https://kawalpemilu.org#52136,"KANDANGSAPI, CIJAKU, LEBAK, BANTEN",7,93,118,211
https://kawalpemilu.org#52136,"KANDANGSAPI, CIJAKU, LEBAK, BANTEN",8,153,85,238
https://kawalpemilu.org#52136,"KANDANGSAPI, CIJAKU, LEBAK, BANTEN",9,74,80,154
https://kawalpemilu.org#52136,"KANDANGSAPI, CIJAKU, LEBAK, BANTEN",10,99,140,239
https://kawalpemilu.org#52136,"KANDANGSAPI, CIJAKU, LEBAK, BANTEN",11,44,175,219
https://kawalpemilu.org#52136,"KANDANGSAPI, CIJAKU, LEBAK, BANTEN",12,60,100,160
https://kawalpemilu.org#52136,"KANDANGSAPI, CIJAKU, LEBAK, BANTEN",13,51,58,109
https://kawalpemilu.org#52136,"KANDANGSAPI, CIJAKU, LEBAK, BANTEN",14,82,62,144
https://kawalpemilu.org#52136,"KANDANGSAPI, CIJAKU, LEBAK, BANTEN",15,124,83,207
https://kawalpemilu.org#52136,"KANDANGSAPI, CIJAKU, LEBAK, BANTEN",16,50,85,135
https://kawalpemilu.org#52137,"CIHUJAN, CIJAKU, LEBAK, BANTEN",1,118,51,169
https://kawalpemilu.org#52137,"CIHUJAN, CIJAKU, LEBAK, BANTEN",2,141,69,210
https://kawalpemilu.org#52137,"CIHUJAN, CIJAKU, LEBAK, BANTEN",3,113,116,229
https://kawalpemilu.org#52137,"CIHUJAN, CIJAKU, LEBAK, BANTEN",4,134,83,217
https://kawalpemilu.org#52137,"CIHUJAN, CIJAKU, LEBAK, BANTEN",5,101,93,194
https://kawalpemilu.org#52137,"CIHUJAN, CIJAKU, LEBAK, BANTEN",6,110,52,162
https://kawalpemilu.org#52137,"CIHUJAN, CIJAKU, LEBAK, BANTEN",7,123,48,171
https://kawalpemilu.org#52137,"CIHUJAN, CIJAKU, LEBAK, BANTEN",8,119,80,199
https://kawalpemilu.org#52137,"CIHUJAN, CIJAKU, LEBAK, BANTEN",9,129,63,192
https://kawalpemilu.org#52138,"CIMENGA, CIJAKU, LEBAK, BANTEN",1,27,90,117
https://kawalpemilu.org#52138,"CIMENGA, CIJAKU, LEBAK, BANTEN",2,31,162,193
https://kawalpemilu.org#52138,"CIMENGA, CIJAKU, LEBAK, BANTEN",3,14,109,123
https://kawalpemilu.org#52138,"CIMENGA, CIJAKU, LEBAK, BANTEN",4,14,145,159
https://kawalpemilu.org#52138,"CIMENGA, CIJAKU, LEBAK, BANTEN",5,31,114,145
https://kawalpemilu.org#52138,"CIMENGA, CIJAKU, LEBAK, BANTEN",6,44,57,101
https://kawalpemilu.org#52139,"SUKASENANG, CIJAKU, LEBAK, BANTEN",1,76,146,222
https://kawalpemilu.org#52139,"SUKASENANG, CIJAKU, LEBAK, BANTEN",2,91,99,190
https://kawalpemilu.org#52139,"SUKASENANG, CIJAKU, LEBAK, BANTEN",3,83,106,189
https://kawalpemilu.org#52139,"SUKASENANG, CIJAKU, LEBAK, BANTEN",4,113,89,202
https://kawalpemilu.org#52139,"SUKASENANG, CIJAKU, LEBAK, BANTEN",5,67,90,157
https://kawalpemilu.org#52139,"SUKASENANG, CIJAKU, LEBAK, BANTEN",6,91,84,175
https://kawalpemilu.org#52140,"KAPUNDUHAN, CIJAKU, LEBAK, BANTEN",1,76,138,214
https://kawalpemilu.org#52140,"KAPUNDUHAN, CIJAKU, LEBAK, BANTEN",2,44,155,199
https://kawalpemilu.org#52140,"KAPUNDUHAN, CIJAKU, LEBAK, BANTEN",3,68,57,125
https://kawalpemilu.org#52140,"KAPUNDUHAN, CIJAKU, LEBAK, BANTEN",4,36,109,145
https://kawalpemilu.org#52140,"KAPUNDUHAN, CIJAKU, LEBAK, BANTEN",5,43,126,169
https://kawalpemilu.org#52140,"KAPUNDUHAN, CIJAKU, LEBAK, BANTEN",6,48,152,200
https://kawalpemilu.org#52142,"ANGGALAN, CIKULUR, LEBAK, BANTEN",1,65,128,193
https://kawalpemilu.org#52142,"ANGGALAN, CIKULUR, LEBAK, BANTEN",2,77,77,154
https://kawalpemilu.org#52142,"ANGGALAN, CIKULUR, LEBAK, BANTEN",4,54,146,200
https://kawalpemilu.org#52142,"ANGGALAN, CIKULUR, LEBAK, BANTEN",5,68,118,186
https://kawalpemilu.org#52142,"ANGGALAN, CIKULUR, LEBAK, BANTEN",6,83,97,180
https://kawalpemilu.org#52142,"ANGGALAN, CIKULUR, LEBAK, BANTEN",7,31,158,189
https://kawalpemilu.org#52142,"ANGGALAN, CIKULUR, LEBAK, BANTEN",8,58,150,208
https://kawalpemilu.org#52142,"ANGGALAN, CIKULUR, LEBAK, BANTEN",9,89,103,192
https://kawalpemilu.org#52143,"MUNCANGKOPONG, CIKULUR, LEBAK, BANTEN",1,58,144,202
https://kawalpemilu.org#52143,"MUNCANGKOPONG, CIKULUR, LEBAK, BANTEN",2,43,181,224
https://kawalpemilu.org#52143,"MUNCANGKOPONG, CIKULUR, LEBAK, BANTEN",3,33,141,174
https://kawalpemilu.org#52143,"MUNCANGKOPONG, CIKULUR, LEBAK, BANTEN",4,51,137,188
https://kawalpemilu.org#52143,"MUNCANGKOPONG, CIKULUR, LEBAK, BANTEN",5,85,114,199
https://kawalpemilu.org#52143,"MUNCANGKOPONG, CIKULUR, LEBAK, BANTEN",6,62,123,185
https://kawalpemilu.org#52143,"MUNCANGKOPONG, CIKULUR, LEBAK, BANTEN",7,83,95,178
https://kawalpemilu.org#52143,"MUNCANGKOPONG, CIKULUR, LEBAK, BANTEN",8,48,141,189
https://kawalpemilu.org#52143,"MUNCANGKOPONG, CIKULUR, LEBAK, BANTEN",9,61,149,210
https://kawalpemilu.org#52143,"MUNCANGKOPONG, CIKULUR, LEBAK, BANTEN",10,46,209,255
https://kawalpemilu.org#52143,"MUNCANGKOPONG, CIKULUR, LEBAK, BANTEN",11,24,199,223
https://kawalpemilu.org#52143,"MUNCANGKOPONG, CIKULUR, LEBAK, BANTEN",12,53,168,221
https://kawalpemilu.org#52144,"SUKAHARJA, CIKULUR, LEBAK, BANTEN",1,93,108,201
https://kawalpemilu.org#52144,"SUKAHARJA, CIKULUR, LEBAK, BANTEN",2,59,158,217
https://kawalpemilu.org#52144,"SUKAHARJA, CIKULUR, LEBAK, BANTEN",3,75,110,185
https://kawalpemilu.org#52144,"SUKAHARJA, CIKULUR, LEBAK, BANTEN",4,63,142,205
https://kawalpemilu.org#52144,"SUKAHARJA, CIKULUR, LEBAK, BANTEN",5,106,92,198
https://kawalpemilu.org#52144,"SUKAHARJA, CIKULUR, LEBAK, BANTEN",6,91,121,212
https://kawalpemilu.org#52144,"SUKAHARJA, CIKULUR, LEBAK, BANTEN",7,53,129,182
https://kawalpemilu.org#52144,"SUKAHARJA, CIKULUR, LEBAK, BANTEN",8,45,159,204
https://kawalpemilu.org#52145,"TAMANJAYA, CIKULUR, LEBAK, BANTEN",1,24,204,228
https://kawalpemilu.org#52145,"TAMANJAYA, CIKULUR, LEBAK, BANTEN",2,36,170,206
https://kawalpemilu.org#52145,"TAMANJAYA, CIKULUR, LEBAK, BANTEN",3,43,168,211
https://kawalpemilu.org#52145,"TAMANJAYA, CIKULUR, LEBAK, BANTEN",4,76,143,219
https://kawalpemilu.org#52145,"TAMANJAYA, CIKULUR, LEBAK, BANTEN",5,61,116,177
https://kawalpemilu.org#52145,"TAMANJAYA, CIKULUR, LEBAK, BANTEN",6,50,183,233
https://kawalpemilu.org#52145,"TAMANJAYA, CIKULUR, LEBAK, BANTEN",7,59,141,200
https://kawalpemilu.org#52146,"CIGOONG UTARA, CIKULUR, LEBAK, BANTEN",1,54,200,254
https://kawalpemilu.org#52146,"CIGOONG UTARA, CIKULUR, LEBAK, BANTEN",2,49,197,246
https://kawalpemilu.org#52146,"CIGOONG UTARA, CIKULUR, LEBAK, BANTEN",3,70,171,241
https://kawalpemilu.org#52146,"CIGOONG UTARA, CIKULUR, LEBAK, BANTEN",4,31,160,191
https://kawalpemilu.org#52146,"CIGOONG UTARA, CIKULUR, LEBAK, BANTEN",5,68,166,234
https://kawalpemilu.org#52146,"CIGOONG UTARA, CIKULUR, LEBAK, BANTEN",6,103,108,211
https://kawalpemilu.org#52146,"CIGOONG UTARA, CIKULUR, LEBAK, BANTEN",7,40,151,191
https://kawalpemilu.org#52146,"CIGOONG UTARA, CIKULUR, LEBAK, BANTEN",8,70,147,217
https://kawalpemilu.org#52146,"CIGOONG UTARA, CIKULUR, LEBAK, BANTEN",9,53,151,204
https://kawalpemilu.org#52146,"CIGOONG UTARA, CIKULUR, LEBAK, BANTEN",10,51,163,214
https://kawalpemilu.org#52146,"CIGOONG UTARA, CIKULUR, LEBAK, BANTEN",11,35,179,214
https://kawalpemilu.org#52147,"MUARADUA, CIKULUR, LEBAK, BANTEN",1,56,155,211
https://kawalpemilu.org#52147,"MUARADUA, CIKULUR, LEBAK, BANTEN",2,57,127,184
https://kawalpemilu.org#52147,"MUARADUA, CIKULUR, LEBAK, BANTEN",3,77,105,182
https://kawalpemilu.org#52147,"MUARADUA, CIKULUR, LEBAK, BANTEN",4,105,97,202
https://kawalpemilu.org#52147,"MUARADUA, CIKULUR, LEBAK, BANTEN",5,54,127,181
https://kawalpemilu.org#52147,"MUARADUA, CIKULUR, LEBAK, BANTEN",6,109,78,187
https://kawalpemilu.org#52147,"MUARADUA, CIKULUR, LEBAK, BANTEN",7,63,100,163
https://kawalpemilu.org#52147,"MUARADUA, CIKULUR, LEBAK, BANTEN",8,45,134,179
https://kawalpemilu.org#52147,"MUARADUA, CIKULUR, LEBAK, BANTEN",9,65,96,161
https://kawalpemilu.org#52147,"MUARADUA, CIKULUR, LEBAK, BANTEN",10,67,129,196
https://kawalpemilu.org#52147,"MUARADUA, CIKULUR, LEBAK, BANTEN",11,90,112,202
https://kawalpemilu.org#52147,"MUARADUA, CIKULUR, LEBAK, BANTEN",12,76,105,181
https://kawalpemilu.org#52147,"MUARADUA, CIKULUR, LEBAK, BANTEN",13,77,121,198
https://kawalpemilu.org#52147,"MUARADUA, CIKULUR, LEBAK, BANTEN",14,86,120,206
https://kawalpemilu.org#52147,"MUARADUA, CIKULUR, LEBAK, BANTEN",15,50,139,189
https://kawalpemilu.org#52147,"MUARADUA, CIKULUR, LEBAK, BANTEN",16,76,118,194
https://kawalpemilu.org#52147,"MUARADUA, CIKULUR, LEBAK, BANTEN",17,90,126,216
https://kawalpemilu.org#52147,"MUARADUA, CIKULUR, LEBAK, BANTEN",18,114,74,188
https://kawalpemilu.org#52148,"CIKULUR, CIKULUR, LEBAK, BANTEN",1,43,158,201
https://kawalpemilu.org#52148,"CIKULUR, CIKULUR, LEBAK, BANTEN",2,64,183,247
https://kawalpemilu.org#52148,"CIKULUR, CIKULUR, LEBAK, BANTEN",3,32,174,206
https://kawalpemilu.org#52148,"CIKULUR, CIKULUR, LEBAK, BANTEN",4,57,175,232
https://kawalpemilu.org#52148,"CIKULUR, CIKULUR, LEBAK, BANTEN",5,78,140,218
https://kawalpemilu.org#52148,"CIKULUR, CIKULUR, LEBAK, BANTEN",6,51,179,230
https://kawalpemilu.org#52148,"CIKULUR, CIKULUR, LEBAK, BANTEN",7,36,184,220
https://kawalpemilu.org#52148,"CIKULUR, CIKULUR, LEBAK, BANTEN",8,56,158,214
https://kawalpemilu.org#52148,"CIKULUR, CIKULUR, LEBAK, BANTEN",9,41,171,212
https://kawalpemilu.org#52148,"CIKULUR, CIKULUR, LEBAK, BANTEN",10,44,180,224
https://kawalpemilu.org#52148,"CIKULUR, CIKULUR, LEBAK, BANTEN",12,21,149,170
https://kawalpemilu.org#52148,"CIKULUR, CIKULUR, LEBAK, BANTEN",13,62,142,204
https://kawalpemilu.org#52149,"CURUGPANJANG, CIKULUR, LEBAK, BANTEN",1,28,208,236
https://kawalpemilu.org#52149,"CURUGPANJANG, CIKULUR, LEBAK, BANTEN",2,58,154,212
https://kawalpemilu.org#52149,"CURUGPANJANG, CIKULUR, LEBAK, BANTEN",3,55,157,212
https://kawalpemilu.org#52149,"CURUGPANJANG, CIKULUR, LEBAK, BANTEN",4,56,161,217
https://kawalpemilu.org#52149,"CURUGPANJANG, CIKULUR, LEBAK, BANTEN",5,31,179,210
https://kawalpemilu.org#52149,"CURUGPANJANG, CIKULUR, LEBAK, BANTEN",6,27,218,245
https://kawalpemilu.org#52149,"CURUGPANJANG, CIKULUR, LEBAK, BANTEN",7,37,189,226
https://kawalpemilu.org#52149,"CURUGPANJANG, CIKULUR, LEBAK, BANTEN",8,56,148,204
https://kawalpemilu.org#52149,"CURUGPANJANG, CIKULUR, LEBAK, BANTEN",9,70,139,209
https://kawalpemilu.org#52149,"CURUGPANJANG, CIKULUR, LEBAK, BANTEN",10,57,148,205
https://kawalpemilu.org#52149,"CURUGPANJANG, CIKULUR, LEBAK, BANTEN",11,62,156,218
https://kawalpemilu.org#52149,"CURUGPANJANG, CIKULUR, LEBAK, BANTEN",12,62,100,162
https://kawalpemilu.org#52149,"CURUGPANJANG, CIKULUR, LEBAK, BANTEN",13,101,99,200
https://kawalpemilu.org#52150,"CIGOONG SELATAN, CIKULUR, LEBAK, BANTEN",1,75,142,217
https://kawalpemilu.org#52150,"CIGOONG SELATAN, CIKULUR, LEBAK, BANTEN",2,87,138,225
https://kawalpemilu.org#52150,"CIGOONG SELATAN, CIKULUR, LEBAK, BANTEN",3,67,167,234
https://kawalpemilu.org#52150,"CIGOONG SELATAN, CIKULUR, LEBAK, BANTEN",4,62,107,169
https://kawalpemilu.org#52150,"CIGOONG SELATAN, CIKULUR, LEBAK, BANTEN",5,41,129,170
https://kawalpemilu.org#52150,"CIGOONG SELATAN, CIKULUR, LEBAK, BANTEN",6,77,136,213
https://kawalpemilu.org#52150,"CIGOONG SELATAN, CIKULUR, LEBAK, BANTEN",7,93,115,208
https://kawalpemilu.org#52150,"CIGOONG SELATAN, CIKULUR, LEBAK, BANTEN",8,111,115,226
https://kawalpemilu.org#52150,"CIGOONG SELATAN, CIKULUR, LEBAK, BANTEN",9,47,150,197
https://kawalpemilu.org#52150,"CIGOONG SELATAN, CIKULUR, LEBAK, BANTEN",10,65,130,195
https://kawalpemilu.org#52151,"SUMURBANDUNG, CIKULUR, LEBAK, BANTEN",1,64,158,222
https://kawalpemilu.org#52151,"SUMURBANDUNG, CIKULUR, LEBAK, BANTEN",2,55,150,205
https://kawalpemilu.org#52151,"SUMURBANDUNG, CIKULUR, LEBAK, BANTEN",3,55,169,224
https://kawalpemilu.org#52151,"SUMURBANDUNG, CIKULUR, LEBAK, BANTEN",4,57,151,208
https://kawalpemilu.org#52151,"SUMURBANDUNG, CIKULUR, LEBAK, BANTEN",5,80,129,209
https://kawalpemilu.org#52151,"SUMURBANDUNG, CIKULUR, LEBAK, BANTEN",6,74,144,218
https://kawalpemilu.org#52151,"SUMURBANDUNG, CIKULUR, LEBAK, BANTEN",7,79,129,208
https://kawalpemilu.org#52151,"SUMURBANDUNG, CIKULUR, LEBAK, BANTEN",8,87,109,196
https://kawalpemilu.org#52151,"SUMURBANDUNG, CIKULUR, LEBAK, BANTEN",9,70,134,204
https://kawalpemilu.org#52151,"SUMURBANDUNG, CIKULUR, LEBAK, BANTEN",10,65,132,197
https://kawalpemilu.org#52151,"SUMURBANDUNG, CIKULUR, LEBAK, BANTEN",11,69,143,212
https://kawalpemilu.org#52151,"SUMURBANDUNG, CIKULUR, LEBAK, BANTEN",12,68,138,206
https://kawalpemilu.org#52151,"SUMURBANDUNG, CIKULUR, LEBAK, BANTEN",13,54,134,188
https://kawalpemilu.org#52151,"SUMURBANDUNG, CIKULUR, LEBAK, BANTEN",14,60,143,203
https://kawalpemilu.org#52151,"SUMURBANDUNG, CIKULUR, LEBAK, BANTEN",15,66,144,210
https://kawalpemilu.org#52151,"SUMURBANDUNG, CIKULUR, LEBAK, BANTEN",16,31,142,173
https://kawalpemilu.org#52151,"SUMURBANDUNG, CIKULUR, LEBAK, BANTEN",17,46,132,178
https://kawalpemilu.org#52151,"SUMURBANDUNG, CIKULUR, LEBAK, BANTEN",18,79,108,187
https://kawalpemilu.org#52152,"PARAGE, CIKULUR, LEBAK, BANTEN",1,69,108,177
https://kawalpemilu.org#52152,"PARAGE, CIKULUR, LEBAK, BANTEN",2,81,106,187
https://kawalpemilu.org#52152,"PARAGE, CIKULUR, LEBAK, BANTEN",3,60,149,209
https://kawalpemilu.org#52152,"PARAGE, CIKULUR, LEBAK, BANTEN",4,55,126,181
https://kawalpemilu.org#52152,"PARAGE, CIKULUR, LEBAK, BANTEN",5,53,103,156
https://kawalpemilu.org#52152,"PARAGE, CIKULUR, LEBAK, BANTEN",6,41,144,185
https://kawalpemilu.org#52152,"PARAGE, CIKULUR, LEBAK, BANTEN",7,40,166,206
https://kawalpemilu.org#52152,"PARAGE, CIKULUR, LEBAK, BANTEN",8,40,164,204
https://kawalpemilu.org#52153,"SUKADAYA, CIKULUR, LEBAK, BANTEN",1,56,142,198
https://kawalpemilu.org#52153,"SUKADAYA, CIKULUR, LEBAK, BANTEN",2,65,101,166
https://kawalpemilu.org#52153,"SUKADAYA, CIKULUR, LEBAK, BANTEN",3,30,175,205
https://kawalpemilu.org#52153,"SUKADAYA, CIKULUR, LEBAK, BANTEN",4,56,135,191
https://kawalpemilu.org#52153,"SUKADAYA, CIKULUR, LEBAK, BANTEN",5,93,129,222
https://kawalpemilu.org#52153,"SUKADAYA, CIKULUR, LEBAK, BANTEN",6,51,153,204
https://kawalpemilu.org#52153,"SUKADAYA, CIKULUR, LEBAK, BANTEN",7,71,116,187
https://kawalpemilu.org#52153,"SUKADAYA, CIKULUR, LEBAK, BANTEN",8,67,94,161
https://kawalpemilu.org#52153,"SUKADAYA, CIKULUR, LEBAK, BANTEN",9,40,148,188
https://kawalpemilu.org#52153,"SUKADAYA, CIKULUR, LEBAK, BANTEN",10,27,179,206
https://kawalpemilu.org#52153,"SUKADAYA, CIKULUR, LEBAK, BANTEN",11,53,141,194
https://kawalpemilu.org#52154,"PASIRGINTUNG, CIKULUR, LEBAK, BANTEN",1,70,96,166
https://kawalpemilu.org#52154,"PASIRGINTUNG, CIKULUR, LEBAK, BANTEN",2,63,107,170
https://kawalpemilu.org#52154,"PASIRGINTUNG, CIKULUR, LEBAK, BANTEN",3,74,78,152
https://kawalpemilu.org#52154,"PASIRGINTUNG, CIKULUR, LEBAK, BANTEN",4,73,124,197
https://kawalpemilu.org#52154,"PASIRGINTUNG, CIKULUR, LEBAK, BANTEN",5,104,87,191
https://kawalpemilu.org#52154,"PASIRGINTUNG, CIKULUR, LEBAK, BANTEN",6,87,68,155
https://kawalpemilu.org#52156,"TAMBAKBAYA, CIBADAK, LEBAK, BANTEN",1,74,113,187
https://kawalpemilu.org#52156,"TAMBAKBAYA, CIBADAK, LEBAK, BANTEN",2,73,141,214
https://kawalpemilu.org#52156,"TAMBAKBAYA, CIBADAK, LEBAK, BANTEN",3,39,206,245
https://kawalpemilu.org#52156,"TAMBAKBAYA, CIBADAK, LEBAK, BANTEN",4,40,164,204
https://kawalpemilu.org#52156,"TAMBAKBAYA, CIBADAK, LEBAK, BANTEN",5,84,132,216
https://kawalpemilu.org#52156,"TAMBAKBAYA, CIBADAK, LEBAK, BANTEN",6,57,168,225
https://kawalpemilu.org#52156,"TAMBAKBAYA, CIBADAK, LEBAK, BANTEN",7,75,125,200
https://kawalpemilu.org#52156,"TAMBAKBAYA, CIBADAK, LEBAK, BANTEN",8,71,150,221
https://kawalpemilu.org#52156,"TAMBAKBAYA, CIBADAK, LEBAK, BANTEN",9,82,124,206
https://kawalpemilu.org#52156,"TAMBAKBAYA, CIBADAK, LEBAK, BANTEN",10,113,89,202
https://kawalpemilu.org#52156,"TAMBAKBAYA, CIBADAK, LEBAK, BANTEN",11,92,125,217
https://kawalpemilu.org#52156,"TAMBAKBAYA, CIBADAK, LEBAK, BANTEN",12,61,143,204
https://kawalpemilu.org#52156,"TAMBAKBAYA, CIBADAK, LEBAK, BANTEN",13,63,168,231
https://kawalpemilu.org#52156,"TAMBAKBAYA, CIBADAK, LEBAK, BANTEN",14,60,132,192
https://kawalpemilu.org#52156,"TAMBAKBAYA, CIBADAK, LEBAK, BANTEN",15,72,119,191
https://kawalpemilu.org#52156,"TAMBAKBAYA, CIBADAK, LEBAK, BANTEN",16,69,121,190
https://kawalpemilu.org#52157,"KADUAGUNG TIMUR, CIBADAK, LEBAK, BANTEN",1,63,125,188
https://kawalpemilu.org#52157,"KADUAGUNG TIMUR, CIBADAK, LEBAK, BANTEN",2,53,165,218
https://kawalpemilu.org#52157,"KADUAGUNG TIMUR, CIBADAK, LEBAK, BANTEN",3,68,101,169
https://kawalpemilu.org#52157,"KADUAGUNG TIMUR, CIBADAK, LEBAK, BANTEN",4,51,149,200
https://kawalpemilu.org#52157,"KADUAGUNG TIMUR, CIBADAK, LEBAK, BANTEN",5,71,132,203
https://kawalpemilu.org#52157,"KADUAGUNG TIMUR, CIBADAK, LEBAK, BANTEN",6,60,165,225
https://kawalpemilu.org#52157,"KADUAGUNG TIMUR, CIBADAK, LEBAK, BANTEN",7,38,178,216
https://kawalpemilu.org#52157,"KADUAGUNG TIMUR, CIBADAK, LEBAK, BANTEN",8,65,153,218
https://kawalpemilu.org#52157,"KADUAGUNG TIMUR, CIBADAK, LEBAK, BANTEN",9,34,186,220
https://kawalpemilu.org#52157,"KADUAGUNG TIMUR, CIBADAK, LEBAK, BANTEN",10,65,155,220
https://kawalpemilu.org#52157,"KADUAGUNG TIMUR, CIBADAK, LEBAK, BANTEN",11,59,175,234
https://kawalpemilu.org#52157,"KADUAGUNG TIMUR, CIBADAK, LEBAK, BANTEN",12,64,150,214
https://kawalpemilu.org#52157,"KADUAGUNG TIMUR, CIBADAK, LEBAK, BANTEN",13,57,125,182
https://kawalpemilu.org#52157,"KADUAGUNG TIMUR, CIBADAK, LEBAK, BANTEN",14,66,150,216
https://kawalpemilu.org#52157,"KADUAGUNG TIMUR, CIBADAK, LEBAK, BANTEN",15,67,144,211
https://kawalpemilu.org#52157,"KADUAGUNG TIMUR, CIBADAK, LEBAK, BANTEN",16,50,141,191
https://kawalpemilu.org#52157,"KADUAGUNG TIMUR, CIBADAK, LEBAK, BANTEN",17,50,123,173
https://kawalpemilu.org#52157,"KADUAGUNG TIMUR, CIBADAK, LEBAK, BANTEN",18,67,204,271
https://kawalpemilu.org#52157,"KADUAGUNG TIMUR, CIBADAK, LEBAK, BANTEN",19,39,133,172
https://kawalpemilu.org#52157,"KADUAGUNG TIMUR, CIBADAK, LEBAK, BANTEN",20,54,154,208
https://kawalpemilu.org#52157,"KADUAGUNG TIMUR, CIBADAK, LEBAK, BANTEN",21,44,172,216
https://kawalpemilu.org#52158,"PANANCANGAN, CIBADAK, LEBAK, BANTEN",1,53,110,163
https://kawalpemilu.org#52158,"PANANCANGAN, CIBADAK, LEBAK, BANTEN",2,35,133,168
https://kawalpemilu.org#52158,"PANANCANGAN, CIBADAK, LEBAK, BANTEN",3,63,163,226
https://kawalpemilu.org#52158,"PANANCANGAN, CIBADAK, LEBAK, BANTEN",4,49,138,187
https://kawalpemilu.org#52158,"PANANCANGAN, CIBADAK, LEBAK, BANTEN",5,36,194,230
https://kawalpemilu.org#52158,"PANANCANGAN, CIBADAK, LEBAK, BANTEN",6,48,168,216
https://kawalpemilu.org#52158,"PANANCANGAN, CIBADAK, LEBAK, BANTEN",7,41,179,220
https://kawalpemilu.org#52158,"PANANCANGAN, CIBADAK, LEBAK, BANTEN",8,75,163,238
https://kawalpemilu.org#52158,"PANANCANGAN, CIBADAK, LEBAK, BANTEN",9,70,157,227
https://kawalpemilu.org#52159,"CIBADAK, CIBADAK, LEBAK, BANTEN",1,67,174,241
https://kawalpemilu.org#52159,"CIBADAK, CIBADAK, LEBAK, BANTEN",2,80,157,237
https://kawalpemilu.org#52159,"CIBADAK, CIBADAK, LEBAK, BANTEN",3,60,163,223
https://kawalpemilu.org#52159,"CIBADAK, CIBADAK, LEBAK, BANTEN",4,53,150,203
https://kawalpemilu.org#52159,"CIBADAK, CIBADAK, LEBAK, BANTEN",5,109,135,244
https://kawalpemilu.org#52159,"CIBADAK, CIBADAK, LEBAK, BANTEN",6,80,152,232
https://kawalpemilu.org#52159,"CIBADAK, CIBADAK, LEBAK, BANTEN",7,55,124,179
https://kawalpemilu.org#52159,"CIBADAK, CIBADAK, LEBAK, BANTEN",8,45,146,191
https://kawalpemilu.org#52159,"CIBADAK, CIBADAK, LEBAK, BANTEN",9,57,123,180
https://kawalpemilu.org#52159,"CIBADAK, CIBADAK, LEBAK, BANTEN",10,46,132,178
https://kawalpemilu.org#52159,"CIBADAK, CIBADAK, LEBAK, BANTEN",11,68,105,173
https://kawalpemilu.org#52159,"CIBADAK, CIBADAK, LEBAK, BANTEN",12,50,114,164
https://kawalpemilu.org#52159,"CIBADAK, CIBADAK, LEBAK, BANTEN",13,98,87,185
https://kawalpemilu.org#52159,"CIBADAK, CIBADAK, LEBAK, BANTEN",14,66,124,190
https://kawalpemilu.org#52159,"CIBADAK, CIBADAK, LEBAK, BANTEN",15,67,127,194
https://kawalpemilu.org#52160,"ASEM, CIBADAK, LEBAK, BANTEN",1,61,140,201
https://kawalpemilu.org#52160,"ASEM, CIBADAK, LEBAK, BANTEN",2,60,78,138
https://kawalpemilu.org#52160,"ASEM, CIBADAK, LEBAK, BANTEN",3,36,79,115
https://kawalpemilu.org#52160,"ASEM, CIBADAK, LEBAK, BANTEN",4,89,70,159
https://kawalpemilu.org#52160,"ASEM, CIBADAK, LEBAK, BANTEN",5,69,134,203
https://kawalpemilu.org#52160,"ASEM, CIBADAK, LEBAK, BANTEN",6,79,136,215
https://kawalpemilu.org#52160,"ASEM, CIBADAK, LEBAK, BANTEN",7,94,138,232
https://kawalpemilu.org#52160,"ASEM, CIBADAK, LEBAK, BANTEN",8,47,163,210
https://kawalpemilu.org#52160,"ASEM, CIBADAK, LEBAK, BANTEN",9,54,74,128
https://kawalpemilu.org#52161,"CISANGU, CIBADAK, LEBAK, BANTEN",1,41,101,142
https://kawalpemilu.org#52161,"CISANGU, CIBADAK, LEBAK, BANTEN",2,81,102,183
https://kawalpemilu.org#52161,"CISANGU, CIBADAK, LEBAK, BANTEN",3,71,142,213
https://kawalpemilu.org#52161,"CISANGU, CIBADAK, LEBAK, BANTEN",4,52,178,230
https://kawalpemilu.org#52161,"CISANGU, CIBADAK, LEBAK, BANTEN",5,34,199,233
https://kawalpemilu.org#52161,"CISANGU, CIBADAK, LEBAK, BANTEN",6,40,191,231
https://kawalpemilu.org#52161,"CISANGU, CIBADAK, LEBAK, BANTEN",7,43,125,168
https://kawalpemilu.org#52161,"CISANGU, CIBADAK, LEBAK, BANTEN",8,33,126,159
https://kawalpemilu.org#52161,"CISANGU, CIBADAK, LEBAK, BANTEN",9,49,157,206
https://kawalpemilu.org#52161,"CISANGU, CIBADAK, LEBAK, BANTEN",10,78,178,206
https://kawalpemilu.org#52162,"KADUAGUNG BARAT, CIBADAK, LEBAK, BANTEN",1,35,189,224
https://kawalpemilu.org#52162,"KADUAGUNG BARAT, CIBADAK, LEBAK, BANTEN",2,62,163,225
https://kawalpemilu.org#52162,"KADUAGUNG BARAT, CIBADAK, LEBAK, BANTEN",3,48,106,154
https://kawalpemilu.org#52162,"KADUAGUNG BARAT, CIBADAK, LEBAK, BANTEN",4,68,129,197
https://kawalpemilu.org#52162,"KADUAGUNG BARAT, CIBADAK, LEBAK, BANTEN",5,32,131,163
https://kawalpemilu.org#52162,"KADUAGUNG BARAT, CIBADAK, LEBAK, BANTEN",6,31,126,157
https://kawalpemilu.org#52162,"KADUAGUNG BARAT, CIBADAK, LEBAK, BANTEN",7,39,113,152
https://kawalpemilu.org#52162,"KADUAGUNG BARAT, CIBADAK, LEBAK, BANTEN",8,38,111,149
https://kawalpemilu.org#52162,"KADUAGUNG BARAT, CIBADAK, LEBAK, BANTEN",9,41,131,172
https://kawalpemilu.org#52162,"KADUAGUNG BARAT, CIBADAK, LEBAK, BANTEN",10,49,85,134
https://kawalpemilu.org#52162,"KADUAGUNG BARAT, CIBADAK, LEBAK, BANTEN",11,57,118,175
https://kawalpemilu.org#52162,"KADUAGUNG BARAT, CIBADAK, LEBAK, BANTEN",12,44,167,211
https://kawalpemilu.org#52162,"KADUAGUNG BARAT, CIBADAK, LEBAK, BANTEN",13,62,168,230
https://kawalpemilu.org#52162,"KADUAGUNG BARAT, CIBADAK, LEBAK, BANTEN",14,49,90,139
https://kawalpemilu.org#52162,"KADUAGUNG BARAT, CIBADAK, LEBAK, BANTEN",15,50,70,120
https://kawalpemilu.org#52163,"BOJONGCAE, CIBADAK, LEBAK, BANTEN",1,41,186,227
https://kawalpemilu.org#52163,"BOJONGCAE, CIBADAK, LEBAK, BANTEN",2,78,152,230
https://kawalpemilu.org#52163,"BOJONGCAE, CIBADAK, LEBAK, BANTEN",3,64,151,215
https://kawalpemilu.org#52163,"BOJONGCAE, CIBADAK, LEBAK, BANTEN",4,76,152,228
https://kawalpemilu.org#52163,"BOJONGCAE, CIBADAK, LEBAK, BANTEN",5,90,131,221
https://kawalpemilu.org#52163,"BOJONGCAE, CIBADAK, LEBAK, BANTEN",6,58,157,215
https://kawalpemilu.org#52163,"BOJONGCAE, CIBADAK, LEBAK, BANTEN",7,48,169,217
https://kawalpemilu.org#52163,"BOJONGCAE, CIBADAK, LEBAK, BANTEN",8,0,0,0
https://kawalpemilu.org#52163,"BOJONGCAE, CIBADAK, LEBAK, BANTEN",9,29,190,219
https://kawalpemilu.org#52163,"BOJONGCAE, CIBADAK, LEBAK, BANTEN",10,69,148,217
https://kawalpemilu.org#52164,"MALABAR, CIBADAK, LEBAK, BANTEN",1,33,157,190
https://kawalpemilu.org#52164,"MALABAR, CIBADAK, LEBAK, BANTEN",2,24,183,207
https://kawalpemilu.org#52164,"MALABAR, CIBADAK, LEBAK, BANTEN",3,19,162,181
https://kawalpemilu.org#52164,"MALABAR, CIBADAK, LEBAK, BANTEN",4,20,213,233
https://kawalpemilu.org#52164,"MALABAR, CIBADAK, LEBAK, BANTEN",5,28,215,243
https://kawalpemilu.org#52164,"MALABAR, CIBADAK, LEBAK, BANTEN",6,21,220,241
https://kawalpemilu.org#52164,"MALABAR, CIBADAK, LEBAK, BANTEN",7,53,177,230
https://kawalpemilu.org#52164,"MALABAR, CIBADAK, LEBAK, BANTEN",8,71,146,217
https://kawalpemilu.org#52164,"MALABAR, CIBADAK, LEBAK, BANTEN",9,41,117,158
https://kawalpemilu.org#52165,"PASAR KEONG, CIBADAK, LEBAK, BANTEN",1,45,166,211
https://kawalpemilu.org#52165,"PASAR KEONG, CIBADAK, LEBAK, BANTEN",2,41,180,221
https://kawalpemilu.org#52165,"PASAR KEONG, CIBADAK, LEBAK, BANTEN",3,45,184,229
https://kawalpemilu.org#52165,"PASAR KEONG, CIBADAK, LEBAK, BANTEN",4,47,175,222
https://kawalpemilu.org#52165,"PASAR KEONG, CIBADAK, LEBAK, BANTEN",5,55,159,214
https://kawalpemilu.org#52165,"PASAR KEONG, CIBADAK, LEBAK, BANTEN",6,47,177,224
https://kawalpemilu.org#52165,"PASAR KEONG, CIBADAK, LEBAK, BANTEN",7,52,168,220
https://kawalpemilu.org#52165,"PASAR KEONG, CIBADAK, LEBAK, BANTEN",8,67,163,230
https://kawalpemilu.org#52165,"PASAR KEONG, CIBADAK, LEBAK, BANTEN",9,53,166,219
https://kawalpemilu.org#52165,"PASAR KEONG, CIBADAK, LEBAK, BANTEN",10,50,170,220
https://kawalpemilu.org#52165,"PASAR KEONG, CIBADAK, LEBAK, BANTEN",11,59,196,255
https://kawalpemilu.org#52165,"PASAR KEONG, CIBADAK, LEBAK, BANTEN",12,35,167,202
https://kawalpemilu.org#52165,"PASAR KEONG, CIBADAK, LEBAK, BANTEN",13,38,212,250
https://kawalpemilu.org#52165,"PASAR KEONG, CIBADAK, LEBAK, BANTEN",14,55,165,220
https://kawalpemilu.org#52166,"BOJONG LELES, CIBADAK, LEBAK, BANTEN",1,96,143,239
https://kawalpemilu.org#52166,"BOJONG LELES, CIBADAK, LEBAK, BANTEN",2,55,187,242
https://kawalpemilu.org#52166,"BOJONG LELES, CIBADAK, LEBAK, BANTEN",3,83,156,239
https://kawalpemilu.org#52166,"BOJONG LELES, CIBADAK, LEBAK, BANTEN",4,74,189,263
https://kawalpemilu.org#52166,"BOJONG LELES, CIBADAK, LEBAK, BANTEN",5,89,159,248
https://kawalpemilu.org#52166,"BOJONG LELES, CIBADAK, LEBAK, BANTEN",6,75,146,221
https://kawalpemilu.org#52166,"BOJONG LELES, CIBADAK, LEBAK, BANTEN",7,73,179,252
https://kawalpemilu.org#52166,"BOJONG LELES, CIBADAK, LEBAK, BANTEN",8,125,157,282
https://kawalpemilu.org#52166,"BOJONG LELES, CIBADAK, LEBAK, BANTEN",9,89,160,249
https://kawalpemilu.org#52166,"BOJONG LELES, CIBADAK, LEBAK, BANTEN",10,81,197,278
https://kawalpemilu.org#52166,"BOJONG LELES, CIBADAK, LEBAK, BANTEN",11,78,166,244
https://kawalpemilu.org#52166,"BOJONG LELES, CIBADAK, LEBAK, BANTEN",12,53,167,220
https://kawalpemilu.org#52166,"BOJONG LELES, CIBADAK, LEBAK, BANTEN",13,61,169,230
https://kawalpemilu.org#52166,"BOJONG LELES, CIBADAK, LEBAK, BANTEN",14,45,189,234
https://kawalpemilu.org#52166,"BOJONG LELES, CIBADAK, LEBAK, BANTEN",15,43,164,207
https://kawalpemilu.org#52167,"CIMENTENG JAYA, CIBADAK, LEBAK, BANTEN",1,31,88,119
https://kawalpemilu.org#52167,"CIMENTENG JAYA, CIBADAK, LEBAK, BANTEN",2,52,173,225
https://kawalpemilu.org#52167,"CIMENTENG JAYA, CIBADAK, LEBAK, BANTEN",3,125,118,243
https://kawalpemilu.org#52167,"CIMENTENG JAYA, CIBADAK, LEBAK, BANTEN",4,64,119,183
https://kawalpemilu.org#52167,"CIMENTENG JAYA, CIBADAK, LEBAK, BANTEN",5,96,101,197
https://kawalpemilu.org#52168,"MEKAR AGUNG, CIBADAK, LEBAK, BANTEN",1,59,155,214
https://kawalpemilu.org#52168,"MEKAR AGUNG, CIBADAK, LEBAK, BANTEN",2,118,126,244
https://kawalpemilu.org#52168,"MEKAR AGUNG, CIBADAK, LEBAK, BANTEN",3,71,172,243
https://kawalpemilu.org#52168,"MEKAR AGUNG, CIBADAK, LEBAK, BANTEN",4,52,168,220
https://kawalpemilu.org#52168,"MEKAR AGUNG, CIBADAK, LEBAK, BANTEN",5,71,165,236
https://kawalpemilu.org#52168,"MEKAR AGUNG, CIBADAK, LEBAK, BANTEN",6,61,141,202
https://kawalpemilu.org#52168,"MEKAR AGUNG, CIBADAK, LEBAK, BANTEN",7,75,127,202
https://kawalpemilu.org#52168,"MEKAR AGUNG, CIBADAK, LEBAK, BANTEN",8,51,123,174
https://kawalpemilu.org#52168,"MEKAR AGUNG, CIBADAK, LEBAK, BANTEN",9,69,95,164
https://kawalpemilu.org#52168,"MEKAR AGUNG, CIBADAK, LEBAK, BANTEN",10,62,134,196
https://kawalpemilu.org#52168,"MEKAR AGUNG, CIBADAK, LEBAK, BANTEN",11,71,150,221
https://kawalpemilu.org#52168,"MEKAR AGUNG, CIBADAK, LEBAK, BANTEN",12,79,154,233
https://kawalpemilu.org#52169,"ASEM MARGALUYU, CIBADAK, LEBAK, BANTEN",1,59,160,219
https://kawalpemilu.org#52169,"ASEM MARGALUYU, CIBADAK, LEBAK, BANTEN",2,97,109,206
https://kawalpemilu.org#52169,"ASEM MARGALUYU, CIBADAK, LEBAK, BANTEN",3,77,126,203
https://kawalpemilu.org#52169,"ASEM MARGALUYU, CIBADAK, LEBAK, BANTEN",4,83,111,194
https://kawalpemilu.org#52169,"ASEM MARGALUYU, CIBADAK, LEBAK, BANTEN",5,67,104,171
https://kawalpemilu.org#52169,"ASEM MARGALUYU, CIBADAK, LEBAK, BANTEN",6,62,110,14
https://kawalpemilu.org#52169,"ASEM MARGALUYU, CIBADAK, LEBAK, BANTEN",7,20,131,151
https://kawalpemilu.org#52169,"ASEM MARGALUYU, CIBADAK, LEBAK, BANTEN",8,82,147,229
https://kawalpemilu.org#52169,"ASEM MARGALUYU, CIBADAK, LEBAK, BANTEN",9,56,158,214
https://kawalpemilu.org#52169,"ASEM MARGALUYU, CIBADAK, LEBAK, BANTEN",10,65,152,217
https://kawalpemilu.org#52170,"KADUAGUNG TENGAH, CIBADAK, LEBAK, BANTEN",1,140,55,195
https://kawalpemilu.org#52170,"KADUAGUNG TENGAH, CIBADAK, LEBAK, BANTEN",2,106,128,234
https://kawalpemilu.org#52170,"KADUAGUNG TENGAH, CIBADAK, LEBAK, BANTEN",3,99,135,234
https://kawalpemilu.org#52170,"KADUAGUNG TENGAH, CIBADAK, LEBAK, BANTEN",4,81,95,176
https://kawalpemilu.org#52170,"KADUAGUNG TENGAH, CIBADAK, LEBAK, BANTEN",5,75,137,212
https://kawalpemilu.org#52170,"KADUAGUNG TENGAH, CIBADAK, LEBAK, BANTEN",6,92,93,185
https://kawalpemilu.org#52170,"KADUAGUNG TENGAH, CIBADAK, LEBAK, BANTEN",7,52,171,223
https://kawalpemilu.org#52170,"KADUAGUNG TENGAH, CIBADAK, LEBAK, BANTEN",8,66,151,217
https://kawalpemilu.org#52170,"KADUAGUNG TENGAH, CIBADAK, LEBAK, BANTEN",9,49,196,245
https://kawalpemilu.org#52170,"KADUAGUNG TENGAH, CIBADAK, LEBAK, BANTEN",10,27,181,208
https://kawalpemilu.org#52170,"KADUAGUNG TENGAH, CIBADAK, LEBAK, BANTEN",11,84,55,139
https://kawalpemilu.org#52172,"CIBEBER, CIBEBER, LEBAK, BANTEN",1,90,140,230
https://kawalpemilu.org#52172,"CIBEBER, CIBEBER, LEBAK, BANTEN",2,41,29,70
https://kawalpemilu.org#52172,"CIBEBER, CIBEBER, LEBAK, BANTEN",3,57,107,164
https://kawalpemilu.org#52172,"CIBEBER, CIBEBER, LEBAK, BANTEN",4,99,112,211
https://kawalpemilu.org#52172,"CIBEBER, CIBEBER, LEBAK, BANTEN",5,51,148,199
https://kawalpemilu.org#52172,"CIBEBER, CIBEBER, LEBAK, BANTEN",6,60,180,240
https://kawalpemilu.org#52172,"CIBEBER, CIBEBER, LEBAK, BANTEN",7,54,158,212
https://kawalpemilu.org#52172,"CIBEBER, CIBEBER, LEBAK, BANTEN",8,30,127,157
https://kawalpemilu.org#52172,"CIBEBER, CIBEBER, LEBAK, BANTEN",9,133,87,220
https://kawalpemilu.org#52172,"CIBEBER, CIBEBER, LEBAK, BANTEN",10,95,105,200
https://kawalpemilu.org#52172,"CIBEBER, CIBEBER, LEBAK, BANTEN",11,52,188,240
https://kawalpemilu.org#52172,"CIBEBER, CIBEBER, LEBAK, BANTEN",12,79,122,201
https://kawalpemilu.org#52172,"CIBEBER, CIBEBER, LEBAK, BANTEN",13,38,54,92
https://kawalpemilu.org#52173,"CITOREK TENGAH, CIBEBER, LEBAK, BANTEN",1,30,184,214
https://kawalpemilu.org#52173,"CITOREK TENGAH, CIBEBER, LEBAK, BANTEN",2,25,201,226
https://kawalpemilu.org#52173,"CITOREK TENGAH, CIBEBER, LEBAK, BANTEN",3,41,197,238
https://kawalpemilu.org#52173,"CITOREK TENGAH, CIBEBER, LEBAK, BANTEN",4,58,152,210
https://kawalpemilu.org#52173,"CITOREK TENGAH, CIBEBER, LEBAK, BANTEN",5,37,168,205
https://kawalpemilu.org#52173,"CITOREK TENGAH, CIBEBER, LEBAK, BANTEN",6,59,150,209
https://kawalpemilu.org#52173,"CITOREK TENGAH, CIBEBER, LEBAK, BANTEN",7,25,183,208
https://kawalpemilu.org#52173,"CITOREK TENGAH, CIBEBER, LEBAK, BANTEN",8,50,210,260
https://kawalpemilu.org#52173,"CITOREK TENGAH, CIBEBER, LEBAK, BANTEN",9,63,198,261
https://kawalpemilu.org#52173,"CITOREK TENGAH, CIBEBER, LEBAK, BANTEN",10,24,197,221
https://kawalpemilu.org#52173,"CITOREK TENGAH, CIBEBER, LEBAK, BANTEN",11,28,189,217
https://kawalpemilu.org#52173,"CITOREK TENGAH, CIBEBER, LEBAK, BANTEN",12,9,84,93
https://kawalpemilu.org#52174,"CISUNGSANG, CIBEBER, LEBAK, BANTEN",2,65,128,193
https://kawalpemilu.org#52174,"CISUNGSANG, CIBEBER, LEBAK, BANTEN",3,82,133,215
https://kawalpemilu.org#52174,"CISUNGSANG, CIBEBER, LEBAK, BANTEN",4,100,112,212
https://kawalpemilu.org#52174,"CISUNGSANG, CIBEBER, LEBAK, BANTEN",5,96,127,223
https://kawalpemilu.org#52174,"CISUNGSANG, CIBEBER, LEBAK, BANTEN",6,116,112,228
https://kawalpemilu.org#52174,"CISUNGSANG, CIBEBER, LEBAK, BANTEN",7,50,101,151
https://kawalpemilu.org#52175,"KUJANGJAYA, CIBEBER, LEBAK, BANTEN",1,139,120,259
https://kawalpemilu.org#52175,"KUJANGJAYA, CIBEBER, LEBAK, BANTEN",2,128,54,182
https://kawalpemilu.org#52175,"KUJANGJAYA, CIBEBER, LEBAK, BANTEN",3,112,69,181
https://kawalpemilu.org#52175,"KUJANGJAYA, CIBEBER, LEBAK, BANTEN",4,97,131,228
https://kawalpemilu.org#52175,"KUJANGJAYA, CIBEBER, LEBAK, BANTEN",5,135,62,197
https://kawalpemilu.org#52175,"KUJANGJAYA, CIBEBER, LEBAK, BANTEN",6,131,138,269
https://kawalpemilu.org#52175,"KUJANGJAYA, CIBEBER, LEBAK, BANTEN",7,136,70,206
https://kawalpemilu.org#52175,"KUJANGJAYA, CIBEBER, LEBAK, BANTEN",8,138,46,184
https://kawalpemilu.org#52175,"KUJANGJAYA, CIBEBER, LEBAK, BANTEN",9,170,51,221
https://kawalpemilu.org#52176,"KUJANGSARI, CIBEBER, LEBAK, BANTEN",1,121,119,240
https://kawalpemilu.org#52176,"KUJANGSARI, CIBEBER, LEBAK, BANTEN",2,163,77,240
https://kawalpemilu.org#52176,"KUJANGSARI, CIBEBER, LEBAK, BANTEN",3,129,99,228
https://kawalpemilu.org#52176,"KUJANGSARI, CIBEBER, LEBAK, BANTEN",4,133,110,243
https://kawalpemilu.org#52176,"KUJANGSARI, CIBEBER, LEBAK, BANTEN",5,132,91,223
https://kawalpemilu.org#52176,"KUJANGSARI, CIBEBER, LEBAK, BANTEN",6,112,128,240
https://kawalpemilu.org#52177,"NEGLASARI, CIBEBER, LEBAK, BANTEN",1,110,105,215
https://kawalpemilu.org#52177,"NEGLASARI, CIBEBER, LEBAK, BANTEN",2,99,123,222
https://kawalpemilu.org#52177,"NEGLASARI, CIBEBER, LEBAK, BANTEN",3,69,144,213
https://kawalpemilu.org#52177,"NEGLASARI, CIBEBER, LEBAK, BANTEN",4,97,123,220
https://kawalpemilu.org#52177,"NEGLASARI, CIBEBER, LEBAK, BANTEN",5,109,116,225
https://kawalpemilu.org#52177,"NEGLASARI, CIBEBER, LEBAK, BANTEN",6,91,115,206
https://kawalpemilu.org#52177,"NEGLASARI, CIBEBER, LEBAK, BANTEN",7,81,123,204
https://kawalpemilu.org#52177,"NEGLASARI, CIBEBER, LEBAK, BANTEN",8,105,143,248
https://kawalpemilu.org#52177,"NEGLASARI, CIBEBER, LEBAK, BANTEN",9,42,204,246
https://kawalpemilu.org#52177,"NEGLASARI, CIBEBER, LEBAK, BANTEN",10,66,165,231
https://kawalpemilu.org#52177,"NEGLASARI, CIBEBER, LEBAK, BANTEN",11,43,180,223
https://kawalpemilu.org#52178,"MEKARSARI, CIBEBER, LEBAK, BANTEN",1,76,89,165
https://kawalpemilu.org#52178,"MEKARSARI, CIBEBER, LEBAK, BANTEN",2,140,79,219
https://kawalpemilu.org#52178,"MEKARSARI, CIBEBER, LEBAK, BANTEN",3,52,107,159
https://kawalpemilu.org#52178,"MEKARSARI, CIBEBER, LEBAK, BANTEN",4,91,24,115
https://kawalpemilu.org#52178,"MEKARSARI, CIBEBER, LEBAK, BANTEN",5,117,36,153
https://kawalpemilu.org#52178,"MEKARSARI, CIBEBER, LEBAK, BANTEN",6,97,82,179
https://kawalpemilu.org#52178,"MEKARSARI, CIBEBER, LEBAK, BANTEN",7,139,78,217
https://kawalpemilu.org#52178,"MEKARSARI, CIBEBER, LEBAK, BANTEN",8,19,149,168
https://kawalpemilu.org#52178,"MEKARSARI, CIBEBER, LEBAK, BANTEN",9,85,27,112
https://kawalpemilu.org#52178,"MEKARSARI, CIBEBER, LEBAK, BANTEN",10,113,17,130
https://kawalpemilu.org#52179,"CIKOTOK, CIBEBER, LEBAK, BANTEN",1,61,138,199
https://kawalpemilu.org#52179,"CIKOTOK, CIBEBER, LEBAK, BANTEN",2,62,96,158
https://kawalpemilu.org#52179,"CIKOTOK, CIBEBER, LEBAK, BANTEN",3,88,93,181
https://kawalpemilu.org#52179,"CIKOTOK, CIBEBER, LEBAK, BANTEN",4,101,96,197
https://kawalpemilu.org#52179,"CIKOTOK, CIBEBER, LEBAK, BANTEN",5,89,105,194
https://kawalpemilu.org#52179,"CIKOTOK, CIBEBER, LEBAK, BANTEN",6,73,104,177
https://kawalpemilu.org#52179,"CIKOTOK, CIBEBER, LEBAK, BANTEN",7,70,107,177
https://kawalpemilu.org#52179,"CIKOTOK, CIBEBER, LEBAK, BANTEN",8,55,65,120
https://kawalpemilu.org#52180,"SUKAMULYA, CIBEBER, LEBAK, BANTEN",1,47,170,217
https://kawalpemilu.org#52180,"SUKAMULYA, CIBEBER, LEBAK, BANTEN",2,96,117,213
https://kawalpemilu.org#52180,"SUKAMULYA, CIBEBER, LEBAK, BANTEN",3,73,151,224
https://kawalpemilu.org#52180,"SUKAMULYA, CIBEBER, LEBAK, BANTEN",4,77,141,218
https://kawalpemilu.org#52180,"SUKAMULYA, CIBEBER, LEBAK, BANTEN",5,127,68,195
https://kawalpemilu.org#52180,"SUKAMULYA, CIBEBER, LEBAK, BANTEN",6,144,68,212
https://kawalpemilu.org#52180,"SUKAMULYA, CIBEBER, LEBAK, BANTEN",7,122,90,212
https://kawalpemilu.org#52180,"SUKAMULYA, CIBEBER, LEBAK, BANTEN",8,127,88,215
https://kawalpemilu.org#52180,"SUKAMULYA, CIBEBER, LEBAK, BANTEN",9,130,40,170
https://kawalpemilu.org#52181,"CITOREK TIMUR, CIBEBER, LEBAK, BANTEN",1,48,197,254
https://kawalpemilu.org#52181,"CITOREK TIMUR, CIBEBER, LEBAK, BANTEN",2,70,174,244
https://kawalpemilu.org#52181,"CITOREK TIMUR, CIBEBER, LEBAK, BANTEN",3,86,147,233
https://kawalpemilu.org#52181,"CITOREK TIMUR, CIBEBER, LEBAK, BANTEN",4,90,128,218
https://kawalpemilu.org#52181,"CITOREK TIMUR, CIBEBER, LEBAK, BANTEN",5,80,135,215
https://kawalpemilu.org#52181,"CITOREK TIMUR, CIBEBER, LEBAK, BANTEN",6,166,109,275
https://kawalpemilu.org#52181,"CITOREK TIMUR, CIBEBER, LEBAK, BANTEN",7,108,122,230
https://kawalpemilu.org#52181,"CITOREK TIMUR, CIBEBER, LEBAK, BANTEN",8,55,66,121
https://kawalpemilu.org#52182,"WARUNGBANTEN, CIBEBER, LEBAK, BANTEN",1,97,122,219
https://kawalpemilu.org#52182,"WARUNGBANTEN, CIBEBER, LEBAK, BANTEN",2,82,128,210
https://kawalpemilu.org#52182,"WARUNGBANTEN, CIBEBER, LEBAK, BANTEN",3,60,149,209
https://kawalpemilu.org#52182,"WARUNGBANTEN, CIBEBER, LEBAK, BANTEN",4,46,125,171
https://kawalpemilu.org#52182,"WARUNGBANTEN, CIBEBER, LEBAK, BANTEN",5,63,140,203
https://kawalpemilu.org#52182,"WARUNGBANTEN, CIBEBER, LEBAK, BANTEN",6,54,166,220
https://kawalpemilu.org#52182,"WARUNGBANTEN, CIBEBER, LEBAK, BANTEN",7,76,138,214
https://kawalpemilu.org#52182,"WARUNGBANTEN, CIBEBER, LEBAK, BANTEN",8,42,92,134
https://kawalpemilu.org#52182,"WARUNGBANTEN, CIBEBER, LEBAK, BANTEN",9,43,89,132
https://kawalpemilu.org#52182,"WARUNGBANTEN, CIBEBER, LEBAK, BANTEN",10,58,17,75
https://kawalpemilu.org#52183,"HEGARMANAH, CIBEBER, LEBAK, BANTEN",1,121,128,249
https://kawalpemilu.org#52183,"HEGARMANAH, CIBEBER, LEBAK, BANTEN",2,173,39,212
https://kawalpemilu.org#52183,"HEGARMANAH, CIBEBER, LEBAK, BANTEN",3,201,48,249
https://kawalpemilu.org#52183,"HEGARMANAH, CIBEBER, LEBAK, BANTEN",4,56,180,236
https://kawalpemilu.org#52183,"HEGARMANAH, CIBEBER, LEBAK, BANTEN",5,68,108,176
https://kawalpemilu.org#52183,"HEGARMANAH, CIBEBER, LEBAK, BANTEN",6,32,129,161
https://kawalpemilu.org#52184,"SITUMULYA, CIBEBER, LEBAK, BANTEN",1,92,103,195
https://kawalpemilu.org#52184,"SITUMULYA, CIBEBER, LEBAK, BANTEN",2,126,110,236
https://kawalpemilu.org#52184,"SITUMULYA, CIBEBER, LEBAK, BANTEN",3,112,91,203
https://kawalpemilu.org#52184,"SITUMULYA, CIBEBER, LEBAK, BANTEN",4,129,83,212
https://kawalpemilu.org#52184,"SITUMULYA, CIBEBER, LEBAK, BANTEN",5,137,77,214
https://kawalpemilu.org#52184,"SITUMULYA, CIBEBER, LEBAK, BANTEN",6,194,51,245
https://kawalpemilu.org#52184,"SITUMULYA, CIBEBER, LEBAK, BANTEN",7,105,56,161
https://kawalpemilu.org#52184,"SITUMULYA, CIBEBER, LEBAK, BANTEN",8,86,115,201
https://kawalpemilu.org#52184,"SITUMULYA, CIBEBER, LEBAK, BANTEN",9,120,8,128
https://kawalpemilu.org#52185,"CITOREK KIDUL, CIBEBER, LEBAK, BANTEN",1,65,112,177
https://kawalpemilu.org#52185,"CITOREK KIDUL, CIBEBER, LEBAK, BANTEN",2,81,178,259
https://kawalpemilu.org#52185,"CITOREK KIDUL, CIBEBER, LEBAK, BANTEN",3,84,181,265
https://kawalpemilu.org#52185,"CITOREK KIDUL, CIBEBER, LEBAK, BANTEN",4,78,188,266
https://kawalpemilu.org#52185,"CITOREK KIDUL, CIBEBER, LEBAK, BANTEN",5,96,100,196
https://kawalpemilu.org#52185,"CITOREK KIDUL, CIBEBER, LEBAK, BANTEN",6,102,29,131
https://kawalpemilu.org#52186,"CIKADU, CIBEBER, LEBAK, BANTEN",1,117,93,210
https://kawalpemilu.org#52186,"CIKADU, CIBEBER, LEBAK, BANTEN",2,173,53,226
https://kawalpemilu.org#52186,"CIKADU, CIBEBER, LEBAK, BANTEN",3,153,66,219
https://kawalpemilu.org#52186,"CIKADU, CIBEBER, LEBAK, BANTEN",4,97,24,121
https://kawalpemilu.org#52186,"CIKADU, CIBEBER, LEBAK, BANTEN",5,148,86,234
https://kawalpemilu.org#52186,"CIKADU, CIBEBER, LEBAK, BANTEN",6,124,64,188
https://kawalpemilu.org#52186,"CIKADU, CIBEBER, LEBAK, BANTEN",7,131,44,175
https://kawalpemilu.org#52186,"CIKADU, CIBEBER, LEBAK, BANTEN",8,116,44,160
https://kawalpemilu.org#52186,"CIKADU, CIBEBER, LEBAK, BANTEN",9,160,60,220
https://kawalpemilu.org#52187,"SINARGALIH, CIBEBER, LEBAK, BANTEN",1,138,108,246
https://kawalpemilu.org#52187,"SINARGALIH, CIBEBER, LEBAK, BANTEN",2,176,99,275
https://kawalpemilu.org#52187,"SINARGALIH, CIBEBER, LEBAK, BANTEN",3,159,103,262
https://kawalpemilu.org#52187,"SINARGALIH, CIBEBER, LEBAK, BANTEN",4,134,105,239
https://kawalpemilu.org#52187,"SINARGALIH, CIBEBER, LEBAK, BANTEN",5,126,71,197
https://kawalpemilu.org#52187,"SINARGALIH, CIBEBER, LEBAK, BANTEN",6,136,108,244
https://kawalpemilu.org#52187,"SINARGALIH, CIBEBER, LEBAK, BANTEN",7,147,58,205
https://kawalpemilu.org#52188,"CITOREK BARAT, CIBEBER, LEBAK, BANTEN",1,37,179,216
https://kawalpemilu.org#52188,"CITOREK BARAT, CIBEBER, LEBAK, BANTEN",2,45,171,216
https://kawalpemilu.org#52188,"CITOREK BARAT, CIBEBER, LEBAK, BANTEN",3,57,142,199
https://kawalpemilu.org#52188,"CITOREK BARAT, CIBEBER, LEBAK, BANTEN",5,142,5,147
https://kawalpemilu.org#52188,"CITOREK BARAT, CIBEBER, LEBAK, BANTEN",6,145,38,183
https://kawalpemilu.org#52188,"CITOREK BARAT, CIBEBER, LEBAK, BANTEN",7,133,37,170
https://kawalpemilu.org#52188,"CITOREK BARAT, CIBEBER, LEBAK, BANTEN",8,143,25,168
https://kawalpemilu.org#52188,"CITOREK BARAT, CIBEBER, LEBAK, BANTEN",9,143,20,163
https://kawalpemilu.org#52188,"CITOREK BARAT, CIBEBER, LEBAK, BANTEN",10,0,0,0
https://kawalpemilu.org#52188,"CITOREK BARAT, CIBEBER, LEBAK, BANTEN",11,45,149,194
https://kawalpemilu.org#52189,"CIHAMBALI, CIBEBER, LEBAK, BANTEN",1,147,115,262
https://kawalpemilu.org#52189,"CIHAMBALI, CIBEBER, LEBAK, BANTEN",2,173,80,253
https://kawalpemilu.org#52189,"CIHAMBALI, CIBEBER, LEBAK, BANTEN",3,146,85,231
https://kawalpemilu.org#52189,"CIHAMBALI, CIBEBER, LEBAK, BANTEN",4,186,64,250
https://kawalpemilu.org#52189,"CIHAMBALI, CIBEBER, LEBAK, BANTEN",6,123,131,254
https://kawalpemilu.org#52189,"CIHAMBALI, CIBEBER, LEBAK, BANTEN",7,110,40,150
https://kawalpemilu.org#52189,"CIHAMBALI, CIBEBER, LEBAK, BANTEN",8,117,67,184
https://kawalpemilu.org#52189,"CIHAMBALI, CIBEBER, LEBAK, BANTEN",9,28,30,58
https://kawalpemilu.org#52190,"GUNUNGWANGUN, CIBEBER, LEBAK, BANTEN",1,154,82,236
https://kawalpemilu.org#52190,"GUNUNGWANGUN, CIBEBER, LEBAK, BANTEN",2,108,28,136
https://kawalpemilu.org#52190,"GUNUNGWANGUN, CIBEBER, LEBAK, BANTEN",3,112,54,166
https://kawalpemilu.org#52190,"GUNUNGWANGUN, CIBEBER, LEBAK, BANTEN",4,180,10,190
https://kawalpemilu.org#52190,"GUNUNGWANGUN, CIBEBER, LEBAK, BANTEN",5,125,31,156
https://kawalpemilu.org#52190,"GUNUNGWANGUN, CIBEBER, LEBAK, BANTEN",6,130,37,167
https://kawalpemilu.org#52191,"WANASARI, CIBEBER, LEBAK, BANTEN",1,93,119,212
https://kawalpemilu.org#52191,"WANASARI, CIBEBER, LEBAK, BANTEN",2,89,127,216
https://kawalpemilu.org#52191,"WANASARI, CIBEBER, LEBAK, BANTEN",3,82,148,230
https://kawalpemilu.org#52191,"WANASARI, CIBEBER, LEBAK, BANTEN",4,38,138,176
https://kawalpemilu.org#52191,"WANASARI, CIBEBER, LEBAK, BANTEN",5,57,122,179
https://kawalpemilu.org#52191,"WANASARI, CIBEBER, LEBAK, BANTEN",6,78,100,178
https://kawalpemilu.org#52191,"WANASARI, CIBEBER, LEBAK, BANTEN",7,68,122,190
https://kawalpemilu.org#52191,"WANASARI, CIBEBER, LEBAK, BANTEN",8,106,81,187
https://kawalpemilu.org#52193,"CIHERANG, CIBEBER, LEBAK, BANTEN",1,97,119,216
https://kawalpemilu.org#52193,"CIHERANG, CIBEBER, LEBAK, BANTEN",2,110,119,229
https://kawalpemilu.org#52193,"CIHERANG, CIBEBER, LEBAK, BANTEN",3,90,112,202
https://kawalpemilu.org#52193,"CIHERANG, CIBEBER, LEBAK, BANTEN",4,71,102,173
https://kawalpemilu.org#52193,"CIHERANG, CIBEBER, LEBAK, BANTEN",5,68,94,162
https://kawalpemilu.org#52193,"CIHERANG, CIBEBER, LEBAK, BANTEN",6,61,111,172
https://kawalpemilu.org#52193,"CIHERANG, CIBEBER, LEBAK, BANTEN",7,79,86,165
https://kawalpemilu.org#52193,"CIHERANG, CIBEBER, LEBAK, BANTEN",8,121,93,214
https://kawalpemilu.org#52193,"CIHERANG, CIBEBER, LEBAK, BANTEN",9,87,103,190
https://kawalpemilu.org#52193,"CIHERANG, CIBEBER, LEBAK, BANTEN",10,81,71,152
https://kawalpemilu.org#52193,"CIHERANG, CIBEBER, LEBAK, BANTEN",11,89,77,166
https://kawalpemilu.org#88398,"CITOREK SABRANG, CIBEBER, LEBAK, BANTEN",1,104,94,198
https://kawalpemilu.org#88398,"CITOREK SABRANG, CIBEBER, LEBAK, BANTEN",2,123,86,209
https://kawalpemilu.org#88398,"CITOREK SABRANG, CIBEBER, LEBAK, BANTEN",3,72,78,150
https://kawalpemilu.org#88398,"CITOREK SABRANG, CIBEBER, LEBAK, BANTEN",4,90,57,147
https://kawalpemilu.org#88398,"CITOREK SABRANG, CIBEBER, LEBAK, BANTEN",5,111,152,263
https://kawalpemilu.org#88398,"CITOREK SABRANG, CIBEBER, LEBAK, BANTEN",6,26,135,161
https://kawalpemilu.org#88398,"CITOREK SABRANG, CIBEBER, LEBAK, BANTEN",7,16,127,143
https://kawalpemilu.org#52195,"CILOGRANG, CILOGRANG, LEBAK, BANTEN",1,25,194,219
https://kawalpemilu.org#52195,"CILOGRANG, CILOGRANG, LEBAK, BANTEN",2,56,125,181
https://kawalpemilu.org#52195,"CILOGRANG, CILOGRANG, LEBAK, BANTEN",3,20,168,188
https://kawalpemilu.org#52195,"CILOGRANG, CILOGRANG, LEBAK, BANTEN",4,57,147,204
https://kawalpemilu.org#52195,"CILOGRANG, CILOGRANG, LEBAK, BANTEN",5,34,81,115
https://kawalpemilu.org#52195,"CILOGRANG, CILOGRANG, LEBAK, BANTEN",6,18,144,162
https://kawalpemilu.org#52195,"CILOGRANG, CILOGRANG, LEBAK, BANTEN",7,31,108,139
https://kawalpemilu.org#52195,"CILOGRANG, CILOGRANG, LEBAK, BANTEN",8,20,132,152
https://kawalpemilu.org#52195,"CILOGRANG, CILOGRANG, LEBAK, BANTEN",9,10,102,112
https://kawalpemilu.org#52195,"CILOGRANG, CILOGRANG, LEBAK, BANTEN",10,32,175,207
https://kawalpemilu.org#52195,"CILOGRANG, CILOGRANG, LEBAK, BANTEN",11,35,199,234
https://kawalpemilu.org#52196,"CIBARENO, CILOGRANG, LEBAK, BANTEN",1,29,133,162
https://kawalpemilu.org#52196,"CIBARENO, CILOGRANG, LEBAK, BANTEN",2,52,139,191
https://kawalpemilu.org#52196,"CIBARENO, CILOGRANG, LEBAK, BANTEN",3,101,103,204
https://kawalpemilu.org#52196,"CIBARENO, CILOGRANG, LEBAK, BANTEN",4,60,138,198
https://kawalpemilu.org#52196,"CIBARENO, CILOGRANG, LEBAK, BANTEN",5,30,172,202
https://kawalpemilu.org#52196,"CIBARENO, CILOGRANG, LEBAK, BANTEN",6,51,147,198
https://kawalpemilu.org#52196,"CIBARENO, CILOGRANG, LEBAK, BANTEN",7,17,84,101
https://kawalpemilu.org#52197,"CIKAMUNDING, CILOGRANG, LEBAK, BANTEN",1,37,182,219
https://kawalpemilu.org#52197,"CIKAMUNDING, CILOGRANG, LEBAK, BANTEN",2,84,131,215
https://kawalpemilu.org#52197,"CIKAMUNDING, CILOGRANG, LEBAK, BANTEN",3,57,171,228
https://kawalpemilu.org#52197,"CIKAMUNDING, CILOGRANG, LEBAK, BANTEN",4,46,170,216
https://kawalpemilu.org#52197,"CIKAMUNDING, CILOGRANG, LEBAK, BANTEN",5,36,165,201
https://kawalpemilu.org#52197,"CIKAMUNDING, CILOGRANG, LEBAK, BANTEN",6,54,144,198
https://kawalpemilu.org#52197,"CIKAMUNDING, CILOGRANG, LEBAK, BANTEN",7,30,196,226
https://kawalpemilu.org#52197,"CIKAMUNDING, CILOGRANG, LEBAK, BANTEN",8,73,140,213
https://kawalpemilu.org#52197,"CIKAMUNDING, CILOGRANG, LEBAK, BANTEN",9,22,213,235
https://kawalpemilu.org#52197,"CIKAMUNDING, CILOGRANG, LEBAK, BANTEN",10,20,164,184
https://kawalpemilu.org#52198,"CIJENGKOL, CILOGRANG, LEBAK, BANTEN",1,16,176,192
https://kawalpemilu.org#52198,"CIJENGKOL, CILOGRANG, LEBAK, BANTEN",2,25,165,190
https://kawalpemilu.org#52198,"CIJENGKOL, CILOGRANG, LEBAK, BANTEN",3,55,154,209
https://kawalpemilu.org#52198,"CIJENGKOL, CILOGRANG, LEBAK, BANTEN",4,42,126,168
https://kawalpemilu.org#52198,"CIJENGKOL, CILOGRANG, LEBAK, BANTEN",5,73,100,173
https://kawalpemilu.org#52198,"CIJENGKOL, CILOGRANG, LEBAK, BANTEN",6,47,89,136
https://kawalpemilu.org#52198,"CIJENGKOL, CILOGRANG, LEBAK, BANTEN",7,124,87,211
https://kawalpemilu.org#52198,"CIJENGKOL, CILOGRANG, LEBAK, BANTEN",8,54,100,154
https://kawalpemilu.org#52198,"CIJENGKOL, CILOGRANG, LEBAK, BANTEN",9,54,147,201
https://kawalpemilu.org#52198,"CIJENGKOL, CILOGRANG, LEBAK, BANTEN",10,52,157,209
https://kawalpemilu.org#52198,"CIJENGKOL, CILOGRANG, LEBAK, BANTEN",11,83,88,171
https://kawalpemilu.org#52198,"CIJENGKOL, CILOGRANG, LEBAK, BANTEN",12,17,166,183
https://kawalpemilu.org#52198,"CIJENGKOL, CILOGRANG, LEBAK, BANTEN",13,30,138,168
https://kawalpemilu.org#52198,"CIJENGKOL, CILOGRANG, LEBAK, BANTEN",14,72,86,158
https://kawalpemilu.org#52198,"CIJENGKOL, CILOGRANG, LEBAK, BANTEN",15,27,96,123
https://kawalpemilu.org#52199,"PASIRBUNGUR, CILOGRANG, LEBAK, BANTEN",1,44,199,243
https://kawalpemilu.org#52199,"PASIRBUNGUR, CILOGRANG, LEBAK, BANTEN",2,27,197,224
https://kawalpemilu.org#52199,"PASIRBUNGUR, CILOGRANG, LEBAK, BANTEN",3,24,177,201
https://kawalpemilu.org#52199,"PASIRBUNGUR, CILOGRANG, LEBAK, BANTEN",4,18,165,183
https://kawalpemilu.org#52199,"PASIRBUNGUR, CILOGRANG, LEBAK, BANTEN",5,33,149,182
https://kawalpemilu.org#52199,"PASIRBUNGUR, CILOGRANG, LEBAK, BANTEN",6,11,224,235
https://kawalpemilu.org#52199,"PASIRBUNGUR, CILOGRANG, LEBAK, BANTEN",7,18,244,262
https://kawalpemilu.org#52199,"PASIRBUNGUR, CILOGRANG, LEBAK, BANTEN",8,16,198,214
https://kawalpemilu.org#52199,"PASIRBUNGUR, CILOGRANG, LEBAK, BANTEN",9,5,173,178
https://kawalpemilu.org#52199,"PASIRBUNGUR, CILOGRANG, LEBAK, BANTEN",10,6,193,199
https://kawalpemilu.org#52199,"PASIRBUNGUR, CILOGRANG, LEBAK, BANTEN",11,5,138,143
https://kawalpemilu.org#52199,"PASIRBUNGUR, CILOGRANG, LEBAK, BANTEN",12,3,142,145
https://kawalpemilu.org#52199,"PASIRBUNGUR, CILOGRANG, LEBAK, BANTEN",13,13,161,174
https://kawalpemilu.org#52199,"PASIRBUNGUR, CILOGRANG, LEBAK, BANTEN",14,8,149,157
https://kawalpemilu.org#52199,"PASIRBUNGUR, CILOGRANG, LEBAK, BANTEN",15,14,134,148
https://kawalpemilu.org#52199,"PASIRBUNGUR, CILOGRANG, LEBAK, BANTEN",16,23,125,148
https://kawalpemilu.org#52199,"PASIRBUNGUR, CILOGRANG, LEBAK, BANTEN",17,27,173,200
https://kawalpemilu.org#52200,"LEBAKTIPAR, CILOGRANG, LEBAK, BANTEN",1,36,149,185
https://kawalpemilu.org#52200,"LEBAKTIPAR, CILOGRANG, LEBAK, BANTEN",2,44,144,188
https://kawalpemilu.org#52200,"LEBAKTIPAR, CILOGRANG, LEBAK, BANTEN",3,45,145,190
https://kawalpemilu.org#52200,"LEBAKTIPAR, CILOGRANG, LEBAK, BANTEN",4,52,120,172
https://kawalpemilu.org#52200,"LEBAKTIPAR, CILOGRANG, LEBAK, BANTEN",5,55,122,177
https://kawalpemilu.org#52200,"LEBAKTIPAR, CILOGRANG, LEBAK, BANTEN",6,97,125,222
https://kawalpemilu.org#52200,"LEBAKTIPAR, CILOGRANG, LEBAK, BANTEN",7,103,95,198
https://kawalpemilu.org#52200,"LEBAKTIPAR, CILOGRANG, LEBAK, BANTEN",8,70,140,210
https://kawalpemilu.org#52200,"LEBAKTIPAR, CILOGRANG, LEBAK, BANTEN",9,67,139,206
https://kawalpemilu.org#52200,"LEBAKTIPAR, CILOGRANG, LEBAK, BANTEN",10,58,135,193
https://kawalpemilu.org#52201,"CIKATOMAS, CILOGRANG, LEBAK, BANTEN",1,41,141,182
https://kawalpemilu.org#52201,"CIKATOMAS, CILOGRANG, LEBAK, BANTEN",2,34,134,168
https://kawalpemilu.org#52201,"CIKATOMAS, CILOGRANG, LEBAK, BANTEN",3,33,128,161
https://kawalpemilu.org#52201,"CIKATOMAS, CILOGRANG, LEBAK, BANTEN",4,61,129,190
https://kawalpemilu.org#52201,"CIKATOMAS, CILOGRANG, LEBAK, BANTEN",5,60,125,185
https://kawalpemilu.org#52201,"CIKATOMAS, CILOGRANG, LEBAK, BANTEN",6,15,139,154
https://kawalpemilu.org#52201,"CIKATOMAS, CILOGRANG, LEBAK, BANTEN",7,40,66,106
https://kawalpemilu.org#52201,"CIKATOMAS, CILOGRANG, LEBAK, BANTEN",8,47,94,141
https://kawalpemilu.org#52201,"CIKATOMAS, CILOGRANG, LEBAK, BANTEN",9,57,85,142
https://kawalpemilu.org#52201,"CIKATOMAS, CILOGRANG, LEBAK, BANTEN",10,107,88,195
https://kawalpemilu.org#52201,"CIKATOMAS, CILOGRANG, LEBAK, BANTEN",11,49,175,224
https://kawalpemilu.org#52201,"CIKATOMAS, CILOGRANG, LEBAK, BANTEN",12,124,102,226
https://kawalpemilu.org#52201,"CIKATOMAS, CILOGRANG, LEBAK, BANTEN",13,54,149,203
https://kawalpemilu.org#52201,"CIKATOMAS, CILOGRANG, LEBAK, BANTEN",14,74,62,136
https://kawalpemilu.org#52201,"CIKATOMAS, CILOGRANG, LEBAK, BANTEN",15,45,58,103
https://kawalpemilu.org#52201,"CIKATOMAS, CILOGRANG, LEBAK, BANTEN",16,76,73,149
https://kawalpemilu.org#52202,"GIRIMUKTI, CILOGRANG, LEBAK, BANTEN",1,129,105,234
https://kawalpemilu.org#52202,"GIRIMUKTI, CILOGRANG, LEBAK, BANTEN",2,58,57,115
https://kawalpemilu.org#52202,"GIRIMUKTI, CILOGRANG, LEBAK, BANTEN",3,107,30,137
https://kawalpemilu.org#52202,"GIRIMUKTI, CILOGRANG, LEBAK, BANTEN",4,168,65,233
https://kawalpemilu.org#52202,"GIRIMUKTI, CILOGRANG, LEBAK, BANTEN",5,146,15,161
https://kawalpemilu.org#52202,"GIRIMUKTI, CILOGRANG, LEBAK, BANTEN",6,68,131,199
https://kawalpemilu.org#52202,"GIRIMUKTI, CILOGRANG, LEBAK, BANTEN",7,26,72,98
https://kawalpemilu.org#52202,"GIRIMUKTI, CILOGRANG, LEBAK, BANTEN",8,78,90,168
https://kawalpemilu.org#52202,"GIRIMUKTI, CILOGRANG, LEBAK, BANTEN",9,104,83,187
https://kawalpemilu.org#52202,"GIRIMUKTI, CILOGRANG, LEBAK, BANTEN",10,181,41,222
https://kawalpemilu.org#52203,"CIREUNDEU, CILOGRANG, LEBAK, BANTEN",1,41,176,217
https://kawalpemilu.org#52203,"CIREUNDEU, CILOGRANG, LEBAK, BANTEN",2,42,157,199
https://kawalpemilu.org#52203,"CIREUNDEU, CILOGRANG, LEBAK, BANTEN",3,15,137,152
https://kawalpemilu.org#52203,"CIREUNDEU, CILOGRANG, LEBAK, BANTEN",4,12,132,144
https://kawalpemilu.org#52203,"CIREUNDEU, CILOGRANG, LEBAK, BANTEN",5,27,146,173
https://kawalpemilu.org#52203,"CIREUNDEU, CILOGRANG, LEBAK, BANTEN",6,7,155,162
https://kawalpemilu.org#52203,"CIREUNDEU, CILOGRANG, LEBAK, BANTEN",7,15,167,182
https://kawalpemilu.org#52204,"GUNUNGBATU, CILOGRANG, LEBAK, BANTEN",1,62,135,197
https://kawalpemilu.org#52204,"GUNUNGBATU, CILOGRANG, LEBAK, BANTEN",2,31,168,199
https://kawalpemilu.org#52204,"GUNUNGBATU, CILOGRANG, LEBAK, BANTEN",3,53,125,178
https://kawalpemilu.org#52204,"GUNUNGBATU, CILOGRANG, LEBAK, BANTEN",4,68,148,216
https://kawalpemilu.org#52204,"GUNUNGBATU, CILOGRANG, LEBAK, BANTEN",5,57,138,195
https://kawalpemilu.org#52204,"GUNUNGBATU, CILOGRANG, LEBAK, BANTEN",6,62,73,135
https://kawalpemilu.org#52204,"GUNUNGBATU, CILOGRANG, LEBAK, BANTEN",7,23,163,186
https://kawalpemilu.org#52204,"GUNUNGBATU, CILOGRANG, LEBAK, BANTEN",8,42,108,150
https://kawalpemilu.org#52204,"GUNUNGBATU, CILOGRANG, LEBAK, BANTEN",9,50,143,193
https://kawalpemilu.org#52206,"WANASALAM, WANASALAM, LEBAK, BANTEN",1,127,70,197
https://kawalpemilu.org#52206,"WANASALAM, WANASALAM, LEBAK, BANTEN",2,139,79,218
https://kawalpemilu.org#52206,"WANASALAM, WANASALAM, LEBAK, BANTEN",3,118,56,174
https://kawalpemilu.org#52206,"WANASALAM, WANASALAM, LEBAK, BANTEN",4,78,145,223
https://kawalpemilu.org#52206,"WANASALAM, WANASALAM, LEBAK, BANTEN",5,50,153,203
https://kawalpemilu.org#52206,"WANASALAM, WANASALAM, LEBAK, BANTEN",6,74,95,169
https://kawalpemilu.org#52206,"WANASALAM, WANASALAM, LEBAK, BANTEN",7,76,119,195
https://kawalpemilu.org#52206,"WANASALAM, WANASALAM, LEBAK, BANTEN",8,88,113,201
https://kawalpemilu.org#52206,"WANASALAM, WANASALAM, LEBAK, BANTEN",9,151,79,230
https://kawalpemilu.org#52206,"WANASALAM, WANASALAM, LEBAK, BANTEN",10,156,62,218
https://kawalpemilu.org#52206,"WANASALAM, WANASALAM, LEBAK, BANTEN",11,169,69,238
https://kawalpemilu.org#52206,"WANASALAM, WANASALAM, LEBAK, BANTEN",12,163,48,211
https://kawalpemilu.org#52206,"WANASALAM, WANASALAM, LEBAK, BANTEN",13,192,52,171
https://kawalpemilu.org#52206,"WANASALAM, WANASALAM, LEBAK, BANTEN",14,96,95,191
https://kawalpemilu.org#52206,"WANASALAM, WANASALAM, LEBAK, BANTEN",15,47,68,115
https://kawalpemilu.org#52206,"WANASALAM, WANASALAM, LEBAK, BANTEN",16,133,89,222
https://kawalpemilu.org#52206,"WANASALAM, WANASALAM, LEBAK, BANTEN",17,80,137,217
https://kawalpemilu.org#52206,"WANASALAM, WANASALAM, LEBAK, BANTEN",18,113,72,185
https://kawalpemilu.org#52207,"BEJOD, WANASALAM, LEBAK, BANTEN",1,40,153,193
https://kawalpemilu.org#52207,"BEJOD, WANASALAM, LEBAK, BANTEN",2,95,99,194
https://kawalpemilu.org#52207,"BEJOD, WANASALAM, LEBAK, BANTEN",3,85,103,188
https://kawalpemilu.org#52207,"BEJOD, WANASALAM, LEBAK, BANTEN",4,83,84,167
https://kawalpemilu.org#52207,"BEJOD, WANASALAM, LEBAK, BANTEN",5,102,74,176
https://kawalpemilu.org#52207,"BEJOD, WANASALAM, LEBAK, BANTEN",6,106,97,203
https://kawalpemilu.org#52207,"BEJOD, WANASALAM, LEBAK, BANTEN",7,67,108,175
https://kawalpemilu.org#52207,"BEJOD, WANASALAM, LEBAK, BANTEN",8,132,80,212
https://kawalpemilu.org#52207,"BEJOD, WANASALAM, LEBAK, BANTEN",9,65,84,149
https://kawalpemilu.org#52207,"BEJOD, WANASALAM, LEBAK, BANTEN",10,62,152,214
https://kawalpemilu.org#52207,"BEJOD, WANASALAM, LEBAK, BANTEN",11,53,124,177
https://kawalpemilu.org#52207,"BEJOD, WANASALAM, LEBAK, BANTEN",12,95,64,159
https://kawalpemilu.org#52207,"BEJOD, WANASALAM, LEBAK, BANTEN",13,130,63,193
https://kawalpemilu.org#52207,"BEJOD, WANASALAM, LEBAK, BANTEN",14,62,92,154
https://kawalpemilu.org#52207,"BEJOD, WANASALAM, LEBAK, BANTEN",15,57,92,149
https://kawalpemilu.org#52207,"BEJOD, WANASALAM, LEBAK, BANTEN",16,90,82,172
https://kawalpemilu.org#52207,"BEJOD, WANASALAM, LEBAK, BANTEN",17,55,77,132
https://kawalpemilu.org#52208,"CILANGKAP, WANASALAM, LEBAK, BANTEN",1,31,127,158
https://kawalpemilu.org#52208,"CILANGKAP, WANASALAM, LEBAK, BANTEN",2,102,75,177
https://kawalpemilu.org#52208,"CILANGKAP, WANASALAM, LEBAK, BANTEN",3,74,57,131
https://kawalpemilu.org#52208,"CILANGKAP, WANASALAM, LEBAK, BANTEN",4,99,63,162
https://kawalpemilu.org#52208,"CILANGKAP, WANASALAM, LEBAK, BANTEN",5,54,68,122
https://kawalpemilu.org#52208,"CILANGKAP, WANASALAM, LEBAK, BANTEN",6,68,70,138
https://kawalpemilu.org#52208,"CILANGKAP, WANASALAM, LEBAK, BANTEN",7,75,49,124
https://kawalpemilu.org#52208,"CILANGKAP, WANASALAM, LEBAK, BANTEN",8,71,110,181
https://kawalpemilu.org#52209,"CIPEUCANG, WANASALAM, LEBAK, BANTEN",1,37,103,140
https://kawalpemilu.org#52209,"CIPEUCANG, WANASALAM, LEBAK, BANTEN",2,48,122,170
https://kawalpemilu.org#52209,"CIPEUCANG, WANASALAM, LEBAK, BANTEN",3,25,107,132
https://kawalpemilu.org#52209,"CIPEUCANG, WANASALAM, LEBAK, BANTEN",4,69,56,125
https://kawalpemilu.org#52209,"CIPEUCANG, WANASALAM, LEBAK, BANTEN",5,18,135,153
https://kawalpemilu.org#52209,"CIPEUCANG, WANASALAM, LEBAK, BANTEN",6,34,122,156
https://kawalpemilu.org#52209,"CIPEUCANG, WANASALAM, LEBAK, BANTEN",7,65,64,129
https://kawalpemilu.org#52209,"CIPEUCANG, WANASALAM, LEBAK, BANTEN",8,90,75,165
https://kawalpemilu.org#52210,"MUARA, WANASALAM, LEBAK, BANTEN",1,186,60,246
https://kawalpemilu.org#52210,"MUARA, WANASALAM, LEBAK, BANTEN",2,136,74,210
https://kawalpemilu.org#52210,"MUARA, WANASALAM, LEBAK, BANTEN",3,148,69,217
https://kawalpemilu.org#52210,"MUARA, WANASALAM, LEBAK, BANTEN",4,115,96,211
https://kawalpemilu.org#52210,"MUARA, WANASALAM, LEBAK, BANTEN",5,143,73,216
https://kawalpemilu.org#52210,"MUARA, WANASALAM, LEBAK, BANTEN",6,93,115,208
https://kawalpemilu.org#52210,"MUARA, WANASALAM, LEBAK, BANTEN",7,164,89,253
https://kawalpemilu.org#52210,"MUARA, WANASALAM, LEBAK, BANTEN",8,120,73,193
https://kawalpemilu.org#52210,"MUARA, WANASALAM, LEBAK, BANTEN",9,116,110,226
https://kawalpemilu.org#52210,"MUARA, WANASALAM, LEBAK, BANTEN",10,84,137,221
https://kawalpemilu.org#52210,"MUARA, WANASALAM, LEBAK, BANTEN",11,105,82,187
https://kawalpemilu.org#52210,"MUARA, WANASALAM, LEBAK, BANTEN",12,64,172,236
https://kawalpemilu.org#52210,"MUARA, WANASALAM, LEBAK, BANTEN",14,70,111,181
https://kawalpemilu.org#52210,"MUARA, WANASALAM, LEBAK, BANTEN",15,99,102,201
https://kawalpemilu.org#52210,"MUARA, WANASALAM, LEBAK, BANTEN",16,106,106,212
https://kawalpemilu.org#52210,"MUARA, WANASALAM, LEBAK, BANTEN",17,109,106,215
https://kawalpemilu.org#52210,"MUARA, WANASALAM, LEBAK, BANTEN",19,91,93,184
https://kawalpemilu.org#52210,"MUARA, WANASALAM, LEBAK, BANTEN",20,144,92,236
https://kawalpemilu.org#52210,"MUARA, WANASALAM, LEBAK, BANTEN",21,82,137,219
https://kawalpemilu.org#52210,"MUARA, WANASALAM, LEBAK, BANTEN",23,133,86,219
https://kawalpemilu.org#52210,"MUARA, WANASALAM, LEBAK, BANTEN",24,94,93,187
https://kawalpemilu.org#52210,"MUARA, WANASALAM, LEBAK, BANTEN",25,141,83,224
https://kawalpemilu.org#52210,"MUARA, WANASALAM, LEBAK, BANTEN",26,93,153,246
https://kawalpemilu.org#52211,"PARUNGPANJANG, WANASALAM, LEBAK, BANTEN",1,23,166,189
https://kawalpemilu.org#52211,"PARUNGPANJANG, WANASALAM, LEBAK, BANTEN",2,34,155,189
https://kawalpemilu.org#52211,"PARUNGPANJANG, WANASALAM, LEBAK, BANTEN",3,69,133,202
https://kawalpemilu.org#52211,"PARUNGPANJANG, WANASALAM, LEBAK, BANTEN",4,100,112,212
https://kawalpemilu.org#52211,"PARUNGPANJANG, WANASALAM, LEBAK, BANTEN",5,59,145,204
https://kawalpemilu.org#52211,"PARUNGPANJANG, WANASALAM, LEBAK, BANTEN",6,73,100,173
https://kawalpemilu.org#52211,"PARUNGPANJANG, WANASALAM, LEBAK, BANTEN",7,53,68,121
https://kawalpemilu.org#52211,"PARUNGPANJANG, WANASALAM, LEBAK, BANTEN",8,65,132,197
https://kawalpemilu.org#52211,"PARUNGPANJANG, WANASALAM, LEBAK, BANTEN",9,30,144,174
https://kawalpemilu.org#52211,"PARUNGPANJANG, WANASALAM, LEBAK, BANTEN",10,80,119,199
https://kawalpemilu.org#52211,"PARUNGPANJANG, WANASALAM, LEBAK, BANTEN",11,47,85,132
https://kawalpemilu.org#52211,"PARUNGPANJANG, WANASALAM, LEBAK, BANTEN",12,60,52,112
https://kawalpemilu.org#52212,"CIKEUSIK, WANASALAM, LEBAK, BANTEN",1,67,79,146
https://kawalpemilu.org#52212,"CIKEUSIK, WANASALAM, LEBAK, BANTEN",2,67,97,164
https://kawalpemilu.org#52212,"CIKEUSIK, WANASALAM, LEBAK, BANTEN",3,40,177,217
https://kawalpemilu.org#52212,"CIKEUSIK, WANASALAM, LEBAK, BANTEN",4,43,121,164
https://kawalpemilu.org#52212,"CIKEUSIK, WANASALAM, LEBAK, BANTEN",5,77,125,202
https://kawalpemilu.org#52212,"CIKEUSIK, WANASALAM, LEBAK, BANTEN",6,50,62,112
https://kawalpemilu.org#52212,"CIKEUSIK, WANASALAM, LEBAK, BANTEN",7,44,179,223
https://kawalpemilu.org#52212,"CIKEUSIK, WANASALAM, LEBAK, BANTEN",8,73,82,155
https://kawalpemilu.org#52212,"CIKEUSIK, WANASALAM, LEBAK, BANTEN",9,33,33,66
https://kawalpemilu.org#52212,"CIKEUSIK, WANASALAM, LEBAK, BANTEN",10,77,47,124
https://kawalpemilu.org#52213,"KATAPANG, WANASALAM, LEBAK, BANTEN",1,15,149,164
https://kawalpemilu.org#52213,"KATAPANG, WANASALAM, LEBAK, BANTEN",2,12,107,119
https://kawalpemilu.org#52213,"KATAPANG, WANASALAM, LEBAK, BANTEN",3,26,66,92
https://kawalpemilu.org#52213,"KATAPANG, WANASALAM, LEBAK, BANTEN",4,36,96,132
https://kawalpemilu.org#52213,"KATAPANG, WANASALAM, LEBAK, BANTEN",5,24,70,94
https://kawalpemilu.org#52213,"KATAPANG, WANASALAM, LEBAK, BANTEN",6,64,94,150
https://kawalpemilu.org#52213,"KATAPANG, WANASALAM, LEBAK, BANTEN",7,8,133,141
https://kawalpemilu.org#52213,"KATAPANG, WANASALAM, LEBAK, BANTEN",8,30,88,118
https://kawalpemilu.org#52213,"KATAPANG, WANASALAM, LEBAK, BANTEN",9,14,106,120
https://kawalpemilu.org#52213,"KATAPANG, WANASALAM, LEBAK, BANTEN",10,15,92,107
https://kawalpemilu.org#52213,"KATAPANG, WANASALAM, LEBAK, BANTEN",11,11,87,98
https://kawalpemilu.org#52213,"KATAPANG, WANASALAM, LEBAK, BANTEN",12,24,79,103
https://kawalpemilu.org#52213,"KATAPANG, WANASALAM, LEBAK, BANTEN",13,25,91,116
https://kawalpemilu.org#52213,"KATAPANG, WANASALAM, LEBAK, BANTEN",14,20,65,85
https://kawalpemilu.org#52213,"KATAPANG, WANASALAM, LEBAK, BANTEN",15,23,68,91
https://kawalpemilu.org#52213,"KATAPANG, WANASALAM, LEBAK, BANTEN",16,71,10,81
https://kawalpemilu.org#52214,"CISARAP, WANASALAM, LEBAK, BANTEN",1,75,88,163
https://kawalpemilu.org#52214,"CISARAP, WANASALAM, LEBAK, BANTEN",2,49,103,152
https://kawalpemilu.org#52214,"CISARAP, WANASALAM, LEBAK, BANTEN",3,64,68,132
https://kawalpemilu.org#52214,"CISARAP, WANASALAM, LEBAK, BANTEN",4,65,86,151
https://kawalpemilu.org#52214,"CISARAP, WANASALAM, LEBAK, BANTEN",5,84,30,114
https://kawalpemilu.org#52214,"CISARAP, WANASALAM, LEBAK, BANTEN",6,62,74,136
https://kawalpemilu.org#52214,"CISARAP, WANASALAM, LEBAK, BANTEN",7,46,112,158
https://kawalpemilu.org#52214,"CISARAP, WANASALAM, LEBAK, BANTEN",8,81,79,160
https://kawalpemilu.org#52214,"CISARAP, WANASALAM, LEBAK, BANTEN",9,66,110,176
https://kawalpemilu.org#52214,"CISARAP, WANASALAM, LEBAK, BANTEN",10,85,43,128
https://kawalpemilu.org#52214,"CISARAP, WANASALAM, LEBAK, BANTEN",11,70,79,149
https://kawalpemilu.org#52214,"CISARAP, WANASALAM, LEBAK, BANTEN",12,63,90,153
https://kawalpemilu.org#52215,"SUKATANI, WANASALAM, LEBAK, BANTEN",1,117,91,208
https://kawalpemilu.org#52215,"SUKATANI, WANASALAM, LEBAK, BANTEN",2,116,102,218
https://kawalpemilu.org#52215,"SUKATANI, WANASALAM, LEBAK, BANTEN",3,147,69,216
https://kawalpemilu.org#52215,"SUKATANI, WANASALAM, LEBAK, BANTEN",4,97,129,226
https://kawalpemilu.org#52215,"SUKATANI, WANASALAM, LEBAK, BANTEN",5,96,83,179
https://kawalpemilu.org#52215,"SUKATANI, WANASALAM, LEBAK, BANTEN",6,65,125,190
https://kawalpemilu.org#52215,"SUKATANI, WANASALAM, LEBAK, BANTEN",7,122,82,204
https://kawalpemilu.org#52215,"SUKATANI, WANASALAM, LEBAK, BANTEN",8,104,54,158
https://kawalpemilu.org#52215,"SUKATANI, WANASALAM, LEBAK, BANTEN",9,68,124,192
https://kawalpemilu.org#52215,"SUKATANI, WANASALAM, LEBAK, BANTEN",10,74,90,164
https://kawalpemilu.org#52215,"SUKATANI, WANASALAM, LEBAK, BANTEN",12,109,61,170
https://kawalpemilu.org#52215,"SUKATANI, WANASALAM, LEBAK, BANTEN",13,110,94,204
https://kawalpemilu.org#52215,"SUKATANI, WANASALAM, LEBAK, BANTEN",15,66,87,153
https://kawalpemilu.org#52216,"CIPEDANG, WANASALAM, LEBAK, BANTEN",1,78,110,188
https://kawalpemilu.org#52216,"CIPEDANG, WANASALAM, LEBAK, BANTEN",2,64,149,213
https://kawalpemilu.org#52216,"CIPEDANG, WANASALAM, LEBAK, BANTEN",3,62,130,192
https://kawalpemilu.org#52216,"CIPEDANG, WANASALAM, LEBAK, BANTEN",4,55,135,190
https://kawalpemilu.org#52216,"CIPEDANG, WANASALAM, LEBAK, BANTEN",5,155,63,218
https://kawalpemilu.org#52216,"CIPEDANG, WANASALAM, LEBAK, BANTEN",6,107,109,216
https://kawalpemilu.org#52216,"CIPEDANG, WANASALAM, LEBAK, BANTEN",7,72,77,149
https://kawalpemilu.org#52216,"CIPEDANG, WANASALAM, LEBAK, BANTEN",8,77,116,193
https://kawalpemilu.org#52216,"CIPEDANG, WANASALAM, LEBAK, BANTEN",9,91,73,164
https://kawalpemilu.org#52216,"CIPEDANG, WANASALAM, LEBAK, BANTEN",10,169,49,218
https://kawalpemilu.org#52216,"CIPEDANG, WANASALAM, LEBAK, BANTEN",11,68,26,94
https://kawalpemilu.org#52217,"PARUNGSARI, WANASALAM, LEBAK, BANTEN",1,53,147,200
https://kawalpemilu.org#52217,"PARUNGSARI, WANASALAM, LEBAK, BANTEN",2,16,184,200
https://kawalpemilu.org#52217,"PARUNGSARI, WANASALAM, LEBAK, BANTEN",3,118,82,200
https://kawalpemilu.org#52217,"PARUNGSARI, WANASALAM, LEBAK, BANTEN",4,79,79,158
https://kawalpemilu.org#52217,"PARUNGSARI, WANASALAM, LEBAK, BANTEN",5,99,86,185
https://kawalpemilu.org#52217,"PARUNGSARI, WANASALAM, LEBAK, BANTEN",6,43,141,184
https://kawalpemilu.org#52217,"PARUNGSARI, WANASALAM, LEBAK, BANTEN",7,84,78,162
https://kawalpemilu.org#52218,"KARANGPAMINDANGAN, WANASALAM, LEBAK, BANTEN",1,44,144,188
https://kawalpemilu.org#52218,"KARANGPAMINDANGAN, WANASALAM, LEBAK, BANTEN",2,79,92,171
https://kawalpemilu.org#52218,"KARANGPAMINDANGAN, WANASALAM, LEBAK, BANTEN",3,114,51,165
https://kawalpemilu.org#52218,"KARANGPAMINDANGAN, WANASALAM, LEBAK, BANTEN",4,58,46,104
https://kawalpemilu.org#52218,"KARANGPAMINDANGAN, WANASALAM, LEBAK, BANTEN",5,109,62,171
https://kawalpemilu.org#52218,"KARANGPAMINDANGAN, WANASALAM, LEBAK, BANTEN",6,59,110,169
https://kawalpemilu.org#52218,"KARANGPAMINDANGAN, WANASALAM, LEBAK, BANTEN",7,59,34,93
https://kawalpemilu.org#52220,"CIPARASI, SOBANG, LEBAK, BANTEN",1,43,180,223
https://kawalpemilu.org#52220,"CIPARASI, SOBANG, LEBAK, BANTEN",2,10,189,199
https://kawalpemilu.org#52220,"CIPARASI, SOBANG, LEBAK, BANTEN",3,8,167,175
https://kawalpemilu.org#52220,"CIPARASI, SOBANG, LEBAK, BANTEN",4,19,154,173
https://kawalpemilu.org#52220,"CIPARASI, SOBANG, LEBAK, BANTEN",5,23,191,214
https://kawalpemilu.org#52220,"CIPARASI, SOBANG, LEBAK, BANTEN",6,30,147,177
https://kawalpemilu.org#52220,"CIPARASI, SOBANG, LEBAK, BANTEN",7,31,148,179
https://kawalpemilu.org#52220,"CIPARASI, SOBANG, LEBAK, BANTEN",8,33,166,199
https://kawalpemilu.org#52220,"CIPARASI, SOBANG, LEBAK, BANTEN",9,9,148,157
https://kawalpemilu.org#52220,"CIPARASI, SOBANG, LEBAK, BANTEN",10,14,175,189
https://kawalpemilu.org#52221,"SOBANG, SOBANG, LEBAK, BANTEN",1,156,81,237
https://kawalpemilu.org#52221,"SOBANG, SOBANG, LEBAK, BANTEN",2,175,67,242
https://kawalpemilu.org#52221,"SOBANG, SOBANG, LEBAK, BANTEN",3,95,44,139
https://kawalpemilu.org#52221,"SOBANG, SOBANG, LEBAK, BANTEN",4,104,104,208
https://kawalpemilu.org#52221,"SOBANG, SOBANG, LEBAK, BANTEN",5,156,65,221
https://kawalpemilu.org#52221,"SOBANG, SOBANG, LEBAK, BANTEN",6,110,96,206
https://kawalpemilu.org#52221,"SOBANG, SOBANG, LEBAK, BANTEN",7,117,77,194
https://kawalpemilu.org#52221,"SOBANG, SOBANG, LEBAK, BANTEN",8,179,59,238
https://kawalpemilu.org#52221,"SOBANG, SOBANG, LEBAK, BANTEN",9,139,56,195
https://kawalpemilu.org#52221,"SOBANG, SOBANG, LEBAK, BANTEN",10,109,50,159
https://kawalpemilu.org#52221,"SOBANG, SOBANG, LEBAK, BANTEN",11,131,73,204
https://kawalpemilu.org#52221,"SOBANG, SOBANG, LEBAK, BANTEN",12,121,112,233
https://kawalpemilu.org#52222,"SUKAJAYA, SOBANG, LEBAK, BANTEN",1,133,108,241
https://kawalpemilu.org#52222,"SUKAJAYA, SOBANG, LEBAK, BANTEN",2,146,37,183
https://kawalpemilu.org#52222,"SUKAJAYA, SOBANG, LEBAK, BANTEN",3,159,24,183
https://kawalpemilu.org#52222,"SUKAJAYA, SOBANG, LEBAK, BANTEN",4,108,53,161
https://kawalpemilu.org#52222,"SUKAJAYA, SOBANG, LEBAK, BANTEN",5,120,11,131
https://kawalpemilu.org#52222,"SUKAJAYA, SOBANG, LEBAK, BANTEN",6,134,50,184
https://kawalpemilu.org#52222,"SUKAJAYA, SOBANG, LEBAK, BANTEN",7,119,82,201
https://kawalpemilu.org#52222,"SUKAJAYA, SOBANG, LEBAK, BANTEN",8,196,25,221
https://kawalpemilu.org#52223,"SINDANGLAYA, SOBANG, LEBAK, BANTEN",1,193,11,204
https://kawalpemilu.org#52223,"SINDANGLAYA, SOBANG, LEBAK, BANTEN",2,183,52,235
https://kawalpemilu.org#52223,"SINDANGLAYA, SOBANG, LEBAK, BANTEN",3,112,82,194
https://kawalpemilu.org#52223,"SINDANGLAYA, SOBANG, LEBAK, BANTEN",4,155,111,266
https://kawalpemilu.org#52223,"SINDANGLAYA, SOBANG, LEBAK, BANTEN",5,154,8,162
https://kawalpemilu.org#52223,"SINDANGLAYA, SOBANG, LEBAK, BANTEN",6,157,43,200
https://kawalpemilu.org#52223,"SINDANGLAYA, SOBANG, LEBAK, BANTEN",7,200,40,240
https://kawalpemilu.org#52223,"SINDANGLAYA, SOBANG, LEBAK, BANTEN",8,121,66,187
https://kawalpemilu.org#52223,"SINDANGLAYA, SOBANG, LEBAK, BANTEN",9,185,67,252
https://kawalpemilu.org#52223,"SINDANGLAYA, SOBANG, LEBAK, BANTEN",10,126,37,163
https://kawalpemilu.org#52224,"SUKAMAJU, SOBANG, LEBAK, BANTEN",1,38,215,253
https://kawalpemilu.org#52224,"SUKAMAJU, SOBANG, LEBAK, BANTEN",2,37,180,217
https://kawalpemilu.org#52224,"SUKAMAJU, SOBANG, LEBAK, BANTEN",3,55,185,240
https://kawalpemilu.org#52224,"SUKAMAJU, SOBANG, LEBAK, BANTEN",4,24,120,144
https://kawalpemilu.org#52224,"SUKAMAJU, SOBANG, LEBAK, BANTEN",5,155,99,254
https://kawalpemilu.org#52224,"SUKAMAJU, SOBANG, LEBAK, BANTEN",6,81,140,221
https://kawalpemilu.org#52224,"SUKAMAJU, SOBANG, LEBAK, BANTEN",7,45,214,259
https://kawalpemilu.org#52224,"SUKAMAJU, SOBANG, LEBAK, BANTEN",8,38,185,223
https://kawalpemilu.org#52224,"SUKAMAJU, SOBANG, LEBAK, BANTEN",9,51,190,241
https://kawalpemilu.org#52224,"SUKAMAJU, SOBANG, LEBAK, BANTEN",10,16,129,145
https://kawalpemilu.org#52224,"SUKAMAJU, SOBANG, LEBAK, BANTEN",11,139,116,255
https://kawalpemilu.org#52224,"SUKAMAJU, SOBANG, LEBAK, BANTEN",12,70,149,219
https://kawalpemilu.org#52225,"HARIANG, SOBANG, LEBAK, BANTEN",1,34,184,218
https://kawalpemilu.org#52225,"HARIANG, SOBANG, LEBAK, BANTEN",2,34,105,139
https://kawalpemilu.org#52225,"HARIANG, SOBANG, LEBAK, BANTEN",3,99,72,171
https://kawalpemilu.org#52225,"HARIANG, SOBANG, LEBAK, BANTEN",4,112,54,166
https://kawalpemilu.org#52225,"HARIANG, SOBANG, LEBAK, BANTEN",5,39,94,133
https://kawalpemilu.org#52225,"HARIANG, SOBANG, LEBAK, BANTEN",6,99,76,175
https://kawalpemilu.org#52225,"HARIANG, SOBANG, LEBAK, BANTEN",7,120,104,224
https://kawalpemilu.org#52225,"HARIANG, SOBANG, LEBAK, BANTEN",8,84,54,138
https://kawalpemilu.org#52225,"HARIANG, SOBANG, LEBAK, BANTEN",9,36,150,186
https://kawalpemilu.org#52225,"HARIANG, SOBANG, LEBAK, BANTEN",10,41,107,148
https://kawalpemilu.org#52225,"HARIANG, SOBANG, LEBAK, BANTEN",11,122,42,164
https://kawalpemilu.org#52225,"HARIANG, SOBANG, LEBAK, BANTEN",12,58,74,132
https://kawalpemilu.org#52225,"HARIANG, SOBANG, LEBAK, BANTEN",13,68,83,151
https://kawalpemilu.org#52225,"HARIANG, SOBANG, LEBAK, BANTEN",14,103,84,187
https://kawalpemilu.org#52225,"HARIANG, SOBANG, LEBAK, BANTEN",15,199,11,210
https://kawalpemilu.org#52225,"HARIANG, SOBANG, LEBAK, BANTEN",16,135,93,228
https://kawalpemilu.org#52225,"HARIANG, SOBANG, LEBAK, BANTEN",17,82,57,139
https://kawalpemilu.org#52226,"MAJASARI, SOBANG, LEBAK, BANTEN",1,41,113,154
https://kawalpemilu.org#52226,"MAJASARI, SOBANG, LEBAK, BANTEN",2,49,173,222
https://kawalpemilu.org#52226,"MAJASARI, SOBANG, LEBAK, BANTEN",3,22,149,171
https://kawalpemilu.org#52226,"MAJASARI, SOBANG, LEBAK, BANTEN",4,42,154,196
https://kawalpemilu.org#52226,"MAJASARI, SOBANG, LEBAK, BANTEN",5,50,153,203
https://kawalpemilu.org#52226,"MAJASARI, SOBANG, LEBAK, BANTEN",6,29,141,170
https://kawalpemilu.org#52226,"MAJASARI, SOBANG, LEBAK, BANTEN",7,40,128,168
https://kawalpemilu.org#52226,"MAJASARI, SOBANG, LEBAK, BANTEN",8,50,150,200
https://kawalpemilu.org#52226,"MAJASARI, SOBANG, LEBAK, BANTEN",9,65,124,189
https://kawalpemilu.org#52226,"MAJASARI, SOBANG, LEBAK, BANTEN",10,28,175,203
https://kawalpemilu.org#52226,"MAJASARI, SOBANG, LEBAK, BANTEN",11,26,166,192
https://kawalpemilu.org#52226,"MAJASARI, SOBANG, LEBAK, BANTEN",12,36,153,189
https://kawalpemilu.org#52226,"MAJASARI, SOBANG, LEBAK, BANTEN",13,48,156,204
https://kawalpemilu.org#52227,"SINARJAYA, SOBANG, LEBAK, BANTEN",1,62,175,237
https://kawalpemilu.org#52227,"SINARJAYA, SOBANG, LEBAK, BANTEN",2,149,25,174
https://kawalpemilu.org#52227,"SINARJAYA, SOBANG, LEBAK, BANTEN",3,160,38,198
https://kawalpemilu.org#52227,"SINARJAYA, SOBANG, LEBAK, BANTEN",4,135,87,222
https://kawalpemilu.org#52227,"SINARJAYA, SOBANG, LEBAK, BANTEN",5,145,37,182
https://kawalpemilu.org#52227,"SINARJAYA, SOBANG, LEBAK, BANTEN",6,182,25,207
https://kawalpemilu.org#52227,"SINARJAYA, SOBANG, LEBAK, BANTEN",7,206,14,220
https://kawalpemilu.org#52228,"CIROMPANG, SOBANG, LEBAK, BANTEN",1,107,37,144
https://kawalpemilu.org#52228,"CIROMPANG, SOBANG, LEBAK, BANTEN",2,124,48,172
https://kawalpemilu.org#52228,"CIROMPANG, SOBANG, LEBAK, BANTEN",3,83,134,217
https://kawalpemilu.org#52228,"CIROMPANG, SOBANG, LEBAK, BANTEN",4,86,56,142
https://kawalpemilu.org#52228,"CIROMPANG, SOBANG, LEBAK, BANTEN",5,116,52,168
https://kawalpemilu.org#52228,"CIROMPANG, SOBANG, LEBAK, BANTEN",6,176,60,236
https://kawalpemilu.org#52229,"SUKARESMI, SOBANG, LEBAK, BANTEN",1,103,94,197
https://kawalpemilu.org#52229,"SUKARESMI, SOBANG, LEBAK, BANTEN",2,99,86,185
https://kawalpemilu.org#52229,"SUKARESMI, SOBANG, LEBAK, BANTEN",3,116,125,241
https://kawalpemilu.org#52229,"SUKARESMI, SOBANG, LEBAK, BANTEN",4,110,82,192
https://kawalpemilu.org#52229,"SUKARESMI, SOBANG, LEBAK, BANTEN",5,86,88,174
https://kawalpemilu.org#52229,"SUKARESMI, SOBANG, LEBAK, BANTEN",6,80,67,147
https://kawalpemilu.org#52229,"SUKARESMI, SOBANG, LEBAK, BANTEN",7,52,99,151
https://kawalpemilu.org#52231,"GURADOG, CURUG BITUNG, LEBAK, BANTEN",1,228,39,267
https://kawalpemilu.org#52231,"GURADOG, CURUG BITUNG, LEBAK, BANTEN",2,245,23,268
https://kawalpemilu.org#52231,"GURADOG, CURUG BITUNG, LEBAK, BANTEN",3,192,77,269
https://kawalpemilu.org#52231,"GURADOG, CURUG BITUNG, LEBAK, BANTEN",4,243,24,267
https://kawalpemilu.org#52231,"GURADOG, CURUG BITUNG, LEBAK, BANTEN",5,194,28,222
https://kawalpemilu.org#52231,"GURADOG, CURUG BITUNG, LEBAK, BANTEN",6,255,39,294
https://kawalpemilu.org#52231,"GURADOG, CURUG BITUNG, LEBAK, BANTEN",7,234,57,291
https://kawalpemilu.org#52231,"GURADOG, CURUG BITUNG, LEBAK, BANTEN",8,244,48,292
https://kawalpemilu.org#52231,"GURADOG, CURUG BITUNG, LEBAK, BANTEN",9,236,55,291
https://kawalpemilu.org#52231,"GURADOG, CURUG BITUNG, LEBAK, BANTEN",10,276,14,290
https://kawalpemilu.org#52231,"GURADOG, CURUG BITUNG, LEBAK, BANTEN",11,289,2,291
https://kawalpemilu.org#52232,"CURUGBITUNG, CURUG BITUNG, LEBAK, BANTEN",1,79,110,189
https://kawalpemilu.org#52232,"CURUGBITUNG, CURUG BITUNG, LEBAK, BANTEN",2,62,130,192
https://kawalpemilu.org#52232,"CURUGBITUNG, CURUG BITUNG, LEBAK, BANTEN",3,61,152,213
https://kawalpemilu.org#52232,"CURUGBITUNG, CURUG BITUNG, LEBAK, BANTEN",4,59,144,203
https://kawalpemilu.org#52232,"CURUGBITUNG, CURUG BITUNG, LEBAK, BANTEN",5,58,139,197
https://kawalpemilu.org#52232,"CURUGBITUNG, CURUG BITUNG, LEBAK, BANTEN",6,65,144,209
https://kawalpemilu.org#52232,"CURUGBITUNG, CURUG BITUNG, LEBAK, BANTEN",7,77,122,199
https://kawalpemilu.org#52232,"CURUGBITUNG, CURUG BITUNG, LEBAK, BANTEN",8,25,150,175
https://kawalpemilu.org#52232,"CURUGBITUNG, CURUG BITUNG, LEBAK, BANTEN",9,53,116,169
https://kawalpemilu.org#52233,"CANDI, CURUG BITUNG, LEBAK, BANTEN",1,94,137,231
https://kawalpemilu.org#52233,"CANDI, CURUG BITUNG, LEBAK, BANTEN",2,75,146,221
https://kawalpemilu.org#52233,"CANDI, CURUG BITUNG, LEBAK, BANTEN",3,75,155,230
https://kawalpemilu.org#52233,"CANDI, CURUG BITUNG, LEBAK, BANTEN",4,77,166,243
https://kawalpemilu.org#52233,"CANDI, CURUG BITUNG, LEBAK, BANTEN",5,61,152,213
https://kawalpemilu.org#52233,"CANDI, CURUG BITUNG, LEBAK, BANTEN",6,50,154,204
https://kawalpemilu.org#52233,"CANDI, CURUG BITUNG, LEBAK, BANTEN",7,25,133,158
https://kawalpemilu.org#52233,"CANDI, CURUG BITUNG, LEBAK, BANTEN",8,72,61,133
https://kawalpemilu.org#52234,"MAYAK, CURUG BITUNG, LEBAK, BANTEN",1,83,92,175
https://kawalpemilu.org#52234,"MAYAK, CURUG BITUNG, LEBAK, BANTEN",2,106,72,178
https://kawalpemilu.org#52234,"MAYAK, CURUG BITUNG, LEBAK, BANTEN",3,112,65,177
https://kawalpemilu.org#52234,"MAYAK, CURUG BITUNG, LEBAK, BANTEN",4,56,132,188
https://kawalpemilu.org#52234,"MAYAK, CURUG BITUNG, LEBAK, BANTEN",5,72,131,203
https://kawalpemilu.org#52234,"MAYAK, CURUG BITUNG, LEBAK, BANTEN",6,55,133,188
https://kawalpemilu.org#52234,"MAYAK, CURUG BITUNG, LEBAK, BANTEN",7,60,121,181
https://kawalpemilu.org#52235,"CIPINING, CURUG BITUNG, LEBAK, BANTEN",1,110,90,200
https://kawalpemilu.org#52235,"CIPINING, CURUG BITUNG, LEBAK, BANTEN",2,72,124,196
https://kawalpemilu.org#52235,"CIPINING, CURUG BITUNG, LEBAK, BANTEN",3,52,163,215
https://kawalpemilu.org#52235,"CIPINING, CURUG BITUNG, LEBAK, BANTEN",4,56,151,207
https://kawalpemilu.org#52235,"CIPINING, CURUG BITUNG, LEBAK, BANTEN",5,58,144,202
https://kawalpemilu.org#52235,"CIPINING, CURUG BITUNG, LEBAK, BANTEN",6,57,116,173
https://kawalpemilu.org#52235,"CIPINING, CURUG BITUNG, LEBAK, BANTEN",7,51,146,197
https://kawalpemilu.org#52235,"CIPINING, CURUG BITUNG, LEBAK, BANTEN",8,85,109,194
https://kawalpemilu.org#52235,"CIPINING, CURUG BITUNG, LEBAK, BANTEN",9,50,149,199
https://kawalpemilu.org#52235,"CIPINING, CURUG BITUNG, LEBAK, BANTEN",10,59,127,186
https://kawalpemilu.org#52236,"CILAYANG, CURUG BITUNG, LEBAK, BANTEN",1,74,149,223
https://kawalpemilu.org#52236,"CILAYANG, CURUG BITUNG, LEBAK, BANTEN",2,59,142,201
https://kawalpemilu.org#52236,"CILAYANG, CURUG BITUNG, LEBAK, BANTEN",3,56,129,185
https://kawalpemilu.org#52236,"CILAYANG, CURUG BITUNG, LEBAK, BANTEN",4,83,113,196
https://kawalpemilu.org#52236,"CILAYANG, CURUG BITUNG, LEBAK, BANTEN",5,77,111,188
https://kawalpemilu.org#52236,"CILAYANG, CURUG BITUNG, LEBAK, BANTEN",6,86,114,200
https://kawalpemilu.org#52236,"CILAYANG, CURUG BITUNG, LEBAK, BANTEN",7,90,111,201
https://kawalpemilu.org#52236,"CILAYANG, CURUG BITUNG, LEBAK, BANTEN",8,117,106,223
https://kawalpemilu.org#52236,"CILAYANG, CURUG BITUNG, LEBAK, BANTEN",9,99,46,145
https://kawalpemilu.org#52236,"CILAYANG, CURUG BITUNG, LEBAK, BANTEN",10,43,113,156
https://kawalpemilu.org#52236,"CILAYANG, CURUG BITUNG, LEBAK, BANTEN",11,72,115,187
https://kawalpemilu.org#52237,"CIBURUY, CURUG BITUNG, LEBAK, BANTEN",1,81,114,195
https://kawalpemilu.org#52237,"CIBURUY, CURUG BITUNG, LEBAK, BANTEN",2,76,133,209
https://kawalpemilu.org#52237,"CIBURUY, CURUG BITUNG, LEBAK, BANTEN",3,66,144,210
https://kawalpemilu.org#52237,"CIBURUY, CURUG BITUNG, LEBAK, BANTEN",4,68,124,192
https://kawalpemilu.org#52237,"CIBURUY, CURUG BITUNG, LEBAK, BANTEN",5,72,145,217
https://kawalpemilu.org#52237,"CIBURUY, CURUG BITUNG, LEBAK, BANTEN",6,49,131,180
https://kawalpemilu.org#52237,"CIBURUY, CURUG BITUNG, LEBAK, BANTEN",7,51,148,199
https://kawalpemilu.org#52237,"CIBURUY, CURUG BITUNG, LEBAK, BANTEN",8,42,116,158
https://kawalpemilu.org#52237,"CIBURUY, CURUG BITUNG, LEBAK, BANTEN",9,98,98,196
https://kawalpemilu.org#52237,"CIBURUY, CURUG BITUNG, LEBAK, BANTEN",10,49,143,192
https://kawalpemilu.org#52237,"CIBURUY, CURUG BITUNG, LEBAK, BANTEN",11,47,111,158
https://kawalpemilu.org#52237,"CIBURUY, CURUG BITUNG, LEBAK, BANTEN",12,32,160,192
https://kawalpemilu.org#52237,"CIBURUY, CURUG BITUNG, LEBAK, BANTEN",13,78,140,218
https://kawalpemilu.org#52237,"CIBURUY, CURUG BITUNG, LEBAK, BANTEN",14,48,148,196
https://kawalpemilu.org#52237,"CIBURUY, CURUG BITUNG, LEBAK, BANTEN",15,59,154,213
https://kawalpemilu.org#52238,"SEKARWANGI, CURUG BITUNG, LEBAK, BANTEN",1,61,174,235
https://kawalpemilu.org#52238,"SEKARWANGI, CURUG BITUNG, LEBAK, BANTEN",2,55,162,217
https://kawalpemilu.org#52238,"SEKARWANGI, CURUG BITUNG, LEBAK, BANTEN",3,62,162,224
https://kawalpemilu.org#52238,"SEKARWANGI, CURUG BITUNG, LEBAK, BANTEN",4,33,144,177
https://kawalpemilu.org#52238,"SEKARWANGI, CURUG BITUNG, LEBAK, BANTEN",5,34,142,176
https://kawalpemilu.org#52238,"SEKARWANGI, CURUG BITUNG, LEBAK, BANTEN",6,34,103,137
https://kawalpemilu.org#52238,"SEKARWANGI, CURUG BITUNG, LEBAK, BANTEN",7,39,183,222
https://kawalpemilu.org#52238,"SEKARWANGI, CURUG BITUNG, LEBAK, BANTEN",8,54,181,235
https://kawalpemilu.org#52238,"SEKARWANGI, CURUG BITUNG, LEBAK, BANTEN",9,36,184,220
https://kawalpemilu.org#52238,"SEKARWANGI, CURUG BITUNG, LEBAK, BANTEN",10,31,191,222
https://kawalpemilu.org#52239,"CIDADAP, CURUG BITUNG, LEBAK, BANTEN",1,42,152,194
https://kawalpemilu.org#52239,"CIDADAP, CURUG BITUNG, LEBAK, BANTEN",2,42,160,202
https://kawalpemilu.org#52239,"CIDADAP, CURUG BITUNG, LEBAK, BANTEN",3,67,145,212
https://kawalpemilu.org#52239,"CIDADAP, CURUG BITUNG, LEBAK, BANTEN",4,76,121,197
https://kawalpemilu.org#52239,"CIDADAP, CURUG BITUNG, LEBAK, BANTEN",5,65,132,197
https://kawalpemilu.org#52239,"CIDADAP, CURUG BITUNG, LEBAK, BANTEN",6,59,156,215
https://kawalpemilu.org#52239,"CIDADAP, CURUG BITUNG, LEBAK, BANTEN",7,96,126,222
https://kawalpemilu.org#52239,"CIDADAP, CURUG BITUNG, LEBAK, BANTEN",8,73,137,210
https://kawalpemilu.org#52239,"CIDADAP, CURUG BITUNG, LEBAK, BANTEN",9,49,144,193
https://kawalpemilu.org#52239,"CIDADAP, CURUG BITUNG, LEBAK, BANTEN",10,52,125,177
https://kawalpemilu.org#52240,"LEBAKASIH, CURUG BITUNG, LEBAK, BANTEN",1,135,87,222
https://kawalpemilu.org#52240,"LEBAKASIH, CURUG BITUNG, LEBAK, BANTEN",2,113,95,208
https://kawalpemilu.org#52240,"LEBAKASIH, CURUG BITUNG, LEBAK, BANTEN",3,114,96,210
https://kawalpemilu.org#52240,"LEBAKASIH, CURUG BITUNG, LEBAK, BANTEN",4,93,134,227
https://kawalpemilu.org#52240,"LEBAKASIH, CURUG BITUNG, LEBAK, BANTEN",5,45,126,171
https://kawalpemilu.org#52240,"LEBAKASIH, CURUG BITUNG, LEBAK, BANTEN",6,54,122,176
https://kawalpemilu.org#52240,"LEBAKASIH, CURUG BITUNG, LEBAK, BANTEN",7,56,125,181
https://kawalpemilu.org#52242,"KALANGANYAR, KALANGANYAR, LEBAK, BANTEN",1,51,129,180
https://kawalpemilu.org#52242,"KALANGANYAR, KALANGANYAR, LEBAK, BANTEN",2,40,128,168
https://kawalpemilu.org#52242,"KALANGANYAR, KALANGANYAR, LEBAK, BANTEN",3,26,81,107
https://kawalpemilu.org#52242,"KALANGANYAR, KALANGANYAR, LEBAK, BANTEN",4,76,133,209
https://kawalpemilu.org#52242,"KALANGANYAR, KALANGANYAR, LEBAK, BANTEN",5,34,104,138
https://kawalpemilu.org#52242,"KALANGANYAR, KALANGANYAR, LEBAK, BANTEN",6,56,38,94
https://kawalpemilu.org#52242,"KALANGANYAR, KALANGANYAR, LEBAK, BANTEN",7,68,151,219
https://kawalpemilu.org#52242,"KALANGANYAR, KALANGANYAR, LEBAK, BANTEN",8,56,50,106
https://kawalpemilu.org#52242,"KALANGANYAR, KALANGANYAR, LEBAK, BANTEN",9,57,80,137
https://kawalpemilu.org#52242,"KALANGANYAR, KALANGANYAR, LEBAK, BANTEN",10,99,100,199
https://kawalpemilu.org#52242,"KALANGANYAR, KALANGANYAR, LEBAK, BANTEN",11,36,69,105
https://kawalpemilu.org#52242,"KALANGANYAR, KALANGANYAR, LEBAK, BANTEN",12,26,98,124
https://kawalpemilu.org#52242,"KALANGANYAR, KALANGANYAR, LEBAK, BANTEN",13,57,80,137
https://kawalpemilu.org#52242,"KALANGANYAR, KALANGANYAR, LEBAK, BANTEN",14,66,75,141
https://kawalpemilu.org#52242,"KALANGANYAR, KALANGANYAR, LEBAK, BANTEN",15,25,108,133
https://kawalpemilu.org#52242,"KALANGANYAR, KALANGANYAR, LEBAK, BANTEN",16,58,167,225
https://kawalpemilu.org#52243,"PASIRKUPA, KALANGANYAR, LEBAK, BANTEN",1,30,181,211
https://kawalpemilu.org#52243,"PASIRKUPA, KALANGANYAR, LEBAK, BANTEN",2,28,172,200
https://kawalpemilu.org#52243,"PASIRKUPA, KALANGANYAR, LEBAK, BANTEN",3,17,163,180
https://kawalpemilu.org#52243,"PASIRKUPA, KALANGANYAR, LEBAK, BANTEN",4,27,147,174
https://kawalpemilu.org#52243,"PASIRKUPA, KALANGANYAR, LEBAK, BANTEN",5,21,145,166
https://kawalpemilu.org#52243,"PASIRKUPA, KALANGANYAR, LEBAK, BANTEN",6,32,171,203
https://kawalpemilu.org#52243,"PASIRKUPA, KALANGANYAR, LEBAK, BANTEN",7,34,154,188
https://kawalpemilu.org#52243,"PASIRKUPA, KALANGANYAR, LEBAK, BANTEN",8,34,163,197
https://kawalpemilu.org#52243,"PASIRKUPA, KALANGANYAR, LEBAK, BANTEN",9,31,173,204
https://kawalpemilu.org#52243,"PASIRKUPA, KALANGANYAR, LEBAK, BANTEN",10,64,136,200
https://kawalpemilu.org#52243,"PASIRKUPA, KALANGANYAR, LEBAK, BANTEN",11,42,169,211
https://kawalpemilu.org#52243,"PASIRKUPA, KALANGANYAR, LEBAK, BANTEN",12,42,120,162
https://kawalpemilu.org#52243,"PASIRKUPA, KALANGANYAR, LEBAK, BANTEN",13,24,138,162
https://kawalpemilu.org#52243,"PASIRKUPA, KALANGANYAR, LEBAK, BANTEN",14,21,147,168
https://kawalpemilu.org#52243,"PASIRKUPA, KALANGANYAR, LEBAK, BANTEN",15,22,122,144
https://kawalpemilu.org#52243,"PASIRKUPA, KALANGANYAR, LEBAK, BANTEN",16,14,150,164
https://kawalpemilu.org#52243,"PASIRKUPA, KALANGANYAR, LEBAK, BANTEN",17,49,169,218
https://kawalpemilu.org#52243,"PASIRKUPA, KALANGANYAR, LEBAK, BANTEN",18,54,157,211
https://kawalpemilu.org#52244,"CILANGKAP, KALANGANYAR, LEBAK, BANTEN",1,53,137,190
https://kawalpemilu.org#52244,"CILANGKAP, KALANGANYAR, LEBAK, BANTEN",2,96,150,246
https://kawalpemilu.org#52244,"CILANGKAP, KALANGANYAR, LEBAK, BANTEN",3,60,184,244
https://kawalpemilu.org#52244,"CILANGKAP, KALANGANYAR, LEBAK, BANTEN",4,74,160,234
https://kawalpemilu.org#52244,"CILANGKAP, KALANGANYAR, LEBAK, BANTEN",5,50,189,239
https://kawalpemilu.org#52244,"CILANGKAP, KALANGANYAR, LEBAK, BANTEN",6,42,169,211
https://kawalpemilu.org#52244,"CILANGKAP, KALANGANYAR, LEBAK, BANTEN",7,71,149,220
https://kawalpemilu.org#52244,"CILANGKAP, KALANGANYAR, LEBAK, BANTEN",8,82,154,236
https://kawalpemilu.org#52244,"CILANGKAP, KALANGANYAR, LEBAK, BANTEN",9,47,160,207
https://kawalpemilu.org#52244,"CILANGKAP, KALANGANYAR, LEBAK, BANTEN",10,30,181,211
https://kawalpemilu.org#52244,"CILANGKAP, KALANGANYAR, LEBAK, BANTEN",11,32,136,168
https://kawalpemilu.org#52244,"CILANGKAP, KALANGANYAR, LEBAK, BANTEN",12,23,125,148
https://kawalpemilu.org#52245,"AWEH, KALANGANYAR, LEBAK, BANTEN",1,58,113,171
https://kawalpemilu.org#52245,"AWEH, KALANGANYAR, LEBAK, BANTEN",2,76,117,193
https://kawalpemilu.org#52245,"AWEH, KALANGANYAR, LEBAK, BANTEN",3,29,167,196
https://kawalpemilu.org#52245,"AWEH, KALANGANYAR, LEBAK, BANTEN",4,50,174,224
https://kawalpemilu.org#52245,"AWEH, KALANGANYAR, LEBAK, BANTEN",5,43,203,246
https://kawalpemilu.org#52245,"AWEH, KALANGANYAR, LEBAK, BANTEN",6,82,123,205
https://kawalpemilu.org#52245,"AWEH, KALANGANYAR, LEBAK, BANTEN",7,83,97,180
https://kawalpemilu.org#52245,"AWEH, KALANGANYAR, LEBAK, BANTEN",8,50,141,191
https://kawalpemilu.org#52245,"AWEH, KALANGANYAR, LEBAK, BANTEN",9,70,134,204
https://kawalpemilu.org#52245,"AWEH, KALANGANYAR, LEBAK, BANTEN",10,29,123,152
https://kawalpemilu.org#52245,"AWEH, KALANGANYAR, LEBAK, BANTEN",11,35,165,200
https://kawalpemilu.org#52245,"AWEH, KALANGANYAR, LEBAK, BANTEN",12,46,172,218
https://kawalpemilu.org#52245,"AWEH, KALANGANYAR, LEBAK, BANTEN",13,62,169,231
https://kawalpemilu.org#52245,"AWEH, KALANGANYAR, LEBAK, BANTEN",14,31,177,208
https://kawalpemilu.org#52245,"AWEH, KALANGANYAR, LEBAK, BANTEN",15,60,163,223
https://kawalpemilu.org#52245,"AWEH, KALANGANYAR, LEBAK, BANTEN",16,72,163,235
https://kawalpemilu.org#52245,"AWEH, KALANGANYAR, LEBAK, BANTEN",17,45,180,225
https://kawalpemilu.org#52246,"SANGIANGTANJUNG, KALANGANYAR, LEBAK, BANTEN",1,74,67,141
https://kawalpemilu.org#52246,"SANGIANGTANJUNG, KALANGANYAR, LEBAK, BANTEN",3,43,113,156
https://kawalpemilu.org#52246,"SANGIANGTANJUNG, KALANGANYAR, LEBAK, BANTEN",4,49,124,173
https://kawalpemilu.org#52246,"SANGIANGTANJUNG, KALANGANYAR, LEBAK, BANTEN",5,58,124,182
https://kawalpemilu.org#52246,"SANGIANGTANJUNG, KALANGANYAR, LEBAK, BANTEN",6,78,92,170
https://kawalpemilu.org#52246,"SANGIANGTANJUNG, KALANGANYAR, LEBAK, BANTEN",7,72,80,152
https://kawalpemilu.org#52246,"SANGIANGTANJUNG, KALANGANYAR, LEBAK, BANTEN",8,82,92,174
https://kawalpemilu.org#52246,"SANGIANGTANJUNG, KALANGANYAR, LEBAK, BANTEN",9,39,115,154
https://kawalpemilu.org#52246,"SANGIANGTANJUNG, KALANGANYAR, LEBAK, BANTEN",10,56,102,158
https://kawalpemilu.org#52246,"SANGIANGTANJUNG, KALANGANYAR, LEBAK, BANTEN",11,54,80,134
https://kawalpemilu.org#52246,"SANGIANGTANJUNG, KALANGANYAR, LEBAK, BANTEN",12,33,123,156
https://kawalpemilu.org#52246,"SANGIANGTANJUNG, KALANGANYAR, LEBAK, BANTEN",13,73,102,175
https://kawalpemilu.org#52246,"SANGIANGTANJUNG, KALANGANYAR, LEBAK, BANTEN",14,95,112,207
https://kawalpemilu.org#52246,"SANGIANGTANJUNG, KALANGANYAR, LEBAK, BANTEN",15,49,138,187
https://kawalpemilu.org#52247,"SUKAMEKARSARI, KALANGANYAR, LEBAK, BANTEN",1,40,146,186
https://kawalpemilu.org#52247,"SUKAMEKARSARI, KALANGANYAR, LEBAK, BANTEN",2,57,125,182
https://kawalpemilu.org#52247,"SUKAMEKARSARI, KALANGANYAR, LEBAK, BANTEN",3,54,83,137
https://kawalpemilu.org#52247,"SUKAMEKARSARI, KALANGANYAR, LEBAK, BANTEN",4,52,106,158
https://kawalpemilu.org#52247,"SUKAMEKARSARI, KALANGANYAR, LEBAK, BANTEN",5,63,100,163
https://kawalpemilu.org#52247,"SUKAMEKARSARI, KALANGANYAR, LEBAK, BANTEN",6,47,99,146
https://kawalpemilu.org#52247,"SUKAMEKARSARI, KALANGANYAR, LEBAK, BANTEN",7,29,109,138
https://kawalpemilu.org#52247,"SUKAMEKARSARI, KALANGANYAR, LEBAK, BANTEN",8,42,119,161
https://kawalpemilu.org#52247,"SUKAMEKARSARI, KALANGANYAR, LEBAK, BANTEN",9,64,109,173
https://kawalpemilu.org#52247,"SUKAMEKARSARI, KALANGANYAR, LEBAK, BANTEN",10,40,132,172
https://kawalpemilu.org#52247,"SUKAMEKARSARI, KALANGANYAR, LEBAK, BANTEN",11,56,159,215
https://kawalpemilu.org#52247,"SUKAMEKARSARI, KALANGANYAR, LEBAK, BANTEN",12,30,172,202
https://kawalpemilu.org#52247,"SUKAMEKARSARI, KALANGANYAR, LEBAK, BANTEN",13,46,121,167
https://kawalpemilu.org#52247,"SUKAMEKARSARI, KALANGANYAR, LEBAK, BANTEN",14,35,131,166
https://kawalpemilu.org#52247,"SUKAMEKARSARI, KALANGANYAR, LEBAK, BANTEN",15,37,118,155
https://kawalpemilu.org#52247,"SUKAMEKARSARI, KALANGANYAR, LEBAK, BANTEN",16,85,98,183
https://kawalpemilu.org#52247,"SUKAMEKARSARI, KALANGANYAR, LEBAK, BANTEN",17,56,142,198
https://kawalpemilu.org#52247,"SUKAMEKARSARI, KALANGANYAR, LEBAK, BANTEN",18,34,166,200
https://kawalpemilu.org#52247,"SUKAMEKARSARI, KALANGANYAR, LEBAK, BANTEN",19,64,118,182
https://kawalpemilu.org#52248,"CIKATAPIS, KALANGANYAR, LEBAK, BANTEN",2,41,171,212
https://kawalpemilu.org#52248,"CIKATAPIS, KALANGANYAR, LEBAK, BANTEN",3,61,186,247
https://kawalpemilu.org#52248,"CIKATAPIS, KALANGANYAR, LEBAK, BANTEN",4,72,176,248
https://kawalpemilu.org#52248,"CIKATAPIS, KALANGANYAR, LEBAK, BANTEN",5,60,174,234
https://kawalpemilu.org#52248,"CIKATAPIS, KALANGANYAR, LEBAK, BANTEN",6,35,197,232
https://kawalpemilu.org#52248,"CIKATAPIS, KALANGANYAR, LEBAK, BANTEN",7,43,182,225
https://kawalpemilu.org#52248,"CIKATAPIS, KALANGANYAR, LEBAK, BANTEN",8,53,187,240
https://kawalpemilu.org#52248,"CIKATAPIS, KALANGANYAR, LEBAK, BANTEN",9,28,204,232
https://kawalpemilu.org#52250,"BANJARIRIGASI, LEBAKGEDONG, LEBAK, BANTEN",1,18,201,219
https://kawalpemilu.org#52250,"BANJARIRIGASI, LEBAKGEDONG, LEBAK, BANTEN",2,35,184,219
https://kawalpemilu.org#52250,"BANJARIRIGASI, LEBAKGEDONG, LEBAK, BANTEN",3,44,183,227
https://kawalpemilu.org#52250,"BANJARIRIGASI, LEBAKGEDONG, LEBAK, BANTEN",4,49,168,217
https://kawalpemilu.org#52250,"BANJARIRIGASI, LEBAKGEDONG, LEBAK, BANTEN",5,28,175,203
https://kawalpemilu.org#52250,"BANJARIRIGASI, LEBAKGEDONG, LEBAK, BANTEN",6,37,218,255
https://kawalpemilu.org#52250,"BANJARIRIGASI, LEBAKGEDONG, LEBAK, BANTEN",7,56,212,268
https://kawalpemilu.org#52250,"BANJARIRIGASI, LEBAKGEDONG, LEBAK, BANTEN",9,34,197,231
https://kawalpemilu.org#52250,"BANJARIRIGASI, LEBAKGEDONG, LEBAK, BANTEN",10,23,186,209
https://kawalpemilu.org#52250,"BANJARIRIGASI, LEBAKGEDONG, LEBAK, BANTEN",11,40,180,220
https://kawalpemilu.org#52250,"BANJARIRIGASI, LEBAKGEDONG, LEBAK, BANTEN",12,47,182,229
https://kawalpemilu.org#52250,"BANJARIRIGASI, LEBAKGEDONG, LEBAK, BANTEN",13,65,150,215
https://kawalpemilu.org#52250,"BANJARIRIGASI, LEBAKGEDONG, LEBAK, BANTEN",14,42,199,241
https://kawalpemilu.org#52250,"BANJARIRIGASI, LEBAKGEDONG, LEBAK, BANTEN",15,50,196,246
https://kawalpemilu.org#52250,"BANJARIRIGASI, LEBAKGEDONG, LEBAK, BANTEN",16,11,249,260
https://kawalpemilu.org#52251,"CILADAEUN, LEBAKGEDONG, LEBAK, BANTEN",1,62,137,199
https://kawalpemilu.org#52251,"CILADAEUN, LEBAKGEDONG, LEBAK, BANTEN",2,39,158,197
https://kawalpemilu.org#52251,"CILADAEUN, LEBAKGEDONG, LEBAK, BANTEN",4,25,196,221
https://kawalpemilu.org#52251,"CILADAEUN, LEBAKGEDONG, LEBAK, BANTEN",5,57,143,200
https://kawalpemilu.org#52251,"CILADAEUN, LEBAKGEDONG, LEBAK, BANTEN",6,58,159,217
https://kawalpemilu.org#52251,"CILADAEUN, LEBAKGEDONG, LEBAK, BANTEN",7,41,182,223
https://kawalpemilu.org#52251,"CILADAEUN, LEBAKGEDONG, LEBAK, BANTEN",8,23,201,224
https://kawalpemilu.org#52251,"CILADAEUN, LEBAKGEDONG, LEBAK, BANTEN",9,10,237,247
https://kawalpemilu.org#52251,"CILADAEUN, LEBAKGEDONG, LEBAK, BANTEN",10,28,192,220
https://kawalpemilu.org#52252,"LEBAKGEDONG, LEBAKGEDONG, LEBAK, BANTEN",1,63,181,244
https://kawalpemilu.org#52252,"LEBAKGEDONG, LEBAKGEDONG, LEBAK, BANTEN",2,82,184,266
https://kawalpemilu.org#52252,"LEBAKGEDONG, LEBAKGEDONG, LEBAK, BANTEN",3,55,78,133
https://kawalpemilu.org#52252,"LEBAKGEDONG, LEBAKGEDONG, LEBAK, BANTEN",4,46,176,222
https://kawalpemilu.org#52252,"LEBAKGEDONG, LEBAKGEDONG, LEBAK, BANTEN",5,6,154,160
https://kawalpemilu.org#52252,"LEBAKGEDONG, LEBAKGEDONG, LEBAK, BANTEN",6,58,155,213
https://kawalpemilu.org#52252,"LEBAKGEDONG, LEBAKGEDONG, LEBAK, BANTEN",7,65,189,254
https://kawalpemilu.org#52252,"LEBAKGEDONG, LEBAKGEDONG, LEBAK, BANTEN",8,30,157,187
https://kawalpemilu.org#52252,"LEBAKGEDONG, LEBAKGEDONG, LEBAK, BANTEN",9,11,159,170
https://kawalpemilu.org#52252,"LEBAKGEDONG, LEBAKGEDONG, LEBAK, BANTEN",10,48,74,122
https://kawalpemilu.org#52253,"BANJARSARI, LEBAKGEDONG, LEBAK, BANTEN",1,4,95,99
https://kawalpemilu.org#52253,"BANJARSARI, LEBAKGEDONG, LEBAK, BANTEN",2,36,214,250
https://kawalpemilu.org#52253,"BANJARSARI, LEBAKGEDONG, LEBAK, BANTEN",3,138,96,234
https://kawalpemilu.org#52253,"BANJARSARI, LEBAKGEDONG, LEBAK, BANTEN",4,128,108,236
https://kawalpemilu.org#52253,"BANJARSARI, LEBAKGEDONG, LEBAK, BANTEN",5,58,124,182
https://kawalpemilu.org#52253,"BANJARSARI, LEBAKGEDONG, LEBAK, BANTEN",6,11,269,280
https://kawalpemilu.org#52253,"BANJARSARI, LEBAKGEDONG, LEBAK, BANTEN",7,85,139,224
https://kawalpemilu.org#52254,"LEBAKSITU, LEBAKGEDONG, LEBAK, BANTEN",1,18,221,239
https://kawalpemilu.org#52254,"LEBAKSITU, LEBAKGEDONG, LEBAK, BANTEN",2,89,155,244
https://kawalpemilu.org#52254,"LEBAKSITU, LEBAKGEDONG, LEBAK, BANTEN",3,97,164,261
https://kawalpemilu.org#52254,"LEBAKSITU, LEBAKGEDONG, LEBAK, BANTEN",4,36,204,240
https://kawalpemilu.org#52254,"LEBAKSITU, LEBAKGEDONG, LEBAK, BANTEN",5,107,115,222
https://kawalpemilu.org#52254,"LEBAKSITU, LEBAKGEDONG, LEBAK, BANTEN",6,25,151,176
https://kawalpemilu.org#52254,"LEBAKSITU, LEBAKGEDONG, LEBAK, BANTEN",7,53,217,270
https://kawalpemilu.org#52254,"LEBAKSITU, LEBAKGEDONG, LEBAK, BANTEN",8,107,131,238
https://kawalpemilu.org#52254,"LEBAKSITU, LEBAKGEDONG, LEBAK, BANTEN",9,47,95,142
https://kawalpemilu.org#52254,"LEBAKSITU, LEBAKGEDONG, LEBAK, BANTEN",10,95,61,156
https://kawalpemilu.org#52254,"LEBAKSITU, LEBAKGEDONG, LEBAK, BANTEN",11,15,118,133
https://kawalpemilu.org#52255,"LEBAKSANGKA, LEBAKGEDONG, LEBAK, BANTEN",1,25,202,227
https://kawalpemilu.org#52255,"LEBAKSANGKA, LEBAKGEDONG, LEBAK, BANTEN",2,32,195,227
https://kawalpemilu.org#52255,"LEBAKSANGKA, LEBAKGEDONG, LEBAK, BANTEN",3,42,206,248
https://kawalpemilu.org#52255,"LEBAKSANGKA, LEBAKGEDONG, LEBAK, BANTEN",4,47,139,186
https://kawalpemilu.org#52255,"LEBAKSANGKA, LEBAKGEDONG, LEBAK, BANTEN",5,37,194,231
https://kawalpemilu.org#52255,"LEBAKSANGKA, LEBAKGEDONG, LEBAK, BANTEN",6,30,195,225
https://kawalpemilu.org#52255,"LEBAKSANGKA, LEBAKGEDONG, LEBAK, BANTEN",7,32,177,209
https://kawalpemilu.org#52255,"LEBAKSANGKA, LEBAKGEDONG, LEBAK, BANTEN",8,60,98,158
https://kawalpemilu.org#52255,"LEBAKSANGKA, LEBAKGEDONG, LEBAK, BANTEN",9,114,82,196
https://kawalpemilu.org#52257,"PANYAUNGAN, CIHARA, LEBAK, BANTEN",1,81,76,157
https://kawalpemilu.org#52257,"PANYAUNGAN, CIHARA, LEBAK, BANTEN",2,85,126,211
https://kawalpemilu.org#52257,"PANYAUNGAN, CIHARA, LEBAK, BANTEN",3,111,88,3
https://kawalpemilu.org#52257,"PANYAUNGAN, CIHARA, LEBAK, BANTEN",4,46,97,143
https://kawalpemilu.org#52257,"PANYAUNGAN, CIHARA, LEBAK, BANTEN",5,88,95,183
https://kawalpemilu.org#52257,"PANYAUNGAN, CIHARA, LEBAK, BANTEN",6,57,134,191
https://kawalpemilu.org#52257,"PANYAUNGAN, CIHARA, LEBAK, BANTEN",7,123,100,223
https://kawalpemilu.org#52257,"PANYAUNGAN, CIHARA, LEBAK, BANTEN",8,84,117,201
https://kawalpemilu.org#52257,"PANYAUNGAN, CIHARA, LEBAK, BANTEN",9,101,24,125
https://kawalpemilu.org#52257,"PANYAUNGAN, CIHARA, LEBAK, BANTEN",10,100,78,178
https://kawalpemilu.org#52257,"PANYAUNGAN, CIHARA, LEBAK, BANTEN",11,53,127,180
https://kawalpemilu.org#52257,"PANYAUNGAN, CIHARA, LEBAK, BANTEN",12,52,112,164
https://kawalpemilu.org#52257,"PANYAUNGAN, CIHARA, LEBAK, BANTEN",13,135,66,201
https://kawalpemilu.org#52257,"PANYAUNGAN, CIHARA, LEBAK, BANTEN",14,58,52,110
https://kawalpemilu.org#52258,"CIHARA, CIHARA, LEBAK, BANTEN",1,50,110,160
https://kawalpemilu.org#52258,"CIHARA, CIHARA, LEBAK, BANTEN",2,49,139,188
https://kawalpemilu.org#52258,"CIHARA, CIHARA, LEBAK, BANTEN",3,137,65,202
https://kawalpemilu.org#52258,"CIHARA, CIHARA, LEBAK, BANTEN",4,52,125,177
https://kawalpemilu.org#52258,"CIHARA, CIHARA, LEBAK, BANTEN",5,67,138,205
https://kawalpemilu.org#52258,"CIHARA, CIHARA, LEBAK, BANTEN",6,49,53,102
https://kawalpemilu.org#52258,"CIHARA, CIHARA, LEBAK, BANTEN",7,47,106,153
https://kawalpemilu.org#52258,"CIHARA, CIHARA, LEBAK, BANTEN",8,114,54,168
https://kawalpemilu.org#52258,"CIHARA, CIHARA, LEBAK, BANTEN",9,128,52,180
https://kawalpemilu.org#52258,"CIHARA, CIHARA, LEBAK, BANTEN",10,58,110,168
https://kawalpemilu.org#52258,"CIHARA, CIHARA, LEBAK, BANTEN",11,74,68,142
https://kawalpemilu.org#52258,"CIHARA, CIHARA, LEBAK, BANTEN",12,30,88,118
https://kawalpemilu.org#52259,"CIPARAHU, CIHARA, LEBAK, BANTEN",1,51,125,176
https://kawalpemilu.org#52259,"CIPARAHU, CIHARA, LEBAK, BANTEN",2,105,113,218
https://kawalpemilu.org#52259,"CIPARAHU, CIHARA, LEBAK, BANTEN",3,68,99,167
https://kawalpemilu.org#52259,"CIPARAHU, CIHARA, LEBAK, BANTEN",4,131,74,205
https://kawalpemilu.org#52259,"CIPARAHU, CIHARA, LEBAK, BANTEN",5,83,74,157
https://kawalpemilu.org#52259,"CIPARAHU, CIHARA, LEBAK, BANTEN",6,59,95,154
https://kawalpemilu.org#52259,"CIPARAHU, CIHARA, LEBAK, BANTEN",7,118,68,186
https://kawalpemilu.org#52259,"CIPARAHU, CIHARA, LEBAK, BANTEN",8,106,74,180
https://kawalpemilu.org#52259,"CIPARAHU, CIHARA, LEBAK, BANTEN",9,48,68,116
https://kawalpemilu.org#52259,"CIPARAHU, CIHARA, LEBAK, BANTEN",10,70,75,145
https://kawalpemilu.org#52259,"CIPARAHU, CIHARA, LEBAK, BANTEN",11,48,112,160
https://kawalpemilu.org#52259,"CIPARAHU, CIHARA, LEBAK, BANTEN",12,58,77,135
https://kawalpemilu.org#52259,"CIPARAHU, CIHARA, LEBAK, BANTEN",13,69,98,167
https://kawalpemilu.org#52259,"CIPARAHU, CIHARA, LEBAK, BANTEN",14,18,138,156
https://kawalpemilu.org#52259,"CIPARAHU, CIHARA, LEBAK, BANTEN",15,77,95,172
https://kawalpemilu.org#52260,"PONDOKPANJANG, CIHARA, LEBAK, BANTEN",1,126,108,234
https://kawalpemilu.org#52260,"PONDOKPANJANG, CIHARA, LEBAK, BANTEN",2,176,41,217
https://kawalpemilu.org#52260,"PONDOKPANJANG, CIHARA, LEBAK, BANTEN",3,66,130,196
https://kawalpemilu.org#52260,"PONDOKPANJANG, CIHARA, LEBAK, BANTEN",4,133,52,185
https://kawalpemilu.org#52260,"PONDOKPANJANG, CIHARA, LEBAK, BANTEN",5,71,69,140
https://kawalpemilu.org#52260,"PONDOKPANJANG, CIHARA, LEBAK, BANTEN",6,59,169,228
https://kawalpemilu.org#52260,"PONDOKPANJANG, CIHARA, LEBAK, BANTEN",7,100,133,233
https://kawalpemilu.org#52260,"PONDOKPANJANG, CIHARA, LEBAK, BANTEN",8,97,130,227
https://kawalpemilu.org#52260,"PONDOKPANJANG, CIHARA, LEBAK, BANTEN",9,136,93,229
https://kawalpemilu.org#52260,"PONDOKPANJANG, CIHARA, LEBAK, BANTEN",10,107,116,223
https://kawalpemilu.org#52260,"PONDOKPANJANG, CIHARA, LEBAK, BANTEN",11,119,89,208
https://kawalpemilu.org#52260,"PONDOKPANJANG, CIHARA, LEBAK, BANTEN",12,92,77,169
https://kawalpemilu.org#52260,"PONDOKPANJANG, CIHARA, LEBAK, BANTEN",13,98,71,169
https://kawalpemilu.org#52260,"PONDOKPANJANG, CIHARA, LEBAK, BANTEN",14,73,68,141
https://kawalpemilu.org#52260,"PONDOKPANJANG, CIHARA, LEBAK, BANTEN",15,48,78,126
https://kawalpemilu.org#52261,"CITEUPUSEUN, CIHARA, LEBAK, BANTEN",1,92,115,207
https://kawalpemilu.org#52261,"CITEUPUSEUN, CIHARA, LEBAK, BANTEN",2,37,187,224
https://kawalpemilu.org#52261,"CITEUPUSEUN, CIHARA, LEBAK, BANTEN",3,26,134,160
https://kawalpemilu.org#52261,"CITEUPUSEUN, CIHARA, LEBAK, BANTEN",4,86,93,179
https://kawalpemilu.org#52261,"CITEUPUSEUN, CIHARA, LEBAK, BANTEN",5,92,104,196
https://kawalpemilu.org#52261,"CITEUPUSEUN, CIHARA, LEBAK, BANTEN",6,78,117,195
https://kawalpemilu.org#52261,"CITEUPUSEUN, CIHARA, LEBAK, BANTEN",7,92,100,192
https://kawalpemilu.org#52261,"CITEUPUSEUN, CIHARA, LEBAK, BANTEN",8,29,118,147
https://kawalpemilu.org#52262,"LEBAKPEUNDEUY, CIHARA, LEBAK, BANTEN",1,66,99,165
https://kawalpemilu.org#52262,"LEBAKPEUNDEUY, CIHARA, LEBAK, BANTEN",2,41,86,127
https://kawalpemilu.org#52262,"LEBAKPEUNDEUY, CIHARA, LEBAK, BANTEN",3,118,69,187
https://kawalpemilu.org#52262,"LEBAKPEUNDEUY, CIHARA, LEBAK, BANTEN",4,69,65,134
https://kawalpemilu.org#52262,"LEBAKPEUNDEUY, CIHARA, LEBAK, BANTEN",5,70,25,95
https://kawalpemilu.org#52262,"LEBAKPEUNDEUY, CIHARA, LEBAK, BANTEN",6,127,63,190
https://kawalpemilu.org#52262,"LEBAKPEUNDEUY, CIHARA, LEBAK, BANTEN",7,40,82,122
https://kawalpemilu.org#52262,"LEBAKPEUNDEUY, CIHARA, LEBAK, BANTEN",8,114,50,164
https://kawalpemilu.org#52262,"LEBAKPEUNDEUY, CIHARA, LEBAK, BANTEN",9,89,33,122
https://kawalpemilu.org#52263,"MEKARSARI, CIHARA, LEBAK, BANTEN",1,62,172,234
https://kawalpemilu.org#52263,"MEKARSARI, CIHARA, LEBAK, BANTEN",2,117,69,186
https://kawalpemilu.org#52263,"MEKARSARI, CIHARA, LEBAK, BANTEN",3,84,142,226
https://kawalpemilu.org#52263,"MEKARSARI, CIHARA, LEBAK, BANTEN",4,77,110,187
https://kawalpemilu.org#52263,"MEKARSARI, CIHARA, LEBAK, BANTEN",6,52,136,138
https://kawalpemilu.org#52263,"MEKARSARI, CIHARA, LEBAK, BANTEN",7,85,100,185
https://kawalpemilu.org#52263,"MEKARSARI, CIHARA, LEBAK, BANTEN",8,109,63,172
https://kawalpemilu.org#52263,"MEKARSARI, CIHARA, LEBAK, BANTEN",9,44,191,235
https://kawalpemilu.org#52263,"MEKARSARI, CIHARA, LEBAK, BANTEN",10,112,103,215
https://kawalpemilu.org#52263,"MEKARSARI, CIHARA, LEBAK, BANTEN",11,32,158,190
https://kawalpemilu.org#52263,"MEKARSARI, CIHARA, LEBAK, BANTEN",12,133,43,176
https://kawalpemilu.org#52264,"KARANGKAMULYAN, CIHARA, LEBAK, BANTEN",1,131,48,179
https://kawalpemilu.org#52264,"KARANGKAMULYAN, CIHARA, LEBAK, BANTEN",2,78,148,226
https://kawalpemilu.org#52264,"KARANGKAMULYAN, CIHARA, LEBAK, BANTEN",3,63,119,182
https://kawalpemilu.org#52264,"KARANGKAMULYAN, CIHARA, LEBAK, BANTEN",4,77,139,216
https://kawalpemilu.org#52264,"KARANGKAMULYAN, CIHARA, LEBAK, BANTEN",5,49,159,208
https://kawalpemilu.org#52264,"KARANGKAMULYAN, CIHARA, LEBAK, BANTEN",6,152,27,179
https://kawalpemilu.org#52264,"KARANGKAMULYAN, CIHARA, LEBAK, BANTEN",7,57,115,172
https://kawalpemilu.org#52264,"KARANGKAMULYAN, CIHARA, LEBAK, BANTEN",8,128,75,203
https://kawalpemilu.org#52264,"KARANGKAMULYAN, CIHARA, LEBAK, BANTEN",9,121,101,222
https://kawalpemilu.org#52264,"KARANGKAMULYAN, CIHARA, LEBAK, BANTEN",10,55,138,193
https://kawalpemilu.org#52264,"KARANGKAMULYAN, CIHARA, LEBAK, BANTEN",11,41,121,162
https://kawalpemilu.org#52265,"BARUNAI, CIHARA, LEBAK, BANTEN",1,78,78,156
https://kawalpemilu.org#52265,"BARUNAI, CIHARA, LEBAK, BANTEN",2,154,41,195
https://kawalpemilu.org#52265,"BARUNAI, CIHARA, LEBAK, BANTEN",3,173,27,200
https://kawalpemilu.org#52265,"BARUNAI, CIHARA, LEBAK, BANTEN",4,49,89,138
https://kawalpemilu.org#52265,"BARUNAI, CIHARA, LEBAK, BANTEN",5,93,60,153
https://kawalpemilu.org#52265,"BARUNAI, CIHARA, LEBAK, BANTEN",6,177,26,203
https://kawalpemilu.org#52265,"BARUNAI, CIHARA, LEBAK, BANTEN",7,163,69,232
https://kawalpemilu.org#52267,"DATARCAE, CIRINTEN, LEBAK, BANTEN",1,19,179,198
https://kawalpemilu.org#52267,"DATARCAE, CIRINTEN, LEBAK, BANTEN",2,28,169,197
https://kawalpemilu.org#52267,"DATARCAE, CIRINTEN, LEBAK, BANTEN",3,16,189,205
https://kawalpemilu.org#52267,"DATARCAE, CIRINTEN, LEBAK, BANTEN",4,38,162,200
https://kawalpemilu.org#52267,"DATARCAE, CIRINTEN, LEBAK, BANTEN",5,18,194,212
https://kawalpemilu.org#52267,"DATARCAE, CIRINTEN, LEBAK, BANTEN",6,24,105,129
https://kawalpemilu.org#52268,"CIRINTEN, CIRINTEN, LEBAK, BANTEN",1,37,181,218
https://kawalpemilu.org#52268,"CIRINTEN, CIRINTEN, LEBAK, BANTEN",2,20,194,214
https://kawalpemilu.org#52268,"CIRINTEN, CIRINTEN, LEBAK, BANTEN",3,27,214,241
https://kawalpemilu.org#52268,"CIRINTEN, CIRINTEN, LEBAK, BANTEN",4,31,127,158
https://kawalpemilu.org#52268,"CIRINTEN, CIRINTEN, LEBAK, BANTEN",5,50,152,202
https://kawalpemilu.org#52268,"CIRINTEN, CIRINTEN, LEBAK, BANTEN",6,31,173,204
https://kawalpemilu.org#52268,"CIRINTEN, CIRINTEN, LEBAK, BANTEN",7,42,138,180
https://kawalpemilu.org#52268,"CIRINTEN, CIRINTEN, LEBAK, BANTEN",8,57,55,112
https://kawalpemilu.org#52268,"CIRINTEN, CIRINTEN, LEBAK, BANTEN",9,70,87,157
https://kawalpemilu.org#52268,"CIRINTEN, CIRINTEN, LEBAK, BANTEN",10,23,107,130
https://kawalpemilu.org#52268,"CIRINTEN, CIRINTEN, LEBAK, BANTEN",11,86,92,178
https://kawalpemilu.org#52268,"CIRINTEN, CIRINTEN, LEBAK, BANTEN",12,28,135,163
https://kawalpemilu.org#52268,"CIRINTEN, CIRINTEN, LEBAK, BANTEN",13,37,80,117
https://kawalpemilu.org#52268,"CIRINTEN, CIRINTEN, LEBAK, BANTEN",14,120,68,188
https://kawalpemilu.org#52268,"CIRINTEN, CIRINTEN, LEBAK, BANTEN",15,51,171,222
https://kawalpemilu.org#52269,"KARANGNUNGGAL, CIRINTEN, LEBAK, BANTEN",1,21,200,221
https://kawalpemilu.org#52269,"KARANGNUNGGAL, CIRINTEN, LEBAK, BANTEN",2,29,176,205
https://kawalpemilu.org#52269,"KARANGNUNGGAL, CIRINTEN, LEBAK, BANTEN",3,89,87,176
https://kawalpemilu.org#52269,"KARANGNUNGGAL, CIRINTEN, LEBAK, BANTEN",4,37,181,218
https://kawalpemilu.org#52269,"KARANGNUNGGAL, CIRINTEN, LEBAK, BANTEN",5,50,150,200
https://kawalpemilu.org#52269,"KARANGNUNGGAL, CIRINTEN, LEBAK, BANTEN",6,58,129,187
https://kawalpemilu.org#52270,"KADUDAMAS, CIRINTEN, LEBAK, BANTEN",1,53,180,233
https://kawalpemilu.org#52270,"KADUDAMAS, CIRINTEN, LEBAK, BANTEN",2,53,120,173
https://kawalpemilu.org#52270,"KADUDAMAS, CIRINTEN, LEBAK, BANTEN",3,51,159,210
https://kawalpemilu.org#52270,"KADUDAMAS, CIRINTEN, LEBAK, BANTEN",4,34,114,148
https://kawalpemilu.org#52270,"KADUDAMAS, CIRINTEN, LEBAK, BANTEN",5,27,201,228
https://kawalpemilu.org#52270,"KADUDAMAS, CIRINTEN, LEBAK, BANTEN",6,26,195,221
https://kawalpemilu.org#52270,"KADUDAMAS, CIRINTEN, LEBAK, BANTEN",7,21,194,215
https://kawalpemilu.org#52270,"KADUDAMAS, CIRINTEN, LEBAK, BANTEN",8,19,185,204
https://kawalpemilu.org#52270,"KADUDAMAS, CIRINTEN, LEBAK, BANTEN",9,11,170,181
https://kawalpemilu.org#52270,"KADUDAMAS, CIRINTEN, LEBAK, BANTEN",10,23,70,93
https://kawalpemilu.org#52271,"BADUR, CIRINTEN, LEBAK, BANTEN",1,52,162,214
https://kawalpemilu.org#52271,"BADUR, CIRINTEN, LEBAK, BANTEN",2,44,142,186
https://kawalpemilu.org#52271,"BADUR, CIRINTEN, LEBAK, BANTEN",3,70,140,210
https://kawalpemilu.org#52271,"BADUR, CIRINTEN, LEBAK, BANTEN",4,45,170,215
https://kawalpemilu.org#52271,"BADUR, CIRINTEN, LEBAK, BANTEN",5,39,167,206
https://kawalpemilu.org#52271,"BADUR, CIRINTEN, LEBAK, BANTEN",6,24,171,195
https://kawalpemilu.org#52271,"BADUR, CIRINTEN, LEBAK, BANTEN",7,16,174,190
https://kawalpemilu.org#52271,"BADUR, CIRINTEN, LEBAK, BANTEN",8,22,166,188
https://kawalpemilu.org#52272,"PARAKANLIMA, CIRINTEN, LEBAK, BANTEN",1,10,185,195
https://kawalpemilu.org#52272,"PARAKANLIMA, CIRINTEN, LEBAK, BANTEN",2,16,191,207
https://kawalpemilu.org#52272,"PARAKANLIMA, CIRINTEN, LEBAK, BANTEN",3,14,118,132
https://kawalpemilu.org#52272,"PARAKANLIMA, CIRINTEN, LEBAK, BANTEN",4,30,137,167
https://kawalpemilu.org#52272,"PARAKANLIMA, CIRINTEN, LEBAK, BANTEN",5,40,168,208
https://kawalpemilu.org#52272,"PARAKANLIMA, CIRINTEN, LEBAK, BANTEN",6,16,218,234
https://kawalpemilu.org#52272,"PARAKANLIMA, CIRINTEN, LEBAK, BANTEN",7,25,166,191
https://kawalpemilu.org#52272,"PARAKANLIMA, CIRINTEN, LEBAK, BANTEN",8,18,141,159
https://kawalpemilu.org#52272,"PARAKANLIMA, CIRINTEN, LEBAK, BANTEN",9,67,68,135
https://kawalpemilu.org#52272,"PARAKANLIMA, CIRINTEN, LEBAK, BANTEN",10,71,123,194
https://kawalpemilu.org#52272,"PARAKANLIMA, CIRINTEN, LEBAK, BANTEN",11,87,109,196
https://kawalpemilu.org#52272,"PARAKANLIMA, CIRINTEN, LEBAK, BANTEN",12,14,137,151
https://kawalpemilu.org#52273,"NANGGERANG, CIRINTEN, LEBAK, BANTEN",1,45,143,188
https://kawalpemilu.org#52273,"NANGGERANG, CIRINTEN, LEBAK, BANTEN",2,91,126,217
https://kawalpemilu.org#52273,"NANGGERANG, CIRINTEN, LEBAK, BANTEN",3,83,118,201
https://kawalpemilu.org#52273,"NANGGERANG, CIRINTEN, LEBAK, BANTEN",4,40,177,217
https://kawalpemilu.org#52273,"NANGGERANG, CIRINTEN, LEBAK, BANTEN",5,42,122,164
https://kawalpemilu.org#52273,"NANGGERANG, CIRINTEN, LEBAK, BANTEN",6,36,199,235
https://kawalpemilu.org#52273,"NANGGERANG, CIRINTEN, LEBAK, BANTEN",7,123,101,224
https://kawalpemilu.org#52273,"NANGGERANG, CIRINTEN, LEBAK, BANTEN",8,105,124,229
https://kawalpemilu.org#52274,"CEMPAKA, CIRINTEN, LEBAK, BANTEN",1,32,147,179
https://kawalpemilu.org#52274,"CEMPAKA, CIRINTEN, LEBAK, BANTEN",2,14,185,199
https://kawalpemilu.org#52274,"CEMPAKA, CIRINTEN, LEBAK, BANTEN",3,30,155,185
https://kawalpemilu.org#52274,"CEMPAKA, CIRINTEN, LEBAK, BANTEN",4,35,174,209
https://kawalpemilu.org#52274,"CEMPAKA, CIRINTEN, LEBAK, BANTEN",5,26,179,205
https://kawalpemilu.org#52274,"CEMPAKA, CIRINTEN, LEBAK, BANTEN",6,53,144,197
https://kawalpemilu.org#52275,"KAROYA, CIRINTEN, LEBAK, BANTEN",1,35,183,218
https://kawalpemilu.org#52275,"KAROYA, CIRINTEN, LEBAK, BANTEN",2,36,184,220
https://kawalpemilu.org#52275,"KAROYA, CIRINTEN, LEBAK, BANTEN",3,82,122,204
https://kawalpemilu.org#52275,"KAROYA, CIRINTEN, LEBAK, BANTEN",4,67,147,214
https://kawalpemilu.org#52275,"KAROYA, CIRINTEN, LEBAK, BANTEN",5,75,140,215
https://kawalpemilu.org#52276,"CIBARANI, CIRINTEN, LEBAK, BANTEN",1,216,35,251
https://kawalpemilu.org#52276,"CIBARANI, CIRINTEN, LEBAK, BANTEN",2,143,57,200
https://kawalpemilu.org#52276,"CIBARANI, CIRINTEN, LEBAK, BANTEN",3,98,123,221
https://kawalpemilu.org#52276,"CIBARANI, CIRINTEN, LEBAK, BANTEN",4,48,116,164
https://kawalpemilu.org#52276,"CIBARANI, CIRINTEN, LEBAK, BANTEN",5,56,83,139
https://kawalpemilu.org#52276,"CIBARANI, CIRINTEN, LEBAK, BANTEN",6,67,83,150
https://kawalpemilu.org#52278,"PEUCANGPARI, CIGEMLONG, LEBAK, BANTEN",1,25,137,162
https://kawalpemilu.org#52278,"PEUCANGPARI, CIGEMLONG, LEBAK, BANTEN",2,25,159,184
https://kawalpemilu.org#52278,"PEUCANGPARI, CIGEMLONG, LEBAK, BANTEN",3,45,145,190
https://kawalpemilu.org#52278,"PEUCANGPARI, CIGEMLONG, LEBAK, BANTEN",4,25,141,166
https://kawalpemilu.org#52278,"PEUCANGPARI, CIGEMLONG, LEBAK, BANTEN",5,101,73,174
https://kawalpemilu.org#52278,"PEUCANGPARI, CIGEMLONG, LEBAK, BANTEN",6,41,101,142
https://kawalpemilu.org#52278,"PEUCANGPARI, CIGEMLONG, LEBAK, BANTEN",7,23,180,203
https://kawalpemilu.org#52278,"PEUCANGPARI, CIGEMLONG, LEBAK, BANTEN",8,44,124,168
https://kawalpemilu.org#52278,"PEUCANGPARI, CIGEMLONG, LEBAK, BANTEN",9,99,94,193
https://kawalpemilu.org#52278,"PEUCANGPARI, CIGEMLONG, LEBAK, BANTEN",10,107,72,179
https://kawalpemilu.org#52278,"PEUCANGPARI, CIGEMLONG, LEBAK, BANTEN",11,83,121,204
https://kawalpemilu.org#52278,"PEUCANGPARI, CIGEMLONG, LEBAK, BANTEN",12,26,68,94
https://kawalpemilu.org#52279,"CIBUNGUR, CIGEMLONG, LEBAK, BANTEN",1,60,164,224
https://kawalpemilu.org#52279,"CIBUNGUR, CIGEMLONG, LEBAK, BANTEN",2,132,42,174
https://kawalpemilu.org#52279,"CIBUNGUR, CIGEMLONG, LEBAK, BANTEN",3,25,98,123
https://kawalpemilu.org#52279,"CIBUNGUR, CIGEMLONG, LEBAK, BANTEN",4,34,161,195
https://kawalpemilu.org#52279,"CIBUNGUR, CIGEMLONG, LEBAK, BANTEN",5,89,147,236
https://kawalpemilu.org#52279,"CIBUNGUR, CIGEMLONG, LEBAK, BANTEN",6,141,32,173
https://kawalpemilu.org#52279,"CIBUNGUR, CIGEMLONG, LEBAK, BANTEN",7,121,23,144
https://kawalpemilu.org#52280,"MUGIJAYA, CIGEMLONG, LEBAK, BANTEN",1,32,177,209
https://kawalpemilu.org#52280,"MUGIJAYA, CIGEMLONG, LEBAK, BANTEN",2,36,157,193
https://kawalpemilu.org#52280,"MUGIJAYA, CIGEMLONG, LEBAK, BANTEN",3,44,197,241
https://kawalpemilu.org#52280,"MUGIJAYA, CIGEMLONG, LEBAK, BANTEN",4,28,139,167
https://kawalpemilu.org#52280,"MUGIJAYA, CIGEMLONG, LEBAK, BANTEN",5,45,111,156
https://kawalpemilu.org#52280,"MUGIJAYA, CIGEMLONG, LEBAK, BANTEN",6,128,71,199
https://kawalpemilu.org#52281,"CIKATE, CIGEMLONG, LEBAK, BANTEN",1,47,183,230
https://kawalpemilu.org#52281,"CIKATE, CIGEMLONG, LEBAK, BANTEN",2,83,144,227
https://kawalpemilu.org#52281,"CIKATE, CIGEMLONG, LEBAK, BANTEN",3,61,76,137
https://kawalpemilu.org#52281,"CIKATE, CIGEMLONG, LEBAK, BANTEN",4,134,98,232
https://kawalpemilu.org#52281,"CIKATE, CIGEMLONG, LEBAK, BANTEN",5,127,100,227
https://kawalpemilu.org#52281,"CIKATE, CIGEMLONG, LEBAK, BANTEN",6,91,102,193
https://kawalpemilu.org#52282,"CIGEMBLONG, CIGEMLONG, LEBAK, BANTEN",1,64,118,182
https://kawalpemilu.org#52282,"CIGEMBLONG, CIGEMLONG, LEBAK, BANTEN",2,70,131,201
https://kawalpemilu.org#52282,"CIGEMBLONG, CIGEMLONG, LEBAK, BANTEN",3,116,78,194
https://kawalpemilu.org#52282,"CIGEMBLONG, CIGEMLONG, LEBAK, BANTEN",4,122,97,219
https://kawalpemilu.org#52282,"CIGEMBLONG, CIGEMLONG, LEBAK, BANTEN",5,57,149,206
https://kawalpemilu.org#52282,"CIGEMBLONG, CIGEMLONG, LEBAK, BANTEN",6,68,137,205
https://kawalpemilu.org#52282,"CIGEMBLONG, CIGEMLONG, LEBAK, BANTEN",7,38,41,79
https://kawalpemilu.org#52282,"CIGEMBLONG, CIGEMLONG, LEBAK, BANTEN",8,91,124,215
https://kawalpemilu.org#52282,"CIGEMBLONG, CIGEMLONG, LEBAK, BANTEN",9,151,78,229
https://kawalpemilu.org#52283,"CIKADONGDONG, CIGEMLONG, LEBAK, BANTEN",1,124,41,165
https://kawalpemilu.org#52283,"CIKADONGDONG, CIGEMLONG, LEBAK, BANTEN",2,119,57,176
https://kawalpemilu.org#52283,"CIKADONGDONG, CIGEMLONG, LEBAK, BANTEN",3,106,132,238
https://kawalpemilu.org#52283,"CIKADONGDONG, CIGEMLONG, LEBAK, BANTEN",4,113,59,172
https://kawalpemilu.org#52283,"CIKADONGDONG, CIGEMLONG, LEBAK, BANTEN",5,78,62,140
https://kawalpemilu.org#52283,"CIKADONGDONG, CIGEMLONG, LEBAK, BANTEN",6,38,77,115
https://kawalpemilu.org#52283,"CIKADONGDONG, CIGEMLONG, LEBAK, BANTEN",7,103,42,145
https://kawalpemilu.org#52284,"CIKARET, CIGEMLONG, LEBAK, BANTEN",1,30,170,200
https://kawalpemilu.org#52284,"CIKARET, CIGEMLONG, LEBAK, BANTEN",2,32,106,138
https://kawalpemilu.org#52284,"CIKARET, CIGEMLONG, LEBAK, BANTEN",3,87,102,189
https://kawalpemilu.org#52284,"CIKARET, CIGEMLONG, LEBAK, BANTEN",4,47,143,190
https://kawalpemilu.org#52284,"CIKARET, CIGEMLONG, LEBAK, BANTEN",5,23,178,201
https://kawalpemilu.org#52284,"CIKARET, CIGEMLONG, LEBAK, BANTEN",6,30,130,160
https://kawalpemilu.org#52284,"CIKARET, CIGEMLONG, LEBAK, BANTEN",7,48,148,196
https://kawalpemilu.org#52284,"CIKARET, CIGEMLONG, LEBAK, BANTEN",8,60,89,149
https://kawalpemilu.org#52285,"WANGUNJAYA, CIGEMLONG, LEBAK, BANTEN",1,139,95,234
https://kawalpemilu.org#52285,"WANGUNJAYA, CIGEMLONG, LEBAK, BANTEN",2,92,116,208
https://kawalpemilu.org#52285,"WANGUNJAYA, CIGEMLONG, LEBAK, BANTEN",3,109,88,197
https://kawalpemilu.org#52285,"WANGUNJAYA, CIGEMLONG, LEBAK, BANTEN",4,174,21,195
https://kawalpemilu.org#52285,"WANGUNJAYA, CIGEMLONG, LEBAK, BANTEN",5,150,38,188
https://kawalpemilu.org#52285,"WANGUNJAYA, CIGEMLONG, LEBAK, BANTEN",6,160,22,182
https://kawalpemilu.org#52286,"CIKARATUAN, CIGEMLONG, LEBAK, BANTEN",1,111,121,232
https://kawalpemilu.org#52286,"CIKARATUAN, CIGEMLONG, LEBAK, BANTEN",2,32,130,162
https://kawalpemilu.org#52286,"CIKARATUAN, CIGEMLONG, LEBAK, BANTEN",3,98,100,198
https://kawalpemilu.org#52286,"CIKARATUAN, CIGEMLONG, LEBAK, BANTEN",4,39,113,152
https://kawalpemilu.org#52286,"CIKARATUAN, CIGEMLONG, LEBAK, BANTEN",5,52,125,177
https://kawalpemilu.org#52286,"CIKARATUAN, CIGEMLONG, LEBAK, BANTEN",6,27,141,168
https://kawalpemilu.org#52286,"CIKARATUAN, CIGEMLONG, LEBAK, BANTEN",7,25,123,148
https://kawalpemilu.org#52289,"BALARAJA, BALARAJA, TANGERANG, BANTEN",1,69,128,197
https://kawalpemilu.org#52289,"BALARAJA, BALARAJA, TANGERANG, BANTEN",2,78,117,195
https://kawalpemilu.org#52289,"BALARAJA, BALARAJA, TANGERANG, BANTEN",3,81,178,259
https://kawalpemilu.org#52289,"BALARAJA, BALARAJA, TANGERANG, BANTEN",4,64,105,169
https://kawalpemilu.org#52289,"BALARAJA, BALARAJA, TANGERANG, BANTEN",5,64,181,245
https://kawalpemilu.org#52289,"BALARAJA, BALARAJA, TANGERANG, BANTEN",6,57,135,192
https://kawalpemilu.org#52289,"BALARAJA, BALARAJA, TANGERANG, BANTEN",7,70,204,274
https://kawalpemilu.org#52289,"BALARAJA, BALARAJA, TANGERANG, BANTEN",8,67,109,176
https://kawalpemilu.org#52289,"BALARAJA, BALARAJA, TANGERANG, BANTEN",9,52,216,268
https://kawalpemilu.org#52289,"BALARAJA, BALARAJA, TANGERANG, BANTEN",10,73,124,197
https://kawalpemilu.org#52289,"BALARAJA, BALARAJA, TANGERANG, BANTEN",11,67,108,175
https://kawalpemilu.org#52289,"BALARAJA, BALARAJA, TANGERANG, BANTEN",12,69,137,206
https://kawalpemilu.org#52289,"BALARAJA, BALARAJA, TANGERANG, BANTEN",13,50,98,148
https://kawalpemilu.org#52289,"BALARAJA, BALARAJA, TANGERANG, BANTEN",14,58,156,214
https://kawalpemilu.org#52289,"BALARAJA, BALARAJA, TANGERANG, BANTEN",15,86,89,175
https://kawalpemilu.org#52289,"BALARAJA, BALARAJA, TANGERANG, BANTEN",16,77,120,197
https://kawalpemilu.org#52289,"BALARAJA, BALARAJA, TANGERANG, BANTEN",17,83,142,225
https://kawalpemilu.org#52289,"BALARAJA, BALARAJA, TANGERANG, BANTEN",18,65,183,248
https://kawalpemilu.org#52289,"BALARAJA, BALARAJA, TANGERANG, BANTEN",19,71,146,217
https://kawalpemilu.org#52289,"BALARAJA, BALARAJA, TANGERANG, BANTEN",20,30,121,151
https://kawalpemilu.org#52289,"BALARAJA, BALARAJA, TANGERANG, BANTEN",21,54,168,222
https://kawalpemilu.org#52289,"BALARAJA, BALARAJA, TANGERANG, BANTEN",22,46,117,163
https://kawalpemilu.org#52289,"BALARAJA, BALARAJA, TANGERANG, BANTEN",23,59,117,176
https://kawalpemilu.org#52289,"BALARAJA, BALARAJA, TANGERANG, BANTEN",24,73,182,255
https://kawalpemilu.org#52289,"BALARAJA, BALARAJA, TANGERANG, BANTEN",25,68,89,157
https://kawalpemilu.org#52289,"BALARAJA, BALARAJA, TANGERANG, BANTEN",26,75,138,213
https://kawalpemilu.org#52289,"BALARAJA, BALARAJA, TANGERANG, BANTEN",27,52,105,157
https://kawalpemilu.org#52289,"BALARAJA, BALARAJA, TANGERANG, BANTEN",28,50,167,217
https://kawalpemilu.org#52289,"BALARAJA, BALARAJA, TANGERANG, BANTEN",29,52,114,166
https://kawalpemilu.org#52290,"CANGKUDU, BALARAJA, TANGERANG, BANTEN",1,37,154,191
https://kawalpemilu.org#52290,"CANGKUDU, BALARAJA, TANGERANG, BANTEN",2,27,125,152
https://kawalpemilu.org#52290,"CANGKUDU, BALARAJA, TANGERANG, BANTEN",3,40,168,208
https://kawalpemilu.org#52290,"CANGKUDU, BALARAJA, TANGERANG, BANTEN",4,84,144,228
https://kawalpemilu.org#52290,"CANGKUDU, BALARAJA, TANGERANG, BANTEN",6,62,119,181
https://kawalpemilu.org#52290,"CANGKUDU, BALARAJA, TANGERANG, BANTEN",7,30,124,154
https://kawalpemilu.org#52290,"CANGKUDU, BALARAJA, TANGERANG, BANTEN",8,101,163,264
https://kawalpemilu.org#52290,"CANGKUDU, BALARAJA, TANGERANG, BANTEN",9,52,124,176
https://kawalpemilu.org#52290,"CANGKUDU, BALARAJA, TANGERANG, BANTEN",10,61,131,192
https://kawalpemilu.org#52290,"CANGKUDU, BALARAJA, TANGERANG, BANTEN",11,56,165,221
https://kawalpemilu.org#52290,"CANGKUDU, BALARAJA, TANGERANG, BANTEN",12,97,99,196
https://kawalpemilu.org#52290,"CANGKUDU, BALARAJA, TANGERANG, BANTEN",13,82,142,224
https://kawalpemilu.org#52290,"CANGKUDU, BALARAJA, TANGERANG, BANTEN",15,52,134,186
https://kawalpemilu.org#52290,"CANGKUDU, BALARAJA, TANGERANG, BANTEN",16,63,136,199
https://kawalpemilu.org#52290,"CANGKUDU, BALARAJA, TANGERANG, BANTEN",17,62,110,172
https://kawalpemilu.org#52290,"CANGKUDU, BALARAJA, TANGERANG, BANTEN",18,39,143,182
https://kawalpemilu.org#52290,"CANGKUDU, BALARAJA, TANGERANG, BANTEN",19,83,120,203
https://kawalpemilu.org#52290,"CANGKUDU, BALARAJA, TANGERANG, BANTEN",21,77,124,201
https://kawalpemilu.org#52290,"CANGKUDU, BALARAJA, TANGERANG, BANTEN",22,105,157,262
https://kawalpemilu.org#52290,"CANGKUDU, BALARAJA, TANGERANG, BANTEN",23,93,156,249
https://kawalpemilu.org#52290,"CANGKUDU, BALARAJA, TANGERANG, BANTEN",24,64,91,155
https://kawalpemilu.org#52290,"CANGKUDU, BALARAJA, TANGERANG, BANTEN",25,88,114,202
https://kawalpemilu.org#52290,"CANGKUDU, BALARAJA, TANGERANG, BANTEN",26,104,111,215
https://kawalpemilu.org#52290,"CANGKUDU, BALARAJA, TANGERANG, BANTEN",27,31,130,161
https://kawalpemilu.org#52290,"CANGKUDU, BALARAJA, TANGERANG, BANTEN",28,32,125,157
https://kawalpemilu.org#52290,"CANGKUDU, BALARAJA, TANGERANG, BANTEN",29,57,148,205
https://kawalpemilu.org#52290,"CANGKUDU, BALARAJA, TANGERANG, BANTEN",30,70,83,153
https://kawalpemilu.org#52290,"CANGKUDU, BALARAJA, TANGERANG, BANTEN",31,81,102,183
https://kawalpemilu.org#52290,"CANGKUDU, BALARAJA, TANGERANG, BANTEN",32,26,107,133
https://kawalpemilu.org#52290,"CANGKUDU, BALARAJA, TANGERANG, BANTEN",33,89,151,240
https://kawalpemilu.org#52290,"CANGKUDU, BALARAJA, TANGERANG, BANTEN",34,60,170,230
https://kawalpemilu.org#52290,"CANGKUDU, BALARAJA, TANGERANG, BANTEN",35,70,92,162
https://kawalpemilu.org#52290,"CANGKUDU, BALARAJA, TANGERANG, BANTEN",36,65,122,187
https://kawalpemilu.org#52290,"CANGKUDU, BALARAJA, TANGERANG, BANTEN",37,70,141,211
https://kawalpemilu.org#52290,"CANGKUDU, BALARAJA, TANGERANG, BANTEN",39,45,138,183
https://kawalpemilu.org#52290,"CANGKUDU, BALARAJA, TANGERANG, BANTEN",40,64,86,150
https://kawalpemilu.org#52290,"CANGKUDU, BALARAJA, TANGERANG, BANTEN",41,78,118,196
https://kawalpemilu.org#52290,"CANGKUDU, BALARAJA, TANGERANG, BANTEN",42,116,133,249
https://kawalpemilu.org#52290,"CANGKUDU, BALARAJA, TANGERANG, BANTEN",43,74,89,163
https://kawalpemilu.org#52290,"CANGKUDU, BALARAJA, TANGERANG, BANTEN",44,113,173,286
https://kawalpemilu.org#52290,"CANGKUDU, BALARAJA, TANGERANG, BANTEN",45,86,89,175
https://kawalpemilu.org#52290,"CANGKUDU, BALARAJA, TANGERANG, BANTEN",46,84,127,211
https://kawalpemilu.org#52291,"TALAGASARI, BALARAJA, TANGERANG, BANTEN",1,56,143,199
https://kawalpemilu.org#52291,"TALAGASARI, BALARAJA, TANGERANG, BANTEN",2,50,146,196
https://kawalpemilu.org#52291,"TALAGASARI, BALARAJA, TANGERANG, BANTEN",3,49,134,183
https://kawalpemilu.org#52291,"TALAGASARI, BALARAJA, TANGERANG, BANTEN",4,106,142,248
https://kawalpemilu.org#52291,"TALAGASARI, BALARAJA, TANGERANG, BANTEN",5,83,97,180
https://kawalpemilu.org#52291,"TALAGASARI, BALARAJA, TANGERANG, BANTEN",6,73,132,205
https://kawalpemilu.org#52291,"TALAGASARI, BALARAJA, TANGERANG, BANTEN",7,55,135,190
https://kawalpemilu.org#52291,"TALAGASARI, BALARAJA, TANGERANG, BANTEN",8,28,157,185
https://kawalpemilu.org#52291,"TALAGASARI, BALARAJA, TANGERANG, BANTEN",10,45,152,197
https://kawalpemilu.org#52291,"TALAGASARI, BALARAJA, TANGERANG, BANTEN",11,59,133,192
https://kawalpemilu.org#52291,"TALAGASARI, BALARAJA, TANGERANG, BANTEN",12,49,159,208
https://kawalpemilu.org#52291,"TALAGASARI, BALARAJA, TANGERANG, BANTEN",13,69,171,240
https://kawalpemilu.org#52291,"TALAGASARI, BALARAJA, TANGERANG, BANTEN",14,71,125,196
https://kawalpemilu.org#52291,"TALAGASARI, BALARAJA, TANGERANG, BANTEN",15,83,97,180
https://kawalpemilu.org#52291,"TALAGASARI, BALARAJA, TANGERANG, BANTEN",16,62,109,171
https://kawalpemilu.org#52291,"TALAGASARI, BALARAJA, TANGERANG, BANTEN",17,52,120,172
https://kawalpemilu.org#52291,"TALAGASARI, BALARAJA, TANGERANG, BANTEN",18,32,108,140
https://kawalpemilu.org#52291,"TALAGASARI, BALARAJA, TANGERANG, BANTEN",19,65,121,186
https://kawalpemilu.org#52291,"TALAGASARI, BALARAJA, TANGERANG, BANTEN",20,54,132,186
https://kawalpemilu.org#52291,"TALAGASARI, BALARAJA, TANGERANG, BANTEN",21,43,143,186
https://kawalpemilu.org#52291,"TALAGASARI, BALARAJA, TANGERANG, BANTEN",22,77,141,5
https://kawalpemilu.org#52291,"TALAGASARI, BALARAJA, TANGERANG, BANTEN",23,52,142,194
https://kawalpemilu.org#52291,"TALAGASARI, BALARAJA, TANGERANG, BANTEN",24,52,134,186
https://kawalpemilu.org#52291,"TALAGASARI, BALARAJA, TANGERANG, BANTEN",25,72,131,203
https://kawalpemilu.org#52291,"TALAGASARI, BALARAJA, TANGERANG, BANTEN",26,68,171,239
https://kawalpemilu.org#52292,"TOBAT, BALARAJA, TANGERANG, BANTEN",1,63,129,192
https://kawalpemilu.org#52292,"TOBAT, BALARAJA, TANGERANG, BANTEN",2,62,106,168
https://kawalpemilu.org#52292,"TOBAT, BALARAJA, TANGERANG, BANTEN",3,82,144,226
https://kawalpemilu.org#52292,"TOBAT, BALARAJA, TANGERANG, BANTEN",4,23,114,137
https://kawalpemilu.org#52292,"TOBAT, BALARAJA, TANGERANG, BANTEN",5,61,138,199
https://kawalpemilu.org#52292,"TOBAT, BALARAJA, TANGERANG, BANTEN",6,85,153,238
https://kawalpemilu.org#52292,"TOBAT, BALARAJA, TANGERANG, BANTEN",7,55,182,237
https://kawalpemilu.org#52292,"TOBAT, BALARAJA, TANGERANG, BANTEN",8,61,150,211
https://kawalpemilu.org#52292,"TOBAT, BALARAJA, TANGERANG, BANTEN",9,56,177,233
https://kawalpemilu.org#52292,"TOBAT, BALARAJA, TANGERANG, BANTEN",10,70,153,223
https://kawalpemilu.org#52292,"TOBAT, BALARAJA, TANGERANG, BANTEN",11,44,87,131
https://kawalpemilu.org#52292,"TOBAT, BALARAJA, TANGERANG, BANTEN",12,50,94,144
https://kawalpemilu.org#52292,"TOBAT, BALARAJA, TANGERANG, BANTEN",13,31,153,184
https://kawalpemilu.org#52292,"TOBAT, BALARAJA, TANGERANG, BANTEN",14,64,91,155
https://kawalpemilu.org#52292,"TOBAT, BALARAJA, TANGERANG, BANTEN",15,53,119,172
https://kawalpemilu.org#52292,"TOBAT, BALARAJA, TANGERANG, BANTEN",17,62,100,162
https://kawalpemilu.org#52292,"TOBAT, BALARAJA, TANGERANG, BANTEN",18,59,137,196
https://kawalpemilu.org#52292,"TOBAT, BALARAJA, TANGERANG, BANTEN",19,43,207,250
https://kawalpemilu.org#52292,"TOBAT, BALARAJA, TANGERANG, BANTEN",20,34,115,149
https://kawalpemilu.org#52292,"TOBAT, BALARAJA, TANGERANG, BANTEN",21,52,155,207
https://kawalpemilu.org#52292,"TOBAT, BALARAJA, TANGERANG, BANTEN",22,70,151,221
https://kawalpemilu.org#52292,"TOBAT, BALARAJA, TANGERANG, BANTEN",23,68,128,196
https://kawalpemilu.org#52292,"TOBAT, BALARAJA, TANGERANG, BANTEN",24,44,128,172
https://kawalpemilu.org#52292,"TOBAT, BALARAJA, TANGERANG, BANTEN",25,72,129,201
https://kawalpemilu.org#52292,"TOBAT, BALARAJA, TANGERANG, BANTEN",26,109,126,235
https://kawalpemilu.org#52292,"TOBAT, BALARAJA, TANGERANG, BANTEN",27,42,103,145
https://kawalpemilu.org#52292,"TOBAT, BALARAJA, TANGERANG, BANTEN",28,51,112,163
https://kawalpemilu.org#52292,"TOBAT, BALARAJA, TANGERANG, BANTEN",29,74,151,225
https://kawalpemilu.org#52292,"TOBAT, BALARAJA, TANGERANG, BANTEN",30,62,179,241
https://kawalpemilu.org#52292,"TOBAT, BALARAJA, TANGERANG, BANTEN",31,65,144,209
https://kawalpemilu.org#52292,"TOBAT, BALARAJA, TANGERANG, BANTEN",32,84,145,229
https://kawalpemilu.org#52292,"TOBAT, BALARAJA, TANGERANG, BANTEN",33,79,135,214
https://kawalpemilu.org#52292,"TOBAT, BALARAJA, TANGERANG, BANTEN",34,42,101,143
https://kawalpemilu.org#52292,"TOBAT, BALARAJA, TANGERANG, BANTEN",35,39,125,164
https://kawalpemilu.org#52292,"TOBAT, BALARAJA, TANGERANG, BANTEN",36,76,107,183
https://kawalpemilu.org#52292,"TOBAT, BALARAJA, TANGERANG, BANTEN",38,43,101,144
https://kawalpemilu.org#52292,"TOBAT, BALARAJA, TANGERANG, BANTEN",39,55,138,193
https://kawalpemilu.org#52292,"TOBAT, BALARAJA, TANGERANG, BANTEN",40,64,145,209
https://kawalpemilu.org#52292,"TOBAT, BALARAJA, TANGERANG, BANTEN",41,45,119,164
https://kawalpemilu.org#52292,"TOBAT, BALARAJA, TANGERANG, BANTEN",42,48,108,156
https://kawalpemilu.org#52292,"TOBAT, BALARAJA, TANGERANG, BANTEN",43,41,98,139
https://kawalpemilu.org#52292,"TOBAT, BALARAJA, TANGERANG, BANTEN",44,76,124,200
https://kawalpemilu.org#52292,"TOBAT, BALARAJA, TANGERANG, BANTEN",45,60,120,180
https://kawalpemilu.org#52293,"SENTUL, BALARAJA, TANGERANG, BANTEN",1,61,136,197
https://kawalpemilu.org#52293,"SENTUL, BALARAJA, TANGERANG, BANTEN",2,43,135,178
https://kawalpemilu.org#52293,"SENTUL, BALARAJA, TANGERANG, BANTEN",3,46,139,185
https://kawalpemilu.org#52293,"SENTUL, BALARAJA, TANGERANG, BANTEN",4,57,98,155
https://kawalpemilu.org#52293,"SENTUL, BALARAJA, TANGERANG, BANTEN",5,46,138,184
https://kawalpemilu.org#52293,"SENTUL, BALARAJA, TANGERANG, BANTEN",6,44,122,166
https://kawalpemilu.org#52293,"SENTUL, BALARAJA, TANGERANG, BANTEN",8,61,164,225
https://kawalpemilu.org#52293,"SENTUL, BALARAJA, TANGERANG, BANTEN",9,49,123,172
https://kawalpemilu.org#52293,"SENTUL, BALARAJA, TANGERANG, BANTEN",10,62,115,177
https://kawalpemilu.org#52293,"SENTUL, BALARAJA, TANGERANG, BANTEN",11,83,200,283
https://kawalpemilu.org#52293,"SENTUL, BALARAJA, TANGERANG, BANTEN",12,87,162,249
https://kawalpemilu.org#52293,"SENTUL, BALARAJA, TANGERANG, BANTEN",13,85,129,214
https://kawalpemilu.org#52293,"SENTUL, BALARAJA, TANGERANG, BANTEN",14,97,154,251
https://kawalpemilu.org#52293,"SENTUL, BALARAJA, TANGERANG, BANTEN",15,68,102,170
https://kawalpemilu.org#52293,"SENTUL, BALARAJA, TANGERANG, BANTEN",16,73,153,226
https://kawalpemilu.org#52293,"SENTUL, BALARAJA, TANGERANG, BANTEN",17,52,159,211
https://kawalpemilu.org#52293,"SENTUL, BALARAJA, TANGERANG, BANTEN",18,71,117,188
https://kawalpemilu.org#52293,"SENTUL, BALARAJA, TANGERANG, BANTEN",19,41,120,161
https://kawalpemilu.org#52293,"SENTUL, BALARAJA, TANGERANG, BANTEN",20,52,131,183
https://kawalpemilu.org#52293,"SENTUL, BALARAJA, TANGERANG, BANTEN",21,39,119,158
https://kawalpemilu.org#52293,"SENTUL, BALARAJA, TANGERANG, BANTEN",22,57,125,182
https://kawalpemilu.org#52293,"SENTUL, BALARAJA, TANGERANG, BANTEN",23,58,136,194
https://kawalpemilu.org#52293,"SENTUL, BALARAJA, TANGERANG, BANTEN",24,44,126,170
https://kawalpemilu.org#52293,"SENTUL, BALARAJA, TANGERANG, BANTEN",25,40,150,190
https://kawalpemilu.org#52293,"SENTUL, BALARAJA, TANGERANG, BANTEN",26,34,124,158
https://kawalpemilu.org#52293,"SENTUL, BALARAJA, TANGERANG, BANTEN",28,81,115,196
https://kawalpemilu.org#52293,"SENTUL, BALARAJA, TANGERANG, BANTEN",29,82,138,220
https://kawalpemilu.org#52293,"SENTUL, BALARAJA, TANGERANG, BANTEN",30,60,112,172
https://kawalpemilu.org#52293,"SENTUL, BALARAJA, TANGERANG, BANTEN",31,45,161,206
https://kawalpemilu.org#52294,"GEMBONG, BALARAJA, TANGERANG, BANTEN",1,59,118,177
https://kawalpemilu.org#52294,"GEMBONG, BALARAJA, TANGERANG, BANTEN",2,50,150,200
https://kawalpemilu.org#52294,"GEMBONG, BALARAJA, TANGERANG, BANTEN",3,57,93,150
https://kawalpemilu.org#52294,"GEMBONG, BALARAJA, TANGERANG, BANTEN",4,57,134,191
https://kawalpemilu.org#52294,"GEMBONG, BALARAJA, TANGERANG, BANTEN",5,56,149,205
https://kawalpemilu.org#52294,"GEMBONG, BALARAJA, TANGERANG, BANTEN",6,76,82,158
https://kawalpemilu.org#52294,"GEMBONG, BALARAJA, TANGERANG, BANTEN",7,68,133,201
https://kawalpemilu.org#52294,"GEMBONG, BALARAJA, TANGERANG, BANTEN",8,47,147,194
https://kawalpemilu.org#52294,"GEMBONG, BALARAJA, TANGERANG, BANTEN",9,50,199,249
https://kawalpemilu.org#52294,"GEMBONG, BALARAJA, TANGERANG, BANTEN",10,57,146,203
https://kawalpemilu.org#52294,"GEMBONG, BALARAJA, TANGERANG, BANTEN",11,69,136,205
https://kawalpemilu.org#52294,"GEMBONG, BALARAJA, TANGERANG, BANTEN",12,46,154,200
https://kawalpemilu.org#52294,"GEMBONG, BALARAJA, TANGERANG, BANTEN",13,54,141,195
https://kawalpemilu.org#52294,"GEMBONG, BALARAJA, TANGERANG, BANTEN",14,34,134,168
https://kawalpemilu.org#52294,"GEMBONG, BALARAJA, TANGERANG, BANTEN",15,60,147,207
https://kawalpemilu.org#52294,"GEMBONG, BALARAJA, TANGERANG, BANTEN",16,71,144,215
https://kawalpemilu.org#52294,"GEMBONG, BALARAJA, TANGERANG, BANTEN",17,52,118,175
https://kawalpemilu.org#52294,"GEMBONG, BALARAJA, TANGERANG, BANTEN",18,82,118,200
https://kawalpemilu.org#52294,"GEMBONG, BALARAJA, TANGERANG, BANTEN",19,61,152,213
https://kawalpemilu.org#52294,"GEMBONG, BALARAJA, TANGERANG, BANTEN",20,49,127,176
https://kawalpemilu.org#52294,"GEMBONG, BALARAJA, TANGERANG, BANTEN",21,50,134,184
https://kawalpemilu.org#52294,"GEMBONG, BALARAJA, TANGERANG, BANTEN",22,47,140,187
https://kawalpemilu.org#52294,"GEMBONG, BALARAJA, TANGERANG, BANTEN",23,40,132,172
https://kawalpemilu.org#52294,"GEMBONG, BALARAJA, TANGERANG, BANTEN",24,53,84,137
https://kawalpemilu.org#52294,"GEMBONG, BALARAJA, TANGERANG, BANTEN",25,57,147,204
https://kawalpemilu.org#52294,"GEMBONG, BALARAJA, TANGERANG, BANTEN",26,80,118,198
https://kawalpemilu.org#52294,"GEMBONG, BALARAJA, TANGERANG, BANTEN",27,43,135,178
https://kawalpemilu.org#52294,"GEMBONG, BALARAJA, TANGERANG, BANTEN",28,36,141,171
https://kawalpemilu.org#52294,"GEMBONG, BALARAJA, TANGERANG, BANTEN",29,22,142,164
https://kawalpemilu.org#52294,"GEMBONG, BALARAJA, TANGERANG, BANTEN",30,47,155,202
https://kawalpemilu.org#52294,"GEMBONG, BALARAJA, TANGERANG, BANTEN",31,44,156,200
https://kawalpemilu.org#52294,"GEMBONG, BALARAJA, TANGERANG, BANTEN",32,54,134,188
https://kawalpemilu.org#52294,"GEMBONG, BALARAJA, TANGERANG, BANTEN",33,44,162,206
https://kawalpemilu.org#52294,"GEMBONG, BALARAJA, TANGERANG, BANTEN",34,44,137,181
https://kawalpemilu.org#52294,"GEMBONG, BALARAJA, TANGERANG, BANTEN",35,85,119,204
https://kawalpemilu.org#52294,"GEMBONG, BALARAJA, TANGERANG, BANTEN",36,58,96,154
https://kawalpemilu.org#52294,"GEMBONG, BALARAJA, TANGERANG, BANTEN",37,69,157,226
https://kawalpemilu.org#52294,"GEMBONG, BALARAJA, TANGERANG, BANTEN",38,36,101,137
https://kawalpemilu.org#52294,"GEMBONG, BALARAJA, TANGERANG, BANTEN",39,71,74,145
https://kawalpemilu.org#52295,"SUKAMURNI, BALARAJA, TANGERANG, BANTEN",1,49,115,164
https://kawalpemilu.org#52295,"SUKAMURNI, BALARAJA, TANGERANG, BANTEN",2,65,123,188
https://kawalpemilu.org#52295,"SUKAMURNI, BALARAJA, TANGERANG, BANTEN",3,78,157,235
https://kawalpemilu.org#52295,"SUKAMURNI, BALARAJA, TANGERANG, BANTEN",4,88,187,275
https://kawalpemilu.org#52295,"SUKAMURNI, BALARAJA, TANGERANG, BANTEN",5,61,156,217
https://kawalpemilu.org#52295,"SUKAMURNI, BALARAJA, TANGERANG, BANTEN",6,41,170,211
https://kawalpemilu.org#52295,"SUKAMURNI, BALARAJA, TANGERANG, BANTEN",7,33,129,168
https://kawalpemilu.org#52295,"SUKAMURNI, BALARAJA, TANGERANG, BANTEN",8,36,146,182
https://kawalpemilu.org#52295,"SUKAMURNI, BALARAJA, TANGERANG, BANTEN",9,52,129,181
https://kawalpemilu.org#52295,"SUKAMURNI, BALARAJA, TANGERANG, BANTEN",10,68,161,229
https://kawalpemilu.org#52295,"SUKAMURNI, BALARAJA, TANGERANG, BANTEN",11,32,159,191
https://kawalpemilu.org#52295,"SUKAMURNI, BALARAJA, TANGERANG, BANTEN",12,84,166,250
https://kawalpemilu.org#52295,"SUKAMURNI, BALARAJA, TANGERANG, BANTEN",13,73,101,174
https://kawalpemilu.org#52295,"SUKAMURNI, BALARAJA, TANGERANG, BANTEN",14,51,139,190
https://kawalpemilu.org#52295,"SUKAMURNI, BALARAJA, TANGERANG, BANTEN",15,75,94,169
https://kawalpemilu.org#52295,"SUKAMURNI, BALARAJA, TANGERANG, BANTEN",16,36,127,163
https://kawalpemilu.org#52295,"SUKAMURNI, BALARAJA, TANGERANG, BANTEN",18,98,123,221
https://kawalpemilu.org#52295,"SUKAMURNI, BALARAJA, TANGERANG, BANTEN",19,62,126,188
https://kawalpemilu.org#52295,"SUKAMURNI, BALARAJA, TANGERANG, BANTEN",20,41,123,144
https://kawalpemilu.org#52295,"SUKAMURNI, BALARAJA, TANGERANG, BANTEN",21,50,120,170
https://kawalpemilu.org#52295,"SUKAMURNI, BALARAJA, TANGERANG, BANTEN",22,37,116,153
https://kawalpemilu.org#52296,"SAGA, BALARAJA, TANGERANG, BANTEN",1,55,110,165
https://kawalpemilu.org#52296,"SAGA, BALARAJA, TANGERANG, BANTEN",2,62,187,249
https://kawalpemilu.org#52296,"SAGA, BALARAJA, TANGERANG, BANTEN",3,27,171,198
https://kawalpemilu.org#52296,"SAGA, BALARAJA, TANGERANG, BANTEN",4,93,132,225
https://kawalpemilu.org#52296,"SAGA, BALARAJA, TANGERANG, BANTEN",5,42,174,216
https://kawalpemilu.org#52296,"SAGA, BALARAJA, TANGERANG, BANTEN",6,80,126,206
https://kawalpemilu.org#52296,"SAGA, BALARAJA, TANGERANG, BANTEN",7,74,133,207
https://kawalpemilu.org#52296,"SAGA, BALARAJA, TANGERANG, BANTEN",8,58,98,156
https://kawalpemilu.org#52296,"SAGA, BALARAJA, TANGERANG, BANTEN",9,43,239,282
https://kawalpemilu.org#52296,"SAGA, BALARAJA, TANGERANG, BANTEN",10,67,215,282
https://kawalpemilu.org#52296,"SAGA, BALARAJA, TANGERANG, BANTEN",11,41,190,231
https://kawalpemilu.org#52296,"SAGA, BALARAJA, TANGERANG, BANTEN",12,130,166,296
https://kawalpemilu.org#52296,"SAGA, BALARAJA, TANGERANG, BANTEN",13,59,162,221
https://kawalpemilu.org#52296,"SAGA, BALARAJA, TANGERANG, BANTEN",14,57,184,241
https://kawalpemilu.org#52296,"SAGA, BALARAJA, TANGERANG, BANTEN",15,75,181,256
https://kawalpemilu.org#52296,"SAGA, BALARAJA, TANGERANG, BANTEN",16,76,167,243
https://kawalpemilu.org#52296,"SAGA, BALARAJA, TANGERANG, BANTEN",17,86,145,231
https://kawalpemilu.org#52296,"SAGA, BALARAJA, TANGERANG, BANTEN",18,93,122,215
https://kawalpemilu.org#52296,"SAGA, BALARAJA, TANGERANG, BANTEN",19,96,135,231
https://kawalpemilu.org#52296,"SAGA, BALARAJA, TANGERANG, BANTEN",20,47,172,219
https://kawalpemilu.org#52296,"SAGA, BALARAJA, TANGERANG, BANTEN",21,91,148,239
https://kawalpemilu.org#52296,"SAGA, BALARAJA, TANGERANG, BANTEN",22,91,145,236
https://kawalpemilu.org#52296,"SAGA, BALARAJA, TANGERANG, BANTEN",23,63,164,227
https://kawalpemilu.org#52296,"SAGA, BALARAJA, TANGERANG, BANTEN",24,86,132,218
https://kawalpemilu.org#52296,"SAGA, BALARAJA, TANGERANG, BANTEN",25,103,136,239
https://kawalpemilu.org#52296,"SAGA, BALARAJA, TANGERANG, BANTEN",26,81,118,199
https://kawalpemilu.org#52296,"SAGA, BALARAJA, TANGERANG, BANTEN",27,104,115,219
https://kawalpemilu.org#52296,"SAGA, BALARAJA, TANGERANG, BANTEN",28,51,113,164
https://kawalpemilu.org#52296,"SAGA, BALARAJA, TANGERANG, BANTEN",29,95,128,223
https://kawalpemilu.org#52296,"SAGA, BALARAJA, TANGERANG, BANTEN",30,107,105,212
https://kawalpemilu.org#52296,"SAGA, BALARAJA, TANGERANG, BANTEN",32,63,135,198
https://kawalpemilu.org#52296,"SAGA, BALARAJA, TANGERANG, BANTEN",33,106,210,316
https://kawalpemilu.org#52296,"SAGA, BALARAJA, TANGERANG, BANTEN",34,88,141,229
https://kawalpemilu.org#52296,"SAGA, BALARAJA, TANGERANG, BANTEN",35,89,120,209
https://kawalpemilu.org#52296,"SAGA, BALARAJA, TANGERANG, BANTEN",36,106,138,244
https://kawalpemilu.org#52296,"SAGA, BALARAJA, TANGERANG, BANTEN",37,90,99,189
https://kawalpemilu.org#52296,"SAGA, BALARAJA, TANGERANG, BANTEN",38,67,117,184
https://kawalpemilu.org#52296,"SAGA, BALARAJA, TANGERANG, BANTEN",39,120,106,226
https://kawalpemilu.org#52296,"SAGA, BALARAJA, TANGERANG, BANTEN",40,93,101,194
https://kawalpemilu.org#52296,"SAGA, BALARAJA, TANGERANG, BANTEN",41,106,130,236
https://kawalpemilu.org#52296,"SAGA, BALARAJA, TANGERANG, BANTEN",42,60,107,167
https://kawalpemilu.org#52296,"SAGA, BALARAJA, TANGERANG, BANTEN",43,59,132,191
https://kawalpemilu.org#52296,"SAGA, BALARAJA, TANGERANG, BANTEN",44,0,0,0
https://kawalpemilu.org#52296,"SAGA, BALARAJA, TANGERANG, BANTEN",45,63,188,251
https://kawalpemilu.org#52296,"SAGA, BALARAJA, TANGERANG, BANTEN",46,70,128,198
https://kawalpemilu.org#52296,"SAGA, BALARAJA, TANGERANG, BANTEN",49,61,116,177
https://kawalpemilu.org#52296,"SAGA, BALARAJA, TANGERANG, BANTEN",50,66,156,222
https://kawalpemilu.org#52296,"SAGA, BALARAJA, TANGERANG, BANTEN",51,62,99,161
https://kawalpemilu.org#52296,"SAGA, BALARAJA, TANGERANG, BANTEN",52,69,186,255
https://kawalpemilu.org#52296,"SAGA, BALARAJA, TANGERANG, BANTEN",53,98,176,274
https://kawalpemilu.org#52296,"SAGA, BALARAJA, TANGERANG, BANTEN",54,130,139,269
https://kawalpemilu.org#52296,"SAGA, BALARAJA, TANGERANG, BANTEN",55,49,147,196
https://kawalpemilu.org#52296,"SAGA, BALARAJA, TANGERANG, BANTEN",56,52,159,211
https://kawalpemilu.org#52296,"SAGA, BALARAJA, TANGERANG, BANTEN",57,75,115,190
https://kawalpemilu.org#52296,"SAGA, BALARAJA, TANGERANG, BANTEN",58,90,97,187
https://kawalpemilu.org#52296,"SAGA, BALARAJA, TANGERANG, BANTEN",59,65,133,198
https://kawalpemilu.org#52296,"SAGA, BALARAJA, TANGERANG, BANTEN",60,81,151,232
https://kawalpemilu.org#52296,"SAGA, BALARAJA, TANGERANG, BANTEN",61,111,174,285
https://kawalpemilu.org#52296,"SAGA, BALARAJA, TANGERANG, BANTEN",62,67,128,195
https://kawalpemilu.org#52296,"SAGA, BALARAJA, TANGERANG, BANTEN",63,149,137,286
https://kawalpemilu.org#52296,"SAGA, BALARAJA, TANGERANG, BANTEN",64,81,94,175
https://kawalpemilu.org#52296,"SAGA, BALARAJA, TANGERANG, BANTEN",65,94,149,243
https://kawalpemilu.org#52296,"SAGA, BALARAJA, TANGERANG, BANTEN",66,80,150,230
https://kawalpemilu.org#52296,"SAGA, BALARAJA, TANGERANG, BANTEN",67,70,123,193
https://kawalpemilu.org#52296,"SAGA, BALARAJA, TANGERANG, BANTEN",68,94,163,257
https://kawalpemilu.org#52296,"SAGA, BALARAJA, TANGERANG, BANTEN",69,89,113,202
https://kawalpemilu.org#52296,"SAGA, BALARAJA, TANGERANG, BANTEN",70,61,141,202
https://kawalpemilu.org#52296,"SAGA, BALARAJA, TANGERANG, BANTEN",71,119,150,269
https://kawalpemilu.org#52296,"SAGA, BALARAJA, TANGERANG, BANTEN",72,117,135,252
https://kawalpemilu.org#52296,"SAGA, BALARAJA, TANGERANG, BANTEN",74,62,131,193
https://kawalpemilu.org#52296,"SAGA, BALARAJA, TANGERANG, BANTEN",75,74,154,228
https://kawalpemilu.org#52296,"SAGA, BALARAJA, TANGERANG, BANTEN",77,46,113,159
https://kawalpemilu.org#52296,"SAGA, BALARAJA, TANGERANG, BANTEN",79,68,61,129
https://kawalpemilu.org#52296,"SAGA, BALARAJA, TANGERANG, BANTEN",80,96,130,226
https://kawalpemilu.org#52297,"SENTUL JAYA, BALARAJA, TANGERANG, BANTEN",1,39,148,187
https://kawalpemilu.org#52297,"SENTUL JAYA, BALARAJA, TANGERANG, BANTEN",2,82,138,220
https://kawalpemilu.org#52297,"SENTUL JAYA, BALARAJA, TANGERANG, BANTEN",3,50,142,192
https://kawalpemilu.org#52297,"SENTUL JAYA, BALARAJA, TANGERANG, BANTEN",4,52,185,234
https://kawalpemilu.org#52297,"SENTUL JAYA, BALARAJA, TANGERANG, BANTEN",5,62,170,232
https://kawalpemilu.org#52297,"SENTUL JAYA, BALARAJA, TANGERANG, BANTEN",6,96,107,203
https://kawalpemilu.org#52297,"SENTUL JAYA, BALARAJA, TANGERANG, BANTEN",7,88,199,287
https://kawalpemilu.org#52297,"SENTUL JAYA, BALARAJA, TANGERANG, BANTEN",8,114,89,203
https://kawalpemilu.org#52297,"SENTUL JAYA, BALARAJA, TANGERANG, BANTEN",9,75,130,205
https://kawalpemilu.org#52297,"SENTUL JAYA, BALARAJA, TANGERANG, BANTEN",10,53,150,203
https://kawalpemilu.org#52297,"SENTUL JAYA, BALARAJA, TANGERANG, BANTEN",11,70,63,133
https://kawalpemilu.org#52297,"SENTUL JAYA, BALARAJA, TANGERANG, BANTEN",12,49,119,168
https://kawalpemilu.org#52297,"SENTUL JAYA, BALARAJA, TANGERANG, BANTEN",13,76,134,210
https://kawalpemilu.org#52297,"SENTUL JAYA, BALARAJA, TANGERANG, BANTEN",14,53,130,183
https://kawalpemilu.org#52297,"SENTUL JAYA, BALARAJA, TANGERANG, BANTEN",15,52,171,223
https://kawalpemilu.org#52297,"SENTUL JAYA, BALARAJA, TANGERANG, BANTEN",16,72,152,224
https://kawalpemilu.org#52297,"SENTUL JAYA, BALARAJA, TANGERANG, BANTEN",17,83,100,183
https://kawalpemilu.org#52297,"SENTUL JAYA, BALARAJA, TANGERANG, BANTEN",18,51,150,201
https://kawalpemilu.org#52297,"SENTUL JAYA, BALARAJA, TANGERANG, BANTEN",19,59,131,190
https://kawalpemilu.org#52299,"PANGKAT, JAYANTI, TANGERANG, BANTEN",1,62,122,184
https://kawalpemilu.org#52299,"PANGKAT, JAYANTI, TANGERANG, BANTEN",2,68,127,195
https://kawalpemilu.org#52299,"PANGKAT, JAYANTI, TANGERANG, BANTEN",3,46,154,200
https://kawalpemilu.org#52299,"PANGKAT, JAYANTI, TANGERANG, BANTEN",4,60,144,204
https://kawalpemilu.org#52299,"PANGKAT, JAYANTI, TANGERANG, BANTEN",5,83,85,168
https://kawalpemilu.org#52299,"PANGKAT, JAYANTI, TANGERANG, BANTEN",6,77,101,178
https://kawalpemilu.org#52299,"PANGKAT, JAYANTI, TANGERANG, BANTEN",7,146,88,234
https://kawalpemilu.org#52299,"PANGKAT, JAYANTI, TANGERANG, BANTEN",8,57,156,213
https://kawalpemilu.org#52299,"PANGKAT, JAYANTI, TANGERANG, BANTEN",9,120,100,220
https://kawalpemilu.org#52299,"PANGKAT, JAYANTI, TANGERANG, BANTEN",10,93,131,224
https://kawalpemilu.org#52299,"PANGKAT, JAYANTI, TANGERANG, BANTEN",11,77,138,215
https://kawalpemilu.org#52299,"PANGKAT, JAYANTI, TANGERANG, BANTEN",12,81,127,208
https://kawalpemilu.org#52299,"PANGKAT, JAYANTI, TANGERANG, BANTEN",13,82,109,191
https://kawalpemilu.org#52299,"PANGKAT, JAYANTI, TANGERANG, BANTEN",14,81,110,191
https://kawalpemilu.org#52299,"PANGKAT, JAYANTI, TANGERANG, BANTEN",15,103,85,188
https://kawalpemilu.org#52299,"PANGKAT, JAYANTI, TANGERANG, BANTEN",16,46,119,165
https://kawalpemilu.org#52300,"PABUARAN, JAYANTI, TANGERANG, BANTEN",1,94,164,258
https://kawalpemilu.org#52300,"PABUARAN, JAYANTI, TANGERANG, BANTEN",2,79,79,158
https://kawalpemilu.org#52300,"PABUARAN, JAYANTI, TANGERANG, BANTEN",3,58,103,161
https://kawalpemilu.org#52300,"PABUARAN, JAYANTI, TANGERANG, BANTEN",4,101,148,249
https://kawalpemilu.org#52300,"PABUARAN, JAYANTI, TANGERANG, BANTEN",5,94,138,232
https://kawalpemilu.org#52300,"PABUARAN, JAYANTI, TANGERANG, BANTEN",6,56,137,193
https://kawalpemilu.org#52300,"PABUARAN, JAYANTI, TANGERANG, BANTEN",7,146,88,234
https://kawalpemilu.org#52300,"PABUARAN, JAYANTI, TANGERANG, BANTEN",8,126,101,227
https://kawalpemilu.org#52300,"PABUARAN, JAYANTI, TANGERANG, BANTEN",9,84,124,206
https://kawalpemilu.org#52300,"PABUARAN, JAYANTI, TANGERANG, BANTEN",10,59,135,194
https://kawalpemilu.org#52300,"PABUARAN, JAYANTI, TANGERANG, BANTEN",11,104,129,233
https://kawalpemilu.org#52300,"PABUARAN, JAYANTI, TANGERANG, BANTEN",12,74,117,191
https://kawalpemilu.org#52300,"PABUARAN, JAYANTI, TANGERANG, BANTEN",13,88,95,183
https://kawalpemilu.org#52300,"PABUARAN, JAYANTI, TANGERANG, BANTEN",14,83,94,177
https://kawalpemilu.org#52300,"PABUARAN, JAYANTI, TANGERANG, BANTEN",15,120,98,218
https://kawalpemilu.org#52300,"PABUARAN, JAYANTI, TANGERANG, BANTEN",16,92,112,204
https://kawalpemilu.org#52300,"PABUARAN, JAYANTI, TANGERANG, BANTEN",17,193,118,211
https://kawalpemilu.org#52300,"PABUARAN, JAYANTI, TANGERANG, BANTEN",18,120,117,237
https://kawalpemilu.org#52300,"PABUARAN, JAYANTI, TANGERANG, BANTEN",19,72,184,256
https://kawalpemilu.org#52301,"PASIR MUNCANG, JAYANTI, TANGERANG, BANTEN",1,84,132,216
https://kawalpemilu.org#52301,"PASIR MUNCANG, JAYANTI, TANGERANG, BANTEN",2,52,158,210
https://kawalpemilu.org#52301,"PASIR MUNCANG, JAYANTI, TANGERANG, BANTEN",3,38,151,189
https://kawalpemilu.org#52301,"PASIR MUNCANG, JAYANTI, TANGERANG, BANTEN",4,65,173,238
https://kawalpemilu.org#52301,"PASIR MUNCANG, JAYANTI, TANGERANG, BANTEN",5,57,155,212
https://kawalpemilu.org#52301,"PASIR MUNCANG, JAYANTI, TANGERANG, BANTEN",6,29,170,199
https://kawalpemilu.org#52301,"PASIR MUNCANG, JAYANTI, TANGERANG, BANTEN",7,43,156,199
https://kawalpemilu.org#52301,"PASIR MUNCANG, JAYANTI, TANGERANG, BANTEN",8,51,149,200
https://kawalpemilu.org#52301,"PASIR MUNCANG, JAYANTI, TANGERANG, BANTEN",9,36,176,212
https://kawalpemilu.org#52301,"PASIR MUNCANG, JAYANTI, TANGERANG, BANTEN",10,43,164,207
https://kawalpemilu.org#52301,"PASIR MUNCANG, JAYANTI, TANGERANG, BANTEN",11,46,173,219
https://kawalpemilu.org#52301,"PASIR MUNCANG, JAYANTI, TANGERANG, BANTEN",12,62,165,227
https://kawalpemilu.org#52301,"PASIR MUNCANG, JAYANTI, TANGERANG, BANTEN",13,66,99,165
https://kawalpemilu.org#52301,"PASIR MUNCANG, JAYANTI, TANGERANG, BANTEN",14,52,93,145
https://kawalpemilu.org#52301,"PASIR MUNCANG, JAYANTI, TANGERANG, BANTEN",15,90,84,174
https://kawalpemilu.org#52301,"PASIR MUNCANG, JAYANTI, TANGERANG, BANTEN",16,58,66,124
https://kawalpemilu.org#52301,"PASIR MUNCANG, JAYANTI, TANGERANG, BANTEN",17,65,128,193
https://kawalpemilu.org#52301,"PASIR MUNCANG, JAYANTI, TANGERANG, BANTEN",18,63,140,203
https://kawalpemilu.org#52301,"PASIR MUNCANG, JAYANTI, TANGERANG, BANTEN",19,105,146,251
https://kawalpemilu.org#52301,"PASIR MUNCANG, JAYANTI, TANGERANG, BANTEN",20,62,157,219
https://kawalpemilu.org#52301,"PASIR MUNCANG, JAYANTI, TANGERANG, BANTEN",21,103,97,200
https://kawalpemilu.org#52301,"PASIR MUNCANG, JAYANTI, TANGERANG, BANTEN",22,129,101,230
https://kawalpemilu.org#52301,"PASIR MUNCANG, JAYANTI, TANGERANG, BANTEN",23,83,124,207
https://kawalpemilu.org#52301,"PASIR MUNCANG, JAYANTI, TANGERANG, BANTEN",24,92,113,205
https://kawalpemilu.org#52301,"PASIR MUNCANG, JAYANTI, TANGERANG, BANTEN",25,71,114,185
https://kawalpemilu.org#52301,"PASIR MUNCANG, JAYANTI, TANGERANG, BANTEN",26,36,130,166
https://kawalpemilu.org#52302,"SUMUR BANDUNG, JAYANTI, TANGERANG, BANTEN",1,54,136,190
https://kawalpemilu.org#52302,"SUMUR BANDUNG, JAYANTI, TANGERANG, BANTEN",2,57,124,181
https://kawalpemilu.org#52302,"SUMUR BANDUNG, JAYANTI, TANGERANG, BANTEN",3,116,148,264
https://kawalpemilu.org#52302,"SUMUR BANDUNG, JAYANTI, TANGERANG, BANTEN",4,116,108,224
https://kawalpemilu.org#52302,"SUMUR BANDUNG, JAYANTI, TANGERANG, BANTEN",5,70,145,215
https://kawalpemilu.org#52302,"SUMUR BANDUNG, JAYANTI, TANGERANG, BANTEN",6,84,158,242
https://kawalpemilu.org#52302,"SUMUR BANDUNG, JAYANTI, TANGERANG, BANTEN",7,87,133,220
https://kawalpemilu.org#52302,"SUMUR BANDUNG, JAYANTI, TANGERANG, BANTEN",8,40,122,162
https://kawalpemilu.org#52302,"SUMUR BANDUNG, JAYANTI, TANGERANG, BANTEN",9,44,112,156
https://kawalpemilu.org#52302,"SUMUR BANDUNG, JAYANTI, TANGERANG, BANTEN",10,78,179,257
https://kawalpemilu.org#52302,"SUMUR BANDUNG, JAYANTI, TANGERANG, BANTEN",11,80,183,263
https://kawalpemilu.org#52302,"SUMUR BANDUNG, JAYANTI, TANGERANG, BANTEN",12,51,143,194
https://kawalpemilu.org#52302,"SUMUR BANDUNG, JAYANTI, TANGERANG, BANTEN",13,70,148,218
https://kawalpemilu.org#52302,"SUMUR BANDUNG, JAYANTI, TANGERANG, BANTEN",14,66,158,224
https://kawalpemilu.org#52302,"SUMUR BANDUNG, JAYANTI, TANGERANG, BANTEN",15,70,159,229
https://kawalpemilu.org#52302,"SUMUR BANDUNG, JAYANTI, TANGERANG, BANTEN",16,83,134,217
https://kawalpemilu.org#52302,"SUMUR BANDUNG, JAYANTI, TANGERANG, BANTEN",17,52,93,145
https://kawalpemilu.org#52302,"SUMUR BANDUNG, JAYANTI, TANGERANG, BANTEN",18,63,79,142
https://kawalpemilu.org#52302,"SUMUR BANDUNG, JAYANTI, TANGERANG, BANTEN",19,83,157,240
https://kawalpemilu.org#52302,"SUMUR BANDUNG, JAYANTI, TANGERANG, BANTEN",20,64,140,204
https://kawalpemilu.org#52302,"SUMUR BANDUNG, JAYANTI, TANGERANG, BANTEN",21,72,133,205
https://kawalpemilu.org#52302,"SUMUR BANDUNG, JAYANTI, TANGERANG, BANTEN",22,64,108,172
https://kawalpemilu.org#52302,"SUMUR BANDUNG, JAYANTI, TANGERANG, BANTEN",23,51,111,162
https://kawalpemilu.org#52302,"SUMUR BANDUNG, JAYANTI, TANGERANG, BANTEN",24,56,105,161
https://kawalpemilu.org#52302,"SUMUR BANDUNG, JAYANTI, TANGERANG, BANTEN",25,51,107,158
https://kawalpemilu.org#52303,"JAYANTI, JAYANTI, TANGERANG, BANTEN",1,77,82,159
https://kawalpemilu.org#52303,"JAYANTI, JAYANTI, TANGERANG, BANTEN",2,62,185,247
https://kawalpemilu.org#52303,"JAYANTI, JAYANTI, TANGERANG, BANTEN",3,57,139,196
https://kawalpemilu.org#52303,"JAYANTI, JAYANTI, TANGERANG, BANTEN",4,64,154,218
https://kawalpemilu.org#52303,"JAYANTI, JAYANTI, TANGERANG, BANTEN",5,58,130,188
https://kawalpemilu.org#52303,"JAYANTI, JAYANTI, TANGERANG, BANTEN",6,37,107,144
https://kawalpemilu.org#52303,"JAYANTI, JAYANTI, TANGERANG, BANTEN",7,62,172,234
https://kawalpemilu.org#52303,"JAYANTI, JAYANTI, TANGERANG, BANTEN",8,84,97,181
https://kawalpemilu.org#52303,"JAYANTI, JAYANTI, TANGERANG, BANTEN",9,73,110,183
https://kawalpemilu.org#52303,"JAYANTI, JAYANTI, TANGERANG, BANTEN",10,88,122,210
https://kawalpemilu.org#52303,"JAYANTI, JAYANTI, TANGERANG, BANTEN",11,68,108,176
https://kawalpemilu.org#52303,"JAYANTI, JAYANTI, TANGERANG, BANTEN",12,71,106,177
https://kawalpemilu.org#52303,"JAYANTI, JAYANTI, TANGERANG, BANTEN",13,48,163,211
https://kawalpemilu.org#52303,"JAYANTI, JAYANTI, TANGERANG, BANTEN",14,0,0,0
https://kawalpemilu.org#52303,"JAYANTI, JAYANTI, TANGERANG, BANTEN",15,44,195,239
https://kawalpemilu.org#52303,"JAYANTI, JAYANTI, TANGERANG, BANTEN",16,95,150,245
https://kawalpemilu.org#52303,"JAYANTI, JAYANTI, TANGERANG, BANTEN",17,63,199,262
https://kawalpemilu.org#52303,"JAYANTI, JAYANTI, TANGERANG, BANTEN",19,44,179,223
https://kawalpemilu.org#52303,"JAYANTI, JAYANTI, TANGERANG, BANTEN",20,63,117,180
https://kawalpemilu.org#52303,"JAYANTI, JAYANTI, TANGERANG, BANTEN",21,66,123,189
https://kawalpemilu.org#52303,"JAYANTI, JAYANTI, TANGERANG, BANTEN",22,55,105,160
https://kawalpemilu.org#52303,"JAYANTI, JAYANTI, TANGERANG, BANTEN",23,78,187,265
https://kawalpemilu.org#52303,"JAYANTI, JAYANTI, TANGERANG, BANTEN",24,63,139,202
https://kawalpemilu.org#52303,"JAYANTI, JAYANTI, TANGERANG, BANTEN",25,43,117,160
https://kawalpemilu.org#52303,"JAYANTI, JAYANTI, TANGERANG, BANTEN",26,58,116,224
https://kawalpemilu.org#52303,"JAYANTI, JAYANTI, TANGERANG, BANTEN",27,40,129,169
https://kawalpemilu.org#52303,"JAYANTI, JAYANTI, TANGERANG, BANTEN",28,47,129,176
https://kawalpemilu.org#52303,"JAYANTI, JAYANTI, TANGERANG, BANTEN",29,52,140,192
https://kawalpemilu.org#52303,"JAYANTI, JAYANTI, TANGERANG, BANTEN",30,84,120,204
https://kawalpemilu.org#52304,"DANGDEUR, JAYANTI, TANGERANG, BANTEN",1,41,152,193
https://kawalpemilu.org#52304,"DANGDEUR, JAYANTI, TANGERANG, BANTEN",2,56,109,165
https://kawalpemilu.org#52304,"DANGDEUR, JAYANTI, TANGERANG, BANTEN",3,21,165,186
https://kawalpemilu.org#52304,"DANGDEUR, JAYANTI, TANGERANG, BANTEN",4,65,145,210
https://kawalpemilu.org#52304,"DANGDEUR, JAYANTI, TANGERANG, BANTEN",5,60,137,197
https://kawalpemilu.org#52304,"DANGDEUR, JAYANTI, TANGERANG, BANTEN",6,46,103,149
https://kawalpemilu.org#52304,"DANGDEUR, JAYANTI, TANGERANG, BANTEN",7,66,99,165
https://kawalpemilu.org#52304,"DANGDEUR, JAYANTI, TANGERANG, BANTEN",8,84,109,193
https://kawalpemilu.org#52304,"DANGDEUR, JAYANTI, TANGERANG, BANTEN",9,85,105,190
https://kawalpemilu.org#52304,"DANGDEUR, JAYANTI, TANGERANG, BANTEN",10,48,106,154
https://kawalpemilu.org#52304,"DANGDEUR, JAYANTI, TANGERANG, BANTEN",11,114,85,199
https://kawalpemilu.org#52304,"DANGDEUR, JAYANTI, TANGERANG, BANTEN",13,85,130,215
https://kawalpemilu.org#52304,"DANGDEUR, JAYANTI, TANGERANG, BANTEN",14,78,119,197
https://kawalpemilu.org#52304,"DANGDEUR, JAYANTI, TANGERANG, BANTEN",15,80,105,185
https://kawalpemilu.org#52304,"DANGDEUR, JAYANTI, TANGERANG, BANTEN",16,79,111,190
https://kawalpemilu.org#52304,"DANGDEUR, JAYANTI, TANGERANG, BANTEN",17,97,58,155
https://kawalpemilu.org#52304,"DANGDEUR, JAYANTI, TANGERANG, BANTEN",18,69,89,158
https://kawalpemilu.org#52304,"DANGDEUR, JAYANTI, TANGERANG, BANTEN",19,29,93,122
https://kawalpemilu.org#52304,"DANGDEUR, JAYANTI, TANGERANG, BANTEN",20,76,106,182
https://kawalpemilu.org#52304,"DANGDEUR, JAYANTI, TANGERANG, BANTEN",22,58,137,195
https://kawalpemilu.org#52304,"DANGDEUR, JAYANTI, TANGERANG, BANTEN",23,79,115,194
https://kawalpemilu.org#52304,"DANGDEUR, JAYANTI, TANGERANG, BANTEN",24,41,84,125
https://kawalpemilu.org#52305,"CIKANDE, JAYANTI, TANGERANG, BANTEN",2,26,151,177
https://kawalpemilu.org#52305,"CIKANDE, JAYANTI, TANGERANG, BANTEN",3,110,157,267
https://kawalpemilu.org#52305,"CIKANDE, JAYANTI, TANGERANG, BANTEN",4,134,128,262
https://kawalpemilu.org#52305,"CIKANDE, JAYANTI, TANGERANG, BANTEN",5,137,131,268
https://kawalpemilu.org#52305,"CIKANDE, JAYANTI, TANGERANG, BANTEN",6,124,137,261
https://kawalpemilu.org#52305,"CIKANDE, JAYANTI, TANGERANG, BANTEN",8,99,160,259
https://kawalpemilu.org#52305,"CIKANDE, JAYANTI, TANGERANG, BANTEN",9,93,119,212
https://kawalpemilu.org#52305,"CIKANDE, JAYANTI, TANGERANG, BANTEN",10,43,132,175
https://kawalpemilu.org#52305,"CIKANDE, JAYANTI, TANGERANG, BANTEN",11,51,189,240
https://kawalpemilu.org#52305,"CIKANDE, JAYANTI, TANGERANG, BANTEN",13,61,98,159
https://kawalpemilu.org#52305,"CIKANDE, JAYANTI, TANGERANG, BANTEN",14,71,188,259
https://kawalpemilu.org#52305,"CIKANDE, JAYANTI, TANGERANG, BANTEN",15,76,136,112
https://kawalpemilu.org#52305,"CIKANDE, JAYANTI, TANGERANG, BANTEN",16,73,114,187
https://kawalpemilu.org#52305,"CIKANDE, JAYANTI, TANGERANG, BANTEN",17,105,134,239
https://kawalpemilu.org#52305,"CIKANDE, JAYANTI, TANGERANG, BANTEN",18,93,143,236
https://kawalpemilu.org#52305,"CIKANDE, JAYANTI, TANGERANG, BANTEN",19,80,141,221
https://kawalpemilu.org#52305,"CIKANDE, JAYANTI, TANGERANG, BANTEN",20,66,130,196
https://kawalpemilu.org#52305,"CIKANDE, JAYANTI, TANGERANG, BANTEN",21,64,135,199
https://kawalpemilu.org#52305,"CIKANDE, JAYANTI, TANGERANG, BANTEN",22,49,163,212
https://kawalpemilu.org#52305,"CIKANDE, JAYANTI, TANGERANG, BANTEN",23,49,155,204
https://kawalpemilu.org#52305,"CIKANDE, JAYANTI, TANGERANG, BANTEN",24,50,156,206
https://kawalpemilu.org#52305,"CIKANDE, JAYANTI, TANGERANG, BANTEN",25,100,169,269
https://kawalpemilu.org#52305,"CIKANDE, JAYANTI, TANGERANG, BANTEN",26,101,109,210
https://kawalpemilu.org#52305,"CIKANDE, JAYANTI, TANGERANG, BANTEN",27,73,122,195
https://kawalpemilu.org#52305,"CIKANDE, JAYANTI, TANGERANG, BANTEN",29,75,149,224
https://kawalpemilu.org#52305,"CIKANDE, JAYANTI, TANGERANG, BANTEN",30,83,89,172
https://kawalpemilu.org#52305,"CIKANDE, JAYANTI, TANGERANG, BANTEN",31,75,74,149
https://kawalpemilu.org#52306,"PASIR GINTUNG, JAYANTI, TANGERANG, BANTEN",1,64,116,180
https://kawalpemilu.org#52306,"PASIR GINTUNG, JAYANTI, TANGERANG, BANTEN",2,75,160,235
https://kawalpemilu.org#52306,"PASIR GINTUNG, JAYANTI, TANGERANG, BANTEN",3,55,101,156
https://kawalpemilu.org#52306,"PASIR GINTUNG, JAYANTI, TANGERANG, BANTEN",4,74,88,162
https://kawalpemilu.org#52306,"PASIR GINTUNG, JAYANTI, TANGERANG, BANTEN",5,102,92,194
https://kawalpemilu.org#52306,"PASIR GINTUNG, JAYANTI, TANGERANG, BANTEN",6,103,120,223
https://kawalpemilu.org#52306,"PASIR GINTUNG, JAYANTI, TANGERANG, BANTEN",7,29,155,184
https://kawalpemilu.org#52306,"PASIR GINTUNG, JAYANTI, TANGERANG, BANTEN",8,40,133,173
https://kawalpemilu.org#52306,"PASIR GINTUNG, JAYANTI, TANGERANG, BANTEN",9,68,157,225
https://kawalpemilu.org#52306,"PASIR GINTUNG, JAYANTI, TANGERANG, BANTEN",10,83,132,215
https://kawalpemilu.org#52306,"PASIR GINTUNG, JAYANTI, TANGERANG, BANTEN",11,46,159,205
https://kawalpemilu.org#52306,"PASIR GINTUNG, JAYANTI, TANGERANG, BANTEN",12,74,117,191
https://kawalpemilu.org#52306,"PASIR GINTUNG, JAYANTI, TANGERANG, BANTEN",13,54,145,199
https://kawalpemilu.org#52306,"PASIR GINTUNG, JAYANTI, TANGERANG, BANTEN",14,33,125,158
https://kawalpemilu.org#52306,"PASIR GINTUNG, JAYANTI, TANGERANG, BANTEN",15,53,54,107
https://kawalpemilu.org#52306,"PASIR GINTUNG, JAYANTI, TANGERANG, BANTEN",16,33,56,89
https://kawalpemilu.org#52306,"PASIR GINTUNG, JAYANTI, TANGERANG, BANTEN",17,29,124,153
https://kawalpemilu.org#52308,"TIGARAKSA, TIGARAKSA, TANGERANG, BANTEN",1,57,193,250
https://kawalpemilu.org#52308,"TIGARAKSA, TIGARAKSA, TANGERANG, BANTEN",2,48,199,247
https://kawalpemilu.org#52308,"TIGARAKSA, TIGARAKSA, TANGERANG, BANTEN",3,87,176,263
https://kawalpemilu.org#52308,"TIGARAKSA, TIGARAKSA, TANGERANG, BANTEN",5,112,131,243
https://kawalpemilu.org#52308,"TIGARAKSA, TIGARAKSA, TANGERANG, BANTEN",6,92,168,260
https://kawalpemilu.org#52308,"TIGARAKSA, TIGARAKSA, TANGERANG, BANTEN",7,43,137,180
https://kawalpemilu.org#52308,"TIGARAKSA, TIGARAKSA, TANGERANG, BANTEN",8,64,124,188
https://kawalpemilu.org#52308,"TIGARAKSA, TIGARAKSA, TANGERANG, BANTEN",9,54,165,219
https://kawalpemilu.org#52308,"TIGARAKSA, TIGARAKSA, TANGERANG, BANTEN",10,55,179,234
https://kawalpemilu.org#52308,"TIGARAKSA, TIGARAKSA, TANGERANG, BANTEN",11,98,159,257
https://kawalpemilu.org#52308,"TIGARAKSA, TIGARAKSA, TANGERANG, BANTEN",12,78,146,224
https://kawalpemilu.org#52308,"TIGARAKSA, TIGARAKSA, TANGERANG, BANTEN",13,55,143,198
https://kawalpemilu.org#52308,"TIGARAKSA, TIGARAKSA, TANGERANG, BANTEN",14,83,107,190
https://kawalpemilu.org#52308,"TIGARAKSA, TIGARAKSA, TANGERANG, BANTEN",17,130,127,257
https://kawalpemilu.org#52308,"TIGARAKSA, TIGARAKSA, TANGERANG, BANTEN",18,68,135,203
https://kawalpemilu.org#52308,"TIGARAKSA, TIGARAKSA, TANGERANG, BANTEN",20,128,170,298
https://kawalpemilu.org#52308,"TIGARAKSA, TIGARAKSA, TANGERANG, BANTEN",21,120,180,300
https://kawalpemilu.org#52308,"TIGARAKSA, TIGARAKSA, TANGERANG, BANTEN",22,97,163,260
https://kawalpemilu.org#52308,"TIGARAKSA, TIGARAKSA, TANGERANG, BANTEN",23,74,74,148
https://kawalpemilu.org#52308,"TIGARAKSA, TIGARAKSA, TANGERANG, BANTEN",24,48,129,177
https://kawalpemilu.org#52308,"TIGARAKSA, TIGARAKSA, TANGERANG, BANTEN",25,69,170,239
https://kawalpemilu.org#52308,"TIGARAKSA, TIGARAKSA, TANGERANG, BANTEN",26,57,170,227
https://kawalpemilu.org#52308,"TIGARAKSA, TIGARAKSA, TANGERANG, BANTEN",27,36,105,141
https://kawalpemilu.org#52308,"TIGARAKSA, TIGARAKSA, TANGERANG, BANTEN",28,115,159,274
https://kawalpemilu.org#52308,"TIGARAKSA, TIGARAKSA, TANGERANG, BANTEN",29,111,134,245
https://kawalpemilu.org#52308,"TIGARAKSA, TIGARAKSA, TANGERANG, BANTEN",30,97,120,212
https://kawalpemilu.org#52308,"TIGARAKSA, TIGARAKSA, TANGERANG, BANTEN",31,106,118,224
https://kawalpemilu.org#52308,"TIGARAKSA, TIGARAKSA, TANGERANG, BANTEN",32,102,144,246
https://kawalpemilu.org#52308,"TIGARAKSA, TIGARAKSA, TANGERANG, BANTEN",33,102,177,279
https://kawalpemilu.org#52308,"TIGARAKSA, TIGARAKSA, TANGERANG, BANTEN",34,80,121,201
https://kawalpemilu.org#52308,"TIGARAKSA, TIGARAKSA, TANGERANG, BANTEN",35,104,194,298
https://kawalpemilu.org#52309,"KADU AGUNG, TIGARAKSA, TANGERANG, BANTEN",2,119,54,173
https://kawalpemilu.org#52309,"KADU AGUNG, TIGARAKSA, TANGERANG, BANTEN",3,136,125,261
https://kawalpemilu.org#52309,"KADU AGUNG, TIGARAKSA, TANGERANG, BANTEN",4,74,158,232
https://kawalpemilu.org#52309,"KADU AGUNG, TIGARAKSA, TANGERANG, BANTEN",5,159,112,271
https://kawalpemilu.org#52309,"KADU AGUNG, TIGARAKSA, TANGERANG, BANTEN",6,129,145,274
https://kawalpemilu.org#52309,"KADU AGUNG, TIGARAKSA, TANGERANG, BANTEN",7,78,181,259
https://kawalpemilu.org#52309,"KADU AGUNG, TIGARAKSA, TANGERANG, BANTEN",8,58,123,181
https://kawalpemilu.org#52309,"KADU AGUNG, TIGARAKSA, TANGERANG, BANTEN",9,79,99,178
https://kawalpemilu.org#52309,"KADU AGUNG, TIGARAKSA, TANGERANG, BANTEN",10,42,183,225
https://kawalpemilu.org#52309,"KADU AGUNG, TIGARAKSA, TANGERANG, BANTEN",11,32,163,195
https://kawalpemilu.org#52309,"KADU AGUNG, TIGARAKSA, TANGERANG, BANTEN",12,66,176,242
https://kawalpemilu.org#52309,"KADU AGUNG, TIGARAKSA, TANGERANG, BANTEN",13,68,148,216
https://kawalpemilu.org#52309,"KADU AGUNG, TIGARAKSA, TANGERANG, BANTEN",14,44,182,226
https://kawalpemilu.org#52309,"KADU AGUNG, TIGARAKSA, TANGERANG, BANTEN",15,66,140,206
https://kawalpemilu.org#52309,"KADU AGUNG, TIGARAKSA, TANGERANG, BANTEN",16,56,148,204
https://kawalpemilu.org#52309,"KADU AGUNG, TIGARAKSA, TANGERANG, BANTEN",17,56,178,234
https://kawalpemilu.org#52309,"KADU AGUNG, TIGARAKSA, TANGERANG, BANTEN",18,64,132,196
https://kawalpemilu.org#52309,"KADU AGUNG, TIGARAKSA, TANGERANG, BANTEN",19,50,188,238
https://kawalpemilu.org#52309,"KADU AGUNG, TIGARAKSA, TANGERANG, BANTEN",20,41,177,218
https://kawalpemilu.org#52309,"KADU AGUNG, TIGARAKSA, TANGERANG, BANTEN",21,52,102,154
https://kawalpemilu.org#52310,"PASIR BOLANG, TIGARAKSA, TANGERANG, BANTEN",1,44,104,148
https://kawalpemilu.org#52310,"PASIR BOLANG, TIGARAKSA, TANGERANG, BANTEN",2,54,111,165
https://kawalpemilu.org#52310,"PASIR BOLANG, TIGARAKSA, TANGERANG, BANTEN",7,76,118,194
https://kawalpemilu.org#52310,"PASIR BOLANG, TIGARAKSA, TANGERANG, BANTEN",8,70,118,188
https://kawalpemilu.org#52310,"PASIR BOLANG, TIGARAKSA, TANGERANG, BANTEN",9,56,102,158
https://kawalpemilu.org#52310,"PASIR BOLANG, TIGARAKSA, TANGERANG, BANTEN",10,81,141,222
https://kawalpemilu.org#52310,"PASIR BOLANG, TIGARAKSA, TANGERANG, BANTEN",11,52,114,166
https://kawalpemilu.org#52310,"PASIR BOLANG, TIGARAKSA, TANGERANG, BANTEN",14,67,185,252
https://kawalpemilu.org#52310,"PASIR BOLANG, TIGARAKSA, TANGERANG, BANTEN",15,64,132,196
https://kawalpemilu.org#52310,"PASIR BOLANG, TIGARAKSA, TANGERANG, BANTEN",18,57,108,165
https://kawalpemilu.org#52310,"PASIR BOLANG, TIGARAKSA, TANGERANG, BANTEN",19,51,99,150
https://kawalpemilu.org#52311,"MATAGARA, TIGARAKSA, TANGERANG, BANTEN",1,39,169,208
https://kawalpemilu.org#52311,"MATAGARA, TIGARAKSA, TANGERANG, BANTEN",2,47,81,128
https://kawalpemilu.org#52311,"MATAGARA, TIGARAKSA, TANGERANG, BANTEN",3,44,156,200
https://kawalpemilu.org#52311,"MATAGARA, TIGARAKSA, TANGERANG, BANTEN",4,32,124,156
https://kawalpemilu.org#52311,"MATAGARA, TIGARAKSA, TANGERANG, BANTEN",5,45,110,155
https://kawalpemilu.org#52311,"MATAGARA, TIGARAKSA, TANGERANG, BANTEN",6,57,158,215
https://kawalpemilu.org#52311,"MATAGARA, TIGARAKSA, TANGERANG, BANTEN",7,61,163,224
https://kawalpemilu.org#52311,"MATAGARA, TIGARAKSA, TANGERANG, BANTEN",8,69,165,234
https://kawalpemilu.org#52311,"MATAGARA, TIGARAKSA, TANGERANG, BANTEN",9,98,146,244
https://kawalpemilu.org#52311,"MATAGARA, TIGARAKSA, TANGERANG, BANTEN",16,45,177,222
https://kawalpemilu.org#52311,"MATAGARA, TIGARAKSA, TANGERANG, BANTEN",17,64,102,166
https://kawalpemilu.org#52311,"MATAGARA, TIGARAKSA, TANGERANG, BANTEN",18,46,162,208
https://kawalpemilu.org#52311,"MATAGARA, TIGARAKSA, TANGERANG, BANTEN",19,43,148,191
https://kawalpemilu.org#52311,"MATAGARA, TIGARAKSA, TANGERANG, BANTEN",20,91,159,250
https://kawalpemilu.org#52311,"MATAGARA, TIGARAKSA, TANGERANG, BANTEN",21,106,147,253
https://kawalpemilu.org#52311,"MATAGARA, TIGARAKSA, TANGERANG, BANTEN",22,93,126,219
https://kawalpemilu.org#52311,"MATAGARA, TIGARAKSA, TANGERANG, BANTEN",23,120,144,264
https://kawalpemilu.org#52311,"MATAGARA, TIGARAKSA, TANGERANG, BANTEN",24,74,168,242
https://kawalpemilu.org#52311,"MATAGARA, TIGARAKSA, TANGERANG, BANTEN",25,73,136,209
https://kawalpemilu.org#52311,"MATAGARA, TIGARAKSA, TANGERANG, BANTEN",26,67,101,168
https://kawalpemilu.org#52311,"MATAGARA, TIGARAKSA, TANGERANG, BANTEN",27,99,118,217
https://kawalpemilu.org#52311,"MATAGARA, TIGARAKSA, TANGERANG, BANTEN",28,111,130,241
https://kawalpemilu.org#52311,"MATAGARA, TIGARAKSA, TANGERANG, BANTEN",29,116,141,257
https://kawalpemilu.org#52311,"MATAGARA, TIGARAKSA, TANGERANG, BANTEN",30,95,130,225
https://kawalpemilu.org#52311,"MATAGARA, TIGARAKSA, TANGERANG, BANTEN",31,108,132,240
https://kawalpemilu.org#52312,"PASIR NANGKA, TIGARAKSA, TANGERANG, BANTEN",1,76,192,268
https://kawalpemilu.org#52312,"PASIR NANGKA, TIGARAKSA, TANGERANG, BANTEN",2,103,146,249
https://kawalpemilu.org#52312,"PASIR NANGKA, TIGARAKSA, TANGERANG, BANTEN",3,44,141,185
https://kawalpemilu.org#52312,"PASIR NANGKA, TIGARAKSA, TANGERANG, BANTEN",4,99,181,281
https://kawalpemilu.org#52312,"PASIR NANGKA, TIGARAKSA, TANGERANG, BANTEN",5,70,147,217
https://kawalpemilu.org#52312,"PASIR NANGKA, TIGARAKSA, TANGERANG, BANTEN",6,58,161,219
https://kawalpemilu.org#52312,"PASIR NANGKA, TIGARAKSA, TANGERANG, BANTEN",7,63,111,174
https://kawalpemilu.org#52312,"PASIR NANGKA, TIGARAKSA, TANGERANG, BANTEN",8,60,132,192
https://kawalpemilu.org#52312,"PASIR NANGKA, TIGARAKSA, TANGERANG, BANTEN",9,75,142,217
https://kawalpemilu.org#52312,"PASIR NANGKA, TIGARAKSA, TANGERANG, BANTEN",10,67,175,242
https://kawalpemilu.org#52312,"PASIR NANGKA, TIGARAKSA, TANGERANG, BANTEN",12,60,156,216
https://kawalpemilu.org#52312,"PASIR NANGKA, TIGARAKSA, TANGERANG, BANTEN",13,77,142,219
https://kawalpemilu.org#52312,"PASIR NANGKA, TIGARAKSA, TANGERANG, BANTEN",14,67,183,250
https://kawalpemilu.org#52312,"PASIR NANGKA, TIGARAKSA, TANGERANG, BANTEN",15,47,134,181
https://kawalpemilu.org#52312,"PASIR NANGKA, TIGARAKSA, TANGERANG, BANTEN",18,52,126,178
https://kawalpemilu.org#52312,"PASIR NANGKA, TIGARAKSA, TANGERANG, BANTEN",19,179,168,347
https://kawalpemilu.org#52312,"PASIR NANGKA, TIGARAKSA, TANGERANG, BANTEN",20,66,113,179
https://kawalpemilu.org#52312,"PASIR NANGKA, TIGARAKSA, TANGERANG, BANTEN",21,79,124,203
https://kawalpemilu.org#52312,"PASIR NANGKA, TIGARAKSA, TANGERANG, BANTEN",22,78,118,196
https://kawalpemilu.org#52312,"PASIR NANGKA, TIGARAKSA, TANGERANG, BANTEN",23,69,157,226
https://kawalpemilu.org#52312,"PASIR NANGKA, TIGARAKSA, TANGERANG, BANTEN",24,77,144,221
https://kawalpemilu.org#52312,"PASIR NANGKA, TIGARAKSA, TANGERANG, BANTEN",25,85,178,263
https://kawalpemilu.org#52312,"PASIR NANGKA, TIGARAKSA, TANGERANG, BANTEN",26,53,108,161
https://kawalpemilu.org#52312,"PASIR NANGKA, TIGARAKSA, TANGERANG, BANTEN",27,23,77,100
https://kawalpemilu.org#52312,"PASIR NANGKA, TIGARAKSA, TANGERANG, BANTEN",28,65,99,164
https://kawalpemilu.org#52312,"PASIR NANGKA, TIGARAKSA, TANGERANG, BANTEN",30,99,108,207
https://kawalpemilu.org#52312,"PASIR NANGKA, TIGARAKSA, TANGERANG, BANTEN",31,48,132,180
https://kawalpemilu.org#52312,"PASIR NANGKA, TIGARAKSA, TANGERANG, BANTEN",32,64,138,206
https://kawalpemilu.org#52312,"PASIR NANGKA, TIGARAKSA, TANGERANG, BANTEN",33,55,121,176
https://kawalpemilu.org#52312,"PASIR NANGKA, TIGARAKSA, TANGERANG, BANTEN",34,61,126,187
https://kawalpemilu.org#52312,"PASIR NANGKA, TIGARAKSA, TANGERANG, BANTEN",35,33,127,160
https://kawalpemilu.org#52312,"PASIR NANGKA, TIGARAKSA, TANGERANG, BANTEN",36,44,146,190
https://kawalpemilu.org#52312,"PASIR NANGKA, TIGARAKSA, TANGERANG, BANTEN",37,44,151,195
https://kawalpemilu.org#52312,"PASIR NANGKA, TIGARAKSA, TANGERANG, BANTEN",38,41,125,166
https://kawalpemilu.org#52312,"PASIR NANGKA, TIGARAKSA, TANGERANG, BANTEN",39,104,126,230
https://kawalpemilu.org#52312,"PASIR NANGKA, TIGARAKSA, TANGERANG, BANTEN",40,77,140,217
https://kawalpemilu.org#52312,"PASIR NANGKA, TIGARAKSA, TANGERANG, BANTEN",41,84,130,214
https://kawalpemilu.org#52312,"PASIR NANGKA, TIGARAKSA, TANGERANG, BANTEN",42,96,126,222
https://kawalpemilu.org#52312,"PASIR NANGKA, TIGARAKSA, TANGERANG, BANTEN",43,68,145,213
https://kawalpemilu.org#52312,"PASIR NANGKA, TIGARAKSA, TANGERANG, BANTEN",44,66,135,201
https://kawalpemilu.org#52312,"PASIR NANGKA, TIGARAKSA, TANGERANG, BANTEN",45,78,139,217
https://kawalpemilu.org#52312,"PASIR NANGKA, TIGARAKSA, TANGERANG, BANTEN",46,82,132,214
https://kawalpemilu.org#52312,"PASIR NANGKA, TIGARAKSA, TANGERANG, BANTEN",47,65,156,221
https://kawalpemilu.org#52312,"PASIR NANGKA, TIGARAKSA, TANGERANG, BANTEN",51,79,110,189
https://kawalpemilu.org#52312,"PASIR NANGKA, TIGARAKSA, TANGERANG, BANTEN",52,82,130,212
https://kawalpemilu.org#52312,"PASIR NANGKA, TIGARAKSA, TANGERANG, BANTEN",53,75,138,213
https://kawalpemilu.org#52312,"PASIR NANGKA, TIGARAKSA, TANGERANG, BANTEN",54,130,83,213
https://kawalpemilu.org#52312,"PASIR NANGKA, TIGARAKSA, TANGERANG, BANTEN",55,89,118,207
https://kawalpemilu.org#52312,"PASIR NANGKA, TIGARAKSA, TANGERANG, BANTEN",56,66,147,213
https://kawalpemilu.org#52312,"PASIR NANGKA, TIGARAKSA, TANGERANG, BANTEN",57,94,150,244
https://kawalpemilu.org#52312,"PASIR NANGKA, TIGARAKSA, TANGERANG, BANTEN",58,72,124,196
https://kawalpemilu.org#52312,"PASIR NANGKA, TIGARAKSA, TANGERANG, BANTEN",59,132,137,269
https://kawalpemilu.org#52312,"PASIR NANGKA, TIGARAKSA, TANGERANG, BANTEN",60,127,144,271
https://kawalpemilu.org#52312,"PASIR NANGKA, TIGARAKSA, TANGERANG, BANTEN",61,107,159,266
https://kawalpemilu.org#52312,"PASIR NANGKA, TIGARAKSA, TANGERANG, BANTEN",62,101,167,268
https://kawalpemilu.org#52312,"PASIR NANGKA, TIGARAKSA, TANGERANG, BANTEN",63,116,160,276
https://kawalpemilu.org#52313,"PETE, TIGARAKSA, TANGERANG, BANTEN",1,48,126,174
https://kawalpemilu.org#52313,"PETE, TIGARAKSA, TANGERANG, BANTEN",2,76,112,188
https://kawalpemilu.org#52313,"PETE, TIGARAKSA, TANGERANG, BANTEN",3,106,102,208
https://kawalpemilu.org#52313,"PETE, TIGARAKSA, TANGERANG, BANTEN",4,55,139,194
https://kawalpemilu.org#52313,"PETE, TIGARAKSA, TANGERANG, BANTEN",5,48,151,199
https://kawalpemilu.org#52313,"PETE, TIGARAKSA, TANGERANG, BANTEN",6,34,140,174
https://kawalpemilu.org#52313,"PETE, TIGARAKSA, TANGERANG, BANTEN",7,35,129,164
https://kawalpemilu.org#52313,"PETE, TIGARAKSA, TANGERANG, BANTEN",8,72,107,179
https://kawalpemilu.org#52313,"PETE, TIGARAKSA, TANGERANG, BANTEN",9,58,79,137
https://kawalpemilu.org#52313,"PETE, TIGARAKSA, TANGERANG, BANTEN",10,62,79,141
https://kawalpemilu.org#52313,"PETE, TIGARAKSA, TANGERANG, BANTEN",11,53,129,182
https://kawalpemilu.org#52313,"PETE, TIGARAKSA, TANGERANG, BANTEN",12,26,148,174
https://kawalpemilu.org#52313,"PETE, TIGARAKSA, TANGERANG, BANTEN",13,54,121,175
https://kawalpemilu.org#52313,"PETE, TIGARAKSA, TANGERANG, BANTEN",14,40,107,147
https://kawalpemilu.org#52313,"PETE, TIGARAKSA, TANGERANG, BANTEN",15,54,131,167
https://kawalpemilu.org#52313,"PETE, TIGARAKSA, TANGERANG, BANTEN",16,44,99,2
https://kawalpemilu.org#52313,"PETE, TIGARAKSA, TANGERANG, BANTEN",17,64,125,189
https://kawalpemilu.org#52313,"PETE, TIGARAKSA, TANGERANG, BANTEN",18,67,126,193
https://kawalpemilu.org#52313,"PETE, TIGARAKSA, TANGERANG, BANTEN",19,86,131,217
https://kawalpemilu.org#52313,"PETE, TIGARAKSA, TANGERANG, BANTEN",20,76,187,263
https://kawalpemilu.org#52313,"PETE, TIGARAKSA, TANGERANG, BANTEN",21,76,163,239
https://kawalpemilu.org#52313,"PETE, TIGARAKSA, TANGERANG, BANTEN",22,72,163,235
https://kawalpemilu.org#52313,"PETE, TIGARAKSA, TANGERANG, BANTEN",23,70,93,163
https://kawalpemilu.org#52313,"PETE, TIGARAKSA, TANGERANG, BANTEN",24,71,89,160
https://kawalpemilu.org#52313,"PETE, TIGARAKSA, TANGERANG, BANTEN",25,71,118,189
https://kawalpemilu.org#52313,"PETE, TIGARAKSA, TANGERANG, BANTEN",26,84,82,166
https://kawalpemilu.org#52313,"PETE, TIGARAKSA, TANGERANG, BANTEN",27,67,132,199
https://kawalpemilu.org#52313,"PETE, TIGARAKSA, TANGERANG, BANTEN",28,71,126,197
https://kawalpemilu.org#52313,"PETE, TIGARAKSA, TANGERANG, BANTEN",29,89,70,159
https://kawalpemilu.org#52313,"PETE, TIGARAKSA, TANGERANG, BANTEN",30,77,77,154
https://kawalpemilu.org#52313,"PETE, TIGARAKSA, TANGERANG, BANTEN",31,94,108,202
https://kawalpemilu.org#52313,"PETE, TIGARAKSA, TANGERANG, BANTEN",32,68,165,233
https://kawalpemilu.org#52313,"PETE, TIGARAKSA, TANGERANG, BANTEN",33,74,106,180
https://kawalpemilu.org#52313,"PETE, TIGARAKSA, TANGERANG, BANTEN",34,53,110,163
https://kawalpemilu.org#52313,"PETE, TIGARAKSA, TANGERANG, BANTEN",35,64,105,169
https://kawalpemilu.org#52313,"PETE, TIGARAKSA, TANGERANG, BANTEN",36,51,101,152
https://kawalpemilu.org#52313,"PETE, TIGARAKSA, TANGERANG, BANTEN",37,56,130,186
https://kawalpemilu.org#52313,"PETE, TIGARAKSA, TANGERANG, BANTEN",38,60,117,177
https://kawalpemilu.org#52313,"PETE, TIGARAKSA, TANGERANG, BANTEN",39,59,95,154
https://kawalpemilu.org#52313,"PETE, TIGARAKSA, TANGERANG, BANTEN",40,48,97,145
https://kawalpemilu.org#52313,"PETE, TIGARAKSA, TANGERANG, BANTEN",41,84,96,180
https://kawalpemilu.org#52313,"PETE, TIGARAKSA, TANGERANG, BANTEN",42,66,91,157
https://kawalpemilu.org#52313,"PETE, TIGARAKSA, TANGERANG, BANTEN",43,129,116,245
https://kawalpemilu.org#52313,"PETE, TIGARAKSA, TANGERANG, BANTEN",44,86,90,176
https://kawalpemilu.org#52313,"PETE, TIGARAKSA, TANGERANG, BANTEN",45,57,110,167
https://kawalpemilu.org#52314,"TEGALSARI, TIGARAKSA, TANGERANG, BANTEN",1,66,132,198
https://kawalpemilu.org#52314,"TEGALSARI, TIGARAKSA, TANGERANG, BANTEN",2,106,135,241
https://kawalpemilu.org#52314,"TEGALSARI, TIGARAKSA, TANGERANG, BANTEN",4,54,106,160
https://kawalpemilu.org#52314,"TEGALSARI, TIGARAKSA, TANGERANG, BANTEN",5,135,106,241
https://kawalpemilu.org#52314,"TEGALSARI, TIGARAKSA, TANGERANG, BANTEN",6,48,80,128
https://kawalpemilu.org#52314,"TEGALSARI, TIGARAKSA, TANGERANG, BANTEN",7,65,100,165
https://kawalpemilu.org#52314,"TEGALSARI, TIGARAKSA, TANGERANG, BANTEN",8,79,156,235
https://kawalpemilu.org#52314,"TEGALSARI, TIGARAKSA, TANGERANG, BANTEN",9,91,105,196
https://kawalpemilu.org#52314,"TEGALSARI, TIGARAKSA, TANGERANG, BANTEN",10,71,97,168
https://kawalpemilu.org#52314,"TEGALSARI, TIGARAKSA, TANGERANG, BANTEN",11,68,88,156
https://kawalpemilu.org#52314,"TEGALSARI, TIGARAKSA, TANGERANG, BANTEN",12,50,150,200
https://kawalpemilu.org#52314,"TEGALSARI, TIGARAKSA, TANGERANG, BANTEN",13,48,175,223
https://kawalpemilu.org#52314,"TEGALSARI, TIGARAKSA, TANGERANG, BANTEN",14,82,146,228
https://kawalpemilu.org#52315,"PEMATANG, TIGARAKSA, TANGERANG, BANTEN",2,61,107,168
https://kawalpemilu.org#52315,"PEMATANG, TIGARAKSA, TANGERANG, BANTEN",3,37,151,188
https://kawalpemilu.org#52315,"PEMATANG, TIGARAKSA, TANGERANG, BANTEN",4,57,162,219
https://kawalpemilu.org#52315,"PEMATANG, TIGARAKSA, TANGERANG, BANTEN",6,97,123,220
https://kawalpemilu.org#52315,"PEMATANG, TIGARAKSA, TANGERANG, BANTEN",7,35,191,226
https://kawalpemilu.org#52315,"PEMATANG, TIGARAKSA, TANGERANG, BANTEN",8,58,159,217
https://kawalpemilu.org#52315,"PEMATANG, TIGARAKSA, TANGERANG, BANTEN",9,82,121,203
https://kawalpemilu.org#52315,"PEMATANG, TIGARAKSA, TANGERANG, BANTEN",10,82,143,225
https://kawalpemilu.org#52315,"PEMATANG, TIGARAKSA, TANGERANG, BANTEN",11,116,119,235
https://kawalpemilu.org#52315,"PEMATANG, TIGARAKSA, TANGERANG, BANTEN",12,33,159,192
https://kawalpemilu.org#52315,"PEMATANG, TIGARAKSA, TANGERANG, BANTEN",13,103,119,222
https://kawalpemilu.org#52315,"PEMATANG, TIGARAKSA, TANGERANG, BANTEN",14,84,131,215
https://kawalpemilu.org#52315,"PEMATANG, TIGARAKSA, TANGERANG, BANTEN",15,99,138,237
https://kawalpemilu.org#52315,"PEMATANG, TIGARAKSA, TANGERANG, BANTEN",16,100,141,241
https://kawalpemilu.org#52315,"PEMATANG, TIGARAKSA, TANGERANG, BANTEN",19,46,171,217
https://kawalpemilu.org#52315,"PEMATANG, TIGARAKSA, TANGERANG, BANTEN",20,41,185,226
https://kawalpemilu.org#52315,"PEMATANG, TIGARAKSA, TANGERANG, BANTEN",21,50,59,109
https://kawalpemilu.org#52315,"PEMATANG, TIGARAKSA, TANGERANG, BANTEN",22,47,74,121
https://kawalpemilu.org#52315,"PEMATANG, TIGARAKSA, TANGERANG, BANTEN",23,22,102,124
https://kawalpemilu.org#52315,"PEMATANG, TIGARAKSA, TANGERANG, BANTEN",24,25,134,159
https://kawalpemilu.org#52315,"PEMATANG, TIGARAKSA, TANGERANG, BANTEN",26,95,128,223
https://kawalpemilu.org#52315,"PEMATANG, TIGARAKSA, TANGERANG, BANTEN",27,122,143,265
https://kawalpemilu.org#52316,"CISEREH, TIGARAKSA, TANGERANG, BANTEN",1,70,109,179
https://kawalpemilu.org#52316,"CISEREH, TIGARAKSA, TANGERANG, BANTEN",2,50,117,167
https://kawalpemilu.org#52316,"CISEREH, TIGARAKSA, TANGERANG, BANTEN",3,39,132,171
https://kawalpemilu.org#52316,"CISEREH, TIGARAKSA, TANGERANG, BANTEN",4,40,176,216
https://kawalpemilu.org#52316,"CISEREH, TIGARAKSA, TANGERANG, BANTEN",5,39,191,230
https://kawalpemilu.org#52316,"CISEREH, TIGARAKSA, TANGERANG, BANTEN",6,42,149,191
https://kawalpemilu.org#52316,"CISEREH, TIGARAKSA, TANGERANG, BANTEN",7,24,166,190
https://kawalpemilu.org#52316,"CISEREH, TIGARAKSA, TANGERANG, BANTEN",8,30,152,182
https://kawalpemilu.org#52316,"CISEREH, TIGARAKSA, TANGERANG, BANTEN",9,62,138,200
https://kawalpemilu.org#52316,"CISEREH, TIGARAKSA, TANGERANG, BANTEN",10,64,153,217
https://kawalpemilu.org#52316,"CISEREH, TIGARAKSA, TANGERANG, BANTEN",12,90,133,223
https://kawalpemilu.org#52316,"CISEREH, TIGARAKSA, TANGERANG, BANTEN",13,40,175,215
https://kawalpemilu.org#52316,"CISEREH, TIGARAKSA, TANGERANG, BANTEN",14,41,186,227
https://kawalpemilu.org#52316,"CISEREH, TIGARAKSA, TANGERANG, BANTEN",15,60,173,233
https://kawalpemilu.org#52316,"CISEREH, TIGARAKSA, TANGERANG, BANTEN",16,32,200,232
https://kawalpemilu.org#52316,"CISEREH, TIGARAKSA, TANGERANG, BANTEN",17,78,137,215
https://kawalpemilu.org#52317,"MARGASARI, TIGARAKSA, TANGERANG, BANTEN",1,47,124,171
https://kawalpemilu.org#52317,"MARGASARI, TIGARAKSA, TANGERANG, BANTEN",2,54,153,207
https://kawalpemilu.org#52317,"MARGASARI, TIGARAKSA, TANGERANG, BANTEN",3,50,148,198
https://kawalpemilu.org#52317,"MARGASARI, TIGARAKSA, TANGERANG, BANTEN",4,39,154,193
https://kawalpemilu.org#52317,"MARGASARI, TIGARAKSA, TANGERANG, BANTEN",5,62,173,235
https://kawalpemilu.org#52317,"MARGASARI, TIGARAKSA, TANGERANG, BANTEN",6,67,168,235
https://kawalpemilu.org#52317,"MARGASARI, TIGARAKSA, TANGERANG, BANTEN",7,61,134,195
https://kawalpemilu.org#52317,"MARGASARI, TIGARAKSA, TANGERANG, BANTEN",8,61,103,164
https://kawalpemilu.org#52317,"MARGASARI, TIGARAKSA, TANGERANG, BANTEN",9,58,80,138
https://kawalpemilu.org#52317,"MARGASARI, TIGARAKSA, TANGERANG, BANTEN",10,50,107,157
https://kawalpemilu.org#52317,"MARGASARI, TIGARAKSA, TANGERANG, BANTEN",11,22,71,93
https://kawalpemilu.org#52317,"MARGASARI, TIGARAKSA, TANGERANG, BANTEN",12,21,121,142
https://kawalpemilu.org#52317,"MARGASARI, TIGARAKSA, TANGERANG, BANTEN",13,28,146,174
https://kawalpemilu.org#52317,"MARGASARI, TIGARAKSA, TANGERANG, BANTEN",14,45,143,188
https://kawalpemilu.org#52317,"MARGASARI, TIGARAKSA, TANGERANG, BANTEN",15,45,137,182
https://kawalpemilu.org#52317,"MARGASARI, TIGARAKSA, TANGERANG, BANTEN",16,62,152,214
https://kawalpemilu.org#52317,"MARGASARI, TIGARAKSA, TANGERANG, BANTEN",17,37,157,194
https://kawalpemilu.org#52317,"MARGASARI, TIGARAKSA, TANGERANG, BANTEN",18,33,166,199
https://kawalpemilu.org#52317,"MARGASARI, TIGARAKSA, TANGERANG, BANTEN",19,49,151,200
https://kawalpemilu.org#52317,"MARGASARI, TIGARAKSA, TANGERANG, BANTEN",20,57,158,215
https://kawalpemilu.org#52317,"MARGASARI, TIGARAKSA, TANGERANG, BANTEN",21,143,89,232
https://kawalpemilu.org#52317,"MARGASARI, TIGARAKSA, TANGERANG, BANTEN",22,105,83,188
https://kawalpemilu.org#52317,"MARGASARI, TIGARAKSA, TANGERANG, BANTEN",23,116,111,227
https://kawalpemilu.org#52317,"MARGASARI, TIGARAKSA, TANGERANG, BANTEN",24,81,69,150
https://kawalpemilu.org#52317,"MARGASARI, TIGARAKSA, TANGERANG, BANTEN",25,105,102,207
https://kawalpemilu.org#52317,"MARGASARI, TIGARAKSA, TANGERANG, BANTEN",26,114,70,184
https://kawalpemilu.org#52317,"MARGASARI, TIGARAKSA, TANGERANG, BANTEN",27,101,80,181
https://kawalpemilu.org#52317,"MARGASARI, TIGARAKSA, TANGERANG, BANTEN",28,117,87,204
https://kawalpemilu.org#52317,"MARGASARI, TIGARAKSA, TANGERANG, BANTEN",29,119,93,212
https://kawalpemilu.org#52317,"MARGASARI, TIGARAKSA, TANGERANG, BANTEN",30,107,61,168
https://kawalpemilu.org#52317,"MARGASARI, TIGARAKSA, TANGERANG, BANTEN",31,134,88,222
https://kawalpemilu.org#52317,"MARGASARI, TIGARAKSA, TANGERANG, BANTEN",32,106,110,216
https://kawalpemilu.org#52317,"MARGASARI, TIGARAKSA, TANGERANG, BANTEN",33,103,84,187
https://kawalpemilu.org#52317,"MARGASARI, TIGARAKSA, TANGERANG, BANTEN",34,106,70,176
https://kawalpemilu.org#52317,"MARGASARI, TIGARAKSA, TANGERANG, BANTEN",35,103,81,184
https://kawalpemilu.org#52317,"MARGASARI, TIGARAKSA, TANGERANG, BANTEN",36,77,82,159
https://kawalpemilu.org#52317,"MARGASARI, TIGARAKSA, TANGERANG, BANTEN",37,131,78,209
https://kawalpemilu.org#52317,"MARGASARI, TIGARAKSA, TANGERANG, BANTEN",38,136,67,203
https://kawalpemilu.org#52317,"MARGASARI, TIGARAKSA, TANGERANG, BANTEN",39,195,90,285
https://kawalpemilu.org#52317,"MARGASARI, TIGARAKSA, TANGERANG, BANTEN",40,137,73,210
https://kawalpemilu.org#52317,"MARGASARI, TIGARAKSA, TANGERANG, BANTEN",41,124,58,182
https://kawalpemilu.org#52317,"MARGASARI, TIGARAKSA, TANGERANG, BANTEN",42,58,80,138
https://kawalpemilu.org#52318,"CILELES, TIGARAKSA, TANGERANG, BANTEN",1,54,73,127
https://kawalpemilu.org#52318,"CILELES, TIGARAKSA, TANGERANG, BANTEN",2,81,92,173
https://kawalpemilu.org#52318,"CILELES, TIGARAKSA, TANGERANG, BANTEN",3,126,111,237
https://kawalpemilu.org#52318,"CILELES, TIGARAKSA, TANGERANG, BANTEN",4,67,83,150
https://kawalpemilu.org#52318,"CILELES, TIGARAKSA, TANGERANG, BANTEN",5,49,68,117
https://kawalpemilu.org#52318,"CILELES, TIGARAKSA, TANGERANG, BANTEN",6,105,66,171
https://kawalpemilu.org#52318,"CILELES, TIGARAKSA, TANGERANG, BANTEN",7,94,74,168
https://kawalpemilu.org#52318,"CILELES, TIGARAKSA, TANGERANG, BANTEN",8,76,144,220
https://kawalpemilu.org#52318,"CILELES, TIGARAKSA, TANGERANG, BANTEN",9,58,92,150
https://kawalpemilu.org#52318,"CILELES, TIGARAKSA, TANGERANG, BANTEN",10,39,154,193
https://kawalpemilu.org#52318,"CILELES, TIGARAKSA, TANGERANG, BANTEN",11,56,119,175
https://kawalpemilu.org#52318,"CILELES, TIGARAKSA, TANGERANG, BANTEN",12,52,161,213
https://kawalpemilu.org#52318,"CILELES, TIGARAKSA, TANGERANG, BANTEN",13,73,173,246
https://kawalpemilu.org#52318,"CILELES, TIGARAKSA, TANGERANG, BANTEN",14,131,81,215
https://kawalpemilu.org#52318,"CILELES, TIGARAKSA, TANGERANG, BANTEN",15,123,71,194
https://kawalpemilu.org#52318,"CILELES, TIGARAKSA, TANGERANG, BANTEN",16,113,114,227
https://kawalpemilu.org#52318,"CILELES, TIGARAKSA, TANGERANG, BANTEN",17,104,119,223
https://kawalpemilu.org#52318,"CILELES, TIGARAKSA, TANGERANG, BANTEN",18,112,106,218
https://kawalpemilu.org#52318,"CILELES, TIGARAKSA, TANGERANG, BANTEN",19,82,92,174
https://kawalpemilu.org#52318,"CILELES, TIGARAKSA, TANGERANG, BANTEN",20,54,145,199
https://kawalpemilu.org#52318,"CILELES, TIGARAKSA, TANGERANG, BANTEN",21,113,114,227
https://kawalpemilu.org#52318,"CILELES, TIGARAKSA, TANGERANG, BANTEN",22,88,138,226
https://kawalpemilu.org#52318,"CILELES, TIGARAKSA, TANGERANG, BANTEN",23,55,131,186
https://kawalpemilu.org#52318,"CILELES, TIGARAKSA, TANGERANG, BANTEN",24,77,108,185
https://kawalpemilu.org#52318,"CILELES, TIGARAKSA, TANGERANG, BANTEN",25,48,142,190
https://kawalpemilu.org#52318,"CILELES, TIGARAKSA, TANGERANG, BANTEN",26,98,93,191
https://kawalpemilu.org#52319,"SODONG, TIGARAKSA, TANGERANG, BANTEN",1,94,152,246
https://kawalpemilu.org#52319,"SODONG, TIGARAKSA, TANGERANG, BANTEN",2,95,101,196
https://kawalpemilu.org#52319,"SODONG, TIGARAKSA, TANGERANG, BANTEN",3,134,134,268
https://kawalpemilu.org#52319,"SODONG, TIGARAKSA, TANGERANG, BANTEN",4,57,141,198
https://kawalpemilu.org#52319,"SODONG, TIGARAKSA, TANGERANG, BANTEN",5,145,130,7
https://kawalpemilu.org#52319,"SODONG, TIGARAKSA, TANGERANG, BANTEN",6,83,113,196
https://kawalpemilu.org#52319,"SODONG, TIGARAKSA, TANGERANG, BANTEN",7,67,116,183
https://kawalpemilu.org#52319,"SODONG, TIGARAKSA, TANGERANG, BANTEN",8,79,145,224
https://kawalpemilu.org#52319,"SODONG, TIGARAKSA, TANGERANG, BANTEN",9,59,123,182
https://kawalpemilu.org#52319,"SODONG, TIGARAKSA, TANGERANG, BANTEN",10,73,115,188
https://kawalpemilu.org#52319,"SODONG, TIGARAKSA, TANGERANG, BANTEN",11,106,120,226
https://kawalpemilu.org#52319,"SODONG, TIGARAKSA, TANGERANG, BANTEN",12,108,89,197
https://kawalpemilu.org#52319,"SODONG, TIGARAKSA, TANGERANG, BANTEN",13,63,128,191
https://kawalpemilu.org#52319,"SODONG, TIGARAKSA, TANGERANG, BANTEN",14,104,106,210
https://kawalpemilu.org#52319,"SODONG, TIGARAKSA, TANGERANG, BANTEN",15,139,99,238
https://kawalpemilu.org#52319,"SODONG, TIGARAKSA, TANGERANG, BANTEN",16,46,143,189
https://kawalpemilu.org#52319,"SODONG, TIGARAKSA, TANGERANG, BANTEN",17,151,166,317
https://kawalpemilu.org#52319,"SODONG, TIGARAKSA, TANGERANG, BANTEN",18,105,110,215
https://kawalpemilu.org#52319,"SODONG, TIGARAKSA, TANGERANG, BANTEN",19,123,86,209
https://kawalpemilu.org#52319,"SODONG, TIGARAKSA, TANGERANG, BANTEN",20,52,129,181
https://kawalpemilu.org#52319,"SODONG, TIGARAKSA, TANGERANG, BANTEN",21,75,98,173
https://kawalpemilu.org#52319,"SODONG, TIGARAKSA, TANGERANG, BANTEN",22,57,125,182
https://kawalpemilu.org#52319,"SODONG, TIGARAKSA, TANGERANG, BANTEN",23,62,125,187
https://kawalpemilu.org#52319,"SODONG, TIGARAKSA, TANGERANG, BANTEN",25,136,94,230
https://kawalpemilu.org#52320,"TAPOS, TIGARAKSA, TANGERANG, BANTEN",1,79,123,202
https://kawalpemilu.org#52320,"TAPOS, TIGARAKSA, TANGERANG, BANTEN",2,47,91,138
https://kawalpemilu.org#52320,"TAPOS, TIGARAKSA, TANGERANG, BANTEN",3,36,170,206
https://kawalpemilu.org#52320,"TAPOS, TIGARAKSA, TANGERANG, BANTEN",4,33,143,176
https://kawalpemilu.org#52320,"TAPOS, TIGARAKSA, TANGERANG, BANTEN",5,65,137,202
https://kawalpemilu.org#52320,"TAPOS, TIGARAKSA, TANGERANG, BANTEN",6,44,139,183
https://kawalpemilu.org#52320,"TAPOS, TIGARAKSA, TANGERANG, BANTEN",7,47,192,239
https://kawalpemilu.org#52320,"TAPOS, TIGARAKSA, TANGERANG, BANTEN",8,39,168,207
https://kawalpemilu.org#52320,"TAPOS, TIGARAKSA, TANGERANG, BANTEN",9,41,179,220
https://kawalpemilu.org#52320,"TAPOS, TIGARAKSA, TANGERANG, BANTEN",10,70,169,239
https://kawalpemilu.org#52320,"TAPOS, TIGARAKSA, TANGERANG, BANTEN",11,55,162,217
https://kawalpemilu.org#52320,"TAPOS, TIGARAKSA, TANGERANG, BANTEN",12,38,212,250
https://kawalpemilu.org#52320,"TAPOS, TIGARAKSA, TANGERANG, BANTEN",13,26,205,231
https://kawalpemilu.org#52320,"TAPOS, TIGARAKSA, TANGERANG, BANTEN",14,36,208,244
https://kawalpemilu.org#52320,"TAPOS, TIGARAKSA, TANGERANG, BANTEN",15,48,206,254
https://kawalpemilu.org#52320,"TAPOS, TIGARAKSA, TANGERANG, BANTEN",16,66,186,252
https://kawalpemilu.org#52320,"TAPOS, TIGARAKSA, TANGERANG, BANTEN",17,59,141,200
https://kawalpemilu.org#52320,"TAPOS, TIGARAKSA, TANGERANG, BANTEN",18,48,135,183
https://kawalpemilu.org#52320,"TAPOS, TIGARAKSA, TANGERANG, BANTEN",19,39,144,183
https://kawalpemilu.org#52320,"TAPOS, TIGARAKSA, TANGERANG, BANTEN",20,40,122,162
https://kawalpemilu.org#52320,"TAPOS, TIGARAKSA, TANGERANG, BANTEN",21,25,127,152
https://kawalpemilu.org#52320,"TAPOS, TIGARAKSA, TANGERANG, BANTEN",22,42,115,157
https://kawalpemilu.org#52320,"TAPOS, TIGARAKSA, TANGERANG, BANTEN",23,39,115,154
https://kawalpemilu.org#52320,"TAPOS, TIGARAKSA, TANGERANG, BANTEN",24,66,142,208
https://kawalpemilu.org#52320,"TAPOS, TIGARAKSA, TANGERANG, BANTEN",25,62,129,191
https://kawalpemilu.org#52321,"BANTAR PANJANG, TIGARAKSA, TANGERANG, BANTEN",1,45,131,176
https://kawalpemilu.org#52321,"BANTAR PANJANG, TIGARAKSA, TANGERANG, BANTEN",2,62,175,237
https://kawalpemilu.org#52321,"BANTAR PANJANG, TIGARAKSA, TANGERANG, BANTEN",3,63,104,167
https://kawalpemilu.org#52321,"BANTAR PANJANG, TIGARAKSA, TANGERANG, BANTEN",4,48,123,171
https://kawalpemilu.org#52321,"BANTAR PANJANG, TIGARAKSA, TANGERANG, BANTEN",5,68,88,156
https://kawalpemilu.org#52321,"BANTAR PANJANG, TIGARAKSA, TANGERANG, BANTEN",6,55,107,162
https://kawalpemilu.org#52321,"BANTAR PANJANG, TIGARAKSA, TANGERANG, BANTEN",8,68,113,181
https://kawalpemilu.org#52321,"BANTAR PANJANG, TIGARAKSA, TANGERANG, BANTEN",9,59,136,195
https://kawalpemilu.org#52321,"BANTAR PANJANG, TIGARAKSA, TANGERANG, BANTEN",10,44,141,185
https://kawalpemilu.org#52321,"BANTAR PANJANG, TIGARAKSA, TANGERANG, BANTEN",11,84,152,236
https://kawalpemilu.org#52321,"BANTAR PANJANG, TIGARAKSA, TANGERANG, BANTEN",13,76,129,205
https://kawalpemilu.org#52321,"BANTAR PANJANG, TIGARAKSA, TANGERANG, BANTEN",14,61,178,239
https://kawalpemilu.org#52321,"BANTAR PANJANG, TIGARAKSA, TANGERANG, BANTEN",15,72,100,172
https://kawalpemilu.org#52321,"BANTAR PANJANG, TIGARAKSA, TANGERANG, BANTEN",16,34,115,149
https://kawalpemilu.org#52321,"BANTAR PANJANG, TIGARAKSA, TANGERANG, BANTEN",17,130,129,259
https://kawalpemilu.org#52321,"BANTAR PANJANG, TIGARAKSA, TANGERANG, BANTEN",18,38,97,135
https://kawalpemilu.org#52321,"BANTAR PANJANG, TIGARAKSA, TANGERANG, BANTEN",19,49,101,150
https://kawalpemilu.org#52321,"BANTAR PANJANG, TIGARAKSA, TANGERANG, BANTEN",20,59,60,119
https://kawalpemilu.org#52321,"BANTAR PANJANG, TIGARAKSA, TANGERANG, BANTEN",21,74,90,164
https://kawalpemilu.org#52321,"BANTAR PANJANG, TIGARAKSA, TANGERANG, BANTEN",22,85,127,212
https://kawalpemilu.org#52323,"SUKAMANAH, JAMBE, TANGERANG, BANTEN",1,82,135,217
https://kawalpemilu.org#52323,"SUKAMANAH, JAMBE, TANGERANG, BANTEN",2,33,108,141
https://kawalpemilu.org#52323,"SUKAMANAH, JAMBE, TANGERANG, BANTEN",3,30,152,182
https://kawalpemilu.org#52323,"SUKAMANAH, JAMBE, TANGERANG, BANTEN",4,58,109,167
https://kawalpemilu.org#52323,"SUKAMANAH, JAMBE, TANGERANG, BANTEN",5,79,75,154
https://kawalpemilu.org#52323,"SUKAMANAH, JAMBE, TANGERANG, BANTEN",6,94,130,224
https://kawalpemilu.org#52323,"SUKAMANAH, JAMBE, TANGERANG, BANTEN",7,123,106,229
https://kawalpemilu.org#52323,"SUKAMANAH, JAMBE, TANGERANG, BANTEN",8,50,144,194
https://kawalpemilu.org#52323,"SUKAMANAH, JAMBE, TANGERANG, BANTEN",9,56,115,171
https://kawalpemilu.org#52323,"SUKAMANAH, JAMBE, TANGERANG, BANTEN",10,78,111,189
https://kawalpemilu.org#52323,"SUKAMANAH, JAMBE, TANGERANG, BANTEN",11,62,149,211
https://kawalpemilu.org#52323,"SUKAMANAH, JAMBE, TANGERANG, BANTEN",13,67,79,146
https://kawalpemilu.org#52324,"JAMBE, JAMBE, TANGERANG, BANTEN",1,57,183,240
https://kawalpemilu.org#52324,"JAMBE, JAMBE, TANGERANG, BANTEN",2,62,122,184
https://kawalpemilu.org#52324,"JAMBE, JAMBE, TANGERANG, BANTEN",3,69,174,243
https://kawalpemilu.org#52324,"JAMBE, JAMBE, TANGERANG, BANTEN",4,72,202,274
https://kawalpemilu.org#52324,"JAMBE, JAMBE, TANGERANG, BANTEN",6,69,146,215
https://kawalpemilu.org#52324,"JAMBE, JAMBE, TANGERANG, BANTEN",7,60,207,267
https://kawalpemilu.org#52324,"JAMBE, JAMBE, TANGERANG, BANTEN",8,84,149,233
https://kawalpemilu.org#52324,"JAMBE, JAMBE, TANGERANG, BANTEN",9,89,172,261
https://kawalpemilu.org#52324,"JAMBE, JAMBE, TANGERANG, BANTEN",10,49,165,214
https://kawalpemilu.org#52324,"JAMBE, JAMBE, TANGERANG, BANTEN",11,119,151,270
https://kawalpemilu.org#52324,"JAMBE, JAMBE, TANGERANG, BANTEN",12,50,175,225
https://kawalpemilu.org#52324,"JAMBE, JAMBE, TANGERANG, BANTEN",14,148,140,288
https://kawalpemilu.org#52324,"JAMBE, JAMBE, TANGERANG, BANTEN",15,85,131,216
https://kawalpemilu.org#52324,"JAMBE, JAMBE, TANGERANG, BANTEN",16,74,142,216
https://kawalpemilu.org#52325,"TIPAR RAYA, JAMBE, TANGERANG, BANTEN",1,48,147,195
https://kawalpemilu.org#52325,"TIPAR RAYA, JAMBE, TANGERANG, BANTEN",2,62,120,182
https://kawalpemilu.org#52325,"TIPAR RAYA, JAMBE, TANGERANG, BANTEN",3,77,126,203
https://kawalpemilu.org#52325,"TIPAR RAYA, JAMBE, TANGERANG, BANTEN",4,53,169,222
https://kawalpemilu.org#52325,"TIPAR RAYA, JAMBE, TANGERANG, BANTEN",5,64,139,203
https://kawalpemilu.org#52325,"TIPAR RAYA, JAMBE, TANGERANG, BANTEN",6,65,161,226
https://kawalpemilu.org#52325,"TIPAR RAYA, JAMBE, TANGERANG, BANTEN",7,50,132,184
https://kawalpemilu.org#52325,"TIPAR RAYA, JAMBE, TANGERANG, BANTEN",8,32,131,163
https://kawalpemilu.org#52325,"TIPAR RAYA, JAMBE, TANGERANG, BANTEN",9,63,122,185
https://kawalpemilu.org#52325,"TIPAR RAYA, JAMBE, TANGERANG, BANTEN",10,52,175,227
https://kawalpemilu.org#52325,"TIPAR RAYA, JAMBE, TANGERANG, BANTEN",11,79,144,223
https://kawalpemilu.org#52325,"TIPAR RAYA, JAMBE, TANGERANG, BANTEN",12,79,135,214
https://kawalpemilu.org#52325,"TIPAR RAYA, JAMBE, TANGERANG, BANTEN",13,48,144,192
https://kawalpemilu.org#52326,"TABAN, JAMBE, TANGERANG, BANTEN",1,78,154,232
https://kawalpemilu.org#52326,"TABAN, JAMBE, TANGERANG, BANTEN",3,47,161,208
https://kawalpemilu.org#52326,"TABAN, JAMBE, TANGERANG, BANTEN",5,68,187,255
https://kawalpemilu.org#52326,"TABAN, JAMBE, TANGERANG, BANTEN",6,67,164,231
https://kawalpemilu.org#52326,"TABAN, JAMBE, TANGERANG, BANTEN",7,89,154,243
https://kawalpemilu.org#52326,"TABAN, JAMBE, TANGERANG, BANTEN",8,89,141,230
https://kawalpemilu.org#52326,"TABAN, JAMBE, TANGERANG, BANTEN",10,44,124,168
https://kawalpemilu.org#52326,"TABAN, JAMBE, TANGERANG, BANTEN",11,47,153,200
https://kawalpemilu.org#52326,"TABAN, JAMBE, TANGERANG, BANTEN",12,51,149,200
https://kawalpemilu.org#52326,"TABAN, JAMBE, TANGERANG, BANTEN",13,42,115,157
https://kawalpemilu.org#52326,"TABAN, JAMBE, TANGERANG, BANTEN",14,59,150,209
https://kawalpemilu.org#52326,"TABAN, JAMBE, TANGERANG, BANTEN",15,76,119,76
https://kawalpemilu.org#52326,"TABAN, JAMBE, TANGERANG, BANTEN",16,52,173,225
https://kawalpemilu.org#52326,"TABAN, JAMBE, TANGERANG, BANTEN",18,50,99,149
https://kawalpemilu.org#52326,"TABAN, JAMBE, TANGERANG, BANTEN",19,77,131,208
https://kawalpemilu.org#52326,"TABAN, JAMBE, TANGERANG, BANTEN",20,47,123,170
https://kawalpemilu.org#52326,"TABAN, JAMBE, TANGERANG, BANTEN",21,44,94,138
https://kawalpemilu.org#52326,"TABAN, JAMBE, TANGERANG, BANTEN",22,43,100,143
https://kawalpemilu.org#52326,"TABAN, JAMBE, TANGERANG, BANTEN",23,40,110,150
https://kawalpemilu.org#52326,"TABAN, JAMBE, TANGERANG, BANTEN",24,55,123,178
https://kawalpemilu.org#52327,"DARU, JAMBE, TANGERANG, BANTEN",1,88,157,245
https://kawalpemilu.org#52327,"DARU, JAMBE, TANGERANG, BANTEN",2,100,140,240
https://kawalpemilu.org#52327,"DARU, JAMBE, TANGERANG, BANTEN",4,93,81,174
https://kawalpemilu.org#52327,"DARU, JAMBE, TANGERANG, BANTEN",5,79,63,142
https://kawalpemilu.org#52327,"DARU, JAMBE, TANGERANG, BANTEN",6,87,135,222
https://kawalpemilu.org#52327,"DARU, JAMBE, TANGERANG, BANTEN",7,76,167,243
https://kawalpemilu.org#52327,"DARU, JAMBE, TANGERANG, BANTEN",8,114,92,206
https://kawalpemilu.org#52327,"DARU, JAMBE, TANGERANG, BANTEN",9,103,116,219
https://kawalpemilu.org#52327,"DARU, JAMBE, TANGERANG, BANTEN",10,77,133,210
https://kawalpemilu.org#52327,"DARU, JAMBE, TANGERANG, BANTEN",11,135,87,222
https://kawalpemilu.org#52327,"DARU, JAMBE, TANGERANG, BANTEN",12,30,126,156
https://kawalpemilu.org#52327,"DARU, JAMBE, TANGERANG, BANTEN",13,25,101,126
https://kawalpemilu.org#52327,"DARU, JAMBE, TANGERANG, BANTEN",14,27,96,123
https://kawalpemilu.org#52327,"DARU, JAMBE, TANGERANG, BANTEN",15,79,178,257
https://kawalpemilu.org#52327,"DARU, JAMBE, TANGERANG, BANTEN",16,59,127,186
https://kawalpemilu.org#52327,"DARU, JAMBE, TANGERANG, BANTEN",17,49,118,167
https://kawalpemilu.org#52327,"DARU, JAMBE, TANGERANG, BANTEN",18,68,129,197
https://kawalpemilu.org#52327,"DARU, JAMBE, TANGERANG, BANTEN",19,86,108,194
https://kawalpemilu.org#52327,"DARU, JAMBE, TANGERANG, BANTEN",20,75,106,181
https://kawalpemilu.org#52327,"DARU, JAMBE, TANGERANG, BANTEN",21,96,117,213
https://kawalpemilu.org#52328,"KUTRUK, JAMBE, TANGERANG, BANTEN",1,70,203,273
https://kawalpemilu.org#52328,"KUTRUK, JAMBE, TANGERANG, BANTEN",2,50,167,217
https://kawalpemilu.org#52328,"KUTRUK, JAMBE, TANGERANG, BANTEN",3,108,118,226
https://kawalpemilu.org#52328,"KUTRUK, JAMBE, TANGERANG, BANTEN",4,17,114,131
https://kawalpemilu.org#52328,"KUTRUK, JAMBE, TANGERANG, BANTEN",5,39,155,194
https://kawalpemilu.org#52328,"KUTRUK, JAMBE, TANGERANG, BANTEN",6,57,144,201
https://kawalpemilu.org#52328,"KUTRUK, JAMBE, TANGERANG, BANTEN",7,88,138,226
https://kawalpemilu.org#52328,"KUTRUK, JAMBE, TANGERANG, BANTEN",8,94,147,241
https://kawalpemilu.org#52328,"KUTRUK, JAMBE, TANGERANG, BANTEN",9,20,135,155
https://kawalpemilu.org#52328,"KUTRUK, JAMBE, TANGERANG, BANTEN",10,72,149,221
https://kawalpemilu.org#52328,"KUTRUK, JAMBE, TANGERANG, BANTEN",11,119,151,270
https://kawalpemilu.org#52328,"KUTRUK, JAMBE, TANGERANG, BANTEN",12,32,114,146
https://kawalpemilu.org#52328,"KUTRUK, JAMBE, TANGERANG, BANTEN",13,29,75,104
https://kawalpemilu.org#52328,"KUTRUK, JAMBE, TANGERANG, BANTEN",15,67,145,212
https://kawalpemilu.org#52328,"KUTRUK, JAMBE, TANGERANG, BANTEN",16,51,52,103
https://kawalpemilu.org#52329,"RANCA BUAYA, JAMBE, TANGERANG, BANTEN",1,68,184,252
https://kawalpemilu.org#52329,"RANCA BUAYA, JAMBE, TANGERANG, BANTEN",2,86,149,235
https://kawalpemilu.org#52329,"RANCA BUAYA, JAMBE, TANGERANG, BANTEN",6,78,103,181
https://kawalpemilu.org#52329,"RANCA BUAYA, JAMBE, TANGERANG, BANTEN",9,75,143,218
https://kawalpemilu.org#52330,"MEKARSARI, JAMBE, TANGERANG, BANTEN",1,81,118,199
https://kawalpemilu.org#52330,"MEKARSARI, JAMBE, TANGERANG, BANTEN",2,146,27,173
https://kawalpemilu.org#52330,"MEKARSARI, JAMBE, TANGERANG, BANTEN",3,116,142,258
https://kawalpemilu.org#52330,"MEKARSARI, JAMBE, TANGERANG, BANTEN",4,87,108,195
https://kawalpemilu.org#52330,"MEKARSARI, JAMBE, TANGERANG, BANTEN",6,82,71,153
https://kawalpemilu.org#52330,"MEKARSARI, JAMBE, TANGERANG, BANTEN",8,124,122,246
https://kawalpemilu.org#52330,"MEKARSARI, JAMBE, TANGERANG, BANTEN",9,90,162,252
https://kawalpemilu.org#52330,"MEKARSARI, JAMBE, TANGERANG, BANTEN",10,98,125,223
https://kawalpemilu.org#52331,"ANCOL PASIR, JAMBE, TANGERANG, BANTEN",1,81,172,253
https://kawalpemilu.org#52331,"ANCOL PASIR, JAMBE, TANGERANG, BANTEN",2,114,149,263
https://kawalpemilu.org#52331,"ANCOL PASIR, JAMBE, TANGERANG, BANTEN",3,70,129,199
https://kawalpemilu.org#52331,"ANCOL PASIR, JAMBE, TANGERANG, BANTEN",4,67,87,154
https://kawalpemilu.org#52331,"ANCOL PASIR, JAMBE, TANGERANG, BANTEN",5,87,145,232
https://kawalpemilu.org#52331,"ANCOL PASIR, JAMBE, TANGERANG, BANTEN",6,104,163,267
https://kawalpemilu.org#52332,"PASIR BARAT, JAMBE, TANGERANG, BANTEN",1,87,153,240
https://kawalpemilu.org#52332,"PASIR BARAT, JAMBE, TANGERANG, BANTEN",2,75,108,183
https://kawalpemilu.org#52332,"PASIR BARAT, JAMBE, TANGERANG, BANTEN",3,48,164,212
https://kawalpemilu.org#52332,"PASIR BARAT, JAMBE, TANGERANG, BANTEN",4,71,153,224
https://kawalpemilu.org#52332,"PASIR BARAT, JAMBE, TANGERANG, BANTEN",5,49,140,189
https://kawalpemilu.org#52332,"PASIR BARAT, JAMBE, TANGERANG, BANTEN",6,89,114,203
https://kawalpemilu.org#52332,"PASIR BARAT, JAMBE, TANGERANG, BANTEN",7,69,175,244
https://kawalpemilu.org#52332,"PASIR BARAT, JAMBE, TANGERANG, BANTEN",8,28,135,163
https://kawalpemilu.org#52332,"PASIR BARAT, JAMBE, TANGERANG, BANTEN",9,131,127,258
https://kawalpemilu.org#52334,"CISOKA, CISOKA, TANGERANG, BANTEN",1,127,85,212
https://kawalpemilu.org#52334,"CISOKA, CISOKA, TANGERANG, BANTEN",2,101,84,185
https://kawalpemilu.org#52334,"CISOKA, CISOKA, TANGERANG, BANTEN",3,62,188,250
https://kawalpemilu.org#52334,"CISOKA, CISOKA, TANGERANG, BANTEN",5,72,133,205
https://kawalpemilu.org#52334,"CISOKA, CISOKA, TANGERANG, BANTEN",6,113,99,212
https://kawalpemilu.org#52334,"CISOKA, CISOKA, TANGERANG, BANTEN",7,52,192,244
https://kawalpemilu.org#52334,"CISOKA, CISOKA, TANGERANG, BANTEN",8,49,177,266
https://kawalpemilu.org#52334,"CISOKA, CISOKA, TANGERANG, BANTEN",9,46,156,202
https://kawalpemilu.org#52334,"CISOKA, CISOKA, TANGERANG, BANTEN",10,56,147,203
https://kawalpemilu.org#52334,"CISOKA, CISOKA, TANGERANG, BANTEN",11,79,165,244
https://kawalpemilu.org#52334,"CISOKA, CISOKA, TANGERANG, BANTEN",12,70,175,245
https://kawalpemilu.org#52334,"CISOKA, CISOKA, TANGERANG, BANTEN",13,49,153,202
https://kawalpemilu.org#52334,"CISOKA, CISOKA, TANGERANG, BANTEN",14,71,146,217
https://kawalpemilu.org#52334,"CISOKA, CISOKA, TANGERANG, BANTEN",15,83,145,228
https://kawalpemilu.org#52334,"CISOKA, CISOKA, TANGERANG, BANTEN",16,92,134,226
https://kawalpemilu.org#52334,"CISOKA, CISOKA, TANGERANG, BANTEN",17,59,106,165
https://kawalpemilu.org#52334,"CISOKA, CISOKA, TANGERANG, BANTEN",18,74,98,172
https://kawalpemilu.org#52334,"CISOKA, CISOKA, TANGERANG, BANTEN",19,89,147,236
https://kawalpemilu.org#52334,"CISOKA, CISOKA, TANGERANG, BANTEN",21,37,96,133
https://kawalpemilu.org#52334,"CISOKA, CISOKA, TANGERANG, BANTEN",22,79,95,174
https://kawalpemilu.org#52334,"CISOKA, CISOKA, TANGERANG, BANTEN",23,84,120,204
https://kawalpemilu.org#52334,"CISOKA, CISOKA, TANGERANG, BANTEN",24,70,111,181
https://kawalpemilu.org#52334,"CISOKA, CISOKA, TANGERANG, BANTEN",25,74,125,199
https://kawalpemilu.org#52335,"CARINGIN, CISOKA, TANGERANG, BANTEN",1,40,149,189
https://kawalpemilu.org#52335,"CARINGIN, CISOKA, TANGERANG, BANTEN",2,52,152,204
https://kawalpemilu.org#52335,"CARINGIN, CISOKA, TANGERANG, BANTEN",3,86,160,246
https://kawalpemilu.org#52335,"CARINGIN, CISOKA, TANGERANG, BANTEN",4,48,155,203
https://kawalpemilu.org#52335,"CARINGIN, CISOKA, TANGERANG, BANTEN",5,39,94,133
https://kawalpemilu.org#52335,"CARINGIN, CISOKA, TANGERANG, BANTEN",6,29,105,134
https://kawalpemilu.org#52335,"CARINGIN, CISOKA, TANGERANG, BANTEN",7,44,179,223
https://kawalpemilu.org#52335,"CARINGIN, CISOKA, TANGERANG, BANTEN",8,79,150,229
https://kawalpemilu.org#52335,"CARINGIN, CISOKA, TANGERANG, BANTEN",9,60,153,213
https://kawalpemilu.org#52335,"CARINGIN, CISOKA, TANGERANG, BANTEN",10,89,126,215
https://kawalpemilu.org#52335,"CARINGIN, CISOKA, TANGERANG, BANTEN",11,58,87,145
https://kawalpemilu.org#52335,"CARINGIN, CISOKA, TANGERANG, BANTEN",12,56,115,171
https://kawalpemilu.org#52335,"CARINGIN, CISOKA, TANGERANG, BANTEN",13,64,147,211
https://kawalpemilu.org#52335,"CARINGIN, CISOKA, TANGERANG, BANTEN",14,41,110,151
https://kawalpemilu.org#52335,"CARINGIN, CISOKA, TANGERANG, BANTEN",15,85,107,192
https://kawalpemilu.org#52335,"CARINGIN, CISOKA, TANGERANG, BANTEN",16,50,134,184
https://kawalpemilu.org#52335,"CARINGIN, CISOKA, TANGERANG, BANTEN",17,42,120,162
https://kawalpemilu.org#52335,"CARINGIN, CISOKA, TANGERANG, BANTEN",18,45,128,173
https://kawalpemilu.org#52335,"CARINGIN, CISOKA, TANGERANG, BANTEN",19,85,119,204
https://kawalpemilu.org#52335,"CARINGIN, CISOKA, TANGERANG, BANTEN",20,36,119,155
https://kawalpemilu.org#52335,"CARINGIN, CISOKA, TANGERANG, BANTEN",21,96,117,213
https://kawalpemilu.org#52335,"CARINGIN, CISOKA, TANGERANG, BANTEN",22,57,98,155
https://kawalpemilu.org#52335,"CARINGIN, CISOKA, TANGERANG, BANTEN",23,25,142,167
https://kawalpemilu.org#52335,"CARINGIN, CISOKA, TANGERANG, BANTEN",24,64,153,217
https://kawalpemilu.org#52335,"CARINGIN, CISOKA, TANGERANG, BANTEN",25,86,132,218
https://kawalpemilu.org#52335,"CARINGIN, CISOKA, TANGERANG, BANTEN",26,19,39,58
https://kawalpemilu.org#52335,"CARINGIN, CISOKA, TANGERANG, BANTEN",27,13,37,50
https://kawalpemilu.org#52335,"CARINGIN, CISOKA, TANGERANG, BANTEN",28,11,44,55
https://kawalpemilu.org#52336,"SELAPAJANG, CISOKA, TANGERANG, BANTEN",1,100,149,249
https://kawalpemilu.org#52336,"SELAPAJANG, CISOKA, TANGERANG, BANTEN",2,94,108,202
https://kawalpemilu.org#52336,"SELAPAJANG, CISOKA, TANGERANG, BANTEN",3,90,156,246
https://kawalpemilu.org#52336,"SELAPAJANG, CISOKA, TANGERANG, BANTEN",4,45,201,246
https://kawalpemilu.org#52336,"SELAPAJANG, CISOKA, TANGERANG, BANTEN",5,87,168,255
https://kawalpemilu.org#52336,"SELAPAJANG, CISOKA, TANGERANG, BANTEN",6,50,145,195
https://kawalpemilu.org#52336,"SELAPAJANG, CISOKA, TANGERANG, BANTEN",7,79,125,204
https://kawalpemilu.org#52336,"SELAPAJANG, CISOKA, TANGERANG, BANTEN",8,67,96,163
https://kawalpemilu.org#52336,"SELAPAJANG, CISOKA, TANGERANG, BANTEN",9,73,123,196
https://kawalpemilu.org#52336,"SELAPAJANG, CISOKA, TANGERANG, BANTEN",10,38,136,174
https://kawalpemilu.org#52336,"SELAPAJANG, CISOKA, TANGERANG, BANTEN",11,44,162,206
https://kawalpemilu.org#52336,"SELAPAJANG, CISOKA, TANGERANG, BANTEN",12,57,118,175
https://kawalpemilu.org#52336,"SELAPAJANG, CISOKA, TANGERANG, BANTEN",13,46,133,179
https://kawalpemilu.org#52336,"SELAPAJANG, CISOKA, TANGERANG, BANTEN",14,61,158,219
https://kawalpemilu.org#52336,"SELAPAJANG, CISOKA, TANGERANG, BANTEN",16,84,145,229
https://kawalpemilu.org#52336,"SELAPAJANG, CISOKA, TANGERANG, BANTEN",17,106,173,279
https://kawalpemilu.org#52336,"SELAPAJANG, CISOKA, TANGERANG, BANTEN",18,70,154,224
https://kawalpemilu.org#52336,"SELAPAJANG, CISOKA, TANGERANG, BANTEN",19,67,159,226
https://kawalpemilu.org#52336,"SELAPAJANG, CISOKA, TANGERANG, BANTEN",20,87,104,191
https://kawalpemilu.org#52336,"SELAPAJANG, CISOKA, TANGERANG, BANTEN",21,107,108,215
https://kawalpemilu.org#52336,"SELAPAJANG, CISOKA, TANGERANG, BANTEN",22,101,125,226
https://kawalpemilu.org#52336,"SELAPAJANG, CISOKA, TANGERANG, BANTEN",23,103,140,243
https://kawalpemilu.org#52336,"SELAPAJANG, CISOKA, TANGERANG, BANTEN",24,99,137,236
https://kawalpemilu.org#52336,"SELAPAJANG, CISOKA, TANGERANG, BANTEN",25,70,99,169
https://kawalpemilu.org#52336,"SELAPAJANG, CISOKA, TANGERANG, BANTEN",26,101,80,181
https://kawalpemilu.org#52337,"SUKATANI, CISOKA, TANGERANG, BANTEN",1,86,161,247
https://kawalpemilu.org#52337,"SUKATANI, CISOKA, TANGERANG, BANTEN",2,110,127,237
https://kawalpemilu.org#52337,"SUKATANI, CISOKA, TANGERANG, BANTEN",3,98,82,180
https://kawalpemilu.org#52337,"SUKATANI, CISOKA, TANGERANG, BANTEN",5,49,130,179
https://kawalpemilu.org#52337,"SUKATANI, CISOKA, TANGERANG, BANTEN",6,47,136,183
https://kawalpemilu.org#52337,"SUKATANI, CISOKA, TANGERANG, BANTEN",7,89,108,197
https://kawalpemilu.org#52337,"SUKATANI, CISOKA, TANGERANG, BANTEN",8,79,155,234
https://kawalpemilu.org#52337,"SUKATANI, CISOKA, TANGERANG, BANTEN",9,101,118,219
https://kawalpemilu.org#52337,"SUKATANI, CISOKA, TANGERANG, BANTEN",10,70,147,217
https://kawalpemilu.org#52337,"SUKATANI, CISOKA, TANGERANG, BANTEN",11,73,150,223
https://kawalpemilu.org#52337,"SUKATANI, CISOKA, TANGERANG, BANTEN",12,64,116,180
https://kawalpemilu.org#52337,"SUKATANI, CISOKA, TANGERANG, BANTEN",13,54,131,185
https://kawalpemilu.org#52337,"SUKATANI, CISOKA, TANGERANG, BANTEN",14,55,127,182
https://kawalpemilu.org#52337,"SUKATANI, CISOKA, TANGERANG, BANTEN",15,79,112,191
https://kawalpemilu.org#52337,"SUKATANI, CISOKA, TANGERANG, BANTEN",16,79,128,207
https://kawalpemilu.org#52337,"SUKATANI, CISOKA, TANGERANG, BANTEN",17,82,173,255
https://kawalpemilu.org#52337,"SUKATANI, CISOKA, TANGERANG, BANTEN",18,74,124,198
https://kawalpemilu.org#52337,"SUKATANI, CISOKA, TANGERANG, BANTEN",20,79,155,234
https://kawalpemilu.org#52337,"SUKATANI, CISOKA, TANGERANG, BANTEN",21,68,163,231
https://kawalpemilu.org#52337,"SUKATANI, CISOKA, TANGERANG, BANTEN",22,55,146,201
https://kawalpemilu.org#52337,"SUKATANI, CISOKA, TANGERANG, BANTEN",24,82,173,255
https://kawalpemilu.org#52337,"SUKATANI, CISOKA, TANGERANG, BANTEN",25,82,189,271
https://kawalpemilu.org#52337,"SUKATANI, CISOKA, TANGERANG, BANTEN",26,72,156,228
https://kawalpemilu.org#52337,"SUKATANI, CISOKA, TANGERANG, BANTEN",27,68,119,187
https://kawalpemilu.org#52337,"SUKATANI, CISOKA, TANGERANG, BANTEN",28,65,144,209
https://kawalpemilu.org#52337,"SUKATANI, CISOKA, TANGERANG, BANTEN",29,36,67,103
https://kawalpemilu.org#52338,"KARANG HARJA, CISOKA, TANGERANG, BANTEN",1,92,149,241
https://kawalpemilu.org#52338,"KARANG HARJA, CISOKA, TANGERANG, BANTEN",2,93,118,211
https://kawalpemilu.org#52338,"KARANG HARJA, CISOKA, TANGERANG, BANTEN",3,112,113,225
https://kawalpemilu.org#52338,"KARANG HARJA, CISOKA, TANGERANG, BANTEN",4,90,112,202
https://kawalpemilu.org#52338,"KARANG HARJA, CISOKA, TANGERANG, BANTEN",5,59,79,138
https://kawalpemilu.org#52338,"KARANG HARJA, CISOKA, TANGERANG, BANTEN",6,87,76,163
https://kawalpemilu.org#52338,"KARANG HARJA, CISOKA, TANGERANG, BANTEN",7,88,105,193
https://kawalpemilu.org#52338,"KARANG HARJA, CISOKA, TANGERANG, BANTEN",8,74,120,194
https://kawalpemilu.org#52338,"KARANG HARJA, CISOKA, TANGERANG, BANTEN",9,84,101,185
https://kawalpemilu.org#52338,"KARANG HARJA, CISOKA, TANGERANG, BANTEN",10,115,96,211
https://kawalpemilu.org#52338,"KARANG HARJA, CISOKA, TANGERANG, BANTEN",11,99,126,225
https://kawalpemilu.org#52338,"KARANG HARJA, CISOKA, TANGERANG, BANTEN",12,96,143,239
https://kawalpemilu.org#52338,"KARANG HARJA, CISOKA, TANGERANG, BANTEN",13,135,121,256
https://kawalpemilu.org#52338,"KARANG HARJA, CISOKA, TANGERANG, BANTEN",14,113,90,203
https://kawalpemilu.org#52338,"KARANG HARJA, CISOKA, TANGERANG, BANTEN",15,55,121,176
https://kawalpemilu.org#52338,"KARANG HARJA, CISOKA, TANGERANG, BANTEN",16,116,102,218
https://kawalpemilu.org#52339,"BOJONG LOA, CISOKA, TANGERANG, BANTEN",1,82,137,219
https://kawalpemilu.org#52339,"BOJONG LOA, CISOKA, TANGERANG, BANTEN",2,74,134,208
https://kawalpemilu.org#52339,"BOJONG LOA, CISOKA, TANGERANG, BANTEN",3,50,134,184
https://kawalpemilu.org#52339,"BOJONG LOA, CISOKA, TANGERANG, BANTEN",4,52,86,138
https://kawalpemilu.org#52339,"BOJONG LOA, CISOKA, TANGERANG, BANTEN",5,39,143,182
https://kawalpemilu.org#52339,"BOJONG LOA, CISOKA, TANGERANG, BANTEN",6,63,135,198
https://kawalpemilu.org#52339,"BOJONG LOA, CISOKA, TANGERANG, BANTEN",7,61,116,177
https://kawalpemilu.org#52339,"BOJONG LOA, CISOKA, TANGERANG, BANTEN",8,79,69,148
https://kawalpemilu.org#52339,"BOJONG LOA, CISOKA, TANGERANG, BANTEN",9,73,107,180
https://kawalpemilu.org#52339,"BOJONG LOA, CISOKA, TANGERANG, BANTEN",10,74,110,184
https://kawalpemilu.org#52339,"BOJONG LOA, CISOKA, TANGERANG, BANTEN",11,0,10,10
https://kawalpemilu.org#52339,"BOJONG LOA, CISOKA, TANGERANG, BANTEN",12,84,122,206
https://kawalpemilu.org#52339,"BOJONG LOA, CISOKA, TANGERANG, BANTEN",13,40,161,201
https://kawalpemilu.org#52339,"BOJONG LOA, CISOKA, TANGERANG, BANTEN",14,54,150,204
https://kawalpemilu.org#52339,"BOJONG LOA, CISOKA, TANGERANG, BANTEN",15,58,84,142
https://kawalpemilu.org#52339,"BOJONG LOA, CISOKA, TANGERANG, BANTEN",16,61,95,156
https://kawalpemilu.org#52339,"BOJONG LOA, CISOKA, TANGERANG, BANTEN",17,55,117,172
https://kawalpemilu.org#52339,"BOJONG LOA, CISOKA, TANGERANG, BANTEN",18,79,124,203
https://kawalpemilu.org#52339,"BOJONG LOA, CISOKA, TANGERANG, BANTEN",20,61,116,177
https://kawalpemilu.org#52339,"BOJONG LOA, CISOKA, TANGERANG, BANTEN",21,77,90,167
https://kawalpemilu.org#52339,"BOJONG LOA, CISOKA, TANGERANG, BANTEN",22,53,146,199
https://kawalpemilu.org#52340,"CIBUGEL, CISOKA, TANGERANG, BANTEN",1,66,151,217
https://kawalpemilu.org#52340,"CIBUGEL, CISOKA, TANGERANG, BANTEN",2,65,159,224
https://kawalpemilu.org#52340,"CIBUGEL, CISOKA, TANGERANG, BANTEN",3,67,126,193
https://kawalpemilu.org#52340,"CIBUGEL, CISOKA, TANGERANG, BANTEN",4,71,134,205
https://kawalpemilu.org#52340,"CIBUGEL, CISOKA, TANGERANG, BANTEN",5,85,146,231
https://kawalpemilu.org#52340,"CIBUGEL, CISOKA, TANGERANG, BANTEN",6,67,116,183
https://kawalpemilu.org#52340,"CIBUGEL, CISOKA, TANGERANG, BANTEN",7,51,124,175
https://kawalpemilu.org#52340,"CIBUGEL, CISOKA, TANGERANG, BANTEN",8,50,148,198
https://kawalpemilu.org#52340,"CIBUGEL, CISOKA, TANGERANG, BANTEN",9,72,114,186
https://kawalpemilu.org#52340,"CIBUGEL, CISOKA, TANGERANG, BANTEN",10,52,162,214
https://kawalpemilu.org#52340,"CIBUGEL, CISOKA, TANGERANG, BANTEN",11,63,143,206
https://kawalpemilu.org#52340,"CIBUGEL, CISOKA, TANGERANG, BANTEN",12,122,158,280
https://kawalpemilu.org#52340,"CIBUGEL, CISOKA, TANGERANG, BANTEN",13,18,166,184
https://kawalpemilu.org#52340,"CIBUGEL, CISOKA, TANGERANG, BANTEN",14,20,134,154
https://kawalpemilu.org#52340,"CIBUGEL, CISOKA, TANGERANG, BANTEN",15,90,164,254
https://kawalpemilu.org#52340,"CIBUGEL, CISOKA, TANGERANG, BANTEN",16,40,105,145
https://kawalpemilu.org#52340,"CIBUGEL, CISOKA, TANGERANG, BANTEN",17,96,152,248
https://kawalpemilu.org#52340,"CIBUGEL, CISOKA, TANGERANG, BANTEN",18,90,149,239
https://kawalpemilu.org#52340,"CIBUGEL, CISOKA, TANGERANG, BANTEN",22,73,128,201
https://kawalpemilu.org#52340,"CIBUGEL, CISOKA, TANGERANG, BANTEN",23,85,129,214
https://kawalpemilu.org#52340,"CIBUGEL, CISOKA, TANGERANG, BANTEN",24,38,128,166
https://kawalpemilu.org#52340,"CIBUGEL, CISOKA, TANGERANG, BANTEN",25,34,108,142
https://kawalpemilu.org#52341,"CEMPAKA, CISOKA, TANGERANG, BANTEN",1,68,153,221
https://kawalpemilu.org#52341,"CEMPAKA, CISOKA, TANGERANG, BANTEN",2,89,134,223
https://kawalpemilu.org#52341,"CEMPAKA, CISOKA, TANGERANG, BANTEN",3,127,93,220
https://kawalpemilu.org#52341,"CEMPAKA, CISOKA, TANGERANG, BANTEN",4,93,127,220
https://kawalpemilu.org#52341,"CEMPAKA, CISOKA, TANGERANG, BANTEN",5,101,117,218
https://kawalpemilu.org#52341,"CEMPAKA, CISOKA, TANGERANG, BANTEN",6,100,131,231
https://kawalpemilu.org#52341,"CEMPAKA, CISOKA, TANGERANG, BANTEN",7,93,89,182
https://kawalpemilu.org#52341,"CEMPAKA, CISOKA, TANGERANG, BANTEN",8,98,115,213
https://kawalpemilu.org#52341,"CEMPAKA, CISOKA, TANGERANG, BANTEN",9,47,159,206
https://kawalpemilu.org#52341,"CEMPAKA, CISOKA, TANGERANG, BANTEN",10,138,117,255
https://kawalpemilu.org#52341,"CEMPAKA, CISOKA, TANGERANG, BANTEN",11,135,129,264
https://kawalpemilu.org#52341,"CEMPAKA, CISOKA, TANGERANG, BANTEN",12,74,137,211
https://kawalpemilu.org#52341,"CEMPAKA, CISOKA, TANGERANG, BANTEN",13,63,120,183
https://kawalpemilu.org#52341,"CEMPAKA, CISOKA, TANGERANG, BANTEN",14,99,124,223
https://kawalpemilu.org#52341,"CEMPAKA, CISOKA, TANGERANG, BANTEN",15,100,100,200
https://kawalpemilu.org#52341,"CEMPAKA, CISOKA, TANGERANG, BANTEN",16,66,90,156
https://kawalpemilu.org#52341,"CEMPAKA, CISOKA, TANGERANG, BANTEN",17,81,143,224
https://kawalpemilu.org#52341,"CEMPAKA, CISOKA, TANGERANG, BANTEN",18,66,93,159
https://kawalpemilu.org#52341,"CEMPAKA, CISOKA, TANGERANG, BANTEN",19,89,118,207
https://kawalpemilu.org#52341,"CEMPAKA, CISOKA, TANGERANG, BANTEN",20,81,135,216
https://kawalpemilu.org#52341,"CEMPAKA, CISOKA, TANGERANG, BANTEN",21,144,90,234
https://kawalpemilu.org#52341,"CEMPAKA, CISOKA, TANGERANG, BANTEN",22,118,107,225
https://kawalpemilu.org#52342,"CARENANG, CISOKA, TANGERANG, BANTEN",1,94,126,220
https://kawalpemilu.org#52342,"CARENANG, CISOKA, TANGERANG, BANTEN",2,98,51,149
https://kawalpemilu.org#52342,"CARENANG, CISOKA, TANGERANG, BANTEN",3,83,105,188
https://kawalpemilu.org#52342,"CARENANG, CISOKA, TANGERANG, BANTEN",4,111,91,202
https://kawalpemilu.org#52342,"CARENANG, CISOKA, TANGERANG, BANTEN",5,104,103,207
https://kawalpemilu.org#52342,"CARENANG, CISOKA, TANGERANG, BANTEN",6,77,119,196
https://kawalpemilu.org#52342,"CARENANG, CISOKA, TANGERANG, BANTEN",7,62,159,221
https://kawalpemilu.org#52342,"CARENANG, CISOKA, TANGERANG, BANTEN",8,55,150,205
https://kawalpemilu.org#52342,"CARENANG, CISOKA, TANGERANG, BANTEN",9,53,62,115
https://kawalpemilu.org#52342,"CARENANG, CISOKA, TANGERANG, BANTEN",10,62,186,248
https://kawalpemilu.org#52342,"CARENANG, CISOKA, TANGERANG, BANTEN",11,87,152,239
https://kawalpemilu.org#52342,"CARENANG, CISOKA, TANGERANG, BANTEN",12,80,147,227
https://kawalpemilu.org#52342,"CARENANG, CISOKA, TANGERANG, BANTEN",13,50,170,220
https://kawalpemilu.org#52342,"CARENANG, CISOKA, TANGERANG, BANTEN",14,65,129,194
https://kawalpemilu.org#52342,"CARENANG, CISOKA, TANGERANG, BANTEN",15,78,106,184
https://kawalpemilu.org#52342,"CARENANG, CISOKA, TANGERANG, BANTEN",16,103,116,219
https://kawalpemilu.org#52342,"CARENANG, CISOKA, TANGERANG, BANTEN",17,153,75,228
https://kawalpemilu.org#52342,"CARENANG, CISOKA, TANGERANG, BANTEN",18,126,105,231
https://kawalpemilu.org#52342,"CARENANG, CISOKA, TANGERANG, BANTEN",19,87,133,220
https://kawalpemilu.org#52342,"CARENANG, CISOKA, TANGERANG, BANTEN",20,11,24,35
https://kawalpemilu.org#52342,"CARENANG, CISOKA, TANGERANG, BANTEN",21,32,41,73
https://kawalpemilu.org#52343,"JEUNGJING, CISOKA, TANGERANG, BANTEN",1,91,129,220
https://kawalpemilu.org#52343,"JEUNGJING, CISOKA, TANGERANG, BANTEN",2,46,118,164
https://kawalpemilu.org#52343,"JEUNGJING, CISOKA, TANGERANG, BANTEN",3,70,159,229
https://kawalpemilu.org#52343,"JEUNGJING, CISOKA, TANGERANG, BANTEN",4,68,108,176
https://kawalpemilu.org#52343,"JEUNGJING, CISOKA, TANGERANG, BANTEN",5,86,142,228
https://kawalpemilu.org#52343,"JEUNGJING, CISOKA, TANGERANG, BANTEN",6,70,155,225
https://kawalpemilu.org#52343,"JEUNGJING, CISOKA, TANGERANG, BANTEN",7,116,120,236
https://kawalpemilu.org#52343,"JEUNGJING, CISOKA, TANGERANG, BANTEN",8,85,111,196
https://kawalpemilu.org#52343,"JEUNGJING, CISOKA, TANGERANG, BANTEN",9,57,101,158
https://kawalpemilu.org#52343,"JEUNGJING, CISOKA, TANGERANG, BANTEN",10,54,146,200
https://kawalpemilu.org#52343,"JEUNGJING, CISOKA, TANGERANG, BANTEN",11,77,97,174
https://kawalpemilu.org#52343,"JEUNGJING, CISOKA, TANGERANG, BANTEN",12,116,113,229
https://kawalpemilu.org#52343,"JEUNGJING, CISOKA, TANGERANG, BANTEN",13,86,118,204
https://kawalpemilu.org#52343,"JEUNGJING, CISOKA, TANGERANG, BANTEN",14,104,100,204
https://kawalpemilu.org#52343,"JEUNGJING, CISOKA, TANGERANG, BANTEN",15,119,116,235
https://kawalpemilu.org#52343,"JEUNGJING, CISOKA, TANGERANG, BANTEN",17,105,100,205
https://kawalpemilu.org#52343,"JEUNGJING, CISOKA, TANGERANG, BANTEN",18,55,76,131
https://kawalpemilu.org#52343,"JEUNGJING, CISOKA, TANGERANG, BANTEN",19,58,58,116
https://kawalpemilu.org#52343,"JEUNGJING, CISOKA, TANGERANG, BANTEN",20,86,111,197
https://kawalpemilu.org#52343,"JEUNGJING, CISOKA, TANGERANG, BANTEN",21,58,67,125
https://kawalpemilu.org#52343,"JEUNGJING, CISOKA, TANGERANG, BANTEN",22,80,57,137
https://kawalpemilu.org#52343,"JEUNGJING, CISOKA, TANGERANG, BANTEN",23,55,133,188
https://kawalpemilu.org#52343,"JEUNGJING, CISOKA, TANGERANG, BANTEN",24,60,154,214
https://kawalpemilu.org#52343,"JEUNGJING, CISOKA, TANGERANG, BANTEN",25,68,168,236
https://kawalpemilu.org#52343,"JEUNGJING, CISOKA, TANGERANG, BANTEN",26,76,155,231
https://kawalpemilu.org#52343,"JEUNGJING, CISOKA, TANGERANG, BANTEN",27,51,133,184
https://kawalpemilu.org#52343,"JEUNGJING, CISOKA, TANGERANG, BANTEN",28,29,122,151
https://kawalpemilu.org#52343,"JEUNGJING, CISOKA, TANGERANG, BANTEN",29,35,95,130
https://kawalpemilu.org#52343,"JEUNGJING, CISOKA, TANGERANG, BANTEN",30,77,70,147
https://kawalpemilu.org#52343,"JEUNGJING, CISOKA, TANGERANG, BANTEN",31,107,155,262
https://kawalpemilu.org#52343,"JEUNGJING, CISOKA, TANGERANG, BANTEN",32,47,77,124
https://kawalpemilu.org#52343,"JEUNGJING, CISOKA, TANGERANG, BANTEN",33,70,75,145
https://kawalpemilu.org#52343,"JEUNGJING, CISOKA, TANGERANG, BANTEN",35,13,81,94
https://kawalpemilu.org#52346,"PASIR AMPO, KRESEK, TANGERANG, BANTEN",2,71,108,179
https://kawalpemilu.org#52346,"PASIR AMPO, KRESEK, TANGERANG, BANTEN",3,80,84,164
https://kawalpemilu.org#52346,"PASIR AMPO, KRESEK, TANGERANG, BANTEN",4,75,53,128
https://kawalpemilu.org#52346,"PASIR AMPO, KRESEK, TANGERANG, BANTEN",5,77,127,204
https://kawalpemilu.org#52346,"PASIR AMPO, KRESEK, TANGERANG, BANTEN",7,71,68,139
https://kawalpemilu.org#52346,"PASIR AMPO, KRESEK, TANGERANG, BANTEN",8,53,93,146
https://kawalpemilu.org#52346,"PASIR AMPO, KRESEK, TANGERANG, BANTEN",9,80,80,160
https://kawalpemilu.org#52346,"PASIR AMPO, KRESEK, TANGERANG, BANTEN",11,107,75,182
https://kawalpemilu.org#52346,"PASIR AMPO, KRESEK, TANGERANG, BANTEN",12,117,59,176
https://kawalpemilu.org#52346,"PASIR AMPO, KRESEK, TANGERANG, BANTEN",14,131,55,186
https://kawalpemilu.org#52346,"PASIR AMPO, KRESEK, TANGERANG, BANTEN",15,117,44,161
https://kawalpemilu.org#52346,"PASIR AMPO, KRESEK, TANGERANG, BANTEN",16,121,44,165
https://kawalpemilu.org#52346,"PASIR AMPO, KRESEK, TANGERANG, BANTEN",17,87,65,152
https://kawalpemilu.org#52346,"PASIR AMPO, KRESEK, TANGERANG, BANTEN",18,78,42,120
https://kawalpemilu.org#52346,"PASIR AMPO, KRESEK, TANGERANG, BANTEN",19,73,33,106
https://kawalpemilu.org#52346,"PASIR AMPO, KRESEK, TANGERANG, BANTEN",20,113,59,172
https://kawalpemilu.org#52346,"PASIR AMPO, KRESEK, TANGERANG, BANTEN",21,94,95,189
https://kawalpemilu.org#52346,"PASIR AMPO, KRESEK, TANGERANG, BANTEN",22,146,80,226
https://kawalpemilu.org#52347,"RANCAILAT, KRESEK, TANGERANG, BANTEN",1,41,97,138
https://kawalpemilu.org#52347,"RANCAILAT, KRESEK, TANGERANG, BANTEN",2,0,0,0
https://kawalpemilu.org#52347,"RANCAILAT, KRESEK, TANGERANG, BANTEN",3,60,133,193
https://kawalpemilu.org#52347,"RANCAILAT, KRESEK, TANGERANG, BANTEN",4,75,113,188
https://kawalpemilu.org#52347,"RANCAILAT, KRESEK, TANGERANG, BANTEN",5,79,117,196
https://kawalpemilu.org#52347,"RANCAILAT, KRESEK, TANGERANG, BANTEN",6,58,115,173
https://kawalpemilu.org#52347,"RANCAILAT, KRESEK, TANGERANG, BANTEN",8,51,130,181
https://kawalpemilu.org#52347,"RANCAILAT, KRESEK, TANGERANG, BANTEN",9,72,77,149
https://kawalpemilu.org#52347,"RANCAILAT, KRESEK, TANGERANG, BANTEN",10,64,100,164
https://kawalpemilu.org#52347,"RANCAILAT, KRESEK, TANGERANG, BANTEN",11,61,180,241
https://kawalpemilu.org#52347,"RANCAILAT, KRESEK, TANGERANG, BANTEN",12,58,137,195
https://kawalpemilu.org#52347,"RANCAILAT, KRESEK, TANGERANG, BANTEN",13,82,88,170
https://kawalpemilu.org#52347,"RANCAILAT, KRESEK, TANGERANG, BANTEN",14,103,92,195
https://kawalpemilu.org#52347,"RANCAILAT, KRESEK, TANGERANG, BANTEN",15,55,98,153
https://kawalpemilu.org#52347,"RANCAILAT, KRESEK, TANGERANG, BANTEN",16,48,115,163
https://kawalpemilu.org#52347,"RANCAILAT, KRESEK, TANGERANG, BANTEN",17,31,99,130
https://kawalpemilu.org#52347,"RANCAILAT, KRESEK, TANGERANG, BANTEN",18,40,98,138
https://kawalpemilu.org#52347,"RANCAILAT, KRESEK, TANGERANG, BANTEN",20,39,117,156
https://kawalpemilu.org#52347,"RANCAILAT, KRESEK, TANGERANG, BANTEN",21,55,172,227
https://kawalpemilu.org#52347,"RANCAILAT, KRESEK, TANGERANG, BANTEN",22,79,144,223
https://kawalpemilu.org#52347,"RANCAILAT, KRESEK, TANGERANG, BANTEN",23,50,147,197
https://kawalpemilu.org#52347,"RANCAILAT, KRESEK, TANGERANG, BANTEN",24,56,127,183
https://kawalpemilu.org#52347,"RANCAILAT, KRESEK, TANGERANG, BANTEN",25,67,65,132
https://kawalpemilu.org#52348,"KEMUNING, KRESEK, TANGERANG, BANTEN",1,44,132,176
https://kawalpemilu.org#52348,"KEMUNING, KRESEK, TANGERANG, BANTEN",2,41,153,194
https://kawalpemilu.org#52348,"KEMUNING, KRESEK, TANGERANG, BANTEN",3,33,106,139
https://kawalpemilu.org#52348,"KEMUNING, KRESEK, TANGERANG, BANTEN",4,83,73,156
https://kawalpemilu.org#52348,"KEMUNING, KRESEK, TANGERANG, BANTEN",5,84,101,185
https://kawalpemilu.org#52348,"KEMUNING, KRESEK, TANGERANG, BANTEN",6,72,133,205
https://kawalpemilu.org#52348,"KEMUNING, KRESEK, TANGERANG, BANTEN",7,46,124,170
https://kawalpemilu.org#52348,"KEMUNING, KRESEK, TANGERANG, BANTEN",8,51,112,163
https://kawalpemilu.org#52348,"KEMUNING, KRESEK, TANGERANG, BANTEN",9,68,104,172
https://kawalpemilu.org#52348,"KEMUNING, KRESEK, TANGERANG, BANTEN",11,91,127,218
https://kawalpemilu.org#52348,"KEMUNING, KRESEK, TANGERANG, BANTEN",13,55,79,134
https://kawalpemilu.org#52348,"KEMUNING, KRESEK, TANGERANG, BANTEN",14,37,123,160
https://kawalpemilu.org#52348,"KEMUNING, KRESEK, TANGERANG, BANTEN",15,46,96,142
https://kawalpemilu.org#52348,"KEMUNING, KRESEK, TANGERANG, BANTEN",16,41,129,170
https://kawalpemilu.org#52348,"KEMUNING, KRESEK, TANGERANG, BANTEN",17,38,115,153
https://kawalpemilu.org#52348,"KEMUNING, KRESEK, TANGERANG, BANTEN",19,25,131,156
https://kawalpemilu.org#52348,"KEMUNING, KRESEK, TANGERANG, BANTEN",20,78,111,189
https://kawalpemilu.org#52348,"KEMUNING, KRESEK, TANGERANG, BANTEN",21,97,75,172
https://kawalpemilu.org#52348,"KEMUNING, KRESEK, TANGERANG, BANTEN",22,80,95,126
https://kawalpemilu.org#52348,"KEMUNING, KRESEK, TANGERANG, BANTEN",23,86,92,178
https://kawalpemilu.org#52348,"KEMUNING, KRESEK, TANGERANG, BANTEN",24,54,82,140
https://kawalpemilu.org#52348,"KEMUNING, KRESEK, TANGERANG, BANTEN",25,69,78,147
https://kawalpemilu.org#52348,"KEMUNING, KRESEK, TANGERANG, BANTEN",26,90,91,181
https://kawalpemilu.org#52348,"KEMUNING, KRESEK, TANGERANG, BANTEN",27,53,87,140
https://kawalpemilu.org#52348,"KEMUNING, KRESEK, TANGERANG, BANTEN",30,98,78,176
https://kawalpemilu.org#52348,"KEMUNING, KRESEK, TANGERANG, BANTEN",31,97,83,180
https://kawalpemilu.org#52348,"KEMUNING, KRESEK, TANGERANG, BANTEN",32,100,90,190
https://kawalpemilu.org#52348,"KEMUNING, KRESEK, TANGERANG, BANTEN",33,78,100,178
https://kawalpemilu.org#52349,"RENGED, KRESEK, TANGERANG, BANTEN",1,48,116,164
https://kawalpemilu.org#52349,"RENGED, KRESEK, TANGERANG, BANTEN",2,52,124,176
https://kawalpemilu.org#52349,"RENGED, KRESEK, TANGERANG, BANTEN",3,75,145,220
https://kawalpemilu.org#52349,"RENGED, KRESEK, TANGERANG, BANTEN",4,80,153,233
https://kawalpemilu.org#52349,"RENGED, KRESEK, TANGERANG, BANTEN",5,92,80,172
https://kawalpemilu.org#52349,"RENGED, KRESEK, TANGERANG, BANTEN",6,62,85,147
https://kawalpemilu.org#52349,"RENGED, KRESEK, TANGERANG, BANTEN",8,111,108,219
https://kawalpemilu.org#52349,"RENGED, KRESEK, TANGERANG, BANTEN",9,82,82,164
https://kawalpemilu.org#52349,"RENGED, KRESEK, TANGERANG, BANTEN",10,73,103,176
https://kawalpemilu.org#52349,"RENGED, KRESEK, TANGERANG, BANTEN",11,94,77,171
https://kawalpemilu.org#52349,"RENGED, KRESEK, TANGERANG, BANTEN",12,79,85,164
https://kawalpemilu.org#52349,"RENGED, KRESEK, TANGERANG, BANTEN",13,82,64,146
https://kawalpemilu.org#52349,"RENGED, KRESEK, TANGERANG, BANTEN",14,84,71,155
https://kawalpemilu.org#52349,"RENGED, KRESEK, TANGERANG, BANTEN",15,86,65,151
https://kawalpemilu.org#52349,"RENGED, KRESEK, TANGERANG, BANTEN",16,78,37,115
https://kawalpemilu.org#52349,"RENGED, KRESEK, TANGERANG, BANTEN",17,92,83,175
https://kawalpemilu.org#52349,"RENGED, KRESEK, TANGERANG, BANTEN",18,116,69,185
https://kawalpemilu.org#52349,"RENGED, KRESEK, TANGERANG, BANTEN",19,128,122,250
https://kawalpemilu.org#52349,"RENGED, KRESEK, TANGERANG, BANTEN",20,136,125,261
https://kawalpemilu.org#52349,"RENGED, KRESEK, TANGERANG, BANTEN",21,92,137,249
https://kawalpemilu.org#52349,"RENGED, KRESEK, TANGERANG, BANTEN",22,100,146,246
https://kawalpemilu.org#52349,"RENGED, KRESEK, TANGERANG, BANTEN",23,67,73,140
https://kawalpemilu.org#52349,"RENGED, KRESEK, TANGERANG, BANTEN",24,84,84,168
https://kawalpemilu.org#52349,"RENGED, KRESEK, TANGERANG, BANTEN",25,50,81,131
https://kawalpemilu.org#52349,"RENGED, KRESEK, TANGERANG, BANTEN",26,72,91,163
https://kawalpemilu.org#52350,"TALOK, KRESEK, TANGERANG, BANTEN",1,122,82,204
https://kawalpemilu.org#52350,"TALOK, KRESEK, TANGERANG, BANTEN",2,87,56,143
https://kawalpemilu.org#52350,"TALOK, KRESEK, TANGERANG, BANTEN",3,67,67,134
https://kawalpemilu.org#52350,"TALOK, KRESEK, TANGERANG, BANTEN",5,86,79,165
https://kawalpemilu.org#52350,"TALOK, KRESEK, TANGERANG, BANTEN",6,97,159,256
https://kawalpemilu.org#52350,"TALOK, KRESEK, TANGERANG, BANTEN",7,90,31,221
https://kawalpemilu.org#52350,"TALOK, KRESEK, TANGERANG, BANTEN",8,95,143,238
https://kawalpemilu.org#52350,"TALOK, KRESEK, TANGERANG, BANTEN",9,104,120,224
https://kawalpemilu.org#52350,"TALOK, KRESEK, TANGERANG, BANTEN",10,78,49,127
https://kawalpemilu.org#52350,"TALOK, KRESEK, TANGERANG, BANTEN",11,74,53,127
https://kawalpemilu.org#52350,"TALOK, KRESEK, TANGERANG, BANTEN",12,138,109,247
https://kawalpemilu.org#52350,"TALOK, KRESEK, TANGERANG, BANTEN",13,89,153,7
https://kawalpemilu.org#52350,"TALOK, KRESEK, TANGERANG, BANTEN",14,71,178,249
https://kawalpemilu.org#52350,"TALOK, KRESEK, TANGERANG, BANTEN",15,103,140,243
https://kawalpemilu.org#52350,"TALOK, KRESEK, TANGERANG, BANTEN",17,122,130,252
https://kawalpemilu.org#52350,"TALOK, KRESEK, TANGERANG, BANTEN",18,85,119,204
https://kawalpemilu.org#52350,"TALOK, KRESEK, TANGERANG, BANTEN",19,43,124,167
https://kawalpemilu.org#52350,"TALOK, KRESEK, TANGERANG, BANTEN",20,158,62,220
https://kawalpemilu.org#52351,"KOPER, KRESEK, TANGERANG, BANTEN",1,69,63,132
https://kawalpemilu.org#52351,"KOPER, KRESEK, TANGERANG, BANTEN",2,78,53,131
https://kawalpemilu.org#52351,"KOPER, KRESEK, TANGERANG, BANTEN",3,109,72,181
https://kawalpemilu.org#52351,"KOPER, KRESEK, TANGERANG, BANTEN",4,98,83,181
https://kawalpemilu.org#52351,"KOPER, KRESEK, TANGERANG, BANTEN",5,96,50,146
https://kawalpemilu.org#52351,"KOPER, KRESEK, TANGERANG, BANTEN",6,103,33,136
https://kawalpemilu.org#52351,"KOPER, KRESEK, TANGERANG, BANTEN",7,74,57,131
https://kawalpemilu.org#52351,"KOPER, KRESEK, TANGERANG, BANTEN",8,92,40,132
https://kawalpemilu.org#52351,"KOPER, KRESEK, TANGERANG, BANTEN",9,62,64,126
https://kawalpemilu.org#52351,"KOPER, KRESEK, TANGERANG, BANTEN",10,115,73,188
https://kawalpemilu.org#52351,"KOPER, KRESEK, TANGERANG, BANTEN",11,102,64,166
https://kawalpemilu.org#52351,"KOPER, KRESEK, TANGERANG, BANTEN",13,96,84,180
https://kawalpemilu.org#52351,"KOPER, KRESEK, TANGERANG, BANTEN",14,152,88,240
https://kawalpemilu.org#52351,"KOPER, KRESEK, TANGERANG, BANTEN",15,136,71,207
https://kawalpemilu.org#52351,"KOPER, KRESEK, TANGERANG, BANTEN",16,118,55,173
https://kawalpemilu.org#52351,"KOPER, KRESEK, TANGERANG, BANTEN",17,123,55,178
https://kawalpemilu.org#52352,"JENGKOL, KRESEK, TANGERANG, BANTEN",1,103,92,195
https://kawalpemilu.org#52352,"JENGKOL, KRESEK, TANGERANG, BANTEN",2,85,103,188
https://kawalpemilu.org#52352,"JENGKOL, KRESEK, TANGERANG, BANTEN",3,51,125,176
https://kawalpemilu.org#52352,"JENGKOL, KRESEK, TANGERANG, BANTEN",4,70,149,219
https://kawalpemilu.org#52352,"JENGKOL, KRESEK, TANGERANG, BANTEN",5,117,131,248
https://kawalpemilu.org#52352,"JENGKOL, KRESEK, TANGERANG, BANTEN",6,69,157,226
https://kawalpemilu.org#52352,"JENGKOL, KRESEK, TANGERANG, BANTEN",7,84,126,210
https://kawalpemilu.org#52352,"JENGKOL, KRESEK, TANGERANG, BANTEN",8,90,106,196
https://kawalpemilu.org#52352,"JENGKOL, KRESEK, TANGERANG, BANTEN",9,64,77,141
https://kawalpemilu.org#52352,"JENGKOL, KRESEK, TANGERANG, BANTEN",10,81,72,153
https://kawalpemilu.org#52352,"JENGKOL, KRESEK, TANGERANG, BANTEN",11,82,120,202
https://kawalpemilu.org#52352,"JENGKOL, KRESEK, TANGERANG, BANTEN",12,113,41,154
https://kawalpemilu.org#52352,"JENGKOL, KRESEK, TANGERANG, BANTEN",13,124,56,180
https://kawalpemilu.org#52352,"JENGKOL, KRESEK, TANGERANG, BANTEN",15,124,115,239
https://kawalpemilu.org#52352,"JENGKOL, KRESEK, TANGERANG, BANTEN",16,48,125,173
https://kawalpemilu.org#52352,"JENGKOL, KRESEK, TANGERANG, BANTEN",17,67,115,182
https://kawalpemilu.org#52352,"JENGKOL, KRESEK, TANGERANG, BANTEN",19,75,81,156
https://kawalpemilu.org#52352,"JENGKOL, KRESEK, TANGERANG, BANTEN",20,68,61,129
https://kawalpemilu.org#52352,"JENGKOL, KRESEK, TANGERANG, BANTEN",21,63,68,131
https://kawalpemilu.org#52353,"PATRASANA, KRESEK, TANGERANG, BANTEN",1,97,93,190
https://kawalpemilu.org#52353,"PATRASANA, KRESEK, TANGERANG, BANTEN",2,113,92,205
https://kawalpemilu.org#52353,"PATRASANA, KRESEK, TANGERANG, BANTEN",3,91,130,221
https://kawalpemilu.org#52353,"PATRASANA, KRESEK, TANGERANG, BANTEN",4,129,84,213
https://kawalpemilu.org#52353,"PATRASANA, KRESEK, TANGERANG, BANTEN",5,86,97,183
https://kawalpemilu.org#52353,"PATRASANA, KRESEK, TANGERANG, BANTEN",7,86,95,181
https://kawalpemilu.org#52353,"PATRASANA, KRESEK, TANGERANG, BANTEN",8,82,81,163
https://kawalpemilu.org#52353,"PATRASANA, KRESEK, TANGERANG, BANTEN",9,75,91,166
https://kawalpemilu.org#52353,"PATRASANA, KRESEK, TANGERANG, BANTEN",10,126,42,168
https://kawalpemilu.org#52353,"PATRASANA, KRESEK, TANGERANG, BANTEN",11,83,54,137
https://kawalpemilu.org#52353,"PATRASANA, KRESEK, TANGERANG, BANTEN",12,59,98,157
https://kawalpemilu.org#52353,"PATRASANA, KRESEK, TANGERANG, BANTEN",13,71,95,166
https://kawalpemilu.org#52353,"PATRASANA, KRESEK, TANGERANG, BANTEN",14,70,90,160
https://kawalpemilu.org#52353,"PATRASANA, KRESEK, TANGERANG, BANTEN",15,58,93,151
https://kawalpemilu.org#52353,"PATRASANA, KRESEK, TANGERANG, BANTEN",17,75,117,192
https://kawalpemilu.org#52353,"PATRASANA, KRESEK, TANGERANG, BANTEN",18,93,100,193
https://kawalpemilu.org#52353,"PATRASANA, KRESEK, TANGERANG, BANTEN",19,93,59,152
https://kawalpemilu.org#52353,"PATRASANA, KRESEK, TANGERANG, BANTEN",20,81,62,143
https://kawalpemilu.org#52353,"PATRASANA, KRESEK, TANGERANG, BANTEN",24,73,63,136
https://kawalpemilu.org#52353,"PATRASANA, KRESEK, TANGERANG, BANTEN",25,81,100,181
https://kawalpemilu.org#52353,"PATRASANA, KRESEK, TANGERANG, BANTEN",26,80,108,188
https://kawalpemilu.org#52353,"PATRASANA, KRESEK, TANGERANG, BANTEN",27,73,90,163
https://kawalpemilu.org#52353,"PATRASANA, KRESEK, TANGERANG, BANTEN",28,62,111,173
https://kawalpemilu.org#52354,"KRESEK, KRESEK, TANGERANG, BANTEN",1,92,134,226
https://kawalpemilu.org#52354,"KRESEK, KRESEK, TANGERANG, BANTEN",3,86,115,201
https://kawalpemilu.org#52354,"KRESEK, KRESEK, TANGERANG, BANTEN",4,81,105,186
https://kawalpemilu.org#52354,"KRESEK, KRESEK, TANGERANG, BANTEN",5,58,104,162
https://kawalpemilu.org#52354,"KRESEK, KRESEK, TANGERANG, BANTEN",6,65,98,163
https://kawalpemilu.org#52354,"KRESEK, KRESEK, TANGERANG, BANTEN",8,83,109,192
https://kawalpemilu.org#52354,"KRESEK, KRESEK, TANGERANG, BANTEN",9,80,97,177
https://kawalpemilu.org#52354,"KRESEK, KRESEK, TANGERANG, BANTEN",10,57,129,186
https://kawalpemilu.org#52354,"KRESEK, KRESEK, TANGERANG, BANTEN",11,54,90,144
https://kawalpemilu.org#52354,"KRESEK, KRESEK, TANGERANG, BANTEN",12,97,121,218
https://kawalpemilu.org#52354,"KRESEK, KRESEK, TANGERANG, BANTEN",17,94,113,207
https://kawalpemilu.org#52354,"KRESEK, KRESEK, TANGERANG, BANTEN",18,77,117,194
https://kawalpemilu.org#52354,"KRESEK, KRESEK, TANGERANG, BANTEN",19,89,124,213
https://kawalpemilu.org#52354,"KRESEK, KRESEK, TANGERANG, BANTEN",20,101,124,225
https://kawalpemilu.org#52354,"KRESEK, KRESEK, TANGERANG, BANTEN",22,83,46,131
https://kawalpemilu.org#52354,"KRESEK, KRESEK, TANGERANG, BANTEN",23,80,39,119
https://kawalpemilu.org#52354,"KRESEK, KRESEK, TANGERANG, BANTEN",24,138,64,202
https://kawalpemilu.org#52354,"KRESEK, KRESEK, TANGERANG, BANTEN",25,90,52,142
https://kawalpemilu.org#52354,"KRESEK, KRESEK, TANGERANG, BANTEN",26,62,71,133
https://kawalpemilu.org#52354,"KRESEK, KRESEK, TANGERANG, BANTEN",28,113,131,244
https://kawalpemilu.org#52354,"KRESEK, KRESEK, TANGERANG, BANTEN",29,95,120,215
https://kawalpemilu.org#52354,"KRESEK, KRESEK, TANGERANG, BANTEN",31,53,85,138
https://kawalpemilu.org#52354,"KRESEK, KRESEK, TANGERANG, BANTEN",32,60,76,136
https://kawalpemilu.org#52354,"KRESEK, KRESEK, TANGERANG, BANTEN",33,96,135,231
https://kawalpemilu.org#52357,"KRONJO, KRONJO, TANGERANG, BANTEN",1,55,109,164
https://kawalpemilu.org#52357,"KRONJO, KRONJO, TANGERANG, BANTEN",6,90,124,214
https://kawalpemilu.org#52357,"KRONJO, KRONJO, TANGERANG, BANTEN",11,59,148,207
https://kawalpemilu.org#52357,"KRONJO, KRONJO, TANGERANG, BANTEN",12,82,84,166
https://kawalpemilu.org#52357,"KRONJO, KRONJO, TANGERANG, BANTEN",13,51,123,174
https://kawalpemilu.org#52357,"KRONJO, KRONJO, TANGERANG, BANTEN",14,35,100,135
https://kawalpemilu.org#52357,"KRONJO, KRONJO, TANGERANG, BANTEN",16,33,48,81
https://kawalpemilu.org#52357,"KRONJO, KRONJO, TANGERANG, BANTEN",17,70,88,158
https://kawalpemilu.org#52357,"KRONJO, KRONJO, TANGERANG, BANTEN",18,57,111,168
https://kawalpemilu.org#52357,"KRONJO, KRONJO, TANGERANG, BANTEN",20,41,76,117
https://kawalpemilu.org#52357,"KRONJO, KRONJO, TANGERANG, BANTEN",21,42,96,138
https://kawalpemilu.org#52357,"KRONJO, KRONJO, TANGERANG, BANTEN",22,50,113,163
https://kawalpemilu.org#52357,"KRONJO, KRONJO, TANGERANG, BANTEN",23,59,134,193
https://kawalpemilu.org#52357,"KRONJO, KRONJO, TANGERANG, BANTEN",24,56,179,235
https://kawalpemilu.org#52357,"KRONJO, KRONJO, TANGERANG, BANTEN",25,39,48,87
https://kawalpemilu.org#52357,"KRONJO, KRONJO, TANGERANG, BANTEN",27,44,81,125
https://kawalpemilu.org#52357,"KRONJO, KRONJO, TANGERANG, BANTEN",28,56,52,108
https://kawalpemilu.org#52358,"PAGENJAHAN, KRONJO, TANGERANG, BANTEN",1,42,147,189
https://kawalpemilu.org#52358,"PAGENJAHAN, KRONJO, TANGERANG, BANTEN",2,63,112,175
https://kawalpemilu.org#52358,"PAGENJAHAN, KRONJO, TANGERANG, BANTEN",3,104,82,186
https://kawalpemilu.org#52358,"PAGENJAHAN, KRONJO, TANGERANG, BANTEN",6,92,77,169
https://kawalpemilu.org#52358,"PAGENJAHAN, KRONJO, TANGERANG, BANTEN",8,72,138,210
https://kawalpemilu.org#52358,"PAGENJAHAN, KRONJO, TANGERANG, BANTEN",9,78,119,197
https://kawalpemilu.org#52358,"PAGENJAHAN, KRONJO, TANGERANG, BANTEN",11,81,97,178
https://kawalpemilu.org#52358,"PAGENJAHAN, KRONJO, TANGERANG, BANTEN",13,34,163,197
https://kawalpemilu.org#52358,"PAGENJAHAN, KRONJO, TANGERANG, BANTEN",14,73,120,193
https://kawalpemilu.org#52358,"PAGENJAHAN, KRONJO, TANGERANG, BANTEN",15,54,108,162
https://kawalpemilu.org#52358,"PAGENJAHAN, KRONJO, TANGERANG, BANTEN",16,40,127,167
https://kawalpemilu.org#52358,"PAGENJAHAN, KRONJO, TANGERANG, BANTEN",18,38,121,159
https://kawalpemilu.org#52358,"PAGENJAHAN, KRONJO, TANGERANG, BANTEN",19,74,100,181
https://kawalpemilu.org#52358,"PAGENJAHAN, KRONJO, TANGERANG, BANTEN",20,37,102,139
https://kawalpemilu.org#52359,"PASIR, KRONJO, TANGERANG, BANTEN",1,66,103,169
https://kawalpemilu.org#52359,"PASIR, KRONJO, TANGERANG, BANTEN",4,55,140,195
https://kawalpemilu.org#52359,"PASIR, KRONJO, TANGERANG, BANTEN",6,28,121,149
https://kawalpemilu.org#52359,"PASIR, KRONJO, TANGERANG, BANTEN",7,56,99,155
https://kawalpemilu.org#52359,"PASIR, KRONJO, TANGERANG, BANTEN",8,42,138,180
https://kawalpemilu.org#52359,"PASIR, KRONJO, TANGERANG, BANTEN",9,69,121,190
https://kawalpemilu.org#52359,"PASIR, KRONJO, TANGERANG, BANTEN",11,59,118,177
https://kawalpemilu.org#52359,"PASIR, KRONJO, TANGERANG, BANTEN",12,44,164,208
https://kawalpemilu.org#52359,"PASIR, KRONJO, TANGERANG, BANTEN",13,57,111,168
https://kawalpemilu.org#52359,"PASIR, KRONJO, TANGERANG, BANTEN",14,49,104,153
https://kawalpemilu.org#52360,"MUNCUNG, KRONJO, TANGERANG, BANTEN",1,57,104,161
https://kawalpemilu.org#52360,"MUNCUNG, KRONJO, TANGERANG, BANTEN",2,83,114,197
https://kawalpemilu.org#52360,"MUNCUNG, KRONJO, TANGERANG, BANTEN",3,67,79,146
https://kawalpemilu.org#52360,"MUNCUNG, KRONJO, TANGERANG, BANTEN",4,58,114,172
https://kawalpemilu.org#52360,"MUNCUNG, KRONJO, TANGERANG, BANTEN",5,52,106,158
https://kawalpemilu.org#52360,"MUNCUNG, KRONJO, TANGERANG, BANTEN",6,80,105,185
https://kawalpemilu.org#52360,"MUNCUNG, KRONJO, TANGERANG, BANTEN",9,60,107,167
https://kawalpemilu.org#52360,"MUNCUNG, KRONJO, TANGERANG, BANTEN",10,71,117,188
https://kawalpemilu.org#52360,"MUNCUNG, KRONJO, TANGERANG, BANTEN",11,86,128,214
https://kawalpemilu.org#52360,"MUNCUNG, KRONJO, TANGERANG, BANTEN",12,78,50,128
https://kawalpemilu.org#52360,"MUNCUNG, KRONJO, TANGERANG, BANTEN",13,65,67,132
https://kawalpemilu.org#52360,"MUNCUNG, KRONJO, TANGERANG, BANTEN",14,22,32,54
https://kawalpemilu.org#52360,"MUNCUNG, KRONJO, TANGERANG, BANTEN",15,54,88,142
https://kawalpemilu.org#52360,"MUNCUNG, KRONJO, TANGERANG, BANTEN",16,66,52,118
https://kawalpemilu.org#52360,"MUNCUNG, KRONJO, TANGERANG, BANTEN",17,49,75,124
https://kawalpemilu.org#52360,"MUNCUNG, KRONJO, TANGERANG, BANTEN",18,70,72,142
https://kawalpemilu.org#52360,"MUNCUNG, KRONJO, TANGERANG, BANTEN",19,83,61,144
https://kawalpemilu.org#52361,"PAGEDANGAN ILIR, KRONJO, TANGERANG, BANTEN",1,87,111,198
https://kawalpemilu.org#52361,"PAGEDANGAN ILIR, KRONJO, TANGERANG, BANTEN",2,46,103,149
https://kawalpemilu.org#52361,"PAGEDANGAN ILIR, KRONJO, TANGERANG, BANTEN",3,68,163,231
https://kawalpemilu.org#52361,"PAGEDANGAN ILIR, KRONJO, TANGERANG, BANTEN",4,50,94,144
https://kawalpemilu.org#52361,"PAGEDANGAN ILIR, KRONJO, TANGERANG, BANTEN",7,94,102,196
https://kawalpemilu.org#52361,"PAGEDANGAN ILIR, KRONJO, TANGERANG, BANTEN",8,90,59,149
https://kawalpemilu.org#52361,"PAGEDANGAN ILIR, KRONJO, TANGERANG, BANTEN",9,71,87,158
https://kawalpemilu.org#52361,"PAGEDANGAN ILIR, KRONJO, TANGERANG, BANTEN",10,63,89,152
https://kawalpemilu.org#52361,"PAGEDANGAN ILIR, KRONJO, TANGERANG, BANTEN",15,60,131,191
https://kawalpemilu.org#52361,"PAGEDANGAN ILIR, KRONJO, TANGERANG, BANTEN",19,63,94,157
https://kawalpemilu.org#52361,"PAGEDANGAN ILIR, KRONJO, TANGERANG, BANTEN",20,63,82,145
https://kawalpemilu.org#52361,"PAGEDANGAN ILIR, KRONJO, TANGERANG, BANTEN",21,62,88,150
https://kawalpemilu.org#52361,"PAGEDANGAN ILIR, KRONJO, TANGERANG, BANTEN",22,51,54,105
https://kawalpemilu.org#52362,"PAGEDANGAN UDIK, KRONJO, TANGERANG, BANTEN",1,60,125,185
https://kawalpemilu.org#52362,"PAGEDANGAN UDIK, KRONJO, TANGERANG, BANTEN",2,33,115,148
https://kawalpemilu.org#52362,"PAGEDANGAN UDIK, KRONJO, TANGERANG, BANTEN",3,66,146,212
https://kawalpemilu.org#52362,"PAGEDANGAN UDIK, KRONJO, TANGERANG, BANTEN",4,60,73,133
https://kawalpemilu.org#52362,"PAGEDANGAN UDIK, KRONJO, TANGERANG, BANTEN",5,107,107,214
https://kawalpemilu.org#52362,"PAGEDANGAN UDIK, KRONJO, TANGERANG, BANTEN",6,57,94,151
https://kawalpemilu.org#52362,"PAGEDANGAN UDIK, KRONJO, TANGERANG, BANTEN",7,54,154,208
https://kawalpemilu.org#52362,"PAGEDANGAN UDIK, KRONJO, TANGERANG, BANTEN",8,74,125,199
https://kawalpemilu.org#52362,"PAGEDANGAN UDIK, KRONJO, TANGERANG, BANTEN",9,56,96,152
https://kawalpemilu.org#52362,"PAGEDANGAN UDIK, KRONJO, TANGERANG, BANTEN",10,42,87,129
https://kawalpemilu.org#52362,"PAGEDANGAN UDIK, KRONJO, TANGERANG, BANTEN",11,68,132,200
https://kawalpemilu.org#52362,"PAGEDANGAN UDIK, KRONJO, TANGERANG, BANTEN",12,56,121,177
https://kawalpemilu.org#52362,"PAGEDANGAN UDIK, KRONJO, TANGERANG, BANTEN",13,77,119,196
https://kawalpemilu.org#52362,"PAGEDANGAN UDIK, KRONJO, TANGERANG, BANTEN",14,66,129,195
https://kawalpemilu.org#52362,"PAGEDANGAN UDIK, KRONJO, TANGERANG, BANTEN",15,38,97,135
https://kawalpemilu.org#52362,"PAGEDANGAN UDIK, KRONJO, TANGERANG, BANTEN",16,56,85,141
https://kawalpemilu.org#52362,"PAGEDANGAN UDIK, KRONJO, TANGERANG, BANTEN",17,77,92,169
https://kawalpemilu.org#52362,"PAGEDANGAN UDIK, KRONJO, TANGERANG, BANTEN",18,57,164,221
https://kawalpemilu.org#52362,"PAGEDANGAN UDIK, KRONJO, TANGERANG, BANTEN",19,49,106,155
https://kawalpemilu.org#52362,"PAGEDANGAN UDIK, KRONJO, TANGERANG, BANTEN",20,44,117,161
https://kawalpemilu.org#52363,"PASILIAN, KRONJO, TANGERANG, BANTEN",1,40,84,124
https://kawalpemilu.org#52363,"PASILIAN, KRONJO, TANGERANG, BANTEN",2,56,74,130
https://kawalpemilu.org#52363,"PASILIAN, KRONJO, TANGERANG, BANTEN",3,105,116,221
https://kawalpemilu.org#52363,"PASILIAN, KRONJO, TANGERANG, BANTEN",5,57,89,146
https://kawalpemilu.org#52363,"PASILIAN, KRONJO, TANGERANG, BANTEN",6,64,171,235
https://kawalpemilu.org#52363,"PASILIAN, KRONJO, TANGERANG, BANTEN",7,113,118,231
https://kawalpemilu.org#52363,"PASILIAN, KRONJO, TANGERANG, BANTEN",8,24,115,139
https://kawalpemilu.org#52363,"PASILIAN, KRONJO, TANGERANG, BANTEN",9,32,103,135
https://kawalpemilu.org#52363,"PASILIAN, KRONJO, TANGERANG, BANTEN",11,35,99,134
https://kawalpemilu.org#52363,"PASILIAN, KRONJO, TANGERANG, BANTEN",12,53,143,196
https://kawalpemilu.org#52363,"PASILIAN, KRONJO, TANGERANG, BANTEN",13,58,92,150
https://kawalpemilu.org#52363,"PASILIAN, KRONJO, TANGERANG, BANTEN",14,68,96,164
https://kawalpemilu.org#52363,"PASILIAN, KRONJO, TANGERANG, BANTEN",15,114,122,236
https://kawalpemilu.org#52363,"PASILIAN, KRONJO, TANGERANG, BANTEN",16,46,94,140
https://kawalpemilu.org#52363,"PASILIAN, KRONJO, TANGERANG, BANTEN",17,46,75,121
https://kawalpemilu.org#52363,"PASILIAN, KRONJO, TANGERANG, BANTEN",18,51,80,131
https://kawalpemilu.org#52363,"PASILIAN, KRONJO, TANGERANG, BANTEN",19,36,80,116
https://kawalpemilu.org#52363,"PASILIAN, KRONJO, TANGERANG, BANTEN",21,59,72,122
https://kawalpemilu.org#52363,"PASILIAN, KRONJO, TANGERANG, BANTEN",22,49,137,186
https://kawalpemilu.org#52363,"PASILIAN, KRONJO, TANGERANG, BANTEN",23,23,102,125
https://kawalpemilu.org#52363,"PASILIAN, KRONJO, TANGERANG, BANTEN",25,65,77,142
https://kawalpemilu.org#52364,"BAKUNG, KRONJO, TANGERANG, BANTEN",1,34,87,121
https://kawalpemilu.org#52364,"BAKUNG, KRONJO, TANGERANG, BANTEN",5,65,110,175
https://kawalpemilu.org#52364,"BAKUNG, KRONJO, TANGERANG, BANTEN",7,51,77,128
https://kawalpemilu.org#52364,"BAKUNG, KRONJO, TANGERANG, BANTEN",8,72,143,215
https://kawalpemilu.org#52364,"BAKUNG, KRONJO, TANGERANG, BANTEN",9,52,139,191
https://kawalpemilu.org#52364,"BAKUNG, KRONJO, TANGERANG, BANTEN",10,54,75,129
https://kawalpemilu.org#52364,"BAKUNG, KRONJO, TANGERANG, BANTEN",12,92,135,227
https://kawalpemilu.org#52364,"BAKUNG, KRONJO, TANGERANG, BANTEN",13,85,73,158
https://kawalpemilu.org#52364,"BAKUNG, KRONJO, TANGERANG, BANTEN",14,69,61,130
https://kawalpemilu.org#52364,"BAKUNG, KRONJO, TANGERANG, BANTEN",15,50,103,153
https://kawalpemilu.org#52364,"BAKUNG, KRONJO, TANGERANG, BANTEN",16,42,76,118
https://kawalpemilu.org#52364,"BAKUNG, KRONJO, TANGERANG, BANTEN",17,55,120,175
https://kawalpemilu.org#52364,"BAKUNG, KRONJO, TANGERANG, BANTEN",18,50,96,146
https://kawalpemilu.org#52364,"BAKUNG, KRONJO, TANGERANG, BANTEN",19,49,116,165
https://kawalpemilu.org#52364,"BAKUNG, KRONJO, TANGERANG, BANTEN",20,64,87,151
https://kawalpemilu.org#52364,"BAKUNG, KRONJO, TANGERANG, BANTEN",21,43,139,182
https://kawalpemilu.org#52364,"BAKUNG, KRONJO, TANGERANG, BANTEN",22,46,89,135
https://kawalpemilu.org#52364,"BAKUNG, KRONJO, TANGERANG, BANTEN",23,51,135,186
https://kawalpemilu.org#52364,"BAKUNG, KRONJO, TANGERANG, BANTEN",25,99,66,165
https://kawalpemilu.org#52364,"BAKUNG, KRONJO, TANGERANG, BANTEN",27,77,79,156
https://kawalpemilu.org#52364,"BAKUNG, KRONJO, TANGERANG, BANTEN",28,59,63,122
https://kawalpemilu.org#52364,"BAKUNG, KRONJO, TANGERANG, BANTEN",29,30,108,138
https://kawalpemilu.org#52365,"BLUKBUK, KRONJO, TANGERANG, BANTEN",1,63,167,230
https://kawalpemilu.org#52365,"BLUKBUK, KRONJO, TANGERANG, BANTEN",2,55,148,203
https://kawalpemilu.org#52365,"BLUKBUK, KRONJO, TANGERANG, BANTEN",3,44,120,164
https://kawalpemilu.org#52365,"BLUKBUK, KRONJO, TANGERANG, BANTEN",4,50,128,178
https://kawalpemilu.org#52365,"BLUKBUK, KRONJO, TANGERANG, BANTEN",5,51,116,167
https://kawalpemilu.org#52365,"BLUKBUK, KRONJO, TANGERANG, BANTEN",6,135,108,243
https://kawalpemilu.org#52365,"BLUKBUK, KRONJO, TANGERANG, BANTEN",7,63,156,219
https://kawalpemilu.org#52365,"BLUKBUK, KRONJO, TANGERANG, BANTEN",8,61,160,221
https://kawalpemilu.org#52365,"BLUKBUK, KRONJO, TANGERANG, BANTEN",9,38,95,133
https://kawalpemilu.org#52365,"BLUKBUK, KRONJO, TANGERANG, BANTEN",10,72,66,138
https://kawalpemilu.org#52365,"BLUKBUK, KRONJO, TANGERANG, BANTEN",11,72,132,204
https://kawalpemilu.org#52365,"BLUKBUK, KRONJO, TANGERANG, BANTEN",12,54,93,147
https://kawalpemilu.org#52365,"BLUKBUK, KRONJO, TANGERANG, BANTEN",13,49,126,175
https://kawalpemilu.org#52365,"BLUKBUK, KRONJO, TANGERANG, BANTEN",14,88,140,228
https://kawalpemilu.org#52365,"BLUKBUK, KRONJO, TANGERANG, BANTEN",15,50,118,168
https://kawalpemilu.org#52365,"BLUKBUK, KRONJO, TANGERANG, BANTEN",16,42,80,122
https://kawalpemilu.org#52365,"BLUKBUK, KRONJO, TANGERANG, BANTEN",17,64,62,126
https://kawalpemilu.org#52366,"CIRUMPAK, KRONJO, TANGERANG, BANTEN",3,39,135,174
https://kawalpemilu.org#52366,"CIRUMPAK, KRONJO, TANGERANG, BANTEN",4,93,117,210
https://kawalpemilu.org#52366,"CIRUMPAK, KRONJO, TANGERANG, BANTEN",5,72,202,274
https://kawalpemilu.org#52366,"CIRUMPAK, KRONJO, TANGERANG, BANTEN",6,48,75,123
https://kawalpemilu.org#52366,"CIRUMPAK, KRONJO, TANGERANG, BANTEN",7,44,91,135
https://kawalpemilu.org#52366,"CIRUMPAK, KRONJO, TANGERANG, BANTEN",8,98,130,228
https://kawalpemilu.org#52366,"CIRUMPAK, KRONJO, TANGERANG, BANTEN",9,88,79,167
https://kawalpemilu.org#52366,"CIRUMPAK, KRONJO, TANGERANG, BANTEN",10,24,88,112
https://kawalpemilu.org#52366,"CIRUMPAK, KRONJO, TANGERANG, BANTEN",11,43,128,171
https://kawalpemilu.org#52366,"CIRUMPAK, KRONJO, TANGERANG, BANTEN",12,50,145,195
https://kawalpemilu.org#52366,"CIRUMPAK, KRONJO, TANGERANG, BANTEN",13,150,108,258
https://kawalpemilu.org#52368,"MAUK TIMUR, MAUK, TANGERANG, BANTEN",1,74,169,243
https://kawalpemilu.org#52368,"MAUK TIMUR, MAUK, TANGERANG, BANTEN",3,46,100,146
https://kawalpemilu.org#52368,"MAUK TIMUR, MAUK, TANGERANG, BANTEN",4,42,97,139
https://kawalpemilu.org#52368,"MAUK TIMUR, MAUK, TANGERANG, BANTEN",5,83,160,243
https://kawalpemilu.org#52368,"MAUK TIMUR, MAUK, TANGERANG, BANTEN",7,76,117,193
https://kawalpemilu.org#52368,"MAUK TIMUR, MAUK, TANGERANG, BANTEN",8,69,95,164
https://kawalpemilu.org#52368,"MAUK TIMUR, MAUK, TANGERANG, BANTEN",9,104,60,164
https://kawalpemilu.org#52368,"MAUK TIMUR, MAUK, TANGERANG, BANTEN",11,89,85,174
https://kawalpemilu.org#52368,"MAUK TIMUR, MAUK, TANGERANG, BANTEN",12,61,121,182
https://kawalpemilu.org#52368,"MAUK TIMUR, MAUK, TANGERANG, BANTEN",14,54,110,164
https://kawalpemilu.org#52368,"MAUK TIMUR, MAUK, TANGERANG, BANTEN",15,39,96,135
https://kawalpemilu.org#52368,"MAUK TIMUR, MAUK, TANGERANG, BANTEN",16,32,92,124
https://kawalpemilu.org#52368,"MAUK TIMUR, MAUK, TANGERANG, BANTEN",17,52,51,103
https://kawalpemilu.org#52368,"MAUK TIMUR, MAUK, TANGERANG, BANTEN",19,71,82,153
https://kawalpemilu.org#52368,"MAUK TIMUR, MAUK, TANGERANG, BANTEN",20,79,34,113
https://kawalpemilu.org#52368,"MAUK TIMUR, MAUK, TANGERANG, BANTEN",21,72,84,156
https://kawalpemilu.org#52369,"MAUK BARAT, MAUK, TANGERANG, BANTEN",1,50,96,146
https://kawalpemilu.org#52369,"MAUK BARAT, MAUK, TANGERANG, BANTEN",2,65,131,196
https://kawalpemilu.org#52369,"MAUK BARAT, MAUK, TANGERANG, BANTEN",3,53,172,225
https://kawalpemilu.org#52369,"MAUK BARAT, MAUK, TANGERANG, BANTEN",4,30,102,132
https://kawalpemilu.org#52369,"MAUK BARAT, MAUK, TANGERANG, BANTEN",5,74,128,202
https://kawalpemilu.org#52369,"MAUK BARAT, MAUK, TANGERANG, BANTEN",6,91,93,184
https://kawalpemilu.org#52369,"MAUK BARAT, MAUK, TANGERANG, BANTEN",7,69,92,161
https://kawalpemilu.org#52369,"MAUK BARAT, MAUK, TANGERANG, BANTEN",8,56,112,168
https://kawalpemilu.org#52369,"MAUK BARAT, MAUK, TANGERANG, BANTEN",9,65,125,190
https://kawalpemilu.org#52369,"MAUK BARAT, MAUK, TANGERANG, BANTEN",11,62,151,213
https://kawalpemilu.org#52369,"MAUK BARAT, MAUK, TANGERANG, BANTEN",12,48,79,127
https://kawalpemilu.org#52369,"MAUK BARAT, MAUK, TANGERANG, BANTEN",15,51,108,159
https://kawalpemilu.org#52369,"MAUK BARAT, MAUK, TANGERANG, BANTEN",16,84,94,178
https://kawalpemilu.org#52369,"MAUK BARAT, MAUK, TANGERANG, BANTEN",17,54,124,178
https://kawalpemilu.org#52369,"MAUK BARAT, MAUK, TANGERANG, BANTEN",18,49,115,164
https://kawalpemilu.org#52369,"MAUK BARAT, MAUK, TANGERANG, BANTEN",19,115,88,203
https://kawalpemilu.org#52369,"MAUK BARAT, MAUK, TANGERANG, BANTEN",20,89,120,209
https://kawalpemilu.org#52369,"MAUK BARAT, MAUK, TANGERANG, BANTEN",21,64,146,210
https://kawalpemilu.org#52370,"TEGAL KUNIR KIDUL, MAUK, TANGERANG, BANTEN",2,57,130,187
https://kawalpemilu.org#52370,"TEGAL KUNIR KIDUL, MAUK, TANGERANG, BANTEN",3,55,193,248
https://kawalpemilu.org#52370,"TEGAL KUNIR KIDUL, MAUK, TANGERANG, BANTEN",5,52,142,194
https://kawalpemilu.org#52370,"TEGAL KUNIR KIDUL, MAUK, TANGERANG, BANTEN",8,33,173,206
https://kawalpemilu.org#52370,"TEGAL KUNIR KIDUL, MAUK, TANGERANG, BANTEN",9,49,141,190
https://kawalpemilu.org#52370,"TEGAL KUNIR KIDUL, MAUK, TANGERANG, BANTEN",10,23,74,97
https://kawalpemilu.org#52370,"TEGAL KUNIR KIDUL, MAUK, TANGERANG, BANTEN",11,41,178,219
https://kawalpemilu.org#52370,"TEGAL KUNIR KIDUL, MAUK, TANGERANG, BANTEN",12,36,107,143
https://kawalpemilu.org#52370,"TEGAL KUNIR KIDUL, MAUK, TANGERANG, BANTEN",16,29,155,184
https://kawalpemilu.org#52370,"TEGAL KUNIR KIDUL, MAUK, TANGERANG, BANTEN",17,43,158,201
https://kawalpemilu.org#52370,"TEGAL KUNIR KIDUL, MAUK, TANGERANG, BANTEN",18,38,148,186
https://kawalpemilu.org#52370,"TEGAL KUNIR KIDUL, MAUK, TANGERANG, BANTEN",19,45,203,248
https://kawalpemilu.org#52370,"TEGAL KUNIR KIDUL, MAUK, TANGERANG, BANTEN",20,43,192,235
https://kawalpemilu.org#52370,"TEGAL KUNIR KIDUL, MAUK, TANGERANG, BANTEN",21,39,179,218
https://kawalpemilu.org#52370,"TEGAL KUNIR KIDUL, MAUK, TANGERANG, BANTEN",22,29,157,186
https://kawalpemilu.org#52370,"TEGAL KUNIR KIDUL, MAUK, TANGERANG, BANTEN",23,21,117,138
https://kawalpemilu.org#52370,"TEGAL KUNIR KIDUL, MAUK, TANGERANG, BANTEN",24,44,134,178
https://kawalpemilu.org#52370,"TEGAL KUNIR KIDUL, MAUK, TANGERANG, BANTEN",25,166,168,234
https://kawalpemilu.org#52370,"TEGAL KUNIR KIDUL, MAUK, TANGERANG, BANTEN",26,64,184,248
https://kawalpemilu.org#52370,"TEGAL KUNIR KIDUL, MAUK, TANGERANG, BANTEN",28,25,147,172
https://kawalpemilu.org#52371,"TEGAL KUNIR LOR, MAUK, TANGERANG, BANTEN",1,29,117,146
https://kawalpemilu.org#52371,"TEGAL KUNIR LOR, MAUK, TANGERANG, BANTEN",2,33,150,183
https://kawalpemilu.org#52371,"TEGAL KUNIR LOR, MAUK, TANGERANG, BANTEN",3,31,175,206
https://kawalpemilu.org#52371,"TEGAL KUNIR LOR, MAUK, TANGERANG, BANTEN",4,27,115,142
https://kawalpemilu.org#52371,"TEGAL KUNIR LOR, MAUK, TANGERANG, BANTEN",6,18,143,161
https://kawalpemilu.org#52371,"TEGAL KUNIR LOR, MAUK, TANGERANG, BANTEN",7,37,176,213
https://kawalpemilu.org#52371,"TEGAL KUNIR LOR, MAUK, TANGERANG, BANTEN",9,33,171,204
https://kawalpemilu.org#52371,"TEGAL KUNIR LOR, MAUK, TANGERANG, BANTEN",10,37,145,182
https://kawalpemilu.org#52371,"TEGAL KUNIR LOR, MAUK, TANGERANG, BANTEN",11,28,126,154
https://kawalpemilu.org#52371,"TEGAL KUNIR LOR, MAUK, TANGERANG, BANTEN",13,17,136,153
https://kawalpemilu.org#52371,"TEGAL KUNIR LOR, MAUK, TANGERANG, BANTEN",14,14,122,136
https://kawalpemilu.org#52371,"TEGAL KUNIR LOR, MAUK, TANGERANG, BANTEN",15,71,182,253
https://kawalpemilu.org#52371,"TEGAL KUNIR LOR, MAUK, TANGERANG, BANTEN",17,16,165,181
https://kawalpemilu.org#52371,"TEGAL KUNIR LOR, MAUK, TANGERANG, BANTEN",18,11,204,215
https://kawalpemilu.org#52371,"TEGAL KUNIR LOR, MAUK, TANGERANG, BANTEN",19,29,162,191
https://kawalpemilu.org#52371,"TEGAL KUNIR LOR, MAUK, TANGERANG, BANTEN",20,31,206,237
https://kawalpemilu.org#52371,"TEGAL KUNIR LOR, MAUK, TANGERANG, BANTEN",22,28,201,229
https://kawalpemilu.org#52371,"TEGAL KUNIR LOR, MAUK, TANGERANG, BANTEN",23,20,151,171
https://kawalpemilu.org#52371,"TEGAL KUNIR LOR, MAUK, TANGERANG, BANTEN",24,19,142,161
https://kawalpemilu.org#52371,"TEGAL KUNIR LOR, MAUK, TANGERANG, BANTEN",25,30,109,139
https://kawalpemilu.org#52372,"SASAK, MAUK, TANGERANG, BANTEN",1,30,167,197
https://kawalpemilu.org#52372,"SASAK, MAUK, TANGERANG, BANTEN",2,71,157,228
https://kawalpemilu.org#52372,"SASAK, MAUK, TANGERANG, BANTEN",3,28,121,149
https://kawalpemilu.org#52372,"SASAK, MAUK, TANGERANG, BANTEN",4,30,140,170
https://kawalpemilu.org#52372,"SASAK, MAUK, TANGERANG, BANTEN",5,153,197,250
https://kawalpemilu.org#52372,"SASAK, MAUK, TANGERANG, BANTEN",6,62,136,198
https://kawalpemilu.org#52372,"SASAK, MAUK, TANGERANG, BANTEN",7,67,153,220
https://kawalpemilu.org#52372,"SASAK, MAUK, TANGERANG, BANTEN",8,86,123,209
https://kawalpemilu.org#52372,"SASAK, MAUK, TANGERANG, BANTEN",10,48,151,202
https://kawalpemilu.org#52372,"SASAK, MAUK, TANGERANG, BANTEN",11,62,154,216
https://kawalpemilu.org#52372,"SASAK, MAUK, TANGERANG, BANTEN",12,21,131,152
https://kawalpemilu.org#52372,"SASAK, MAUK, TANGERANG, BANTEN",14,61,181,242
https://kawalpemilu.org#52372,"SASAK, MAUK, TANGERANG, BANTEN",15,50,145,195
https://kawalpemilu.org#52372,"SASAK, MAUK, TANGERANG, BANTEN",16,74,126,200
https://kawalpemilu.org#52372,"SASAK, MAUK, TANGERANG, BANTEN",17,57,183,240
https://kawalpemilu.org#52373,"GUNUNG SARI, MAUK, TANGERANG, BANTEN",1,61,125,186
https://kawalpemilu.org#52373,"GUNUNG SARI, MAUK, TANGERANG, BANTEN",2,53,190,243
https://kawalpemilu.org#52373,"GUNUNG SARI, MAUK, TANGERANG, BANTEN",3,44,124,168
https://kawalpemilu.org#52373,"GUNUNG SARI, MAUK, TANGERANG, BANTEN",4,54,116,170
https://kawalpemilu.org#52373,"GUNUNG SARI, MAUK, TANGERANG, BANTEN",5,76,168,244
https://kawalpemilu.org#52373,"GUNUNG SARI, MAUK, TANGERANG, BANTEN",6,39,124,163
https://kawalpemilu.org#52373,"GUNUNG SARI, MAUK, TANGERANG, BANTEN",7,42,74,116
https://kawalpemilu.org#52373,"GUNUNG SARI, MAUK, TANGERANG, BANTEN",8,51,128,179
https://kawalpemilu.org#52373,"GUNUNG SARI, MAUK, TANGERANG, BANTEN",9,51,172,223
https://kawalpemilu.org#52373,"GUNUNG SARI, MAUK, TANGERANG, BANTEN",10,49,117,166
https://kawalpemilu.org#52373,"GUNUNG SARI, MAUK, TANGERANG, BANTEN",11,45,137,182
https://kawalpemilu.org#52373,"GUNUNG SARI, MAUK, TANGERANG, BANTEN",12,51,120,171
https://kawalpemilu.org#52373,"GUNUNG SARI, MAUK, TANGERANG, BANTEN",13,48,217,265
https://kawalpemilu.org#52373,"GUNUNG SARI, MAUK, TANGERANG, BANTEN",14,43,140,183
https://kawalpemilu.org#52374,"KEDUNG DALEM, MAUK, TANGERANG, BANTEN",1,42,119,161
https://kawalpemilu.org#52374,"KEDUNG DALEM, MAUK, TANGERANG, BANTEN",2,40,111,151
https://kawalpemilu.org#52374,"KEDUNG DALEM, MAUK, TANGERANG, BANTEN",5,26,224,250
https://kawalpemilu.org#52374,"KEDUNG DALEM, MAUK, TANGERANG, BANTEN",6,46,175,221
https://kawalpemilu.org#52374,"KEDUNG DALEM, MAUK, TANGERANG, BANTEN",7,62,173,235
https://kawalpemilu.org#52374,"KEDUNG DALEM, MAUK, TANGERANG, BANTEN",9,39,198,237
https://kawalpemilu.org#52374,"KEDUNG DALEM, MAUK, TANGERANG, BANTEN",10,26,130,156
https://kawalpemilu.org#52374,"KEDUNG DALEM, MAUK, TANGERANG, BANTEN",12,57,155,212
https://kawalpemilu.org#52374,"KEDUNG DALEM, MAUK, TANGERANG, BANTEN",13,44,52,96
https://kawalpemilu.org#52374,"KEDUNG DALEM, MAUK, TANGERANG, BANTEN",14,35,93,128
https://kawalpemilu.org#52374,"KEDUNG DALEM, MAUK, TANGERANG, BANTEN",15,25,72,97
https://kawalpemilu.org#52374,"KEDUNG DALEM, MAUK, TANGERANG, BANTEN",16,40,101,141
https://kawalpemilu.org#52374,"KEDUNG DALEM, MAUK, TANGERANG, BANTEN",17,38,72,110
https://kawalpemilu.org#52374,"KEDUNG DALEM, MAUK, TANGERANG, BANTEN",19,33,126,159
https://kawalpemilu.org#52374,"KEDUNG DALEM, MAUK, TANGERANG, BANTEN",20,30,51,81
https://kawalpemilu.org#52374,"KEDUNG DALEM, MAUK, TANGERANG, BANTEN",21,32,136,168
https://kawalpemilu.org#52374,"KEDUNG DALEM, MAUK, TANGERANG, BANTEN",22,99,140,239
https://kawalpemilu.org#52374,"KEDUNG DALEM, MAUK, TANGERANG, BANTEN",23,58,187,245
https://kawalpemilu.org#52374,"KEDUNG DALEM, MAUK, TANGERANG, BANTEN",24,23,181,204
https://kawalpemilu.org#52374,"KEDUNG DALEM, MAUK, TANGERANG, BANTEN",25,28,141,169
https://kawalpemilu.org#52374,"KEDUNG DALEM, MAUK, TANGERANG, BANTEN",27,40,87,127
https://kawalpemilu.org#52374,"KEDUNG DALEM, MAUK, TANGERANG, BANTEN",29,33,99,132
https://kawalpemilu.org#52375,"MARGA MULYA, MAUK, TANGERANG, BANTEN",1,99,129,228
https://kawalpemilu.org#52375,"MARGA MULYA, MAUK, TANGERANG, BANTEN",2,53,103,156
https://kawalpemilu.org#52375,"MARGA MULYA, MAUK, TANGERANG, BANTEN",3,66,122,188
https://kawalpemilu.org#52375,"MARGA MULYA, MAUK, TANGERANG, BANTEN",4,24,103,127
https://kawalpemilu.org#52375,"MARGA MULYA, MAUK, TANGERANG, BANTEN",5,72,154,226
https://kawalpemilu.org#52375,"MARGA MULYA, MAUK, TANGERANG, BANTEN",6,106,85,191
https://kawalpemilu.org#52375,"MARGA MULYA, MAUK, TANGERANG, BANTEN",7,129,69,198
https://kawalpemilu.org#52375,"MARGA MULYA, MAUK, TANGERANG, BANTEN",8,131,79,210
https://kawalpemilu.org#52375,"MARGA MULYA, MAUK, TANGERANG, BANTEN",9,207,5,212
https://kawalpemilu.org#52375,"MARGA MULYA, MAUK, TANGERANG, BANTEN",10,85,99,184
https://kawalpemilu.org#52375,"MARGA MULYA, MAUK, TANGERANG, BANTEN",11,92,86,178
https://kawalpemilu.org#52375,"MARGA MULYA, MAUK, TANGERANG, BANTEN",12,82,116,198
https://kawalpemilu.org#52375,"MARGA MULYA, MAUK, TANGERANG, BANTEN",13,51,150,201
https://kawalpemilu.org#52375,"MARGA MULYA, MAUK, TANGERANG, BANTEN",14,40,160,200
https://kawalpemilu.org#52375,"MARGA MULYA, MAUK, TANGERANG, BANTEN",15,62,120,182
https://kawalpemilu.org#52375,"MARGA MULYA, MAUK, TANGERANG, BANTEN",17,113,73,186
https://kawalpemilu.org#52375,"MARGA MULYA, MAUK, TANGERANG, BANTEN",18,102,73,175
https://kawalpemilu.org#52375,"MARGA MULYA, MAUK, TANGERANG, BANTEN",19,91,113,204
https://kawalpemilu.org#52375,"MARGA MULYA, MAUK, TANGERANG, BANTEN",20,63,146,209
https://kawalpemilu.org#52375,"MARGA MULYA, MAUK, TANGERANG, BANTEN",21,155,49,204
https://kawalpemilu.org#52375,"MARGA MULYA, MAUK, TANGERANG, BANTEN",22,211,5,216
https://kawalpemilu.org#52375,"MARGA MULYA, MAUK, TANGERANG, BANTEN",23,77,88,165
https://kawalpemilu.org#52375,"MARGA MULYA, MAUK, TANGERANG, BANTEN",24,66,102,168
https://kawalpemilu.org#52375,"MARGA MULYA, MAUK, TANGERANG, BANTEN",25,45,112,157
https://kawalpemilu.org#52376,"TANJUNG ANOM, MAUK, TANGERANG, BANTEN",1,122,106,228
https://kawalpemilu.org#52376,"TANJUNG ANOM, MAUK, TANGERANG, BANTEN",3,124,91,215
https://kawalpemilu.org#52376,"TANJUNG ANOM, MAUK, TANGERANG, BANTEN",4,75,154,229
https://kawalpemilu.org#52376,"TANJUNG ANOM, MAUK, TANGERANG, BANTEN",7,57,145,202
https://kawalpemilu.org#52376,"TANJUNG ANOM, MAUK, TANGERANG, BANTEN",10,54,171,225
https://kawalpemilu.org#52376,"TANJUNG ANOM, MAUK, TANGERANG, BANTEN",14,109,94,203
https://kawalpemilu.org#52376,"TANJUNG ANOM, MAUK, TANGERANG, BANTEN",17,44,180,224
https://kawalpemilu.org#52376,"TANJUNG ANOM, MAUK, TANGERANG, BANTEN",19,76,162,238
https://kawalpemilu.org#52376,"TANJUNG ANOM, MAUK, TANGERANG, BANTEN",20,58,124,182
https://kawalpemilu.org#52377,"JATIWARINGIN, MAUK, TANGERANG, BANTEN",1,42,153,195
https://kawalpemilu.org#52377,"JATIWARINGIN, MAUK, TANGERANG, BANTEN",2,58,103,161
https://kawalpemilu.org#52377,"JATIWARINGIN, MAUK, TANGERANG, BANTEN",3,39,120,159
https://kawalpemilu.org#52377,"JATIWARINGIN, MAUK, TANGERANG, BANTEN",4,34,162,196
https://kawalpemilu.org#52377,"JATIWARINGIN, MAUK, TANGERANG, BANTEN",7,33,145,178
https://kawalpemilu.org#52377,"JATIWARINGIN, MAUK, TANGERANG, BANTEN",8,56,124,180
https://kawalpemilu.org#52377,"JATIWARINGIN, MAUK, TANGERANG, BANTEN",10,25,169,197
https://kawalpemilu.org#52377,"JATIWARINGIN, MAUK, TANGERANG, BANTEN",11,41,146,187
https://kawalpemilu.org#52377,"JATIWARINGIN, MAUK, TANGERANG, BANTEN",13,64,171,235
https://kawalpemilu.org#52377,"JATIWARINGIN, MAUK, TANGERANG, BANTEN",14,34,101,135
https://kawalpemilu.org#52377,"JATIWARINGIN, MAUK, TANGERANG, BANTEN",15,54,105,159
https://kawalpemilu.org#52377,"JATIWARINGIN, MAUK, TANGERANG, BANTEN",16,27,143,170
https://kawalpemilu.org#52377,"JATIWARINGIN, MAUK, TANGERANG, BANTEN",17,61,151,212
https://kawalpemilu.org#52377,"JATIWARINGIN, MAUK, TANGERANG, BANTEN",18,46,178,224
https://kawalpemilu.org#52377,"JATIWARINGIN, MAUK, TANGERANG, BANTEN",19,48,179,227
https://kawalpemilu.org#52377,"JATIWARINGIN, MAUK, TANGERANG, BANTEN",20,27,166,193
https://kawalpemilu.org#52377,"JATIWARINGIN, MAUK, TANGERANG, BANTEN",22,45,106,151
https://kawalpemilu.org#52377,"JATIWARINGIN, MAUK, TANGERANG, BANTEN",23,28,177,205
https://kawalpemilu.org#52377,"JATIWARINGIN, MAUK, TANGERANG, BANTEN",24,36,178,214
https://kawalpemilu.org#52377,"JATIWARINGIN, MAUK, TANGERANG, BANTEN",25,73,170,243
https://kawalpemilu.org#52377,"JATIWARINGIN, MAUK, TANGERANG, BANTEN",27,53,158,211
https://kawalpemilu.org#52378,"BANYU ASIH, MAUK, TANGERANG, BANTEN",1,62,173,235
https://kawalpemilu.org#52378,"BANYU ASIH, MAUK, TANGERANG, BANTEN",2,34,134,168
https://kawalpemilu.org#52378,"BANYU ASIH, MAUK, TANGERANG, BANTEN",3,25,123,148
https://kawalpemilu.org#52378,"BANYU ASIH, MAUK, TANGERANG, BANTEN",4,32,140,172
https://kawalpemilu.org#52378,"BANYU ASIH, MAUK, TANGERANG, BANTEN",5,28,175,203
https://kawalpemilu.org#52378,"BANYU ASIH, MAUK, TANGERANG, BANTEN",6,51,170,221
https://kawalpemilu.org#52378,"BANYU ASIH, MAUK, TANGERANG, BANTEN",7,38,141,179
https://kawalpemilu.org#52378,"BANYU ASIH, MAUK, TANGERANG, BANTEN",9,42,129,171
https://kawalpemilu.org#52378,"BANYU ASIH, MAUK, TANGERANG, BANTEN",10,34,144,178
https://kawalpemilu.org#52378,"BANYU ASIH, MAUK, TANGERANG, BANTEN",11,34,197,231
https://kawalpemilu.org#52378,"BANYU ASIH, MAUK, TANGERANG, BANTEN",12,35,136,171
https://kawalpemilu.org#52378,"BANYU ASIH, MAUK, TANGERANG, BANTEN",13,41,134,175
https://kawalpemilu.org#52378,"BANYU ASIH, MAUK, TANGERANG, BANTEN",14,41,147,188
https://kawalpemilu.org#52378,"BANYU ASIH, MAUK, TANGERANG, BANTEN",15,51,139,190
https://kawalpemilu.org#52378,"BANYU ASIH, MAUK, TANGERANG, BANTEN",16,35,152,187
https://kawalpemilu.org#52378,"BANYU ASIH, MAUK, TANGERANG, BANTEN",17,31,187,218
https://kawalpemilu.org#52378,"BANYU ASIH, MAUK, TANGERANG, BANTEN",18,51,158,209
https://kawalpemilu.org#52378,"BANYU ASIH, MAUK, TANGERANG, BANTEN",20,31,202,233
https://kawalpemilu.org#52378,"BANYU ASIH, MAUK, TANGERANG, BANTEN",21,32,154,186
https://kawalpemilu.org#52378,"BANYU ASIH, MAUK, TANGERANG, BANTEN",22,30,131,161
https://kawalpemilu.org#52378,"BANYU ASIH, MAUK, TANGERANG, BANTEN",23,40,150,190
https://kawalpemilu.org#52379,"KETAPANG, MAUK, TANGERANG, BANTEN",1,50,130,180
https://kawalpemilu.org#52379,"KETAPANG, MAUK, TANGERANG, BANTEN",2,37,197,234
https://kawalpemilu.org#52379,"KETAPANG, MAUK, TANGERANG, BANTEN",3,29,183,212
https://kawalpemilu.org#52379,"KETAPANG, MAUK, TANGERANG, BANTEN",4,30,199,229
https://kawalpemilu.org#52379,"KETAPANG, MAUK, TANGERANG, BANTEN",5,36,154,190
https://kawalpemilu.org#52379,"KETAPANG, MAUK, TANGERANG, BANTEN",6,60,174,234
https://kawalpemilu.org#52379,"KETAPANG, MAUK, TANGERANG, BANTEN",7,25,205,230
https://kawalpemilu.org#52379,"KETAPANG, MAUK, TANGERANG, BANTEN",10,41,152,193
https://kawalpemilu.org#52379,"KETAPANG, MAUK, TANGERANG, BANTEN",11,31,153,184
https://kawalpemilu.org#52379,"KETAPANG, MAUK, TANGERANG, BANTEN",12,36,187,223
https://kawalpemilu.org#52379,"KETAPANG, MAUK, TANGERANG, BANTEN",13,42,183,225
https://kawalpemilu.org#52379,"KETAPANG, MAUK, TANGERANG, BANTEN",14,27,187,214
https://kawalpemilu.org#52379,"KETAPANG, MAUK, TANGERANG, BANTEN",15,41,126,167
https://kawalpemilu.org#52379,"KETAPANG, MAUK, TANGERANG, BANTEN",16,63,179,242
https://kawalpemilu.org#52379,"KETAPANG, MAUK, TANGERANG, BANTEN",17,25,178,203
https://kawalpemilu.org#52379,"KETAPANG, MAUK, TANGERANG, BANTEN",18,37,198,235
https://kawalpemilu.org#52379,"KETAPANG, MAUK, TANGERANG, BANTEN",19,94,130,224
https://kawalpemilu.org#52381,"PATRAMANGGALA, KEMIRI, TANGERANG, BANTEN",1,92,83,175
https://kawalpemilu.org#52381,"PATRAMANGGALA, KEMIRI, TANGERANG, BANTEN",2,79,107,186
https://kawalpemilu.org#52381,"PATRAMANGGALA, KEMIRI, TANGERANG, BANTEN",3,60,77,137
https://kawalpemilu.org#52381,"PATRAMANGGALA, KEMIRI, TANGERANG, BANTEN",4,41,61,102
https://kawalpemilu.org#52381,"PATRAMANGGALA, KEMIRI, TANGERANG, BANTEN",5,48,138,186
https://kawalpemilu.org#52381,"PATRAMANGGALA, KEMIRI, TANGERANG, BANTEN",6,47,123,170
https://kawalpemilu.org#52381,"PATRAMANGGALA, KEMIRI, TANGERANG, BANTEN",8,61,70,131
https://kawalpemilu.org#52381,"PATRAMANGGALA, KEMIRI, TANGERANG, BANTEN",9,65,106,171
https://kawalpemilu.org#52381,"PATRAMANGGALA, KEMIRI, TANGERANG, BANTEN",10,43,121,164
https://kawalpemilu.org#52381,"PATRAMANGGALA, KEMIRI, TANGERANG, BANTEN",11,46,95,141
https://kawalpemilu.org#52381,"PATRAMANGGALA, KEMIRI, TANGERANG, BANTEN",12,69,92,161
https://kawalpemilu.org#52381,"PATRAMANGGALA, KEMIRI, TANGERANG, BANTEN",13,54,98,152
https://kawalpemilu.org#52381,"PATRAMANGGALA, KEMIRI, TANGERANG, BANTEN",14,59,100,159
https://kawalpemilu.org#52381,"PATRAMANGGALA, KEMIRI, TANGERANG, BANTEN",16,42,77,119
https://kawalpemilu.org#52382,"KARANG ANYAR, KEMIRI, TANGERANG, BANTEN",1,70,67,137
https://kawalpemilu.org#52382,"KARANG ANYAR, KEMIRI, TANGERANG, BANTEN",2,59,65,124
https://kawalpemilu.org#52382,"KARANG ANYAR, KEMIRI, TANGERANG, BANTEN",4,60,104,164
https://kawalpemilu.org#52382,"KARANG ANYAR, KEMIRI, TANGERANG, BANTEN",5,90,78,168
https://kawalpemilu.org#52382,"KARANG ANYAR, KEMIRI, TANGERANG, BANTEN",7,77,83,160
https://kawalpemilu.org#52382,"KARANG ANYAR, KEMIRI, TANGERANG, BANTEN",8,77,66,143
https://kawalpemilu.org#52382,"KARANG ANYAR, KEMIRI, TANGERANG, BANTEN",9,62,75,137
https://kawalpemilu.org#52382,"KARANG ANYAR, KEMIRI, TANGERANG, BANTEN",10,61,79,140
https://kawalpemilu.org#52382,"KARANG ANYAR, KEMIRI, TANGERANG, BANTEN",11,84,85,169
https://kawalpemilu.org#52382,"KARANG ANYAR, KEMIRI, TANGERANG, BANTEN",12,63,131,194
https://kawalpemilu.org#52382,"KARANG ANYAR, KEMIRI, TANGERANG, BANTEN",13,30,49,79
https://kawalpemilu.org#52383,"LONTAR, KEMIRI, TANGERANG, BANTEN",1,89,115,204
https://kawalpemilu.org#52383,"LONTAR, KEMIRI, TANGERANG, BANTEN",3,65,77,142
https://kawalpemilu.org#52383,"LONTAR, KEMIRI, TANGERANG, BANTEN",4,60,77,137
https://kawalpemilu.org#52383,"LONTAR, KEMIRI, TANGERANG, BANTEN",5,101,90,191
https://kawalpemilu.org#52383,"LONTAR, KEMIRI, TANGERANG, BANTEN",6,63,66,129
https://kawalpemilu.org#52383,"LONTAR, KEMIRI, TANGERANG, BANTEN",7,59,55,114
https://kawalpemilu.org#52383,"LONTAR, KEMIRI, TANGERANG, BANTEN",8,105,79,184
https://kawalpemilu.org#52383,"LONTAR, KEMIRI, TANGERANG, BANTEN",9,113,72,185
https://kawalpemilu.org#52383,"LONTAR, KEMIRI, TANGERANG, BANTEN",10,106,31,137
https://kawalpemilu.org#52383,"LONTAR, KEMIRI, TANGERANG, BANTEN",11,66,37,103
https://kawalpemilu.org#52383,"LONTAR, KEMIRI, TANGERANG, BANTEN",12,123,95,218
https://kawalpemilu.org#52383,"LONTAR, KEMIRI, TANGERANG, BANTEN",13,106,90,190
https://kawalpemilu.org#52383,"LONTAR, KEMIRI, TANGERANG, BANTEN",14,80,99,179
https://kawalpemilu.org#52383,"LONTAR, KEMIRI, TANGERANG, BANTEN",15,114,142,256
https://kawalpemilu.org#52383,"LONTAR, KEMIRI, TANGERANG, BANTEN",16,121,105,226
https://kawalpemilu.org#52383,"LONTAR, KEMIRI, TANGERANG, BANTEN",17,137,126,263
https://kawalpemilu.org#52383,"LONTAR, KEMIRI, TANGERANG, BANTEN",19,92,72,164
https://kawalpemilu.org#52384,"KEMIRI, KEMIRI, TANGERANG, BANTEN",1,86,101,187
https://kawalpemilu.org#52384,"KEMIRI, KEMIRI, TANGERANG, BANTEN",2,77,107,184
https://kawalpemilu.org#52384,"KEMIRI, KEMIRI, TANGERANG, BANTEN",3,58,67,125
https://kawalpemilu.org#52384,"KEMIRI, KEMIRI, TANGERANG, BANTEN",4,69,61,130
https://kawalpemilu.org#52384,"KEMIRI, KEMIRI, TANGERANG, BANTEN",6,65,112,177
https://kawalpemilu.org#52384,"KEMIRI, KEMIRI, TANGERANG, BANTEN",7,83,134,217
https://kawalpemilu.org#52384,"KEMIRI, KEMIRI, TANGERANG, BANTEN",8,74,125,199
https://kawalpemilu.org#52384,"KEMIRI, KEMIRI, TANGERANG, BANTEN",9,83,100,183
https://kawalpemilu.org#52384,"KEMIRI, KEMIRI, TANGERANG, BANTEN",11,49,76,125
https://kawalpemilu.org#52384,"KEMIRI, KEMIRI, TANGERANG, BANTEN",13,72,134,206
https://kawalpemilu.org#52384,"KEMIRI, KEMIRI, TANGERANG, BANTEN",14,57,79,136
https://kawalpemilu.org#52384,"KEMIRI, KEMIRI, TANGERANG, BANTEN",16,58,62,120
https://kawalpemilu.org#52384,"KEMIRI, KEMIRI, TANGERANG, BANTEN",17,74,41,115
https://kawalpemilu.org#52384,"KEMIRI, KEMIRI, TANGERANG, BANTEN",18,49,86,135
https://kawalpemilu.org#52384,"KEMIRI, KEMIRI, TANGERANG, BANTEN",19,44,76,120
https://kawalpemilu.org#52384,"KEMIRI, KEMIRI, TANGERANG, BANTEN",20,28,136,164
https://kawalpemilu.org#52384,"KEMIRI, KEMIRI, TANGERANG, BANTEN",21,77,103,180
https://kawalpemilu.org#52384,"KEMIRI, KEMIRI, TANGERANG, BANTEN",22,109,95,204
https://kawalpemilu.org#52384,"KEMIRI, KEMIRI, TANGERANG, BANTEN",27,56,126,182
https://kawalpemilu.org#52384,"KEMIRI, KEMIRI, TANGERANG, BANTEN",28,94,95,189
https://kawalpemilu.org#52384,"KEMIRI, KEMIRI, TANGERANG, BANTEN",29,18,202,220
https://kawalpemilu.org#52384,"KEMIRI, KEMIRI, TANGERANG, BANTEN",30,42,137,179
https://kawalpemilu.org#52384,"KEMIRI, KEMIRI, TANGERANG, BANTEN",31,59,122,181
https://kawalpemilu.org#52384,"KEMIRI, KEMIRI, TANGERANG, BANTEN",32,55,87,142
https://kawalpemilu.org#52384,"KEMIRI, KEMIRI, TANGERANG, BANTEN",34,23,121,144
https://kawalpemilu.org#52384,"KEMIRI, KEMIRI, TANGERANG, BANTEN",35,37,90,127
https://kawalpemilu.org#52384,"KEMIRI, KEMIRI, TANGERANG, BANTEN",36,50,71,121
https://kawalpemilu.org#52385,"RANCA LABUH, KEMIRI, TANGERANG, BANTEN",1,45,155,200
https://kawalpemilu.org#52385,"RANCA LABUH, KEMIRI, TANGERANG, BANTEN",12,35,118,153
https://kawalpemilu.org#52385,"RANCA LABUH, KEMIRI, TANGERANG, BANTEN",13,86,116,202
https://kawalpemilu.org#52385,"RANCA LABUH, KEMIRI, TANGERANG, BANTEN",14,45,81,126
https://kawalpemilu.org#52385,"RANCA LABUH, KEMIRI, TANGERANG, BANTEN",16,56,133,189
https://kawalpemilu.org#52385,"RANCA LABUH, KEMIRI, TANGERANG, BANTEN",18,86,147,233
https://kawalpemilu.org#52385,"RANCA LABUH, KEMIRI, TANGERANG, BANTEN",19,52,161,213
https://kawalpemilu.org#52385,"RANCA LABUH, KEMIRI, TANGERANG, BANTEN",20,57,168,225
https://kawalpemilu.org#52385,"RANCA LABUH, KEMIRI, TANGERANG, BANTEN",21,54,135,189
https://kawalpemilu.org#52386,"KLEBET, KEMIRI, TANGERANG, BANTEN",3,32,136,168
https://kawalpemilu.org#52386,"KLEBET, KEMIRI, TANGERANG, BANTEN",4,45,150,195
https://kawalpemilu.org#52386,"KLEBET, KEMIRI, TANGERANG, BANTEN",5,58,147,205
https://kawalpemilu.org#52386,"KLEBET, KEMIRI, TANGERANG, BANTEN",6,70,154,224
https://kawalpemilu.org#52386,"KLEBET, KEMIRI, TANGERANG, BANTEN",7,98,120,218
https://kawalpemilu.org#52386,"KLEBET, KEMIRI, TANGERANG, BANTEN",8,82,128,210
https://kawalpemilu.org#52386,"KLEBET, KEMIRI, TANGERANG, BANTEN",10,63,135,198
https://kawalpemilu.org#52386,"KLEBET, KEMIRI, TANGERANG, BANTEN",11,74,118,192
https://kawalpemilu.org#52386,"KLEBET, KEMIRI, TANGERANG, BANTEN",12,80,113,193
https://kawalpemilu.org#52386,"KLEBET, KEMIRI, TANGERANG, BANTEN",13,67,181,248
https://kawalpemilu.org#52386,"KLEBET, KEMIRI, TANGERANG, BANTEN",16,85,72,157
https://kawalpemilu.org#52386,"KLEBET, KEMIRI, TANGERANG, BANTEN",17,61,109,170
https://kawalpemilu.org#52386,"KLEBET, KEMIRI, TANGERANG, BANTEN",18,55,91,146
https://kawalpemilu.org#52386,"KLEBET, KEMIRI, TANGERANG, BANTEN",19,64,104,168
https://kawalpemilu.org#52386,"KLEBET, KEMIRI, TANGERANG, BANTEN",21,101,136,237
https://kawalpemilu.org#52386,"KLEBET, KEMIRI, TANGERANG, BANTEN",22,74,140,214
https://kawalpemilu.org#52386,"KLEBET, KEMIRI, TANGERANG, BANTEN",23,70,129,199
https://kawalpemilu.org#52386,"KLEBET, KEMIRI, TANGERANG, BANTEN",24,50,124,174
https://kawalpemilu.org#52386,"KLEBET, KEMIRI, TANGERANG, BANTEN",25,30,120,150
https://kawalpemilu.org#52386,"KLEBET, KEMIRI, TANGERANG, BANTEN",26,37,135,172
https://kawalpemilu.org#52386,"KLEBET, KEMIRI, TANGERANG, BANTEN",29,65,93,158
https://kawalpemilu.org#52386,"KLEBET, KEMIRI, TANGERANG, BANTEN",30,36,135,171
https://kawalpemilu.org#52387,"LEGOK SUKA MAJU, KEMIRI, TANGERANG, BANTEN",1,38,141,179
https://kawalpemilu.org#52387,"LEGOK SUKA MAJU, KEMIRI, TANGERANG, BANTEN",3,42,81,123
https://kawalpemilu.org#52387,"LEGOK SUKA MAJU, KEMIRI, TANGERANG, BANTEN",4,39,91,130
https://kawalpemilu.org#52387,"LEGOK SUKA MAJU, KEMIRI, TANGERANG, BANTEN",5,21,102,123
https://kawalpemilu.org#52387,"LEGOK SUKA MAJU, KEMIRI, TANGERANG, BANTEN",6,27,96,123
https://kawalpemilu.org#52387,"LEGOK SUKA MAJU, KEMIRI, TANGERANG, BANTEN",7,56,144,200
https://kawalpemilu.org#52387,"LEGOK SUKA MAJU, KEMIRI, TANGERANG, BANTEN",8,43,142,185
https://kawalpemilu.org#52387,"LEGOK SUKA MAJU, KEMIRI, TANGERANG, BANTEN",9,40,131,171
https://kawalpemilu.org#52387,"LEGOK SUKA MAJU, KEMIRI, TANGERANG, BANTEN",10,47,120,167
https://kawalpemilu.org#52387,"LEGOK SUKA MAJU, KEMIRI, TANGERANG, BANTEN",11,52,83,135
https://kawalpemilu.org#52387,"LEGOK SUKA MAJU, KEMIRI, TANGERANG, BANTEN",12,56,67,123
https://kawalpemilu.org#52387,"LEGOK SUKA MAJU, KEMIRI, TANGERANG, BANTEN",13,47,120,167
https://kawalpemilu.org#52387,"LEGOK SUKA MAJU, KEMIRI, TANGERANG, BANTEN",14,39,121,160
https://kawalpemilu.org#52387,"LEGOK SUKA MAJU, KEMIRI, TANGERANG, BANTEN",15,38,107,145
https://kawalpemilu.org#52387,"LEGOK SUKA MAJU, KEMIRI, TANGERANG, BANTEN",16,85,84,169
https://kawalpemilu.org#52389,"SUKADIRI, SUKADIRI, TANGERANG, BANTEN",1,63,74,137
https://kawalpemilu.org#52389,"SUKADIRI, SUKADIRI, TANGERANG, BANTEN",2,55,87,142
https://kawalpemilu.org#52389,"SUKADIRI, SUKADIRI, TANGERANG, BANTEN",3,68,115,183
https://kawalpemilu.org#52389,"SUKADIRI, SUKADIRI, TANGERANG, BANTEN",4,54,137,191
https://kawalpemilu.org#52389,"SUKADIRI, SUKADIRI, TANGERANG, BANTEN",5,82,109,191
https://kawalpemilu.org#52389,"SUKADIRI, SUKADIRI, TANGERANG, BANTEN",6,39,108,147
https://kawalpemilu.org#52389,"SUKADIRI, SUKADIRI, TANGERANG, BANTEN",7,62,108,170
https://kawalpemilu.org#52389,"SUKADIRI, SUKADIRI, TANGERANG, BANTEN",8,53,114,167
https://kawalpemilu.org#52389,"SUKADIRI, SUKADIRI, TANGERANG, BANTEN",9,57,115,172
https://kawalpemilu.org#52389,"SUKADIRI, SUKADIRI, TANGERANG, BANTEN",10,54,117,171
https://kawalpemilu.org#52389,"SUKADIRI, SUKADIRI, TANGERANG, BANTEN",11,39,145,184
https://kawalpemilu.org#52389,"SUKADIRI, SUKADIRI, TANGERANG, BANTEN",12,24,148,172
https://kawalpemilu.org#52389,"SUKADIRI, SUKADIRI, TANGERANG, BANTEN",13,27,117,144
https://kawalpemilu.org#52389,"SUKADIRI, SUKADIRI, TANGERANG, BANTEN",14,39,121,160
https://kawalpemilu.org#52389,"SUKADIRI, SUKADIRI, TANGERANG, BANTEN",16,39,142,181
https://kawalpemilu.org#52389,"SUKADIRI, SUKADIRI, TANGERANG, BANTEN",17,49,138,187
https://kawalpemilu.org#52389,"SUKADIRI, SUKADIRI, TANGERANG, BANTEN",20,39,93,132
https://kawalpemilu.org#52389,"SUKADIRI, SUKADIRI, TANGERANG, BANTEN",21,60,124,184
https://kawalpemilu.org#52390,"BUARAN JATI, SUKADIRI, TANGERANG, BANTEN",1,72,151,223
https://kawalpemilu.org#52390,"BUARAN JATI, SUKADIRI, TANGERANG, BANTEN",2,73,135,208
https://kawalpemilu.org#52390,"BUARAN JATI, SUKADIRI, TANGERANG, BANTEN",3,56,198,254
https://kawalpemilu.org#52390,"BUARAN JATI, SUKADIRI, TANGERANG, BANTEN",4,37,103,140
https://kawalpemilu.org#52390,"BUARAN JATI, SUKADIRI, TANGERANG, BANTEN",5,41,125,166
https://kawalpemilu.org#52390,"BUARAN JATI, SUKADIRI, TANGERANG, BANTEN",6,57,189,245
https://kawalpemilu.org#52390,"BUARAN JATI, SUKADIRI, TANGERANG, BANTEN",7,36,180,216
https://kawalpemilu.org#52390,"BUARAN JATI, SUKADIRI, TANGERANG, BANTEN",8,53,160,213
https://kawalpemilu.org#52390,"BUARAN JATI, SUKADIRI, TANGERANG, BANTEN",9,26,212,238
https://kawalpemilu.org#52390,"BUARAN JATI, SUKADIRI, TANGERANG, BANTEN",10,36,241,277
https://kawalpemilu.org#52390,"BUARAN JATI, SUKADIRI, TANGERANG, BANTEN",11,41,161,202
https://kawalpemilu.org#52390,"BUARAN JATI, SUKADIRI, TANGERANG, BANTEN",12,80,173,253
https://kawalpemilu.org#52390,"BUARAN JATI, SUKADIRI, TANGERANG, BANTEN",13,63,166,229
https://kawalpemilu.org#52390,"BUARAN JATI, SUKADIRI, TANGERANG, BANTEN",14,42,211,253
https://kawalpemilu.org#52390,"BUARAN JATI, SUKADIRI, TANGERANG, BANTEN",15,38,160,198
https://kawalpemilu.org#52390,"BUARAN JATI, SUKADIRI, TANGERANG, BANTEN",16,34,138,172
https://kawalpemilu.org#52390,"BUARAN JATI, SUKADIRI, TANGERANG, BANTEN",18,57,166,223
https://kawalpemilu.org#52390,"BUARAN JATI, SUKADIRI, TANGERANG, BANTEN",19,40,201,241
https://kawalpemilu.org#52390,"BUARAN JATI, SUKADIRI, TANGERANG, BANTEN",20,39,225,264
https://kawalpemilu.org#52390,"BUARAN JATI, SUKADIRI, TANGERANG, BANTEN",21,40,190,230
https://kawalpemilu.org#52390,"BUARAN JATI, SUKADIRI, TANGERANG, BANTEN",22,47,187,234
https://kawalpemilu.org#52391,"RAWA KIDANG, SUKADIRI, TANGERANG, BANTEN",1,28,173,201
https://kawalpemilu.org#52391,"RAWA KIDANG, SUKADIRI, TANGERANG, BANTEN",2,22,139,161
https://kawalpemilu.org#52391,"RAWA KIDANG, SUKADIRI, TANGERANG, BANTEN",3,39,111,150
https://kawalpemilu.org#52391,"RAWA KIDANG, SUKADIRI, TANGERANG, BANTEN",4,21,146,167
https://kawalpemilu.org#52391,"RAWA KIDANG, SUKADIRI, TANGERANG, BANTEN",5,26,207,233
https://kawalpemilu.org#52391,"RAWA KIDANG, SUKADIRI, TANGERANG, BANTEN",6,27,229,256
https://kawalpemilu.org#52391,"RAWA KIDANG, SUKADIRI, TANGERANG, BANTEN",7,35,152,187
https://kawalpemilu.org#52391,"RAWA KIDANG, SUKADIRI, TANGERANG, BANTEN",8,19,165,184
https://kawalpemilu.org#52391,"RAWA KIDANG, SUKADIRI, TANGERANG, BANTEN",9,21,116,137
https://kawalpemilu.org#52391,"RAWA KIDANG, SUKADIRI, TANGERANG, BANTEN",10,12,176,188
https://kawalpemilu.org#52391,"RAWA KIDANG, SUKADIRI, TANGERANG, BANTEN",11,31,119,150
https://kawalpemilu.org#52391,"RAWA KIDANG, SUKADIRI, TANGERANG, BANTEN",12,22,127,149
https://kawalpemilu.org#52391,"RAWA KIDANG, SUKADIRI, TANGERANG, BANTEN",13,17,136,153
https://kawalpemilu.org#52391,"RAWA KIDANG, SUKADIRI, TANGERANG, BANTEN",14,20,118,138
https://kawalpemilu.org#52391,"RAWA KIDANG, SUKADIRI, TANGERANG, BANTEN",15,48,160,208
https://kawalpemilu.org#52391,"RAWA KIDANG, SUKADIRI, TANGERANG, BANTEN",16,41,109,150
https://kawalpemilu.org#52391,"RAWA KIDANG, SUKADIRI, TANGERANG, BANTEN",17,35,115,150
https://kawalpemilu.org#52391,"RAWA KIDANG, SUKADIRI, TANGERANG, BANTEN",18,28,142,170
https://kawalpemilu.org#52391,"RAWA KIDANG, SUKADIRI, TANGERANG, BANTEN",19,29,130,159
https://kawalpemilu.org#52391,"RAWA KIDANG, SUKADIRI, TANGERANG, BANTEN",20,33,126,159
https://kawalpemilu.org#52391,"RAWA KIDANG, SUKADIRI, TANGERANG, BANTEN",21,40,133,173
https://kawalpemilu.org#52391,"RAWA KIDANG, SUKADIRI, TANGERANG, BANTEN",22,23,123,146
https://kawalpemilu.org#52392,"PEKAYON, SUKADIRI, TANGERANG, BANTEN",1,72,121,193
https://kawalpemilu.org#52392,"PEKAYON, SUKADIRI, TANGERANG, BANTEN",2,74,117,191
https://kawalpemilu.org#52392,"PEKAYON, SUKADIRI, TANGERANG, BANTEN",3,40,163,203
https://kawalpemilu.org#52392,"PEKAYON, SUKADIRI, TANGERANG, BANTEN",4,89,130,219
https://kawalpemilu.org#52392,"PEKAYON, SUKADIRI, TANGERANG, BANTEN",5,57,112,169
https://kawalpemilu.org#52392,"PEKAYON, SUKADIRI, TANGERANG, BANTEN",6,55,108,163
https://kawalpemilu.org#52392,"PEKAYON, SUKADIRI, TANGERANG, BANTEN",7,21,120,141
https://kawalpemilu.org#52392,"PEKAYON, SUKADIRI, TANGERANG, BANTEN",8,37,144,181
https://kawalpemilu.org#52392,"PEKAYON, SUKADIRI, TANGERANG, BANTEN",9,31,163,194
https://kawalpemilu.org#52392,"PEKAYON, SUKADIRI, TANGERANG, BANTEN",10,60,144,204
https://kawalpemilu.org#52392,"PEKAYON, SUKADIRI, TANGERANG, BANTEN",11,24,135,159
https://kawalpemilu.org#52392,"PEKAYON, SUKADIRI, TANGERANG, BANTEN",12,27,128,155
https://kawalpemilu.org#52392,"PEKAYON, SUKADIRI, TANGERANG, BANTEN",13,40,105,145
https://kawalpemilu.org#52392,"PEKAYON, SUKADIRI, TANGERANG, BANTEN",14,38,100,138
https://kawalpemilu.org#52392,"PEKAYON, SUKADIRI, TANGERANG, BANTEN",15,43,161,204
https://kawalpemilu.org#52392,"PEKAYON, SUKADIRI, TANGERANG, BANTEN",16,63,92,155
https://kawalpemilu.org#52392,"PEKAYON, SUKADIRI, TANGERANG, BANTEN",17,44,120,5
https://kawalpemilu.org#52392,"PEKAYON, SUKADIRI, TANGERANG, BANTEN",18,53,110,163
https://kawalpemilu.org#52392,"PEKAYON, SUKADIRI, TANGERANG, BANTEN",19,40,130,170
https://kawalpemilu.org#52392,"PEKAYON, SUKADIRI, TANGERANG, BANTEN",20,66,86,152
https://kawalpemilu.org#52392,"PEKAYON, SUKADIRI, TANGERANG, BANTEN",21,26,113,139
https://kawalpemilu.org#52392,"PEKAYON, SUKADIRI, TANGERANG, BANTEN",22,22,126,148
https://kawalpemilu.org#52392,"PEKAYON, SUKADIRI, TANGERANG, BANTEN",23,27,167,194
https://kawalpemilu.org#52392,"PEKAYON, SUKADIRI, TANGERANG, BANTEN",24,44,140,184
https://kawalpemilu.org#52392,"PEKAYON, SUKADIRI, TANGERANG, BANTEN",25,27,133,160
https://kawalpemilu.org#52392,"PEKAYON, SUKADIRI, TANGERANG, BANTEN",26,39,123,162
https://kawalpemilu.org#52392,"PEKAYON, SUKADIRI, TANGERANG, BANTEN",27,57,163,220
https://kawalpemilu.org#52392,"PEKAYON, SUKADIRI, TANGERANG, BANTEN",28,75,145,220
https://kawalpemilu.org#52392,"PEKAYON, SUKADIRI, TANGERANG, BANTEN",29,52,78,130
https://kawalpemilu.org#52392,"PEKAYON, SUKADIRI, TANGERANG, BANTEN",30,38,88,126
https://kawalpemilu.org#52392,"PEKAYON, SUKADIRI, TANGERANG, BANTEN",31,46,98,144
https://kawalpemilu.org#52392,"PEKAYON, SUKADIRI, TANGERANG, BANTEN",32,63,106,169
https://kawalpemilu.org#52392,"PEKAYON, SUKADIRI, TANGERANG, BANTEN",33,48,114,162
https://kawalpemilu.org#52392,"PEKAYON, SUKADIRI, TANGERANG, BANTEN",34,42,120,162
https://kawalpemilu.org#52392,"PEKAYON, SUKADIRI, TANGERANG, BANTEN",35,59,170,229
https://kawalpemilu.org#52392,"PEKAYON, SUKADIRI, TANGERANG, BANTEN",36,45,139,184
https://kawalpemilu.org#52392,"PEKAYON, SUKADIRI, TANGERANG, BANTEN",37,47,116,163
https://kawalpemilu.org#52392,"PEKAYON, SUKADIRI, TANGERANG, BANTEN",38,35,98,133
https://kawalpemilu.org#52392,"PEKAYON, SUKADIRI, TANGERANG, BANTEN",39,96,94,190
https://kawalpemilu.org#52392,"PEKAYON, SUKADIRI, TANGERANG, BANTEN",40,25,76,101
https://kawalpemilu.org#52393,"KARANG SERANG, SUKADIRI, TANGERANG, BANTEN",1,38,101,139
https://kawalpemilu.org#52393,"KARANG SERANG, SUKADIRI, TANGERANG, BANTEN",2,37,94,131
https://kawalpemilu.org#52393,"KARANG SERANG, SUKADIRI, TANGERANG, BANTEN",3,52,90,142
https://kawalpemilu.org#52393,"KARANG SERANG, SUKADIRI, TANGERANG, BANTEN",4,77,51,128
https://kawalpemilu.org#52393,"KARANG SERANG, SUKADIRI, TANGERANG, BANTEN",5,89,64,153
https://kawalpemilu.org#52393,"KARANG SERANG, SUKADIRI, TANGERANG, BANTEN",6,73,91,164
https://kawalpemilu.org#52393,"KARANG SERANG, SUKADIRI, TANGERANG, BANTEN",8,53,65,118
https://kawalpemilu.org#52393,"KARANG SERANG, SUKADIRI, TANGERANG, BANTEN",9,104,78,182
https://kawalpemilu.org#52393,"KARANG SERANG, SUKADIRI, TANGERANG, BANTEN",10,95,93,188
https://kawalpemilu.org#52393,"KARANG SERANG, SUKADIRI, TANGERANG, BANTEN",11,115,72,187
https://kawalpemilu.org#52393,"KARANG SERANG, SUKADIRI, TANGERANG, BANTEN",12,34,131,165
https://kawalpemilu.org#52393,"KARANG SERANG, SUKADIRI, TANGERANG, BANTEN",13,81,92,173
https://kawalpemilu.org#52393,"KARANG SERANG, SUKADIRI, TANGERANG, BANTEN",14,78,112,190
https://kawalpemilu.org#52393,"KARANG SERANG, SUKADIRI, TANGERANG, BANTEN",15,80,100,180
https://kawalpemilu.org#52393,"KARANG SERANG, SUKADIRI, TANGERANG, BANTEN",16,72,75,147
https://kawalpemilu.org#52393,"KARANG SERANG, SUKADIRI, TANGERANG, BANTEN",17,82,66,148
https://kawalpemilu.org#52393,"KARANG SERANG, SUKADIRI, TANGERANG, BANTEN",18,83,77,160
https://kawalpemilu.org#52393,"KARANG SERANG, SUKADIRI, TANGERANG, BANTEN",19,104,79,183
https://kawalpemilu.org#52393,"KARANG SERANG, SUKADIRI, TANGERANG, BANTEN",20,101,83,184
https://kawalpemilu.org#52393,"KARANG SERANG, SUKADIRI, TANGERANG, BANTEN",21,94,68,162
https://kawalpemilu.org#52393,"KARANG SERANG, SUKADIRI, TANGERANG, BANTEN",22,110,66,176
https://kawalpemilu.org#52393,"KARANG SERANG, SUKADIRI, TANGERANG, BANTEN",23,102,71,173
https://kawalpemilu.org#52393,"KARANG SERANG, SUKADIRI, TANGERANG, BANTEN",24,115,72,187
https://kawalpemilu.org#52393,"KARANG SERANG, SUKADIRI, TANGERANG, BANTEN",25,97,39,136
https://kawalpemilu.org#52393,"KARANG SERANG, SUKADIRI, TANGERANG, BANTEN",26,77,45,122
https://kawalpemilu.org#52394,"KOSAMBI, SUKADIRI, TANGERANG, BANTEN",1,44,155,199
https://kawalpemilu.org#52394,"KOSAMBI, SUKADIRI, TANGERANG, BANTEN",2,33,191,224
https://kawalpemilu.org#52394,"KOSAMBI, SUKADIRI, TANGERANG, BANTEN",3,16,158,174
https://kawalpemilu.org#52394,"KOSAMBI, SUKADIRI, TANGERANG, BANTEN",4,16,139,155
https://kawalpemilu.org#52394,"KOSAMBI, SUKADIRI, TANGERANG, BANTEN",5,22,114,136
https://kawalpemilu.org#52394,"KOSAMBI, SUKADIRI, TANGERANG, BANTEN",6,21,109,130
https://kawalpemilu.org#52394,"KOSAMBI, SUKADIRI, TANGERANG, BANTEN",7,23,147,170
https://kawalpemilu.org#52394,"KOSAMBI, SUKADIRI, TANGERANG, BANTEN",8,29,153,182
https://kawalpemilu.org#52394,"KOSAMBI, SUKADIRI, TANGERANG, BANTEN",9,22,169,191
https://kawalpemilu.org#52394,"KOSAMBI, SUKADIRI, TANGERANG, BANTEN",10,46,122,168
https://kawalpemilu.org#52394,"KOSAMBI, SUKADIRI, TANGERANG, BANTEN",11,46,176,222
https://kawalpemilu.org#52394,"KOSAMBI, SUKADIRI, TANGERANG, BANTEN",12,36,138,174
https://kawalpemilu.org#52394,"KOSAMBI, SUKADIRI, TANGERANG, BANTEN",13,41,128,169
https://kawalpemilu.org#52394,"KOSAMBI, SUKADIRI, TANGERANG, BANTEN",14,32,142,174
https://kawalpemilu.org#52394,"KOSAMBI, SUKADIRI, TANGERANG, BANTEN",15,24,115,139
https://kawalpemilu.org#52394,"KOSAMBI, SUKADIRI, TANGERANG, BANTEN",16,24,120,144
https://kawalpemilu.org#52394,"KOSAMBI, SUKADIRI, TANGERANG, BANTEN",17,23,178,7
https://kawalpemilu.org#52394,"KOSAMBI, SUKADIRI, TANGERANG, BANTEN",18,34,153,187
https://kawalpemilu.org#52394,"KOSAMBI, SUKADIRI, TANGERANG, BANTEN",19,22,134,156
https://kawalpemilu.org#52394,"KOSAMBI, SUKADIRI, TANGERANG, BANTEN",20,32,135,167
https://kawalpemilu.org#52394,"KOSAMBI, SUKADIRI, TANGERANG, BANTEN",21,24,135,159
https://kawalpemilu.org#52394,"KOSAMBI, SUKADIRI, TANGERANG, BANTEN",22,27,177,204
https://kawalpemilu.org#52394,"KOSAMBI, SUKADIRI, TANGERANG, BANTEN",23,32,168,200
https://kawalpemilu.org#52394,"KOSAMBI, SUKADIRI, TANGERANG, BANTEN",24,39,157,196
https://kawalpemilu.org#52394,"KOSAMBI, SUKADIRI, TANGERANG, BANTEN",25,31,157,188
https://kawalpemilu.org#52394,"KOSAMBI, SUKADIRI, TANGERANG, BANTEN",26,40,126,166
https://kawalpemilu.org#52394,"KOSAMBI, SUKADIRI, TANGERANG, BANTEN",27,38,167,205
https://kawalpemilu.org#52394,"KOSAMBI, SUKADIRI, TANGERANG, BANTEN",28,33,176,209
https://kawalpemilu.org#52394,"KOSAMBI, SUKADIRI, TANGERANG, BANTEN",29,48,164,212
https://kawalpemilu.org#52394,"KOSAMBI, SUKADIRI, TANGERANG, BANTEN",30,71,67,138
https://kawalpemilu.org#52394,"KOSAMBI, SUKADIRI, TANGERANG, BANTEN",31,13,80,93
https://kawalpemilu.org#52395,"MEKAR KONDANG, SUKADIRI, TANGERANG, BANTEN",2,43,104,147
https://kawalpemilu.org#52395,"MEKAR KONDANG, SUKADIRI, TANGERANG, BANTEN",4,60,142,202
https://kawalpemilu.org#52395,"MEKAR KONDANG, SUKADIRI, TANGERANG, BANTEN",5,57,171,228
https://kawalpemilu.org#52395,"MEKAR KONDANG, SUKADIRI, TANGERANG, BANTEN",6,33,119,152
https://kawalpemilu.org#52395,"MEKAR KONDANG, SUKADIRI, TANGERANG, BANTEN",7,34,118,152
https://kawalpemilu.org#52395,"MEKAR KONDANG, SUKADIRI, TANGERANG, BANTEN",8,28,127,155
https://kawalpemilu.org#52395,"MEKAR KONDANG, SUKADIRI, TANGERANG, BANTEN",9,33,110,143
https://kawalpemilu.org#52395,"MEKAR KONDANG, SUKADIRI, TANGERANG, BANTEN",10,74,136,210
https://kawalpemilu.org#52395,"MEKAR KONDANG, SUKADIRI, TANGERANG, BANTEN",11,47,96,143
https://kawalpemilu.org#52395,"MEKAR KONDANG, SUKADIRI, TANGERANG, BANTEN",12,38,97,135
https://kawalpemilu.org#52395,"MEKAR KONDANG, SUKADIRI, TANGERANG, BANTEN",13,23,140,163
https://kawalpemilu.org#52395,"MEKAR KONDANG, SUKADIRI, TANGERANG, BANTEN",15,70,153,223
https://kawalpemilu.org#52395,"MEKAR KONDANG, SUKADIRI, TANGERANG, BANTEN",16,43,141,184
https://kawalpemilu.org#52395,"MEKAR KONDANG, SUKADIRI, TANGERANG, BANTEN",17,30,143,173
https://kawalpemilu.org#52395,"MEKAR KONDANG, SUKADIRI, TANGERANG, BANTEN",18,34,163,197
https://kawalpemilu.org#52395,"MEKAR KONDANG, SUKADIRI, TANGERANG, BANTEN",19,38,156,194
https://kawalpemilu.org#52395,"MEKAR KONDANG, SUKADIRI, TANGERANG, BANTEN",20,21,126,147
https://kawalpemilu.org#52396,"GINTUNG, SUKADIRI, TANGERANG, BANTEN",1,37,172,209
https://kawalpemilu.org#52396,"GINTUNG, SUKADIRI, TANGERANG, BANTEN",2,36,141,177
https://kawalpemilu.org#52396,"GINTUNG, SUKADIRI, TANGERANG, BANTEN",3,32,95,127
https://kawalpemilu.org#52396,"GINTUNG, SUKADIRI, TANGERANG, BANTEN",4,43,97,140
https://kawalpemilu.org#52396,"GINTUNG, SUKADIRI, TANGERANG, BANTEN",5,34,101,135
https://kawalpemilu.org#52396,"GINTUNG, SUKADIRI, TANGERANG, BANTEN",6,16,122,138
https://kawalpemilu.org#52396,"GINTUNG, SUKADIRI, TANGERANG, BANTEN",7,27,107,134
https://kawalpemilu.org#52396,"GINTUNG, SUKADIRI, TANGERANG, BANTEN",8,23,111,134
https://kawalpemilu.org#52396,"GINTUNG, SUKADIRI, TANGERANG, BANTEN",9,21,122,143
https://kawalpemilu.org#52396,"GINTUNG, SUKADIRI, TANGERANG, BANTEN",10,22,193,215
https://kawalpemilu.org#52396,"GINTUNG, SUKADIRI, TANGERANG, BANTEN",11,27,174,201
https://kawalpemilu.org#52396,"GINTUNG, SUKADIRI, TANGERANG, BANTEN",12,27,180,207
https://kawalpemilu.org#52396,"GINTUNG, SUKADIRI, TANGERANG, BANTEN",13,27,149,176
https://kawalpemilu.org#52396,"GINTUNG, SUKADIRI, TANGERANG, BANTEN",14,30,96,126
https://kawalpemilu.org#52396,"GINTUNG, SUKADIRI, TANGERANG, BANTEN",15,25,124,149
https://kawalpemilu.org#52396,"GINTUNG, SUKADIRI, TANGERANG, BANTEN",16,28,177,205
https://kawalpemilu.org#52396,"GINTUNG, SUKADIRI, TANGERANG, BANTEN",17,39,129,168
https://kawalpemilu.org#52396,"GINTUNG, SUKADIRI, TANGERANG, BANTEN",18,36,140,176
https://kawalpemilu.org#52396,"GINTUNG, SUKADIRI, TANGERANG, BANTEN",20,37,155,192
https://kawalpemilu.org#52396,"GINTUNG, SUKADIRI, TANGERANG, BANTEN",21,37,192,229
https://kawalpemilu.org#52396,"GINTUNG, SUKADIRI, TANGERANG, BANTEN",22,28,178,206
https://kawalpemilu.org#52396,"GINTUNG, SUKADIRI, TANGERANG, BANTEN",23,58,152,210
https://kawalpemilu.org#52396,"GINTUNG, SUKADIRI, TANGERANG, BANTEN",24,41,175,216
https://kawalpemilu.org#52396,"GINTUNG, SUKADIRI, TANGERANG, BANTEN",25,42,173,215
https://kawalpemilu.org#52396,"GINTUNG, SUKADIRI, TANGERANG, BANTEN",26,51,173,224
https://kawalpemilu.org#52396,"GINTUNG, SUKADIRI, TANGERANG, BANTEN",27,47,129,176
https://kawalpemilu.org#52396,"GINTUNG, SUKADIRI, TANGERANG, BANTEN",28,69,138,207
https://kawalpemilu.org#52396,"GINTUNG, SUKADIRI, TANGERANG, BANTEN",29,80,128,208
https://kawalpemilu.org#52396,"GINTUNG, SUKADIRI, TANGERANG, BANTEN",30,68,123,191
https://kawalpemilu.org#52396,"GINTUNG, SUKADIRI, TANGERANG, BANTEN",31,27,87,114
https://kawalpemilu.org#52396,"GINTUNG, SUKADIRI, TANGERANG, BANTEN",32,22,87,109
https://kawalpemilu.org#52396,"GINTUNG, SUKADIRI, TANGERANG, BANTEN",33,14,97,111
https://kawalpemilu.org#52398,"SUKATANI, RAJEG, TANGERANG, BANTEN",1,89,111,200
https://kawalpemilu.org#52398,"SUKATANI, RAJEG, TANGERANG, BANTEN",2,76,139,215
https://kawalpemilu.org#52398,"SUKATANI, RAJEG, TANGERANG, BANTEN",3,103,113,216
https://kawalpemilu.org#52398,"SUKATANI, RAJEG, TANGERANG, BANTEN",4,128,112,240
https://kawalpemilu.org#52398,"SUKATANI, RAJEG, TANGERANG, BANTEN",5,137,117,254
https://kawalpemilu.org#52398,"SUKATANI, RAJEG, TANGERANG, BANTEN",6,81,170,251
https://kawalpemilu.org#52398,"SUKATANI, RAJEG, TANGERANG, BANTEN",7,105,142,247
https://kawalpemilu.org#52398,"SUKATANI, RAJEG, TANGERANG, BANTEN",8,117,140,257
https://kawalpemilu.org#52398,"SUKATANI, RAJEG, TANGERANG, BANTEN",9,132,148,280
https://kawalpemilu.org#52398,"SUKATANI, RAJEG, TANGERANG, BANTEN",10,73,142,215
https://kawalpemilu.org#52398,"SUKATANI, RAJEG, TANGERANG, BANTEN",11,83,145,228
https://kawalpemilu.org#52398,"SUKATANI, RAJEG, TANGERANG, BANTEN",12,76,124,200
https://kawalpemilu.org#52398,"SUKATANI, RAJEG, TANGERANG, BANTEN",13,66,127,193
https://kawalpemilu.org#52398,"SUKATANI, RAJEG, TANGERANG, BANTEN",14,115,111,226
https://kawalpemilu.org#52398,"SUKATANI, RAJEG, TANGERANG, BANTEN",15,74,198,272
https://kawalpemilu.org#52398,"SUKATANI, RAJEG, TANGERANG, BANTEN",16,93,121,214
https://kawalpemilu.org#52398,"SUKATANI, RAJEG, TANGERANG, BANTEN",17,76,130,206
https://kawalpemilu.org#52398,"SUKATANI, RAJEG, TANGERANG, BANTEN",18,90,138,228
https://kawalpemilu.org#52398,"SUKATANI, RAJEG, TANGERANG, BANTEN",19,46,139,185
https://kawalpemilu.org#52398,"SUKATANI, RAJEG, TANGERANG, BANTEN",20,36,161,197
https://kawalpemilu.org#52398,"SUKATANI, RAJEG, TANGERANG, BANTEN",21,82,92,180
https://kawalpemilu.org#52398,"SUKATANI, RAJEG, TANGERANG, BANTEN",22,84,108,192
https://kawalpemilu.org#52398,"SUKATANI, RAJEG, TANGERANG, BANTEN",23,72,128,200
https://kawalpemilu.org#52398,"SUKATANI, RAJEG, TANGERANG, BANTEN",24,70,105,175
https://kawalpemilu.org#52398,"SUKATANI, RAJEG, TANGERANG, BANTEN",25,72,95,167
https://kawalpemilu.org#52398,"SUKATANI, RAJEG, TANGERANG, BANTEN",26,72,148,220
https://kawalpemilu.org#52398,"SUKATANI, RAJEG, TANGERANG, BANTEN",27,54,124,178
https://kawalpemilu.org#52398,"SUKATANI, RAJEG, TANGERANG, BANTEN",28,77,111,188
https://kawalpemilu.org#52398,"SUKATANI, RAJEG, TANGERANG, BANTEN",29,68,107,175
https://kawalpemilu.org#52398,"SUKATANI, RAJEG, TANGERANG, BANTEN",30,65,134,199
https://kawalpemilu.org#52398,"SUKATANI, RAJEG, TANGERANG, BANTEN",31,66,126,192
https://kawalpemilu.org#52398,"SUKATANI, RAJEG, TANGERANG, BANTEN",32,49,146,195
https://kawalpemilu.org#52398,"SUKATANI, RAJEG, TANGERANG, BANTEN",33,81,107,188
https://kawalpemilu.org#52398,"SUKATANI, RAJEG, TANGERANG, BANTEN",34,65,137,202
https://kawalpemilu.org#52398,"SUKATANI, RAJEG, TANGERANG, BANTEN",35,42,153,195
https://kawalpemilu.org#52398,"SUKATANI, RAJEG, TANGERANG, BANTEN",36,63,115,178
https://kawalpemilu.org#52398,"SUKATANI, RAJEG, TANGERANG, BANTEN",37,51,141,192
https://kawalpemilu.org#52398,"SUKATANI, RAJEG, TANGERANG, BANTEN",38,76,123,199
https://kawalpemilu.org#52398,"SUKATANI, RAJEG, TANGERANG, BANTEN",39,102,106,208
https://kawalpemilu.org#52398,"SUKATANI, RAJEG, TANGERANG, BANTEN",40,90,120,210
https://kawalpemilu.org#52398,"SUKATANI, RAJEG, TANGERANG, BANTEN",41,72,135,207
https://kawalpemilu.org#52398,"SUKATANI, RAJEG, TANGERANG, BANTEN",42,101,118,219
https://kawalpemilu.org#52398,"SUKATANI, RAJEG, TANGERANG, BANTEN",43,78,118,196
https://kawalpemilu.org#52398,"SUKATANI, RAJEG, TANGERANG, BANTEN",44,90,106,196
https://kawalpemilu.org#52398,"SUKATANI, RAJEG, TANGERANG, BANTEN",45,54,142,196
https://kawalpemilu.org#52398,"SUKATANI, RAJEG, TANGERANG, BANTEN",46,94,147,241
https://kawalpemilu.org#52398,"SUKATANI, RAJEG, TANGERANG, BANTEN",47,65,211,276
https://kawalpemilu.org#52398,"SUKATANI, RAJEG, TANGERANG, BANTEN",48,97,172,269
https://kawalpemilu.org#52398,"SUKATANI, RAJEG, TANGERANG, BANTEN",49,47,132,179
https://kawalpemilu.org#52398,"SUKATANI, RAJEG, TANGERANG, BANTEN",50,63,123,186
https://kawalpemilu.org#52398,"SUKATANI, RAJEG, TANGERANG, BANTEN",52,80,154,234
https://kawalpemilu.org#52398,"SUKATANI, RAJEG, TANGERANG, BANTEN",53,70,131,201
https://kawalpemilu.org#52398,"SUKATANI, RAJEG, TANGERANG, BANTEN",54,99,124,223
https://kawalpemilu.org#52398,"SUKATANI, RAJEG, TANGERANG, BANTEN",55,34,139,173
https://kawalpemilu.org#52398,"SUKATANI, RAJEG, TANGERANG, BANTEN",56,50,138,188
https://kawalpemilu.org#52398,"SUKATANI, RAJEG, TANGERANG, BANTEN",57,103,111,214
https://kawalpemilu.org#52398,"SUKATANI, RAJEG, TANGERANG, BANTEN",58,100,180,280
https://kawalpemilu.org#52398,"SUKATANI, RAJEG, TANGERANG, BANTEN",59,93,165,258
https://kawalpemilu.org#52398,"SUKATANI, RAJEG, TANGERANG, BANTEN",60,38,178,216
https://kawalpemilu.org#52398,"SUKATANI, RAJEG, TANGERANG, BANTEN",61,27,138,165
https://kawalpemilu.org#52398,"SUKATANI, RAJEG, TANGERANG, BANTEN",62,76,114,190
https://kawalpemilu.org#52399,"RAJEG, RAJEG, TANGERANG, BANTEN",1,54,96,150
https://kawalpemilu.org#52399,"RAJEG, RAJEG, TANGERANG, BANTEN",2,51,97,148
https://kawalpemilu.org#52399,"RAJEG, RAJEG, TANGERANG, BANTEN",3,49,114,163
https://kawalpemilu.org#52399,"RAJEG, RAJEG, TANGERANG, BANTEN",4,67,100,167
https://kawalpemilu.org#52399,"RAJEG, RAJEG, TANGERANG, BANTEN",5,35,128,163
https://kawalpemilu.org#52399,"RAJEG, RAJEG, TANGERANG, BANTEN",6,45,109,154
https://kawalpemilu.org#52399,"RAJEG, RAJEG, TANGERANG, BANTEN",7,103,90,193
https://kawalpemilu.org#52399,"RAJEG, RAJEG, TANGERANG, BANTEN",8,110,75,185
https://kawalpemilu.org#52399,"RAJEG, RAJEG, TANGERANG, BANTEN",9,60,103,163
https://kawalpemilu.org#52399,"RAJEG, RAJEG, TANGERANG, BANTEN",10,68,121,189
https://kawalpemilu.org#52399,"RAJEG, RAJEG, TANGERANG, BANTEN",12,50,93,143
https://kawalpemilu.org#52399,"RAJEG, RAJEG, TANGERANG, BANTEN",13,45,165,210
https://kawalpemilu.org#52399,"RAJEG, RAJEG, TANGERANG, BANTEN",15,88,152,240
https://kawalpemilu.org#52399,"RAJEG, RAJEG, TANGERANG, BANTEN",16,101,128,229
https://kawalpemilu.org#52399,"RAJEG, RAJEG, TANGERANG, BANTEN",17,47,173,220
https://kawalpemilu.org#52399,"RAJEG, RAJEG, TANGERANG, BANTEN",18,47,161,208
https://kawalpemilu.org#52399,"RAJEG, RAJEG, TANGERANG, BANTEN",19,35,91,126
https://kawalpemilu.org#52399,"RAJEG, RAJEG, TANGERANG, BANTEN",20,45,99,144
https://kawalpemilu.org#52399,"RAJEG, RAJEG, TANGERANG, BANTEN",21,60,82,142
https://kawalpemilu.org#52399,"RAJEG, RAJEG, TANGERANG, BANTEN",22,62,72,134
https://kawalpemilu.org#52399,"RAJEG, RAJEG, TANGERANG, BANTEN",24,88,92,180
https://kawalpemilu.org#52399,"RAJEG, RAJEG, TANGERANG, BANTEN",25,86,122,208
https://kawalpemilu.org#52399,"RAJEG, RAJEG, TANGERANG, BANTEN",26,62,126,188
https://kawalpemilu.org#52399,"RAJEG, RAJEG, TANGERANG, BANTEN",27,103,136,239
https://kawalpemilu.org#52399,"RAJEG, RAJEG, TANGERANG, BANTEN",28,85,148,233
https://kawalpemilu.org#52399,"RAJEG, RAJEG, TANGERANG, BANTEN",29,76,147,223
https://kawalpemilu.org#52399,"RAJEG, RAJEG, TANGERANG, BANTEN",30,86,127,213
https://kawalpemilu.org#52399,"RAJEG, RAJEG, TANGERANG, BANTEN",31,78,111,189
https://kawalpemilu.org#52399,"RAJEG, RAJEG, TANGERANG, BANTEN",33,65,116,181
https://kawalpemilu.org#52399,"RAJEG, RAJEG, TANGERANG, BANTEN",34,67,85,152
https://kawalpemilu.org#52399,"RAJEG, RAJEG, TANGERANG, BANTEN",35,72,78,150
https://kawalpemilu.org#52399,"RAJEG, RAJEG, TANGERANG, BANTEN",36,87,99,186
https://kawalpemilu.org#52399,"RAJEG, RAJEG, TANGERANG, BANTEN",37,93,151,244
https://kawalpemilu.org#52399,"RAJEG, RAJEG, TANGERANG, BANTEN",38,109,143,252
https://kawalpemilu.org#52399,"RAJEG, RAJEG, TANGERANG, BANTEN",39,59,95,154
https://kawalpemilu.org#52399,"RAJEG, RAJEG, TANGERANG, BANTEN",40,71,119,190
https://kawalpemilu.org#52399,"RAJEG, RAJEG, TANGERANG, BANTEN",41,70,93,163
https://kawalpemilu.org#52400,"RAJEG MULYA, RAJEG, TANGERANG, BANTEN",1,80,110,190
https://kawalpemilu.org#52400,"RAJEG MULYA, RAJEG, TANGERANG, BANTEN",2,80,111,191
https://kawalpemilu.org#52400,"RAJEG MULYA, RAJEG, TANGERANG, BANTEN",3,43,171,214
https://kawalpemilu.org#52400,"RAJEG MULYA, RAJEG, TANGERANG, BANTEN",4,62,184,7
https://kawalpemilu.org#52400,"RAJEG MULYA, RAJEG, TANGERANG, BANTEN",5,94,80,174
https://kawalpemilu.org#52400,"RAJEG MULYA, RAJEG, TANGERANG, BANTEN",6,79,112,191
https://kawalpemilu.org#52400,"RAJEG MULYA, RAJEG, TANGERANG, BANTEN",8,85,95,180
https://kawalpemilu.org#52400,"RAJEG MULYA, RAJEG, TANGERANG, BANTEN",9,69,83,152
https://kawalpemilu.org#52400,"RAJEG MULYA, RAJEG, TANGERANG, BANTEN",10,83,91,174
https://kawalpemilu.org#52400,"RAJEG MULYA, RAJEG, TANGERANG, BANTEN",12,58,166,224
https://kawalpemilu.org#52400,"RAJEG MULYA, RAJEG, TANGERANG, BANTEN",14,39,146,185
https://kawalpemilu.org#52400,"RAJEG MULYA, RAJEG, TANGERANG, BANTEN",21,124,153,277
https://kawalpemilu.org#52400,"RAJEG MULYA, RAJEG, TANGERANG, BANTEN",22,61,72,133
https://kawalpemilu.org#52401,"PANGARENGAN, RAJEG, TANGERANG, BANTEN",1,83,144,227
https://kawalpemilu.org#52401,"PANGARENGAN, RAJEG, TANGERANG, BANTEN",2,102,110,212
https://kawalpemilu.org#52401,"PANGARENGAN, RAJEG, TANGERANG, BANTEN",3,93,103,196
https://kawalpemilu.org#52401,"PANGARENGAN, RAJEG, TANGERANG, BANTEN",5,59,118,177
https://kawalpemilu.org#52401,"PANGARENGAN, RAJEG, TANGERANG, BANTEN",6,69,114,183
https://kawalpemilu.org#52401,"PANGARENGAN, RAJEG, TANGERANG, BANTEN",7,110,99,209
https://kawalpemilu.org#52401,"PANGARENGAN, RAJEG, TANGERANG, BANTEN",8,85,148,233
https://kawalpemilu.org#52401,"PANGARENGAN, RAJEG, TANGERANG, BANTEN",9,117,72,189
https://kawalpemilu.org#52401,"PANGARENGAN, RAJEG, TANGERANG, BANTEN",10,100,67,167
https://kawalpemilu.org#52401,"PANGARENGAN, RAJEG, TANGERANG, BANTEN",11,70,88,158
https://kawalpemilu.org#52401,"PANGARENGAN, RAJEG, TANGERANG, BANTEN",12,68,113,181
https://kawalpemilu.org#52401,"PANGARENGAN, RAJEG, TANGERANG, BANTEN",13,48,169,217
https://kawalpemilu.org#52401,"PANGARENGAN, RAJEG, TANGERANG, BANTEN",14,70,133,203
https://kawalpemilu.org#52401,"PANGARENGAN, RAJEG, TANGERANG, BANTEN",15,100,72,172
https://kawalpemilu.org#52401,"PANGARENGAN, RAJEG, TANGERANG, BANTEN",16,94,82,176
https://kawalpemilu.org#52401,"PANGARENGAN, RAJEG, TANGERANG, BANTEN",17,87,132,219
https://kawalpemilu.org#52401,"PANGARENGAN, RAJEG, TANGERANG, BANTEN",18,98,130,128
https://kawalpemilu.org#52401,"PANGARENGAN, RAJEG, TANGERANG, BANTEN",19,55,120,175
https://kawalpemilu.org#52401,"PANGARENGAN, RAJEG, TANGERANG, BANTEN",20,54,99,153
https://kawalpemilu.org#52401,"PANGARENGAN, RAJEG, TANGERANG, BANTEN",21,46,111,157
https://kawalpemilu.org#52401,"PANGARENGAN, RAJEG, TANGERANG, BANTEN",23,87,102,189
https://kawalpemilu.org#52401,"PANGARENGAN, RAJEG, TANGERANG, BANTEN",24,66,114,180
https://kawalpemilu.org#52401,"PANGARENGAN, RAJEG, TANGERANG, BANTEN",25,55,133,188
https://kawalpemilu.org#52401,"PANGARENGAN, RAJEG, TANGERANG, BANTEN",26,99,98,197
https://kawalpemilu.org#52401,"PANGARENGAN, RAJEG, TANGERANG, BANTEN",27,96,85,181
https://kawalpemilu.org#52401,"PANGARENGAN, RAJEG, TANGERANG, BANTEN",28,98,99,197
https://kawalpemilu.org#52401,"PANGARENGAN, RAJEG, TANGERANG, BANTEN",29,83,136,219
https://kawalpemilu.org#52401,"PANGARENGAN, RAJEG, TANGERANG, BANTEN",30,82,96,178
https://kawalpemilu.org#52401,"PANGARENGAN, RAJEG, TANGERANG, BANTEN",31,49,111,160
https://kawalpemilu.org#52402,"JAMBU KARYA, RAJEG, TANGERANG, BANTEN",1,42,174,216
https://kawalpemilu.org#52402,"JAMBU KARYA, RAJEG, TANGERANG, BANTEN",2,32,154,186
https://kawalpemilu.org#52402,"JAMBU KARYA, RAJEG, TANGERANG, BANTEN",3,72,72,144
https://kawalpemilu.org#52402,"JAMBU KARYA, RAJEG, TANGERANG, BANTEN",4,48,88,136
https://kawalpemilu.org#52402,"JAMBU KARYA, RAJEG, TANGERANG, BANTEN",5,55,91,146
https://kawalpemilu.org#52402,"JAMBU KARYA, RAJEG, TANGERANG, BANTEN",6,34,153,187
https://kawalpemilu.org#52402,"JAMBU KARYA, RAJEG, TANGERANG, BANTEN",7,57,161,218
https://kawalpemilu.org#52402,"JAMBU KARYA, RAJEG, TANGERANG, BANTEN",8,52,181,233
https://kawalpemilu.org#52402,"JAMBU KARYA, RAJEG, TANGERANG, BANTEN",9,48,146,194
https://kawalpemilu.org#52402,"JAMBU KARYA, RAJEG, TANGERANG, BANTEN",10,67,93,160
https://kawalpemilu.org#52402,"JAMBU KARYA, RAJEG, TANGERANG, BANTEN",11,60,94,154
https://kawalpemilu.org#52402,"JAMBU KARYA, RAJEG, TANGERANG, BANTEN",12,52,116,168
https://kawalpemilu.org#52402,"JAMBU KARYA, RAJEG, TANGERANG, BANTEN",14,25,166,191
https://kawalpemilu.org#52402,"JAMBU KARYA, RAJEG, TANGERANG, BANTEN",15,42,159,201
https://kawalpemilu.org#52402,"JAMBU KARYA, RAJEG, TANGERANG, BANTEN",17,66,145,211
https://kawalpemilu.org#52402,"JAMBU KARYA, RAJEG, TANGERANG, BANTEN",18,44,134,178
https://kawalpemilu.org#52402,"JAMBU KARYA, RAJEG, TANGERANG, BANTEN",19,50,120,170
https://kawalpemilu.org#52402,"JAMBU KARYA, RAJEG, TANGERANG, BANTEN",20,38,120,158
https://kawalpemilu.org#52403,"LEMBANGSARI, RAJEG, TANGERANG, BANTEN",1,38,118,156
https://kawalpemilu.org#52403,"LEMBANGSARI, RAJEG, TANGERANG, BANTEN",2,105,83,188
https://kawalpemilu.org#52403,"LEMBANGSARI, RAJEG, TANGERANG, BANTEN",3,46,109,155
https://kawalpemilu.org#52403,"LEMBANGSARI, RAJEG, TANGERANG, BANTEN",4,78,62,140
https://kawalpemilu.org#52403,"LEMBANGSARI, RAJEG, TANGERANG, BANTEN",6,65,134,199
https://kawalpemilu.org#52403,"LEMBANGSARI, RAJEG, TANGERANG, BANTEN",7,80,163,243
https://kawalpemilu.org#52403,"LEMBANGSARI, RAJEG, TANGERANG, BANTEN",8,69,165,234
https://kawalpemilu.org#52403,"LEMBANGSARI, RAJEG, TANGERANG, BANTEN",9,57,149,206
https://kawalpemilu.org#52403,"LEMBANGSARI, RAJEG, TANGERANG, BANTEN",10,48,121,169
https://kawalpemilu.org#52403,"LEMBANGSARI, RAJEG, TANGERANG, BANTEN",11,67,91,158
https://kawalpemilu.org#52403,"LEMBANGSARI, RAJEG, TANGERANG, BANTEN",12,30,132,162
https://kawalpemilu.org#52403,"LEMBANGSARI, RAJEG, TANGERANG, BANTEN",13,44,124,12
https://kawalpemilu.org#52403,"LEMBANGSARI, RAJEG, TANGERANG, BANTEN",14,35,136,171
https://kawalpemilu.org#52403,"LEMBANGSARI, RAJEG, TANGERANG, BANTEN",15,42,122,164
https://kawalpemilu.org#52403,"LEMBANGSARI, RAJEG, TANGERANG, BANTEN",16,29,129,158
https://kawalpemilu.org#52403,"LEMBANGSARI, RAJEG, TANGERANG, BANTEN",17,62,201,263
https://kawalpemilu.org#52403,"LEMBANGSARI, RAJEG, TANGERANG, BANTEN",18,57,194,251
https://kawalpemilu.org#52403,"LEMBANGSARI, RAJEG, TANGERANG, BANTEN",20,66,145,211
https://kawalpemilu.org#52403,"LEMBANGSARI, RAJEG, TANGERANG, BANTEN",21,68,142,210
https://kawalpemilu.org#52403,"LEMBANGSARI, RAJEG, TANGERANG, BANTEN",22,86,109,195
https://kawalpemilu.org#52403,"LEMBANGSARI, RAJEG, TANGERANG, BANTEN",23,49,98,147
https://kawalpemilu.org#52403,"LEMBANGSARI, RAJEG, TANGERANG, BANTEN",24,43,110,153
https://kawalpemilu.org#52403,"LEMBANGSARI, RAJEG, TANGERANG, BANTEN",25,110,129,239
https://kawalpemilu.org#52403,"LEMBANGSARI, RAJEG, TANGERANG, BANTEN",26,137,112,249
https://kawalpemilu.org#52404,"SUKAMANAH, RAJEG, TANGERANG, BANTEN",1,86,112,198
https://kawalpemilu.org#52404,"SUKAMANAH, RAJEG, TANGERANG, BANTEN",2,93,71,164
https://kawalpemilu.org#52404,"SUKAMANAH, RAJEG, TANGERANG, BANTEN",3,64,120,184
https://kawalpemilu.org#52404,"SUKAMANAH, RAJEG, TANGERANG, BANTEN",4,42,140,182
https://kawalpemilu.org#52404,"SUKAMANAH, RAJEG, TANGERANG, BANTEN",5,40,156,196
https://kawalpemilu.org#52404,"SUKAMANAH, RAJEG, TANGERANG, BANTEN",8,41,163,204
https://kawalpemilu.org#52404,"SUKAMANAH, RAJEG, TANGERANG, BANTEN",9,54,168,222
https://kawalpemilu.org#52404,"SUKAMANAH, RAJEG, TANGERANG, BANTEN",14,100,82,182
https://kawalpemilu.org#52404,"SUKAMANAH, RAJEG, TANGERANG, BANTEN",15,84,111,195
https://kawalpemilu.org#52404,"SUKAMANAH, RAJEG, TANGERANG, BANTEN",16,51,173,224
https://kawalpemilu.org#52404,"SUKAMANAH, RAJEG, TANGERANG, BANTEN",17,60,100,160
https://kawalpemilu.org#52404,"SUKAMANAH, RAJEG, TANGERANG, BANTEN",18,119,114,233
https://kawalpemilu.org#52404,"SUKAMANAH, RAJEG, TANGERANG, BANTEN",20,70,130,200
https://kawalpemilu.org#52404,"SUKAMANAH, RAJEG, TANGERANG, BANTEN",21,116,130,246
https://kawalpemilu.org#52404,"SUKAMANAH, RAJEG, TANGERANG, BANTEN",22,40,158,198
https://kawalpemilu.org#52404,"SUKAMANAH, RAJEG, TANGERANG, BANTEN",23,86,159,245
https://kawalpemilu.org#52404,"SUKAMANAH, RAJEG, TANGERANG, BANTEN",24,113,139,252
https://kawalpemilu.org#52404,"SUKAMANAH, RAJEG, TANGERANG, BANTEN",25,88,148,236
https://kawalpemilu.org#52404,"SUKAMANAH, RAJEG, TANGERANG, BANTEN",26,85,146,231
https://kawalpemilu.org#52404,"SUKAMANAH, RAJEG, TANGERANG, BANTEN",28,55,121,176
https://kawalpemilu.org#52404,"SUKAMANAH, RAJEG, TANGERANG, BANTEN",29,49,90,139
https://kawalpemilu.org#52404,"SUKAMANAH, RAJEG, TANGERANG, BANTEN",35,60,145,205
https://kawalpemilu.org#52404,"SUKAMANAH, RAJEG, TANGERANG, BANTEN",36,51,139,190
https://kawalpemilu.org#52404,"SUKAMANAH, RAJEG, TANGERANG, BANTEN",37,66,93,159
https://kawalpemilu.org#52404,"SUKAMANAH, RAJEG, TANGERANG, BANTEN",38,78,80,158
https://kawalpemilu.org#52404,"SUKAMANAH, RAJEG, TANGERANG, BANTEN",39,52,129,181
https://kawalpemilu.org#52404,"SUKAMANAH, RAJEG, TANGERANG, BANTEN",40,39,98,137
https://kawalpemilu.org#52404,"SUKAMANAH, RAJEG, TANGERANG, BANTEN",41,32,104,136
https://kawalpemilu.org#52404,"SUKAMANAH, RAJEG, TANGERANG, BANTEN",42,35,79,114
https://kawalpemilu.org#52404,"SUKAMANAH, RAJEG, TANGERANG, BANTEN",43,49,159,208
https://kawalpemilu.org#52404,"SUKAMANAH, RAJEG, TANGERANG, BANTEN",44,145,126,271
https://kawalpemilu.org#52405,"TANJAKAN, RAJEG, TANGERANG, BANTEN",1,64,111,175
https://kawalpemilu.org#52405,"TANJAKAN, RAJEG, TANGERANG, BANTEN",2,58,110,168
https://kawalpemilu.org#52405,"TANJAKAN, RAJEG, TANGERANG, BANTEN",3,42,123,165
https://kawalpemilu.org#52405,"TANJAKAN, RAJEG, TANGERANG, BANTEN",4,48,147,195
https://kawalpemilu.org#52405,"TANJAKAN, RAJEG, TANGERANG, BANTEN",5,60,163,223
https://kawalpemilu.org#52405,"TANJAKAN, RAJEG, TANGERANG, BANTEN",6,52,169,221
https://kawalpemilu.org#52405,"TANJAKAN, RAJEG, TANGERANG, BANTEN",7,68,182,250
https://kawalpemilu.org#52405,"TANJAKAN, RAJEG, TANGERANG, BANTEN",8,59,159,218
https://kawalpemilu.org#52405,"TANJAKAN, RAJEG, TANGERANG, BANTEN",9,44,167,211
https://kawalpemilu.org#52405,"TANJAKAN, RAJEG, TANGERANG, BANTEN",10,52,161,213
https://kawalpemilu.org#52405,"TANJAKAN, RAJEG, TANGERANG, BANTEN",11,50,180,230
https://kawalpemilu.org#52405,"TANJAKAN, RAJEG, TANGERANG, BANTEN",12,51,152,203
https://kawalpemilu.org#52405,"TANJAKAN, RAJEG, TANGERANG, BANTEN",13,43,156,199
https://kawalpemilu.org#52405,"TANJAKAN, RAJEG, TANGERANG, BANTEN",14,67,131,198
https://kawalpemilu.org#52405,"TANJAKAN, RAJEG, TANGERANG, BANTEN",16,40,130,170
https://kawalpemilu.org#52405,"TANJAKAN, RAJEG, TANGERANG, BANTEN",17,64,144,208
https://kawalpemilu.org#52405,"TANJAKAN, RAJEG, TANGERANG, BANTEN",18,47,122,169
https://kawalpemilu.org#52405,"TANJAKAN, RAJEG, TANGERANG, BANTEN",19,75,116,191
https://kawalpemilu.org#52405,"TANJAKAN, RAJEG, TANGERANG, BANTEN",20,95,102,197
https://kawalpemilu.org#52405,"TANJAKAN, RAJEG, TANGERANG, BANTEN",21,129,121,250
https://kawalpemilu.org#52405,"TANJAKAN, RAJEG, TANGERANG, BANTEN",22,107,137,244
https://kawalpemilu.org#52406,"TANJAKAN MEKAR, RAJEG, TANGERANG, BANTEN",1,54,109,163
https://kawalpemilu.org#52406,"TANJAKAN MEKAR, RAJEG, TANGERANG, BANTEN",2,36,116,152
https://kawalpemilu.org#52406,"TANJAKAN MEKAR, RAJEG, TANGERANG, BANTEN",3,55,120,175
https://kawalpemilu.org#52406,"TANJAKAN MEKAR, RAJEG, TANGERANG, BANTEN",4,66,115,181
https://kawalpemilu.org#52406,"TANJAKAN MEKAR, RAJEG, TANGERANG, BANTEN",5,48,123,171
https://kawalpemilu.org#52406,"TANJAKAN MEKAR, RAJEG, TANGERANG, BANTEN",6,70,142,212
https://kawalpemilu.org#52406,"TANJAKAN MEKAR, RAJEG, TANGERANG, BANTEN",7,48,124,172
https://kawalpemilu.org#52406,"TANJAKAN MEKAR, RAJEG, TANGERANG, BANTEN",8,36,118,154
https://kawalpemilu.org#52406,"TANJAKAN MEKAR, RAJEG, TANGERANG, BANTEN",9,55,91,146
https://kawalpemilu.org#52406,"TANJAKAN MEKAR, RAJEG, TANGERANG, BANTEN",10,70,96,166
https://kawalpemilu.org#52406,"TANJAKAN MEKAR, RAJEG, TANGERANG, BANTEN",11,71,127,198
https://kawalpemilu.org#52406,"TANJAKAN MEKAR, RAJEG, TANGERANG, BANTEN",12,88,145,233
https://kawalpemilu.org#52406,"TANJAKAN MEKAR, RAJEG, TANGERANG, BANTEN",13,77,132,209
https://kawalpemilu.org#52406,"TANJAKAN MEKAR, RAJEG, TANGERANG, BANTEN",14,68,108,176
https://kawalpemilu.org#52406,"TANJAKAN MEKAR, RAJEG, TANGERANG, BANTEN",16,90,103,193
https://kawalpemilu.org#52406,"TANJAKAN MEKAR, RAJEG, TANGERANG, BANTEN",17,61,146,207
https://kawalpemilu.org#52406,"TANJAKAN MEKAR, RAJEG, TANGERANG, BANTEN",18,55,91,146
https://kawalpemilu.org#52407,"SUKASARI, RAJEG, TANGERANG, BANTEN",1,80,97,177
https://kawalpemilu.org#52407,"SUKASARI, RAJEG, TANGERANG, BANTEN",2,105,83,188
https://kawalpemilu.org#52407,"SUKASARI, RAJEG, TANGERANG, BANTEN",3,81,119,200
https://kawalpemilu.org#52407,"SUKASARI, RAJEG, TANGERANG, BANTEN",4,66,130,196
https://kawalpemilu.org#52407,"SUKASARI, RAJEG, TANGERANG, BANTEN",5,37,182,219
https://kawalpemilu.org#52407,"SUKASARI, RAJEG, TANGERANG, BANTEN",6,48,196,244
https://kawalpemilu.org#52407,"SUKASARI, RAJEG, TANGERANG, BANTEN",7,80,163,243
https://kawalpemilu.org#52407,"SUKASARI, RAJEG, TANGERANG, BANTEN",8,89,134,223
https://kawalpemilu.org#52407,"SUKASARI, RAJEG, TANGERANG, BANTEN",9,57,149,206
https://kawalpemilu.org#52407,"SUKASARI, RAJEG, TANGERANG, BANTEN",10,44,130,174
https://kawalpemilu.org#52407,"SUKASARI, RAJEG, TANGERANG, BANTEN",11,23,144,167
https://kawalpemilu.org#52407,"SUKASARI, RAJEG, TANGERANG, BANTEN",13,59,127,186
https://kawalpemilu.org#52407,"SUKASARI, RAJEG, TANGERANG, BANTEN",14,59,132,191
https://kawalpemilu.org#52407,"SUKASARI, RAJEG, TANGERANG, BANTEN",15,54,146,200
https://kawalpemilu.org#52407,"SUKASARI, RAJEG, TANGERANG, BANTEN",16,52,130,182
https://kawalpemilu.org#52407,"SUKASARI, RAJEG, TANGERANG, BANTEN",17,52,151,203
https://kawalpemilu.org#52407,"SUKASARI, RAJEG, TANGERANG, BANTEN",18,67,95,162
https://kawalpemilu.org#52407,"SUKASARI, RAJEG, TANGERANG, BANTEN",19,38,181,219
https://kawalpemilu.org#52407,"SUKASARI, RAJEG, TANGERANG, BANTEN",20,33,115,148
https://kawalpemilu.org#52407,"SUKASARI, RAJEG, TANGERANG, BANTEN",21,95,106,201
https://kawalpemilu.org#52407,"SUKASARI, RAJEG, TANGERANG, BANTEN",22,86,109,195
https://kawalpemilu.org#52407,"SUKASARI, RAJEG, TANGERANG, BANTEN",23,80,91,171
https://kawalpemilu.org#52407,"SUKASARI, RAJEG, TANGERANG, BANTEN",24,92,101,193
https://kawalpemilu.org#52407,"SUKASARI, RAJEG, TANGERANG, BANTEN",25,87,85,172
https://kawalpemilu.org#52407,"SUKASARI, RAJEG, TANGERANG, BANTEN",26,113,92,205
https://kawalpemilu.org#52407,"SUKASARI, RAJEG, TANGERANG, BANTEN",27,51,101,152
https://kawalpemilu.org#52407,"SUKASARI, RAJEG, TANGERANG, BANTEN",28,66,98,164
https://kawalpemilu.org#52407,"SUKASARI, RAJEG, TANGERANG, BANTEN",29,53,124,177
https://kawalpemilu.org#52407,"SUKASARI, RAJEG, TANGERANG, BANTEN",30,162,72,234
https://kawalpemilu.org#52408,"RANCA BANGO, RAJEG, TANGERANG, BANTEN",1,62,120,182
https://kawalpemilu.org#52408,"RANCA BANGO, RAJEG, TANGERANG, BANTEN",2,86,107,193
https://kawalpemilu.org#52408,"RANCA BANGO, RAJEG, TANGERANG, BANTEN",3,54,161,215
https://kawalpemilu.org#52408,"RANCA BANGO, RAJEG, TANGERANG, BANTEN",6,93,95,188
https://kawalpemilu.org#52408,"RANCA BANGO, RAJEG, TANGERANG, BANTEN",8,79,109,188
https://kawalpemilu.org#52408,"RANCA BANGO, RAJEG, TANGERANG, BANTEN",10,78,73,151
https://kawalpemilu.org#52408,"RANCA BANGO, RAJEG, TANGERANG, BANTEN",11,44,93,137
https://kawalpemilu.org#52408,"RANCA BANGO, RAJEG, TANGERANG, BANTEN",13,88,148,236
https://kawalpemilu.org#52408,"RANCA BANGO, RAJEG, TANGERANG, BANTEN",16,66,122,188
https://kawalpemilu.org#52408,"RANCA BANGO, RAJEG, TANGERANG, BANTEN",17,68,112,180
https://kawalpemilu.org#52409,"DAON, RAJEG, TANGERANG, BANTEN",1,114,61,175
https://kawalpemilu.org#52409,"DAON, RAJEG, TANGERANG, BANTEN",2,99,60,159
https://kawalpemilu.org#52409,"DAON, RAJEG, TANGERANG, BANTEN",3,49,101,150
https://kawalpemilu.org#52409,"DAON, RAJEG, TANGERANG, BANTEN",4,40,100,140
https://kawalpemilu.org#52409,"DAON, RAJEG, TANGERANG, BANTEN",5,49,112,161
https://kawalpemilu.org#52409,"DAON, RAJEG, TANGERANG, BANTEN",6,55,81,136
https://kawalpemilu.org#52409,"DAON, RAJEG, TANGERANG, BANTEN",7,84,103,187
https://kawalpemilu.org#52409,"DAON, RAJEG, TANGERANG, BANTEN",8,91,111,202
https://kawalpemilu.org#52409,"DAON, RAJEG, TANGERANG, BANTEN",9,61,110,171
https://kawalpemilu.org#52409,"DAON, RAJEG, TANGERANG, BANTEN",11,99,107,206
https://kawalpemilu.org#52409,"DAON, RAJEG, TANGERANG, BANTEN",12,77,161,238
https://kawalpemilu.org#52409,"DAON, RAJEG, TANGERANG, BANTEN",13,49,134,183
https://kawalpemilu.org#52409,"DAON, RAJEG, TANGERANG, BANTEN",14,51,118,169
https://kawalpemilu.org#52409,"DAON, RAJEG, TANGERANG, BANTEN",15,96,96,192
https://kawalpemilu.org#52409,"DAON, RAJEG, TANGERANG, BANTEN",16,62,118,180
https://kawalpemilu.org#52409,"DAON, RAJEG, TANGERANG, BANTEN",17,97,126,223
https://kawalpemilu.org#52409,"DAON, RAJEG, TANGERANG, BANTEN",18,79,143,222
https://kawalpemilu.org#52409,"DAON, RAJEG, TANGERANG, BANTEN",20,41,138,179
https://kawalpemilu.org#52409,"DAON, RAJEG, TANGERANG, BANTEN",21,36,124,160
https://kawalpemilu.org#52409,"DAON, RAJEG, TANGERANG, BANTEN",22,32,112,144
https://kawalpemilu.org#52409,"DAON, RAJEG, TANGERANG, BANTEN",23,99,128,227
https://kawalpemilu.org#52409,"DAON, RAJEG, TANGERANG, BANTEN",24,83,139,222
https://kawalpemilu.org#52409,"DAON, RAJEG, TANGERANG, BANTEN",25,101,118,219
https://kawalpemilu.org#52409,"DAON, RAJEG, TANGERANG, BANTEN",26,106,131,237
https://kawalpemilu.org#52409,"DAON, RAJEG, TANGERANG, BANTEN",27,75,125,200
https://kawalpemilu.org#52409,"DAON, RAJEG, TANGERANG, BANTEN",28,64,161,225
https://kawalpemilu.org#52409,"DAON, RAJEG, TANGERANG, BANTEN",30,53,171,224
https://kawalpemilu.org#52409,"DAON, RAJEG, TANGERANG, BANTEN",31,82,143,225
https://kawalpemilu.org#52409,"DAON, RAJEG, TANGERANG, BANTEN",32,89,125,214
https://kawalpemilu.org#52409,"DAON, RAJEG, TANGERANG, BANTEN",33,113,128,241
https://kawalpemilu.org#52410,"MEKARSARI, RAJEG, TANGERANG, BANTEN",1,86,112,198
https://kawalpemilu.org#52410,"MEKARSARI, RAJEG, TANGERANG, BANTEN",3,85,82,167
https://kawalpemilu.org#52410,"MEKARSARI, RAJEG, TANGERANG, BANTEN",4,75,112,187
https://kawalpemilu.org#52410,"MEKARSARI, RAJEG, TANGERANG, BANTEN",5,60,147,207
https://kawalpemilu.org#52410,"MEKARSARI, RAJEG, TANGERANG, BANTEN",7,68,109,177
https://kawalpemilu.org#52410,"MEKARSARI, RAJEG, TANGERANG, BANTEN",8,81,97,178
https://kawalpemilu.org#52410,"MEKARSARI, RAJEG, TANGERANG, BANTEN",9,67,165,232
https://kawalpemilu.org#52410,"MEKARSARI, RAJEG, TANGERANG, BANTEN",10,77,121,198
https://kawalpemilu.org#52410,"MEKARSARI, RAJEG, TANGERANG, BANTEN",13,71,140,211
https://kawalpemilu.org#52410,"MEKARSARI, RAJEG, TANGERANG, BANTEN",14,75,120,195
https://kawalpemilu.org#52410,"MEKARSARI, RAJEG, TANGERANG, BANTEN",16,57,185,242
https://kawalpemilu.org#52410,"MEKARSARI, RAJEG, TANGERANG, BANTEN",17,88,136,224
https://kawalpemilu.org#52410,"MEKARSARI, RAJEG, TANGERANG, BANTEN",18,43,115,158
https://kawalpemilu.org#52410,"MEKARSARI, RAJEG, TANGERANG, BANTEN",19,44,110,154
https://kawalpemilu.org#52410,"MEKARSARI, RAJEG, TANGERANG, BANTEN",21,66,171,237
https://kawalpemilu.org#52410,"MEKARSARI, RAJEG, TANGERANG, BANTEN",22,67,123,190
https://kawalpemilu.org#52410,"MEKARSARI, RAJEG, TANGERANG, BANTEN",23,69,113,182
https://kawalpemilu.org#52410,"MEKARSARI, RAJEG, TANGERANG, BANTEN",24,104,89,193
https://kawalpemilu.org#52410,"MEKARSARI, RAJEG, TANGERANG, BANTEN",25,91,117,208
https://kawalpemilu.org#52410,"MEKARSARI, RAJEG, TANGERANG, BANTEN",26,98,138,236
https://kawalpemilu.org#52410,"MEKARSARI, RAJEG, TANGERANG, BANTEN",27,112,128,240
https://kawalpemilu.org#52410,"MEKARSARI, RAJEG, TANGERANG, BANTEN",28,91,139,230
https://kawalpemilu.org#52410,"MEKARSARI, RAJEG, TANGERANG, BANTEN",29,52,174,226
https://kawalpemilu.org#52410,"MEKARSARI, RAJEG, TANGERANG, BANTEN",30,64,167,231
https://kawalpemilu.org#52410,"MEKARSARI, RAJEG, TANGERANG, BANTEN",31,83,172,255
https://kawalpemilu.org#52410,"MEKARSARI, RAJEG, TANGERANG, BANTEN",32,49,171,220
https://kawalpemilu.org#52410,"MEKARSARI, RAJEG, TANGERANG, BANTEN",33,62,123,185
https://kawalpemilu.org#52410,"MEKARSARI, RAJEG, TANGERANG, BANTEN",34,59,147,206
https://kawalpemilu.org#52410,"MEKARSARI, RAJEG, TANGERANG, BANTEN",35,71,127,198
https://kawalpemilu.org#52410,"MEKARSARI, RAJEG, TANGERANG, BANTEN",36,84,119,203
https://kawalpemilu.org#52410,"MEKARSARI, RAJEG, TANGERANG, BANTEN",37,81,103,184
https://kawalpemilu.org#52410,"MEKARSARI, RAJEG, TANGERANG, BANTEN",38,90,136,226
https://kawalpemilu.org#52410,"MEKARSARI, RAJEG, TANGERANG, BANTEN",39,80,152,232
https://kawalpemilu.org#52410,"MEKARSARI, RAJEG, TANGERANG, BANTEN",40,98,157,255
https://kawalpemilu.org#52410,"MEKARSARI, RAJEG, TANGERANG, BANTEN",41,62,178,240
https://kawalpemilu.org#52410,"MEKARSARI, RAJEG, TANGERANG, BANTEN",42,99,110,209
https://kawalpemilu.org#52410,"MEKARSARI, RAJEG, TANGERANG, BANTEN",43,94,96,190
https://kawalpemilu.org#52410,"MEKARSARI, RAJEG, TANGERANG, BANTEN",44,61,95,156
https://kawalpemilu.org#52410,"MEKARSARI, RAJEG, TANGERANG, BANTEN",45,80,99,179
https://kawalpemilu.org#52410,"MEKARSARI, RAJEG, TANGERANG, BANTEN",46,76,96,172
https://kawalpemilu.org#52410,"MEKARSARI, RAJEG, TANGERANG, BANTEN",47,93,133,226
https://kawalpemilu.org#52410,"MEKARSARI, RAJEG, TANGERANG, BANTEN",48,55,104,159
https://kawalpemilu.org#52410,"MEKARSARI, RAJEG, TANGERANG, BANTEN",49,76,107,185
https://kawalpemilu.org#52410,"MEKARSARI, RAJEG, TANGERANG, BANTEN",50,106,141,247
https://kawalpemilu.org#52410,"MEKARSARI, RAJEG, TANGERANG, BANTEN",51,83,133,216
https://kawalpemilu.org#52410,"MEKARSARI, RAJEG, TANGERANG, BANTEN",52,53,154,207
https://kawalpemilu.org#52410,"MEKARSARI, RAJEG, TANGERANG, BANTEN",53,77,133,210
https://kawalpemilu.org#52410,"MEKARSARI, RAJEG, TANGERANG, BANTEN",55,94,90,184
https://kawalpemilu.org#52410,"MEKARSARI, RAJEG, TANGERANG, BANTEN",56,94,156,250
https://kawalpemilu.org#52410,"MEKARSARI, RAJEG, TANGERANG, BANTEN",57,97,141,238
https://kawalpemilu.org#52410,"MEKARSARI, RAJEG, TANGERANG, BANTEN",58,88,156,244
https://kawalpemilu.org#52410,"MEKARSARI, RAJEG, TANGERANG, BANTEN",62,103,117,220
https://kawalpemilu.org#52410,"MEKARSARI, RAJEG, TANGERANG, BANTEN",63,63,104,167
https://kawalpemilu.org#52410,"MEKARSARI, RAJEG, TANGERANG, BANTEN",64,118,137,255
https://kawalpemilu.org#52410,"MEKARSARI, RAJEG, TANGERANG, BANTEN",67,61,109,170
https://kawalpemilu.org#52410,"MEKARSARI, RAJEG, TANGERANG, BANTEN",68,101,155,256
https://kawalpemilu.org#52410,"MEKARSARI, RAJEG, TANGERANG, BANTEN",69,73,123,196
https://kawalpemilu.org#52410,"MEKARSARI, RAJEG, TANGERANG, BANTEN",70,89,123,212
https://kawalpemilu.org#52410,"MEKARSARI, RAJEG, TANGERANG, BANTEN",72,75,114,189
https://kawalpemilu.org#52410,"MEKARSARI, RAJEG, TANGERANG, BANTEN",73,114,118,232
https://kawalpemilu.org#52410,"MEKARSARI, RAJEG, TANGERANG, BANTEN",74,110,88,198
https://kawalpemilu.org#52410,"MEKARSARI, RAJEG, TANGERANG, BANTEN",75,111,66,177
https://kawalpemilu.org#52410,"MEKARSARI, RAJEG, TANGERANG, BANTEN",76,83,157,240
https://kawalpemilu.org#52410,"MEKARSARI, RAJEG, TANGERANG, BANTEN",77,106,121,227
https://kawalpemilu.org#52410,"MEKARSARI, RAJEG, TANGERANG, BANTEN",78,71,70,141
https://kawalpemilu.org#52410,"MEKARSARI, RAJEG, TANGERANG, BANTEN",79,65,78,143
https://kawalpemilu.org#52412,"SINDANGSARI, PASAR KEMIS, TANGERANG, BANTEN",1,67,109,176
https://kawalpemilu.org#52412,"SINDANGSARI, PASAR KEMIS, TANGERANG, BANTEN",2,83,113,196
https://kawalpemilu.org#52412,"SINDANGSARI, PASAR KEMIS, TANGERANG, BANTEN",3,65,163,228
https://kawalpemilu.org#52412,"SINDANGSARI, PASAR KEMIS, TANGERANG, BANTEN",4,59,159,218
https://kawalpemilu.org#52412,"SINDANGSARI, PASAR KEMIS, TANGERANG, BANTEN",5,32,129,161
https://kawalpemilu.org#52412,"SINDANGSARI, PASAR KEMIS, TANGERANG, BANTEN",6,36,140,176
https://kawalpemilu.org#52412,"SINDANGSARI, PASAR KEMIS, TANGERANG, BANTEN",8,50,161,211
https://kawalpemilu.org#52412,"SINDANGSARI, PASAR KEMIS, TANGERANG, BANTEN",9,64,148,212
https://kawalpemilu.org#52412,"SINDANGSARI, PASAR KEMIS, TANGERANG, BANTEN",10,46,142,188
https://kawalpemilu.org#52412,"SINDANGSARI, PASAR KEMIS, TANGERANG, BANTEN",11,72,116,188
https://kawalpemilu.org#52412,"SINDANGSARI, PASAR KEMIS, TANGERANG, BANTEN",12,42,106,148
https://kawalpemilu.org#52412,"SINDANGSARI, PASAR KEMIS, TANGERANG, BANTEN",14,22,125,147
https://kawalpemilu.org#52412,"SINDANGSARI, PASAR KEMIS, TANGERANG, BANTEN",15,23,117,140
https://kawalpemilu.org#52412,"SINDANGSARI, PASAR KEMIS, TANGERANG, BANTEN",16,42,175,217
https://kawalpemilu.org#52412,"SINDANGSARI, PASAR KEMIS, TANGERANG, BANTEN",17,51,186,237
https://kawalpemilu.org#52412,"SINDANGSARI, PASAR KEMIS, TANGERANG, BANTEN",18,34,149,183
https://kawalpemilu.org#52412,"SINDANGSARI, PASAR KEMIS, TANGERANG, BANTEN",19,41,140,181
https://kawalpemilu.org#52412,"SINDANGSARI, PASAR KEMIS, TANGERANG, BANTEN",20,67,114,181
https://kawalpemilu.org#52412,"SINDANGSARI, PASAR KEMIS, TANGERANG, BANTEN",21,62,128,190
https://kawalpemilu.org#52412,"SINDANGSARI, PASAR KEMIS, TANGERANG, BANTEN",22,64,110,174
https://kawalpemilu.org#52412,"SINDANGSARI, PASAR KEMIS, TANGERANG, BANTEN",23,50,100,150
https://kawalpemilu.org#52412,"SINDANGSARI, PASAR KEMIS, TANGERANG, BANTEN",24,85,126,211
https://kawalpemilu.org#52412,"SINDANGSARI, PASAR KEMIS, TANGERANG, BANTEN",26,66,183,249
https://kawalpemilu.org#52412,"SINDANGSARI, PASAR KEMIS, TANGERANG, BANTEN",27,36,132,168
https://kawalpemilu.org#52412,"SINDANGSARI, PASAR KEMIS, TANGERANG, BANTEN",28,41,114,155
https://kawalpemilu.org#52412,"SINDANGSARI, PASAR KEMIS, TANGERANG, BANTEN",30,45,173,218
https://kawalpemilu.org#52412,"SINDANGSARI, PASAR KEMIS, TANGERANG, BANTEN",31,34,108,142
https://kawalpemilu.org#52412,"SINDANGSARI, PASAR KEMIS, TANGERANG, BANTEN",32,23,105,128
https://kawalpemilu.org#52412,"SINDANGSARI, PASAR KEMIS, TANGERANG, BANTEN",33,28,134,162
https://kawalpemilu.org#52412,"SINDANGSARI, PASAR KEMIS, TANGERANG, BANTEN",34,42,113,155
https://kawalpemilu.org#52412,"SINDANGSARI, PASAR KEMIS, TANGERANG, BANTEN",35,36,207,243
https://kawalpemilu.org#52412,"SINDANGSARI, PASAR KEMIS, TANGERANG, BANTEN",36,33,192,225
https://kawalpemilu.org#52412,"SINDANGSARI, PASAR KEMIS, TANGERANG, BANTEN",37,45,183,228
https://kawalpemilu.org#52412,"SINDANGSARI, PASAR KEMIS, TANGERANG, BANTEN",38,54,169,223
https://kawalpemilu.org#52412,"SINDANGSARI, PASAR KEMIS, TANGERANG, BANTEN",39,115,90,205
https://kawalpemilu.org#52412,"SINDANGSARI, PASAR KEMIS, TANGERANG, BANTEN",40,88,124,212
https://kawalpemilu.org#52412,"SINDANGSARI, PASAR KEMIS, TANGERANG, BANTEN",41,105,121,226
https://kawalpemilu.org#52412,"SINDANGSARI, PASAR KEMIS, TANGERANG, BANTEN",42,130,110,240
https://kawalpemilu.org#52412,"SINDANGSARI, PASAR KEMIS, TANGERANG, BANTEN",43,76,95,171
https://kawalpemilu.org#52412,"SINDANGSARI, PASAR KEMIS, TANGERANG, BANTEN",44,134,115,249
https://kawalpemilu.org#52412,"SINDANGSARI, PASAR KEMIS, TANGERANG, BANTEN",45,69,106,175
https://kawalpemilu.org#52412,"SINDANGSARI, PASAR KEMIS, TANGERANG, BANTEN",46,108,135,243
https://kawalpemilu.org#52412,"SINDANGSARI, PASAR KEMIS, TANGERANG, BANTEN",47,102,114,216
https://kawalpemilu.org#52412,"SINDANGSARI, PASAR KEMIS, TANGERANG, BANTEN",48,54,57,111
https://kawalpemilu.org#52412,"SINDANGSARI, PASAR KEMIS, TANGERANG, BANTEN",50,92,139,231
https://kawalpemilu.org#52412,"SINDANGSARI, PASAR KEMIS, TANGERANG, BANTEN",51,79,152,231
https://kawalpemilu.org#52412,"SINDANGSARI, PASAR KEMIS, TANGERANG, BANTEN",52,47,158,205
https://kawalpemilu.org#52412,"SINDANGSARI, PASAR KEMIS, TANGERANG, BANTEN",53,100,156,256
https://kawalpemilu.org#52412,"SINDANGSARI, PASAR KEMIS, TANGERANG, BANTEN",54,111,154,265
https://kawalpemilu.org#52412,"SINDANGSARI, PASAR KEMIS, TANGERANG, BANTEN",55,85,131,216
https://kawalpemilu.org#52412,"SINDANGSARI, PASAR KEMIS, TANGERANG, BANTEN",57,115,154,269
https://kawalpemilu.org#52412,"SINDANGSARI, PASAR KEMIS, TANGERANG, BANTEN",58,89,150,239
https://kawalpemilu.org#52412,"SINDANGSARI, PASAR KEMIS, TANGERANG, BANTEN",60,136,102,238
https://kawalpemilu.org#52412,"SINDANGSARI, PASAR KEMIS, TANGERANG, BANTEN",61,83,128,211
https://kawalpemilu.org#52412,"SINDANGSARI, PASAR KEMIS, TANGERANG, BANTEN",62,78,106,184
https://kawalpemilu.org#52412,"SINDANGSARI, PASAR KEMIS, TANGERANG, BANTEN",63,101,146,247
https://kawalpemilu.org#52412,"SINDANGSARI, PASAR KEMIS, TANGERANG, BANTEN",65,116,94,210
https://kawalpemilu.org#52412,"SINDANGSARI, PASAR KEMIS, TANGERANG, BANTEN",66,122,55,177
https://kawalpemilu.org#52412,"SINDANGSARI, PASAR KEMIS, TANGERANG, BANTEN",67,82,73,155
https://kawalpemilu.org#52412,"SINDANGSARI, PASAR KEMIS, TANGERANG, BANTEN",68,67,89,156
https://kawalpemilu.org#52412,"SINDANGSARI, PASAR KEMIS, TANGERANG, BANTEN",69,84,107,191
https://kawalpemilu.org#52412,"SINDANGSARI, PASAR KEMIS, TANGERANG, BANTEN",70,118,120,238
https://kawalpemilu.org#52412,"SINDANGSARI, PASAR KEMIS, TANGERANG, BANTEN",72,120,98,218
https://kawalpemilu.org#52412,"SINDANGSARI, PASAR KEMIS, TANGERANG, BANTEN",73,103,117,220
https://kawalpemilu.org#52412,"SINDANGSARI, PASAR KEMIS, TANGERANG, BANTEN",74,102,163,265
https://kawalpemilu.org#52412,"SINDANGSARI, PASAR KEMIS, TANGERANG, BANTEN",75,90,85,175
https://kawalpemilu.org#52412,"SINDANGSARI, PASAR KEMIS, TANGERANG, BANTEN",76,89,96,185
https://kawalpemilu.org#52412,"SINDANGSARI, PASAR KEMIS, TANGERANG, BANTEN",78,111,120,231
https://kawalpemilu.org#52412,"SINDANGSARI, PASAR KEMIS, TANGERANG, BANTEN",79,143,110,253
https://kawalpemilu.org#52412,"SINDANGSARI, PASAR KEMIS, TANGERANG, BANTEN",80,115,85,200
https://kawalpemilu.org#52412,"SINDANGSARI, PASAR KEMIS, TANGERANG, BANTEN",81,138,118,256
https://kawalpemilu.org#52412,"SINDANGSARI, PASAR KEMIS, TANGERANG, BANTEN",82,77,91,168
https://kawalpemilu.org#52412,"SINDANGSARI, PASAR KEMIS, TANGERANG, BANTEN",83,102,123,225
https://kawalpemilu.org#52412,"SINDANGSARI, PASAR KEMIS, TANGERANG, BANTEN",84,100,111,211
https://kawalpemilu.org#52412,"SINDANGSARI, PASAR KEMIS, TANGERANG, BANTEN",85,103,114,217
https://kawalpemilu.org#52412,"SINDANGSARI, PASAR KEMIS, TANGERANG, BANTEN",86,161,127,288
https://kawalpemilu.org#52412,"SINDANGSARI, PASAR KEMIS, TANGERANG, BANTEN",87,101,113,214
https://kawalpemilu.org#52412,"SINDANGSARI, PASAR KEMIS, TANGERANG, BANTEN",88,98,112,210
https://kawalpemilu.org#52412,"SINDANGSARI, PASAR KEMIS, TANGERANG, BANTEN",89,73,114,187
https://kawalpemilu.org#52412,"SINDANGSARI, PASAR KEMIS, TANGERANG, BANTEN",90,74,63,137
https://kawalpemilu.org#52413,"KUTABUMI, PASAR KEMIS, TANGERANG, BANTEN",1,38,127,165
https://kawalpemilu.org#52413,"KUTABUMI, PASAR KEMIS, TANGERANG, BANTEN",2,34,129,163
https://kawalpemilu.org#52413,"KUTABUMI, PASAR KEMIS, TANGERANG, BANTEN",3,31,100,131
https://kawalpemilu.org#52413,"KUTABUMI, PASAR KEMIS, TANGERANG, BANTEN",4,31,124,155
https://kawalpemilu.org#52413,"KUTABUMI, PASAR KEMIS, TANGERANG, BANTEN",5,48,147,195
https://kawalpemilu.org#52413,"KUTABUMI, PASAR KEMIS, TANGERANG, BANTEN",6,58,117,175
https://kawalpemilu.org#52413,"KUTABUMI, PASAR KEMIS, TANGERANG, BANTEN",7,66,117,183
https://kawalpemilu.org#52413,"KUTABUMI, PASAR KEMIS, TANGERANG, BANTEN",8,56,103,159
https://kawalpemilu.org#52413,"KUTABUMI, PASAR KEMIS, TANGERANG, BANTEN",9,75,142,217
https://kawalpemilu.org#52413,"KUTABUMI, PASAR KEMIS, TANGERANG, BANTEN",10,89,143,232
https://kawalpemilu.org#52413,"KUTABUMI, PASAR KEMIS, TANGERANG, BANTEN",11,65,135,200
https://kawalpemilu.org#52413,"KUTABUMI, PASAR KEMIS, TANGERANG, BANTEN",12,56,141,197
https://kawalpemilu.org#52413,"KUTABUMI, PASAR KEMIS, TANGERANG, BANTEN",13,77,139,216
https://kawalpemilu.org#52413,"KUTABUMI, PASAR KEMIS, TANGERANG, BANTEN",14,101,119,220
https://kawalpemilu.org#52413,"KUTABUMI, PASAR KEMIS, TANGERANG, BANTEN",15,100,120,220
https://kawalpemilu.org#52413,"KUTABUMI, PASAR KEMIS, TANGERANG, BANTEN",16,86,132,218
https://kawalpemilu.org#52413,"KUTABUMI, PASAR KEMIS, TANGERANG, BANTEN",17,79,120,199
https://kawalpemilu.org#52413,"KUTABUMI, PASAR KEMIS, TANGERANG, BANTEN",18,76,125,201
https://kawalpemilu.org#52413,"KUTABUMI, PASAR KEMIS, TANGERANG, BANTEN",19,86,125,211
https://kawalpemilu.org#52413,"KUTABUMI, PASAR KEMIS, TANGERANG, BANTEN",20,42,93,135
https://kawalpemilu.org#52413,"KUTABUMI, PASAR KEMIS, TANGERANG, BANTEN",21,62,143,205
https://kawalpemilu.org#52413,"KUTABUMI, PASAR KEMIS, TANGERANG, BANTEN",22,68,126,194
https://kawalpemilu.org#52413,"KUTABUMI, PASAR KEMIS, TANGERANG, BANTEN",23,52,122,174
https://kawalpemilu.org#52413,"KUTABUMI, PASAR KEMIS, TANGERANG, BANTEN",24,80,171,251
https://kawalpemilu.org#52413,"KUTABUMI, PASAR KEMIS, TANGERANG, BANTEN",25,66,113,179
https://kawalpemilu.org#52413,"KUTABUMI, PASAR KEMIS, TANGERANG, BANTEN",26,95,126,221
https://kawalpemilu.org#52413,"KUTABUMI, PASAR KEMIS, TANGERANG, BANTEN",27,89,107,196
https://kawalpemilu.org#52413,"KUTABUMI, PASAR KEMIS, TANGERANG, BANTEN",28,77,69,146
https://kawalpemilu.org#52413,"KUTABUMI, PASAR KEMIS, TANGERANG, BANTEN",29,70,82,152
https://kawalpemilu.org#52413,"KUTABUMI, PASAR KEMIS, TANGERANG, BANTEN",30,91,81,172
https://kawalpemilu.org#52413,"KUTABUMI, PASAR KEMIS, TANGERANG, BANTEN",31,86,91,177
https://kawalpemilu.org#52413,"KUTABUMI, PASAR KEMIS, TANGERANG, BANTEN",32,58,167,225
https://kawalpemilu.org#52413,"KUTABUMI, PASAR KEMIS, TANGERANG, BANTEN",33,44,181,225
https://kawalpemilu.org#52413,"KUTABUMI, PASAR KEMIS, TANGERANG, BANTEN",34,70,139,209
https://kawalpemilu.org#52413,"KUTABUMI, PASAR KEMIS, TANGERANG, BANTEN",35,52,138,190
https://kawalpemilu.org#52413,"KUTABUMI, PASAR KEMIS, TANGERANG, BANTEN",36,55,152,207
https://kawalpemilu.org#52413,"KUTABUMI, PASAR KEMIS, TANGERANG, BANTEN",37,75,142,217
https://kawalpemilu.org#52413,"KUTABUMI, PASAR KEMIS, TANGERANG, BANTEN",38,111,86,197
https://kawalpemilu.org#52413,"KUTABUMI, PASAR KEMIS, TANGERANG, BANTEN",39,83,77,160
https://kawalpemilu.org#52413,"KUTABUMI, PASAR KEMIS, TANGERANG, BANTEN",40,74,58,132
https://kawalpemilu.org#52413,"KUTABUMI, PASAR KEMIS, TANGERANG, BANTEN",41,95,69,164
https://kawalpemilu.org#52413,"KUTABUMI, PASAR KEMIS, TANGERANG, BANTEN",42,86,85,171
https://kawalpemilu.org#52413,"KUTABUMI, PASAR KEMIS, TANGERANG, BANTEN",43,40,75,115
https://kawalpemilu.org#52413,"KUTABUMI, PASAR KEMIS, TANGERANG, BANTEN",44,81,98,179
https://kawalpemilu.org#52413,"KUTABUMI, PASAR KEMIS, TANGERANG, BANTEN",45,85,79,164
https://kawalpemilu.org#52413,"KUTABUMI, PASAR KEMIS, TANGERANG, BANTEN",46,90,115,205
https://kawalpemilu.org#52413,"KUTABUMI, PASAR KEMIS, TANGERANG, BANTEN",47,99,66,165
https://kawalpemilu.org#52413,"KUTABUMI, PASAR KEMIS, TANGERANG, BANTEN",48,101,106,207
https://kawalpemilu.org#52413,"KUTABUMI, PASAR KEMIS, TANGERANG, BANTEN",49,79,100,179
https://kawalpemilu.org#52413,"KUTABUMI, PASAR KEMIS, TANGERANG, BANTEN",50,109,90,199
https://kawalpemilu.org#52413,"KUTABUMI, PASAR KEMIS, TANGERANG, BANTEN",51,89,92,181
https://kawalpemilu.org#52413,"KUTABUMI, PASAR KEMIS, TANGERANG, BANTEN",52,70,87,157
https://kawalpemilu.org#52413,"KUTABUMI, PASAR KEMIS, TANGERANG, BANTEN",53,77,96,173
https://kawalpemilu.org#52413,"KUTABUMI, PASAR KEMIS, TANGERANG, BANTEN",54,65,79,144
https://kawalpemilu.org#52413,"KUTABUMI, PASAR KEMIS, TANGERANG, BANTEN",55,91,63,154
https://kawalpemilu.org#52413,"KUTABUMI, PASAR KEMIS, TANGERANG, BANTEN",56,105,69,174
https://kawalpemilu.org#52413,"KUTABUMI, PASAR KEMIS, TANGERANG, BANTEN",57,129,96,225
https://kawalpemilu.org#52413,"KUTABUMI, PASAR KEMIS, TANGERANG, BANTEN",58,100,112,212
https://kawalpemilu.org#52413,"KUTABUMI, PASAR KEMIS, TANGERANG, BANTEN",59,94,141,235
https://kawalpemilu.org#52413,"KUTABUMI, PASAR KEMIS, TANGERANG, BANTEN",60,88,119,207
https://kawalpemilu.org#52413,"KUTABUMI, PASAR KEMIS, TANGERANG, BANTEN",61,106,93,199
https://kawalpemilu.org#52413,"KUTABUMI, PASAR KEMIS, TANGERANG, BANTEN",62,84,78,162
https://kawalpemilu.org#52413,"KUTABUMI, PASAR KEMIS, TANGERANG, BANTEN",63,84,126,210
https://kawalpemilu.org#52413,"KUTABUMI, PASAR KEMIS, TANGERANG, BANTEN",65,107,82,189
https://kawalpemilu.org#52413,"KUTABUMI, PASAR KEMIS, TANGERANG, BANTEN",66,56,80,136
https://kawalpemilu.org#52413,"KUTABUMI, PASAR KEMIS, TANGERANG, BANTEN",67,86,125,211
https://kawalpemilu.org#52413,"KUTABUMI, PASAR KEMIS, TANGERANG, BANTEN",68,83,124,207
https://kawalpemilu.org#52413,"KUTABUMI, PASAR KEMIS, TANGERANG, BANTEN",69,112,97,237
https://kawalpemilu.org#52413,"KUTABUMI, PASAR KEMIS, TANGERANG, BANTEN",70,86,152,238
https://kawalpemilu.org#52413,"KUTABUMI, PASAR KEMIS, TANGERANG, BANTEN",71,107,123,230
https://kawalpemilu.org#52413,"KUTABUMI, PASAR KEMIS, TANGERANG, BANTEN",72,82,141,223
https://kawalpemilu.org#52413,"KUTABUMI, PASAR KEMIS, TANGERANG, BANTEN",73,90,115,205
https://kawalpemilu.org#52413,"KUTABUMI, PASAR KEMIS, TANGERANG, BANTEN",74,96,141,237
https://kawalpemilu.org#52413,"KUTABUMI, PASAR KEMIS, TANGERANG, BANTEN",75,119,134,253
https://kawalpemilu.org#52413,"KUTABUMI, PASAR KEMIS, TANGERANG, BANTEN",76,112,134,246
https://kawalpemilu.org#52413,"KUTABUMI, PASAR KEMIS, TANGERANG, BANTEN",77,114,131,245
https://kawalpemilu.org#52413,"KUTABUMI, PASAR KEMIS, TANGERANG, BANTEN",78,101,135,236
https://kawalpemilu.org#52413,"KUTABUMI, PASAR KEMIS, TANGERANG, BANTEN",79,106,144,250
https://kawalpemilu.org#52413,"KUTABUMI, PASAR KEMIS, TANGERANG, BANTEN",80,115,115,230
https://kawalpemilu.org#52413,"KUTABUMI, PASAR KEMIS, TANGERANG, BANTEN",81,107,137,244
https://kawalpemilu.org#52413,"KUTABUMI, PASAR KEMIS, TANGERANG, BANTEN",82,99,154,253
https://kawalpemilu.org#52413,"KUTABUMI, PASAR KEMIS, TANGERANG, BANTEN",83,75,135,210
https://kawalpemilu.org#52413,"KUTABUMI, PASAR KEMIS, TANGERANG, BANTEN",84,64,137,201
https://kawalpemilu.org#52413,"KUTABUMI, PASAR KEMIS, TANGERANG, BANTEN",85,72,101,173
https://kawalpemilu.org#52413,"KUTABUMI, PASAR KEMIS, TANGERANG, BANTEN",86,96,87,183
https://kawalpemilu.org#52413,"KUTABUMI, PASAR KEMIS, TANGERANG, BANTEN",87,110,119,229
https://kawalpemilu.org#52413,"KUTABUMI, PASAR KEMIS, TANGERANG, BANTEN",88,106,135,241
https://kawalpemilu.org#52413,"KUTABUMI, PASAR KEMIS, TANGERANG, BANTEN",89,140,143,283
https://kawalpemilu.org#52413,"KUTABUMI, PASAR KEMIS, TANGERANG, BANTEN",90,128,144,272
https://kawalpemilu.org#52413,"KUTABUMI, PASAR KEMIS, TANGERANG, BANTEN",92,143,133,276
https://kawalpemilu.org#52413,"KUTABUMI, PASAR KEMIS, TANGERANG, BANTEN",93,111,145,256
https://kawalpemilu.org#52413,"KUTABUMI, PASAR KEMIS, TANGERANG, BANTEN",94,140,129,269
https://kawalpemilu.org#52413,"KUTABUMI, PASAR KEMIS, TANGERANG, BANTEN",95,97,155,252
https://kawalpemilu.org#52413,"KUTABUMI, PASAR KEMIS, TANGERANG, BANTEN",96,118,125,243
https://kawalpemilu.org#52413,"KUTABUMI, PASAR KEMIS, TANGERANG, BANTEN",97,115,121,236
https://kawalpemilu.org#52413,"KUTABUMI, PASAR KEMIS, TANGERANG, BANTEN",98,111,146,257
https://kawalpemilu.org#52413,"KUTABUMI, PASAR KEMIS, TANGERANG, BANTEN",99,101,132,233
https://kawalpemilu.org#52413,"KUTABUMI, PASAR KEMIS, TANGERANG, BANTEN",100,136,118,254
https://kawalpemilu.org#52413,"KUTABUMI, PASAR KEMIS, TANGERANG, BANTEN",101,75,150,225
https://kawalpemilu.org#52413,"KUTABUMI, PASAR KEMIS, TANGERANG, BANTEN",102,60,159,219
https://kawalpemilu.org#52413,"KUTABUMI, PASAR KEMIS, TANGERANG, BANTEN",103,109,140,249
https://kawalpemilu.org#52413,"KUTABUMI, PASAR KEMIS, TANGERANG, BANTEN",104,118,134,252
https://kawalpemilu.org#52413,"KUTABUMI, PASAR KEMIS, TANGERANG, BANTEN",105,91,110,201
https://kawalpemilu.org#52413,"KUTABUMI, PASAR KEMIS, TANGERANG, BANTEN",106,92,88,180
https://kawalpemilu.org#52413,"KUTABUMI, PASAR KEMIS, TANGERANG, BANTEN",107,94,117,211
https://kawalpemilu.org#52413,"KUTABUMI, PASAR KEMIS, TANGERANG, BANTEN",108,77,140,217
https://kawalpemilu.org#52413,"KUTABUMI, PASAR KEMIS, TANGERANG, BANTEN",109,87,135,222
https://kawalpemilu.org#52413,"KUTABUMI, PASAR KEMIS, TANGERANG, BANTEN",110,98,125,223
https://kawalpemilu.org#52413,"KUTABUMI, PASAR KEMIS, TANGERANG, BANTEN",111,95,129,224
https://kawalpemilu.org#52413,"KUTABUMI, PASAR KEMIS, TANGERANG, BANTEN",112,116,158,274
https://kawalpemilu.org#52413,"KUTABUMI, PASAR KEMIS, TANGERANG, BANTEN",113,73,73,146
https://kawalpemilu.org#52413,"KUTABUMI, PASAR KEMIS, TANGERANG, BANTEN",114,105,126,231
https://kawalpemilu.org#52413,"KUTABUMI, PASAR KEMIS, TANGERANG, BANTEN",115,95,82,177
https://kawalpemilu.org#52413,"KUTABUMI, PASAR KEMIS, TANGERANG, BANTEN",116,63,67,130
https://kawalpemilu.org#52413,"KUTABUMI, PASAR KEMIS, TANGERANG, BANTEN",117,71,110,181
https://kawalpemilu.org#52413,"KUTABUMI, PASAR KEMIS, TANGERANG, BANTEN",118,81,122,203
https://kawalpemilu.org#52413,"KUTABUMI, PASAR KEMIS, TANGERANG, BANTEN",119,58,121,179
https://kawalpemilu.org#52413,"KUTABUMI, PASAR KEMIS, TANGERANG, BANTEN",120,52,106,158
https://kawalpemilu.org#52414,"KUTA JAYA, PASAR KEMIS, TANGERANG, BANTEN",1,43,141,184
https://kawalpemilu.org#52414,"KUTA JAYA, PASAR KEMIS, TANGERANG, BANTEN",2,46,114,160
https://kawalpemilu.org#52414,"KUTA JAYA, PASAR KEMIS, TANGERANG, BANTEN",3,48,119,167
https://kawalpemilu.org#52414,"KUTA JAYA, PASAR KEMIS, TANGERANG, BANTEN",4,40,135,175
https://kawalpemilu.org#52414,"KUTA JAYA, PASAR KEMIS, TANGERANG, BANTEN",5,86,161,247
https://kawalpemilu.org#52414,"KUTA JAYA, PASAR KEMIS, TANGERANG, BANTEN",6,68,158,226
https://kawalpemilu.org#52414,"KUTA JAYA, PASAR KEMIS, TANGERANG, BANTEN",7,34,120,154
https://kawalpemilu.org#52414,"KUTA JAYA, PASAR KEMIS, TANGERANG, BANTEN",8,52,136,188
https://kawalpemilu.org#52414,"KUTA JAYA, PASAR KEMIS, TANGERANG, BANTEN",9,38,125,163
https://kawalpemilu.org#52414,"KUTA JAYA, PASAR KEMIS, TANGERANG, BANTEN",10,38,139,177
https://kawalpemilu.org#52414,"KUTA JAYA, PASAR KEMIS, TANGERANG, BANTEN",11,70,126,196
https://kawalpemilu.org#52414,"KUTA JAYA, PASAR KEMIS, TANGERANG, BANTEN",12,44,136,180
https://kawalpemilu.org#52414,"KUTA JAYA, PASAR KEMIS, TANGERANG, BANTEN",14,47,132,179
https://kawalpemilu.org#52414,"KUTA JAYA, PASAR KEMIS, TANGERANG, BANTEN",15,65,94,159
https://kawalpemilu.org#52414,"KUTA JAYA, PASAR KEMIS, TANGERANG, BANTEN",16,72,106,178
https://kawalpemilu.org#52414,"KUTA JAYA, PASAR KEMIS, TANGERANG, BANTEN",17,75,84,159
https://kawalpemilu.org#52414,"KUTA JAYA, PASAR KEMIS, TANGERANG, BANTEN",18,91,72,163
https://kawalpemilu.org#52414,"KUTA JAYA, PASAR KEMIS, TANGERANG, BANTEN",19,167,147,314
https://kawalpemilu.org#52414,"KUTA JAYA, PASAR KEMIS, TANGERANG, BANTEN",21,66,67,133
https://kawalpemilu.org#52414,"KUTA JAYA, PASAR KEMIS, TANGERANG, BANTEN",22,135,73,208
https://kawalpemilu.org#52414,"KUTA JAYA, PASAR KEMIS, TANGERANG, BANTEN",23,83,99,182
https://kawalpemilu.org#52414,"KUTA JAYA, PASAR KEMIS, TANGERANG, BANTEN",24,117,83,200
https://kawalpemilu.org#52414,"KUTA JAYA, PASAR KEMIS, TANGERANG, BANTEN",25,100,118,218
https://kawalpemilu.org#52414,"KUTA JAYA, PASAR KEMIS, TANGERANG, BANTEN",26,80,118,198
https://kawalpemilu.org#52414,"KUTA JAYA, PASAR KEMIS, TANGERANG, BANTEN",27,81,85,166
https://kawalpemilu.org#52414,"KUTA JAYA, PASAR KEMIS, TANGERANG, BANTEN",28,114,93,207
https://kawalpemilu.org#52414,"KUTA JAYA, PASAR KEMIS, TANGERANG, BANTEN",29,132,102,234
https://kawalpemilu.org#52414,"KUTA JAYA, PASAR KEMIS, TANGERANG, BANTEN",30,154,104,258
https://kawalpemilu.org#52414,"KUTA JAYA, PASAR KEMIS, TANGERANG, BANTEN",31,118,104,222
https://kawalpemilu.org#52414,"KUTA JAYA, PASAR KEMIS, TANGERANG, BANTEN",32,124,76,200
https://kawalpemilu.org#52414,"KUTA JAYA, PASAR KEMIS, TANGERANG, BANTEN",33,115,131,246
https://kawalpemilu.org#52414,"KUTA JAYA, PASAR KEMIS, TANGERANG, BANTEN",34,129,98,227
https://kawalpemilu.org#52414,"KUTA JAYA, PASAR KEMIS, TANGERANG, BANTEN",35,82,84,166
https://kawalpemilu.org#52414,"KUTA JAYA, PASAR KEMIS, TANGERANG, BANTEN",36,75,121,196
https://kawalpemilu.org#52414,"KUTA JAYA, PASAR KEMIS, TANGERANG, BANTEN",37,76,111,187
https://kawalpemilu.org#52414,"KUTA JAYA, PASAR KEMIS, TANGERANG, BANTEN",38,45,63,108
https://kawalpemilu.org#52414,"KUTA JAYA, PASAR KEMIS, TANGERANG, BANTEN",39,62,86,148
https://kawalpemilu.org#52414,"KUTA JAYA, PASAR KEMIS, TANGERANG, BANTEN",40,50,58,108
https://kawalpemilu.org#52414,"KUTA JAYA, PASAR KEMIS, TANGERANG, BANTEN",41,114,80,194
https://kawalpemilu.org#52414,"KUTA JAYA, PASAR KEMIS, TANGERANG, BANTEN",42,73,99,172
https://kawalpemilu.org#52414,"KUTA JAYA, PASAR KEMIS, TANGERANG, BANTEN",43,84,66,150
https://kawalpemilu.org#52414,"KUTA JAYA, PASAR KEMIS, TANGERANG, BANTEN",44,87,83,170
https://kawalpemilu.org#52414,"KUTA JAYA, PASAR KEMIS, TANGERANG, BANTEN",45,117,77,194
https://kawalpemilu.org#52414,"KUTA JAYA, PASAR KEMIS, TANGERANG, BANTEN",46,109,97,206
https://kawalpemilu.org#52414,"KUTA JAYA, PASAR KEMIS, TANGERANG, BANTEN",47,138,95,233
https://kawalpemilu.org#52414,"KUTA JAYA, PASAR KEMIS, TANGERANG, BANTEN",48,86,100,186
https://kawalpemilu.org#52414,"KUTA JAYA, PASAR KEMIS, TANGERANG, BANTEN",49,125,120,245
https://kawalpemilu.org#52414,"KUTA JAYA, PASAR KEMIS, TANGERANG, BANTEN",50,97,100,197
https://kawalpemilu.org#52414,"KUTA JAYA, PASAR KEMIS, TANGERANG, BANTEN",51,77,97,174
https://kawalpemilu.org#52414,"KUTA JAYA, PASAR KEMIS, TANGERANG, BANTEN",52,76,104,180
https://kawalpemilu.org#52414,"KUTA JAYA, PASAR KEMIS, TANGERANG, BANTEN",53,56,164,220
https://kawalpemilu.org#52414,"KUTA JAYA, PASAR KEMIS, TANGERANG, BANTEN",54,112,116,228
https://kawalpemilu.org#52414,"KUTA JAYA, PASAR KEMIS, TANGERANG, BANTEN",55,97,80,177
https://kawalpemilu.org#52414,"KUTA JAYA, PASAR KEMIS, TANGERANG, BANTEN",56,125,86,211
https://kawalpemilu.org#52414,"KUTA JAYA, PASAR KEMIS, TANGERANG, BANTEN",57,93,124,217
https://kawalpemilu.org#52414,"KUTA JAYA, PASAR KEMIS, TANGERANG, BANTEN",58,112,129,241
https://kawalpemilu.org#52414,"KUTA JAYA, PASAR KEMIS, TANGERANG, BANTEN",59,69,137,206
https://kawalpemilu.org#52414,"KUTA JAYA, PASAR KEMIS, TANGERANG, BANTEN",60,75,74,149
https://kawalpemilu.org#52414,"KUTA JAYA, PASAR KEMIS, TANGERANG, BANTEN",61,62,121,183
https://kawalpemilu.org#52414,"KUTA JAYA, PASAR KEMIS, TANGERANG, BANTEN",62,73,98,171
https://kawalpemilu.org#52414,"KUTA JAYA, PASAR KEMIS, TANGERANG, BANTEN",63,61,110,171
https://kawalpemilu.org#52414,"KUTA JAYA, PASAR KEMIS, TANGERANG, BANTEN",64,127,74,201
https://kawalpemilu.org#52414,"KUTA JAYA, PASAR KEMIS, TANGERANG, BANTEN",65,135,71,206
https://kawalpemilu.org#52414,"KUTA JAYA, PASAR KEMIS, TANGERANG, BANTEN",66,103,105,208
https://kawalpemilu.org#52414,"KUTA JAYA, PASAR KEMIS, TANGERANG, BANTEN",68,71,83,154
https://kawalpemilu.org#52414,"KUTA JAYA, PASAR KEMIS, TANGERANG, BANTEN",69,127,108,235
https://kawalpemilu.org#52414,"KUTA JAYA, PASAR KEMIS, TANGERANG, BANTEN",70,71,137,208
https://kawalpemilu.org#52414,"KUTA JAYA, PASAR KEMIS, TANGERANG, BANTEN",71,79,99,178
https://kawalpemilu.org#52414,"KUTA JAYA, PASAR KEMIS, TANGERANG, BANTEN",72,137,91,228
https://kawalpemilu.org#52414,"KUTA JAYA, PASAR KEMIS, TANGERANG, BANTEN",73,119,124,243
https://kawalpemilu.org#52414,"KUTA JAYA, PASAR KEMIS, TANGERANG, BANTEN",74,101,115,116
https://kawalpemilu.org#52414,"KUTA JAYA, PASAR KEMIS, TANGERANG, BANTEN",75,112,99,211
https://kawalpemilu.org#52414,"KUTA JAYA, PASAR KEMIS, TANGERANG, BANTEN",76,99,104,203
https://kawalpemilu.org#52414,"KUTA JAYA, PASAR KEMIS, TANGERANG, BANTEN",77,116,84,200
https://kawalpemilu.org#52414,"KUTA JAYA, PASAR KEMIS, TANGERANG, BANTEN",78,105,162,267
https://kawalpemilu.org#52414,"KUTA JAYA, PASAR KEMIS, TANGERANG, BANTEN",79,92,135,227
https://kawalpemilu.org#52414,"KUTA JAYA, PASAR KEMIS, TANGERANG, BANTEN",80,114,176,290
https://kawalpemilu.org#52414,"KUTA JAYA, PASAR KEMIS, TANGERANG, BANTEN",81,78,118,196
https://kawalpemilu.org#52414,"KUTA JAYA, PASAR KEMIS, TANGERANG, BANTEN",82,92,109,201
https://kawalpemilu.org#52414,"KUTA JAYA, PASAR KEMIS, TANGERANG, BANTEN",83,100,92,192
https://kawalpemilu.org#52414,"KUTA JAYA, PASAR KEMIS, TANGERANG, BANTEN",84,87,103,190
https://kawalpemilu.org#52414,"KUTA JAYA, PASAR KEMIS, TANGERANG, BANTEN",85,118,128,246
https://kawalpemilu.org#52414,"KUTA JAYA, PASAR KEMIS, TANGERANG, BANTEN",86,134,97,231
https://kawalpemilu.org#52414,"KUTA JAYA, PASAR KEMIS, TANGERANG, BANTEN",87,96,106,202
https://kawalpemilu.org#52414,"KUTA JAYA, PASAR KEMIS, TANGERANG, BANTEN",88,110,137,247
https://kawalpemilu.org#52414,"KUTA JAYA, PASAR KEMIS, TANGERANG, BANTEN",89,67,144,211
https://kawalpemilu.org#52415,"KUTA BARU, PASAR KEMIS, TANGERANG, BANTEN",1,62,116,178
https://kawalpemilu.org#52415,"KUTA BARU, PASAR KEMIS, TANGERANG, BANTEN",2,86,157,243
https://kawalpemilu.org#52415,"KUTA BARU, PASAR KEMIS, TANGERANG, BANTEN",3,123,125,248
https://kawalpemilu.org#52415,"KUTA BARU, PASAR KEMIS, TANGERANG, BANTEN",4,143,113,256
https://kawalpemilu.org#52415,"KUTA BARU, PASAR KEMIS, TANGERANG, BANTEN",5,102,128,230
https://kawalpemilu.org#52415,"KUTA BARU, PASAR KEMIS, TANGERANG, BANTEN",6,113,115,228
https://kawalpemilu.org#52415,"KUTA BARU, PASAR KEMIS, TANGERANG, BANTEN",7,66,117,183
https://kawalpemilu.org#52415,"KUTA BARU, PASAR KEMIS, TANGERANG, BANTEN",8,65,112,177
https://kawalpemilu.org#52415,"KUTA BARU, PASAR KEMIS, TANGERANG, BANTEN",9,56,102,158
https://kawalpemilu.org#52415,"KUTA BARU, PASAR KEMIS, TANGERANG, BANTEN",10,89,143,232
https://kawalpemilu.org#52415,"KUTA BARU, PASAR KEMIS, TANGERANG, BANTEN",11,104,96,200
https://kawalpemilu.org#52415,"KUTA BARU, PASAR KEMIS, TANGERANG, BANTEN",13,77,139,216
https://kawalpemilu.org#52415,"KUTA BARU, PASAR KEMIS, TANGERANG, BANTEN",14,106,118,224
https://kawalpemilu.org#52415,"KUTA BARU, PASAR KEMIS, TANGERANG, BANTEN",15,100,120,220
https://kawalpemilu.org#52415,"KUTA BARU, PASAR KEMIS, TANGERANG, BANTEN",16,110,137,147
https://kawalpemilu.org#52415,"KUTA BARU, PASAR KEMIS, TANGERANG, BANTEN",19,86,125,211
https://kawalpemilu.org#52415,"KUTA BARU, PASAR KEMIS, TANGERANG, BANTEN",21,107,137,244
https://kawalpemilu.org#52415,"KUTA BARU, PASAR KEMIS, TANGERANG, BANTEN",22,153,87,240
https://kawalpemilu.org#52415,"KUTA BARU, PASAR KEMIS, TANGERANG, BANTEN",23,125,96,221
https://kawalpemilu.org#52415,"KUTA BARU, PASAR KEMIS, TANGERANG, BANTEN",24,92,152,244
https://kawalpemilu.org#52415,"KUTA BARU, PASAR KEMIS, TANGERANG, BANTEN",26,64,98,162
https://kawalpemilu.org#52415,"KUTA BARU, PASAR KEMIS, TANGERANG, BANTEN",30,87,136,223
https://kawalpemilu.org#52415,"KUTA BARU, PASAR KEMIS, TANGERANG, BANTEN",31,103,94,197
https://kawalpemilu.org#52415,"KUTA BARU, PASAR KEMIS, TANGERANG, BANTEN",32,101,96,197
https://kawalpemilu.org#52415,"KUTA BARU, PASAR KEMIS, TANGERANG, BANTEN",33,97,106,203
https://kawalpemilu.org#52415,"KUTA BARU, PASAR KEMIS, TANGERANG, BANTEN",34,111,119,230
https://kawalpemilu.org#52415,"KUTA BARU, PASAR KEMIS, TANGERANG, BANTEN",35,115,85,200
https://kawalpemilu.org#52415,"KUTA BARU, PASAR KEMIS, TANGERANG, BANTEN",36,163,88,251
https://kawalpemilu.org#52415,"KUTA BARU, PASAR KEMIS, TANGERANG, BANTEN",37,125,124,249
https://kawalpemilu.org#52415,"KUTA BARU, PASAR KEMIS, TANGERANG, BANTEN",38,149,82,231
https://kawalpemilu.org#52415,"KUTA BARU, PASAR KEMIS, TANGERANG, BANTEN",39,98,71,169
https://kawalpemilu.org#52415,"KUTA BARU, PASAR KEMIS, TANGERANG, BANTEN",40,108,63,171
https://kawalpemilu.org#52415,"KUTA BARU, PASAR KEMIS, TANGERANG, BANTEN",41,156,85,241
https://kawalpemilu.org#52415,"KUTA BARU, PASAR KEMIS, TANGERANG, BANTEN",42,111,127,238
https://kawalpemilu.org#52415,"KUTA BARU, PASAR KEMIS, TANGERANG, BANTEN",43,40,75,115
https://kawalpemilu.org#52415,"KUTA BARU, PASAR KEMIS, TANGERANG, BANTEN",44,116,90,206
https://kawalpemilu.org#52415,"KUTA BARU, PASAR KEMIS, TANGERANG, BANTEN",45,98,45,143
https://kawalpemilu.org#52415,"KUTA BARU, PASAR KEMIS, TANGERANG, BANTEN",46,126,44,170
https://kawalpemilu.org#52415,"KUTA BARU, PASAR KEMIS, TANGERANG, BANTEN",47,113,37,150
https://kawalpemilu.org#52415,"KUTA BARU, PASAR KEMIS, TANGERANG, BANTEN",48,56,65,121
https://kawalpemilu.org#52415,"KUTA BARU, PASAR KEMIS, TANGERANG, BANTEN",49,99,110,209
https://kawalpemilu.org#52415,"KUTA BARU, PASAR KEMIS, TANGERANG, BANTEN",50,89,124,213
https://kawalpemilu.org#52415,"KUTA BARU, PASAR KEMIS, TANGERANG, BANTEN",51,93,83,176
https://kawalpemilu.org#52415,"KUTA BARU, PASAR KEMIS, TANGERANG, BANTEN",52,106,76,182
https://kawalpemilu.org#52415,"KUTA BARU, PASAR KEMIS, TANGERANG, BANTEN",53,77,96,173
https://kawalpemilu.org#52415,"KUTA BARU, PASAR KEMIS, TANGERANG, BANTEN",54,144,103,247
https://kawalpemilu.org#52415,"KUTA BARU, PASAR KEMIS, TANGERANG, BANTEN",55,91,63,154
https://kawalpemilu.org#52415,"KUTA BARU, PASAR KEMIS, TANGERANG, BANTEN",59,94,141,235
https://kawalpemilu.org#52415,"KUTA BARU, PASAR KEMIS, TANGERANG, BANTEN",60,165,81,246
https://kawalpemilu.org#52415,"KUTA BARU, PASAR KEMIS, TANGERANG, BANTEN",61,134,110,244
https://kawalpemilu.org#52415,"KUTA BARU, PASAR KEMIS, TANGERANG, BANTEN",62,128,98,226
https://kawalpemilu.org#52415,"KUTA BARU, PASAR KEMIS, TANGERANG, BANTEN",63,112,80,192
https://kawalpemilu.org#52415,"KUTA BARU, PASAR KEMIS, TANGERANG, BANTEN",64,96,83,179
https://kawalpemilu.org#52415,"KUTA BARU, PASAR KEMIS, TANGERANG, BANTEN",65,138,81,219
https://kawalpemilu.org#52415,"KUTA BARU, PASAR KEMIS, TANGERANG, BANTEN",66,176,78,254
https://kawalpemilu.org#52415,"KUTA BARU, PASAR KEMIS, TANGERANG, BANTEN",67,119,99,218
https://kawalpemilu.org#52415,"KUTA BARU, PASAR KEMIS, TANGERANG, BANTEN",68,125,98,223
https://kawalpemilu.org#52415,"KUTA BARU, PASAR KEMIS, TANGERANG, BANTEN",69,107,131,238
https://kawalpemilu.org#52415,"KUTA BARU, PASAR KEMIS, TANGERANG, BANTEN",70,86,152,238
https://kawalpemilu.org#52415,"KUTA BARU, PASAR KEMIS, TANGERANG, BANTEN",71,107,123,230
https://kawalpemilu.org#52415,"KUTA BARU, PASAR KEMIS, TANGERANG, BANTEN",72,82,141,223
https://kawalpemilu.org#52415,"KUTA BARU, PASAR KEMIS, TANGERANG, BANTEN",73,114,104,218
https://kawalpemilu.org#52415,"KUTA BARU, PASAR KEMIS, TANGERANG, BANTEN",74,128,116,244
https://kawalpemilu.org#52415,"KUTA BARU, PASAR KEMIS, TANGERANG, BANTEN",75,149,76,225
https://kawalpemilu.org#52415,"KUTA BARU, PASAR KEMIS, TANGERANG, BANTEN",77,122,70,192
https://kawalpemilu.org#52415,"KUTA BARU, PASAR KEMIS, TANGERANG, BANTEN",78,134,79,213
https://kawalpemilu.org#52415,"KUTA BARU, PASAR KEMIS, TANGERANG, BANTEN",79,134,104,238
https://kawalpemilu.org#52415,"KUTA BARU, PASAR KEMIS, TANGERANG, BANTEN",81,130,102,232
https://kawalpemilu.org#52415,"KUTA BARU, PASAR KEMIS, TANGERANG, BANTEN",82,123,110,233
https://kawalpemilu.org#52415,"KUTA BARU, PASAR KEMIS, TANGERANG, BANTEN",83,101,141,242
https://kawalpemilu.org#52415,"KUTA BARU, PASAR KEMIS, TANGERANG, BANTEN",84,95,119,214
https://kawalpemilu.org#52415,"KUTA BARU, PASAR KEMIS, TANGERANG, BANTEN",85,120,123,243
https://kawalpemilu.org#52415,"KUTA BARU, PASAR KEMIS, TANGERANG, BANTEN",86,120,111,231
https://kawalpemilu.org#52416,"PASAR KEMIS, PASAR KEMIS, TANGERANG, BANTEN",1,56,139,195
https://kawalpemilu.org#52416,"PASAR KEMIS, PASAR KEMIS, TANGERANG, BANTEN",2,46,101,147
https://kawalpemilu.org#52416,"PASAR KEMIS, PASAR KEMIS, TANGERANG, BANTEN",3,81,149,230
https://kawalpemilu.org#52416,"PASAR KEMIS, PASAR KEMIS, TANGERANG, BANTEN",4,101,170,271
https://kawalpemilu.org#52416,"PASAR KEMIS, PASAR KEMIS, TANGERANG, BANTEN",5,85,116,201
https://kawalpemilu.org#52416,"PASAR KEMIS, PASAR KEMIS, TANGERANG, BANTEN",6,110,76,186
https://kawalpemilu.org#52416,"PASAR KEMIS, PASAR KEMIS, TANGERANG, BANTEN",7,131,77,208
https://kawalpemilu.org#52416,"PASAR KEMIS, PASAR KEMIS, TANGERANG, BANTEN",8,152,72,224
https://kawalpemilu.org#52416,"PASAR KEMIS, PASAR KEMIS, TANGERANG, BANTEN",9,103,74,177
https://kawalpemilu.org#52416,"PASAR KEMIS, PASAR KEMIS, TANGERANG, BANTEN",10,88,77,165
https://kawalpemilu.org#52416,"PASAR KEMIS, PASAR KEMIS, TANGERANG, BANTEN",11,100,61,161
https://kawalpemilu.org#52416,"PASAR KEMIS, PASAR KEMIS, TANGERANG, BANTEN",12,117,71,188
https://kawalpemilu.org#52416,"PASAR KEMIS, PASAR KEMIS, TANGERANG, BANTEN",13,107,111,218
https://kawalpemilu.org#52416,"PASAR KEMIS, PASAR KEMIS, TANGERANG, BANTEN",14,148,114,262
https://kawalpemilu.org#52416,"PASAR KEMIS, PASAR KEMIS, TANGERANG, BANTEN",15,88,171,259
https://kawalpemilu.org#52416,"PASAR KEMIS, PASAR KEMIS, TANGERANG, BANTEN",16,81,177,258
https://kawalpemilu.org#52416,"PASAR KEMIS, PASAR KEMIS, TANGERANG, BANTEN",17,67,106,173
https://kawalpemilu.org#52416,"PASAR KEMIS, PASAR KEMIS, TANGERANG, BANTEN",18,65,98,163
https://kawalpemilu.org#52416,"PASAR KEMIS, PASAR KEMIS, TANGERANG, BANTEN",19,38,86,124
https://kawalpemilu.org#52416,"PASAR KEMIS, PASAR KEMIS, TANGERANG, BANTEN",20,39,89,128
https://kawalpemilu.org#52416,"PASAR KEMIS, PASAR KEMIS, TANGERANG, BANTEN",21,41,60,101
https://kawalpemilu.org#52416,"PASAR KEMIS, PASAR KEMIS, TANGERANG, BANTEN",22,54,94,148
https://kawalpemilu.org#52416,"PASAR KEMIS, PASAR KEMIS, TANGERANG, BANTEN",23,63,124,187
https://kawalpemilu.org#52416,"PASAR KEMIS, PASAR KEMIS, TANGERANG, BANTEN",24,75,140,215
https://kawalpemilu.org#52416,"PASAR KEMIS, PASAR KEMIS, TANGERANG, BANTEN",25,55,95,150
https://kawalpemilu.org#52416,"PASAR KEMIS, PASAR KEMIS, TANGERANG, BANTEN",26,56,100,156
https://kawalpemilu.org#52416,"PASAR KEMIS, PASAR KEMIS, TANGERANG, BANTEN",27,55,93,148
https://kawalpemilu.org#52416,"PASAR KEMIS, PASAR KEMIS, TANGERANG, BANTEN",28,68,144,212
https://kawalpemilu.org#52416,"PASAR KEMIS, PASAR KEMIS, TANGERANG, BANTEN",29,77,147,224
https://kawalpemilu.org#52416,"PASAR KEMIS, PASAR KEMIS, TANGERANG, BANTEN",30,73,115,188
https://kawalpemilu.org#52416,"PASAR KEMIS, PASAR KEMIS, TANGERANG, BANTEN",31,53,137,190
https://kawalpemilu.org#52416,"PASAR KEMIS, PASAR KEMIS, TANGERANG, BANTEN",32,0,0,0
https://kawalpemilu.org#52416,"PASAR KEMIS, PASAR KEMIS, TANGERANG, BANTEN",33,53,176,229
https://kawalpemilu.org#52416,"PASAR KEMIS, PASAR KEMIS, TANGERANG, BANTEN",34,54,167,221
https://kawalpemilu.org#52416,"PASAR KEMIS, PASAR KEMIS, TANGERANG, BANTEN",35,40,103,143
https://kawalpemilu.org#52416,"PASAR KEMIS, PASAR KEMIS, TANGERANG, BANTEN",36,33,123,156
https://kawalpemilu.org#52416,"PASAR KEMIS, PASAR KEMIS, TANGERANG, BANTEN",37,50,128,178
https://kawalpemilu.org#52416,"PASAR KEMIS, PASAR KEMIS, TANGERANG, BANTEN",38,69,127,196
https://kawalpemilu.org#52416,"PASAR KEMIS, PASAR KEMIS, TANGERANG, BANTEN",39,36,126,162
https://kawalpemilu.org#52416,"PASAR KEMIS, PASAR KEMIS, TANGERANG, BANTEN",40,28,106,134
https://kawalpemilu.org#52416,"PASAR KEMIS, PASAR KEMIS, TANGERANG, BANTEN",41,43,111,154
https://kawalpemilu.org#52416,"PASAR KEMIS, PASAR KEMIS, TANGERANG, BANTEN",42,51,88,139
https://kawalpemilu.org#52416,"PASAR KEMIS, PASAR KEMIS, TANGERANG, BANTEN",43,55,93,148
https://kawalpemilu.org#52416,"PASAR KEMIS, PASAR KEMIS, TANGERANG, BANTEN",44,41,58,99
https://kawalpemilu.org#52416,"PASAR KEMIS, PASAR KEMIS, TANGERANG, BANTEN",45,58,79,137
https://kawalpemilu.org#52416,"PASAR KEMIS, PASAR KEMIS, TANGERANG, BANTEN",46,37,136,173
https://kawalpemilu.org#52416,"PASAR KEMIS, PASAR KEMIS, TANGERANG, BANTEN",47,52,156,208
https://kawalpemilu.org#52416,"PASAR KEMIS, PASAR KEMIS, TANGERANG, BANTEN",48,89,98,187
https://kawalpemilu.org#52416,"PASAR KEMIS, PASAR KEMIS, TANGERANG, BANTEN",49,84,142,226
https://kawalpemilu.org#52416,"PASAR KEMIS, PASAR KEMIS, TANGERANG, BANTEN",50,93,84,177
https://kawalpemilu.org#52416,"PASAR KEMIS, PASAR KEMIS, TANGERANG, BANTEN",51,110,107,217
https://kawalpemilu.org#52416,"PASAR KEMIS, PASAR KEMIS, TANGERANG, BANTEN",52,119,110,229
https://kawalpemilu.org#52416,"PASAR KEMIS, PASAR KEMIS, TANGERANG, BANTEN",53,133,72,205
https://kawalpemilu.org#52416,"PASAR KEMIS, PASAR KEMIS, TANGERANG, BANTEN",54,65,120,185
https://kawalpemilu.org#52416,"PASAR KEMIS, PASAR KEMIS, TANGERANG, BANTEN",55,70,118,188
https://kawalpemilu.org#52416,"PASAR KEMIS, PASAR KEMIS, TANGERANG, BANTEN",56,53,98,151
https://kawalpemilu.org#52416,"PASAR KEMIS, PASAR KEMIS, TANGERANG, BANTEN",57,60,93,153
https://kawalpemilu.org#52416,"PASAR KEMIS, PASAR KEMIS, TANGERANG, BANTEN",58,99,94,193
https://kawalpemilu.org#52416,"PASAR KEMIS, PASAR KEMIS, TANGERANG, BANTEN",59,90,107,197
https://kawalpemilu.org#52417,"SUKAMANTRI, PASAR KEMIS, TANGERANG, BANTEN",1,43,157,200
https://kawalpemilu.org#52417,"SUKAMANTRI, PASAR KEMIS, TANGERANG, BANTEN",2,54,152,206
https://kawalpemilu.org#52417,"SUKAMANTRI, PASAR KEMIS, TANGERANG, BANTEN",3,41,165,206
https://kawalpemilu.org#52417,"SUKAMANTRI, PASAR KEMIS, TANGERANG, BANTEN",4,41,140,181
https://kawalpemilu.org#52417,"SUKAMANTRI, PASAR KEMIS, TANGERANG, BANTEN",6,92,67,159
https://kawalpemilu.org#52417,"SUKAMANTRI, PASAR KEMIS, TANGERANG, BANTEN",7,60,104,164
https://kawalpemilu.org#52417,"SUKAMANTRI, PASAR KEMIS, TANGERANG, BANTEN",8,66,58,124
https://kawalpemilu.org#52417,"SUKAMANTRI, PASAR KEMIS, TANGERANG, BANTEN",9,82,65,147
https://kawalpemilu.org#52417,"SUKAMANTRI, PASAR KEMIS, TANGERANG, BANTEN",10,101,92,193
https://kawalpemilu.org#52417,"SUKAMANTRI, PASAR KEMIS, TANGERANG, BANTEN",12,124,98,222
https://kawalpemilu.org#52417,"SUKAMANTRI, PASAR KEMIS, TANGERANG, BANTEN",13,121,80,201
https://kawalpemilu.org#52417,"SUKAMANTRI, PASAR KEMIS, TANGERANG, BANTEN",14,139,109,248
https://kawalpemilu.org#52417,"SUKAMANTRI, PASAR KEMIS, TANGERANG, BANTEN",15,145,116,261
https://kawalpemilu.org#52417,"SUKAMANTRI, PASAR KEMIS, TANGERANG, BANTEN",16,151,111,262
https://kawalpemilu.org#52417,"SUKAMANTRI, PASAR KEMIS, TANGERANG, BANTEN",17,124,114,238
https://kawalpemilu.org#52417,"SUKAMANTRI, PASAR KEMIS, TANGERANG, BANTEN",18,101,102,203
https://kawalpemilu.org#52417,"SUKAMANTRI, PASAR KEMIS, TANGERANG, BANTEN",19,123,85,209
https://kawalpemilu.org#52417,"SUKAMANTRI, PASAR KEMIS, TANGERANG, BANTEN",20,97,101,198
https://kawalpemilu.org#52417,"SUKAMANTRI, PASAR KEMIS, TANGERANG, BANTEN",21,78,94,172
https://kawalpemilu.org#52417,"SUKAMANTRI, PASAR KEMIS, TANGERANG, BANTEN",22,109,97,206
https://kawalpemilu.org#52417,"SUKAMANTRI, PASAR KEMIS, TANGERANG, BANTEN",24,130,86,216
https://kawalpemilu.org#52417,"SUKAMANTRI, PASAR KEMIS, TANGERANG, BANTEN",25,93,96,189
https://kawalpemilu.org#52417,"SUKAMANTRI, PASAR KEMIS, TANGERANG, BANTEN",26,82,94,176
https://kawalpemilu.org#52417,"SUKAMANTRI, PASAR KEMIS, TANGERANG, BANTEN",27,107,74,181
https://kawalpemilu.org#52417,"SUKAMANTRI, PASAR KEMIS, TANGERANG, BANTEN",28,107,88,195
https://kawalpemilu.org#52417,"SUKAMANTRI, PASAR KEMIS, TANGERANG, BANTEN",29,88,88,176
https://kawalpemilu.org#52417,"SUKAMANTRI, PASAR KEMIS, TANGERANG, BANTEN",30,101,106,207
https://kawalpemilu.org#52417,"SUKAMANTRI, PASAR KEMIS, TANGERANG, BANTEN",31,103,164,267
https://kawalpemilu.org#52417,"SUKAMANTRI, PASAR KEMIS, TANGERANG, BANTEN",32,126,128,254
https://kawalpemilu.org#52417,"SUKAMANTRI, PASAR KEMIS, TANGERANG, BANTEN",33,120,103,223
https://kawalpemilu.org#52417,"SUKAMANTRI, PASAR KEMIS, TANGERANG, BANTEN",34,144,129,273
https://kawalpemilu.org#52417,"SUKAMANTRI, PASAR KEMIS, TANGERANG, BANTEN",35,95,107,202
https://kawalpemilu.org#52417,"SUKAMANTRI, PASAR KEMIS, TANGERANG, BANTEN",36,87,146,233
https://kawalpemilu.org#52417,"SUKAMANTRI, PASAR KEMIS, TANGERANG, BANTEN",37,110,115,225
https://kawalpemilu.org#52417,"SUKAMANTRI, PASAR KEMIS, TANGERANG, BANTEN",38,0,0,0
https://kawalpemilu.org#52417,"SUKAMANTRI, PASAR KEMIS, TANGERANG, BANTEN",39,43,143,186
https://kawalpemilu.org#52417,"SUKAMANTRI, PASAR KEMIS, TANGERANG, BANTEN",42,61,154,215
https://kawalpemilu.org#52417,"SUKAMANTRI, PASAR KEMIS, TANGERANG, BANTEN",43,60,138,198
https://kawalpemilu.org#52417,"SUKAMANTRI, PASAR KEMIS, TANGERANG, BANTEN",44,48,145,193
https://kawalpemilu.org#52417,"SUKAMANTRI, PASAR KEMIS, TANGERANG, BANTEN",45,50,122,172
https://kawalpemilu.org#52417,"SUKAMANTRI, PASAR KEMIS, TANGERANG, BANTEN",46,33,68,101
https://kawalpemilu.org#52417,"SUKAMANTRI, PASAR KEMIS, TANGERANG, BANTEN",47,52,215,267
https://kawalpemilu.org#52417,"SUKAMANTRI, PASAR KEMIS, TANGERANG, BANTEN",48,74,116,190
https://kawalpemilu.org#52417,"SUKAMANTRI, PASAR KEMIS, TANGERANG, BANTEN",49,49,165,214
https://kawalpemilu.org#52417,"SUKAMANTRI, PASAR KEMIS, TANGERANG, BANTEN",50,58,114,172
https://kawalpemilu.org#52417,"SUKAMANTRI, PASAR KEMIS, TANGERANG, BANTEN",51,55,122,177
https://kawalpemilu.org#52417,"SUKAMANTRI, PASAR KEMIS, TANGERANG, BANTEN",52,80,138,218
https://kawalpemilu.org#52417,"SUKAMANTRI, PASAR KEMIS, TANGERANG, BANTEN",53,74,152,226
https://kawalpemilu.org#52417,"SUKAMANTRI, PASAR KEMIS, TANGERANG, BANTEN",54,56,143,199
https://kawalpemilu.org#52417,"SUKAMANTRI, PASAR KEMIS, TANGERANG, BANTEN",55,53,83,136
https://kawalpemilu.org#52417,"SUKAMANTRI, PASAR KEMIS, TANGERANG, BANTEN",56,56,98,154
https://kawalpemilu.org#52417,"SUKAMANTRI, PASAR KEMIS, TANGERANG, BANTEN",57,56,124,180
https://kawalpemilu.org#52417,"SUKAMANTRI, PASAR KEMIS, TANGERANG, BANTEN",58,81,135,216
https://kawalpemilu.org#52417,"SUKAMANTRI, PASAR KEMIS, TANGERANG, BANTEN",59,74,142,216
https://kawalpemilu.org#52417,"SUKAMANTRI, PASAR KEMIS, TANGERANG, BANTEN",60,72,117,189
https://kawalpemilu.org#52417,"SUKAMANTRI, PASAR KEMIS, TANGERANG, BANTEN",61,68,106,174
https://kawalpemilu.org#52417,"SUKAMANTRI, PASAR KEMIS, TANGERANG, BANTEN",62,49,78,127
https://kawalpemilu.org#52417,"SUKAMANTRI, PASAR KEMIS, TANGERANG, BANTEN",63,82,76,158
https://kawalpemilu.org#52417,"SUKAMANTRI, PASAR KEMIS, TANGERANG, BANTEN",64,66,63,129
https://kawalpemilu.org#52417,"SUKAMANTRI, PASAR KEMIS, TANGERANG, BANTEN",65,33,68,101
https://kawalpemilu.org#52417,"SUKAMANTRI, PASAR KEMIS, TANGERANG, BANTEN",66,74,102,176
https://kawalpemilu.org#52417,"SUKAMANTRI, PASAR KEMIS, TANGERANG, BANTEN",67,72,110,182
https://kawalpemilu.org#52417,"SUKAMANTRI, PASAR KEMIS, TANGERANG, BANTEN",68,53,140,193
https://kawalpemilu.org#52417,"SUKAMANTRI, PASAR KEMIS, TANGERANG, BANTEN",69,78,109,187
https://kawalpemilu.org#52417,"SUKAMANTRI, PASAR KEMIS, TANGERANG, BANTEN",70,68,141,209
https://kawalpemilu.org#52417,"SUKAMANTRI, PASAR KEMIS, TANGERANG, BANTEN",71,88,121,209
https://kawalpemilu.org#52417,"SUKAMANTRI, PASAR KEMIS, TANGERANG, BANTEN",72,43,95,138
https://kawalpemilu.org#52417,"SUKAMANTRI, PASAR KEMIS, TANGERANG, BANTEN",73,57,148,205
https://kawalpemilu.org#52417,"SUKAMANTRI, PASAR KEMIS, TANGERANG, BANTEN",74,66,178,244
https://kawalpemilu.org#52417,"SUKAMANTRI, PASAR KEMIS, TANGERANG, BANTEN",75,46,175,221
https://kawalpemilu.org#52417,"SUKAMANTRI, PASAR KEMIS, TANGERANG, BANTEN",76,136,155,291
https://kawalpemilu.org#52417,"SUKAMANTRI, PASAR KEMIS, TANGERANG, BANTEN",77,30,200,230
https://kawalpemilu.org#52417,"SUKAMANTRI, PASAR KEMIS, TANGERANG, BANTEN",78,55,183,238
https://kawalpemilu.org#52417,"SUKAMANTRI, PASAR KEMIS, TANGERANG, BANTEN",80,49,127,176
https://kawalpemilu.org#52417,"SUKAMANTRI, PASAR KEMIS, TANGERANG, BANTEN",81,63,123,186
https://kawalpemilu.org#52417,"SUKAMANTRI, PASAR KEMIS, TANGERANG, BANTEN",82,107,103,210
https://kawalpemilu.org#52417,"SUKAMANTRI, PASAR KEMIS, TANGERANG, BANTEN",83,87,82,169
https://kawalpemilu.org#52417,"SUKAMANTRI, PASAR KEMIS, TANGERANG, BANTEN",84,116,33,149
https://kawalpemilu.org#52417,"SUKAMANTRI, PASAR KEMIS, TANGERANG, BANTEN",85,97,69,166
https://kawalpemilu.org#52418,"PANGADEGAN, PASAR KEMIS, TANGERANG, BANTEN",1,74,137,211
https://kawalpemilu.org#52418,"PANGADEGAN, PASAR KEMIS, TANGERANG, BANTEN",2,78,131,209
https://kawalpemilu.org#52418,"PANGADEGAN, PASAR KEMIS, TANGERANG, BANTEN",3,45,100,145
https://kawalpemilu.org#52418,"PANGADEGAN, PASAR KEMIS, TANGERANG, BANTEN",4,41,122,163
https://kawalpemilu.org#52418,"PANGADEGAN, PASAR KEMIS, TANGERANG, BANTEN",5,34,107,141
https://kawalpemilu.org#52418,"PANGADEGAN, PASAR KEMIS, TANGERANG, BANTEN",6,34,146,180
https://kawalpemilu.org#52418,"PANGADEGAN, PASAR KEMIS, TANGERANG, BANTEN",7,40,116,156
https://kawalpemilu.org#52418,"PANGADEGAN, PASAR KEMIS, TANGERANG, BANTEN",8,35,104,139
https://kawalpemilu.org#52418,"PANGADEGAN, PASAR KEMIS, TANGERANG, BANTEN",9,57,132,189
https://kawalpemilu.org#52418,"PANGADEGAN, PASAR KEMIS, TANGERANG, BANTEN",10,48,133,181
https://kawalpemilu.org#52418,"PANGADEGAN, PASAR KEMIS, TANGERANG, BANTEN",11,60,125,185
https://kawalpemilu.org#52418,"PANGADEGAN, PASAR KEMIS, TANGERANG, BANTEN",12,58,152,210
https://kawalpemilu.org#52418,"PANGADEGAN, PASAR KEMIS, TANGERANG, BANTEN",13,32,164,196
https://kawalpemilu.org#52418,"PANGADEGAN, PASAR KEMIS, TANGERANG, BANTEN",14,30,168,198
https://kawalpemilu.org#52418,"PANGADEGAN, PASAR KEMIS, TANGERANG, BANTEN",15,43,148,191
https://kawalpemilu.org#52418,"PANGADEGAN, PASAR KEMIS, TANGERANG, BANTEN",16,54,83,137
https://kawalpemilu.org#52418,"PANGADEGAN, PASAR KEMIS, TANGERANG, BANTEN",17,45,100,145
https://kawalpemilu.org#52418,"PANGADEGAN, PASAR KEMIS, TANGERANG, BANTEN",18,50,59,109
https://kawalpemilu.org#52418,"PANGADEGAN, PASAR KEMIS, TANGERANG, BANTEN",19,64,96,160
https://kawalpemilu.org#52418,"PANGADEGAN, PASAR KEMIS, TANGERANG, BANTEN",20,58,114,172
https://kawalpemilu.org#52418,"PANGADEGAN, PASAR KEMIS, TANGERANG, BANTEN",21,47,93,140
https://kawalpemilu.org#52418,"PANGADEGAN, PASAR KEMIS, TANGERANG, BANTEN",22,61,80,141
https://kawalpemilu.org#52418,"PANGADEGAN, PASAR KEMIS, TANGERANG, BANTEN",23,34,124,158
https://kawalpemilu.org#52418,"PANGADEGAN, PASAR KEMIS, TANGERANG, BANTEN",24,21,94,115
https://kawalpemilu.org#52418,"PANGADEGAN, PASAR KEMIS, TANGERANG, BANTEN",25,44,65,109
https://kawalpemilu.org#52418,"PANGADEGAN, PASAR KEMIS, TANGERANG, BANTEN",26,63,89,152
https://kawalpemilu.org#52418,"PANGADEGAN, PASAR KEMIS, TANGERANG, BANTEN",27,50,91,141
https://kawalpemilu.org#52418,"PANGADEGAN, PASAR KEMIS, TANGERANG, BANTEN",28,53,80,133
https://kawalpemilu.org#52418,"PANGADEGAN, PASAR KEMIS, TANGERANG, BANTEN",29,52,163,215
https://kawalpemilu.org#52418,"PANGADEGAN, PASAR KEMIS, TANGERANG, BANTEN",30,54,184,238
https://kawalpemilu.org#52418,"PANGADEGAN, PASAR KEMIS, TANGERANG, BANTEN",31,51,121,172
https://kawalpemilu.org#52418,"PANGADEGAN, PASAR KEMIS, TANGERANG, BANTEN",32,57,116,173
https://kawalpemilu.org#52418,"PANGADEGAN, PASAR KEMIS, TANGERANG, BANTEN",33,65,107,172
https://kawalpemilu.org#52418,"PANGADEGAN, PASAR KEMIS, TANGERANG, BANTEN",34,109,118,227
https://kawalpemilu.org#52418,"PANGADEGAN, PASAR KEMIS, TANGERANG, BANTEN",37,35,131,166
https://kawalpemilu.org#52418,"PANGADEGAN, PASAR KEMIS, TANGERANG, BANTEN",38,75,90,165
https://kawalpemilu.org#52418,"PANGADEGAN, PASAR KEMIS, TANGERANG, BANTEN",39,31,129,160
https://kawalpemilu.org#52418,"PANGADEGAN, PASAR KEMIS, TANGERANG, BANTEN",40,63,136,199
https://kawalpemilu.org#52418,"PANGADEGAN, PASAR KEMIS, TANGERANG, BANTEN",41,34,125,159
https://kawalpemilu.org#52418,"PANGADEGAN, PASAR KEMIS, TANGERANG, BANTEN",42,40,164,204
https://kawalpemilu.org#52418,"PANGADEGAN, PASAR KEMIS, TANGERANG, BANTEN",43,27,165,192
https://kawalpemilu.org#52418,"PANGADEGAN, PASAR KEMIS, TANGERANG, BANTEN",44,36,106,142
https://kawalpemilu.org#52418,"PANGADEGAN, PASAR KEMIS, TANGERANG, BANTEN",45,29,129,158
https://kawalpemilu.org#52418,"PANGADEGAN, PASAR KEMIS, TANGERANG, BANTEN",46,36,93,129
https://kawalpemilu.org#52418,"PANGADEGAN, PASAR KEMIS, TANGERANG, BANTEN",47,36,79,115
https://kawalpemilu.org#52419,"GELAM JAYA, PASAR KEMIS, TANGERANG, BANTEN",1,74,136,210
https://kawalpemilu.org#52419,"GELAM JAYA, PASAR KEMIS, TANGERANG, BANTEN",2,69,154,223
https://kawalpemilu.org#52419,"GELAM JAYA, PASAR KEMIS, TANGERANG, BANTEN",3,57,145,202
https://kawalpemilu.org#52419,"GELAM JAYA, PASAR KEMIS, TANGERANG, BANTEN",4,80,147,227
https://kawalpemilu.org#52419,"GELAM JAYA, PASAR KEMIS, TANGERANG, BANTEN",5,81,152,233
https://kawalpemilu.org#52419,"GELAM JAYA, PASAR KEMIS, TANGERANG, BANTEN",6,0,0,0
https://kawalpemilu.org#52419,"GELAM JAYA, PASAR KEMIS, TANGERANG, BANTEN",7,92,132,224
https://kawalpemilu.org#52419,"GELAM JAYA, PASAR KEMIS, TANGERANG, BANTEN",8,82,119,201
https://kawalpemilu.org#52419,"GELAM JAYA, PASAR KEMIS, TANGERANG, BANTEN",9,67,117,184
https://kawalpemilu.org#52419,"GELAM JAYA, PASAR KEMIS, TANGERANG, BANTEN",10,66,137,203
https://kawalpemilu.org#52419,"GELAM JAYA, PASAR KEMIS, TANGERANG, BANTEN",11,79,127,206
https://kawalpemilu.org#52419,"GELAM JAYA, PASAR KEMIS, TANGERANG, BANTEN",12,56,102,158
https://kawalpemilu.org#52419,"GELAM JAYA, PASAR KEMIS, TANGERANG, BANTEN",13,80,128,208
https://kawalpemilu.org#52419,"GELAM JAYA, PASAR KEMIS, TANGERANG, BANTEN",14,57,169,226
https://kawalpemilu.org#52419,"GELAM JAYA, PASAR KEMIS, TANGERANG, BANTEN",15,45,127,172
https://kawalpemilu.org#52419,"GELAM JAYA, PASAR KEMIS, TANGERANG, BANTEN",16,66,136,202
https://kawalpemilu.org#52419,"GELAM JAYA, PASAR KEMIS, TANGERANG, BANTEN",17,109,148,257
https://kawalpemilu.org#52419,"GELAM JAYA, PASAR KEMIS, TANGERANG, BANTEN",18,66,111,177
https://kawalpemilu.org#52419,"GELAM JAYA, PASAR KEMIS, TANGERANG, BANTEN",19,68,140,208
https://kawalpemilu.org#52419,"GELAM JAYA, PASAR KEMIS, TANGERANG, BANTEN",20,82,157,239
https://kawalpemilu.org#52419,"GELAM JAYA, PASAR KEMIS, TANGERANG, BANTEN",21,30,147,177
https://kawalpemilu.org#52419,"GELAM JAYA, PASAR KEMIS, TANGERANG, BANTEN",22,30,114,144
https://kawalpemilu.org#52419,"GELAM JAYA, PASAR KEMIS, TANGERANG, BANTEN",23,73,122,195
https://kawalpemilu.org#52419,"GELAM JAYA, PASAR KEMIS, TANGERANG, BANTEN",24,30,101,131
https://kawalpemilu.org#52419,"GELAM JAYA, PASAR KEMIS, TANGERANG, BANTEN",25,71,130,201
https://kawalpemilu.org#52419,"GELAM JAYA, PASAR KEMIS, TANGERANG, BANTEN",26,51,140,191
https://kawalpemilu.org#52419,"GELAM JAYA, PASAR KEMIS, TANGERANG, BANTEN",27,86,64,150
https://kawalpemilu.org#52419,"GELAM JAYA, PASAR KEMIS, TANGERANG, BANTEN",28,87,83,170
https://kawalpemilu.org#52419,"GELAM JAYA, PASAR KEMIS, TANGERANG, BANTEN",29,79,79,158
https://kawalpemilu.org#52419,"GELAM JAYA, PASAR KEMIS, TANGERANG, BANTEN",30,56,75,131
https://kawalpemilu.org#52419,"GELAM JAYA, PASAR KEMIS, TANGERANG, BANTEN",31,48,41,89
https://kawalpemilu.org#52419,"GELAM JAYA, PASAR KEMIS, TANGERANG, BANTEN",32,28,54,82
https://kawalpemilu.org#52419,"GELAM JAYA, PASAR KEMIS, TANGERANG, BANTEN",33,0,0,0
https://kawalpemilu.org#52419,"GELAM JAYA, PASAR KEMIS, TANGERANG, BANTEN",34,56,77,133
https://kawalpemilu.org#52419,"GELAM JAYA, PASAR KEMIS, TANGERANG, BANTEN",35,53,83,136
https://kawalpemilu.org#52419,"GELAM JAYA, PASAR KEMIS, TANGERANG, BANTEN",36,110,12,122
https://kawalpemilu.org#52419,"GELAM JAYA, PASAR KEMIS, TANGERANG, BANTEN",37,154,16,170
https://kawalpemilu.org#52419,"GELAM JAYA, PASAR KEMIS, TANGERANG, BANTEN",38,164,43,207
https://kawalpemilu.org#52419,"GELAM JAYA, PASAR KEMIS, TANGERANG, BANTEN",39,240,27,267
https://kawalpemilu.org#52419,"GELAM JAYA, PASAR KEMIS, TANGERANG, BANTEN",40,187,33,220
https://kawalpemilu.org#52419,"GELAM JAYA, PASAR KEMIS, TANGERANG, BANTEN",41,183,31,214
https://kawalpemilu.org#52419,"GELAM JAYA, PASAR KEMIS, TANGERANG, BANTEN",42,166,41,207
https://kawalpemilu.org#52419,"GELAM JAYA, PASAR KEMIS, TANGERANG, BANTEN",43,174,64,238
https://kawalpemilu.org#52419,"GELAM JAYA, PASAR KEMIS, TANGERANG, BANTEN",44,81,33,114
https://kawalpemilu.org#52419,"GELAM JAYA, PASAR KEMIS, TANGERANG, BANTEN",45,133,57,190
https://kawalpemilu.org#52419,"GELAM JAYA, PASAR KEMIS, TANGERANG, BANTEN",46,87,54,141
https://kawalpemilu.org#52419,"GELAM JAYA, PASAR KEMIS, TANGERANG, BANTEN",47,118,62,180
https://kawalpemilu.org#52419,"GELAM JAYA, PASAR KEMIS, TANGERANG, BANTEN",48,187,15,202
https://kawalpemilu.org#52419,"GELAM JAYA, PASAR KEMIS, TANGERANG, BANTEN",49,162,76,238
https://kawalpemilu.org#52419,"GELAM JAYA, PASAR KEMIS, TANGERANG, BANTEN",50,121,41,162
https://kawalpemilu.org#52419,"GELAM JAYA, PASAR KEMIS, TANGERANG, BANTEN",51,147,89,236
https://kawalpemilu.org#52419,"GELAM JAYA, PASAR KEMIS, TANGERANG, BANTEN",52,148,41,189
https://kawalpemilu.org#52419,"GELAM JAYA, PASAR KEMIS, TANGERANG, BANTEN",54,137,69,206
https://kawalpemilu.org#52419,"GELAM JAYA, PASAR KEMIS, TANGERANG, BANTEN",55,142,60,202
https://kawalpemilu.org#52419,"GELAM JAYA, PASAR KEMIS, TANGERANG, BANTEN",56,173,37,210
https://kawalpemilu.org#52419,"GELAM JAYA, PASAR KEMIS, TANGERANG, BANTEN",57,119,101,220
https://kawalpemilu.org#52419,"GELAM JAYA, PASAR KEMIS, TANGERANG, BANTEN",58,155,96,251
https://kawalpemilu.org#52419,"GELAM JAYA, PASAR KEMIS, TANGERANG, BANTEN",59,112,145,257
https://kawalpemilu.org#52419,"GELAM JAYA, PASAR KEMIS, TANGERANG, BANTEN",60,149,132,281
https://kawalpemilu.org#52419,"GELAM JAYA, PASAR KEMIS, TANGERANG, BANTEN",61,114,107,221
https://kawalpemilu.org#52419,"GELAM JAYA, PASAR KEMIS, TANGERANG, BANTEN",62,148,72,220
https://kawalpemilu.org#52419,"GELAM JAYA, PASAR KEMIS, TANGERANG, BANTEN",63,159,80,239
https://kawalpemilu.org#52419,"GELAM JAYA, PASAR KEMIS, TANGERANG, BANTEN",64,116,96,212
https://kawalpemilu.org#52419,"GELAM JAYA, PASAR KEMIS, TANGERANG, BANTEN",65,104,131,235
https://kawalpemilu.org#52419,"GELAM JAYA, PASAR KEMIS, TANGERANG, BANTEN",66,133,70,203
https://kawalpemilu.org#52419,"GELAM JAYA, PASAR KEMIS, TANGERANG, BANTEN",67,141,50,191
https://kawalpemilu.org#52419,"GELAM JAYA, PASAR KEMIS, TANGERANG, BANTEN",68,161,46,207
https://kawalpemilu.org#52419,"GELAM JAYA, PASAR KEMIS, TANGERANG, BANTEN",69,173,36,209
https://kawalpemilu.org#52419,"GELAM JAYA, PASAR KEMIS, TANGERANG, BANTEN",70,157,51,208
https://kawalpemilu.org#52419,"GELAM JAYA, PASAR KEMIS, TANGERANG, BANTEN",71,120,60,180
https://kawalpemilu.org#52419,"GELAM JAYA, PASAR KEMIS, TANGERANG, BANTEN",72,132,29,161
https://kawalpemilu.org#52419,"GELAM JAYA, PASAR KEMIS, TANGERANG, BANTEN",73,184,32,216
https://kawalpemilu.org#52419,"GELAM JAYA, PASAR KEMIS, TANGERANG, BANTEN",74,151,23,174
https://kawalpemilu.org#52419,"GELAM JAYA, PASAR KEMIS, TANGERANG, BANTEN",75,150,76,226
https://kawalpemilu.org#52419,"GELAM JAYA, PASAR KEMIS, TANGERANG, BANTEN",76,140,93,233
https://kawalpemilu.org#52419,"GELAM JAYA, PASAR KEMIS, TANGERANG, BANTEN",77,158,91,249
https://kawalpemilu.org#52419,"GELAM JAYA, PASAR KEMIS, TANGERANG, BANTEN",78,226,41,267
https://kawalpemilu.org#52419,"GELAM JAYA, PASAR KEMIS, TANGERANG, BANTEN",79,203,44,247
https://kawalpemilu.org#52419,"GELAM JAYA, PASAR KEMIS, TANGERANG, BANTEN",80,237,22,259
https://kawalpemilu.org#52419,"GELAM JAYA, PASAR KEMIS, TANGERANG, BANTEN",81,231,42,273
https://kawalpemilu.org#52419,"GELAM JAYA, PASAR KEMIS, TANGERANG, BANTEN",82,107,76,183
https://kawalpemilu.org#52419,"GELAM JAYA, PASAR KEMIS, TANGERANG, BANTEN",83,96,71,167
https://kawalpemilu.org#52419,"GELAM JAYA, PASAR KEMIS, TANGERANG, BANTEN",84,92,71,163
https://kawalpemilu.org#52419,"GELAM JAYA, PASAR KEMIS, TANGERANG, BANTEN",85,156,86,242
https://kawalpemilu.org#52419,"GELAM JAYA, PASAR KEMIS, TANGERANG, BANTEN",86,116,119,235
https://kawalpemilu.org#52419,"GELAM JAYA, PASAR KEMIS, TANGERANG, BANTEN",87,155,107,262
https://kawalpemilu.org#52419,"GELAM JAYA, PASAR KEMIS, TANGERANG, BANTEN",88,92,90,182
https://kawalpemilu.org#52419,"GELAM JAYA, PASAR KEMIS, TANGERANG, BANTEN",89,148,110,258
https://kawalpemilu.org#52419,"GELAM JAYA, PASAR KEMIS, TANGERANG, BANTEN",90,141,80,221
https://kawalpemilu.org#52419,"GELAM JAYA, PASAR KEMIS, TANGERANG, BANTEN",91,147,100,247
https://kawalpemilu.org#52419,"GELAM JAYA, PASAR KEMIS, TANGERANG, BANTEN",92,78,112,190
https://kawalpemilu.org#52419,"GELAM JAYA, PASAR KEMIS, TANGERANG, BANTEN",93,86,119,205
https://kawalpemilu.org#52419,"GELAM JAYA, PASAR KEMIS, TANGERANG, BANTEN",94,81,148,229
https://kawalpemilu.org#52419,"GELAM JAYA, PASAR KEMIS, TANGERANG, BANTEN",95,133,63,196
https://kawalpemilu.org#52419,"GELAM JAYA, PASAR KEMIS, TANGERANG, BANTEN",96,119,95,214
https://kawalpemilu.org#52419,"GELAM JAYA, PASAR KEMIS, TANGERANG, BANTEN",97,104,125,229
https://kawalpemilu.org#52419,"GELAM JAYA, PASAR KEMIS, TANGERANG, BANTEN",98,114,89,203
https://kawalpemilu.org#52419,"GELAM JAYA, PASAR KEMIS, TANGERANG, BANTEN",99,88,84,172
https://kawalpemilu.org#52419,"GELAM JAYA, PASAR KEMIS, TANGERANG, BANTEN",100,52,89,141
https://kawalpemilu.org#52419,"GELAM JAYA, PASAR KEMIS, TANGERANG, BANTEN",101,149,35,184
https://kawalpemilu.org#52419,"GELAM JAYA, PASAR KEMIS, TANGERANG, BANTEN",102,169,62,231
https://kawalpemilu.org#52419,"GELAM JAYA, PASAR KEMIS, TANGERANG, BANTEN",103,83,64,147
https://kawalpemilu.org#52419,"GELAM JAYA, PASAR KEMIS, TANGERANG, BANTEN",104,131,69,200
https://kawalpemilu.org#52419,"GELAM JAYA, PASAR KEMIS, TANGERANG, BANTEN",105,158,91,249
https://kawalpemilu.org#52419,"GELAM JAYA, PASAR KEMIS, TANGERANG, BANTEN",106,148,71,219
https://kawalpemilu.org#52419,"GELAM JAYA, PASAR KEMIS, TANGERANG, BANTEN",107,131,39,170
https://kawalpemilu.org#52420,"SUKA ASIH, PASAR KEMIS, TANGERANG, BANTEN",1,31,124,155
https://kawalpemilu.org#52420,"SUKA ASIH, PASAR KEMIS, TANGERANG, BANTEN",2,35,142,177
https://kawalpemilu.org#52420,"SUKA ASIH, PASAR KEMIS, TANGERANG, BANTEN",3,42,203,245
https://kawalpemilu.org#52420,"SUKA ASIH, PASAR KEMIS, TANGERANG, BANTEN",4,58,159,217
https://kawalpemilu.org#52420,"SUKA ASIH, PASAR KEMIS, TANGERANG, BANTEN",5,50,158,208
https://kawalpemilu.org#52420,"SUKA ASIH, PASAR KEMIS, TANGERANG, BANTEN",6,23,115,138
https://kawalpemilu.org#52420,"SUKA ASIH, PASAR KEMIS, TANGERANG, BANTEN",7,46,139,185
https://kawalpemilu.org#52420,"SUKA ASIH, PASAR KEMIS, TANGERANG, BANTEN",8,62,193,255
https://kawalpemilu.org#52420,"SUKA ASIH, PASAR KEMIS, TANGERANG, BANTEN",9,70,205,275
https://kawalpemilu.org#52420,"SUKA ASIH, PASAR KEMIS, TANGERANG, BANTEN",10,59,90,149
https://kawalpemilu.org#52420,"SUKA ASIH, PASAR KEMIS, TANGERANG, BANTEN",11,38,87,125
https://kawalpemilu.org#52420,"SUKA ASIH, PASAR KEMIS, TANGERANG, BANTEN",12,63,193,256
https://kawalpemilu.org#52420,"SUKA ASIH, PASAR KEMIS, TANGERANG, BANTEN",13,42,109,151
https://kawalpemilu.org#52420,"SUKA ASIH, PASAR KEMIS, TANGERANG, BANTEN",14,47,159,206
https://kawalpemilu.org#52420,"SUKA ASIH, PASAR KEMIS, TANGERANG, BANTEN",15,41,136,177
https://kawalpemilu.org#52420,"SUKA ASIH, PASAR KEMIS, TANGERANG, BANTEN",16,41,152,193
https://kawalpemilu.org#52420,"SUKA ASIH, PASAR KEMIS, TANGERANG, BANTEN",17,38,162,200
https://kawalpemilu.org#52420,"SUKA ASIH, PASAR KEMIS, TANGERANG, BANTEN",18,33,164,197
https://kawalpemilu.org#52420,"SUKA ASIH, PASAR KEMIS, TANGERANG, BANTEN",19,40,143,183
https://kawalpemilu.org#52420,"SUKA ASIH, PASAR KEMIS, TANGERANG, BANTEN",20,25,142,167
https://kawalpemilu.org#52420,"SUKA ASIH, PASAR KEMIS, TANGERANG, BANTEN",21,39,123,162
https://kawalpemilu.org#52420,"SUKA ASIH, PASAR KEMIS, TANGERANG, BANTEN",22,34,114,148
https://kawalpemilu.org#52420,"SUKA ASIH, PASAR KEMIS, TANGERANG, BANTEN",23,62,140,202
https://kawalpemilu.org#52420,"SUKA ASIH, PASAR KEMIS, TANGERANG, BANTEN",24,49,148,197
https://kawalpemilu.org#52420,"SUKA ASIH, PASAR KEMIS, TANGERANG, BANTEN",25,65,109,174
https://kawalpemilu.org#52420,"SUKA ASIH, PASAR KEMIS, TANGERANG, BANTEN",26,78,115,193
https://kawalpemilu.org#52420,"SUKA ASIH, PASAR KEMIS, TANGERANG, BANTEN",27,75,93,168
https://kawalpemilu.org#52420,"SUKA ASIH, PASAR KEMIS, TANGERANG, BANTEN",28,64,87,151
https://kawalpemilu.org#52420,"SUKA ASIH, PASAR KEMIS, TANGERANG, BANTEN",29,106,87,193
https://kawalpemilu.org#52420,"SUKA ASIH, PASAR KEMIS, TANGERANG, BANTEN",30,79,77,156
https://kawalpemilu.org#52420,"SUKA ASIH, PASAR KEMIS, TANGERANG, BANTEN",31,101,64,165
https://kawalpemilu.org#52420,"SUKA ASIH, PASAR KEMIS, TANGERANG, BANTEN",32,78,72,150
https://kawalpemilu.org#52420,"SUKA ASIH, PASAR KEMIS, TANGERANG, BANTEN",33,80,77,157
https://kawalpemilu.org#52420,"SUKA ASIH, PASAR KEMIS, TANGERANG, BANTEN",34,62,94,156
https://kawalpemilu.org#52420,"SUKA ASIH, PASAR KEMIS, TANGERANG, BANTEN",35,0,0,0
https://kawalpemilu.org#52420,"SUKA ASIH, PASAR KEMIS, TANGERANG, BANTEN",36,34,70,104
https://kawalpemilu.org#52420,"SUKA ASIH, PASAR KEMIS, TANGERANG, BANTEN",37,86,104,190
https://kawalpemilu.org#52420,"SUKA ASIH, PASAR KEMIS, TANGERANG, BANTEN",40,108,95,203
https://kawalpemilu.org#52422,"TELUKNAGA, TELUKNAGA, TANGERANG, BANTEN",1,82,196,278
https://kawalpemilu.org#52422,"TELUKNAGA, TELUKNAGA, TANGERANG, BANTEN",2,48,189,237
https://kawalpemilu.org#52422,"TELUKNAGA, TELUKNAGA, TANGERANG, BANTEN",3,114,149,263
https://kawalpemilu.org#52422,"TELUKNAGA, TELUKNAGA, TANGERANG, BANTEN",4,99,149,248
https://kawalpemilu.org#52422,"TELUKNAGA, TELUKNAGA, TANGERANG, BANTEN",5,82,152,234
https://kawalpemilu.org#52422,"TELUKNAGA, TELUKNAGA, TANGERANG, BANTEN",6,64,204,268
https://kawalpemilu.org#52422,"TELUKNAGA, TELUKNAGA, TANGERANG, BANTEN",7,88,192,280
https://kawalpemilu.org#52422,"TELUKNAGA, TELUKNAGA, TANGERANG, BANTEN",9,120,149,269
https://kawalpemilu.org#52422,"TELUKNAGA, TELUKNAGA, TANGERANG, BANTEN",11,108,164,272
https://kawalpemilu.org#52422,"TELUKNAGA, TELUKNAGA, TANGERANG, BANTEN",12,56,74,130
https://kawalpemilu.org#52422,"TELUKNAGA, TELUKNAGA, TANGERANG, BANTEN",13,180,34,214
https://kawalpemilu.org#52422,"TELUKNAGA, TELUKNAGA, TANGERANG, BANTEN",14,106,136,242
https://kawalpemilu.org#52422,"TELUKNAGA, TELUKNAGA, TANGERANG, BANTEN",15,85,147,232
https://kawalpemilu.org#52422,"TELUKNAGA, TELUKNAGA, TANGERANG, BANTEN",16,127,149,276
https://kawalpemilu.org#52422,"TELUKNAGA, TELUKNAGA, TANGERANG, BANTEN",17,79,167,8
https://kawalpemilu.org#52422,"TELUKNAGA, TELUKNAGA, TANGERANG, BANTEN",18,117,119,236
https://kawalpemilu.org#52422,"TELUKNAGA, TELUKNAGA, TANGERANG, BANTEN",22,73,182,255
https://kawalpemilu.org#52422,"TELUKNAGA, TELUKNAGA, TANGERANG, BANTEN",23,90,191,281
https://kawalpemilu.org#52422,"TELUKNAGA, TELUKNAGA, TANGERANG, BANTEN",24,50,197,247
https://kawalpemilu.org#52422,"TELUKNAGA, TELUKNAGA, TANGERANG, BANTEN",25,55,193,248
https://kawalpemilu.org#52422,"TELUKNAGA, TELUKNAGA, TANGERANG, BANTEN",26,72,163,235
https://kawalpemilu.org#52422,"TELUKNAGA, TELUKNAGA, TANGERANG, BANTEN",27,79,193,272
https://kawalpemilu.org#52422,"TELUKNAGA, TELUKNAGA, TANGERANG, BANTEN",28,65,188,253
https://kawalpemilu.org#52422,"TELUKNAGA, TELUKNAGA, TANGERANG, BANTEN",29,85,187,272
https://kawalpemilu.org#52422,"TELUKNAGA, TELUKNAGA, TANGERANG, BANTEN",30,94,179,273
https://kawalpemilu.org#52422,"TELUKNAGA, TELUKNAGA, TANGERANG, BANTEN",31,55,232,287
https://kawalpemilu.org#52422,"TELUKNAGA, TELUKNAGA, TANGERANG, BANTEN",32,78,188,266
https://kawalpemilu.org#52422,"TELUKNAGA, TELUKNAGA, TANGERANG, BANTEN",33,87,185,272
https://kawalpemilu.org#52422,"TELUKNAGA, TELUKNAGA, TANGERANG, BANTEN",34,90,152,242
https://kawalpemilu.org#52422,"TELUKNAGA, TELUKNAGA, TANGERANG, BANTEN",35,34,91,125
https://kawalpemilu.org#52423,"BOJONG RENGED, TELUKNAGA, TANGERANG, BANTEN",2,69,133,202
https://kawalpemilu.org#52423,"BOJONG RENGED, TELUKNAGA, TANGERANG, BANTEN",3,45,165,210
https://kawalpemilu.org#52423,"BOJONG RENGED, TELUKNAGA, TANGERANG, BANTEN",4,32,113,145
https://kawalpemilu.org#52423,"BOJONG RENGED, TELUKNAGA, TANGERANG, BANTEN",5,53,216,269
https://kawalpemilu.org#52423,"BOJONG RENGED, TELUKNAGA, TANGERANG, BANTEN",6,68,196,264
https://kawalpemilu.org#52423,"BOJONG RENGED, TELUKNAGA, TANGERANG, BANTEN",7,80,154,234
https://kawalpemilu.org#52423,"BOJONG RENGED, TELUKNAGA, TANGERANG, BANTEN",8,102,146,248
https://kawalpemilu.org#52423,"BOJONG RENGED, TELUKNAGA, TANGERANG, BANTEN",9,84,151,235
https://kawalpemilu.org#52423,"BOJONG RENGED, TELUKNAGA, TANGERANG, BANTEN",10,89,155,244
https://kawalpemilu.org#52423,"BOJONG RENGED, TELUKNAGA, TANGERANG, BANTEN",11,120,143,263
https://kawalpemilu.org#52423,"BOJONG RENGED, TELUKNAGA, TANGERANG, BANTEN",12,76,135,211
https://kawalpemilu.org#52423,"BOJONG RENGED, TELUKNAGA, TANGERANG, BANTEN",13,98,106,204
https://kawalpemilu.org#52423,"BOJONG RENGED, TELUKNAGA, TANGERANG, BANTEN",14,58,122,180
https://kawalpemilu.org#52423,"BOJONG RENGED, TELUKNAGA, TANGERANG, BANTEN",15,51,88,139
https://kawalpemilu.org#52423,"BOJONG RENGED, TELUKNAGA, TANGERANG, BANTEN",16,84,127,211
https://kawalpemilu.org#52423,"BOJONG RENGED, TELUKNAGA, TANGERANG, BANTEN",17,70,171,241
https://kawalpemilu.org#52423,"BOJONG RENGED, TELUKNAGA, TANGERANG, BANTEN",18,71,162,233
https://kawalpemilu.org#52423,"BOJONG RENGED, TELUKNAGA, TANGERANG, BANTEN",19,77,189,266
https://kawalpemilu.org#52423,"BOJONG RENGED, TELUKNAGA, TANGERANG, BANTEN",20,89,141,230
https://kawalpemilu.org#52423,"BOJONG RENGED, TELUKNAGA, TANGERANG, BANTEN",21,59,177,236
https://kawalpemilu.org#52423,"BOJONG RENGED, TELUKNAGA, TANGERANG, BANTEN",22,66,194,260
https://kawalpemilu.org#52423,"BOJONG RENGED, TELUKNAGA, TANGERANG, BANTEN",23,58,181,239
https://kawalpemilu.org#52423,"BOJONG RENGED, TELUKNAGA, TANGERANG, BANTEN",24,67,176,243
https://kawalpemilu.org#52423,"BOJONG RENGED, TELUKNAGA, TANGERANG, BANTEN",25,72,195,267
https://kawalpemilu.org#52423,"BOJONG RENGED, TELUKNAGA, TANGERANG, BANTEN",26,46,150,196
https://kawalpemilu.org#52423,"BOJONG RENGED, TELUKNAGA, TANGERANG, BANTEN",28,58,166,224
https://kawalpemilu.org#52423,"BOJONG RENGED, TELUKNAGA, TANGERANG, BANTEN",30,60,135,195
https://kawalpemilu.org#52423,"BOJONG RENGED, TELUKNAGA, TANGERANG, BANTEN",31,60,115,175
https://kawalpemilu.org#52423,"BOJONG RENGED, TELUKNAGA, TANGERANG, BANTEN",32,58,94,152
https://kawalpemilu.org#52423,"BOJONG RENGED, TELUKNAGA, TANGERANG, BANTEN",33,46,161,207
https://kawalpemilu.org#52423,"BOJONG RENGED, TELUKNAGA, TANGERANG, BANTEN",34,28,87,115
https://kawalpemilu.org#52423,"BOJONG RENGED, TELUKNAGA, TANGERANG, BANTEN",35,18,32,50
https://kawalpemilu.org#52424,"BABAKAN ASEM, TELUKNAGA, TANGERANG, BANTEN",1,88,167,255
https://kawalpemilu.org#52424,"BABAKAN ASEM, TELUKNAGA, TANGERANG, BANTEN",2,44,198,242
https://kawalpemilu.org#52424,"BABAKAN ASEM, TELUKNAGA, TANGERANG, BANTEN",3,81,149,230
https://kawalpemilu.org#52424,"BABAKAN ASEM, TELUKNAGA, TANGERANG, BANTEN",4,71,164,235
https://kawalpemilu.org#52424,"BABAKAN ASEM, TELUKNAGA, TANGERANG, BANTEN",5,83,139,222
https://kawalpemilu.org#52424,"BABAKAN ASEM, TELUKNAGA, TANGERANG, BANTEN",6,116,139,255
https://kawalpemilu.org#52424,"BABAKAN ASEM, TELUKNAGA, TANGERANG, BANTEN",7,103,133,236
https://kawalpemilu.org#52424,"BABAKAN ASEM, TELUKNAGA, TANGERANG, BANTEN",8,112,130,242
https://kawalpemilu.org#52424,"BABAKAN ASEM, TELUKNAGA, TANGERANG, BANTEN",9,102,140,242
https://kawalpemilu.org#52424,"BABAKAN ASEM, TELUKNAGA, TANGERANG, BANTEN",10,96,120,216
https://kawalpemilu.org#52424,"BABAKAN ASEM, TELUKNAGA, TANGERANG, BANTEN",11,80,163,243
https://kawalpemilu.org#52424,"BABAKAN ASEM, TELUKNAGA, TANGERANG, BANTEN",12,72,179,251
https://kawalpemilu.org#52424,"BABAKAN ASEM, TELUKNAGA, TANGERANG, BANTEN",13,81,129,210
https://kawalpemilu.org#52424,"BABAKAN ASEM, TELUKNAGA, TANGERANG, BANTEN",14,106,106,212
https://kawalpemilu.org#52424,"BABAKAN ASEM, TELUKNAGA, TANGERANG, BANTEN",27,11,78,89
https://kawalpemilu.org#52425,"KEBONCAU, TELUKNAGA, TANGERANG, BANTEN",1,49,148,197
https://kawalpemilu.org#52425,"KEBONCAU, TELUKNAGA, TANGERANG, BANTEN",2,39,167,206
https://kawalpemilu.org#52425,"KEBONCAU, TELUKNAGA, TANGERANG, BANTEN",3,71,147,218
https://kawalpemilu.org#52425,"KEBONCAU, TELUKNAGA, TANGERANG, BANTEN",4,58,170,228
https://kawalpemilu.org#52425,"KEBONCAU, TELUKNAGA, TANGERANG, BANTEN",5,63,100,163
https://kawalpemilu.org#52425,"KEBONCAU, TELUKNAGA, TANGERANG, BANTEN",6,78,95,173
https://kawalpemilu.org#52425,"KEBONCAU, TELUKNAGA, TANGERANG, BANTEN",7,116,115,231
https://kawalpemilu.org#52425,"KEBONCAU, TELUKNAGA, TANGERANG, BANTEN",8,87,140,227
https://kawalpemilu.org#52425,"KEBONCAU, TELUKNAGA, TANGERANG, BANTEN",9,90,142,232
https://kawalpemilu.org#52425,"KEBONCAU, TELUKNAGA, TANGERANG, BANTEN",10,102,149,251
https://kawalpemilu.org#52425,"KEBONCAU, TELUKNAGA, TANGERANG, BANTEN",11,110,115,225
https://kawalpemilu.org#52425,"KEBONCAU, TELUKNAGA, TANGERANG, BANTEN",12,84,110,194
https://kawalpemilu.org#52425,"KEBONCAU, TELUKNAGA, TANGERANG, BANTEN",13,62,140,202
https://kawalpemilu.org#52425,"KEBONCAU, TELUKNAGA, TANGERANG, BANTEN",14,85,162,247
https://kawalpemilu.org#52425,"KEBONCAU, TELUKNAGA, TANGERANG, BANTEN",15,84,177,261
https://kawalpemilu.org#52425,"KEBONCAU, TELUKNAGA, TANGERANG, BANTEN",16,55,107,162
https://kawalpemilu.org#52425,"KEBONCAU, TELUKNAGA, TANGERANG, BANTEN",17,51,122,173
https://kawalpemilu.org#52425,"KEBONCAU, TELUKNAGA, TANGERANG, BANTEN",18,59,86,145
https://kawalpemilu.org#52425,"KEBONCAU, TELUKNAGA, TANGERANG, BANTEN",19,42,90,132
https://kawalpemilu.org#52425,"KEBONCAU, TELUKNAGA, TANGERANG, BANTEN",20,45,157,202
https://kawalpemilu.org#52425,"KEBONCAU, TELUKNAGA, TANGERANG, BANTEN",21,110,166,276
https://kawalpemilu.org#52425,"KEBONCAU, TELUKNAGA, TANGERANG, BANTEN",22,93,159,252
https://kawalpemilu.org#52425,"KEBONCAU, TELUKNAGA, TANGERANG, BANTEN",23,54,169,223
https://kawalpemilu.org#52425,"KEBONCAU, TELUKNAGA, TANGERANG, BANTEN",24,55,173,228
https://kawalpemilu.org#52425,"KEBONCAU, TELUKNAGA, TANGERANG, BANTEN",25,19,157,176
https://kawalpemilu.org#52425,"KEBONCAU, TELUKNAGA, TANGERANG, BANTEN",26,36,138,174
https://kawalpemilu.org#52425,"KEBONCAU, TELUKNAGA, TANGERANG, BANTEN",27,100,103,203
https://kawalpemilu.org#52425,"KEBONCAU, TELUKNAGA, TANGERANG, BANTEN",28,77,126,203
https://kawalpemilu.org#52425,"KEBONCAU, TELUKNAGA, TANGERANG, BANTEN",29,71,103,174
https://kawalpemilu.org#52425,"KEBONCAU, TELUKNAGA, TANGERANG, BANTEN",30,71,146,217
https://kawalpemilu.org#52425,"KEBONCAU, TELUKNAGA, TANGERANG, BANTEN",31,80,89,169
https://kawalpemilu.org#52425,"KEBONCAU, TELUKNAGA, TANGERANG, BANTEN",32,96,130,226
https://kawalpemilu.org#52425,"KEBONCAU, TELUKNAGA, TANGERANG, BANTEN",34,26,98,124
https://kawalpemilu.org#52425,"KEBONCAU, TELUKNAGA, TANGERANG, BANTEN",35,34,89,123
https://kawalpemilu.org#52425,"KEBONCAU, TELUKNAGA, TANGERANG, BANTEN",36,45,88,133
https://kawalpemilu.org#52425,"KEBONCAU, TELUKNAGA, TANGERANG, BANTEN",37,68,74,142
https://kawalpemilu.org#52425,"KEBONCAU, TELUKNAGA, TANGERANG, BANTEN",38,53,80,133
https://kawalpemilu.org#52426,"PANGKALAN, TELUKNAGA, TANGERANG, BANTEN",1,63,111,174
https://kawalpemilu.org#52426,"PANGKALAN, TELUKNAGA, TANGERANG, BANTEN",2,79,136,215
https://kawalpemilu.org#52426,"PANGKALAN, TELUKNAGA, TANGERANG, BANTEN",3,51,118,169
https://kawalpemilu.org#52426,"PANGKALAN, TELUKNAGA, TANGERANG, BANTEN",4,93,107,200
https://kawalpemilu.org#52426,"PANGKALAN, TELUKNAGA, TANGERANG, BANTEN",5,81,105,186
https://kawalpemilu.org#52426,"PANGKALAN, TELUKNAGA, TANGERANG, BANTEN",6,71,151,222
https://kawalpemilu.org#52426,"PANGKALAN, TELUKNAGA, TANGERANG, BANTEN",7,92,97,189
https://kawalpemilu.org#52426,"PANGKALAN, TELUKNAGA, TANGERANG, BANTEN",8,91,142,233
https://kawalpemilu.org#52426,"PANGKALAN, TELUKNAGA, TANGERANG, BANTEN",9,85,174,259
https://kawalpemilu.org#52426,"PANGKALAN, TELUKNAGA, TANGERANG, BANTEN",10,119,141,260
https://kawalpemilu.org#52426,"PANGKALAN, TELUKNAGA, TANGERANG, BANTEN",11,66,161,227
https://kawalpemilu.org#52426,"PANGKALAN, TELUKNAGA, TANGERANG, BANTEN",12,78,151,229
https://kawalpemilu.org#52426,"PANGKALAN, TELUKNAGA, TANGERANG, BANTEN",13,81,123,204
https://kawalpemilu.org#52426,"PANGKALAN, TELUKNAGA, TANGERANG, BANTEN",14,74,171,245
https://kawalpemilu.org#52426,"PANGKALAN, TELUKNAGA, TANGERANG, BANTEN",15,94,137,231
https://kawalpemilu.org#52426,"PANGKALAN, TELUKNAGA, TANGERANG, BANTEN",16,84,137,221
https://kawalpemilu.org#52426,"PANGKALAN, TELUKNAGA, TANGERANG, BANTEN",17,55,126,181
https://kawalpemilu.org#52426,"PANGKALAN, TELUKNAGA, TANGERANG, BANTEN",18,57,118,175
https://kawalpemilu.org#52426,"PANGKALAN, TELUKNAGA, TANGERANG, BANTEN",19,38,107,145
https://kawalpemilu.org#52426,"PANGKALAN, TELUKNAGA, TANGERANG, BANTEN",20,70,146,216
https://kawalpemilu.org#52426,"PANGKALAN, TELUKNAGA, TANGERANG, BANTEN",26,115,111,226
https://kawalpemilu.org#52426,"PANGKALAN, TELUKNAGA, TANGERANG, BANTEN",27,166,73,239
https://kawalpemilu.org#52426,"PANGKALAN, TELUKNAGA, TANGERANG, BANTEN",28,121,121,242
https://kawalpemilu.org#52426,"PANGKALAN, TELUKNAGA, TANGERANG, BANTEN",29,217,24,241
https://kawalpemilu.org#52426,"PANGKALAN, TELUKNAGA, TANGERANG, BANTEN",30,134,127,261
https://kawalpemilu.org#52426,"PANGKALAN, TELUKNAGA, TANGERANG, BANTEN",31,117,108,225
https://kawalpemilu.org#52426,"PANGKALAN, TELUKNAGA, TANGERANG, BANTEN",32,156,98,254
https://kawalpemilu.org#52426,"PANGKALAN, TELUKNAGA, TANGERANG, BANTEN",33,91,158,249
https://kawalpemilu.org#52426,"PANGKALAN, TELUKNAGA, TANGERANG, BANTEN",34,112,149,261
https://kawalpemilu.org#52426,"PANGKALAN, TELUKNAGA, TANGERANG, BANTEN",35,127,114,241
https://kawalpemilu.org#52426,"PANGKALAN, TELUKNAGA, TANGERANG, BANTEN",36,82,117,199
https://kawalpemilu.org#52426,"PANGKALAN, TELUKNAGA, TANGERANG, BANTEN",37,86,151,237
https://kawalpemilu.org#52426,"PANGKALAN, TELUKNAGA, TANGERANG, BANTEN",38,97,147,244
https://kawalpemilu.org#52426,"PANGKALAN, TELUKNAGA, TANGERANG, BANTEN",39,121,134,255
https://kawalpemilu.org#52426,"PANGKALAN, TELUKNAGA, TANGERANG, BANTEN",40,79,134,213
https://kawalpemilu.org#52426,"PANGKALAN, TELUKNAGA, TANGERANG, BANTEN",41,129,97,226
https://kawalpemilu.org#52426,"PANGKALAN, TELUKNAGA, TANGERANG, BANTEN",42,58,186,244
https://kawalpemilu.org#52426,"PANGKALAN, TELUKNAGA, TANGERANG, BANTEN",43,63,183,246
https://kawalpemilu.org#52426,"PANGKALAN, TELUKNAGA, TANGERANG, BANTEN",44,63,151,214
https://kawalpemilu.org#52426,"PANGKALAN, TELUKNAGA, TANGERANG, BANTEN",45,49,144,193
https://kawalpemilu.org#52427,"KAMPUNG MELAYU TIMUR, TELUKNAGA, TANGERANG, BANTEN",1,46,182,228
https://kawalpemilu.org#52427,"KAMPUNG MELAYU TIMUR, TELUKNAGA, TANGERANG, BANTEN",2,98,91,189
https://kawalpemilu.org#52427,"KAMPUNG MELAYU TIMUR, TELUKNAGA, TANGERANG, BANTEN",3,103,167,270
https://kawalpemilu.org#52427,"KAMPUNG MELAYU TIMUR, TELUKNAGA, TANGERANG, BANTEN",4,101,121,222
https://kawalpemilu.org#52427,"KAMPUNG MELAYU TIMUR, TELUKNAGA, TANGERANG, BANTEN",7,52,114,166
https://kawalpemilu.org#52427,"KAMPUNG MELAYU TIMUR, TELUKNAGA, TANGERANG, BANTEN",8,110,101,211
https://kawalpemilu.org#52427,"KAMPUNG MELAYU TIMUR, TELUKNAGA, TANGERANG, BANTEN",9,66,152,218
https://kawalpemilu.org#52427,"KAMPUNG MELAYU TIMUR, TELUKNAGA, TANGERANG, BANTEN",11,61,203,11
https://kawalpemilu.org#52427,"KAMPUNG MELAYU TIMUR, TELUKNAGA, TANGERANG, BANTEN",12,72,180,252
https://kawalpemilu.org#52427,"KAMPUNG MELAYU TIMUR, TELUKNAGA, TANGERANG, BANTEN",13,54,97,151
https://kawalpemilu.org#52427,"KAMPUNG MELAYU TIMUR, TELUKNAGA, TANGERANG, BANTEN",14,58,132,190
https://kawalpemilu.org#52427,"KAMPUNG MELAYU TIMUR, TELUKNAGA, TANGERANG, BANTEN",15,51,175,226
https://kawalpemilu.org#52427,"KAMPUNG MELAYU TIMUR, TELUKNAGA, TANGERANG, BANTEN",16,46,174,220
https://kawalpemilu.org#52427,"KAMPUNG MELAYU TIMUR, TELUKNAGA, TANGERANG, BANTEN",17,100,167,267
https://kawalpemilu.org#52427,"KAMPUNG MELAYU TIMUR, TELUKNAGA, TANGERANG, BANTEN",18,103,172,275
https://kawalpemilu.org#52427,"KAMPUNG MELAYU TIMUR, TELUKNAGA, TANGERANG, BANTEN",19,72,100,172
https://kawalpemilu.org#52427,"KAMPUNG MELAYU TIMUR, TELUKNAGA, TANGERANG, BANTEN",20,81,104,185
https://kawalpemilu.org#52427,"KAMPUNG MELAYU TIMUR, TELUKNAGA, TANGERANG, BANTEN",21,120,104,224
https://kawalpemilu.org#52427,"KAMPUNG MELAYU TIMUR, TELUKNAGA, TANGERANG, BANTEN",22,96,144,240
https://kawalpemilu.org#52427,"KAMPUNG MELAYU TIMUR, TELUKNAGA, TANGERANG, BANTEN",23,122,91,213
https://kawalpemilu.org#52427,"KAMPUNG MELAYU TIMUR, TELUKNAGA, TANGERANG, BANTEN",24,173,65,237
https://kawalpemilu.org#52427,"KAMPUNG MELAYU TIMUR, TELUKNAGA, TANGERANG, BANTEN",25,128,83,211
https://kawalpemilu.org#52427,"KAMPUNG MELAYU TIMUR, TELUKNAGA, TANGERANG, BANTEN",26,128,83,211
https://kawalpemilu.org#52427,"KAMPUNG MELAYU TIMUR, TELUKNAGA, TANGERANG, BANTEN",27,92,47,139
https://kawalpemilu.org#52427,"KAMPUNG MELAYU TIMUR, TELUKNAGA, TANGERANG, BANTEN",28,67,39,106
https://kawalpemilu.org#52427,"KAMPUNG MELAYU TIMUR, TELUKNAGA, TANGERANG, BANTEN",29,38,66,104
https://kawalpemilu.org#52427,"KAMPUNG MELAYU TIMUR, TELUKNAGA, TANGERANG, BANTEN",30,54,78,132
https://kawalpemilu.org#52427,"KAMPUNG MELAYU TIMUR, TELUKNAGA, TANGERANG, BANTEN",31,37,104,141
https://kawalpemilu.org#52427,"KAMPUNG MELAYU TIMUR, TELUKNAGA, TANGERANG, BANTEN",32,98,79,177
https://kawalpemilu.org#52427,"KAMPUNG MELAYU TIMUR, TELUKNAGA, TANGERANG, BANTEN",33,68,116,184
https://kawalpemilu.org#52427,"KAMPUNG MELAYU TIMUR, TELUKNAGA, TANGERANG, BANTEN",35,40,56,96
https://kawalpemilu.org#52427,"KAMPUNG MELAYU TIMUR, TELUKNAGA, TANGERANG, BANTEN",36,54,103,157
https://kawalpemilu.org#52427,"KAMPUNG MELAYU TIMUR, TELUKNAGA, TANGERANG, BANTEN",37,55,139,194
https://kawalpemilu.org#52427,"KAMPUNG MELAYU TIMUR, TELUKNAGA, TANGERANG, BANTEN",38,107,175,282
https://kawalpemilu.org#52427,"KAMPUNG MELAYU TIMUR, TELUKNAGA, TANGERANG, BANTEN",39,93,143,236
https://kawalpemilu.org#52427,"KAMPUNG MELAYU TIMUR, TELUKNAGA, TANGERANG, BANTEN",40,139,63,202
https://kawalpemilu.org#52427,"KAMPUNG MELAYU TIMUR, TELUKNAGA, TANGERANG, BANTEN",41,79,117,196
https://kawalpemilu.org#52427,"KAMPUNG MELAYU TIMUR, TELUKNAGA, TANGERANG, BANTEN",42,78,113,191
https://kawalpemilu.org#52427,"KAMPUNG MELAYU TIMUR, TELUKNAGA, TANGERANG, BANTEN",43,78,104,182
https://kawalpemilu.org#52427,"KAMPUNG MELAYU TIMUR, TELUKNAGA, TANGERANG, BANTEN",44,74,115,189
https://kawalpemilu.org#52427,"KAMPUNG MELAYU TIMUR, TELUKNAGA, TANGERANG, BANTEN",45,68,82,150
https://kawalpemilu.org#52427,"KAMPUNG MELAYU TIMUR, TELUKNAGA, TANGERANG, BANTEN",46,70,104,174
https://kawalpemilu.org#52427,"KAMPUNG MELAYU TIMUR, TELUKNAGA, TANGERANG, BANTEN",47,49,74,123
https://kawalpemilu.org#52427,"KAMPUNG MELAYU TIMUR, TELUKNAGA, TANGERANG, BANTEN",48,66,86,152
https://kawalpemilu.org#52427,"KAMPUNG MELAYU TIMUR, TELUKNAGA, TANGERANG, BANTEN",49,79,171,250
https://kawalpemilu.org#52427,"KAMPUNG MELAYU TIMUR, TELUKNAGA, TANGERANG, BANTEN",50,90,97,187
https://kawalpemilu.org#52427,"KAMPUNG MELAYU TIMUR, TELUKNAGA, TANGERANG, BANTEN",51,153,33,186
https://kawalpemilu.org#52427,"KAMPUNG MELAYU TIMUR, TELUKNAGA, TANGERANG, BANTEN",52,89,58,147
https://kawalpemilu.org#52428,"KAMPUNG MELAYU BARAT, TELUKNAGA, TANGERANG, BANTEN",1,108,89,197
https://kawalpemilu.org#52428,"KAMPUNG MELAYU BARAT, TELUKNAGA, TANGERANG, BANTEN",2,127,87,214
https://kawalpemilu.org#52428,"KAMPUNG MELAYU BARAT, TELUKNAGA, TANGERANG, BANTEN",3,109,97,206
https://kawalpemilu.org#52428,"KAMPUNG MELAYU BARAT, TELUKNAGA, TANGERANG, BANTEN",4,132,99,231
https://kawalpemilu.org#52428,"KAMPUNG MELAYU BARAT, TELUKNAGA, TANGERANG, BANTEN",5,134,140,274
https://kawalpemilu.org#52428,"KAMPUNG MELAYU BARAT, TELUKNAGA, TANGERANG, BANTEN",6,117,102,119
https://kawalpemilu.org#52428,"KAMPUNG MELAYU BARAT, TELUKNAGA, TANGERANG, BANTEN",7,85,108,193
https://kawalpemilu.org#52428,"KAMPUNG MELAYU BARAT, TELUKNAGA, TANGERANG, BANTEN",8,75,107,182
https://kawalpemilu.org#52428,"KAMPUNG MELAYU BARAT, TELUKNAGA, TANGERANG, BANTEN",9,57,148,205
https://kawalpemilu.org#52428,"KAMPUNG MELAYU BARAT, TELUKNAGA, TANGERANG, BANTEN",10,115,153,268
https://kawalpemilu.org#52428,"KAMPUNG MELAYU BARAT, TELUKNAGA, TANGERANG, BANTEN",11,51,137,188
https://kawalpemilu.org#52428,"KAMPUNG MELAYU BARAT, TELUKNAGA, TANGERANG, BANTEN",12,46,144,190
https://kawalpemilu.org#52428,"KAMPUNG MELAYU BARAT, TELUKNAGA, TANGERANG, BANTEN",13,68,131,199
https://kawalpemilu.org#52428,"KAMPUNG MELAYU BARAT, TELUKNAGA, TANGERANG, BANTEN",14,58,135,193
https://kawalpemilu.org#52428,"KAMPUNG MELAYU BARAT, TELUKNAGA, TANGERANG, BANTEN",15,71,139,210
https://kawalpemilu.org#52428,"KAMPUNG MELAYU BARAT, TELUKNAGA, TANGERANG, BANTEN",16,54,105,159
https://kawalpemilu.org#52428,"KAMPUNG MELAYU BARAT, TELUKNAGA, TANGERANG, BANTEN",17,92,82,174
https://kawalpemilu.org#52428,"KAMPUNG MELAYU BARAT, TELUKNAGA, TANGERANG, BANTEN",18,113,79,192
https://kawalpemilu.org#52428,"KAMPUNG MELAYU BARAT, TELUKNAGA, TANGERANG, BANTEN",19,161,17,178
https://kawalpemilu.org#52428,"KAMPUNG MELAYU BARAT, TELUKNAGA, TANGERANG, BANTEN",20,207,8,215
https://kawalpemilu.org#52428,"KAMPUNG MELAYU BARAT, TELUKNAGA, TANGERANG, BANTEN",21,63,125,188
https://kawalpemilu.org#52428,"KAMPUNG MELAYU BARAT, TELUKNAGA, TANGERANG, BANTEN",22,58,119,177
https://kawalpemilu.org#52428,"KAMPUNG MELAYU BARAT, TELUKNAGA, TANGERANG, BANTEN",23,57,129,186
https://kawalpemilu.org#52428,"KAMPUNG MELAYU BARAT, TELUKNAGA, TANGERANG, BANTEN",24,62,129,191
https://kawalpemilu.org#52428,"KAMPUNG MELAYU BARAT, TELUKNAGA, TANGERANG, BANTEN",25,68,134,202
https://kawalpemilu.org#52428,"KAMPUNG MELAYU BARAT, TELUKNAGA, TANGERANG, BANTEN",26,68,116,184
https://kawalpemilu.org#52428,"KAMPUNG MELAYU BARAT, TELUKNAGA, TANGERANG, BANTEN",27,193,53,246
https://kawalpemilu.org#52428,"KAMPUNG MELAYU BARAT, TELUKNAGA, TANGERANG, BANTEN",28,69,142,211
https://kawalpemilu.org#52428,"KAMPUNG MELAYU BARAT, TELUKNAGA, TANGERANG, BANTEN",29,85,128,213
https://kawalpemilu.org#52428,"KAMPUNG MELAYU BARAT, TELUKNAGA, TANGERANG, BANTEN",30,70,150,220
https://kawalpemilu.org#52428,"KAMPUNG MELAYU BARAT, TELUKNAGA, TANGERANG, BANTEN",31,80,131,211
https://kawalpemilu.org#52428,"KAMPUNG MELAYU BARAT, TELUKNAGA, TANGERANG, BANTEN",32,79,116,195
https://kawalpemilu.org#52428,"KAMPUNG MELAYU BARAT, TELUKNAGA, TANGERANG, BANTEN",33,88,103,191
https://kawalpemilu.org#52428,"KAMPUNG MELAYU BARAT, TELUKNAGA, TANGERANG, BANTEN",34,129,86,215
https://kawalpemilu.org#52428,"KAMPUNG MELAYU BARAT, TELUKNAGA, TANGERANG, BANTEN",35,158,51,209
https://kawalpemilu.org#52429,"MUARA, TELUKNAGA, TANGERANG, BANTEN",1,79,103,182
https://kawalpemilu.org#52429,"MUARA, TELUKNAGA, TANGERANG, BANTEN",3,56,131,187
https://kawalpemilu.org#52429,"MUARA, TELUKNAGA, TANGERANG, BANTEN",5,109,78,187
https://kawalpemilu.org#52429,"MUARA, TELUKNAGA, TANGERANG, BANTEN",6,114,101,215
https://kawalpemilu.org#52429,"MUARA, TELUKNAGA, TANGERANG, BANTEN",7,74,83,157
https://kawalpemilu.org#52429,"MUARA, TELUKNAGA, TANGERANG, BANTEN",8,69,79,148
https://kawalpemilu.org#52429,"MUARA, TELUKNAGA, TANGERANG, BANTEN",9,63,118,181
https://kawalpemilu.org#52429,"MUARA, TELUKNAGA, TANGERANG, BANTEN",10,65,114,179
https://kawalpemilu.org#52429,"MUARA, TELUKNAGA, TANGERANG, BANTEN",11,74,114,188
https://kawalpemilu.org#52430,"LEMO, TELUKNAGA, TANGERANG, BANTEN",1,66,145,211
https://kawalpemilu.org#52430,"LEMO, TELUKNAGA, TANGERANG, BANTEN",2,63,193,256
https://kawalpemilu.org#52430,"LEMO, TELUKNAGA, TANGERANG, BANTEN",3,67,195,262
https://kawalpemilu.org#52430,"LEMO, TELUKNAGA, TANGERANG, BANTEN",4,38,151,189
https://kawalpemilu.org#52430,"LEMO, TELUKNAGA, TANGERANG, BANTEN",5,109,102,211
https://kawalpemilu.org#52430,"LEMO, TELUKNAGA, TANGERANG, BANTEN",6,94,95,189
https://kawalpemilu.org#52430,"LEMO, TELUKNAGA, TANGERANG, BANTEN",7,178,7,185
https://kawalpemilu.org#52430,"LEMO, TELUKNAGA, TANGERANG, BANTEN",8,96,124,220
https://kawalpemilu.org#52430,"LEMO, TELUKNAGA, TANGERANG, BANTEN",9,80,115,195
https://kawalpemilu.org#52430,"LEMO, TELUKNAGA, TANGERANG, BANTEN",10,111,47,158
https://kawalpemilu.org#52430,"LEMO, TELUKNAGA, TANGERANG, BANTEN",11,72,165,237
https://kawalpemilu.org#52430,"LEMO, TELUKNAGA, TANGERANG, BANTEN",12,64,153,217
https://kawalpemilu.org#52430,"LEMO, TELUKNAGA, TANGERANG, BANTEN",13,33,201,234
https://kawalpemilu.org#52430,"LEMO, TELUKNAGA, TANGERANG, BANTEN",14,34,114,148
https://kawalpemilu.org#52430,"LEMO, TELUKNAGA, TANGERANG, BANTEN",15,67,83,150
https://kawalpemilu.org#52430,"LEMO, TELUKNAGA, TANGERANG, BANTEN",16,63,94,157
https://kawalpemilu.org#52430,"LEMO, TELUKNAGA, TANGERANG, BANTEN",17,92,98,190
https://kawalpemilu.org#52430,"LEMO, TELUKNAGA, TANGERANG, BANTEN",18,55,116,171
https://kawalpemilu.org#52430,"LEMO, TELUKNAGA, TANGERANG, BANTEN",19,101,115,216
https://kawalpemilu.org#52430,"LEMO, TELUKNAGA, TANGERANG, BANTEN",20,95,89,184
https://kawalpemilu.org#52431,"TANJUNG PASIR, TELUKNAGA, TANGERANG, BANTEN",1,98,144,242
https://kawalpemilu.org#52431,"TANJUNG PASIR, TELUKNAGA, TANGERANG, BANTEN",2,114,125,239
https://kawalpemilu.org#52431,"TANJUNG PASIR, TELUKNAGA, TANGERANG, BANTEN",3,80,135,215
https://kawalpemilu.org#52431,"TANJUNG PASIR, TELUKNAGA, TANGERANG, BANTEN",4,78,138,216
https://kawalpemilu.org#52431,"TANJUNG PASIR, TELUKNAGA, TANGERANG, BANTEN",5,89,129,218
https://kawalpemilu.org#52431,"TANJUNG PASIR, TELUKNAGA, TANGERANG, BANTEN",6,93,121,214
https://kawalpemilu.org#52431,"TANJUNG PASIR, TELUKNAGA, TANGERANG, BANTEN",7,82,78,160
https://kawalpemilu.org#52431,"TANJUNG PASIR, TELUKNAGA, TANGERANG, BANTEN",9,111,153,264
https://kawalpemilu.org#52431,"TANJUNG PASIR, TELUKNAGA, TANGERANG, BANTEN",10,58,150,208
https://kawalpemilu.org#52431,"TANJUNG PASIR, TELUKNAGA, TANGERANG, BANTEN",11,53,120,173
https://kawalpemilu.org#52431,"TANJUNG PASIR, TELUKNAGA, TANGERANG, BANTEN",12,53,87,140
https://kawalpemilu.org#52431,"TANJUNG PASIR, TELUKNAGA, TANGERANG, BANTEN",13,59,100,159
https://kawalpemilu.org#52431,"TANJUNG PASIR, TELUKNAGA, TANGERANG, BANTEN",14,50,138,188
https://kawalpemilu.org#52431,"TANJUNG PASIR, TELUKNAGA, TANGERANG, BANTEN",16,81,96,177
https://kawalpemilu.org#52431,"TANJUNG PASIR, TELUKNAGA, TANGERANG, BANTEN",17,91,112,203
https://kawalpemilu.org#52431,"TANJUNG PASIR, TELUKNAGA, TANGERANG, BANTEN",18,76,98,174
https://kawalpemilu.org#52431,"TANJUNG PASIR, TELUKNAGA, TANGERANG, BANTEN",19,57,67,124
https://kawalpemilu.org#52431,"TANJUNG PASIR, TELUKNAGA, TANGERANG, BANTEN",20,99,153,252
https://kawalpemilu.org#52431,"TANJUNG PASIR, TELUKNAGA, TANGERANG, BANTEN",21,74,126,200
https://kawalpemilu.org#52431,"TANJUNG PASIR, TELUKNAGA, TANGERANG, BANTEN",22,95,168,263
https://kawalpemilu.org#52431,"TANJUNG PASIR, TELUKNAGA, TANGERANG, BANTEN",23,55,170,225
https://kawalpemilu.org#52431,"TANJUNG PASIR, TELUKNAGA, TANGERANG, BANTEN",24,47,155,202
https://kawalpemilu.org#52431,"TANJUNG PASIR, TELUKNAGA, TANGERANG, BANTEN",25,53,163,216
https://kawalpemilu.org#52431,"TANJUNG PASIR, TELUKNAGA, TANGERANG, BANTEN",26,70,136,206
https://kawalpemilu.org#52432,"TEGAL ANGUS, TELUKNAGA, TANGERANG, BANTEN",1,75,169,244
https://kawalpemilu.org#52432,"TEGAL ANGUS, TELUKNAGA, TANGERANG, BANTEN",3,107,124,231
https://kawalpemilu.org#52432,"TEGAL ANGUS, TELUKNAGA, TANGERANG, BANTEN",4,81,136,217
https://kawalpemilu.org#52432,"TEGAL ANGUS, TELUKNAGA, TANGERANG, BANTEN",13,90,132,222
https://kawalpemilu.org#52432,"TEGAL ANGUS, TELUKNAGA, TANGERANG, BANTEN",14,71,150,221
https://kawalpemilu.org#52432,"TEGAL ANGUS, TELUKNAGA, TANGERANG, BANTEN",15,78,151,229
https://kawalpemilu.org#52432,"TEGAL ANGUS, TELUKNAGA, TANGERANG, BANTEN",16,86,188,274
https://kawalpemilu.org#52432,"TEGAL ANGUS, TELUKNAGA, TANGERANG, BANTEN",19,65,179,244
https://kawalpemilu.org#52432,"TEGAL ANGUS, TELUKNAGA, TANGERANG, BANTEN",20,70,190,260
https://kawalpemilu.org#52432,"TEGAL ANGUS, TELUKNAGA, TANGERANG, BANTEN",21,90,141,231
https://kawalpemilu.org#52432,"TEGAL ANGUS, TELUKNAGA, TANGERANG, BANTEN",22,98,146,244
https://kawalpemilu.org#52432,"TEGAL ANGUS, TELUKNAGA, TANGERANG, BANTEN",23,113,141,254
https://kawalpemilu.org#52432,"TEGAL ANGUS, TELUKNAGA, TANGERANG, BANTEN",24,77,184,261
https://kawalpemilu.org#52433,"TANJUNG BURUNG, TELUKNAGA, TANGERANG, BANTEN",1,107,145,252
https://kawalpemilu.org#52433,"TANJUNG BURUNG, TELUKNAGA, TANGERANG, BANTEN",2,79,131,210
https://kawalpemilu.org#52433,"TANJUNG BURUNG, TELUKNAGA, TANGERANG, BANTEN",3,82,199,281
https://kawalpemilu.org#52433,"TANJUNG BURUNG, TELUKNAGA, TANGERANG, BANTEN",4,85,121,206
https://kawalpemilu.org#52433,"TANJUNG BURUNG, TELUKNAGA, TANGERANG, BANTEN",5,99,142,241
https://kawalpemilu.org#52433,"TANJUNG BURUNG, TELUKNAGA, TANGERANG, BANTEN",6,75,92,167
https://kawalpemilu.org#52433,"TANJUNG BURUNG, TELUKNAGA, TANGERANG, BANTEN",7,100,111,211
https://kawalpemilu.org#52433,"TANJUNG BURUNG, TELUKNAGA, TANGERANG, BANTEN",8,105,101,206
https://kawalpemilu.org#52433,"TANJUNG BURUNG, TELUKNAGA, TANGERANG, BANTEN",9,59,140,199
https://kawalpemilu.org#52433,"TANJUNG BURUNG, TELUKNAGA, TANGERANG, BANTEN",10,90,111,201
https://kawalpemilu.org#52433,"TANJUNG BURUNG, TELUKNAGA, TANGERANG, BANTEN",11,196,10,206
https://kawalpemilu.org#52433,"TANJUNG BURUNG, TELUKNAGA, TANGERANG, BANTEN",12,156,68,224
https://kawalpemilu.org#52433,"TANJUNG BURUNG, TELUKNAGA, TANGERANG, BANTEN",13,113,97,210
https://kawalpemilu.org#52433,"TANJUNG BURUNG, TELUKNAGA, TANGERANG, BANTEN",14,82,70,152
https://kawalpemilu.org#52433,"TANJUNG BURUNG, TELUKNAGA, TANGERANG, BANTEN",15,43,48,91
https://kawalpemilu.org#52433,"TANJUNG BURUNG, TELUKNAGA, TANGERANG, BANTEN",16,78,167,245
https://kawalpemilu.org#52433,"TANJUNG BURUNG, TELUKNAGA, TANGERANG, BANTEN",17,46,143,189
https://kawalpemilu.org#52433,"TANJUNG BURUNG, TELUKNAGA, TANGERANG, BANTEN",18,41,152,193
https://kawalpemilu.org#52433,"TANJUNG BURUNG, TELUKNAGA, TANGERANG, BANTEN",19,53,172,225
https://kawalpemilu.org#52433,"TANJUNG BURUNG, TELUKNAGA, TANGERANG, BANTEN",20,83,127,210
https://kawalpemilu.org#52433,"TANJUNG BURUNG, TELUKNAGA, TANGERANG, BANTEN",21,75,131,206
https://kawalpemilu.org#52433,"TANJUNG BURUNG, TELUKNAGA, TANGERANG, BANTEN",22,125,116,241
https://kawalpemilu.org#52434,"KAMPUNG BESAR, TELUKNAGA, TANGERANG, BANTEN",1,86,171,257
https://kawalpemilu.org#52434,"KAMPUNG BESAR, TELUKNAGA, TANGERANG, BANTEN",2,76,215,291
https://kawalpemilu.org#52434,"KAMPUNG BESAR, TELUKNAGA, TANGERANG, BANTEN",3,68,224,292
https://kawalpemilu.org#52434,"KAMPUNG BESAR, TELUKNAGA, TANGERANG, BANTEN",4,48,183,231
https://kawalpemilu.org#52434,"KAMPUNG BESAR, TELUKNAGA, TANGERANG, BANTEN",5,61,214,275
https://kawalpemilu.org#52434,"KAMPUNG BESAR, TELUKNAGA, TANGERANG, BANTEN",6,66,233,299
https://kawalpemilu.org#52434,"KAMPUNG BESAR, TELUKNAGA, TANGERANG, BANTEN",7,51,185,236
https://kawalpemilu.org#52434,"KAMPUNG BESAR, TELUKNAGA, TANGERANG, BANTEN",8,115,107,222
https://kawalpemilu.org#52434,"KAMPUNG BESAR, TELUKNAGA, TANGERANG, BANTEN",9,113,127,240
https://kawalpemilu.org#52434,"KAMPUNG BESAR, TELUKNAGA, TANGERANG, BANTEN",10,70,168,238
https://kawalpemilu.org#52434,"KAMPUNG BESAR, TELUKNAGA, TANGERANG, BANTEN",11,63,195,258
https://kawalpemilu.org#52434,"KAMPUNG BESAR, TELUKNAGA, TANGERANG, BANTEN",13,58,151,209
https://kawalpemilu.org#52434,"KAMPUNG BESAR, TELUKNAGA, TANGERANG, BANTEN",14,75,144,219
https://kawalpemilu.org#52434,"KAMPUNG BESAR, TELUKNAGA, TANGERANG, BANTEN",15,145,84,239
https://kawalpemilu.org#52434,"KAMPUNG BESAR, TELUKNAGA, TANGERANG, BANTEN",16,88,180,268
https://kawalpemilu.org#52434,"KAMPUNG BESAR, TELUKNAGA, TANGERANG, BANTEN",17,68,145,174
https://kawalpemilu.org#52434,"KAMPUNG BESAR, TELUKNAGA, TANGERANG, BANTEN",18,90,122,212
https://kawalpemilu.org#52434,"KAMPUNG BESAR, TELUKNAGA, TANGERANG, BANTEN",19,123,133,256
https://kawalpemilu.org#52434,"KAMPUNG BESAR, TELUKNAGA, TANGERANG, BANTEN",20,36,227,263
https://kawalpemilu.org#52434,"KAMPUNG BESAR, TELUKNAGA, TANGERANG, BANTEN",21,65,179,244
https://kawalpemilu.org#52434,"KAMPUNG BESAR, TELUKNAGA, TANGERANG, BANTEN",22,49,223,272
https://kawalpemilu.org#52434,"KAMPUNG BESAR, TELUKNAGA, TANGERANG, BANTEN",23,44,165,209
https://kawalpemilu.org#52434,"KAMPUNG BESAR, TELUKNAGA, TANGERANG, BANTEN",24,99,104,203
https://kawalpemilu.org#52434,"KAMPUNG BESAR, TELUKNAGA, TANGERANG, BANTEN",25,71,166,237
https://kawalpemilu.org#52434,"KAMPUNG BESAR, TELUKNAGA, TANGERANG, BANTEN",26,110,113,223
https://kawalpemilu.org#52434,"KAMPUNG BESAR, TELUKNAGA, TANGERANG, BANTEN",27,39,171,210
https://kawalpemilu.org#52434,"KAMPUNG BESAR, TELUKNAGA, TANGERANG, BANTEN",28,81,150,231
https://kawalpemilu.org#52434,"KAMPUNG BESAR, TELUKNAGA, TANGERANG, BANTEN",29,94,124,218
https://kawalpemilu.org#52434,"KAMPUNG BESAR, TELUKNAGA, TANGERANG, BANTEN",30,82,132,214
https://kawalpemilu.org#52434,"KAMPUNG BESAR, TELUKNAGA, TANGERANG, BANTEN",31,46,166,212
https://kawalpemilu.org#52434,"KAMPUNG BESAR, TELUKNAGA, TANGERANG, BANTEN",32,79,110,189
https://kawalpemilu.org#52436,"KOSAMBI BARAT, KOSAMBI, TANGERANG, BANTEN",4,112,46,158
https://kawalpemilu.org#52436,"KOSAMBI BARAT, KOSAMBI, TANGERANG, BANTEN",5,106,121,227
https://kawalpemilu.org#52436,"KOSAMBI BARAT, KOSAMBI, TANGERANG, BANTEN",6,135,82,217
https://kawalpemilu.org#52436,"KOSAMBI BARAT, KOSAMBI, TANGERANG, BANTEN",9,60,100,160
https://kawalpemilu.org#52436,"KOSAMBI BARAT, KOSAMBI, TANGERANG, BANTEN",10,65,81,146
https://kawalpemilu.org#52436,"KOSAMBI BARAT, KOSAMBI, TANGERANG, BANTEN",11,95,105,200
https://kawalpemilu.org#52436,"KOSAMBI BARAT, KOSAMBI, TANGERANG, BANTEN",12,90,66,156
https://kawalpemilu.org#52436,"KOSAMBI BARAT, KOSAMBI, TANGERANG, BANTEN",13,99,81,180
https://kawalpemilu.org#52436,"KOSAMBI BARAT, KOSAMBI, TANGERANG, BANTEN",14,82,47,129
https://kawalpemilu.org#52436,"KOSAMBI BARAT, KOSAMBI, TANGERANG, BANTEN",16,118,72,190
https://kawalpemilu.org#52436,"KOSAMBI BARAT, KOSAMBI, TANGERANG, BANTEN",17,136,86,222
https://kawalpemilu.org#52436,"KOSAMBI BARAT, KOSAMBI, TANGERANG, BANTEN",18,97,47,144
https://kawalpemilu.org#52436,"KOSAMBI BARAT, KOSAMBI, TANGERANG, BANTEN",19,95,60,155
https://kawalpemilu.org#52437,"SALEMBARAN JAYA, KOSAMBI, TANGERANG, BANTEN",1,41,171,212
https://kawalpemilu.org#52437,"SALEMBARAN JAYA, KOSAMBI, TANGERANG, BANTEN",2,65,81,146
https://kawalpemilu.org#52437,"SALEMBARAN JAYA, KOSAMBI, TANGERANG, BANTEN",3,52,129,181
https://kawalpemilu.org#52437,"SALEMBARAN JAYA, KOSAMBI, TANGERANG, BANTEN",4,70,81,151
https://kawalpemilu.org#52437,"SALEMBARAN JAYA, KOSAMBI, TANGERANG, BANTEN",5,98,114,212
https://kawalpemilu.org#52437,"SALEMBARAN JAYA, KOSAMBI, TANGERANG, BANTEN",6,83,95,178
https://kawalpemilu.org#52437,"SALEMBARAN JAYA, KOSAMBI, TANGERANG, BANTEN",7,59,200,259
https://kawalpemilu.org#52437,"SALEMBARAN JAYA, KOSAMBI, TANGERANG, BANTEN",8,90,133,223
https://kawalpemilu.org#52437,"SALEMBARAN JAYA, KOSAMBI, TANGERANG, BANTEN",9,129,56,185
https://kawalpemilu.org#52437,"SALEMBARAN JAYA, KOSAMBI, TANGERANG, BANTEN",10,95,89,184
https://kawalpemilu.org#52437,"SALEMBARAN JAYA, KOSAMBI, TANGERANG, BANTEN",11,117,81,198
https://kawalpemilu.org#52437,"SALEMBARAN JAYA, KOSAMBI, TANGERANG, BANTEN",12,93,68,161
https://kawalpemilu.org#52437,"SALEMBARAN JAYA, KOSAMBI, TANGERANG, BANTEN",13,141,68,209
https://kawalpemilu.org#52437,"SALEMBARAN JAYA, KOSAMBI, TANGERANG, BANTEN",14,101,78,179
https://kawalpemilu.org#52437,"SALEMBARAN JAYA, KOSAMBI, TANGERANG, BANTEN",15,110,59,169
https://kawalpemilu.org#52437,"SALEMBARAN JAYA, KOSAMBI, TANGERANG, BANTEN",16,13,27,40
https://kawalpemilu.org#52437,"SALEMBARAN JAYA, KOSAMBI, TANGERANG, BANTEN",17,99,164,263
https://kawalpemilu.org#52437,"SALEMBARAN JAYA, KOSAMBI, TANGERANG, BANTEN",18,71,92,163
https://kawalpemilu.org#52437,"SALEMBARAN JAYA, KOSAMBI, TANGERANG, BANTEN",19,72,64,136
https://kawalpemilu.org#52437,"SALEMBARAN JAYA, KOSAMBI, TANGERANG, BANTEN",20,32,135,167
https://kawalpemilu.org#52437,"SALEMBARAN JAYA, KOSAMBI, TANGERANG, BANTEN",21,77,106,183
https://kawalpemilu.org#52437,"SALEMBARAN JAYA, KOSAMBI, TANGERANG, BANTEN",22,41,150,191
https://kawalpemilu.org#52437,"SALEMBARAN JAYA, KOSAMBI, TANGERANG, BANTEN",23,30,146,176
https://kawalpemilu.org#52437,"SALEMBARAN JAYA, KOSAMBI, TANGERANG, BANTEN",24,72,97,169
https://kawalpemilu.org#52437,"SALEMBARAN JAYA, KOSAMBI, TANGERANG, BANTEN",25,76,93,168
https://kawalpemilu.org#52437,"SALEMBARAN JAYA, KOSAMBI, TANGERANG, BANTEN",26,57,98,155
https://kawalpemilu.org#52437,"SALEMBARAN JAYA, KOSAMBI, TANGERANG, BANTEN",27,77,142,219
https://kawalpemilu.org#52437,"SALEMBARAN JAYA, KOSAMBI, TANGERANG, BANTEN",28,105,106,211
https://kawalpemilu.org#52437,"SALEMBARAN JAYA, KOSAMBI, TANGERANG, BANTEN",29,118,82,200
https://kawalpemilu.org#52437,"SALEMBARAN JAYA, KOSAMBI, TANGERANG, BANTEN",30,106,163,269
https://kawalpemilu.org#52437,"SALEMBARAN JAYA, KOSAMBI, TANGERANG, BANTEN",31,100,105,205
https://kawalpemilu.org#52437,"SALEMBARAN JAYA, KOSAMBI, TANGERANG, BANTEN",32,104,98,202
https://kawalpemilu.org#52437,"SALEMBARAN JAYA, KOSAMBI, TANGERANG, BANTEN",33,141,77,218
https://kawalpemilu.org#52437,"SALEMBARAN JAYA, KOSAMBI, TANGERANG, BANTEN",34,113,74,187
https://kawalpemilu.org#52437,"SALEMBARAN JAYA, KOSAMBI, TANGERANG, BANTEN",35,74,91,165
https://kawalpemilu.org#52437,"SALEMBARAN JAYA, KOSAMBI, TANGERANG, BANTEN",36,107,82,189
https://kawalpemilu.org#52437,"SALEMBARAN JAYA, KOSAMBI, TANGERANG, BANTEN",37,138,73,211
https://kawalpemilu.org#52437,"SALEMBARAN JAYA, KOSAMBI, TANGERANG, BANTEN",38,67,76,143
https://kawalpemilu.org#52437,"SALEMBARAN JAYA, KOSAMBI, TANGERANG, BANTEN",39,87,77,164
https://kawalpemilu.org#52437,"SALEMBARAN JAYA, KOSAMBI, TANGERANG, BANTEN",40,81,86,167
https://kawalpemilu.org#52437,"SALEMBARAN JAYA, KOSAMBI, TANGERANG, BANTEN",41,81,67,148
https://kawalpemilu.org#52437,"SALEMBARAN JAYA, KOSAMBI, TANGERANG, BANTEN",42,144,26,170
https://kawalpemilu.org#52437,"SALEMBARAN JAYA, KOSAMBI, TANGERANG, BANTEN",44,61,90,151
https://kawalpemilu.org#52437,"SALEMBARAN JAYA, KOSAMBI, TANGERANG, BANTEN",45,78,118,196
https://kawalpemilu.org#52437,"SALEMBARAN JAYA, KOSAMBI, TANGERANG, BANTEN",46,56,106,162
https://kawalpemilu.org#52437,"SALEMBARAN JAYA, KOSAMBI, TANGERANG, BANTEN",47,58,83,141
https://kawalpemilu.org#52437,"SALEMBARAN JAYA, KOSAMBI, TANGERANG, BANTEN",48,113,82,195
https://kawalpemilu.org#52437,"SALEMBARAN JAYA, KOSAMBI, TANGERANG, BANTEN",49,114,114,228
https://kawalpemilu.org#52437,"SALEMBARAN JAYA, KOSAMBI, TANGERANG, BANTEN",50,63,142,205
https://kawalpemilu.org#52438,"DADAP, KOSAMBI, TANGERANG, BANTEN",1,47,67,114
https://kawalpemilu.org#52438,"DADAP, KOSAMBI, TANGERANG, BANTEN",2,76,112,188
https://kawalpemilu.org#52438,"DADAP, KOSAMBI, TANGERANG, BANTEN",3,102,81,183
https://kawalpemilu.org#52438,"DADAP, KOSAMBI, TANGERANG, BANTEN",4,124,99,223
https://kawalpemilu.org#52438,"DADAP, KOSAMBI, TANGERANG, BANTEN",6,170,89,259
https://kawalpemilu.org#52438,"DADAP, KOSAMBI, TANGERANG, BANTEN",7,124,123,247
https://kawalpemilu.org#52438,"DADAP, KOSAMBI, TANGERANG, BANTEN",8,89,111,200
https://kawalpemilu.org#52438,"DADAP, KOSAMBI, TANGERANG, BANTEN",9,58,92,150
https://kawalpemilu.org#52438,"DADAP, KOSAMBI, TANGERANG, BANTEN",10,78,53,131
https://kawalpemilu.org#52438,"DADAP, KOSAMBI, TANGERANG, BANTEN",11,61,74,135
https://kawalpemilu.org#52438,"DADAP, KOSAMBI, TANGERANG, BANTEN",12,81,100,181
https://kawalpemilu.org#52438,"DADAP, KOSAMBI, TANGERANG, BANTEN",13,52,69,121
https://kawalpemilu.org#52438,"DADAP, KOSAMBI, TANGERANG, BANTEN",14,70,67,137
https://kawalpemilu.org#52438,"DADAP, KOSAMBI, TANGERANG, BANTEN",15,64,74,138
https://kawalpemilu.org#52438,"DADAP, KOSAMBI, TANGERANG, BANTEN",16,80,60,140
https://kawalpemilu.org#52438,"DADAP, KOSAMBI, TANGERANG, BANTEN",17,54,59,113
https://kawalpemilu.org#52438,"DADAP, KOSAMBI, TANGERANG, BANTEN",18,64,64,128
https://kawalpemilu.org#52438,"DADAP, KOSAMBI, TANGERANG, BANTEN",19,66,67,133
https://kawalpemilu.org#52438,"DADAP, KOSAMBI, TANGERANG, BANTEN",20,107,85,192
https://kawalpemilu.org#52438,"DADAP, KOSAMBI, TANGERANG, BANTEN",21,73,39,112
https://kawalpemilu.org#52438,"DADAP, KOSAMBI, TANGERANG, BANTEN",22,86,115,201
https://kawalpemilu.org#52438,"DADAP, KOSAMBI, TANGERANG, BANTEN",23,104,124,228
https://kawalpemilu.org#52438,"DADAP, KOSAMBI, TANGERANG, BANTEN",24,50,115,165
https://kawalpemilu.org#52438,"DADAP, KOSAMBI, TANGERANG, BANTEN",25,102,123,225
https://kawalpemilu.org#52438,"DADAP, KOSAMBI, TANGERANG, BANTEN",26,89,94,183
https://kawalpemilu.org#52438,"DADAP, KOSAMBI, TANGERANG, BANTEN",27,78,70,148
https://kawalpemilu.org#52438,"DADAP, KOSAMBI, TANGERANG, BANTEN",29,118,37,155
https://kawalpemilu.org#52438,"DADAP, KOSAMBI, TANGERANG, BANTEN",30,84,69,153
https://kawalpemilu.org#52438,"DADAP, KOSAMBI, TANGERANG, BANTEN",31,188,5,193
https://kawalpemilu.org#52438,"DADAP, KOSAMBI, TANGERANG, BANTEN",32,185,6,191
https://kawalpemilu.org#52438,"DADAP, KOSAMBI, TANGERANG, BANTEN",33,162,11,173
https://kawalpemilu.org#52438,"DADAP, KOSAMBI, TANGERANG, BANTEN",34,155,2,157
https://kawalpemilu.org#52438,"DADAP, KOSAMBI, TANGERANG, BANTEN",36,146,8,154
https://kawalpemilu.org#52438,"DADAP, KOSAMBI, TANGERANG, BANTEN",37,192,14,206
https://kawalpemilu.org#52438,"DADAP, KOSAMBI, TANGERANG, BANTEN",39,246,17,263
https://kawalpemilu.org#52438,"DADAP, KOSAMBI, TANGERANG, BANTEN",41,124,26,150
https://kawalpemilu.org#52438,"DADAP, KOSAMBI, TANGERANG, BANTEN",42,136,5,141
https://kawalpemilu.org#52438,"DADAP, KOSAMBI, TANGERANG, BANTEN",43,123,1,124
https://kawalpemilu.org#52438,"DADAP, KOSAMBI, TANGERANG, BANTEN",44,153,4,157
https://kawalpemilu.org#52438,"DADAP, KOSAMBI, TANGERANG, BANTEN",45,157,13,170
https://kawalpemilu.org#52438,"DADAP, KOSAMBI, TANGERANG, BANTEN",46,72,1,73
https://kawalpemilu.org#52438,"DADAP, KOSAMBI, TANGERANG, BANTEN",47,108,5,113
https://kawalpemilu.org#52438,"DADAP, KOSAMBI, TANGERANG, BANTEN",48,204,10,214
https://kawalpemilu.org#52438,"DADAP, KOSAMBI, TANGERANG, BANTEN",49,210,16,226
https://kawalpemilu.org#52438,"DADAP, KOSAMBI, TANGERANG, BANTEN",50,208,14,222
https://kawalpemilu.org#52438,"DADAP, KOSAMBI, TANGERANG, BANTEN",52,155,8,163
https://kawalpemilu.org#52438,"DADAP, KOSAMBI, TANGERANG, BANTEN",54,132,29,161
https://kawalpemilu.org#52438,"DADAP, KOSAMBI, TANGERANG, BANTEN",55,92,46,138
https://kawalpemilu.org#52438,"DADAP, KOSAMBI, TANGERANG, BANTEN",56,106,39,145
https://kawalpemilu.org#52438,"DADAP, KOSAMBI, TANGERANG, BANTEN",57,133,4,137
https://kawalpemilu.org#52438,"DADAP, KOSAMBI, TANGERANG, BANTEN",58,103,22,125
https://kawalpemilu.org#52438,"DADAP, KOSAMBI, TANGERANG, BANTEN",59,100,41,141
https://kawalpemilu.org#52438,"DADAP, KOSAMBI, TANGERANG, BANTEN",60,65,43,108
https://kawalpemilu.org#52438,"DADAP, KOSAMBI, TANGERANG, BANTEN",61,85,59,144
https://kawalpemilu.org#52438,"DADAP, KOSAMBI, TANGERANG, BANTEN",62,71,55,126
https://kawalpemilu.org#52438,"DADAP, KOSAMBI, TANGERANG, BANTEN",63,80,55,135
https://kawalpemilu.org#52438,"DADAP, KOSAMBI, TANGERANG, BANTEN",64,68,58,126
https://kawalpemilu.org#52438,"DADAP, KOSAMBI, TANGERANG, BANTEN",65,93,64,157
https://kawalpemilu.org#52438,"DADAP, KOSAMBI, TANGERANG, BANTEN",66,87,44,131
https://kawalpemilu.org#52438,"DADAP, KOSAMBI, TANGERANG, BANTEN",67,68,53,121
https://kawalpemilu.org#52439,"KOSAMBI TIMUR, KOSAMBI, TANGERANG, BANTEN",1,108,127,235
https://kawalpemilu.org#52439,"KOSAMBI TIMUR, KOSAMBI, TANGERANG, BANTEN",2,84,142,226
https://kawalpemilu.org#52439,"KOSAMBI TIMUR, KOSAMBI, TANGERANG, BANTEN",3,142,90,232
https://kawalpemilu.org#52439,"KOSAMBI TIMUR, KOSAMBI, TANGERANG, BANTEN",4,124,115,239
https://kawalpemilu.org#52439,"KOSAMBI TIMUR, KOSAMBI, TANGERANG, BANTEN",5,148,33,181
https://kawalpemilu.org#52439,"KOSAMBI TIMUR, KOSAMBI, TANGERANG, BANTEN",6,127,124,251
https://kawalpemilu.org#52439,"KOSAMBI TIMUR, KOSAMBI, TANGERANG, BANTEN",7,60,87,147
https://kawalpemilu.org#52439,"KOSAMBI TIMUR, KOSAMBI, TANGERANG, BANTEN",8,138,106,244
https://kawalpemilu.org#52439,"KOSAMBI TIMUR, KOSAMBI, TANGERANG, BANTEN",9,114,129,243
https://kawalpemilu.org#52439,"KOSAMBI TIMUR, KOSAMBI, TANGERANG, BANTEN",10,92,140,232
https://kawalpemilu.org#52439,"KOSAMBI TIMUR, KOSAMBI, TANGERANG, BANTEN",11,107,101,208
https://kawalpemilu.org#52439,"KOSAMBI TIMUR, KOSAMBI, TANGERANG, BANTEN",12,105,141,246
https://kawalpemilu.org#52439,"KOSAMBI TIMUR, KOSAMBI, TANGERANG, BANTEN",13,136,106,242
https://kawalpemilu.org#52439,"KOSAMBI TIMUR, KOSAMBI, TANGERANG, BANTEN",14,112,77,189
https://kawalpemilu.org#52439,"KOSAMBI TIMUR, KOSAMBI, TANGERANG, BANTEN",15,263,11,274
https://kawalpemilu.org#52439,"KOSAMBI TIMUR, KOSAMBI, TANGERANG, BANTEN",16,94,99,193
https://kawalpemilu.org#52439,"KOSAMBI TIMUR, KOSAMBI, TANGERANG, BANTEN",17,84,84,168
https://kawalpemilu.org#52439,"KOSAMBI TIMUR, KOSAMBI, TANGERANG, BANTEN",18,107,49,156
https://kawalpemilu.org#52439,"KOSAMBI TIMUR, KOSAMBI, TANGERANG, BANTEN",19,134,108,242
https://kawalpemilu.org#52439,"KOSAMBI TIMUR, KOSAMBI, TANGERANG, BANTEN",21,83,73,156
https://kawalpemilu.org#52439,"KOSAMBI TIMUR, KOSAMBI, TANGERANG, BANTEN",22,123,67,190
https://kawalpemilu.org#52439,"KOSAMBI TIMUR, KOSAMBI, TANGERANG, BANTEN",23,106,159,265
https://kawalpemilu.org#52439,"KOSAMBI TIMUR, KOSAMBI, TANGERANG, BANTEN",24,58,88,146
https://kawalpemilu.org#52439,"KOSAMBI TIMUR, KOSAMBI, TANGERANG, BANTEN",25,106,117,223
https://kawalpemilu.org#52439,"KOSAMBI TIMUR, KOSAMBI, TANGERANG, BANTEN",26,94,60,154
https://kawalpemilu.org#52439,"KOSAMBI TIMUR, KOSAMBI, TANGERANG, BANTEN",27,210,17,227
https://kawalpemilu.org#52440,"SALEMBARAN JATI, KOSAMBI, TANGERANG, BANTEN",1,59,58,117
https://kawalpemilu.org#52440,"SALEMBARAN JATI, KOSAMBI, TANGERANG, BANTEN",2,91,90,181
https://kawalpemilu.org#52440,"SALEMBARAN JATI, KOSAMBI, TANGERANG, BANTEN",7,90,94,184
https://kawalpemilu.org#52440,"SALEMBARAN JATI, KOSAMBI, TANGERANG, BANTEN",9,88,60,148
https://kawalpemilu.org#52440,"SALEMBARAN JATI, KOSAMBI, TANGERANG, BANTEN",10,39,61,100
https://kawalpemilu.org#52440,"SALEMBARAN JATI, KOSAMBI, TANGERANG, BANTEN",11,75,55,130
https://kawalpemilu.org#52440,"SALEMBARAN JATI, KOSAMBI, TANGERANG, BANTEN",12,71,43,114
https://kawalpemilu.org#52440,"SALEMBARAN JATI, KOSAMBI, TANGERANG, BANTEN",13,63,79,142
https://kawalpemilu.org#52440,"SALEMBARAN JATI, KOSAMBI, TANGERANG, BANTEN",14,68,100,168
https://kawalpemilu.org#52440,"SALEMBARAN JATI, KOSAMBI, TANGERANG, BANTEN",17,65,86,151
https://kawalpemilu.org#52440,"SALEMBARAN JATI, KOSAMBI, TANGERANG, BANTEN",19,103,32,135
https://kawalpemilu.org#52440,"SALEMBARAN JATI, KOSAMBI, TANGERANG, BANTEN",20,69,71,140
https://kawalpemilu.org#52441,"RAWA RENGAS, KOSAMBI, TANGERANG, BANTEN",2,36,132,168
https://kawalpemilu.org#52441,"RAWA RENGAS, KOSAMBI, TANGERANG, BANTEN",3,81,175,256
https://kawalpemilu.org#52441,"RAWA RENGAS, KOSAMBI, TANGERANG, BANTEN",4,68,132,200
https://kawalpemilu.org#52441,"RAWA RENGAS, KOSAMBI, TANGERANG, BANTEN",5,51,155,206
https://kawalpemilu.org#52441,"RAWA RENGAS, KOSAMBI, TANGERANG, BANTEN",6,49,115,164
https://kawalpemilu.org#52441,"RAWA RENGAS, KOSAMBI, TANGERANG, BANTEN",7,37,134,171
https://kawalpemilu.org#52441,"RAWA RENGAS, KOSAMBI, TANGERANG, BANTEN",8,75,137,212
https://kawalpemilu.org#52441,"RAWA RENGAS, KOSAMBI, TANGERANG, BANTEN",9,43,109,152
https://kawalpemilu.org#52441,"RAWA RENGAS, KOSAMBI, TANGERANG, BANTEN",10,16,130,146
https://kawalpemilu.org#52441,"RAWA RENGAS, KOSAMBI, TANGERANG, BANTEN",11,34,99,133
https://kawalpemilu.org#52441,"RAWA RENGAS, KOSAMBI, TANGERANG, BANTEN",12,32,143,175
https://kawalpemilu.org#52441,"RAWA RENGAS, KOSAMBI, TANGERANG, BANTEN",13,63,129,192
https://kawalpemilu.org#52441,"RAWA RENGAS, KOSAMBI, TANGERANG, BANTEN",14,32,143,175
https://kawalpemilu.org#52441,"RAWA RENGAS, KOSAMBI, TANGERANG, BANTEN",15,43,143,186
https://kawalpemilu.org#52441,"RAWA RENGAS, KOSAMBI, TANGERANG, BANTEN",16,41,180,221
https://kawalpemilu.org#52441,"RAWA RENGAS, KOSAMBI, TANGERANG, BANTEN",17,43,129,172
https://kawalpemilu.org#52441,"RAWA RENGAS, KOSAMBI, TANGERANG, BANTEN",18,61,157,218
https://kawalpemilu.org#52441,"RAWA RENGAS, KOSAMBI, TANGERANG, BANTEN",19,74,160,234
https://kawalpemilu.org#52441,"RAWA RENGAS, KOSAMBI, TANGERANG, BANTEN",20,75,135,210
https://kawalpemilu.org#52441,"RAWA RENGAS, KOSAMBI, TANGERANG, BANTEN",21,54,138,192
https://kawalpemilu.org#52441,"RAWA RENGAS, KOSAMBI, TANGERANG, BANTEN",22,56,103,159
https://kawalpemilu.org#52441,"RAWA RENGAS, KOSAMBI, TANGERANG, BANTEN",23,44,119,163
https://kawalpemilu.org#52441,"RAWA RENGAS, KOSAMBI, TANGERANG, BANTEN",24,19,133,152
https://kawalpemilu.org#52441,"RAWA RENGAS, KOSAMBI, TANGERANG, BANTEN",25,35,108,143
https://kawalpemilu.org#52441,"RAWA RENGAS, KOSAMBI, TANGERANG, BANTEN",26,86,86,172
https://kawalpemilu.org#52441,"RAWA RENGAS, KOSAMBI, TANGERANG, BANTEN",27,44,83,127
https://kawalpemilu.org#52441,"RAWA RENGAS, KOSAMBI, TANGERANG, BANTEN",28,53,57,110
https://kawalpemilu.org#52441,"RAWA RENGAS, KOSAMBI, TANGERANG, BANTEN",29,92,139,231
https://kawalpemilu.org#52442,"RAWA BURUNG, KOSAMBI, TANGERANG, BANTEN",1,27,218,245
https://kawalpemilu.org#52442,"RAWA BURUNG, KOSAMBI, TANGERANG, BANTEN",2,58,160,218
https://kawalpemilu.org#52442,"RAWA BURUNG, KOSAMBI, TANGERANG, BANTEN",3,83,112,195
https://kawalpemilu.org#52442,"RAWA BURUNG, KOSAMBI, TANGERANG, BANTEN",4,65,93,158
https://kawalpemilu.org#52442,"RAWA BURUNG, KOSAMBI, TANGERANG, BANTEN",5,58,179,237
https://kawalpemilu.org#52442,"RAWA BURUNG, KOSAMBI, TANGERANG, BANTEN",6,43,180,223
https://kawalpemilu.org#52442,"RAWA BURUNG, KOSAMBI, TANGERANG, BANTEN",7,94,166,260
https://kawalpemilu.org#52442,"RAWA BURUNG, KOSAMBI, TANGERANG, BANTEN",8,27,165,192
https://kawalpemilu.org#52442,"RAWA BURUNG, KOSAMBI, TANGERANG, BANTEN",9,53,161,214
https://kawalpemilu.org#52442,"RAWA BURUNG, KOSAMBI, TANGERANG, BANTEN",10,52,190,242
https://kawalpemilu.org#52442,"RAWA BURUNG, KOSAMBI, TANGERANG, BANTEN",11,27,181,208
https://kawalpemilu.org#52442,"RAWA BURUNG, KOSAMBI, TANGERANG, BANTEN",12,16,172,188
https://kawalpemilu.org#52442,"RAWA BURUNG, KOSAMBI, TANGERANG, BANTEN",13,40,139,179
https://kawalpemilu.org#52442,"RAWA BURUNG, KOSAMBI, TANGERANG, BANTEN",14,44,166,210
https://kawalpemilu.org#52442,"RAWA BURUNG, KOSAMBI, TANGERANG, BANTEN",15,47,193,240
https://kawalpemilu.org#52442,"RAWA BURUNG, KOSAMBI, TANGERANG, BANTEN",16,83,117,200
https://kawalpemilu.org#52442,"RAWA BURUNG, KOSAMBI, TANGERANG, BANTEN",17,31,174,205
https://kawalpemilu.org#52442,"RAWA BURUNG, KOSAMBI, TANGERANG, BANTEN",18,85,132,217
https://kawalpemilu.org#52442,"RAWA BURUNG, KOSAMBI, TANGERANG, BANTEN",19,35,167,202
https://kawalpemilu.org#52442,"RAWA BURUNG, KOSAMBI, TANGERANG, BANTEN",20,30,149,179
https://kawalpemilu.org#52442,"RAWA BURUNG, KOSAMBI, TANGERANG, BANTEN",22,58,157,215
https://kawalpemilu.org#52442,"RAWA BURUNG, KOSAMBI, TANGERANG, BANTEN",23,23,156,179
https://kawalpemilu.org#52442,"RAWA BURUNG, KOSAMBI, TANGERANG, BANTEN",25,53,188,241
https://kawalpemilu.org#52443,"CENGKLONG, KOSAMBI, TANGERANG, BANTEN",2,80,101,181
https://kawalpemilu.org#52443,"CENGKLONG, KOSAMBI, TANGERANG, BANTEN",3,72,96,168
https://kawalpemilu.org#52443,"CENGKLONG, KOSAMBI, TANGERANG, BANTEN",4,108,104,212
https://kawalpemilu.org#52443,"CENGKLONG, KOSAMBI, TANGERANG, BANTEN",5,113,70,183
https://kawalpemilu.org#52443,"CENGKLONG, KOSAMBI, TANGERANG, BANTEN",6,109,81,190
https://kawalpemilu.org#52443,"CENGKLONG, KOSAMBI, TANGERANG, BANTEN",7,119,118,237
https://kawalpemilu.org#52443,"CENGKLONG, KOSAMBI, TANGERANG, BANTEN",8,82,128,210
https://kawalpemilu.org#52443,"CENGKLONG, KOSAMBI, TANGERANG, BANTEN",9,74,84,158
https://kawalpemilu.org#52443,"CENGKLONG, KOSAMBI, TANGERANG, BANTEN",10,55,134,189
https://kawalpemilu.org#52443,"CENGKLONG, KOSAMBI, TANGERANG, BANTEN",11,191,1,192
https://kawalpemilu.org#52443,"CENGKLONG, KOSAMBI, TANGERANG, BANTEN",12,231,5,236
https://kawalpemilu.org#52443,"CENGKLONG, KOSAMBI, TANGERANG, BANTEN",13,145,17,162
https://kawalpemilu.org#52443,"CENGKLONG, KOSAMBI, TANGERANG, BANTEN",14,53,72,125
https://kawalpemilu.org#52443,"CENGKLONG, KOSAMBI, TANGERANG, BANTEN",15,63,79,142
https://kawalpemilu.org#52443,"CENGKLONG, KOSAMBI, TANGERANG, BANTEN",16,65,60,125
https://kawalpemilu.org#52443,"CENGKLONG, KOSAMBI, TANGERANG, BANTEN",17,99,81,180
https://kawalpemilu.org#52443,"CENGKLONG, KOSAMBI, TANGERANG, BANTEN",18,79,56,135
https://kawalpemilu.org#52443,"CENGKLONG, KOSAMBI, TANGERANG, BANTEN",19,55,89,144
https://kawalpemilu.org#52443,"CENGKLONG, KOSAMBI, TANGERANG, BANTEN",20,84,96,180
https://kawalpemilu.org#52443,"CENGKLONG, KOSAMBI, TANGERANG, BANTEN",21,76,72,148
https://kawalpemilu.org#52443,"CENGKLONG, KOSAMBI, TANGERANG, BANTEN",22,63,72,135
https://kawalpemilu.org#52443,"CENGKLONG, KOSAMBI, TANGERANG, BANTEN",23,117,106,223
https://kawalpemilu.org#52443,"CENGKLONG, KOSAMBI, TANGERANG, BANTEN",24,76,103,179
https://kawalpemilu.org#52443,"CENGKLONG, KOSAMBI, TANGERANG, BANTEN",25,83,95,178
https://kawalpemilu.org#52443,"CENGKLONG, KOSAMBI, TANGERANG, BANTEN",26,65,99,164
https://kawalpemilu.org#52443,"CENGKLONG, KOSAMBI, TANGERANG, BANTEN",27,78,78,156
https://kawalpemilu.org#52443,"CENGKLONG, KOSAMBI, TANGERANG, BANTEN",28,87,144,231
https://kawalpemilu.org#52443,"CENGKLONG, KOSAMBI, TANGERANG, BANTEN",30,94,144,238
https://kawalpemilu.org#52443,"CENGKLONG, KOSAMBI, TANGERANG, BANTEN",31,91,93,184
https://kawalpemilu.org#52443,"CENGKLONG, KOSAMBI, TANGERANG, BANTEN",33,62,131,193
https://kawalpemilu.org#52443,"CENGKLONG, KOSAMBI, TANGERANG, BANTEN",34,109,106,215
https://kawalpemilu.org#52443,"CENGKLONG, KOSAMBI, TANGERANG, BANTEN",35,186,1,187
https://kawalpemilu.org#52443,"CENGKLONG, KOSAMBI, TANGERANG, BANTEN",36,74,88,162
https://kawalpemilu.org#52443,"CENGKLONG, KOSAMBI, TANGERANG, BANTEN",37,42,90,132
https://kawalpemilu.org#52443,"CENGKLONG, KOSAMBI, TANGERANG, BANTEN",38,51,83,134
https://kawalpemilu.org#52443,"CENGKLONG, KOSAMBI, TANGERANG, BANTEN",39,78,75,153
https://kawalpemilu.org#52444,"BELIMBING, KOSAMBI, TANGERANG, BANTEN",1,248,8,256
https://kawalpemilu.org#52444,"BELIMBING, KOSAMBI, TANGERANG, BANTEN",2,93,153,246
https://kawalpemilu.org#52444,"BELIMBING, KOSAMBI, TANGERANG, BANTEN",3,74,148,222
https://kawalpemilu.org#52444,"BELIMBING, KOSAMBI, TANGERANG, BANTEN",4,167,31,198
https://kawalpemilu.org#52444,"BELIMBING, KOSAMBI, TANGERANG, BANTEN",5,108,115,223
https://kawalpemilu.org#52444,"BELIMBING, KOSAMBI, TANGERANG, BANTEN",6,154,89,243
https://kawalpemilu.org#52444,"BELIMBING, KOSAMBI, TANGERANG, BANTEN",7,100,90,190
https://kawalpemilu.org#52444,"BELIMBING, KOSAMBI, TANGERANG, BANTEN",8,80,80,160
https://kawalpemilu.org#52444,"BELIMBING, KOSAMBI, TANGERANG, BANTEN",9,65,162,227
https://kawalpemilu.org#52444,"BELIMBING, KOSAMBI, TANGERANG, BANTEN",10,115,130,245
https://kawalpemilu.org#52444,"BELIMBING, KOSAMBI, TANGERANG, BANTEN",11,121,132,253
https://kawalpemilu.org#52444,"BELIMBING, KOSAMBI, TANGERANG, BANTEN",12,98,80,178
https://kawalpemilu.org#52444,"BELIMBING, KOSAMBI, TANGERANG, BANTEN",13,107,83,190
https://kawalpemilu.org#52444,"BELIMBING, KOSAMBI, TANGERANG, BANTEN",14,132,96,228
https://kawalpemilu.org#52444,"BELIMBING, KOSAMBI, TANGERANG, BANTEN",15,117,88,205
https://kawalpemilu.org#52444,"BELIMBING, KOSAMBI, TANGERANG, BANTEN",17,240,5,245
https://kawalpemilu.org#52444,"BELIMBING, KOSAMBI, TANGERANG, BANTEN",18,103,126,229
https://kawalpemilu.org#52444,"BELIMBING, KOSAMBI, TANGERANG, BANTEN",19,80,102,182
https://kawalpemilu.org#52444,"BELIMBING, KOSAMBI, TANGERANG, BANTEN",20,66,95,161
https://kawalpemilu.org#52444,"BELIMBING, KOSAMBI, TANGERANG, BANTEN",21,74,145,219
https://kawalpemilu.org#52444,"BELIMBING, KOSAMBI, TANGERANG, BANTEN",22,83,159,242
https://kawalpemilu.org#52444,"BELIMBING, KOSAMBI, TANGERANG, BANTEN",23,52,167,219
https://kawalpemilu.org#52444,"BELIMBING, KOSAMBI, TANGERANG, BANTEN",24,72,118,190
https://kawalpemilu.org#52444,"BELIMBING, KOSAMBI, TANGERANG, BANTEN",25,135,74,209
https://kawalpemilu.org#52444,"BELIMBING, KOSAMBI, TANGERANG, BANTEN",26,80,127,207
https://kawalpemilu.org#52444,"BELIMBING, KOSAMBI, TANGERANG, BANTEN",27,175,70,245
https://kawalpemilu.org#52444,"BELIMBING, KOSAMBI, TANGERANG, BANTEN",28,95,129,224
https://kawalpemilu.org#52444,"BELIMBING, KOSAMBI, TANGERANG, BANTEN",29,103,93,196
https://kawalpemilu.org#52444,"BELIMBING, KOSAMBI, TANGERANG, BANTEN",30,97,112,209
https://kawalpemilu.org#52444,"BELIMBING, KOSAMBI, TANGERANG, BANTEN",31,112,83,195
https://kawalpemilu.org#52444,"BELIMBING, KOSAMBI, TANGERANG, BANTEN",32,99,89,188
https://kawalpemilu.org#52444,"BELIMBING, KOSAMBI, TANGERANG, BANTEN",33,97,114,211
https://kawalpemilu.org#52444,"BELIMBING, KOSAMBI, TANGERANG, BANTEN",34,94,103,197
https://kawalpemilu.org#52444,"BELIMBING, KOSAMBI, TANGERANG, BANTEN",35,96,93,189
https://kawalpemilu.org#52444,"BELIMBING, KOSAMBI, TANGERANG, BANTEN",36,57,109,166
https://kawalpemilu.org#52444,"BELIMBING, KOSAMBI, TANGERANG, BANTEN",37,90,110,200
https://kawalpemilu.org#52445,"JATI MULYA, KOSAMBI, TANGERANG, BANTEN",1,83,141,224
https://kawalpemilu.org#52445,"JATI MULYA, KOSAMBI, TANGERANG, BANTEN",2,50,203,253
https://kawalpemilu.org#52445,"JATI MULYA, KOSAMBI, TANGERANG, BANTEN",3,66,181,247
https://kawalpemilu.org#52445,"JATI MULYA, KOSAMBI, TANGERANG, BANTEN",4,49,102,151
https://kawalpemilu.org#52445,"JATI MULYA, KOSAMBI, TANGERANG, BANTEN",5,82,99,181
https://kawalpemilu.org#52445,"JATI MULYA, KOSAMBI, TANGERANG, BANTEN",6,123,44,167
https://kawalpemilu.org#52445,"JATI MULYA, KOSAMBI, TANGERANG, BANTEN",7,117,162,279
https://kawalpemilu.org#52445,"JATI MULYA, KOSAMBI, TANGERANG, BANTEN",8,78,79,157
https://kawalpemilu.org#52445,"JATI MULYA, KOSAMBI, TANGERANG, BANTEN",9,142,64,206
https://kawalpemilu.org#52445,"JATI MULYA, KOSAMBI, TANGERANG, BANTEN",11,87,56,143
https://kawalpemilu.org#52445,"JATI MULYA, KOSAMBI, TANGERANG, BANTEN",12,220,40,260
https://kawalpemilu.org#52445,"JATI MULYA, KOSAMBI, TANGERANG, BANTEN",16,53,96,149
https://kawalpemilu.org#52445,"JATI MULYA, KOSAMBI, TANGERANG, BANTEN",17,52,86,138
https://kawalpemilu.org#52445,"JATI MULYA, KOSAMBI, TANGERANG, BANTEN",18,79,103,182
https://kawalpemilu.org#52445,"JATI MULYA, KOSAMBI, TANGERANG, BANTEN",19,89,148,237
https://kawalpemilu.org#52445,"JATI MULYA, KOSAMBI, TANGERANG, BANTEN",20,26,83,109
https://kawalpemilu.org#52445,"JATI MULYA, KOSAMBI, TANGERANG, BANTEN",21,49,112,161
https://kawalpemilu.org#52445,"JATI MULYA, KOSAMBI, TANGERANG, BANTEN",22,42,68,102
https://kawalpemilu.org#52445,"JATI MULYA, KOSAMBI, TANGERANG, BANTEN",24,125,37,162
https://kawalpemilu.org#52445,"JATI MULYA, KOSAMBI, TANGERANG, BANTEN",25,163,23,186
https://kawalpemilu.org#52445,"JATI MULYA, KOSAMBI, TANGERANG, BANTEN",26,134,15,149
https://kawalpemilu.org#52445,"JATI MULYA, KOSAMBI, TANGERANG, BANTEN",27,135,24,159
https://kawalpemilu.org#52447,"PAKUHAJI, PAKUHAJI, TANGERANG, BANTEN",1,45,175,220
https://kawalpemilu.org#52447,"PAKUHAJI, PAKUHAJI, TANGERANG, BANTEN",2,29,100,129
https://kawalpemilu.org#52447,"PAKUHAJI, PAKUHAJI, TANGERANG, BANTEN",3,95,89,184
https://kawalpemilu.org#52447,"PAKUHAJI, PAKUHAJI, TANGERANG, BANTEN",6,107,119,226
https://kawalpemilu.org#52447,"PAKUHAJI, PAKUHAJI, TANGERANG, BANTEN",7,128,73,201
https://kawalpemilu.org#52447,"PAKUHAJI, PAKUHAJI, TANGERANG, BANTEN",8,64,91,155
https://kawalpemilu.org#52447,"PAKUHAJI, PAKUHAJI, TANGERANG, BANTEN",9,73,126,199
https://kawalpemilu.org#52447,"PAKUHAJI, PAKUHAJI, TANGERANG, BANTEN",10,64,165,229
https://kawalpemilu.org#52447,"PAKUHAJI, PAKUHAJI, TANGERANG, BANTEN",11,51,116,167
https://kawalpemilu.org#52447,"PAKUHAJI, PAKUHAJI, TANGERANG, BANTEN",13,59,117,176
https://kawalpemilu.org#52447,"PAKUHAJI, PAKUHAJI, TANGERANG, BANTEN",14,74,154,228
https://kawalpemilu.org#52447,"PAKUHAJI, PAKUHAJI, TANGERANG, BANTEN",17,58,130,188
https://kawalpemilu.org#52447,"PAKUHAJI, PAKUHAJI, TANGERANG, BANTEN",21,34,122,156
https://kawalpemilu.org#52447,"PAKUHAJI, PAKUHAJI, TANGERANG, BANTEN",22,55,84,139
https://kawalpemilu.org#52447,"PAKUHAJI, PAKUHAJI, TANGERANG, BANTEN",23,36,92,128
https://kawalpemilu.org#52447,"PAKUHAJI, PAKUHAJI, TANGERANG, BANTEN",24,81,102,183
https://kawalpemilu.org#52447,"PAKUHAJI, PAKUHAJI, TANGERANG, BANTEN",25,76,108,184
https://kawalpemilu.org#52447,"PAKUHAJI, PAKUHAJI, TANGERANG, BANTEN",26,40,104,144
https://kawalpemilu.org#52447,"PAKUHAJI, PAKUHAJI, TANGERANG, BANTEN",27,58,106,164
https://kawalpemilu.org#52447,"PAKUHAJI, PAKUHAJI, TANGERANG, BANTEN",28,53,117,170
https://kawalpemilu.org#52447,"PAKUHAJI, PAKUHAJI, TANGERANG, BANTEN",29,32,97,129
https://kawalpemilu.org#52447,"PAKUHAJI, PAKUHAJI, TANGERANG, BANTEN",31,75,104,179
https://kawalpemilu.org#52447,"PAKUHAJI, PAKUHAJI, TANGERANG, BANTEN",32,77,158,235
https://kawalpemilu.org#52447,"PAKUHAJI, PAKUHAJI, TANGERANG, BANTEN",33,22,76,98
https://kawalpemilu.org#52447,"PAKUHAJI, PAKUHAJI, TANGERANG, BANTEN",34,54,123,177
https://kawalpemilu.org#52447,"PAKUHAJI, PAKUHAJI, TANGERANG, BANTEN",35,64,58,122
https://kawalpemilu.org#52447,"PAKUHAJI, PAKUHAJI, TANGERANG, BANTEN",36,64,94,158
https://kawalpemilu.org#52447,"PAKUHAJI, PAKUHAJI, TANGERANG, BANTEN",37,65,117,182
https://kawalpemilu.org#52447,"PAKUHAJI, PAKUHAJI, TANGERANG, BANTEN",38,40,116,156
https://kawalpemilu.org#52447,"PAKUHAJI, PAKUHAJI, TANGERANG, BANTEN",39,53,148,201
https://kawalpemilu.org#52448,"PAKU ALAM, PAKUHAJI, TANGERANG, BANTEN",1,47,146,193
https://kawalpemilu.org#52448,"PAKU ALAM, PAKUHAJI, TANGERANG, BANTEN",2,43,82,125
https://kawalpemilu.org#52448,"PAKU ALAM, PAKUHAJI, TANGERANG, BANTEN",3,32,107,139
https://kawalpemilu.org#52448,"PAKU ALAM, PAKUHAJI, TANGERANG, BANTEN",4,40,130,170
https://kawalpemilu.org#52448,"PAKU ALAM, PAKUHAJI, TANGERANG, BANTEN",6,44,100,144
https://kawalpemilu.org#52448,"PAKU ALAM, PAKUHAJI, TANGERANG, BANTEN",7,57,102,159
https://kawalpemilu.org#52448,"PAKU ALAM, PAKUHAJI, TANGERANG, BANTEN",8,58,93,151
https://kawalpemilu.org#52448,"PAKU ALAM, PAKUHAJI, TANGERANG, BANTEN",11,62,119,181
https://kawalpemilu.org#52448,"PAKU ALAM, PAKUHAJI, TANGERANG, BANTEN",12,92,132,224
https://kawalpemilu.org#52448,"PAKU ALAM, PAKUHAJI, TANGERANG, BANTEN",13,42,100,142
https://kawalpemilu.org#52448,"PAKU ALAM, PAKUHAJI, TANGERANG, BANTEN",14,43,73,116
https://kawalpemilu.org#52448,"PAKU ALAM, PAKUHAJI, TANGERANG, BANTEN",16,40,114,154
https://kawalpemilu.org#52448,"PAKU ALAM, PAKUHAJI, TANGERANG, BANTEN",18,41,196,237
https://kawalpemilu.org#52448,"PAKU ALAM, PAKUHAJI, TANGERANG, BANTEN",19,53,145,198
https://kawalpemilu.org#52448,"PAKU ALAM, PAKUHAJI, TANGERANG, BANTEN",20,36,110,146
https://kawalpemilu.org#52448,"PAKU ALAM, PAKUHAJI, TANGERANG, BANTEN",21,32,122,154
https://kawalpemilu.org#52448,"PAKU ALAM, PAKUHAJI, TANGERANG, BANTEN",22,45,97,142
https://kawalpemilu.org#52448,"PAKU ALAM, PAKUHAJI, TANGERANG, BANTEN",23,45,111,156
https://kawalpemilu.org#52448,"PAKU ALAM, PAKUHAJI, TANGERANG, BANTEN",24,36,116,152
https://kawalpemilu.org#52448,"PAKU ALAM, PAKUHAJI, TANGERANG, BANTEN",25,41,102,143
https://kawalpemilu.org#52448,"PAKU ALAM, PAKUHAJI, TANGERANG, BANTEN",26,92,122,214
https://kawalpemilu.org#52448,"PAKU ALAM, PAKUHAJI, TANGERANG, BANTEN",27,53,143,196
https://kawalpemilu.org#52449,"BONISARI, PAKUHAJI, TANGERANG, BANTEN",4,73,94,167
https://kawalpemilu.org#52449,"BONISARI, PAKUHAJI, TANGERANG, BANTEN",5,72,166,238
https://kawalpemilu.org#52449,"BONISARI, PAKUHAJI, TANGERANG, BANTEN",8,60,81,141
https://kawalpemilu.org#52449,"BONISARI, PAKUHAJI, TANGERANG, BANTEN",9,64,78,142
https://kawalpemilu.org#52449,"BONISARI, PAKUHAJI, TANGERANG, BANTEN",10,38,101,139
https://kawalpemilu.org#52449,"BONISARI, PAKUHAJI, TANGERANG, BANTEN",11,30,124,154
https://kawalpemilu.org#52449,"BONISARI, PAKUHAJI, TANGERANG, BANTEN",12,48,77,125
https://kawalpemilu.org#52449,"BONISARI, PAKUHAJI, TANGERANG, BANTEN",13,41,97,138
https://kawalpemilu.org#52449,"BONISARI, PAKUHAJI, TANGERANG, BANTEN",14,59,93,152
https://kawalpemilu.org#52449,"BONISARI, PAKUHAJI, TANGERANG, BANTEN",21,40,105,145
https://kawalpemilu.org#52449,"BONISARI, PAKUHAJI, TANGERANG, BANTEN",23,39,90,129
https://kawalpemilu.org#52449,"BONISARI, PAKUHAJI, TANGERANG, BANTEN",24,52,103,155
https://kawalpemilu.org#52449,"BONISARI, PAKUHAJI, TANGERANG, BANTEN",25,60,91,151
https://kawalpemilu.org#52449,"BONISARI, PAKUHAJI, TANGERANG, BANTEN",26,36,110,146
https://kawalpemilu.org#52449,"BONISARI, PAKUHAJI, TANGERANG, BANTEN",27,40,121,161
https://kawalpemilu.org#52450,"RAWA BONI, PAKUHAJI, TANGERANG, BANTEN",1,101,146,247
https://kawalpemilu.org#52450,"RAWA BONI, PAKUHAJI, TANGERANG, BANTEN",2,70,99,169
https://kawalpemilu.org#52450,"RAWA BONI, PAKUHAJI, TANGERANG, BANTEN",3,67,147,214
https://kawalpemilu.org#52450,"RAWA BONI, PAKUHAJI, TANGERANG, BANTEN",4,50,136,186
https://kawalpemilu.org#52450,"RAWA BONI, PAKUHAJI, TANGERANG, BANTEN",5,94,95,189
https://kawalpemilu.org#52450,"RAWA BONI, PAKUHAJI, TANGERANG, BANTEN",6,40,171,211
https://kawalpemilu.org#52450,"RAWA BONI, PAKUHAJI, TANGERANG, BANTEN",7,30,134,164
https://kawalpemilu.org#52450,"RAWA BONI, PAKUHAJI, TANGERANG, BANTEN",9,89,104,193
https://kawalpemilu.org#52450,"RAWA BONI, PAKUHAJI, TANGERANG, BANTEN",10,90,101,191
https://kawalpemilu.org#52450,"RAWA BONI, PAKUHAJI, TANGERANG, BANTEN",11,87,117,204
https://kawalpemilu.org#52450,"RAWA BONI, PAKUHAJI, TANGERANG, BANTEN",12,122,92,214
https://kawalpemilu.org#52450,"RAWA BONI, PAKUHAJI, TANGERANG, BANTEN",13,107,141,248
https://kawalpemilu.org#52450,"RAWA BONI, PAKUHAJI, TANGERANG, BANTEN",14,74,108,182
https://kawalpemilu.org#52450,"RAWA BONI, PAKUHAJI, TANGERANG, BANTEN",15,20,102,122
https://kawalpemilu.org#52450,"RAWA BONI, PAKUHAJI, TANGERANG, BANTEN",16,60,125,185
https://kawalpemilu.org#52450,"RAWA BONI, PAKUHAJI, TANGERANG, BANTEN",17,87,65,152
https://kawalpemilu.org#52450,"RAWA BONI, PAKUHAJI, TANGERANG, BANTEN",18,72,96,168
https://kawalpemilu.org#52450,"RAWA BONI, PAKUHAJI, TANGERANG, BANTEN",20,73,90,163
https://kawalpemilu.org#52450,"RAWA BONI, PAKUHAJI, TANGERANG, BANTEN",21,72,171,243
https://kawalpemilu.org#52451,"BUARAN MANGGA, PAKUHAJI, TANGERANG, BANTEN",1,47,125,172
https://kawalpemilu.org#52451,"BUARAN MANGGA, PAKUHAJI, TANGERANG, BANTEN",2,64,91,155
https://kawalpemilu.org#52451,"BUARAN MANGGA, PAKUHAJI, TANGERANG, BANTEN",3,58,141,199
https://kawalpemilu.org#52451,"BUARAN MANGGA, PAKUHAJI, TANGERANG, BANTEN",4,48,132,180
https://kawalpemilu.org#52451,"BUARAN MANGGA, PAKUHAJI, TANGERANG, BANTEN",5,19,112,131
https://kawalpemilu.org#52451,"BUARAN MANGGA, PAKUHAJI, TANGERANG, BANTEN",6,52,116,168
https://kawalpemilu.org#52451,"BUARAN MANGGA, PAKUHAJI, TANGERANG, BANTEN",7,21,117,138
https://kawalpemilu.org#52451,"BUARAN MANGGA, PAKUHAJI, TANGERANG, BANTEN",9,94,51,145
https://kawalpemilu.org#52451,"BUARAN MANGGA, PAKUHAJI, TANGERANG, BANTEN",11,53,119,172
https://kawalpemilu.org#52451,"BUARAN MANGGA, PAKUHAJI, TANGERANG, BANTEN",12,58,121,179
https://kawalpemilu.org#52451,"BUARAN MANGGA, PAKUHAJI, TANGERANG, BANTEN",14,44,94,138
https://kawalpemilu.org#52451,"BUARAN MANGGA, PAKUHAJI, TANGERANG, BANTEN",15,42,78,120
https://kawalpemilu.org#52451,"BUARAN MANGGA, PAKUHAJI, TANGERANG, BANTEN",16,26,112,138
https://kawalpemilu.org#52451,"BUARAN MANGGA, PAKUHAJI, TANGERANG, BANTEN",17,73,77,150
https://kawalpemilu.org#52451,"BUARAN MANGGA, PAKUHAJI, TANGERANG, BANTEN",18,67,65,132
https://kawalpemilu.org#52452,"BUARAN BAMBU, PAKUHAJI, TANGERANG, BANTEN",1,48,102,150
https://kawalpemilu.org#52452,"BUARAN BAMBU, PAKUHAJI, TANGERANG, BANTEN",2,61,108,7
https://kawalpemilu.org#52452,"BUARAN BAMBU, PAKUHAJI, TANGERANG, BANTEN",3,133,112,245
https://kawalpemilu.org#52452,"BUARAN BAMBU, PAKUHAJI, TANGERANG, BANTEN",4,75,138,213
https://kawalpemilu.org#52452,"BUARAN BAMBU, PAKUHAJI, TANGERANG, BANTEN",5,67,138,205
https://kawalpemilu.org#52452,"BUARAN BAMBU, PAKUHAJI, TANGERANG, BANTEN",6,76,150,226
https://kawalpemilu.org#52452,"BUARAN BAMBU, PAKUHAJI, TANGERANG, BANTEN",7,79,163,242
https://kawalpemilu.org#52452,"BUARAN BAMBU, PAKUHAJI, TANGERANG, BANTEN",9,47,107,154
https://kawalpemilu.org#52452,"BUARAN BAMBU, PAKUHAJI, TANGERANG, BANTEN",10,24,122,146
https://kawalpemilu.org#52452,"BUARAN BAMBU, PAKUHAJI, TANGERANG, BANTEN",11,65,152,217
https://kawalpemilu.org#52452,"BUARAN BAMBU, PAKUHAJI, TANGERANG, BANTEN",12,75,105,180
https://kawalpemilu.org#52452,"BUARAN BAMBU, PAKUHAJI, TANGERANG, BANTEN",13,52,107,159
https://kawalpemilu.org#52452,"BUARAN BAMBU, PAKUHAJI, TANGERANG, BANTEN",14,49,117,166
https://kawalpemilu.org#52452,"BUARAN BAMBU, PAKUHAJI, TANGERANG, BANTEN",15,101,143,244
https://kawalpemilu.org#52452,"BUARAN BAMBU, PAKUHAJI, TANGERANG, BANTEN",16,72,143,215
https://kawalpemilu.org#52452,"BUARAN BAMBU, PAKUHAJI, TANGERANG, BANTEN",17,78,125,203
https://kawalpemilu.org#52452,"BUARAN BAMBU, PAKUHAJI, TANGERANG, BANTEN",19,43,156,199
https://kawalpemilu.org#52452,"BUARAN BAMBU, PAKUHAJI, TANGERANG, BANTEN",20,27,113,140
https://kawalpemilu.org#52452,"BUARAN BAMBU, PAKUHAJI, TANGERANG, BANTEN",21,44,111,155
https://kawalpemilu.org#52452,"BUARAN BAMBU, PAKUHAJI, TANGERANG, BANTEN",22,20,110,130
https://kawalpemilu.org#52452,"BUARAN BAMBU, PAKUHAJI, TANGERANG, BANTEN",23,54,151,205
https://kawalpemilu.org#52452,"BUARAN BAMBU, PAKUHAJI, TANGERANG, BANTEN",24,64,106,170
https://kawalpemilu.org#52453,"KALIBARU, PAKUHAJI, TANGERANG, BANTEN",7,83,81,172
https://kawalpemilu.org#52453,"KALIBARU, PAKUHAJI, TANGERANG, BANTEN",8,96,74,170
https://kawalpemilu.org#52453,"KALIBARU, PAKUHAJI, TANGERANG, BANTEN",10,49,94,143
https://kawalpemilu.org#52453,"KALIBARU, PAKUHAJI, TANGERANG, BANTEN",12,64,157,221
https://kawalpemilu.org#52453,"KALIBARU, PAKUHAJI, TANGERANG, BANTEN",13,49,97,146
https://kawalpemilu.org#52453,"KALIBARU, PAKUHAJI, TANGERANG, BANTEN",14,72,82,154
https://kawalpemilu.org#52453,"KALIBARU, PAKUHAJI, TANGERANG, BANTEN",16,81,148,229
https://kawalpemilu.org#52453,"KALIBARU, PAKUHAJI, TANGERANG, BANTEN",17,40,113,153
https://kawalpemilu.org#52453,"KALIBARU, PAKUHAJI, TANGERANG, BANTEN",18,69,116,185
https://kawalpemilu.org#52453,"KALIBARU, PAKUHAJI, TANGERANG, BANTEN",19,49,162,211
https://kawalpemilu.org#52453,"KALIBARU, PAKUHAJI, TANGERANG, BANTEN",20,73,116,189
https://kawalpemilu.org#52453,"KALIBARU, PAKUHAJI, TANGERANG, BANTEN",21,72,87,159
https://kawalpemilu.org#52453,"KALIBARU, PAKUHAJI, TANGERANG, BANTEN",22,61,96,157
https://kawalpemilu.org#52453,"KALIBARU, PAKUHAJI, TANGERANG, BANTEN",23,47,188,235
https://kawalpemilu.org#52453,"KALIBARU, PAKUHAJI, TANGERANG, BANTEN",24,74,76,150
https://kawalpemilu.org#52453,"KALIBARU, PAKUHAJI, TANGERANG, BANTEN",25,57,106,163
https://kawalpemilu.org#52453,"KALIBARU, PAKUHAJI, TANGERANG, BANTEN",28,50,115,165
https://kawalpemilu.org#52453,"KALIBARU, PAKUHAJI, TANGERANG, BANTEN",29,33,104,137
https://kawalpemilu.org#52453,"KALIBARU, PAKUHAJI, TANGERANG, BANTEN",31,68,75,143
https://kawalpemilu.org#52454,"KOHOD, PAKUHAJI, TANGERANG, BANTEN",1,95,163,258
https://kawalpemilu.org#52454,"KOHOD, PAKUHAJI, TANGERANG, BANTEN",2,57,110,167
https://kawalpemilu.org#52454,"KOHOD, PAKUHAJI, TANGERANG, BANTEN",3,88,129,217
https://kawalpemilu.org#52454,"KOHOD, PAKUHAJI, TANGERANG, BANTEN",4,92,141,233
https://kawalpemilu.org#52454,"KOHOD, PAKUHAJI, TANGERANG, BANTEN",5,112,139,251
https://kawalpemilu.org#52454,"KOHOD, PAKUHAJI, TANGERANG, BANTEN",6,112,92,204
https://kawalpemilu.org#52454,"KOHOD, PAKUHAJI, TANGERANG, BANTEN",7,105,122,227
https://kawalpemilu.org#52454,"KOHOD, PAKUHAJI, TANGERANG, BANTEN",8,118,122,240
https://kawalpemilu.org#52454,"KOHOD, PAKUHAJI, TANGERANG, BANTEN",9,73,60,133
https://kawalpemilu.org#52454,"KOHOD, PAKUHAJI, TANGERANG, BANTEN",10,128,84,212
https://kawalpemilu.org#52454,"KOHOD, PAKUHAJI, TANGERANG, BANTEN",11,93,76,169
https://kawalpemilu.org#52454,"KOHOD, PAKUHAJI, TANGERANG, BANTEN",12,69,100,169
https://kawalpemilu.org#52454,"KOHOD, PAKUHAJI, TANGERANG, BANTEN",13,73,108,181
https://kawalpemilu.org#52454,"KOHOD, PAKUHAJI, TANGERANG, BANTEN",14,59,75,134
https://kawalpemilu.org#52454,"KOHOD, PAKUHAJI, TANGERANG, BANTEN",15,94,96,190
https://kawalpemilu.org#52454,"KOHOD, PAKUHAJI, TANGERANG, BANTEN",16,65,60,125
https://kawalpemilu.org#52454,"KOHOD, PAKUHAJI, TANGERANG, BANTEN",17,97,119,216
https://kawalpemilu.org#52454,"KOHOD, PAKUHAJI, TANGERANG, BANTEN",18,95,106,201
https://kawalpemilu.org#52454,"KOHOD, PAKUHAJI, TANGERANG, BANTEN",19,105,89,194
https://kawalpemilu.org#52454,"KOHOD, PAKUHAJI, TANGERANG, BANTEN",20,67,112,179
https://kawalpemilu.org#52454,"KOHOD, PAKUHAJI, TANGERANG, BANTEN",21,89,156,245
https://kawalpemilu.org#52454,"KOHOD, PAKUHAJI, TANGERANG, BANTEN",22,53,125,178
https://kawalpemilu.org#52455,"KRAMAT, PAKUHAJI, TANGERANG, BANTEN",1,49,97,146
https://kawalpemilu.org#52455,"KRAMAT, PAKUHAJI, TANGERANG, BANTEN",2,78,123,201
https://kawalpemilu.org#52455,"KRAMAT, PAKUHAJI, TANGERANG, BANTEN",3,62,98,160
https://kawalpemilu.org#52455,"KRAMAT, PAKUHAJI, TANGERANG, BANTEN",5,58,95,153
https://kawalpemilu.org#52455,"KRAMAT, PAKUHAJI, TANGERANG, BANTEN",6,40,98,138
https://kawalpemilu.org#52455,"KRAMAT, PAKUHAJI, TANGERANG, BANTEN",11,79,123,202
https://kawalpemilu.org#52455,"KRAMAT, PAKUHAJI, TANGERANG, BANTEN",14,55,119,174
https://kawalpemilu.org#52455,"KRAMAT, PAKUHAJI, TANGERANG, BANTEN",15,42,78,120
https://kawalpemilu.org#52455,"KRAMAT, PAKUHAJI, TANGERANG, BANTEN",16,73,133,206
https://kawalpemilu.org#52455,"KRAMAT, PAKUHAJI, TANGERANG, BANTEN",17,65,83,148
https://kawalpemilu.org#52455,"KRAMAT, PAKUHAJI, TANGERANG, BANTEN",18,92,98,190
https://kawalpemilu.org#52455,"KRAMAT, PAKUHAJI, TANGERANG, BANTEN",19,56,89,145
https://kawalpemilu.org#52455,"KRAMAT, PAKUHAJI, TANGERANG, BANTEN",20,42,79,121
https://kawalpemilu.org#52455,"KRAMAT, PAKUHAJI, TANGERANG, BANTEN",21,84,70,154
https://kawalpemilu.org#52455,"KRAMAT, PAKUHAJI, TANGERANG, BANTEN",23,69,62,131
https://kawalpemilu.org#52455,"KRAMAT, PAKUHAJI, TANGERANG, BANTEN",24,75,145,220
https://kawalpemilu.org#52455,"KRAMAT, PAKUHAJI, TANGERANG, BANTEN",25,48,98,146
https://kawalpemilu.org#52455,"KRAMAT, PAKUHAJI, TANGERANG, BANTEN",26,57,112,169
https://kawalpemilu.org#52455,"KRAMAT, PAKUHAJI, TANGERANG, BANTEN",27,61,114,175
https://kawalpemilu.org#52456,"SUKAWALI, PAKUHAJI, TANGERANG, BANTEN",1,105,73,178
https://kawalpemilu.org#52456,"SUKAWALI, PAKUHAJI, TANGERANG, BANTEN",3,58,64,122
https://kawalpemilu.org#52456,"SUKAWALI, PAKUHAJI, TANGERANG, BANTEN",4,71,62,133
https://kawalpemilu.org#52456,"SUKAWALI, PAKUHAJI, TANGERANG, BANTEN",5,105,93,198
https://kawalpemilu.org#52456,"SUKAWALI, PAKUHAJI, TANGERANG, BANTEN",6,73,87,160
https://kawalpemilu.org#52456,"SUKAWALI, PAKUHAJI, TANGERANG, BANTEN",7,47,57,104
https://kawalpemilu.org#52456,"SUKAWALI, PAKUHAJI, TANGERANG, BANTEN",8,109,87,196
https://kawalpemilu.org#52456,"SUKAWALI, PAKUHAJI, TANGERANG, BANTEN",9,81,92,173
https://kawalpemilu.org#52456,"SUKAWALI, PAKUHAJI, TANGERANG, BANTEN",10,41,108,149
https://kawalpemilu.org#52456,"SUKAWALI, PAKUHAJI, TANGERANG, BANTEN",11,35,99,134
https://kawalpemilu.org#52456,"SUKAWALI, PAKUHAJI, TANGERANG, BANTEN",13,26,135,161
https://kawalpemilu.org#52456,"SUKAWALI, PAKUHAJI, TANGERANG, BANTEN",15,85,138,223
https://kawalpemilu.org#52456,"SUKAWALI, PAKUHAJI, TANGERANG, BANTEN",16,47,70,117
https://kawalpemilu.org#52456,"SUKAWALI, PAKUHAJI, TANGERANG, BANTEN",17,50,98,148
https://kawalpemilu.org#52456,"SUKAWALI, PAKUHAJI, TANGERANG, BANTEN",18,73,93,166
https://kawalpemilu.org#52456,"SUKAWALI, PAKUHAJI, TANGERANG, BANTEN",19,58,109,167
https://kawalpemilu.org#52456,"SUKAWALI, PAKUHAJI, TANGERANG, BANTEN",23,71,86,157
https://kawalpemilu.org#52456,"SUKAWALI, PAKUHAJI, TANGERANG, BANTEN",24,74,87,161
https://kawalpemilu.org#52456,"SUKAWALI, PAKUHAJI, TANGERANG, BANTEN",28,44,103,147
https://kawalpemilu.org#52456,"SUKAWALI, PAKUHAJI, TANGERANG, BANTEN",29,30,127,157
https://kawalpemilu.org#52457,"SURYA BAHARI, PAKUHAJI, TANGERANG, BANTEN",1,117,39,156
https://kawalpemilu.org#52457,"SURYA BAHARI, PAKUHAJI, TANGERANG, BANTEN",3,101,48,149
https://kawalpemilu.org#52457,"SURYA BAHARI, PAKUHAJI, TANGERANG, BANTEN",5,123,60,183
https://kawalpemilu.org#52457,"SURYA BAHARI, PAKUHAJI, TANGERANG, BANTEN",6,123,56,179
https://kawalpemilu.org#52457,"SURYA BAHARI, PAKUHAJI, TANGERANG, BANTEN",7,121,62,183
https://kawalpemilu.org#52457,"SURYA BAHARI, PAKUHAJI, TANGERANG, BANTEN",8,91,65,156
https://kawalpemilu.org#52457,"SURYA BAHARI, PAKUHAJI, TANGERANG, BANTEN",9,70,63,133
https://kawalpemilu.org#52457,"SURYA BAHARI, PAKUHAJI, TANGERANG, BANTEN",10,77,56,133
https://kawalpemilu.org#52457,"SURYA BAHARI, PAKUHAJI, TANGERANG, BANTEN",13,84,100,184
https://kawalpemilu.org#52457,"SURYA BAHARI, PAKUHAJI, TANGERANG, BANTEN",14,79,120,199
https://kawalpemilu.org#52457,"SURYA BAHARI, PAKUHAJI, TANGERANG, BANTEN",16,93,48,141
https://kawalpemilu.org#52457,"SURYA BAHARI, PAKUHAJI, TANGERANG, BANTEN",17,86,49,135
https://kawalpemilu.org#52457,"SURYA BAHARI, PAKUHAJI, TANGERANG, BANTEN",20,120,67,187
https://kawalpemilu.org#52457,"SURYA BAHARI, PAKUHAJI, TANGERANG, BANTEN",22,129,83,212
https://kawalpemilu.org#52457,"SURYA BAHARI, PAKUHAJI, TANGERANG, BANTEN",23,124,86,210
https://kawalpemilu.org#52457,"SURYA BAHARI, PAKUHAJI, TANGERANG, BANTEN",24,125,96,221
https://kawalpemilu.org#52458,"KIARA PAYUNG, PAKUHAJI, TANGERANG, BANTEN",1,45,130,175
https://kawalpemilu.org#52458,"KIARA PAYUNG, PAKUHAJI, TANGERANG, BANTEN",2,73,128,201
https://kawalpemilu.org#52458,"KIARA PAYUNG, PAKUHAJI, TANGERANG, BANTEN",3,21,152,173
https://kawalpemilu.org#52458,"KIARA PAYUNG, PAKUHAJI, TANGERANG, BANTEN",4,75,127,202
https://kawalpemilu.org#52458,"KIARA PAYUNG, PAKUHAJI, TANGERANG, BANTEN",5,53,165,218
https://kawalpemilu.org#52458,"KIARA PAYUNG, PAKUHAJI, TANGERANG, BANTEN",6,49,138,187
https://kawalpemilu.org#52458,"KIARA PAYUNG, PAKUHAJI, TANGERANG, BANTEN",7,59,216,275
https://kawalpemilu.org#52458,"KIARA PAYUNG, PAKUHAJI, TANGERANG, BANTEN",8,36,99,135
https://kawalpemilu.org#52458,"KIARA PAYUNG, PAKUHAJI, TANGERANG, BANTEN",9,50,119,169
https://kawalpemilu.org#52458,"KIARA PAYUNG, PAKUHAJI, TANGERANG, BANTEN",10,60,150,210
https://kawalpemilu.org#52458,"KIARA PAYUNG, PAKUHAJI, TANGERANG, BANTEN",11,48,202,250
https://kawalpemilu.org#52458,"KIARA PAYUNG, PAKUHAJI, TANGERANG, BANTEN",12,56,173,229
https://kawalpemilu.org#52458,"KIARA PAYUNG, PAKUHAJI, TANGERANG, BANTEN",13,94,116,210
https://kawalpemilu.org#52458,"KIARA PAYUNG, PAKUHAJI, TANGERANG, BANTEN",14,133,94,227
https://kawalpemilu.org#52458,"KIARA PAYUNG, PAKUHAJI, TANGERANG, BANTEN",15,69,105,174
https://kawalpemilu.org#52458,"KIARA PAYUNG, PAKUHAJI, TANGERANG, BANTEN",16,84,144,228
https://kawalpemilu.org#52458,"KIARA PAYUNG, PAKUHAJI, TANGERANG, BANTEN",17,63,100,163
https://kawalpemilu.org#52458,"KIARA PAYUNG, PAKUHAJI, TANGERANG, BANTEN",18,88,112,200
https://kawalpemilu.org#52458,"KIARA PAYUNG, PAKUHAJI, TANGERANG, BANTEN",19,76,134,210
https://kawalpemilu.org#52458,"KIARA PAYUNG, PAKUHAJI, TANGERANG, BANTEN",20,114,121,235
https://kawalpemilu.org#52458,"KIARA PAYUNG, PAKUHAJI, TANGERANG, BANTEN",21,65,66,131
https://kawalpemilu.org#52458,"KIARA PAYUNG, PAKUHAJI, TANGERANG, BANTEN",22,66,132,198
https://kawalpemilu.org#52458,"KIARA PAYUNG, PAKUHAJI, TANGERANG, BANTEN",23,71,106,177
https://kawalpemilu.org#52458,"KIARA PAYUNG, PAKUHAJI, TANGERANG, BANTEN",24,24,128,152
https://kawalpemilu.org#52458,"KIARA PAYUNG, PAKUHAJI, TANGERANG, BANTEN",25,59,150,209
https://kawalpemilu.org#52458,"KIARA PAYUNG, PAKUHAJI, TANGERANG, BANTEN",26,45,180,225
https://kawalpemilu.org#52458,"KIARA PAYUNG, PAKUHAJI, TANGERANG, BANTEN",29,64,158,222
https://kawalpemilu.org#52458,"KIARA PAYUNG, PAKUHAJI, TANGERANG, BANTEN",33,96,159,255
https://kawalpemilu.org#52458,"KIARA PAYUNG, PAKUHAJI, TANGERANG, BANTEN",34,107,121,228
https://kawalpemilu.org#52458,"KIARA PAYUNG, PAKUHAJI, TANGERANG, BANTEN",36,64,201,265
https://kawalpemilu.org#52458,"KIARA PAYUNG, PAKUHAJI, TANGERANG, BANTEN",37,41,163,204
https://kawalpemilu.org#52458,"KIARA PAYUNG, PAKUHAJI, TANGERANG, BANTEN",38,110,118,228
https://kawalpemilu.org#52458,"KIARA PAYUNG, PAKUHAJI, TANGERANG, BANTEN",39,76,140,216
https://kawalpemilu.org#52458,"KIARA PAYUNG, PAKUHAJI, TANGERANG, BANTEN",40,118,140,258
https://kawalpemilu.org#52458,"KIARA PAYUNG, PAKUHAJI, TANGERANG, BANTEN",41,98,135,233
https://kawalpemilu.org#52459,"LAKSANA, PAKUHAJI, TANGERANG, BANTEN",2,38,117,155
https://kawalpemilu.org#52459,"LAKSANA, PAKUHAJI, TANGERANG, BANTEN",3,56,133,189
https://kawalpemilu.org#52459,"LAKSANA, PAKUHAJI, TANGERANG, BANTEN",4,48,139,187
https://kawalpemilu.org#52459,"LAKSANA, PAKUHAJI, TANGERANG, BANTEN",5,56,111,167
https://kawalpemilu.org#52459,"LAKSANA, PAKUHAJI, TANGERANG, BANTEN",6,64,114,178
https://kawalpemilu.org#52459,"LAKSANA, PAKUHAJI, TANGERANG, BANTEN",7,28,129,157
https://kawalpemilu.org#52459,"LAKSANA, PAKUHAJI, TANGERANG, BANTEN",8,82,126,208
https://kawalpemilu.org#52459,"LAKSANA, PAKUHAJI, TANGERANG, BANTEN",10,41,111,152
https://kawalpemilu.org#52459,"LAKSANA, PAKUHAJI, TANGERANG, BANTEN",11,59,90,149
https://kawalpemilu.org#52459,"LAKSANA, PAKUHAJI, TANGERANG, BANTEN",12,37,121,158
https://kawalpemilu.org#52459,"LAKSANA, PAKUHAJI, TANGERANG, BANTEN",14,37,159,196
https://kawalpemilu.org#52459,"LAKSANA, PAKUHAJI, TANGERANG, BANTEN",15,41,135,176
https://kawalpemilu.org#52459,"LAKSANA, PAKUHAJI, TANGERANG, BANTEN",16,41,113,154
https://kawalpemilu.org#52459,"LAKSANA, PAKUHAJI, TANGERANG, BANTEN",17,36,102,138
https://kawalpemilu.org#52459,"LAKSANA, PAKUHAJI, TANGERANG, BANTEN",18,42,94,136
https://kawalpemilu.org#52459,"LAKSANA, PAKUHAJI, TANGERANG, BANTEN",19,53,92,145
https://kawalpemilu.org#52459,"LAKSANA, PAKUHAJI, TANGERANG, BANTEN",20,53,78,131
https://kawalpemilu.org#52459,"LAKSANA, PAKUHAJI, TANGERANG, BANTEN",22,37,87,124
https://kawalpemilu.org#52460,"GAGA, PAKUHAJI, TANGERANG, BANTEN",2,197,21,218
https://kawalpemilu.org#52460,"GAGA, PAKUHAJI, TANGERANG, BANTEN",4,45,128,173
https://kawalpemilu.org#52460,"GAGA, PAKUHAJI, TANGERANG, BANTEN",6,37,94,131
https://kawalpemilu.org#52460,"GAGA, PAKUHAJI, TANGERANG, BANTEN",7,45,112,157
https://kawalpemilu.org#52460,"GAGA, PAKUHAJI, TANGERANG, BANTEN",8,85,90,175
https://kawalpemilu.org#52460,"GAGA, PAKUHAJI, TANGERANG, BANTEN",9,91,176,267
https://kawalpemilu.org#52460,"GAGA, PAKUHAJI, TANGERANG, BANTEN",10,22,123,145
https://kawalpemilu.org#52460,"GAGA, PAKUHAJI, TANGERANG, BANTEN",11,53,157,210
https://kawalpemilu.org#52460,"GAGA, PAKUHAJI, TANGERANG, BANTEN",12,39,180,219
https://kawalpemilu.org#52460,"GAGA, PAKUHAJI, TANGERANG, BANTEN",14,55,154,209
https://kawalpemilu.org#52460,"GAGA, PAKUHAJI, TANGERANG, BANTEN",15,71,169,240
https://kawalpemilu.org#52460,"GAGA, PAKUHAJI, TANGERANG, BANTEN",16,76,131,207
https://kawalpemilu.org#52460,"GAGA, PAKUHAJI, TANGERANG, BANTEN",17,59,98,157
https://kawalpemilu.org#52460,"GAGA, PAKUHAJI, TANGERANG, BANTEN",18,83,124,207
https://kawalpemilu.org#52460,"GAGA, PAKUHAJI, TANGERANG, BANTEN",21,116,74,190
https://kawalpemilu.org#52460,"GAGA, PAKUHAJI, TANGERANG, BANTEN",22,109,72,181
https://kawalpemilu.org#52460,"GAGA, PAKUHAJI, TANGERANG, BANTEN",24,66,162,228
https://kawalpemilu.org#52460,"GAGA, PAKUHAJI, TANGERANG, BANTEN",27,84,90,174
https://kawalpemilu.org#52460,"GAGA, PAKUHAJI, TANGERANG, BANTEN",28,42,92,134
https://kawalpemilu.org#52460,"GAGA, PAKUHAJI, TANGERANG, BANTEN",29,58,127,185
https://kawalpemilu.org#52460,"GAGA, PAKUHAJI, TANGERANG, BANTEN",30,47,165,212
https://kawalpemilu.org#52460,"GAGA, PAKUHAJI, TANGERANG, BANTEN",31,31,121,152
https://kawalpemilu.org#52460,"GAGA, PAKUHAJI, TANGERANG, BANTEN",32,69,111,180
https://kawalpemilu.org#52460,"GAGA, PAKUHAJI, TANGERANG, BANTEN",34,86,74,160
https://kawalpemilu.org#52460,"GAGA, PAKUHAJI, TANGERANG, BANTEN",35,89,107,196
https://kawalpemilu.org#52462,"SEPATAN, SEPATAN, TANGERANG, BANTEN",1,42,223,265
https://kawalpemilu.org#52462,"SEPATAN, SEPATAN, TANGERANG, BANTEN",2,38,197,235
https://kawalpemilu.org#52462,"SEPATAN, SEPATAN, TANGERANG, BANTEN",3,31,197,228
https://kawalpemilu.org#52462,"SEPATAN, SEPATAN, TANGERANG, BANTEN",4,34,128,162
https://kawalpemilu.org#52462,"SEPATAN, SEPATAN, TANGERANG, BANTEN",5,43,157,200
https://kawalpemilu.org#52462,"SEPATAN, SEPATAN, TANGERANG, BANTEN",6,66,142,208
https://kawalpemilu.org#52462,"SEPATAN, SEPATAN, TANGERANG, BANTEN",7,46,141,187
https://kawalpemilu.org#52462,"SEPATAN, SEPATAN, TANGERANG, BANTEN",8,52,79,131
https://kawalpemilu.org#52462,"SEPATAN, SEPATAN, TANGERANG, BANTEN",9,54,102,156
https://kawalpemilu.org#52462,"SEPATAN, SEPATAN, TANGERANG, BANTEN",10,46,126,172
https://kawalpemilu.org#52462,"SEPATAN, SEPATAN, TANGERANG, BANTEN",11,51,138,189
https://kawalpemilu.org#52462,"SEPATAN, SEPATAN, TANGERANG, BANTEN",12,60,193,253
https://kawalpemilu.org#52462,"SEPATAN, SEPATAN, TANGERANG, BANTEN",13,48,203,251
https://kawalpemilu.org#52462,"SEPATAN, SEPATAN, TANGERANG, BANTEN",14,80,145,225
https://kawalpemilu.org#52462,"SEPATAN, SEPATAN, TANGERANG, BANTEN",15,89,91,180
https://kawalpemilu.org#52462,"SEPATAN, SEPATAN, TANGERANG, BANTEN",16,81,115,196
https://kawalpemilu.org#52462,"SEPATAN, SEPATAN, TANGERANG, BANTEN",17,87,85,172
https://kawalpemilu.org#52462,"SEPATAN, SEPATAN, TANGERANG, BANTEN",18,58,166,224
https://kawalpemilu.org#52462,"SEPATAN, SEPATAN, TANGERANG, BANTEN",19,52,185,237
https://kawalpemilu.org#52462,"SEPATAN, SEPATAN, TANGERANG, BANTEN",20,76,173,249
https://kawalpemilu.org#52462,"SEPATAN, SEPATAN, TANGERANG, BANTEN",21,46,157,203
https://kawalpemilu.org#52462,"SEPATAN, SEPATAN, TANGERANG, BANTEN",22,54,140,194
https://kawalpemilu.org#52462,"SEPATAN, SEPATAN, TANGERANG, BANTEN",23,22,149,171
https://kawalpemilu.org#52462,"SEPATAN, SEPATAN, TANGERANG, BANTEN",25,52,207,259
https://kawalpemilu.org#52462,"SEPATAN, SEPATAN, TANGERANG, BANTEN",26,28,233,261
https://kawalpemilu.org#52462,"SEPATAN, SEPATAN, TANGERANG, BANTEN",27,35,187,222
https://kawalpemilu.org#52462,"SEPATAN, SEPATAN, TANGERANG, BANTEN",28,54,140,194
https://kawalpemilu.org#52462,"SEPATAN, SEPATAN, TANGERANG, BANTEN",29,45,152,197
https://kawalpemilu.org#52462,"SEPATAN, SEPATAN, TANGERANG, BANTEN",30,67,121,188
https://kawalpemilu.org#52462,"SEPATAN, SEPATAN, TANGERANG, BANTEN",31,55,116,171
https://kawalpemilu.org#52462,"SEPATAN, SEPATAN, TANGERANG, BANTEN",32,83,123,206
https://kawalpemilu.org#52462,"SEPATAN, SEPATAN, TANGERANG, BANTEN",33,81,171,252
https://kawalpemilu.org#52462,"SEPATAN, SEPATAN, TANGERANG, BANTEN",34,54,165,219
https://kawalpemilu.org#52463,"KARET, SEPATAN, TANGERANG, BANTEN",1,47,175,222
https://kawalpemilu.org#52463,"KARET, SEPATAN, TANGERANG, BANTEN",2,60,179,239
https://kawalpemilu.org#52463,"KARET, SEPATAN, TANGERANG, BANTEN",3,50,157,207
https://kawalpemilu.org#52463,"KARET, SEPATAN, TANGERANG, BANTEN",4,92,175,267
https://kawalpemilu.org#52463,"KARET, SEPATAN, TANGERANG, BANTEN",5,55,146,201
https://kawalpemilu.org#52463,"KARET, SEPATAN, TANGERANG, BANTEN",6,54,208,262
https://kawalpemilu.org#52463,"KARET, SEPATAN, TANGERANG, BANTEN",7,52,204,256
https://kawalpemilu.org#52463,"KARET, SEPATAN, TANGERANG, BANTEN",8,50,193,243
https://kawalpemilu.org#52463,"KARET, SEPATAN, TANGERANG, BANTEN",9,119,137,256
https://kawalpemilu.org#52463,"KARET, SEPATAN, TANGERANG, BANTEN",10,93,137,230
https://kawalpemilu.org#52463,"KARET, SEPATAN, TANGERANG, BANTEN",11,77,150,227
https://kawalpemilu.org#52463,"KARET, SEPATAN, TANGERANG, BANTEN",12,81,183,264
https://kawalpemilu.org#52463,"KARET, SEPATAN, TANGERANG, BANTEN",13,82,211,293
https://kawalpemilu.org#52463,"KARET, SEPATAN, TANGERANG, BANTEN",14,77,149,226
https://kawalpemilu.org#52463,"KARET, SEPATAN, TANGERANG, BANTEN",15,44,118,162
https://kawalpemilu.org#52463,"KARET, SEPATAN, TANGERANG, BANTEN",16,47,186,233
https://kawalpemilu.org#52463,"KARET, SEPATAN, TANGERANG, BANTEN",17,122,112,234
https://kawalpemilu.org#52463,"KARET, SEPATAN, TANGERANG, BANTEN",18,51,201,252
https://kawalpemilu.org#52463,"KARET, SEPATAN, TANGERANG, BANTEN",19,56,180,236
https://kawalpemilu.org#52463,"KARET, SEPATAN, TANGERANG, BANTEN",20,75,168,243
https://kawalpemilu.org#52463,"KARET, SEPATAN, TANGERANG, BANTEN",21,92,145,237
https://kawalpemilu.org#52463,"KARET, SEPATAN, TANGERANG, BANTEN",22,82,161,143
https://kawalpemilu.org#52463,"KARET, SEPATAN, TANGERANG, BANTEN",23,123,128,251
https://kawalpemilu.org#52463,"KARET, SEPATAN, TANGERANG, BANTEN",24,97,97,194
https://kawalpemilu.org#52463,"KARET, SEPATAN, TANGERANG, BANTEN",25,113,100,213
https://kawalpemilu.org#52463,"KARET, SEPATAN, TANGERANG, BANTEN",26,112,138,250
https://kawalpemilu.org#52463,"KARET, SEPATAN, TANGERANG, BANTEN",27,87,154,241
https://kawalpemilu.org#52463,"KARET, SEPATAN, TANGERANG, BANTEN",28,82,144,226
https://kawalpemilu.org#52463,"KARET, SEPATAN, TANGERANG, BANTEN",29,135,154,289
https://kawalpemilu.org#52463,"KARET, SEPATAN, TANGERANG, BANTEN",30,124,148,272
https://kawalpemilu.org#52463,"KARET, SEPATAN, TANGERANG, BANTEN",31,30,138,168
https://kawalpemilu.org#52463,"KARET, SEPATAN, TANGERANG, BANTEN",32,32,98,130
https://kawalpemilu.org#52463,"KARET, SEPATAN, TANGERANG, BANTEN",33,61,111,172
https://kawalpemilu.org#52463,"KARET, SEPATAN, TANGERANG, BANTEN",34,52,158,210
https://kawalpemilu.org#52463,"KARET, SEPATAN, TANGERANG, BANTEN",35,70,178,248
https://kawalpemilu.org#52463,"KARET, SEPATAN, TANGERANG, BANTEN",36,52,206,258
https://kawalpemilu.org#52463,"KARET, SEPATAN, TANGERANG, BANTEN",37,61,178,239
https://kawalpemilu.org#52463,"KARET, SEPATAN, TANGERANG, BANTEN",38,93,135,228
https://kawalpemilu.org#52463,"KARET, SEPATAN, TANGERANG, BANTEN",39,94,94,188
https://kawalpemilu.org#52463,"KARET, SEPATAN, TANGERANG, BANTEN",40,73,80,153
https://kawalpemilu.org#52463,"KARET, SEPATAN, TANGERANG, BANTEN",41,61,118,179
https://kawalpemilu.org#52463,"KARET, SEPATAN, TANGERANG, BANTEN",42,35,141,176
https://kawalpemilu.org#52463,"KARET, SEPATAN, TANGERANG, BANTEN",43,63,109,172
https://kawalpemilu.org#52463,"KARET, SEPATAN, TANGERANG, BANTEN",44,53,130,183
https://kawalpemilu.org#52463,"KARET, SEPATAN, TANGERANG, BANTEN",45,95,100,195
https://kawalpemilu.org#52463,"KARET, SEPATAN, TANGERANG, BANTEN",46,140,77,217
https://kawalpemilu.org#52463,"KARET, SEPATAN, TANGERANG, BANTEN",47,105,133,238
https://kawalpemilu.org#52463,"KARET, SEPATAN, TANGERANG, BANTEN",48,59,87,146
https://kawalpemilu.org#52463,"KARET, SEPATAN, TANGERANG, BANTEN",49,58,85,143
https://kawalpemilu.org#52463,"KARET, SEPATAN, TANGERANG, BANTEN",50,75,119,194
https://kawalpemilu.org#52463,"KARET, SEPATAN, TANGERANG, BANTEN",51,65,56,121
https://kawalpemilu.org#52464,"KAYU AGUNG, SEPATAN, TANGERANG, BANTEN",1,61,137,198
https://kawalpemilu.org#52464,"KAYU AGUNG, SEPATAN, TANGERANG, BANTEN",3,75,105,180
https://kawalpemilu.org#52464,"KAYU AGUNG, SEPATAN, TANGERANG, BANTEN",4,38,106,144
https://kawalpemilu.org#52464,"KAYU AGUNG, SEPATAN, TANGERANG, BANTEN",5,51,94,145
https://kawalpemilu.org#52464,"KAYU AGUNG, SEPATAN, TANGERANG, BANTEN",6,35,119,154
https://kawalpemilu.org#52464,"KAYU AGUNG, SEPATAN, TANGERANG, BANTEN",7,45,170,215
https://kawalpemilu.org#52464,"KAYU AGUNG, SEPATAN, TANGERANG, BANTEN",8,73,156,229
https://kawalpemilu.org#52464,"KAYU AGUNG, SEPATAN, TANGERANG, BANTEN",9,57,192,249
https://kawalpemilu.org#52464,"KAYU AGUNG, SEPATAN, TANGERANG, BANTEN",10,66,138,204
https://kawalpemilu.org#52464,"KAYU AGUNG, SEPATAN, TANGERANG, BANTEN",11,88,162,250
https://kawalpemilu.org#52464,"KAYU AGUNG, SEPATAN, TANGERANG, BANTEN",12,79,77,156
https://kawalpemilu.org#52464,"KAYU AGUNG, SEPATAN, TANGERANG, BANTEN",13,40,117,157
https://kawalpemilu.org#52464,"KAYU AGUNG, SEPATAN, TANGERANG, BANTEN",14,46,129,175
https://kawalpemilu.org#52464,"KAYU AGUNG, SEPATAN, TANGERANG, BANTEN",15,39,83,122
https://kawalpemilu.org#52464,"KAYU AGUNG, SEPATAN, TANGERANG, BANTEN",16,54,126,180
https://kawalpemilu.org#52464,"KAYU AGUNG, SEPATAN, TANGERANG, BANTEN",17,92,127,219
https://kawalpemilu.org#52464,"KAYU AGUNG, SEPATAN, TANGERANG, BANTEN",18,55,130,185
https://kawalpemilu.org#52464,"KAYU AGUNG, SEPATAN, TANGERANG, BANTEN",19,45,65,110
https://kawalpemilu.org#52464,"KAYU AGUNG, SEPATAN, TANGERANG, BANTEN",20,63,155,218
https://kawalpemilu.org#52464,"KAYU AGUNG, SEPATAN, TANGERANG, BANTEN",21,46,111,157
https://kawalpemilu.org#52464,"KAYU AGUNG, SEPATAN, TANGERANG, BANTEN",22,61,112,173
https://kawalpemilu.org#52464,"KAYU AGUNG, SEPATAN, TANGERANG, BANTEN",23,43,119,162
https://kawalpemilu.org#52464,"KAYU AGUNG, SEPATAN, TANGERANG, BANTEN",24,65,89,154
https://kawalpemilu.org#52464,"KAYU AGUNG, SEPATAN, TANGERANG, BANTEN",25,59,162,221
https://kawalpemilu.org#52464,"KAYU AGUNG, SEPATAN, TANGERANG, BANTEN",26,53,110,163
https://kawalpemilu.org#52464,"KAYU AGUNG, SEPATAN, TANGERANG, BANTEN",27,43,99,142
https://kawalpemilu.org#52464,"KAYU AGUNG, SEPATAN, TANGERANG, BANTEN",28,33,133,166
https://kawalpemilu.org#52464,"KAYU AGUNG, SEPATAN, TANGERANG, BANTEN",29,48,158,206
https://kawalpemilu.org#52464,"KAYU AGUNG, SEPATAN, TANGERANG, BANTEN",30,58,139,197
https://kawalpemilu.org#52464,"KAYU AGUNG, SEPATAN, TANGERANG, BANTEN",31,55,129,184
https://kawalpemilu.org#52464,"KAYU AGUNG, SEPATAN, TANGERANG, BANTEN",32,76,87,163
https://kawalpemilu.org#52464,"KAYU AGUNG, SEPATAN, TANGERANG, BANTEN",33,52,107,159
https://kawalpemilu.org#52464,"KAYU AGUNG, SEPATAN, TANGERANG, BANTEN",34,60,130,190
https://kawalpemilu.org#52464,"KAYU AGUNG, SEPATAN, TANGERANG, BANTEN",35,82,140,222
https://kawalpemilu.org#52464,"KAYU AGUNG, SEPATAN, TANGERANG, BANTEN",36,45,78,123
https://kawalpemilu.org#52464,"KAYU AGUNG, SEPATAN, TANGERANG, BANTEN",37,116,132,248
https://kawalpemilu.org#52464,"KAYU AGUNG, SEPATAN, TANGERANG, BANTEN",38,85,108,193
https://kawalpemilu.org#52464,"KAYU AGUNG, SEPATAN, TANGERANG, BANTEN",39,34,112,146
https://kawalpemilu.org#52464,"KAYU AGUNG, SEPATAN, TANGERANG, BANTEN",40,63,188,251
https://kawalpemilu.org#52464,"KAYU AGUNG, SEPATAN, TANGERANG, BANTEN",41,51,113,164
https://kawalpemilu.org#52465,"KAYU BONGKOK, SEPATAN, TANGERANG, BANTEN",1,58,185,243
https://kawalpemilu.org#52465,"KAYU BONGKOK, SEPATAN, TANGERANG, BANTEN",2,48,182,230
https://kawalpemilu.org#52465,"KAYU BONGKOK, SEPATAN, TANGERANG, BANTEN",3,33,184,217
https://kawalpemilu.org#52465,"KAYU BONGKOK, SEPATAN, TANGERANG, BANTEN",4,69,147,216
https://kawalpemilu.org#52465,"KAYU BONGKOK, SEPATAN, TANGERANG, BANTEN",5,44,154,198
https://kawalpemilu.org#52465,"KAYU BONGKOK, SEPATAN, TANGERANG, BANTEN",6,36,170,206
https://kawalpemilu.org#52465,"KAYU BONGKOK, SEPATAN, TANGERANG, BANTEN",7,33,138,171
https://kawalpemilu.org#52465,"KAYU BONGKOK, SEPATAN, TANGERANG, BANTEN",8,45,126,171
https://kawalpemilu.org#52465,"KAYU BONGKOK, SEPATAN, TANGERANG, BANTEN",9,32,158,190
https://kawalpemilu.org#52465,"KAYU BONGKOK, SEPATAN, TANGERANG, BANTEN",11,45,183,228
https://kawalpemilu.org#52465,"KAYU BONGKOK, SEPATAN, TANGERANG, BANTEN",12,33,197,230
https://kawalpemilu.org#52465,"KAYU BONGKOK, SEPATAN, TANGERANG, BANTEN",13,23,150,173
https://kawalpemilu.org#52465,"KAYU BONGKOK, SEPATAN, TANGERANG, BANTEN",14,49,113,162
https://kawalpemilu.org#52465,"KAYU BONGKOK, SEPATAN, TANGERANG, BANTEN",15,74,164,238
https://kawalpemilu.org#52465,"KAYU BONGKOK, SEPATAN, TANGERANG, BANTEN",16,68,181,249
https://kawalpemilu.org#52465,"KAYU BONGKOK, SEPATAN, TANGERANG, BANTEN",17,56,206,262
https://kawalpemilu.org#52465,"KAYU BONGKOK, SEPATAN, TANGERANG, BANTEN",18,24,140,164
https://kawalpemilu.org#52465,"KAYU BONGKOK, SEPATAN, TANGERANG, BANTEN",19,59,132,191
https://kawalpemilu.org#52465,"KAYU BONGKOK, SEPATAN, TANGERANG, BANTEN",20,47,126,173
https://kawalpemilu.org#52465,"KAYU BONGKOK, SEPATAN, TANGERANG, BANTEN",21,66,123,189
https://kawalpemilu.org#52466,"PONDOK JAYA, SEPATAN, TANGERANG, BANTEN",1,81,159,240
https://kawalpemilu.org#52466,"PONDOK JAYA, SEPATAN, TANGERANG, BANTEN",2,54,170,224
https://kawalpemilu.org#52466,"PONDOK JAYA, SEPATAN, TANGERANG, BANTEN",3,86,176,262
https://kawalpemilu.org#52466,"PONDOK JAYA, SEPATAN, TANGERANG, BANTEN",4,33,93,126
https://kawalpemilu.org#52466,"PONDOK JAYA, SEPATAN, TANGERANG, BANTEN",5,89,152,241
https://kawalpemilu.org#52466,"PONDOK JAYA, SEPATAN, TANGERANG, BANTEN",6,32,136,168
https://kawalpemilu.org#52466,"PONDOK JAYA, SEPATAN, TANGERANG, BANTEN",7,34,97,131
https://kawalpemilu.org#52466,"PONDOK JAYA, SEPATAN, TANGERANG, BANTEN",9,58,141,199
https://kawalpemilu.org#52466,"PONDOK JAYA, SEPATAN, TANGERANG, BANTEN",10,110,114,224
https://kawalpemilu.org#52466,"PONDOK JAYA, SEPATAN, TANGERANG, BANTEN",11,44,170,214
https://kawalpemilu.org#52466,"PONDOK JAYA, SEPATAN, TANGERANG, BANTEN",12,41,151,192
https://kawalpemilu.org#52466,"PONDOK JAYA, SEPATAN, TANGERANG, BANTEN",13,43,158,202
https://kawalpemilu.org#52466,"PONDOK JAYA, SEPATAN, TANGERANG, BANTEN",14,45,185,230
https://kawalpemilu.org#52466,"PONDOK JAYA, SEPATAN, TANGERANG, BANTEN",15,74,96,170
https://kawalpemilu.org#52466,"PONDOK JAYA, SEPATAN, TANGERANG, BANTEN",16,36,112,148
https://kawalpemilu.org#52466,"PONDOK JAYA, SEPATAN, TANGERANG, BANTEN",17,37,139,176
https://kawalpemilu.org#52466,"PONDOK JAYA, SEPATAN, TANGERANG, BANTEN",18,46,220,226
https://kawalpemilu.org#52466,"PONDOK JAYA, SEPATAN, TANGERANG, BANTEN",20,52,124,176
https://kawalpemilu.org#52466,"PONDOK JAYA, SEPATAN, TANGERANG, BANTEN",21,40,147,187
https://kawalpemilu.org#52466,"PONDOK JAYA, SEPATAN, TANGERANG, BANTEN",22,35,87,122
https://kawalpemilu.org#52466,"PONDOK JAYA, SEPATAN, TANGERANG, BANTEN",23,78,156,234
https://kawalpemilu.org#52466,"PONDOK JAYA, SEPATAN, TANGERANG, BANTEN",24,62,138,200
https://kawalpemilu.org#52466,"PONDOK JAYA, SEPATAN, TANGERANG, BANTEN",25,47,185,232
https://kawalpemilu.org#52466,"PONDOK JAYA, SEPATAN, TANGERANG, BANTEN",26,47,132,179
https://kawalpemilu.org#52466,"PONDOK JAYA, SEPATAN, TANGERANG, BANTEN",27,44,130,174
https://kawalpemilu.org#52466,"PONDOK JAYA, SEPATAN, TANGERANG, BANTEN",28,50,146,196
https://kawalpemilu.org#52466,"PONDOK JAYA, SEPATAN, TANGERANG, BANTEN",29,99,116,215
https://kawalpemilu.org#52466,"PONDOK JAYA, SEPATAN, TANGERANG, BANTEN",30,29,108,137
https://kawalpemilu.org#52466,"PONDOK JAYA, SEPATAN, TANGERANG, BANTEN",31,48,149,197
https://kawalpemilu.org#52467,"PISANGAN JAYA, SEPATAN, TANGERANG, BANTEN",1,56,158,214
https://kawalpemilu.org#52467,"PISANGAN JAYA, SEPATAN, TANGERANG, BANTEN",2,63,130,193
https://kawalpemilu.org#52467,"PISANGAN JAYA, SEPATAN, TANGERANG, BANTEN",3,75,162,237
https://kawalpemilu.org#52467,"PISANGAN JAYA, SEPATAN, TANGERANG, BANTEN",4,33,172,205
https://kawalpemilu.org#52467,"PISANGAN JAYA, SEPATAN, TANGERANG, BANTEN",5,119,136,255
https://kawalpemilu.org#52467,"PISANGAN JAYA, SEPATAN, TANGERANG, BANTEN",6,81,109,190
https://kawalpemilu.org#52467,"PISANGAN JAYA, SEPATAN, TANGERANG, BANTEN",7,136,121,257
https://kawalpemilu.org#52467,"PISANGAN JAYA, SEPATAN, TANGERANG, BANTEN",8,122,106,228
https://kawalpemilu.org#52467,"PISANGAN JAYA, SEPATAN, TANGERANG, BANTEN",9,90,129,219
https://kawalpemilu.org#52467,"PISANGAN JAYA, SEPATAN, TANGERANG, BANTEN",10,104,107,211
https://kawalpemilu.org#52467,"PISANGAN JAYA, SEPATAN, TANGERANG, BANTEN",11,86,130,216
https://kawalpemilu.org#52467,"PISANGAN JAYA, SEPATAN, TANGERANG, BANTEN",12,78,117,195
https://kawalpemilu.org#52467,"PISANGAN JAYA, SEPATAN, TANGERANG, BANTEN",13,103,105,208
https://kawalpemilu.org#52467,"PISANGAN JAYA, SEPATAN, TANGERANG, BANTEN",14,78,96,174
https://kawalpemilu.org#52467,"PISANGAN JAYA, SEPATAN, TANGERANG, BANTEN",15,111,61,172
https://kawalpemilu.org#52467,"PISANGAN JAYA, SEPATAN, TANGERANG, BANTEN",16,122,121,243
https://kawalpemilu.org#52467,"PISANGAN JAYA, SEPATAN, TANGERANG, BANTEN",17,84,92,176
https://kawalpemilu.org#52467,"PISANGAN JAYA, SEPATAN, TANGERANG, BANTEN",18,48,153,201
https://kawalpemilu.org#52467,"PISANGAN JAYA, SEPATAN, TANGERANG, BANTEN",19,49,118,167
https://kawalpemilu.org#52467,"PISANGAN JAYA, SEPATAN, TANGERANG, BANTEN",20,47,120,167
https://kawalpemilu.org#52467,"PISANGAN JAYA, SEPATAN, TANGERANG, BANTEN",21,74,156,230
https://kawalpemilu.org#52467,"PISANGAN JAYA, SEPATAN, TANGERANG, BANTEN",22,172,134,306
https://kawalpemilu.org#52467,"PISANGAN JAYA, SEPATAN, TANGERANG, BANTEN",23,111,130,241
https://kawalpemilu.org#52467,"PISANGAN JAYA, SEPATAN, TANGERANG, BANTEN",24,89,146,235
https://kawalpemilu.org#52467,"PISANGAN JAYA, SEPATAN, TANGERANG, BANTEN",25,110,150,260
https://kawalpemilu.org#52467,"PISANGAN JAYA, SEPATAN, TANGERANG, BANTEN",26,72,94,166
https://kawalpemilu.org#52467,"PISANGAN JAYA, SEPATAN, TANGERANG, BANTEN",27,58,150,208
https://kawalpemilu.org#52467,"PISANGAN JAYA, SEPATAN, TANGERANG, BANTEN",28,80,99,179
https://kawalpemilu.org#52467,"PISANGAN JAYA, SEPATAN, TANGERANG, BANTEN",29,85,151,236
https://kawalpemilu.org#52467,"PISANGAN JAYA, SEPATAN, TANGERANG, BANTEN",30,24,131,155
https://kawalpemilu.org#52467,"PISANGAN JAYA, SEPATAN, TANGERANG, BANTEN",31,40,140,180
https://kawalpemilu.org#52467,"PISANGAN JAYA, SEPATAN, TANGERANG, BANTEN",32,87,136,223
https://kawalpemilu.org#52467,"PISANGAN JAYA, SEPATAN, TANGERANG, BANTEN",34,86,91,177
https://kawalpemilu.org#52467,"PISANGAN JAYA, SEPATAN, TANGERANG, BANTEN",35,101,131,232
https://kawalpemilu.org#52467,"PISANGAN JAYA, SEPATAN, TANGERANG, BANTEN",36,117,113,230
https://kawalpemilu.org#52467,"PISANGAN JAYA, SEPATAN, TANGERANG, BANTEN",37,61,95,156
https://kawalpemilu.org#52467,"PISANGAN JAYA, SEPATAN, TANGERANG, BANTEN",38,77,104,181
https://kawalpemilu.org#52467,"PISANGAN JAYA, SEPATAN, TANGERANG, BANTEN",39,87,85,172
https://kawalpemilu.org#52467,"PISANGAN JAYA, SEPATAN, TANGERANG, BANTEN",40,35,110,145
https://kawalpemilu.org#52467,"PISANGAN JAYA, SEPATAN, TANGERANG, BANTEN",41,76,98,174
https://kawalpemilu.org#52467,"PISANGAN JAYA, SEPATAN, TANGERANG, BANTEN",42,53,162,215
https://kawalpemilu.org#52467,"PISANGAN JAYA, SEPATAN, TANGERANG, BANTEN",43,72,137,209
https://kawalpemilu.org#52467,"PISANGAN JAYA, SEPATAN, TANGERANG, BANTEN",44,68,173,241
https://kawalpemilu.org#52467,"PISANGAN JAYA, SEPATAN, TANGERANG, BANTEN",45,100,89,189
https://kawalpemilu.org#52467,"PISANGAN JAYA, SEPATAN, TANGERANG, BANTEN",46,98,128,226
https://kawalpemilu.org#52467,"PISANGAN JAYA, SEPATAN, TANGERANG, BANTEN",47,95,90,185
https://kawalpemilu.org#52468,"MEKAR JAYA, SEPATAN, TANGERANG, BANTEN",1,91,181,272
https://kawalpemilu.org#52468,"MEKAR JAYA, SEPATAN, TANGERANG, BANTEN",2,52,158,210
https://kawalpemilu.org#52468,"MEKAR JAYA, SEPATAN, TANGERANG, BANTEN",3,41,163,204
https://kawalpemilu.org#52468,"MEKAR JAYA, SEPATAN, TANGERANG, BANTEN",4,43,172,215
https://kawalpemilu.org#52468,"MEKAR JAYA, SEPATAN, TANGERANG, BANTEN",5,26,210,236
https://kawalpemilu.org#52468,"MEKAR JAYA, SEPATAN, TANGERANG, BANTEN",6,41,153,194
https://kawalpemilu.org#52468,"MEKAR JAYA, SEPATAN, TANGERANG, BANTEN",7,46,187,233
https://kawalpemilu.org#52468,"MEKAR JAYA, SEPATAN, TANGERANG, BANTEN",9,35,110,145
https://kawalpemilu.org#52468,"MEKAR JAYA, SEPATAN, TANGERANG, BANTEN",10,32,133,165
https://kawalpemilu.org#52468,"MEKAR JAYA, SEPATAN, TANGERANG, BANTEN",11,0,0,0
https://kawalpemilu.org#52468,"MEKAR JAYA, SEPATAN, TANGERANG, BANTEN",13,38,155,193
https://kawalpemilu.org#52468,"MEKAR JAYA, SEPATAN, TANGERANG, BANTEN",14,65,182,247
https://kawalpemilu.org#52468,"MEKAR JAYA, SEPATAN, TANGERANG, BANTEN",15,18,175,193
https://kawalpemilu.org#52468,"MEKAR JAYA, SEPATAN, TANGERANG, BANTEN",16,18,186,204
https://kawalpemilu.org#52468,"MEKAR JAYA, SEPATAN, TANGERANG, BANTEN",17,45,142,187
https://kawalpemilu.org#52468,"MEKAR JAYA, SEPATAN, TANGERANG, BANTEN",18,51,160,211
https://kawalpemilu.org#52468,"MEKAR JAYA, SEPATAN, TANGERANG, BANTEN",19,42,213,255
https://kawalpemilu.org#52468,"MEKAR JAYA, SEPATAN, TANGERANG, BANTEN",20,20,195,215
https://kawalpemilu.org#52468,"MEKAR JAYA, SEPATAN, TANGERANG, BANTEN",21,36,194,230
https://kawalpemilu.org#52468,"MEKAR JAYA, SEPATAN, TANGERANG, BANTEN",22,39,136,175
https://kawalpemilu.org#52468,"MEKAR JAYA, SEPATAN, TANGERANG, BANTEN",23,25,104,129
https://kawalpemilu.org#52468,"MEKAR JAYA, SEPATAN, TANGERANG, BANTEN",25,16,131,147
https://kawalpemilu.org#52468,"MEKAR JAYA, SEPATAN, TANGERANG, BANTEN",26,32,135,167
https://kawalpemilu.org#52468,"MEKAR JAYA, SEPATAN, TANGERANG, BANTEN",27,17,152,169
https://kawalpemilu.org#52469,"SARAKAN, SEPATAN, TANGERANG, BANTEN",1,88,179,267
https://kawalpemilu.org#52469,"SARAKAN, SEPATAN, TANGERANG, BANTEN",2,66,105,171
https://kawalpemilu.org#52469,"SARAKAN, SEPATAN, TANGERANG, BANTEN",3,93,140,233
https://kawalpemilu.org#52469,"SARAKAN, SEPATAN, TANGERANG, BANTEN",4,96,140,236
https://kawalpemilu.org#52469,"SARAKAN, SEPATAN, TANGERANG, BANTEN",5,98,117,215
https://kawalpemilu.org#52469,"SARAKAN, SEPATAN, TANGERANG, BANTEN",6,89,135,224
https://kawalpemilu.org#52469,"SARAKAN, SEPATAN, TANGERANG, BANTEN",7,72,139,211
https://kawalpemilu.org#52469,"SARAKAN, SEPATAN, TANGERANG, BANTEN",8,77,162,239
https://kawalpemilu.org#52469,"SARAKAN, SEPATAN, TANGERANG, BANTEN",9,68,122,190
https://kawalpemilu.org#52469,"SARAKAN, SEPATAN, TANGERANG, BANTEN",10,106,140,246
https://kawalpemilu.org#52469,"SARAKAN, SEPATAN, TANGERANG, BANTEN",11,35,185,220
https://kawalpemilu.org#52469,"SARAKAN, SEPATAN, TANGERANG, BANTEN",12,54,118,172
https://kawalpemilu.org#52469,"SARAKAN, SEPATAN, TANGERANG, BANTEN",13,28,117,145
https://kawalpemilu.org#52469,"SARAKAN, SEPATAN, TANGERANG, BANTEN",14,101,160,261
https://kawalpemilu.org#52469,"SARAKAN, SEPATAN, TANGERANG, BANTEN",15,30,126,156
https://kawalpemilu.org#52469,"SARAKAN, SEPATAN, TANGERANG, BANTEN",17,73,165,238
https://kawalpemilu.org#52469,"SARAKAN, SEPATAN, TANGERANG, BANTEN",18,28,136,164
https://kawalpemilu.org#52469,"SARAKAN, SEPATAN, TANGERANG, BANTEN",19,78,123,201
https://kawalpemilu.org#52469,"SARAKAN, SEPATAN, TANGERANG, BANTEN",20,49,55,104
https://kawalpemilu.org#52469,"SARAKAN, SEPATAN, TANGERANG, BANTEN",21,91,101,192
https://kawalpemilu.org#52469,"SARAKAN, SEPATAN, TANGERANG, BANTEN",22,62,122,184
https://kawalpemilu.org#52469,"SARAKAN, SEPATAN, TANGERANG, BANTEN",23,83,119,202
https://kawalpemilu.org#52469,"SARAKAN, SEPATAN, TANGERANG, BANTEN",24,70,121,191
https://kawalpemilu.org#52469,"SARAKAN, SEPATAN, TANGERANG, BANTEN",25,53,120,173
https://kawalpemilu.org#52469,"SARAKAN, SEPATAN, TANGERANG, BANTEN",26,52,151,203
https://kawalpemilu.org#52469,"SARAKAN, SEPATAN, TANGERANG, BANTEN",27,54,145,199
https://kawalpemilu.org#52469,"SARAKAN, SEPATAN, TANGERANG, BANTEN",28,45,166,211
https://kawalpemilu.org#52469,"SARAKAN, SEPATAN, TANGERANG, BANTEN",29,29,143,172
https://kawalpemilu.org#52469,"SARAKAN, SEPATAN, TANGERANG, BANTEN",30,49,95,144
https://kawalpemilu.org#52469,"SARAKAN, SEPATAN, TANGERANG, BANTEN",31,87,143,230
https://kawalpemilu.org#52469,"SARAKAN, SEPATAN, TANGERANG, BANTEN",32,54,90,144
https://kawalpemilu.org#52469,"SARAKAN, SEPATAN, TANGERANG, BANTEN",33,52,173,225
https://kawalpemilu.org#52471,"CURUG KULON, CURUG, TANGERANG, BANTEN",2,71,84,155
https://kawalpemilu.org#52471,"CURUG KULON, CURUG, TANGERANG, BANTEN",3,69,80,149
https://kawalpemilu.org#52471,"CURUG KULON, CURUG, TANGERANG, BANTEN",4,68,121,189
https://kawalpemilu.org#52471,"CURUG KULON, CURUG, TANGERANG, BANTEN",6,76,126,202
https://kawalpemilu.org#52471,"CURUG KULON, CURUG, TANGERANG, BANTEN",7,66,125,191
https://kawalpemilu.org#52471,"CURUG KULON, CURUG, TANGERANG, BANTEN",8,65,149,214
https://kawalpemilu.org#52471,"CURUG KULON, CURUG, TANGERANG, BANTEN",9,65,143,208
https://kawalpemilu.org#52471,"CURUG KULON, CURUG, TANGERANG, BANTEN",10,64,94,158
https://kawalpemilu.org#52471,"CURUG KULON, CURUG, TANGERANG, BANTEN",11,72,115,187
https://kawalpemilu.org#52471,"CURUG KULON, CURUG, TANGERANG, BANTEN",12,78,104,182
https://kawalpemilu.org#52471,"CURUG KULON, CURUG, TANGERANG, BANTEN",13,61,161,222
https://kawalpemilu.org#52471,"CURUG KULON, CURUG, TANGERANG, BANTEN",14,65,169,234
https://kawalpemilu.org#52471,"CURUG KULON, CURUG, TANGERANG, BANTEN",15,80,140,220
https://kawalpemilu.org#52471,"CURUG KULON, CURUG, TANGERANG, BANTEN",16,54,169,223
https://kawalpemilu.org#52471,"CURUG KULON, CURUG, TANGERANG, BANTEN",17,52,147,199
https://kawalpemilu.org#52471,"CURUG KULON, CURUG, TANGERANG, BANTEN",18,48,169,217
https://kawalpemilu.org#52471,"CURUG KULON, CURUG, TANGERANG, BANTEN",19,53,187,240
https://kawalpemilu.org#52471,"CURUG KULON, CURUG, TANGERANG, BANTEN",20,56,88,144
https://kawalpemilu.org#52471,"CURUG KULON, CURUG, TANGERANG, BANTEN",21,52,104,156
https://kawalpemilu.org#52471,"CURUG KULON, CURUG, TANGERANG, BANTEN",22,34,135,169
https://kawalpemilu.org#52471,"CURUG KULON, CURUG, TANGERANG, BANTEN",23,40,130,170
https://kawalpemilu.org#52471,"CURUG KULON, CURUG, TANGERANG, BANTEN",24,97,130,227
https://kawalpemilu.org#52471,"CURUG KULON, CURUG, TANGERANG, BANTEN",26,59,211,270
https://kawalpemilu.org#52471,"CURUG KULON, CURUG, TANGERANG, BANTEN",27,77,110,187
https://kawalpemilu.org#52471,"CURUG KULON, CURUG, TANGERANG, BANTEN",28,63,122,185
https://kawalpemilu.org#52471,"CURUG KULON, CURUG, TANGERANG, BANTEN",29,63,113,176
https://kawalpemilu.org#52471,"CURUG KULON, CURUG, TANGERANG, BANTEN",30,60,130,190
https://kawalpemilu.org#52471,"CURUG KULON, CURUG, TANGERANG, BANTEN",31,73,143,216
https://kawalpemilu.org#52471,"CURUG KULON, CURUG, TANGERANG, BANTEN",32,65,144,209
https://kawalpemilu.org#52471,"CURUG KULON, CURUG, TANGERANG, BANTEN",33,76,125,201
https://kawalpemilu.org#52471,"CURUG KULON, CURUG, TANGERANG, BANTEN",34,56,120,176
https://kawalpemilu.org#52471,"CURUG KULON, CURUG, TANGERANG, BANTEN",35,50,107,157
https://kawalpemilu.org#52471,"CURUG KULON, CURUG, TANGERANG, BANTEN",36,78,176,254
https://kawalpemilu.org#52471,"CURUG KULON, CURUG, TANGERANG, BANTEN",37,72,193,265
https://kawalpemilu.org#52471,"CURUG KULON, CURUG, TANGERANG, BANTEN",38,93,152,245
https://kawalpemilu.org#52471,"CURUG KULON, CURUG, TANGERANG, BANTEN",39,60,158,218
https://kawalpemilu.org#52471,"CURUG KULON, CURUG, TANGERANG, BANTEN",40,42,155,197
https://kawalpemilu.org#52471,"CURUG KULON, CURUG, TANGERANG, BANTEN",41,71,166,237
https://kawalpemilu.org#52471,"CURUG KULON, CURUG, TANGERANG, BANTEN",42,75,158,233
https://kawalpemilu.org#52471,"CURUG KULON, CURUG, TANGERANG, BANTEN",43,59,125,184
https://kawalpemilu.org#52471,"CURUG KULON, CURUG, TANGERANG, BANTEN",44,79,148,227
https://kawalpemilu.org#52471,"CURUG KULON, CURUG, TANGERANG, BANTEN",45,79,144,223
https://kawalpemilu.org#52471,"CURUG KULON, CURUG, TANGERANG, BANTEN",46,90,123,213
https://kawalpemilu.org#52471,"CURUG KULON, CURUG, TANGERANG, BANTEN",47,97,138,235
https://kawalpemilu.org#52471,"CURUG KULON, CURUG, TANGERANG, BANTEN",48,96,156,252
https://kawalpemilu.org#52471,"CURUG KULON, CURUG, TANGERANG, BANTEN",49,65,122,187
https://kawalpemilu.org#52471,"CURUG KULON, CURUG, TANGERANG, BANTEN",50,66,135,201
https://kawalpemilu.org#52471,"CURUG KULON, CURUG, TANGERANG, BANTEN",51,113,156,269
https://kawalpemilu.org#52472,"SUKABAKTI, CURUG, TANGERANG, BANTEN",1,63,109,172
https://kawalpemilu.org#52472,"SUKABAKTI, CURUG, TANGERANG, BANTEN",2,57,71,128
https://kawalpemilu.org#52472,"SUKABAKTI, CURUG, TANGERANG, BANTEN",3,75,110,185
https://kawalpemilu.org#52472,"SUKABAKTI, CURUG, TANGERANG, BANTEN",4,56,130,186
https://kawalpemilu.org#52472,"SUKABAKTI, CURUG, TANGERANG, BANTEN",6,106,100,206
https://kawalpemilu.org#52472,"SUKABAKTI, CURUG, TANGERANG, BANTEN",7,74,106,180
https://kawalpemilu.org#52472,"SUKABAKTI, CURUG, TANGERANG, BANTEN",8,49,104,153
https://kawalpemilu.org#52472,"SUKABAKTI, CURUG, TANGERANG, BANTEN",9,86,162,248
https://kawalpemilu.org#52472,"SUKABAKTI, CURUG, TANGERANG, BANTEN",10,78,130,208
https://kawalpemilu.org#52472,"SUKABAKTI, CURUG, TANGERANG, BANTEN",11,33,88,121
https://kawalpemilu.org#52472,"SUKABAKTI, CURUG, TANGERANG, BANTEN",12,83,101,184
https://kawalpemilu.org#52472,"SUKABAKTI, CURUG, TANGERANG, BANTEN",13,96,141,237
https://kawalpemilu.org#52472,"SUKABAKTI, CURUG, TANGERANG, BANTEN",14,102,137,239
https://kawalpemilu.org#52472,"SUKABAKTI, CURUG, TANGERANG, BANTEN",15,78,126,204
https://kawalpemilu.org#52472,"SUKABAKTI, CURUG, TANGERANG, BANTEN",16,89,143,232
https://kawalpemilu.org#52472,"SUKABAKTI, CURUG, TANGERANG, BANTEN",17,101,116,217
https://kawalpemilu.org#52472,"SUKABAKTI, CURUG, TANGERANG, BANTEN",18,75,82,157
https://kawalpemilu.org#52472,"SUKABAKTI, CURUG, TANGERANG, BANTEN",19,67,102,169
https://kawalpemilu.org#52472,"SUKABAKTI, CURUG, TANGERANG, BANTEN",20,82,93,175
https://kawalpemilu.org#52472,"SUKABAKTI, CURUG, TANGERANG, BANTEN",21,62,132,194
https://kawalpemilu.org#52472,"SUKABAKTI, CURUG, TANGERANG, BANTEN",22,52,126,178
https://kawalpemilu.org#52472,"SUKABAKTI, CURUG, TANGERANG, BANTEN",24,130,126,256
https://kawalpemilu.org#52472,"SUKABAKTI, CURUG, TANGERANG, BANTEN",25,33,169,202
https://kawalpemilu.org#52472,"SUKABAKTI, CURUG, TANGERANG, BANTEN",26,63,73,136
https://kawalpemilu.org#52472,"SUKABAKTI, CURUG, TANGERANG, BANTEN",27,40,113,153
https://kawalpemilu.org#52472,"SUKABAKTI, CURUG, TANGERANG, BANTEN",28,75,162,237
https://kawalpemilu.org#52472,"SUKABAKTI, CURUG, TANGERANG, BANTEN",29,55,99,154
https://kawalpemilu.org#52472,"SUKABAKTI, CURUG, TANGERANG, BANTEN",30,52,91,143
https://kawalpemilu.org#52472,"SUKABAKTI, CURUG, TANGERANG, BANTEN",31,80,89,169
https://kawalpemilu.org#52472,"SUKABAKTI, CURUG, TANGERANG, BANTEN",32,77,48,125
https://kawalpemilu.org#52472,"SUKABAKTI, CURUG, TANGERANG, BANTEN",33,75,92,167
https://kawalpemilu.org#52472,"SUKABAKTI, CURUG, TANGERANG, BANTEN",34,58,110,168
https://kawalpemilu.org#52472,"SUKABAKTI, CURUG, TANGERANG, BANTEN",35,71,97,168
https://kawalpemilu.org#52472,"SUKABAKTI, CURUG, TANGERANG, BANTEN",36,73,165,238
https://kawalpemilu.org#52472,"SUKABAKTI, CURUG, TANGERANG, BANTEN",37,60,150,210
https://kawalpemilu.org#52472,"SUKABAKTI, CURUG, TANGERANG, BANTEN",38,48,146,194
https://kawalpemilu.org#52472,"SUKABAKTI, CURUG, TANGERANG, BANTEN",39,65,147,212
https://kawalpemilu.org#52472,"SUKABAKTI, CURUG, TANGERANG, BANTEN",40,89,161,250
https://kawalpemilu.org#52472,"SUKABAKTI, CURUG, TANGERANG, BANTEN",41,93,196,289
https://kawalpemilu.org#52472,"SUKABAKTI, CURUG, TANGERANG, BANTEN",42,89,197,286
https://kawalpemilu.org#52472,"SUKABAKTI, CURUG, TANGERANG, BANTEN",43,131,98,229
https://kawalpemilu.org#52472,"SUKABAKTI, CURUG, TANGERANG, BANTEN",44,72,33,105
https://kawalpemilu.org#52472,"SUKABAKTI, CURUG, TANGERANG, BANTEN",45,152,108,260
https://kawalpemilu.org#52472,"SUKABAKTI, CURUG, TANGERANG, BANTEN",46,130,106,236
https://kawalpemilu.org#52472,"SUKABAKTI, CURUG, TANGERANG, BANTEN",47,109,71,0
https://kawalpemilu.org#52472,"SUKABAKTI, CURUG, TANGERANG, BANTEN",48,103,66,169
https://kawalpemilu.org#52472,"SUKABAKTI, CURUG, TANGERANG, BANTEN",49,88,72,160
https://kawalpemilu.org#52472,"SUKABAKTI, CURUG, TANGERANG, BANTEN",51,62,31,93
https://kawalpemilu.org#52472,"SUKABAKTI, CURUG, TANGERANG, BANTEN",52,125,102,227
https://kawalpemilu.org#52472,"SUKABAKTI, CURUG, TANGERANG, BANTEN",53,93,87,180
https://kawalpemilu.org#52473,"BINONG, CURUG, TANGERANG, BANTEN",1,84,99,183
https://kawalpemilu.org#52473,"BINONG, CURUG, TANGERANG, BANTEN",2,0,0,0
https://kawalpemilu.org#52473,"BINONG, CURUG, TANGERANG, BANTEN",3,55,63,118
https://kawalpemilu.org#52473,"BINONG, CURUG, TANGERANG, BANTEN",4,77,76,153
https://kawalpemilu.org#52473,"BINONG, CURUG, TANGERANG, BANTEN",5,106,119,225
https://kawalpemilu.org#52473,"BINONG, CURUG, TANGERANG, BANTEN",7,98,161,259
https://kawalpemilu.org#52473,"BINONG, CURUG, TANGERANG, BANTEN",8,88,160,202
https://kawalpemilu.org#52473,"BINONG, CURUG, TANGERANG, BANTEN",9,77,155,232
https://kawalpemilu.org#52473,"BINONG, CURUG, TANGERANG, BANTEN",10,76,120,196
https://kawalpemilu.org#52473,"BINONG, CURUG, TANGERANG, BANTEN",11,0,0,102
https://kawalpemilu.org#52473,"BINONG, CURUG, TANGERANG, BANTEN",12,84,95,179
https://kawalpemilu.org#52473,"BINONG, CURUG, TANGERANG, BANTEN",13,84,132,216
https://kawalpemilu.org#52473,"BINONG, CURUG, TANGERANG, BANTEN",15,69,163,232
https://kawalpemilu.org#52473,"BINONG, CURUG, TANGERANG, BANTEN",16,99,133,232
https://kawalpemilu.org#52473,"BINONG, CURUG, TANGERANG, BANTEN",17,120,142,262
https://kawalpemilu.org#52473,"BINONG, CURUG, TANGERANG, BANTEN",18,87,166,253
https://kawalpemilu.org#52473,"BINONG, CURUG, TANGERANG, BANTEN",19,72,153,225
https://kawalpemilu.org#52473,"BINONG, CURUG, TANGERANG, BANTEN",20,60,107,167
https://kawalpemilu.org#52473,"BINONG, CURUG, TANGERANG, BANTEN",21,0,0,0
https://kawalpemilu.org#52473,"BINONG, CURUG, TANGERANG, BANTEN",22,107,128,235
https://kawalpemilu.org#52473,"BINONG, CURUG, TANGERANG, BANTEN",23,124,118,242
https://kawalpemilu.org#52473,"BINONG, CURUG, TANGERANG, BANTEN",24,120,142,262
https://kawalpemilu.org#52473,"BINONG, CURUG, TANGERANG, BANTEN",25,0,0,0
https://kawalpemilu.org#52473,"BINONG, CURUG, TANGERANG, BANTEN",26,98,104,202
https://kawalpemilu.org#52473,"BINONG, CURUG, TANGERANG, BANTEN",27,77,110,187
https://kawalpemilu.org#52473,"BINONG, CURUG, TANGERANG, BANTEN",29,62,84,146
https://kawalpemilu.org#52473,"BINONG, CURUG, TANGERANG, BANTEN",30,74,61,135
https://kawalpemilu.org#52473,"BINONG, CURUG, TANGERANG, BANTEN",31,46,58,104
https://kawalpemilu.org#52473,"BINONG, CURUG, TANGERANG, BANTEN",32,64,58,122
https://kawalpemilu.org#52473,"BINONG, CURUG, TANGERANG, BANTEN",33,0,0,0
https://kawalpemilu.org#52473,"BINONG, CURUG, TANGERANG, BANTEN",35,68,113,181
https://kawalpemilu.org#52473,"BINONG, CURUG, TANGERANG, BANTEN",36,89,130,219
https://kawalpemilu.org#52473,"BINONG, CURUG, TANGERANG, BANTEN",37,77,156,233
https://kawalpemilu.org#52473,"BINONG, CURUG, TANGERANG, BANTEN",38,53,70,123
https://kawalpemilu.org#52473,"BINONG, CURUG, TANGERANG, BANTEN",39,49,67,116
https://kawalpemilu.org#52473,"BINONG, CURUG, TANGERANG, BANTEN",40,134,103,237
https://kawalpemilu.org#52473,"BINONG, CURUG, TANGERANG, BANTEN",43,89,133,222
https://kawalpemilu.org#52473,"BINONG, CURUG, TANGERANG, BANTEN",44,89,123,212
https://kawalpemilu.org#52473,"BINONG, CURUG, TANGERANG, BANTEN",45,133,37,170
https://kawalpemilu.org#52473,"BINONG, CURUG, TANGERANG, BANTEN",46,141,88,229
https://kawalpemilu.org#52473,"BINONG, CURUG, TANGERANG, BANTEN",49,87,175,262
https://kawalpemilu.org#52473,"BINONG, CURUG, TANGERANG, BANTEN",50,97,130,127
https://kawalpemilu.org#52473,"BINONG, CURUG, TANGERANG, BANTEN",51,65,135,200
https://kawalpemilu.org#52473,"BINONG, CURUG, TANGERANG, BANTEN",52,51,99,150
https://kawalpemilu.org#52473,"BINONG, CURUG, TANGERANG, BANTEN",53,61,116,177
https://kawalpemilu.org#52473,"BINONG, CURUG, TANGERANG, BANTEN",54,62,58,120
https://kawalpemilu.org#52473,"BINONG, CURUG, TANGERANG, BANTEN",55,92,88,180
https://kawalpemilu.org#52473,"BINONG, CURUG, TANGERANG, BANTEN",56,24,129,153
https://kawalpemilu.org#52473,"BINONG, CURUG, TANGERANG, BANTEN",58,71,107,178
https://kawalpemilu.org#52473,"BINONG, CURUG, TANGERANG, BANTEN",59,64,92,156
https://kawalpemilu.org#52473,"BINONG, CURUG, TANGERANG, BANTEN",60,59,98,157
https://kawalpemilu.org#52473,"BINONG, CURUG, TANGERANG, BANTEN",62,67,143,210
https://kawalpemilu.org#52473,"BINONG, CURUG, TANGERANG, BANTEN",63,73,118,191
https://kawalpemilu.org#52473,"BINONG, CURUG, TANGERANG, BANTEN",64,79,144,223
https://kawalpemilu.org#52473,"BINONG, CURUG, TANGERANG, BANTEN",65,52,158,210
https://kawalpemilu.org#52473,"BINONG, CURUG, TANGERANG, BANTEN",67,106,129,235
https://kawalpemilu.org#52473,"BINONG, CURUG, TANGERANG, BANTEN",68,151,96,247
https://kawalpemilu.org#52473,"BINONG, CURUG, TANGERANG, BANTEN",69,133,83,216
https://kawalpemilu.org#52473,"BINONG, CURUG, TANGERANG, BANTEN",71,137,108,245
https://kawalpemilu.org#52473,"BINONG, CURUG, TANGERANG, BANTEN",72,124,71,195
https://kawalpemilu.org#52473,"BINONG, CURUG, TANGERANG, BANTEN",73,100,82,182
https://kawalpemilu.org#52473,"BINONG, CURUG, TANGERANG, BANTEN",74,123,115,238
https://kawalpemilu.org#52473,"BINONG, CURUG, TANGERANG, BANTEN",75,86,119,205
https://kawalpemilu.org#52473,"BINONG, CURUG, TANGERANG, BANTEN",76,119,109,228
https://kawalpemilu.org#52473,"BINONG, CURUG, TANGERANG, BANTEN",77,94,66,160
https://kawalpemilu.org#52473,"BINONG, CURUG, TANGERANG, BANTEN",78,132,111,243
https://kawalpemilu.org#52473,"BINONG, CURUG, TANGERANG, BANTEN",79,101,82,183
https://kawalpemilu.org#52473,"BINONG, CURUG, TANGERANG, BANTEN",80,107,125,232
https://kawalpemilu.org#52473,"BINONG, CURUG, TANGERANG, BANTEN",81,102,115,217
https://kawalpemilu.org#52473,"BINONG, CURUG, TANGERANG, BANTEN",83,129,109,238
https://kawalpemilu.org#52473,"BINONG, CURUG, TANGERANG, BANTEN",84,136,124,260
https://kawalpemilu.org#52473,"BINONG, CURUG, TANGERANG, BANTEN",85,104,85,189
https://kawalpemilu.org#52473,"BINONG, CURUG, TANGERANG, BANTEN",86,92,119,211
https://kawalpemilu.org#52473,"BINONG, CURUG, TANGERANG, BANTEN",87,152,78,230
https://kawalpemilu.org#52473,"BINONG, CURUG, TANGERANG, BANTEN",88,149,100,249
https://kawalpemilu.org#52473,"BINONG, CURUG, TANGERANG, BANTEN",89,94,151,245
https://kawalpemilu.org#52473,"BINONG, CURUG, TANGERANG, BANTEN",90,82,147,229
https://kawalpemilu.org#52473,"BINONG, CURUG, TANGERANG, BANTEN",91,104,124,228
https://kawalpemilu.org#52473,"BINONG, CURUG, TANGERANG, BANTEN",92,69,84,153
https://kawalpemilu.org#52473,"BINONG, CURUG, TANGERANG, BANTEN",93,65,36,101
https://kawalpemilu.org#52473,"BINONG, CURUG, TANGERANG, BANTEN",94,85,81,166
https://kawalpemilu.org#52473,"BINONG, CURUG, TANGERANG, BANTEN",95,99,98,197
https://kawalpemilu.org#52473,"BINONG, CURUG, TANGERANG, BANTEN",96,95,104,199
https://kawalpemilu.org#52473,"BINONG, CURUG, TANGERANG, BANTEN",97,108,130,238
https://kawalpemilu.org#52473,"BINONG, CURUG, TANGERANG, BANTEN",98,116,118,234
https://kawalpemilu.org#52473,"BINONG, CURUG, TANGERANG, BANTEN",99,106,105,211
https://kawalpemilu.org#52473,"BINONG, CURUG, TANGERANG, BANTEN",100,112,95,207
https://kawalpemilu.org#52473,"BINONG, CURUG, TANGERANG, BANTEN",101,102,140,242
https://kawalpemilu.org#52473,"BINONG, CURUG, TANGERANG, BANTEN",102,71,73,144
https://kawalpemilu.org#52473,"BINONG, CURUG, TANGERANG, BANTEN",104,115,134,249
https://kawalpemilu.org#52473,"BINONG, CURUG, TANGERANG, BANTEN",105,92,97,189
https://kawalpemilu.org#52473,"BINONG, CURUG, TANGERANG, BANTEN",106,102,124,226
https://kawalpemilu.org#52473,"BINONG, CURUG, TANGERANG, BANTEN",107,104,146,250
https://kawalpemilu.org#52473,"BINONG, CURUG, TANGERANG, BANTEN",108,102,71,173
https://kawalpemilu.org#52473,"BINONG, CURUG, TANGERANG, BANTEN",110,64,105,169
https://kawalpemilu.org#52473,"BINONG, CURUG, TANGERANG, BANTEN",111,143,125,268
https://kawalpemilu.org#52473,"BINONG, CURUG, TANGERANG, BANTEN",112,122,105,227
https://kawalpemilu.org#52473,"BINONG, CURUG, TANGERANG, BANTEN",113,71,82,0
https://kawalpemilu.org#52473,"BINONG, CURUG, TANGERANG, BANTEN",114,100,85,185
https://kawalpemilu.org#52473,"BINONG, CURUG, TANGERANG, BANTEN",115,125,108,233
https://kawalpemilu.org#52473,"BINONG, CURUG, TANGERANG, BANTEN",116,77,64,141
https://kawalpemilu.org#52473,"BINONG, CURUG, TANGERANG, BANTEN",117,74,64,138
https://kawalpemilu.org#52473,"BINONG, CURUG, TANGERANG, BANTEN",118,182,84,266
https://kawalpemilu.org#52473,"BINONG, CURUG, TANGERANG, BANTEN",119,123,113,236
https://kawalpemilu.org#52473,"BINONG, CURUG, TANGERANG, BANTEN",120,75,153,228
https://kawalpemilu.org#52473,"BINONG, CURUG, TANGERANG, BANTEN",121,78,88,166
https://kawalpemilu.org#52473,"BINONG, CURUG, TANGERANG, BANTEN",122,88,81,169
https://kawalpemilu.org#52473,"BINONG, CURUG, TANGERANG, BANTEN",124,90,117,207
https://kawalpemilu.org#52473,"BINONG, CURUG, TANGERANG, BANTEN",125,91,131,222
https://kawalpemilu.org#52473,"BINONG, CURUG, TANGERANG, BANTEN",126,47,78,119
https://kawalpemilu.org#52473,"BINONG, CURUG, TANGERANG, BANTEN",127,92,118,210
https://kawalpemilu.org#52473,"BINONG, CURUG, TANGERANG, BANTEN",129,109,150,259
https://kawalpemilu.org#52473,"BINONG, CURUG, TANGERANG, BANTEN",130,103,141,244
https://kawalpemilu.org#52473,"BINONG, CURUG, TANGERANG, BANTEN",131,86,177,263
https://kawalpemilu.org#52473,"BINONG, CURUG, TANGERANG, BANTEN",132,52,102,154
https://kawalpemilu.org#52473,"BINONG, CURUG, TANGERANG, BANTEN",133,69,131,200
https://kawalpemilu.org#52473,"BINONG, CURUG, TANGERANG, BANTEN",134,130,128,258
https://kawalpemilu.org#52473,"BINONG, CURUG, TANGERANG, BANTEN",135,91,179,270
https://kawalpemilu.org#52473,"BINONG, CURUG, TANGERANG, BANTEN",137,117,138,255
https://kawalpemilu.org#52473,"BINONG, CURUG, TANGERANG, BANTEN",138,141,109,250
https://kawalpemilu.org#52473,"BINONG, CURUG, TANGERANG, BANTEN",139,127,117,244
https://kawalpemilu.org#52473,"BINONG, CURUG, TANGERANG, BANTEN",140,0,0,0
https://kawalpemilu.org#52473,"BINONG, CURUG, TANGERANG, BANTEN",141,200,17,217
https://kawalpemilu.org#52473,"BINONG, CURUG, TANGERANG, BANTEN",142,227,12,239
https://kawalpemilu.org#52473,"BINONG, CURUG, TANGERANG, BANTEN",143,191,28,219
https://kawalpemilu.org#52473,"BINONG, CURUG, TANGERANG, BANTEN",144,215,31,246
https://kawalpemilu.org#52473,"BINONG, CURUG, TANGERANG, BANTEN",145,193,14,207
https://kawalpemilu.org#52473,"BINONG, CURUG, TANGERANG, BANTEN",146,206,24,230
https://kawalpemilu.org#52473,"BINONG, CURUG, TANGERANG, BANTEN",147,192,11,203
https://kawalpemilu.org#52473,"BINONG, CURUG, TANGERANG, BANTEN",148,218,7,225
https://kawalpemilu.org#52473,"BINONG, CURUG, TANGERANG, BANTEN",149,238,19,257
https://kawalpemilu.org#52473,"BINONG, CURUG, TANGERANG, BANTEN",150,176,29,205
https://kawalpemilu.org#52473,"BINONG, CURUG, TANGERANG, BANTEN",151,142,13,155
https://kawalpemilu.org#52473,"BINONG, CURUG, TANGERANG, BANTEN",152,220,23,243
https://kawalpemilu.org#52473,"BINONG, CURUG, TANGERANG, BANTEN",153,216,38,254
https://kawalpemilu.org#52473,"BINONG, CURUG, TANGERANG, BANTEN",154,190,15,205
https://kawalpemilu.org#52473,"BINONG, CURUG, TANGERANG, BANTEN",155,170,41,211
https://kawalpemilu.org#52473,"BINONG, CURUG, TANGERANG, BANTEN",156,187,33,220
https://kawalpemilu.org#52473,"BINONG, CURUG, TANGERANG, BANTEN",157,218,37,255
https://kawalpemilu.org#52473,"BINONG, CURUG, TANGERANG, BANTEN",158,134,13,147
https://kawalpemilu.org#52473,"BINONG, CURUG, TANGERANG, BANTEN",159,183,34,217
https://kawalpemilu.org#52473,"BINONG, CURUG, TANGERANG, BANTEN",160,190,12,202
https://kawalpemilu.org#52474,"CURUG WETAN, CURUG, TANGERANG, BANTEN",1,81,149,230
https://kawalpemilu.org#52474,"CURUG WETAN, CURUG, TANGERANG, BANTEN",2,69,95,164
https://kawalpemilu.org#52474,"CURUG WETAN, CURUG, TANGERANG, BANTEN",3,110,133,243
https://kawalpemilu.org#52474,"CURUG WETAN, CURUG, TANGERANG, BANTEN",4,61,128,189
https://kawalpemilu.org#52474,"CURUG WETAN, CURUG, TANGERANG, BANTEN",5,72,142,214
https://kawalpemilu.org#52474,"CURUG WETAN, CURUG, TANGERANG, BANTEN",6,83,87,170
https://kawalpemilu.org#52474,"CURUG WETAN, CURUG, TANGERANG, BANTEN",7,78,104,182
https://kawalpemilu.org#52474,"CURUG WETAN, CURUG, TANGERANG, BANTEN",8,57,184,241
https://kawalpemilu.org#52474,"CURUG WETAN, CURUG, TANGERANG, BANTEN",9,78,102,180
https://kawalpemilu.org#52474,"CURUG WETAN, CURUG, TANGERANG, BANTEN",10,62,125,187
https://kawalpemilu.org#52474,"CURUG WETAN, CURUG, TANGERANG, BANTEN",11,57,124,181
https://kawalpemilu.org#52474,"CURUG WETAN, CURUG, TANGERANG, BANTEN",12,57,125,182
https://kawalpemilu.org#52474,"CURUG WETAN, CURUG, TANGERANG, BANTEN",13,60,165,225
https://kawalpemilu.org#52474,"CURUG WETAN, CURUG, TANGERANG, BANTEN",14,64,92,156
https://kawalpemilu.org#52474,"CURUG WETAN, CURUG, TANGERANG, BANTEN",15,43,106,149
https://kawalpemilu.org#52474,"CURUG WETAN, CURUG, TANGERANG, BANTEN",16,38,114,152
https://kawalpemilu.org#52474,"CURUG WETAN, CURUG, TANGERANG, BANTEN",17,64,155,219
https://kawalpemilu.org#52474,"CURUG WETAN, CURUG, TANGERANG, BANTEN",18,81,148,229
https://kawalpemilu.org#52474,"CURUG WETAN, CURUG, TANGERANG, BANTEN",19,85,139,224
https://kawalpemilu.org#52474,"CURUG WETAN, CURUG, TANGERANG, BANTEN",20,101,125,226
https://kawalpemilu.org#52474,"CURUG WETAN, CURUG, TANGERANG, BANTEN",21,115,140,255
https://kawalpemilu.org#52474,"CURUG WETAN, CURUG, TANGERANG, BANTEN",22,60,106,166
https://kawalpemilu.org#52474,"CURUG WETAN, CURUG, TANGERANG, BANTEN",23,58,119,177
https://kawalpemilu.org#52474,"CURUG WETAN, CURUG, TANGERANG, BANTEN",24,49,124,173
https://kawalpemilu.org#52474,"CURUG WETAN, CURUG, TANGERANG, BANTEN",25,55,109,164
https://kawalpemilu.org#52474,"CURUG WETAN, CURUG, TANGERANG, BANTEN",26,47,113,160
https://kawalpemilu.org#52474,"CURUG WETAN, CURUG, TANGERANG, BANTEN",27,75,111,186
https://kawalpemilu.org#52474,"CURUG WETAN, CURUG, TANGERANG, BANTEN",28,100,45,145
https://kawalpemilu.org#52474,"CURUG WETAN, CURUG, TANGERANG, BANTEN",29,55,40,95
https://kawalpemilu.org#52474,"CURUG WETAN, CURUG, TANGERANG, BANTEN",30,65,168,233
https://kawalpemilu.org#52474,"CURUG WETAN, CURUG, TANGERANG, BANTEN",31,87,97,184
https://kawalpemilu.org#52474,"CURUG WETAN, CURUG, TANGERANG, BANTEN",32,34,85,119
https://kawalpemilu.org#52474,"CURUG WETAN, CURUG, TANGERANG, BANTEN",33,101,115,216
https://kawalpemilu.org#52474,"CURUG WETAN, CURUG, TANGERANG, BANTEN",34,135,120,255
https://kawalpemilu.org#52474,"CURUG WETAN, CURUG, TANGERANG, BANTEN",35,84,64,148
https://kawalpemilu.org#52474,"CURUG WETAN, CURUG, TANGERANG, BANTEN",36,114,95,209
https://kawalpemilu.org#52474,"CURUG WETAN, CURUG, TANGERANG, BANTEN",37,68,86,154
https://kawalpemilu.org#52474,"CURUG WETAN, CURUG, TANGERANG, BANTEN",38,105,58,163
https://kawalpemilu.org#52474,"CURUG WETAN, CURUG, TANGERANG, BANTEN",39,118,86,204
https://kawalpemilu.org#52474,"CURUG WETAN, CURUG, TANGERANG, BANTEN",40,91,65,156
https://kawalpemilu.org#52474,"CURUG WETAN, CURUG, TANGERANG, BANTEN",41,126,75,201
https://kawalpemilu.org#52474,"CURUG WETAN, CURUG, TANGERANG, BANTEN",42,122,131,253
https://kawalpemilu.org#52474,"CURUG WETAN, CURUG, TANGERANG, BANTEN",43,121,134,255
https://kawalpemilu.org#52474,"CURUG WETAN, CURUG, TANGERANG, BANTEN",44,104,101,205
https://kawalpemilu.org#52474,"CURUG WETAN, CURUG, TANGERANG, BANTEN",45,86,72,158
https://kawalpemilu.org#52475,"KADU, CURUG, TANGERANG, BANTEN",1,98,83,181
https://kawalpemilu.org#52475,"KADU, CURUG, TANGERANG, BANTEN",2,131,72,203
https://kawalpemilu.org#52475,"KADU, CURUG, TANGERANG, BANTEN",3,129,93,222
https://kawalpemilu.org#52475,"KADU, CURUG, TANGERANG, BANTEN",4,23,32,55
https://kawalpemilu.org#52475,"KADU, CURUG, TANGERANG, BANTEN",5,27,61,88
https://kawalpemilu.org#52475,"KADU, CURUG, TANGERANG, BANTEN",6,39,87,126
https://kawalpemilu.org#52475,"KADU, CURUG, TANGERANG, BANTEN",7,48,72,120
https://kawalpemilu.org#52475,"KADU, CURUG, TANGERANG, BANTEN",8,28,42,70
https://kawalpemilu.org#52475,"KADU, CURUG, TANGERANG, BANTEN",9,60,145,205
https://kawalpemilu.org#52475,"KADU, CURUG, TANGERANG, BANTEN",10,68,156,224
https://kawalpemilu.org#52475,"KADU, CURUG, TANGERANG, BANTEN",11,69,87,156
https://kawalpemilu.org#52475,"KADU, CURUG, TANGERANG, BANTEN",12,85,120,205
https://kawalpemilu.org#52475,"KADU, CURUG, TANGERANG, BANTEN",13,59,74,133
https://kawalpemilu.org#52475,"KADU, CURUG, TANGERANG, BANTEN",14,40,55,95
https://kawalpemilu.org#52475,"KADU, CURUG, TANGERANG, BANTEN",15,89,132,221
https://kawalpemilu.org#52475,"KADU, CURUG, TANGERANG, BANTEN",16,77,135,212
https://kawalpemilu.org#52475,"KADU, CURUG, TANGERANG, BANTEN",18,94,113,207
https://kawalpemilu.org#52475,"KADU, CURUG, TANGERANG, BANTEN",19,92,106,198
https://kawalpemilu.org#52475,"KADU, CURUG, TANGERANG, BANTEN",21,68,95,163
https://kawalpemilu.org#52475,"KADU, CURUG, TANGERANG, BANTEN",22,56,147,203
https://kawalpemilu.org#52475,"KADU, CURUG, TANGERANG, BANTEN",23,63,123,186
https://kawalpemilu.org#52475,"KADU, CURUG, TANGERANG, BANTEN",24,71,167,238
https://kawalpemilu.org#52475,"KADU, CURUG, TANGERANG, BANTEN",25,62,98,160
https://kawalpemilu.org#52475,"KADU, CURUG, TANGERANG, BANTEN",26,41,108,149
https://kawalpemilu.org#52475,"KADU, CURUG, TANGERANG, BANTEN",27,42,96,138
https://kawalpemilu.org#52475,"KADU, CURUG, TANGERANG, BANTEN",28,53,100,153
https://kawalpemilu.org#52475,"KADU, CURUG, TANGERANG, BANTEN",29,82,134,216
https://kawalpemilu.org#52475,"KADU, CURUG, TANGERANG, BANTEN",30,62,110,172
https://kawalpemilu.org#52475,"KADU, CURUG, TANGERANG, BANTEN",31,61,129,190
https://kawalpemilu.org#52475,"KADU, CURUG, TANGERANG, BANTEN",32,49,88,137
https://kawalpemilu.org#52475,"KADU, CURUG, TANGERANG, BANTEN",33,72,176,248
https://kawalpemilu.org#52475,"KADU, CURUG, TANGERANG, BANTEN",34,83,141,230
https://kawalpemilu.org#52475,"KADU, CURUG, TANGERANG, BANTEN",36,81,156,237
https://kawalpemilu.org#52475,"KADU, CURUG, TANGERANG, BANTEN",37,73,156,229
https://kawalpemilu.org#52475,"KADU, CURUG, TANGERANG, BANTEN",38,65,167,232
https://kawalpemilu.org#52475,"KADU, CURUG, TANGERANG, BANTEN",39,90,138,228
https://kawalpemilu.org#52475,"KADU, CURUG, TANGERANG, BANTEN",40,70,151,221
https://kawalpemilu.org#52475,"KADU, CURUG, TANGERANG, BANTEN",41,43,114,157
https://kawalpemilu.org#52475,"KADU, CURUG, TANGERANG, BANTEN",42,43,135,3
https://kawalpemilu.org#52475,"KADU, CURUG, TANGERANG, BANTEN",43,80,121,201
https://kawalpemilu.org#52475,"KADU, CURUG, TANGERANG, BANTEN",44,69,81,150
https://kawalpemilu.org#52475,"KADU, CURUG, TANGERANG, BANTEN",47,69,157,226
https://kawalpemilu.org#52475,"KADU, CURUG, TANGERANG, BANTEN",48,82,119,201
https://kawalpemilu.org#52475,"KADU, CURUG, TANGERANG, BANTEN",49,69,121,190
https://kawalpemilu.org#52475,"KADU, CURUG, TANGERANG, BANTEN",50,77,169,246
https://kawalpemilu.org#52475,"KADU, CURUG, TANGERANG, BANTEN",51,82,102,184
https://kawalpemilu.org#52475,"KADU, CURUG, TANGERANG, BANTEN",52,0,0,0
https://kawalpemilu.org#52475,"KADU, CURUG, TANGERANG, BANTEN",53,83,132,215
https://kawalpemilu.org#52475,"KADU, CURUG, TANGERANG, BANTEN",54,114,185,299
https://kawalpemilu.org#52475,"KADU, CURUG, TANGERANG, BANTEN",55,81,102,183
https://kawalpemilu.org#52475,"KADU, CURUG, TANGERANG, BANTEN",56,24,129,153
https://kawalpemilu.org#52475,"KADU, CURUG, TANGERANG, BANTEN",57,33,148,181
https://kawalpemilu.org#52475,"KADU, CURUG, TANGERANG, BANTEN",58,131,26,157
https://kawalpemilu.org#52475,"KADU, CURUG, TANGERANG, BANTEN",59,11,134,145
https://kawalpemilu.org#52475,"KADU, CURUG, TANGERANG, BANTEN",60,44,158,202
https://kawalpemilu.org#52475,"KADU, CURUG, TANGERANG, BANTEN",61,62,154,216
https://kawalpemilu.org#52475,"KADU, CURUG, TANGERANG, BANTEN",62,58,141,199
https://kawalpemilu.org#52475,"KADU, CURUG, TANGERANG, BANTEN",63,51,157,208
https://kawalpemilu.org#52475,"KADU, CURUG, TANGERANG, BANTEN",64,30,142,172
https://kawalpemilu.org#52475,"KADU, CURUG, TANGERANG, BANTEN",65,39,159,198
https://kawalpemilu.org#52475,"KADU, CURUG, TANGERANG, BANTEN",66,37,173,210
https://kawalpemilu.org#52475,"KADU, CURUG, TANGERANG, BANTEN",67,58,199,257
https://kawalpemilu.org#52475,"KADU, CURUG, TANGERANG, BANTEN",68,49,164,213
https://kawalpemilu.org#52475,"KADU, CURUG, TANGERANG, BANTEN",69,37,189,226
https://kawalpemilu.org#52475,"KADU, CURUG, TANGERANG, BANTEN",70,59,185,244
https://kawalpemilu.org#52475,"KADU, CURUG, TANGERANG, BANTEN",71,73,129,202
https://kawalpemilu.org#52475,"KADU, CURUG, TANGERANG, BANTEN",72,95,133,228
https://kawalpemilu.org#52475,"KADU, CURUG, TANGERANG, BANTEN",73,45,211,256
https://kawalpemilu.org#52475,"KADU, CURUG, TANGERANG, BANTEN",74,71,215,286
https://kawalpemilu.org#52475,"KADU, CURUG, TANGERANG, BANTEN",75,68,144,212
https://kawalpemilu.org#52475,"KADU, CURUG, TANGERANG, BANTEN",76,121,132,253
https://kawalpemilu.org#52475,"KADU, CURUG, TANGERANG, BANTEN",77,207,95,302
https://kawalpemilu.org#52476,"KADU JAYA, CURUG, TANGERANG, BANTEN",1,74,98,172
https://kawalpemilu.org#52476,"KADU JAYA, CURUG, TANGERANG, BANTEN",2,69,114,183
https://kawalpemilu.org#52476,"KADU JAYA, CURUG, TANGERANG, BANTEN",3,65,103,168
https://kawalpemilu.org#52476,"KADU JAYA, CURUG, TANGERANG, BANTEN",4,56,72,128
https://kawalpemilu.org#52476,"KADU JAYA, CURUG, TANGERANG, BANTEN",5,59,93,152
https://kawalpemilu.org#52476,"KADU JAYA, CURUG, TANGERANG, BANTEN",6,69,94,163
https://kawalpemilu.org#52476,"KADU JAYA, CURUG, TANGERANG, BANTEN",7,85,128,213
https://kawalpemilu.org#52476,"KADU JAYA, CURUG, TANGERANG, BANTEN",8,73,141,214
https://kawalpemilu.org#52476,"KADU JAYA, CURUG, TANGERANG, BANTEN",9,68,86,154
https://kawalpemilu.org#52476,"KADU JAYA, CURUG, TANGERANG, BANTEN",10,87,92,179
https://kawalpemilu.org#52476,"KADU JAYA, CURUG, TANGERANG, BANTEN",11,65,133,198
https://kawalpemilu.org#52476,"KADU JAYA, CURUG, TANGERANG, BANTEN",12,43,107,150
https://kawalpemilu.org#52476,"KADU JAYA, CURUG, TANGERANG, BANTEN",13,62,168,230
https://kawalpemilu.org#52476,"KADU JAYA, CURUG, TANGERANG, BANTEN",14,51,106,157
https://kawalpemilu.org#52476,"KADU JAYA, CURUG, TANGERANG, BANTEN",15,68,90,158
https://kawalpemilu.org#52476,"KADU JAYA, CURUG, TANGERANG, BANTEN",16,60,141,201
https://kawalpemilu.org#52476,"KADU JAYA, CURUG, TANGERANG, BANTEN",18,106,103,209
https://kawalpemilu.org#52476,"KADU JAYA, CURUG, TANGERANG, BANTEN",19,44,126,170
https://kawalpemilu.org#52476,"KADU JAYA, CURUG, TANGERANG, BANTEN",20,39,125,164
https://kawalpemilu.org#52476,"KADU JAYA, CURUG, TANGERANG, BANTEN",21,56,123,179
https://kawalpemilu.org#52476,"KADU JAYA, CURUG, TANGERANG, BANTEN",22,53,130,183
https://kawalpemilu.org#52476,"KADU JAYA, CURUG, TANGERANG, BANTEN",23,60,140,200
https://kawalpemilu.org#52476,"KADU JAYA, CURUG, TANGERANG, BANTEN",24,52,147,199
https://kawalpemilu.org#52476,"KADU JAYA, CURUG, TANGERANG, BANTEN",25,57,116,173
https://kawalpemilu.org#52476,"KADU JAYA, CURUG, TANGERANG, BANTEN",26,51,85,136
https://kawalpemilu.org#52476,"KADU JAYA, CURUG, TANGERANG, BANTEN",27,42,122,164
https://kawalpemilu.org#52476,"KADU JAYA, CURUG, TANGERANG, BANTEN",28,46,121,167
https://kawalpemilu.org#52476,"KADU JAYA, CURUG, TANGERANG, BANTEN",29,41,114,155
https://kawalpemilu.org#52476,"KADU JAYA, CURUG, TANGERANG, BANTEN",30,50,106,156
https://kawalpemilu.org#52476,"KADU JAYA, CURUG, TANGERANG, BANTEN",31,60,115,175
https://kawalpemilu.org#52476,"KADU JAYA, CURUG, TANGERANG, BANTEN",32,62,109,171
https://kawalpemilu.org#52476,"KADU JAYA, CURUG, TANGERANG, BANTEN",33,49,99,148
https://kawalpemilu.org#52476,"KADU JAYA, CURUG, TANGERANG, BANTEN",34,60,111,171
https://kawalpemilu.org#52476,"KADU JAYA, CURUG, TANGERANG, BANTEN",35,40,124,164
https://kawalpemilu.org#52476,"KADU JAYA, CURUG, TANGERANG, BANTEN",36,65,103,168
https://kawalpemilu.org#52476,"KADU JAYA, CURUG, TANGERANG, BANTEN",37,49,111,160
https://kawalpemilu.org#52476,"KADU JAYA, CURUG, TANGERANG, BANTEN",38,71,118,189
https://kawalpemilu.org#52476,"KADU JAYA, CURUG, TANGERANG, BANTEN",39,52,86,138
https://kawalpemilu.org#52476,"KADU JAYA, CURUG, TANGERANG, BANTEN",40,52,107,159
https://kawalpemilu.org#52476,"KADU JAYA, CURUG, TANGERANG, BANTEN",41,63,69,132
https://kawalpemilu.org#52476,"KADU JAYA, CURUG, TANGERANG, BANTEN",42,68,67,135
https://kawalpemilu.org#52476,"KADU JAYA, CURUG, TANGERANG, BANTEN",43,64,99,163
https://kawalpemilu.org#52476,"KADU JAYA, CURUG, TANGERANG, BANTEN",44,62,118,180
https://kawalpemilu.org#52476,"KADU JAYA, CURUG, TANGERANG, BANTEN",45,113,130,243
https://kawalpemilu.org#52476,"KADU JAYA, CURUG, TANGERANG, BANTEN",47,53,147,200
https://kawalpemilu.org#52476,"KADU JAYA, CURUG, TANGERANG, BANTEN",48,91,195,286
https://kawalpemilu.org#52476,"KADU JAYA, CURUG, TANGERANG, BANTEN",49,77,119,196
https://kawalpemilu.org#52476,"KADU JAYA, CURUG, TANGERANG, BANTEN",50,82,113,195
https://kawalpemilu.org#52476,"KADU JAYA, CURUG, TANGERANG, BANTEN",51,81,141,222
https://kawalpemilu.org#52477,"CUKANGGALIH, CURUG, TANGERANG, BANTEN",1,74,107,181
https://kawalpemilu.org#52477,"CUKANGGALIH, CURUG, TANGERANG, BANTEN",2,77,123,200
https://kawalpemilu.org#52477,"CUKANGGALIH, CURUG, TANGERANG, BANTEN",3,60,110,170
https://kawalpemilu.org#52477,"CUKANGGALIH, CURUG, TANGERANG, BANTEN",4,78,113,191
https://kawalpemilu.org#52477,"CUKANGGALIH, CURUG, TANGERANG, BANTEN",5,71,171,188
https://kawalpemilu.org#52477,"CUKANGGALIH, CURUG, TANGERANG, BANTEN",7,64,161,225
https://kawalpemilu.org#52477,"CUKANGGALIH, CURUG, TANGERANG, BANTEN",8,44,122,166
https://kawalpemilu.org#52477,"CUKANGGALIH, CURUG, TANGERANG, BANTEN",9,47,134,181
https://kawalpemilu.org#52477,"CUKANGGALIH, CURUG, TANGERANG, BANTEN",10,49,63,112
https://kawalpemilu.org#52477,"CUKANGGALIH, CURUG, TANGERANG, BANTEN",11,73,112,185
https://kawalpemilu.org#52477,"CUKANGGALIH, CURUG, TANGERANG, BANTEN",12,52,71,123
https://kawalpemilu.org#52477,"CUKANGGALIH, CURUG, TANGERANG, BANTEN",13,77,76,153
https://kawalpemilu.org#52477,"CUKANGGALIH, CURUG, TANGERANG, BANTEN",15,90,85,175
https://kawalpemilu.org#52477,"CUKANGGALIH, CURUG, TANGERANG, BANTEN",16,103,80,183
https://kawalpemilu.org#52477,"CUKANGGALIH, CURUG, TANGERANG, BANTEN",18,53,99,152
https://kawalpemilu.org#52477,"CUKANGGALIH, CURUG, TANGERANG, BANTEN",19,87,106,193
https://kawalpemilu.org#52477,"CUKANGGALIH, CURUG, TANGERANG, BANTEN",20,29,109,138
https://kawalpemilu.org#52477,"CUKANGGALIH, CURUG, TANGERANG, BANTEN",22,43,129,172
https://kawalpemilu.org#52477,"CUKANGGALIH, CURUG, TANGERANG, BANTEN",23,62,129,191
https://kawalpemilu.org#52477,"CUKANGGALIH, CURUG, TANGERANG, BANTEN",24,92,116,208
https://kawalpemilu.org#52477,"CUKANGGALIH, CURUG, TANGERANG, BANTEN",25,62,127,189
https://kawalpemilu.org#52477,"CUKANGGALIH, CURUG, TANGERANG, BANTEN",26,52,141,193
https://kawalpemilu.org#52477,"CUKANGGALIH, CURUG, TANGERANG, BANTEN",27,35,124,159
https://kawalpemilu.org#52477,"CUKANGGALIH, CURUG, TANGERANG, BANTEN",28,37,109,146
https://kawalpemilu.org#52477,"CUKANGGALIH, CURUG, TANGERANG, BANTEN",29,53,97,150
https://kawalpemilu.org#52477,"CUKANGGALIH, CURUG, TANGERANG, BANTEN",31,64,137,201
https://kawalpemilu.org#52477,"CUKANGGALIH, CURUG, TANGERANG, BANTEN",32,48,114,162
https://kawalpemilu.org#52477,"CUKANGGALIH, CURUG, TANGERANG, BANTEN",33,42,126,168
https://kawalpemilu.org#52477,"CUKANGGALIH, CURUG, TANGERANG, BANTEN",34,59,129,188
https://kawalpemilu.org#52477,"CUKANGGALIH, CURUG, TANGERANG, BANTEN",35,55,96,151
https://kawalpemilu.org#52477,"CUKANGGALIH, CURUG, TANGERANG, BANTEN",36,46,147,193
https://kawalpemilu.org#52477,"CUKANGGALIH, CURUG, TANGERANG, BANTEN",37,53,129,182
https://kawalpemilu.org#52477,"CUKANGGALIH, CURUG, TANGERANG, BANTEN",38,36,97,133
https://kawalpemilu.org#52477,"CUKANGGALIH, CURUG, TANGERANG, BANTEN",39,64,118,182
https://kawalpemilu.org#52477,"CUKANGGALIH, CURUG, TANGERANG, BANTEN",40,114,81,195
https://kawalpemilu.org#52477,"CUKANGGALIH, CURUG, TANGERANG, BANTEN",41,58,74,132
https://kawalpemilu.org#52477,"CUKANGGALIH, CURUG, TANGERANG, BANTEN",42,75,96,171
https://kawalpemilu.org#52477,"CUKANGGALIH, CURUG, TANGERANG, BANTEN",43,66,90,156
https://kawalpemilu.org#52477,"CUKANGGALIH, CURUG, TANGERANG, BANTEN",44,103,110,213
https://kawalpemilu.org#52477,"CUKANGGALIH, CURUG, TANGERANG, BANTEN",45,66,77,143
https://kawalpemilu.org#52479,"SUKAMULYA, CIKUPA, TANGERANG, BANTEN",2,60,224,284
https://kawalpemilu.org#52479,"SUKAMULYA, CIKUPA, TANGERANG, BANTEN",3,64,207,230
https://kawalpemilu.org#52479,"SUKAMULYA, CIKUPA, TANGERANG, BANTEN",4,50,151,201
https://kawalpemilu.org#52479,"SUKAMULYA, CIKUPA, TANGERANG, BANTEN",6,45,150,195
https://kawalpemilu.org#52479,"SUKAMULYA, CIKUPA, TANGERANG, BANTEN",8,106,147,253
https://kawalpemilu.org#52479,"SUKAMULYA, CIKUPA, TANGERANG, BANTEN",10,69,130,199
https://kawalpemilu.org#52479,"SUKAMULYA, CIKUPA, TANGERANG, BANTEN",12,35,125,160
https://kawalpemilu.org#52479,"SUKAMULYA, CIKUPA, TANGERANG, BANTEN",13,53,105,158
https://kawalpemilu.org#52479,"SUKAMULYA, CIKUPA, TANGERANG, BANTEN",14,54,120,174
https://kawalpemilu.org#52479,"SUKAMULYA, CIKUPA, TANGERANG, BANTEN",17,134,100,234
https://kawalpemilu.org#52479,"SUKAMULYA, CIKUPA, TANGERANG, BANTEN",18,127,143,270
https://kawalpemilu.org#52479,"SUKAMULYA, CIKUPA, TANGERANG, BANTEN",20,80,160,240
https://kawalpemilu.org#52479,"SUKAMULYA, CIKUPA, TANGERANG, BANTEN",22,59,165,224
https://kawalpemilu.org#52479,"SUKAMULYA, CIKUPA, TANGERANG, BANTEN",23,65,139,204
https://kawalpemilu.org#52479,"SUKAMULYA, CIKUPA, TANGERANG, BANTEN",24,77,139,216
https://kawalpemilu.org#52479,"SUKAMULYA, CIKUPA, TANGERANG, BANTEN",28,71,164,235
https://kawalpemilu.org#52479,"SUKAMULYA, CIKUPA, TANGERANG, BANTEN",31,64,108,172
https://kawalpemilu.org#52479,"SUKAMULYA, CIKUPA, TANGERANG, BANTEN",32,53,179,232
https://kawalpemilu.org#52479,"SUKAMULYA, CIKUPA, TANGERANG, BANTEN",33,43,139,182
https://kawalpemilu.org#52479,"SUKAMULYA, CIKUPA, TANGERANG, BANTEN",38,80,192,272
https://kawalpemilu.org#52479,"SUKAMULYA, CIKUPA, TANGERANG, BANTEN",43,27,110,137
https://kawalpemilu.org#52479,"SUKAMULYA, CIKUPA, TANGERANG, BANTEN",44,37,126,163
https://kawalpemilu.org#52479,"SUKAMULYA, CIKUPA, TANGERANG, BANTEN",46,76,143,219
https://kawalpemilu.org#52479,"SUKAMULYA, CIKUPA, TANGERANG, BANTEN",48,112,128,240
https://kawalpemilu.org#52479,"SUKAMULYA, CIKUPA, TANGERANG, BANTEN",49,95,124,219
https://kawalpemilu.org#52479,"SUKAMULYA, CIKUPA, TANGERANG, BANTEN",50,91,119,210
https://kawalpemilu.org#52479,"SUKAMULYA, CIKUPA, TANGERANG, BANTEN",54,70,128,198
https://kawalpemilu.org#52479,"SUKAMULYA, CIKUPA, TANGERANG, BANTEN",60,36,83,119
https://kawalpemilu.org#52480,"BUNDER, CIKUPA, TANGERANG, BANTEN",1,121,160,281
https://kawalpemilu.org#52480,"BUNDER, CIKUPA, TANGERANG, BANTEN",2,83,135,218
https://kawalpemilu.org#52480,"BUNDER, CIKUPA, TANGERANG, BANTEN",3,67,148,215
https://kawalpemilu.org#52480,"BUNDER, CIKUPA, TANGERANG, BANTEN",4,40,137,177
https://kawalpemilu.org#52480,"BUNDER, CIKUPA, TANGERANG, BANTEN",5,65,125,190
https://kawalpemilu.org#52480,"BUNDER, CIKUPA, TANGERANG, BANTEN",6,49,118,167
https://kawalpemilu.org#52480,"BUNDER, CIKUPA, TANGERANG, BANTEN",7,41,162,203
https://kawalpemilu.org#52480,"BUNDER, CIKUPA, TANGERANG, BANTEN",8,30,73,112
https://kawalpemilu.org#52480,"BUNDER, CIKUPA, TANGERANG, BANTEN",9,63,150,213
https://kawalpemilu.org#52480,"BUNDER, CIKUPA, TANGERANG, BANTEN",10,79,171,250
https://kawalpemilu.org#52480,"BUNDER, CIKUPA, TANGERANG, BANTEN",11,64,195,259
https://kawalpemilu.org#52480,"BUNDER, CIKUPA, TANGERANG, BANTEN",14,79,136,215
https://kawalpemilu.org#52480,"BUNDER, CIKUPA, TANGERANG, BANTEN",15,52,107,159
https://kawalpemilu.org#52480,"BUNDER, CIKUPA, TANGERANG, BANTEN",16,35,120,155
https://kawalpemilu.org#52480,"BUNDER, CIKUPA, TANGERANG, BANTEN",17,22,80,102
https://kawalpemilu.org#52480,"BUNDER, CIKUPA, TANGERANG, BANTEN",19,90,145,235
https://kawalpemilu.org#52480,"BUNDER, CIKUPA, TANGERANG, BANTEN",20,84,121,205
https://kawalpemilu.org#52480,"BUNDER, CIKUPA, TANGERANG, BANTEN",21,64,115,179
https://kawalpemilu.org#52480,"BUNDER, CIKUPA, TANGERANG, BANTEN",22,80,162,242
https://kawalpemilu.org#52480,"BUNDER, CIKUPA, TANGERANG, BANTEN",23,73,135,208
https://kawalpemilu.org#52480,"BUNDER, CIKUPA, TANGERANG, BANTEN",25,59,131,190
https://kawalpemilu.org#52480,"BUNDER, CIKUPA, TANGERANG, BANTEN",27,45,111,156
https://kawalpemilu.org#52480,"BUNDER, CIKUPA, TANGERANG, BANTEN",28,52,136,188
https://kawalpemilu.org#52480,"BUNDER, CIKUPA, TANGERANG, BANTEN",29,66,105,171
https://kawalpemilu.org#52480,"BUNDER, CIKUPA, TANGERANG, BANTEN",30,45,112,157
https://kawalpemilu.org#52480,"BUNDER, CIKUPA, TANGERANG, BANTEN",31,38,127,165
https://kawalpemilu.org#52480,"BUNDER, CIKUPA, TANGERANG, BANTEN",32,37,115,152
https://kawalpemilu.org#52480,"BUNDER, CIKUPA, TANGERANG, BANTEN",33,30,122,152
https://kawalpemilu.org#52481,"CIBADAK, CIKUPA, TANGERANG, BANTEN",1,49,195,244
https://kawalpemilu.org#52481,"CIBADAK, CIKUPA, TANGERANG, BANTEN",2,51,190,241
https://kawalpemilu.org#52481,"CIBADAK, CIKUPA, TANGERANG, BANTEN",3,54,146,200
https://kawalpemilu.org#52481,"CIBADAK, CIKUPA, TANGERANG, BANTEN",4,91,174,265
https://kawalpemilu.org#52481,"CIBADAK, CIKUPA, TANGERANG, BANTEN",5,59,149,208
https://kawalpemilu.org#52481,"CIBADAK, CIKUPA, TANGERANG, BANTEN",6,32,191,223
https://kawalpemilu.org#52481,"CIBADAK, CIKUPA, TANGERANG, BANTEN",8,62,148,210
https://kawalpemilu.org#52481,"CIBADAK, CIKUPA, TANGERANG, BANTEN",9,38,182,220
https://kawalpemilu.org#52481,"CIBADAK, CIKUPA, TANGERANG, BANTEN",10,79,140,219
https://kawalpemilu.org#52481,"CIBADAK, CIKUPA, TANGERANG, BANTEN",11,108,151,259
https://kawalpemilu.org#52481,"CIBADAK, CIKUPA, TANGERANG, BANTEN",12,46,130,176
https://kawalpemilu.org#52481,"CIBADAK, CIKUPA, TANGERANG, BANTEN",13,58,112,170
https://kawalpemilu.org#52481,"CIBADAK, CIKUPA, TANGERANG, BANTEN",14,90,118,208
https://kawalpemilu.org#52481,"CIBADAK, CIKUPA, TANGERANG, BANTEN",15,92,166,258
https://kawalpemilu.org#52481,"CIBADAK, CIKUPA, TANGERANG, BANTEN",16,54,144,198
https://kawalpemilu.org#52481,"CIBADAK, CIKUPA, TANGERANG, BANTEN",17,39,117,156
https://kawalpemilu.org#52481,"CIBADAK, CIKUPA, TANGERANG, BANTEN",18,54,147,201
https://kawalpemilu.org#52481,"CIBADAK, CIKUPA, TANGERANG, BANTEN",19,69,152,221
https://kawalpemilu.org#52481,"CIBADAK, CIKUPA, TANGERANG, BANTEN",20,60,157,217
https://kawalpemilu.org#52481,"CIBADAK, CIKUPA, TANGERANG, BANTEN",21,56,149,205
https://kawalpemilu.org#52481,"CIBADAK, CIKUPA, TANGERANG, BANTEN",22,52,171,223
https://kawalpemilu.org#52481,"CIBADAK, CIKUPA, TANGERANG, BANTEN",23,45,194,239
https://kawalpemilu.org#52481,"CIBADAK, CIKUPA, TANGERANG, BANTEN",24,52,172,224
https://kawalpemilu.org#52481,"CIBADAK, CIKUPA, TANGERANG, BANTEN",25,55,166,221
https://kawalpemilu.org#52481,"CIBADAK, CIKUPA, TANGERANG, BANTEN",26,48,56,104
https://kawalpemilu.org#52481,"CIBADAK, CIKUPA, TANGERANG, BANTEN",27,25,61,86
https://kawalpemilu.org#52481,"CIBADAK, CIKUPA, TANGERANG, BANTEN",28,42,69,111
https://kawalpemilu.org#52481,"CIBADAK, CIKUPA, TANGERANG, BANTEN",30,31,57,88
https://kawalpemilu.org#52481,"CIBADAK, CIKUPA, TANGERANG, BANTEN",31,36,54,90
https://kawalpemilu.org#52482,"TALAGA, CIKUPA, TANGERANG, BANTEN",4,67,173,240
https://kawalpemilu.org#52482,"TALAGA, CIKUPA, TANGERANG, BANTEN",5,66,149,215
https://kawalpemilu.org#52482,"TALAGA, CIKUPA, TANGERANG, BANTEN",6,52,177,229
https://kawalpemilu.org#52482,"TALAGA, CIKUPA, TANGERANG, BANTEN",7,55,137,192
https://kawalpemilu.org#52482,"TALAGA, CIKUPA, TANGERANG, BANTEN",8,85,134,219
https://kawalpemilu.org#52482,"TALAGA, CIKUPA, TANGERANG, BANTEN",9,70,176,246
https://kawalpemilu.org#52482,"TALAGA, CIKUPA, TANGERANG, BANTEN",10,102,113,215
https://kawalpemilu.org#52482,"TALAGA, CIKUPA, TANGERANG, BANTEN",11,36,127,163
https://kawalpemilu.org#52482,"TALAGA, CIKUPA, TANGERANG, BANTEN",12,44,202,246
https://kawalpemilu.org#52482,"TALAGA, CIKUPA, TANGERANG, BANTEN",13,49,158,207
https://kawalpemilu.org#52482,"TALAGA, CIKUPA, TANGERANG, BANTEN",14,49,165,214
https://kawalpemilu.org#52482,"TALAGA, CIKUPA, TANGERANG, BANTEN",15,59,148,207
https://kawalpemilu.org#52482,"TALAGA, CIKUPA, TANGERANG, BANTEN",16,68,153,221
https://kawalpemilu.org#52482,"TALAGA, CIKUPA, TANGERANG, BANTEN",17,72,169,241
https://kawalpemilu.org#52482,"TALAGA, CIKUPA, TANGERANG, BANTEN",19,51,176,227
https://kawalpemilu.org#52482,"TALAGA, CIKUPA, TANGERANG, BANTEN",20,61,117,178
https://kawalpemilu.org#52482,"TALAGA, CIKUPA, TANGERANG, BANTEN",21,65,175,240
https://kawalpemilu.org#52482,"TALAGA, CIKUPA, TANGERANG, BANTEN",22,53,196,249
https://kawalpemilu.org#52482,"TALAGA, CIKUPA, TANGERANG, BANTEN",23,61,148,209
https://kawalpemilu.org#52482,"TALAGA, CIKUPA, TANGERANG, BANTEN",24,56,92,148
https://kawalpemilu.org#52482,"TALAGA, CIKUPA, TANGERANG, BANTEN",25,19,94,113
https://kawalpemilu.org#52482,"TALAGA, CIKUPA, TANGERANG, BANTEN",26,71,180,251
https://kawalpemilu.org#52482,"TALAGA, CIKUPA, TANGERANG, BANTEN",27,73,161,234
https://kawalpemilu.org#52482,"TALAGA, CIKUPA, TANGERANG, BANTEN",28,43,223,266
https://kawalpemilu.org#52482,"TALAGA, CIKUPA, TANGERANG, BANTEN",29,73,173,246
https://kawalpemilu.org#52482,"TALAGA, CIKUPA, TANGERANG, BANTEN",30,33,133,146
https://kawalpemilu.org#52482,"TALAGA, CIKUPA, TANGERANG, BANTEN",31,63,153,218
https://kawalpemilu.org#52482,"TALAGA, CIKUPA, TANGERANG, BANTEN",32,49,186,235
https://kawalpemilu.org#52482,"TALAGA, CIKUPA, TANGERANG, BANTEN",33,51,184,235
https://kawalpemilu.org#52482,"TALAGA, CIKUPA, TANGERANG, BANTEN",34,48,183,231
https://kawalpemilu.org#52482,"TALAGA, CIKUPA, TANGERANG, BANTEN",35,55,193,248
https://kawalpemilu.org#52482,"TALAGA, CIKUPA, TANGERANG, BANTEN",36,66,117,183
https://kawalpemilu.org#52482,"TALAGA, CIKUPA, TANGERANG, BANTEN",37,42,70,112
https://kawalpemilu.org#52482,"TALAGA, CIKUPA, TANGERANG, BANTEN",38,36,141,177
https://kawalpemilu.org#52482,"TALAGA, CIKUPA, TANGERANG, BANTEN",39,38,54,92
https://kawalpemilu.org#52482,"TALAGA, CIKUPA, TANGERANG, BANTEN",40,38,84,122
https://kawalpemilu.org#52483,"TALAGASARI, CIKUPA, TANGERANG, BANTEN",1,70,163,233
https://kawalpemilu.org#52483,"TALAGASARI, CIKUPA, TANGERANG, BANTEN",4,40,149,189
https://kawalpemilu.org#52483,"TALAGASARI, CIKUPA, TANGERANG, BANTEN",5,45,136,181
https://kawalpemilu.org#52483,"TALAGASARI, CIKUPA, TANGERANG, BANTEN",6,56,169,225
https://kawalpemilu.org#52483,"TALAGASARI, CIKUPA, TANGERANG, BANTEN",7,68,163,231
https://kawalpemilu.org#52483,"TALAGASARI, CIKUPA, TANGERANG, BANTEN",8,48,169,217
https://kawalpemilu.org#52483,"TALAGASARI, CIKUPA, TANGERANG, BANTEN",9,63,169,232
https://kawalpemilu.org#52483,"TALAGASARI, CIKUPA, TANGERANG, BANTEN",10,58,111,169
https://kawalpemilu.org#52483,"TALAGASARI, CIKUPA, TANGERANG, BANTEN",11,58,117,175
https://kawalpemilu.org#52483,"TALAGASARI, CIKUPA, TANGERANG, BANTEN",12,49,162,211
https://kawalpemilu.org#52483,"TALAGASARI, CIKUPA, TANGERANG, BANTEN",13,44,94,138
https://kawalpemilu.org#52483,"TALAGASARI, CIKUPA, TANGERANG, BANTEN",14,46,141,187
https://kawalpemilu.org#52483,"TALAGASARI, CIKUPA, TANGERANG, BANTEN",15,35,227,262
https://kawalpemilu.org#52483,"TALAGASARI, CIKUPA, TANGERANG, BANTEN",16,58,129,187
https://kawalpemilu.org#52483,"TALAGASARI, CIKUPA, TANGERANG, BANTEN",17,57,137,194
https://kawalpemilu.org#52483,"TALAGASARI, CIKUPA, TANGERANG, BANTEN",18,111,86,197
https://kawalpemilu.org#52483,"TALAGASARI, CIKUPA, TANGERANG, BANTEN",19,62,156,218
https://kawalpemilu.org#52483,"TALAGASARI, CIKUPA, TANGERANG, BANTEN",20,57,228,285
https://kawalpemilu.org#52483,"TALAGASARI, CIKUPA, TANGERANG, BANTEN",21,50,161,211
https://kawalpemilu.org#52483,"TALAGASARI, CIKUPA, TANGERANG, BANTEN",23,78,146,224
https://kawalpemilu.org#52483,"TALAGASARI, CIKUPA, TANGERANG, BANTEN",24,67,100,167
https://kawalpemilu.org#52483,"TALAGASARI, CIKUPA, TANGERANG, BANTEN",26,36,147,183
https://kawalpemilu.org#52483,"TALAGASARI, CIKUPA, TANGERANG, BANTEN",27,51,161,212
https://kawalpemilu.org#52483,"TALAGASARI, CIKUPA, TANGERANG, BANTEN",28,50,150,200
https://kawalpemilu.org#52483,"TALAGASARI, CIKUPA, TANGERANG, BANTEN",29,68,197,265
https://kawalpemilu.org#52483,"TALAGASARI, CIKUPA, TANGERANG, BANTEN",30,44,167,211
https://kawalpemilu.org#52483,"TALAGASARI, CIKUPA, TANGERANG, BANTEN",31,40,174,214
https://kawalpemilu.org#52483,"TALAGASARI, CIKUPA, TANGERANG, BANTEN",32,60,128,188
https://kawalpemilu.org#52483,"TALAGASARI, CIKUPA, TANGERANG, BANTEN",33,58,134,6
https://kawalpemilu.org#52483,"TALAGASARI, CIKUPA, TANGERANG, BANTEN",34,59,180,239
https://kawalpemilu.org#52483,"TALAGASARI, CIKUPA, TANGERANG, BANTEN",35,52,81,133
https://kawalpemilu.org#52483,"TALAGASARI, CIKUPA, TANGERANG, BANTEN",36,41,140,181
https://kawalpemilu.org#52483,"TALAGASARI, CIKUPA, TANGERANG, BANTEN",37,66,83,149
https://kawalpemilu.org#52483,"TALAGASARI, CIKUPA, TANGERANG, BANTEN",38,38,129,167
https://kawalpemilu.org#52483,"TALAGASARI, CIKUPA, TANGERANG, BANTEN",39,69,156,225
https://kawalpemilu.org#52483,"TALAGASARI, CIKUPA, TANGERANG, BANTEN",40,39,156,195
https://kawalpemilu.org#52483,"TALAGASARI, CIKUPA, TANGERANG, BANTEN",41,37,153,190
https://kawalpemilu.org#52483,"TALAGASARI, CIKUPA, TANGERANG, BANTEN",42,57,139,196
https://kawalpemilu.org#52483,"TALAGASARI, CIKUPA, TANGERANG, BANTEN",43,40,76,116
https://kawalpemilu.org#52483,"TALAGASARI, CIKUPA, TANGERANG, BANTEN",44,42,109,151
https://kawalpemilu.org#52484,"DUKUH, CIKUPA, TANGERANG, BANTEN",1,52,117,169
https://kawalpemilu.org#52484,"DUKUH, CIKUPA, TANGERANG, BANTEN",2,48,124,172
https://kawalpemilu.org#52484,"DUKUH, CIKUPA, TANGERANG, BANTEN",3,60,147,207
https://kawalpemilu.org#52484,"DUKUH, CIKUPA, TANGERANG, BANTEN",4,53,172,225
https://kawalpemilu.org#52484,"DUKUH, CIKUPA, TANGERANG, BANTEN",5,36,166,202
https://kawalpemilu.org#52484,"DUKUH, CIKUPA, TANGERANG, BANTEN",6,72,138,210
https://kawalpemilu.org#52484,"DUKUH, CIKUPA, TANGERANG, BANTEN",7,54,109,163
https://kawalpemilu.org#52484,"DUKUH, CIKUPA, TANGERANG, BANTEN",8,69,110,179
https://kawalpemilu.org#52484,"DUKUH, CIKUPA, TANGERANG, BANTEN",9,70,196,266
https://kawalpemilu.org#52484,"DUKUH, CIKUPA, TANGERANG, BANTEN",10,68,145,213
https://kawalpemilu.org#52484,"DUKUH, CIKUPA, TANGERANG, BANTEN",11,50,106,156
https://kawalpemilu.org#52484,"DUKUH, CIKUPA, TANGERANG, BANTEN",12,39,147,186
https://kawalpemilu.org#52484,"DUKUH, CIKUPA, TANGERANG, BANTEN",13,58,141,199
https://kawalpemilu.org#52484,"DUKUH, CIKUPA, TANGERANG, BANTEN",14,67,172,239
https://kawalpemilu.org#52484,"DUKUH, CIKUPA, TANGERANG, BANTEN",15,79,152,231
https://kawalpemilu.org#52484,"DUKUH, CIKUPA, TANGERANG, BANTEN",16,58,151,209
https://kawalpemilu.org#52484,"DUKUH, CIKUPA, TANGERANG, BANTEN",17,52,150,202
https://kawalpemilu.org#52484,"DUKUH, CIKUPA, TANGERANG, BANTEN",18,188,36,224
https://kawalpemilu.org#52484,"DUKUH, CIKUPA, TANGERANG, BANTEN",19,185,72,257
https://kawalpemilu.org#52484,"DUKUH, CIKUPA, TANGERANG, BANTEN",20,110,165,275
https://kawalpemilu.org#52484,"DUKUH, CIKUPA, TANGERANG, BANTEN",21,40,129,169
https://kawalpemilu.org#52484,"DUKUH, CIKUPA, TANGERANG, BANTEN",22,33,142,175
https://kawalpemilu.org#52484,"DUKUH, CIKUPA, TANGERANG, BANTEN",23,63,155,218
https://kawalpemilu.org#52484,"DUKUH, CIKUPA, TANGERANG, BANTEN",24,33,210,243
https://kawalpemilu.org#52484,"DUKUH, CIKUPA, TANGERANG, BANTEN",25,38,153,191
https://kawalpemilu.org#52484,"DUKUH, CIKUPA, TANGERANG, BANTEN",26,56,123,179
https://kawalpemilu.org#52484,"DUKUH, CIKUPA, TANGERANG, BANTEN",27,68,115,183
https://kawalpemilu.org#52484,"DUKUH, CIKUPA, TANGERANG, BANTEN",28,64,202,266
https://kawalpemilu.org#52484,"DUKUH, CIKUPA, TANGERANG, BANTEN",29,55,129,121
https://kawalpemilu.org#52484,"DUKUH, CIKUPA, TANGERANG, BANTEN",30,61,138,199
https://kawalpemilu.org#52484,"DUKUH, CIKUPA, TANGERANG, BANTEN",31,40,96,136
https://kawalpemilu.org#52484,"DUKUH, CIKUPA, TANGERANG, BANTEN",33,61,142,203
https://kawalpemilu.org#52484,"DUKUH, CIKUPA, TANGERANG, BANTEN",34,41,169,210
https://kawalpemilu.org#52484,"DUKUH, CIKUPA, TANGERANG, BANTEN",35,71,142,213
https://kawalpemilu.org#52484,"DUKUH, CIKUPA, TANGERANG, BANTEN",36,88,170,258
https://kawalpemilu.org#52484,"DUKUH, CIKUPA, TANGERANG, BANTEN",37,61,147,208
https://kawalpemilu.org#52484,"DUKUH, CIKUPA, TANGERANG, BANTEN",38,73,127,200
https://kawalpemilu.org#52484,"DUKUH, CIKUPA, TANGERANG, BANTEN",39,187,58,245
https://kawalpemilu.org#52485,"CIKUPA, CIKUPA, TANGERANG, BANTEN",1,114,114,228
https://kawalpemilu.org#52485,"CIKUPA, CIKUPA, TANGERANG, BANTEN",3,68,119,187
https://kawalpemilu.org#52485,"CIKUPA, CIKUPA, TANGERANG, BANTEN",4,100,100,200
https://kawalpemilu.org#52485,"CIKUPA, CIKUPA, TANGERANG, BANTEN",6,76,178,254
https://kawalpemilu.org#52485,"CIKUPA, CIKUPA, TANGERANG, BANTEN",8,109,160,269
https://kawalpemilu.org#52485,"CIKUPA, CIKUPA, TANGERANG, BANTEN",9,154,86,240
https://kawalpemilu.org#52485,"CIKUPA, CIKUPA, TANGERANG, BANTEN",10,216,31,247
https://kawalpemilu.org#52485,"CIKUPA, CIKUPA, TANGERANG, BANTEN",11,106,55,161
https://kawalpemilu.org#52485,"CIKUPA, CIKUPA, TANGERANG, BANTEN",12,124,28,152
https://kawalpemilu.org#52485,"CIKUPA, CIKUPA, TANGERANG, BANTEN",13,149,67,216
https://kawalpemilu.org#52485,"CIKUPA, CIKUPA, TANGERANG, BANTEN",14,136,92,228
https://kawalpemilu.org#52485,"CIKUPA, CIKUPA, TANGERANG, BANTEN",15,74,41,115
https://kawalpemilu.org#52485,"CIKUPA, CIKUPA, TANGERANG, BANTEN",16,31,123,154
https://kawalpemilu.org#52485,"CIKUPA, CIKUPA, TANGERANG, BANTEN",17,68,192,260
https://kawalpemilu.org#52485,"CIKUPA, CIKUPA, TANGERANG, BANTEN",18,78,180,258
https://kawalpemilu.org#52485,"CIKUPA, CIKUPA, TANGERANG, BANTEN",19,35,152,187
https://kawalpemilu.org#52485,"CIKUPA, CIKUPA, TANGERANG, BANTEN",20,76,175,251
https://kawalpemilu.org#52485,"CIKUPA, CIKUPA, TANGERANG, BANTEN",21,155,78,233
https://kawalpemilu.org#52485,"CIKUPA, CIKUPA, TANGERANG, BANTEN",22,163,89,252
https://kawalpemilu.org#52485,"CIKUPA, CIKUPA, TANGERANG, BANTEN",23,215,64,279
https://kawalpemilu.org#52485,"CIKUPA, CIKUPA, TANGERANG, BANTEN",24,210,40,250
https://kawalpemilu.org#52485,"CIKUPA, CIKUPA, TANGERANG, BANTEN",25,202,50,252
https://kawalpemilu.org#52485,"CIKUPA, CIKUPA, TANGERANG, BANTEN",26,65,109,174
https://kawalpemilu.org#52485,"CIKUPA, CIKUPA, TANGERANG, BANTEN",27,82,88,170
https://kawalpemilu.org#52485,"CIKUPA, CIKUPA, TANGERANG, BANTEN",28,77,103,180
https://kawalpemilu.org#52485,"CIKUPA, CIKUPA, TANGERANG, BANTEN",29,54,81,135
https://kawalpemilu.org#52485,"CIKUPA, CIKUPA, TANGERANG, BANTEN",30,98,140,238
https://kawalpemilu.org#52485,"CIKUPA, CIKUPA, TANGERANG, BANTEN",31,154,85,239
https://kawalpemilu.org#52485,"CIKUPA, CIKUPA, TANGERANG, BANTEN",32,140,63,203
https://kawalpemilu.org#52485,"CIKUPA, CIKUPA, TANGERANG, BANTEN",33,148,50,198
https://kawalpemilu.org#52485,"CIKUPA, CIKUPA, TANGERANG, BANTEN",34,88,35,123
https://kawalpemilu.org#52485,"CIKUPA, CIKUPA, TANGERANG, BANTEN",35,28,124,152
https://kawalpemilu.org#52485,"CIKUPA, CIKUPA, TANGERANG, BANTEN",36,34,119,153
https://kawalpemilu.org#52485,"CIKUPA, CIKUPA, TANGERANG, BANTEN",37,86,134,220
https://kawalpemilu.org#52485,"CIKUPA, CIKUPA, TANGERANG, BANTEN",38,48,159,207
https://kawalpemilu.org#52485,"CIKUPA, CIKUPA, TANGERANG, BANTEN",39,62,147,209
https://kawalpemilu.org#52485,"CIKUPA, CIKUPA, TANGERANG, BANTEN",40,132,78,210
https://kawalpemilu.org#52485,"CIKUPA, CIKUPA, TANGERANG, BANTEN",41,93,74,167
https://kawalpemilu.org#52485,"CIKUPA, CIKUPA, TANGERANG, BANTEN",42,156,27,183
https://kawalpemilu.org#52486,"SUKANAGARA, CIKUPA, TANGERANG, BANTEN",1,11,97,108
https://kawalpemilu.org#52486,"SUKANAGARA, CIKUPA, TANGERANG, BANTEN",2,78,140,218
https://kawalpemilu.org#52486,"SUKANAGARA, CIKUPA, TANGERANG, BANTEN",3,66,134,200
https://kawalpemilu.org#52486,"SUKANAGARA, CIKUPA, TANGERANG, BANTEN",4,72,193,265
https://kawalpemilu.org#52486,"SUKANAGARA, CIKUPA, TANGERANG, BANTEN",5,39,108,147
https://kawalpemilu.org#52486,"SUKANAGARA, CIKUPA, TANGERANG, BANTEN",6,19,134,153
https://kawalpemilu.org#52486,"SUKANAGARA, CIKUPA, TANGERANG, BANTEN",7,55,157,212
https://kawalpemilu.org#52486,"SUKANAGARA, CIKUPA, TANGERANG, BANTEN",8,50,174,224
https://kawalpemilu.org#52486,"SUKANAGARA, CIKUPA, TANGERANG, BANTEN",9,59,130,189
https://kawalpemilu.org#52486,"SUKANAGARA, CIKUPA, TANGERANG, BANTEN",10,31,173,204
https://kawalpemilu.org#52486,"SUKANAGARA, CIKUPA, TANGERANG, BANTEN",11,40,197,237
https://kawalpemilu.org#52486,"SUKANAGARA, CIKUPA, TANGERANG, BANTEN",14,57,122,179
https://kawalpemilu.org#52486,"SUKANAGARA, CIKUPA, TANGERANG, BANTEN",16,68,127,195
https://kawalpemilu.org#52486,"SUKANAGARA, CIKUPA, TANGERANG, BANTEN",18,58,174,232
https://kawalpemilu.org#52486,"SUKANAGARA, CIKUPA, TANGERANG, BANTEN",19,50,100,150
https://kawalpemilu.org#52486,"SUKANAGARA, CIKUPA, TANGERANG, BANTEN",20,20,116,136
https://kawalpemilu.org#52486,"SUKANAGARA, CIKUPA, TANGERANG, BANTEN",21,50,126,176
https://kawalpemilu.org#52486,"SUKANAGARA, CIKUPA, TANGERANG, BANTEN",22,46,176,222
https://kawalpemilu.org#52486,"SUKANAGARA, CIKUPA, TANGERANG, BANTEN",23,49,132,181
https://kawalpemilu.org#52486,"SUKANAGARA, CIKUPA, TANGERANG, BANTEN",24,41,178,219
https://kawalpemilu.org#52486,"SUKANAGARA, CIKUPA, TANGERANG, BANTEN",25,45,211,256
https://kawalpemilu.org#52487,"BITUNG JAYA, CIKUPA, TANGERANG, BANTEN",1,77,139,216
https://kawalpemilu.org#52487,"BITUNG JAYA, CIKUPA, TANGERANG, BANTEN",2,42,138,180
https://kawalpemilu.org#52487,"BITUNG JAYA, CIKUPA, TANGERANG, BANTEN",3,46,113,159
https://kawalpemilu.org#52487,"BITUNG JAYA, CIKUPA, TANGERANG, BANTEN",4,35,130,165
https://kawalpemilu.org#52487,"BITUNG JAYA, CIKUPA, TANGERANG, BANTEN",5,39,130,169
https://kawalpemilu.org#52487,"BITUNG JAYA, CIKUPA, TANGERANG, BANTEN",6,44,129,173
https://kawalpemilu.org#52487,"BITUNG JAYA, CIKUPA, TANGERANG, BANTEN",7,53,161,214
https://kawalpemilu.org#52487,"BITUNG JAYA, CIKUPA, TANGERANG, BANTEN",8,52,128,180
https://kawalpemilu.org#52487,"BITUNG JAYA, CIKUPA, TANGERANG, BANTEN",9,31,154,185
https://kawalpemilu.org#52487,"BITUNG JAYA, CIKUPA, TANGERANG, BANTEN",11,32,108,140
https://kawalpemilu.org#52487,"BITUNG JAYA, CIKUPA, TANGERANG, BANTEN",12,37,136,173
https://kawalpemilu.org#52487,"BITUNG JAYA, CIKUPA, TANGERANG, BANTEN",13,18,174,192
https://kawalpemilu.org#52487,"BITUNG JAYA, CIKUPA, TANGERANG, BANTEN",14,53,129,182
https://kawalpemilu.org#52487,"BITUNG JAYA, CIKUPA, TANGERANG, BANTEN",16,55,121,176
https://kawalpemilu.org#52487,"BITUNG JAYA, CIKUPA, TANGERANG, BANTEN",18,57,130,187
https://kawalpemilu.org#52487,"BITUNG JAYA, CIKUPA, TANGERANG, BANTEN",19,79,125,204
https://kawalpemilu.org#52487,"BITUNG JAYA, CIKUPA, TANGERANG, BANTEN",20,53,111,164
https://kawalpemilu.org#52487,"BITUNG JAYA, CIKUPA, TANGERANG, BANTEN",21,69,118,187
https://kawalpemilu.org#52487,"BITUNG JAYA, CIKUPA, TANGERANG, BANTEN",22,44,120,164
https://kawalpemilu.org#52487,"BITUNG JAYA, CIKUPA, TANGERANG, BANTEN",23,40,82,122
https://kawalpemilu.org#52487,"BITUNG JAYA, CIKUPA, TANGERANG, BANTEN",24,24,125,149
https://kawalpemilu.org#52487,"BITUNG JAYA, CIKUPA, TANGERANG, BANTEN",25,32,116,148
https://kawalpemilu.org#52487,"BITUNG JAYA, CIKUPA, TANGERANG, BANTEN",26,90,150,240
https://kawalpemilu.org#52487,"BITUNG JAYA, CIKUPA, TANGERANG, BANTEN",27,31,130,161
https://kawalpemilu.org#52487,"BITUNG JAYA, CIKUPA, TANGERANG, BANTEN",29,27,95,122
https://kawalpemilu.org#52487,"BITUNG JAYA, CIKUPA, TANGERANG, BANTEN",30,100,129,229
https://kawalpemilu.org#52487,"BITUNG JAYA, CIKUPA, TANGERANG, BANTEN",31,46,147,193
https://kawalpemilu.org#52487,"BITUNG JAYA, CIKUPA, TANGERANG, BANTEN",32,30,97,127
https://kawalpemilu.org#52487,"BITUNG JAYA, CIKUPA, TANGERANG, BANTEN",33,37,143,180
https://kawalpemilu.org#52487,"BITUNG JAYA, CIKUPA, TANGERANG, BANTEN",34,45,148,193
https://kawalpemilu.org#52487,"BITUNG JAYA, CIKUPA, TANGERANG, BANTEN",35,57,145,202
https://kawalpemilu.org#52487,"BITUNG JAYA, CIKUPA, TANGERANG, BANTEN",36,48,112,160
https://kawalpemilu.org#52487,"BITUNG JAYA, CIKUPA, TANGERANG, BANTEN",37,35,161,196
https://kawalpemilu.org#52487,"BITUNG JAYA, CIKUPA, TANGERANG, BANTEN",38,73,87,160
https://kawalpemilu.org#52487,"BITUNG JAYA, CIKUPA, TANGERANG, BANTEN",39,39,131,170
https://kawalpemilu.org#52487,"BITUNG JAYA, CIKUPA, TANGERANG, BANTEN",40,41,150,195
https://kawalpemilu.org#52488,"PASIR GADUNG, CIKUPA, TANGERANG, BANTEN",1,58,173,231
https://kawalpemilu.org#52488,"PASIR GADUNG, CIKUPA, TANGERANG, BANTEN",2,43,136,179
https://kawalpemilu.org#52488,"PASIR GADUNG, CIKUPA, TANGERANG, BANTEN",3,35,112,147
https://kawalpemilu.org#52488,"PASIR GADUNG, CIKUPA, TANGERANG, BANTEN",4,61,181,242
https://kawalpemilu.org#52488,"PASIR GADUNG, CIKUPA, TANGERANG, BANTEN",5,58,118,176
https://kawalpemilu.org#52488,"PASIR GADUNG, CIKUPA, TANGERANG, BANTEN",7,55,187,242
https://kawalpemilu.org#52488,"PASIR GADUNG, CIKUPA, TANGERANG, BANTEN",8,40,138,178
https://kawalpemilu.org#52488,"PASIR GADUNG, CIKUPA, TANGERANG, BANTEN",9,54,143,197
https://kawalpemilu.org#52488,"PASIR GADUNG, CIKUPA, TANGERANG, BANTEN",10,38,168,206
https://kawalpemilu.org#52488,"PASIR GADUNG, CIKUPA, TANGERANG, BANTEN",11,77,185,262
https://kawalpemilu.org#52488,"PASIR GADUNG, CIKUPA, TANGERANG, BANTEN",12,48,186,234
https://kawalpemilu.org#52488,"PASIR GADUNG, CIKUPA, TANGERANG, BANTEN",13,59,206,265
https://kawalpemilu.org#52488,"PASIR GADUNG, CIKUPA, TANGERANG, BANTEN",14,62,158,220
https://kawalpemilu.org#52488,"PASIR GADUNG, CIKUPA, TANGERANG, BANTEN",15,70,135,205
https://kawalpemilu.org#52488,"PASIR GADUNG, CIKUPA, TANGERANG, BANTEN",16,29,56,85
https://kawalpemilu.org#52488,"PASIR GADUNG, CIKUPA, TANGERANG, BANTEN",17,42,157,199
https://kawalpemilu.org#52488,"PASIR GADUNG, CIKUPA, TANGERANG, BANTEN",18,41,169,210
https://kawalpemilu.org#52488,"PASIR GADUNG, CIKUPA, TANGERANG, BANTEN",19,90,109,199
https://kawalpemilu.org#52488,"PASIR GADUNG, CIKUPA, TANGERANG, BANTEN",20,89,114,203
https://kawalpemilu.org#52488,"PASIR GADUNG, CIKUPA, TANGERANG, BANTEN",21,78,135,213
https://kawalpemilu.org#52488,"PASIR GADUNG, CIKUPA, TANGERANG, BANTEN",22,91,159,250
https://kawalpemilu.org#52488,"PASIR GADUNG, CIKUPA, TANGERANG, BANTEN",23,75,163,238
https://kawalpemilu.org#52488,"PASIR GADUNG, CIKUPA, TANGERANG, BANTEN",24,42,135,177
https://kawalpemilu.org#52488,"PASIR GADUNG, CIKUPA, TANGERANG, BANTEN",25,55,141,196
https://kawalpemilu.org#52488,"PASIR GADUNG, CIKUPA, TANGERANG, BANTEN",26,46,109,155
https://kawalpemilu.org#52488,"PASIR GADUNG, CIKUPA, TANGERANG, BANTEN",28,59,190,249
https://kawalpemilu.org#52488,"PASIR GADUNG, CIKUPA, TANGERANG, BANTEN",29,42,144,186
https://kawalpemilu.org#52488,"PASIR GADUNG, CIKUPA, TANGERANG, BANTEN",30,53,127,180
https://kawalpemilu.org#52488,"PASIR GADUNG, CIKUPA, TANGERANG, BANTEN",31,52,165,217
https://kawalpemilu.org#52488,"PASIR GADUNG, CIKUPA, TANGERANG, BANTEN",32,54,104,158
https://kawalpemilu.org#52488,"PASIR GADUNG, CIKUPA, TANGERANG, BANTEN",33,58,145,203
https://kawalpemilu.org#52488,"PASIR GADUNG, CIKUPA, TANGERANG, BANTEN",34,48,196,244
https://kawalpemilu.org#52488,"PASIR GADUNG, CIKUPA, TANGERANG, BANTEN",35,40,184,224
https://kawalpemilu.org#52488,"PASIR GADUNG, CIKUPA, TANGERANG, BANTEN",36,65,151,216
https://kawalpemilu.org#52488,"PASIR GADUNG, CIKUPA, TANGERANG, BANTEN",37,32,138,170
https://kawalpemilu.org#52488,"PASIR GADUNG, CIKUPA, TANGERANG, BANTEN",38,38,103,141
https://kawalpemilu.org#52488,"PASIR GADUNG, CIKUPA, TANGERANG, BANTEN",39,64,112,176
https://kawalpemilu.org#52488,"PASIR GADUNG, CIKUPA, TANGERANG, BANTEN",40,41,161,202
https://kawalpemilu.org#52488,"PASIR GADUNG, CIKUPA, TANGERANG, BANTEN",41,85,130,215
https://kawalpemilu.org#52488,"PASIR GADUNG, CIKUPA, TANGERANG, BANTEN",42,82,119,201
https://kawalpemilu.org#52488,"PASIR GADUNG, CIKUPA, TANGERANG, BANTEN",43,76,135,211
https://kawalpemilu.org#52488,"PASIR GADUNG, CIKUPA, TANGERANG, BANTEN",44,91,148,239
https://kawalpemilu.org#52488,"PASIR GADUNG, CIKUPA, TANGERANG, BANTEN",45,91,128,219
https://kawalpemilu.org#52488,"PASIR GADUNG, CIKUPA, TANGERANG, BANTEN",46,71,125,196
https://kawalpemilu.org#52489,"SUKADAMAI, CIKUPA, TANGERANG, BANTEN",1,72,109,181
https://kawalpemilu.org#52489,"SUKADAMAI, CIKUPA, TANGERANG, BANTEN",2,66,158,224
https://kawalpemilu.org#52489,"SUKADAMAI, CIKUPA, TANGERANG, BANTEN",3,26,141,167
https://kawalpemilu.org#52489,"SUKADAMAI, CIKUPA, TANGERANG, BANTEN",4,52,153,205
https://kawalpemilu.org#52489,"SUKADAMAI, CIKUPA, TANGERANG, BANTEN",5,50,120,170
https://kawalpemilu.org#52489,"SUKADAMAI, CIKUPA, TANGERANG, BANTEN",6,50,173,223
https://kawalpemilu.org#52489,"SUKADAMAI, CIKUPA, TANGERANG, BANTEN",7,45,155,200
https://kawalpemilu.org#52489,"SUKADAMAI, CIKUPA, TANGERANG, BANTEN",8,18,129,147
https://kawalpemilu.org#52489,"SUKADAMAI, CIKUPA, TANGERANG, BANTEN",9,57,132,189
https://kawalpemilu.org#52489,"SUKADAMAI, CIKUPA, TANGERANG, BANTEN",10,67,169,236
https://kawalpemilu.org#52489,"SUKADAMAI, CIKUPA, TANGERANG, BANTEN",11,42,84,126
https://kawalpemilu.org#52489,"SUKADAMAI, CIKUPA, TANGERANG, BANTEN",12,36,137,173
https://kawalpemilu.org#52489,"SUKADAMAI, CIKUPA, TANGERANG, BANTEN",13,65,155,220
https://kawalpemilu.org#52489,"SUKADAMAI, CIKUPA, TANGERANG, BANTEN",14,80,187,267
https://kawalpemilu.org#52489,"SUKADAMAI, CIKUPA, TANGERANG, BANTEN",15,61,126,187
https://kawalpemilu.org#52489,"SUKADAMAI, CIKUPA, TANGERANG, BANTEN",16,52,96,148
https://kawalpemilu.org#52489,"SUKADAMAI, CIKUPA, TANGERANG, BANTEN",17,63,142,205
https://kawalpemilu.org#52489,"SUKADAMAI, CIKUPA, TANGERANG, BANTEN",18,75,139,214
https://kawalpemilu.org#52489,"SUKADAMAI, CIKUPA, TANGERANG, BANTEN",19,70,180,250
https://kawalpemilu.org#52489,"SUKADAMAI, CIKUPA, TANGERANG, BANTEN",20,43,126,169
https://kawalpemilu.org#52489,"SUKADAMAI, CIKUPA, TANGERANG, BANTEN",21,36,131,167
https://kawalpemilu.org#52489,"SUKADAMAI, CIKUPA, TANGERANG, BANTEN",22,34,142,176
https://kawalpemilu.org#52489,"SUKADAMAI, CIKUPA, TANGERANG, BANTEN",24,71,119,190
https://kawalpemilu.org#52489,"SUKADAMAI, CIKUPA, TANGERANG, BANTEN",26,58,160,218
https://kawalpemilu.org#52489,"SUKADAMAI, CIKUPA, TANGERANG, BANTEN",27,65,106,171
https://kawalpemilu.org#52489,"SUKADAMAI, CIKUPA, TANGERANG, BANTEN",28,47,120,167
https://kawalpemilu.org#52489,"SUKADAMAI, CIKUPA, TANGERANG, BANTEN",29,63,124,187
https://kawalpemilu.org#52489,"SUKADAMAI, CIKUPA, TANGERANG, BANTEN",30,42,142,184
https://kawalpemilu.org#52489,"SUKADAMAI, CIKUPA, TANGERANG, BANTEN",32,69,119,188
https://kawalpemilu.org#52489,"SUKADAMAI, CIKUPA, TANGERANG, BANTEN",33,70,163,233
https://kawalpemilu.org#52489,"SUKADAMAI, CIKUPA, TANGERANG, BANTEN",34,44,147,191
https://kawalpemilu.org#52489,"SUKADAMAI, CIKUPA, TANGERANG, BANTEN",35,51,135,186
https://kawalpemilu.org#52489,"SUKADAMAI, CIKUPA, TANGERANG, BANTEN",36,67,148,215
https://kawalpemilu.org#52489,"SUKADAMAI, CIKUPA, TANGERANG, BANTEN",37,46,92,138
https://kawalpemilu.org#52489,"SUKADAMAI, CIKUPA, TANGERANG, BANTEN",38,58,132,190
https://kawalpemilu.org#52489,"SUKADAMAI, CIKUPA, TANGERANG, BANTEN",39,42,147,189
https://kawalpemilu.org#52489,"SUKADAMAI, CIKUPA, TANGERANG, BANTEN",40,48,159,207
https://kawalpemilu.org#52489,"SUKADAMAI, CIKUPA, TANGERANG, BANTEN",41,54,183,237
https://kawalpemilu.org#52489,"SUKADAMAI, CIKUPA, TANGERANG, BANTEN",42,33,113,146
https://kawalpemilu.org#52489,"SUKADAMAI, CIKUPA, TANGERANG, BANTEN",43,14,121,135
https://kawalpemilu.org#52489,"SUKADAMAI, CIKUPA, TANGERANG, BANTEN",44,43,124,167
https://kawalpemilu.org#52489,"SUKADAMAI, CIKUPA, TANGERANG, BANTEN",45,30,166,7
https://kawalpemilu.org#52490,"PASIR JAYA, CIKUPA, TANGERANG, BANTEN",1,74,167,241
https://kawalpemilu.org#52490,"PASIR JAYA, CIKUPA, TANGERANG, BANTEN",2,60,139,199
https://kawalpemilu.org#52490,"PASIR JAYA, CIKUPA, TANGERANG, BANTEN",3,51,148,199
https://kawalpemilu.org#52490,"PASIR JAYA, CIKUPA, TANGERANG, BANTEN",4,41,171,212
https://kawalpemilu.org#52490,"PASIR JAYA, CIKUPA, TANGERANG, BANTEN",5,58,170,228
https://kawalpemilu.org#52490,"PASIR JAYA, CIKUPA, TANGERANG, BANTEN",6,36,202,238
https://kawalpemilu.org#52490,"PASIR JAYA, CIKUPA, TANGERANG, BANTEN",7,30,195,225
https://kawalpemilu.org#52490,"PASIR JAYA, CIKUPA, TANGERANG, BANTEN",8,34,231,265
https://kawalpemilu.org#52490,"PASIR JAYA, CIKUPA, TANGERANG, BANTEN",9,39,196,235
https://kawalpemilu.org#52490,"PASIR JAYA, CIKUPA, TANGERANG, BANTEN",10,53,215,268
https://kawalpemilu.org#52490,"PASIR JAYA, CIKUPA, TANGERANG, BANTEN",11,27,212,239
https://kawalpemilu.org#52490,"PASIR JAYA, CIKUPA, TANGERANG, BANTEN",12,61,158,219
https://kawalpemilu.org#52490,"PASIR JAYA, CIKUPA, TANGERANG, BANTEN",13,51,163,214
https://kawalpemilu.org#52490,"PASIR JAYA, CIKUPA, TANGERANG, BANTEN",14,91,155,246
https://kawalpemilu.org#52490,"PASIR JAYA, CIKUPA, TANGERANG, BANTEN",15,98,165,263
https://kawalpemilu.org#52490,"PASIR JAYA, CIKUPA, TANGERANG, BANTEN",16,96,95,191
https://kawalpemilu.org#52490,"PASIR JAYA, CIKUPA, TANGERANG, BANTEN",17,68,179,247
https://kawalpemilu.org#52490,"PASIR JAYA, CIKUPA, TANGERANG, BANTEN",18,96,152,248
https://kawalpemilu.org#52490,"PASIR JAYA, CIKUPA, TANGERANG, BANTEN",19,80,168,248
https://kawalpemilu.org#52490,"PASIR JAYA, CIKUPA, TANGERANG, BANTEN",20,73,215,288
https://kawalpemilu.org#52490,"PASIR JAYA, CIKUPA, TANGERANG, BANTEN",21,64,203,267
https://kawalpemilu.org#52490,"PASIR JAYA, CIKUPA, TANGERANG, BANTEN",22,71,166,237
https://kawalpemilu.org#52490,"PASIR JAYA, CIKUPA, TANGERANG, BANTEN",23,59,200,259
https://kawalpemilu.org#52490,"PASIR JAYA, CIKUPA, TANGERANG, BANTEN",24,99,176,275
https://kawalpemilu.org#52490,"PASIR JAYA, CIKUPA, TANGERANG, BANTEN",25,50,129,179
https://kawalpemilu.org#52490,"PASIR JAYA, CIKUPA, TANGERANG, BANTEN",26,72,138,210
https://kawalpemilu.org#52490,"PASIR JAYA, CIKUPA, TANGERANG, BANTEN",27,46,134,180
https://kawalpemilu.org#52490,"PASIR JAYA, CIKUPA, TANGERANG, BANTEN",28,39,137,176
https://kawalpemilu.org#52490,"PASIR JAYA, CIKUPA, TANGERANG, BANTEN",29,39,116,155
https://kawalpemilu.org#52490,"PASIR JAYA, CIKUPA, TANGERANG, BANTEN",30,46,199,245
https://kawalpemilu.org#52490,"PASIR JAYA, CIKUPA, TANGERANG, BANTEN",31,53,212,265
https://kawalpemilu.org#52490,"PASIR JAYA, CIKUPA, TANGERANG, BANTEN",32,34,172,206
https://kawalpemilu.org#52490,"PASIR JAYA, CIKUPA, TANGERANG, BANTEN",34,61,68,129
https://kawalpemilu.org#52490,"PASIR JAYA, CIKUPA, TANGERANG, BANTEN",35,40,174,214
https://kawalpemilu.org#52490,"PASIR JAYA, CIKUPA, TANGERANG, BANTEN",36,53,131,184
https://kawalpemilu.org#52490,"PASIR JAYA, CIKUPA, TANGERANG, BANTEN",37,77,193,270
https://kawalpemilu.org#52490,"PASIR JAYA, CIKUPA, TANGERANG, BANTEN",38,76,118,194
https://kawalpemilu.org#52490,"PASIR JAYA, CIKUPA, TANGERANG, BANTEN",39,55,150,205
https://kawalpemilu.org#52490,"PASIR JAYA, CIKUPA, TANGERANG, BANTEN",40,61,104,165
https://kawalpemilu.org#52490,"PASIR JAYA, CIKUPA, TANGERANG, BANTEN",41,96,156,252
https://kawalpemilu.org#52490,"PASIR JAYA, CIKUPA, TANGERANG, BANTEN",42,75,170,245
https://kawalpemilu.org#52490,"PASIR JAYA, CIKUPA, TANGERANG, BANTEN",43,63,170,233
https://kawalpemilu.org#52490,"PASIR JAYA, CIKUPA, TANGERANG, BANTEN",44,58,199,257
https://kawalpemilu.org#52490,"PASIR JAYA, CIKUPA, TANGERANG, BANTEN",45,75,172,247
https://kawalpemilu.org#52490,"PASIR JAYA, CIKUPA, TANGERANG, BANTEN",46,95,176,271
https://kawalpemilu.org#52490,"PASIR JAYA, CIKUPA, TANGERANG, BANTEN",47,77,132,209
https://kawalpemilu.org#52490,"PASIR JAYA, CIKUPA, TANGERANG, BANTEN",49,42,198,240
https://kawalpemilu.org#52490,"PASIR JAYA, CIKUPA, TANGERANG, BANTEN",50,37,116,153
https://kawalpemilu.org#52490,"PASIR JAYA, CIKUPA, TANGERANG, BANTEN",51,63,85,148
https://kawalpemilu.org#52490,"PASIR JAYA, CIKUPA, TANGERANG, BANTEN",52,25,55,80
https://kawalpemilu.org#52491,"BUDI MULYA, CIKUPA, TANGERANG, BANTEN",1,61,165,226
https://kawalpemilu.org#52491,"BUDI MULYA, CIKUPA, TANGERANG, BANTEN",2,38,139,177
https://kawalpemilu.org#52491,"BUDI MULYA, CIKUPA, TANGERANG, BANTEN",3,39,91,130
https://kawalpemilu.org#52491,"BUDI MULYA, CIKUPA, TANGERANG, BANTEN",4,52,134,186
https://kawalpemilu.org#52491,"BUDI MULYA, CIKUPA, TANGERANG, BANTEN",5,46,120,166
https://kawalpemilu.org#52491,"BUDI MULYA, CIKUPA, TANGERANG, BANTEN",6,48,132,180
https://kawalpemilu.org#52491,"BUDI MULYA, CIKUPA, TANGERANG, BANTEN",7,66,172,238
https://kawalpemilu.org#52491,"BUDI MULYA, CIKUPA, TANGERANG, BANTEN",8,45,112,157
https://kawalpemilu.org#52491,"BUDI MULYA, CIKUPA, TANGERANG, BANTEN",9,44,127,171
https://kawalpemilu.org#52491,"BUDI MULYA, CIKUPA, TANGERANG, BANTEN",10,46,88,134
https://kawalpemilu.org#52491,"BUDI MULYA, CIKUPA, TANGERANG, BANTEN",11,58,136,194
https://kawalpemilu.org#52491,"BUDI MULYA, CIKUPA, TANGERANG, BANTEN",12,45,124,169
https://kawalpemilu.org#52491,"BUDI MULYA, CIKUPA, TANGERANG, BANTEN",13,18,174,192
https://kawalpemilu.org#52491,"BUDI MULYA, CIKUPA, TANGERANG, BANTEN",14,53,129,182
https://kawalpemilu.org#52491,"BUDI MULYA, CIKUPA, TANGERANG, BANTEN",15,25,103,128
https://kawalpemilu.org#52491,"BUDI MULYA, CIKUPA, TANGERANG, BANTEN",16,34,124,158
https://kawalpemilu.org#52491,"BUDI MULYA, CIKUPA, TANGERANG, BANTEN",17,19,98,117
https://kawalpemilu.org#52492,"BOJONG, CIKUPA, TANGERANG, BANTEN",1,55,172,227
https://kawalpemilu.org#52492,"BOJONG, CIKUPA, TANGERANG, BANTEN",2,63,143,206
https://kawalpemilu.org#52492,"BOJONG, CIKUPA, TANGERANG, BANTEN",3,78,142,220
https://kawalpemilu.org#52492,"BOJONG, CIKUPA, TANGERANG, BANTEN",4,65,137,202
https://kawalpemilu.org#52492,"BOJONG, CIKUPA, TANGERANG, BANTEN",5,54,139,193
https://kawalpemilu.org#52492,"BOJONG, CIKUPA, TANGERANG, BANTEN",6,59,147,206
https://kawalpemilu.org#52492,"BOJONG, CIKUPA, TANGERANG, BANTEN",7,49,144,193
https://kawalpemilu.org#52492,"BOJONG, CIKUPA, TANGERANG, BANTEN",8,56,104,160
https://kawalpemilu.org#52492,"BOJONG, CIKUPA, TANGERANG, BANTEN",9,43,111,154
https://kawalpemilu.org#52492,"BOJONG, CIKUPA, TANGERANG, BANTEN",10,54,112,166
https://kawalpemilu.org#52492,"BOJONG, CIKUPA, TANGERANG, BANTEN",11,27,84,111
https://kawalpemilu.org#52492,"BOJONG, CIKUPA, TANGERANG, BANTEN",12,41,119,160
https://kawalpemilu.org#52492,"BOJONG, CIKUPA, TANGERANG, BANTEN",13,40,110,150
https://kawalpemilu.org#52492,"BOJONG, CIKUPA, TANGERANG, BANTEN",14,42,120,162
https://kawalpemilu.org#52492,"BOJONG, CIKUPA, TANGERANG, BANTEN",15,47,187,234
https://kawalpemilu.org#52492,"BOJONG, CIKUPA, TANGERANG, BANTEN",16,37,171,208
https://kawalpemilu.org#52492,"BOJONG, CIKUPA, TANGERANG, BANTEN",17,45,198,243
https://kawalpemilu.org#52492,"BOJONG, CIKUPA, TANGERANG, BANTEN",18,46,95,141
https://kawalpemilu.org#52492,"BOJONG, CIKUPA, TANGERANG, BANTEN",19,39,106,145
https://kawalpemilu.org#52492,"BOJONG, CIKUPA, TANGERANG, BANTEN",20,32,179,211
https://kawalpemilu.org#52492,"BOJONG, CIKUPA, TANGERANG, BANTEN",21,20,183,203
https://kawalpemilu.org#52492,"BOJONG, CIKUPA, TANGERANG, BANTEN",22,19,132,151
https://kawalpemilu.org#52492,"BOJONG, CIKUPA, TANGERANG, BANTEN",23,24,113,137
https://kawalpemilu.org#52492,"BOJONG, CIKUPA, TANGERANG, BANTEN",24,19,126,145
https://kawalpemilu.org#52492,"BOJONG, CIKUPA, TANGERANG, BANTEN",25,28,150,178
https://kawalpemilu.org#52492,"BOJONG, CIKUPA, TANGERANG, BANTEN",26,17,135,152
https://kawalpemilu.org#52492,"BOJONG, CIKUPA, TANGERANG, BANTEN",27,32,204,236
https://kawalpemilu.org#52492,"BOJONG, CIKUPA, TANGERANG, BANTEN",28,61,184,245
https://kawalpemilu.org#52492,"BOJONG, CIKUPA, TANGERANG, BANTEN",29,42,183,225
https://kawalpemilu.org#52492,"BOJONG, CIKUPA, TANGERANG, BANTEN",31,77,140,217
https://kawalpemilu.org#52492,"BOJONG, CIKUPA, TANGERANG, BANTEN",32,53,158,211
https://kawalpemilu.org#52492,"BOJONG, CIKUPA, TANGERANG, BANTEN",33,65,150,215
https://kawalpemilu.org#52492,"BOJONG, CIKUPA, TANGERANG, BANTEN",34,53,176,229
https://kawalpemilu.org#52492,"BOJONG, CIKUPA, TANGERANG, BANTEN",35,47,116,163
https://kawalpemilu.org#52492,"BOJONG, CIKUPA, TANGERANG, BANTEN",36,42,115,157
https://kawalpemilu.org#52492,"BOJONG, CIKUPA, TANGERANG, BANTEN",37,36,162,198
https://kawalpemilu.org#52492,"BOJONG, CIKUPA, TANGERANG, BANTEN",38,51,163,214
https://kawalpemilu.org#52492,"BOJONG, CIKUPA, TANGERANG, BANTEN",39,33,122,155
https://kawalpemilu.org#52492,"BOJONG, CIKUPA, TANGERANG, BANTEN",41,86,160,246
https://kawalpemilu.org#52492,"BOJONG, CIKUPA, TANGERANG, BANTEN",42,81,148,229
https://kawalpemilu.org#52492,"BOJONG, CIKUPA, TANGERANG, BANTEN",43,28,79,107
https://kawalpemilu.org#52492,"BOJONG, CIKUPA, TANGERANG, BANTEN",44,43,95,138
https://kawalpemilu.org#52494,"MEKAR BAKTI, PANONGAN, TANGERANG, BANTEN",1,57,180,237
https://kawalpemilu.org#52494,"MEKAR BAKTI, PANONGAN, TANGERANG, BANTEN",2,43,141,184
https://kawalpemilu.org#52494,"MEKAR BAKTI, PANONGAN, TANGERANG, BANTEN",3,41,126,167
https://kawalpemilu.org#52494,"MEKAR BAKTI, PANONGAN, TANGERANG, BANTEN",4,38,121,159
https://kawalpemilu.org#52494,"MEKAR BAKTI, PANONGAN, TANGERANG, BANTEN",5,107,115,222
https://kawalpemilu.org#52494,"MEKAR BAKTI, PANONGAN, TANGERANG, BANTEN",6,96,88,184
https://kawalpemilu.org#52494,"MEKAR BAKTI, PANONGAN, TANGERANG, BANTEN",7,77,175,252
https://kawalpemilu.org#52494,"MEKAR BAKTI, PANONGAN, TANGERANG, BANTEN",8,70,181,251
https://kawalpemilu.org#52494,"MEKAR BAKTI, PANONGAN, TANGERANG, BANTEN",9,31,138,169
https://kawalpemilu.org#52494,"MEKAR BAKTI, PANONGAN, TANGERANG, BANTEN",10,56,103,159
https://kawalpemilu.org#52494,"MEKAR BAKTI, PANONGAN, TANGERANG, BANTEN",11,83,130,213
https://kawalpemilu.org#52494,"MEKAR BAKTI, PANONGAN, TANGERANG, BANTEN",12,71,160,231
https://kawalpemilu.org#52494,"MEKAR BAKTI, PANONGAN, TANGERANG, BANTEN",13,142,124,266
https://kawalpemilu.org#52494,"MEKAR BAKTI, PANONGAN, TANGERANG, BANTEN",14,152,71,223
https://kawalpemilu.org#52494,"MEKAR BAKTI, PANONGAN, TANGERANG, BANTEN",15,98,93,191
https://kawalpemilu.org#52494,"MEKAR BAKTI, PANONGAN, TANGERANG, BANTEN",16,108,146,254
https://kawalpemilu.org#52494,"MEKAR BAKTI, PANONGAN, TANGERANG, BANTEN",17,92,113,205
https://kawalpemilu.org#52494,"MEKAR BAKTI, PANONGAN, TANGERANG, BANTEN",18,123,69,192
https://kawalpemilu.org#52494,"MEKAR BAKTI, PANONGAN, TANGERANG, BANTEN",19,131,86,217
https://kawalpemilu.org#52494,"MEKAR BAKTI, PANONGAN, TANGERANG, BANTEN",21,92,101,193
https://kawalpemilu.org#52494,"MEKAR BAKTI, PANONGAN, TANGERANG, BANTEN",22,112,123,235
https://kawalpemilu.org#52494,"MEKAR BAKTI, PANONGAN, TANGERANG, BANTEN",23,127,96,223
https://kawalpemilu.org#52494,"MEKAR BAKTI, PANONGAN, TANGERANG, BANTEN",24,184,102,286
https://kawalpemilu.org#52494,"MEKAR BAKTI, PANONGAN, TANGERANG, BANTEN",25,87,121,208
https://kawalpemilu.org#52494,"MEKAR BAKTI, PANONGAN, TANGERANG, BANTEN",26,89,152,241
https://kawalpemilu.org#52494,"MEKAR BAKTI, PANONGAN, TANGERANG, BANTEN",27,65,91,156
https://kawalpemilu.org#52494,"MEKAR BAKTI, PANONGAN, TANGERANG, BANTEN",28,167,101,268
https://kawalpemilu.org#52494,"MEKAR BAKTI, PANONGAN, TANGERANG, BANTEN",29,111,96,207
https://kawalpemilu.org#52494,"MEKAR BAKTI, PANONGAN, TANGERANG, BANTEN",30,77,90,167
https://kawalpemilu.org#52494,"MEKAR BAKTI, PANONGAN, TANGERANG, BANTEN",31,120,167,287
https://kawalpemilu.org#52494,"MEKAR BAKTI, PANONGAN, TANGERANG, BANTEN",32,42,139,181
https://kawalpemilu.org#52494,"MEKAR BAKTI, PANONGAN, TANGERANG, BANTEN",33,20,138,158
https://kawalpemilu.org#52494,"MEKAR BAKTI, PANONGAN, TANGERANG, BANTEN",34,53,104,157
https://kawalpemilu.org#52494,"MEKAR BAKTI, PANONGAN, TANGERANG, BANTEN",35,75,123,198
https://kawalpemilu.org#52494,"MEKAR BAKTI, PANONGAN, TANGERANG, BANTEN",36,61,113,174
https://kawalpemilu.org#52494,"MEKAR BAKTI, PANONGAN, TANGERANG, BANTEN",37,224,39,263
https://kawalpemilu.org#52494,"MEKAR BAKTI, PANONGAN, TANGERANG, BANTEN",38,80,175,255
https://kawalpemilu.org#52494,"MEKAR BAKTI, PANONGAN, TANGERANG, BANTEN",39,51,139,190
https://kawalpemilu.org#52494,"MEKAR BAKTI, PANONGAN, TANGERANG, BANTEN",40,67,99,166
https://kawalpemilu.org#52494,"MEKAR BAKTI, PANONGAN, TANGERANG, BANTEN",41,55,125,180
https://kawalpemilu.org#52494,"MEKAR BAKTI, PANONGAN, TANGERANG, BANTEN",42,33,122,155
https://kawalpemilu.org#52494,"MEKAR BAKTI, PANONGAN, TANGERANG, BANTEN",43,123,103,226
https://kawalpemilu.org#52494,"MEKAR BAKTI, PANONGAN, TANGERANG, BANTEN",44,169,82,251
https://kawalpemilu.org#52494,"MEKAR BAKTI, PANONGAN, TANGERANG, BANTEN",45,128,110,238
https://kawalpemilu.org#52494,"MEKAR BAKTI, PANONGAN, TANGERANG, BANTEN",46,118,148,266
https://kawalpemilu.org#52494,"MEKAR BAKTI, PANONGAN, TANGERANG, BANTEN",47,90,167,257
https://kawalpemilu.org#52494,"MEKAR BAKTI, PANONGAN, TANGERANG, BANTEN",48,136,88,224
https://kawalpemilu.org#52494,"MEKAR BAKTI, PANONGAN, TANGERANG, BANTEN",49,123,77,200
https://kawalpemilu.org#52494,"MEKAR BAKTI, PANONGAN, TANGERANG, BANTEN",50,78,94,172
https://kawalpemilu.org#52494,"MEKAR BAKTI, PANONGAN, TANGERANG, BANTEN",51,97,100,197
https://kawalpemilu.org#52494,"MEKAR BAKTI, PANONGAN, TANGERANG, BANTEN",52,111,121,232
https://kawalpemilu.org#52494,"MEKAR BAKTI, PANONGAN, TANGERANG, BANTEN",53,68,118,186
https://kawalpemilu.org#52494,"MEKAR BAKTI, PANONGAN, TANGERANG, BANTEN",54,100,118,218
https://kawalpemilu.org#52494,"MEKAR BAKTI, PANONGAN, TANGERANG, BANTEN",55,146,65,211
https://kawalpemilu.org#52494,"MEKAR BAKTI, PANONGAN, TANGERANG, BANTEN",56,139,97,236
https://kawalpemilu.org#52494,"MEKAR BAKTI, PANONGAN, TANGERANG, BANTEN",57,114,134,248
https://kawalpemilu.org#52494,"MEKAR BAKTI, PANONGAN, TANGERANG, BANTEN",58,124,133,257
https://kawalpemilu.org#52494,"MEKAR BAKTI, PANONGAN, TANGERANG, BANTEN",59,87,98,185
https://kawalpemilu.org#52494,"MEKAR BAKTI, PANONGAN, TANGERANG, BANTEN",60,55,105,160
https://kawalpemilu.org#52494,"MEKAR BAKTI, PANONGAN, TANGERANG, BANTEN",61,80,130,210
https://kawalpemilu.org#52495,"RANCA IYUH, PANONGAN, TANGERANG, BANTEN",1,42,133,175
https://kawalpemilu.org#52495,"RANCA IYUH, PANONGAN, TANGERANG, BANTEN",2,73,165,238
https://kawalpemilu.org#52495,"RANCA IYUH, PANONGAN, TANGERANG, BANTEN",3,83,84,167
https://kawalpemilu.org#52495,"RANCA IYUH, PANONGAN, TANGERANG, BANTEN",4,70,154,224
https://kawalpemilu.org#52495,"RANCA IYUH, PANONGAN, TANGERANG, BANTEN",5,57,107,164
https://kawalpemilu.org#52495,"RANCA IYUH, PANONGAN, TANGERANG, BANTEN",6,55,94,149
https://kawalpemilu.org#52495,"RANCA IYUH, PANONGAN, TANGERANG, BANTEN",7,52,120,172
https://kawalpemilu.org#52495,"RANCA IYUH, PANONGAN, TANGERANG, BANTEN",8,126,106,232
https://kawalpemilu.org#52495,"RANCA IYUH, PANONGAN, TANGERANG, BANTEN",9,85,103,188
https://kawalpemilu.org#52495,"RANCA IYUH, PANONGAN, TANGERANG, BANTEN",10,86,171,257
https://kawalpemilu.org#52495,"RANCA IYUH, PANONGAN, TANGERANG, BANTEN",11,73,116,189
https://kawalpemilu.org#52495,"RANCA IYUH, PANONGAN, TANGERANG, BANTEN",12,106,80,186
https://kawalpemilu.org#52495,"RANCA IYUH, PANONGAN, TANGERANG, BANTEN",13,105,132,237
https://kawalpemilu.org#52495,"RANCA IYUH, PANONGAN, TANGERANG, BANTEN",15,80,114,194
https://kawalpemilu.org#52495,"RANCA IYUH, PANONGAN, TANGERANG, BANTEN",17,28,154,182
https://kawalpemilu.org#52495,"RANCA IYUH, PANONGAN, TANGERANG, BANTEN",18,103,133,236
https://kawalpemilu.org#52495,"RANCA IYUH, PANONGAN, TANGERANG, BANTEN",19,87,143,230
https://kawalpemilu.org#52495,"RANCA IYUH, PANONGAN, TANGERANG, BANTEN",20,82,70,152
https://kawalpemilu.org#52495,"RANCA IYUH, PANONGAN, TANGERANG, BANTEN",21,76,137,213
https://kawalpemilu.org#52495,"RANCA IYUH, PANONGAN, TANGERANG, BANTEN",22,69,87,156
https://kawalpemilu.org#52495,"RANCA IYUH, PANONGAN, TANGERANG, BANTEN",23,0,0,0
https://kawalpemilu.org#52495,"RANCA IYUH, PANONGAN, TANGERANG, BANTEN",24,73,126,199
https://kawalpemilu.org#52495,"RANCA IYUH, PANONGAN, TANGERANG, BANTEN",25,77,130,207
https://kawalpemilu.org#52495,"RANCA IYUH, PANONGAN, TANGERANG, BANTEN",26,135,111,246
https://kawalpemilu.org#52495,"RANCA IYUH, PANONGAN, TANGERANG, BANTEN",27,80,89,169
https://kawalpemilu.org#52495,"RANCA IYUH, PANONGAN, TANGERANG, BANTEN",28,70,92,162
https://kawalpemilu.org#52495,"RANCA IYUH, PANONGAN, TANGERANG, BANTEN",30,92,112,204
https://kawalpemilu.org#52495,"RANCA IYUH, PANONGAN, TANGERANG, BANTEN",34,70,150,220
https://kawalpemilu.org#52495,"RANCA IYUH, PANONGAN, TANGERANG, BANTEN",36,91,112,203
https://kawalpemilu.org#52495,"RANCA IYUH, PANONGAN, TANGERANG, BANTEN",37,83,132,215
https://kawalpemilu.org#52496,"PEUSAR, PANONGAN, TANGERANG, BANTEN",1,114,154,268
https://kawalpemilu.org#52496,"PEUSAR, PANONGAN, TANGERANG, BANTEN",2,70,158,228
https://kawalpemilu.org#52496,"PEUSAR, PANONGAN, TANGERANG, BANTEN",3,116,174,290
https://kawalpemilu.org#52496,"PEUSAR, PANONGAN, TANGERANG, BANTEN",4,77,143,220
https://kawalpemilu.org#52496,"PEUSAR, PANONGAN, TANGERANG, BANTEN",5,81,182,263
https://kawalpemilu.org#52496,"PEUSAR, PANONGAN, TANGERANG, BANTEN",6,55,151,206
https://kawalpemilu.org#52496,"PEUSAR, PANONGAN, TANGERANG, BANTEN",7,50,146,196
https://kawalpemilu.org#52496,"PEUSAR, PANONGAN, TANGERANG, BANTEN",8,78,89,167
https://kawalpemilu.org#52496,"PEUSAR, PANONGAN, TANGERANG, BANTEN",9,51,167,218
https://kawalpemilu.org#52496,"PEUSAR, PANONGAN, TANGERANG, BANTEN",10,80,70,150
https://kawalpemilu.org#52496,"PEUSAR, PANONGAN, TANGERANG, BANTEN",11,83,147,230
https://kawalpemilu.org#52496,"PEUSAR, PANONGAN, TANGERANG, BANTEN",12,28,137,165
https://kawalpemilu.org#52496,"PEUSAR, PANONGAN, TANGERANG, BANTEN",13,23,180,203
https://kawalpemilu.org#52496,"PEUSAR, PANONGAN, TANGERANG, BANTEN",14,45,200,245
https://kawalpemilu.org#52496,"PEUSAR, PANONGAN, TANGERANG, BANTEN",15,46,187,233
https://kawalpemilu.org#52496,"PEUSAR, PANONGAN, TANGERANG, BANTEN",16,39,147,186
https://kawalpemilu.org#52496,"PEUSAR, PANONGAN, TANGERANG, BANTEN",17,47,151,198
https://kawalpemilu.org#52496,"PEUSAR, PANONGAN, TANGERANG, BANTEN",18,57,149,206
https://kawalpemilu.org#52496,"PEUSAR, PANONGAN, TANGERANG, BANTEN",19,28,99,127
https://kawalpemilu.org#52496,"PEUSAR, PANONGAN, TANGERANG, BANTEN",20,63,141,204
https://kawalpemilu.org#52496,"PEUSAR, PANONGAN, TANGERANG, BANTEN",24,64,163,227
https://kawalpemilu.org#52496,"PEUSAR, PANONGAN, TANGERANG, BANTEN",26,44,125,169
https://kawalpemilu.org#52496,"PEUSAR, PANONGAN, TANGERANG, BANTEN",27,80,124,204
https://kawalpemilu.org#52496,"PEUSAR, PANONGAN, TANGERANG, BANTEN",28,156,103,259
https://kawalpemilu.org#52497,"RANCA KALAPA, PANONGAN, TANGERANG, BANTEN",1,109,114,223
https://kawalpemilu.org#52497,"RANCA KALAPA, PANONGAN, TANGERANG, BANTEN",2,93,141,234
https://kawalpemilu.org#52497,"RANCA KALAPA, PANONGAN, TANGERANG, BANTEN",3,82,119,201
https://kawalpemilu.org#52497,"RANCA KALAPA, PANONGAN, TANGERANG, BANTEN",4,82,98,180
https://kawalpemilu.org#52497,"RANCA KALAPA, PANONGAN, TANGERANG, BANTEN",5,109,135,244
https://kawalpemilu.org#52497,"RANCA KALAPA, PANONGAN, TANGERANG, BANTEN",6,109,70,179
https://kawalpemilu.org#52497,"RANCA KALAPA, PANONGAN, TANGERANG, BANTEN",7,71,68,139
https://kawalpemilu.org#52497,"RANCA KALAPA, PANONGAN, TANGERANG, BANTEN",8,63,161,224
https://kawalpemilu.org#52497,"RANCA KALAPA, PANONGAN, TANGERANG, BANTEN",9,65,155,220
https://kawalpemilu.org#52497,"RANCA KALAPA, PANONGAN, TANGERANG, BANTEN",10,54,115,169
https://kawalpemilu.org#52497,"RANCA KALAPA, PANONGAN, TANGERANG, BANTEN",11,57,127,184
https://kawalpemilu.org#52497,"RANCA KALAPA, PANONGAN, TANGERANG, BANTEN",12,65,143,208
https://kawalpemilu.org#52497,"RANCA KALAPA, PANONGAN, TANGERANG, BANTEN",13,91,119,210
https://kawalpemilu.org#52497,"RANCA KALAPA, PANONGAN, TANGERANG, BANTEN",14,73,109,182
https://kawalpemilu.org#52497,"RANCA KALAPA, PANONGAN, TANGERANG, BANTEN",15,103,116,219
https://kawalpemilu.org#52497,"RANCA KALAPA, PANONGAN, TANGERANG, BANTEN",16,102,124,226
https://kawalpemilu.org#52497,"RANCA KALAPA, PANONGAN, TANGERANG, BANTEN",17,0,0,0
https://kawalpemilu.org#52497,"RANCA KALAPA, PANONGAN, TANGERANG, BANTEN",18,50,104,154
https://kawalpemilu.org#52497,"RANCA KALAPA, PANONGAN, TANGERANG, BANTEN",19,53,149,202
https://kawalpemilu.org#52497,"RANCA KALAPA, PANONGAN, TANGERANG, BANTEN",20,63,148,211
https://kawalpemilu.org#52497,"RANCA KALAPA, PANONGAN, TANGERANG, BANTEN",21,119,97,216
https://kawalpemilu.org#52497,"RANCA KALAPA, PANONGAN, TANGERANG, BANTEN",22,40,117,157
https://kawalpemilu.org#52497,"RANCA KALAPA, PANONGAN, TANGERANG, BANTEN",23,37,158,195
https://kawalpemilu.org#52498,"SERDANG KULON, PANONGAN, TANGERANG, BANTEN",1,61,160,221
https://kawalpemilu.org#52498,"SERDANG KULON, PANONGAN, TANGERANG, BANTEN",2,84,152,236
https://kawalpemilu.org#52498,"SERDANG KULON, PANONGAN, TANGERANG, BANTEN",3,65,169,234
https://kawalpemilu.org#52498,"SERDANG KULON, PANONGAN, TANGERANG, BANTEN",4,50,196,246
https://kawalpemilu.org#52498,"SERDANG KULON, PANONGAN, TANGERANG, BANTEN",5,42,107,149
https://kawalpemilu.org#52498,"SERDANG KULON, PANONGAN, TANGERANG, BANTEN",6,47,155,202
https://kawalpemilu.org#52498,"SERDANG KULON, PANONGAN, TANGERANG, BANTEN",7,97,163,260
https://kawalpemilu.org#52498,"SERDANG KULON, PANONGAN, TANGERANG, BANTEN",8,48,202,250
https://kawalpemilu.org#52498,"SERDANG KULON, PANONGAN, TANGERANG, BANTEN",9,42,147,189
https://kawalpemilu.org#52498,"SERDANG KULON, PANONGAN, TANGERANG, BANTEN",11,45,190,5
https://kawalpemilu.org#52498,"SERDANG KULON, PANONGAN, TANGERANG, BANTEN",12,108,147,255
https://kawalpemilu.org#52498,"SERDANG KULON, PANONGAN, TANGERANG, BANTEN",13,74,148,222
https://kawalpemilu.org#52498,"SERDANG KULON, PANONGAN, TANGERANG, BANTEN",14,43,164,207
https://kawalpemilu.org#52498,"SERDANG KULON, PANONGAN, TANGERANG, BANTEN",15,69,181,250
https://kawalpemilu.org#52498,"SERDANG KULON, PANONGAN, TANGERANG, BANTEN",16,43,203,246
https://kawalpemilu.org#52498,"SERDANG KULON, PANONGAN, TANGERANG, BANTEN",17,56,163,219
https://kawalpemilu.org#52498,"SERDANG KULON, PANONGAN, TANGERANG, BANTEN",18,38,154,192
https://kawalpemilu.org#52498,"SERDANG KULON, PANONGAN, TANGERANG, BANTEN",19,71,132,203
https://kawalpemilu.org#52498,"SERDANG KULON, PANONGAN, TANGERANG, BANTEN",20,43,192,235
https://kawalpemilu.org#52498,"SERDANG KULON, PANONGAN, TANGERANG, BANTEN",21,53,145,198
https://kawalpemilu.org#52498,"SERDANG KULON, PANONGAN, TANGERANG, BANTEN",22,55,142,197
https://kawalpemilu.org#52498,"SERDANG KULON, PANONGAN, TANGERANG, BANTEN",23,64,158,222
https://kawalpemilu.org#52498,"SERDANG KULON, PANONGAN, TANGERANG, BANTEN",24,97,182,279
https://kawalpemilu.org#52499,"MEKAR JAYA, PANONGAN, TANGERANG, BANTEN",1,62,165,227
https://kawalpemilu.org#52499,"MEKAR JAYA, PANONGAN, TANGERANG, BANTEN",2,38,192,230
https://kawalpemilu.org#52499,"MEKAR JAYA, PANONGAN, TANGERANG, BANTEN",3,0,0,0
https://kawalpemilu.org#52499,"MEKAR JAYA, PANONGAN, TANGERANG, BANTEN",4,37,138,175
https://kawalpemilu.org#52499,"MEKAR JAYA, PANONGAN, TANGERANG, BANTEN",5,77,161,238
https://kawalpemilu.org#52499,"MEKAR JAYA, PANONGAN, TANGERANG, BANTEN",6,60,134,194
https://kawalpemilu.org#52499,"MEKAR JAYA, PANONGAN, TANGERANG, BANTEN",7,55,117,172
https://kawalpemilu.org#52499,"MEKAR JAYA, PANONGAN, TANGERANG, BANTEN",8,66,143,209
https://kawalpemilu.org#52499,"MEKAR JAYA, PANONGAN, TANGERANG, BANTEN",9,42,180,222
https://kawalpemilu.org#52499,"MEKAR JAYA, PANONGAN, TANGERANG, BANTEN",10,96,132,228
https://kawalpemilu.org#52499,"MEKAR JAYA, PANONGAN, TANGERANG, BANTEN",11,54,185,239
https://kawalpemilu.org#52499,"MEKAR JAYA, PANONGAN, TANGERANG, BANTEN",12,64,157,221
https://kawalpemilu.org#52499,"MEKAR JAYA, PANONGAN, TANGERANG, BANTEN",13,52,194,246
https://kawalpemilu.org#52499,"MEKAR JAYA, PANONGAN, TANGERANG, BANTEN",14,57,120,177
https://kawalpemilu.org#52499,"MEKAR JAYA, PANONGAN, TANGERANG, BANTEN",15,97,118,215
https://kawalpemilu.org#52499,"MEKAR JAYA, PANONGAN, TANGERANG, BANTEN",16,56,135,191
https://kawalpemilu.org#52499,"MEKAR JAYA, PANONGAN, TANGERANG, BANTEN",17,76,101,177
https://kawalpemilu.org#52499,"MEKAR JAYA, PANONGAN, TANGERANG, BANTEN",18,75,130,205
https://kawalpemilu.org#52499,"MEKAR JAYA, PANONGAN, TANGERANG, BANTEN",19,53,165,218
https://kawalpemilu.org#52499,"MEKAR JAYA, PANONGAN, TANGERANG, BANTEN",20,98,127,225
https://kawalpemilu.org#52499,"MEKAR JAYA, PANONGAN, TANGERANG, BANTEN",21,174,67,241
https://kawalpemilu.org#52500,"CIAKAR, PANONGAN, TANGERANG, BANTEN",1,75,147,222
https://kawalpemilu.org#52500,"CIAKAR, PANONGAN, TANGERANG, BANTEN",2,119,155,274
https://kawalpemilu.org#52500,"CIAKAR, PANONGAN, TANGERANG, BANTEN",3,78,160,238
https://kawalpemilu.org#52500,"CIAKAR, PANONGAN, TANGERANG, BANTEN",4,80,149,229
https://kawalpemilu.org#52500,"CIAKAR, PANONGAN, TANGERANG, BANTEN",5,113,117,230
https://kawalpemilu.org#52500,"CIAKAR, PANONGAN, TANGERANG, BANTEN",6,133,108,241
https://kawalpemilu.org#52500,"CIAKAR, PANONGAN, TANGERANG, BANTEN",7,96,122,218
https://kawalpemilu.org#52500,"CIAKAR, PANONGAN, TANGERANG, BANTEN",8,124,118,242
https://kawalpemilu.org#52500,"CIAKAR, PANONGAN, TANGERANG, BANTEN",9,44,131,175
https://kawalpemilu.org#52500,"CIAKAR, PANONGAN, TANGERANG, BANTEN",10,76,150,226
https://kawalpemilu.org#52500,"CIAKAR, PANONGAN, TANGERANG, BANTEN",11,64,144,208
https://kawalpemilu.org#52500,"CIAKAR, PANONGAN, TANGERANG, BANTEN",12,52,128,180
https://kawalpemilu.org#52500,"CIAKAR, PANONGAN, TANGERANG, BANTEN",13,117,83,200
https://kawalpemilu.org#52500,"CIAKAR, PANONGAN, TANGERANG, BANTEN",14,91,97,188
https://kawalpemilu.org#52500,"CIAKAR, PANONGAN, TANGERANG, BANTEN",15,106,120,226
https://kawalpemilu.org#52500,"CIAKAR, PANONGAN, TANGERANG, BANTEN",16,90,142,232
https://kawalpemilu.org#52500,"CIAKAR, PANONGAN, TANGERANG, BANTEN",17,94,156,250
https://kawalpemilu.org#52500,"CIAKAR, PANONGAN, TANGERANG, BANTEN",18,126,77,203
https://kawalpemilu.org#52500,"CIAKAR, PANONGAN, TANGERANG, BANTEN",19,98,131,229
https://kawalpemilu.org#52500,"CIAKAR, PANONGAN, TANGERANG, BANTEN",20,86,104,190
https://kawalpemilu.org#52500,"CIAKAR, PANONGAN, TANGERANG, BANTEN",21,131,126,257
https://kawalpemilu.org#52500,"CIAKAR, PANONGAN, TANGERANG, BANTEN",22,96,113,209
https://kawalpemilu.org#52500,"CIAKAR, PANONGAN, TANGERANG, BANTEN",23,107,43,150
https://kawalpemilu.org#52500,"CIAKAR, PANONGAN, TANGERANG, BANTEN",24,158,103,261
https://kawalpemilu.org#52500,"CIAKAR, PANONGAN, TANGERANG, BANTEN",25,120,139,259
https://kawalpemilu.org#52500,"CIAKAR, PANONGAN, TANGERANG, BANTEN",26,117,111,228
https://kawalpemilu.org#52500,"CIAKAR, PANONGAN, TANGERANG, BANTEN",27,116,124,240
https://kawalpemilu.org#52500,"CIAKAR, PANONGAN, TANGERANG, BANTEN",28,56,135,191
https://kawalpemilu.org#52500,"CIAKAR, PANONGAN, TANGERANG, BANTEN",29,65,120,185
https://kawalpemilu.org#52500,"CIAKAR, PANONGAN, TANGERANG, BANTEN",30,63,95,158
https://kawalpemilu.org#52500,"CIAKAR, PANONGAN, TANGERANG, BANTEN",31,189,50,239
https://kawalpemilu.org#52500,"CIAKAR, PANONGAN, TANGERANG, BANTEN",32,81,121,202
https://kawalpemilu.org#52500,"CIAKAR, PANONGAN, TANGERANG, BANTEN",33,48,145,193
https://kawalpemilu.org#52500,"CIAKAR, PANONGAN, TANGERANG, BANTEN",34,198,1,199
https://kawalpemilu.org#52500,"CIAKAR, PANONGAN, TANGERANG, BANTEN",35,70,153,223
https://kawalpemilu.org#52500,"CIAKAR, PANONGAN, TANGERANG, BANTEN",36,60,115,175
https://kawalpemilu.org#52500,"CIAKAR, PANONGAN, TANGERANG, BANTEN",37,92,152,244
https://kawalpemilu.org#52500,"CIAKAR, PANONGAN, TANGERANG, BANTEN",38,70,117,187
https://kawalpemilu.org#52500,"CIAKAR, PANONGAN, TANGERANG, BANTEN",39,57,161,218
https://kawalpemilu.org#52500,"CIAKAR, PANONGAN, TANGERANG, BANTEN",40,37,136,173
https://kawalpemilu.org#52500,"CIAKAR, PANONGAN, TANGERANG, BANTEN",41,123,89,212
https://kawalpemilu.org#52500,"CIAKAR, PANONGAN, TANGERANG, BANTEN",42,118,114,232
https://kawalpemilu.org#52500,"CIAKAR, PANONGAN, TANGERANG, BANTEN",43,67,170,237
https://kawalpemilu.org#52500,"CIAKAR, PANONGAN, TANGERANG, BANTEN",44,106,114,220
https://kawalpemilu.org#52500,"CIAKAR, PANONGAN, TANGERANG, BANTEN",45,60,103,163
https://kawalpemilu.org#52500,"CIAKAR, PANONGAN, TANGERANG, BANTEN",46,53,127,180
https://kawalpemilu.org#52500,"CIAKAR, PANONGAN, TANGERANG, BANTEN",47,73,131,204
https://kawalpemilu.org#52500,"CIAKAR, PANONGAN, TANGERANG, BANTEN",48,66,128,194
https://kawalpemilu.org#52500,"CIAKAR, PANONGAN, TANGERANG, BANTEN",49,144,90,234
https://kawalpemilu.org#52500,"CIAKAR, PANONGAN, TANGERANG, BANTEN",50,57,139,196
https://kawalpemilu.org#52500,"CIAKAR, PANONGAN, TANGERANG, BANTEN",51,89,99,188
https://kawalpemilu.org#52500,"CIAKAR, PANONGAN, TANGERANG, BANTEN",52,93,106,199
https://kawalpemilu.org#52500,"CIAKAR, PANONGAN, TANGERANG, BANTEN",53,109,70,179
https://kawalpemilu.org#52500,"CIAKAR, PANONGAN, TANGERANG, BANTEN",54,94,97,191
https://kawalpemilu.org#52500,"CIAKAR, PANONGAN, TANGERANG, BANTEN",55,111,118,229
https://kawalpemilu.org#52500,"CIAKAR, PANONGAN, TANGERANG, BANTEN",56,73,124,197
https://kawalpemilu.org#52500,"CIAKAR, PANONGAN, TANGERANG, BANTEN",57,124,120,244
https://kawalpemilu.org#52500,"CIAKAR, PANONGAN, TANGERANG, BANTEN",58,83,85,168
https://kawalpemilu.org#52500,"CIAKAR, PANONGAN, TANGERANG, BANTEN",59,133,122,255
https://kawalpemilu.org#52500,"CIAKAR, PANONGAN, TANGERANG, BANTEN",60,110,94,204
https://kawalpemilu.org#52500,"CIAKAR, PANONGAN, TANGERANG, BANTEN",61,120,94,214
https://kawalpemilu.org#52500,"CIAKAR, PANONGAN, TANGERANG, BANTEN",62,126,121,247
https://kawalpemilu.org#52500,"CIAKAR, PANONGAN, TANGERANG, BANTEN",63,111,114,225
https://kawalpemilu.org#52500,"CIAKAR, PANONGAN, TANGERANG, BANTEN",64,80,121,201
https://kawalpemilu.org#52500,"CIAKAR, PANONGAN, TANGERANG, BANTEN",65,68,98,166
https://kawalpemilu.org#52500,"CIAKAR, PANONGAN, TANGERANG, BANTEN",66,75,103,178
https://kawalpemilu.org#52500,"CIAKAR, PANONGAN, TANGERANG, BANTEN",67,67,148,215
https://kawalpemilu.org#52500,"CIAKAR, PANONGAN, TANGERANG, BANTEN",68,199,69,268
https://kawalpemilu.org#52500,"CIAKAR, PANONGAN, TANGERANG, BANTEN",69,74,163,237
https://kawalpemilu.org#52500,"CIAKAR, PANONGAN, TANGERANG, BANTEN",70,77,94,171
https://kawalpemilu.org#52500,"CIAKAR, PANONGAN, TANGERANG, BANTEN",71,187,7,194
https://kawalpemilu.org#52500,"CIAKAR, PANONGAN, TANGERANG, BANTEN",72,118,57,175
https://kawalpemilu.org#52500,"CIAKAR, PANONGAN, TANGERANG, BANTEN",73,61,81,142
https://kawalpemilu.org#52500,"CIAKAR, PANONGAN, TANGERANG, BANTEN",74,35,132,167
https://kawalpemilu.org#52500,"CIAKAR, PANONGAN, TANGERANG, BANTEN",75,96,64,160
https://kawalpemilu.org#52501,"PANONGAN, PANONGAN, TANGERANG, BANTEN",1,44,172,216
https://kawalpemilu.org#52501,"PANONGAN, PANONGAN, TANGERANG, BANTEN",2,53,138,191
https://kawalpemilu.org#52501,"PANONGAN, PANONGAN, TANGERANG, BANTEN",3,60,180,240
https://kawalpemilu.org#52501,"PANONGAN, PANONGAN, TANGERANG, BANTEN",4,47,156,203
https://kawalpemilu.org#52501,"PANONGAN, PANONGAN, TANGERANG, BANTEN",5,150,93,243
https://kawalpemilu.org#52501,"PANONGAN, PANONGAN, TANGERANG, BANTEN",6,67,131,198
https://kawalpemilu.org#52501,"PANONGAN, PANONGAN, TANGERANG, BANTEN",7,50,146,196
https://kawalpemilu.org#52501,"PANONGAN, PANONGAN, TANGERANG, BANTEN",8,78,89,167
https://kawalpemilu.org#52501,"PANONGAN, PANONGAN, TANGERANG, BANTEN",9,139,114,253
https://kawalpemilu.org#52501,"PANONGAN, PANONGAN, TANGERANG, BANTEN",10,80,70,150
https://kawalpemilu.org#52501,"PANONGAN, PANONGAN, TANGERANG, BANTEN",11,83,147,230
https://kawalpemilu.org#52501,"PANONGAN, PANONGAN, TANGERANG, BANTEN",12,115,123,238
https://kawalpemilu.org#52501,"PANONGAN, PANONGAN, TANGERANG, BANTEN",13,108,96,204
https://kawalpemilu.org#52501,"PANONGAN, PANONGAN, TANGERANG, BANTEN",14,117,151,268
https://kawalpemilu.org#52501,"PANONGAN, PANONGAN, TANGERANG, BANTEN",15,106,118,224
https://kawalpemilu.org#52501,"PANONGAN, PANONGAN, TANGERANG, BANTEN",16,71,126,197
https://kawalpemilu.org#52501,"PANONGAN, PANONGAN, TANGERANG, BANTEN",17,92,121,213
https://kawalpemilu.org#52501,"PANONGAN, PANONGAN, TANGERANG, BANTEN",18,144,131,275
https://kawalpemilu.org#52501,"PANONGAN, PANONGAN, TANGERANG, BANTEN",19,76,162,238
https://kawalpemilu.org#52501,"PANONGAN, PANONGAN, TANGERANG, BANTEN",20,59,133,192
https://kawalpemilu.org#52501,"PANONGAN, PANONGAN, TANGERANG, BANTEN",21,37,157,194
https://kawalpemilu.org#52501,"PANONGAN, PANONGAN, TANGERANG, BANTEN",22,54,160,214
https://kawalpemilu.org#52501,"PANONGAN, PANONGAN, TANGERANG, BANTEN",23,64,167,231
https://kawalpemilu.org#52501,"PANONGAN, PANONGAN, TANGERANG, BANTEN",24,57,74,131
https://kawalpemilu.org#52501,"PANONGAN, PANONGAN, TANGERANG, BANTEN",25,173,81,254
https://kawalpemilu.org#52501,"PANONGAN, PANONGAN, TANGERANG, BANTEN",26,64,111,175
https://kawalpemilu.org#52501,"PANONGAN, PANONGAN, TANGERANG, BANTEN",27,55,142,197
https://kawalpemilu.org#52501,"PANONGAN, PANONGAN, TANGERANG, BANTEN",28,84,69,153
https://kawalpemilu.org#52501,"PANONGAN, PANONGAN, TANGERANG, BANTEN",29,122,100,222
https://kawalpemilu.org#52501,"PANONGAN, PANONGAN, TANGERANG, BANTEN",30,126,118,244
https://kawalpemilu.org#52501,"PANONGAN, PANONGAN, TANGERANG, BANTEN",31,108,132,240
https://kawalpemilu.org#52501,"PANONGAN, PANONGAN, TANGERANG, BANTEN",32,109,76,185
https://kawalpemilu.org#52501,"PANONGAN, PANONGAN, TANGERANG, BANTEN",33,102,134,236
https://kawalpemilu.org#52501,"PANONGAN, PANONGAN, TANGERANG, BANTEN",34,109,128,237
https://kawalpemilu.org#52501,"PANONGAN, PANONGAN, TANGERANG, BANTEN",35,115,127,242
https://kawalpemilu.org#52501,"PANONGAN, PANONGAN, TANGERANG, BANTEN",36,78,107,185
https://kawalpemilu.org#52501,"PANONGAN, PANONGAN, TANGERANG, BANTEN",37,83,124,207
https://kawalpemilu.org#52501,"PANONGAN, PANONGAN, TANGERANG, BANTEN",38,87,157,244
https://kawalpemilu.org#52501,"PANONGAN, PANONGAN, TANGERANG, BANTEN",39,58,130,188
https://kawalpemilu.org#52501,"PANONGAN, PANONGAN, TANGERANG, BANTEN",40,62,125,187
https://kawalpemilu.org#52501,"PANONGAN, PANONGAN, TANGERANG, BANTEN",41,85,151,236
https://kawalpemilu.org#52501,"PANONGAN, PANONGAN, TANGERANG, BANTEN",42,65,131,196
https://kawalpemilu.org#52501,"PANONGAN, PANONGAN, TANGERANG, BANTEN",43,137,12,149
https://kawalpemilu.org#52501,"PANONGAN, PANONGAN, TANGERANG, BANTEN",44,71,172,243
https://kawalpemilu.org#52501,"PANONGAN, PANONGAN, TANGERANG, BANTEN",45,56,158,214
https://kawalpemilu.org#52501,"PANONGAN, PANONGAN, TANGERANG, BANTEN",46,54,165,219
https://kawalpemilu.org#52503,"BABAKAN, LEGOK, TANGERANG, BANTEN",1,111,128,239
https://kawalpemilu.org#52503,"BABAKAN, LEGOK, TANGERANG, BANTEN",2,89,164,253
https://kawalpemilu.org#52503,"BABAKAN, LEGOK, TANGERANG, BANTEN",3,65,188,253
https://kawalpemilu.org#52503,"BABAKAN, LEGOK, TANGERANG, BANTEN",4,109,129,238
https://kawalpemilu.org#52503,"BABAKAN, LEGOK, TANGERANG, BANTEN",5,106,128,234
https://kawalpemilu.org#52503,"BABAKAN, LEGOK, TANGERANG, BANTEN",6,42,142,184
https://kawalpemilu.org#52503,"BABAKAN, LEGOK, TANGERANG, BANTEN",7,57,152,209
https://kawalpemilu.org#52503,"BABAKAN, LEGOK, TANGERANG, BANTEN",8,56,144,200
https://kawalpemilu.org#52503,"BABAKAN, LEGOK, TANGERANG, BANTEN",9,39,171,210
https://kawalpemilu.org#52503,"BABAKAN, LEGOK, TANGERANG, BANTEN",11,84,121,205
https://kawalpemilu.org#52503,"BABAKAN, LEGOK, TANGERANG, BANTEN",12,127,99,226
https://kawalpemilu.org#52503,"BABAKAN, LEGOK, TANGERANG, BANTEN",13,82,148,230
https://kawalpemilu.org#52503,"BABAKAN, LEGOK, TANGERANG, BANTEN",14,119,153,272
https://kawalpemilu.org#52503,"BABAKAN, LEGOK, TANGERANG, BANTEN",15,67,170,237
https://kawalpemilu.org#52503,"BABAKAN, LEGOK, TANGERANG, BANTEN",16,85,155,240
https://kawalpemilu.org#52503,"BABAKAN, LEGOK, TANGERANG, BANTEN",17,104,160,264
https://kawalpemilu.org#52503,"BABAKAN, LEGOK, TANGERANG, BANTEN",18,63,141,204
https://kawalpemilu.org#52503,"BABAKAN, LEGOK, TANGERANG, BANTEN",19,58,93,151
https://kawalpemilu.org#52503,"BABAKAN, LEGOK, TANGERANG, BANTEN",20,71,143,214
https://kawalpemilu.org#52503,"BABAKAN, LEGOK, TANGERANG, BANTEN",21,49,128,177
https://kawalpemilu.org#52503,"BABAKAN, LEGOK, TANGERANG, BANTEN",22,59,129,188
https://kawalpemilu.org#52503,"BABAKAN, LEGOK, TANGERANG, BANTEN",23,60,175,235
https://kawalpemilu.org#52503,"BABAKAN, LEGOK, TANGERANG, BANTEN",24,47,181,228
https://kawalpemilu.org#52503,"BABAKAN, LEGOK, TANGERANG, BANTEN",25,54,178,232
https://kawalpemilu.org#52503,"BABAKAN, LEGOK, TANGERANG, BANTEN",26,39,166,205
https://kawalpemilu.org#52503,"BABAKAN, LEGOK, TANGERANG, BANTEN",27,72,193,265
https://kawalpemilu.org#52503,"BABAKAN, LEGOK, TANGERANG, BANTEN",28,87,72,159
https://kawalpemilu.org#52503,"BABAKAN, LEGOK, TANGERANG, BANTEN",29,75,115,190
https://kawalpemilu.org#52503,"BABAKAN, LEGOK, TANGERANG, BANTEN",30,91,101,192
https://kawalpemilu.org#52503,"BABAKAN, LEGOK, TANGERANG, BANTEN",31,98,111,209
https://kawalpemilu.org#52503,"BABAKAN, LEGOK, TANGERANG, BANTEN",32,66,95,161
https://kawalpemilu.org#52503,"BABAKAN, LEGOK, TANGERANG, BANTEN",33,90,116,206
https://kawalpemilu.org#52504,"CARINGIN, LEGOK, TANGERANG, BANTEN",1,73,170,243
https://kawalpemilu.org#52504,"CARINGIN, LEGOK, TANGERANG, BANTEN",2,77,120,197
https://kawalpemilu.org#52504,"CARINGIN, LEGOK, TANGERANG, BANTEN",3,71,114,185
https://kawalpemilu.org#52504,"CARINGIN, LEGOK, TANGERANG, BANTEN",4,81,139,220
https://kawalpemilu.org#52504,"CARINGIN, LEGOK, TANGERANG, BANTEN",5,100,102,203
https://kawalpemilu.org#52504,"CARINGIN, LEGOK, TANGERANG, BANTEN",6,87,163,250
https://kawalpemilu.org#52504,"CARINGIN, LEGOK, TANGERANG, BANTEN",7,57,109,166
https://kawalpemilu.org#52504,"CARINGIN, LEGOK, TANGERANG, BANTEN",8,92,105,197
https://kawalpemilu.org#52504,"CARINGIN, LEGOK, TANGERANG, BANTEN",9,93,114,207
https://kawalpemilu.org#52504,"CARINGIN, LEGOK, TANGERANG, BANTEN",10,149,126,275
https://kawalpemilu.org#52504,"CARINGIN, LEGOK, TANGERANG, BANTEN",11,113,116,229
https://kawalpemilu.org#52504,"CARINGIN, LEGOK, TANGERANG, BANTEN",12,116,103,219
https://kawalpemilu.org#52504,"CARINGIN, LEGOK, TANGERANG, BANTEN",13,134,164,298
https://kawalpemilu.org#52504,"CARINGIN, LEGOK, TANGERANG, BANTEN",14,73,130,203
https://kawalpemilu.org#52504,"CARINGIN, LEGOK, TANGERANG, BANTEN",15,81,128,209
https://kawalpemilu.org#52504,"CARINGIN, LEGOK, TANGERANG, BANTEN",16,70,98,168
https://kawalpemilu.org#52504,"CARINGIN, LEGOK, TANGERANG, BANTEN",17,82,104,186
https://kawalpemilu.org#52504,"CARINGIN, LEGOK, TANGERANG, BANTEN",18,62,118,180
https://kawalpemilu.org#52504,"CARINGIN, LEGOK, TANGERANG, BANTEN",19,63,130,193
https://kawalpemilu.org#52504,"CARINGIN, LEGOK, TANGERANG, BANTEN",20,61,85,146
https://kawalpemilu.org#52504,"CARINGIN, LEGOK, TANGERANG, BANTEN",21,90,77,167
https://kawalpemilu.org#52504,"CARINGIN, LEGOK, TANGERANG, BANTEN",22,70,122,192
https://kawalpemilu.org#52504,"CARINGIN, LEGOK, TANGERANG, BANTEN",23,127,108,235
https://kawalpemilu.org#52504,"CARINGIN, LEGOK, TANGERANG, BANTEN",24,61,91,152
https://kawalpemilu.org#52504,"CARINGIN, LEGOK, TANGERANG, BANTEN",25,82,103,185
https://kawalpemilu.org#52504,"CARINGIN, LEGOK, TANGERANG, BANTEN",26,99,107,206
https://kawalpemilu.org#52504,"CARINGIN, LEGOK, TANGERANG, BANTEN",27,152,131,283
https://kawalpemilu.org#52505,"SERDANG WETAN, LEGOK, TANGERANG, BANTEN",1,67,114,181
https://kawalpemilu.org#52505,"SERDANG WETAN, LEGOK, TANGERANG, BANTEN",2,46,148,194
https://kawalpemilu.org#52505,"SERDANG WETAN, LEGOK, TANGERANG, BANTEN",5,35,62,97
https://kawalpemilu.org#52505,"SERDANG WETAN, LEGOK, TANGERANG, BANTEN",6,40,74,114
https://kawalpemilu.org#52505,"SERDANG WETAN, LEGOK, TANGERANG, BANTEN",7,38,65,103
https://kawalpemilu.org#52505,"SERDANG WETAN, LEGOK, TANGERANG, BANTEN",8,64,86,150
https://kawalpemilu.org#52505,"SERDANG WETAN, LEGOK, TANGERANG, BANTEN",9,34,116,150
https://kawalpemilu.org#52505,"SERDANG WETAN, LEGOK, TANGERANG, BANTEN",10,52,128,180
https://kawalpemilu.org#52505,"SERDANG WETAN, LEGOK, TANGERANG, BANTEN",11,73,143,216
https://kawalpemilu.org#52505,"SERDANG WETAN, LEGOK, TANGERANG, BANTEN",12,68,104,172
https://kawalpemilu.org#52505,"SERDANG WETAN, LEGOK, TANGERANG, BANTEN",14,100,150,250
https://kawalpemilu.org#52505,"SERDANG WETAN, LEGOK, TANGERANG, BANTEN",16,76,84,160
https://kawalpemilu.org#52505,"SERDANG WETAN, LEGOK, TANGERANG, BANTEN",17,64,110,174
https://kawalpemilu.org#52505,"SERDANG WETAN, LEGOK, TANGERANG, BANTEN",18,47,121,168
https://kawalpemilu.org#52505,"SERDANG WETAN, LEGOK, TANGERANG, BANTEN",19,59,125,184
https://kawalpemilu.org#52505,"SERDANG WETAN, LEGOK, TANGERANG, BANTEN",20,62,52,114
https://kawalpemilu.org#52505,"SERDANG WETAN, LEGOK, TANGERANG, BANTEN",21,37,123,160
https://kawalpemilu.org#52505,"SERDANG WETAN, LEGOK, TANGERANG, BANTEN",22,44,119,163
https://kawalpemilu.org#52505,"SERDANG WETAN, LEGOK, TANGERANG, BANTEN",23,62,143,205
https://kawalpemilu.org#52505,"SERDANG WETAN, LEGOK, TANGERANG, BANTEN",24,56,144,200
https://kawalpemilu.org#52505,"SERDANG WETAN, LEGOK, TANGERANG, BANTEN",25,59,145,204
https://kawalpemilu.org#52505,"SERDANG WETAN, LEGOK, TANGERANG, BANTEN",27,60,163,223
https://kawalpemilu.org#52505,"SERDANG WETAN, LEGOK, TANGERANG, BANTEN",28,0,0,0
https://kawalpemilu.org#52505,"SERDANG WETAN, LEGOK, TANGERANG, BANTEN",29,47,103,150
https://kawalpemilu.org#52505,"SERDANG WETAN, LEGOK, TANGERANG, BANTEN",30,33,110,143
https://kawalpemilu.org#52505,"SERDANG WETAN, LEGOK, TANGERANG, BANTEN",32,66,100,166
https://kawalpemilu.org#52505,"SERDANG WETAN, LEGOK, TANGERANG, BANTEN",33,62,142,204
https://kawalpemilu.org#52505,"SERDANG WETAN, LEGOK, TANGERANG, BANTEN",34,47,129,176
https://kawalpemilu.org#52505,"SERDANG WETAN, LEGOK, TANGERANG, BANTEN",35,46,114,160
https://kawalpemilu.org#52505,"SERDANG WETAN, LEGOK, TANGERANG, BANTEN",36,40,120,160
https://kawalpemilu.org#52505,"SERDANG WETAN, LEGOK, TANGERANG, BANTEN",37,36,114,150
https://kawalpemilu.org#52505,"SERDANG WETAN, LEGOK, TANGERANG, BANTEN",40,100,146,246
https://kawalpemilu.org#52505,"SERDANG WETAN, LEGOK, TANGERANG, BANTEN",41,0,0,0
https://kawalpemilu.org#52505,"SERDANG WETAN, LEGOK, TANGERANG, BANTEN",42,86,99,185
https://kawalpemilu.org#52505,"SERDANG WETAN, LEGOK, TANGERANG, BANTEN",43,105,94,199
https://kawalpemilu.org#52505,"SERDANG WETAN, LEGOK, TANGERANG, BANTEN",44,94,136,230
https://kawalpemilu.org#52505,"SERDANG WETAN, LEGOK, TANGERANG, BANTEN",45,35,39,74
https://kawalpemilu.org#52505,"SERDANG WETAN, LEGOK, TANGERANG, BANTEN",46,26,43,69
https://kawalpemilu.org#52505,"SERDANG WETAN, LEGOK, TANGERANG, BANTEN",47,48,70,118
https://kawalpemilu.org#52506,"BABAT, LEGOK, TANGERANG, BANTEN",1,208,18,226
https://kawalpemilu.org#52506,"BABAT, LEGOK, TANGERANG, BANTEN",2,60,180,240
https://kawalpemilu.org#52506,"BABAT, LEGOK, TANGERANG, BANTEN",3,31,144,175
https://kawalpemilu.org#52506,"BABAT, LEGOK, TANGERANG, BANTEN",4,21,140,161
https://kawalpemilu.org#52506,"BABAT, LEGOK, TANGERANG, BANTEN",5,27,118,145
https://kawalpemilu.org#52506,"BABAT, LEGOK, TANGERANG, BANTEN",6,41,219,260
https://kawalpemilu.org#52506,"BABAT, LEGOK, TANGERANG, BANTEN",7,42,188,230
https://kawalpemilu.org#52506,"BABAT, LEGOK, TANGERANG, BANTEN",8,33,181,214
https://kawalpemilu.org#52506,"BABAT, LEGOK, TANGERANG, BANTEN",9,31,170,201
https://kawalpemilu.org#52506,"BABAT, LEGOK, TANGERANG, BANTEN",10,25,121,146
https://kawalpemilu.org#52506,"BABAT, LEGOK, TANGERANG, BANTEN",11,33,149,182
https://kawalpemilu.org#52506,"BABAT, LEGOK, TANGERANG, BANTEN",12,57,154,211
https://kawalpemilu.org#52506,"BABAT, LEGOK, TANGERANG, BANTEN",14,53,140,193
https://kawalpemilu.org#52506,"BABAT, LEGOK, TANGERANG, BANTEN",15,172,62,234
https://kawalpemilu.org#52506,"BABAT, LEGOK, TANGERANG, BANTEN",16,149,110,259
https://kawalpemilu.org#52506,"BABAT, LEGOK, TANGERANG, BANTEN",17,52,112,164
https://kawalpemilu.org#52506,"BABAT, LEGOK, TANGERANG, BANTEN",18,100,118,218
https://kawalpemilu.org#52506,"BABAT, LEGOK, TANGERANG, BANTEN",19,57,155,212
https://kawalpemilu.org#52506,"BABAT, LEGOK, TANGERANG, BANTEN",20,57,145,202
https://kawalpemilu.org#52507,"CIANGIR, LEGOK, TANGERANG, BANTEN",1,62,95,157
https://kawalpemilu.org#52507,"CIANGIR, LEGOK, TANGERANG, BANTEN",2,66,163,229
https://kawalpemilu.org#52507,"CIANGIR, LEGOK, TANGERANG, BANTEN",3,59,154,213
https://kawalpemilu.org#52507,"CIANGIR, LEGOK, TANGERANG, BANTEN",5,34,143,177
https://kawalpemilu.org#52507,"CIANGIR, LEGOK, TANGERANG, BANTEN",8,69,104,173
https://kawalpemilu.org#52507,"CIANGIR, LEGOK, TANGERANG, BANTEN",9,33,182,215
https://kawalpemilu.org#52507,"CIANGIR, LEGOK, TANGERANG, BANTEN",10,87,143,230
https://kawalpemilu.org#52507,"CIANGIR, LEGOK, TANGERANG, BANTEN",13,61,149,210
https://kawalpemilu.org#52507,"CIANGIR, LEGOK, TANGERANG, BANTEN",14,52,121,173
https://kawalpemilu.org#52507,"CIANGIR, LEGOK, TANGERANG, BANTEN",16,34,147,181
https://kawalpemilu.org#52507,"CIANGIR, LEGOK, TANGERANG, BANTEN",17,76,67,143
https://kawalpemilu.org#52507,"CIANGIR, LEGOK, TANGERANG, BANTEN",18,84,127,211
https://kawalpemilu.org#52507,"CIANGIR, LEGOK, TANGERANG, BANTEN",19,42,175,217
https://kawalpemilu.org#52508,"LEGOK, LEGOK, TANGERANG, BANTEN",1,63,160,223
https://kawalpemilu.org#52508,"LEGOK, LEGOK, TANGERANG, BANTEN",2,37,149,186
https://kawalpemilu.org#52508,"LEGOK, LEGOK, TANGERANG, BANTEN",3,45,142,187
https://kawalpemilu.org#52508,"LEGOK, LEGOK, TANGERANG, BANTEN",4,50,148,198
https://kawalpemilu.org#52508,"LEGOK, LEGOK, TANGERANG, BANTEN",5,40,158,198
https://kawalpemilu.org#52508,"LEGOK, LEGOK, TANGERANG, BANTEN",6,56,141,197
https://kawalpemilu.org#52508,"LEGOK, LEGOK, TANGERANG, BANTEN",7,54,173,227
https://kawalpemilu.org#52508,"LEGOK, LEGOK, TANGERANG, BANTEN",8,47,169,216
https://kawalpemilu.org#52508,"LEGOK, LEGOK, TANGERANG, BANTEN",9,43,186,229
https://kawalpemilu.org#52508,"LEGOK, LEGOK, TANGERANG, BANTEN",10,70,150,220
https://kawalpemilu.org#52508,"LEGOK, LEGOK, TANGERANG, BANTEN",11,38,103,141
https://kawalpemilu.org#52508,"LEGOK, LEGOK, TANGERANG, BANTEN",12,38,135,173
https://kawalpemilu.org#52508,"LEGOK, LEGOK, TANGERANG, BANTEN",13,30,111,141
https://kawalpemilu.org#52508,"LEGOK, LEGOK, TANGERANG, BANTEN",14,41,137,178
https://kawalpemilu.org#52508,"LEGOK, LEGOK, TANGERANG, BANTEN",15,50,143,193
https://kawalpemilu.org#52508,"LEGOK, LEGOK, TANGERANG, BANTEN",16,37,128,165
https://kawalpemilu.org#52508,"LEGOK, LEGOK, TANGERANG, BANTEN",17,45,96,141
https://kawalpemilu.org#52508,"LEGOK, LEGOK, TANGERANG, BANTEN",18,27,106,133
https://kawalpemilu.org#52508,"LEGOK, LEGOK, TANGERANG, BANTEN",19,31,116,147
https://kawalpemilu.org#52508,"LEGOK, LEGOK, TANGERANG, BANTEN",20,53,137,190
https://kawalpemilu.org#52508,"LEGOK, LEGOK, TANGERANG, BANTEN",21,64,100,164
https://kawalpemilu.org#52508,"LEGOK, LEGOK, TANGERANG, BANTEN",22,72,107,179
https://kawalpemilu.org#52508,"LEGOK, LEGOK, TANGERANG, BANTEN",23,61,135,196
https://kawalpemilu.org#52508,"LEGOK, LEGOK, TANGERANG, BANTEN",24,49,159,208
https://kawalpemilu.org#52508,"LEGOK, LEGOK, TANGERANG, BANTEN",25,46,153,199
https://kawalpemilu.org#52508,"LEGOK, LEGOK, TANGERANG, BANTEN",26,81,100,181
https://kawalpemilu.org#52508,"LEGOK, LEGOK, TANGERANG, BANTEN",27,82,114,196
https://kawalpemilu.org#52508,"LEGOK, LEGOK, TANGERANG, BANTEN",28,134,93,227
https://kawalpemilu.org#52508,"LEGOK, LEGOK, TANGERANG, BANTEN",29,116,89,205
https://kawalpemilu.org#52508,"LEGOK, LEGOK, TANGERANG, BANTEN",31,102,147,249
https://kawalpemilu.org#52508,"LEGOK, LEGOK, TANGERANG, BANTEN",32,122,115,237
https://kawalpemilu.org#52508,"LEGOK, LEGOK, TANGERANG, BANTEN",33,126,121,247
https://kawalpemilu.org#52508,"LEGOK, LEGOK, TANGERANG, BANTEN",34,127,162,289
https://kawalpemilu.org#52508,"LEGOK, LEGOK, TANGERANG, BANTEN",35,125,138,263
https://kawalpemilu.org#52508,"LEGOK, LEGOK, TANGERANG, BANTEN",36,200,81,281
https://kawalpemilu.org#52509,"PALASARI, LEGOK, TANGERANG, BANTEN",1,77,157,234
https://kawalpemilu.org#52509,"PALASARI, LEGOK, TANGERANG, BANTEN",2,50,172,222
https://kawalpemilu.org#52509,"PALASARI, LEGOK, TANGERANG, BANTEN",3,89,132,221
https://kawalpemilu.org#52509,"PALASARI, LEGOK, TANGERANG, BANTEN",4,38,82,120
https://kawalpemilu.org#52509,"PALASARI, LEGOK, TANGERANG, BANTEN",5,96,158,254
https://kawalpemilu.org#52509,"PALASARI, LEGOK, TANGERANG, BANTEN",6,93,101,194
https://kawalpemilu.org#52509,"PALASARI, LEGOK, TANGERANG, BANTEN",7,69,105,174
https://kawalpemilu.org#52509,"PALASARI, LEGOK, TANGERANG, BANTEN",8,56,107,163
https://kawalpemilu.org#52509,"PALASARI, LEGOK, TANGERANG, BANTEN",9,103,131,234
https://kawalpemilu.org#52509,"PALASARI, LEGOK, TANGERANG, BANTEN",10,99,105,204
https://kawalpemilu.org#52509,"PALASARI, LEGOK, TANGERANG, BANTEN",11,125,132,257
https://kawalpemilu.org#52509,"PALASARI, LEGOK, TANGERANG, BANTEN",12,108,155,263
https://kawalpemilu.org#52509,"PALASARI, LEGOK, TANGERANG, BANTEN",13,37,156,193
https://kawalpemilu.org#52509,"PALASARI, LEGOK, TANGERANG, BANTEN",14,47,156,203
https://kawalpemilu.org#52509,"PALASARI, LEGOK, TANGERANG, BANTEN",15,64,134,198
https://kawalpemilu.org#52509,"PALASARI, LEGOK, TANGERANG, BANTEN",16,72,145,217
https://kawalpemilu.org#52509,"PALASARI, LEGOK, TANGERANG, BANTEN",17,64,144,208
https://kawalpemilu.org#52509,"PALASARI, LEGOK, TANGERANG, BANTEN",18,78,131,209
https://kawalpemilu.org#52509,"PALASARI, LEGOK, TANGERANG, BANTEN",19,72,145,217
https://kawalpemilu.org#52509,"PALASARI, LEGOK, TANGERANG, BANTEN",20,50,129,179
https://kawalpemilu.org#52509,"PALASARI, LEGOK, TANGERANG, BANTEN",21,46,136,182
https://kawalpemilu.org#52509,"PALASARI, LEGOK, TANGERANG, BANTEN",22,96,99,195
https://kawalpemilu.org#52509,"PALASARI, LEGOK, TANGERANG, BANTEN",23,39,145,0
https://kawalpemilu.org#52509,"PALASARI, LEGOK, TANGERANG, BANTEN",24,26,164,190
https://kawalpemilu.org#52509,"PALASARI, LEGOK, TANGERANG, BANTEN",25,48,167,215
https://kawalpemilu.org#52509,"PALASARI, LEGOK, TANGERANG, BANTEN",26,36,159,195
https://kawalpemilu.org#52509,"PALASARI, LEGOK, TANGERANG, BANTEN",27,54,160,214
https://kawalpemilu.org#52509,"PALASARI, LEGOK, TANGERANG, BANTEN",28,28,165,193
https://kawalpemilu.org#52509,"PALASARI, LEGOK, TANGERANG, BANTEN",29,39,158,197
https://kawalpemilu.org#52509,"PALASARI, LEGOK, TANGERANG, BANTEN",30,82,124,206
https://kawalpemilu.org#52509,"PALASARI, LEGOK, TANGERANG, BANTEN",31,103,129,232
https://kawalpemilu.org#52509,"PALASARI, LEGOK, TANGERANG, BANTEN",32,109,123,232
https://kawalpemilu.org#52509,"PALASARI, LEGOK, TANGERANG, BANTEN",33,133,103,236
https://kawalpemilu.org#52510,"BOJONGKAMAL, LEGOK, TANGERANG, BANTEN",1,44,143,187
https://kawalpemilu.org#52510,"BOJONGKAMAL, LEGOK, TANGERANG, BANTEN",2,62,125,187
https://kawalpemilu.org#52510,"BOJONGKAMAL, LEGOK, TANGERANG, BANTEN",3,60,162,222
https://kawalpemilu.org#52510,"BOJONGKAMAL, LEGOK, TANGERANG, BANTEN",4,57,162,219
https://kawalpemilu.org#52510,"BOJONGKAMAL, LEGOK, TANGERANG, BANTEN",6,58,125,183
https://kawalpemilu.org#52510,"BOJONGKAMAL, LEGOK, TANGERANG, BANTEN",7,131,105,236
https://kawalpemilu.org#52510,"BOJONGKAMAL, LEGOK, TANGERANG, BANTEN",8,75,190,265
https://kawalpemilu.org#52510,"BOJONGKAMAL, LEGOK, TANGERANG, BANTEN",9,44,161,205
https://kawalpemilu.org#52510,"BOJONGKAMAL, LEGOK, TANGERANG, BANTEN",10,56,131,187
https://kawalpemilu.org#52510,"BOJONGKAMAL, LEGOK, TANGERANG, BANTEN",11,56,142,198
https://kawalpemilu.org#52510,"BOJONGKAMAL, LEGOK, TANGERANG, BANTEN",12,141,113,254
https://kawalpemilu.org#52510,"BOJONGKAMAL, LEGOK, TANGERANG, BANTEN",13,141,90,231
https://kawalpemilu.org#52510,"BOJONGKAMAL, LEGOK, TANGERANG, BANTEN",14,101,129,230
https://kawalpemilu.org#52510,"BOJONGKAMAL, LEGOK, TANGERANG, BANTEN",15,77,143,220
https://kawalpemilu.org#52510,"BOJONGKAMAL, LEGOK, TANGERANG, BANTEN",16,38,137,175
https://kawalpemilu.org#52510,"BOJONGKAMAL, LEGOK, TANGERANG, BANTEN",18,39,128,167
https://kawalpemilu.org#52511,"RANCAGONG, LEGOK, TANGERANG, BANTEN",1,51,141,192
https://kawalpemilu.org#52511,"RANCAGONG, LEGOK, TANGERANG, BANTEN",2,55,135,190
https://kawalpemilu.org#52511,"RANCAGONG, LEGOK, TANGERANG, BANTEN",3,45,127,172
https://kawalpemilu.org#52511,"RANCAGONG, LEGOK, TANGERANG, BANTEN",4,51,109,160
https://kawalpemilu.org#52511,"RANCAGONG, LEGOK, TANGERANG, BANTEN",5,74,150,224
https://kawalpemilu.org#52511,"RANCAGONG, LEGOK, TANGERANG, BANTEN",6,56,155,211
https://kawalpemilu.org#52511,"RANCAGONG, LEGOK, TANGERANG, BANTEN",7,49,201,250
https://kawalpemilu.org#52511,"RANCAGONG, LEGOK, TANGERANG, BANTEN",8,44,194,238
https://kawalpemilu.org#52511,"RANCAGONG, LEGOK, TANGERANG, BANTEN",9,51,168,219
https://kawalpemilu.org#52511,"RANCAGONG, LEGOK, TANGERANG, BANTEN",10,50,165,215
https://kawalpemilu.org#52511,"RANCAGONG, LEGOK, TANGERANG, BANTEN",11,65,119,184
https://kawalpemilu.org#52511,"RANCAGONG, LEGOK, TANGERANG, BANTEN",12,53,132,185
https://kawalpemilu.org#52511,"RANCAGONG, LEGOK, TANGERANG, BANTEN",13,28,153,181
https://kawalpemilu.org#52511,"RANCAGONG, LEGOK, TANGERANG, BANTEN",14,28,143,171
https://kawalpemilu.org#52511,"RANCAGONG, LEGOK, TANGERANG, BANTEN",15,49,139,188
https://kawalpemilu.org#52511,"RANCAGONG, LEGOK, TANGERANG, BANTEN",16,48,134,182
https://kawalpemilu.org#52511,"RANCAGONG, LEGOK, TANGERANG, BANTEN",17,96,157,253
https://kawalpemilu.org#52511,"RANCAGONG, LEGOK, TANGERANG, BANTEN",18,98,161,259
https://kawalpemilu.org#52511,"RANCAGONG, LEGOK, TANGERANG, BANTEN",19,84,91,175
https://kawalpemilu.org#52511,"RANCAGONG, LEGOK, TANGERANG, BANTEN",20,114,66,180
https://kawalpemilu.org#52511,"RANCAGONG, LEGOK, TANGERANG, BANTEN",21,94,151,245
https://kawalpemilu.org#52511,"RANCAGONG, LEGOK, TANGERANG, BANTEN",22,97,107,204
https://kawalpemilu.org#52511,"RANCAGONG, LEGOK, TANGERANG, BANTEN",23,75,118,193
https://kawalpemilu.org#52511,"RANCAGONG, LEGOK, TANGERANG, BANTEN",24,68,101,169
https://kawalpemilu.org#52511,"RANCAGONG, LEGOK, TANGERANG, BANTEN",25,40,139,179
https://kawalpemilu.org#52511,"RANCAGONG, LEGOK, TANGERANG, BANTEN",26,43,111,154
https://kawalpemilu.org#52511,"RANCAGONG, LEGOK, TANGERANG, BANTEN",27,81,144,225
https://kawalpemilu.org#52511,"RANCAGONG, LEGOK, TANGERANG, BANTEN",28,37,106,143
https://kawalpemilu.org#52511,"RANCAGONG, LEGOK, TANGERANG, BANTEN",29,101,118,219
https://kawalpemilu.org#52511,"RANCAGONG, LEGOK, TANGERANG, BANTEN",30,79,126,205
https://kawalpemilu.org#52511,"RANCAGONG, LEGOK, TANGERANG, BANTEN",31,90,143,233
https://kawalpemilu.org#52511,"RANCAGONG, LEGOK, TANGERANG, BANTEN",32,102,160,262
https://kawalpemilu.org#52511,"RANCAGONG, LEGOK, TANGERANG, BANTEN",33,108,116,224
https://kawalpemilu.org#52511,"RANCAGONG, LEGOK, TANGERANG, BANTEN",34,53,126,179
https://kawalpemilu.org#52511,"RANCAGONG, LEGOK, TANGERANG, BANTEN",35,53,147,200
https://kawalpemilu.org#52511,"RANCAGONG, LEGOK, TANGERANG, BANTEN",36,50,118,168
https://kawalpemilu.org#52511,"RANCAGONG, LEGOK, TANGERANG, BANTEN",37,63,132,195
https://kawalpemilu.org#52511,"RANCAGONG, LEGOK, TANGERANG, BANTEN",38,58,154,212
https://kawalpemilu.org#52511,"RANCAGONG, LEGOK, TANGERANG, BANTEN",39,55,144,199
https://kawalpemilu.org#52511,"RANCAGONG, LEGOK, TANGERANG, BANTEN",40,71,75,146
https://kawalpemilu.org#52511,"RANCAGONG, LEGOK, TANGERANG, BANTEN",41,73,57,130
https://kawalpemilu.org#52512,"KEMUNING, LEGOK, TANGERANG, BANTEN",1,68,91,159
https://kawalpemilu.org#52512,"KEMUNING, LEGOK, TANGERANG, BANTEN",2,91,89,180
https://kawalpemilu.org#52512,"KEMUNING, LEGOK, TANGERANG, BANTEN",3,56,89,145
https://kawalpemilu.org#52512,"KEMUNING, LEGOK, TANGERANG, BANTEN",4,52,70,122
https://kawalpemilu.org#52512,"KEMUNING, LEGOK, TANGERANG, BANTEN",5,64,115,179
https://kawalpemilu.org#52512,"KEMUNING, LEGOK, TANGERANG, BANTEN",6,56,119,175
https://kawalpemilu.org#52512,"KEMUNING, LEGOK, TANGERANG, BANTEN",7,82,121,103
https://kawalpemilu.org#52512,"KEMUNING, LEGOK, TANGERANG, BANTEN",8,70,152,222
https://kawalpemilu.org#52512,"KEMUNING, LEGOK, TANGERANG, BANTEN",9,75,144,219
https://kawalpemilu.org#52512,"KEMUNING, LEGOK, TANGERANG, BANTEN",10,73,131,204
https://kawalpemilu.org#52512,"KEMUNING, LEGOK, TANGERANG, BANTEN",11,83,78,161
https://kawalpemilu.org#52512,"KEMUNING, LEGOK, TANGERANG, BANTEN",12,82,123,205
https://kawalpemilu.org#52512,"KEMUNING, LEGOK, TANGERANG, BANTEN",13,74,129,203
https://kawalpemilu.org#52512,"KEMUNING, LEGOK, TANGERANG, BANTEN",14,63,160,223
https://kawalpemilu.org#52512,"KEMUNING, LEGOK, TANGERANG, BANTEN",15,75,155,230
https://kawalpemilu.org#52512,"KEMUNING, LEGOK, TANGERANG, BANTEN",16,61,160,221
https://kawalpemilu.org#52512,"KEMUNING, LEGOK, TANGERANG, BANTEN",17,90,152,242
https://kawalpemilu.org#52512,"KEMUNING, LEGOK, TANGERANG, BANTEN",18,105,131,236
https://kawalpemilu.org#52512,"KEMUNING, LEGOK, TANGERANG, BANTEN",19,56,123,179
https://kawalpemilu.org#52512,"KEMUNING, LEGOK, TANGERANG, BANTEN",20,65,133,198
https://kawalpemilu.org#52512,"KEMUNING, LEGOK, TANGERANG, BANTEN",21,68,162,230
https://kawalpemilu.org#52512,"KEMUNING, LEGOK, TANGERANG, BANTEN",22,96,138,234
https://kawalpemilu.org#52513,"CIRARAB, LEGOK, TANGERANG, BANTEN",1,86,147,233
https://kawalpemilu.org#52513,"CIRARAB, LEGOK, TANGERANG, BANTEN",2,85,155,240
https://kawalpemilu.org#52513,"CIRARAB, LEGOK, TANGERANG, BANTEN",3,89,146,235
https://kawalpemilu.org#52513,"CIRARAB, LEGOK, TANGERANG, BANTEN",4,76,113,189
https://kawalpemilu.org#52513,"CIRARAB, LEGOK, TANGERANG, BANTEN",5,91,111,202
https://kawalpemilu.org#52513,"CIRARAB, LEGOK, TANGERANG, BANTEN",6,84,74,158
https://kawalpemilu.org#52513,"CIRARAB, LEGOK, TANGERANG, BANTEN",8,0,0,0
https://kawalpemilu.org#52513,"CIRARAB, LEGOK, TANGERANG, BANTEN",9,69,124,193
https://kawalpemilu.org#52513,"CIRARAB, LEGOK, TANGERANG, BANTEN",10,66,156,222
https://kawalpemilu.org#52513,"CIRARAB, LEGOK, TANGERANG, BANTEN",11,72,135,207
https://kawalpemilu.org#52513,"CIRARAB, LEGOK, TANGERANG, BANTEN",12,84,138,222
https://kawalpemilu.org#52513,"CIRARAB, LEGOK, TANGERANG, BANTEN",13,89,139,228
https://kawalpemilu.org#52513,"CIRARAB, LEGOK, TANGERANG, BANTEN",14,72,105,177
https://kawalpemilu.org#52513,"CIRARAB, LEGOK, TANGERANG, BANTEN",15,84,132,216
https://kawalpemilu.org#52513,"CIRARAB, LEGOK, TANGERANG, BANTEN",16,86,70,156
https://kawalpemilu.org#52513,"CIRARAB, LEGOK, TANGERANG, BANTEN",17,67,118,185
https://kawalpemilu.org#52513,"CIRARAB, LEGOK, TANGERANG, BANTEN",18,150,120,270
https://kawalpemilu.org#52513,"CIRARAB, LEGOK, TANGERANG, BANTEN",19,67,118,185
https://kawalpemilu.org#52515,"MEDANG, PAGEDANGAN, TANGERANG, BANTEN",1,102,141,243
https://kawalpemilu.org#52515,"MEDANG, PAGEDANGAN, TANGERANG, BANTEN",2,93,137,230
https://kawalpemilu.org#52515,"MEDANG, PAGEDANGAN, TANGERANG, BANTEN",3,79,161,240
https://kawalpemilu.org#52515,"MEDANG, PAGEDANGAN, TANGERANG, BANTEN",4,72,115,187
https://kawalpemilu.org#52515,"MEDANG, PAGEDANGAN, TANGERANG, BANTEN",5,37,198,235
https://kawalpemilu.org#52515,"MEDANG, PAGEDANGAN, TANGERANG, BANTEN",6,29,184,219
https://kawalpemilu.org#52515,"MEDANG, PAGEDANGAN, TANGERANG, BANTEN",7,64,165,229
https://kawalpemilu.org#52515,"MEDANG, PAGEDANGAN, TANGERANG, BANTEN",8,74,173,247
https://kawalpemilu.org#52515,"MEDANG, PAGEDANGAN, TANGERANG, BANTEN",9,73,180,253
https://kawalpemilu.org#52515,"MEDANG, PAGEDANGAN, TANGERANG, BANTEN",10,87,168,255
https://kawalpemilu.org#52515,"MEDANG, PAGEDANGAN, TANGERANG, BANTEN",11,129,116,245
https://kawalpemilu.org#52515,"MEDANG, PAGEDANGAN, TANGERANG, BANTEN",12,193,56,249
https://kawalpemilu.org#52515,"MEDANG, PAGEDANGAN, TANGERANG, BANTEN",13,127,87,214
https://kawalpemilu.org#52515,"MEDANG, PAGEDANGAN, TANGERANG, BANTEN",14,119,129,248
https://kawalpemilu.org#52515,"MEDANG, PAGEDANGAN, TANGERANG, BANTEN",15,99,119,218
https://kawalpemilu.org#52515,"MEDANG, PAGEDANGAN, TANGERANG, BANTEN",16,133,77,210
https://kawalpemilu.org#52515,"MEDANG, PAGEDANGAN, TANGERANG, BANTEN",17,131,93,224
https://kawalpemilu.org#52515,"MEDANG, PAGEDANGAN, TANGERANG, BANTEN",18,89,123,212
https://kawalpemilu.org#52515,"MEDANG, PAGEDANGAN, TANGERANG, BANTEN",19,165,105,270
https://kawalpemilu.org#52515,"MEDANG, PAGEDANGAN, TANGERANG, BANTEN",20,222,72,294
https://kawalpemilu.org#52515,"MEDANG, PAGEDANGAN, TANGERANG, BANTEN",21,147,91,238
https://kawalpemilu.org#52515,"MEDANG, PAGEDANGAN, TANGERANG, BANTEN",22,154,109,263
https://kawalpemilu.org#52515,"MEDANG, PAGEDANGAN, TANGERANG, BANTEN",23,101,134,235
https://kawalpemilu.org#52515,"MEDANG, PAGEDANGAN, TANGERANG, BANTEN",24,70,125,195
https://kawalpemilu.org#52515,"MEDANG, PAGEDANGAN, TANGERANG, BANTEN",25,68,155,223
https://kawalpemilu.org#52515,"MEDANG, PAGEDANGAN, TANGERANG, BANTEN",26,46,117,163
https://kawalpemilu.org#52515,"MEDANG, PAGEDANGAN, TANGERANG, BANTEN",27,93,66,159
https://kawalpemilu.org#52515,"MEDANG, PAGEDANGAN, TANGERANG, BANTEN",28,67,151,218
https://kawalpemilu.org#52515,"MEDANG, PAGEDANGAN, TANGERANG, BANTEN",29,67,183,250
https://kawalpemilu.org#52515,"MEDANG, PAGEDANGAN, TANGERANG, BANTEN",30,82,164,246
https://kawalpemilu.org#52515,"MEDANG, PAGEDANGAN, TANGERANG, BANTEN",31,89,158,247
https://kawalpemilu.org#52515,"MEDANG, PAGEDANGAN, TANGERANG, BANTEN",32,155,111,266
https://kawalpemilu.org#52515,"MEDANG, PAGEDANGAN, TANGERANG, BANTEN",33,109,140,249
https://kawalpemilu.org#52515,"MEDANG, PAGEDANGAN, TANGERANG, BANTEN",34,88,156,244
https://kawalpemilu.org#52515,"MEDANG, PAGEDANGAN, TANGERANG, BANTEN",35,130,91,221
https://kawalpemilu.org#52515,"MEDANG, PAGEDANGAN, TANGERANG, BANTEN",36,104,118,222
https://kawalpemilu.org#52515,"MEDANG, PAGEDANGAN, TANGERANG, BANTEN",37,76,134,210
https://kawalpemilu.org#52515,"MEDANG, PAGEDANGAN, TANGERANG, BANTEN",38,118,84,202
https://kawalpemilu.org#52515,"MEDANG, PAGEDANGAN, TANGERANG, BANTEN",39,119,145,264
https://kawalpemilu.org#52515,"MEDANG, PAGEDANGAN, TANGERANG, BANTEN",40,153,104,257
https://kawalpemilu.org#52515,"MEDANG, PAGEDANGAN, TANGERANG, BANTEN",41,99,135,234
https://kawalpemilu.org#52515,"MEDANG, PAGEDANGAN, TANGERANG, BANTEN",42,103,80,183
https://kawalpemilu.org#52515,"MEDANG, PAGEDANGAN, TANGERANG, BANTEN",43,159,99,258
https://kawalpemilu.org#52515,"MEDANG, PAGEDANGAN, TANGERANG, BANTEN",44,132,107,239
https://kawalpemilu.org#52515,"MEDANG, PAGEDANGAN, TANGERANG, BANTEN",45,181,107,288
https://kawalpemilu.org#52515,"MEDANG, PAGEDANGAN, TANGERANG, BANTEN",46,226,42,268
https://kawalpemilu.org#52515,"MEDANG, PAGEDANGAN, TANGERANG, BANTEN",47,94,128,222
https://kawalpemilu.org#52515,"MEDANG, PAGEDANGAN, TANGERANG, BANTEN",48,127,87,214
https://kawalpemilu.org#52516,"CICALENGKA, PAGEDANGAN, TANGERANG, BANTEN",1,39,111,150
https://kawalpemilu.org#52516,"CICALENGKA, PAGEDANGAN, TANGERANG, BANTEN",2,40,94,134
https://kawalpemilu.org#52516,"CICALENGKA, PAGEDANGAN, TANGERANG, BANTEN",3,52,184,236
https://kawalpemilu.org#52516,"CICALENGKA, PAGEDANGAN, TANGERANG, BANTEN",4,51,212,263
https://kawalpemilu.org#52516,"CICALENGKA, PAGEDANGAN, TANGERANG, BANTEN",5,82,151,233
https://kawalpemilu.org#52516,"CICALENGKA, PAGEDANGAN, TANGERANG, BANTEN",6,61,184,245
https://kawalpemilu.org#52516,"CICALENGKA, PAGEDANGAN, TANGERANG, BANTEN",7,40,153,193
https://kawalpemilu.org#52516,"CICALENGKA, PAGEDANGAN, TANGERANG, BANTEN",8,38,190,228
https://kawalpemilu.org#52516,"CICALENGKA, PAGEDANGAN, TANGERANG, BANTEN",9,47,175,222
https://kawalpemilu.org#52516,"CICALENGKA, PAGEDANGAN, TANGERANG, BANTEN",10,43,159,202
https://kawalpemilu.org#52516,"CICALENGKA, PAGEDANGAN, TANGERANG, BANTEN",11,47,149,196
https://kawalpemilu.org#52516,"CICALENGKA, PAGEDANGAN, TANGERANG, BANTEN",12,56,146,202
https://kawalpemilu.org#52516,"CICALENGKA, PAGEDANGAN, TANGERANG, BANTEN",13,0,0,0
https://kawalpemilu.org#52516,"CICALENGKA, PAGEDANGAN, TANGERANG, BANTEN",14,33,214,247
https://kawalpemilu.org#52516,"CICALENGKA, PAGEDANGAN, TANGERANG, BANTEN",15,107,158,264
https://kawalpemilu.org#52516,"CICALENGKA, PAGEDANGAN, TANGERANG, BANTEN",16,42,122,164
https://kawalpemilu.org#52516,"CICALENGKA, PAGEDANGAN, TANGERANG, BANTEN",17,25,163,188
https://kawalpemilu.org#52516,"CICALENGKA, PAGEDANGAN, TANGERANG, BANTEN",18,48,133,181
https://kawalpemilu.org#52516,"CICALENGKA, PAGEDANGAN, TANGERANG, BANTEN",19,69,106,175
https://kawalpemilu.org#52517,"PAGEDANGAN, PAGEDANGAN, TANGERANG, BANTEN",1,66,135,201
https://kawalpemilu.org#52517,"PAGEDANGAN, PAGEDANGAN, TANGERANG, BANTEN",2,88,115,203
https://kawalpemilu.org#52517,"PAGEDANGAN, PAGEDANGAN, TANGERANG, BANTEN",3,79,175,254
https://kawalpemilu.org#52517,"PAGEDANGAN, PAGEDANGAN, TANGERANG, BANTEN",4,55,163,218
https://kawalpemilu.org#52517,"PAGEDANGAN, PAGEDANGAN, TANGERANG, BANTEN",5,79,137,216
https://kawalpemilu.org#52517,"PAGEDANGAN, PAGEDANGAN, TANGERANG, BANTEN",6,46,148,194
https://kawalpemilu.org#52517,"PAGEDANGAN, PAGEDANGAN, TANGERANG, BANTEN",7,67,180,247
https://kawalpemilu.org#52517,"PAGEDANGAN, PAGEDANGAN, TANGERANG, BANTEN",8,109,146,255
https://kawalpemilu.org#52517,"PAGEDANGAN, PAGEDANGAN, TANGERANG, BANTEN",9,81,126,207
https://kawalpemilu.org#52517,"PAGEDANGAN, PAGEDANGAN, TANGERANG, BANTEN",10,107,94,202
https://kawalpemilu.org#52517,"PAGEDANGAN, PAGEDANGAN, TANGERANG, BANTEN",11,68,95,163
https://kawalpemilu.org#52517,"PAGEDANGAN, PAGEDANGAN, TANGERANG, BANTEN",12,80,143,223
https://kawalpemilu.org#52517,"PAGEDANGAN, PAGEDANGAN, TANGERANG, BANTEN",13,65,81,146
https://kawalpemilu.org#52517,"PAGEDANGAN, PAGEDANGAN, TANGERANG, BANTEN",14,133,100,233
https://kawalpemilu.org#52517,"PAGEDANGAN, PAGEDANGAN, TANGERANG, BANTEN",15,64,150,214
https://kawalpemilu.org#52517,"PAGEDANGAN, PAGEDANGAN, TANGERANG, BANTEN",16,104,152,256
https://kawalpemilu.org#52517,"PAGEDANGAN, PAGEDANGAN, TANGERANG, BANTEN",17,97,154,251
https://kawalpemilu.org#52517,"PAGEDANGAN, PAGEDANGAN, TANGERANG, BANTEN",18,88,130,218
https://kawalpemilu.org#52517,"PAGEDANGAN, PAGEDANGAN, TANGERANG, BANTEN",19,91,112,203
https://kawalpemilu.org#52517,"PAGEDANGAN, PAGEDANGAN, TANGERANG, BANTEN",20,56,141,197
https://kawalpemilu.org#52517,"PAGEDANGAN, PAGEDANGAN, TANGERANG, BANTEN",22,70,126,196
https://kawalpemilu.org#52517,"PAGEDANGAN, PAGEDANGAN, TANGERANG, BANTEN",23,70,127,197
https://kawalpemilu.org#52517,"PAGEDANGAN, PAGEDANGAN, TANGERANG, BANTEN",24,113,120,233
https://kawalpemilu.org#52517,"PAGEDANGAN, PAGEDANGAN, TANGERANG, BANTEN",25,80,107,187
https://kawalpemilu.org#52517,"PAGEDANGAN, PAGEDANGAN, TANGERANG, BANTEN",26,64,124,188
https://kawalpemilu.org#52517,"PAGEDANGAN, PAGEDANGAN, TANGERANG, BANTEN",27,54,104,158
https://kawalpemilu.org#52517,"PAGEDANGAN, PAGEDANGAN, TANGERANG, BANTEN",28,102,84,186
https://kawalpemilu.org#52517,"PAGEDANGAN, PAGEDANGAN, TANGERANG, BANTEN",29,64,84,148
https://kawalpemilu.org#52517,"PAGEDANGAN, PAGEDANGAN, TANGERANG, BANTEN",30,91,92,183
https://kawalpemilu.org#52517,"PAGEDANGAN, PAGEDANGAN, TANGERANG, BANTEN",31,86,107,193
https://kawalpemilu.org#52517,"PAGEDANGAN, PAGEDANGAN, TANGERANG, BANTEN",32,42,105,147
https://kawalpemilu.org#52517,"PAGEDANGAN, PAGEDANGAN, TANGERANG, BANTEN",33,250,20,270
https://kawalpemilu.org#52517,"PAGEDANGAN, PAGEDANGAN, TANGERANG, BANTEN",34,156,9,165
https://kawalpemilu.org#52518,"CIJANTRA, PAGEDANGAN, TANGERANG, BANTEN",1,58,185,243
https://kawalpemilu.org#52518,"CIJANTRA, PAGEDANGAN, TANGERANG, BANTEN",2,60,127,187
https://kawalpemilu.org#52518,"CIJANTRA, PAGEDANGAN, TANGERANG, BANTEN",3,52,113,165
https://kawalpemilu.org#52518,"CIJANTRA, PAGEDANGAN, TANGERANG, BANTEN",4,29,151,180
https://kawalpemilu.org#52518,"CIJANTRA, PAGEDANGAN, TANGERANG, BANTEN",5,43,79,122
https://kawalpemilu.org#52518,"CIJANTRA, PAGEDANGAN, TANGERANG, BANTEN",6,9,118,127
https://kawalpemilu.org#52518,"CIJANTRA, PAGEDANGAN, TANGERANG, BANTEN",7,22,108,130
https://kawalpemilu.org#52518,"CIJANTRA, PAGEDANGAN, TANGERANG, BANTEN",8,69,123,192
https://kawalpemilu.org#52518,"CIJANTRA, PAGEDANGAN, TANGERANG, BANTEN",9,44,187,231
https://kawalpemilu.org#52518,"CIJANTRA, PAGEDANGAN, TANGERANG, BANTEN",10,110,36,146
https://kawalpemilu.org#52518,"CIJANTRA, PAGEDANGAN, TANGERANG, BANTEN",11,19,82,101
https://kawalpemilu.org#52518,"CIJANTRA, PAGEDANGAN, TANGERANG, BANTEN",12,40,180,220
https://kawalpemilu.org#52518,"CIJANTRA, PAGEDANGAN, TANGERANG, BANTEN",13,53,125,178
https://kawalpemilu.org#52518,"CIJANTRA, PAGEDANGAN, TANGERANG, BANTEN",14,52,128,180
https://kawalpemilu.org#52518,"CIJANTRA, PAGEDANGAN, TANGERANG, BANTEN",16,30,109,139
https://kawalpemilu.org#52518,"CIJANTRA, PAGEDANGAN, TANGERANG, BANTEN",17,33,121,154
https://kawalpemilu.org#52518,"CIJANTRA, PAGEDANGAN, TANGERANG, BANTEN",18,30,105,135
https://kawalpemilu.org#52518,"CIJANTRA, PAGEDANGAN, TANGERANG, BANTEN",19,68,105,173
https://kawalpemilu.org#52518,"CIJANTRA, PAGEDANGAN, TANGERANG, BANTEN",20,19,107,126
https://kawalpemilu.org#52518,"CIJANTRA, PAGEDANGAN, TANGERANG, BANTEN",21,29,150,179
https://kawalpemilu.org#52518,"CIJANTRA, PAGEDANGAN, TANGERANG, BANTEN",22,102,42,144
https://kawalpemilu.org#52518,"CIJANTRA, PAGEDANGAN, TANGERANG, BANTEN",23,24,165,189
https://kawalpemilu.org#52519,"LENGKONG KULON, PAGEDANGAN, TANGERANG, BANTEN",1,32,240,272
https://kawalpemilu.org#52519,"LENGKONG KULON, PAGEDANGAN, TANGERANG, BANTEN",2,112,128,240
https://kawalpemilu.org#52519,"LENGKONG KULON, PAGEDANGAN, TANGERANG, BANTEN",3,91,135,226
https://kawalpemilu.org#52519,"LENGKONG KULON, PAGEDANGAN, TANGERANG, BANTEN",4,81,163,244
https://kawalpemilu.org#52519,"LENGKONG KULON, PAGEDANGAN, TANGERANG, BANTEN",5,78,129,207
https://kawalpemilu.org#52519,"LENGKONG KULON, PAGEDANGAN, TANGERANG, BANTEN",6,68,196,264
https://kawalpemilu.org#52519,"LENGKONG KULON, PAGEDANGAN, TANGERANG, BANTEN",7,60,125,185
https://kawalpemilu.org#52519,"LENGKONG KULON, PAGEDANGAN, TANGERANG, BANTEN",8,72,128,200
https://kawalpemilu.org#52519,"LENGKONG KULON, PAGEDANGAN, TANGERANG, BANTEN",9,24,171,195
https://kawalpemilu.org#52519,"LENGKONG KULON, PAGEDANGAN, TANGERANG, BANTEN",10,43,227,270
https://kawalpemilu.org#52519,"LENGKONG KULON, PAGEDANGAN, TANGERANG, BANTEN",11,21,128,149
https://kawalpemilu.org#52519,"LENGKONG KULON, PAGEDANGAN, TANGERANG, BANTEN",12,107,136,243
https://kawalpemilu.org#52519,"LENGKONG KULON, PAGEDANGAN, TANGERANG, BANTEN",13,178,84,262
https://kawalpemilu.org#52519,"LENGKONG KULON, PAGEDANGAN, TANGERANG, BANTEN",14,98,142,240
https://kawalpemilu.org#52519,"LENGKONG KULON, PAGEDANGAN, TANGERANG, BANTEN",15,114,140,254
https://kawalpemilu.org#52519,"LENGKONG KULON, PAGEDANGAN, TANGERANG, BANTEN",16,81,124,205
https://kawalpemilu.org#52519,"LENGKONG KULON, PAGEDANGAN, TANGERANG, BANTEN",17,94,131,225
https://kawalpemilu.org#52519,"LENGKONG KULON, PAGEDANGAN, TANGERANG, BANTEN",18,58,179,237
https://kawalpemilu.org#52519,"LENGKONG KULON, PAGEDANGAN, TANGERANG, BANTEN",19,35,121,156
https://kawalpemilu.org#52519,"LENGKONG KULON, PAGEDANGAN, TANGERANG, BANTEN",20,98,138,236
https://kawalpemilu.org#52519,"LENGKONG KULON, PAGEDANGAN, TANGERANG, BANTEN",21,44,138,182
https://kawalpemilu.org#52519,"LENGKONG KULON, PAGEDANGAN, TANGERANG, BANTEN",22,35,110,145
https://kawalpemilu.org#52519,"LENGKONG KULON, PAGEDANGAN, TANGERANG, BANTEN",23,11,113,124
https://kawalpemilu.org#52520,"SITU GADUNG, PAGEDANGAN, TANGERANG, BANTEN",1,70,142,212
https://kawalpemilu.org#52520,"SITU GADUNG, PAGEDANGAN, TANGERANG, BANTEN",2,75,131,206
https://kawalpemilu.org#52520,"SITU GADUNG, PAGEDANGAN, TANGERANG, BANTEN",3,71,138,209
https://kawalpemilu.org#52520,"SITU GADUNG, PAGEDANGAN, TANGERANG, BANTEN",4,84,137,221
https://kawalpemilu.org#52520,"SITU GADUNG, PAGEDANGAN, TANGERANG, BANTEN",7,87,131,218
https://kawalpemilu.org#52520,"SITU GADUNG, PAGEDANGAN, TANGERANG, BANTEN",10,75,108,183
https://kawalpemilu.org#52520,"SITU GADUNG, PAGEDANGAN, TANGERANG, BANTEN",11,51,165,216
https://kawalpemilu.org#52520,"SITU GADUNG, PAGEDANGAN, TANGERANG, BANTEN",12,70,123,193
https://kawalpemilu.org#52520,"SITU GADUNG, PAGEDANGAN, TANGERANG, BANTEN",13,66,151,217
https://kawalpemilu.org#52520,"SITU GADUNG, PAGEDANGAN, TANGERANG, BANTEN",14,79,103,182
https://kawalpemilu.org#52520,"SITU GADUNG, PAGEDANGAN, TANGERANG, BANTEN",15,105,117,222
https://kawalpemilu.org#52520,"SITU GADUNG, PAGEDANGAN, TANGERANG, BANTEN",16,104,119,223
https://kawalpemilu.org#52520,"SITU GADUNG, PAGEDANGAN, TANGERANG, BANTEN",18,112,113,225
https://kawalpemilu.org#52520,"SITU GADUNG, PAGEDANGAN, TANGERANG, BANTEN",19,95,105,200
https://kawalpemilu.org#52520,"SITU GADUNG, PAGEDANGAN, TANGERANG, BANTEN",20,68,100,168
https://kawalpemilu.org#52520,"SITU GADUNG, PAGEDANGAN, TANGERANG, BANTEN",21,91,109,200
https://kawalpemilu.org#52520,"SITU GADUNG, PAGEDANGAN, TANGERANG, BANTEN",22,225,33,258
https://kawalpemilu.org#52520,"SITU GADUNG, PAGEDANGAN, TANGERANG, BANTEN",23,89,100,189
https://kawalpemilu.org#52520,"SITU GADUNG, PAGEDANGAN, TANGERANG, BANTEN",24,57,87,144
https://kawalpemilu.org#52520,"SITU GADUNG, PAGEDANGAN, TANGERANG, BANTEN",25,75,93,168
https://kawalpemilu.org#52521,"JATAKE, PAGEDANGAN, TANGERANG, BANTEN",1,51,174,225
https://kawalpemilu.org#52521,"JATAKE, PAGEDANGAN, TANGERANG, BANTEN",2,55,124,179
https://kawalpemilu.org#52521,"JATAKE, PAGEDANGAN, TANGERANG, BANTEN",3,61,138,199
https://kawalpemilu.org#52521,"JATAKE, PAGEDANGAN, TANGERANG, BANTEN",4,44,196,240
https://kawalpemilu.org#52521,"JATAKE, PAGEDANGAN, TANGERANG, BANTEN",5,51,133,184
https://kawalpemilu.org#52521,"JATAKE, PAGEDANGAN, TANGERANG, BANTEN",6,65,135,200
https://kawalpemilu.org#52521,"JATAKE, PAGEDANGAN, TANGERANG, BANTEN",7,32,198,230
https://kawalpemilu.org#52521,"JATAKE, PAGEDANGAN, TANGERANG, BANTEN",8,32,167,199
https://kawalpemilu.org#52521,"JATAKE, PAGEDANGAN, TANGERANG, BANTEN",9,68,113,181
https://kawalpemilu.org#52521,"JATAKE, PAGEDANGAN, TANGERANG, BANTEN",10,100,133,233
https://kawalpemilu.org#52521,"JATAKE, PAGEDANGAN, TANGERANG, BANTEN",11,41,167,208
https://kawalpemilu.org#52521,"JATAKE, PAGEDANGAN, TANGERANG, BANTEN",12,39,165,204
https://kawalpemilu.org#52521,"JATAKE, PAGEDANGAN, TANGERANG, BANTEN",13,82,104,186
https://kawalpemilu.org#52521,"JATAKE, PAGEDANGAN, TANGERANG, BANTEN",14,77,113,190
https://kawalpemilu.org#52521,"JATAKE, PAGEDANGAN, TANGERANG, BANTEN",15,45,151,196
https://kawalpemilu.org#52521,"JATAKE, PAGEDANGAN, TANGERANG, BANTEN",16,56,138,194
https://kawalpemilu.org#52521,"JATAKE, PAGEDANGAN, TANGERANG, BANTEN",17,70,124,194
https://kawalpemilu.org#52521,"JATAKE, PAGEDANGAN, TANGERANG, BANTEN",18,126,85,211
https://kawalpemilu.org#52521,"JATAKE, PAGEDANGAN, TANGERANG, BANTEN",19,68,113,181
https://kawalpemilu.org#52521,"JATAKE, PAGEDANGAN, TANGERANG, BANTEN",20,57,139,196
https://kawalpemilu.org#52521,"JATAKE, PAGEDANGAN, TANGERANG, BANTEN",21,56,137,193
https://kawalpemilu.org#52521,"JATAKE, PAGEDANGAN, TANGERANG, BANTEN",22,34,205,239
https://kawalpemilu.org#52521,"JATAKE, PAGEDANGAN, TANGERANG, BANTEN",23,57,182,239
https://kawalpemilu.org#52521,"JATAKE, PAGEDANGAN, TANGERANG, BANTEN",24,84,136,220
https://kawalpemilu.org#52522,"CIHUNI, PAGEDANGAN, TANGERANG, BANTEN",1,96,179,275
https://kawalpemilu.org#52522,"CIHUNI, PAGEDANGAN, TANGERANG, BANTEN",2,82,153,235
https://kawalpemilu.org#52522,"CIHUNI, PAGEDANGAN, TANGERANG, BANTEN",3,68,179,247
https://kawalpemilu.org#52522,"CIHUNI, PAGEDANGAN, TANGERANG, BANTEN",4,60,130,190
https://kawalpemilu.org#52522,"CIHUNI, PAGEDANGAN, TANGERANG, BANTEN",5,77,151,228
https://kawalpemilu.org#52522,"CIHUNI, PAGEDANGAN, TANGERANG, BANTEN",6,46,150,196
https://kawalpemilu.org#52522,"CIHUNI, PAGEDANGAN, TANGERANG, BANTEN",7,87,131,218
https://kawalpemilu.org#52522,"CIHUNI, PAGEDANGAN, TANGERANG, BANTEN",8,245,42,287
https://kawalpemilu.org#52522,"CIHUNI, PAGEDANGAN, TANGERANG, BANTEN",9,44,116,160
https://kawalpemilu.org#52522,"CIHUNI, PAGEDANGAN, TANGERANG, BANTEN",10,43,132,175
https://kawalpemilu.org#52522,"CIHUNI, PAGEDANGAN, TANGERANG, BANTEN",11,61,129,190
https://kawalpemilu.org#52522,"CIHUNI, PAGEDANGAN, TANGERANG, BANTEN",12,68,147,215
https://kawalpemilu.org#52522,"CIHUNI, PAGEDANGAN, TANGERANG, BANTEN",13,75,189,264
https://kawalpemilu.org#52522,"CIHUNI, PAGEDANGAN, TANGERANG, BANTEN",14,99,125,224
https://kawalpemilu.org#52522,"CIHUNI, PAGEDANGAN, TANGERANG, BANTEN",15,25,126,151
https://kawalpemilu.org#52522,"CIHUNI, PAGEDANGAN, TANGERANG, BANTEN",16,54,112,166
https://kawalpemilu.org#52522,"CIHUNI, PAGEDANGAN, TANGERANG, BANTEN",17,35,107,142
https://kawalpemilu.org#52522,"CIHUNI, PAGEDANGAN, TANGERANG, BANTEN",18,81,123,204
https://kawalpemilu.org#52523,"KADU SIRUNG, PAGEDANGAN, TANGERANG, BANTEN",1,88,84,172
https://kawalpemilu.org#52523,"KADU SIRUNG, PAGEDANGAN, TANGERANG, BANTEN",2,62,127,189
https://kawalpemilu.org#52523,"KADU SIRUNG, PAGEDANGAN, TANGERANG, BANTEN",3,54,92,146
https://kawalpemilu.org#52523,"KADU SIRUNG, PAGEDANGAN, TANGERANG, BANTEN",4,59,167,226
https://kawalpemilu.org#52523,"KADU SIRUNG, PAGEDANGAN, TANGERANG, BANTEN",5,79,137,216
https://kawalpemilu.org#52523,"KADU SIRUNG, PAGEDANGAN, TANGERANG, BANTEN",6,48,172,220
https://kawalpemilu.org#52523,"KADU SIRUNG, PAGEDANGAN, TANGERANG, BANTEN",7,51,163,214
https://kawalpemilu.org#52523,"KADU SIRUNG, PAGEDANGAN, TANGERANG, BANTEN",8,42,132,174
https://kawalpemilu.org#52523,"KADU SIRUNG, PAGEDANGAN, TANGERANG, BANTEN",9,26,180,206
https://kawalpemilu.org#52523,"KADU SIRUNG, PAGEDANGAN, TANGERANG, BANTEN",10,102,93,195
https://kawalpemilu.org#52523,"KADU SIRUNG, PAGEDANGAN, TANGERANG, BANTEN",11,52,87,139
https://kawalpemilu.org#52523,"KADU SIRUNG, PAGEDANGAN, TANGERANG, BANTEN",12,56,138,194
https://kawalpemilu.org#52523,"KADU SIRUNG, PAGEDANGAN, TANGERANG, BANTEN",13,59,147,206
https://kawalpemilu.org#52523,"KADU SIRUNG, PAGEDANGAN, TANGERANG, BANTEN",14,62,112,174
https://kawalpemilu.org#52523,"KADU SIRUNG, PAGEDANGAN, TANGERANG, BANTEN",15,54,146,200
https://kawalpemilu.org#52523,"KADU SIRUNG, PAGEDANGAN, TANGERANG, BANTEN",16,70,57,127
https://kawalpemilu.org#52523,"KADU SIRUNG, PAGEDANGAN, TANGERANG, BANTEN",17,80,124,204
https://kawalpemilu.org#52523,"KADU SIRUNG, PAGEDANGAN, TANGERANG, BANTEN",18,64,169,233
https://kawalpemilu.org#52523,"KADU SIRUNG, PAGEDANGAN, TANGERANG, BANTEN",19,53,154,207
https://kawalpemilu.org#52523,"KADU SIRUNG, PAGEDANGAN, TANGERANG, BANTEN",20,50,172,222
https://kawalpemilu.org#52523,"KADU SIRUNG, PAGEDANGAN, TANGERANG, BANTEN",21,48,123,171
https://kawalpemilu.org#52523,"KADU SIRUNG, PAGEDANGAN, TANGERANG, BANTEN",22,44,146,190
https://kawalpemilu.org#52523,"KADU SIRUNG, PAGEDANGAN, TANGERANG, BANTEN",23,21,117,138
https://kawalpemilu.org#52523,"KADU SIRUNG, PAGEDANGAN, TANGERANG, BANTEN",24,69,113,182
https://kawalpemilu.org#52524,"MALANG NENGAH, PAGEDANGAN, TANGERANG, BANTEN",1,58,158,216
https://kawalpemilu.org#52524,"MALANG NENGAH, PAGEDANGAN, TANGERANG, BANTEN",2,70,144,214
https://kawalpemilu.org#52524,"MALANG NENGAH, PAGEDANGAN, TANGERANG, BANTEN",3,64,131,195
https://kawalpemilu.org#52524,"MALANG NENGAH, PAGEDANGAN, TANGERANG, BANTEN",4,43,128,171
https://kawalpemilu.org#52524,"MALANG NENGAH, PAGEDANGAN, TANGERANG, BANTEN",5,59,108,167
https://kawalpemilu.org#52524,"MALANG NENGAH, PAGEDANGAN, TANGERANG, BANTEN",6,34,112,146
https://kawalpemilu.org#52524,"MALANG NENGAH, PAGEDANGAN, TANGERANG, BANTEN",7,66,135,201
https://kawalpemilu.org#52524,"MALANG NENGAH, PAGEDANGAN, TANGERANG, BANTEN",8,73,136,209
https://kawalpemilu.org#52524,"MALANG NENGAH, PAGEDANGAN, TANGERANG, BANTEN",9,67,123,190
https://kawalpemilu.org#52524,"MALANG NENGAH, PAGEDANGAN, TANGERANG, BANTEN",10,69,119,188
https://kawalpemilu.org#52524,"MALANG NENGAH, PAGEDANGAN, TANGERANG, BANTEN",11,57,133,190
https://kawalpemilu.org#52524,"MALANG NENGAH, PAGEDANGAN, TANGERANG, BANTEN",12,34,123,157
https://kawalpemilu.org#52524,"MALANG NENGAH, PAGEDANGAN, TANGERANG, BANTEN",13,62,141,203
https://kawalpemilu.org#52524,"MALANG NENGAH, PAGEDANGAN, TANGERANG, BANTEN",14,81,142,223
https://kawalpemilu.org#52524,"MALANG NENGAH, PAGEDANGAN, TANGERANG, BANTEN",15,41,121,162
https://kawalpemilu.org#52524,"MALANG NENGAH, PAGEDANGAN, TANGERANG, BANTEN",16,62,136,198
https://kawalpemilu.org#52524,"MALANG NENGAH, PAGEDANGAN, TANGERANG, BANTEN",17,54,107,161
https://kawalpemilu.org#52524,"MALANG NENGAH, PAGEDANGAN, TANGERANG, BANTEN",18,40,105,145
https://kawalpemilu.org#52524,"MALANG NENGAH, PAGEDANGAN, TANGERANG, BANTEN",19,94,109,203
https://kawalpemilu.org#52524,"MALANG NENGAH, PAGEDANGAN, TANGERANG, BANTEN",20,83,133,216
https://kawalpemilu.org#52524,"MALANG NENGAH, PAGEDANGAN, TANGERANG, BANTEN",21,78,105,183
https://kawalpemilu.org#52524,"MALANG NENGAH, PAGEDANGAN, TANGERANG, BANTEN",22,68,131,199
https://kawalpemilu.org#52524,"MALANG NENGAH, PAGEDANGAN, TANGERANG, BANTEN",23,51,168,219
https://kawalpemilu.org#52524,"MALANG NENGAH, PAGEDANGAN, TANGERANG, BANTEN",24,66,160,226
https://kawalpemilu.org#52525,"KARANG TENGAH, PAGEDANGAN, TANGERANG, BANTEN",1,78,165,243
https://kawalpemilu.org#52525,"KARANG TENGAH, PAGEDANGAN, TANGERANG, BANTEN",2,54,149,203
https://kawalpemilu.org#52525,"KARANG TENGAH, PAGEDANGAN, TANGERANG, BANTEN",4,75,116,191
https://kawalpemilu.org#52525,"KARANG TENGAH, PAGEDANGAN, TANGERANG, BANTEN",5,80,109,189
https://kawalpemilu.org#52525,"KARANG TENGAH, PAGEDANGAN, TANGERANG, BANTEN",6,72,98,170
https://kawalpemilu.org#52525,"KARANG TENGAH, PAGEDANGAN, TANGERANG, BANTEN",7,99,137,236
https://kawalpemilu.org#52525,"KARANG TENGAH, PAGEDANGAN, TANGERANG, BANTEN",8,88,154,242
https://kawalpemilu.org#52525,"KARANG TENGAH, PAGEDANGAN, TANGERANG, BANTEN",9,57,142,199
https://kawalpemilu.org#52525,"KARANG TENGAH, PAGEDANGAN, TANGERANG, BANTEN",10,61,153,214
https://kawalpemilu.org#52525,"KARANG TENGAH, PAGEDANGAN, TANGERANG, BANTEN",11,85,109,194
https://kawalpemilu.org#52525,"KARANG TENGAH, PAGEDANGAN, TANGERANG, BANTEN",12,51,124,175
https://kawalpemilu.org#52525,"KARANG TENGAH, PAGEDANGAN, TANGERANG, BANTEN",13,69,100,169
https://kawalpemilu.org#52527,"CISAUK, CISAUK, TANGERANG, BANTEN",1,82,146,228
https://kawalpemilu.org#52527,"CISAUK, CISAUK, TANGERANG, BANTEN",2,84,165,249
https://kawalpemilu.org#52527,"CISAUK, CISAUK, TANGERANG, BANTEN",3,55,118,173
https://kawalpemilu.org#52527,"CISAUK, CISAUK, TANGERANG, BANTEN",4,58,127,185
https://kawalpemilu.org#52527,"CISAUK, CISAUK, TANGERANG, BANTEN",5,79,103,182
https://kawalpemilu.org#52527,"CISAUK, CISAUK, TANGERANG, BANTEN",6,74,106,180
https://kawalpemilu.org#52527,"CISAUK, CISAUK, TANGERANG, BANTEN",7,68,120,188
https://kawalpemilu.org#52527,"CISAUK, CISAUK, TANGERANG, BANTEN",8,71,105,176
https://kawalpemilu.org#52527,"CISAUK, CISAUK, TANGERANG, BANTEN",9,40,116,156
https://kawalpemilu.org#52527,"CISAUK, CISAUK, TANGERANG, BANTEN",10,51,125,176
https://kawalpemilu.org#52527,"CISAUK, CISAUK, TANGERANG, BANTEN",11,76,154,230
https://kawalpemilu.org#52527,"CISAUK, CISAUK, TANGERANG, BANTEN",12,98,142,240
https://kawalpemilu.org#52527,"CISAUK, CISAUK, TANGERANG, BANTEN",13,115,99,214
https://kawalpemilu.org#52527,"CISAUK, CISAUK, TANGERANG, BANTEN",14,89,68,157
https://kawalpemilu.org#52527,"CISAUK, CISAUK, TANGERANG, BANTEN",15,103,118,221
https://kawalpemilu.org#52527,"CISAUK, CISAUK, TANGERANG, BANTEN",16,109,110,219
https://kawalpemilu.org#52527,"CISAUK, CISAUK, TANGERANG, BANTEN",17,81,103,184
https://kawalpemilu.org#52527,"CISAUK, CISAUK, TANGERANG, BANTEN",18,97,95,192
https://kawalpemilu.org#52527,"CISAUK, CISAUK, TANGERANG, BANTEN",19,78,144,222
https://kawalpemilu.org#52527,"CISAUK, CISAUK, TANGERANG, BANTEN",20,82,149,231
https://kawalpemilu.org#52527,"CISAUK, CISAUK, TANGERANG, BANTEN",21,82,161,243
https://kawalpemilu.org#52527,"CISAUK, CISAUK, TANGERANG, BANTEN",22,124,163,287
https://kawalpemilu.org#52527,"CISAUK, CISAUK, TANGERANG, BANTEN",23,102,103,205
https://kawalpemilu.org#52527,"CISAUK, CISAUK, TANGERANG, BANTEN",24,56,59,115
https://kawalpemilu.org#52527,"CISAUK, CISAUK, TANGERANG, BANTEN",25,97,101,198
https://kawalpemilu.org#52527,"CISAUK, CISAUK, TANGERANG, BANTEN",26,161,68,229
https://kawalpemilu.org#52527,"CISAUK, CISAUK, TANGERANG, BANTEN",27,147,141,288
https://kawalpemilu.org#52527,"CISAUK, CISAUK, TANGERANG, BANTEN",28,111,150,261
https://kawalpemilu.org#52527,"CISAUK, CISAUK, TANGERANG, BANTEN",29,107,127,234
https://kawalpemilu.org#52527,"CISAUK, CISAUK, TANGERANG, BANTEN",30,50,129,179
https://kawalpemilu.org#52527,"CISAUK, CISAUK, TANGERANG, BANTEN",31,75,138,213
https://kawalpemilu.org#52527,"CISAUK, CISAUK, TANGERANG, BANTEN",32,66,95,161
https://kawalpemilu.org#52527,"CISAUK, CISAUK, TANGERANG, BANTEN",33,101,112,213
https://kawalpemilu.org#52527,"CISAUK, CISAUK, TANGERANG, BANTEN",34,101,64,165
https://kawalpemilu.org#52527,"CISAUK, CISAUK, TANGERANG, BANTEN",35,73,179,252
https://kawalpemilu.org#52527,"CISAUK, CISAUK, TANGERANG, BANTEN",36,112,123,235
https://kawalpemilu.org#52527,"CISAUK, CISAUK, TANGERANG, BANTEN",37,75,158,233
https://kawalpemilu.org#52527,"CISAUK, CISAUK, TANGERANG, BANTEN",38,65,138,203
https://kawalpemilu.org#52527,"CISAUK, CISAUK, TANGERANG, BANTEN",39,118,126,244
https://kawalpemilu.org#52527,"CISAUK, CISAUK, TANGERANG, BANTEN",40,76,114,190
https://kawalpemilu.org#52528,"MEKAR WANGI, CISAUK, TANGERANG, BANTEN",1,78,89,167
https://kawalpemilu.org#52528,"MEKAR WANGI, CISAUK, TANGERANG, BANTEN",2,69,93,162
https://kawalpemilu.org#52528,"MEKAR WANGI, CISAUK, TANGERANG, BANTEN",3,83,73,156
https://kawalpemilu.org#52528,"MEKAR WANGI, CISAUK, TANGERANG, BANTEN",4,103,112,215
https://kawalpemilu.org#52528,"MEKAR WANGI, CISAUK, TANGERANG, BANTEN",5,75,112,187
https://kawalpemilu.org#52528,"MEKAR WANGI, CISAUK, TANGERANG, BANTEN",6,0,0,0
https://kawalpemilu.org#52528,"MEKAR WANGI, CISAUK, TANGERANG, BANTEN",7,41,155,196
https://kawalpemilu.org#52528,"MEKAR WANGI, CISAUK, TANGERANG, BANTEN",8,33,127,160
https://kawalpemilu.org#52528,"MEKAR WANGI, CISAUK, TANGERANG, BANTEN",9,31,150,181
https://kawalpemilu.org#52528,"MEKAR WANGI, CISAUK, TANGERANG, BANTEN",10,73,110,183
https://kawalpemilu.org#52528,"MEKAR WANGI, CISAUK, TANGERANG, BANTEN",11,61,124,185
https://kawalpemilu.org#52528,"MEKAR WANGI, CISAUK, TANGERANG, BANTEN",12,68,78,146
https://kawalpemilu.org#52528,"MEKAR WANGI, CISAUK, TANGERANG, BANTEN",13,67,62,129
https://kawalpemilu.org#52528,"MEKAR WANGI, CISAUK, TANGERANG, BANTEN",14,74,84,158
https://kawalpemilu.org#52528,"MEKAR WANGI, CISAUK, TANGERANG, BANTEN",15,97,47,144
https://kawalpemilu.org#52528,"MEKAR WANGI, CISAUK, TANGERANG, BANTEN",16,48,71,119
https://kawalpemilu.org#52528,"MEKAR WANGI, CISAUK, TANGERANG, BANTEN",17,38,46,84
https://kawalpemilu.org#52528,"MEKAR WANGI, CISAUK, TANGERANG, BANTEN",18,45,62,7
https://kawalpemilu.org#52528,"MEKAR WANGI, CISAUK, TANGERANG, BANTEN",19,92,100,192
https://kawalpemilu.org#52528,"MEKAR WANGI, CISAUK, TANGERANG, BANTEN",20,91,91,182
https://kawalpemilu.org#52528,"MEKAR WANGI, CISAUK, TANGERANG, BANTEN",21,95,93,188
https://kawalpemilu.org#52529,"SURADITA, CISAUK, TANGERANG, BANTEN",1,142,91,233
https://kawalpemilu.org#52529,"SURADITA, CISAUK, TANGERANG, BANTEN",2,137,115,252
https://kawalpemilu.org#52529,"SURADITA, CISAUK, TANGERANG, BANTEN",3,81,177,258
https://kawalpemilu.org#52529,"SURADITA, CISAUK, TANGERANG, BANTEN",4,62,158,220
https://kawalpemilu.org#52529,"SURADITA, CISAUK, TANGERANG, BANTEN",5,108,131,239
https://kawalpemilu.org#52529,"SURADITA, CISAUK, TANGERANG, BANTEN",6,111,172,283
https://kawalpemilu.org#52529,"SURADITA, CISAUK, TANGERANG, BANTEN",7,132,124,256
https://kawalpemilu.org#52529,"SURADITA, CISAUK, TANGERANG, BANTEN",8,71,116,187
https://kawalpemilu.org#52529,"SURADITA, CISAUK, TANGERANG, BANTEN",9,111,131,242
https://kawalpemilu.org#52529,"SURADITA, CISAUK, TANGERANG, BANTEN",10,31,154,185
https://kawalpemilu.org#52529,"SURADITA, CISAUK, TANGERANG, BANTEN",11,41,114,155
https://kawalpemilu.org#52529,"SURADITA, CISAUK, TANGERANG, BANTEN",12,80,126,206
https://kawalpemilu.org#52529,"SURADITA, CISAUK, TANGERANG, BANTEN",13,58,93,151
https://kawalpemilu.org#52529,"SURADITA, CISAUK, TANGERANG, BANTEN",15,77,98,175
https://kawalpemilu.org#52529,"SURADITA, CISAUK, TANGERANG, BANTEN",16,65,144,209
https://kawalpemilu.org#52529,"SURADITA, CISAUK, TANGERANG, BANTEN",17,45,153,198
https://kawalpemilu.org#52529,"SURADITA, CISAUK, TANGERANG, BANTEN",18,56,194,250
https://kawalpemilu.org#52529,"SURADITA, CISAUK, TANGERANG, BANTEN",19,38,132,170
https://kawalpemilu.org#52529,"SURADITA, CISAUK, TANGERANG, BANTEN",20,45,120,165
https://kawalpemilu.org#52529,"SURADITA, CISAUK, TANGERANG, BANTEN",21,72,133,205
https://kawalpemilu.org#52529,"SURADITA, CISAUK, TANGERANG, BANTEN",22,41,137,178
https://kawalpemilu.org#52529,"SURADITA, CISAUK, TANGERANG, BANTEN",23,37,98,135
https://kawalpemilu.org#52529,"SURADITA, CISAUK, TANGERANG, BANTEN",24,34,92,126
https://kawalpemilu.org#52529,"SURADITA, CISAUK, TANGERANG, BANTEN",25,48,181,229
https://kawalpemilu.org#52529,"SURADITA, CISAUK, TANGERANG, BANTEN",26,79,122,201
https://kawalpemilu.org#52529,"SURADITA, CISAUK, TANGERANG, BANTEN",27,80,176,256
https://kawalpemilu.org#52529,"SURADITA, CISAUK, TANGERANG, BANTEN",28,35,205,240
https://kawalpemilu.org#52529,"SURADITA, CISAUK, TANGERANG, BANTEN",29,96,133,229
https://kawalpemilu.org#52529,"SURADITA, CISAUK, TANGERANG, BANTEN",31,97,119,216
https://kawalpemilu.org#52529,"SURADITA, CISAUK, TANGERANG, BANTEN",32,81,45,126
https://kawalpemilu.org#52529,"SURADITA, CISAUK, TANGERANG, BANTEN",33,105,80,185
https://kawalpemilu.org#52529,"SURADITA, CISAUK, TANGERANG, BANTEN",34,67,123,190
https://kawalpemilu.org#52529,"SURADITA, CISAUK, TANGERANG, BANTEN",35,51,110,161
https://kawalpemilu.org#52529,"SURADITA, CISAUK, TANGERANG, BANTEN",36,106,104,210
https://kawalpemilu.org#52529,"SURADITA, CISAUK, TANGERANG, BANTEN",37,93,84,177
https://kawalpemilu.org#52529,"SURADITA, CISAUK, TANGERANG, BANTEN",38,132,102,234
https://kawalpemilu.org#52529,"SURADITA, CISAUK, TANGERANG, BANTEN",39,81,53,134
https://kawalpemilu.org#52529,"SURADITA, CISAUK, TANGERANG, BANTEN",40,86,85,171
https://kawalpemilu.org#52529,"SURADITA, CISAUK, TANGERANG, BANTEN",41,105,100,205
https://kawalpemilu.org#52529,"SURADITA, CISAUK, TANGERANG, BANTEN",42,67,159,226
https://kawalpemilu.org#52529,"SURADITA, CISAUK, TANGERANG, BANTEN",43,86,110,196
https://kawalpemilu.org#52529,"SURADITA, CISAUK, TANGERANG, BANTEN",44,99,139,238
https://kawalpemilu.org#52529,"SURADITA, CISAUK, TANGERANG, BANTEN",45,160,117,277
https://kawalpemilu.org#52529,"SURADITA, CISAUK, TANGERANG, BANTEN",46,52,94,146
https://kawalpemilu.org#52529,"SURADITA, CISAUK, TANGERANG, BANTEN",47,97,180,277
https://kawalpemilu.org#52529,"SURADITA, CISAUK, TANGERANG, BANTEN",48,88,181,269
https://kawalpemilu.org#52529,"SURADITA, CISAUK, TANGERANG, BANTEN",49,47,103,150
https://kawalpemilu.org#52529,"SURADITA, CISAUK, TANGERANG, BANTEN",50,43,48,91
https://kawalpemilu.org#52529,"SURADITA, CISAUK, TANGERANG, BANTEN",51,117,116,233
https://kawalpemilu.org#52529,"SURADITA, CISAUK, TANGERANG, BANTEN",52,44,84,128
https://kawalpemilu.org#52529,"SURADITA, CISAUK, TANGERANG, BANTEN",53,138,113,251
https://kawalpemilu.org#52529,"SURADITA, CISAUK, TANGERANG, BANTEN",54,83,130,213
https://kawalpemilu.org#52529,"SURADITA, CISAUK, TANGERANG, BANTEN",55,81,144,225
https://kawalpemilu.org#52529,"SURADITA, CISAUK, TANGERANG, BANTEN",56,72,137,209
https://kawalpemilu.org#52529,"SURADITA, CISAUK, TANGERANG, BANTEN",57,96,179,275
https://kawalpemilu.org#52529,"SURADITA, CISAUK, TANGERANG, BANTEN",58,94,143,237
https://kawalpemilu.org#52529,"SURADITA, CISAUK, TANGERANG, BANTEN",59,97,111,208
https://kawalpemilu.org#52529,"SURADITA, CISAUK, TANGERANG, BANTEN",60,75,78,153
https://kawalpemilu.org#52529,"SURADITA, CISAUK, TANGERANG, BANTEN",61,145,127,272
https://kawalpemilu.org#52529,"SURADITA, CISAUK, TANGERANG, BANTEN",62,136,118,254
https://kawalpemilu.org#52529,"SURADITA, CISAUK, TANGERANG, BANTEN",63,116,98,214
https://kawalpemilu.org#52529,"SURADITA, CISAUK, TANGERANG, BANTEN",64,66,60,126
https://kawalpemilu.org#52529,"SURADITA, CISAUK, TANGERANG, BANTEN",65,110,111,221
https://kawalpemilu.org#52529,"SURADITA, CISAUK, TANGERANG, BANTEN",66,59,92,151
https://kawalpemilu.org#52529,"SURADITA, CISAUK, TANGERANG, BANTEN",67,72,108,180
https://kawalpemilu.org#52529,"SURADITA, CISAUK, TANGERANG, BANTEN",68,98,144,242
https://kawalpemilu.org#52529,"SURADITA, CISAUK, TANGERANG, BANTEN",69,108,164,272
https://kawalpemilu.org#52529,"SURADITA, CISAUK, TANGERANG, BANTEN",70,130,147,277
https://kawalpemilu.org#52529,"SURADITA, CISAUK, TANGERANG, BANTEN",71,103,91,194
https://kawalpemilu.org#52529,"SURADITA, CISAUK, TANGERANG, BANTEN",72,50,43,93
https://kawalpemilu.org#52529,"SURADITA, CISAUK, TANGERANG, BANTEN",73,88,101,189
https://kawalpemilu.org#52529,"SURADITA, CISAUK, TANGERANG, BANTEN",74,61,102,163
https://kawalpemilu.org#52529,"SURADITA, CISAUK, TANGERANG, BANTEN",75,55,126,181
https://kawalpemilu.org#52529,"SURADITA, CISAUK, TANGERANG, BANTEN",76,48,72,120
https://kawalpemilu.org#52529,"SURADITA, CISAUK, TANGERANG, BANTEN",77,59,77,136
https://kawalpemilu.org#52530,"SAMPORA, CISAUK, TANGERANG, BANTEN",1,33,130,163
https://kawalpemilu.org#52530,"SAMPORA, CISAUK, TANGERANG, BANTEN",2,49,115,164
https://kawalpemilu.org#52530,"SAMPORA, CISAUK, TANGERANG, BANTEN",3,99,169,268
https://kawalpemilu.org#52530,"SAMPORA, CISAUK, TANGERANG, BANTEN",4,80,114,194
https://kawalpemilu.org#52530,"SAMPORA, CISAUK, TANGERANG, BANTEN",5,88,122,210
https://kawalpemilu.org#52530,"SAMPORA, CISAUK, TANGERANG, BANTEN",6,83,134,217
https://kawalpemilu.org#52530,"SAMPORA, CISAUK, TANGERANG, BANTEN",7,96,130,226
https://kawalpemilu.org#52530,"SAMPORA, CISAUK, TANGERANG, BANTEN",8,74,132,206
https://kawalpemilu.org#52530,"SAMPORA, CISAUK, TANGERANG, BANTEN",9,76,154,230
https://kawalpemilu.org#52530,"SAMPORA, CISAUK, TANGERANG, BANTEN",10,54,114,168
https://kawalpemilu.org#52530,"SAMPORA, CISAUK, TANGERANG, BANTEN",11,47,132,179
https://kawalpemilu.org#52530,"SAMPORA, CISAUK, TANGERANG, BANTEN",12,147,111,258
https://kawalpemilu.org#52530,"SAMPORA, CISAUK, TANGERANG, BANTEN",13,159,79,238
https://kawalpemilu.org#52530,"SAMPORA, CISAUK, TANGERANG, BANTEN",14,196,47,243
https://kawalpemilu.org#52530,"SAMPORA, CISAUK, TANGERANG, BANTEN",15,196,33,229
https://kawalpemilu.org#52530,"SAMPORA, CISAUK, TANGERANG, BANTEN",16,90,156,246
https://kawalpemilu.org#52530,"SAMPORA, CISAUK, TANGERANG, BANTEN",17,79,113,192
https://kawalpemilu.org#52530,"SAMPORA, CISAUK, TANGERANG, BANTEN",18,78,84,162
https://kawalpemilu.org#52530,"SAMPORA, CISAUK, TANGERANG, BANTEN",19,46,96,142
https://kawalpemilu.org#52530,"SAMPORA, CISAUK, TANGERANG, BANTEN",20,220,24,244
https://kawalpemilu.org#52530,"SAMPORA, CISAUK, TANGERANG, BANTEN",21,218,42,260
https://kawalpemilu.org#52530,"SAMPORA, CISAUK, TANGERANG, BANTEN",22,241,49,290
https://kawalpemilu.org#52531,"DANGDANG, CISAUK, TANGERANG, BANTEN",1,74,116,190
https://kawalpemilu.org#52531,"DANGDANG, CISAUK, TANGERANG, BANTEN",2,98,111,209
https://kawalpemilu.org#52531,"DANGDANG, CISAUK, TANGERANG, BANTEN",4,113,59,172
https://kawalpemilu.org#52531,"DANGDANG, CISAUK, TANGERANG, BANTEN",5,63,105,168
https://kawalpemilu.org#52531,"DANGDANG, CISAUK, TANGERANG, BANTEN",6,70,104,174
https://kawalpemilu.org#52531,"DANGDANG, CISAUK, TANGERANG, BANTEN",10,60,108,168
https://kawalpemilu.org#52531,"DANGDANG, CISAUK, TANGERANG, BANTEN",11,86,78,164
https://kawalpemilu.org#52531,"DANGDANG, CISAUK, TANGERANG, BANTEN",12,158,76,234
https://kawalpemilu.org#52531,"DANGDANG, CISAUK, TANGERANG, BANTEN",13,138,36,174
https://kawalpemilu.org#52531,"DANGDANG, CISAUK, TANGERANG, BANTEN",14,124,56,180
https://kawalpemilu.org#52531,"DANGDANG, CISAUK, TANGERANG, BANTEN",15,118,83,201
https://kawalpemilu.org#52531,"DANGDANG, CISAUK, TANGERANG, BANTEN",16,105,128,233
https://kawalpemilu.org#52531,"DANGDANG, CISAUK, TANGERANG, BANTEN",17,72,138,210
https://kawalpemilu.org#52531,"DANGDANG, CISAUK, TANGERANG, BANTEN",18,72,99,171
https://kawalpemilu.org#52531,"DANGDANG, CISAUK, TANGERANG, BANTEN",19,121,70,191
https://kawalpemilu.org#52531,"DANGDANG, CISAUK, TANGERANG, BANTEN",20,128,81,209
https://kawalpemilu.org#52532,"CIBOGO, CISAUK, TANGERANG, BANTEN",1,56,63,119
https://kawalpemilu.org#52532,"CIBOGO, CISAUK, TANGERANG, BANTEN",2,79,120,199
https://kawalpemilu.org#52532,"CIBOGO, CISAUK, TANGERANG, BANTEN",3,100,87,187
https://kawalpemilu.org#52532,"CIBOGO, CISAUK, TANGERANG, BANTEN",4,88,120,208
https://kawalpemilu.org#52532,"CIBOGO, CISAUK, TANGERANG, BANTEN",5,68,152,220
https://kawalpemilu.org#52532,"CIBOGO, CISAUK, TANGERANG, BANTEN",6,90,119,209
https://kawalpemilu.org#52532,"CIBOGO, CISAUK, TANGERANG, BANTEN",7,85,165,250
https://kawalpemilu.org#52532,"CIBOGO, CISAUK, TANGERANG, BANTEN",8,72,144,216
https://kawalpemilu.org#52532,"CIBOGO, CISAUK, TANGERANG, BANTEN",9,79,64,143
https://kawalpemilu.org#52532,"CIBOGO, CISAUK, TANGERANG, BANTEN",10,145,130,275
https://kawalpemilu.org#52532,"CIBOGO, CISAUK, TANGERANG, BANTEN",11,116,113,229
https://kawalpemilu.org#52532,"CIBOGO, CISAUK, TANGERANG, BANTEN",12,0,0,0
https://kawalpemilu.org#52532,"CIBOGO, CISAUK, TANGERANG, BANTEN",13,67,142,209
https://kawalpemilu.org#52532,"CIBOGO, CISAUK, TANGERANG, BANTEN",14,77,143,220
https://kawalpemilu.org#52532,"CIBOGO, CISAUK, TANGERANG, BANTEN",15,80,141,221
https://kawalpemilu.org#52532,"CIBOGO, CISAUK, TANGERANG, BANTEN",16,90,161,251
https://kawalpemilu.org#52532,"CIBOGO, CISAUK, TANGERANG, BANTEN",17,58,120,178
https://kawalpemilu.org#52532,"CIBOGO, CISAUK, TANGERANG, BANTEN",18,74,114,188
https://kawalpemilu.org#52532,"CIBOGO, CISAUK, TANGERANG, BANTEN",19,82,146,228
https://kawalpemilu.org#52532,"CIBOGO, CISAUK, TANGERANG, BANTEN",20,44,91,135
https://kawalpemilu.org#52532,"CIBOGO, CISAUK, TANGERANG, BANTEN",21,40,103,143
https://kawalpemilu.org#52532,"CIBOGO, CISAUK, TANGERANG, BANTEN",22,42,71,113
https://kawalpemilu.org#52532,"CIBOGO, CISAUK, TANGERANG, BANTEN",23,54,86,140
https://kawalpemilu.org#52532,"CIBOGO, CISAUK, TANGERANG, BANTEN",24,83,110,193
https://kawalpemilu.org#52532,"CIBOGO, CISAUK, TANGERANG, BANTEN",25,61,135,196
https://kawalpemilu.org#52532,"CIBOGO, CISAUK, TANGERANG, BANTEN",26,113,83,196
https://kawalpemilu.org#52532,"CIBOGO, CISAUK, TANGERANG, BANTEN",27,74,129,203
https://kawalpemilu.org#52532,"CIBOGO, CISAUK, TANGERANG, BANTEN",28,69,142,211
https://kawalpemilu.org#52532,"CIBOGO, CISAUK, TANGERANG, BANTEN",29,54,173,227
https://kawalpemilu.org#52532,"CIBOGO, CISAUK, TANGERANG, BANTEN",30,46,154,200
https://kawalpemilu.org#52532,"CIBOGO, CISAUK, TANGERANG, BANTEN",31,67,143,210
https://kawalpemilu.org#52532,"CIBOGO, CISAUK, TANGERANG, BANTEN",32,58,153,211
https://kawalpemilu.org#52532,"CIBOGO, CISAUK, TANGERANG, BANTEN",33,49,194,243
https://kawalpemilu.org#52532,"CIBOGO, CISAUK, TANGERANG, BANTEN",34,67,127,194
https://kawalpemilu.org#52532,"CIBOGO, CISAUK, TANGERANG, BANTEN",35,65,65,130
https://kawalpemilu.org#52532,"CIBOGO, CISAUK, TANGERANG, BANTEN",36,77,130,207
https://kawalpemilu.org#52532,"CIBOGO, CISAUK, TANGERANG, BANTEN",37,102,131,233
https://kawalpemilu.org#52532,"CIBOGO, CISAUK, TANGERANG, BANTEN",38,91,75,166
https://kawalpemilu.org#52532,"CIBOGO, CISAUK, TANGERANG, BANTEN",39,101,12,113
https://kawalpemilu.org#52532,"CIBOGO, CISAUK, TANGERANG, BANTEN",40,105,81,186
https://kawalpemilu.org#52532,"CIBOGO, CISAUK, TANGERANG, BANTEN",41,87,72,159
https://kawalpemilu.org#52532,"CIBOGO, CISAUK, TANGERANG, BANTEN",42,158,94,252
https://kawalpemilu.org#52532,"CIBOGO, CISAUK, TANGERANG, BANTEN",43,139,108,247
https://kawalpemilu.org#52532,"CIBOGO, CISAUK, TANGERANG, BANTEN",44,212,72,284
https://kawalpemilu.org#52534,"BENDA, SUKAMULYA, TANGERANG, BANTEN",1,15,139,154
https://kawalpemilu.org#52534,"BENDA, SUKAMULYA, TANGERANG, BANTEN",2,26,128,154
https://kawalpemilu.org#52534,"BENDA, SUKAMULYA, TANGERANG, BANTEN",3,79,112,191
https://kawalpemilu.org#52534,"BENDA, SUKAMULYA, TANGERANG, BANTEN",4,47,138,185
https://kawalpemilu.org#52534,"BENDA, SUKAMULYA, TANGERANG, BANTEN",6,61,142,203
https://kawalpemilu.org#52534,"BENDA, SUKAMULYA, TANGERANG, BANTEN",7,63,92,155
https://kawalpemilu.org#52534,"BENDA, SUKAMULYA, TANGERANG, BANTEN",8,60,108,168
https://kawalpemilu.org#52534,"BENDA, SUKAMULYA, TANGERANG, BANTEN",9,63,104,167
https://kawalpemilu.org#52534,"BENDA, SUKAMULYA, TANGERANG, BANTEN",10,57,111,168
https://kawalpemilu.org#52534,"BENDA, SUKAMULYA, TANGERANG, BANTEN",11,82,120,202
https://kawalpemilu.org#52534,"BENDA, SUKAMULYA, TANGERANG, BANTEN",12,69,137,206
https://kawalpemilu.org#52534,"BENDA, SUKAMULYA, TANGERANG, BANTEN",13,67,181,248
https://kawalpemilu.org#52534,"BENDA, SUKAMULYA, TANGERANG, BANTEN",14,82,116,198
https://kawalpemilu.org#52534,"BENDA, SUKAMULYA, TANGERANG, BANTEN",15,84,157,241
https://kawalpemilu.org#52534,"BENDA, SUKAMULYA, TANGERANG, BANTEN",16,37,199,236
https://kawalpemilu.org#52534,"BENDA, SUKAMULYA, TANGERANG, BANTEN",17,54,117,171
https://kawalpemilu.org#52534,"BENDA, SUKAMULYA, TANGERANG, BANTEN",18,91,154,245
https://kawalpemilu.org#52534,"BENDA, SUKAMULYA, TANGERANG, BANTEN",19,45,158,203
https://kawalpemilu.org#52534,"BENDA, SUKAMULYA, TANGERANG, BANTEN",20,43,145,188
https://kawalpemilu.org#52535,"SUKAMULYA, SUKAMULYA, TANGERANG, BANTEN",1,61,118,179
https://kawalpemilu.org#52535,"SUKAMULYA, SUKAMULYA, TANGERANG, BANTEN",2,110,135,245
https://kawalpemilu.org#52535,"SUKAMULYA, SUKAMULYA, TANGERANG, BANTEN",3,95,105,200
https://kawalpemilu.org#52535,"SUKAMULYA, SUKAMULYA, TANGERANG, BANTEN",4,89,99,188
https://kawalpemilu.org#52535,"SUKAMULYA, SUKAMULYA, TANGERANG, BANTEN",5,82,134,216
https://kawalpemilu.org#52535,"SUKAMULYA, SUKAMULYA, TANGERANG, BANTEN",6,84,113,197
https://kawalpemilu.org#52535,"SUKAMULYA, SUKAMULYA, TANGERANG, BANTEN",7,99,110,209
https://kawalpemilu.org#52535,"SUKAMULYA, SUKAMULYA, TANGERANG, BANTEN",8,117,134,251
https://kawalpemilu.org#52535,"SUKAMULYA, SUKAMULYA, TANGERANG, BANTEN",9,64,150,214
https://kawalpemilu.org#52535,"SUKAMULYA, SUKAMULYA, TANGERANG, BANTEN",10,60,98,158
https://kawalpemilu.org#52535,"SUKAMULYA, SUKAMULYA, TANGERANG, BANTEN",12,142,92,234
https://kawalpemilu.org#52535,"SUKAMULYA, SUKAMULYA, TANGERANG, BANTEN",13,108,101,209
https://kawalpemilu.org#52535,"SUKAMULYA, SUKAMULYA, TANGERANG, BANTEN",14,109,89,198
https://kawalpemilu.org#52535,"SUKAMULYA, SUKAMULYA, TANGERANG, BANTEN",16,56,62,118
https://kawalpemilu.org#52535,"SUKAMULYA, SUKAMULYA, TANGERANG, BANTEN",17,70,146,216
https://kawalpemilu.org#52535,"SUKAMULYA, SUKAMULYA, TANGERANG, BANTEN",18,87,146,233
https://kawalpemilu.org#52535,"SUKAMULYA, SUKAMULYA, TANGERANG, BANTEN",19,53,173,226
https://kawalpemilu.org#52535,"SUKAMULYA, SUKAMULYA, TANGERANG, BANTEN",20,88,128,216
https://kawalpemilu.org#52535,"SUKAMULYA, SUKAMULYA, TANGERANG, BANTEN",22,122,141,263
https://kawalpemilu.org#52535,"SUKAMULYA, SUKAMULYA, TANGERANG, BANTEN",23,102,104,206
https://kawalpemilu.org#52535,"SUKAMULYA, SUKAMULYA, TANGERANG, BANTEN",24,128,85,213
https://kawalpemilu.org#52535,"SUKAMULYA, SUKAMULYA, TANGERANG, BANTEN",25,82,97,179
https://kawalpemilu.org#52536,"KALIASIN, SUKAMULYA, TANGERANG, BANTEN",1,82,120,202
https://kawalpemilu.org#52536,"KALIASIN, SUKAMULYA, TANGERANG, BANTEN",2,79,115,194
https://kawalpemilu.org#52536,"KALIASIN, SUKAMULYA, TANGERANG, BANTEN",3,62,104,166
https://kawalpemilu.org#52536,"KALIASIN, SUKAMULYA, TANGERANG, BANTEN",4,109,127,236
https://kawalpemilu.org#52536,"KALIASIN, SUKAMULYA, TANGERANG, BANTEN",5,100,116,216
https://kawalpemilu.org#52536,"KALIASIN, SUKAMULYA, TANGERANG, BANTEN",6,82,108,190
https://kawalpemilu.org#52536,"KALIASIN, SUKAMULYA, TANGERANG, BANTEN",7,60,122,182
https://kawalpemilu.org#52536,"KALIASIN, SUKAMULYA, TANGERANG, BANTEN",8,38,197,235
https://kawalpemilu.org#52536,"KALIASIN, SUKAMULYA, TANGERANG, BANTEN",9,33,168,201
https://kawalpemilu.org#52536,"KALIASIN, SUKAMULYA, TANGERANG, BANTEN",10,70,90,160
https://kawalpemilu.org#52536,"KALIASIN, SUKAMULYA, TANGERANG, BANTEN",11,97,108,205
https://kawalpemilu.org#52536,"KALIASIN, SUKAMULYA, TANGERANG, BANTEN",12,86,119,205
https://kawalpemilu.org#52536,"KALIASIN, SUKAMULYA, TANGERANG, BANTEN",13,89,86,175
https://kawalpemilu.org#52536,"KALIASIN, SUKAMULYA, TANGERANG, BANTEN",14,60,129,189
https://kawalpemilu.org#52536,"KALIASIN, SUKAMULYA, TANGERANG, BANTEN",15,81,151,232
https://kawalpemilu.org#52536,"KALIASIN, SUKAMULYA, TANGERANG, BANTEN",16,66,179,245
https://kawalpemilu.org#52536,"KALIASIN, SUKAMULYA, TANGERANG, BANTEN",17,85,125,210
https://kawalpemilu.org#52536,"KALIASIN, SUKAMULYA, TANGERANG, BANTEN",18,102,145,247
https://kawalpemilu.org#52536,"KALIASIN, SUKAMULYA, TANGERANG, BANTEN",19,63,122,185
https://kawalpemilu.org#52536,"KALIASIN, SUKAMULYA, TANGERANG, BANTEN",20,102,145,247
https://kawalpemilu.org#52536,"KALIASIN, SUKAMULYA, TANGERANG, BANTEN",21,91,150,241
https://kawalpemilu.org#52536,"KALIASIN, SUKAMULYA, TANGERANG, BANTEN",22,41,85,126
https://kawalpemilu.org#52536,"KALIASIN, SUKAMULYA, TANGERANG, BANTEN",23,86,130,216
https://kawalpemilu.org#52536,"KALIASIN, SUKAMULYA, TANGERANG, BANTEN",24,43,70,113
https://kawalpemilu.org#52536,"KALIASIN, SUKAMULYA, TANGERANG, BANTEN",25,41,114,155
https://kawalpemilu.org#52536,"KALIASIN, SUKAMULYA, TANGERANG, BANTEN",26,50,128,178
https://kawalpemilu.org#52536,"KALIASIN, SUKAMULYA, TANGERANG, BANTEN",27,42,151,193
https://kawalpemilu.org#52536,"KALIASIN, SUKAMULYA, TANGERANG, BANTEN",28,38,154,192
https://kawalpemilu.org#52536,"KALIASIN, SUKAMULYA, TANGERANG, BANTEN",29,38,135,173
https://kawalpemilu.org#52537,"BUNIAYU, SUKAMULYA, TANGERANG, BANTEN",1,68,188,256
https://kawalpemilu.org#52537,"BUNIAYU, SUKAMULYA, TANGERANG, BANTEN",2,104,101,205
https://kawalpemilu.org#52537,"BUNIAYU, SUKAMULYA, TANGERANG, BANTEN",3,78,94,172
https://kawalpemilu.org#52537,"BUNIAYU, SUKAMULYA, TANGERANG, BANTEN",4,88,89,177
https://kawalpemilu.org#52537,"BUNIAYU, SUKAMULYA, TANGERANG, BANTEN",5,94,67,161
https://kawalpemilu.org#52537,"BUNIAYU, SUKAMULYA, TANGERANG, BANTEN",6,112,56,168
https://kawalpemilu.org#52537,"BUNIAYU, SUKAMULYA, TANGERANG, BANTEN",7,98,93,191
https://kawalpemilu.org#52537,"BUNIAYU, SUKAMULYA, TANGERANG, BANTEN",10,51,179,230
https://kawalpemilu.org#52537,"BUNIAYU, SUKAMULYA, TANGERANG, BANTEN",11,118,89,207
https://kawalpemilu.org#52537,"BUNIAYU, SUKAMULYA, TANGERANG, BANTEN",12,92,131,223
https://kawalpemilu.org#52537,"BUNIAYU, SUKAMULYA, TANGERANG, BANTEN",13,88,92,180
https://kawalpemilu.org#52537,"BUNIAYU, SUKAMULYA, TANGERANG, BANTEN",14,101,85,186
https://kawalpemilu.org#52537,"BUNIAYU, SUKAMULYA, TANGERANG, BANTEN",15,105,113,218
https://kawalpemilu.org#52537,"BUNIAYU, SUKAMULYA, TANGERANG, BANTEN",16,81,141,222
https://kawalpemilu.org#52537,"BUNIAYU, SUKAMULYA, TANGERANG, BANTEN",17,33,65,98
https://kawalpemilu.org#52538,"PARAHU, SUKAMULYA, TANGERANG, BANTEN",2,73,153,226
https://kawalpemilu.org#52538,"PARAHU, SUKAMULYA, TANGERANG, BANTEN",3,79,107,186
https://kawalpemilu.org#52538,"PARAHU, SUKAMULYA, TANGERANG, BANTEN",4,58,101,159
https://kawalpemilu.org#52538,"PARAHU, SUKAMULYA, TANGERANG, BANTEN",5,49,158,207
https://kawalpemilu.org#52538,"PARAHU, SUKAMULYA, TANGERANG, BANTEN",6,58,144,202
https://kawalpemilu.org#52538,"PARAHU, SUKAMULYA, TANGERANG, BANTEN",7,38,191,229
https://kawalpemilu.org#52538,"PARAHU, SUKAMULYA, TANGERANG, BANTEN",8,57,96,153
https://kawalpemilu.org#52538,"PARAHU, SUKAMULYA, TANGERANG, BANTEN",9,52,136,188
https://kawalpemilu.org#52538,"PARAHU, SUKAMULYA, TANGERANG, BANTEN",10,41,127,168
https://kawalpemilu.org#52538,"PARAHU, SUKAMULYA, TANGERANG, BANTEN",11,46,111,157
https://kawalpemilu.org#52538,"PARAHU, SUKAMULYA, TANGERANG, BANTEN",13,45,112,157
https://kawalpemilu.org#52538,"PARAHU, SUKAMULYA, TANGERANG, BANTEN",17,70,98,168
https://kawalpemilu.org#52538,"PARAHU, SUKAMULYA, TANGERANG, BANTEN",18,48,171,219
https://kawalpemilu.org#52538,"PARAHU, SUKAMULYA, TANGERANG, BANTEN",19,44,140,184
https://kawalpemilu.org#52538,"PARAHU, SUKAMULYA, TANGERANG, BANTEN",20,40,134,174
https://kawalpemilu.org#52538,"PARAHU, SUKAMULYA, TANGERANG, BANTEN",21,78,109,187
https://kawalpemilu.org#52538,"PARAHU, SUKAMULYA, TANGERANG, BANTEN",23,76,190,266
https://kawalpemilu.org#52538,"PARAHU, SUKAMULYA, TANGERANG, BANTEN",24,81,130,211
https://kawalpemilu.org#52538,"PARAHU, SUKAMULYA, TANGERANG, BANTEN",25,53,121,174
https://kawalpemilu.org#52538,"PARAHU, SUKAMULYA, TANGERANG, BANTEN",26,40,131,171
https://kawalpemilu.org#52538,"PARAHU, SUKAMULYA, TANGERANG, BANTEN",27,40,115,155
https://kawalpemilu.org#52538,"PARAHU, SUKAMULYA, TANGERANG, BANTEN",28,81,115,196
https://kawalpemilu.org#52538,"PARAHU, SUKAMULYA, TANGERANG, BANTEN",30,95,99,194
https://kawalpemilu.org#52538,"PARAHU, SUKAMULYA, TANGERANG, BANTEN",31,83,128,211
https://kawalpemilu.org#52538,"PARAHU, SUKAMULYA, TANGERANG, BANTEN",33,84,125,209
https://kawalpemilu.org#52538,"PARAHU, SUKAMULYA, TANGERANG, BANTEN",34,85,129,214
https://kawalpemilu.org#52538,"PARAHU, SUKAMULYA, TANGERANG, BANTEN",35,0,0,0
https://kawalpemilu.org#52538,"PARAHU, SUKAMULYA, TANGERANG, BANTEN",36,64,87,151
https://kawalpemilu.org#52538,"PARAHU, SUKAMULYA, TANGERANG, BANTEN",37,99,72,171
https://kawalpemilu.org#52538,"PARAHU, SUKAMULYA, TANGERANG, BANTEN",38,115,82,197
https://kawalpemilu.org#52538,"PARAHU, SUKAMULYA, TANGERANG, BANTEN",40,80,123,203
https://kawalpemilu.org#52538,"PARAHU, SUKAMULYA, TANGERANG, BANTEN",42,29,58,87
https://kawalpemilu.org#52538,"PARAHU, SUKAMULYA, TANGERANG, BANTEN",43,40,130,170
https://kawalpemilu.org#52539,"MERAK, SUKAMULYA, TANGERANG, BANTEN",1,71,139,210
https://kawalpemilu.org#52539,"MERAK, SUKAMULYA, TANGERANG, BANTEN",2,50,98,148
https://kawalpemilu.org#52539,"MERAK, SUKAMULYA, TANGERANG, BANTEN",3,65,112,117
https://kawalpemilu.org#52539,"MERAK, SUKAMULYA, TANGERANG, BANTEN",4,76,172,248
https://kawalpemilu.org#52539,"MERAK, SUKAMULYA, TANGERANG, BANTEN",5,50,152,202
https://kawalpemilu.org#52539,"MERAK, SUKAMULYA, TANGERANG, BANTEN",6,45,108,153
https://kawalpemilu.org#52539,"MERAK, SUKAMULYA, TANGERANG, BANTEN",7,48,164,212
https://kawalpemilu.org#52539,"MERAK, SUKAMULYA, TANGERANG, BANTEN",8,15,91,106
https://kawalpemilu.org#52539,"MERAK, SUKAMULYA, TANGERANG, BANTEN",9,36,105,141
https://kawalpemilu.org#52539,"MERAK, SUKAMULYA, TANGERANG, BANTEN",10,65,123,188
https://kawalpemilu.org#52539,"MERAK, SUKAMULYA, TANGERANG, BANTEN",11,37,77,114
https://kawalpemilu.org#52539,"MERAK, SUKAMULYA, TANGERANG, BANTEN",12,39,88,127
https://kawalpemilu.org#52539,"MERAK, SUKAMULYA, TANGERANG, BANTEN",13,69,54,123
https://kawalpemilu.org#52539,"MERAK, SUKAMULYA, TANGERANG, BANTEN",16,64,116,180
https://kawalpemilu.org#52539,"MERAK, SUKAMULYA, TANGERANG, BANTEN",17,31,120,151
https://kawalpemilu.org#52539,"MERAK, SUKAMULYA, TANGERANG, BANTEN",18,22,133,155
https://kawalpemilu.org#52539,"MERAK, SUKAMULYA, TANGERANG, BANTEN",19,50,103,153
https://kawalpemilu.org#52539,"MERAK, SUKAMULYA, TANGERANG, BANTEN",20,65,125,190
https://kawalpemilu.org#52539,"MERAK, SUKAMULYA, TANGERANG, BANTEN",21,25,101,126
https://kawalpemilu.org#52539,"MERAK, SUKAMULYA, TANGERANG, BANTEN",22,18,122,140
https://kawalpemilu.org#52539,"MERAK, SUKAMULYA, TANGERANG, BANTEN",24,45,61,106
https://kawalpemilu.org#52539,"MERAK, SUKAMULYA, TANGERANG, BANTEN",25,71,102,173
https://kawalpemilu.org#52539,"MERAK, SUKAMULYA, TANGERANG, BANTEN",26,65,106,171
https://kawalpemilu.org#52539,"MERAK, SUKAMULYA, TANGERANG, BANTEN",27,17,140,157
https://kawalpemilu.org#52539,"MERAK, SUKAMULYA, TANGERANG, BANTEN",28,37,92,129
https://kawalpemilu.org#52539,"MERAK, SUKAMULYA, TANGERANG, BANTEN",29,67,116,183
https://kawalpemilu.org#52539,"MERAK, SUKAMULYA, TANGERANG, BANTEN",30,101,136,237
https://kawalpemilu.org#52539,"MERAK, SUKAMULYA, TANGERANG, BANTEN",31,75,81,156
https://kawalpemilu.org#52539,"MERAK, SUKAMULYA, TANGERANG, BANTEN",32,40,89,129
https://kawalpemilu.org#52540,"BUNAR, SUKAMULYA, TANGERANG, BANTEN",1,52,150,202
https://kawalpemilu.org#52540,"BUNAR, SUKAMULYA, TANGERANG, BANTEN",2,60,151,211
https://kawalpemilu.org#52540,"BUNAR, SUKAMULYA, TANGERANG, BANTEN",3,58,118,176
https://kawalpemilu.org#52540,"BUNAR, SUKAMULYA, TANGERANG, BANTEN",4,72,146,218
https://kawalpemilu.org#52540,"BUNAR, SUKAMULYA, TANGERANG, BANTEN",5,45,121,166
https://kawalpemilu.org#52540,"BUNAR, SUKAMULYA, TANGERANG, BANTEN",6,41,113,154
https://kawalpemilu.org#52540,"BUNAR, SUKAMULYA, TANGERANG, BANTEN",7,57,150,207
https://kawalpemilu.org#52540,"BUNAR, SUKAMULYA, TANGERANG, BANTEN",8,60,127,187
https://kawalpemilu.org#52540,"BUNAR, SUKAMULYA, TANGERANG, BANTEN",9,25,141,166
https://kawalpemilu.org#52540,"BUNAR, SUKAMULYA, TANGERANG, BANTEN",10,56,176,232
https://kawalpemilu.org#52540,"BUNAR, SUKAMULYA, TANGERANG, BANTEN",12,85,131,216
https://kawalpemilu.org#52540,"BUNAR, SUKAMULYA, TANGERANG, BANTEN",13,92,174,266
https://kawalpemilu.org#52540,"BUNAR, SUKAMULYA, TANGERANG, BANTEN",14,44,133,177
https://kawalpemilu.org#52540,"BUNAR, SUKAMULYA, TANGERANG, BANTEN",15,37,110,147
https://kawalpemilu.org#52540,"BUNAR, SUKAMULYA, TANGERANG, BANTEN",18,54,129,183
https://kawalpemilu.org#52540,"BUNAR, SUKAMULYA, TANGERANG, BANTEN",19,61,113,174
https://kawalpemilu.org#52540,"BUNAR, SUKAMULYA, TANGERANG, BANTEN",20,95,127,222
https://kawalpemilu.org#52540,"BUNAR, SUKAMULYA, TANGERANG, BANTEN",21,59,171,230
https://kawalpemilu.org#52540,"BUNAR, SUKAMULYA, TANGERANG, BANTEN",22,63,179,242
https://kawalpemilu.org#52540,"BUNAR, SUKAMULYA, TANGERANG, BANTEN",23,39,211,250
https://kawalpemilu.org#52540,"BUNAR, SUKAMULYA, TANGERANG, BANTEN",24,47,114,161
https://kawalpemilu.org#52540,"BUNAR, SUKAMULYA, TANGERANG, BANTEN",25,41,119,160
https://kawalpemilu.org#52541,"KUBANG, SUKAMULYA, TANGERANG, BANTEN",1,58,155,213
https://kawalpemilu.org#52541,"KUBANG, SUKAMULYA, TANGERANG, BANTEN",2,62,161,223
https://kawalpemilu.org#52541,"KUBANG, SUKAMULYA, TANGERANG, BANTEN",3,34,169,203
https://kawalpemilu.org#52541,"KUBANG, SUKAMULYA, TANGERANG, BANTEN",4,55,166,221
https://kawalpemilu.org#52541,"KUBANG, SUKAMULYA, TANGERANG, BANTEN",6,101,112,213
https://kawalpemilu.org#52541,"KUBANG, SUKAMULYA, TANGERANG, BANTEN",7,106,103,209
https://kawalpemilu.org#52541,"KUBANG, SUKAMULYA, TANGERANG, BANTEN",8,83,117,200
https://kawalpemilu.org#52541,"KUBANG, SUKAMULYA, TANGERANG, BANTEN",9,77,106,183
https://kawalpemilu.org#52541,"KUBANG, SUKAMULYA, TANGERANG, BANTEN",10,104,75,179
https://kawalpemilu.org#52541,"KUBANG, SUKAMULYA, TANGERANG, BANTEN",11,67,61,128
https://kawalpemilu.org#52541,"KUBANG, SUKAMULYA, TANGERANG, BANTEN",13,114,107,221
https://kawalpemilu.org#52541,"KUBANG, SUKAMULYA, TANGERANG, BANTEN",14,95,97,192
https://kawalpemilu.org#52541,"KUBANG, SUKAMULYA, TANGERANG, BANTEN",16,108,77,187
https://kawalpemilu.org#52541,"KUBANG, SUKAMULYA, TANGERANG, BANTEN",17,96,85,181
https://kawalpemilu.org#52541,"KUBANG, SUKAMULYA, TANGERANG, BANTEN",18,104,111,215
https://kawalpemilu.org#52541,"KUBANG, SUKAMULYA, TANGERANG, BANTEN",19,115,93,208
https://kawalpemilu.org#52543,"KELAPA DUA, KELAPA DUA, TANGERANG, BANTEN",2,48,114,162
https://kawalpemilu.org#52543,"KELAPA DUA, KELAPA DUA, TANGERANG, BANTEN",4,47,174,221
https://kawalpemilu.org#52543,"KELAPA DUA, KELAPA DUA, TANGERANG, BANTEN",5,85,166,251
https://kawalpemilu.org#52543,"KELAPA DUA, KELAPA DUA, TANGERANG, BANTEN",6,32,182,214
https://kawalpemilu.org#52543,"KELAPA DUA, KELAPA DUA, TANGERANG, BANTEN",8,55,178,233
https://kawalpemilu.org#52543,"KELAPA DUA, KELAPA DUA, TANGERANG, BANTEN",9,74,178,252
https://kawalpemilu.org#52543,"KELAPA DUA, KELAPA DUA, TANGERANG, BANTEN",10,73,154,227
https://kawalpemilu.org#52543,"KELAPA DUA, KELAPA DUA, TANGERANG, BANTEN",11,73,60,133
https://kawalpemilu.org#52543,"KELAPA DUA, KELAPA DUA, TANGERANG, BANTEN",12,96,93,189
https://kawalpemilu.org#52543,"KELAPA DUA, KELAPA DUA, TANGERANG, BANTEN",15,93,115,208
https://kawalpemilu.org#52543,"KELAPA DUA, KELAPA DUA, TANGERANG, BANTEN",16,89,138,227
https://kawalpemilu.org#52543,"KELAPA DUA, KELAPA DUA, TANGERANG, BANTEN",19,99,127,226
https://kawalpemilu.org#52543,"KELAPA DUA, KELAPA DUA, TANGERANG, BANTEN",20,54,87,141
https://kawalpemilu.org#52543,"KELAPA DUA, KELAPA DUA, TANGERANG, BANTEN",21,53,132,185
https://kawalpemilu.org#52543,"KELAPA DUA, KELAPA DUA, TANGERANG, BANTEN",23,70,143,213
https://kawalpemilu.org#52543,"KELAPA DUA, KELAPA DUA, TANGERANG, BANTEN",25,62,117,179
https://kawalpemilu.org#52543,"KELAPA DUA, KELAPA DUA, TANGERANG, BANTEN",26,75,119,194
https://kawalpemilu.org#52543,"KELAPA DUA, KELAPA DUA, TANGERANG, BANTEN",27,62,69,131
https://kawalpemilu.org#52543,"KELAPA DUA, KELAPA DUA, TANGERANG, BANTEN",29,72,89,161
https://kawalpemilu.org#52543,"KELAPA DUA, KELAPA DUA, TANGERANG, BANTEN",30,101,81,182
https://kawalpemilu.org#52543,"KELAPA DUA, KELAPA DUA, TANGERANG, BANTEN",31,66,152,218
https://kawalpemilu.org#52543,"KELAPA DUA, KELAPA DUA, TANGERANG, BANTEN",32,101,127,228
https://kawalpemilu.org#52543,"KELAPA DUA, KELAPA DUA, TANGERANG, BANTEN",33,75,127,202
https://kawalpemilu.org#52543,"KELAPA DUA, KELAPA DUA, TANGERANG, BANTEN",34,72,66,138
https://kawalpemilu.org#52543,"KELAPA DUA, KELAPA DUA, TANGERANG, BANTEN",35,64,100,164
https://kawalpemilu.org#52543,"KELAPA DUA, KELAPA DUA, TANGERANG, BANTEN",36,110,131,241
https://kawalpemilu.org#52543,"KELAPA DUA, KELAPA DUA, TANGERANG, BANTEN",37,78,128,206
https://kawalpemilu.org#52543,"KELAPA DUA, KELAPA DUA, TANGERANG, BANTEN",38,67,155,222
https://kawalpemilu.org#52543,"KELAPA DUA, KELAPA DUA, TANGERANG, BANTEN",39,96,120,216
https://kawalpemilu.org#52543,"KELAPA DUA, KELAPA DUA, TANGERANG, BANTEN",40,85,105,190
https://kawalpemilu.org#52543,"KELAPA DUA, KELAPA DUA, TANGERANG, BANTEN",41,92,99,191
https://kawalpemilu.org#52543,"KELAPA DUA, KELAPA DUA, TANGERANG, BANTEN",42,91,134,225
https://kawalpemilu.org#52543,"KELAPA DUA, KELAPA DUA, TANGERANG, BANTEN",43,41,72,113
https://kawalpemilu.org#52543,"KELAPA DUA, KELAPA DUA, TANGERANG, BANTEN",44,68,111,179
https://kawalpemilu.org#52543,"KELAPA DUA, KELAPA DUA, TANGERANG, BANTEN",45,82,96,178
https://kawalpemilu.org#52543,"KELAPA DUA, KELAPA DUA, TANGERANG, BANTEN",46,82,81,163
https://kawalpemilu.org#52543,"KELAPA DUA, KELAPA DUA, TANGERANG, BANTEN",47,77,121,198
https://kawalpemilu.org#52543,"KELAPA DUA, KELAPA DUA, TANGERANG, BANTEN",48,67,117,184
https://kawalpemilu.org#52543,"KELAPA DUA, KELAPA DUA, TANGERANG, BANTEN",49,58,81,139
https://kawalpemilu.org#52543,"KELAPA DUA, KELAPA DUA, TANGERANG, BANTEN",50,84,78,162
https://kawalpemilu.org#52543,"KELAPA DUA, KELAPA DUA, TANGERANG, BANTEN",51,60,111,171
https://kawalpemilu.org#52543,"KELAPA DUA, KELAPA DUA, TANGERANG, BANTEN",53,81,78,159
https://kawalpemilu.org#52543,"KELAPA DUA, KELAPA DUA, TANGERANG, BANTEN",54,43,72,115
https://kawalpemilu.org#52543,"KELAPA DUA, KELAPA DUA, TANGERANG, BANTEN",55,43,68,111
https://kawalpemilu.org#52543,"KELAPA DUA, KELAPA DUA, TANGERANG, BANTEN",56,194,9,203
https://kawalpemilu.org#52543,"KELAPA DUA, KELAPA DUA, TANGERANG, BANTEN",57,159,5,164
https://kawalpemilu.org#52543,"KELAPA DUA, KELAPA DUA, TANGERANG, BANTEN",58,167,7,174
https://kawalpemilu.org#52543,"KELAPA DUA, KELAPA DUA, TANGERANG, BANTEN",59,268,16,284
https://kawalpemilu.org#52543,"KELAPA DUA, KELAPA DUA, TANGERANG, BANTEN",60,54,176,230
https://kawalpemilu.org#52543,"KELAPA DUA, KELAPA DUA, TANGERANG, BANTEN",61,52,165,217
https://kawalpemilu.org#52543,"KELAPA DUA, KELAPA DUA, TANGERANG, BANTEN",62,47,91,138
https://kawalpemilu.org#52543,"KELAPA DUA, KELAPA DUA, TANGERANG, BANTEN",63,46,167,213
https://kawalpemilu.org#52543,"KELAPA DUA, KELAPA DUA, TANGERANG, BANTEN",64,35,189,224
https://kawalpemilu.org#52543,"KELAPA DUA, KELAPA DUA, TANGERANG, BANTEN",65,54,168,224
https://kawalpemilu.org#52543,"KELAPA DUA, KELAPA DUA, TANGERANG, BANTEN",67,44,136,180
https://kawalpemilu.org#52543,"KELAPA DUA, KELAPA DUA, TANGERANG, BANTEN",69,58,117,175
https://kawalpemilu.org#52543,"KELAPA DUA, KELAPA DUA, TANGERANG, BANTEN",71,59,193,252
https://kawalpemilu.org#52543,"KELAPA DUA, KELAPA DUA, TANGERANG, BANTEN",72,174,6,180
https://kawalpemilu.org#52543,"KELAPA DUA, KELAPA DUA, TANGERANG, BANTEN",73,24,94,118
https://kawalpemilu.org#52543,"KELAPA DUA, KELAPA DUA, TANGERANG, BANTEN",74,32,75,107
https://kawalpemilu.org#52543,"KELAPA DUA, KELAPA DUA, TANGERANG, BANTEN",75,206,15,221
https://kawalpemilu.org#52543,"KELAPA DUA, KELAPA DUA, TANGERANG, BANTEN",76,54,85,139
https://kawalpemilu.org#52543,"KELAPA DUA, KELAPA DUA, TANGERANG, BANTEN",77,83,86,169
https://kawalpemilu.org#52543,"KELAPA DUA, KELAPA DUA, TANGERANG, BANTEN",78,76,105,181
https://kawalpemilu.org#52543,"KELAPA DUA, KELAPA DUA, TANGERANG, BANTEN",79,70,82,152
https://kawalpemilu.org#52543,"KELAPA DUA, KELAPA DUA, TANGERANG, BANTEN",80,51,84,115
https://kawalpemilu.org#52543,"KELAPA DUA, KELAPA DUA, TANGERANG, BANTEN",81,66,57,123
https://kawalpemilu.org#52543,"KELAPA DUA, KELAPA DUA, TANGERANG, BANTEN",82,76,108,184
https://kawalpemilu.org#52543,"KELAPA DUA, KELAPA DUA, TANGERANG, BANTEN",83,93,133,226
https://kawalpemilu.org#52543,"KELAPA DUA, KELAPA DUA, TANGERANG, BANTEN",84,62,103,165
https://kawalpemilu.org#52543,"KELAPA DUA, KELAPA DUA, TANGERANG, BANTEN",85,71,42,113
https://kawalpemilu.org#52543,"KELAPA DUA, KELAPA DUA, TANGERANG, BANTEN",86,53,118,171
https://kawalpemilu.org#52543,"KELAPA DUA, KELAPA DUA, TANGERANG, BANTEN",87,29,59,88
https://kawalpemilu.org#52543,"KELAPA DUA, KELAPA DUA, TANGERANG, BANTEN",88,191,10,201
https://kawalpemilu.org#52543,"KELAPA DUA, KELAPA DUA, TANGERANG, BANTEN",89,172,9,181
https://kawalpemilu.org#52543,"KELAPA DUA, KELAPA DUA, TANGERANG, BANTEN",90,21,100,121
https://kawalpemilu.org#52543,"KELAPA DUA, KELAPA DUA, TANGERANG, BANTEN",91,26,160,186
https://kawalpemilu.org#52543,"KELAPA DUA, KELAPA DUA, TANGERANG, BANTEN",92,88,132,220
https://kawalpemilu.org#52543,"KELAPA DUA, KELAPA DUA, TANGERANG, BANTEN",93,265,3,268
https://kawalpemilu.org#52543,"KELAPA DUA, KELAPA DUA, TANGERANG, BANTEN",94,300,3,303
https://kawalpemilu.org#52543,"KELAPA DUA, KELAPA DUA, TANGERANG, BANTEN",95,280,4,284
https://kawalpemilu.org#52543,"KELAPA DUA, KELAPA DUA, TANGERANG, BANTEN",96,224,8,232
https://kawalpemilu.org#52543,"KELAPA DUA, KELAPA DUA, TANGERANG, BANTEN",97,296,5,301
https://kawalpemilu.org#52543,"KELAPA DUA, KELAPA DUA, TANGERANG, BANTEN",98,299,9,308
https://kawalpemilu.org#52543,"KELAPA DUA, KELAPA DUA, TANGERANG, BANTEN",99,184,4,188
https://kawalpemilu.org#52544,"BENCONGAN, KELAPA DUA, TANGERANG, BANTEN",1,89,119,28
https://kawalpemilu.org#52544,"BENCONGAN, KELAPA DUA, TANGERANG, BANTEN",2,79,120,199
https://kawalpemilu.org#52544,"BENCONGAN, KELAPA DUA, TANGERANG, BANTEN",3,88,106,194
https://kawalpemilu.org#52544,"BENCONGAN, KELAPA DUA, TANGERANG, BANTEN",4,81,111,192
https://kawalpemilu.org#52544,"BENCONGAN, KELAPA DUA, TANGERANG, BANTEN",5,99,101,200
https://kawalpemilu.org#52544,"BENCONGAN, KELAPA DUA, TANGERANG, BANTEN",6,102,88,190
https://kawalpemilu.org#52544,"BENCONGAN, KELAPA DUA, TANGERANG, BANTEN",7,30,28,58
https://kawalpemilu.org#52544,"BENCONGAN, KELAPA DUA, TANGERANG, BANTEN",8,90,103,193
https://kawalpemilu.org#52544,"BENCONGAN, KELAPA DUA, TANGERANG, BANTEN",9,53,100,153
https://kawalpemilu.org#52544,"BENCONGAN, KELAPA DUA, TANGERANG, BANTEN",10,71,93,164
https://kawalpemilu.org#52544,"BENCONGAN, KELAPA DUA, TANGERANG, BANTEN",12,62,82,144
https://kawalpemilu.org#52544,"BENCONGAN, KELAPA DUA, TANGERANG, BANTEN",13,75,67,142
https://kawalpemilu.org#52544,"BENCONGAN, KELAPA DUA, TANGERANG, BANTEN",14,100,104,204
https://kawalpemilu.org#52544,"BENCONGAN, KELAPA DUA, TANGERANG, BANTEN",15,138,69,207
https://kawalpemilu.org#52544,"BENCONGAN, KELAPA DUA, TANGERANG, BANTEN",16,124,77,201
https://kawalpemilu.org#52544,"BENCONGAN, KELAPA DUA, TANGERANG, BANTEN",17,117,96,213
https://kawalpemilu.org#52544,"BENCONGAN, KELAPA DUA, TANGERANG, BANTEN",18,88,149,237
https://kawalpemilu.org#52544,"BENCONGAN, KELAPA DUA, TANGERANG, BANTEN",19,137,116,253
https://kawalpemilu.org#52544,"BENCONGAN, KELAPA DUA, TANGERANG, BANTEN",21,92,52,144
https://kawalpemilu.org#52544,"BENCONGAN, KELAPA DUA, TANGERANG, BANTEN",22,63,100,163
https://kawalpemilu.org#52544,"BENCONGAN, KELAPA DUA, TANGERANG, BANTEN",24,66,90,156
https://kawalpemilu.org#52544,"BENCONGAN, KELAPA DUA, TANGERANG, BANTEN",25,59,124,183
https://kawalpemilu.org#52544,"BENCONGAN, KELAPA DUA, TANGERANG, BANTEN",26,63,97,160
https://kawalpemilu.org#52544,"BENCONGAN, KELAPA DUA, TANGERANG, BANTEN",27,45,89,134
https://kawalpemilu.org#52544,"BENCONGAN, KELAPA DUA, TANGERANG, BANTEN",28,0,0,0
https://kawalpemilu.org#52544,"BENCONGAN, KELAPA DUA, TANGERANG, BANTEN",29,66,147,213
https://kawalpemilu.org#52544,"BENCONGAN, KELAPA DUA, TANGERANG, BANTEN",31,79,106,185
https://kawalpemilu.org#52544,"BENCONGAN, KELAPA DUA, TANGERANG, BANTEN",32,79,78,157
https://kawalpemilu.org#52544,"BENCONGAN, KELAPA DUA, TANGERANG, BANTEN",33,77,91,168
https://kawalpemilu.org#52544,"BENCONGAN, KELAPA DUA, TANGERANG, BANTEN",34,78,117,195
https://kawalpemilu.org#52544,"BENCONGAN, KELAPA DUA, TANGERANG, BANTEN",36,92,101,193
https://kawalpemilu.org#52544,"BENCONGAN, KELAPA DUA, TANGERANG, BANTEN",37,119,83,202
https://kawalpemilu.org#52544,"BENCONGAN, KELAPA DUA, TANGERANG, BANTEN",39,82,110,192
https://kawalpemilu.org#52544,"BENCONGAN, KELAPA DUA, TANGERANG, BANTEN",40,79,122,201
https://kawalpemilu.org#52544,"BENCONGAN, KELAPA DUA, TANGERANG, BANTEN",41,145,103,248
https://kawalpemilu.org#52544,"BENCONGAN, KELAPA DUA, TANGERANG, BANTEN",42,128,98,226
https://kawalpemilu.org#52544,"BENCONGAN, KELAPA DUA, TANGERANG, BANTEN",44,103,87,184
https://kawalpemilu.org#52544,"BENCONGAN, KELAPA DUA, TANGERANG, BANTEN",45,79,87,166
https://kawalpemilu.org#52544,"BENCONGAN, KELAPA DUA, TANGERANG, BANTEN",46,92,81,173
https://kawalpemilu.org#52544,"BENCONGAN, KELAPA DUA, TANGERANG, BANTEN",48,109,126,235
https://kawalpemilu.org#52544,"BENCONGAN, KELAPA DUA, TANGERANG, BANTEN",49,95,98,193
https://kawalpemilu.org#52544,"BENCONGAN, KELAPA DUA, TANGERANG, BANTEN",50,67,95,162
https://kawalpemilu.org#52544,"BENCONGAN, KELAPA DUA, TANGERANG, BANTEN",51,93,97,190
https://kawalpemilu.org#52544,"BENCONGAN, KELAPA DUA, TANGERANG, BANTEN",52,80,119,199
https://kawalpemilu.org#52544,"BENCONGAN, KELAPA DUA, TANGERANG, BANTEN",53,75,92,167
https://kawalpemilu.org#52544,"BENCONGAN, KELAPA DUA, TANGERANG, BANTEN",54,95,81,176
https://kawalpemilu.org#52544,"BENCONGAN, KELAPA DUA, TANGERANG, BANTEN",55,91,120,211
https://kawalpemilu.org#52544,"BENCONGAN, KELAPA DUA, TANGERANG, BANTEN",56,69,121,190
https://kawalpemilu.org#52544,"BENCONGAN, KELAPA DUA, TANGERANG, BANTEN",57,109,124,233
https://kawalpemilu.org#52544,"BENCONGAN, KELAPA DUA, TANGERANG, BANTEN",58,139,105,244
https://kawalpemilu.org#52544,"BENCONGAN, KELAPA DUA, TANGERANG, BANTEN",59,93,100,193
https://kawalpemilu.org#52544,"BENCONGAN, KELAPA DUA, TANGERANG, BANTEN",60,72,126,198
https://kawalpemilu.org#52544,"BENCONGAN, KELAPA DUA, TANGERANG, BANTEN",61,76,118,194
https://kawalpemilu.org#52544,"BENCONGAN, KELAPA DUA, TANGERANG, BANTEN",62,0,0,0
https://kawalpemilu.org#52544,"BENCONGAN, KELAPA DUA, TANGERANG, BANTEN",63,79,137,216
https://kawalpemilu.org#52544,"BENCONGAN, KELAPA DUA, TANGERANG, BANTEN",64,108,123,231
https://kawalpemilu.org#52544,"BENCONGAN, KELAPA DUA, TANGERANG, BANTEN",65,103,137,240
https://kawalpemilu.org#52544,"BENCONGAN, KELAPA DUA, TANGERANG, BANTEN",67,60,81,141
https://kawalpemilu.org#52544,"BENCONGAN, KELAPA DUA, TANGERANG, BANTEN",68,101,85,186
https://kawalpemilu.org#52544,"BENCONGAN, KELAPA DUA, TANGERANG, BANTEN",69,83,97,180
https://kawalpemilu.org#52544,"BENCONGAN, KELAPA DUA, TANGERANG, BANTEN",70,96,95,191
https://kawalpemilu.org#52544,"BENCONGAN, KELAPA DUA, TANGERANG, BANTEN",71,70,102,172
https://kawalpemilu.org#52544,"BENCONGAN, KELAPA DUA, TANGERANG, BANTEN",72,54,87,141
https://kawalpemilu.org#52544,"BENCONGAN, KELAPA DUA, TANGERANG, BANTEN",73,100,116,216
https://kawalpemilu.org#52544,"BENCONGAN, KELAPA DUA, TANGERANG, BANTEN",74,89,119,208
https://kawalpemilu.org#52544,"BENCONGAN, KELAPA DUA, TANGERANG, BANTEN",75,73,80,153
https://kawalpemilu.org#52544,"BENCONGAN, KELAPA DUA, TANGERANG, BANTEN",76,68,77,145
https://kawalpemilu.org#52544,"BENCONGAN, KELAPA DUA, TANGERANG, BANTEN",77,70,152,222
https://kawalpemilu.org#52544,"BENCONGAN, KELAPA DUA, TANGERANG, BANTEN",79,88,144,232
https://kawalpemilu.org#52544,"BENCONGAN, KELAPA DUA, TANGERANG, BANTEN",80,80,85,165
https://kawalpemilu.org#52544,"BENCONGAN, KELAPA DUA, TANGERANG, BANTEN",81,70,80,150
https://kawalpemilu.org#52544,"BENCONGAN, KELAPA DUA, TANGERANG, BANTEN",82,92,140,232
https://kawalpemilu.org#52544,"BENCONGAN, KELAPA DUA, TANGERANG, BANTEN",83,127,86,213
https://kawalpemilu.org#52544,"BENCONGAN, KELAPA DUA, TANGERANG, BANTEN",84,84,122,206
https://kawalpemilu.org#52544,"BENCONGAN, KELAPA DUA, TANGERANG, BANTEN",85,55,130,185
https://kawalpemilu.org#52544,"BENCONGAN, KELAPA DUA, TANGERANG, BANTEN",86,106,110,216
https://kawalpemilu.org#52544,"BENCONGAN, KELAPA DUA, TANGERANG, BANTEN",87,90,113,203
https://kawalpemilu.org#52544,"BENCONGAN, KELAPA DUA, TANGERANG, BANTEN",89,76,101,177
https://kawalpemilu.org#52544,"BENCONGAN, KELAPA DUA, TANGERANG, BANTEN",90,103,71,174
https://kawalpemilu.org#52544,"BENCONGAN, KELAPA DUA, TANGERANG, BANTEN",91,84,107,191
https://kawalpemilu.org#52544,"BENCONGAN, KELAPA DUA, TANGERANG, BANTEN",92,62,105,167
https://kawalpemilu.org#52544,"BENCONGAN, KELAPA DUA, TANGERANG, BANTEN",93,60,96,156
https://kawalpemilu.org#52544,"BENCONGAN, KELAPA DUA, TANGERANG, BANTEN",94,79,89,168
https://kawalpemilu.org#52544,"BENCONGAN, KELAPA DUA, TANGERANG, BANTEN",95,68,88,156
https://kawalpemilu.org#52544,"BENCONGAN, KELAPA DUA, TANGERANG, BANTEN",96,78,101,179
https://kawalpemilu.org#52544,"BENCONGAN, KELAPA DUA, TANGERANG, BANTEN",98,75,71,146
https://kawalpemilu.org#52544,"BENCONGAN, KELAPA DUA, TANGERANG, BANTEN",99,40,88,128
https://kawalpemilu.org#52544,"BENCONGAN, KELAPA DUA, TANGERANG, BANTEN",100,145,77,222
https://kawalpemilu.org#52544,"BENCONGAN, KELAPA DUA, TANGERANG, BANTEN",101,128,81,209
https://kawalpemilu.org#52544,"BENCONGAN, KELAPA DUA, TANGERANG, BANTEN",102,133,36,169
https://kawalpemilu.org#52544,"BENCONGAN, KELAPA DUA, TANGERANG, BANTEN",103,117,89,206
https://kawalpemilu.org#52544,"BENCONGAN, KELAPA DUA, TANGERANG, BANTEN",104,100,80,180
https://kawalpemilu.org#52544,"BENCONGAN, KELAPA DUA, TANGERANG, BANTEN",105,80,79,159
https://kawalpemilu.org#52544,"BENCONGAN, KELAPA DUA, TANGERANG, BANTEN",106,93,89,182
https://kawalpemilu.org#52544,"BENCONGAN, KELAPA DUA, TANGERANG, BANTEN",107,109,107,216
https://kawalpemilu.org#52544,"BENCONGAN, KELAPA DUA, TANGERANG, BANTEN",108,80,113,193
https://kawalpemilu.org#52544,"BENCONGAN, KELAPA DUA, TANGERANG, BANTEN",110,96,85,181
https://kawalpemilu.org#52544,"BENCONGAN, KELAPA DUA, TANGERANG, BANTEN",111,116,73,189
https://kawalpemilu.org#52544,"BENCONGAN, KELAPA DUA, TANGERANG, BANTEN",112,107,114,221
https://kawalpemilu.org#52544,"BENCONGAN, KELAPA DUA, TANGERANG, BANTEN",113,84,120,204
https://kawalpemilu.org#52544,"BENCONGAN, KELAPA DUA, TANGERANG, BANTEN",115,108,31,139
https://kawalpemilu.org#52544,"BENCONGAN, KELAPA DUA, TANGERANG, BANTEN",116,71,85,156
https://kawalpemilu.org#52544,"BENCONGAN, KELAPA DUA, TANGERANG, BANTEN",117,90,50,140
https://kawalpemilu.org#52544,"BENCONGAN, KELAPA DUA, TANGERANG, BANTEN",118,89,82,171
https://kawalpemilu.org#52544,"BENCONGAN, KELAPA DUA, TANGERANG, BANTEN",119,86,96,182
https://kawalpemilu.org#52544,"BENCONGAN, KELAPA DUA, TANGERANG, BANTEN",120,93,81,174
https://kawalpemilu.org#52544,"BENCONGAN, KELAPA DUA, TANGERANG, BANTEN",121,95,74,169
https://kawalpemilu.org#52544,"BENCONGAN, KELAPA DUA, TANGERANG, BANTEN",122,101,103,204
https://kawalpemilu.org#52544,"BENCONGAN, KELAPA DUA, TANGERANG, BANTEN",123,71,81,152
https://kawalpemilu.org#52544,"BENCONGAN, KELAPA DUA, TANGERANG, BANTEN",124,36,47,83
https://kawalpemilu.org#52544,"BENCONGAN, KELAPA DUA, TANGERANG, BANTEN",126,51,78,129
https://kawalpemilu.org#52544,"BENCONGAN, KELAPA DUA, TANGERANG, BANTEN",127,72,62,134
https://kawalpemilu.org#52544,"BENCONGAN, KELAPA DUA, TANGERANG, BANTEN",128,89,30,119
https://kawalpemilu.org#52544,"BENCONGAN, KELAPA DUA, TANGERANG, BANTEN",129,59,50,107
https://kawalpemilu.org#52544,"BENCONGAN, KELAPA DUA, TANGERANG, BANTEN",130,36,30,66
https://kawalpemilu.org#52544,"BENCONGAN, KELAPA DUA, TANGERANG, BANTEN",131,72,77,149
https://kawalpemilu.org#52544,"BENCONGAN, KELAPA DUA, TANGERANG, BANTEN",132,66,76,142
https://kawalpemilu.org#52544,"BENCONGAN, KELAPA DUA, TANGERANG, BANTEN",133,35,41,76
https://kawalpemilu.org#52544,"BENCONGAN, KELAPA DUA, TANGERANG, BANTEN",134,68,35,103
https://kawalpemilu.org#52544,"BENCONGAN, KELAPA DUA, TANGERANG, BANTEN",135,46,43,89
https://kawalpemilu.org#52544,"BENCONGAN, KELAPA DUA, TANGERANG, BANTEN",136,67,97,164
https://kawalpemilu.org#52544,"BENCONGAN, KELAPA DUA, TANGERANG, BANTEN",137,72,79,151
https://kawalpemilu.org#52544,"BENCONGAN, KELAPA DUA, TANGERANG, BANTEN",138,134,53,187
https://kawalpemilu.org#52544,"BENCONGAN, KELAPA DUA, TANGERANG, BANTEN",139,88,35,123
https://kawalpemilu.org#52544,"BENCONGAN, KELAPA DUA, TANGERANG, BANTEN",140,43,23,66
https://kawalpemilu.org#52545,"BENCONGAN INDAH, KELAPA DUA, TANGERANG, BANTEN",1,92,99,191
https://kawalpemilu.org#52545,"BENCONGAN INDAH, KELAPA DUA, TANGERANG, BANTEN",2,56,101,157
https://kawalpemilu.org#52545,"BENCONGAN INDAH, KELAPA DUA, TANGERANG, BANTEN",3,85,81,166
https://kawalpemilu.org#52545,"BENCONGAN INDAH, KELAPA DUA, TANGERANG, BANTEN",4,72,76,148
https://kawalpemilu.org#52545,"BENCONGAN INDAH, KELAPA DUA, TANGERANG, BANTEN",5,42,86,128
https://kawalpemilu.org#52545,"BENCONGAN INDAH, KELAPA DUA, TANGERANG, BANTEN",6,76,130,206
https://kawalpemilu.org#52545,"BENCONGAN INDAH, KELAPA DUA, TANGERANG, BANTEN",7,61,64,125
https://kawalpemilu.org#52545,"BENCONGAN INDAH, KELAPA DUA, TANGERANG, BANTEN",8,99,104,203
https://kawalpemilu.org#52545,"BENCONGAN INDAH, KELAPA DUA, TANGERANG, BANTEN",9,79,91,170
https://kawalpemilu.org#52545,"BENCONGAN INDAH, KELAPA DUA, TANGERANG, BANTEN",10,70,96,166
https://kawalpemilu.org#52545,"BENCONGAN INDAH, KELAPA DUA, TANGERANG, BANTEN",11,54,90,144
https://kawalpemilu.org#52545,"BENCONGAN INDAH, KELAPA DUA, TANGERANG, BANTEN",12,69,124,193
https://kawalpemilu.org#52545,"BENCONGAN INDAH, KELAPA DUA, TANGERANG, BANTEN",13,53,79,132
https://kawalpemilu.org#52545,"BENCONGAN INDAH, KELAPA DUA, TANGERANG, BANTEN",14,83,44,127
https://kawalpemilu.org#52545,"BENCONGAN INDAH, KELAPA DUA, TANGERANG, BANTEN",15,76,157,233
https://kawalpemilu.org#52545,"BENCONGAN INDAH, KELAPA DUA, TANGERANG, BANTEN",16,92,148,240
https://kawalpemilu.org#52545,"BENCONGAN INDAH, KELAPA DUA, TANGERANG, BANTEN",17,99,154,253
https://kawalpemilu.org#52545,"BENCONGAN INDAH, KELAPA DUA, TANGERANG, BANTEN",18,88,149,237
https://kawalpemilu.org#52545,"BENCONGAN INDAH, KELAPA DUA, TANGERANG, BANTEN",19,55,69,124
https://kawalpemilu.org#52545,"BENCONGAN INDAH, KELAPA DUA, TANGERANG, BANTEN",20,93,117,210
https://kawalpemilu.org#52545,"BENCONGAN INDAH, KELAPA DUA, TANGERANG, BANTEN",21,152,101,253
https://kawalpemilu.org#52545,"BENCONGAN INDAH, KELAPA DUA, TANGERANG, BANTEN",22,83,87,170
https://kawalpemilu.org#52545,"BENCONGAN INDAH, KELAPA DUA, TANGERANG, BANTEN",23,78,112,190
https://kawalpemilu.org#52545,"BENCONGAN INDAH, KELAPA DUA, TANGERANG, BANTEN",24,59,105,164
https://kawalpemilu.org#52545,"BENCONGAN INDAH, KELAPA DUA, TANGERANG, BANTEN",25,90,121,211
https://kawalpemilu.org#52545,"BENCONGAN INDAH, KELAPA DUA, TANGERANG, BANTEN",26,76,94,170
https://kawalpemilu.org#52545,"BENCONGAN INDAH, KELAPA DUA, TANGERANG, BANTEN",27,77,70,147
https://kawalpemilu.org#52545,"BENCONGAN INDAH, KELAPA DUA, TANGERANG, BANTEN",28,167,17,184
https://kawalpemilu.org#52545,"BENCONGAN INDAH, KELAPA DUA, TANGERANG, BANTEN",29,168,9,177
https://kawalpemilu.org#52545,"BENCONGAN INDAH, KELAPA DUA, TANGERANG, BANTEN",30,200,7,207
https://kawalpemilu.org#52545,"BENCONGAN INDAH, KELAPA DUA, TANGERANG, BANTEN",31,181,15,196
https://kawalpemilu.org#52545,"BENCONGAN INDAH, KELAPA DUA, TANGERANG, BANTEN",32,153,8,161
https://kawalpemilu.org#52545,"BENCONGAN INDAH, KELAPA DUA, TANGERANG, BANTEN",33,182,16,0
https://kawalpemilu.org#52545,"BENCONGAN INDAH, KELAPA DUA, TANGERANG, BANTEN",34,182,12,194
https://kawalpemilu.org#52545,"BENCONGAN INDAH, KELAPA DUA, TANGERANG, BANTEN",35,155,17,172
https://kawalpemilu.org#52545,"BENCONGAN INDAH, KELAPA DUA, TANGERANG, BANTEN",36,182,19,201
https://kawalpemilu.org#52545,"BENCONGAN INDAH, KELAPA DUA, TANGERANG, BANTEN",37,159,21,180
https://kawalpemilu.org#52545,"BENCONGAN INDAH, KELAPA DUA, TANGERANG, BANTEN",38,53,86,139
https://kawalpemilu.org#52545,"BENCONGAN INDAH, KELAPA DUA, TANGERANG, BANTEN",39,80,56,136
https://kawalpemilu.org#52545,"BENCONGAN INDAH, KELAPA DUA, TANGERANG, BANTEN",40,70,87,157
https://kawalpemilu.org#52545,"BENCONGAN INDAH, KELAPA DUA, TANGERANG, BANTEN",41,61,76,137
https://kawalpemilu.org#52545,"BENCONGAN INDAH, KELAPA DUA, TANGERANG, BANTEN",42,58,78,136
https://kawalpemilu.org#52546,"PAKULONAN BARAT, KELAPA DUA, TANGERANG, BANTEN",1,250,18,268
https://kawalpemilu.org#52546,"PAKULONAN BARAT, KELAPA DUA, TANGERANG, BANTEN",2,45,140,185
https://kawalpemilu.org#52546,"PAKULONAN BARAT, KELAPA DUA, TANGERANG, BANTEN",3,46,167,213
https://kawalpemilu.org#52546,"PAKULONAN BARAT, KELAPA DUA, TANGERANG, BANTEN",4,37,189,226
https://kawalpemilu.org#52546,"PAKULONAN BARAT, KELAPA DUA, TANGERANG, BANTEN",5,51,156,207
https://kawalpemilu.org#52546,"PAKULONAN BARAT, KELAPA DUA, TANGERANG, BANTEN",6,62,135,197
https://kawalpemilu.org#52546,"PAKULONAN BARAT, KELAPA DUA, TANGERANG, BANTEN",7,71,113,184
https://kawalpemilu.org#52546,"PAKULONAN BARAT, KELAPA DUA, TANGERANG, BANTEN",8,55,116,171
https://kawalpemilu.org#52546,"PAKULONAN BARAT, KELAPA DUA, TANGERANG, BANTEN",9,53,113,166
https://kawalpemilu.org#52546,"PAKULONAN BARAT, KELAPA DUA, TANGERANG, BANTEN",10,37,152,189
https://kawalpemilu.org#52546,"PAKULONAN BARAT, KELAPA DUA, TANGERANG, BANTEN",11,175,0,175
https://kawalpemilu.org#52546,"PAKULONAN BARAT, KELAPA DUA, TANGERANG, BANTEN",12,48,157,205
https://kawalpemilu.org#52546,"PAKULONAN BARAT, KELAPA DUA, TANGERANG, BANTEN",13,40,209,249
https://kawalpemilu.org#52546,"PAKULONAN BARAT, KELAPA DUA, TANGERANG, BANTEN",14,44,185,229
https://kawalpemilu.org#52546,"PAKULONAN BARAT, KELAPA DUA, TANGERANG, BANTEN",15,48,197,245
https://kawalpemilu.org#52546,"PAKULONAN BARAT, KELAPA DUA, TANGERANG, BANTEN",18,72,128,200
https://kawalpemilu.org#52546,"PAKULONAN BARAT, KELAPA DUA, TANGERANG, BANTEN",19,62,145,207
https://kawalpemilu.org#52546,"PAKULONAN BARAT, KELAPA DUA, TANGERANG, BANTEN",20,56,134,190
https://kawalpemilu.org#52546,"PAKULONAN BARAT, KELAPA DUA, TANGERANG, BANTEN",21,19,181,200
https://kawalpemilu.org#52546,"PAKULONAN BARAT, KELAPA DUA, TANGERANG, BANTEN",22,50,150,200
https://kawalpemilu.org#52546,"PAKULONAN BARAT, KELAPA DUA, TANGERANG, BANTEN",23,43,159,202
https://kawalpemilu.org#52546,"PAKULONAN BARAT, KELAPA DUA, TANGERANG, BANTEN",24,50,164,214
https://kawalpemilu.org#52546,"PAKULONAN BARAT, KELAPA DUA, TANGERANG, BANTEN",25,55,156,211
https://kawalpemilu.org#52546,"PAKULONAN BARAT, KELAPA DUA, TANGERANG, BANTEN",26,58,167,225
https://kawalpemilu.org#52546,"PAKULONAN BARAT, KELAPA DUA, TANGERANG, BANTEN",27,76,88,164
https://kawalpemilu.org#52546,"PAKULONAN BARAT, KELAPA DUA, TANGERANG, BANTEN",28,78,93,171
https://kawalpemilu.org#52546,"PAKULONAN BARAT, KELAPA DUA, TANGERANG, BANTEN",29,79,110,189
https://kawalpemilu.org#52546,"PAKULONAN BARAT, KELAPA DUA, TANGERANG, BANTEN",30,87,115,202
https://kawalpemilu.org#52546,"PAKULONAN BARAT, KELAPA DUA, TANGERANG, BANTEN",31,200,9,209
https://kawalpemilu.org#52546,"PAKULONAN BARAT, KELAPA DUA, TANGERANG, BANTEN",32,190,6,196
https://kawalpemilu.org#52546,"PAKULONAN BARAT, KELAPA DUA, TANGERANG, BANTEN",33,175,0,175
https://kawalpemilu.org#52546,"PAKULONAN BARAT, KELAPA DUA, TANGERANG, BANTEN",34,155,7,162
https://kawalpemilu.org#52546,"PAKULONAN BARAT, KELAPA DUA, TANGERANG, BANTEN",35,204,9,213
https://kawalpemilu.org#52546,"PAKULONAN BARAT, KELAPA DUA, TANGERANG, BANTEN",36,249,14,263
https://kawalpemilu.org#52546,"PAKULONAN BARAT, KELAPA DUA, TANGERANG, BANTEN",37,203,5,208
https://kawalpemilu.org#52546,"PAKULONAN BARAT, KELAPA DUA, TANGERANG, BANTEN",38,216,10,226
https://kawalpemilu.org#52546,"PAKULONAN BARAT, KELAPA DUA, TANGERANG, BANTEN",39,230,7,237
https://kawalpemilu.org#52546,"PAKULONAN BARAT, KELAPA DUA, TANGERANG, BANTEN",40,188,4,192
https://kawalpemilu.org#52546,"PAKULONAN BARAT, KELAPA DUA, TANGERANG, BANTEN",41,168,3,171
https://kawalpemilu.org#52546,"PAKULONAN BARAT, KELAPA DUA, TANGERANG, BANTEN",42,184,13,197
https://kawalpemilu.org#52546,"PAKULONAN BARAT, KELAPA DUA, TANGERANG, BANTEN",43,182,8,191
https://kawalpemilu.org#52546,"PAKULONAN BARAT, KELAPA DUA, TANGERANG, BANTEN",44,198,15,213
https://kawalpemilu.org#52546,"PAKULONAN BARAT, KELAPA DUA, TANGERANG, BANTEN",45,196,20,216
https://kawalpemilu.org#52546,"PAKULONAN BARAT, KELAPA DUA, TANGERANG, BANTEN",46,228,7,235
https://kawalpemilu.org#52546,"PAKULONAN BARAT, KELAPA DUA, TANGERANG, BANTEN",47,164,13,177
https://kawalpemilu.org#52546,"PAKULONAN BARAT, KELAPA DUA, TANGERANG, BANTEN",48,181,22,203
https://kawalpemilu.org#52546,"PAKULONAN BARAT, KELAPA DUA, TANGERANG, BANTEN",49,242,5,247
https://kawalpemilu.org#52546,"PAKULONAN BARAT, KELAPA DUA, TANGERANG, BANTEN",50,224,9,233
https://kawalpemilu.org#52546,"PAKULONAN BARAT, KELAPA DUA, TANGERANG, BANTEN",51,175,5,180
https://kawalpemilu.org#52546,"PAKULONAN BARAT, KELAPA DUA, TANGERANG, BANTEN",52,157,10,167
https://kawalpemilu.org#52546,"PAKULONAN BARAT, KELAPA DUA, TANGERANG, BANTEN",53,250,18,268
https://kawalpemilu.org#52546,"PAKULONAN BARAT, KELAPA DUA, TANGERANG, BANTEN",54,17,44,61
https://kawalpemilu.org#52546,"PAKULONAN BARAT, KELAPA DUA, TANGERANG, BANTEN",55,139,7,146
https://kawalpemilu.org#52546,"PAKULONAN BARAT, KELAPA DUA, TANGERANG, BANTEN",56,190,7,197
https://kawalpemilu.org#52546,"PAKULONAN BARAT, KELAPA DUA, TANGERANG, BANTEN",57,234,12,246
https://kawalpemilu.org#52546,"PAKULONAN BARAT, KELAPA DUA, TANGERANG, BANTEN",58,182,7,189
https://kawalpemilu.org#52546,"PAKULONAN BARAT, KELAPA DUA, TANGERANG, BANTEN",59,138,10,148
https://kawalpemilu.org#52546,"PAKULONAN BARAT, KELAPA DUA, TANGERANG, BANTEN",60,107,7,114
https://kawalpemilu.org#52546,"PAKULONAN BARAT, KELAPA DUA, TANGERANG, BANTEN",61,152,3,155
https://kawalpemilu.org#52546,"PAKULONAN BARAT, KELAPA DUA, TANGERANG, BANTEN",62,143,7,150
https://kawalpemilu.org#52547,"BOJONG NANGKA, KELAPA DUA, TANGERANG, BANTEN",1,102,144,246
https://kawalpemilu.org#52547,"BOJONG NANGKA, KELAPA DUA, TANGERANG, BANTEN",3,47,72,119
https://kawalpemilu.org#52547,"BOJONG NANGKA, KELAPA DUA, TANGERANG, BANTEN",4,37,61,98
https://kawalpemilu.org#52547,"BOJONG NANGKA, KELAPA DUA, TANGERANG, BANTEN",5,48,129,177
https://kawalpemilu.org#52547,"BOJONG NANGKA, KELAPA DUA, TANGERANG, BANTEN",7,60,106,166
https://kawalpemilu.org#52547,"BOJONG NANGKA, KELAPA DUA, TANGERANG, BANTEN",8,75,114,189
https://kawalpemilu.org#52547,"BOJONG NANGKA, KELAPA DUA, TANGERANG, BANTEN",9,71,155,226
https://kawalpemilu.org#52547,"BOJONG NANGKA, KELAPA DUA, TANGERANG, BANTEN",10,56,135,191
https://kawalpemilu.org#52547,"BOJONG NANGKA, KELAPA DUA, TANGERANG, BANTEN",11,64,138,202
https://kawalpemilu.org#52547,"BOJONG NANGKA, KELAPA DUA, TANGERANG, BANTEN",12,113,146,259
https://kawalpemilu.org#52547,"BOJONG NANGKA, KELAPA DUA, TANGERANG, BANTEN",13,60,131,191
https://kawalpemilu.org#52547,"BOJONG NANGKA, KELAPA DUA, TANGERANG, BANTEN",15,60,150,210
https://kawalpemilu.org#52547,"BOJONG NANGKA, KELAPA DUA, TANGERANG, BANTEN",16,61,146,207
https://kawalpemilu.org#52547,"BOJONG NANGKA, KELAPA DUA, TANGERANG, BANTEN",17,91,116,207
https://kawalpemilu.org#52547,"BOJONG NANGKA, KELAPA DUA, TANGERANG, BANTEN",19,33,103,136
https://kawalpemilu.org#52547,"BOJONG NANGKA, KELAPA DUA, TANGERANG, BANTEN",20,47,91,138
https://kawalpemilu.org#52547,"BOJONG NANGKA, KELAPA DUA, TANGERANG, BANTEN",21,82,92,174
https://kawalpemilu.org#52547,"BOJONG NANGKA, KELAPA DUA, TANGERANG, BANTEN",22,79,92,171
https://kawalpemilu.org#52547,"BOJONG NANGKA, KELAPA DUA, TANGERANG, BANTEN",23,79,95,174
https://kawalpemilu.org#52547,"BOJONG NANGKA, KELAPA DUA, TANGERANG, BANTEN",24,106,87,193
https://kawalpemilu.org#52547,"BOJONG NANGKA, KELAPA DUA, TANGERANG, BANTEN",25,90,91,181
https://kawalpemilu.org#52547,"BOJONG NANGKA, KELAPA DUA, TANGERANG, BANTEN",26,67,65,132
https://kawalpemilu.org#52547,"BOJONG NANGKA, KELAPA DUA, TANGERANG, BANTEN",27,77,147,224
https://kawalpemilu.org#52547,"BOJONG NANGKA, KELAPA DUA, TANGERANG, BANTEN",28,77,147,224
https://kawalpemilu.org#52547,"BOJONG NANGKA, KELAPA DUA, TANGERANG, BANTEN",29,69,152,221
https://kawalpemilu.org#52547,"BOJONG NANGKA, KELAPA DUA, TANGERANG, BANTEN",30,60,110,170
https://kawalpemilu.org#52547,"BOJONG NANGKA, KELAPA DUA, TANGERANG, BANTEN",31,78,147,225
https://kawalpemilu.org#52547,"BOJONG NANGKA, KELAPA DUA, TANGERANG, BANTEN",32,81,151,232
https://kawalpemilu.org#52547,"BOJONG NANGKA, KELAPA DUA, TANGERANG, BANTEN",33,68,107,175
https://kawalpemilu.org#52547,"BOJONG NANGKA, KELAPA DUA, TANGERANG, BANTEN",34,66,109,175
https://kawalpemilu.org#52547,"BOJONG NANGKA, KELAPA DUA, TANGERANG, BANTEN",35,92,147,239
https://kawalpemilu.org#52547,"BOJONG NANGKA, KELAPA DUA, TANGERANG, BANTEN",36,71,113,184
https://kawalpemilu.org#52547,"BOJONG NANGKA, KELAPA DUA, TANGERANG, BANTEN",37,84,110,194
https://kawalpemilu.org#52547,"BOJONG NANGKA, KELAPA DUA, TANGERANG, BANTEN",39,57,177,234
https://kawalpemilu.org#52547,"BOJONG NANGKA, KELAPA DUA, TANGERANG, BANTEN",40,80,145,225
https://kawalpemilu.org#52547,"BOJONG NANGKA, KELAPA DUA, TANGERANG, BANTEN",41,81,124,205
https://kawalpemilu.org#52547,"BOJONG NANGKA, KELAPA DUA, TANGERANG, BANTEN",42,60,113,173
https://kawalpemilu.org#52547,"BOJONG NANGKA, KELAPA DUA, TANGERANG, BANTEN",43,65,95,160
https://kawalpemilu.org#52547,"BOJONG NANGKA, KELAPA DUA, TANGERANG, BANTEN",44,85,80,165
https://kawalpemilu.org#52547,"BOJONG NANGKA, KELAPA DUA, TANGERANG, BANTEN",45,62,101,163
https://kawalpemilu.org#52547,"BOJONG NANGKA, KELAPA DUA, TANGERANG, BANTEN",46,82,70,152
https://kawalpemilu.org#52547,"BOJONG NANGKA, KELAPA DUA, TANGERANG, BANTEN",47,104,65,169
https://kawalpemilu.org#52547,"BOJONG NANGKA, KELAPA DUA, TANGERANG, BANTEN",48,109,61,170
https://kawalpemilu.org#52547,"BOJONG NANGKA, KELAPA DUA, TANGERANG, BANTEN",49,119,79,198
https://kawalpemilu.org#52547,"BOJONG NANGKA, KELAPA DUA, TANGERANG, BANTEN",50,111,86,197
https://kawalpemilu.org#52547,"BOJONG NANGKA, KELAPA DUA, TANGERANG, BANTEN",51,95,116,211
https://kawalpemilu.org#52547,"BOJONG NANGKA, KELAPA DUA, TANGERANG, BANTEN",52,94,80,174
https://kawalpemilu.org#52547,"BOJONG NANGKA, KELAPA DUA, TANGERANG, BANTEN",53,123,96,219
https://kawalpemilu.org#52547,"BOJONG NANGKA, KELAPA DUA, TANGERANG, BANTEN",54,117,94,211
https://kawalpemilu.org#52547,"BOJONG NANGKA, KELAPA DUA, TANGERANG, BANTEN",55,88,93,181
https://kawalpemilu.org#52547,"BOJONG NANGKA, KELAPA DUA, TANGERANG, BANTEN",56,91,81,172
https://kawalpemilu.org#52547,"BOJONG NANGKA, KELAPA DUA, TANGERANG, BANTEN",57,114,86,200
https://kawalpemilu.org#52547,"BOJONG NANGKA, KELAPA DUA, TANGERANG, BANTEN",58,112,85,197
https://kawalpemilu.org#52547,"BOJONG NANGKA, KELAPA DUA, TANGERANG, BANTEN",59,122,74,196
https://kawalpemilu.org#52547,"BOJONG NANGKA, KELAPA DUA, TANGERANG, BANTEN",60,95,99,194
https://kawalpemilu.org#52547,"BOJONG NANGKA, KELAPA DUA, TANGERANG, BANTEN",61,89,97,186
https://kawalpemilu.org#52547,"BOJONG NANGKA, KELAPA DUA, TANGERANG, BANTEN",62,83,112,195
https://kawalpemilu.org#52547,"BOJONG NANGKA, KELAPA DUA, TANGERANG, BANTEN",63,119,123,242
https://kawalpemilu.org#52547,"BOJONG NANGKA, KELAPA DUA, TANGERANG, BANTEN",64,126,115,241
https://kawalpemilu.org#52547,"BOJONG NANGKA, KELAPA DUA, TANGERANG, BANTEN",65,133,110,243
https://kawalpemilu.org#52547,"BOJONG NANGKA, KELAPA DUA, TANGERANG, BANTEN",66,123,113,236
https://kawalpemilu.org#52547,"BOJONG NANGKA, KELAPA DUA, TANGERANG, BANTEN",67,99,121,220
https://kawalpemilu.org#52547,"BOJONG NANGKA, KELAPA DUA, TANGERANG, BANTEN",68,121,154,275
https://kawalpemilu.org#52547,"BOJONG NANGKA, KELAPA DUA, TANGERANG, BANTEN",69,107,152,259
https://kawalpemilu.org#52547,"BOJONG NANGKA, KELAPA DUA, TANGERANG, BANTEN",70,118,119,237
https://kawalpemilu.org#52547,"BOJONG NANGKA, KELAPA DUA, TANGERANG, BANTEN",71,105,105,210
https://kawalpemilu.org#52547,"BOJONG NANGKA, KELAPA DUA, TANGERANG, BANTEN",72,105,82,187
https://kawalpemilu.org#52547,"BOJONG NANGKA, KELAPA DUA, TANGERANG, BANTEN",73,118,119,237
https://kawalpemilu.org#52547,"BOJONG NANGKA, KELAPA DUA, TANGERANG, BANTEN",74,131,101,232
https://kawalpemilu.org#52547,"BOJONG NANGKA, KELAPA DUA, TANGERANG, BANTEN",75,92,110,202
https://kawalpemilu.org#52547,"BOJONG NANGKA, KELAPA DUA, TANGERANG, BANTEN",76,105,95,200
https://kawalpemilu.org#52547,"BOJONG NANGKA, KELAPA DUA, TANGERANG, BANTEN",77,144,84,228
https://kawalpemilu.org#52547,"BOJONG NANGKA, KELAPA DUA, TANGERANG, BANTEN",78,129,98,227
https://kawalpemilu.org#52547,"BOJONG NANGKA, KELAPA DUA, TANGERANG, BANTEN",79,115,98,213
https://kawalpemilu.org#52547,"BOJONG NANGKA, KELAPA DUA, TANGERANG, BANTEN",80,77,65,142
https://kawalpemilu.org#52547,"BOJONG NANGKA, KELAPA DUA, TANGERANG, BANTEN",81,59,74,133
https://kawalpemilu.org#52547,"BOJONG NANGKA, KELAPA DUA, TANGERANG, BANTEN",83,80,57,137
https://kawalpemilu.org#52547,"BOJONG NANGKA, KELAPA DUA, TANGERANG, BANTEN",84,55,65,120
https://kawalpemilu.org#52547,"BOJONG NANGKA, KELAPA DUA, TANGERANG, BANTEN",85,61,69,130
https://kawalpemilu.org#52547,"BOJONG NANGKA, KELAPA DUA, TANGERANG, BANTEN",86,79,90,169
https://kawalpemilu.org#52547,"BOJONG NANGKA, KELAPA DUA, TANGERANG, BANTEN",87,69,101,170
https://kawalpemilu.org#52547,"BOJONG NANGKA, KELAPA DUA, TANGERANG, BANTEN",88,102,123,225
https://kawalpemilu.org#52547,"BOJONG NANGKA, KELAPA DUA, TANGERANG, BANTEN",89,112,152,264
https://kawalpemilu.org#52547,"BOJONG NANGKA, KELAPA DUA, TANGERANG, BANTEN",90,123,92,215
https://kawalpemilu.org#52547,"BOJONG NANGKA, KELAPA DUA, TANGERANG, BANTEN",91,108,119,227
https://kawalpemilu.org#52547,"BOJONG NANGKA, KELAPA DUA, TANGERANG, BANTEN",92,91,122,213
https://kawalpemilu.org#52547,"BOJONG NANGKA, KELAPA DUA, TANGERANG, BANTEN",93,97,107,204
https://kawalpemilu.org#52547,"BOJONG NANGKA, KELAPA DUA, TANGERANG, BANTEN",94,89,85,174
https://kawalpemilu.org#52547,"BOJONG NANGKA, KELAPA DUA, TANGERANG, BANTEN",95,104,82,186
https://kawalpemilu.org#52547,"BOJONG NANGKA, KELAPA DUA, TANGERANG, BANTEN",96,63,141,204
https://kawalpemilu.org#52547,"BOJONG NANGKA, KELAPA DUA, TANGERANG, BANTEN",97,86,81,167
https://kawalpemilu.org#52547,"BOJONG NANGKA, KELAPA DUA, TANGERANG, BANTEN",98,66,114,180
https://kawalpemilu.org#52547,"BOJONG NANGKA, KELAPA DUA, TANGERANG, BANTEN",99,70,116,186
https://kawalpemilu.org#52547,"BOJONG NANGKA, KELAPA DUA, TANGERANG, BANTEN",100,108,123,231
https://kawalpemilu.org#52547,"BOJONG NANGKA, KELAPA DUA, TANGERANG, BANTEN",101,103,128,231
https://kawalpemilu.org#52547,"BOJONG NANGKA, KELAPA DUA, TANGERANG, BANTEN",102,115,115,230
https://kawalpemilu.org#52547,"BOJONG NANGKA, KELAPA DUA, TANGERANG, BANTEN",103,101,135,236
https://kawalpemilu.org#52547,"BOJONG NANGKA, KELAPA DUA, TANGERANG, BANTEN",104,98,110,208
https://kawalpemilu.org#52547,"BOJONG NANGKA, KELAPA DUA, TANGERANG, BANTEN",105,132,93,225
https://kawalpemilu.org#52547,"BOJONG NANGKA, KELAPA DUA, TANGERANG, BANTEN",106,105,105,210
https://kawalpemilu.org#52547,"BOJONG NANGKA, KELAPA DUA, TANGERANG, BANTEN",107,110,96,206
https://kawalpemilu.org#52547,"BOJONG NANGKA, KELAPA DUA, TANGERANG, BANTEN",109,87,136,223
https://kawalpemilu.org#52547,"BOJONG NANGKA, KELAPA DUA, TANGERANG, BANTEN",110,105,104,209
https://kawalpemilu.org#52547,"BOJONG NANGKA, KELAPA DUA, TANGERANG, BANTEN",111,99,92,191
https://kawalpemilu.org#52547,"BOJONG NANGKA, KELAPA DUA, TANGERANG, BANTEN",114,89,122,211
https://kawalpemilu.org#52547,"BOJONG NANGKA, KELAPA DUA, TANGERANG, BANTEN",115,94,130,224
https://kawalpemilu.org#52547,"BOJONG NANGKA, KELAPA DUA, TANGERANG, BANTEN",116,110,129,239
https://kawalpemilu.org#52547,"BOJONG NANGKA, KELAPA DUA, TANGERANG, BANTEN",117,99,87,186
https://kawalpemilu.org#52547,"BOJONG NANGKA, KELAPA DUA, TANGERANG, BANTEN",118,118,80,198
https://kawalpemilu.org#52547,"BOJONG NANGKA, KELAPA DUA, TANGERANG, BANTEN",119,92,111,203
https://kawalpemilu.org#52547,"BOJONG NANGKA, KELAPA DUA, TANGERANG, BANTEN",120,74,107,181
https://kawalpemilu.org#52547,"BOJONG NANGKA, KELAPA DUA, TANGERANG, BANTEN",121,93,81,174
https://kawalpemilu.org#52547,"BOJONG NANGKA, KELAPA DUA, TANGERANG, BANTEN",122,73,83,156
https://kawalpemilu.org#52547,"BOJONG NANGKA, KELAPA DUA, TANGERANG, BANTEN",123,91,97,188
https://kawalpemilu.org#52547,"BOJONG NANGKA, KELAPA DUA, TANGERANG, BANTEN",124,62,95,157
https://kawalpemilu.org#52547,"BOJONG NANGKA, KELAPA DUA, TANGERANG, BANTEN",125,87,83,170
https://kawalpemilu.org#52547,"BOJONG NANGKA, KELAPA DUA, TANGERANG, BANTEN",126,146,117,263
https://kawalpemilu.org#52547,"BOJONG NANGKA, KELAPA DUA, TANGERANG, BANTEN",127,93,140,233
https://kawalpemilu.org#52547,"BOJONG NANGKA, KELAPA DUA, TANGERANG, BANTEN",128,104,113,217
https://kawalpemilu.org#52547,"BOJONG NANGKA, KELAPA DUA, TANGERANG, BANTEN",129,87,118,205
https://kawalpemilu.org#52547,"BOJONG NANGKA, KELAPA DUA, TANGERANG, BANTEN",130,57,106,163
https://kawalpemilu.org#52547,"BOJONG NANGKA, KELAPA DUA, TANGERANG, BANTEN",131,65,121,186
https://kawalpemilu.org#52547,"BOJONG NANGKA, KELAPA DUA, TANGERANG, BANTEN",132,226,9,235
https://kawalpemilu.org#52547,"BOJONG NANGKA, KELAPA DUA, TANGERANG, BANTEN",133,96,146,242
https://kawalpemilu.org#52547,"BOJONG NANGKA, KELAPA DUA, TANGERANG, BANTEN",134,121,118,239
https://kawalpemilu.org#52547,"BOJONG NANGKA, KELAPA DUA, TANGERANG, BANTEN",135,149,95,244
https://kawalpemilu.org#52547,"BOJONG NANGKA, KELAPA DUA, TANGERANG, BANTEN",137,65,170,235
https://kawalpemilu.org#52547,"BOJONG NANGKA, KELAPA DUA, TANGERANG, BANTEN",138,56,134,190
https://kawalpemilu.org#52547,"BOJONG NANGKA, KELAPA DUA, TANGERANG, BANTEN",139,21,64,85
https://kawalpemilu.org#52547,"BOJONG NANGKA, KELAPA DUA, TANGERANG, BANTEN",141,40,26,66
https://kawalpemilu.org#52547,"BOJONG NANGKA, KELAPA DUA, TANGERANG, BANTEN",142,98,47,145
https://kawalpemilu.org#52547,"BOJONG NANGKA, KELAPA DUA, TANGERANG, BANTEN",143,47,44,91
https://kawalpemilu.org#52547,"BOJONG NANGKA, KELAPA DUA, TANGERANG, BANTEN",144,104,177,281
https://kawalpemilu.org#52547,"BOJONG NANGKA, KELAPA DUA, TANGERANG, BANTEN",145,80,58,138
https://kawalpemilu.org#52548,"CURUG SANGERENG, KELAPA DUA, TANGERANG, BANTEN",1,67,159,226
https://kawalpemilu.org#52548,"CURUG SANGERENG, KELAPA DUA, TANGERANG, BANTEN",2,75,121,196
https://kawalpemilu.org#52548,"CURUG SANGERENG, KELAPA DUA, TANGERANG, BANTEN",3,84,114,198
https://kawalpemilu.org#52548,"CURUG SANGERENG, KELAPA DUA, TANGERANG, BANTEN",6,71,150,221
https://kawalpemilu.org#52548,"CURUG SANGERENG, KELAPA DUA, TANGERANG, BANTEN",7,47,198,245
https://kawalpemilu.org#52548,"CURUG SANGERENG, KELAPA DUA, TANGERANG, BANTEN",8,95,114,209
https://kawalpemilu.org#52548,"CURUG SANGERENG, KELAPA DUA, TANGERANG, BANTEN",9,74,118,192
https://kawalpemilu.org#52548,"CURUG SANGERENG, KELAPA DUA, TANGERANG, BANTEN",10,89,101,190
https://kawalpemilu.org#52548,"CURUG SANGERENG, KELAPA DUA, TANGERANG, BANTEN",11,54,101,155
https://kawalpemilu.org#52548,"CURUG SANGERENG, KELAPA DUA, TANGERANG, BANTEN",13,136,8,144
https://kawalpemilu.org#52548,"CURUG SANGERENG, KELAPA DUA, TANGERANG, BANTEN",14,132,8,140
https://kawalpemilu.org#52548,"CURUG SANGERENG, KELAPA DUA, TANGERANG, BANTEN",15,139,10,149
https://kawalpemilu.org#52548,"CURUG SANGERENG, KELAPA DUA, TANGERANG, BANTEN",16,164,8,172
https://kawalpemilu.org#52548,"CURUG SANGERENG, KELAPA DUA, TANGERANG, BANTEN",17,150,14,164
https://kawalpemilu.org#52548,"CURUG SANGERENG, KELAPA DUA, TANGERANG, BANTEN",18,151,13,164
https://kawalpemilu.org#52548,"CURUG SANGERENG, KELAPA DUA, TANGERANG, BANTEN",19,158,4,162
https://kawalpemilu.org#52548,"CURUG SANGERENG, KELAPA DUA, TANGERANG, BANTEN",20,165,19,184
https://kawalpemilu.org#52548,"CURUG SANGERENG, KELAPA DUA, TANGERANG, BANTEN",21,164,24,188
https://kawalpemilu.org#52548,"CURUG SANGERENG, KELAPA DUA, TANGERANG, BANTEN",22,180,21,201
https://kawalpemilu.org#52548,"CURUG SANGERENG, KELAPA DUA, TANGERANG, BANTEN",23,157,10,167
https://kawalpemilu.org#52548,"CURUG SANGERENG, KELAPA DUA, TANGERANG, BANTEN",24,179,13,192
https://kawalpemilu.org#52548,"CURUG SANGERENG, KELAPA DUA, TANGERANG, BANTEN",28,40,159,199
https://kawalpemilu.org#52548,"CURUG SANGERENG, KELAPA DUA, TANGERANG, BANTEN",29,52,132,184
https://kawalpemilu.org#52548,"CURUG SANGERENG, KELAPA DUA, TANGERANG, BANTEN",30,225,4,229
https://kawalpemilu.org#52548,"CURUG SANGERENG, KELAPA DUA, TANGERANG, BANTEN",31,220,3,223
https://kawalpemilu.org#52548,"CURUG SANGERENG, KELAPA DUA, TANGERANG, BANTEN",32,265,6,271
https://kawalpemilu.org#52548,"CURUG SANGERENG, KELAPA DUA, TANGERANG, BANTEN",33,227,13,240
https://kawalpemilu.org#52548,"CURUG SANGERENG, KELAPA DUA, TANGERANG, BANTEN",34,204,18,222
https://kawalpemilu.org#52548,"CURUG SANGERENG, KELAPA DUA, TANGERANG, BANTEN",35,214,8,222
https://kawalpemilu.org#52548,"CURUG SANGERENG, KELAPA DUA, TANGERANG, BANTEN",36,185,25,210
https://kawalpemilu.org#52548,"CURUG SANGERENG, KELAPA DUA, TANGERANG, BANTEN",37,220,5,225
https://kawalpemilu.org#52548,"CURUG SANGERENG, KELAPA DUA, TANGERANG, BANTEN",38,202,5,207
https://kawalpemilu.org#52548,"CURUG SANGERENG, KELAPA DUA, TANGERANG, BANTEN",39,170,8,178
https://kawalpemilu.org#52548,"CURUG SANGERENG, KELAPA DUA, TANGERANG, BANTEN",40,179,8,187
https://kawalpemilu.org#52548,"CURUG SANGERENG, KELAPA DUA, TANGERANG, BANTEN",41,196,7,203
https://kawalpemilu.org#52548,"CURUG SANGERENG, KELAPA DUA, TANGERANG, BANTEN",42,164,4,168
https://kawalpemilu.org#52548,"CURUG SANGERENG, KELAPA DUA, TANGERANG, BANTEN",43,147,7,154
https://kawalpemilu.org#52548,"CURUG SANGERENG, KELAPA DUA, TANGERANG, BANTEN",45,43,32,75
https://kawalpemilu.org#52548,"CURUG SANGERENG, KELAPA DUA, TANGERANG, BANTEN",46,169,10,179
https://kawalpemilu.org#52548,"CURUG SANGERENG, KELAPA DUA, TANGERANG, BANTEN",47,199,29,228
https://kawalpemilu.org#52550,"SINDANG JAYA, SINDANG JAYA, TANGERANG, BANTEN",1,49,172,221
https://kawalpemilu.org#52550,"SINDANG JAYA, SINDANG JAYA, TANGERANG, BANTEN",2,44,135,179
https://kawalpemilu.org#52550,"SINDANG JAYA, SINDANG JAYA, TANGERANG, BANTEN",3,36,122,158
https://kawalpemilu.org#52550,"SINDANG JAYA, SINDANG JAYA, TANGERANG, BANTEN",4,43,147,190
https://kawalpemilu.org#52550,"SINDANG JAYA, SINDANG JAYA, TANGERANG, BANTEN",5,34,111,145
https://kawalpemilu.org#52550,"SINDANG JAYA, SINDANG JAYA, TANGERANG, BANTEN",6,38,127,165
https://kawalpemilu.org#52550,"SINDANG JAYA, SINDANG JAYA, TANGERANG, BANTEN",7,54,97,151
https://kawalpemilu.org#52550,"SINDANG JAYA, SINDANG JAYA, TANGERANG, BANTEN",8,49,107,156
https://kawalpemilu.org#52550,"SINDANG JAYA, SINDANG JAYA, TANGERANG, BANTEN",9,60,102,162
https://kawalpemilu.org#52550,"SINDANG JAYA, SINDANG JAYA, TANGERANG, BANTEN",10,50,125,175
https://kawalpemilu.org#52550,"SINDANG JAYA, SINDANG JAYA, TANGERANG, BANTEN",11,78,116,194
https://kawalpemilu.org#52550,"SINDANG JAYA, SINDANG JAYA, TANGERANG, BANTEN",12,65,137,202
https://kawalpemilu.org#52550,"SINDANG JAYA, SINDANG JAYA, TANGERANG, BANTEN",13,64,110,174
https://kawalpemilu.org#52550,"SINDANG JAYA, SINDANG JAYA, TANGERANG, BANTEN",15,45,120,165
https://kawalpemilu.org#52550,"SINDANG JAYA, SINDANG JAYA, TANGERANG, BANTEN",16,38,163,201
https://kawalpemilu.org#52550,"SINDANG JAYA, SINDANG JAYA, TANGERANG, BANTEN",17,50,133,183
https://kawalpemilu.org#52550,"SINDANG JAYA, SINDANG JAYA, TANGERANG, BANTEN",18,87,121,208
https://kawalpemilu.org#52550,"SINDANG JAYA, SINDANG JAYA, TANGERANG, BANTEN",19,55,135,190
https://kawalpemilu.org#52550,"SINDANG JAYA, SINDANG JAYA, TANGERANG, BANTEN",20,55,137,192
https://kawalpemilu.org#52550,"SINDANG JAYA, SINDANG JAYA, TANGERANG, BANTEN",21,63,123,186
https://kawalpemilu.org#52550,"SINDANG JAYA, SINDANG JAYA, TANGERANG, BANTEN",22,76,99,175
https://kawalpemilu.org#52550,"SINDANG JAYA, SINDANG JAYA, TANGERANG, BANTEN",23,99,109,208
https://kawalpemilu.org#52550,"SINDANG JAYA, SINDANG JAYA, TANGERANG, BANTEN",25,54,116,170
https://kawalpemilu.org#52550,"SINDANG JAYA, SINDANG JAYA, TANGERANG, BANTEN",26,72,150,222
https://kawalpemilu.org#52550,"SINDANG JAYA, SINDANG JAYA, TANGERANG, BANTEN",27,50,153,203
https://kawalpemilu.org#52550,"SINDANG JAYA, SINDANG JAYA, TANGERANG, BANTEN",28,41,103,144
https://kawalpemilu.org#52550,"SINDANG JAYA, SINDANG JAYA, TANGERANG, BANTEN",29,35,114,149
https://kawalpemilu.org#52551,"WANAKERTA, SINDANG JAYA, TANGERANG, BANTEN",1,36,142,178
https://kawalpemilu.org#52551,"WANAKERTA, SINDANG JAYA, TANGERANG, BANTEN",2,37,125,2
https://kawalpemilu.org#52551,"WANAKERTA, SINDANG JAYA, TANGERANG, BANTEN",3,27,159,186
https://kawalpemilu.org#52551,"WANAKERTA, SINDANG JAYA, TANGERANG, BANTEN",4,65,146,211
https://kawalpemilu.org#52551,"WANAKERTA, SINDANG JAYA, TANGERANG, BANTEN",5,59,140,199
https://kawalpemilu.org#52551,"WANAKERTA, SINDANG JAYA, TANGERANG, BANTEN",6,45,172,217
https://kawalpemilu.org#52551,"WANAKERTA, SINDANG JAYA, TANGERANG, BANTEN",7,53,138,191
https://kawalpemilu.org#52551,"WANAKERTA, SINDANG JAYA, TANGERANG, BANTEN",8,38,166,204
https://kawalpemilu.org#52551,"WANAKERTA, SINDANG JAYA, TANGERANG, BANTEN",9,44,131,175
https://kawalpemilu.org#52551,"WANAKERTA, SINDANG JAYA, TANGERANG, BANTEN",10,24,111,135
https://kawalpemilu.org#52551,"WANAKERTA, SINDANG JAYA, TANGERANG, BANTEN",11,36,126,162
https://kawalpemilu.org#52551,"WANAKERTA, SINDANG JAYA, TANGERANG, BANTEN",12,77,169,246
https://kawalpemilu.org#52551,"WANAKERTA, SINDANG JAYA, TANGERANG, BANTEN",13,54,149,203
https://kawalpemilu.org#52551,"WANAKERTA, SINDANG JAYA, TANGERANG, BANTEN",14,60,131,191
https://kawalpemilu.org#52551,"WANAKERTA, SINDANG JAYA, TANGERANG, BANTEN",15,43,136,11
https://kawalpemilu.org#52551,"WANAKERTA, SINDANG JAYA, TANGERANG, BANTEN",16,47,165,212
https://kawalpemilu.org#52551,"WANAKERTA, SINDANG JAYA, TANGERANG, BANTEN",20,59,83,142
https://kawalpemilu.org#52551,"WANAKERTA, SINDANG JAYA, TANGERANG, BANTEN",21,78,158,236
https://kawalpemilu.org#52551,"WANAKERTA, SINDANG JAYA, TANGERANG, BANTEN",22,54,176,230
https://kawalpemilu.org#52551,"WANAKERTA, SINDANG JAYA, TANGERANG, BANTEN",23,53,190,243
https://kawalpemilu.org#52551,"WANAKERTA, SINDANG JAYA, TANGERANG, BANTEN",24,78,132,210
https://kawalpemilu.org#52551,"WANAKERTA, SINDANG JAYA, TANGERANG, BANTEN",25,45,121,166
https://kawalpemilu.org#52551,"WANAKERTA, SINDANG JAYA, TANGERANG, BANTEN",26,54,144,198
https://kawalpemilu.org#52551,"WANAKERTA, SINDANG JAYA, TANGERANG, BANTEN",27,46,117,163
https://kawalpemilu.org#52551,"WANAKERTA, SINDANG JAYA, TANGERANG, BANTEN",28,61,131,192
https://kawalpemilu.org#52551,"WANAKERTA, SINDANG JAYA, TANGERANG, BANTEN",29,51,104,155
https://kawalpemilu.org#52551,"WANAKERTA, SINDANG JAYA, TANGERANG, BANTEN",30,83,114,197
https://kawalpemilu.org#52551,"WANAKERTA, SINDANG JAYA, TANGERANG, BANTEN",31,27,100,127
https://kawalpemilu.org#52551,"WANAKERTA, SINDANG JAYA, TANGERANG, BANTEN",32,36,90,126
https://kawalpemilu.org#52551,"WANAKERTA, SINDANG JAYA, TANGERANG, BANTEN",33,38,98,136
https://kawalpemilu.org#52551,"WANAKERTA, SINDANG JAYA, TANGERANG, BANTEN",34,32,130,162
https://kawalpemilu.org#52551,"WANAKERTA, SINDANG JAYA, TANGERANG, BANTEN",35,71,162,233
https://kawalpemilu.org#52551,"WANAKERTA, SINDANG JAYA, TANGERANG, BANTEN",36,77,135,212
https://kawalpemilu.org#52551,"WANAKERTA, SINDANG JAYA, TANGERANG, BANTEN",37,81,136,217
https://kawalpemilu.org#52551,"WANAKERTA, SINDANG JAYA, TANGERANG, BANTEN",38,101,78,179
https://kawalpemilu.org#52551,"WANAKERTA, SINDANG JAYA, TANGERANG, BANTEN",39,64,113,177
https://kawalpemilu.org#52551,"WANAKERTA, SINDANG JAYA, TANGERANG, BANTEN",40,92,121,213
https://kawalpemilu.org#52551,"WANAKERTA, SINDANG JAYA, TANGERANG, BANTEN",42,71,76,147
https://kawalpemilu.org#52551,"WANAKERTA, SINDANG JAYA, TANGERANG, BANTEN",43,117,126,243
https://kawalpemilu.org#52551,"WANAKERTA, SINDANG JAYA, TANGERANG, BANTEN",44,92,138,230
https://kawalpemilu.org#52551,"WANAKERTA, SINDANG JAYA, TANGERANG, BANTEN",45,77,103,180
https://kawalpemilu.org#52551,"WANAKERTA, SINDANG JAYA, TANGERANG, BANTEN",46,79,147,226
https://kawalpemilu.org#52551,"WANAKERTA, SINDANG JAYA, TANGERANG, BANTEN",47,76,88,164
https://kawalpemilu.org#52551,"WANAKERTA, SINDANG JAYA, TANGERANG, BANTEN",48,63,97,160
https://kawalpemilu.org#52551,"WANAKERTA, SINDANG JAYA, TANGERANG, BANTEN",49,90,115,205
https://kawalpemilu.org#52551,"WANAKERTA, SINDANG JAYA, TANGERANG, BANTEN",50,104,102,206
https://kawalpemilu.org#52551,"WANAKERTA, SINDANG JAYA, TANGERANG, BANTEN",51,123,130,253
https://kawalpemilu.org#52551,"WANAKERTA, SINDANG JAYA, TANGERANG, BANTEN",52,113,130,243
https://kawalpemilu.org#52551,"WANAKERTA, SINDANG JAYA, TANGERANG, BANTEN",53,99,130,229
https://kawalpemilu.org#52551,"WANAKERTA, SINDANG JAYA, TANGERANG, BANTEN",54,80,122,202
https://kawalpemilu.org#52551,"WANAKERTA, SINDANG JAYA, TANGERANG, BANTEN",55,43,62,105
https://kawalpemilu.org#52552,"SUKAHARJA, SINDANG JAYA, TANGERANG, BANTEN",1,38,177,216
https://kawalpemilu.org#52552,"SUKAHARJA, SINDANG JAYA, TANGERANG, BANTEN",2,59,181,240
https://kawalpemilu.org#52552,"SUKAHARJA, SINDANG JAYA, TANGERANG, BANTEN",3,38,125,163
https://kawalpemilu.org#52552,"SUKAHARJA, SINDANG JAYA, TANGERANG, BANTEN",5,38,108,146
https://kawalpemilu.org#52552,"SUKAHARJA, SINDANG JAYA, TANGERANG, BANTEN",6,34,108,142
https://kawalpemilu.org#52552,"SUKAHARJA, SINDANG JAYA, TANGERANG, BANTEN",7,43,155,198
https://kawalpemilu.org#52552,"SUKAHARJA, SINDANG JAYA, TANGERANG, BANTEN",8,61,136,197
https://kawalpemilu.org#52552,"SUKAHARJA, SINDANG JAYA, TANGERANG, BANTEN",11,32,185,217
https://kawalpemilu.org#52552,"SUKAHARJA, SINDANG JAYA, TANGERANG, BANTEN",12,30,187,217
https://kawalpemilu.org#52552,"SUKAHARJA, SINDANG JAYA, TANGERANG, BANTEN",13,42,144,186
https://kawalpemilu.org#52552,"SUKAHARJA, SINDANG JAYA, TANGERANG, BANTEN",14,40,112,152
https://kawalpemilu.org#52552,"SUKAHARJA, SINDANG JAYA, TANGERANG, BANTEN",15,38,124,162
https://kawalpemilu.org#52552,"SUKAHARJA, SINDANG JAYA, TANGERANG, BANTEN",16,19,111,130
https://kawalpemilu.org#52552,"SUKAHARJA, SINDANG JAYA, TANGERANG, BANTEN",17,36,133,169
https://kawalpemilu.org#52552,"SUKAHARJA, SINDANG JAYA, TANGERANG, BANTEN",18,39,121,160
https://kawalpemilu.org#52552,"SUKAHARJA, SINDANG JAYA, TANGERANG, BANTEN",19,75,170,245
https://kawalpemilu.org#52552,"SUKAHARJA, SINDANG JAYA, TANGERANG, BANTEN",20,59,165,224
https://kawalpemilu.org#52552,"SUKAHARJA, SINDANG JAYA, TANGERANG, BANTEN",21,49,185,234
https://kawalpemilu.org#52552,"SUKAHARJA, SINDANG JAYA, TANGERANG, BANTEN",22,50,193,243
https://kawalpemilu.org#52552,"SUKAHARJA, SINDANG JAYA, TANGERANG, BANTEN",23,53,153,206
https://kawalpemilu.org#52552,"SUKAHARJA, SINDANG JAYA, TANGERANG, BANTEN",24,75,99,174
https://kawalpemilu.org#52552,"SUKAHARJA, SINDANG JAYA, TANGERANG, BANTEN",25,63,103,166
https://kawalpemilu.org#52552,"SUKAHARJA, SINDANG JAYA, TANGERANG, BANTEN",26,48,115,163
https://kawalpemilu.org#52552,"SUKAHARJA, SINDANG JAYA, TANGERANG, BANTEN",27,33,129,162
https://kawalpemilu.org#52552,"SUKAHARJA, SINDANG JAYA, TANGERANG, BANTEN",28,35,134,169
https://kawalpemilu.org#52552,"SUKAHARJA, SINDANG JAYA, TANGERANG, BANTEN",29,41,194,235
https://kawalpemilu.org#52552,"SUKAHARJA, SINDANG JAYA, TANGERANG, BANTEN",30,10,160,170
https://kawalpemilu.org#52552,"SUKAHARJA, SINDANG JAYA, TANGERANG, BANTEN",31,19,166,185
https://kawalpemilu.org#52552,"SUKAHARJA, SINDANG JAYA, TANGERANG, BANTEN",32,83,154,237
https://kawalpemilu.org#52552,"SUKAHARJA, SINDANG JAYA, TANGERANG, BANTEN",35,42,208,250
https://kawalpemilu.org#52552,"SUKAHARJA, SINDANG JAYA, TANGERANG, BANTEN",37,30,181,211
https://kawalpemilu.org#52552,"SUKAHARJA, SINDANG JAYA, TANGERANG, BANTEN",38,30,189,219
https://kawalpemilu.org#52552,"SUKAHARJA, SINDANG JAYA, TANGERANG, BANTEN",39,28,129,157
https://kawalpemilu.org#52552,"SUKAHARJA, SINDANG JAYA, TANGERANG, BANTEN",40,36,131,167
https://kawalpemilu.org#52552,"SUKAHARJA, SINDANG JAYA, TANGERANG, BANTEN",41,26,165,191
https://kawalpemilu.org#52552,"SUKAHARJA, SINDANG JAYA, TANGERANG, BANTEN",42,48,149,197
https://kawalpemilu.org#52552,"SUKAHARJA, SINDANG JAYA, TANGERANG, BANTEN",43,45,161,206
https://kawalpemilu.org#52552,"SUKAHARJA, SINDANG JAYA, TANGERANG, BANTEN",45,41,137,178
https://kawalpemilu.org#52552,"SUKAHARJA, SINDANG JAYA, TANGERANG, BANTEN",46,38,112,150
https://kawalpemilu.org#52552,"SUKAHARJA, SINDANG JAYA, TANGERANG, BANTEN",47,94,146,240
https://kawalpemilu.org#52553,"SINDANGASIH, SINDANG JAYA, TANGERANG, BANTEN",1,85,102,187
https://kawalpemilu.org#52553,"SINDANGASIH, SINDANG JAYA, TANGERANG, BANTEN",2,57,103,160
https://kawalpemilu.org#52553,"SINDANGASIH, SINDANG JAYA, TANGERANG, BANTEN",3,63,168,231
https://kawalpemilu.org#52553,"SINDANGASIH, SINDANG JAYA, TANGERANG, BANTEN",5,79,105,184
https://kawalpemilu.org#52553,"SINDANGASIH, SINDANG JAYA, TANGERANG, BANTEN",6,81,135,216
https://kawalpemilu.org#52553,"SINDANGASIH, SINDANG JAYA, TANGERANG, BANTEN",7,47,158,205
https://kawalpemilu.org#52553,"SINDANGASIH, SINDANG JAYA, TANGERANG, BANTEN",8,43,158,201
https://kawalpemilu.org#52553,"SINDANGASIH, SINDANG JAYA, TANGERANG, BANTEN",9,11,96,107
https://kawalpemilu.org#52553,"SINDANGASIH, SINDANG JAYA, TANGERANG, BANTEN",10,23,150,173
https://kawalpemilu.org#52553,"SINDANGASIH, SINDANG JAYA, TANGERANG, BANTEN",11,35,160,195
https://kawalpemilu.org#52553,"SINDANGASIH, SINDANG JAYA, TANGERANG, BANTEN",12,49,166,215
https://kawalpemilu.org#52553,"SINDANGASIH, SINDANG JAYA, TANGERANG, BANTEN",13,53,144,197
https://kawalpemilu.org#52553,"SINDANGASIH, SINDANG JAYA, TANGERANG, BANTEN",14,52,159,211
https://kawalpemilu.org#52553,"SINDANGASIH, SINDANG JAYA, TANGERANG, BANTEN",15,59,178,237
https://kawalpemilu.org#52553,"SINDANGASIH, SINDANG JAYA, TANGERANG, BANTEN",16,45,189,234
https://kawalpemilu.org#52553,"SINDANGASIH, SINDANG JAYA, TANGERANG, BANTEN",17,8,103,111
https://kawalpemilu.org#52553,"SINDANGASIH, SINDANG JAYA, TANGERANG, BANTEN",18,24,126,150
https://kawalpemilu.org#52553,"SINDANGASIH, SINDANG JAYA, TANGERANG, BANTEN",19,19,133,152
https://kawalpemilu.org#52553,"SINDANGASIH, SINDANG JAYA, TANGERANG, BANTEN",20,19,126,145
https://kawalpemilu.org#52553,"SINDANGASIH, SINDANG JAYA, TANGERANG, BANTEN",22,36,103,139
https://kawalpemilu.org#52553,"SINDANGASIH, SINDANG JAYA, TANGERANG, BANTEN",23,46,133,179
https://kawalpemilu.org#52553,"SINDANGASIH, SINDANG JAYA, TANGERANG, BANTEN",28,79,89,167
https://kawalpemilu.org#52553,"SINDANGASIH, SINDANG JAYA, TANGERANG, BANTEN",30,44,135,179
https://kawalpemilu.org#52554,"SINDANGPANON, SINDANG JAYA, TANGERANG, BANTEN",1,37,127,164
https://kawalpemilu.org#52554,"SINDANGPANON, SINDANG JAYA, TANGERANG, BANTEN",2,31,98,129
https://kawalpemilu.org#52554,"SINDANGPANON, SINDANG JAYA, TANGERANG, BANTEN",3,41,151,192
https://kawalpemilu.org#52554,"SINDANGPANON, SINDANG JAYA, TANGERANG, BANTEN",4,57,129,186
https://kawalpemilu.org#52554,"SINDANGPANON, SINDANG JAYA, TANGERANG, BANTEN",5,78,129,207
https://kawalpemilu.org#52554,"SINDANGPANON, SINDANG JAYA, TANGERANG, BANTEN",6,37,85,122
https://kawalpemilu.org#52554,"SINDANGPANON, SINDANG JAYA, TANGERANG, BANTEN",7,51,131,182
https://kawalpemilu.org#52554,"SINDANGPANON, SINDANG JAYA, TANGERANG, BANTEN",8,44,82,126
https://kawalpemilu.org#52554,"SINDANGPANON, SINDANG JAYA, TANGERANG, BANTEN",9,68,157,225
https://kawalpemilu.org#52554,"SINDANGPANON, SINDANG JAYA, TANGERANG, BANTEN",10,63,160,223
https://kawalpemilu.org#52554,"SINDANGPANON, SINDANG JAYA, TANGERANG, BANTEN",11,49,144,193
https://kawalpemilu.org#52554,"SINDANGPANON, SINDANG JAYA, TANGERANG, BANTEN",12,56,146,202
https://kawalpemilu.org#52554,"SINDANGPANON, SINDANG JAYA, TANGERANG, BANTEN",13,64,123,187
https://kawalpemilu.org#52554,"SINDANGPANON, SINDANG JAYA, TANGERANG, BANTEN",15,42,101,143
https://kawalpemilu.org#52554,"SINDANGPANON, SINDANG JAYA, TANGERANG, BANTEN",16,63,184,247
https://kawalpemilu.org#52554,"SINDANGPANON, SINDANG JAYA, TANGERANG, BANTEN",17,101,149,250
https://kawalpemilu.org#52554,"SINDANGPANON, SINDANG JAYA, TANGERANG, BANTEN",18,66,158,224
https://kawalpemilu.org#52554,"SINDANGPANON, SINDANG JAYA, TANGERANG, BANTEN",19,84,164,248
https://kawalpemilu.org#52554,"SINDANGPANON, SINDANG JAYA, TANGERANG, BANTEN",20,48,147,195
https://kawalpemilu.org#52554,"SINDANGPANON, SINDANG JAYA, TANGERANG, BANTEN",21,46,159,205
https://kawalpemilu.org#52554,"SINDANGPANON, SINDANG JAYA, TANGERANG, BANTEN",22,60,152,212
https://kawalpemilu.org#52554,"SINDANGPANON, SINDANG JAYA, TANGERANG, BANTEN",23,64,127,191
https://kawalpemilu.org#52554,"SINDANGPANON, SINDANG JAYA, TANGERANG, BANTEN",25,34,70,104
https://kawalpemilu.org#52554,"SINDANGPANON, SINDANG JAYA, TANGERANG, BANTEN",26,19,151,170
https://kawalpemilu.org#52554,"SINDANGPANON, SINDANG JAYA, TANGERANG, BANTEN",27,24,143,167
https://kawalpemilu.org#52554,"SINDANGPANON, SINDANG JAYA, TANGERANG, BANTEN",28,46,148,194
https://kawalpemilu.org#52554,"SINDANGPANON, SINDANG JAYA, TANGERANG, BANTEN",29,39,156,195
https://kawalpemilu.org#52554,"SINDANGPANON, SINDANG JAYA, TANGERANG, BANTEN",30,41,159,200
https://kawalpemilu.org#52554,"SINDANGPANON, SINDANG JAYA, TANGERANG, BANTEN",31,19,179,198
https://kawalpemilu.org#52554,"SINDANGPANON, SINDANG JAYA, TANGERANG, BANTEN",32,92,124,216
https://kawalpemilu.org#52554,"SINDANGPANON, SINDANG JAYA, TANGERANG, BANTEN",33,104,127,231
https://kawalpemilu.org#52554,"SINDANGPANON, SINDANG JAYA, TANGERANG, BANTEN",34,172,77,249
https://kawalpemilu.org#52554,"SINDANGPANON, SINDANG JAYA, TANGERANG, BANTEN",35,136,138,274
https://kawalpemilu.org#52554,"SINDANGPANON, SINDANG JAYA, TANGERANG, BANTEN",36,70,73,143
https://kawalpemilu.org#52554,"SINDANGPANON, SINDANG JAYA, TANGERANG, BANTEN",37,82,96,178
https://kawalpemilu.org#52554,"SINDANGPANON, SINDANG JAYA, TANGERANG, BANTEN",38,57,78,135
https://kawalpemilu.org#52554,"SINDANGPANON, SINDANG JAYA, TANGERANG, BANTEN",39,92,143,235
https://kawalpemilu.org#52554,"SINDANGPANON, SINDANG JAYA, TANGERANG, BANTEN",40,71,73,144
https://kawalpemilu.org#52554,"SINDANGPANON, SINDANG JAYA, TANGERANG, BANTEN",41,78,73,151
https://kawalpemilu.org#52554,"SINDANGPANON, SINDANG JAYA, TANGERANG, BANTEN",42,55,130,185
https://kawalpemilu.org#52554,"SINDANGPANON, SINDANG JAYA, TANGERANG, BANTEN",43,72,117,189
https://kawalpemilu.org#52554,"SINDANGPANON, SINDANG JAYA, TANGERANG, BANTEN",44,50,160,210
https://kawalpemilu.org#52554,"SINDANGPANON, SINDANG JAYA, TANGERANG, BANTEN",45,83,120,203
https://kawalpemilu.org#52554,"SINDANGPANON, SINDANG JAYA, TANGERANG, BANTEN",46,48,163,211
https://kawalpemilu.org#52555,"SINDANGSONO, SINDANG JAYA, TANGERANG, BANTEN",1,35,174,209
https://kawalpemilu.org#52555,"SINDANGSONO, SINDANG JAYA, TANGERANG, BANTEN",3,44,156,200
https://kawalpemilu.org#52555,"SINDANGSONO, SINDANG JAYA, TANGERANG, BANTEN",4,39,133,172
https://kawalpemilu.org#52555,"SINDANGSONO, SINDANG JAYA, TANGERANG, BANTEN",5,49,170,219
https://kawalpemilu.org#52555,"SINDANGSONO, SINDANG JAYA, TANGERANG, BANTEN",6,40,177,217
https://kawalpemilu.org#52555,"SINDANGSONO, SINDANG JAYA, TANGERANG, BANTEN",7,21,222,243
https://kawalpemilu.org#52555,"SINDANGSONO, SINDANG JAYA, TANGERANG, BANTEN",8,15,192,207
https://kawalpemilu.org#52555,"SINDANGSONO, SINDANG JAYA, TANGERANG, BANTEN",9,29,168,197
https://kawalpemilu.org#52555,"SINDANGSONO, SINDANG JAYA, TANGERANG, BANTEN",10,35,158,193
https://kawalpemilu.org#52555,"SINDANGSONO, SINDANG JAYA, TANGERANG, BANTEN",12,52,178,230
https://kawalpemilu.org#52555,"SINDANGSONO, SINDANG JAYA, TANGERANG, BANTEN",13,40,189,229
https://kawalpemilu.org#52555,"SINDANGSONO, SINDANG JAYA, TANGERANG, BANTEN",14,17,193,210
https://kawalpemilu.org#52555,"SINDANGSONO, SINDANG JAYA, TANGERANG, BANTEN",15,19,197,216
https://kawalpemilu.org#52555,"SINDANGSONO, SINDANG JAYA, TANGERANG, BANTEN",16,23,159,182
https://kawalpemilu.org#52555,"SINDANGSONO, SINDANG JAYA, TANGERANG, BANTEN",17,41,167,208
https://kawalpemilu.org#52555,"SINDANGSONO, SINDANG JAYA, TANGERANG, BANTEN",18,27,214,241
https://kawalpemilu.org#52555,"SINDANGSONO, SINDANG JAYA, TANGERANG, BANTEN",20,45,168,213
https://kawalpemilu.org#52555,"SINDANGSONO, SINDANG JAYA, TANGERANG, BANTEN",21,29,156,185
https://kawalpemilu.org#52555,"SINDANGSONO, SINDANG JAYA, TANGERANG, BANTEN",22,42,175,217
https://kawalpemilu.org#52555,"SINDANGSONO, SINDANG JAYA, TANGERANG, BANTEN",23,15,189,204
https://kawalpemilu.org#52555,"SINDANGSONO, SINDANG JAYA, TANGERANG, BANTEN",24,15,231,246
https://kawalpemilu.org#52555,"SINDANGSONO, SINDANG JAYA, TANGERANG, BANTEN",26,65,165,230
https://kawalpemilu.org#52555,"SINDANGSONO, SINDANG JAYA, TANGERANG, BANTEN",27,64,142,206
https://kawalpemilu.org#52555,"SINDANGSONO, SINDANG JAYA, TANGERANG, BANTEN",28,61,154,215
https://kawalpemilu.org#52555,"SINDANGSONO, SINDANG JAYA, TANGERANG, BANTEN",30,41,137,178
https://kawalpemilu.org#52555,"SINDANGSONO, SINDANG JAYA, TANGERANG, BANTEN",31,35,109,144
https://kawalpemilu.org#52555,"SINDANGSONO, SINDANG JAYA, TANGERANG, BANTEN",32,39,166,205
https://kawalpemilu.org#52555,"SINDANGSONO, SINDANG JAYA, TANGERANG, BANTEN",33,34,136,170
https://kawalpemilu.org#52555,"SINDANGSONO, SINDANG JAYA, TANGERANG, BANTEN",34,29,198,227
https://kawalpemilu.org#52555,"SINDANGSONO, SINDANG JAYA, TANGERANG, BANTEN",35,52,113,165
https://kawalpemilu.org#52556,"BADAK ANOM, SINDANG JAYA, TANGERANG, BANTEN",1,94,161,255
https://kawalpemilu.org#52556,"BADAK ANOM, SINDANG JAYA, TANGERANG, BANTEN",2,102,145,247
https://kawalpemilu.org#52556,"BADAK ANOM, SINDANG JAYA, TANGERANG, BANTEN",4,87,147,234
https://kawalpemilu.org#52556,"BADAK ANOM, SINDANG JAYA, TANGERANG, BANTEN",5,99,104,203
https://kawalpemilu.org#52556,"BADAK ANOM, SINDANG JAYA, TANGERANG, BANTEN",6,112,111,223
https://kawalpemilu.org#52556,"BADAK ANOM, SINDANG JAYA, TANGERANG, BANTEN",8,26,99,125
https://kawalpemilu.org#52556,"BADAK ANOM, SINDANG JAYA, TANGERANG, BANTEN",9,48,148,196
https://kawalpemilu.org#52556,"BADAK ANOM, SINDANG JAYA, TANGERANG, BANTEN",10,46,117,163
https://kawalpemilu.org#52556,"BADAK ANOM, SINDANG JAYA, TANGERANG, BANTEN",11,33,154,187
https://kawalpemilu.org#52556,"BADAK ANOM, SINDANG JAYA, TANGERANG, BANTEN",12,35,143,178
https://kawalpemilu.org#52556,"BADAK ANOM, SINDANG JAYA, TANGERANG, BANTEN",15,33,134,167
https://kawalpemilu.org#52556,"BADAK ANOM, SINDANG JAYA, TANGERANG, BANTEN",16,28,130,158
https://kawalpemilu.org#52556,"BADAK ANOM, SINDANG JAYA, TANGERANG, BANTEN",18,55,93,148
https://kawalpemilu.org#52556,"BADAK ANOM, SINDANG JAYA, TANGERANG, BANTEN",19,56,138,194
https://kawalpemilu.org#52556,"BADAK ANOM, SINDANG JAYA, TANGERANG, BANTEN",20,90,121,211
https://kawalpemilu.org#52558,"KEDAUNG BARAT, SEPATAN TIMUR, TANGERANG, BANTEN",1,127,130,257
https://kawalpemilu.org#52558,"KEDAUNG BARAT, SEPATAN TIMUR, TANGERANG, BANTEN",2,210,4,214
https://kawalpemilu.org#52558,"KEDAUNG BARAT, SEPATAN TIMUR, TANGERANG, BANTEN",3,166,21,187
https://kawalpemilu.org#52558,"KEDAUNG BARAT, SEPATAN TIMUR, TANGERANG, BANTEN",4,178,52,230
https://kawalpemilu.org#52558,"KEDAUNG BARAT, SEPATAN TIMUR, TANGERANG, BANTEN",5,61,162,223
https://kawalpemilu.org#52558,"KEDAUNG BARAT, SEPATAN TIMUR, TANGERANG, BANTEN",8,95,151,246
https://kawalpemilu.org#52558,"KEDAUNG BARAT, SEPATAN TIMUR, TANGERANG, BANTEN",9,150,103,253
https://kawalpemilu.org#52558,"KEDAUNG BARAT, SEPATAN TIMUR, TANGERANG, BANTEN",10,83,146,229
https://kawalpemilu.org#52558,"KEDAUNG BARAT, SEPATAN TIMUR, TANGERANG, BANTEN",11,55,174,229
https://kawalpemilu.org#52558,"KEDAUNG BARAT, SEPATAN TIMUR, TANGERANG, BANTEN",12,82,119,201
https://kawalpemilu.org#52558,"KEDAUNG BARAT, SEPATAN TIMUR, TANGERANG, BANTEN",13,126,114,240
https://kawalpemilu.org#52558,"KEDAUNG BARAT, SEPATAN TIMUR, TANGERANG, BANTEN",14,105,111,216
https://kawalpemilu.org#52558,"KEDAUNG BARAT, SEPATAN TIMUR, TANGERANG, BANTEN",15,175,66,241
https://kawalpemilu.org#52558,"KEDAUNG BARAT, SEPATAN TIMUR, TANGERANG, BANTEN",20,71,136,207
https://kawalpemilu.org#52558,"KEDAUNG BARAT, SEPATAN TIMUR, TANGERANG, BANTEN",21,123,102,225
https://kawalpemilu.org#52558,"KEDAUNG BARAT, SEPATAN TIMUR, TANGERANG, BANTEN",22,49,161,210
https://kawalpemilu.org#52558,"KEDAUNG BARAT, SEPATAN TIMUR, TANGERANG, BANTEN",23,64,174,238
https://kawalpemilu.org#52558,"KEDAUNG BARAT, SEPATAN TIMUR, TANGERANG, BANTEN",24,154,103,257
https://kawalpemilu.org#52558,"KEDAUNG BARAT, SEPATAN TIMUR, TANGERANG, BANTEN",26,100,136,236
https://kawalpemilu.org#52558,"KEDAUNG BARAT, SEPATAN TIMUR, TANGERANG, BANTEN",27,81,108,189
https://kawalpemilu.org#52558,"KEDAUNG BARAT, SEPATAN TIMUR, TANGERANG, BANTEN",28,43,157,200
https://kawalpemilu.org#52558,"KEDAUNG BARAT, SEPATAN TIMUR, TANGERANG, BANTEN",30,105,107,212
https://kawalpemilu.org#52559,"LEBAK WANGI, SEPATAN TIMUR, TANGERANG, BANTEN",1,41,132,173
https://kawalpemilu.org#52559,"LEBAK WANGI, SEPATAN TIMUR, TANGERANG, BANTEN",4,98,143,241
https://kawalpemilu.org#52559,"LEBAK WANGI, SEPATAN TIMUR, TANGERANG, BANTEN",5,46,156,202
https://kawalpemilu.org#52559,"LEBAK WANGI, SEPATAN TIMUR, TANGERANG, BANTEN",6,41,205,246
https://kawalpemilu.org#52559,"LEBAK WANGI, SEPATAN TIMUR, TANGERANG, BANTEN",7,57,141,198
https://kawalpemilu.org#52559,"LEBAK WANGI, SEPATAN TIMUR, TANGERANG, BANTEN",8,95,130,225
https://kawalpemilu.org#52559,"LEBAK WANGI, SEPATAN TIMUR, TANGERANG, BANTEN",9,121,133,254
https://kawalpemilu.org#52559,"LEBAK WANGI, SEPATAN TIMUR, TANGERANG, BANTEN",10,74,106,180
https://kawalpemilu.org#52559,"LEBAK WANGI, SEPATAN TIMUR, TANGERANG, BANTEN",11,61,175,236
https://kawalpemilu.org#52559,"LEBAK WANGI, SEPATAN TIMUR, TANGERANG, BANTEN",15,143,108,251
https://kawalpemilu.org#52559,"LEBAK WANGI, SEPATAN TIMUR, TANGERANG, BANTEN",16,96,182,278
https://kawalpemilu.org#52559,"LEBAK WANGI, SEPATAN TIMUR, TANGERANG, BANTEN",18,67,162,229
https://kawalpemilu.org#52559,"LEBAK WANGI, SEPATAN TIMUR, TANGERANG, BANTEN",19,80,154,234
https://kawalpemilu.org#52559,"LEBAK WANGI, SEPATAN TIMUR, TANGERANG, BANTEN",21,76,156,232
https://kawalpemilu.org#52559,"LEBAK WANGI, SEPATAN TIMUR, TANGERANG, BANTEN",22,75,137,212
https://kawalpemilu.org#52559,"LEBAK WANGI, SEPATAN TIMUR, TANGERANG, BANTEN",23,58,195,253
https://kawalpemilu.org#52559,"LEBAK WANGI, SEPATAN TIMUR, TANGERANG, BANTEN",24,64,120,184
https://kawalpemilu.org#52559,"LEBAK WANGI, SEPATAN TIMUR, TANGERANG, BANTEN",26,102,141,243
https://kawalpemilu.org#52559,"LEBAK WANGI, SEPATAN TIMUR, TANGERANG, BANTEN",27,60,144,204
https://kawalpemilu.org#52559,"LEBAK WANGI, SEPATAN TIMUR, TANGERANG, BANTEN",28,180,63,243
https://kawalpemilu.org#52559,"LEBAK WANGI, SEPATAN TIMUR, TANGERANG, BANTEN",29,54,111,165
https://kawalpemilu.org#52559,"LEBAK WANGI, SEPATAN TIMUR, TANGERANG, BANTEN",30,51,178,229
https://kawalpemilu.org#52559,"LEBAK WANGI, SEPATAN TIMUR, TANGERANG, BANTEN",31,62,118,180
https://kawalpemilu.org#52559,"LEBAK WANGI, SEPATAN TIMUR, TANGERANG, BANTEN",32,66,166,132
https://kawalpemilu.org#52559,"LEBAK WANGI, SEPATAN TIMUR, TANGERANG, BANTEN",33,53,150,203
https://kawalpemilu.org#52559,"LEBAK WANGI, SEPATAN TIMUR, TANGERANG, BANTEN",34,51,185,236
https://kawalpemilu.org#52559,"LEBAK WANGI, SEPATAN TIMUR, TANGERANG, BANTEN",36,54,112,166
https://kawalpemilu.org#52559,"LEBAK WANGI, SEPATAN TIMUR, TANGERANG, BANTEN",37,106,104,210
https://kawalpemilu.org#52559,"LEBAK WANGI, SEPATAN TIMUR, TANGERANG, BANTEN",38,73,172,245
https://kawalpemilu.org#52559,"LEBAK WANGI, SEPATAN TIMUR, TANGERANG, BANTEN",39,76,110,186
https://kawalpemilu.org#52559,"LEBAK WANGI, SEPATAN TIMUR, TANGERANG, BANTEN",41,81,107,188
https://kawalpemilu.org#52559,"LEBAK WANGI, SEPATAN TIMUR, TANGERANG, BANTEN",42,48,161,209
https://kawalpemilu.org#52559,"LEBAK WANGI, SEPATAN TIMUR, TANGERANG, BANTEN",43,58,118,176
https://kawalpemilu.org#52559,"LEBAK WANGI, SEPATAN TIMUR, TANGERANG, BANTEN",45,129,72,201
https://kawalpemilu.org#52559,"LEBAK WANGI, SEPATAN TIMUR, TANGERANG, BANTEN",46,80,178,258
https://kawalpemilu.org#52559,"LEBAK WANGI, SEPATAN TIMUR, TANGERANG, BANTEN",47,71,118,189
https://kawalpemilu.org#52559,"LEBAK WANGI, SEPATAN TIMUR, TANGERANG, BANTEN",48,64,123,187
https://kawalpemilu.org#52559,"LEBAK WANGI, SEPATAN TIMUR, TANGERANG, BANTEN",49,68,157,225
https://kawalpemilu.org#52559,"LEBAK WANGI, SEPATAN TIMUR, TANGERANG, BANTEN",50,69,168,237
https://kawalpemilu.org#52559,"LEBAK WANGI, SEPATAN TIMUR, TANGERANG, BANTEN",53,42,141,183
https://kawalpemilu.org#52559,"LEBAK WANGI, SEPATAN TIMUR, TANGERANG, BANTEN",54,74,162,236
https://kawalpemilu.org#52559,"LEBAK WANGI, SEPATAN TIMUR, TANGERANG, BANTEN",55,79,143,222
https://kawalpemilu.org#52559,"LEBAK WANGI, SEPATAN TIMUR, TANGERANG, BANTEN",56,72,169,241
https://kawalpemilu.org#52559,"LEBAK WANGI, SEPATAN TIMUR, TANGERANG, BANTEN",57,91,151,242
https://kawalpemilu.org#52559,"LEBAK WANGI, SEPATAN TIMUR, TANGERANG, BANTEN",59,56,116,172
https://kawalpemilu.org#52559,"LEBAK WANGI, SEPATAN TIMUR, TANGERANG, BANTEN",60,71,151,222
https://kawalpemilu.org#52559,"LEBAK WANGI, SEPATAN TIMUR, TANGERANG, BANTEN",61,109,130,239
https://kawalpemilu.org#52559,"LEBAK WANGI, SEPATAN TIMUR, TANGERANG, BANTEN",62,92,146,238
https://kawalpemilu.org#52559,"LEBAK WANGI, SEPATAN TIMUR, TANGERANG, BANTEN",64,69,72,141
https://kawalpemilu.org#52559,"LEBAK WANGI, SEPATAN TIMUR, TANGERANG, BANTEN",65,47,112,159
https://kawalpemilu.org#52560,"JATI MULYA, SEPATAN TIMUR, TANGERANG, BANTEN",1,58,127,185
https://kawalpemilu.org#52560,"JATI MULYA, SEPATAN TIMUR, TANGERANG, BANTEN",2,59,123,182
https://kawalpemilu.org#52560,"JATI MULYA, SEPATAN TIMUR, TANGERANG, BANTEN",3,87,105,192
https://kawalpemilu.org#52560,"JATI MULYA, SEPATAN TIMUR, TANGERANG, BANTEN",4,60,156,216
https://kawalpemilu.org#52560,"JATI MULYA, SEPATAN TIMUR, TANGERANG, BANTEN",5,61,154,215
https://kawalpemilu.org#52560,"JATI MULYA, SEPATAN TIMUR, TANGERANG, BANTEN",6,54,132,186
https://kawalpemilu.org#52560,"JATI MULYA, SEPATAN TIMUR, TANGERANG, BANTEN",9,70,160,230
https://kawalpemilu.org#52560,"JATI MULYA, SEPATAN TIMUR, TANGERANG, BANTEN",14,52,103,155
https://kawalpemilu.org#52560,"JATI MULYA, SEPATAN TIMUR, TANGERANG, BANTEN",17,86,160,246
https://kawalpemilu.org#52560,"JATI MULYA, SEPATAN TIMUR, TANGERANG, BANTEN",22,74,126,200
https://kawalpemilu.org#52560,"JATI MULYA, SEPATAN TIMUR, TANGERANG, BANTEN",25,57,125,182
https://kawalpemilu.org#52561,"SANGIANG, SEPATAN TIMUR, TANGERANG, BANTEN",1,57,146,203
https://kawalpemilu.org#52561,"SANGIANG, SEPATAN TIMUR, TANGERANG, BANTEN",2,71,171,242
https://kawalpemilu.org#52561,"SANGIANG, SEPATAN TIMUR, TANGERANG, BANTEN",3,35,102,137
https://kawalpemilu.org#52561,"SANGIANG, SEPATAN TIMUR, TANGERANG, BANTEN",4,63,173,236
https://kawalpemilu.org#52561,"SANGIANG, SEPATAN TIMUR, TANGERANG, BANTEN",5,67,172,239
https://kawalpemilu.org#52561,"SANGIANG, SEPATAN TIMUR, TANGERANG, BANTEN",6,61,117,178
https://kawalpemilu.org#52561,"SANGIANG, SEPATAN TIMUR, TANGERANG, BANTEN",7,56,146,202
https://kawalpemilu.org#52561,"SANGIANG, SEPATAN TIMUR, TANGERANG, BANTEN",8,67,185,252
https://kawalpemilu.org#52561,"SANGIANG, SEPATAN TIMUR, TANGERANG, BANTEN",9,32,165,197
https://kawalpemilu.org#52561,"SANGIANG, SEPATAN TIMUR, TANGERANG, BANTEN",10,57,135,192
https://kawalpemilu.org#52561,"SANGIANG, SEPATAN TIMUR, TANGERANG, BANTEN",11,58,111,169
https://kawalpemilu.org#52561,"SANGIANG, SEPATAN TIMUR, TANGERANG, BANTEN",15,54,199,253
https://kawalpemilu.org#52561,"SANGIANG, SEPATAN TIMUR, TANGERANG, BANTEN",16,57,169,226
https://kawalpemilu.org#52561,"SANGIANG, SEPATAN TIMUR, TANGERANG, BANTEN",17,58,138,196
https://kawalpemilu.org#52561,"SANGIANG, SEPATAN TIMUR, TANGERANG, BANTEN",19,52,128,180
https://kawalpemilu.org#52561,"SANGIANG, SEPATAN TIMUR, TANGERANG, BANTEN",20,45,105,150
https://kawalpemilu.org#52561,"SANGIANG, SEPATAN TIMUR, TANGERANG, BANTEN",21,59,163,222
https://kawalpemilu.org#52561,"SANGIANG, SEPATAN TIMUR, TANGERANG, BANTEN",23,47,159,206
https://kawalpemilu.org#52561,"SANGIANG, SEPATAN TIMUR, TANGERANG, BANTEN",24,47,129,176
https://kawalpemilu.org#52561,"SANGIANG, SEPATAN TIMUR, TANGERANG, BANTEN",25,60,156,216
https://kawalpemilu.org#52562,"GEMPOL SARI, SEPATAN TIMUR, TANGERANG, BANTEN",1,40,162,202
https://kawalpemilu.org#52562,"GEMPOL SARI, SEPATAN TIMUR, TANGERANG, BANTEN",2,73,158,231
https://kawalpemilu.org#52562,"GEMPOL SARI, SEPATAN TIMUR, TANGERANG, BANTEN",3,104,140,244
https://kawalpemilu.org#52562,"GEMPOL SARI, SEPATAN TIMUR, TANGERANG, BANTEN",4,100,147,247
https://kawalpemilu.org#52562,"GEMPOL SARI, SEPATAN TIMUR, TANGERANG, BANTEN",5,81,154,235
https://kawalpemilu.org#52562,"GEMPOL SARI, SEPATAN TIMUR, TANGERANG, BANTEN",6,115,126,241
https://kawalpemilu.org#52562,"GEMPOL SARI, SEPATAN TIMUR, TANGERANG, BANTEN",7,66,140,206
https://kawalpemilu.org#52562,"GEMPOL SARI, SEPATAN TIMUR, TANGERANG, BANTEN",8,40,144,184
https://kawalpemilu.org#52562,"GEMPOL SARI, SEPATAN TIMUR, TANGERANG, BANTEN",9,83,159,242
https://kawalpemilu.org#52562,"GEMPOL SARI, SEPATAN TIMUR, TANGERANG, BANTEN",11,68,110,178
https://kawalpemilu.org#52562,"GEMPOL SARI, SEPATAN TIMUR, TANGERANG, BANTEN",12,49,140,189
https://kawalpemilu.org#52562,"GEMPOL SARI, SEPATAN TIMUR, TANGERANG, BANTEN",13,82,156,238
https://kawalpemilu.org#52562,"GEMPOL SARI, SEPATAN TIMUR, TANGERANG, BANTEN",14,62,131,193
https://kawalpemilu.org#52562,"GEMPOL SARI, SEPATAN TIMUR, TANGERANG, BANTEN",16,61,197,258
https://kawalpemilu.org#52562,"GEMPOL SARI, SEPATAN TIMUR, TANGERANG, BANTEN",17,45,203,248
https://kawalpemilu.org#52562,"GEMPOL SARI, SEPATAN TIMUR, TANGERANG, BANTEN",18,74,141,215
https://kawalpemilu.org#52562,"GEMPOL SARI, SEPATAN TIMUR, TANGERANG, BANTEN",19,42,87,129
https://kawalpemilu.org#52562,"GEMPOL SARI, SEPATAN TIMUR, TANGERANG, BANTEN",20,56,148,204
https://kawalpemilu.org#52562,"GEMPOL SARI, SEPATAN TIMUR, TANGERANG, BANTEN",21,78,143,221
https://kawalpemilu.org#52562,"GEMPOL SARI, SEPATAN TIMUR, TANGERANG, BANTEN",22,60,139,199
https://kawalpemilu.org#52562,"GEMPOL SARI, SEPATAN TIMUR, TANGERANG, BANTEN",23,59,130,189
https://kawalpemilu.org#52562,"GEMPOL SARI, SEPATAN TIMUR, TANGERANG, BANTEN",24,77,150,227
https://kawalpemilu.org#52562,"GEMPOL SARI, SEPATAN TIMUR, TANGERANG, BANTEN",25,112,124,236
https://kawalpemilu.org#52562,"GEMPOL SARI, SEPATAN TIMUR, TANGERANG, BANTEN",26,78,149,227
https://kawalpemilu.org#52562,"GEMPOL SARI, SEPATAN TIMUR, TANGERANG, BANTEN",27,66,126,192
https://kawalpemilu.org#52562,"GEMPOL SARI, SEPATAN TIMUR, TANGERANG, BANTEN",28,33,151,184
https://kawalpemilu.org#52562,"GEMPOL SARI, SEPATAN TIMUR, TANGERANG, BANTEN",29,80,143,223
https://kawalpemilu.org#52562,"GEMPOL SARI, SEPATAN TIMUR, TANGERANG, BANTEN",30,73,127,200
https://kawalpemilu.org#52562,"GEMPOL SARI, SEPATAN TIMUR, TANGERANG, BANTEN",31,98,116,214
https://kawalpemilu.org#52562,"GEMPOL SARI, SEPATAN TIMUR, TANGERANG, BANTEN",33,64,171,235
https://kawalpemilu.org#52562,"GEMPOL SARI, SEPATAN TIMUR, TANGERANG, BANTEN",34,65,120,185
https://kawalpemilu.org#52562,"GEMPOL SARI, SEPATAN TIMUR, TANGERANG, BANTEN",35,103,129,232
https://kawalpemilu.org#52562,"GEMPOL SARI, SEPATAN TIMUR, TANGERANG, BANTEN",36,68,145,213
https://kawalpemilu.org#52562,"GEMPOL SARI, SEPATAN TIMUR, TANGERANG, BANTEN",37,69,172,241
https://kawalpemilu.org#52562,"GEMPOL SARI, SEPATAN TIMUR, TANGERANG, BANTEN",38,46,175,221
https://kawalpemilu.org#52562,"GEMPOL SARI, SEPATAN TIMUR, TANGERANG, BANTEN",39,52,157,209
https://kawalpemilu.org#52562,"GEMPOL SARI, SEPATAN TIMUR, TANGERANG, BANTEN",40,44,111,155
https://kawalpemilu.org#52563,"KAMPUNG KELOR, SEPATAN TIMUR, TANGERANG, BANTEN",1,66,165,231
https://kawalpemilu.org#52563,"KAMPUNG KELOR, SEPATAN TIMUR, TANGERANG, BANTEN",6,83,190,273
https://kawalpemilu.org#52563,"KAMPUNG KELOR, SEPATAN TIMUR, TANGERANG, BANTEN",8,79,100,179
https://kawalpemilu.org#52563,"KAMPUNG KELOR, SEPATAN TIMUR, TANGERANG, BANTEN",11,84,130,214
https://kawalpemilu.org#52563,"KAMPUNG KELOR, SEPATAN TIMUR, TANGERANG, BANTEN",12,73,137,210
https://kawalpemilu.org#52563,"KAMPUNG KELOR, SEPATAN TIMUR, TANGERANG, BANTEN",13,46,122,168
https://kawalpemilu.org#52563,"KAMPUNG KELOR, SEPATAN TIMUR, TANGERANG, BANTEN",16,121,144,265
https://kawalpemilu.org#52563,"KAMPUNG KELOR, SEPATAN TIMUR, TANGERANG, BANTEN",19,82,115,197
https://kawalpemilu.org#52563,"KAMPUNG KELOR, SEPATAN TIMUR, TANGERANG, BANTEN",21,98,88,186
https://kawalpemilu.org#52563,"KAMPUNG KELOR, SEPATAN TIMUR, TANGERANG, BANTEN",22,69,122,191
https://kawalpemilu.org#52564,"PONDOK KELOR, SEPATAN TIMUR, TANGERANG, BANTEN",1,116,86,202
https://kawalpemilu.org#52564,"PONDOK KELOR, SEPATAN TIMUR, TANGERANG, BANTEN",2,120,91,211
https://kawalpemilu.org#52564,"PONDOK KELOR, SEPATAN TIMUR, TANGERANG, BANTEN",3,106,91,197
https://kawalpemilu.org#52564,"PONDOK KELOR, SEPATAN TIMUR, TANGERANG, BANTEN",4,64,132,196
https://kawalpemilu.org#52564,"PONDOK KELOR, SEPATAN TIMUR, TANGERANG, BANTEN",5,76,127,203
https://kawalpemilu.org#52564,"PONDOK KELOR, SEPATAN TIMUR, TANGERANG, BANTEN",6,73,184,257
https://kawalpemilu.org#52564,"PONDOK KELOR, SEPATAN TIMUR, TANGERANG, BANTEN",7,43,196,239
https://kawalpemilu.org#52564,"PONDOK KELOR, SEPATAN TIMUR, TANGERANG, BANTEN",8,83,153,236
https://kawalpemilu.org#52564,"PONDOK KELOR, SEPATAN TIMUR, TANGERANG, BANTEN",9,50,120,170
https://kawalpemilu.org#52564,"PONDOK KELOR, SEPATAN TIMUR, TANGERANG, BANTEN",11,93,125,218
https://kawalpemilu.org#52564,"PONDOK KELOR, SEPATAN TIMUR, TANGERANG, BANTEN",13,94,65,159
https://kawalpemilu.org#52564,"PONDOK KELOR, SEPATAN TIMUR, TANGERANG, BANTEN",14,56,163,219
https://kawalpemilu.org#52564,"PONDOK KELOR, SEPATAN TIMUR, TANGERANG, BANTEN",15,71,118,189
https://kawalpemilu.org#52564,"PONDOK KELOR, SEPATAN TIMUR, TANGERANG, BANTEN",16,99,135,234
https://kawalpemilu.org#52564,"PONDOK KELOR, SEPATAN TIMUR, TANGERANG, BANTEN",17,40,190,230
https://kawalpemilu.org#52564,"PONDOK KELOR, SEPATAN TIMUR, TANGERANG, BANTEN",18,54,173,227
https://kawalpemilu.org#52564,"PONDOK KELOR, SEPATAN TIMUR, TANGERANG, BANTEN",19,53,193,246
https://kawalpemilu.org#52564,"PONDOK KELOR, SEPATAN TIMUR, TANGERANG, BANTEN",20,77,96,173
https://kawalpemilu.org#52564,"PONDOK KELOR, SEPATAN TIMUR, TANGERANG, BANTEN",21,93,108,201
https://kawalpemilu.org#52565,"TANAH MERAH, SEPATAN TIMUR, TANGERANG, BANTEN",1,62,107,169
https://kawalpemilu.org#52565,"TANAH MERAH, SEPATAN TIMUR, TANGERANG, BANTEN",2,86,145,231
https://kawalpemilu.org#52565,"TANAH MERAH, SEPATAN TIMUR, TANGERANG, BANTEN",3,69,129,198
https://kawalpemilu.org#52565,"TANAH MERAH, SEPATAN TIMUR, TANGERANG, BANTEN",5,52,152,204
https://kawalpemilu.org#52565,"TANAH MERAH, SEPATAN TIMUR, TANGERANG, BANTEN",6,67,123,190
https://kawalpemilu.org#52565,"TANAH MERAH, SEPATAN TIMUR, TANGERANG, BANTEN",8,68,144,212
https://kawalpemilu.org#52565,"TANAH MERAH, SEPATAN TIMUR, TANGERANG, BANTEN",9,79,140,219
https://kawalpemilu.org#52565,"TANAH MERAH, SEPATAN TIMUR, TANGERANG, BANTEN",10,72,139,211
https://kawalpemilu.org#52565,"TANAH MERAH, SEPATAN TIMUR, TANGERANG, BANTEN",11,80,134,214
https://kawalpemilu.org#52565,"TANAH MERAH, SEPATAN TIMUR, TANGERANG, BANTEN",12,46,101,147
https://kawalpemilu.org#52565,"TANAH MERAH, SEPATAN TIMUR, TANGERANG, BANTEN",13,96,166,262
https://kawalpemilu.org#52565,"TANAH MERAH, SEPATAN TIMUR, TANGERANG, BANTEN",14,35,70,105
https://kawalpemilu.org#52565,"TANAH MERAH, SEPATAN TIMUR, TANGERANG, BANTEN",15,85,136,221
https://kawalpemilu.org#52565,"TANAH MERAH, SEPATAN TIMUR, TANGERANG, BANTEN",17,53,112,165
https://kawalpemilu.org#52565,"TANAH MERAH, SEPATAN TIMUR, TANGERANG, BANTEN",18,61,118,179
https://kawalpemilu.org#52565,"TANAH MERAH, SEPATAN TIMUR, TANGERANG, BANTEN",19,34,133,167
https://kawalpemilu.org#52565,"TANAH MERAH, SEPATAN TIMUR, TANGERANG, BANTEN",20,51,125,176
https://kawalpemilu.org#52565,"TANAH MERAH, SEPATAN TIMUR, TANGERANG, BANTEN",21,52,122,174
https://kawalpemilu.org#52565,"TANAH MERAH, SEPATAN TIMUR, TANGERANG, BANTEN",23,68,114,182
https://kawalpemilu.org#52565,"TANAH MERAH, SEPATAN TIMUR, TANGERANG, BANTEN",24,73,134,207
https://kawalpemilu.org#52565,"TANAH MERAH, SEPATAN TIMUR, TANGERANG, BANTEN",25,64,179,243
https://kawalpemilu.org#52565,"TANAH MERAH, SEPATAN TIMUR, TANGERANG, BANTEN",26,70,150,225
https://kawalpemilu.org#52567,"SOLEAR, SOLEAR, TANGERANG, BANTEN",2,52,175,227
https://kawalpemilu.org#52567,"SOLEAR, SOLEAR, TANGERANG, BANTEN",3,93,96,189
https://kawalpemilu.org#52567,"SOLEAR, SOLEAR, TANGERANG, BANTEN",4,83,148,231
https://kawalpemilu.org#52567,"SOLEAR, SOLEAR, TANGERANG, BANTEN",5,112,120,232
https://kawalpemilu.org#52567,"SOLEAR, SOLEAR, TANGERANG, BANTEN",6,41,113,154
https://kawalpemilu.org#52567,"SOLEAR, SOLEAR, TANGERANG, BANTEN",7,113,111,224
https://kawalpemilu.org#52567,"SOLEAR, SOLEAR, TANGERANG, BANTEN",8,120,106,226
https://kawalpemilu.org#52567,"SOLEAR, SOLEAR, TANGERANG, BANTEN",9,57,152,209
https://kawalpemilu.org#52567,"SOLEAR, SOLEAR, TANGERANG, BANTEN",10,55,117,172
https://kawalpemilu.org#52567,"SOLEAR, SOLEAR, TANGERANG, BANTEN",11,63,105,168
https://kawalpemilu.org#52567,"SOLEAR, SOLEAR, TANGERANG, BANTEN",12,152,83,235
https://kawalpemilu.org#52567,"SOLEAR, SOLEAR, TANGERANG, BANTEN",13,130,116,246
https://kawalpemilu.org#52567,"SOLEAR, SOLEAR, TANGERANG, BANTEN",14,64,128,192
https://kawalpemilu.org#52567,"SOLEAR, SOLEAR, TANGERANG, BANTEN",15,60,121,181
https://kawalpemilu.org#52567,"SOLEAR, SOLEAR, TANGERANG, BANTEN",16,66,128,194
https://kawalpemilu.org#52567,"SOLEAR, SOLEAR, TANGERANG, BANTEN",17,124,87,211
https://kawalpemilu.org#52567,"SOLEAR, SOLEAR, TANGERANG, BANTEN",18,106,95,201
https://kawalpemilu.org#52567,"SOLEAR, SOLEAR, TANGERANG, BANTEN",19,83,130,213
https://kawalpemilu.org#52567,"SOLEAR, SOLEAR, TANGERANG, BANTEN",20,63,127,190
https://kawalpemilu.org#52567,"SOLEAR, SOLEAR, TANGERANG, BANTEN",21,72,124,196
https://kawalpemilu.org#52567,"SOLEAR, SOLEAR, TANGERANG, BANTEN",22,50,83,133
https://kawalpemilu.org#52567,"SOLEAR, SOLEAR, TANGERANG, BANTEN",23,71,95,166
https://kawalpemilu.org#52567,"SOLEAR, SOLEAR, TANGERANG, BANTEN",24,90,60,150
https://kawalpemilu.org#52567,"SOLEAR, SOLEAR, TANGERANG, BANTEN",25,78,90,168
https://kawalpemilu.org#52567,"SOLEAR, SOLEAR, TANGERANG, BANTEN",26,45,107,152
https://kawalpemilu.org#52567,"SOLEAR, SOLEAR, TANGERANG, BANTEN",27,112,105,217
https://kawalpemilu.org#52567,"SOLEAR, SOLEAR, TANGERANG, BANTEN",28,93,90,183
https://kawalpemilu.org#52567,"SOLEAR, SOLEAR, TANGERANG, BANTEN",29,112,104,216
https://kawalpemilu.org#52568,"CIKUYA, SOLEAR, TANGERANG, BANTEN",1,74,104,178
https://kawalpemilu.org#52568,"CIKUYA, SOLEAR, TANGERANG, BANTEN",2,115,122,237
https://kawalpemilu.org#52568,"CIKUYA, SOLEAR, TANGERANG, BANTEN",3,55,68,123
https://kawalpemilu.org#52568,"CIKUYA, SOLEAR, TANGERANG, BANTEN",4,102,124,226
https://kawalpemilu.org#52568,"CIKUYA, SOLEAR, TANGERANG, BANTEN",5,89,79,168
https://kawalpemilu.org#52568,"CIKUYA, SOLEAR, TANGERANG, BANTEN",6,112,56,168
https://kawalpemilu.org#52568,"CIKUYA, SOLEAR, TANGERANG, BANTEN",7,124,107,231
https://kawalpemilu.org#52568,"CIKUYA, SOLEAR, TANGERANG, BANTEN",8,148,88,236
https://kawalpemilu.org#52568,"CIKUYA, SOLEAR, TANGERANG, BANTEN",9,104,91,195
https://kawalpemilu.org#52568,"CIKUYA, SOLEAR, TANGERANG, BANTEN",10,63,105,168
https://kawalpemilu.org#52568,"CIKUYA, SOLEAR, TANGERANG, BANTEN",12,81,125,206
https://kawalpemilu.org#52568,"CIKUYA, SOLEAR, TANGERANG, BANTEN",13,165,83,248
https://kawalpemilu.org#52568,"CIKUYA, SOLEAR, TANGERANG, BANTEN",14,75,65,140
https://kawalpemilu.org#52568,"CIKUYA, SOLEAR, TANGERANG, BANTEN",15,67,182,249
https://kawalpemilu.org#52568,"CIKUYA, SOLEAR, TANGERANG, BANTEN",16,102,160,262
https://kawalpemilu.org#52568,"CIKUYA, SOLEAR, TANGERANG, BANTEN",17,47,136,183
https://kawalpemilu.org#52568,"CIKUYA, SOLEAR, TANGERANG, BANTEN",18,93,63,156
https://kawalpemilu.org#52568,"CIKUYA, SOLEAR, TANGERANG, BANTEN",19,101,81,182
https://kawalpemilu.org#52568,"CIKUYA, SOLEAR, TANGERANG, BANTEN",20,86,71,157
https://kawalpemilu.org#52568,"CIKUYA, SOLEAR, TANGERANG, BANTEN",21,144,129,273
https://kawalpemilu.org#52568,"CIKUYA, SOLEAR, TANGERANG, BANTEN",23,101,118,219
https://kawalpemilu.org#52568,"CIKUYA, SOLEAR, TANGERANG, BANTEN",24,83,75,185
https://kawalpemilu.org#52568,"CIKUYA, SOLEAR, TANGERANG, BANTEN",25,115,57,172
https://kawalpemilu.org#52568,"CIKUYA, SOLEAR, TANGERANG, BANTEN",26,134,109,243
https://kawalpemilu.org#52568,"CIKUYA, SOLEAR, TANGERANG, BANTEN",27,116,39,155
https://kawalpemilu.org#52568,"CIKUYA, SOLEAR, TANGERANG, BANTEN",28,105,71,176
https://kawalpemilu.org#52568,"CIKUYA, SOLEAR, TANGERANG, BANTEN",29,75,74,149
https://kawalpemilu.org#52568,"CIKUYA, SOLEAR, TANGERANG, BANTEN",30,108,129,231
https://kawalpemilu.org#52568,"CIKUYA, SOLEAR, TANGERANG, BANTEN",31,102,60,162
https://kawalpemilu.org#52568,"CIKUYA, SOLEAR, TANGERANG, BANTEN",32,154,86,240
https://kawalpemilu.org#52568,"CIKUYA, SOLEAR, TANGERANG, BANTEN",33,122,101,223
https://kawalpemilu.org#52568,"CIKUYA, SOLEAR, TANGERANG, BANTEN",34,89,84,173
https://kawalpemilu.org#52568,"CIKUYA, SOLEAR, TANGERANG, BANTEN",35,76,64,140
https://kawalpemilu.org#52568,"CIKUYA, SOLEAR, TANGERANG, BANTEN",36,111,125,236
https://kawalpemilu.org#52568,"CIKUYA, SOLEAR, TANGERANG, BANTEN",37,91,119,210
https://kawalpemilu.org#52568,"CIKUYA, SOLEAR, TANGERANG, BANTEN",38,139,92,231
https://kawalpemilu.org#52568,"CIKUYA, SOLEAR, TANGERANG, BANTEN",39,145,74,219
https://kawalpemilu.org#52568,"CIKUYA, SOLEAR, TANGERANG, BANTEN",40,40,109,149
https://kawalpemilu.org#52568,"CIKUYA, SOLEAR, TANGERANG, BANTEN",41,100,42,142
https://kawalpemilu.org#52568,"CIKUYA, SOLEAR, TANGERANG, BANTEN",42,46,39,85
https://kawalpemilu.org#52569,"CIKASUNGKA, SOLEAR, TANGERANG, BANTEN",1,119,120,239
https://kawalpemilu.org#52569,"CIKASUNGKA, SOLEAR, TANGERANG, BANTEN",2,112,81,193
https://kawalpemilu.org#52569,"CIKASUNGKA, SOLEAR, TANGERANG, BANTEN",3,40,124,164
https://kawalpemilu.org#52569,"CIKASUNGKA, SOLEAR, TANGERANG, BANTEN",4,71,123,194
https://kawalpemilu.org#52569,"CIKASUNGKA, SOLEAR, TANGERANG, BANTEN",5,97,115,212
https://kawalpemilu.org#52569,"CIKASUNGKA, SOLEAR, TANGERANG, BANTEN",6,77,112,189
https://kawalpemilu.org#52569,"CIKASUNGKA, SOLEAR, TANGERANG, BANTEN",7,78,119,197
https://kawalpemilu.org#52569,"CIKASUNGKA, SOLEAR, TANGERANG, BANTEN",8,74,102,176
https://kawalpemilu.org#52569,"CIKASUNGKA, SOLEAR, TANGERANG, BANTEN",9,58,99,157
https://kawalpemilu.org#52569,"CIKASUNGKA, SOLEAR, TANGERANG, BANTEN",10,98,97,195
https://kawalpemilu.org#52569,"CIKASUNGKA, SOLEAR, TANGERANG, BANTEN",11,70,79,149
https://kawalpemilu.org#52569,"CIKASUNGKA, SOLEAR, TANGERANG, BANTEN",13,104,95,199
https://kawalpemilu.org#52569,"CIKASUNGKA, SOLEAR, TANGERANG, BANTEN",14,106,85,191
https://kawalpemilu.org#52569,"CIKASUNGKA, SOLEAR, TANGERANG, BANTEN",15,100,91,191
https://kawalpemilu.org#52569,"CIKASUNGKA, SOLEAR, TANGERANG, BANTEN",16,99,106,205
https://kawalpemilu.org#52569,"CIKASUNGKA, SOLEAR, TANGERANG, BANTEN",17,91,91,182
https://kawalpemilu.org#52569,"CIKASUNGKA, SOLEAR, TANGERANG, BANTEN",18,104,150,254
https://kawalpemilu.org#52569,"CIKASUNGKA, SOLEAR, TANGERANG, BANTEN",19,115,106,221
https://kawalpemilu.org#52569,"CIKASUNGKA, SOLEAR, TANGERANG, BANTEN",20,105,79,184
https://kawalpemilu.org#52569,"CIKASUNGKA, SOLEAR, TANGERANG, BANTEN",21,114,93,207
https://kawalpemilu.org#52569,"CIKASUNGKA, SOLEAR, TANGERANG, BANTEN",22,96,115,211
https://kawalpemilu.org#52569,"CIKASUNGKA, SOLEAR, TANGERANG, BANTEN",23,93,86,179
https://kawalpemilu.org#52569,"CIKASUNGKA, SOLEAR, TANGERANG, BANTEN",24,68,93,161
https://kawalpemilu.org#52569,"CIKASUNGKA, SOLEAR, TANGERANG, BANTEN",25,166,103,269
https://kawalpemilu.org#52569,"CIKASUNGKA, SOLEAR, TANGERANG, BANTEN",26,106,99,205
https://kawalpemilu.org#52569,"CIKASUNGKA, SOLEAR, TANGERANG, BANTEN",27,80,70,150
https://kawalpemilu.org#52569,"CIKASUNGKA, SOLEAR, TANGERANG, BANTEN",28,91,130,221
https://kawalpemilu.org#52569,"CIKASUNGKA, SOLEAR, TANGERANG, BANTEN",29,100,57,157
https://kawalpemilu.org#52569,"CIKASUNGKA, SOLEAR, TANGERANG, BANTEN",30,126,104,230
https://kawalpemilu.org#52569,"CIKASUNGKA, SOLEAR, TANGERANG, BANTEN",31,76,79,155
https://kawalpemilu.org#52569,"CIKASUNGKA, SOLEAR, TANGERANG, BANTEN",32,78,111,189
https://kawalpemilu.org#52569,"CIKASUNGKA, SOLEAR, TANGERANG, BANTEN",33,84,132,216
https://kawalpemilu.org#52569,"CIKASUNGKA, SOLEAR, TANGERANG, BANTEN",34,58,125,183
https://kawalpemilu.org#52569,"CIKASUNGKA, SOLEAR, TANGERANG, BANTEN",35,97,123,220
https://kawalpemilu.org#52569,"CIKASUNGKA, SOLEAR, TANGERANG, BANTEN",36,78,93,171
https://kawalpemilu.org#52569,"CIKASUNGKA, SOLEAR, TANGERANG, BANTEN",37,95,86,181
https://kawalpemilu.org#52569,"CIKASUNGKA, SOLEAR, TANGERANG, BANTEN",38,101,105,206
https://kawalpemilu.org#52569,"CIKASUNGKA, SOLEAR, TANGERANG, BANTEN",39,95,57,152
https://kawalpemilu.org#52569,"CIKASUNGKA, SOLEAR, TANGERANG, BANTEN",40,67,116,183
https://kawalpemilu.org#52569,"CIKASUNGKA, SOLEAR, TANGERANG, BANTEN",41,59,83,142
https://kawalpemilu.org#52569,"CIKASUNGKA, SOLEAR, TANGERANG, BANTEN",42,78,51,129
https://kawalpemilu.org#52569,"CIKASUNGKA, SOLEAR, TANGERANG, BANTEN",43,90,71,161
https://kawalpemilu.org#52569,"CIKASUNGKA, SOLEAR, TANGERANG, BANTEN",44,77,139,216
https://kawalpemilu.org#52569,"CIKASUNGKA, SOLEAR, TANGERANG, BANTEN",45,60,125,185
https://kawalpemilu.org#52569,"CIKASUNGKA, SOLEAR, TANGERANG, BANTEN",46,108,34,142
https://kawalpemilu.org#52569,"CIKASUNGKA, SOLEAR, TANGERANG, BANTEN",47,99,80,179
https://kawalpemilu.org#52569,"CIKASUNGKA, SOLEAR, TANGERANG, BANTEN",48,116,97,213
https://kawalpemilu.org#52569,"CIKASUNGKA, SOLEAR, TANGERANG, BANTEN",49,88,98,186
https://kawalpemilu.org#52569,"CIKASUNGKA, SOLEAR, TANGERANG, BANTEN",50,169,83,252
https://kawalpemilu.org#52569,"CIKASUNGKA, SOLEAR, TANGERANG, BANTEN",51,124,112,236
https://kawalpemilu.org#52569,"CIKASUNGKA, SOLEAR, TANGERANG, BANTEN",52,144,94,238
https://kawalpemilu.org#52569,"CIKASUNGKA, SOLEAR, TANGERANG, BANTEN",53,77,90,167
https://kawalpemilu.org#52569,"CIKASUNGKA, SOLEAR, TANGERANG, BANTEN",54,89,99,188
https://kawalpemilu.org#52569,"CIKASUNGKA, SOLEAR, TANGERANG, BANTEN",55,131,83,214
https://kawalpemilu.org#52569,"CIKASUNGKA, SOLEAR, TANGERANG, BANTEN",56,61,78,139
https://kawalpemilu.org#52569,"CIKASUNGKA, SOLEAR, TANGERANG, BANTEN",57,115,75,190
https://kawalpemilu.org#52569,"CIKASUNGKA, SOLEAR, TANGERANG, BANTEN",58,130,89,219
https://kawalpemilu.org#52569,"CIKASUNGKA, SOLEAR, TANGERANG, BANTEN",59,129,92,221
https://kawalpemilu.org#52569,"CIKASUNGKA, SOLEAR, TANGERANG, BANTEN",60,112,115,227
https://kawalpemilu.org#52569,"CIKASUNGKA, SOLEAR, TANGERANG, BANTEN",61,90,87,177
https://kawalpemilu.org#52569,"CIKASUNGKA, SOLEAR, TANGERANG, BANTEN",62,122,122,244
https://kawalpemilu.org#52569,"CIKASUNGKA, SOLEAR, TANGERANG, BANTEN",63,85,50,135
https://kawalpemilu.org#52570,"CIREUNDEU, SOLEAR, TANGERANG, BANTEN",1,112,148,260
https://kawalpemilu.org#52570,"CIREUNDEU, SOLEAR, TANGERANG, BANTEN",2,135,83,218
https://kawalpemilu.org#52570,"CIREUNDEU, SOLEAR, TANGERANG, BANTEN",3,127,97,224
https://kawalpemilu.org#52570,"CIREUNDEU, SOLEAR, TANGERANG, BANTEN",4,112,137,249
https://kawalpemilu.org#52570,"CIREUNDEU, SOLEAR, TANGERANG, BANTEN",5,116,111,227
https://kawalpemilu.org#52570,"CIREUNDEU, SOLEAR, TANGERANG, BANTEN",6,70,82,152
https://kawalpemilu.org#52570,"CIREUNDEU, SOLEAR, TANGERANG, BANTEN",7,95,143,238
https://kawalpemilu.org#52570,"CIREUNDEU, SOLEAR, TANGERANG, BANTEN",8,104,106,210
https://kawalpemilu.org#52570,"CIREUNDEU, SOLEAR, TANGERANG, BANTEN",9,107,123,230
https://kawalpemilu.org#52570,"CIREUNDEU, SOLEAR, TANGERANG, BANTEN",10,129,88,217
https://kawalpemilu.org#52570,"CIREUNDEU, SOLEAR, TANGERANG, BANTEN",11,98,51,149
https://kawalpemilu.org#52570,"CIREUNDEU, SOLEAR, TANGERANG, BANTEN",12,141,51,192
https://kawalpemilu.org#52570,"CIREUNDEU, SOLEAR, TANGERANG, BANTEN",13,81,106,187
https://kawalpemilu.org#52570,"CIREUNDEU, SOLEAR, TANGERANG, BANTEN",14,89,92,181
https://kawalpemilu.org#52571,"CIKAREO, SOLEAR, TANGERANG, BANTEN",2,125,124,249
https://kawalpemilu.org#52571,"CIKAREO, SOLEAR, TANGERANG, BANTEN",8,81,65,146
https://kawalpemilu.org#52571,"CIKAREO, SOLEAR, TANGERANG, BANTEN",9,95,147,242
https://kawalpemilu.org#52571,"CIKAREO, SOLEAR, TANGERANG, BANTEN",10,89,121,210
https://kawalpemilu.org#52571,"CIKAREO, SOLEAR, TANGERANG, BANTEN",11,92,61,153
https://kawalpemilu.org#52571,"CIKAREO, SOLEAR, TANGERANG, BANTEN",12,144,79,223
https://kawalpemilu.org#52571,"CIKAREO, SOLEAR, TANGERANG, BANTEN",13,137,93,230
https://kawalpemilu.org#52571,"CIKAREO, SOLEAR, TANGERANG, BANTEN",14,95,84,179
https://kawalpemilu.org#52571,"CIKAREO, SOLEAR, TANGERANG, BANTEN",15,92,57,149
https://kawalpemilu.org#52571,"CIKAREO, SOLEAR, TANGERANG, BANTEN",16,74,52,126
https://kawalpemilu.org#52571,"CIKAREO, SOLEAR, TANGERANG, BANTEN",17,63,66,129
https://kawalpemilu.org#52572,"PASANGGRAHAN, SOLEAR, TANGERANG, BANTEN",1,70,122,192
https://kawalpemilu.org#52572,"PASANGGRAHAN, SOLEAR, TANGERANG, BANTEN",2,64,119,183
https://kawalpemilu.org#52572,"PASANGGRAHAN, SOLEAR, TANGERANG, BANTEN",3,62,90,157
https://kawalpemilu.org#52572,"PASANGGRAHAN, SOLEAR, TANGERANG, BANTEN",4,133,79,212
https://kawalpemilu.org#52572,"PASANGGRAHAN, SOLEAR, TANGERANG, BANTEN",5,89,125,214
https://kawalpemilu.org#52572,"PASANGGRAHAN, SOLEAR, TANGERANG, BANTEN",6,78,85,163
https://kawalpemilu.org#52572,"PASANGGRAHAN, SOLEAR, TANGERANG, BANTEN",7,76,99,175
https://kawalpemilu.org#52572,"PASANGGRAHAN, SOLEAR, TANGERANG, BANTEN",8,93,111,204
https://kawalpemilu.org#52572,"PASANGGRAHAN, SOLEAR, TANGERANG, BANTEN",9,94,120,214
https://kawalpemilu.org#52572,"PASANGGRAHAN, SOLEAR, TANGERANG, BANTEN",10,95,117,212
https://kawalpemilu.org#52572,"PASANGGRAHAN, SOLEAR, TANGERANG, BANTEN",11,84,127,211
https://kawalpemilu.org#52572,"PASANGGRAHAN, SOLEAR, TANGERANG, BANTEN",13,78,84,162
https://kawalpemilu.org#52572,"PASANGGRAHAN, SOLEAR, TANGERANG, BANTEN",14,60,131,191
https://kawalpemilu.org#52572,"PASANGGRAHAN, SOLEAR, TANGERANG, BANTEN",15,110,113,223
https://kawalpemilu.org#52572,"PASANGGRAHAN, SOLEAR, TANGERANG, BANTEN",16,105,139,244
https://kawalpemilu.org#52572,"PASANGGRAHAN, SOLEAR, TANGERANG, BANTEN",17,86,139,225
https://kawalpemilu.org#52572,"PASANGGRAHAN, SOLEAR, TANGERANG, BANTEN",18,61,112,173
https://kawalpemilu.org#52572,"PASANGGRAHAN, SOLEAR, TANGERANG, BANTEN",19,75,128,203
https://kawalpemilu.org#52572,"PASANGGRAHAN, SOLEAR, TANGERANG, BANTEN",20,73,88,161
https://kawalpemilu.org#52572,"PASANGGRAHAN, SOLEAR, TANGERANG, BANTEN",21,54,91,145
https://kawalpemilu.org#52572,"PASANGGRAHAN, SOLEAR, TANGERANG, BANTEN",22,56,57,113
https://kawalpemilu.org#52572,"PASANGGRAHAN, SOLEAR, TANGERANG, BANTEN",23,60,104,164
https://kawalpemilu.org#52572,"PASANGGRAHAN, SOLEAR, TANGERANG, BANTEN",24,103,142,245
https://kawalpemilu.org#52572,"PASANGGRAHAN, SOLEAR, TANGERANG, BANTEN",25,94,120,214
https://kawalpemilu.org#52572,"PASANGGRAHAN, SOLEAR, TANGERANG, BANTEN",26,83,162,245
https://kawalpemilu.org#52572,"PASANGGRAHAN, SOLEAR, TANGERANG, BANTEN",27,62,114,176
https://kawalpemilu.org#52572,"PASANGGRAHAN, SOLEAR, TANGERANG, BANTEN",28,61,87,148
https://kawalpemilu.org#52572,"PASANGGRAHAN, SOLEAR, TANGERANG, BANTEN",29,68,102,170
https://kawalpemilu.org#52572,"PASANGGRAHAN, SOLEAR, TANGERANG, BANTEN",30,57,76,135
https://kawalpemilu.org#52572,"PASANGGRAHAN, SOLEAR, TANGERANG, BANTEN",31,118,133,251
https://kawalpemilu.org#52572,"PASANGGRAHAN, SOLEAR, TANGERANG, BANTEN",32,48,105,153
https://kawalpemilu.org#52572,"PASANGGRAHAN, SOLEAR, TANGERANG, BANTEN",33,45,94,139
https://kawalpemilu.org#52572,"PASANGGRAHAN, SOLEAR, TANGERANG, BANTEN",34,53,67,120
https://kawalpemilu.org#52572,"PASANGGRAHAN, SOLEAR, TANGERANG, BANTEN",35,88,87,175
https://kawalpemilu.org#52572,"PASANGGRAHAN, SOLEAR, TANGERANG, BANTEN",36,67,88,155
https://kawalpemilu.org#52572,"PASANGGRAHAN, SOLEAR, TANGERANG, BANTEN",37,79,55,134
https://kawalpemilu.org#52572,"PASANGGRAHAN, SOLEAR, TANGERANG, BANTEN",38,67,122,189
https://kawalpemilu.org#52572,"PASANGGRAHAN, SOLEAR, TANGERANG, BANTEN",39,142,152,294
https://kawalpemilu.org#52572,"PASANGGRAHAN, SOLEAR, TANGERANG, BANTEN",40,91,119,210
https://kawalpemilu.org#52572,"PASANGGRAHAN, SOLEAR, TANGERANG, BANTEN",41,105,128,233
https://kawalpemilu.org#52572,"PASANGGRAHAN, SOLEAR, TANGERANG, BANTEN",42,60,174,234
https://kawalpemilu.org#52572,"PASANGGRAHAN, SOLEAR, TANGERANG, BANTEN",43,78,140,218
https://kawalpemilu.org#52572,"PASANGGRAHAN, SOLEAR, TANGERANG, BANTEN",44,72,180,252
https://kawalpemilu.org#52572,"PASANGGRAHAN, SOLEAR, TANGERANG, BANTEN",45,105,105,210
https://kawalpemilu.org#52572,"PASANGGRAHAN, SOLEAR, TANGERANG, BANTEN",46,61,148,209
https://kawalpemilu.org#52572,"PASANGGRAHAN, SOLEAR, TANGERANG, BANTEN",47,42,85,127
https://kawalpemilu.org#52572,"PASANGGRAHAN, SOLEAR, TANGERANG, BANTEN",48,95,133,228
https://kawalpemilu.org#52572,"PASANGGRAHAN, SOLEAR, TANGERANG, BANTEN",50,61,91,152
https://kawalpemilu.org#52572,"PASANGGRAHAN, SOLEAR, TANGERANG, BANTEN",51,49,115,164
https://kawalpemilu.org#52572,"PASANGGRAHAN, SOLEAR, TANGERANG, BANTEN",52,103,142,245
https://kawalpemilu.org#52572,"PASANGGRAHAN, SOLEAR, TANGERANG, BANTEN",53,53,141,194
https://kawalpemilu.org#52572,"PASANGGRAHAN, SOLEAR, TANGERANG, BANTEN",54,86,152,238
https://kawalpemilu.org#52572,"PASANGGRAHAN, SOLEAR, TANGERANG, BANTEN",55,110,136,246
https://kawalpemilu.org#52573,"MUNJUL, SOLEAR, TANGERANG, BANTEN",1,139,115,254
https://kawalpemilu.org#52573,"MUNJUL, SOLEAR, TANGERANG, BANTEN",2,117,145,262
https://kawalpemilu.org#52573,"MUNJUL, SOLEAR, TANGERANG, BANTEN",3,46,138,184
https://kawalpemilu.org#52573,"MUNJUL, SOLEAR, TANGERANG, BANTEN",4,103,154,257
https://kawalpemilu.org#52573,"MUNJUL, SOLEAR, TANGERANG, BANTEN",5,126,182,308
https://kawalpemilu.org#52573,"MUNJUL, SOLEAR, TANGERANG, BANTEN",6,100,132,232
https://kawalpemilu.org#52573,"MUNJUL, SOLEAR, TANGERANG, BANTEN",7,38,160,198
https://kawalpemilu.org#52573,"MUNJUL, SOLEAR, TANGERANG, BANTEN",8,119,98,217
https://kawalpemilu.org#52573,"MUNJUL, SOLEAR, TANGERANG, BANTEN",9,134,102,236
https://kawalpemilu.org#52573,"MUNJUL, SOLEAR, TANGERANG, BANTEN",10,58,182,240
https://kawalpemilu.org#52573,"MUNJUL, SOLEAR, TANGERANG, BANTEN",11,119,133,252
https://kawalpemilu.org#52573,"MUNJUL, SOLEAR, TANGERANG, BANTEN",12,49,82,131
https://kawalpemilu.org#52573,"MUNJUL, SOLEAR, TANGERANG, BANTEN",13,53,155,208
https://kawalpemilu.org#52573,"MUNJUL, SOLEAR, TANGERANG, BANTEN",14,50,124,174
https://kawalpemilu.org#52573,"MUNJUL, SOLEAR, TANGERANG, BANTEN",15,192,61,253
https://kawalpemilu.org#52573,"MUNJUL, SOLEAR, TANGERANG, BANTEN",16,170,93,263
https://kawalpemilu.org#52573,"MUNJUL, SOLEAR, TANGERANG, BANTEN",17,45,188,233
https://kawalpemilu.org#52573,"MUNJUL, SOLEAR, TANGERANG, BANTEN",18,79,118,197
https://kawalpemilu.org#52573,"MUNJUL, SOLEAR, TANGERANG, BANTEN",19,81,151,232
https://kawalpemilu.org#52573,"MUNJUL, SOLEAR, TANGERANG, BANTEN",20,38,133,171
https://kawalpemilu.org#52573,"MUNJUL, SOLEAR, TANGERANG, BANTEN",21,66,112,178
https://kawalpemilu.org#52573,"MUNJUL, SOLEAR, TANGERANG, BANTEN",22,90,123,213
https://kawalpemilu.org#52573,"MUNJUL, SOLEAR, TANGERANG, BANTEN",23,132,95,227
https://kawalpemilu.org#52573,"MUNJUL, SOLEAR, TANGERANG, BANTEN",24,110,112,222
https://kawalpemilu.org#52573,"MUNJUL, SOLEAR, TANGERANG, BANTEN",25,95,151,246
https://kawalpemilu.org#52575,"GUNUNG KALER, GUNUNG KALER, TANGERANG, BANTEN",1,105,115,220
https://kawalpemilu.org#52575,"GUNUNG KALER, GUNUNG KALER, TANGERANG, BANTEN",2,31,97,128
https://kawalpemilu.org#52575,"GUNUNG KALER, GUNUNG KALER, TANGERANG, BANTEN",3,50,98,148
https://kawalpemilu.org#52575,"GUNUNG KALER, GUNUNG KALER, TANGERANG, BANTEN",4,64,117,181
https://kawalpemilu.org#52575,"GUNUNG KALER, GUNUNG KALER, TANGERANG, BANTEN",9,93,124,217
https://kawalpemilu.org#52575,"GUNUNG KALER, GUNUNG KALER, TANGERANG, BANTEN",11,28,98,126
https://kawalpemilu.org#52575,"GUNUNG KALER, GUNUNG KALER, TANGERANG, BANTEN",13,63,126,189
https://kawalpemilu.org#52575,"GUNUNG KALER, GUNUNG KALER, TANGERANG, BANTEN",14,69,112,181
https://kawalpemilu.org#52575,"GUNUNG KALER, GUNUNG KALER, TANGERANG, BANTEN",15,117,78,195
https://kawalpemilu.org#52575,"GUNUNG KALER, GUNUNG KALER, TANGERANG, BANTEN",18,83,127,210
https://kawalpemilu.org#52576,"SIDOKO, GUNUNG KALER, TANGERANG, BANTEN",1,72,120,192
https://kawalpemilu.org#52576,"SIDOKO, GUNUNG KALER, TANGERANG, BANTEN",7,62,76,138
https://kawalpemilu.org#52576,"SIDOKO, GUNUNG KALER, TANGERANG, BANTEN",9,92,129,221
https://kawalpemilu.org#52576,"SIDOKO, GUNUNG KALER, TANGERANG, BANTEN",11,63,103,163
https://kawalpemilu.org#52576,"SIDOKO, GUNUNG KALER, TANGERANG, BANTEN",12,56,110,166
https://kawalpemilu.org#52576,"SIDOKO, GUNUNG KALER, TANGERANG, BANTEN",15,42,148,190
https://kawalpemilu.org#52576,"SIDOKO, GUNUNG KALER, TANGERANG, BANTEN",16,65,111,176
https://kawalpemilu.org#52576,"SIDOKO, GUNUNG KALER, TANGERANG, BANTEN",17,57,108,165
https://kawalpemilu.org#52576,"SIDOKO, GUNUNG KALER, TANGERANG, BANTEN",18,76,62,138
https://kawalpemilu.org#52577,"RANCAGEDE, GUNUNG KALER, TANGERANG, BANTEN",1,76,57,133
https://kawalpemilu.org#52577,"RANCAGEDE, GUNUNG KALER, TANGERANG, BANTEN",2,120,83,203
https://kawalpemilu.org#52577,"RANCAGEDE, GUNUNG KALER, TANGERANG, BANTEN",3,74,92,166
https://kawalpemilu.org#52577,"RANCAGEDE, GUNUNG KALER, TANGERANG, BANTEN",4,81,72,153
https://kawalpemilu.org#52577,"RANCAGEDE, GUNUNG KALER, TANGERANG, BANTEN",5,150,75,225
https://kawalpemilu.org#52577,"RANCAGEDE, GUNUNG KALER, TANGERANG, BANTEN",6,91,75,166
https://kawalpemilu.org#52577,"RANCAGEDE, GUNUNG KALER, TANGERANG, BANTEN",7,43,90,133
https://kawalpemilu.org#52577,"RANCAGEDE, GUNUNG KALER, TANGERANG, BANTEN",8,77,105,182
https://kawalpemilu.org#52577,"RANCAGEDE, GUNUNG KALER, TANGERANG, BANTEN",9,70,66,136
https://kawalpemilu.org#52577,"RANCAGEDE, GUNUNG KALER, TANGERANG, BANTEN",10,109,130,239
https://kawalpemilu.org#52577,"RANCAGEDE, GUNUNG KALER, TANGERANG, BANTEN",11,45,63,108
https://kawalpemilu.org#52577,"RANCAGEDE, GUNUNG KALER, TANGERANG, BANTEN",12,140,50,190
https://kawalpemilu.org#52577,"RANCAGEDE, GUNUNG KALER, TANGERANG, BANTEN",13,143,75,218
https://kawalpemilu.org#52577,"RANCAGEDE, GUNUNG KALER, TANGERANG, BANTEN",14,115,85,200
https://kawalpemilu.org#52577,"RANCAGEDE, GUNUNG KALER, TANGERANG, BANTEN",15,66,47,113
https://kawalpemilu.org#52577,"RANCAGEDE, GUNUNG KALER, TANGERANG, BANTEN",16,158,56,214
https://kawalpemilu.org#52577,"RANCAGEDE, GUNUNG KALER, TANGERANG, BANTEN",17,80,60,140
https://kawalpemilu.org#52577,"RANCAGEDE, GUNUNG KALER, TANGERANG, BANTEN",18,85,52,137
https://kawalpemilu.org#52577,"RANCAGEDE, GUNUNG KALER, TANGERANG, BANTEN",19,114,110,224
https://kawalpemilu.org#52577,"RANCAGEDE, GUNUNG KALER, TANGERANG, BANTEN",20,42,68,110
https://kawalpemilu.org#52577,"RANCAGEDE, GUNUNG KALER, TANGERANG, BANTEN",21,50,72,122
https://kawalpemilu.org#52577,"RANCAGEDE, GUNUNG KALER, TANGERANG, BANTEN",22,68,63,131
https://kawalpemilu.org#52577,"RANCAGEDE, GUNUNG KALER, TANGERANG, BANTEN",24,107,76,183
https://kawalpemilu.org#52577,"RANCAGEDE, GUNUNG KALER, TANGERANG, BANTEN",25,60,129,189
https://kawalpemilu.org#52578,"KEDUNG, GUNUNG KALER, TANGERANG, BANTEN",1,85,78,163
https://kawalpemilu.org#52578,"KEDUNG, GUNUNG KALER, TANGERANG, BANTEN",2,88,83,171
https://kawalpemilu.org#52578,"KEDUNG, GUNUNG KALER, TANGERANG, BANTEN",8,41,113,154
https://kawalpemilu.org#52578,"KEDUNG, GUNUNG KALER, TANGERANG, BANTEN",9,56,71,127
https://kawalpemilu.org#52578,"KEDUNG, GUNUNG KALER, TANGERANG, BANTEN",10,138,88,226
https://kawalpemilu.org#52578,"KEDUNG, GUNUNG KALER, TANGERANG, BANTEN",13,60,88,148
https://kawalpemilu.org#52578,"KEDUNG, GUNUNG KALER, TANGERANG, BANTEN",14,39,57,96
https://kawalpemilu.org#52578,"KEDUNG, GUNUNG KALER, TANGERANG, BANTEN",15,87,46,133
https://kawalpemilu.org#52578,"KEDUNG, GUNUNG KALER, TANGERANG, BANTEN",16,78,57,135
https://kawalpemilu.org#52578,"KEDUNG, GUNUNG KALER, TANGERANG, BANTEN",17,49,55,104
https://kawalpemilu.org#52578,"KEDUNG, GUNUNG KALER, TANGERANG, BANTEN",18,59,86,145
https://kawalpemilu.org#52579,"CIPAEH, GUNUNG KALER, TANGERANG, BANTEN",2,156,36,192
https://kawalpemilu.org#52579,"CIPAEH, GUNUNG KALER, TANGERANG, BANTEN",3,115,95,210
https://kawalpemilu.org#52579,"CIPAEH, GUNUNG KALER, TANGERANG, BANTEN",4,118,104,222
https://kawalpemilu.org#52579,"CIPAEH, GUNUNG KALER, TANGERANG, BANTEN",5,128,90,218
https://kawalpemilu.org#52579,"CIPAEH, GUNUNG KALER, TANGERANG, BANTEN",6,140,61,148
https://kawalpemilu.org#52579,"CIPAEH, GUNUNG KALER, TANGERANG, BANTEN",7,108,86,194
https://kawalpemilu.org#52579,"CIPAEH, GUNUNG KALER, TANGERANG, BANTEN",8,69,50,119
https://kawalpemilu.org#52579,"CIPAEH, GUNUNG KALER, TANGERANG, BANTEN",9,191,21,212
https://kawalpemilu.org#52579,"CIPAEH, GUNUNG KALER, TANGERANG, BANTEN",11,128,41,169
https://kawalpemilu.org#52579,"CIPAEH, GUNUNG KALER, TANGERANG, BANTEN",12,174,78,251
https://kawalpemilu.org#52579,"CIPAEH, GUNUNG KALER, TANGERANG, BANTEN",13,95,145,240
https://kawalpemilu.org#52580,"ONYAM, GUNUNG KALER, TANGERANG, BANTEN",1,106,62,168
https://kawalpemilu.org#52580,"ONYAM, GUNUNG KALER, TANGERANG, BANTEN",2,78,81,159
https://kawalpemilu.org#52580,"ONYAM, GUNUNG KALER, TANGERANG, BANTEN",3,130,91,221
https://kawalpemilu.org#52580,"ONYAM, GUNUNG KALER, TANGERANG, BANTEN",4,72,64,136
https://kawalpemilu.org#52580,"ONYAM, GUNUNG KALER, TANGERANG, BANTEN",5,117,67,184
https://kawalpemilu.org#52580,"ONYAM, GUNUNG KALER, TANGERANG, BANTEN",6,108,53,161
https://kawalpemilu.org#52580,"ONYAM, GUNUNG KALER, TANGERANG, BANTEN",9,85,76,161
https://kawalpemilu.org#52580,"ONYAM, GUNUNG KALER, TANGERANG, BANTEN",10,113,98,211
https://kawalpemilu.org#52580,"ONYAM, GUNUNG KALER, TANGERANG, BANTEN",11,70,55,125
https://kawalpemilu.org#52580,"ONYAM, GUNUNG KALER, TANGERANG, BANTEN",12,84,99,183
https://kawalpemilu.org#52580,"ONYAM, GUNUNG KALER, TANGERANG, BANTEN",14,86,59,145
https://kawalpemilu.org#52580,"ONYAM, GUNUNG KALER, TANGERANG, BANTEN",15,124,68,192
https://kawalpemilu.org#52580,"ONYAM, GUNUNG KALER, TANGERANG, BANTEN",16,100,50,150
https://kawalpemilu.org#52580,"ONYAM, GUNUNG KALER, TANGERANG, BANTEN",17,79,78,157
https://kawalpemilu.org#52580,"ONYAM, GUNUNG KALER, TANGERANG, BANTEN",18,90,70,160
https://kawalpemilu.org#52580,"ONYAM, GUNUNG KALER, TANGERANG, BANTEN",19,47,104,151
https://kawalpemilu.org#52580,"ONYAM, GUNUNG KALER, TANGERANG, BANTEN",20,78,116,194
https://kawalpemilu.org#52580,"ONYAM, GUNUNG KALER, TANGERANG, BANTEN",21,94,123,217
https://kawalpemilu.org#52580,"ONYAM, GUNUNG KALER, TANGERANG, BANTEN",22,64,65,129
https://kawalpemilu.org#52581,"TAMIANG, GUNUNG KALER, TANGERANG, BANTEN",1,72,95,167
https://kawalpemilu.org#52581,"TAMIANG, GUNUNG KALER, TANGERANG, BANTEN",2,52,79,131
https://kawalpemilu.org#52581,"TAMIANG, GUNUNG KALER, TANGERANG, BANTEN",3,55,80,135
https://kawalpemilu.org#52581,"TAMIANG, GUNUNG KALER, TANGERANG, BANTEN",4,83,81,164
https://kawalpemilu.org#52581,"TAMIANG, GUNUNG KALER, TANGERANG, BANTEN",5,78,65,143
https://kawalpemilu.org#52581,"TAMIANG, GUNUNG KALER, TANGERANG, BANTEN",8,68,45,113
https://kawalpemilu.org#52581,"TAMIANG, GUNUNG KALER, TANGERANG, BANTEN",9,65,67,132
https://kawalpemilu.org#52581,"TAMIANG, GUNUNG KALER, TANGERANG, BANTEN",10,61,110,171
https://kawalpemilu.org#52581,"TAMIANG, GUNUNG KALER, TANGERANG, BANTEN",11,125,96,221
https://kawalpemilu.org#52581,"TAMIANG, GUNUNG KALER, TANGERANG, BANTEN",12,101,101,202
https://kawalpemilu.org#52581,"TAMIANG, GUNUNG KALER, TANGERANG, BANTEN",13,96,112,208
https://kawalpemilu.org#52581,"TAMIANG, GUNUNG KALER, TANGERANG, BANTEN",14,151,70,221
https://kawalpemilu.org#52581,"TAMIANG, GUNUNG KALER, TANGERANG, BANTEN",15,125,109,234
https://kawalpemilu.org#52581,"TAMIANG, GUNUNG KALER, TANGERANG, BANTEN",17,45,85,130
https://kawalpemilu.org#52581,"TAMIANG, GUNUNG KALER, TANGERANG, BANTEN",18,83,77,160
https://kawalpemilu.org#52581,"TAMIANG, GUNUNG KALER, TANGERANG, BANTEN",19,68,75,143
https://kawalpemilu.org#52581,"TAMIANG, GUNUNG KALER, TANGERANG, BANTEN",21,59,75,134
https://kawalpemilu.org#52581,"TAMIANG, GUNUNG KALER, TANGERANG, BANTEN",22,73,48,121
https://kawalpemilu.org#52581,"TAMIANG, GUNUNG KALER, TANGERANG, BANTEN",23,68,105,173
https://kawalpemilu.org#52581,"TAMIANG, GUNUNG KALER, TANGERANG, BANTEN",24,86,128,214
https://kawalpemilu.org#52581,"TAMIANG, GUNUNG KALER, TANGERANG, BANTEN",25,89,111,200
https://kawalpemilu.org#52581,"TAMIANG, GUNUNG KALER, TANGERANG, BANTEN",26,119,89,208
https://kawalpemilu.org#52581,"TAMIANG, GUNUNG KALER, TANGERANG, BANTEN",27,132,102,234
https://kawalpemilu.org#52581,"TAMIANG, GUNUNG KALER, TANGERANG, BANTEN",28,51,78,129
https://kawalpemilu.org#52582,"KANDAWATI, GUNUNG KALER, TANGERANG, BANTEN",1,54,97,151
https://kawalpemilu.org#52582,"KANDAWATI, GUNUNG KALER, TANGERANG, BANTEN",2,83,100,183
https://kawalpemilu.org#52582,"KANDAWATI, GUNUNG KALER, TANGERANG, BANTEN",3,54,106,160
https://kawalpemilu.org#52582,"KANDAWATI, GUNUNG KALER, TANGERANG, BANTEN",4,83,96,179
https://kawalpemilu.org#52582,"KANDAWATI, GUNUNG KALER, TANGERANG, BANTEN",5,56,62,118
https://kawalpemilu.org#52582,"KANDAWATI, GUNUNG KALER, TANGERANG, BANTEN",6,104,93,197
https://kawalpemilu.org#52582,"KANDAWATI, GUNUNG KALER, TANGERANG, BANTEN",7,136,117,253
https://kawalpemilu.org#52582,"KANDAWATI, GUNUNG KALER, TANGERANG, BANTEN",8,108,72,180
https://kawalpemilu.org#52582,"KANDAWATI, GUNUNG KALER, TANGERANG, BANTEN",9,90,87,177
https://kawalpemilu.org#52582,"KANDAWATI, GUNUNG KALER, TANGERANG, BANTEN",10,88,70,158
https://kawalpemilu.org#52582,"KANDAWATI, GUNUNG KALER, TANGERANG, BANTEN",11,51,77,128
https://kawalpemilu.org#52582,"KANDAWATI, GUNUNG KALER, TANGERANG, BANTEN",13,124,116,240
https://kawalpemilu.org#52582,"KANDAWATI, GUNUNG KALER, TANGERANG, BANTEN",14,66,84,150
https://kawalpemilu.org#52582,"KANDAWATI, GUNUNG KALER, TANGERANG, BANTEN",16,117,55,172
https://kawalpemilu.org#52583,"CIBETOK, GUNUNG KALER, TANGERANG, BANTEN",1,101,104,205
https://kawalpemilu.org#52583,"CIBETOK, GUNUNG KALER, TANGERANG, BANTEN",2,131,84,215
https://kawalpemilu.org#52583,"CIBETOK, GUNUNG KALER, TANGERANG, BANTEN",3,103,109,212
https://kawalpemilu.org#52583,"CIBETOK, GUNUNG KALER, TANGERANG, BANTEN",4,115,96,211
https://kawalpemilu.org#52583,"CIBETOK, GUNUNG KALER, TANGERANG, BANTEN",5,62,72,134
https://kawalpemilu.org#52583,"CIBETOK, GUNUNG KALER, TANGERANG, BANTEN",6,44,80,124
https://kawalpemilu.org#52583,"CIBETOK, GUNUNG KALER, TANGERANG, BANTEN",7,81,110,191
https://kawalpemilu.org#52583,"CIBETOK, GUNUNG KALER, TANGERANG, BANTEN",8,81,74,155
https://kawalpemilu.org#52583,"CIBETOK, GUNUNG KALER, TANGERANG, BANTEN",9,138,80,218
https://kawalpemilu.org#52583,"CIBETOK, GUNUNG KALER, TANGERANG, BANTEN",10,102,99,201
https://kawalpemilu.org#52583,"CIBETOK, GUNUNG KALER, TANGERANG, BANTEN",11,122,60,182
https://kawalpemilu.org#52583,"CIBETOK, GUNUNG KALER, TANGERANG, BANTEN",12,87,134,221
https://kawalpemilu.org#52583,"CIBETOK, GUNUNG KALER, TANGERANG, BANTEN",13,45,101,146
https://kawalpemilu.org#52583,"CIBETOK, GUNUNG KALER, TANGERANG, BANTEN",14,42,104,146
https://kawalpemilu.org#52583,"CIBETOK, GUNUNG KALER, TANGERANG, BANTEN",15,73,101,174
https://kawalpemilu.org#52583,"CIBETOK, GUNUNG KALER, TANGERANG, BANTEN",17,140,43,183
https://kawalpemilu.org#52585,"MEKAR BARU, MEKAR BARU, TANGERANG, BANTEN",1,97,56,153
https://kawalpemilu.org#52585,"MEKAR BARU, MEKAR BARU, TANGERANG, BANTEN",2,69,77,146
https://kawalpemilu.org#52585,"MEKAR BARU, MEKAR BARU, TANGERANG, BANTEN",4,85,89,174
https://kawalpemilu.org#52585,"MEKAR BARU, MEKAR BARU, TANGERANG, BANTEN",5,62,144,206
https://kawalpemilu.org#52585,"MEKAR BARU, MEKAR BARU, TANGERANG, BANTEN",7,76,128,204
https://kawalpemilu.org#52585,"MEKAR BARU, MEKAR BARU, TANGERANG, BANTEN",8,48,130,178
https://kawalpemilu.org#52585,"MEKAR BARU, MEKAR BARU, TANGERANG, BANTEN",9,72,152,224
https://kawalpemilu.org#52585,"MEKAR BARU, MEKAR BARU, TANGERANG, BANTEN",10,55,81,136
https://kawalpemilu.org#52585,"MEKAR BARU, MEKAR BARU, TANGERANG, BANTEN",11,64,116,180
https://kawalpemilu.org#52585,"MEKAR BARU, MEKAR BARU, TANGERANG, BANTEN",12,66,107,173
https://kawalpemilu.org#52586,"KEDAUNG, MEKAR BARU, TANGERANG, BANTEN",7,12,168,180
https://kawalpemilu.org#52586,"KEDAUNG, MEKAR BARU, TANGERANG, BANTEN",8,48,142,190
https://kawalpemilu.org#52586,"KEDAUNG, MEKAR BARU, TANGERANG, BANTEN",11,33,125,158
https://kawalpemilu.org#52587,"CIJERUK, MEKAR BARU, TANGERANG, BANTEN",1,80,202,282
https://kawalpemilu.org#52587,"CIJERUK, MEKAR BARU, TANGERANG, BANTEN",2,66,148,214
https://kawalpemilu.org#52587,"CIJERUK, MEKAR BARU, TANGERANG, BANTEN",3,57,182,239
https://kawalpemilu.org#52587,"CIJERUK, MEKAR BARU, TANGERANG, BANTEN",4,32,107,139
https://kawalpemilu.org#52587,"CIJERUK, MEKAR BARU, TANGERANG, BANTEN",5,51,115,166
https://kawalpemilu.org#52587,"CIJERUK, MEKAR BARU, TANGERANG, BANTEN",6,67,209,276
https://kawalpemilu.org#52587,"CIJERUK, MEKAR BARU, TANGERANG, BANTEN",7,106,58,164
https://kawalpemilu.org#52587,"CIJERUK, MEKAR BARU, TANGERANG, BANTEN",8,46,162,208
https://kawalpemilu.org#52587,"CIJERUK, MEKAR BARU, TANGERANG, BANTEN",9,77,180,257
https://kawalpemilu.org#52587,"CIJERUK, MEKAR BARU, TANGERANG, BANTEN",10,93,100,193
https://kawalpemilu.org#52587,"CIJERUK, MEKAR BARU, TANGERANG, BANTEN",11,53,166,219
https://kawalpemilu.org#52587,"CIJERUK, MEKAR BARU, TANGERANG, BANTEN",12,27,112,139
https://kawalpemilu.org#52587,"CIJERUK, MEKAR BARU, TANGERANG, BANTEN",13,28,164,192
https://kawalpemilu.org#52587,"CIJERUK, MEKAR BARU, TANGERANG, BANTEN",14,63,129,192
https://kawalpemilu.org#52588,"WALIWIS, MEKAR BARU, TANGERANG, BANTEN",1,39,106,145
https://kawalpemilu.org#52588,"WALIWIS, MEKAR BARU, TANGERANG, BANTEN",3,76,144,220
https://kawalpemilu.org#52588,"WALIWIS, MEKAR BARU, TANGERANG, BANTEN",4,29,103,132
https://kawalpemilu.org#52588,"WALIWIS, MEKAR BARU, TANGERANG, BANTEN",6,100,100,205
https://kawalpemilu.org#52588,"WALIWIS, MEKAR BARU, TANGERANG, BANTEN",7,65,107,172
https://kawalpemilu.org#52588,"WALIWIS, MEKAR BARU, TANGERANG, BANTEN",8,44,117,161
https://kawalpemilu.org#52588,"WALIWIS, MEKAR BARU, TANGERANG, BANTEN",9,42,123,165
https://kawalpemilu.org#52588,"WALIWIS, MEKAR BARU, TANGERANG, BANTEN",10,50,108,158
https://kawalpemilu.org#52588,"WALIWIS, MEKAR BARU, TANGERANG, BANTEN",11,29,122,151
https://kawalpemilu.org#52588,"WALIWIS, MEKAR BARU, TANGERANG, BANTEN",12,27,104,131
https://kawalpemilu.org#52588,"WALIWIS, MEKAR BARU, TANGERANG, BANTEN",13,49,77,126
https://kawalpemilu.org#52588,"WALIWIS, MEKAR BARU, TANGERANG, BANTEN",14,60,95,155
https://kawalpemilu.org#52588,"WALIWIS, MEKAR BARU, TANGERANG, BANTEN",15,34,167,201
https://kawalpemilu.org#52589,"KLUTUK, MEKAR BARU, TANGERANG, BANTEN",2,79,45,124
https://kawalpemilu.org#52589,"KLUTUK, MEKAR BARU, TANGERANG, BANTEN",3,42,116,158
https://kawalpemilu.org#52589,"KLUTUK, MEKAR BARU, TANGERANG, BANTEN",4,67,178,245
https://kawalpemilu.org#52589,"KLUTUK, MEKAR BARU, TANGERANG, BANTEN",6,46,101,147
https://kawalpemilu.org#52589,"KLUTUK, MEKAR BARU, TANGERANG, BANTEN",7,120,88,208
https://kawalpemilu.org#52590,"JENGGOT, MEKAR BARU, TANGERANG, BANTEN",1,0,0,0
https://kawalpemilu.org#52590,"JENGGOT, MEKAR BARU, TANGERANG, BANTEN",3,90,92,182
https://kawalpemilu.org#52590,"JENGGOT, MEKAR BARU, TANGERANG, BANTEN",4,90,107,197
https://kawalpemilu.org#52590,"JENGGOT, MEKAR BARU, TANGERANG, BANTEN",5,59,119,178
https://kawalpemilu.org#52590,"JENGGOT, MEKAR BARU, TANGERANG, BANTEN",6,64,126,190
https://kawalpemilu.org#52590,"JENGGOT, MEKAR BARU, TANGERANG, BANTEN",7,80,128,208
https://kawalpemilu.org#52590,"JENGGOT, MEKAR BARU, TANGERANG, BANTEN",8,36,124,160
https://kawalpemilu.org#52590,"JENGGOT, MEKAR BARU, TANGERANG, BANTEN",9,67,76,143
https://kawalpemilu.org#52590,"JENGGOT, MEKAR BARU, TANGERANG, BANTEN",10,71,105,176
https://kawalpemilu.org#52590,"JENGGOT, MEKAR BARU, TANGERANG, BANTEN",11,57,79,136
https://kawalpemilu.org#52590,"JENGGOT, MEKAR BARU, TANGERANG, BANTEN",12,36,97,133
https://kawalpemilu.org#52590,"JENGGOT, MEKAR BARU, TANGERANG, BANTEN",15,90,51,141
https://kawalpemilu.org#52590,"JENGGOT, MEKAR BARU, TANGERANG, BANTEN",16,78,104,182
https://kawalpemilu.org#52590,"JENGGOT, MEKAR BARU, TANGERANG, BANTEN",18,37,129,166
https://kawalpemilu.org#52590,"JENGGOT, MEKAR BARU, TANGERANG, BANTEN",19,108,48,156
https://kawalpemilu.org#52590,"JENGGOT, MEKAR BARU, TANGERANG, BANTEN",20,42,78,120
https://kawalpemilu.org#52591,"KOSAMBI DALAM, MEKAR BARU, TANGERANG, BANTEN",5,78,148,226
https://kawalpemilu.org#52591,"KOSAMBI DALAM, MEKAR BARU, TANGERANG, BANTEN",6,81,93,174
https://kawalpemilu.org#52591,"KOSAMBI DALAM, MEKAR BARU, TANGERANG, BANTEN",8,49,94,143
https://kawalpemilu.org#52591,"KOSAMBI DALAM, MEKAR BARU, TANGERANG, BANTEN",10,67,110,177
https://kawalpemilu.org#52591,"KOSAMBI DALAM, MEKAR BARU, TANGERANG, BANTEN",12,63,84,147
https://kawalpemilu.org#52591,"KOSAMBI DALAM, MEKAR BARU, TANGERANG, BANTEN",13,78,122,200
https://kawalpemilu.org#52591,"KOSAMBI DALAM, MEKAR BARU, TANGERANG, BANTEN",14,0,0,0
https://kawalpemilu.org#52591,"KOSAMBI DALAM, MEKAR BARU, TANGERANG, BANTEN",15,22,105,127
https://kawalpemilu.org#52591,"KOSAMBI DALAM, MEKAR BARU, TANGERANG, BANTEN",19,76,69,145
https://kawalpemilu.org#52591,"KOSAMBI DALAM, MEKAR BARU, TANGERANG, BANTEN",23,80,105,185
https://kawalpemilu.org#52591,"KOSAMBI DALAM, MEKAR BARU, TANGERANG, BANTEN",24,74,95,169
https://kawalpemilu.org#52591,"KOSAMBI DALAM, MEKAR BARU, TANGERANG, BANTEN",25,74,88,162
https://kawalpemilu.org#52592,"GANDARIA, MEKAR BARU, TANGERANG, BANTEN",2,81,148,229
https://kawalpemilu.org#52592,"GANDARIA, MEKAR BARU, TANGERANG, BANTEN",3,78,179,257
https://kawalpemilu.org#52592,"GANDARIA, MEKAR BARU, TANGERANG, BANTEN",4,58,90,148
https://kawalpemilu.org#52592,"GANDARIA, MEKAR BARU, TANGERANG, BANTEN",5,42,107,149
https://kawalpemilu.org#52592,"GANDARIA, MEKAR BARU, TANGERANG, BANTEN",6,63,130,193
https://kawalpemilu.org#52592,"GANDARIA, MEKAR BARU, TANGERANG, BANTEN",8,34,133,167
https://kawalpemilu.org#52592,"GANDARIA, MEKAR BARU, TANGERANG, BANTEN",9,84,133,217
https://kawalpemilu.org#52592,"GANDARIA, MEKAR BARU, TANGERANG, BANTEN",10,56,203,259
https://kawalpemilu.org#52592,"GANDARIA, MEKAR BARU, TANGERANG, BANTEN",11,40,93,133
https://kawalpemilu.org#52592,"GANDARIA, MEKAR BARU, TANGERANG, BANTEN",12,36,112,148
https://kawalpemilu.org#52592,"GANDARIA, MEKAR BARU, TANGERANG, BANTEN",13,60,96,156
https://kawalpemilu.org#52592,"GANDARIA, MEKAR BARU, TANGERANG, BANTEN",14,85,122,207
https://kawalpemilu.org#52592,"GANDARIA, MEKAR BARU, TANGERANG, BANTEN",15,60,94,154
https://kawalpemilu.org#52595,"KRAMATWATU, KRAMATWATU, SERANG, BANTEN",1,32,199,231
https://kawalpemilu.org#52595,"KRAMATWATU, KRAMATWATU, SERANG, BANTEN",2,64,181,245
https://kawalpemilu.org#52595,"KRAMATWATU, KRAMATWATU, SERANG, BANTEN",3,76,160,236
https://kawalpemilu.org#52595,"KRAMATWATU, KRAMATWATU, SERANG, BANTEN",4,83,165,248
https://kawalpemilu.org#52595,"KRAMATWATU, KRAMATWATU, SERANG, BANTEN",5,64,190,254
https://kawalpemilu.org#52595,"KRAMATWATU, KRAMATWATU, SERANG, BANTEN",6,76,197,273
https://kawalpemilu.org#52595,"KRAMATWATU, KRAMATWATU, SERANG, BANTEN",7,72,194,266
https://kawalpemilu.org#52595,"KRAMATWATU, KRAMATWATU, SERANG, BANTEN",8,72,179,251
https://kawalpemilu.org#52595,"KRAMATWATU, KRAMATWATU, SERANG, BANTEN",9,44,121,165
https://kawalpemilu.org#52595,"KRAMATWATU, KRAMATWATU, SERANG, BANTEN",10,69,127,196
https://kawalpemilu.org#52595,"KRAMATWATU, KRAMATWATU, SERANG, BANTEN",11,148,109,257
https://kawalpemilu.org#52595,"KRAMATWATU, KRAMATWATU, SERANG, BANTEN",12,22,126,148
https://kawalpemilu.org#52595,"KRAMATWATU, KRAMATWATU, SERANG, BANTEN",13,76,187,263
https://kawalpemilu.org#52595,"KRAMATWATU, KRAMATWATU, SERANG, BANTEN",14,39,95,134
https://kawalpemilu.org#52595,"KRAMATWATU, KRAMATWATU, SERANG, BANTEN",15,74,150,224
https://kawalpemilu.org#52595,"KRAMATWATU, KRAMATWATU, SERANG, BANTEN",16,50,120,170
https://kawalpemilu.org#52595,"KRAMATWATU, KRAMATWATU, SERANG, BANTEN",17,69,174,243
https://kawalpemilu.org#52595,"KRAMATWATU, KRAMATWATU, SERANG, BANTEN",18,79,177,256
https://kawalpemilu.org#52595,"KRAMATWATU, KRAMATWATU, SERANG, BANTEN",19,77,157,234
https://kawalpemilu.org#52595,"KRAMATWATU, KRAMATWATU, SERANG, BANTEN",20,98,157,255
https://kawalpemilu.org#52595,"KRAMATWATU, KRAMATWATU, SERANG, BANTEN",21,94,146,240
https://kawalpemilu.org#52595,"KRAMATWATU, KRAMATWATU, SERANG, BANTEN",22,90,144,234
https://kawalpemilu.org#52595,"KRAMATWATU, KRAMATWATU, SERANG, BANTEN",23,86,183,269
https://kawalpemilu.org#52595,"KRAMATWATU, KRAMATWATU, SERANG, BANTEN",24,81,162,243
https://kawalpemilu.org#52595,"KRAMATWATU, KRAMATWATU, SERANG, BANTEN",25,91,144,235
https://kawalpemilu.org#52595,"KRAMATWATU, KRAMATWATU, SERANG, BANTEN",26,53,149,202
https://kawalpemilu.org#52595,"KRAMATWATU, KRAMATWATU, SERANG, BANTEN",28,69,175,244
https://kawalpemilu.org#52596,"MARGASANA, KRAMATWATU, SERANG, BANTEN",1,65,95,160
https://kawalpemilu.org#52596,"MARGASANA, KRAMATWATU, SERANG, BANTEN",2,74,173,247
https://kawalpemilu.org#52596,"MARGASANA, KRAMATWATU, SERANG, BANTEN",3,74,168,242
https://kawalpemilu.org#52596,"MARGASANA, KRAMATWATU, SERANG, BANTEN",4,46,217,263
https://kawalpemilu.org#52596,"MARGASANA, KRAMATWATU, SERANG, BANTEN",6,45,215,260
https://kawalpemilu.org#52596,"MARGASANA, KRAMATWATU, SERANG, BANTEN",7,70,175,245
https://kawalpemilu.org#52596,"MARGASANA, KRAMATWATU, SERANG, BANTEN",8,38,193,231
https://kawalpemilu.org#52596,"MARGASANA, KRAMATWATU, SERANG, BANTEN",9,37,217,254
https://kawalpemilu.org#52596,"MARGASANA, KRAMATWATU, SERANG, BANTEN",10,72,117,189
https://kawalpemilu.org#52596,"MARGASANA, KRAMATWATU, SERANG, BANTEN",11,63,175,238
https://kawalpemilu.org#52596,"MARGASANA, KRAMATWATU, SERANG, BANTEN",12,21,176,197
https://kawalpemilu.org#52596,"MARGASANA, KRAMATWATU, SERANG, BANTEN",14,31,121,152
https://kawalpemilu.org#52596,"MARGASANA, KRAMATWATU, SERANG, BANTEN",15,26,118,144
https://kawalpemilu.org#52597,"PEJATEN, KRAMATWATU, SERANG, BANTEN",1,65,121,186
https://kawalpemilu.org#52597,"PEJATEN, KRAMATWATU, SERANG, BANTEN",2,73,104,177
https://kawalpemilu.org#52597,"PEJATEN, KRAMATWATU, SERANG, BANTEN",3,63,200,263
https://kawalpemilu.org#52597,"PEJATEN, KRAMATWATU, SERANG, BANTEN",4,87,115,202
https://kawalpemilu.org#52597,"PEJATEN, KRAMATWATU, SERANG, BANTEN",5,55,143,198
https://kawalpemilu.org#52597,"PEJATEN, KRAMATWATU, SERANG, BANTEN",6,35,88,123
https://kawalpemilu.org#52597,"PEJATEN, KRAMATWATU, SERANG, BANTEN",7,65,161,226
https://kawalpemilu.org#52597,"PEJATEN, KRAMATWATU, SERANG, BANTEN",8,85,152,237
https://kawalpemilu.org#52597,"PEJATEN, KRAMATWATU, SERANG, BANTEN",9,78,137,215
https://kawalpemilu.org#52597,"PEJATEN, KRAMATWATU, SERANG, BANTEN",10,44,116,160
https://kawalpemilu.org#52597,"PEJATEN, KRAMATWATU, SERANG, BANTEN",11,82,108,190
https://kawalpemilu.org#52597,"PEJATEN, KRAMATWATU, SERANG, BANTEN",12,73,118,191
https://kawalpemilu.org#52597,"PEJATEN, KRAMATWATU, SERANG, BANTEN",14,64,165,229
https://kawalpemilu.org#52597,"PEJATEN, KRAMATWATU, SERANG, BANTEN",15,70,170,240
https://kawalpemilu.org#52597,"PEJATEN, KRAMATWATU, SERANG, BANTEN",16,52,109,161
https://kawalpemilu.org#52597,"PEJATEN, KRAMATWATU, SERANG, BANTEN",17,67,155,222
https://kawalpemilu.org#52597,"PEJATEN, KRAMATWATU, SERANG, BANTEN",18,99,140,239
https://kawalpemilu.org#52597,"PEJATEN, KRAMATWATU, SERANG, BANTEN",19,57,118,175
https://kawalpemilu.org#52597,"PEJATEN, KRAMATWATU, SERANG, BANTEN",20,59,145,204
https://kawalpemilu.org#52597,"PEJATEN, KRAMATWATU, SERANG, BANTEN",21,68,163,231
https://kawalpemilu.org#52597,"PEJATEN, KRAMATWATU, SERANG, BANTEN",22,65,183,248
https://kawalpemilu.org#52597,"PEJATEN, KRAMATWATU, SERANG, BANTEN",23,41,176,217
https://kawalpemilu.org#52597,"PEJATEN, KRAMATWATU, SERANG, BANTEN",24,35,216,251
https://kawalpemilu.org#52597,"PEJATEN, KRAMATWATU, SERANG, BANTEN",25,76,152,19
https://kawalpemilu.org#52597,"PEJATEN, KRAMATWATU, SERANG, BANTEN",26,139,30,169
https://kawalpemilu.org#52597,"PEJATEN, KRAMATWATU, SERANG, BANTEN",27,114,154,268
https://kawalpemilu.org#52597,"PEJATEN, KRAMATWATU, SERANG, BANTEN",28,45,76,121
https://kawalpemilu.org#52597,"PEJATEN, KRAMATWATU, SERANG, BANTEN",29,79,91,170
https://kawalpemilu.org#52597,"PEJATEN, KRAMATWATU, SERANG, BANTEN",30,71,120,191
https://kawalpemilu.org#52597,"PEJATEN, KRAMATWATU, SERANG, BANTEN",31,30,138,168
https://kawalpemilu.org#52597,"PEJATEN, KRAMATWATU, SERANG, BANTEN",32,38,120,158
https://kawalpemilu.org#52598,"TOYOMERTO, KRAMATWATU, SERANG, BANTEN",1,26,187,213
https://kawalpemilu.org#52598,"TOYOMERTO, KRAMATWATU, SERANG, BANTEN",2,30,168,198
https://kawalpemilu.org#52598,"TOYOMERTO, KRAMATWATU, SERANG, BANTEN",3,56,140,196
https://kawalpemilu.org#52598,"TOYOMERTO, KRAMATWATU, SERANG, BANTEN",4,38,150,188
https://kawalpemilu.org#52598,"TOYOMERTO, KRAMATWATU, SERANG, BANTEN",5,51,143,194
https://kawalpemilu.org#52598,"TOYOMERTO, KRAMATWATU, SERANG, BANTEN",6,50,182,232
https://kawalpemilu.org#52598,"TOYOMERTO, KRAMATWATU, SERANG, BANTEN",7,39,194,233
https://kawalpemilu.org#52598,"TOYOMERTO, KRAMATWATU, SERANG, BANTEN",8,56,162,218
https://kawalpemilu.org#52598,"TOYOMERTO, KRAMATWATU, SERANG, BANTEN",9,68,137,205
https://kawalpemilu.org#52598,"TOYOMERTO, KRAMATWATU, SERANG, BANTEN",10,61,119,180
https://kawalpemilu.org#52598,"TOYOMERTO, KRAMATWATU, SERANG, BANTEN",11,84,117,201
https://kawalpemilu.org#52598,"TOYOMERTO, KRAMATWATU, SERANG, BANTEN",12,74,122,196
https://kawalpemilu.org#52598,"TOYOMERTO, KRAMATWATU, SERANG, BANTEN",13,33,76,109
https://kawalpemilu.org#52599,"HARJATANI, KRAMATWATU, SERANG, BANTEN",1,55,179,234
https://kawalpemilu.org#52599,"HARJATANI, KRAMATWATU, SERANG, BANTEN",2,64,176,240
https://kawalpemilu.org#52599,"HARJATANI, KRAMATWATU, SERANG, BANTEN",3,72,154,226
https://kawalpemilu.org#52599,"HARJATANI, KRAMATWATU, SERANG, BANTEN",4,41,132,173
https://kawalpemilu.org#52599,"HARJATANI, KRAMATWATU, SERANG, BANTEN",5,65,116,181
https://kawalpemilu.org#52599,"HARJATANI, KRAMATWATU, SERANG, BANTEN",6,41,209,250
https://kawalpemilu.org#52599,"HARJATANI, KRAMATWATU, SERANG, BANTEN",7,22,219,241
https://kawalpemilu.org#52599,"HARJATANI, KRAMATWATU, SERANG, BANTEN",8,20,193,213
https://kawalpemilu.org#52599,"HARJATANI, KRAMATWATU, SERANG, BANTEN",9,94,144,238
https://kawalpemilu.org#52599,"HARJATANI, KRAMATWATU, SERANG, BANTEN",10,55,163,218
https://kawalpemilu.org#52599,"HARJATANI, KRAMATWATU, SERANG, BANTEN",11,81,147,228
https://kawalpemilu.org#52599,"HARJATANI, KRAMATWATU, SERANG, BANTEN",12,69,140,209
https://kawalpemilu.org#52599,"HARJATANI, KRAMATWATU, SERANG, BANTEN",13,63,161,224
https://kawalpemilu.org#52599,"HARJATANI, KRAMATWATU, SERANG, BANTEN",14,88,126,214
https://kawalpemilu.org#52599,"HARJATANI, KRAMATWATU, SERANG, BANTEN",15,47,107,154
https://kawalpemilu.org#52599,"HARJATANI, KRAMATWATU, SERANG, BANTEN",16,36,112,148
https://kawalpemilu.org#52599,"HARJATANI, KRAMATWATU, SERANG, BANTEN",17,49,124,173
https://kawalpemilu.org#52599,"HARJATANI, KRAMATWATU, SERANG, BANTEN",18,92,103,195
https://kawalpemilu.org#52599,"HARJATANI, KRAMATWATU, SERANG, BANTEN",19,73,118,191
https://kawalpemilu.org#52599,"HARJATANI, KRAMATWATU, SERANG, BANTEN",20,72,84,156
https://kawalpemilu.org#52599,"HARJATANI, KRAMATWATU, SERANG, BANTEN",21,84,109,193
https://kawalpemilu.org#52599,"HARJATANI, KRAMATWATU, SERANG, BANTEN",22,71,71,142
https://kawalpemilu.org#52599,"HARJATANI, KRAMATWATU, SERANG, BANTEN",23,103,138,241
https://kawalpemilu.org#52599,"HARJATANI, KRAMATWATU, SERANG, BANTEN",24,129,93,222
https://kawalpemilu.org#52599,"HARJATANI, KRAMATWATU, SERANG, BANTEN",25,80,93,173
https://kawalpemilu.org#52599,"HARJATANI, KRAMATWATU, SERANG, BANTEN",26,71,144,215
https://kawalpemilu.org#52599,"HARJATANI, KRAMATWATU, SERANG, BANTEN",27,89,151,240
https://kawalpemilu.org#52599,"HARJATANI, KRAMATWATU, SERANG, BANTEN",28,101,115,216
https://kawalpemilu.org#52599,"HARJATANI, KRAMATWATU, SERANG, BANTEN",29,78,129,207
https://kawalpemilu.org#52599,"HARJATANI, KRAMATWATU, SERANG, BANTEN",30,82,85,167
https://kawalpemilu.org#52599,"HARJATANI, KRAMATWATU, SERANG, BANTEN",31,77,157,234
https://kawalpemilu.org#52599,"HARJATANI, KRAMATWATU, SERANG, BANTEN",32,69,147,216
https://kawalpemilu.org#52599,"HARJATANI, KRAMATWATU, SERANG, BANTEN",33,55,92,147
https://kawalpemilu.org#52599,"HARJATANI, KRAMATWATU, SERANG, BANTEN",34,82,92,174
https://kawalpemilu.org#52599,"HARJATANI, KRAMATWATU, SERANG, BANTEN",35,39,207,246
https://kawalpemilu.org#52599,"HARJATANI, KRAMATWATU, SERANG, BANTEN",36,39,143,182
https://kawalpemilu.org#52600,"SERDANG, KRAMATWATU, SERANG, BANTEN",1,17,272,289
https://kawalpemilu.org#52600,"SERDANG, KRAMATWATU, SERANG, BANTEN",2,29,258,287
https://kawalpemilu.org#52600,"SERDANG, KRAMATWATU, SERANG, BANTEN",3,7,264,271
https://kawalpemilu.org#52600,"SERDANG, KRAMATWATU, SERANG, BANTEN",4,25,186,211
https://kawalpemilu.org#52600,"SERDANG, KRAMATWATU, SERANG, BANTEN",5,28,167,195
https://kawalpemilu.org#52600,"SERDANG, KRAMATWATU, SERANG, BANTEN",6,33,259,292
https://kawalpemilu.org#52600,"SERDANG, KRAMATWATU, SERANG, BANTEN",7,50,210,260
https://kawalpemilu.org#52600,"SERDANG, KRAMATWATU, SERANG, BANTEN",8,33,257,290
https://kawalpemilu.org#52600,"SERDANG, KRAMATWATU, SERANG, BANTEN",9,43,219,262
https://kawalpemilu.org#52600,"SERDANG, KRAMATWATU, SERANG, BANTEN",10,31,173,204
https://kawalpemilu.org#52600,"SERDANG, KRAMATWATU, SERANG, BANTEN",11,74,128,202
https://kawalpemilu.org#52600,"SERDANG, KRAMATWATU, SERANG, BANTEN",12,62,205,267
https://kawalpemilu.org#52600,"SERDANG, KRAMATWATU, SERANG, BANTEN",13,81,149,230
https://kawalpemilu.org#52600,"SERDANG, KRAMATWATU, SERANG, BANTEN",14,48,117,165
https://kawalpemilu.org#52600,"SERDANG, KRAMATWATU, SERANG, BANTEN",15,20,116,136
https://kawalpemilu.org#52601,"TERATE, KRAMATWATU, SERANG, BANTEN",1,32,217,249
https://kawalpemilu.org#52601,"TERATE, KRAMATWATU, SERANG, BANTEN",2,32,168,200
https://kawalpemilu.org#52601,"TERATE, KRAMATWATU, SERANG, BANTEN",3,44,177,221
https://kawalpemilu.org#52601,"TERATE, KRAMATWATU, SERANG, BANTEN",4,38,180,218
https://kawalpemilu.org#52601,"TERATE, KRAMATWATU, SERANG, BANTEN",5,30,207,237
https://kawalpemilu.org#52601,"TERATE, KRAMATWATU, SERANG, BANTEN",6,69,157,226
https://kawalpemilu.org#52601,"TERATE, KRAMATWATU, SERANG, BANTEN",7,27,197,224
https://kawalpemilu.org#52601,"TERATE, KRAMATWATU, SERANG, BANTEN",8,34,153,187
https://kawalpemilu.org#52601,"TERATE, KRAMATWATU, SERANG, BANTEN",9,35,168,203
https://kawalpemilu.org#52601,"TERATE, KRAMATWATU, SERANG, BANTEN",10,45,231,276
https://kawalpemilu.org#52601,"TERATE, KRAMATWATU, SERANG, BANTEN",11,28,123,151
https://kawalpemilu.org#52601,"TERATE, KRAMATWATU, SERANG, BANTEN",12,41,99,140
https://kawalpemilu.org#52601,"TERATE, KRAMATWATU, SERANG, BANTEN",13,46,177,223
https://kawalpemilu.org#52602,"TONJONG, KRAMATWATU, SERANG, BANTEN",1,48,217,265
https://kawalpemilu.org#52602,"TONJONG, KRAMATWATU, SERANG, BANTEN",2,45,196,241
https://kawalpemilu.org#52602,"TONJONG, KRAMATWATU, SERANG, BANTEN",4,52,163,215
https://kawalpemilu.org#52602,"TONJONG, KRAMATWATU, SERANG, BANTEN",7,42,150,192
https://kawalpemilu.org#52602,"TONJONG, KRAMATWATU, SERANG, BANTEN",8,34,199,233
https://kawalpemilu.org#52602,"TONJONG, KRAMATWATU, SERANG, BANTEN",9,35,178,213
https://kawalpemilu.org#52602,"TONJONG, KRAMATWATU, SERANG, BANTEN",10,36,143,179
https://kawalpemilu.org#52603,"PAMENGKANG, KRAMATWATU, SERANG, BANTEN",1,45,164,209
https://kawalpemilu.org#52603,"PAMENGKANG, KRAMATWATU, SERANG, BANTEN",2,84,121,205
https://kawalpemilu.org#52603,"PAMENGKANG, KRAMATWATU, SERANG, BANTEN",3,65,118,183
https://kawalpemilu.org#52603,"PAMENGKANG, KRAMATWATU, SERANG, BANTEN",4,67,128,195
https://kawalpemilu.org#52603,"PAMENGKANG, KRAMATWATU, SERANG, BANTEN",5,118,100,218
https://kawalpemilu.org#52603,"PAMENGKANG, KRAMATWATU, SERANG, BANTEN",6,109,90,199
https://kawalpemilu.org#52603,"PAMENGKANG, KRAMATWATU, SERANG, BANTEN",7,68,86,154
https://kawalpemilu.org#52603,"PAMENGKANG, KRAMATWATU, SERANG, BANTEN",8,81,111,194
https://kawalpemilu.org#52603,"PAMENGKANG, KRAMATWATU, SERANG, BANTEN",9,122,82,204
https://kawalpemilu.org#52603,"PAMENGKANG, KRAMATWATU, SERANG, BANTEN",10,64,89,153
https://kawalpemilu.org#52603,"PAMENGKANG, KRAMATWATU, SERANG, BANTEN",11,57,154,211
https://kawalpemilu.org#52603,"PAMENGKANG, KRAMATWATU, SERANG, BANTEN",12,78,154,232
https://kawalpemilu.org#52603,"PAMENGKANG, KRAMATWATU, SERANG, BANTEN",13,93,138,231
https://kawalpemilu.org#52603,"PAMENGKANG, KRAMATWATU, SERANG, BANTEN",14,70,108,178
https://kawalpemilu.org#52603,"PAMENGKANG, KRAMATWATU, SERANG, BANTEN",15,41,168,209
https://kawalpemilu.org#52604,"PEGADINGAN, KRAMATWATU, SERANG, BANTEN",1,34,171,205
https://kawalpemilu.org#52604,"PEGADINGAN, KRAMATWATU, SERANG, BANTEN",3,28,193,221
https://kawalpemilu.org#52604,"PEGADINGAN, KRAMATWATU, SERANG, BANTEN",4,26,175,201
https://kawalpemilu.org#52604,"PEGADINGAN, KRAMATWATU, SERANG, BANTEN",5,27,158,185
https://kawalpemilu.org#52604,"PEGADINGAN, KRAMATWATU, SERANG, BANTEN",6,27,184,211
https://kawalpemilu.org#52604,"PEGADINGAN, KRAMATWATU, SERANG, BANTEN",7,51,200,251
https://kawalpemilu.org#52604,"PEGADINGAN, KRAMATWATU, SERANG, BANTEN",8,25,130,242
https://kawalpemilu.org#52604,"PEGADINGAN, KRAMATWATU, SERANG, BANTEN",9,61,141,202
https://kawalpemilu.org#52604,"PEGADINGAN, KRAMATWATU, SERANG, BANTEN",10,65,151,216
https://kawalpemilu.org#52604,"PEGADINGAN, KRAMATWATU, SERANG, BANTEN",11,52,174,226
https://kawalpemilu.org#52604,"PEGADINGAN, KRAMATWATU, SERANG, BANTEN",12,69,161,230
https://kawalpemilu.org#52604,"PEGADINGAN, KRAMATWATU, SERANG, BANTEN",13,106,147,253
https://kawalpemilu.org#52604,"PEGADINGAN, KRAMATWATU, SERANG, BANTEN",14,93,161,254
https://kawalpemilu.org#52604,"PEGADINGAN, KRAMATWATU, SERANG, BANTEN",15,25,130,155
https://kawalpemilu.org#52605,"LEBAKWANA, KRAMATWATU, SERANG, BANTEN",1,63,194,257
https://kawalpemilu.org#52605,"LEBAKWANA, KRAMATWATU, SERANG, BANTEN",2,67,192,259
https://kawalpemilu.org#52605,"LEBAKWANA, KRAMATWATU, SERANG, BANTEN",3,32,179,211
https://kawalpemilu.org#52605,"LEBAKWANA, KRAMATWATU, SERANG, BANTEN",4,39,165,204
https://kawalpemilu.org#52605,"LEBAKWANA, KRAMATWATU, SERANG, BANTEN",5,13,172,185
https://kawalpemilu.org#52605,"LEBAKWANA, KRAMATWATU, SERANG, BANTEN",6,28,170,198
https://kawalpemilu.org#52605,"LEBAKWANA, KRAMATWATU, SERANG, BANTEN",7,45,141,186
https://kawalpemilu.org#52605,"LEBAKWANA, KRAMATWATU, SERANG, BANTEN",8,45,156,204
https://kawalpemilu.org#52605,"LEBAKWANA, KRAMATWATU, SERANG, BANTEN",9,47,232,279
https://kawalpemilu.org#52605,"LEBAKWANA, KRAMATWATU, SERANG, BANTEN",10,69,127,196
https://kawalpemilu.org#52605,"LEBAKWANA, KRAMATWATU, SERANG, BANTEN",11,33,141,174
https://kawalpemilu.org#52605,"LEBAKWANA, KRAMATWATU, SERANG, BANTEN",12,32,165,197
https://kawalpemilu.org#52605,"LEBAKWANA, KRAMATWATU, SERANG, BANTEN",13,61,106,167
https://kawalpemilu.org#52605,"LEBAKWANA, KRAMATWATU, SERANG, BANTEN",14,81,163,244
https://kawalpemilu.org#52605,"LEBAKWANA, KRAMATWATU, SERANG, BANTEN",15,109,143,252
https://kawalpemilu.org#52605,"LEBAKWANA, KRAMATWATU, SERANG, BANTEN",16,86,192,278
https://kawalpemilu.org#52605,"LEBAKWANA, KRAMATWATU, SERANG, BANTEN",17,91,144,235
https://kawalpemilu.org#52605,"LEBAKWANA, KRAMATWATU, SERANG, BANTEN",18,81,211,292
https://kawalpemilu.org#52605,"LEBAKWANA, KRAMATWATU, SERANG, BANTEN",19,34,171,205
https://kawalpemilu.org#52605,"LEBAKWANA, KRAMATWATU, SERANG, BANTEN",20,45,163,208
https://kawalpemilu.org#52605,"LEBAKWANA, KRAMATWATU, SERANG, BANTEN",21,30,158,188
https://kawalpemilu.org#52605,"LEBAKWANA, KRAMATWATU, SERANG, BANTEN",22,47,88,135
https://kawalpemilu.org#52606,"WANAYASA, KRAMATWATU, SERANG, BANTEN",1,70,165,235
https://kawalpemilu.org#52606,"WANAYASA, KRAMATWATU, SERANG, BANTEN",2,115,124,239
https://kawalpemilu.org#52606,"WANAYASA, KRAMATWATU, SERANG, BANTEN",3,78,131,209
https://kawalpemilu.org#52606,"WANAYASA, KRAMATWATU, SERANG, BANTEN",4,71,160,231
https://kawalpemilu.org#52606,"WANAYASA, KRAMATWATU, SERANG, BANTEN",5,89,136,225
https://kawalpemilu.org#52606,"WANAYASA, KRAMATWATU, SERANG, BANTEN",6,54,136,190
https://kawalpemilu.org#52606,"WANAYASA, KRAMATWATU, SERANG, BANTEN",7,42,154,196
https://kawalpemilu.org#52606,"WANAYASA, KRAMATWATU, SERANG, BANTEN",8,64,135,199
https://kawalpemilu.org#52606,"WANAYASA, KRAMATWATU, SERANG, BANTEN",9,67,148,215
https://kawalpemilu.org#52606,"WANAYASA, KRAMATWATU, SERANG, BANTEN",10,70,108,178
https://kawalpemilu.org#52606,"WANAYASA, KRAMATWATU, SERANG, BANTEN",11,37,147,184
https://kawalpemilu.org#52606,"WANAYASA, KRAMATWATU, SERANG, BANTEN",12,37,136,173
https://kawalpemilu.org#52606,"WANAYASA, KRAMATWATU, SERANG, BANTEN",13,73,132,205
https://kawalpemilu.org#52606,"WANAYASA, KRAMATWATU, SERANG, BANTEN",14,95,112,207
https://kawalpemilu.org#52607,"PELAMUNAN, KRAMATWATU, SERANG, BANTEN",1,48,116,164
https://kawalpemilu.org#52607,"PELAMUNAN, KRAMATWATU, SERANG, BANTEN",2,66,150,216
https://kawalpemilu.org#52607,"PELAMUNAN, KRAMATWATU, SERANG, BANTEN",3,49,131,180
https://kawalpemilu.org#52607,"PELAMUNAN, KRAMATWATU, SERANG, BANTEN",4,37,136,173
https://kawalpemilu.org#52607,"PELAMUNAN, KRAMATWATU, SERANG, BANTEN",5,46,123,0
https://kawalpemilu.org#52607,"PELAMUNAN, KRAMATWATU, SERANG, BANTEN",6,45,138,183
https://kawalpemilu.org#52607,"PELAMUNAN, KRAMATWATU, SERANG, BANTEN",7,79,161,240
https://kawalpemilu.org#52607,"PELAMUNAN, KRAMATWATU, SERANG, BANTEN",8,48,156,204
https://kawalpemilu.org#52607,"PELAMUNAN, KRAMATWATU, SERANG, BANTEN",9,55,166,221
https://kawalpemilu.org#52607,"PELAMUNAN, KRAMATWATU, SERANG, BANTEN",10,70,131,201
https://kawalpemilu.org#52607,"PELAMUNAN, KRAMATWATU, SERANG, BANTEN",11,75,115,190
https://kawalpemilu.org#52607,"PELAMUNAN, KRAMATWATU, SERANG, BANTEN",12,61,140,201
https://kawalpemilu.org#52607,"PELAMUNAN, KRAMATWATU, SERANG, BANTEN",13,71,115,186
https://kawalpemilu.org#52607,"PELAMUNAN, KRAMATWATU, SERANG, BANTEN",14,68,125,193
https://kawalpemilu.org#52607,"PELAMUNAN, KRAMATWATU, SERANG, BANTEN",15,77,114,191
https://kawalpemilu.org#52607,"PELAMUNAN, KRAMATWATU, SERANG, BANTEN",16,69,122,191
https://kawalpemilu.org#52607,"PELAMUNAN, KRAMATWATU, SERANG, BANTEN",17,67,115,182
https://kawalpemilu.org#52607,"PELAMUNAN, KRAMATWATU, SERANG, BANTEN",18,69,140,209
https://kawalpemilu.org#52607,"PELAMUNAN, KRAMATWATU, SERANG, BANTEN",19,68,103,171
https://kawalpemilu.org#52607,"PELAMUNAN, KRAMATWATU, SERANG, BANTEN",20,77,133,210
https://kawalpemilu.org#52607,"PELAMUNAN, KRAMATWATU, SERANG, BANTEN",21,44,114,158
https://kawalpemilu.org#52607,"PELAMUNAN, KRAMATWATU, SERANG, BANTEN",22,47,95,142
https://kawalpemilu.org#52607,"PELAMUNAN, KRAMATWATU, SERANG, BANTEN",23,47,127,174
https://kawalpemilu.org#52607,"PELAMUNAN, KRAMATWATU, SERANG, BANTEN",24,47,121,168
https://kawalpemilu.org#52607,"PELAMUNAN, KRAMATWATU, SERANG, BANTEN",25,68,108,175
https://kawalpemilu.org#52607,"PELAMUNAN, KRAMATWATU, SERANG, BANTEN",26,75,133,208
https://kawalpemilu.org#52607,"PELAMUNAN, KRAMATWATU, SERANG, BANTEN",27,47,114,161
https://kawalpemilu.org#52607,"PELAMUNAN, KRAMATWATU, SERANG, BANTEN",28,44,115,159
https://kawalpemilu.org#52608,"TELUK TERATE, KRAMATWATU, SERANG, BANTEN",1,56,143,199
https://kawalpemilu.org#52608,"TELUK TERATE, KRAMATWATU, SERANG, BANTEN",2,58,155,213
https://kawalpemilu.org#52608,"TELUK TERATE, KRAMATWATU, SERANG, BANTEN",3,42,163,205
https://kawalpemilu.org#52608,"TELUK TERATE, KRAMATWATU, SERANG, BANTEN",4,64,203,267
https://kawalpemilu.org#52608,"TELUK TERATE, KRAMATWATU, SERANG, BANTEN",5,58,187,245
https://kawalpemilu.org#52609,"MARGATANI, KRAMATWATU, SERANG, BANTEN",1,71,114,185
https://kawalpemilu.org#52609,"MARGATANI, KRAMATWATU, SERANG, BANTEN",2,70,129,199
https://kawalpemilu.org#52609,"MARGATANI, KRAMATWATU, SERANG, BANTEN",3,57,153,210
https://kawalpemilu.org#52609,"MARGATANI, KRAMATWATU, SERANG, BANTEN",4,57,160,217
https://kawalpemilu.org#52609,"MARGATANI, KRAMATWATU, SERANG, BANTEN",5,61,89,150
https://kawalpemilu.org#52609,"MARGATANI, KRAMATWATU, SERANG, BANTEN",6,45,154,199
https://kawalpemilu.org#52609,"MARGATANI, KRAMATWATU, SERANG, BANTEN",7,42,143,185
https://kawalpemilu.org#52609,"MARGATANI, KRAMATWATU, SERANG, BANTEN",8,51,125,176
https://kawalpemilu.org#52609,"MARGATANI, KRAMATWATU, SERANG, BANTEN",9,64,137,201
https://kawalpemilu.org#52609,"MARGATANI, KRAMATWATU, SERANG, BANTEN",10,84,154,238
https://kawalpemilu.org#52609,"MARGATANI, KRAMATWATU, SERANG, BANTEN",11,60,164,224
https://kawalpemilu.org#52609,"MARGATANI, KRAMATWATU, SERANG, BANTEN",12,69,115,184
https://kawalpemilu.org#52609,"MARGATANI, KRAMATWATU, SERANG, BANTEN",13,44,142,186
https://kawalpemilu.org#52609,"MARGATANI, KRAMATWATU, SERANG, BANTEN",14,56,141,197
https://kawalpemilu.org#52609,"MARGATANI, KRAMATWATU, SERANG, BANTEN",15,64,119,183
https://kawalpemilu.org#52609,"MARGATANI, KRAMATWATU, SERANG, BANTEN",16,70,141,211
https://kawalpemilu.org#52609,"MARGATANI, KRAMATWATU, SERANG, BANTEN",17,70,103,173
https://kawalpemilu.org#52609,"MARGATANI, KRAMATWATU, SERANG, BANTEN",18,55,166,221
https://kawalpemilu.org#52609,"MARGATANI, KRAMATWATU, SERANG, BANTEN",19,285,134,219
https://kawalpemilu.org#52609,"MARGATANI, KRAMATWATU, SERANG, BANTEN",20,78,125,203
https://kawalpemilu.org#52609,"MARGATANI, KRAMATWATU, SERANG, BANTEN",21,42,127,169
https://kawalpemilu.org#52609,"MARGATANI, KRAMATWATU, SERANG, BANTEN",22,62,96,158
https://kawalpemilu.org#52609,"MARGATANI, KRAMATWATU, SERANG, BANTEN",23,69,137,206
https://kawalpemilu.org#52609,"MARGATANI, KRAMATWATU, SERANG, BANTEN",24,52,69,121
https://kawalpemilu.org#52609,"MARGATANI, KRAMATWATU, SERANG, BANTEN",25,42,102,144
https://kawalpemilu.org#52609,"MARGATANI, KRAMATWATU, SERANG, BANTEN",26,44,106,150
https://kawalpemilu.org#52611,"WARINGINKURUNG, WARINGINKURUNG, SERANG, BANTEN",1,28,203,231
https://kawalpemilu.org#52611,"WARINGINKURUNG, WARINGINKURUNG, SERANG, BANTEN",2,63,115,178
https://kawalpemilu.org#52611,"WARINGINKURUNG, WARINGINKURUNG, SERANG, BANTEN",3,38,156,194
https://kawalpemilu.org#52611,"WARINGINKURUNG, WARINGINKURUNG, SERANG, BANTEN",4,70,147,217
https://kawalpemilu.org#52611,"WARINGINKURUNG, WARINGINKURUNG, SERANG, BANTEN",5,61,162,223
https://kawalpemilu.org#52611,"WARINGINKURUNG, WARINGINKURUNG, SERANG, BANTEN",6,59,163,222
https://kawalpemilu.org#52611,"WARINGINKURUNG, WARINGINKURUNG, SERANG, BANTEN",7,43,159,202
https://kawalpemilu.org#52611,"WARINGINKURUNG, WARINGINKURUNG, SERANG, BANTEN",8,35,153,188
https://kawalpemilu.org#52611,"WARINGINKURUNG, WARINGINKURUNG, SERANG, BANTEN",9,11,214,225
https://kawalpemilu.org#52611,"WARINGINKURUNG, WARINGINKURUNG, SERANG, BANTEN",10,54,179,233
https://kawalpemilu.org#52611,"WARINGINKURUNG, WARINGINKURUNG, SERANG, BANTEN",11,56,167,223
https://kawalpemilu.org#52611,"WARINGINKURUNG, WARINGINKURUNG, SERANG, BANTEN",12,63,115,178
https://kawalpemilu.org#52611,"WARINGINKURUNG, WARINGINKURUNG, SERANG, BANTEN",13,77,129,206
https://kawalpemilu.org#52611,"WARINGINKURUNG, WARINGINKURUNG, SERANG, BANTEN",14,73,107,180
https://kawalpemilu.org#52611,"WARINGINKURUNG, WARINGINKURUNG, SERANG, BANTEN",15,64,162,226
https://kawalpemilu.org#52611,"WARINGINKURUNG, WARINGINKURUNG, SERANG, BANTEN",16,49,147,196
https://kawalpemilu.org#52611,"WARINGINKURUNG, WARINGINKURUNG, SERANG, BANTEN",17,23,140,163
https://kawalpemilu.org#52611,"WARINGINKURUNG, WARINGINKURUNG, SERANG, BANTEN",18,85,110,195
https://kawalpemilu.org#52611,"WARINGINKURUNG, WARINGINKURUNG, SERANG, BANTEN",19,51,122,173
https://kawalpemilu.org#52611,"WARINGINKURUNG, WARINGINKURUNG, SERANG, BANTEN",20,67,133,200
https://kawalpemilu.org#52611,"WARINGINKURUNG, WARINGINKURUNG, SERANG, BANTEN",21,76,148,224
https://kawalpemilu.org#52611,"WARINGINKURUNG, WARINGINKURUNG, SERANG, BANTEN",22,58,176,234
https://kawalpemilu.org#52611,"WARINGINKURUNG, WARINGINKURUNG, SERANG, BANTEN",23,71,163,234
https://kawalpemilu.org#52611,"WARINGINKURUNG, WARINGINKURUNG, SERANG, BANTEN",24,55,147,202
https://kawalpemilu.org#52611,"WARINGINKURUNG, WARINGINKURUNG, SERANG, BANTEN",25,57,154,211
https://kawalpemilu.org#52611,"WARINGINKURUNG, WARINGINKURUNG, SERANG, BANTEN",26,60,151,211
https://kawalpemilu.org#52611,"WARINGINKURUNG, WARINGINKURUNG, SERANG, BANTEN",27,61,126,187
https://kawalpemilu.org#52611,"WARINGINKURUNG, WARINGINKURUNG, SERANG, BANTEN",28,49,118,167
https://kawalpemilu.org#52611,"WARINGINKURUNG, WARINGINKURUNG, SERANG, BANTEN",29,55,140,195
https://kawalpemilu.org#52611,"WARINGINKURUNG, WARINGINKURUNG, SERANG, BANTEN",30,66,142,208
https://kawalpemilu.org#52611,"WARINGINKURUNG, WARINGINKURUNG, SERANG, BANTEN",31,47,81,128
https://kawalpemilu.org#52611,"WARINGINKURUNG, WARINGINKURUNG, SERANG, BANTEN",32,52,75,127
https://kawalpemilu.org#52611,"WARINGINKURUNG, WARINGINKURUNG, SERANG, BANTEN",33,83,133,216
https://kawalpemilu.org#52612,"TALAGA LUHUR, WARINGINKURUNG, SERANG, BANTEN",1,20,153,173
https://kawalpemilu.org#52612,"TALAGA LUHUR, WARINGINKURUNG, SERANG, BANTEN",2,47,150,197
https://kawalpemilu.org#52612,"TALAGA LUHUR, WARINGINKURUNG, SERANG, BANTEN",3,52,121,173
https://kawalpemilu.org#52612,"TALAGA LUHUR, WARINGINKURUNG, SERANG, BANTEN",4,56,114,170
https://kawalpemilu.org#52612,"TALAGA LUHUR, WARINGINKURUNG, SERANG, BANTEN",5,45,146,191
https://kawalpemilu.org#52612,"TALAGA LUHUR, WARINGINKURUNG, SERANG, BANTEN",6,30,156,186
https://kawalpemilu.org#52612,"TALAGA LUHUR, WARINGINKURUNG, SERANG, BANTEN",7,41,144,185
https://kawalpemilu.org#52612,"TALAGA LUHUR, WARINGINKURUNG, SERANG, BANTEN",8,30,106,136
https://kawalpemilu.org#52612,"TALAGA LUHUR, WARINGINKURUNG, SERANG, BANTEN",9,23,145,168
https://kawalpemilu.org#52612,"TALAGA LUHUR, WARINGINKURUNG, SERANG, BANTEN",10,36,112,148
https://kawalpemilu.org#52613,"BINANGUN, WARINGINKURUNG, SERANG, BANTEN",1,36,182,218
https://kawalpemilu.org#52613,"BINANGUN, WARINGINKURUNG, SERANG, BANTEN",2,31,188,219
https://kawalpemilu.org#52613,"BINANGUN, WARINGINKURUNG, SERANG, BANTEN",3,25,200,225
https://kawalpemilu.org#52613,"BINANGUN, WARINGINKURUNG, SERANG, BANTEN",4,18,180,198
https://kawalpemilu.org#52613,"BINANGUN, WARINGINKURUNG, SERANG, BANTEN",5,59,121,180
https://kawalpemilu.org#52613,"BINANGUN, WARINGINKURUNG, SERANG, BANTEN",6,25,166,191
https://kawalpemilu.org#52613,"BINANGUN, WARINGINKURUNG, SERANG, BANTEN",7,29,142,171
https://kawalpemilu.org#52613,"BINANGUN, WARINGINKURUNG, SERANG, BANTEN",8,22,158,180
https://kawalpemilu.org#52613,"BINANGUN, WARINGINKURUNG, SERANG, BANTEN",9,54,170,224
https://kawalpemilu.org#52614,"MELATI, WARINGINKURUNG, SERANG, BANTEN",1,54,156,210
https://kawalpemilu.org#52614,"MELATI, WARINGINKURUNG, SERANG, BANTEN",2,35,174,209
https://kawalpemilu.org#52614,"MELATI, WARINGINKURUNG, SERANG, BANTEN",3,25,176,201
https://kawalpemilu.org#52614,"MELATI, WARINGINKURUNG, SERANG, BANTEN",4,87,139,226
https://kawalpemilu.org#52614,"MELATI, WARINGINKURUNG, SERANG, BANTEN",5,16,157,173
https://kawalpemilu.org#52614,"MELATI, WARINGINKURUNG, SERANG, BANTEN",6,73,102,175
https://kawalpemilu.org#52614,"MELATI, WARINGINKURUNG, SERANG, BANTEN",7,33,133,166
https://kawalpemilu.org#52614,"MELATI, WARINGINKURUNG, SERANG, BANTEN",8,31,131,162
https://kawalpemilu.org#52615,"SASAHAN, WARINGINKURUNG, SERANG, BANTEN",1,31,219,250
https://kawalpemilu.org#52615,"SASAHAN, WARINGINKURUNG, SERANG, BANTEN",2,23,146,169
https://kawalpemilu.org#52615,"SASAHAN, WARINGINKURUNG, SERANG, BANTEN",3,28,160,188
https://kawalpemilu.org#52615,"SASAHAN, WARINGINKURUNG, SERANG, BANTEN",4,33,157,13
https://kawalpemilu.org#52615,"SASAHAN, WARINGINKURUNG, SERANG, BANTEN",5,34,133,167
https://kawalpemilu.org#52615,"SASAHAN, WARINGINKURUNG, SERANG, BANTEN",6,38,148,186
https://kawalpemilu.org#52615,"SASAHAN, WARINGINKURUNG, SERANG, BANTEN",7,54,150,204
https://kawalpemilu.org#52615,"SASAHAN, WARINGINKURUNG, SERANG, BANTEN",8,31,106,137
https://kawalpemilu.org#52615,"SASAHAN, WARINGINKURUNG, SERANG, BANTEN",9,39,151,190
https://kawalpemilu.org#52615,"SASAHAN, WARINGINKURUNG, SERANG, BANTEN",10,31,194,225
https://kawalpemilu.org#52616,"SUKA DALEM, WARINGINKURUNG, SERANG, BANTEN",1,57,187,244
https://kawalpemilu.org#52616,"SUKA DALEM, WARINGINKURUNG, SERANG, BANTEN",2,30,199,229
https://kawalpemilu.org#52616,"SUKA DALEM, WARINGINKURUNG, SERANG, BANTEN",3,41,194,235
https://kawalpemilu.org#52616,"SUKA DALEM, WARINGINKURUNG, SERANG, BANTEN",4,41,188,229
https://kawalpemilu.org#52616,"SUKA DALEM, WARINGINKURUNG, SERANG, BANTEN",5,41,199,240
https://kawalpemilu.org#52616,"SUKA DALEM, WARINGINKURUNG, SERANG, BANTEN",6,47,122,169
https://kawalpemilu.org#52616,"SUKA DALEM, WARINGINKURUNG, SERANG, BANTEN",7,54,145,199
https://kawalpemilu.org#52616,"SUKA DALEM, WARINGINKURUNG, SERANG, BANTEN",8,72,153,225
https://kawalpemilu.org#52616,"SUKA DALEM, WARINGINKURUNG, SERANG, BANTEN",9,73,137,210
https://kawalpemilu.org#52616,"SUKA DALEM, WARINGINKURUNG, SERANG, BANTEN",10,59,127,186
https://kawalpemilu.org#52616,"SUKA DALEM, WARINGINKURUNG, SERANG, BANTEN",11,17,203,220
https://kawalpemilu.org#52616,"SUKA DALEM, WARINGINKURUNG, SERANG, BANTEN",12,28,190,218
https://kawalpemilu.org#52616,"SUKA DALEM, WARINGINKURUNG, SERANG, BANTEN",13,89,155,244
https://kawalpemilu.org#52616,"SUKA DALEM, WARINGINKURUNG, SERANG, BANTEN",14,67,159,226
https://kawalpemilu.org#52616,"SUKA DALEM, WARINGINKURUNG, SERANG, BANTEN",15,13,234,247
https://kawalpemilu.org#52616,"SUKA DALEM, WARINGINKURUNG, SERANG, BANTEN",16,24,179,203
https://kawalpemilu.org#52616,"SUKA DALEM, WARINGINKURUNG, SERANG, BANTEN",17,34,178,212
https://kawalpemilu.org#52616,"SUKA DALEM, WARINGINKURUNG, SERANG, BANTEN",18,25,185,210
https://kawalpemilu.org#52616,"SUKA DALEM, WARINGINKURUNG, SERANG, BANTEN",19,15,200,215
https://kawalpemilu.org#52616,"SUKA DALEM, WARINGINKURUNG, SERANG, BANTEN",20,24,149,173
https://kawalpemilu.org#52616,"SUKA DALEM, WARINGINKURUNG, SERANG, BANTEN",21,18,196,214
https://kawalpemilu.org#52617,"SUKABARES, WARINGINKURUNG, SERANG, BANTEN",1,31,181,212
https://kawalpemilu.org#52617,"SUKABARES, WARINGINKURUNG, SERANG, BANTEN",2,29,169,198
https://kawalpemilu.org#52617,"SUKABARES, WARINGINKURUNG, SERANG, BANTEN",3,22,150,172
https://kawalpemilu.org#52617,"SUKABARES, WARINGINKURUNG, SERANG, BANTEN",4,38,120,158
https://kawalpemilu.org#52617,"SUKABARES, WARINGINKURUNG, SERANG, BANTEN",5,45,202,247
https://kawalpemilu.org#52617,"SUKABARES, WARINGINKURUNG, SERANG, BANTEN",6,32,162,194
https://kawalpemilu.org#52617,"SUKABARES, WARINGINKURUNG, SERANG, BANTEN",7,35,153,188
https://kawalpemilu.org#52617,"SUKABARES, WARINGINKURUNG, SERANG, BANTEN",8,37,115,152
https://kawalpemilu.org#52617,"SUKABARES, WARINGINKURUNG, SERANG, BANTEN",9,43,106,149
https://kawalpemilu.org#52617,"SUKABARES, WARINGINKURUNG, SERANG, BANTEN",10,53,123,176
https://kawalpemilu.org#52617,"SUKABARES, WARINGINKURUNG, SERANG, BANTEN",12,58,124,182
https://kawalpemilu.org#52618,"SAMBILAWANG, WARINGINKURUNG, SERANG, BANTEN",1,34,145,179
https://kawalpemilu.org#52618,"SAMBILAWANG, WARINGINKURUNG, SERANG, BANTEN",2,35,122,157
https://kawalpemilu.org#52618,"SAMBILAWANG, WARINGINKURUNG, SERANG, BANTEN",3,45,141,186
https://kawalpemilu.org#52618,"SAMBILAWANG, WARINGINKURUNG, SERANG, BANTEN",4,32,141,173
https://kawalpemilu.org#52618,"SAMBILAWANG, WARINGINKURUNG, SERANG, BANTEN",5,69,150,219
https://kawalpemilu.org#52618,"SAMBILAWANG, WARINGINKURUNG, SERANG, BANTEN",6,53,148,201
https://kawalpemilu.org#52618,"SAMBILAWANG, WARINGINKURUNG, SERANG, BANTEN",7,56,158,214
https://kawalpemilu.org#52618,"SAMBILAWANG, WARINGINKURUNG, SERANG, BANTEN",8,41,130,171
https://kawalpemilu.org#52618,"SAMBILAWANG, WARINGINKURUNG, SERANG, BANTEN",9,28,151,179
https://kawalpemilu.org#52618,"SAMBILAWANG, WARINGINKURUNG, SERANG, BANTEN",10,45,123,168
https://kawalpemilu.org#52618,"SAMBILAWANG, WARINGINKURUNG, SERANG, BANTEN",11,51,163,214
https://kawalpemilu.org#52618,"SAMBILAWANG, WARINGINKURUNG, SERANG, BANTEN",12,47,185,232
https://kawalpemilu.org#52618,"SAMBILAWANG, WARINGINKURUNG, SERANG, BANTEN",13,53,161,214
https://kawalpemilu.org#52618,"SAMBILAWANG, WARINGINKURUNG, SERANG, BANTEN",14,32,191,223
https://kawalpemilu.org#52619,"SAMPIR, WARINGINKURUNG, SERANG, BANTEN",1,63,148,211
https://kawalpemilu.org#52619,"SAMPIR, WARINGINKURUNG, SERANG, BANTEN",2,62,163,225
https://kawalpemilu.org#52619,"SAMPIR, WARINGINKURUNG, SERANG, BANTEN",3,97,140,237
https://kawalpemilu.org#52619,"SAMPIR, WARINGINKURUNG, SERANG, BANTEN",4,48,119,167
https://kawalpemilu.org#52619,"SAMPIR, WARINGINKURUNG, SERANG, BANTEN",6,45,78,123
https://kawalpemilu.org#52619,"SAMPIR, WARINGINKURUNG, SERANG, BANTEN",7,74,132,206
https://kawalpemilu.org#52620,"COKOPSULANJANA, WARINGINKURUNG, SERANG, BANTEN",1,29,114,143
https://kawalpemilu.org#52620,"COKOPSULANJANA, WARINGINKURUNG, SERANG, BANTEN",2,14,123,137
https://kawalpemilu.org#52620,"COKOPSULANJANA, WARINGINKURUNG, SERANG, BANTEN",3,35,95,130
https://kawalpemilu.org#52620,"COKOPSULANJANA, WARINGINKURUNG, SERANG, BANTEN",4,44,136,180
https://kawalpemilu.org#52620,"COKOPSULANJANA, WARINGINKURUNG, SERANG, BANTEN",5,70,119,189
https://kawalpemilu.org#52620,"COKOPSULANJANA, WARINGINKURUNG, SERANG, BANTEN",6,82,147,229
https://kawalpemilu.org#52620,"COKOPSULANJANA, WARINGINKURUNG, SERANG, BANTEN",7,63,153,216
https://kawalpemilu.org#52621,"KEMUNING, WARINGINKURUNG, SERANG, BANTEN",1,29,190,219
https://kawalpemilu.org#52621,"KEMUNING, WARINGINKURUNG, SERANG, BANTEN",2,47,171,218
https://kawalpemilu.org#52621,"KEMUNING, WARINGINKURUNG, SERANG, BANTEN",3,41,169,210
https://kawalpemilu.org#52621,"KEMUNING, WARINGINKURUNG, SERANG, BANTEN",4,53,138,191
https://kawalpemilu.org#52621,"KEMUNING, WARINGINKURUNG, SERANG, BANTEN",7,34,139,183
https://kawalpemilu.org#52621,"KEMUNING, WARINGINKURUNG, SERANG, BANTEN",8,37,134,171
https://kawalpemilu.org#52621,"KEMUNING, WARINGINKURUNG, SERANG, BANTEN",9,42,171,213
https://kawalpemilu.org#52623,"BOJONEGARA, BOJONEGARA, SERANG, BANTEN",1,31,205,236
https://kawalpemilu.org#52623,"BOJONEGARA, BOJONEGARA, SERANG, BANTEN",2,39,203,242
https://kawalpemilu.org#52623,"BOJONEGARA, BOJONEGARA, SERANG, BANTEN",3,51,145,195
https://kawalpemilu.org#52623,"BOJONEGARA, BOJONEGARA, SERANG, BANTEN",4,62,129,191
https://kawalpemilu.org#52623,"BOJONEGARA, BOJONEGARA, SERANG, BANTEN",5,48,134,182
https://kawalpemilu.org#52623,"BOJONEGARA, BOJONEGARA, SERANG, BANTEN",6,54,135,189
https://kawalpemilu.org#52623,"BOJONEGARA, BOJONEGARA, SERANG, BANTEN",7,13,193,206
https://kawalpemilu.org#52623,"BOJONEGARA, BOJONEGARA, SERANG, BANTEN",8,26,202,228
https://kawalpemilu.org#52623,"BOJONEGARA, BOJONEGARA, SERANG, BANTEN",9,26,225,251
https://kawalpemilu.org#52623,"BOJONEGARA, BOJONEGARA, SERANG, BANTEN",10,19,250,269
https://kawalpemilu.org#52623,"BOJONEGARA, BOJONEGARA, SERANG, BANTEN",11,32,188,220
https://kawalpemilu.org#52623,"BOJONEGARA, BOJONEGARA, SERANG, BANTEN",12,37,181,218
https://kawalpemilu.org#52623,"BOJONEGARA, BOJONEGARA, SERANG, BANTEN",13,49,179,228
https://kawalpemilu.org#52623,"BOJONEGARA, BOJONEGARA, SERANG, BANTEN",14,41,199,240
https://kawalpemilu.org#52623,"BOJONEGARA, BOJONEGARA, SERANG, BANTEN",15,37,201,238
https://kawalpemilu.org#52624,"MANGKUNEGARA, BOJONEGARA, SERANG, BANTEN",1,31,190,221
https://kawalpemilu.org#52624,"MANGKUNEGARA, BOJONEGARA, SERANG, BANTEN",2,32,236,268
https://kawalpemilu.org#52624,"MANGKUNEGARA, BOJONEGARA, SERANG, BANTEN",3,42,223,265
https://kawalpemilu.org#52624,"MANGKUNEGARA, BOJONEGARA, SERANG, BANTEN",4,23,171,194
https://kawalpemilu.org#52624,"MANGKUNEGARA, BOJONEGARA, SERANG, BANTEN",5,61,194,255
https://kawalpemilu.org#52624,"MANGKUNEGARA, BOJONEGARA, SERANG, BANTEN",6,35,180,215
https://kawalpemilu.org#52624,"MANGKUNEGARA, BOJONEGARA, SERANG, BANTEN",7,38,168,206
https://kawalpemilu.org#52624,"MANGKUNEGARA, BOJONEGARA, SERANG, BANTEN",9,68,188,256
https://kawalpemilu.org#52624,"MANGKUNEGARA, BOJONEGARA, SERANG, BANTEN",10,42,158,200
https://kawalpemilu.org#52624,"MANGKUNEGARA, BOJONEGARA, SERANG, BANTEN",11,94,154,248
https://kawalpemilu.org#52624,"MANGKUNEGARA, BOJONEGARA, SERANG, BANTEN",12,95,136,231
https://kawalpemilu.org#52625,"WANAKARTA, BOJONEGARA, SERANG, BANTEN",1,52,150,202
https://kawalpemilu.org#52625,"WANAKARTA, BOJONEGARA, SERANG, BANTEN",2,31,174,205
https://kawalpemilu.org#52625,"WANAKARTA, BOJONEGARA, SERANG, BANTEN",3,40,171,211
https://kawalpemilu.org#52625,"WANAKARTA, BOJONEGARA, SERANG, BANTEN",4,58,177,235
https://kawalpemilu.org#52625,"WANAKARTA, BOJONEGARA, SERANG, BANTEN",5,28,170,12
https://kawalpemilu.org#52625,"WANAKARTA, BOJONEGARA, SERANG, BANTEN",6,36,161,197
https://kawalpemilu.org#52625,"WANAKARTA, BOJONEGARA, SERANG, BANTEN",7,38,167,205
https://kawalpemilu.org#52625,"WANAKARTA, BOJONEGARA, SERANG, BANTEN",8,57,142,199
https://kawalpemilu.org#52625,"WANAKARTA, BOJONEGARA, SERANG, BANTEN",9,58,137,195
https://kawalpemilu.org#52626,"KARANG KEPUH, BOJONEGARA, SERANG, BANTEN",1,37,147,184
https://kawalpemilu.org#52626,"KARANG KEPUH, BOJONEGARA, SERANG, BANTEN",2,33,146,179
https://kawalpemilu.org#52626,"KARANG KEPUH, BOJONEGARA, SERANG, BANTEN",3,18,123,141
https://kawalpemilu.org#52626,"KARANG KEPUH, BOJONEGARA, SERANG, BANTEN",4,34,165,199
https://kawalpemilu.org#52626,"KARANG KEPUH, BOJONEGARA, SERANG, BANTEN",5,42,119,162
https://kawalpemilu.org#52626,"KARANG KEPUH, BOJONEGARA, SERANG, BANTEN",6,40,154,194
https://kawalpemilu.org#52626,"KARANG KEPUH, BOJONEGARA, SERANG, BANTEN",7,43,139,182
https://kawalpemilu.org#52626,"KARANG KEPUH, BOJONEGARA, SERANG, BANTEN",8,38,170,208
https://kawalpemilu.org#52626,"KARANG KEPUH, BOJONEGARA, SERANG, BANTEN",9,45,129,174
https://kawalpemilu.org#52626,"KARANG KEPUH, BOJONEGARA, SERANG, BANTEN",10,32,117,149
https://kawalpemilu.org#52626,"KARANG KEPUH, BOJONEGARA, SERANG, BANTEN",11,38,216,254
https://kawalpemilu.org#52626,"KARANG KEPUH, BOJONEGARA, SERANG, BANTEN",12,19,158,177
https://kawalpemilu.org#52626,"KARANG KEPUH, BOJONEGARA, SERANG, BANTEN",13,13,127,140
https://kawalpemilu.org#52626,"KARANG KEPUH, BOJONEGARA, SERANG, BANTEN",14,65,88,153
https://kawalpemilu.org#52626,"KARANG KEPUH, BOJONEGARA, SERANG, BANTEN",15,64,114,178
https://kawalpemilu.org#52626,"KARANG KEPUH, BOJONEGARA, SERANG, BANTEN",16,10,157,167
https://kawalpemilu.org#52626,"KARANG KEPUH, BOJONEGARA, SERANG, BANTEN",17,18,175,193
https://kawalpemilu.org#52626,"KARANG KEPUH, BOJONEGARA, SERANG, BANTEN",18,35,160,195
https://kawalpemilu.org#52627,"LAMBANGSARI, BOJONEGARA, SERANG, BANTEN",1,75,148,223
https://kawalpemilu.org#52627,"LAMBANGSARI, BOJONEGARA, SERANG, BANTEN",2,74,104,178
https://kawalpemilu.org#52627,"LAMBANGSARI, BOJONEGARA, SERANG, BANTEN",3,68,122,190
https://kawalpemilu.org#52627,"LAMBANGSARI, BOJONEGARA, SERANG, BANTEN",4,54,137,191
https://kawalpemilu.org#52627,"LAMBANGSARI, BOJONEGARA, SERANG, BANTEN",5,52,148,200
https://kawalpemilu.org#52627,"LAMBANGSARI, BOJONEGARA, SERANG, BANTEN",6,67,119,186
https://kawalpemilu.org#52627,"LAMBANGSARI, BOJONEGARA, SERANG, BANTEN",7,102,112,214
https://kawalpemilu.org#52627,"LAMBANGSARI, BOJONEGARA, SERANG, BANTEN",8,74,169,243
https://kawalpemilu.org#52627,"LAMBANGSARI, BOJONEGARA, SERANG, BANTEN",9,61,186,247
https://kawalpemilu.org#52627,"LAMBANGSARI, BOJONEGARA, SERANG, BANTEN",10,43,157,200
https://kawalpemilu.org#52627,"LAMBANGSARI, BOJONEGARA, SERANG, BANTEN",11,53,125,128
https://kawalpemilu.org#52627,"LAMBANGSARI, BOJONEGARA, SERANG, BANTEN",12,76,126,202
https://kawalpemilu.org#52627,"LAMBANGSARI, BOJONEGARA, SERANG, BANTEN",13,48,138,186
https://kawalpemilu.org#52627,"LAMBANGSARI, BOJONEGARA, SERANG, BANTEN",14,37,157,194
https://kawalpemilu.org#52628,"KERTASANA, BOJONEGARA, SERANG, BANTEN",1,49,145,194
https://kawalpemilu.org#52628,"KERTASANA, BOJONEGARA, SERANG, BANTEN",2,49,141,190
https://kawalpemilu.org#52628,"KERTASANA, BOJONEGARA, SERANG, BANTEN",3,40,139,179
https://kawalpemilu.org#52628,"KERTASANA, BOJONEGARA, SERANG, BANTEN",4,33,156,189
https://kawalpemilu.org#52628,"KERTASANA, BOJONEGARA, SERANG, BANTEN",5,40,155,195
https://kawalpemilu.org#52628,"KERTASANA, BOJONEGARA, SERANG, BANTEN",6,69,118,187
https://kawalpemilu.org#52628,"KERTASANA, BOJONEGARA, SERANG, BANTEN",7,60,118,178
https://kawalpemilu.org#52628,"KERTASANA, BOJONEGARA, SERANG, BANTEN",8,68,106,174
https://kawalpemilu.org#52628,"KERTASANA, BOJONEGARA, SERANG, BANTEN",9,46,134,180
https://kawalpemilu.org#52628,"KERTASANA, BOJONEGARA, SERANG, BANTEN",10,38,126,169
https://kawalpemilu.org#52628,"KERTASANA, BOJONEGARA, SERANG, BANTEN",11,34,144,178
https://kawalpemilu.org#52628,"KERTASANA, BOJONEGARA, SERANG, BANTEN",12,33,126,159
https://kawalpemilu.org#52628,"KERTASANA, BOJONEGARA, SERANG, BANTEN",13,24,121,145
https://kawalpemilu.org#52628,"KERTASANA, BOJONEGARA, SERANG, BANTEN",14,75,154,229
https://kawalpemilu.org#52628,"KERTASANA, BOJONEGARA, SERANG, BANTEN",15,71,150,221
https://kawalpemilu.org#52628,"KERTASANA, BOJONEGARA, SERANG, BANTEN",16,66,156,222
https://kawalpemilu.org#52629,"MARGAGIRI, BOJONEGARA, SERANG, BANTEN",1,24,224,248
https://kawalpemilu.org#52629,"MARGAGIRI, BOJONEGARA, SERANG, BANTEN",2,25,205,230
https://kawalpemilu.org#52629,"MARGAGIRI, BOJONEGARA, SERANG, BANTEN",3,14,224,238
https://kawalpemilu.org#52629,"MARGAGIRI, BOJONEGARA, SERANG, BANTEN",4,13,215,228
https://kawalpemilu.org#52629,"MARGAGIRI, BOJONEGARA, SERANG, BANTEN",5,22,178,200
https://kawalpemilu.org#52629,"MARGAGIRI, BOJONEGARA, SERANG, BANTEN",6,37,213,239
https://kawalpemilu.org#52629,"MARGAGIRI, BOJONEGARA, SERANG, BANTEN",7,43,159,202
https://kawalpemilu.org#52629,"MARGAGIRI, BOJONEGARA, SERANG, BANTEN",8,17,230,247
https://kawalpemilu.org#52629,"MARGAGIRI, BOJONEGARA, SERANG, BANTEN",9,16,217,233
https://kawalpemilu.org#52629,"MARGAGIRI, BOJONEGARA, SERANG, BANTEN",10,27,212,239
https://kawalpemilu.org#52629,"MARGAGIRI, BOJONEGARA, SERANG, BANTEN",11,35,202,237
https://kawalpemilu.org#52629,"MARGAGIRI, BOJONEGARA, SERANG, BANTEN",12,24,201,225
https://kawalpemilu.org#52629,"MARGAGIRI, BOJONEGARA, SERANG, BANTEN",13,26,179,205
https://kawalpemilu.org#52629,"MARGAGIRI, BOJONEGARA, SERANG, BANTEN",14,41,152,193
https://kawalpemilu.org#52629,"MARGAGIRI, BOJONEGARA, SERANG, BANTEN",15,40,155,195
https://kawalpemilu.org#52629,"MARGAGIRI, BOJONEGARA, SERANG, BANTEN",16,33,160,193
https://kawalpemilu.org#52629,"MARGAGIRI, BOJONEGARA, SERANG, BANTEN",17,38,188,226
https://kawalpemilu.org#52629,"MARGAGIRI, BOJONEGARA, SERANG, BANTEN",18,24,179,203
https://kawalpemilu.org#52630,"UKIRSARI, BOJONEGARA, SERANG, BANTEN",1,60,203,263
https://kawalpemilu.org#52630,"UKIRSARI, BOJONEGARA, SERANG, BANTEN",2,54,175,229
https://kawalpemilu.org#52630,"UKIRSARI, BOJONEGARA, SERANG, BANTEN",3,63,154,217
https://kawalpemilu.org#52630,"UKIRSARI, BOJONEGARA, SERANG, BANTEN",4,33,205,238
https://kawalpemilu.org#52630,"UKIRSARI, BOJONEGARA, SERANG, BANTEN",5,14,174,188
https://kawalpemilu.org#52630,"UKIRSARI, BOJONEGARA, SERANG, BANTEN",6,15,167,182
https://kawalpemilu.org#52630,"UKIRSARI, BOJONEGARA, SERANG, BANTEN",7,33,194,227
https://kawalpemilu.org#52630,"UKIRSARI, BOJONEGARA, SERANG, BANTEN",8,20,160,180
https://kawalpemilu.org#52630,"UKIRSARI, BOJONEGARA, SERANG, BANTEN",9,25,136,161
https://kawalpemilu.org#52630,"UKIRSARI, BOJONEGARA, SERANG, BANTEN",10,19,99,118
https://kawalpemilu.org#52631,"PAKUNCEN, BOJONEGARA, SERANG, BANTEN",1,15,134,149
https://kawalpemilu.org#52631,"PAKUNCEN, BOJONEGARA, SERANG, BANTEN",2,21,150,171
https://kawalpemilu.org#52631,"PAKUNCEN, BOJONEGARA, SERANG, BANTEN",3,27,70,97
https://kawalpemilu.org#52631,"PAKUNCEN, BOJONEGARA, SERANG, BANTEN",4,10,143,153
https://kawalpemilu.org#52631,"PAKUNCEN, BOJONEGARA, SERANG, BANTEN",5,20,187,207
https://kawalpemilu.org#52631,"PAKUNCEN, BOJONEGARA, SERANG, BANTEN",6,15,174,189
https://kawalpemilu.org#52631,"PAKUNCEN, BOJONEGARA, SERANG, BANTEN",7,6,182,188
https://kawalpemilu.org#52631,"PAKUNCEN, BOJONEGARA, SERANG, BANTEN",8,16,163,179
https://kawalpemilu.org#52631,"PAKUNCEN, BOJONEGARA, SERANG, BANTEN",9,10,197,207
https://kawalpemilu.org#52631,"PAKUNCEN, BOJONEGARA, SERANG, BANTEN",10,11,55,66
https://kawalpemilu.org#52631,"PAKUNCEN, BOJONEGARA, SERANG, BANTEN",11,16,156,172
https://kawalpemilu.org#52631,"PAKUNCEN, BOJONEGARA, SERANG, BANTEN",12,30,186,216
https://kawalpemilu.org#52631,"PAKUNCEN, BOJONEGARA, SERANG, BANTEN",13,12,110,122
https://kawalpemilu.org#52631,"PAKUNCEN, BOJONEGARA, SERANG, BANTEN",14,26,186,212
https://kawalpemilu.org#52632,"PANGARENGAN, BOJONEGARA, SERANG, BANTEN",1,22,163,185
https://kawalpemilu.org#52632,"PANGARENGAN, BOJONEGARA, SERANG, BANTEN",2,35,130,165
https://kawalpemilu.org#52632,"PANGARENGAN, BOJONEGARA, SERANG, BANTEN",3,27,146,173
https://kawalpemilu.org#52632,"PANGARENGAN, BOJONEGARA, SERANG, BANTEN",4,17,179,196
https://kawalpemilu.org#52632,"PANGARENGAN, BOJONEGARA, SERANG, BANTEN",5,38,200,238
https://kawalpemilu.org#52632,"PANGARENGAN, BOJONEGARA, SERANG, BANTEN",6,26,170,196
https://kawalpemilu.org#52632,"PANGARENGAN, BOJONEGARA, SERANG, BANTEN",7,44,119,163
https://kawalpemilu.org#52632,"PANGARENGAN, BOJONEGARA, SERANG, BANTEN",8,20,114,134
https://kawalpemilu.org#52632,"PANGARENGAN, BOJONEGARA, SERANG, BANTEN",9,30,167,197
https://kawalpemilu.org#52632,"PANGARENGAN, BOJONEGARA, SERANG, BANTEN",10,14,190,204
https://kawalpemilu.org#52632,"PANGARENGAN, BOJONEGARA, SERANG, BANTEN",11,38,172,210
https://kawalpemilu.org#52632,"PANGARENGAN, BOJONEGARA, SERANG, BANTEN",12,17,132,149
https://kawalpemilu.org#89639,"MEKAR JAYA, BOJONEGARA, SERANG, BANTEN",1,33,128,161
https://kawalpemilu.org#89639,"MEKAR JAYA, BOJONEGARA, SERANG, BANTEN",2,28,143,171
https://kawalpemilu.org#89639,"MEKAR JAYA, BOJONEGARA, SERANG, BANTEN",3,8,174,182
https://kawalpemilu.org#89639,"MEKAR JAYA, BOJONEGARA, SERANG, BANTEN",4,8,96,104
https://kawalpemilu.org#89639,"MEKAR JAYA, BOJONEGARA, SERANG, BANTEN",5,8,171,179
https://kawalpemilu.org#89639,"MEKAR JAYA, BOJONEGARA, SERANG, BANTEN",6,47,131,178
https://kawalpemilu.org#89639,"MEKAR JAYA, BOJONEGARA, SERANG, BANTEN",7,20,108,128
https://kawalpemilu.org#89639,"MEKAR JAYA, BOJONEGARA, SERANG, BANTEN",8,11,76,87
https://kawalpemilu.org#89639,"MEKAR JAYA, BOJONEGARA, SERANG, BANTEN",9,17,176,193
https://kawalpemilu.org#89639,"MEKAR JAYA, BOJONEGARA, SERANG, BANTEN",10,26,155,181
https://kawalpemilu.org#89639,"MEKAR JAYA, BOJONEGARA, SERANG, BANTEN",11,25,135,160
https://kawalpemilu.org#89639,"MEKAR JAYA, BOJONEGARA, SERANG, BANTEN",12,27,157,9
https://kawalpemilu.org#89639,"MEKAR JAYA, BOJONEGARA, SERANG, BANTEN",13,4,122,126
https://kawalpemilu.org#89639,"MEKAR JAYA, BOJONEGARA, SERANG, BANTEN",14,5,140,145
https://kawalpemilu.org#52634,"PULO AMPEL, PULO AMPEL, SERANG, BANTEN",1,19,220,239
https://kawalpemilu.org#52634,"PULO AMPEL, PULO AMPEL, SERANG, BANTEN",2,29,221,250
https://kawalpemilu.org#52634,"PULO AMPEL, PULO AMPEL, SERANG, BANTEN",3,25,200,225
https://kawalpemilu.org#52634,"PULO AMPEL, PULO AMPEL, SERANG, BANTEN",4,23,213,236
https://kawalpemilu.org#52634,"PULO AMPEL, PULO AMPEL, SERANG, BANTEN",5,33,210,243
https://kawalpemilu.org#52634,"PULO AMPEL, PULO AMPEL, SERANG, BANTEN",6,41,179,220
https://kawalpemilu.org#52634,"PULO AMPEL, PULO AMPEL, SERANG, BANTEN",7,48,182,230
https://kawalpemilu.org#52635,"SUMURANJA, PULO AMPEL, SERANG, BANTEN",1,29,220,249
https://kawalpemilu.org#52635,"SUMURANJA, PULO AMPEL, SERANG, BANTEN",2,19,248,267
https://kawalpemilu.org#52635,"SUMURANJA, PULO AMPEL, SERANG, BANTEN",3,15,262,277
https://kawalpemilu.org#52635,"SUMURANJA, PULO AMPEL, SERANG, BANTEN",4,5,278,283
https://kawalpemilu.org#52635,"SUMURANJA, PULO AMPEL, SERANG, BANTEN",5,6,255,261
https://kawalpemilu.org#52635,"SUMURANJA, PULO AMPEL, SERANG, BANTEN",6,12,240,252
https://kawalpemilu.org#52635,"SUMURANJA, PULO AMPEL, SERANG, BANTEN",7,11,230,241
https://kawalpemilu.org#52635,"SUMURANJA, PULO AMPEL, SERANG, BANTEN",8,20,248,268
https://kawalpemilu.org#52635,"SUMURANJA, PULO AMPEL, SERANG, BANTEN",9,12,208,220
https://kawalpemilu.org#52635,"SUMURANJA, PULO AMPEL, SERANG, BANTEN",10,6,236,242
https://kawalpemilu.org#52635,"SUMURANJA, PULO AMPEL, SERANG, BANTEN",11,4,225,229
https://kawalpemilu.org#52635,"SUMURANJA, PULO AMPEL, SERANG, BANTEN",12,4,270,274
https://kawalpemilu.org#52636,"MANGUNREJA, PULO AMPEL, SERANG, BANTEN",1,19,235,254
https://kawalpemilu.org#52636,"MANGUNREJA, PULO AMPEL, SERANG, BANTEN",2,18,257,275
https://kawalpemilu.org#52636,"MANGUNREJA, PULO AMPEL, SERANG, BANTEN",3,18,246,264
https://kawalpemilu.org#52636,"MANGUNREJA, PULO AMPEL, SERANG, BANTEN",4,5,245,250
https://kawalpemilu.org#52636,"MANGUNREJA, PULO AMPEL, SERANG, BANTEN",5,19,238,257
https://kawalpemilu.org#52636,"MANGUNREJA, PULO AMPEL, SERANG, BANTEN",6,13,242,255
https://kawalpemilu.org#52636,"MANGUNREJA, PULO AMPEL, SERANG, BANTEN",7,19,221,240
https://kawalpemilu.org#52636,"MANGUNREJA, PULO AMPEL, SERANG, BANTEN",8,45,184,229
https://kawalpemilu.org#52637,"KEDUNG SOKA, PULO AMPEL, SERANG, BANTEN",1,16,232,248
https://kawalpemilu.org#52637,"KEDUNG SOKA, PULO AMPEL, SERANG, BANTEN",2,18,188,206
https://kawalpemilu.org#52637,"KEDUNG SOKA, PULO AMPEL, SERANG, BANTEN",3,19,170,189
https://kawalpemilu.org#52637,"KEDUNG SOKA, PULO AMPEL, SERANG, BANTEN",4,21,204,225
https://kawalpemilu.org#52637,"KEDUNG SOKA, PULO AMPEL, SERANG, BANTEN",5,17,176,193
https://kawalpemilu.org#52637,"KEDUNG SOKA, PULO AMPEL, SERANG, BANTEN",6,18,144,162
https://kawalpemilu.org#52637,"KEDUNG SOKA, PULO AMPEL, SERANG, BANTEN",7,26,165,191
https://kawalpemilu.org#52637,"KEDUNG SOKA, PULO AMPEL, SERANG, BANTEN",8,19,241,260
https://kawalpemilu.org#52637,"KEDUNG SOKA, PULO AMPEL, SERANG, BANTEN",10,6,200,206
https://kawalpemilu.org#52637,"KEDUNG SOKA, PULO AMPEL, SERANG, BANTEN",11,14,210,224
https://kawalpemilu.org#52637,"KEDUNG SOKA, PULO AMPEL, SERANG, BANTEN",12,14,213,227
https://kawalpemilu.org#52637,"KEDUNG SOKA, PULO AMPEL, SERANG, BANTEN",13,21,230,251
https://kawalpemilu.org#52637,"KEDUNG SOKA, PULO AMPEL, SERANG, BANTEN",14,10,154,164
https://kawalpemilu.org#52638,"SALIRA, PULO AMPEL, SERANG, BANTEN",1,39,216,255
https://kawalpemilu.org#52638,"SALIRA, PULO AMPEL, SERANG, BANTEN",2,33,235,268
https://kawalpemilu.org#52638,"SALIRA, PULO AMPEL, SERANG, BANTEN",3,52,197,249
https://kawalpemilu.org#52638,"SALIRA, PULO AMPEL, SERANG, BANTEN",4,36,226,262
https://kawalpemilu.org#52638,"SALIRA, PULO AMPEL, SERANG, BANTEN",5,82,146,228
https://kawalpemilu.org#52638,"SALIRA, PULO AMPEL, SERANG, BANTEN",6,33,204,237
https://kawalpemilu.org#52638,"SALIRA, PULO AMPEL, SERANG, BANTEN",7,37,188,225
https://kawalpemilu.org#52638,"SALIRA, PULO AMPEL, SERANG, BANTEN",8,31,158,189
https://kawalpemilu.org#52638,"SALIRA, PULO AMPEL, SERANG, BANTEN",9,11,202,213
https://kawalpemilu.org#52638,"SALIRA, PULO AMPEL, SERANG, BANTEN",10,14,221,235
https://kawalpemilu.org#52638,"SALIRA, PULO AMPEL, SERANG, BANTEN",11,17,236,253
https://kawalpemilu.org#52638,"SALIRA, PULO AMPEL, SERANG, BANTEN",12,28,188,216
https://kawalpemilu.org#52639,"ARGAWANA, PULO AMPEL, SERANG, BANTEN",1,41,197,238
https://kawalpemilu.org#52639,"ARGAWANA, PULO AMPEL, SERANG, BANTEN",2,36,190,226
https://kawalpemilu.org#52639,"ARGAWANA, PULO AMPEL, SERANG, BANTEN",3,12,190,202
https://kawalpemilu.org#52639,"ARGAWANA, PULO AMPEL, SERANG, BANTEN",4,24,194,218
https://kawalpemilu.org#52639,"ARGAWANA, PULO AMPEL, SERANG, BANTEN",5,23,188,211
https://kawalpemilu.org#52639,"ARGAWANA, PULO AMPEL, SERANG, BANTEN",6,10,193,203
https://kawalpemilu.org#52639,"ARGAWANA, PULO AMPEL, SERANG, BANTEN",8,14,200,214
https://kawalpemilu.org#52639,"ARGAWANA, PULO AMPEL, SERANG, BANTEN",9,9,259,268
https://kawalpemilu.org#52639,"ARGAWANA, PULO AMPEL, SERANG, BANTEN",10,17,186,203
https://kawalpemilu.org#52639,"ARGAWANA, PULO AMPEL, SERANG, BANTEN",11,28,230,258
https://kawalpemilu.org#52639,"ARGAWANA, PULO AMPEL, SERANG, BANTEN",12,14,218,232
https://kawalpemilu.org#52639,"ARGAWANA, PULO AMPEL, SERANG, BANTEN",13,14,204,218
https://kawalpemilu.org#52639,"ARGAWANA, PULO AMPEL, SERANG, BANTEN",14,30,218,248
https://kawalpemilu.org#52639,"ARGAWANA, PULO AMPEL, SERANG, BANTEN",15,25,205,230
https://kawalpemilu.org#52639,"ARGAWANA, PULO AMPEL, SERANG, BANTEN",16,22,214,236
https://kawalpemilu.org#52639,"ARGAWANA, PULO AMPEL, SERANG, BANTEN",17,17,197,214
https://kawalpemilu.org#52639,"ARGAWANA, PULO AMPEL, SERANG, BANTEN",18,23,190,213
https://kawalpemilu.org#52639,"ARGAWANA, PULO AMPEL, SERANG, BANTEN",19,7,225,232
https://kawalpemilu.org#52639,"ARGAWANA, PULO AMPEL, SERANG, BANTEN",20,20,207,227
https://kawalpemilu.org#52640,"BANYUWANGI, PULO AMPEL, SERANG, BANTEN",1,40,215,255
https://kawalpemilu.org#52640,"BANYUWANGI, PULO AMPEL, SERANG, BANTEN",2,29,230,259
https://kawalpemilu.org#52640,"BANYUWANGI, PULO AMPEL, SERANG, BANTEN",3,29,222,251
https://kawalpemilu.org#52640,"BANYUWANGI, PULO AMPEL, SERANG, BANTEN",4,38,215,253
https://kawalpemilu.org#52640,"BANYUWANGI, PULO AMPEL, SERANG, BANTEN",5,30,242,272
https://kawalpemilu.org#52640,"BANYUWANGI, PULO AMPEL, SERANG, BANTEN",7,14,229,243
https://kawalpemilu.org#52640,"BANYUWANGI, PULO AMPEL, SERANG, BANTEN",8,20,236,256
https://kawalpemilu.org#52640,"BANYUWANGI, PULO AMPEL, SERANG, BANTEN",9,17,238,255
https://kawalpemilu.org#52640,"BANYUWANGI, PULO AMPEL, SERANG, BANTEN",10,16,151,167
https://kawalpemilu.org#52641,"MARGASARI, PULO AMPEL, SERANG, BANTEN",1,12,225,237
https://kawalpemilu.org#52641,"MARGASARI, PULO AMPEL, SERANG, BANTEN",2,16,218,234
https://kawalpemilu.org#52641,"MARGASARI, PULO AMPEL, SERANG, BANTEN",3,11,218,229
https://kawalpemilu.org#52641,"MARGASARI, PULO AMPEL, SERANG, BANTEN",4,4,180,184
https://kawalpemilu.org#52641,"MARGASARI, PULO AMPEL, SERANG, BANTEN",5,17,271,288
https://kawalpemilu.org#52641,"MARGASARI, PULO AMPEL, SERANG, BANTEN",6,10,217,227
https://kawalpemilu.org#52641,"MARGASARI, PULO AMPEL, SERANG, BANTEN",7,13,194,207
https://kawalpemilu.org#52641,"MARGASARI, PULO AMPEL, SERANG, BANTEN",8,28,200,228
https://kawalpemilu.org#52641,"MARGASARI, PULO AMPEL, SERANG, BANTEN",9,13,205,218
https://kawalpemilu.org#52641,"MARGASARI, PULO AMPEL, SERANG, BANTEN",10,32,153,185
https://kawalpemilu.org#52641,"MARGASARI, PULO AMPEL, SERANG, BANTEN",11,49,135,184
https://kawalpemilu.org#52642,"PULO PANJANG, PULO AMPEL, SERANG, BANTEN",1,36,185,221
https://kawalpemilu.org#52642,"PULO PANJANG, PULO AMPEL, SERANG, BANTEN",2,33,148,181
https://kawalpemilu.org#52642,"PULO PANJANG, PULO AMPEL, SERANG, BANTEN",3,34,147,181
https://kawalpemilu.org#52642,"PULO PANJANG, PULO AMPEL, SERANG, BANTEN",4,62,134,196
https://kawalpemilu.org#52642,"PULO PANJANG, PULO AMPEL, SERANG, BANTEN",5,31,149,180
https://kawalpemilu.org#52642,"PULO PANJANG, PULO AMPEL, SERANG, BANTEN",6,36,195,231
https://kawalpemilu.org#52642,"PULO PANJANG, PULO AMPEL, SERANG, BANTEN",7,48,176,224
https://kawalpemilu.org#52642,"PULO PANJANG, PULO AMPEL, SERANG, BANTEN",8,43,161,204
https://kawalpemilu.org#52642,"PULO PANJANG, PULO AMPEL, SERANG, BANTEN",9,41,157,198
https://kawalpemilu.org#52644,"CIRUAS, CIRUAS, SERANG, BANTEN",1,54,186,240
https://kawalpemilu.org#52644,"CIRUAS, CIRUAS, SERANG, BANTEN",2,57,159,216
https://kawalpemilu.org#52644,"CIRUAS, CIRUAS, SERANG, BANTEN",3,62,146,208
https://kawalpemilu.org#52644,"CIRUAS, CIRUAS, SERANG, BANTEN",4,52,151,203
https://kawalpemilu.org#52644,"CIRUAS, CIRUAS, SERANG, BANTEN",5,96,142,238
https://kawalpemilu.org#52644,"CIRUAS, CIRUAS, SERANG, BANTEN",6,21,116,137
https://kawalpemilu.org#52644,"CIRUAS, CIRUAS, SERANG, BANTEN",7,34,166,200
https://kawalpemilu.org#52645,"CITEREP, CIRUAS, SERANG, BANTEN",1,49,105,153
https://kawalpemilu.org#52645,"CITEREP, CIRUAS, SERANG, BANTEN",2,61,72,133
https://kawalpemilu.org#52645,"CITEREP, CIRUAS, SERANG, BANTEN",3,53,111,164
https://kawalpemilu.org#52645,"CITEREP, CIRUAS, SERANG, BANTEN",4,67,87,154
https://kawalpemilu.org#52645,"CITEREP, CIRUAS, SERANG, BANTEN",5,30,60,1
https://kawalpemilu.org#52645,"CITEREP, CIRUAS, SERANG, BANTEN",6,72,111,183
https://kawalpemilu.org#52645,"CITEREP, CIRUAS, SERANG, BANTEN",7,66,163,229
https://kawalpemilu.org#52645,"CITEREP, CIRUAS, SERANG, BANTEN",8,44,208,252
https://kawalpemilu.org#52645,"CITEREP, CIRUAS, SERANG, BANTEN",9,44,199,243
https://kawalpemilu.org#52645,"CITEREP, CIRUAS, SERANG, BANTEN",10,43,217,260
https://kawalpemilu.org#52645,"CITEREP, CIRUAS, SERANG, BANTEN",11,26,219,245
https://kawalpemilu.org#52645,"CITEREP, CIRUAS, SERANG, BANTEN",12,67,189,256
https://kawalpemilu.org#52645,"CITEREP, CIRUAS, SERANG, BANTEN",13,61,127,188
https://kawalpemilu.org#52645,"CITEREP, CIRUAS, SERANG, BANTEN",14,33,74,107
https://kawalpemilu.org#52645,"CITEREP, CIRUAS, SERANG, BANTEN",15,73,125,198
https://kawalpemilu.org#52645,"CITEREP, CIRUAS, SERANG, BANTEN",16,61,144,205
https://kawalpemilu.org#52645,"CITEREP, CIRUAS, SERANG, BANTEN",17,51,104,155
https://kawalpemilu.org#52645,"CITEREP, CIRUAS, SERANG, BANTEN",18,58,138,196
https://kawalpemilu.org#52645,"CITEREP, CIRUAS, SERANG, BANTEN",19,86,120,206
https://kawalpemilu.org#52646,"PULO, CIRUAS, SERANG, BANTEN",1,34,225,260
https://kawalpemilu.org#52646,"PULO, CIRUAS, SERANG, BANTEN",2,40,168,208
https://kawalpemilu.org#52646,"PULO, CIRUAS, SERANG, BANTEN",3,57,196,253
https://kawalpemilu.org#52646,"PULO, CIRUAS, SERANG, BANTEN",4,34,164,198
https://kawalpemilu.org#52646,"PULO, CIRUAS, SERANG, BANTEN",5,9,203,212
https://kawalpemilu.org#52646,"PULO, CIRUAS, SERANG, BANTEN",6,42,203,245
https://kawalpemilu.org#52646,"PULO, CIRUAS, SERANG, BANTEN",7,37,150,187
https://kawalpemilu.org#52646,"PULO, CIRUAS, SERANG, BANTEN",8,53,162,220
https://kawalpemilu.org#52646,"PULO, CIRUAS, SERANG, BANTEN",9,63,178,241
https://kawalpemilu.org#52646,"PULO, CIRUAS, SERANG, BANTEN",10,52,136,188
https://kawalpemilu.org#52646,"PULO, CIRUAS, SERANG, BANTEN",11,54,109,163
https://kawalpemilu.org#52646,"PULO, CIRUAS, SERANG, BANTEN",12,65,111,176
https://kawalpemilu.org#52646,"PULO, CIRUAS, SERANG, BANTEN",13,62,112,174
https://kawalpemilu.org#52646,"PULO, CIRUAS, SERANG, BANTEN",14,69,135,204
https://kawalpemilu.org#52646,"PULO, CIRUAS, SERANG, BANTEN",15,53,154,207
https://kawalpemilu.org#52646,"PULO, CIRUAS, SERANG, BANTEN",16,72,101,173
https://kawalpemilu.org#52646,"PULO, CIRUAS, SERANG, BANTEN",17,50,135,185
https://kawalpemilu.org#52647,"KADIKARAN, CIRUAS, SERANG, BANTEN",1,31,145,176
https://kawalpemilu.org#52647,"KADIKARAN, CIRUAS, SERANG, BANTEN",2,45,171,216
https://kawalpemilu.org#52647,"KADIKARAN, CIRUAS, SERANG, BANTEN",3,34,175,209
https://kawalpemilu.org#52647,"KADIKARAN, CIRUAS, SERANG, BANTEN",4,49,138,187
https://kawalpemilu.org#52647,"KADIKARAN, CIRUAS, SERANG, BANTEN",5,48,131,179
https://kawalpemilu.org#52647,"KADIKARAN, CIRUAS, SERANG, BANTEN",6,36,117,153
https://kawalpemilu.org#52647,"KADIKARAN, CIRUAS, SERANG, BANTEN",7,50,148,198
https://kawalpemilu.org#52647,"KADIKARAN, CIRUAS, SERANG, BANTEN",8,56,121,177
https://kawalpemilu.org#52647,"KADIKARAN, CIRUAS, SERANG, BANTEN",9,41,140,181
https://kawalpemilu.org#52647,"KADIKARAN, CIRUAS, SERANG, BANTEN",10,61,127,188
https://kawalpemilu.org#52647,"KADIKARAN, CIRUAS, SERANG, BANTEN",11,51,164,215
https://kawalpemilu.org#52647,"KADIKARAN, CIRUAS, SERANG, BANTEN",12,59,126,185
https://kawalpemilu.org#52648,"KEPANDEAN, CIRUAS, SERANG, BANTEN",1,56,194,250
https://kawalpemilu.org#52648,"KEPANDEAN, CIRUAS, SERANG, BANTEN",2,29,180,209
https://kawalpemilu.org#52648,"KEPANDEAN, CIRUAS, SERANG, BANTEN",3,41,204,245
https://kawalpemilu.org#52648,"KEPANDEAN, CIRUAS, SERANG, BANTEN",4,28,193,221
https://kawalpemilu.org#52648,"KEPANDEAN, CIRUAS, SERANG, BANTEN",5,22,200,222
https://kawalpemilu.org#52648,"KEPANDEAN, CIRUAS, SERANG, BANTEN",6,49,161,210
https://kawalpemilu.org#52648,"KEPANDEAN, CIRUAS, SERANG, BANTEN",7,24,168,192
https://kawalpemilu.org#52648,"KEPANDEAN, CIRUAS, SERANG, BANTEN",8,41,164,205
https://kawalpemilu.org#52648,"KEPANDEAN, CIRUAS, SERANG, BANTEN",9,29,137,166
https://kawalpemilu.org#52648,"KEPANDEAN, CIRUAS, SERANG, BANTEN",10,30,168,198
https://kawalpemilu.org#52648,"KEPANDEAN, CIRUAS, SERANG, BANTEN",11,67,179,246
https://kawalpemilu.org#52648,"KEPANDEAN, CIRUAS, SERANG, BANTEN",12,62,174,236
https://kawalpemilu.org#52648,"KEPANDEAN, CIRUAS, SERANG, BANTEN",13,43,152,195
https://kawalpemilu.org#52648,"KEPANDEAN, CIRUAS, SERANG, BANTEN",14,42,163,205
https://kawalpemilu.org#52648,"KEPANDEAN, CIRUAS, SERANG, BANTEN",15,31,117,148
https://kawalpemilu.org#52649,"GOSARA, CIRUAS, SERANG, BANTEN",1,39,205,244
https://kawalpemilu.org#52649,"GOSARA, CIRUAS, SERANG, BANTEN",2,51,161,212
https://kawalpemilu.org#52649,"GOSARA, CIRUAS, SERANG, BANTEN",3,69,165,234
https://kawalpemilu.org#52649,"GOSARA, CIRUAS, SERANG, BANTEN",4,55,124,179
https://kawalpemilu.org#52649,"GOSARA, CIRUAS, SERANG, BANTEN",5,51,139,190
https://kawalpemilu.org#52649,"GOSARA, CIRUAS, SERANG, BANTEN",6,52,130,182
https://kawalpemilu.org#52649,"GOSARA, CIRUAS, SERANG, BANTEN",7,44,135,179
https://kawalpemilu.org#52652,"BUMIJAYA, CIRUAS, SERANG, BANTEN",1,80,134,214
https://kawalpemilu.org#52652,"BUMIJAYA, CIRUAS, SERANG, BANTEN",2,36,133,169
https://kawalpemilu.org#52652,"BUMIJAYA, CIRUAS, SERANG, BANTEN",3,31,153,184
https://kawalpemilu.org#52652,"BUMIJAYA, CIRUAS, SERANG, BANTEN",4,55,146,201
https://kawalpemilu.org#52652,"BUMIJAYA, CIRUAS, SERANG, BANTEN",5,48,119,167
https://kawalpemilu.org#52652,"BUMIJAYA, CIRUAS, SERANG, BANTEN",6,60,107,167
https://kawalpemilu.org#52652,"BUMIJAYA, CIRUAS, SERANG, BANTEN",7,0,0,0
https://kawalpemilu.org#52652,"BUMIJAYA, CIRUAS, SERANG, BANTEN",8,62,136,198
https://kawalpemilu.org#52652,"BUMIJAYA, CIRUAS, SERANG, BANTEN",9,48,129,177
https://kawalpemilu.org#52652,"BUMIJAYA, CIRUAS, SERANG, BANTEN",10,56,169,225
https://kawalpemilu.org#52652,"BUMIJAYA, CIRUAS, SERANG, BANTEN",11,0,0,0
https://kawalpemilu.org#52652,"BUMIJAYA, CIRUAS, SERANG, BANTEN",12,69,121,190
https://kawalpemilu.org#52652,"BUMIJAYA, CIRUAS, SERANG, BANTEN",13,80,109,189
https://kawalpemilu.org#52653,"PENGGALANG, CIRUAS, SERANG, BANTEN",1,61,124,185
https://kawalpemilu.org#52653,"PENGGALANG, CIRUAS, SERANG, BANTEN",2,106,110,216
https://kawalpemilu.org#52653,"PENGGALANG, CIRUAS, SERANG, BANTEN",3,65,113,178
https://kawalpemilu.org#52653,"PENGGALANG, CIRUAS, SERANG, BANTEN",4,48,162,210
https://kawalpemilu.org#52653,"PENGGALANG, CIRUAS, SERANG, BANTEN",5,68,151,219
https://kawalpemilu.org#52653,"PENGGALANG, CIRUAS, SERANG, BANTEN",6,56,141,197
https://kawalpemilu.org#52653,"PENGGALANG, CIRUAS, SERANG, BANTEN",7,33,141,174
https://kawalpemilu.org#52653,"PENGGALANG, CIRUAS, SERANG, BANTEN",8,54,125,179
https://kawalpemilu.org#52653,"PENGGALANG, CIRUAS, SERANG, BANTEN",9,55,120,175
https://kawalpemilu.org#52653,"PENGGALANG, CIRUAS, SERANG, BANTEN",10,72,98,170
https://kawalpemilu.org#52653,"PENGGALANG, CIRUAS, SERANG, BANTEN",11,51,142,193
https://kawalpemilu.org#52653,"PENGGALANG, CIRUAS, SERANG, BANTEN",12,67,109,176
https://kawalpemilu.org#52654,"PAMONG, CIRUAS, SERANG, BANTEN",1,26,191,217
https://kawalpemilu.org#52654,"PAMONG, CIRUAS, SERANG, BANTEN",2,19,171,190
https://kawalpemilu.org#52654,"PAMONG, CIRUAS, SERANG, BANTEN",3,31,175,206
https://kawalpemilu.org#52654,"PAMONG, CIRUAS, SERANG, BANTEN",4,52,153,205
https://kawalpemilu.org#52654,"PAMONG, CIRUAS, SERANG, BANTEN",5,51,171,222
https://kawalpemilu.org#52654,"PAMONG, CIRUAS, SERANG, BANTEN",6,46,136,209
https://kawalpemilu.org#52654,"PAMONG, CIRUAS, SERANG, BANTEN",7,55,181,286
https://kawalpemilu.org#52654,"PAMONG, CIRUAS, SERANG, BANTEN",8,39,181,245
https://kawalpemilu.org#52654,"PAMONG, CIRUAS, SERANG, BANTEN",9,95,102,197
https://kawalpemilu.org#52654,"PAMONG, CIRUAS, SERANG, BANTEN",10,72,81,153
https://kawalpemilu.org#52654,"PAMONG, CIRUAS, SERANG, BANTEN",11,45,139,184
https://kawalpemilu.org#52655,"CIGELAM, CIRUAS, SERANG, BANTEN",1,40,141,181
https://kawalpemilu.org#52655,"CIGELAM, CIRUAS, SERANG, BANTEN",2,35,131,166
https://kawalpemilu.org#52655,"CIGELAM, CIRUAS, SERANG, BANTEN",3,33,145,178
https://kawalpemilu.org#52655,"CIGELAM, CIRUAS, SERANG, BANTEN",4,56,77,133
https://kawalpemilu.org#52655,"CIGELAM, CIRUAS, SERANG, BANTEN",5,79,138,217
https://kawalpemilu.org#52655,"CIGELAM, CIRUAS, SERANG, BANTEN",6,82,135,217
https://kawalpemilu.org#52655,"CIGELAM, CIRUAS, SERANG, BANTEN",7,91,177,268
https://kawalpemilu.org#52655,"CIGELAM, CIRUAS, SERANG, BANTEN",8,61,162,5
https://kawalpemilu.org#52655,"CIGELAM, CIRUAS, SERANG, BANTEN",9,74,134,208
https://kawalpemilu.org#52655,"CIGELAM, CIRUAS, SERANG, BANTEN",10,64,126,190
https://kawalpemilu.org#52655,"CIGELAM, CIRUAS, SERANG, BANTEN",11,66,86,152
https://kawalpemilu.org#52655,"CIGELAM, CIRUAS, SERANG, BANTEN",12,103,97,200
https://kawalpemilu.org#52655,"CIGELAM, CIRUAS, SERANG, BANTEN",13,84,98,182
https://kawalpemilu.org#52655,"CIGELAM, CIRUAS, SERANG, BANTEN",14,167,78,145
https://kawalpemilu.org#52655,"CIGELAM, CIRUAS, SERANG, BANTEN",15,53,66,119
https://kawalpemilu.org#52655,"CIGELAM, CIRUAS, SERANG, BANTEN",16,26,126,152
https://kawalpemilu.org#52656,"SINGAMERTA, CIRUAS, SERANG, BANTEN",1,68,177,245
https://kawalpemilu.org#52656,"SINGAMERTA, CIRUAS, SERANG, BANTEN",2,76,139,215
https://kawalpemilu.org#52656,"SINGAMERTA, CIRUAS, SERANG, BANTEN",3,52,172,224
https://kawalpemilu.org#52656,"SINGAMERTA, CIRUAS, SERANG, BANTEN",4,70,177,247
https://kawalpemilu.org#52656,"SINGAMERTA, CIRUAS, SERANG, BANTEN",5,56,152,208
https://kawalpemilu.org#52656,"SINGAMERTA, CIRUAS, SERANG, BANTEN",6,57,156,213
https://kawalpemilu.org#52656,"SINGAMERTA, CIRUAS, SERANG, BANTEN",7,27,228,255
https://kawalpemilu.org#52656,"SINGAMERTA, CIRUAS, SERANG, BANTEN",8,27,172,199
https://kawalpemilu.org#52656,"SINGAMERTA, CIRUAS, SERANG, BANTEN",9,48,173,221
https://kawalpemilu.org#52656,"SINGAMERTA, CIRUAS, SERANG, BANTEN",10,58,151,209
https://kawalpemilu.org#52656,"SINGAMERTA, CIRUAS, SERANG, BANTEN",11,68,161,229
https://kawalpemilu.org#52657,"RANJENG, CIRUAS, SERANG, BANTEN",1,41,146,187
https://kawalpemilu.org#52657,"RANJENG, CIRUAS, SERANG, BANTEN",2,71,174,245
https://kawalpemilu.org#52657,"RANJENG, CIRUAS, SERANG, BANTEN",3,66,122,188
https://kawalpemilu.org#52657,"RANJENG, CIRUAS, SERANG, BANTEN",4,69,171,240
https://kawalpemilu.org#52657,"RANJENG, CIRUAS, SERANG, BANTEN",5,53,170,223
https://kawalpemilu.org#52657,"RANJENG, CIRUAS, SERANG, BANTEN",6,69,190,259
https://kawalpemilu.org#52657,"RANJENG, CIRUAS, SERANG, BANTEN",7,64,162,226
https://kawalpemilu.org#52657,"RANJENG, CIRUAS, SERANG, BANTEN",8,70,143,213
https://kawalpemilu.org#52657,"RANJENG, CIRUAS, SERANG, BANTEN",9,80,139,219
https://kawalpemilu.org#52657,"RANJENG, CIRUAS, SERANG, BANTEN",10,68,123,191
https://kawalpemilu.org#52657,"RANJENG, CIRUAS, SERANG, BANTEN",11,75,97,172
https://kawalpemilu.org#52657,"RANJENG, CIRUAS, SERANG, BANTEN",12,60,166,226
https://kawalpemilu.org#52657,"RANJENG, CIRUAS, SERANG, BANTEN",13,79,156,235
https://kawalpemilu.org#52657,"RANJENG, CIRUAS, SERANG, BANTEN",14,64,130,194
https://kawalpemilu.org#52657,"RANJENG, CIRUAS, SERANG, BANTEN",15,27,133,160
https://kawalpemilu.org#52657,"RANJENG, CIRUAS, SERANG, BANTEN",16,67,150,217
https://kawalpemilu.org#52657,"RANJENG, CIRUAS, SERANG, BANTEN",17,39,148,187
https://kawalpemilu.org#52657,"RANJENG, CIRUAS, SERANG, BANTEN",18,69,160,229
https://kawalpemilu.org#52657,"RANJENG, CIRUAS, SERANG, BANTEN",19,84,147,231
https://kawalpemilu.org#52657,"RANJENG, CIRUAS, SERANG, BANTEN",20,55,184,239
https://kawalpemilu.org#52657,"RANJENG, CIRUAS, SERANG, BANTEN",21,94,132,226
https://kawalpemilu.org#52657,"RANJENG, CIRUAS, SERANG, BANTEN",22,129,117,246
https://kawalpemilu.org#52657,"RANJENG, CIRUAS, SERANG, BANTEN",23,94,132,226
https://kawalpemilu.org#52657,"RANJENG, CIRUAS, SERANG, BANTEN",24,140,98,238
https://kawalpemilu.org#52657,"RANJENG, CIRUAS, SERANG, BANTEN",25,118,133,251
https://kawalpemilu.org#52657,"RANJENG, CIRUAS, SERANG, BANTEN",26,93,151,244
https://kawalpemilu.org#52657,"RANJENG, CIRUAS, SERANG, BANTEN",27,115,151,266
https://kawalpemilu.org#52657,"RANJENG, CIRUAS, SERANG, BANTEN",28,122,133,255
https://kawalpemilu.org#52657,"RANJENG, CIRUAS, SERANG, BANTEN",29,154,139,293
https://kawalpemilu.org#52657,"RANJENG, CIRUAS, SERANG, BANTEN",30,44,93,137
https://kawalpemilu.org#52657,"RANJENG, CIRUAS, SERANG, BANTEN",31,48,130,178
https://kawalpemilu.org#52657,"RANJENG, CIRUAS, SERANG, BANTEN",32,83,120,203
https://kawalpemilu.org#52657,"RANJENG, CIRUAS, SERANG, BANTEN",33,58,157,215
https://kawalpemilu.org#52657,"RANJENG, CIRUAS, SERANG, BANTEN",34,78,141,219
https://kawalpemilu.org#52657,"RANJENG, CIRUAS, SERANG, BANTEN",35,67,70,137
https://kawalpemilu.org#52657,"RANJENG, CIRUAS, SERANG, BANTEN",36,88,72,160
https://kawalpemilu.org#52657,"RANJENG, CIRUAS, SERANG, BANTEN",37,112,94,206
https://kawalpemilu.org#52658,"BEBERAN, CIRUAS, SERANG, BANTEN",1,49,194,243
https://kawalpemilu.org#52658,"BEBERAN, CIRUAS, SERANG, BANTEN",2,66,175,241
https://kawalpemilu.org#52658,"BEBERAN, CIRUAS, SERANG, BANTEN",3,51,173,224
https://kawalpemilu.org#52658,"BEBERAN, CIRUAS, SERANG, BANTEN",4,74,151,225
https://kawalpemilu.org#52658,"BEBERAN, CIRUAS, SERANG, BANTEN",5,44,151,195
https://kawalpemilu.org#52658,"BEBERAN, CIRUAS, SERANG, BANTEN",6,89,136,225
https://kawalpemilu.org#52658,"BEBERAN, CIRUAS, SERANG, BANTEN",7,103,140,243
https://kawalpemilu.org#52658,"BEBERAN, CIRUAS, SERANG, BANTEN",8,49,154,203
https://kawalpemilu.org#52658,"BEBERAN, CIRUAS, SERANG, BANTEN",9,70,152,222
https://kawalpemilu.org#52658,"BEBERAN, CIRUAS, SERANG, BANTEN",10,56,154,210
https://kawalpemilu.org#52658,"BEBERAN, CIRUAS, SERANG, BANTEN",11,50,167,217
https://kawalpemilu.org#52659,"KASERANGAN, CIRUAS, SERANG, BANTEN",1,96,152,248
https://kawalpemilu.org#52659,"KASERANGAN, CIRUAS, SERANG, BANTEN",2,57,173,230
https://kawalpemilu.org#52659,"KASERANGAN, CIRUAS, SERANG, BANTEN",3,58,160,218
https://kawalpemilu.org#52659,"KASERANGAN, CIRUAS, SERANG, BANTEN",4,70,152,222
https://kawalpemilu.org#52659,"KASERANGAN, CIRUAS, SERANG, BANTEN",5,59,177,236
https://kawalpemilu.org#52659,"KASERANGAN, CIRUAS, SERANG, BANTEN",6,66,171,237
https://kawalpemilu.org#52659,"KASERANGAN, CIRUAS, SERANG, BANTEN",7,46,205,251
https://kawalpemilu.org#52659,"KASERANGAN, CIRUAS, SERANG, BANTEN",8,48,138,186
https://kawalpemilu.org#52659,"KASERANGAN, CIRUAS, SERANG, BANTEN",9,45,76,121
https://kawalpemilu.org#52659,"KASERANGAN, CIRUAS, SERANG, BANTEN",10,55,186,241
https://kawalpemilu.org#52659,"KASERANGAN, CIRUAS, SERANG, BANTEN",11,57,154,211
https://kawalpemilu.org#52660,"PELAWAD, CIRUAS, SERANG, BANTEN",1,112,102,214
https://kawalpemilu.org#52660,"PELAWAD, CIRUAS, SERANG, BANTEN",2,117,127,244
https://kawalpemilu.org#52660,"PELAWAD, CIRUAS, SERANG, BANTEN",3,110,152,262
https://kawalpemilu.org#52660,"PELAWAD, CIRUAS, SERANG, BANTEN",4,77,120,197
https://kawalpemilu.org#52660,"PELAWAD, CIRUAS, SERANG, BANTEN",5,64,129,193
https://kawalpemilu.org#52660,"PELAWAD, CIRUAS, SERANG, BANTEN",6,78,161,239
https://kawalpemilu.org#52660,"PELAWAD, CIRUAS, SERANG, BANTEN",7,99,123,222
https://kawalpemilu.org#52660,"PELAWAD, CIRUAS, SERANG, BANTEN",8,101,102,203
https://kawalpemilu.org#52660,"PELAWAD, CIRUAS, SERANG, BANTEN",9,74,169,243
https://kawalpemilu.org#52660,"PELAWAD, CIRUAS, SERANG, BANTEN",10,78,134,212
https://kawalpemilu.org#52660,"PELAWAD, CIRUAS, SERANG, BANTEN",11,73,132,205
https://kawalpemilu.org#52660,"PELAWAD, CIRUAS, SERANG, BANTEN",12,102,155,257
https://kawalpemilu.org#52660,"PELAWAD, CIRUAS, SERANG, BANTEN",13,91,100,191
https://kawalpemilu.org#52660,"PELAWAD, CIRUAS, SERANG, BANTEN",14,112,141,253
https://kawalpemilu.org#52660,"PELAWAD, CIRUAS, SERANG, BANTEN",15,108,146,254
https://kawalpemilu.org#52660,"PELAWAD, CIRUAS, SERANG, BANTEN",16,80,127,207
https://kawalpemilu.org#52660,"PELAWAD, CIRUAS, SERANG, BANTEN",17,107,116,223
https://kawalpemilu.org#52660,"PELAWAD, CIRUAS, SERANG, BANTEN",18,89,149,238
https://kawalpemilu.org#52660,"PELAWAD, CIRUAS, SERANG, BANTEN",19,107,138,245
https://kawalpemilu.org#52660,"PELAWAD, CIRUAS, SERANG, BANTEN",20,99,132,231
https://kawalpemilu.org#52660,"PELAWAD, CIRUAS, SERANG, BANTEN",21,98,130,228
https://kawalpemilu.org#52660,"PELAWAD, CIRUAS, SERANG, BANTEN",22,111,135,246
https://kawalpemilu.org#52660,"PELAWAD, CIRUAS, SERANG, BANTEN",23,93,143,236
https://kawalpemilu.org#52660,"PELAWAD, CIRUAS, SERANG, BANTEN",24,102,137,239
https://kawalpemilu.org#52660,"PELAWAD, CIRUAS, SERANG, BANTEN",25,98,143,241
https://kawalpemilu.org#52660,"PELAWAD, CIRUAS, SERANG, BANTEN",26,67,131,198
https://kawalpemilu.org#52660,"PELAWAD, CIRUAS, SERANG, BANTEN",27,69,111,180
https://kawalpemilu.org#52660,"PELAWAD, CIRUAS, SERANG, BANTEN",28,86,104,190
https://kawalpemilu.org#52662,"KRAGILAN, KRAGILAN, SERANG, BANTEN",1,48,156,204
https://kawalpemilu.org#52662,"KRAGILAN, KRAGILAN, SERANG, BANTEN",2,39,177,216
https://kawalpemilu.org#52662,"KRAGILAN, KRAGILAN, SERANG, BANTEN",3,34,144,178
https://kawalpemilu.org#52662,"KRAGILAN, KRAGILAN, SERANG, BANTEN",4,0,0,0
https://kawalpemilu.org#52662,"KRAGILAN, KRAGILAN, SERANG, BANTEN",5,28,151,179
https://kawalpemilu.org#52662,"KRAGILAN, KRAGILAN, SERANG, BANTEN",6,56,172,228
https://kawalpemilu.org#52662,"KRAGILAN, KRAGILAN, SERANG, BANTEN",7,41,186,227
https://kawalpemilu.org#52662,"KRAGILAN, KRAGILAN, SERANG, BANTEN",8,28,175,203
https://kawalpemilu.org#52662,"KRAGILAN, KRAGILAN, SERANG, BANTEN",10,43,142,185
https://kawalpemilu.org#52662,"KRAGILAN, KRAGILAN, SERANG, BANTEN",11,53,125,178
https://kawalpemilu.org#52662,"KRAGILAN, KRAGILAN, SERANG, BANTEN",12,56,110,166
https://kawalpemilu.org#52662,"KRAGILAN, KRAGILAN, SERANG, BANTEN",13,63,136,199
https://kawalpemilu.org#52662,"KRAGILAN, KRAGILAN, SERANG, BANTEN",14,61,121,182
https://kawalpemilu.org#52662,"KRAGILAN, KRAGILAN, SERANG, BANTEN",16,51,130,181
https://kawalpemilu.org#52662,"KRAGILAN, KRAGILAN, SERANG, BANTEN",18,43,81,124
https://kawalpemilu.org#52662,"KRAGILAN, KRAGILAN, SERANG, BANTEN",19,68,134,202
https://kawalpemilu.org#52662,"KRAGILAN, KRAGILAN, SERANG, BANTEN",20,98,107,205
https://kawalpemilu.org#52662,"KRAGILAN, KRAGILAN, SERANG, BANTEN",21,58,154,212
https://kawalpemilu.org#52662,"KRAGILAN, KRAGILAN, SERANG, BANTEN",23,57,102,159
https://kawalpemilu.org#52662,"KRAGILAN, KRAGILAN, SERANG, BANTEN",24,56,143,199
https://kawalpemilu.org#52662,"KRAGILAN, KRAGILAN, SERANG, BANTEN",25,52,122,174
https://kawalpemilu.org#52662,"KRAGILAN, KRAGILAN, SERANG, BANTEN",26,52,137,189
https://kawalpemilu.org#52662,"KRAGILAN, KRAGILAN, SERANG, BANTEN",27,31,151,182
https://kawalpemilu.org#52662,"KRAGILAN, KRAGILAN, SERANG, BANTEN",28,91,137,228
https://kawalpemilu.org#52662,"KRAGILAN, KRAGILAN, SERANG, BANTEN",29,96,86,182
https://kawalpemilu.org#52663,"SILEBU, KRAGILAN, SERANG, BANTEN",1,71,164,235
https://kawalpemilu.org#52663,"SILEBU, KRAGILAN, SERANG, BANTEN",2,39,74,113
https://kawalpemilu.org#52663,"SILEBU, KRAGILAN, SERANG, BANTEN",3,57,100,157
https://kawalpemilu.org#52663,"SILEBU, KRAGILAN, SERANG, BANTEN",4,59,106,165
https://kawalpemilu.org#52663,"SILEBU, KRAGILAN, SERANG, BANTEN",5,67,123,192
https://kawalpemilu.org#52663,"SILEBU, KRAGILAN, SERANG, BANTEN",6,40,149,189
https://kawalpemilu.org#52663,"SILEBU, KRAGILAN, SERANG, BANTEN",7,72,126,198
https://kawalpemilu.org#52663,"SILEBU, KRAGILAN, SERANG, BANTEN",8,102,68,170
https://kawalpemilu.org#52663,"SILEBU, KRAGILAN, SERANG, BANTEN",9,71,95,166
https://kawalpemilu.org#52663,"SILEBU, KRAGILAN, SERANG, BANTEN",10,67,130,197
https://kawalpemilu.org#52663,"SILEBU, KRAGILAN, SERANG, BANTEN",11,48,142,190
https://kawalpemilu.org#52663,"SILEBU, KRAGILAN, SERANG, BANTEN",12,80,123,203
https://kawalpemilu.org#52663,"SILEBU, KRAGILAN, SERANG, BANTEN",13,43,127,170
https://kawalpemilu.org#52663,"SILEBU, KRAGILAN, SERANG, BANTEN",14,54,149,203
https://kawalpemilu.org#52663,"SILEBU, KRAGILAN, SERANG, BANTEN",15,78,114,192
https://kawalpemilu.org#52663,"SILEBU, KRAGILAN, SERANG, BANTEN",16,61,108,169
https://kawalpemilu.org#52663,"SILEBU, KRAGILAN, SERANG, BANTEN",17,62,102,164
https://kawalpemilu.org#52663,"SILEBU, KRAGILAN, SERANG, BANTEN",18,63,125,188
https://kawalpemilu.org#52664,"PEMATANG, KRAGILAN, SERANG, BANTEN",2,30,159,189
https://kawalpemilu.org#52664,"PEMATANG, KRAGILAN, SERANG, BANTEN",3,86,120,206
https://kawalpemilu.org#52664,"PEMATANG, KRAGILAN, SERANG, BANTEN",4,82,138,220
https://kawalpemilu.org#52664,"PEMATANG, KRAGILAN, SERANG, BANTEN",5,54,148,202
https://kawalpemilu.org#52664,"PEMATANG, KRAGILAN, SERANG, BANTEN",6,53,143,196
https://kawalpemilu.org#52664,"PEMATANG, KRAGILAN, SERANG, BANTEN",7,133,56,189
https://kawalpemilu.org#52664,"PEMATANG, KRAGILAN, SERANG, BANTEN",8,65,137,202
https://kawalpemilu.org#52664,"PEMATANG, KRAGILAN, SERANG, BANTEN",9,56,142,198
https://kawalpemilu.org#52664,"PEMATANG, KRAGILAN, SERANG, BANTEN",10,44,159,203
https://kawalpemilu.org#52664,"PEMATANG, KRAGILAN, SERANG, BANTEN",11,61,123,184
https://kawalpemilu.org#52664,"PEMATANG, KRAGILAN, SERANG, BANTEN",12,46,97,143
https://kawalpemilu.org#52665,"DUKUH, KRAGILAN, SERANG, BANTEN",1,70,112,182
https://kawalpemilu.org#52665,"DUKUH, KRAGILAN, SERANG, BANTEN",2,86,146,232
https://kawalpemilu.org#52665,"DUKUH, KRAGILAN, SERANG, BANTEN",3,47,151,198
https://kawalpemilu.org#52665,"DUKUH, KRAGILAN, SERANG, BANTEN",4,37,139,176
https://kawalpemilu.org#52665,"DUKUH, KRAGILAN, SERANG, BANTEN",5,30,188,218
https://kawalpemilu.org#52665,"DUKUH, KRAGILAN, SERANG, BANTEN",6,44,169,213
https://kawalpemilu.org#52665,"DUKUH, KRAGILAN, SERANG, BANTEN",7,51,150,201
https://kawalpemilu.org#52665,"DUKUH, KRAGILAN, SERANG, BANTEN",8,53,147,200
https://kawalpemilu.org#52665,"DUKUH, KRAGILAN, SERANG, BANTEN",9,46,130,176
https://kawalpemilu.org#52665,"DUKUH, KRAGILAN, SERANG, BANTEN",10,57,138,295
https://kawalpemilu.org#52665,"DUKUH, KRAGILAN, SERANG, BANTEN",11,57,145,202
https://kawalpemilu.org#52665,"DUKUH, KRAGILAN, SERANG, BANTEN",12,73,127,200
https://kawalpemilu.org#52665,"DUKUH, KRAGILAN, SERANG, BANTEN",13,59,134,193
https://kawalpemilu.org#52665,"DUKUH, KRAGILAN, SERANG, BANTEN",14,42,101,143
https://kawalpemilu.org#52666,"UNDAR ANDIR, KRAGILAN, SERANG, BANTEN",1,0,0,0
https://kawalpemilu.org#52666,"UNDAR ANDIR, KRAGILAN, SERANG, BANTEN",2,38,176,214
https://kawalpemilu.org#52666,"UNDAR ANDIR, KRAGILAN, SERANG, BANTEN",3,43,203,246
https://kawalpemilu.org#52666,"UNDAR ANDIR, KRAGILAN, SERANG, BANTEN",4,44,183,227
https://kawalpemilu.org#52666,"UNDAR ANDIR, KRAGILAN, SERANG, BANTEN",5,34,161,195
https://kawalpemilu.org#52666,"UNDAR ANDIR, KRAGILAN, SERANG, BANTEN",6,23,189,212
https://kawalpemilu.org#52666,"UNDAR ANDIR, KRAGILAN, SERANG, BANTEN",7,31,163,194
https://kawalpemilu.org#52666,"UNDAR ANDIR, KRAGILAN, SERANG, BANTEN",8,65,122,187
https://kawalpemilu.org#52666,"UNDAR ANDIR, KRAGILAN, SERANG, BANTEN",9,37,119,156
https://kawalpemilu.org#52666,"UNDAR ANDIR, KRAGILAN, SERANG, BANTEN",10,40,104,144
https://kawalpemilu.org#52666,"UNDAR ANDIR, KRAGILAN, SERANG, BANTEN",11,32,125,157
https://kawalpemilu.org#52666,"UNDAR ANDIR, KRAGILAN, SERANG, BANTEN",12,28,121,149
https://kawalpemilu.org#52667,"SUKAJADI, KRAGILAN, SERANG, BANTEN",1,78,144,222
https://kawalpemilu.org#52667,"SUKAJADI, KRAGILAN, SERANG, BANTEN",2,56,147,203
https://kawalpemilu.org#52667,"SUKAJADI, KRAGILAN, SERANG, BANTEN",3,78,101,179
https://kawalpemilu.org#52667,"SUKAJADI, KRAGILAN, SERANG, BANTEN",4,80,95,175
https://kawalpemilu.org#52667,"SUKAJADI, KRAGILAN, SERANG, BANTEN",5,94,90,184
https://kawalpemilu.org#52667,"SUKAJADI, KRAGILAN, SERANG, BANTEN",6,43,171,214
https://kawalpemilu.org#52667,"SUKAJADI, KRAGILAN, SERANG, BANTEN",7,49,160,209
https://kawalpemilu.org#52667,"SUKAJADI, KRAGILAN, SERANG, BANTEN",8,52,155,207
https://kawalpemilu.org#52667,"SUKAJADI, KRAGILAN, SERANG, BANTEN",9,44,140,184
https://kawalpemilu.org#52667,"SUKAJADI, KRAGILAN, SERANG, BANTEN",10,83,110,193
https://kawalpemilu.org#52667,"SUKAJADI, KRAGILAN, SERANG, BANTEN",11,78,98,176
https://kawalpemilu.org#52667,"SUKAJADI, KRAGILAN, SERANG, BANTEN",12,92,100,192
https://kawalpemilu.org#52667,"SUKAJADI, KRAGILAN, SERANG, BANTEN",13,83,79,162
https://kawalpemilu.org#52667,"SUKAJADI, KRAGILAN, SERANG, BANTEN",15,89,70,159
https://kawalpemilu.org#52667,"SUKAJADI, KRAGILAN, SERANG, BANTEN",16,73,132,205
https://kawalpemilu.org#52667,"SUKAJADI, KRAGILAN, SERANG, BANTEN",17,105,69,174
https://kawalpemilu.org#52668,"SENTUL, KRAGILAN, SERANG, BANTEN",1,84,83,167
https://kawalpemilu.org#52668,"SENTUL, KRAGILAN, SERANG, BANTEN",2,59,150,209
https://kawalpemilu.org#52668,"SENTUL, KRAGILAN, SERANG, BANTEN",3,57,133,190
https://kawalpemilu.org#52668,"SENTUL, KRAGILAN, SERANG, BANTEN",4,59,150,209
https://kawalpemilu.org#52668,"SENTUL, KRAGILAN, SERANG, BANTEN",5,54,166,220
https://kawalpemilu.org#52668,"SENTUL, KRAGILAN, SERANG, BANTEN",6,94,136,230
https://kawalpemilu.org#52668,"SENTUL, KRAGILAN, SERANG, BANTEN",7,112,96,208
https://kawalpemilu.org#52668,"SENTUL, KRAGILAN, SERANG, BANTEN",8,102,61,163
https://kawalpemilu.org#52668,"SENTUL, KRAGILAN, SERANG, BANTEN",10,153,44,197
https://kawalpemilu.org#52668,"SENTUL, KRAGILAN, SERANG, BANTEN",11,64,166,230
https://kawalpemilu.org#52668,"SENTUL, KRAGILAN, SERANG, BANTEN",12,63,163,226
https://kawalpemilu.org#52668,"SENTUL, KRAGILAN, SERANG, BANTEN",13,72,176,248
https://kawalpemilu.org#52668,"SENTUL, KRAGILAN, SERANG, BANTEN",14,93,132,225
https://kawalpemilu.org#52668,"SENTUL, KRAGILAN, SERANG, BANTEN",15,97,150,247
https://kawalpemilu.org#52668,"SENTUL, KRAGILAN, SERANG, BANTEN",16,66,178,244
https://kawalpemilu.org#52668,"SENTUL, KRAGILAN, SERANG, BANTEN",17,53,129,182
https://kawalpemilu.org#52668,"SENTUL, KRAGILAN, SERANG, BANTEN",18,68,177,245
https://kawalpemilu.org#52668,"SENTUL, KRAGILAN, SERANG, BANTEN",19,55,119,169
https://kawalpemilu.org#52668,"SENTUL, KRAGILAN, SERANG, BANTEN",20,89,131,220
https://kawalpemilu.org#52668,"SENTUL, KRAGILAN, SERANG, BANTEN",21,113,98,211
https://kawalpemilu.org#52668,"SENTUL, KRAGILAN, SERANG, BANTEN",22,108,119,227
https://kawalpemilu.org#52668,"SENTUL, KRAGILAN, SERANG, BANTEN",23,87,141,228
https://kawalpemilu.org#52668,"SENTUL, KRAGILAN, SERANG, BANTEN",24,73,123,196
https://kawalpemilu.org#52668,"SENTUL, KRAGILAN, SERANG, BANTEN",25,45,103,148
https://kawalpemilu.org#52668,"SENTUL, KRAGILAN, SERANG, BANTEN",26,49,100,149
https://kawalpemilu.org#52668,"SENTUL, KRAGILAN, SERANG, BANTEN",27,35,91,126
https://kawalpemilu.org#52668,"SENTUL, KRAGILAN, SERANG, BANTEN",28,22,59,81
https://kawalpemilu.org#52668,"SENTUL, KRAGILAN, SERANG, BANTEN",29,40,104,144
https://kawalpemilu.org#52668,"SENTUL, KRAGILAN, SERANG, BANTEN",30,102,59,161
https://kawalpemilu.org#52668,"SENTUL, KRAGILAN, SERANG, BANTEN",31,32,76,108
https://kawalpemilu.org#52668,"SENTUL, KRAGILAN, SERANG, BANTEN",32,42,60,102
https://kawalpemilu.org#52668,"SENTUL, KRAGILAN, SERANG, BANTEN",33,102,141,243
https://kawalpemilu.org#52669,"JERUK TIPIS, KRAGILAN, SERANG, BANTEN",1,35,178,213
https://kawalpemilu.org#52669,"JERUK TIPIS, KRAGILAN, SERANG, BANTEN",2,48,133,181
https://kawalpemilu.org#52669,"JERUK TIPIS, KRAGILAN, SERANG, BANTEN",3,57,132,189
https://kawalpemilu.org#52669,"JERUK TIPIS, KRAGILAN, SERANG, BANTEN",4,77,100,177
https://kawalpemilu.org#52669,"JERUK TIPIS, KRAGILAN, SERANG, BANTEN",5,50,175,225
https://kawalpemilu.org#52669,"JERUK TIPIS, KRAGILAN, SERANG, BANTEN",6,36,172,208
https://kawalpemilu.org#52669,"JERUK TIPIS, KRAGILAN, SERANG, BANTEN",7,53,139,192
https://kawalpemilu.org#52669,"JERUK TIPIS, KRAGILAN, SERANG, BANTEN",8,54,127,181
https://kawalpemilu.org#52669,"JERUK TIPIS, KRAGILAN, SERANG, BANTEN",9,60,157,217
https://kawalpemilu.org#52669,"JERUK TIPIS, KRAGILAN, SERANG, BANTEN",10,48,146,194
https://kawalpemilu.org#52669,"JERUK TIPIS, KRAGILAN, SERANG, BANTEN",11,41,169,210
https://kawalpemilu.org#52669,"JERUK TIPIS, KRAGILAN, SERANG, BANTEN",12,16,118,134
https://kawalpemilu.org#52669,"JERUK TIPIS, KRAGILAN, SERANG, BANTEN",13,55,126,181
https://kawalpemilu.org#52669,"JERUK TIPIS, KRAGILAN, SERANG, BANTEN",14,52,163,215
https://kawalpemilu.org#52669,"JERUK TIPIS, KRAGILAN, SERANG, BANTEN",15,34,132,166
https://kawalpemilu.org#52672,"KENDAYAKAN, KRAGILAN, SERANG, BANTEN",1,73,166,239
https://kawalpemilu.org#52672,"KENDAYAKAN, KRAGILAN, SERANG, BANTEN",2,53,150,203
https://kawalpemilu.org#52672,"KENDAYAKAN, KRAGILAN, SERANG, BANTEN",3,73,147,220
https://kawalpemilu.org#52672,"KENDAYAKAN, KRAGILAN, SERANG, BANTEN",4,78,136,214
https://kawalpemilu.org#52672,"KENDAYAKAN, KRAGILAN, SERANG, BANTEN",5,65,151,216
https://kawalpemilu.org#52672,"KENDAYAKAN, KRAGILAN, SERANG, BANTEN",6,91,118,209
https://kawalpemilu.org#52672,"KENDAYAKAN, KRAGILAN, SERANG, BANTEN",7,81,112,193
https://kawalpemilu.org#52672,"KENDAYAKAN, KRAGILAN, SERANG, BANTEN",8,64,161,225
https://kawalpemilu.org#52672,"KENDAYAKAN, KRAGILAN, SERANG, BANTEN",9,80,138,218
https://kawalpemilu.org#52672,"KENDAYAKAN, KRAGILAN, SERANG, BANTEN",10,70,121,191
https://kawalpemilu.org#52672,"KENDAYAKAN, KRAGILAN, SERANG, BANTEN",11,80,138,218
https://kawalpemilu.org#52672,"KENDAYAKAN, KRAGILAN, SERANG, BANTEN",12,87,132,219
https://kawalpemilu.org#52672,"KENDAYAKAN, KRAGILAN, SERANG, BANTEN",13,107,95,202
https://kawalpemilu.org#52672,"KENDAYAKAN, KRAGILAN, SERANG, BANTEN",14,121,94,215
https://kawalpemilu.org#52672,"KENDAYAKAN, KRAGILAN, SERANG, BANTEN",15,21,147,168
https://kawalpemilu.org#52672,"KENDAYAKAN, KRAGILAN, SERANG, BANTEN",16,30,173,203
https://kawalpemilu.org#52672,"KENDAYAKAN, KRAGILAN, SERANG, BANTEN",17,23,173,196
https://kawalpemilu.org#52672,"KENDAYAKAN, KRAGILAN, SERANG, BANTEN",18,61,142,203
https://kawalpemilu.org#52672,"KENDAYAKAN, KRAGILAN, SERANG, BANTEN",19,25,75,100
https://kawalpemilu.org#52672,"KENDAYAKAN, KRAGILAN, SERANG, BANTEN",20,61,103,164
https://kawalpemilu.org#52672,"KENDAYAKAN, KRAGILAN, SERANG, BANTEN",21,35,103,138
https://kawalpemilu.org#52672,"KENDAYAKAN, KRAGILAN, SERANG, BANTEN",22,70,121,191
https://kawalpemilu.org#52672,"KENDAYAKAN, KRAGILAN, SERANG, BANTEN",23,68,100,168
https://kawalpemilu.org#52672,"KENDAYAKAN, KRAGILAN, SERANG, BANTEN",24,0,0,0
https://kawalpemilu.org#52672,"KENDAYAKAN, KRAGILAN, SERANG, BANTEN",25,93,135,228
https://kawalpemilu.org#52672,"KENDAYAKAN, KRAGILAN, SERANG, BANTEN",26,80,138,218
https://kawalpemilu.org#52672,"KENDAYAKAN, KRAGILAN, SERANG, BANTEN",27,111,114,225
https://kawalpemilu.org#52672,"KENDAYAKAN, KRAGILAN, SERANG, BANTEN",28,84,110,194
https://kawalpemilu.org#52672,"KENDAYAKAN, KRAGILAN, SERANG, BANTEN",29,100,114,214
https://kawalpemilu.org#52672,"KENDAYAKAN, KRAGILAN, SERANG, BANTEN",30,90,116,206
https://kawalpemilu.org#52672,"KENDAYAKAN, KRAGILAN, SERANG, BANTEN",31,92,108,200
https://kawalpemilu.org#52672,"KENDAYAKAN, KRAGILAN, SERANG, BANTEN",32,87,93,180
https://kawalpemilu.org#52672,"KENDAYAKAN, KRAGILAN, SERANG, BANTEN",33,83,92,175
https://kawalpemilu.org#52673,"TEGALMAJA, KRAGILAN, SERANG, BANTEN",1,101,149,250
https://kawalpemilu.org#52673,"TEGALMAJA, KRAGILAN, SERANG, BANTEN",2,84,141,225
https://kawalpemilu.org#52673,"TEGALMAJA, KRAGILAN, SERANG, BANTEN",4,37,129,166
https://kawalpemilu.org#52673,"TEGALMAJA, KRAGILAN, SERANG, BANTEN",5,45,139,184
https://kawalpemilu.org#52673,"TEGALMAJA, KRAGILAN, SERANG, BANTEN",6,70,131,201
https://kawalpemilu.org#52673,"TEGALMAJA, KRAGILAN, SERANG, BANTEN",7,92,109,201
https://kawalpemilu.org#52673,"TEGALMAJA, KRAGILAN, SERANG, BANTEN",8,32,130,162
https://kawalpemilu.org#52673,"TEGALMAJA, KRAGILAN, SERANG, BANTEN",9,41,122,163
https://kawalpemilu.org#52673,"TEGALMAJA, KRAGILAN, SERANG, BANTEN",10,76,119,195
https://kawalpemilu.org#52673,"TEGALMAJA, KRAGILAN, SERANG, BANTEN",11,48,99,147
https://kawalpemilu.org#52674,"CISAIT, KRAGILAN, SERANG, BANTEN",1,35,140,175
https://kawalpemilu.org#52674,"CISAIT, KRAGILAN, SERANG, BANTEN",2,39,163,202
https://kawalpemilu.org#52674,"CISAIT, KRAGILAN, SERANG, BANTEN",3,32,169,201
https://kawalpemilu.org#52674,"CISAIT, KRAGILAN, SERANG, BANTEN",4,88,145,233
https://kawalpemilu.org#52674,"CISAIT, KRAGILAN, SERANG, BANTEN",5,110,104,214
https://kawalpemilu.org#52674,"CISAIT, KRAGILAN, SERANG, BANTEN",6,67,158,225
https://kawalpemilu.org#52674,"CISAIT, KRAGILAN, SERANG, BANTEN",7,36,188,224
https://kawalpemilu.org#52674,"CISAIT, KRAGILAN, SERANG, BANTEN",8,63,123,186
https://kawalpemilu.org#52674,"CISAIT, KRAGILAN, SERANG, BANTEN",9,63,138,201
https://kawalpemilu.org#52674,"CISAIT, KRAGILAN, SERANG, BANTEN",10,47,172,219
https://kawalpemilu.org#52674,"CISAIT, KRAGILAN, SERANG, BANTEN",11,63,122,185
https://kawalpemilu.org#52674,"CISAIT, KRAGILAN, SERANG, BANTEN",12,76,157,233
https://kawalpemilu.org#52674,"CISAIT, KRAGILAN, SERANG, BANTEN",13,109,131,240
https://kawalpemilu.org#52674,"CISAIT, KRAGILAN, SERANG, BANTEN",14,104,147,251
https://kawalpemilu.org#52674,"CISAIT, KRAGILAN, SERANG, BANTEN",15,97,146,243
https://kawalpemilu.org#52674,"CISAIT, KRAGILAN, SERANG, BANTEN",16,86,128,214
https://kawalpemilu.org#52674,"CISAIT, KRAGILAN, SERANG, BANTEN",17,88,153,241
https://kawalpemilu.org#52674,"CISAIT, KRAGILAN, SERANG, BANTEN",18,96,141,237
https://kawalpemilu.org#52674,"CISAIT, KRAGILAN, SERANG, BANTEN",19,76,101,177
https://kawalpemilu.org#52674,"CISAIT, KRAGILAN, SERANG, BANTEN",20,109,100,209
https://kawalpemilu.org#52674,"CISAIT, KRAGILAN, SERANG, BANTEN",21,55,114,169
https://kawalpemilu.org#52674,"CISAIT, KRAGILAN, SERANG, BANTEN",22,69,101,170
https://kawalpemilu.org#52674,"CISAIT, KRAGILAN, SERANG, BANTEN",23,46,126,172
https://kawalpemilu.org#52674,"CISAIT, KRAGILAN, SERANG, BANTEN",24,44,132,176
https://kawalpemilu.org#52674,"CISAIT, KRAGILAN, SERANG, BANTEN",25,42,74,96
https://kawalpemilu.org#52674,"CISAIT, KRAGILAN, SERANG, BANTEN",26,0,0,0
https://kawalpemilu.org#52675,"KRAMATJATI, KRAGILAN, SERANG, BANTEN",1,79,129,208
https://kawalpemilu.org#52675,"KRAMATJATI, KRAGILAN, SERANG, BANTEN",2,58,116,174
https://kawalpemilu.org#52675,"KRAMATJATI, KRAGILAN, SERANG, BANTEN",3,72,128,200
https://kawalpemilu.org#52675,"KRAMATJATI, KRAGILAN, SERANG, BANTEN",4,48,177,225
https://kawalpemilu.org#52675,"KRAMATJATI, KRAGILAN, SERANG, BANTEN",5,44,175,219
https://kawalpemilu.org#52675,"KRAMATJATI, KRAGILAN, SERANG, BANTEN",6,34,199,233
https://kawalpemilu.org#52675,"KRAMATJATI, KRAGILAN, SERANG, BANTEN",7,55,167,222
https://kawalpemilu.org#52675,"KRAMATJATI, KRAGILAN, SERANG, BANTEN",8,45,115,160
https://kawalpemilu.org#52675,"KRAMATJATI, KRAGILAN, SERANG, BANTEN",9,56,139,195
https://kawalpemilu.org#52675,"KRAMATJATI, KRAGILAN, SERANG, BANTEN",10,75,159,234
https://kawalpemilu.org#52675,"KRAMATJATI, KRAGILAN, SERANG, BANTEN",11,74,128,202
https://kawalpemilu.org#52677,"PONTANG, PONTANG, SERANG, BANTEN",1,55,168,223
https://kawalpemilu.org#52677,"PONTANG, PONTANG, SERANG, BANTEN",2,55,158,213
https://kawalpemilu.org#52677,"PONTANG, PONTANG, SERANG, BANTEN",3,65,163,228
https://kawalpemilu.org#52677,"PONTANG, PONTANG, SERANG, BANTEN",4,71,168,239
https://kawalpemilu.org#52677,"PONTANG, PONTANG, SERANG, BANTEN",5,70,146,216
https://kawalpemilu.org#52677,"PONTANG, PONTANG, SERANG, BANTEN",6,79,143,222
https://kawalpemilu.org#52677,"PONTANG, PONTANG, SERANG, BANTEN",7,55,173,228
https://kawalpemilu.org#52677,"PONTANG, PONTANG, SERANG, BANTEN",8,73,148,221
https://kawalpemilu.org#52677,"PONTANG, PONTANG, SERANG, BANTEN",9,54,160,214
https://kawalpemilu.org#52677,"PONTANG, PONTANG, SERANG, BANTEN",10,66,169,235
https://kawalpemilu.org#52677,"PONTANG, PONTANG, SERANG, BANTEN",11,41,177,218
https://kawalpemilu.org#52678,"SUKANEGARA, PONTANG, SERANG, BANTEN",1,95,145,240
https://kawalpemilu.org#52678,"SUKANEGARA, PONTANG, SERANG, BANTEN",3,62,132,194
https://kawalpemilu.org#52678,"SUKANEGARA, PONTANG, SERANG, BANTEN",4,60,150,210
https://kawalpemilu.org#52678,"SUKANEGARA, PONTANG, SERANG, BANTEN",5,64,139,203
https://kawalpemilu.org#52678,"SUKANEGARA, PONTANG, SERANG, BANTEN",6,47,116,163
https://kawalpemilu.org#52678,"SUKANEGARA, PONTANG, SERANG, BANTEN",7,39,103,142
https://kawalpemilu.org#52678,"SUKANEGARA, PONTANG, SERANG, BANTEN",8,32,109,141
https://kawalpemilu.org#52679,"LINDUK, PONTANG, SERANG, BANTEN",1,67,145,212
https://kawalpemilu.org#52679,"LINDUK, PONTANG, SERANG, BANTEN",2,67,145,212
https://kawalpemilu.org#52679,"LINDUK, PONTANG, SERANG, BANTEN",3,54,147,201
https://kawalpemilu.org#52679,"LINDUK, PONTANG, SERANG, BANTEN",4,60,173,233
https://kawalpemilu.org#52679,"LINDUK, PONTANG, SERANG, BANTEN",5,73,158,231
https://kawalpemilu.org#52679,"LINDUK, PONTANG, SERANG, BANTEN",6,52,160,212
https://kawalpemilu.org#52679,"LINDUK, PONTANG, SERANG, BANTEN",7,32,114,146
https://kawalpemilu.org#52679,"LINDUK, PONTANG, SERANG, BANTEN",8,30,111,141
https://kawalpemilu.org#52679,"LINDUK, PONTANG, SERANG, BANTEN",9,37,167,204
https://kawalpemilu.org#52679,"LINDUK, PONTANG, SERANG, BANTEN",10,34,160,194
https://kawalpemilu.org#52679,"LINDUK, PONTANG, SERANG, BANTEN",11,42,144,186
https://kawalpemilu.org#52679,"LINDUK, PONTANG, SERANG, BANTEN",12,32,117,209
https://kawalpemilu.org#52679,"LINDUK, PONTANG, SERANG, BANTEN",13,23,172,195
https://kawalpemilu.org#52679,"LINDUK, PONTANG, SERANG, BANTEN",14,65,114,179
https://kawalpemilu.org#52679,"LINDUK, PONTANG, SERANG, BANTEN",15,16,100,116
https://kawalpemilu.org#52680,"PULOKENCANA, PONTANG, SERANG, BANTEN",1,40,166,206
https://kawalpemilu.org#52680,"PULOKENCANA, PONTANG, SERANG, BANTEN",2,37,152,189
https://kawalpemilu.org#52680,"PULOKENCANA, PONTANG, SERANG, BANTEN",3,40,139,179
https://kawalpemilu.org#52680,"PULOKENCANA, PONTANG, SERANG, BANTEN",4,69,123,192
https://kawalpemilu.org#52680,"PULOKENCANA, PONTANG, SERANG, BANTEN",5,62,132,194
https://kawalpemilu.org#52680,"PULOKENCANA, PONTANG, SERANG, BANTEN",6,28,158,186
https://kawalpemilu.org#52680,"PULOKENCANA, PONTANG, SERANG, BANTEN",7,26,122,148
https://kawalpemilu.org#52680,"PULOKENCANA, PONTANG, SERANG, BANTEN",8,80,125,205
https://kawalpemilu.org#52680,"PULOKENCANA, PONTANG, SERANG, BANTEN",9,32,183,215
https://kawalpemilu.org#52680,"PULOKENCANA, PONTANG, SERANG, BANTEN",10,59,167,226
https://kawalpemilu.org#52680,"PULOKENCANA, PONTANG, SERANG, BANTEN",11,69,128,197
https://kawalpemilu.org#52680,"PULOKENCANA, PONTANG, SERANG, BANTEN",12,76,112,188
https://kawalpemilu.org#52680,"PULOKENCANA, PONTANG, SERANG, BANTEN",13,22,166,188
https://kawalpemilu.org#52682,"KELAPIAN, PONTANG, SERANG, BANTEN",1,12,180,192
https://kawalpemilu.org#52682,"KELAPIAN, PONTANG, SERANG, BANTEN",2,19,190,209
https://kawalpemilu.org#52682,"KELAPIAN, PONTANG, SERANG, BANTEN",3,20,140,160
https://kawalpemilu.org#52682,"KELAPIAN, PONTANG, SERANG, BANTEN",4,27,198,225
https://kawalpemilu.org#52682,"KELAPIAN, PONTANG, SERANG, BANTEN",5,33,166,199
https://kawalpemilu.org#52682,"KELAPIAN, PONTANG, SERANG, BANTEN",6,45,149,194
https://kawalpemilu.org#52682,"KELAPIAN, PONTANG, SERANG, BANTEN",7,11,136,147
https://kawalpemilu.org#52682,"KELAPIAN, PONTANG, SERANG, BANTEN",8,21,186,207
https://kawalpemilu.org#52682,"KELAPIAN, PONTANG, SERANG, BANTEN",9,31,198,229
https://kawalpemilu.org#52682,"KELAPIAN, PONTANG, SERANG, BANTEN",10,59,143,202
https://kawalpemilu.org#52682,"KELAPIAN, PONTANG, SERANG, BANTEN",11,64,146,210
https://kawalpemilu.org#52684,"KUBANG PUJI, PONTANG, SERANG, BANTEN",1,59,158,217
https://kawalpemilu.org#52684,"KUBANG PUJI, PONTANG, SERANG, BANTEN",2,32,201,233
https://kawalpemilu.org#52684,"KUBANG PUJI, PONTANG, SERANG, BANTEN",3,52,148,200
https://kawalpemilu.org#52684,"KUBANG PUJI, PONTANG, SERANG, BANTEN",4,53,141,194
https://kawalpemilu.org#52684,"KUBANG PUJI, PONTANG, SERANG, BANTEN",5,79,129,208
https://kawalpemilu.org#52684,"KUBANG PUJI, PONTANG, SERANG, BANTEN",6,81,130,211
https://kawalpemilu.org#52684,"KUBANG PUJI, PONTANG, SERANG, BANTEN",7,78,113,191
https://kawalpemilu.org#52684,"KUBANG PUJI, PONTANG, SERANG, BANTEN",8,59,162,221
https://kawalpemilu.org#52684,"KUBANG PUJI, PONTANG, SERANG, BANTEN",9,81,146,227
https://kawalpemilu.org#52684,"KUBANG PUJI, PONTANG, SERANG, BANTEN",10,58,180,238
https://kawalpemilu.org#52684,"KUBANG PUJI, PONTANG, SERANG, BANTEN",12,41,141,182
https://kawalpemilu.org#52684,"KUBANG PUJI, PONTANG, SERANG, BANTEN",13,59,144,203
https://kawalpemilu.org#52684,"KUBANG PUJI, PONTANG, SERANG, BANTEN",14,44,157,201
https://kawalpemilu.org#52685,"DOMAS, PONTANG, SERANG, BANTEN",1,136,75,211
https://kawalpemilu.org#52685,"DOMAS, PONTANG, SERANG, BANTEN",2,0,0,0
https://kawalpemilu.org#52685,"DOMAS, PONTANG, SERANG, BANTEN",3,54,146,200
https://kawalpemilu.org#52685,"DOMAS, PONTANG, SERANG, BANTEN",4,112,94,206
https://kawalpemilu.org#52685,"DOMAS, PONTANG, SERANG, BANTEN",5,101,109,210
https://kawalpemilu.org#52685,"DOMAS, PONTANG, SERANG, BANTEN",6,77,130,207
https://kawalpemilu.org#52685,"DOMAS, PONTANG, SERANG, BANTEN",7,58,139,197
https://kawalpemilu.org#52685,"DOMAS, PONTANG, SERANG, BANTEN",8,65,157,222
https://kawalpemilu.org#52685,"DOMAS, PONTANG, SERANG, BANTEN",9,58,171,229
https://kawalpemilu.org#52685,"DOMAS, PONTANG, SERANG, BANTEN",10,49,174,223
https://kawalpemilu.org#52685,"DOMAS, PONTANG, SERANG, BANTEN",11,66,157,223
https://kawalpemilu.org#52685,"DOMAS, PONTANG, SERANG, BANTEN",12,52,177,229
https://kawalpemilu.org#52685,"DOMAS, PONTANG, SERANG, BANTEN",13,38,185,223
https://kawalpemilu.org#52686,"SINGARAJAN, PONTANG, SERANG, BANTEN",1,51,172,223
https://kawalpemilu.org#52686,"SINGARAJAN, PONTANG, SERANG, BANTEN",2,64,181,245
https://kawalpemilu.org#52686,"SINGARAJAN, PONTANG, SERANG, BANTEN",3,44,159,203
https://kawalpemilu.org#52686,"SINGARAJAN, PONTANG, SERANG, BANTEN",4,49,172,221
https://kawalpemilu.org#52686,"SINGARAJAN, PONTANG, SERANG, BANTEN",5,24,156,180
https://kawalpemilu.org#52686,"SINGARAJAN, PONTANG, SERANG, BANTEN",6,37,171,208
https://kawalpemilu.org#52686,"SINGARAJAN, PONTANG, SERANG, BANTEN",7,51,138,189
https://kawalpemilu.org#52686,"SINGARAJAN, PONTANG, SERANG, BANTEN",8,57,137,194
https://kawalpemilu.org#52686,"SINGARAJAN, PONTANG, SERANG, BANTEN",9,37,181,218
https://kawalpemilu.org#52686,"SINGARAJAN, PONTANG, SERANG, BANTEN",10,53,147,200
https://kawalpemilu.org#52686,"SINGARAJAN, PONTANG, SERANG, BANTEN",11,53,137,190
https://kawalpemilu.org#52686,"SINGARAJAN, PONTANG, SERANG, BANTEN",12,68,118,186
https://kawalpemilu.org#52686,"SINGARAJAN, PONTANG, SERANG, BANTEN",13,70,146,216
https://kawalpemilu.org#52687,"KASERANGAN, PONTANG, SERANG, BANTEN",1,110,98,208
https://kawalpemilu.org#52687,"KASERANGAN, PONTANG, SERANG, BANTEN",2,71,133,204
https://kawalpemilu.org#52687,"KASERANGAN, PONTANG, SERANG, BANTEN",3,55,158,213
https://kawalpemilu.org#52687,"KASERANGAN, PONTANG, SERANG, BANTEN",4,102,141,243
https://kawalpemilu.org#52687,"KASERANGAN, PONTANG, SERANG, BANTEN",5,45,174,219
https://kawalpemilu.org#52687,"KASERANGAN, PONTANG, SERANG, BANTEN",6,42,169,211
https://kawalpemilu.org#52687,"KASERANGAN, PONTANG, SERANG, BANTEN",7,33,189,222
https://kawalpemilu.org#52687,"KASERANGAN, PONTANG, SERANG, BANTEN",8,30,146,176
https://kawalpemilu.org#52687,"KASERANGAN, PONTANG, SERANG, BANTEN",9,46,149,195
https://kawalpemilu.org#52687,"KASERANGAN, PONTANG, SERANG, BANTEN",10,43,163,206
https://kawalpemilu.org#52687,"KASERANGAN, PONTANG, SERANG, BANTEN",11,58,136,194
https://kawalpemilu.org#52687,"KASERANGAN, PONTANG, SERANG, BANTEN",12,52,151,203
https://kawalpemilu.org#52687,"KASERANGAN, PONTANG, SERANG, BANTEN",13,44,143,187
https://kawalpemilu.org#52688,"WANAYASA, PONTANG, SERANG, BANTEN",1,50,164,214
https://kawalpemilu.org#52688,"WANAYASA, PONTANG, SERANG, BANTEN",2,78,145,223
https://kawalpemilu.org#52688,"WANAYASA, PONTANG, SERANG, BANTEN",3,72,129,201
https://kawalpemilu.org#52688,"WANAYASA, PONTANG, SERANG, BANTEN",4,81,138,219
https://kawalpemilu.org#52688,"WANAYASA, PONTANG, SERANG, BANTEN",5,35,158,193
https://kawalpemilu.org#52688,"WANAYASA, PONTANG, SERANG, BANTEN",6,39,120,159
https://kawalpemilu.org#52688,"WANAYASA, PONTANG, SERANG, BANTEN",7,27,134,161
https://kawalpemilu.org#52688,"WANAYASA, PONTANG, SERANG, BANTEN",8,41,92,133
https://kawalpemilu.org#52689,"SUKA JAYA, PONTANG, SERANG, BANTEN",1,65,171,236
https://kawalpemilu.org#52689,"SUKA JAYA, PONTANG, SERANG, BANTEN",2,67,142,209
https://kawalpemilu.org#52689,"SUKA JAYA, PONTANG, SERANG, BANTEN",3,92,111,203
https://kawalpemilu.org#52689,"SUKA JAYA, PONTANG, SERANG, BANTEN",4,77,152,229
https://kawalpemilu.org#52689,"SUKA JAYA, PONTANG, SERANG, BANTEN",5,61,72,133
https://kawalpemilu.org#52689,"SUKA JAYA, PONTANG, SERANG, BANTEN",6,69,84,153
https://kawalpemilu.org#52689,"SUKA JAYA, PONTANG, SERANG, BANTEN",7,101,122,223
https://kawalpemilu.org#52689,"SUKA JAYA, PONTANG, SERANG, BANTEN",8,73,126,199
https://kawalpemilu.org#52689,"SUKA JAYA, PONTANG, SERANG, BANTEN",9,54,116,170
https://kawalpemilu.org#52689,"SUKA JAYA, PONTANG, SERANG, BANTEN",10,44,120,164
https://kawalpemilu.org#52689,"SUKA JAYA, PONTANG, SERANG, BANTEN",11,60,109,169
https://kawalpemilu.org#52689,"SUKA JAYA, PONTANG, SERANG, BANTEN",12,63,82,145
https://kawalpemilu.org#52689,"SUKA JAYA, PONTANG, SERANG, BANTEN",13,39,95,134
https://kawalpemilu.org#52689,"SUKA JAYA, PONTANG, SERANG, BANTEN",14,40,83,123
https://kawalpemilu.org#52693,"TIRTAYASA, TIRTAYASA, SERANG, BANTEN",1,45,184,229
https://kawalpemilu.org#52693,"TIRTAYASA, TIRTAYASA, SERANG, BANTEN",2,38,184,222
https://kawalpemilu.org#52693,"TIRTAYASA, TIRTAYASA, SERANG, BANTEN",3,49,188,237
https://kawalpemilu.org#52693,"TIRTAYASA, TIRTAYASA, SERANG, BANTEN",4,49,145,194
https://kawalpemilu.org#52693,"TIRTAYASA, TIRTAYASA, SERANG, BANTEN",5,34,169,203
https://kawalpemilu.org#52693,"TIRTAYASA, TIRTAYASA, SERANG, BANTEN",6,31,196,227
https://kawalpemilu.org#52693,"TIRTAYASA, TIRTAYASA, SERANG, BANTEN",7,33,178,211
https://kawalpemilu.org#52693,"TIRTAYASA, TIRTAYASA, SERANG, BANTEN",8,39,172,211
https://kawalpemilu.org#52693,"TIRTAYASA, TIRTAYASA, SERANG, BANTEN",9,58,199,257
https://kawalpemilu.org#52693,"TIRTAYASA, TIRTAYASA, SERANG, BANTEN",10,48,210,258
https://kawalpemilu.org#52694,"SAMPARWADI, TIRTAYASA, SERANG, BANTEN",1,52,186,238
https://kawalpemilu.org#52694,"SAMPARWADI, TIRTAYASA, SERANG, BANTEN",2,30,184,214
https://kawalpemilu.org#52694,"SAMPARWADI, TIRTAYASA, SERANG, BANTEN",3,45,168,213
https://kawalpemilu.org#52694,"SAMPARWADI, TIRTAYASA, SERANG, BANTEN",4,64,144,208
https://kawalpemilu.org#52694,"SAMPARWADI, TIRTAYASA, SERANG, BANTEN",5,63,167,230
https://kawalpemilu.org#52694,"SAMPARWADI, TIRTAYASA, SERANG, BANTEN",6,42,172,214
https://kawalpemilu.org#52694,"SAMPARWADI, TIRTAYASA, SERANG, BANTEN",7,41,192,233
https://kawalpemilu.org#52694,"SAMPARWADI, TIRTAYASA, SERANG, BANTEN",8,25,164,189
https://kawalpemilu.org#52695,"KEMANISAN, TIRTAYASA, SERANG, BANTEN",1,34,145,179
https://kawalpemilu.org#52695,"KEMANISAN, TIRTAYASA, SERANG, BANTEN",2,59,135,194
https://kawalpemilu.org#52695,"KEMANISAN, TIRTAYASA, SERANG, BANTEN",3,70,114,184
https://kawalpemilu.org#52695,"KEMANISAN, TIRTAYASA, SERANG, BANTEN",4,65,148,213
https://kawalpemilu.org#52695,"KEMANISAN, TIRTAYASA, SERANG, BANTEN",5,61,120,181
https://kawalpemilu.org#52695,"KEMANISAN, TIRTAYASA, SERANG, BANTEN",6,90,147,237
https://kawalpemilu.org#52695,"KEMANISAN, TIRTAYASA, SERANG, BANTEN",7,62,127,189
https://kawalpemilu.org#52695,"KEMANISAN, TIRTAYASA, SERANG, BANTEN",8,53,135,188
https://kawalpemilu.org#52696,"PONTANG LEGON, TIRTAYASA, SERANG, BANTEN",1,90,99,189
https://kawalpemilu.org#52696,"PONTANG LEGON, TIRTAYASA, SERANG, BANTEN",2,42,169,211
https://kawalpemilu.org#52696,"PONTANG LEGON, TIRTAYASA, SERANG, BANTEN",3,97,96,193
https://kawalpemilu.org#52696,"PONTANG LEGON, TIRTAYASA, SERANG, BANTEN",4,92,110,202
https://kawalpemilu.org#52696,"PONTANG LEGON, TIRTAYASA, SERANG, BANTEN",5,115,115,230
https://kawalpemilu.org#52696,"PONTANG LEGON, TIRTAYASA, SERANG, BANTEN",6,90,116,206
https://kawalpemilu.org#52696,"PONTANG LEGON, TIRTAYASA, SERANG, BANTEN",7,76,132,208
https://kawalpemilu.org#52696,"PONTANG LEGON, TIRTAYASA, SERANG, BANTEN",8,63,97,160
https://kawalpemilu.org#52696,"PONTANG LEGON, TIRTAYASA, SERANG, BANTEN",9,33,90,123
https://kawalpemilu.org#52697,"KEBON, TIRTAYASA, SERANG, BANTEN",1,56,194,250
https://kawalpemilu.org#52697,"KEBON, TIRTAYASA, SERANG, BANTEN",2,61,171,232
https://kawalpemilu.org#52697,"KEBON, TIRTAYASA, SERANG, BANTEN",3,72,155,227
https://kawalpemilu.org#52697,"KEBON, TIRTAYASA, SERANG, BANTEN",4,101,126,227
https://kawalpemilu.org#52697,"KEBON, TIRTAYASA, SERANG, BANTEN",5,47,158,205
https://kawalpemilu.org#52697,"KEBON, TIRTAYASA, SERANG, BANTEN",6,63,167,230
https://kawalpemilu.org#52697,"KEBON, TIRTAYASA, SERANG, BANTEN",7,36,161,197
https://kawalpemilu.org#52697,"KEBON, TIRTAYASA, SERANG, BANTEN",8,10,89,99
https://kawalpemilu.org#52697,"KEBON, TIRTAYASA, SERANG, BANTEN",9,36,91,127
https://kawalpemilu.org#52697,"KEBON, TIRTAYASA, SERANG, BANTEN",10,32,162,194
https://kawalpemilu.org#52698,"SUJUNG, TIRTAYASA, SERANG, BANTEN",1,38,132,170
https://kawalpemilu.org#52698,"SUJUNG, TIRTAYASA, SERANG, BANTEN",2,29,122,151
https://kawalpemilu.org#52698,"SUJUNG, TIRTAYASA, SERANG, BANTEN",3,31,175,206
https://kawalpemilu.org#52698,"SUJUNG, TIRTAYASA, SERANG, BANTEN",4,40,124,164
https://kawalpemilu.org#52698,"SUJUNG, TIRTAYASA, SERANG, BANTEN",5,65,155,220
https://kawalpemilu.org#52698,"SUJUNG, TIRTAYASA, SERANG, BANTEN",6,37,113,150
https://kawalpemilu.org#52698,"SUJUNG, TIRTAYASA, SERANG, BANTEN",7,83,128,211
https://kawalpemilu.org#52698,"SUJUNG, TIRTAYASA, SERANG, BANTEN",8,77,124,201
https://kawalpemilu.org#52698,"SUJUNG, TIRTAYASA, SERANG, BANTEN",10,65,155,220
https://kawalpemilu.org#52698,"SUJUNG, TIRTAYASA, SERANG, BANTEN",11,76,167,243
https://kawalpemilu.org#52698,"SUJUNG, TIRTAYASA, SERANG, BANTEN",12,33,161,194
https://kawalpemilu.org#52698,"SUJUNG, TIRTAYASA, SERANG, BANTEN",13,24,134,158
https://kawalpemilu.org#52698,"SUJUNG, TIRTAYASA, SERANG, BANTEN",14,47,150,197
https://kawalpemilu.org#52698,"SUJUNG, TIRTAYASA, SERANG, BANTEN",15,64,164,228
https://kawalpemilu.org#52699,"LONTAR, TIRTAYASA, SERANG, BANTEN",1,85,81,166
https://kawalpemilu.org#52699,"LONTAR, TIRTAYASA, SERANG, BANTEN",2,43,86,129
https://kawalpemilu.org#52699,"LONTAR, TIRTAYASA, SERANG, BANTEN",3,65,105,170
https://kawalpemilu.org#52699,"LONTAR, TIRTAYASA, SERANG, BANTEN",4,77,113,190
https://kawalpemilu.org#52699,"LONTAR, TIRTAYASA, SERANG, BANTEN",5,40,116,156
https://kawalpemilu.org#52699,"LONTAR, TIRTAYASA, SERANG, BANTEN",6,48,90,138
https://kawalpemilu.org#52699,"LONTAR, TIRTAYASA, SERANG, BANTEN",7,62,116,178
https://kawalpemilu.org#52699,"LONTAR, TIRTAYASA, SERANG, BANTEN",8,58,101,159
https://kawalpemilu.org#52699,"LONTAR, TIRTAYASA, SERANG, BANTEN",9,83,104,187
https://kawalpemilu.org#52699,"LONTAR, TIRTAYASA, SERANG, BANTEN",10,85,106,191
https://kawalpemilu.org#52699,"LONTAR, TIRTAYASA, SERANG, BANTEN",11,56,98,154
https://kawalpemilu.org#52699,"LONTAR, TIRTAYASA, SERANG, BANTEN",12,70,65,135
https://kawalpemilu.org#52699,"LONTAR, TIRTAYASA, SERANG, BANTEN",13,112,67,179
https://kawalpemilu.org#52699,"LONTAR, TIRTAYASA, SERANG, BANTEN",14,108,90,198
https://kawalpemilu.org#52699,"LONTAR, TIRTAYASA, SERANG, BANTEN",15,121,83,204
https://kawalpemilu.org#52699,"LONTAR, TIRTAYASA, SERANG, BANTEN",16,107,79,186
https://kawalpemilu.org#52699,"LONTAR, TIRTAYASA, SERANG, BANTEN",17,78,93,171
https://kawalpemilu.org#52699,"LONTAR, TIRTAYASA, SERANG, BANTEN",18,110,72,182
https://kawalpemilu.org#52699,"LONTAR, TIRTAYASA, SERANG, BANTEN",19,90,86,176
https://kawalpemilu.org#52699,"LONTAR, TIRTAYASA, SERANG, BANTEN",20,109,63,172
https://kawalpemilu.org#52700,"SUSUKAN, TIRTAYASA, SERANG, BANTEN",1,56,178,234
https://kawalpemilu.org#52700,"SUSUKAN, TIRTAYASA, SERANG, BANTEN",2,70,141,211
https://kawalpemilu.org#52700,"SUSUKAN, TIRTAYASA, SERANG, BANTEN",3,77,147,224
https://kawalpemilu.org#52700,"SUSUKAN, TIRTAYASA, SERANG, BANTEN",4,46,189,235
https://kawalpemilu.org#52700,"SUSUKAN, TIRTAYASA, SERANG, BANTEN",5,42,180,222
https://kawalpemilu.org#52700,"SUSUKAN, TIRTAYASA, SERANG, BANTEN",6,53,162,215
https://kawalpemilu.org#52700,"SUSUKAN, TIRTAYASA, SERANG, BANTEN",7,46,154,200
https://kawalpemilu.org#52700,"SUSUKAN, TIRTAYASA, SERANG, BANTEN",8,80,121,201
https://kawalpemilu.org#52700,"SUSUKAN, TIRTAYASA, SERANG, BANTEN",9,42,129,171
https://kawalpemilu.org#52700,"SUSUKAN, TIRTAYASA, SERANG, BANTEN",10,50,168,218
https://kawalpemilu.org#52700,"SUSUKAN, TIRTAYASA, SERANG, BANTEN",11,85,114,199
https://kawalpemilu.org#52700,"SUSUKAN, TIRTAYASA, SERANG, BANTEN",12,53,124,177
https://kawalpemilu.org#52701,"WARGASARA, TIRTAYASA, SERANG, BANTEN",1,99,114,213
https://kawalpemilu.org#52701,"WARGASARA, TIRTAYASA, SERANG, BANTEN",2,104,98,202
https://kawalpemilu.org#52701,"WARGASARA, TIRTAYASA, SERANG, BANTEN",3,56,97,153
https://kawalpemilu.org#52701,"WARGASARA, TIRTAYASA, SERANG, BANTEN",4,31,154,185
https://kawalpemilu.org#52702,"LABAN, TIRTAYASA, SERANG, BANTEN",1,49,182,231
https://kawalpemilu.org#52702,"LABAN, TIRTAYASA, SERANG, BANTEN",2,38,172,210
https://kawalpemilu.org#52702,"LABAN, TIRTAYASA, SERANG, BANTEN",3,27,188,215
https://kawalpemilu.org#52702,"LABAN, TIRTAYASA, SERANG, BANTEN",4,51,182,233
https://kawalpemilu.org#52702,"LABAN, TIRTAYASA, SERANG, BANTEN",5,28,177,205
https://kawalpemilu.org#52702,"LABAN, TIRTAYASA, SERANG, BANTEN",6,35,209,244
https://kawalpemilu.org#52702,"LABAN, TIRTAYASA, SERANG, BANTEN",7,44,166,210
https://kawalpemilu.org#52703,"TENGKURAK, TIRTAYASA, SERANG, BANTEN",1,86,129,215
https://kawalpemilu.org#52703,"TENGKURAK, TIRTAYASA, SERANG, BANTEN",2,58,143,201
https://kawalpemilu.org#52703,"TENGKURAK, TIRTAYASA, SERANG, BANTEN",3,71,119,190
https://kawalpemilu.org#52703,"TENGKURAK, TIRTAYASA, SERANG, BANTEN",4,89,100,189
https://kawalpemilu.org#52703,"TENGKURAK, TIRTAYASA, SERANG, BANTEN",5,63,136,199
https://kawalpemilu.org#52703,"TENGKURAK, TIRTAYASA, SERANG, BANTEN",6,45,189,234
https://kawalpemilu.org#52703,"TENGKURAK, TIRTAYASA, SERANG, BANTEN",7,64,150,214
https://kawalpemilu.org#52703,"TENGKURAK, TIRTAYASA, SERANG, BANTEN",8,62,163,225
https://kawalpemilu.org#52704,"ALANG-ALANG, TIRTAYASA, SERANG, BANTEN",1,66,118,184
https://kawalpemilu.org#52704,"ALANG-ALANG, TIRTAYASA, SERANG, BANTEN",2,53,126,179
https://kawalpemilu.org#52704,"ALANG-ALANG, TIRTAYASA, SERANG, BANTEN",3,38,105,143
https://kawalpemilu.org#52704,"ALANG-ALANG, TIRTAYASA, SERANG, BANTEN",4,76,90,166
https://kawalpemilu.org#52704,"ALANG-ALANG, TIRTAYASA, SERANG, BANTEN",5,60,116,176
https://kawalpemilu.org#52704,"ALANG-ALANG, TIRTAYASA, SERANG, BANTEN",6,67,109,176
https://kawalpemilu.org#52704,"ALANG-ALANG, TIRTAYASA, SERANG, BANTEN",7,56,84,140
https://kawalpemilu.org#52704,"ALANG-ALANG, TIRTAYASA, SERANG, BANTEN",8,54,152,206
https://kawalpemilu.org#52704,"ALANG-ALANG, TIRTAYASA, SERANG, BANTEN",9,68,128,196
https://kawalpemilu.org#52705,"KEBUYUTAN, TIRTAYASA, SERANG, BANTEN",1,44,155,199
https://kawalpemilu.org#52705,"KEBUYUTAN, TIRTAYASA, SERANG, BANTEN",2,48,163,211
https://kawalpemilu.org#52705,"KEBUYUTAN, TIRTAYASA, SERANG, BANTEN",3,74,131,205
https://kawalpemilu.org#52705,"KEBUYUTAN, TIRTAYASA, SERANG, BANTEN",4,59,139,198
https://kawalpemilu.org#52705,"KEBUYUTAN, TIRTAYASA, SERANG, BANTEN",5,23,191,214
https://kawalpemilu.org#52705,"KEBUYUTAN, TIRTAYASA, SERANG, BANTEN",6,43,155,198
https://kawalpemilu.org#52706,"PUSER, TIRTAYASA, SERANG, BANTEN",1,74,159,233
https://kawalpemilu.org#52706,"PUSER, TIRTAYASA, SERANG, BANTEN",2,93,162,255
https://kawalpemilu.org#52706,"PUSER, TIRTAYASA, SERANG, BANTEN",3,23,210,233
https://kawalpemilu.org#52706,"PUSER, TIRTAYASA, SERANG, BANTEN",4,15,162,177
https://kawalpemilu.org#52706,"PUSER, TIRTAYASA, SERANG, BANTEN",5,15,170,185
https://kawalpemilu.org#52706,"PUSER, TIRTAYASA, SERANG, BANTEN",6,45,171,216
https://kawalpemilu.org#52706,"PUSER, TIRTAYASA, SERANG, BANTEN",7,43,129,172
https://kawalpemilu.org#52706,"PUSER, TIRTAYASA, SERANG, BANTEN",8,14,183,197
https://kawalpemilu.org#52706,"PUSER, TIRTAYASA, SERANG, BANTEN",9,37,112,149
https://kawalpemilu.org#52708,"TANARA, TANARA, SERANG, BANTEN",1,111,96,207
https://kawalpemilu.org#52708,"TANARA, TANARA, SERANG, BANTEN",2,174,40,214
https://kawalpemilu.org#52708,"TANARA, TANARA, SERANG, BANTEN",3,124,78,202
https://kawalpemilu.org#52708,"TANARA, TANARA, SERANG, BANTEN",4,109,120,229
https://kawalpemilu.org#52708,"TANARA, TANARA, SERANG, BANTEN",5,136,82,218
https://kawalpemilu.org#52708,"TANARA, TANARA, SERANG, BANTEN",6,169,81,250
https://kawalpemilu.org#52708,"TANARA, TANARA, SERANG, BANTEN",7,124,113,237
https://kawalpemilu.org#52708,"TANARA, TANARA, SERANG, BANTEN",8,131,82,213
https://kawalpemilu.org#52709,"CERUKCUK, TANARA, SERANG, BANTEN",1,44,193,237
https://kawalpemilu.org#52709,"CERUKCUK, TANARA, SERANG, BANTEN",2,29,82,211
https://kawalpemilu.org#52709,"CERUKCUK, TANARA, SERANG, BANTEN",3,66,192,258
https://kawalpemilu.org#52709,"CERUKCUK, TANARA, SERANG, BANTEN",4,49,204,253
https://kawalpemilu.org#52709,"CERUKCUK, TANARA, SERANG, BANTEN",5,30,171,201
https://kawalpemilu.org#52709,"CERUKCUK, TANARA, SERANG, BANTEN",6,42,177,219
https://kawalpemilu.org#52709,"CERUKCUK, TANARA, SERANG, BANTEN",7,25,221,246
https://kawalpemilu.org#52709,"CERUKCUK, TANARA, SERANG, BANTEN",8,19,198,217
https://kawalpemilu.org#52709,"CERUKCUK, TANARA, SERANG, BANTEN",9,31,176,207
https://kawalpemilu.org#52709,"CERUKCUK, TANARA, SERANG, BANTEN",10,69,131,200
https://kawalpemilu.org#52709,"CERUKCUK, TANARA, SERANG, BANTEN",11,35,176,211
https://kawalpemilu.org#52709,"CERUKCUK, TANARA, SERANG, BANTEN",12,28,166,194
https://kawalpemilu.org#52709,"CERUKCUK, TANARA, SERANG, BANTEN",13,46,161,207
https://kawalpemilu.org#52710,"TENJOAYU, TANARA, SERANG, BANTEN",1,95,109,204
https://kawalpemilu.org#52710,"TENJOAYU, TANARA, SERANG, BANTEN",2,75,126,201
https://kawalpemilu.org#52710,"TENJOAYU, TANARA, SERANG, BANTEN",3,73,120,193
https://kawalpemilu.org#52710,"TENJOAYU, TANARA, SERANG, BANTEN",4,57,112,169
https://kawalpemilu.org#52710,"TENJOAYU, TANARA, SERANG, BANTEN",5,59,157,216
https://kawalpemilu.org#52710,"TENJOAYU, TANARA, SERANG, BANTEN",6,71,155,226
https://kawalpemilu.org#52710,"TENJOAYU, TANARA, SERANG, BANTEN",7,40,193,233
https://kawalpemilu.org#52710,"TENJOAYU, TANARA, SERANG, BANTEN",8,36,169,205
https://kawalpemilu.org#52710,"TENJOAYU, TANARA, SERANG, BANTEN",9,44,139,183
https://kawalpemilu.org#52710,"TENJOAYU, TANARA, SERANG, BANTEN",10,71,106,177
https://kawalpemilu.org#52710,"TENJOAYU, TANARA, SERANG, BANTEN",11,68,111,179
https://kawalpemilu.org#52710,"TENJOAYU, TANARA, SERANG, BANTEN",12,79,121,200
https://kawalpemilu.org#52710,"TENJOAYU, TANARA, SERANG, BANTEN",13,42,137,179
https://kawalpemilu.org#52710,"TENJOAYU, TANARA, SERANG, BANTEN",14,68,119,187
https://kawalpemilu.org#52711,"SUKAMANAH, TANARA, SERANG, BANTEN",2,92,152,244
https://kawalpemilu.org#52711,"SUKAMANAH, TANARA, SERANG, BANTEN",3,102,148,250
https://kawalpemilu.org#52711,"SUKAMANAH, TANARA, SERANG, BANTEN",4,106,171,277
https://kawalpemilu.org#52711,"SUKAMANAH, TANARA, SERANG, BANTEN",5,90,142,232
https://kawalpemilu.org#52711,"SUKAMANAH, TANARA, SERANG, BANTEN",6,94,129,223
https://kawalpemilu.org#52711,"SUKAMANAH, TANARA, SERANG, BANTEN",7,101,128,229
https://kawalpemilu.org#52711,"SUKAMANAH, TANARA, SERANG, BANTEN",8,107,88,195
https://kawalpemilu.org#52712,"LEMPUYANG, TANARA, SERANG, BANTEN",1,75,132,207
https://kawalpemilu.org#52712,"LEMPUYANG, TANARA, SERANG, BANTEN",2,47,171,218
https://kawalpemilu.org#52712,"LEMPUYANG, TANARA, SERANG, BANTEN",3,39,157,196
https://kawalpemilu.org#52712,"LEMPUYANG, TANARA, SERANG, BANTEN",4,29,200,229
https://kawalpemilu.org#52712,"LEMPUYANG, TANARA, SERANG, BANTEN",5,26,195,221
https://kawalpemilu.org#52712,"LEMPUYANG, TANARA, SERANG, BANTEN",6,34,203,237
https://kawalpemilu.org#52712,"LEMPUYANG, TANARA, SERANG, BANTEN",7,35,177,212
https://kawalpemilu.org#52712,"LEMPUYANG, TANARA, SERANG, BANTEN",8,38,180,218
https://kawalpemilu.org#52712,"LEMPUYANG, TANARA, SERANG, BANTEN",9,44,158,202
https://kawalpemilu.org#52712,"LEMPUYANG, TANARA, SERANG, BANTEN",10,43,184,227
https://kawalpemilu.org#52712,"LEMPUYANG, TANARA, SERANG, BANTEN",11,33,196,229
https://kawalpemilu.org#52712,"LEMPUYANG, TANARA, SERANG, BANTEN",12,29,190,219
https://kawalpemilu.org#52712,"LEMPUYANG, TANARA, SERANG, BANTEN",13,40,159,199
https://kawalpemilu.org#52712,"LEMPUYANG, TANARA, SERANG, BANTEN",14,33,174,207
https://kawalpemilu.org#52712,"LEMPUYANG, TANARA, SERANG, BANTEN",15,30,167,197
https://kawalpemilu.org#52712,"LEMPUYANG, TANARA, SERANG, BANTEN",16,20,190,210
https://kawalpemilu.org#52712,"LEMPUYANG, TANARA, SERANG, BANTEN",17,17,186,203
https://kawalpemilu.org#52712,"LEMPUYANG, TANARA, SERANG, BANTEN",18,15,213,228
https://kawalpemilu.org#52712,"LEMPUYANG, TANARA, SERANG, BANTEN",19,23,197,220
https://kawalpemilu.org#52713,"SIREMEN, TANARA, SERANG, BANTEN",1,33,193,226
https://kawalpemilu.org#52713,"SIREMEN, TANARA, SERANG, BANTEN",2,32,212,244
https://kawalpemilu.org#52713,"SIREMEN, TANARA, SERANG, BANTEN",4,7,239,246
https://kawalpemilu.org#52713,"SIREMEN, TANARA, SERANG, BANTEN",5,43,197,240
https://kawalpemilu.org#52713,"SIREMEN, TANARA, SERANG, BANTEN",6,29,197,226
https://kawalpemilu.org#52713,"SIREMEN, TANARA, SERANG, BANTEN",7,15,188,203
https://kawalpemilu.org#52713,"SIREMEN, TANARA, SERANG, BANTEN",8,24,225,249
https://kawalpemilu.org#52713,"SIREMEN, TANARA, SERANG, BANTEN",9,22,223,245
https://kawalpemilu.org#52713,"SIREMEN, TANARA, SERANG, BANTEN",10,14,168,182
https://kawalpemilu.org#52714,"BENDUNG, TANARA, SERANG, BANTEN",1,58,152,210
https://kawalpemilu.org#52714,"BENDUNG, TANARA, SERANG, BANTEN",2,66,138,204
https://kawalpemilu.org#52714,"BENDUNG, TANARA, SERANG, BANTEN",3,69,124,193
https://kawalpemilu.org#52714,"BENDUNG, TANARA, SERANG, BANTEN",4,70,126,196
https://kawalpemilu.org#52714,"BENDUNG, TANARA, SERANG, BANTEN",5,67,131,198
https://kawalpemilu.org#52714,"BENDUNG, TANARA, SERANG, BANTEN",6,51,170,221
https://kawalpemilu.org#52714,"BENDUNG, TANARA, SERANG, BANTEN",7,62,185,247
https://kawalpemilu.org#52714,"BENDUNG, TANARA, SERANG, BANTEN",8,55,196,251
https://kawalpemilu.org#52714,"BENDUNG, TANARA, SERANG, BANTEN",9,29,190,219
https://kawalpemilu.org#52714,"BENDUNG, TANARA, SERANG, BANTEN",10,29,183,212
https://kawalpemilu.org#52714,"BENDUNG, TANARA, SERANG, BANTEN",11,13,194,207
https://kawalpemilu.org#52714,"BENDUNG, TANARA, SERANG, BANTEN",12,27,177,204
https://kawalpemilu.org#52714,"BENDUNG, TANARA, SERANG, BANTEN",13,21,183,204
https://kawalpemilu.org#52714,"BENDUNG, TANARA, SERANG, BANTEN",14,18,155,173
https://kawalpemilu.org#52714,"BENDUNG, TANARA, SERANG, BANTEN",15,14,188,202
https://kawalpemilu.org#52714,"BENDUNG, TANARA, SERANG, BANTEN",16,8,139,147
https://kawalpemilu.org#52715,"PEDALEMAN, TANARA, SERANG, BANTEN",1,121,113,234
https://kawalpemilu.org#52715,"PEDALEMAN, TANARA, SERANG, BANTEN",2,89,133,222
https://kawalpemilu.org#52715,"PEDALEMAN, TANARA, SERANG, BANTEN",3,87,114,87
https://kawalpemilu.org#52715,"PEDALEMAN, TANARA, SERANG, BANTEN",4,79,136,215
https://kawalpemilu.org#52715,"PEDALEMAN, TANARA, SERANG, BANTEN",5,95,150,245
https://kawalpemilu.org#52715,"PEDALEMAN, TANARA, SERANG, BANTEN",6,134,121,255
https://kawalpemilu.org#52715,"PEDALEMAN, TANARA, SERANG, BANTEN",7,119,128,247
https://kawalpemilu.org#52715,"PEDALEMAN, TANARA, SERANG, BANTEN",8,123,71,194
https://kawalpemilu.org#52715,"PEDALEMAN, TANARA, SERANG, BANTEN",9,124,89,213
https://kawalpemilu.org#52715,"PEDALEMAN, TANARA, SERANG, BANTEN",10,136,85,221
https://kawalpemilu.org#52715,"PEDALEMAN, TANARA, SERANG, BANTEN",11,103,107,210
https://kawalpemilu.org#52715,"PEDALEMAN, TANARA, SERANG, BANTEN",12,99,97,196
https://kawalpemilu.org#52715,"PEDALEMAN, TANARA, SERANG, BANTEN",13,82,124,206
https://kawalpemilu.org#52715,"PEDALEMAN, TANARA, SERANG, BANTEN",14,104,105,209
https://kawalpemilu.org#52715,"PEDALEMAN, TANARA, SERANG, BANTEN",15,93,137,230
https://kawalpemilu.org#52715,"PEDALEMAN, TANARA, SERANG, BANTEN",16,108,123,231
https://kawalpemilu.org#52716,"CIBODAS, TANARA, SERANG, BANTEN",1,10,234,244
https://kawalpemilu.org#52716,"CIBODAS, TANARA, SERANG, BANTEN",2,14,205,219
https://kawalpemilu.org#52716,"CIBODAS, TANARA, SERANG, BANTEN",3,20,177,197
https://kawalpemilu.org#52716,"CIBODAS, TANARA, SERANG, BANTEN",4,16,151,167
https://kawalpemilu.org#52716,"CIBODAS, TANARA, SERANG, BANTEN",5,12,159,171
https://kawalpemilu.org#52716,"CIBODAS, TANARA, SERANG, BANTEN",6,7,186,193
https://kawalpemilu.org#52716,"CIBODAS, TANARA, SERANG, BANTEN",7,12,168,180
https://kawalpemilu.org#52716,"CIBODAS, TANARA, SERANG, BANTEN",8,32,186,218
https://kawalpemilu.org#52716,"CIBODAS, TANARA, SERANG, BANTEN",9,26,170,196
https://kawalpemilu.org#52716,"CIBODAS, TANARA, SERANG, BANTEN",10,77,139,216
https://kawalpemilu.org#52716,"CIBODAS, TANARA, SERANG, BANTEN",11,26,163,189
https://kawalpemilu.org#52716,"CIBODAS, TANARA, SERANG, BANTEN",12,33,197,230
https://kawalpemilu.org#52716,"CIBODAS, TANARA, SERANG, BANTEN",13,42,136,178
https://kawalpemilu.org#52718,"CIKANDE, CIKANDE, SERANG, BANTEN",1,66,162,228
https://kawalpemilu.org#52718,"CIKANDE, CIKANDE, SERANG, BANTEN",2,58,136,194
https://kawalpemilu.org#52718,"CIKANDE, CIKANDE, SERANG, BANTEN",3,66,168,234
https://kawalpemilu.org#52718,"CIKANDE, CIKANDE, SERANG, BANTEN",4,87,130,217
https://kawalpemilu.org#52718,"CIKANDE, CIKANDE, SERANG, BANTEN",5,94,152,246
https://kawalpemilu.org#52718,"CIKANDE, CIKANDE, SERANG, BANTEN",6,67,150,217
https://kawalpemilu.org#52718,"CIKANDE, CIKANDE, SERANG, BANTEN",7,56,179,235
https://kawalpemilu.org#52718,"CIKANDE, CIKANDE, SERANG, BANTEN",8,30,237,267
https://kawalpemilu.org#52718,"CIKANDE, CIKANDE, SERANG, BANTEN",10,39,194,233
https://kawalpemilu.org#52718,"CIKANDE, CIKANDE, SERANG, BANTEN",11,71,192,263
https://kawalpemilu.org#52718,"CIKANDE, CIKANDE, SERANG, BANTEN",12,86,153,239
https://kawalpemilu.org#52718,"CIKANDE, CIKANDE, SERANG, BANTEN",13,75,157,232
https://kawalpemilu.org#52718,"CIKANDE, CIKANDE, SERANG, BANTEN",14,43,242,285
https://kawalpemilu.org#52718,"CIKANDE, CIKANDE, SERANG, BANTEN",15,124,98,222
https://kawalpemilu.org#52718,"CIKANDE, CIKANDE, SERANG, BANTEN",16,46,183,229
https://kawalpemilu.org#52718,"CIKANDE, CIKANDE, SERANG, BANTEN",17,57,194,251
https://kawalpemilu.org#52718,"CIKANDE, CIKANDE, SERANG, BANTEN",18,105,139,244
https://kawalpemilu.org#52718,"CIKANDE, CIKANDE, SERANG, BANTEN",19,95,95,190
https://kawalpemilu.org#52718,"CIKANDE, CIKANDE, SERANG, BANTEN",20,76,134,210
https://kawalpemilu.org#52718,"CIKANDE, CIKANDE, SERANG, BANTEN",21,109,120,229
https://kawalpemilu.org#52718,"CIKANDE, CIKANDE, SERANG, BANTEN",22,83,119,202
https://kawalpemilu.org#52718,"CIKANDE, CIKANDE, SERANG, BANTEN",23,121,138,259
https://kawalpemilu.org#52718,"CIKANDE, CIKANDE, SERANG, BANTEN",24,90,110,200
https://kawalpemilu.org#52718,"CIKANDE, CIKANDE, SERANG, BANTEN",25,97,132,229
https://kawalpemilu.org#52718,"CIKANDE, CIKANDE, SERANG, BANTEN",26,53,154,207
https://kawalpemilu.org#52718,"CIKANDE, CIKANDE, SERANG, BANTEN",27,66,104,170
https://kawalpemilu.org#52718,"CIKANDE, CIKANDE, SERANG, BANTEN",28,89,197,286
https://kawalpemilu.org#52718,"CIKANDE, CIKANDE, SERANG, BANTEN",29,88,167,255
https://kawalpemilu.org#52718,"CIKANDE, CIKANDE, SERANG, BANTEN",30,81,166,247
https://kawalpemilu.org#52718,"CIKANDE, CIKANDE, SERANG, BANTEN",31,106,121,227
https://kawalpemilu.org#52718,"CIKANDE, CIKANDE, SERANG, BANTEN",32,147,120,267
https://kawalpemilu.org#52718,"CIKANDE, CIKANDE, SERANG, BANTEN",33,93,105,198
https://kawalpemilu.org#52718,"CIKANDE, CIKANDE, SERANG, BANTEN",34,95,120,215
https://kawalpemilu.org#52718,"CIKANDE, CIKANDE, SERANG, BANTEN",35,82,134,216
https://kawalpemilu.org#52718,"CIKANDE, CIKANDE, SERANG, BANTEN",36,96,140,236
https://kawalpemilu.org#52718,"CIKANDE, CIKANDE, SERANG, BANTEN",37,88,128,216
https://kawalpemilu.org#52718,"CIKANDE, CIKANDE, SERANG, BANTEN",38,100,105,205
https://kawalpemilu.org#52718,"CIKANDE, CIKANDE, SERANG, BANTEN",39,114,90,204
https://kawalpemilu.org#52718,"CIKANDE, CIKANDE, SERANG, BANTEN",40,122,114,236
https://kawalpemilu.org#52718,"CIKANDE, CIKANDE, SERANG, BANTEN",41,113,118,231
https://kawalpemilu.org#52718,"CIKANDE, CIKANDE, SERANG, BANTEN",42,122,151,273
https://kawalpemilu.org#52718,"CIKANDE, CIKANDE, SERANG, BANTEN",43,105,115,220
https://kawalpemilu.org#52718,"CIKANDE, CIKANDE, SERANG, BANTEN",44,142,107,249
https://kawalpemilu.org#52718,"CIKANDE, CIKANDE, SERANG, BANTEN",45,99,101,200
https://kawalpemilu.org#52718,"CIKANDE, CIKANDE, SERANG, BANTEN",46,76,101,177
https://kawalpemilu.org#52718,"CIKANDE, CIKANDE, SERANG, BANTEN",47,54,133,187
https://kawalpemilu.org#52718,"CIKANDE, CIKANDE, SERANG, BANTEN",48,63,102,165
https://kawalpemilu.org#52718,"CIKANDE, CIKANDE, SERANG, BANTEN",49,86,105,191
https://kawalpemilu.org#52718,"CIKANDE, CIKANDE, SERANG, BANTEN",50,76,132,208
https://kawalpemilu.org#52718,"CIKANDE, CIKANDE, SERANG, BANTEN",51,89,71,0
https://kawalpemilu.org#52718,"CIKANDE, CIKANDE, SERANG, BANTEN",52,70,129,199
https://kawalpemilu.org#52718,"CIKANDE, CIKANDE, SERANG, BANTEN",53,68,35,103
https://kawalpemilu.org#52719,"LEUWI LIMUS, CIKANDE, SERANG, BANTEN",1,63,154,217
https://kawalpemilu.org#52719,"LEUWI LIMUS, CIKANDE, SERANG, BANTEN",2,19,168,187
https://kawalpemilu.org#52719,"LEUWI LIMUS, CIKANDE, SERANG, BANTEN",3,46,78,124
https://kawalpemilu.org#52719,"LEUWI LIMUS, CIKANDE, SERANG, BANTEN",4,61,112,173
https://kawalpemilu.org#52719,"LEUWI LIMUS, CIKANDE, SERANG, BANTEN",5,41,143,184
https://kawalpemilu.org#52719,"LEUWI LIMUS, CIKANDE, SERANG, BANTEN",6,47,202,249
https://kawalpemilu.org#52719,"LEUWI LIMUS, CIKANDE, SERANG, BANTEN",7,61,198,259
https://kawalpemilu.org#52719,"LEUWI LIMUS, CIKANDE, SERANG, BANTEN",8,43,182,225
https://kawalpemilu.org#52719,"LEUWI LIMUS, CIKANDE, SERANG, BANTEN",9,51,163,214
https://kawalpemilu.org#52719,"LEUWI LIMUS, CIKANDE, SERANG, BANTEN",10,57,212,269
https://kawalpemilu.org#52719,"LEUWI LIMUS, CIKANDE, SERANG, BANTEN",11,31,180,211
https://kawalpemilu.org#52719,"LEUWI LIMUS, CIKANDE, SERANG, BANTEN",12,35,149,184
https://kawalpemilu.org#52719,"LEUWI LIMUS, CIKANDE, SERANG, BANTEN",13,40,172,212
https://kawalpemilu.org#52719,"LEUWI LIMUS, CIKANDE, SERANG, BANTEN",14,53,167,220
https://kawalpemilu.org#52719,"LEUWI LIMUS, CIKANDE, SERANG, BANTEN",15,115,98,213
https://kawalpemilu.org#52719,"LEUWI LIMUS, CIKANDE, SERANG, BANTEN",16,68,155,223
https://kawalpemilu.org#52719,"LEUWI LIMUS, CIKANDE, SERANG, BANTEN",17,50,152,202
https://kawalpemilu.org#52719,"LEUWI LIMUS, CIKANDE, SERANG, BANTEN",18,33,175,208
https://kawalpemilu.org#52719,"LEUWI LIMUS, CIKANDE, SERANG, BANTEN",19,36,156,192
https://kawalpemilu.org#52720,"NAMBO UDIK, CIKANDE, SERANG, BANTEN",1,86,171,257
https://kawalpemilu.org#52720,"NAMBO UDIK, CIKANDE, SERANG, BANTEN",2,48,157,205
https://kawalpemilu.org#52720,"NAMBO UDIK, CIKANDE, SERANG, BANTEN",3,76,148,224
https://kawalpemilu.org#52720,"NAMBO UDIK, CIKANDE, SERANG, BANTEN",4,58,191,249
https://kawalpemilu.org#52720,"NAMBO UDIK, CIKANDE, SERANG, BANTEN",5,47,180,227
https://kawalpemilu.org#52720,"NAMBO UDIK, CIKANDE, SERANG, BANTEN",6,61,163,224
https://kawalpemilu.org#52720,"NAMBO UDIK, CIKANDE, SERANG, BANTEN",7,87,134,221
https://kawalpemilu.org#52720,"NAMBO UDIK, CIKANDE, SERANG, BANTEN",8,79,112,9
https://kawalpemilu.org#52720,"NAMBO UDIK, CIKANDE, SERANG, BANTEN",9,54,175,229
https://kawalpemilu.org#52720,"NAMBO UDIK, CIKANDE, SERANG, BANTEN",10,50,205,255
https://kawalpemilu.org#52720,"NAMBO UDIK, CIKANDE, SERANG, BANTEN",11,52,164,216
https://kawalpemilu.org#52720,"NAMBO UDIK, CIKANDE, SERANG, BANTEN",12,78,166,244
https://kawalpemilu.org#52720,"NAMBO UDIK, CIKANDE, SERANG, BANTEN",13,32,220,252
https://kawalpemilu.org#52720,"NAMBO UDIK, CIKANDE, SERANG, BANTEN",14,51,178,229
https://kawalpemilu.org#52720,"NAMBO UDIK, CIKANDE, SERANG, BANTEN",15,60,186,246
https://kawalpemilu.org#52721,"PARIGI, CIKANDE, SERANG, BANTEN",1,36,193,229
https://kawalpemilu.org#52721,"PARIGI, CIKANDE, SERANG, BANTEN",2,44,195,239
https://kawalpemilu.org#52721,"PARIGI, CIKANDE, SERANG, BANTEN",3,58,181,239
https://kawalpemilu.org#52721,"PARIGI, CIKANDE, SERANG, BANTEN",4,38,212,250
https://kawalpemilu.org#52721,"PARIGI, CIKANDE, SERANG, BANTEN",5,65,180,245
https://kawalpemilu.org#52721,"PARIGI, CIKANDE, SERANG, BANTEN",6,53,185,238
https://kawalpemilu.org#52721,"PARIGI, CIKANDE, SERANG, BANTEN",7,45,181,226
https://kawalpemilu.org#52721,"PARIGI, CIKANDE, SERANG, BANTEN",8,39,187,226
https://kawalpemilu.org#52721,"PARIGI, CIKANDE, SERANG, BANTEN",9,41,193,234
https://kawalpemilu.org#52721,"PARIGI, CIKANDE, SERANG, BANTEN",10,55,156,211
https://kawalpemilu.org#52721,"PARIGI, CIKANDE, SERANG, BANTEN",11,93,123,216
https://kawalpemilu.org#52721,"PARIGI, CIKANDE, SERANG, BANTEN",12,81,149,230
https://kawalpemilu.org#52721,"PARIGI, CIKANDE, SERANG, BANTEN",13,85,167,252
https://kawalpemilu.org#52721,"PARIGI, CIKANDE, SERANG, BANTEN",14,52,159,211
https://kawalpemilu.org#52721,"PARIGI, CIKANDE, SERANG, BANTEN",15,62,146,208
https://kawalpemilu.org#52721,"PARIGI, CIKANDE, SERANG, BANTEN",16,52,152,204
https://kawalpemilu.org#52721,"PARIGI, CIKANDE, SERANG, BANTEN",17,55,161,216
https://kawalpemilu.org#52721,"PARIGI, CIKANDE, SERANG, BANTEN",18,112,106,218
https://kawalpemilu.org#52721,"PARIGI, CIKANDE, SERANG, BANTEN",19,63,150,213
https://kawalpemilu.org#52721,"PARIGI, CIKANDE, SERANG, BANTEN",20,56,125,181
https://kawalpemilu.org#52721,"PARIGI, CIKANDE, SERANG, BANTEN",21,97,142,239
https://kawalpemilu.org#52721,"PARIGI, CIKANDE, SERANG, BANTEN",22,123,112,235
https://kawalpemilu.org#52721,"PARIGI, CIKANDE, SERANG, BANTEN",23,46,162,208
https://kawalpemilu.org#52721,"PARIGI, CIKANDE, SERANG, BANTEN",24,59,152,211
https://kawalpemilu.org#52722,"KOPER, CIKANDE, SERANG, BANTEN",1,73,119,192
https://kawalpemilu.org#52722,"KOPER, CIKANDE, SERANG, BANTEN",2,82,139,221
https://kawalpemilu.org#52722,"KOPER, CIKANDE, SERANG, BANTEN",3,68,155,223
https://kawalpemilu.org#52722,"KOPER, CIKANDE, SERANG, BANTEN",4,109,120,229
https://kawalpemilu.org#52722,"KOPER, CIKANDE, SERANG, BANTEN",5,86,88,174
https://kawalpemilu.org#52722,"KOPER, CIKANDE, SERANG, BANTEN",6,65,168,233
https://kawalpemilu.org#52722,"KOPER, CIKANDE, SERANG, BANTEN",7,89,119,208
https://kawalpemilu.org#52722,"KOPER, CIKANDE, SERANG, BANTEN",8,61,85,146
https://kawalpemilu.org#52722,"KOPER, CIKANDE, SERANG, BANTEN",9,102,116,218
https://kawalpemilu.org#52722,"KOPER, CIKANDE, SERANG, BANTEN",11,69,155,224
https://kawalpemilu.org#52722,"KOPER, CIKANDE, SERANG, BANTEN",12,65,127,192
https://kawalpemilu.org#52722,"KOPER, CIKANDE, SERANG, BANTEN",13,66,111,177
https://kawalpemilu.org#52722,"KOPER, CIKANDE, SERANG, BANTEN",14,153,78,231
https://kawalpemilu.org#52722,"KOPER, CIKANDE, SERANG, BANTEN",15,115,98,213
https://kawalpemilu.org#52722,"KOPER, CIKANDE, SERANG, BANTEN",16,117,69,186
https://kawalpemilu.org#52722,"KOPER, CIKANDE, SERANG, BANTEN",17,135,94,229
https://kawalpemilu.org#52722,"KOPER, CIKANDE, SERANG, BANTEN",18,106,136,242
https://kawalpemilu.org#52722,"KOPER, CIKANDE, SERANG, BANTEN",19,50,162,212
https://kawalpemilu.org#52722,"KOPER, CIKANDE, SERANG, BANTEN",20,48,167,215
https://kawalpemilu.org#52723,"BAKUNG, CIKANDE, SERANG, BANTEN",1,79,166,245
https://kawalpemilu.org#52723,"BAKUNG, CIKANDE, SERANG, BANTEN",2,65,154,219
https://kawalpemilu.org#52723,"BAKUNG, CIKANDE, SERANG, BANTEN",3,136,90,226
https://kawalpemilu.org#52723,"BAKUNG, CIKANDE, SERANG, BANTEN",4,86,163,249
https://kawalpemilu.org#52723,"BAKUNG, CIKANDE, SERANG, BANTEN",5,38,201,239
https://kawalpemilu.org#52723,"BAKUNG, CIKANDE, SERANG, BANTEN",6,89,144,233
https://kawalpemilu.org#52723,"BAKUNG, CIKANDE, SERANG, BANTEN",7,103,122,225
https://kawalpemilu.org#52723,"BAKUNG, CIKANDE, SERANG, BANTEN",8,71,145,216
https://kawalpemilu.org#52723,"BAKUNG, CIKANDE, SERANG, BANTEN",9,76,135,211
https://kawalpemilu.org#52723,"BAKUNG, CIKANDE, SERANG, BANTEN",10,90,132,222
https://kawalpemilu.org#52723,"BAKUNG, CIKANDE, SERANG, BANTEN",11,99,113,212
https://kawalpemilu.org#52723,"BAKUNG, CIKANDE, SERANG, BANTEN",12,58,185,243
https://kawalpemilu.org#52723,"BAKUNG, CIKANDE, SERANG, BANTEN",13,89,153,242
https://kawalpemilu.org#52723,"BAKUNG, CIKANDE, SERANG, BANTEN",14,117,116,233
https://kawalpemilu.org#52723,"BAKUNG, CIKANDE, SERANG, BANTEN",15,61,171,232
https://kawalpemilu.org#52723,"BAKUNG, CIKANDE, SERANG, BANTEN",16,74,154,233
https://kawalpemilu.org#52724,"JULANG, CIKANDE, SERANG, BANTEN",1,36,185,221
https://kawalpemilu.org#52724,"JULANG, CIKANDE, SERANG, BANTEN",2,58,187,245
https://kawalpemilu.org#52724,"JULANG, CIKANDE, SERANG, BANTEN",3,32,220,252
https://kawalpemilu.org#52724,"JULANG, CIKANDE, SERANG, BANTEN",4,43,162,205
https://kawalpemilu.org#52724,"JULANG, CIKANDE, SERANG, BANTEN",5,57,166,223
https://kawalpemilu.org#52724,"JULANG, CIKANDE, SERANG, BANTEN",6,78,165,243
https://kawalpemilu.org#52724,"JULANG, CIKANDE, SERANG, BANTEN",7,57,190,247
https://kawalpemilu.org#52724,"JULANG, CIKANDE, SERANG, BANTEN",8,75,176,251
https://kawalpemilu.org#52724,"JULANG, CIKANDE, SERANG, BANTEN",9,74,107,181
https://kawalpemilu.org#52724,"JULANG, CIKANDE, SERANG, BANTEN",10,32,190,222
https://kawalpemilu.org#52724,"JULANG, CIKANDE, SERANG, BANTEN",11,85,104,189
https://kawalpemilu.org#52724,"JULANG, CIKANDE, SERANG, BANTEN",12,44,180,224
https://kawalpemilu.org#52724,"JULANG, CIKANDE, SERANG, BANTEN",13,72,150,222
https://kawalpemilu.org#52724,"JULANG, CIKANDE, SERANG, BANTEN",14,93,164,257
https://kawalpemilu.org#52724,"JULANG, CIKANDE, SERANG, BANTEN",15,88,161,249
https://kawalpemilu.org#52724,"JULANG, CIKANDE, SERANG, BANTEN",16,101,107,208
https://kawalpemilu.org#52724,"JULANG, CIKANDE, SERANG, BANTEN",17,66,170,236
https://kawalpemilu.org#52724,"JULANG, CIKANDE, SERANG, BANTEN",18,91,156,247
https://kawalpemilu.org#52724,"JULANG, CIKANDE, SERANG, BANTEN",19,77,120,197
https://kawalpemilu.org#52724,"JULANG, CIKANDE, SERANG, BANTEN",20,62,141,203
https://kawalpemilu.org#52725,"SUKATANI, CIKANDE, SERANG, BANTEN",1,31,222,253
https://kawalpemilu.org#52725,"SUKATANI, CIKANDE, SERANG, BANTEN",2,41,199,240
https://kawalpemilu.org#52725,"SUKATANI, CIKANDE, SERANG, BANTEN",3,39,217,256
https://kawalpemilu.org#52725,"SUKATANI, CIKANDE, SERANG, BANTEN",4,25,226,251
https://kawalpemilu.org#52725,"SUKATANI, CIKANDE, SERANG, BANTEN",5,50,196,246
https://kawalpemilu.org#52725,"SUKATANI, CIKANDE, SERANG, BANTEN",6,56,160,216
https://kawalpemilu.org#52725,"SUKATANI, CIKANDE, SERANG, BANTEN",7,78,131,209
https://kawalpemilu.org#52725,"SUKATANI, CIKANDE, SERANG, BANTEN",8,56,180,236
https://kawalpemilu.org#52725,"SUKATANI, CIKANDE, SERANG, BANTEN",9,35,164,199
https://kawalpemilu.org#52725,"SUKATANI, CIKANDE, SERANG, BANTEN",10,57,182,239
https://kawalpemilu.org#52725,"SUKATANI, CIKANDE, SERANG, BANTEN",11,67,146,213
https://kawalpemilu.org#52725,"SUKATANI, CIKANDE, SERANG, BANTEN",12,104,120,224
https://kawalpemilu.org#52726,"SITUTERATE, CIKANDE, SERANG, BANTEN",1,99,175,274
https://kawalpemilu.org#52726,"SITUTERATE, CIKANDE, SERANG, BANTEN",2,119,120,239
https://kawalpemilu.org#52726,"SITUTERATE, CIKANDE, SERANG, BANTEN",3,86,177,263
https://kawalpemilu.org#52726,"SITUTERATE, CIKANDE, SERANG, BANTEN",4,131,160,291
https://kawalpemilu.org#52726,"SITUTERATE, CIKANDE, SERANG, BANTEN",5,92,170,262
https://kawalpemilu.org#52726,"SITUTERATE, CIKANDE, SERANG, BANTEN",6,102,141,243
https://kawalpemilu.org#52726,"SITUTERATE, CIKANDE, SERANG, BANTEN",7,72,174,246
https://kawalpemilu.org#52726,"SITUTERATE, CIKANDE, SERANG, BANTEN",8,75,178,253
https://kawalpemilu.org#52726,"SITUTERATE, CIKANDE, SERANG, BANTEN",9,54,195,249
https://kawalpemilu.org#52726,"SITUTERATE, CIKANDE, SERANG, BANTEN",10,98,137,235
https://kawalpemilu.org#52726,"SITUTERATE, CIKANDE, SERANG, BANTEN",11,72,188,265
https://kawalpemilu.org#52726,"SITUTERATE, CIKANDE, SERANG, BANTEN",12,73,182,255
https://kawalpemilu.org#52726,"SITUTERATE, CIKANDE, SERANG, BANTEN",13,117,153,270
https://kawalpemilu.org#52726,"SITUTERATE, CIKANDE, SERANG, BANTEN",14,113,144,257
https://kawalpemilu.org#52726,"SITUTERATE, CIKANDE, SERANG, BANTEN",15,127,119,246
https://kawalpemilu.org#52726,"SITUTERATE, CIKANDE, SERANG, BANTEN",16,108,143,251
https://kawalpemilu.org#52726,"SITUTERATE, CIKANDE, SERANG, BANTEN",17,117,95,212
https://kawalpemilu.org#52727,"KAMURANG, CIKANDE, SERANG, BANTEN",1,182,55,237
https://kawalpemilu.org#52727,"KAMURANG, CIKANDE, SERANG, BANTEN",2,74,128,202
https://kawalpemilu.org#52727,"KAMURANG, CIKANDE, SERANG, BANTEN",3,73,138,211
https://kawalpemilu.org#52727,"KAMURANG, CIKANDE, SERANG, BANTEN",4,76,102,178
https://kawalpemilu.org#52727,"KAMURANG, CIKANDE, SERANG, BANTEN",5,32,176,208
https://kawalpemilu.org#52727,"KAMURANG, CIKANDE, SERANG, BANTEN",6,60,130,190
https://kawalpemilu.org#52727,"KAMURANG, CIKANDE, SERANG, BANTEN",7,53,173,226
https://kawalpemilu.org#52727,"KAMURANG, CIKANDE, SERANG, BANTEN",8,101,122,223
https://kawalpemilu.org#52727,"KAMURANG, CIKANDE, SERANG, BANTEN",9,100,127,227
https://kawalpemilu.org#52727,"KAMURANG, CIKANDE, SERANG, BANTEN",10,81,120,201
https://kawalpemilu.org#52727,"KAMURANG, CIKANDE, SERANG, BANTEN",11,38,185,223
https://kawalpemilu.org#52727,"KAMURANG, CIKANDE, SERANG, BANTEN",12,57,164,221
https://kawalpemilu.org#52727,"KAMURANG, CIKANDE, SERANG, BANTEN",13,75,97,172
https://kawalpemilu.org#52727,"KAMURANG, CIKANDE, SERANG, BANTEN",14,53,126,179
https://kawalpemilu.org#52728,"GEMBOR UDIK, CIKANDE, SERANG, BANTEN",1,48,182,230
https://kawalpemilu.org#52728,"GEMBOR UDIK, CIKANDE, SERANG, BANTEN",2,55,168,223
https://kawalpemilu.org#52728,"GEMBOR UDIK, CIKANDE, SERANG, BANTEN",3,43,194,237
https://kawalpemilu.org#52728,"GEMBOR UDIK, CIKANDE, SERANG, BANTEN",4,53,199,252
https://kawalpemilu.org#52728,"GEMBOR UDIK, CIKANDE, SERANG, BANTEN",5,66,168,234
https://kawalpemilu.org#52728,"GEMBOR UDIK, CIKANDE, SERANG, BANTEN",6,41,160,201
https://kawalpemilu.org#52728,"GEMBOR UDIK, CIKANDE, SERANG, BANTEN",7,47,159,206
https://kawalpemilu.org#52728,"GEMBOR UDIK, CIKANDE, SERANG, BANTEN",8,43,167,210
https://kawalpemilu.org#52728,"GEMBOR UDIK, CIKANDE, SERANG, BANTEN",9,38,181,219
https://kawalpemilu.org#52728,"GEMBOR UDIK, CIKANDE, SERANG, BANTEN",10,34,163,197
https://kawalpemilu.org#52728,"GEMBOR UDIK, CIKANDE, SERANG, BANTEN",11,71,155,226
https://kawalpemilu.org#52728,"GEMBOR UDIK, CIKANDE, SERANG, BANTEN",12,42,168,210
https://kawalpemilu.org#52728,"GEMBOR UDIK, CIKANDE, SERANG, BANTEN",13,30,134,164
https://kawalpemilu.org#52728,"GEMBOR UDIK, CIKANDE, SERANG, BANTEN",14,63,171,234
https://kawalpemilu.org#52728,"GEMBOR UDIK, CIKANDE, SERANG, BANTEN",15,41,150,191
https://kawalpemilu.org#52729,"SONGGOMJAYA, CIKANDE, SERANG, BANTEN",1,104,111,215
https://kawalpemilu.org#52729,"SONGGOMJAYA, CIKANDE, SERANG, BANTEN",2,84,117,201
https://kawalpemilu.org#52729,"SONGGOMJAYA, CIKANDE, SERANG, BANTEN",3,62,147,209
https://kawalpemilu.org#52729,"SONGGOMJAYA, CIKANDE, SERANG, BANTEN",4,63,127,190
https://kawalpemilu.org#52729,"SONGGOMJAYA, CIKANDE, SERANG, BANTEN",5,125,99,224
https://kawalpemilu.org#52729,"SONGGOMJAYA, CIKANDE, SERANG, BANTEN",6,78,148,226
https://kawalpemilu.org#52729,"SONGGOMJAYA, CIKANDE, SERANG, BANTEN",7,64,148,212
https://kawalpemilu.org#52729,"SONGGOMJAYA, CIKANDE, SERANG, BANTEN",8,57,173,230
https://kawalpemilu.org#52729,"SONGGOMJAYA, CIKANDE, SERANG, BANTEN",9,64,141,205
https://kawalpemilu.org#52729,"SONGGOMJAYA, CIKANDE, SERANG, BANTEN",10,66,147,213
https://kawalpemilu.org#52729,"SONGGOMJAYA, CIKANDE, SERANG, BANTEN",11,91,116,207
https://kawalpemilu.org#52729,"SONGGOMJAYA, CIKANDE, SERANG, BANTEN",12,117,104,221
https://kawalpemilu.org#52729,"SONGGOMJAYA, CIKANDE, SERANG, BANTEN",13,89,118,207
https://kawalpemilu.org#89640,"CIKANDE PERMAI, CIKANDE, SERANG, BANTEN",1,111,118,229
https://kawalpemilu.org#89640,"CIKANDE PERMAI, CIKANDE, SERANG, BANTEN",2,124,156,280
https://kawalpemilu.org#89640,"CIKANDE PERMAI, CIKANDE, SERANG, BANTEN",3,113,127,240
https://kawalpemilu.org#89640,"CIKANDE PERMAI, CIKANDE, SERANG, BANTEN",4,92,136,228
https://kawalpemilu.org#89640,"CIKANDE PERMAI, CIKANDE, SERANG, BANTEN",5,78,117,195
https://kawalpemilu.org#89640,"CIKANDE PERMAI, CIKANDE, SERANG, BANTEN",6,113,158,271
https://kawalpemilu.org#89640,"CIKANDE PERMAI, CIKANDE, SERANG, BANTEN",7,98,135,233
https://kawalpemilu.org#89640,"CIKANDE PERMAI, CIKANDE, SERANG, BANTEN",8,80,107,187
https://kawalpemilu.org#89640,"CIKANDE PERMAI, CIKANDE, SERANG, BANTEN",9,67,107,174
https://kawalpemilu.org#89640,"CIKANDE PERMAI, CIKANDE, SERANG, BANTEN",10,103,122,225
https://kawalpemilu.org#89640,"CIKANDE PERMAI, CIKANDE, SERANG, BANTEN",11,48,145,193
https://kawalpemilu.org#89640,"CIKANDE PERMAI, CIKANDE, SERANG, BANTEN",12,57,141,198
https://kawalpemilu.org#89640,"CIKANDE PERMAI, CIKANDE, SERANG, BANTEN",13,45,168,213
https://kawalpemilu.org#89640,"CIKANDE PERMAI, CIKANDE, SERANG, BANTEN",14,108,164,272
https://kawalpemilu.org#89640,"CIKANDE PERMAI, CIKANDE, SERANG, BANTEN",15,77,103,180
https://kawalpemilu.org#89640,"CIKANDE PERMAI, CIKANDE, SERANG, BANTEN",16,92,129,221
https://kawalpemilu.org#89640,"CIKANDE PERMAI, CIKANDE, SERANG, BANTEN",17,144,127,271
https://kawalpemilu.org#89640,"CIKANDE PERMAI, CIKANDE, SERANG, BANTEN",18,116,140,256
https://kawalpemilu.org#89640,"CIKANDE PERMAI, CIKANDE, SERANG, BANTEN",19,105,107,212
https://kawalpemilu.org#89640,"CIKANDE PERMAI, CIKANDE, SERANG, BANTEN",20,68,148,216
https://kawalpemilu.org#89640,"CIKANDE PERMAI, CIKANDE, SERANG, BANTEN",21,111,140,251
https://kawalpemilu.org#89640,"CIKANDE PERMAI, CIKANDE, SERANG, BANTEN",22,72,177,249
https://kawalpemilu.org#89640,"CIKANDE PERMAI, CIKANDE, SERANG, BANTEN",23,76,136,212
https://kawalpemilu.org#89640,"CIKANDE PERMAI, CIKANDE, SERANG, BANTEN",24,98,133,231
https://kawalpemilu.org#89640,"CIKANDE PERMAI, CIKANDE, SERANG, BANTEN",25,125,128,253
https://kawalpemilu.org#89640,"CIKANDE PERMAI, CIKANDE, SERANG, BANTEN",26,110,103,213
https://kawalpemilu.org#89640,"CIKANDE PERMAI, CIKANDE, SERANG, BANTEN",27,108,116,224
https://kawalpemilu.org#89640,"CIKANDE PERMAI, CIKANDE, SERANG, BANTEN",28,92,112,204
https://kawalpemilu.org#89640,"CIKANDE PERMAI, CIKANDE, SERANG, BANTEN",29,130,68,198
https://kawalpemilu.org#89640,"CIKANDE PERMAI, CIKANDE, SERANG, BANTEN",30,121,109,230
https://kawalpemilu.org#89640,"CIKANDE PERMAI, CIKANDE, SERANG, BANTEN",31,123,88,211
https://kawalpemilu.org#89640,"CIKANDE PERMAI, CIKANDE, SERANG, BANTEN",32,81,115,196
https://kawalpemilu.org#89640,"CIKANDE PERMAI, CIKANDE, SERANG, BANTEN",33,113,122,235
https://kawalpemilu.org#89640,"CIKANDE PERMAI, CIKANDE, SERANG, BANTEN",34,118,130,1
https://kawalpemilu.org#89640,"CIKANDE PERMAI, CIKANDE, SERANG, BANTEN",35,86,123,209
https://kawalpemilu.org#89640,"CIKANDE PERMAI, CIKANDE, SERANG, BANTEN",36,93,104,197
https://kawalpemilu.org#89640,"CIKANDE PERMAI, CIKANDE, SERANG, BANTEN",37,114,137,251
https://kawalpemilu.org#89640,"CIKANDE PERMAI, CIKANDE, SERANG, BANTEN",38,102,141,243
https://kawalpemilu.org#89640,"CIKANDE PERMAI, CIKANDE, SERANG, BANTEN",39,87,162,249
https://kawalpemilu.org#89640,"CIKANDE PERMAI, CIKANDE, SERANG, BANTEN",40,99,121,220
https://kawalpemilu.org#89640,"CIKANDE PERMAI, CIKANDE, SERANG, BANTEN",41,93,105,198
https://kawalpemilu.org#89640,"CIKANDE PERMAI, CIKANDE, SERANG, BANTEN",42,74,115,189
https://kawalpemilu.org#89640,"CIKANDE PERMAI, CIKANDE, SERANG, BANTEN",43,58,70,128
https://kawalpemilu.org#89640,"CIKANDE PERMAI, CIKANDE, SERANG, BANTEN",44,77,115,192
https://kawalpemilu.org#89640,"CIKANDE PERMAI, CIKANDE, SERANG, BANTEN",45,135,97,232
https://kawalpemilu.org#89640,"CIKANDE PERMAI, CIKANDE, SERANG, BANTEN",46,72,59,131
https://kawalpemilu.org#89640,"CIKANDE PERMAI, CIKANDE, SERANG, BANTEN",47,79,78,157
https://kawalpemilu.org#52731,"KIBIN, KIBIN, SERANG, BANTEN",1,39,114,153
https://kawalpemilu.org#52731,"KIBIN, KIBIN, SERANG, BANTEN",2,24,53,77
https://kawalpemilu.org#52731,"KIBIN, KIBIN, SERANG, BANTEN",3,75,103,178
https://kawalpemilu.org#52731,"KIBIN, KIBIN, SERANG, BANTEN",4,117,75,192
https://kawalpemilu.org#52731,"KIBIN, KIBIN, SERANG, BANTEN",5,29,66,95
https://kawalpemilu.org#52731,"KIBIN, KIBIN, SERANG, BANTEN",6,45,66,111
https://kawalpemilu.org#52731,"KIBIN, KIBIN, SERANG, BANTEN",7,80,120,200
https://kawalpemilu.org#52731,"KIBIN, KIBIN, SERANG, BANTEN",8,78,101,179
https://kawalpemilu.org#52731,"KIBIN, KIBIN, SERANG, BANTEN",9,72,101,173
https://kawalpemilu.org#52731,"KIBIN, KIBIN, SERANG, BANTEN",10,58,80,138
https://kawalpemilu.org#52731,"KIBIN, KIBIN, SERANG, BANTEN",11,82,89,171
https://kawalpemilu.org#52731,"KIBIN, KIBIN, SERANG, BANTEN",12,95,119,214
https://kawalpemilu.org#52731,"KIBIN, KIBIN, SERANG, BANTEN",13,41,91,132
https://kawalpemilu.org#52731,"KIBIN, KIBIN, SERANG, BANTEN",14,23,96,119
https://kawalpemilu.org#52731,"KIBIN, KIBIN, SERANG, BANTEN",15,55,82,137
https://kawalpemilu.org#52731,"KIBIN, KIBIN, SERANG, BANTEN",16,30,126,156
https://kawalpemilu.org#52731,"KIBIN, KIBIN, SERANG, BANTEN",17,96,142,238
https://kawalpemilu.org#52731,"KIBIN, KIBIN, SERANG, BANTEN",18,36,182,218
https://kawalpemilu.org#52731,"KIBIN, KIBIN, SERANG, BANTEN",19,39,179,218
https://kawalpemilu.org#52731,"KIBIN, KIBIN, SERANG, BANTEN",20,66,142,208
https://kawalpemilu.org#52731,"KIBIN, KIBIN, SERANG, BANTEN",21,48,123,171
https://kawalpemilu.org#52731,"KIBIN, KIBIN, SERANG, BANTEN",22,42,127,169
https://kawalpemilu.org#52731,"KIBIN, KIBIN, SERANG, BANTEN",23,56,136,192
https://kawalpemilu.org#52731,"KIBIN, KIBIN, SERANG, BANTEN",24,58,100,158
https://kawalpemilu.org#52731,"KIBIN, KIBIN, SERANG, BANTEN",25,30,121,151
https://kawalpemilu.org#52731,"KIBIN, KIBIN, SERANG, BANTEN",26,53,123,176
https://kawalpemilu.org#52731,"KIBIN, KIBIN, SERANG, BANTEN",27,24,148,172
https://kawalpemilu.org#52731,"KIBIN, KIBIN, SERANG, BANTEN",28,71,135,206
https://kawalpemilu.org#52732,"KETOS, KIBIN, SERANG, BANTEN",1,133,92,225
https://kawalpemilu.org#52732,"KETOS, KIBIN, SERANG, BANTEN",2,190,68,258
https://kawalpemilu.org#52732,"KETOS, KIBIN, SERANG, BANTEN",3,41,130,171
https://kawalpemilu.org#52732,"KETOS, KIBIN, SERANG, BANTEN",4,39,131,170
https://kawalpemilu.org#52732,"KETOS, KIBIN, SERANG, BANTEN",5,66,156,222
https://kawalpemilu.org#52732,"KETOS, KIBIN, SERANG, BANTEN",6,85,105,190
https://kawalpemilu.org#52732,"KETOS, KIBIN, SERANG, BANTEN",7,92,100,192
https://kawalpemilu.org#52732,"KETOS, KIBIN, SERANG, BANTEN",8,44,159,203
https://kawalpemilu.org#52732,"KETOS, KIBIN, SERANG, BANTEN",9,56,103,159
https://kawalpemilu.org#52732,"KETOS, KIBIN, SERANG, BANTEN",10,64,118,182
https://kawalpemilu.org#52732,"KETOS, KIBIN, SERANG, BANTEN",11,35,124,159
https://kawalpemilu.org#52732,"KETOS, KIBIN, SERANG, BANTEN",12,73,136,209
https://kawalpemilu.org#52732,"KETOS, KIBIN, SERANG, BANTEN",13,62,117,179
https://kawalpemilu.org#52733,"CIJERUK, KIBIN, SERANG, BANTEN",2,90,94,184
https://kawalpemilu.org#52733,"CIJERUK, KIBIN, SERANG, BANTEN",3,138,78,216
https://kawalpemilu.org#52733,"CIJERUK, KIBIN, SERANG, BANTEN",4,153,70,223
https://kawalpemilu.org#52733,"CIJERUK, KIBIN, SERANG, BANTEN",5,90,113,217
https://kawalpemilu.org#52733,"CIJERUK, KIBIN, SERANG, BANTEN",6,93,112,205
https://kawalpemilu.org#52733,"CIJERUK, KIBIN, SERANG, BANTEN",7,128,85,213
https://kawalpemilu.org#52733,"CIJERUK, KIBIN, SERANG, BANTEN",8,87,118,205
https://kawalpemilu.org#52733,"CIJERUK, KIBIN, SERANG, BANTEN",9,73,124,197
https://kawalpemilu.org#52733,"CIJERUK, KIBIN, SERANG, BANTEN",10,82,74,156
https://kawalpemilu.org#52733,"CIJERUK, KIBIN, SERANG, BANTEN",11,95,82,177
https://kawalpemilu.org#52733,"CIJERUK, KIBIN, SERANG, BANTEN",12,91,123,214
https://kawalpemilu.org#52733,"CIJERUK, KIBIN, SERANG, BANTEN",13,91,95,186
https://kawalpemilu.org#52733,"CIJERUK, KIBIN, SERANG, BANTEN",14,63,134,197
https://kawalpemilu.org#52733,"CIJERUK, KIBIN, SERANG, BANTEN",15,87,107,194
https://kawalpemilu.org#52734,"NAGARA, KIBIN, SERANG, BANTEN",1,61,183,244
https://kawalpemilu.org#52734,"NAGARA, KIBIN, SERANG, BANTEN",2,69,161,230
https://kawalpemilu.org#52734,"NAGARA, KIBIN, SERANG, BANTEN",3,97,169,266
https://kawalpemilu.org#52734,"NAGARA, KIBIN, SERANG, BANTEN",4,48,165,213
https://kawalpemilu.org#52734,"NAGARA, KIBIN, SERANG, BANTEN",5,82,119,201
https://kawalpemilu.org#52734,"NAGARA, KIBIN, SERANG, BANTEN",6,67,117,184
https://kawalpemilu.org#52734,"NAGARA, KIBIN, SERANG, BANTEN",7,95,107,202
https://kawalpemilu.org#52734,"NAGARA, KIBIN, SERANG, BANTEN",8,103,79,182
https://kawalpemilu.org#52734,"NAGARA, KIBIN, SERANG, BANTEN",9,76,63,138
https://kawalpemilu.org#52734,"NAGARA, KIBIN, SERANG, BANTEN",10,58,100,158
https://kawalpemilu.org#52734,"NAGARA, KIBIN, SERANG, BANTEN",11,86,126,212
https://kawalpemilu.org#52734,"NAGARA, KIBIN, SERANG, BANTEN",12,76,148,224
https://kawalpemilu.org#52734,"NAGARA, KIBIN, SERANG, BANTEN",13,62,135,197
https://kawalpemilu.org#52734,"NAGARA, KIBIN, SERANG, BANTEN",14,50,88,138
https://kawalpemilu.org#52734,"NAGARA, KIBIN, SERANG, BANTEN",15,128,121,249
https://kawalpemilu.org#52734,"NAGARA, KIBIN, SERANG, BANTEN",16,77,122,199
https://kawalpemilu.org#52734,"NAGARA, KIBIN, SERANG, BANTEN",17,97,79,176
https://kawalpemilu.org#52735,"NAMBO ILIR, KIBIN, SERANG, BANTEN",1,98,106,204
https://kawalpemilu.org#52735,"NAMBO ILIR, KIBIN, SERANG, BANTEN",2,75,89,164
https://kawalpemilu.org#52735,"NAMBO ILIR, KIBIN, SERANG, BANTEN",3,52,147,199
https://kawalpemilu.org#52735,"NAMBO ILIR, KIBIN, SERANG, BANTEN",4,43,176,219
https://kawalpemilu.org#52735,"NAMBO ILIR, KIBIN, SERANG, BANTEN",5,52,110,162
https://kawalpemilu.org#52735,"NAMBO ILIR, KIBIN, SERANG, BANTEN",6,43,183,226
https://kawalpemilu.org#52735,"NAMBO ILIR, KIBIN, SERANG, BANTEN",7,46,150,196
https://kawalpemilu.org#52735,"NAMBO ILIR, KIBIN, SERANG, BANTEN",8,75,126,201
https://kawalpemilu.org#52735,"NAMBO ILIR, KIBIN, SERANG, BANTEN",10,44,139,183
https://kawalpemilu.org#52735,"NAMBO ILIR, KIBIN, SERANG, BANTEN",11,30,127,157
https://kawalpemilu.org#52735,"NAMBO ILIR, KIBIN, SERANG, BANTEN",12,80,99,179
https://kawalpemilu.org#52735,"NAMBO ILIR, KIBIN, SERANG, BANTEN",13,36,36,72
https://kawalpemilu.org#52735,"NAMBO ILIR, KIBIN, SERANG, BANTEN",14,88,178,266
https://kawalpemilu.org#52735,"NAMBO ILIR, KIBIN, SERANG, BANTEN",15,45,188,233
https://kawalpemilu.org#52735,"NAMBO ILIR, KIBIN, SERANG, BANTEN",16,35,203,238
https://kawalpemilu.org#52735,"NAMBO ILIR, KIBIN, SERANG, BANTEN",17,67,180,247
https://kawalpemilu.org#52735,"NAMBO ILIR, KIBIN, SERANG, BANTEN",18,69,165,232
https://kawalpemilu.org#52735,"NAMBO ILIR, KIBIN, SERANG, BANTEN",19,30,147,177
https://kawalpemilu.org#52735,"NAMBO ILIR, KIBIN, SERANG, BANTEN",20,44,100,144
https://kawalpemilu.org#52735,"NAMBO ILIR, KIBIN, SERANG, BANTEN",21,65,115,180
https://kawalpemilu.org#52735,"NAMBO ILIR, KIBIN, SERANG, BANTEN",22,67,147,214
https://kawalpemilu.org#52735,"NAMBO ILIR, KIBIN, SERANG, BANTEN",23,29,90,119
https://kawalpemilu.org#52735,"NAMBO ILIR, KIBIN, SERANG, BANTEN",24,29,97,126
https://kawalpemilu.org#52736,"BARENGKOK, KIBIN, SERANG, BANTEN",1,35,167,202
https://kawalpemilu.org#52736,"BARENGKOK, KIBIN, SERANG, BANTEN",2,39,151,190
https://kawalpemilu.org#52736,"BARENGKOK, KIBIN, SERANG, BANTEN",3,46,153,201
https://kawalpemilu.org#52736,"BARENGKOK, KIBIN, SERANG, BANTEN",4,55,148,203
https://kawalpemilu.org#52736,"BARENGKOK, KIBIN, SERANG, BANTEN",5,73,149,222
https://kawalpemilu.org#52736,"BARENGKOK, KIBIN, SERANG, BANTEN",6,53,153,206
https://kawalpemilu.org#52736,"BARENGKOK, KIBIN, SERANG, BANTEN",7,66,140,206
https://kawalpemilu.org#52736,"BARENGKOK, KIBIN, SERANG, BANTEN",8,83,143,226
https://kawalpemilu.org#52736,"BARENGKOK, KIBIN, SERANG, BANTEN",9,43,149,192
https://kawalpemilu.org#52736,"BARENGKOK, KIBIN, SERANG, BANTEN",10,54,121,175
https://kawalpemilu.org#52736,"BARENGKOK, KIBIN, SERANG, BANTEN",11,52,157,209
https://kawalpemilu.org#52736,"BARENGKOK, KIBIN, SERANG, BANTEN",12,50,152,202
https://kawalpemilu.org#52736,"BARENGKOK, KIBIN, SERANG, BANTEN",13,65,161,226
https://kawalpemilu.org#52736,"BARENGKOK, KIBIN, SERANG, BANTEN",14,44,171,215
https://kawalpemilu.org#52737,"SUKAMAJU, KIBIN, SERANG, BANTEN",1,53,186,239
https://kawalpemilu.org#52737,"SUKAMAJU, KIBIN, SERANG, BANTEN",2,48,136,184
https://kawalpemilu.org#52737,"SUKAMAJU, KIBIN, SERANG, BANTEN",3,97,129,226
https://kawalpemilu.org#52737,"SUKAMAJU, KIBIN, SERANG, BANTEN",4,72,155,227
https://kawalpemilu.org#52737,"SUKAMAJU, KIBIN, SERANG, BANTEN",5,72,161,233
https://kawalpemilu.org#52737,"SUKAMAJU, KIBIN, SERANG, BANTEN",6,46,117,163
https://kawalpemilu.org#52737,"SUKAMAJU, KIBIN, SERANG, BANTEN",7,33,133,166
https://kawalpemilu.org#52737,"SUKAMAJU, KIBIN, SERANG, BANTEN",8,39,162,201
https://kawalpemilu.org#52737,"SUKAMAJU, KIBIN, SERANG, BANTEN",9,29,151,180
https://kawalpemilu.org#52737,"SUKAMAJU, KIBIN, SERANG, BANTEN",10,29,140,169
https://kawalpemilu.org#52737,"SUKAMAJU, KIBIN, SERANG, BANTEN",11,20,121,141
https://kawalpemilu.org#52737,"SUKAMAJU, KIBIN, SERANG, BANTEN",12,41,129,170
https://kawalpemilu.org#52737,"SUKAMAJU, KIBIN, SERANG, BANTEN",13,32,112,144
https://kawalpemilu.org#52737,"SUKAMAJU, KIBIN, SERANG, BANTEN",14,49,126,175
https://kawalpemilu.org#52737,"SUKAMAJU, KIBIN, SERANG, BANTEN",15,69,134,203
https://kawalpemilu.org#52737,"SUKAMAJU, KIBIN, SERANG, BANTEN",16,49,108,157
https://kawalpemilu.org#52738,"TAMBAK, KIBIN, SERANG, BANTEN",1,77,131,208
https://kawalpemilu.org#52738,"TAMBAK, KIBIN, SERANG, BANTEN",2,59,112,171
https://kawalpemilu.org#52738,"TAMBAK, KIBIN, SERANG, BANTEN",3,93,98,191
https://kawalpemilu.org#52738,"TAMBAK, KIBIN, SERANG, BANTEN",4,85,110,195
https://kawalpemilu.org#52738,"TAMBAK, KIBIN, SERANG, BANTEN",5,71,87,158
https://kawalpemilu.org#52738,"TAMBAK, KIBIN, SERANG, BANTEN",6,65,113,178
https://kawalpemilu.org#52738,"TAMBAK, KIBIN, SERANG, BANTEN",7,66,124,190
https://kawalpemilu.org#52738,"TAMBAK, KIBIN, SERANG, BANTEN",8,50,136,186
https://kawalpemilu.org#52738,"TAMBAK, KIBIN, SERANG, BANTEN",9,52,120,172
https://kawalpemilu.org#52738,"TAMBAK, KIBIN, SERANG, BANTEN",10,92,70,162
https://kawalpemilu.org#52738,"TAMBAK, KIBIN, SERANG, BANTEN",11,45,95,140
https://kawalpemilu.org#52738,"TAMBAK, KIBIN, SERANG, BANTEN",12,92,129,221
https://kawalpemilu.org#52738,"TAMBAK, KIBIN, SERANG, BANTEN",13,93,176,269
https://kawalpemilu.org#52738,"TAMBAK, KIBIN, SERANG, BANTEN",14,67,187,254
https://kawalpemilu.org#52738,"TAMBAK, KIBIN, SERANG, BANTEN",15,62,76,138
https://kawalpemilu.org#52738,"TAMBAK, KIBIN, SERANG, BANTEN",16,74,63,137
https://kawalpemilu.org#52738,"TAMBAK, KIBIN, SERANG, BANTEN",17,70,136,201
https://kawalpemilu.org#52738,"TAMBAK, KIBIN, SERANG, BANTEN",18,58,138,196
https://kawalpemilu.org#52738,"TAMBAK, KIBIN, SERANG, BANTEN",19,41,63,104
https://kawalpemilu.org#52738,"TAMBAK, KIBIN, SERANG, BANTEN",20,46,40,86
https://kawalpemilu.org#52738,"TAMBAK, KIBIN, SERANG, BANTEN",21,50,29,79
https://kawalpemilu.org#52738,"TAMBAK, KIBIN, SERANG, BANTEN",22,32,17,49
https://kawalpemilu.org#52738,"TAMBAK, KIBIN, SERANG, BANTEN",23,37,29,66
https://kawalpemilu.org#52738,"TAMBAK, KIBIN, SERANG, BANTEN",24,18,4,22
https://kawalpemilu.org#52739,"CIAGEL, KIBIN, SERANG, BANTEN",1,64,135,199
https://kawalpemilu.org#52739,"CIAGEL, KIBIN, SERANG, BANTEN",2,52,98,150
https://kawalpemilu.org#52739,"CIAGEL, KIBIN, SERANG, BANTEN",3,50,148,198
https://kawalpemilu.org#52739,"CIAGEL, KIBIN, SERANG, BANTEN",4,48,136,184
https://kawalpemilu.org#52739,"CIAGEL, KIBIN, SERANG, BANTEN",5,42,136,178
https://kawalpemilu.org#52739,"CIAGEL, KIBIN, SERANG, BANTEN",6,75,109,184
https://kawalpemilu.org#52739,"CIAGEL, KIBIN, SERANG, BANTEN",7,80,116,196
https://kawalpemilu.org#52739,"CIAGEL, KIBIN, SERANG, BANTEN",8,42,90,132
https://kawalpemilu.org#52739,"CIAGEL, KIBIN, SERANG, BANTEN",9,99,93,192
https://kawalpemilu.org#52739,"CIAGEL, KIBIN, SERANG, BANTEN",10,59,108,167
https://kawalpemilu.org#52739,"CIAGEL, KIBIN, SERANG, BANTEN",11,79,130,209
https://kawalpemilu.org#52739,"CIAGEL, KIBIN, SERANG, BANTEN",12,63,164,227
https://kawalpemilu.org#52739,"CIAGEL, KIBIN, SERANG, BANTEN",13,79,154,233
https://kawalpemilu.org#52739,"CIAGEL, KIBIN, SERANG, BANTEN",14,38,129,167
https://kawalpemilu.org#52739,"CIAGEL, KIBIN, SERANG, BANTEN",15,47,95,142
https://kawalpemilu.org#52739,"CIAGEL, KIBIN, SERANG, BANTEN",16,87,99,186
https://kawalpemilu.org#52739,"CIAGEL, KIBIN, SERANG, BANTEN",17,58,172,230
https://kawalpemilu.org#52739,"CIAGEL, KIBIN, SERANG, BANTEN",18,106,108,214
https://kawalpemilu.org#52739,"CIAGEL, KIBIN, SERANG, BANTEN",19,102,127,229
https://kawalpemilu.org#52739,"CIAGEL, KIBIN, SERANG, BANTEN",20,80,100,180
https://kawalpemilu.org#52739,"CIAGEL, KIBIN, SERANG, BANTEN",21,94,104,198
https://kawalpemilu.org#52741,"CARENANG, CARENANG, SERANG, BANTEN",1,84,164,248
https://kawalpemilu.org#52741,"CARENANG, CARENANG, SERANG, BANTEN",2,90,150,240
https://kawalpemilu.org#52741,"CARENANG, CARENANG, SERANG, BANTEN",3,100,137,237
https://kawalpemilu.org#52741,"CARENANG, CARENANG, SERANG, BANTEN",4,31,217,248
https://kawalpemilu.org#52741,"CARENANG, CARENANG, SERANG, BANTEN",5,41,196,237
https://kawalpemilu.org#52741,"CARENANG, CARENANG, SERANG, BANTEN",6,32,203,235
https://kawalpemilu.org#52741,"CARENANG, CARENANG, SERANG, BANTEN",7,32,200,232
https://kawalpemilu.org#52741,"CARENANG, CARENANG, SERANG, BANTEN",8,29,66,95
https://kawalpemilu.org#52742,"PAMANUK, CARENANG, SERANG, BANTEN",1,83,87,170
https://kawalpemilu.org#52742,"PAMANUK, CARENANG, SERANG, BANTEN",2,64,150,214
https://kawalpemilu.org#52742,"PAMANUK, CARENANG, SERANG, BANTEN",3,41,167,208
https://kawalpemilu.org#52742,"PAMANUK, CARENANG, SERANG, BANTEN",4,40,204,244
https://kawalpemilu.org#52742,"PAMANUK, CARENANG, SERANG, BANTEN",5,34,192,226
https://kawalpemilu.org#52742,"PAMANUK, CARENANG, SERANG, BANTEN",6,25,158,183
https://kawalpemilu.org#52742,"PAMANUK, CARENANG, SERANG, BANTEN",7,37,172,209
https://kawalpemilu.org#52742,"PAMANUK, CARENANG, SERANG, BANTEN",8,50,226,276
https://kawalpemilu.org#52742,"PAMANUK, CARENANG, SERANG, BANTEN",9,25,169,194
https://kawalpemilu.org#52742,"PAMANUK, CARENANG, SERANG, BANTEN",10,34,139,173
https://kawalpemilu.org#52742,"PAMANUK, CARENANG, SERANG, BANTEN",11,37,219,256
https://kawalpemilu.org#52742,"PAMANUK, CARENANG, SERANG, BANTEN",12,44,55,99
https://kawalpemilu.org#52743,"MANDAYA, CARENANG, SERANG, BANTEN",1,44,207,251
https://kawalpemilu.org#52743,"MANDAYA, CARENANG, SERANG, BANTEN",2,45,203,248
https://kawalpemilu.org#52743,"MANDAYA, CARENANG, SERANG, BANTEN",3,49,219,268
https://kawalpemilu.org#52743,"MANDAYA, CARENANG, SERANG, BANTEN",4,48,206,254
https://kawalpemilu.org#52743,"MANDAYA, CARENANG, SERANG, BANTEN",5,110,135,245
https://kawalpemilu.org#52743,"MANDAYA, CARENANG, SERANG, BANTEN",6,64,171,235
https://kawalpemilu.org#52743,"MANDAYA, CARENANG, SERANG, BANTEN",7,92,132,224
https://kawalpemilu.org#52743,"MANDAYA, CARENANG, SERANG, BANTEN",8,77,174,251
https://kawalpemilu.org#52743,"MANDAYA, CARENANG, SERANG, BANTEN",9,64,189,253
https://kawalpemilu.org#52743,"MANDAYA, CARENANG, SERANG, BANTEN",10,105,125,230
https://kawalpemilu.org#52743,"MANDAYA, CARENANG, SERANG, BANTEN",11,122,110,232
https://kawalpemilu.org#52743,"MANDAYA, CARENANG, SERANG, BANTEN",12,118,116,234
https://kawalpemilu.org#52743,"MANDAYA, CARENANG, SERANG, BANTEN",13,43,153,196
https://kawalpemilu.org#52744,"TERAS, CARENANG, SERANG, BANTEN",1,45,168,213
https://kawalpemilu.org#52744,"TERAS, CARENANG, SERANG, BANTEN",3,67,150,217
https://kawalpemilu.org#52744,"TERAS, CARENANG, SERANG, BANTEN",4,50,165,215
https://kawalpemilu.org#52744,"TERAS, CARENANG, SERANG, BANTEN",5,32,174,206
https://kawalpemilu.org#52744,"TERAS, CARENANG, SERANG, BANTEN",6,45,154,199
https://kawalpemilu.org#52744,"TERAS, CARENANG, SERANG, BANTEN",7,52,195,247
https://kawalpemilu.org#52744,"TERAS, CARENANG, SERANG, BANTEN",8,47,175,222
https://kawalpemilu.org#52744,"TERAS, CARENANG, SERANG, BANTEN",9,55,151,206
https://kawalpemilu.org#52744,"TERAS, CARENANG, SERANG, BANTEN",10,40,157,197
https://kawalpemilu.org#52744,"TERAS, CARENANG, SERANG, BANTEN",11,43,155,198
https://kawalpemilu.org#52744,"TERAS, CARENANG, SERANG, BANTEN",12,82,107,189
https://kawalpemilu.org#52744,"TERAS, CARENANG, SERANG, BANTEN",13,52,121,173
https://kawalpemilu.org#52744,"TERAS, CARENANG, SERANG, BANTEN",14,43,111,154
https://kawalpemilu.org#52744,"TERAS, CARENANG, SERANG, BANTEN",15,42,183,225
https://kawalpemilu.org#52744,"TERAS, CARENANG, SERANG, BANTEN",16,20,154,174
https://kawalpemilu.org#52744,"TERAS, CARENANG, SERANG, BANTEN",17,41,147,188
https://kawalpemilu.org#52744,"TERAS, CARENANG, SERANG, BANTEN",18,53,165,218
https://kawalpemilu.org#52744,"TERAS, CARENANG, SERANG, BANTEN",19,52,103,155
https://kawalpemilu.org#52746,"RAGASMASIGIT, CARENANG, SERANG, BANTEN",1,29,198,227
https://kawalpemilu.org#52746,"RAGASMASIGIT, CARENANG, SERANG, BANTEN",2,42,151,193
https://kawalpemilu.org#52746,"RAGASMASIGIT, CARENANG, SERANG, BANTEN",3,47,155,38
https://kawalpemilu.org#52746,"RAGASMASIGIT, CARENANG, SERANG, BANTEN",4,45,133,178
https://kawalpemilu.org#52746,"RAGASMASIGIT, CARENANG, SERANG, BANTEN",5,104,103,207
https://kawalpemilu.org#52746,"RAGASMASIGIT, CARENANG, SERANG, BANTEN",6,111,95,206
https://kawalpemilu.org#52746,"RAGASMASIGIT, CARENANG, SERANG, BANTEN",7,84,97,181
https://kawalpemilu.org#52746,"RAGASMASIGIT, CARENANG, SERANG, BANTEN",8,60,147,207
https://kawalpemilu.org#52746,"RAGASMASIGIT, CARENANG, SERANG, BANTEN",9,44,150,194
https://kawalpemilu.org#52746,"RAGASMASIGIT, CARENANG, SERANG, BANTEN",10,63,149,212
https://kawalpemilu.org#52746,"RAGASMASIGIT, CARENANG, SERANG, BANTEN",11,69,152,221
https://kawalpemilu.org#52746,"RAGASMASIGIT, CARENANG, SERANG, BANTEN",12,74,123,197
https://kawalpemilu.org#52746,"RAGASMASIGIT, CARENANG, SERANG, BANTEN",13,63,151,214
https://kawalpemilu.org#52746,"RAGASMASIGIT, CARENANG, SERANG, BANTEN",14,0,0,0
https://kawalpemilu.org#52746,"RAGASMASIGIT, CARENANG, SERANG, BANTEN",15,32,154,186
https://kawalpemilu.org#52746,"RAGASMASIGIT, CARENANG, SERANG, BANTEN",16,37,155,192
https://kawalpemilu.org#52746,"RAGASMASIGIT, CARENANG, SERANG, BANTEN",17,27,109,136
https://kawalpemilu.org#52746,"RAGASMASIGIT, CARENANG, SERANG, BANTEN",18,19,127,146
https://kawalpemilu.org#52747,"WALIKUKUN, CARENANG, SERANG, BANTEN",1,22,216,238
https://kawalpemilu.org#52747,"WALIKUKUN, CARENANG, SERANG, BANTEN",2,66,153,219
https://kawalpemilu.org#52747,"WALIKUKUN, CARENANG, SERANG, BANTEN",3,59,163,222
https://kawalpemilu.org#52747,"WALIKUKUN, CARENANG, SERANG, BANTEN",4,51,141,192
https://kawalpemilu.org#52747,"WALIKUKUN, CARENANG, SERANG, BANTEN",5,54,81,135
https://kawalpemilu.org#52747,"WALIKUKUN, CARENANG, SERANG, BANTEN",6,87,96,191
https://kawalpemilu.org#52747,"WALIKUKUN, CARENANG, SERANG, BANTEN",7,69,98,167
https://kawalpemilu.org#52747,"WALIKUKUN, CARENANG, SERANG, BANTEN",8,49,86,135
https://kawalpemilu.org#52747,"WALIKUKUN, CARENANG, SERANG, BANTEN",9,48,170,218
https://kawalpemilu.org#52747,"WALIKUKUN, CARENANG, SERANG, BANTEN",10,42,157,199
https://kawalpemilu.org#52747,"WALIKUKUN, CARENANG, SERANG, BANTEN",11,24,127,201
https://kawalpemilu.org#52747,"WALIKUKUN, CARENANG, SERANG, BANTEN",12,76,161,237
https://kawalpemilu.org#52747,"WALIKUKUN, CARENANG, SERANG, BANTEN",13,45,178,223
https://kawalpemilu.org#52747,"WALIKUKUN, CARENANG, SERANG, BANTEN",14,41,196,237
https://kawalpemilu.org#52749,"PANENJOAN, CARENANG, SERANG, BANTEN",1,44,190,262
https://kawalpemilu.org#52749,"PANENJOAN, CARENANG, SERANG, BANTEN",2,66,146,212
https://kawalpemilu.org#52749,"PANENJOAN, CARENANG, SERANG, BANTEN",3,90,136,226
https://kawalpemilu.org#52749,"PANENJOAN, CARENANG, SERANG, BANTEN",4,69,148,217
https://kawalpemilu.org#52749,"PANENJOAN, CARENANG, SERANG, BANTEN",5,49,166,215
https://kawalpemilu.org#52749,"PANENJOAN, CARENANG, SERANG, BANTEN",6,76,142,218
https://kawalpemilu.org#52749,"PANENJOAN, CARENANG, SERANG, BANTEN",7,0,0,0
https://kawalpemilu.org#52749,"PANENJOAN, CARENANG, SERANG, BANTEN",8,59,150,209
https://kawalpemilu.org#52749,"PANENJOAN, CARENANG, SERANG, BANTEN",9,67,141,208
https://kawalpemilu.org#52749,"PANENJOAN, CARENANG, SERANG, BANTEN",10,58,172,230
https://kawalpemilu.org#52749,"PANENJOAN, CARENANG, SERANG, BANTEN",11,28,199,227
https://kawalpemilu.org#52749,"PANENJOAN, CARENANG, SERANG, BANTEN",12,56,132,188
https://kawalpemilu.org#52750,"MEKARSARI, CARENANG, SERANG, BANTEN",1,90,137,227
https://kawalpemilu.org#52750,"MEKARSARI, CARENANG, SERANG, BANTEN",2,109,163,272
https://kawalpemilu.org#52750,"MEKARSARI, CARENANG, SERANG, BANTEN",3,103,156,259
https://kawalpemilu.org#52750,"MEKARSARI, CARENANG, SERANG, BANTEN",4,71,182,267
https://kawalpemilu.org#52750,"MEKARSARI, CARENANG, SERANG, BANTEN",5,76,156,232
https://kawalpemilu.org#52750,"MEKARSARI, CARENANG, SERANG, BANTEN",6,88,113,201
https://kawalpemilu.org#52750,"MEKARSARI, CARENANG, SERANG, BANTEN",7,34,139,173
https://kawalpemilu.org#52750,"MEKARSARI, CARENANG, SERANG, BANTEN",8,84,129,213
https://kawalpemilu.org#52750,"MEKARSARI, CARENANG, SERANG, BANTEN",9,71,169,240
https://kawalpemilu.org#52750,"MEKARSARI, CARENANG, SERANG, BANTEN",10,114,124,238
https://kawalpemilu.org#52750,"MEKARSARI, CARENANG, SERANG, BANTEN",11,34,189,223
https://kawalpemilu.org#52750,"MEKARSARI, CARENANG, SERANG, BANTEN",12,55,109,164
https://kawalpemilu.org#52752,"BINUANG, BINUANG, SERANG, BANTEN",1,77,149,226
https://kawalpemilu.org#52752,"BINUANG, BINUANG, SERANG, BANTEN",2,77,180,257
https://kawalpemilu.org#52752,"BINUANG, BINUANG, SERANG, BANTEN",3,53,136,189
https://kawalpemilu.org#52752,"BINUANG, BINUANG, SERANG, BANTEN",4,64,145,209
https://kawalpemilu.org#52752,"BINUANG, BINUANG, SERANG, BANTEN",5,32,194,226
https://kawalpemilu.org#52752,"BINUANG, BINUANG, SERANG, BANTEN",6,28,179,207
https://kawalpemilu.org#52752,"BINUANG, BINUANG, SERANG, BANTEN",7,64,127,191
https://kawalpemilu.org#52752,"BINUANG, BINUANG, SERANG, BANTEN",8,65,98,163
https://kawalpemilu.org#52752,"BINUANG, BINUANG, SERANG, BANTEN",9,84,47,131
https://kawalpemilu.org#52752,"BINUANG, BINUANG, SERANG, BANTEN",10,97,42,139
https://kawalpemilu.org#52752,"BINUANG, BINUANG, SERANG, BANTEN",11,95,83,178
https://kawalpemilu.org#52752,"BINUANG, BINUANG, SERANG, BANTEN",12,94,69,163
https://kawalpemilu.org#52752,"BINUANG, BINUANG, SERANG, BANTEN",13,60,175,235
https://kawalpemilu.org#52752,"BINUANG, BINUANG, SERANG, BANTEN",14,57,114,171
https://kawalpemilu.org#52752,"BINUANG, BINUANG, SERANG, BANTEN",15,0,0,0
https://kawalpemilu.org#52752,"BINUANG, BINUANG, SERANG, BANTEN",16,90,100,190
https://kawalpemilu.org#52753,"CAKUNG, BINUANG, SERANG, BANTEN",1,80,120,200
https://kawalpemilu.org#52753,"CAKUNG, BINUANG, SERANG, BANTEN",2,72,122,194
https://kawalpemilu.org#52753,"CAKUNG, BINUANG, SERANG, BANTEN",3,124,83,207
https://kawalpemilu.org#52753,"CAKUNG, BINUANG, SERANG, BANTEN",4,52,188,240
https://kawalpemilu.org#52753,"CAKUNG, BINUANG, SERANG, BANTEN",5,71,167,238
https://kawalpemilu.org#52753,"CAKUNG, BINUANG, SERANG, BANTEN",6,51,135,186
https://kawalpemilu.org#52753,"CAKUNG, BINUANG, SERANG, BANTEN",7,62,125,187
https://kawalpemilu.org#52753,"CAKUNG, BINUANG, SERANG, BANTEN",8,95,145,240
https://kawalpemilu.org#52753,"CAKUNG, BINUANG, SERANG, BANTEN",10,73,115,188
https://kawalpemilu.org#52753,"CAKUNG, BINUANG, SERANG, BANTEN",11,45,119,164
https://kawalpemilu.org#52753,"CAKUNG, BINUANG, SERANG, BANTEN",12,51,153,204
https://kawalpemilu.org#52753,"CAKUNG, BINUANG, SERANG, BANTEN",13,45,108,153
https://kawalpemilu.org#52754,"RENGED, BINUANG, SERANG, BANTEN",1,21,148,169
https://kawalpemilu.org#52754,"RENGED, BINUANG, SERANG, BANTEN",2,48,144,192
https://kawalpemilu.org#52754,"RENGED, BINUANG, SERANG, BANTEN",3,56,132,188
https://kawalpemilu.org#52754,"RENGED, BINUANG, SERANG, BANTEN",4,54,105,159
https://kawalpemilu.org#52754,"RENGED, BINUANG, SERANG, BANTEN",5,57,83,140
https://kawalpemilu.org#52754,"RENGED, BINUANG, SERANG, BANTEN",6,59,99,158
https://kawalpemilu.org#52754,"RENGED, BINUANG, SERANG, BANTEN",7,51,130,182
https://kawalpemilu.org#52754,"RENGED, BINUANG, SERANG, BANTEN",8,25,60,85
https://kawalpemilu.org#52754,"RENGED, BINUANG, SERANG, BANTEN",9,81,166,247
https://kawalpemilu.org#52754,"RENGED, BINUANG, SERANG, BANTEN",10,43,215,258
https://kawalpemilu.org#52755,"GEMBOR, BINUANG, SERANG, BANTEN",1,78,114,192
https://kawalpemilu.org#52755,"GEMBOR, BINUANG, SERANG, BANTEN",2,64,126,190
https://kawalpemilu.org#52755,"GEMBOR, BINUANG, SERANG, BANTEN",3,54,83,137
https://kawalpemilu.org#52755,"GEMBOR, BINUANG, SERANG, BANTEN",4,73,154,227
https://kawalpemilu.org#52755,"GEMBOR, BINUANG, SERANG, BANTEN",5,57,157,214
https://kawalpemilu.org#52755,"GEMBOR, BINUANG, SERANG, BANTEN",6,92,106,198
https://kawalpemilu.org#52755,"GEMBOR, BINUANG, SERANG, BANTEN",7,61,157,218
https://kawalpemilu.org#52755,"GEMBOR, BINUANG, SERANG, BANTEN",8,68,154,222
https://kawalpemilu.org#52755,"GEMBOR, BINUANG, SERANG, BANTEN",9,86,144,230
https://kawalpemilu.org#52755,"GEMBOR, BINUANG, SERANG, BANTEN",10,57,107,164
https://kawalpemilu.org#52755,"GEMBOR, BINUANG, SERANG, BANTEN",11,64,123,187
https://kawalpemilu.org#52755,"GEMBOR, BINUANG, SERANG, BANTEN",12,53,118,171
https://kawalpemilu.org#52755,"GEMBOR, BINUANG, SERANG, BANTEN",13,72,112,184
https://kawalpemilu.org#52755,"GEMBOR, BINUANG, SERANG, BANTEN",14,66,85,151
https://kawalpemilu.org#52755,"GEMBOR, BINUANG, SERANG, BANTEN",15,43,191,234
https://kawalpemilu.org#52755,"GEMBOR, BINUANG, SERANG, BANTEN",16,56,177,233
https://kawalpemilu.org#52755,"GEMBOR, BINUANG, SERANG, BANTEN",17,94,108,202
https://kawalpemilu.org#52755,"GEMBOR, BINUANG, SERANG, BANTEN",18,46,103,149
https://kawalpemilu.org#52755,"GEMBOR, BINUANG, SERANG, BANTEN",19,43,114,157
https://kawalpemilu.org#52755,"GEMBOR, BINUANG, SERANG, BANTEN",20,45,126,171
https://kawalpemilu.org#52755,"GEMBOR, BINUANG, SERANG, BANTEN",21,41,126,167
https://kawalpemilu.org#52755,"GEMBOR, BINUANG, SERANG, BANTEN",22,62,187,249
https://kawalpemilu.org#52755,"GEMBOR, BINUANG, SERANG, BANTEN",23,34,172,206
https://kawalpemilu.org#52756,"WARAKAS, BINUANG, SERANG, BANTEN",1,38,153,191
https://kawalpemilu.org#52756,"WARAKAS, BINUANG, SERANG, BANTEN",2,38,156,194
https://kawalpemilu.org#52756,"WARAKAS, BINUANG, SERANG, BANTEN",3,41,119,160
https://kawalpemilu.org#52756,"WARAKAS, BINUANG, SERANG, BANTEN",4,85,144,229
https://kawalpemilu.org#52756,"WARAKAS, BINUANG, SERANG, BANTEN",5,74,132,206
https://kawalpemilu.org#52756,"WARAKAS, BINUANG, SERANG, BANTEN",6,70,134,204
https://kawalpemilu.org#52756,"WARAKAS, BINUANG, SERANG, BANTEN",7,68,148,216
https://kawalpemilu.org#52756,"WARAKAS, BINUANG, SERANG, BANTEN",8,64,124,188
https://kawalpemilu.org#52756,"WARAKAS, BINUANG, SERANG, BANTEN",9,60,144,204
https://kawalpemilu.org#52756,"WARAKAS, BINUANG, SERANG, BANTEN",10,48,158,206
https://kawalpemilu.org#52756,"WARAKAS, BINUANG, SERANG, BANTEN",11,50,153,203
https://kawalpemilu.org#52756,"WARAKAS, BINUANG, SERANG, BANTEN",12,18,170,188
https://kawalpemilu.org#52757,"SUKAMAMPIR, BINUANG, SERANG, BANTEN",1,52,179,231
https://kawalpemilu.org#52757,"SUKAMAMPIR, BINUANG, SERANG, BANTEN",2,57,175,232
https://kawalpemilu.org#52757,"SUKAMAMPIR, BINUANG, SERANG, BANTEN",3,57,176,233
https://kawalpemilu.org#52757,"SUKAMAMPIR, BINUANG, SERANG, BANTEN",4,70,123,193
https://kawalpemilu.org#52757,"SUKAMAMPIR, BINUANG, SERANG, BANTEN",5,66,137,203
https://kawalpemilu.org#52757,"SUKAMAMPIR, BINUANG, SERANG, BANTEN",6,49,123,172
https://kawalpemilu.org#52757,"SUKAMAMPIR, BINUANG, SERANG, BANTEN",7,75,138,213
https://kawalpemilu.org#52757,"SUKAMAMPIR, BINUANG, SERANG, BANTEN",8,81,115,196
https://kawalpemilu.org#52757,"SUKAMAMPIR, BINUANG, SERANG, BANTEN",9,102,136,238
https://kawalpemilu.org#52757,"SUKAMAMPIR, BINUANG, SERANG, BANTEN",10,63,171,234
https://kawalpemilu.org#52757,"SUKAMAMPIR, BINUANG, SERANG, BANTEN",11,59,158,217
https://kawalpemilu.org#52757,"SUKAMAMPIR, BINUANG, SERANG, BANTEN",12,71,153,224
https://kawalpemilu.org#52758,"LAMARAN, BINUANG, SERANG, BANTEN",1,30,195,225
https://kawalpemilu.org#52758,"LAMARAN, BINUANG, SERANG, BANTEN",2,51,179,230
https://kawalpemilu.org#52758,"LAMARAN, BINUANG, SERANG, BANTEN",3,27,182,209
https://kawalpemilu.org#52758,"LAMARAN, BINUANG, SERANG, BANTEN",4,37,177,214
https://kawalpemilu.org#52758,"LAMARAN, BINUANG, SERANG, BANTEN",5,50,154,204
https://kawalpemilu.org#52758,"LAMARAN, BINUANG, SERANG, BANTEN",6,50,156,206
https://kawalpemilu.org#52758,"LAMARAN, BINUANG, SERANG, BANTEN",7,64,142,206
https://kawalpemilu.org#52758,"LAMARAN, BINUANG, SERANG, BANTEN",8,64,115,179
https://kawalpemilu.org#52758,"LAMARAN, BINUANG, SERANG, BANTEN",9,95,92,187
https://kawalpemilu.org#52758,"LAMARAN, BINUANG, SERANG, BANTEN",11,108,97,205
https://kawalpemilu.org#52758,"LAMARAN, BINUANG, SERANG, BANTEN",12,100,94,194
https://kawalpemilu.org#52758,"LAMARAN, BINUANG, SERANG, BANTEN",14,100,102,202
https://kawalpemilu.org#52760,"PETIR, PETIR, SERANG, BANTEN",1,25,178,203
https://kawalpemilu.org#52760,"PETIR, PETIR, SERANG, BANTEN",2,63,135,198
https://kawalpemilu.org#52760,"PETIR, PETIR, SERANG, BANTEN",3,48,177,225
https://kawalpemilu.org#52760,"PETIR, PETIR, SERANG, BANTEN",4,92,135,227
https://kawalpemilu.org#52760,"PETIR, PETIR, SERANG, BANTEN",5,88,104,192
https://kawalpemilu.org#52760,"PETIR, PETIR, SERANG, BANTEN",6,65,116,181
https://kawalpemilu.org#52760,"PETIR, PETIR, SERANG, BANTEN",7,35,151,186
https://kawalpemilu.org#52760,"PETIR, PETIR, SERANG, BANTEN",8,51,148,199
https://kawalpemilu.org#52760,"PETIR, PETIR, SERANG, BANTEN",9,47,172,219
https://kawalpemilu.org#52760,"PETIR, PETIR, SERANG, BANTEN",10,35,169,204
https://kawalpemilu.org#52760,"PETIR, PETIR, SERANG, BANTEN",11,53,163,216
https://kawalpemilu.org#52760,"PETIR, PETIR, SERANG, BANTEN",12,49,144,193
https://kawalpemilu.org#52760,"PETIR, PETIR, SERANG, BANTEN",13,78,122,200
https://kawalpemilu.org#52760,"PETIR, PETIR, SERANG, BANTEN",14,64,145,209
https://kawalpemilu.org#52760,"PETIR, PETIR, SERANG, BANTEN",15,67,104,171
https://kawalpemilu.org#52760,"PETIR, PETIR, SERANG, BANTEN",16,56,147,203
https://kawalpemilu.org#52761,"CIRANGKONG, PETIR, SERANG, BANTEN",1,86,135,221
https://kawalpemilu.org#52761,"CIRANGKONG, PETIR, SERANG, BANTEN",2,70,145,215
https://kawalpemilu.org#52761,"CIRANGKONG, PETIR, SERANG, BANTEN",3,36,142,178
https://kawalpemilu.org#52761,"CIRANGKONG, PETIR, SERANG, BANTEN",4,25,171,196
https://kawalpemilu.org#52761,"CIRANGKONG, PETIR, SERANG, BANTEN",5,30,162,192
https://kawalpemilu.org#52761,"CIRANGKONG, PETIR, SERANG, BANTEN",6,41,130,171
https://kawalpemilu.org#52761,"CIRANGKONG, PETIR, SERANG, BANTEN",7,57,122,179
https://kawalpemilu.org#52761,"CIRANGKONG, PETIR, SERANG, BANTEN",8,89,60,149
https://kawalpemilu.org#52761,"CIRANGKONG, PETIR, SERANG, BANTEN",9,70,97,167
https://kawalpemilu.org#52761,"CIRANGKONG, PETIR, SERANG, BANTEN",10,81,124,205
https://kawalpemilu.org#52761,"CIRANGKONG, PETIR, SERANG, BANTEN",11,111,103,214
https://kawalpemilu.org#52761,"CIRANGKONG, PETIR, SERANG, BANTEN",12,39,105,144
https://kawalpemilu.org#52761,"CIRANGKONG, PETIR, SERANG, BANTEN",13,90,124,214
https://kawalpemilu.org#52762,"TAMBILUK, PETIR, SERANG, BANTEN",1,94,115,209
https://kawalpemilu.org#52762,"TAMBILUK, PETIR, SERANG, BANTEN",2,79,140,219
https://kawalpemilu.org#52762,"TAMBILUK, PETIR, SERANG, BANTEN",3,80,105,185
https://kawalpemilu.org#52762,"TAMBILUK, PETIR, SERANG, BANTEN",4,83,140,223
https://kawalpemilu.org#52762,"TAMBILUK, PETIR, SERANG, BANTEN",5,81,103,184
https://kawalpemilu.org#52762,"TAMBILUK, PETIR, SERANG, BANTEN",6,54,111,165
https://kawalpemilu.org#52762,"TAMBILUK, PETIR, SERANG, BANTEN",7,89,90,179
https://kawalpemilu.org#52762,"TAMBILUK, PETIR, SERANG, BANTEN",8,93,89,182
https://kawalpemilu.org#52762,"TAMBILUK, PETIR, SERANG, BANTEN",9,132,74,206
https://kawalpemilu.org#52762,"TAMBILUK, PETIR, SERANG, BANTEN",10,61,140,201
https://kawalpemilu.org#52762,"TAMBILUK, PETIR, SERANG, BANTEN",11,61,125,186
https://kawalpemilu.org#52762,"TAMBILUK, PETIR, SERANG, BANTEN",12,33,114,147
https://kawalpemilu.org#52762,"TAMBILUK, PETIR, SERANG, BANTEN",13,49,134,183
https://kawalpemilu.org#52762,"TAMBILUK, PETIR, SERANG, BANTEN",14,83,116,199
https://kawalpemilu.org#52762,"TAMBILUK, PETIR, SERANG, BANTEN",15,106,102,208
https://kawalpemilu.org#52762,"TAMBILUK, PETIR, SERANG, BANTEN",16,112,104,216
https://kawalpemilu.org#52762,"TAMBILUK, PETIR, SERANG, BANTEN",17,130,90,220
https://kawalpemilu.org#52762,"TAMBILUK, PETIR, SERANG, BANTEN",18,143,87,230
https://kawalpemilu.org#52762,"TAMBILUK, PETIR, SERANG, BANTEN",19,49,122,171
https://kawalpemilu.org#52762,"TAMBILUK, PETIR, SERANG, BANTEN",20,61,126,187
https://kawalpemilu.org#52762,"TAMBILUK, PETIR, SERANG, BANTEN",21,70,108,178
https://kawalpemilu.org#52762,"TAMBILUK, PETIR, SERANG, BANTEN",22,68,123,191
https://kawalpemilu.org#52763,"SINDANGSARI, PETIR, SERANG, BANTEN",1,36,126,162
https://kawalpemilu.org#52763,"SINDANGSARI, PETIR, SERANG, BANTEN",2,41,177,218
https://kawalpemilu.org#52763,"SINDANGSARI, PETIR, SERANG, BANTEN",3,74,122,196
https://kawalpemilu.org#52763,"SINDANGSARI, PETIR, SERANG, BANTEN",4,36,161,197
https://kawalpemilu.org#52763,"SINDANGSARI, PETIR, SERANG, BANTEN",5,32,146,178
https://kawalpemilu.org#52763,"SINDANGSARI, PETIR, SERANG, BANTEN",6,60,171,231
https://kawalpemilu.org#52763,"SINDANGSARI, PETIR, SERANG, BANTEN",7,70,126,196
https://kawalpemilu.org#52763,"SINDANGSARI, PETIR, SERANG, BANTEN",8,71,171,242
https://kawalpemilu.org#52763,"SINDANGSARI, PETIR, SERANG, BANTEN",9,92,132,224
https://kawalpemilu.org#52763,"SINDANGSARI, PETIR, SERANG, BANTEN",10,28,134,162
https://kawalpemilu.org#52763,"SINDANGSARI, PETIR, SERANG, BANTEN",11,47,148,195
https://kawalpemilu.org#52763,"SINDANGSARI, PETIR, SERANG, BANTEN",12,51,129,180
https://kawalpemilu.org#52763,"SINDANGSARI, PETIR, SERANG, BANTEN",13,58,113,171
https://kawalpemilu.org#52763,"SINDANGSARI, PETIR, SERANG, BANTEN",14,34,138,172
https://kawalpemilu.org#52763,"SINDANGSARI, PETIR, SERANG, BANTEN",15,55,89,144
https://kawalpemilu.org#52763,"SINDANGSARI, PETIR, SERANG, BANTEN",16,33,154,187
https://kawalpemilu.org#52763,"SINDANGSARI, PETIR, SERANG, BANTEN",17,51,122,173
https://kawalpemilu.org#52764,"PADASUKA, PETIR, SERANG, BANTEN",1,37,143,180
https://kawalpemilu.org#52764,"PADASUKA, PETIR, SERANG, BANTEN",2,58,154,212
https://kawalpemilu.org#52764,"PADASUKA, PETIR, SERANG, BANTEN",3,36,164,200
https://kawalpemilu.org#52764,"PADASUKA, PETIR, SERANG, BANTEN",4,37,188,225
https://kawalpemilu.org#52764,"PADASUKA, PETIR, SERANG, BANTEN",5,42,113,155
https://kawalpemilu.org#52764,"PADASUKA, PETIR, SERANG, BANTEN",6,62,140,202
https://kawalpemilu.org#52764,"PADASUKA, PETIR, SERANG, BANTEN",7,82,127,209
https://kawalpemilu.org#52764,"PADASUKA, PETIR, SERANG, BANTEN",8,70,144,214
https://kawalpemilu.org#52765,"SEUAT, PETIR, SERANG, BANTEN",1,30,129,159
https://kawalpemilu.org#52765,"SEUAT, PETIR, SERANG, BANTEN",2,42,165,207
https://kawalpemilu.org#52765,"SEUAT, PETIR, SERANG, BANTEN",3,89,115,204
https://kawalpemilu.org#52765,"SEUAT, PETIR, SERANG, BANTEN",4,81,91,172
https://kawalpemilu.org#52765,"SEUAT, PETIR, SERANG, BANTEN",5,45,137,182
https://kawalpemilu.org#52765,"SEUAT, PETIR, SERANG, BANTEN",6,48,131,179
https://kawalpemilu.org#52765,"SEUAT, PETIR, SERANG, BANTEN",7,53,78,131
https://kawalpemilu.org#52765,"SEUAT, PETIR, SERANG, BANTEN",8,76,51,127
https://kawalpemilu.org#52765,"SEUAT, PETIR, SERANG, BANTEN",9,36,157,193
https://kawalpemilu.org#52765,"SEUAT, PETIR, SERANG, BANTEN",10,30,145,174
https://kawalpemilu.org#52765,"SEUAT, PETIR, SERANG, BANTEN",11,35,162,197
https://kawalpemilu.org#52765,"SEUAT, PETIR, SERANG, BANTEN",12,59,111,170
https://kawalpemilu.org#52766,"NAGARAPADANG, PETIR, SERANG, BANTEN",1,88,120,208
https://kawalpemilu.org#52766,"NAGARAPADANG, PETIR, SERANG, BANTEN",2,79,108,187
https://kawalpemilu.org#52766,"NAGARAPADANG, PETIR, SERANG, BANTEN",3,105,120,225
https://kawalpemilu.org#52766,"NAGARAPADANG, PETIR, SERANG, BANTEN",4,109,108,217
https://kawalpemilu.org#52766,"NAGARAPADANG, PETIR, SERANG, BANTEN",5,64,166,230
https://kawalpemilu.org#52766,"NAGARAPADANG, PETIR, SERANG, BANTEN",6,66,101,167
https://kawalpemilu.org#52766,"NAGARAPADANG, PETIR, SERANG, BANTEN",7,86,109,195
https://kawalpemilu.org#52766,"NAGARAPADANG, PETIR, SERANG, BANTEN",8,55,114,169
https://kawalpemilu.org#52766,"NAGARAPADANG, PETIR, SERANG, BANTEN",9,78,105,183
https://kawalpemilu.org#52766,"NAGARAPADANG, PETIR, SERANG, BANTEN",10,52,96,148
https://kawalpemilu.org#52766,"NAGARAPADANG, PETIR, SERANG, BANTEN",11,52,126,178
https://kawalpemilu.org#52766,"NAGARAPADANG, PETIR, SERANG, BANTEN",12,39,180,219
https://kawalpemilu.org#52766,"NAGARAPADANG, PETIR, SERANG, BANTEN",13,41,81,122
https://kawalpemilu.org#52767,"KADUGENEP, PETIR, SERANG, BANTEN",1,63,114,177
https://kawalpemilu.org#52767,"KADUGENEP, PETIR, SERANG, BANTEN",2,62,132,194
https://kawalpemilu.org#52767,"KADUGENEP, PETIR, SERANG, BANTEN",3,40,162,202
https://kawalpemilu.org#52767,"KADUGENEP, PETIR, SERANG, BANTEN",4,76,121,197
https://kawalpemilu.org#52767,"KADUGENEP, PETIR, SERANG, BANTEN",5,129,93,222
https://kawalpemilu.org#52767,"KADUGENEP, PETIR, SERANG, BANTEN",6,95,152,247
https://kawalpemilu.org#52767,"KADUGENEP, PETIR, SERANG, BANTEN",7,69,114,183
https://kawalpemilu.org#52767,"KADUGENEP, PETIR, SERANG, BANTEN",8,84,128,212
https://kawalpemilu.org#52767,"KADUGENEP, PETIR, SERANG, BANTEN",9,77,114,191
https://kawalpemilu.org#52767,"KADUGENEP, PETIR, SERANG, BANTEN",10,70,86,156
https://kawalpemilu.org#52767,"KADUGENEP, PETIR, SERANG, BANTEN",11,80,101,181
https://kawalpemilu.org#52768,"CIREUNDEU, PETIR, SERANG, BANTEN",1,68,123,191
https://kawalpemilu.org#52768,"CIREUNDEU, PETIR, SERANG, BANTEN",2,56,155,211
https://kawalpemilu.org#52768,"CIREUNDEU, PETIR, SERANG, BANTEN",3,93,121,214
https://kawalpemilu.org#52768,"CIREUNDEU, PETIR, SERANG, BANTEN",4,86,146,232
https://kawalpemilu.org#52768,"CIREUNDEU, PETIR, SERANG, BANTEN",5,59,159,218
https://kawalpemilu.org#52768,"CIREUNDEU, PETIR, SERANG, BANTEN",6,37,184,221
https://kawalpemilu.org#52768,"CIREUNDEU, PETIR, SERANG, BANTEN",7,78,126,204
https://kawalpemilu.org#52768,"CIREUNDEU, PETIR, SERANG, BANTEN",8,92,117,209
https://kawalpemilu.org#52769,"SANDING, PETIR, SERANG, BANTEN",1,55,151,206
https://kawalpemilu.org#52769,"SANDING, PETIR, SERANG, BANTEN",2,37,153,190
https://kawalpemilu.org#52769,"SANDING, PETIR, SERANG, BANTEN",3,24,178,202
https://kawalpemilu.org#52769,"SANDING, PETIR, SERANG, BANTEN",4,69,127,196
https://kawalpemilu.org#52769,"SANDING, PETIR, SERANG, BANTEN",5,59,156,215
https://kawalpemilu.org#52769,"SANDING, PETIR, SERANG, BANTEN",6,72,120,192
https://kawalpemilu.org#52769,"SANDING, PETIR, SERANG, BANTEN",7,74,127,201
https://kawalpemilu.org#52769,"SANDING, PETIR, SERANG, BANTEN",8,72,79,151
https://kawalpemilu.org#52769,"SANDING, PETIR, SERANG, BANTEN",9,43,143,186
https://kawalpemilu.org#52770,"KAMPUNG BARU, PETIR, SERANG, BANTEN",1,36,146,182
https://kawalpemilu.org#52770,"KAMPUNG BARU, PETIR, SERANG, BANTEN",2,63,137,200
https://kawalpemilu.org#52770,"KAMPUNG BARU, PETIR, SERANG, BANTEN",3,74,112,186
https://kawalpemilu.org#52770,"KAMPUNG BARU, PETIR, SERANG, BANTEN",5,72,198,270
https://kawalpemilu.org#52770,"KAMPUNG BARU, PETIR, SERANG, BANTEN",6,92,120,212
https://kawalpemilu.org#52770,"KAMPUNG BARU, PETIR, SERANG, BANTEN",7,42,175,217
https://kawalpemilu.org#52770,"KAMPUNG BARU, PETIR, SERANG, BANTEN",8,41,121,162
https://kawalpemilu.org#52771,"MEKAR BARU, PETIR, SERANG, BANTEN",1,61,157,218
https://kawalpemilu.org#52771,"MEKAR BARU, PETIR, SERANG, BANTEN",2,75,160,235
https://kawalpemilu.org#52771,"MEKAR BARU, PETIR, SERANG, BANTEN",3,45,157,202
https://kawalpemilu.org#52771,"MEKAR BARU, PETIR, SERANG, BANTEN",4,63,158,221
https://kawalpemilu.org#52771,"MEKAR BARU, PETIR, SERANG, BANTEN",5,63,157,220
https://kawalpemilu.org#52771,"MEKAR BARU, PETIR, SERANG, BANTEN",6,36,152,188
https://kawalpemilu.org#52771,"MEKAR BARU, PETIR, SERANG, BANTEN",7,78,152,230
https://kawalpemilu.org#52771,"MEKAR BARU, PETIR, SERANG, BANTEN",8,51,155,206
https://kawalpemilu.org#52771,"MEKAR BARU, PETIR, SERANG, BANTEN",9,89,81,170
https://kawalpemilu.org#52771,"MEKAR BARU, PETIR, SERANG, BANTEN",10,98,107,205
https://kawalpemilu.org#52771,"MEKAR BARU, PETIR, SERANG, BANTEN",11,89,106,195
https://kawalpemilu.org#52771,"MEKAR BARU, PETIR, SERANG, BANTEN",12,67,129,196
https://kawalpemilu.org#52771,"MEKAR BARU, PETIR, SERANG, BANTEN",13,64,158,222
https://kawalpemilu.org#52771,"MEKAR BARU, PETIR, SERANG, BANTEN",14,77,124,201
https://kawalpemilu.org#52772,"SEUAT JAYA, PETIR, SERANG, BANTEN",1,94,128,222
https://kawalpemilu.org#52772,"SEUAT JAYA, PETIR, SERANG, BANTEN",2,25,174,199
https://kawalpemilu.org#52772,"SEUAT JAYA, PETIR, SERANG, BANTEN",3,50,127,177
https://kawalpemilu.org#52772,"SEUAT JAYA, PETIR, SERANG, BANTEN",4,54,133,187
https://kawalpemilu.org#52772,"SEUAT JAYA, PETIR, SERANG, BANTEN",5,47,131,178
https://kawalpemilu.org#52772,"SEUAT JAYA, PETIR, SERANG, BANTEN",6,55,185,240
https://kawalpemilu.org#52772,"SEUAT JAYA, PETIR, SERANG, BANTEN",7,63,162,225
https://kawalpemilu.org#52772,"SEUAT JAYA, PETIR, SERANG, BANTEN",8,41,208,249
https://kawalpemilu.org#89641,"KUBANG JAYA, PETIR, SERANG, BANTEN",1,32,160,192
https://kawalpemilu.org#89641,"KUBANG JAYA, PETIR, SERANG, BANTEN",2,44,141,185
https://kawalpemilu.org#89641,"KUBANG JAYA, PETIR, SERANG, BANTEN",3,36,182,218
https://kawalpemilu.org#89641,"KUBANG JAYA, PETIR, SERANG, BANTEN",4,75,117,192
https://kawalpemilu.org#89641,"KUBANG JAYA, PETIR, SERANG, BANTEN",5,57,128,185
https://kawalpemilu.org#89641,"KUBANG JAYA, PETIR, SERANG, BANTEN",6,55,156,211
https://kawalpemilu.org#89641,"KUBANG JAYA, PETIR, SERANG, BANTEN",7,61,148,209
https://kawalpemilu.org#89641,"KUBANG JAYA, PETIR, SERANG, BANTEN",8,49,160,209
https://kawalpemilu.org#89641,"KUBANG JAYA, PETIR, SERANG, BANTEN",9,36,178,214
https://kawalpemilu.org#89641,"KUBANG JAYA, PETIR, SERANG, BANTEN",10,76,107,183
https://kawalpemilu.org#89642,"BOJONG NANGKA, PETIR, SERANG, BANTEN",1,50,111,161
https://kawalpemilu.org#89642,"BOJONG NANGKA, PETIR, SERANG, BANTEN",2,56,101,157
https://kawalpemilu.org#89642,"BOJONG NANGKA, PETIR, SERANG, BANTEN",3,48,140,188
https://kawalpemilu.org#89642,"BOJONG NANGKA, PETIR, SERANG, BANTEN",4,82,147,229
https://kawalpemilu.org#89642,"BOJONG NANGKA, PETIR, SERANG, BANTEN",5,62,159,221
https://kawalpemilu.org#89642,"BOJONG NANGKA, PETIR, SERANG, BANTEN",6,21,211,232
https://kawalpemilu.org#52774,"TANJUNG TEJA, TUNJUNG TEJA, SERANG, BANTEN",1,41,139,180
https://kawalpemilu.org#52774,"TANJUNG TEJA, TUNJUNG TEJA, SERANG, BANTEN",2,54,141,195
https://kawalpemilu.org#52774,"TANJUNG TEJA, TUNJUNG TEJA, SERANG, BANTEN",3,64,106,170
https://kawalpemilu.org#52774,"TANJUNG TEJA, TUNJUNG TEJA, SERANG, BANTEN",4,60,153,213
https://kawalpemilu.org#52774,"TANJUNG TEJA, TUNJUNG TEJA, SERANG, BANTEN",5,83,142,225
https://kawalpemilu.org#52774,"TANJUNG TEJA, TUNJUNG TEJA, SERANG, BANTEN",6,79,113,192
https://kawalpemilu.org#52774,"TANJUNG TEJA, TUNJUNG TEJA, SERANG, BANTEN",7,85,127,212
https://kawalpemilu.org#52774,"TANJUNG TEJA, TUNJUNG TEJA, SERANG, BANTEN",8,85,94,179
https://kawalpemilu.org#52774,"TANJUNG TEJA, TUNJUNG TEJA, SERANG, BANTEN",9,99,91,190
https://kawalpemilu.org#52774,"TANJUNG TEJA, TUNJUNG TEJA, SERANG, BANTEN",10,76,108,184
https://kawalpemilu.org#52774,"TANJUNG TEJA, TUNJUNG TEJA, SERANG, BANTEN",11,52,175,227
https://kawalpemilu.org#52774,"TANJUNG TEJA, TUNJUNG TEJA, SERANG, BANTEN",12,41,149,190
https://kawalpemilu.org#52774,"TANJUNG TEJA, TUNJUNG TEJA, SERANG, BANTEN",13,67,109,176
https://kawalpemilu.org#52774,"TANJUNG TEJA, TUNJUNG TEJA, SERANG, BANTEN",14,74,137,211
https://kawalpemilu.org#52775,"SUKASARI, TUNJUNG TEJA, SERANG, BANTEN",1,59,149,208
https://kawalpemilu.org#52775,"SUKASARI, TUNJUNG TEJA, SERANG, BANTEN",2,66,132,198
https://kawalpemilu.org#52775,"SUKASARI, TUNJUNG TEJA, SERANG, BANTEN",3,59,159,218
https://kawalpemilu.org#52775,"SUKASARI, TUNJUNG TEJA, SERANG, BANTEN",4,79,104,183
https://kawalpemilu.org#52775,"SUKASARI, TUNJUNG TEJA, SERANG, BANTEN",5,60,147,207
https://kawalpemilu.org#52775,"SUKASARI, TUNJUNG TEJA, SERANG, BANTEN",6,72,145,217
https://kawalpemilu.org#52775,"SUKASARI, TUNJUNG TEJA, SERANG, BANTEN",7,71,139,210
https://kawalpemilu.org#52775,"SUKASARI, TUNJUNG TEJA, SERANG, BANTEN",8,71,95,166
https://kawalpemilu.org#52775,"SUKASARI, TUNJUNG TEJA, SERANG, BANTEN",9,38,124,162
https://kawalpemilu.org#52775,"SUKASARI, TUNJUNG TEJA, SERANG, BANTEN",10,73,173,210
https://kawalpemilu.org#52775,"SUKASARI, TUNJUNG TEJA, SERANG, BANTEN",11,63,129,192
https://kawalpemilu.org#52775,"SUKASARI, TUNJUNG TEJA, SERANG, BANTEN",12,50,152,202
https://kawalpemilu.org#52775,"SUKASARI, TUNJUNG TEJA, SERANG, BANTEN",13,94,117,211
https://kawalpemilu.org#52775,"SUKASARI, TUNJUNG TEJA, SERANG, BANTEN",14,85,90,175
https://kawalpemilu.org#52775,"SUKASARI, TUNJUNG TEJA, SERANG, BANTEN",15,118,96,214
https://kawalpemilu.org#52775,"SUKASARI, TUNJUNG TEJA, SERANG, BANTEN",16,121,92,213
https://kawalpemilu.org#52775,"SUKASARI, TUNJUNG TEJA, SERANG, BANTEN",17,66,146,212
https://kawalpemilu.org#52775,"SUKASARI, TUNJUNG TEJA, SERANG, BANTEN",18,75,102,176
https://kawalpemilu.org#52775,"SUKASARI, TUNJUNG TEJA, SERANG, BANTEN",19,62,101,163
https://kawalpemilu.org#52776,"PANUNGGULAN, TUNJUNG TEJA, SERANG, BANTEN",1,69,119,188
https://kawalpemilu.org#52776,"PANUNGGULAN, TUNJUNG TEJA, SERANG, BANTEN",2,68,116,184
https://kawalpemilu.org#52776,"PANUNGGULAN, TUNJUNG TEJA, SERANG, BANTEN",3,116,80,196
https://kawalpemilu.org#52776,"PANUNGGULAN, TUNJUNG TEJA, SERANG, BANTEN",4,65,142,207
https://kawalpemilu.org#52776,"PANUNGGULAN, TUNJUNG TEJA, SERANG, BANTEN",5,69,129,98
https://kawalpemilu.org#52776,"PANUNGGULAN, TUNJUNG TEJA, SERANG, BANTEN",6,114,99,213
https://kawalpemilu.org#52776,"PANUNGGULAN, TUNJUNG TEJA, SERANG, BANTEN",7,87,101,188
https://kawalpemilu.org#52776,"PANUNGGULAN, TUNJUNG TEJA, SERANG, BANTEN",8,66,139,205
https://kawalpemilu.org#52776,"PANUNGGULAN, TUNJUNG TEJA, SERANG, BANTEN",9,31,143,174
https://kawalpemilu.org#52776,"PANUNGGULAN, TUNJUNG TEJA, SERANG, BANTEN",10,85,121,206
https://kawalpemilu.org#52776,"PANUNGGULAN, TUNJUNG TEJA, SERANG, BANTEN",11,86,122,208
https://kawalpemilu.org#52776,"PANUNGGULAN, TUNJUNG TEJA, SERANG, BANTEN",12,64,112,176
https://kawalpemilu.org#52776,"PANUNGGULAN, TUNJUNG TEJA, SERANG, BANTEN",13,69,143,212
https://kawalpemilu.org#52776,"PANUNGGULAN, TUNJUNG TEJA, SERANG, BANTEN",14,49,137,186
https://kawalpemilu.org#52776,"PANUNGGULAN, TUNJUNG TEJA, SERANG, BANTEN",15,59,139,198
https://kawalpemilu.org#52776,"PANUNGGULAN, TUNJUNG TEJA, SERANG, BANTEN",16,96,88,184
https://kawalpemilu.org#52777,"MALANGGAH, TUNJUNG TEJA, SERANG, BANTEN",1,69,154,223
https://kawalpemilu.org#52777,"MALANGGAH, TUNJUNG TEJA, SERANG, BANTEN",2,66,196,262
https://kawalpemilu.org#52777,"MALANGGAH, TUNJUNG TEJA, SERANG, BANTEN",3,68,166,234
https://kawalpemilu.org#52777,"MALANGGAH, TUNJUNG TEJA, SERANG, BANTEN",4,69,151,220
https://kawalpemilu.org#52777,"MALANGGAH, TUNJUNG TEJA, SERANG, BANTEN",5,74,143,217
https://kawalpemilu.org#52777,"MALANGGAH, TUNJUNG TEJA, SERANG, BANTEN",6,71,143,214
https://kawalpemilu.org#52777,"MALANGGAH, TUNJUNG TEJA, SERANG, BANTEN",7,84,140,224
https://kawalpemilu.org#52777,"MALANGGAH, TUNJUNG TEJA, SERANG, BANTEN",9,47,176,223
https://kawalpemilu.org#52777,"MALANGGAH, TUNJUNG TEJA, SERANG, BANTEN",10,85,114,199
https://kawalpemilu.org#52777,"MALANGGAH, TUNJUNG TEJA, SERANG, BANTEN",11,75,138,213
https://kawalpemilu.org#52777,"MALANGGAH, TUNJUNG TEJA, SERANG, BANTEN",12,91,105,196
https://kawalpemilu.org#52777,"MALANGGAH, TUNJUNG TEJA, SERANG, BANTEN",13,68,150,218
https://kawalpemilu.org#52777,"MALANGGAH, TUNJUNG TEJA, SERANG, BANTEN",14,0,0,0
https://kawalpemilu.org#52777,"MALANGGAH, TUNJUNG TEJA, SERANG, BANTEN",15,138,77,215
https://kawalpemilu.org#52777,"MALANGGAH, TUNJUNG TEJA, SERANG, BANTEN",17,65,114,178
https://kawalpemilu.org#52777,"MALANGGAH, TUNJUNG TEJA, SERANG, BANTEN",19,91,78,169
https://kawalpemilu.org#52777,"MALANGGAH, TUNJUNG TEJA, SERANG, BANTEN",20,86,88,174
https://kawalpemilu.org#52778,"KEMUNING, TUNJUNG TEJA, SERANG, BANTEN",1,33,163,196
https://kawalpemilu.org#52778,"KEMUNING, TUNJUNG TEJA, SERANG, BANTEN",2,37,149,186
https://kawalpemilu.org#52778,"KEMUNING, TUNJUNG TEJA, SERANG, BANTEN",3,38,196,234
https://kawalpemilu.org#52778,"KEMUNING, TUNJUNG TEJA, SERANG, BANTEN",4,13,188,201
https://kawalpemilu.org#52778,"KEMUNING, TUNJUNG TEJA, SERANG, BANTEN",5,55,169,224
https://kawalpemilu.org#52778,"KEMUNING, TUNJUNG TEJA, SERANG, BANTEN",6,51,174,225
https://kawalpemilu.org#52778,"KEMUNING, TUNJUNG TEJA, SERANG, BANTEN",7,90,128,218
https://kawalpemilu.org#52778,"KEMUNING, TUNJUNG TEJA, SERANG, BANTEN",8,71,94,165
https://kawalpemilu.org#52778,"KEMUNING, TUNJUNG TEJA, SERANG, BANTEN",9,124,91,215
https://kawalpemilu.org#52778,"KEMUNING, TUNJUNG TEJA, SERANG, BANTEN",10,118,102,220
https://kawalpemilu.org#52778,"KEMUNING, TUNJUNG TEJA, SERANG, BANTEN",11,98,89,187
https://kawalpemilu.org#52779,"BOJONG MENTENG, TUNJUNG TEJA, SERANG, BANTEN",1,52,143,195
https://kawalpemilu.org#52779,"BOJONG MENTENG, TUNJUNG TEJA, SERANG, BANTEN",2,61,107,168
https://kawalpemilu.org#52779,"BOJONG MENTENG, TUNJUNG TEJA, SERANG, BANTEN",3,64,117,181
https://kawalpemilu.org#52779,"BOJONG MENTENG, TUNJUNG TEJA, SERANG, BANTEN",4,46,146,192
https://kawalpemilu.org#52779,"BOJONG MENTENG, TUNJUNG TEJA, SERANG, BANTEN",5,53,149,202
https://kawalpemilu.org#52779,"BOJONG MENTENG, TUNJUNG TEJA, SERANG, BANTEN",6,38,153,191
https://kawalpemilu.org#52779,"BOJONG MENTENG, TUNJUNG TEJA, SERANG, BANTEN",7,55,167,222
https://kawalpemilu.org#52779,"BOJONG MENTENG, TUNJUNG TEJA, SERANG, BANTEN",8,34,134,168
https://kawalpemilu.org#52779,"BOJONG MENTENG, TUNJUNG TEJA, SERANG, BANTEN",9,44,39,83
https://kawalpemilu.org#52779,"BOJONG MENTENG, TUNJUNG TEJA, SERANG, BANTEN",10,56,78,134
https://kawalpemilu.org#52779,"BOJONG MENTENG, TUNJUNG TEJA, SERANG, BANTEN",11,53,118,171
https://kawalpemilu.org#52779,"BOJONG MENTENG, TUNJUNG TEJA, SERANG, BANTEN",12,37,74,111
https://kawalpemilu.org#52779,"BOJONG MENTENG, TUNJUNG TEJA, SERANG, BANTEN",13,71,91,162
https://kawalpemilu.org#52780,"BOJONG CATANG, TUNJUNG TEJA, SERANG, BANTEN",1,62,148,210
https://kawalpemilu.org#52780,"BOJONG CATANG, TUNJUNG TEJA, SERANG, BANTEN",2,82,142,224
https://kawalpemilu.org#52780,"BOJONG CATANG, TUNJUNG TEJA, SERANG, BANTEN",3,57,136,193
https://kawalpemilu.org#52780,"BOJONG CATANG, TUNJUNG TEJA, SERANG, BANTEN",4,83,120,203
https://kawalpemilu.org#52780,"BOJONG CATANG, TUNJUNG TEJA, SERANG, BANTEN",5,71,118,189
https://kawalpemilu.org#52780,"BOJONG CATANG, TUNJUNG TEJA, SERANG, BANTEN",6,48,132,180
https://kawalpemilu.org#52780,"BOJONG CATANG, TUNJUNG TEJA, SERANG, BANTEN",7,105,111,216
https://kawalpemilu.org#52780,"BOJONG CATANG, TUNJUNG TEJA, SERANG, BANTEN",8,87,132,219
https://kawalpemilu.org#52780,"BOJONG CATANG, TUNJUNG TEJA, SERANG, BANTEN",9,66,112,178
https://kawalpemilu.org#52780,"BOJONG CATANG, TUNJUNG TEJA, SERANG, BANTEN",10,52,151,203
https://kawalpemilu.org#52780,"BOJONG CATANG, TUNJUNG TEJA, SERANG, BANTEN",11,27,148,175
https://kawalpemilu.org#52780,"BOJONG CATANG, TUNJUNG TEJA, SERANG, BANTEN",12,59,99,158
https://kawalpemilu.org#52780,"BOJONG CATANG, TUNJUNG TEJA, SERANG, BANTEN",13,129,71,200
https://kawalpemilu.org#52780,"BOJONG CATANG, TUNJUNG TEJA, SERANG, BANTEN",14,52,152,204
https://kawalpemilu.org#52780,"BOJONG CATANG, TUNJUNG TEJA, SERANG, BANTEN",15,54,161,215
https://kawalpemilu.org#52781,"BOJONG PANDAN, TUNJUNG TEJA, SERANG, BANTEN",1,64,131,195
https://kawalpemilu.org#52781,"BOJONG PANDAN, TUNJUNG TEJA, SERANG, BANTEN",2,60,163,224
https://kawalpemilu.org#52781,"BOJONG PANDAN, TUNJUNG TEJA, SERANG, BANTEN",3,0,0,0
https://kawalpemilu.org#52781,"BOJONG PANDAN, TUNJUNG TEJA, SERANG, BANTEN",4,96,114,210
https://kawalpemilu.org#52781,"BOJONG PANDAN, TUNJUNG TEJA, SERANG, BANTEN",5,57,148,205
https://kawalpemilu.org#52781,"BOJONG PANDAN, TUNJUNG TEJA, SERANG, BANTEN",6,36,178,214
https://kawalpemilu.org#52781,"BOJONG PANDAN, TUNJUNG TEJA, SERANG, BANTEN",7,25,208,233
https://kawalpemilu.org#52781,"BOJONG PANDAN, TUNJUNG TEJA, SERANG, BANTEN",8,41,157,198
https://kawalpemilu.org#52781,"BOJONG PANDAN, TUNJUNG TEJA, SERANG, BANTEN",9,95,98,193
https://kawalpemilu.org#52781,"BOJONG PANDAN, TUNJUNG TEJA, SERANG, BANTEN",10,70,121,191
https://kawalpemilu.org#52781,"BOJONG PANDAN, TUNJUNG TEJA, SERANG, BANTEN",11,63,128,191
https://kawalpemilu.org#52781,"BOJONG PANDAN, TUNJUNG TEJA, SERANG, BANTEN",12,67,127,194
https://kawalpemilu.org#52781,"BOJONG PANDAN, TUNJUNG TEJA, SERANG, BANTEN",13,53,113,166
https://kawalpemilu.org#52781,"BOJONG PANDAN, TUNJUNG TEJA, SERANG, BANTEN",14,88,95,183
https://kawalpemilu.org#52781,"BOJONG PANDAN, TUNJUNG TEJA, SERANG, BANTEN",15,59,120,179
https://kawalpemilu.org#52781,"BOJONG PANDAN, TUNJUNG TEJA, SERANG, BANTEN",16,57,158,215
https://kawalpemilu.org#52781,"BOJONG PANDAN, TUNJUNG TEJA, SERANG, BANTEN",17,65,114,178
https://kawalpemilu.org#52782,"PANCAREGANG, TUNJUNG TEJA, SERANG, BANTEN",1,43,140,183
https://kawalpemilu.org#52782,"PANCAREGANG, TUNJUNG TEJA, SERANG, BANTEN",2,101,101,202
https://kawalpemilu.org#52782,"PANCAREGANG, TUNJUNG TEJA, SERANG, BANTEN",3,70,111,181
https://kawalpemilu.org#52782,"PANCAREGANG, TUNJUNG TEJA, SERANG, BANTEN",4,65,139,204
https://kawalpemilu.org#52782,"PANCAREGANG, TUNJUNG TEJA, SERANG, BANTEN",5,55,130,185
https://kawalpemilu.org#52782,"PANCAREGANG, TUNJUNG TEJA, SERANG, BANTEN",6,55,148,203
https://kawalpemilu.org#52782,"PANCAREGANG, TUNJUNG TEJA, SERANG, BANTEN",7,61,149,210
https://kawalpemilu.org#52784,"BAROS, BAROS, SERANG, BANTEN",1,48,194,242
https://kawalpemilu.org#52784,"BAROS, BAROS, SERANG, BANTEN",2,49,201,250
https://kawalpemilu.org#52784,"BAROS, BAROS, SERANG, BANTEN",3,29,174,203
https://kawalpemilu.org#52784,"BAROS, BAROS, SERANG, BANTEN",4,72,166,238
https://kawalpemilu.org#52784,"BAROS, BAROS, SERANG, BANTEN",5,78,121,199
https://kawalpemilu.org#52784,"BAROS, BAROS, SERANG, BANTEN",6,66,146,212
https://kawalpemilu.org#52784,"BAROS, BAROS, SERANG, BANTEN",7,51,194,245
https://kawalpemilu.org#52784,"BAROS, BAROS, SERANG, BANTEN",8,46,179,225
https://kawalpemilu.org#52784,"BAROS, BAROS, SERANG, BANTEN",9,94,129,223
https://kawalpemilu.org#52784,"BAROS, BAROS, SERANG, BANTEN",10,81,167,248
https://kawalpemilu.org#52784,"BAROS, BAROS, SERANG, BANTEN",11,35,203,238
https://kawalpemilu.org#52784,"BAROS, BAROS, SERANG, BANTEN",12,53,166,219
https://kawalpemilu.org#52784,"BAROS, BAROS, SERANG, BANTEN",13,52,185,237
https://kawalpemilu.org#52784,"BAROS, BAROS, SERANG, BANTEN",14,58,133,191
https://kawalpemilu.org#52784,"BAROS, BAROS, SERANG, BANTEN",15,91,95,186
https://kawalpemilu.org#52784,"BAROS, BAROS, SERANG, BANTEN",16,59,146,205
https://kawalpemilu.org#52785,"TEJAMARI, BAROS, SERANG, BANTEN",1,65,179,244
https://kawalpemilu.org#52785,"TEJAMARI, BAROS, SERANG, BANTEN",2,70,160,230
https://kawalpemilu.org#52785,"TEJAMARI, BAROS, SERANG, BANTEN",3,62,166,228
https://kawalpemilu.org#52785,"TEJAMARI, BAROS, SERANG, BANTEN",4,58,144,202
https://kawalpemilu.org#52785,"TEJAMARI, BAROS, SERANG, BANTEN",5,44,165,209
https://kawalpemilu.org#52785,"TEJAMARI, BAROS, SERANG, BANTEN",6,44,164,208
https://kawalpemilu.org#52785,"TEJAMARI, BAROS, SERANG, BANTEN",7,41,105,146
https://kawalpemilu.org#52785,"TEJAMARI, BAROS, SERANG, BANTEN",8,26,136,162
https://kawalpemilu.org#52785,"TEJAMARI, BAROS, SERANG, BANTEN",9,27,112,139
https://kawalpemilu.org#52785,"TEJAMARI, BAROS, SERANG, BANTEN",10,36,95,131
https://kawalpemilu.org#52785,"TEJAMARI, BAROS, SERANG, BANTEN",11,52,84,136
https://kawalpemilu.org#52786,"PANYIRAPAN, BAROS, SERANG, BANTEN",1,40,163,203
https://kawalpemilu.org#52786,"PANYIRAPAN, BAROS, SERANG, BANTEN",2,51,172,223
https://kawalpemilu.org#52786,"PANYIRAPAN, BAROS, SERANG, BANTEN",3,69,94,163
https://kawalpemilu.org#52786,"PANYIRAPAN, BAROS, SERANG, BANTEN",4,19,224,243
https://kawalpemilu.org#52786,"PANYIRAPAN, BAROS, SERANG, BANTEN",5,36,182,218
https://kawalpemilu.org#52786,"PANYIRAPAN, BAROS, SERANG, BANTEN",6,45,154,199
https://kawalpemilu.org#52786,"PANYIRAPAN, BAROS, SERANG, BANTEN",7,55,170,225
https://kawalpemilu.org#52786,"PANYIRAPAN, BAROS, SERANG, BANTEN",8,68,173,241
https://kawalpemilu.org#52786,"PANYIRAPAN, BAROS, SERANG, BANTEN",9,63,145,208
https://kawalpemilu.org#52786,"PANYIRAPAN, BAROS, SERANG, BANTEN",10,28,158,186
https://kawalpemilu.org#52786,"PANYIRAPAN, BAROS, SERANG, BANTEN",11,28,151,179
https://kawalpemilu.org#52786,"PANYIRAPAN, BAROS, SERANG, BANTEN",12,44,165,209
https://kawalpemilu.org#52786,"PANYIRAPAN, BAROS, SERANG, BANTEN",13,42,121,163
https://kawalpemilu.org#52786,"PANYIRAPAN, BAROS, SERANG, BANTEN",14,46,123,169
https://kawalpemilu.org#52786,"PANYIRAPAN, BAROS, SERANG, BANTEN",15,99,146,245
https://kawalpemilu.org#52786,"PANYIRAPAN, BAROS, SERANG, BANTEN",16,42,166,208
https://kawalpemilu.org#52786,"PANYIRAPAN, BAROS, SERANG, BANTEN",17,46,167,213
https://kawalpemilu.org#52787,"SIDAMUKTI, BAROS, SERANG, BANTEN",1,45,170,215
https://kawalpemilu.org#52787,"SIDAMUKTI, BAROS, SERANG, BANTEN",2,48,137,185
https://kawalpemilu.org#52787,"SIDAMUKTI, BAROS, SERANG, BANTEN",3,20,215,235
https://kawalpemilu.org#52787,"SIDAMUKTI, BAROS, SERANG, BANTEN",4,54,177,231
https://kawalpemilu.org#52787,"SIDAMUKTI, BAROS, SERANG, BANTEN",5,76,167,243
https://kawalpemilu.org#52787,"SIDAMUKTI, BAROS, SERANG, BANTEN",6,73,153,226
https://kawalpemilu.org#52787,"SIDAMUKTI, BAROS, SERANG, BANTEN",7,39,138,177
https://kawalpemilu.org#52787,"SIDAMUKTI, BAROS, SERANG, BANTEN",8,49,138,187
https://kawalpemilu.org#52787,"SIDAMUKTI, BAROS, SERANG, BANTEN",9,63,131,194
https://kawalpemilu.org#52787,"SIDAMUKTI, BAROS, SERANG, BANTEN",10,58,118,176
https://kawalpemilu.org#52787,"SIDAMUKTI, BAROS, SERANG, BANTEN",11,62,111,173
https://kawalpemilu.org#52787,"SIDAMUKTI, BAROS, SERANG, BANTEN",12,66,122,188
https://kawalpemilu.org#52787,"SIDAMUKTI, BAROS, SERANG, BANTEN",13,32,97,129
https://kawalpemilu.org#52787,"SIDAMUKTI, BAROS, SERANG, BANTEN",14,62,122,184
https://kawalpemilu.org#52788,"SUKACAI, BAROS, SERANG, BANTEN",1,21,159,180
https://kawalpemilu.org#52788,"SUKACAI, BAROS, SERANG, BANTEN",2,19,160,179
https://kawalpemilu.org#52788,"SUKACAI, BAROS, SERANG, BANTEN",3,24,164,188
https://kawalpemilu.org#52788,"SUKACAI, BAROS, SERANG, BANTEN",4,31,187,218
https://kawalpemilu.org#52788,"SUKACAI, BAROS, SERANG, BANTEN",5,43,91,134
https://kawalpemilu.org#52788,"SUKACAI, BAROS, SERANG, BANTEN",6,85,123,208
https://kawalpemilu.org#52788,"SUKACAI, BAROS, SERANG, BANTEN",7,79,90,169
https://kawalpemilu.org#52788,"SUKACAI, BAROS, SERANG, BANTEN",8,64,86,150
https://kawalpemilu.org#52788,"SUKACAI, BAROS, SERANG, BANTEN",9,20,102,122
https://kawalpemilu.org#52788,"SUKACAI, BAROS, SERANG, BANTEN",10,31,105,136
https://kawalpemilu.org#52788,"SUKACAI, BAROS, SERANG, BANTEN",11,37,94,131
https://kawalpemilu.org#52789,"TAMANSARI, BAROS, SERANG, BANTEN",1,50,161,211
https://kawalpemilu.org#52789,"TAMANSARI, BAROS, SERANG, BANTEN",2,31,157,188
https://kawalpemilu.org#52789,"TAMANSARI, BAROS, SERANG, BANTEN",3,54,186,240
https://kawalpemilu.org#52789,"TAMANSARI, BAROS, SERANG, BANTEN",4,53,160,213
https://kawalpemilu.org#52789,"TAMANSARI, BAROS, SERANG, BANTEN",5,31,129,160
https://kawalpemilu.org#52789,"TAMANSARI, BAROS, SERANG, BANTEN",6,45,158,203
https://kawalpemilu.org#52789,"TAMANSARI, BAROS, SERANG, BANTEN",7,82,121,203
https://kawalpemilu.org#52789,"TAMANSARI, BAROS, SERANG, BANTEN",8,44,181,225
https://kawalpemilu.org#52790,"SINDANGMANDI, BAROS, SERANG, BANTEN",1,22,176,198
https://kawalpemilu.org#52790,"SINDANGMANDI, BAROS, SERANG, BANTEN",2,29,190,219
https://kawalpemilu.org#52790,"SINDANGMANDI, BAROS, SERANG, BANTEN",3,50,90,147
https://kawalpemilu.org#52790,"SINDANGMANDI, BAROS, SERANG, BANTEN",4,49,152,201
https://kawalpemilu.org#52790,"SINDANGMANDI, BAROS, SERANG, BANTEN",5,38,143,181
https://kawalpemilu.org#52790,"SINDANGMANDI, BAROS, SERANG, BANTEN",6,33,133,166
https://kawalpemilu.org#52790,"SINDANGMANDI, BAROS, SERANG, BANTEN",7,86,115,201
https://kawalpemilu.org#52790,"SINDANGMANDI, BAROS, SERANG, BANTEN",8,49,114,163
https://kawalpemilu.org#52790,"SINDANGMANDI, BAROS, SERANG, BANTEN",10,60,114,174
https://kawalpemilu.org#52790,"SINDANGMANDI, BAROS, SERANG, BANTEN",11,89,92,181
https://kawalpemilu.org#52790,"SINDANGMANDI, BAROS, SERANG, BANTEN",12,102,100,202
https://kawalpemilu.org#52790,"SINDANGMANDI, BAROS, SERANG, BANTEN",13,69,143,212
https://kawalpemilu.org#52790,"SINDANGMANDI, BAROS, SERANG, BANTEN",14,74,114,188
https://kawalpemilu.org#52790,"SINDANGMANDI, BAROS, SERANG, BANTEN",15,123,101,224
https://kawalpemilu.org#52790,"SINDANGMANDI, BAROS, SERANG, BANTEN",16,63,119,182
https://kawalpemilu.org#52791,"CISALAM, BAROS, SERANG, BANTEN",1,98,122,220
https://kawalpemilu.org#52791,"CISALAM, BAROS, SERANG, BANTEN",2,64,126,190
https://kawalpemilu.org#52791,"CISALAM, BAROS, SERANG, BANTEN",3,66,108,174
https://kawalpemilu.org#52791,"CISALAM, BAROS, SERANG, BANTEN",4,97,117,214
https://kawalpemilu.org#52791,"CISALAM, BAROS, SERANG, BANTEN",5,79,118,197
https://kawalpemilu.org#52791,"CISALAM, BAROS, SERANG, BANTEN",6,74,151,225
https://kawalpemilu.org#52791,"CISALAM, BAROS, SERANG, BANTEN",7,90,113,203
https://kawalpemilu.org#52791,"CISALAM, BAROS, SERANG, BANTEN",8,82,94,176
https://kawalpemilu.org#52791,"CISALAM, BAROS, SERANG, BANTEN",9,46,176,222
https://kawalpemilu.org#52791,"CISALAM, BAROS, SERANG, BANTEN",10,62,132,194
https://kawalpemilu.org#52791,"CISALAM, BAROS, SERANG, BANTEN",11,25,145,170
https://kawalpemilu.org#52792,"SUKAMANAH, BAROS, SERANG, BANTEN",1,34,97,131
https://kawalpemilu.org#52792,"SUKAMANAH, BAROS, SERANG, BANTEN",2,44,204,248
https://kawalpemilu.org#52792,"SUKAMANAH, BAROS, SERANG, BANTEN",3,42,169,211
https://kawalpemilu.org#52792,"SUKAMANAH, BAROS, SERANG, BANTEN",4,40,169,209
https://kawalpemilu.org#52792,"SUKAMANAH, BAROS, SERANG, BANTEN",5,45,188,233
https://kawalpemilu.org#52792,"SUKAMANAH, BAROS, SERANG, BANTEN",6,64,154,218
https://kawalpemilu.org#52792,"SUKAMANAH, BAROS, SERANG, BANTEN",7,34,110,144
https://kawalpemilu.org#52792,"SUKAMANAH, BAROS, SERANG, BANTEN",8,32,132,164
https://kawalpemilu.org#52792,"SUKAMANAH, BAROS, SERANG, BANTEN",9,31,152,183
https://kawalpemilu.org#52792,"SUKAMANAH, BAROS, SERANG, BANTEN",10,47,150,197
https://kawalpemilu.org#52792,"SUKAMANAH, BAROS, SERANG, BANTEN",11,53,183,236
https://kawalpemilu.org#52792,"SUKAMANAH, BAROS, SERANG, BANTEN",12,48,204,252
https://kawalpemilu.org#52792,"SUKAMANAH, BAROS, SERANG, BANTEN",13,42,162,204
https://kawalpemilu.org#52792,"SUKAMANAH, BAROS, SERANG, BANTEN",14,26,169,195
https://kawalpemilu.org#52792,"SUKAMANAH, BAROS, SERANG, BANTEN",15,45,124,169
https://kawalpemilu.org#52792,"SUKAMANAH, BAROS, SERANG, BANTEN",16,49,141,190
https://kawalpemilu.org#52792,"SUKAMANAH, BAROS, SERANG, BANTEN",17,29,101,130
https://kawalpemilu.org#52792,"SUKAMANAH, BAROS, SERANG, BANTEN",18,26,102,128
https://kawalpemilu.org#52792,"SUKAMANAH, BAROS, SERANG, BANTEN",19,43,67,110
https://kawalpemilu.org#52793,"SUKAMENAK, BAROS, SERANG, BANTEN",1,65,136,201
https://kawalpemilu.org#52793,"SUKAMENAK, BAROS, SERANG, BANTEN",2,52,149,201
https://kawalpemilu.org#52793,"SUKAMENAK, BAROS, SERANG, BANTEN",3,40,154,194
https://kawalpemilu.org#52793,"SUKAMENAK, BAROS, SERANG, BANTEN",4,58,174,232
https://kawalpemilu.org#52793,"SUKAMENAK, BAROS, SERANG, BANTEN",5,25,183,208
https://kawalpemilu.org#52793,"SUKAMENAK, BAROS, SERANG, BANTEN",6,46,161,207
https://kawalpemilu.org#52793,"SUKAMENAK, BAROS, SERANG, BANTEN",7,36,196,232
https://kawalpemilu.org#52793,"SUKAMENAK, BAROS, SERANG, BANTEN",8,69,154,223
https://kawalpemilu.org#52793,"SUKAMENAK, BAROS, SERANG, BANTEN",9,32,126,158
https://kawalpemilu.org#52794,"CURUGAGUNG, BAROS, SERANG, BANTEN",1,38,183,221
https://kawalpemilu.org#52794,"CURUGAGUNG, BAROS, SERANG, BANTEN",2,58,145,203
https://kawalpemilu.org#52794,"CURUGAGUNG, BAROS, SERANG, BANTEN",3,53,124,177
https://kawalpemilu.org#52794,"CURUGAGUNG, BAROS, SERANG, BANTEN",4,42,134,176
https://kawalpemilu.org#52794,"CURUGAGUNG, BAROS, SERANG, BANTEN",5,32,169,201
https://kawalpemilu.org#52794,"CURUGAGUNG, BAROS, SERANG, BANTEN",6,34,137,171
https://kawalpemilu.org#52794,"CURUGAGUNG, BAROS, SERANG, BANTEN",7,20,221,241
https://kawalpemilu.org#52794,"CURUGAGUNG, BAROS, SERANG, BANTEN",8,20,169,189
https://kawalpemilu.org#52795,"PADASUKA, BAROS, SERANG, BANTEN",1,46,186,232
https://kawalpemilu.org#52795,"PADASUKA, BAROS, SERANG, BANTEN",2,82,141,223
https://kawalpemilu.org#52795,"PADASUKA, BAROS, SERANG, BANTEN",3,80,133,213
https://kawalpemilu.org#52795,"PADASUKA, BAROS, SERANG, BANTEN",4,55,147,202
https://kawalpemilu.org#52795,"PADASUKA, BAROS, SERANG, BANTEN",5,45,171,216
https://kawalpemilu.org#52795,"PADASUKA, BAROS, SERANG, BANTEN",6,57,154,211
https://kawalpemilu.org#52795,"PADASUKA, BAROS, SERANG, BANTEN",7,54,161,215
https://kawalpemilu.org#52795,"PADASUKA, BAROS, SERANG, BANTEN",8,98,132,230
https://kawalpemilu.org#52796,"SINARMUKTI, BAROS, SERANG, BANTEN",1,73,114,187
https://kawalpemilu.org#52796,"SINARMUKTI, BAROS, SERANG, BANTEN",2,78,157,235
https://kawalpemilu.org#52796,"SINARMUKTI, BAROS, SERANG, BANTEN",3,69,160,229
https://kawalpemilu.org#52796,"SINARMUKTI, BAROS, SERANG, BANTEN",4,57,161,218
https://kawalpemilu.org#52796,"SINARMUKTI, BAROS, SERANG, BANTEN",5,55,207,262
https://kawalpemilu.org#52796,"SINARMUKTI, BAROS, SERANG, BANTEN",6,97,164,261
https://kawalpemilu.org#52797,"SUKA INDAH, BAROS, SERANG, BANTEN",2,50,180,230
https://kawalpemilu.org#52797,"SUKA INDAH, BAROS, SERANG, BANTEN",3,42,131,173
https://kawalpemilu.org#52797,"SUKA INDAH, BAROS, SERANG, BANTEN",4,32,176,208
https://kawalpemilu.org#52797,"SUKA INDAH, BAROS, SERANG, BANTEN",5,37,139,176
https://kawalpemilu.org#52797,"SUKA INDAH, BAROS, SERANG, BANTEN",6,33,197,230
https://kawalpemilu.org#52797,"SUKA INDAH, BAROS, SERANG, BANTEN",7,37,173,210
https://kawalpemilu.org#52797,"SUKA INDAH, BAROS, SERANG, BANTEN",8,69,200,269
https://kawalpemilu.org#52797,"SUKA INDAH, BAROS, SERANG, BANTEN",9,48,155,203
https://kawalpemilu.org#52797,"SUKA INDAH, BAROS, SERANG, BANTEN",10,24,107,131
https://kawalpemilu.org#52797,"SUKA INDAH, BAROS, SERANG, BANTEN",11,39,135,174
https://kawalpemilu.org#52797,"SUKA INDAH, BAROS, SERANG, BANTEN",12,20,76,96
https://kawalpemilu.org#52799,"CIKEUSAL, CIKEUSAL, SERANG, BANTEN",1,85,151,236
https://kawalpemilu.org#52799,"CIKEUSAL, CIKEUSAL, SERANG, BANTEN",2,70,159,229
https://kawalpemilu.org#52799,"CIKEUSAL, CIKEUSAL, SERANG, BANTEN",3,52,198,250
https://kawalpemilu.org#52799,"CIKEUSAL, CIKEUSAL, SERANG, BANTEN",4,55,184,239
https://kawalpemilu.org#52799,"CIKEUSAL, CIKEUSAL, SERANG, BANTEN",5,67,103,170
https://kawalpemilu.org#52799,"CIKEUSAL, CIKEUSAL, SERANG, BANTEN",6,68,191,259
https://kawalpemilu.org#52799,"CIKEUSAL, CIKEUSAL, SERANG, BANTEN",7,44,183,227
https://kawalpemilu.org#52799,"CIKEUSAL, CIKEUSAL, SERANG, BANTEN",8,77,118,195
https://kawalpemilu.org#52799,"CIKEUSAL, CIKEUSAL, SERANG, BANTEN",9,57,146,203
https://kawalpemilu.org#52799,"CIKEUSAL, CIKEUSAL, SERANG, BANTEN",10,49,154,203
https://kawalpemilu.org#52799,"CIKEUSAL, CIKEUSAL, SERANG, BANTEN",11,67,123,190
https://kawalpemilu.org#52799,"CIKEUSAL, CIKEUSAL, SERANG, BANTEN",12,70,155,225
https://kawalpemilu.org#52799,"CIKEUSAL, CIKEUSAL, SERANG, BANTEN",13,55,194,249
https://kawalpemilu.org#52799,"CIKEUSAL, CIKEUSAL, SERANG, BANTEN",14,32,132,164
https://kawalpemilu.org#52799,"CIKEUSAL, CIKEUSAL, SERANG, BANTEN",15,52,172,224
https://kawalpemilu.org#52799,"CIKEUSAL, CIKEUSAL, SERANG, BANTEN",16,53,190,243
https://kawalpemilu.org#52800,"DAHU, CIKEUSAL, SERANG, BANTEN",1,39,145,184
https://kawalpemilu.org#52800,"DAHU, CIKEUSAL, SERANG, BANTEN",2,55,164,219
https://kawalpemilu.org#52800,"DAHU, CIKEUSAL, SERANG, BANTEN",3,65,165,230
https://kawalpemilu.org#52800,"DAHU, CIKEUSAL, SERANG, BANTEN",4,72,146,218
https://kawalpemilu.org#52800,"DAHU, CIKEUSAL, SERANG, BANTEN",5,56,149,205
https://kawalpemilu.org#52800,"DAHU, CIKEUSAL, SERANG, BANTEN",6,63,140,203
https://kawalpemilu.org#52800,"DAHU, CIKEUSAL, SERANG, BANTEN",7,92,141,233
https://kawalpemilu.org#52800,"DAHU, CIKEUSAL, SERANG, BANTEN",8,52,144,196
https://kawalpemilu.org#52800,"DAHU, CIKEUSAL, SERANG, BANTEN",9,62,127,189
https://kawalpemilu.org#52800,"DAHU, CIKEUSAL, SERANG, BANTEN",10,75,159,234
https://kawalpemilu.org#52800,"DAHU, CIKEUSAL, SERANG, BANTEN",11,71,149,220
https://kawalpemilu.org#52800,"DAHU, CIKEUSAL, SERANG, BANTEN",12,71,127,198
https://kawalpemilu.org#52800,"DAHU, CIKEUSAL, SERANG, BANTEN",13,76,148,224
https://kawalpemilu.org#52800,"DAHU, CIKEUSAL, SERANG, BANTEN",14,52,179,231
https://kawalpemilu.org#52800,"DAHU, CIKEUSAL, SERANG, BANTEN",15,73,163,235
https://kawalpemilu.org#52800,"DAHU, CIKEUSAL, SERANG, BANTEN",16,76,128,204
https://kawalpemilu.org#52801,"KATULISAN, CIKEUSAL, SERANG, BANTEN",1,123,113,236
https://kawalpemilu.org#52801,"KATULISAN, CIKEUSAL, SERANG, BANTEN",2,62,132,194
https://kawalpemilu.org#52801,"KATULISAN, CIKEUSAL, SERANG, BANTEN",3,90,136,226
https://kawalpemilu.org#52801,"KATULISAN, CIKEUSAL, SERANG, BANTEN",4,77,150,227
https://kawalpemilu.org#52801,"KATULISAN, CIKEUSAL, SERANG, BANTEN",5,53,173,226
https://kawalpemilu.org#52801,"KATULISAN, CIKEUSAL, SERANG, BANTEN",6,99,126,225
https://kawalpemilu.org#52801,"KATULISAN, CIKEUSAL, SERANG, BANTEN",7,97,143,240
https://kawalpemilu.org#52801,"KATULISAN, CIKEUSAL, SERANG, BANTEN",8,72,158,230
https://kawalpemilu.org#52802,"SUKAMAJU, CIKEUSAL, SERANG, BANTEN",1,75,145,220
https://kawalpemilu.org#52802,"SUKAMAJU, CIKEUSAL, SERANG, BANTEN",2,54,160,214
https://kawalpemilu.org#52802,"SUKAMAJU, CIKEUSAL, SERANG, BANTEN",3,76,131,207
https://kawalpemilu.org#52802,"SUKAMAJU, CIKEUSAL, SERANG, BANTEN",4,108,135,243
https://kawalpemilu.org#52802,"SUKAMAJU, CIKEUSAL, SERANG, BANTEN",5,101,143,244
https://kawalpemilu.org#52802,"SUKAMAJU, CIKEUSAL, SERANG, BANTEN",6,80,155,235
https://kawalpemilu.org#52802,"SUKAMAJU, CIKEUSAL, SERANG, BANTEN",7,105,108,213
https://kawalpemilu.org#52802,"SUKAMAJU, CIKEUSAL, SERANG, BANTEN",8,92,135,227
https://kawalpemilu.org#52802,"SUKAMAJU, CIKEUSAL, SERANG, BANTEN",9,127,93,220
https://kawalpemilu.org#52802,"SUKAMAJU, CIKEUSAL, SERANG, BANTEN",10,115,110,225
https://kawalpemilu.org#52802,"SUKAMAJU, CIKEUSAL, SERANG, BANTEN",11,66,154,220
https://kawalpemilu.org#52803,"CILAYANG, CIKEUSAL, SERANG, BANTEN",1,82,135,217
https://kawalpemilu.org#52803,"CILAYANG, CIKEUSAL, SERANG, BANTEN",2,93,126,219
https://kawalpemilu.org#52803,"CILAYANG, CIKEUSAL, SERANG, BANTEN",3,84,78,162
https://kawalpemilu.org#52803,"CILAYANG, CIKEUSAL, SERANG, BANTEN",4,71,175,246
https://kawalpemilu.org#52803,"CILAYANG, CIKEUSAL, SERANG, BANTEN",5,43,153,196
https://kawalpemilu.org#52803,"CILAYANG, CIKEUSAL, SERANG, BANTEN",7,63,135,198
https://kawalpemilu.org#52803,"CILAYANG, CIKEUSAL, SERANG, BANTEN",8,78,94,172
https://kawalpemilu.org#52803,"CILAYANG, CIKEUSAL, SERANG, BANTEN",9,78,98,176
https://kawalpemilu.org#52803,"CILAYANG, CIKEUSAL, SERANG, BANTEN",10,113,103,216
https://kawalpemilu.org#52803,"CILAYANG, CIKEUSAL, SERANG, BANTEN",11,105,137,242
https://kawalpemilu.org#52803,"CILAYANG, CIKEUSAL, SERANG, BANTEN",12,105,127,232
https://kawalpemilu.org#52804,"SUKAMENAK, CIKEUSAL, SERANG, BANTEN",1,103,101,204
https://kawalpemilu.org#52804,"SUKAMENAK, CIKEUSAL, SERANG, BANTEN",2,125,80,205
https://kawalpemilu.org#52804,"SUKAMENAK, CIKEUSAL, SERANG, BANTEN",3,84,138,222
https://kawalpemilu.org#52804,"SUKAMENAK, CIKEUSAL, SERANG, BANTEN",4,87,142,229
https://kawalpemilu.org#52804,"SUKAMENAK, CIKEUSAL, SERANG, BANTEN",5,93,149,242
https://kawalpemilu.org#52804,"SUKAMENAK, CIKEUSAL, SERANG, BANTEN",6,78,159,237
https://kawalpemilu.org#52804,"SUKAMENAK, CIKEUSAL, SERANG, BANTEN",7,96,67,163
https://kawalpemilu.org#52804,"SUKAMENAK, CIKEUSAL, SERANG, BANTEN",8,49,151,200
https://kawalpemilu.org#52804,"SUKAMENAK, CIKEUSAL, SERANG, BANTEN",9,41,56,97
https://kawalpemilu.org#52805,"CIMAUNG, CIKEUSAL, SERANG, BANTEN",1,118,126,244
https://kawalpemilu.org#52805,"CIMAUNG, CIKEUSAL, SERANG, BANTEN",2,90,109,199
https://kawalpemilu.org#52805,"CIMAUNG, CIKEUSAL, SERANG, BANTEN",3,0,0,0
https://kawalpemilu.org#52805,"CIMAUNG, CIKEUSAL, SERANG, BANTEN",4,88,135,223
https://kawalpemilu.org#52805,"CIMAUNG, CIKEUSAL, SERANG, BANTEN",5,92,93,185
https://kawalpemilu.org#52805,"CIMAUNG, CIKEUSAL, SERANG, BANTEN",6,101,90,191
https://kawalpemilu.org#52805,"CIMAUNG, CIKEUSAL, SERANG, BANTEN",7,128,120,248
https://kawalpemilu.org#52805,"CIMAUNG, CIKEUSAL, SERANG, BANTEN",8,90,92,182
https://kawalpemilu.org#52805,"CIMAUNG, CIKEUSAL, SERANG, BANTEN",9,96,83,179
https://kawalpemilu.org#52805,"CIMAUNG, CIKEUSAL, SERANG, BANTEN",10,105,123,228
https://kawalpemilu.org#52805,"CIMAUNG, CIKEUSAL, SERANG, BANTEN",11,63,169,232
https://kawalpemilu.org#52805,"CIMAUNG, CIKEUSAL, SERANG, BANTEN",12,89,124,213
https://kawalpemilu.org#52805,"CIMAUNG, CIKEUSAL, SERANG, BANTEN",13,88,125,213
https://kawalpemilu.org#52806,"PANYABRANGAN, CIKEUSAL, SERANG, BANTEN",1,75,109,184
https://kawalpemilu.org#52806,"PANYABRANGAN, CIKEUSAL, SERANG, BANTEN",2,69,159,228
https://kawalpemilu.org#52806,"PANYABRANGAN, CIKEUSAL, SERANG, BANTEN",3,56,163,219
https://kawalpemilu.org#52806,"PANYABRANGAN, CIKEUSAL, SERANG, BANTEN",4,63,163,226
https://kawalpemilu.org#52806,"PANYABRANGAN, CIKEUSAL, SERANG, BANTEN",5,68,97,165
https://kawalpemilu.org#52806,"PANYABRANGAN, CIKEUSAL, SERANG, BANTEN",6,52,179,231
https://kawalpemilu.org#52806,"PANYABRANGAN, CIKEUSAL, SERANG, BANTEN",7,65,171,236
https://kawalpemilu.org#52806,"PANYABRANGAN, CIKEUSAL, SERANG, BANTEN",8,62,164,226
https://kawalpemilu.org#52806,"PANYABRANGAN, CIKEUSAL, SERANG, BANTEN",9,77,164,241
https://kawalpemilu.org#52806,"PANYABRANGAN, CIKEUSAL, SERANG, BANTEN",10,83,127,210
https://kawalpemilu.org#52806,"PANYABRANGAN, CIKEUSAL, SERANG, BANTEN",11,95,135,230
https://kawalpemilu.org#52806,"PANYABRANGAN, CIKEUSAL, SERANG, BANTEN",12,114,82,196
https://kawalpemilu.org#52806,"PANYABRANGAN, CIKEUSAL, SERANG, BANTEN",13,103,113,216
https://kawalpemilu.org#52806,"PANYABRANGAN, CIKEUSAL, SERANG, BANTEN",14,107,104,211
https://kawalpemilu.org#52806,"PANYABRANGAN, CIKEUSAL, SERANG, BANTEN",15,77,150,227
https://kawalpemilu.org#52806,"PANYABRANGAN, CIKEUSAL, SERANG, BANTEN",16,56,120,176
https://kawalpemilu.org#52806,"PANYABRANGAN, CIKEUSAL, SERANG, BANTEN",17,123,103,226
https://kawalpemilu.org#52807,"GANDAYASA, CIKEUSAL, SERANG, BANTEN",1,36,189,225
https://kawalpemilu.org#52807,"GANDAYASA, CIKEUSAL, SERANG, BANTEN",2,62,175,237
https://kawalpemilu.org#52807,"GANDAYASA, CIKEUSAL, SERANG, BANTEN",3,63,201,264
https://kawalpemilu.org#52807,"GANDAYASA, CIKEUSAL, SERANG, BANTEN",4,52,100,152
https://kawalpemilu.org#52807,"GANDAYASA, CIKEUSAL, SERANG, BANTEN",5,59,139,198
https://kawalpemilu.org#52807,"GANDAYASA, CIKEUSAL, SERANG, BANTEN",6,56,185,241
https://kawalpemilu.org#52807,"GANDAYASA, CIKEUSAL, SERANG, BANTEN",7,62,167,229
https://kawalpemilu.org#52807,"GANDAYASA, CIKEUSAL, SERANG, BANTEN",8,117,123,240
https://kawalpemilu.org#52807,"GANDAYASA, CIKEUSAL, SERANG, BANTEN",9,68,136,204
https://kawalpemilu.org#52807,"GANDAYASA, CIKEUSAL, SERANG, BANTEN",10,46,134,180
https://kawalpemilu.org#52807,"GANDAYASA, CIKEUSAL, SERANG, BANTEN",11,60,158,218
https://kawalpemilu.org#52807,"GANDAYASA, CIKEUSAL, SERANG, BANTEN",12,88,127,215
https://kawalpemilu.org#52807,"GANDAYASA, CIKEUSAL, SERANG, BANTEN",13,37,108,145
https://kawalpemilu.org#52807,"GANDAYASA, CIKEUSAL, SERANG, BANTEN",15,58,112,170
https://kawalpemilu.org#52807,"GANDAYASA, CIKEUSAL, SERANG, BANTEN",16,26,86,112
https://kawalpemilu.org#52808,"BANTAR PANJANG, CIKEUSAL, SERANG, BANTEN",1,44,119,163
https://kawalpemilu.org#52808,"BANTAR PANJANG, CIKEUSAL, SERANG, BANTEN",2,54,149,203
https://kawalpemilu.org#52808,"BANTAR PANJANG, CIKEUSAL, SERANG, BANTEN",3,63,149,212
https://kawalpemilu.org#52808,"BANTAR PANJANG, CIKEUSAL, SERANG, BANTEN",4,55,197,252
https://kawalpemilu.org#52808,"BANTAR PANJANG, CIKEUSAL, SERANG, BANTEN",6,84,137,221
https://kawalpemilu.org#52808,"BANTAR PANJANG, CIKEUSAL, SERANG, BANTEN",7,36,136,172
https://kawalpemilu.org#52808,"BANTAR PANJANG, CIKEUSAL, SERANG, BANTEN",8,90,125,215
https://kawalpemilu.org#52808,"BANTAR PANJANG, CIKEUSAL, SERANG, BANTEN",9,89,82,171
https://kawalpemilu.org#52809,"SUKARATU, CIKEUSAL, SERANG, BANTEN",1,56,177,233
https://kawalpemilu.org#52809,"SUKARATU, CIKEUSAL, SERANG, BANTEN",2,70,173,243
https://kawalpemilu.org#52809,"SUKARATU, CIKEUSAL, SERANG, BANTEN",3,69,167,236
https://kawalpemilu.org#52809,"SUKARATU, CIKEUSAL, SERANG, BANTEN",4,52,177,229
https://kawalpemilu.org#52809,"SUKARATU, CIKEUSAL, SERANG, BANTEN",5,47,151,198
https://kawalpemilu.org#52809,"SUKARATU, CIKEUSAL, SERANG, BANTEN",6,75,149,224
https://kawalpemilu.org#52809,"SUKARATU, CIKEUSAL, SERANG, BANTEN",7,28,137,165
https://kawalpemilu.org#52809,"SUKARATU, CIKEUSAL, SERANG, BANTEN",8,22,145,167
https://kawalpemilu.org#52809,"SUKARATU, CIKEUSAL, SERANG, BANTEN",9,53,173,226
https://kawalpemilu.org#52809,"SUKARATU, CIKEUSAL, SERANG, BANTEN",10,70,187,257
https://kawalpemilu.org#52810,"HARUNDANG, CIKEUSAL, SERANG, BANTEN",1,77,152,229
https://kawalpemilu.org#52810,"HARUNDANG, CIKEUSAL, SERANG, BANTEN",2,65,158,223
https://kawalpemilu.org#52810,"HARUNDANG, CIKEUSAL, SERANG, BANTEN",3,74,161,235
https://kawalpemilu.org#52810,"HARUNDANG, CIKEUSAL, SERANG, BANTEN",4,55,190,245
https://kawalpemilu.org#52810,"HARUNDANG, CIKEUSAL, SERANG, BANTEN",5,55,176,231
https://kawalpemilu.org#52810,"HARUNDANG, CIKEUSAL, SERANG, BANTEN",6,38,201,239
https://kawalpemilu.org#52810,"HARUNDANG, CIKEUSAL, SERANG, BANTEN",7,55,196,251
https://kawalpemilu.org#52811,"SUKARAME, CIKEUSAL, SERANG, BANTEN",1,85,158,243
https://kawalpemilu.org#52811,"SUKARAME, CIKEUSAL, SERANG, BANTEN",2,84,117,201
https://kawalpemilu.org#52811,"SUKARAME, CIKEUSAL, SERANG, BANTEN",3,92,127,219
https://kawalpemilu.org#52811,"SUKARAME, CIKEUSAL, SERANG, BANTEN",4,45,163,208
https://kawalpemilu.org#52811,"SUKARAME, CIKEUSAL, SERANG, BANTEN",5,30,176,206
https://kawalpemilu.org#52811,"SUKARAME, CIKEUSAL, SERANG, BANTEN",6,96,110,206
https://kawalpemilu.org#52811,"SUKARAME, CIKEUSAL, SERANG, BANTEN",7,24,137,161
https://kawalpemilu.org#52811,"SUKARAME, CIKEUSAL, SERANG, BANTEN",8,58,126,184
https://kawalpemilu.org#52811,"SUKARAME, CIKEUSAL, SERANG, BANTEN",9,93,107,200
https://kawalpemilu.org#52811,"SUKARAME, CIKEUSAL, SERANG, BANTEN",10,61,113,174
https://kawalpemilu.org#52811,"SUKARAME, CIKEUSAL, SERANG, BANTEN",11,76,107,183
https://kawalpemilu.org#52811,"SUKARAME, CIKEUSAL, SERANG, BANTEN",12,92,93,185
https://kawalpemilu.org#52812,"PANOSOGAN, CIKEUSAL, SERANG, BANTEN",1,91,133,224
https://kawalpemilu.org#52812,"PANOSOGAN, CIKEUSAL, SERANG, BANTEN",2,57,180,237
https://kawalpemilu.org#52812,"PANOSOGAN, CIKEUSAL, SERANG, BANTEN",3,88,99,187
https://kawalpemilu.org#52812,"PANOSOGAN, CIKEUSAL, SERANG, BANTEN",4,110,116,226
https://kawalpemilu.org#52812,"PANOSOGAN, CIKEUSAL, SERANG, BANTEN",5,94,125,219
https://kawalpemilu.org#52812,"PANOSOGAN, CIKEUSAL, SERANG, BANTEN",6,127,91,218
https://kawalpemilu.org#52812,"PANOSOGAN, CIKEUSAL, SERANG, BANTEN",7,37,165,202
https://kawalpemilu.org#52812,"PANOSOGAN, CIKEUSAL, SERANG, BANTEN",8,31,206,237
https://kawalpemilu.org#52812,"PANOSOGAN, CIKEUSAL, SERANG, BANTEN",9,41,50,91
https://kawalpemilu.org#52813,"MONGPOK, CIKEUSAL, SERANG, BANTEN",1,52,120,172
https://kawalpemilu.org#52813,"MONGPOK, CIKEUSAL, SERANG, BANTEN",2,37,142,179
https://kawalpemilu.org#52813,"MONGPOK, CIKEUSAL, SERANG, BANTEN",3,50,146,196
https://kawalpemilu.org#52813,"MONGPOK, CIKEUSAL, SERANG, BANTEN",4,61,151,212
https://kawalpemilu.org#52813,"MONGPOK, CIKEUSAL, SERANG, BANTEN",5,63,145,208
https://kawalpemilu.org#52813,"MONGPOK, CIKEUSAL, SERANG, BANTEN",6,48,142,190
https://kawalpemilu.org#52813,"MONGPOK, CIKEUSAL, SERANG, BANTEN",7,74,132,206
https://kawalpemilu.org#52813,"MONGPOK, CIKEUSAL, SERANG, BANTEN",8,50,128,178
https://kawalpemilu.org#52813,"MONGPOK, CIKEUSAL, SERANG, BANTEN",9,51,152,203
https://kawalpemilu.org#52813,"MONGPOK, CIKEUSAL, SERANG, BANTEN",10,75,127,202
https://kawalpemilu.org#52813,"MONGPOK, CIKEUSAL, SERANG, BANTEN",11,67,120,187
https://kawalpemilu.org#52813,"MONGPOK, CIKEUSAL, SERANG, BANTEN",12,117,73,190
https://kawalpemilu.org#52813,"MONGPOK, CIKEUSAL, SERANG, BANTEN",13,63,114,117
https://kawalpemilu.org#52813,"MONGPOK, CIKEUSAL, SERANG, BANTEN",14,54,134,188
https://kawalpemilu.org#52813,"MONGPOK, CIKEUSAL, SERANG, BANTEN",15,34,168,202
https://kawalpemilu.org#52813,"MONGPOK, CIKEUSAL, SERANG, BANTEN",16,62,179,241
https://kawalpemilu.org#52813,"MONGPOK, CIKEUSAL, SERANG, BANTEN",18,88,103,191
https://kawalpemilu.org#89643,"SUKARAJA, CIKEUSAL, SERANG, BANTEN",1,78,174,252
https://kawalpemilu.org#89643,"SUKARAJA, CIKEUSAL, SERANG, BANTEN",2,91,133,224
https://kawalpemilu.org#89643,"SUKARAJA, CIKEUSAL, SERANG, BANTEN",3,144,75,219
https://kawalpemilu.org#89643,"SUKARAJA, CIKEUSAL, SERANG, BANTEN",5,93,95,188
https://kawalpemilu.org#89643,"SUKARAJA, CIKEUSAL, SERANG, BANTEN",7,128,82,210
https://kawalpemilu.org#89643,"SUKARAJA, CIKEUSAL, SERANG, BANTEN",8,137,92,229
https://kawalpemilu.org#89643,"SUKARAJA, CIKEUSAL, SERANG, BANTEN",9,121,100,221
https://kawalpemilu.org#89643,"SUKARAJA, CIKEUSAL, SERANG, BANTEN",10,97,110,207
https://kawalpemilu.org#89643,"SUKARAJA, CIKEUSAL, SERANG, BANTEN",11,113,121,234
https://kawalpemilu.org#89643,"SUKARAJA, CIKEUSAL, SERANG, BANTEN",12,61,118,179
https://kawalpemilu.org#89643,"SUKARAJA, CIKEUSAL, SERANG, BANTEN",13,72,115,187
https://kawalpemilu.org#89644,"CILAYANG GUHA, CIKEUSAL, SERANG, BANTEN",1,71,99,170
https://kawalpemilu.org#89644,"CILAYANG GUHA, CIKEUSAL, SERANG, BANTEN",2,110,112,222
https://kawalpemilu.org#89644,"CILAYANG GUHA, CIKEUSAL, SERANG, BANTEN",3,143,69,212
https://kawalpemilu.org#89644,"CILAYANG GUHA, CIKEUSAL, SERANG, BANTEN",4,53,179,232
https://kawalpemilu.org#89644,"CILAYANG GUHA, CIKEUSAL, SERANG, BANTEN",5,31,202,233
https://kawalpemilu.org#89644,"CILAYANG GUHA, CIKEUSAL, SERANG, BANTEN",6,32,176,208
https://kawalpemilu.org#89644,"CILAYANG GUHA, CIKEUSAL, SERANG, BANTEN",7,55,139,194
https://kawalpemilu.org#89644,"CILAYANG GUHA, CIKEUSAL, SERANG, BANTEN",8,56,160,216
https://kawalpemilu.org#89644,"CILAYANG GUHA, CIKEUSAL, SERANG, BANTEN",9,74,164,13
https://kawalpemilu.org#89644,"CILAYANG GUHA, CIKEUSAL, SERANG, BANTEN",10,65,147,212
https://kawalpemilu.org#52815,"PAMARAYAN, PAMARAYAN, SERANG, BANTEN",1,47,136,183
https://kawalpemilu.org#52815,"PAMARAYAN, PAMARAYAN, SERANG, BANTEN",2,68,145,213
https://kawalpemilu.org#52815,"PAMARAYAN, PAMARAYAN, SERANG, BANTEN",3,60,148,208
https://kawalpemilu.org#52815,"PAMARAYAN, PAMARAYAN, SERANG, BANTEN",4,45,171,216
https://kawalpemilu.org#52815,"PAMARAYAN, PAMARAYAN, SERANG, BANTEN",5,68,154,222
https://kawalpemilu.org#52815,"PAMARAYAN, PAMARAYAN, SERANG, BANTEN",6,106,127,233
https://kawalpemilu.org#52815,"PAMARAYAN, PAMARAYAN, SERANG, BANTEN",7,62,189,251
https://kawalpemilu.org#52815,"PAMARAYAN, PAMARAYAN, SERANG, BANTEN",9,54,140,194
https://kawalpemilu.org#52815,"PAMARAYAN, PAMARAYAN, SERANG, BANTEN",10,68,123,191
https://kawalpemilu.org#52815,"PAMARAYAN, PAMARAYAN, SERANG, BANTEN",11,56,146,202
https://kawalpemilu.org#52815,"PAMARAYAN, PAMARAYAN, SERANG, BANTEN",12,83,157,240
https://kawalpemilu.org#52815,"PAMARAYAN, PAMARAYAN, SERANG, BANTEN",13,102,112,214
https://kawalpemilu.org#52815,"PAMARAYAN, PAMARAYAN, SERANG, BANTEN",14,92,91,183
https://kawalpemilu.org#52815,"PAMARAYAN, PAMARAYAN, SERANG, BANTEN",15,133,60,193
https://kawalpemilu.org#52815,"PAMARAYAN, PAMARAYAN, SERANG, BANTEN",16,120,74,194
https://kawalpemilu.org#52816,"DAMPING, PAMARAYAN, SERANG, BANTEN",1,108,113,221
https://kawalpemilu.org#52816,"DAMPING, PAMARAYAN, SERANG, BANTEN",2,113,107,220
https://kawalpemilu.org#52816,"DAMPING, PAMARAYAN, SERANG, BANTEN",3,149,26,175
https://kawalpemilu.org#52816,"DAMPING, PAMARAYAN, SERANG, BANTEN",4,162,29,191
https://kawalpemilu.org#52816,"DAMPING, PAMARAYAN, SERANG, BANTEN",5,185,21,206
https://kawalpemilu.org#52816,"DAMPING, PAMARAYAN, SERANG, BANTEN",6,153,17,170
https://kawalpemilu.org#52816,"DAMPING, PAMARAYAN, SERANG, BANTEN",7,141,40,181
https://kawalpemilu.org#52816,"DAMPING, PAMARAYAN, SERANG, BANTEN",8,150,65,215
https://kawalpemilu.org#52816,"DAMPING, PAMARAYAN, SERANG, BANTEN",9,102,65,167
https://kawalpemilu.org#52816,"DAMPING, PAMARAYAN, SERANG, BANTEN",10,92,68,160
https://kawalpemilu.org#52816,"DAMPING, PAMARAYAN, SERANG, BANTEN",11,130,68,198
https://kawalpemilu.org#52816,"DAMPING, PAMARAYAN, SERANG, BANTEN",12,164,50,214
https://kawalpemilu.org#52816,"DAMPING, PAMARAYAN, SERANG, BANTEN",13,117,62,179
https://kawalpemilu.org#52816,"DAMPING, PAMARAYAN, SERANG, BANTEN",14,123,60,183
https://kawalpemilu.org#52816,"DAMPING, PAMARAYAN, SERANG, BANTEN",15,95,96,191
https://kawalpemilu.org#52816,"DAMPING, PAMARAYAN, SERANG, BANTEN",16,67,100,167
https://kawalpemilu.org#52816,"DAMPING, PAMARAYAN, SERANG, BANTEN",17,77,75,152
https://kawalpemilu.org#52817,"WIRANA, PAMARAYAN, SERANG, BANTEN",1,40,172,212
https://kawalpemilu.org#52817,"WIRANA, PAMARAYAN, SERANG, BANTEN",2,85,153,238
https://kawalpemilu.org#52817,"WIRANA, PAMARAYAN, SERANG, BANTEN",3,113,71,184
https://kawalpemilu.org#52817,"WIRANA, PAMARAYAN, SERANG, BANTEN",4,93,86,179
https://kawalpemilu.org#52817,"WIRANA, PAMARAYAN, SERANG, BANTEN",5,119,80,199
https://kawalpemilu.org#52817,"WIRANA, PAMARAYAN, SERANG, BANTEN",6,80,115,8
https://kawalpemilu.org#52817,"WIRANA, PAMARAYAN, SERANG, BANTEN",7,123,76,199
https://kawalpemilu.org#52817,"WIRANA, PAMARAYAN, SERANG, BANTEN",9,101,52,153
https://kawalpemilu.org#52817,"WIRANA, PAMARAYAN, SERANG, BANTEN",10,93,91,184
https://kawalpemilu.org#52817,"WIRANA, PAMARAYAN, SERANG, BANTEN",11,142,69,211
https://kawalpemilu.org#52817,"WIRANA, PAMARAYAN, SERANG, BANTEN",12,92,97,189
https://kawalpemilu.org#52817,"WIRANA, PAMARAYAN, SERANG, BANTEN",13,67,99,166
https://kawalpemilu.org#52817,"WIRANA, PAMARAYAN, SERANG, BANTEN",14,47,146,193
https://kawalpemilu.org#52817,"WIRANA, PAMARAYAN, SERANG, BANTEN",15,72,107,179
https://kawalpemilu.org#52817,"WIRANA, PAMARAYAN, SERANG, BANTEN",16,73,85,158
https://kawalpemilu.org#52817,"WIRANA, PAMARAYAN, SERANG, BANTEN",17,97,122,219
https://kawalpemilu.org#52817,"WIRANA, PAMARAYAN, SERANG, BANTEN",18,87,108,195
https://kawalpemilu.org#52817,"WIRANA, PAMARAYAN, SERANG, BANTEN",19,88,118,206
https://kawalpemilu.org#52817,"WIRANA, PAMARAYAN, SERANG, BANTEN",20,79,122,201
https://kawalpemilu.org#52818,"KEBONCAU, PAMARAYAN, SERANG, BANTEN",1,98,141,239
https://kawalpemilu.org#52818,"KEBONCAU, PAMARAYAN, SERANG, BANTEN",2,90,108,198
https://kawalpemilu.org#52818,"KEBONCAU, PAMARAYAN, SERANG, BANTEN",3,140,91,231
https://kawalpemilu.org#52818,"KEBONCAU, PAMARAYAN, SERANG, BANTEN",4,103,58,161
https://kawalpemilu.org#52818,"KEBONCAU, PAMARAYAN, SERANG, BANTEN",5,107,63,174
https://kawalpemilu.org#52818,"KEBONCAU, PAMARAYAN, SERANG, BANTEN",6,116,65,181
https://kawalpemilu.org#52818,"KEBONCAU, PAMARAYAN, SERANG, BANTEN",7,120,59,179
https://kawalpemilu.org#52818,"KEBONCAU, PAMARAYAN, SERANG, BANTEN",8,130,93,223
https://kawalpemilu.org#52818,"KEBONCAU, PAMARAYAN, SERANG, BANTEN",9,168,59,227
https://kawalpemilu.org#52818,"KEBONCAU, PAMARAYAN, SERANG, BANTEN",10,91,96,187
https://kawalpemilu.org#52818,"KEBONCAU, PAMARAYAN, SERANG, BANTEN",11,64,42,106
https://kawalpemilu.org#52818,"KEBONCAU, PAMARAYAN, SERANG, BANTEN",12,45,135,180
https://kawalpemilu.org#52818,"KEBONCAU, PAMARAYAN, SERANG, BANTEN",13,121,85,206
https://kawalpemilu.org#52818,"KEBONCAU, PAMARAYAN, SERANG, BANTEN",14,110,101,211
https://kawalpemilu.org#52818,"KEBONCAU, PAMARAYAN, SERANG, BANTEN",15,72,90,162
https://kawalpemilu.org#52818,"KEBONCAU, PAMARAYAN, SERANG, BANTEN",16,78,136,214
https://kawalpemilu.org#52819,"PUDAR, PAMARAYAN, SERANG, BANTEN",1,51,151,202
https://kawalpemilu.org#52819,"PUDAR, PAMARAYAN, SERANG, BANTEN",2,51,149,200
https://kawalpemilu.org#52819,"PUDAR, PAMARAYAN, SERANG, BANTEN",3,36,173,209
https://kawalpemilu.org#52819,"PUDAR, PAMARAYAN, SERANG, BANTEN",4,41,173,214
https://kawalpemilu.org#52819,"PUDAR, PAMARAYAN, SERANG, BANTEN",5,75,70,145
https://kawalpemilu.org#52819,"PUDAR, PAMARAYAN, SERANG, BANTEN",6,33,138,171
https://kawalpemilu.org#52819,"PUDAR, PAMARAYAN, SERANG, BANTEN",7,47,106,153
https://kawalpemilu.org#52819,"PUDAR, PAMARAYAN, SERANG, BANTEN",8,49,77,126
https://kawalpemilu.org#52819,"PUDAR, PAMARAYAN, SERANG, BANTEN",9,50,98,148
https://kawalpemilu.org#52819,"PUDAR, PAMARAYAN, SERANG, BANTEN",10,64,149,213
https://kawalpemilu.org#52819,"PUDAR, PAMARAYAN, SERANG, BANTEN",11,12,206,218
https://kawalpemilu.org#52819,"PUDAR, PAMARAYAN, SERANG, BANTEN",12,53,115,168
https://kawalpemilu.org#52819,"PUDAR, PAMARAYAN, SERANG, BANTEN",13,61,99,160
https://kawalpemilu.org#52819,"PUDAR, PAMARAYAN, SERANG, BANTEN",14,0,0,0
https://kawalpemilu.org#52819,"PUDAR, PAMARAYAN, SERANG, BANTEN",15,108,86,194
https://kawalpemilu.org#52819,"PUDAR, PAMARAYAN, SERANG, BANTEN",16,77,111,188
https://kawalpemilu.org#52819,"PUDAR, PAMARAYAN, SERANG, BANTEN",17,72,179,251
https://kawalpemilu.org#52819,"PUDAR, PAMARAYAN, SERANG, BANTEN",18,54,104,158
https://kawalpemilu.org#52820,"BINONG, PAMARAYAN, SERANG, BANTEN",1,106,75,181
https://kawalpemilu.org#52820,"BINONG, PAMARAYAN, SERANG, BANTEN",2,87,69,156
https://kawalpemilu.org#52820,"BINONG, PAMARAYAN, SERANG, BANTEN",3,115,70,185
https://kawalpemilu.org#52820,"BINONG, PAMARAYAN, SERANG, BANTEN",4,160,48,208
https://kawalpemilu.org#52820,"BINONG, PAMARAYAN, SERANG, BANTEN",5,70,140,210
https://kawalpemilu.org#52820,"BINONG, PAMARAYAN, SERANG, BANTEN",6,124,113,237
https://kawalpemilu.org#52820,"BINONG, PAMARAYAN, SERANG, BANTEN",7,58,164,222
https://kawalpemilu.org#52820,"BINONG, PAMARAYAN, SERANG, BANTEN",8,64,146,210
https://kawalpemilu.org#52820,"BINONG, PAMARAYAN, SERANG, BANTEN",9,106,100,206
https://kawalpemilu.org#52820,"BINONG, PAMARAYAN, SERANG, BANTEN",10,91,120,211
https://kawalpemilu.org#52820,"BINONG, PAMARAYAN, SERANG, BANTEN",11,74,156,230
https://kawalpemilu.org#52820,"BINONG, PAMARAYAN, SERANG, BANTEN",12,97,125,222
https://kawalpemilu.org#52821,"SANGIANG, PAMARAYAN, SERANG, BANTEN",1,118,108,226
https://kawalpemilu.org#52821,"SANGIANG, PAMARAYAN, SERANG, BANTEN",2,156,89,245
https://kawalpemilu.org#52821,"SANGIANG, PAMARAYAN, SERANG, BANTEN",3,78,97,175
https://kawalpemilu.org#52821,"SANGIANG, PAMARAYAN, SERANG, BANTEN",4,117,80,197
https://kawalpemilu.org#52821,"SANGIANG, PAMARAYAN, SERANG, BANTEN",5,88,81,169
https://kawalpemilu.org#52821,"SANGIANG, PAMARAYAN, SERANG, BANTEN",6,93,82,175
https://kawalpemilu.org#52821,"SANGIANG, PAMARAYAN, SERANG, BANTEN",7,112,92,204
https://kawalpemilu.org#52821,"SANGIANG, PAMARAYAN, SERANG, BANTEN",8,107,72,179
https://kawalpemilu.org#52821,"SANGIANG, PAMARAYAN, SERANG, BANTEN",9,79,66,145
https://kawalpemilu.org#52821,"SANGIANG, PAMARAYAN, SERANG, BANTEN",10,87,121,208
https://kawalpemilu.org#52821,"SANGIANG, PAMARAYAN, SERANG, BANTEN",11,137,99,236
https://kawalpemilu.org#52821,"SANGIANG, PAMARAYAN, SERANG, BANTEN",12,132,86,218
https://kawalpemilu.org#52821,"SANGIANG, PAMARAYAN, SERANG, BANTEN",13,56,177,233
https://kawalpemilu.org#52821,"SANGIANG, PAMARAYAN, SERANG, BANTEN",14,80,146,226
https://kawalpemilu.org#52821,"SANGIANG, PAMARAYAN, SERANG, BANTEN",15,67,125,192
https://kawalpemilu.org#52821,"SANGIANG, PAMARAYAN, SERANG, BANTEN",16,81,91,172
https://kawalpemilu.org#52821,"SANGIANG, PAMARAYAN, SERANG, BANTEN",17,112,79,191
https://kawalpemilu.org#52821,"SANGIANG, PAMARAYAN, SERANG, BANTEN",18,129,76,205
https://kawalpemilu.org#52821,"SANGIANG, PAMARAYAN, SERANG, BANTEN",19,55,132,187
https://kawalpemilu.org#52821,"SANGIANG, PAMARAYAN, SERANG, BANTEN",20,57,118,175
https://kawalpemilu.org#52822,"KAMPUNGBARU, PAMARAYAN, SERANG, BANTEN",1,71,136,207
https://kawalpemilu.org#52822,"KAMPUNGBARU, PAMARAYAN, SERANG, BANTEN",2,100,123,223
https://kawalpemilu.org#52822,"KAMPUNGBARU, PAMARAYAN, SERANG, BANTEN",3,69,155,224
https://kawalpemilu.org#52822,"KAMPUNGBARU, PAMARAYAN, SERANG, BANTEN",4,43,173,216
https://kawalpemilu.org#52822,"KAMPUNGBARU, PAMARAYAN, SERANG, BANTEN",5,54,158,212
https://kawalpemilu.org#52822,"KAMPUNGBARU, PAMARAYAN, SERANG, BANTEN",6,32,193,225
https://kawalpemilu.org#52822,"KAMPUNGBARU, PAMARAYAN, SERANG, BANTEN",7,71,107,178
https://kawalpemilu.org#52822,"KAMPUNGBARU, PAMARAYAN, SERANG, BANTEN",8,63,161,224
https://kawalpemilu.org#52822,"KAMPUNGBARU, PAMARAYAN, SERANG, BANTEN",9,83,140,223
https://kawalpemilu.org#52822,"KAMPUNGBARU, PAMARAYAN, SERANG, BANTEN",10,74,147,221
https://kawalpemilu.org#52822,"KAMPUNGBARU, PAMARAYAN, SERANG, BANTEN",11,91,121,212
https://kawalpemilu.org#52822,"KAMPUNGBARU, PAMARAYAN, SERANG, BANTEN",12,91,135,226
https://kawalpemilu.org#52822,"KAMPUNGBARU, PAMARAYAN, SERANG, BANTEN",13,99,88,187
https://kawalpemilu.org#52822,"KAMPUNGBARU, PAMARAYAN, SERANG, BANTEN",14,64,154,218
https://kawalpemilu.org#52822,"KAMPUNGBARU, PAMARAYAN, SERANG, BANTEN",15,75,135,210
https://kawalpemilu.org#52822,"KAMPUNGBARU, PAMARAYAN, SERANG, BANTEN",16,89,123,212
https://kawalpemilu.org#52822,"KAMPUNGBARU, PAMARAYAN, SERANG, BANTEN",17,77,72,149
https://kawalpemilu.org#52822,"KAMPUNGBARU, PAMARAYAN, SERANG, BANTEN",18,48,159,207
https://kawalpemilu.org#52822,"KAMPUNGBARU, PAMARAYAN, SERANG, BANTEN",19,60,152,212
https://kawalpemilu.org#52822,"KAMPUNGBARU, PAMARAYAN, SERANG, BANTEN",20,70,122,192
https://kawalpemilu.org#52823,"PASIRLIMUS, PAMARAYAN, SERANG, BANTEN",1,30,125,155
https://kawalpemilu.org#52823,"PASIRLIMUS, PAMARAYAN, SERANG, BANTEN",2,90,126,216
https://kawalpemilu.org#52823,"PASIRLIMUS, PAMARAYAN, SERANG, BANTEN",3,56,137,193
https://kawalpemilu.org#52823,"PASIRLIMUS, PAMARAYAN, SERANG, BANTEN",4,83,128,211
https://kawalpemilu.org#52823,"PASIRLIMUS, PAMARAYAN, SERANG, BANTEN",5,65,186,251
https://kawalpemilu.org#52823,"PASIRLIMUS, PAMARAYAN, SERANG, BANTEN",6,104,81,185
https://kawalpemilu.org#52823,"PASIRLIMUS, PAMARAYAN, SERANG, BANTEN",7,190,85,275
https://kawalpemilu.org#52823,"PASIRLIMUS, PAMARAYAN, SERANG, BANTEN",8,85,140,225
https://kawalpemilu.org#52823,"PASIRLIMUS, PAMARAYAN, SERANG, BANTEN",9,113,127,240
https://kawalpemilu.org#52823,"PASIRLIMUS, PAMARAYAN, SERANG, BANTEN",10,96,156,252
https://kawalpemilu.org#52823,"PASIRLIMUS, PAMARAYAN, SERANG, BANTEN",11,94,123,217
https://kawalpemilu.org#52823,"PASIRLIMUS, PAMARAYAN, SERANG, BANTEN",13,70,145,215
https://kawalpemilu.org#52823,"PASIRLIMUS, PAMARAYAN, SERANG, BANTEN",14,110,97,207
https://kawalpemilu.org#52823,"PASIRLIMUS, PAMARAYAN, SERANG, BANTEN",16,116,86,202
https://kawalpemilu.org#52823,"PASIRLIMUS, PAMARAYAN, SERANG, BANTEN",17,115,104,219
https://kawalpemilu.org#52823,"PASIRLIMUS, PAMARAYAN, SERANG, BANTEN",18,58,110,168
https://kawalpemilu.org#52823,"PASIRLIMUS, PAMARAYAN, SERANG, BANTEN",19,60,135,195
https://kawalpemilu.org#89645,"PASIR KEMBANG, PAMARAYAN, SERANG, BANTEN",1,68,141,209
https://kawalpemilu.org#89645,"PASIR KEMBANG, PAMARAYAN, SERANG, BANTEN",2,61,150,211
https://kawalpemilu.org#89645,"PASIR KEMBANG, PAMARAYAN, SERANG, BANTEN",3,71,119,190
https://kawalpemilu.org#89645,"PASIR KEMBANG, PAMARAYAN, SERANG, BANTEN",4,68,107,175
https://kawalpemilu.org#89645,"PASIR KEMBANG, PAMARAYAN, SERANG, BANTEN",5,69,108,177
https://kawalpemilu.org#89645,"PASIR KEMBANG, PAMARAYAN, SERANG, BANTEN",6,66,141,207
https://kawalpemilu.org#89645,"PASIR KEMBANG, PAMARAYAN, SERANG, BANTEN",7,77,122,199
https://kawalpemilu.org#89645,"PASIR KEMBANG, PAMARAYAN, SERANG, BANTEN",8,71,143,214
https://kawalpemilu.org#89645,"PASIR KEMBANG, PAMARAYAN, SERANG, BANTEN",10,126,94,220
https://kawalpemilu.org#89645,"PASIR KEMBANG, PAMARAYAN, SERANG, BANTEN",11,113,66,179
https://kawalpemilu.org#52825,"KOPO, KOPO, SERANG, BANTEN",1,35,172,207
https://kawalpemilu.org#52825,"KOPO, KOPO, SERANG, BANTEN",2,56,134,190
https://kawalpemilu.org#52825,"KOPO, KOPO, SERANG, BANTEN",3,46,124,170
https://kawalpemilu.org#52825,"KOPO, KOPO, SERANG, BANTEN",4,46,157,203
https://kawalpemilu.org#52825,"KOPO, KOPO, SERANG, BANTEN",5,54,180,234
https://kawalpemilu.org#52825,"KOPO, KOPO, SERANG, BANTEN",6,40,191,231
https://kawalpemilu.org#52825,"KOPO, KOPO, SERANG, BANTEN",7,68,151,219
https://kawalpemilu.org#52825,"KOPO, KOPO, SERANG, BANTEN",8,85,140,225
https://kawalpemilu.org#52825,"KOPO, KOPO, SERANG, BANTEN",9,40,188,228
https://kawalpemilu.org#52825,"KOPO, KOPO, SERANG, BANTEN",10,62,168,230
https://kawalpemilu.org#52826,"GARUT, KOPO, SERANG, BANTEN",1,102,124,226
https://kawalpemilu.org#52826,"GARUT, KOPO, SERANG, BANTEN",2,63,141,204
https://kawalpemilu.org#52826,"GARUT, KOPO, SERANG, BANTEN",3,100,138,239
https://kawalpemilu.org#52826,"GARUT, KOPO, SERANG, BANTEN",4,94,124,218
https://kawalpemilu.org#52826,"GARUT, KOPO, SERANG, BANTEN",5,99,124,223
https://kawalpemilu.org#52826,"GARUT, KOPO, SERANG, BANTEN",7,69,103,172
https://kawalpemilu.org#52826,"GARUT, KOPO, SERANG, BANTEN",8,53,149,202
https://kawalpemilu.org#52826,"GARUT, KOPO, SERANG, BANTEN",9,75,116,191
https://kawalpemilu.org#52826,"GARUT, KOPO, SERANG, BANTEN",10,64,95,159
https://kawalpemilu.org#52826,"GARUT, KOPO, SERANG, BANTEN",11,57,135,192
https://kawalpemilu.org#52826,"GARUT, KOPO, SERANG, BANTEN",12,71,134,205
https://kawalpemilu.org#52826,"GARUT, KOPO, SERANG, BANTEN",13,64,163,227
https://kawalpemilu.org#52826,"GARUT, KOPO, SERANG, BANTEN",14,26,158,184
https://kawalpemilu.org#52826,"GARUT, KOPO, SERANG, BANTEN",15,95,103,198
https://kawalpemilu.org#52826,"GARUT, KOPO, SERANG, BANTEN",16,57,104,161
https://kawalpemilu.org#52827,"NANGGUNG, KOPO, SERANG, BANTEN",1,104,130,234
https://kawalpemilu.org#52827,"NANGGUNG, KOPO, SERANG, BANTEN",3,57,200,257
https://kawalpemilu.org#52827,"NANGGUNG, KOPO, SERANG, BANTEN",4,84,128,212
https://kawalpemilu.org#52827,"NANGGUNG, KOPO, SERANG, BANTEN",5,55,142,197
https://kawalpemilu.org#52827,"NANGGUNG, KOPO, SERANG, BANTEN",6,43,142,185
https://kawalpemilu.org#52827,"NANGGUNG, KOPO, SERANG, BANTEN",7,50,189,239
https://kawalpemilu.org#52827,"NANGGUNG, KOPO, SERANG, BANTEN",8,32,127,159
https://kawalpemilu.org#52827,"NANGGUNG, KOPO, SERANG, BANTEN",9,25,181,206
https://kawalpemilu.org#52827,"NANGGUNG, KOPO, SERANG, BANTEN",10,51,171,222
https://kawalpemilu.org#52827,"NANGGUNG, KOPO, SERANG, BANTEN",11,45,197,242
https://kawalpemilu.org#52827,"NANGGUNG, KOPO, SERANG, BANTEN",12,37,214,251
https://kawalpemilu.org#52827,"NANGGUNG, KOPO, SERANG, BANTEN",13,37,184,221
https://kawalpemilu.org#52827,"NANGGUNG, KOPO, SERANG, BANTEN",14,41,182,223
https://kawalpemilu.org#52827,"NANGGUNG, KOPO, SERANG, BANTEN",15,64,149,213
https://kawalpemilu.org#52827,"NANGGUNG, KOPO, SERANG, BANTEN",16,43,152,195
https://kawalpemilu.org#52827,"NANGGUNG, KOPO, SERANG, BANTEN",17,47,154,201
https://kawalpemilu.org#52827,"NANGGUNG, KOPO, SERANG, BANTEN",18,49,182,231
https://kawalpemilu.org#52827,"NANGGUNG, KOPO, SERANG, BANTEN",19,52,202,254
https://kawalpemilu.org#52827,"NANGGUNG, KOPO, SERANG, BANTEN",20,46,181,227
https://kawalpemilu.org#52827,"NANGGUNG, KOPO, SERANG, BANTEN",21,66,174,240
https://kawalpemilu.org#52827,"NANGGUNG, KOPO, SERANG, BANTEN",22,25,128,153
https://kawalpemilu.org#52828,"CIDAHU, KOPO, SERANG, BANTEN",1,60,151,211
https://kawalpemilu.org#52828,"CIDAHU, KOPO, SERANG, BANTEN",2,65,136,201
https://kawalpemilu.org#52828,"CIDAHU, KOPO, SERANG, BANTEN",3,80,130,210
https://kawalpemilu.org#52828,"CIDAHU, KOPO, SERANG, BANTEN",4,68,138,206
https://kawalpemilu.org#52828,"CIDAHU, KOPO, SERANG, BANTEN",5,85,99,184
https://kawalpemilu.org#52828,"CIDAHU, KOPO, SERANG, BANTEN",6,104,131,235
https://kawalpemilu.org#52828,"CIDAHU, KOPO, SERANG, BANTEN",7,80,146,226
https://kawalpemilu.org#52828,"CIDAHU, KOPO, SERANG, BANTEN",8,49,126,175
https://kawalpemilu.org#52828,"CIDAHU, KOPO, SERANG, BANTEN",9,68,133,201
https://kawalpemilu.org#52828,"CIDAHU, KOPO, SERANG, BANTEN",10,77,78,155
https://kawalpemilu.org#52828,"CIDAHU, KOPO, SERANG, BANTEN",11,78,112,190
https://kawalpemilu.org#52828,"CIDAHU, KOPO, SERANG, BANTEN",12,76,90,166
https://kawalpemilu.org#52828,"CIDAHU, KOPO, SERANG, BANTEN",13,86,82,168
https://kawalpemilu.org#52828,"CIDAHU, KOPO, SERANG, BANTEN",14,63,141,204
https://kawalpemilu.org#52828,"CIDAHU, KOPO, SERANG, BANTEN",15,34,68,102
https://kawalpemilu.org#52828,"CIDAHU, KOPO, SERANG, BANTEN",16,70,133,203
https://kawalpemilu.org#52829,"NYOMPOK, KOPO, SERANG, BANTEN",1,50,181,231
https://kawalpemilu.org#52829,"NYOMPOK, KOPO, SERANG, BANTEN",2,63,148,211
https://kawalpemilu.org#52829,"NYOMPOK, KOPO, SERANG, BANTEN",3,62,103,165
https://kawalpemilu.org#52829,"NYOMPOK, KOPO, SERANG, BANTEN",4,47,143,190
https://kawalpemilu.org#52829,"NYOMPOK, KOPO, SERANG, BANTEN",5,66,159,225
https://kawalpemilu.org#52829,"NYOMPOK, KOPO, SERANG, BANTEN",6,93,132,225
https://kawalpemilu.org#52829,"NYOMPOK, KOPO, SERANG, BANTEN",7,63,144,207
https://kawalpemilu.org#52829,"NYOMPOK, KOPO, SERANG, BANTEN",8,52,150,202
https://kawalpemilu.org#52829,"NYOMPOK, KOPO, SERANG, BANTEN",9,35,192,227
https://kawalpemilu.org#52829,"NYOMPOK, KOPO, SERANG, BANTEN",10,27,188,215
https://kawalpemilu.org#52829,"NYOMPOK, KOPO, SERANG, BANTEN",11,10,202,212
https://kawalpemilu.org#52829,"NYOMPOK, KOPO, SERANG, BANTEN",12,17,187,204
https://kawalpemilu.org#52829,"NYOMPOK, KOPO, SERANG, BANTEN",13,39,147,186
https://kawalpemilu.org#52829,"NYOMPOK, KOPO, SERANG, BANTEN",14,76,113,189
https://kawalpemilu.org#52829,"NYOMPOK, KOPO, SERANG, BANTEN",15,47,127,174
https://kawalpemilu.org#52829,"NYOMPOK, KOPO, SERANG, BANTEN",16,65,126,191
https://kawalpemilu.org#52829,"NYOMPOK, KOPO, SERANG, BANTEN",17,70,119,189
https://kawalpemilu.org#52829,"NYOMPOK, KOPO, SERANG, BANTEN",18,14,55,69
https://kawalpemilu.org#52829,"NYOMPOK, KOPO, SERANG, BANTEN",19,25,76,101
https://kawalpemilu.org#52830,"GABUS, KOPO, SERANG, BANTEN",1,70,146,216
https://kawalpemilu.org#52830,"GABUS, KOPO, SERANG, BANTEN",2,63,123,186
https://kawalpemilu.org#52830,"GABUS, KOPO, SERANG, BANTEN",3,47,168,215
https://kawalpemilu.org#52830,"GABUS, KOPO, SERANG, BANTEN",4,50,180,230
https://kawalpemilu.org#52830,"GABUS, KOPO, SERANG, BANTEN",5,18,100,118
https://kawalpemilu.org#52830,"GABUS, KOPO, SERANG, BANTEN",6,34,124,158
https://kawalpemilu.org#52830,"GABUS, KOPO, SERANG, BANTEN",7,33,144,177
https://kawalpemilu.org#52830,"GABUS, KOPO, SERANG, BANTEN",8,61,184,245
https://kawalpemilu.org#52830,"GABUS, KOPO, SERANG, BANTEN",10,40,150,190
https://kawalpemilu.org#52830,"GABUS, KOPO, SERANG, BANTEN",11,58,137,195
https://kawalpemilu.org#52830,"GABUS, KOPO, SERANG, BANTEN",12,62,134,196
https://kawalpemilu.org#52830,"GABUS, KOPO, SERANG, BANTEN",13,67,106,173
https://kawalpemilu.org#52830,"GABUS, KOPO, SERANG, BANTEN",14,42,91,133
https://kawalpemilu.org#52830,"GABUS, KOPO, SERANG, BANTEN",15,40,144,184
https://kawalpemilu.org#52830,"GABUS, KOPO, SERANG, BANTEN",16,40,122,162
https://kawalpemilu.org#52830,"GABUS, KOPO, SERANG, BANTEN",17,89,139,228
https://kawalpemilu.org#52830,"GABUS, KOPO, SERANG, BANTEN",18,31,137,168
https://kawalpemilu.org#52830,"GABUS, KOPO, SERANG, BANTEN",19,63,184,247
https://kawalpemilu.org#52830,"GABUS, KOPO, SERANG, BANTEN",20,40,142,182
https://kawalpemilu.org#52830,"GABUS, KOPO, SERANG, BANTEN",21,60,153,213
https://kawalpemilu.org#52830,"GABUS, KOPO, SERANG, BANTEN",22,68,145,213
https://kawalpemilu.org#52831,"CARENANG UDIK, KOPO, SERANG, BANTEN",1,73,144,217
https://kawalpemilu.org#52831,"CARENANG UDIK, KOPO, SERANG, BANTEN",2,93,117,210
https://kawalpemilu.org#52831,"CARENANG UDIK, KOPO, SERANG, BANTEN",3,77,116,193
https://kawalpemilu.org#52831,"CARENANG UDIK, KOPO, SERANG, BANTEN",4,80,130,210
https://kawalpemilu.org#52831,"CARENANG UDIK, KOPO, SERANG, BANTEN",5,122,122,244
https://kawalpemilu.org#52831,"CARENANG UDIK, KOPO, SERANG, BANTEN",6,42,132,174
https://kawalpemilu.org#52831,"CARENANG UDIK, KOPO, SERANG, BANTEN",7,62,141,203
https://kawalpemilu.org#52831,"CARENANG UDIK, KOPO, SERANG, BANTEN",8,49,162,211
https://kawalpemilu.org#52831,"CARENANG UDIK, KOPO, SERANG, BANTEN",9,55,187,242
https://kawalpemilu.org#52831,"CARENANG UDIK, KOPO, SERANG, BANTEN",10,41,207,248
https://kawalpemilu.org#52831,"CARENANG UDIK, KOPO, SERANG, BANTEN",11,35,218,253
https://kawalpemilu.org#52831,"CARENANG UDIK, KOPO, SERANG, BANTEN",12,24,143,167
https://kawalpemilu.org#52831,"CARENANG UDIK, KOPO, SERANG, BANTEN",13,14,101,115
https://kawalpemilu.org#52832,"RANCASUMUR, KOPO, SERANG, BANTEN",1,69,162,231
https://kawalpemilu.org#52832,"RANCASUMUR, KOPO, SERANG, BANTEN",2,78,99,177
https://kawalpemilu.org#52832,"RANCASUMUR, KOPO, SERANG, BANTEN",3,66,134,200
https://kawalpemilu.org#52832,"RANCASUMUR, KOPO, SERANG, BANTEN",4,80,176,256
https://kawalpemilu.org#52832,"RANCASUMUR, KOPO, SERANG, BANTEN",5,77,159,236
https://kawalpemilu.org#52832,"RANCASUMUR, KOPO, SERANG, BANTEN",6,122,94,216
https://kawalpemilu.org#52832,"RANCASUMUR, KOPO, SERANG, BANTEN",8,143,104,247
https://kawalpemilu.org#52832,"RANCASUMUR, KOPO, SERANG, BANTEN",9,63,141,204
https://kawalpemilu.org#52832,"RANCASUMUR, KOPO, SERANG, BANTEN",10,41,175,216
https://kawalpemilu.org#52832,"RANCASUMUR, KOPO, SERANG, BANTEN",11,54,145,199
https://kawalpemilu.org#52832,"RANCASUMUR, KOPO, SERANG, BANTEN",12,69,111,180
https://kawalpemilu.org#52832,"RANCASUMUR, KOPO, SERANG, BANTEN",13,107,127,234
https://kawalpemilu.org#52832,"RANCASUMUR, KOPO, SERANG, BANTEN",14,76,153,229
https://kawalpemilu.org#52832,"RANCASUMUR, KOPO, SERANG, BANTEN",15,95,121,216
https://kawalpemilu.org#52833,"BABAKANJAYA, KOPO, SERANG, BANTEN",1,53,181,234
https://kawalpemilu.org#52833,"BABAKANJAYA, KOPO, SERANG, BANTEN",2,58,181,239
https://kawalpemilu.org#52833,"BABAKANJAYA, KOPO, SERANG, BANTEN",3,37,187,224
https://kawalpemilu.org#52833,"BABAKANJAYA, KOPO, SERANG, BANTEN",4,40,160,200
https://kawalpemilu.org#52833,"BABAKANJAYA, KOPO, SERANG, BANTEN",5,51,171,222
https://kawalpemilu.org#52833,"BABAKANJAYA, KOPO, SERANG, BANTEN",6,57,162,219
https://kawalpemilu.org#52833,"BABAKANJAYA, KOPO, SERANG, BANTEN",7,25,88,113
https://kawalpemilu.org#52834,"MEKARBARU, KOPO, SERANG, BANTEN",1,61,140,201
https://kawalpemilu.org#52834,"MEKARBARU, KOPO, SERANG, BANTEN",2,58,80,138
https://kawalpemilu.org#52834,"MEKARBARU, KOPO, SERANG, BANTEN",3,66,139,205
https://kawalpemilu.org#52834,"MEKARBARU, KOPO, SERANG, BANTEN",4,47,144,191
https://kawalpemilu.org#52834,"MEKARBARU, KOPO, SERANG, BANTEN",6,82,128,210
https://kawalpemilu.org#52834,"MEKARBARU, KOPO, SERANG, BANTEN",7,70,128,198
https://kawalpemilu.org#52834,"MEKARBARU, KOPO, SERANG, BANTEN",8,78,141,219
https://kawalpemilu.org#52834,"MEKARBARU, KOPO, SERANG, BANTEN",9,78,143,221
https://kawalpemilu.org#52834,"MEKARBARU, KOPO, SERANG, BANTEN",10,46,185,231
https://kawalpemilu.org#52834,"MEKARBARU, KOPO, SERANG, BANTEN",11,71,127,198
https://kawalpemilu.org#52834,"MEKARBARU, KOPO, SERANG, BANTEN",12,66,127,193
https://kawalpemilu.org#52834,"MEKARBARU, KOPO, SERANG, BANTEN",13,46,115,161
https://kawalpemilu.org#52834,"MEKARBARU, KOPO, SERANG, BANTEN",14,43,79,122
https://kawalpemilu.org#52836,"JAWILAN, JAWILAN, SERANG, BANTEN",1,45,123,168
https://kawalpemilu.org#52836,"JAWILAN, JAWILAN, SERANG, BANTEN",2,32,209,241
https://kawalpemilu.org#52836,"JAWILAN, JAWILAN, SERANG, BANTEN",3,39,187,226
https://kawalpemilu.org#52836,"JAWILAN, JAWILAN, SERANG, BANTEN",4,53,117,170
https://kawalpemilu.org#52836,"JAWILAN, JAWILAN, SERANG, BANTEN",5,30,190,220
https://kawalpemilu.org#52836,"JAWILAN, JAWILAN, SERANG, BANTEN",6,52,168,220
https://kawalpemilu.org#52836,"JAWILAN, JAWILAN, SERANG, BANTEN",7,58,194,252
https://kawalpemilu.org#52836,"JAWILAN, JAWILAN, SERANG, BANTEN",9,98,124,220
https://kawalpemilu.org#52836,"JAWILAN, JAWILAN, SERANG, BANTEN",10,36,178,214
https://kawalpemilu.org#52836,"JAWILAN, JAWILAN, SERANG, BANTEN",11,38,199,237
https://kawalpemilu.org#52836,"JAWILAN, JAWILAN, SERANG, BANTEN",12,75,145,220
https://kawalpemilu.org#52836,"JAWILAN, JAWILAN, SERANG, BANTEN",13,38,162,200
https://kawalpemilu.org#52836,"JAWILAN, JAWILAN, SERANG, BANTEN",14,22,152,174
https://kawalpemilu.org#52836,"JAWILAN, JAWILAN, SERANG, BANTEN",15,53,114,167
https://kawalpemilu.org#52837,"BOJOT, JAWILAN, SERANG, BANTEN",1,41,166,207
https://kawalpemilu.org#52837,"BOJOT, JAWILAN, SERANG, BANTEN",2,41,162,203
https://kawalpemilu.org#52837,"BOJOT, JAWILAN, SERANG, BANTEN",3,32,174,204
https://kawalpemilu.org#52837,"BOJOT, JAWILAN, SERANG, BANTEN",4,36,148,184
https://kawalpemilu.org#52837,"BOJOT, JAWILAN, SERANG, BANTEN",5,55,97,152
https://kawalpemilu.org#52837,"BOJOT, JAWILAN, SERANG, BANTEN",6,36,138,174
https://kawalpemilu.org#52837,"BOJOT, JAWILAN, SERANG, BANTEN",7,36,114,150
https://kawalpemilu.org#52837,"BOJOT, JAWILAN, SERANG, BANTEN",8,70,107,177
https://kawalpemilu.org#52837,"BOJOT, JAWILAN, SERANG, BANTEN",9,55,56,111
https://kawalpemilu.org#52837,"BOJOT, JAWILAN, SERANG, BANTEN",11,83,122,205
https://kawalpemilu.org#52837,"BOJOT, JAWILAN, SERANG, BANTEN",12,43,181,224
https://kawalpemilu.org#52837,"BOJOT, JAWILAN, SERANG, BANTEN",13,63,127,190
https://kawalpemilu.org#52837,"BOJOT, JAWILAN, SERANG, BANTEN",14,29,195,224
https://kawalpemilu.org#52837,"BOJOT, JAWILAN, SERANG, BANTEN",15,15,101,116
https://kawalpemilu.org#52838,"CEMPLANG, JAWILAN, SERANG, BANTEN",1,34,208,242
https://kawalpemilu.org#52838,"CEMPLANG, JAWILAN, SERANG, BANTEN",2,39,156,195
https://kawalpemilu.org#52838,"CEMPLANG, JAWILAN, SERANG, BANTEN",3,0,0,0
https://kawalpemilu.org#52838,"CEMPLANG, JAWILAN, SERANG, BANTEN",4,47,152,199
https://kawalpemilu.org#52838,"CEMPLANG, JAWILAN, SERANG, BANTEN",5,40,172,212
https://kawalpemilu.org#52838,"CEMPLANG, JAWILAN, SERANG, BANTEN",6,76,175,251
https://kawalpemilu.org#52838,"CEMPLANG, JAWILAN, SERANG, BANTEN",7,68,190,258
https://kawalpemilu.org#52838,"CEMPLANG, JAWILAN, SERANG, BANTEN",8,55,202,257
https://kawalpemilu.org#52838,"CEMPLANG, JAWILAN, SERANG, BANTEN",9,77,193,270
https://kawalpemilu.org#52838,"CEMPLANG, JAWILAN, SERANG, BANTEN",10,46,133,179
https://kawalpemilu.org#52838,"CEMPLANG, JAWILAN, SERANG, BANTEN",11,40,149,189
https://kawalpemilu.org#52838,"CEMPLANG, JAWILAN, SERANG, BANTEN",12,77,124,201
https://kawalpemilu.org#52838,"CEMPLANG, JAWILAN, SERANG, BANTEN",13,38,133,171
https://kawalpemilu.org#52838,"CEMPLANG, JAWILAN, SERANG, BANTEN",14,79,167,246
https://kawalpemilu.org#52838,"CEMPLANG, JAWILAN, SERANG, BANTEN",15,80,98,178
https://kawalpemilu.org#52838,"CEMPLANG, JAWILAN, SERANG, BANTEN",16,72,121,193
https://kawalpemilu.org#52838,"CEMPLANG, JAWILAN, SERANG, BANTEN",17,74,135,209
https://kawalpemilu.org#52838,"CEMPLANG, JAWILAN, SERANG, BANTEN",18,42,120,162
https://kawalpemilu.org#52838,"CEMPLANG, JAWILAN, SERANG, BANTEN",19,64,90,154
https://kawalpemilu.org#52838,"CEMPLANG, JAWILAN, SERANG, BANTEN",20,59,158,217
https://kawalpemilu.org#52838,"CEMPLANG, JAWILAN, SERANG, BANTEN",21,68,131,199
https://kawalpemilu.org#52838,"CEMPLANG, JAWILAN, SERANG, BANTEN",22,42,115,157
https://kawalpemilu.org#52839,"PAGINTUNGAN, JAWILAN, SERANG, BANTEN",1,58,155,213
https://kawalpemilu.org#52839,"PAGINTUNGAN, JAWILAN, SERANG, BANTEN",2,66,144,210
https://kawalpemilu.org#52839,"PAGINTUNGAN, JAWILAN, SERANG, BANTEN",3,12,128,140
https://kawalpemilu.org#52839,"PAGINTUNGAN, JAWILAN, SERANG, BANTEN",4,54,134,188
https://kawalpemilu.org#52839,"PAGINTUNGAN, JAWILAN, SERANG, BANTEN",5,45,165,210
https://kawalpemilu.org#52839,"PAGINTUNGAN, JAWILAN, SERANG, BANTEN",6,37,171,208
https://kawalpemilu.org#52839,"PAGINTUNGAN, JAWILAN, SERANG, BANTEN",7,54,160,214
https://kawalpemilu.org#52839,"PAGINTUNGAN, JAWILAN, SERANG, BANTEN",8,46,150,196
https://kawalpemilu.org#52839,"PAGINTUNGAN, JAWILAN, SERANG, BANTEN",9,51,93,44
https://kawalpemilu.org#52839,"PAGINTUNGAN, JAWILAN, SERANG, BANTEN",10,29,104,133
https://kawalpemilu.org#52839,"PAGINTUNGAN, JAWILAN, SERANG, BANTEN",11,69,83,152
https://kawalpemilu.org#52839,"PAGINTUNGAN, JAWILAN, SERANG, BANTEN",12,33,160,193
https://kawalpemilu.org#52839,"PAGINTUNGAN, JAWILAN, SERANG, BANTEN",13,24,137,161
https://kawalpemilu.org#52839,"PAGINTUNGAN, JAWILAN, SERANG, BANTEN",14,45,94,139
https://kawalpemilu.org#52839,"PAGINTUNGAN, JAWILAN, SERANG, BANTEN",15,60,99,159
https://kawalpemilu.org#52839,"PAGINTUNGAN, JAWILAN, SERANG, BANTEN",16,68,102,170
https://kawalpemilu.org#52839,"PAGINTUNGAN, JAWILAN, SERANG, BANTEN",17,84,132,226
https://kawalpemilu.org#52839,"PAGINTUNGAN, JAWILAN, SERANG, BANTEN",18,89,58,147
https://kawalpemilu.org#52839,"PAGINTUNGAN, JAWILAN, SERANG, BANTEN",19,92,125,217
https://kawalpemilu.org#52839,"PAGINTUNGAN, JAWILAN, SERANG, BANTEN",20,60,146,206
https://kawalpemilu.org#52840,"PASIRBUYUT, JAWILAN, SERANG, BANTEN",1,41,146,187
https://kawalpemilu.org#52840,"PASIRBUYUT, JAWILAN, SERANG, BANTEN",2,72,183,255
https://kawalpemilu.org#52840,"PASIRBUYUT, JAWILAN, SERANG, BANTEN",3,62,167,229
https://kawalpemilu.org#52840,"PASIRBUYUT, JAWILAN, SERANG, BANTEN",4,79,148,227
https://kawalpemilu.org#52840,"PASIRBUYUT, JAWILAN, SERANG, BANTEN",5,71,179,250
https://kawalpemilu.org#52840,"PASIRBUYUT, JAWILAN, SERANG, BANTEN",6,31,103,134
https://kawalpemilu.org#52840,"PASIRBUYUT, JAWILAN, SERANG, BANTEN",7,40,141,181
https://kawalpemilu.org#52840,"PASIRBUYUT, JAWILAN, SERANG, BANTEN",8,92,99,191
https://kawalpemilu.org#52840,"PASIRBUYUT, JAWILAN, SERANG, BANTEN",9,63,159,222
https://kawalpemilu.org#52840,"PASIRBUYUT, JAWILAN, SERANG, BANTEN",10,30,176,206
https://kawalpemilu.org#52840,"PASIRBUYUT, JAWILAN, SERANG, BANTEN",11,42,210,252
https://kawalpemilu.org#52840,"PASIRBUYUT, JAWILAN, SERANG, BANTEN",12,34,224,258
https://kawalpemilu.org#52840,"PASIRBUYUT, JAWILAN, SERANG, BANTEN",13,91,162,253
https://kawalpemilu.org#52840,"PASIRBUYUT, JAWILAN, SERANG, BANTEN",14,49,105,13
https://kawalpemilu.org#52840,"PASIRBUYUT, JAWILAN, SERANG, BANTEN",15,44,183,227
https://kawalpemilu.org#52840,"PASIRBUYUT, JAWILAN, SERANG, BANTEN",16,72,126,198
https://kawalpemilu.org#52840,"PASIRBUYUT, JAWILAN, SERANG, BANTEN",17,28,205,233
https://kawalpemilu.org#52840,"PASIRBUYUT, JAWILAN, SERANG, BANTEN",18,55,168,223
https://kawalpemilu.org#52840,"PASIRBUYUT, JAWILAN, SERANG, BANTEN",19,34,179,213
https://kawalpemilu.org#52840,"PASIRBUYUT, JAWILAN, SERANG, BANTEN",20,73,84,157
https://kawalpemilu.org#52841,"MAJASARI, JAWILAN, SERANG, BANTEN",1,44,139,183
https://kawalpemilu.org#52841,"MAJASARI, JAWILAN, SERANG, BANTEN",2,71,147,218
https://kawalpemilu.org#52841,"MAJASARI, JAWILAN, SERANG, BANTEN",3,35,171,206
https://kawalpemilu.org#52841,"MAJASARI, JAWILAN, SERANG, BANTEN",4,28,205,233
https://kawalpemilu.org#52841,"MAJASARI, JAWILAN, SERANG, BANTEN",5,32,211,243
https://kawalpemilu.org#52841,"MAJASARI, JAWILAN, SERANG, BANTEN",6,36,229,265
https://kawalpemilu.org#52841,"MAJASARI, JAWILAN, SERANG, BANTEN",7,37,200,237
https://kawalpemilu.org#52841,"MAJASARI, JAWILAN, SERANG, BANTEN",8,66,171,237
https://kawalpemilu.org#52841,"MAJASARI, JAWILAN, SERANG, BANTEN",9,36,115,151
https://kawalpemilu.org#52841,"MAJASARI, JAWILAN, SERANG, BANTEN",10,26,144,170
https://kawalpemilu.org#52841,"MAJASARI, JAWILAN, SERANG, BANTEN",11,85,137,222
https://kawalpemilu.org#52841,"MAJASARI, JAWILAN, SERANG, BANTEN",12,58,186,244
https://kawalpemilu.org#52841,"MAJASARI, JAWILAN, SERANG, BANTEN",13,64,160,224
https://kawalpemilu.org#52841,"MAJASARI, JAWILAN, SERANG, BANTEN",14,36,198,234
https://kawalpemilu.org#52841,"MAJASARI, JAWILAN, SERANG, BANTEN",15,56,181,237
https://kawalpemilu.org#52841,"MAJASARI, JAWILAN, SERANG, BANTEN",16,41,205,246
https://kawalpemilu.org#52841,"MAJASARI, JAWILAN, SERANG, BANTEN",17,71,156,227
https://kawalpemilu.org#52841,"MAJASARI, JAWILAN, SERANG, BANTEN",18,23,167,190
https://kawalpemilu.org#52841,"MAJASARI, JAWILAN, SERANG, BANTEN",19,73,153,226
https://kawalpemilu.org#52841,"MAJASARI, JAWILAN, SERANG, BANTEN",20,42,181,223
https://kawalpemilu.org#52841,"MAJASARI, JAWILAN, SERANG, BANTEN",21,52,168,220
https://kawalpemilu.org#52842,"PARAKAN, JAWILAN, SERANG, BANTEN",1,104,142,246
https://kawalpemilu.org#52842,"PARAKAN, JAWILAN, SERANG, BANTEN",2,92,148,240
https://kawalpemilu.org#52842,"PARAKAN, JAWILAN, SERANG, BANTEN",3,83,161,244
https://kawalpemilu.org#52842,"PARAKAN, JAWILAN, SERANG, BANTEN",4,112,118,230
https://kawalpemilu.org#52842,"PARAKAN, JAWILAN, SERANG, BANTEN",5,62,118,180
https://kawalpemilu.org#52842,"PARAKAN, JAWILAN, SERANG, BANTEN",6,58,171,229
https://kawalpemilu.org#52842,"PARAKAN, JAWILAN, SERANG, BANTEN",7,79,160,239
https://kawalpemilu.org#52842,"PARAKAN, JAWILAN, SERANG, BANTEN",8,47,189,236
https://kawalpemilu.org#52842,"PARAKAN, JAWILAN, SERANG, BANTEN",9,46,202,248
https://kawalpemilu.org#52842,"PARAKAN, JAWILAN, SERANG, BANTEN",10,36,201,237
https://kawalpemilu.org#52842,"PARAKAN, JAWILAN, SERANG, BANTEN",11,46,191,237
https://kawalpemilu.org#52842,"PARAKAN, JAWILAN, SERANG, BANTEN",12,46,166,212
https://kawalpemilu.org#52842,"PARAKAN, JAWILAN, SERANG, BANTEN",13,69,158,227
https://kawalpemilu.org#52842,"PARAKAN, JAWILAN, SERANG, BANTEN",14,40,174,214
https://kawalpemilu.org#52842,"PARAKAN, JAWILAN, SERANG, BANTEN",15,82,147,229
https://kawalpemilu.org#52842,"PARAKAN, JAWILAN, SERANG, BANTEN",16,64,144,208
https://kawalpemilu.org#52843,"KAREO, JAWILAN, SERANG, BANTEN",1,51,156,207
https://kawalpemilu.org#52843,"KAREO, JAWILAN, SERANG, BANTEN",2,46,162,208
https://kawalpemilu.org#52843,"KAREO, JAWILAN, SERANG, BANTEN",3,18,155,173
https://kawalpemilu.org#52843,"KAREO, JAWILAN, SERANG, BANTEN",4,32,103,135
https://kawalpemilu.org#52843,"KAREO, JAWILAN, SERANG, BANTEN",5,70,118,188
https://kawalpemilu.org#52843,"KAREO, JAWILAN, SERANG, BANTEN",6,37,201,238
https://kawalpemilu.org#52843,"KAREO, JAWILAN, SERANG, BANTEN",7,62,164,226
https://kawalpemilu.org#52843,"KAREO, JAWILAN, SERANG, BANTEN",8,45,166,211
https://kawalpemilu.org#52843,"KAREO, JAWILAN, SERANG, BANTEN",9,28,148,176
https://kawalpemilu.org#52843,"KAREO, JAWILAN, SERANG, BANTEN",11,35,190,225
https://kawalpemilu.org#52843,"KAREO, JAWILAN, SERANG, BANTEN",12,73,167,240
https://kawalpemilu.org#52843,"KAREO, JAWILAN, SERANG, BANTEN",13,38,151,189
https://kawalpemilu.org#52843,"KAREO, JAWILAN, SERANG, BANTEN",14,41,105,146
https://kawalpemilu.org#52843,"KAREO, JAWILAN, SERANG, BANTEN",15,63,118,181
https://kawalpemilu.org#52843,"KAREO, JAWILAN, SERANG, BANTEN",16,77,99,176
https://kawalpemilu.org#52843,"KAREO, JAWILAN, SERANG, BANTEN",17,48,168,216
https://kawalpemilu.org#52843,"KAREO, JAWILAN, SERANG, BANTEN",18,61,169,230
https://kawalpemilu.org#52843,"KAREO, JAWILAN, SERANG, BANTEN",19,49,128,177
https://kawalpemilu.org#52843,"KAREO, JAWILAN, SERANG, BANTEN",20,52,131,183
https://kawalpemilu.org#52844,"JUNTI, JAWILAN, SERANG, BANTEN",1,55,183,238
https://kawalpemilu.org#52844,"JUNTI, JAWILAN, SERANG, BANTEN",2,96,147,243
https://kawalpemilu.org#52844,"JUNTI, JAWILAN, SERANG, BANTEN",3,53,133,186
https://kawalpemilu.org#52844,"JUNTI, JAWILAN, SERANG, BANTEN",4,73,152,225
https://kawalpemilu.org#52844,"JUNTI, JAWILAN, SERANG, BANTEN",5,64,152,216
https://kawalpemilu.org#52844,"JUNTI, JAWILAN, SERANG, BANTEN",6,91,148,239
https://kawalpemilu.org#52844,"JUNTI, JAWILAN, SERANG, BANTEN",7,96,142,238
https://kawalpemilu.org#52844,"JUNTI, JAWILAN, SERANG, BANTEN",8,77,174,251
https://kawalpemilu.org#52844,"JUNTI, JAWILAN, SERANG, BANTEN",9,53,141,194
https://kawalpemilu.org#52844,"JUNTI, JAWILAN, SERANG, BANTEN",10,89,131,220
https://kawalpemilu.org#52844,"JUNTI, JAWILAN, SERANG, BANTEN",11,60,190,250
https://kawalpemilu.org#52844,"JUNTI, JAWILAN, SERANG, BANTEN",12,82,130,212
https://kawalpemilu.org#52844,"JUNTI, JAWILAN, SERANG, BANTEN",13,108,139,247
https://kawalpemilu.org#52844,"JUNTI, JAWILAN, SERANG, BANTEN",14,113,123,236
https://kawalpemilu.org#52844,"JUNTI, JAWILAN, SERANG, BANTEN",15,86,91,177
https://kawalpemilu.org#52844,"JUNTI, JAWILAN, SERANG, BANTEN",16,61,221,282
https://kawalpemilu.org#52844,"JUNTI, JAWILAN, SERANG, BANTEN",17,59,181,240
https://kawalpemilu.org#52844,"JUNTI, JAWILAN, SERANG, BANTEN",18,54,128,182
https://kawalpemilu.org#52844,"JUNTI, JAWILAN, SERANG, BANTEN",19,47,97,144
https://kawalpemilu.org#52844,"JUNTI, JAWILAN, SERANG, BANTEN",20,49,127,176
https://kawalpemilu.org#52844,"JUNTI, JAWILAN, SERANG, BANTEN",21,42,69,111
https://kawalpemilu.org#52846,"UJUNGTEBU, CIOMAS, SERANG, BANTEN",1,56,159,215
https://kawalpemilu.org#52846,"UJUNGTEBU, CIOMAS, SERANG, BANTEN",2,32,193,225
https://kawalpemilu.org#52846,"UJUNGTEBU, CIOMAS, SERANG, BANTEN",3,30,124,154
https://kawalpemilu.org#52846,"UJUNGTEBU, CIOMAS, SERANG, BANTEN",4,21,127,148
https://kawalpemilu.org#52846,"UJUNGTEBU, CIOMAS, SERANG, BANTEN",5,33,158,191
https://kawalpemilu.org#52846,"UJUNGTEBU, CIOMAS, SERANG, BANTEN",6,30,203,233
https://kawalpemilu.org#52846,"UJUNGTEBU, CIOMAS, SERANG, BANTEN",7,20,177,197
https://kawalpemilu.org#52846,"UJUNGTEBU, CIOMAS, SERANG, BANTEN",8,21,116,137
https://kawalpemilu.org#52846,"UJUNGTEBU, CIOMAS, SERANG, BANTEN",9,35,162,197
https://kawalpemilu.org#52846,"UJUNGTEBU, CIOMAS, SERANG, BANTEN",10,42,148,190
https://kawalpemilu.org#52846,"UJUNGTEBU, CIOMAS, SERANG, BANTEN",11,49,108,157
https://kawalpemilu.org#52846,"UJUNGTEBU, CIOMAS, SERANG, BANTEN",13,32,151,183
https://kawalpemilu.org#52846,"UJUNGTEBU, CIOMAS, SERANG, BANTEN",14,13,159,172
https://kawalpemilu.org#52846,"UJUNGTEBU, CIOMAS, SERANG, BANTEN",15,14,141,155
https://kawalpemilu.org#52847,"SIKETUG, CIOMAS, SERANG, BANTEN",1,50,159,209
https://kawalpemilu.org#52847,"SIKETUG, CIOMAS, SERANG, BANTEN",2,42,179,221
https://kawalpemilu.org#52847,"SIKETUG, CIOMAS, SERANG, BANTEN",3,85,126,211
https://kawalpemilu.org#52847,"SIKETUG, CIOMAS, SERANG, BANTEN",4,73,124,197
https://kawalpemilu.org#52847,"SIKETUG, CIOMAS, SERANG, BANTEN",5,63,116,179
https://kawalpemilu.org#52847,"SIKETUG, CIOMAS, SERANG, BANTEN",6,120,77,197
https://kawalpemilu.org#52847,"SIKETUG, CIOMAS, SERANG, BANTEN",7,39,167,206
https://kawalpemilu.org#52847,"SIKETUG, CIOMAS, SERANG, BANTEN",8,24,164,188
https://kawalpemilu.org#52847,"SIKETUG, CIOMAS, SERANG, BANTEN",9,23,184,207
https://kawalpemilu.org#52848,"LEBAK, CIOMAS, SERANG, BANTEN",1,56,126,182
https://kawalpemilu.org#52848,"LEBAK, CIOMAS, SERANG, BANTEN",2,79,123,202
https://kawalpemilu.org#52848,"LEBAK, CIOMAS, SERANG, BANTEN",3,32,154,186
https://kawalpemilu.org#52848,"LEBAK, CIOMAS, SERANG, BANTEN",4,50,132,182
https://kawalpemilu.org#52848,"LEBAK, CIOMAS, SERANG, BANTEN",6,58,124,182
https://kawalpemilu.org#52848,"LEBAK, CIOMAS, SERANG, BANTEN",7,85,130,215
https://kawalpemilu.org#52848,"LEBAK, CIOMAS, SERANG, BANTEN",8,70,108,178
https://kawalpemilu.org#52848,"LEBAK, CIOMAS, SERANG, BANTEN",9,65,117,182
https://kawalpemilu.org#52848,"LEBAK, CIOMAS, SERANG, BANTEN",10,41,116,157
https://kawalpemilu.org#52848,"LEBAK, CIOMAS, SERANG, BANTEN",11,28,150,178
https://kawalpemilu.org#52848,"LEBAK, CIOMAS, SERANG, BANTEN",12,24,155,179
https://kawalpemilu.org#52848,"LEBAK, CIOMAS, SERANG, BANTEN",13,16,189,205
https://kawalpemilu.org#52849,"PONDOK KAHURU, CIOMAS, SERANG, BANTEN",1,54,164,218
https://kawalpemilu.org#52849,"PONDOK KAHURU, CIOMAS, SERANG, BANTEN",2,31,166,197
https://kawalpemilu.org#52849,"PONDOK KAHURU, CIOMAS, SERANG, BANTEN",3,44,158,202
https://kawalpemilu.org#52849,"PONDOK KAHURU, CIOMAS, SERANG, BANTEN",4,69,133,202
https://kawalpemilu.org#52849,"PONDOK KAHURU, CIOMAS, SERANG, BANTEN",5,24,170,194
https://kawalpemilu.org#52849,"PONDOK KAHURU, CIOMAS, SERANG, BANTEN",6,67,163,230
https://kawalpemilu.org#52849,"PONDOK KAHURU, CIOMAS, SERANG, BANTEN",7,60,131,191
https://kawalpemilu.org#52849,"PONDOK KAHURU, CIOMAS, SERANG, BANTEN",8,109,78,187
https://kawalpemilu.org#52849,"PONDOK KAHURU, CIOMAS, SERANG, BANTEN",9,63,112,175
https://kawalpemilu.org#52849,"PONDOK KAHURU, CIOMAS, SERANG, BANTEN",10,14,128,142
https://kawalpemilu.org#52849,"PONDOK KAHURU, CIOMAS, SERANG, BANTEN",11,31,151,182
https://kawalpemilu.org#52849,"PONDOK KAHURU, CIOMAS, SERANG, BANTEN",12,68,126,194
https://kawalpemilu.org#52849,"PONDOK KAHURU, CIOMAS, SERANG, BANTEN",13,57,78,135
https://kawalpemilu.org#52850,"SUKABARES, CIOMAS, SERANG, BANTEN",1,48,144,192
https://kawalpemilu.org#52850,"SUKABARES, CIOMAS, SERANG, BANTEN",2,88,134,222
https://kawalpemilu.org#52850,"SUKABARES, CIOMAS, SERANG, BANTEN",3,69,143,212
https://kawalpemilu.org#52850,"SUKABARES, CIOMAS, SERANG, BANTEN",4,57,138,195
https://kawalpemilu.org#52850,"SUKABARES, CIOMAS, SERANG, BANTEN",5,34,162,196
https://kawalpemilu.org#52850,"SUKABARES, CIOMAS, SERANG, BANTEN",6,45,135,180
https://kawalpemilu.org#52850,"SUKABARES, CIOMAS, SERANG, BANTEN",7,60,125,185
https://kawalpemilu.org#52850,"SUKABARES, CIOMAS, SERANG, BANTEN",8,37,198,235
https://kawalpemilu.org#52850,"SUKABARES, CIOMAS, SERANG, BANTEN",9,48,171,219
https://kawalpemilu.org#52851,"SUKARENA, CIOMAS, SERANG, BANTEN",1,54,179,233
https://kawalpemilu.org#52851,"SUKARENA, CIOMAS, SERANG, BANTEN",2,48,180,228
https://kawalpemilu.org#52851,"SUKARENA, CIOMAS, SERANG, BANTEN",3,25,161,186
https://kawalpemilu.org#52851,"SUKARENA, CIOMAS, SERANG, BANTEN",4,39,147,186
https://kawalpemilu.org#52851,"SUKARENA, CIOMAS, SERANG, BANTEN",5,64,140,204
https://kawalpemilu.org#52851,"SUKARENA, CIOMAS, SERANG, BANTEN",6,23,162,185
https://kawalpemilu.org#52851,"SUKARENA, CIOMAS, SERANG, BANTEN",7,14,155,169
https://kawalpemilu.org#52851,"SUKARENA, CIOMAS, SERANG, BANTEN",8,9,209,218
https://kawalpemilu.org#52851,"SUKARENA, CIOMAS, SERANG, BANTEN",9,30,189,219
https://kawalpemilu.org#52851,"SUKARENA, CIOMAS, SERANG, BANTEN",10,12,195,207
https://kawalpemilu.org#52851,"SUKARENA, CIOMAS, SERANG, BANTEN",11,68,141,209
https://kawalpemilu.org#52851,"SUKARENA, CIOMAS, SERANG, BANTEN",12,37,173,210
https://kawalpemilu.org#52851,"SUKARENA, CIOMAS, SERANG, BANTEN",13,32,192,224
https://kawalpemilu.org#52851,"SUKARENA, CIOMAS, SERANG, BANTEN",14,38,103,141
https://kawalpemilu.org#52852,"SUKADANA, CIOMAS, SERANG, BANTEN",1,76,162,238
https://kawalpemilu.org#52852,"SUKADANA, CIOMAS, SERANG, BANTEN",2,38,143,181
https://kawalpemilu.org#52852,"SUKADANA, CIOMAS, SERANG, BANTEN",3,79,148,227
https://kawalpemilu.org#52852,"SUKADANA, CIOMAS, SERANG, BANTEN",4,60,134,194
https://kawalpemilu.org#52852,"SUKADANA, CIOMAS, SERANG, BANTEN",5,21,223,244
https://kawalpemilu.org#52852,"SUKADANA, CIOMAS, SERANG, BANTEN",6,63,173,236
https://kawalpemilu.org#52852,"SUKADANA, CIOMAS, SERANG, BANTEN",7,62,180,242
https://kawalpemilu.org#52852,"SUKADANA, CIOMAS, SERANG, BANTEN",8,44,121,165
https://kawalpemilu.org#52852,"SUKADANA, CIOMAS, SERANG, BANTEN",9,97,157,252
https://kawalpemilu.org#52852,"SUKADANA, CIOMAS, SERANG, BANTEN",10,59,118,177
https://kawalpemilu.org#52852,"SUKADANA, CIOMAS, SERANG, BANTEN",11,68,137,205
https://kawalpemilu.org#52852,"SUKADANA, CIOMAS, SERANG, BANTEN",12,69,128,197
https://kawalpemilu.org#52852,"SUKADANA, CIOMAS, SERANG, BANTEN",13,66,148,214
https://kawalpemilu.org#52852,"SUKADANA, CIOMAS, SERANG, BANTEN",14,69,127,196
https://kawalpemilu.org#52852,"SUKADANA, CIOMAS, SERANG, BANTEN",15,36,159,195
https://kawalpemilu.org#52853,"CEMPLANG, CIOMAS, SERANG, BANTEN",2,35,179,214
https://kawalpemilu.org#52853,"CEMPLANG, CIOMAS, SERANG, BANTEN",3,48,155,203
https://kawalpemilu.org#52853,"CEMPLANG, CIOMAS, SERANG, BANTEN",4,51,105,156
https://kawalpemilu.org#52853,"CEMPLANG, CIOMAS, SERANG, BANTEN",5,45,174,219
https://kawalpemilu.org#52853,"CEMPLANG, CIOMAS, SERANG, BANTEN",6,60,123,183
https://kawalpemilu.org#52853,"CEMPLANG, CIOMAS, SERANG, BANTEN",7,46,146,192
https://kawalpemilu.org#52853,"CEMPLANG, CIOMAS, SERANG, BANTEN",8,55,114,169
https://kawalpemilu.org#52853,"CEMPLANG, CIOMAS, SERANG, BANTEN",9,48,152,200
https://kawalpemilu.org#52853,"CEMPLANG, CIOMAS, SERANG, BANTEN",10,15,105,120
https://kawalpemilu.org#52854,"CISITU, CIOMAS, SERANG, BANTEN",1,20,148,168
https://kawalpemilu.org#52854,"CISITU, CIOMAS, SERANG, BANTEN",2,45,140,185
https://kawalpemilu.org#52854,"CISITU, CIOMAS, SERANG, BANTEN",3,110,111,221
https://kawalpemilu.org#52854,"CISITU, CIOMAS, SERANG, BANTEN",4,43,168,211
https://kawalpemilu.org#52854,"CISITU, CIOMAS, SERANG, BANTEN",5,61,135,196
https://kawalpemilu.org#52854,"CISITU, CIOMAS, SERANG, BANTEN",6,53,148,201
https://kawalpemilu.org#52854,"CISITU, CIOMAS, SERANG, BANTEN",7,51,163,214
https://kawalpemilu.org#52854,"CISITU, CIOMAS, SERANG, BANTEN",8,59,157,216
https://kawalpemilu.org#52854,"CISITU, CIOMAS, SERANG, BANTEN",9,67,167,234
https://kawalpemilu.org#52855,"CITAMAN, CIOMAS, SERANG, BANTEN",1,37,169,206
https://kawalpemilu.org#52855,"CITAMAN, CIOMAS, SERANG, BANTEN",2,39,185,224
https://kawalpemilu.org#52855,"CITAMAN, CIOMAS, SERANG, BANTEN",3,24,169,193
https://kawalpemilu.org#52855,"CITAMAN, CIOMAS, SERANG, BANTEN",4,96,77,173
https://kawalpemilu.org#52855,"CITAMAN, CIOMAS, SERANG, BANTEN",5,56,99,155
https://kawalpemilu.org#52855,"CITAMAN, CIOMAS, SERANG, BANTEN",6,93,122,215
https://kawalpemilu.org#52855,"CITAMAN, CIOMAS, SERANG, BANTEN",7,71,75,146
https://kawalpemilu.org#52855,"CITAMAN, CIOMAS, SERANG, BANTEN",8,113,60,173
https://kawalpemilu.org#52855,"CITAMAN, CIOMAS, SERANG, BANTEN",9,63,100,163
https://kawalpemilu.org#52856,"PANYAUNGAN JAYA, CIOMAS, SERANG, BANTEN",1,29,187,216
https://kawalpemilu.org#52856,"PANYAUNGAN JAYA, CIOMAS, SERANG, BANTEN",2,29,180,209
https://kawalpemilu.org#52856,"PANYAUNGAN JAYA, CIOMAS, SERANG, BANTEN",3,37,119,156
https://kawalpemilu.org#52856,"PANYAUNGAN JAYA, CIOMAS, SERANG, BANTEN",4,40,133,173
https://kawalpemilu.org#52856,"PANYAUNGAN JAYA, CIOMAS, SERANG, BANTEN",5,39,153,192
https://kawalpemilu.org#52856,"PANYAUNGAN JAYA, CIOMAS, SERANG, BANTEN",7,34,83,117
https://kawalpemilu.org#52856,"PANYAUNGAN JAYA, CIOMAS, SERANG, BANTEN",8,46,112,158
https://kawalpemilu.org#52856,"PANYAUNGAN JAYA, CIOMAS, SERANG, BANTEN",9,26,162,188
https://kawalpemilu.org#52856,"PANYAUNGAN JAYA, CIOMAS, SERANG, BANTEN",10,12,153,165
https://kawalpemilu.org#52856,"PANYAUNGAN JAYA, CIOMAS, SERANG, BANTEN",11,13,192,205
https://kawalpemilu.org#52858,"PABUARAN, PABUARAN, SERANG, BANTEN",1,20,202,222
https://kawalpemilu.org#52858,"PABUARAN, PABUARAN, SERANG, BANTEN",2,18,205,223
https://kawalpemilu.org#52858,"PABUARAN, PABUARAN, SERANG, BANTEN",3,21,210,231
https://kawalpemilu.org#52858,"PABUARAN, PABUARAN, SERANG, BANTEN",4,41,171,212
https://kawalpemilu.org#52858,"PABUARAN, PABUARAN, SERANG, BANTEN",5,61,207,268
https://kawalpemilu.org#52858,"PABUARAN, PABUARAN, SERANG, BANTEN",6,82,170,252
https://kawalpemilu.org#52858,"PABUARAN, PABUARAN, SERANG, BANTEN",7,58,170,228
https://kawalpemilu.org#52858,"PABUARAN, PABUARAN, SERANG, BANTEN",8,48,181,229
https://kawalpemilu.org#52858,"PABUARAN, PABUARAN, SERANG, BANTEN",9,48,150,198
https://kawalpemilu.org#52858,"PABUARAN, PABUARAN, SERANG, BANTEN",10,41,196,237
https://kawalpemilu.org#52858,"PABUARAN, PABUARAN, SERANG, BANTEN",11,80,158,238
https://kawalpemilu.org#52858,"PABUARAN, PABUARAN, SERANG, BANTEN",12,44,74,118
https://kawalpemilu.org#52858,"PABUARAN, PABUARAN, SERANG, BANTEN",13,48,170,218
https://kawalpemilu.org#52858,"PABUARAN, PABUARAN, SERANG, BANTEN",14,35,236,271
https://kawalpemilu.org#52858,"PABUARAN, PABUARAN, SERANG, BANTEN",15,35,166,201
https://kawalpemilu.org#52858,"PABUARAN, PABUARAN, SERANG, BANTEN",16,46,144,190
https://kawalpemilu.org#52858,"PABUARAN, PABUARAN, SERANG, BANTEN",17,48,120,168
https://kawalpemilu.org#52858,"PABUARAN, PABUARAN, SERANG, BANTEN",18,46,105,151
https://kawalpemilu.org#52858,"PABUARAN, PABUARAN, SERANG, BANTEN",19,80,61,141
https://kawalpemilu.org#52858,"PABUARAN, PABUARAN, SERANG, BANTEN",20,53,54,107
https://kawalpemilu.org#52859,"KADUBEUREUM, PABUARAN, SERANG, BANTEN",1,45,128,173
https://kawalpemilu.org#52859,"KADUBEUREUM, PABUARAN, SERANG, BANTEN",2,59,107,166
https://kawalpemilu.org#52859,"KADUBEUREUM, PABUARAN, SERANG, BANTEN",3,82,130,212
https://kawalpemilu.org#52859,"KADUBEUREUM, PABUARAN, SERANG, BANTEN",4,26,71,97
https://kawalpemilu.org#52859,"KADUBEUREUM, PABUARAN, SERANG, BANTEN",5,70,104,174
https://kawalpemilu.org#52859,"KADUBEUREUM, PABUARAN, SERANG, BANTEN",6,97,86,183
https://kawalpemilu.org#52859,"KADUBEUREUM, PABUARAN, SERANG, BANTEN",7,60,103,163
https://kawalpemilu.org#52859,"KADUBEUREUM, PABUARAN, SERANG, BANTEN",8,54,114,168
https://kawalpemilu.org#52859,"KADUBEUREUM, PABUARAN, SERANG, BANTEN",9,86,132,218
https://kawalpemilu.org#52859,"KADUBEUREUM, PABUARAN, SERANG, BANTEN",10,80,150,230
https://kawalpemilu.org#52859,"KADUBEUREUM, PABUARAN, SERANG, BANTEN",11,52,223,275
https://kawalpemilu.org#52859,"KADUBEUREUM, PABUARAN, SERANG, BANTEN",12,30,168,198
https://kawalpemilu.org#52859,"KADUBEUREUM, PABUARAN, SERANG, BANTEN",13,53,146,199
https://kawalpemilu.org#52859,"KADUBEUREUM, PABUARAN, SERANG, BANTEN",14,80,108,188
https://kawalpemilu.org#52859,"KADUBEUREUM, PABUARAN, SERANG, BANTEN",15,61,98,159
https://kawalpemilu.org#52859,"KADUBEUREUM, PABUARAN, SERANG, BANTEN",16,92,112,204
https://kawalpemilu.org#52859,"KADUBEUREUM, PABUARAN, SERANG, BANTEN",17,61,55,116
https://kawalpemilu.org#52859,"KADUBEUREUM, PABUARAN, SERANG, BANTEN",18,24,45,69
https://kawalpemilu.org#52860,"TANJUNGSARI, PABUARAN, SERANG, BANTEN",1,26,195,221
https://kawalpemilu.org#52860,"TANJUNGSARI, PABUARAN, SERANG, BANTEN",2,14,219,233
https://kawalpemilu.org#52860,"TANJUNGSARI, PABUARAN, SERANG, BANTEN",3,56,185,241
https://kawalpemilu.org#52860,"TANJUNGSARI, PABUARAN, SERANG, BANTEN",4,28,223,251
https://kawalpemilu.org#52860,"TANJUNGSARI, PABUARAN, SERANG, BANTEN",5,27,175,202
https://kawalpemilu.org#52860,"TANJUNGSARI, PABUARAN, SERANG, BANTEN",6,44,201,245
https://kawalpemilu.org#52860,"TANJUNGSARI, PABUARAN, SERANG, BANTEN",7,19,165,184
https://kawalpemilu.org#52860,"TANJUNGSARI, PABUARAN, SERANG, BANTEN",8,20,156,176
https://kawalpemilu.org#52860,"TANJUNGSARI, PABUARAN, SERANG, BANTEN",9,24,183,207
https://kawalpemilu.org#52860,"TANJUNGSARI, PABUARAN, SERANG, BANTEN",10,25,140,165
https://kawalpemilu.org#52860,"TANJUNGSARI, PABUARAN, SERANG, BANTEN",11,22,135,157
https://kawalpemilu.org#52861,"PANCANEGARA, PABUARAN, SERANG, BANTEN",1,106,150,256
https://kawalpemilu.org#52861,"PANCANEGARA, PABUARAN, SERANG, BANTEN",2,84,143,227
https://kawalpemilu.org#52861,"PANCANEGARA, PABUARAN, SERANG, BANTEN",3,45,160,205
https://kawalpemilu.org#52861,"PANCANEGARA, PABUARAN, SERANG, BANTEN",4,50,156,206
https://kawalpemilu.org#52861,"PANCANEGARA, PABUARAN, SERANG, BANTEN",5,52,157,209
https://kawalpemilu.org#52861,"PANCANEGARA, PABUARAN, SERANG, BANTEN",6,57,158,215
https://kawalpemilu.org#52861,"PANCANEGARA, PABUARAN, SERANG, BANTEN",7,71,134,205
https://kawalpemilu.org#52861,"PANCANEGARA, PABUARAN, SERANG, BANTEN",8,67,105,172
https://kawalpemilu.org#52861,"PANCANEGARA, PABUARAN, SERANG, BANTEN",9,78,136,214
https://kawalpemilu.org#52861,"PANCANEGARA, PABUARAN, SERANG, BANTEN",10,50,118,168
https://kawalpemilu.org#52861,"PANCANEGARA, PABUARAN, SERANG, BANTEN",11,47,95,142
https://kawalpemilu.org#52861,"PANCANEGARA, PABUARAN, SERANG, BANTEN",12,30,128,158
https://kawalpemilu.org#52861,"PANCANEGARA, PABUARAN, SERANG, BANTEN",13,73,91,164
https://kawalpemilu.org#52861,"PANCANEGARA, PABUARAN, SERANG, BANTEN",14,71,174,245
https://kawalpemilu.org#52861,"PANCANEGARA, PABUARAN, SERANG, BANTEN",15,87,119,206
https://kawalpemilu.org#52861,"PANCANEGARA, PABUARAN, SERANG, BANTEN",16,75,124,199
https://kawalpemilu.org#52861,"PANCANEGARA, PABUARAN, SERANG, BANTEN",17,23,94,117
https://kawalpemilu.org#52861,"PANCANEGARA, PABUARAN, SERANG, BANTEN",18,62,99,161
https://kawalpemilu.org#52861,"PANCANEGARA, PABUARAN, SERANG, BANTEN",19,79,57,136
https://kawalpemilu.org#52862,"SINDANGSARI, PABUARAN, SERANG, BANTEN",1,61,157,218
https://kawalpemilu.org#52862,"SINDANGSARI, PABUARAN, SERANG, BANTEN",2,60,122,182
https://kawalpemilu.org#52862,"SINDANGSARI, PABUARAN, SERANG, BANTEN",3,66,184,250
https://kawalpemilu.org#52862,"SINDANGSARI, PABUARAN, SERANG, BANTEN",4,67,176,243
https://kawalpemilu.org#52862,"SINDANGSARI, PABUARAN, SERANG, BANTEN",5,82,159,241
https://kawalpemilu.org#52862,"SINDANGSARI, PABUARAN, SERANG, BANTEN",7,37,192,229
https://kawalpemilu.org#52862,"SINDANGSARI, PABUARAN, SERANG, BANTEN",10,58,192,250
https://kawalpemilu.org#52862,"SINDANGSARI, PABUARAN, SERANG, BANTEN",11,0,0,0
https://kawalpemilu.org#52862,"SINDANGSARI, PABUARAN, SERANG, BANTEN",12,44,163,207
https://kawalpemilu.org#52862,"SINDANGSARI, PABUARAN, SERANG, BANTEN",13,40,157,197
https://kawalpemilu.org#52862,"SINDANGSARI, PABUARAN, SERANG, BANTEN",14,52,180,232
https://kawalpemilu.org#52862,"SINDANGSARI, PABUARAN, SERANG, BANTEN",15,73,160,233
https://kawalpemilu.org#52862,"SINDANGSARI, PABUARAN, SERANG, BANTEN",16,92,110,202
https://kawalpemilu.org#52862,"SINDANGSARI, PABUARAN, SERANG, BANTEN",17,75,132,207
https://kawalpemilu.org#52862,"SINDANGSARI, PABUARAN, SERANG, BANTEN",18,134,78,212
https://kawalpemilu.org#52862,"SINDANGSARI, PABUARAN, SERANG, BANTEN",19,64,159,223
https://kawalpemilu.org#52862,"SINDANGSARI, PABUARAN, SERANG, BANTEN",20,100,128,228
https://kawalpemilu.org#52862,"SINDANGSARI, PABUARAN, SERANG, BANTEN",21,46,155,201
https://kawalpemilu.org#52862,"SINDANGSARI, PABUARAN, SERANG, BANTEN",22,34,81,115
https://kawalpemilu.org#52863,"SINDANGHEULA, PABUARAN, SERANG, BANTEN",1,60,172,232
https://kawalpemilu.org#52863,"SINDANGHEULA, PABUARAN, SERANG, BANTEN",2,45,218,263
https://kawalpemilu.org#52863,"SINDANGHEULA, PABUARAN, SERANG, BANTEN",3,66,184,250
https://kawalpemilu.org#52863,"SINDANGHEULA, PABUARAN, SERANG, BANTEN",4,62,188,250
https://kawalpemilu.org#52863,"SINDANGHEULA, PABUARAN, SERANG, BANTEN",5,46,142,188
https://kawalpemilu.org#52863,"SINDANGHEULA, PABUARAN, SERANG, BANTEN",6,69,160,229
https://kawalpemilu.org#52863,"SINDANGHEULA, PABUARAN, SERANG, BANTEN",7,57,169,226
https://kawalpemilu.org#52863,"SINDANGHEULA, PABUARAN, SERANG, BANTEN",8,20,223,243
https://kawalpemilu.org#52863,"SINDANGHEULA, PABUARAN, SERANG, BANTEN",9,18,197,215
https://kawalpemilu.org#52863,"SINDANGHEULA, PABUARAN, SERANG, BANTEN",10,14,149,163
https://kawalpemilu.org#52863,"SINDANGHEULA, PABUARAN, SERANG, BANTEN",11,28,179,207
https://kawalpemilu.org#52863,"SINDANGHEULA, PABUARAN, SERANG, BANTEN",12,62,169,231
https://kawalpemilu.org#52863,"SINDANGHEULA, PABUARAN, SERANG, BANTEN",13,52,110,162
https://kawalpemilu.org#52863,"SINDANGHEULA, PABUARAN, SERANG, BANTEN",14,66,180,246
https://kawalpemilu.org#52863,"SINDANGHEULA, PABUARAN, SERANG, BANTEN",15,69,103,172
https://kawalpemilu.org#52863,"SINDANGHEULA, PABUARAN, SERANG, BANTEN",16,23,120,143
https://kawalpemilu.org#52863,"SINDANGHEULA, PABUARAN, SERANG, BANTEN",17,29,142,171
https://kawalpemilu.org#52863,"SINDANGHEULA, PABUARAN, SERANG, BANTEN",18,42,161,203
https://kawalpemilu.org#52863,"SINDANGHEULA, PABUARAN, SERANG, BANTEN",19,42,153,195
https://kawalpemilu.org#52863,"SINDANGHEULA, PABUARAN, SERANG, BANTEN",20,59,139,198
https://kawalpemilu.org#52863,"SINDANGHEULA, PABUARAN, SERANG, BANTEN",21,25,73,98
https://kawalpemilu.org#52863,"SINDANGHEULA, PABUARAN, SERANG, BANTEN",22,42,157,199
https://kawalpemilu.org#52864,"PASANGGRAHAN, PABUARAN, SERANG, BANTEN",1,67,169,236
https://kawalpemilu.org#52864,"PASANGGRAHAN, PABUARAN, SERANG, BANTEN",2,66,130,196
https://kawalpemilu.org#52864,"PASANGGRAHAN, PABUARAN, SERANG, BANTEN",3,138,71,209
https://kawalpemilu.org#52864,"PASANGGRAHAN, PABUARAN, SERANG, BANTEN",4,123,87,210
https://kawalpemilu.org#52864,"PASANGGRAHAN, PABUARAN, SERANG, BANTEN",5,57,143,206
https://kawalpemilu.org#52864,"PASANGGRAHAN, PABUARAN, SERANG, BANTEN",6,24,242,266
https://kawalpemilu.org#52864,"PASANGGRAHAN, PABUARAN, SERANG, BANTEN",7,43,151,194
https://kawalpemilu.org#52864,"PASANGGRAHAN, PABUARAN, SERANG, BANTEN",8,46,192,238
https://kawalpemilu.org#52864,"PASANGGRAHAN, PABUARAN, SERANG, BANTEN",9,52,107,159
https://kawalpemilu.org#52864,"PASANGGRAHAN, PABUARAN, SERANG, BANTEN",11,32,97,129
https://kawalpemilu.org#84988,"TALAGA WARNA, PABUARAN, SERANG, BANTEN",1,37,164,201
https://kawalpemilu.org#84988,"TALAGA WARNA, PABUARAN, SERANG, BANTEN",2,50,117,167
https://kawalpemilu.org#84988,"TALAGA WARNA, PABUARAN, SERANG, BANTEN",3,50,155,205
https://kawalpemilu.org#84988,"TALAGA WARNA, PABUARAN, SERANG, BANTEN",4,59,105,164
https://kawalpemilu.org#84988,"TALAGA WARNA, PABUARAN, SERANG, BANTEN",5,12,111,123
https://kawalpemilu.org#52866,"PADARINCANG, PADARINCANG, SERANG, BANTEN",1,72,125,197
https://kawalpemilu.org#52866,"PADARINCANG, PADARINCANG, SERANG, BANTEN",2,62,118,180
https://kawalpemilu.org#52866,"PADARINCANG, PADARINCANG, SERANG, BANTEN",3,60,135,195
https://kawalpemilu.org#52866,"PADARINCANG, PADARINCANG, SERANG, BANTEN",4,73,137,210
https://kawalpemilu.org#52866,"PADARINCANG, PADARINCANG, SERANG, BANTEN",5,31,182,213
https://kawalpemilu.org#52866,"PADARINCANG, PADARINCANG, SERANG, BANTEN",6,70,121,191
https://kawalpemilu.org#52866,"PADARINCANG, PADARINCANG, SERANG, BANTEN",7,76,111,187
https://kawalpemilu.org#52866,"PADARINCANG, PADARINCANG, SERANG, BANTEN",8,82,100,182
https://kawalpemilu.org#52866,"PADARINCANG, PADARINCANG, SERANG, BANTEN",9,71,74,145
https://kawalpemilu.org#52866,"PADARINCANG, PADARINCANG, SERANG, BANTEN",10,66,115,181
https://kawalpemilu.org#52866,"PADARINCANG, PADARINCANG, SERANG, BANTEN",11,81,173,254
https://kawalpemilu.org#52866,"PADARINCANG, PADARINCANG, SERANG, BANTEN",12,28,198,225
https://kawalpemilu.org#52866,"PADARINCANG, PADARINCANG, SERANG, BANTEN",13,52,141,193
https://kawalpemilu.org#52866,"PADARINCANG, PADARINCANG, SERANG, BANTEN",14,104,114,218
https://kawalpemilu.org#52866,"PADARINCANG, PADARINCANG, SERANG, BANTEN",15,67,60,127
https://kawalpemilu.org#52867,"BUGEL, PADARINCANG, SERANG, BANTEN",1,38,153,191
https://kawalpemilu.org#52867,"BUGEL, PADARINCANG, SERANG, BANTEN",2,34,134,168
https://kawalpemilu.org#52867,"BUGEL, PADARINCANG, SERANG, BANTEN",3,61,108,169
https://kawalpemilu.org#52867,"BUGEL, PADARINCANG, SERANG, BANTEN",4,48,116,164
https://kawalpemilu.org#52867,"BUGEL, PADARINCANG, SERANG, BANTEN",5,45,132,177
https://kawalpemilu.org#52867,"BUGEL, PADARINCANG, SERANG, BANTEN",6,40,143,183
https://kawalpemilu.org#52867,"BUGEL, PADARINCANG, SERANG, BANTEN",7,39,157,196
https://kawalpemilu.org#52867,"BUGEL, PADARINCANG, SERANG, BANTEN",8,47,134,181
https://kawalpemilu.org#52867,"BUGEL, PADARINCANG, SERANG, BANTEN",9,46,115,161
https://kawalpemilu.org#52867,"BUGEL, PADARINCANG, SERANG, BANTEN",10,31,131,162
https://kawalpemilu.org#52867,"BUGEL, PADARINCANG, SERANG, BANTEN",11,52,94,146
https://kawalpemilu.org#52867,"BUGEL, PADARINCANG, SERANG, BANTEN",12,70,85,155
https://kawalpemilu.org#52867,"BUGEL, PADARINCANG, SERANG, BANTEN",13,40,136,176
https://kawalpemilu.org#52867,"BUGEL, PADARINCANG, SERANG, BANTEN",14,59,88,147
https://kawalpemilu.org#52867,"BUGEL, PADARINCANG, SERANG, BANTEN",15,79,113,192
https://kawalpemilu.org#52867,"BUGEL, PADARINCANG, SERANG, BANTEN",16,29,140,169
https://kawalpemilu.org#52868,"CIBOJONG, PADARINCANG, SERANG, BANTEN",1,44,122,166
https://kawalpemilu.org#52868,"CIBOJONG, PADARINCANG, SERANG, BANTEN",2,36,109,145
https://kawalpemilu.org#52868,"CIBOJONG, PADARINCANG, SERANG, BANTEN",3,65,154,219
https://kawalpemilu.org#52868,"CIBOJONG, PADARINCANG, SERANG, BANTEN",4,55,166,221
https://kawalpemilu.org#52868,"CIBOJONG, PADARINCANG, SERANG, BANTEN",5,84,119,203
https://kawalpemilu.org#52868,"CIBOJONG, PADARINCANG, SERANG, BANTEN",6,59,126,185
https://kawalpemilu.org#52868,"CIBOJONG, PADARINCANG, SERANG, BANTEN",7,37,114,151
https://kawalpemilu.org#52868,"CIBOJONG, PADARINCANG, SERANG, BANTEN",8,36,155,191
https://kawalpemilu.org#52868,"CIBOJONG, PADARINCANG, SERANG, BANTEN",9,49,148,197
https://kawalpemilu.org#52868,"CIBOJONG, PADARINCANG, SERANG, BANTEN",10,44,187,231
https://kawalpemilu.org#52868,"CIBOJONG, PADARINCANG, SERANG, BANTEN",11,43,129,172
https://kawalpemilu.org#52868,"CIBOJONG, PADARINCANG, SERANG, BANTEN",12,18,109,127
https://kawalpemilu.org#52869,"CITASUK, PADARINCANG, SERANG, BANTEN",1,43,151,194
https://kawalpemilu.org#52869,"CITASUK, PADARINCANG, SERANG, BANTEN",2,70,126,196
https://kawalpemilu.org#52869,"CITASUK, PADARINCANG, SERANG, BANTEN",3,67,109,176
https://kawalpemilu.org#52869,"CITASUK, PADARINCANG, SERANG, BANTEN",4,81,117,198
https://kawalpemilu.org#52869,"CITASUK, PADARINCANG, SERANG, BANTEN",5,94,83,177
https://kawalpemilu.org#52869,"CITASUK, PADARINCANG, SERANG, BANTEN",6,100,134,234
https://kawalpemilu.org#52869,"CITASUK, PADARINCANG, SERANG, BANTEN",7,76,112,188
https://kawalpemilu.org#52869,"CITASUK, PADARINCANG, SERANG, BANTEN",8,59,125,184
https://kawalpemilu.org#52869,"CITASUK, PADARINCANG, SERANG, BANTEN",9,72,133,205
https://kawalpemilu.org#52869,"CITASUK, PADARINCANG, SERANG, BANTEN",10,37,198,235
https://kawalpemilu.org#52869,"CITASUK, PADARINCANG, SERANG, BANTEN",11,35,158,193
https://kawalpemilu.org#52869,"CITASUK, PADARINCANG, SERANG, BANTEN",12,26,146,172
https://kawalpemilu.org#52869,"CITASUK, PADARINCANG, SERANG, BANTEN",13,44,136,180
https://kawalpemilu.org#52869,"CITASUK, PADARINCANG, SERANG, BANTEN",14,101,110,211
https://kawalpemilu.org#52869,"CITASUK, PADARINCANG, SERANG, BANTEN",15,65,142,207
https://kawalpemilu.org#52869,"CITASUK, PADARINCANG, SERANG, BANTEN",16,68,95,163
https://kawalpemilu.org#52869,"CITASUK, PADARINCANG, SERANG, BANTEN",17,107,72,179
https://kawalpemilu.org#52869,"CITASUK, PADARINCANG, SERANG, BANTEN",18,61,121,3
https://kawalpemilu.org#52869,"CITASUK, PADARINCANG, SERANG, BANTEN",19,59,116,175
https://kawalpemilu.org#52869,"CITASUK, PADARINCANG, SERANG, BANTEN",20,77,81,158
https://kawalpemilu.org#52869,"CITASUK, PADARINCANG, SERANG, BANTEN",21,71,71,142
https://kawalpemilu.org#52869,"CITASUK, PADARINCANG, SERANG, BANTEN",22,54,130,184
https://kawalpemilu.org#52870,"CISAAT, PADARINCANG, SERANG, BANTEN",1,52,123,175
https://kawalpemilu.org#52870,"CISAAT, PADARINCANG, SERANG, BANTEN",2,56,122,178
https://kawalpemilu.org#52870,"CISAAT, PADARINCANG, SERANG, BANTEN",3,80,166,246
https://kawalpemilu.org#52870,"CISAAT, PADARINCANG, SERANG, BANTEN",4,66,141,207
https://kawalpemilu.org#52870,"CISAAT, PADARINCANG, SERANG, BANTEN",5,65,124,189
https://kawalpemilu.org#52870,"CISAAT, PADARINCANG, SERANG, BANTEN",6,37,191,228
https://kawalpemilu.org#52870,"CISAAT, PADARINCANG, SERANG, BANTEN",7,29,170,199
https://kawalpemilu.org#52870,"CISAAT, PADARINCANG, SERANG, BANTEN",8,40,143,183
https://kawalpemilu.org#52870,"CISAAT, PADARINCANG, SERANG, BANTEN",9,25,157,182
https://kawalpemilu.org#52870,"CISAAT, PADARINCANG, SERANG, BANTEN",10,19,186,205
https://kawalpemilu.org#52871,"CIOMAS, PADARINCANG, SERANG, BANTEN",1,23,152,175
https://kawalpemilu.org#52871,"CIOMAS, PADARINCANG, SERANG, BANTEN",2,42,141,183
https://kawalpemilu.org#52871,"CIOMAS, PADARINCANG, SERANG, BANTEN",3,44,128,172
https://kawalpemilu.org#52871,"CIOMAS, PADARINCANG, SERANG, BANTEN",4,25,126,151
https://kawalpemilu.org#52871,"CIOMAS, PADARINCANG, SERANG, BANTEN",5,15,142,157
https://kawalpemilu.org#52871,"CIOMAS, PADARINCANG, SERANG, BANTEN",6,55,151,206
https://kawalpemilu.org#52871,"CIOMAS, PADARINCANG, SERANG, BANTEN",7,50,137,187
https://kawalpemilu.org#52871,"CIOMAS, PADARINCANG, SERANG, BANTEN",8,30,143,173
https://kawalpemilu.org#52871,"CIOMAS, PADARINCANG, SERANG, BANTEN",9,33,167,200
https://kawalpemilu.org#52871,"CIOMAS, PADARINCANG, SERANG, BANTEN",10,32,172,204
https://kawalpemilu.org#52871,"CIOMAS, PADARINCANG, SERANG, BANTEN",11,16,183,199
https://kawalpemilu.org#52871,"CIOMAS, PADARINCANG, SERANG, BANTEN",12,18,201,219
https://kawalpemilu.org#52871,"CIOMAS, PADARINCANG, SERANG, BANTEN",13,16,125,141
https://kawalpemilu.org#52871,"CIOMAS, PADARINCANG, SERANG, BANTEN",14,55,123,178
https://kawalpemilu.org#52871,"CIOMAS, PADARINCANG, SERANG, BANTEN",16,54,137,191
https://kawalpemilu.org#52871,"CIOMAS, PADARINCANG, SERANG, BANTEN",17,52,115,6
https://kawalpemilu.org#52871,"CIOMAS, PADARINCANG, SERANG, BANTEN",18,60,125,185
https://kawalpemilu.org#52871,"CIOMAS, PADARINCANG, SERANG, BANTEN",19,44,138,182
https://kawalpemilu.org#52871,"CIOMAS, PADARINCANG, SERANG, BANTEN",20,51,115,166
https://kawalpemilu.org#52871,"CIOMAS, PADARINCANG, SERANG, BANTEN",21,28,150,178
https://kawalpemilu.org#52871,"CIOMAS, PADARINCANG, SERANG, BANTEN",22,43,131,174
https://kawalpemilu.org#52871,"CIOMAS, PADARINCANG, SERANG, BANTEN",23,26,149,175
https://kawalpemilu.org#52872,"BARUGBUG, PADARINCANG, SERANG, BANTEN",1,46,157,203
https://kawalpemilu.org#52872,"BARUGBUG, PADARINCANG, SERANG, BANTEN",2,73,132,205
https://kawalpemilu.org#52872,"BARUGBUG, PADARINCANG, SERANG, BANTEN",3,41,148,189
https://kawalpemilu.org#52872,"BARUGBUG, PADARINCANG, SERANG, BANTEN",4,64,131,195
https://kawalpemilu.org#52872,"BARUGBUG, PADARINCANG, SERANG, BANTEN",6,98,98,196
https://kawalpemilu.org#52872,"BARUGBUG, PADARINCANG, SERANG, BANTEN",7,76,85,161
https://kawalpemilu.org#52873,"BATU KUWUNG, PADARINCANG, SERANG, BANTEN",1,50,178,228
https://kawalpemilu.org#52873,"BATU KUWUNG, PADARINCANG, SERANG, BANTEN",2,52,166,218
https://kawalpemilu.org#52873,"BATU KUWUNG, PADARINCANG, SERANG, BANTEN",3,35,167,202
https://kawalpemilu.org#52873,"BATU KUWUNG, PADARINCANG, SERANG, BANTEN",4,97,87,184
https://kawalpemilu.org#52873,"BATU KUWUNG, PADARINCANG, SERANG, BANTEN",5,70,154,224
https://kawalpemilu.org#52873,"BATU KUWUNG, PADARINCANG, SERANG, BANTEN",6,43,157,200
https://kawalpemilu.org#52873,"BATU KUWUNG, PADARINCANG, SERANG, BANTEN",7,52,148,200
https://kawalpemilu.org#52873,"BATU KUWUNG, PADARINCANG, SERANG, BANTEN",8,77,153,230
https://kawalpemilu.org#52873,"BATU KUWUNG, PADARINCANG, SERANG, BANTEN",9,50,102,152
https://kawalpemilu.org#52873,"BATU KUWUNG, PADARINCANG, SERANG, BANTEN",10,65,148,213
https://kawalpemilu.org#52873,"BATU KUWUNG, PADARINCANG, SERANG, BANTEN",11,47,85,132
https://kawalpemilu.org#52873,"BATU KUWUNG, PADARINCANG, SERANG, BANTEN",12,97,93,190
https://kawalpemilu.org#52873,"BATU KUWUNG, PADARINCANG, SERANG, BANTEN",13,76,118,194
https://kawalpemilu.org#52873,"BATU KUWUNG, PADARINCANG, SERANG, BANTEN",15,57,102,159
https://kawalpemilu.org#52873,"BATU KUWUNG, PADARINCANG, SERANG, BANTEN",16,51,145,196
https://kawalpemilu.org#52873,"BATU KUWUNG, PADARINCANG, SERANG, BANTEN",17,65,108,173
https://kawalpemilu.org#52873,"BATU KUWUNG, PADARINCANG, SERANG, BANTEN",18,67,125,192
https://kawalpemilu.org#52873,"BATU KUWUNG, PADARINCANG, SERANG, BANTEN",19,70,103,173
https://kawalpemilu.org#52873,"BATU KUWUNG, PADARINCANG, SERANG, BANTEN",20,87,4,91
https://kawalpemilu.org#52873,"BATU KUWUNG, PADARINCANG, SERANG, BANTEN",21,47,104,151
https://kawalpemilu.org#52873,"BATU KUWUNG, PADARINCANG, SERANG, BANTEN",22,28,109,137
https://kawalpemilu.org#52873,"BATU KUWUNG, PADARINCANG, SERANG, BANTEN",23,30,86,116
https://kawalpemilu.org#52873,"BATU KUWUNG, PADARINCANG, SERANG, BANTEN",24,38,86,124
https://kawalpemilu.org#52874,"KRAMATLABAN, PADARINCANG, SERANG, BANTEN",2,96,91,187
https://kawalpemilu.org#52874,"KRAMATLABAN, PADARINCANG, SERANG, BANTEN",3,71,126,197
https://kawalpemilu.org#52874,"KRAMATLABAN, PADARINCANG, SERANG, BANTEN",4,49,134,0
https://kawalpemilu.org#52874,"KRAMATLABAN, PADARINCANG, SERANG, BANTEN",5,26,104,130
https://kawalpemilu.org#52874,"KRAMATLABAN, PADARINCANG, SERANG, BANTEN",6,62,149,211
https://kawalpemilu.org#52874,"KRAMATLABAN, PADARINCANG, SERANG, BANTEN",7,46,115,161
https://kawalpemilu.org#52874,"KRAMATLABAN, PADARINCANG, SERANG, BANTEN",8,23,176,199
https://kawalpemilu.org#52874,"KRAMATLABAN, PADARINCANG, SERANG, BANTEN",9,29,139,165
https://kawalpemilu.org#52874,"KRAMATLABAN, PADARINCANG, SERANG, BANTEN",10,30,191,221
https://kawalpemilu.org#52874,"KRAMATLABAN, PADARINCANG, SERANG, BANTEN",11,44,135,179
https://kawalpemilu.org#52874,"KRAMATLABAN, PADARINCANG, SERANG, BANTEN",12,13,209,222
https://kawalpemilu.org#52874,"KRAMATLABAN, PADARINCANG, SERANG, BANTEN",13,38,135,173
https://kawalpemilu.org#52875,"KALUMPANG, PADARINCANG, SERANG, BANTEN",1,45,166,211
https://kawalpemilu.org#52875,"KALUMPANG, PADARINCANG, SERANG, BANTEN",2,68,116,184
https://kawalpemilu.org#52875,"KALUMPANG, PADARINCANG, SERANG, BANTEN",3,48,122,170
https://kawalpemilu.org#52875,"KALUMPANG, PADARINCANG, SERANG, BANTEN",4,81,107,188
https://kawalpemilu.org#52875,"KALUMPANG, PADARINCANG, SERANG, BANTEN",5,68,119,187
https://kawalpemilu.org#52875,"KALUMPANG, PADARINCANG, SERANG, BANTEN",6,60,124,184
https://kawalpemilu.org#52875,"KALUMPANG, PADARINCANG, SERANG, BANTEN",7,77,188,265
https://kawalpemilu.org#52875,"KALUMPANG, PADARINCANG, SERANG, BANTEN",8,41,191,232
https://kawalpemilu.org#52875,"KALUMPANG, PADARINCANG, SERANG, BANTEN",9,72,111,183
https://kawalpemilu.org#52875,"KALUMPANG, PADARINCANG, SERANG, BANTEN",10,51,100,151
https://kawalpemilu.org#52875,"KALUMPANG, PADARINCANG, SERANG, BANTEN",11,65,80,145
https://kawalpemilu.org#52875,"KALUMPANG, PADARINCANG, SERANG, BANTEN",12,44,115,159
https://kawalpemilu.org#52875,"KALUMPANG, PADARINCANG, SERANG, BANTEN",13,80,118,198
https://kawalpemilu.org#52875,"KALUMPANG, PADARINCANG, SERANG, BANTEN",14,45,74,119
https://kawalpemilu.org#52875,"KALUMPANG, PADARINCANG, SERANG, BANTEN",15,57,59,116
https://kawalpemilu.org#52876,"KADUBEUREUM, PADARINCANG, SERANG, BANTEN",1,70,108,178
https://kawalpemilu.org#52876,"KADUBEUREUM, PADARINCANG, SERANG, BANTEN",2,26,183,209
https://kawalpemilu.org#52876,"KADUBEUREUM, PADARINCANG, SERANG, BANTEN",3,37,139,176
https://kawalpemilu.org#52876,"KADUBEUREUM, PADARINCANG, SERANG, BANTEN",4,33,133,166
https://kawalpemilu.org#52876,"KADUBEUREUM, PADARINCANG, SERANG, BANTEN",5,44,137,181
https://kawalpemilu.org#52876,"KADUBEUREUM, PADARINCANG, SERANG, BANTEN",6,56,143,199
https://kawalpemilu.org#52876,"KADUBEUREUM, PADARINCANG, SERANG, BANTEN",7,39,130,169
https://kawalpemilu.org#52876,"KADUBEUREUM, PADARINCANG, SERANG, BANTEN",8,90,108,198
https://kawalpemilu.org#52876,"KADUBEUREUM, PADARINCANG, SERANG, BANTEN",9,21,146,167
https://kawalpemilu.org#52876,"KADUBEUREUM, PADARINCANG, SERANG, BANTEN",10,31,113,144
https://kawalpemilu.org#52876,"KADUBEUREUM, PADARINCANG, SERANG, BANTEN",11,43,134,177
https://kawalpemilu.org#52876,"KADUBEUREUM, PADARINCANG, SERANG, BANTEN",12,62,123,185
https://kawalpemilu.org#52876,"KADUBEUREUM, PADARINCANG, SERANG, BANTEN",13,67,153,220
https://kawalpemilu.org#52876,"KADUBEUREUM, PADARINCANG, SERANG, BANTEN",14,58,128,186
https://kawalpemilu.org#52876,"KADUBEUREUM, PADARINCANG, SERANG, BANTEN",15,60,128,188
https://kawalpemilu.org#52876,"KADUBEUREUM, PADARINCANG, SERANG, BANTEN",16,51,133,184
https://kawalpemilu.org#52876,"KADUBEUREUM, PADARINCANG, SERANG, BANTEN",17,46,183,229
https://kawalpemilu.org#52877,"CIPAYUNG, PADARINCANG, SERANG, BANTEN",1,36,143,179
https://kawalpemilu.org#52877,"CIPAYUNG, PADARINCANG, SERANG, BANTEN",2,38,141,179
https://kawalpemilu.org#52877,"CIPAYUNG, PADARINCANG, SERANG, BANTEN",3,24,135,159
https://kawalpemilu.org#52877,"CIPAYUNG, PADARINCANG, SERANG, BANTEN",4,42,148,190
https://kawalpemilu.org#52877,"CIPAYUNG, PADARINCANG, SERANG, BANTEN",5,29,135,164
https://kawalpemilu.org#52877,"CIPAYUNG, PADARINCANG, SERANG, BANTEN",6,71,124,195
https://kawalpemilu.org#52877,"CIPAYUNG, PADARINCANG, SERANG, BANTEN",7,49,118,167
https://kawalpemilu.org#52877,"CIPAYUNG, PADARINCANG, SERANG, BANTEN",8,48,162,210
https://kawalpemilu.org#52877,"CIPAYUNG, PADARINCANG, SERANG, BANTEN",9,55,123,178
https://kawalpemilu.org#52877,"CIPAYUNG, PADARINCANG, SERANG, BANTEN",10,68,105,173
https://kawalpemilu.org#52877,"CIPAYUNG, PADARINCANG, SERANG, BANTEN",11,62,114,176
https://kawalpemilu.org#52877,"CIPAYUNG, PADARINCANG, SERANG, BANTEN",12,41,136,177
https://kawalpemilu.org#52877,"CIPAYUNG, PADARINCANG, SERANG, BANTEN",13,53,87,140
https://kawalpemilu.org#52877,"CIPAYUNG, PADARINCANG, SERANG, BANTEN",14,80,93,173
https://kawalpemilu.org#52877,"CIPAYUNG, PADARINCANG, SERANG, BANTEN",15,58,83,141
https://kawalpemilu.org#52877,"CIPAYUNG, PADARINCANG, SERANG, BANTEN",16,63,88,151
https://kawalpemilu.org#52878,"CURUG GOONG, PADARINCANG, SERANG, BANTEN",1,57,97,154
https://kawalpemilu.org#52878,"CURUG GOONG, PADARINCANG, SERANG, BANTEN",2,77,165,242
https://kawalpemilu.org#52878,"CURUG GOONG, PADARINCANG, SERANG, BANTEN",3,64,81,145
https://kawalpemilu.org#52878,"CURUG GOONG, PADARINCANG, SERANG, BANTEN",4,65,154,219
https://kawalpemilu.org#52878,"CURUG GOONG, PADARINCANG, SERANG, BANTEN",5,56,169,225
https://kawalpemilu.org#52878,"CURUG GOONG, PADARINCANG, SERANG, BANTEN",6,44,163,207
https://kawalpemilu.org#52878,"CURUG GOONG, PADARINCANG, SERANG, BANTEN",7,58,159,217
https://kawalpemilu.org#52878,"CURUG GOONG, PADARINCANG, SERANG, BANTEN",8,65,145,210
https://kawalpemilu.org#52878,"CURUG GOONG, PADARINCANG, SERANG, BANTEN",9,63,149,212
https://kawalpemilu.org#52878,"CURUG GOONG, PADARINCANG, SERANG, BANTEN",10,57,118,175
https://kawalpemilu.org#52878,"CURUG GOONG, PADARINCANG, SERANG, BANTEN",11,52,96,148
https://kawalpemilu.org#52878,"CURUG GOONG, PADARINCANG, SERANG, BANTEN",12,53,56,109
https://kawalpemilu.org#52879,"KADU KEMPONG, PADARINCANG, SERANG, BANTEN",1,65,116,181
https://kawalpemilu.org#52879,"KADU KEMPONG, PADARINCANG, SERANG, BANTEN",2,52,87,139
https://kawalpemilu.org#52879,"KADU KEMPONG, PADARINCANG, SERANG, BANTEN",3,109,112,221
https://kawalpemilu.org#52879,"KADU KEMPONG, PADARINCANG, SERANG, BANTEN",4,93,98,191
https://kawalpemilu.org#52879,"KADU KEMPONG, PADARINCANG, SERANG, BANTEN",5,69,114,183
https://kawalpemilu.org#52879,"KADU KEMPONG, PADARINCANG, SERANG, BANTEN",6,63,122,185
https://kawalpemilu.org#52879,"KADU KEMPONG, PADARINCANG, SERANG, BANTEN",7,40,113,153
https://kawalpemilu.org#52879,"KADU KEMPONG, PADARINCANG, SERANG, BANTEN",8,41,82,123
https://kawalpemilu.org#52881,"ANYAR, ANYAR, SERANG, BANTEN",1,43,191,234
https://kawalpemilu.org#52881,"ANYAR, ANYAR, SERANG, BANTEN",2,73,174,247
https://kawalpemilu.org#52881,"ANYAR, ANYAR, SERANG, BANTEN",3,60,147,207
https://kawalpemilu.org#52881,"ANYAR, ANYAR, SERANG, BANTEN",4,119,123,242
https://kawalpemilu.org#52881,"ANYAR, ANYAR, SERANG, BANTEN",5,99,87,186
https://kawalpemilu.org#52881,"ANYAR, ANYAR, SERANG, BANTEN",6,83,162,244
https://kawalpemilu.org#52881,"ANYAR, ANYAR, SERANG, BANTEN",7,56,191,247
https://kawalpemilu.org#52881,"ANYAR, ANYAR, SERANG, BANTEN",8,62,185,247
https://kawalpemilu.org#52881,"ANYAR, ANYAR, SERANG, BANTEN",9,78,177,255
https://kawalpemilu.org#52881,"ANYAR, ANYAR, SERANG, BANTEN",10,85,132,217
https://kawalpemilu.org#52881,"ANYAR, ANYAR, SERANG, BANTEN",11,112,183,295
https://kawalpemilu.org#52881,"ANYAR, ANYAR, SERANG, BANTEN",12,119,138,257
https://kawalpemilu.org#52881,"ANYAR, ANYAR, SERANG, BANTEN",13,63,177,240
https://kawalpemilu.org#52881,"ANYAR, ANYAR, SERANG, BANTEN",14,50,130,180
https://kawalpemilu.org#52881,"ANYAR, ANYAR, SERANG, BANTEN",15,64,151,215
https://kawalpemilu.org#52881,"ANYAR, ANYAR, SERANG, BANTEN",16,53,155,208
https://kawalpemilu.org#52881,"ANYAR, ANYAR, SERANG, BANTEN",17,58,152,210
https://kawalpemilu.org#52881,"ANYAR, ANYAR, SERANG, BANTEN",18,73,156,229
https://kawalpemilu.org#52881,"ANYAR, ANYAR, SERANG, BANTEN",19,75,147,222
https://kawalpemilu.org#52881,"ANYAR, ANYAR, SERANG, BANTEN",20,82,118,200
https://kawalpemilu.org#52881,"ANYAR, ANYAR, SERANG, BANTEN",21,51,77,128
https://kawalpemilu.org#52881,"ANYAR, ANYAR, SERANG, BANTEN",22,83,123,206
https://kawalpemilu.org#52882,"SINDANG MANDI, ANYAR, SERANG, BANTEN",1,57,162,219
https://kawalpemilu.org#52882,"SINDANG MANDI, ANYAR, SERANG, BANTEN",2,38,162,200
https://kawalpemilu.org#52882,"SINDANG MANDI, ANYAR, SERANG, BANTEN",3,36,154,190
https://kawalpemilu.org#52882,"SINDANG MANDI, ANYAR, SERANG, BANTEN",4,29,151,180
https://kawalpemilu.org#52882,"SINDANG MANDI, ANYAR, SERANG, BANTEN",5,35,131,166
https://kawalpemilu.org#52882,"SINDANG MANDI, ANYAR, SERANG, BANTEN",6,66,109,175
https://kawalpemilu.org#52882,"SINDANG MANDI, ANYAR, SERANG, BANTEN",7,40,124,164
https://kawalpemilu.org#52882,"SINDANG MANDI, ANYAR, SERANG, BANTEN",8,39,144,183
https://kawalpemilu.org#52882,"SINDANG MANDI, ANYAR, SERANG, BANTEN",9,38,134,172
https://kawalpemilu.org#52882,"SINDANG MANDI, ANYAR, SERANG, BANTEN",10,58,117,175
https://kawalpemilu.org#52882,"SINDANG MANDI, ANYAR, SERANG, BANTEN",11,26,149,175
https://kawalpemilu.org#52882,"SINDANG MANDI, ANYAR, SERANG, BANTEN",12,45,139,184
https://kawalpemilu.org#52882,"SINDANG MANDI, ANYAR, SERANG, BANTEN",13,22,171,193
https://kawalpemilu.org#52882,"SINDANG MANDI, ANYAR, SERANG, BANTEN",14,68,77,145
https://kawalpemilu.org#52882,"SINDANG MANDI, ANYAR, SERANG, BANTEN",15,38,75,113
https://kawalpemilu.org#52883,"CIKONENG, ANYAR, SERANG, BANTEN",1,96,150,246
https://kawalpemilu.org#52883,"CIKONENG, ANYAR, SERANG, BANTEN",2,55,164,219
https://kawalpemilu.org#52883,"CIKONENG, ANYAR, SERANG, BANTEN",3,69,147,216
https://kawalpemilu.org#52883,"CIKONENG, ANYAR, SERANG, BANTEN",4,57,195,250
https://kawalpemilu.org#52883,"CIKONENG, ANYAR, SERANG, BANTEN",5,66,194,260
https://kawalpemilu.org#52883,"CIKONENG, ANYAR, SERANG, BANTEN",6,76,139,215
https://kawalpemilu.org#52883,"CIKONENG, ANYAR, SERANG, BANTEN",7,108,122,230
https://kawalpemilu.org#52883,"CIKONENG, ANYAR, SERANG, BANTEN",9,127,151,278
https://kawalpemilu.org#52883,"CIKONENG, ANYAR, SERANG, BANTEN",10,110,140,250
https://kawalpemilu.org#52883,"CIKONENG, ANYAR, SERANG, BANTEN",11,103,155,256
https://kawalpemilu.org#52883,"CIKONENG, ANYAR, SERANG, BANTEN",12,90,167,257
https://kawalpemilu.org#52883,"CIKONENG, ANYAR, SERANG, BANTEN",13,86,139,225
https://kawalpemilu.org#52883,"CIKONENG, ANYAR, SERANG, BANTEN",14,89,97,186
https://kawalpemilu.org#52883,"CIKONENG, ANYAR, SERANG, BANTEN",15,85,134,219
https://kawalpemilu.org#52883,"CIKONENG, ANYAR, SERANG, BANTEN",16,61,27,88
https://kawalpemilu.org#52884,"TANJUNGMANIS, ANYAR, SERANG, BANTEN",1,54,187,241
https://kawalpemilu.org#52884,"TANJUNGMANIS, ANYAR, SERANG, BANTEN",2,44,191,235
https://kawalpemilu.org#52884,"TANJUNGMANIS, ANYAR, SERANG, BANTEN",3,67,178,245
https://kawalpemilu.org#52884,"TANJUNGMANIS, ANYAR, SERANG, BANTEN",4,66,206,272
https://kawalpemilu.org#52884,"TANJUNGMANIS, ANYAR, SERANG, BANTEN",5,53,222,275
https://kawalpemilu.org#52884,"TANJUNGMANIS, ANYAR, SERANG, BANTEN",6,72,207,279
https://kawalpemilu.org#52884,"TANJUNGMANIS, ANYAR, SERANG, BANTEN",7,72,177,249
https://kawalpemilu.org#52885,"BANDULU, ANYAR, SERANG, BANTEN",2,66,185,251
https://kawalpemilu.org#52885,"BANDULU, ANYAR, SERANG, BANTEN",3,59,195,254
https://kawalpemilu.org#52885,"BANDULU, ANYAR, SERANG, BANTEN",4,85,100,185
https://kawalpemilu.org#52885,"BANDULU, ANYAR, SERANG, BANTEN",5,151,128,279
https://kawalpemilu.org#52885,"BANDULU, ANYAR, SERANG, BANTEN",6,102,136,238
https://kawalpemilu.org#52885,"BANDULU, ANYAR, SERANG, BANTEN",7,114,107,221
https://kawalpemilu.org#52885,"BANDULU, ANYAR, SERANG, BANTEN",8,101,141,242
https://kawalpemilu.org#52885,"BANDULU, ANYAR, SERANG, BANTEN",9,48,191,239
https://kawalpemilu.org#52885,"BANDULU, ANYAR, SERANG, BANTEN",10,50,210,260
https://kawalpemilu.org#52885,"BANDULU, ANYAR, SERANG, BANTEN",11,51,148,199
https://kawalpemilu.org#52885,"BANDULU, ANYAR, SERANG, BANTEN",12,91,155,246
https://kawalpemilu.org#52885,"BANDULU, ANYAR, SERANG, BANTEN",13,102,137,239
https://kawalpemilu.org#52885,"BANDULU, ANYAR, SERANG, BANTEN",14,39,99,138
https://kawalpemilu.org#52886,"BUNIHARA, ANYAR, SERANG, BANTEN",1,41,213,254
https://kawalpemilu.org#52886,"BUNIHARA, ANYAR, SERANG, BANTEN",2,63,175,238
https://kawalpemilu.org#52886,"BUNIHARA, ANYAR, SERANG, BANTEN",3,123,159,282
https://kawalpemilu.org#52886,"BUNIHARA, ANYAR, SERANG, BANTEN",4,100,119,219
https://kawalpemilu.org#52886,"BUNIHARA, ANYAR, SERANG, BANTEN",5,86,152,238
https://kawalpemilu.org#52886,"BUNIHARA, ANYAR, SERANG, BANTEN",6,78,165,243
https://kawalpemilu.org#52886,"BUNIHARA, ANYAR, SERANG, BANTEN",7,64,166,230
https://kawalpemilu.org#52886,"BUNIHARA, ANYAR, SERANG, BANTEN",8,66,175,241
https://kawalpemilu.org#52886,"BUNIHARA, ANYAR, SERANG, BANTEN",9,73,144,217
https://kawalpemilu.org#52886,"BUNIHARA, ANYAR, SERANG, BANTEN",10,56,102,158
https://kawalpemilu.org#52886,"BUNIHARA, ANYAR, SERANG, BANTEN",11,43,114,157
https://kawalpemilu.org#52887,"KOSAMBIRONYOK, ANYAR, SERANG, BANTEN",1,90,130,220
https://kawalpemilu.org#52887,"KOSAMBIRONYOK, ANYAR, SERANG, BANTEN",2,64,177,241
https://kawalpemilu.org#52887,"KOSAMBIRONYOK, ANYAR, SERANG, BANTEN",3,36,70,106
https://kawalpemilu.org#52887,"KOSAMBIRONYOK, ANYAR, SERANG, BANTEN",6,34,84,118
https://kawalpemilu.org#52887,"KOSAMBIRONYOK, ANYAR, SERANG, BANTEN",7,51,178,229
https://kawalpemilu.org#52887,"KOSAMBIRONYOK, ANYAR, SERANG, BANTEN",8,59,200,259
https://kawalpemilu.org#52887,"KOSAMBIRONYOK, ANYAR, SERANG, BANTEN",9,38,199,237
https://kawalpemilu.org#52887,"KOSAMBIRONYOK, ANYAR, SERANG, BANTEN",10,36,210,246
https://kawalpemilu.org#52887,"KOSAMBIRONYOK, ANYAR, SERANG, BANTEN",11,46,192,238
https://kawalpemilu.org#52887,"KOSAMBIRONYOK, ANYAR, SERANG, BANTEN",12,67,152,219
https://kawalpemilu.org#52887,"KOSAMBIRONYOK, ANYAR, SERANG, BANTEN",13,65,149,214
https://kawalpemilu.org#52887,"KOSAMBIRONYOK, ANYAR, SERANG, BANTEN",14,37,134,171
https://kawalpemilu.org#52888,"BANJARSARI, ANYAR, SERANG, BANTEN",1,49,195,244
https://kawalpemilu.org#52888,"BANJARSARI, ANYAR, SERANG, BANTEN",2,96,134,230
https://kawalpemilu.org#52888,"BANJARSARI, ANYAR, SERANG, BANTEN",3,64,166,230
https://kawalpemilu.org#52888,"BANJARSARI, ANYAR, SERANG, BANTEN",5,28,239,267
https://kawalpemilu.org#52888,"BANJARSARI, ANYAR, SERANG, BANTEN",6,62,140,202
https://kawalpemilu.org#52888,"BANJARSARI, ANYAR, SERANG, BANTEN",7,41,197,238
https://kawalpemilu.org#52888,"BANJARSARI, ANYAR, SERANG, BANTEN",8,64,189,254
https://kawalpemilu.org#52888,"BANJARSARI, ANYAR, SERANG, BANTEN",9,101,111,212
https://kawalpemilu.org#52889,"MEKARSARI, ANYAR, SERANG, BANTEN",1,96,154,250
https://kawalpemilu.org#52889,"MEKARSARI, ANYAR, SERANG, BANTEN",2,101,155,256
https://kawalpemilu.org#52889,"MEKARSARI, ANYAR, SERANG, BANTEN",3,101,114,215
https://kawalpemilu.org#52889,"MEKARSARI, ANYAR, SERANG, BANTEN",4,60,195,255
https://kawalpemilu.org#52889,"MEKARSARI, ANYAR, SERANG, BANTEN",5,51,151,202
https://kawalpemilu.org#52889,"MEKARSARI, ANYAR, SERANG, BANTEN",6,85,168,253
https://kawalpemilu.org#52889,"MEKARSARI, ANYAR, SERANG, BANTEN",7,103,139,242
https://kawalpemilu.org#52889,"MEKARSARI, ANYAR, SERANG, BANTEN",8,60,175,235
https://kawalpemilu.org#52889,"MEKARSARI, ANYAR, SERANG, BANTEN",9,53,164,217
https://kawalpemilu.org#52889,"MEKARSARI, ANYAR, SERANG, BANTEN",10,60,186,246
https://kawalpemilu.org#52889,"MEKARSARI, ANYAR, SERANG, BANTEN",11,65,174,239
https://kawalpemilu.org#52889,"MEKARSARI, ANYAR, SERANG, BANTEN",12,47,188,235
https://kawalpemilu.org#52889,"MEKARSARI, ANYAR, SERANG, BANTEN",13,71,172,243
https://kawalpemilu.org#52889,"MEKARSARI, ANYAR, SERANG, BANTEN",14,57,183,240
https://kawalpemilu.org#52889,"MEKARSARI, ANYAR, SERANG, BANTEN",15,34,152,186
https://kawalpemilu.org#52889,"MEKARSARI, ANYAR, SERANG, BANTEN",16,31,52,83
https://kawalpemilu.org#52889,"MEKARSARI, ANYAR, SERANG, BANTEN",17,45,87,132
https://kawalpemilu.org#52890,"SINDANGKARYA, ANYAR, SERANG, BANTEN",1,87,161,248
https://kawalpemilu.org#52890,"SINDANGKARYA, ANYAR, SERANG, BANTEN",2,69,150,219
https://kawalpemilu.org#52890,"SINDANGKARYA, ANYAR, SERANG, BANTEN",3,75,164,239
https://kawalpemilu.org#52890,"SINDANGKARYA, ANYAR, SERANG, BANTEN",4,43,173,216
https://kawalpemilu.org#52890,"SINDANGKARYA, ANYAR, SERANG, BANTEN",5,40,168,208
https://kawalpemilu.org#52890,"SINDANGKARYA, ANYAR, SERANG, BANTEN",6,36,123,159
https://kawalpemilu.org#52890,"SINDANGKARYA, ANYAR, SERANG, BANTEN",7,36,214,250
https://kawalpemilu.org#52890,"SINDANGKARYA, ANYAR, SERANG, BANTEN",8,46,204,250
https://kawalpemilu.org#52890,"SINDANGKARYA, ANYAR, SERANG, BANTEN",9,118,110,228
https://kawalpemilu.org#52890,"SINDANGKARYA, ANYAR, SERANG, BANTEN",10,107,86,193
https://kawalpemilu.org#52890,"SINDANGKARYA, ANYAR, SERANG, BANTEN",11,66,86,152
https://kawalpemilu.org#84989,"TAMBANG AYAM, ANYAR, SERANG, BANTEN",1,64,132,196
https://kawalpemilu.org#84989,"TAMBANG AYAM, ANYAR, SERANG, BANTEN",2,100,131,231
https://kawalpemilu.org#84989,"TAMBANG AYAM, ANYAR, SERANG, BANTEN",3,85,131,216
https://kawalpemilu.org#84989,"TAMBANG AYAM, ANYAR, SERANG, BANTEN",4,83,131,214
https://kawalpemilu.org#84989,"TAMBANG AYAM, ANYAR, SERANG, BANTEN",5,50,142,192
https://kawalpemilu.org#84989,"TAMBANG AYAM, ANYAR, SERANG, BANTEN",6,109,131,240
https://kawalpemilu.org#84989,"TAMBANG AYAM, ANYAR, SERANG, BANTEN",7,92,71,163
https://kawalpemilu.org#84989,"TAMBANG AYAM, ANYAR, SERANG, BANTEN",8,109,84,193
https://kawalpemilu.org#84989,"TAMBANG AYAM, ANYAR, SERANG, BANTEN",10,76,153,229
https://kawalpemilu.org#84989,"TAMBANG AYAM, ANYAR, SERANG, BANTEN",11,48,156,204
https://kawalpemilu.org#84989,"TAMBANG AYAM, ANYAR, SERANG, BANTEN",12,80,79,159
https://kawalpemilu.org#89647,"GROGOL INDAH, ANYAR, SERANG, BANTEN",1,75,181,256
https://kawalpemilu.org#89647,"GROGOL INDAH, ANYAR, SERANG, BANTEN",2,86,180,266
https://kawalpemilu.org#89647,"GROGOL INDAH, ANYAR, SERANG, BANTEN",3,59,183,242
https://kawalpemilu.org#89647,"GROGOL INDAH, ANYAR, SERANG, BANTEN",4,20,227,247
https://kawalpemilu.org#89647,"GROGOL INDAH, ANYAR, SERANG, BANTEN",5,101,150,251
https://kawalpemilu.org#89647,"GROGOL INDAH, ANYAR, SERANG, BANTEN",6,47,176,223
https://kawalpemilu.org#89647,"GROGOL INDAH, ANYAR, SERANG, BANTEN",7,75,117,192
https://kawalpemilu.org#89647,"GROGOL INDAH, ANYAR, SERANG, BANTEN",8,99,141,240
https://kawalpemilu.org#89647,"GROGOL INDAH, ANYAR, SERANG, BANTEN",9,12,51,63
https://kawalpemilu.org#89647,"GROGOL INDAH, ANYAR, SERANG, BANTEN",10,35,84,119
https://kawalpemilu.org#52892,"CINANGKA, CINANGKA, SERANG, BANTEN",1,49,89,138
https://kawalpemilu.org#52892,"CINANGKA, CINANGKA, SERANG, BANTEN",2,39,159,198
https://kawalpemilu.org#52892,"CINANGKA, CINANGKA, SERANG, BANTEN",3,60,157,217
https://kawalpemilu.org#52892,"CINANGKA, CINANGKA, SERANG, BANTEN",4,69,146,215
https://kawalpemilu.org#52892,"CINANGKA, CINANGKA, SERANG, BANTEN",5,56,136,192
https://kawalpemilu.org#52892,"CINANGKA, CINANGKA, SERANG, BANTEN",6,37,190,227
https://kawalpemilu.org#52892,"CINANGKA, CINANGKA, SERANG, BANTEN",7,26,178,204
https://kawalpemilu.org#52892,"CINANGKA, CINANGKA, SERANG, BANTEN",8,43,198,241
https://kawalpemilu.org#52892,"CINANGKA, CINANGKA, SERANG, BANTEN",9,31,163,194
https://kawalpemilu.org#52892,"CINANGKA, CINANGKA, SERANG, BANTEN",10,35,145,180
https://kawalpemilu.org#52892,"CINANGKA, CINANGKA, SERANG, BANTEN",11,73,108,181
https://kawalpemilu.org#52892,"CINANGKA, CINANGKA, SERANG, BANTEN",12,34,123,157
https://kawalpemilu.org#52892,"CINANGKA, CINANGKA, SERANG, BANTEN",13,50,176,226
https://kawalpemilu.org#52892,"CINANGKA, CINANGKA, SERANG, BANTEN",14,48,167,215
https://kawalpemilu.org#52892,"CINANGKA, CINANGKA, SERANG, BANTEN",15,26,103,129
https://kawalpemilu.org#52892,"CINANGKA, CINANGKA, SERANG, BANTEN",16,43,124,167
https://kawalpemilu.org#52893,"BANTAR WARU, CINANGKA, SERANG, BANTEN",1,74,137,211
https://kawalpemilu.org#52893,"BANTAR WARU, CINANGKA, SERANG, BANTEN",2,41,127,168
https://kawalpemilu.org#52893,"BANTAR WARU, CINANGKA, SERANG, BANTEN",3,43,134,177
https://kawalpemilu.org#52893,"BANTAR WARU, CINANGKA, SERANG, BANTEN",4,24,128,152
https://kawalpemilu.org#52893,"BANTAR WARU, CINANGKA, SERANG, BANTEN",5,35,161,196
https://kawalpemilu.org#52893,"BANTAR WARU, CINANGKA, SERANG, BANTEN",6,41,115,156
https://kawalpemilu.org#52893,"BANTAR WARU, CINANGKA, SERANG, BANTEN",7,33,120,153
https://kawalpemilu.org#52893,"BANTAR WARU, CINANGKA, SERANG, BANTEN",8,72,85,157
https://kawalpemilu.org#52893,"BANTAR WARU, CINANGKA, SERANG, BANTEN",9,72,85,157
https://kawalpemilu.org#52893,"BANTAR WARU, CINANGKA, SERANG, BANTEN",10,38,181,219
https://kawalpemilu.org#52893,"BANTAR WARU, CINANGKA, SERANG, BANTEN",11,42,129,171
https://kawalpemilu.org#52893,"BANTAR WARU, CINANGKA, SERANG, BANTEN",12,34,162,196
https://kawalpemilu.org#52893,"BANTAR WARU, CINANGKA, SERANG, BANTEN",13,29,112,141
https://kawalpemilu.org#52893,"BANTAR WARU, CINANGKA, SERANG, BANTEN",14,15,55,70
https://kawalpemilu.org#52893,"BANTAR WARU, CINANGKA, SERANG, BANTEN",15,26,21,47
https://kawalpemilu.org#52894,"PASAURAN, CINANGKA, SERANG, BANTEN",1,60,108,168
https://kawalpemilu.org#52894,"PASAURAN, CINANGKA, SERANG, BANTEN",2,64,138,202
https://kawalpemilu.org#52894,"PASAURAN, CINANGKA, SERANG, BANTEN",3,75,105,180
https://kawalpemilu.org#52894,"PASAURAN, CINANGKA, SERANG, BANTEN",4,77,115,192
https://kawalpemilu.org#52894,"PASAURAN, CINANGKA, SERANG, BANTEN",5,55,140,195
https://kawalpemilu.org#52894,"PASAURAN, CINANGKA, SERANG, BANTEN",6,34,158,192
https://kawalpemilu.org#52894,"PASAURAN, CINANGKA, SERANG, BANTEN",7,14,206,220
https://kawalpemilu.org#52894,"PASAURAN, CINANGKA, SERANG, BANTEN",8,26,155,181
https://kawalpemilu.org#52894,"PASAURAN, CINANGKA, SERANG, BANTEN",9,46,126,172
https://kawalpemilu.org#52895,"BULAKAN, CINANGKA, SERANG, BANTEN",1,50,155,205
https://kawalpemilu.org#52895,"BULAKAN, CINANGKA, SERANG, BANTEN",2,64,125,189
https://kawalpemilu.org#52895,"BULAKAN, CINANGKA, SERANG, BANTEN",3,43,168,211
https://kawalpemilu.org#52895,"BULAKAN, CINANGKA, SERANG, BANTEN",4,72,120,192
https://kawalpemilu.org#52895,"BULAKAN, CINANGKA, SERANG, BANTEN",5,42,174,216
https://kawalpemilu.org#52895,"BULAKAN, CINANGKA, SERANG, BANTEN",6,36,173,209
https://kawalpemilu.org#52895,"BULAKAN, CINANGKA, SERANG, BANTEN",7,30,172,202
https://kawalpemilu.org#52895,"BULAKAN, CINANGKA, SERANG, BANTEN",8,37,182,219
https://kawalpemilu.org#52895,"BULAKAN, CINANGKA, SERANG, BANTEN",9,53,102,155
https://kawalpemilu.org#52895,"BULAKAN, CINANGKA, SERANG, BANTEN",10,64,122,186
https://kawalpemilu.org#52895,"BULAKAN, CINANGKA, SERANG, BANTEN",11,32,178,210
https://kawalpemilu.org#52895,"BULAKAN, CINANGKA, SERANG, BANTEN",12,31,147,178
https://kawalpemilu.org#52896,"KARANG SURAGA, CINANGKA, SERANG, BANTEN",1,52,149,201
https://kawalpemilu.org#52896,"KARANG SURAGA, CINANGKA, SERANG, BANTEN",2,61,162,223
https://kawalpemilu.org#52896,"KARANG SURAGA, CINANGKA, SERANG, BANTEN",3,74,149,223
https://kawalpemilu.org#52896,"KARANG SURAGA, CINANGKA, SERANG, BANTEN",4,38,77,115
https://kawalpemilu.org#52896,"KARANG SURAGA, CINANGKA, SERANG, BANTEN",5,83,140,223
https://kawalpemilu.org#52896,"KARANG SURAGA, CINANGKA, SERANG, BANTEN",6,89,107,196
https://kawalpemilu.org#52896,"KARANG SURAGA, CINANGKA, SERANG, BANTEN",7,87,117,204
https://kawalpemilu.org#52896,"KARANG SURAGA, CINANGKA, SERANG, BANTEN",8,64,170,234
https://kawalpemilu.org#52896,"KARANG SURAGA, CINANGKA, SERANG, BANTEN",9,61,133,194
https://kawalpemilu.org#52896,"KARANG SURAGA, CINANGKA, SERANG, BANTEN",10,55,167,222
https://kawalpemilu.org#52896,"KARANG SURAGA, CINANGKA, SERANG, BANTEN",11,48,136,184
https://kawalpemilu.org#52896,"KARANG SURAGA, CINANGKA, SERANG, BANTEN",12,83,149,232
https://kawalpemilu.org#52896,"KARANG SURAGA, CINANGKA, SERANG, BANTEN",13,92,120,212
https://kawalpemilu.org#52896,"KARANG SURAGA, CINANGKA, SERANG, BANTEN",14,80,143,223
https://kawalpemilu.org#52896,"KARANG SURAGA, CINANGKA, SERANG, BANTEN",15,97,134,231
https://kawalpemilu.org#52896,"KARANG SURAGA, CINANGKA, SERANG, BANTEN",16,36,137,173
https://kawalpemilu.org#52896,"KARANG SURAGA, CINANGKA, SERANG, BANTEN",17,53,148,201
https://kawalpemilu.org#52897,"UMBUL TANJUNG, CINANGKA, SERANG, BANTEN",1,63,147,210
https://kawalpemilu.org#52897,"UMBUL TANJUNG, CINANGKA, SERANG, BANTEN",2,41,166,207
https://kawalpemilu.org#52897,"UMBUL TANJUNG, CINANGKA, SERANG, BANTEN",3,56,153,209
https://kawalpemilu.org#52897,"UMBUL TANJUNG, CINANGKA, SERANG, BANTEN",4,57,139,196
https://kawalpemilu.org#52897,"UMBUL TANJUNG, CINANGKA, SERANG, BANTEN",5,53,102,155
https://kawalpemilu.org#52897,"UMBUL TANJUNG, CINANGKA, SERANG, BANTEN",6,31,105,136
https://kawalpemilu.org#52897,"UMBUL TANJUNG, CINANGKA, SERANG, BANTEN",7,55,123,178
https://kawalpemilu.org#52897,"UMBUL TANJUNG, CINANGKA, SERANG, BANTEN",8,16,102,163
https://kawalpemilu.org#52897,"UMBUL TANJUNG, CINANGKA, SERANG, BANTEN",9,40,103,143
https://kawalpemilu.org#52897,"UMBUL TANJUNG, CINANGKA, SERANG, BANTEN",10,41,141,182
https://kawalpemilu.org#52897,"UMBUL TANJUNG, CINANGKA, SERANG, BANTEN",11,24,184,208
https://kawalpemilu.org#52897,"UMBUL TANJUNG, CINANGKA, SERANG, BANTEN",12,18,77,95
https://kawalpemilu.org#52897,"UMBUL TANJUNG, CINANGKA, SERANG, BANTEN",13,8,40,48
https://kawalpemilu.org#52897,"UMBUL TANJUNG, CINANGKA, SERANG, BANTEN",14,50,97,147
https://kawalpemilu.org#52897,"UMBUL TANJUNG, CINANGKA, SERANG, BANTEN",15,69,74,143
https://kawalpemilu.org#52897,"UMBUL TANJUNG, CINANGKA, SERANG, BANTEN",16,44,114,158
https://kawalpemilu.org#52898,"KUBANG BAROS, CINANGKA, SERANG, BANTEN",1,31,195,226
https://kawalpemilu.org#52898,"KUBANG BAROS, CINANGKA, SERANG, BANTEN",2,96,110,206
https://kawalpemilu.org#52898,"KUBANG BAROS, CINANGKA, SERANG, BANTEN",3,56,146,202
https://kawalpemilu.org#52898,"KUBANG BAROS, CINANGKA, SERANG, BANTEN",4,47,155,202
https://kawalpemilu.org#52898,"KUBANG BAROS, CINANGKA, SERANG, BANTEN",5,124,69,193
https://kawalpemilu.org#52898,"KUBANG BAROS, CINANGKA, SERANG, BANTEN",6,19,145,164
https://kawalpemilu.org#52898,"KUBANG BAROS, CINANGKA, SERANG, BANTEN",7,33,122,155
https://kawalpemilu.org#52898,"KUBANG BAROS, CINANGKA, SERANG, BANTEN",8,13,175,188
https://kawalpemilu.org#52898,"KUBANG BAROS, CINANGKA, SERANG, BANTEN",9,37,169,206
https://kawalpemilu.org#52898,"KUBANG BAROS, CINANGKA, SERANG, BANTEN",10,47,120,167
https://kawalpemilu.org#52898,"KUBANG BAROS, CINANGKA, SERANG, BANTEN",11,44,139,183
https://kawalpemilu.org#52898,"KUBANG BAROS, CINANGKA, SERANG, BANTEN",12,27,115,142
https://kawalpemilu.org#52898,"KUBANG BAROS, CINANGKA, SERANG, BANTEN",13,26,137,163
https://kawalpemilu.org#52899,"RANCA SANGGAL, CINANGKA, SERANG, BANTEN",1,53,158,211
https://kawalpemilu.org#52899,"RANCA SANGGAL, CINANGKA, SERANG, BANTEN",2,66,137,203
https://kawalpemilu.org#52899,"RANCA SANGGAL, CINANGKA, SERANG, BANTEN",3,66,145,211
https://kawalpemilu.org#52899,"RANCA SANGGAL, CINANGKA, SERANG, BANTEN",4,67,121,188
https://kawalpemilu.org#52899,"RANCA SANGGAL, CINANGKA, SERANG, BANTEN",5,69,129,198
https://kawalpemilu.org#52899,"RANCA SANGGAL, CINANGKA, SERANG, BANTEN",6,76,120,196
https://kawalpemilu.org#52899,"RANCA SANGGAL, CINANGKA, SERANG, BANTEN",7,104,91,195
https://kawalpemilu.org#52899,"RANCA SANGGAL, CINANGKA, SERANG, BANTEN",8,49,99,148
https://kawalpemilu.org#52899,"RANCA SANGGAL, CINANGKA, SERANG, BANTEN",9,101,86,187
https://kawalpemilu.org#52899,"RANCA SANGGAL, CINANGKA, SERANG, BANTEN",10,29,95,124
https://kawalpemilu.org#52900,"CIKOLELET, CINANGKA, SERANG, BANTEN",1,45,140,185
https://kawalpemilu.org#52900,"CIKOLELET, CINANGKA, SERANG, BANTEN",2,51,153,204
https://kawalpemilu.org#52900,"CIKOLELET, CINANGKA, SERANG, BANTEN",3,42,162,204
https://kawalpemilu.org#52900,"CIKOLELET, CINANGKA, SERANG, BANTEN",4,60,94,154
https://kawalpemilu.org#52900,"CIKOLELET, CINANGKA, SERANG, BANTEN",5,57,92,149
https://kawalpemilu.org#52900,"CIKOLELET, CINANGKA, SERANG, BANTEN",6,42,163,205
https://kawalpemilu.org#52900,"CIKOLELET, CINANGKA, SERANG, BANTEN",7,64,122,186
https://kawalpemilu.org#52900,"CIKOLELET, CINANGKA, SERANG, BANTEN",8,40,128,168
https://kawalpemilu.org#52900,"CIKOLELET, CINANGKA, SERANG, BANTEN",9,65,147,212
https://kawalpemilu.org#52900,"CIKOLELET, CINANGKA, SERANG, BANTEN",10,70,121,191
https://kawalpemilu.org#52900,"CIKOLELET, CINANGKA, SERANG, BANTEN",11,55,132,187
https://kawalpemilu.org#52900,"CIKOLELET, CINANGKA, SERANG, BANTEN",12,48,99,147
https://kawalpemilu.org#52900,"CIKOLELET, CINANGKA, SERANG, BANTEN",13,21,101,122
https://kawalpemilu.org#52900,"CIKOLELET, CINANGKA, SERANG, BANTEN",14,42,106,148
https://kawalpemilu.org#52900,"CIKOLELET, CINANGKA, SERANG, BANTEN",15,32,92,124
https://kawalpemilu.org#52900,"CIKOLELET, CINANGKA, SERANG, BANTEN",16,57,75,132
https://kawalpemilu.org#52901,"SINDANG LAYA, CINANGKA, SERANG, BANTEN",1,54,172,226
https://kawalpemilu.org#52901,"SINDANG LAYA, CINANGKA, SERANG, BANTEN",2,71,175,246
https://kawalpemilu.org#52901,"SINDANG LAYA, CINANGKA, SERANG, BANTEN",3,63,161,224
https://kawalpemilu.org#52901,"SINDANG LAYA, CINANGKA, SERANG, BANTEN",4,58,188,246
https://kawalpemilu.org#52901,"SINDANG LAYA, CINANGKA, SERANG, BANTEN",5,62,171,233
https://kawalpemilu.org#52901,"SINDANG LAYA, CINANGKA, SERANG, BANTEN",6,58,177,235
https://kawalpemilu.org#52901,"SINDANG LAYA, CINANGKA, SERANG, BANTEN",7,51,161,212
https://kawalpemilu.org#52901,"SINDANG LAYA, CINANGKA, SERANG, BANTEN",8,63,142,205
https://kawalpemilu.org#52901,"SINDANG LAYA, CINANGKA, SERANG, BANTEN",9,69,153,222
https://kawalpemilu.org#52901,"SINDANG LAYA, CINANGKA, SERANG, BANTEN",10,72,122,194
https://kawalpemilu.org#52901,"SINDANG LAYA, CINANGKA, SERANG, BANTEN",11,93,132,225
https://kawalpemilu.org#52901,"SINDANG LAYA, CINANGKA, SERANG, BANTEN",12,32,109,141
https://kawalpemilu.org#52901,"SINDANG LAYA, CINANGKA, SERANG, BANTEN",13,62,116,178
https://kawalpemilu.org#52901,"SINDANG LAYA, CINANGKA, SERANG, BANTEN",14,39,105,144
https://kawalpemilu.org#52901,"SINDANG LAYA, CINANGKA, SERANG, BANTEN",15,30,76,106
https://kawalpemilu.org#52902,"KAMASAN, CINANGKA, SERANG, BANTEN",1,52,182,234
https://kawalpemilu.org#52902,"KAMASAN, CINANGKA, SERANG, BANTEN",2,40,173,213
https://kawalpemilu.org#52902,"KAMASAN, CINANGKA, SERANG, BANTEN",3,50,140,190
https://kawalpemilu.org#52902,"KAMASAN, CINANGKA, SERANG, BANTEN",4,41,197,238
https://kawalpemilu.org#52902,"KAMASAN, CINANGKA, SERANG, BANTEN",5,65,154,219
https://kawalpemilu.org#52902,"KAMASAN, CINANGKA, SERANG, BANTEN",6,47,152,199
https://kawalpemilu.org#52902,"KAMASAN, CINANGKA, SERANG, BANTEN",7,39,163,202
https://kawalpemilu.org#52902,"KAMASAN, CINANGKA, SERANG, BANTEN",8,67,178,245
https://kawalpemilu.org#52902,"KAMASAN, CINANGKA, SERANG, BANTEN",9,49,167,216
https://kawalpemilu.org#52902,"KAMASAN, CINANGKA, SERANG, BANTEN",10,19,188,207
https://kawalpemilu.org#52902,"KAMASAN, CINANGKA, SERANG, BANTEN",11,25,190,215
https://kawalpemilu.org#52902,"KAMASAN, CINANGKA, SERANG, BANTEN",12,33,206,239
https://kawalpemilu.org#52902,"KAMASAN, CINANGKA, SERANG, BANTEN",13,50,159,209
https://kawalpemilu.org#52902,"KAMASAN, CINANGKA, SERANG, BANTEN",14,35,170,205
https://kawalpemilu.org#52902,"KAMASAN, CINANGKA, SERANG, BANTEN",15,20,203,223
https://kawalpemilu.org#52902,"KAMASAN, CINANGKA, SERANG, BANTEN",16,25,164,189
https://kawalpemilu.org#52902,"KAMASAN, CINANGKA, SERANG, BANTEN",17,39,172,211
https://kawalpemilu.org#52902,"KAMASAN, CINANGKA, SERANG, BANTEN",19,46,142,188
https://kawalpemilu.org#52902,"KAMASAN, CINANGKA, SERANG, BANTEN",20,28,140,168
https://kawalpemilu.org#52902,"KAMASAN, CINANGKA, SERANG, BANTEN",21,24,123,147
https://kawalpemilu.org#52903,"BANTAR WANGI, CINANGKA, SERANG, BANTEN",1,39,148,187
https://kawalpemilu.org#52903,"BANTAR WANGI, CINANGKA, SERANG, BANTEN",3,50,108,158
https://kawalpemilu.org#52903,"BANTAR WANGI, CINANGKA, SERANG, BANTEN",5,59,135,194
https://kawalpemilu.org#52903,"BANTAR WANGI, CINANGKA, SERANG, BANTEN",6,45,117,162
https://kawalpemilu.org#52903,"BANTAR WANGI, CINANGKA, SERANG, BANTEN",7,45,92,137
https://kawalpemilu.org#52904,"MEKARSARI, CINANGKA, SERANG, BANTEN",1,46,145,191
https://kawalpemilu.org#52904,"MEKARSARI, CINANGKA, SERANG, BANTEN",2,63,100,163
https://kawalpemilu.org#52904,"MEKARSARI, CINANGKA, SERANG, BANTEN",3,21,172,193
https://kawalpemilu.org#52904,"MEKARSARI, CINANGKA, SERANG, BANTEN",4,42,110,152
https://kawalpemilu.org#52904,"MEKARSARI, CINANGKA, SERANG, BANTEN",5,59,168,227
https://kawalpemilu.org#52904,"MEKARSARI, CINANGKA, SERANG, BANTEN",6,101,121,222
https://kawalpemilu.org#52904,"MEKARSARI, CINANGKA, SERANG, BANTEN",7,61,158,219
https://kawalpemilu.org#52904,"MEKARSARI, CINANGKA, SERANG, BANTEN",8,47,116,163
https://kawalpemilu.org#52904,"MEKARSARI, CINANGKA, SERANG, BANTEN",9,55,124,179
https://kawalpemilu.org#84990,"BAROS JAYA, CINANGKA, SERANG, BANTEN",1,20,211,231
https://kawalpemilu.org#84990,"BAROS JAYA, CINANGKA, SERANG, BANTEN",2,44,112,156
https://kawalpemilu.org#84990,"BAROS JAYA, CINANGKA, SERANG, BANTEN",3,34,166,200
https://kawalpemilu.org#84990,"BAROS JAYA, CINANGKA, SERANG, BANTEN",4,56,127,183
https://kawalpemilu.org#52906,"MANCAK, MANCAK, SERANG, BANTEN",1,52,166,218
https://kawalpemilu.org#52906,"MANCAK, MANCAK, SERANG, BANTEN",2,56,165,221
https://kawalpemilu.org#52906,"MANCAK, MANCAK, SERANG, BANTEN",3,51,159,210
https://kawalpemilu.org#52906,"MANCAK, MANCAK, SERANG, BANTEN",4,40,149,189
https://kawalpemilu.org#52906,"MANCAK, MANCAK, SERANG, BANTEN",5,29,169,198
https://kawalpemilu.org#52906,"MANCAK, MANCAK, SERANG, BANTEN",7,65,119,184
https://kawalpemilu.org#52906,"MANCAK, MANCAK, SERANG, BANTEN",8,74,107,181
https://kawalpemilu.org#52906,"MANCAK, MANCAK, SERANG, BANTEN",9,55,123,178
https://kawalpemilu.org#52906,"MANCAK, MANCAK, SERANG, BANTEN",10,42,114,156
https://kawalpemilu.org#52906,"MANCAK, MANCAK, SERANG, BANTEN",11,29,153,182
https://kawalpemilu.org#52906,"MANCAK, MANCAK, SERANG, BANTEN",12,28,152,180
https://kawalpemilu.org#52906,"MANCAK, MANCAK, SERANG, BANTEN",13,26,147,173
https://kawalpemilu.org#52907,"CIWARNA, MANCAK, SERANG, BANTEN",1,23,174,197
https://kawalpemilu.org#52907,"CIWARNA, MANCAK, SERANG, BANTEN",2,29,129,158
https://kawalpemilu.org#52907,"CIWARNA, MANCAK, SERANG, BANTEN",3,48,124,172
https://kawalpemilu.org#52907,"CIWARNA, MANCAK, SERANG, BANTEN",4,33,151,184
https://kawalpemilu.org#52907,"CIWARNA, MANCAK, SERANG, BANTEN",5,35,94,129
https://kawalpemilu.org#52907,"CIWARNA, MANCAK, SERANG, BANTEN",6,9,94,103
https://kawalpemilu.org#52907,"CIWARNA, MANCAK, SERANG, BANTEN",7,46,154,200
https://kawalpemilu.org#52907,"CIWARNA, MANCAK, SERANG, BANTEN",8,39,191,230
https://kawalpemilu.org#52907,"CIWARNA, MANCAK, SERANG, BANTEN",9,73,72,145
https://kawalpemilu.org#52907,"CIWARNA, MANCAK, SERANG, BANTEN",10,62,80,142
https://kawalpemilu.org#52907,"CIWARNA, MANCAK, SERANG, BANTEN",11,50,106,156
https://kawalpemilu.org#52907,"CIWARNA, MANCAK, SERANG, BANTEN",12,47,118,165
https://kawalpemilu.org#52908,"ANGSANA, MANCAK, SERANG, BANTEN",1,25,170,195
https://kawalpemilu.org#52908,"ANGSANA, MANCAK, SERANG, BANTEN",2,68,115,183
https://kawalpemilu.org#52908,"ANGSANA, MANCAK, SERANG, BANTEN",3,38,164,202
https://kawalpemilu.org#52908,"ANGSANA, MANCAK, SERANG, BANTEN",4,68,119,187
https://kawalpemilu.org#52908,"ANGSANA, MANCAK, SERANG, BANTEN",5,36,120,156
https://kawalpemilu.org#52908,"ANGSANA, MANCAK, SERANG, BANTEN",6,59,162,221
https://kawalpemilu.org#52908,"ANGSANA, MANCAK, SERANG, BANTEN",7,70,155,225
https://kawalpemilu.org#52908,"ANGSANA, MANCAK, SERANG, BANTEN",8,68,159,227
https://kawalpemilu.org#52908,"ANGSANA, MANCAK, SERANG, BANTEN",9,50,131,181
https://kawalpemilu.org#52908,"ANGSANA, MANCAK, SERANG, BANTEN",10,26,158,184
https://kawalpemilu.org#52908,"ANGSANA, MANCAK, SERANG, BANTEN",11,33,164,197
https://kawalpemilu.org#52908,"ANGSANA, MANCAK, SERANG, BANTEN",13,38,135,173
https://kawalpemilu.org#52908,"ANGSANA, MANCAK, SERANG, BANTEN",14,32,152,184
https://kawalpemilu.org#52909,"TALAGA, MANCAK, SERANG, BANTEN",1,30,130,160
https://kawalpemilu.org#52909,"TALAGA, MANCAK, SERANG, BANTEN",2,28,200,228
https://kawalpemilu.org#52909,"TALAGA, MANCAK, SERANG, BANTEN",3,22,116,138
https://kawalpemilu.org#52909,"TALAGA, MANCAK, SERANG, BANTEN",4,20,130,150
https://kawalpemilu.org#52909,"TALAGA, MANCAK, SERANG, BANTEN",5,17,105,122
https://kawalpemilu.org#52909,"TALAGA, MANCAK, SERANG, BANTEN",6,32,169,201
https://kawalpemilu.org#52909,"TALAGA, MANCAK, SERANG, BANTEN",7,25,157,182
https://kawalpemilu.org#52909,"TALAGA, MANCAK, SERANG, BANTEN",8,52,118,170
https://kawalpemilu.org#52909,"TALAGA, MANCAK, SERANG, BANTEN",10,57,144,201
https://kawalpemilu.org#52909,"TALAGA, MANCAK, SERANG, BANTEN",11,51,155,206
https://kawalpemilu.org#52909,"TALAGA, MANCAK, SERANG, BANTEN",12,77,96,173
https://kawalpemilu.org#52910,"CIKEDUNG, MANCAK, SERANG, BANTEN",1,39,98,137
https://kawalpemilu.org#52910,"CIKEDUNG, MANCAK, SERANG, BANTEN",2,35,110,145
https://kawalpemilu.org#52910,"CIKEDUNG, MANCAK, SERANG, BANTEN",3,128,78,206
https://kawalpemilu.org#52910,"CIKEDUNG, MANCAK, SERANG, BANTEN",4,112,44,156
https://kawalpemilu.org#52910,"CIKEDUNG, MANCAK, SERANG, BANTEN",5,139,24,163
https://kawalpemilu.org#52910,"CIKEDUNG, MANCAK, SERANG, BANTEN",6,88,53,141
https://kawalpemilu.org#52911,"SIGEDONG, MANCAK, SERANG, BANTEN",1,24,133,157
https://kawalpemilu.org#52911,"SIGEDONG, MANCAK, SERANG, BANTEN",2,35,119,154
https://kawalpemilu.org#52911,"SIGEDONG, MANCAK, SERANG, BANTEN",3,38,143,181
https://kawalpemilu.org#52911,"SIGEDONG, MANCAK, SERANG, BANTEN",4,56,140,196
https://kawalpemilu.org#52911,"SIGEDONG, MANCAK, SERANG, BANTEN",5,53,117,170
https://kawalpemilu.org#52911,"SIGEDONG, MANCAK, SERANG, BANTEN",6,57,121,178
https://kawalpemilu.org#52911,"SIGEDONG, MANCAK, SERANG, BANTEN",7,36,146,182
https://kawalpemilu.org#52911,"SIGEDONG, MANCAK, SERANG, BANTEN",8,62,119,181
https://kawalpemilu.org#52911,"SIGEDONG, MANCAK, SERANG, BANTEN",9,16,172,188
https://kawalpemilu.org#52911,"SIGEDONG, MANCAK, SERANG, BANTEN",10,26,159,185
https://kawalpemilu.org#52912,"SANGIANG, MANCAK, SERANG, BANTEN",1,46,177,223
https://kawalpemilu.org#52912,"SANGIANG, MANCAK, SERANG, BANTEN",2,49,152,201
https://kawalpemilu.org#52912,"SANGIANG, MANCAK, SERANG, BANTEN",3,28,151,179
https://kawalpemilu.org#52912,"SANGIANG, MANCAK, SERANG, BANTEN",4,48,135,183
https://kawalpemilu.org#52912,"SANGIANG, MANCAK, SERANG, BANTEN",5,27,132,159
https://kawalpemilu.org#52912,"SANGIANG, MANCAK, SERANG, BANTEN",6,28,153,181
https://kawalpemilu.org#52912,"SANGIANG, MANCAK, SERANG, BANTEN",7,33,158,191
https://kawalpemilu.org#52912,"SANGIANG, MANCAK, SERANG, BANTEN",8,44,149,193
https://kawalpemilu.org#52912,"SANGIANG, MANCAK, SERANG, BANTEN",9,22,186,208
https://kawalpemilu.org#52913,"PASIRWARU, MANCAK, SERANG, BANTEN",1,37,162,199
https://kawalpemilu.org#52913,"PASIRWARU, MANCAK, SERANG, BANTEN",2,53,78,131
https://kawalpemilu.org#52913,"PASIRWARU, MANCAK, SERANG, BANTEN",3,47,104,151
https://kawalpemilu.org#52913,"PASIRWARU, MANCAK, SERANG, BANTEN",4,34,142,176
https://kawalpemilu.org#52913,"PASIRWARU, MANCAK, SERANG, BANTEN",5,45,154,199
https://kawalpemilu.org#52913,"PASIRWARU, MANCAK, SERANG, BANTEN",6,42,85,127
https://kawalpemilu.org#52913,"PASIRWARU, MANCAK, SERANG, BANTEN",7,41,143,184
https://kawalpemilu.org#52913,"PASIRWARU, MANCAK, SERANG, BANTEN",8,42,163,205
https://kawalpemilu.org#52913,"PASIRWARU, MANCAK, SERANG, BANTEN",9,39,139,178
https://kawalpemilu.org#52914,"WARINGIN, MANCAK, SERANG, BANTEN",1,36,108,144
https://kawalpemilu.org#52914,"WARINGIN, MANCAK, SERANG, BANTEN",2,30,109,139
https://kawalpemilu.org#52914,"WARINGIN, MANCAK, SERANG, BANTEN",3,59,160,219
https://kawalpemilu.org#52914,"WARINGIN, MANCAK, SERANG, BANTEN",4,62,153,215
https://kawalpemilu.org#52914,"WARINGIN, MANCAK, SERANG, BANTEN",5,43,187,230
https://kawalpemilu.org#52914,"WARINGIN, MANCAK, SERANG, BANTEN",6,39,121,160
https://kawalpemilu.org#52914,"WARINGIN, MANCAK, SERANG, BANTEN",7,20,118,138
https://kawalpemilu.org#52914,"WARINGIN, MANCAK, SERANG, BANTEN",8,43,150,193
https://kawalpemilu.org#52914,"WARINGIN, MANCAK, SERANG, BANTEN",9,84,112,196
https://kawalpemilu.org#52915,"WINONG, MANCAK, SERANG, BANTEN",1,36,195,231
https://kawalpemilu.org#52915,"WINONG, MANCAK, SERANG, BANTEN",3,74,154,228
https://kawalpemilu.org#52915,"WINONG, MANCAK, SERANG, BANTEN",4,47,152,152
https://kawalpemilu.org#52915,"WINONG, MANCAK, SERANG, BANTEN",5,46,166,212
https://kawalpemilu.org#52915,"WINONG, MANCAK, SERANG, BANTEN",6,92,123,215
https://kawalpemilu.org#52915,"WINONG, MANCAK, SERANG, BANTEN",7,24,185,209
https://kawalpemilu.org#52916,"BATUKUDA, MANCAK, SERANG, BANTEN",1,30,202,232
https://kawalpemilu.org#52916,"BATUKUDA, MANCAK, SERANG, BANTEN",2,49,173,222
https://kawalpemilu.org#52916,"BATUKUDA, MANCAK, SERANG, BANTEN",3,28,226,254
https://kawalpemilu.org#52916,"BATUKUDA, MANCAK, SERANG, BANTEN",4,39,208,247
https://kawalpemilu.org#52916,"BATUKUDA, MANCAK, SERANG, BANTEN",5,28,111,139
https://kawalpemilu.org#52916,"BATUKUDA, MANCAK, SERANG, BANTEN",6,43,163,206
https://kawalpemilu.org#52916,"BATUKUDA, MANCAK, SERANG, BANTEN",7,39,132,171
https://kawalpemilu.org#52916,"BATUKUDA, MANCAK, SERANG, BANTEN",8,38,159,197
https://kawalpemilu.org#52916,"BATUKUDA, MANCAK, SERANG, BANTEN",9,19,133,152
https://kawalpemilu.org#52916,"BATUKUDA, MANCAK, SERANG, BANTEN",10,38,182,220
https://kawalpemilu.org#52916,"BATUKUDA, MANCAK, SERANG, BANTEN",11,33,127,160
https://kawalpemilu.org#52916,"BATUKUDA, MANCAK, SERANG, BANTEN",12,37,126,163
https://kawalpemilu.org#52916,"BATUKUDA, MANCAK, SERANG, BANTEN",13,13,168,181
https://kawalpemilu.org#52916,"BATUKUDA, MANCAK, SERANG, BANTEN",14,7,90,97
https://kawalpemilu.org#52916,"BATUKUDA, MANCAK, SERANG, BANTEN",15,23,191,214
https://kawalpemilu.org#52916,"BATUKUDA, MANCAK, SERANG, BANTEN",16,13,160,173
https://kawalpemilu.org#52916,"BATUKUDA, MANCAK, SERANG, BANTEN",17,19,147,166
https://kawalpemilu.org#52916,"BATUKUDA, MANCAK, SERANG, BANTEN",18,27,143,170
https://kawalpemilu.org#52916,"BATUKUDA, MANCAK, SERANG, BANTEN",19,34,147,181
https://kawalpemilu.org#52916,"BATUKUDA, MANCAK, SERANG, BANTEN",20,32,93,125
https://kawalpemilu.org#52917,"LABUAN, MANCAK, SERANG, BANTEN",1,23,162,185
https://kawalpemilu.org#52917,"LABUAN, MANCAK, SERANG, BANTEN",2,64,154,218
https://kawalpemilu.org#52917,"LABUAN, MANCAK, SERANG, BANTEN",3,49,158,207
https://kawalpemilu.org#52917,"LABUAN, MANCAK, SERANG, BANTEN",4,34,134,168
https://kawalpemilu.org#52917,"LABUAN, MANCAK, SERANG, BANTEN",5,48,174,222
https://kawalpemilu.org#52917,"LABUAN, MANCAK, SERANG, BANTEN",6,27,136,163
https://kawalpemilu.org#52917,"LABUAN, MANCAK, SERANG, BANTEN",7,18,183,201
https://kawalpemilu.org#52917,"LABUAN, MANCAK, SERANG, BANTEN",8,25,102,127
https://kawalpemilu.org#52917,"LABUAN, MANCAK, SERANG, BANTEN",9,30,111,141
https://kawalpemilu.org#52917,"LABUAN, MANCAK, SERANG, BANTEN",10,28,163,191
https://kawalpemilu.org#52917,"LABUAN, MANCAK, SERANG, BANTEN",11,35,187,222
https://kawalpemilu.org#52917,"LABUAN, MANCAK, SERANG, BANTEN",12,34,185,219
https://kawalpemilu.org#52917,"LABUAN, MANCAK, SERANG, BANTEN",13,65,163,228
https://kawalpemilu.org#52917,"LABUAN, MANCAK, SERANG, BANTEN",14,55,187,242
https://kawalpemilu.org#52917,"LABUAN, MANCAK, SERANG, BANTEN",15,33,110,142
https://kawalpemilu.org#52917,"LABUAN, MANCAK, SERANG, BANTEN",16,82,141,223
https://kawalpemilu.org#52918,"BALE KAMBANG, MANCAK, SERANG, BANTEN",1,29,211,240
https://kawalpemilu.org#52918,"BALE KAMBANG, MANCAK, SERANG, BANTEN",2,34,202,236
https://kawalpemilu.org#52918,"BALE KAMBANG, MANCAK, SERANG, BANTEN",3,35,190,225
https://kawalpemilu.org#52918,"BALE KAMBANG, MANCAK, SERANG, BANTEN",4,23,184,11
https://kawalpemilu.org#52918,"BALE KAMBANG, MANCAK, SERANG, BANTEN",5,25,147,172
https://kawalpemilu.org#52918,"BALE KAMBANG, MANCAK, SERANG, BANTEN",6,34,177,211
https://kawalpemilu.org#84991,"BALE KENCANA, MANCAK, SERANG, BANTEN",1,36,155,191
https://kawalpemilu.org#84991,"BALE KENCANA, MANCAK, SERANG, BANTEN",2,69,112,181
https://kawalpemilu.org#84991,"BALE KENCANA, MANCAK, SERANG, BANTEN",3,73,161,234
https://kawalpemilu.org#84991,"BALE KENCANA, MANCAK, SERANG, BANTEN",4,55,170,225
https://kawalpemilu.org#84991,"BALE KENCANA, MANCAK, SERANG, BANTEN",5,42,165,207
https://kawalpemilu.org#52920,"GUNUNGSARI, GUNUNG SARI, SERANG, BANTEN",1,47,185,232
https://kawalpemilu.org#52920,"GUNUNGSARI, GUNUNG SARI, SERANG, BANTEN",2,43,167,210
https://kawalpemilu.org#52920,"GUNUNGSARI, GUNUNG SARI, SERANG, BANTEN",3,48,173,221
https://kawalpemilu.org#52920,"GUNUNGSARI, GUNUNG SARI, SERANG, BANTEN",4,24,120,144
https://kawalpemilu.org#52920,"GUNUNGSARI, GUNUNG SARI, SERANG, BANTEN",5,51,156,207
https://kawalpemilu.org#52920,"GUNUNGSARI, GUNUNG SARI, SERANG, BANTEN",6,58,104,162
https://kawalpemilu.org#52920,"GUNUNGSARI, GUNUNG SARI, SERANG, BANTEN",7,77,114,191
https://kawalpemilu.org#52920,"GUNUNGSARI, GUNUNG SARI, SERANG, BANTEN",8,38,95,133
https://kawalpemilu.org#52920,"GUNUNGSARI, GUNUNG SARI, SERANG, BANTEN",9,67,92,159
https://kawalpemilu.org#52920,"GUNUNGSARI, GUNUNG SARI, SERANG, BANTEN",10,79,148,227
https://kawalpemilu.org#52920,"GUNUNGSARI, GUNUNG SARI, SERANG, BANTEN",11,20,140,160
https://kawalpemilu.org#52920,"GUNUNGSARI, GUNUNG SARI, SERANG, BANTEN",12,47,139,186
https://kawalpemilu.org#52921,"CIHERANG, GUNUNG SARI, SERANG, BANTEN",1,35,169,204
https://kawalpemilu.org#52921,"CIHERANG, GUNUNG SARI, SERANG, BANTEN",2,58,111,169
https://kawalpemilu.org#52921,"CIHERANG, GUNUNG SARI, SERANG, BANTEN",3,34,179,213
https://kawalpemilu.org#52921,"CIHERANG, GUNUNG SARI, SERANG, BANTEN",4,39,157,196
https://kawalpemilu.org#52921,"CIHERANG, GUNUNG SARI, SERANG, BANTEN",5,66,146,212
https://kawalpemilu.org#52921,"CIHERANG, GUNUNG SARI, SERANG, BANTEN",6,67,136,203
https://kawalpemilu.org#52921,"CIHERANG, GUNUNG SARI, SERANG, BANTEN",7,61,129,190
https://kawalpemilu.org#52921,"CIHERANG, GUNUNG SARI, SERANG, BANTEN",8,83,124,207
https://kawalpemilu.org#52921,"CIHERANG, GUNUNG SARI, SERANG, BANTEN",9,63,133,196
https://kawalpemilu.org#52921,"CIHERANG, GUNUNG SARI, SERANG, BANTEN",10,66,133,199
https://kawalpemilu.org#52921,"CIHERANG, GUNUNG SARI, SERANG, BANTEN",11,36,123,159
https://kawalpemilu.org#52922,"TAMIANG, GUNUNG SARI, SERANG, BANTEN",1,49,142,191
https://kawalpemilu.org#52922,"TAMIANG, GUNUNG SARI, SERANG, BANTEN",2,42,138,180
https://kawalpemilu.org#52922,"TAMIANG, GUNUNG SARI, SERANG, BANTEN",3,48,94,142
https://kawalpemilu.org#52922,"TAMIANG, GUNUNG SARI, SERANG, BANTEN",4,68,114,182
https://kawalpemilu.org#52922,"TAMIANG, GUNUNG SARI, SERANG, BANTEN",5,46,189,235
https://kawalpemilu.org#52922,"TAMIANG, GUNUNG SARI, SERANG, BANTEN",6,48,172,220
https://kawalpemilu.org#52922,"TAMIANG, GUNUNG SARI, SERANG, BANTEN",7,47,180,227
https://kawalpemilu.org#52922,"TAMIANG, GUNUNG SARI, SERANG, BANTEN",8,55,175,230
https://kawalpemilu.org#52922,"TAMIANG, GUNUNG SARI, SERANG, BANTEN",9,25,191,216
https://kawalpemilu.org#52922,"TAMIANG, GUNUNG SARI, SERANG, BANTEN",10,35,191,226
https://kawalpemilu.org#52922,"TAMIANG, GUNUNG SARI, SERANG, BANTEN",11,32,180,212
https://kawalpemilu.org#52922,"TAMIANG, GUNUNG SARI, SERANG, BANTEN",12,42,154,196
https://kawalpemilu.org#52923,"SUKALABA, GUNUNG SARI, SERANG, BANTEN",1,30,163,193
https://kawalpemilu.org#52923,"SUKALABA, GUNUNG SARI, SERANG, BANTEN",2,22,143,165
https://kawalpemilu.org#52923,"SUKALABA, GUNUNG SARI, SERANG, BANTEN",3,22,173,195
https://kawalpemilu.org#52923,"SUKALABA, GUNUNG SARI, SERANG, BANTEN",4,59,125,184
https://kawalpemilu.org#52923,"SUKALABA, GUNUNG SARI, SERANG, BANTEN",5,56,105,161
https://kawalpemilu.org#52923,"SUKALABA, GUNUNG SARI, SERANG, BANTEN",6,64,98,162
https://kawalpemilu.org#52923,"SUKALABA, GUNUNG SARI, SERANG, BANTEN",7,58,121,179
https://kawalpemilu.org#52923,"SUKALABA, GUNUNG SARI, SERANG, BANTEN",8,38,142,180
https://kawalpemilu.org#52924,"KADU AGUNG, GUNUNG SARI, SERANG, BANTEN",1,24,138,162
https://kawalpemilu.org#52924,"KADU AGUNG, GUNUNG SARI, SERANG, BANTEN",2,36,128,164
https://kawalpemilu.org#52924,"KADU AGUNG, GUNUNG SARI, SERANG, BANTEN",3,31,137,168
https://kawalpemilu.org#52924,"KADU AGUNG, GUNUNG SARI, SERANG, BANTEN",4,40,120,160
https://kawalpemilu.org#52924,"KADU AGUNG, GUNUNG SARI, SERANG, BANTEN",5,52,155,207
https://kawalpemilu.org#52924,"KADU AGUNG, GUNUNG SARI, SERANG, BANTEN",6,38,162,200
https://kawalpemilu.org#52924,"KADU AGUNG, GUNUNG SARI, SERANG, BANTEN",7,39,151,190
https://kawalpemilu.org#52924,"KADU AGUNG, GUNUNG SARI, SERANG, BANTEN",8,25,141,166
https://kawalpemilu.org#52924,"KADU AGUNG, GUNUNG SARI, SERANG, BANTEN",9,8,129,137
https://kawalpemilu.org#52924,"KADU AGUNG, GUNUNG SARI, SERANG, BANTEN",10,55,88,143
https://kawalpemilu.org#52924,"KADU AGUNG, GUNUNG SARI, SERANG, BANTEN",11,28,90,118
https://kawalpemilu.org#52924,"KADU AGUNG, GUNUNG SARI, SERANG, BANTEN",12,2,130,132
https://kawalpemilu.org#52925,"LUWUK, GUNUNG SARI, SERANG, BANTEN",1,56,167,223
https://kawalpemilu.org#52925,"LUWUK, GUNUNG SARI, SERANG, BANTEN",2,59,109,168
https://kawalpemilu.org#52925,"LUWUK, GUNUNG SARI, SERANG, BANTEN",3,47,141,188
https://kawalpemilu.org#52925,"LUWUK, GUNUNG SARI, SERANG, BANTEN",4,19,130,149
https://kawalpemilu.org#52925,"LUWUK, GUNUNG SARI, SERANG, BANTEN",5,46,146,192
https://kawalpemilu.org#52925,"LUWUK, GUNUNG SARI, SERANG, BANTEN",6,28,140,168
https://kawalpemilu.org#52926,"CURUG SULANJANA, GUNUNG SARI, SERANG, BANTEN",1,82,90,172
https://kawalpemilu.org#52926,"CURUG SULANJANA, GUNUNG SARI, SERANG, BANTEN",2,61,138,199
https://kawalpemilu.org#52926,"CURUG SULANJANA, GUNUNG SARI, SERANG, BANTEN",3,84,118,202
https://kawalpemilu.org#52926,"CURUG SULANJANA, GUNUNG SARI, SERANG, BANTEN",4,68,72,140
https://kawalpemilu.org#52926,"CURUG SULANJANA, GUNUNG SARI, SERANG, BANTEN",5,47,163,210
https://kawalpemilu.org#52926,"CURUG SULANJANA, GUNUNG SARI, SERANG, BANTEN",6,50,153,203
https://kawalpemilu.org#52926,"CURUG SULANJANA, GUNUNG SARI, SERANG, BANTEN",7,23,86,109
https://kawalpemilu.org#52926,"CURUG SULANJANA, GUNUNG SARI, SERANG, BANTEN",8,84,102,186
https://kawalpemilu.org#52928,"BANDUNG, BANDUNG, SERANG, BANTEN",1,64,148,212
https://kawalpemilu.org#52928,"BANDUNG, BANDUNG, SERANG, BANTEN",2,46,143,189
https://kawalpemilu.org#52928,"BANDUNG, BANDUNG, SERANG, BANTEN",3,61,117,178
https://kawalpemilu.org#52928,"BANDUNG, BANDUNG, SERANG, BANTEN",4,55,162,217
https://kawalpemilu.org#52928,"BANDUNG, BANDUNG, SERANG, BANTEN",5,52,177,229
https://kawalpemilu.org#52928,"BANDUNG, BANDUNG, SERANG, BANTEN",6,97,99,196
https://kawalpemilu.org#52928,"BANDUNG, BANDUNG, SERANG, BANTEN",7,55,143,198
https://kawalpemilu.org#52928,"BANDUNG, BANDUNG, SERANG, BANTEN",8,112,90,202
https://kawalpemilu.org#52928,"BANDUNG, BANDUNG, SERANG, BANTEN",9,93,147,240
https://kawalpemilu.org#52928,"BANDUNG, BANDUNG, SERANG, BANTEN",10,75,158,233
https://kawalpemilu.org#52928,"BANDUNG, BANDUNG, SERANG, BANTEN",11,73,156,229
https://kawalpemilu.org#52928,"BANDUNG, BANDUNG, SERANG, BANTEN",12,64,158,222
https://kawalpemilu.org#52928,"BANDUNG, BANDUNG, SERANG, BANTEN",13,102,122,224
https://kawalpemilu.org#52928,"BANDUNG, BANDUNG, SERANG, BANTEN",14,29,210,239
https://kawalpemilu.org#52928,"BANDUNG, BANDUNG, SERANG, BANTEN",15,49,164,213
https://kawalpemilu.org#52928,"BANDUNG, BANDUNG, SERANG, BANTEN",16,42,167,209
https://kawalpemilu.org#52928,"BANDUNG, BANDUNG, SERANG, BANTEN",17,74,105,179
https://kawalpemilu.org#52928,"BANDUNG, BANDUNG, SERANG, BANTEN",18,79,105,184
https://kawalpemilu.org#52928,"BANDUNG, BANDUNG, SERANG, BANTEN",19,107,129,236
https://kawalpemilu.org#52928,"BANDUNG, BANDUNG, SERANG, BANTEN",20,102,87,189
https://kawalpemilu.org#52928,"BANDUNG, BANDUNG, SERANG, BANTEN",21,91,77,168
https://kawalpemilu.org#52928,"BANDUNG, BANDUNG, SERANG, BANTEN",22,78,60,138
https://kawalpemilu.org#52929,"MANDER, BANDUNG, SERANG, BANTEN",1,201,37,238
https://kawalpemilu.org#52929,"MANDER, BANDUNG, SERANG, BANTEN",2,152,54,206
https://kawalpemilu.org#52929,"MANDER, BANDUNG, SERANG, BANTEN",3,74,140,214
https://kawalpemilu.org#52929,"MANDER, BANDUNG, SERANG, BANTEN",4,99,106,205
https://kawalpemilu.org#52929,"MANDER, BANDUNG, SERANG, BANTEN",5,87,119,216
https://kawalpemilu.org#52929,"MANDER, BANDUNG, SERANG, BANTEN",6,143,99,242
https://kawalpemilu.org#52929,"MANDER, BANDUNG, SERANG, BANTEN",7,122,101,223
https://kawalpemilu.org#52929,"MANDER, BANDUNG, SERANG, BANTEN",8,154,98,252
https://kawalpemilu.org#52929,"MANDER, BANDUNG, SERANG, BANTEN",9,94,113,207
https://kawalpemilu.org#52929,"MANDER, BANDUNG, SERANG, BANTEN",10,105,101,206
https://kawalpemilu.org#52929,"MANDER, BANDUNG, SERANG, BANTEN",11,79,169,248
https://kawalpemilu.org#52929,"MANDER, BANDUNG, SERANG, BANTEN",12,105,119,224
https://kawalpemilu.org#52929,"MANDER, BANDUNG, SERANG, BANTEN",13,109,102,211
https://kawalpemilu.org#52929,"MANDER, BANDUNG, SERANG, BANTEN",14,108,141,249
https://kawalpemilu.org#52929,"MANDER, BANDUNG, SERANG, BANTEN",15,123,101,224
https://kawalpemilu.org#52930,"PENAMPING, BANDUNG, SERANG, BANTEN",1,50,158,208
https://kawalpemilu.org#52930,"PENAMPING, BANDUNG, SERANG, BANTEN",2,98,101,199
https://kawalpemilu.org#52930,"PENAMPING, BANDUNG, SERANG, BANTEN",3,74,107,181
https://kawalpemilu.org#52930,"PENAMPING, BANDUNG, SERANG, BANTEN",4,60,128,188
https://kawalpemilu.org#52930,"PENAMPING, BANDUNG, SERANG, BANTEN",5,89,145,234
https://kawalpemilu.org#52930,"PENAMPING, BANDUNG, SERANG, BANTEN",6,81,167,248
https://kawalpemilu.org#52930,"PENAMPING, BANDUNG, SERANG, BANTEN",7,82,143,225
https://kawalpemilu.org#52930,"PENAMPING, BANDUNG, SERANG, BANTEN",8,105,124,229
https://kawalpemilu.org#52930,"PENAMPING, BANDUNG, SERANG, BANTEN",9,130,85,215
https://kawalpemilu.org#52930,"PENAMPING, BANDUNG, SERANG, BANTEN",10,89,89,176
https://kawalpemilu.org#52930,"PENAMPING, BANDUNG, SERANG, BANTEN",11,67,131,198
https://kawalpemilu.org#52930,"PENAMPING, BANDUNG, SERANG, BANTEN",12,100,114,214
https://kawalpemilu.org#52930,"PENAMPING, BANDUNG, SERANG, BANTEN",13,98,85,183
https://kawalpemilu.org#52930,"PENAMPING, BANDUNG, SERANG, BANTEN",14,93,117,210
https://kawalpemilu.org#52931,"PANGAWINAN, BANDUNG, SERANG, BANTEN",1,98,134,232
https://kawalpemilu.org#52931,"PANGAWINAN, BANDUNG, SERANG, BANTEN",2,70,78,148
https://kawalpemilu.org#52931,"PANGAWINAN, BANDUNG, SERANG, BANTEN",3,103,136,239
https://kawalpemilu.org#52931,"PANGAWINAN, BANDUNG, SERANG, BANTEN",4,114,77,191
https://kawalpemilu.org#52931,"PANGAWINAN, BANDUNG, SERANG, BANTEN",5,87,144,231
https://kawalpemilu.org#52931,"PANGAWINAN, BANDUNG, SERANG, BANTEN",6,65,144,209
https://kawalpemilu.org#52931,"PANGAWINAN, BANDUNG, SERANG, BANTEN",7,98,123,221
https://kawalpemilu.org#52931,"PANGAWINAN, BANDUNG, SERANG, BANTEN",8,73,131,204
https://kawalpemilu.org#52931,"PANGAWINAN, BANDUNG, SERANG, BANTEN",10,72,105,177
https://kawalpemilu.org#52931,"PANGAWINAN, BANDUNG, SERANG, BANTEN",11,94,90,184
https://kawalpemilu.org#52931,"PANGAWINAN, BANDUNG, SERANG, BANTEN",12,55,123,178
https://kawalpemilu.org#52932,"MALABAR, BANDUNG, SERANG, BANTEN",1,103,108,211
https://kawalpemilu.org#52932,"MALABAR, BANDUNG, SERANG, BANTEN",2,76,109,185
https://kawalpemilu.org#52932,"MALABAR, BANDUNG, SERANG, BANTEN",4,73,137,210
https://kawalpemilu.org#52932,"MALABAR, BANDUNG, SERANG, BANTEN",5,94,101,195
https://kawalpemilu.org#52932,"MALABAR, BANDUNG, SERANG, BANTEN",6,54,188,242
https://kawalpemilu.org#52932,"MALABAR, BANDUNG, SERANG, BANTEN",7,52,137,189
https://kawalpemilu.org#52932,"MALABAR, BANDUNG, SERANG, BANTEN",8,62,136,198
https://kawalpemilu.org#52932,"MALABAR, BANDUNG, SERANG, BANTEN",9,94,82,176
https://kawalpemilu.org#52933,"BLOKANG, BANDUNG, SERANG, BANTEN",1,106,125,231
https://kawalpemilu.org#52933,"BLOKANG, BANDUNG, SERANG, BANTEN",2,77,185,262
https://kawalpemilu.org#52933,"BLOKANG, BANDUNG, SERANG, BANTEN",3,58,179,237
https://kawalpemilu.org#52933,"BLOKANG, BANDUNG, SERANG, BANTEN",4,0,0,0
https://kawalpemilu.org#52933,"BLOKANG, BANDUNG, SERANG, BANTEN",5,60,120,180
https://kawalpemilu.org#52933,"BLOKANG, BANDUNG, SERANG, BANTEN",6,36,59,95
https://kawalpemilu.org#52933,"BLOKANG, BANDUNG, SERANG, BANTEN",8,68,138,206
https://kawalpemilu.org#52933,"BLOKANG, BANDUNG, SERANG, BANTEN",9,60,140,200
https://kawalpemilu.org#52933,"BLOKANG, BANDUNG, SERANG, BANTEN",10,77,91,168
https://kawalpemilu.org#52933,"BLOKANG, BANDUNG, SERANG, BANTEN",11,83,139,222
https://kawalpemilu.org#52933,"BLOKANG, BANDUNG, SERANG, BANTEN",12,43,193,236
https://kawalpemilu.org#52933,"BLOKANG, BANDUNG, SERANG, BANTEN",13,78,127,205
https://kawalpemilu.org#52934,"BABAKAN, BANDUNG, SERANG, BANTEN",1,85,132,217
https://kawalpemilu.org#52934,"BABAKAN, BANDUNG, SERANG, BANTEN",2,69,149,218
https://kawalpemilu.org#52934,"BABAKAN, BANDUNG, SERANG, BANTEN",3,91,146,237
https://kawalpemilu.org#52934,"BABAKAN, BANDUNG, SERANG, BANTEN",4,94,130,224
https://kawalpemilu.org#52934,"BABAKAN, BANDUNG, SERANG, BANTEN",5,35,178,213
https://kawalpemilu.org#52934,"BABAKAN, BANDUNG, SERANG, BANTEN",6,69,115,184
https://kawalpemilu.org#52934,"BABAKAN, BANDUNG, SERANG, BANTEN",7,39,86,125
https://kawalpemilu.org#52934,"BABAKAN, BANDUNG, SERANG, BANTEN",8,92,136,228
https://kawalpemilu.org#52934,"BABAKAN, BANDUNG, SERANG, BANTEN",9,47,184,231
https://kawalpemilu.org#52935,"PRINGWULUNG, BANDUNG, SERANG, BANTEN",1,89,142,231
https://kawalpemilu.org#52935,"PRINGWULUNG, BANDUNG, SERANG, BANTEN",2,108,121,229
https://kawalpemilu.org#52935,"PRINGWULUNG, BANDUNG, SERANG, BANTEN",3,54,182,236
https://kawalpemilu.org#52935,"PRINGWULUNG, BANDUNG, SERANG, BANTEN",4,75,120,195
https://kawalpemilu.org#52935,"PRINGWULUNG, BANDUNG, SERANG, BANTEN",5,59,136,195
https://kawalpemilu.org#52935,"PRINGWULUNG, BANDUNG, SERANG, BANTEN",6,96,81,177
https://kawalpemilu.org#52935,"PRINGWULUNG, BANDUNG, SERANG, BANTEN",7,78,82,160
https://kawalpemilu.org#52935,"PRINGWULUNG, BANDUNG, SERANG, BANTEN",8,119,107,226
https://kawalpemilu.org#52935,"PRINGWULUNG, BANDUNG, SERANG, BANTEN",9,94,164,258
https://kawalpemilu.org#52935,"PRINGWULUNG, BANDUNG, SERANG, BANTEN",10,95,126,221
https://kawalpemilu.org#52935,"PRINGWULUNG, BANDUNG, SERANG, BANTEN",11,78,90,168
https://kawalpemilu.org#52650,"KEBONRATU, LEBAK WANGI, SERANG, BANTEN",1,43,167,210
https://kawalpemilu.org#52650,"KEBONRATU, LEBAK WANGI, SERANG, BANTEN",2,42,183,225
https://kawalpemilu.org#52650,"KEBONRATU, LEBAK WANGI, SERANG, BANTEN",3,34,142,176
https://kawalpemilu.org#52650,"KEBONRATU, LEBAK WANGI, SERANG, BANTEN",4,60,167,227
https://kawalpemilu.org#52650,"KEBONRATU, LEBAK WANGI, SERANG, BANTEN",5,47,154,201
https://kawalpemilu.org#52650,"KEBONRATU, LEBAK WANGI, SERANG, BANTEN",6,33,146,179
https://kawalpemilu.org#52650,"KEBONRATU, LEBAK WANGI, SERANG, BANTEN",7,58,163,221
https://kawalpemilu.org#52650,"KEBONRATU, LEBAK WANGI, SERANG, BANTEN",8,42,136,178
https://kawalpemilu.org#52650,"KEBONRATU, LEBAK WANGI, SERANG, BANTEN",9,58,122,180
https://kawalpemilu.org#52650,"KEBONRATU, LEBAK WANGI, SERANG, BANTEN",10,71,126,197
https://kawalpemilu.org#52650,"KEBONRATU, LEBAK WANGI, SERANG, BANTEN",11,82,94,176
https://kawalpemilu.org#52650,"KEBONRATU, LEBAK WANGI, SERANG, BANTEN",12,75,124,199
https://kawalpemilu.org#52650,"KEBONRATU, LEBAK WANGI, SERANG, BANTEN",13,61,37,98
https://kawalpemilu.org#52651,"TIREM, LEBAK WANGI, SERANG, BANTEN",2,68,143,211
https://kawalpemilu.org#52651,"TIREM, LEBAK WANGI, SERANG, BANTEN",3,45,157,202
https://kawalpemilu.org#52651,"TIREM, LEBAK WANGI, SERANG, BANTEN",4,25,130,155
https://kawalpemilu.org#52651,"TIREM, LEBAK WANGI, SERANG, BANTEN",5,51,130,181
https://kawalpemilu.org#52651,"TIREM, LEBAK WANGI, SERANG, BANTEN",6,47,154,201
https://kawalpemilu.org#52651,"TIREM, LEBAK WANGI, SERANG, BANTEN",7,63,153,216
https://kawalpemilu.org#52651,"TIREM, LEBAK WANGI, SERANG, BANTEN",8,78,127,205
https://kawalpemilu.org#52651,"TIREM, LEBAK WANGI, SERANG, BANTEN",9,86,117,203
https://kawalpemilu.org#52651,"TIREM, LEBAK WANGI, SERANG, BANTEN",10,43,172,215
https://kawalpemilu.org#52651,"TIREM, LEBAK WANGI, SERANG, BANTEN",11,49,159,208
https://kawalpemilu.org#52651,"TIREM, LEBAK WANGI, SERANG, BANTEN",12,53,156,209
https://kawalpemilu.org#52651,"TIREM, LEBAK WANGI, SERANG, BANTEN",13,71,134,205
https://kawalpemilu.org#52651,"TIREM, LEBAK WANGI, SERANG, BANTEN",14,91,150,241
https://kawalpemilu.org#52670,"TERAS BENDUNG, LEBAK WANGI, SERANG, BANTEN",1,82,99,181
https://kawalpemilu.org#52670,"TERAS BENDUNG, LEBAK WANGI, SERANG, BANTEN",2,83,81,164
https://kawalpemilu.org#52670,"TERAS BENDUNG, LEBAK WANGI, SERANG, BANTEN",3,92,74,166
https://kawalpemilu.org#52670,"TERAS BENDUNG, LEBAK WANGI, SERANG, BANTEN",4,84,89,173
https://kawalpemilu.org#52670,"TERAS BENDUNG, LEBAK WANGI, SERANG, BANTEN",5,95,106,201
https://kawalpemilu.org#52670,"TERAS BENDUNG, LEBAK WANGI, SERANG, BANTEN",6,71,118,189
https://kawalpemilu.org#52670,"TERAS BENDUNG, LEBAK WANGI, SERANG, BANTEN",7,82,87,169
https://kawalpemilu.org#52670,"TERAS BENDUNG, LEBAK WANGI, SERANG, BANTEN",8,92,97,189
https://kawalpemilu.org#52670,"TERAS BENDUNG, LEBAK WANGI, SERANG, BANTEN",9,101,95,196
https://kawalpemilu.org#52670,"TERAS BENDUNG, LEBAK WANGI, SERANG, BANTEN",10,85,94,179
https://kawalpemilu.org#52670,"TERAS BENDUNG, LEBAK WANGI, SERANG, BANTEN",11,49,114,163
https://kawalpemilu.org#52670,"TERAS BENDUNG, LEBAK WANGI, SERANG, BANTEN",12,38,113,151
https://kawalpemilu.org#52670,"TERAS BENDUNG, LEBAK WANGI, SERANG, BANTEN",13,65,40,105
https://kawalpemilu.org#52670,"TERAS BENDUNG, LEBAK WANGI, SERANG, BANTEN",14,72,86,158
https://kawalpemilu.org#52670,"TERAS BENDUNG, LEBAK WANGI, SERANG, BANTEN",15,49,99,148
https://kawalpemilu.org#52671,"KAMARUTON, LEBAK WANGI, SERANG, BANTEN",1,46,158,204
https://kawalpemilu.org#52671,"KAMARUTON, LEBAK WANGI, SERANG, BANTEN",2,50,165,215
https://kawalpemilu.org#52671,"KAMARUTON, LEBAK WANGI, SERANG, BANTEN",3,39,80,119
https://kawalpemilu.org#52671,"KAMARUTON, LEBAK WANGI, SERANG, BANTEN",4,110,81,191
https://kawalpemilu.org#52671,"KAMARUTON, LEBAK WANGI, SERANG, BANTEN",5,97,98,195
https://kawalpemilu.org#52671,"KAMARUTON, LEBAK WANGI, SERANG, BANTEN",6,75,108,183
https://kawalpemilu.org#52671,"KAMARUTON, LEBAK WANGI, SERANG, BANTEN",7,110,99,209
https://kawalpemilu.org#52671,"KAMARUTON, LEBAK WANGI, SERANG, BANTEN",8,113,78,191
https://kawalpemilu.org#52671,"KAMARUTON, LEBAK WANGI, SERANG, BANTEN",9,81,101,182
https://kawalpemilu.org#52671,"KAMARUTON, LEBAK WANGI, SERANG, BANTEN",10,45,45,90
https://kawalpemilu.org#52681,"PEGANDIKAN, LEBAK WANGI, SERANG, BANTEN",1,35,157,192
https://kawalpemilu.org#52681,"PEGANDIKAN, LEBAK WANGI, SERANG, BANTEN",2,34,141,175
https://kawalpemilu.org#52681,"PEGANDIKAN, LEBAK WANGI, SERANG, BANTEN",3,48,138,186
https://kawalpemilu.org#52681,"PEGANDIKAN, LEBAK WANGI, SERANG, BANTEN",4,58,133,191
https://kawalpemilu.org#52681,"PEGANDIKAN, LEBAK WANGI, SERANG, BANTEN",5,57,131,188
https://kawalpemilu.org#52681,"PEGANDIKAN, LEBAK WANGI, SERANG, BANTEN",6,62,121,183
https://kawalpemilu.org#52681,"PEGANDIKAN, LEBAK WANGI, SERANG, BANTEN",7,32,115,147
https://kawalpemilu.org#52681,"PEGANDIKAN, LEBAK WANGI, SERANG, BANTEN",8,33,147,173
https://kawalpemilu.org#52681,"PEGANDIKAN, LEBAK WANGI, SERANG, BANTEN",9,16,216,232
https://kawalpemilu.org#52681,"PEGANDIKAN, LEBAK WANGI, SERANG, BANTEN",10,24,177,201
https://kawalpemilu.org#52681,"PEGANDIKAN, LEBAK WANGI, SERANG, BANTEN",11,22,172,194
https://kawalpemilu.org#52681,"PEGANDIKAN, LEBAK WANGI, SERANG, BANTEN",12,21,21,42
https://kawalpemilu.org#52683,"LEBAK KEPUH, LEBAK WANGI, SERANG, BANTEN",1,58,119,177
https://kawalpemilu.org#52683,"LEBAK KEPUH, LEBAK WANGI, SERANG, BANTEN",2,62,123,185
https://kawalpemilu.org#52683,"LEBAK KEPUH, LEBAK WANGI, SERANG, BANTEN",3,53,134,187
https://kawalpemilu.org#52683,"LEBAK KEPUH, LEBAK WANGI, SERANG, BANTEN",4,63,108,171
https://kawalpemilu.org#52683,"LEBAK KEPUH, LEBAK WANGI, SERANG, BANTEN",5,73,112,185
https://kawalpemilu.org#52683,"LEBAK KEPUH, LEBAK WANGI, SERANG, BANTEN",6,43,94,137
https://kawalpemilu.org#52683,"LEBAK KEPUH, LEBAK WANGI, SERANG, BANTEN",7,44,126,170
https://kawalpemilu.org#52683,"LEBAK KEPUH, LEBAK WANGI, SERANG, BANTEN",8,17,31,48
https://kawalpemilu.org#52683,"LEBAK KEPUH, LEBAK WANGI, SERANG, BANTEN",9,19,50,69
https://kawalpemilu.org#52690,"KENCANA HARAPAN, LEBAK WANGI, SERANG, BANTEN",1,61,113,174
https://kawalpemilu.org#52690,"KENCANA HARAPAN, LEBAK WANGI, SERANG, BANTEN",2,44,138,182
https://kawalpemilu.org#52690,"KENCANA HARAPAN, LEBAK WANGI, SERANG, BANTEN",3,20,119,139
https://kawalpemilu.org#52690,"KENCANA HARAPAN, LEBAK WANGI, SERANG, BANTEN",4,26,144,170
https://kawalpemilu.org#52690,"KENCANA HARAPAN, LEBAK WANGI, SERANG, BANTEN",5,25,183,208
https://kawalpemilu.org#52690,"KENCANA HARAPAN, LEBAK WANGI, SERANG, BANTEN",6,19,211,230
https://kawalpemilu.org#52690,"KENCANA HARAPAN, LEBAK WANGI, SERANG, BANTEN",7,13,164,177
https://kawalpemilu.org#52690,"KENCANA HARAPAN, LEBAK WANGI, SERANG, BANTEN",8,14,177,191
https://kawalpemilu.org#52690,"KENCANA HARAPAN, LEBAK WANGI, SERANG, BANTEN",9,19,156,175
https://kawalpemilu.org#52690,"KENCANA HARAPAN, LEBAK WANGI, SERANG, BANTEN",10,42,138,180
https://kawalpemilu.org#52690,"KENCANA HARAPAN, LEBAK WANGI, SERANG, BANTEN",11,33,99,132
https://kawalpemilu.org#52690,"KENCANA HARAPAN, LEBAK WANGI, SERANG, BANTEN",12,41,127,168
https://kawalpemilu.org#52691,"LEBAK WANGI, LEBAK WANGI, SERANG, BANTEN",1,103,43,146
https://kawalpemilu.org#52691,"LEBAK WANGI, LEBAK WANGI, SERANG, BANTEN",2,108,68,176
https://kawalpemilu.org#52691,"LEBAK WANGI, LEBAK WANGI, SERANG, BANTEN",3,98,31,129
https://kawalpemilu.org#52691,"LEBAK WANGI, LEBAK WANGI, SERANG, BANTEN",4,146,94,240
https://kawalpemilu.org#52691,"LEBAK WANGI, LEBAK WANGI, SERANG, BANTEN",5,109,96,205
https://kawalpemilu.org#52691,"LEBAK WANGI, LEBAK WANGI, SERANG, BANTEN",6,82,81,163
https://kawalpemilu.org#52691,"LEBAK WANGI, LEBAK WANGI, SERANG, BANTEN",7,121,67,188
https://kawalpemilu.org#52691,"LEBAK WANGI, LEBAK WANGI, SERANG, BANTEN",8,157,51,208
https://kawalpemilu.org#52691,"LEBAK WANGI, LEBAK WANGI, SERANG, BANTEN",9,102,81,183
https://kawalpemilu.org#52745,"PURWADADI, LEBAK WANGI, SERANG, BANTEN",1,37,157,194
https://kawalpemilu.org#52745,"PURWADADI, LEBAK WANGI, SERANG, BANTEN",2,39,129,164
https://kawalpemilu.org#52745,"PURWADADI, LEBAK WANGI, SERANG, BANTEN",3,48,128,170
https://kawalpemilu.org#52745,"PURWADADI, LEBAK WANGI, SERANG, BANTEN",4,36,166,202
https://kawalpemilu.org#52745,"PURWADADI, LEBAK WANGI, SERANG, BANTEN",5,43,167,210
https://kawalpemilu.org#52745,"PURWADADI, LEBAK WANGI, SERANG, BANTEN",6,50,113,163
https://kawalpemilu.org#52745,"PURWADADI, LEBAK WANGI, SERANG, BANTEN",7,38,169,207
https://kawalpemilu.org#52745,"PURWADADI, LEBAK WANGI, SERANG, BANTEN",8,69,127,196
https://kawalpemilu.org#52745,"PURWADADI, LEBAK WANGI, SERANG, BANTEN",9,73,119,192
https://kawalpemilu.org#52745,"PURWADADI, LEBAK WANGI, SERANG, BANTEN",10,58,128,186
https://kawalpemilu.org#52745,"PURWADADI, LEBAK WANGI, SERANG, BANTEN",11,62,116,178
https://kawalpemilu.org#52745,"PURWADADI, LEBAK WANGI, SERANG, BANTEN",12,70,185,255
https://kawalpemilu.org#52745,"PURWADADI, LEBAK WANGI, SERANG, BANTEN",13,63,132,195
https://kawalpemilu.org#52745,"PURWADADI, LEBAK WANGI, SERANG, BANTEN",14,60,126,186
https://kawalpemilu.org#52745,"PURWADADI, LEBAK WANGI, SERANG, BANTEN",15,100,68,168
https://kawalpemilu.org#52745,"PURWADADI, LEBAK WANGI, SERANG, BANTEN",16,96,87,183
https://kawalpemilu.org#52748,"BOLANG, LEBAK WANGI, SERANG, BANTEN",1,26,149,175
https://kawalpemilu.org#52748,"BOLANG, LEBAK WANGI, SERANG, BANTEN",2,48,135,183
https://kawalpemilu.org#52748,"BOLANG, LEBAK WANGI, SERANG, BANTEN",3,52,148,200
https://kawalpemilu.org#52748,"BOLANG, LEBAK WANGI, SERANG, BANTEN",4,117,113,230
https://kawalpemilu.org#52748,"BOLANG, LEBAK WANGI, SERANG, BANTEN",5,80,100,180
https://kawalpemilu.org#52748,"BOLANG, LEBAK WANGI, SERANG, BANTEN",6,23,160,183
https://kawalpemilu.org#52748,"BOLANG, LEBAK WANGI, SERANG, BANTEN",7,21,172,193
https://kawalpemilu.org#52748,"BOLANG, LEBAK WANGI, SERANG, BANTEN",8,68,123,191
https://kawalpemilu.org#52748,"BOLANG, LEBAK WANGI, SERANG, BANTEN",9,44,159,203
https://kawalpemilu.org#52748,"BOLANG, LEBAK WANGI, SERANG, BANTEN",10,50,142,192
https://kawalpemilu.org#52748,"BOLANG, LEBAK WANGI, SERANG, BANTEN",11,40,168,208
https://kawalpemilu.org#52748,"BOLANG, LEBAK WANGI, SERANG, BANTEN",12,66,137,203
https://kawalpemilu.org#52938,"SUKARASA, TANGERANG, KOTA TANGERANG, BANTEN",1,74,127,201
https://kawalpemilu.org#52938,"SUKARASA, TANGERANG, KOTA TANGERANG, BANTEN",2,100,113,213
https://kawalpemilu.org#52938,"SUKARASA, TANGERANG, KOTA TANGERANG, BANTEN",3,140,31,171
https://kawalpemilu.org#52938,"SUKARASA, TANGERANG, KOTA TANGERANG, BANTEN",4,71,43,114
https://kawalpemilu.org#52938,"SUKARASA, TANGERANG, KOTA TANGERANG, BANTEN",5,154,23,177
https://kawalpemilu.org#52938,"SUKARASA, TANGERANG, KOTA TANGERANG, BANTEN",6,134,39,173
https://kawalpemilu.org#52938,"SUKARASA, TANGERANG, KOTA TANGERANG, BANTEN",7,115,41,156
https://kawalpemilu.org#52938,"SUKARASA, TANGERANG, KOTA TANGERANG, BANTEN",8,149,105,254
https://kawalpemilu.org#52938,"SUKARASA, TANGERANG, KOTA TANGERANG, BANTEN",9,118,14,132
https://kawalpemilu.org#52938,"SUKARASA, TANGERANG, KOTA TANGERANG, BANTEN",10,93,92,185
https://kawalpemilu.org#52938,"SUKARASA, TANGERANG, KOTA TANGERANG, BANTEN",11,69,136,205
https://kawalpemilu.org#52938,"SUKARASA, TANGERANG, KOTA TANGERANG, BANTEN",12,111,92,203
https://kawalpemilu.org#52938,"SUKARASA, TANGERANG, KOTA TANGERANG, BANTEN",13,172,8,180
https://kawalpemilu.org#52938,"SUKARASA, TANGERANG, KOTA TANGERANG, BANTEN",14,240,9,249
https://kawalpemilu.org#52938,"SUKARASA, TANGERANG, KOTA TANGERANG, BANTEN",15,174,34,208
https://kawalpemilu.org#52938,"SUKARASA, TANGERANG, KOTA TANGERANG, BANTEN",16,203,9,212
https://kawalpemilu.org#52938,"SUKARASA, TANGERANG, KOTA TANGERANG, BANTEN",17,183,9,192
https://kawalpemilu.org#52938,"SUKARASA, TANGERANG, KOTA TANGERANG, BANTEN",18,175,1,176
https://kawalpemilu.org#52938,"SUKARASA, TANGERANG, KOTA TANGERANG, BANTEN",19,74,137,211
https://kawalpemilu.org#52938,"SUKARASA, TANGERANG, KOTA TANGERANG, BANTEN",20,88,137,225
https://kawalpemilu.org#52938,"SUKARASA, TANGERANG, KOTA TANGERANG, BANTEN",21,49,117,166
https://kawalpemilu.org#52938,"SUKARASA, TANGERANG, KOTA TANGERANG, BANTEN",22,30,93,123
https://kawalpemilu.org#52939,"SUKAASIH, TANGERANG, KOTA TANGERANG, BANTEN",1,101,107,208
https://kawalpemilu.org#52939,"SUKAASIH, TANGERANG, KOTA TANGERANG, BANTEN",2,0,0,0
https://kawalpemilu.org#52939,"SUKAASIH, TANGERANG, KOTA TANGERANG, BANTEN",3,116,111,227
https://kawalpemilu.org#52939,"SUKAASIH, TANGERANG, KOTA TANGERANG, BANTEN",4,62,131,193
https://kawalpemilu.org#52939,"SUKAASIH, TANGERANG, KOTA TANGERANG, BANTEN",5,85,77,162
https://kawalpemilu.org#52939,"SUKAASIH, TANGERANG, KOTA TANGERANG, BANTEN",6,65,56,121
https://kawalpemilu.org#52939,"SUKAASIH, TANGERANG, KOTA TANGERANG, BANTEN",7,129,104,233
https://kawalpemilu.org#52939,"SUKAASIH, TANGERANG, KOTA TANGERANG, BANTEN",8,0,0,0
https://kawalpemilu.org#52939,"SUKAASIH, TANGERANG, KOTA TANGERANG, BANTEN",9,89,133,222
https://kawalpemilu.org#52939,"SUKAASIH, TANGERANG, KOTA TANGERANG, BANTEN",10,141,98,239
https://kawalpemilu.org#52939,"SUKAASIH, TANGERANG, KOTA TANGERANG, BANTEN",11,73,54,127
https://kawalpemilu.org#52939,"SUKAASIH, TANGERANG, KOTA TANGERANG, BANTEN",12,93,96,189
https://kawalpemilu.org#52939,"SUKAASIH, TANGERANG, KOTA TANGERANG, BANTEN",13,60,96,156
https://kawalpemilu.org#52939,"SUKAASIH, TANGERANG, KOTA TANGERANG, BANTEN",14,51,111,162
https://kawalpemilu.org#52939,"SUKAASIH, TANGERANG, KOTA TANGERANG, BANTEN",15,138,75,213
https://kawalpemilu.org#52939,"SUKAASIH, TANGERANG, KOTA TANGERANG, BANTEN",16,125,44,169
https://kawalpemilu.org#52939,"SUKAASIH, TANGERANG, KOTA TANGERANG, BANTEN",17,80,75,155
https://kawalpemilu.org#52939,"SUKAASIH, TANGERANG, KOTA TANGERANG, BANTEN",18,10,22,32
https://kawalpemilu.org#52940,"TANAH TINGGI, TANGERANG, KOTA TANGERANG, BANTEN",1,207,26,233
https://kawalpemilu.org#52940,"TANAH TINGGI, TANGERANG, KOTA TANGERANG, BANTEN",2,126,89,215
https://kawalpemilu.org#52940,"TANAH TINGGI, TANGERANG, KOTA TANGERANG, BANTEN",3,88,88,176
https://kawalpemilu.org#52940,"TANAH TINGGI, TANGERANG, KOTA TANGERANG, BANTEN",4,126,53,179
https://kawalpemilu.org#52940,"TANAH TINGGI, TANGERANG, KOTA TANGERANG, BANTEN",5,88,153,241
https://kawalpemilu.org#52940,"TANAH TINGGI, TANGERANG, KOTA TANGERANG, BANTEN",6,94,148,242
https://kawalpemilu.org#52940,"TANAH TINGGI, TANGERANG, KOTA TANGERANG, BANTEN",7,161,91,252
https://kawalpemilu.org#52940,"TANAH TINGGI, TANGERANG, KOTA TANGERANG, BANTEN",8,128,119,247
https://kawalpemilu.org#52940,"TANAH TINGGI, TANGERANG, KOTA TANGERANG, BANTEN",9,143,90,233
https://kawalpemilu.org#52940,"TANAH TINGGI, TANGERANG, KOTA TANGERANG, BANTEN",10,100,146,246
https://kawalpemilu.org#52940,"TANAH TINGGI, TANGERANG, KOTA TANGERANG, BANTEN",11,125,61,186
https://kawalpemilu.org#52940,"TANAH TINGGI, TANGERANG, KOTA TANGERANG, BANTEN",12,96,91,187
https://kawalpemilu.org#52940,"TANAH TINGGI, TANGERANG, KOTA TANGERANG, BANTEN",13,133,89,222
https://kawalpemilu.org#52940,"TANAH TINGGI, TANGERANG, KOTA TANGERANG, BANTEN",14,115,72,187
https://kawalpemilu.org#52940,"TANAH TINGGI, TANGERANG, KOTA TANGERANG, BANTEN",15,79,86,165
https://kawalpemilu.org#52940,"TANAH TINGGI, TANGERANG, KOTA TANGERANG, BANTEN",16,86,97,183
https://kawalpemilu.org#52940,"TANAH TINGGI, TANGERANG, KOTA TANGERANG, BANTEN",17,90,116,206
https://kawalpemilu.org#52940,"TANAH TINGGI, TANGERANG, KOTA TANGERANG, BANTEN",18,79,158,237
https://kawalpemilu.org#52940,"TANAH TINGGI, TANGERANG, KOTA TANGERANG, BANTEN",19,72,113,185
https://kawalpemilu.org#52940,"TANAH TINGGI, TANGERANG, KOTA TANGERANG, BANTEN",20,140,74,214
https://kawalpemilu.org#52940,"TANAH TINGGI, TANGERANG, KOTA TANGERANG, BANTEN",21,68,132,200
https://kawalpemilu.org#52940,"TANAH TINGGI, TANGERANG, KOTA TANGERANG, BANTEN",22,44,86,130
https://kawalpemilu.org#52940,"TANAH TINGGI, TANGERANG, KOTA TANGERANG, BANTEN",23,68,65,133
https://kawalpemilu.org#52940,"TANAH TINGGI, TANGERANG, KOTA TANGERANG, BANTEN",24,91,119,210
https://kawalpemilu.org#52940,"TANAH TINGGI, TANGERANG, KOTA TANGERANG, BANTEN",25,93,108,201
https://kawalpemilu.org#52940,"TANAH TINGGI, TANGERANG, KOTA TANGERANG, BANTEN",26,67,115,182
https://kawalpemilu.org#52940,"TANAH TINGGI, TANGERANG, KOTA TANGERANG, BANTEN",27,125,65,190
https://kawalpemilu.org#52940,"TANAH TINGGI, TANGERANG, KOTA TANGERANG, BANTEN",28,147,84,231
https://kawalpemilu.org#52940,"TANAH TINGGI, TANGERANG, KOTA TANGERANG, BANTEN",29,157,102,259
https://kawalpemilu.org#52940,"TANAH TINGGI, TANGERANG, KOTA TANGERANG, BANTEN",30,72,149,221
https://kawalpemilu.org#52940,"TANAH TINGGI, TANGERANG, KOTA TANGERANG, BANTEN",31,105,116,221
https://kawalpemilu.org#52940,"TANAH TINGGI, TANGERANG, KOTA TANGERANG, BANTEN",32,126,100,226
https://kawalpemilu.org#52940,"TANAH TINGGI, TANGERANG, KOTA TANGERANG, BANTEN",33,109,115,224
https://kawalpemilu.org#52940,"TANAH TINGGI, TANGERANG, KOTA TANGERANG, BANTEN",34,81,136,217
https://kawalpemilu.org#52940,"TANAH TINGGI, TANGERANG, KOTA TANGERANG, BANTEN",35,88,146,234
https://kawalpemilu.org#52940,"TANAH TINGGI, TANGERANG, KOTA TANGERANG, BANTEN",36,90,134,224
https://kawalpemilu.org#52940,"TANAH TINGGI, TANGERANG, KOTA TANGERANG, BANTEN",37,0,0,0
https://kawalpemilu.org#52940,"TANAH TINGGI, TANGERANG, KOTA TANGERANG, BANTEN",38,83,110,193
https://kawalpemilu.org#52940,"TANAH TINGGI, TANGERANG, KOTA TANGERANG, BANTEN",39,80,97,177
https://kawalpemilu.org#52940,"TANAH TINGGI, TANGERANG, KOTA TANGERANG, BANTEN",40,82,93,175
https://kawalpemilu.org#52940,"TANAH TINGGI, TANGERANG, KOTA TANGERANG, BANTEN",41,91,82,173
https://kawalpemilu.org#52940,"TANAH TINGGI, TANGERANG, KOTA TANGERANG, BANTEN",42,95,101,196
https://kawalpemilu.org#52940,"TANAH TINGGI, TANGERANG, KOTA TANGERANG, BANTEN",43,79,94,173
https://kawalpemilu.org#52940,"TANAH TINGGI, TANGERANG, KOTA TANGERANG, BANTEN",44,139,122,261
https://kawalpemilu.org#52940,"TANAH TINGGI, TANGERANG, KOTA TANGERANG, BANTEN",45,46,111,157
https://kawalpemilu.org#52940,"TANAH TINGGI, TANGERANG, KOTA TANGERANG, BANTEN",46,36,81,117
https://kawalpemilu.org#52940,"TANAH TINGGI, TANGERANG, KOTA TANGERANG, BANTEN",47,45,172,217
https://kawalpemilu.org#52940,"TANAH TINGGI, TANGERANG, KOTA TANGERANG, BANTEN",48,120,136,256
https://kawalpemilu.org#52940,"TANAH TINGGI, TANGERANG, KOTA TANGERANG, BANTEN",49,86,143,229
https://kawalpemilu.org#52940,"TANAH TINGGI, TANGERANG, KOTA TANGERANG, BANTEN",50,64,140,204
https://kawalpemilu.org#52940,"TANAH TINGGI, TANGERANG, KOTA TANGERANG, BANTEN",51,68,179,247
https://kawalpemilu.org#52940,"TANAH TINGGI, TANGERANG, KOTA TANGERANG, BANTEN",52,61,122,183
https://kawalpemilu.org#52940,"TANAH TINGGI, TANGERANG, KOTA TANGERANG, BANTEN",53,55,127,182
https://kawalpemilu.org#52940,"TANAH TINGGI, TANGERANG, KOTA TANGERANG, BANTEN",54,69,119,188
https://kawalpemilu.org#52940,"TANAH TINGGI, TANGERANG, KOTA TANGERANG, BANTEN",55,42,123,165
https://kawalpemilu.org#52940,"TANAH TINGGI, TANGERANG, KOTA TANGERANG, BANTEN",56,76,127,203
https://kawalpemilu.org#52940,"TANAH TINGGI, TANGERANG, KOTA TANGERANG, BANTEN",57,93,144,237
https://kawalpemilu.org#52940,"TANAH TINGGI, TANGERANG, KOTA TANGERANG, BANTEN",58,60,70,128
https://kawalpemilu.org#52940,"TANAH TINGGI, TANGERANG, KOTA TANGERANG, BANTEN",59,87,79,166
https://kawalpemilu.org#52940,"TANAH TINGGI, TANGERANG, KOTA TANGERANG, BANTEN",60,105,59,164
https://kawalpemilu.org#52940,"TANAH TINGGI, TANGERANG, KOTA TANGERANG, BANTEN",61,106,63,169
https://kawalpemilu.org#52940,"TANAH TINGGI, TANGERANG, KOTA TANGERANG, BANTEN",62,100,110,210
https://kawalpemilu.org#52940,"TANAH TINGGI, TANGERANG, KOTA TANGERANG, BANTEN",63,104,108,212
https://kawalpemilu.org#52940,"TANAH TINGGI, TANGERANG, KOTA TANGERANG, BANTEN",64,136,48,184
https://kawalpemilu.org#52940,"TANAH TINGGI, TANGERANG, KOTA TANGERANG, BANTEN",65,71,140,211
https://kawalpemilu.org#52940,"TANAH TINGGI, TANGERANG, KOTA TANGERANG, BANTEN",66,125,86,211
https://kawalpemilu.org#52940,"TANAH TINGGI, TANGERANG, KOTA TANGERANG, BANTEN",67,46,109,155
https://kawalpemilu.org#52940,"TANAH TINGGI, TANGERANG, KOTA TANGERANG, BANTEN",68,61,141,202
https://kawalpemilu.org#52940,"TANAH TINGGI, TANGERANG, KOTA TANGERANG, BANTEN",69,81,97,178
https://kawalpemilu.org#52940,"TANAH TINGGI, TANGERANG, KOTA TANGERANG, BANTEN",70,60,79,139
https://kawalpemilu.org#52940,"TANAH TINGGI, TANGERANG, KOTA TANGERANG, BANTEN",71,95,111,206
https://kawalpemilu.org#52940,"TANAH TINGGI, TANGERANG, KOTA TANGERANG, BANTEN",72,53,122,175
https://kawalpemilu.org#52940,"TANAH TINGGI, TANGERANG, KOTA TANGERANG, BANTEN",73,48,137,185
https://kawalpemilu.org#52940,"TANAH TINGGI, TANGERANG, KOTA TANGERANG, BANTEN",74,45,64,109
https://kawalpemilu.org#52940,"TANAH TINGGI, TANGERANG, KOTA TANGERANG, BANTEN",75,80,63,143
https://kawalpemilu.org#52940,"TANAH TINGGI, TANGERANG, KOTA TANGERANG, BANTEN",76,85,58,143
https://kawalpemilu.org#52940,"TANAH TINGGI, TANGERANG, KOTA TANGERANG, BANTEN",77,51,96,147
https://kawalpemilu.org#52940,"TANAH TINGGI, TANGERANG, KOTA TANGERANG, BANTEN",78,98,94,192
https://kawalpemilu.org#52940,"TANAH TINGGI, TANGERANG, KOTA TANGERANG, BANTEN",79,86,65,151
https://kawalpemilu.org#52940,"TANAH TINGGI, TANGERANG, KOTA TANGERANG, BANTEN",80,101,102,203
https://kawalpemilu.org#52940,"TANAH TINGGI, TANGERANG, KOTA TANGERANG, BANTEN",81,70,103,173
https://kawalpemilu.org#52940,"TANAH TINGGI, TANGERANG, KOTA TANGERANG, BANTEN",82,43,74,117
https://kawalpemilu.org#52940,"TANAH TINGGI, TANGERANG, KOTA TANGERANG, BANTEN",83,87,94,181
https://kawalpemilu.org#52940,"TANAH TINGGI, TANGERANG, KOTA TANGERANG, BANTEN",84,145,86,231
https://kawalpemilu.org#52940,"TANAH TINGGI, TANGERANG, KOTA TANGERANG, BANTEN",85,149,92,241
https://kawalpemilu.org#52940,"TANAH TINGGI, TANGERANG, KOTA TANGERANG, BANTEN",86,77,96,173
https://kawalpemilu.org#52940,"TANAH TINGGI, TANGERANG, KOTA TANGERANG, BANTEN",87,70,90,169
https://kawalpemilu.org#52940,"TANAH TINGGI, TANGERANG, KOTA TANGERANG, BANTEN",89,79,111,190
https://kawalpemilu.org#52940,"TANAH TINGGI, TANGERANG, KOTA TANGERANG, BANTEN",90,100,97,197
https://kawalpemilu.org#52940,"TANAH TINGGI, TANGERANG, KOTA TANGERANG, BANTEN",91,126,99,225
https://kawalpemilu.org#52940,"TANAH TINGGI, TANGERANG, KOTA TANGERANG, BANTEN",92,152,101,253
https://kawalpemilu.org#52940,"TANAH TINGGI, TANGERANG, KOTA TANGERANG, BANTEN",93,135,42,177
https://kawalpemilu.org#52940,"TANAH TINGGI, TANGERANG, KOTA TANGERANG, BANTEN",94,99,67,166
https://kawalpemilu.org#52940,"TANAH TINGGI, TANGERANG, KOTA TANGERANG, BANTEN",95,153,73,226
https://kawalpemilu.org#52940,"TANAH TINGGI, TANGERANG, KOTA TANGERANG, BANTEN",96,84,58,142
https://kawalpemilu.org#52940,"TANAH TINGGI, TANGERANG, KOTA TANGERANG, BANTEN",97,120,78,198
https://kawalpemilu.org#52940,"TANAH TINGGI, TANGERANG, KOTA TANGERANG, BANTEN",98,173,72,245
https://kawalpemilu.org#52940,"TANAH TINGGI, TANGERANG, KOTA TANGERANG, BANTEN",99,144,84,228
https://kawalpemilu.org#52940,"TANAH TINGGI, TANGERANG, KOTA TANGERANG, BANTEN",100,94,124,218
https://kawalpemilu.org#52940,"TANAH TINGGI, TANGERANG, KOTA TANGERANG, BANTEN",101,50,113,163
https://kawalpemilu.org#52941,"BUARAN INDAH, TANGERANG, KOTA TANGERANG, BANTEN",1,77,114,191
https://kawalpemilu.org#52941,"BUARAN INDAH, TANGERANG, KOTA TANGERANG, BANTEN",2,54,59,113
https://kawalpemilu.org#52941,"BUARAN INDAH, TANGERANG, KOTA TANGERANG, BANTEN",3,62,71,133
https://kawalpemilu.org#52941,"BUARAN INDAH, TANGERANG, KOTA TANGERANG, BANTEN",4,48,72,120
https://kawalpemilu.org#52941,"BUARAN INDAH, TANGERANG, KOTA TANGERANG, BANTEN",5,69,67,136
https://kawalpemilu.org#52941,"BUARAN INDAH, TANGERANG, KOTA TANGERANG, BANTEN",6,119,95,214
https://kawalpemilu.org#52941,"BUARAN INDAH, TANGERANG, KOTA TANGERANG, BANTEN",7,77,143,220
https://kawalpemilu.org#52941,"BUARAN INDAH, TANGERANG, KOTA TANGERANG, BANTEN",8,67,114,181
https://kawalpemilu.org#52941,"BUARAN INDAH, TANGERANG, KOTA TANGERANG, BANTEN",9,76,133,209
https://kawalpemilu.org#52941,"BUARAN INDAH, TANGERANG, KOTA TANGERANG, BANTEN",10,83,164,247
https://kawalpemilu.org#52941,"BUARAN INDAH, TANGERANG, KOTA TANGERANG, BANTEN",11,76,128,204
https://kawalpemilu.org#52941,"BUARAN INDAH, TANGERANG, KOTA TANGERANG, BANTEN",12,84,74,158
https://kawalpemilu.org#52941,"BUARAN INDAH, TANGERANG, KOTA TANGERANG, BANTEN",13,43,84,127
https://kawalpemilu.org#52941,"BUARAN INDAH, TANGERANG, KOTA TANGERANG, BANTEN",14,83,141,224
https://kawalpemilu.org#52941,"BUARAN INDAH, TANGERANG, KOTA TANGERANG, BANTEN",15,75,139,214
https://kawalpemilu.org#52941,"BUARAN INDAH, TANGERANG, KOTA TANGERANG, BANTEN",16,73,176,249
https://kawalpemilu.org#52941,"BUARAN INDAH, TANGERANG, KOTA TANGERANG, BANTEN",17,65,146,211
https://kawalpemilu.org#52941,"BUARAN INDAH, TANGERANG, KOTA TANGERANG, BANTEN",18,62,120,182
https://kawalpemilu.org#52941,"BUARAN INDAH, TANGERANG, KOTA TANGERANG, BANTEN",19,94,102,196
https://kawalpemilu.org#52941,"BUARAN INDAH, TANGERANG, KOTA TANGERANG, BANTEN",20,139,111,250
https://kawalpemilu.org#52941,"BUARAN INDAH, TANGERANG, KOTA TANGERANG, BANTEN",21,108,65,173
https://kawalpemilu.org#52941,"BUARAN INDAH, TANGERANG, KOTA TANGERANG, BANTEN",22,86,76,162
https://kawalpemilu.org#52941,"BUARAN INDAH, TANGERANG, KOTA TANGERANG, BANTEN",23,95,111,206
https://kawalpemilu.org#52941,"BUARAN INDAH, TANGERANG, KOTA TANGERANG, BANTEN",24,74,137,211
https://kawalpemilu.org#52941,"BUARAN INDAH, TANGERANG, KOTA TANGERANG, BANTEN",25,85,120,205
https://kawalpemilu.org#52941,"BUARAN INDAH, TANGERANG, KOTA TANGERANG, BANTEN",26,88,117,205
https://kawalpemilu.org#52941,"BUARAN INDAH, TANGERANG, KOTA TANGERANG, BANTEN",27,82,116,198
https://kawalpemilu.org#52941,"BUARAN INDAH, TANGERANG, KOTA TANGERANG, BANTEN",28,61,132,193
https://kawalpemilu.org#52941,"BUARAN INDAH, TANGERANG, KOTA TANGERANG, BANTEN",29,55,103,158
https://kawalpemilu.org#52941,"BUARAN INDAH, TANGERANG, KOTA TANGERANG, BANTEN",30,58,83,141
https://kawalpemilu.org#52941,"BUARAN INDAH, TANGERANG, KOTA TANGERANG, BANTEN",31,59,98,157
https://kawalpemilu.org#52941,"BUARAN INDAH, TANGERANG, KOTA TANGERANG, BANTEN",32,50,89,139
https://kawalpemilu.org#52941,"BUARAN INDAH, TANGERANG, KOTA TANGERANG, BANTEN",34,50,110,160
https://kawalpemilu.org#52941,"BUARAN INDAH, TANGERANG, KOTA TANGERANG, BANTEN",35,75,112,187
https://kawalpemilu.org#52941,"BUARAN INDAH, TANGERANG, KOTA TANGERANG, BANTEN",36,89,107,196
https://kawalpemilu.org#52941,"BUARAN INDAH, TANGERANG, KOTA TANGERANG, BANTEN",37,51,109,160
https://kawalpemilu.org#52941,"BUARAN INDAH, TANGERANG, KOTA TANGERANG, BANTEN",38,66,101,167
https://kawalpemilu.org#52941,"BUARAN INDAH, TANGERANG, KOTA TANGERANG, BANTEN",39,65,72,137
https://kawalpemilu.org#52941,"BUARAN INDAH, TANGERANG, KOTA TANGERANG, BANTEN",40,79,147,226
https://kawalpemilu.org#52941,"BUARAN INDAH, TANGERANG, KOTA TANGERANG, BANTEN",41,69,119,188
https://kawalpemilu.org#52941,"BUARAN INDAH, TANGERANG, KOTA TANGERANG, BANTEN",43,58,124,182
https://kawalpemilu.org#52941,"BUARAN INDAH, TANGERANG, KOTA TANGERANG, BANTEN",44,41,144,185
https://kawalpemilu.org#52941,"BUARAN INDAH, TANGERANG, KOTA TANGERANG, BANTEN",46,54,131,185
https://kawalpemilu.org#52941,"BUARAN INDAH, TANGERANG, KOTA TANGERANG, BANTEN",47,78,108,186
https://kawalpemilu.org#52941,"BUARAN INDAH, TANGERANG, KOTA TANGERANG, BANTEN",49,69,120,189
https://kawalpemilu.org#52941,"BUARAN INDAH, TANGERANG, KOTA TANGERANG, BANTEN",51,85,88,173
https://kawalpemilu.org#52941,"BUARAN INDAH, TANGERANG, KOTA TANGERANG, BANTEN",52,84,110,194
https://kawalpemilu.org#52941,"BUARAN INDAH, TANGERANG, KOTA TANGERANG, BANTEN",53,54,90,144
https://kawalpemilu.org#52941,"BUARAN INDAH, TANGERANG, KOTA TANGERANG, BANTEN",54,30,108,138
https://kawalpemilu.org#52941,"BUARAN INDAH, TANGERANG, KOTA TANGERANG, BANTEN",55,90,72,162
https://kawalpemilu.org#52941,"BUARAN INDAH, TANGERANG, KOTA TANGERANG, BANTEN",56,50,94,144
https://kawalpemilu.org#52941,"BUARAN INDAH, TANGERANG, KOTA TANGERANG, BANTEN",57,83,155,238
https://kawalpemilu.org#52941,"BUARAN INDAH, TANGERANG, KOTA TANGERANG, BANTEN",58,86,95,181
https://kawalpemilu.org#52941,"BUARAN INDAH, TANGERANG, KOTA TANGERANG, BANTEN",59,92,133,225
https://kawalpemilu.org#52941,"BUARAN INDAH, TANGERANG, KOTA TANGERANG, BANTEN",60,87,158,245
https://kawalpemilu.org#52941,"BUARAN INDAH, TANGERANG, KOTA TANGERANG, BANTEN",61,63,152,215
https://kawalpemilu.org#52941,"BUARAN INDAH, TANGERANG, KOTA TANGERANG, BANTEN",62,49,131,180
https://kawalpemilu.org#52941,"BUARAN INDAH, TANGERANG, KOTA TANGERANG, BANTEN",63,60,107,167
https://kawalpemilu.org#52941,"BUARAN INDAH, TANGERANG, KOTA TANGERANG, BANTEN",64,39,103,142
https://kawalpemilu.org#52941,"BUARAN INDAH, TANGERANG, KOTA TANGERANG, BANTEN",66,41,112,153
https://kawalpemilu.org#52941,"BUARAN INDAH, TANGERANG, KOTA TANGERANG, BANTEN",67,51,91,142
https://kawalpemilu.org#52941,"BUARAN INDAH, TANGERANG, KOTA TANGERANG, BANTEN",68,79,115,194
https://kawalpemilu.org#52941,"BUARAN INDAH, TANGERANG, KOTA TANGERANG, BANTEN",69,87,123,210
https://kawalpemilu.org#52941,"BUARAN INDAH, TANGERANG, KOTA TANGERANG, BANTEN",70,79,121,200
https://kawalpemilu.org#52941,"BUARAN INDAH, TANGERANG, KOTA TANGERANG, BANTEN",71,82,145,227
https://kawalpemilu.org#52941,"BUARAN INDAH, TANGERANG, KOTA TANGERANG, BANTEN",72,82,136,218
https://kawalpemilu.org#52941,"BUARAN INDAH, TANGERANG, KOTA TANGERANG, BANTEN",73,68,85,153
https://kawalpemilu.org#52941,"BUARAN INDAH, TANGERANG, KOTA TANGERANG, BANTEN",74,66,58,124
https://kawalpemilu.org#52941,"BUARAN INDAH, TANGERANG, KOTA TANGERANG, BANTEN",75,108,81,189
https://kawalpemilu.org#52941,"BUARAN INDAH, TANGERANG, KOTA TANGERANG, BANTEN",76,72,97,169
https://kawalpemilu.org#52941,"BUARAN INDAH, TANGERANG, KOTA TANGERANG, BANTEN",77,52,86,138
https://kawalpemilu.org#52941,"BUARAN INDAH, TANGERANG, KOTA TANGERANG, BANTEN",78,116,232,348
https://kawalpemilu.org#52941,"BUARAN INDAH, TANGERANG, KOTA TANGERANG, BANTEN",79,183,272,455
https://kawalpemilu.org#52942,"CIKOKOL, TANGERANG, KOTA TANGERANG, BANTEN",1,92,117,209
https://kawalpemilu.org#52942,"CIKOKOL, TANGERANG, KOTA TANGERANG, BANTEN",3,92,140,232
https://kawalpemilu.org#52942,"CIKOKOL, TANGERANG, KOTA TANGERANG, BANTEN",4,56,87,143
https://kawalpemilu.org#52942,"CIKOKOL, TANGERANG, KOTA TANGERANG, BANTEN",5,67,92,153
https://kawalpemilu.org#52942,"CIKOKOL, TANGERANG, KOTA TANGERANG, BANTEN",6,93,96,189
https://kawalpemilu.org#52942,"CIKOKOL, TANGERANG, KOTA TANGERANG, BANTEN",7,87,99,186
https://kawalpemilu.org#52942,"CIKOKOL, TANGERANG, KOTA TANGERANG, BANTEN",8,103,95,195
https://kawalpemilu.org#52942,"CIKOKOL, TANGERANG, KOTA TANGERANG, BANTEN",9,49,140,189
https://kawalpemilu.org#52942,"CIKOKOL, TANGERANG, KOTA TANGERANG, BANTEN",10,42,142,184
https://kawalpemilu.org#52942,"CIKOKOL, TANGERANG, KOTA TANGERANG, BANTEN",11,49,130,179
https://kawalpemilu.org#52942,"CIKOKOL, TANGERANG, KOTA TANGERANG, BANTEN",12,65,126,191
https://kawalpemilu.org#52942,"CIKOKOL, TANGERANG, KOTA TANGERANG, BANTEN",13,70,100,170
https://kawalpemilu.org#52942,"CIKOKOL, TANGERANG, KOTA TANGERANG, BANTEN",14,164,28,194
https://kawalpemilu.org#52942,"CIKOKOL, TANGERANG, KOTA TANGERANG, BANTEN",15,71,143,214
https://kawalpemilu.org#52942,"CIKOKOL, TANGERANG, KOTA TANGERANG, BANTEN",16,93,117,210
https://kawalpemilu.org#52942,"CIKOKOL, TANGERANG, KOTA TANGERANG, BANTEN",17,57,193,250
https://kawalpemilu.org#52942,"CIKOKOL, TANGERANG, KOTA TANGERANG, BANTEN",18,87,64,151
https://kawalpemilu.org#52942,"CIKOKOL, TANGERANG, KOTA TANGERANG, BANTEN",19,54,82,136
https://kawalpemilu.org#52942,"CIKOKOL, TANGERANG, KOTA TANGERANG, BANTEN",20,51,95,146
https://kawalpemilu.org#52942,"CIKOKOL, TANGERANG, KOTA TANGERANG, BANTEN",21,87,77,164
https://kawalpemilu.org#52942,"CIKOKOL, TANGERANG, KOTA TANGERANG, BANTEN",22,72,104,176
https://kawalpemilu.org#52942,"CIKOKOL, TANGERANG, KOTA TANGERANG, BANTEN",23,79,109,188
https://kawalpemilu.org#52942,"CIKOKOL, TANGERANG, KOTA TANGERANG, BANTEN",24,90,110,200
https://kawalpemilu.org#52942,"CIKOKOL, TANGERANG, KOTA TANGERANG, BANTEN",25,67,129,196
https://kawalpemilu.org#52942,"CIKOKOL, TANGERANG, KOTA TANGERANG, BANTEN",26,69,63,132
https://kawalpemilu.org#52942,"CIKOKOL, TANGERANG, KOTA TANGERANG, BANTEN",27,47,92,139
https://kawalpemilu.org#52942,"CIKOKOL, TANGERANG, KOTA TANGERANG, BANTEN",28,65,114,179
https://kawalpemilu.org#52942,"CIKOKOL, TANGERANG, KOTA TANGERANG, BANTEN",30,55,152,207
https://kawalpemilu.org#52942,"CIKOKOL, TANGERANG, KOTA TANGERANG, BANTEN",31,88,170,258
https://kawalpemilu.org#52942,"CIKOKOL, TANGERANG, KOTA TANGERANG, BANTEN",32,61,90,151
https://kawalpemilu.org#52942,"CIKOKOL, TANGERANG, KOTA TANGERANG, BANTEN",33,69,118,187
https://kawalpemilu.org#52942,"CIKOKOL, TANGERANG, KOTA TANGERANG, BANTEN",34,60,127,187
https://kawalpemilu.org#52942,"CIKOKOL, TANGERANG, KOTA TANGERANG, BANTEN",35,81,111,192
https://kawalpemilu.org#52942,"CIKOKOL, TANGERANG, KOTA TANGERANG, BANTEN",36,41,135,176
https://kawalpemilu.org#52942,"CIKOKOL, TANGERANG, KOTA TANGERANG, BANTEN",37,56,135,191
https://kawalpemilu.org#52942,"CIKOKOL, TANGERANG, KOTA TANGERANG, BANTEN",38,90,98,188
https://kawalpemilu.org#52942,"CIKOKOL, TANGERANG, KOTA TANGERANG, BANTEN",39,79,110,189
https://kawalpemilu.org#52942,"CIKOKOL, TANGERANG, KOTA TANGERANG, BANTEN",40,106,132,238
https://kawalpemilu.org#52942,"CIKOKOL, TANGERANG, KOTA TANGERANG, BANTEN",41,113,100,213
https://kawalpemilu.org#52942,"CIKOKOL, TANGERANG, KOTA TANGERANG, BANTEN",42,90,108,198
https://kawalpemilu.org#52942,"CIKOKOL, TANGERANG, KOTA TANGERANG, BANTEN",43,67,152,219
https://kawalpemilu.org#52942,"CIKOKOL, TANGERANG, KOTA TANGERANG, BANTEN",44,113,129,242
https://kawalpemilu.org#52942,"CIKOKOL, TANGERANG, KOTA TANGERANG, BANTEN",45,57,114,171
https://kawalpemilu.org#52942,"CIKOKOL, TANGERANG, KOTA TANGERANG, BANTEN",46,69,105,174
https://kawalpemilu.org#52942,"CIKOKOL, TANGERANG, KOTA TANGERANG, BANTEN",47,73,59,132
https://kawalpemilu.org#52942,"CIKOKOL, TANGERANG, KOTA TANGERANG, BANTEN",48,61,64,125
https://kawalpemilu.org#52942,"CIKOKOL, TANGERANG, KOTA TANGERANG, BANTEN",49,65,71,136
https://kawalpemilu.org#52942,"CIKOKOL, TANGERANG, KOTA TANGERANG, BANTEN",50,50,76,126
https://kawalpemilu.org#52942,"CIKOKOL, TANGERANG, KOTA TANGERANG, BANTEN",51,120,103,223
https://kawalpemilu.org#52942,"CIKOKOL, TANGERANG, KOTA TANGERANG, BANTEN",52,82,86,168
https://kawalpemilu.org#52942,"CIKOKOL, TANGERANG, KOTA TANGERANG, BANTEN",53,87,68,155
https://kawalpemilu.org#52942,"CIKOKOL, TANGERANG, KOTA TANGERANG, BANTEN",54,97,85,182
https://kawalpemilu.org#52942,"CIKOKOL, TANGERANG, KOTA TANGERANG, BANTEN",55,124,87,211
https://kawalpemilu.org#52942,"CIKOKOL, TANGERANG, KOTA TANGERANG, BANTEN",56,83,135,218
https://kawalpemilu.org#52942,"CIKOKOL, TANGERANG, KOTA TANGERANG, BANTEN",57,92,159,251
https://kawalpemilu.org#52942,"CIKOKOL, TANGERANG, KOTA TANGERANG, BANTEN",58,113,67,180
https://kawalpemilu.org#52942,"CIKOKOL, TANGERANG, KOTA TANGERANG, BANTEN",59,96,75,171
https://kawalpemilu.org#52942,"CIKOKOL, TANGERANG, KOTA TANGERANG, BANTEN",60,72,164,236
https://kawalpemilu.org#52942,"CIKOKOL, TANGERANG, KOTA TANGERANG, BANTEN",61,107,145,252
https://kawalpemilu.org#52942,"CIKOKOL, TANGERANG, KOTA TANGERANG, BANTEN",62,101,100,201
https://kawalpemilu.org#52942,"CIKOKOL, TANGERANG, KOTA TANGERANG, BANTEN",63,76,97,173
https://kawalpemilu.org#52942,"CIKOKOL, TANGERANG, KOTA TANGERANG, BANTEN",64,79,53,132
https://kawalpemilu.org#52942,"CIKOKOL, TANGERANG, KOTA TANGERANG, BANTEN",65,95,66,161
https://kawalpemilu.org#52942,"CIKOKOL, TANGERANG, KOTA TANGERANG, BANTEN",66,246,25,271
https://kawalpemilu.org#52942,"CIKOKOL, TANGERANG, KOTA TANGERANG, BANTEN",67,230,19,249
https://kawalpemilu.org#52942,"CIKOKOL, TANGERANG, KOTA TANGERANG, BANTEN",68,106,146,252
https://kawalpemilu.org#52942,"CIKOKOL, TANGERANG, KOTA TANGERANG, BANTEN",69,100,152,252
https://kawalpemilu.org#52942,"CIKOKOL, TANGERANG, KOTA TANGERANG, BANTEN",70,47,101,148
https://kawalpemilu.org#52942,"CIKOKOL, TANGERANG, KOTA TANGERANG, BANTEN",71,62,93,155
https://kawalpemilu.org#52942,"CIKOKOL, TANGERANG, KOTA TANGERANG, BANTEN",72,91,95,186
https://kawalpemilu.org#52942,"CIKOKOL, TANGERANG, KOTA TANGERANG, BANTEN",73,73,114,187
https://kawalpemilu.org#52942,"CIKOKOL, TANGERANG, KOTA TANGERANG, BANTEN",74,48,98,146
https://kawalpemilu.org#52942,"CIKOKOL, TANGERANG, KOTA TANGERANG, BANTEN",75,57,110,167
https://kawalpemilu.org#52942,"CIKOKOL, TANGERANG, KOTA TANGERANG, BANTEN",76,67,122,198
https://kawalpemilu.org#52942,"CIKOKOL, TANGERANG, KOTA TANGERANG, BANTEN",77,75,131,206
https://kawalpemilu.org#52942,"CIKOKOL, TANGERANG, KOTA TANGERANG, BANTEN",78,57,128,185
https://kawalpemilu.org#52942,"CIKOKOL, TANGERANG, KOTA TANGERANG, BANTEN",79,69,99,168
https://kawalpemilu.org#52942,"CIKOKOL, TANGERANG, KOTA TANGERANG, BANTEN",80,53,34,87
https://kawalpemilu.org#52942,"CIKOKOL, TANGERANG, KOTA TANGERANG, BANTEN",83,66,115,181
https://kawalpemilu.org#52942,"CIKOKOL, TANGERANG, KOTA TANGERANG, BANTEN",84,66,90,156
https://kawalpemilu.org#52942,"CIKOKOL, TANGERANG, KOTA TANGERANG, BANTEN",85,95,144,239
https://kawalpemilu.org#52942,"CIKOKOL, TANGERANG, KOTA TANGERANG, BANTEN",86,66,152,218
https://kawalpemilu.org#52942,"CIKOKOL, TANGERANG, KOTA TANGERANG, BANTEN",87,63,163,226
https://kawalpemilu.org#52942,"CIKOKOL, TANGERANG, KOTA TANGERANG, BANTEN",88,53,110,163
https://kawalpemilu.org#52942,"CIKOKOL, TANGERANG, KOTA TANGERANG, BANTEN",89,30,98,128
https://kawalpemilu.org#52942,"CIKOKOL, TANGERANG, KOTA TANGERANG, BANTEN",90,149,36,185
https://kawalpemilu.org#52943,"KELAPA INDAH, TANGERANG, KOTA TANGERANG, BANTEN",1,159,46,205
https://kawalpemilu.org#52943,"KELAPA INDAH, TANGERANG, KOTA TANGERANG, BANTEN",2,183,27,210
https://kawalpemilu.org#52943,"KELAPA INDAH, TANGERANG, KOTA TANGERANG, BANTEN",3,162,9,171
https://kawalpemilu.org#52943,"KELAPA INDAH, TANGERANG, KOTA TANGERANG, BANTEN",4,99,14,113
https://kawalpemilu.org#52943,"KELAPA INDAH, TANGERANG, KOTA TANGERANG, BANTEN",5,138,9,147
https://kawalpemilu.org#52943,"KELAPA INDAH, TANGERANG, KOTA TANGERANG, BANTEN",6,113,5,118
https://kawalpemilu.org#52943,"KELAPA INDAH, TANGERANG, KOTA TANGERANG, BANTEN",7,120,7,127
https://kawalpemilu.org#52943,"KELAPA INDAH, TANGERANG, KOTA TANGERANG, BANTEN",8,139,18,157
https://kawalpemilu.org#52943,"KELAPA INDAH, TANGERANG, KOTA TANGERANG, BANTEN",9,133,7,140
https://kawalpemilu.org#52943,"KELAPA INDAH, TANGERANG, KOTA TANGERANG, BANTEN",10,123,3,126
https://kawalpemilu.org#52943,"KELAPA INDAH, TANGERANG, KOTA TANGERANG, BANTEN",11,191,28,219
https://kawalpemilu.org#52943,"KELAPA INDAH, TANGERANG, KOTA TANGERANG, BANTEN",12,161,14,175
https://kawalpemilu.org#52943,"KELAPA INDAH, TANGERANG, KOTA TANGERANG, BANTEN",13,100,22,122
https://kawalpemilu.org#52943,"KELAPA INDAH, TANGERANG, KOTA TANGERANG, BANTEN",14,146,11,157
https://kawalpemilu.org#52943,"KELAPA INDAH, TANGERANG, KOTA TANGERANG, BANTEN",15,45,98,143
https://kawalpemilu.org#52943,"KELAPA INDAH, TANGERANG, KOTA TANGERANG, BANTEN",16,34,91,125
https://kawalpemilu.org#52943,"KELAPA INDAH, TANGERANG, KOTA TANGERANG, BANTEN",17,73,101,174
https://kawalpemilu.org#52943,"KELAPA INDAH, TANGERANG, KOTA TANGERANG, BANTEN",18,69,61,130
https://kawalpemilu.org#52943,"KELAPA INDAH, TANGERANG, KOTA TANGERANG, BANTEN",19,67,69,136
https://kawalpemilu.org#52943,"KELAPA INDAH, TANGERANG, KOTA TANGERANG, BANTEN",20,58,67,125
https://kawalpemilu.org#52943,"KELAPA INDAH, TANGERANG, KOTA TANGERANG, BANTEN",21,85,95,180
https://kawalpemilu.org#52943,"KELAPA INDAH, TANGERANG, KOTA TANGERANG, BANTEN",22,87,110,197
https://kawalpemilu.org#52943,"KELAPA INDAH, TANGERANG, KOTA TANGERANG, BANTEN",23,83,89,172
https://kawalpemilu.org#52943,"KELAPA INDAH, TANGERANG, KOTA TANGERANG, BANTEN",24,76,88,164
https://kawalpemilu.org#52943,"KELAPA INDAH, TANGERANG, KOTA TANGERANG, BANTEN",25,88,130,218
https://kawalpemilu.org#52943,"KELAPA INDAH, TANGERANG, KOTA TANGERANG, BANTEN",26,78,70,148
https://kawalpemilu.org#52943,"KELAPA INDAH, TANGERANG, KOTA TANGERANG, BANTEN",27,58,62,120
https://kawalpemilu.org#52943,"KELAPA INDAH, TANGERANG, KOTA TANGERANG, BANTEN",28,63,78,141
https://kawalpemilu.org#52943,"KELAPA INDAH, TANGERANG, KOTA TANGERANG, BANTEN",29,52,89,141
https://kawalpemilu.org#52943,"KELAPA INDAH, TANGERANG, KOTA TANGERANG, BANTEN",30,51,88,139
https://kawalpemilu.org#52943,"KELAPA INDAH, TANGERANG, KOTA TANGERANG, BANTEN",31,63,82,145
https://kawalpemilu.org#52943,"KELAPA INDAH, TANGERANG, KOTA TANGERANG, BANTEN",32,58,84,142
https://kawalpemilu.org#52943,"KELAPA INDAH, TANGERANG, KOTA TANGERANG, BANTEN",33,50,92,142
https://kawalpemilu.org#52943,"KELAPA INDAH, TANGERANG, KOTA TANGERANG, BANTEN",34,52,88,140
https://kawalpemilu.org#52943,"KELAPA INDAH, TANGERANG, KOTA TANGERANG, BANTEN",36,73,97,170
https://kawalpemilu.org#52943,"KELAPA INDAH, TANGERANG, KOTA TANGERANG, BANTEN",37,92,94,186
https://kawalpemilu.org#52943,"KELAPA INDAH, TANGERANG, KOTA TANGERANG, BANTEN",38,82,92,174
https://kawalpemilu.org#52943,"KELAPA INDAH, TANGERANG, KOTA TANGERANG, BANTEN",39,97,92,189
https://kawalpemilu.org#52943,"KELAPA INDAH, TANGERANG, KOTA TANGERANG, BANTEN",40,180,32,212
https://kawalpemilu.org#52943,"KELAPA INDAH, TANGERANG, KOTA TANGERANG, BANTEN",41,185,31,216
https://kawalpemilu.org#52944,"SUKASARI, TANGERANG, KOTA TANGERANG, BANTEN",1,113,86,199
https://kawalpemilu.org#52944,"SUKASARI, TANGERANG, KOTA TANGERANG, BANTEN",2,0,0,0
https://kawalpemilu.org#52944,"SUKASARI, TANGERANG, KOTA TANGERANG, BANTEN",3,101,97,198
https://kawalpemilu.org#52944,"SUKASARI, TANGERANG, KOTA TANGERANG, BANTEN",4,76,115,191
https://kawalpemilu.org#52944,"SUKASARI, TANGERANG, KOTA TANGERANG, BANTEN",5,86,92,178
https://kawalpemilu.org#52944,"SUKASARI, TANGERANG, KOTA TANGERANG, BANTEN",6,84,74,158
https://kawalpemilu.org#52944,"SUKASARI, TANGERANG, KOTA TANGERANG, BANTEN",8,113,109,222
https://kawalpemilu.org#52944,"SUKASARI, TANGERANG, KOTA TANGERANG, BANTEN",9,51,67,118
https://kawalpemilu.org#52944,"SUKASARI, TANGERANG, KOTA TANGERANG, BANTEN",10,60,58,118
https://kawalpemilu.org#52944,"SUKASARI, TANGERANG, KOTA TANGERANG, BANTEN",11,129,12,141
https://kawalpemilu.org#52944,"SUKASARI, TANGERANG, KOTA TANGERANG, BANTEN",12,132,1,133
https://kawalpemilu.org#52944,"SUKASARI, TANGERANG, KOTA TANGERANG, BANTEN",13,44,123,167
https://kawalpemilu.org#52944,"SUKASARI, TANGERANG, KOTA TANGERANG, BANTEN",15,27,129,156
https://kawalpemilu.org#52944,"SUKASARI, TANGERANG, KOTA TANGERANG, BANTEN",16,72,97,169
https://kawalpemilu.org#52944,"SUKASARI, TANGERANG, KOTA TANGERANG, BANTEN",20,102,26,128
https://kawalpemilu.org#52944,"SUKASARI, TANGERANG, KOTA TANGERANG, BANTEN",21,101,16,117
https://kawalpemilu.org#52944,"SUKASARI, TANGERANG, KOTA TANGERANG, BANTEN",22,73,101,174
https://kawalpemilu.org#52944,"SUKASARI, TANGERANG, KOTA TANGERANG, BANTEN",23,58,102,160
https://kawalpemilu.org#52944,"SUKASARI, TANGERANG, KOTA TANGERANG, BANTEN",24,87,102,189
https://kawalpemilu.org#52944,"SUKASARI, TANGERANG, KOTA TANGERANG, BANTEN",27,112,78,190
https://kawalpemilu.org#52944,"SUKASARI, TANGERANG, KOTA TANGERANG, BANTEN",28,65,128,193
https://kawalpemilu.org#52944,"SUKASARI, TANGERANG, KOTA TANGERANG, BANTEN",29,66,141,207
https://kawalpemilu.org#52944,"SUKASARI, TANGERANG, KOTA TANGERANG, BANTEN",30,79,76,155
https://kawalpemilu.org#52944,"SUKASARI, TANGERANG, KOTA TANGERANG, BANTEN",32,87,75,162
https://kawalpemilu.org#52944,"SUKASARI, TANGERANG, KOTA TANGERANG, BANTEN",35,73,104,177
https://kawalpemilu.org#52944,"SUKASARI, TANGERANG, KOTA TANGERANG, BANTEN",36,62,78,140
https://kawalpemilu.org#52944,"SUKASARI, TANGERANG, KOTA TANGERANG, BANTEN",38,212,8,220
https://kawalpemilu.org#52944,"SUKASARI, TANGERANG, KOTA TANGERANG, BANTEN",39,155,41,196
https://kawalpemilu.org#52944,"SUKASARI, TANGERANG, KOTA TANGERANG, BANTEN",40,152,37,189
https://kawalpemilu.org#52944,"SUKASARI, TANGERANG, KOTA TANGERANG, BANTEN",41,164,4,168
https://kawalpemilu.org#52944,"SUKASARI, TANGERANG, KOTA TANGERANG, BANTEN",44,130,64,194
https://kawalpemilu.org#52944,"SUKASARI, TANGERANG, KOTA TANGERANG, BANTEN",46,46,117,163
https://kawalpemilu.org#52944,"SUKASARI, TANGERANG, KOTA TANGERANG, BANTEN",48,66,105,171
https://kawalpemilu.org#52944,"SUKASARI, TANGERANG, KOTA TANGERANG, BANTEN",50,61,122,183
https://kawalpemilu.org#52944,"SUKASARI, TANGERANG, KOTA TANGERANG, BANTEN",51,48,80,128
https://kawalpemilu.org#52944,"SUKASARI, TANGERANG, KOTA TANGERANG, BANTEN",52,33,59,92
https://kawalpemilu.org#52944,"SUKASARI, TANGERANG, KOTA TANGERANG, BANTEN",53,100,69,169
https://kawalpemilu.org#52944,"SUKASARI, TANGERANG, KOTA TANGERANG, BANTEN",54,76,81,157
https://kawalpemilu.org#52944,"SUKASARI, TANGERANG, KOTA TANGERANG, BANTEN",55,207,2,209
https://kawalpemilu.org#52944,"SUKASARI, TANGERANG, KOTA TANGERANG, BANTEN",56,199,14,213
https://kawalpemilu.org#52944,"SUKASARI, TANGERANG, KOTA TANGERANG, BANTEN",57,162,9,171
https://kawalpemilu.org#52944,"SUKASARI, TANGERANG, KOTA TANGERANG, BANTEN",59,122,27,149
https://kawalpemilu.org#52944,"SUKASARI, TANGERANG, KOTA TANGERANG, BANTEN",60,85,117,202
https://kawalpemilu.org#52944,"SUKASARI, TANGERANG, KOTA TANGERANG, BANTEN",61,79,140,219
https://kawalpemilu.org#52944,"SUKASARI, TANGERANG, KOTA TANGERANG, BANTEN",62,57,70,127
https://kawalpemilu.org#52944,"SUKASARI, TANGERANG, KOTA TANGERANG, BANTEN",63,54,107,161
https://kawalpemilu.org#52944,"SUKASARI, TANGERANG, KOTA TANGERANG, BANTEN",64,0,0,0
https://kawalpemilu.org#52944,"SUKASARI, TANGERANG, KOTA TANGERANG, BANTEN",65,66,99,165
https://kawalpemilu.org#52944,"SUKASARI, TANGERANG, KOTA TANGERANG, BANTEN",66,56,106,162
https://kawalpemilu.org#52944,"SUKASARI, TANGERANG, KOTA TANGERANG, BANTEN",69,86,66,152
https://kawalpemilu.org#52944,"SUKASARI, TANGERANG, KOTA TANGERANG, BANTEN",70,115,83,198
https://kawalpemilu.org#52944,"SUKASARI, TANGERANG, KOTA TANGERANG, BANTEN",71,105,90,195
https://kawalpemilu.org#52944,"SUKASARI, TANGERANG, KOTA TANGERANG, BANTEN",72,94,53,147
https://kawalpemilu.org#52944,"SUKASARI, TANGERANG, KOTA TANGERANG, BANTEN",73,114,52,166
https://kawalpemilu.org#52944,"SUKASARI, TANGERANG, KOTA TANGERANG, BANTEN",74,129,35,164
https://kawalpemilu.org#52944,"SUKASARI, TANGERANG, KOTA TANGERANG, BANTEN",75,135,43,178
https://kawalpemilu.org#52944,"SUKASARI, TANGERANG, KOTA TANGERANG, BANTEN",77,72,140,212
https://kawalpemilu.org#52944,"SUKASARI, TANGERANG, KOTA TANGERANG, BANTEN",78,91,127,218
https://kawalpemilu.org#52944,"SUKASARI, TANGERANG, KOTA TANGERANG, BANTEN",79,73,157,230
https://kawalpemilu.org#52944,"SUKASARI, TANGERANG, KOTA TANGERANG, BANTEN",80,128,73,201
https://kawalpemilu.org#52944,"SUKASARI, TANGERANG, KOTA TANGERANG, BANTEN",81,42,122,164
https://kawalpemilu.org#52944,"SUKASARI, TANGERANG, KOTA TANGERANG, BANTEN",85,246,14,260
https://kawalpemilu.org#52944,"SUKASARI, TANGERANG, KOTA TANGERANG, BANTEN",87,57,143,200
https://kawalpemilu.org#52945,"BABAKAN, TANGERANG, KOTA TANGERANG, BANTEN",1,63,93,156
https://kawalpemilu.org#52945,"BABAKAN, TANGERANG, KOTA TANGERANG, BANTEN",2,81,77,158
https://kawalpemilu.org#52945,"BABAKAN, TANGERANG, KOTA TANGERANG, BANTEN",3,89,101,190
https://kawalpemilu.org#52945,"BABAKAN, TANGERANG, KOTA TANGERANG, BANTEN",4,163,88,251
https://kawalpemilu.org#52945,"BABAKAN, TANGERANG, KOTA TANGERANG, BANTEN",5,108,127,235
https://kawalpemilu.org#52945,"BABAKAN, TANGERANG, KOTA TANGERANG, BANTEN",6,105,122,227
https://kawalpemilu.org#52945,"BABAKAN, TANGERANG, KOTA TANGERANG, BANTEN",7,64,107,171
https://kawalpemilu.org#52945,"BABAKAN, TANGERANG, KOTA TANGERANG, BANTEN",8,42,116,158
https://kawalpemilu.org#52945,"BABAKAN, TANGERANG, KOTA TANGERANG, BANTEN",9,59,90,149
https://kawalpemilu.org#52945,"BABAKAN, TANGERANG, KOTA TANGERANG, BANTEN",10,48,129,177
https://kawalpemilu.org#52945,"BABAKAN, TANGERANG, KOTA TANGERANG, BANTEN",11,52,119,171
https://kawalpemilu.org#52945,"BABAKAN, TANGERANG, KOTA TANGERANG, BANTEN",12,74,127,201
https://kawalpemilu.org#52945,"BABAKAN, TANGERANG, KOTA TANGERANG, BANTEN",13,116,102,218
https://kawalpemilu.org#52945,"BABAKAN, TANGERANG, KOTA TANGERANG, BANTEN",14,54,74,128
https://kawalpemilu.org#52945,"BABAKAN, TANGERANG, KOTA TANGERANG, BANTEN",15,58,61,119
https://kawalpemilu.org#52945,"BABAKAN, TANGERANG, KOTA TANGERANG, BANTEN",16,158,121,279
https://kawalpemilu.org#52945,"BABAKAN, TANGERANG, KOTA TANGERANG, BANTEN",17,87,121,208
https://kawalpemilu.org#52945,"BABAKAN, TANGERANG, KOTA TANGERANG, BANTEN",18,85,113,198
https://kawalpemilu.org#52945,"BABAKAN, TANGERANG, KOTA TANGERANG, BANTEN",19,80,94,174
https://kawalpemilu.org#52945,"BABAKAN, TANGERANG, KOTA TANGERANG, BANTEN",20,69,98,167
https://kawalpemilu.org#52945,"BABAKAN, TANGERANG, KOTA TANGERANG, BANTEN",21,113,90,203
https://kawalpemilu.org#52945,"BABAKAN, TANGERANG, KOTA TANGERANG, BANTEN",22,90,127,217
https://kawalpemilu.org#52945,"BABAKAN, TANGERANG, KOTA TANGERANG, BANTEN",23,69,150,219
https://kawalpemilu.org#52945,"BABAKAN, TANGERANG, KOTA TANGERANG, BANTEN",24,116,89,205
https://kawalpemilu.org#52945,"BABAKAN, TANGERANG, KOTA TANGERANG, BANTEN",25,85,104,189
https://kawalpemilu.org#52945,"BABAKAN, TANGERANG, KOTA TANGERANG, BANTEN",26,80,104,184
https://kawalpemilu.org#52945,"BABAKAN, TANGERANG, KOTA TANGERANG, BANTEN",27,120,81,201
https://kawalpemilu.org#52945,"BABAKAN, TANGERANG, KOTA TANGERANG, BANTEN",28,122,92,214
https://kawalpemilu.org#52945,"BABAKAN, TANGERANG, KOTA TANGERANG, BANTEN",29,50,157,207
https://kawalpemilu.org#52945,"BABAKAN, TANGERANG, KOTA TANGERANG, BANTEN",30,60,142,202
https://kawalpemilu.org#52945,"BABAKAN, TANGERANG, KOTA TANGERANG, BANTEN",31,79,106,185
https://kawalpemilu.org#52945,"BABAKAN, TANGERANG, KOTA TANGERANG, BANTEN",32,52,104,156
https://kawalpemilu.org#52945,"BABAKAN, TANGERANG, KOTA TANGERANG, BANTEN",33,82,104,186
https://kawalpemilu.org#52945,"BABAKAN, TANGERANG, KOTA TANGERANG, BANTEN",34,72,148,220
https://kawalpemilu.org#52945,"BABAKAN, TANGERANG, KOTA TANGERANG, BANTEN",35,76,151,227
https://kawalpemilu.org#52945,"BABAKAN, TANGERANG, KOTA TANGERANG, BANTEN",36,61,115,176
https://kawalpemilu.org#52945,"BABAKAN, TANGERANG, KOTA TANGERANG, BANTEN",37,62,156,218
https://kawalpemilu.org#52945,"BABAKAN, TANGERANG, KOTA TANGERANG, BANTEN",38,52,108,160
https://kawalpemilu.org#52945,"BABAKAN, TANGERANG, KOTA TANGERANG, BANTEN",39,57,135,192
https://kawalpemilu.org#52945,"BABAKAN, TANGERANG, KOTA TANGERANG, BANTEN",40,51,129,180
https://kawalpemilu.org#52945,"BABAKAN, TANGERANG, KOTA TANGERANG, BANTEN",41,36,101,137
https://kawalpemilu.org#52945,"BABAKAN, TANGERANG, KOTA TANGERANG, BANTEN",42,68,99,167
https://kawalpemilu.org#52945,"BABAKAN, TANGERANG, KOTA TANGERANG, BANTEN",43,76,101,177
https://kawalpemilu.org#52945,"BABAKAN, TANGERANG, KOTA TANGERANG, BANTEN",44,45,154,196
https://kawalpemilu.org#52945,"BABAKAN, TANGERANG, KOTA TANGERANG, BANTEN",45,42,154,196
https://kawalpemilu.org#52945,"BABAKAN, TANGERANG, KOTA TANGERANG, BANTEN",46,43,101,144
https://kawalpemilu.org#52945,"BABAKAN, TANGERANG, KOTA TANGERANG, BANTEN",47,38,138,176
https://kawalpemilu.org#52945,"BABAKAN, TANGERANG, KOTA TANGERANG, BANTEN",48,58,109,167
https://kawalpemilu.org#52945,"BABAKAN, TANGERANG, KOTA TANGERANG, BANTEN",49,72,76,148
https://kawalpemilu.org#52945,"BABAKAN, TANGERANG, KOTA TANGERANG, BANTEN",50,75,83,158
https://kawalpemilu.org#52945,"BABAKAN, TANGERANG, KOTA TANGERANG, BANTEN",51,66,96,162
https://kawalpemilu.org#52945,"BABAKAN, TANGERANG, KOTA TANGERANG, BANTEN",52,100,124,224
https://kawalpemilu.org#52945,"BABAKAN, TANGERANG, KOTA TANGERANG, BANTEN",53,99,122,221
https://kawalpemilu.org#52945,"BABAKAN, TANGERANG, KOTA TANGERANG, BANTEN",54,80,118,198
https://kawalpemilu.org#52945,"BABAKAN, TANGERANG, KOTA TANGERANG, BANTEN",55,207,75,282
https://kawalpemilu.org#52945,"BABAKAN, TANGERANG, KOTA TANGERANG, BANTEN",56,59,81,140
https://kawalpemilu.org#52945,"BABAKAN, TANGERANG, KOTA TANGERANG, BANTEN",58,119,95,214
https://kawalpemilu.org#52945,"BABAKAN, TANGERANG, KOTA TANGERANG, BANTEN",59,128,103,231
https://kawalpemilu.org#52947,"KERONCONG, JATIUWUNG, KOTA TANGERANG, BANTEN",1,58,138,196
https://kawalpemilu.org#52947,"KERONCONG, JATIUWUNG, KOTA TANGERANG, BANTEN",2,61,126,187
https://kawalpemilu.org#52947,"KERONCONG, JATIUWUNG, KOTA TANGERANG, BANTEN",3,56,94,150
https://kawalpemilu.org#52947,"KERONCONG, JATIUWUNG, KOTA TANGERANG, BANTEN",4,111,90,201
https://kawalpemilu.org#52947,"KERONCONG, JATIUWUNG, KOTA TANGERANG, BANTEN",6,53,98,151
https://kawalpemilu.org#52947,"KERONCONG, JATIUWUNG, KOTA TANGERANG, BANTEN",7,50,66,116
https://kawalpemilu.org#52947,"KERONCONG, JATIUWUNG, KOTA TANGERANG, BANTEN",8,81,93,174
https://kawalpemilu.org#52947,"KERONCONG, JATIUWUNG, KOTA TANGERANG, BANTEN",9,120,81,201
https://kawalpemilu.org#52947,"KERONCONG, JATIUWUNG, KOTA TANGERANG, BANTEN",10,106,81,187
https://kawalpemilu.org#52947,"KERONCONG, JATIUWUNG, KOTA TANGERANG, BANTEN",11,48,74,122
https://kawalpemilu.org#52947,"KERONCONG, JATIUWUNG, KOTA TANGERANG, BANTEN",12,80,60,140
https://kawalpemilu.org#52947,"KERONCONG, JATIUWUNG, KOTA TANGERANG, BANTEN",13,94,82,176
https://kawalpemilu.org#52947,"KERONCONG, JATIUWUNG, KOTA TANGERANG, BANTEN",14,84,73,157
https://kawalpemilu.org#52947,"KERONCONG, JATIUWUNG, KOTA TANGERANG, BANTEN",15,60,54,114
https://kawalpemilu.org#52947,"KERONCONG, JATIUWUNG, KOTA TANGERANG, BANTEN",16,100,76,176
https://kawalpemilu.org#52947,"KERONCONG, JATIUWUNG, KOTA TANGERANG, BANTEN",17,118,82,200
https://kawalpemilu.org#52947,"KERONCONG, JATIUWUNG, KOTA TANGERANG, BANTEN",18,126,85,211
https://kawalpemilu.org#52947,"KERONCONG, JATIUWUNG, KOTA TANGERANG, BANTEN",19,57,66,123
https://kawalpemilu.org#52947,"KERONCONG, JATIUWUNG, KOTA TANGERANG, BANTEN",20,69,83,152
https://kawalpemilu.org#52947,"KERONCONG, JATIUWUNG, KOTA TANGERANG, BANTEN",21,93,61,154
https://kawalpemilu.org#52947,"KERONCONG, JATIUWUNG, KOTA TANGERANG, BANTEN",22,72,104,176
https://kawalpemilu.org#52947,"KERONCONG, JATIUWUNG, KOTA TANGERANG, BANTEN",23,82,53,135
https://kawalpemilu.org#52947,"KERONCONG, JATIUWUNG, KOTA TANGERANG, BANTEN",24,81,58,139
https://kawalpemilu.org#52947,"KERONCONG, JATIUWUNG, KOTA TANGERANG, BANTEN",25,96,66,162
https://kawalpemilu.org#52947,"KERONCONG, JATIUWUNG, KOTA TANGERANG, BANTEN",26,93,81,174
https://kawalpemilu.org#52947,"KERONCONG, JATIUWUNG, KOTA TANGERANG, BANTEN",27,81,61,142
https://kawalpemilu.org#52947,"KERONCONG, JATIUWUNG, KOTA TANGERANG, BANTEN",28,83,60,143
https://kawalpemilu.org#52947,"KERONCONG, JATIUWUNG, KOTA TANGERANG, BANTEN",29,90,78,168
https://kawalpemilu.org#52947,"KERONCONG, JATIUWUNG, KOTA TANGERANG, BANTEN",30,56,71,127
https://kawalpemilu.org#52947,"KERONCONG, JATIUWUNG, KOTA TANGERANG, BANTEN",32,54,131,185
https://kawalpemilu.org#52947,"KERONCONG, JATIUWUNG, KOTA TANGERANG, BANTEN",33,54,131,185
https://kawalpemilu.org#52947,"KERONCONG, JATIUWUNG, KOTA TANGERANG, BANTEN",34,63,126,189
https://kawalpemilu.org#52947,"KERONCONG, JATIUWUNG, KOTA TANGERANG, BANTEN",38,88,113,201
https://kawalpemilu.org#52947,"KERONCONG, JATIUWUNG, KOTA TANGERANG, BANTEN",47,43,132,175
https://kawalpemilu.org#52947,"KERONCONG, JATIUWUNG, KOTA TANGERANG, BANTEN",48,68,66,134
https://kawalpemilu.org#52947,"KERONCONG, JATIUWUNG, KOTA TANGERANG, BANTEN",51,30,147,177
https://kawalpemilu.org#52947,"KERONCONG, JATIUWUNG, KOTA TANGERANG, BANTEN",54,42,167,209
https://kawalpemilu.org#52947,"KERONCONG, JATIUWUNG, KOTA TANGERANG, BANTEN",56,68,83,151
https://kawalpemilu.org#52947,"KERONCONG, JATIUWUNG, KOTA TANGERANG, BANTEN",57,78,93,171
https://kawalpemilu.org#52947,"KERONCONG, JATIUWUNG, KOTA TANGERANG, BANTEN",58,83,68,151
https://kawalpemilu.org#52947,"KERONCONG, JATIUWUNG, KOTA TANGERANG, BANTEN",59,95,111,206
https://kawalpemilu.org#52947,"KERONCONG, JATIUWUNG, KOTA TANGERANG, BANTEN",60,87,132,219
https://kawalpemilu.org#52948,"JATAKE, JATIUWUNG, KOTA TANGERANG, BANTEN",1,43,129,172
https://kawalpemilu.org#52948,"JATAKE, JATIUWUNG, KOTA TANGERANG, BANTEN",3,31,126,157
https://kawalpemilu.org#52948,"JATAKE, JATIUWUNG, KOTA TANGERANG, BANTEN",4,60,137,197
https://kawalpemilu.org#52948,"JATAKE, JATIUWUNG, KOTA TANGERANG, BANTEN",6,19,126,145
https://kawalpemilu.org#52948,"JATAKE, JATIUWUNG, KOTA TANGERANG, BANTEN",8,38,113,151
https://kawalpemilu.org#52948,"JATAKE, JATIUWUNG, KOTA TANGERANG, BANTEN",11,61,118,185
https://kawalpemilu.org#52948,"JATAKE, JATIUWUNG, KOTA TANGERANG, BANTEN",14,31,94,125
https://kawalpemilu.org#52948,"JATAKE, JATIUWUNG, KOTA TANGERANG, BANTEN",15,39,91,130
https://kawalpemilu.org#52948,"JATAKE, JATIUWUNG, KOTA TANGERANG, BANTEN",16,91,116,207
https://kawalpemilu.org#52948,"JATAKE, JATIUWUNG, KOTA TANGERANG, BANTEN",17,69,130,199
https://kawalpemilu.org#52948,"JATAKE, JATIUWUNG, KOTA TANGERANG, BANTEN",18,59,94,153
https://kawalpemilu.org#52948,"JATAKE, JATIUWUNG, KOTA TANGERANG, BANTEN",20,81,91,172
https://kawalpemilu.org#52948,"JATAKE, JATIUWUNG, KOTA TANGERANG, BANTEN",23,63,115,178
https://kawalpemilu.org#52948,"JATAKE, JATIUWUNG, KOTA TANGERANG, BANTEN",24,61,151,212
https://kawalpemilu.org#52948,"JATAKE, JATIUWUNG, KOTA TANGERANG, BANTEN",25,55,85,140
https://kawalpemilu.org#52948,"JATAKE, JATIUWUNG, KOTA TANGERANG, BANTEN",26,47,97,144
https://kawalpemilu.org#52948,"JATAKE, JATIUWUNG, KOTA TANGERANG, BANTEN",27,93,125,218
https://kawalpemilu.org#52948,"JATAKE, JATIUWUNG, KOTA TANGERANG, BANTEN",28,86,112,198
https://kawalpemilu.org#52948,"JATAKE, JATIUWUNG, KOTA TANGERANG, BANTEN",32,86,90,176
https://kawalpemilu.org#52948,"JATAKE, JATIUWUNG, KOTA TANGERANG, BANTEN",33,61,100,161
https://kawalpemilu.org#52948,"JATAKE, JATIUWUNG, KOTA TANGERANG, BANTEN",35,48,123,171
https://kawalpemilu.org#52948,"JATAKE, JATIUWUNG, KOTA TANGERANG, BANTEN",36,41,143,184
https://kawalpemilu.org#52948,"JATAKE, JATIUWUNG, KOTA TANGERANG, BANTEN",37,61,104,165
https://kawalpemilu.org#52948,"JATAKE, JATIUWUNG, KOTA TANGERANG, BANTEN",38,48,117,165
https://kawalpemilu.org#52948,"JATAKE, JATIUWUNG, KOTA TANGERANG, BANTEN",40,33,92,125
https://kawalpemilu.org#52948,"JATAKE, JATIUWUNG, KOTA TANGERANG, BANTEN",41,31,50,81
https://kawalpemilu.org#52948,"JATAKE, JATIUWUNG, KOTA TANGERANG, BANTEN",42,84,99,183
https://kawalpemilu.org#52948,"JATAKE, JATIUWUNG, KOTA TANGERANG, BANTEN",43,70,103,173
https://kawalpemilu.org#52949,"PASIR JAYA, JATIUWUNG, KOTA TANGERANG, BANTEN",1,31,103,134
https://kawalpemilu.org#52949,"PASIR JAYA, JATIUWUNG, KOTA TANGERANG, BANTEN",2,24,97,121
https://kawalpemilu.org#52949,"PASIR JAYA, JATIUWUNG, KOTA TANGERANG, BANTEN",3,54,157,211
https://kawalpemilu.org#52949,"PASIR JAYA, JATIUWUNG, KOTA TANGERANG, BANTEN",4,80,126,206
https://kawalpemilu.org#52949,"PASIR JAYA, JATIUWUNG, KOTA TANGERANG, BANTEN",5,24,53,77
https://kawalpemilu.org#52949,"PASIR JAYA, JATIUWUNG, KOTA TANGERANG, BANTEN",6,52,104,156
https://kawalpemilu.org#52949,"PASIR JAYA, JATIUWUNG, KOTA TANGERANG, BANTEN",7,54,121,175
https://kawalpemilu.org#52949,"PASIR JAYA, JATIUWUNG, KOTA TANGERANG, BANTEN",8,45,161,206
https://kawalpemilu.org#52949,"PASIR JAYA, JATIUWUNG, KOTA TANGERANG, BANTEN",9,78,104,182
https://kawalpemilu.org#52949,"PASIR JAYA, JATIUWUNG, KOTA TANGERANG, BANTEN",10,89,136,225
https://kawalpemilu.org#52949,"PASIR JAYA, JATIUWUNG, KOTA TANGERANG, BANTEN",11,29,131,160
https://kawalpemilu.org#52949,"PASIR JAYA, JATIUWUNG, KOTA TANGERANG, BANTEN",12,34,114,148
https://kawalpemilu.org#52949,"PASIR JAYA, JATIUWUNG, KOTA TANGERANG, BANTEN",13,82,89,171
https://kawalpemilu.org#52949,"PASIR JAYA, JATIUWUNG, KOTA TANGERANG, BANTEN",14,65,125,190
https://kawalpemilu.org#52949,"PASIR JAYA, JATIUWUNG, KOTA TANGERANG, BANTEN",15,59,153,212
https://kawalpemilu.org#52949,"PASIR JAYA, JATIUWUNG, KOTA TANGERANG, BANTEN",16,89,120,209
https://kawalpemilu.org#52949,"PASIR JAYA, JATIUWUNG, KOTA TANGERANG, BANTEN",17,51,105,156
https://kawalpemilu.org#52949,"PASIR JAYA, JATIUWUNG, KOTA TANGERANG, BANTEN",18,44,85,129
https://kawalpemilu.org#52949,"PASIR JAYA, JATIUWUNG, KOTA TANGERANG, BANTEN",19,47,135,182
https://kawalpemilu.org#52949,"PASIR JAYA, JATIUWUNG, KOTA TANGERANG, BANTEN",20,39,71,110
https://kawalpemilu.org#52949,"PASIR JAYA, JATIUWUNG, KOTA TANGERANG, BANTEN",21,35,72,107
https://kawalpemilu.org#52949,"PASIR JAYA, JATIUWUNG, KOTA TANGERANG, BANTEN",22,29,45,74
https://kawalpemilu.org#52949,"PASIR JAYA, JATIUWUNG, KOTA TANGERANG, BANTEN",23,34,79,113
https://kawalpemilu.org#52949,"PASIR JAYA, JATIUWUNG, KOTA TANGERANG, BANTEN",24,27,87,114
https://kawalpemilu.org#52949,"PASIR JAYA, JATIUWUNG, KOTA TANGERANG, BANTEN",25,43,75,118
https://kawalpemilu.org#52949,"PASIR JAYA, JATIUWUNG, KOTA TANGERANG, BANTEN",26,55,87,142
https://kawalpemilu.org#52949,"PASIR JAYA, JATIUWUNG, KOTA TANGERANG, BANTEN",27,54,139,193
https://kawalpemilu.org#52949,"PASIR JAYA, JATIUWUNG, KOTA TANGERANG, BANTEN",28,56,125,181
https://kawalpemilu.org#52949,"PASIR JAYA, JATIUWUNG, KOTA TANGERANG, BANTEN",29,54,94,148
https://kawalpemilu.org#52949,"PASIR JAYA, JATIUWUNG, KOTA TANGERANG, BANTEN",30,48,88,136
https://kawalpemilu.org#52949,"PASIR JAYA, JATIUWUNG, KOTA TANGERANG, BANTEN",31,44,103,147
https://kawalpemilu.org#52949,"PASIR JAYA, JATIUWUNG, KOTA TANGERANG, BANTEN",32,37,92,129
https://kawalpemilu.org#52949,"PASIR JAYA, JATIUWUNG, KOTA TANGERANG, BANTEN",33,63,151,214
https://kawalpemilu.org#52949,"PASIR JAYA, JATIUWUNG, KOTA TANGERANG, BANTEN",34,70,140,210
https://kawalpemilu.org#52949,"PASIR JAYA, JATIUWUNG, KOTA TANGERANG, BANTEN",35,108,117,225
https://kawalpemilu.org#52949,"PASIR JAYA, JATIUWUNG, KOTA TANGERANG, BANTEN",36,46,143,189
https://kawalpemilu.org#52949,"PASIR JAYA, JATIUWUNG, KOTA TANGERANG, BANTEN",37,64,167,231
https://kawalpemilu.org#52949,"PASIR JAYA, JATIUWUNG, KOTA TANGERANG, BANTEN",38,42,130,172
https://kawalpemilu.org#52949,"PASIR JAYA, JATIUWUNG, KOTA TANGERANG, BANTEN",39,60,131,191
https://kawalpemilu.org#52949,"PASIR JAYA, JATIUWUNG, KOTA TANGERANG, BANTEN",40,45,109,154
https://kawalpemilu.org#52949,"PASIR JAYA, JATIUWUNG, KOTA TANGERANG, BANTEN",41,48,90,138
https://kawalpemilu.org#52949,"PASIR JAYA, JATIUWUNG, KOTA TANGERANG, BANTEN",42,72,126,198
https://kawalpemilu.org#52949,"PASIR JAYA, JATIUWUNG, KOTA TANGERANG, BANTEN",43,62,106,168
https://kawalpemilu.org#52949,"PASIR JAYA, JATIUWUNG, KOTA TANGERANG, BANTEN",44,48,117,165
https://kawalpemilu.org#52949,"PASIR JAYA, JATIUWUNG, KOTA TANGERANG, BANTEN",45,51,121,172
https://kawalpemilu.org#52949,"PASIR JAYA, JATIUWUNG, KOTA TANGERANG, BANTEN",46,34,87,121
https://kawalpemilu.org#52949,"PASIR JAYA, JATIUWUNG, KOTA TANGERANG, BANTEN",47,27,99,126
https://kawalpemilu.org#52950,"GANDASARI, JATIUWUNG, KOTA TANGERANG, BANTEN",1,13,275,288
https://kawalpemilu.org#52950,"GANDASARI, JATIUWUNG, KOTA TANGERANG, BANTEN",2,80,136,216
https://kawalpemilu.org#52950,"GANDASARI, JATIUWUNG, KOTA TANGERANG, BANTEN",3,87,177,264
https://kawalpemilu.org#52950,"GANDASARI, JATIUWUNG, KOTA TANGERANG, BANTEN",4,108,125,233
https://kawalpemilu.org#52950,"GANDASARI, JATIUWUNG, KOTA TANGERANG, BANTEN",5,77,153,230
https://kawalpemilu.org#52950,"GANDASARI, JATIUWUNG, KOTA TANGERANG, BANTEN",6,103,142,245
https://kawalpemilu.org#52950,"GANDASARI, JATIUWUNG, KOTA TANGERANG, BANTEN",7,88,127,215
https://kawalpemilu.org#52950,"GANDASARI, JATIUWUNG, KOTA TANGERANG, BANTEN",8,64,115,179
https://kawalpemilu.org#52950,"GANDASARI, JATIUWUNG, KOTA TANGERANG, BANTEN",9,73,108,181
https://kawalpemilu.org#52950,"GANDASARI, JATIUWUNG, KOTA TANGERANG, BANTEN",10,66,127,193
https://kawalpemilu.org#52950,"GANDASARI, JATIUWUNG, KOTA TANGERANG, BANTEN",11,74,102,176
https://kawalpemilu.org#52950,"GANDASARI, JATIUWUNG, KOTA TANGERANG, BANTEN",12,64,124,188
https://kawalpemilu.org#52950,"GANDASARI, JATIUWUNG, KOTA TANGERANG, BANTEN",13,41,118,159
https://kawalpemilu.org#52950,"GANDASARI, JATIUWUNG, KOTA TANGERANG, BANTEN",14,55,97,152
https://kawalpemilu.org#52950,"GANDASARI, JATIUWUNG, KOTA TANGERANG, BANTEN",15,92,129,221
https://kawalpemilu.org#52950,"GANDASARI, JATIUWUNG, KOTA TANGERANG, BANTEN",16,76,111,187
https://kawalpemilu.org#52950,"GANDASARI, JATIUWUNG, KOTA TANGERANG, BANTEN",17,81,116,197
https://kawalpemilu.org#52950,"GANDASARI, JATIUWUNG, KOTA TANGERANG, BANTEN",18,80,128,208
https://kawalpemilu.org#52950,"GANDASARI, JATIUWUNG, KOTA TANGERANG, BANTEN",19,59,144,203
https://kawalpemilu.org#52950,"GANDASARI, JATIUWUNG, KOTA TANGERANG, BANTEN",20,72,118,190
https://kawalpemilu.org#52950,"GANDASARI, JATIUWUNG, KOTA TANGERANG, BANTEN",21,76,137,213
https://kawalpemilu.org#52950,"GANDASARI, JATIUWUNG, KOTA TANGERANG, BANTEN",22,49,143,192
https://kawalpemilu.org#52950,"GANDASARI, JATIUWUNG, KOTA TANGERANG, BANTEN",23,58,159,217
https://kawalpemilu.org#52950,"GANDASARI, JATIUWUNG, KOTA TANGERANG, BANTEN",26,83,148,231
https://kawalpemilu.org#52950,"GANDASARI, JATIUWUNG, KOTA TANGERANG, BANTEN",28,68,145,213
https://kawalpemilu.org#52950,"GANDASARI, JATIUWUNG, KOTA TANGERANG, BANTEN",29,63,111,174
https://kawalpemilu.org#52950,"GANDASARI, JATIUWUNG, KOTA TANGERANG, BANTEN",30,52,128,180
https://kawalpemilu.org#52950,"GANDASARI, JATIUWUNG, KOTA TANGERANG, BANTEN",31,84,111,195
https://kawalpemilu.org#52950,"GANDASARI, JATIUWUNG, KOTA TANGERANG, BANTEN",32,73,99,172
https://kawalpemilu.org#52950,"GANDASARI, JATIUWUNG, KOTA TANGERANG, BANTEN",33,60,198,258
https://kawalpemilu.org#52950,"GANDASARI, JATIUWUNG, KOTA TANGERANG, BANTEN",34,66,183,249
https://kawalpemilu.org#52950,"GANDASARI, JATIUWUNG, KOTA TANGERANG, BANTEN",35,52,104,156
https://kawalpemilu.org#52950,"GANDASARI, JATIUWUNG, KOTA TANGERANG, BANTEN",37,66,100,166
https://kawalpemilu.org#52950,"GANDASARI, JATIUWUNG, KOTA TANGERANG, BANTEN",38,58,93,151
https://kawalpemilu.org#52950,"GANDASARI, JATIUWUNG, KOTA TANGERANG, BANTEN",39,61,109,170
https://kawalpemilu.org#52950,"GANDASARI, JATIUWUNG, KOTA TANGERANG, BANTEN",40,63,129,192
https://kawalpemilu.org#52950,"GANDASARI, JATIUWUNG, KOTA TANGERANG, BANTEN",42,72,110,182
https://kawalpemilu.org#52950,"GANDASARI, JATIUWUNG, KOTA TANGERANG, BANTEN",44,62,99,161
https://kawalpemilu.org#52950,"GANDASARI, JATIUWUNG, KOTA TANGERANG, BANTEN",46,74,89,163
https://kawalpemilu.org#52950,"GANDASARI, JATIUWUNG, KOTA TANGERANG, BANTEN",47,125,132,257
https://kawalpemilu.org#52950,"GANDASARI, JATIUWUNG, KOTA TANGERANG, BANTEN",48,105,109,214
https://kawalpemilu.org#52950,"GANDASARI, JATIUWUNG, KOTA TANGERANG, BANTEN",49,74,104,178
https://kawalpemilu.org#52950,"GANDASARI, JATIUWUNG, KOTA TANGERANG, BANTEN",51,75,140,215
https://kawalpemilu.org#52950,"GANDASARI, JATIUWUNG, KOTA TANGERANG, BANTEN",52,57,110,167
https://kawalpemilu.org#52950,"GANDASARI, JATIUWUNG, KOTA TANGERANG, BANTEN",53,67,105,172
https://kawalpemilu.org#52951,"MANIS JAYA, JATIUWUNG, KOTA TANGERANG, BANTEN",2,79,136,215
https://kawalpemilu.org#52951,"MANIS JAYA, JATIUWUNG, KOTA TANGERANG, BANTEN",4,82,94,176
https://kawalpemilu.org#52951,"MANIS JAYA, JATIUWUNG, KOTA TANGERANG, BANTEN",5,71,103,174
https://kawalpemilu.org#52951,"MANIS JAYA, JATIUWUNG, KOTA TANGERANG, BANTEN",6,72,103,175
https://kawalpemilu.org#52951,"MANIS JAYA, JATIUWUNG, KOTA TANGERANG, BANTEN",7,69,104,173
https://kawalpemilu.org#52951,"MANIS JAYA, JATIUWUNG, KOTA TANGERANG, BANTEN",8,62,109,171
https://kawalpemilu.org#52951,"MANIS JAYA, JATIUWUNG, KOTA TANGERANG, BANTEN",9,47,107,154
https://kawalpemilu.org#52951,"MANIS JAYA, JATIUWUNG, KOTA TANGERANG, BANTEN",10,79,75,154
https://kawalpemilu.org#52951,"MANIS JAYA, JATIUWUNG, KOTA TANGERANG, BANTEN",11,73,83,156
https://kawalpemilu.org#52951,"MANIS JAYA, JATIUWUNG, KOTA TANGERANG, BANTEN",12,67,74,141
https://kawalpemilu.org#52951,"MANIS JAYA, JATIUWUNG, KOTA TANGERANG, BANTEN",13,86,125,211
https://kawalpemilu.org#52951,"MANIS JAYA, JATIUWUNG, KOTA TANGERANG, BANTEN",14,63,99,162
https://kawalpemilu.org#52951,"MANIS JAYA, JATIUWUNG, KOTA TANGERANG, BANTEN",15,52,84,136
https://kawalpemilu.org#52951,"MANIS JAYA, JATIUWUNG, KOTA TANGERANG, BANTEN",16,46,83,129
https://kawalpemilu.org#52951,"MANIS JAYA, JATIUWUNG, KOTA TANGERANG, BANTEN",17,66,78,144
https://kawalpemilu.org#52951,"MANIS JAYA, JATIUWUNG, KOTA TANGERANG, BANTEN",18,50,74,124
https://kawalpemilu.org#52951,"MANIS JAYA, JATIUWUNG, KOTA TANGERANG, BANTEN",19,58,118,176
https://kawalpemilu.org#52951,"MANIS JAYA, JATIUWUNG, KOTA TANGERANG, BANTEN",20,62,102,164
https://kawalpemilu.org#52951,"MANIS JAYA, JATIUWUNG, KOTA TANGERANG, BANTEN",21,47,125,172
https://kawalpemilu.org#52951,"MANIS JAYA, JATIUWUNG, KOTA TANGERANG, BANTEN",22,67,113,180
https://kawalpemilu.org#52951,"MANIS JAYA, JATIUWUNG, KOTA TANGERANG, BANTEN",23,82,129,211
https://kawalpemilu.org#52951,"MANIS JAYA, JATIUWUNG, KOTA TANGERANG, BANTEN",24,61,109,170
https://kawalpemilu.org#52951,"MANIS JAYA, JATIUWUNG, KOTA TANGERANG, BANTEN",25,76,109,185
https://kawalpemilu.org#52951,"MANIS JAYA, JATIUWUNG, KOTA TANGERANG, BANTEN",26,59,98,157
https://kawalpemilu.org#52951,"MANIS JAYA, JATIUWUNG, KOTA TANGERANG, BANTEN",27,67,94,161
https://kawalpemilu.org#52951,"MANIS JAYA, JATIUWUNG, KOTA TANGERANG, BANTEN",28,0,0,0
https://kawalpemilu.org#52951,"MANIS JAYA, JATIUWUNG, KOTA TANGERANG, BANTEN",29,72,116,188
https://kawalpemilu.org#52951,"MANIS JAYA, JATIUWUNG, KOTA TANGERANG, BANTEN",30,86,118,204
https://kawalpemilu.org#52951,"MANIS JAYA, JATIUWUNG, KOTA TANGERANG, BANTEN",31,76,121,197
https://kawalpemilu.org#52951,"MANIS JAYA, JATIUWUNG, KOTA TANGERANG, BANTEN",32,35,145,180
https://kawalpemilu.org#52951,"MANIS JAYA, JATIUWUNG, KOTA TANGERANG, BANTEN",33,100,91,191
https://kawalpemilu.org#52951,"MANIS JAYA, JATIUWUNG, KOTA TANGERANG, BANTEN",34,63,115,178
https://kawalpemilu.org#52951,"MANIS JAYA, JATIUWUNG, KOTA TANGERANG, BANTEN",35,76,107,183
https://kawalpemilu.org#52951,"MANIS JAYA, JATIUWUNG, KOTA TANGERANG, BANTEN",36,43,183,226
https://kawalpemilu.org#52951,"MANIS JAYA, JATIUWUNG, KOTA TANGERANG, BANTEN",37,49,147,196
https://kawalpemilu.org#52951,"MANIS JAYA, JATIUWUNG, KOTA TANGERANG, BANTEN",38,64,157,221
https://kawalpemilu.org#52951,"MANIS JAYA, JATIUWUNG, KOTA TANGERANG, BANTEN",40,55,112,167
https://kawalpemilu.org#52951,"MANIS JAYA, JATIUWUNG, KOTA TANGERANG, BANTEN",41,45,132,177
https://kawalpemilu.org#52951,"MANIS JAYA, JATIUWUNG, KOTA TANGERANG, BANTEN",42,44,98,142
https://kawalpemilu.org#52951,"MANIS JAYA, JATIUWUNG, KOTA TANGERANG, BANTEN",43,54,89,143
https://kawalpemilu.org#52952,"ALAM JAYA, JATIUWUNG, KOTA TANGERANG, BANTEN",1,102,116,218
https://kawalpemilu.org#52952,"ALAM JAYA, JATIUWUNG, KOTA TANGERANG, BANTEN",2,98,123,221
https://kawalpemilu.org#52952,"ALAM JAYA, JATIUWUNG, KOTA TANGERANG, BANTEN",3,53,138,191
https://kawalpemilu.org#52952,"ALAM JAYA, JATIUWUNG, KOTA TANGERANG, BANTEN",4,75,140,215
https://kawalpemilu.org#52952,"ALAM JAYA, JATIUWUNG, KOTA TANGERANG, BANTEN",5,66,152,218
https://kawalpemilu.org#52952,"ALAM JAYA, JATIUWUNG, KOTA TANGERANG, BANTEN",6,40,173,213
https://kawalpemilu.org#52952,"ALAM JAYA, JATIUWUNG, KOTA TANGERANG, BANTEN",7,58,138,196
https://kawalpemilu.org#52952,"ALAM JAYA, JATIUWUNG, KOTA TANGERANG, BANTEN",8,66,114,180
https://kawalpemilu.org#52952,"ALAM JAYA, JATIUWUNG, KOTA TANGERANG, BANTEN",9,49,114,163
https://kawalpemilu.org#52952,"ALAM JAYA, JATIUWUNG, KOTA TANGERANG, BANTEN",10,50,174,224
https://kawalpemilu.org#52952,"ALAM JAYA, JATIUWUNG, KOTA TANGERANG, BANTEN",11,69,114,183
https://kawalpemilu.org#52952,"ALAM JAYA, JATIUWUNG, KOTA TANGERANG, BANTEN",12,65,119,184
https://kawalpemilu.org#52952,"ALAM JAYA, JATIUWUNG, KOTA TANGERANG, BANTEN",13,55,111,166
https://kawalpemilu.org#52952,"ALAM JAYA, JATIUWUNG, KOTA TANGERANG, BANTEN",14,53,108,161
https://kawalpemilu.org#52952,"ALAM JAYA, JATIUWUNG, KOTA TANGERANG, BANTEN",15,21,120,141
https://kawalpemilu.org#52952,"ALAM JAYA, JATIUWUNG, KOTA TANGERANG, BANTEN",18,57,137,194
https://kawalpemilu.org#52952,"ALAM JAYA, JATIUWUNG, KOTA TANGERANG, BANTEN",19,97,138,235
https://kawalpemilu.org#52952,"ALAM JAYA, JATIUWUNG, KOTA TANGERANG, BANTEN",20,99,121,220
https://kawalpemilu.org#52952,"ALAM JAYA, JATIUWUNG, KOTA TANGERANG, BANTEN",21,135,156,291
https://kawalpemilu.org#52952,"ALAM JAYA, JATIUWUNG, KOTA TANGERANG, BANTEN",22,21,78,99
https://kawalpemilu.org#52952,"ALAM JAYA, JATIUWUNG, KOTA TANGERANG, BANTEN",23,50,101,158
https://kawalpemilu.org#52952,"ALAM JAYA, JATIUWUNG, KOTA TANGERANG, BANTEN",24,64,157,221
https://kawalpemilu.org#52952,"ALAM JAYA, JATIUWUNG, KOTA TANGERANG, BANTEN",25,52,163,215
https://kawalpemilu.org#52952,"ALAM JAYA, JATIUWUNG, KOTA TANGERANG, BANTEN",26,107,55,162
https://kawalpemilu.org#52952,"ALAM JAYA, JATIUWUNG, KOTA TANGERANG, BANTEN",27,77,75,152
https://kawalpemilu.org#52952,"ALAM JAYA, JATIUWUNG, KOTA TANGERANG, BANTEN",28,54,102,156
https://kawalpemilu.org#52952,"ALAM JAYA, JATIUWUNG, KOTA TANGERANG, BANTEN",29,90,68,158
https://kawalpemilu.org#52952,"ALAM JAYA, JATIUWUNG, KOTA TANGERANG, BANTEN",30,89,82,171
https://kawalpemilu.org#52952,"ALAM JAYA, JATIUWUNG, KOTA TANGERANG, BANTEN",32,78,128,206
https://kawalpemilu.org#52952,"ALAM JAYA, JATIUWUNG, KOTA TANGERANG, BANTEN",33,90,109,199
https://kawalpemilu.org#52952,"ALAM JAYA, JATIUWUNG, KOTA TANGERANG, BANTEN",34,103,124,227
https://kawalpemilu.org#52952,"ALAM JAYA, JATIUWUNG, KOTA TANGERANG, BANTEN",35,118,150,268
https://kawalpemilu.org#52952,"ALAM JAYA, JATIUWUNG, KOTA TANGERANG, BANTEN",36,75,115,190
https://kawalpemilu.org#52952,"ALAM JAYA, JATIUWUNG, KOTA TANGERANG, BANTEN",37,51,134,185
https://kawalpemilu.org#52952,"ALAM JAYA, JATIUWUNG, KOTA TANGERANG, BANTEN",39,48,106,154
https://kawalpemilu.org#52952,"ALAM JAYA, JATIUWUNG, KOTA TANGERANG, BANTEN",40,68,89,157
https://kawalpemilu.org#52952,"ALAM JAYA, JATIUWUNG, KOTA TANGERANG, BANTEN",41,86,95,181
https://kawalpemilu.org#52952,"ALAM JAYA, JATIUWUNG, KOTA TANGERANG, BANTEN",42,67,108,175
https://kawalpemilu.org#52952,"ALAM JAYA, JATIUWUNG, KOTA TANGERANG, BANTEN",43,114,66,180
https://kawalpemilu.org#52952,"ALAM JAYA, JATIUWUNG, KOTA TANGERANG, BANTEN",44,0,0,0
https://kawalpemilu.org#52952,"ALAM JAYA, JATIUWUNG, KOTA TANGERANG, BANTEN",45,88,91,179
https://kawalpemilu.org#52952,"ALAM JAYA, JATIUWUNG, KOTA TANGERANG, BANTEN",46,98,100,198
https://kawalpemilu.org#52952,"ALAM JAYA, JATIUWUNG, KOTA TANGERANG, BANTEN",47,82,129,211
https://kawalpemilu.org#52952,"ALAM JAYA, JATIUWUNG, KOTA TANGERANG, BANTEN",48,139,119,258
https://kawalpemilu.org#52952,"ALAM JAYA, JATIUWUNG, KOTA TANGERANG, BANTEN",49,88,84,172
https://kawalpemilu.org#52952,"ALAM JAYA, JATIUWUNG, KOTA TANGERANG, BANTEN",50,55,94,149
https://kawalpemilu.org#52952,"ALAM JAYA, JATIUWUNG, KOTA TANGERANG, BANTEN",51,87,126,213
https://kawalpemilu.org#52952,"ALAM JAYA, JATIUWUNG, KOTA TANGERANG, BANTEN",52,75,130,205
https://kawalpemilu.org#52952,"ALAM JAYA, JATIUWUNG, KOTA TANGERANG, BANTEN",53,96,105,201
https://kawalpemilu.org#52952,"ALAM JAYA, JATIUWUNG, KOTA TANGERANG, BANTEN",54,63,87,150
https://kawalpemilu.org#52954,"BATUCEPER, BATUCEPER, KOTA TANGERANG, BANTEN",1,64,107,171
https://kawalpemilu.org#52954,"BATUCEPER, BATUCEPER, KOTA TANGERANG, BANTEN",2,62,44,106
https://kawalpemilu.org#52954,"BATUCEPER, BATUCEPER, KOTA TANGERANG, BANTEN",4,80,131,211
https://kawalpemilu.org#52954,"BATUCEPER, BATUCEPER, KOTA TANGERANG, BANTEN",5,75,77,152
https://kawalpemilu.org#52954,"BATUCEPER, BATUCEPER, KOTA TANGERANG, BANTEN",7,64,134,198
https://kawalpemilu.org#52954,"BATUCEPER, BATUCEPER, KOTA TANGERANG, BANTEN",8,92,150,242
https://kawalpemilu.org#52954,"BATUCEPER, BATUCEPER, KOTA TANGERANG, BANTEN",9,79,76,155
https://kawalpemilu.org#52954,"BATUCEPER, BATUCEPER, KOTA TANGERANG, BANTEN",10,76,80,156
https://kawalpemilu.org#52954,"BATUCEPER, BATUCEPER, KOTA TANGERANG, BANTEN",11,92,153,245
https://kawalpemilu.org#52954,"BATUCEPER, BATUCEPER, KOTA TANGERANG, BANTEN",12,152,90,242
https://kawalpemilu.org#52954,"BATUCEPER, BATUCEPER, KOTA TANGERANG, BANTEN",13,66,90,156
https://kawalpemilu.org#52954,"BATUCEPER, BATUCEPER, KOTA TANGERANG, BANTEN",14,66,75,141
https://kawalpemilu.org#52954,"BATUCEPER, BATUCEPER, KOTA TANGERANG, BANTEN",15,63,80,143
https://kawalpemilu.org#52954,"BATUCEPER, BATUCEPER, KOTA TANGERANG, BANTEN",16,86,56,142
https://kawalpemilu.org#52954,"BATUCEPER, BATUCEPER, KOTA TANGERANG, BANTEN",17,73,142,215
https://kawalpemilu.org#52954,"BATUCEPER, BATUCEPER, KOTA TANGERANG, BANTEN",18,140,42,182
https://kawalpemilu.org#52954,"BATUCEPER, BATUCEPER, KOTA TANGERANG, BANTEN",19,135,45,180
https://kawalpemilu.org#52954,"BATUCEPER, BATUCEPER, KOTA TANGERANG, BANTEN",20,99,43,142
https://kawalpemilu.org#52954,"BATUCEPER, BATUCEPER, KOTA TANGERANG, BANTEN",21,85,47,132
https://kawalpemilu.org#52954,"BATUCEPER, BATUCEPER, KOTA TANGERANG, BANTEN",22,95,135,230
https://kawalpemilu.org#52954,"BATUCEPER, BATUCEPER, KOTA TANGERANG, BANTEN",23,104,104,208
https://kawalpemilu.org#52954,"BATUCEPER, BATUCEPER, KOTA TANGERANG, BANTEN",24,91,122,213
https://kawalpemilu.org#52954,"BATUCEPER, BATUCEPER, KOTA TANGERANG, BANTEN",26,81,100,181
https://kawalpemilu.org#52954,"BATUCEPER, BATUCEPER, KOTA TANGERANG, BANTEN",27,68,96,164
https://kawalpemilu.org#52954,"BATUCEPER, BATUCEPER, KOTA TANGERANG, BANTEN",30,57,80,137
https://kawalpemilu.org#52954,"BATUCEPER, BATUCEPER, KOTA TANGERANG, BANTEN",31,51,95,146
https://kawalpemilu.org#52954,"BATUCEPER, BATUCEPER, KOTA TANGERANG, BANTEN",32,130,23,153
https://kawalpemilu.org#52954,"BATUCEPER, BATUCEPER, KOTA TANGERANG, BANTEN",33,123,13,136
https://kawalpemilu.org#52954,"BATUCEPER, BATUCEPER, KOTA TANGERANG, BANTEN",34,182,18,200
https://kawalpemilu.org#52954,"BATUCEPER, BATUCEPER, KOTA TANGERANG, BANTEN",35,175,16,191
https://kawalpemilu.org#52954,"BATUCEPER, BATUCEPER, KOTA TANGERANG, BANTEN",36,119,49,168
https://kawalpemilu.org#52954,"BATUCEPER, BATUCEPER, KOTA TANGERANG, BANTEN",37,130,45,175
https://kawalpemilu.org#52954,"BATUCEPER, BATUCEPER, KOTA TANGERANG, BANTEN",40,120,42,162
https://kawalpemilu.org#52954,"BATUCEPER, BATUCEPER, KOTA TANGERANG, BANTEN",41,133,52,185
https://kawalpemilu.org#52954,"BATUCEPER, BATUCEPER, KOTA TANGERANG, BANTEN",42,124,51,175
https://kawalpemilu.org#52954,"BATUCEPER, BATUCEPER, KOTA TANGERANG, BANTEN",43,119,15,134
https://kawalpemilu.org#52954,"BATUCEPER, BATUCEPER, KOTA TANGERANG, BANTEN",44,133,11,144
https://kawalpemilu.org#52954,"BATUCEPER, BATUCEPER, KOTA TANGERANG, BANTEN",45,149,5,154
https://kawalpemilu.org#52954,"BATUCEPER, BATUCEPER, KOTA TANGERANG, BANTEN",46,151,27,178
https://kawalpemilu.org#52955,"BATUJAYA, BATUCEPER, KOTA TANGERANG, BANTEN",2,101,115,216
https://kawalpemilu.org#52955,"BATUJAYA, BATUCEPER, KOTA TANGERANG, BANTEN",3,66,107,173
https://kawalpemilu.org#52955,"BATUJAYA, BATUCEPER, KOTA TANGERANG, BANTEN",4,40,135,175
https://kawalpemilu.org#52955,"BATUJAYA, BATUCEPER, KOTA TANGERANG, BANTEN",6,103,117,220
https://kawalpemilu.org#52955,"BATUJAYA, BATUCEPER, KOTA TANGERANG, BANTEN",7,113,102,215
https://kawalpemilu.org#52955,"BATUJAYA, BATUCEPER, KOTA TANGERANG, BANTEN",8,94,154,248
https://kawalpemilu.org#52955,"BATUJAYA, BATUCEPER, KOTA TANGERANG, BANTEN",9,63,103,166
https://kawalpemilu.org#52955,"BATUJAYA, BATUCEPER, KOTA TANGERANG, BANTEN",10,60,119,179
https://kawalpemilu.org#52955,"BATUJAYA, BATUCEPER, KOTA TANGERANG, BANTEN",11,89,126,215
https://kawalpemilu.org#52955,"BATUJAYA, BATUCEPER, KOTA TANGERANG, BANTEN",13,59,185,244
https://kawalpemilu.org#52955,"BATUJAYA, BATUCEPER, KOTA TANGERANG, BANTEN",14,56,145,201
https://kawalpemilu.org#52955,"BATUJAYA, BATUCEPER, KOTA TANGERANG, BANTEN",15,63,107,170
https://kawalpemilu.org#52955,"BATUJAYA, BATUCEPER, KOTA TANGERANG, BANTEN",16,39,103,142
https://kawalpemilu.org#52955,"BATUJAYA, BATUCEPER, KOTA TANGERANG, BANTEN",17,59,158,217
https://kawalpemilu.org#52955,"BATUJAYA, BATUCEPER, KOTA TANGERANG, BANTEN",18,39,181,220
https://kawalpemilu.org#52955,"BATUJAYA, BATUCEPER, KOTA TANGERANG, BANTEN",20,69,138,207
https://kawalpemilu.org#52955,"BATUJAYA, BATUCEPER, KOTA TANGERANG, BANTEN",21,55,164,219
https://kawalpemilu.org#52955,"BATUJAYA, BATUCEPER, KOTA TANGERANG, BANTEN",22,52,127,179
https://kawalpemilu.org#52955,"BATUJAYA, BATUCEPER, KOTA TANGERANG, BANTEN",23,72,170,242
https://kawalpemilu.org#52955,"BATUJAYA, BATUCEPER, KOTA TANGERANG, BANTEN",24,59,165,224
https://kawalpemilu.org#52955,"BATUJAYA, BATUCEPER, KOTA TANGERANG, BANTEN",25,47,130,177
https://kawalpemilu.org#52955,"BATUJAYA, BATUCEPER, KOTA TANGERANG, BANTEN",26,58,181,239
https://kawalpemilu.org#52955,"BATUJAYA, BATUCEPER, KOTA TANGERANG, BANTEN",27,0,0,0
https://kawalpemilu.org#52955,"BATUJAYA, BATUCEPER, KOTA TANGERANG, BANTEN",28,60,134,194
https://kawalpemilu.org#52956,"PORIS GAGA, BATUCEPER, KOTA TANGERANG, BANTEN",1,71,111,182
https://kawalpemilu.org#52956,"PORIS GAGA, BATUCEPER, KOTA TANGERANG, BANTEN",2,61,79,140
https://kawalpemilu.org#52956,"PORIS GAGA, BATUCEPER, KOTA TANGERANG, BANTEN",3,85,97,182
https://kawalpemilu.org#52956,"PORIS GAGA, BATUCEPER, KOTA TANGERANG, BANTEN",4,97,110,207
https://kawalpemilu.org#52956,"PORIS GAGA, BATUCEPER, KOTA TANGERANG, BANTEN",5,57,101,158
https://kawalpemilu.org#52956,"PORIS GAGA, BATUCEPER, KOTA TANGERANG, BANTEN",6,85,123,208
https://kawalpemilu.org#52956,"PORIS GAGA, BATUCEPER, KOTA TANGERANG, BANTEN",7,64,95,159
https://kawalpemilu.org#52956,"PORIS GAGA, BATUCEPER, KOTA TANGERANG, BANTEN",8,107,119,226
https://kawalpemilu.org#52956,"PORIS GAGA, BATUCEPER, KOTA TANGERANG, BANTEN",9,67,86,153
https://kawalpemilu.org#52956,"PORIS GAGA, BATUCEPER, KOTA TANGERANG, BANTEN",10,107,152,259
https://kawalpemilu.org#52956,"PORIS GAGA, BATUCEPER, KOTA TANGERANG, BANTEN",11,120,172,292
https://kawalpemilu.org#52956,"PORIS GAGA, BATUCEPER, KOTA TANGERANG, BANTEN",12,99,114,213
https://kawalpemilu.org#52956,"PORIS GAGA, BATUCEPER, KOTA TANGERANG, BANTEN",13,74,155,229
https://kawalpemilu.org#52956,"PORIS GAGA, BATUCEPER, KOTA TANGERANG, BANTEN",14,76,111,187
https://kawalpemilu.org#52956,"PORIS GAGA, BATUCEPER, KOTA TANGERANG, BANTEN",15,70,124,194
https://kawalpemilu.org#52956,"PORIS GAGA, BATUCEPER, KOTA TANGERANG, BANTEN",16,61,110,171
https://kawalpemilu.org#52956,"PORIS GAGA, BATUCEPER, KOTA TANGERANG, BANTEN",17,88,133,221
https://kawalpemilu.org#52956,"PORIS GAGA, BATUCEPER, KOTA TANGERANG, BANTEN",18,63,134,197
https://kawalpemilu.org#52956,"PORIS GAGA, BATUCEPER, KOTA TANGERANG, BANTEN",20,36,165,201
https://kawalpemilu.org#52956,"PORIS GAGA, BATUCEPER, KOTA TANGERANG, BANTEN",21,109,109,218
https://kawalpemilu.org#52956,"PORIS GAGA, BATUCEPER, KOTA TANGERANG, BANTEN",22,59,186,245
https://kawalpemilu.org#52956,"PORIS GAGA, BATUCEPER, KOTA TANGERANG, BANTEN",23,89,157,246
https://kawalpemilu.org#52956,"PORIS GAGA, BATUCEPER, KOTA TANGERANG, BANTEN",24,65,157,222
https://kawalpemilu.org#52956,"PORIS GAGA, BATUCEPER, KOTA TANGERANG, BANTEN",25,33,155,188
https://kawalpemilu.org#52956,"PORIS GAGA, BATUCEPER, KOTA TANGERANG, BANTEN",26,168,74,242
https://kawalpemilu.org#52956,"PORIS GAGA, BATUCEPER, KOTA TANGERANG, BANTEN",27,180,57,237
https://kawalpemilu.org#52956,"PORIS GAGA, BATUCEPER, KOTA TANGERANG, BANTEN",28,188,57,245
https://kawalpemilu.org#52956,"PORIS GAGA, BATUCEPER, KOTA TANGERANG, BANTEN",29,170,83,253
https://kawalpemilu.org#52956,"PORIS GAGA, BATUCEPER, KOTA TANGERANG, BANTEN",30,53,173,226
https://kawalpemilu.org#52956,"PORIS GAGA, BATUCEPER, KOTA TANGERANG, BANTEN",31,31,189,220
https://kawalpemilu.org#52956,"PORIS GAGA, BATUCEPER, KOTA TANGERANG, BANTEN",32,70,195,265
https://kawalpemilu.org#52956,"PORIS GAGA, BATUCEPER, KOTA TANGERANG, BANTEN",33,67,179,246
https://kawalpemilu.org#52956,"PORIS GAGA, BATUCEPER, KOTA TANGERANG, BANTEN",34,58,184,242
https://kawalpemilu.org#52956,"PORIS GAGA, BATUCEPER, KOTA TANGERANG, BANTEN",35,45,181,226
https://kawalpemilu.org#52956,"PORIS GAGA, BATUCEPER, KOTA TANGERANG, BANTEN",37,108,135,243
https://kawalpemilu.org#52956,"PORIS GAGA, BATUCEPER, KOTA TANGERANG, BANTEN",38,81,153,234
https://kawalpemilu.org#52956,"PORIS GAGA, BATUCEPER, KOTA TANGERANG, BANTEN",39,103,93,196
https://kawalpemilu.org#52956,"PORIS GAGA, BATUCEPER, KOTA TANGERANG, BANTEN",40,90,149,239
https://kawalpemilu.org#52956,"PORIS GAGA, BATUCEPER, KOTA TANGERANG, BANTEN",41,88,142,230
https://kawalpemilu.org#52956,"PORIS GAGA, BATUCEPER, KOTA TANGERANG, BANTEN",42,159,83,242
https://kawalpemilu.org#52956,"PORIS GAGA, BATUCEPER, KOTA TANGERANG, BANTEN",43,225,2,227
https://kawalpemilu.org#52956,"PORIS GAGA, BATUCEPER, KOTA TANGERANG, BANTEN",44,264,4,268
https://kawalpemilu.org#52956,"PORIS GAGA, BATUCEPER, KOTA TANGERANG, BANTEN",45,229,9,238
https://kawalpemilu.org#52956,"PORIS GAGA, BATUCEPER, KOTA TANGERANG, BANTEN",46,252,5,257
https://kawalpemilu.org#52956,"PORIS GAGA, BATUCEPER, KOTA TANGERANG, BANTEN",47,244,5,249
https://kawalpemilu.org#52957,"PORIS GAGA BARU, BATUCEPER, KOTA TANGERANG, BANTEN",1,85,93,178
https://kawalpemilu.org#52957,"PORIS GAGA BARU, BATUCEPER, KOTA TANGERANG, BANTEN",2,80,116,196
https://kawalpemilu.org#52957,"PORIS GAGA BARU, BATUCEPER, KOTA TANGERANG, BANTEN",3,88,112,200
https://kawalpemilu.org#52957,"PORIS GAGA BARU, BATUCEPER, KOTA TANGERANG, BANTEN",4,82,99,181
https://kawalpemilu.org#52957,"PORIS GAGA BARU, BATUCEPER, KOTA TANGERANG, BANTEN",5,81,103,184
https://kawalpemilu.org#52957,"PORIS GAGA BARU, BATUCEPER, KOTA TANGERANG, BANTEN",6,63,91,154
https://kawalpemilu.org#52957,"PORIS GAGA BARU, BATUCEPER, KOTA TANGERANG, BANTEN",7,53,87,140
https://kawalpemilu.org#52957,"PORIS GAGA BARU, BATUCEPER, KOTA TANGERANG, BANTEN",8,58,91,149
https://kawalpemilu.org#52957,"PORIS GAGA BARU, BATUCEPER, KOTA TANGERANG, BANTEN",9,82,61,143
https://kawalpemilu.org#52957,"PORIS GAGA BARU, BATUCEPER, KOTA TANGERANG, BANTEN",10,48,112,160
https://kawalpemilu.org#52957,"PORIS GAGA BARU, BATUCEPER, KOTA TANGERANG, BANTEN",11,80,126,206
https://kawalpemilu.org#52957,"PORIS GAGA BARU, BATUCEPER, KOTA TANGERANG, BANTEN",12,54,103,157
https://kawalpemilu.org#52957,"PORIS GAGA BARU, BATUCEPER, KOTA TANGERANG, BANTEN",13,90,98,188
https://kawalpemilu.org#52957,"PORIS GAGA BARU, BATUCEPER, KOTA TANGERANG, BANTEN",14,70,119,189
https://kawalpemilu.org#52957,"PORIS GAGA BARU, BATUCEPER, KOTA TANGERANG, BANTEN",15,67,54,121
https://kawalpemilu.org#52957,"PORIS GAGA BARU, BATUCEPER, KOTA TANGERANG, BANTEN",16,74,99,173
https://kawalpemilu.org#52957,"PORIS GAGA BARU, BATUCEPER, KOTA TANGERANG, BANTEN",17,110,127,237
https://kawalpemilu.org#52957,"PORIS GAGA BARU, BATUCEPER, KOTA TANGERANG, BANTEN",18,73,127,200
https://kawalpemilu.org#52957,"PORIS GAGA BARU, BATUCEPER, KOTA TANGERANG, BANTEN",19,54,115,169
https://kawalpemilu.org#52957,"PORIS GAGA BARU, BATUCEPER, KOTA TANGERANG, BANTEN",20,60,141,201
https://kawalpemilu.org#52957,"PORIS GAGA BARU, BATUCEPER, KOTA TANGERANG, BANTEN",21,57,95,152
https://kawalpemilu.org#52957,"PORIS GAGA BARU, BATUCEPER, KOTA TANGERANG, BANTEN",22,99,106,205
https://kawalpemilu.org#52957,"PORIS GAGA BARU, BATUCEPER, KOTA TANGERANG, BANTEN",23,53,153,206
https://kawalpemilu.org#52957,"PORIS GAGA BARU, BATUCEPER, KOTA TANGERANG, BANTEN",24,52,128,180
https://kawalpemilu.org#52957,"PORIS GAGA BARU, BATUCEPER, KOTA TANGERANG, BANTEN",25,45,159,204
https://kawalpemilu.org#52957,"PORIS GAGA BARU, BATUCEPER, KOTA TANGERANG, BANTEN",26,25,92,117
https://kawalpemilu.org#52957,"PORIS GAGA BARU, BATUCEPER, KOTA TANGERANG, BANTEN",27,15,146,161
https://kawalpemilu.org#52957,"PORIS GAGA BARU, BATUCEPER, KOTA TANGERANG, BANTEN",28,52,128,180
https://kawalpemilu.org#52957,"PORIS GAGA BARU, BATUCEPER, KOTA TANGERANG, BANTEN",29,57,102,159
https://kawalpemilu.org#52957,"PORIS GAGA BARU, BATUCEPER, KOTA TANGERANG, BANTEN",30,41,103,144
https://kawalpemilu.org#52957,"PORIS GAGA BARU, BATUCEPER, KOTA TANGERANG, BANTEN",31,68,140,208
https://kawalpemilu.org#52957,"PORIS GAGA BARU, BATUCEPER, KOTA TANGERANG, BANTEN",32,47,125,172
https://kawalpemilu.org#52957,"PORIS GAGA BARU, BATUCEPER, KOTA TANGERANG, BANTEN",33,158,40,198
https://kawalpemilu.org#52957,"PORIS GAGA BARU, BATUCEPER, KOTA TANGERANG, BANTEN",34,138,54,192
https://kawalpemilu.org#52958,"KEBON BESAR, BATUCEPER, KOTA TANGERANG, BANTEN",1,62,73,135
https://kawalpemilu.org#52958,"KEBON BESAR, BATUCEPER, KOTA TANGERANG, BANTEN",2,62,44,106
https://kawalpemilu.org#52958,"KEBON BESAR, BATUCEPER, KOTA TANGERANG, BANTEN",3,82,122,204
https://kawalpemilu.org#52958,"KEBON BESAR, BATUCEPER, KOTA TANGERANG, BANTEN",4,78,99,177
https://kawalpemilu.org#52958,"KEBON BESAR, BATUCEPER, KOTA TANGERANG, BANTEN",5,47,90,137
https://kawalpemilu.org#52958,"KEBON BESAR, BATUCEPER, KOTA TANGERANG, BANTEN",6,43,85,128
https://kawalpemilu.org#52958,"KEBON BESAR, BATUCEPER, KOTA TANGERANG, BANTEN",7,77,91,168
https://kawalpemilu.org#52958,"KEBON BESAR, BATUCEPER, KOTA TANGERANG, BANTEN",8,70,83,153
https://kawalpemilu.org#52958,"KEBON BESAR, BATUCEPER, KOTA TANGERANG, BANTEN",9,68,88,156
https://kawalpemilu.org#52958,"KEBON BESAR, BATUCEPER, KOTA TANGERANG, BANTEN",10,112,97,209
https://kawalpemilu.org#52958,"KEBON BESAR, BATUCEPER, KOTA TANGERANG, BANTEN",11,124,99,223
https://kawalpemilu.org#52958,"KEBON BESAR, BATUCEPER, KOTA TANGERANG, BANTEN",12,81,117,198
https://kawalpemilu.org#52958,"KEBON BESAR, BATUCEPER, KOTA TANGERANG, BANTEN",13,66,124,190
https://kawalpemilu.org#52958,"KEBON BESAR, BATUCEPER, KOTA TANGERANG, BANTEN",14,58,111,169
https://kawalpemilu.org#52958,"KEBON BESAR, BATUCEPER, KOTA TANGERANG, BANTEN",15,66,91,157
https://kawalpemilu.org#52958,"KEBON BESAR, BATUCEPER, KOTA TANGERANG, BANTEN",16,84,136,220
https://kawalpemilu.org#52958,"KEBON BESAR, BATUCEPER, KOTA TANGERANG, BANTEN",17,69,101,170
https://kawalpemilu.org#52958,"KEBON BESAR, BATUCEPER, KOTA TANGERANG, BANTEN",18,89,82,171
https://kawalpemilu.org#52958,"KEBON BESAR, BATUCEPER, KOTA TANGERANG, BANTEN",19,39,85,124
https://kawalpemilu.org#52958,"KEBON BESAR, BATUCEPER, KOTA TANGERANG, BANTEN",20,78,130,208
https://kawalpemilu.org#52958,"KEBON BESAR, BATUCEPER, KOTA TANGERANG, BANTEN",21,55,102,157
https://kawalpemilu.org#52958,"KEBON BESAR, BATUCEPER, KOTA TANGERANG, BANTEN",25,70,82,152
https://kawalpemilu.org#52958,"KEBON BESAR, BATUCEPER, KOTA TANGERANG, BANTEN",26,76,100,176
https://kawalpemilu.org#52958,"KEBON BESAR, BATUCEPER, KOTA TANGERANG, BANTEN",27,57,149,206
https://kawalpemilu.org#52958,"KEBON BESAR, BATUCEPER, KOTA TANGERANG, BANTEN",28,65,196,261
https://kawalpemilu.org#52958,"KEBON BESAR, BATUCEPER, KOTA TANGERANG, BANTEN",30,23,103,126
https://kawalpemilu.org#52958,"KEBON BESAR, BATUCEPER, KOTA TANGERANG, BANTEN",31,51,124,175
https://kawalpemilu.org#52958,"KEBON BESAR, BATUCEPER, KOTA TANGERANG, BANTEN",32,41,104,145
https://kawalpemilu.org#52958,"KEBON BESAR, BATUCEPER, KOTA TANGERANG, BANTEN",33,84,42,126
https://kawalpemilu.org#52958,"KEBON BESAR, BATUCEPER, KOTA TANGERANG, BANTEN",34,107,107,214
https://kawalpemilu.org#52958,"KEBON BESAR, BATUCEPER, KOTA TANGERANG, BANTEN",35,76,100,176
https://kawalpemilu.org#52958,"KEBON BESAR, BATUCEPER, KOTA TANGERANG, BANTEN",36,74,55,129
https://kawalpemilu.org#52958,"KEBON BESAR, BATUCEPER, KOTA TANGERANG, BANTEN",37,102,40,142
https://kawalpemilu.org#52958,"KEBON BESAR, BATUCEPER, KOTA TANGERANG, BANTEN",38,91,37,128
https://kawalpemilu.org#52958,"KEBON BESAR, BATUCEPER, KOTA TANGERANG, BANTEN",39,109,110,219
https://kawalpemilu.org#52958,"KEBON BESAR, BATUCEPER, KOTA TANGERANG, BANTEN",40,49,72,121
https://kawalpemilu.org#52958,"KEBON BESAR, BATUCEPER, KOTA TANGERANG, BANTEN",41,42,70,112
https://kawalpemilu.org#52958,"KEBON BESAR, BATUCEPER, KOTA TANGERANG, BANTEN",42,41,133,174
https://kawalpemilu.org#52958,"KEBON BESAR, BATUCEPER, KOTA TANGERANG, BANTEN",43,52,90,142
https://kawalpemilu.org#52959,"BATUSARI, BATUCEPER, KOTA TANGERANG, BANTEN",1,117,62,179
https://kawalpemilu.org#52959,"BATUSARI, BATUCEPER, KOTA TANGERANG, BANTEN",2,117,62,179
https://kawalpemilu.org#52959,"BATUSARI, BATUCEPER, KOTA TANGERANG, BANTEN",4,131,87,218
https://kawalpemilu.org#52959,"BATUSARI, BATUCEPER, KOTA TANGERANG, BANTEN",5,68,117,185
https://kawalpemilu.org#52959,"BATUSARI, BATUCEPER, KOTA TANGERANG, BANTEN",6,81,85,166
https://kawalpemilu.org#52959,"BATUSARI, BATUCEPER, KOTA TANGERANG, BANTEN",8,116,133,249
https://kawalpemilu.org#52959,"BATUSARI, BATUCEPER, KOTA TANGERANG, BANTEN",9,43,198,241
https://kawalpemilu.org#52959,"BATUSARI, BATUCEPER, KOTA TANGERANG, BANTEN",11,72,148,220
https://kawalpemilu.org#52959,"BATUSARI, BATUCEPER, KOTA TANGERANG, BANTEN",13,52,158,210
https://kawalpemilu.org#52959,"BATUSARI, BATUCEPER, KOTA TANGERANG, BANTEN",15,63,130,193
https://kawalpemilu.org#52959,"BATUSARI, BATUCEPER, KOTA TANGERANG, BANTEN",16,77,150,13
https://kawalpemilu.org#52959,"BATUSARI, BATUCEPER, KOTA TANGERANG, BANTEN",17,99,150,249
https://kawalpemilu.org#52959,"BATUSARI, BATUCEPER, KOTA TANGERANG, BANTEN",18,73,147,220
https://kawalpemilu.org#52959,"BATUSARI, BATUCEPER, KOTA TANGERANG, BANTEN",19,70,185,255
https://kawalpemilu.org#52959,"BATUSARI, BATUCEPER, KOTA TANGERANG, BANTEN",20,115,109,224
https://kawalpemilu.org#52959,"BATUSARI, BATUCEPER, KOTA TANGERANG, BANTEN",21,199,28,227
https://kawalpemilu.org#52959,"BATUSARI, BATUCEPER, KOTA TANGERANG, BANTEN",22,47,173,220
https://kawalpemilu.org#52959,"BATUSARI, BATUCEPER, KOTA TANGERANG, BANTEN",23,30,184,214
https://kawalpemilu.org#52959,"BATUSARI, BATUCEPER, KOTA TANGERANG, BANTEN",24,141,53,194
https://kawalpemilu.org#52959,"BATUSARI, BATUCEPER, KOTA TANGERANG, BANTEN",25,55,134,189
https://kawalpemilu.org#52959,"BATUSARI, BATUCEPER, KOTA TANGERANG, BANTEN",26,54,151,205
https://kawalpemilu.org#52959,"BATUSARI, BATUCEPER, KOTA TANGERANG, BANTEN",27,55,184,239
https://kawalpemilu.org#52959,"BATUSARI, BATUCEPER, KOTA TANGERANG, BANTEN",28,27,166,193
https://kawalpemilu.org#52959,"BATUSARI, BATUCEPER, KOTA TANGERANG, BANTEN",29,31,165,196
https://kawalpemilu.org#52959,"BATUSARI, BATUCEPER, KOTA TANGERANG, BANTEN",30,36,168,204
https://kawalpemilu.org#52959,"BATUSARI, BATUCEPER, KOTA TANGERANG, BANTEN",32,37,150,187
https://kawalpemilu.org#52959,"BATUSARI, BATUCEPER, KOTA TANGERANG, BANTEN",33,51,145,196
https://kawalpemilu.org#52959,"BATUSARI, BATUCEPER, KOTA TANGERANG, BANTEN",34,86,155,241
https://kawalpemilu.org#52959,"BATUSARI, BATUCEPER, KOTA TANGERANG, BANTEN",35,68,153,221
https://kawalpemilu.org#52959,"BATUSARI, BATUCEPER, KOTA TANGERANG, BANTEN",36,90,158,248
https://kawalpemilu.org#52959,"BATUSARI, BATUCEPER, KOTA TANGERANG, BANTEN",37,59,103,162
https://kawalpemilu.org#52959,"BATUSARI, BATUCEPER, KOTA TANGERANG, BANTEN",38,119,126,245
https://kawalpemilu.org#52959,"BATUSARI, BATUCEPER, KOTA TANGERANG, BANTEN",39,91,160,251
https://kawalpemilu.org#52959,"BATUSARI, BATUCEPER, KOTA TANGERANG, BANTEN",40,110,63,173
https://kawalpemilu.org#52959,"BATUSARI, BATUCEPER, KOTA TANGERANG, BANTEN",41,102,104,206
https://kawalpemilu.org#52959,"BATUSARI, BATUCEPER, KOTA TANGERANG, BANTEN",42,80,78,158
https://kawalpemilu.org#52959,"BATUSARI, BATUCEPER, KOTA TANGERANG, BANTEN",43,35,153,188
https://kawalpemilu.org#52959,"BATUSARI, BATUCEPER, KOTA TANGERANG, BANTEN",44,42,118,160
https://kawalpemilu.org#52960,"PORIS JAYA, BATUCEPER, KOTA TANGERANG, BANTEN",1,82,117,199
https://kawalpemilu.org#52960,"PORIS JAYA, BATUCEPER, KOTA TANGERANG, BANTEN",2,52,127,179
https://kawalpemilu.org#52960,"PORIS JAYA, BATUCEPER, KOTA TANGERANG, BANTEN",3,68,142,210
https://kawalpemilu.org#52960,"PORIS JAYA, BATUCEPER, KOTA TANGERANG, BANTEN",4,41,97,138
https://kawalpemilu.org#52960,"PORIS JAYA, BATUCEPER, KOTA TANGERANG, BANTEN",5,57,145,202
https://kawalpemilu.org#52960,"PORIS JAYA, BATUCEPER, KOTA TANGERANG, BANTEN",6,55,159,214
https://kawalpemilu.org#52960,"PORIS JAYA, BATUCEPER, KOTA TANGERANG, BANTEN",7,55,183,238
https://kawalpemilu.org#52960,"PORIS JAYA, BATUCEPER, KOTA TANGERANG, BANTEN",8,62,136,198
https://kawalpemilu.org#52960,"PORIS JAYA, BATUCEPER, KOTA TANGERANG, BANTEN",9,35,132,167
https://kawalpemilu.org#52960,"PORIS JAYA, BATUCEPER, KOTA TANGERANG, BANTEN",10,76,199,275
https://kawalpemilu.org#52960,"PORIS JAYA, BATUCEPER, KOTA TANGERANG, BANTEN",11,44,218,262
https://kawalpemilu.org#52960,"PORIS JAYA, BATUCEPER, KOTA TANGERANG, BANTEN",12,59,207,266
https://kawalpemilu.org#52960,"PORIS JAYA, BATUCEPER, KOTA TANGERANG, BANTEN",13,58,183,241
https://kawalpemilu.org#52960,"PORIS JAYA, BATUCEPER, KOTA TANGERANG, BANTEN",14,37,223,260
https://kawalpemilu.org#52960,"PORIS JAYA, BATUCEPER, KOTA TANGERANG, BANTEN",15,57,149,206
https://kawalpemilu.org#52960,"PORIS JAYA, BATUCEPER, KOTA TANGERANG, BANTEN",16,56,124,180
https://kawalpemilu.org#52960,"PORIS JAYA, BATUCEPER, KOTA TANGERANG, BANTEN",17,51,157,208
https://kawalpemilu.org#52960,"PORIS JAYA, BATUCEPER, KOTA TANGERANG, BANTEN",18,39,149,188
https://kawalpemilu.org#52960,"PORIS JAYA, BATUCEPER, KOTA TANGERANG, BANTEN",19,196,40,236
https://kawalpemilu.org#52960,"PORIS JAYA, BATUCEPER, KOTA TANGERANG, BANTEN",20,193,39,232
https://kawalpemilu.org#52960,"PORIS JAYA, BATUCEPER, KOTA TANGERANG, BANTEN",21,203,30,233
https://kawalpemilu.org#52960,"PORIS JAYA, BATUCEPER, KOTA TANGERANG, BANTEN",22,199,46,245
https://kawalpemilu.org#52960,"PORIS JAYA, BATUCEPER, KOTA TANGERANG, BANTEN",23,72,170,242
https://kawalpemilu.org#52960,"PORIS JAYA, BATUCEPER, KOTA TANGERANG, BANTEN",24,43,140,183
https://kawalpemilu.org#52960,"PORIS JAYA, BATUCEPER, KOTA TANGERANG, BANTEN",25,50,109,159
https://kawalpemilu.org#52960,"PORIS JAYA, BATUCEPER, KOTA TANGERANG, BANTEN",26,108,138,246
https://kawalpemilu.org#52962,"BELENDUNG, BENDA, KOTA TANGERANG, BANTEN",1,39,141,180
https://kawalpemilu.org#52962,"BELENDUNG, BENDA, KOTA TANGERANG, BANTEN",2,41,113,154
https://kawalpemilu.org#52962,"BELENDUNG, BENDA, KOTA TANGERANG, BANTEN",3,34,95,129
https://kawalpemilu.org#52962,"BELENDUNG, BENDA, KOTA TANGERANG, BANTEN",4,21,130,151
https://kawalpemilu.org#52962,"BELENDUNG, BENDA, KOTA TANGERANG, BANTEN",5,20,103,123
https://kawalpemilu.org#52962,"BELENDUNG, BENDA, KOTA TANGERANG, BANTEN",6,22,150,172
https://kawalpemilu.org#52962,"BELENDUNG, BENDA, KOTA TANGERANG, BANTEN",7,38,121,159
https://kawalpemilu.org#52962,"BELENDUNG, BENDA, KOTA TANGERANG, BANTEN",8,26,138,164
https://kawalpemilu.org#52962,"BELENDUNG, BENDA, KOTA TANGERANG, BANTEN",9,42,138,180
https://kawalpemilu.org#52962,"BELENDUNG, BENDA, KOTA TANGERANG, BANTEN",10,42,127,169
https://kawalpemilu.org#52962,"BELENDUNG, BENDA, KOTA TANGERANG, BANTEN",11,50,121,171
https://kawalpemilu.org#52962,"BELENDUNG, BENDA, KOTA TANGERANG, BANTEN",12,47,104,151
https://kawalpemilu.org#52962,"BELENDUNG, BENDA, KOTA TANGERANG, BANTEN",13,26,136,162
https://kawalpemilu.org#52962,"BELENDUNG, BENDA, KOTA TANGERANG, BANTEN",14,24,117,141
https://kawalpemilu.org#52962,"BELENDUNG, BENDA, KOTA TANGERANG, BANTEN",15,42,124,166
https://kawalpemilu.org#52962,"BELENDUNG, BENDA, KOTA TANGERANG, BANTEN",16,40,111,151
https://kawalpemilu.org#52962,"BELENDUNG, BENDA, KOTA TANGERANG, BANTEN",17,37,114,151
https://kawalpemilu.org#52962,"BELENDUNG, BENDA, KOTA TANGERANG, BANTEN",18,25,136,161
https://kawalpemilu.org#52962,"BELENDUNG, BENDA, KOTA TANGERANG, BANTEN",19,22,125,147
https://kawalpemilu.org#52962,"BELENDUNG, BENDA, KOTA TANGERANG, BANTEN",20,20,163,183
https://kawalpemilu.org#52962,"BELENDUNG, BENDA, KOTA TANGERANG, BANTEN",21,52,125,177
https://kawalpemilu.org#52962,"BELENDUNG, BENDA, KOTA TANGERANG, BANTEN",22,14,160,174
https://kawalpemilu.org#52962,"BELENDUNG, BENDA, KOTA TANGERANG, BANTEN",23,42,114,156
https://kawalpemilu.org#52962,"BELENDUNG, BENDA, KOTA TANGERANG, BANTEN",24,37,116,153
https://kawalpemilu.org#52962,"BELENDUNG, BENDA, KOTA TANGERANG, BANTEN",25,42,120,162
https://kawalpemilu.org#52962,"BELENDUNG, BENDA, KOTA TANGERANG, BANTEN",26,28,133,161
https://kawalpemilu.org#52962,"BELENDUNG, BENDA, KOTA TANGERANG, BANTEN",27,59,121,180
https://kawalpemilu.org#52962,"BELENDUNG, BENDA, KOTA TANGERANG, BANTEN",28,52,115,167
https://kawalpemilu.org#52962,"BELENDUNG, BENDA, KOTA TANGERANG, BANTEN",29,56,127,183
https://kawalpemilu.org#52962,"BELENDUNG, BENDA, KOTA TANGERANG, BANTEN",30,41,140,181
https://kawalpemilu.org#52962,"BELENDUNG, BENDA, KOTA TANGERANG, BANTEN",31,24,125,149
https://kawalpemilu.org#52962,"BELENDUNG, BENDA, KOTA TANGERANG, BANTEN",32,15,154,169
https://kawalpemilu.org#52962,"BELENDUNG, BENDA, KOTA TANGERANG, BANTEN",33,20,126,146
https://kawalpemilu.org#52962,"BELENDUNG, BENDA, KOTA TANGERANG, BANTEN",34,25,139,164
https://kawalpemilu.org#52962,"BELENDUNG, BENDA, KOTA TANGERANG, BANTEN",35,27,117,144
https://kawalpemilu.org#52962,"BELENDUNG, BENDA, KOTA TANGERANG, BANTEN",36,19,151,170
https://kawalpemilu.org#52962,"BELENDUNG, BENDA, KOTA TANGERANG, BANTEN",37,36,125,161
https://kawalpemilu.org#52962,"BELENDUNG, BENDA, KOTA TANGERANG, BANTEN",38,26,141,167
https://kawalpemilu.org#52962,"BELENDUNG, BENDA, KOTA TANGERANG, BANTEN",39,20,141,161
https://kawalpemilu.org#52962,"BELENDUNG, BENDA, KOTA TANGERANG, BANTEN",40,20,142,162
https://kawalpemilu.org#52962,"BELENDUNG, BENDA, KOTA TANGERANG, BANTEN",41,12,130,142
https://kawalpemilu.org#52962,"BELENDUNG, BENDA, KOTA TANGERANG, BANTEN",42,12,152,164
https://kawalpemilu.org#52962,"BELENDUNG, BENDA, KOTA TANGERANG, BANTEN",43,20,109,129
https://kawalpemilu.org#52962,"BELENDUNG, BENDA, KOTA TANGERANG, BANTEN",44,10,121,131
https://kawalpemilu.org#52962,"BELENDUNG, BENDA, KOTA TANGERANG, BANTEN",45,34,126,160
https://kawalpemilu.org#52962,"BELENDUNG, BENDA, KOTA TANGERANG, BANTEN",46,13,105,118
https://kawalpemilu.org#52962,"BELENDUNG, BENDA, KOTA TANGERANG, BANTEN",47,31,114,145
https://kawalpemilu.org#52962,"BELENDUNG, BENDA, KOTA TANGERANG, BANTEN",48,40,121,161
https://kawalpemilu.org#52962,"BELENDUNG, BENDA, KOTA TANGERANG, BANTEN",49,40,114,154
https://kawalpemilu.org#52962,"BELENDUNG, BENDA, KOTA TANGERANG, BANTEN",50,41,116,157
https://kawalpemilu.org#52962,"BELENDUNG, BENDA, KOTA TANGERANG, BANTEN",51,38,129,167
https://kawalpemilu.org#52962,"BELENDUNG, BENDA, KOTA TANGERANG, BANTEN",52,33,134,167
https://kawalpemilu.org#52962,"BELENDUNG, BENDA, KOTA TANGERANG, BANTEN",53,35,136,171
https://kawalpemilu.org#52962,"BELENDUNG, BENDA, KOTA TANGERANG, BANTEN",54,33,141,174
https://kawalpemilu.org#52962,"BELENDUNG, BENDA, KOTA TANGERANG, BANTEN",55,63,116,179
https://kawalpemilu.org#52962,"BELENDUNG, BENDA, KOTA TANGERANG, BANTEN",56,70,118,188
https://kawalpemilu.org#52962,"BELENDUNG, BENDA, KOTA TANGERANG, BANTEN",58,70,107,177
https://kawalpemilu.org#52962,"BELENDUNG, BENDA, KOTA TANGERANG, BANTEN",59,117,79,196
https://kawalpemilu.org#52962,"BELENDUNG, BENDA, KOTA TANGERANG, BANTEN",60,43,127,170
https://kawalpemilu.org#52962,"BELENDUNG, BENDA, KOTA TANGERANG, BANTEN",61,58,124,182
https://kawalpemilu.org#52962,"BELENDUNG, BENDA, KOTA TANGERANG, BANTEN",62,45,125,170
https://kawalpemilu.org#52962,"BELENDUNG, BENDA, KOTA TANGERANG, BANTEN",63,41,134,175
https://kawalpemilu.org#52962,"BELENDUNG, BENDA, KOTA TANGERANG, BANTEN",64,27,126,153
https://kawalpemilu.org#52962,"BELENDUNG, BENDA, KOTA TANGERANG, BANTEN",65,34,120,154
https://kawalpemilu.org#52962,"BELENDUNG, BENDA, KOTA TANGERANG, BANTEN",66,26,117,143
https://kawalpemilu.org#52962,"BELENDUNG, BENDA, KOTA TANGERANG, BANTEN",67,29,122,151
https://kawalpemilu.org#52962,"BELENDUNG, BENDA, KOTA TANGERANG, BANTEN",68,34,137,171
https://kawalpemilu.org#52962,"BELENDUNG, BENDA, KOTA TANGERANG, BANTEN",69,25,124,149
https://kawalpemilu.org#52962,"BELENDUNG, BENDA, KOTA TANGERANG, BANTEN",70,32,101,133
https://kawalpemilu.org#52962,"BELENDUNG, BENDA, KOTA TANGERANG, BANTEN",71,59,108,167
https://kawalpemilu.org#52962,"BELENDUNG, BENDA, KOTA TANGERANG, BANTEN",72,52,108,160
https://kawalpemilu.org#52962,"BELENDUNG, BENDA, KOTA TANGERANG, BANTEN",73,46,111,157
https://kawalpemilu.org#52962,"BELENDUNG, BENDA, KOTA TANGERANG, BANTEN",74,67,116,183
https://kawalpemilu.org#52962,"BELENDUNG, BENDA, KOTA TANGERANG, BANTEN",75,52,91,143
https://kawalpemilu.org#52962,"BELENDUNG, BENDA, KOTA TANGERANG, BANTEN",76,36,129,165
https://kawalpemilu.org#52962,"BELENDUNG, BENDA, KOTA TANGERANG, BANTEN",77,52,105,157
https://kawalpemilu.org#52962,"BELENDUNG, BENDA, KOTA TANGERANG, BANTEN",78,182,37,219
https://kawalpemilu.org#52962,"BELENDUNG, BENDA, KOTA TANGERANG, BANTEN",79,179,34,213
https://kawalpemilu.org#52962,"BELENDUNG, BENDA, KOTA TANGERANG, BANTEN",80,170,27,197
https://kawalpemilu.org#52963,"JURUMUDI, BENDA, KOTA TANGERANG, BANTEN",1,37,107,144
https://kawalpemilu.org#52963,"JURUMUDI, BENDA, KOTA TANGERANG, BANTEN",2,57,115,172
https://kawalpemilu.org#52963,"JURUMUDI, BENDA, KOTA TANGERANG, BANTEN",3,69,129,198
https://kawalpemilu.org#52963,"JURUMUDI, BENDA, KOTA TANGERANG, BANTEN",4,56,133,189
https://kawalpemilu.org#52963,"JURUMUDI, BENDA, KOTA TANGERANG, BANTEN",5,68,118,186
https://kawalpemilu.org#52963,"JURUMUDI, BENDA, KOTA TANGERANG, BANTEN",6,64,149,213
https://kawalpemilu.org#52963,"JURUMUDI, BENDA, KOTA TANGERANG, BANTEN",7,66,111,177
https://kawalpemilu.org#52963,"JURUMUDI, BENDA, KOTA TANGERANG, BANTEN",8,63,126,189
https://kawalpemilu.org#52963,"JURUMUDI, BENDA, KOTA TANGERANG, BANTEN",9,64,142,206
https://kawalpemilu.org#52963,"JURUMUDI, BENDA, KOTA TANGERANG, BANTEN",10,68,113,181
https://kawalpemilu.org#52963,"JURUMUDI, BENDA, KOTA TANGERANG, BANTEN",11,44,142,186
https://kawalpemilu.org#52963,"JURUMUDI, BENDA, KOTA TANGERANG, BANTEN",12,50,125,175
https://kawalpemilu.org#52963,"JURUMUDI, BENDA, KOTA TANGERANG, BANTEN",13,45,89,134
https://kawalpemilu.org#52963,"JURUMUDI, BENDA, KOTA TANGERANG, BANTEN",14,32,115,147
https://kawalpemilu.org#52963,"JURUMUDI, BENDA, KOTA TANGERANG, BANTEN",15,73,108,181
https://kawalpemilu.org#52963,"JURUMUDI, BENDA, KOTA TANGERANG, BANTEN",16,53,123,176
https://kawalpemilu.org#52963,"JURUMUDI, BENDA, KOTA TANGERANG, BANTEN",17,33,83,116
https://kawalpemilu.org#52963,"JURUMUDI, BENDA, KOTA TANGERANG, BANTEN",18,62,113,175
https://kawalpemilu.org#52963,"JURUMUDI, BENDA, KOTA TANGERANG, BANTEN",19,53,133,186
https://kawalpemilu.org#52963,"JURUMUDI, BENDA, KOTA TANGERANG, BANTEN",20,85,106,191
https://kawalpemilu.org#52963,"JURUMUDI, BENDA, KOTA TANGERANG, BANTEN",21,32,151,183
https://kawalpemilu.org#52963,"JURUMUDI, BENDA, KOTA TANGERANG, BANTEN",22,47,147,194
https://kawalpemilu.org#52963,"JURUMUDI, BENDA, KOTA TANGERANG, BANTEN",23,53,116,169
https://kawalpemilu.org#52963,"JURUMUDI, BENDA, KOTA TANGERANG, BANTEN",24,69,129,198
https://kawalpemilu.org#52963,"JURUMUDI, BENDA, KOTA TANGERANG, BANTEN",25,48,121,169
https://kawalpemilu.org#52963,"JURUMUDI, BENDA, KOTA TANGERANG, BANTEN",26,80,129,209
https://kawalpemilu.org#52963,"JURUMUDI, BENDA, KOTA TANGERANG, BANTEN",27,74,125,199
https://kawalpemilu.org#52963,"JURUMUDI, BENDA, KOTA TANGERANG, BANTEN",28,157,11,168
https://kawalpemilu.org#52963,"JURUMUDI, BENDA, KOTA TANGERANG, BANTEN",29,148,14,162
https://kawalpemilu.org#52963,"JURUMUDI, BENDA, KOTA TANGERANG, BANTEN",30,182,15,197
https://kawalpemilu.org#52963,"JURUMUDI, BENDA, KOTA TANGERANG, BANTEN",31,51,187,238
https://kawalpemilu.org#52963,"JURUMUDI, BENDA, KOTA TANGERANG, BANTEN",32,66,176,242
https://kawalpemilu.org#52963,"JURUMUDI, BENDA, KOTA TANGERANG, BANTEN",33,55,120,175
https://kawalpemilu.org#52963,"JURUMUDI, BENDA, KOTA TANGERANG, BANTEN",34,67,169,236
https://kawalpemilu.org#52963,"JURUMUDI, BENDA, KOTA TANGERANG, BANTEN",35,76,131,207
https://kawalpemilu.org#52963,"JURUMUDI, BENDA, KOTA TANGERANG, BANTEN",36,81,150,231
https://kawalpemilu.org#52963,"JURUMUDI, BENDA, KOTA TANGERANG, BANTEN",37,97,113,210
https://kawalpemilu.org#52963,"JURUMUDI, BENDA, KOTA TANGERANG, BANTEN",38,114,76,190
https://kawalpemilu.org#52963,"JURUMUDI, BENDA, KOTA TANGERANG, BANTEN",39,39,150,189
https://kawalpemilu.org#52963,"JURUMUDI, BENDA, KOTA TANGERANG, BANTEN",40,28,157,185
https://kawalpemilu.org#52963,"JURUMUDI, BENDA, KOTA TANGERANG, BANTEN",41,71,123,194
https://kawalpemilu.org#52963,"JURUMUDI, BENDA, KOTA TANGERANG, BANTEN",42,74,74,148
https://kawalpemilu.org#52963,"JURUMUDI, BENDA, KOTA TANGERANG, BANTEN",43,74,79,153
https://kawalpemilu.org#52963,"JURUMUDI, BENDA, KOTA TANGERANG, BANTEN",44,74,117,191
https://kawalpemilu.org#52963,"JURUMUDI, BENDA, KOTA TANGERANG, BANTEN",45,65,119,184
https://kawalpemilu.org#52963,"JURUMUDI, BENDA, KOTA TANGERANG, BANTEN",46,60,107,167
https://kawalpemilu.org#52963,"JURUMUDI, BENDA, KOTA TANGERANG, BANTEN",47,148,50,198
https://kawalpemilu.org#52963,"JURUMUDI, BENDA, KOTA TANGERANG, BANTEN",48,150,40,190
https://kawalpemilu.org#52963,"JURUMUDI, BENDA, KOTA TANGERANG, BANTEN",49,58,145,203
https://kawalpemilu.org#52963,"JURUMUDI, BENDA, KOTA TANGERANG, BANTEN",50,71,136,207
https://kawalpemilu.org#52963,"JURUMUDI, BENDA, KOTA TANGERANG, BANTEN",51,85,89,174
https://kawalpemilu.org#52963,"JURUMUDI, BENDA, KOTA TANGERANG, BANTEN",52,63,109,172
https://kawalpemilu.org#52963,"JURUMUDI, BENDA, KOTA TANGERANG, BANTEN",53,48,86,134
https://kawalpemilu.org#52963,"JURUMUDI, BENDA, KOTA TANGERANG, BANTEN",54,148,42,190
https://kawalpemilu.org#52963,"JURUMUDI, BENDA, KOTA TANGERANG, BANTEN",55,68,82,150
https://kawalpemilu.org#52963,"JURUMUDI, BENDA, KOTA TANGERANG, BANTEN",56,54,115,169
https://kawalpemilu.org#52964,"BENDA, BENDA, KOTA TANGERANG, BANTEN",2,102,71,173
https://kawalpemilu.org#52964,"BENDA, BENDA, KOTA TANGERANG, BANTEN",4,103,81,184
https://kawalpemilu.org#52964,"BENDA, BENDA, KOTA TANGERANG, BANTEN",5,74,113,187
https://kawalpemilu.org#52964,"BENDA, BENDA, KOTA TANGERANG, BANTEN",6,62,133,195
https://kawalpemilu.org#52964,"BENDA, BENDA, KOTA TANGERANG, BANTEN",7,77,130,207
https://kawalpemilu.org#52964,"BENDA, BENDA, KOTA TANGERANG, BANTEN",8,37,158,195
https://kawalpemilu.org#52964,"BENDA, BENDA, KOTA TANGERANG, BANTEN",9,59,87,146
https://kawalpemilu.org#52964,"BENDA, BENDA, KOTA TANGERANG, BANTEN",10,109,94,203
https://kawalpemilu.org#52964,"BENDA, BENDA, KOTA TANGERANG, BANTEN",12,187,15,202
https://kawalpemilu.org#52964,"BENDA, BENDA, KOTA TANGERANG, BANTEN",13,113,70,183
https://kawalpemilu.org#52964,"BENDA, BENDA, KOTA TANGERANG, BANTEN",14,92,120,212
https://kawalpemilu.org#52964,"BENDA, BENDA, KOTA TANGERANG, BANTEN",15,74,92,166
https://kawalpemilu.org#52964,"BENDA, BENDA, KOTA TANGERANG, BANTEN",17,71,76,147
https://kawalpemilu.org#52964,"BENDA, BENDA, KOTA TANGERANG, BANTEN",18,66,100,166
https://kawalpemilu.org#52964,"BENDA, BENDA, KOTA TANGERANG, BANTEN",19,63,105,168
https://kawalpemilu.org#52964,"BENDA, BENDA, KOTA TANGERANG, BANTEN",20,61,110,171
https://kawalpemilu.org#52964,"BENDA, BENDA, KOTA TANGERANG, BANTEN",21,80,110,190
https://kawalpemilu.org#52964,"BENDA, BENDA, KOTA TANGERANG, BANTEN",25,93,159,252
https://kawalpemilu.org#52964,"BENDA, BENDA, KOTA TANGERANG, BANTEN",26,82,154,236
https://kawalpemilu.org#52964,"BENDA, BENDA, KOTA TANGERANG, BANTEN",29,64,141,205
https://kawalpemilu.org#52964,"BENDA, BENDA, KOTA TANGERANG, BANTEN",30,198,24,222
https://kawalpemilu.org#52964,"BENDA, BENDA, KOTA TANGERANG, BANTEN",31,44,123,167
https://kawalpemilu.org#52964,"BENDA, BENDA, KOTA TANGERANG, BANTEN",32,60,136,196
https://kawalpemilu.org#52964,"BENDA, BENDA, KOTA TANGERANG, BANTEN",34,57,102,159
https://kawalpemilu.org#52964,"BENDA, BENDA, KOTA TANGERANG, BANTEN",35,59,133,192
https://kawalpemilu.org#52965,"PAJANG, BENDA, KOTA TANGERANG, BANTEN",1,40,116,156
https://kawalpemilu.org#52965,"PAJANG, BENDA, KOTA TANGERANG, BANTEN",2,80,110,190
https://kawalpemilu.org#52965,"PAJANG, BENDA, KOTA TANGERANG, BANTEN",4,55,96,151
https://kawalpemilu.org#52965,"PAJANG, BENDA, KOTA TANGERANG, BANTEN",5,51,96,147
https://kawalpemilu.org#52965,"PAJANG, BENDA, KOTA TANGERANG, BANTEN",6,47,82,129
https://kawalpemilu.org#52965,"PAJANG, BENDA, KOTA TANGERANG, BANTEN",7,40,94,134
https://kawalpemilu.org#52965,"PAJANG, BENDA, KOTA TANGERANG, BANTEN",8,57,88,145
https://kawalpemilu.org#52965,"PAJANG, BENDA, KOTA TANGERANG, BANTEN",9,50,112,162
https://kawalpemilu.org#52965,"PAJANG, BENDA, KOTA TANGERANG, BANTEN",10,67,86,153
https://kawalpemilu.org#52965,"PAJANG, BENDA, KOTA TANGERANG, BANTEN",11,74,71,145
https://kawalpemilu.org#52965,"PAJANG, BENDA, KOTA TANGERANG, BANTEN",12,79,84,163
https://kawalpemilu.org#52965,"PAJANG, BENDA, KOTA TANGERANG, BANTEN",13,93,91,184
https://kawalpemilu.org#52965,"PAJANG, BENDA, KOTA TANGERANG, BANTEN",14,64,98,162
https://kawalpemilu.org#52965,"PAJANG, BENDA, KOTA TANGERANG, BANTEN",15,102,119,221
https://kawalpemilu.org#52965,"PAJANG, BENDA, KOTA TANGERANG, BANTEN",16,165,9,174
https://kawalpemilu.org#52965,"PAJANG, BENDA, KOTA TANGERANG, BANTEN",18,112,86,198
https://kawalpemilu.org#52965,"PAJANG, BENDA, KOTA TANGERANG, BANTEN",19,39,93,132
https://kawalpemilu.org#52965,"PAJANG, BENDA, KOTA TANGERANG, BANTEN",21,63,135,198
https://kawalpemilu.org#52965,"PAJANG, BENDA, KOTA TANGERANG, BANTEN",22,79,109,188
https://kawalpemilu.org#52965,"PAJANG, BENDA, KOTA TANGERANG, BANTEN",23,63,125,188
https://kawalpemilu.org#52965,"PAJANG, BENDA, KOTA TANGERANG, BANTEN",24,62,158,220
https://kawalpemilu.org#52965,"PAJANG, BENDA, KOTA TANGERANG, BANTEN",25,39,123,162
https://kawalpemilu.org#52965,"PAJANG, BENDA, KOTA TANGERANG, BANTEN",26,62,113,175
https://kawalpemilu.org#52965,"PAJANG, BENDA, KOTA TANGERANG, BANTEN",27,51,97,148
https://kawalpemilu.org#52965,"PAJANG, BENDA, KOTA TANGERANG, BANTEN",28,52,60,112
https://kawalpemilu.org#52965,"PAJANG, BENDA, KOTA TANGERANG, BANTEN",29,55,89,144
https://kawalpemilu.org#52965,"PAJANG, BENDA, KOTA TANGERANG, BANTEN",30,50,101,151
https://kawalpemilu.org#52965,"PAJANG, BENDA, KOTA TANGERANG, BANTEN",31,33,64,97
https://kawalpemilu.org#52965,"PAJANG, BENDA, KOTA TANGERANG, BANTEN",32,32,55,87
https://kawalpemilu.org#52965,"PAJANG, BENDA, KOTA TANGERANG, BANTEN",33,55,118,173
https://kawalpemilu.org#52965,"PAJANG, BENDA, KOTA TANGERANG, BANTEN",34,59,133,192
https://kawalpemilu.org#52965,"PAJANG, BENDA, KOTA TANGERANG, BANTEN",35,12,17,29
https://kawalpemilu.org#52966,"JURUMUDI BARU, BENDA, KOTA TANGERANG, BANTEN",1,37,145,182
https://kawalpemilu.org#52966,"JURUMUDI BARU, BENDA, KOTA TANGERANG, BANTEN",2,40,132,172
https://kawalpemilu.org#52966,"JURUMUDI BARU, BENDA, KOTA TANGERANG, BANTEN",3,52,137,189
https://kawalpemilu.org#52966,"JURUMUDI BARU, BENDA, KOTA TANGERANG, BANTEN",4,55,114,169
https://kawalpemilu.org#52966,"JURUMUDI BARU, BENDA, KOTA TANGERANG, BANTEN",5,35,141,176
https://kawalpemilu.org#52966,"JURUMUDI BARU, BENDA, KOTA TANGERANG, BANTEN",6,21,109,130
https://kawalpemilu.org#52966,"JURUMUDI BARU, BENDA, KOTA TANGERANG, BANTEN",8,44,88,132
https://kawalpemilu.org#52966,"JURUMUDI BARU, BENDA, KOTA TANGERANG, BANTEN",9,74,127,201
https://kawalpemilu.org#52966,"JURUMUDI BARU, BENDA, KOTA TANGERANG, BANTEN",11,32,137,169
https://kawalpemilu.org#52966,"JURUMUDI BARU, BENDA, KOTA TANGERANG, BANTEN",12,46,101,147
https://kawalpemilu.org#52966,"JURUMUDI BARU, BENDA, KOTA TANGERANG, BANTEN",14,69,116,185
https://kawalpemilu.org#52966,"JURUMUDI BARU, BENDA, KOTA TANGERANG, BANTEN",15,56,86,142
https://kawalpemilu.org#52966,"JURUMUDI BARU, BENDA, KOTA TANGERANG, BANTEN",16,40,82,0
https://kawalpemilu.org#52966,"JURUMUDI BARU, BENDA, KOTA TANGERANG, BANTEN",17,37,131,168
https://kawalpemilu.org#52966,"JURUMUDI BARU, BENDA, KOTA TANGERANG, BANTEN",19,36,134,170
https://kawalpemilu.org#52966,"JURUMUDI BARU, BENDA, KOTA TANGERANG, BANTEN",20,37,104,141
https://kawalpemilu.org#52966,"JURUMUDI BARU, BENDA, KOTA TANGERANG, BANTEN",21,45,105,150
https://kawalpemilu.org#52966,"JURUMUDI BARU, BENDA, KOTA TANGERANG, BANTEN",22,60,61,121
https://kawalpemilu.org#52966,"JURUMUDI BARU, BENDA, KOTA TANGERANG, BANTEN",24,76,90,166
https://kawalpemilu.org#52966,"JURUMUDI BARU, BENDA, KOTA TANGERANG, BANTEN",25,88,61,149
https://kawalpemilu.org#52966,"JURUMUDI BARU, BENDA, KOTA TANGERANG, BANTEN",26,66,72,138
https://kawalpemilu.org#52966,"JURUMUDI BARU, BENDA, KOTA TANGERANG, BANTEN",27,34,129,163
https://kawalpemilu.org#52966,"JURUMUDI BARU, BENDA, KOTA TANGERANG, BANTEN",28,44,106,150
https://kawalpemilu.org#52966,"JURUMUDI BARU, BENDA, KOTA TANGERANG, BANTEN",29,52,92,144
https://kawalpemilu.org#52966,"JURUMUDI BARU, BENDA, KOTA TANGERANG, BANTEN",30,72,84,156
https://kawalpemilu.org#52966,"JURUMUDI BARU, BENDA, KOTA TANGERANG, BANTEN",31,75,86,161
https://kawalpemilu.org#52966,"JURUMUDI BARU, BENDA, KOTA TANGERANG, BANTEN",33,66,124,190
https://kawalpemilu.org#52966,"JURUMUDI BARU, BENDA, KOTA TANGERANG, BANTEN",34,50,112,162
https://kawalpemilu.org#52966,"JURUMUDI BARU, BENDA, KOTA TANGERANG, BANTEN",35,52,101,153
https://kawalpemilu.org#52966,"JURUMUDI BARU, BENDA, KOTA TANGERANG, BANTEN",36,43,121,164
https://kawalpemilu.org#52966,"JURUMUDI BARU, BENDA, KOTA TANGERANG, BANTEN",37,65,90,155
https://kawalpemilu.org#52966,"JURUMUDI BARU, BENDA, KOTA TANGERANG, BANTEN",39,47,80,127
https://kawalpemilu.org#52966,"JURUMUDI BARU, BENDA, KOTA TANGERANG, BANTEN",40,41,78,119
https://kawalpemilu.org#52966,"JURUMUDI BARU, BENDA, KOTA TANGERANG, BANTEN",41,66,97,163
https://kawalpemilu.org#52966,"JURUMUDI BARU, BENDA, KOTA TANGERANG, BANTEN",42,64,107,171
https://kawalpemilu.org#52966,"JURUMUDI BARU, BENDA, KOTA TANGERANG, BANTEN",43,63,71,134
https://kawalpemilu.org#52966,"JURUMUDI BARU, BENDA, KOTA TANGERANG, BANTEN",47,55,87,142
https://kawalpemilu.org#52966,"JURUMUDI BARU, BENDA, KOTA TANGERANG, BANTEN",48,54,108,162
https://kawalpemilu.org#52966,"JURUMUDI BARU, BENDA, KOTA TANGERANG, BANTEN",49,52,87,139
https://kawalpemilu.org#52966,"JURUMUDI BARU, BENDA, KOTA TANGERANG, BANTEN",50,84,108,192
https://kawalpemilu.org#52966,"JURUMUDI BARU, BENDA, KOTA TANGERANG, BANTEN",51,70,88,158
https://kawalpemilu.org#52966,"JURUMUDI BARU, BENDA, KOTA TANGERANG, BANTEN",52,94,114,208
https://kawalpemilu.org#52966,"JURUMUDI BARU, BENDA, KOTA TANGERANG, BANTEN",53,105,98,203
https://kawalpemilu.org#52966,"JURUMUDI BARU, BENDA, KOTA TANGERANG, BANTEN",54,67,58,125
https://kawalpemilu.org#52966,"JURUMUDI BARU, BENDA, KOTA TANGERANG, BANTEN",55,71,51,122
https://kawalpemilu.org#52966,"JURUMUDI BARU, BENDA, KOTA TANGERANG, BANTEN",56,171,10,181
https://kawalpemilu.org#52966,"JURUMUDI BARU, BENDA, KOTA TANGERANG, BANTEN",57,168,10,178
https://kawalpemilu.org#52966,"JURUMUDI BARU, BENDA, KOTA TANGERANG, BANTEN",58,186,1,187
https://kawalpemilu.org#52966,"JURUMUDI BARU, BENDA, KOTA TANGERANG, BANTEN",59,166,3,169
https://kawalpemilu.org#52966,"JURUMUDI BARU, BENDA, KOTA TANGERANG, BANTEN",60,162,7,169
https://kawalpemilu.org#52966,"JURUMUDI BARU, BENDA, KOTA TANGERANG, BANTEN",62,156,5,161
https://kawalpemilu.org#52966,"JURUMUDI BARU, BENDA, KOTA TANGERANG, BANTEN",63,169,8,177
https://kawalpemilu.org#52966,"JURUMUDI BARU, BENDA, KOTA TANGERANG, BANTEN",64,147,14,161
https://kawalpemilu.org#52966,"JURUMUDI BARU, BENDA, KOTA TANGERANG, BANTEN",65,140,5,145
https://kawalpemilu.org#52966,"JURUMUDI BARU, BENDA, KOTA TANGERANG, BANTEN",66,116,5,121
https://kawalpemilu.org#52966,"JURUMUDI BARU, BENDA, KOTA TANGERANG, BANTEN",67,121,8,129
https://kawalpemilu.org#52966,"JURUMUDI BARU, BENDA, KOTA TANGERANG, BANTEN",68,108,5,113
https://kawalpemilu.org#52966,"JURUMUDI BARU, BENDA, KOTA TANGERANG, BANTEN",69,134,9,143
https://kawalpemilu.org#52966,"JURUMUDI BARU, BENDA, KOTA TANGERANG, BANTEN",71,81,78,159
https://kawalpemilu.org#52966,"JURUMUDI BARU, BENDA, KOTA TANGERANG, BANTEN",72,75,75,150
https://kawalpemilu.org#52966,"JURUMUDI BARU, BENDA, KOTA TANGERANG, BANTEN",73,72,84,156
https://kawalpemilu.org#52968,"CIPONDOH, CIPONDOH, KOTA TANGERANG, BANTEN",2,81,173,254
https://kawalpemilu.org#52968,"CIPONDOH, CIPONDOH, KOTA TANGERANG, BANTEN",3,81,161,242
https://kawalpemilu.org#52968,"CIPONDOH, CIPONDOH, KOTA TANGERANG, BANTEN",4,76,144,220
https://kawalpemilu.org#52968,"CIPONDOH, CIPONDOH, KOTA TANGERANG, BANTEN",5,55,191,246
https://kawalpemilu.org#52968,"CIPONDOH, CIPONDOH, KOTA TANGERANG, BANTEN",6,78,123,201
https://kawalpemilu.org#52968,"CIPONDOH, CIPONDOH, KOTA TANGERANG, BANTEN",7,76,115,191
https://kawalpemilu.org#52968,"CIPONDOH, CIPONDOH, KOTA TANGERANG, BANTEN",8,50,121,171
https://kawalpemilu.org#52968,"CIPONDOH, CIPONDOH, KOTA TANGERANG, BANTEN",9,95,185,280
https://kawalpemilu.org#52968,"CIPONDOH, CIPONDOH, KOTA TANGERANG, BANTEN",10,81,157,238
https://kawalpemilu.org#52968,"CIPONDOH, CIPONDOH, KOTA TANGERANG, BANTEN",11,72,155,227
https://kawalpemilu.org#52968,"CIPONDOH, CIPONDOH, KOTA TANGERANG, BANTEN",12,77,139,216
https://kawalpemilu.org#52968,"CIPONDOH, CIPONDOH, KOTA TANGERANG, BANTEN",13,116,153,269
https://kawalpemilu.org#52968,"CIPONDOH, CIPONDOH, KOTA TANGERANG, BANTEN",14,78,158,236
https://kawalpemilu.org#52968,"CIPONDOH, CIPONDOH, KOTA TANGERANG, BANTEN",15,53,181,234
https://kawalpemilu.org#52968,"CIPONDOH, CIPONDOH, KOTA TANGERANG, BANTEN",16,87,151,238
https://kawalpemilu.org#52968,"CIPONDOH, CIPONDOH, KOTA TANGERANG, BANTEN",17,66,187,253
https://kawalpemilu.org#52968,"CIPONDOH, CIPONDOH, KOTA TANGERANG, BANTEN",18,71,151,222
https://kawalpemilu.org#52968,"CIPONDOH, CIPONDOH, KOTA TANGERANG, BANTEN",19,58,159,217
https://kawalpemilu.org#52968,"CIPONDOH, CIPONDOH, KOTA TANGERANG, BANTEN",20,66,213,279
https://kawalpemilu.org#52968,"CIPONDOH, CIPONDOH, KOTA TANGERANG, BANTEN",21,93,170,263
https://kawalpemilu.org#52968,"CIPONDOH, CIPONDOH, KOTA TANGERANG, BANTEN",22,29,215,244
https://kawalpemilu.org#52968,"CIPONDOH, CIPONDOH, KOTA TANGERANG, BANTEN",23,51,140,191
https://kawalpemilu.org#52968,"CIPONDOH, CIPONDOH, KOTA TANGERANG, BANTEN",24,35,151,186
https://kawalpemilu.org#52968,"CIPONDOH, CIPONDOH, KOTA TANGERANG, BANTEN",25,51,203,254
https://kawalpemilu.org#52968,"CIPONDOH, CIPONDOH, KOTA TANGERANG, BANTEN",26,57,178,235
https://kawalpemilu.org#52968,"CIPONDOH, CIPONDOH, KOTA TANGERANG, BANTEN",27,84,146,230
https://kawalpemilu.org#52968,"CIPONDOH, CIPONDOH, KOTA TANGERANG, BANTEN",28,30,126,156
https://kawalpemilu.org#52968,"CIPONDOH, CIPONDOH, KOTA TANGERANG, BANTEN",29,61,156,217
https://kawalpemilu.org#52968,"CIPONDOH, CIPONDOH, KOTA TANGERANG, BANTEN",30,56,109,165
https://kawalpemilu.org#52968,"CIPONDOH, CIPONDOH, KOTA TANGERANG, BANTEN",31,62,99,161
https://kawalpemilu.org#52968,"CIPONDOH, CIPONDOH, KOTA TANGERANG, BANTEN",32,90,129,219
https://kawalpemilu.org#52968,"CIPONDOH, CIPONDOH, KOTA TANGERANG, BANTEN",33,80,112,192
https://kawalpemilu.org#52968,"CIPONDOH, CIPONDOH, KOTA TANGERANG, BANTEN",34,87,90,177
https://kawalpemilu.org#52968,"CIPONDOH, CIPONDOH, KOTA TANGERANG, BANTEN",35,54,88,142
https://kawalpemilu.org#52968,"CIPONDOH, CIPONDOH, KOTA TANGERANG, BANTEN",36,88,112,200
https://kawalpemilu.org#52968,"CIPONDOH, CIPONDOH, KOTA TANGERANG, BANTEN",37,104,102,206
https://kawalpemilu.org#52968,"CIPONDOH, CIPONDOH, KOTA TANGERANG, BANTEN",38,98,71,169
https://kawalpemilu.org#52968,"CIPONDOH, CIPONDOH, KOTA TANGERANG, BANTEN",39,78,97,175
https://kawalpemilu.org#52968,"CIPONDOH, CIPONDOH, KOTA TANGERANG, BANTEN",40,117,110,227
https://kawalpemilu.org#52968,"CIPONDOH, CIPONDOH, KOTA TANGERANG, BANTEN",41,54,127,181
https://kawalpemilu.org#52968,"CIPONDOH, CIPONDOH, KOTA TANGERANG, BANTEN",42,102,92,194
https://kawalpemilu.org#52968,"CIPONDOH, CIPONDOH, KOTA TANGERANG, BANTEN",43,111,171,282
https://kawalpemilu.org#52968,"CIPONDOH, CIPONDOH, KOTA TANGERANG, BANTEN",44,78,155,233
https://kawalpemilu.org#52968,"CIPONDOH, CIPONDOH, KOTA TANGERANG, BANTEN",45,78,135,213
https://kawalpemilu.org#52968,"CIPONDOH, CIPONDOH, KOTA TANGERANG, BANTEN",46,70,127,197
https://kawalpemilu.org#52968,"CIPONDOH, CIPONDOH, KOTA TANGERANG, BANTEN",47,87,79,166
https://kawalpemilu.org#52968,"CIPONDOH, CIPONDOH, KOTA TANGERANG, BANTEN",48,106,90,196
https://kawalpemilu.org#52968,"CIPONDOH, CIPONDOH, KOTA TANGERANG, BANTEN",49,146,115,261
https://kawalpemilu.org#52968,"CIPONDOH, CIPONDOH, KOTA TANGERANG, BANTEN",50,113,135,248
https://kawalpemilu.org#52968,"CIPONDOH, CIPONDOH, KOTA TANGERANG, BANTEN",51,104,136,240
https://kawalpemilu.org#52968,"CIPONDOH, CIPONDOH, KOTA TANGERANG, BANTEN",52,126,147,273
https://kawalpemilu.org#52968,"CIPONDOH, CIPONDOH, KOTA TANGERANG, BANTEN",53,108,178,286
https://kawalpemilu.org#52968,"CIPONDOH, CIPONDOH, KOTA TANGERANG, BANTEN",54,114,162,276
https://kawalpemilu.org#52968,"CIPONDOH, CIPONDOH, KOTA TANGERANG, BANTEN",55,122,158,280
https://kawalpemilu.org#52968,"CIPONDOH, CIPONDOH, KOTA TANGERANG, BANTEN",56,57,105,162
https://kawalpemilu.org#52968,"CIPONDOH, CIPONDOH, KOTA TANGERANG, BANTEN",57,62,171,233
https://kawalpemilu.org#52968,"CIPONDOH, CIPONDOH, KOTA TANGERANG, BANTEN",58,66,141,207
https://kawalpemilu.org#52968,"CIPONDOH, CIPONDOH, KOTA TANGERANG, BANTEN",59,54,76,130
https://kawalpemilu.org#52968,"CIPONDOH, CIPONDOH, KOTA TANGERANG, BANTEN",60,54,101,155
https://kawalpemilu.org#52968,"CIPONDOH, CIPONDOH, KOTA TANGERANG, BANTEN",61,132,134,266
https://kawalpemilu.org#52968,"CIPONDOH, CIPONDOH, KOTA TANGERANG, BANTEN",62,120,148,268
https://kawalpemilu.org#52968,"CIPONDOH, CIPONDOH, KOTA TANGERANG, BANTEN",63,45,148,193
https://kawalpemilu.org#52968,"CIPONDOH, CIPONDOH, KOTA TANGERANG, BANTEN",64,41,202,243
https://kawalpemilu.org#52968,"CIPONDOH, CIPONDOH, KOTA TANGERANG, BANTEN",65,61,140,201
https://kawalpemilu.org#52968,"CIPONDOH, CIPONDOH, KOTA TANGERANG, BANTEN",66,59,106,165
https://kawalpemilu.org#52969,"CIPONDOH MAKMUR, CIPONDOH, KOTA TANGERANG, BANTEN",1,36,220,256
https://kawalpemilu.org#52969,"CIPONDOH MAKMUR, CIPONDOH, KOTA TANGERANG, BANTEN",2,45,185,230
https://kawalpemilu.org#52969,"CIPONDOH MAKMUR, CIPONDOH, KOTA TANGERANG, BANTEN",3,75,173,248
https://kawalpemilu.org#52969,"CIPONDOH MAKMUR, CIPONDOH, KOTA TANGERANG, BANTEN",4,50,183,233
https://kawalpemilu.org#52969,"CIPONDOH MAKMUR, CIPONDOH, KOTA TANGERANG, BANTEN",5,53,149,202
https://kawalpemilu.org#52969,"CIPONDOH MAKMUR, CIPONDOH, KOTA TANGERANG, BANTEN",6,39,119,158
https://kawalpemilu.org#52969,"CIPONDOH MAKMUR, CIPONDOH, KOTA TANGERANG, BANTEN",7,33,127,160
https://kawalpemilu.org#52969,"CIPONDOH MAKMUR, CIPONDOH, KOTA TANGERANG, BANTEN",8,40,110,150
https://kawalpemilu.org#52969,"CIPONDOH MAKMUR, CIPONDOH, KOTA TANGERANG, BANTEN",9,74,141,215
https://kawalpemilu.org#52969,"CIPONDOH MAKMUR, CIPONDOH, KOTA TANGERANG, BANTEN",10,60,154,214
https://kawalpemilu.org#52969,"CIPONDOH MAKMUR, CIPONDOH, KOTA TANGERANG, BANTEN",11,38,163,201
https://kawalpemilu.org#52969,"CIPONDOH MAKMUR, CIPONDOH, KOTA TANGERANG, BANTEN",12,46,111,157
https://kawalpemilu.org#52969,"CIPONDOH MAKMUR, CIPONDOH, KOTA TANGERANG, BANTEN",13,88,126,214
https://kawalpemilu.org#52969,"CIPONDOH MAKMUR, CIPONDOH, KOTA TANGERANG, BANTEN",14,62,122,184
https://kawalpemilu.org#52969,"CIPONDOH MAKMUR, CIPONDOH, KOTA TANGERANG, BANTEN",15,62,165,227
https://kawalpemilu.org#52969,"CIPONDOH MAKMUR, CIPONDOH, KOTA TANGERANG, BANTEN",17,58,168,226
https://kawalpemilu.org#52969,"CIPONDOH MAKMUR, CIPONDOH, KOTA TANGERANG, BANTEN",18,77,179,256
https://kawalpemilu.org#52969,"CIPONDOH MAKMUR, CIPONDOH, KOTA TANGERANG, BANTEN",19,99,119,218
https://kawalpemilu.org#52969,"CIPONDOH MAKMUR, CIPONDOH, KOTA TANGERANG, BANTEN",20,70,113,183
https://kawalpemilu.org#52969,"CIPONDOH MAKMUR, CIPONDOH, KOTA TANGERANG, BANTEN",21,56,180,236
https://kawalpemilu.org#52969,"CIPONDOH MAKMUR, CIPONDOH, KOTA TANGERANG, BANTEN",22,83,180,263
https://kawalpemilu.org#52969,"CIPONDOH MAKMUR, CIPONDOH, KOTA TANGERANG, BANTEN",23,91,157,248
https://kawalpemilu.org#52969,"CIPONDOH MAKMUR, CIPONDOH, KOTA TANGERANG, BANTEN",24,46,97,143
https://kawalpemilu.org#52969,"CIPONDOH MAKMUR, CIPONDOH, KOTA TANGERANG, BANTEN",25,36,95,131
https://kawalpemilu.org#52969,"CIPONDOH MAKMUR, CIPONDOH, KOTA TANGERANG, BANTEN",26,79,109,188
https://kawalpemilu.org#52969,"CIPONDOH MAKMUR, CIPONDOH, KOTA TANGERANG, BANTEN",27,65,72,137
https://kawalpemilu.org#52969,"CIPONDOH MAKMUR, CIPONDOH, KOTA TANGERANG, BANTEN",28,158,59,217
https://kawalpemilu.org#52969,"CIPONDOH MAKMUR, CIPONDOH, KOTA TANGERANG, BANTEN",29,106,105,211
https://kawalpemilu.org#52969,"CIPONDOH MAKMUR, CIPONDOH, KOTA TANGERANG, BANTEN",30,103,85,188
https://kawalpemilu.org#52969,"CIPONDOH MAKMUR, CIPONDOH, KOTA TANGERANG, BANTEN",31,127,48,175
https://kawalpemilu.org#52969,"CIPONDOH MAKMUR, CIPONDOH, KOTA TANGERANG, BANTEN",33,90,56,146
https://kawalpemilu.org#52969,"CIPONDOH MAKMUR, CIPONDOH, KOTA TANGERANG, BANTEN",34,136,79,215
https://kawalpemilu.org#52969,"CIPONDOH MAKMUR, CIPONDOH, KOTA TANGERANG, BANTEN",35,125,82,207
https://kawalpemilu.org#52969,"CIPONDOH MAKMUR, CIPONDOH, KOTA TANGERANG, BANTEN",36,138,92,230
https://kawalpemilu.org#52969,"CIPONDOH MAKMUR, CIPONDOH, KOTA TANGERANG, BANTEN",37,145,111,256
https://kawalpemilu.org#52969,"CIPONDOH MAKMUR, CIPONDOH, KOTA TANGERANG, BANTEN",38,102,126,228
https://kawalpemilu.org#52969,"CIPONDOH MAKMUR, CIPONDOH, KOTA TANGERANG, BANTEN",40,131,72,203
https://kawalpemilu.org#52969,"CIPONDOH MAKMUR, CIPONDOH, KOTA TANGERANG, BANTEN",41,107,68,175
https://kawalpemilu.org#52969,"CIPONDOH MAKMUR, CIPONDOH, KOTA TANGERANG, BANTEN",42,97,92,189
https://kawalpemilu.org#52969,"CIPONDOH MAKMUR, CIPONDOH, KOTA TANGERANG, BANTEN",43,102,96,198
https://kawalpemilu.org#52969,"CIPONDOH MAKMUR, CIPONDOH, KOTA TANGERANG, BANTEN",44,88,125,213
https://kawalpemilu.org#52969,"CIPONDOH MAKMUR, CIPONDOH, KOTA TANGERANG, BANTEN",45,100,134,234
https://kawalpemilu.org#52969,"CIPONDOH MAKMUR, CIPONDOH, KOTA TANGERANG, BANTEN",46,85,167,253
https://kawalpemilu.org#52969,"CIPONDOH MAKMUR, CIPONDOH, KOTA TANGERANG, BANTEN",47,107,141,248
https://kawalpemilu.org#52969,"CIPONDOH MAKMUR, CIPONDOH, KOTA TANGERANG, BANTEN",48,97,111,208
https://kawalpemilu.org#52969,"CIPONDOH MAKMUR, CIPONDOH, KOTA TANGERANG, BANTEN",49,99,115,214
https://kawalpemilu.org#52969,"CIPONDOH MAKMUR, CIPONDOH, KOTA TANGERANG, BANTEN",50,74,115,189
https://kawalpemilu.org#52969,"CIPONDOH MAKMUR, CIPONDOH, KOTA TANGERANG, BANTEN",51,122,112,234
https://kawalpemilu.org#52969,"CIPONDOH MAKMUR, CIPONDOH, KOTA TANGERANG, BANTEN",52,122,102,224
https://kawalpemilu.org#52969,"CIPONDOH MAKMUR, CIPONDOH, KOTA TANGERANG, BANTEN",53,150,51,201
https://kawalpemilu.org#52969,"CIPONDOH MAKMUR, CIPONDOH, KOTA TANGERANG, BANTEN",55,95,94,189
https://kawalpemilu.org#52969,"CIPONDOH MAKMUR, CIPONDOH, KOTA TANGERANG, BANTEN",56,85,97,182
https://kawalpemilu.org#52969,"CIPONDOH MAKMUR, CIPONDOH, KOTA TANGERANG, BANTEN",57,111,100,211
https://kawalpemilu.org#52969,"CIPONDOH MAKMUR, CIPONDOH, KOTA TANGERANG, BANTEN",58,105,94,199
https://kawalpemilu.org#52969,"CIPONDOH MAKMUR, CIPONDOH, KOTA TANGERANG, BANTEN",59,84,114,198
https://kawalpemilu.org#52969,"CIPONDOH MAKMUR, CIPONDOH, KOTA TANGERANG, BANTEN",60,124,85,209
https://kawalpemilu.org#52969,"CIPONDOH MAKMUR, CIPONDOH, KOTA TANGERANG, BANTEN",61,120,143,263
https://kawalpemilu.org#52969,"CIPONDOH MAKMUR, CIPONDOH, KOTA TANGERANG, BANTEN",62,80,120,200
https://kawalpemilu.org#52969,"CIPONDOH MAKMUR, CIPONDOH, KOTA TANGERANG, BANTEN",63,112,134,248
https://kawalpemilu.org#52969,"CIPONDOH MAKMUR, CIPONDOH, KOTA TANGERANG, BANTEN",64,97,126,223
https://kawalpemilu.org#52969,"CIPONDOH MAKMUR, CIPONDOH, KOTA TANGERANG, BANTEN",65,86,150,236
https://kawalpemilu.org#52969,"CIPONDOH MAKMUR, CIPONDOH, KOTA TANGERANG, BANTEN",66,71,149,220
https://kawalpemilu.org#52969,"CIPONDOH MAKMUR, CIPONDOH, KOTA TANGERANG, BANTEN",67,107,153,260
https://kawalpemilu.org#52969,"CIPONDOH MAKMUR, CIPONDOH, KOTA TANGERANG, BANTEN",68,130,103,233
https://kawalpemilu.org#52969,"CIPONDOH MAKMUR, CIPONDOH, KOTA TANGERANG, BANTEN",69,71,124,195
https://kawalpemilu.org#52969,"CIPONDOH MAKMUR, CIPONDOH, KOTA TANGERANG, BANTEN",70,82,155,237
https://kawalpemilu.org#52969,"CIPONDOH MAKMUR, CIPONDOH, KOTA TANGERANG, BANTEN",71,50,42,92
https://kawalpemilu.org#52969,"CIPONDOH MAKMUR, CIPONDOH, KOTA TANGERANG, BANTEN",72,61,179,240
https://kawalpemilu.org#52969,"CIPONDOH MAKMUR, CIPONDOH, KOTA TANGERANG, BANTEN",73,65,170,235
https://kawalpemilu.org#52969,"CIPONDOH MAKMUR, CIPONDOH, KOTA TANGERANG, BANTEN",74,82,127,209
https://kawalpemilu.org#52969,"CIPONDOH MAKMUR, CIPONDOH, KOTA TANGERANG, BANTEN",75,70,110,180
https://kawalpemilu.org#52969,"CIPONDOH MAKMUR, CIPONDOH, KOTA TANGERANG, BANTEN",76,53,111,164
https://kawalpemilu.org#52969,"CIPONDOH MAKMUR, CIPONDOH, KOTA TANGERANG, BANTEN",77,74,118,192
https://kawalpemilu.org#52969,"CIPONDOH MAKMUR, CIPONDOH, KOTA TANGERANG, BANTEN",78,239,48,287
https://kawalpemilu.org#52969,"CIPONDOH MAKMUR, CIPONDOH, KOTA TANGERANG, BANTEN",79,159,134,293
https://kawalpemilu.org#52969,"CIPONDOH MAKMUR, CIPONDOH, KOTA TANGERANG, BANTEN",80,150,95,245
https://kawalpemilu.org#52969,"CIPONDOH MAKMUR, CIPONDOH, KOTA TANGERANG, BANTEN",81,141,130,271
https://kawalpemilu.org#52969,"CIPONDOH MAKMUR, CIPONDOH, KOTA TANGERANG, BANTEN",82,103,95,198
https://kawalpemilu.org#52969,"CIPONDOH MAKMUR, CIPONDOH, KOTA TANGERANG, BANTEN",83,121,116,237
https://kawalpemilu.org#52969,"CIPONDOH MAKMUR, CIPONDOH, KOTA TANGERANG, BANTEN",84,124,99,223
https://kawalpemilu.org#52970,"CIPONDOH INDAH, CIPONDOH, KOTA TANGERANG, BANTEN",1,190,11,201
https://kawalpemilu.org#52970,"CIPONDOH INDAH, CIPONDOH, KOTA TANGERANG, BANTEN",2,183,30,213
https://kawalpemilu.org#52970,"CIPONDOH INDAH, CIPONDOH, KOTA TANGERANG, BANTEN",3,165,54,219
https://kawalpemilu.org#52970,"CIPONDOH INDAH, CIPONDOH, KOTA TANGERANG, BANTEN",5,176,17,193
https://kawalpemilu.org#52970,"CIPONDOH INDAH, CIPONDOH, KOTA TANGERANG, BANTEN",6,188,29,217
https://kawalpemilu.org#52970,"CIPONDOH INDAH, CIPONDOH, KOTA TANGERANG, BANTEN",7,195,32,227
https://kawalpemilu.org#52970,"CIPONDOH INDAH, CIPONDOH, KOTA TANGERANG, BANTEN",8,135,12,147
https://kawalpemilu.org#52970,"CIPONDOH INDAH, CIPONDOH, KOTA TANGERANG, BANTEN",9,156,33,189
https://kawalpemilu.org#52970,"CIPONDOH INDAH, CIPONDOH, KOTA TANGERANG, BANTEN",10,166,34,200
https://kawalpemilu.org#52970,"CIPONDOH INDAH, CIPONDOH, KOTA TANGERANG, BANTEN",11,44,120,164
https://kawalpemilu.org#52970,"CIPONDOH INDAH, CIPONDOH, KOTA TANGERANG, BANTEN",12,63,126,189
https://kawalpemilu.org#52970,"CIPONDOH INDAH, CIPONDOH, KOTA TANGERANG, BANTEN",13,66,107,173
https://kawalpemilu.org#52970,"CIPONDOH INDAH, CIPONDOH, KOTA TANGERANG, BANTEN",14,54,154,208
https://kawalpemilu.org#52970,"CIPONDOH INDAH, CIPONDOH, KOTA TANGERANG, BANTEN",15,83,87,170
https://kawalpemilu.org#52970,"CIPONDOH INDAH, CIPONDOH, KOTA TANGERANG, BANTEN",16,46,94,140
https://kawalpemilu.org#52970,"CIPONDOH INDAH, CIPONDOH, KOTA TANGERANG, BANTEN",17,74,103,177
https://kawalpemilu.org#52970,"CIPONDOH INDAH, CIPONDOH, KOTA TANGERANG, BANTEN",18,101,129,230
https://kawalpemilu.org#52970,"CIPONDOH INDAH, CIPONDOH, KOTA TANGERANG, BANTEN",19,85,126,211
https://kawalpemilu.org#52970,"CIPONDOH INDAH, CIPONDOH, KOTA TANGERANG, BANTEN",20,52,117,109
https://kawalpemilu.org#52970,"CIPONDOH INDAH, CIPONDOH, KOTA TANGERANG, BANTEN",21,41,130,171
https://kawalpemilu.org#52970,"CIPONDOH INDAH, CIPONDOH, KOTA TANGERANG, BANTEN",22,44,107,151
https://kawalpemilu.org#52970,"CIPONDOH INDAH, CIPONDOH, KOTA TANGERANG, BANTEN",23,30,124,154
https://kawalpemilu.org#52970,"CIPONDOH INDAH, CIPONDOH, KOTA TANGERANG, BANTEN",24,37,127,164
https://kawalpemilu.org#52970,"CIPONDOH INDAH, CIPONDOH, KOTA TANGERANG, BANTEN",25,54,123,177
https://kawalpemilu.org#52970,"CIPONDOH INDAH, CIPONDOH, KOTA TANGERANG, BANTEN",26,94,128,222
https://kawalpemilu.org#52970,"CIPONDOH INDAH, CIPONDOH, KOTA TANGERANG, BANTEN",27,36,87,123
https://kawalpemilu.org#52970,"CIPONDOH INDAH, CIPONDOH, KOTA TANGERANG, BANTEN",28,27,116,143
https://kawalpemilu.org#52970,"CIPONDOH INDAH, CIPONDOH, KOTA TANGERANG, BANTEN",29,73,144,217
https://kawalpemilu.org#52970,"CIPONDOH INDAH, CIPONDOH, KOTA TANGERANG, BANTEN",30,54,164,218
https://kawalpemilu.org#52970,"CIPONDOH INDAH, CIPONDOH, KOTA TANGERANG, BANTEN",31,41,123,164
https://kawalpemilu.org#52970,"CIPONDOH INDAH, CIPONDOH, KOTA TANGERANG, BANTEN",32,70,109,179
https://kawalpemilu.org#52970,"CIPONDOH INDAH, CIPONDOH, KOTA TANGERANG, BANTEN",33,40,142,182
https://kawalpemilu.org#52970,"CIPONDOH INDAH, CIPONDOH, KOTA TANGERANG, BANTEN",34,40,186,226
https://kawalpemilu.org#52970,"CIPONDOH INDAH, CIPONDOH, KOTA TANGERANG, BANTEN",35,177,36,213
https://kawalpemilu.org#52970,"CIPONDOH INDAH, CIPONDOH, KOTA TANGERANG, BANTEN",36,190,79,269
https://kawalpemilu.org#52970,"CIPONDOH INDAH, CIPONDOH, KOTA TANGERANG, BANTEN",37,176,31,207
https://kawalpemilu.org#52970,"CIPONDOH INDAH, CIPONDOH, KOTA TANGERANG, BANTEN",38,199,16,215
https://kawalpemilu.org#52970,"CIPONDOH INDAH, CIPONDOH, KOTA TANGERANG, BANTEN",39,160,75,235
https://kawalpemilu.org#52970,"CIPONDOH INDAH, CIPONDOH, KOTA TANGERANG, BANTEN",40,212,37,249
https://kawalpemilu.org#52970,"CIPONDOH INDAH, CIPONDOH, KOTA TANGERANG, BANTEN",41,160,61,221
https://kawalpemilu.org#52970,"CIPONDOH INDAH, CIPONDOH, KOTA TANGERANG, BANTEN",42,213,58,271
https://kawalpemilu.org#52970,"CIPONDOH INDAH, CIPONDOH, KOTA TANGERANG, BANTEN",43,173,20,193
https://kawalpemilu.org#52970,"CIPONDOH INDAH, CIPONDOH, KOTA TANGERANG, BANTEN",44,185,51,236
https://kawalpemilu.org#52970,"CIPONDOH INDAH, CIPONDOH, KOTA TANGERANG, BANTEN",45,217,21,238
https://kawalpemilu.org#52970,"CIPONDOH INDAH, CIPONDOH, KOTA TANGERANG, BANTEN",46,240,28,268
https://kawalpemilu.org#52970,"CIPONDOH INDAH, CIPONDOH, KOTA TANGERANG, BANTEN",47,181,68,251
https://kawalpemilu.org#52970,"CIPONDOH INDAH, CIPONDOH, KOTA TANGERANG, BANTEN",48,223,37,260
https://kawalpemilu.org#52970,"CIPONDOH INDAH, CIPONDOH, KOTA TANGERANG, BANTEN",49,101,19,120
https://kawalpemilu.org#52970,"CIPONDOH INDAH, CIPONDOH, KOTA TANGERANG, BANTEN",50,226,10,236
https://kawalpemilu.org#52970,"CIPONDOH INDAH, CIPONDOH, KOTA TANGERANG, BANTEN",51,203,35,238
https://kawalpemilu.org#52970,"CIPONDOH INDAH, CIPONDOH, KOTA TANGERANG, BANTEN",52,172,8,180
https://kawalpemilu.org#52970,"CIPONDOH INDAH, CIPONDOH, KOTA TANGERANG, BANTEN",53,165,25,190
https://kawalpemilu.org#52970,"CIPONDOH INDAH, CIPONDOH, KOTA TANGERANG, BANTEN",54,171,50,221
https://kawalpemilu.org#52970,"CIPONDOH INDAH, CIPONDOH, KOTA TANGERANG, BANTEN",56,252,8,260
https://kawalpemilu.org#52970,"CIPONDOH INDAH, CIPONDOH, KOTA TANGERANG, BANTEN",57,167,23,190
https://kawalpemilu.org#52970,"CIPONDOH INDAH, CIPONDOH, KOTA TANGERANG, BANTEN",58,198,16,214
https://kawalpemilu.org#52970,"CIPONDOH INDAH, CIPONDOH, KOTA TANGERANG, BANTEN",59,158,4,162
https://kawalpemilu.org#52970,"CIPONDOH INDAH, CIPONDOH, KOTA TANGERANG, BANTEN",60,126,20,146
https://kawalpemilu.org#52970,"CIPONDOH INDAH, CIPONDOH, KOTA TANGERANG, BANTEN",61,225,3,228
https://kawalpemilu.org#52970,"CIPONDOH INDAH, CIPONDOH, KOTA TANGERANG, BANTEN",62,155,11,166
https://kawalpemilu.org#52970,"CIPONDOH INDAH, CIPONDOH, KOTA TANGERANG, BANTEN",63,195,9,204
https://kawalpemilu.org#52970,"CIPONDOH INDAH, CIPONDOH, KOTA TANGERANG, BANTEN",64,194,6,200
https://kawalpemilu.org#52970,"CIPONDOH INDAH, CIPONDOH, KOTA TANGERANG, BANTEN",65,230,11,241
https://kawalpemilu.org#52970,"CIPONDOH INDAH, CIPONDOH, KOTA TANGERANG, BANTEN",66,203,8,211
https://kawalpemilu.org#52970,"CIPONDOH INDAH, CIPONDOH, KOTA TANGERANG, BANTEN",67,256,5,261
https://kawalpemilu.org#52970,"CIPONDOH INDAH, CIPONDOH, KOTA TANGERANG, BANTEN",68,213,16,229
https://kawalpemilu.org#52971,"GONDRONG, CIPONDOH, KOTA TANGERANG, BANTEN",1,34,135,169
https://kawalpemilu.org#52971,"GONDRONG, CIPONDOH, KOTA TANGERANG, BANTEN",2,31,125,156
https://kawalpemilu.org#52971,"GONDRONG, CIPONDOH, KOTA TANGERANG, BANTEN",3,44,123,167
https://kawalpemilu.org#52971,"GONDRONG, CIPONDOH, KOTA TANGERANG, BANTEN",4,56,145,201
https://kawalpemilu.org#52971,"GONDRONG, CIPONDOH, KOTA TANGERANG, BANTEN",5,69,192,261
https://kawalpemilu.org#52971,"GONDRONG, CIPONDOH, KOTA TANGERANG, BANTEN",6,54,142,196
https://kawalpemilu.org#52971,"GONDRONG, CIPONDOH, KOTA TANGERANG, BANTEN",7,84,155,239
https://kawalpemilu.org#52971,"GONDRONG, CIPONDOH, KOTA TANGERANG, BANTEN",8,92,93,185
https://kawalpemilu.org#52971,"GONDRONG, CIPONDOH, KOTA TANGERANG, BANTEN",9,100,78,178
https://kawalpemilu.org#52971,"GONDRONG, CIPONDOH, KOTA TANGERANG, BANTEN",10,70,185,255
https://kawalpemilu.org#52971,"GONDRONG, CIPONDOH, KOTA TANGERANG, BANTEN",11,35,132,167
https://kawalpemilu.org#52971,"GONDRONG, CIPONDOH, KOTA TANGERANG, BANTEN",12,42,126,168
https://kawalpemilu.org#52971,"GONDRONG, CIPONDOH, KOTA TANGERANG, BANTEN",13,57,102,159
https://kawalpemilu.org#52971,"GONDRONG, CIPONDOH, KOTA TANGERANG, BANTEN",14,56,107,163
https://kawalpemilu.org#52971,"GONDRONG, CIPONDOH, KOTA TANGERANG, BANTEN",15,72,142,214
https://kawalpemilu.org#52971,"GONDRONG, CIPONDOH, KOTA TANGERANG, BANTEN",16,56,166,222
https://kawalpemilu.org#52971,"GONDRONG, CIPONDOH, KOTA TANGERANG, BANTEN",17,72,147,219
https://kawalpemilu.org#52971,"GONDRONG, CIPONDOH, KOTA TANGERANG, BANTEN",18,75,150,225
https://kawalpemilu.org#52971,"GONDRONG, CIPONDOH, KOTA TANGERANG, BANTEN",19,67,194,261
https://kawalpemilu.org#52971,"GONDRONG, CIPONDOH, KOTA TANGERANG, BANTEN",20,45,113,158
https://kawalpemilu.org#52971,"GONDRONG, CIPONDOH, KOTA TANGERANG, BANTEN",21,35,137,172
https://kawalpemilu.org#52971,"GONDRONG, CIPONDOH, KOTA TANGERANG, BANTEN",22,44,120,164
https://kawalpemilu.org#52971,"GONDRONG, CIPONDOH, KOTA TANGERANG, BANTEN",23,31,135,166
https://kawalpemilu.org#52971,"GONDRONG, CIPONDOH, KOTA TANGERANG, BANTEN",24,50,177,227
https://kawalpemilu.org#52971,"GONDRONG, CIPONDOH, KOTA TANGERANG, BANTEN",26,79,222,301
https://kawalpemilu.org#52971,"GONDRONG, CIPONDOH, KOTA TANGERANG, BANTEN",27,38,130,168
https://kawalpemilu.org#52971,"GONDRONG, CIPONDOH, KOTA TANGERANG, BANTEN",28,54,111,165
https://kawalpemilu.org#52971,"GONDRONG, CIPONDOH, KOTA TANGERANG, BANTEN",29,68,153,221
https://kawalpemilu.org#52971,"GONDRONG, CIPONDOH, KOTA TANGERANG, BANTEN",30,70,146,216
https://kawalpemilu.org#52971,"GONDRONG, CIPONDOH, KOTA TANGERANG, BANTEN",31,67,121,188
https://kawalpemilu.org#52971,"GONDRONG, CIPONDOH, KOTA TANGERANG, BANTEN",32,88,149,237
https://kawalpemilu.org#52971,"GONDRONG, CIPONDOH, KOTA TANGERANG, BANTEN",33,87,147,234
https://kawalpemilu.org#52971,"GONDRONG, CIPONDOH, KOTA TANGERANG, BANTEN",34,60,114,174
https://kawalpemilu.org#52971,"GONDRONG, CIPONDOH, KOTA TANGERANG, BANTEN",35,54,79,133
https://kawalpemilu.org#52971,"GONDRONG, CIPONDOH, KOTA TANGERANG, BANTEN",36,45,127,172
https://kawalpemilu.org#52971,"GONDRONG, CIPONDOH, KOTA TANGERANG, BANTEN",37,65,158,223
https://kawalpemilu.org#52971,"GONDRONG, CIPONDOH, KOTA TANGERANG, BANTEN",38,78,117,195
https://kawalpemilu.org#52971,"GONDRONG, CIPONDOH, KOTA TANGERANG, BANTEN",39,64,113,177
https://kawalpemilu.org#52971,"GONDRONG, CIPONDOH, KOTA TANGERANG, BANTEN",40,87,80,167
https://kawalpemilu.org#52971,"GONDRONG, CIPONDOH, KOTA TANGERANG, BANTEN",41,78,128,206
https://kawalpemilu.org#52971,"GONDRONG, CIPONDOH, KOTA TANGERANG, BANTEN",42,67,108,175
https://kawalpemilu.org#52971,"GONDRONG, CIPONDOH, KOTA TANGERANG, BANTEN",43,47,116,163
https://kawalpemilu.org#52971,"GONDRONG, CIPONDOH, KOTA TANGERANG, BANTEN",44,30,139,169
https://kawalpemilu.org#52971,"GONDRONG, CIPONDOH, KOTA TANGERANG, BANTEN",45,56,136,192
https://kawalpemilu.org#52971,"GONDRONG, CIPONDOH, KOTA TANGERANG, BANTEN",46,59,120,179
https://kawalpemilu.org#52971,"GONDRONG, CIPONDOH, KOTA TANGERANG, BANTEN",47,60,197,257
https://kawalpemilu.org#52971,"GONDRONG, CIPONDOH, KOTA TANGERANG, BANTEN",48,29,126,155
https://kawalpemilu.org#52971,"GONDRONG, CIPONDOH, KOTA TANGERANG, BANTEN",49,44,119,163
https://kawalpemilu.org#52971,"GONDRONG, CIPONDOH, KOTA TANGERANG, BANTEN",50,30,156,186
https://kawalpemilu.org#52971,"GONDRONG, CIPONDOH, KOTA TANGERANG, BANTEN",51,34,147,181
https://kawalpemilu.org#52971,"GONDRONG, CIPONDOH, KOTA TANGERANG, BANTEN",52,23,125,148
https://kawalpemilu.org#52971,"GONDRONG, CIPONDOH, KOTA TANGERANG, BANTEN",53,17,134,151
https://kawalpemilu.org#52971,"GONDRONG, CIPONDOH, KOTA TANGERANG, BANTEN",54,29,139,168
https://kawalpemilu.org#52971,"GONDRONG, CIPONDOH, KOTA TANGERANG, BANTEN",55,33,125,158
https://kawalpemilu.org#52971,"GONDRONG, CIPONDOH, KOTA TANGERANG, BANTEN",56,67,88,155
https://kawalpemilu.org#52971,"GONDRONG, CIPONDOH, KOTA TANGERANG, BANTEN",57,38,118,156
https://kawalpemilu.org#52971,"GONDRONG, CIPONDOH, KOTA TANGERANG, BANTEN",58,50,119,169
https://kawalpemilu.org#52971,"GONDRONG, CIPONDOH, KOTA TANGERANG, BANTEN",59,40,137,177
https://kawalpemilu.org#52971,"GONDRONG, CIPONDOH, KOTA TANGERANG, BANTEN",60,283,8,291
https://kawalpemilu.org#52972,"KENANGA, CIPONDOH, KOTA TANGERANG, BANTEN",2,96,103,199
https://kawalpemilu.org#52972,"KENANGA, CIPONDOH, KOTA TANGERANG, BANTEN",3,93,134,227
https://kawalpemilu.org#52972,"KENANGA, CIPONDOH, KOTA TANGERANG, BANTEN",4,89,85,174
https://kawalpemilu.org#52972,"KENANGA, CIPONDOH, KOTA TANGERANG, BANTEN",5,87,118,205
https://kawalpemilu.org#52972,"KENANGA, CIPONDOH, KOTA TANGERANG, BANTEN",6,74,112,186
https://kawalpemilu.org#52972,"KENANGA, CIPONDOH, KOTA TANGERANG, BANTEN",7,81,122,203
https://kawalpemilu.org#52972,"KENANGA, CIPONDOH, KOTA TANGERANG, BANTEN",8,69,101,170
https://kawalpemilu.org#52972,"KENANGA, CIPONDOH, KOTA TANGERANG, BANTEN",9,62,118,180
https://kawalpemilu.org#52972,"KENANGA, CIPONDOH, KOTA TANGERANG, BANTEN",10,69,109,178
https://kawalpemilu.org#52972,"KENANGA, CIPONDOH, KOTA TANGERANG, BANTEN",11,71,103,174
https://kawalpemilu.org#52972,"KENANGA, CIPONDOH, KOTA TANGERANG, BANTEN",12,39,119,158
https://kawalpemilu.org#52972,"KENANGA, CIPONDOH, KOTA TANGERANG, BANTEN",13,32,192,224
https://kawalpemilu.org#52972,"KENANGA, CIPONDOH, KOTA TANGERANG, BANTEN",14,48,170,218
https://kawalpemilu.org#52972,"KENANGA, CIPONDOH, KOTA TANGERANG, BANTEN",15,35,111,146
https://kawalpemilu.org#52972,"KENANGA, CIPONDOH, KOTA TANGERANG, BANTEN",16,84,98,182
https://kawalpemilu.org#52972,"KENANGA, CIPONDOH, KOTA TANGERANG, BANTEN",17,35,155,190
https://kawalpemilu.org#52972,"KENANGA, CIPONDOH, KOTA TANGERANG, BANTEN",18,52,135,187
https://kawalpemilu.org#52972,"KENANGA, CIPONDOH, KOTA TANGERANG, BANTEN",19,72,122,194
https://kawalpemilu.org#52972,"KENANGA, CIPONDOH, KOTA TANGERANG, BANTEN",20,59,147,206
https://kawalpemilu.org#52972,"KENANGA, CIPONDOH, KOTA TANGERANG, BANTEN",21,29,190,219
https://kawalpemilu.org#52972,"KENANGA, CIPONDOH, KOTA TANGERANG, BANTEN",22,57,173,230
https://kawalpemilu.org#52972,"KENANGA, CIPONDOH, KOTA TANGERANG, BANTEN",23,65,207,272
https://kawalpemilu.org#52972,"KENANGA, CIPONDOH, KOTA TANGERANG, BANTEN",24,121,72,193
https://kawalpemilu.org#52972,"KENANGA, CIPONDOH, KOTA TANGERANG, BANTEN",25,82,103,185
https://kawalpemilu.org#52972,"KENANGA, CIPONDOH, KOTA TANGERANG, BANTEN",26,68,143,211
https://kawalpemilu.org#52972,"KENANGA, CIPONDOH, KOTA TANGERANG, BANTEN",28,63,102,165
https://kawalpemilu.org#52972,"KENANGA, CIPONDOH, KOTA TANGERANG, BANTEN",29,80,112,192
https://kawalpemilu.org#52972,"KENANGA, CIPONDOH, KOTA TANGERANG, BANTEN",30,41,143,184
https://kawalpemilu.org#52972,"KENANGA, CIPONDOH, KOTA TANGERANG, BANTEN",31,80,78,158
https://kawalpemilu.org#52972,"KENANGA, CIPONDOH, KOTA TANGERANG, BANTEN",32,59,151,210
https://kawalpemilu.org#52972,"KENANGA, CIPONDOH, KOTA TANGERANG, BANTEN",33,96,139,235
https://kawalpemilu.org#52972,"KENANGA, CIPONDOH, KOTA TANGERANG, BANTEN",34,140,99,239
https://kawalpemilu.org#52972,"KENANGA, CIPONDOH, KOTA TANGERANG, BANTEN",35,144,61,205
https://kawalpemilu.org#52972,"KENANGA, CIPONDOH, KOTA TANGERANG, BANTEN",36,196,22,218
https://kawalpemilu.org#52972,"KENANGA, CIPONDOH, KOTA TANGERANG, BANTEN",37,148,33,181
https://kawalpemilu.org#52972,"KENANGA, CIPONDOH, KOTA TANGERANG, BANTEN",38,66,148,214
https://kawalpemilu.org#52972,"KENANGA, CIPONDOH, KOTA TANGERANG, BANTEN",40,46,187,233
https://kawalpemilu.org#52973,"PETIR, CIPONDOH, KOTA TANGERANG, BANTEN",1,61,151,212
https://kawalpemilu.org#52973,"PETIR, CIPONDOH, KOTA TANGERANG, BANTEN",2,53,169,222
https://kawalpemilu.org#52973,"PETIR, CIPONDOH, KOTA TANGERANG, BANTEN",4,49,159,208
https://kawalpemilu.org#52973,"PETIR, CIPONDOH, KOTA TANGERANG, BANTEN",5,42,157,199
https://kawalpemilu.org#52973,"PETIR, CIPONDOH, KOTA TANGERANG, BANTEN",6,38,163,201
https://kawalpemilu.org#52973,"PETIR, CIPONDOH, KOTA TANGERANG, BANTEN",7,34,174,208
https://kawalpemilu.org#52973,"PETIR, CIPONDOH, KOTA TANGERANG, BANTEN",8,47,161,208
https://kawalpemilu.org#52973,"PETIR, CIPONDOH, KOTA TANGERANG, BANTEN",9,48,160,208
https://kawalpemilu.org#52973,"PETIR, CIPONDOH, KOTA TANGERANG, BANTEN",10,44,140,184
https://kawalpemilu.org#52973,"PETIR, CIPONDOH, KOTA TANGERANG, BANTEN",11,53,150,203
https://kawalpemilu.org#52973,"PETIR, CIPONDOH, KOTA TANGERANG, BANTEN",12,38,185,223
https://kawalpemilu.org#52973,"PETIR, CIPONDOH, KOTA TANGERANG, BANTEN",13,48,168,216
https://kawalpemilu.org#52973,"PETIR, CIPONDOH, KOTA TANGERANG, BANTEN",14,32,193,225
https://kawalpemilu.org#52973,"PETIR, CIPONDOH, KOTA TANGERANG, BANTEN",15,43,179,222
https://kawalpemilu.org#52973,"PETIR, CIPONDOH, KOTA TANGERANG, BANTEN",16,44,172,216
https://kawalpemilu.org#52973,"PETIR, CIPONDOH, KOTA TANGERANG, BANTEN",17,46,171,217
https://kawalpemilu.org#52973,"PETIR, CIPONDOH, KOTA TANGERANG, BANTEN",18,59,161,220
https://kawalpemilu.org#52973,"PETIR, CIPONDOH, KOTA TANGERANG, BANTEN",19,40,176,216
https://kawalpemilu.org#52973,"PETIR, CIPONDOH, KOTA TANGERANG, BANTEN",20,38,140,178
https://kawalpemilu.org#52973,"PETIR, CIPONDOH, KOTA TANGERANG, BANTEN",21,42,157,199
https://kawalpemilu.org#52973,"PETIR, CIPONDOH, KOTA TANGERANG, BANTEN",22,41,169,210
https://kawalpemilu.org#52973,"PETIR, CIPONDOH, KOTA TANGERANG, BANTEN",23,74,171,245
https://kawalpemilu.org#52973,"PETIR, CIPONDOH, KOTA TANGERANG, BANTEN",24,69,159,125
https://kawalpemilu.org#52973,"PETIR, CIPONDOH, KOTA TANGERANG, BANTEN",25,56,161,217
https://kawalpemilu.org#52973,"PETIR, CIPONDOH, KOTA TANGERANG, BANTEN",26,46,149,195
https://kawalpemilu.org#52973,"PETIR, CIPONDOH, KOTA TANGERANG, BANTEN",27,30,150,180
https://kawalpemilu.org#52973,"PETIR, CIPONDOH, KOTA TANGERANG, BANTEN",28,60,149,209
https://kawalpemilu.org#52973,"PETIR, CIPONDOH, KOTA TANGERANG, BANTEN",29,51,166,217
https://kawalpemilu.org#52973,"PETIR, CIPONDOH, KOTA TANGERANG, BANTEN",30,68,122,190
https://kawalpemilu.org#52973,"PETIR, CIPONDOH, KOTA TANGERANG, BANTEN",31,63,130,193
https://kawalpemilu.org#52973,"PETIR, CIPONDOH, KOTA TANGERANG, BANTEN",32,47,145,192
https://kawalpemilu.org#52973,"PETIR, CIPONDOH, KOTA TANGERANG, BANTEN",33,74,158,232
https://kawalpemilu.org#52973,"PETIR, CIPONDOH, KOTA TANGERANG, BANTEN",34,59,190,249
https://kawalpemilu.org#52973,"PETIR, CIPONDOH, KOTA TANGERANG, BANTEN",35,67,150,217
https://kawalpemilu.org#52973,"PETIR, CIPONDOH, KOTA TANGERANG, BANTEN",36,114,131,245
https://kawalpemilu.org#52973,"PETIR, CIPONDOH, KOTA TANGERANG, BANTEN",37,108,122,230
https://kawalpemilu.org#52973,"PETIR, CIPONDOH, KOTA TANGERANG, BANTEN",38,76,139,215
https://kawalpemilu.org#52973,"PETIR, CIPONDOH, KOTA TANGERANG, BANTEN",39,73,149,222
https://kawalpemilu.org#52973,"PETIR, CIPONDOH, KOTA TANGERANG, BANTEN",40,75,126,201
https://kawalpemilu.org#52973,"PETIR, CIPONDOH, KOTA TANGERANG, BANTEN",41,83,77,160
https://kawalpemilu.org#52973,"PETIR, CIPONDOH, KOTA TANGERANG, BANTEN",42,60,78,138
https://kawalpemilu.org#52973,"PETIR, CIPONDOH, KOTA TANGERANG, BANTEN",43,61,114,175
https://kawalpemilu.org#52973,"PETIR, CIPONDOH, KOTA TANGERANG, BANTEN",44,75,82,157
https://kawalpemilu.org#52973,"PETIR, CIPONDOH, KOTA TANGERANG, BANTEN",45,51,157,208
https://kawalpemilu.org#52973,"PETIR, CIPONDOH, KOTA TANGERANG, BANTEN",46,43,149,192
https://kawalpemilu.org#52973,"PETIR, CIPONDOH, KOTA TANGERANG, BANTEN",47,34,147,181
https://kawalpemilu.org#52973,"PETIR, CIPONDOH, KOTA TANGERANG, BANTEN",48,56,114,170
https://kawalpemilu.org#52973,"PETIR, CIPONDOH, KOTA TANGERANG, BANTEN",49,77,142,219
https://kawalpemilu.org#52973,"PETIR, CIPONDOH, KOTA TANGERANG, BANTEN",50,51,151,202
https://kawalpemilu.org#52973,"PETIR, CIPONDOH, KOTA TANGERANG, BANTEN",51,32,129,161
https://kawalpemilu.org#52973,"PETIR, CIPONDOH, KOTA TANGERANG, BANTEN",52,47,94,141
https://kawalpemilu.org#52973,"PETIR, CIPONDOH, KOTA TANGERANG, BANTEN",53,60,109,169
https://kawalpemilu.org#52973,"PETIR, CIPONDOH, KOTA TANGERANG, BANTEN",54,279,25,304
https://kawalpemilu.org#52973,"PETIR, CIPONDOH, KOTA TANGERANG, BANTEN",55,210,41,251
https://kawalpemilu.org#52973,"PETIR, CIPONDOH, KOTA TANGERANG, BANTEN",56,259,15,274
https://kawalpemilu.org#52973,"PETIR, CIPONDOH, KOTA TANGERANG, BANTEN",57,244,26,270
https://kawalpemilu.org#52974,"KETAPANG, CIPONDOH, KOTA TANGERANG, BANTEN",1,64,158,222
https://kawalpemilu.org#52974,"KETAPANG, CIPONDOH, KOTA TANGERANG, BANTEN",2,64,59,123
https://kawalpemilu.org#52974,"KETAPANG, CIPONDOH, KOTA TANGERANG, BANTEN",3,39,128,167
https://kawalpemilu.org#52974,"KETAPANG, CIPONDOH, KOTA TANGERANG, BANTEN",4,60,108,168
https://kawalpemilu.org#52974,"KETAPANG, CIPONDOH, KOTA TANGERANG, BANTEN",5,33,81,114
https://kawalpemilu.org#52974,"KETAPANG, CIPONDOH, KOTA TANGERANG, BANTEN",6,69,164,233
https://kawalpemilu.org#52974,"KETAPANG, CIPONDOH, KOTA TANGERANG, BANTEN",7,90,127,217
https://kawalpemilu.org#52974,"KETAPANG, CIPONDOH, KOTA TANGERANG, BANTEN",8,98,141,239
https://kawalpemilu.org#52974,"KETAPANG, CIPONDOH, KOTA TANGERANG, BANTEN",9,101,133,234
https://kawalpemilu.org#52974,"KETAPANG, CIPONDOH, KOTA TANGERANG, BANTEN",10,63,162,225
https://kawalpemilu.org#52974,"KETAPANG, CIPONDOH, KOTA TANGERANG, BANTEN",11,38,132,170
https://kawalpemilu.org#52974,"KETAPANG, CIPONDOH, KOTA TANGERANG, BANTEN",12,49,125,174
https://kawalpemilu.org#52974,"KETAPANG, CIPONDOH, KOTA TANGERANG, BANTEN",13,57,163,220
https://kawalpemilu.org#52974,"KETAPANG, CIPONDOH, KOTA TANGERANG, BANTEN",14,55,156,211
https://kawalpemilu.org#52974,"KETAPANG, CIPONDOH, KOTA TANGERANG, BANTEN",15,52,162,214
https://kawalpemilu.org#52974,"KETAPANG, CIPONDOH, KOTA TANGERANG, BANTEN",16,43,143,186
https://kawalpemilu.org#52974,"KETAPANG, CIPONDOH, KOTA TANGERANG, BANTEN",17,11,170,181
https://kawalpemilu.org#52974,"KETAPANG, CIPONDOH, KOTA TANGERANG, BANTEN",18,28,220,248
https://kawalpemilu.org#52974,"KETAPANG, CIPONDOH, KOTA TANGERANG, BANTEN",19,34,95,129
https://kawalpemilu.org#52974,"KETAPANG, CIPONDOH, KOTA TANGERANG, BANTEN",20,45,156,201
https://kawalpemilu.org#52974,"KETAPANG, CIPONDOH, KOTA TANGERANG, BANTEN",21,48,184,232
https://kawalpemilu.org#52974,"KETAPANG, CIPONDOH, KOTA TANGERANG, BANTEN",22,43,139,182
https://kawalpemilu.org#52974,"KETAPANG, CIPONDOH, KOTA TANGERANG, BANTEN",23,43,165,208
https://kawalpemilu.org#52974,"KETAPANG, CIPONDOH, KOTA TANGERANG, BANTEN",24,52,163,215
https://kawalpemilu.org#52974,"KETAPANG, CIPONDOH, KOTA TANGERANG, BANTEN",25,36,122,158
https://kawalpemilu.org#52974,"KETAPANG, CIPONDOH, KOTA TANGERANG, BANTEN",26,31,202,233
https://kawalpemilu.org#52974,"KETAPANG, CIPONDOH, KOTA TANGERANG, BANTEN",27,39,148,187
https://kawalpemilu.org#52974,"KETAPANG, CIPONDOH, KOTA TANGERANG, BANTEN",28,80,151,231
https://kawalpemilu.org#52974,"KETAPANG, CIPONDOH, KOTA TANGERANG, BANTEN",29,53,154,207
https://kawalpemilu.org#52974,"KETAPANG, CIPONDOH, KOTA TANGERANG, BANTEN",30,60,133,193
https://kawalpemilu.org#52974,"KETAPANG, CIPONDOH, KOTA TANGERANG, BANTEN",31,70,189,259
https://kawalpemilu.org#52974,"KETAPANG, CIPONDOH, KOTA TANGERANG, BANTEN",32,60,188,248
https://kawalpemilu.org#52974,"KETAPANG, CIPONDOH, KOTA TANGERANG, BANTEN",33,72,173,245
https://kawalpemilu.org#52974,"KETAPANG, CIPONDOH, KOTA TANGERANG, BANTEN",34,43,103,146
https://kawalpemilu.org#52974,"KETAPANG, CIPONDOH, KOTA TANGERANG, BANTEN",35,43,149,192
https://kawalpemilu.org#52974,"KETAPANG, CIPONDOH, KOTA TANGERANG, BANTEN",36,52,180,232
https://kawalpemilu.org#52974,"KETAPANG, CIPONDOH, KOTA TANGERANG, BANTEN",37,37,95,132
https://kawalpemilu.org#52974,"KETAPANG, CIPONDOH, KOTA TANGERANG, BANTEN",38,52,104,156
https://kawalpemilu.org#52974,"KETAPANG, CIPONDOH, KOTA TANGERANG, BANTEN",39,37,175,212
https://kawalpemilu.org#52974,"KETAPANG, CIPONDOH, KOTA TANGERANG, BANTEN",40,122,138,260
https://kawalpemilu.org#52974,"KETAPANG, CIPONDOH, KOTA TANGERANG, BANTEN",41,168,85,253
https://kawalpemilu.org#52974,"KETAPANG, CIPONDOH, KOTA TANGERANG, BANTEN",42,198,14,212
https://kawalpemilu.org#52975,"PORIS PLAWAD, CIPONDOH, KOTA TANGERANG, BANTEN",1,96,66,162
https://kawalpemilu.org#52975,"PORIS PLAWAD, CIPONDOH, KOTA TANGERANG, BANTEN",2,76,124,200
https://kawalpemilu.org#52975,"PORIS PLAWAD, CIPONDOH, KOTA TANGERANG, BANTEN",3,55,108,163
https://kawalpemilu.org#52975,"PORIS PLAWAD, CIPONDOH, KOTA TANGERANG, BANTEN",4,92,95,187
https://kawalpemilu.org#52975,"PORIS PLAWAD, CIPONDOH, KOTA TANGERANG, BANTEN",5,69,150,219
https://kawalpemilu.org#52975,"PORIS PLAWAD, CIPONDOH, KOTA TANGERANG, BANTEN",6,78,142,220
https://kawalpemilu.org#52975,"PORIS PLAWAD, CIPONDOH, KOTA TANGERANG, BANTEN",7,46,160,206
https://kawalpemilu.org#52975,"PORIS PLAWAD, CIPONDOH, KOTA TANGERANG, BANTEN",8,41,135,176
https://kawalpemilu.org#52975,"PORIS PLAWAD, CIPONDOH, KOTA TANGERANG, BANTEN",9,53,134,187
https://kawalpemilu.org#52975,"PORIS PLAWAD, CIPONDOH, KOTA TANGERANG, BANTEN",10,63,123,186
https://kawalpemilu.org#52975,"PORIS PLAWAD, CIPONDOH, KOTA TANGERANG, BANTEN",11,82,139,221
https://kawalpemilu.org#52975,"PORIS PLAWAD, CIPONDOH, KOTA TANGERANG, BANTEN",12,89,142,231
https://kawalpemilu.org#52975,"PORIS PLAWAD, CIPONDOH, KOTA TANGERANG, BANTEN",13,71,125,196
https://kawalpemilu.org#52975,"PORIS PLAWAD, CIPONDOH, KOTA TANGERANG, BANTEN",14,56,126,182
https://kawalpemilu.org#52975,"PORIS PLAWAD, CIPONDOH, KOTA TANGERANG, BANTEN",15,83,100,183
https://kawalpemilu.org#52975,"PORIS PLAWAD, CIPONDOH, KOTA TANGERANG, BANTEN",16,72,94,166
https://kawalpemilu.org#52975,"PORIS PLAWAD, CIPONDOH, KOTA TANGERANG, BANTEN",17,103,120,223
https://kawalpemilu.org#52975,"PORIS PLAWAD, CIPONDOH, KOTA TANGERANG, BANTEN",18,85,97,182
https://kawalpemilu.org#52975,"PORIS PLAWAD, CIPONDOH, KOTA TANGERANG, BANTEN",19,101,119,220
https://kawalpemilu.org#52975,"PORIS PLAWAD, CIPONDOH, KOTA TANGERANG, BANTEN",20,71,135,206
https://kawalpemilu.org#52975,"PORIS PLAWAD, CIPONDOH, KOTA TANGERANG, BANTEN",21,68,137,205
https://kawalpemilu.org#52975,"PORIS PLAWAD, CIPONDOH, KOTA TANGERANG, BANTEN",22,70,179,249
https://kawalpemilu.org#52975,"PORIS PLAWAD, CIPONDOH, KOTA TANGERANG, BANTEN",23,49,128,177
https://kawalpemilu.org#52975,"PORIS PLAWAD, CIPONDOH, KOTA TANGERANG, BANTEN",24,61,99,160
https://kawalpemilu.org#52975,"PORIS PLAWAD, CIPONDOH, KOTA TANGERANG, BANTEN",25,42,140,182
https://kawalpemilu.org#52975,"PORIS PLAWAD, CIPONDOH, KOTA TANGERANG, BANTEN",26,51,120,171
https://kawalpemilu.org#52975,"PORIS PLAWAD, CIPONDOH, KOTA TANGERANG, BANTEN",27,58,143,201
https://kawalpemilu.org#52975,"PORIS PLAWAD, CIPONDOH, KOTA TANGERANG, BANTEN",28,43,105,148
https://kawalpemilu.org#52975,"PORIS PLAWAD, CIPONDOH, KOTA TANGERANG, BANTEN",29,28,79,107
https://kawalpemilu.org#52975,"PORIS PLAWAD, CIPONDOH, KOTA TANGERANG, BANTEN",30,51,151,202
https://kawalpemilu.org#52975,"PORIS PLAWAD, CIPONDOH, KOTA TANGERANG, BANTEN",31,36,119,155
https://kawalpemilu.org#52975,"PORIS PLAWAD, CIPONDOH, KOTA TANGERANG, BANTEN",32,58,120,178
https://kawalpemilu.org#52975,"PORIS PLAWAD, CIPONDOH, KOTA TANGERANG, BANTEN",33,48,148,196
https://kawalpemilu.org#52975,"PORIS PLAWAD, CIPONDOH, KOTA TANGERANG, BANTEN",34,55,169,224
https://kawalpemilu.org#52975,"PORIS PLAWAD, CIPONDOH, KOTA TANGERANG, BANTEN",35,90,203,293
https://kawalpemilu.org#52975,"PORIS PLAWAD, CIPONDOH, KOTA TANGERANG, BANTEN",36,84,196,280
https://kawalpemilu.org#52975,"PORIS PLAWAD, CIPONDOH, KOTA TANGERANG, BANTEN",37,70,120,190
https://kawalpemilu.org#52975,"PORIS PLAWAD, CIPONDOH, KOTA TANGERANG, BANTEN",38,50,132,182
https://kawalpemilu.org#52975,"PORIS PLAWAD, CIPONDOH, KOTA TANGERANG, BANTEN",39,73,72,145
https://kawalpemilu.org#52975,"PORIS PLAWAD, CIPONDOH, KOTA TANGERANG, BANTEN",40,60,55,115
https://kawalpemilu.org#52975,"PORIS PLAWAD, CIPONDOH, KOTA TANGERANG, BANTEN",41,60,80,140
https://kawalpemilu.org#52975,"PORIS PLAWAD, CIPONDOH, KOTA TANGERANG, BANTEN",42,37,43,80
https://kawalpemilu.org#52975,"PORIS PLAWAD, CIPONDOH, KOTA TANGERANG, BANTEN",43,121,128,249
https://kawalpemilu.org#52975,"PORIS PLAWAD, CIPONDOH, KOTA TANGERANG, BANTEN",44,144,114,258
https://kawalpemilu.org#52975,"PORIS PLAWAD, CIPONDOH, KOTA TANGERANG, BANTEN",45,133,97,230
https://kawalpemilu.org#52975,"PORIS PLAWAD, CIPONDOH, KOTA TANGERANG, BANTEN",46,126,76,202
https://kawalpemilu.org#52975,"PORIS PLAWAD, CIPONDOH, KOTA TANGERANG, BANTEN",47,156,117,273
https://kawalpemilu.org#52975,"PORIS PLAWAD, CIPONDOH, KOTA TANGERANG, BANTEN",48,145,107,252
https://kawalpemilu.org#52976,"PORIS PLAWAD UTARA, CIPONDOH, KOTA TANGERANG, BANTEN",1,88,204,292
https://kawalpemilu.org#52976,"PORIS PLAWAD UTARA, CIPONDOH, KOTA TANGERANG, BANTEN",2,75,185,260
https://kawalpemilu.org#52976,"PORIS PLAWAD UTARA, CIPONDOH, KOTA TANGERANG, BANTEN",3,111,177,288
https://kawalpemilu.org#52976,"PORIS PLAWAD UTARA, CIPONDOH, KOTA TANGERANG, BANTEN",4,75,154,229
https://kawalpemilu.org#52976,"PORIS PLAWAD UTARA, CIPONDOH, KOTA TANGERANG, BANTEN",5,63,155,218
https://kawalpemilu.org#52976,"PORIS PLAWAD UTARA, CIPONDOH, KOTA TANGERANG, BANTEN",6,55,140,195
https://kawalpemilu.org#52976,"PORIS PLAWAD UTARA, CIPONDOH, KOTA TANGERANG, BANTEN",7,76,159,235
https://kawalpemilu.org#52976,"PORIS PLAWAD UTARA, CIPONDOH, KOTA TANGERANG, BANTEN",8,88,170,258
https://kawalpemilu.org#52976,"PORIS PLAWAD UTARA, CIPONDOH, KOTA TANGERANG, BANTEN",9,112,123,235
https://kawalpemilu.org#52976,"PORIS PLAWAD UTARA, CIPONDOH, KOTA TANGERANG, BANTEN",10,93,210,303
https://kawalpemilu.org#52976,"PORIS PLAWAD UTARA, CIPONDOH, KOTA TANGERANG, BANTEN",11,85,154,239
https://kawalpemilu.org#52976,"PORIS PLAWAD UTARA, CIPONDOH, KOTA TANGERANG, BANTEN",12,62,136,198
https://kawalpemilu.org#52976,"PORIS PLAWAD UTARA, CIPONDOH, KOTA TANGERANG, BANTEN",13,85,187,272
https://kawalpemilu.org#52976,"PORIS PLAWAD UTARA, CIPONDOH, KOTA TANGERANG, BANTEN",14,63,141,204
https://kawalpemilu.org#52976,"PORIS PLAWAD UTARA, CIPONDOH, KOTA TANGERANG, BANTEN",15,64,169,233
https://kawalpemilu.org#52976,"PORIS PLAWAD UTARA, CIPONDOH, KOTA TANGERANG, BANTEN",16,66,171,237
https://kawalpemilu.org#52976,"PORIS PLAWAD UTARA, CIPONDOH, KOTA TANGERANG, BANTEN",17,70,185,255
https://kawalpemilu.org#52976,"PORIS PLAWAD UTARA, CIPONDOH, KOTA TANGERANG, BANTEN",18,50,116,166
https://kawalpemilu.org#52976,"PORIS PLAWAD UTARA, CIPONDOH, KOTA TANGERANG, BANTEN",19,109,146,255
https://kawalpemilu.org#52976,"PORIS PLAWAD UTARA, CIPONDOH, KOTA TANGERANG, BANTEN",27,64,161,225
https://kawalpemilu.org#52976,"PORIS PLAWAD UTARA, CIPONDOH, KOTA TANGERANG, BANTEN",29,29,226,255
https://kawalpemilu.org#52976,"PORIS PLAWAD UTARA, CIPONDOH, KOTA TANGERANG, BANTEN",30,72,125,197
https://kawalpemilu.org#52976,"PORIS PLAWAD UTARA, CIPONDOH, KOTA TANGERANG, BANTEN",31,32,222,254
https://kawalpemilu.org#52976,"PORIS PLAWAD UTARA, CIPONDOH, KOTA TANGERANG, BANTEN",33,55,141,196
https://kawalpemilu.org#52976,"PORIS PLAWAD UTARA, CIPONDOH, KOTA TANGERANG, BANTEN",34,42,89,131
https://kawalpemilu.org#52976,"PORIS PLAWAD UTARA, CIPONDOH, KOTA TANGERANG, BANTEN",35,80,158,238
https://kawalpemilu.org#52976,"PORIS PLAWAD UTARA, CIPONDOH, KOTA TANGERANG, BANTEN",36,35,227,262
https://kawalpemilu.org#52976,"PORIS PLAWAD UTARA, CIPONDOH, KOTA TANGERANG, BANTEN",37,57,160,217
https://kawalpemilu.org#52976,"PORIS PLAWAD UTARA, CIPONDOH, KOTA TANGERANG, BANTEN",38,76,131,207
https://kawalpemilu.org#52976,"PORIS PLAWAD UTARA, CIPONDOH, KOTA TANGERANG, BANTEN",39,70,134,204
https://kawalpemilu.org#52976,"PORIS PLAWAD UTARA, CIPONDOH, KOTA TANGERANG, BANTEN",40,73,126,199
https://kawalpemilu.org#52976,"PORIS PLAWAD UTARA, CIPONDOH, KOTA TANGERANG, BANTEN",41,55,165,220
https://kawalpemilu.org#52976,"PORIS PLAWAD UTARA, CIPONDOH, KOTA TANGERANG, BANTEN",42,46,140,186
https://kawalpemilu.org#52976,"PORIS PLAWAD UTARA, CIPONDOH, KOTA TANGERANG, BANTEN",43,39,189,228
https://kawalpemilu.org#52976,"PORIS PLAWAD UTARA, CIPONDOH, KOTA TANGERANG, BANTEN",44,108,118,226
https://kawalpemilu.org#52976,"PORIS PLAWAD UTARA, CIPONDOH, KOTA TANGERANG, BANTEN",45,147,130,277
https://kawalpemilu.org#52976,"PORIS PLAWAD UTARA, CIPONDOH, KOTA TANGERANG, BANTEN",46,102,117,219
https://kawalpemilu.org#52976,"PORIS PLAWAD UTARA, CIPONDOH, KOTA TANGERANG, BANTEN",47,120,115,235
https://kawalpemilu.org#52976,"PORIS PLAWAD UTARA, CIPONDOH, KOTA TANGERANG, BANTEN",48,122,118,240
https://kawalpemilu.org#52976,"PORIS PLAWAD UTARA, CIPONDOH, KOTA TANGERANG, BANTEN",49,138,126,264
https://kawalpemilu.org#52976,"PORIS PLAWAD UTARA, CIPONDOH, KOTA TANGERANG, BANTEN",50,42,22,64
https://kawalpemilu.org#52977,"PORIS PLAWAD INDAH, CIPONDOH, KOTA TANGERANG, BANTEN",1,89,118,207
https://kawalpemilu.org#52977,"PORIS PLAWAD INDAH, CIPONDOH, KOTA TANGERANG, BANTEN",2,83,110,193
https://kawalpemilu.org#52977,"PORIS PLAWAD INDAH, CIPONDOH, KOTA TANGERANG, BANTEN",3,74,90,164
https://kawalpemilu.org#52977,"PORIS PLAWAD INDAH, CIPONDOH, KOTA TANGERANG, BANTEN",4,80,112,192
https://kawalpemilu.org#52977,"PORIS PLAWAD INDAH, CIPONDOH, KOTA TANGERANG, BANTEN",5,70,132,202
https://kawalpemilu.org#52977,"PORIS PLAWAD INDAH, CIPONDOH, KOTA TANGERANG, BANTEN",6,84,151,235
https://kawalpemilu.org#52977,"PORIS PLAWAD INDAH, CIPONDOH, KOTA TANGERANG, BANTEN",7,85,107,192
https://kawalpemilu.org#52977,"PORIS PLAWAD INDAH, CIPONDOH, KOTA TANGERANG, BANTEN",8,67,116,183
https://kawalpemilu.org#52977,"PORIS PLAWAD INDAH, CIPONDOH, KOTA TANGERANG, BANTEN",9,73,83,156
https://kawalpemilu.org#52977,"PORIS PLAWAD INDAH, CIPONDOH, KOTA TANGERANG, BANTEN",10,64,144,208
https://kawalpemilu.org#52977,"PORIS PLAWAD INDAH, CIPONDOH, KOTA TANGERANG, BANTEN",11,55,77,132
https://kawalpemilu.org#52977,"PORIS PLAWAD INDAH, CIPONDOH, KOTA TANGERANG, BANTEN",12,73,159,232
https://kawalpemilu.org#52977,"PORIS PLAWAD INDAH, CIPONDOH, KOTA TANGERANG, BANTEN",13,81,148,229
https://kawalpemilu.org#52977,"PORIS PLAWAD INDAH, CIPONDOH, KOTA TANGERANG, BANTEN",14,66,137,203
https://kawalpemilu.org#52977,"PORIS PLAWAD INDAH, CIPONDOH, KOTA TANGERANG, BANTEN",16,51,109,160
https://kawalpemilu.org#52977,"PORIS PLAWAD INDAH, CIPONDOH, KOTA TANGERANG, BANTEN",17,35,90,125
https://kawalpemilu.org#52977,"PORIS PLAWAD INDAH, CIPONDOH, KOTA TANGERANG, BANTEN",18,43,94,137
https://kawalpemilu.org#52977,"PORIS PLAWAD INDAH, CIPONDOH, KOTA TANGERANG, BANTEN",19,46,142,188
https://kawalpemilu.org#52977,"PORIS PLAWAD INDAH, CIPONDOH, KOTA TANGERANG, BANTEN",20,67,147,214
https://kawalpemilu.org#52977,"PORIS PLAWAD INDAH, CIPONDOH, KOTA TANGERANG, BANTEN",21,63,92,155
https://kawalpemilu.org#52977,"PORIS PLAWAD INDAH, CIPONDOH, KOTA TANGERANG, BANTEN",22,59,119,178
https://kawalpemilu.org#52977,"PORIS PLAWAD INDAH, CIPONDOH, KOTA TANGERANG, BANTEN",23,61,100,161
https://kawalpemilu.org#52977,"PORIS PLAWAD INDAH, CIPONDOH, KOTA TANGERANG, BANTEN",24,48,142,190
https://kawalpemilu.org#52977,"PORIS PLAWAD INDAH, CIPONDOH, KOTA TANGERANG, BANTEN",25,55,140,195
https://kawalpemilu.org#52977,"PORIS PLAWAD INDAH, CIPONDOH, KOTA TANGERANG, BANTEN",26,55,195,250
https://kawalpemilu.org#52977,"PORIS PLAWAD INDAH, CIPONDOH, KOTA TANGERANG, BANTEN",27,55,115,170
https://kawalpemilu.org#52977,"PORIS PLAWAD INDAH, CIPONDOH, KOTA TANGERANG, BANTEN",28,49,131,180
https://kawalpemilu.org#52977,"PORIS PLAWAD INDAH, CIPONDOH, KOTA TANGERANG, BANTEN",29,48,111,159
https://kawalpemilu.org#52977,"PORIS PLAWAD INDAH, CIPONDOH, KOTA TANGERANG, BANTEN",30,73,144,217
https://kawalpemilu.org#52977,"PORIS PLAWAD INDAH, CIPONDOH, KOTA TANGERANG, BANTEN",31,60,134,194
https://kawalpemilu.org#52977,"PORIS PLAWAD INDAH, CIPONDOH, KOTA TANGERANG, BANTEN",32,99,131,230
https://kawalpemilu.org#52977,"PORIS PLAWAD INDAH, CIPONDOH, KOTA TANGERANG, BANTEN",33,111,118,229
https://kawalpemilu.org#52977,"PORIS PLAWAD INDAH, CIPONDOH, KOTA TANGERANG, BANTEN",34,69,136,205
https://kawalpemilu.org#52977,"PORIS PLAWAD INDAH, CIPONDOH, KOTA TANGERANG, BANTEN",36,50,92,142
https://kawalpemilu.org#52977,"PORIS PLAWAD INDAH, CIPONDOH, KOTA TANGERANG, BANTEN",37,128,87,215
https://kawalpemilu.org#52977,"PORIS PLAWAD INDAH, CIPONDOH, KOTA TANGERANG, BANTEN",38,123,75,198
https://kawalpemilu.org#52977,"PORIS PLAWAD INDAH, CIPONDOH, KOTA TANGERANG, BANTEN",39,161,82,243
https://kawalpemilu.org#52977,"PORIS PLAWAD INDAH, CIPONDOH, KOTA TANGERANG, BANTEN",40,132,81,213
https://kawalpemilu.org#52977,"PORIS PLAWAD INDAH, CIPONDOH, KOTA TANGERANG, BANTEN",41,154,32,186
https://kawalpemilu.org#52977,"PORIS PLAWAD INDAH, CIPONDOH, KOTA TANGERANG, BANTEN",42,144,105,249
https://kawalpemilu.org#52977,"PORIS PLAWAD INDAH, CIPONDOH, KOTA TANGERANG, BANTEN",43,181,75,256
https://kawalpemilu.org#52977,"PORIS PLAWAD INDAH, CIPONDOH, KOTA TANGERANG, BANTEN",44,183,48,231
https://kawalpemilu.org#52977,"PORIS PLAWAD INDAH, CIPONDOH, KOTA TANGERANG, BANTEN",45,128,58,186
https://kawalpemilu.org#52977,"PORIS PLAWAD INDAH, CIPONDOH, KOTA TANGERANG, BANTEN",46,104,56,160
https://kawalpemilu.org#52977,"PORIS PLAWAD INDAH, CIPONDOH, KOTA TANGERANG, BANTEN",47,111,98,209
https://kawalpemilu.org#52977,"PORIS PLAWAD INDAH, CIPONDOH, KOTA TANGERANG, BANTEN",48,159,58,217
https://kawalpemilu.org#52977,"PORIS PLAWAD INDAH, CIPONDOH, KOTA TANGERANG, BANTEN",49,149,102,251
https://kawalpemilu.org#52977,"PORIS PLAWAD INDAH, CIPONDOH, KOTA TANGERANG, BANTEN",50,178,52,230
https://kawalpemilu.org#52977,"PORIS PLAWAD INDAH, CIPONDOH, KOTA TANGERANG, BANTEN",51,113,88,201
https://kawalpemilu.org#52977,"PORIS PLAWAD INDAH, CIPONDOH, KOTA TANGERANG, BANTEN",52,126,73,199
https://kawalpemilu.org#52977,"PORIS PLAWAD INDAH, CIPONDOH, KOTA TANGERANG, BANTEN",53,132,59,191
https://kawalpemilu.org#52977,"PORIS PLAWAD INDAH, CIPONDOH, KOTA TANGERANG, BANTEN",54,105,38,143
https://kawalpemilu.org#52977,"PORIS PLAWAD INDAH, CIPONDOH, KOTA TANGERANG, BANTEN",55,142,64,206
https://kawalpemilu.org#52977,"PORIS PLAWAD INDAH, CIPONDOH, KOTA TANGERANG, BANTEN",56,132,34,166
https://kawalpemilu.org#52977,"PORIS PLAWAD INDAH, CIPONDOH, KOTA TANGERANG, BANTEN",57,117,36,153
https://kawalpemilu.org#52977,"PORIS PLAWAD INDAH, CIPONDOH, KOTA TANGERANG, BANTEN",58,176,46,222
https://kawalpemilu.org#52977,"PORIS PLAWAD INDAH, CIPONDOH, KOTA TANGERANG, BANTEN",59,185,47,232
https://kawalpemilu.org#52977,"PORIS PLAWAD INDAH, CIPONDOH, KOTA TANGERANG, BANTEN",60,229,32,261
https://kawalpemilu.org#52977,"PORIS PLAWAD INDAH, CIPONDOH, KOTA TANGERANG, BANTEN",61,237,36,273
https://kawalpemilu.org#52977,"PORIS PLAWAD INDAH, CIPONDOH, KOTA TANGERANG, BANTEN",62,225,30,255
https://kawalpemilu.org#52977,"PORIS PLAWAD INDAH, CIPONDOH, KOTA TANGERANG, BANTEN",63,167,64,231
https://kawalpemilu.org#52977,"PORIS PLAWAD INDAH, CIPONDOH, KOTA TANGERANG, BANTEN",64,141,57,198
https://kawalpemilu.org#52977,"PORIS PLAWAD INDAH, CIPONDOH, KOTA TANGERANG, BANTEN",65,140,66,206
https://kawalpemilu.org#52977,"PORIS PLAWAD INDAH, CIPONDOH, KOTA TANGERANG, BANTEN",66,138,100,238
https://kawalpemilu.org#52977,"PORIS PLAWAD INDAH, CIPONDOH, KOTA TANGERANG, BANTEN",67,141,100,241
https://kawalpemilu.org#52977,"PORIS PLAWAD INDAH, CIPONDOH, KOTA TANGERANG, BANTEN",68,116,101,217
https://kawalpemilu.org#52977,"PORIS PLAWAD INDAH, CIPONDOH, KOTA TANGERANG, BANTEN",69,113,94,207
https://kawalpemilu.org#52977,"PORIS PLAWAD INDAH, CIPONDOH, KOTA TANGERANG, BANTEN",70,104,129,233
https://kawalpemilu.org#52979,"PANINGGILAN, CILEDUG, KOTA TANGERANG, BANTEN",1,78,129,207
https://kawalpemilu.org#52979,"PANINGGILAN, CILEDUG, KOTA TANGERANG, BANTEN",2,79,133,212
https://kawalpemilu.org#52979,"PANINGGILAN, CILEDUG, KOTA TANGERANG, BANTEN",3,89,133,222
https://kawalpemilu.org#52979,"PANINGGILAN, CILEDUG, KOTA TANGERANG, BANTEN",4,84,70,154
https://kawalpemilu.org#52979,"PANINGGILAN, CILEDUG, KOTA TANGERANG, BANTEN",5,96,79,175
https://kawalpemilu.org#52979,"PANINGGILAN, CILEDUG, KOTA TANGERANG, BANTEN",6,57,111,168
https://kawalpemilu.org#52979,"PANINGGILAN, CILEDUG, KOTA TANGERANG, BANTEN",7,57,95,152
https://kawalpemilu.org#52979,"PANINGGILAN, CILEDUG, KOTA TANGERANG, BANTEN",8,69,115,184
https://kawalpemilu.org#52979,"PANINGGILAN, CILEDUG, KOTA TANGERANG, BANTEN",9,88,101,189
https://kawalpemilu.org#52979,"PANINGGILAN, CILEDUG, KOTA TANGERANG, BANTEN",10,99,101,200
https://kawalpemilu.org#52979,"PANINGGILAN, CILEDUG, KOTA TANGERANG, BANTEN",11,40,106,146
https://kawalpemilu.org#52979,"PANINGGILAN, CILEDUG, KOTA TANGERANG, BANTEN",12,52,104,156
https://kawalpemilu.org#52979,"PANINGGILAN, CILEDUG, KOTA TANGERANG, BANTEN",13,72,103,175
https://kawalpemilu.org#52979,"PANINGGILAN, CILEDUG, KOTA TANGERANG, BANTEN",14,74,76,150
https://kawalpemilu.org#52979,"PANINGGILAN, CILEDUG, KOTA TANGERANG, BANTEN",15,69,83,152
https://kawalpemilu.org#52979,"PANINGGILAN, CILEDUG, KOTA TANGERANG, BANTEN",16,72,81,153
https://kawalpemilu.org#52979,"PANINGGILAN, CILEDUG, KOTA TANGERANG, BANTEN",17,85,85,170
https://kawalpemilu.org#52979,"PANINGGILAN, CILEDUG, KOTA TANGERANG, BANTEN",18,83,93,176
https://kawalpemilu.org#52979,"PANINGGILAN, CILEDUG, KOTA TANGERANG, BANTEN",19,94,103,197
https://kawalpemilu.org#52979,"PANINGGILAN, CILEDUG, KOTA TANGERANG, BANTEN",21,74,130,204
https://kawalpemilu.org#52979,"PANINGGILAN, CILEDUG, KOTA TANGERANG, BANTEN",22,77,123,200
https://kawalpemilu.org#52979,"PANINGGILAN, CILEDUG, KOTA TANGERANG, BANTEN",23,100,105,205
https://kawalpemilu.org#52979,"PANINGGILAN, CILEDUG, KOTA TANGERANG, BANTEN",24,95,120,215
https://kawalpemilu.org#52979,"PANINGGILAN, CILEDUG, KOTA TANGERANG, BANTEN",25,80,114,194
https://kawalpemilu.org#52979,"PANINGGILAN, CILEDUG, KOTA TANGERANG, BANTEN",26,94,121,215
https://kawalpemilu.org#52979,"PANINGGILAN, CILEDUG, KOTA TANGERANG, BANTEN",27,104,127,231
https://kawalpemilu.org#52979,"PANINGGILAN, CILEDUG, KOTA TANGERANG, BANTEN",28,70,135,205
https://kawalpemilu.org#52979,"PANINGGILAN, CILEDUG, KOTA TANGERANG, BANTEN",29,108,142,250
https://kawalpemilu.org#52979,"PANINGGILAN, CILEDUG, KOTA TANGERANG, BANTEN",30,47,126,173
https://kawalpemilu.org#52979,"PANINGGILAN, CILEDUG, KOTA TANGERANG, BANTEN",31,44,103,147
https://kawalpemilu.org#52979,"PANINGGILAN, CILEDUG, KOTA TANGERANG, BANTEN",32,77,127,204
https://kawalpemilu.org#52979,"PANINGGILAN, CILEDUG, KOTA TANGERANG, BANTEN",33,87,121,208
https://kawalpemilu.org#52979,"PANINGGILAN, CILEDUG, KOTA TANGERANG, BANTEN",34,113,86,199
https://kawalpemilu.org#52979,"PANINGGILAN, CILEDUG, KOTA TANGERANG, BANTEN",35,104,157,261
https://kawalpemilu.org#52979,"PANINGGILAN, CILEDUG, KOTA TANGERANG, BANTEN",36,113,109,222
https://kawalpemilu.org#52979,"PANINGGILAN, CILEDUG, KOTA TANGERANG, BANTEN",37,85,120,205
https://kawalpemilu.org#52979,"PANINGGILAN, CILEDUG, KOTA TANGERANG, BANTEN",38,87,144,231
https://kawalpemilu.org#52979,"PANINGGILAN, CILEDUG, KOTA TANGERANG, BANTEN",39,67,117,184
https://kawalpemilu.org#52979,"PANINGGILAN, CILEDUG, KOTA TANGERANG, BANTEN",40,93,59,152
https://kawalpemilu.org#52979,"PANINGGILAN, CILEDUG, KOTA TANGERANG, BANTEN",41,79,151,230
https://kawalpemilu.org#52979,"PANINGGILAN, CILEDUG, KOTA TANGERANG, BANTEN",42,85,138,223
https://kawalpemilu.org#52979,"PANINGGILAN, CILEDUG, KOTA TANGERANG, BANTEN",44,92,139,231
https://kawalpemilu.org#52979,"PANINGGILAN, CILEDUG, KOTA TANGERANG, BANTEN",45,95,120,215
https://kawalpemilu.org#52979,"PANINGGILAN, CILEDUG, KOTA TANGERANG, BANTEN",46,68,100,168
https://kawalpemilu.org#52979,"PANINGGILAN, CILEDUG, KOTA TANGERANG, BANTEN",47,54,128,182
https://kawalpemilu.org#52979,"PANINGGILAN, CILEDUG, KOTA TANGERANG, BANTEN",48,81,143,224
https://kawalpemilu.org#52979,"PANINGGILAN, CILEDUG, KOTA TANGERANG, BANTEN",49,78,141,219
https://kawalpemilu.org#52979,"PANINGGILAN, CILEDUG, KOTA TANGERANG, BANTEN",50,58,85,143
https://kawalpemilu.org#52979,"PANINGGILAN, CILEDUG, KOTA TANGERANG, BANTEN",51,131,91,222
https://kawalpemilu.org#52979,"PANINGGILAN, CILEDUG, KOTA TANGERANG, BANTEN",52,115,93,208
https://kawalpemilu.org#52979,"PANINGGILAN, CILEDUG, KOTA TANGERANG, BANTEN",53,56,53,109
https://kawalpemilu.org#52979,"PANINGGILAN, CILEDUG, KOTA TANGERANG, BANTEN",54,104,150,254
https://kawalpemilu.org#52979,"PANINGGILAN, CILEDUG, KOTA TANGERANG, BANTEN",55,130,121,251
https://kawalpemilu.org#52979,"PANINGGILAN, CILEDUG, KOTA TANGERANG, BANTEN",56,121,149,270
https://kawalpemilu.org#52980,"SUDIMARA BARAT, CILEDUG, KOTA TANGERANG, BANTEN",1,82,41,123
https://kawalpemilu.org#52980,"SUDIMARA BARAT, CILEDUG, KOTA TANGERANG, BANTEN",2,144,51,195
https://kawalpemilu.org#52980,"SUDIMARA BARAT, CILEDUG, KOTA TANGERANG, BANTEN",3,151,62,213
https://kawalpemilu.org#52980,"SUDIMARA BARAT, CILEDUG, KOTA TANGERANG, BANTEN",4,155,64,219
https://kawalpemilu.org#52980,"SUDIMARA BARAT, CILEDUG, KOTA TANGERANG, BANTEN",5,151,58,209
https://kawalpemilu.org#52980,"SUDIMARA BARAT, CILEDUG, KOTA TANGERANG, BANTEN",6,48,79,127
https://kawalpemilu.org#52980,"SUDIMARA BARAT, CILEDUG, KOTA TANGERANG, BANTEN",7,92,164,256
https://kawalpemilu.org#52980,"SUDIMARA BARAT, CILEDUG, KOTA TANGERANG, BANTEN",8,121,140,261
https://kawalpemilu.org#52980,"SUDIMARA BARAT, CILEDUG, KOTA TANGERANG, BANTEN",9,85,115,200
https://kawalpemilu.org#52980,"SUDIMARA BARAT, CILEDUG, KOTA TANGERANG, BANTEN",10,99,123,222
https://kawalpemilu.org#52980,"SUDIMARA BARAT, CILEDUG, KOTA TANGERANG, BANTEN",11,113,66,179
https://kawalpemilu.org#52980,"SUDIMARA BARAT, CILEDUG, KOTA TANGERANG, BANTEN",12,115,156,271
https://kawalpemilu.org#52980,"SUDIMARA BARAT, CILEDUG, KOTA TANGERANG, BANTEN",13,98,159,257
https://kawalpemilu.org#52980,"SUDIMARA BARAT, CILEDUG, KOTA TANGERANG, BANTEN",15,79,149,228
https://kawalpemilu.org#52980,"SUDIMARA BARAT, CILEDUG, KOTA TANGERANG, BANTEN",16,87,149,236
https://kawalpemilu.org#52980,"SUDIMARA BARAT, CILEDUG, KOTA TANGERANG, BANTEN",17,71,147,218
https://kawalpemilu.org#52980,"SUDIMARA BARAT, CILEDUG, KOTA TANGERANG, BANTEN",18,84,164,248
https://kawalpemilu.org#52980,"SUDIMARA BARAT, CILEDUG, KOTA TANGERANG, BANTEN",19,103,171,274
https://kawalpemilu.org#52980,"SUDIMARA BARAT, CILEDUG, KOTA TANGERANG, BANTEN",20,109,162,271
https://kawalpemilu.org#52980,"SUDIMARA BARAT, CILEDUG, KOTA TANGERANG, BANTEN",21,124,115,239
https://kawalpemilu.org#52980,"SUDIMARA BARAT, CILEDUG, KOTA TANGERANG, BANTEN",22,91,171,262
https://kawalpemilu.org#52980,"SUDIMARA BARAT, CILEDUG, KOTA TANGERANG, BANTEN",23,72,133,205
https://kawalpemilu.org#52980,"SUDIMARA BARAT, CILEDUG, KOTA TANGERANG, BANTEN",24,93,137,230
https://kawalpemilu.org#52980,"SUDIMARA BARAT, CILEDUG, KOTA TANGERANG, BANTEN",25,72,164,236
https://kawalpemilu.org#52980,"SUDIMARA BARAT, CILEDUG, KOTA TANGERANG, BANTEN",26,52,109,161
https://kawalpemilu.org#52980,"SUDIMARA BARAT, CILEDUG, KOTA TANGERANG, BANTEN",27,95,81,176
https://kawalpemilu.org#52980,"SUDIMARA BARAT, CILEDUG, KOTA TANGERANG, BANTEN",28,94,65,159
https://kawalpemilu.org#52980,"SUDIMARA BARAT, CILEDUG, KOTA TANGERANG, BANTEN",29,118,69,187
https://kawalpemilu.org#52980,"SUDIMARA BARAT, CILEDUG, KOTA TANGERANG, BANTEN",30,143,113,256
https://kawalpemilu.org#52980,"SUDIMARA BARAT, CILEDUG, KOTA TANGERANG, BANTEN",31,43,45,88
https://kawalpemilu.org#52980,"SUDIMARA BARAT, CILEDUG, KOTA TANGERANG, BANTEN",32,109,150,259
https://kawalpemilu.org#52980,"SUDIMARA BARAT, CILEDUG, KOTA TANGERANG, BANTEN",33,141,115,256
https://kawalpemilu.org#52980,"SUDIMARA BARAT, CILEDUG, KOTA TANGERANG, BANTEN",34,132,82,214
https://kawalpemilu.org#52980,"SUDIMARA BARAT, CILEDUG, KOTA TANGERANG, BANTEN",35,126,114,240
https://kawalpemilu.org#52980,"SUDIMARA BARAT, CILEDUG, KOTA TANGERANG, BANTEN",36,167,126,293
https://kawalpemilu.org#52980,"SUDIMARA BARAT, CILEDUG, KOTA TANGERANG, BANTEN",37,139,107,246
https://kawalpemilu.org#52980,"SUDIMARA BARAT, CILEDUG, KOTA TANGERANG, BANTEN",38,99,60,159
https://kawalpemilu.org#52980,"SUDIMARA BARAT, CILEDUG, KOTA TANGERANG, BANTEN",39,62,181,243
https://kawalpemilu.org#52980,"SUDIMARA BARAT, CILEDUG, KOTA TANGERANG, BANTEN",40,61,153,214
https://kawalpemilu.org#52980,"SUDIMARA BARAT, CILEDUG, KOTA TANGERANG, BANTEN",41,71,139,210
https://kawalpemilu.org#52980,"SUDIMARA BARAT, CILEDUG, KOTA TANGERANG, BANTEN",42,97,70,167
https://kawalpemilu.org#52980,"SUDIMARA BARAT, CILEDUG, KOTA TANGERANG, BANTEN",43,80,49,129
https://kawalpemilu.org#52980,"SUDIMARA BARAT, CILEDUG, KOTA TANGERANG, BANTEN",44,85,64,149
https://kawalpemilu.org#52980,"SUDIMARA BARAT, CILEDUG, KOTA TANGERANG, BANTEN",45,100,66,166
https://kawalpemilu.org#52980,"SUDIMARA BARAT, CILEDUG, KOTA TANGERANG, BANTEN",46,89,53,142
https://kawalpemilu.org#52980,"SUDIMARA BARAT, CILEDUG, KOTA TANGERANG, BANTEN",47,76,70,146
https://kawalpemilu.org#52980,"SUDIMARA BARAT, CILEDUG, KOTA TANGERANG, BANTEN",48,68,61,129
https://kawalpemilu.org#52980,"SUDIMARA BARAT, CILEDUG, KOTA TANGERANG, BANTEN",49,156,72,228
https://kawalpemilu.org#52981,"SUDIMARA TIMUR, CILEDUG, KOTA TANGERANG, BANTEN",1,49,44,93
https://kawalpemilu.org#52981,"SUDIMARA TIMUR, CILEDUG, KOTA TANGERANG, BANTEN",2,122,140,262
https://kawalpemilu.org#52981,"SUDIMARA TIMUR, CILEDUG, KOTA TANGERANG, BANTEN",3,77,102,179
https://kawalpemilu.org#52981,"SUDIMARA TIMUR, CILEDUG, KOTA TANGERANG, BANTEN",4,62,83,145
https://kawalpemilu.org#52981,"SUDIMARA TIMUR, CILEDUG, KOTA TANGERANG, BANTEN",5,126,127,253
https://kawalpemilu.org#52981,"SUDIMARA TIMUR, CILEDUG, KOTA TANGERANG, BANTEN",6,66,89,155
https://kawalpemilu.org#52981,"SUDIMARA TIMUR, CILEDUG, KOTA TANGERANG, BANTEN",7,82,53,135
https://kawalpemilu.org#52981,"SUDIMARA TIMUR, CILEDUG, KOTA TANGERANG, BANTEN",8,123,110,233
https://kawalpemilu.org#52981,"SUDIMARA TIMUR, CILEDUG, KOTA TANGERANG, BANTEN",9,68,141,209
https://kawalpemilu.org#52981,"SUDIMARA TIMUR, CILEDUG, KOTA TANGERANG, BANTEN",10,98,61,159
https://kawalpemilu.org#52981,"SUDIMARA TIMUR, CILEDUG, KOTA TANGERANG, BANTEN",11,98,63,161
https://kawalpemilu.org#52981,"SUDIMARA TIMUR, CILEDUG, KOTA TANGERANG, BANTEN",12,136,98,234
https://kawalpemilu.org#52981,"SUDIMARA TIMUR, CILEDUG, KOTA TANGERANG, BANTEN",13,81,105,186
https://kawalpemilu.org#52981,"SUDIMARA TIMUR, CILEDUG, KOTA TANGERANG, BANTEN",14,70,52,122
https://kawalpemilu.org#52981,"SUDIMARA TIMUR, CILEDUG, KOTA TANGERANG, BANTEN",15,137,155,292
https://kawalpemilu.org#52981,"SUDIMARA TIMUR, CILEDUG, KOTA TANGERANG, BANTEN",16,87,95,182
https://kawalpemilu.org#52981,"SUDIMARA TIMUR, CILEDUG, KOTA TANGERANG, BANTEN",17,41,88,129
https://kawalpemilu.org#52981,"SUDIMARA TIMUR, CILEDUG, KOTA TANGERANG, BANTEN",18,108,105,213
https://kawalpemilu.org#52981,"SUDIMARA TIMUR, CILEDUG, KOTA TANGERANG, BANTEN",19,56,79,135
https://kawalpemilu.org#52981,"SUDIMARA TIMUR, CILEDUG, KOTA TANGERANG, BANTEN",20,79,107,186
https://kawalpemilu.org#52981,"SUDIMARA TIMUR, CILEDUG, KOTA TANGERANG, BANTEN",21,74,104,178
https://kawalpemilu.org#52981,"SUDIMARA TIMUR, CILEDUG, KOTA TANGERANG, BANTEN",22,96,71,167
https://kawalpemilu.org#52981,"SUDIMARA TIMUR, CILEDUG, KOTA TANGERANG, BANTEN",23,106,120,226
https://kawalpemilu.org#52981,"SUDIMARA TIMUR, CILEDUG, KOTA TANGERANG, BANTEN",24,47,152,199
https://kawalpemilu.org#52981,"SUDIMARA TIMUR, CILEDUG, KOTA TANGERANG, BANTEN",25,130,120,250
https://kawalpemilu.org#52981,"SUDIMARA TIMUR, CILEDUG, KOTA TANGERANG, BANTEN",26,115,143,258
https://kawalpemilu.org#52981,"SUDIMARA TIMUR, CILEDUG, KOTA TANGERANG, BANTEN",27,67,100,167
https://kawalpemilu.org#52981,"SUDIMARA TIMUR, CILEDUG, KOTA TANGERANG, BANTEN",28,52,95,147
https://kawalpemilu.org#52981,"SUDIMARA TIMUR, CILEDUG, KOTA TANGERANG, BANTEN",29,70,146,216
https://kawalpemilu.org#52981,"SUDIMARA TIMUR, CILEDUG, KOTA TANGERANG, BANTEN",30,121,146,267
https://kawalpemilu.org#52981,"SUDIMARA TIMUR, CILEDUG, KOTA TANGERANG, BANTEN",31,62,100,162
https://kawalpemilu.org#52981,"SUDIMARA TIMUR, CILEDUG, KOTA TANGERANG, BANTEN",32,117,146,263
https://kawalpemilu.org#52981,"SUDIMARA TIMUR, CILEDUG, KOTA TANGERANG, BANTEN",33,66,88,154
https://kawalpemilu.org#52981,"SUDIMARA TIMUR, CILEDUG, KOTA TANGERANG, BANTEN",34,140,109,249
https://kawalpemilu.org#52981,"SUDIMARA TIMUR, CILEDUG, KOTA TANGERANG, BANTEN",35,119,110,229
https://kawalpemilu.org#52982,"TAJUR, CILEDUG, KOTA TANGERANG, BANTEN",1,59,211,270
https://kawalpemilu.org#52982,"TAJUR, CILEDUG, KOTA TANGERANG, BANTEN",2,153,59,212
https://kawalpemilu.org#52982,"TAJUR, CILEDUG, KOTA TANGERANG, BANTEN",3,62,188,250
https://kawalpemilu.org#52982,"TAJUR, CILEDUG, KOTA TANGERANG, BANTEN",4,51,104,155
https://kawalpemilu.org#52982,"TAJUR, CILEDUG, KOTA TANGERANG, BANTEN",5,52,97,149
https://kawalpemilu.org#52982,"TAJUR, CILEDUG, KOTA TANGERANG, BANTEN",6,55,113,168
https://kawalpemilu.org#52982,"TAJUR, CILEDUG, KOTA TANGERANG, BANTEN",7,61,105,166
https://kawalpemilu.org#52982,"TAJUR, CILEDUG, KOTA TANGERANG, BANTEN",8,75,86,161
https://kawalpemilu.org#52982,"TAJUR, CILEDUG, KOTA TANGERANG, BANTEN",9,46,113,159
https://kawalpemilu.org#52982,"TAJUR, CILEDUG, KOTA TANGERANG, BANTEN",10,64,149,213
https://kawalpemilu.org#52982,"TAJUR, CILEDUG, KOTA TANGERANG, BANTEN",11,83,144,227
https://kawalpemilu.org#52982,"TAJUR, CILEDUG, KOTA TANGERANG, BANTEN",12,101,154,255
https://kawalpemilu.org#52982,"TAJUR, CILEDUG, KOTA TANGERANG, BANTEN",13,82,185,267
https://kawalpemilu.org#52982,"TAJUR, CILEDUG, KOTA TANGERANG, BANTEN",14,81,187,268
https://kawalpemilu.org#52982,"TAJUR, CILEDUG, KOTA TANGERANG, BANTEN",15,92,183,275
https://kawalpemilu.org#52982,"TAJUR, CILEDUG, KOTA TANGERANG, BANTEN",16,129,155,284
https://kawalpemilu.org#52982,"TAJUR, CILEDUG, KOTA TANGERANG, BANTEN",17,124,118,242
https://kawalpemilu.org#52982,"TAJUR, CILEDUG, KOTA TANGERANG, BANTEN",18,65,166,231
https://kawalpemilu.org#52982,"TAJUR, CILEDUG, KOTA TANGERANG, BANTEN",19,73,158,231
https://kawalpemilu.org#52982,"TAJUR, CILEDUG, KOTA TANGERANG, BANTEN",20,90,144,234
https://kawalpemilu.org#52982,"TAJUR, CILEDUG, KOTA TANGERANG, BANTEN",21,122,155,277
https://kawalpemilu.org#52982,"TAJUR, CILEDUG, KOTA TANGERANG, BANTEN",22,68,143,211
https://kawalpemilu.org#52982,"TAJUR, CILEDUG, KOTA TANGERANG, BANTEN",23,62,146,208
https://kawalpemilu.org#52982,"TAJUR, CILEDUG, KOTA TANGERANG, BANTEN",24,69,130,199
https://kawalpemilu.org#52982,"TAJUR, CILEDUG, KOTA TANGERANG, BANTEN",25,71,121,192
https://kawalpemilu.org#52982,"TAJUR, CILEDUG, KOTA TANGERANG, BANTEN",26,74,104,178
https://kawalpemilu.org#52982,"TAJUR, CILEDUG, KOTA TANGERANG, BANTEN",27,82,116,198
https://kawalpemilu.org#52982,"TAJUR, CILEDUG, KOTA TANGERANG, BANTEN",28,78,101,179
https://kawalpemilu.org#52982,"TAJUR, CILEDUG, KOTA TANGERANG, BANTEN",29,71,185,256
https://kawalpemilu.org#52982,"TAJUR, CILEDUG, KOTA TANGERANG, BANTEN",30,105,73,178
https://kawalpemilu.org#52982,"TAJUR, CILEDUG, KOTA TANGERANG, BANTEN",31,63,88,151
https://kawalpemilu.org#52982,"TAJUR, CILEDUG, KOTA TANGERANG, BANTEN",32,113,84,197
https://kawalpemilu.org#52982,"TAJUR, CILEDUG, KOTA TANGERANG, BANTEN",33,126,124,250
https://kawalpemilu.org#52982,"TAJUR, CILEDUG, KOTA TANGERANG, BANTEN",34,90,60,150
https://kawalpemilu.org#52982,"TAJUR, CILEDUG, KOTA TANGERANG, BANTEN",35,92,80,172
https://kawalpemilu.org#52982,"TAJUR, CILEDUG, KOTA TANGERANG, BANTEN",36,79,109,188
https://kawalpemilu.org#52982,"TAJUR, CILEDUG, KOTA TANGERANG, BANTEN",37,80,82,162
https://kawalpemilu.org#52982,"TAJUR, CILEDUG, KOTA TANGERANG, BANTEN",38,153,128,281
https://kawalpemilu.org#52982,"TAJUR, CILEDUG, KOTA TANGERANG, BANTEN",39,134,88,222
https://kawalpemilu.org#52982,"TAJUR, CILEDUG, KOTA TANGERANG, BANTEN",40,113,114,227
https://kawalpemilu.org#52982,"TAJUR, CILEDUG, KOTA TANGERANG, BANTEN",41,109,93,202
https://kawalpemilu.org#52982,"TAJUR, CILEDUG, KOTA TANGERANG, BANTEN",42,148,84,232
https://kawalpemilu.org#52982,"TAJUR, CILEDUG, KOTA TANGERANG, BANTEN",43,146,78,224
https://kawalpemilu.org#52982,"TAJUR, CILEDUG, KOTA TANGERANG, BANTEN",44,134,131,265
https://kawalpemilu.org#52982,"TAJUR, CILEDUG, KOTA TANGERANG, BANTEN",45,73,84,157
https://kawalpemilu.org#52982,"TAJUR, CILEDUG, KOTA TANGERANG, BANTEN",46,78,99,177
https://kawalpemilu.org#52982,"TAJUR, CILEDUG, KOTA TANGERANG, BANTEN",47,123,149,272
https://kawalpemilu.org#52982,"TAJUR, CILEDUG, KOTA TANGERANG, BANTEN",48,102,90,192
https://kawalpemilu.org#52982,"TAJUR, CILEDUG, KOTA TANGERANG, BANTEN",49,154,123,277
https://kawalpemilu.org#52983,"PARUNG SERAB, CILEDUG, KOTA TANGERANG, BANTEN",1,70,99,169
https://kawalpemilu.org#52983,"PARUNG SERAB, CILEDUG, KOTA TANGERANG, BANTEN",2,77,111,188
https://kawalpemilu.org#52983,"PARUNG SERAB, CILEDUG, KOTA TANGERANG, BANTEN",3,106,163,269
https://kawalpemilu.org#52983,"PARUNG SERAB, CILEDUG, KOTA TANGERANG, BANTEN",4,88,153,241
https://kawalpemilu.org#52983,"PARUNG SERAB, CILEDUG, KOTA TANGERANG, BANTEN",5,109,166,275
https://kawalpemilu.org#52983,"PARUNG SERAB, CILEDUG, KOTA TANGERANG, BANTEN",6,148,103,251
https://kawalpemilu.org#52983,"PARUNG SERAB, CILEDUG, KOTA TANGERANG, BANTEN",8,109,79,188
https://kawalpemilu.org#52983,"PARUNG SERAB, CILEDUG, KOTA TANGERANG, BANTEN",9,79,136,215
https://kawalpemilu.org#52983,"PARUNG SERAB, CILEDUG, KOTA TANGERANG, BANTEN",11,73,94,167
https://kawalpemilu.org#52983,"PARUNG SERAB, CILEDUG, KOTA TANGERANG, BANTEN",12,85,147,232
https://kawalpemilu.org#52983,"PARUNG SERAB, CILEDUG, KOTA TANGERANG, BANTEN",13,118,96,214
https://kawalpemilu.org#52983,"PARUNG SERAB, CILEDUG, KOTA TANGERANG, BANTEN",14,51,94,145
https://kawalpemilu.org#52983,"PARUNG SERAB, CILEDUG, KOTA TANGERANG, BANTEN",15,84,127,211
https://kawalpemilu.org#52983,"PARUNG SERAB, CILEDUG, KOTA TANGERANG, BANTEN",16,75,131,206
https://kawalpemilu.org#52983,"PARUNG SERAB, CILEDUG, KOTA TANGERANG, BANTEN",20,66,81,147
https://kawalpemilu.org#52983,"PARUNG SERAB, CILEDUG, KOTA TANGERANG, BANTEN",21,68,136,204
https://kawalpemilu.org#52983,"PARUNG SERAB, CILEDUG, KOTA TANGERANG, BANTEN",22,72,150,222
https://kawalpemilu.org#52983,"PARUNG SERAB, CILEDUG, KOTA TANGERANG, BANTEN",23,119,92,211
https://kawalpemilu.org#52983,"PARUNG SERAB, CILEDUG, KOTA TANGERANG, BANTEN",24,67,156,223
https://kawalpemilu.org#52983,"PARUNG SERAB, CILEDUG, KOTA TANGERANG, BANTEN",25,127,92,219
https://kawalpemilu.org#52983,"PARUNG SERAB, CILEDUG, KOTA TANGERANG, BANTEN",26,156,88,244
https://kawalpemilu.org#52983,"PARUNG SERAB, CILEDUG, KOTA TANGERANG, BANTEN",27,116,39,155
https://kawalpemilu.org#52983,"PARUNG SERAB, CILEDUG, KOTA TANGERANG, BANTEN",28,93,149,242
https://kawalpemilu.org#52983,"PARUNG SERAB, CILEDUG, KOTA TANGERANG, BANTEN",29,49,105,154
https://kawalpemilu.org#52983,"PARUNG SERAB, CILEDUG, KOTA TANGERANG, BANTEN",30,57,144,201
https://kawalpemilu.org#52983,"PARUNG SERAB, CILEDUG, KOTA TANGERANG, BANTEN",31,81,104,185
https://kawalpemilu.org#52983,"PARUNG SERAB, CILEDUG, KOTA TANGERANG, BANTEN",32,88,152,240
https://kawalpemilu.org#52983,"PARUNG SERAB, CILEDUG, KOTA TANGERANG, BANTEN",33,83,144,227
https://kawalpemilu.org#52983,"PARUNG SERAB, CILEDUG, KOTA TANGERANG, BANTEN",34,97,147,244
https://kawalpemilu.org#52983,"PARUNG SERAB, CILEDUG, KOTA TANGERANG, BANTEN",35,106,145,251
https://kawalpemilu.org#52983,"PARUNG SERAB, CILEDUG, KOTA TANGERANG, BANTEN",36,77,140,217
https://kawalpemilu.org#52983,"PARUNG SERAB, CILEDUG, KOTA TANGERANG, BANTEN",37,124,90,214
https://kawalpemilu.org#52983,"PARUNG SERAB, CILEDUG, KOTA TANGERANG, BANTEN",38,102,100,202
https://kawalpemilu.org#52983,"PARUNG SERAB, CILEDUG, KOTA TANGERANG, BANTEN",39,132,113,245
https://kawalpemilu.org#52983,"PARUNG SERAB, CILEDUG, KOTA TANGERANG, BANTEN",40,99,135,234
https://kawalpemilu.org#52983,"PARUNG SERAB, CILEDUG, KOTA TANGERANG, BANTEN",41,67,155,222
https://kawalpemilu.org#52983,"PARUNG SERAB, CILEDUG, KOTA TANGERANG, BANTEN",42,92,146,238
https://kawalpemilu.org#52983,"PARUNG SERAB, CILEDUG, KOTA TANGERANG, BANTEN",43,44,116,160
https://kawalpemilu.org#52983,"PARUNG SERAB, CILEDUG, KOTA TANGERANG, BANTEN",44,55,112,167
https://kawalpemilu.org#52983,"PARUNG SERAB, CILEDUG, KOTA TANGERANG, BANTEN",45,71,146,217
https://kawalpemilu.org#52983,"PARUNG SERAB, CILEDUG, KOTA TANGERANG, BANTEN",46,113,151,264
https://kawalpemilu.org#52983,"PARUNG SERAB, CILEDUG, KOTA TANGERANG, BANTEN",47,54,148,202
https://kawalpemilu.org#52984,"SUDIMARA JAYA, CILEDUG, KOTA TANGERANG, BANTEN",3,87,189,276
https://kawalpemilu.org#52984,"SUDIMARA JAYA, CILEDUG, KOTA TANGERANG, BANTEN",7,82,98,180
https://kawalpemilu.org#52984,"SUDIMARA JAYA, CILEDUG, KOTA TANGERANG, BANTEN",10,98,109,207
https://kawalpemilu.org#52984,"SUDIMARA JAYA, CILEDUG, KOTA TANGERANG, BANTEN",11,80,145,225
https://kawalpemilu.org#52984,"SUDIMARA JAYA, CILEDUG, KOTA TANGERANG, BANTEN",12,70,157,227
https://kawalpemilu.org#52984,"SUDIMARA JAYA, CILEDUG, KOTA TANGERANG, BANTEN",13,77,77,154
https://kawalpemilu.org#52984,"SUDIMARA JAYA, CILEDUG, KOTA TANGERANG, BANTEN",14,41,109,150
https://kawalpemilu.org#52984,"SUDIMARA JAYA, CILEDUG, KOTA TANGERANG, BANTEN",15,57,98,155
https://kawalpemilu.org#52984,"SUDIMARA JAYA, CILEDUG, KOTA TANGERANG, BANTEN",16,58,108,166
https://kawalpemilu.org#52984,"SUDIMARA JAYA, CILEDUG, KOTA TANGERANG, BANTEN",17,93,61,154
https://kawalpemilu.org#52984,"SUDIMARA JAYA, CILEDUG, KOTA TANGERANG, BANTEN",18,89,75,164
https://kawalpemilu.org#52984,"SUDIMARA JAYA, CILEDUG, KOTA TANGERANG, BANTEN",19,49,98,147
https://kawalpemilu.org#52984,"SUDIMARA JAYA, CILEDUG, KOTA TANGERANG, BANTEN",20,91,65,156
https://kawalpemilu.org#52984,"SUDIMARA JAYA, CILEDUG, KOTA TANGERANG, BANTEN",21,117,99,261
https://kawalpemilu.org#52984,"SUDIMARA JAYA, CILEDUG, KOTA TANGERANG, BANTEN",22,56,84,140
https://kawalpemilu.org#52984,"SUDIMARA JAYA, CILEDUG, KOTA TANGERANG, BANTEN",23,124,116,240
https://kawalpemilu.org#52984,"SUDIMARA JAYA, CILEDUG, KOTA TANGERANG, BANTEN",24,58,107,165
https://kawalpemilu.org#52984,"SUDIMARA JAYA, CILEDUG, KOTA TANGERANG, BANTEN",25,66,95,161
https://kawalpemilu.org#52984,"SUDIMARA JAYA, CILEDUG, KOTA TANGERANG, BANTEN",26,82,109,191
https://kawalpemilu.org#52984,"SUDIMARA JAYA, CILEDUG, KOTA TANGERANG, BANTEN",27,86,101,187
https://kawalpemilu.org#52984,"SUDIMARA JAYA, CILEDUG, KOTA TANGERANG, BANTEN",28,86,88,174
https://kawalpemilu.org#52984,"SUDIMARA JAYA, CILEDUG, KOTA TANGERANG, BANTEN",29,87,146,233
https://kawalpemilu.org#52984,"SUDIMARA JAYA, CILEDUG, KOTA TANGERANG, BANTEN",30,137,99,236
https://kawalpemilu.org#52984,"SUDIMARA JAYA, CILEDUG, KOTA TANGERANG, BANTEN",31,80,66,146
https://kawalpemilu.org#52984,"SUDIMARA JAYA, CILEDUG, KOTA TANGERANG, BANTEN",32,110,65,175
https://kawalpemilu.org#52984,"SUDIMARA JAYA, CILEDUG, KOTA TANGERANG, BANTEN",33,125,147,272
https://kawalpemilu.org#52984,"SUDIMARA JAYA, CILEDUG, KOTA TANGERANG, BANTEN",34,79,116,195
https://kawalpemilu.org#52984,"SUDIMARA JAYA, CILEDUG, KOTA TANGERANG, BANTEN",35,127,152,279
https://kawalpemilu.org#52984,"SUDIMARA JAYA, CILEDUG, KOTA TANGERANG, BANTEN",36,120,94,214
https://kawalpemilu.org#52984,"SUDIMARA JAYA, CILEDUG, KOTA TANGERANG, BANTEN",37,114,115,229
https://kawalpemilu.org#52984,"SUDIMARA JAYA, CILEDUG, KOTA TANGERANG, BANTEN",38,131,106,237
https://kawalpemilu.org#52984,"SUDIMARA JAYA, CILEDUG, KOTA TANGERANG, BANTEN",39,132,97,229
https://kawalpemilu.org#52984,"SUDIMARA JAYA, CILEDUG, KOTA TANGERANG, BANTEN",40,130,101,231
https://kawalpemilu.org#52984,"SUDIMARA JAYA, CILEDUG, KOTA TANGERANG, BANTEN",41,120,135,255
https://kawalpemilu.org#52984,"SUDIMARA JAYA, CILEDUG, KOTA TANGERANG, BANTEN",42,83,126,209
https://kawalpemilu.org#52984,"SUDIMARA JAYA, CILEDUG, KOTA TANGERANG, BANTEN",43,66,72,138
https://kawalpemilu.org#52984,"SUDIMARA JAYA, CILEDUG, KOTA TANGERANG, BANTEN",44,97,86,183
https://kawalpemilu.org#52984,"SUDIMARA JAYA, CILEDUG, KOTA TANGERANG, BANTEN",45,124,65,189
https://kawalpemilu.org#52984,"SUDIMARA JAYA, CILEDUG, KOTA TANGERANG, BANTEN",46,72,177,249
https://kawalpemilu.org#52984,"SUDIMARA JAYA, CILEDUG, KOTA TANGERANG, BANTEN",47,106,140,246
https://kawalpemilu.org#52984,"SUDIMARA JAYA, CILEDUG, KOTA TANGERANG, BANTEN",48,117,87,204
https://kawalpemilu.org#52984,"SUDIMARA JAYA, CILEDUG, KOTA TANGERANG, BANTEN",49,100,82,182
https://kawalpemilu.org#52984,"SUDIMARA JAYA, CILEDUG, KOTA TANGERANG, BANTEN",50,79,74,153
https://kawalpemilu.org#52984,"SUDIMARA JAYA, CILEDUG, KOTA TANGERANG, BANTEN",51,88,81,169
https://kawalpemilu.org#52984,"SUDIMARA JAYA, CILEDUG, KOTA TANGERANG, BANTEN",52,120,139,259
https://kawalpemilu.org#52984,"SUDIMARA JAYA, CILEDUG, KOTA TANGERANG, BANTEN",53,84,178,262
https://kawalpemilu.org#52984,"SUDIMARA JAYA, CILEDUG, KOTA TANGERANG, BANTEN",54,107,147,254
https://kawalpemilu.org#52984,"SUDIMARA JAYA, CILEDUG, KOTA TANGERANG, BANTEN",56,124,133,257
https://kawalpemilu.org#52984,"SUDIMARA JAYA, CILEDUG, KOTA TANGERANG, BANTEN",57,153,82,235
https://kawalpemilu.org#52984,"SUDIMARA JAYA, CILEDUG, KOTA TANGERANG, BANTEN",58,92,75,167
https://kawalpemilu.org#52984,"SUDIMARA JAYA, CILEDUG, KOTA TANGERANG, BANTEN",59,96,62,158
https://kawalpemilu.org#52984,"SUDIMARA JAYA, CILEDUG, KOTA TANGERANG, BANTEN",60,79,116,195
https://kawalpemilu.org#52984,"SUDIMARA JAYA, CILEDUG, KOTA TANGERANG, BANTEN",61,123,66,189
https://kawalpemilu.org#52984,"SUDIMARA JAYA, CILEDUG, KOTA TANGERANG, BANTEN",62,75,53,128
https://kawalpemilu.org#52984,"SUDIMARA JAYA, CILEDUG, KOTA TANGERANG, BANTEN",63,92,82,174
https://kawalpemilu.org#52984,"SUDIMARA JAYA, CILEDUG, KOTA TANGERANG, BANTEN",64,91,84,175
https://kawalpemilu.org#52984,"SUDIMARA JAYA, CILEDUG, KOTA TANGERANG, BANTEN",65,46,105,151
https://kawalpemilu.org#52985,"SUDIMARA SELATAN, CILEDUG, KOTA TANGERANG, BANTEN",1,164,54,218
https://kawalpemilu.org#52985,"SUDIMARA SELATAN, CILEDUG, KOTA TANGERANG, BANTEN",2,67,138,205
https://kawalpemilu.org#52985,"SUDIMARA SELATAN, CILEDUG, KOTA TANGERANG, BANTEN",3,81,116,197
https://kawalpemilu.org#52985,"SUDIMARA SELATAN, CILEDUG, KOTA TANGERANG, BANTEN",4,107,150,257
https://kawalpemilu.org#52985,"SUDIMARA SELATAN, CILEDUG, KOTA TANGERANG, BANTEN",6,80,144,224
https://kawalpemilu.org#52985,"SUDIMARA SELATAN, CILEDUG, KOTA TANGERANG, BANTEN",7,70,138,208
https://kawalpemilu.org#52985,"SUDIMARA SELATAN, CILEDUG, KOTA TANGERANG, BANTEN",8,93,96,189
https://kawalpemilu.org#52985,"SUDIMARA SELATAN, CILEDUG, KOTA TANGERANG, BANTEN",9,82,129,211
https://kawalpemilu.org#52985,"SUDIMARA SELATAN, CILEDUG, KOTA TANGERANG, BANTEN",10,88,113,201
https://kawalpemilu.org#52985,"SUDIMARA SELATAN, CILEDUG, KOTA TANGERANG, BANTEN",12,100,142,242
https://kawalpemilu.org#52985,"SUDIMARA SELATAN, CILEDUG, KOTA TANGERANG, BANTEN",13,56,166,222
https://kawalpemilu.org#52985,"SUDIMARA SELATAN, CILEDUG, KOTA TANGERANG, BANTEN",15,60,105,165
https://kawalpemilu.org#52985,"SUDIMARA SELATAN, CILEDUG, KOTA TANGERANG, BANTEN",19,114,108,222
https://kawalpemilu.org#52985,"SUDIMARA SELATAN, CILEDUG, KOTA TANGERANG, BANTEN",20,74,112,186
https://kawalpemilu.org#52985,"SUDIMARA SELATAN, CILEDUG, KOTA TANGERANG, BANTEN",21,74,103,177
https://kawalpemilu.org#52985,"SUDIMARA SELATAN, CILEDUG, KOTA TANGERANG, BANTEN",23,66,135,201
https://kawalpemilu.org#52985,"SUDIMARA SELATAN, CILEDUG, KOTA TANGERANG, BANTEN",25,50,121,171
https://kawalpemilu.org#52985,"SUDIMARA SELATAN, CILEDUG, KOTA TANGERANG, BANTEN",26,78,142,220
https://kawalpemilu.org#52985,"SUDIMARA SELATAN, CILEDUG, KOTA TANGERANG, BANTEN",28,55,125,180
https://kawalpemilu.org#52985,"SUDIMARA SELATAN, CILEDUG, KOTA TANGERANG, BANTEN",29,50,121,171
https://kawalpemilu.org#52985,"SUDIMARA SELATAN, CILEDUG, KOTA TANGERANG, BANTEN",30,53,133,186
https://kawalpemilu.org#52985,"SUDIMARA SELATAN, CILEDUG, KOTA TANGERANG, BANTEN",31,37,139,176
https://kawalpemilu.org#52985,"SUDIMARA SELATAN, CILEDUG, KOTA TANGERANG, BANTEN",32,53,112,165
https://kawalpemilu.org#52985,"SUDIMARA SELATAN, CILEDUG, KOTA TANGERANG, BANTEN",33,30,125,155
https://kawalpemilu.org#52985,"SUDIMARA SELATAN, CILEDUG, KOTA TANGERANG, BANTEN",34,63,94,157
https://kawalpemilu.org#52985,"SUDIMARA SELATAN, CILEDUG, KOTA TANGERANG, BANTEN",35,74,77,151
https://kawalpemilu.org#52985,"SUDIMARA SELATAN, CILEDUG, KOTA TANGERANG, BANTEN",37,75,85,160
https://kawalpemilu.org#52985,"SUDIMARA SELATAN, CILEDUG, KOTA TANGERANG, BANTEN",38,45,114,159
https://kawalpemilu.org#52985,"SUDIMARA SELATAN, CILEDUG, KOTA TANGERANG, BANTEN",41,43,97,140
https://kawalpemilu.org#52985,"SUDIMARA SELATAN, CILEDUG, KOTA TANGERANG, BANTEN",42,44,175,219
https://kawalpemilu.org#52985,"SUDIMARA SELATAN, CILEDUG, KOTA TANGERANG, BANTEN",43,50,192,242
https://kawalpemilu.org#52985,"SUDIMARA SELATAN, CILEDUG, KOTA TANGERANG, BANTEN",44,69,145,214
https://kawalpemilu.org#52985,"SUDIMARA SELATAN, CILEDUG, KOTA TANGERANG, BANTEN",46,198,76,274
https://kawalpemilu.org#52985,"SUDIMARA SELATAN, CILEDUG, KOTA TANGERANG, BANTEN",48,129,31,160
https://kawalpemilu.org#52986,"PANINGGILAN UTARA, CILEDUG, KOTA TANGERANG, BANTEN",1,75,178,253
https://kawalpemilu.org#52986,"PANINGGILAN UTARA, CILEDUG, KOTA TANGERANG, BANTEN",2,66,189,255
https://kawalpemilu.org#52986,"PANINGGILAN UTARA, CILEDUG, KOTA TANGERANG, BANTEN",3,45,120,165
https://kawalpemilu.org#52986,"PANINGGILAN UTARA, CILEDUG, KOTA TANGERANG, BANTEN",4,39,108,147
https://kawalpemilu.org#52986,"PANINGGILAN UTARA, CILEDUG, KOTA TANGERANG, BANTEN",5,139,100,239
https://kawalpemilu.org#52986,"PANINGGILAN UTARA, CILEDUG, KOTA TANGERANG, BANTEN",6,91,133,224
https://kawalpemilu.org#52986,"PANINGGILAN UTARA, CILEDUG, KOTA TANGERANG, BANTEN",8,123,148,271
https://kawalpemilu.org#52986,"PANINGGILAN UTARA, CILEDUG, KOTA TANGERANG, BANTEN",9,122,99,211
https://kawalpemilu.org#52986,"PANINGGILAN UTARA, CILEDUG, KOTA TANGERANG, BANTEN",10,119,86,205
https://kawalpemilu.org#52986,"PANINGGILAN UTARA, CILEDUG, KOTA TANGERANG, BANTEN",11,172,100,272
https://kawalpemilu.org#52986,"PANINGGILAN UTARA, CILEDUG, KOTA TANGERANG, BANTEN",16,121,105,226
https://kawalpemilu.org#52986,"PANINGGILAN UTARA, CILEDUG, KOTA TANGERANG, BANTEN",17,102,95,197
https://kawalpemilu.org#52986,"PANINGGILAN UTARA, CILEDUG, KOTA TANGERANG, BANTEN",18,148,117,265
https://kawalpemilu.org#52986,"PANINGGILAN UTARA, CILEDUG, KOTA TANGERANG, BANTEN",19,97,170,267
https://kawalpemilu.org#52986,"PANINGGILAN UTARA, CILEDUG, KOTA TANGERANG, BANTEN",20,70,91,161
https://kawalpemilu.org#52986,"PANINGGILAN UTARA, CILEDUG, KOTA TANGERANG, BANTEN",21,68,85,153
https://kawalpemilu.org#52986,"PANINGGILAN UTARA, CILEDUG, KOTA TANGERANG, BANTEN",22,93,92,185
https://kawalpemilu.org#52986,"PANINGGILAN UTARA, CILEDUG, KOTA TANGERANG, BANTEN",23,90,99,189
https://kawalpemilu.org#52986,"PANINGGILAN UTARA, CILEDUG, KOTA TANGERANG, BANTEN",24,86,88,174
https://kawalpemilu.org#52986,"PANINGGILAN UTARA, CILEDUG, KOTA TANGERANG, BANTEN",25,90,110,200
https://kawalpemilu.org#52986,"PANINGGILAN UTARA, CILEDUG, KOTA TANGERANG, BANTEN",26,67,98,165
https://kawalpemilu.org#52986,"PANINGGILAN UTARA, CILEDUG, KOTA TANGERANG, BANTEN",27,101,142,243
https://kawalpemilu.org#52986,"PANINGGILAN UTARA, CILEDUG, KOTA TANGERANG, BANTEN",28,65,144,209
https://kawalpemilu.org#52986,"PANINGGILAN UTARA, CILEDUG, KOTA TANGERANG, BANTEN",29,90,189,279
https://kawalpemilu.org#52986,"PANINGGILAN UTARA, CILEDUG, KOTA TANGERANG, BANTEN",30,122,116,238
https://kawalpemilu.org#52986,"PANINGGILAN UTARA, CILEDUG, KOTA TANGERANG, BANTEN",31,116,105,221
https://kawalpemilu.org#52986,"PANINGGILAN UTARA, CILEDUG, KOTA TANGERANG, BANTEN",32,117,73,190
https://kawalpemilu.org#52986,"PANINGGILAN UTARA, CILEDUG, KOTA TANGERANG, BANTEN",33,140,121,261
https://kawalpemilu.org#52986,"PANINGGILAN UTARA, CILEDUG, KOTA TANGERANG, BANTEN",34,97,164,261
https://kawalpemilu.org#52986,"PANINGGILAN UTARA, CILEDUG, KOTA TANGERANG, BANTEN",35,57,142,199
https://kawalpemilu.org#52986,"PANINGGILAN UTARA, CILEDUG, KOTA TANGERANG, BANTEN",36,58,145,203
https://kawalpemilu.org#52986,"PANINGGILAN UTARA, CILEDUG, KOTA TANGERANG, BANTEN",37,35,58,93
https://kawalpemilu.org#52986,"PANINGGILAN UTARA, CILEDUG, KOTA TANGERANG, BANTEN",38,109,168,277
https://kawalpemilu.org#52986,"PANINGGILAN UTARA, CILEDUG, KOTA TANGERANG, BANTEN",39,149,85,234
https://kawalpemilu.org#52986,"PANINGGILAN UTARA, CILEDUG, KOTA TANGERANG, BANTEN",40,81,98,179
https://kawalpemilu.org#52986,"PANINGGILAN UTARA, CILEDUG, KOTA TANGERANG, BANTEN",41,89,84,173
https://kawalpemilu.org#52986,"PANINGGILAN UTARA, CILEDUG, KOTA TANGERANG, BANTEN",42,89,184,273
https://kawalpemilu.org#52986,"PANINGGILAN UTARA, CILEDUG, KOTA TANGERANG, BANTEN",43,99,97,196
https://kawalpemilu.org#52986,"PANINGGILAN UTARA, CILEDUG, KOTA TANGERANG, BANTEN",44,135,99,234
https://kawalpemilu.org#52986,"PANINGGILAN UTARA, CILEDUG, KOTA TANGERANG, BANTEN",45,98,81,179
https://kawalpemilu.org#52986,"PANINGGILAN UTARA, CILEDUG, KOTA TANGERANG, BANTEN",46,82,62,144
https://kawalpemilu.org#52986,"PANINGGILAN UTARA, CILEDUG, KOTA TANGERANG, BANTEN",47,95,94,189
https://kawalpemilu.org#52986,"PANINGGILAN UTARA, CILEDUG, KOTA TANGERANG, BANTEN",48,123,117,240
https://kawalpemilu.org#52986,"PANINGGILAN UTARA, CILEDUG, KOTA TANGERANG, BANTEN",49,139,117,256
https://kawalpemilu.org#52986,"PANINGGILAN UTARA, CILEDUG, KOTA TANGERANG, BANTEN",50,102,96,198
https://kawalpemilu.org#52988,"KARAWACI, KARAWACI, KOTA TANGERANG, BANTEN",1,77,146,223
https://kawalpemilu.org#52988,"KARAWACI, KARAWACI, KOTA TANGERANG, BANTEN",2,156,29,185
https://kawalpemilu.org#52988,"KARAWACI, KARAWACI, KOTA TANGERANG, BANTEN",3,172,24,196
https://kawalpemilu.org#52988,"KARAWACI, KARAWACI, KOTA TANGERANG, BANTEN",4,81,78,159
https://kawalpemilu.org#52988,"KARAWACI, KARAWACI, KOTA TANGERANG, BANTEN",5,61,84,145
https://kawalpemilu.org#52988,"KARAWACI, KARAWACI, KOTA TANGERANG, BANTEN",6,68,61,129
https://kawalpemilu.org#52988,"KARAWACI, KARAWACI, KOTA TANGERANG, BANTEN",7,137,11,148
https://kawalpemilu.org#52988,"KARAWACI, KARAWACI, KOTA TANGERANG, BANTEN",9,68,110,178
https://kawalpemilu.org#52988,"KARAWACI, KARAWACI, KOTA TANGERANG, BANTEN",10,97,93,190
https://kawalpemilu.org#52988,"KARAWACI, KARAWACI, KOTA TANGERANG, BANTEN",11,114,73,187
https://kawalpemilu.org#52988,"KARAWACI, KARAWACI, KOTA TANGERANG, BANTEN",12,88,91,179
https://kawalpemilu.org#52988,"KARAWACI, KARAWACI, KOTA TANGERANG, BANTEN",13,89,96,185
https://kawalpemilu.org#52988,"KARAWACI, KARAWACI, KOTA TANGERANG, BANTEN",14,110,58,168
https://kawalpemilu.org#52988,"KARAWACI, KARAWACI, KOTA TANGERANG, BANTEN",15,133,68,201
https://kawalpemilu.org#52988,"KARAWACI, KARAWACI, KOTA TANGERANG, BANTEN",16,131,48,179
https://kawalpemilu.org#52988,"KARAWACI, KARAWACI, KOTA TANGERANG, BANTEN",17,99,71,170
https://kawalpemilu.org#52988,"KARAWACI, KARAWACI, KOTA TANGERANG, BANTEN",18,78,85,163
https://kawalpemilu.org#52988,"KARAWACI, KARAWACI, KOTA TANGERANG, BANTEN",19,139,48,187
https://kawalpemilu.org#52988,"KARAWACI, KARAWACI, KOTA TANGERANG, BANTEN",20,205,13,218
https://kawalpemilu.org#52988,"KARAWACI, KARAWACI, KOTA TANGERANG, BANTEN",22,101,102,203
https://kawalpemilu.org#52988,"KARAWACI, KARAWACI, KOTA TANGERANG, BANTEN",23,113,96,209
https://kawalpemilu.org#52988,"KARAWACI, KARAWACI, KOTA TANGERANG, BANTEN",24,122,66,188
https://kawalpemilu.org#52989,"BOJONG JAYA, KARAWACI, KOTA TANGERANG, BANTEN",1,205,51,256
https://kawalpemilu.org#52989,"BOJONG JAYA, KARAWACI, KOTA TANGERANG, BANTEN",2,192,59,251
https://kawalpemilu.org#52989,"BOJONG JAYA, KARAWACI, KOTA TANGERANG, BANTEN",3,152,55,207
https://kawalpemilu.org#52989,"BOJONG JAYA, KARAWACI, KOTA TANGERANG, BANTEN",4,209,58,267
https://kawalpemilu.org#52989,"BOJONG JAYA, KARAWACI, KOTA TANGERANG, BANTEN",5,147,56,203
https://kawalpemilu.org#52989,"BOJONG JAYA, KARAWACI, KOTA TANGERANG, BANTEN",6,68,61,129
https://kawalpemilu.org#52989,"BOJONG JAYA, KARAWACI, KOTA TANGERANG, BANTEN",7,73,97,170
https://kawalpemilu.org#52989,"BOJONG JAYA, KARAWACI, KOTA TANGERANG, BANTEN",8,133,143,276
https://kawalpemilu.org#52989,"BOJONG JAYA, KARAWACI, KOTA TANGERANG, BANTEN",9,137,148,285
https://kawalpemilu.org#52989,"BOJONG JAYA, KARAWACI, KOTA TANGERANG, BANTEN",10,107,122,229
https://kawalpemilu.org#52989,"BOJONG JAYA, KARAWACI, KOTA TANGERANG, BANTEN",11,137,145,282
https://kawalpemilu.org#52989,"BOJONG JAYA, KARAWACI, KOTA TANGERANG, BANTEN",12,122,147,269
https://kawalpemilu.org#52989,"BOJONG JAYA, KARAWACI, KOTA TANGERANG, BANTEN",13,151,146,297
https://kawalpemilu.org#52989,"BOJONG JAYA, KARAWACI, KOTA TANGERANG, BANTEN",14,65,96,161
https://kawalpemilu.org#52989,"BOJONG JAYA, KARAWACI, KOTA TANGERANG, BANTEN",15,82,98,180
https://kawalpemilu.org#52989,"BOJONG JAYA, KARAWACI, KOTA TANGERANG, BANTEN",16,90,113,203
https://kawalpemilu.org#52989,"BOJONG JAYA, KARAWACI, KOTA TANGERANG, BANTEN",17,86,134,220
https://kawalpemilu.org#52989,"BOJONG JAYA, KARAWACI, KOTA TANGERANG, BANTEN",18,100,140,240
https://kawalpemilu.org#52989,"BOJONG JAYA, KARAWACI, KOTA TANGERANG, BANTEN",19,108,133,241
https://kawalpemilu.org#52989,"BOJONG JAYA, KARAWACI, KOTA TANGERANG, BANTEN",20,215,57,272
https://kawalpemilu.org#52990,"KARAWACI BARU, KARAWACI, KOTA TANGERANG, BANTEN",1,86,166,252
https://kawalpemilu.org#52990,"KARAWACI BARU, KARAWACI, KOTA TANGERANG, BANTEN",2,113,123,236
https://kawalpemilu.org#52990,"KARAWACI BARU, KARAWACI, KOTA TANGERANG, BANTEN",3,78,98,176
https://kawalpemilu.org#52990,"KARAWACI BARU, KARAWACI, KOTA TANGERANG, BANTEN",4,106,125,231
https://kawalpemilu.org#52990,"KARAWACI BARU, KARAWACI, KOTA TANGERANG, BANTEN",5,99,117,216
https://kawalpemilu.org#52990,"KARAWACI BARU, KARAWACI, KOTA TANGERANG, BANTEN",6,65,92,157
https://kawalpemilu.org#52990,"KARAWACI BARU, KARAWACI, KOTA TANGERANG, BANTEN",7,98,108,206
https://kawalpemilu.org#52990,"KARAWACI BARU, KARAWACI, KOTA TANGERANG, BANTEN",8,80,145,225
https://kawalpemilu.org#52990,"KARAWACI BARU, KARAWACI, KOTA TANGERANG, BANTEN",9,72,136,208
https://kawalpemilu.org#52990,"KARAWACI BARU, KARAWACI, KOTA TANGERANG, BANTEN",10,81,90,171
https://kawalpemilu.org#52990,"KARAWACI BARU, KARAWACI, KOTA TANGERANG, BANTEN",11,101,97,198
https://kawalpemilu.org#52990,"KARAWACI BARU, KARAWACI, KOTA TANGERANG, BANTEN",12,138,92,230
https://kawalpemilu.org#52990,"KARAWACI BARU, KARAWACI, KOTA TANGERANG, BANTEN",13,83,140,223
https://kawalpemilu.org#52990,"KARAWACI BARU, KARAWACI, KOTA TANGERANG, BANTEN",14,98,151,249
https://kawalpemilu.org#52990,"KARAWACI BARU, KARAWACI, KOTA TANGERANG, BANTEN",15,108,143,251
https://kawalpemilu.org#52990,"KARAWACI BARU, KARAWACI, KOTA TANGERANG, BANTEN",16,58,132,190
https://kawalpemilu.org#52990,"KARAWACI BARU, KARAWACI, KOTA TANGERANG, BANTEN",17,87,158,245
https://kawalpemilu.org#52990,"KARAWACI BARU, KARAWACI, KOTA TANGERANG, BANTEN",18,65,112,177
https://kawalpemilu.org#52990,"KARAWACI BARU, KARAWACI, KOTA TANGERANG, BANTEN",19,77,91,168
https://kawalpemilu.org#52990,"KARAWACI BARU, KARAWACI, KOTA TANGERANG, BANTEN",20,73,89,162
https://kawalpemilu.org#52990,"KARAWACI BARU, KARAWACI, KOTA TANGERANG, BANTEN",21,68,94,162
https://kawalpemilu.org#52990,"KARAWACI BARU, KARAWACI, KOTA TANGERANG, BANTEN",22,67,114,181
https://kawalpemilu.org#52990,"KARAWACI BARU, KARAWACI, KOTA TANGERANG, BANTEN",23,111,87,198
https://kawalpemilu.org#52990,"KARAWACI BARU, KARAWACI, KOTA TANGERANG, BANTEN",24,93,156,249
https://kawalpemilu.org#52990,"KARAWACI BARU, KARAWACI, KOTA TANGERANG, BANTEN",25,96,147,243
https://kawalpemilu.org#52990,"KARAWACI BARU, KARAWACI, KOTA TANGERANG, BANTEN",26,72,120,192
https://kawalpemilu.org#52990,"KARAWACI BARU, KARAWACI, KOTA TANGERANG, BANTEN",27,106,111,217
https://kawalpemilu.org#52990,"KARAWACI BARU, KARAWACI, KOTA TANGERANG, BANTEN",28,108,119,227
https://kawalpemilu.org#52990,"KARAWACI BARU, KARAWACI, KOTA TANGERANG, BANTEN",29,93,112,205
https://kawalpemilu.org#52990,"KARAWACI BARU, KARAWACI, KOTA TANGERANG, BANTEN",30,76,93,169
https://kawalpemilu.org#52990,"KARAWACI BARU, KARAWACI, KOTA TANGERANG, BANTEN",31,107,131,238
https://kawalpemilu.org#52990,"KARAWACI BARU, KARAWACI, KOTA TANGERANG, BANTEN",32,116,100,216
https://kawalpemilu.org#52990,"KARAWACI BARU, KARAWACI, KOTA TANGERANG, BANTEN",33,94,93,187
https://kawalpemilu.org#52990,"KARAWACI BARU, KARAWACI, KOTA TANGERANG, BANTEN",34,99,98,197
https://kawalpemilu.org#52990,"KARAWACI BARU, KARAWACI, KOTA TANGERANG, BANTEN",35,81,123,204
https://kawalpemilu.org#52990,"KARAWACI BARU, KARAWACI, KOTA TANGERANG, BANTEN",36,68,102,170
https://kawalpemilu.org#52990,"KARAWACI BARU, KARAWACI, KOTA TANGERANG, BANTEN",37,105,86,191
https://kawalpemilu.org#52990,"KARAWACI BARU, KARAWACI, KOTA TANGERANG, BANTEN",38,75,90,165
https://kawalpemilu.org#52990,"KARAWACI BARU, KARAWACI, KOTA TANGERANG, BANTEN",39,98,93,191
https://kawalpemilu.org#52990,"KARAWACI BARU, KARAWACI, KOTA TANGERANG, BANTEN",40,98,107,205
https://kawalpemilu.org#52990,"KARAWACI BARU, KARAWACI, KOTA TANGERANG, BANTEN",41,117,69,186
https://kawalpemilu.org#52990,"KARAWACI BARU, KARAWACI, KOTA TANGERANG, BANTEN",42,85,110,195
https://kawalpemilu.org#52990,"KARAWACI BARU, KARAWACI, KOTA TANGERANG, BANTEN",43,86,93,179
https://kawalpemilu.org#52990,"KARAWACI BARU, KARAWACI, KOTA TANGERANG, BANTEN",44,117,42,159
https://kawalpemilu.org#52990,"KARAWACI BARU, KARAWACI, KOTA TANGERANG, BANTEN",45,87,57,144
https://kawalpemilu.org#52990,"KARAWACI BARU, KARAWACI, KOTA TANGERANG, BANTEN",46,92,80,172
https://kawalpemilu.org#52991,"NUSA JAYA, KARAWACI, KOTA TANGERANG, BANTEN",1,45,61,106
https://kawalpemilu.org#52991,"NUSA JAYA, KARAWACI, KOTA TANGERANG, BANTEN",2,56,62,118
https://kawalpemilu.org#52991,"NUSA JAYA, KARAWACI, KOTA TANGERANG, BANTEN",3,39,105,144
https://kawalpemilu.org#52991,"NUSA JAYA, KARAWACI, KOTA TANGERANG, BANTEN",4,46,70,116
https://kawalpemilu.org#52991,"NUSA JAYA, KARAWACI, KOTA TANGERANG, BANTEN",5,67,98,165
https://kawalpemilu.org#52991,"NUSA JAYA, KARAWACI, KOTA TANGERANG, BANTEN",6,63,100,163
https://kawalpemilu.org#52991,"NUSA JAYA, KARAWACI, KOTA TANGERANG, BANTEN",7,95,117,212
https://kawalpemilu.org#52991,"NUSA JAYA, KARAWACI, KOTA TANGERANG, BANTEN",8,94,147,241
https://kawalpemilu.org#52991,"NUSA JAYA, KARAWACI, KOTA TANGERANG, BANTEN",9,95,143,238
https://kawalpemilu.org#52991,"NUSA JAYA, KARAWACI, KOTA TANGERANG, BANTEN",10,117,146,263
https://kawalpemilu.org#52991,"NUSA JAYA, KARAWACI, KOTA TANGERANG, BANTEN",11,145,140,285
https://kawalpemilu.org#52991,"NUSA JAYA, KARAWACI, KOTA TANGERANG, BANTEN",12,100,147,247
https://kawalpemilu.org#52991,"NUSA JAYA, KARAWACI, KOTA TANGERANG, BANTEN",13,111,139,250
https://kawalpemilu.org#52991,"NUSA JAYA, KARAWACI, KOTA TANGERANG, BANTEN",14,134,127,261
https://kawalpemilu.org#52991,"NUSA JAYA, KARAWACI, KOTA TANGERANG, BANTEN",15,109,81,190
https://kawalpemilu.org#52991,"NUSA JAYA, KARAWACI, KOTA TANGERANG, BANTEN",16,106,99,205
https://kawalpemilu.org#52991,"NUSA JAYA, KARAWACI, KOTA TANGERANG, BANTEN",17,97,99,196
https://kawalpemilu.org#52991,"NUSA JAYA, KARAWACI, KOTA TANGERANG, BANTEN",18,86,95,181
https://kawalpemilu.org#52991,"NUSA JAYA, KARAWACI, KOTA TANGERANG, BANTEN",19,126,99,225
https://kawalpemilu.org#52991,"NUSA JAYA, KARAWACI, KOTA TANGERANG, BANTEN",20,110,120,230
https://kawalpemilu.org#52991,"NUSA JAYA, KARAWACI, KOTA TANGERANG, BANTEN",21,87,107,194
https://kawalpemilu.org#52991,"NUSA JAYA, KARAWACI, KOTA TANGERANG, BANTEN",22,80,150,230
https://kawalpemilu.org#52991,"NUSA JAYA, KARAWACI, KOTA TANGERANG, BANTEN",23,90,123,213
https://kawalpemilu.org#52991,"NUSA JAYA, KARAWACI, KOTA TANGERANG, BANTEN",24,85,126,211
https://kawalpemilu.org#52991,"NUSA JAYA, KARAWACI, KOTA TANGERANG, BANTEN",25,65,121,186
https://kawalpemilu.org#52991,"NUSA JAYA, KARAWACI, KOTA TANGERANG, BANTEN",26,66,87,153
https://kawalpemilu.org#52991,"NUSA JAYA, KARAWACI, KOTA TANGERANG, BANTEN",27,124,101,225
https://kawalpemilu.org#52991,"NUSA JAYA, KARAWACI, KOTA TANGERANG, BANTEN",28,73,114,187
https://kawalpemilu.org#52991,"NUSA JAYA, KARAWACI, KOTA TANGERANG, BANTEN",29,67,104,171
https://kawalpemilu.org#52991,"NUSA JAYA, KARAWACI, KOTA TANGERANG, BANTEN",30,172,48,220
https://kawalpemilu.org#52991,"NUSA JAYA, KARAWACI, KOTA TANGERANG, BANTEN",31,171,20,191
https://kawalpemilu.org#52991,"NUSA JAYA, KARAWACI, KOTA TANGERANG, BANTEN",32,170,35,205
https://kawalpemilu.org#52991,"NUSA JAYA, KARAWACI, KOTA TANGERANG, BANTEN",33,117,13,130
https://kawalpemilu.org#52991,"NUSA JAYA, KARAWACI, KOTA TANGERANG, BANTEN",34,46,63,109
https://kawalpemilu.org#52991,"NUSA JAYA, KARAWACI, KOTA TANGERANG, BANTEN",35,97,122,219
https://kawalpemilu.org#52991,"NUSA JAYA, KARAWACI, KOTA TANGERANG, BANTEN",36,45,62,107
https://kawalpemilu.org#52991,"NUSA JAYA, KARAWACI, KOTA TANGERANG, BANTEN",37,107,146,253
https://kawalpemilu.org#52991,"NUSA JAYA, KARAWACI, KOTA TANGERANG, BANTEN",38,98,107,205
https://kawalpemilu.org#52991,"NUSA JAYA, KARAWACI, KOTA TANGERANG, BANTEN",39,83,109,192
https://kawalpemilu.org#52991,"NUSA JAYA, KARAWACI, KOTA TANGERANG, BANTEN",40,87,134,221
https://kawalpemilu.org#52991,"NUSA JAYA, KARAWACI, KOTA TANGERANG, BANTEN",41,117,108,225
https://kawalpemilu.org#52991,"NUSA JAYA, KARAWACI, KOTA TANGERANG, BANTEN",42,130,102,232
https://kawalpemilu.org#52991,"NUSA JAYA, KARAWACI, KOTA TANGERANG, BANTEN",43,143,82,225
https://kawalpemilu.org#52992,"CIMONE, KARAWACI, KOTA TANGERANG, BANTEN",1,74,160,234
https://kawalpemilu.org#52992,"CIMONE, KARAWACI, KOTA TANGERANG, BANTEN",2,67,118,185
https://kawalpemilu.org#52992,"CIMONE, KARAWACI, KOTA TANGERANG, BANTEN",3,85,129,214
https://kawalpemilu.org#52992,"CIMONE, KARAWACI, KOTA TANGERANG, BANTEN",4,109,161,270
https://kawalpemilu.org#52992,"CIMONE, KARAWACI, KOTA TANGERANG, BANTEN",5,64,132,196
https://kawalpemilu.org#52992,"CIMONE, KARAWACI, KOTA TANGERANG, BANTEN",6,104,123,227
https://kawalpemilu.org#52992,"CIMONE, KARAWACI, KOTA TANGERANG, BANTEN",7,117,107,224
https://kawalpemilu.org#52992,"CIMONE, KARAWACI, KOTA TANGERANG, BANTEN",8,70,149,219
https://kawalpemilu.org#52992,"CIMONE, KARAWACI, KOTA TANGERANG, BANTEN",9,70,170,240
https://kawalpemilu.org#52992,"CIMONE, KARAWACI, KOTA TANGERANG, BANTEN",10,124,134,258
https://kawalpemilu.org#52992,"CIMONE, KARAWACI, KOTA TANGERANG, BANTEN",11,113,108,221
https://kawalpemilu.org#52992,"CIMONE, KARAWACI, KOTA TANGERANG, BANTEN",12,109,118,227
https://kawalpemilu.org#52992,"CIMONE, KARAWACI, KOTA TANGERANG, BANTEN",13,102,121,223
https://kawalpemilu.org#52992,"CIMONE, KARAWACI, KOTA TANGERANG, BANTEN",14,95,130,225
https://kawalpemilu.org#52992,"CIMONE, KARAWACI, KOTA TANGERANG, BANTEN",15,142,106,248
https://kawalpemilu.org#52992,"CIMONE, KARAWACI, KOTA TANGERANG, BANTEN",16,141,153,294
https://kawalpemilu.org#52992,"CIMONE, KARAWACI, KOTA TANGERANG, BANTEN",17,136,132,268
https://kawalpemilu.org#52992,"CIMONE, KARAWACI, KOTA TANGERANG, BANTEN",18,85,170,255
https://kawalpemilu.org#52992,"CIMONE, KARAWACI, KOTA TANGERANG, BANTEN",19,111,118,229
https://kawalpemilu.org#52992,"CIMONE, KARAWACI, KOTA TANGERANG, BANTEN",20,156,72,228
https://kawalpemilu.org#52992,"CIMONE, KARAWACI, KOTA TANGERANG, BANTEN",21,193,59,252
https://kawalpemilu.org#52992,"CIMONE, KARAWACI, KOTA TANGERANG, BANTEN",22,148,88,236
https://kawalpemilu.org#52992,"CIMONE, KARAWACI, KOTA TANGERANG, BANTEN",23,69,107,176
https://kawalpemilu.org#52992,"CIMONE, KARAWACI, KOTA TANGERANG, BANTEN",24,68,105,173
https://kawalpemilu.org#52992,"CIMONE, KARAWACI, KOTA TANGERANG, BANTEN",25,105,122,227
https://kawalpemilu.org#52992,"CIMONE, KARAWACI, KOTA TANGERANG, BANTEN",26,114,129,243
https://kawalpemilu.org#52992,"CIMONE, KARAWACI, KOTA TANGERANG, BANTEN",27,65,155,220
https://kawalpemilu.org#52992,"CIMONE, KARAWACI, KOTA TANGERANG, BANTEN",28,128,37,16
https://kawalpemilu.org#52992,"CIMONE, KARAWACI, KOTA TANGERANG, BANTEN",29,183,21,204
https://kawalpemilu.org#52992,"CIMONE, KARAWACI, KOTA TANGERANG, BANTEN",30,136,58,194
https://kawalpemilu.org#52992,"CIMONE, KARAWACI, KOTA TANGERANG, BANTEN",31,116,70,186
https://kawalpemilu.org#52992,"CIMONE, KARAWACI, KOTA TANGERANG, BANTEN",32,139,112,251
https://kawalpemilu.org#52992,"CIMONE, KARAWACI, KOTA TANGERANG, BANTEN",33,78,51,129
https://kawalpemilu.org#52992,"CIMONE, KARAWACI, KOTA TANGERANG, BANTEN",34,147,31,178
https://kawalpemilu.org#52992,"CIMONE, KARAWACI, KOTA TANGERANG, BANTEN",35,101,69,170
https://kawalpemilu.org#52992,"CIMONE, KARAWACI, KOTA TANGERANG, BANTEN",36,164,53,217
https://kawalpemilu.org#52992,"CIMONE, KARAWACI, KOTA TANGERANG, BANTEN",37,143,64,207
https://kawalpemilu.org#52992,"CIMONE, KARAWACI, KOTA TANGERANG, BANTEN",38,124,82,206
https://kawalpemilu.org#52992,"CIMONE, KARAWACI, KOTA TANGERANG, BANTEN",39,170,28,198
https://kawalpemilu.org#52992,"CIMONE, KARAWACI, KOTA TANGERANG, BANTEN",40,179,27,206
https://kawalpemilu.org#52992,"CIMONE, KARAWACI, KOTA TANGERANG, BANTEN",41,178,44,222
https://kawalpemilu.org#52992,"CIMONE, KARAWACI, KOTA TANGERANG, BANTEN",42,135,36,171
https://kawalpemilu.org#52992,"CIMONE, KARAWACI, KOTA TANGERANG, BANTEN",43,141,44,185
https://kawalpemilu.org#52992,"CIMONE, KARAWACI, KOTA TANGERANG, BANTEN",44,88,147,235
https://kawalpemilu.org#52992,"CIMONE, KARAWACI, KOTA TANGERANG, BANTEN",45,91,144,235
https://kawalpemilu.org#52992,"CIMONE, KARAWACI, KOTA TANGERANG, BANTEN",46,93,150,243
https://kawalpemilu.org#52992,"CIMONE, KARAWACI, KOTA TANGERANG, BANTEN",47,81,180,261
https://kawalpemilu.org#52992,"CIMONE, KARAWACI, KOTA TANGERANG, BANTEN",48,92,132,224
https://kawalpemilu.org#52993,"CIMONE JAYA, KARAWACI, KOTA TANGERANG, BANTEN",1,72,101,173
https://kawalpemilu.org#52993,"CIMONE JAYA, KARAWACI, KOTA TANGERANG, BANTEN",2,92,105,197
https://kawalpemilu.org#52993,"CIMONE JAYA, KARAWACI, KOTA TANGERANG, BANTEN",3,94,110,204
https://kawalpemilu.org#52993,"CIMONE JAYA, KARAWACI, KOTA TANGERANG, BANTEN",4,94,120,214
https://kawalpemilu.org#52993,"CIMONE JAYA, KARAWACI, KOTA TANGERANG, BANTEN",5,72,119,191
https://kawalpemilu.org#52993,"CIMONE JAYA, KARAWACI, KOTA TANGERANG, BANTEN",6,81,157,238
https://kawalpemilu.org#52993,"CIMONE JAYA, KARAWACI, KOTA TANGERANG, BANTEN",7,78,123,201
https://kawalpemilu.org#52993,"CIMONE JAYA, KARAWACI, KOTA TANGERANG, BANTEN",8,190,73,263
https://kawalpemilu.org#52993,"CIMONE JAYA, KARAWACI, KOTA TANGERANG, BANTEN",9,108,124,232
https://kawalpemilu.org#52993,"CIMONE JAYA, KARAWACI, KOTA TANGERANG, BANTEN",10,148,100,248
https://kawalpemilu.org#52993,"CIMONE JAYA, KARAWACI, KOTA TANGERANG, BANTEN",11,108,132,240
https://kawalpemilu.org#52993,"CIMONE JAYA, KARAWACI, KOTA TANGERANG, BANTEN",12,128,94,222
https://kawalpemilu.org#52993,"CIMONE JAYA, KARAWACI, KOTA TANGERANG, BANTEN",13,176,56,232
https://kawalpemilu.org#52993,"CIMONE JAYA, KARAWACI, KOTA TANGERANG, BANTEN",14,104,115,219
https://kawalpemilu.org#52993,"CIMONE JAYA, KARAWACI, KOTA TANGERANG, BANTEN",15,109,104,213
https://kawalpemilu.org#52993,"CIMONE JAYA, KARAWACI, KOTA TANGERANG, BANTEN",16,126,96,222
https://kawalpemilu.org#52993,"CIMONE JAYA, KARAWACI, KOTA TANGERANG, BANTEN",17,116,76,192
https://kawalpemilu.org#52993,"CIMONE JAYA, KARAWACI, KOTA TANGERANG, BANTEN",18,170,49,219
https://kawalpemilu.org#52993,"CIMONE JAYA, KARAWACI, KOTA TANGERANG, BANTEN",19,123,68,191
https://kawalpemilu.org#52993,"CIMONE JAYA, KARAWACI, KOTA TANGERANG, BANTEN",20,68,111,179
https://kawalpemilu.org#52993,"CIMONE JAYA, KARAWACI, KOTA TANGERANG, BANTEN",22,72,112,184
https://kawalpemilu.org#52993,"CIMONE JAYA, KARAWACI, KOTA TANGERANG, BANTEN",23,70,99,169
https://kawalpemilu.org#52993,"CIMONE JAYA, KARAWACI, KOTA TANGERANG, BANTEN",24,57,115,172
https://kawalpemilu.org#52993,"CIMONE JAYA, KARAWACI, KOTA TANGERANG, BANTEN",25,58,110,168
https://kawalpemilu.org#52993,"CIMONE JAYA, KARAWACI, KOTA TANGERANG, BANTEN",26,50,157,209
https://kawalpemilu.org#52993,"CIMONE JAYA, KARAWACI, KOTA TANGERANG, BANTEN",27,72,120,192
https://kawalpemilu.org#52993,"CIMONE JAYA, KARAWACI, KOTA TANGERANG, BANTEN",28,52,101,153
https://kawalpemilu.org#52993,"CIMONE JAYA, KARAWACI, KOTA TANGERANG, BANTEN",29,65,118,183
https://kawalpemilu.org#52993,"CIMONE JAYA, KARAWACI, KOTA TANGERANG, BANTEN",30,83,106,189
https://kawalpemilu.org#52993,"CIMONE JAYA, KARAWACI, KOTA TANGERANG, BANTEN",31,91,100,191
https://kawalpemilu.org#52993,"CIMONE JAYA, KARAWACI, KOTA TANGERANG, BANTEN",32,72,102,174
https://kawalpemilu.org#52993,"CIMONE JAYA, KARAWACI, KOTA TANGERANG, BANTEN",33,84,104,188
https://kawalpemilu.org#52993,"CIMONE JAYA, KARAWACI, KOTA TANGERANG, BANTEN",34,68,90,158
https://kawalpemilu.org#52993,"CIMONE JAYA, KARAWACI, KOTA TANGERANG, BANTEN",35,90,104,194
https://kawalpemilu.org#52993,"CIMONE JAYA, KARAWACI, KOTA TANGERANG, BANTEN",36,57,114,171
https://kawalpemilu.org#52993,"CIMONE JAYA, KARAWACI, KOTA TANGERANG, BANTEN",37,68,98,166
https://kawalpemilu.org#52993,"CIMONE JAYA, KARAWACI, KOTA TANGERANG, BANTEN",38,99,93,192
https://kawalpemilu.org#52993,"CIMONE JAYA, KARAWACI, KOTA TANGERANG, BANTEN",39,93,88,181
https://kawalpemilu.org#52993,"CIMONE JAYA, KARAWACI, KOTA TANGERANG, BANTEN",40,110,85,195
https://kawalpemilu.org#52993,"CIMONE JAYA, KARAWACI, KOTA TANGERANG, BANTEN",41,64,80,144
https://kawalpemilu.org#52993,"CIMONE JAYA, KARAWACI, KOTA TANGERANG, BANTEN",42,99,91,190
https://kawalpemilu.org#52993,"CIMONE JAYA, KARAWACI, KOTA TANGERANG, BANTEN",43,77,83,160
https://kawalpemilu.org#52994,"PABUARAN, KARAWACI, KOTA TANGERANG, BANTEN",4,76,69,145
https://kawalpemilu.org#52994,"PABUARAN, KARAWACI, KOTA TANGERANG, BANTEN",5,112,120,232
https://kawalpemilu.org#52994,"PABUARAN, KARAWACI, KOTA TANGERANG, BANTEN",6,100,104,204
https://kawalpemilu.org#52994,"PABUARAN, KARAWACI, KOTA TANGERANG, BANTEN",7,94,131,225
https://kawalpemilu.org#52994,"PABUARAN, KARAWACI, KOTA TANGERANG, BANTEN",8,108,120,228
https://kawalpemilu.org#52994,"PABUARAN, KARAWACI, KOTA TANGERANG, BANTEN",10,84,140,224
https://kawalpemilu.org#52994,"PABUARAN, KARAWACI, KOTA TANGERANG, BANTEN",11,74,95,169
https://kawalpemilu.org#52994,"PABUARAN, KARAWACI, KOTA TANGERANG, BANTEN",13,82,112,194
https://kawalpemilu.org#52994,"PABUARAN, KARAWACI, KOTA TANGERANG, BANTEN",14,64,107,171
https://kawalpemilu.org#52994,"PABUARAN, KARAWACI, KOTA TANGERANG, BANTEN",15,58,95,153
https://kawalpemilu.org#52994,"PABUARAN, KARAWACI, KOTA TANGERANG, BANTEN",16,80,148,228
https://kawalpemilu.org#52994,"PABUARAN, KARAWACI, KOTA TANGERANG, BANTEN",17,80,154,234
https://kawalpemilu.org#52994,"PABUARAN, KARAWACI, KOTA TANGERANG, BANTEN",18,56,134,190
https://kawalpemilu.org#52994,"PABUARAN, KARAWACI, KOTA TANGERANG, BANTEN",20,70,116,186
https://kawalpemilu.org#52994,"PABUARAN, KARAWACI, KOTA TANGERANG, BANTEN",21,225,9,234
https://kawalpemilu.org#52994,"PABUARAN, KARAWACI, KOTA TANGERANG, BANTEN",23,165,24,189
https://kawalpemilu.org#52994,"PABUARAN, KARAWACI, KOTA TANGERANG, BANTEN",24,82,129,211
https://kawalpemilu.org#52994,"PABUARAN, KARAWACI, KOTA TANGERANG, BANTEN",25,168,31,199
https://kawalpemilu.org#52994,"PABUARAN, KARAWACI, KOTA TANGERANG, BANTEN",26,76,118,194
https://kawalpemilu.org#52994,"PABUARAN, KARAWACI, KOTA TANGERANG, BANTEN",27,52,76,128
https://kawalpemilu.org#52995,"SUMUR PACING, KARAWACI, KOTA TANGERANG, BANTEN",1,92,138,230
https://kawalpemilu.org#52995,"SUMUR PACING, KARAWACI, KOTA TANGERANG, BANTEN",2,121,120,241
https://kawalpemilu.org#52995,"SUMUR PACING, KARAWACI, KOTA TANGERANG, BANTEN",3,175,36,211
https://kawalpemilu.org#52995,"SUMUR PACING, KARAWACI, KOTA TANGERANG, BANTEN",4,84,141,225
https://kawalpemilu.org#52995,"SUMUR PACING, KARAWACI, KOTA TANGERANG, BANTEN",5,81,139,220
https://kawalpemilu.org#52995,"SUMUR PACING, KARAWACI, KOTA TANGERANG, BANTEN",6,107,121,228
https://kawalpemilu.org#52995,"SUMUR PACING, KARAWACI, KOTA TANGERANG, BANTEN",7,59,202,261
https://kawalpemilu.org#52995,"SUMUR PACING, KARAWACI, KOTA TANGERANG, BANTEN",8,89,134,223
https://kawalpemilu.org#52995,"SUMUR PACING, KARAWACI, KOTA TANGERANG, BANTEN",9,72,154,226
https://kawalpemilu.org#52995,"SUMUR PACING, KARAWACI, KOTA TANGERANG, BANTEN",10,72,135,207
https://kawalpemilu.org#52995,"SUMUR PACING, KARAWACI, KOTA TANGERANG, BANTEN",11,99,136,235
https://kawalpemilu.org#52995,"SUMUR PACING, KARAWACI, KOTA TANGERANG, BANTEN",12,85,109,194
https://kawalpemilu.org#52995,"SUMUR PACING, KARAWACI, KOTA TANGERANG, BANTEN",13,84,157,241
https://kawalpemilu.org#52995,"SUMUR PACING, KARAWACI, KOTA TANGERANG, BANTEN",14,45,148,193
https://kawalpemilu.org#52995,"SUMUR PACING, KARAWACI, KOTA TANGERANG, BANTEN",15,75,180,255
https://kawalpemilu.org#52996,"BUGEL, KARAWACI, KOTA TANGERANG, BANTEN",1,42,98,140
https://kawalpemilu.org#52996,"BUGEL, KARAWACI, KOTA TANGERANG, BANTEN",2,46,101,147
https://kawalpemilu.org#52996,"BUGEL, KARAWACI, KOTA TANGERANG, BANTEN",3,43,109,152
https://kawalpemilu.org#52996,"BUGEL, KARAWACI, KOTA TANGERANG, BANTEN",4,50,97,147
https://kawalpemilu.org#52996,"BUGEL, KARAWACI, KOTA TANGERANG, BANTEN",5,24,128,152
https://kawalpemilu.org#52996,"BUGEL, KARAWACI, KOTA TANGERANG, BANTEN",6,37,119,156
https://kawalpemilu.org#52996,"BUGEL, KARAWACI, KOTA TANGERANG, BANTEN",7,51,125,176
https://kawalpemilu.org#52996,"BUGEL, KARAWACI, KOTA TANGERANG, BANTEN",8,31,156,187
https://kawalpemilu.org#52996,"BUGEL, KARAWACI, KOTA TANGERANG, BANTEN",9,78,153,231
https://kawalpemilu.org#52996,"BUGEL, KARAWACI, KOTA TANGERANG, BANTEN",10,88,138,226
https://kawalpemilu.org#52996,"BUGEL, KARAWACI, KOTA TANGERANG, BANTEN",11,47,128,175
https://kawalpemilu.org#52996,"BUGEL, KARAWACI, KOTA TANGERANG, BANTEN",12,58,82,140
https://kawalpemilu.org#52996,"BUGEL, KARAWACI, KOTA TANGERANG, BANTEN",13,136,86,222
https://kawalpemilu.org#52996,"BUGEL, KARAWACI, KOTA TANGERANG, BANTEN",14,87,43,130
https://kawalpemilu.org#52996,"BUGEL, KARAWACI, KOTA TANGERANG, BANTEN",15,112,84,196
https://kawalpemilu.org#52996,"BUGEL, KARAWACI, KOTA TANGERANG, BANTEN",16,92,90,182
https://kawalpemilu.org#52996,"BUGEL, KARAWACI, KOTA TANGERANG, BANTEN",17,120,70,190
https://kawalpemilu.org#52996,"BUGEL, KARAWACI, KOTA TANGERANG, BANTEN",18,103,117,220
https://kawalpemilu.org#52996,"BUGEL, KARAWACI, KOTA TANGERANG, BANTEN",20,101,130,231
https://kawalpemilu.org#52996,"BUGEL, KARAWACI, KOTA TANGERANG, BANTEN",21,130,94,224
https://kawalpemilu.org#52996,"BUGEL, KARAWACI, KOTA TANGERANG, BANTEN",22,100,141,241
https://kawalpemilu.org#52996,"BUGEL, KARAWACI, KOTA TANGERANG, BANTEN",23,149,73,222
https://kawalpemilu.org#52996,"BUGEL, KARAWACI, KOTA TANGERANG, BANTEN",24,141,80,221
https://kawalpemilu.org#52996,"BUGEL, KARAWACI, KOTA TANGERANG, BANTEN",26,65,129,194
https://kawalpemilu.org#52996,"BUGEL, KARAWACI, KOTA TANGERANG, BANTEN",27,66,122,188
https://kawalpemilu.org#52996,"BUGEL, KARAWACI, KOTA TANGERANG, BANTEN",28,111,81,192
https://kawalpemilu.org#52996,"BUGEL, KARAWACI, KOTA TANGERANG, BANTEN",29,72,57,129
https://kawalpemilu.org#52996,"BUGEL, KARAWACI, KOTA TANGERANG, BANTEN",30,106,116,222
https://kawalpemilu.org#52996,"BUGEL, KARAWACI, KOTA TANGERANG, BANTEN",31,91,110,201
https://kawalpemilu.org#52996,"BUGEL, KARAWACI, KOTA TANGERANG, BANTEN",32,148,64,212
https://kawalpemilu.org#52996,"BUGEL, KARAWACI, KOTA TANGERANG, BANTEN",33,120,43,163
https://kawalpemilu.org#52996,"BUGEL, KARAWACI, KOTA TANGERANG, BANTEN",34,129,82,211
https://kawalpemilu.org#52996,"BUGEL, KARAWACI, KOTA TANGERANG, BANTEN",35,90,88,178
https://kawalpemilu.org#52996,"BUGEL, KARAWACI, KOTA TANGERANG, BANTEN",36,120,58,178
https://kawalpemilu.org#52996,"BUGEL, KARAWACI, KOTA TANGERANG, BANTEN",37,91,65,156
https://kawalpemilu.org#52996,"BUGEL, KARAWACI, KOTA TANGERANG, BANTEN",38,135,56,191
https://kawalpemilu.org#52996,"BUGEL, KARAWACI, KOTA TANGERANG, BANTEN",39,51,103,154
https://kawalpemilu.org#52996,"BUGEL, KARAWACI, KOTA TANGERANG, BANTEN",40,46,110,156
https://kawalpemilu.org#52996,"BUGEL, KARAWACI, KOTA TANGERANG, BANTEN",41,65,134,199
https://kawalpemilu.org#52996,"BUGEL, KARAWACI, KOTA TANGERANG, BANTEN",43,89,41,130
https://kawalpemilu.org#52996,"BUGEL, KARAWACI, KOTA TANGERANG, BANTEN",44,36,114,150
https://kawalpemilu.org#52996,"BUGEL, KARAWACI, KOTA TANGERANG, BANTEN",45,53,118,171
https://kawalpemilu.org#52996,"BUGEL, KARAWACI, KOTA TANGERANG, BANTEN",46,60,90,150
https://kawalpemilu.org#52996,"BUGEL, KARAWACI, KOTA TANGERANG, BANTEN",47,68,73,141
https://kawalpemilu.org#52996,"BUGEL, KARAWACI, KOTA TANGERANG, BANTEN",48,61,110,171
https://kawalpemilu.org#52996,"BUGEL, KARAWACI, KOTA TANGERANG, BANTEN",49,86,117,203
https://kawalpemilu.org#52997,"MARGASARI, KARAWACI, KOTA TANGERANG, BANTEN",3,155,127,282
https://kawalpemilu.org#52997,"MARGASARI, KARAWACI, KOTA TANGERANG, BANTEN",4,114,128,242
https://kawalpemilu.org#52997,"MARGASARI, KARAWACI, KOTA TANGERANG, BANTEN",5,99,116,215
https://kawalpemilu.org#52997,"MARGASARI, KARAWACI, KOTA TANGERANG, BANTEN",6,105,86,191
https://kawalpemilu.org#52997,"MARGASARI, KARAWACI, KOTA TANGERANG, BANTEN",7,143,154,297
https://kawalpemilu.org#52997,"MARGASARI, KARAWACI, KOTA TANGERANG, BANTEN",8,107,126,233
https://kawalpemilu.org#52997,"MARGASARI, KARAWACI, KOTA TANGERANG, BANTEN",9,111,188,299
https://kawalpemilu.org#52997,"MARGASARI, KARAWACI, KOTA TANGERANG, BANTEN",10,89,155,244
https://kawalpemilu.org#52997,"MARGASARI, KARAWACI, KOTA TANGERANG, BANTEN",11,89,144,233
https://kawalpemilu.org#52997,"MARGASARI, KARAWACI, KOTA TANGERANG, BANTEN",12,71,98,169
https://kawalpemilu.org#52997,"MARGASARI, KARAWACI, KOTA TANGERANG, BANTEN",13,44,118,162
https://kawalpemilu.org#52997,"MARGASARI, KARAWACI, KOTA TANGERANG, BANTEN",14,69,191,260
https://kawalpemilu.org#52997,"MARGASARI, KARAWACI, KOTA TANGERANG, BANTEN",15,64,180,244
https://kawalpemilu.org#52997,"MARGASARI, KARAWACI, KOTA TANGERANG, BANTEN",17,70,218,288
https://kawalpemilu.org#52997,"MARGASARI, KARAWACI, KOTA TANGERANG, BANTEN",18,74,169,243
https://kawalpemilu.org#52997,"MARGASARI, KARAWACI, KOTA TANGERANG, BANTEN",19,90,156,246
https://kawalpemilu.org#52997,"MARGASARI, KARAWACI, KOTA TANGERANG, BANTEN",20,94,141,235
https://kawalpemilu.org#52997,"MARGASARI, KARAWACI, KOTA TANGERANG, BANTEN",21,86,92,178
https://kawalpemilu.org#52997,"MARGASARI, KARAWACI, KOTA TANGERANG, BANTEN",22,91,92,183
https://kawalpemilu.org#52997,"MARGASARI, KARAWACI, KOTA TANGERANG, BANTEN",23,86,126,212
https://kawalpemilu.org#52997,"MARGASARI, KARAWACI, KOTA TANGERANG, BANTEN",24,57,67,124
https://kawalpemilu.org#52997,"MARGASARI, KARAWACI, KOTA TANGERANG, BANTEN",25,45,62,107
https://kawalpemilu.org#52997,"MARGASARI, KARAWACI, KOTA TANGERANG, BANTEN",26,127,126,253
https://kawalpemilu.org#52997,"MARGASARI, KARAWACI, KOTA TANGERANG, BANTEN",27,108,136,244
https://kawalpemilu.org#52997,"MARGASARI, KARAWACI, KOTA TANGERANG, BANTEN",28,64,107,171
https://kawalpemilu.org#52997,"MARGASARI, KARAWACI, KOTA TANGERANG, BANTEN",29,79,99,178
https://kawalpemilu.org#52997,"MARGASARI, KARAWACI, KOTA TANGERANG, BANTEN",30,64,134,198
https://kawalpemilu.org#52997,"MARGASARI, KARAWACI, KOTA TANGERANG, BANTEN",31,67,124,191
https://kawalpemilu.org#52997,"MARGASARI, KARAWACI, KOTA TANGERANG, BANTEN",32,77,170,247
https://kawalpemilu.org#52997,"MARGASARI, KARAWACI, KOTA TANGERANG, BANTEN",33,63,134,197
https://kawalpemilu.org#52997,"MARGASARI, KARAWACI, KOTA TANGERANG, BANTEN",34,62,103,165
https://kawalpemilu.org#52997,"MARGASARI, KARAWACI, KOTA TANGERANG, BANTEN",35,105,103,208
https://kawalpemilu.org#52997,"MARGASARI, KARAWACI, KOTA TANGERANG, BANTEN",36,86,88,174
https://kawalpemilu.org#52997,"MARGASARI, KARAWACI, KOTA TANGERANG, BANTEN",37,93,133,226
https://kawalpemilu.org#52997,"MARGASARI, KARAWACI, KOTA TANGERANG, BANTEN",38,98,104,202
https://kawalpemilu.org#52997,"MARGASARI, KARAWACI, KOTA TANGERANG, BANTEN",39,107,126,233
https://kawalpemilu.org#52997,"MARGASARI, KARAWACI, KOTA TANGERANG, BANTEN",40,95,133,228
https://kawalpemilu.org#52997,"MARGASARI, KARAWACI, KOTA TANGERANG, BANTEN",41,86,157,243
https://kawalpemilu.org#52997,"MARGASARI, KARAWACI, KOTA TANGERANG, BANTEN",42,95,149,244
https://kawalpemilu.org#52997,"MARGASARI, KARAWACI, KOTA TANGERANG, BANTEN",43,136,79,215
https://kawalpemilu.org#52998,"PABUARAN TUMPENG, KARAWACI, KOTA TANGERANG, BANTEN",1,94,107,201
https://kawalpemilu.org#52998,"PABUARAN TUMPENG, KARAWACI, KOTA TANGERANG, BANTEN",2,47,118,165
https://kawalpemilu.org#52998,"PABUARAN TUMPENG, KARAWACI, KOTA TANGERANG, BANTEN",3,82,100,182
https://kawalpemilu.org#52998,"PABUARAN TUMPENG, KARAWACI, KOTA TANGERANG, BANTEN",4,73,134,207
https://kawalpemilu.org#52998,"PABUARAN TUMPENG, KARAWACI, KOTA TANGERANG, BANTEN",5,179,45,224
https://kawalpemilu.org#52998,"PABUARAN TUMPENG, KARAWACI, KOTA TANGERANG, BANTEN",6,124,114,238
https://kawalpemilu.org#52998,"PABUARAN TUMPENG, KARAWACI, KOTA TANGERANG, BANTEN",7,73,127,200
https://kawalpemilu.org#52998,"PABUARAN TUMPENG, KARAWACI, KOTA TANGERANG, BANTEN",8,89,113,202
https://kawalpemilu.org#52998,"PABUARAN TUMPENG, KARAWACI, KOTA TANGERANG, BANTEN",9,84,87,171
https://kawalpemilu.org#52998,"PABUARAN TUMPENG, KARAWACI, KOTA TANGERANG, BANTEN",10,55,82,137
https://kawalpemilu.org#52998,"PABUARAN TUMPENG, KARAWACI, KOTA TANGERANG, BANTEN",11,55,110,165
https://kawalpemilu.org#52998,"PABUARAN TUMPENG, KARAWACI, KOTA TANGERANG, BANTEN",12,63,161,224
https://kawalpemilu.org#52998,"PABUARAN TUMPENG, KARAWACI, KOTA TANGERANG, BANTEN",13,85,106,191
https://kawalpemilu.org#52998,"PABUARAN TUMPENG, KARAWACI, KOTA TANGERANG, BANTEN",14,53,149,202
https://kawalpemilu.org#52998,"PABUARAN TUMPENG, KARAWACI, KOTA TANGERANG, BANTEN",15,32,151,183
https://kawalpemilu.org#52998,"PABUARAN TUMPENG, KARAWACI, KOTA TANGERANG, BANTEN",16,128,33,161
https://kawalpemilu.org#52998,"PABUARAN TUMPENG, KARAWACI, KOTA TANGERANG, BANTEN",17,110,16,126
https://kawalpemilu.org#52998,"PABUARAN TUMPENG, KARAWACI, KOTA TANGERANG, BANTEN",18,78,121,199
https://kawalpemilu.org#52998,"PABUARAN TUMPENG, KARAWACI, KOTA TANGERANG, BANTEN",19,83,145,228
https://kawalpemilu.org#52998,"PABUARAN TUMPENG, KARAWACI, KOTA TANGERANG, BANTEN",20,62,101,163
https://kawalpemilu.org#52998,"PABUARAN TUMPENG, KARAWACI, KOTA TANGERANG, BANTEN",21,77,140,217
https://kawalpemilu.org#52998,"PABUARAN TUMPENG, KARAWACI, KOTA TANGERANG, BANTEN",22,70,134,204
https://kawalpemilu.org#52998,"PABUARAN TUMPENG, KARAWACI, KOTA TANGERANG, BANTEN",23,71,125,196
https://kawalpemilu.org#52998,"PABUARAN TUMPENG, KARAWACI, KOTA TANGERANG, BANTEN",24,59,120,179
https://kawalpemilu.org#52998,"PABUARAN TUMPENG, KARAWACI, KOTA TANGERANG, BANTEN",25,133,47,180
https://kawalpemilu.org#52998,"PABUARAN TUMPENG, KARAWACI, KOTA TANGERANG, BANTEN",26,146,21,167
https://kawalpemilu.org#52998,"PABUARAN TUMPENG, KARAWACI, KOTA TANGERANG, BANTEN",27,104,94,198
https://kawalpemilu.org#52998,"PABUARAN TUMPENG, KARAWACI, KOTA TANGERANG, BANTEN",28,97,68,165
https://kawalpemilu.org#52998,"PABUARAN TUMPENG, KARAWACI, KOTA TANGERANG, BANTEN",29,129,31,160
https://kawalpemilu.org#52998,"PABUARAN TUMPENG, KARAWACI, KOTA TANGERANG, BANTEN",30,110,62,172
https://kawalpemilu.org#52998,"PABUARAN TUMPENG, KARAWACI, KOTA TANGERANG, BANTEN",31,79,68,147
https://kawalpemilu.org#52998,"PABUARAN TUMPENG, KARAWACI, KOTA TANGERANG, BANTEN",32,77,84,161
https://kawalpemilu.org#52998,"PABUARAN TUMPENG, KARAWACI, KOTA TANGERANG, BANTEN",33,109,28,137
https://kawalpemilu.org#52998,"PABUARAN TUMPENG, KARAWACI, KOTA TANGERANG, BANTEN",34,116,74,190
https://kawalpemilu.org#52998,"PABUARAN TUMPENG, KARAWACI, KOTA TANGERANG, BANTEN",35,0,0,0
https://kawalpemilu.org#52998,"PABUARAN TUMPENG, KARAWACI, KOTA TANGERANG, BANTEN",36,112,47,159
https://kawalpemilu.org#52998,"PABUARAN TUMPENG, KARAWACI, KOTA TANGERANG, BANTEN",37,131,34,165
https://kawalpemilu.org#52998,"PABUARAN TUMPENG, KARAWACI, KOTA TANGERANG, BANTEN",38,73,34,107
https://kawalpemilu.org#52998,"PABUARAN TUMPENG, KARAWACI, KOTA TANGERANG, BANTEN",39,76,53,129
https://kawalpemilu.org#52998,"PABUARAN TUMPENG, KARAWACI, KOTA TANGERANG, BANTEN",40,82,97,179
https://kawalpemilu.org#52998,"PABUARAN TUMPENG, KARAWACI, KOTA TANGERANG, BANTEN",41,76,79,155
https://kawalpemilu.org#52998,"PABUARAN TUMPENG, KARAWACI, KOTA TANGERANG, BANTEN",42,146,38,184
https://kawalpemilu.org#52998,"PABUARAN TUMPENG, KARAWACI, KOTA TANGERANG, BANTEN",43,125,42,167
https://kawalpemilu.org#52998,"PABUARAN TUMPENG, KARAWACI, KOTA TANGERANG, BANTEN",44,65,107,172
https://kawalpemilu.org#52998,"PABUARAN TUMPENG, KARAWACI, KOTA TANGERANG, BANTEN",45,68,109,177
https://kawalpemilu.org#52998,"PABUARAN TUMPENG, KARAWACI, KOTA TANGERANG, BANTEN",46,66,134,200
https://kawalpemilu.org#52998,"PABUARAN TUMPENG, KARAWACI, KOTA TANGERANG, BANTEN",47,113,54,167
https://kawalpemilu.org#52999,"NAMBO JAYA, KARAWACI, KOTA TANGERANG, BANTEN",1,106,162,268
https://kawalpemilu.org#52999,"NAMBO JAYA, KARAWACI, KOTA TANGERANG, BANTEN",2,73,161,234
https://kawalpemilu.org#52999,"NAMBO JAYA, KARAWACI, KOTA TANGERANG, BANTEN",3,92,124,216
https://kawalpemilu.org#52999,"NAMBO JAYA, KARAWACI, KOTA TANGERANG, BANTEN",5,107,118,225
https://kawalpemilu.org#52999,"NAMBO JAYA, KARAWACI, KOTA TANGERANG, BANTEN",6,138,98,236
https://kawalpemilu.org#52999,"NAMBO JAYA, KARAWACI, KOTA TANGERANG, BANTEN",7,111,98,209
https://kawalpemilu.org#52999,"NAMBO JAYA, KARAWACI, KOTA TANGERANG, BANTEN",8,102,92,194
https://kawalpemilu.org#52999,"NAMBO JAYA, KARAWACI, KOTA TANGERANG, BANTEN",9,130,68,198
https://kawalpemilu.org#52999,"NAMBO JAYA, KARAWACI, KOTA TANGERANG, BANTEN",10,121,59,180
https://kawalpemilu.org#52999,"NAMBO JAYA, KARAWACI, KOTA TANGERANG, BANTEN",11,158,65,223
https://kawalpemilu.org#52999,"NAMBO JAYA, KARAWACI, KOTA TANGERANG, BANTEN",12,128,95,223
https://kawalpemilu.org#52999,"NAMBO JAYA, KARAWACI, KOTA TANGERANG, BANTEN",13,126,77,203
https://kawalpemilu.org#52999,"NAMBO JAYA, KARAWACI, KOTA TANGERANG, BANTEN",14,121,88,209
https://kawalpemilu.org#52999,"NAMBO JAYA, KARAWACI, KOTA TANGERANG, BANTEN",15,77,132,209
https://kawalpemilu.org#52999,"NAMBO JAYA, KARAWACI, KOTA TANGERANG, BANTEN",16,115,36,151
https://kawalpemilu.org#52999,"NAMBO JAYA, KARAWACI, KOTA TANGERANG, BANTEN",17,68,88,156
https://kawalpemilu.org#52999,"NAMBO JAYA, KARAWACI, KOTA TANGERANG, BANTEN",18,90,76,166
https://kawalpemilu.org#52999,"NAMBO JAYA, KARAWACI, KOTA TANGERANG, BANTEN",19,160,84,244
https://kawalpemilu.org#52999,"NAMBO JAYA, KARAWACI, KOTA TANGERANG, BANTEN",20,98,88,186
https://kawalpemilu.org#52999,"NAMBO JAYA, KARAWACI, KOTA TANGERANG, BANTEN",21,99,127,226
https://kawalpemilu.org#53000,"GERENDENG, KARAWACI, KOTA TANGERANG, BANTEN",1,28,134,162
https://kawalpemilu.org#53000,"GERENDENG, KARAWACI, KOTA TANGERANG, BANTEN",3,37,149,186
https://kawalpemilu.org#53000,"GERENDENG, KARAWACI, KOTA TANGERANG, BANTEN",5,66,147,213
https://kawalpemilu.org#53000,"GERENDENG, KARAWACI, KOTA TANGERANG, BANTEN",6,72,159,231
https://kawalpemilu.org#53000,"GERENDENG, KARAWACI, KOTA TANGERANG, BANTEN",7,29,113,142
https://kawalpemilu.org#53000,"GERENDENG, KARAWACI, KOTA TANGERANG, BANTEN",8,37,130,167
https://kawalpemilu.org#53000,"GERENDENG, KARAWACI, KOTA TANGERANG, BANTEN",11,45,139,184
https://kawalpemilu.org#53000,"GERENDENG, KARAWACI, KOTA TANGERANG, BANTEN",12,66,111,177
https://kawalpemilu.org#53000,"GERENDENG, KARAWACI, KOTA TANGERANG, BANTEN",13,44,145,189
https://kawalpemilu.org#53000,"GERENDENG, KARAWACI, KOTA TANGERANG, BANTEN",14,56,138,194
https://kawalpemilu.org#53000,"GERENDENG, KARAWACI, KOTA TANGERANG, BANTEN",15,86,86,174
https://kawalpemilu.org#53000,"GERENDENG, KARAWACI, KOTA TANGERANG, BANTEN",16,139,6,145
https://kawalpemilu.org#53000,"GERENDENG, KARAWACI, KOTA TANGERANG, BANTEN",17,205,0,205
https://kawalpemilu.org#53000,"GERENDENG, KARAWACI, KOTA TANGERANG, BANTEN",18,203,8,211
https://kawalpemilu.org#53000,"GERENDENG, KARAWACI, KOTA TANGERANG, BANTEN",19,36,119,155
https://kawalpemilu.org#53000,"GERENDENG, KARAWACI, KOTA TANGERANG, BANTEN",20,75,76,151
https://kawalpemilu.org#53000,"GERENDENG, KARAWACI, KOTA TANGERANG, BANTEN",21,86,98,184
https://kawalpemilu.org#53000,"GERENDENG, KARAWACI, KOTA TANGERANG, BANTEN",22,181,7,188
https://kawalpemilu.org#53000,"GERENDENG, KARAWACI, KOTA TANGERANG, BANTEN",23,154,4,158
https://kawalpemilu.org#53000,"GERENDENG, KARAWACI, KOTA TANGERANG, BANTEN",24,189,15,204
https://kawalpemilu.org#53000,"GERENDENG, KARAWACI, KOTA TANGERANG, BANTEN",25,129,2,131
https://kawalpemilu.org#53000,"GERENDENG, KARAWACI, KOTA TANGERANG, BANTEN",26,163,0,163
https://kawalpemilu.org#53000,"GERENDENG, KARAWACI, KOTA TANGERANG, BANTEN",27,180,10,190
https://kawalpemilu.org#53000,"GERENDENG, KARAWACI, KOTA TANGERANG, BANTEN",29,118,122,240
https://kawalpemilu.org#53000,"GERENDENG, KARAWACI, KOTA TANGERANG, BANTEN",30,158,99,257
https://kawalpemilu.org#53000,"GERENDENG, KARAWACI, KOTA TANGERANG, BANTEN",31,122,151,273
https://kawalpemilu.org#53000,"GERENDENG, KARAWACI, KOTA TANGERANG, BANTEN",32,173,57,230
https://kawalpemilu.org#53000,"GERENDENG, KARAWACI, KOTA TANGERANG, BANTEN",33,61,114,175
https://kawalpemilu.org#53000,"GERENDENG, KARAWACI, KOTA TANGERANG, BANTEN",34,52,94,146
https://kawalpemilu.org#53000,"GERENDENG, KARAWACI, KOTA TANGERANG, BANTEN",35,70,127,197
https://kawalpemilu.org#53001,"SUKAJADI, KARAWACI, KOTA TANGERANG, BANTEN",1,188,1,189
https://kawalpemilu.org#53001,"SUKAJADI, KARAWACI, KOTA TANGERANG, BANTEN",2,198,1,199
https://kawalpemilu.org#53001,"SUKAJADI, KARAWACI, KOTA TANGERANG, BANTEN",3,103,39,142
https://kawalpemilu.org#53001,"SUKAJADI, KARAWACI, KOTA TANGERANG, BANTEN",4,116,66,182
https://kawalpemilu.org#53001,"SUKAJADI, KARAWACI, KOTA TANGERANG, BANTEN",5,175,2,177
https://kawalpemilu.org#53001,"SUKAJADI, KARAWACI, KOTA TANGERANG, BANTEN",8,96,128,224
https://kawalpemilu.org#53001,"SUKAJADI, KARAWACI, KOTA TANGERANG, BANTEN",10,158,67,225
https://kawalpemilu.org#53001,"SUKAJADI, KARAWACI, KOTA TANGERANG, BANTEN",11,218,0,218
https://kawalpemilu.org#53001,"SUKAJADI, KARAWACI, KOTA TANGERANG, BANTEN",12,215,13,228
https://kawalpemilu.org#53001,"SUKAJADI, KARAWACI, KOTA TANGERANG, BANTEN",13,201,56,257
https://kawalpemilu.org#53001,"SUKAJADI, KARAWACI, KOTA TANGERANG, BANTEN",16,87,164,251
https://kawalpemilu.org#53001,"SUKAJADI, KARAWACI, KOTA TANGERANG, BANTEN",18,215,9,224
https://kawalpemilu.org#53001,"SUKAJADI, KARAWACI, KOTA TANGERANG, BANTEN",19,215,4,219
https://kawalpemilu.org#53001,"SUKAJADI, KARAWACI, KOTA TANGERANG, BANTEN",20,146,5,151
https://kawalpemilu.org#53001,"SUKAJADI, KARAWACI, KOTA TANGERANG, BANTEN",21,139,10,149
https://kawalpemilu.org#53001,"SUKAJADI, KARAWACI, KOTA TANGERANG, BANTEN",22,149,2,151
https://kawalpemilu.org#53001,"SUKAJADI, KARAWACI, KOTA TANGERANG, BANTEN",23,115,3,118
https://kawalpemilu.org#53001,"SUKAJADI, KARAWACI, KOTA TANGERANG, BANTEN",24,155,1,156
https://kawalpemilu.org#53001,"SUKAJADI, KARAWACI, KOTA TANGERANG, BANTEN",25,248,1,249
https://kawalpemilu.org#53001,"SUKAJADI, KARAWACI, KOTA TANGERANG, BANTEN",26,164,5,169
https://kawalpemilu.org#53001,"SUKAJADI, KARAWACI, KOTA TANGERANG, BANTEN",27,213,3,216
https://kawalpemilu.org#53002,"PASAR BARU, KARAWACI, KOTA TANGERANG, BANTEN",1,127,112,239
https://kawalpemilu.org#53002,"PASAR BARU, KARAWACI, KOTA TANGERANG, BANTEN",2,0,0,0
https://kawalpemilu.org#53002,"PASAR BARU, KARAWACI, KOTA TANGERANG, BANTEN",3,116,56,172
https://kawalpemilu.org#53002,"PASAR BARU, KARAWACI, KOTA TANGERANG, BANTEN",4,126,101,227
https://kawalpemilu.org#53002,"PASAR BARU, KARAWACI, KOTA TANGERANG, BANTEN",6,105,114,219
https://kawalpemilu.org#53002,"PASAR BARU, KARAWACI, KOTA TANGERANG, BANTEN",7,65,219,284
https://kawalpemilu.org#53002,"PASAR BARU, KARAWACI, KOTA TANGERANG, BANTEN",8,247,6,253
https://kawalpemilu.org#53002,"PASAR BARU, KARAWACI, KOTA TANGERANG, BANTEN",9,117,125,242
https://kawalpemilu.org#53002,"PASAR BARU, KARAWACI, KOTA TANGERANG, BANTEN",10,240,20,260
https://kawalpemilu.org#53002,"PASAR BARU, KARAWACI, KOTA TANGERANG, BANTEN",11,231,3,234
https://kawalpemilu.org#53002,"PASAR BARU, KARAWACI, KOTA TANGERANG, BANTEN",12,187,24,211
https://kawalpemilu.org#53002,"PASAR BARU, KARAWACI, KOTA TANGERANG, BANTEN",13,192,26,218
https://kawalpemilu.org#53002,"PASAR BARU, KARAWACI, KOTA TANGERANG, BANTEN",14,41,109,150
https://kawalpemilu.org#53003,"KOANG JAYA, KARAWACI, KOTA TANGERANG, BANTEN",1,79,155,234
https://kawalpemilu.org#53003,"KOANG JAYA, KARAWACI, KOTA TANGERANG, BANTEN",2,79,97,176
https://kawalpemilu.org#53003,"KOANG JAYA, KARAWACI, KOTA TANGERANG, BANTEN",3,70,87,157
https://kawalpemilu.org#53003,"KOANG JAYA, KARAWACI, KOTA TANGERANG, BANTEN",4,52,105,157
https://kawalpemilu.org#53003,"KOANG JAYA, KARAWACI, KOTA TANGERANG, BANTEN",5,47,107,154
https://kawalpemilu.org#53003,"KOANG JAYA, KARAWACI, KOTA TANGERANG, BANTEN",6,48,154,202
https://kawalpemilu.org#53003,"KOANG JAYA, KARAWACI, KOTA TANGERANG, BANTEN",7,58,150,208
https://kawalpemilu.org#53003,"KOANG JAYA, KARAWACI, KOTA TANGERANG, BANTEN",8,41,131,172
https://kawalpemilu.org#53003,"KOANG JAYA, KARAWACI, KOTA TANGERANG, BANTEN",9,36,112,148
https://kawalpemilu.org#53003,"KOANG JAYA, KARAWACI, KOTA TANGERANG, BANTEN",10,66,131,197
https://kawalpemilu.org#53003,"KOANG JAYA, KARAWACI, KOTA TANGERANG, BANTEN",11,72,116,188
https://kawalpemilu.org#53003,"KOANG JAYA, KARAWACI, KOTA TANGERANG, BANTEN",12,127,60,187
https://kawalpemilu.org#53003,"KOANG JAYA, KARAWACI, KOTA TANGERANG, BANTEN",13,66,155,221
https://kawalpemilu.org#53003,"KOANG JAYA, KARAWACI, KOTA TANGERANG, BANTEN",14,111,138,249
https://kawalpemilu.org#53003,"KOANG JAYA, KARAWACI, KOTA TANGERANG, BANTEN",15,40,174,214
https://kawalpemilu.org#53003,"KOANG JAYA, KARAWACI, KOTA TANGERANG, BANTEN",16,51,165,216
https://kawalpemilu.org#53003,"KOANG JAYA, KARAWACI, KOTA TANGERANG, BANTEN",17,95,143,238
https://kawalpemilu.org#53003,"KOANG JAYA, KARAWACI, KOTA TANGERANG, BANTEN",19,68,151,219
https://kawalpemilu.org#53003,"KOANG JAYA, KARAWACI, KOTA TANGERANG, BANTEN",20,88,112,200
https://kawalpemilu.org#53003,"KOANG JAYA, KARAWACI, KOTA TANGERANG, BANTEN",21,125,139,264
https://kawalpemilu.org#53003,"KOANG JAYA, KARAWACI, KOTA TANGERANG, BANTEN",22,63,137,200
https://kawalpemilu.org#53003,"KOANG JAYA, KARAWACI, KOTA TANGERANG, BANTEN",23,35,168,203
https://kawalpemilu.org#53003,"KOANG JAYA, KARAWACI, KOTA TANGERANG, BANTEN",24,66,163,229
https://kawalpemilu.org#53003,"KOANG JAYA, KARAWACI, KOTA TANGERANG, BANTEN",25,65,169,234
https://kawalpemilu.org#53003,"KOANG JAYA, KARAWACI, KOTA TANGERANG, BANTEN",26,196,12,208
https://kawalpemilu.org#53003,"KOANG JAYA, KARAWACI, KOTA TANGERANG, BANTEN",27,193,12,205
https://kawalpemilu.org#53005,"PERIUK, PERIUK, KOTA TANGERANG, BANTEN",1,72,159,231
https://kawalpemilu.org#53005,"PERIUK, PERIUK, KOTA TANGERANG, BANTEN",2,89,118,207
https://kawalpemilu.org#53005,"PERIUK, PERIUK, KOTA TANGERANG, BANTEN",3,73,126,199
https://kawalpemilu.org#53005,"PERIUK, PERIUK, KOTA TANGERANG, BANTEN",4,83,125,208
https://kawalpemilu.org#53005,"PERIUK, PERIUK, KOTA TANGERANG, BANTEN",6,108,86,194
https://kawalpemilu.org#53005,"PERIUK, PERIUK, KOTA TANGERANG, BANTEN",7,75,120,195
https://kawalpemilu.org#53005,"PERIUK, PERIUK, KOTA TANGERANG, BANTEN",8,69,104,173
https://kawalpemilu.org#53005,"PERIUK, PERIUK, KOTA TANGERANG, BANTEN",9,81,132,213
https://kawalpemilu.org#53005,"PERIUK, PERIUK, KOTA TANGERANG, BANTEN",10,61,141,202
https://kawalpemilu.org#53005,"PERIUK, PERIUK, KOTA TANGERANG, BANTEN",11,85,124,209
https://kawalpemilu.org#53005,"PERIUK, PERIUK, KOTA TANGERANG, BANTEN",12,102,126,228
https://kawalpemilu.org#53005,"PERIUK, PERIUK, KOTA TANGERANG, BANTEN",13,74,137,211
https://kawalpemilu.org#53005,"PERIUK, PERIUK, KOTA TANGERANG, BANTEN",14,82,137,219
https://kawalpemilu.org#53005,"PERIUK, PERIUK, KOTA TANGERANG, BANTEN",15,88,145,233
https://kawalpemilu.org#53005,"PERIUK, PERIUK, KOTA TANGERANG, BANTEN",16,108,113,221
https://kawalpemilu.org#53005,"PERIUK, PERIUK, KOTA TANGERANG, BANTEN",17,92,104,196
https://kawalpemilu.org#53005,"PERIUK, PERIUK, KOTA TANGERANG, BANTEN",18,82,104,186
https://kawalpemilu.org#53005,"PERIUK, PERIUK, KOTA TANGERANG, BANTEN",19,102,81,183
https://kawalpemilu.org#53005,"PERIUK, PERIUK, KOTA TANGERANG, BANTEN",20,72,119,191
https://kawalpemilu.org#53005,"PERIUK, PERIUK, KOTA TANGERANG, BANTEN",22,83,143,226
https://kawalpemilu.org#53005,"PERIUK, PERIUK, KOTA TANGERANG, BANTEN",23,90,165,255
https://kawalpemilu.org#53005,"PERIUK, PERIUK, KOTA TANGERANG, BANTEN",24,62,105,167
https://kawalpemilu.org#53005,"PERIUK, PERIUK, KOTA TANGERANG, BANTEN",25,117,139,256
https://kawalpemilu.org#53005,"PERIUK, PERIUK, KOTA TANGERANG, BANTEN",26,69,98,167
https://kawalpemilu.org#53005,"PERIUK, PERIUK, KOTA TANGERANG, BANTEN",27,62,97,159
https://kawalpemilu.org#53005,"PERIUK, PERIUK, KOTA TANGERANG, BANTEN",29,56,126,182
https://kawalpemilu.org#53005,"PERIUK, PERIUK, KOTA TANGERANG, BANTEN",30,50,181,231
https://kawalpemilu.org#53005,"PERIUK, PERIUK, KOTA TANGERANG, BANTEN",31,60,169,229
https://kawalpemilu.org#53005,"PERIUK, PERIUK, KOTA TANGERANG, BANTEN",32,92,91,183
https://kawalpemilu.org#53005,"PERIUK, PERIUK, KOTA TANGERANG, BANTEN",33,93,59,152
https://kawalpemilu.org#53005,"PERIUK, PERIUK, KOTA TANGERANG, BANTEN",34,121,96,217
https://kawalpemilu.org#53005,"PERIUK, PERIUK, KOTA TANGERANG, BANTEN",35,97,106,203
https://kawalpemilu.org#53005,"PERIUK, PERIUK, KOTA TANGERANG, BANTEN",36,164,79,243
https://kawalpemilu.org#53005,"PERIUK, PERIUK, KOTA TANGERANG, BANTEN",37,147,78,225
https://kawalpemilu.org#53005,"PERIUK, PERIUK, KOTA TANGERANG, BANTEN",39,160,93,253
https://kawalpemilu.org#53005,"PERIUK, PERIUK, KOTA TANGERANG, BANTEN",40,117,139,256
https://kawalpemilu.org#53005,"PERIUK, PERIUK, KOTA TANGERANG, BANTEN",41,88,100,188
https://kawalpemilu.org#53005,"PERIUK, PERIUK, KOTA TANGERANG, BANTEN",42,131,69,200
https://kawalpemilu.org#53005,"PERIUK, PERIUK, KOTA TANGERANG, BANTEN",43,107,65,172
https://kawalpemilu.org#53005,"PERIUK, PERIUK, KOTA TANGERANG, BANTEN",44,158,29,187
https://kawalpemilu.org#53005,"PERIUK, PERIUK, KOTA TANGERANG, BANTEN",45,147,81,228
https://kawalpemilu.org#53005,"PERIUK, PERIUK, KOTA TANGERANG, BANTEN",46,153,78,231
https://kawalpemilu.org#53005,"PERIUK, PERIUK, KOTA TANGERANG, BANTEN",47,147,93,240
https://kawalpemilu.org#53005,"PERIUK, PERIUK, KOTA TANGERANG, BANTEN",48,90,139,229
https://kawalpemilu.org#53005,"PERIUK, PERIUK, KOTA TANGERANG, BANTEN",49,90,107,197
https://kawalpemilu.org#53005,"PERIUK, PERIUK, KOTA TANGERANG, BANTEN",50,96,99,195
https://kawalpemilu.org#53005,"PERIUK, PERIUK, KOTA TANGERANG, BANTEN",51,116,142,258
https://kawalpemilu.org#53005,"PERIUK, PERIUK, KOTA TANGERANG, BANTEN",52,106,80,186
https://kawalpemilu.org#53005,"PERIUK, PERIUK, KOTA TANGERANG, BANTEN",53,103,73,176
https://kawalpemilu.org#53005,"PERIUK, PERIUK, KOTA TANGERANG, BANTEN",54,159,80,239
https://kawalpemilu.org#53005,"PERIUK, PERIUK, KOTA TANGERANG, BANTEN",55,160,92,252
https://kawalpemilu.org#53005,"PERIUK, PERIUK, KOTA TANGERANG, BANTEN",56,130,89,219
https://kawalpemilu.org#53005,"PERIUK, PERIUK, KOTA TANGERANG, BANTEN",57,152,95,247
https://kawalpemilu.org#53005,"PERIUK, PERIUK, KOTA TANGERANG, BANTEN",58,159,95,254
https://kawalpemilu.org#53005,"PERIUK, PERIUK, KOTA TANGERANG, BANTEN",59,159,80,239
https://kawalpemilu.org#53005,"PERIUK, PERIUK, KOTA TANGERANG, BANTEN",60,182,78,260
https://kawalpemilu.org#53005,"PERIUK, PERIUK, KOTA TANGERANG, BANTEN",61,134,76,210
https://kawalpemilu.org#53005,"PERIUK, PERIUK, KOTA TANGERANG, BANTEN",62,165,60,225
https://kawalpemilu.org#53005,"PERIUK, PERIUK, KOTA TANGERANG, BANTEN",63,131,57,188
https://kawalpemilu.org#53006,"GEMBOR, PERIUK, KOTA TANGERANG, BANTEN",1,69,151,220
https://kawalpemilu.org#53006,"GEMBOR, PERIUK, KOTA TANGERANG, BANTEN",2,61,104,165
https://kawalpemilu.org#53006,"GEMBOR, PERIUK, KOTA TANGERANG, BANTEN",3,63,102,165
https://kawalpemilu.org#53006,"GEMBOR, PERIUK, KOTA TANGERANG, BANTEN",4,72,129,201
https://kawalpemilu.org#53006,"GEMBOR, PERIUK, KOTA TANGERANG, BANTEN",5,61,108,169
https://kawalpemilu.org#53006,"GEMBOR, PERIUK, KOTA TANGERANG, BANTEN",6,69,117,186
https://kawalpemilu.org#53006,"GEMBOR, PERIUK, KOTA TANGERANG, BANTEN",7,65,128,193
https://kawalpemilu.org#53006,"GEMBOR, PERIUK, KOTA TANGERANG, BANTEN",8,47,133,180
https://kawalpemilu.org#53006,"GEMBOR, PERIUK, KOTA TANGERANG, BANTEN",9,72,147,219
https://kawalpemilu.org#53006,"GEMBOR, PERIUK, KOTA TANGERANG, BANTEN",10,59,137,196
https://kawalpemilu.org#53006,"GEMBOR, PERIUK, KOTA TANGERANG, BANTEN",11,64,137,201
https://kawalpemilu.org#53006,"GEMBOR, PERIUK, KOTA TANGERANG, BANTEN",12,101,152,253
https://kawalpemilu.org#53006,"GEMBOR, PERIUK, KOTA TANGERANG, BANTEN",13,95,149,244
https://kawalpemilu.org#53006,"GEMBOR, PERIUK, KOTA TANGERANG, BANTEN",14,87,176,263
https://kawalpemilu.org#53006,"GEMBOR, PERIUK, KOTA TANGERANG, BANTEN",15,79,162,241
https://kawalpemilu.org#53006,"GEMBOR, PERIUK, KOTA TANGERANG, BANTEN",16,116,94,210
https://kawalpemilu.org#53006,"GEMBOR, PERIUK, KOTA TANGERANG, BANTEN",17,122,80,202
https://kawalpemilu.org#53006,"GEMBOR, PERIUK, KOTA TANGERANG, BANTEN",18,85,117,202
https://kawalpemilu.org#53006,"GEMBOR, PERIUK, KOTA TANGERANG, BANTEN",19,114,86,200
https://kawalpemilu.org#53006,"GEMBOR, PERIUK, KOTA TANGERANG, BANTEN",20,107,107,214
https://kawalpemilu.org#53006,"GEMBOR, PERIUK, KOTA TANGERANG, BANTEN",21,102,97,199
https://kawalpemilu.org#53006,"GEMBOR, PERIUK, KOTA TANGERANG, BANTEN",22,142,89,231
https://kawalpemilu.org#53006,"GEMBOR, PERIUK, KOTA TANGERANG, BANTEN",23,132,91,223
https://kawalpemilu.org#53006,"GEMBOR, PERIUK, KOTA TANGERANG, BANTEN",24,87,114,201
https://kawalpemilu.org#53006,"GEMBOR, PERIUK, KOTA TANGERANG, BANTEN",25,134,85,219
https://kawalpemilu.org#53006,"GEMBOR, PERIUK, KOTA TANGERANG, BANTEN",26,125,94,219
https://kawalpemilu.org#53006,"GEMBOR, PERIUK, KOTA TANGERANG, BANTEN",27,152,81,233
https://kawalpemilu.org#53006,"GEMBOR, PERIUK, KOTA TANGERANG, BANTEN",28,157,97,254
https://kawalpemilu.org#53006,"GEMBOR, PERIUK, KOTA TANGERANG, BANTEN",29,115,101,216
https://kawalpemilu.org#53006,"GEMBOR, PERIUK, KOTA TANGERANG, BANTEN",30,109,117,226
https://kawalpemilu.org#53006,"GEMBOR, PERIUK, KOTA TANGERANG, BANTEN",31,103,107,210
https://kawalpemilu.org#53006,"GEMBOR, PERIUK, KOTA TANGERANG, BANTEN",32,141,94,235
https://kawalpemilu.org#53006,"GEMBOR, PERIUK, KOTA TANGERANG, BANTEN",33,137,65,202
https://kawalpemilu.org#53006,"GEMBOR, PERIUK, KOTA TANGERANG, BANTEN",34,96,81,177
https://kawalpemilu.org#53006,"GEMBOR, PERIUK, KOTA TANGERANG, BANTEN",35,126,76,202
https://kawalpemilu.org#53006,"GEMBOR, PERIUK, KOTA TANGERANG, BANTEN",36,115,80,195
https://kawalpemilu.org#53006,"GEMBOR, PERIUK, KOTA TANGERANG, BANTEN",37,134,89,223
https://kawalpemilu.org#53006,"GEMBOR, PERIUK, KOTA TANGERANG, BANTEN",38,106,108,214
https://kawalpemilu.org#53006,"GEMBOR, PERIUK, KOTA TANGERANG, BANTEN",39,127,120,240
https://kawalpemilu.org#53006,"GEMBOR, PERIUK, KOTA TANGERANG, BANTEN",40,111,113,224
https://kawalpemilu.org#53006,"GEMBOR, PERIUK, KOTA TANGERANG, BANTEN",41,108,127,235
https://kawalpemilu.org#53006,"GEMBOR, PERIUK, KOTA TANGERANG, BANTEN",42,131,112,243
https://kawalpemilu.org#53006,"GEMBOR, PERIUK, KOTA TANGERANG, BANTEN",43,126,101,227
https://kawalpemilu.org#53006,"GEMBOR, PERIUK, KOTA TANGERANG, BANTEN",44,101,104,205
https://kawalpemilu.org#53006,"GEMBOR, PERIUK, KOTA TANGERANG, BANTEN",45,97,77,174
https://kawalpemilu.org#53006,"GEMBOR, PERIUK, KOTA TANGERANG, BANTEN",46,100,113,213
https://kawalpemilu.org#53006,"GEMBOR, PERIUK, KOTA TANGERANG, BANTEN",47,96,94,190
https://kawalpemilu.org#53006,"GEMBOR, PERIUK, KOTA TANGERANG, BANTEN",48,111,101,212
https://kawalpemilu.org#53006,"GEMBOR, PERIUK, KOTA TANGERANG, BANTEN",49,100,121,221
https://kawalpemilu.org#53006,"GEMBOR, PERIUK, KOTA TANGERANG, BANTEN",50,122,92,214
https://kawalpemilu.org#53006,"GEMBOR, PERIUK, KOTA TANGERANG, BANTEN",51,118,112,230
https://kawalpemilu.org#53006,"GEMBOR, PERIUK, KOTA TANGERANG, BANTEN",52,104,111,215
https://kawalpemilu.org#53006,"GEMBOR, PERIUK, KOTA TANGERANG, BANTEN",53,107,115,222
https://kawalpemilu.org#53006,"GEMBOR, PERIUK, KOTA TANGERANG, BANTEN",54,96,119,215
https://kawalpemilu.org#53006,"GEMBOR, PERIUK, KOTA TANGERANG, BANTEN",55,83,102,185
https://kawalpemilu.org#53006,"GEMBOR, PERIUK, KOTA TANGERANG, BANTEN",56,146,113,259
https://kawalpemilu.org#53006,"GEMBOR, PERIUK, KOTA TANGERANG, BANTEN",57,93,122,215
https://kawalpemilu.org#53006,"GEMBOR, PERIUK, KOTA TANGERANG, BANTEN",58,142,100,242
https://kawalpemilu.org#53006,"GEMBOR, PERIUK, KOTA TANGERANG, BANTEN",59,108,111,219
https://kawalpemilu.org#53006,"GEMBOR, PERIUK, KOTA TANGERANG, BANTEN",60,105,91,196
https://kawalpemilu.org#53006,"GEMBOR, PERIUK, KOTA TANGERANG, BANTEN",61,124,92,216
https://kawalpemilu.org#53006,"GEMBOR, PERIUK, KOTA TANGERANG, BANTEN",62,128,68,196
https://kawalpemilu.org#53006,"GEMBOR, PERIUK, KOTA TANGERANG, BANTEN",63,101,120,221
https://kawalpemilu.org#53006,"GEMBOR, PERIUK, KOTA TANGERANG, BANTEN",64,122,74,196
https://kawalpemilu.org#53006,"GEMBOR, PERIUK, KOTA TANGERANG, BANTEN",65,121,67,188
https://kawalpemilu.org#53006,"GEMBOR, PERIUK, KOTA TANGERANG, BANTEN",66,133,79,212
https://kawalpemilu.org#53006,"GEMBOR, PERIUK, KOTA TANGERANG, BANTEN",67,88,119,207
https://kawalpemilu.org#53006,"GEMBOR, PERIUK, KOTA TANGERANG, BANTEN",68,108,101,209
https://kawalpemilu.org#53006,"GEMBOR, PERIUK, KOTA TANGERANG, BANTEN",69,112,105,217
https://kawalpemilu.org#53006,"GEMBOR, PERIUK, KOTA TANGERANG, BANTEN",70,150,91,241
https://kawalpemilu.org#53006,"GEMBOR, PERIUK, KOTA TANGERANG, BANTEN",71,128,99,227
https://kawalpemilu.org#53006,"GEMBOR, PERIUK, KOTA TANGERANG, BANTEN",72,124,94,218
https://kawalpemilu.org#53006,"GEMBOR, PERIUK, KOTA TANGERANG, BANTEN",73,86,128,214
https://kawalpemilu.org#53006,"GEMBOR, PERIUK, KOTA TANGERANG, BANTEN",74,51,160,211
https://kawalpemilu.org#53006,"GEMBOR, PERIUK, KOTA TANGERANG, BANTEN",75,75,162,237
https://kawalpemilu.org#53006,"GEMBOR, PERIUK, KOTA TANGERANG, BANTEN",76,46,98,144
https://kawalpemilu.org#53006,"GEMBOR, PERIUK, KOTA TANGERANG, BANTEN",77,55,144,199
https://kawalpemilu.org#53006,"GEMBOR, PERIUK, KOTA TANGERANG, BANTEN",78,56,153,209
https://kawalpemilu.org#53006,"GEMBOR, PERIUK, KOTA TANGERANG, BANTEN",79,67,118,185
https://kawalpemilu.org#53006,"GEMBOR, PERIUK, KOTA TANGERANG, BANTEN",80,72,139,211
https://kawalpemilu.org#53006,"GEMBOR, PERIUK, KOTA TANGERANG, BANTEN",81,60,137,197
https://kawalpemilu.org#53007,"GEBANG RAYA, PERIUK, KOTA TANGERANG, BANTEN",1,67,120,187
https://kawalpemilu.org#53007,"GEBANG RAYA, PERIUK, KOTA TANGERANG, BANTEN",2,41,119,163
https://kawalpemilu.org#53007,"GEBANG RAYA, PERIUK, KOTA TANGERANG, BANTEN",3,65,116,181
https://kawalpemilu.org#53007,"GEBANG RAYA, PERIUK, KOTA TANGERANG, BANTEN",4,69,127,196
https://kawalpemilu.org#53007,"GEBANG RAYA, PERIUK, KOTA TANGERANG, BANTEN",5,58,101,159
https://kawalpemilu.org#53007,"GEBANG RAYA, PERIUK, KOTA TANGERANG, BANTEN",6,75,143,218
https://kawalpemilu.org#53007,"GEBANG RAYA, PERIUK, KOTA TANGERANG, BANTEN",7,75,124,199
https://kawalpemilu.org#53007,"GEBANG RAYA, PERIUK, KOTA TANGERANG, BANTEN",8,86,137,223
https://kawalpemilu.org#53007,"GEBANG RAYA, PERIUK, KOTA TANGERANG, BANTEN",9,65,136,201
https://kawalpemilu.org#53007,"GEBANG RAYA, PERIUK, KOTA TANGERANG, BANTEN",10,59,150,209
https://kawalpemilu.org#53007,"GEBANG RAYA, PERIUK, KOTA TANGERANG, BANTEN",11,55,166,221
https://kawalpemilu.org#53007,"GEBANG RAYA, PERIUK, KOTA TANGERANG, BANTEN",12,66,139,205
https://kawalpemilu.org#53007,"GEBANG RAYA, PERIUK, KOTA TANGERANG, BANTEN",13,55,158,213
https://kawalpemilu.org#53007,"GEBANG RAYA, PERIUK, KOTA TANGERANG, BANTEN",14,62,180,242
https://kawalpemilu.org#53007,"GEBANG RAYA, PERIUK, KOTA TANGERANG, BANTEN",15,131,107,238
https://kawalpemilu.org#53007,"GEBANG RAYA, PERIUK, KOTA TANGERANG, BANTEN",16,121,109,230
https://kawalpemilu.org#53007,"GEBANG RAYA, PERIUK, KOTA TANGERANG, BANTEN",18,123,90,213
https://kawalpemilu.org#53007,"GEBANG RAYA, PERIUK, KOTA TANGERANG, BANTEN",19,119,128,247
https://kawalpemilu.org#53007,"GEBANG RAYA, PERIUK, KOTA TANGERANG, BANTEN",20,144,111,255
https://kawalpemilu.org#53007,"GEBANG RAYA, PERIUK, KOTA TANGERANG, BANTEN",21,126,90,216
https://kawalpemilu.org#53007,"GEBANG RAYA, PERIUK, KOTA TANGERANG, BANTEN",22,120,86,206
https://kawalpemilu.org#53007,"GEBANG RAYA, PERIUK, KOTA TANGERANG, BANTEN",23,140,85,225
https://kawalpemilu.org#53007,"GEBANG RAYA, PERIUK, KOTA TANGERANG, BANTEN",24,130,87,217
https://kawalpemilu.org#53007,"GEBANG RAYA, PERIUK, KOTA TANGERANG, BANTEN",25,105,84,189
https://kawalpemilu.org#53007,"GEBANG RAYA, PERIUK, KOTA TANGERANG, BANTEN",26,132,86,218
https://kawalpemilu.org#53007,"GEBANG RAYA, PERIUK, KOTA TANGERANG, BANTEN",27,142,66,208
https://kawalpemilu.org#53007,"GEBANG RAYA, PERIUK, KOTA TANGERANG, BANTEN",28,130,97,227
https://kawalpemilu.org#53007,"GEBANG RAYA, PERIUK, KOTA TANGERANG, BANTEN",29,99,156,255
https://kawalpemilu.org#53007,"GEBANG RAYA, PERIUK, KOTA TANGERANG, BANTEN",30,60,147,207
https://kawalpemilu.org#53007,"GEBANG RAYA, PERIUK, KOTA TANGERANG, BANTEN",31,62,136,198
https://kawalpemilu.org#53007,"GEBANG RAYA, PERIUK, KOTA TANGERANG, BANTEN",32,73,160,233
https://kawalpemilu.org#53007,"GEBANG RAYA, PERIUK, KOTA TANGERANG, BANTEN",33,107,137,244
https://kawalpemilu.org#53007,"GEBANG RAYA, PERIUK, KOTA TANGERANG, BANTEN",34,93,126,219
https://kawalpemilu.org#53007,"GEBANG RAYA, PERIUK, KOTA TANGERANG, BANTEN",35,66,121,187
https://kawalpemilu.org#53007,"GEBANG RAYA, PERIUK, KOTA TANGERANG, BANTEN",36,81,136,217
https://kawalpemilu.org#53007,"GEBANG RAYA, PERIUK, KOTA TANGERANG, BANTEN",37,175,52,227
https://kawalpemilu.org#53007,"GEBANG RAYA, PERIUK, KOTA TANGERANG, BANTEN",38,116,109,225
https://kawalpemilu.org#53007,"GEBANG RAYA, PERIUK, KOTA TANGERANG, BANTEN",39,96,122,218
https://kawalpemilu.org#53007,"GEBANG RAYA, PERIUK, KOTA TANGERANG, BANTEN",40,94,119,213
https://kawalpemilu.org#53007,"GEBANG RAYA, PERIUK, KOTA TANGERANG, BANTEN",41,128,96,224
https://kawalpemilu.org#53007,"GEBANG RAYA, PERIUK, KOTA TANGERANG, BANTEN",42,93,135,228
https://kawalpemilu.org#53007,"GEBANG RAYA, PERIUK, KOTA TANGERANG, BANTEN",43,125,96,221
https://kawalpemilu.org#53007,"GEBANG RAYA, PERIUK, KOTA TANGERANG, BANTEN",44,130,82,212
https://kawalpemilu.org#53007,"GEBANG RAYA, PERIUK, KOTA TANGERANG, BANTEN",45,132,83,215
https://kawalpemilu.org#53007,"GEBANG RAYA, PERIUK, KOTA TANGERANG, BANTEN",46,123,106,229
https://kawalpemilu.org#53007,"GEBANG RAYA, PERIUK, KOTA TANGERANG, BANTEN",47,93,130,223
https://kawalpemilu.org#53007,"GEBANG RAYA, PERIUK, KOTA TANGERANG, BANTEN",48,125,79,204
https://kawalpemilu.org#53007,"GEBANG RAYA, PERIUK, KOTA TANGERANG, BANTEN",49,125,120,245
https://kawalpemilu.org#53007,"GEBANG RAYA, PERIUK, KOTA TANGERANG, BANTEN",51,116,129,245
https://kawalpemilu.org#53007,"GEBANG RAYA, PERIUK, KOTA TANGERANG, BANTEN",52,135,110,245
https://kawalpemilu.org#53007,"GEBANG RAYA, PERIUK, KOTA TANGERANG, BANTEN",53,141,78,219
https://kawalpemilu.org#53007,"GEBANG RAYA, PERIUK, KOTA TANGERANG, BANTEN",54,170,73,243
https://kawalpemilu.org#53007,"GEBANG RAYA, PERIUK, KOTA TANGERANG, BANTEN",55,163,66,229
https://kawalpemilu.org#53007,"GEBANG RAYA, PERIUK, KOTA TANGERANG, BANTEN",56,200,45,245
https://kawalpemilu.org#53007,"GEBANG RAYA, PERIUK, KOTA TANGERANG, BANTEN",57,174,42,216
https://kawalpemilu.org#53007,"GEBANG RAYA, PERIUK, KOTA TANGERANG, BANTEN",58,198,44,242
https://kawalpemilu.org#53007,"GEBANG RAYA, PERIUK, KOTA TANGERANG, BANTEN",59,186,35,221
https://kawalpemilu.org#53007,"GEBANG RAYA, PERIUK, KOTA TANGERANG, BANTEN",60,203,93,298
https://kawalpemilu.org#53007,"GEBANG RAYA, PERIUK, KOTA TANGERANG, BANTEN",61,155,132,287
https://kawalpemilu.org#53007,"GEBANG RAYA, PERIUK, KOTA TANGERANG, BANTEN",62,176,108,284
https://kawalpemilu.org#53007,"GEBANG RAYA, PERIUK, KOTA TANGERANG, BANTEN",63,128,143,271
https://kawalpemilu.org#53007,"GEBANG RAYA, PERIUK, KOTA TANGERANG, BANTEN",65,104,97,201
https://kawalpemilu.org#53007,"GEBANG RAYA, PERIUK, KOTA TANGERANG, BANTEN",66,163,61,224
https://kawalpemilu.org#53007,"GEBANG RAYA, PERIUK, KOTA TANGERANG, BANTEN",67,148,89,237
https://kawalpemilu.org#53007,"GEBANG RAYA, PERIUK, KOTA TANGERANG, BANTEN",68,120,93,213
https://kawalpemilu.org#53007,"GEBANG RAYA, PERIUK, KOTA TANGERANG, BANTEN",69,148,70,218
https://kawalpemilu.org#53007,"GEBANG RAYA, PERIUK, KOTA TANGERANG, BANTEN",70,143,58,201
https://kawalpemilu.org#53007,"GEBANG RAYA, PERIUK, KOTA TANGERANG, BANTEN",72,137,56,193
https://kawalpemilu.org#53007,"GEBANG RAYA, PERIUK, KOTA TANGERANG, BANTEN",73,178,46,224
https://kawalpemilu.org#53007,"GEBANG RAYA, PERIUK, KOTA TANGERANG, BANTEN",74,177,18,195
https://kawalpemilu.org#53007,"GEBANG RAYA, PERIUK, KOTA TANGERANG, BANTEN",75,105,132,237
https://kawalpemilu.org#53007,"GEBANG RAYA, PERIUK, KOTA TANGERANG, BANTEN",76,139,116,255
https://kawalpemilu.org#53007,"GEBANG RAYA, PERIUK, KOTA TANGERANG, BANTEN",77,159,105,264
https://kawalpemilu.org#53007,"GEBANG RAYA, PERIUK, KOTA TANGERANG, BANTEN",78,144,115,259
https://kawalpemilu.org#53007,"GEBANG RAYA, PERIUK, KOTA TANGERANG, BANTEN",79,102,134,236
https://kawalpemilu.org#53007,"GEBANG RAYA, PERIUK, KOTA TANGERANG, BANTEN",80,106,113,219
https://kawalpemilu.org#53007,"GEBANG RAYA, PERIUK, KOTA TANGERANG, BANTEN",81,77,149,226
https://kawalpemilu.org#53007,"GEBANG RAYA, PERIUK, KOTA TANGERANG, BANTEN",82,118,144,262
https://kawalpemilu.org#53007,"GEBANG RAYA, PERIUK, KOTA TANGERANG, BANTEN",83,117,138,255
https://kawalpemilu.org#53007,"GEBANG RAYA, PERIUK, KOTA TANGERANG, BANTEN",84,71,104,175
https://kawalpemilu.org#53007,"GEBANG RAYA, PERIUK, KOTA TANGERANG, BANTEN",85,87,102,189
https://kawalpemilu.org#53007,"GEBANG RAYA, PERIUK, KOTA TANGERANG, BANTEN",86,56,113,169
https://kawalpemilu.org#53007,"GEBANG RAYA, PERIUK, KOTA TANGERANG, BANTEN",87,57,136,193
https://kawalpemilu.org#53007,"GEBANG RAYA, PERIUK, KOTA TANGERANG, BANTEN",88,47,131,178
https://kawalpemilu.org#53007,"GEBANG RAYA, PERIUK, KOTA TANGERANG, BANTEN",89,226,24,250
https://kawalpemilu.org#53007,"GEBANG RAYA, PERIUK, KOTA TANGERANG, BANTEN",90,185,28,213
https://kawalpemilu.org#53007,"GEBANG RAYA, PERIUK, KOTA TANGERANG, BANTEN",92,194,20,214
https://kawalpemilu.org#53007,"GEBANG RAYA, PERIUK, KOTA TANGERANG, BANTEN",93,131,78,211
https://kawalpemilu.org#53007,"GEBANG RAYA, PERIUK, KOTA TANGERANG, BANTEN",94,131,78,211
https://kawalpemilu.org#53007,"GEBANG RAYA, PERIUK, KOTA TANGERANG, BANTEN",95,163,89,252
https://kawalpemilu.org#53007,"GEBANG RAYA, PERIUK, KOTA TANGERANG, BANTEN",96,135,89,224
https://kawalpemilu.org#53007,"GEBANG RAYA, PERIUK, KOTA TANGERANG, BANTEN",97,107,75,182
https://kawalpemilu.org#53007,"GEBANG RAYA, PERIUK, KOTA TANGERANG, BANTEN",98,127,87,214
https://kawalpemilu.org#53007,"GEBANG RAYA, PERIUK, KOTA TANGERANG, BANTEN",99,122,66,188
https://kawalpemilu.org#53007,"GEBANG RAYA, PERIUK, KOTA TANGERANG, BANTEN",100,143,41,184
https://kawalpemilu.org#53008,"SANGIANG JAYA, PERIUK, KOTA TANGERANG, BANTEN",1,35,114,149
https://kawalpemilu.org#53008,"SANGIANG JAYA, PERIUK, KOTA TANGERANG, BANTEN",2,88,133,221
https://kawalpemilu.org#53008,"SANGIANG JAYA, PERIUK, KOTA TANGERANG, BANTEN",3,73,137,210
https://kawalpemilu.org#53008,"SANGIANG JAYA, PERIUK, KOTA TANGERANG, BANTEN",4,71,120,191
https://kawalpemilu.org#53008,"SANGIANG JAYA, PERIUK, KOTA TANGERANG, BANTEN",5,110,107,217
https://kawalpemilu.org#53008,"SANGIANG JAYA, PERIUK, KOTA TANGERANG, BANTEN",6,66,136,202
https://kawalpemilu.org#53008,"SANGIANG JAYA, PERIUK, KOTA TANGERANG, BANTEN",7,62,93,155
https://kawalpemilu.org#53008,"SANGIANG JAYA, PERIUK, KOTA TANGERANG, BANTEN",9,103,180,283
https://kawalpemilu.org#53008,"SANGIANG JAYA, PERIUK, KOTA TANGERANG, BANTEN",10,104,155,259
https://kawalpemilu.org#53008,"SANGIANG JAYA, PERIUK, KOTA TANGERANG, BANTEN",11,87,158,245
https://kawalpemilu.org#53008,"SANGIANG JAYA, PERIUK, KOTA TANGERANG, BANTEN",12,140,135,275
https://kawalpemilu.org#53008,"SANGIANG JAYA, PERIUK, KOTA TANGERANG, BANTEN",13,117,119,236
https://kawalpemilu.org#53008,"SANGIANG JAYA, PERIUK, KOTA TANGERANG, BANTEN",14,120,120,240
https://kawalpemilu.org#53008,"SANGIANG JAYA, PERIUK, KOTA TANGERANG, BANTEN",15,102,140,242
https://kawalpemilu.org#53008,"SANGIANG JAYA, PERIUK, KOTA TANGERANG, BANTEN",16,78,124,202
https://kawalpemilu.org#53008,"SANGIANG JAYA, PERIUK, KOTA TANGERANG, BANTEN",18,69,182,251
https://kawalpemilu.org#53008,"SANGIANG JAYA, PERIUK, KOTA TANGERANG, BANTEN",19,90,147,237
https://kawalpemilu.org#53008,"SANGIANG JAYA, PERIUK, KOTA TANGERANG, BANTEN",21,76,126,202
https://kawalpemilu.org#53008,"SANGIANG JAYA, PERIUK, KOTA TANGERANG, BANTEN",22,75,129,204
https://kawalpemilu.org#53008,"SANGIANG JAYA, PERIUK, KOTA TANGERANG, BANTEN",23,83,127,210
https://kawalpemilu.org#53008,"SANGIANG JAYA, PERIUK, KOTA TANGERANG, BANTEN",25,89,148,237
https://kawalpemilu.org#53008,"SANGIANG JAYA, PERIUK, KOTA TANGERANG, BANTEN",26,90,150,240
https://kawalpemilu.org#53008,"SANGIANG JAYA, PERIUK, KOTA TANGERANG, BANTEN",27,77,194,271
https://kawalpemilu.org#53008,"SANGIANG JAYA, PERIUK, KOTA TANGERANG, BANTEN",32,99,170,269
https://kawalpemilu.org#53008,"SANGIANG JAYA, PERIUK, KOTA TANGERANG, BANTEN",33,89,152,241
https://kawalpemilu.org#53008,"SANGIANG JAYA, PERIUK, KOTA TANGERANG, BANTEN",34,64,154,218
https://kawalpemilu.org#53008,"SANGIANG JAYA, PERIUK, KOTA TANGERANG, BANTEN",35,44,168,212
https://kawalpemilu.org#53008,"SANGIANG JAYA, PERIUK, KOTA TANGERANG, BANTEN",36,49,165,214
https://kawalpemilu.org#53008,"SANGIANG JAYA, PERIUK, KOTA TANGERANG, BANTEN",37,139,94,233
https://kawalpemilu.org#53008,"SANGIANG JAYA, PERIUK, KOTA TANGERANG, BANTEN",38,125,46,171
https://kawalpemilu.org#53008,"SANGIANG JAYA, PERIUK, KOTA TANGERANG, BANTEN",39,141,63,204
https://kawalpemilu.org#53008,"SANGIANG JAYA, PERIUK, KOTA TANGERANG, BANTEN",40,181,37,218
https://kawalpemilu.org#53008,"SANGIANG JAYA, PERIUK, KOTA TANGERANG, BANTEN",41,204,51,255
https://kawalpemilu.org#53008,"SANGIANG JAYA, PERIUK, KOTA TANGERANG, BANTEN",42,217,61,278
https://kawalpemilu.org#53008,"SANGIANG JAYA, PERIUK, KOTA TANGERANG, BANTEN",45,140,89,229
https://kawalpemilu.org#53008,"SANGIANG JAYA, PERIUK, KOTA TANGERANG, BANTEN",46,212,65,277
https://kawalpemilu.org#53008,"SANGIANG JAYA, PERIUK, KOTA TANGERANG, BANTEN",47,116,74,190
https://kawalpemilu.org#53008,"SANGIANG JAYA, PERIUK, KOTA TANGERANG, BANTEN",48,145,22,167
https://kawalpemilu.org#53008,"SANGIANG JAYA, PERIUK, KOTA TANGERANG, BANTEN",49,146,26,172
https://kawalpemilu.org#53008,"SANGIANG JAYA, PERIUK, KOTA TANGERANG, BANTEN",50,251,10,261
https://kawalpemilu.org#53008,"SANGIANG JAYA, PERIUK, KOTA TANGERANG, BANTEN",51,193,46,239
https://kawalpemilu.org#53008,"SANGIANG JAYA, PERIUK, KOTA TANGERANG, BANTEN",52,158,39,197
https://kawalpemilu.org#53008,"SANGIANG JAYA, PERIUK, KOTA TANGERANG, BANTEN",53,184,18,202
https://kawalpemilu.org#53008,"SANGIANG JAYA, PERIUK, KOTA TANGERANG, BANTEN",54,275,10,285
https://kawalpemilu.org#53008,"SANGIANG JAYA, PERIUK, KOTA TANGERANG, BANTEN",55,256,18,274
https://kawalpemilu.org#53008,"SANGIANG JAYA, PERIUK, KOTA TANGERANG, BANTEN",56,216,18,234
https://kawalpemilu.org#53008,"SANGIANG JAYA, PERIUK, KOTA TANGERANG, BANTEN",57,215,38,253
https://kawalpemilu.org#53008,"SANGIANG JAYA, PERIUK, KOTA TANGERANG, BANTEN",58,225,14,239
https://kawalpemilu.org#53008,"SANGIANG JAYA, PERIUK, KOTA TANGERANG, BANTEN",59,234,26,260
https://kawalpemilu.org#53008,"SANGIANG JAYA, PERIUK, KOTA TANGERANG, BANTEN",60,71,55,126
https://kawalpemilu.org#53009,"PERIUK JAYA, PERIUK, KOTA TANGERANG, BANTEN",1,78,164,242
https://kawalpemilu.org#53009,"PERIUK JAYA, PERIUK, KOTA TANGERANG, BANTEN",2,59,142,201
https://kawalpemilu.org#53009,"PERIUK JAYA, PERIUK, KOTA TANGERANG, BANTEN",3,41,188,229
https://kawalpemilu.org#53009,"PERIUK JAYA, PERIUK, KOTA TANGERANG, BANTEN",4,61,149,210
https://kawalpemilu.org#53009,"PERIUK JAYA, PERIUK, KOTA TANGERANG, BANTEN",5,87,132,219
https://kawalpemilu.org#53009,"PERIUK JAYA, PERIUK, KOTA TANGERANG, BANTEN",6,93,146,239
https://kawalpemilu.org#53009,"PERIUK JAYA, PERIUK, KOTA TANGERANG, BANTEN",7,96,124,220
https://kawalpemilu.org#53009,"PERIUK JAYA, PERIUK, KOTA TANGERANG, BANTEN",8,56,160,216
https://kawalpemilu.org#53009,"PERIUK JAYA, PERIUK, KOTA TANGERANG, BANTEN",9,67,126,193
https://kawalpemilu.org#53009,"PERIUK JAYA, PERIUK, KOTA TANGERANG, BANTEN",10,71,118,189
https://kawalpemilu.org#53009,"PERIUK JAYA, PERIUK, KOTA TANGERANG, BANTEN",12,88,139,227
https://kawalpemilu.org#53009,"PERIUK JAYA, PERIUK, KOTA TANGERANG, BANTEN",13,84,150,234
https://kawalpemilu.org#53009,"PERIUK JAYA, PERIUK, KOTA TANGERANG, BANTEN",14,60,159,219
https://kawalpemilu.org#53009,"PERIUK JAYA, PERIUK, KOTA TANGERANG, BANTEN",15,50,117,167
https://kawalpemilu.org#53009,"PERIUK JAYA, PERIUK, KOTA TANGERANG, BANTEN",16,101,75,176
https://kawalpemilu.org#53009,"PERIUK JAYA, PERIUK, KOTA TANGERANG, BANTEN",17,59,157,216
https://kawalpemilu.org#53009,"PERIUK JAYA, PERIUK, KOTA TANGERANG, BANTEN",18,79,116,195
https://kawalpemilu.org#53009,"PERIUK JAYA, PERIUK, KOTA TANGERANG, BANTEN",19,78,105,183
https://kawalpemilu.org#53009,"PERIUK JAYA, PERIUK, KOTA TANGERANG, BANTEN",20,87,91,178
https://kawalpemilu.org#53009,"PERIUK JAYA, PERIUK, KOTA TANGERANG, BANTEN",21,64,116,180
https://kawalpemilu.org#53009,"PERIUK JAYA, PERIUK, KOTA TANGERANG, BANTEN",22,82,116,198
https://kawalpemilu.org#53009,"PERIUK JAYA, PERIUK, KOTA TANGERANG, BANTEN",23,69,155,224
https://kawalpemilu.org#53009,"PERIUK JAYA, PERIUK, KOTA TANGERANG, BANTEN",24,61,160,221
https://kawalpemilu.org#53009,"PERIUK JAYA, PERIUK, KOTA TANGERANG, BANTEN",25,81,134,215
https://kawalpemilu.org#53009,"PERIUK JAYA, PERIUK, KOTA TANGERANG, BANTEN",26,142,100,242
https://kawalpemilu.org#53009,"PERIUK JAYA, PERIUK, KOTA TANGERANG, BANTEN",27,97,124,221
https://kawalpemilu.org#53009,"PERIUK JAYA, PERIUK, KOTA TANGERANG, BANTEN",28,94,126,220
https://kawalpemilu.org#53009,"PERIUK JAYA, PERIUK, KOTA TANGERANG, BANTEN",29,66,79,145
https://kawalpemilu.org#53009,"PERIUK JAYA, PERIUK, KOTA TANGERANG, BANTEN",30,98,81,179
https://kawalpemilu.org#53009,"PERIUK JAYA, PERIUK, KOTA TANGERANG, BANTEN",31,111,80,191
https://kawalpemilu.org#53009,"PERIUK JAYA, PERIUK, KOTA TANGERANG, BANTEN",32,128,86,214
https://kawalpemilu.org#53009,"PERIUK JAYA, PERIUK, KOTA TANGERANG, BANTEN",33,109,86,195
https://kawalpemilu.org#53009,"PERIUK JAYA, PERIUK, KOTA TANGERANG, BANTEN",34,102,84,186
https://kawalpemilu.org#53009,"PERIUK JAYA, PERIUK, KOTA TANGERANG, BANTEN",35,114,77,191
https://kawalpemilu.org#53009,"PERIUK JAYA, PERIUK, KOTA TANGERANG, BANTEN",36,106,126,232
https://kawalpemilu.org#53009,"PERIUK JAYA, PERIUK, KOTA TANGERANG, BANTEN",38,124,99,223
https://kawalpemilu.org#53009,"PERIUK JAYA, PERIUK, KOTA TANGERANG, BANTEN",39,145,90,235
https://kawalpemilu.org#53009,"PERIUK JAYA, PERIUK, KOTA TANGERANG, BANTEN",40,124,119,243
https://kawalpemilu.org#53009,"PERIUK JAYA, PERIUK, KOTA TANGERANG, BANTEN",41,129,84,213
https://kawalpemilu.org#53009,"PERIUK JAYA, PERIUK, KOTA TANGERANG, BANTEN",42,91,109,200
https://kawalpemilu.org#53009,"PERIUK JAYA, PERIUK, KOTA TANGERANG, BANTEN",43,122,116,238
https://kawalpemilu.org#53009,"PERIUK JAYA, PERIUK, KOTA TANGERANG, BANTEN",45,109,88,197
https://kawalpemilu.org#53009,"PERIUK JAYA, PERIUK, KOTA TANGERANG, BANTEN",46,92,97,189
https://kawalpemilu.org#53009,"PERIUK JAYA, PERIUK, KOTA TANGERANG, BANTEN",47,114,82,196
https://kawalpemilu.org#53009,"PERIUK JAYA, PERIUK, KOTA TANGERANG, BANTEN",48,108,80,188
https://kawalpemilu.org#53011,"CIBODAS, CIBODAS, KOTA TANGERANG, BANTEN",1,93,139,232
https://kawalpemilu.org#53011,"CIBODAS, CIBODAS, KOTA TANGERANG, BANTEN",2,57,163,220
https://kawalpemilu.org#53011,"CIBODAS, CIBODAS, KOTA TANGERANG, BANTEN",3,66,165,231
https://kawalpemilu.org#53011,"CIBODAS, CIBODAS, KOTA TANGERANG, BANTEN",4,80,100,180
https://kawalpemilu.org#53011,"CIBODAS, CIBODAS, KOTA TANGERANG, BANTEN",5,101,160,261
https://kawalpemilu.org#53011,"CIBODAS, CIBODAS, KOTA TANGERANG, BANTEN",6,102,155,257
https://kawalpemilu.org#53011,"CIBODAS, CIBODAS, KOTA TANGERANG, BANTEN",7,96,136,232
https://kawalpemilu.org#53011,"CIBODAS, CIBODAS, KOTA TANGERANG, BANTEN",8,121,112,233
https://kawalpemilu.org#53011,"CIBODAS, CIBODAS, KOTA TANGERANG, BANTEN",9,114,127,241
https://kawalpemilu.org#53011,"CIBODAS, CIBODAS, KOTA TANGERANG, BANTEN",10,101,145,246
https://kawalpemilu.org#53011,"CIBODAS, CIBODAS, KOTA TANGERANG, BANTEN",11,138,158,296
https://kawalpemilu.org#53011,"CIBODAS, CIBODAS, KOTA TANGERANG, BANTEN",12,132,135,267
https://kawalpemilu.org#53011,"CIBODAS, CIBODAS, KOTA TANGERANG, BANTEN",13,88,164,252
https://kawalpemilu.org#53011,"CIBODAS, CIBODAS, KOTA TANGERANG, BANTEN",14,89,164,253
https://kawalpemilu.org#53011,"CIBODAS, CIBODAS, KOTA TANGERANG, BANTEN",15,99,81,180
https://kawalpemilu.org#53011,"CIBODAS, CIBODAS, KOTA TANGERANG, BANTEN",16,102,75,177
https://kawalpemilu.org#53011,"CIBODAS, CIBODAS, KOTA TANGERANG, BANTEN",17,123,64,187
https://kawalpemilu.org#53011,"CIBODAS, CIBODAS, KOTA TANGERANG, BANTEN",18,119,83,202
https://kawalpemilu.org#53011,"CIBODAS, CIBODAS, KOTA TANGERANG, BANTEN",19,82,95,177
https://kawalpemilu.org#53011,"CIBODAS, CIBODAS, KOTA TANGERANG, BANTEN",20,87,64,151
https://kawalpemilu.org#53011,"CIBODAS, CIBODAS, KOTA TANGERANG, BANTEN",21,90,142,232
https://kawalpemilu.org#53011,"CIBODAS, CIBODAS, KOTA TANGERANG, BANTEN",22,57,154,211
https://kawalpemilu.org#53011,"CIBODAS, CIBODAS, KOTA TANGERANG, BANTEN",23,148,82,230
https://kawalpemilu.org#53011,"CIBODAS, CIBODAS, KOTA TANGERANG, BANTEN",24,142,127,269
https://kawalpemilu.org#53011,"CIBODAS, CIBODAS, KOTA TANGERANG, BANTEN",26,115,148,263
https://kawalpemilu.org#53011,"CIBODAS, CIBODAS, KOTA TANGERANG, BANTEN",27,149,101,250
https://kawalpemilu.org#53011,"CIBODAS, CIBODAS, KOTA TANGERANG, BANTEN",28,146,87,233
https://kawalpemilu.org#53011,"CIBODAS, CIBODAS, KOTA TANGERANG, BANTEN",30,144,76,220
https://kawalpemilu.org#53011,"CIBODAS, CIBODAS, KOTA TANGERANG, BANTEN",31,156,97,253
https://kawalpemilu.org#53011,"CIBODAS, CIBODAS, KOTA TANGERANG, BANTEN",32,87,102,189
https://kawalpemilu.org#53011,"CIBODAS, CIBODAS, KOTA TANGERANG, BANTEN",33,89,103,192
https://kawalpemilu.org#53011,"CIBODAS, CIBODAS, KOTA TANGERANG, BANTEN",34,112,113,225
https://kawalpemilu.org#53011,"CIBODAS, CIBODAS, KOTA TANGERANG, BANTEN",35,110,155,265
https://kawalpemilu.org#53011,"CIBODAS, CIBODAS, KOTA TANGERANG, BANTEN",36,105,137,242
https://kawalpemilu.org#53011,"CIBODAS, CIBODAS, KOTA TANGERANG, BANTEN",37,124,141,265
https://kawalpemilu.org#53011,"CIBODAS, CIBODAS, KOTA TANGERANG, BANTEN",38,138,121,259
https://kawalpemilu.org#53011,"CIBODAS, CIBODAS, KOTA TANGERANG, BANTEN",39,162,57,219
https://kawalpemilu.org#53011,"CIBODAS, CIBODAS, KOTA TANGERANG, BANTEN",40,143,69,212
https://kawalpemilu.org#53011,"CIBODAS, CIBODAS, KOTA TANGERANG, BANTEN",41,150,54,204
https://kawalpemilu.org#53011,"CIBODAS, CIBODAS, KOTA TANGERANG, BANTEN",42,164,72,236
https://kawalpemilu.org#53011,"CIBODAS, CIBODAS, KOTA TANGERANG, BANTEN",43,115,43,158
https://kawalpemilu.org#53011,"CIBODAS, CIBODAS, KOTA TANGERANG, BANTEN",44,149,73,222
https://kawalpemilu.org#53011,"CIBODAS, CIBODAS, KOTA TANGERANG, BANTEN",45,127,89,216
https://kawalpemilu.org#53011,"CIBODAS, CIBODAS, KOTA TANGERANG, BANTEN",46,145,107,252
https://kawalpemilu.org#53011,"CIBODAS, CIBODAS, KOTA TANGERANG, BANTEN",47,146,68,214
https://kawalpemilu.org#53011,"CIBODAS, CIBODAS, KOTA TANGERANG, BANTEN",48,159,104,263
https://kawalpemilu.org#53011,"CIBODAS, CIBODAS, KOTA TANGERANG, BANTEN",49,185,61,246
https://kawalpemilu.org#53011,"CIBODAS, CIBODAS, KOTA TANGERANG, BANTEN",50,127,57,184
https://kawalpemilu.org#53011,"CIBODAS, CIBODAS, KOTA TANGERANG, BANTEN",51,164,84,248
https://kawalpemilu.org#53011,"CIBODAS, CIBODAS, KOTA TANGERANG, BANTEN",52,163,75,238
https://kawalpemilu.org#53011,"CIBODAS, CIBODAS, KOTA TANGERANG, BANTEN",53,131,84,215
https://kawalpemilu.org#53011,"CIBODAS, CIBODAS, KOTA TANGERANG, BANTEN",54,146,85,233
https://kawalpemilu.org#53011,"CIBODAS, CIBODAS, KOTA TANGERANG, BANTEN",55,140,114,254
https://kawalpemilu.org#53011,"CIBODAS, CIBODAS, KOTA TANGERANG, BANTEN",56,105,139,244
https://kawalpemilu.org#53011,"CIBODAS, CIBODAS, KOTA TANGERANG, BANTEN",57,101,139,240
https://kawalpemilu.org#53011,"CIBODAS, CIBODAS, KOTA TANGERANG, BANTEN",59,118,123,241
https://kawalpemilu.org#53011,"CIBODAS, CIBODAS, KOTA TANGERANG, BANTEN",60,164,91,255
https://kawalpemilu.org#53011,"CIBODAS, CIBODAS, KOTA TANGERANG, BANTEN",61,172,77,249
https://kawalpemilu.org#53011,"CIBODAS, CIBODAS, KOTA TANGERANG, BANTEN",62,104,119,223
https://kawalpemilu.org#53011,"CIBODAS, CIBODAS, KOTA TANGERANG, BANTEN",63,131,62,193
https://kawalpemilu.org#53012,"CIBODASARI, CIBODAS, KOTA TANGERANG, BANTEN",1,105,156,261
https://kawalpemilu.org#53012,"CIBODASARI, CIBODAS, KOTA TANGERANG, BANTEN",2,92,155,247
https://kawalpemilu.org#53012,"CIBODASARI, CIBODAS, KOTA TANGERANG, BANTEN",3,107,136,243
https://kawalpemilu.org#53012,"CIBODASARI, CIBODAS, KOTA TANGERANG, BANTEN",4,171,95,266
https://kawalpemilu.org#53012,"CIBODASARI, CIBODAS, KOTA TANGERANG, BANTEN",5,102,168,270
https://kawalpemilu.org#53012,"CIBODASARI, CIBODAS, KOTA TANGERANG, BANTEN",6,67,129,196
https://kawalpemilu.org#53012,"CIBODASARI, CIBODAS, KOTA TANGERANG, BANTEN",7,84,141,225
https://kawalpemilu.org#53012,"CIBODASARI, CIBODAS, KOTA TANGERANG, BANTEN",8,124,152,276
https://kawalpemilu.org#53012,"CIBODASARI, CIBODAS, KOTA TANGERANG, BANTEN",9,113,137,250
https://kawalpemilu.org#53012,"CIBODASARI, CIBODAS, KOTA TANGERANG, BANTEN",10,87,138,225
https://kawalpemilu.org#53012,"CIBODASARI, CIBODAS, KOTA TANGERANG, BANTEN",11,85,149,234
https://kawalpemilu.org#53012,"CIBODASARI, CIBODAS, KOTA TANGERANG, BANTEN",12,104,143,247
https://kawalpemilu.org#53012,"CIBODASARI, CIBODAS, KOTA TANGERANG, BANTEN",13,68,117,185
https://kawalpemilu.org#53012,"CIBODASARI, CIBODAS, KOTA TANGERANG, BANTEN",14,75,138,213
https://kawalpemilu.org#53012,"CIBODASARI, CIBODAS, KOTA TANGERANG, BANTEN",15,69,136,205
https://kawalpemilu.org#53012,"CIBODASARI, CIBODAS, KOTA TANGERANG, BANTEN",16,115,163,278
https://kawalpemilu.org#53012,"CIBODASARI, CIBODAS, KOTA TANGERANG, BANTEN",17,111,153,268
https://kawalpemilu.org#53012,"CIBODASARI, CIBODAS, KOTA TANGERANG, BANTEN",18,132,160,292
https://kawalpemilu.org#53012,"CIBODASARI, CIBODAS, KOTA TANGERANG, BANTEN",19,137,118,255
https://kawalpemilu.org#53012,"CIBODASARI, CIBODAS, KOTA TANGERANG, BANTEN",20,77,159,236
https://kawalpemilu.org#53012,"CIBODASARI, CIBODAS, KOTA TANGERANG, BANTEN",21,130,138,268
https://kawalpemilu.org#53012,"CIBODASARI, CIBODAS, KOTA TANGERANG, BANTEN",22,73,155,228
https://kawalpemilu.org#53012,"CIBODASARI, CIBODAS, KOTA TANGERANG, BANTEN",23,117,158,275
https://kawalpemilu.org#53012,"CIBODASARI, CIBODAS, KOTA TANGERANG, BANTEN",24,109,250,259
https://kawalpemilu.org#53012,"CIBODASARI, CIBODAS, KOTA TANGERANG, BANTEN",25,139,128,267
https://kawalpemilu.org#53012,"CIBODASARI, CIBODAS, KOTA TANGERANG, BANTEN",27,109,142,251
https://kawalpemilu.org#53012,"CIBODASARI, CIBODAS, KOTA TANGERANG, BANTEN",29,77,149,226
https://kawalpemilu.org#53012,"CIBODASARI, CIBODAS, KOTA TANGERANG, BANTEN",30,89,105,194
https://kawalpemilu.org#53012,"CIBODASARI, CIBODAS, KOTA TANGERANG, BANTEN",31,65,168,233
https://kawalpemilu.org#53012,"CIBODASARI, CIBODAS, KOTA TANGERANG, BANTEN",32,112,108,220
https://kawalpemilu.org#53012,"CIBODASARI, CIBODAS, KOTA TANGERANG, BANTEN",33,66,89,155
https://kawalpemilu.org#53012,"CIBODASARI, CIBODAS, KOTA TANGERANG, BANTEN",34,85,162,247
https://kawalpemilu.org#53012,"CIBODASARI, CIBODAS, KOTA TANGERANG, BANTEN",35,111,100,211
https://kawalpemilu.org#53012,"CIBODASARI, CIBODAS, KOTA TANGERANG, BANTEN",37,99,150,249
https://kawalpemilu.org#53012,"CIBODASARI, CIBODAS, KOTA TANGERANG, BANTEN",38,138,139,277
https://kawalpemilu.org#53012,"CIBODASARI, CIBODAS, KOTA TANGERANG, BANTEN",40,115,115,230
https://kawalpemilu.org#53012,"CIBODASARI, CIBODAS, KOTA TANGERANG, BANTEN",41,111,127,238
https://kawalpemilu.org#53012,"CIBODASARI, CIBODAS, KOTA TANGERANG, BANTEN",42,126,162,288
https://kawalpemilu.org#53012,"CIBODASARI, CIBODAS, KOTA TANGERANG, BANTEN",43,135,126,261
https://kawalpemilu.org#53012,"CIBODASARI, CIBODAS, KOTA TANGERANG, BANTEN",44,139,132,271
https://kawalpemilu.org#53012,"CIBODASARI, CIBODAS, KOTA TANGERANG, BANTEN",45,115,149,264
https://kawalpemilu.org#53012,"CIBODASARI, CIBODAS, KOTA TANGERANG, BANTEN",46,89,144,233
https://kawalpemilu.org#53012,"CIBODASARI, CIBODAS, KOTA TANGERANG, BANTEN",47,91,159,250
https://kawalpemilu.org#53012,"CIBODASARI, CIBODAS, KOTA TANGERANG, BANTEN",48,115,125,240
https://kawalpemilu.org#53012,"CIBODASARI, CIBODAS, KOTA TANGERANG, BANTEN",49,119,142,261
https://kawalpemilu.org#53012,"CIBODASARI, CIBODAS, KOTA TANGERANG, BANTEN",50,107,155,262
https://kawalpemilu.org#53012,"CIBODASARI, CIBODAS, KOTA TANGERANG, BANTEN",51,104,158,262
https://kawalpemilu.org#53012,"CIBODASARI, CIBODAS, KOTA TANGERANG, BANTEN",52,144,105,249
https://kawalpemilu.org#53012,"CIBODASARI, CIBODAS, KOTA TANGERANG, BANTEN",53,103,126,229
https://kawalpemilu.org#53012,"CIBODASARI, CIBODAS, KOTA TANGERANG, BANTEN",54,118,126,244
https://kawalpemilu.org#53012,"CIBODASARI, CIBODAS, KOTA TANGERANG, BANTEN",55,122,154,276
https://kawalpemilu.org#53012,"CIBODASARI, CIBODAS, KOTA TANGERANG, BANTEN",56,79,152,231
https://kawalpemilu.org#53012,"CIBODASARI, CIBODAS, KOTA TANGERANG, BANTEN",57,132,96,228
https://kawalpemilu.org#53012,"CIBODASARI, CIBODAS, KOTA TANGERANG, BANTEN",58,105,126,231
https://kawalpemilu.org#53012,"CIBODASARI, CIBODAS, KOTA TANGERANG, BANTEN",59,98,131,229
https://kawalpemilu.org#53012,"CIBODASARI, CIBODAS, KOTA TANGERANG, BANTEN",60,76,122,198
https://kawalpemilu.org#53012,"CIBODASARI, CIBODAS, KOTA TANGERANG, BANTEN",61,83,108,191
https://kawalpemilu.org#53012,"CIBODASARI, CIBODAS, KOTA TANGERANG, BANTEN",62,99,100,199
https://kawalpemilu.org#53012,"CIBODASARI, CIBODAS, KOTA TANGERANG, BANTEN",63,115,74,189
https://kawalpemilu.org#53012,"CIBODASARI, CIBODAS, KOTA TANGERANG, BANTEN",64,86,121,207
https://kawalpemilu.org#53012,"CIBODASARI, CIBODAS, KOTA TANGERANG, BANTEN",65,70,99,169
https://kawalpemilu.org#53012,"CIBODASARI, CIBODAS, KOTA TANGERANG, BANTEN",66,102,131,233
https://kawalpemilu.org#53012,"CIBODASARI, CIBODAS, KOTA TANGERANG, BANTEN",67,74,124,198
https://kawalpemilu.org#53012,"CIBODASARI, CIBODAS, KOTA TANGERANG, BANTEN",69,87,152,239
https://kawalpemilu.org#53012,"CIBODASARI, CIBODAS, KOTA TANGERANG, BANTEN",70,88,159,247
https://kawalpemilu.org#53012,"CIBODASARI, CIBODAS, KOTA TANGERANG, BANTEN",71,69,120,189
https://kawalpemilu.org#53012,"CIBODASARI, CIBODAS, KOTA TANGERANG, BANTEN",73,118,138,256
https://kawalpemilu.org#53012,"CIBODASARI, CIBODAS, KOTA TANGERANG, BANTEN",74,86,150,236
https://kawalpemilu.org#53012,"CIBODASARI, CIBODAS, KOTA TANGERANG, BANTEN",75,92,150,242
https://kawalpemilu.org#53012,"CIBODASARI, CIBODAS, KOTA TANGERANG, BANTEN",76,105,127,232
https://kawalpemilu.org#53012,"CIBODASARI, CIBODAS, KOTA TANGERANG, BANTEN",77,101,116,217
https://kawalpemilu.org#53012,"CIBODASARI, CIBODAS, KOTA TANGERANG, BANTEN",78,65,166,231
https://kawalpemilu.org#53012,"CIBODASARI, CIBODAS, KOTA TANGERANG, BANTEN",79,77,167,244
https://kawalpemilu.org#53012,"CIBODASARI, CIBODAS, KOTA TANGERANG, BANTEN",80,72,106,178
https://kawalpemilu.org#53013,"CIBODAS BARU, CIBODAS, KOTA TANGERANG, BANTEN",1,78,80,158
https://kawalpemilu.org#53013,"CIBODAS BARU, CIBODAS, KOTA TANGERANG, BANTEN",2,90,66,156
https://kawalpemilu.org#53013,"CIBODAS BARU, CIBODAS, KOTA TANGERANG, BANTEN",3,115,164,279
https://kawalpemilu.org#53013,"CIBODAS BARU, CIBODAS, KOTA TANGERANG, BANTEN",4,154,123,277
https://kawalpemilu.org#53013,"CIBODAS BARU, CIBODAS, KOTA TANGERANG, BANTEN",5,91,132,223
https://kawalpemilu.org#53013,"CIBODAS BARU, CIBODAS, KOTA TANGERANG, BANTEN",6,80,94,174
https://kawalpemilu.org#53013,"CIBODAS BARU, CIBODAS, KOTA TANGERANG, BANTEN",7,88,143,231
https://kawalpemilu.org#53013,"CIBODAS BARU, CIBODAS, KOTA TANGERANG, BANTEN",8,83,175,258
https://kawalpemilu.org#53013,"CIBODAS BARU, CIBODAS, KOTA TANGERANG, BANTEN",9,99,165,264
https://kawalpemilu.org#53013,"CIBODAS BARU, CIBODAS, KOTA TANGERANG, BANTEN",10,127,111,238
https://kawalpemilu.org#53013,"CIBODAS BARU, CIBODAS, KOTA TANGERANG, BANTEN",11,141,104,245
https://kawalpemilu.org#53013,"CIBODAS BARU, CIBODAS, KOTA TANGERANG, BANTEN",12,111,168,269
https://kawalpemilu.org#53013,"CIBODAS BARU, CIBODAS, KOTA TANGERANG, BANTEN",13,113,121,234
https://kawalpemilu.org#53013,"CIBODAS BARU, CIBODAS, KOTA TANGERANG, BANTEN",14,129,125,254
https://kawalpemilu.org#53013,"CIBODAS BARU, CIBODAS, KOTA TANGERANG, BANTEN",15,153,132,285
https://kawalpemilu.org#53013,"CIBODAS BARU, CIBODAS, KOTA TANGERANG, BANTEN",16,117,130,247
https://kawalpemilu.org#53013,"CIBODAS BARU, CIBODAS, KOTA TANGERANG, BANTEN",17,152,138,290
https://kawalpemilu.org#53013,"CIBODAS BARU, CIBODAS, KOTA TANGERANG, BANTEN",18,110,149,259
https://kawalpemilu.org#53013,"CIBODAS BARU, CIBODAS, KOTA TANGERANG, BANTEN",19,82,122,204
https://kawalpemilu.org#53013,"CIBODAS BARU, CIBODAS, KOTA TANGERANG, BANTEN",20,103,103,244
https://kawalpemilu.org#53013,"CIBODAS BARU, CIBODAS, KOTA TANGERANG, BANTEN",21,112,76,188
https://kawalpemilu.org#53013,"CIBODAS BARU, CIBODAS, KOTA TANGERANG, BANTEN",22,63,82,145
https://kawalpemilu.org#53013,"CIBODAS BARU, CIBODAS, KOTA TANGERANG, BANTEN",23,79,120,199
https://kawalpemilu.org#53013,"CIBODAS BARU, CIBODAS, KOTA TANGERANG, BANTEN",27,74,140,214
https://kawalpemilu.org#53013,"CIBODAS BARU, CIBODAS, KOTA TANGERANG, BANTEN",28,145,124,269
https://kawalpemilu.org#53013,"CIBODAS BARU, CIBODAS, KOTA TANGERANG, BANTEN",29,102,130,232
https://kawalpemilu.org#53013,"CIBODAS BARU, CIBODAS, KOTA TANGERANG, BANTEN",30,107,136,243
https://kawalpemilu.org#53013,"CIBODAS BARU, CIBODAS, KOTA TANGERANG, BANTEN",31,114,133,247
https://kawalpemilu.org#53013,"CIBODAS BARU, CIBODAS, KOTA TANGERANG, BANTEN",32,112,149,261
https://kawalpemilu.org#53013,"CIBODAS BARU, CIBODAS, KOTA TANGERANG, BANTEN",33,86,119,205
https://kawalpemilu.org#53013,"CIBODAS BARU, CIBODAS, KOTA TANGERANG, BANTEN",34,98,155,253
https://kawalpemilu.org#53013,"CIBODAS BARU, CIBODAS, KOTA TANGERANG, BANTEN",35,132,129,261
https://kawalpemilu.org#53013,"CIBODAS BARU, CIBODAS, KOTA TANGERANG, BANTEN",36,123,134,257
https://kawalpemilu.org#53013,"CIBODAS BARU, CIBODAS, KOTA TANGERANG, BANTEN",37,100,139,239
https://kawalpemilu.org#53013,"CIBODAS BARU, CIBODAS, KOTA TANGERANG, BANTEN",38,96,151,247
https://kawalpemilu.org#53013,"CIBODAS BARU, CIBODAS, KOTA TANGERANG, BANTEN",39,108,176,284
https://kawalpemilu.org#53013,"CIBODAS BARU, CIBODAS, KOTA TANGERANG, BANTEN",40,83,200,283
https://kawalpemilu.org#53013,"CIBODAS BARU, CIBODAS, KOTA TANGERANG, BANTEN",41,109,166,275
https://kawalpemilu.org#53013,"CIBODAS BARU, CIBODAS, KOTA TANGERANG, BANTEN",42,97,161,258
https://kawalpemilu.org#53013,"CIBODAS BARU, CIBODAS, KOTA TANGERANG, BANTEN",43,141,89,230
https://kawalpemilu.org#53013,"CIBODAS BARU, CIBODAS, KOTA TANGERANG, BANTEN",44,104,163,267
https://kawalpemilu.org#53013,"CIBODAS BARU, CIBODAS, KOTA TANGERANG, BANTEN",45,111,140,251
https://kawalpemilu.org#53013,"CIBODAS BARU, CIBODAS, KOTA TANGERANG, BANTEN",46,95,112,207
https://kawalpemilu.org#53013,"CIBODAS BARU, CIBODAS, KOTA TANGERANG, BANTEN",47,88,95,183
https://kawalpemilu.org#53013,"CIBODAS BARU, CIBODAS, KOTA TANGERANG, BANTEN",48,95,84,179
https://kawalpemilu.org#53014,"PANUNGGANGAN BARAT, CIBODAS, KOTA TANGERANG, BANTEN",1,56,207,263
https://kawalpemilu.org#53014,"PANUNGGANGAN BARAT, CIBODAS, KOTA TANGERANG, BANTEN",2,89,198,287
https://kawalpemilu.org#53014,"PANUNGGANGAN BARAT, CIBODAS, KOTA TANGERANG, BANTEN",3,127,59,186
https://kawalpemilu.org#53014,"PANUNGGANGAN BARAT, CIBODAS, KOTA TANGERANG, BANTEN",4,43,206,249
https://kawalpemilu.org#53014,"PANUNGGANGAN BARAT, CIBODAS, KOTA TANGERANG, BANTEN",5,81,189,270
https://kawalpemilu.org#53014,"PANUNGGANGAN BARAT, CIBODAS, KOTA TANGERANG, BANTEN",6,63,190,253
https://kawalpemilu.org#53014,"PANUNGGANGAN BARAT, CIBODAS, KOTA TANGERANG, BANTEN",7,92,173,265
https://kawalpemilu.org#53014,"PANUNGGANGAN BARAT, CIBODAS, KOTA TANGERANG, BANTEN",8,44,170,214
https://kawalpemilu.org#53014,"PANUNGGANGAN BARAT, CIBODAS, KOTA TANGERANG, BANTEN",9,70,107,177
https://kawalpemilu.org#53014,"PANUNGGANGAN BARAT, CIBODAS, KOTA TANGERANG, BANTEN",10,50,113,163
https://kawalpemilu.org#53014,"PANUNGGANGAN BARAT, CIBODAS, KOTA TANGERANG, BANTEN",11,67,116,183
https://kawalpemilu.org#53014,"PANUNGGANGAN BARAT, CIBODAS, KOTA TANGERANG, BANTEN",12,78,177,255
https://kawalpemilu.org#53014,"PANUNGGANGAN BARAT, CIBODAS, KOTA TANGERANG, BANTEN",13,67,178,245
https://kawalpemilu.org#53014,"PANUNGGANGAN BARAT, CIBODAS, KOTA TANGERANG, BANTEN",14,44,141,185
https://kawalpemilu.org#53014,"PANUNGGANGAN BARAT, CIBODAS, KOTA TANGERANG, BANTEN",15,48,162,210
https://kawalpemilu.org#53014,"PANUNGGANGAN BARAT, CIBODAS, KOTA TANGERANG, BANTEN",17,54,157,211
https://kawalpemilu.org#53014,"PANUNGGANGAN BARAT, CIBODAS, KOTA TANGERANG, BANTEN",18,70,182,252
https://kawalpemilu.org#53014,"PANUNGGANGAN BARAT, CIBODAS, KOTA TANGERANG, BANTEN",19,68,146,214
https://kawalpemilu.org#53014,"PANUNGGANGAN BARAT, CIBODAS, KOTA TANGERANG, BANTEN",20,83,205,87
https://kawalpemilu.org#53014,"PANUNGGANGAN BARAT, CIBODAS, KOTA TANGERANG, BANTEN",21,66,216,282
https://kawalpemilu.org#53014,"PANUNGGANGAN BARAT, CIBODAS, KOTA TANGERANG, BANTEN",22,75,160,235
https://kawalpemilu.org#53014,"PANUNGGANGAN BARAT, CIBODAS, KOTA TANGERANG, BANTEN",23,56,108,164
https://kawalpemilu.org#53014,"PANUNGGANGAN BARAT, CIBODAS, KOTA TANGERANG, BANTEN",24,60,134,194
https://kawalpemilu.org#53014,"PANUNGGANGAN BARAT, CIBODAS, KOTA TANGERANG, BANTEN",25,45,135,180
https://kawalpemilu.org#53014,"PANUNGGANGAN BARAT, CIBODAS, KOTA TANGERANG, BANTEN",26,108,129,237
https://kawalpemilu.org#53014,"PANUNGGANGAN BARAT, CIBODAS, KOTA TANGERANG, BANTEN",27,78,177,255
https://kawalpemilu.org#53014,"PANUNGGANGAN BARAT, CIBODAS, KOTA TANGERANG, BANTEN",29,63,14,77
https://kawalpemilu.org#53014,"PANUNGGANGAN BARAT, CIBODAS, KOTA TANGERANG, BANTEN",30,146,53,199
https://kawalpemilu.org#53014,"PANUNGGANGAN BARAT, CIBODAS, KOTA TANGERANG, BANTEN",31,96,94,190
https://kawalpemilu.org#53014,"PANUNGGANGAN BARAT, CIBODAS, KOTA TANGERANG, BANTEN",32,105,113,218
https://kawalpemilu.org#53014,"PANUNGGANGAN BARAT, CIBODAS, KOTA TANGERANG, BANTEN",33,98,101,6
https://kawalpemilu.org#53014,"PANUNGGANGAN BARAT, CIBODAS, KOTA TANGERANG, BANTEN",34,103,98,201
https://kawalpemilu.org#53014,"PANUNGGANGAN BARAT, CIBODAS, KOTA TANGERANG, BANTEN",35,143,122,265
https://kawalpemilu.org#53014,"PANUNGGANGAN BARAT, CIBODAS, KOTA TANGERANG, BANTEN",36,94,162,256
https://kawalpemilu.org#53014,"PANUNGGANGAN BARAT, CIBODAS, KOTA TANGERANG, BANTEN",37,113,106,219
https://kawalpemilu.org#53014,"PANUNGGANGAN BARAT, CIBODAS, KOTA TANGERANG, BANTEN",38,149,71,220
https://kawalpemilu.org#53014,"PANUNGGANGAN BARAT, CIBODAS, KOTA TANGERANG, BANTEN",39,123,125,248
https://kawalpemilu.org#53014,"PANUNGGANGAN BARAT, CIBODAS, KOTA TANGERANG, BANTEN",40,96,121,217
https://kawalpemilu.org#53014,"PANUNGGANGAN BARAT, CIBODAS, KOTA TANGERANG, BANTEN",41,62,124,186
https://kawalpemilu.org#53014,"PANUNGGANGAN BARAT, CIBODAS, KOTA TANGERANG, BANTEN",42,96,160,256
https://kawalpemilu.org#53014,"PANUNGGANGAN BARAT, CIBODAS, KOTA TANGERANG, BANTEN",44,248,24,272
https://kawalpemilu.org#53014,"PANUNGGANGAN BARAT, CIBODAS, KOTA TANGERANG, BANTEN",45,256,16,272
https://kawalpemilu.org#53014,"PANUNGGANGAN BARAT, CIBODAS, KOTA TANGERANG, BANTEN",46,228,16,244
https://kawalpemilu.org#53014,"PANUNGGANGAN BARAT, CIBODAS, KOTA TANGERANG, BANTEN",47,142,14,156
https://kawalpemilu.org#53014,"PANUNGGANGAN BARAT, CIBODAS, KOTA TANGERANG, BANTEN",48,213,15,228
https://kawalpemilu.org#53014,"PANUNGGANGAN BARAT, CIBODAS, KOTA TANGERANG, BANTEN",49,213,6,219
https://kawalpemilu.org#53014,"PANUNGGANGAN BARAT, CIBODAS, KOTA TANGERANG, BANTEN",50,104,1,105
https://kawalpemilu.org#53015,"UWUNG JAYA, CIBODAS, KOTA TANGERANG, BANTEN",1,112,153,265
https://kawalpemilu.org#53015,"UWUNG JAYA, CIBODAS, KOTA TANGERANG, BANTEN",2,85,148,233
https://kawalpemilu.org#53015,"UWUNG JAYA, CIBODAS, KOTA TANGERANG, BANTEN",3,78,139,217
https://kawalpemilu.org#53015,"UWUNG JAYA, CIBODAS, KOTA TANGERANG, BANTEN",4,59,94,153
https://kawalpemilu.org#53015,"UWUNG JAYA, CIBODAS, KOTA TANGERANG, BANTEN",5,66,136,202
https://kawalpemilu.org#53015,"UWUNG JAYA, CIBODAS, KOTA TANGERANG, BANTEN",7,123,173,296
https://kawalpemilu.org#53015,"UWUNG JAYA, CIBODAS, KOTA TANGERANG, BANTEN",8,69,83,152
https://kawalpemilu.org#53015,"UWUNG JAYA, CIBODAS, KOTA TANGERANG, BANTEN",9,103,105,208
https://kawalpemilu.org#53015,"UWUNG JAYA, CIBODAS, KOTA TANGERANG, BANTEN",10,75,69,144
https://kawalpemilu.org#53015,"UWUNG JAYA, CIBODAS, KOTA TANGERANG, BANTEN",11,87,117,204
https://kawalpemilu.org#53015,"UWUNG JAYA, CIBODAS, KOTA TANGERANG, BANTEN",12,91,128,219
https://kawalpemilu.org#53015,"UWUNG JAYA, CIBODAS, KOTA TANGERANG, BANTEN",13,80,176,256
https://kawalpemilu.org#53015,"UWUNG JAYA, CIBODAS, KOTA TANGERANG, BANTEN",14,91,130,221
https://kawalpemilu.org#53015,"UWUNG JAYA, CIBODAS, KOTA TANGERANG, BANTEN",15,74,118,192
https://kawalpemilu.org#53015,"UWUNG JAYA, CIBODAS, KOTA TANGERANG, BANTEN",16,77,95,172
https://kawalpemilu.org#53015,"UWUNG JAYA, CIBODAS, KOTA TANGERANG, BANTEN",17,105,91,196
https://kawalpemilu.org#53015,"UWUNG JAYA, CIBODAS, KOTA TANGERANG, BANTEN",18,244,34,278
https://kawalpemilu.org#53015,"UWUNG JAYA, CIBODAS, KOTA TANGERANG, BANTEN",19,160,40,200
https://kawalpemilu.org#53015,"UWUNG JAYA, CIBODAS, KOTA TANGERANG, BANTEN",20,196,41,237
https://kawalpemilu.org#53015,"UWUNG JAYA, CIBODAS, KOTA TANGERANG, BANTEN",21,143,79,222
https://kawalpemilu.org#53015,"UWUNG JAYA, CIBODAS, KOTA TANGERANG, BANTEN",22,110,62,172
https://kawalpemilu.org#53015,"UWUNG JAYA, CIBODAS, KOTA TANGERANG, BANTEN",23,97,10,107
https://kawalpemilu.org#53015,"UWUNG JAYA, CIBODAS, KOTA TANGERANG, BANTEN",24,163,35,198
https://kawalpemilu.org#53015,"UWUNG JAYA, CIBODAS, KOTA TANGERANG, BANTEN",25,152,23,175
https://kawalpemilu.org#53015,"UWUNG JAYA, CIBODAS, KOTA TANGERANG, BANTEN",26,162,56,218
https://kawalpemilu.org#53015,"UWUNG JAYA, CIBODAS, KOTA TANGERANG, BANTEN",27,116,49,165
https://kawalpemilu.org#53015,"UWUNG JAYA, CIBODAS, KOTA TANGERANG, BANTEN",28,149,31,180
https://kawalpemilu.org#53015,"UWUNG JAYA, CIBODAS, KOTA TANGERANG, BANTEN",29,135,53,188
https://kawalpemilu.org#53015,"UWUNG JAYA, CIBODAS, KOTA TANGERANG, BANTEN",30,169,19,188
https://kawalpemilu.org#53015,"UWUNG JAYA, CIBODAS, KOTA TANGERANG, BANTEN",31,205,48,253
https://kawalpemilu.org#53015,"UWUNG JAYA, CIBODAS, KOTA TANGERANG, BANTEN",32,93,61,154
https://kawalpemilu.org#53015,"UWUNG JAYA, CIBODAS, KOTA TANGERANG, BANTEN",35,135,60,195
https://kawalpemilu.org#53015,"UWUNG JAYA, CIBODAS, KOTA TANGERANG, BANTEN",41,109,139,248
https://kawalpemilu.org#53015,"UWUNG JAYA, CIBODAS, KOTA TANGERANG, BANTEN",43,45,124,169
https://kawalpemilu.org#53015,"UWUNG JAYA, CIBODAS, KOTA TANGERANG, BANTEN",44,54,222,276
https://kawalpemilu.org#53015,"UWUNG JAYA, CIBODAS, KOTA TANGERANG, BANTEN",45,73,137,210
https://kawalpemilu.org#53015,"UWUNG JAYA, CIBODAS, KOTA TANGERANG, BANTEN",46,92,131,223
https://kawalpemilu.org#53015,"UWUNG JAYA, CIBODAS, KOTA TANGERANG, BANTEN",47,74,109,183
https://kawalpemilu.org#53015,"UWUNG JAYA, CIBODAS, KOTA TANGERANG, BANTEN",48,59,135,194
https://kawalpemilu.org#53015,"UWUNG JAYA, CIBODAS, KOTA TANGERANG, BANTEN",49,87,167,254
https://kawalpemilu.org#53015,"UWUNG JAYA, CIBODAS, KOTA TANGERANG, BANTEN",50,37,91,128
https://kawalpemilu.org#53015,"UWUNG JAYA, CIBODAS, KOTA TANGERANG, BANTEN",51,102,143,245
https://kawalpemilu.org#53015,"UWUNG JAYA, CIBODAS, KOTA TANGERANG, BANTEN",52,137,109,246
https://kawalpemilu.org#53015,"UWUNG JAYA, CIBODAS, KOTA TANGERANG, BANTEN",53,112,37,149
https://kawalpemilu.org#53015,"UWUNG JAYA, CIBODAS, KOTA TANGERANG, BANTEN",54,185,75,260
https://kawalpemilu.org#53015,"UWUNG JAYA, CIBODAS, KOTA TANGERANG, BANTEN",55,112,113,225
https://kawalpemilu.org#53015,"UWUNG JAYA, CIBODAS, KOTA TANGERANG, BANTEN",56,131,82,213
https://kawalpemilu.org#53015,"UWUNG JAYA, CIBODAS, KOTA TANGERANG, BANTEN",57,135,103,238
https://kawalpemilu.org#53015,"UWUNG JAYA, CIBODAS, KOTA TANGERANG, BANTEN",59,140,109,249
https://kawalpemilu.org#53015,"UWUNG JAYA, CIBODAS, KOTA TANGERANG, BANTEN",60,144,94,238
https://kawalpemilu.org#53015,"UWUNG JAYA, CIBODAS, KOTA TANGERANG, BANTEN",63,110,85,195
https://kawalpemilu.org#53015,"UWUNG JAYA, CIBODAS, KOTA TANGERANG, BANTEN",64,106,122,228
https://kawalpemilu.org#53015,"UWUNG JAYA, CIBODAS, KOTA TANGERANG, BANTEN",65,112,108,220
https://kawalpemilu.org#53015,"UWUNG JAYA, CIBODAS, KOTA TANGERANG, BANTEN",66,76,111,187
https://kawalpemilu.org#53015,"UWUNG JAYA, CIBODAS, KOTA TANGERANG, BANTEN",67,94,93,187
https://kawalpemilu.org#53015,"UWUNG JAYA, CIBODAS, KOTA TANGERANG, BANTEN",68,82,115,197
https://kawalpemilu.org#53015,"UWUNG JAYA, CIBODAS, KOTA TANGERANG, BANTEN",69,69,123,192
https://kawalpemilu.org#53015,"UWUNG JAYA, CIBODAS, KOTA TANGERANG, BANTEN",70,62,154,216
https://kawalpemilu.org#53015,"UWUNG JAYA, CIBODAS, KOTA TANGERANG, BANTEN",71,126,101,227
https://kawalpemilu.org#53015,"UWUNG JAYA, CIBODAS, KOTA TANGERANG, BANTEN",73,100,47,147
https://kawalpemilu.org#53015,"UWUNG JAYA, CIBODAS, KOTA TANGERANG, BANTEN",74,124,173,297
https://kawalpemilu.org#53015,"UWUNG JAYA, CIBODAS, KOTA TANGERANG, BANTEN",75,129,120,249
https://kawalpemilu.org#53016,"JATIUWUNG, CIBODAS, KOTA TANGERANG, BANTEN",1,105,120,225
https://kawalpemilu.org#53016,"JATIUWUNG, CIBODAS, KOTA TANGERANG, BANTEN",2,90,116,206
https://kawalpemilu.org#53016,"JATIUWUNG, CIBODAS, KOTA TANGERANG, BANTEN",3,91,127,218
https://kawalpemilu.org#53016,"JATIUWUNG, CIBODAS, KOTA TANGERANG, BANTEN",4,104,94,198
https://kawalpemilu.org#53016,"JATIUWUNG, CIBODAS, KOTA TANGERANG, BANTEN",5,120,106,226
https://kawalpemilu.org#53016,"JATIUWUNG, CIBODAS, KOTA TANGERANG, BANTEN",6,70,198,268
https://kawalpemilu.org#53016,"JATIUWUNG, CIBODAS, KOTA TANGERANG, BANTEN",7,60,173,233
https://kawalpemilu.org#53016,"JATIUWUNG, CIBODAS, KOTA TANGERANG, BANTEN",9,120,109,229
https://kawalpemilu.org#53016,"JATIUWUNG, CIBODAS, KOTA TANGERANG, BANTEN",10,90,87,177
https://kawalpemilu.org#53016,"JATIUWUNG, CIBODAS, KOTA TANGERANG, BANTEN",11,117,145,262
https://kawalpemilu.org#53016,"JATIUWUNG, CIBODAS, KOTA TANGERANG, BANTEN",12,108,128,236
https://kawalpemilu.org#53016,"JATIUWUNG, CIBODAS, KOTA TANGERANG, BANTEN",13,55,172,227
https://kawalpemilu.org#53016,"JATIUWUNG, CIBODAS, KOTA TANGERANG, BANTEN",14,46,229,275
https://kawalpemilu.org#53016,"JATIUWUNG, CIBODAS, KOTA TANGERANG, BANTEN",15,81,188,269
https://kawalpemilu.org#53016,"JATIUWUNG, CIBODAS, KOTA TANGERANG, BANTEN",16,96,191,287
https://kawalpemilu.org#53016,"JATIUWUNG, CIBODAS, KOTA TANGERANG, BANTEN",17,76,121,197
https://kawalpemilu.org#53016,"JATIUWUNG, CIBODAS, KOTA TANGERANG, BANTEN",18,71,77,148
https://kawalpemilu.org#53016,"JATIUWUNG, CIBODAS, KOTA TANGERANG, BANTEN",19,70,113,183
https://kawalpemilu.org#53016,"JATIUWUNG, CIBODAS, KOTA TANGERANG, BANTEN",20,93,183,276
https://kawalpemilu.org#53016,"JATIUWUNG, CIBODAS, KOTA TANGERANG, BANTEN",21,86,90,176
https://kawalpemilu.org#53016,"JATIUWUNG, CIBODAS, KOTA TANGERANG, BANTEN",22,55,118,173
https://kawalpemilu.org#53016,"JATIUWUNG, CIBODAS, KOTA TANGERANG, BANTEN",23,69,158,227
https://kawalpemilu.org#53016,"JATIUWUNG, CIBODAS, KOTA TANGERANG, BANTEN",24,87,129,216
https://kawalpemilu.org#53016,"JATIUWUNG, CIBODAS, KOTA TANGERANG, BANTEN",25,59,134,193
https://kawalpemilu.org#53016,"JATIUWUNG, CIBODAS, KOTA TANGERANG, BANTEN",26,46,146,192
https://kawalpemilu.org#53016,"JATIUWUNG, CIBODAS, KOTA TANGERANG, BANTEN",27,62,166,228
https://kawalpemilu.org#53016,"JATIUWUNG, CIBODAS, KOTA TANGERANG, BANTEN",28,19,78,97
https://kawalpemilu.org#53016,"JATIUWUNG, CIBODAS, KOTA TANGERANG, BANTEN",29,63,190,253
https://kawalpemilu.org#53016,"JATIUWUNG, CIBODAS, KOTA TANGERANG, BANTEN",30,38,200,238
https://kawalpemilu.org#53016,"JATIUWUNG, CIBODAS, KOTA TANGERANG, BANTEN",31,102,144,246
https://kawalpemilu.org#53016,"JATIUWUNG, CIBODAS, KOTA TANGERANG, BANTEN",32,103,176,279
https://kawalpemilu.org#53016,"JATIUWUNG, CIBODAS, KOTA TANGERANG, BANTEN",33,38,158,196
https://kawalpemilu.org#53016,"JATIUWUNG, CIBODAS, KOTA TANGERANG, BANTEN",34,49,142,191
https://kawalpemilu.org#53018,"NEGLASARI, NEGLASARI, KOTA TANGERANG, BANTEN",1,73,71,144
https://kawalpemilu.org#53018,"NEGLASARI, NEGLASARI, KOTA TANGERANG, BANTEN",2,57,116,173
https://kawalpemilu.org#53018,"NEGLASARI, NEGLASARI, KOTA TANGERANG, BANTEN",3,106,162,268
https://kawalpemilu.org#53018,"NEGLASARI, NEGLASARI, KOTA TANGERANG, BANTEN",4,128,101,229
https://kawalpemilu.org#53018,"NEGLASARI, NEGLASARI, KOTA TANGERANG, BANTEN",6,44,114,158
https://kawalpemilu.org#53018,"NEGLASARI, NEGLASARI, KOTA TANGERANG, BANTEN",7,55,90,145
https://kawalpemilu.org#53018,"NEGLASARI, NEGLASARI, KOTA TANGERANG, BANTEN",8,57,115,172
https://kawalpemilu.org#53018,"NEGLASARI, NEGLASARI, KOTA TANGERANG, BANTEN",10,54,152,206
https://kawalpemilu.org#53018,"NEGLASARI, NEGLASARI, KOTA TANGERANG, BANTEN",11,111,140,251
https://kawalpemilu.org#53018,"NEGLASARI, NEGLASARI, KOTA TANGERANG, BANTEN",12,101,97,198
https://kawalpemilu.org#53018,"NEGLASARI, NEGLASARI, KOTA TANGERANG, BANTEN",13,74,70,144
https://kawalpemilu.org#53018,"NEGLASARI, NEGLASARI, KOTA TANGERANG, BANTEN",14,47,106,153
https://kawalpemilu.org#53018,"NEGLASARI, NEGLASARI, KOTA TANGERANG, BANTEN",15,87,132,219
https://kawalpemilu.org#53018,"NEGLASARI, NEGLASARI, KOTA TANGERANG, BANTEN",16,118,84,202
https://kawalpemilu.org#53018,"NEGLASARI, NEGLASARI, KOTA TANGERANG, BANTEN",18,107,85,192
https://kawalpemilu.org#53018,"NEGLASARI, NEGLASARI, KOTA TANGERANG, BANTEN",19,100,94,194
https://kawalpemilu.org#53018,"NEGLASARI, NEGLASARI, KOTA TANGERANG, BANTEN",20,73,94,167
https://kawalpemilu.org#53018,"NEGLASARI, NEGLASARI, KOTA TANGERANG, BANTEN",21,62,111,173
https://kawalpemilu.org#53018,"NEGLASARI, NEGLASARI, KOTA TANGERANG, BANTEN",22,99,67,166
https://kawalpemilu.org#53018,"NEGLASARI, NEGLASARI, KOTA TANGERANG, BANTEN",23,65,84,149
https://kawalpemilu.org#53018,"NEGLASARI, NEGLASARI, KOTA TANGERANG, BANTEN",24,124,114,238
https://kawalpemilu.org#53018,"NEGLASARI, NEGLASARI, KOTA TANGERANG, BANTEN",25,122,81,203
https://kawalpemilu.org#53018,"NEGLASARI, NEGLASARI, KOTA TANGERANG, BANTEN",26,125,98,223
https://kawalpemilu.org#53018,"NEGLASARI, NEGLASARI, KOTA TANGERANG, BANTEN",27,125,81,206
https://kawalpemilu.org#53018,"NEGLASARI, NEGLASARI, KOTA TANGERANG, BANTEN",28,137,94,231
https://kawalpemilu.org#53018,"NEGLASARI, NEGLASARI, KOTA TANGERANG, BANTEN",29,161,75,236
https://kawalpemilu.org#53018,"NEGLASARI, NEGLASARI, KOTA TANGERANG, BANTEN",30,112,115,227
https://kawalpemilu.org#53018,"NEGLASARI, NEGLASARI, KOTA TANGERANG, BANTEN",31,111,125,236
https://kawalpemilu.org#53018,"NEGLASARI, NEGLASARI, KOTA TANGERANG, BANTEN",32,100,87,187
https://kawalpemilu.org#53018,"NEGLASARI, NEGLASARI, KOTA TANGERANG, BANTEN",33,131,133,264
https://kawalpemilu.org#53018,"NEGLASARI, NEGLASARI, KOTA TANGERANG, BANTEN",34,145,91,236
https://kawalpemilu.org#53018,"NEGLASARI, NEGLASARI, KOTA TANGERANG, BANTEN",35,175,34,209
https://kawalpemilu.org#53018,"NEGLASARI, NEGLASARI, KOTA TANGERANG, BANTEN",36,189,10,199
https://kawalpemilu.org#53018,"NEGLASARI, NEGLASARI, KOTA TANGERANG, BANTEN",37,182,24,206
https://kawalpemilu.org#53018,"NEGLASARI, NEGLASARI, KOTA TANGERANG, BANTEN",38,138,2,140
https://kawalpemilu.org#53018,"NEGLASARI, NEGLASARI, KOTA TANGERANG, BANTEN",39,132,3,135
https://kawalpemilu.org#53018,"NEGLASARI, NEGLASARI, KOTA TANGERANG, BANTEN",40,126,1,127
https://kawalpemilu.org#53018,"NEGLASARI, NEGLASARI, KOTA TANGERANG, BANTEN",41,167,56,223
https://kawalpemilu.org#53018,"NEGLASARI, NEGLASARI, KOTA TANGERANG, BANTEN",42,179,23,202
https://kawalpemilu.org#53018,"NEGLASARI, NEGLASARI, KOTA TANGERANG, BANTEN",43,191,6,197
https://kawalpemilu.org#53018,"NEGLASARI, NEGLASARI, KOTA TANGERANG, BANTEN",44,211,15,226
https://kawalpemilu.org#53018,"NEGLASARI, NEGLASARI, KOTA TANGERANG, BANTEN",45,133,86,219
https://kawalpemilu.org#53018,"NEGLASARI, NEGLASARI, KOTA TANGERANG, BANTEN",46,204,7,211
https://kawalpemilu.org#53018,"NEGLASARI, NEGLASARI, KOTA TANGERANG, BANTEN",47,151,54,205
https://kawalpemilu.org#53018,"NEGLASARI, NEGLASARI, KOTA TANGERANG, BANTEN",48,139,69,208
https://kawalpemilu.org#53018,"NEGLASARI, NEGLASARI, KOTA TANGERANG, BANTEN",50,177,18,195
https://kawalpemilu.org#53018,"NEGLASARI, NEGLASARI, KOTA TANGERANG, BANTEN",51,122,99,221
https://kawalpemilu.org#53018,"NEGLASARI, NEGLASARI, KOTA TANGERANG, BANTEN",53,99,110,209
https://kawalpemilu.org#53018,"NEGLASARI, NEGLASARI, KOTA TANGERANG, BANTEN",54,71,133,204
https://kawalpemilu.org#53018,"NEGLASARI, NEGLASARI, KOTA TANGERANG, BANTEN",55,90,136,226
https://kawalpemilu.org#53018,"NEGLASARI, NEGLASARI, KOTA TANGERANG, BANTEN",56,143,79,222
https://kawalpemilu.org#53018,"NEGLASARI, NEGLASARI, KOTA TANGERANG, BANTEN",57,96,100,196
https://kawalpemilu.org#53019,"KARANG SARI, NEGLASARI, KOTA TANGERANG, BANTEN",1,100,97,197
https://kawalpemilu.org#53019,"KARANG SARI, NEGLASARI, KOTA TANGERANG, BANTEN",2,64,133,197
https://kawalpemilu.org#53019,"KARANG SARI, NEGLASARI, KOTA TANGERANG, BANTEN",3,111,68,179
https://kawalpemilu.org#53019,"KARANG SARI, NEGLASARI, KOTA TANGERANG, BANTEN",4,105,73,178
https://kawalpemilu.org#53019,"KARANG SARI, NEGLASARI, KOTA TANGERANG, BANTEN",5,62,116,178
https://kawalpemilu.org#53019,"KARANG SARI, NEGLASARI, KOTA TANGERANG, BANTEN",6,76,92,168
https://kawalpemilu.org#53019,"KARANG SARI, NEGLASARI, KOTA TANGERANG, BANTEN",7,183,5,188
https://kawalpemilu.org#53019,"KARANG SARI, NEGLASARI, KOTA TANGERANG, BANTEN",8,200,8,208
https://kawalpemilu.org#53019,"KARANG SARI, NEGLASARI, KOTA TANGERANG, BANTEN",9,165,40,205
https://kawalpemilu.org#53019,"KARANG SARI, NEGLASARI, KOTA TANGERANG, BANTEN",11,85,109,194
https://kawalpemilu.org#53019,"KARANG SARI, NEGLASARI, KOTA TANGERANG, BANTEN",12,81,104,185
https://kawalpemilu.org#53019,"KARANG SARI, NEGLASARI, KOTA TANGERANG, BANTEN",13,62,95,157
https://kawalpemilu.org#53019,"KARANG SARI, NEGLASARI, KOTA TANGERANG, BANTEN",14,60,155,215
https://kawalpemilu.org#53019,"KARANG SARI, NEGLASARI, KOTA TANGERANG, BANTEN",16,92,99,191
https://kawalpemilu.org#53019,"KARANG SARI, NEGLASARI, KOTA TANGERANG, BANTEN",17,74,105,179
https://kawalpemilu.org#53019,"KARANG SARI, NEGLASARI, KOTA TANGERANG, BANTEN",18,73,85,158
https://kawalpemilu.org#53019,"KARANG SARI, NEGLASARI, KOTA TANGERANG, BANTEN",21,83,110,193
https://kawalpemilu.org#53019,"KARANG SARI, NEGLASARI, KOTA TANGERANG, BANTEN",22,116,106,222
https://kawalpemilu.org#53019,"KARANG SARI, NEGLASARI, KOTA TANGERANG, BANTEN",23,76,123,199
https://kawalpemilu.org#53019,"KARANG SARI, NEGLASARI, KOTA TANGERANG, BANTEN",24,97,127,224
https://kawalpemilu.org#53019,"KARANG SARI, NEGLASARI, KOTA TANGERANG, BANTEN",26,91,151,242
https://kawalpemilu.org#53019,"KARANG SARI, NEGLASARI, KOTA TANGERANG, BANTEN",27,108,125,233
https://kawalpemilu.org#53019,"KARANG SARI, NEGLASARI, KOTA TANGERANG, BANTEN",28,128,112,240
https://kawalpemilu.org#53019,"KARANG SARI, NEGLASARI, KOTA TANGERANG, BANTEN",29,78,120,198
https://kawalpemilu.org#53019,"KARANG SARI, NEGLASARI, KOTA TANGERANG, BANTEN",30,38,142,180
https://kawalpemilu.org#53019,"KARANG SARI, NEGLASARI, KOTA TANGERANG, BANTEN",31,63,144,207
https://kawalpemilu.org#53019,"KARANG SARI, NEGLASARI, KOTA TANGERANG, BANTEN",32,57,142,199
https://kawalpemilu.org#53019,"KARANG SARI, NEGLASARI, KOTA TANGERANG, BANTEN",33,48,122,170
https://kawalpemilu.org#53019,"KARANG SARI, NEGLASARI, KOTA TANGERANG, BANTEN",34,81,133,214
https://kawalpemilu.org#53019,"KARANG SARI, NEGLASARI, KOTA TANGERANG, BANTEN",35,63,144,207
https://kawalpemilu.org#53019,"KARANG SARI, NEGLASARI, KOTA TANGERANG, BANTEN",36,61,152,213
https://kawalpemilu.org#53019,"KARANG SARI, NEGLASARI, KOTA TANGERANG, BANTEN",37,66,140,206
https://kawalpemilu.org#53019,"KARANG SARI, NEGLASARI, KOTA TANGERANG, BANTEN",38,61,136,197
https://kawalpemilu.org#53019,"KARANG SARI, NEGLASARI, KOTA TANGERANG, BANTEN",39,66,146,212
https://kawalpemilu.org#53019,"KARANG SARI, NEGLASARI, KOTA TANGERANG, BANTEN",41,58,92,150
https://kawalpemilu.org#53019,"KARANG SARI, NEGLASARI, KOTA TANGERANG, BANTEN",43,149,28,177
https://kawalpemilu.org#53019,"KARANG SARI, NEGLASARI, KOTA TANGERANG, BANTEN",44,69,123,192
https://kawalpemilu.org#53019,"KARANG SARI, NEGLASARI, KOTA TANGERANG, BANTEN",45,74,114,188
https://kawalpemilu.org#53019,"KARANG SARI, NEGLASARI, KOTA TANGERANG, BANTEN",46,96,86,182
https://kawalpemilu.org#53019,"KARANG SARI, NEGLASARI, KOTA TANGERANG, BANTEN",47,51,119,170
https://kawalpemilu.org#53019,"KARANG SARI, NEGLASARI, KOTA TANGERANG, BANTEN",48,49,107,156
https://kawalpemilu.org#53019,"KARANG SARI, NEGLASARI, KOTA TANGERANG, BANTEN",51,108,89,197
https://kawalpemilu.org#53019,"KARANG SARI, NEGLASARI, KOTA TANGERANG, BANTEN",53,51,110,161
https://kawalpemilu.org#53019,"KARANG SARI, NEGLASARI, KOTA TANGERANG, BANTEN",54,69,104,173
https://kawalpemilu.org#53019,"KARANG SARI, NEGLASARI, KOTA TANGERANG, BANTEN",55,80,102,182
https://kawalpemilu.org#53019,"KARANG SARI, NEGLASARI, KOTA TANGERANG, BANTEN",56,93,110,203
https://kawalpemilu.org#53019,"KARANG SARI, NEGLASARI, KOTA TANGERANG, BANTEN",57,86,101,187
https://kawalpemilu.org#53019,"KARANG SARI, NEGLASARI, KOTA TANGERANG, BANTEN",58,72,113,185
https://kawalpemilu.org#53019,"KARANG SARI, NEGLASARI, KOTA TANGERANG, BANTEN",59,72,122,194
https://kawalpemilu.org#53019,"KARANG SARI, NEGLASARI, KOTA TANGERANG, BANTEN",61,93,94,187
https://kawalpemilu.org#53019,"KARANG SARI, NEGLASARI, KOTA TANGERANG, BANTEN",62,104,62,166
https://kawalpemilu.org#53019,"KARANG SARI, NEGLASARI, KOTA TANGERANG, BANTEN",63,109,61,170
https://kawalpemilu.org#53019,"KARANG SARI, NEGLASARI, KOTA TANGERANG, BANTEN",64,102,72,174
https://kawalpemilu.org#53019,"KARANG SARI, NEGLASARI, KOTA TANGERANG, BANTEN",65,92,85,177
https://kawalpemilu.org#53019,"KARANG SARI, NEGLASARI, KOTA TANGERANG, BANTEN",66,117,63,180
https://kawalpemilu.org#53019,"KARANG SARI, NEGLASARI, KOTA TANGERANG, BANTEN",67,102,86,188
https://kawalpemilu.org#53019,"KARANG SARI, NEGLASARI, KOTA TANGERANG, BANTEN",68,98,100,198
https://kawalpemilu.org#53019,"KARANG SARI, NEGLASARI, KOTA TANGERANG, BANTEN",69,97,96,193
https://kawalpemilu.org#53019,"KARANG SARI, NEGLASARI, KOTA TANGERANG, BANTEN",70,112,79,191
https://kawalpemilu.org#53019,"KARANG SARI, NEGLASARI, KOTA TANGERANG, BANTEN",71,100,86,186
https://kawalpemilu.org#53019,"KARANG SARI, NEGLASARI, KOTA TANGERANG, BANTEN",72,100,86,186
https://kawalpemilu.org#53019,"KARANG SARI, NEGLASARI, KOTA TANGERANG, BANTEN",73,70,90,160
https://kawalpemilu.org#53019,"KARANG SARI, NEGLASARI, KOTA TANGERANG, BANTEN",74,109,75,184
https://kawalpemilu.org#53019,"KARANG SARI, NEGLASARI, KOTA TANGERANG, BANTEN",75,62,117,179
https://kawalpemilu.org#53019,"KARANG SARI, NEGLASARI, KOTA TANGERANG, BANTEN",76,54,112,166
https://kawalpemilu.org#53019,"KARANG SARI, NEGLASARI, KOTA TANGERANG, BANTEN",77,41,127,168
https://kawalpemilu.org#53019,"KARANG SARI, NEGLASARI, KOTA TANGERANG, BANTEN",78,110,91,201
https://kawalpemilu.org#53019,"KARANG SARI, NEGLASARI, KOTA TANGERANG, BANTEN",79,75,127,202
https://kawalpemilu.org#53020,"SELAPAJANG JAYA, NEGLASARI, KOTA TANGERANG, BANTEN",1,249,8,257
https://kawalpemilu.org#53020,"SELAPAJANG JAYA, NEGLASARI, KOTA TANGERANG, BANTEN",2,91,128,219
https://kawalpemilu.org#53020,"SELAPAJANG JAYA, NEGLASARI, KOTA TANGERANG, BANTEN",3,47,142,189
https://kawalpemilu.org#53020,"SELAPAJANG JAYA, NEGLASARI, KOTA TANGERANG, BANTEN",5,64,196,260
https://kawalpemilu.org#53020,"SELAPAJANG JAYA, NEGLASARI, KOTA TANGERANG, BANTEN",6,56,148,204
https://kawalpemilu.org#53020,"SELAPAJANG JAYA, NEGLASARI, KOTA TANGERANG, BANTEN",7,59,132,191
https://kawalpemilu.org#53020,"SELAPAJANG JAYA, NEGLASARI, KOTA TANGERANG, BANTEN",8,42,136,178
https://kawalpemilu.org#53020,"SELAPAJANG JAYA, NEGLASARI, KOTA TANGERANG, BANTEN",9,38,120,158
https://kawalpemilu.org#53020,"SELAPAJANG JAYA, NEGLASARI, KOTA TANGERANG, BANTEN",10,63,180,243
https://kawalpemilu.org#53020,"SELAPAJANG JAYA, NEGLASARI, KOTA TANGERANG, BANTEN",11,144,59,203
https://kawalpemilu.org#53020,"SELAPAJANG JAYA, NEGLASARI, KOTA TANGERANG, BANTEN",13,93,145,238
https://kawalpemilu.org#53020,"SELAPAJANG JAYA, NEGLASARI, KOTA TANGERANG, BANTEN",15,75,159,234
https://kawalpemilu.org#53020,"SELAPAJANG JAYA, NEGLASARI, KOTA TANGERANG, BANTEN",16,65,175,240
https://kawalpemilu.org#53020,"SELAPAJANG JAYA, NEGLASARI, KOTA TANGERANG, BANTEN",17,185,17,202
https://kawalpemilu.org#53020,"SELAPAJANG JAYA, NEGLASARI, KOTA TANGERANG, BANTEN",18,112,129,241
https://kawalpemilu.org#53020,"SELAPAJANG JAYA, NEGLASARI, KOTA TANGERANG, BANTEN",19,0,0,0
https://kawalpemilu.org#53020,"SELAPAJANG JAYA, NEGLASARI, KOTA TANGERANG, BANTEN",20,102,114,216
https://kawalpemilu.org#53020,"SELAPAJANG JAYA, NEGLASARI, KOTA TANGERANG, BANTEN",22,44,107,151
https://kawalpemilu.org#53020,"SELAPAJANG JAYA, NEGLASARI, KOTA TANGERANG, BANTEN",23,65,130,195
https://kawalpemilu.org#53020,"SELAPAJANG JAYA, NEGLASARI, KOTA TANGERANG, BANTEN",24,69,86,155
https://kawalpemilu.org#53020,"SELAPAJANG JAYA, NEGLASARI, KOTA TANGERANG, BANTEN",26,0,0,0
https://kawalpemilu.org#53020,"SELAPAJANG JAYA, NEGLASARI, KOTA TANGERANG, BANTEN",27,75,65,140
https://kawalpemilu.org#53020,"SELAPAJANG JAYA, NEGLASARI, KOTA TANGERANG, BANTEN",31,88,59,147
https://kawalpemilu.org#53020,"SELAPAJANG JAYA, NEGLASARI, KOTA TANGERANG, BANTEN",32,192,39,231
https://kawalpemilu.org#53020,"SELAPAJANG JAYA, NEGLASARI, KOTA TANGERANG, BANTEN",33,85,105,190
https://kawalpemilu.org#53020,"SELAPAJANG JAYA, NEGLASARI, KOTA TANGERANG, BANTEN",34,67,95,162
https://kawalpemilu.org#53020,"SELAPAJANG JAYA, NEGLASARI, KOTA TANGERANG, BANTEN",35,139,22,161
https://kawalpemilu.org#53020,"SELAPAJANG JAYA, NEGLASARI, KOTA TANGERANG, BANTEN",36,124,27,151
https://kawalpemilu.org#53020,"SELAPAJANG JAYA, NEGLASARI, KOTA TANGERANG, BANTEN",38,79,59,138
https://kawalpemilu.org#53020,"SELAPAJANG JAYA, NEGLASARI, KOTA TANGERANG, BANTEN",40,80,147,227
https://kawalpemilu.org#53020,"SELAPAJANG JAYA, NEGLASARI, KOTA TANGERANG, BANTEN",41,76,160,236
https://kawalpemilu.org#53020,"SELAPAJANG JAYA, NEGLASARI, KOTA TANGERANG, BANTEN",42,59,160,219
https://kawalpemilu.org#53020,"SELAPAJANG JAYA, NEGLASARI, KOTA TANGERANG, BANTEN",43,37,138,175
https://kawalpemilu.org#53020,"SELAPAJANG JAYA, NEGLASARI, KOTA TANGERANG, BANTEN",44,47,147,194
https://kawalpemilu.org#53020,"SELAPAJANG JAYA, NEGLASARI, KOTA TANGERANG, BANTEN",45,101,154,255
https://kawalpemilu.org#53020,"SELAPAJANG JAYA, NEGLASARI, KOTA TANGERANG, BANTEN",46,85,150,235
https://kawalpemilu.org#53020,"SELAPAJANG JAYA, NEGLASARI, KOTA TANGERANG, BANTEN",47,120,65,185
https://kawalpemilu.org#53020,"SELAPAJANG JAYA, NEGLASARI, KOTA TANGERANG, BANTEN",48,101,86,187
https://kawalpemilu.org#53020,"SELAPAJANG JAYA, NEGLASARI, KOTA TANGERANG, BANTEN",49,109,65,174
https://kawalpemilu.org#53020,"SELAPAJANG JAYA, NEGLASARI, KOTA TANGERANG, BANTEN",50,106,58,164
https://kawalpemilu.org#53021,"KEDAUNG WETAN, NEGLASARI, KOTA TANGERANG, BANTEN",3,160,71,231
https://kawalpemilu.org#53021,"KEDAUNG WETAN, NEGLASARI, KOTA TANGERANG, BANTEN",5,146,71,217
https://kawalpemilu.org#53021,"KEDAUNG WETAN, NEGLASARI, KOTA TANGERANG, BANTEN",7,106,121,227
https://kawalpemilu.org#53021,"KEDAUNG WETAN, NEGLASARI, KOTA TANGERANG, BANTEN",8,184,44,228
https://kawalpemilu.org#53021,"KEDAUNG WETAN, NEGLASARI, KOTA TANGERANG, BANTEN",10,113,90,206
https://kawalpemilu.org#53021,"KEDAUNG WETAN, NEGLASARI, KOTA TANGERANG, BANTEN",15,68,96,164
https://kawalpemilu.org#53021,"KEDAUNG WETAN, NEGLASARI, KOTA TANGERANG, BANTEN",16,101,91,192
https://kawalpemilu.org#53021,"KEDAUNG WETAN, NEGLASARI, KOTA TANGERANG, BANTEN",17,87,98,185
https://kawalpemilu.org#53021,"KEDAUNG WETAN, NEGLASARI, KOTA TANGERANG, BANTEN",18,107,148,255
https://kawalpemilu.org#53021,"KEDAUNG WETAN, NEGLASARI, KOTA TANGERANG, BANTEN",19,123,125,248
https://kawalpemilu.org#53021,"KEDAUNG WETAN, NEGLASARI, KOTA TANGERANG, BANTEN",22,77,83,160
https://kawalpemilu.org#53021,"KEDAUNG WETAN, NEGLASARI, KOTA TANGERANG, BANTEN",23,69,153,234
https://kawalpemilu.org#53021,"KEDAUNG WETAN, NEGLASARI, KOTA TANGERANG, BANTEN",24,73,152,225
https://kawalpemilu.org#53021,"KEDAUNG WETAN, NEGLASARI, KOTA TANGERANG, BANTEN",25,93,135,228
https://kawalpemilu.org#53021,"KEDAUNG WETAN, NEGLASARI, KOTA TANGERANG, BANTEN",26,121,89,210
https://kawalpemilu.org#53021,"KEDAUNG WETAN, NEGLASARI, KOTA TANGERANG, BANTEN",28,65,131,196
https://kawalpemilu.org#53021,"KEDAUNG WETAN, NEGLASARI, KOTA TANGERANG, BANTEN",30,60,146,206
https://kawalpemilu.org#53021,"KEDAUNG WETAN, NEGLASARI, KOTA TANGERANG, BANTEN",31,72,93,165
https://kawalpemilu.org#53021,"KEDAUNG WETAN, NEGLASARI, KOTA TANGERANG, BANTEN",32,88,103,191
https://kawalpemilu.org#53021,"KEDAUNG WETAN, NEGLASARI, KOTA TANGERANG, BANTEN",34,99,111,210
https://kawalpemilu.org#53021,"KEDAUNG WETAN, NEGLASARI, KOTA TANGERANG, BANTEN",35,114,105,219
https://kawalpemilu.org#53021,"KEDAUNG WETAN, NEGLASARI, KOTA TANGERANG, BANTEN",39,93,105,198
https://kawalpemilu.org#53021,"KEDAUNG WETAN, NEGLASARI, KOTA TANGERANG, BANTEN",42,109,78,187
https://kawalpemilu.org#53021,"KEDAUNG WETAN, NEGLASARI, KOTA TANGERANG, BANTEN",44,76,187,263
https://kawalpemilu.org#53021,"KEDAUNG WETAN, NEGLASARI, KOTA TANGERANG, BANTEN",46,173,79,252
https://kawalpemilu.org#53022,"MEKARSARI, NEGLASARI, KOTA TANGERANG, BANTEN",1,176,49,225
https://kawalpemilu.org#53022,"MEKARSARI, NEGLASARI, KOTA TANGERANG, BANTEN",2,213,7,220
https://kawalpemilu.org#53022,"MEKARSARI, NEGLASARI, KOTA TANGERANG, BANTEN",3,168,42,210
https://kawalpemilu.org#53022,"MEKARSARI, NEGLASARI, KOTA TANGERANG, BANTEN",4,130,97,227
https://kawalpemilu.org#53022,"MEKARSARI, NEGLASARI, KOTA TANGERANG, BANTEN",5,104,117,221
https://kawalpemilu.org#53022,"MEKARSARI, NEGLASARI, KOTA TANGERANG, BANTEN",6,106,129,235
https://kawalpemilu.org#53022,"MEKARSARI, NEGLASARI, KOTA TANGERANG, BANTEN",7,69,128,197
https://kawalpemilu.org#53022,"MEKARSARI, NEGLASARI, KOTA TANGERANG, BANTEN",8,70,146,216
https://kawalpemilu.org#53022,"MEKARSARI, NEGLASARI, KOTA TANGERANG, BANTEN",9,86,124,210
https://kawalpemilu.org#53022,"MEKARSARI, NEGLASARI, KOTA TANGERANG, BANTEN",10,146,87,233
https://kawalpemilu.org#53022,"MEKARSARI, NEGLASARI, KOTA TANGERANG, BANTEN",11,75,146,221
https://kawalpemilu.org#53022,"MEKARSARI, NEGLASARI, KOTA TANGERANG, BANTEN",12,75,122,197
https://kawalpemilu.org#53022,"MEKARSARI, NEGLASARI, KOTA TANGERANG, BANTEN",13,93,135,228
https://kawalpemilu.org#53022,"MEKARSARI, NEGLASARI, KOTA TANGERANG, BANTEN",14,78,144,222
https://kawalpemilu.org#53022,"MEKARSARI, NEGLASARI, KOTA TANGERANG, BANTEN",15,120,76,196
https://kawalpemilu.org#53022,"MEKARSARI, NEGLASARI, KOTA TANGERANG, BANTEN",16,154,63,217
https://kawalpemilu.org#53022,"MEKARSARI, NEGLASARI, KOTA TANGERANG, BANTEN",17,231,8,239
https://kawalpemilu.org#53022,"MEKARSARI, NEGLASARI, KOTA TANGERANG, BANTEN",18,231,4,235
https://kawalpemilu.org#53022,"MEKARSARI, NEGLASARI, KOTA TANGERANG, BANTEN",19,226,6,232
https://kawalpemilu.org#53022,"MEKARSARI, NEGLASARI, KOTA TANGERANG, BANTEN",20,248,13,261
https://kawalpemilu.org#53022,"MEKARSARI, NEGLASARI, KOTA TANGERANG, BANTEN",21,221,4,225
https://kawalpemilu.org#53022,"MEKARSARI, NEGLASARI, KOTA TANGERANG, BANTEN",22,178,6,184
https://kawalpemilu.org#53022,"MEKARSARI, NEGLASARI, KOTA TANGERANG, BANTEN",23,181,7,188
https://kawalpemilu.org#53022,"MEKARSARI, NEGLASARI, KOTA TANGERANG, BANTEN",24,143,42,185
https://kawalpemilu.org#53022,"MEKARSARI, NEGLASARI, KOTA TANGERANG, BANTEN",25,186,19,205
https://kawalpemilu.org#53022,"MEKARSARI, NEGLASARI, KOTA TANGERANG, BANTEN",26,223,5,228
https://kawalpemilu.org#53022,"MEKARSARI, NEGLASARI, KOTA TANGERANG, BANTEN",28,160,6,166
https://kawalpemilu.org#53022,"MEKARSARI, NEGLASARI, KOTA TANGERANG, BANTEN",29,168,8,176
https://kawalpemilu.org#53022,"MEKARSARI, NEGLASARI, KOTA TANGERANG, BANTEN",30,254,7,261
https://kawalpemilu.org#53022,"MEKARSARI, NEGLASARI, KOTA TANGERANG, BANTEN",31,212,13,225
https://kawalpemilu.org#53022,"MEKARSARI, NEGLASARI, KOTA TANGERANG, BANTEN",32,209,8,217
https://kawalpemilu.org#53022,"MEKARSARI, NEGLASARI, KOTA TANGERANG, BANTEN",33,224,7,231
https://kawalpemilu.org#53022,"MEKARSARI, NEGLASARI, KOTA TANGERANG, BANTEN",34,226,3,229
https://kawalpemilu.org#53022,"MEKARSARI, NEGLASARI, KOTA TANGERANG, BANTEN",35,193,26,219
https://kawalpemilu.org#53023,"KARANG ANYAR, NEGLASARI, KOTA TANGERANG, BANTEN",3,64,132,196
https://kawalpemilu.org#53023,"KARANG ANYAR, NEGLASARI, KOTA TANGERANG, BANTEN",4,87,137,224
https://kawalpemilu.org#53023,"KARANG ANYAR, NEGLASARI, KOTA TANGERANG, BANTEN",6,48,171,219
https://kawalpemilu.org#53023,"KARANG ANYAR, NEGLASARI, KOTA TANGERANG, BANTEN",7,53,134,187
https://kawalpemilu.org#53023,"KARANG ANYAR, NEGLASARI, KOTA TANGERANG, BANTEN",8,76,148,224
https://kawalpemilu.org#53023,"KARANG ANYAR, NEGLASARI, KOTA TANGERANG, BANTEN",11,94,144,238
https://kawalpemilu.org#53023,"KARANG ANYAR, NEGLASARI, KOTA TANGERANG, BANTEN",12,93,161,254
https://kawalpemilu.org#53023,"KARANG ANYAR, NEGLASARI, KOTA TANGERANG, BANTEN",13,74,110,184
https://kawalpemilu.org#53023,"KARANG ANYAR, NEGLASARI, KOTA TANGERANG, BANTEN",14,67,150,217
https://kawalpemilu.org#53023,"KARANG ANYAR, NEGLASARI, KOTA TANGERANG, BANTEN",15,85,161,246
https://kawalpemilu.org#53023,"KARANG ANYAR, NEGLASARI, KOTA TANGERANG, BANTEN",16,51,113,164
https://kawalpemilu.org#53023,"KARANG ANYAR, NEGLASARI, KOTA TANGERANG, BANTEN",17,75,143,218
https://kawalpemilu.org#53023,"KARANG ANYAR, NEGLASARI, KOTA TANGERANG, BANTEN",18,86,119,206
https://kawalpemilu.org#53023,"KARANG ANYAR, NEGLASARI, KOTA TANGERANG, BANTEN",19,71,130,201
https://kawalpemilu.org#53023,"KARANG ANYAR, NEGLASARI, KOTA TANGERANG, BANTEN",21,138,80,194
https://kawalpemilu.org#53023,"KARANG ANYAR, NEGLASARI, KOTA TANGERANG, BANTEN",22,131,79,210
https://kawalpemilu.org#53023,"KARANG ANYAR, NEGLASARI, KOTA TANGERANG, BANTEN",23,86,122,208
https://kawalpemilu.org#53023,"KARANG ANYAR, NEGLASARI, KOTA TANGERANG, BANTEN",24,80,140,220
https://kawalpemilu.org#53023,"KARANG ANYAR, NEGLASARI, KOTA TANGERANG, BANTEN",25,85,145,230
https://kawalpemilu.org#53023,"KARANG ANYAR, NEGLASARI, KOTA TANGERANG, BANTEN",27,95,133,228
https://kawalpemilu.org#53023,"KARANG ANYAR, NEGLASARI, KOTA TANGERANG, BANTEN",28,99,128,227
https://kawalpemilu.org#53023,"KARANG ANYAR, NEGLASARI, KOTA TANGERANG, BANTEN",29,107,121,228
https://kawalpemilu.org#53023,"KARANG ANYAR, NEGLASARI, KOTA TANGERANG, BANTEN",30,101,130,231
https://kawalpemilu.org#53023,"KARANG ANYAR, NEGLASARI, KOTA TANGERANG, BANTEN",31,61,169,230
https://kawalpemilu.org#53023,"KARANG ANYAR, NEGLASARI, KOTA TANGERANG, BANTEN",32,88,163,251
https://kawalpemilu.org#53023,"KARANG ANYAR, NEGLASARI, KOTA TANGERANG, BANTEN",33,92,136,228
https://kawalpemilu.org#53023,"KARANG ANYAR, NEGLASARI, KOTA TANGERANG, BANTEN",34,80,151,231
https://kawalpemilu.org#53023,"KARANG ANYAR, NEGLASARI, KOTA TANGERANG, BANTEN",35,94,129,223
https://kawalpemilu.org#53023,"KARANG ANYAR, NEGLASARI, KOTA TANGERANG, BANTEN",36,80,143,223
https://kawalpemilu.org#53024,"KEDAUNG BARU, NEGLASARI, KOTA TANGERANG, BANTEN",1,78,78,156
https://kawalpemilu.org#53024,"KEDAUNG BARU, NEGLASARI, KOTA TANGERANG, BANTEN",2,84,73,157
https://kawalpemilu.org#53024,"KEDAUNG BARU, NEGLASARI, KOTA TANGERANG, BANTEN",3,130,86,216
https://kawalpemilu.org#53024,"KEDAUNG BARU, NEGLASARI, KOTA TANGERANG, BANTEN",4,97,111,208
https://kawalpemilu.org#53024,"KEDAUNG BARU, NEGLASARI, KOTA TANGERANG, BANTEN",10,85,64,149
https://kawalpemilu.org#53024,"KEDAUNG BARU, NEGLASARI, KOTA TANGERANG, BANTEN",13,86,107,193
https://kawalpemilu.org#53024,"KEDAUNG BARU, NEGLASARI, KOTA TANGERANG, BANTEN",15,159,84,243
https://kawalpemilu.org#53024,"KEDAUNG BARU, NEGLASARI, KOTA TANGERANG, BANTEN",18,107,113,220
https://kawalpemilu.org#53024,"KEDAUNG BARU, NEGLASARI, KOTA TANGERANG, BANTEN",19,155,97,252
https://kawalpemilu.org#53024,"KEDAUNG BARU, NEGLASARI, KOTA TANGERANG, BANTEN",20,90,114,204
https://kawalpemilu.org#53024,"KEDAUNG BARU, NEGLASARI, KOTA TANGERANG, BANTEN",21,91,103,194
https://kawalpemilu.org#53024,"KEDAUNG BARU, NEGLASARI, KOTA TANGERANG, BANTEN",22,119,53,172
https://kawalpemilu.org#53024,"KEDAUNG BARU, NEGLASARI, KOTA TANGERANG, BANTEN",25,88,83,171
https://kawalpemilu.org#53026,"PINANG, PINANG, KOTA TANGERANG, BANTEN",1,67,107,174
https://kawalpemilu.org#53026,"PINANG, PINANG, KOTA TANGERANG, BANTEN",2,50,106,156
https://kawalpemilu.org#53026,"PINANG, PINANG, KOTA TANGERANG, BANTEN",3,51,110,161
https://kawalpemilu.org#53026,"PINANG, PINANG, KOTA TANGERANG, BANTEN",4,31,80,111
https://kawalpemilu.org#53026,"PINANG, PINANG, KOTA TANGERANG, BANTEN",5,24,152,176
https://kawalpemilu.org#53026,"PINANG, PINANG, KOTA TANGERANG, BANTEN",6,31,125,156
https://kawalpemilu.org#53026,"PINANG, PINANG, KOTA TANGERANG, BANTEN",7,55,95,150
https://kawalpemilu.org#53026,"PINANG, PINANG, KOTA TANGERANG, BANTEN",8,52,102,154
https://kawalpemilu.org#53026,"PINANG, PINANG, KOTA TANGERANG, BANTEN",9,52,132,184
https://kawalpemilu.org#53026,"PINANG, PINANG, KOTA TANGERANG, BANTEN",10,38,136,174
https://kawalpemilu.org#53026,"PINANG, PINANG, KOTA TANGERANG, BANTEN",11,50,92,142
https://kawalpemilu.org#53026,"PINANG, PINANG, KOTA TANGERANG, BANTEN",12,58,107,165
https://kawalpemilu.org#53026,"PINANG, PINANG, KOTA TANGERANG, BANTEN",13,47,127,174
https://kawalpemilu.org#53026,"PINANG, PINANG, KOTA TANGERANG, BANTEN",14,35,160,195
https://kawalpemilu.org#53026,"PINANG, PINANG, KOTA TANGERANG, BANTEN",15,61,100,161
https://kawalpemilu.org#53026,"PINANG, PINANG, KOTA TANGERANG, BANTEN",16,75,121,196
https://kawalpemilu.org#53026,"PINANG, PINANG, KOTA TANGERANG, BANTEN",17,92,128,220
https://kawalpemilu.org#53026,"PINANG, PINANG, KOTA TANGERANG, BANTEN",18,77,150,227
https://kawalpemilu.org#53026,"PINANG, PINANG, KOTA TANGERANG, BANTEN",19,76,103,179
https://kawalpemilu.org#53026,"PINANG, PINANG, KOTA TANGERANG, BANTEN",20,76,122,198
https://kawalpemilu.org#53026,"PINANG, PINANG, KOTA TANGERANG, BANTEN",21,47,70,117
https://kawalpemilu.org#53026,"PINANG, PINANG, KOTA TANGERANG, BANTEN",22,52,91,143
https://kawalpemilu.org#53026,"PINANG, PINANG, KOTA TANGERANG, BANTEN",23,72,128,200
https://kawalpemilu.org#53026,"PINANG, PINANG, KOTA TANGERANG, BANTEN",25,57,119,176
https://kawalpemilu.org#53026,"PINANG, PINANG, KOTA TANGERANG, BANTEN",26,68,116,234
https://kawalpemilu.org#53026,"PINANG, PINANG, KOTA TANGERANG, BANTEN",27,44,111,155
https://kawalpemilu.org#53026,"PINANG, PINANG, KOTA TANGERANG, BANTEN",28,46,130,176
https://kawalpemilu.org#53026,"PINANG, PINANG, KOTA TANGERANG, BANTEN",29,79,107,186
https://kawalpemilu.org#53026,"PINANG, PINANG, KOTA TANGERANG, BANTEN",30,93,109,202
https://kawalpemilu.org#53026,"PINANG, PINANG, KOTA TANGERANG, BANTEN",31,58,105,163
https://kawalpemilu.org#53026,"PINANG, PINANG, KOTA TANGERANG, BANTEN",32,54,80,134
https://kawalpemilu.org#53026,"PINANG, PINANG, KOTA TANGERANG, BANTEN",33,69,130,199
https://kawalpemilu.org#53026,"PINANG, PINANG, KOTA TANGERANG, BANTEN",34,59,126,185
https://kawalpemilu.org#53026,"PINANG, PINANG, KOTA TANGERANG, BANTEN",35,87,158,245
https://kawalpemilu.org#53026,"PINANG, PINANG, KOTA TANGERANG, BANTEN",36,95,160,255
https://kawalpemilu.org#53026,"PINANG, PINANG, KOTA TANGERANG, BANTEN",37,62,200,262
https://kawalpemilu.org#53026,"PINANG, PINANG, KOTA TANGERANG, BANTEN",38,44,104,148
https://kawalpemilu.org#53026,"PINANG, PINANG, KOTA TANGERANG, BANTEN",39,43,93,136
https://kawalpemilu.org#53026,"PINANG, PINANG, KOTA TANGERANG, BANTEN",40,81,179,260
https://kawalpemilu.org#53026,"PINANG, PINANG, KOTA TANGERANG, BANTEN",41,60,178,238
https://kawalpemilu.org#53026,"PINANG, PINANG, KOTA TANGERANG, BANTEN",42,60,124,184
https://kawalpemilu.org#53026,"PINANG, PINANG, KOTA TANGERANG, BANTEN",43,55,119,174
https://kawalpemilu.org#53026,"PINANG, PINANG, KOTA TANGERANG, BANTEN",44,123,99,222
https://kawalpemilu.org#53026,"PINANG, PINANG, KOTA TANGERANG, BANTEN",45,129,96,225
https://kawalpemilu.org#53026,"PINANG, PINANG, KOTA TANGERANG, BANTEN",46,57,76,133
https://kawalpemilu.org#53026,"PINANG, PINANG, KOTA TANGERANG, BANTEN",47,83,69,152
https://kawalpemilu.org#53026,"PINANG, PINANG, KOTA TANGERANG, BANTEN",48,73,57,130
https://kawalpemilu.org#53026,"PINANG, PINANG, KOTA TANGERANG, BANTEN",50,106,89,195
https://kawalpemilu.org#53026,"PINANG, PINANG, KOTA TANGERANG, BANTEN",51,83,104,187
https://kawalpemilu.org#53026,"PINANG, PINANG, KOTA TANGERANG, BANTEN",52,121,102,223
https://kawalpemilu.org#53026,"PINANG, PINANG, KOTA TANGERANG, BANTEN",53,122,81,203
https://kawalpemilu.org#53026,"PINANG, PINANG, KOTA TANGERANG, BANTEN",54,101,81,182
https://kawalpemilu.org#53026,"PINANG, PINANG, KOTA TANGERANG, BANTEN",55,97,77,174
https://kawalpemilu.org#53026,"PINANG, PINANG, KOTA TANGERANG, BANTEN",56,75,62,137
https://kawalpemilu.org#53026,"PINANG, PINANG, KOTA TANGERANG, BANTEN",57,92,98,190
https://kawalpemilu.org#53026,"PINANG, PINANG, KOTA TANGERANG, BANTEN",58,72,114,186
https://kawalpemilu.org#53026,"PINANG, PINANG, KOTA TANGERANG, BANTEN",59,108,78,186
https://kawalpemilu.org#53026,"PINANG, PINANG, KOTA TANGERANG, BANTEN",60,88,93,181
https://kawalpemilu.org#53026,"PINANG, PINANG, KOTA TANGERANG, BANTEN",61,78,88,166
https://kawalpemilu.org#53026,"PINANG, PINANG, KOTA TANGERANG, BANTEN",62,78,87,165
https://kawalpemilu.org#53026,"PINANG, PINANG, KOTA TANGERANG, BANTEN",63,93,81,174
https://kawalpemilu.org#53026,"PINANG, PINANG, KOTA TANGERANG, BANTEN",64,84,83,167
https://kawalpemilu.org#53026,"PINANG, PINANG, KOTA TANGERANG, BANTEN",65,121,105,226
https://kawalpemilu.org#53026,"PINANG, PINANG, KOTA TANGERANG, BANTEN",66,121,101,222
https://kawalpemilu.org#53027,"SUDIMARA PINANG, PINANG, KOTA TANGERANG, BANTEN",1,83,87,170
https://kawalpemilu.org#53027,"SUDIMARA PINANG, PINANG, KOTA TANGERANG, BANTEN",2,93,107,200
https://kawalpemilu.org#53027,"SUDIMARA PINANG, PINANG, KOTA TANGERANG, BANTEN",3,65,59,124
https://kawalpemilu.org#53027,"SUDIMARA PINANG, PINANG, KOTA TANGERANG, BANTEN",4,52,102,154
https://kawalpemilu.org#53027,"SUDIMARA PINANG, PINANG, KOTA TANGERANG, BANTEN",5,39,79,118
https://kawalpemilu.org#53027,"SUDIMARA PINANG, PINANG, KOTA TANGERANG, BANTEN",6,116,97,213
https://kawalpemilu.org#53027,"SUDIMARA PINANG, PINANG, KOTA TANGERANG, BANTEN",7,81,125,206
https://kawalpemilu.org#53027,"SUDIMARA PINANG, PINANG, KOTA TANGERANG, BANTEN",8,87,60,147
https://kawalpemilu.org#53027,"SUDIMARA PINANG, PINANG, KOTA TANGERANG, BANTEN",9,36,101,137
https://kawalpemilu.org#53027,"SUDIMARA PINANG, PINANG, KOTA TANGERANG, BANTEN",10,90,94,184
https://kawalpemilu.org#53027,"SUDIMARA PINANG, PINANG, KOTA TANGERANG, BANTEN",11,51,89,140
https://kawalpemilu.org#53027,"SUDIMARA PINANG, PINANG, KOTA TANGERANG, BANTEN",12,87,110,197
https://kawalpemilu.org#53027,"SUDIMARA PINANG, PINANG, KOTA TANGERANG, BANTEN",13,43,71,114
https://kawalpemilu.org#53027,"SUDIMARA PINANG, PINANG, KOTA TANGERANG, BANTEN",14,39,112,151
https://kawalpemilu.org#53027,"SUDIMARA PINANG, PINANG, KOTA TANGERANG, BANTEN",15,55,177,232
https://kawalpemilu.org#53027,"SUDIMARA PINANG, PINANG, KOTA TANGERANG, BANTEN",16,54,143,197
https://kawalpemilu.org#53027,"SUDIMARA PINANG, PINANG, KOTA TANGERANG, BANTEN",17,87,90,177
https://kawalpemilu.org#53027,"SUDIMARA PINANG, PINANG, KOTA TANGERANG, BANTEN",18,76,79,155
https://kawalpemilu.org#53027,"SUDIMARA PINANG, PINANG, KOTA TANGERANG, BANTEN",19,47,70,117
https://kawalpemilu.org#53027,"SUDIMARA PINANG, PINANG, KOTA TANGERANG, BANTEN",20,97,64,161
https://kawalpemilu.org#53027,"SUDIMARA PINANG, PINANG, KOTA TANGERANG, BANTEN",21,87,103,190
https://kawalpemilu.org#53027,"SUDIMARA PINANG, PINANG, KOTA TANGERANG, BANTEN",22,63,106,169
https://kawalpemilu.org#53027,"SUDIMARA PINANG, PINANG, KOTA TANGERANG, BANTEN",23,104,63,167
https://kawalpemilu.org#53027,"SUDIMARA PINANG, PINANG, KOTA TANGERANG, BANTEN",24,64,142,206
https://kawalpemilu.org#53027,"SUDIMARA PINANG, PINANG, KOTA TANGERANG, BANTEN",25,87,104,191
https://kawalpemilu.org#53027,"SUDIMARA PINANG, PINANG, KOTA TANGERANG, BANTEN",26,81,141,222
https://kawalpemilu.org#53027,"SUDIMARA PINANG, PINANG, KOTA TANGERANG, BANTEN",27,85,131,216
https://kawalpemilu.org#53027,"SUDIMARA PINANG, PINANG, KOTA TANGERANG, BANTEN",28,110,45,155
https://kawalpemilu.org#53027,"SUDIMARA PINANG, PINANG, KOTA TANGERANG, BANTEN",29,76,101,177
https://kawalpemilu.org#53027,"SUDIMARA PINANG, PINANG, KOTA TANGERANG, BANTEN",30,76,164,240
https://kawalpemilu.org#53027,"SUDIMARA PINANG, PINANG, KOTA TANGERANG, BANTEN",31,74,142,216
https://kawalpemilu.org#53027,"SUDIMARA PINANG, PINANG, KOTA TANGERANG, BANTEN",32,54,135,189
https://kawalpemilu.org#53027,"SUDIMARA PINANG, PINANG, KOTA TANGERANG, BANTEN",33,46,112,158
https://kawalpemilu.org#53027,"SUDIMARA PINANG, PINANG, KOTA TANGERANG, BANTEN",34,34,119,153
https://kawalpemilu.org#53027,"SUDIMARA PINANG, PINANG, KOTA TANGERANG, BANTEN",35,71,102,173
https://kawalpemilu.org#53027,"SUDIMARA PINANG, PINANG, KOTA TANGERANG, BANTEN",36,66,116,182
https://kawalpemilu.org#53027,"SUDIMARA PINANG, PINANG, KOTA TANGERANG, BANTEN",37,45,116,161
https://kawalpemilu.org#53027,"SUDIMARA PINANG, PINANG, KOTA TANGERANG, BANTEN",38,58,104,162
https://kawalpemilu.org#53027,"SUDIMARA PINANG, PINANG, KOTA TANGERANG, BANTEN",39,70,71,141
https://kawalpemilu.org#53027,"SUDIMARA PINANG, PINANG, KOTA TANGERANG, BANTEN",40,69,65,134
https://kawalpemilu.org#53027,"SUDIMARA PINANG, PINANG, KOTA TANGERANG, BANTEN",41,69,89,158
https://kawalpemilu.org#53027,"SUDIMARA PINANG, PINANG, KOTA TANGERANG, BANTEN",42,32,100,132
https://kawalpemilu.org#53027,"SUDIMARA PINANG, PINANG, KOTA TANGERANG, BANTEN",43,29,88,117
https://kawalpemilu.org#53027,"SUDIMARA PINANG, PINANG, KOTA TANGERANG, BANTEN",44,62,150,212
https://kawalpemilu.org#53027,"SUDIMARA PINANG, PINANG, KOTA TANGERANG, BANTEN",45,55,109,164
https://kawalpemilu.org#53027,"SUDIMARA PINANG, PINANG, KOTA TANGERANG, BANTEN",46,46,113,159
https://kawalpemilu.org#53027,"SUDIMARA PINANG, PINANG, KOTA TANGERANG, BANTEN",47,44,120,164
https://kawalpemilu.org#53027,"SUDIMARA PINANG, PINANG, KOTA TANGERANG, BANTEN",48,82,113,195
https://kawalpemilu.org#53027,"SUDIMARA PINANG, PINANG, KOTA TANGERANG, BANTEN",49,95,129,224
https://kawalpemilu.org#53027,"SUDIMARA PINANG, PINANG, KOTA TANGERANG, BANTEN",50,81,162,243
https://kawalpemilu.org#53027,"SUDIMARA PINANG, PINANG, KOTA TANGERANG, BANTEN",51,54,112,166
https://kawalpemilu.org#53027,"SUDIMARA PINANG, PINANG, KOTA TANGERANG, BANTEN",52,48,128,176
https://kawalpemilu.org#53027,"SUDIMARA PINANG, PINANG, KOTA TANGERANG, BANTEN",53,69,90,159
https://kawalpemilu.org#53027,"SUDIMARA PINANG, PINANG, KOTA TANGERANG, BANTEN",54,46,103,149
https://kawalpemilu.org#53027,"SUDIMARA PINANG, PINANG, KOTA TANGERANG, BANTEN",55,82,76,158
https://kawalpemilu.org#53027,"SUDIMARA PINANG, PINANG, KOTA TANGERANG, BANTEN",56,56,88,144
https://kawalpemilu.org#53027,"SUDIMARA PINANG, PINANG, KOTA TANGERANG, BANTEN",57,76,97,173
https://kawalpemilu.org#53027,"SUDIMARA PINANG, PINANG, KOTA TANGERANG, BANTEN",58,65,98,163
https://kawalpemilu.org#53027,"SUDIMARA PINANG, PINANG, KOTA TANGERANG, BANTEN",59,104,105,209
https://kawalpemilu.org#53027,"SUDIMARA PINANG, PINANG, KOTA TANGERANG, BANTEN",60,78,95,173
https://kawalpemilu.org#53028,"NEROGTOG, PINANG, KOTA TANGERANG, BANTEN",1,78,166,244
https://kawalpemilu.org#53028,"NEROGTOG, PINANG, KOTA TANGERANG, BANTEN",2,55,162,217
https://kawalpemilu.org#53028,"NEROGTOG, PINANG, KOTA TANGERANG, BANTEN",3,86,142,228
https://kawalpemilu.org#53028,"NEROGTOG, PINANG, KOTA TANGERANG, BANTEN",4,72,130,202
https://kawalpemilu.org#53028,"NEROGTOG, PINANG, KOTA TANGERANG, BANTEN",5,72,141,213
https://kawalpemilu.org#53028,"NEROGTOG, PINANG, KOTA TANGERANG, BANTEN",6,69,192,261
https://kawalpemilu.org#53028,"NEROGTOG, PINANG, KOTA TANGERANG, BANTEN",7,68,130,198
https://kawalpemilu.org#53028,"NEROGTOG, PINANG, KOTA TANGERANG, BANTEN",8,55,105,160
https://kawalpemilu.org#53028,"NEROGTOG, PINANG, KOTA TANGERANG, BANTEN",9,77,108,185
https://kawalpemilu.org#53028,"NEROGTOG, PINANG, KOTA TANGERANG, BANTEN",10,97,109,206
https://kawalpemilu.org#53028,"NEROGTOG, PINANG, KOTA TANGERANG, BANTEN",11,51,182,233
https://kawalpemilu.org#53028,"NEROGTOG, PINANG, KOTA TANGERANG, BANTEN",12,76,168,244
https://kawalpemilu.org#53028,"NEROGTOG, PINANG, KOTA TANGERANG, BANTEN",13,99,136,235
https://kawalpemilu.org#53028,"NEROGTOG, PINANG, KOTA TANGERANG, BANTEN",14,77,143,220
https://kawalpemilu.org#53028,"NEROGTOG, PINANG, KOTA TANGERANG, BANTEN",15,91,164,255
https://kawalpemilu.org#53028,"NEROGTOG, PINANG, KOTA TANGERANG, BANTEN",16,116,138,254
https://kawalpemilu.org#53028,"NEROGTOG, PINANG, KOTA TANGERANG, BANTEN",17,49,174,223
https://kawalpemilu.org#53028,"NEROGTOG, PINANG, KOTA TANGERANG, BANTEN",18,65,144,209
https://kawalpemilu.org#53028,"NEROGTOG, PINANG, KOTA TANGERANG, BANTEN",19,48,196,244
https://kawalpemilu.org#53028,"NEROGTOG, PINANG, KOTA TANGERANG, BANTEN",20,38,172,210
https://kawalpemilu.org#53028,"NEROGTOG, PINANG, KOTA TANGERANG, BANTEN",21,85,92,177
https://kawalpemilu.org#53028,"NEROGTOG, PINANG, KOTA TANGERANG, BANTEN",22,61,74,135
https://kawalpemilu.org#53028,"NEROGTOG, PINANG, KOTA TANGERANG, BANTEN",23,81,114,195
https://kawalpemilu.org#53028,"NEROGTOG, PINANG, KOTA TANGERANG, BANTEN",24,73,104,177
https://kawalpemilu.org#53028,"NEROGTOG, PINANG, KOTA TANGERANG, BANTEN",25,71,117,188
https://kawalpemilu.org#53028,"NEROGTOG, PINANG, KOTA TANGERANG, BANTEN",27,53,143,196
https://kawalpemilu.org#53028,"NEROGTOG, PINANG, KOTA TANGERANG, BANTEN",28,114,156,270
https://kawalpemilu.org#53028,"NEROGTOG, PINANG, KOTA TANGERANG, BANTEN",29,51,194,245
https://kawalpemilu.org#53028,"NEROGTOG, PINANG, KOTA TANGERANG, BANTEN",30,102,159,261
https://kawalpemilu.org#53028,"NEROGTOG, PINANG, KOTA TANGERANG, BANTEN",31,57,155,212
https://kawalpemilu.org#53028,"NEROGTOG, PINANG, KOTA TANGERANG, BANTEN",32,64,160,224
https://kawalpemilu.org#53028,"NEROGTOG, PINANG, KOTA TANGERANG, BANTEN",33,73,151,224
https://kawalpemilu.org#53028,"NEROGTOG, PINANG, KOTA TANGERANG, BANTEN",34,51,160,211
https://kawalpemilu.org#53028,"NEROGTOG, PINANG, KOTA TANGERANG, BANTEN",35,75,105,180
https://kawalpemilu.org#53028,"NEROGTOG, PINANG, KOTA TANGERANG, BANTEN",36,84,109,193
https://kawalpemilu.org#53028,"NEROGTOG, PINANG, KOTA TANGERANG, BANTEN",37,62,119,181
https://kawalpemilu.org#53028,"NEROGTOG, PINANG, KOTA TANGERANG, BANTEN",38,73,129,202
https://kawalpemilu.org#53028,"NEROGTOG, PINANG, KOTA TANGERANG, BANTEN",39,81,141,222
https://kawalpemilu.org#53028,"NEROGTOG, PINANG, KOTA TANGERANG, BANTEN",40,77,105,182
https://kawalpemilu.org#53028,"NEROGTOG, PINANG, KOTA TANGERANG, BANTEN",41,147,78,225
https://kawalpemilu.org#53028,"NEROGTOG, PINANG, KOTA TANGERANG, BANTEN",42,145,96,241
https://kawalpemilu.org#53028,"NEROGTOG, PINANG, KOTA TANGERANG, BANTEN",43,126,119,245
https://kawalpemilu.org#53028,"NEROGTOG, PINANG, KOTA TANGERANG, BANTEN",44,111,152,263
https://kawalpemilu.org#53028,"NEROGTOG, PINANG, KOTA TANGERANG, BANTEN",45,114,150,264
https://kawalpemilu.org#53029,"KUNCIRAN, PINANG, KOTA TANGERANG, BANTEN",1,114,128,242
https://kawalpemilu.org#53029,"KUNCIRAN, PINANG, KOTA TANGERANG, BANTEN",2,94,143,237
https://kawalpemilu.org#53029,"KUNCIRAN, PINANG, KOTA TANGERANG, BANTEN",4,91,135,226
https://kawalpemilu.org#53029,"KUNCIRAN, PINANG, KOTA TANGERANG, BANTEN",5,86,175,261
https://kawalpemilu.org#53029,"KUNCIRAN, PINANG, KOTA TANGERANG, BANTEN",6,85,148,233
https://kawalpemilu.org#53029,"KUNCIRAN, PINANG, KOTA TANGERANG, BANTEN",7,94,120,214
https://kawalpemilu.org#53029,"KUNCIRAN, PINANG, KOTA TANGERANG, BANTEN",8,73,150,223
https://kawalpemilu.org#53029,"KUNCIRAN, PINANG, KOTA TANGERANG, BANTEN",9,92,130,222
https://kawalpemilu.org#53029,"KUNCIRAN, PINANG, KOTA TANGERANG, BANTEN",10,101,137,238
https://kawalpemilu.org#53029,"KUNCIRAN, PINANG, KOTA TANGERANG, BANTEN",11,142,68,210
https://kawalpemilu.org#53029,"KUNCIRAN, PINANG, KOTA TANGERANG, BANTEN",12,113,97,210
https://kawalpemilu.org#53029,"KUNCIRAN, PINANG, KOTA TANGERANG, BANTEN",13,98,117,215
https://kawalpemilu.org#53029,"KUNCIRAN, PINANG, KOTA TANGERANG, BANTEN",14,137,130,267
https://kawalpemilu.org#53029,"KUNCIRAN, PINANG, KOTA TANGERANG, BANTEN",15,104,164,268
https://kawalpemilu.org#53029,"KUNCIRAN, PINANG, KOTA TANGERANG, BANTEN",16,109,121,230
https://kawalpemilu.org#53029,"KUNCIRAN, PINANG, KOTA TANGERANG, BANTEN",17,128,92,220
https://kawalpemilu.org#53029,"KUNCIRAN, PINANG, KOTA TANGERANG, BANTEN",18,111,120,231
https://kawalpemilu.org#53029,"KUNCIRAN, PINANG, KOTA TANGERANG, BANTEN",19,95,131,226
https://kawalpemilu.org#53029,"KUNCIRAN, PINANG, KOTA TANGERANG, BANTEN",21,89,140,229
https://kawalpemilu.org#53029,"KUNCIRAN, PINANG, KOTA TANGERANG, BANTEN",22,128,137,265
https://kawalpemilu.org#53029,"KUNCIRAN, PINANG, KOTA TANGERANG, BANTEN",23,99,180,279
https://kawalpemilu.org#53029,"KUNCIRAN, PINANG, KOTA TANGERANG, BANTEN",24,118,125,243
https://kawalpemilu.org#53029,"KUNCIRAN, PINANG, KOTA TANGERANG, BANTEN",25,95,128,223
https://kawalpemilu.org#53029,"KUNCIRAN, PINANG, KOTA TANGERANG, BANTEN",26,153,105,258
https://kawalpemilu.org#53029,"KUNCIRAN, PINANG, KOTA TANGERANG, BANTEN",27,123,113,236
https://kawalpemilu.org#53029,"KUNCIRAN, PINANG, KOTA TANGERANG, BANTEN",28,126,159,285
https://kawalpemilu.org#53029,"KUNCIRAN, PINANG, KOTA TANGERANG, BANTEN",29,129,108,237
https://kawalpemilu.org#53029,"KUNCIRAN, PINANG, KOTA TANGERANG, BANTEN",30,90,140,230
https://kawalpemilu.org#53029,"KUNCIRAN, PINANG, KOTA TANGERANG, BANTEN",31,111,106,217
https://kawalpemilu.org#53029,"KUNCIRAN, PINANG, KOTA TANGERANG, BANTEN",32,123,122,245
https://kawalpemilu.org#53029,"KUNCIRAN, PINANG, KOTA TANGERANG, BANTEN",33,119,158,277
https://kawalpemilu.org#53029,"KUNCIRAN, PINANG, KOTA TANGERANG, BANTEN",34,127,129,256
https://kawalpemilu.org#53029,"KUNCIRAN, PINANG, KOTA TANGERANG, BANTEN",35,53,162,215
https://kawalpemilu.org#53029,"KUNCIRAN, PINANG, KOTA TANGERANG, BANTEN",36,75,179,254
https://kawalpemilu.org#53029,"KUNCIRAN, PINANG, KOTA TANGERANG, BANTEN",37,122,144,266
https://kawalpemilu.org#53030,"KUNCIRAN INDAH, PINANG, KOTA TANGERANG, BANTEN",1,134,101,235
https://kawalpemilu.org#53030,"KUNCIRAN INDAH, PINANG, KOTA TANGERANG, BANTEN",2,107,112,119
https://kawalpemilu.org#53030,"KUNCIRAN INDAH, PINANG, KOTA TANGERANG, BANTEN",3,118,105,223
https://kawalpemilu.org#53030,"KUNCIRAN INDAH, PINANG, KOTA TANGERANG, BANTEN",4,101,137,238
https://kawalpemilu.org#53030,"KUNCIRAN INDAH, PINANG, KOTA TANGERANG, BANTEN",5,78,152,230
https://kawalpemilu.org#53030,"KUNCIRAN INDAH, PINANG, KOTA TANGERANG, BANTEN",6,94,126,220
https://kawalpemilu.org#53030,"KUNCIRAN INDAH, PINANG, KOTA TANGERANG, BANTEN",7,107,114,221
https://kawalpemilu.org#53030,"KUNCIRAN INDAH, PINANG, KOTA TANGERANG, BANTEN",8,141,85,226
https://kawalpemilu.org#53030,"KUNCIRAN INDAH, PINANG, KOTA TANGERANG, BANTEN",9,82,106,188
https://kawalpemilu.org#53030,"KUNCIRAN INDAH, PINANG, KOTA TANGERANG, BANTEN",10,123,76,199
https://kawalpemilu.org#53030,"KUNCIRAN INDAH, PINANG, KOTA TANGERANG, BANTEN",11,95,134,229
https://kawalpemilu.org#53030,"KUNCIRAN INDAH, PINANG, KOTA TANGERANG, BANTEN",13,106,114,220
https://kawalpemilu.org#53030,"KUNCIRAN INDAH, PINANG, KOTA TANGERANG, BANTEN",14,78,92,170
https://kawalpemilu.org#53030,"KUNCIRAN INDAH, PINANG, KOTA TANGERANG, BANTEN",15,78,96,174
https://kawalpemilu.org#53030,"KUNCIRAN INDAH, PINANG, KOTA TANGERANG, BANTEN",16,65,119,184
https://kawalpemilu.org#53030,"KUNCIRAN INDAH, PINANG, KOTA TANGERANG, BANTEN",17,97,129,226
https://kawalpemilu.org#53030,"KUNCIRAN INDAH, PINANG, KOTA TANGERANG, BANTEN",18,96,98,194
https://kawalpemilu.org#53030,"KUNCIRAN INDAH, PINANG, KOTA TANGERANG, BANTEN",19,76,103,179
https://kawalpemilu.org#53030,"KUNCIRAN INDAH, PINANG, KOTA TANGERANG, BANTEN",20,119,102,221
https://kawalpemilu.org#53030,"KUNCIRAN INDAH, PINANG, KOTA TANGERANG, BANTEN",21,83,92,175
https://kawalpemilu.org#53030,"KUNCIRAN INDAH, PINANG, KOTA TANGERANG, BANTEN",22,112,102,214
https://kawalpemilu.org#53030,"KUNCIRAN INDAH, PINANG, KOTA TANGERANG, BANTEN",23,126,117,243
https://kawalpemilu.org#53030,"KUNCIRAN INDAH, PINANG, KOTA TANGERANG, BANTEN",24,102,98,200
https://kawalpemilu.org#53030,"KUNCIRAN INDAH, PINANG, KOTA TANGERANG, BANTEN",25,102,115,217
https://kawalpemilu.org#53030,"KUNCIRAN INDAH, PINANG, KOTA TANGERANG, BANTEN",26,79,132,211
https://kawalpemilu.org#53030,"KUNCIRAN INDAH, PINANG, KOTA TANGERANG, BANTEN",27,86,132,218
https://kawalpemilu.org#53030,"KUNCIRAN INDAH, PINANG, KOTA TANGERANG, BANTEN",28,106,132,238
https://kawalpemilu.org#53030,"KUNCIRAN INDAH, PINANG, KOTA TANGERANG, BANTEN",29,106,104,210
https://kawalpemilu.org#53030,"KUNCIRAN INDAH, PINANG, KOTA TANGERANG, BANTEN",30,95,86,181
https://kawalpemilu.org#53030,"KUNCIRAN INDAH, PINANG, KOTA TANGERANG, BANTEN",31,81,118,199
https://kawalpemilu.org#53030,"KUNCIRAN INDAH, PINANG, KOTA TANGERANG, BANTEN",32,83,138,221
https://kawalpemilu.org#53030,"KUNCIRAN INDAH, PINANG, KOTA TANGERANG, BANTEN",33,94,104,198
https://kawalpemilu.org#53030,"KUNCIRAN INDAH, PINANG, KOTA TANGERANG, BANTEN",34,88,140,228
https://kawalpemilu.org#53030,"KUNCIRAN INDAH, PINANG, KOTA TANGERANG, BANTEN",35,73,140,213
https://kawalpemilu.org#53030,"KUNCIRAN INDAH, PINANG, KOTA TANGERANG, BANTEN",36,88,159,247
https://kawalpemilu.org#53030,"KUNCIRAN INDAH, PINANG, KOTA TANGERANG, BANTEN",37,72,106,178
https://kawalpemilu.org#53030,"KUNCIRAN INDAH, PINANG, KOTA TANGERANG, BANTEN",38,107,135,242
https://kawalpemilu.org#53030,"KUNCIRAN INDAH, PINANG, KOTA TANGERANG, BANTEN",39,86,134,220
https://kawalpemilu.org#53030,"KUNCIRAN INDAH, PINANG, KOTA TANGERANG, BANTEN",40,105,144,249
https://kawalpemilu.org#53030,"KUNCIRAN INDAH, PINANG, KOTA TANGERANG, BANTEN",41,93,131,224
https://kawalpemilu.org#53030,"KUNCIRAN INDAH, PINANG, KOTA TANGERANG, BANTEN",42,93,142,235
https://kawalpemilu.org#53030,"KUNCIRAN INDAH, PINANG, KOTA TANGERANG, BANTEN",43,122,96,218
https://kawalpemilu.org#53030,"KUNCIRAN INDAH, PINANG, KOTA TANGERANG, BANTEN",44,71,100,171
https://kawalpemilu.org#53030,"KUNCIRAN INDAH, PINANG, KOTA TANGERANG, BANTEN",45,93,105,198
https://kawalpemilu.org#53030,"KUNCIRAN INDAH, PINANG, KOTA TANGERANG, BANTEN",46,76,86,162
https://kawalpemilu.org#53030,"KUNCIRAN INDAH, PINANG, KOTA TANGERANG, BANTEN",47,77,121,198
https://kawalpemilu.org#53030,"KUNCIRAN INDAH, PINANG, KOTA TANGERANG, BANTEN",48,54,106,160
https://kawalpemilu.org#53030,"KUNCIRAN INDAH, PINANG, KOTA TANGERANG, BANTEN",49,88,106,194
https://kawalpemilu.org#53030,"KUNCIRAN INDAH, PINANG, KOTA TANGERANG, BANTEN",50,71,97,168
https://kawalpemilu.org#53030,"KUNCIRAN INDAH, PINANG, KOTA TANGERANG, BANTEN",51,77,125,202
https://kawalpemilu.org#53030,"KUNCIRAN INDAH, PINANG, KOTA TANGERANG, BANTEN",52,75,161,236
https://kawalpemilu.org#53030,"KUNCIRAN INDAH, PINANG, KOTA TANGERANG, BANTEN",53,68,144,212
https://kawalpemilu.org#53030,"KUNCIRAN INDAH, PINANG, KOTA TANGERANG, BANTEN",54,77,170,247
https://kawalpemilu.org#53030,"KUNCIRAN INDAH, PINANG, KOTA TANGERANG, BANTEN",55,91,130,221
https://kawalpemilu.org#53030,"KUNCIRAN INDAH, PINANG, KOTA TANGERANG, BANTEN",56,102,101,203
https://kawalpemilu.org#53030,"KUNCIRAN INDAH, PINANG, KOTA TANGERANG, BANTEN",57,122,94,216
https://kawalpemilu.org#53030,"KUNCIRAN INDAH, PINANG, KOTA TANGERANG, BANTEN",58,132,122,254
https://kawalpemilu.org#53030,"KUNCIRAN INDAH, PINANG, KOTA TANGERANG, BANTEN",59,112,107,219
https://kawalpemilu.org#53030,"KUNCIRAN INDAH, PINANG, KOTA TANGERANG, BANTEN",60,81,141,222
https://kawalpemilu.org#53030,"KUNCIRAN INDAH, PINANG, KOTA TANGERANG, BANTEN",61,76,121,197
https://kawalpemilu.org#53030,"KUNCIRAN INDAH, PINANG, KOTA TANGERANG, BANTEN",62,95,139,234
https://kawalpemilu.org#53030,"KUNCIRAN INDAH, PINANG, KOTA TANGERANG, BANTEN",63,106,100,206
https://kawalpemilu.org#53030,"KUNCIRAN INDAH, PINANG, KOTA TANGERANG, BANTEN",64,88,123,211
https://kawalpemilu.org#53030,"KUNCIRAN INDAH, PINANG, KOTA TANGERANG, BANTEN",65,95,104,199
https://kawalpemilu.org#53030,"KUNCIRAN INDAH, PINANG, KOTA TANGERANG, BANTEN",66,81,105,186
https://kawalpemilu.org#53030,"KUNCIRAN INDAH, PINANG, KOTA TANGERANG, BANTEN",67,77,154,231
https://kawalpemilu.org#53030,"KUNCIRAN INDAH, PINANG, KOTA TANGERANG, BANTEN",68,73,119,192
https://kawalpemilu.org#53030,"KUNCIRAN INDAH, PINANG, KOTA TANGERANG, BANTEN",69,101,96,197
https://kawalpemilu.org#53030,"KUNCIRAN INDAH, PINANG, KOTA TANGERANG, BANTEN",70,62,141,203
https://kawalpemilu.org#53030,"KUNCIRAN INDAH, PINANG, KOTA TANGERANG, BANTEN",71,64,134,198
https://kawalpemilu.org#53030,"KUNCIRAN INDAH, PINANG, KOTA TANGERANG, BANTEN",72,84,118,202
https://kawalpemilu.org#53030,"KUNCIRAN INDAH, PINANG, KOTA TANGERANG, BANTEN",73,85,110,195
https://kawalpemilu.org#53030,"KUNCIRAN INDAH, PINANG, KOTA TANGERANG, BANTEN",74,71,121,192
https://kawalpemilu.org#53030,"KUNCIRAN INDAH, PINANG, KOTA TANGERANG, BANTEN",75,82,110,192
https://kawalpemilu.org#53030,"KUNCIRAN INDAH, PINANG, KOTA TANGERANG, BANTEN",76,70,128,198
https://kawalpemilu.org#53030,"KUNCIRAN INDAH, PINANG, KOTA TANGERANG, BANTEN",77,103,129,232
https://kawalpemilu.org#53030,"KUNCIRAN INDAH, PINANG, KOTA TANGERANG, BANTEN",78,91,119,210
https://kawalpemilu.org#53030,"KUNCIRAN INDAH, PINANG, KOTA TANGERANG, BANTEN",79,98,151,249
https://kawalpemilu.org#53030,"KUNCIRAN INDAH, PINANG, KOTA TANGERANG, BANTEN",80,98,129,227
https://kawalpemilu.org#53030,"KUNCIRAN INDAH, PINANG, KOTA TANGERANG, BANTEN",81,83,146,229
https://kawalpemilu.org#53030,"KUNCIRAN INDAH, PINANG, KOTA TANGERANG, BANTEN",82,91,123,214
https://kawalpemilu.org#53030,"KUNCIRAN INDAH, PINANG, KOTA TANGERANG, BANTEN",83,69,84,153
https://kawalpemilu.org#53030,"KUNCIRAN INDAH, PINANG, KOTA TANGERANG, BANTEN",84,112,130,242
https://kawalpemilu.org#53030,"KUNCIRAN INDAH, PINANG, KOTA TANGERANG, BANTEN",85,101,127,228
https://kawalpemilu.org#53030,"KUNCIRAN INDAH, PINANG, KOTA TANGERANG, BANTEN",86,74,115,189
https://kawalpemilu.org#53030,"KUNCIRAN INDAH, PINANG, KOTA TANGERANG, BANTEN",87,72,126,198
https://kawalpemilu.org#53030,"KUNCIRAN INDAH, PINANG, KOTA TANGERANG, BANTEN",88,85,131,216
https://kawalpemilu.org#53030,"KUNCIRAN INDAH, PINANG, KOTA TANGERANG, BANTEN",89,62,145,207
https://kawalpemilu.org#53030,"KUNCIRAN INDAH, PINANG, KOTA TANGERANG, BANTEN",90,68,153,221
https://kawalpemilu.org#53030,"KUNCIRAN INDAH, PINANG, KOTA TANGERANG, BANTEN",91,66,121,187
https://kawalpemilu.org#53030,"KUNCIRAN INDAH, PINANG, KOTA TANGERANG, BANTEN",92,89,148,237
https://kawalpemilu.org#53031,"KUNCIRAN JAYA, PINANG, KOTA TANGERANG, BANTEN",1,76,123,199
https://kawalpemilu.org#53031,"KUNCIRAN JAYA, PINANG, KOTA TANGERANG, BANTEN",3,57,169,226
https://kawalpemilu.org#53031,"KUNCIRAN JAYA, PINANG, KOTA TANGERANG, BANTEN",4,53,167,220
https://kawalpemilu.org#53031,"KUNCIRAN JAYA, PINANG, KOTA TANGERANG, BANTEN",5,54,160,214
https://kawalpemilu.org#53031,"KUNCIRAN JAYA, PINANG, KOTA TANGERANG, BANTEN",6,40,166,206
https://kawalpemilu.org#53031,"KUNCIRAN JAYA, PINANG, KOTA TANGERANG, BANTEN",7,42,163,205
https://kawalpemilu.org#53031,"KUNCIRAN JAYA, PINANG, KOTA TANGERANG, BANTEN",9,88,139,227
https://kawalpemilu.org#53031,"KUNCIRAN JAYA, PINANG, KOTA TANGERANG, BANTEN",10,45,154,199
https://kawalpemilu.org#53031,"KUNCIRAN JAYA, PINANG, KOTA TANGERANG, BANTEN",11,37,160,197
https://kawalpemilu.org#53031,"KUNCIRAN JAYA, PINANG, KOTA TANGERANG, BANTEN",12,47,135,182
https://kawalpemilu.org#53031,"KUNCIRAN JAYA, PINANG, KOTA TANGERANG, BANTEN",13,44,129,173
https://kawalpemilu.org#53031,"KUNCIRAN JAYA, PINANG, KOTA TANGERANG, BANTEN",14,32,105,137
https://kawalpemilu.org#53031,"KUNCIRAN JAYA, PINANG, KOTA TANGERANG, BANTEN",15,37,116,153
https://kawalpemilu.org#53031,"KUNCIRAN JAYA, PINANG, KOTA TANGERANG, BANTEN",16,52,142,194
https://kawalpemilu.org#53031,"KUNCIRAN JAYA, PINANG, KOTA TANGERANG, BANTEN",17,50,141,191
https://kawalpemilu.org#53031,"KUNCIRAN JAYA, PINANG, KOTA TANGERANG, BANTEN",18,63,169,232
https://kawalpemilu.org#53031,"KUNCIRAN JAYA, PINANG, KOTA TANGERANG, BANTEN",19,82,140,222
https://kawalpemilu.org#53031,"KUNCIRAN JAYA, PINANG, KOTA TANGERANG, BANTEN",20,68,190,258
https://kawalpemilu.org#53031,"KUNCIRAN JAYA, PINANG, KOTA TANGERANG, BANTEN",21,47,130,177
https://kawalpemilu.org#53031,"KUNCIRAN JAYA, PINANG, KOTA TANGERANG, BANTEN",22,41,132,173
https://kawalpemilu.org#53031,"KUNCIRAN JAYA, PINANG, KOTA TANGERANG, BANTEN",23,54,133,187
https://kawalpemilu.org#53031,"KUNCIRAN JAYA, PINANG, KOTA TANGERANG, BANTEN",24,42,159,201
https://kawalpemilu.org#53031,"KUNCIRAN JAYA, PINANG, KOTA TANGERANG, BANTEN",25,72,177,249
https://kawalpemilu.org#53031,"KUNCIRAN JAYA, PINANG, KOTA TANGERANG, BANTEN",26,39,196,235
https://kawalpemilu.org#53032,"CIPETE, PINANG, KOTA TANGERANG, BANTEN",1,48,190,238
https://kawalpemilu.org#53032,"CIPETE, PINANG, KOTA TANGERANG, BANTEN",2,53,166,219
https://kawalpemilu.org#53032,"CIPETE, PINANG, KOTA TANGERANG, BANTEN",3,31,168,199
https://kawalpemilu.org#53032,"CIPETE, PINANG, KOTA TANGERANG, BANTEN",4,37,156,193
https://kawalpemilu.org#53032,"CIPETE, PINANG, KOTA TANGERANG, BANTEN",5,77,166,243
https://kawalpemilu.org#53032,"CIPETE, PINANG, KOTA TANGERANG, BANTEN",6,53,204,257
https://kawalpemilu.org#53032,"CIPETE, PINANG, KOTA TANGERANG, BANTEN",7,64,170,234
https://kawalpemilu.org#53032,"CIPETE, PINANG, KOTA TANGERANG, BANTEN",8,60,148,208
https://kawalpemilu.org#53032,"CIPETE, PINANG, KOTA TANGERANG, BANTEN",9,62,132,194
https://kawalpemilu.org#53032,"CIPETE, PINANG, KOTA TANGERANG, BANTEN",10,37,155,192
https://kawalpemilu.org#53032,"CIPETE, PINANG, KOTA TANGERANG, BANTEN",11,39,149,188
https://kawalpemilu.org#53032,"CIPETE, PINANG, KOTA TANGERANG, BANTEN",12,59,167,226
https://kawalpemilu.org#53032,"CIPETE, PINANG, KOTA TANGERANG, BANTEN",13,55,155,210
https://kawalpemilu.org#53032,"CIPETE, PINANG, KOTA TANGERANG, BANTEN",14,87,111,198
https://kawalpemilu.org#53032,"CIPETE, PINANG, KOTA TANGERANG, BANTEN",15,83,117,200
https://kawalpemilu.org#53032,"CIPETE, PINANG, KOTA TANGERANG, BANTEN",16,82,103,185
https://kawalpemilu.org#53032,"CIPETE, PINANG, KOTA TANGERANG, BANTEN",17,58,207,265
https://kawalpemilu.org#53032,"CIPETE, PINANG, KOTA TANGERANG, BANTEN",18,49,170,219
https://kawalpemilu.org#53032,"CIPETE, PINANG, KOTA TANGERANG, BANTEN",19,46,138,184
https://kawalpemilu.org#53032,"CIPETE, PINANG, KOTA TANGERANG, BANTEN",20,53,161,214
https://kawalpemilu.org#53032,"CIPETE, PINANG, KOTA TANGERANG, BANTEN",21,43,184,227
https://kawalpemilu.org#53032,"CIPETE, PINANG, KOTA TANGERANG, BANTEN",22,45,119,164
https://kawalpemilu.org#53032,"CIPETE, PINANG, KOTA TANGERANG, BANTEN",23,58,215,273
https://kawalpemilu.org#53032,"CIPETE, PINANG, KOTA TANGERANG, BANTEN",24,44,167,211
https://kawalpemilu.org#53032,"CIPETE, PINANG, KOTA TANGERANG, BANTEN",25,38,188,219
https://kawalpemilu.org#53032,"CIPETE, PINANG, KOTA TANGERANG, BANTEN",26,54,156,210
https://kawalpemilu.org#53032,"CIPETE, PINANG, KOTA TANGERANG, BANTEN",27,51,194,245
https://kawalpemilu.org#53032,"CIPETE, PINANG, KOTA TANGERANG, BANTEN",28,154,62,216
https://kawalpemilu.org#53032,"CIPETE, PINANG, KOTA TANGERANG, BANTEN",29,143,39,182
https://kawalpemilu.org#53032,"CIPETE, PINANG, KOTA TANGERANG, BANTEN",30,150,46,196
https://kawalpemilu.org#53032,"CIPETE, PINANG, KOTA TANGERANG, BANTEN",31,153,77,230
https://kawalpemilu.org#53032,"CIPETE, PINANG, KOTA TANGERANG, BANTEN",32,191,67,258
https://kawalpemilu.org#53032,"CIPETE, PINANG, KOTA TANGERANG, BANTEN",33,161,82,243
https://kawalpemilu.org#53032,"CIPETE, PINANG, KOTA TANGERANG, BANTEN",34,218,28,246
https://kawalpemilu.org#53032,"CIPETE, PINANG, KOTA TANGERANG, BANTEN",35,193,61,254
https://kawalpemilu.org#53032,"CIPETE, PINANG, KOTA TANGERANG, BANTEN",36,241,34,275
https://kawalpemilu.org#53032,"CIPETE, PINANG, KOTA TANGERANG, BANTEN",37,156,74,230
https://kawalpemilu.org#53032,"CIPETE, PINANG, KOTA TANGERANG, BANTEN",38,203,93,296
https://kawalpemilu.org#53032,"CIPETE, PINANG, KOTA TANGERANG, BANTEN",39,148,85,233
https://kawalpemilu.org#53033,"PAKOJAN, PINANG, KOTA TANGERANG, BANTEN",1,40,113,138
https://kawalpemilu.org#53033,"PAKOJAN, PINANG, KOTA TANGERANG, BANTEN",2,32,116,148
https://kawalpemilu.org#53033,"PAKOJAN, PINANG, KOTA TANGERANG, BANTEN",3,77,118,195
https://kawalpemilu.org#53033,"PAKOJAN, PINANG, KOTA TANGERANG, BANTEN",4,56,127,183
https://kawalpemilu.org#53033,"PAKOJAN, PINANG, KOTA TANGERANG, BANTEN",5,56,153,209
https://kawalpemilu.org#53033,"PAKOJAN, PINANG, KOTA TANGERANG, BANTEN",6,59,138,197
https://kawalpemilu.org#53033,"PAKOJAN, PINANG, KOTA TANGERANG, BANTEN",7,64,179,243
https://kawalpemilu.org#53033,"PAKOJAN, PINANG, KOTA TANGERANG, BANTEN",8,31,128,159
https://kawalpemilu.org#53033,"PAKOJAN, PINANG, KOTA TANGERANG, BANTEN",9,38,146,184
https://kawalpemilu.org#53033,"PAKOJAN, PINANG, KOTA TANGERANG, BANTEN",10,68,131,199
https://kawalpemilu.org#53033,"PAKOJAN, PINANG, KOTA TANGERANG, BANTEN",11,75,52,127
https://kawalpemilu.org#53033,"PAKOJAN, PINANG, KOTA TANGERANG, BANTEN",12,91,136,227
https://kawalpemilu.org#53033,"PAKOJAN, PINANG, KOTA TANGERANG, BANTEN",13,141,99,240
https://kawalpemilu.org#53033,"PAKOJAN, PINANG, KOTA TANGERANG, BANTEN",14,70,120,190
https://kawalpemilu.org#53033,"PAKOJAN, PINANG, KOTA TANGERANG, BANTEN",15,66,129,195
https://kawalpemilu.org#53033,"PAKOJAN, PINANG, KOTA TANGERANG, BANTEN",16,60,153,213
https://kawalpemilu.org#53033,"PAKOJAN, PINANG, KOTA TANGERANG, BANTEN",17,81,137,218
https://kawalpemilu.org#53033,"PAKOJAN, PINANG, KOTA TANGERANG, BANTEN",18,71,162,233
https://kawalpemilu.org#53033,"PAKOJAN, PINANG, KOTA TANGERANG, BANTEN",19,71,164,235
https://kawalpemilu.org#53033,"PAKOJAN, PINANG, KOTA TANGERANG, BANTEN",20,17,129,146
https://kawalpemilu.org#53033,"PAKOJAN, PINANG, KOTA TANGERANG, BANTEN",21,49,166,215
https://kawalpemilu.org#53033,"PAKOJAN, PINANG, KOTA TANGERANG, BANTEN",22,42,153,195
https://kawalpemilu.org#53033,"PAKOJAN, PINANG, KOTA TANGERANG, BANTEN",23,48,145,193
https://kawalpemilu.org#53034,"PANUNGGANGAN, PINANG, KOTA TANGERANG, BANTEN",1,127,160,287
https://kawalpemilu.org#53034,"PANUNGGANGAN, PINANG, KOTA TANGERANG, BANTEN",2,129,100,229
https://kawalpemilu.org#53034,"PANUNGGANGAN, PINANG, KOTA TANGERANG, BANTEN",3,114,133,247
https://kawalpemilu.org#53034,"PANUNGGANGAN, PINANG, KOTA TANGERANG, BANTEN",4,69,175,244
https://kawalpemilu.org#53034,"PANUNGGANGAN, PINANG, KOTA TANGERANG, BANTEN",5,67,141,208
https://kawalpemilu.org#53034,"PANUNGGANGAN, PINANG, KOTA TANGERANG, BANTEN",6,72,114,186
https://kawalpemilu.org#53034,"PANUNGGANGAN, PINANG, KOTA TANGERANG, BANTEN",7,60,120,180
https://kawalpemilu.org#53034,"PANUNGGANGAN, PINANG, KOTA TANGERANG, BANTEN",8,70,163,233
https://kawalpemilu.org#53034,"PANUNGGANGAN, PINANG, KOTA TANGERANG, BANTEN",9,76,155,231
https://kawalpemilu.org#53034,"PANUNGGANGAN, PINANG, KOTA TANGERANG, BANTEN",10,73,152,225
https://kawalpemilu.org#53034,"PANUNGGANGAN, PINANG, KOTA TANGERANG, BANTEN",11,103,149,252
https://kawalpemilu.org#53034,"PANUNGGANGAN, PINANG, KOTA TANGERANG, BANTEN",12,96,145,241
https://kawalpemilu.org#53034,"PANUNGGANGAN, PINANG, KOTA TANGERANG, BANTEN",13,72,167,239
https://kawalpemilu.org#53034,"PANUNGGANGAN, PINANG, KOTA TANGERANG, BANTEN",14,112,126,238
https://kawalpemilu.org#53034,"PANUNGGANGAN, PINANG, KOTA TANGERANG, BANTEN",16,71,183,254
https://kawalpemilu.org#53034,"PANUNGGANGAN, PINANG, KOTA TANGERANG, BANTEN",17,80,163,243
https://kawalpemilu.org#53034,"PANUNGGANGAN, PINANG, KOTA TANGERANG, BANTEN",18,78,124,202
https://kawalpemilu.org#53034,"PANUNGGANGAN, PINANG, KOTA TANGERANG, BANTEN",19,68,99,167
https://kawalpemilu.org#53034,"PANUNGGANGAN, PINANG, KOTA TANGERANG, BANTEN",20,107,120,227
https://kawalpemilu.org#53034,"PANUNGGANGAN, PINANG, KOTA TANGERANG, BANTEN",21,122,128,250
https://kawalpemilu.org#53034,"PANUNGGANGAN, PINANG, KOTA TANGERANG, BANTEN",22,46,139,185
https://kawalpemilu.org#53034,"PANUNGGANGAN, PINANG, KOTA TANGERANG, BANTEN",24,51,124,175
https://kawalpemilu.org#53034,"PANUNGGANGAN, PINANG, KOTA TANGERANG, BANTEN",25,62,179,241
https://kawalpemilu.org#53034,"PANUNGGANGAN, PINANG, KOTA TANGERANG, BANTEN",26,57,177,234
https://kawalpemilu.org#53035,"PANUNGGANGAN UTARA, PINANG, KOTA TANGERANG, BANTEN",1,43,102,145
https://kawalpemilu.org#53035,"PANUNGGANGAN UTARA, PINANG, KOTA TANGERANG, BANTEN",2,49,112,161
https://kawalpemilu.org#53035,"PANUNGGANGAN UTARA, PINANG, KOTA TANGERANG, BANTEN",3,62,72,134
https://kawalpemilu.org#53035,"PANUNGGANGAN UTARA, PINANG, KOTA TANGERANG, BANTEN",4,55,95,150
https://kawalpemilu.org#53035,"PANUNGGANGAN UTARA, PINANG, KOTA TANGERANG, BANTEN",5,91,94,185
https://kawalpemilu.org#53035,"PANUNGGANGAN UTARA, PINANG, KOTA TANGERANG, BANTEN",6,91,77,168
https://kawalpemilu.org#53035,"PANUNGGANGAN UTARA, PINANG, KOTA TANGERANG, BANTEN",7,86,127,213
https://kawalpemilu.org#53035,"PANUNGGANGAN UTARA, PINANG, KOTA TANGERANG, BANTEN",8,80,91,171
https://kawalpemilu.org#53035,"PANUNGGANGAN UTARA, PINANG, KOTA TANGERANG, BANTEN",9,68,100,168
https://kawalpemilu.org#53035,"PANUNGGANGAN UTARA, PINANG, KOTA TANGERANG, BANTEN",10,82,89,171
https://kawalpemilu.org#53035,"PANUNGGANGAN UTARA, PINANG, KOTA TANGERANG, BANTEN",11,64,83,147
https://kawalpemilu.org#53035,"PANUNGGANGAN UTARA, PINANG, KOTA TANGERANG, BANTEN",12,81,82,163
https://kawalpemilu.org#53035,"PANUNGGANGAN UTARA, PINANG, KOTA TANGERANG, BANTEN",13,49,104,153
https://kawalpemilu.org#53035,"PANUNGGANGAN UTARA, PINANG, KOTA TANGERANG, BANTEN",14,106,86,192
https://kawalpemilu.org#53035,"PANUNGGANGAN UTARA, PINANG, KOTA TANGERANG, BANTEN",15,84,112,196
https://kawalpemilu.org#53035,"PANUNGGANGAN UTARA, PINANG, KOTA TANGERANG, BANTEN",16,89,109,198
https://kawalpemilu.org#53035,"PANUNGGANGAN UTARA, PINANG, KOTA TANGERANG, BANTEN",17,88,112,200
https://kawalpemilu.org#53035,"PANUNGGANGAN UTARA, PINANG, KOTA TANGERANG, BANTEN",18,76,83,159
https://kawalpemilu.org#53035,"PANUNGGANGAN UTARA, PINANG, KOTA TANGERANG, BANTEN",19,71,140,211
https://kawalpemilu.org#53035,"PANUNGGANGAN UTARA, PINANG, KOTA TANGERANG, BANTEN",20,80,90,170
https://kawalpemilu.org#53035,"PANUNGGANGAN UTARA, PINANG, KOTA TANGERANG, BANTEN",21,84,102,186
https://kawalpemilu.org#53035,"PANUNGGANGAN UTARA, PINANG, KOTA TANGERANG, BANTEN",22,101,97,198
https://kawalpemilu.org#53035,"PANUNGGANGAN UTARA, PINANG, KOTA TANGERANG, BANTEN",23,60,84,144
https://kawalpemilu.org#53035,"PANUNGGANGAN UTARA, PINANG, KOTA TANGERANG, BANTEN",24,72,88,160
https://kawalpemilu.org#53035,"PANUNGGANGAN UTARA, PINANG, KOTA TANGERANG, BANTEN",25,58,67,125
https://kawalpemilu.org#53035,"PANUNGGANGAN UTARA, PINANG, KOTA TANGERANG, BANTEN",26,87,120,207
https://kawalpemilu.org#53035,"PANUNGGANGAN UTARA, PINANG, KOTA TANGERANG, BANTEN",27,87,57,144
https://kawalpemilu.org#53035,"PANUNGGANGAN UTARA, PINANG, KOTA TANGERANG, BANTEN",28,61,115,176
https://kawalpemilu.org#53035,"PANUNGGANGAN UTARA, PINANG, KOTA TANGERANG, BANTEN",29,70,155,225
https://kawalpemilu.org#53035,"PANUNGGANGAN UTARA, PINANG, KOTA TANGERANG, BANTEN",30,93,126,219
https://kawalpemilu.org#53035,"PANUNGGANGAN UTARA, PINANG, KOTA TANGERANG, BANTEN",31,98,143,241
https://kawalpemilu.org#53035,"PANUNGGANGAN UTARA, PINANG, KOTA TANGERANG, BANTEN",32,95,155,250
https://kawalpemilu.org#53035,"PANUNGGANGAN UTARA, PINANG, KOTA TANGERANG, BANTEN",33,86,147,233
https://kawalpemilu.org#53035,"PANUNGGANGAN UTARA, PINANG, KOTA TANGERANG, BANTEN",34,88,129,217
https://kawalpemilu.org#53035,"PANUNGGANGAN UTARA, PINANG, KOTA TANGERANG, BANTEN",35,97,99,196
https://kawalpemilu.org#53035,"PANUNGGANGAN UTARA, PINANG, KOTA TANGERANG, BANTEN",36,105,91,196
https://kawalpemilu.org#53035,"PANUNGGANGAN UTARA, PINANG, KOTA TANGERANG, BANTEN",37,97,129,226
https://kawalpemilu.org#53035,"PANUNGGANGAN UTARA, PINANG, KOTA TANGERANG, BANTEN",38,91,129,220
https://kawalpemilu.org#53035,"PANUNGGANGAN UTARA, PINANG, KOTA TANGERANG, BANTEN",39,76,136,212
https://kawalpemilu.org#53035,"PANUNGGANGAN UTARA, PINANG, KOTA TANGERANG, BANTEN",40,84,98,182
https://kawalpemilu.org#53035,"PANUNGGANGAN UTARA, PINANG, KOTA TANGERANG, BANTEN",41,77,94,171
https://kawalpemilu.org#53035,"PANUNGGANGAN UTARA, PINANG, KOTA TANGERANG, BANTEN",42,76,123,199
https://kawalpemilu.org#53035,"PANUNGGANGAN UTARA, PINANG, KOTA TANGERANG, BANTEN",43,59,128,187
https://kawalpemilu.org#53035,"PANUNGGANGAN UTARA, PINANG, KOTA TANGERANG, BANTEN",44,64,130,194
https://kawalpemilu.org#53035,"PANUNGGANGAN UTARA, PINANG, KOTA TANGERANG, BANTEN",45,81,101,182
https://kawalpemilu.org#53035,"PANUNGGANGAN UTARA, PINANG, KOTA TANGERANG, BANTEN",46,35,119,154
https://kawalpemilu.org#53035,"PANUNGGANGAN UTARA, PINANG, KOTA TANGERANG, BANTEN",47,42,89,131
https://kawalpemilu.org#53035,"PANUNGGANGAN UTARA, PINANG, KOTA TANGERANG, BANTEN",48,55,120,175
https://kawalpemilu.org#53035,"PANUNGGANGAN UTARA, PINANG, KOTA TANGERANG, BANTEN",49,69,126,195
https://kawalpemilu.org#53035,"PANUNGGANGAN UTARA, PINANG, KOTA TANGERANG, BANTEN",50,88,89,177
https://kawalpemilu.org#53035,"PANUNGGANGAN UTARA, PINANG, KOTA TANGERANG, BANTEN",51,99,74,173
https://kawalpemilu.org#53035,"PANUNGGANGAN UTARA, PINANG, KOTA TANGERANG, BANTEN",52,105,85,190
https://kawalpemilu.org#53035,"PANUNGGANGAN UTARA, PINANG, KOTA TANGERANG, BANTEN",53,124,65,189
https://kawalpemilu.org#53035,"PANUNGGANGAN UTARA, PINANG, KOTA TANGERANG, BANTEN",54,57,197,254
https://kawalpemilu.org#53035,"PANUNGGANGAN UTARA, PINANG, KOTA TANGERANG, BANTEN",55,57,197,254
https://kawalpemilu.org#53035,"PANUNGGANGAN UTARA, PINANG, KOTA TANGERANG, BANTEN",56,25,193,218
https://kawalpemilu.org#53035,"PANUNGGANGAN UTARA, PINANG, KOTA TANGERANG, BANTEN",57,145,123,173
https://kawalpemilu.org#53035,"PANUNGGANGAN UTARA, PINANG, KOTA TANGERANG, BANTEN",58,52,131,183
https://kawalpemilu.org#53035,"PANUNGGANGAN UTARA, PINANG, KOTA TANGERANG, BANTEN",59,38,136,174
https://kawalpemilu.org#53035,"PANUNGGANGAN UTARA, PINANG, KOTA TANGERANG, BANTEN",60,61,137,198
https://kawalpemilu.org#53035,"PANUNGGANGAN UTARA, PINANG, KOTA TANGERANG, BANTEN",61,82,118,200
https://kawalpemilu.org#53035,"PANUNGGANGAN UTARA, PINANG, KOTA TANGERANG, BANTEN",62,48,134,182
https://kawalpemilu.org#53035,"PANUNGGANGAN UTARA, PINANG, KOTA TANGERANG, BANTEN",63,53,104,157
https://kawalpemilu.org#53035,"PANUNGGANGAN UTARA, PINANG, KOTA TANGERANG, BANTEN",64,58,128,186
https://kawalpemilu.org#53035,"PANUNGGANGAN UTARA, PINANG, KOTA TANGERANG, BANTEN",65,62,133,195
https://kawalpemilu.org#53035,"PANUNGGANGAN UTARA, PINANG, KOTA TANGERANG, BANTEN",66,44,133,177
https://kawalpemilu.org#53035,"PANUNGGANGAN UTARA, PINANG, KOTA TANGERANG, BANTEN",67,48,128,176
https://kawalpemilu.org#53035,"PANUNGGANGAN UTARA, PINANG, KOTA TANGERANG, BANTEN",68,41,134,175
https://kawalpemilu.org#53035,"PANUNGGANGAN UTARA, PINANG, KOTA TANGERANG, BANTEN",69,55,123,178
https://kawalpemilu.org#53035,"PANUNGGANGAN UTARA, PINANG, KOTA TANGERANG, BANTEN",70,24,130,154
https://kawalpemilu.org#53036,"PANUNGGANGAN TIMUR, PINANG, KOTA TANGERANG, BANTEN",1,62,180,242
https://kawalpemilu.org#53036,"PANUNGGANGAN TIMUR, PINANG, KOTA TANGERANG, BANTEN",2,53,173,226
https://kawalpemilu.org#53036,"PANUNGGANGAN TIMUR, PINANG, KOTA TANGERANG, BANTEN",3,47,105,152
https://kawalpemilu.org#53036,"PANUNGGANGAN TIMUR, PINANG, KOTA TANGERANG, BANTEN",4,46,113,159
https://kawalpemilu.org#53036,"PANUNGGANGAN TIMUR, PINANG, KOTA TANGERANG, BANTEN",5,64,115,179
https://kawalpemilu.org#53036,"PANUNGGANGAN TIMUR, PINANG, KOTA TANGERANG, BANTEN",6,52,132,184
https://kawalpemilu.org#53036,"PANUNGGANGAN TIMUR, PINANG, KOTA TANGERANG, BANTEN",7,94,128,222
https://kawalpemilu.org#53036,"PANUNGGANGAN TIMUR, PINANG, KOTA TANGERANG, BANTEN",8,122,68,190
https://kawalpemilu.org#53036,"PANUNGGANGAN TIMUR, PINANG, KOTA TANGERANG, BANTEN",9,31,100,131
https://kawalpemilu.org#53036,"PANUNGGANGAN TIMUR, PINANG, KOTA TANGERANG, BANTEN",10,34,100,134
https://kawalpemilu.org#53038,"KARANG TENGAH, KARANG TENGAH, KOTA TANGERANG, BANTEN",1,126,124,250
https://kawalpemilu.org#53038,"KARANG TENGAH, KARANG TENGAH, KOTA TANGERANG, BANTEN",2,111,144,255
https://kawalpemilu.org#53038,"KARANG TENGAH, KARANG TENGAH, KOTA TANGERANG, BANTEN",3,69,168,237
https://kawalpemilu.org#53038,"KARANG TENGAH, KARANG TENGAH, KOTA TANGERANG, BANTEN",4,57,203,260
https://kawalpemilu.org#53038,"KARANG TENGAH, KARANG TENGAH, KOTA TANGERANG, BANTEN",5,71,193,264
https://kawalpemilu.org#53038,"KARANG TENGAH, KARANG TENGAH, KOTA TANGERANG, BANTEN",6,100,171,271
https://kawalpemilu.org#53038,"KARANG TENGAH, KARANG TENGAH, KOTA TANGERANG, BANTEN",7,97,180,277
https://kawalpemilu.org#53038,"KARANG TENGAH, KARANG TENGAH, KOTA TANGERANG, BANTEN",8,82,160,242
https://kawalpemilu.org#53038,"KARANG TENGAH, KARANG TENGAH, KOTA TANGERANG, BANTEN",9,125,144,269
https://kawalpemilu.org#53038,"KARANG TENGAH, KARANG TENGAH, KOTA TANGERANG, BANTEN",10,111,151,262
https://kawalpemilu.org#53038,"KARANG TENGAH, KARANG TENGAH, KOTA TANGERANG, BANTEN",11,73,149,222
https://kawalpemilu.org#53038,"KARANG TENGAH, KARANG TENGAH, KOTA TANGERANG, BANTEN",12,103,110,213
https://kawalpemilu.org#53038,"KARANG TENGAH, KARANG TENGAH, KOTA TANGERANG, BANTEN",13,72,128,200
https://kawalpemilu.org#53038,"KARANG TENGAH, KARANG TENGAH, KOTA TANGERANG, BANTEN",14,139,113,252
https://kawalpemilu.org#53038,"KARANG TENGAH, KARANG TENGAH, KOTA TANGERANG, BANTEN",15,122,116,238
https://kawalpemilu.org#53038,"KARANG TENGAH, KARANG TENGAH, KOTA TANGERANG, BANTEN",16,72,132,207
https://kawalpemilu.org#53038,"KARANG TENGAH, KARANG TENGAH, KOTA TANGERANG, BANTEN",17,121,127,248
https://kawalpemilu.org#53038,"KARANG TENGAH, KARANG TENGAH, KOTA TANGERANG, BANTEN",18,75,130,205
https://kawalpemilu.org#53038,"KARANG TENGAH, KARANG TENGAH, KOTA TANGERANG, BANTEN",19,81,168,249
https://kawalpemilu.org#53038,"KARANG TENGAH, KARANG TENGAH, KOTA TANGERANG, BANTEN",20,55,178,233
https://kawalpemilu.org#53038,"KARANG TENGAH, KARANG TENGAH, KOTA TANGERANG, BANTEN",21,104,117,221
https://kawalpemilu.org#53038,"KARANG TENGAH, KARANG TENGAH, KOTA TANGERANG, BANTEN",22,87,163,250
https://kawalpemilu.org#53038,"KARANG TENGAH, KARANG TENGAH, KOTA TANGERANG, BANTEN",23,91,170,261
https://kawalpemilu.org#53038,"KARANG TENGAH, KARANG TENGAH, KOTA TANGERANG, BANTEN",24,85,145,230
https://kawalpemilu.org#53038,"KARANG TENGAH, KARANG TENGAH, KOTA TANGERANG, BANTEN",26,132,123,255
https://kawalpemilu.org#53038,"KARANG TENGAH, KARANG TENGAH, KOTA TANGERANG, BANTEN",27,148,119,267
https://kawalpemilu.org#53038,"KARANG TENGAH, KARANG TENGAH, KOTA TANGERANG, BANTEN",28,96,161,257
https://kawalpemilu.org#53038,"KARANG TENGAH, KARANG TENGAH, KOTA TANGERANG, BANTEN",29,90,150,240
https://kawalpemilu.org#53038,"KARANG TENGAH, KARANG TENGAH, KOTA TANGERANG, BANTEN",30,127,95,222
https://kawalpemilu.org#53038,"KARANG TENGAH, KARANG TENGAH, KOTA TANGERANG, BANTEN",31,101,123,224
https://kawalpemilu.org#53038,"KARANG TENGAH, KARANG TENGAH, KOTA TANGERANG, BANTEN",32,127,100,227
https://kawalpemilu.org#53038,"KARANG TENGAH, KARANG TENGAH, KOTA TANGERANG, BANTEN",33,101,111,212
https://kawalpemilu.org#53038,"KARANG TENGAH, KARANG TENGAH, KOTA TANGERANG, BANTEN",34,102,121,223
https://kawalpemilu.org#53038,"KARANG TENGAH, KARANG TENGAH, KOTA TANGERANG, BANTEN",35,90,102,192
https://kawalpemilu.org#53038,"KARANG TENGAH, KARANG TENGAH, KOTA TANGERANG, BANTEN",36,100,118,218
https://kawalpemilu.org#53038,"KARANG TENGAH, KARANG TENGAH, KOTA TANGERANG, BANTEN",37,100,116,216
https://kawalpemilu.org#53038,"KARANG TENGAH, KARANG TENGAH, KOTA TANGERANG, BANTEN",38,141,81,222
https://kawalpemilu.org#53038,"KARANG TENGAH, KARANG TENGAH, KOTA TANGERANG, BANTEN",39,116,114,230
https://kawalpemilu.org#53038,"KARANG TENGAH, KARANG TENGAH, KOTA TANGERANG, BANTEN",40,107,107,214
https://kawalpemilu.org#53038,"KARANG TENGAH, KARANG TENGAH, KOTA TANGERANG, BANTEN",41,125,90,215
https://kawalpemilu.org#53038,"KARANG TENGAH, KARANG TENGAH, KOTA TANGERANG, BANTEN",42,111,92,203
https://kawalpemilu.org#53038,"KARANG TENGAH, KARANG TENGAH, KOTA TANGERANG, BANTEN",43,106,155,261
https://kawalpemilu.org#53038,"KARANG TENGAH, KARANG TENGAH, KOTA TANGERANG, BANTEN",44,109,128,237
https://kawalpemilu.org#53038,"KARANG TENGAH, KARANG TENGAH, KOTA TANGERANG, BANTEN",45,110,122,232
https://kawalpemilu.org#53038,"KARANG TENGAH, KARANG TENGAH, KOTA TANGERANG, BANTEN",46,118,109,227
https://kawalpemilu.org#53038,"KARANG TENGAH, KARANG TENGAH, KOTA TANGERANG, BANTEN",47,116,92,208
https://kawalpemilu.org#53038,"KARANG TENGAH, KARANG TENGAH, KOTA TANGERANG, BANTEN",48,84,133,217
https://kawalpemilu.org#53038,"KARANG TENGAH, KARANG TENGAH, KOTA TANGERANG, BANTEN",49,85,135,220
https://kawalpemilu.org#53038,"KARANG TENGAH, KARANG TENGAH, KOTA TANGERANG, BANTEN",50,75,138,213
https://kawalpemilu.org#53038,"KARANG TENGAH, KARANG TENGAH, KOTA TANGERANG, BANTEN",51,88,60,148
https://kawalpemilu.org#53038,"KARANG TENGAH, KARANG TENGAH, KOTA TANGERANG, BANTEN",52,62,88,150
https://kawalpemilu.org#53038,"KARANG TENGAH, KARANG TENGAH, KOTA TANGERANG, BANTEN",53,120,82,202
https://kawalpemilu.org#53038,"KARANG TENGAH, KARANG TENGAH, KOTA TANGERANG, BANTEN",54,96,114,210
https://kawalpemilu.org#53038,"KARANG TENGAH, KARANG TENGAH, KOTA TANGERANG, BANTEN",55,111,88,199
https://kawalpemilu.org#53038,"KARANG TENGAH, KARANG TENGAH, KOTA TANGERANG, BANTEN",57,123,65,188
https://kawalpemilu.org#53038,"KARANG TENGAH, KARANG TENGAH, KOTA TANGERANG, BANTEN",58,163,32,195
https://kawalpemilu.org#53038,"KARANG TENGAH, KARANG TENGAH, KOTA TANGERANG, BANTEN",59,138,32,170
https://kawalpemilu.org#53038,"KARANG TENGAH, KARANG TENGAH, KOTA TANGERANG, BANTEN",60,129,126,255
https://kawalpemilu.org#53038,"KARANG TENGAH, KARANG TENGAH, KOTA TANGERANG, BANTEN",61,74,133,207
https://kawalpemilu.org#53038,"KARANG TENGAH, KARANG TENGAH, KOTA TANGERANG, BANTEN",62,82,124,206
https://kawalpemilu.org#53038,"KARANG TENGAH, KARANG TENGAH, KOTA TANGERANG, BANTEN",63,108,128,236
https://kawalpemilu.org#53038,"KARANG TENGAH, KARANG TENGAH, KOTA TANGERANG, BANTEN",64,91,130,221
https://kawalpemilu.org#53038,"KARANG TENGAH, KARANG TENGAH, KOTA TANGERANG, BANTEN",65,102,124,226
https://kawalpemilu.org#53038,"KARANG TENGAH, KARANG TENGAH, KOTA TANGERANG, BANTEN",66,113,135,248
https://kawalpemilu.org#53038,"KARANG TENGAH, KARANG TENGAH, KOTA TANGERANG, BANTEN",67,102,103,205
https://kawalpemilu.org#53038,"KARANG TENGAH, KARANG TENGAH, KOTA TANGERANG, BANTEN",69,100,137,237
https://kawalpemilu.org#53038,"KARANG TENGAH, KARANG TENGAH, KOTA TANGERANG, BANTEN",70,178,75,253
https://kawalpemilu.org#53039,"KARANG MULYA, KARANG TENGAH, KOTA TANGERANG, BANTEN",1,122,110,232
https://kawalpemilu.org#53039,"KARANG MULYA, KARANG TENGAH, KOTA TANGERANG, BANTEN",2,60,124,184
https://kawalpemilu.org#53039,"KARANG MULYA, KARANG TENGAH, KOTA TANGERANG, BANTEN",3,54,155,209
https://kawalpemilu.org#53039,"KARANG MULYA, KARANG TENGAH, KOTA TANGERANG, BANTEN",4,100,136,236
https://kawalpemilu.org#53039,"KARANG MULYA, KARANG TENGAH, KOTA TANGERANG, BANTEN",5,82,137,219
https://kawalpemilu.org#53039,"KARANG MULYA, KARANG TENGAH, KOTA TANGERANG, BANTEN",6,74,149,223
https://kawalpemilu.org#53039,"KARANG MULYA, KARANG TENGAH, KOTA TANGERANG, BANTEN",7,80,178,258
https://kawalpemilu.org#53039,"KARANG MULYA, KARANG TENGAH, KOTA TANGERANG, BANTEN",8,68,222,290
https://kawalpemilu.org#53039,"KARANG MULYA, KARANG TENGAH, KOTA TANGERANG, BANTEN",9,81,136,217
https://kawalpemilu.org#53039,"KARANG MULYA, KARANG TENGAH, KOTA TANGERANG, BANTEN",10,86,145,231
https://kawalpemilu.org#53039,"KARANG MULYA, KARANG TENGAH, KOTA TANGERANG, BANTEN",11,72,183,255
https://kawalpemilu.org#53039,"KARANG MULYA, KARANG TENGAH, KOTA TANGERANG, BANTEN",12,44,154,198
https://kawalpemilu.org#53039,"KARANG MULYA, KARANG TENGAH, KOTA TANGERANG, BANTEN",13,57,178,235
https://kawalpemilu.org#53039,"KARANG MULYA, KARANG TENGAH, KOTA TANGERANG, BANTEN",14,40,118,158
https://kawalpemilu.org#53039,"KARANG MULYA, KARANG TENGAH, KOTA TANGERANG, BANTEN",15,139,61,200
https://kawalpemilu.org#53039,"KARANG MULYA, KARANG TENGAH, KOTA TANGERANG, BANTEN",16,123,87,210
https://kawalpemilu.org#53039,"KARANG MULYA, KARANG TENGAH, KOTA TANGERANG, BANTEN",17,54,154,208
https://kawalpemilu.org#53039,"KARANG MULYA, KARANG TENGAH, KOTA TANGERANG, BANTEN",18,60,199,259
https://kawalpemilu.org#53039,"KARANG MULYA, KARANG TENGAH, KOTA TANGERANG, BANTEN",19,52,126,178
https://kawalpemilu.org#53039,"KARANG MULYA, KARANG TENGAH, KOTA TANGERANG, BANTEN",20,54,145,199
https://kawalpemilu.org#53039,"KARANG MULYA, KARANG TENGAH, KOTA TANGERANG, BANTEN",22,75,130,205
https://kawalpemilu.org#53039,"KARANG MULYA, KARANG TENGAH, KOTA TANGERANG, BANTEN",23,124,81,205
https://kawalpemilu.org#53039,"KARANG MULYA, KARANG TENGAH, KOTA TANGERANG, BANTEN",24,125,89,214
https://kawalpemilu.org#53039,"KARANG MULYA, KARANG TENGAH, KOTA TANGERANG, BANTEN",25,47,198,245
https://kawalpemilu.org#53039,"KARANG MULYA, KARANG TENGAH, KOTA TANGERANG, BANTEN",26,57,192,249
https://kawalpemilu.org#53039,"KARANG MULYA, KARANG TENGAH, KOTA TANGERANG, BANTEN",27,87,144,231
https://kawalpemilu.org#53039,"KARANG MULYA, KARANG TENGAH, KOTA TANGERANG, BANTEN",28,53,87,140
https://kawalpemilu.org#53039,"KARANG MULYA, KARANG TENGAH, KOTA TANGERANG, BANTEN",29,121,128,249
https://kawalpemilu.org#53039,"KARANG MULYA, KARANG TENGAH, KOTA TANGERANG, BANTEN",30,154,106,260
https://kawalpemilu.org#53039,"KARANG MULYA, KARANG TENGAH, KOTA TANGERANG, BANTEN",31,115,100,215
https://kawalpemilu.org#53039,"KARANG MULYA, KARANG TENGAH, KOTA TANGERANG, BANTEN",32,61,154,215
https://kawalpemilu.org#53039,"KARANG MULYA, KARANG TENGAH, KOTA TANGERANG, BANTEN",33,85,121,206
https://kawalpemilu.org#53039,"KARANG MULYA, KARANG TENGAH, KOTA TANGERANG, BANTEN",34,193,14,207
https://kawalpemilu.org#53039,"KARANG MULYA, KARANG TENGAH, KOTA TANGERANG, BANTEN",35,189,23,212
https://kawalpemilu.org#53039,"KARANG MULYA, KARANG TENGAH, KOTA TANGERANG, BANTEN",36,216,19,235
https://kawalpemilu.org#53039,"KARANG MULYA, KARANG TENGAH, KOTA TANGERANG, BANTEN",37,209,18,227
https://kawalpemilu.org#53039,"KARANG MULYA, KARANG TENGAH, KOTA TANGERANG, BANTEN",38,205,14,219
https://kawalpemilu.org#53039,"KARANG MULYA, KARANG TENGAH, KOTA TANGERANG, BANTEN",39,190,9,199
https://kawalpemilu.org#53039,"KARANG MULYA, KARANG TENGAH, KOTA TANGERANG, BANTEN",40,178,27,205
https://kawalpemilu.org#53039,"KARANG MULYA, KARANG TENGAH, KOTA TANGERANG, BANTEN",41,173,16,189
https://kawalpemilu.org#53040,"PONDOK BAHAR, KARANG TENGAH, KOTA TANGERANG, BANTEN",1,77,187,264
https://kawalpemilu.org#53040,"PONDOK BAHAR, KARANG TENGAH, KOTA TANGERANG, BANTEN",2,96,167,263
https://kawalpemilu.org#53040,"PONDOK BAHAR, KARANG TENGAH, KOTA TANGERANG, BANTEN",3,81,181,263
https://kawalpemilu.org#53040,"PONDOK BAHAR, KARANG TENGAH, KOTA TANGERANG, BANTEN",4,46,228,274
https://kawalpemilu.org#53040,"PONDOK BAHAR, KARANG TENGAH, KOTA TANGERANG, BANTEN",5,39,192,231
https://kawalpemilu.org#53040,"PONDOK BAHAR, KARANG TENGAH, KOTA TANGERANG, BANTEN",6,23,211,234
https://kawalpemilu.org#53040,"PONDOK BAHAR, KARANG TENGAH, KOTA TANGERANG, BANTEN",8,54,157,211
https://kawalpemilu.org#53040,"PONDOK BAHAR, KARANG TENGAH, KOTA TANGERANG, BANTEN",9,33,106,139
https://kawalpemilu.org#53040,"PONDOK BAHAR, KARANG TENGAH, KOTA TANGERANG, BANTEN",10,43,126,169
https://kawalpemilu.org#53040,"PONDOK BAHAR, KARANG TENGAH, KOTA TANGERANG, BANTEN",11,62,161,223
https://kawalpemilu.org#53040,"PONDOK BAHAR, KARANG TENGAH, KOTA TANGERANG, BANTEN",12,71,155,226
https://kawalpemilu.org#53040,"PONDOK BAHAR, KARANG TENGAH, KOTA TANGERANG, BANTEN",13,92,103,195
https://kawalpemilu.org#53040,"PONDOK BAHAR, KARANG TENGAH, KOTA TANGERANG, BANTEN",14,52,121,173
https://kawalpemilu.org#53040,"PONDOK BAHAR, KARANG TENGAH, KOTA TANGERANG, BANTEN",15,84,145,229
https://kawalpemilu.org#53040,"PONDOK BAHAR, KARANG TENGAH, KOTA TANGERANG, BANTEN",16,48,145,193
https://kawalpemilu.org#53040,"PONDOK BAHAR, KARANG TENGAH, KOTA TANGERANG, BANTEN",17,62,126,188
https://kawalpemilu.org#53040,"PONDOK BAHAR, KARANG TENGAH, KOTA TANGERANG, BANTEN",18,63,163,226
https://kawalpemilu.org#53040,"PONDOK BAHAR, KARANG TENGAH, KOTA TANGERANG, BANTEN",19,110,92,202
https://kawalpemilu.org#53040,"PONDOK BAHAR, KARANG TENGAH, KOTA TANGERANG, BANTEN",20,87,86,173
https://kawalpemilu.org#53040,"PONDOK BAHAR, KARANG TENGAH, KOTA TANGERANG, BANTEN",21,84,90,174
https://kawalpemilu.org#53040,"PONDOK BAHAR, KARANG TENGAH, KOTA TANGERANG, BANTEN",22,100,129,229
https://kawalpemilu.org#53040,"PONDOK BAHAR, KARANG TENGAH, KOTA TANGERANG, BANTEN",23,113,126,239
https://kawalpemilu.org#53040,"PONDOK BAHAR, KARANG TENGAH, KOTA TANGERANG, BANTEN",24,84,133,217
https://kawalpemilu.org#53040,"PONDOK BAHAR, KARANG TENGAH, KOTA TANGERANG, BANTEN",25,92,107,199
https://kawalpemilu.org#53040,"PONDOK BAHAR, KARANG TENGAH, KOTA TANGERANG, BANTEN",26,87,112,199
https://kawalpemilu.org#53040,"PONDOK BAHAR, KARANG TENGAH, KOTA TANGERANG, BANTEN",27,76,122,198
https://kawalpemilu.org#53040,"PONDOK BAHAR, KARANG TENGAH, KOTA TANGERANG, BANTEN",28,89,66,155
https://kawalpemilu.org#53040,"PONDOK BAHAR, KARANG TENGAH, KOTA TANGERANG, BANTEN",29,96,88,184
https://kawalpemilu.org#53040,"PONDOK BAHAR, KARANG TENGAH, KOTA TANGERANG, BANTEN",30,87,121,208
https://kawalpemilu.org#53040,"PONDOK BAHAR, KARANG TENGAH, KOTA TANGERANG, BANTEN",31,72,140,212
https://kawalpemilu.org#53040,"PONDOK BAHAR, KARANG TENGAH, KOTA TANGERANG, BANTEN",32,81,124,205
https://kawalpemilu.org#53040,"PONDOK BAHAR, KARANG TENGAH, KOTA TANGERANG, BANTEN",33,107,120,227
https://kawalpemilu.org#53040,"PONDOK BAHAR, KARANG TENGAH, KOTA TANGERANG, BANTEN",34,129,99,228
https://kawalpemilu.org#53040,"PONDOK BAHAR, KARANG TENGAH, KOTA TANGERANG, BANTEN",35,89,144,238
https://kawalpemilu.org#53040,"PONDOK BAHAR, KARANG TENGAH, KOTA TANGERANG, BANTEN",36,125,93,218
https://kawalpemilu.org#53040,"PONDOK BAHAR, KARANG TENGAH, KOTA TANGERANG, BANTEN",37,120,133,253
https://kawalpemilu.org#53040,"PONDOK BAHAR, KARANG TENGAH, KOTA TANGERANG, BANTEN",38,111,127,238
https://kawalpemilu.org#53041,"PONDOK PUCUNG, KARANG TENGAH, KOTA TANGERANG, BANTEN",1,67,129,196
https://kawalpemilu.org#53041,"PONDOK PUCUNG, KARANG TENGAH, KOTA TANGERANG, BANTEN",2,56,135,191
https://kawalpemilu.org#53041,"PONDOK PUCUNG, KARANG TENGAH, KOTA TANGERANG, BANTEN",3,57,162,219
https://kawalpemilu.org#53041,"PONDOK PUCUNG, KARANG TENGAH, KOTA TANGERANG, BANTEN",4,68,97,165
https://kawalpemilu.org#53041,"PONDOK PUCUNG, KARANG TENGAH, KOTA TANGERANG, BANTEN",5,97,103,200
https://kawalpemilu.org#53041,"PONDOK PUCUNG, KARANG TENGAH, KOTA TANGERANG, BANTEN",6,74,69,143
https://kawalpemilu.org#53041,"PONDOK PUCUNG, KARANG TENGAH, KOTA TANGERANG, BANTEN",7,109,124,233
https://kawalpemilu.org#53041,"PONDOK PUCUNG, KARANG TENGAH, KOTA TANGERANG, BANTEN",8,33,99,132
https://kawalpemilu.org#53041,"PONDOK PUCUNG, KARANG TENGAH, KOTA TANGERANG, BANTEN",9,94,141,235
https://kawalpemilu.org#53041,"PONDOK PUCUNG, KARANG TENGAH, KOTA TANGERANG, BANTEN",10,96,148,244
https://kawalpemilu.org#53041,"PONDOK PUCUNG, KARANG TENGAH, KOTA TANGERANG, BANTEN",11,94,115,209
https://kawalpemilu.org#53041,"PONDOK PUCUNG, KARANG TENGAH, KOTA TANGERANG, BANTEN",12,95,100,195
https://kawalpemilu.org#53041,"PONDOK PUCUNG, KARANG TENGAH, KOTA TANGERANG, BANTEN",13,81,111,192
https://kawalpemilu.org#53041,"PONDOK PUCUNG, KARANG TENGAH, KOTA TANGERANG, BANTEN",14,93,179,272
https://kawalpemilu.org#53041,"PONDOK PUCUNG, KARANG TENGAH, KOTA TANGERANG, BANTEN",15,61,133,194
https://kawalpemilu.org#53041,"PONDOK PUCUNG, KARANG TENGAH, KOTA TANGERANG, BANTEN",16,24,99,123
https://kawalpemilu.org#53041,"PONDOK PUCUNG, KARANG TENGAH, KOTA TANGERANG, BANTEN",17,49,95,144
https://kawalpemilu.org#53041,"PONDOK PUCUNG, KARANG TENGAH, KOTA TANGERANG, BANTEN",18,58,153,211
https://kawalpemilu.org#53041,"PONDOK PUCUNG, KARANG TENGAH, KOTA TANGERANG, BANTEN",19,34,129,163
https://kawalpemilu.org#53041,"PONDOK PUCUNG, KARANG TENGAH, KOTA TANGERANG, BANTEN",20,43,102,145
https://kawalpemilu.org#53041,"PONDOK PUCUNG, KARANG TENGAH, KOTA TANGERANG, BANTEN",21,36,110,146
https://kawalpemilu.org#53041,"PONDOK PUCUNG, KARANG TENGAH, KOTA TANGERANG, BANTEN",22,112,111,223
https://kawalpemilu.org#53041,"PONDOK PUCUNG, KARANG TENGAH, KOTA TANGERANG, BANTEN",23,88,138,226
https://kawalpemilu.org#53041,"PONDOK PUCUNG, KARANG TENGAH, KOTA TANGERANG, BANTEN",24,46,156,202
https://kawalpemilu.org#53041,"PONDOK PUCUNG, KARANG TENGAH, KOTA TANGERANG, BANTEN",25,54,172,226
https://kawalpemilu.org#53041,"PONDOK PUCUNG, KARANG TENGAH, KOTA TANGERANG, BANTEN",26,55,212,267
https://kawalpemilu.org#53041,"PONDOK PUCUNG, KARANG TENGAH, KOTA TANGERANG, BANTEN",27,84,170,254
https://kawalpemilu.org#53041,"PONDOK PUCUNG, KARANG TENGAH, KOTA TANGERANG, BANTEN",28,118,81,199
https://kawalpemilu.org#53041,"PONDOK PUCUNG, KARANG TENGAH, KOTA TANGERANG, BANTEN",29,132,73,205
https://kawalpemilu.org#53041,"PONDOK PUCUNG, KARANG TENGAH, KOTA TANGERANG, BANTEN",30,154,77,231
https://kawalpemilu.org#53041,"PONDOK PUCUNG, KARANG TENGAH, KOTA TANGERANG, BANTEN",31,106,67,173
https://kawalpemilu.org#53041,"PONDOK PUCUNG, KARANG TENGAH, KOTA TANGERANG, BANTEN",32,127,92,219
https://kawalpemilu.org#53041,"PONDOK PUCUNG, KARANG TENGAH, KOTA TANGERANG, BANTEN",33,132,14,146
https://kawalpemilu.org#53041,"PONDOK PUCUNG, KARANG TENGAH, KOTA TANGERANG, BANTEN",34,157,70,227
https://kawalpemilu.org#53041,"PONDOK PUCUNG, KARANG TENGAH, KOTA TANGERANG, BANTEN",35,185,20,205
https://kawalpemilu.org#53041,"PONDOK PUCUNG, KARANG TENGAH, KOTA TANGERANG, BANTEN",36,206,8,214
https://kawalpemilu.org#53041,"PONDOK PUCUNG, KARANG TENGAH, KOTA TANGERANG, BANTEN",37,230,14,244
https://kawalpemilu.org#53041,"PONDOK PUCUNG, KARANG TENGAH, KOTA TANGERANG, BANTEN",38,233,24,257
https://kawalpemilu.org#53042,"KARANG TIMUR, KARANG TENGAH, KOTA TANGERANG, BANTEN",1,79,129,208
https://kawalpemilu.org#53042,"KARANG TIMUR, KARANG TENGAH, KOTA TANGERANG, BANTEN",2,44,175,219
https://kawalpemilu.org#53042,"KARANG TIMUR, KARANG TENGAH, KOTA TANGERANG, BANTEN",3,68,128,196
https://kawalpemilu.org#53042,"KARANG TIMUR, KARANG TENGAH, KOTA TANGERANG, BANTEN",4,64,196,260
https://kawalpemilu.org#53042,"KARANG TIMUR, KARANG TENGAH, KOTA TANGERANG, BANTEN",5,67,135,202
https://kawalpemilu.org#53042,"KARANG TIMUR, KARANG TENGAH, KOTA TANGERANG, BANTEN",6,146,87,233
https://kawalpemilu.org#53042,"KARANG TIMUR, KARANG TENGAH, KOTA TANGERANG, BANTEN",7,129,132,261
https://kawalpemilu.org#53042,"KARANG TIMUR, KARANG TENGAH, KOTA TANGERANG, BANTEN",8,93,102,195
https://kawalpemilu.org#53042,"KARANG TIMUR, KARANG TENGAH, KOTA TANGERANG, BANTEN",9,94,125,219
https://kawalpemilu.org#53042,"KARANG TIMUR, KARANG TENGAH, KOTA TANGERANG, BANTEN",10,117,109,226
https://kawalpemilu.org#53042,"KARANG TIMUR, KARANG TENGAH, KOTA TANGERANG, BANTEN",11,110,105,215
https://kawalpemilu.org#53042,"KARANG TIMUR, KARANG TENGAH, KOTA TANGERANG, BANTEN",12,135,120,255
https://kawalpemilu.org#53042,"KARANG TIMUR, KARANG TENGAH, KOTA TANGERANG, BANTEN",13,110,75,185
https://kawalpemilu.org#53042,"KARANG TIMUR, KARANG TENGAH, KOTA TANGERANG, BANTEN",14,100,61,161
https://kawalpemilu.org#53042,"KARANG TIMUR, KARANG TENGAH, KOTA TANGERANG, BANTEN",15,99,73,172
https://kawalpemilu.org#53042,"KARANG TIMUR, KARANG TENGAH, KOTA TANGERANG, BANTEN",16,78,123,201
https://kawalpemilu.org#53042,"KARANG TIMUR, KARANG TENGAH, KOTA TANGERANG, BANTEN",17,125,105,230
https://kawalpemilu.org#53042,"KARANG TIMUR, KARANG TENGAH, KOTA TANGERANG, BANTEN",18,78,129,207
https://kawalpemilu.org#53042,"KARANG TIMUR, KARANG TENGAH, KOTA TANGERANG, BANTEN",19,93,92,185
https://kawalpemilu.org#53042,"KARANG TIMUR, KARANG TENGAH, KOTA TANGERANG, BANTEN",20,101,115,216
https://kawalpemilu.org#53042,"KARANG TIMUR, KARANG TENGAH, KOTA TANGERANG, BANTEN",21,92,91,183
https://kawalpemilu.org#53042,"KARANG TIMUR, KARANG TENGAH, KOTA TANGERANG, BANTEN",22,111,112,223
https://kawalpemilu.org#53042,"KARANG TIMUR, KARANG TENGAH, KOTA TANGERANG, BANTEN",23,107,93,200
https://kawalpemilu.org#53042,"KARANG TIMUR, KARANG TENGAH, KOTA TANGERANG, BANTEN",24,127,95,222
https://kawalpemilu.org#53042,"KARANG TIMUR, KARANG TENGAH, KOTA TANGERANG, BANTEN",25,105,96,201
https://kawalpemilu.org#53042,"KARANG TIMUR, KARANG TENGAH, KOTA TANGERANG, BANTEN",26,82,102,184
https://kawalpemilu.org#53042,"KARANG TIMUR, KARANG TENGAH, KOTA TANGERANG, BANTEN",27,84,94,178
https://kawalpemilu.org#53042,"KARANG TIMUR, KARANG TENGAH, KOTA TANGERANG, BANTEN",28,185,19,204
https://kawalpemilu.org#53042,"KARANG TIMUR, KARANG TENGAH, KOTA TANGERANG, BANTEN",29,147,84,231
https://kawalpemilu.org#53042,"KARANG TIMUR, KARANG TENGAH, KOTA TANGERANG, BANTEN",30,94,129,223
https://kawalpemilu.org#53042,"KARANG TIMUR, KARANG TENGAH, KOTA TANGERANG, BANTEN",31,93,124,217
https://kawalpemilu.org#53042,"KARANG TIMUR, KARANG TENGAH, KOTA TANGERANG, BANTEN",32,75,120,195
https://kawalpemilu.org#53042,"KARANG TIMUR, KARANG TENGAH, KOTA TANGERANG, BANTEN",33,92,129,221
https://kawalpemilu.org#53042,"KARANG TIMUR, KARANG TENGAH, KOTA TANGERANG, BANTEN",34,105,81,186
https://kawalpemilu.org#53042,"KARANG TIMUR, KARANG TENGAH, KOTA TANGERANG, BANTEN",35,116,85,201
https://kawalpemilu.org#53042,"KARANG TIMUR, KARANG TENGAH, KOTA TANGERANG, BANTEN",36,155,79,234
https://kawalpemilu.org#53042,"KARANG TIMUR, KARANG TENGAH, KOTA TANGERANG, BANTEN",37,107,54,161
https://kawalpemilu.org#53042,"KARANG TIMUR, KARANG TENGAH, KOTA TANGERANG, BANTEN",38,87,49,136
https://kawalpemilu.org#53042,"KARANG TIMUR, KARANG TENGAH, KOTA TANGERANG, BANTEN",39,68,85,153
https://kawalpemilu.org#53042,"KARANG TIMUR, KARANG TENGAH, KOTA TANGERANG, BANTEN",40,62,110,172
https://kawalpemilu.org#53042,"KARANG TIMUR, KARANG TENGAH, KOTA TANGERANG, BANTEN",41,73,101,174
https://kawalpemilu.org#53042,"KARANG TIMUR, KARANG TENGAH, KOTA TANGERANG, BANTEN",42,80,94,174
https://kawalpemilu.org#53042,"KARANG TIMUR, KARANG TENGAH, KOTA TANGERANG, BANTEN",43,82,78,160
https://kawalpemilu.org#53042,"KARANG TIMUR, KARANG TENGAH, KOTA TANGERANG, BANTEN",44,66,74,140
https://kawalpemilu.org#53042,"KARANG TIMUR, KARANG TENGAH, KOTA TANGERANG, BANTEN",45,60,87,147
https://kawalpemilu.org#53042,"KARANG TIMUR, KARANG TENGAH, KOTA TANGERANG, BANTEN",46,114,80,194
https://kawalpemilu.org#53042,"KARANG TIMUR, KARANG TENGAH, KOTA TANGERANG, BANTEN",47,73,67,140
https://kawalpemilu.org#53042,"KARANG TIMUR, KARANG TENGAH, KOTA TANGERANG, BANTEN",48,105,148,253
https://kawalpemilu.org#53042,"KARANG TIMUR, KARANG TENGAH, KOTA TANGERANG, BANTEN",49,81,93,174
https://kawalpemilu.org#53042,"KARANG TIMUR, KARANG TENGAH, KOTA TANGERANG, BANTEN",50,66,69,135
https://kawalpemilu.org#53043,"PADURENAN, KARANG TENGAH, KOTA TANGERANG, BANTEN",1,157,85,242
https://kawalpemilu.org#53043,"PADURENAN, KARANG TENGAH, KOTA TANGERANG, BANTEN",2,143,115,258
https://kawalpemilu.org#53043,"PADURENAN, KARANG TENGAH, KOTA TANGERANG, BANTEN",4,103,126,229
https://kawalpemilu.org#53043,"PADURENAN, KARANG TENGAH, KOTA TANGERANG, BANTEN",5,82,111,193
https://kawalpemilu.org#53043,"PADURENAN, KARANG TENGAH, KOTA TANGERANG, BANTEN",6,72,44,116
https://kawalpemilu.org#53043,"PADURENAN, KARANG TENGAH, KOTA TANGERANG, BANTEN",7,90,91,181
https://kawalpemilu.org#53043,"PADURENAN, KARANG TENGAH, KOTA TANGERANG, BANTEN",8,72,77,149
https://kawalpemilu.org#53043,"PADURENAN, KARANG TENGAH, KOTA TANGERANG, BANTEN",9,63,103,166
https://kawalpemilu.org#53043,"PADURENAN, KARANG TENGAH, KOTA TANGERANG, BANTEN",10,89,66,155
https://kawalpemilu.org#53043,"PADURENAN, KARANG TENGAH, KOTA TANGERANG, BANTEN",11,60,92,152
https://kawalpemilu.org#53043,"PADURENAN, KARANG TENGAH, KOTA TANGERANG, BANTEN",12,118,147,265
https://kawalpemilu.org#53043,"PADURENAN, KARANG TENGAH, KOTA TANGERANG, BANTEN",13,109,148,257
https://kawalpemilu.org#53043,"PADURENAN, KARANG TENGAH, KOTA TANGERANG, BANTEN",14,108,145,253
https://kawalpemilu.org#53043,"PADURENAN, KARANG TENGAH, KOTA TANGERANG, BANTEN",15,107,88,195
https://kawalpemilu.org#53043,"PADURENAN, KARANG TENGAH, KOTA TANGERANG, BANTEN",16,119,72,191
https://kawalpemilu.org#53043,"PADURENAN, KARANG TENGAH, KOTA TANGERANG, BANTEN",17,89,83,172
https://kawalpemilu.org#53043,"PADURENAN, KARANG TENGAH, KOTA TANGERANG, BANTEN",18,84,108,192
https://kawalpemilu.org#53043,"PADURENAN, KARANG TENGAH, KOTA TANGERANG, BANTEN",19,101,116,217
https://kawalpemilu.org#53043,"PADURENAN, KARANG TENGAH, KOTA TANGERANG, BANTEN",20,93,162,255
https://kawalpemilu.org#53043,"PADURENAN, KARANG TENGAH, KOTA TANGERANG, BANTEN",21,77,154,231
https://kawalpemilu.org#53043,"PADURENAN, KARANG TENGAH, KOTA TANGERANG, BANTEN",22,103,164,267
https://kawalpemilu.org#53043,"PADURENAN, KARANG TENGAH, KOTA TANGERANG, BANTEN",23,85,133,218
https://kawalpemilu.org#53043,"PADURENAN, KARANG TENGAH, KOTA TANGERANG, BANTEN",24,68,119,187
https://kawalpemilu.org#53043,"PADURENAN, KARANG TENGAH, KOTA TANGERANG, BANTEN",25,63,164,227
https://kawalpemilu.org#53043,"PADURENAN, KARANG TENGAH, KOTA TANGERANG, BANTEN",26,89,120,209
https://kawalpemilu.org#53043,"PADURENAN, KARANG TENGAH, KOTA TANGERANG, BANTEN",27,98,128,226
https://kawalpemilu.org#53043,"PADURENAN, KARANG TENGAH, KOTA TANGERANG, BANTEN",28,52,139,191
https://kawalpemilu.org#53043,"PADURENAN, KARANG TENGAH, KOTA TANGERANG, BANTEN",29,118,50,168
https://kawalpemilu.org#53043,"PADURENAN, KARANG TENGAH, KOTA TANGERANG, BANTEN",30,143,102,245
https://kawalpemilu.org#53043,"PADURENAN, KARANG TENGAH, KOTA TANGERANG, BANTEN",31,117,108,225
https://kawalpemilu.org#53043,"PADURENAN, KARANG TENGAH, KOTA TANGERANG, BANTEN",32,104,131,235
https://kawalpemilu.org#53043,"PADURENAN, KARANG TENGAH, KOTA TANGERANG, BANTEN",33,164,99,263
https://kawalpemilu.org#53043,"PADURENAN, KARANG TENGAH, KOTA TANGERANG, BANTEN",34,109,94,203
https://kawalpemilu.org#53043,"PADURENAN, KARANG TENGAH, KOTA TANGERANG, BANTEN",35,137,58,195
https://kawalpemilu.org#53043,"PADURENAN, KARANG TENGAH, KOTA TANGERANG, BANTEN",36,165,88,253
https://kawalpemilu.org#53043,"PADURENAN, KARANG TENGAH, KOTA TANGERANG, BANTEN",37,78,141,219
https://kawalpemilu.org#53043,"PADURENAN, KARANG TENGAH, KOTA TANGERANG, BANTEN",38,54,162,216
https://kawalpemilu.org#53043,"PADURENAN, KARANG TENGAH, KOTA TANGERANG, BANTEN",39,67,139,206
https://kawalpemilu.org#53043,"PADURENAN, KARANG TENGAH, KOTA TANGERANG, BANTEN",40,50,120,170
https://kawalpemilu.org#53043,"PADURENAN, KARANG TENGAH, KOTA TANGERANG, BANTEN",41,99,179,278
https://kawalpemilu.org#53043,"PADURENAN, KARANG TENGAH, KOTA TANGERANG, BANTEN",42,66,151,217
https://kawalpemilu.org#53043,"PADURENAN, KARANG TENGAH, KOTA TANGERANG, BANTEN",43,68,148,216
https://kawalpemilu.org#53043,"PADURENAN, KARANG TENGAH, KOTA TANGERANG, BANTEN",44,75,124,199
https://kawalpemilu.org#53043,"PADURENAN, KARANG TENGAH, KOTA TANGERANG, BANTEN",45,31,76,107
https://kawalpemilu.org#53043,"PADURENAN, KARANG TENGAH, KOTA TANGERANG, BANTEN",46,60,144,204
https://kawalpemilu.org#53043,"PADURENAN, KARANG TENGAH, KOTA TANGERANG, BANTEN",47,48,200,248
https://kawalpemilu.org#53043,"PADURENAN, KARANG TENGAH, KOTA TANGERANG, BANTEN",48,53,193,246
https://kawalpemilu.org#53043,"PADURENAN, KARANG TENGAH, KOTA TANGERANG, BANTEN",49,60,118,178
https://kawalpemilu.org#53043,"PADURENAN, KARANG TENGAH, KOTA TANGERANG, BANTEN",50,74,98,172
https://kawalpemilu.org#53043,"PADURENAN, KARANG TENGAH, KOTA TANGERANG, BANTEN",51,146,30,176
https://kawalpemilu.org#53043,"PADURENAN, KARANG TENGAH, KOTA TANGERANG, BANTEN",52,76,156,232
https://kawalpemilu.org#53043,"PADURENAN, KARANG TENGAH, KOTA TANGERANG, BANTEN",53,93,135,228
https://kawalpemilu.org#53043,"PADURENAN, KARANG TENGAH, KOTA TANGERANG, BANTEN",54,98,52,150
https://kawalpemilu.org#53043,"PADURENAN, KARANG TENGAH, KOTA TANGERANG, BANTEN",55,137,66,203
https://kawalpemilu.org#53043,"PADURENAN, KARANG TENGAH, KOTA TANGERANG, BANTEN",56,110,58,168
https://kawalpemilu.org#53043,"PADURENAN, KARANG TENGAH, KOTA TANGERANG, BANTEN",57,160,86,246
https://kawalpemilu.org#53044,"PARUNG JAYA, KARANG TENGAH, KOTA TANGERANG, BANTEN",1,73,168,241
https://kawalpemilu.org#53044,"PARUNG JAYA, KARANG TENGAH, KOTA TANGERANG, BANTEN",2,55,195,250
https://kawalpemilu.org#53044,"PARUNG JAYA, KARANG TENGAH, KOTA TANGERANG, BANTEN",3,75,154,229
https://kawalpemilu.org#53044,"PARUNG JAYA, KARANG TENGAH, KOTA TANGERANG, BANTEN",4,57,191,248
https://kawalpemilu.org#53044,"PARUNG JAYA, KARANG TENGAH, KOTA TANGERANG, BANTEN",5,59,196,255
https://kawalpemilu.org#53044,"PARUNG JAYA, KARANG TENGAH, KOTA TANGERANG, BANTEN",6,29,158,187
https://kawalpemilu.org#53044,"PARUNG JAYA, KARANG TENGAH, KOTA TANGERANG, BANTEN",7,22,171,193
https://kawalpemilu.org#53044,"PARUNG JAYA, KARANG TENGAH, KOTA TANGERANG, BANTEN",8,27,156,183
https://kawalpemilu.org#53044,"PARUNG JAYA, KARANG TENGAH, KOTA TANGERANG, BANTEN",9,54,171,225
https://kawalpemilu.org#53044,"PARUNG JAYA, KARANG TENGAH, KOTA TANGERANG, BANTEN",10,52,160,212
https://kawalpemilu.org#53044,"PARUNG JAYA, KARANG TENGAH, KOTA TANGERANG, BANTEN",11,46,131,177
https://kawalpemilu.org#53044,"PARUNG JAYA, KARANG TENGAH, KOTA TANGERANG, BANTEN",12,58,159,217
https://kawalpemilu.org#53044,"PARUNG JAYA, KARANG TENGAH, KOTA TANGERANG, BANTEN",13,84,157,241
https://kawalpemilu.org#53044,"PARUNG JAYA, KARANG TENGAH, KOTA TANGERANG, BANTEN",14,37,165,202
https://kawalpemilu.org#53044,"PARUNG JAYA, KARANG TENGAH, KOTA TANGERANG, BANTEN",15,88,151,239
https://kawalpemilu.org#53044,"PARUNG JAYA, KARANG TENGAH, KOTA TANGERANG, BANTEN",16,61,169,230
https://kawalpemilu.org#53044,"PARUNG JAYA, KARANG TENGAH, KOTA TANGERANG, BANTEN",17,139,13,152
https://kawalpemilu.org#53046,"LARANGAN UTARA, LARANGAN, KOTA TANGERANG, BANTEN",1,120,133,253
https://kawalpemilu.org#53046,"LARANGAN UTARA, LARANGAN, KOTA TANGERANG, BANTEN",2,107,111,218
https://kawalpemilu.org#53046,"LARANGAN UTARA, LARANGAN, KOTA TANGERANG, BANTEN",3,153,79,232
https://kawalpemilu.org#53046,"LARANGAN UTARA, LARANGAN, KOTA TANGERANG, BANTEN",4,150,79,229
https://kawalpemilu.org#53046,"LARANGAN UTARA, LARANGAN, KOTA TANGERANG, BANTEN",5,151,79,230
https://kawalpemilu.org#53046,"LARANGAN UTARA, LARANGAN, KOTA TANGERANG, BANTEN",6,118,78,196
https://kawalpemilu.org#53046,"LARANGAN UTARA, LARANGAN, KOTA TANGERANG, BANTEN",7,125,97,222
https://kawalpemilu.org#53046,"LARANGAN UTARA, LARANGAN, KOTA TANGERANG, BANTEN",9,152,113,265
https://kawalpemilu.org#53046,"LARANGAN UTARA, LARANGAN, KOTA TANGERANG, BANTEN",10,146,91,237
https://kawalpemilu.org#53046,"LARANGAN UTARA, LARANGAN, KOTA TANGERANG, BANTEN",11,134,127,261
https://kawalpemilu.org#53046,"LARANGAN UTARA, LARANGAN, KOTA TANGERANG, BANTEN",12,175,76,251
https://kawalpemilu.org#53046,"LARANGAN UTARA, LARANGAN, KOTA TANGERANG, BANTEN",13,155,107,262
https://kawalpemilu.org#53046,"LARANGAN UTARA, LARANGAN, KOTA TANGERANG, BANTEN",14,133,114,247
https://kawalpemilu.org#53046,"LARANGAN UTARA, LARANGAN, KOTA TANGERANG, BANTEN",15,132,108,240
https://kawalpemilu.org#53046,"LARANGAN UTARA, LARANGAN, KOTA TANGERANG, BANTEN",16,136,109,245
https://kawalpemilu.org#53046,"LARANGAN UTARA, LARANGAN, KOTA TANGERANG, BANTEN",17,115,90,205
https://kawalpemilu.org#53046,"LARANGAN UTARA, LARANGAN, KOTA TANGERANG, BANTEN",18,113,99,212
https://kawalpemilu.org#53046,"LARANGAN UTARA, LARANGAN, KOTA TANGERANG, BANTEN",19,124,100,224
https://kawalpemilu.org#53046,"LARANGAN UTARA, LARANGAN, KOTA TANGERANG, BANTEN",20,134,75,209
https://kawalpemilu.org#53046,"LARANGAN UTARA, LARANGAN, KOTA TANGERANG, BANTEN",21,99,105,204
https://kawalpemilu.org#53046,"LARANGAN UTARA, LARANGAN, KOTA TANGERANG, BANTEN",22,97,99,196
https://kawalpemilu.org#53046,"LARANGAN UTARA, LARANGAN, KOTA TANGERANG, BANTEN",23,97,119,216
https://kawalpemilu.org#53046,"LARANGAN UTARA, LARANGAN, KOTA TANGERANG, BANTEN",24,88,122,210
https://kawalpemilu.org#53046,"LARANGAN UTARA, LARANGAN, KOTA TANGERANG, BANTEN",26,106,97,203
https://kawalpemilu.org#53046,"LARANGAN UTARA, LARANGAN, KOTA TANGERANG, BANTEN",27,119,101,220
https://kawalpemilu.org#53046,"LARANGAN UTARA, LARANGAN, KOTA TANGERANG, BANTEN",28,97,132,229
https://kawalpemilu.org#53046,"LARANGAN UTARA, LARANGAN, KOTA TANGERANG, BANTEN",30,99,110,209
https://kawalpemilu.org#53046,"LARANGAN UTARA, LARANGAN, KOTA TANGERANG, BANTEN",31,96,113,209
https://kawalpemilu.org#53046,"LARANGAN UTARA, LARANGAN, KOTA TANGERANG, BANTEN",32,98,99,197
https://kawalpemilu.org#53046,"LARANGAN UTARA, LARANGAN, KOTA TANGERANG, BANTEN",33,113,98,211
https://kawalpemilu.org#53046,"LARANGAN UTARA, LARANGAN, KOTA TANGERANG, BANTEN",34,85,131,216
https://kawalpemilu.org#53046,"LARANGAN UTARA, LARANGAN, KOTA TANGERANG, BANTEN",35,83,119,202
https://kawalpemilu.org#53046,"LARANGAN UTARA, LARANGAN, KOTA TANGERANG, BANTEN",36,102,117,219
https://kawalpemilu.org#53046,"LARANGAN UTARA, LARANGAN, KOTA TANGERANG, BANTEN",37,89,143,232
https://kawalpemilu.org#53046,"LARANGAN UTARA, LARANGAN, KOTA TANGERANG, BANTEN",38,153,99,252
https://kawalpemilu.org#53046,"LARANGAN UTARA, LARANGAN, KOTA TANGERANG, BANTEN",39,112,107,219
https://kawalpemilu.org#53046,"LARANGAN UTARA, LARANGAN, KOTA TANGERANG, BANTEN",40,104,139,243
https://kawalpemilu.org#53046,"LARANGAN UTARA, LARANGAN, KOTA TANGERANG, BANTEN",41,139,86,225
https://kawalpemilu.org#53046,"LARANGAN UTARA, LARANGAN, KOTA TANGERANG, BANTEN",42,102,136,238
https://kawalpemilu.org#53046,"LARANGAN UTARA, LARANGAN, KOTA TANGERANG, BANTEN",43,95,108,203
https://kawalpemilu.org#53046,"LARANGAN UTARA, LARANGAN, KOTA TANGERANG, BANTEN",44,104,111,215
https://kawalpemilu.org#53046,"LARANGAN UTARA, LARANGAN, KOTA TANGERANG, BANTEN",45,128,123,251
https://kawalpemilu.org#53046,"LARANGAN UTARA, LARANGAN, KOTA TANGERANG, BANTEN",46,116,115,231
https://kawalpemilu.org#53046,"LARANGAN UTARA, LARANGAN, KOTA TANGERANG, BANTEN",47,89,141,230
https://kawalpemilu.org#53046,"LARANGAN UTARA, LARANGAN, KOTA TANGERANG, BANTEN",48,111,116,227
https://kawalpemilu.org#53046,"LARANGAN UTARA, LARANGAN, KOTA TANGERANG, BANTEN",49,93,108,201
https://kawalpemilu.org#53046,"LARANGAN UTARA, LARANGAN, KOTA TANGERANG, BANTEN",50,91,133,224
https://kawalpemilu.org#53046,"LARANGAN UTARA, LARANGAN, KOTA TANGERANG, BANTEN",52,77,140,217
https://kawalpemilu.org#53046,"LARANGAN UTARA, LARANGAN, KOTA TANGERANG, BANTEN",53,100,125,225
https://kawalpemilu.org#53046,"LARANGAN UTARA, LARANGAN, KOTA TANGERANG, BANTEN",54,102,115,217
https://kawalpemilu.org#53046,"LARANGAN UTARA, LARANGAN, KOTA TANGERANG, BANTEN",55,134,124,258
https://kawalpemilu.org#53046,"LARANGAN UTARA, LARANGAN, KOTA TANGERANG, BANTEN",56,125,101,226
https://kawalpemilu.org#53046,"LARANGAN UTARA, LARANGAN, KOTA TANGERANG, BANTEN",58,126,157,283
https://kawalpemilu.org#53046,"LARANGAN UTARA, LARANGAN, KOTA TANGERANG, BANTEN",59,120,115,235
https://kawalpemilu.org#53046,"LARANGAN UTARA, LARANGAN, KOTA TANGERANG, BANTEN",60,130,103,233
https://kawalpemilu.org#53046,"LARANGAN UTARA, LARANGAN, KOTA TANGERANG, BANTEN",61,130,114,244
https://kawalpemilu.org#53047,"LARANGAN SELATAN, LARANGAN, KOTA TANGERANG, BANTEN",1,88,115,203
https://kawalpemilu.org#53047,"LARANGAN SELATAN, LARANGAN, KOTA TANGERANG, BANTEN",2,86,119,205
https://kawalpemilu.org#53047,"LARANGAN SELATAN, LARANGAN, KOTA TANGERANG, BANTEN",3,119,74,193
https://kawalpemilu.org#53047,"LARANGAN SELATAN, LARANGAN, KOTA TANGERANG, BANTEN",4,121,74,195
https://kawalpemilu.org#53047,"LARANGAN SELATAN, LARANGAN, KOTA TANGERANG, BANTEN",5,149,90,239
https://kawalpemilu.org#53047,"LARANGAN SELATAN, LARANGAN, KOTA TANGERANG, BANTEN",6,173,124,297
https://kawalpemilu.org#53047,"LARANGAN SELATAN, LARANGAN, KOTA TANGERANG, BANTEN",7,122,132,254
https://kawalpemilu.org#53047,"LARANGAN SELATAN, LARANGAN, KOTA TANGERANG, BANTEN",8,131,118,249
https://kawalpemilu.org#53047,"LARANGAN SELATAN, LARANGAN, KOTA TANGERANG, BANTEN",9,107,110,217
https://kawalpemilu.org#53047,"LARANGAN SELATAN, LARANGAN, KOTA TANGERANG, BANTEN",10,152,106,258
https://kawalpemilu.org#53047,"LARANGAN SELATAN, LARANGAN, KOTA TANGERANG, BANTEN",11,123,87,210
https://kawalpemilu.org#53047,"LARANGAN SELATAN, LARANGAN, KOTA TANGERANG, BANTEN",12,70,117,187
https://kawalpemilu.org#53047,"LARANGAN SELATAN, LARANGAN, KOTA TANGERANG, BANTEN",13,107,116,223
https://kawalpemilu.org#53047,"LARANGAN SELATAN, LARANGAN, KOTA TANGERANG, BANTEN",14,122,135,257
https://kawalpemilu.org#53047,"LARANGAN SELATAN, LARANGAN, KOTA TANGERANG, BANTEN",15,117,153,270
https://kawalpemilu.org#53047,"LARANGAN SELATAN, LARANGAN, KOTA TANGERANG, BANTEN",16,125,107,232
https://kawalpemilu.org#53047,"LARANGAN SELATAN, LARANGAN, KOTA TANGERANG, BANTEN",17,122,109,231
https://kawalpemilu.org#53047,"LARANGAN SELATAN, LARANGAN, KOTA TANGERANG, BANTEN",18,54,98,152
https://kawalpemilu.org#53047,"LARANGAN SELATAN, LARANGAN, KOTA TANGERANG, BANTEN",19,53,126,179
https://kawalpemilu.org#53047,"LARANGAN SELATAN, LARANGAN, KOTA TANGERANG, BANTEN",20,96,117,213
https://kawalpemilu.org#53047,"LARANGAN SELATAN, LARANGAN, KOTA TANGERANG, BANTEN",21,163,111,274
https://kawalpemilu.org#53047,"LARANGAN SELATAN, LARANGAN, KOTA TANGERANG, BANTEN",22,92,133,225
https://kawalpemilu.org#53047,"LARANGAN SELATAN, LARANGAN, KOTA TANGERANG, BANTEN",23,81,131,212
https://kawalpemilu.org#53047,"LARANGAN SELATAN, LARANGAN, KOTA TANGERANG, BANTEN",24,98,108,206
https://kawalpemilu.org#53047,"LARANGAN SELATAN, LARANGAN, KOTA TANGERANG, BANTEN",25,87,127,214
https://kawalpemilu.org#53047,"LARANGAN SELATAN, LARANGAN, KOTA TANGERANG, BANTEN",27,98,147,245
https://kawalpemilu.org#53047,"LARANGAN SELATAN, LARANGAN, KOTA TANGERANG, BANTEN",28,111,133,244
https://kawalpemilu.org#53047,"LARANGAN SELATAN, LARANGAN, KOTA TANGERANG, BANTEN",29,83,124,207
https://kawalpemilu.org#53047,"LARANGAN SELATAN, LARANGAN, KOTA TANGERANG, BANTEN",31,160,105,265
https://kawalpemilu.org#53047,"LARANGAN SELATAN, LARANGAN, KOTA TANGERANG, BANTEN",32,146,147,293
https://kawalpemilu.org#53047,"LARANGAN SELATAN, LARANGAN, KOTA TANGERANG, BANTEN",33,118,116,234
https://kawalpemilu.org#53047,"LARANGAN SELATAN, LARANGAN, KOTA TANGERANG, BANTEN",34,117,96,213
https://kawalpemilu.org#53047,"LARANGAN SELATAN, LARANGAN, KOTA TANGERANG, BANTEN",35,129,153,282
https://kawalpemilu.org#53047,"LARANGAN SELATAN, LARANGAN, KOTA TANGERANG, BANTEN",36,85,107,192
https://kawalpemilu.org#53047,"LARANGAN SELATAN, LARANGAN, KOTA TANGERANG, BANTEN",37,96,64,160
https://kawalpemilu.org#53047,"LARANGAN SELATAN, LARANGAN, KOTA TANGERANG, BANTEN",38,47,84,131
https://kawalpemilu.org#53047,"LARANGAN SELATAN, LARANGAN, KOTA TANGERANG, BANTEN",39,90,105,195
https://kawalpemilu.org#53047,"LARANGAN SELATAN, LARANGAN, KOTA TANGERANG, BANTEN",40,115,61,176
https://kawalpemilu.org#53047,"LARANGAN SELATAN, LARANGAN, KOTA TANGERANG, BANTEN",41,96,94,190
https://kawalpemilu.org#53047,"LARANGAN SELATAN, LARANGAN, KOTA TANGERANG, BANTEN",42,100,72,172
https://kawalpemilu.org#53047,"LARANGAN SELATAN, LARANGAN, KOTA TANGERANG, BANTEN",43,96,58,154
https://kawalpemilu.org#53047,"LARANGAN SELATAN, LARANGAN, KOTA TANGERANG, BANTEN",44,102,126,228
https://kawalpemilu.org#53047,"LARANGAN SELATAN, LARANGAN, KOTA TANGERANG, BANTEN",45,108,98,206
https://kawalpemilu.org#53047,"LARANGAN SELATAN, LARANGAN, KOTA TANGERANG, BANTEN",46,108,101,209
https://kawalpemilu.org#53047,"LARANGAN SELATAN, LARANGAN, KOTA TANGERANG, BANTEN",47,73,136,209
https://kawalpemilu.org#53047,"LARANGAN SELATAN, LARANGAN, KOTA TANGERANG, BANTEN",48,117,115,232
https://kawalpemilu.org#53047,"LARANGAN SELATAN, LARANGAN, KOTA TANGERANG, BANTEN",49,71,73,144
https://kawalpemilu.org#53047,"LARANGAN SELATAN, LARANGAN, KOTA TANGERANG, BANTEN",50,81,129,210
https://kawalpemilu.org#53047,"LARANGAN SELATAN, LARANGAN, KOTA TANGERANG, BANTEN",51,83,57,140
https://kawalpemilu.org#53047,"LARANGAN SELATAN, LARANGAN, KOTA TANGERANG, BANTEN",52,78,109,187
https://kawalpemilu.org#53047,"LARANGAN SELATAN, LARANGAN, KOTA TANGERANG, BANTEN",53,50,149,199
https://kawalpemilu.org#53047,"LARANGAN SELATAN, LARANGAN, KOTA TANGERANG, BANTEN",54,62,73,135
https://kawalpemilu.org#53048,"CIPADU, LARANGAN, KOTA TANGERANG, BANTEN",1,150,99,249
https://kawalpemilu.org#53048,"CIPADU, LARANGAN, KOTA TANGERANG, BANTEN",2,133,113,246
https://kawalpemilu.org#53048,"CIPADU, LARANGAN, KOTA TANGERANG, BANTEN",3,136,110,246
https://kawalpemilu.org#53048,"CIPADU, LARANGAN, KOTA TANGERANG, BANTEN",4,115,118,233
https://kawalpemilu.org#53048,"CIPADU, LARANGAN, KOTA TANGERANG, BANTEN",5,132,85,217
https://kawalpemilu.org#53048,"CIPADU, LARANGAN, KOTA TANGERANG, BANTEN",6,84,125,209
https://kawalpemilu.org#53048,"CIPADU, LARANGAN, KOTA TANGERANG, BANTEN",7,0,0,0
https://kawalpemilu.org#53048,"CIPADU, LARANGAN, KOTA TANGERANG, BANTEN",8,100,116,216
https://kawalpemilu.org#53048,"CIPADU, LARANGAN, KOTA TANGERANG, BANTEN",9,102,132,234
https://kawalpemilu.org#53048,"CIPADU, LARANGAN, KOTA TANGERANG, BANTEN",10,94,98,192
https://kawalpemilu.org#53048,"CIPADU, LARANGAN, KOTA TANGERANG, BANTEN",11,137,96,233
https://kawalpemilu.org#53048,"CIPADU, LARANGAN, KOTA TANGERANG, BANTEN",12,110,112,222
https://kawalpemilu.org#53048,"CIPADU, LARANGAN, KOTA TANGERANG, BANTEN",13,109,120,229
https://kawalpemilu.org#53048,"CIPADU, LARANGAN, KOTA TANGERANG, BANTEN",14,115,125,240
https://kawalpemilu.org#53048,"CIPADU, LARANGAN, KOTA TANGERANG, BANTEN",15,106,158,264
https://kawalpemilu.org#53048,"CIPADU, LARANGAN, KOTA TANGERANG, BANTEN",16,93,132,225
https://kawalpemilu.org#53048,"CIPADU, LARANGAN, KOTA TANGERANG, BANTEN",17,146,126,272
https://kawalpemilu.org#53048,"CIPADU, LARANGAN, KOTA TANGERANG, BANTEN",18,131,106,237
https://kawalpemilu.org#53048,"CIPADU, LARANGAN, KOTA TANGERANG, BANTEN",19,91,118,209
https://kawalpemilu.org#53048,"CIPADU, LARANGAN, KOTA TANGERANG, BANTEN",20,0,0,0
https://kawalpemilu.org#53048,"CIPADU, LARANGAN, KOTA TANGERANG, BANTEN",21,90,125,215
https://kawalpemilu.org#53048,"CIPADU, LARANGAN, KOTA TANGERANG, BANTEN",22,118,102,220
https://kawalpemilu.org#53048,"CIPADU, LARANGAN, KOTA TANGERANG, BANTEN",23,93,107,200
https://kawalpemilu.org#53048,"CIPADU, LARANGAN, KOTA TANGERANG, BANTEN",24,98,97,195
https://kawalpemilu.org#53048,"CIPADU, LARANGAN, KOTA TANGERANG, BANTEN",25,104,112,216
https://kawalpemilu.org#53048,"CIPADU, LARANGAN, KOTA TANGERANG, BANTEN",26,123,84,207
https://kawalpemilu.org#53048,"CIPADU, LARANGAN, KOTA TANGERANG, BANTEN",27,73,89,162
https://kawalpemilu.org#53048,"CIPADU, LARANGAN, KOTA TANGERANG, BANTEN",28,117,149,266
https://kawalpemilu.org#53048,"CIPADU, LARANGAN, KOTA TANGERANG, BANTEN",29,106,133,239
https://kawalpemilu.org#53048,"CIPADU, LARANGAN, KOTA TANGERANG, BANTEN",30,95,134,229
https://kawalpemilu.org#53048,"CIPADU, LARANGAN, KOTA TANGERANG, BANTEN",31,106,151,257
https://kawalpemilu.org#53048,"CIPADU, LARANGAN, KOTA TANGERANG, BANTEN",32,89,141,230
https://kawalpemilu.org#53048,"CIPADU, LARANGAN, KOTA TANGERANG, BANTEN",33,88,132,220
https://kawalpemilu.org#53048,"CIPADU, LARANGAN, KOTA TANGERANG, BANTEN",34,68,140,208
https://kawalpemilu.org#53048,"CIPADU, LARANGAN, KOTA TANGERANG, BANTEN",35,109,110,219
https://kawalpemilu.org#53048,"CIPADU, LARANGAN, KOTA TANGERANG, BANTEN",36,113,108,221
https://kawalpemilu.org#53048,"CIPADU, LARANGAN, KOTA TANGERANG, BANTEN",37,108,135,243
https://kawalpemilu.org#53048,"CIPADU, LARANGAN, KOTA TANGERANG, BANTEN",38,108,101,209
https://kawalpemilu.org#53048,"CIPADU, LARANGAN, KOTA TANGERANG, BANTEN",39,74,168,242
https://kawalpemilu.org#53048,"CIPADU, LARANGAN, KOTA TANGERANG, BANTEN",40,92,124,216
https://kawalpemilu.org#53048,"CIPADU, LARANGAN, KOTA TANGERANG, BANTEN",41,97,152,249
https://kawalpemilu.org#53048,"CIPADU, LARANGAN, KOTA TANGERANG, BANTEN",42,73,148,221
https://kawalpemilu.org#53048,"CIPADU, LARANGAN, KOTA TANGERANG, BANTEN",43,78,192,270
https://kawalpemilu.org#53048,"CIPADU, LARANGAN, KOTA TANGERANG, BANTEN",44,100,115,215
https://kawalpemilu.org#53048,"CIPADU, LARANGAN, KOTA TANGERANG, BANTEN",45,107,113,220
https://kawalpemilu.org#53048,"CIPADU, LARANGAN, KOTA TANGERANG, BANTEN",46,100,122,222
https://kawalpemilu.org#53048,"CIPADU, LARANGAN, KOTA TANGERANG, BANTEN",47,78,127,205
https://kawalpemilu.org#53048,"CIPADU, LARANGAN, KOTA TANGERANG, BANTEN",48,99,125,224
https://kawalpemilu.org#53048,"CIPADU, LARANGAN, KOTA TANGERANG, BANTEN",49,69,139,208
https://kawalpemilu.org#53048,"CIPADU, LARANGAN, KOTA TANGERANG, BANTEN",50,77,125,202
https://kawalpemilu.org#53049,"KREO, LARANGAN, KOTA TANGERANG, BANTEN",1,157,109,266
https://kawalpemilu.org#53049,"KREO, LARANGAN, KOTA TANGERANG, BANTEN",2,120,101,221
https://kawalpemilu.org#53049,"KREO, LARANGAN, KOTA TANGERANG, BANTEN",3,110,138,248
https://kawalpemilu.org#53049,"KREO, LARANGAN, KOTA TANGERANG, BANTEN",4,134,128,262
https://kawalpemilu.org#53049,"KREO, LARANGAN, KOTA TANGERANG, BANTEN",5,153,93,246
https://kawalpemilu.org#53049,"KREO, LARANGAN, KOTA TANGERANG, BANTEN",6,135,104,239
https://kawalpemilu.org#53049,"KREO, LARANGAN, KOTA TANGERANG, BANTEN",7,129,139,268
https://kawalpemilu.org#53049,"KREO, LARANGAN, KOTA TANGERANG, BANTEN",8,80,143,223
https://kawalpemilu.org#53049,"KREO, LARANGAN, KOTA TANGERANG, BANTEN",9,110,144,254
https://kawalpemilu.org#53049,"KREO, LARANGAN, KOTA TANGERANG, BANTEN",10,127,114,241
https://kawalpemilu.org#53049,"KREO, LARANGAN, KOTA TANGERANG, BANTEN",11,133,119,252
https://kawalpemilu.org#53049,"KREO, LARANGAN, KOTA TANGERANG, BANTEN",12,118,118,236
https://kawalpemilu.org#53049,"KREO, LARANGAN, KOTA TANGERANG, BANTEN",13,114,127,241
https://kawalpemilu.org#53049,"KREO, LARANGAN, KOTA TANGERANG, BANTEN",14,105,146,251
https://kawalpemilu.org#53049,"KREO, LARANGAN, KOTA TANGERANG, BANTEN",16,103,129,232
https://kawalpemilu.org#53049,"KREO, LARANGAN, KOTA TANGERANG, BANTEN",17,95,145,240
https://kawalpemilu.org#53049,"KREO, LARANGAN, KOTA TANGERANG, BANTEN",18,93,162,255
https://kawalpemilu.org#53049,"KREO, LARANGAN, KOTA TANGERANG, BANTEN",19,93,123,216
https://kawalpemilu.org#53049,"KREO, LARANGAN, KOTA TANGERANG, BANTEN",20,108,134,242
https://kawalpemilu.org#53049,"KREO, LARANGAN, KOTA TANGERANG, BANTEN",21,81,97,178
https://kawalpemilu.org#53049,"KREO, LARANGAN, KOTA TANGERANG, BANTEN",22,85,124,209
https://kawalpemilu.org#53049,"KREO, LARANGAN, KOTA TANGERANG, BANTEN",23,118,130,248
https://kawalpemilu.org#53049,"KREO, LARANGAN, KOTA TANGERANG, BANTEN",24,86,103,189
https://kawalpemilu.org#53049,"KREO, LARANGAN, KOTA TANGERANG, BANTEN",25,97,132,229
https://kawalpemilu.org#53049,"KREO, LARANGAN, KOTA TANGERANG, BANTEN",26,106,112,218
https://kawalpemilu.org#53049,"KREO, LARANGAN, KOTA TANGERANG, BANTEN",27,109,142,251
https://kawalpemilu.org#53049,"KREO, LARANGAN, KOTA TANGERANG, BANTEN",28,106,123,229
https://kawalpemilu.org#53049,"KREO, LARANGAN, KOTA TANGERANG, BANTEN",29,158,83,241
https://kawalpemilu.org#53049,"KREO, LARANGAN, KOTA TANGERANG, BANTEN",30,99,136,235
https://kawalpemilu.org#53049,"KREO, LARANGAN, KOTA TANGERANG, BANTEN",31,133,118,251
https://kawalpemilu.org#53049,"KREO, LARANGAN, KOTA TANGERANG, BANTEN",32,91,184,175
https://kawalpemilu.org#53049,"KREO, LARANGAN, KOTA TANGERANG, BANTEN",33,62,59,121
https://kawalpemilu.org#53049,"KREO, LARANGAN, KOTA TANGERANG, BANTEN",34,115,101,216
https://kawalpemilu.org#53049,"KREO, LARANGAN, KOTA TANGERANG, BANTEN",35,119,115,234
https://kawalpemilu.org#53049,"KREO, LARANGAN, KOTA TANGERANG, BANTEN",36,123,89,212
https://kawalpemilu.org#53049,"KREO, LARANGAN, KOTA TANGERANG, BANTEN",38,70,109,179
https://kawalpemilu.org#53050,"LARANGAN INDAH, LARANGAN, KOTA TANGERANG, BANTEN",1,118,156,274
https://kawalpemilu.org#53050,"LARANGAN INDAH, LARANGAN, KOTA TANGERANG, BANTEN",2,112,147,259
https://kawalpemilu.org#53050,"LARANGAN INDAH, LARANGAN, KOTA TANGERANG, BANTEN",3,128,142,270
https://kawalpemilu.org#53050,"LARANGAN INDAH, LARANGAN, KOTA TANGERANG, BANTEN",4,123,129,252
https://kawalpemilu.org#53050,"LARANGAN INDAH, LARANGAN, KOTA TANGERANG, BANTEN",5,134,127,261
https://kawalpemilu.org#53050,"LARANGAN INDAH, LARANGAN, KOTA TANGERANG, BANTEN",6,192,63,255
https://kawalpemilu.org#53050,"LARANGAN INDAH, LARANGAN, KOTA TANGERANG, BANTEN",7,122,132,254
https://kawalpemilu.org#53050,"LARANGAN INDAH, LARANGAN, KOTA TANGERANG, BANTEN",8,71,169,240
https://kawalpemilu.org#53050,"LARANGAN INDAH, LARANGAN, KOTA TANGERANG, BANTEN",9,124,147,271
https://kawalpemilu.org#53050,"LARANGAN INDAH, LARANGAN, KOTA TANGERANG, BANTEN",10,116,142,258
https://kawalpemilu.org#53050,"LARANGAN INDAH, LARANGAN, KOTA TANGERANG, BANTEN",12,148,106,254
https://kawalpemilu.org#53050,"LARANGAN INDAH, LARANGAN, KOTA TANGERANG, BANTEN",13,130,124,254
https://kawalpemilu.org#53050,"LARANGAN INDAH, LARANGAN, KOTA TANGERANG, BANTEN",14,124,153,277
https://kawalpemilu.org#53050,"LARANGAN INDAH, LARANGAN, KOTA TANGERANG, BANTEN",15,100,198,298
https://kawalpemilu.org#53050,"LARANGAN INDAH, LARANGAN, KOTA TANGERANG, BANTEN",16,92,149,241
https://kawalpemilu.org#53050,"LARANGAN INDAH, LARANGAN, KOTA TANGERANG, BANTEN",17,129,124,253
https://kawalpemilu.org#53050,"LARANGAN INDAH, LARANGAN, KOTA TANGERANG, BANTEN",18,101,128,229
https://kawalpemilu.org#53050,"LARANGAN INDAH, LARANGAN, KOTA TANGERANG, BANTEN",19,98,133,231
https://kawalpemilu.org#53050,"LARANGAN INDAH, LARANGAN, KOTA TANGERANG, BANTEN",20,111,106,217
https://kawalpemilu.org#53050,"LARANGAN INDAH, LARANGAN, KOTA TANGERANG, BANTEN",22,162,106,268
https://kawalpemilu.org#53050,"LARANGAN INDAH, LARANGAN, KOTA TANGERANG, BANTEN",23,133,115,248
https://kawalpemilu.org#53050,"LARANGAN INDAH, LARANGAN, KOTA TANGERANG, BANTEN",27,0,0,0
https://kawalpemilu.org#53050,"LARANGAN INDAH, LARANGAN, KOTA TANGERANG, BANTEN",28,118,151,269
https://kawalpemilu.org#53050,"LARANGAN INDAH, LARANGAN, KOTA TANGERANG, BANTEN",30,146,96,242
https://kawalpemilu.org#53050,"LARANGAN INDAH, LARANGAN, KOTA TANGERANG, BANTEN",31,175,98,273
https://kawalpemilu.org#53050,"LARANGAN INDAH, LARANGAN, KOTA TANGERANG, BANTEN",32,171,97,268
https://kawalpemilu.org#53050,"LARANGAN INDAH, LARANGAN, KOTA TANGERANG, BANTEN",33,118,85,203
https://kawalpemilu.org#53050,"LARANGAN INDAH, LARANGAN, KOTA TANGERANG, BANTEN",34,105,104,209
https://kawalpemilu.org#53050,"LARANGAN INDAH, LARANGAN, KOTA TANGERANG, BANTEN",35,90,124,214
https://kawalpemilu.org#53051,"GAGA, LARANGAN, KOTA TANGERANG, BANTEN",1,148,127,275
https://kawalpemilu.org#53051,"GAGA, LARANGAN, KOTA TANGERANG, BANTEN",2,127,128,255
https://kawalpemilu.org#53051,"GAGA, LARANGAN, KOTA TANGERANG, BANTEN",3,117,133,250
https://kawalpemilu.org#53051,"GAGA, LARANGAN, KOTA TANGERANG, BANTEN",4,106,120,226
https://kawalpemilu.org#53051,"GAGA, LARANGAN, KOTA TANGERANG, BANTEN",5,132,115,247
https://kawalpemilu.org#53051,"GAGA, LARANGAN, KOTA TANGERANG, BANTEN",6,97,89,186
https://kawalpemilu.org#53051,"GAGA, LARANGAN, KOTA TANGERANG, BANTEN",7,80,93,173
https://kawalpemilu.org#53051,"GAGA, LARANGAN, KOTA TANGERANG, BANTEN",8,86,86,172
https://kawalpemilu.org#53051,"GAGA, LARANGAN, KOTA TANGERANG, BANTEN",9,118,97,215
https://kawalpemilu.org#53051,"GAGA, LARANGAN, KOTA TANGERANG, BANTEN",10,66,114,180
https://kawalpemilu.org#53051,"GAGA, LARANGAN, KOTA TANGERANG, BANTEN",11,84,109,193
https://kawalpemilu.org#53051,"GAGA, LARANGAN, KOTA TANGERANG, BANTEN",12,172,80,252
https://kawalpemilu.org#53051,"GAGA, LARANGAN, KOTA TANGERANG, BANTEN",13,171,88,259
https://kawalpemilu.org#53051,"GAGA, LARANGAN, KOTA TANGERANG, BANTEN",14,129,86,215
https://kawalpemilu.org#53051,"GAGA, LARANGAN, KOTA TANGERANG, BANTEN",15,128,106,234
https://kawalpemilu.org#53051,"GAGA, LARANGAN, KOTA TANGERANG, BANTEN",17,131,130,261
https://kawalpemilu.org#53051,"GAGA, LARANGAN, KOTA TANGERANG, BANTEN",18,97,99,196
https://kawalpemilu.org#53051,"GAGA, LARANGAN, KOTA TANGERANG, BANTEN",19,97,118,215
https://kawalpemilu.org#53051,"GAGA, LARANGAN, KOTA TANGERANG, BANTEN",20,79,121,200
https://kawalpemilu.org#53051,"GAGA, LARANGAN, KOTA TANGERANG, BANTEN",21,58,106,164
https://kawalpemilu.org#53051,"GAGA, LARANGAN, KOTA TANGERANG, BANTEN",22,115,161,276
https://kawalpemilu.org#53051,"GAGA, LARANGAN, KOTA TANGERANG, BANTEN",23,118,162,280
https://kawalpemilu.org#53051,"GAGA, LARANGAN, KOTA TANGERANG, BANTEN",24,111,122,233
https://kawalpemilu.org#53051,"GAGA, LARANGAN, KOTA TANGERANG, BANTEN",25,137,114,251
https://kawalpemilu.org#53051,"GAGA, LARANGAN, KOTA TANGERANG, BANTEN",26,105,86,191
https://kawalpemilu.org#53051,"GAGA, LARANGAN, KOTA TANGERANG, BANTEN",27,142,108,250
https://kawalpemilu.org#53051,"GAGA, LARANGAN, KOTA TANGERANG, BANTEN",28,147,106,253
https://kawalpemilu.org#53051,"GAGA, LARANGAN, KOTA TANGERANG, BANTEN",29,138,92,230
https://kawalpemilu.org#53051,"GAGA, LARANGAN, KOTA TANGERANG, BANTEN",30,104,71,175
https://kawalpemilu.org#53051,"GAGA, LARANGAN, KOTA TANGERANG, BANTEN",31,73,145,218
https://kawalpemilu.org#53051,"GAGA, LARANGAN, KOTA TANGERANG, BANTEN",32,110,140,250
https://kawalpemilu.org#53051,"GAGA, LARANGAN, KOTA TANGERANG, BANTEN",33,131,97,228
https://kawalpemilu.org#53051,"GAGA, LARANGAN, KOTA TANGERANG, BANTEN",34,109,80,189
https://kawalpemilu.org#53051,"GAGA, LARANGAN, KOTA TANGERANG, BANTEN",35,112,124,236
https://kawalpemilu.org#53051,"GAGA, LARANGAN, KOTA TANGERANG, BANTEN",36,110,153,263
https://kawalpemilu.org#53051,"GAGA, LARANGAN, KOTA TANGERANG, BANTEN",37,107,142,249
https://kawalpemilu.org#53051,"GAGA, LARANGAN, KOTA TANGERANG, BANTEN",38,118,141,259
https://kawalpemilu.org#53051,"GAGA, LARANGAN, KOTA TANGERANG, BANTEN",39,128,116,244
https://kawalpemilu.org#53051,"GAGA, LARANGAN, KOTA TANGERANG, BANTEN",40,130,108,238
https://kawalpemilu.org#53051,"GAGA, LARANGAN, KOTA TANGERANG, BANTEN",41,121,110,231
https://kawalpemilu.org#53051,"GAGA, LARANGAN, KOTA TANGERANG, BANTEN",42,144,103,247
https://kawalpemilu.org#53051,"GAGA, LARANGAN, KOTA TANGERANG, BANTEN",43,107,117,224
https://kawalpemilu.org#53051,"GAGA, LARANGAN, KOTA TANGERANG, BANTEN",44,151,91,242
https://kawalpemilu.org#53051,"GAGA, LARANGAN, KOTA TANGERANG, BANTEN",45,122,100,222
https://kawalpemilu.org#53051,"GAGA, LARANGAN, KOTA TANGERANG, BANTEN",46,137,102,239
https://kawalpemilu.org#53051,"GAGA, LARANGAN, KOTA TANGERANG, BANTEN",47,122,123,245
https://kawalpemilu.org#53051,"GAGA, LARANGAN, KOTA TANGERANG, BANTEN",48,115,124,239
https://kawalpemilu.org#53051,"GAGA, LARANGAN, KOTA TANGERANG, BANTEN",49,94,116,210
https://kawalpemilu.org#53051,"GAGA, LARANGAN, KOTA TANGERANG, BANTEN",50,101,96,197
https://kawalpemilu.org#53051,"GAGA, LARANGAN, KOTA TANGERANG, BANTEN",51,127,98,225
https://kawalpemilu.org#53051,"GAGA, LARANGAN, KOTA TANGERANG, BANTEN",52,155,104,259
https://kawalpemilu.org#53051,"GAGA, LARANGAN, KOTA TANGERANG, BANTEN",53,127,81,208
https://kawalpemilu.org#53051,"GAGA, LARANGAN, KOTA TANGERANG, BANTEN",54,154,120,274
https://kawalpemilu.org#53051,"GAGA, LARANGAN, KOTA TANGERANG, BANTEN",55,160,129,289
https://kawalpemilu.org#53051,"GAGA, LARANGAN, KOTA TANGERANG, BANTEN",56,153,99,252
https://kawalpemilu.org#53051,"GAGA, LARANGAN, KOTA TANGERANG, BANTEN",57,141,100,241
https://kawalpemilu.org#53051,"GAGA, LARANGAN, KOTA TANGERANG, BANTEN",58,104,105,209
https://kawalpemilu.org#53051,"GAGA, LARANGAN, KOTA TANGERANG, BANTEN",59,144,140,284
https://kawalpemilu.org#53051,"GAGA, LARANGAN, KOTA TANGERANG, BANTEN",60,153,113,266
https://kawalpemilu.org#53051,"GAGA, LARANGAN, KOTA TANGERANG, BANTEN",61,121,76,197
https://kawalpemilu.org#53052,"CIPADU JAYA, LARANGAN, KOTA TANGERANG, BANTEN",1,102,98,200
https://kawalpemilu.org#53052,"CIPADU JAYA, LARANGAN, KOTA TANGERANG, BANTEN",2,92,101,193
https://kawalpemilu.org#53052,"CIPADU JAYA, LARANGAN, KOTA TANGERANG, BANTEN",3,122,106,228
https://kawalpemilu.org#53052,"CIPADU JAYA, LARANGAN, KOTA TANGERANG, BANTEN",4,95,128,223
https://kawalpemilu.org#53052,"CIPADU JAYA, LARANGAN, KOTA TANGERANG, BANTEN",5,134,72,206
https://kawalpemilu.org#53052,"CIPADU JAYA, LARANGAN, KOTA TANGERANG, BANTEN",6,104,109,213
https://kawalpemilu.org#53052,"CIPADU JAYA, LARANGAN, KOTA TANGERANG, BANTEN",7,98,83,181
https://kawalpemilu.org#53052,"CIPADU JAYA, LARANGAN, KOTA TANGERANG, BANTEN",8,114,78,192
https://kawalpemilu.org#53052,"CIPADU JAYA, LARANGAN, KOTA TANGERANG, BANTEN",9,115,127,242
https://kawalpemilu.org#53052,"CIPADU JAYA, LARANGAN, KOTA TANGERANG, BANTEN",10,120,116,236
https://kawalpemilu.org#53052,"CIPADU JAYA, LARANGAN, KOTA TANGERANG, BANTEN",11,103,121,224
https://kawalpemilu.org#53052,"CIPADU JAYA, LARANGAN, KOTA TANGERANG, BANTEN",12,140,122,262
https://kawalpemilu.org#53052,"CIPADU JAYA, LARANGAN, KOTA TANGERANG, BANTEN",13,124,140,264
https://kawalpemilu.org#53052,"CIPADU JAYA, LARANGAN, KOTA TANGERANG, BANTEN",14,98,132,230
https://kawalpemilu.org#53052,"CIPADU JAYA, LARANGAN, KOTA TANGERANG, BANTEN",15,83,126,209
https://kawalpemilu.org#53052,"CIPADU JAYA, LARANGAN, KOTA TANGERANG, BANTEN",16,114,148,262
https://kawalpemilu.org#53052,"CIPADU JAYA, LARANGAN, KOTA TANGERANG, BANTEN",17,100,134,234
https://kawalpemilu.org#53052,"CIPADU JAYA, LARANGAN, KOTA TANGERANG, BANTEN",18,140,110,250
https://kawalpemilu.org#53052,"CIPADU JAYA, LARANGAN, KOTA TANGERANG, BANTEN",19,118,123,241
https://kawalpemilu.org#53052,"CIPADU JAYA, LARANGAN, KOTA TANGERANG, BANTEN",20,66,176,242
https://kawalpemilu.org#53052,"CIPADU JAYA, LARANGAN, KOTA TANGERANG, BANTEN",21,115,131,246
https://kawalpemilu.org#53052,"CIPADU JAYA, LARANGAN, KOTA TANGERANG, BANTEN",22,94,97,191
https://kawalpemilu.org#53052,"CIPADU JAYA, LARANGAN, KOTA TANGERANG, BANTEN",23,141,101,242
https://kawalpemilu.org#53052,"CIPADU JAYA, LARANGAN, KOTA TANGERANG, BANTEN",24,94,117,211
https://kawalpemilu.org#53052,"CIPADU JAYA, LARANGAN, KOTA TANGERANG, BANTEN",25,102,147,249
https://kawalpemilu.org#53052,"CIPADU JAYA, LARANGAN, KOTA TANGERANG, BANTEN",26,104,91,195
https://kawalpemilu.org#53052,"CIPADU JAYA, LARANGAN, KOTA TANGERANG, BANTEN",27,121,124,245
https://kawalpemilu.org#53052,"CIPADU JAYA, LARANGAN, KOTA TANGERANG, BANTEN",28,102,115,217
https://kawalpemilu.org#53052,"CIPADU JAYA, LARANGAN, KOTA TANGERANG, BANTEN",29,122,145,267
https://kawalpemilu.org#53052,"CIPADU JAYA, LARANGAN, KOTA TANGERANG, BANTEN",30,65,208,273
https://kawalpemilu.org#53052,"CIPADU JAYA, LARANGAN, KOTA TANGERANG, BANTEN",31,50,171,221
https://kawalpemilu.org#53052,"CIPADU JAYA, LARANGAN, KOTA TANGERANG, BANTEN",32,89,151,240
https://kawalpemilu.org#53052,"CIPADU JAYA, LARANGAN, KOTA TANGERANG, BANTEN",33,89,155,244
https://kawalpemilu.org#53052,"CIPADU JAYA, LARANGAN, KOTA TANGERANG, BANTEN",34,127,117,244
https://kawalpemilu.org#53052,"CIPADU JAYA, LARANGAN, KOTA TANGERANG, BANTEN",36,107,150,257
https://kawalpemilu.org#53052,"CIPADU JAYA, LARANGAN, KOTA TANGERANG, BANTEN",37,134,109,243
https://kawalpemilu.org#53052,"CIPADU JAYA, LARANGAN, KOTA TANGERANG, BANTEN",38,131,94,225
https://kawalpemilu.org#53052,"CIPADU JAYA, LARANGAN, KOTA TANGERANG, BANTEN",39,127,72,199
https://kawalpemilu.org#53052,"CIPADU JAYA, LARANGAN, KOTA TANGERANG, BANTEN",40,133,83,216
https://kawalpemilu.org#53052,"CIPADU JAYA, LARANGAN, KOTA TANGERANG, BANTEN",41,116,65,181
https://kawalpemilu.org#53052,"CIPADU JAYA, LARANGAN, KOTA TANGERANG, BANTEN",42,133,52,185
https://kawalpemilu.org#53052,"CIPADU JAYA, LARANGAN, KOTA TANGERANG, BANTEN",43,102,84,186
https://kawalpemilu.org#53053,"KREO SELATAN, LARANGAN, KOTA TANGERANG, BANTEN",1,103,102,205
https://kawalpemilu.org#53053,"KREO SELATAN, LARANGAN, KOTA TANGERANG, BANTEN",2,105,86,191
https://kawalpemilu.org#53053,"KREO SELATAN, LARANGAN, KOTA TANGERANG, BANTEN",3,125,152,277
https://kawalpemilu.org#53053,"KREO SELATAN, LARANGAN, KOTA TANGERANG, BANTEN",4,132,143,275
https://kawalpemilu.org#53053,"KREO SELATAN, LARANGAN, KOTA TANGERANG, BANTEN",5,131,113,244
https://kawalpemilu.org#53053,"KREO SELATAN, LARANGAN, KOTA TANGERANG, BANTEN",6,116,87,203
https://kawalpemilu.org#53053,"KREO SELATAN, LARANGAN, KOTA TANGERANG, BANTEN",7,118,114,232
https://kawalpemilu.org#53053,"KREO SELATAN, LARANGAN, KOTA TANGERANG, BANTEN",8,137,148,285
https://kawalpemilu.org#53053,"KREO SELATAN, LARANGAN, KOTA TANGERANG, BANTEN",10,71,93,164
https://kawalpemilu.org#53053,"KREO SELATAN, LARANGAN, KOTA TANGERANG, BANTEN",11,107,93,200
https://kawalpemilu.org#53053,"KREO SELATAN, LARANGAN, KOTA TANGERANG, BANTEN",12,120,171,291
https://kawalpemilu.org#53053,"KREO SELATAN, LARANGAN, KOTA TANGERANG, BANTEN",13,92,155,247
https://kawalpemilu.org#53053,"KREO SELATAN, LARANGAN, KOTA TANGERANG, BANTEN",14,110,159,269
https://kawalpemilu.org#53053,"KREO SELATAN, LARANGAN, KOTA TANGERANG, BANTEN",15,121,177,298
https://kawalpemilu.org#53053,"KREO SELATAN, LARANGAN, KOTA TANGERANG, BANTEN",16,93,149,242
https://kawalpemilu.org#53053,"KREO SELATAN, LARANGAN, KOTA TANGERANG, BANTEN",17,106,161,267
https://kawalpemilu.org#53053,"KREO SELATAN, LARANGAN, KOTA TANGERANG, BANTEN",18,77,192,269
https://kawalpemilu.org#53053,"KREO SELATAN, LARANGAN, KOTA TANGERANG, BANTEN",19,96,189,285
https://kawalpemilu.org#53053,"KREO SELATAN, LARANGAN, KOTA TANGERANG, BANTEN",20,113,174,287
https://kawalpemilu.org#53053,"KREO SELATAN, LARANGAN, KOTA TANGERANG, BANTEN",21,75,222,297
https://kawalpemilu.org#53053,"KREO SELATAN, LARANGAN, KOTA TANGERANG, BANTEN",22,108,141,249
https://kawalpemilu.org#53053,"KREO SELATAN, LARANGAN, KOTA TANGERANG, BANTEN",23,95,149,244
https://kawalpemilu.org#53053,"KREO SELATAN, LARANGAN, KOTA TANGERANG, BANTEN",24,99,145,244
https://kawalpemilu.org#53053,"KREO SELATAN, LARANGAN, KOTA TANGERANG, BANTEN",25,106,173,279
https://kawalpemilu.org#53053,"KREO SELATAN, LARANGAN, KOTA TANGERANG, BANTEN",26,81,174,255
https://kawalpemilu.org#53053,"KREO SELATAN, LARANGAN, KOTA TANGERANG, BANTEN",27,145,111,256
https://kawalpemilu.org#53053,"KREO SELATAN, LARANGAN, KOTA TANGERANG, BANTEN",29,42,141,183
https://kawalpemilu.org#53053,"KREO SELATAN, LARANGAN, KOTA TANGERANG, BANTEN",30,85,166,251
https://kawalpemilu.org#53053,"KREO SELATAN, LARANGAN, KOTA TANGERANG, BANTEN",31,135,139,274
https://kawalpemilu.org#53053,"KREO SELATAN, LARANGAN, KOTA TANGERANG, BANTEN",32,61,140,201
https://kawalpemilu.org#53053,"KREO SELATAN, LARANGAN, KOTA TANGERANG, BANTEN",33,77,138,215
https://kawalpemilu.org#53053,"KREO SELATAN, LARANGAN, KOTA TANGERANG, BANTEN",34,69,124,193
https://kawalpemilu.org#53053,"KREO SELATAN, LARANGAN, KOTA TANGERANG, BANTEN",35,47,141,188
https://kawalpemilu.org#53053,"KREO SELATAN, LARANGAN, KOTA TANGERANG, BANTEN",36,84,118,202
https://kawalpemilu.org#53053,"KREO SELATAN, LARANGAN, KOTA TANGERANG, BANTEN",37,90,98,188
https://kawalpemilu.org#53053,"KREO SELATAN, LARANGAN, KOTA TANGERANG, BANTEN",38,101,110,211
https://kawalpemilu.org#53053,"KREO SELATAN, LARANGAN, KOTA TANGERANG, BANTEN",39,67,102,169
https://kawalpemilu.org#53056,"CIBEBER, CIBEBER, KOTA CILEGON, BANTEN",1,95,172,267
https://kawalpemilu.org#53056,"CIBEBER, CIBEBER, KOTA CILEGON, BANTEN",2,75,137,212
https://kawalpemilu.org#53056,"CIBEBER, CIBEBER, KOTA CILEGON, BANTEN",3,75,203,278
https://kawalpemilu.org#53056,"CIBEBER, CIBEBER, KOTA CILEGON, BANTEN",4,45,173,218
https://kawalpemilu.org#53056,"CIBEBER, CIBEBER, KOTA CILEGON, BANTEN",5,51,148,199
https://kawalpemilu.org#53056,"CIBEBER, CIBEBER, KOTA CILEGON, BANTEN",6,84,129,213
https://kawalpemilu.org#53056,"CIBEBER, CIBEBER, KOTA CILEGON, BANTEN",7,60,173,233
https://kawalpemilu.org#53056,"CIBEBER, CIBEBER, KOTA CILEGON, BANTEN",8,49,111,160
https://kawalpemilu.org#53056,"CIBEBER, CIBEBER, KOTA CILEGON, BANTEN",9,46,90,136
https://kawalpemilu.org#53056,"CIBEBER, CIBEBER, KOTA CILEGON, BANTEN",10,101,172,273
https://kawalpemilu.org#53056,"CIBEBER, CIBEBER, KOTA CILEGON, BANTEN",11,118,112,230
https://kawalpemilu.org#53056,"CIBEBER, CIBEBER, KOTA CILEGON, BANTEN",12,97,98,196
https://kawalpemilu.org#53056,"CIBEBER, CIBEBER, KOTA CILEGON, BANTEN",13,78,142,220
https://kawalpemilu.org#53056,"CIBEBER, CIBEBER, KOTA CILEGON, BANTEN",14,75,107,182
https://kawalpemilu.org#53056,"CIBEBER, CIBEBER, KOTA CILEGON, BANTEN",15,71,84,155
https://kawalpemilu.org#53056,"CIBEBER, CIBEBER, KOTA CILEGON, BANTEN",16,75,153,228
https://kawalpemilu.org#53056,"CIBEBER, CIBEBER, KOTA CILEGON, BANTEN",17,54,140,194
https://kawalpemilu.org#53056,"CIBEBER, CIBEBER, KOTA CILEGON, BANTEN",18,54,154,208
https://kawalpemilu.org#53056,"CIBEBER, CIBEBER, KOTA CILEGON, BANTEN",19,43,197,240
https://kawalpemilu.org#53056,"CIBEBER, CIBEBER, KOTA CILEGON, BANTEN",20,76,125,201
https://kawalpemilu.org#53056,"CIBEBER, CIBEBER, KOTA CILEGON, BANTEN",21,46,97,143
https://kawalpemilu.org#53056,"CIBEBER, CIBEBER, KOTA CILEGON, BANTEN",22,72,130,202
https://kawalpemilu.org#53056,"CIBEBER, CIBEBER, KOTA CILEGON, BANTEN",23,47,92,139
https://kawalpemilu.org#53056,"CIBEBER, CIBEBER, KOTA CILEGON, BANTEN",24,109,146,255
https://kawalpemilu.org#53056,"CIBEBER, CIBEBER, KOTA CILEGON, BANTEN",25,83,70,153
https://kawalpemilu.org#53056,"CIBEBER, CIBEBER, KOTA CILEGON, BANTEN",26,62,90,152
https://kawalpemilu.org#53056,"CIBEBER, CIBEBER, KOTA CILEGON, BANTEN",27,58,133,191
https://kawalpemilu.org#53056,"CIBEBER, CIBEBER, KOTA CILEGON, BANTEN",28,67,122,189
https://kawalpemilu.org#53056,"CIBEBER, CIBEBER, KOTA CILEGON, BANTEN",29,31,92,123
https://kawalpemilu.org#53056,"CIBEBER, CIBEBER, KOTA CILEGON, BANTEN",30,69,101,170
https://kawalpemilu.org#53056,"CIBEBER, CIBEBER, KOTA CILEGON, BANTEN",31,33,88,121
https://kawalpemilu.org#53056,"CIBEBER, CIBEBER, KOTA CILEGON, BANTEN",32,49,128,177
https://kawalpemilu.org#53056,"CIBEBER, CIBEBER, KOTA CILEGON, BANTEN",33,71,127,198
https://kawalpemilu.org#53056,"CIBEBER, CIBEBER, KOTA CILEGON, BANTEN",34,90,104,194
https://kawalpemilu.org#53056,"CIBEBER, CIBEBER, KOTA CILEGON, BANTEN",35,74,140,214
https://kawalpemilu.org#53056,"CIBEBER, CIBEBER, KOTA CILEGON, BANTEN",36,82,125,207
https://kawalpemilu.org#53056,"CIBEBER, CIBEBER, KOTA CILEGON, BANTEN",37,60,76,136
https://kawalpemilu.org#53056,"CIBEBER, CIBEBER, KOTA CILEGON, BANTEN",38,79,140,219
https://kawalpemilu.org#53056,"CIBEBER, CIBEBER, KOTA CILEGON, BANTEN",39,55,83,138
https://kawalpemilu.org#53056,"CIBEBER, CIBEBER, KOTA CILEGON, BANTEN",40,91,174,265
https://kawalpemilu.org#53056,"CIBEBER, CIBEBER, KOTA CILEGON, BANTEN",42,101,166,267
https://kawalpemilu.org#53056,"CIBEBER, CIBEBER, KOTA CILEGON, BANTEN",43,105,111,216
https://kawalpemilu.org#53056,"CIBEBER, CIBEBER, KOTA CILEGON, BANTEN",44,112,155,267
https://kawalpemilu.org#53056,"CIBEBER, CIBEBER, KOTA CILEGON, BANTEN",45,83,125,208
https://kawalpemilu.org#53056,"CIBEBER, CIBEBER, KOTA CILEGON, BANTEN",46,119,151,270
https://kawalpemilu.org#53056,"CIBEBER, CIBEBER, KOTA CILEGON, BANTEN",47,121,119,240
https://kawalpemilu.org#53056,"CIBEBER, CIBEBER, KOTA CILEGON, BANTEN",48,80,140,220
https://kawalpemilu.org#53056,"CIBEBER, CIBEBER, KOTA CILEGON, BANTEN",49,77,104,181
https://kawalpemilu.org#53056,"CIBEBER, CIBEBER, KOTA CILEGON, BANTEN",50,105,158,263
https://kawalpemilu.org#53056,"CIBEBER, CIBEBER, KOTA CILEGON, BANTEN",51,66,115,181
https://kawalpemilu.org#53056,"CIBEBER, CIBEBER, KOTA CILEGON, BANTEN",52,68,119,187
https://kawalpemilu.org#53056,"CIBEBER, CIBEBER, KOTA CILEGON, BANTEN",53,86,130,216
https://kawalpemilu.org#53056,"CIBEBER, CIBEBER, KOTA CILEGON, BANTEN",54,89,135,224
https://kawalpemilu.org#53056,"CIBEBER, CIBEBER, KOTA CILEGON, BANTEN",55,86,125,211
https://kawalpemilu.org#53056,"CIBEBER, CIBEBER, KOTA CILEGON, BANTEN",56,106,94,200
https://kawalpemilu.org#53056,"CIBEBER, CIBEBER, KOTA CILEGON, BANTEN",57,115,125,240
https://kawalpemilu.org#53056,"CIBEBER, CIBEBER, KOTA CILEGON, BANTEN",58,93,184,277
https://kawalpemilu.org#53056,"CIBEBER, CIBEBER, KOTA CILEGON, BANTEN",59,42,142,184
https://kawalpemilu.org#53056,"CIBEBER, CIBEBER, KOTA CILEGON, BANTEN",60,34,161,195
https://kawalpemilu.org#53057,"KEDALEMAN, CIBEBER, KOTA CILEGON, BANTEN",1,76,122,198
https://kawalpemilu.org#53057,"KEDALEMAN, CIBEBER, KOTA CILEGON, BANTEN",2,45,84,129
https://kawalpemilu.org#53057,"KEDALEMAN, CIBEBER, KOTA CILEGON, BANTEN",3,62,148,210
https://kawalpemilu.org#53057,"KEDALEMAN, CIBEBER, KOTA CILEGON, BANTEN",4,74,131,205
https://kawalpemilu.org#53057,"KEDALEMAN, CIBEBER, KOTA CILEGON, BANTEN",5,90,146,236
https://kawalpemilu.org#53057,"KEDALEMAN, CIBEBER, KOTA CILEGON, BANTEN",6,81,145,226
https://kawalpemilu.org#53057,"KEDALEMAN, CIBEBER, KOTA CILEGON, BANTEN",7,73,157,230
https://kawalpemilu.org#53057,"KEDALEMAN, CIBEBER, KOTA CILEGON, BANTEN",8,90,149,239
https://kawalpemilu.org#53057,"KEDALEMAN, CIBEBER, KOTA CILEGON, BANTEN",9,81,118,199
https://kawalpemilu.org#53057,"KEDALEMAN, CIBEBER, KOTA CILEGON, BANTEN",10,68,134,202
https://kawalpemilu.org#53057,"KEDALEMAN, CIBEBER, KOTA CILEGON, BANTEN",11,47,189,236
https://kawalpemilu.org#53057,"KEDALEMAN, CIBEBER, KOTA CILEGON, BANTEN",12,66,151,217
https://kawalpemilu.org#53057,"KEDALEMAN, CIBEBER, KOTA CILEGON, BANTEN",13,56,115,171
https://kawalpemilu.org#53057,"KEDALEMAN, CIBEBER, KOTA CILEGON, BANTEN",14,46,136,182
https://kawalpemilu.org#53057,"KEDALEMAN, CIBEBER, KOTA CILEGON, BANTEN",15,41,151,15
https://kawalpemilu.org#53057,"KEDALEMAN, CIBEBER, KOTA CILEGON, BANTEN",16,35,151,186
https://kawalpemilu.org#53057,"KEDALEMAN, CIBEBER, KOTA CILEGON, BANTEN",17,42,158,200
https://kawalpemilu.org#53057,"KEDALEMAN, CIBEBER, KOTA CILEGON, BANTEN",18,39,181,220
https://kawalpemilu.org#53057,"KEDALEMAN, CIBEBER, KOTA CILEGON, BANTEN",19,27,177,204
https://kawalpemilu.org#53057,"KEDALEMAN, CIBEBER, KOTA CILEGON, BANTEN",20,28,108,136
https://kawalpemilu.org#53057,"KEDALEMAN, CIBEBER, KOTA CILEGON, BANTEN",21,31,165,196
https://kawalpemilu.org#53057,"KEDALEMAN, CIBEBER, KOTA CILEGON, BANTEN",22,108,127,235
https://kawalpemilu.org#53057,"KEDALEMAN, CIBEBER, KOTA CILEGON, BANTEN",23,80,154,234
https://kawalpemilu.org#53057,"KEDALEMAN, CIBEBER, KOTA CILEGON, BANTEN",24,85,128,213
https://kawalpemilu.org#53057,"KEDALEMAN, CIBEBER, KOTA CILEGON, BANTEN",25,71,92,163
https://kawalpemilu.org#53057,"KEDALEMAN, CIBEBER, KOTA CILEGON, BANTEN",26,100,37,137
https://kawalpemilu.org#53057,"KEDALEMAN, CIBEBER, KOTA CILEGON, BANTEN",27,76,58,134
https://kawalpemilu.org#53057,"KEDALEMAN, CIBEBER, KOTA CILEGON, BANTEN",28,82,44,126
https://kawalpemilu.org#53057,"KEDALEMAN, CIBEBER, KOTA CILEGON, BANTEN",29,85,84,169
https://kawalpemilu.org#53057,"KEDALEMAN, CIBEBER, KOTA CILEGON, BANTEN",30,99,96,195
https://kawalpemilu.org#53058,"KARANG ASEM, CIBEBER, KOTA CILEGON, BANTEN",1,0,156,156
https://kawalpemilu.org#53058,"KARANG ASEM, CIBEBER, KOTA CILEGON, BANTEN",2,51,146,197
https://kawalpemilu.org#53058,"KARANG ASEM, CIBEBER, KOTA CILEGON, BANTEN",3,119,127,246
https://kawalpemilu.org#53058,"KARANG ASEM, CIBEBER, KOTA CILEGON, BANTEN",4,103,130,233
https://kawalpemilu.org#53058,"KARANG ASEM, CIBEBER, KOTA CILEGON, BANTEN",5,94,138,232
https://kawalpemilu.org#53058,"KARANG ASEM, CIBEBER, KOTA CILEGON, BANTEN",6,89,142,231
https://kawalpemilu.org#53058,"KARANG ASEM, CIBEBER, KOTA CILEGON, BANTEN",7,47,128,175
https://kawalpemilu.org#53058,"KARANG ASEM, CIBEBER, KOTA CILEGON, BANTEN",8,49,164,213
https://kawalpemilu.org#53058,"KARANG ASEM, CIBEBER, KOTA CILEGON, BANTEN",9,49,149,198
https://kawalpemilu.org#53058,"KARANG ASEM, CIBEBER, KOTA CILEGON, BANTEN",10,72,132,204
https://kawalpemilu.org#53058,"KARANG ASEM, CIBEBER, KOTA CILEGON, BANTEN",11,72,129,201
https://kawalpemilu.org#53058,"KARANG ASEM, CIBEBER, KOTA CILEGON, BANTEN",12,53,121,174
https://kawalpemilu.org#53058,"KARANG ASEM, CIBEBER, KOTA CILEGON, BANTEN",13,39,102,141
https://kawalpemilu.org#53058,"KARANG ASEM, CIBEBER, KOTA CILEGON, BANTEN",14,67,164,231
https://kawalpemilu.org#53058,"KARANG ASEM, CIBEBER, KOTA CILEGON, BANTEN",15,44,146,190
https://kawalpemilu.org#53058,"KARANG ASEM, CIBEBER, KOTA CILEGON, BANTEN",16,64,150,214
https://kawalpemilu.org#53058,"KARANG ASEM, CIBEBER, KOTA CILEGON, BANTEN",17,44,157,201
https://kawalpemilu.org#53058,"KARANG ASEM, CIBEBER, KOTA CILEGON, BANTEN",18,49,159,208
https://kawalpemilu.org#53058,"KARANG ASEM, CIBEBER, KOTA CILEGON, BANTEN",19,52,174,226
https://kawalpemilu.org#53058,"KARANG ASEM, CIBEBER, KOTA CILEGON, BANTEN",20,41,82,123
https://kawalpemilu.org#53058,"KARANG ASEM, CIBEBER, KOTA CILEGON, BANTEN",21,72,191,263
https://kawalpemilu.org#53058,"KARANG ASEM, CIBEBER, KOTA CILEGON, BANTEN",22,79,149,228
https://kawalpemilu.org#53058,"KARANG ASEM, CIBEBER, KOTA CILEGON, BANTEN",23,62,171,233
https://kawalpemilu.org#53058,"KARANG ASEM, CIBEBER, KOTA CILEGON, BANTEN",24,67,163,230
https://kawalpemilu.org#53058,"KARANG ASEM, CIBEBER, KOTA CILEGON, BANTEN",25,76,138,214
https://kawalpemilu.org#53058,"KARANG ASEM, CIBEBER, KOTA CILEGON, BANTEN",26,59,161,220
https://kawalpemilu.org#53058,"KARANG ASEM, CIBEBER, KOTA CILEGON, BANTEN",27,44,153,197
https://kawalpemilu.org#53058,"KARANG ASEM, CIBEBER, KOTA CILEGON, BANTEN",28,72,151,223
https://kawalpemilu.org#53059,"KALITIMBANG, CIBEBER, KOTA CILEGON, BANTEN",1,60,158,218
https://kawalpemilu.org#53059,"KALITIMBANG, CIBEBER, KOTA CILEGON, BANTEN",2,88,109,197
https://kawalpemilu.org#53059,"KALITIMBANG, CIBEBER, KOTA CILEGON, BANTEN",3,38,155,193
https://kawalpemilu.org#53059,"KALITIMBANG, CIBEBER, KOTA CILEGON, BANTEN",4,51,169,220
https://kawalpemilu.org#53059,"KALITIMBANG, CIBEBER, KOTA CILEGON, BANTEN",5,52,160,212
https://kawalpemilu.org#53059,"KALITIMBANG, CIBEBER, KOTA CILEGON, BANTEN",6,73,127,200
https://kawalpemilu.org#53059,"KALITIMBANG, CIBEBER, KOTA CILEGON, BANTEN",7,48,160,208
https://kawalpemilu.org#53059,"KALITIMBANG, CIBEBER, KOTA CILEGON, BANTEN",8,55,192,247
https://kawalpemilu.org#53059,"KALITIMBANG, CIBEBER, KOTA CILEGON, BANTEN",9,69,171,240
https://kawalpemilu.org#53059,"KALITIMBANG, CIBEBER, KOTA CILEGON, BANTEN",10,51,166,217
https://kawalpemilu.org#53059,"KALITIMBANG, CIBEBER, KOTA CILEGON, BANTEN",11,65,185,250
https://kawalpemilu.org#53059,"KALITIMBANG, CIBEBER, KOTA CILEGON, BANTEN",12,48,166,214
https://kawalpemilu.org#53059,"KALITIMBANG, CIBEBER, KOTA CILEGON, BANTEN",13,57,128,185
https://kawalpemilu.org#53059,"KALITIMBANG, CIBEBER, KOTA CILEGON, BANTEN",14,54,146,200
https://kawalpemilu.org#53059,"KALITIMBANG, CIBEBER, KOTA CILEGON, BANTEN",15,60,92,152
https://kawalpemilu.org#53059,"KALITIMBANG, CIBEBER, KOTA CILEGON, BANTEN",16,162,26,188
https://kawalpemilu.org#53059,"KALITIMBANG, CIBEBER, KOTA CILEGON, BANTEN",17,70,123,193
https://kawalpemilu.org#53059,"KALITIMBANG, CIBEBER, KOTA CILEGON, BANTEN",18,49,129,178
https://kawalpemilu.org#53059,"KALITIMBANG, CIBEBER, KOTA CILEGON, BANTEN",19,68,94,162
https://kawalpemilu.org#53059,"KALITIMBANG, CIBEBER, KOTA CILEGON, BANTEN",20,49,113,162
https://kawalpemilu.org#53059,"KALITIMBANG, CIBEBER, KOTA CILEGON, BANTEN",21,22,98,120
https://kawalpemilu.org#53059,"KALITIMBANG, CIBEBER, KOTA CILEGON, BANTEN",22,24,87,111
https://kawalpemilu.org#53059,"KALITIMBANG, CIBEBER, KOTA CILEGON, BANTEN",23,27,71,98
https://kawalpemilu.org#53059,"KALITIMBANG, CIBEBER, KOTA CILEGON, BANTEN",24,29,76,105
https://kawalpemilu.org#53060,"BULAKAN, CIBEBER, KOTA CILEGON, BANTEN",1,33,164,197
https://kawalpemilu.org#53060,"BULAKAN, CIBEBER, KOTA CILEGON, BANTEN",2,43,145,188
https://kawalpemilu.org#53060,"BULAKAN, CIBEBER, KOTA CILEGON, BANTEN",3,97,147,244
https://kawalpemilu.org#53060,"BULAKAN, CIBEBER, KOTA CILEGON, BANTEN",4,38,116,154
https://kawalpemilu.org#53060,"BULAKAN, CIBEBER, KOTA CILEGON, BANTEN",5,68,191,259
https://kawalpemilu.org#53060,"BULAKAN, CIBEBER, KOTA CILEGON, BANTEN",6,81,127,208
https://kawalpemilu.org#53060,"BULAKAN, CIBEBER, KOTA CILEGON, BANTEN",7,70,115,185
https://kawalpemilu.org#53060,"BULAKAN, CIBEBER, KOTA CILEGON, BANTEN",8,42,147,189
https://kawalpemilu.org#53060,"BULAKAN, CIBEBER, KOTA CILEGON, BANTEN",9,83,148,231
https://kawalpemilu.org#53060,"BULAKAN, CIBEBER, KOTA CILEGON, BANTEN",10,60,160,220
https://kawalpemilu.org#53060,"BULAKAN, CIBEBER, KOTA CILEGON, BANTEN",11,27,68,95
https://kawalpemilu.org#53060,"BULAKAN, CIBEBER, KOTA CILEGON, BANTEN",12,44,145,189
https://kawalpemilu.org#53060,"BULAKAN, CIBEBER, KOTA CILEGON, BANTEN",13,74,144,218
https://kawalpemilu.org#53060,"BULAKAN, CIBEBER, KOTA CILEGON, BANTEN",14,81,135,216
https://kawalpemilu.org#53060,"BULAKAN, CIBEBER, KOTA CILEGON, BANTEN",15,50,109,159
https://kawalpemilu.org#53061,"CIKERAI, CIBEBER, KOTA CILEGON, BANTEN",1,38,131,169
https://kawalpemilu.org#53061,"CIKERAI, CIBEBER, KOTA CILEGON, BANTEN",2,57,134,191
https://kawalpemilu.org#53061,"CIKERAI, CIBEBER, KOTA CILEGON, BANTEN",3,72,90,162
https://kawalpemilu.org#53061,"CIKERAI, CIBEBER, KOTA CILEGON, BANTEN",4,68,91,159
https://kawalpemilu.org#53061,"CIKERAI, CIBEBER, KOTA CILEGON, BANTEN",5,69,78,147
https://kawalpemilu.org#53061,"CIKERAI, CIBEBER, KOTA CILEGON, BANTEN",6,36,134,170
https://kawalpemilu.org#53061,"CIKERAI, CIBEBER, KOTA CILEGON, BANTEN",7,41,111,152
https://kawalpemilu.org#53061,"CIKERAI, CIBEBER, KOTA CILEGON, BANTEN",8,78,124,202
https://kawalpemilu.org#53061,"CIKERAI, CIBEBER, KOTA CILEGON, BANTEN",9,85,111,196
https://kawalpemilu.org#53061,"CIKERAI, CIBEBER, KOTA CILEGON, BANTEN",10,58,179,237
https://kawalpemilu.org#53061,"CIKERAI, CIBEBER, KOTA CILEGON, BANTEN",11,40,162,202
https://kawalpemilu.org#53061,"CIKERAI, CIBEBER, KOTA CILEGON, BANTEN",12,43,121,164
https://kawalpemilu.org#53063,"BAGENDUNG, CILEGON, KOTA CILEGON, BANTEN",1,86,192,278
https://kawalpemilu.org#53063,"BAGENDUNG, CILEGON, KOTA CILEGON, BANTEN",2,44,218,262
https://kawalpemilu.org#53063,"BAGENDUNG, CILEGON, KOTA CILEGON, BANTEN",3,35,220,255
https://kawalpemilu.org#53063,"BAGENDUNG, CILEGON, KOTA CILEGON, BANTEN",4,28,173,201
https://kawalpemilu.org#53063,"BAGENDUNG, CILEGON, KOTA CILEGON, BANTEN",5,40,226,266
https://kawalpemilu.org#53063,"BAGENDUNG, CILEGON, KOTA CILEGON, BANTEN",6,50,159,209
https://kawalpemilu.org#53063,"BAGENDUNG, CILEGON, KOTA CILEGON, BANTEN",7,23,177,200
https://kawalpemilu.org#53063,"BAGENDUNG, CILEGON, KOTA CILEGON, BANTEN",8,85,140,225
https://kawalpemilu.org#53063,"BAGENDUNG, CILEGON, KOTA CILEGON, BANTEN",9,47,198,245
https://kawalpemilu.org#53063,"BAGENDUNG, CILEGON, KOTA CILEGON, BANTEN",10,68,186,254
https://kawalpemilu.org#53063,"BAGENDUNG, CILEGON, KOTA CILEGON, BANTEN",11,67,148,215
https://kawalpemilu.org#53063,"BAGENDUNG, CILEGON, KOTA CILEGON, BANTEN",12,78,178,256
https://kawalpemilu.org#53064,"CIWEDUS, CILEGON, KOTA CILEGON, BANTEN",1,58,203,261
https://kawalpemilu.org#53064,"CIWEDUS, CILEGON, KOTA CILEGON, BANTEN",2,27,204,231
https://kawalpemilu.org#53064,"CIWEDUS, CILEGON, KOTA CILEGON, BANTEN",3,43,221,264
https://kawalpemilu.org#53064,"CIWEDUS, CILEGON, KOTA CILEGON, BANTEN",4,53,162,215
https://kawalpemilu.org#53064,"CIWEDUS, CILEGON, KOTA CILEGON, BANTEN",5,54,155,209
https://kawalpemilu.org#53064,"CIWEDUS, CILEGON, KOTA CILEGON, BANTEN",6,73,151,224
https://kawalpemilu.org#53064,"CIWEDUS, CILEGON, KOTA CILEGON, BANTEN",7,93,178,271
https://kawalpemilu.org#53064,"CIWEDUS, CILEGON, KOTA CILEGON, BANTEN",8,79,152,231
https://kawalpemilu.org#53064,"CIWEDUS, CILEGON, KOTA CILEGON, BANTEN",9,81,162,243
https://kawalpemilu.org#53064,"CIWEDUS, CILEGON, KOTA CILEGON, BANTEN",10,46,196,242
https://kawalpemilu.org#53064,"CIWEDUS, CILEGON, KOTA CILEGON, BANTEN",11,71,174,245
https://kawalpemilu.org#53064,"CIWEDUS, CILEGON, KOTA CILEGON, BANTEN",12,45,190,235
https://kawalpemilu.org#53064,"CIWEDUS, CILEGON, KOTA CILEGON, BANTEN",13,61,150,211
https://kawalpemilu.org#53064,"CIWEDUS, CILEGON, KOTA CILEGON, BANTEN",14,46,82,128
https://kawalpemilu.org#53064,"CIWEDUS, CILEGON, KOTA CILEGON, BANTEN",15,103,123,226
https://kawalpemilu.org#53064,"CIWEDUS, CILEGON, KOTA CILEGON, BANTEN",16,92,119,211
https://kawalpemilu.org#53064,"CIWEDUS, CILEGON, KOTA CILEGON, BANTEN",17,81,147,228
https://kawalpemilu.org#53064,"CIWEDUS, CILEGON, KOTA CILEGON, BANTEN",18,99,152,251
https://kawalpemilu.org#53064,"CIWEDUS, CILEGON, KOTA CILEGON, BANTEN",19,73,139,212
https://kawalpemilu.org#53064,"CIWEDUS, CILEGON, KOTA CILEGON, BANTEN",20,50,98,148
https://kawalpemilu.org#53064,"CIWEDUS, CILEGON, KOTA CILEGON, BANTEN",21,66,142,208
https://kawalpemilu.org#53064,"CIWEDUS, CILEGON, KOTA CILEGON, BANTEN",22,103,135,238
https://kawalpemilu.org#53064,"CIWEDUS, CILEGON, KOTA CILEGON, BANTEN",23,96,144,240
https://kawalpemilu.org#53064,"CIWEDUS, CILEGON, KOTA CILEGON, BANTEN",24,77,117,194
https://kawalpemilu.org#53064,"CIWEDUS, CILEGON, KOTA CILEGON, BANTEN",25,78,115,193
https://kawalpemilu.org#53064,"CIWEDUS, CILEGON, KOTA CILEGON, BANTEN",26,77,110,187
https://kawalpemilu.org#53064,"CIWEDUS, CILEGON, KOTA CILEGON, BANTEN",27,52,103,155
https://kawalpemilu.org#53064,"CIWEDUS, CILEGON, KOTA CILEGON, BANTEN",28,62,146,208
https://kawalpemilu.org#53064,"CIWEDUS, CILEGON, KOTA CILEGON, BANTEN",29,67,174,241
https://kawalpemilu.org#53064,"CIWEDUS, CILEGON, KOTA CILEGON, BANTEN",30,79,142,221
https://kawalpemilu.org#53064,"CIWEDUS, CILEGON, KOTA CILEGON, BANTEN",31,60,160,220
https://kawalpemilu.org#53064,"CIWEDUS, CILEGON, KOTA CILEGON, BANTEN",32,46,170,216
https://kawalpemilu.org#53064,"CIWEDUS, CILEGON, KOTA CILEGON, BANTEN",33,48,193,241
https://kawalpemilu.org#53064,"CIWEDUS, CILEGON, KOTA CILEGON, BANTEN",34,49,100,149
https://kawalpemilu.org#53064,"CIWEDUS, CILEGON, KOTA CILEGON, BANTEN",35,37,116,153
https://kawalpemilu.org#53064,"CIWEDUS, CILEGON, KOTA CILEGON, BANTEN",36,47,91,138
https://kawalpemilu.org#53065,"BENDUNGAN, CILEGON, KOTA CILEGON, BANTEN",1,65,139,204
https://kawalpemilu.org#53065,"BENDUNGAN, CILEGON, KOTA CILEGON, BANTEN",2,58,134,192
https://kawalpemilu.org#53065,"BENDUNGAN, CILEGON, KOTA CILEGON, BANTEN",3,81,115,196
https://kawalpemilu.org#53065,"BENDUNGAN, CILEGON, KOTA CILEGON, BANTEN",4,105,162,267
https://kawalpemilu.org#53065,"BENDUNGAN, CILEGON, KOTA CILEGON, BANTEN",5,85,166,251
https://kawalpemilu.org#53065,"BENDUNGAN, CILEGON, KOTA CILEGON, BANTEN",6,61,210,271
https://kawalpemilu.org#53065,"BENDUNGAN, CILEGON, KOTA CILEGON, BANTEN",7,73,211,284
https://kawalpemilu.org#53065,"BENDUNGAN, CILEGON, KOTA CILEGON, BANTEN",8,59,143,202
https://kawalpemilu.org#53065,"BENDUNGAN, CILEGON, KOTA CILEGON, BANTEN",9,50,138,188
https://kawalpemilu.org#53065,"BENDUNGAN, CILEGON, KOTA CILEGON, BANTEN",10,93,200,293
https://kawalpemilu.org#53065,"BENDUNGAN, CILEGON, KOTA CILEGON, BANTEN",11,91,179,270
https://kawalpemilu.org#53065,"BENDUNGAN, CILEGON, KOTA CILEGON, BANTEN",12,73,159,232
https://kawalpemilu.org#53065,"BENDUNGAN, CILEGON, KOTA CILEGON, BANTEN",13,84,169,253
https://kawalpemilu.org#53065,"BENDUNGAN, CILEGON, KOTA CILEGON, BANTEN",14,107,96,203
https://kawalpemilu.org#53065,"BENDUNGAN, CILEGON, KOTA CILEGON, BANTEN",15,63,188,251
https://kawalpemilu.org#53065,"BENDUNGAN, CILEGON, KOTA CILEGON, BANTEN",16,91,161,252
https://kawalpemilu.org#53065,"BENDUNGAN, CILEGON, KOTA CILEGON, BANTEN",17,99,147,246
https://kawalpemilu.org#53065,"BENDUNGAN, CILEGON, KOTA CILEGON, BANTEN",18,76,157,233
https://kawalpemilu.org#53065,"BENDUNGAN, CILEGON, KOTA CILEGON, BANTEN",19,90,187,277
https://kawalpemilu.org#53065,"BENDUNGAN, CILEGON, KOTA CILEGON, BANTEN",20,201,81,282
https://kawalpemilu.org#53065,"BENDUNGAN, CILEGON, KOTA CILEGON, BANTEN",21,82,165,247
https://kawalpemilu.org#53065,"BENDUNGAN, CILEGON, KOTA CILEGON, BANTEN",22,84,98,182
https://kawalpemilu.org#53065,"BENDUNGAN, CILEGON, KOTA CILEGON, BANTEN",23,40,123,163
https://kawalpemilu.org#53065,"BENDUNGAN, CILEGON, KOTA CILEGON, BANTEN",24,65,97,162
https://kawalpemilu.org#53065,"BENDUNGAN, CILEGON, KOTA CILEGON, BANTEN",25,81,168,249
https://kawalpemilu.org#53066,"KETILENG, CILEGON, KOTA CILEGON, BANTEN",1,122,147,269
https://kawalpemilu.org#53066,"KETILENG, CILEGON, KOTA CILEGON, BANTEN",2,79,158,237
https://kawalpemilu.org#53066,"KETILENG, CILEGON, KOTA CILEGON, BANTEN",3,63,202,265
https://kawalpemilu.org#53066,"KETILENG, CILEGON, KOTA CILEGON, BANTEN",4,84,145,229
https://kawalpemilu.org#53066,"KETILENG, CILEGON, KOTA CILEGON, BANTEN",5,103,103,206
https://kawalpemilu.org#53066,"KETILENG, CILEGON, KOTA CILEGON, BANTEN",6,57,207,264
https://kawalpemilu.org#53066,"KETILENG, CILEGON, KOTA CILEGON, BANTEN",8,44,198,242
https://kawalpemilu.org#53066,"KETILENG, CILEGON, KOTA CILEGON, BANTEN",9,80,157,237
https://kawalpemilu.org#53066,"KETILENG, CILEGON, KOTA CILEGON, BANTEN",10,78,156,234
https://kawalpemilu.org#53066,"KETILENG, CILEGON, KOTA CILEGON, BANTEN",11,79,168,247
https://kawalpemilu.org#53066,"KETILENG, CILEGON, KOTA CILEGON, BANTEN",12,67,159,226
https://kawalpemilu.org#53066,"KETILENG, CILEGON, KOTA CILEGON, BANTEN",13,81,157,238
https://kawalpemilu.org#53066,"KETILENG, CILEGON, KOTA CILEGON, BANTEN",14,64,208,272
https://kawalpemilu.org#53066,"KETILENG, CILEGON, KOTA CILEGON, BANTEN",15,89,171,260
https://kawalpemilu.org#53066,"KETILENG, CILEGON, KOTA CILEGON, BANTEN",16,105,137,242
https://kawalpemilu.org#53066,"KETILENG, CILEGON, KOTA CILEGON, BANTEN",17,191,62,253
https://kawalpemilu.org#53067,"CIWADUK, CILEGON, KOTA CILEGON, BANTEN",1,58,166,224
https://kawalpemilu.org#53067,"CIWADUK, CILEGON, KOTA CILEGON, BANTEN",2,61,136,197
https://kawalpemilu.org#53067,"CIWADUK, CILEGON, KOTA CILEGON, BANTEN",3,63,137,200
https://kawalpemilu.org#53067,"CIWADUK, CILEGON, KOTA CILEGON, BANTEN",4,84,151,235
https://kawalpemilu.org#53067,"CIWADUK, CILEGON, KOTA CILEGON, BANTEN",5,57,107,164
https://kawalpemilu.org#53067,"CIWADUK, CILEGON, KOTA CILEGON, BANTEN",6,88,111,199
https://kawalpemilu.org#53067,"CIWADUK, CILEGON, KOTA CILEGON, BANTEN",7,48,159,207
https://kawalpemilu.org#53067,"CIWADUK, CILEGON, KOTA CILEGON, BANTEN",8,52,165,217
https://kawalpemilu.org#53067,"CIWADUK, CILEGON, KOTA CILEGON, BANTEN",9,47,165,212
https://kawalpemilu.org#53067,"CIWADUK, CILEGON, KOTA CILEGON, BANTEN",10,70,169,239
https://kawalpemilu.org#53067,"CIWADUK, CILEGON, KOTA CILEGON, BANTEN",11,54,121,175
https://kawalpemilu.org#53067,"CIWADUK, CILEGON, KOTA CILEGON, BANTEN",12,51,180,231
https://kawalpemilu.org#53067,"CIWADUK, CILEGON, KOTA CILEGON, BANTEN",13,64,147,211
https://kawalpemilu.org#53067,"CIWADUK, CILEGON, KOTA CILEGON, BANTEN",14,64,139,203
https://kawalpemilu.org#53067,"CIWADUK, CILEGON, KOTA CILEGON, BANTEN",15,98,160,258
https://kawalpemilu.org#53067,"CIWADUK, CILEGON, KOTA CILEGON, BANTEN",16,90,143,233
https://kawalpemilu.org#53067,"CIWADUK, CILEGON, KOTA CILEGON, BANTEN",17,76,144,220
https://kawalpemilu.org#53067,"CIWADUK, CILEGON, KOTA CILEGON, BANTEN",18,64,60,124
https://kawalpemilu.org#53067,"CIWADUK, CILEGON, KOTA CILEGON, BANTEN",19,65,92,157
https://kawalpemilu.org#53067,"CIWADUK, CILEGON, KOTA CILEGON, BANTEN",20,51,63,114
https://kawalpemilu.org#53067,"CIWADUK, CILEGON, KOTA CILEGON, BANTEN",21,34,123,157
https://kawalpemilu.org#53067,"CIWADUK, CILEGON, KOTA CILEGON, BANTEN",22,99,147,246
https://kawalpemilu.org#53067,"CIWADUK, CILEGON, KOTA CILEGON, BANTEN",23,39,103,142
https://kawalpemilu.org#53067,"CIWADUK, CILEGON, KOTA CILEGON, BANTEN",24,88,191,279
https://kawalpemilu.org#53067,"CIWADUK, CILEGON, KOTA CILEGON, BANTEN",25,51,94,145
https://kawalpemilu.org#53067,"CIWADUK, CILEGON, KOTA CILEGON, BANTEN",26,36,178,214
https://kawalpemilu.org#53067,"CIWADUK, CILEGON, KOTA CILEGON, BANTEN",27,70,173,243
https://kawalpemilu.org#53067,"CIWADUK, CILEGON, KOTA CILEGON, BANTEN",28,121,137,258
https://kawalpemilu.org#53067,"CIWADUK, CILEGON, KOTA CILEGON, BANTEN",29,62,164,226
https://kawalpemilu.org#53067,"CIWADUK, CILEGON, KOTA CILEGON, BANTEN",30,94,128,222
https://kawalpemilu.org#53067,"CIWADUK, CILEGON, KOTA CILEGON, BANTEN",31,53,169,222
https://kawalpemilu.org#53067,"CIWADUK, CILEGON, KOTA CILEGON, BANTEN",32,50,169,219
https://kawalpemilu.org#53067,"CIWADUK, CILEGON, KOTA CILEGON, BANTEN",33,88,133,221
https://kawalpemilu.org#53067,"CIWADUK, CILEGON, KOTA CILEGON, BANTEN",34,67,175,242
https://kawalpemilu.org#53067,"CIWADUK, CILEGON, KOTA CILEGON, BANTEN",35,35,104,139
https://kawalpemilu.org#53069,"TAMANSARI, PULOMERAK, KOTA CILEGON, BANTEN",1,59,86,145
https://kawalpemilu.org#53069,"TAMANSARI, PULOMERAK, KOTA CILEGON, BANTEN",2,94,45,139
https://kawalpemilu.org#53069,"TAMANSARI, PULOMERAK, KOTA CILEGON, BANTEN",3,111,79,190
https://kawalpemilu.org#53069,"TAMANSARI, PULOMERAK, KOTA CILEGON, BANTEN",4,93,45,138
https://kawalpemilu.org#53069,"TAMANSARI, PULOMERAK, KOTA CILEGON, BANTEN",5,96,41,137
https://kawalpemilu.org#53069,"TAMANSARI, PULOMERAK, KOTA CILEGON, BANTEN",6,115,54,169
https://kawalpemilu.org#53069,"TAMANSARI, PULOMERAK, KOTA CILEGON, BANTEN",7,76,29,105
https://kawalpemilu.org#53069,"TAMANSARI, PULOMERAK, KOTA CILEGON, BANTEN",8,118,88,206
https://kawalpemilu.org#53069,"TAMANSARI, PULOMERAK, KOTA CILEGON, BANTEN",9,115,112,227
https://kawalpemilu.org#53069,"TAMANSARI, PULOMERAK, KOTA CILEGON, BANTEN",10,119,77,196
https://kawalpemilu.org#53069,"TAMANSARI, PULOMERAK, KOTA CILEGON, BANTEN",11,88,61,149
https://kawalpemilu.org#53069,"TAMANSARI, PULOMERAK, KOTA CILEGON, BANTEN",12,94,109,203
https://kawalpemilu.org#53069,"TAMANSARI, PULOMERAK, KOTA CILEGON, BANTEN",13,127,121,248
https://kawalpemilu.org#53069,"TAMANSARI, PULOMERAK, KOTA CILEGON, BANTEN",14,84,144,228
https://kawalpemilu.org#53069,"TAMANSARI, PULOMERAK, KOTA CILEGON, BANTEN",15,150,92,242
https://kawalpemilu.org#53069,"TAMANSARI, PULOMERAK, KOTA CILEGON, BANTEN",16,90,84,174
https://kawalpemilu.org#53069,"TAMANSARI, PULOMERAK, KOTA CILEGON, BANTEN",17,72,121,193
https://kawalpemilu.org#53069,"TAMANSARI, PULOMERAK, KOTA CILEGON, BANTEN",18,75,171,246
https://kawalpemilu.org#53069,"TAMANSARI, PULOMERAK, KOTA CILEGON, BANTEN",19,86,78,164
https://kawalpemilu.org#53069,"TAMANSARI, PULOMERAK, KOTA CILEGON, BANTEN",20,66,89,155
https://kawalpemilu.org#53069,"TAMANSARI, PULOMERAK, KOTA CILEGON, BANTEN",21,89,80,166
https://kawalpemilu.org#53069,"TAMANSARI, PULOMERAK, KOTA CILEGON, BANTEN",22,112,111,223
https://kawalpemilu.org#53069,"TAMANSARI, PULOMERAK, KOTA CILEGON, BANTEN",23,82,125,207
https://kawalpemilu.org#53069,"TAMANSARI, PULOMERAK, KOTA CILEGON, BANTEN",24,92,152,244
https://kawalpemilu.org#53069,"TAMANSARI, PULOMERAK, KOTA CILEGON, BANTEN",25,120,133,253
https://kawalpemilu.org#53069,"TAMANSARI, PULOMERAK, KOTA CILEGON, BANTEN",26,99,154,253
https://kawalpemilu.org#53069,"TAMANSARI, PULOMERAK, KOTA CILEGON, BANTEN",27,120,106,226
https://kawalpemilu.org#53069,"TAMANSARI, PULOMERAK, KOTA CILEGON, BANTEN",28,97,69,166
https://kawalpemilu.org#53069,"TAMANSARI, PULOMERAK, KOTA CILEGON, BANTEN",29,42,150,192
https://kawalpemilu.org#53069,"TAMANSARI, PULOMERAK, KOTA CILEGON, BANTEN",30,34,113,147
https://kawalpemilu.org#53069,"TAMANSARI, PULOMERAK, KOTA CILEGON, BANTEN",31,91,95,186
https://kawalpemilu.org#53069,"TAMANSARI, PULOMERAK, KOTA CILEGON, BANTEN",32,108,162,270
https://kawalpemilu.org#53069,"TAMANSARI, PULOMERAK, KOTA CILEGON, BANTEN",33,76,117,193
https://kawalpemilu.org#53069,"TAMANSARI, PULOMERAK, KOTA CILEGON, BANTEN",34,120,84,204
https://kawalpemilu.org#53069,"TAMANSARI, PULOMERAK, KOTA CILEGON, BANTEN",35,81,166,247
https://kawalpemilu.org#53069,"TAMANSARI, PULOMERAK, KOTA CILEGON, BANTEN",36,65,144,209
https://kawalpemilu.org#53069,"TAMANSARI, PULOMERAK, KOTA CILEGON, BANTEN",37,55,143,198
https://kawalpemilu.org#53069,"TAMANSARI, PULOMERAK, KOTA CILEGON, BANTEN",38,57,160,217
https://kawalpemilu.org#53069,"TAMANSARI, PULOMERAK, KOTA CILEGON, BANTEN",39,149,71,220
https://kawalpemilu.org#53069,"TAMANSARI, PULOMERAK, KOTA CILEGON, BANTEN",40,141,61,202
https://kawalpemilu.org#53069,"TAMANSARI, PULOMERAK, KOTA CILEGON, BANTEN",41,130,39,168
https://kawalpemilu.org#53069,"TAMANSARI, PULOMERAK, KOTA CILEGON, BANTEN",42,94,56,150
https://kawalpemilu.org#53069,"TAMANSARI, PULOMERAK, KOTA CILEGON, BANTEN",43,141,80,221
https://kawalpemilu.org#53069,"TAMANSARI, PULOMERAK, KOTA CILEGON, BANTEN",44,45,156,201
https://kawalpemilu.org#53069,"TAMANSARI, PULOMERAK, KOTA CILEGON, BANTEN",45,77,71,148
https://kawalpemilu.org#53070,"LEBAKGEDE, PULOMERAK, KOTA CILEGON, BANTEN",1,88,156,244
https://kawalpemilu.org#53070,"LEBAKGEDE, PULOMERAK, KOTA CILEGON, BANTEN",2,113,87,200
https://kawalpemilu.org#53070,"LEBAKGEDE, PULOMERAK, KOTA CILEGON, BANTEN",3,107,131,238
https://kawalpemilu.org#53070,"LEBAKGEDE, PULOMERAK, KOTA CILEGON, BANTEN",4,66,46,112
https://kawalpemilu.org#53070,"LEBAKGEDE, PULOMERAK, KOTA CILEGON, BANTEN",5,99,139,238
https://kawalpemilu.org#53070,"LEBAKGEDE, PULOMERAK, KOTA CILEGON, BANTEN",6,86,172,258
https://kawalpemilu.org#53070,"LEBAKGEDE, PULOMERAK, KOTA CILEGON, BANTEN",7,56,113,169
https://kawalpemilu.org#53070,"LEBAKGEDE, PULOMERAK, KOTA CILEGON, BANTEN",8,57,200,257
https://kawalpemilu.org#53070,"LEBAKGEDE, PULOMERAK, KOTA CILEGON, BANTEN",9,53,176,229
https://kawalpemilu.org#53070,"LEBAKGEDE, PULOMERAK, KOTA CILEGON, BANTEN",10,65,137,202
https://kawalpemilu.org#53070,"LEBAKGEDE, PULOMERAK, KOTA CILEGON, BANTEN",11,64,114,178
https://kawalpemilu.org#53070,"LEBAKGEDE, PULOMERAK, KOTA CILEGON, BANTEN",12,56,96,152
https://kawalpemilu.org#53070,"LEBAKGEDE, PULOMERAK, KOTA CILEGON, BANTEN",13,33,115,148
https://kawalpemilu.org#53070,"LEBAKGEDE, PULOMERAK, KOTA CILEGON, BANTEN",14,93,99,192
https://kawalpemilu.org#53070,"LEBAKGEDE, PULOMERAK, KOTA CILEGON, BANTEN",15,63,94,157
https://kawalpemilu.org#53070,"LEBAKGEDE, PULOMERAK, KOTA CILEGON, BANTEN",16,81,159,240
https://kawalpemilu.org#53070,"LEBAKGEDE, PULOMERAK, KOTA CILEGON, BANTEN",17,22,101,123
https://kawalpemilu.org#53070,"LEBAKGEDE, PULOMERAK, KOTA CILEGON, BANTEN",18,68,183,251
https://kawalpemilu.org#53070,"LEBAKGEDE, PULOMERAK, KOTA CILEGON, BANTEN",19,42,71,113
https://kawalpemilu.org#53070,"LEBAKGEDE, PULOMERAK, KOTA CILEGON, BANTEN",20,93,103,196
https://kawalpemilu.org#53070,"LEBAKGEDE, PULOMERAK, KOTA CILEGON, BANTEN",21,73,107,180
https://kawalpemilu.org#53070,"LEBAKGEDE, PULOMERAK, KOTA CILEGON, BANTEN",22,68,70,138
https://kawalpemilu.org#53070,"LEBAKGEDE, PULOMERAK, KOTA CILEGON, BANTEN",23,122,62,184
https://kawalpemilu.org#53070,"LEBAKGEDE, PULOMERAK, KOTA CILEGON, BANTEN",24,48,46,94
https://kawalpemilu.org#53070,"LEBAKGEDE, PULOMERAK, KOTA CILEGON, BANTEN",25,138,98,236
https://kawalpemilu.org#53070,"LEBAKGEDE, PULOMERAK, KOTA CILEGON, BANTEN",26,62,42,104
https://kawalpemilu.org#53070,"LEBAKGEDE, PULOMERAK, KOTA CILEGON, BANTEN",27,45,60,105
https://kawalpemilu.org#53070,"LEBAKGEDE, PULOMERAK, KOTA CILEGON, BANTEN",28,98,52,150
https://kawalpemilu.org#53070,"LEBAKGEDE, PULOMERAK, KOTA CILEGON, BANTEN",29,100,54,154
https://kawalpemilu.org#53070,"LEBAKGEDE, PULOMERAK, KOTA CILEGON, BANTEN",30,124,83,207
https://kawalpemilu.org#53070,"LEBAKGEDE, PULOMERAK, KOTA CILEGON, BANTEN",31,86,56,142
https://kawalpemilu.org#53070,"LEBAKGEDE, PULOMERAK, KOTA CILEGON, BANTEN",32,64,165,229
https://kawalpemilu.org#53070,"LEBAKGEDE, PULOMERAK, KOTA CILEGON, BANTEN",33,39,196,235
https://kawalpemilu.org#53070,"LEBAKGEDE, PULOMERAK, KOTA CILEGON, BANTEN",34,49,128,177
https://kawalpemilu.org#53070,"LEBAKGEDE, PULOMERAK, KOTA CILEGON, BANTEN",35,38,182,220
https://kawalpemilu.org#53070,"LEBAKGEDE, PULOMERAK, KOTA CILEGON, BANTEN",36,52,128,180
https://kawalpemilu.org#53070,"LEBAKGEDE, PULOMERAK, KOTA CILEGON, BANTEN",37,25,135,160
https://kawalpemilu.org#53070,"LEBAKGEDE, PULOMERAK, KOTA CILEGON, BANTEN",38,30,120,150
https://kawalpemilu.org#53070,"LEBAKGEDE, PULOMERAK, KOTA CILEGON, BANTEN",39,13,165,178
https://kawalpemilu.org#53070,"LEBAKGEDE, PULOMERAK, KOTA CILEGON, BANTEN",40,6,105,111
https://kawalpemilu.org#53070,"LEBAKGEDE, PULOMERAK, KOTA CILEGON, BANTEN",41,36,181,217
https://kawalpemilu.org#53070,"LEBAKGEDE, PULOMERAK, KOTA CILEGON, BANTEN",42,27,91,118
https://kawalpemilu.org#53070,"LEBAKGEDE, PULOMERAK, KOTA CILEGON, BANTEN",43,19,179,198
https://kawalpemilu.org#53070,"LEBAKGEDE, PULOMERAK, KOTA CILEGON, BANTEN",44,9,68,77
https://kawalpemilu.org#53071,"MEKARSARI, PULOMERAK, KOTA CILEGON, BANTEN",1,54,73,127
https://kawalpemilu.org#53071,"MEKARSARI, PULOMERAK, KOTA CILEGON, BANTEN",2,53,134,187
https://kawalpemilu.org#53071,"MEKARSARI, PULOMERAK, KOTA CILEGON, BANTEN",3,90,103,193
https://kawalpemilu.org#53071,"MEKARSARI, PULOMERAK, KOTA CILEGON, BANTEN",4,85,82,167
https://kawalpemilu.org#53071,"MEKARSARI, PULOMERAK, KOTA CILEGON, BANTEN",5,132,123,255
https://kawalpemilu.org#53071,"MEKARSARI, PULOMERAK, KOTA CILEGON, BANTEN",6,31,154,185
https://kawalpemilu.org#53071,"MEKARSARI, PULOMERAK, KOTA CILEGON, BANTEN",7,37,156,193
https://kawalpemilu.org#53071,"MEKARSARI, PULOMERAK, KOTA CILEGON, BANTEN",8,58,101,159
https://kawalpemilu.org#53071,"MEKARSARI, PULOMERAK, KOTA CILEGON, BANTEN",9,62,192,254
https://kawalpemilu.org#53071,"MEKARSARI, PULOMERAK, KOTA CILEGON, BANTEN",10,31,119,150
https://kawalpemilu.org#53071,"MEKARSARI, PULOMERAK, KOTA CILEGON, BANTEN",11,26,92,118
https://kawalpemilu.org#53071,"MEKARSARI, PULOMERAK, KOTA CILEGON, BANTEN",12,39,148,187
https://kawalpemilu.org#53071,"MEKARSARI, PULOMERAK, KOTA CILEGON, BANTEN",13,22,135,157
https://kawalpemilu.org#53071,"MEKARSARI, PULOMERAK, KOTA CILEGON, BANTEN",14,20,143,171
https://kawalpemilu.org#53071,"MEKARSARI, PULOMERAK, KOTA CILEGON, BANTEN",15,30,167,197
https://kawalpemilu.org#53071,"MEKARSARI, PULOMERAK, KOTA CILEGON, BANTEN",16,36,185,221
https://kawalpemilu.org#53071,"MEKARSARI, PULOMERAK, KOTA CILEGON, BANTEN",17,36,172,208
https://kawalpemilu.org#53071,"MEKARSARI, PULOMERAK, KOTA CILEGON, BANTEN",18,68,175,243
https://kawalpemilu.org#53071,"MEKARSARI, PULOMERAK, KOTA CILEGON, BANTEN",19,72,148,220
https://kawalpemilu.org#53071,"MEKARSARI, PULOMERAK, KOTA CILEGON, BANTEN",20,90,153,243
https://kawalpemilu.org#53071,"MEKARSARI, PULOMERAK, KOTA CILEGON, BANTEN",21,68,67,135
https://kawalpemilu.org#53071,"MEKARSARI, PULOMERAK, KOTA CILEGON, BANTEN",22,113,72,185
https://kawalpemilu.org#53071,"MEKARSARI, PULOMERAK, KOTA CILEGON, BANTEN",23,108,38,146
https://kawalpemilu.org#53071,"MEKARSARI, PULOMERAK, KOTA CILEGON, BANTEN",24,59,139,198
https://kawalpemilu.org#53071,"MEKARSARI, PULOMERAK, KOTA CILEGON, BANTEN",25,98,97,195
https://kawalpemilu.org#53071,"MEKARSARI, PULOMERAK, KOTA CILEGON, BANTEN",26,124,124,248
https://kawalpemilu.org#53071,"MEKARSARI, PULOMERAK, KOTA CILEGON, BANTEN",27,85,81,166
https://kawalpemilu.org#53071,"MEKARSARI, PULOMERAK, KOTA CILEGON, BANTEN",28,108,112,220
https://kawalpemilu.org#53071,"MEKARSARI, PULOMERAK, KOTA CILEGON, BANTEN",29,77,85,162
https://kawalpemilu.org#53071,"MEKARSARI, PULOMERAK, KOTA CILEGON, BANTEN",30,90,84,174
https://kawalpemilu.org#53071,"MEKARSARI, PULOMERAK, KOTA CILEGON, BANTEN",31,86,151,237
https://kawalpemilu.org#53071,"MEKARSARI, PULOMERAK, KOTA CILEGON, BANTEN",32,66,181,247
https://kawalpemilu.org#53071,"MEKARSARI, PULOMERAK, KOTA CILEGON, BANTEN",33,145,88,233
https://kawalpemilu.org#53071,"MEKARSARI, PULOMERAK, KOTA CILEGON, BANTEN",34,74,78,152
https://kawalpemilu.org#53071,"MEKARSARI, PULOMERAK, KOTA CILEGON, BANTEN",35,74,88,162
https://kawalpemilu.org#53071,"MEKARSARI, PULOMERAK, KOTA CILEGON, BANTEN",36,68,109,177
https://kawalpemilu.org#53071,"MEKARSARI, PULOMERAK, KOTA CILEGON, BANTEN",37,79,93,172
https://kawalpemilu.org#53071,"MEKARSARI, PULOMERAK, KOTA CILEGON, BANTEN",38,43,72,115
https://kawalpemilu.org#53071,"MEKARSARI, PULOMERAK, KOTA CILEGON, BANTEN",39,61,58,119
https://kawalpemilu.org#53072,"SURALAYA, PULOMERAK, KOTA CILEGON, BANTEN",1,83,173,256
https://kawalpemilu.org#53072,"SURALAYA, PULOMERAK, KOTA CILEGON, BANTEN",2,29,142,171
https://kawalpemilu.org#53072,"SURALAYA, PULOMERAK, KOTA CILEGON, BANTEN",3,48,148,196
https://kawalpemilu.org#53072,"SURALAYA, PULOMERAK, KOTA CILEGON, BANTEN",4,112,163,275
https://kawalpemilu.org#53072,"SURALAYA, PULOMERAK, KOTA CILEGON, BANTEN",5,43,188,231
https://kawalpemilu.org#53072,"SURALAYA, PULOMERAK, KOTA CILEGON, BANTEN",6,37,190,227
https://kawalpemilu.org#53072,"SURALAYA, PULOMERAK, KOTA CILEGON, BANTEN",7,57,145,202
https://kawalpemilu.org#53072,"SURALAYA, PULOMERAK, KOTA CILEGON, BANTEN",8,38,175,213
https://kawalpemilu.org#53072,"SURALAYA, PULOMERAK, KOTA CILEGON, BANTEN",9,77,197,274
https://kawalpemilu.org#53072,"SURALAYA, PULOMERAK, KOTA CILEGON, BANTEN",10,95,183,278
https://kawalpemilu.org#53072,"SURALAYA, PULOMERAK, KOTA CILEGON, BANTEN",11,111,152,263
https://kawalpemilu.org#53072,"SURALAYA, PULOMERAK, KOTA CILEGON, BANTEN",12,92,102,194
https://kawalpemilu.org#53072,"SURALAYA, PULOMERAK, KOTA CILEGON, BANTEN",13,48,160,208
https://kawalpemilu.org#53072,"SURALAYA, PULOMERAK, KOTA CILEGON, BANTEN",14,51,149,200
https://kawalpemilu.org#53072,"SURALAYA, PULOMERAK, KOTA CILEGON, BANTEN",15,41,213,254
https://kawalpemilu.org#53072,"SURALAYA, PULOMERAK, KOTA CILEGON, BANTEN",16,33,105,138
https://kawalpemilu.org#53072,"SURALAYA, PULOMERAK, KOTA CILEGON, BANTEN",17,62,47,109
https://kawalpemilu.org#53072,"SURALAYA, PULOMERAK, KOTA CILEGON, BANTEN",18,61,33,94
https://kawalpemilu.org#53072,"SURALAYA, PULOMERAK, KOTA CILEGON, BANTEN",19,61,88,149
https://kawalpemilu.org#53072,"SURALAYA, PULOMERAK, KOTA CILEGON, BANTEN",20,19,105,124
https://kawalpemilu.org#53074,"BANJAR NEGARA, CIWANDAN, KOTA CILEGON, BANTEN",1,37,195,232
https://kawalpemilu.org#53074,"BANJAR NEGARA, CIWANDAN, KOTA CILEGON, BANTEN",2,40,212,252
https://kawalpemilu.org#53074,"BANJAR NEGARA, CIWANDAN, KOTA CILEGON, BANTEN",3,35,210,245
https://kawalpemilu.org#53074,"BANJAR NEGARA, CIWANDAN, KOTA CILEGON, BANTEN",4,19,196,215
https://kawalpemilu.org#53074,"BANJAR NEGARA, CIWANDAN, KOTA CILEGON, BANTEN",5,28,219,247
https://kawalpemilu.org#53074,"BANJAR NEGARA, CIWANDAN, KOTA CILEGON, BANTEN",6,45,148,193
https://kawalpemilu.org#53074,"BANJAR NEGARA, CIWANDAN, KOTA CILEGON, BANTEN",7,44,168,212
https://kawalpemilu.org#53074,"BANJAR NEGARA, CIWANDAN, KOTA CILEGON, BANTEN",8,53,174,227
https://kawalpemilu.org#53074,"BANJAR NEGARA, CIWANDAN, KOTA CILEGON, BANTEN",9,42,157,199
https://kawalpemilu.org#53074,"BANJAR NEGARA, CIWANDAN, KOTA CILEGON, BANTEN",10,44,163,207
https://kawalpemilu.org#53074,"BANJAR NEGARA, CIWANDAN, KOTA CILEGON, BANTEN",11,46,162,208
https://kawalpemilu.org#53074,"BANJAR NEGARA, CIWANDAN, KOTA CILEGON, BANTEN",12,22,216,238
https://kawalpemilu.org#53074,"BANJAR NEGARA, CIWANDAN, KOTA CILEGON, BANTEN",13,40,215,255
https://kawalpemilu.org#53074,"BANJAR NEGARA, CIWANDAN, KOTA CILEGON, BANTEN",14,0,0,0
https://kawalpemilu.org#53074,"BANJAR NEGARA, CIWANDAN, KOTA CILEGON, BANTEN",15,36,152,188
https://kawalpemilu.org#53074,"BANJAR NEGARA, CIWANDAN, KOTA CILEGON, BANTEN",16,44,188,232
https://kawalpemilu.org#53074,"BANJAR NEGARA, CIWANDAN, KOTA CILEGON, BANTEN",17,58,165,223
https://kawalpemilu.org#53074,"BANJAR NEGARA, CIWANDAN, KOTA CILEGON, BANTEN",18,30,184,214
https://kawalpemilu.org#53074,"BANJAR NEGARA, CIWANDAN, KOTA CILEGON, BANTEN",19,18,170,188
https://kawalpemilu.org#53074,"BANJAR NEGARA, CIWANDAN, KOTA CILEGON, BANTEN",20,35,165,200
https://kawalpemilu.org#53075,"TEGAL RATU, CIWANDAN, KOTA CILEGON, BANTEN",1,34,179,213
https://kawalpemilu.org#53075,"TEGAL RATU, CIWANDAN, KOTA CILEGON, BANTEN",2,41,190,231
https://kawalpemilu.org#53075,"TEGAL RATU, CIWANDAN, KOTA CILEGON, BANTEN",3,42,181,223
https://kawalpemilu.org#53075,"TEGAL RATU, CIWANDAN, KOTA CILEGON, BANTEN",4,64,149,213
https://kawalpemilu.org#53075,"TEGAL RATU, CIWANDAN, KOTA CILEGON, BANTEN",5,52,202,254
https://kawalpemilu.org#53075,"TEGAL RATU, CIWANDAN, KOTA CILEGON, BANTEN",6,33,231,264
https://kawalpemilu.org#53075,"TEGAL RATU, CIWANDAN, KOTA CILEGON, BANTEN",7,45,212,257
https://kawalpemilu.org#53075,"TEGAL RATU, CIWANDAN, KOTA CILEGON, BANTEN",8,36,233,269
https://kawalpemilu.org#53075,"TEGAL RATU, CIWANDAN, KOTA CILEGON, BANTEN",9,33,222,255
https://kawalpemilu.org#53075,"TEGAL RATU, CIWANDAN, KOTA CILEGON, BANTEN",10,51,207,258
https://kawalpemilu.org#53075,"TEGAL RATU, CIWANDAN, KOTA CILEGON, BANTEN",11,18,219,237
https://kawalpemilu.org#53075,"TEGAL RATU, CIWANDAN, KOTA CILEGON, BANTEN",12,31,183,214
https://kawalpemilu.org#53075,"TEGAL RATU, CIWANDAN, KOTA CILEGON, BANTEN",13,21,225,246
https://kawalpemilu.org#53075,"TEGAL RATU, CIWANDAN, KOTA CILEGON, BANTEN",14,24,151,175
https://kawalpemilu.org#53075,"TEGAL RATU, CIWANDAN, KOTA CILEGON, BANTEN",15,30,187,217
https://kawalpemilu.org#53075,"TEGAL RATU, CIWANDAN, KOTA CILEGON, BANTEN",16,24,194,218
https://kawalpemilu.org#53075,"TEGAL RATU, CIWANDAN, KOTA CILEGON, BANTEN",17,33,244,277
https://kawalpemilu.org#53075,"TEGAL RATU, CIWANDAN, KOTA CILEGON, BANTEN",18,52,194,246
https://kawalpemilu.org#53075,"TEGAL RATU, CIWANDAN, KOTA CILEGON, BANTEN",19,41,156,197
https://kawalpemilu.org#53075,"TEGAL RATU, CIWANDAN, KOTA CILEGON, BANTEN",20,43,182,225
https://kawalpemilu.org#53075,"TEGAL RATU, CIWANDAN, KOTA CILEGON, BANTEN",21,57,202,259
https://kawalpemilu.org#53075,"TEGAL RATU, CIWANDAN, KOTA CILEGON, BANTEN",22,29,200,229
https://kawalpemilu.org#53075,"TEGAL RATU, CIWANDAN, KOTA CILEGON, BANTEN",23,29,204,233
https://kawalpemilu.org#53075,"TEGAL RATU, CIWANDAN, KOTA CILEGON, BANTEN",24,50,92,142
https://kawalpemilu.org#53075,"TEGAL RATU, CIWANDAN, KOTA CILEGON, BANTEN",25,70,164,234
https://kawalpemilu.org#53075,"TEGAL RATU, CIWANDAN, KOTA CILEGON, BANTEN",26,62,183,245
https://kawalpemilu.org#53075,"TEGAL RATU, CIWANDAN, KOTA CILEGON, BANTEN",27,53,181,234
https://kawalpemilu.org#53075,"TEGAL RATU, CIWANDAN, KOTA CILEGON, BANTEN",28,29,185,214
https://kawalpemilu.org#53075,"TEGAL RATU, CIWANDAN, KOTA CILEGON, BANTEN",29,18,133,151
https://kawalpemilu.org#53076,"KUBANGSARI, CIWANDAN, KOTA CILEGON, BANTEN",1,35,213,248
https://kawalpemilu.org#53076,"KUBANGSARI, CIWANDAN, KOTA CILEGON, BANTEN",2,30,183,213
https://kawalpemilu.org#53076,"KUBANGSARI, CIWANDAN, KOTA CILEGON, BANTEN",3,31,200,231
https://kawalpemilu.org#53076,"KUBANGSARI, CIWANDAN, KOTA CILEGON, BANTEN",4,27,182,209
https://kawalpemilu.org#53076,"KUBANGSARI, CIWANDAN, KOTA CILEGON, BANTEN",5,38,208,246
https://kawalpemilu.org#53076,"KUBANGSARI, CIWANDAN, KOTA CILEGON, BANTEN",6,45,221,266
https://kawalpemilu.org#53076,"KUBANGSARI, CIWANDAN, KOTA CILEGON, BANTEN",7,69,158,227
https://kawalpemilu.org#53076,"KUBANGSARI, CIWANDAN, KOTA CILEGON, BANTEN",8,48,154,202
https://kawalpemilu.org#53076,"KUBANGSARI, CIWANDAN, KOTA CILEGON, BANTEN",9,31,172,203
https://kawalpemilu.org#53076,"KUBANGSARI, CIWANDAN, KOTA CILEGON, BANTEN",10,0,0,0
https://kawalpemilu.org#53076,"KUBANGSARI, CIWANDAN, KOTA CILEGON, BANTEN",11,48,190,238
https://kawalpemilu.org#53076,"KUBANGSARI, CIWANDAN, KOTA CILEGON, BANTEN",12,46,222,268
https://kawalpemilu.org#53076,"KUBANGSARI, CIWANDAN, KOTA CILEGON, BANTEN",13,24,215,239
https://kawalpemilu.org#53076,"KUBANGSARI, CIWANDAN, KOTA CILEGON, BANTEN",14,37,190,227
https://kawalpemilu.org#53076,"KUBANGSARI, CIWANDAN, KOTA CILEGON, BANTEN",15,33,221,254
https://kawalpemilu.org#53076,"KUBANGSARI, CIWANDAN, KOTA CILEGON, BANTEN",16,62,197,259
https://kawalpemilu.org#53076,"KUBANGSARI, CIWANDAN, KOTA CILEGON, BANTEN",17,65,203,268
https://kawalpemilu.org#53076,"KUBANGSARI, CIWANDAN, KOTA CILEGON, BANTEN",18,39,193,232
https://kawalpemilu.org#53076,"KUBANGSARI, CIWANDAN, KOTA CILEGON, BANTEN",19,39,209,248
https://kawalpemilu.org#53077,"GUNUNG SUGIH, CIWANDAN, KOTA CILEGON, BANTEN",1,31,211,242
https://kawalpemilu.org#53077,"GUNUNG SUGIH, CIWANDAN, KOTA CILEGON, BANTEN",2,29,197,226
https://kawalpemilu.org#53077,"GUNUNG SUGIH, CIWANDAN, KOTA CILEGON, BANTEN",3,23,208,231
https://kawalpemilu.org#53077,"GUNUNG SUGIH, CIWANDAN, KOTA CILEGON, BANTEN",4,20,211,231
https://kawalpemilu.org#53077,"GUNUNG SUGIH, CIWANDAN, KOTA CILEGON, BANTEN",5,32,210,242
https://kawalpemilu.org#53077,"GUNUNG SUGIH, CIWANDAN, KOTA CILEGON, BANTEN",6,16,162,178
https://kawalpemilu.org#53077,"GUNUNG SUGIH, CIWANDAN, KOTA CILEGON, BANTEN",7,20,232,252
https://kawalpemilu.org#53077,"GUNUNG SUGIH, CIWANDAN, KOTA CILEGON, BANTEN",8,24,216,240
https://kawalpemilu.org#53077,"GUNUNG SUGIH, CIWANDAN, KOTA CILEGON, BANTEN",9,37,227,262
https://kawalpemilu.org#53077,"GUNUNG SUGIH, CIWANDAN, KOTA CILEGON, BANTEN",10,61,221,282
https://kawalpemilu.org#53077,"GUNUNG SUGIH, CIWANDAN, KOTA CILEGON, BANTEN",11,35,128,163
https://kawalpemilu.org#53077,"GUNUNG SUGIH, CIWANDAN, KOTA CILEGON, BANTEN",12,36,203,239
https://kawalpemilu.org#53077,"GUNUNG SUGIH, CIWANDAN, KOTA CILEGON, BANTEN",13,125,165,290
https://kawalpemilu.org#53077,"GUNUNG SUGIH, CIWANDAN, KOTA CILEGON, BANTEN",14,61,203,264
https://kawalpemilu.org#53077,"GUNUNG SUGIH, CIWANDAN, KOTA CILEGON, BANTEN",15,98,120,218
https://kawalpemilu.org#53077,"GUNUNG SUGIH, CIWANDAN, KOTA CILEGON, BANTEN",16,58,148,206
https://kawalpemilu.org#53077,"GUNUNG SUGIH, CIWANDAN, KOTA CILEGON, BANTEN",17,63,148,211
https://kawalpemilu.org#53077,"GUNUNG SUGIH, CIWANDAN, KOTA CILEGON, BANTEN",18,54,133,187
https://kawalpemilu.org#53077,"GUNUNG SUGIH, CIWANDAN, KOTA CILEGON, BANTEN",19,59,157,216
https://kawalpemilu.org#53078,"KEPUH, CIWANDAN, KOTA CILEGON, BANTEN",1,71,197,268
https://kawalpemilu.org#53078,"KEPUH, CIWANDAN, KOTA CILEGON, BANTEN",2,87,113,200
https://kawalpemilu.org#53078,"KEPUH, CIWANDAN, KOTA CILEGON, BANTEN",3,73,181,254
https://kawalpemilu.org#53078,"KEPUH, CIWANDAN, KOTA CILEGON, BANTEN",4,69,181,250
https://kawalpemilu.org#53078,"KEPUH, CIWANDAN, KOTA CILEGON, BANTEN",5,33,215,248
https://kawalpemilu.org#53078,"KEPUH, CIWANDAN, KOTA CILEGON, BANTEN",6,36,221,257
https://kawalpemilu.org#53078,"KEPUH, CIWANDAN, KOTA CILEGON, BANTEN",7,34,233,267
https://kawalpemilu.org#53078,"KEPUH, CIWANDAN, KOTA CILEGON, BANTEN",8,63,147,210
https://kawalpemilu.org#53078,"KEPUH, CIWANDAN, KOTA CILEGON, BANTEN",9,24,193,8
https://kawalpemilu.org#53078,"KEPUH, CIWANDAN, KOTA CILEGON, BANTEN",10,34,121,155
https://kawalpemilu.org#53078,"KEPUH, CIWANDAN, KOTA CILEGON, BANTEN",11,53,190,243
https://kawalpemilu.org#53078,"KEPUH, CIWANDAN, KOTA CILEGON, BANTEN",12,44,205,249
https://kawalpemilu.org#53078,"KEPUH, CIWANDAN, KOTA CILEGON, BANTEN",13,28,199,227
https://kawalpemilu.org#53078,"KEPUH, CIWANDAN, KOTA CILEGON, BANTEN",14,34,136,170
https://kawalpemilu.org#53078,"KEPUH, CIWANDAN, KOTA CILEGON, BANTEN",15,28,216,244
https://kawalpemilu.org#53078,"KEPUH, CIWANDAN, KOTA CILEGON, BANTEN",16,14,208,222
https://kawalpemilu.org#53078,"KEPUH, CIWANDAN, KOTA CILEGON, BANTEN",17,23,208,231
https://kawalpemilu.org#53078,"KEPUH, CIWANDAN, KOTA CILEGON, BANTEN",18,23,181,204
https://kawalpemilu.org#53078,"KEPUH, CIWANDAN, KOTA CILEGON, BANTEN",19,25,162,187
https://kawalpemilu.org#53078,"KEPUH, CIWANDAN, KOTA CILEGON, BANTEN",20,20,169,189
https://kawalpemilu.org#53078,"KEPUH, CIWANDAN, KOTA CILEGON, BANTEN",21,23,243,266
https://kawalpemilu.org#53078,"KEPUH, CIWANDAN, KOTA CILEGON, BANTEN",22,26,243,269
https://kawalpemilu.org#53079,"RANDAKARI, CIWANDAN, KOTA CILEGON, BANTEN",1,60,182,242
https://kawalpemilu.org#53079,"RANDAKARI, CIWANDAN, KOTA CILEGON, BANTEN",2,25,178,203
https://kawalpemilu.org#53079,"RANDAKARI, CIWANDAN, KOTA CILEGON, BANTEN",3,25,230,255
https://kawalpemilu.org#53079,"RANDAKARI, CIWANDAN, KOTA CILEGON, BANTEN",4,65,188,253
https://kawalpemilu.org#53079,"RANDAKARI, CIWANDAN, KOTA CILEGON, BANTEN",5,74,183,257
https://kawalpemilu.org#53079,"RANDAKARI, CIWANDAN, KOTA CILEGON, BANTEN",6,42,170,212
https://kawalpemilu.org#53079,"RANDAKARI, CIWANDAN, KOTA CILEGON, BANTEN",7,42,182,224
https://kawalpemilu.org#53079,"RANDAKARI, CIWANDAN, KOTA CILEGON, BANTEN",8,13,212,225
https://kawalpemilu.org#53079,"RANDAKARI, CIWANDAN, KOTA CILEGON, BANTEN",9,21,225,246
https://kawalpemilu.org#53079,"RANDAKARI, CIWANDAN, KOTA CILEGON, BANTEN",10,20,229,249
https://kawalpemilu.org#53079,"RANDAKARI, CIWANDAN, KOTA CILEGON, BANTEN",11,32,210,242
https://kawalpemilu.org#53079,"RANDAKARI, CIWANDAN, KOTA CILEGON, BANTEN",12,37,181,218
https://kawalpemilu.org#53079,"RANDAKARI, CIWANDAN, KOTA CILEGON, BANTEN",13,32,192,224
https://kawalpemilu.org#53079,"RANDAKARI, CIWANDAN, KOTA CILEGON, BANTEN",14,43,174,217
https://kawalpemilu.org#53079,"RANDAKARI, CIWANDAN, KOTA CILEGON, BANTEN",15,49,172,221
https://kawalpemilu.org#53079,"RANDAKARI, CIWANDAN, KOTA CILEGON, BANTEN",16,32,139,171
https://kawalpemilu.org#53079,"RANDAKARI, CIWANDAN, KOTA CILEGON, BANTEN",17,62,119,181
https://kawalpemilu.org#53079,"RANDAKARI, CIWANDAN, KOTA CILEGON, BANTEN",18,30,171,201
https://kawalpemilu.org#53079,"RANDAKARI, CIWANDAN, KOTA CILEGON, BANTEN",19,61,148,209
https://kawalpemilu.org#53079,"RANDAKARI, CIWANDAN, KOTA CILEGON, BANTEN",20,47,181,228
https://kawalpemilu.org#53079,"RANDAKARI, CIWANDAN, KOTA CILEGON, BANTEN",21,49,167,216
https://kawalpemilu.org#53079,"RANDAKARI, CIWANDAN, KOTA CILEGON, BANTEN",22,43,158,201
https://kawalpemilu.org#53079,"RANDAKARI, CIWANDAN, KOTA CILEGON, BANTEN",23,42,108,150
https://kawalpemilu.org#53079,"RANDAKARI, CIWANDAN, KOTA CILEGON, BANTEN",24,54,140,194
https://kawalpemilu.org#53081,"SUKMAJAYA, JOMBANG, KOTA CILEGON, BANTEN",1,92,114,206
https://kawalpemilu.org#53081,"SUKMAJAYA, JOMBANG, KOTA CILEGON, BANTEN",2,70,193,263
https://kawalpemilu.org#53081,"SUKMAJAYA, JOMBANG, KOTA CILEGON, BANTEN",3,78,176,254
https://kawalpemilu.org#53081,"SUKMAJAYA, JOMBANG, KOTA CILEGON, BANTEN",4,68,164,232
https://kawalpemilu.org#53081,"SUKMAJAYA, JOMBANG, KOTA CILEGON, BANTEN",5,50,110,171
https://kawalpemilu.org#53081,"SUKMAJAYA, JOMBANG, KOTA CILEGON, BANTEN",6,80,174,254
https://kawalpemilu.org#53081,"SUKMAJAYA, JOMBANG, KOTA CILEGON, BANTEN",7,126,107,233
https://kawalpemilu.org#53081,"SUKMAJAYA, JOMBANG, KOTA CILEGON, BANTEN",8,77,64,141
https://kawalpemilu.org#53081,"SUKMAJAYA, JOMBANG, KOTA CILEGON, BANTEN",9,70,57,127
https://kawalpemilu.org#53081,"SUKMAJAYA, JOMBANG, KOTA CILEGON, BANTEN",10,156,75,231
https://kawalpemilu.org#53081,"SUKMAJAYA, JOMBANG, KOTA CILEGON, BANTEN",11,78,162,240
https://kawalpemilu.org#53081,"SUKMAJAYA, JOMBANG, KOTA CILEGON, BANTEN",12,106,156,262
https://kawalpemilu.org#53081,"SUKMAJAYA, JOMBANG, KOTA CILEGON, BANTEN",13,57,106,163
https://kawalpemilu.org#53081,"SUKMAJAYA, JOMBANG, KOTA CILEGON, BANTEN",14,58,158,216
https://kawalpemilu.org#53081,"SUKMAJAYA, JOMBANG, KOTA CILEGON, BANTEN",15,53,92,145
https://kawalpemilu.org#53081,"SUKMAJAYA, JOMBANG, KOTA CILEGON, BANTEN",16,38,111,149
https://kawalpemilu.org#53081,"SUKMAJAYA, JOMBANG, KOTA CILEGON, BANTEN",17,75,143,218
https://kawalpemilu.org#53081,"SUKMAJAYA, JOMBANG, KOTA CILEGON, BANTEN",18,148,62,210
https://kawalpemilu.org#53081,"SUKMAJAYA, JOMBANG, KOTA CILEGON, BANTEN",19,91,106,197
https://kawalpemilu.org#53081,"SUKMAJAYA, JOMBANG, KOTA CILEGON, BANTEN",20,61,82,143
https://kawalpemilu.org#53081,"SUKMAJAYA, JOMBANG, KOTA CILEGON, BANTEN",21,63,113,176
https://kawalpemilu.org#53081,"SUKMAJAYA, JOMBANG, KOTA CILEGON, BANTEN",22,51,120,171
https://kawalpemilu.org#53081,"SUKMAJAYA, JOMBANG, KOTA CILEGON, BANTEN",23,104,147,251
https://kawalpemilu.org#53081,"SUKMAJAYA, JOMBANG, KOTA CILEGON, BANTEN",24,73,128,201
https://kawalpemilu.org#53081,"SUKMAJAYA, JOMBANG, KOTA CILEGON, BANTEN",25,99,148,247
https://kawalpemilu.org#53081,"SUKMAJAYA, JOMBANG, KOTA CILEGON, BANTEN",26,108,82,190
https://kawalpemilu.org#53081,"SUKMAJAYA, JOMBANG, KOTA CILEGON, BANTEN",27,88,66,154
https://kawalpemilu.org#53081,"SUKMAJAYA, JOMBANG, KOTA CILEGON, BANTEN",28,120,112,232
https://kawalpemilu.org#53081,"SUKMAJAYA, JOMBANG, KOTA CILEGON, BANTEN",29,117,113,230
https://kawalpemilu.org#53081,"SUKMAJAYA, JOMBANG, KOTA CILEGON, BANTEN",30,129,111,240
https://kawalpemilu.org#53081,"SUKMAJAYA, JOMBANG, KOTA CILEGON, BANTEN",31,159,78,237
https://kawalpemilu.org#53081,"SUKMAJAYA, JOMBANG, KOTA CILEGON, BANTEN",32,93,121,214
https://kawalpemilu.org#53081,"SUKMAJAYA, JOMBANG, KOTA CILEGON, BANTEN",33,54,83,137
https://kawalpemilu.org#53082,"JOMBANG WETAN, JOMBANG, KOTA CILEGON, BANTEN",1,44,53,97
https://kawalpemilu.org#53082,"JOMBANG WETAN, JOMBANG, KOTA CILEGON, BANTEN",2,45,91,136
https://kawalpemilu.org#53082,"JOMBANG WETAN, JOMBANG, KOTA CILEGON, BANTEN",3,76,64,140
https://kawalpemilu.org#53082,"JOMBANG WETAN, JOMBANG, KOTA CILEGON, BANTEN",4,60,73,133
https://kawalpemilu.org#53082,"JOMBANG WETAN, JOMBANG, KOTA CILEGON, BANTEN",5,92,114,206
https://kawalpemilu.org#53082,"JOMBANG WETAN, JOMBANG, KOTA CILEGON, BANTEN",6,78,70,148
https://kawalpemilu.org#53082,"JOMBANG WETAN, JOMBANG, KOTA CILEGON, BANTEN",8,86,95,181
https://kawalpemilu.org#53082,"JOMBANG WETAN, JOMBANG, KOTA CILEGON, BANTEN",9,73,104,177
https://kawalpemilu.org#53082,"JOMBANG WETAN, JOMBANG, KOTA CILEGON, BANTEN",10,90,150,240
https://kawalpemilu.org#53082,"JOMBANG WETAN, JOMBANG, KOTA CILEGON, BANTEN",11,88,149,237
https://kawalpemilu.org#53082,"JOMBANG WETAN, JOMBANG, KOTA CILEGON, BANTEN",12,73,139,212
https://kawalpemilu.org#53082,"JOMBANG WETAN, JOMBANG, KOTA CILEGON, BANTEN",13,79,149,227
https://kawalpemilu.org#53082,"JOMBANG WETAN, JOMBANG, KOTA CILEGON, BANTEN",14,99,141,240
https://kawalpemilu.org#53082,"JOMBANG WETAN, JOMBANG, KOTA CILEGON, BANTEN",15,53,109,162
https://kawalpemilu.org#53082,"JOMBANG WETAN, JOMBANG, KOTA CILEGON, BANTEN",16,45,115,160
https://kawalpemilu.org#53082,"JOMBANG WETAN, JOMBANG, KOTA CILEGON, BANTEN",17,97,96,193
https://kawalpemilu.org#53082,"JOMBANG WETAN, JOMBANG, KOTA CILEGON, BANTEN",18,57,73,130
https://kawalpemilu.org#53082,"JOMBANG WETAN, JOMBANG, KOTA CILEGON, BANTEN",19,56,106,162
https://kawalpemilu.org#53082,"JOMBANG WETAN, JOMBANG, KOTA CILEGON, BANTEN",20,63,102,165
https://kawalpemilu.org#53082,"JOMBANG WETAN, JOMBANG, KOTA CILEGON, BANTEN",21,61,160,221
https://kawalpemilu.org#53082,"JOMBANG WETAN, JOMBANG, KOTA CILEGON, BANTEN",22,55,130,185
https://kawalpemilu.org#53082,"JOMBANG WETAN, JOMBANG, KOTA CILEGON, BANTEN",23,60,176,236
https://kawalpemilu.org#53082,"JOMBANG WETAN, JOMBANG, KOTA CILEGON, BANTEN",24,111,121,232
https://kawalpemilu.org#53082,"JOMBANG WETAN, JOMBANG, KOTA CILEGON, BANTEN",25,37,164,201
https://kawalpemilu.org#53082,"JOMBANG WETAN, JOMBANG, KOTA CILEGON, BANTEN",26,97,161,258
https://kawalpemilu.org#53082,"JOMBANG WETAN, JOMBANG, KOTA CILEGON, BANTEN",27,139,94,233
https://kawalpemilu.org#53082,"JOMBANG WETAN, JOMBANG, KOTA CILEGON, BANTEN",28,86,59,145
https://kawalpemilu.org#53082,"JOMBANG WETAN, JOMBANG, KOTA CILEGON, BANTEN",29,89,110,199
https://kawalpemilu.org#53082,"JOMBANG WETAN, JOMBANG, KOTA CILEGON, BANTEN",30,76,136,212
https://kawalpemilu.org#53082,"JOMBANG WETAN, JOMBANG, KOTA CILEGON, BANTEN",31,60,174,234
https://kawalpemilu.org#53082,"JOMBANG WETAN, JOMBANG, KOTA CILEGON, BANTEN",32,46,151,197
https://kawalpemilu.org#53082,"JOMBANG WETAN, JOMBANG, KOTA CILEGON, BANTEN",33,89,166,255
https://kawalpemilu.org#53082,"JOMBANG WETAN, JOMBANG, KOTA CILEGON, BANTEN",34,63,96,159
https://kawalpemilu.org#53082,"JOMBANG WETAN, JOMBANG, KOTA CILEGON, BANTEN",35,107,80,187
https://kawalpemilu.org#53082,"JOMBANG WETAN, JOMBANG, KOTA CILEGON, BANTEN",36,81,171,252
https://kawalpemilu.org#53082,"JOMBANG WETAN, JOMBANG, KOTA CILEGON, BANTEN",37,69,167,236
https://kawalpemilu.org#53082,"JOMBANG WETAN, JOMBANG, KOTA CILEGON, BANTEN",38,99,182,281
https://kawalpemilu.org#53082,"JOMBANG WETAN, JOMBANG, KOTA CILEGON, BANTEN",39,102,125,127
https://kawalpemilu.org#53082,"JOMBANG WETAN, JOMBANG, KOTA CILEGON, BANTEN",40,84,108,192
https://kawalpemilu.org#53082,"JOMBANG WETAN, JOMBANG, KOTA CILEGON, BANTEN",41,93,112,205
https://kawalpemilu.org#53082,"JOMBANG WETAN, JOMBANG, KOTA CILEGON, BANTEN",42,91,114,205
https://kawalpemilu.org#53082,"JOMBANG WETAN, JOMBANG, KOTA CILEGON, BANTEN",43,103,91,194
https://kawalpemilu.org#53082,"JOMBANG WETAN, JOMBANG, KOTA CILEGON, BANTEN",44,119,115,234
https://kawalpemilu.org#53082,"JOMBANG WETAN, JOMBANG, KOTA CILEGON, BANTEN",45,131,101,232
https://kawalpemilu.org#53082,"JOMBANG WETAN, JOMBANG, KOTA CILEGON, BANTEN",46,93,155,248
https://kawalpemilu.org#53082,"JOMBANG WETAN, JOMBANG, KOTA CILEGON, BANTEN",47,38,71,109
https://kawalpemilu.org#53082,"JOMBANG WETAN, JOMBANG, KOTA CILEGON, BANTEN",48,55,105,162
https://kawalpemilu.org#53082,"JOMBANG WETAN, JOMBANG, KOTA CILEGON, BANTEN",49,61,204,265
https://kawalpemilu.org#53082,"JOMBANG WETAN, JOMBANG, KOTA CILEGON, BANTEN",50,76,165,241
https://kawalpemilu.org#53082,"JOMBANG WETAN, JOMBANG, KOTA CILEGON, BANTEN",51,78,168,246
https://kawalpemilu.org#53082,"JOMBANG WETAN, JOMBANG, KOTA CILEGON, BANTEN",52,105,166,271
https://kawalpemilu.org#53082,"JOMBANG WETAN, JOMBANG, KOTA CILEGON, BANTEN",53,121,127,248
https://kawalpemilu.org#53082,"JOMBANG WETAN, JOMBANG, KOTA CILEGON, BANTEN",54,114,110,224
https://kawalpemilu.org#53082,"JOMBANG WETAN, JOMBANG, KOTA CILEGON, BANTEN",55,115,83,198
https://kawalpemilu.org#53082,"JOMBANG WETAN, JOMBANG, KOTA CILEGON, BANTEN",56,78,126,204
https://kawalpemilu.org#53082,"JOMBANG WETAN, JOMBANG, KOTA CILEGON, BANTEN",57,77,134,211
https://kawalpemilu.org#53082,"JOMBANG WETAN, JOMBANG, KOTA CILEGON, BANTEN",58,111,112,223
https://kawalpemilu.org#53082,"JOMBANG WETAN, JOMBANG, KOTA CILEGON, BANTEN",59,106,103,209
https://kawalpemilu.org#53082,"JOMBANG WETAN, JOMBANG, KOTA CILEGON, BANTEN",60,76,104,180
https://kawalpemilu.org#53082,"JOMBANG WETAN, JOMBANG, KOTA CILEGON, BANTEN",61,98,108,206
https://kawalpemilu.org#53082,"JOMBANG WETAN, JOMBANG, KOTA CILEGON, BANTEN",62,72,107,179
https://kawalpemilu.org#53082,"JOMBANG WETAN, JOMBANG, KOTA CILEGON, BANTEN",63,95,98,193
https://kawalpemilu.org#53082,"JOMBANG WETAN, JOMBANG, KOTA CILEGON, BANTEN",64,130,106,236
https://kawalpemilu.org#53083,"MASIGIT, JOMBANG, KOTA CILEGON, BANTEN",1,83,158,241
https://kawalpemilu.org#53083,"MASIGIT, JOMBANG, KOTA CILEGON, BANTEN",2,90,133,223
https://kawalpemilu.org#53083,"MASIGIT, JOMBANG, KOTA CILEGON, BANTEN",3,75,165,140
https://kawalpemilu.org#53083,"MASIGIT, JOMBANG, KOTA CILEGON, BANTEN",4,91,165,256
https://kawalpemilu.org#53083,"MASIGIT, JOMBANG, KOTA CILEGON, BANTEN",5,55,134,189
https://kawalpemilu.org#53083,"MASIGIT, JOMBANG, KOTA CILEGON, BANTEN",6,55,195,250
https://kawalpemilu.org#53083,"MASIGIT, JOMBANG, KOTA CILEGON, BANTEN",7,76,166,238
https://kawalpemilu.org#53083,"MASIGIT, JOMBANG, KOTA CILEGON, BANTEN",8,56,166,222
https://kawalpemilu.org#53083,"MASIGIT, JOMBANG, KOTA CILEGON, BANTEN",9,57,156,213
https://kawalpemilu.org#53083,"MASIGIT, JOMBANG, KOTA CILEGON, BANTEN",10,70,114,184
https://kawalpemilu.org#53083,"MASIGIT, JOMBANG, KOTA CILEGON, BANTEN",11,59,140,199
https://kawalpemilu.org#53083,"MASIGIT, JOMBANG, KOTA CILEGON, BANTEN",12,48,130,178
https://kawalpemilu.org#53083,"MASIGIT, JOMBANG, KOTA CILEGON, BANTEN",13,80,179,259
https://kawalpemilu.org#53083,"MASIGIT, JOMBANG, KOTA CILEGON, BANTEN",14,87,168,254
https://kawalpemilu.org#53083,"MASIGIT, JOMBANG, KOTA CILEGON, BANTEN",15,64,169,233
https://kawalpemilu.org#53083,"MASIGIT, JOMBANG, KOTA CILEGON, BANTEN",16,50,149,199
https://kawalpemilu.org#53083,"MASIGIT, JOMBANG, KOTA CILEGON, BANTEN",17,69,117,186
https://kawalpemilu.org#53083,"MASIGIT, JOMBANG, KOTA CILEGON, BANTEN",18,69,162,231
https://kawalpemilu.org#53083,"MASIGIT, JOMBANG, KOTA CILEGON, BANTEN",19,54,153,207
https://kawalpemilu.org#53083,"MASIGIT, JOMBANG, KOTA CILEGON, BANTEN",20,66,138,204
https://kawalpemilu.org#53083,"MASIGIT, JOMBANG, KOTA CILEGON, BANTEN",21,56,106,162
https://kawalpemilu.org#53083,"MASIGIT, JOMBANG, KOTA CILEGON, BANTEN",22,72,119,191
https://kawalpemilu.org#53083,"MASIGIT, JOMBANG, KOTA CILEGON, BANTEN",23,92,124,216
https://kawalpemilu.org#53083,"MASIGIT, JOMBANG, KOTA CILEGON, BANTEN",24,140,105,245
https://kawalpemilu.org#53083,"MASIGIT, JOMBANG, KOTA CILEGON, BANTEN",25,111,134,245
https://kawalpemilu.org#53083,"MASIGIT, JOMBANG, KOTA CILEGON, BANTEN",26,106,138,244
https://kawalpemilu.org#53083,"MASIGIT, JOMBANG, KOTA CILEGON, BANTEN",27,90,102,192
https://kawalpemilu.org#53083,"MASIGIT, JOMBANG, KOTA CILEGON, BANTEN",28,83,108,191
https://kawalpemilu.org#53083,"MASIGIT, JOMBANG, KOTA CILEGON, BANTEN",29,85,114,199
https://kawalpemilu.org#53083,"MASIGIT, JOMBANG, KOTA CILEGON, BANTEN",30,61,85,146
https://kawalpemilu.org#53083,"MASIGIT, JOMBANG, KOTA CILEGON, BANTEN",31,96,83,179
https://kawalpemilu.org#53083,"MASIGIT, JOMBANG, KOTA CILEGON, BANTEN",32,60,58,218
https://kawalpemilu.org#53083,"MASIGIT, JOMBANG, KOTA CILEGON, BANTEN",33,72,148,220
https://kawalpemilu.org#53083,"MASIGIT, JOMBANG, KOTA CILEGON, BANTEN",34,65,63,128
https://kawalpemilu.org#53083,"MASIGIT, JOMBANG, KOTA CILEGON, BANTEN",35,78,85,163
https://kawalpemilu.org#53083,"MASIGIT, JOMBANG, KOTA CILEGON, BANTEN",36,81,97,3
https://kawalpemilu.org#53083,"MASIGIT, JOMBANG, KOTA CILEGON, BANTEN",37,102,96,198
https://kawalpemilu.org#53083,"MASIGIT, JOMBANG, KOTA CILEGON, BANTEN",38,101,82,183
https://kawalpemilu.org#53083,"MASIGIT, JOMBANG, KOTA CILEGON, BANTEN",39,115,131,246
https://kawalpemilu.org#53083,"MASIGIT, JOMBANG, KOTA CILEGON, BANTEN",40,133,101,234
https://kawalpemilu.org#53083,"MASIGIT, JOMBANG, KOTA CILEGON, BANTEN",41,93,112,205
https://kawalpemilu.org#53084,"PANGGUNG RAWI, JOMBANG, KOTA CILEGON, BANTEN",1,41,165,206
https://kawalpemilu.org#53084,"PANGGUNG RAWI, JOMBANG, KOTA CILEGON, BANTEN",2,43,145,188
https://kawalpemilu.org#53084,"PANGGUNG RAWI, JOMBANG, KOTA CILEGON, BANTEN",3,73,115,188
https://kawalpemilu.org#53084,"PANGGUNG RAWI, JOMBANG, KOTA CILEGON, BANTEN",4,47,87,134
https://kawalpemilu.org#53084,"PANGGUNG RAWI, JOMBANG, KOTA CILEGON, BANTEN",5,81,162,243
https://kawalpemilu.org#53084,"PANGGUNG RAWI, JOMBANG, KOTA CILEGON, BANTEN",6,52,105,157
https://kawalpemilu.org#53084,"PANGGUNG RAWI, JOMBANG, KOTA CILEGON, BANTEN",7,72,118,190
https://kawalpemilu.org#53084,"PANGGUNG RAWI, JOMBANG, KOTA CILEGON, BANTEN",8,83,136,219
https://kawalpemilu.org#53084,"PANGGUNG RAWI, JOMBANG, KOTA CILEGON, BANTEN",9,87,160,247
https://kawalpemilu.org#53084,"PANGGUNG RAWI, JOMBANG, KOTA CILEGON, BANTEN",10,63,138,201
https://kawalpemilu.org#53084,"PANGGUNG RAWI, JOMBANG, KOTA CILEGON, BANTEN",11,60,111,171
https://kawalpemilu.org#53084,"PANGGUNG RAWI, JOMBANG, KOTA CILEGON, BANTEN",12,70,82,152
https://kawalpemilu.org#53084,"PANGGUNG RAWI, JOMBANG, KOTA CILEGON, BANTEN",13,57,162,219
https://kawalpemilu.org#53084,"PANGGUNG RAWI, JOMBANG, KOTA CILEGON, BANTEN",14,67,164,231
https://kawalpemilu.org#53084,"PANGGUNG RAWI, JOMBANG, KOTA CILEGON, BANTEN",15,53,141,194
https://kawalpemilu.org#53084,"PANGGUNG RAWI, JOMBANG, KOTA CILEGON, BANTEN",16,46,121,167
https://kawalpemilu.org#53084,"PANGGUNG RAWI, JOMBANG, KOTA CILEGON, BANTEN",17,63,156,219
https://kawalpemilu.org#53084,"PANGGUNG RAWI, JOMBANG, KOTA CILEGON, BANTEN",18,50,150,200
https://kawalpemilu.org#53084,"PANGGUNG RAWI, JOMBANG, KOTA CILEGON, BANTEN",19,63,165,228
https://kawalpemilu.org#53084,"PANGGUNG RAWI, JOMBANG, KOTA CILEGON, BANTEN",20,51,168,219
https://kawalpemilu.org#53084,"PANGGUNG RAWI, JOMBANG, KOTA CILEGON, BANTEN",21,43,127,170
https://kawalpemilu.org#53084,"PANGGUNG RAWI, JOMBANG, KOTA CILEGON, BANTEN",22,63,190,153
https://kawalpemilu.org#53084,"PANGGUNG RAWI, JOMBANG, KOTA CILEGON, BANTEN",23,112,139,251
https://kawalpemilu.org#53084,"PANGGUNG RAWI, JOMBANG, KOTA CILEGON, BANTEN",24,89,157,246
https://kawalpemilu.org#53084,"PANGGUNG RAWI, JOMBANG, KOTA CILEGON, BANTEN",25,88,158,246
https://kawalpemilu.org#53084,"PANGGUNG RAWI, JOMBANG, KOTA CILEGON, BANTEN",26,74,171,245
https://kawalpemilu.org#53084,"PANGGUNG RAWI, JOMBANG, KOTA CILEGON, BANTEN",27,97,132,229
https://kawalpemilu.org#53084,"PANGGUNG RAWI, JOMBANG, KOTA CILEGON, BANTEN",28,88,150,238
https://kawalpemilu.org#53084,"PANGGUNG RAWI, JOMBANG, KOTA CILEGON, BANTEN",29,110,117,227
https://kawalpemilu.org#53084,"PANGGUNG RAWI, JOMBANG, KOTA CILEGON, BANTEN",30,53,68,121
https://kawalpemilu.org#53084,"PANGGUNG RAWI, JOMBANG, KOTA CILEGON, BANTEN",31,53,119,172
https://kawalpemilu.org#53085,"GEDONG DALEM, JOMBANG, KOTA CILEGON, BANTEN",1,29,170,199
https://kawalpemilu.org#53085,"GEDONG DALEM, JOMBANG, KOTA CILEGON, BANTEN",2,59,146,205
https://kawalpemilu.org#53085,"GEDONG DALEM, JOMBANG, KOTA CILEGON, BANTEN",3,65,163,228
https://kawalpemilu.org#53085,"GEDONG DALEM, JOMBANG, KOTA CILEGON, BANTEN",4,33,121,154
https://kawalpemilu.org#53085,"GEDONG DALEM, JOMBANG, KOTA CILEGON, BANTEN",5,68,172,240
https://kawalpemilu.org#53085,"GEDONG DALEM, JOMBANG, KOTA CILEGON, BANTEN",6,31,198,229
https://kawalpemilu.org#53085,"GEDONG DALEM, JOMBANG, KOTA CILEGON, BANTEN",7,44,205,249
https://kawalpemilu.org#53085,"GEDONG DALEM, JOMBANG, KOTA CILEGON, BANTEN",8,55,170,225
https://kawalpemilu.org#53085,"GEDONG DALEM, JOMBANG, KOTA CILEGON, BANTEN",9,36,129,165
https://kawalpemilu.org#53085,"GEDONG DALEM, JOMBANG, KOTA CILEGON, BANTEN",10,53,175,228
https://kawalpemilu.org#53085,"GEDONG DALEM, JOMBANG, KOTA CILEGON, BANTEN",11,55,165,220
https://kawalpemilu.org#53085,"GEDONG DALEM, JOMBANG, KOTA CILEGON, BANTEN",12,70,180,250
https://kawalpemilu.org#53085,"GEDONG DALEM, JOMBANG, KOTA CILEGON, BANTEN",13,53,207,260
https://kawalpemilu.org#53085,"GEDONG DALEM, JOMBANG, KOTA CILEGON, BANTEN",14,64,152,216
https://kawalpemilu.org#53085,"GEDONG DALEM, JOMBANG, KOTA CILEGON, BANTEN",15,86,190,276
https://kawalpemilu.org#53085,"GEDONG DALEM, JOMBANG, KOTA CILEGON, BANTEN",16,52,121,173
https://kawalpemilu.org#53085,"GEDONG DALEM, JOMBANG, KOTA CILEGON, BANTEN",17,78,89,167
https://kawalpemilu.org#53085,"GEDONG DALEM, JOMBANG, KOTA CILEGON, BANTEN",18,81,164,245
https://kawalpemilu.org#53085,"GEDONG DALEM, JOMBANG, KOTA CILEGON, BANTEN",19,103,154,257
https://kawalpemilu.org#53085,"GEDONG DALEM, JOMBANG, KOTA CILEGON, BANTEN",20,103,170,273
https://kawalpemilu.org#53087,"KOTASARI, GEROGOL, KOTA CILEGON, BANTEN",1,72,123,195
https://kawalpemilu.org#53087,"KOTASARI, GEROGOL, KOTA CILEGON, BANTEN",2,62,122,184
https://kawalpemilu.org#53087,"KOTASARI, GEROGOL, KOTA CILEGON, BANTEN",3,70,126,196
https://kawalpemilu.org#53087,"KOTASARI, GEROGOL, KOTA CILEGON, BANTEN",4,43,138,181
https://kawalpemilu.org#53087,"KOTASARI, GEROGOL, KOTA CILEGON, BANTEN",5,48,170,218
https://kawalpemilu.org#53087,"KOTASARI, GEROGOL, KOTA CILEGON, BANTEN",6,50,188,238
https://kawalpemilu.org#53087,"KOTASARI, GEROGOL, KOTA CILEGON, BANTEN",7,64,171,235
https://kawalpemilu.org#53087,"KOTASARI, GEROGOL, KOTA CILEGON, BANTEN",8,20,239,259
https://kawalpemilu.org#53087,"KOTASARI, GEROGOL, KOTA CILEGON, BANTEN",9,51,227,278
https://kawalpemilu.org#53087,"KOTASARI, GEROGOL, KOTA CILEGON, BANTEN",10,30,127,157
https://kawalpemilu.org#53087,"KOTASARI, GEROGOL, KOTA CILEGON, BANTEN",11,88,171,259
https://kawalpemilu.org#53087,"KOTASARI, GEROGOL, KOTA CILEGON, BANTEN",12,68,167,235
https://kawalpemilu.org#53087,"KOTASARI, GEROGOL, KOTA CILEGON, BANTEN",13,89,147,236
https://kawalpemilu.org#53087,"KOTASARI, GEROGOL, KOTA CILEGON, BANTEN",14,87,135,222
https://kawalpemilu.org#53087,"KOTASARI, GEROGOL, KOTA CILEGON, BANTEN",15,105,123,228
https://kawalpemilu.org#53087,"KOTASARI, GEROGOL, KOTA CILEGON, BANTEN",16,65,116,181
https://kawalpemilu.org#53087,"KOTASARI, GEROGOL, KOTA CILEGON, BANTEN",17,102,134,236
https://kawalpemilu.org#53087,"KOTASARI, GEROGOL, KOTA CILEGON, BANTEN",18,103,178,281
https://kawalpemilu.org#53087,"KOTASARI, GEROGOL, KOTA CILEGON, BANTEN",19,81,195,276
https://kawalpemilu.org#53087,"KOTASARI, GEROGOL, KOTA CILEGON, BANTEN",20,74,138,212
https://kawalpemilu.org#53087,"KOTASARI, GEROGOL, KOTA CILEGON, BANTEN",21,30,127,157
https://kawalpemilu.org#53087,"KOTASARI, GEROGOL, KOTA CILEGON, BANTEN",22,72,159,231
https://kawalpemilu.org#53088,"GROGOL, GEROGOL, KOTA CILEGON, BANTEN",1,37,213,250
https://kawalpemilu.org#53088,"GROGOL, GEROGOL, KOTA CILEGON, BANTEN",2,48,170,218
https://kawalpemilu.org#53088,"GROGOL, GEROGOL, KOTA CILEGON, BANTEN",3,61,172,233
https://kawalpemilu.org#53088,"GROGOL, GEROGOL, KOTA CILEGON, BANTEN",4,41,176,217
https://kawalpemilu.org#53088,"GROGOL, GEROGOL, KOTA CILEGON, BANTEN",5,21,202,223
https://kawalpemilu.org#53088,"GROGOL, GEROGOL, KOTA CILEGON, BANTEN",6,52,154,206
https://kawalpemilu.org#53088,"GROGOL, GEROGOL, KOTA CILEGON, BANTEN",7,30,169,199
https://kawalpemilu.org#53088,"GROGOL, GEROGOL, KOTA CILEGON, BANTEN",8,48,165,213
https://kawalpemilu.org#53088,"GROGOL, GEROGOL, KOTA CILEGON, BANTEN",9,28,106,134
https://kawalpemilu.org#53088,"GROGOL, GEROGOL, KOTA CILEGON, BANTEN",10,31,153,184
https://kawalpemilu.org#53088,"GROGOL, GEROGOL, KOTA CILEGON, BANTEN",11,55,145,200
https://kawalpemilu.org#53088,"GROGOL, GEROGOL, KOTA CILEGON, BANTEN",12,15,175,190
https://kawalpemilu.org#53088,"GROGOL, GEROGOL, KOTA CILEGON, BANTEN",13,34,153,187
https://kawalpemilu.org#53089,"RAWA ARUM, GEROGOL, KOTA CILEGON, BANTEN",1,73,63,136
https://kawalpemilu.org#53089,"RAWA ARUM, GEROGOL, KOTA CILEGON, BANTEN",2,70,152,222
https://kawalpemilu.org#53089,"RAWA ARUM, GEROGOL, KOTA CILEGON, BANTEN",3,39,140,179
https://kawalpemilu.org#53089,"RAWA ARUM, GEROGOL, KOTA CILEGON, BANTEN",4,52,134,186
https://kawalpemilu.org#53089,"RAWA ARUM, GEROGOL, KOTA CILEGON, BANTEN",5,38,127,165
https://kawalpemilu.org#53089,"RAWA ARUM, GEROGOL, KOTA CILEGON, BANTEN",6,44,128,172
https://kawalpemilu.org#53089,"RAWA ARUM, GEROGOL, KOTA CILEGON, BANTEN",7,37,189,226
https://kawalpemilu.org#53089,"RAWA ARUM, GEROGOL, KOTA CILEGON, BANTEN",8,57,158,215
https://kawalpemilu.org#53089,"RAWA ARUM, GEROGOL, KOTA CILEGON, BANTEN",9,57,158,215
https://kawalpemilu.org#53089,"RAWA ARUM, GEROGOL, KOTA CILEGON, BANTEN",10,53,198,251
https://kawalpemilu.org#53089,"RAWA ARUM, GEROGOL, KOTA CILEGON, BANTEN",11,37,153,190
https://kawalpemilu.org#53089,"RAWA ARUM, GEROGOL, KOTA CILEGON, BANTEN",12,41,133,174
https://kawalpemilu.org#53089,"RAWA ARUM, GEROGOL, KOTA CILEGON, BANTEN",13,41,202,243
https://kawalpemilu.org#53089,"RAWA ARUM, GEROGOL, KOTA CILEGON, BANTEN",14,72,172,244
https://kawalpemilu.org#53089,"RAWA ARUM, GEROGOL, KOTA CILEGON, BANTEN",15,27,140,167
https://kawalpemilu.org#53089,"RAWA ARUM, GEROGOL, KOTA CILEGON, BANTEN",16,35,148,183
https://kawalpemilu.org#53089,"RAWA ARUM, GEROGOL, KOTA CILEGON, BANTEN",17,43,107,150
https://kawalpemilu.org#53089,"RAWA ARUM, GEROGOL, KOTA CILEGON, BANTEN",18,36,92,128
https://kawalpemilu.org#53089,"RAWA ARUM, GEROGOL, KOTA CILEGON, BANTEN",19,45,186,231
https://kawalpemilu.org#53089,"RAWA ARUM, GEROGOL, KOTA CILEGON, BANTEN",20,42,187,229
https://kawalpemilu.org#53089,"RAWA ARUM, GEROGOL, KOTA CILEGON, BANTEN",21,52,107,159
https://kawalpemilu.org#53089,"RAWA ARUM, GEROGOL, KOTA CILEGON, BANTEN",22,53,159,212
https://kawalpemilu.org#53089,"RAWA ARUM, GEROGOL, KOTA CILEGON, BANTEN",23,73,173,246
https://kawalpemilu.org#53089,"RAWA ARUM, GEROGOL, KOTA CILEGON, BANTEN",24,21,159,180
https://kawalpemilu.org#53089,"RAWA ARUM, GEROGOL, KOTA CILEGON, BANTEN",25,45,151,196
https://kawalpemilu.org#53089,"RAWA ARUM, GEROGOL, KOTA CILEGON, BANTEN",26,74,151,225
https://kawalpemilu.org#53089,"RAWA ARUM, GEROGOL, KOTA CILEGON, BANTEN",27,63,194,257
https://kawalpemilu.org#53089,"RAWA ARUM, GEROGOL, KOTA CILEGON, BANTEN",28,34,210,244
https://kawalpemilu.org#53089,"RAWA ARUM, GEROGOL, KOTA CILEGON, BANTEN",29,40,156,196
https://kawalpemilu.org#53089,"RAWA ARUM, GEROGOL, KOTA CILEGON, BANTEN",30,31,134,165
https://kawalpemilu.org#53089,"RAWA ARUM, GEROGOL, KOTA CILEGON, BANTEN",31,60,203,263
https://kawalpemilu.org#53089,"RAWA ARUM, GEROGOL, KOTA CILEGON, BANTEN",32,44,106,150
https://kawalpemilu.org#53089,"RAWA ARUM, GEROGOL, KOTA CILEGON, BANTEN",33,54,149,203
https://kawalpemilu.org#53089,"RAWA ARUM, GEROGOL, KOTA CILEGON, BANTEN",34,49,181,230
https://kawalpemilu.org#53089,"RAWA ARUM, GEROGOL, KOTA CILEGON, BANTEN",35,77,185,262
https://kawalpemilu.org#53089,"RAWA ARUM, GEROGOL, KOTA CILEGON, BANTEN",36,43,122,165
https://kawalpemilu.org#53089,"RAWA ARUM, GEROGOL, KOTA CILEGON, BANTEN",37,71,190,261
https://kawalpemilu.org#53089,"RAWA ARUM, GEROGOL, KOTA CILEGON, BANTEN",38,68,194,262
https://kawalpemilu.org#53089,"RAWA ARUM, GEROGOL, KOTA CILEGON, BANTEN",39,51,190,241
https://kawalpemilu.org#53089,"RAWA ARUM, GEROGOL, KOTA CILEGON, BANTEN",40,53,214,267
https://kawalpemilu.org#53089,"RAWA ARUM, GEROGOL, KOTA CILEGON, BANTEN",41,72,180,252
https://kawalpemilu.org#53089,"RAWA ARUM, GEROGOL, KOTA CILEGON, BANTEN",42,88,159,247
https://kawalpemilu.org#53089,"RAWA ARUM, GEROGOL, KOTA CILEGON, BANTEN",43,17,136,153
https://kawalpemilu.org#53089,"RAWA ARUM, GEROGOL, KOTA CILEGON, BANTEN",44,23,116,139
https://kawalpemilu.org#53090,"GEREM, GEROGOL, KOTA CILEGON, BANTEN",1,30,194,224
https://kawalpemilu.org#53090,"GEREM, GEROGOL, KOTA CILEGON, BANTEN",2,14,171,185
https://kawalpemilu.org#53090,"GEREM, GEROGOL, KOTA CILEGON, BANTEN",3,40,132,172
https://kawalpemilu.org#53090,"GEREM, GEROGOL, KOTA CILEGON, BANTEN",4,38,182,220
https://kawalpemilu.org#53090,"GEREM, GEROGOL, KOTA CILEGON, BANTEN",5,60,164,224
https://kawalpemilu.org#53090,"GEREM, GEROGOL, KOTA CILEGON, BANTEN",6,37,164,201
https://kawalpemilu.org#53090,"GEREM, GEROGOL, KOTA CILEGON, BANTEN",7,58,136,194
https://kawalpemilu.org#53090,"GEREM, GEROGOL, KOTA CILEGON, BANTEN",8,25,176,201
https://kawalpemilu.org#53090,"GEREM, GEROGOL, KOTA CILEGON, BANTEN",9,32,170,202
https://kawalpemilu.org#53090,"GEREM, GEROGOL, KOTA CILEGON, BANTEN",10,19,194,213
https://kawalpemilu.org#53090,"GEREM, GEROGOL, KOTA CILEGON, BANTEN",11,41,153,194
https://kawalpemilu.org#53090,"GEREM, GEROGOL, KOTA CILEGON, BANTEN",12,42,161,203
https://kawalpemilu.org#53090,"GEREM, GEROGOL, KOTA CILEGON, BANTEN",13,81,130,211
https://kawalpemilu.org#53090,"GEREM, GEROGOL, KOTA CILEGON, BANTEN",14,59,148,207
https://kawalpemilu.org#53090,"GEREM, GEROGOL, KOTA CILEGON, BANTEN",15,54,178,232
https://kawalpemilu.org#53090,"GEREM, GEROGOL, KOTA CILEGON, BANTEN",16,35,216,251
https://kawalpemilu.org#53090,"GEREM, GEROGOL, KOTA CILEGON, BANTEN",17,67,142,209
https://kawalpemilu.org#53090,"GEREM, GEROGOL, KOTA CILEGON, BANTEN",18,31,157,188
https://kawalpemilu.org#53090,"GEREM, GEROGOL, KOTA CILEGON, BANTEN",19,27,152,179
https://kawalpemilu.org#53090,"GEREM, GEROGOL, KOTA CILEGON, BANTEN",20,47,144,191
https://kawalpemilu.org#53090,"GEREM, GEROGOL, KOTA CILEGON, BANTEN",21,35,188,223
https://kawalpemilu.org#53090,"GEREM, GEROGOL, KOTA CILEGON, BANTEN",22,43,174,217
https://kawalpemilu.org#53090,"GEREM, GEROGOL, KOTA CILEGON, BANTEN",23,48,231,279
https://kawalpemilu.org#53090,"GEREM, GEROGOL, KOTA CILEGON, BANTEN",24,61,134,195
https://kawalpemilu.org#53090,"GEREM, GEROGOL, KOTA CILEGON, BANTEN",25,55,157,212
https://kawalpemilu.org#53090,"GEREM, GEROGOL, KOTA CILEGON, BANTEN",26,39,75,114
https://kawalpemilu.org#53090,"GEREM, GEROGOL, KOTA CILEGON, BANTEN",27,87,66,153
https://kawalpemilu.org#53090,"GEREM, GEROGOL, KOTA CILEGON, BANTEN",28,56,96,154
https://kawalpemilu.org#53090,"GEREM, GEROGOL, KOTA CILEGON, BANTEN",29,49,100,149
https://kawalpemilu.org#53090,"GEREM, GEROGOL, KOTA CILEGON, BANTEN",30,43,76,119
https://kawalpemilu.org#53090,"GEREM, GEROGOL, KOTA CILEGON, BANTEN",31,35,149,184
https://kawalpemilu.org#53090,"GEREM, GEROGOL, KOTA CILEGON, BANTEN",32,0,0,0
https://kawalpemilu.org#53090,"GEREM, GEROGOL, KOTA CILEGON, BANTEN",33,21,197,218
https://kawalpemilu.org#53090,"GEREM, GEROGOL, KOTA CILEGON, BANTEN",34,46,183,229
https://kawalpemilu.org#53090,"GEREM, GEROGOL, KOTA CILEGON, BANTEN",35,116,44,160
https://kawalpemilu.org#53090,"GEREM, GEROGOL, KOTA CILEGON, BANTEN",36,60,38,98
https://kawalpemilu.org#53090,"GEREM, GEROGOL, KOTA CILEGON, BANTEN",37,64,47,111
https://kawalpemilu.org#53090,"GEREM, GEROGOL, KOTA CILEGON, BANTEN",38,75,117,192
https://kawalpemilu.org#53090,"GEREM, GEROGOL, KOTA CILEGON, BANTEN",39,32,240,272
https://kawalpemilu.org#53090,"GEREM, GEROGOL, KOTA CILEGON, BANTEN",40,37,209,246
https://kawalpemilu.org#53090,"GEREM, GEROGOL, KOTA CILEGON, BANTEN",41,46,194,240
https://kawalpemilu.org#53090,"GEREM, GEROGOL, KOTA CILEGON, BANTEN",42,35,153,188
https://kawalpemilu.org#53092,"RAMANUJU, PURWAKARTA, KOTA CILEGON, BANTEN",1,114,110,224
https://kawalpemilu.org#53092,"RAMANUJU, PURWAKARTA, KOTA CILEGON, BANTEN",2,54,86,140
https://kawalpemilu.org#53092,"RAMANUJU, PURWAKARTA, KOTA CILEGON, BANTEN",3,41,49,90
https://kawalpemilu.org#53092,"RAMANUJU, PURWAKARTA, KOTA CILEGON, BANTEN",4,72,97,169
https://kawalpemilu.org#53092,"RAMANUJU, PURWAKARTA, KOTA CILEGON, BANTEN",5,95,97,192
https://kawalpemilu.org#53092,"RAMANUJU, PURWAKARTA, KOTA CILEGON, BANTEN",6,96,79,175
https://kawalpemilu.org#53092,"RAMANUJU, PURWAKARTA, KOTA CILEGON, BANTEN",7,102,90,192
https://kawalpemilu.org#53092,"RAMANUJU, PURWAKARTA, KOTA CILEGON, BANTEN",8,69,91,160
https://kawalpemilu.org#53093,"KOTABUMI, PURWAKARTA, KOTA CILEGON, BANTEN",1,58,142,200
https://kawalpemilu.org#53093,"KOTABUMI, PURWAKARTA, KOTA CILEGON, BANTEN",2,69,118,187
https://kawalpemilu.org#53093,"KOTABUMI, PURWAKARTA, KOTA CILEGON, BANTEN",3,48,135,183
https://kawalpemilu.org#53093,"KOTABUMI, PURWAKARTA, KOTA CILEGON, BANTEN",4,67,120,187
https://kawalpemilu.org#53093,"KOTABUMI, PURWAKARTA, KOTA CILEGON, BANTEN",5,72,180,252
https://kawalpemilu.org#53093,"KOTABUMI, PURWAKARTA, KOTA CILEGON, BANTEN",6,55,153,208
https://kawalpemilu.org#53093,"KOTABUMI, PURWAKARTA, KOTA CILEGON, BANTEN",7,57,106,163
https://kawalpemilu.org#53093,"KOTABUMI, PURWAKARTA, KOTA CILEGON, BANTEN",8,84,96,180
https://kawalpemilu.org#53093,"KOTABUMI, PURWAKARTA, KOTA CILEGON, BANTEN",9,66,128,194
https://kawalpemilu.org#53093,"KOTABUMI, PURWAKARTA, KOTA CILEGON, BANTEN",10,49,108,157
https://kawalpemilu.org#53093,"KOTABUMI, PURWAKARTA, KOTA CILEGON, BANTEN",11,67,99,166
https://kawalpemilu.org#53093,"KOTABUMI, PURWAKARTA, KOTA CILEGON, BANTEN",12,107,120,227
https://kawalpemilu.org#53093,"KOTABUMI, PURWAKARTA, KOTA CILEGON, BANTEN",13,106,126,232
https://kawalpemilu.org#53093,"KOTABUMI, PURWAKARTA, KOTA CILEGON, BANTEN",14,81,134,215
https://kawalpemilu.org#53093,"KOTABUMI, PURWAKARTA, KOTA CILEGON, BANTEN",15,105,160,265
https://kawalpemilu.org#53093,"KOTABUMI, PURWAKARTA, KOTA CILEGON, BANTEN",16,64,120,184
https://kawalpemilu.org#53093,"KOTABUMI, PURWAKARTA, KOTA CILEGON, BANTEN",17,54,77,131
https://kawalpemilu.org#53093,"KOTABUMI, PURWAKARTA, KOTA CILEGON, BANTEN",18,45,208,253
https://kawalpemilu.org#53093,"KOTABUMI, PURWAKARTA, KOTA CILEGON, BANTEN",19,53,178,231
https://kawalpemilu.org#53093,"KOTABUMI, PURWAKARTA, KOTA CILEGON, BANTEN",20,108,129,237
https://kawalpemilu.org#53093,"KOTABUMI, PURWAKARTA, KOTA CILEGON, BANTEN",21,91,110,201
https://kawalpemilu.org#53093,"KOTABUMI, PURWAKARTA, KOTA CILEGON, BANTEN",22,74,193,267
https://kawalpemilu.org#53093,"KOTABUMI, PURWAKARTA, KOTA CILEGON, BANTEN",23,105,132,237
https://kawalpemilu.org#53093,"KOTABUMI, PURWAKARTA, KOTA CILEGON, BANTEN",24,36,152,188
https://kawalpemilu.org#53093,"KOTABUMI, PURWAKARTA, KOTA CILEGON, BANTEN",25,37,191,10
https://kawalpemilu.org#53093,"KOTABUMI, PURWAKARTA, KOTA CILEGON, BANTEN",26,95,134,229
https://kawalpemilu.org#53093,"KOTABUMI, PURWAKARTA, KOTA CILEGON, BANTEN",27,145,115,260
https://kawalpemilu.org#53093,"KOTABUMI, PURWAKARTA, KOTA CILEGON, BANTEN",28,83,114,197
https://kawalpemilu.org#53093,"KOTABUMI, PURWAKARTA, KOTA CILEGON, BANTEN",29,71,181,252
https://kawalpemilu.org#53094,"KEBON DALEM, PURWAKARTA, KOTA CILEGON, BANTEN",1,64,142,206
https://kawalpemilu.org#53094,"KEBON DALEM, PURWAKARTA, KOTA CILEGON, BANTEN",2,40,104,144
https://kawalpemilu.org#53094,"KEBON DALEM, PURWAKARTA, KOTA CILEGON, BANTEN",3,67,70,137
https://kawalpemilu.org#53094,"KEBON DALEM, PURWAKARTA, KOTA CILEGON, BANTEN",4,80,94,174
https://kawalpemilu.org#53094,"KEBON DALEM, PURWAKARTA, KOTA CILEGON, BANTEN",5,85,166,251
https://kawalpemilu.org#53094,"KEBON DALEM, PURWAKARTA, KOTA CILEGON, BANTEN",6,110,142,252
https://kawalpemilu.org#53094,"KEBON DALEM, PURWAKARTA, KOTA CILEGON, BANTEN",7,70,110,180
https://kawalpemilu.org#53094,"KEBON DALEM, PURWAKARTA, KOTA CILEGON, BANTEN",8,62,122,184
https://kawalpemilu.org#53094,"KEBON DALEM, PURWAKARTA, KOTA CILEGON, BANTEN",9,62,101,163
https://kawalpemilu.org#53094,"KEBON DALEM, PURWAKARTA, KOTA CILEGON, BANTEN",10,76,118,194
https://kawalpemilu.org#53094,"KEBON DALEM, PURWAKARTA, KOTA CILEGON, BANTEN",11,75,157,233
https://kawalpemilu.org#53094,"KEBON DALEM, PURWAKARTA, KOTA CILEGON, BANTEN",12,65,127,192
https://kawalpemilu.org#53094,"KEBON DALEM, PURWAKARTA, KOTA CILEGON, BANTEN",13,61,149,210
https://kawalpemilu.org#53094,"KEBON DALEM, PURWAKARTA, KOTA CILEGON, BANTEN",14,53,122,175
https://kawalpemilu.org#53094,"KEBON DALEM, PURWAKARTA, KOTA CILEGON, BANTEN",15,80,128,208
https://kawalpemilu.org#53094,"KEBON DALEM, PURWAKARTA, KOTA CILEGON, BANTEN",16,89,140,229
https://kawalpemilu.org#53094,"KEBON DALEM, PURWAKARTA, KOTA CILEGON, BANTEN",17,94,140,234
https://kawalpemilu.org#53094,"KEBON DALEM, PURWAKARTA, KOTA CILEGON, BANTEN",18,104,112,216
https://kawalpemilu.org#53094,"KEBON DALEM, PURWAKARTA, KOTA CILEGON, BANTEN",19,99,152,251
https://kawalpemilu.org#53094,"KEBON DALEM, PURWAKARTA, KOTA CILEGON, BANTEN",20,168,61,229
https://kawalpemilu.org#53094,"KEBON DALEM, PURWAKARTA, KOTA CILEGON, BANTEN",21,74,121,195
https://kawalpemilu.org#53094,"KEBON DALEM, PURWAKARTA, KOTA CILEGON, BANTEN",22,70,109,179
https://kawalpemilu.org#53094,"KEBON DALEM, PURWAKARTA, KOTA CILEGON, BANTEN",23,81,153,234
https://kawalpemilu.org#53094,"KEBON DALEM, PURWAKARTA, KOTA CILEGON, BANTEN",24,76,160,236
https://kawalpemilu.org#53094,"KEBON DALEM, PURWAKARTA, KOTA CILEGON, BANTEN",25,86,125,211
https://kawalpemilu.org#53094,"KEBON DALEM, PURWAKARTA, KOTA CILEGON, BANTEN",26,49,146,195
https://kawalpemilu.org#53094,"KEBON DALEM, PURWAKARTA, KOTA CILEGON, BANTEN",27,53,172,225
https://kawalpemilu.org#53094,"KEBON DALEM, PURWAKARTA, KOTA CILEGON, BANTEN",28,56,150,206
https://kawalpemilu.org#53094,"KEBON DALEM, PURWAKARTA, KOTA CILEGON, BANTEN",29,71,162,233
https://kawalpemilu.org#53094,"KEBON DALEM, PURWAKARTA, KOTA CILEGON, BANTEN",30,48,174,222
https://kawalpemilu.org#53094,"KEBON DALEM, PURWAKARTA, KOTA CILEGON, BANTEN",31,30,159,3
https://kawalpemilu.org#53094,"KEBON DALEM, PURWAKARTA, KOTA CILEGON, BANTEN",32,57,179,236
https://kawalpemilu.org#53094,"KEBON DALEM, PURWAKARTA, KOTA CILEGON, BANTEN",33,71,150,221
https://kawalpemilu.org#53094,"KEBON DALEM, PURWAKARTA, KOTA CILEGON, BANTEN",34,65,104,169
https://kawalpemilu.org#53094,"KEBON DALEM, PURWAKARTA, KOTA CILEGON, BANTEN",35,40,130,170
https://kawalpemilu.org#53094,"KEBON DALEM, PURWAKARTA, KOTA CILEGON, BANTEN",36,54,129,183
https://kawalpemilu.org#53094,"KEBON DALEM, PURWAKARTA, KOTA CILEGON, BANTEN",37,93,160,253
https://kawalpemilu.org#53094,"KEBON DALEM, PURWAKARTA, KOTA CILEGON, BANTEN",38,73,146,219
https://kawalpemilu.org#53094,"KEBON DALEM, PURWAKARTA, KOTA CILEGON, BANTEN",39,120,154,274
https://kawalpemilu.org#53094,"KEBON DALEM, PURWAKARTA, KOTA CILEGON, BANTEN",40,76,124,200
https://kawalpemilu.org#53095,"PURWAKARTA, PURWAKARTA, KOTA CILEGON, BANTEN",1,35,193,228
https://kawalpemilu.org#53095,"PURWAKARTA, PURWAKARTA, KOTA CILEGON, BANTEN",2,33,186,219
https://kawalpemilu.org#53095,"PURWAKARTA, PURWAKARTA, KOTA CILEGON, BANTEN",3,43,214,257
https://kawalpemilu.org#53095,"PURWAKARTA, PURWAKARTA, KOTA CILEGON, BANTEN",4,41,210,251
https://kawalpemilu.org#53095,"PURWAKARTA, PURWAKARTA, KOTA CILEGON, BANTEN",5,63,183,246
https://kawalpemilu.org#53095,"PURWAKARTA, PURWAKARTA, KOTA CILEGON, BANTEN",6,38,204,242
https://kawalpemilu.org#53095,"PURWAKARTA, PURWAKARTA, KOTA CILEGON, BANTEN",8,29,201,230
https://kawalpemilu.org#53095,"PURWAKARTA, PURWAKARTA, KOTA CILEGON, BANTEN",9,51,199,250
https://kawalpemilu.org#53095,"PURWAKARTA, PURWAKARTA, KOTA CILEGON, BANTEN",10,82,128,210
https://kawalpemilu.org#53095,"PURWAKARTA, PURWAKARTA, KOTA CILEGON, BANTEN",11,57,147,204
https://kawalpemilu.org#53095,"PURWAKARTA, PURWAKARTA, KOTA CILEGON, BANTEN",12,29,168,197
https://kawalpemilu.org#53095,"PURWAKARTA, PURWAKARTA, KOTA CILEGON, BANTEN",13,50,207,257
https://kawalpemilu.org#53095,"PURWAKARTA, PURWAKARTA, KOTA CILEGON, BANTEN",14,88,94,182
https://kawalpemilu.org#53095,"PURWAKARTA, PURWAKARTA, KOTA CILEGON, BANTEN",15,56,107,3
https://kawalpemilu.org#53095,"PURWAKARTA, PURWAKARTA, KOTA CILEGON, BANTEN",16,33,205,238
https://kawalpemilu.org#53095,"PURWAKARTA, PURWAKARTA, KOTA CILEGON, BANTEN",17,20,199,219
https://kawalpemilu.org#53095,"PURWAKARTA, PURWAKARTA, KOTA CILEGON, BANTEN",18,43,199,242
https://kawalpemilu.org#53096,"TEGAL BUNDER, PURWAKARTA, KOTA CILEGON, BANTEN",1,32,177,209
https://kawalpemilu.org#53096,"TEGAL BUNDER, PURWAKARTA, KOTA CILEGON, BANTEN",2,37,215,252
https://kawalpemilu.org#53096,"TEGAL BUNDER, PURWAKARTA, KOTA CILEGON, BANTEN",3,39,202,241
https://kawalpemilu.org#53096,"TEGAL BUNDER, PURWAKARTA, KOTA CILEGON, BANTEN",4,39,189,228
https://kawalpemilu.org#53096,"TEGAL BUNDER, PURWAKARTA, KOTA CILEGON, BANTEN",5,39,209,248
https://kawalpemilu.org#53096,"TEGAL BUNDER, PURWAKARTA, KOTA CILEGON, BANTEN",6,32,248,280
https://kawalpemilu.org#53096,"TEGAL BUNDER, PURWAKARTA, KOTA CILEGON, BANTEN",7,27,207,234
https://kawalpemilu.org#53096,"TEGAL BUNDER, PURWAKARTA, KOTA CILEGON, BANTEN",8,37,155,192
https://kawalpemilu.org#53096,"TEGAL BUNDER, PURWAKARTA, KOTA CILEGON, BANTEN",9,35,167,202
https://kawalpemilu.org#53096,"TEGAL BUNDER, PURWAKARTA, KOTA CILEGON, BANTEN",10,14,102,116
https://kawalpemilu.org#53096,"TEGAL BUNDER, PURWAKARTA, KOTA CILEGON, BANTEN",11,39,142,181
https://kawalpemilu.org#53096,"TEGAL BUNDER, PURWAKARTA, KOTA CILEGON, BANTEN",12,53,196,249
https://kawalpemilu.org#53096,"TEGAL BUNDER, PURWAKARTA, KOTA CILEGON, BANTEN",13,35,150,185
https://kawalpemilu.org#53096,"TEGAL BUNDER, PURWAKARTA, KOTA CILEGON, BANTEN",14,23,252,275
https://kawalpemilu.org#53097,"PABEAN, PURWAKARTA, KOTA CILEGON, BANTEN",1,25,217,242
https://kawalpemilu.org#53097,"PABEAN, PURWAKARTA, KOTA CILEGON, BANTEN",2,40,221,261
https://kawalpemilu.org#53097,"PABEAN, PURWAKARTA, KOTA CILEGON, BANTEN",3,40,175,215
https://kawalpemilu.org#53097,"PABEAN, PURWAKARTA, KOTA CILEGON, BANTEN",4,36,169,205
https://kawalpemilu.org#53097,"PABEAN, PURWAKARTA, KOTA CILEGON, BANTEN",5,68,169,237
https://kawalpemilu.org#53097,"PABEAN, PURWAKARTA, KOTA CILEGON, BANTEN",6,32,164,196
https://kawalpemilu.org#53097,"PABEAN, PURWAKARTA, KOTA CILEGON, BANTEN",7,20,185,205
https://kawalpemilu.org#53097,"PABEAN, PURWAKARTA, KOTA CILEGON, BANTEN",8,28,173,201
https://kawalpemilu.org#53097,"PABEAN, PURWAKARTA, KOTA CILEGON, BANTEN",9,25,178,203
https://kawalpemilu.org#53097,"PABEAN, PURWAKARTA, KOTA CILEGON, BANTEN",10,33,171,204
https://kawalpemilu.org#53097,"PABEAN, PURWAKARTA, KOTA CILEGON, BANTEN",11,42,158,200
https://kawalpemilu.org#53099,"WARNASARI, CITANGKIL, KOTA CILEGON, BANTEN",1,82,185,267
https://kawalpemilu.org#53099,"WARNASARI, CITANGKIL, KOTA CILEGON, BANTEN",2,56,160,216
https://kawalpemilu.org#53099,"WARNASARI, CITANGKIL, KOTA CILEGON, BANTEN",3,56,172,228
https://kawalpemilu.org#53099,"WARNASARI, CITANGKIL, KOTA CILEGON, BANTEN",4,50,203,253
https://kawalpemilu.org#53099,"WARNASARI, CITANGKIL, KOTA CILEGON, BANTEN",5,59,184,243
https://kawalpemilu.org#53099,"WARNASARI, CITANGKIL, KOTA CILEGON, BANTEN",6,35,124,159
https://kawalpemilu.org#53099,"WARNASARI, CITANGKIL, KOTA CILEGON, BANTEN",7,72,183,255
https://kawalpemilu.org#53099,"WARNASARI, CITANGKIL, KOTA CILEGON, BANTEN",8,88,149,237
https://kawalpemilu.org#53099,"WARNASARI, CITANGKIL, KOTA CILEGON, BANTEN",9,69,193,262
https://kawalpemilu.org#53099,"WARNASARI, CITANGKIL, KOTA CILEGON, BANTEN",10,54,190,244
https://kawalpemilu.org#53099,"WARNASARI, CITANGKIL, KOTA CILEGON, BANTEN",11,56,197,253
https://kawalpemilu.org#53099,"WARNASARI, CITANGKIL, KOTA CILEGON, BANTEN",12,39,173,212
https://kawalpemilu.org#53099,"WARNASARI, CITANGKIL, KOTA CILEGON, BANTEN",13,28,182,210
https://kawalpemilu.org#53099,"WARNASARI, CITANGKIL, KOTA CILEGON, BANTEN",14,34,180,214
https://kawalpemilu.org#53099,"WARNASARI, CITANGKIL, KOTA CILEGON, BANTEN",15,81,141,222
https://kawalpemilu.org#53099,"WARNASARI, CITANGKIL, KOTA CILEGON, BANTEN",16,81,145,226
https://kawalpemilu.org#53099,"WARNASARI, CITANGKIL, KOTA CILEGON, BANTEN",17,68,119,187
https://kawalpemilu.org#53099,"WARNASARI, CITANGKIL, KOTA CILEGON, BANTEN",18,74,112,186
https://kawalpemilu.org#53099,"WARNASARI, CITANGKIL, KOTA CILEGON, BANTEN",19,98,125,223
https://kawalpemilu.org#53099,"WARNASARI, CITANGKIL, KOTA CILEGON, BANTEN",20,65,119,184
https://kawalpemilu.org#53099,"WARNASARI, CITANGKIL, KOTA CILEGON, BANTEN",22,98,105,203
https://kawalpemilu.org#53099,"WARNASARI, CITANGKIL, KOTA CILEGON, BANTEN",23,84,116,200
https://kawalpemilu.org#53099,"WARNASARI, CITANGKIL, KOTA CILEGON, BANTEN",24,80,111,191
https://kawalpemilu.org#53099,"WARNASARI, CITANGKIL, KOTA CILEGON, BANTEN",25,102,147,249
https://kawalpemilu.org#53099,"WARNASARI, CITANGKIL, KOTA CILEGON, BANTEN",26,90,187,277
https://kawalpemilu.org#53099,"WARNASARI, CITANGKIL, KOTA CILEGON, BANTEN",27,85,145,230
https://kawalpemilu.org#53099,"WARNASARI, CITANGKIL, KOTA CILEGON, BANTEN",28,61,132,193
https://kawalpemilu.org#53099,"WARNASARI, CITANGKIL, KOTA CILEGON, BANTEN",29,95,153,248
https://kawalpemilu.org#53099,"WARNASARI, CITANGKIL, KOTA CILEGON, BANTEN",30,103,179,282
https://kawalpemilu.org#53099,"WARNASARI, CITANGKIL, KOTA CILEGON, BANTEN",31,82,146,228
https://kawalpemilu.org#53099,"WARNASARI, CITANGKIL, KOTA CILEGON, BANTEN",32,72,169,241
https://kawalpemilu.org#53099,"WARNASARI, CITANGKIL, KOTA CILEGON, BANTEN",33,62,133,195
https://kawalpemilu.org#53099,"WARNASARI, CITANGKIL, KOTA CILEGON, BANTEN",34,85,124,209
https://kawalpemilu.org#53099,"WARNASARI, CITANGKIL, KOTA CILEGON, BANTEN",35,90,124,214
https://kawalpemilu.org#53100,"DRINGO, CITANGKIL, KOTA CILEGON, BANTEN",1,23,170,193
https://kawalpemilu.org#53100,"DRINGO, CITANGKIL, KOTA CILEGON, BANTEN",2,25,152,177
https://kawalpemilu.org#53100,"DRINGO, CITANGKIL, KOTA CILEGON, BANTEN",3,42,191,233
https://kawalpemilu.org#53100,"DRINGO, CITANGKIL, KOTA CILEGON, BANTEN",4,46,198,244
https://kawalpemilu.org#53100,"DRINGO, CITANGKIL, KOTA CILEGON, BANTEN",5,44,176,220
https://kawalpemilu.org#53100,"DRINGO, CITANGKIL, KOTA CILEGON, BANTEN",6,29,154,183
https://kawalpemilu.org#53100,"DRINGO, CITANGKIL, KOTA CILEGON, BANTEN",7,26,168,194
https://kawalpemilu.org#53100,"DRINGO, CITANGKIL, KOTA CILEGON, BANTEN",8,37,159,196
https://kawalpemilu.org#53100,"DRINGO, CITANGKIL, KOTA CILEGON, BANTEN",9,32,182,214
https://kawalpemilu.org#53100,"DRINGO, CITANGKIL, KOTA CILEGON, BANTEN",10,37,188,225
https://kawalpemilu.org#53100,"DRINGO, CITANGKIL, KOTA CILEGON, BANTEN",11,41,199,240
https://kawalpemilu.org#53100,"DRINGO, CITANGKIL, KOTA CILEGON, BANTEN",12,57,137,145
https://kawalpemilu.org#53100,"DRINGO, CITANGKIL, KOTA CILEGON, BANTEN",13,46,184,230
https://kawalpemilu.org#53100,"DRINGO, CITANGKIL, KOTA CILEGON, BANTEN",14,57,161,218
https://kawalpemilu.org#53100,"DRINGO, CITANGKIL, KOTA CILEGON, BANTEN",15,61,194,255
https://kawalpemilu.org#53100,"DRINGO, CITANGKIL, KOTA CILEGON, BANTEN",16,48,115,163
https://kawalpemilu.org#53100,"DRINGO, CITANGKIL, KOTA CILEGON, BANTEN",17,23,184,207
https://kawalpemilu.org#53100,"DRINGO, CITANGKIL, KOTA CILEGON, BANTEN",18,35,176,211
https://kawalpemilu.org#53100,"DRINGO, CITANGKIL, KOTA CILEGON, BANTEN",19,29,193,222
https://kawalpemilu.org#53100,"DRINGO, CITANGKIL, KOTA CILEGON, BANTEN",20,15,127,142
https://kawalpemilu.org#53100,"DRINGO, CITANGKIL, KOTA CILEGON, BANTEN",21,66,147,213
https://kawalpemilu.org#53100,"DRINGO, CITANGKIL, KOTA CILEGON, BANTEN",22,77,145,222
https://kawalpemilu.org#53100,"DRINGO, CITANGKIL, KOTA CILEGON, BANTEN",23,25,129,154
https://kawalpemilu.org#53101,"LEBAK DENOK, CITANGKIL, KOTA CILEGON, BANTEN",1,96,160,256
https://kawalpemilu.org#53101,"LEBAK DENOK, CITANGKIL, KOTA CILEGON, BANTEN",2,59,165,224
https://kawalpemilu.org#53101,"LEBAK DENOK, CITANGKIL, KOTA CILEGON, BANTEN",3,71,199,270
https://kawalpemilu.org#53101,"LEBAK DENOK, CITANGKIL, KOTA CILEGON, BANTEN",4,41,135,176
https://kawalpemilu.org#53101,"LEBAK DENOK, CITANGKIL, KOTA CILEGON, BANTEN",5,49,199,248
https://kawalpemilu.org#53101,"LEBAK DENOK, CITANGKIL, KOTA CILEGON, BANTEN",6,50,196,246
https://kawalpemilu.org#53101,"LEBAK DENOK, CITANGKIL, KOTA CILEGON, BANTEN",7,47,172,219
https://kawalpemilu.org#53101,"LEBAK DENOK, CITANGKIL, KOTA CILEGON, BANTEN",8,52,125,177
https://kawalpemilu.org#53101,"LEBAK DENOK, CITANGKIL, KOTA CILEGON, BANTEN",9,102,162,264
https://kawalpemilu.org#53101,"LEBAK DENOK, CITANGKIL, KOTA CILEGON, BANTEN",10,31,129,160
https://kawalpemilu.org#53101,"LEBAK DENOK, CITANGKIL, KOTA CILEGON, BANTEN",11,37,176,213
https://kawalpemilu.org#53101,"LEBAK DENOK, CITANGKIL, KOTA CILEGON, BANTEN",12,43,187,230
https://kawalpemilu.org#53101,"LEBAK DENOK, CITANGKIL, KOTA CILEGON, BANTEN",13,30,167,197
https://kawalpemilu.org#53101,"LEBAK DENOK, CITANGKIL, KOTA CILEGON, BANTEN",14,59,197,256
https://kawalpemilu.org#53101,"LEBAK DENOK, CITANGKIL, KOTA CILEGON, BANTEN",15,38,171,209
https://kawalpemilu.org#53101,"LEBAK DENOK, CITANGKIL, KOTA CILEGON, BANTEN",16,34,220,254
https://kawalpemilu.org#53101,"LEBAK DENOK, CITANGKIL, KOTA CILEGON, BANTEN",17,48,197,245
https://kawalpemilu.org#53101,"LEBAK DENOK, CITANGKIL, KOTA CILEGON, BANTEN",18,41,166,207
https://kawalpemilu.org#53101,"LEBAK DENOK, CITANGKIL, KOTA CILEGON, BANTEN",19,41,181,222
https://kawalpemilu.org#53101,"LEBAK DENOK, CITANGKIL, KOTA CILEGON, BANTEN",20,34,233,267
https://kawalpemilu.org#53101,"LEBAK DENOK, CITANGKIL, KOTA CILEGON, BANTEN",21,8,132,140
https://kawalpemilu.org#53102,"TAMAN BARU, CITANGKIL, KOTA CILEGON, BANTEN",1,64,137,201
https://kawalpemilu.org#53102,"TAMAN BARU, CITANGKIL, KOTA CILEGON, BANTEN",2,33,174,207
https://kawalpemilu.org#53102,"TAMAN BARU, CITANGKIL, KOTA CILEGON, BANTEN",3,34,164,198
https://kawalpemilu.org#53102,"TAMAN BARU, CITANGKIL, KOTA CILEGON, BANTEN",4,50,214,264
https://kawalpemilu.org#53102,"TAMAN BARU, CITANGKIL, KOTA CILEGON, BANTEN",5,29,192,221
https://kawalpemilu.org#53102,"TAMAN BARU, CITANGKIL, KOTA CILEGON, BANTEN",6,41,218,259
https://kawalpemilu.org#53102,"TAMAN BARU, CITANGKIL, KOTA CILEGON, BANTEN",7,19,242,261
https://kawalpemilu.org#53102,"TAMAN BARU, CITANGKIL, KOTA CILEGON, BANTEN",8,22,242,264
https://kawalpemilu.org#53102,"TAMAN BARU, CITANGKIL, KOTA CILEGON, BANTEN",9,32,202,234
https://kawalpemilu.org#53102,"TAMAN BARU, CITANGKIL, KOTA CILEGON, BANTEN",10,28,196,224
https://kawalpemilu.org#53102,"TAMAN BARU, CITANGKIL, KOTA CILEGON, BANTEN",11,30,195,225
https://kawalpemilu.org#53102,"TAMAN BARU, CITANGKIL, KOTA CILEGON, BANTEN",12,29,227,256
https://kawalpemilu.org#53102,"TAMAN BARU, CITANGKIL, KOTA CILEGON, BANTEN",13,57,213,270
https://kawalpemilu.org#53102,"TAMAN BARU, CITANGKIL, KOTA CILEGON, BANTEN",14,40,195,235
https://kawalpemilu.org#53102,"TAMAN BARU, CITANGKIL, KOTA CILEGON, BANTEN",15,45,223,268
https://kawalpemilu.org#53102,"TAMAN BARU, CITANGKIL, KOTA CILEGON, BANTEN",16,36,180,216
https://kawalpemilu.org#53102,"TAMAN BARU, CITANGKIL, KOTA CILEGON, BANTEN",17,27,175,202
https://kawalpemilu.org#53102,"TAMAN BARU, CITANGKIL, KOTA CILEGON, BANTEN",18,51,171,222
https://kawalpemilu.org#53102,"TAMAN BARU, CITANGKIL, KOTA CILEGON, BANTEN",19,28,164,192
https://kawalpemilu.org#53102,"TAMAN BARU, CITANGKIL, KOTA CILEGON, BANTEN",20,100,107,207
https://kawalpemilu.org#53102,"TAMAN BARU, CITANGKIL, KOTA CILEGON, BANTEN",21,87,117,204
https://kawalpemilu.org#53102,"TAMAN BARU, CITANGKIL, KOTA CILEGON, BANTEN",22,80,159,239
https://kawalpemilu.org#53103,"KEBONSARI, CITANGKIL, KOTA CILEGON, BANTEN",1,50,209,259
https://kawalpemilu.org#53103,"KEBONSARI, CITANGKIL, KOTA CILEGON, BANTEN",2,61,195,256
https://kawalpemilu.org#53103,"KEBONSARI, CITANGKIL, KOTA CILEGON, BANTEN",3,41,189,230
https://kawalpemilu.org#53103,"KEBONSARI, CITANGKIL, KOTA CILEGON, BANTEN",4,31,217,248
https://kawalpemilu.org#53103,"KEBONSARI, CITANGKIL, KOTA CILEGON, BANTEN",5,38,146,184
https://kawalpemilu.org#53103,"KEBONSARI, CITANGKIL, KOTA CILEGON, BANTEN",6,25,216,241
https://kawalpemilu.org#53103,"KEBONSARI, CITANGKIL, KOTA CILEGON, BANTEN",7,35,184,219
https://kawalpemilu.org#53103,"KEBONSARI, CITANGKIL, KOTA CILEGON, BANTEN",8,43,205,248
https://kawalpemilu.org#53103,"KEBONSARI, CITANGKIL, KOTA CILEGON, BANTEN",9,45,150,195
https://kawalpemilu.org#53103,"KEBONSARI, CITANGKIL, KOTA CILEGON, BANTEN",10,32,215,247
https://kawalpemilu.org#53103,"KEBONSARI, CITANGKIL, KOTA CILEGON, BANTEN",11,59,209,268
https://kawalpemilu.org#53103,"KEBONSARI, CITANGKIL, KOTA CILEGON, BANTEN",12,45,164,209
https://kawalpemilu.org#53103,"KEBONSARI, CITANGKIL, KOTA CILEGON, BANTEN",13,37,164,201
https://kawalpemilu.org#53103,"KEBONSARI, CITANGKIL, KOTA CILEGON, BANTEN",14,62,152,214
https://kawalpemilu.org#53103,"KEBONSARI, CITANGKIL, KOTA CILEGON, BANTEN",15,68,144,212
https://kawalpemilu.org#53103,"KEBONSARI, CITANGKIL, KOTA CILEGON, BANTEN",16,61,155,216
https://kawalpemilu.org#53103,"KEBONSARI, CITANGKIL, KOTA CILEGON, BANTEN",17,64,161,225
https://kawalpemilu.org#53103,"KEBONSARI, CITANGKIL, KOTA CILEGON, BANTEN",18,117,78,195
https://kawalpemilu.org#53103,"KEBONSARI, CITANGKIL, KOTA CILEGON, BANTEN",19,92,114,206
https://kawalpemilu.org#53103,"KEBONSARI, CITANGKIL, KOTA CILEGON, BANTEN",20,80,135,215
https://kawalpemilu.org#53103,"KEBONSARI, CITANGKIL, KOTA CILEGON, BANTEN",21,104,131,235
https://kawalpemilu.org#53103,"KEBONSARI, CITANGKIL, KOTA CILEGON, BANTEN",22,92,125,217
https://kawalpemilu.org#53103,"KEBONSARI, CITANGKIL, KOTA CILEGON, BANTEN",23,102,111,213
https://kawalpemilu.org#53103,"KEBONSARI, CITANGKIL, KOTA CILEGON, BANTEN",24,83,113,196
https://kawalpemilu.org#53103,"KEBONSARI, CITANGKIL, KOTA CILEGON, BANTEN",25,102,136,238
https://kawalpemilu.org#53103,"KEBONSARI, CITANGKIL, KOTA CILEGON, BANTEN",26,50,157,207
https://kawalpemilu.org#53103,"KEBONSARI, CITANGKIL, KOTA CILEGON, BANTEN",27,44,166,210
https://kawalpemilu.org#53103,"KEBONSARI, CITANGKIL, KOTA CILEGON, BANTEN",28,57,174,243
https://kawalpemilu.org#53103,"KEBONSARI, CITANGKIL, KOTA CILEGON, BANTEN",29,37,179,216
https://kawalpemilu.org#53103,"KEBONSARI, CITANGKIL, KOTA CILEGON, BANTEN",30,79,156,235
https://kawalpemilu.org#53103,"KEBONSARI, CITANGKIL, KOTA CILEGON, BANTEN",31,53,159,212
https://kawalpemilu.org#53103,"KEBONSARI, CITANGKIL, KOTA CILEGON, BANTEN",32,53,158,211
https://kawalpemilu.org#53103,"KEBONSARI, CITANGKIL, KOTA CILEGON, BANTEN",33,50,161,211
https://kawalpemilu.org#53104,"SAMANGRAYA, CITANGKIL, KOTA CILEGON, BANTEN",1,60,103,163
https://kawalpemilu.org#53104,"SAMANGRAYA, CITANGKIL, KOTA CILEGON, BANTEN",2,67,115,182
https://kawalpemilu.org#53104,"SAMANGRAYA, CITANGKIL, KOTA CILEGON, BANTEN",3,26,121,147
https://kawalpemilu.org#53104,"SAMANGRAYA, CITANGKIL, KOTA CILEGON, BANTEN",4,55,162,217
https://kawalpemilu.org#53104,"SAMANGRAYA, CITANGKIL, KOTA CILEGON, BANTEN",5,49,135,184
https://kawalpemilu.org#53104,"SAMANGRAYA, CITANGKIL, KOTA CILEGON, BANTEN",6,30,85,115
https://kawalpemilu.org#53104,"SAMANGRAYA, CITANGKIL, KOTA CILEGON, BANTEN",7,56,179,235
https://kawalpemilu.org#53104,"SAMANGRAYA, CITANGKIL, KOTA CILEGON, BANTEN",8,50,173,223
https://kawalpemilu.org#53104,"SAMANGRAYA, CITANGKIL, KOTA CILEGON, BANTEN",9,42,189,231
https://kawalpemilu.org#53104,"SAMANGRAYA, CITANGKIL, KOTA CILEGON, BANTEN",10,37,166,203
https://kawalpemilu.org#53104,"SAMANGRAYA, CITANGKIL, KOTA CILEGON, BANTEN",11,54,151,205
https://kawalpemilu.org#53104,"SAMANGRAYA, CITANGKIL, KOTA CILEGON, BANTEN",12,47,147,194
https://kawalpemilu.org#53104,"SAMANGRAYA, CITANGKIL, KOTA CILEGON, BANTEN",13,61,145,206
https://kawalpemilu.org#53104,"SAMANGRAYA, CITANGKIL, KOTA CILEGON, BANTEN",14,47,135,182
https://kawalpemilu.org#53104,"SAMANGRAYA, CITANGKIL, KOTA CILEGON, BANTEN",15,49,135,184
https://kawalpemilu.org#53104,"SAMANGRAYA, CITANGKIL, KOTA CILEGON, BANTEN",16,39,208,247
https://kawalpemilu.org#53104,"SAMANGRAYA, CITANGKIL, KOTA CILEGON, BANTEN",17,64,168,232
https://kawalpemilu.org#53104,"SAMANGRAYA, CITANGKIL, KOTA CILEGON, BANTEN",18,36,214,250
https://kawalpemilu.org#53104,"SAMANGRAYA, CITANGKIL, KOTA CILEGON, BANTEN",19,33,210,243
https://kawalpemilu.org#53104,"SAMANGRAYA, CITANGKIL, KOTA CILEGON, BANTEN",20,55,193,248
https://kawalpemilu.org#53104,"SAMANGRAYA, CITANGKIL, KOTA CILEGON, BANTEN",21,57,192,249
https://kawalpemilu.org#53104,"SAMANGRAYA, CITANGKIL, KOTA CILEGON, BANTEN",22,38,221,259
https://kawalpemilu.org#53104,"SAMANGRAYA, CITANGKIL, KOTA CILEGON, BANTEN",23,41,187,228
https://kawalpemilu.org#53104,"SAMANGRAYA, CITANGKIL, KOTA CILEGON, BANTEN",24,36,211,247
https://kawalpemilu.org#53104,"SAMANGRAYA, CITANGKIL, KOTA CILEGON, BANTEN",25,22,123,145
https://kawalpemilu.org#53104,"SAMANGRAYA, CITANGKIL, KOTA CILEGON, BANTEN",26,64,220,284
https://kawalpemilu.org#53104,"SAMANGRAYA, CITANGKIL, KOTA CILEGON, BANTEN",27,43,114,157
https://kawalpemilu.org#53105,"CITANGKIL, CITANGKIL, KOTA CILEGON, BANTEN",1,97,145,242
https://kawalpemilu.org#53105,"CITANGKIL, CITANGKIL, KOTA CILEGON, BANTEN",2,55,162,217
https://kawalpemilu.org#53105,"CITANGKIL, CITANGKIL, KOTA CILEGON, BANTEN",3,43,178,221
https://kawalpemilu.org#53105,"CITANGKIL, CITANGKIL, KOTA CILEGON, BANTEN",4,47,193,240
https://kawalpemilu.org#53105,"CITANGKIL, CITANGKIL, KOTA CILEGON, BANTEN",5,79,150,229
https://kawalpemilu.org#53105,"CITANGKIL, CITANGKIL, KOTA CILEGON, BANTEN",6,64,154,218
https://kawalpemilu.org#53105,"CITANGKIL, CITANGKIL, KOTA CILEGON, BANTEN",7,61,207,268
https://kawalpemilu.org#53105,"CITANGKIL, CITANGKIL, KOTA CILEGON, BANTEN",8,62,155,217
https://kawalpemilu.org#53105,"CITANGKIL, CITANGKIL, KOTA CILEGON, BANTEN",9,33,155,188
https://kawalpemilu.org#53105,"CITANGKIL, CITANGKIL, KOTA CILEGON, BANTEN",10,52,132,184
https://kawalpemilu.org#53105,"CITANGKIL, CITANGKIL, KOTA CILEGON, BANTEN",11,41,140,181
https://kawalpemilu.org#53105,"CITANGKIL, CITANGKIL, KOTA CILEGON, BANTEN",12,125,111,236
https://kawalpemilu.org#53105,"CITANGKIL, CITANGKIL, KOTA CILEGON, BANTEN",13,62,158,216
https://kawalpemilu.org#53105,"CITANGKIL, CITANGKIL, KOTA CILEGON, BANTEN",14,48,198,246
https://kawalpemilu.org#53105,"CITANGKIL, CITANGKIL, KOTA CILEGON, BANTEN",15,88,109,197
https://kawalpemilu.org#53105,"CITANGKIL, CITANGKIL, KOTA CILEGON, BANTEN",16,36,211,247
https://kawalpemilu.org#53105,"CITANGKIL, CITANGKIL, KOTA CILEGON, BANTEN",17,136,92,228
https://kawalpemilu.org#53105,"CITANGKIL, CITANGKIL, KOTA CILEGON, BANTEN",18,60,120,180
https://kawalpemilu.org#53105,"CITANGKIL, CITANGKIL, KOTA CILEGON, BANTEN",19,44,124,168
https://kawalpemilu.org#53105,"CITANGKIL, CITANGKIL, KOTA CILEGON, BANTEN",20,51,141,192
https://kawalpemilu.org#53105,"CITANGKIL, CITANGKIL, KOTA CILEGON, BANTEN",21,66,136,202
https://kawalpemilu.org#53105,"CITANGKIL, CITANGKIL, KOTA CILEGON, BANTEN",22,42,117,159
https://kawalpemilu.org#53105,"CITANGKIL, CITANGKIL, KOTA CILEGON, BANTEN",23,55,147,202
https://kawalpemilu.org#53105,"CITANGKIL, CITANGKIL, KOTA CILEGON, BANTEN",24,65,146,211
https://kawalpemilu.org#53105,"CITANGKIL, CITANGKIL, KOTA CILEGON, BANTEN",25,45,204,249
https://kawalpemilu.org#53105,"CITANGKIL, CITANGKIL, KOTA CILEGON, BANTEN",26,42,194,236
https://kawalpemilu.org#53105,"CITANGKIL, CITANGKIL, KOTA CILEGON, BANTEN",27,45,183,228
https://kawalpemilu.org#53105,"CITANGKIL, CITANGKIL, KOTA CILEGON, BANTEN",28,20,142,162
https://kawalpemilu.org#53105,"CITANGKIL, CITANGKIL, KOTA CILEGON, BANTEN",29,27,136,163
https://kawalpemilu.org#53105,"CITANGKIL, CITANGKIL, KOTA CILEGON, BANTEN",30,18,158,176
https://kawalpemilu.org#53105,"CITANGKIL, CITANGKIL, KOTA CILEGON, BANTEN",31,72,129,201
https://kawalpemilu.org#53105,"CITANGKIL, CITANGKIL, KOTA CILEGON, BANTEN",32,56,128,184
https://kawalpemilu.org#53105,"CITANGKIL, CITANGKIL, KOTA CILEGON, BANTEN",33,53,111,164
https://kawalpemilu.org#53105,"CITANGKIL, CITANGKIL, KOTA CILEGON, BANTEN",34,59,124,183
https://kawalpemilu.org#53105,"CITANGKIL, CITANGKIL, KOTA CILEGON, BANTEN",35,88,107,195
https://kawalpemilu.org#53105,"CITANGKIL, CITANGKIL, KOTA CILEGON, BANTEN",36,83,104,187
https://kawalpemilu.org#53105,"CITANGKIL, CITANGKIL, KOTA CILEGON, BANTEN",37,74,138,212
https://kawalpemilu.org#53105,"CITANGKIL, CITANGKIL, KOTA CILEGON, BANTEN",38,100,165,265
https://kawalpemilu.org#53105,"CITANGKIL, CITANGKIL, KOTA CILEGON, BANTEN",39,76,190,266
https://kawalpemilu.org#53105,"CITANGKIL, CITANGKIL, KOTA CILEGON, BANTEN",40,63,175,238
https://kawalpemilu.org#53105,"CITANGKIL, CITANGKIL, KOTA CILEGON, BANTEN",41,85,98,183
https://kawalpemilu.org#53105,"CITANGKIL, CITANGKIL, KOTA CILEGON, BANTEN",42,82,82,164
https://kawalpemilu.org#53105,"CITANGKIL, CITANGKIL, KOTA CILEGON, BANTEN",43,89,117,206
https://kawalpemilu.org#53105,"CITANGKIL, CITANGKIL, KOTA CILEGON, BANTEN",44,98,138,236
https://kawalpemilu.org#53105,"CITANGKIL, CITANGKIL, KOTA CILEGON, BANTEN",45,86,109,195
https://kawalpemilu.org#53105,"CITANGKIL, CITANGKIL, KOTA CILEGON, BANTEN",46,77,94,171
https://kawalpemilu.org#53105,"CITANGKIL, CITANGKIL, KOTA CILEGON, BANTEN",47,56,118,174
https://kawalpemilu.org#53105,"CITANGKIL, CITANGKIL, KOTA CILEGON, BANTEN",48,74,159,233
https://kawalpemilu.org#53108,"SERANG, SERANG, KOTA SERANG, BANTEN",1,61,222,283
https://kawalpemilu.org#53108,"SERANG, SERANG, KOTA SERANG, BANTEN",2,69,196,265
https://kawalpemilu.org#53108,"SERANG, SERANG, KOTA SERANG, BANTEN",3,44,110,154
https://kawalpemilu.org#53108,"SERANG, SERANG, KOTA SERANG, BANTEN",4,51,183,234
https://kawalpemilu.org#53108,"SERANG, SERANG, KOTA SERANG, BANTEN",5,65,179,244
https://kawalpemilu.org#53108,"SERANG, SERANG, KOTA SERANG, BANTEN",6,43,180,223
https://kawalpemilu.org#53108,"SERANG, SERANG, KOTA SERANG, BANTEN",7,70,128,198
https://kawalpemilu.org#53108,"SERANG, SERANG, KOTA SERANG, BANTEN",8,59,183,242
https://kawalpemilu.org#53108,"SERANG, SERANG, KOTA SERANG, BANTEN",9,34,173,207
https://kawalpemilu.org#53108,"SERANG, SERANG, KOTA SERANG, BANTEN",10,42,208,250
https://kawalpemilu.org#53108,"SERANG, SERANG, KOTA SERANG, BANTEN",11,53,213,266
https://kawalpemilu.org#53108,"SERANG, SERANG, KOTA SERANG, BANTEN",12,56,191,247
https://kawalpemilu.org#53108,"SERANG, SERANG, KOTA SERANG, BANTEN",13,58,187,245
https://kawalpemilu.org#53108,"SERANG, SERANG, KOTA SERANG, BANTEN",14,58,224,282
https://kawalpemilu.org#53108,"SERANG, SERANG, KOTA SERANG, BANTEN",15,49,186,235
https://kawalpemilu.org#53108,"SERANG, SERANG, KOTA SERANG, BANTEN",16,72,148,220
https://kawalpemilu.org#53108,"SERANG, SERANG, KOTA SERANG, BANTEN",17,67,179,246
https://kawalpemilu.org#53108,"SERANG, SERANG, KOTA SERANG, BANTEN",18,71,209,280
https://kawalpemilu.org#53108,"SERANG, SERANG, KOTA SERANG, BANTEN",19,46,212,258
https://kawalpemilu.org#53108,"SERANG, SERANG, KOTA SERANG, BANTEN",20,51,184,235
https://kawalpemilu.org#53108,"SERANG, SERANG, KOTA SERANG, BANTEN",21,45,178,223
https://kawalpemilu.org#53108,"SERANG, SERANG, KOTA SERANG, BANTEN",22,74,154,228
https://kawalpemilu.org#53108,"SERANG, SERANG, KOTA SERANG, BANTEN",23,66,166,232
https://kawalpemilu.org#53108,"SERANG, SERANG, KOTA SERANG, BANTEN",24,91,171,262
https://kawalpemilu.org#53108,"SERANG, SERANG, KOTA SERANG, BANTEN",25,58,179,237
https://kawalpemilu.org#53108,"SERANG, SERANG, KOTA SERANG, BANTEN",26,72,182,254
https://kawalpemilu.org#53108,"SERANG, SERANG, KOTA SERANG, BANTEN",27,53,225,278
https://kawalpemilu.org#53108,"SERANG, SERANG, KOTA SERANG, BANTEN",28,42,207,249
https://kawalpemilu.org#53108,"SERANG, SERANG, KOTA SERANG, BANTEN",29,60,205,265
https://kawalpemilu.org#53108,"SERANG, SERANG, KOTA SERANG, BANTEN",30,76,178,254
https://kawalpemilu.org#53108,"SERANG, SERANG, KOTA SERANG, BANTEN",31,48,196,244
https://kawalpemilu.org#53108,"SERANG, SERANG, KOTA SERANG, BANTEN",32,55,183,238
https://kawalpemilu.org#53108,"SERANG, SERANG, KOTA SERANG, BANTEN",33,56,134,190
https://kawalpemilu.org#53108,"SERANG, SERANG, KOTA SERANG, BANTEN",34,53,146,199
https://kawalpemilu.org#53108,"SERANG, SERANG, KOTA SERANG, BANTEN",35,105,123,228
https://kawalpemilu.org#53108,"SERANG, SERANG, KOTA SERANG, BANTEN",36,80,145,225
https://kawalpemilu.org#53108,"SERANG, SERANG, KOTA SERANG, BANTEN",37,100,139,239
https://kawalpemilu.org#53108,"SERANG, SERANG, KOTA SERANG, BANTEN",38,95,176,271
https://kawalpemilu.org#53108,"SERANG, SERANG, KOTA SERANG, BANTEN",39,98,201,299
https://kawalpemilu.org#53108,"SERANG, SERANG, KOTA SERANG, BANTEN",40,61,175,236
https://kawalpemilu.org#53108,"SERANG, SERANG, KOTA SERANG, BANTEN",41,53,206,259
https://kawalpemilu.org#53108,"SERANG, SERANG, KOTA SERANG, BANTEN",42,54,170,224
https://kawalpemilu.org#53108,"SERANG, SERANG, KOTA SERANG, BANTEN",43,48,140,188
https://kawalpemilu.org#53108,"SERANG, SERANG, KOTA SERANG, BANTEN",44,51,123,174
https://kawalpemilu.org#53108,"SERANG, SERANG, KOTA SERANG, BANTEN",45,83,150,233
https://kawalpemilu.org#53108,"SERANG, SERANG, KOTA SERANG, BANTEN",46,51,200,251
https://kawalpemilu.org#53108,"SERANG, SERANG, KOTA SERANG, BANTEN",47,88,137,225
https://kawalpemilu.org#53108,"SERANG, SERANG, KOTA SERANG, BANTEN",48,54,106,160
https://kawalpemilu.org#53108,"SERANG, SERANG, KOTA SERANG, BANTEN",49,56,105,161
https://kawalpemilu.org#53108,"SERANG, SERANG, KOTA SERANG, BANTEN",50,58,172,230
https://kawalpemilu.org#53108,"SERANG, SERANG, KOTA SERANG, BANTEN",51,63,180,243
https://kawalpemilu.org#53108,"SERANG, SERANG, KOTA SERANG, BANTEN",52,96,155,251
https://kawalpemilu.org#53108,"SERANG, SERANG, KOTA SERANG, BANTEN",53,63,163,226
https://kawalpemilu.org#53108,"SERANG, SERANG, KOTA SERANG, BANTEN",54,62,175,237
https://kawalpemilu.org#53108,"SERANG, SERANG, KOTA SERANG, BANTEN",55,56,137,193
https://kawalpemilu.org#53108,"SERANG, SERANG, KOTA SERANG, BANTEN",56,73,161,234
https://kawalpemilu.org#53108,"SERANG, SERANG, KOTA SERANG, BANTEN",57,83,109,192
https://kawalpemilu.org#53108,"SERANG, SERANG, KOTA SERANG, BANTEN",58,68,186,254
https://kawalpemilu.org#53108,"SERANG, SERANG, KOTA SERANG, BANTEN",59,77,153,230
https://kawalpemilu.org#53108,"SERANG, SERANG, KOTA SERANG, BANTEN",60,65,106,171
https://kawalpemilu.org#53108,"SERANG, SERANG, KOTA SERANG, BANTEN",61,68,187,255
https://kawalpemilu.org#53108,"SERANG, SERANG, KOTA SERANG, BANTEN",62,59,164,223
https://kawalpemilu.org#53108,"SERANG, SERANG, KOTA SERANG, BANTEN",63,67,146,213
https://kawalpemilu.org#53108,"SERANG, SERANG, KOTA SERANG, BANTEN",64,57,212,269
https://kawalpemilu.org#53108,"SERANG, SERANG, KOTA SERANG, BANTEN",65,30,137,167
https://kawalpemilu.org#53108,"SERANG, SERANG, KOTA SERANG, BANTEN",66,37,133,170
https://kawalpemilu.org#53108,"SERANG, SERANG, KOTA SERANG, BANTEN",67,50,185,235
https://kawalpemilu.org#53108,"SERANG, SERANG, KOTA SERANG, BANTEN",68,38,196,234
https://kawalpemilu.org#53108,"SERANG, SERANG, KOTA SERANG, BANTEN",69,0,0,0
https://kawalpemilu.org#53108,"SERANG, SERANG, KOTA SERANG, BANTEN",70,61,98,159
https://kawalpemilu.org#53108,"SERANG, SERANG, KOTA SERANG, BANTEN",71,39,93,132
https://kawalpemilu.org#53108,"SERANG, SERANG, KOTA SERANG, BANTEN",72,61,131,192
https://kawalpemilu.org#53108,"SERANG, SERANG, KOTA SERANG, BANTEN",73,67,160,227
https://kawalpemilu.org#53108,"SERANG, SERANG, KOTA SERANG, BANTEN",74,66,144,210
https://kawalpemilu.org#53108,"SERANG, SERANG, KOTA SERANG, BANTEN",75,85,199,284
https://kawalpemilu.org#53108,"SERANG, SERANG, KOTA SERANG, BANTEN",76,38,195,233
https://kawalpemilu.org#53108,"SERANG, SERANG, KOTA SERANG, BANTEN",77,23,66,89
https://kawalpemilu.org#53108,"SERANG, SERANG, KOTA SERANG, BANTEN",78,35,73,108
https://kawalpemilu.org#53108,"SERANG, SERANG, KOTA SERANG, BANTEN",79,30,90,120
https://kawalpemilu.org#53108,"SERANG, SERANG, KOTA SERANG, BANTEN",80,7,48,55
https://kawalpemilu.org#53108,"SERANG, SERANG, KOTA SERANG, BANTEN",81,25,50,74
https://kawalpemilu.org#53108,"SERANG, SERANG, KOTA SERANG, BANTEN",82,36,83,119
https://kawalpemilu.org#53108,"SERANG, SERANG, KOTA SERANG, BANTEN",83,26,69,95
https://kawalpemilu.org#53109,"CIPARE, SERANG, KOTA SERANG, BANTEN",1,66,160,226
https://kawalpemilu.org#53109,"CIPARE, SERANG, KOTA SERANG, BANTEN",2,57,167,224
https://kawalpemilu.org#53109,"CIPARE, SERANG, KOTA SERANG, BANTEN",3,58,198,256
https://kawalpemilu.org#53109,"CIPARE, SERANG, KOTA SERANG, BANTEN",4,91,183,274
https://kawalpemilu.org#53109,"CIPARE, SERANG, KOTA SERANG, BANTEN",5,80,206,286
https://kawalpemilu.org#53109,"CIPARE, SERANG, KOTA SERANG, BANTEN",6,49,144,193
https://kawalpemilu.org#53109,"CIPARE, SERANG, KOTA SERANG, BANTEN",7,64,176,240
https://kawalpemilu.org#53109,"CIPARE, SERANG, KOTA SERANG, BANTEN",8,79,128,207
https://kawalpemilu.org#53109,"CIPARE, SERANG, KOTA SERANG, BANTEN",9,65,125,190
https://kawalpemilu.org#53109,"CIPARE, SERANG, KOTA SERANG, BANTEN",10,79,145,224
https://kawalpemilu.org#53109,"CIPARE, SERANG, KOTA SERANG, BANTEN",11,50,142,192
https://kawalpemilu.org#53109,"CIPARE, SERANG, KOTA SERANG, BANTEN",12,80,154,234
https://kawalpemilu.org#53109,"CIPARE, SERANG, KOTA SERANG, BANTEN",13,71,150,221
https://kawalpemilu.org#53109,"CIPARE, SERANG, KOTA SERANG, BANTEN",14,69,150,219
https://kawalpemilu.org#53109,"CIPARE, SERANG, KOTA SERANG, BANTEN",15,58,170,228
https://kawalpemilu.org#53109,"CIPARE, SERANG, KOTA SERANG, BANTEN",16,56,142,198
https://kawalpemilu.org#53109,"CIPARE, SERANG, KOTA SERANG, BANTEN",17,42,126,168
https://kawalpemilu.org#53109,"CIPARE, SERANG, KOTA SERANG, BANTEN",18,119,144,263
https://kawalpemilu.org#53109,"CIPARE, SERANG, KOTA SERANG, BANTEN",19,67,168,235
https://kawalpemilu.org#53109,"CIPARE, SERANG, KOTA SERANG, BANTEN",20,73,171,244
https://kawalpemilu.org#53109,"CIPARE, SERANG, KOTA SERANG, BANTEN",21,69,163,232
https://kawalpemilu.org#53109,"CIPARE, SERANG, KOTA SERANG, BANTEN",22,69,165,234
https://kawalpemilu.org#53109,"CIPARE, SERANG, KOTA SERANG, BANTEN",23,55,194,255
https://kawalpemilu.org#53109,"CIPARE, SERANG, KOTA SERANG, BANTEN",24,80,169,249
https://kawalpemilu.org#53109,"CIPARE, SERANG, KOTA SERANG, BANTEN",25,62,155,217
https://kawalpemilu.org#53109,"CIPARE, SERANG, KOTA SERANG, BANTEN",26,50,211,261
https://kawalpemilu.org#53109,"CIPARE, SERANG, KOTA SERANG, BANTEN",27,46,189,235
https://kawalpemilu.org#53109,"CIPARE, SERANG, KOTA SERANG, BANTEN",28,49,185,234
https://kawalpemilu.org#53109,"CIPARE, SERANG, KOTA SERANG, BANTEN",29,64,193,257
https://kawalpemilu.org#53109,"CIPARE, SERANG, KOTA SERANG, BANTEN",30,79,179,258
https://kawalpemilu.org#53109,"CIPARE, SERANG, KOTA SERANG, BANTEN",31,69,185,254
https://kawalpemilu.org#53109,"CIPARE, SERANG, KOTA SERANG, BANTEN",32,77,187,0
https://kawalpemilu.org#53109,"CIPARE, SERANG, KOTA SERANG, BANTEN",33,92,148,240
https://kawalpemilu.org#53109,"CIPARE, SERANG, KOTA SERANG, BANTEN",34,58,188,246
https://kawalpemilu.org#53109,"CIPARE, SERANG, KOTA SERANG, BANTEN",35,83,192,275
https://kawalpemilu.org#53109,"CIPARE, SERANG, KOTA SERANG, BANTEN",36,93,169,262
https://kawalpemilu.org#53109,"CIPARE, SERANG, KOTA SERANG, BANTEN",37,84,160,244
https://kawalpemilu.org#53109,"CIPARE, SERANG, KOTA SERANG, BANTEN",38,86,168,254
https://kawalpemilu.org#53109,"CIPARE, SERANG, KOTA SERANG, BANTEN",39,75,176,251
https://kawalpemilu.org#53109,"CIPARE, SERANG, KOTA SERANG, BANTEN",40,65,174,239
https://kawalpemilu.org#53109,"CIPARE, SERANG, KOTA SERANG, BANTEN",41,85,141,226
https://kawalpemilu.org#53109,"CIPARE, SERANG, KOTA SERANG, BANTEN",42,55,144,199
https://kawalpemilu.org#53109,"CIPARE, SERANG, KOTA SERANG, BANTEN",43,82,163,245
https://kawalpemilu.org#53109,"CIPARE, SERANG, KOTA SERANG, BANTEN",44,79,147,226
https://kawalpemilu.org#53109,"CIPARE, SERANG, KOTA SERANG, BANTEN",45,54,154,208
https://kawalpemilu.org#53109,"CIPARE, SERANG, KOTA SERANG, BANTEN",46,64,158,222
https://kawalpemilu.org#53109,"CIPARE, SERANG, KOTA SERANG, BANTEN",47,44,138,182
https://kawalpemilu.org#53109,"CIPARE, SERANG, KOTA SERANG, BANTEN",48,59,134,193
https://kawalpemilu.org#53109,"CIPARE, SERANG, KOTA SERANG, BANTEN",49,63,161,224
https://kawalpemilu.org#53109,"CIPARE, SERANG, KOTA SERANG, BANTEN",50,71,145,216
https://kawalpemilu.org#53109,"CIPARE, SERANG, KOTA SERANG, BANTEN",51,33,115,148
https://kawalpemilu.org#53109,"CIPARE, SERANG, KOTA SERANG, BANTEN",52,69,110,179
https://kawalpemilu.org#53109,"CIPARE, SERANG, KOTA SERANG, BANTEN",53,81,148,229
https://kawalpemilu.org#53109,"CIPARE, SERANG, KOTA SERANG, BANTEN",54,65,120,185
https://kawalpemilu.org#53109,"CIPARE, SERANG, KOTA SERANG, BANTEN",55,99,137,236
https://kawalpemilu.org#53109,"CIPARE, SERANG, KOTA SERANG, BANTEN",56,88,98,186
https://kawalpemilu.org#53109,"CIPARE, SERANG, KOTA SERANG, BANTEN",57,85,142,227
https://kawalpemilu.org#53109,"CIPARE, SERANG, KOTA SERANG, BANTEN",58,56,137,193
https://kawalpemilu.org#53109,"CIPARE, SERANG, KOTA SERANG, BANTEN",59,69,170,239
https://kawalpemilu.org#53109,"CIPARE, SERANG, KOTA SERANG, BANTEN",60,74,149,225
https://kawalpemilu.org#53109,"CIPARE, SERANG, KOTA SERANG, BANTEN",61,65,171,236
https://kawalpemilu.org#53109,"CIPARE, SERANG, KOTA SERANG, BANTEN",62,68,141,209
https://kawalpemilu.org#53109,"CIPARE, SERANG, KOTA SERANG, BANTEN",63,76,131,207
https://kawalpemilu.org#53109,"CIPARE, SERANG, KOTA SERANG, BANTEN",64,36,180,216
https://kawalpemilu.org#53109,"CIPARE, SERANG, KOTA SERANG, BANTEN",65,36,116,152
https://kawalpemilu.org#53109,"CIPARE, SERANG, KOTA SERANG, BANTEN",66,41,121,162
https://kawalpemilu.org#53109,"CIPARE, SERANG, KOTA SERANG, BANTEN",67,62,129,191
https://kawalpemilu.org#53109,"CIPARE, SERANG, KOTA SERANG, BANTEN",68,53,147,200
https://kawalpemilu.org#53109,"CIPARE, SERANG, KOTA SERANG, BANTEN",69,32,84,116
https://kawalpemilu.org#53110,"SUMUR PECUNG, SERANG, KOTA SERANG, BANTEN",1,56,164,220
https://kawalpemilu.org#53110,"SUMUR PECUNG, SERANG, KOTA SERANG, BANTEN",2,78,126,204
https://kawalpemilu.org#53110,"SUMUR PECUNG, SERANG, KOTA SERANG, BANTEN",3,138,98,236
https://kawalpemilu.org#53110,"SUMUR PECUNG, SERANG, KOTA SERANG, BANTEN",4,134,52,186
https://kawalpemilu.org#53110,"SUMUR PECUNG, SERANG, KOTA SERANG, BANTEN",5,66,145,211
https://kawalpemilu.org#53110,"SUMUR PECUNG, SERANG, KOTA SERANG, BANTEN",6,71,120,191
https://kawalpemilu.org#53110,"SUMUR PECUNG, SERANG, KOTA SERANG, BANTEN",7,69,140,209
https://kawalpemilu.org#53110,"SUMUR PECUNG, SERANG, KOTA SERANG, BANTEN",8,69,142,211
https://kawalpemilu.org#53110,"SUMUR PECUNG, SERANG, KOTA SERANG, BANTEN",9,65,127,192
https://kawalpemilu.org#53110,"SUMUR PECUNG, SERANG, KOTA SERANG, BANTEN",10,59,89,148
https://kawalpemilu.org#53110,"SUMUR PECUNG, SERANG, KOTA SERANG, BANTEN",11,53,138,191
https://kawalpemilu.org#53110,"SUMUR PECUNG, SERANG, KOTA SERANG, BANTEN",12,32,144,176
https://kawalpemilu.org#53110,"SUMUR PECUNG, SERANG, KOTA SERANG, BANTEN",13,99,149,248
https://kawalpemilu.org#53110,"SUMUR PECUNG, SERANG, KOTA SERANG, BANTEN",14,85,180,265
https://kawalpemilu.org#53110,"SUMUR PECUNG, SERANG, KOTA SERANG, BANTEN",15,32,53,85
https://kawalpemilu.org#53110,"SUMUR PECUNG, SERANG, KOTA SERANG, BANTEN",16,51,126,177
https://kawalpemilu.org#53110,"SUMUR PECUNG, SERANG, KOTA SERANG, BANTEN",17,55,122,177
https://kawalpemilu.org#53110,"SUMUR PECUNG, SERANG, KOTA SERANG, BANTEN",18,44,131,175
https://kawalpemilu.org#53110,"SUMUR PECUNG, SERANG, KOTA SERANG, BANTEN",19,53,110,163
https://kawalpemilu.org#53110,"SUMUR PECUNG, SERANG, KOTA SERANG, BANTEN",20,53,145,198
https://kawalpemilu.org#53110,"SUMUR PECUNG, SERANG, KOTA SERANG, BANTEN",21,49,157,206
https://kawalpemilu.org#53110,"SUMUR PECUNG, SERANG, KOTA SERANG, BANTEN",22,67,135,202
https://kawalpemilu.org#53110,"SUMUR PECUNG, SERANG, KOTA SERANG, BANTEN",23,70,135,205
https://kawalpemilu.org#53110,"SUMUR PECUNG, SERANG, KOTA SERANG, BANTEN",24,61,116,177
https://kawalpemilu.org#53110,"SUMUR PECUNG, SERANG, KOTA SERANG, BANTEN",25,75,160,235
https://kawalpemilu.org#53110,"SUMUR PECUNG, SERANG, KOTA SERANG, BANTEN",26,71,153,224
https://kawalpemilu.org#53110,"SUMUR PECUNG, SERANG, KOTA SERANG, BANTEN",27,89,141,230
https://kawalpemilu.org#53110,"SUMUR PECUNG, SERANG, KOTA SERANG, BANTEN",28,73,131,204
https://kawalpemilu.org#53110,"SUMUR PECUNG, SERANG, KOTA SERANG, BANTEN",29,72,127,199
https://kawalpemilu.org#53110,"SUMUR PECUNG, SERANG, KOTA SERANG, BANTEN",30,62,136,198
https://kawalpemilu.org#53110,"SUMUR PECUNG, SERANG, KOTA SERANG, BANTEN",31,46,130,176
https://kawalpemilu.org#53110,"SUMUR PECUNG, SERANG, KOTA SERANG, BANTEN",32,76,116,192
https://kawalpemilu.org#53110,"SUMUR PECUNG, SERANG, KOTA SERANG, BANTEN",33,65,137,202
https://kawalpemilu.org#53110,"SUMUR PECUNG, SERANG, KOTA SERANG, BANTEN",34,61,133,194
https://kawalpemilu.org#53110,"SUMUR PECUNG, SERANG, KOTA SERANG, BANTEN",35,68,110,178
https://kawalpemilu.org#53110,"SUMUR PECUNG, SERANG, KOTA SERANG, BANTEN",36,85,121,206
https://kawalpemilu.org#53110,"SUMUR PECUNG, SERANG, KOTA SERANG, BANTEN",37,58,149,207
https://kawalpemilu.org#53110,"SUMUR PECUNG, SERANG, KOTA SERANG, BANTEN",38,63,187,250
https://kawalpemilu.org#53110,"SUMUR PECUNG, SERANG, KOTA SERANG, BANTEN",39,60,180,240
https://kawalpemilu.org#53110,"SUMUR PECUNG, SERANG, KOTA SERANG, BANTEN",40,75,117,192
https://kawalpemilu.org#53110,"SUMUR PECUNG, SERANG, KOTA SERANG, BANTEN",41,75,107,182
https://kawalpemilu.org#53110,"SUMUR PECUNG, SERANG, KOTA SERANG, BANTEN",42,62,139,201
https://kawalpemilu.org#53110,"SUMUR PECUNG, SERANG, KOTA SERANG, BANTEN",43,85,168,253
https://kawalpemilu.org#53110,"SUMUR PECUNG, SERANG, KOTA SERANG, BANTEN",44,68,163,231
https://kawalpemilu.org#53110,"SUMUR PECUNG, SERANG, KOTA SERANG, BANTEN",45,91,144,235
https://kawalpemilu.org#53110,"SUMUR PECUNG, SERANG, KOTA SERANG, BANTEN",46,69,152,221
https://kawalpemilu.org#53110,"SUMUR PECUNG, SERANG, KOTA SERANG, BANTEN",47,64,163,227
https://kawalpemilu.org#53110,"SUMUR PECUNG, SERANG, KOTA SERANG, BANTEN",48,78,132,210
https://kawalpemilu.org#53110,"SUMUR PECUNG, SERANG, KOTA SERANG, BANTEN",49,48,164,3
https://kawalpemilu.org#53110,"SUMUR PECUNG, SERANG, KOTA SERANG, BANTEN",50,64,122,186
https://kawalpemilu.org#53110,"SUMUR PECUNG, SERANG, KOTA SERANG, BANTEN",51,79,151,230
https://kawalpemilu.org#53110,"SUMUR PECUNG, SERANG, KOTA SERANG, BANTEN",52,51,121,172
https://kawalpemilu.org#53110,"SUMUR PECUNG, SERANG, KOTA SERANG, BANTEN",53,71,126,197
https://kawalpemilu.org#53110,"SUMUR PECUNG, SERANG, KOTA SERANG, BANTEN",54,60,154,214
https://kawalpemilu.org#53110,"SUMUR PECUNG, SERANG, KOTA SERANG, BANTEN",55,40,178,218
https://kawalpemilu.org#53110,"SUMUR PECUNG, SERANG, KOTA SERANG, BANTEN",56,49,153,202
https://kawalpemilu.org#53110,"SUMUR PECUNG, SERANG, KOTA SERANG, BANTEN",57,49,128,177
https://kawalpemilu.org#53110,"SUMUR PECUNG, SERANG, KOTA SERANG, BANTEN",58,44,129,173
https://kawalpemilu.org#53110,"SUMUR PECUNG, SERANG, KOTA SERANG, BANTEN",59,65,127,192
https://kawalpemilu.org#53110,"SUMUR PECUNG, SERANG, KOTA SERANG, BANTEN",60,76,132,208
https://kawalpemilu.org#53110,"SUMUR PECUNG, SERANG, KOTA SERANG, BANTEN",61,75,126,201
https://kawalpemilu.org#53110,"SUMUR PECUNG, SERANG, KOTA SERANG, BANTEN",62,34,79,113
https://kawalpemilu.org#53110,"SUMUR PECUNG, SERANG, KOTA SERANG, BANTEN",63,34,82,116
https://kawalpemilu.org#53110,"SUMUR PECUNG, SERANG, KOTA SERANG, BANTEN",64,60,47,107
https://kawalpemilu.org#53110,"SUMUR PECUNG, SERANG, KOTA SERANG, BANTEN",65,36,60,96
https://kawalpemilu.org#53110,"SUMUR PECUNG, SERANG, KOTA SERANG, BANTEN",66,43,81,124
https://kawalpemilu.org#53111,"KOTA BARU, SERANG, KOTA SERANG, BANTEN",1,97,129,226
https://kawalpemilu.org#53111,"KOTA BARU, SERANG, KOTA SERANG, BANTEN",2,96,99,195
https://kawalpemilu.org#53111,"KOTA BARU, SERANG, KOTA SERANG, BANTEN",3,108,142,250
https://kawalpemilu.org#53111,"KOTA BARU, SERANG, KOTA SERANG, BANTEN",4,116,113,229
https://kawalpemilu.org#53111,"KOTA BARU, SERANG, KOTA SERANG, BANTEN",6,154,111,265
https://kawalpemilu.org#53111,"KOTA BARU, SERANG, KOTA SERANG, BANTEN",7,160,82,242
https://kawalpemilu.org#53111,"KOTA BARU, SERANG, KOTA SERANG, BANTEN",8,179,86,265
https://kawalpemilu.org#53111,"KOTA BARU, SERANG, KOTA SERANG, BANTEN",9,137,143,280
https://kawalpemilu.org#53111,"KOTA BARU, SERANG, KOTA SERANG, BANTEN",10,70,128,198
https://kawalpemilu.org#53111,"KOTA BARU, SERANG, KOTA SERANG, BANTEN",11,61,150,211
https://kawalpemilu.org#53111,"KOTA BARU, SERANG, KOTA SERANG, BANTEN",12,66,127,193
https://kawalpemilu.org#53111,"KOTA BARU, SERANG, KOTA SERANG, BANTEN",13,206,4,210
https://kawalpemilu.org#53111,"KOTA BARU, SERANG, KOTA SERANG, BANTEN",14,68,157,225
https://kawalpemilu.org#53111,"KOTA BARU, SERANG, KOTA SERANG, BANTEN",15,124,94,218
https://kawalpemilu.org#53111,"KOTA BARU, SERANG, KOTA SERANG, BANTEN",16,127,91,218
https://kawalpemilu.org#53111,"KOTA BARU, SERANG, KOTA SERANG, BANTEN",17,76,103,179
https://kawalpemilu.org#53111,"KOTA BARU, SERANG, KOTA SERANG, BANTEN",18,75,108,183
https://kawalpemilu.org#53111,"KOTA BARU, SERANG, KOTA SERANG, BANTEN",19,48,137,185
https://kawalpemilu.org#53111,"KOTA BARU, SERANG, KOTA SERANG, BANTEN",20,39,69,108
https://kawalpemilu.org#53111,"KOTA BARU, SERANG, KOTA SERANG, BANTEN",21,48,59,107
https://kawalpemilu.org#53111,"KOTA BARU, SERANG, KOTA SERANG, BANTEN",22,44,65,109
https://kawalpemilu.org#53112,"LOPANG, SERANG, KOTA SERANG, BANTEN",1,49,185,234
https://kawalpemilu.org#53112,"LOPANG, SERANG, KOTA SERANG, BANTEN",2,64,187,251
https://kawalpemilu.org#53112,"LOPANG, SERANG, KOTA SERANG, BANTEN",3,58,182,240
https://kawalpemilu.org#53112,"LOPANG, SERANG, KOTA SERANG, BANTEN",4,54,188,242
https://kawalpemilu.org#53112,"LOPANG, SERANG, KOTA SERANG, BANTEN",5,55,158,213
https://kawalpemilu.org#53112,"LOPANG, SERANG, KOTA SERANG, BANTEN",6,56,182,238
https://kawalpemilu.org#53112,"LOPANG, SERANG, KOTA SERANG, BANTEN",7,90,143,233
https://kawalpemilu.org#53112,"LOPANG, SERANG, KOTA SERANG, BANTEN",8,73,136,209
https://kawalpemilu.org#53112,"LOPANG, SERANG, KOTA SERANG, BANTEN",9,72,122,192
https://kawalpemilu.org#53112,"LOPANG, SERANG, KOTA SERANG, BANTEN",10,46,170,216
https://kawalpemilu.org#53112,"LOPANG, SERANG, KOTA SERANG, BANTEN",11,57,157,214
https://kawalpemilu.org#53112,"LOPANG, SERANG, KOTA SERANG, BANTEN",12,47,155,202
https://kawalpemilu.org#53112,"LOPANG, SERANG, KOTA SERANG, BANTEN",13,50,133,183
https://kawalpemilu.org#53112,"LOPANG, SERANG, KOTA SERANG, BANTEN",14,86,157,243
https://kawalpemilu.org#53112,"LOPANG, SERANG, KOTA SERANG, BANTEN",15,74,168,242
https://kawalpemilu.org#53112,"LOPANG, SERANG, KOTA SERANG, BANTEN",16,85,112,197
https://kawalpemilu.org#53112,"LOPANG, SERANG, KOTA SERANG, BANTEN",17,63,165,228
https://kawalpemilu.org#53112,"LOPANG, SERANG, KOTA SERANG, BANTEN",18,87,143,230
https://kawalpemilu.org#53112,"LOPANG, SERANG, KOTA SERANG, BANTEN",19,85,124,209
https://kawalpemilu.org#53112,"LOPANG, SERANG, KOTA SERANG, BANTEN",20,50,147,197
https://kawalpemilu.org#53112,"LOPANG, SERANG, KOTA SERANG, BANTEN",21,77,122,199
https://kawalpemilu.org#53112,"LOPANG, SERANG, KOTA SERANG, BANTEN",22,61,117,178
https://kawalpemilu.org#53112,"LOPANG, SERANG, KOTA SERANG, BANTEN",23,59,141,200
https://kawalpemilu.org#53112,"LOPANG, SERANG, KOTA SERANG, BANTEN",24,80,142,222
https://kawalpemilu.org#53112,"LOPANG, SERANG, KOTA SERANG, BANTEN",25,60,147,207
https://kawalpemilu.org#53112,"LOPANG, SERANG, KOTA SERANG, BANTEN",26,71,148,219
https://kawalpemilu.org#53112,"LOPANG, SERANG, KOTA SERANG, BANTEN",27,41,131,172
https://kawalpemilu.org#53112,"LOPANG, SERANG, KOTA SERANG, BANTEN",28,65,144,209
https://kawalpemilu.org#53112,"LOPANG, SERANG, KOTA SERANG, BANTEN",29,72,127,199
https://kawalpemilu.org#53112,"LOPANG, SERANG, KOTA SERANG, BANTEN",30,68,146,214
https://kawalpemilu.org#53112,"LOPANG, SERANG, KOTA SERANG, BANTEN",31,117,38,155
https://kawalpemilu.org#53112,"LOPANG, SERANG, KOTA SERANG, BANTEN",32,194,54,248
https://kawalpemilu.org#53112,"LOPANG, SERANG, KOTA SERANG, BANTEN",33,120,107,227
https://kawalpemilu.org#53112,"LOPANG, SERANG, KOTA SERANG, BANTEN",34,52,156,208
https://kawalpemilu.org#53112,"LOPANG, SERANG, KOTA SERANG, BANTEN",35,38,205,243
https://kawalpemilu.org#53112,"LOPANG, SERANG, KOTA SERANG, BANTEN",36,72,163,235
https://kawalpemilu.org#53112,"LOPANG, SERANG, KOTA SERANG, BANTEN",37,64,147,211
https://kawalpemilu.org#53112,"LOPANG, SERANG, KOTA SERANG, BANTEN",38,47,87,134
https://kawalpemilu.org#53112,"LOPANG, SERANG, KOTA SERANG, BANTEN",39,150,69,219
https://kawalpemilu.org#53112,"LOPANG, SERANG, KOTA SERANG, BANTEN",40,105,113,218
https://kawalpemilu.org#53112,"LOPANG, SERANG, KOTA SERANG, BANTEN",41,174,61,235
https://kawalpemilu.org#53112,"LOPANG, SERANG, KOTA SERANG, BANTEN",42,65,169,234
https://kawalpemilu.org#53112,"LOPANG, SERANG, KOTA SERANG, BANTEN",43,76,170,246
https://kawalpemilu.org#53112,"LOPANG, SERANG, KOTA SERANG, BANTEN",44,47,71,118
https://kawalpemilu.org#53113,"CIMUNCANG, SERANG, KOTA SERANG, BANTEN",1,54,111,165
https://kawalpemilu.org#53113,"CIMUNCANG, SERANG, KOTA SERANG, BANTEN",2,91,125,216
https://kawalpemilu.org#53113,"CIMUNCANG, SERANG, KOTA SERANG, BANTEN",3,74,140,214
https://kawalpemilu.org#53113,"CIMUNCANG, SERANG, KOTA SERANG, BANTEN",4,49,89,138
https://kawalpemilu.org#53113,"CIMUNCANG, SERANG, KOTA SERANG, BANTEN",5,71,178,249
https://kawalpemilu.org#53113,"CIMUNCANG, SERANG, KOTA SERANG, BANTEN",6,45,137,182
https://kawalpemilu.org#53113,"CIMUNCANG, SERANG, KOTA SERANG, BANTEN",7,73,75,248
https://kawalpemilu.org#53113,"CIMUNCANG, SERANG, KOTA SERANG, BANTEN",8,65,141,206
https://kawalpemilu.org#53113,"CIMUNCANG, SERANG, KOTA SERANG, BANTEN",9,74,154,226
https://kawalpemilu.org#53113,"CIMUNCANG, SERANG, KOTA SERANG, BANTEN",10,76,178,254
https://kawalpemilu.org#53113,"CIMUNCANG, SERANG, KOTA SERANG, BANTEN",11,78,146,224
https://kawalpemilu.org#53113,"CIMUNCANG, SERANG, KOTA SERANG, BANTEN",12,110,121,221
https://kawalpemilu.org#53113,"CIMUNCANG, SERANG, KOTA SERANG, BANTEN",13,86,114,200
https://kawalpemilu.org#53113,"CIMUNCANG, SERANG, KOTA SERANG, BANTEN",14,93,131,224
https://kawalpemilu.org#53113,"CIMUNCANG, SERANG, KOTA SERANG, BANTEN",15,84,191,275
https://kawalpemilu.org#53113,"CIMUNCANG, SERANG, KOTA SERANG, BANTEN",16,72,196,268
https://kawalpemilu.org#53113,"CIMUNCANG, SERANG, KOTA SERANG, BANTEN",17,57,152,209
https://kawalpemilu.org#53113,"CIMUNCANG, SERANG, KOTA SERANG, BANTEN",18,40,91,131
https://kawalpemilu.org#53113,"CIMUNCANG, SERANG, KOTA SERANG, BANTEN",19,74,113,187
https://kawalpemilu.org#53113,"CIMUNCANG, SERANG, KOTA SERANG, BANTEN",20,81,147,228
https://kawalpemilu.org#53113,"CIMUNCANG, SERANG, KOTA SERANG, BANTEN",21,62,143,205
https://kawalpemilu.org#53113,"CIMUNCANG, SERANG, KOTA SERANG, BANTEN",22,63,211,274
https://kawalpemilu.org#53113,"CIMUNCANG, SERANG, KOTA SERANG, BANTEN",23,101,158,259
https://kawalpemilu.org#53113,"CIMUNCANG, SERANG, KOTA SERANG, BANTEN",24,27,85,112
https://kawalpemilu.org#53113,"CIMUNCANG, SERANG, KOTA SERANG, BANTEN",25,82,108,190
https://kawalpemilu.org#53113,"CIMUNCANG, SERANG, KOTA SERANG, BANTEN",26,105,170,275
https://kawalpemilu.org#53113,"CIMUNCANG, SERANG, KOTA SERANG, BANTEN",27,94,84,178
https://kawalpemilu.org#53113,"CIMUNCANG, SERANG, KOTA SERANG, BANTEN",28,77,152,229
https://kawalpemilu.org#53113,"CIMUNCANG, SERANG, KOTA SERANG, BANTEN",29,49,123,172
https://kawalpemilu.org#53113,"CIMUNCANG, SERANG, KOTA SERANG, BANTEN",30,66,122,188
https://kawalpemilu.org#53113,"CIMUNCANG, SERANG, KOTA SERANG, BANTEN",31,55,179,234
https://kawalpemilu.org#53113,"CIMUNCANG, SERANG, KOTA SERANG, BANTEN",32,56,168,224
https://kawalpemilu.org#53113,"CIMUNCANG, SERANG, KOTA SERANG, BANTEN",33,73,105,178
https://kawalpemilu.org#53113,"CIMUNCANG, SERANG, KOTA SERANG, BANTEN",34,50,93,143
https://kawalpemilu.org#53113,"CIMUNCANG, SERANG, KOTA SERANG, BANTEN",35,70,107,177
https://kawalpemilu.org#53113,"CIMUNCANG, SERANG, KOTA SERANG, BANTEN",36,64,131,195
https://kawalpemilu.org#53113,"CIMUNCANG, SERANG, KOTA SERANG, BANTEN",37,67,133,200
https://kawalpemilu.org#53113,"CIMUNCANG, SERANG, KOTA SERANG, BANTEN",38,65,151,216
https://kawalpemilu.org#53113,"CIMUNCANG, SERANG, KOTA SERANG, BANTEN",39,57,143,200
https://kawalpemilu.org#53113,"CIMUNCANG, SERANG, KOTA SERANG, BANTEN",40,82,154,236
https://kawalpemilu.org#53113,"CIMUNCANG, SERANG, KOTA SERANG, BANTEN",41,70,147,217
https://kawalpemilu.org#53113,"CIMUNCANG, SERANG, KOTA SERANG, BANTEN",42,76,181,257
https://kawalpemilu.org#53113,"CIMUNCANG, SERANG, KOTA SERANG, BANTEN",43,100,156,256
https://kawalpemilu.org#53113,"CIMUNCANG, SERANG, KOTA SERANG, BANTEN",44,94,128,222
https://kawalpemilu.org#53113,"CIMUNCANG, SERANG, KOTA SERANG, BANTEN",45,62,157,219
https://kawalpemilu.org#53113,"CIMUNCANG, SERANG, KOTA SERANG, BANTEN",46,94,153,247
https://kawalpemilu.org#53113,"CIMUNCANG, SERANG, KOTA SERANG, BANTEN",47,86,166,252
https://kawalpemilu.org#53113,"CIMUNCANG, SERANG, KOTA SERANG, BANTEN",48,89,125,214
https://kawalpemilu.org#53113,"CIMUNCANG, SERANG, KOTA SERANG, BANTEN",49,70,128,198
https://kawalpemilu.org#53113,"CIMUNCANG, SERANG, KOTA SERANG, BANTEN",50,68,124,192
https://kawalpemilu.org#53113,"CIMUNCANG, SERANG, KOTA SERANG, BANTEN",51,26,135,161
https://kawalpemilu.org#53113,"CIMUNCANG, SERANG, KOTA SERANG, BANTEN",52,88,147,235
https://kawalpemilu.org#53113,"CIMUNCANG, SERANG, KOTA SERANG, BANTEN",53,76,82,158
https://kawalpemilu.org#53113,"CIMUNCANG, SERANG, KOTA SERANG, BANTEN",54,120,85,205
https://kawalpemilu.org#53113,"CIMUNCANG, SERANG, KOTA SERANG, BANTEN",55,55,139,194
https://kawalpemilu.org#53113,"CIMUNCANG, SERANG, KOTA SERANG, BANTEN",56,91,182,273
https://kawalpemilu.org#53113,"CIMUNCANG, SERANG, KOTA SERANG, BANTEN",57,67,163,230
https://kawalpemilu.org#53113,"CIMUNCANG, SERANG, KOTA SERANG, BANTEN",58,93,148,241
https://kawalpemilu.org#53113,"CIMUNCANG, SERANG, KOTA SERANG, BANTEN",59,94,149,243
https://kawalpemilu.org#53113,"CIMUNCANG, SERANG, KOTA SERANG, BANTEN",60,68,138,206
https://kawalpemilu.org#53113,"CIMUNCANG, SERANG, KOTA SERANG, BANTEN",61,63,97,160
https://kawalpemilu.org#53113,"CIMUNCANG, SERANG, KOTA SERANG, BANTEN",62,93,137,230
https://kawalpemilu.org#53113,"CIMUNCANG, SERANG, KOTA SERANG, BANTEN",63,72,170,242
https://kawalpemilu.org#53113,"CIMUNCANG, SERANG, KOTA SERANG, BANTEN",64,46,93,139
https://kawalpemilu.org#53113,"CIMUNCANG, SERANG, KOTA SERANG, BANTEN",65,40,121,161
https://kawalpemilu.org#53113,"CIMUNCANG, SERANG, KOTA SERANG, BANTEN",66,41,69,110
https://kawalpemilu.org#53113,"CIMUNCANG, SERANG, KOTA SERANG, BANTEN",67,75,67,142
https://kawalpemilu.org#53113,"CIMUNCANG, SERANG, KOTA SERANG, BANTEN",68,40,88,128
https://kawalpemilu.org#53114,"UNYUR, SERANG, KOTA SERANG, BANTEN",1,47,148,195
https://kawalpemilu.org#53114,"UNYUR, SERANG, KOTA SERANG, BANTEN",2,65,133,198
https://kawalpemilu.org#53114,"UNYUR, SERANG, KOTA SERANG, BANTEN",3,45,167,212
https://kawalpemilu.org#53114,"UNYUR, SERANG, KOTA SERANG, BANTEN",4,56,169,225
https://kawalpemilu.org#53114,"UNYUR, SERANG, KOTA SERANG, BANTEN",5,39,142,181
https://kawalpemilu.org#53114,"UNYUR, SERANG, KOTA SERANG, BANTEN",6,43,173,214
https://kawalpemilu.org#53114,"UNYUR, SERANG, KOTA SERANG, BANTEN",7,47,197,244
https://kawalpemilu.org#53114,"UNYUR, SERANG, KOTA SERANG, BANTEN",8,60,167,227
https://kawalpemilu.org#53114,"UNYUR, SERANG, KOTA SERANG, BANTEN",9,67,199,266
https://kawalpemilu.org#53114,"UNYUR, SERANG, KOTA SERANG, BANTEN",10,54,190,244
https://kawalpemilu.org#53114,"UNYUR, SERANG, KOTA SERANG, BANTEN",11,47,195,242
https://kawalpemilu.org#53114,"UNYUR, SERANG, KOTA SERANG, BANTEN",12,54,178,232
https://kawalpemilu.org#53114,"UNYUR, SERANG, KOTA SERANG, BANTEN",13,43,168,211
https://kawalpemilu.org#53114,"UNYUR, SERANG, KOTA SERANG, BANTEN",14,40,197,237
https://kawalpemilu.org#53114,"UNYUR, SERANG, KOTA SERANG, BANTEN",15,53,164,217
https://kawalpemilu.org#53114,"UNYUR, SERANG, KOTA SERANG, BANTEN",16,35,196,231
https://kawalpemilu.org#53114,"UNYUR, SERANG, KOTA SERANG, BANTEN",17,39,192,231
https://kawalpemilu.org#53114,"UNYUR, SERANG, KOTA SERANG, BANTEN",18,48,198,246
https://kawalpemilu.org#53114,"UNYUR, SERANG, KOTA SERANG, BANTEN",19,68,193,271
https://kawalpemilu.org#53114,"UNYUR, SERANG, KOTA SERANG, BANTEN",20,118,116,234
https://kawalpemilu.org#53114,"UNYUR, SERANG, KOTA SERANG, BANTEN",21,87,128,215
https://kawalpemilu.org#53114,"UNYUR, SERANG, KOTA SERANG, BANTEN",22,110,120,230
https://kawalpemilu.org#53114,"UNYUR, SERANG, KOTA SERANG, BANTEN",23,55,126,181
https://kawalpemilu.org#53114,"UNYUR, SERANG, KOTA SERANG, BANTEN",24,34,132,166
https://kawalpemilu.org#53114,"UNYUR, SERANG, KOTA SERANG, BANTEN",25,74,142,216
https://kawalpemilu.org#53114,"UNYUR, SERANG, KOTA SERANG, BANTEN",26,57,182,239
https://kawalpemilu.org#53114,"UNYUR, SERANG, KOTA SERANG, BANTEN",27,58,173,231
https://kawalpemilu.org#53114,"UNYUR, SERANG, KOTA SERANG, BANTEN",28,38,183,221
https://kawalpemilu.org#53114,"UNYUR, SERANG, KOTA SERANG, BANTEN",29,40,172,212
https://kawalpemilu.org#53114,"UNYUR, SERANG, KOTA SERANG, BANTEN",30,52,171,223
https://kawalpemilu.org#53114,"UNYUR, SERANG, KOTA SERANG, BANTEN",31,75,190,265
https://kawalpemilu.org#53114,"UNYUR, SERANG, KOTA SERANG, BANTEN",32,68,200,268
https://kawalpemilu.org#53114,"UNYUR, SERANG, KOTA SERANG, BANTEN",33,85,145,230
https://kawalpemilu.org#53114,"UNYUR, SERANG, KOTA SERANG, BANTEN",34,85,140,225
https://kawalpemilu.org#53114,"UNYUR, SERANG, KOTA SERANG, BANTEN",35,82,132,214
https://kawalpemilu.org#53114,"UNYUR, SERANG, KOTA SERANG, BANTEN",36,62,160,222
https://kawalpemilu.org#53114,"UNYUR, SERANG, KOTA SERANG, BANTEN",37,72,146,218
https://kawalpemilu.org#53114,"UNYUR, SERANG, KOTA SERANG, BANTEN",38,76,149,225
https://kawalpemilu.org#53114,"UNYUR, SERANG, KOTA SERANG, BANTEN",39,87,168,255
https://kawalpemilu.org#53114,"UNYUR, SERANG, KOTA SERANG, BANTEN",40,87,167,254
https://kawalpemilu.org#53114,"UNYUR, SERANG, KOTA SERANG, BANTEN",41,97,181,278
https://kawalpemilu.org#53114,"UNYUR, SERANG, KOTA SERANG, BANTEN",42,89,184,273
https://kawalpemilu.org#53114,"UNYUR, SERANG, KOTA SERANG, BANTEN",43,102,175,277
https://kawalpemilu.org#53114,"UNYUR, SERANG, KOTA SERANG, BANTEN",44,89,157,246
https://kawalpemilu.org#53114,"UNYUR, SERANG, KOTA SERANG, BANTEN",45,76,167,243
https://kawalpemilu.org#53114,"UNYUR, SERANG, KOTA SERANG, BANTEN",46,81,133,214
https://kawalpemilu.org#53114,"UNYUR, SERANG, KOTA SERANG, BANTEN",47,82,140,222
https://kawalpemilu.org#53114,"UNYUR, SERANG, KOTA SERANG, BANTEN",48,101,124,225
https://kawalpemilu.org#53114,"UNYUR, SERANG, KOTA SERANG, BANTEN",49,97,151,248
https://kawalpemilu.org#53114,"UNYUR, SERANG, KOTA SERANG, BANTEN",50,35,191,226
https://kawalpemilu.org#53114,"UNYUR, SERANG, KOTA SERANG, BANTEN",51,68,123,191
https://kawalpemilu.org#53114,"UNYUR, SERANG, KOTA SERANG, BANTEN",52,62,121,183
https://kawalpemilu.org#53114,"UNYUR, SERANG, KOTA SERANG, BANTEN",53,97,123,220
https://kawalpemilu.org#53114,"UNYUR, SERANG, KOTA SERANG, BANTEN",54,93,106,199
https://kawalpemilu.org#53114,"UNYUR, SERANG, KOTA SERANG, BANTEN",55,68,165,233
https://kawalpemilu.org#53114,"UNYUR, SERANG, KOTA SERANG, BANTEN",56,76,146,222
https://kawalpemilu.org#53114,"UNYUR, SERANG, KOTA SERANG, BANTEN",57,73,131,204
https://kawalpemilu.org#53114,"UNYUR, SERANG, KOTA SERANG, BANTEN",58,87,114,201
https://kawalpemilu.org#53114,"UNYUR, SERANG, KOTA SERANG, BANTEN",59,82,109,191
https://kawalpemilu.org#53114,"UNYUR, SERANG, KOTA SERANG, BANTEN",60,56,115,171
https://kawalpemilu.org#53114,"UNYUR, SERANG, KOTA SERANG, BANTEN",61,63,143,206
https://kawalpemilu.org#53114,"UNYUR, SERANG, KOTA SERANG, BANTEN",62,47,122,169
https://kawalpemilu.org#53114,"UNYUR, SERANG, KOTA SERANG, BANTEN",63,43,153,196
https://kawalpemilu.org#53114,"UNYUR, SERANG, KOTA SERANG, BANTEN",64,65,191,256
https://kawalpemilu.org#53114,"UNYUR, SERANG, KOTA SERANG, BANTEN",65,74,205,279
https://kawalpemilu.org#53114,"UNYUR, SERANG, KOTA SERANG, BANTEN",66,69,208,277
https://kawalpemilu.org#53114,"UNYUR, SERANG, KOTA SERANG, BANTEN",67,63,195,258
https://kawalpemilu.org#53114,"UNYUR, SERANG, KOTA SERANG, BANTEN",68,72,153,225
https://kawalpemilu.org#53114,"UNYUR, SERANG, KOTA SERANG, BANTEN",69,65,133,198
https://kawalpemilu.org#53114,"UNYUR, SERANG, KOTA SERANG, BANTEN",70,57,130,187
https://kawalpemilu.org#53114,"UNYUR, SERANG, KOTA SERANG, BANTEN",71,74,206,280
https://kawalpemilu.org#53114,"UNYUR, SERANG, KOTA SERANG, BANTEN",72,77,172,249
https://kawalpemilu.org#53114,"UNYUR, SERANG, KOTA SERANG, BANTEN",73,76,141,217
https://kawalpemilu.org#53114,"UNYUR, SERANG, KOTA SERANG, BANTEN",74,75,176,251
https://kawalpemilu.org#53114,"UNYUR, SERANG, KOTA SERANG, BANTEN",75,50,187,237
https://kawalpemilu.org#53114,"UNYUR, SERANG, KOTA SERANG, BANTEN",76,73,177,250
https://kawalpemilu.org#53114,"UNYUR, SERANG, KOTA SERANG, BANTEN",77,71,122,193
https://kawalpemilu.org#53114,"UNYUR, SERANG, KOTA SERANG, BANTEN",78,87,111,198
https://kawalpemilu.org#53114,"UNYUR, SERANG, KOTA SERANG, BANTEN",79,72,126,198
https://kawalpemilu.org#53114,"UNYUR, SERANG, KOTA SERANG, BANTEN",80,58,153,211
https://kawalpemilu.org#53114,"UNYUR, SERANG, KOTA SERANG, BANTEN",81,68,154,222
https://kawalpemilu.org#53114,"UNYUR, SERANG, KOTA SERANG, BANTEN",82,52,172,224
https://kawalpemilu.org#53114,"UNYUR, SERANG, KOTA SERANG, BANTEN",83,88,190,278
https://kawalpemilu.org#53114,"UNYUR, SERANG, KOTA SERANG, BANTEN",84,77,184,261
https://kawalpemilu.org#53114,"UNYUR, SERANG, KOTA SERANG, BANTEN",85,70,171,241
https://kawalpemilu.org#53114,"UNYUR, SERANG, KOTA SERANG, BANTEN",86,71,168,239
https://kawalpemilu.org#53114,"UNYUR, SERANG, KOTA SERANG, BANTEN",87,67,176,243
https://kawalpemilu.org#53114,"UNYUR, SERANG, KOTA SERANG, BANTEN",88,86,187,273
https://kawalpemilu.org#53114,"UNYUR, SERANG, KOTA SERANG, BANTEN",89,73,132,205
https://kawalpemilu.org#53114,"UNYUR, SERANG, KOTA SERANG, BANTEN",90,87,150,237
https://kawalpemilu.org#53114,"UNYUR, SERANG, KOTA SERANG, BANTEN",91,92,154,246
https://kawalpemilu.org#53114,"UNYUR, SERANG, KOTA SERANG, BANTEN",92,80,154,234
https://kawalpemilu.org#53114,"UNYUR, SERANG, KOTA SERANG, BANTEN",93,96,114,210
https://kawalpemilu.org#53114,"UNYUR, SERANG, KOTA SERANG, BANTEN",94,77,143,220
https://kawalpemilu.org#53114,"UNYUR, SERANG, KOTA SERANG, BANTEN",95,18,77,98
https://kawalpemilu.org#53114,"UNYUR, SERANG, KOTA SERANG, BANTEN",96,52,153,205
https://kawalpemilu.org#53114,"UNYUR, SERANG, KOTA SERANG, BANTEN",97,18,78,96
https://kawalpemilu.org#53114,"UNYUR, SERANG, KOTA SERANG, BANTEN",98,36,81,117
https://kawalpemilu.org#53114,"UNYUR, SERANG, KOTA SERANG, BANTEN",99,35,84,119
https://kawalpemilu.org#53114,"UNYUR, SERANG, KOTA SERANG, BANTEN",100,48,72,120
https://kawalpemilu.org#53114,"UNYUR, SERANG, KOTA SERANG, BANTEN",101,56,75,131
https://kawalpemilu.org#53114,"UNYUR, SERANG, KOTA SERANG, BANTEN",102,42,126,168
https://kawalpemilu.org#53114,"UNYUR, SERANG, KOTA SERANG, BANTEN",103,37,69,106
https://kawalpemilu.org#53114,"UNYUR, SERANG, KOTA SERANG, BANTEN",104,30,70,100
https://kawalpemilu.org#53114,"UNYUR, SERANG, KOTA SERANG, BANTEN",105,21,69,90
https://kawalpemilu.org#53114,"UNYUR, SERANG, KOTA SERANG, BANTEN",106,44,150,194
https://kawalpemilu.org#53115,"SUKAWANA, SERANG, KOTA SERANG, BANTEN",1,78,173,251
https://kawalpemilu.org#53115,"SUKAWANA, SERANG, KOTA SERANG, BANTEN",2,66,202,268
https://kawalpemilu.org#53115,"SUKAWANA, SERANG, KOTA SERANG, BANTEN",3,66,163,229
https://kawalpemilu.org#53115,"SUKAWANA, SERANG, KOTA SERANG, BANTEN",4,56,137,193
https://kawalpemilu.org#53115,"SUKAWANA, SERANG, KOTA SERANG, BANTEN",5,96,119,215
https://kawalpemilu.org#53115,"SUKAWANA, SERANG, KOTA SERANG, BANTEN",6,70,146,216
https://kawalpemilu.org#53115,"SUKAWANA, SERANG, KOTA SERANG, BANTEN",7,74,143,217
https://kawalpemilu.org#53115,"SUKAWANA, SERANG, KOTA SERANG, BANTEN",8,31,192,223
https://kawalpemilu.org#53115,"SUKAWANA, SERANG, KOTA SERANG, BANTEN",9,28,180,208
https://kawalpemilu.org#53115,"SUKAWANA, SERANG, KOTA SERANG, BANTEN",10,33,177,210
https://kawalpemilu.org#53115,"SUKAWANA, SERANG, KOTA SERANG, BANTEN",11,65,127,192
https://kawalpemilu.org#53115,"SUKAWANA, SERANG, KOTA SERANG, BANTEN",12,54,154,208
https://kawalpemilu.org#53115,"SUKAWANA, SERANG, KOTA SERANG, BANTEN",13,56,114,170
https://kawalpemilu.org#53115,"SUKAWANA, SERANG, KOTA SERANG, BANTEN",14,42,120,162
https://kawalpemilu.org#53116,"LONTAR BARU, SERANG, KOTA SERANG, BANTEN",1,104,131,235
https://kawalpemilu.org#53116,"LONTAR BARU, SERANG, KOTA SERANG, BANTEN",2,92,148,240
https://kawalpemilu.org#53116,"LONTAR BARU, SERANG, KOTA SERANG, BANTEN",3,104,126,230
https://kawalpemilu.org#53116,"LONTAR BARU, SERANG, KOTA SERANG, BANTEN",4,84,126,210
https://kawalpemilu.org#53116,"LONTAR BARU, SERANG, KOTA SERANG, BANTEN",5,87,184,271
https://kawalpemilu.org#53116,"LONTAR BARU, SERANG, KOTA SERANG, BANTEN",6,51,188,239
https://kawalpemilu.org#53116,"LONTAR BARU, SERANG, KOTA SERANG, BANTEN",7,74,193,267
https://kawalpemilu.org#53116,"LONTAR BARU, SERANG, KOTA SERANG, BANTEN",8,103,145,248
https://kawalpemilu.org#53116,"LONTAR BARU, SERANG, KOTA SERANG, BANTEN",9,77,167,244
https://kawalpemilu.org#53116,"LONTAR BARU, SERANG, KOTA SERANG, BANTEN",10,63,186,249
https://kawalpemilu.org#53116,"LONTAR BARU, SERANG, KOTA SERANG, BANTEN",11,48,172,220
https://kawalpemilu.org#53116,"LONTAR BARU, SERANG, KOTA SERANG, BANTEN",12,54,185,239
https://kawalpemilu.org#53116,"LONTAR BARU, SERANG, KOTA SERANG, BANTEN",13,58,180,238
https://kawalpemilu.org#53116,"LONTAR BARU, SERANG, KOTA SERANG, BANTEN",14,64,150,214
https://kawalpemilu.org#53116,"LONTAR BARU, SERANG, KOTA SERANG, BANTEN",15,96,119,215
https://kawalpemilu.org#53116,"LONTAR BARU, SERANG, KOTA SERANG, BANTEN",16,88,179,267
https://kawalpemilu.org#53116,"LONTAR BARU, SERANG, KOTA SERANG, BANTEN",17,75,172,247
https://kawalpemilu.org#53116,"LONTAR BARU, SERANG, KOTA SERANG, BANTEN",18,67,172,239
https://kawalpemilu.org#53116,"LONTAR BARU, SERANG, KOTA SERANG, BANTEN",19,58,159,217
https://kawalpemilu.org#53116,"LONTAR BARU, SERANG, KOTA SERANG, BANTEN",20,52,180,232
https://kawalpemilu.org#53116,"LONTAR BARU, SERANG, KOTA SERANG, BANTEN",21,105,125,230
https://kawalpemilu.org#53116,"LONTAR BARU, SERANG, KOTA SERANG, BANTEN",22,69,154,223
https://kawalpemilu.org#53116,"LONTAR BARU, SERANG, KOTA SERANG, BANTEN",23,61,152,213
https://kawalpemilu.org#53117,"KALIGANDU, SERANG, KOTA SERANG, BANTEN",1,74,181,255
https://kawalpemilu.org#53117,"KALIGANDU, SERANG, KOTA SERANG, BANTEN",2,57,154,211
https://kawalpemilu.org#53117,"KALIGANDU, SERANG, KOTA SERANG, BANTEN",3,54,171,225
https://kawalpemilu.org#53117,"KALIGANDU, SERANG, KOTA SERANG, BANTEN",4,62,140,202
https://kawalpemilu.org#53117,"KALIGANDU, SERANG, KOTA SERANG, BANTEN",5,68,132,200
https://kawalpemilu.org#53117,"KALIGANDU, SERANG, KOTA SERANG, BANTEN",6,79,144,223
https://kawalpemilu.org#53117,"KALIGANDU, SERANG, KOTA SERANG, BANTEN",7,79,158,237
https://kawalpemilu.org#53117,"KALIGANDU, SERANG, KOTA SERANG, BANTEN",8,42,189,231
https://kawalpemilu.org#53117,"KALIGANDU, SERANG, KOTA SERANG, BANTEN",9,51,194,245
https://kawalpemilu.org#53117,"KALIGANDU, SERANG, KOTA SERANG, BANTEN",10,95,139,234
https://kawalpemilu.org#53117,"KALIGANDU, SERANG, KOTA SERANG, BANTEN",11,70,146,216
https://kawalpemilu.org#53117,"KALIGANDU, SERANG, KOTA SERANG, BANTEN",12,68,143,211
https://kawalpemilu.org#53117,"KALIGANDU, SERANG, KOTA SERANG, BANTEN",13,64,138,202
https://kawalpemilu.org#53117,"KALIGANDU, SERANG, KOTA SERANG, BANTEN",14,33,181,214
https://kawalpemilu.org#53117,"KALIGANDU, SERANG, KOTA SERANG, BANTEN",15,88,107,195
https://kawalpemilu.org#53117,"KALIGANDU, SERANG, KOTA SERANG, BANTEN",16,83,103,186
https://kawalpemilu.org#53117,"KALIGANDU, SERANG, KOTA SERANG, BANTEN",17,41,104,145
https://kawalpemilu.org#53117,"KALIGANDU, SERANG, KOTA SERANG, BANTEN",18,52,82,134
https://kawalpemilu.org#53117,"KALIGANDU, SERANG, KOTA SERANG, BANTEN",19,60,136,196
https://kawalpemilu.org#53117,"KALIGANDU, SERANG, KOTA SERANG, BANTEN",20,57,87,144
https://kawalpemilu.org#53117,"KALIGANDU, SERANG, KOTA SERANG, BANTEN",21,91,86,177
https://kawalpemilu.org#53117,"KALIGANDU, SERANG, KOTA SERANG, BANTEN",22,89,100,189
https://kawalpemilu.org#53117,"KALIGANDU, SERANG, KOTA SERANG, BANTEN",23,82,136,218
https://kawalpemilu.org#53117,"KALIGANDU, SERANG, KOTA SERANG, BANTEN",24,98,108,206
https://kawalpemilu.org#53117,"KALIGANDU, SERANG, KOTA SERANG, BANTEN",25,103,52,155
https://kawalpemilu.org#53117,"KALIGANDU, SERANG, KOTA SERANG, BANTEN",26,83,99,182
https://kawalpemilu.org#53117,"KALIGANDU, SERANG, KOTA SERANG, BANTEN",27,43,154,197
https://kawalpemilu.org#53117,"KALIGANDU, SERANG, KOTA SERANG, BANTEN",28,30,143,173
https://kawalpemilu.org#53117,"KALIGANDU, SERANG, KOTA SERANG, BANTEN",29,0,0,163
https://kawalpemilu.org#53117,"KALIGANDU, SERANG, KOTA SERANG, BANTEN",30,50,117,167
https://kawalpemilu.org#53117,"KALIGANDU, SERANG, KOTA SERANG, BANTEN",31,86,124,210
https://kawalpemilu.org#53117,"KALIGANDU, SERANG, KOTA SERANG, BANTEN",32,76,126,202
https://kawalpemilu.org#53117,"KALIGANDU, SERANG, KOTA SERANG, BANTEN",33,113,111,224
https://kawalpemilu.org#53117,"KALIGANDU, SERANG, KOTA SERANG, BANTEN",34,115,84,199
https://kawalpemilu.org#53117,"KALIGANDU, SERANG, KOTA SERANG, BANTEN",35,55,164,219
https://kawalpemilu.org#53117,"KALIGANDU, SERANG, KOTA SERANG, BANTEN",36,66,155,221
https://kawalpemilu.org#53117,"KALIGANDU, SERANG, KOTA SERANG, BANTEN",37,72,154,226
https://kawalpemilu.org#53117,"KALIGANDU, SERANG, KOTA SERANG, BANTEN",38,76,163,239
https://kawalpemilu.org#53117,"KALIGANDU, SERANG, KOTA SERANG, BANTEN",39,88,167,255
https://kawalpemilu.org#53117,"KALIGANDU, SERANG, KOTA SERANG, BANTEN",40,84,160,244
https://kawalpemilu.org#53117,"KALIGANDU, SERANG, KOTA SERANG, BANTEN",41,71,118,189
https://kawalpemilu.org#53117,"KALIGANDU, SERANG, KOTA SERANG, BANTEN",42,49,126,175
https://kawalpemilu.org#53117,"KALIGANDU, SERANG, KOTA SERANG, BANTEN",43,74,126,200
https://kawalpemilu.org#53117,"KALIGANDU, SERANG, KOTA SERANG, BANTEN",44,87,106,193
https://kawalpemilu.org#53117,"KALIGANDU, SERANG, KOTA SERANG, BANTEN",45,72,95,167
https://kawalpemilu.org#53117,"KALIGANDU, SERANG, KOTA SERANG, BANTEN",46,46,139,190
https://kawalpemilu.org#53117,"KALIGANDU, SERANG, KOTA SERANG, BANTEN",47,64,171,235
https://kawalpemilu.org#53117,"KALIGANDU, SERANG, KOTA SERANG, BANTEN",48,49,164,213
https://kawalpemilu.org#53117,"KALIGANDU, SERANG, KOTA SERANG, BANTEN",49,52,114,166
https://kawalpemilu.org#53117,"KALIGANDU, SERANG, KOTA SERANG, BANTEN",50,80,155,235
https://kawalpemilu.org#53117,"KALIGANDU, SERANG, KOTA SERANG, BANTEN",51,56,157,213
https://kawalpemilu.org#53117,"KALIGANDU, SERANG, KOTA SERANG, BANTEN",52,51,138,189
https://kawalpemilu.org#53117,"KALIGANDU, SERANG, KOTA SERANG, BANTEN",53,50,157,157
https://kawalpemilu.org#53117,"KALIGANDU, SERANG, KOTA SERANG, BANTEN",54,67,193,260
https://kawalpemilu.org#53117,"KALIGANDU, SERANG, KOTA SERANG, BANTEN",55,38,104,142
https://kawalpemilu.org#53117,"KALIGANDU, SERANG, KOTA SERANG, BANTEN",56,67,149,216
https://kawalpemilu.org#53117,"KALIGANDU, SERANG, KOTA SERANG, BANTEN",57,69,159,228
https://kawalpemilu.org#53117,"KALIGANDU, SERANG, KOTA SERANG, BANTEN",58,43,118,161
https://kawalpemilu.org#53117,"KALIGANDU, SERANG, KOTA SERANG, BANTEN",59,51,89,140
https://kawalpemilu.org#53118,"TERONDOL, SERANG, KOTA SERANG, BANTEN",1,72,89,161
https://kawalpemilu.org#53118,"TERONDOL, SERANG, KOTA SERANG, BANTEN",2,65,113,178
https://kawalpemilu.org#53118,"TERONDOL, SERANG, KOTA SERANG, BANTEN",3,52,106,158
https://kawalpemilu.org#53118,"TERONDOL, SERANG, KOTA SERANG, BANTEN",4,78,133,211
https://kawalpemilu.org#53118,"TERONDOL, SERANG, KOTA SERANG, BANTEN",5,65,154,219
https://kawalpemilu.org#53118,"TERONDOL, SERANG, KOTA SERANG, BANTEN",6,54,137,191
https://kawalpemilu.org#53118,"TERONDOL, SERANG, KOTA SERANG, BANTEN",7,49,144,193
https://kawalpemilu.org#53118,"TERONDOL, SERANG, KOTA SERANG, BANTEN",8,91,148,239
https://kawalpemilu.org#53118,"TERONDOL, SERANG, KOTA SERANG, BANTEN",9,67,128,195
https://kawalpemilu.org#53118,"TERONDOL, SERANG, KOTA SERANG, BANTEN",10,73,171,244
https://kawalpemilu.org#53118,"TERONDOL, SERANG, KOTA SERANG, BANTEN",11,76,147,223
https://kawalpemilu.org#53118,"TERONDOL, SERANG, KOTA SERANG, BANTEN",12,81,132,213
https://kawalpemilu.org#53118,"TERONDOL, SERANG, KOTA SERANG, BANTEN",13,101,122,223
https://kawalpemilu.org#53118,"TERONDOL, SERANG, KOTA SERANG, BANTEN",14,88,99,187
https://kawalpemilu.org#53118,"TERONDOL, SERANG, KOTA SERANG, BANTEN",15,62,129,191
https://kawalpemilu.org#53118,"TERONDOL, SERANG, KOTA SERANG, BANTEN",16,77,149,226
https://kawalpemilu.org#53118,"TERONDOL, SERANG, KOTA SERANG, BANTEN",17,68,151,219
https://kawalpemilu.org#53118,"TERONDOL, SERANG, KOTA SERANG, BANTEN",18,80,138,218
https://kawalpemilu.org#53118,"TERONDOL, SERANG, KOTA SERANG, BANTEN",19,61,149,210
https://kawalpemilu.org#53118,"TERONDOL, SERANG, KOTA SERANG, BANTEN",20,69,168,237
https://kawalpemilu.org#53118,"TERONDOL, SERANG, KOTA SERANG, BANTEN",21,85,149,234
https://kawalpemilu.org#53118,"TERONDOL, SERANG, KOTA SERANG, BANTEN",22,77,94,171
https://kawalpemilu.org#53118,"TERONDOL, SERANG, KOTA SERANG, BANTEN",23,95,92,187
https://kawalpemilu.org#53118,"TERONDOL, SERANG, KOTA SERANG, BANTEN",24,50,128,178
https://kawalpemilu.org#53119,"KAGUNGAN, SERANG, KOTA SERANG, BANTEN",1,69,141,210
https://kawalpemilu.org#53119,"KAGUNGAN, SERANG, KOTA SERANG, BANTEN",2,60,156,216
https://kawalpemilu.org#53119,"KAGUNGAN, SERANG, KOTA SERANG, BANTEN",3,56,182,238
https://kawalpemilu.org#53119,"KAGUNGAN, SERANG, KOTA SERANG, BANTEN",4,49,141,190
https://kawalpemilu.org#53119,"KAGUNGAN, SERANG, KOTA SERANG, BANTEN",5,95,148,243
https://kawalpemilu.org#53119,"KAGUNGAN, SERANG, KOTA SERANG, BANTEN",6,58,162,220
https://kawalpemilu.org#53119,"KAGUNGAN, SERANG, KOTA SERANG, BANTEN",7,53,189,242
https://kawalpemilu.org#53119,"KAGUNGAN, SERANG, KOTA SERANG, BANTEN",8,68,174,242
https://kawalpemilu.org#53119,"KAGUNGAN, SERANG, KOTA SERANG, BANTEN",9,57,185,242
https://kawalpemilu.org#53119,"KAGUNGAN, SERANG, KOTA SERANG, BANTEN",10,61,201,262
https://kawalpemilu.org#53119,"KAGUNGAN, SERANG, KOTA SERANG, BANTEN",11,50,210,260
https://kawalpemilu.org#53119,"KAGUNGAN, SERANG, KOTA SERANG, BANTEN",12,115,129,244
https://kawalpemilu.org#53119,"KAGUNGAN, SERANG, KOTA SERANG, BANTEN",13,89,143,232
https://kawalpemilu.org#53119,"KAGUNGAN, SERANG, KOTA SERANG, BANTEN",14,51,179,230
https://kawalpemilu.org#53119,"KAGUNGAN, SERANG, KOTA SERANG, BANTEN",15,66,161,227
https://kawalpemilu.org#53119,"KAGUNGAN, SERANG, KOTA SERANG, BANTEN",16,75,159,234
https://kawalpemilu.org#53119,"KAGUNGAN, SERANG, KOTA SERANG, BANTEN",17,55,171,226
https://kawalpemilu.org#53119,"KAGUNGAN, SERANG, KOTA SERANG, BANTEN",18,41,155,196
https://kawalpemilu.org#53119,"KAGUNGAN, SERANG, KOTA SERANG, BANTEN",19,44,180,224
https://kawalpemilu.org#53119,"KAGUNGAN, SERANG, KOTA SERANG, BANTEN",20,57,191,248
https://kawalpemilu.org#53119,"KAGUNGAN, SERANG, KOTA SERANG, BANTEN",21,42,214,256
https://kawalpemilu.org#53119,"KAGUNGAN, SERANG, KOTA SERANG, BANTEN",22,29,200,229
https://kawalpemilu.org#53119,"KAGUNGAN, SERANG, KOTA SERANG, BANTEN",23,46,195,241
https://kawalpemilu.org#53119,"KAGUNGAN, SERANG, KOTA SERANG, BANTEN",24,59,177,236
https://kawalpemilu.org#53119,"KAGUNGAN, SERANG, KOTA SERANG, BANTEN",25,79,158,237
https://kawalpemilu.org#53119,"KAGUNGAN, SERANG, KOTA SERANG, BANTEN",26,60,166,226
https://kawalpemilu.org#53119,"KAGUNGAN, SERANG, KOTA SERANG, BANTEN",27,85,147,323
https://kawalpemilu.org#53119,"KAGUNGAN, SERANG, KOTA SERANG, BANTEN",28,48,138,186
https://kawalpemilu.org#53119,"KAGUNGAN, SERANG, KOTA SERANG, BANTEN",29,60,172,232
https://kawalpemilu.org#53119,"KAGUNGAN, SERANG, KOTA SERANG, BANTEN",30,48,171,119
https://kawalpemilu.org#53119,"KAGUNGAN, SERANG, KOTA SERANG, BANTEN",31,64,156,220
https://kawalpemilu.org#53119,"KAGUNGAN, SERANG, KOTA SERANG, BANTEN",32,82,137,219
https://kawalpemilu.org#53119,"KAGUNGAN, SERANG, KOTA SERANG, BANTEN",33,68,171,239
https://kawalpemilu.org#53119,"KAGUNGAN, SERANG, KOTA SERANG, BANTEN",34,49,193,242
https://kawalpemilu.org#53119,"KAGUNGAN, SERANG, KOTA SERANG, BANTEN",35,78,163,241
https://kawalpemilu.org#53119,"KAGUNGAN, SERANG, KOTA SERANG, BANTEN",36,70,152,222
https://kawalpemilu.org#53119,"KAGUNGAN, SERANG, KOTA SERANG, BANTEN",37,82,108,190
https://kawalpemilu.org#53119,"KAGUNGAN, SERANG, KOTA SERANG, BANTEN",38,54,153,207
https://kawalpemilu.org#53119,"KAGUNGAN, SERANG, KOTA SERANG, BANTEN",39,29,32,61
https://kawalpemilu.org#53119,"KAGUNGAN, SERANG, KOTA SERANG, BANTEN",40,34,74,108
https://kawalpemilu.org#53119,"KAGUNGAN, SERANG, KOTA SERANG, BANTEN",41,26,89,115
https://kawalpemilu.org#53119,"KAGUNGAN, SERANG, KOTA SERANG, BANTEN",42,31,87,118
https://kawalpemilu.org#53119,"KAGUNGAN, SERANG, KOTA SERANG, BANTEN",43,18,50,68
https://kawalpemilu.org#53121,"KASEMEN, KASEMEN, KOTA SERANG, BANTEN",1,72,188,260
https://kawalpemilu.org#53121,"KASEMEN, KASEMEN, KOTA SERANG, BANTEN",2,65,174,239
https://kawalpemilu.org#53121,"KASEMEN, KASEMEN, KOTA SERANG, BANTEN",3,52,182,234
https://kawalpemilu.org#53121,"KASEMEN, KASEMEN, KOTA SERANG, BANTEN",4,51,211,262
https://kawalpemilu.org#53121,"KASEMEN, KASEMEN, KOTA SERANG, BANTEN",5,49,207,256
https://kawalpemilu.org#53121,"KASEMEN, KASEMEN, KOTA SERANG, BANTEN",6,43,187,230
https://kawalpemilu.org#53121,"KASEMEN, KASEMEN, KOTA SERANG, BANTEN",7,94,152,246
https://kawalpemilu.org#53121,"KASEMEN, KASEMEN, KOTA SERANG, BANTEN",8,101,140,241
https://kawalpemilu.org#53121,"KASEMEN, KASEMEN, KOTA SERANG, BANTEN",9,59,131,190
https://kawalpemilu.org#53121,"KASEMEN, KASEMEN, KOTA SERANG, BANTEN",10,65,131,196
https://kawalpemilu.org#53121,"KASEMEN, KASEMEN, KOTA SERANG, BANTEN",11,97,134,231
https://kawalpemilu.org#53121,"KASEMEN, KASEMEN, KOTA SERANG, BANTEN",12,78,178,253
https://kawalpemilu.org#53121,"KASEMEN, KASEMEN, KOTA SERANG, BANTEN",13,81,170,251
https://kawalpemilu.org#53121,"KASEMEN, KASEMEN, KOTA SERANG, BANTEN",14,47,171,218
https://kawalpemilu.org#53121,"KASEMEN, KASEMEN, KOTA SERANG, BANTEN",15,58,171,229
https://kawalpemilu.org#53121,"KASEMEN, KASEMEN, KOTA SERANG, BANTEN",16,23,215,238
https://kawalpemilu.org#53121,"KASEMEN, KASEMEN, KOTA SERANG, BANTEN",17,49,168,217
https://kawalpemilu.org#53121,"KASEMEN, KASEMEN, KOTA SERANG, BANTEN",18,26,167,193
https://kawalpemilu.org#53121,"KASEMEN, KASEMEN, KOTA SERANG, BANTEN",19,47,186,233
https://kawalpemilu.org#53121,"KASEMEN, KASEMEN, KOTA SERANG, BANTEN",20,28,184,212
https://kawalpemilu.org#53121,"KASEMEN, KASEMEN, KOTA SERANG, BANTEN",21,47,162,209
https://kawalpemilu.org#53121,"KASEMEN, KASEMEN, KOTA SERANG, BANTEN",22,41,178,219
https://kawalpemilu.org#53121,"KASEMEN, KASEMEN, KOTA SERANG, BANTEN",23,31,180,211
https://kawalpemilu.org#53121,"KASEMEN, KASEMEN, KOTA SERANG, BANTEN",24,46,166,212
https://kawalpemilu.org#53121,"KASEMEN, KASEMEN, KOTA SERANG, BANTEN",25,115,157,272
https://kawalpemilu.org#53121,"KASEMEN, KASEMEN, KOTA SERANG, BANTEN",26,86,173,259
https://kawalpemilu.org#53121,"KASEMEN, KASEMEN, KOTA SERANG, BANTEN",27,71,126,197
https://kawalpemilu.org#53121,"KASEMEN, KASEMEN, KOTA SERANG, BANTEN",28,65,121,186
https://kawalpemilu.org#53121,"KASEMEN, KASEMEN, KOTA SERANG, BANTEN",29,30,195,225
https://kawalpemilu.org#53121,"KASEMEN, KASEMEN, KOTA SERANG, BANTEN",30,18,148,166
https://kawalpemilu.org#53121,"KASEMEN, KASEMEN, KOTA SERANG, BANTEN",31,33,172,205
https://kawalpemilu.org#53121,"KASEMEN, KASEMEN, KOTA SERANG, BANTEN",32,49,146,195
https://kawalpemilu.org#53121,"KASEMEN, KASEMEN, KOTA SERANG, BANTEN",33,73,158,231
https://kawalpemilu.org#53121,"KASEMEN, KASEMEN, KOTA SERANG, BANTEN",34,68,153,221
https://kawalpemilu.org#53121,"KASEMEN, KASEMEN, KOTA SERANG, BANTEN",35,78,136,214
https://kawalpemilu.org#53121,"KASEMEN, KASEMEN, KOTA SERANG, BANTEN",36,58,124,182
https://kawalpemilu.org#53121,"KASEMEN, KASEMEN, KOTA SERANG, BANTEN",37,65,87,152
https://kawalpemilu.org#53121,"KASEMEN, KASEMEN, KOTA SERANG, BANTEN",38,64,111,175
https://kawalpemilu.org#53121,"KASEMEN, KASEMEN, KOTA SERANG, BANTEN",39,38,160,198
https://kawalpemilu.org#53121,"KASEMEN, KASEMEN, KOTA SERANG, BANTEN",40,16,144,160
https://kawalpemilu.org#53121,"KASEMEN, KASEMEN, KOTA SERANG, BANTEN",41,55,139,194
https://kawalpemilu.org#53121,"KASEMEN, KASEMEN, KOTA SERANG, BANTEN",42,67,178,245
https://kawalpemilu.org#53122,"MESJID PRIYAYI, KASEMEN, KOTA SERANG, BANTEN",1,21,227,248
https://kawalpemilu.org#53122,"MESJID PRIYAYI, KASEMEN, KOTA SERANG, BANTEN",2,18,177,195
https://kawalpemilu.org#53122,"MESJID PRIYAYI, KASEMEN, KOTA SERANG, BANTEN",3,70,172,242
https://kawalpemilu.org#53122,"MESJID PRIYAYI, KASEMEN, KOTA SERANG, BANTEN",4,48,196,244
https://kawalpemilu.org#53122,"MESJID PRIYAYI, KASEMEN, KOTA SERANG, BANTEN",5,56,148,204
https://kawalpemilu.org#53122,"MESJID PRIYAYI, KASEMEN, KOTA SERANG, BANTEN",6,54,98,152
https://kawalpemilu.org#53122,"MESJID PRIYAYI, KASEMEN, KOTA SERANG, BANTEN",7,52,101,153
https://kawalpemilu.org#53122,"MESJID PRIYAYI, KASEMEN, KOTA SERANG, BANTEN",8,102,102,204
https://kawalpemilu.org#53122,"MESJID PRIYAYI, KASEMEN, KOTA SERANG, BANTEN",9,124,90,214
https://kawalpemilu.org#53122,"MESJID PRIYAYI, KASEMEN, KOTA SERANG, BANTEN",10,60,150,210
https://kawalpemilu.org#53122,"MESJID PRIYAYI, KASEMEN, KOTA SERANG, BANTEN",11,49,67,116
https://kawalpemilu.org#53122,"MESJID PRIYAYI, KASEMEN, KOTA SERANG, BANTEN",12,64,82,146
https://kawalpemilu.org#53122,"MESJID PRIYAYI, KASEMEN, KOTA SERANG, BANTEN",13,29,145,174
https://kawalpemilu.org#53122,"MESJID PRIYAYI, KASEMEN, KOTA SERANG, BANTEN",14,35,131,166
https://kawalpemilu.org#53122,"MESJID PRIYAYI, KASEMEN, KOTA SERANG, BANTEN",15,45,138,183
https://kawalpemilu.org#53122,"MESJID PRIYAYI, KASEMEN, KOTA SERANG, BANTEN",16,33,140,173
https://kawalpemilu.org#53122,"MESJID PRIYAYI, KASEMEN, KOTA SERANG, BANTEN",17,47,135,182
https://kawalpemilu.org#53122,"MESJID PRIYAYI, KASEMEN, KOTA SERANG, BANTEN",18,69,132,201
https://kawalpemilu.org#53122,"MESJID PRIYAYI, KASEMEN, KOTA SERANG, BANTEN",19,42,119,161
https://kawalpemilu.org#53122,"MESJID PRIYAYI, KASEMEN, KOTA SERANG, BANTEN",20,63,135,198
https://kawalpemilu.org#53122,"MESJID PRIYAYI, KASEMEN, KOTA SERANG, BANTEN",21,60,144,204
https://kawalpemilu.org#53122,"MESJID PRIYAYI, KASEMEN, KOTA SERANG, BANTEN",22,49,157,206
https://kawalpemilu.org#53122,"MESJID PRIYAYI, KASEMEN, KOTA SERANG, BANTEN",23,46,132,178
https://kawalpemilu.org#53122,"MESJID PRIYAYI, KASEMEN, KOTA SERANG, BANTEN",24,28,135,163
https://kawalpemilu.org#53122,"MESJID PRIYAYI, KASEMEN, KOTA SERANG, BANTEN",25,0,0,0
https://kawalpemilu.org#53123,"TERUMBU, KASEMEN, KOTA SERANG, BANTEN",1,83,107,190
https://kawalpemilu.org#53123,"TERUMBU, KASEMEN, KOTA SERANG, BANTEN",2,92,83,175
https://kawalpemilu.org#53123,"TERUMBU, KASEMEN, KOTA SERANG, BANTEN",3,90,85,175
https://kawalpemilu.org#53123,"TERUMBU, KASEMEN, KOTA SERANG, BANTEN",4,59,198,257
https://kawalpemilu.org#53123,"TERUMBU, KASEMEN, KOTA SERANG, BANTEN",5,72,172,244
https://kawalpemilu.org#53123,"TERUMBU, KASEMEN, KOTA SERANG, BANTEN",6,66,147,213
https://kawalpemilu.org#53123,"TERUMBU, KASEMEN, KOTA SERANG, BANTEN",7,40,106,146
https://kawalpemilu.org#53123,"TERUMBU, KASEMEN, KOTA SERANG, BANTEN",8,70,130,200
https://kawalpemilu.org#53123,"TERUMBU, KASEMEN, KOTA SERANG, BANTEN",9,55,157,212
https://kawalpemilu.org#53123,"TERUMBU, KASEMEN, KOTA SERANG, BANTEN",10,20,215,235
https://kawalpemilu.org#53123,"TERUMBU, KASEMEN, KOTA SERANG, BANTEN",11,32,138,170
https://kawalpemilu.org#53123,"TERUMBU, KASEMEN, KOTA SERANG, BANTEN",12,17,167,184
https://kawalpemilu.org#53123,"TERUMBU, KASEMEN, KOTA SERANG, BANTEN",13,48,125,173
https://kawalpemilu.org#53123,"TERUMBU, KASEMEN, KOTA SERANG, BANTEN",14,47,136,183
https://kawalpemilu.org#53123,"TERUMBU, KASEMEN, KOTA SERANG, BANTEN",15,45,208,253
https://kawalpemilu.org#53123,"TERUMBU, KASEMEN, KOTA SERANG, BANTEN",16,23,224,247
https://kawalpemilu.org#53123,"TERUMBU, KASEMEN, KOTA SERANG, BANTEN",17,73,176,249
https://kawalpemilu.org#53123,"TERUMBU, KASEMEN, KOTA SERANG, BANTEN",18,67,154,221
https://kawalpemilu.org#53123,"TERUMBU, KASEMEN, KOTA SERANG, BANTEN",19,31,159,190
https://kawalpemilu.org#53123,"TERUMBU, KASEMEN, KOTA SERANG, BANTEN",20,64,142,206
https://kawalpemilu.org#53123,"TERUMBU, KASEMEN, KOTA SERANG, BANTEN",21,69,145,214
https://kawalpemilu.org#53123,"TERUMBU, KASEMEN, KOTA SERANG, BANTEN",22,56,146,202
https://kawalpemilu.org#53123,"TERUMBU, KASEMEN, KOTA SERANG, BANTEN",23,39,120,159
https://kawalpemilu.org#53123,"TERUMBU, KASEMEN, KOTA SERANG, BANTEN",24,60,116,176
https://kawalpemilu.org#53123,"TERUMBU, KASEMEN, KOTA SERANG, BANTEN",25,84,138,222
https://kawalpemilu.org#53124,"WARUNG JAUD, KASEMEN, KOTA SERANG, BANTEN",1,81,142,223
https://kawalpemilu.org#53124,"WARUNG JAUD, KASEMEN, KOTA SERANG, BANTEN",2,139,77,216
https://kawalpemilu.org#53124,"WARUNG JAUD, KASEMEN, KOTA SERANG, BANTEN",3,140,72,212
https://kawalpemilu.org#53124,"WARUNG JAUD, KASEMEN, KOTA SERANG, BANTEN",4,57,164,221
https://kawalpemilu.org#53124,"WARUNG JAUD, KASEMEN, KOTA SERANG, BANTEN",5,36,153,189
https://kawalpemilu.org#53124,"WARUNG JAUD, KASEMEN, KOTA SERANG, BANTEN",6,47,124,171
https://kawalpemilu.org#53124,"WARUNG JAUD, KASEMEN, KOTA SERANG, BANTEN",7,47,141,188
https://kawalpemilu.org#53124,"WARUNG JAUD, KASEMEN, KOTA SERANG, BANTEN",8,58,191,249
https://kawalpemilu.org#53124,"WARUNG JAUD, KASEMEN, KOTA SERANG, BANTEN",9,88,114,202
https://kawalpemilu.org#53124,"WARUNG JAUD, KASEMEN, KOTA SERANG, BANTEN",10,96,98,194
https://kawalpemilu.org#53124,"WARUNG JAUD, KASEMEN, KOTA SERANG, BANTEN",11,80,184,264
https://kawalpemilu.org#53124,"WARUNG JAUD, KASEMEN, KOTA SERANG, BANTEN",12,98,128,226
https://kawalpemilu.org#53124,"WARUNG JAUD, KASEMEN, KOTA SERANG, BANTEN",13,31,198,229
https://kawalpemilu.org#53124,"WARUNG JAUD, KASEMEN, KOTA SERANG, BANTEN",14,20,152,172
https://kawalpemilu.org#53124,"WARUNG JAUD, KASEMEN, KOTA SERANG, BANTEN",15,84,151,235
https://kawalpemilu.org#53124,"WARUNG JAUD, KASEMEN, KOTA SERANG, BANTEN",16,48,147,195
https://kawalpemilu.org#53124,"WARUNG JAUD, KASEMEN, KOTA SERANG, BANTEN",17,60,163,223
https://kawalpemilu.org#53124,"WARUNG JAUD, KASEMEN, KOTA SERANG, BANTEN",18,98,97,195
https://kawalpemilu.org#53124,"WARUNG JAUD, KASEMEN, KOTA SERANG, BANTEN",19,108,131,239
https://kawalpemilu.org#53124,"WARUNG JAUD, KASEMEN, KOTA SERANG, BANTEN",20,59,125,184
https://kawalpemilu.org#53124,"WARUNG JAUD, KASEMEN, KOTA SERANG, BANTEN",21,47,140,187
https://kawalpemilu.org#53124,"WARUNG JAUD, KASEMEN, KOTA SERANG, BANTEN",22,52,166,218
https://kawalpemilu.org#53124,"WARUNG JAUD, KASEMEN, KOTA SERANG, BANTEN",23,44,185,229
https://kawalpemilu.org#53124,"WARUNG JAUD, KASEMEN, KOTA SERANG, BANTEN",24,101,138,239
https://kawalpemilu.org#53124,"WARUNG JAUD, KASEMEN, KOTA SERANG, BANTEN",25,66,136,202
https://kawalpemilu.org#53124,"WARUNG JAUD, KASEMEN, KOTA SERANG, BANTEN",26,64,183,247
https://kawalpemilu.org#53124,"WARUNG JAUD, KASEMEN, KOTA SERANG, BANTEN",27,33,108,141
https://kawalpemilu.org#53125,"BENDUNG, KASEMEN, KOTA SERANG, BANTEN",1,58,120,178
https://kawalpemilu.org#53125,"BENDUNG, KASEMEN, KOTA SERANG, BANTEN",2,59,93,152
https://kawalpemilu.org#53125,"BENDUNG, KASEMEN, KOTA SERANG, BANTEN",3,59,143,202
https://kawalpemilu.org#53125,"BENDUNG, KASEMEN, KOTA SERANG, BANTEN",4,39,162,201
https://kawalpemilu.org#53125,"BENDUNG, KASEMEN, KOTA SERANG, BANTEN",5,26,173,199
https://kawalpemilu.org#53125,"BENDUNG, KASEMEN, KOTA SERANG, BANTEN",6,36,143,179
https://kawalpemilu.org#53125,"BENDUNG, KASEMEN, KOTA SERANG, BANTEN",7,57,141,198
https://kawalpemilu.org#53125,"BENDUNG, KASEMEN, KOTA SERANG, BANTEN",8,46,139,185
https://kawalpemilu.org#53125,"BENDUNG, KASEMEN, KOTA SERANG, BANTEN",9,51,146,197
https://kawalpemilu.org#53125,"BENDUNG, KASEMEN, KOTA SERANG, BANTEN",10,64,132,196
https://kawalpemilu.org#53125,"BENDUNG, KASEMEN, KOTA SERANG, BANTEN",11,46,122,168
https://kawalpemilu.org#53125,"BENDUNG, KASEMEN, KOTA SERANG, BANTEN",12,67,103,170
https://kawalpemilu.org#53125,"BENDUNG, KASEMEN, KOTA SERANG, BANTEN",13,103,49,152
https://kawalpemilu.org#53125,"BENDUNG, KASEMEN, KOTA SERANG, BANTEN",14,77,62,139
https://kawalpemilu.org#53125,"BENDUNG, KASEMEN, KOTA SERANG, BANTEN",15,57,144,201
https://kawalpemilu.org#53125,"BENDUNG, KASEMEN, KOTA SERANG, BANTEN",16,50,131,181
https://kawalpemilu.org#53125,"BENDUNG, KASEMEN, KOTA SERANG, BANTEN",17,36,147,183
https://kawalpemilu.org#53125,"BENDUNG, KASEMEN, KOTA SERANG, BANTEN",18,41,111,152
https://kawalpemilu.org#53125,"BENDUNG, KASEMEN, KOTA SERANG, BANTEN",19,75,140,215
https://kawalpemilu.org#53125,"BENDUNG, KASEMEN, KOTA SERANG, BANTEN",20,82,173,279
https://kawalpemilu.org#53125,"BENDUNG, KASEMEN, KOTA SERANG, BANTEN",21,92,69,161
https://kawalpemilu.org#53125,"BENDUNG, KASEMEN, KOTA SERANG, BANTEN",22,92,67,159
https://kawalpemilu.org#53125,"BENDUNG, KASEMEN, KOTA SERANG, BANTEN",23,63,117,180
https://kawalpemilu.org#53125,"BENDUNG, KASEMEN, KOTA SERANG, BANTEN",24,54,97,151
https://kawalpemilu.org#53126,"BANTEN, KASEMEN, KOTA SERANG, BANTEN",1,70,160,230
https://kawalpemilu.org#53126,"BANTEN, KASEMEN, KOTA SERANG, BANTEN",2,67,156,223
https://kawalpemilu.org#53126,"BANTEN, KASEMEN, KOTA SERANG, BANTEN",3,87,115,202
https://kawalpemilu.org#53126,"BANTEN, KASEMEN, KOTA SERANG, BANTEN",4,80,105,185
https://kawalpemilu.org#53126,"BANTEN, KASEMEN, KOTA SERANG, BANTEN",5,120,85,205
https://kawalpemilu.org#53126,"BANTEN, KASEMEN, KOTA SERANG, BANTEN",6,98,84,182
https://kawalpemilu.org#53126,"BANTEN, KASEMEN, KOTA SERANG, BANTEN",7,94,104,198
https://kawalpemilu.org#53126,"BANTEN, KASEMEN, KOTA SERANG, BANTEN",8,88,111,199
https://kawalpemilu.org#53126,"BANTEN, KASEMEN, KOTA SERANG, BANTEN",9,92,134,226
https://kawalpemilu.org#53126,"BANTEN, KASEMEN, KOTA SERANG, BANTEN",10,114,111,225
https://kawalpemilu.org#53126,"BANTEN, KASEMEN, KOTA SERANG, BANTEN",11,135,87,222
https://kawalpemilu.org#53126,"BANTEN, KASEMEN, KOTA SERANG, BANTEN",12,110,144,254
https://kawalpemilu.org#53126,"BANTEN, KASEMEN, KOTA SERANG, BANTEN",13,126,106,232
https://kawalpemilu.org#53126,"BANTEN, KASEMEN, KOTA SERANG, BANTEN",14,95,116,211
https://kawalpemilu.org#53126,"BANTEN, KASEMEN, KOTA SERANG, BANTEN",15,85,120,205
https://kawalpemilu.org#53126,"BANTEN, KASEMEN, KOTA SERANG, BANTEN",16,74,134,208
https://kawalpemilu.org#53126,"BANTEN, KASEMEN, KOTA SERANG, BANTEN",17,56,157,213
https://kawalpemilu.org#53126,"BANTEN, KASEMEN, KOTA SERANG, BANTEN",18,87,146,233
https://kawalpemilu.org#53126,"BANTEN, KASEMEN, KOTA SERANG, BANTEN",19,113,140,253
https://kawalpemilu.org#53126,"BANTEN, KASEMEN, KOTA SERANG, BANTEN",20,58,133,191
https://kawalpemilu.org#53126,"BANTEN, KASEMEN, KOTA SERANG, BANTEN",21,61,118,179
https://kawalpemilu.org#53126,"BANTEN, KASEMEN, KOTA SERANG, BANTEN",22,77,122,199
https://kawalpemilu.org#53126,"BANTEN, KASEMEN, KOTA SERANG, BANTEN",23,89,105,194
https://kawalpemilu.org#53126,"BANTEN, KASEMEN, KOTA SERANG, BANTEN",24,84,137,221
https://kawalpemilu.org#53126,"BANTEN, KASEMEN, KOTA SERANG, BANTEN",25,109,107,216
https://kawalpemilu.org#53126,"BANTEN, KASEMEN, KOTA SERANG, BANTEN",26,74,161,235
https://kawalpemilu.org#53126,"BANTEN, KASEMEN, KOTA SERANG, BANTEN",27,59,103,162
https://kawalpemilu.org#53126,"BANTEN, KASEMEN, KOTA SERANG, BANTEN",28,63,100,163
https://kawalpemilu.org#53126,"BANTEN, KASEMEN, KOTA SERANG, BANTEN",29,84,122,206
https://kawalpemilu.org#53126,"BANTEN, KASEMEN, KOTA SERANG, BANTEN",30,55,103,158
https://kawalpemilu.org#53126,"BANTEN, KASEMEN, KOTA SERANG, BANTEN",31,92,102,194
https://kawalpemilu.org#53126,"BANTEN, KASEMEN, KOTA SERANG, BANTEN",32,71,112,183
https://kawalpemilu.org#53126,"BANTEN, KASEMEN, KOTA SERANG, BANTEN",33,67,110,177
https://kawalpemilu.org#53126,"BANTEN, KASEMEN, KOTA SERANG, BANTEN",34,104,129,233
https://kawalpemilu.org#53126,"BANTEN, KASEMEN, KOTA SERANG, BANTEN",35,87,147,234
https://kawalpemilu.org#53126,"BANTEN, KASEMEN, KOTA SERANG, BANTEN",36,69,147,216
https://kawalpemilu.org#53126,"BANTEN, KASEMEN, KOTA SERANG, BANTEN",37,85,137,222
https://kawalpemilu.org#53126,"BANTEN, KASEMEN, KOTA SERANG, BANTEN",38,96,137,233
https://kawalpemilu.org#53126,"BANTEN, KASEMEN, KOTA SERANG, BANTEN",39,67,163,230
https://kawalpemilu.org#53126,"BANTEN, KASEMEN, KOTA SERANG, BANTEN",40,80,147,227
https://kawalpemilu.org#53126,"BANTEN, KASEMEN, KOTA SERANG, BANTEN",41,110,92,202
https://kawalpemilu.org#53126,"BANTEN, KASEMEN, KOTA SERANG, BANTEN",42,96,118,214
https://kawalpemilu.org#53126,"BANTEN, KASEMEN, KOTA SERANG, BANTEN",43,60,101,161
https://kawalpemilu.org#53126,"BANTEN, KASEMEN, KOTA SERANG, BANTEN",44,65,90,155
https://kawalpemilu.org#53126,"BANTEN, KASEMEN, KOTA SERANG, BANTEN",45,67,122,189
https://kawalpemilu.org#53127,"SAWAH LUHUR, KASEMEN, KOTA SERANG, BANTEN",1,78,72,150
https://kawalpemilu.org#53127,"SAWAH LUHUR, KASEMEN, KOTA SERANG, BANTEN",2,68,87,155
https://kawalpemilu.org#53127,"SAWAH LUHUR, KASEMEN, KOTA SERANG, BANTEN",3,83,143,226
https://kawalpemilu.org#53127,"SAWAH LUHUR, KASEMEN, KOTA SERANG, BANTEN",4,106,100,206
https://kawalpemilu.org#53127,"SAWAH LUHUR, KASEMEN, KOTA SERANG, BANTEN",5,41,175,216
https://kawalpemilu.org#53127,"SAWAH LUHUR, KASEMEN, KOTA SERANG, BANTEN",6,54,135,189
https://kawalpemilu.org#53127,"SAWAH LUHUR, KASEMEN, KOTA SERANG, BANTEN",7,35,133,168
https://kawalpemilu.org#53127,"SAWAH LUHUR, KASEMEN, KOTA SERANG, BANTEN",8,49,151,200
https://kawalpemilu.org#53127,"SAWAH LUHUR, KASEMEN, KOTA SERANG, BANTEN",9,53,132,185
https://kawalpemilu.org#53127,"SAWAH LUHUR, KASEMEN, KOTA SERANG, BANTEN",10,43,121,164
https://kawalpemilu.org#53127,"SAWAH LUHUR, KASEMEN, KOTA SERANG, BANTEN",12,46,106,152
https://kawalpemilu.org#53127,"SAWAH LUHUR, KASEMEN, KOTA SERANG, BANTEN",13,88,102,190
https://kawalpemilu.org#53127,"SAWAH LUHUR, KASEMEN, KOTA SERANG, BANTEN",14,68,134,202
https://kawalpemilu.org#53127,"SAWAH LUHUR, KASEMEN, KOTA SERANG, BANTEN",15,88,136,224
https://kawalpemilu.org#53127,"SAWAH LUHUR, KASEMEN, KOTA SERANG, BANTEN",16,72,164,236
https://kawalpemilu.org#53127,"SAWAH LUHUR, KASEMEN, KOTA SERANG, BANTEN",17,103,117,220
https://kawalpemilu.org#53127,"SAWAH LUHUR, KASEMEN, KOTA SERANG, BANTEN",18,80,106,186
https://kawalpemilu.org#53127,"SAWAH LUHUR, KASEMEN, KOTA SERANG, BANTEN",19,75,100,175
https://kawalpemilu.org#53127,"SAWAH LUHUR, KASEMEN, KOTA SERANG, BANTEN",20,51,159,210
https://kawalpemilu.org#53127,"SAWAH LUHUR, KASEMEN, KOTA SERANG, BANTEN",21,45,120,165
https://kawalpemilu.org#53127,"SAWAH LUHUR, KASEMEN, KOTA SERANG, BANTEN",22,45,171,216
https://kawalpemilu.org#53127,"SAWAH LUHUR, KASEMEN, KOTA SERANG, BANTEN",23,37,204,241
https://kawalpemilu.org#53127,"SAWAH LUHUR, KASEMEN, KOTA SERANG, BANTEN",24,32,202,234
https://kawalpemilu.org#53127,"SAWAH LUHUR, KASEMEN, KOTA SERANG, BANTEN",25,36,201,237
https://kawalpemilu.org#53127,"SAWAH LUHUR, KASEMEN, KOTA SERANG, BANTEN",26,24,163,187
https://kawalpemilu.org#53127,"SAWAH LUHUR, KASEMEN, KOTA SERANG, BANTEN",27,61,126,187
https://kawalpemilu.org#53127,"SAWAH LUHUR, KASEMEN, KOTA SERANG, BANTEN",28,55,133,188
https://kawalpemilu.org#53127,"SAWAH LUHUR, KASEMEN, KOTA SERANG, BANTEN",29,53,125,178
https://kawalpemilu.org#53127,"SAWAH LUHUR, KASEMEN, KOTA SERANG, BANTEN",30,49,111,160
https://kawalpemilu.org#53128,"KILASAH, KASEMEN, KOTA SERANG, BANTEN",1,77,114,191
https://kawalpemilu.org#53128,"KILASAH, KASEMEN, KOTA SERANG, BANTEN",2,39,111,150
https://kawalpemilu.org#53128,"KILASAH, KASEMEN, KOTA SERANG, BANTEN",3,60,76,136
https://kawalpemilu.org#53128,"KILASAH, KASEMEN, KOTA SERANG, BANTEN",4,45,173,218
https://kawalpemilu.org#53128,"KILASAH, KASEMEN, KOTA SERANG, BANTEN",5,57,171,228
https://kawalpemilu.org#53128,"KILASAH, KASEMEN, KOTA SERANG, BANTEN",6,58,152,210
https://kawalpemilu.org#53128,"KILASAH, KASEMEN, KOTA SERANG, BANTEN",7,64,151,215
https://kawalpemilu.org#53128,"KILASAH, KASEMEN, KOTA SERANG, BANTEN",8,56,175,231
https://kawalpemilu.org#53128,"KILASAH, KASEMEN, KOTA SERANG, BANTEN",9,66,178,244
https://kawalpemilu.org#53128,"KILASAH, KASEMEN, KOTA SERANG, BANTEN",10,34,89,123
https://kawalpemilu.org#53128,"KILASAH, KASEMEN, KOTA SERANG, BANTEN",11,73,139,212
https://kawalpemilu.org#53128,"KILASAH, KASEMEN, KOTA SERANG, BANTEN",12,47,142,189
https://kawalpemilu.org#53128,"KILASAH, KASEMEN, KOTA SERANG, BANTEN",13,46,126,172
https://kawalpemilu.org#53128,"KILASAH, KASEMEN, KOTA SERANG, BANTEN",14,54,142,196
https://kawalpemilu.org#53128,"KILASAH, KASEMEN, KOTA SERANG, BANTEN",15,53,129,182
https://kawalpemilu.org#53128,"KILASAH, KASEMEN, KOTA SERANG, BANTEN",16,92,104,196
https://kawalpemilu.org#53128,"KILASAH, KASEMEN, KOTA SERANG, BANTEN",17,103,121,224
https://kawalpemilu.org#53128,"KILASAH, KASEMEN, KOTA SERANG, BANTEN",18,79,118,197
https://kawalpemilu.org#53128,"KILASAH, KASEMEN, KOTA SERANG, BANTEN",19,74,146,220
https://kawalpemilu.org#53128,"KILASAH, KASEMEN, KOTA SERANG, BANTEN",20,80,132,212
https://kawalpemilu.org#53128,"KILASAH, KASEMEN, KOTA SERANG, BANTEN",21,57,112,169
https://kawalpemilu.org#53128,"KILASAH, KASEMEN, KOTA SERANG, BANTEN",22,24,135,159
https://kawalpemilu.org#53128,"KILASAH, KASEMEN, KOTA SERANG, BANTEN",23,64,148,212
https://kawalpemilu.org#53129,"KASUNYATAN, KASEMEN, KOTA SERANG, BANTEN",1,103,123,226
https://kawalpemilu.org#53129,"KASUNYATAN, KASEMEN, KOTA SERANG, BANTEN",2,85,106,191
https://kawalpemilu.org#53129,"KASUNYATAN, KASEMEN, KOTA SERANG, BANTEN",3,58,147,205
https://kawalpemilu.org#53129,"KASUNYATAN, KASEMEN, KOTA SERANG, BANTEN",4,80,120,200
https://kawalpemilu.org#53129,"KASUNYATAN, KASEMEN, KOTA SERANG, BANTEN",5,81,154,235
https://kawalpemilu.org#53129,"KASUNYATAN, KASEMEN, KOTA SERANG, BANTEN",6,117,136,253
https://kawalpemilu.org#53129,"KASUNYATAN, KASEMEN, KOTA SERANG, BANTEN",7,32,108,140
https://kawalpemilu.org#53129,"KASUNYATAN, KASEMEN, KOTA SERANG, BANTEN",8,94,162,256
https://kawalpemilu.org#53129,"KASUNYATAN, KASEMEN, KOTA SERANG, BANTEN",9,93,137,230
https://kawalpemilu.org#53129,"KASUNYATAN, KASEMEN, KOTA SERANG, BANTEN",10,80,132,212
https://kawalpemilu.org#53129,"KASUNYATAN, KASEMEN, KOTA SERANG, BANTEN",11,61,159,220
https://kawalpemilu.org#53129,"KASUNYATAN, KASEMEN, KOTA SERANG, BANTEN",12,105,126,231
https://kawalpemilu.org#53129,"KASUNYATAN, KASEMEN, KOTA SERANG, BANTEN",13,20,216,236
https://kawalpemilu.org#53129,"KASUNYATAN, KASEMEN, KOTA SERANG, BANTEN",14,37,199,236
https://kawalpemilu.org#53129,"KASUNYATAN, KASEMEN, KOTA SERANG, BANTEN",15,38,162,200
https://kawalpemilu.org#53129,"KASUNYATAN, KASEMEN, KOTA SERANG, BANTEN",16,51,172,223
https://kawalpemilu.org#53129,"KASUNYATAN, KASEMEN, KOTA SERANG, BANTEN",17,47,83,130
https://kawalpemilu.org#53129,"KASUNYATAN, KASEMEN, KOTA SERANG, BANTEN",18,36,105,141
https://kawalpemilu.org#53129,"KASUNYATAN, KASEMEN, KOTA SERANG, BANTEN",19,78,173,251
https://kawalpemilu.org#53129,"KASUNYATAN, KASEMEN, KOTA SERANG, BANTEN",20,71,170,241
https://kawalpemilu.org#53129,"KASUNYATAN, KASEMEN, KOTA SERANG, BANTEN",21,40,174,214
https://kawalpemilu.org#53129,"KASUNYATAN, KASEMEN, KOTA SERANG, BANTEN",22,56,155,211
https://kawalpemilu.org#53129,"KASUNYATAN, KASEMEN, KOTA SERANG, BANTEN",23,57,143,200
https://kawalpemilu.org#53129,"KASUNYATAN, KASEMEN, KOTA SERANG, BANTEN",24,51,135,186
https://kawalpemilu.org#53130,"MARGALUYU, KASEMEN, KOTA SERANG, BANTEN",1,30,61,91
https://kawalpemilu.org#53130,"MARGALUYU, KASEMEN, KOTA SERANG, BANTEN",2,71,88,159
https://kawalpemilu.org#53130,"MARGALUYU, KASEMEN, KOTA SERANG, BANTEN",3,89,138,227
https://kawalpemilu.org#53130,"MARGALUYU, KASEMEN, KOTA SERANG, BANTEN",4,123,98,221
https://kawalpemilu.org#53130,"MARGALUYU, KASEMEN, KOTA SERANG, BANTEN",5,113,124,237
https://kawalpemilu.org#53130,"MARGALUYU, KASEMEN, KOTA SERANG, BANTEN",6,69,143,212
https://kawalpemilu.org#53130,"MARGALUYU, KASEMEN, KOTA SERANG, BANTEN",7,82,153,235
https://kawalpemilu.org#53130,"MARGALUYU, KASEMEN, KOTA SERANG, BANTEN",8,70,156,226
https://kawalpemilu.org#53130,"MARGALUYU, KASEMEN, KOTA SERANG, BANTEN",9,56,137,193
https://kawalpemilu.org#53130,"MARGALUYU, KASEMEN, KOTA SERANG, BANTEN",10,73,91,164
https://kawalpemilu.org#53130,"MARGALUYU, KASEMEN, KOTA SERANG, BANTEN",11,41,92,133
https://kawalpemilu.org#53130,"MARGALUYU, KASEMEN, KOTA SERANG, BANTEN",12,95,65,160
https://kawalpemilu.org#53130,"MARGALUYU, KASEMEN, KOTA SERANG, BANTEN",13,99,100,199
https://kawalpemilu.org#53130,"MARGALUYU, KASEMEN, KOTA SERANG, BANTEN",14,80,119,199
https://kawalpemilu.org#53130,"MARGALUYU, KASEMEN, KOTA SERANG, BANTEN",15,70,74,144
https://kawalpemilu.org#53130,"MARGALUYU, KASEMEN, KOTA SERANG, BANTEN",16,37,71,109
https://kawalpemilu.org#53130,"MARGALUYU, KASEMEN, KOTA SERANG, BANTEN",17,34,71,105
https://kawalpemilu.org#53130,"MARGALUYU, KASEMEN, KOTA SERANG, BANTEN",18,98,129,227
https://kawalpemilu.org#53130,"MARGALUYU, KASEMEN, KOTA SERANG, BANTEN",19,81,160,241
https://kawalpemilu.org#53130,"MARGALUYU, KASEMEN, KOTA SERANG, BANTEN",20,76,148,224
https://kawalpemilu.org#53130,"MARGALUYU, KASEMEN, KOTA SERANG, BANTEN",21,79,131,210
https://kawalpemilu.org#53130,"MARGALUYU, KASEMEN, KOTA SERANG, BANTEN",22,77,120,197
https://kawalpemilu.org#53132,"WALANTAKA, WALANTAKA, KOTA SERANG, BANTEN",1,60,154,214
https://kawalpemilu.org#53132,"WALANTAKA, WALANTAKA, KOTA SERANG, BANTEN",2,56,201,257
https://kawalpemilu.org#53132,"WALANTAKA, WALANTAKA, KOTA SERANG, BANTEN",3,40,169,209
https://kawalpemilu.org#53132,"WALANTAKA, WALANTAKA, KOTA SERANG, BANTEN",4,73,184,257
https://kawalpemilu.org#53132,"WALANTAKA, WALANTAKA, KOTA SERANG, BANTEN",5,62,156,218
https://kawalpemilu.org#53132,"WALANTAKA, WALANTAKA, KOTA SERANG, BANTEN",6,60,169,229
https://kawalpemilu.org#53132,"WALANTAKA, WALANTAKA, KOTA SERANG, BANTEN",7,29,166,195
https://kawalpemilu.org#53132,"WALANTAKA, WALANTAKA, KOTA SERANG, BANTEN",8,55,94,149
https://kawalpemilu.org#53132,"WALANTAKA, WALANTAKA, KOTA SERANG, BANTEN",9,51,143,194
https://kawalpemilu.org#53132,"WALANTAKA, WALANTAKA, KOTA SERANG, BANTEN",10,58,185,243
https://kawalpemilu.org#53132,"WALANTAKA, WALANTAKA, KOTA SERANG, BANTEN",11,35,202,237
https://kawalpemilu.org#53133,"CIGOONG, WALANTAKA, KOTA SERANG, BANTEN",1,55,184,239
https://kawalpemilu.org#53133,"CIGOONG, WALANTAKA, KOTA SERANG, BANTEN",2,37,184,221
https://kawalpemilu.org#53133,"CIGOONG, WALANTAKA, KOTA SERANG, BANTEN",3,44,201,245
https://kawalpemilu.org#53133,"CIGOONG, WALANTAKA, KOTA SERANG, BANTEN",4,77,141,218
https://kawalpemilu.org#53133,"CIGOONG, WALANTAKA, KOTA SERANG, BANTEN",5,67,139,206
https://kawalpemilu.org#53133,"CIGOONG, WALANTAKA, KOTA SERANG, BANTEN",6,103,129,232
https://kawalpemilu.org#53133,"CIGOONG, WALANTAKA, KOTA SERANG, BANTEN",7,71,167,238
https://kawalpemilu.org#53133,"CIGOONG, WALANTAKA, KOTA SERANG, BANTEN",8,47,186,233
https://kawalpemilu.org#53133,"CIGOONG, WALANTAKA, KOTA SERANG, BANTEN",9,53,158,211
https://kawalpemilu.org#53133,"CIGOONG, WALANTAKA, KOTA SERANG, BANTEN",10,80,160,240
https://kawalpemilu.org#53133,"CIGOONG, WALANTAKA, KOTA SERANG, BANTEN",11,96,112,208
https://kawalpemilu.org#53134,"NYAPAH, WALANTAKA, KOTA SERANG, BANTEN",1,124,118,242
https://kawalpemilu.org#53134,"NYAPAH, WALANTAKA, KOTA SERANG, BANTEN",2,77,84,161
https://kawalpemilu.org#53134,"NYAPAH, WALANTAKA, KOTA SERANG, BANTEN",3,141,104,245
https://kawalpemilu.org#53134,"NYAPAH, WALANTAKA, KOTA SERANG, BANTEN",4,52,187,239
https://kawalpemilu.org#53134,"NYAPAH, WALANTAKA, KOTA SERANG, BANTEN",5,93,133,226
https://kawalpemilu.org#53134,"NYAPAH, WALANTAKA, KOTA SERANG, BANTEN",6,97,110,207
https://kawalpemilu.org#53134,"NYAPAH, WALANTAKA, KOTA SERANG, BANTEN",7,120,105,225
https://kawalpemilu.org#53134,"NYAPAH, WALANTAKA, KOTA SERANG, BANTEN",8,107,151,258
https://kawalpemilu.org#53134,"NYAPAH, WALANTAKA, KOTA SERANG, BANTEN",9,81,154,235
https://kawalpemilu.org#53134,"NYAPAH, WALANTAKA, KOTA SERANG, BANTEN",10,69,153,222
https://kawalpemilu.org#53134,"NYAPAH, WALANTAKA, KOTA SERANG, BANTEN",11,61,177,238
https://kawalpemilu.org#53134,"NYAPAH, WALANTAKA, KOTA SERANG, BANTEN",12,82,92,174
https://kawalpemilu.org#53135,"PANGAMPELAN, WALANTAKA, KOTA SERANG, BANTEN",1,33,180,213
https://kawalpemilu.org#53135,"PANGAMPELAN, WALANTAKA, KOTA SERANG, BANTEN",2,32,201,233
https://kawalpemilu.org#53135,"PANGAMPELAN, WALANTAKA, KOTA SERANG, BANTEN",3,20,220,240
https://kawalpemilu.org#53135,"PANGAMPELAN, WALANTAKA, KOTA SERANG, BANTEN",4,31,187,218
https://kawalpemilu.org#53135,"PANGAMPELAN, WALANTAKA, KOTA SERANG, BANTEN",5,27,212,239
https://kawalpemilu.org#53135,"PANGAMPELAN, WALANTAKA, KOTA SERANG, BANTEN",6,34,215,249
https://kawalpemilu.org#53135,"PANGAMPELAN, WALANTAKA, KOTA SERANG, BANTEN",7,46,191,237
https://kawalpemilu.org#53135,"PANGAMPELAN, WALANTAKA, KOTA SERANG, BANTEN",8,46,187,233
https://kawalpemilu.org#53135,"PANGAMPELAN, WALANTAKA, KOTA SERANG, BANTEN",9,48,161,209
https://kawalpemilu.org#53135,"PANGAMPELAN, WALANTAKA, KOTA SERANG, BANTEN",10,50,140,190
https://kawalpemilu.org#53135,"PANGAMPELAN, WALANTAKA, KOTA SERANG, BANTEN",11,52,167,219
https://kawalpemilu.org#53135,"PANGAMPELAN, WALANTAKA, KOTA SERANG, BANTEN",12,61,156,217
https://kawalpemilu.org#53135,"PANGAMPELAN, WALANTAKA, KOTA SERANG, BANTEN",13,31,200,231
https://kawalpemilu.org#53135,"PANGAMPELAN, WALANTAKA, KOTA SERANG, BANTEN",14,43,173,216
https://kawalpemilu.org#53135,"PANGAMPELAN, WALANTAKA, KOTA SERANG, BANTEN",15,42,170,212
https://kawalpemilu.org#53135,"PANGAMPELAN, WALANTAKA, KOTA SERANG, BANTEN",16,51,156,207
https://kawalpemilu.org#53135,"PANGAMPELAN, WALANTAKA, KOTA SERANG, BANTEN",17,93,163,256
https://kawalpemilu.org#53135,"PANGAMPELAN, WALANTAKA, KOTA SERANG, BANTEN",18,72,175,247
https://kawalpemilu.org#53135,"PANGAMPELAN, WALANTAKA, KOTA SERANG, BANTEN",19,70,191,261
https://kawalpemilu.org#53135,"PANGAMPELAN, WALANTAKA, KOTA SERANG, BANTEN",20,116,139,255
https://kawalpemilu.org#53135,"PANGAMPELAN, WALANTAKA, KOTA SERANG, BANTEN",21,108,149,257
https://kawalpemilu.org#53135,"PANGAMPELAN, WALANTAKA, KOTA SERANG, BANTEN",22,88,172,260
https://kawalpemilu.org#53135,"PANGAMPELAN, WALANTAKA, KOTA SERANG, BANTEN",23,98,157,255
https://kawalpemilu.org#53135,"PANGAMPELAN, WALANTAKA, KOTA SERANG, BANTEN",24,88,160,248
https://kawalpemilu.org#53136,"KIARA, WALANTAKA, KOTA SERANG, BANTEN",1,94,151,245
https://kawalpemilu.org#53136,"KIARA, WALANTAKA, KOTA SERANG, BANTEN",2,67,113,180
https://kawalpemilu.org#53136,"KIARA, WALANTAKA, KOTA SERANG, BANTEN",3,45,160,205
https://kawalpemilu.org#53136,"KIARA, WALANTAKA, KOTA SERANG, BANTEN",4,33,224,257
https://kawalpemilu.org#53136,"KIARA, WALANTAKA, KOTA SERANG, BANTEN",5,64,198,262
https://kawalpemilu.org#53136,"KIARA, WALANTAKA, KOTA SERANG, BANTEN",6,54,179,233
https://kawalpemilu.org#53136,"KIARA, WALANTAKA, KOTA SERANG, BANTEN",7,59,180,239
https://kawalpemilu.org#53136,"KIARA, WALANTAKA, KOTA SERANG, BANTEN",8,42,159,201
https://kawalpemilu.org#53136,"KIARA, WALANTAKA, KOTA SERANG, BANTEN",9,43,208,251
https://kawalpemilu.org#53136,"KIARA, WALANTAKA, KOTA SERANG, BANTEN",10,76,173,249
https://kawalpemilu.org#53136,"KIARA, WALANTAKA, KOTA SERANG, BANTEN",11,96,134,230
https://kawalpemilu.org#53136,"KIARA, WALANTAKA, KOTA SERANG, BANTEN",12,99,164,263
https://kawalpemilu.org#53136,"KIARA, WALANTAKA, KOTA SERANG, BANTEN",13,48,161,209
https://kawalpemilu.org#53136,"KIARA, WALANTAKA, KOTA SERANG, BANTEN",14,41,173,214
https://kawalpemilu.org#53136,"KIARA, WALANTAKA, KOTA SERANG, BANTEN",15,57,183,240
https://kawalpemilu.org#53136,"KIARA, WALANTAKA, KOTA SERANG, BANTEN",16,95,75,170
https://kawalpemilu.org#53137,"PAGER AGUNG, WALANTAKA, KOTA SERANG, BANTEN",1,105,125,230
https://kawalpemilu.org#53137,"PAGER AGUNG, WALANTAKA, KOTA SERANG, BANTEN",2,109,98,207
https://kawalpemilu.org#53137,"PAGER AGUNG, WALANTAKA, KOTA SERANG, BANTEN",3,94,120,214
https://kawalpemilu.org#53137,"PAGER AGUNG, WALANTAKA, KOTA SERANG, BANTEN",4,109,88,197
https://kawalpemilu.org#53137,"PAGER AGUNG, WALANTAKA, KOTA SERANG, BANTEN",5,67,128,195
https://kawalpemilu.org#53137,"PAGER AGUNG, WALANTAKA, KOTA SERANG, BANTEN",6,78,124,202
https://kawalpemilu.org#53137,"PAGER AGUNG, WALANTAKA, KOTA SERANG, BANTEN",7,61,151,212
https://kawalpemilu.org#53137,"PAGER AGUNG, WALANTAKA, KOTA SERANG, BANTEN",8,61,141,202
https://kawalpemilu.org#53137,"PAGER AGUNG, WALANTAKA, KOTA SERANG, BANTEN",9,81,164,245
https://kawalpemilu.org#53137,"PAGER AGUNG, WALANTAKA, KOTA SERANG, BANTEN",10,62,141,203
https://kawalpemilu.org#53137,"PAGER AGUNG, WALANTAKA, KOTA SERANG, BANTEN",11,86,122,208
https://kawalpemilu.org#53137,"PAGER AGUNG, WALANTAKA, KOTA SERANG, BANTEN",12,69,176,245
https://kawalpemilu.org#53137,"PAGER AGUNG, WALANTAKA, KOTA SERANG, BANTEN",13,69,149,218
https://kawalpemilu.org#53137,"PAGER AGUNG, WALANTAKA, KOTA SERANG, BANTEN",14,40,166,206
https://kawalpemilu.org#53137,"PAGER AGUNG, WALANTAKA, KOTA SERANG, BANTEN",15,57,138,195
https://kawalpemilu.org#53137,"PAGER AGUNG, WALANTAKA, KOTA SERANG, BANTEN",16,58,137,195
https://kawalpemilu.org#53137,"PAGER AGUNG, WALANTAKA, KOTA SERANG, BANTEN",17,75,167,242
https://kawalpemilu.org#53137,"PAGER AGUNG, WALANTAKA, KOTA SERANG, BANTEN",18,71,151,222
https://kawalpemilu.org#53137,"PAGER AGUNG, WALANTAKA, KOTA SERANG, BANTEN",19,82,126,208
https://kawalpemilu.org#53137,"PAGER AGUNG, WALANTAKA, KOTA SERANG, BANTEN",20,65,162,227
https://kawalpemilu.org#53137,"PAGER AGUNG, WALANTAKA, KOTA SERANG, BANTEN",21,42,166,208
https://kawalpemilu.org#53137,"PAGER AGUNG, WALANTAKA, KOTA SERANG, BANTEN",22,84,153,237
https://kawalpemilu.org#53137,"PAGER AGUNG, WALANTAKA, KOTA SERANG, BANTEN",23,80,142,222
https://kawalpemilu.org#53137,"PAGER AGUNG, WALANTAKA, KOTA SERANG, BANTEN",24,112,151,263
https://kawalpemilu.org#53137,"PAGER AGUNG, WALANTAKA, KOTA SERANG, BANTEN",25,122,146,268
https://kawalpemilu.org#53137,"PAGER AGUNG, WALANTAKA, KOTA SERANG, BANTEN",26,68,80,148
https://kawalpemilu.org#53137,"PAGER AGUNG, WALANTAKA, KOTA SERANG, BANTEN",27,28,99,127
https://kawalpemilu.org#53138,"KALODORAN, WALANTAKA, KOTA SERANG, BANTEN",1,76,143,219
https://kawalpemilu.org#53138,"KALODORAN, WALANTAKA, KOTA SERANG, BANTEN",2,70,160,230
https://kawalpemilu.org#53138,"KALODORAN, WALANTAKA, KOTA SERANG, BANTEN",3,85,136,221
https://kawalpemilu.org#53138,"KALODORAN, WALANTAKA, KOTA SERANG, BANTEN",4,65,140,205
https://kawalpemilu.org#53138,"KALODORAN, WALANTAKA, KOTA SERANG, BANTEN",5,90,148,238
https://kawalpemilu.org#53138,"KALODORAN, WALANTAKA, KOTA SERANG, BANTEN",6,82,139,221
https://kawalpemilu.org#53138,"KALODORAN, WALANTAKA, KOTA SERANG, BANTEN",7,76,138,214
https://kawalpemilu.org#53138,"KALODORAN, WALANTAKA, KOTA SERANG, BANTEN",8,77,138,215
https://kawalpemilu.org#53138,"KALODORAN, WALANTAKA, KOTA SERANG, BANTEN",9,73,140,213
https://kawalpemilu.org#53138,"KALODORAN, WALANTAKA, KOTA SERANG, BANTEN",10,54,124,178
https://kawalpemilu.org#53138,"KALODORAN, WALANTAKA, KOTA SERANG, BANTEN",11,82,124,206
https://kawalpemilu.org#53138,"KALODORAN, WALANTAKA, KOTA SERANG, BANTEN",12,66,157,223
https://kawalpemilu.org#53138,"KALODORAN, WALANTAKA, KOTA SERANG, BANTEN",13,16,138,154
https://kawalpemilu.org#53138,"KALODORAN, WALANTAKA, KOTA SERANG, BANTEN",14,33,105,138
https://kawalpemilu.org#53138,"KALODORAN, WALANTAKA, KOTA SERANG, BANTEN",15,80,128,208
https://kawalpemilu.org#53138,"KALODORAN, WALANTAKA, KOTA SERANG, BANTEN",16,90,130,220
https://kawalpemilu.org#53138,"KALODORAN, WALANTAKA, KOTA SERANG, BANTEN",17,119,127,246
https://kawalpemilu.org#53138,"KALODORAN, WALANTAKA, KOTA SERANG, BANTEN",18,114,138,252
https://kawalpemilu.org#53139,"KAPUREN, WALANTAKA, KOTA SERANG, BANTEN",1,94,91,185
https://kawalpemilu.org#53139,"KAPUREN, WALANTAKA, KOTA SERANG, BANTEN",2,91,116,207
https://kawalpemilu.org#53139,"KAPUREN, WALANTAKA, KOTA SERANG, BANTEN",3,47,75,122
https://kawalpemilu.org#53139,"KAPUREN, WALANTAKA, KOTA SERANG, BANTEN",4,85,99,184
https://kawalpemilu.org#53139,"KAPUREN, WALANTAKA, KOTA SERANG, BANTEN",5,54,110,164
https://kawalpemilu.org#53139,"KAPUREN, WALANTAKA, KOTA SERANG, BANTEN",6,77,135,212
https://kawalpemilu.org#53139,"KAPUREN, WALANTAKA, KOTA SERANG, BANTEN",7,32,158,190
https://kawalpemilu.org#53139,"KAPUREN, WALANTAKA, KOTA SERANG, BANTEN",8,52,162,214
https://kawalpemilu.org#53139,"KAPUREN, WALANTAKA, KOTA SERANG, BANTEN",9,30,139,169
https://kawalpemilu.org#53139,"KAPUREN, WALANTAKA, KOTA SERANG, BANTEN",10,38,165,203
https://kawalpemilu.org#53139,"KAPUREN, WALANTAKA, KOTA SERANG, BANTEN",11,40,132,172
https://kawalpemilu.org#53139,"KAPUREN, WALANTAKA, KOTA SERANG, BANTEN",12,49,129,178
https://kawalpemilu.org#53139,"KAPUREN, WALANTAKA, KOTA SERANG, BANTEN",13,54,154,208
https://kawalpemilu.org#53139,"KAPUREN, WALANTAKA, KOTA SERANG, BANTEN",14,58,149,207
https://kawalpemilu.org#53139,"KAPUREN, WALANTAKA, KOTA SERANG, BANTEN",15,56,175,231
https://kawalpemilu.org#53139,"KAPUREN, WALANTAKA, KOTA SERANG, BANTEN",16,56,165,221
https://kawalpemilu.org#53139,"KAPUREN, WALANTAKA, KOTA SERANG, BANTEN",17,55,83,138
https://kawalpemilu.org#53139,"KAPUREN, WALANTAKA, KOTA SERANG, BANTEN",18,58,72,130
https://kawalpemilu.org#53139,"KAPUREN, WALANTAKA, KOTA SERANG, BANTEN",19,55,99,154
https://kawalpemilu.org#53140,"TERITIH, WALANTAKA, KOTA SERANG, BANTEN",1,74,137,211
https://kawalpemilu.org#53140,"TERITIH, WALANTAKA, KOTA SERANG, BANTEN",2,75,127,202
https://kawalpemilu.org#53140,"TERITIH, WALANTAKA, KOTA SERANG, BANTEN",3,53,147,200
https://kawalpemilu.org#53140,"TERITIH, WALANTAKA, KOTA SERANG, BANTEN",4,59,156,215
https://kawalpemilu.org#53140,"TERITIH, WALANTAKA, KOTA SERANG, BANTEN",5,82,152,234
https://kawalpemilu.org#53140,"TERITIH, WALANTAKA, KOTA SERANG, BANTEN",6,57,175,232
https://kawalpemilu.org#53140,"TERITIH, WALANTAKA, KOTA SERANG, BANTEN",7,89,147,236
https://kawalpemilu.org#53140,"TERITIH, WALANTAKA, KOTA SERANG, BANTEN",8,100,115,215
https://kawalpemilu.org#53140,"TERITIH, WALANTAKA, KOTA SERANG, BANTEN",9,94,137,231
https://kawalpemilu.org#53140,"TERITIH, WALANTAKA, KOTA SERANG, BANTEN",10,88,100,188
https://kawalpemilu.org#53140,"TERITIH, WALANTAKA, KOTA SERANG, BANTEN",11,34,167,201
https://kawalpemilu.org#53140,"TERITIH, WALANTAKA, KOTA SERANG, BANTEN",12,36,180,216
https://kawalpemilu.org#53140,"TERITIH, WALANTAKA, KOTA SERANG, BANTEN",13,35,172,207
https://kawalpemilu.org#53140,"TERITIH, WALANTAKA, KOTA SERANG, BANTEN",14,23,196,219
https://kawalpemilu.org#53140,"TERITIH, WALANTAKA, KOTA SERANG, BANTEN",15,41,172,213
https://kawalpemilu.org#53140,"TERITIH, WALANTAKA, KOTA SERANG, BANTEN",16,110,150,260
https://kawalpemilu.org#53140,"TERITIH, WALANTAKA, KOTA SERANG, BANTEN",17,109,176,285
https://kawalpemilu.org#53140,"TERITIH, WALANTAKA, KOTA SERANG, BANTEN",18,108,152,261
https://kawalpemilu.org#53140,"TERITIH, WALANTAKA, KOTA SERANG, BANTEN",19,108,155,263
https://kawalpemilu.org#53140,"TERITIH, WALANTAKA, KOTA SERANG, BANTEN",20,97,140,237
https://kawalpemilu.org#53140,"TERITIH, WALANTAKA, KOTA SERANG, BANTEN",21,81,160,241
https://kawalpemilu.org#53140,"TERITIH, WALANTAKA, KOTA SERANG, BANTEN",22,39,173,212
https://kawalpemilu.org#53140,"TERITIH, WALANTAKA, KOTA SERANG, BANTEN",23,56,140,196
https://kawalpemilu.org#53140,"TERITIH, WALANTAKA, KOTA SERANG, BANTEN",24,74,128,202
https://kawalpemilu.org#53140,"TERITIH, WALANTAKA, KOTA SERANG, BANTEN",25,79,69,148
https://kawalpemilu.org#53140,"TERITIH, WALANTAKA, KOTA SERANG, BANTEN",26,70,138,208
https://kawalpemilu.org#53140,"TERITIH, WALANTAKA, KOTA SERANG, BANTEN",27,56,126,182
https://kawalpemilu.org#53140,"TERITIH, WALANTAKA, KOTA SERANG, BANTEN",28,51,135,186
https://kawalpemilu.org#53140,"TERITIH, WALANTAKA, KOTA SERANG, BANTEN",29,68,127,195
https://kawalpemilu.org#53140,"TERITIH, WALANTAKA, KOTA SERANG, BANTEN",30,92,138,230
https://kawalpemilu.org#53140,"TERITIH, WALANTAKA, KOTA SERANG, BANTEN",31,83,168,251
https://kawalpemilu.org#53141,"PABUARAN, WALANTAKA, KOTA SERANG, BANTEN",1,36,198,234
https://kawalpemilu.org#53141,"PABUARAN, WALANTAKA, KOTA SERANG, BANTEN",2,171,35,206
https://kawalpemilu.org#53141,"PABUARAN, WALANTAKA, KOTA SERANG, BANTEN",3,47,138,185
https://kawalpemilu.org#53141,"PABUARAN, WALANTAKA, KOTA SERANG, BANTEN",4,76,139,215
https://kawalpemilu.org#53141,"PABUARAN, WALANTAKA, KOTA SERANG, BANTEN",5,60,149,209
https://kawalpemilu.org#53141,"PABUARAN, WALANTAKA, KOTA SERANG, BANTEN",6,65,159,224
https://kawalpemilu.org#53141,"PABUARAN, WALANTAKA, KOTA SERANG, BANTEN",7,70,81,151
https://kawalpemilu.org#53141,"PABUARAN, WALANTAKA, KOTA SERANG, BANTEN",8,72,165,237
https://kawalpemilu.org#53141,"PABUARAN, WALANTAKA, KOTA SERANG, BANTEN",9,78,138,216
https://kawalpemilu.org#53141,"PABUARAN, WALANTAKA, KOTA SERANG, BANTEN",10,88,128,216
https://kawalpemilu.org#53141,"PABUARAN, WALANTAKA, KOTA SERANG, BANTEN",11,44,173,217
https://kawalpemilu.org#53141,"PABUARAN, WALANTAKA, KOTA SERANG, BANTEN",12,31,204,235
https://kawalpemilu.org#53142,"PASULUHAN, WALANTAKA, KOTA SERANG, BANTEN",1,74,160,234
https://kawalpemilu.org#53142,"PASULUHAN, WALANTAKA, KOTA SERANG, BANTEN",2,64,168,232
https://kawalpemilu.org#53142,"PASULUHAN, WALANTAKA, KOTA SERANG, BANTEN",3,41,179,220
https://kawalpemilu.org#53142,"PASULUHAN, WALANTAKA, KOTA SERANG, BANTEN",4,89,136,225
https://kawalpemilu.org#53142,"PASULUHAN, WALANTAKA, KOTA SERANG, BANTEN",5,58,184,242
https://kawalpemilu.org#53142,"PASULUHAN, WALANTAKA, KOTA SERANG, BANTEN",6,44,204,248
https://kawalpemilu.org#53142,"PASULUHAN, WALANTAKA, KOTA SERANG, BANTEN",7,32,147,179
https://kawalpemilu.org#53142,"PASULUHAN, WALANTAKA, KOTA SERANG, BANTEN",8,61,171,232
https://kawalpemilu.org#53142,"PASULUHAN, WALANTAKA, KOTA SERANG, BANTEN",9,68,165,233
https://kawalpemilu.org#53142,"PASULUHAN, WALANTAKA, KOTA SERANG, BANTEN",10,66,166,232
https://kawalpemilu.org#53142,"PASULUHAN, WALANTAKA, KOTA SERANG, BANTEN",11,51,127,178
https://kawalpemilu.org#53142,"PASULUHAN, WALANTAKA, KOTA SERANG, BANTEN",12,53,124,177
https://kawalpemilu.org#53143,"TEGALSARI, WALANTAKA, KOTA SERANG, BANTEN",1,56,154,210
https://kawalpemilu.org#53143,"TEGALSARI, WALANTAKA, KOTA SERANG, BANTEN",2,52,216,268
https://kawalpemilu.org#53143,"TEGALSARI, WALANTAKA, KOTA SERANG, BANTEN",3,57,180,237
https://kawalpemilu.org#53143,"TEGALSARI, WALANTAKA, KOTA SERANG, BANTEN",4,31,217,248
https://kawalpemilu.org#53143,"TEGALSARI, WALANTAKA, KOTA SERANG, BANTEN",5,75,143,218
https://kawalpemilu.org#53143,"TEGALSARI, WALANTAKA, KOTA SERANG, BANTEN",6,79,138,217
https://kawalpemilu.org#53143,"TEGALSARI, WALANTAKA, KOTA SERANG, BANTEN",7,85,212,206
https://kawalpemilu.org#53143,"TEGALSARI, WALANTAKA, KOTA SERANG, BANTEN",8,91,146,237
https://kawalpemilu.org#53143,"TEGALSARI, WALANTAKA, KOTA SERANG, BANTEN",9,86,148,234
https://kawalpemilu.org#53144,"PIPITAN, WALANTAKA, KOTA SERANG, BANTEN",1,94,140,234
https://kawalpemilu.org#53144,"PIPITAN, WALANTAKA, KOTA SERANG, BANTEN",2,92,139,231
https://kawalpemilu.org#53144,"PIPITAN, WALANTAKA, KOTA SERANG, BANTEN",3,87,141,228
https://kawalpemilu.org#53144,"PIPITAN, WALANTAKA, KOTA SERANG, BANTEN",4,78,152,230
https://kawalpemilu.org#53144,"PIPITAN, WALANTAKA, KOTA SERANG, BANTEN",5,90,126,216
https://kawalpemilu.org#53144,"PIPITAN, WALANTAKA, KOTA SERANG, BANTEN",6,85,129,214
https://kawalpemilu.org#53144,"PIPITAN, WALANTAKA, KOTA SERANG, BANTEN",7,80,120,200
https://kawalpemilu.org#53144,"PIPITAN, WALANTAKA, KOTA SERANG, BANTEN",8,83,137,220
https://kawalpemilu.org#53144,"PIPITAN, WALANTAKA, KOTA SERANG, BANTEN",9,112,109,221
https://kawalpemilu.org#53144,"PIPITAN, WALANTAKA, KOTA SERANG, BANTEN",10,31,194,225
https://kawalpemilu.org#53144,"PIPITAN, WALANTAKA, KOTA SERANG, BANTEN",11,27,211,238
https://kawalpemilu.org#53144,"PIPITAN, WALANTAKA, KOTA SERANG, BANTEN",12,35,195,230
https://kawalpemilu.org#53144,"PIPITAN, WALANTAKA, KOTA SERANG, BANTEN",13,44,187,231
https://kawalpemilu.org#53144,"PIPITAN, WALANTAKA, KOTA SERANG, BANTEN",14,40,181,221
https://kawalpemilu.org#53144,"PIPITAN, WALANTAKA, KOTA SERANG, BANTEN",15,45,190,235
https://kawalpemilu.org#53144,"PIPITAN, WALANTAKA, KOTA SERANG, BANTEN",16,38,201,239
https://kawalpemilu.org#53144,"PIPITAN, WALANTAKA, KOTA SERANG, BANTEN",17,40,183,223
https://kawalpemilu.org#53144,"PIPITAN, WALANTAKA, KOTA SERANG, BANTEN",18,53,174,227
https://kawalpemilu.org#53144,"PIPITAN, WALANTAKA, KOTA SERANG, BANTEN",19,52,178,230
https://kawalpemilu.org#53144,"PIPITAN, WALANTAKA, KOTA SERANG, BANTEN",20,45,204,249
https://kawalpemilu.org#53144,"PIPITAN, WALANTAKA, KOTA SERANG, BANTEN",21,86,160,246
https://kawalpemilu.org#53144,"PIPITAN, WALANTAKA, KOTA SERANG, BANTEN",22,92,130,222
https://kawalpemilu.org#53144,"PIPITAN, WALANTAKA, KOTA SERANG, BANTEN",23,77,163,240
https://kawalpemilu.org#53144,"PIPITAN, WALANTAKA, KOTA SERANG, BANTEN",24,61,165,226
https://kawalpemilu.org#53144,"PIPITAN, WALANTAKA, KOTA SERANG, BANTEN",25,77,166,243
https://kawalpemilu.org#53144,"PIPITAN, WALANTAKA, KOTA SERANG, BANTEN",26,69,174,243
https://kawalpemilu.org#53144,"PIPITAN, WALANTAKA, KOTA SERANG, BANTEN",27,70,184,254
https://kawalpemilu.org#53144,"PIPITAN, WALANTAKA, KOTA SERANG, BANTEN",28,38,177,215
https://kawalpemilu.org#53144,"PIPITAN, WALANTAKA, KOTA SERANG, BANTEN",29,34,174,208
https://kawalpemilu.org#53144,"PIPITAN, WALANTAKA, KOTA SERANG, BANTEN",30,43,97,140
https://kawalpemilu.org#53144,"PIPITAN, WALANTAKA, KOTA SERANG, BANTEN",31,46,78,124
https://kawalpemilu.org#53145,"LEBAKWANGI, WALANTAKA, KOTA SERANG, BANTEN",1,43,201,244
https://kawalpemilu.org#53145,"LEBAKWANGI, WALANTAKA, KOTA SERANG, BANTEN",2,47,202,249
https://kawalpemilu.org#53145,"LEBAKWANGI, WALANTAKA, KOTA SERANG, BANTEN",3,52,155,207
https://kawalpemilu.org#53145,"LEBAKWANGI, WALANTAKA, KOTA SERANG, BANTEN",4,53,162,215
https://kawalpemilu.org#53145,"LEBAKWANGI, WALANTAKA, KOTA SERANG, BANTEN",5,75,167,242
https://kawalpemilu.org#53145,"LEBAKWANGI, WALANTAKA, KOTA SERANG, BANTEN",6,82,153,235
https://kawalpemilu.org#53145,"LEBAKWANGI, WALANTAKA, KOTA SERANG, BANTEN",7,84,167,251
https://kawalpemilu.org#53145,"LEBAKWANGI, WALANTAKA, KOTA SERANG, BANTEN",8,41,205,246
https://kawalpemilu.org#53145,"LEBAKWANGI, WALANTAKA, KOTA SERANG, BANTEN",9,57,172,229
https://kawalpemilu.org#53147,"CURUG, CURUG, KOTA SERANG, BANTEN",1,54,170,224
https://kawalpemilu.org#53147,"CURUG, CURUG, KOTA SERANG, BANTEN",2,72,138,210
https://kawalpemilu.org#53147,"CURUG, CURUG, KOTA SERANG, BANTEN",3,43,121,164
https://kawalpemilu.org#53147,"CURUG, CURUG, KOTA SERANG, BANTEN",4,101,142,243
https://kawalpemilu.org#53147,"CURUG, CURUG, KOTA SERANG, BANTEN",5,39,110,149
https://kawalpemilu.org#53147,"CURUG, CURUG, KOTA SERANG, BANTEN",6,21,117,138
https://kawalpemilu.org#53147,"CURUG, CURUG, KOTA SERANG, BANTEN",7,40,91,131
https://kawalpemilu.org#53147,"CURUG, CURUG, KOTA SERANG, BANTEN",8,78,126,204
https://kawalpemilu.org#53147,"CURUG, CURUG, KOTA SERANG, BANTEN",9,68,152,220
https://kawalpemilu.org#53147,"CURUG, CURUG, KOTA SERANG, BANTEN",10,64,87,151
https://kawalpemilu.org#53147,"CURUG, CURUG, KOTA SERANG, BANTEN",11,47,205,252
https://kawalpemilu.org#53147,"CURUG, CURUG, KOTA SERANG, BANTEN",12,52,138,190
https://kawalpemilu.org#53147,"CURUG, CURUG, KOTA SERANG, BANTEN",13,73,134,207
https://kawalpemilu.org#53147,"CURUG, CURUG, KOTA SERANG, BANTEN",14,49,140,189
https://kawalpemilu.org#53148,"TINGGAR, CURUG, KOTA SERANG, BANTEN",1,62,154,216
https://kawalpemilu.org#53148,"TINGGAR, CURUG, KOTA SERANG, BANTEN",2,44,139,183
https://kawalpemilu.org#53148,"TINGGAR, CURUG, KOTA SERANG, BANTEN",3,79,124,203
https://kawalpemilu.org#53148,"TINGGAR, CURUG, KOTA SERANG, BANTEN",4,112,102,214
https://kawalpemilu.org#53148,"TINGGAR, CURUG, KOTA SERANG, BANTEN",5,36,130,166
https://kawalpemilu.org#53148,"TINGGAR, CURUG, KOTA SERANG, BANTEN",6,94,115,209
https://kawalpemilu.org#53148,"TINGGAR, CURUG, KOTA SERANG, BANTEN",7,83,128,211
https://kawalpemilu.org#53148,"TINGGAR, CURUG, KOTA SERANG, BANTEN",8,60,124,184
https://kawalpemilu.org#53148,"TINGGAR, CURUG, KOTA SERANG, BANTEN",9,81,110,191
https://kawalpemilu.org#53148,"TINGGAR, CURUG, KOTA SERANG, BANTEN",10,102,139,241
https://kawalpemilu.org#53148,"TINGGAR, CURUG, KOTA SERANG, BANTEN",11,74,126,200
https://kawalpemilu.org#53148,"TINGGAR, CURUG, KOTA SERANG, BANTEN",12,24,76,100
https://kawalpemilu.org#53148,"TINGGAR, CURUG, KOTA SERANG, BANTEN",13,24,181,205
https://kawalpemilu.org#53148,"TINGGAR, CURUG, KOTA SERANG, BANTEN",14,65,144,209
https://kawalpemilu.org#53148,"TINGGAR, CURUG, KOTA SERANG, BANTEN",15,46,107,153
https://kawalpemilu.org#53148,"TINGGAR, CURUG, KOTA SERANG, BANTEN",16,38,154,192
https://kawalpemilu.org#53148,"TINGGAR, CURUG, KOTA SERANG, BANTEN",17,37,97,134
https://kawalpemilu.org#53148,"TINGGAR, CURUG, KOTA SERANG, BANTEN",18,46,103,149
https://kawalpemilu.org#53148,"TINGGAR, CURUG, KOTA SERANG, BANTEN",19,68,93,161
https://kawalpemilu.org#53149,"KEMANISAN, CURUG, KOTA SERANG, BANTEN",1,43,168,211
https://kawalpemilu.org#53149,"KEMANISAN, CURUG, KOTA SERANG, BANTEN",2,66,183,249
https://kawalpemilu.org#53149,"KEMANISAN, CURUG, KOTA SERANG, BANTEN",3,70,159,229
https://kawalpemilu.org#53149,"KEMANISAN, CURUG, KOTA SERANG, BANTEN",4,73,146,219
https://kawalpemilu.org#53149,"KEMANISAN, CURUG, KOTA SERANG, BANTEN",5,88,105,193
https://kawalpemilu.org#53149,"KEMANISAN, CURUG, KOTA SERANG, BANTEN",6,53,125,178
https://kawalpemilu.org#53149,"KEMANISAN, CURUG, KOTA SERANG, BANTEN",7,40,125,165
https://kawalpemilu.org#53149,"KEMANISAN, CURUG, KOTA SERANG, BANTEN",8,44,125,169
https://kawalpemilu.org#53149,"KEMANISAN, CURUG, KOTA SERANG, BANTEN",9,102,117,219
https://kawalpemilu.org#53149,"KEMANISAN, CURUG, KOTA SERANG, BANTEN",10,96,125,221
https://kawalpemilu.org#53149,"KEMANISAN, CURUG, KOTA SERANG, BANTEN",11,94,142,236
https://kawalpemilu.org#53149,"KEMANISAN, CURUG, KOTA SERANG, BANTEN",12,57,119,176
https://kawalpemilu.org#53149,"KEMANISAN, CURUG, KOTA SERANG, BANTEN",13,92,150,242
https://kawalpemilu.org#53149,"KEMANISAN, CURUG, KOTA SERANG, BANTEN",14,73,169,242
https://kawalpemilu.org#53149,"KEMANISAN, CURUG, KOTA SERANG, BANTEN",15,80,85,165
https://kawalpemilu.org#53149,"KEMANISAN, CURUG, KOTA SERANG, BANTEN",16,71,162,233
https://kawalpemilu.org#53149,"KEMANISAN, CURUG, KOTA SERANG, BANTEN",17,40,170,210
https://kawalpemilu.org#53149,"KEMANISAN, CURUG, KOTA SERANG, BANTEN",18,68,97,165
https://kawalpemilu.org#53149,"KEMANISAN, CURUG, KOTA SERANG, BANTEN",19,78,147,225
https://kawalpemilu.org#53149,"KEMANISAN, CURUG, KOTA SERANG, BANTEN",20,117,54,171
https://kawalpemilu.org#53149,"KEMANISAN, CURUG, KOTA SERANG, BANTEN",21,87,63,150
https://kawalpemilu.org#53149,"KEMANISAN, CURUG, KOTA SERANG, BANTEN",22,137,121,258
https://kawalpemilu.org#53149,"KEMANISAN, CURUG, KOTA SERANG, BANTEN",23,91,122,213
https://kawalpemilu.org#53150,"CIPETE, CURUG, KOTA SERANG, BANTEN",1,60,76,136
https://kawalpemilu.org#53150,"CIPETE, CURUG, KOTA SERANG, BANTEN",2,46,89,135
https://kawalpemilu.org#53150,"CIPETE, CURUG, KOTA SERANG, BANTEN",3,105,38,143
https://kawalpemilu.org#53150,"CIPETE, CURUG, KOTA SERANG, BANTEN",4,86,44,130
https://kawalpemilu.org#53150,"CIPETE, CURUG, KOTA SERANG, BANTEN",5,54,87,141
https://kawalpemilu.org#53150,"CIPETE, CURUG, KOTA SERANG, BANTEN",6,48,95,143
https://kawalpemilu.org#53150,"CIPETE, CURUG, KOTA SERANG, BANTEN",7,93,69,162
https://kawalpemilu.org#53150,"CIPETE, CURUG, KOTA SERANG, BANTEN",8,83,82,165
https://kawalpemilu.org#53150,"CIPETE, CURUG, KOTA SERANG, BANTEN",9,75,66,141
https://kawalpemilu.org#53150,"CIPETE, CURUG, KOTA SERANG, BANTEN",10,99,76,175
https://kawalpemilu.org#53150,"CIPETE, CURUG, KOTA SERANG, BANTEN",11,108,59,167
https://kawalpemilu.org#53150,"CIPETE, CURUG, KOTA SERANG, BANTEN",12,93,60,153
https://kawalpemilu.org#53150,"CIPETE, CURUG, KOTA SERANG, BANTEN",13,48,104,152
https://kawalpemilu.org#53150,"CIPETE, CURUG, KOTA SERANG, BANTEN",14,61,101,162
https://kawalpemilu.org#53150,"CIPETE, CURUG, KOTA SERANG, BANTEN",15,51,80,131
https://kawalpemilu.org#53150,"CIPETE, CURUG, KOTA SERANG, BANTEN",16,45,114,159
https://kawalpemilu.org#53150,"CIPETE, CURUG, KOTA SERANG, BANTEN",17,67,102,169
https://kawalpemilu.org#53150,"CIPETE, CURUG, KOTA SERANG, BANTEN",18,49,38,87
https://kawalpemilu.org#53151,"CILAKU, CURUG, KOTA SERANG, BANTEN",1,58,161,219
https://kawalpemilu.org#53151,"CILAKU, CURUG, KOTA SERANG, BANTEN",2,65,165,230
https://kawalpemilu.org#53151,"CILAKU, CURUG, KOTA SERANG, BANTEN",3,73,155,228
https://kawalpemilu.org#53151,"CILAKU, CURUG, KOTA SERANG, BANTEN",4,39,202,241
https://kawalpemilu.org#53151,"CILAKU, CURUG, KOTA SERANG, BANTEN",5,70,148,218
https://kawalpemilu.org#53151,"CILAKU, CURUG, KOTA SERANG, BANTEN",6,71,166,237
https://kawalpemilu.org#53151,"CILAKU, CURUG, KOTA SERANG, BANTEN",7,78,193,271
https://kawalpemilu.org#53151,"CILAKU, CURUG, KOTA SERANG, BANTEN",8,61,194,255
https://kawalpemilu.org#53151,"CILAKU, CURUG, KOTA SERANG, BANTEN",9,57,149,206
https://kawalpemilu.org#53151,"CILAKU, CURUG, KOTA SERANG, BANTEN",10,63,169,232
https://kawalpemilu.org#53151,"CILAKU, CURUG, KOTA SERANG, BANTEN",11,63,155,218
https://kawalpemilu.org#53151,"CILAKU, CURUG, KOTA SERANG, BANTEN",12,53,146,199
https://kawalpemilu.org#53151,"CILAKU, CURUG, KOTA SERANG, BANTEN",13,63,140,203
https://kawalpemilu.org#53151,"CILAKU, CURUG, KOTA SERANG, BANTEN",14,49,191,240
https://kawalpemilu.org#53151,"CILAKU, CURUG, KOTA SERANG, BANTEN",15,74,142,216
https://kawalpemilu.org#53151,"CILAKU, CURUG, KOTA SERANG, BANTEN",16,47,171,218
https://kawalpemilu.org#53151,"CILAKU, CURUG, KOTA SERANG, BANTEN",17,72,138,210
https://kawalpemilu.org#53151,"CILAKU, CURUG, KOTA SERANG, BANTEN",18,79,149,228
https://kawalpemilu.org#53151,"CILAKU, CURUG, KOTA SERANG, BANTEN",19,91,154,245
https://kawalpemilu.org#53151,"CILAKU, CURUG, KOTA SERANG, BANTEN",20,79,161,240
https://kawalpemilu.org#53151,"CILAKU, CURUG, KOTA SERANG, BANTEN",21,52,177,229
https://kawalpemilu.org#53151,"CILAKU, CURUG, KOTA SERANG, BANTEN",22,67,142,209
https://kawalpemilu.org#53152,"PANCALAKSANA, CURUG, KOTA SERANG, BANTEN",1,44,187,231
https://kawalpemilu.org#53152,"PANCALAKSANA, CURUG, KOTA SERANG, BANTEN",2,50,159,209
https://kawalpemilu.org#53152,"PANCALAKSANA, CURUG, KOTA SERANG, BANTEN",3,38,136,174
https://kawalpemilu.org#53152,"PANCALAKSANA, CURUG, KOTA SERANG, BANTEN",4,62,103,165
https://kawalpemilu.org#53152,"PANCALAKSANA, CURUG, KOTA SERANG, BANTEN",5,30,122,152
https://kawalpemilu.org#53152,"PANCALAKSANA, CURUG, KOTA SERANG, BANTEN",6,44,116,160
https://kawalpemilu.org#53152,"PANCALAKSANA, CURUG, KOTA SERANG, BANTEN",7,79,127,206
https://kawalpemilu.org#53152,"PANCALAKSANA, CURUG, KOTA SERANG, BANTEN",8,94,112,206
https://kawalpemilu.org#53152,"PANCALAKSANA, CURUG, KOTA SERANG, BANTEN",9,88,49,137
https://kawalpemilu.org#53152,"PANCALAKSANA, CURUG, KOTA SERANG, BANTEN",10,57,185,242
https://kawalpemilu.org#53152,"PANCALAKSANA, CURUG, KOTA SERANG, BANTEN",11,64,167,231
https://kawalpemilu.org#53152,"PANCALAKSANA, CURUG, KOTA SERANG, BANTEN",12,68,176,244
https://kawalpemilu.org#53152,"PANCALAKSANA, CURUG, KOTA SERANG, BANTEN",13,91,172,263
https://kawalpemilu.org#53152,"PANCALAKSANA, CURUG, KOTA SERANG, BANTEN",14,69,153,222
https://kawalpemilu.org#53152,"PANCALAKSANA, CURUG, KOTA SERANG, BANTEN",15,63,136,199
https://kawalpemilu.org#53153,"SUKAWANA, CURUG, KOTA SERANG, BANTEN",1,53,199,252
https://kawalpemilu.org#53153,"SUKAWANA, CURUG, KOTA SERANG, BANTEN",2,35,227,262
https://kawalpemilu.org#53153,"SUKAWANA, CURUG, KOTA SERANG, BANTEN",3,44,120,164
https://kawalpemilu.org#53153,"SUKAWANA, CURUG, KOTA SERANG, BANTEN",4,22,151,173
https://kawalpemilu.org#53153,"SUKAWANA, CURUG, KOTA SERANG, BANTEN",6,68,199,267
https://kawalpemilu.org#53153,"SUKAWANA, CURUG, KOTA SERANG, BANTEN",7,76,135,211
https://kawalpemilu.org#53153,"SUKAWANA, CURUG, KOTA SERANG, BANTEN",8,69,140,209
https://kawalpemilu.org#53153,"SUKAWANA, CURUG, KOTA SERANG, BANTEN",9,79,180,259
https://kawalpemilu.org#53153,"SUKAWANA, CURUG, KOTA SERANG, BANTEN",10,127,115,242
https://kawalpemilu.org#53153,"SUKAWANA, CURUG, KOTA SERANG, BANTEN",11,68,157,225
https://kawalpemilu.org#53153,"SUKAWANA, CURUG, KOTA SERANG, BANTEN",12,29,92,121
https://kawalpemilu.org#53154,"SUKALAKSANA, CURUG, KOTA SERANG, BANTEN",1,82,108,190
https://kawalpemilu.org#53154,"SUKALAKSANA, CURUG, KOTA SERANG, BANTEN",2,100,92,192
https://kawalpemilu.org#53154,"SUKALAKSANA, CURUG, KOTA SERANG, BANTEN",3,61,126,187
https://kawalpemilu.org#53154,"SUKALAKSANA, CURUG, KOTA SERANG, BANTEN",4,117,139,256
https://kawalpemilu.org#53154,"SUKALAKSANA, CURUG, KOTA SERANG, BANTEN",5,34,171,205
https://kawalpemilu.org#53154,"SUKALAKSANA, CURUG, KOTA SERANG, BANTEN",6,71,150,221
https://kawalpemilu.org#53154,"SUKALAKSANA, CURUG, KOTA SERANG, BANTEN",7,66,90,156
https://kawalpemilu.org#53154,"SUKALAKSANA, CURUG, KOTA SERANG, BANTEN",8,56,135,191
https://kawalpemilu.org#53154,"SUKALAKSANA, CURUG, KOTA SERANG, BANTEN",9,94,141,235
https://kawalpemilu.org#53154,"SUKALAKSANA, CURUG, KOTA SERANG, BANTEN",10,46,143,189
https://kawalpemilu.org#53154,"SUKALAKSANA, CURUG, KOTA SERANG, BANTEN",11,79,165,244
https://kawalpemilu.org#53154,"SUKALAKSANA, CURUG, KOTA SERANG, BANTEN",12,29,104,133
https://kawalpemilu.org#53154,"SUKALAKSANA, CURUG, KOTA SERANG, BANTEN",13,37,99,136
https://kawalpemilu.org#53154,"SUKALAKSANA, CURUG, KOTA SERANG, BANTEN",14,99,112,211
https://kawalpemilu.org#53154,"SUKALAKSANA, CURUG, KOTA SERANG, BANTEN",15,33,89,122
https://kawalpemilu.org#53154,"SUKALAKSANA, CURUG, KOTA SERANG, BANTEN",16,70,87,157
https://kawalpemilu.org#53154,"SUKALAKSANA, CURUG, KOTA SERANG, BANTEN",17,50,71,121
https://kawalpemilu.org#53155,"CURUG MANIS, CURUG, KOTA SERANG, BANTEN",1,48,193,241
https://kawalpemilu.org#53155,"CURUG MANIS, CURUG, KOTA SERANG, BANTEN",2,37,139,176
https://kawalpemilu.org#53155,"CURUG MANIS, CURUG, KOTA SERANG, BANTEN",3,48,104,152
https://kawalpemilu.org#53155,"CURUG MANIS, CURUG, KOTA SERANG, BANTEN",4,52,80,132
https://kawalpemilu.org#53155,"CURUG MANIS, CURUG, KOTA SERANG, BANTEN",5,57,187,244
https://kawalpemilu.org#53155,"CURUG MANIS, CURUG, KOTA SERANG, BANTEN",6,89,75,164
https://kawalpemilu.org#53155,"CURUG MANIS, CURUG, KOTA SERANG, BANTEN",7,79,76,155
https://kawalpemilu.org#53155,"CURUG MANIS, CURUG, KOTA SERANG, BANTEN",8,73,98,171
https://kawalpemilu.org#53155,"CURUG MANIS, CURUG, KOTA SERANG, BANTEN",9,54,136,190
https://kawalpemilu.org#53155,"CURUG MANIS, CURUG, KOTA SERANG, BANTEN",10,41,129,170
https://kawalpemilu.org#53155,"CURUG MANIS, CURUG, KOTA SERANG, BANTEN",11,27,124,201
https://kawalpemilu.org#53155,"CURUG MANIS, CURUG, KOTA SERANG, BANTEN",12,102,111,213
https://kawalpemilu.org#53155,"CURUG MANIS, CURUG, KOTA SERANG, BANTEN",13,60,114,174
https://kawalpemilu.org#53155,"CURUG MANIS, CURUG, KOTA SERANG, BANTEN",14,74,126,200
https://kawalpemilu.org#53155,"CURUG MANIS, CURUG, KOTA SERANG, BANTEN",15,70,116,186
https://kawalpemilu.org#53155,"CURUG MANIS, CURUG, KOTA SERANG, BANTEN",16,54,89,143
https://kawalpemilu.org#53156,"SUKAJAYA, CURUG, KOTA SERANG, BANTEN",1,48,225,273
https://kawalpemilu.org#53156,"SUKAJAYA, CURUG, KOTA SERANG, BANTEN",2,62,149,211
https://kawalpemilu.org#53156,"SUKAJAYA, CURUG, KOTA SERANG, BANTEN",3,83,179,262
https://kawalpemilu.org#53156,"SUKAJAYA, CURUG, KOTA SERANG, BANTEN",4,78,168,246
https://kawalpemilu.org#53156,"SUKAJAYA, CURUG, KOTA SERANG, BANTEN",5,52,196,248
https://kawalpemilu.org#53156,"SUKAJAYA, CURUG, KOTA SERANG, BANTEN",6,51,199,250
https://kawalpemilu.org#53156,"SUKAJAYA, CURUG, KOTA SERANG, BANTEN",7,49,197,246
https://kawalpemilu.org#53156,"SUKAJAYA, CURUG, KOTA SERANG, BANTEN",8,50,214,264
https://kawalpemilu.org#53156,"SUKAJAYA, CURUG, KOTA SERANG, BANTEN",9,38,235,274
https://kawalpemilu.org#53156,"SUKAJAYA, CURUG, KOTA SERANG, BANTEN",10,34,140,174
https://kawalpemilu.org#53156,"SUKAJAYA, CURUG, KOTA SERANG, BANTEN",11,24,138,162
https://kawalpemilu.org#53156,"SUKAJAYA, CURUG, KOTA SERANG, BANTEN",12,48,129,177
https://kawalpemilu.org#53158,"CIPOCOK JAYA, CIPOCOK JAYA, KOTA SERANG, BANTEN",1,63,201,264
https://kawalpemilu.org#53158,"CIPOCOK JAYA, CIPOCOK JAYA, KOTA SERANG, BANTEN",2,58,181,239
https://kawalpemilu.org#53158,"CIPOCOK JAYA, CIPOCOK JAYA, KOTA SERANG, BANTEN",3,54,147,201
https://kawalpemilu.org#53158,"CIPOCOK JAYA, CIPOCOK JAYA, KOTA SERANG, BANTEN",4,95,170,265
https://kawalpemilu.org#53158,"CIPOCOK JAYA, CIPOCOK JAYA, KOTA SERANG, BANTEN",5,64,140,204
https://kawalpemilu.org#53158,"CIPOCOK JAYA, CIPOCOK JAYA, KOTA SERANG, BANTEN",6,82,139,221
https://kawalpemilu.org#53158,"CIPOCOK JAYA, CIPOCOK JAYA, KOTA SERANG, BANTEN",7,47,215,263
https://kawalpemilu.org#53158,"CIPOCOK JAYA, CIPOCOK JAYA, KOTA SERANG, BANTEN",8,63,167,230
https://kawalpemilu.org#53158,"CIPOCOK JAYA, CIPOCOK JAYA, KOTA SERANG, BANTEN",9,80,120,200
https://kawalpemilu.org#53158,"CIPOCOK JAYA, CIPOCOK JAYA, KOTA SERANG, BANTEN",10,85,155,240
https://kawalpemilu.org#53158,"CIPOCOK JAYA, CIPOCOK JAYA, KOTA SERANG, BANTEN",11,95,132,227
https://kawalpemilu.org#53158,"CIPOCOK JAYA, CIPOCOK JAYA, KOTA SERANG, BANTEN",12,39,124,163
https://kawalpemilu.org#53158,"CIPOCOK JAYA, CIPOCOK JAYA, KOTA SERANG, BANTEN",13,41,120,161
https://kawalpemilu.org#53158,"CIPOCOK JAYA, CIPOCOK JAYA, KOTA SERANG, BANTEN",14,81,215,296
https://kawalpemilu.org#53158,"CIPOCOK JAYA, CIPOCOK JAYA, KOTA SERANG, BANTEN",15,56,199,255
https://kawalpemilu.org#53158,"CIPOCOK JAYA, CIPOCOK JAYA, KOTA SERANG, BANTEN",16,42,217,259
https://kawalpemilu.org#53158,"CIPOCOK JAYA, CIPOCOK JAYA, KOTA SERANG, BANTEN",17,43,232,275
https://kawalpemilu.org#53158,"CIPOCOK JAYA, CIPOCOK JAYA, KOTA SERANG, BANTEN",18,66,184,250
https://kawalpemilu.org#53158,"CIPOCOK JAYA, CIPOCOK JAYA, KOTA SERANG, BANTEN",19,31,173,204
https://kawalpemilu.org#53158,"CIPOCOK JAYA, CIPOCOK JAYA, KOTA SERANG, BANTEN",20,38,153,191
https://kawalpemilu.org#53158,"CIPOCOK JAYA, CIPOCOK JAYA, KOTA SERANG, BANTEN",21,37,139,176
https://kawalpemilu.org#53158,"CIPOCOK JAYA, CIPOCOK JAYA, KOTA SERANG, BANTEN",22,49,145,194
https://kawalpemilu.org#53158,"CIPOCOK JAYA, CIPOCOK JAYA, KOTA SERANG, BANTEN",23,83,140,223
https://kawalpemilu.org#53158,"CIPOCOK JAYA, CIPOCOK JAYA, KOTA SERANG, BANTEN",24,98,120,218
https://kawalpemilu.org#53158,"CIPOCOK JAYA, CIPOCOK JAYA, KOTA SERANG, BANTEN",25,86,174,260
https://kawalpemilu.org#53158,"CIPOCOK JAYA, CIPOCOK JAYA, KOTA SERANG, BANTEN",26,61,210,271
https://kawalpemilu.org#53158,"CIPOCOK JAYA, CIPOCOK JAYA, KOTA SERANG, BANTEN",27,59,164,223
https://kawalpemilu.org#53158,"CIPOCOK JAYA, CIPOCOK JAYA, KOTA SERANG, BANTEN",28,73,183,256
https://kawalpemilu.org#53158,"CIPOCOK JAYA, CIPOCOK JAYA, KOTA SERANG, BANTEN",29,80,151,231
https://kawalpemilu.org#53158,"CIPOCOK JAYA, CIPOCOK JAYA, KOTA SERANG, BANTEN",30,100,177,277
https://kawalpemilu.org#53158,"CIPOCOK JAYA, CIPOCOK JAYA, KOTA SERANG, BANTEN",31,46,136,182
https://kawalpemilu.org#53158,"CIPOCOK JAYA, CIPOCOK JAYA, KOTA SERANG, BANTEN",32,44,131,175
https://kawalpemilu.org#53158,"CIPOCOK JAYA, CIPOCOK JAYA, KOTA SERANG, BANTEN",33,25,145,170
https://kawalpemilu.org#53158,"CIPOCOK JAYA, CIPOCOK JAYA, KOTA SERANG, BANTEN",34,48,132,180
https://kawalpemilu.org#53158,"CIPOCOK JAYA, CIPOCOK JAYA, KOTA SERANG, BANTEN",35,71,157,228
https://kawalpemilu.org#53158,"CIPOCOK JAYA, CIPOCOK JAYA, KOTA SERANG, BANTEN",36,69,152,221
https://kawalpemilu.org#53158,"CIPOCOK JAYA, CIPOCOK JAYA, KOTA SERANG, BANTEN",37,50,119,169
https://kawalpemilu.org#53158,"CIPOCOK JAYA, CIPOCOK JAYA, KOTA SERANG, BANTEN",38,31,138,169
https://kawalpemilu.org#53159,"KARUNDANG, CIPOCOK JAYA, KOTA SERANG, BANTEN",1,106,99,205
https://kawalpemilu.org#53159,"KARUNDANG, CIPOCOK JAYA, KOTA SERANG, BANTEN",2,95,95,190
https://kawalpemilu.org#53159,"KARUNDANG, CIPOCOK JAYA, KOTA SERANG, BANTEN",3,56,126,182
https://kawalpemilu.org#53159,"KARUNDANG, CIPOCOK JAYA, KOTA SERANG, BANTEN",4,33,121,151
https://kawalpemilu.org#53159,"KARUNDANG, CIPOCOK JAYA, KOTA SERANG, BANTEN",5,75,162,237
https://kawalpemilu.org#53159,"KARUNDANG, CIPOCOK JAYA, KOTA SERANG, BANTEN",6,50,178,228
https://kawalpemilu.org#53159,"KARUNDANG, CIPOCOK JAYA, KOTA SERANG, BANTEN",7,34,156,190
https://kawalpemilu.org#53159,"KARUNDANG, CIPOCOK JAYA, KOTA SERANG, BANTEN",8,32,117,149
https://kawalpemilu.org#53159,"KARUNDANG, CIPOCOK JAYA, KOTA SERANG, BANTEN",9,42,175,217
https://kawalpemilu.org#53159,"KARUNDANG, CIPOCOK JAYA, KOTA SERANG, BANTEN",10,46,134,180
https://kawalpemilu.org#53159,"KARUNDANG, CIPOCOK JAYA, KOTA SERANG, BANTEN",11,44,186,230
https://kawalpemilu.org#53159,"KARUNDANG, CIPOCOK JAYA, KOTA SERANG, BANTEN",12,51,128,179
https://kawalpemilu.org#53159,"KARUNDANG, CIPOCOK JAYA, KOTA SERANG, BANTEN",13,55,219,274
https://kawalpemilu.org#53159,"KARUNDANG, CIPOCOK JAYA, KOTA SERANG, BANTEN",14,34,191,225
https://kawalpemilu.org#53159,"KARUNDANG, CIPOCOK JAYA, KOTA SERANG, BANTEN",15,88,150,238
https://kawalpemilu.org#53159,"KARUNDANG, CIPOCOK JAYA, KOTA SERANG, BANTEN",16,77,136,213
https://kawalpemilu.org#53159,"KARUNDANG, CIPOCOK JAYA, KOTA SERANG, BANTEN",17,76,138,214
https://kawalpemilu.org#53159,"KARUNDANG, CIPOCOK JAYA, KOTA SERANG, BANTEN",18,115,114,229
https://kawalpemilu.org#53159,"KARUNDANG, CIPOCOK JAYA, KOTA SERANG, BANTEN",19,87,180,267
https://kawalpemilu.org#53159,"KARUNDANG, CIPOCOK JAYA, KOTA SERANG, BANTEN",20,84,163,247
https://kawalpemilu.org#53159,"KARUNDANG, CIPOCOK JAYA, KOTA SERANG, BANTEN",21,76,136,214
https://kawalpemilu.org#53159,"KARUNDANG, CIPOCOK JAYA, KOTA SERANG, BANTEN",22,81,151,232
https://kawalpemilu.org#53159,"KARUNDANG, CIPOCOK JAYA, KOTA SERANG, BANTEN",23,26,96,122
https://kawalpemilu.org#53159,"KARUNDANG, CIPOCOK JAYA, KOTA SERANG, BANTEN",24,58,63,121
https://kawalpemilu.org#53159,"KARUNDANG, CIPOCOK JAYA, KOTA SERANG, BANTEN",25,47,94,141
https://kawalpemilu.org#53159,"KARUNDANG, CIPOCOK JAYA, KOTA SERANG, BANTEN",26,53,57,110
https://kawalpemilu.org#53159,"KARUNDANG, CIPOCOK JAYA, KOTA SERANG, BANTEN",27,69,74,143
https://kawalpemilu.org#53160,"PANANCANGAN, CIPOCOK JAYA, KOTA SERANG, BANTEN",1,97,151,248
https://kawalpemilu.org#53160,"PANANCANGAN, CIPOCOK JAYA, KOTA SERANG, BANTEN",2,67,192,259
https://kawalpemilu.org#53160,"PANANCANGAN, CIPOCOK JAYA, KOTA SERANG, BANTEN",3,57,154,211
https://kawalpemilu.org#53160,"PANANCANGAN, CIPOCOK JAYA, KOTA SERANG, BANTEN",4,62,190,252
https://kawalpemilu.org#53160,"PANANCANGAN, CIPOCOK JAYA, KOTA SERANG, BANTEN",5,47,180,227
https://kawalpemilu.org#53160,"PANANCANGAN, CIPOCOK JAYA, KOTA SERANG, BANTEN",6,57,157,214
https://kawalpemilu.org#53160,"PANANCANGAN, CIPOCOK JAYA, KOTA SERANG, BANTEN",7,51,156,207
https://kawalpemilu.org#53160,"PANANCANGAN, CIPOCOK JAYA, KOTA SERANG, BANTEN",8,73,144,217
https://kawalpemilu.org#53160,"PANANCANGAN, CIPOCOK JAYA, KOTA SERANG, BANTEN",9,69,193,262
https://kawalpemilu.org#53160,"PANANCANGAN, CIPOCOK JAYA, KOTA SERANG, BANTEN",10,73,183,256
https://kawalpemilu.org#53160,"PANANCANGAN, CIPOCOK JAYA, KOTA SERANG, BANTEN",11,45,191,236
https://kawalpemilu.org#53160,"PANANCANGAN, CIPOCOK JAYA, KOTA SERANG, BANTEN",12,73,131,204
https://kawalpemilu.org#53160,"PANANCANGAN, CIPOCOK JAYA, KOTA SERANG, BANTEN",13,44,187,231
https://kawalpemilu.org#53160,"PANANCANGAN, CIPOCOK JAYA, KOTA SERANG, BANTEN",14,97,173,270
https://kawalpemilu.org#53160,"PANANCANGAN, CIPOCOK JAYA, KOTA SERANG, BANTEN",15,62,136,198
https://kawalpemilu.org#53160,"PANANCANGAN, CIPOCOK JAYA, KOTA SERANG, BANTEN",16,90,115,205
https://kawalpemilu.org#53160,"PANANCANGAN, CIPOCOK JAYA, KOTA SERANG, BANTEN",17,47,210,257
https://kawalpemilu.org#53160,"PANANCANGAN, CIPOCOK JAYA, KOTA SERANG, BANTEN",18,72,178,250
https://kawalpemilu.org#53160,"PANANCANGAN, CIPOCOK JAYA, KOTA SERANG, BANTEN",19,57,206,263
https://kawalpemilu.org#53160,"PANANCANGAN, CIPOCOK JAYA, KOTA SERANG, BANTEN",20,75,166,241
https://kawalpemilu.org#53160,"PANANCANGAN, CIPOCOK JAYA, KOTA SERANG, BANTEN",21,102,151,253
https://kawalpemilu.org#53160,"PANANCANGAN, CIPOCOK JAYA, KOTA SERANG, BANTEN",22,101,164,265
https://kawalpemilu.org#53160,"PANANCANGAN, CIPOCOK JAYA, KOTA SERANG, BANTEN",23,55,187,242
https://kawalpemilu.org#53160,"PANANCANGAN, CIPOCOK JAYA, KOTA SERANG, BANTEN",24,52,188,240
https://kawalpemilu.org#53160,"PANANCANGAN, CIPOCOK JAYA, KOTA SERANG, BANTEN",25,86,161,247
https://kawalpemilu.org#53160,"PANANCANGAN, CIPOCOK JAYA, KOTA SERANG, BANTEN",26,70,193,263
https://kawalpemilu.org#53160,"PANANCANGAN, CIPOCOK JAYA, KOTA SERANG, BANTEN",27,79,161,240
https://kawalpemilu.org#53160,"PANANCANGAN, CIPOCOK JAYA, KOTA SERANG, BANTEN",28,90,164,254
https://kawalpemilu.org#53160,"PANANCANGAN, CIPOCOK JAYA, KOTA SERANG, BANTEN",29,0,0,0
https://kawalpemilu.org#53160,"PANANCANGAN, CIPOCOK JAYA, KOTA SERANG, BANTEN",30,67,167,234
https://kawalpemilu.org#53160,"PANANCANGAN, CIPOCOK JAYA, KOTA SERANG, BANTEN",31,68,176,244
https://kawalpemilu.org#53160,"PANANCANGAN, CIPOCOK JAYA, KOTA SERANG, BANTEN",32,70,179,249
https://kawalpemilu.org#53160,"PANANCANGAN, CIPOCOK JAYA, KOTA SERANG, BANTEN",33,33,88,121
https://kawalpemilu.org#53161,"BANJAR AGUNG, CIPOCOK JAYA, KOTA SERANG, BANTEN",1,98,139,237
https://kawalpemilu.org#53161,"BANJAR AGUNG, CIPOCOK JAYA, KOTA SERANG, BANTEN",2,56,184,240
https://kawalpemilu.org#53161,"BANJAR AGUNG, CIPOCOK JAYA, KOTA SERANG, BANTEN",3,54,160,214
https://kawalpemilu.org#53161,"BANJAR AGUNG, CIPOCOK JAYA, KOTA SERANG, BANTEN",4,59,180,239
https://kawalpemilu.org#53161,"BANJAR AGUNG, CIPOCOK JAYA, KOTA SERANG, BANTEN",5,53,177,230
https://kawalpemilu.org#53161,"BANJAR AGUNG, CIPOCOK JAYA, KOTA SERANG, BANTEN",6,79,188,267
https://kawalpemilu.org#53161,"BANJAR AGUNG, CIPOCOK JAYA, KOTA SERANG, BANTEN",7,65,156,221
https://kawalpemilu.org#53161,"BANJAR AGUNG, CIPOCOK JAYA, KOTA SERANG, BANTEN",8,87,143,230
https://kawalpemilu.org#53161,"BANJAR AGUNG, CIPOCOK JAYA, KOTA SERANG, BANTEN",9,65,123,188
https://kawalpemilu.org#53161,"BANJAR AGUNG, CIPOCOK JAYA, KOTA SERANG, BANTEN",10,92,147,239
https://kawalpemilu.org#53161,"BANJAR AGUNG, CIPOCOK JAYA, KOTA SERANG, BANTEN",11,49,184,233
https://kawalpemilu.org#53161,"BANJAR AGUNG, CIPOCOK JAYA, KOTA SERANG, BANTEN",12,93,139,232
https://kawalpemilu.org#53161,"BANJAR AGUNG, CIPOCOK JAYA, KOTA SERANG, BANTEN",13,66,130,196
https://kawalpemilu.org#53161,"BANJAR AGUNG, CIPOCOK JAYA, KOTA SERANG, BANTEN",14,105,153,253
https://kawalpemilu.org#53161,"BANJAR AGUNG, CIPOCOK JAYA, KOTA SERANG, BANTEN",15,113,141,254
https://kawalpemilu.org#53161,"BANJAR AGUNG, CIPOCOK JAYA, KOTA SERANG, BANTEN",16,85,148,233
https://kawalpemilu.org#53161,"BANJAR AGUNG, CIPOCOK JAYA, KOTA SERANG, BANTEN",17,68,166,234
https://kawalpemilu.org#53161,"BANJAR AGUNG, CIPOCOK JAYA, KOTA SERANG, BANTEN",18,78,151,229
https://kawalpemilu.org#53161,"BANJAR AGUNG, CIPOCOK JAYA, KOTA SERANG, BANTEN",19,60,130,190
https://kawalpemilu.org#53161,"BANJAR AGUNG, CIPOCOK JAYA, KOTA SERANG, BANTEN",20,53,156,209
https://kawalpemilu.org#53161,"BANJAR AGUNG, CIPOCOK JAYA, KOTA SERANG, BANTEN",21,57,135,192
https://kawalpemilu.org#53161,"BANJAR AGUNG, CIPOCOK JAYA, KOTA SERANG, BANTEN",22,44,145,189
https://kawalpemilu.org#53161,"BANJAR AGUNG, CIPOCOK JAYA, KOTA SERANG, BANTEN",23,63,138,201
https://kawalpemilu.org#53161,"BANJAR AGUNG, CIPOCOK JAYA, KOTA SERANG, BANTEN",24,93,156,249
https://kawalpemilu.org#53161,"BANJAR AGUNG, CIPOCOK JAYA, KOTA SERANG, BANTEN",25,79,182,261
https://kawalpemilu.org#53161,"BANJAR AGUNG, CIPOCOK JAYA, KOTA SERANG, BANTEN",26,69,134,203
https://kawalpemilu.org#53161,"BANJAR AGUNG, CIPOCOK JAYA, KOTA SERANG, BANTEN",27,62,191,253
https://kawalpemilu.org#53161,"BANJAR AGUNG, CIPOCOK JAYA, KOTA SERANG, BANTEN",28,58,176,234
https://kawalpemilu.org#53161,"BANJAR AGUNG, CIPOCOK JAYA, KOTA SERANG, BANTEN",29,75,191,266
https://kawalpemilu.org#53161,"BANJAR AGUNG, CIPOCOK JAYA, KOTA SERANG, BANTEN",30,90,161,251
https://kawalpemilu.org#53161,"BANJAR AGUNG, CIPOCOK JAYA, KOTA SERANG, BANTEN",31,59,173,232
https://kawalpemilu.org#53161,"BANJAR AGUNG, CIPOCOK JAYA, KOTA SERANG, BANTEN",32,55,158,213
https://kawalpemilu.org#53161,"BANJAR AGUNG, CIPOCOK JAYA, KOTA SERANG, BANTEN",33,57,159,216
https://kawalpemilu.org#53161,"BANJAR AGUNG, CIPOCOK JAYA, KOTA SERANG, BANTEN",34,62,149,211
https://kawalpemilu.org#53161,"BANJAR AGUNG, CIPOCOK JAYA, KOTA SERANG, BANTEN",35,58,204,262
https://kawalpemilu.org#53162,"BANJAR SARI, CIPOCOK JAYA, KOTA SERANG, BANTEN",1,65,158,223
https://kawalpemilu.org#53162,"BANJAR SARI, CIPOCOK JAYA, KOTA SERANG, BANTEN",2,107,108,215
https://kawalpemilu.org#53162,"BANJAR SARI, CIPOCOK JAYA, KOTA SERANG, BANTEN",3,31,165,196
https://kawalpemilu.org#53162,"BANJAR SARI, CIPOCOK JAYA, KOTA SERANG, BANTEN",4,40,175,215
https://kawalpemilu.org#53162,"BANJAR SARI, CIPOCOK JAYA, KOTA SERANG, BANTEN",5,83,129,212
https://kawalpemilu.org#53162,"BANJAR SARI, CIPOCOK JAYA, KOTA SERANG, BANTEN",6,88,151,239
https://kawalpemilu.org#53162,"BANJAR SARI, CIPOCOK JAYA, KOTA SERANG, BANTEN",7,56,136,192
https://kawalpemilu.org#53162,"BANJAR SARI, CIPOCOK JAYA, KOTA SERANG, BANTEN",8,82,125,207
https://kawalpemilu.org#53162,"BANJAR SARI, CIPOCOK JAYA, KOTA SERANG, BANTEN",9,122,100,222
https://kawalpemilu.org#53162,"BANJAR SARI, CIPOCOK JAYA, KOTA SERANG, BANTEN",10,85,155,240
https://kawalpemilu.org#53162,"BANJAR SARI, CIPOCOK JAYA, KOTA SERANG, BANTEN",11,35,152,187
https://kawalpemilu.org#53162,"BANJAR SARI, CIPOCOK JAYA, KOTA SERANG, BANTEN",12,48,133,181
https://kawalpemilu.org#53162,"BANJAR SARI, CIPOCOK JAYA, KOTA SERANG, BANTEN",13,132,93,225
https://kawalpemilu.org#53162,"BANJAR SARI, CIPOCOK JAYA, KOTA SERANG, BANTEN",14,166,80,246
https://kawalpemilu.org#53162,"BANJAR SARI, CIPOCOK JAYA, KOTA SERANG, BANTEN",15,50,143,193
https://kawalpemilu.org#53162,"BANJAR SARI, CIPOCOK JAYA, KOTA SERANG, BANTEN",16,63,138,201
https://kawalpemilu.org#53162,"BANJAR SARI, CIPOCOK JAYA, KOTA SERANG, BANTEN",17,45,122,167
https://kawalpemilu.org#53162,"BANJAR SARI, CIPOCOK JAYA, KOTA SERANG, BANTEN",18,59,105,164
https://kawalpemilu.org#53162,"BANJAR SARI, CIPOCOK JAYA, KOTA SERANG, BANTEN",19,79,168,247
https://kawalpemilu.org#53162,"BANJAR SARI, CIPOCOK JAYA, KOTA SERANG, BANTEN",20,37,150,187
https://kawalpemilu.org#53162,"BANJAR SARI, CIPOCOK JAYA, KOTA SERANG, BANTEN",21,76,183,259
https://kawalpemilu.org#53162,"BANJAR SARI, CIPOCOK JAYA, KOTA SERANG, BANTEN",22,59,200,259
https://kawalpemilu.org#53162,"BANJAR SARI, CIPOCOK JAYA, KOTA SERANG, BANTEN",23,53,156,209
https://kawalpemilu.org#53162,"BANJAR SARI, CIPOCOK JAYA, KOTA SERANG, BANTEN",24,43,142,185
https://kawalpemilu.org#53162,"BANJAR SARI, CIPOCOK JAYA, KOTA SERANG, BANTEN",25,39,118,157
https://kawalpemilu.org#53162,"BANJAR SARI, CIPOCOK JAYA, KOTA SERANG, BANTEN",26,25,119,144
https://kawalpemilu.org#53162,"BANJAR SARI, CIPOCOK JAYA, KOTA SERANG, BANTEN",27,65,151,216
https://kawalpemilu.org#53162,"BANJAR SARI, CIPOCOK JAYA, KOTA SERANG, BANTEN",28,80,107,187
https://kawalpemilu.org#53162,"BANJAR SARI, CIPOCOK JAYA, KOTA SERANG, BANTEN",29,81,97,178
https://kawalpemilu.org#53162,"BANJAR SARI, CIPOCOK JAYA, KOTA SERANG, BANTEN",30,92,87,179
https://kawalpemilu.org#53162,"BANJAR SARI, CIPOCOK JAYA, KOTA SERANG, BANTEN",31,80,110,190
https://kawalpemilu.org#53162,"BANJAR SARI, CIPOCOK JAYA, KOTA SERANG, BANTEN",32,44,121,165
https://kawalpemilu.org#53162,"BANJAR SARI, CIPOCOK JAYA, KOTA SERANG, BANTEN",33,49,182,231
https://kawalpemilu.org#53162,"BANJAR SARI, CIPOCOK JAYA, KOTA SERANG, BANTEN",34,53,178,231
https://kawalpemilu.org#53162,"BANJAR SARI, CIPOCOK JAYA, KOTA SERANG, BANTEN",35,53,145,198
https://kawalpemilu.org#53162,"BANJAR SARI, CIPOCOK JAYA, KOTA SERANG, BANTEN",36,39,130,169
https://kawalpemilu.org#53162,"BANJAR SARI, CIPOCOK JAYA, KOTA SERANG, BANTEN",37,37,147,184
https://kawalpemilu.org#53162,"BANJAR SARI, CIPOCOK JAYA, KOTA SERANG, BANTEN",38,40,142,182
https://kawalpemilu.org#53162,"BANJAR SARI, CIPOCOK JAYA, KOTA SERANG, BANTEN",39,58,100,158
https://kawalpemilu.org#53162,"BANJAR SARI, CIPOCOK JAYA, KOTA SERANG, BANTEN",40,64,116,180
https://kawalpemilu.org#53162,"BANJAR SARI, CIPOCOK JAYA, KOTA SERANG, BANTEN",41,30,138,168
https://kawalpemilu.org#53162,"BANJAR SARI, CIPOCOK JAYA, KOTA SERANG, BANTEN",42,51,147,198
https://kawalpemilu.org#53162,"BANJAR SARI, CIPOCOK JAYA, KOTA SERANG, BANTEN",43,65,98,163
https://kawalpemilu.org#53162,"BANJAR SARI, CIPOCOK JAYA, KOTA SERANG, BANTEN",44,54,88,142
https://kawalpemilu.org#53162,"BANJAR SARI, CIPOCOK JAYA, KOTA SERANG, BANTEN",45,54,155,209
https://kawalpemilu.org#53162,"BANJAR SARI, CIPOCOK JAYA, KOTA SERANG, BANTEN",46,48,149,197
https://kawalpemilu.org#53162,"BANJAR SARI, CIPOCOK JAYA, KOTA SERANG, BANTEN",47,22,129,151
https://kawalpemilu.org#53162,"BANJAR SARI, CIPOCOK JAYA, KOTA SERANG, BANTEN",48,38,174,212
https://kawalpemilu.org#53162,"BANJAR SARI, CIPOCOK JAYA, KOTA SERANG, BANTEN",49,95,146,241
https://kawalpemilu.org#53162,"BANJAR SARI, CIPOCOK JAYA, KOTA SERANG, BANTEN",50,66,120,186
https://kawalpemilu.org#53162,"BANJAR SARI, CIPOCOK JAYA, KOTA SERANG, BANTEN",51,51,134,185
https://kawalpemilu.org#53162,"BANJAR SARI, CIPOCOK JAYA, KOTA SERANG, BANTEN",52,49,149,198
https://kawalpemilu.org#53162,"BANJAR SARI, CIPOCOK JAYA, KOTA SERANG, BANTEN",53,42,156,198
https://kawalpemilu.org#53162,"BANJAR SARI, CIPOCOK JAYA, KOTA SERANG, BANTEN",54,41,129,170
https://kawalpemilu.org#53162,"BANJAR SARI, CIPOCOK JAYA, KOTA SERANG, BANTEN",55,65,117,182
https://kawalpemilu.org#53162,"BANJAR SARI, CIPOCOK JAYA, KOTA SERANG, BANTEN",56,63,140,203
https://kawalpemilu.org#53163,"TEMBONG, CIPOCOK JAYA, KOTA SERANG, BANTEN",1,73,123,196
https://kawalpemilu.org#53163,"TEMBONG, CIPOCOK JAYA, KOTA SERANG, BANTEN",2,92,114,206
https://kawalpemilu.org#53163,"TEMBONG, CIPOCOK JAYA, KOTA SERANG, BANTEN",3,54,205,255
https://kawalpemilu.org#53163,"TEMBONG, CIPOCOK JAYA, KOTA SERANG, BANTEN",4,55,144,199
https://kawalpemilu.org#53163,"TEMBONG, CIPOCOK JAYA, KOTA SERANG, BANTEN",5,53,155,208
https://kawalpemilu.org#53163,"TEMBONG, CIPOCOK JAYA, KOTA SERANG, BANTEN",6,0,0,0
https://kawalpemilu.org#53163,"TEMBONG, CIPOCOK JAYA, KOTA SERANG, BANTEN",7,53,187,240
https://kawalpemilu.org#53163,"TEMBONG, CIPOCOK JAYA, KOTA SERANG, BANTEN",8,23,165,188
https://kawalpemilu.org#53163,"TEMBONG, CIPOCOK JAYA, KOTA SERANG, BANTEN",9,29,130,159
https://kawalpemilu.org#53163,"TEMBONG, CIPOCOK JAYA, KOTA SERANG, BANTEN",11,72,165,237
https://kawalpemilu.org#53163,"TEMBONG, CIPOCOK JAYA, KOTA SERANG, BANTEN",12,78,134,212
https://kawalpemilu.org#53163,"TEMBONG, CIPOCOK JAYA, KOTA SERANG, BANTEN",13,62,162,224
https://kawalpemilu.org#53163,"TEMBONG, CIPOCOK JAYA, KOTA SERANG, BANTEN",14,65,131,196
https://kawalpemilu.org#53163,"TEMBONG, CIPOCOK JAYA, KOTA SERANG, BANTEN",15,51,129,180
https://kawalpemilu.org#53163,"TEMBONG, CIPOCOK JAYA, KOTA SERANG, BANTEN",16,49,170,219
https://kawalpemilu.org#53163,"TEMBONG, CIPOCOK JAYA, KOTA SERANG, BANTEN",17,22,132,154
https://kawalpemilu.org#53163,"TEMBONG, CIPOCOK JAYA, KOTA SERANG, BANTEN",18,71,134,205
https://kawalpemilu.org#53163,"TEMBONG, CIPOCOK JAYA, KOTA SERANG, BANTEN",19,59,129,188
https://kawalpemilu.org#53163,"TEMBONG, CIPOCOK JAYA, KOTA SERANG, BANTEN",21,84,157,241
https://kawalpemilu.org#53164,"DALUNG, CIPOCOK JAYA, KOTA SERANG, BANTEN",1,102,102,204
https://kawalpemilu.org#53164,"DALUNG, CIPOCOK JAYA, KOTA SERANG, BANTEN",2,94,150,244
https://kawalpemilu.org#53164,"DALUNG, CIPOCOK JAYA, KOTA SERANG, BANTEN",3,66,113,179
https://kawalpemilu.org#53164,"DALUNG, CIPOCOK JAYA, KOTA SERANG, BANTEN",4,67,188,255
https://kawalpemilu.org#53164,"DALUNG, CIPOCOK JAYA, KOTA SERANG, BANTEN",5,32,174,206
https://kawalpemilu.org#53164,"DALUNG, CIPOCOK JAYA, KOTA SERANG, BANTEN",6,28,174,202
https://kawalpemilu.org#53164,"DALUNG, CIPOCOK JAYA, KOTA SERANG, BANTEN",8,71,180,251
https://kawalpemilu.org#53164,"DALUNG, CIPOCOK JAYA, KOTA SERANG, BANTEN",9,58,152,210
https://kawalpemilu.org#53164,"DALUNG, CIPOCOK JAYA, KOTA SERANG, BANTEN",10,42,147,189
https://kawalpemilu.org#53164,"DALUNG, CIPOCOK JAYA, KOTA SERANG, BANTEN",11,51,182,233
https://kawalpemilu.org#53164,"DALUNG, CIPOCOK JAYA, KOTA SERANG, BANTEN",12,60,188,248
https://kawalpemilu.org#53164,"DALUNG, CIPOCOK JAYA, KOTA SERANG, BANTEN",13,49,191,240
https://kawalpemilu.org#53164,"DALUNG, CIPOCOK JAYA, KOTA SERANG, BANTEN",14,56,155,211
https://kawalpemilu.org#53164,"DALUNG, CIPOCOK JAYA, KOTA SERANG, BANTEN",15,58,182,240
https://kawalpemilu.org#53164,"DALUNG, CIPOCOK JAYA, KOTA SERANG, BANTEN",16,58,199,257
https://kawalpemilu.org#53164,"DALUNG, CIPOCOK JAYA, KOTA SERANG, BANTEN",17,53,218,271
https://kawalpemilu.org#53164,"DALUNG, CIPOCOK JAYA, KOTA SERANG, BANTEN",18,50,134,184
https://kawalpemilu.org#53165,"GELAM, CIPOCOK JAYA, KOTA SERANG, BANTEN",1,111,166,277
https://kawalpemilu.org#53165,"GELAM, CIPOCOK JAYA, KOTA SERANG, BANTEN",2,113,117,230
https://kawalpemilu.org#53165,"GELAM, CIPOCOK JAYA, KOTA SERANG, BANTEN",3,121,135,256
https://kawalpemilu.org#53165,"GELAM, CIPOCOK JAYA, KOTA SERANG, BANTEN",4,56,128,182
https://kawalpemilu.org#53165,"GELAM, CIPOCOK JAYA, KOTA SERANG, BANTEN",5,52,100,152
https://kawalpemilu.org#53165,"GELAM, CIPOCOK JAYA, KOTA SERANG, BANTEN",6,62,109,171
https://kawalpemilu.org#53165,"GELAM, CIPOCOK JAYA, KOTA SERANG, BANTEN",7,51,134,185
https://kawalpemilu.org#53165,"GELAM, CIPOCOK JAYA, KOTA SERANG, BANTEN",8,58,94,152
https://kawalpemilu.org#53165,"GELAM, CIPOCOK JAYA, KOTA SERANG, BANTEN",9,42,135,177
https://kawalpemilu.org#53165,"GELAM, CIPOCOK JAYA, KOTA SERANG, BANTEN",10,46,195,241
https://kawalpemilu.org#53165,"GELAM, CIPOCOK JAYA, KOTA SERANG, BANTEN",11,76,169,245
https://kawalpemilu.org#53165,"GELAM, CIPOCOK JAYA, KOTA SERANG, BANTEN",12,73,158,231
https://kawalpemilu.org#53165,"GELAM, CIPOCOK JAYA, KOTA SERANG, BANTEN",13,71,169,240
https://kawalpemilu.org#53165,"GELAM, CIPOCOK JAYA, KOTA SERANG, BANTEN",14,126,79,205
https://kawalpemilu.org#53165,"GELAM, CIPOCOK JAYA, KOTA SERANG, BANTEN",16,117,78,195
https://kawalpemilu.org#53165,"GELAM, CIPOCOK JAYA, KOTA SERANG, BANTEN",17,28,152,180
https://kawalpemilu.org#53165,"GELAM, CIPOCOK JAYA, KOTA SERANG, BANTEN",18,29,143,172
https://kawalpemilu.org#53165,"GELAM, CIPOCOK JAYA, KOTA SERANG, BANTEN",19,93,153,228
https://kawalpemilu.org#53165,"GELAM, CIPOCOK JAYA, KOTA SERANG, BANTEN",20,50,221,271
https://kawalpemilu.org#53165,"GELAM, CIPOCOK JAYA, KOTA SERANG, BANTEN",21,78,140,218
https://kawalpemilu.org#53165,"GELAM, CIPOCOK JAYA, KOTA SERANG, BANTEN",22,39,169,208
https://kawalpemilu.org#53165,"GELAM, CIPOCOK JAYA, KOTA SERANG, BANTEN",23,69,161,230
https://kawalpemilu.org#53165,"GELAM, CIPOCOK JAYA, KOTA SERANG, BANTEN",24,45,190,235
https://kawalpemilu.org#53167,"TAKTAKAN, TAKTAKAN, KOTA SERANG, BANTEN",1,65,145,210
https://kawalpemilu.org#53167,"TAKTAKAN, TAKTAKAN, KOTA SERANG, BANTEN",2,51,157,208
https://kawalpemilu.org#53167,"TAKTAKAN, TAKTAKAN, KOTA SERANG, BANTEN",3,56,153,209
https://kawalpemilu.org#53167,"TAKTAKAN, TAKTAKAN, KOTA SERANG, BANTEN",4,39,189,228
https://kawalpemilu.org#53167,"TAKTAKAN, TAKTAKAN, KOTA SERANG, BANTEN",5,45,192,237
https://kawalpemilu.org#53167,"TAKTAKAN, TAKTAKAN, KOTA SERANG, BANTEN",6,43,165,208
https://kawalpemilu.org#53167,"TAKTAKAN, TAKTAKAN, KOTA SERANG, BANTEN",7,41,136,177
https://kawalpemilu.org#53167,"TAKTAKAN, TAKTAKAN, KOTA SERANG, BANTEN",8,54,126,180
https://kawalpemilu.org#53167,"TAKTAKAN, TAKTAKAN, KOTA SERANG, BANTEN",9,54,128,182
https://kawalpemilu.org#53167,"TAKTAKAN, TAKTAKAN, KOTA SERANG, BANTEN",10,62,167,229
https://kawalpemilu.org#53167,"TAKTAKAN, TAKTAKAN, KOTA SERANG, BANTEN",11,52,198,250
https://kawalpemilu.org#53167,"TAKTAKAN, TAKTAKAN, KOTA SERANG, BANTEN",12,47,180,227
https://kawalpemilu.org#53167,"TAKTAKAN, TAKTAKAN, KOTA SERANG, BANTEN",13,42,188,230
https://kawalpemilu.org#53167,"TAKTAKAN, TAKTAKAN, KOTA SERANG, BANTEN",14,40,175,215
https://kawalpemilu.org#53167,"TAKTAKAN, TAKTAKAN, KOTA SERANG, BANTEN",15,50,154,204
https://kawalpemilu.org#53167,"TAKTAKAN, TAKTAKAN, KOTA SERANG, BANTEN",16,48,131,179
https://kawalpemilu.org#53167,"TAKTAKAN, TAKTAKAN, KOTA SERANG, BANTEN",17,55,156,211
https://kawalpemilu.org#53167,"TAKTAKAN, TAKTAKAN, KOTA SERANG, BANTEN",18,42,176,218
https://kawalpemilu.org#53167,"TAKTAKAN, TAKTAKAN, KOTA SERANG, BANTEN",19,40,161,201
https://kawalpemilu.org#53167,"TAKTAKAN, TAKTAKAN, KOTA SERANG, BANTEN",20,28,164,192
https://kawalpemilu.org#53167,"TAKTAKAN, TAKTAKAN, KOTA SERANG, BANTEN",21,59,143,202
https://kawalpemilu.org#53167,"TAKTAKAN, TAKTAKAN, KOTA SERANG, BANTEN",22,65,161,226
https://kawalpemilu.org#53167,"TAKTAKAN, TAKTAKAN, KOTA SERANG, BANTEN",23,35,112,147
https://kawalpemilu.org#53167,"TAKTAKAN, TAKTAKAN, KOTA SERANG, BANTEN",24,33,118,151
https://kawalpemilu.org#53168,"SAYAR, TAKTAKAN, KOTA SERANG, BANTEN",1,48,123,171
https://kawalpemilu.org#53168,"SAYAR, TAKTAKAN, KOTA SERANG, BANTEN",2,68,109,177
https://kawalpemilu.org#53168,"SAYAR, TAKTAKAN, KOTA SERANG, BANTEN",3,48,165,213
https://kawalpemilu.org#53168,"SAYAR, TAKTAKAN, KOTA SERANG, BANTEN",4,50,171,221
https://kawalpemilu.org#53168,"SAYAR, TAKTAKAN, KOTA SERANG, BANTEN",5,41,177,218
https://kawalpemilu.org#53168,"SAYAR, TAKTAKAN, KOTA SERANG, BANTEN",6,61,123,184
https://kawalpemilu.org#53168,"SAYAR, TAKTAKAN, KOTA SERANG, BANTEN",7,45,112,157
https://kawalpemilu.org#53168,"SAYAR, TAKTAKAN, KOTA SERANG, BANTEN",8,55,119,174
https://kawalpemilu.org#53168,"SAYAR, TAKTAKAN, KOTA SERANG, BANTEN",9,35,148,183
https://kawalpemilu.org#53168,"SAYAR, TAKTAKAN, KOTA SERANG, BANTEN",10,34,151,185
https://kawalpemilu.org#53168,"SAYAR, TAKTAKAN, KOTA SERANG, BANTEN",11,49,129,178
https://kawalpemilu.org#53168,"SAYAR, TAKTAKAN, KOTA SERANG, BANTEN",12,45,120,165
https://kawalpemilu.org#53168,"SAYAR, TAKTAKAN, KOTA SERANG, BANTEN",13,27,88,115
https://kawalpemilu.org#53168,"SAYAR, TAKTAKAN, KOTA SERANG, BANTEN",14,45,126,171
https://kawalpemilu.org#53168,"SAYAR, TAKTAKAN, KOTA SERANG, BANTEN",15,36,132,168
https://kawalpemilu.org#53168,"SAYAR, TAKTAKAN, KOTA SERANG, BANTEN",16,24,156,180
https://kawalpemilu.org#53168,"SAYAR, TAKTAKAN, KOTA SERANG, BANTEN",17,59,79,138
https://kawalpemilu.org#53168,"SAYAR, TAKTAKAN, KOTA SERANG, BANTEN",18,88,60,148
https://kawalpemilu.org#53168,"SAYAR, TAKTAKAN, KOTA SERANG, BANTEN",19,46,150,196
https://kawalpemilu.org#53168,"SAYAR, TAKTAKAN, KOTA SERANG, BANTEN",20,45,129,174
https://kawalpemilu.org#53168,"SAYAR, TAKTAKAN, KOTA SERANG, BANTEN",21,40,128,168
https://kawalpemilu.org#53168,"SAYAR, TAKTAKAN, KOTA SERANG, BANTEN",22,17,61,78
https://kawalpemilu.org#53169,"PANCUR, TAKTAKAN, KOTA SERANG, BANTEN",1,48,189,237
https://kawalpemilu.org#53169,"PANCUR, TAKTAKAN, KOTA SERANG, BANTEN",2,55,178,233
https://kawalpemilu.org#53169,"PANCUR, TAKTAKAN, KOTA SERANG, BANTEN",3,92,138,230
https://kawalpemilu.org#53169,"PANCUR, TAKTAKAN, KOTA SERANG, BANTEN",4,57,114,171
https://kawalpemilu.org#53169,"PANCUR, TAKTAKAN, KOTA SERANG, BANTEN",5,91,120,211
https://kawalpemilu.org#53169,"PANCUR, TAKTAKAN, KOTA SERANG, BANTEN",6,81,76,157
https://kawalpemilu.org#53169,"PANCUR, TAKTAKAN, KOTA SERANG, BANTEN",7,68,97,165
https://kawalpemilu.org#53169,"PANCUR, TAKTAKAN, KOTA SERANG, BANTEN",8,43,174,217
https://kawalpemilu.org#53169,"PANCUR, TAKTAKAN, KOTA SERANG, BANTEN",9,71,151,222
https://kawalpemilu.org#53169,"PANCUR, TAKTAKAN, KOTA SERANG, BANTEN",10,87,158,245
https://kawalpemilu.org#53169,"PANCUR, TAKTAKAN, KOTA SERANG, BANTEN",11,49,167,216
https://kawalpemilu.org#53169,"PANCUR, TAKTAKAN, KOTA SERANG, BANTEN",12,62,141,203
https://kawalpemilu.org#53169,"PANCUR, TAKTAKAN, KOTA SERANG, BANTEN",13,64,125,189
https://kawalpemilu.org#53169,"PANCUR, TAKTAKAN, KOTA SERANG, BANTEN",14,48,105,153
https://kawalpemilu.org#53169,"PANCUR, TAKTAKAN, KOTA SERANG, BANTEN",15,55,101,156
https://kawalpemilu.org#53170,"KURANJI, TAKTAKAN, KOTA SERANG, BANTEN",1,63,173,236
https://kawalpemilu.org#53170,"KURANJI, TAKTAKAN, KOTA SERANG, BANTEN",2,89,176,265
https://kawalpemilu.org#53170,"KURANJI, TAKTAKAN, KOTA SERANG, BANTEN",3,51,156,207
https://kawalpemilu.org#53170,"KURANJI, TAKTAKAN, KOTA SERANG, BANTEN",4,62,167,229
https://kawalpemilu.org#53170,"KURANJI, TAKTAKAN, KOTA SERANG, BANTEN",5,35,211,246
https://kawalpemilu.org#53170,"KURANJI, TAKTAKAN, KOTA SERANG, BANTEN",6,26,187,213
https://kawalpemilu.org#53170,"KURANJI, TAKTAKAN, KOTA SERANG, BANTEN",7,30,189,219
https://kawalpemilu.org#53170,"KURANJI, TAKTAKAN, KOTA SERANG, BANTEN",8,52,153,205
https://kawalpemilu.org#53170,"KURANJI, TAKTAKAN, KOTA SERANG, BANTEN",9,29,178,207
https://kawalpemilu.org#53170,"KURANJI, TAKTAKAN, KOTA SERANG, BANTEN",10,47,181,228
https://kawalpemilu.org#53170,"KURANJI, TAKTAKAN, KOTA SERANG, BANTEN",11,30,163,193
https://kawalpemilu.org#53170,"KURANJI, TAKTAKAN, KOTA SERANG, BANTEN",12,23,165,188
https://kawalpemilu.org#53171,"KALANGANYAR, TAKTAKAN, KOTA SERANG, BANTEN",1,79,155,234
https://kawalpemilu.org#53171,"KALANGANYAR, TAKTAKAN, KOTA SERANG, BANTEN",2,53,196,249
https://kawalpemilu.org#53171,"KALANGANYAR, TAKTAKAN, KOTA SERANG, BANTEN",3,26,181,207
https://kawalpemilu.org#53171,"KALANGANYAR, TAKTAKAN, KOTA SERANG, BANTEN",4,35,167,202
https://kawalpemilu.org#53171,"KALANGANYAR, TAKTAKAN, KOTA SERANG, BANTEN",5,40,148,188
https://kawalpemilu.org#53171,"KALANGANYAR, TAKTAKAN, KOTA SERANG, BANTEN",6,62,166,228
https://kawalpemilu.org#53171,"KALANGANYAR, TAKTAKAN, KOTA SERANG, BANTEN",7,61,97,158
https://kawalpemilu.org#53171,"KALANGANYAR, TAKTAKAN, KOTA SERANG, BANTEN",8,40,126,166
https://kawalpemilu.org#53171,"KALANGANYAR, TAKTAKAN, KOTA SERANG, BANTEN",9,50,194,244
https://kawalpemilu.org#53171,"KALANGANYAR, TAKTAKAN, KOTA SERANG, BANTEN",10,67,177,244
https://kawalpemilu.org#53171,"KALANGANYAR, TAKTAKAN, KOTA SERANG, BANTEN",11,108,134,242
https://kawalpemilu.org#53172,"CILOWONG, TAKTAKAN, KOTA SERANG, BANTEN",1,81,125,206
https://kawalpemilu.org#53172,"CILOWONG, TAKTAKAN, KOTA SERANG, BANTEN",2,56,154,15
https://kawalpemilu.org#53172,"CILOWONG, TAKTAKAN, KOTA SERANG, BANTEN",4,51,99,150
https://kawalpemilu.org#53172,"CILOWONG, TAKTAKAN, KOTA SERANG, BANTEN",5,79,119,198
https://kawalpemilu.org#53172,"CILOWONG, TAKTAKAN, KOTA SERANG, BANTEN",6,27,67,94
https://kawalpemilu.org#53172,"CILOWONG, TAKTAKAN, KOTA SERANG, BANTEN",7,57,184,241
https://kawalpemilu.org#53172,"CILOWONG, TAKTAKAN, KOTA SERANG, BANTEN",8,53,156,209
https://kawalpemilu.org#53172,"CILOWONG, TAKTAKAN, KOTA SERANG, BANTEN",9,40,145,185
https://kawalpemilu.org#53172,"CILOWONG, TAKTAKAN, KOTA SERANG, BANTEN",10,23,142,165
https://kawalpemilu.org#53172,"CILOWONG, TAKTAKAN, KOTA SERANG, BANTEN",11,28,86,114
https://kawalpemilu.org#53172,"CILOWONG, TAKTAKAN, KOTA SERANG, BANTEN",12,33,116,149
https://kawalpemilu.org#53172,"CILOWONG, TAKTAKAN, KOTA SERANG, BANTEN",13,25,96,121
https://kawalpemilu.org#53172,"CILOWONG, TAKTAKAN, KOTA SERANG, BANTEN",14,38,194,232
https://kawalpemilu.org#53172,"CILOWONG, TAKTAKAN, KOTA SERANG, BANTEN",15,58,163,221
https://kawalpemilu.org#53172,"CILOWONG, TAKTAKAN, KOTA SERANG, BANTEN",16,38,163,201
https://kawalpemilu.org#53172,"CILOWONG, TAKTAKAN, KOTA SERANG, BANTEN",17,0,0,0
https://kawalpemilu.org#53172,"CILOWONG, TAKTAKAN, KOTA SERANG, BANTEN",18,36,121,157
https://kawalpemilu.org#53172,"CILOWONG, TAKTAKAN, KOTA SERANG, BANTEN",19,20,121,141
https://kawalpemilu.org#53172,"CILOWONG, TAKTAKAN, KOTA SERANG, BANTEN",20,49,91,140
https://kawalpemilu.org#53172,"CILOWONG, TAKTAKAN, KOTA SERANG, BANTEN",21,28,100,128
https://kawalpemilu.org#53172,"CILOWONG, TAKTAKAN, KOTA SERANG, BANTEN",22,34,101,135
https://kawalpemilu.org#53172,"CILOWONG, TAKTAKAN, KOTA SERANG, BANTEN",23,50,160,210
https://kawalpemilu.org#53172,"CILOWONG, TAKTAKAN, KOTA SERANG, BANTEN",24,14,109,123
https://kawalpemilu.org#53172,"CILOWONG, TAKTAKAN, KOTA SERANG, BANTEN",26,47,122,169
https://kawalpemilu.org#53172,"CILOWONG, TAKTAKAN, KOTA SERANG, BANTEN",27,40,79,119
https://kawalpemilu.org#53172,"CILOWONG, TAKTAKAN, KOTA SERANG, BANTEN",28,54,111,165
https://kawalpemilu.org#53172,"CILOWONG, TAKTAKAN, KOTA SERANG, BANTEN",29,27,101,128
https://kawalpemilu.org#53172,"CILOWONG, TAKTAKAN, KOTA SERANG, BANTEN",30,37,117,154
https://kawalpemilu.org#53173,"PANGGUNGJATI, TAKTAKAN, KOTA SERANG, BANTEN",1,68,190,258
https://kawalpemilu.org#53173,"PANGGUNGJATI, TAKTAKAN, KOTA SERANG, BANTEN",2,48,178,226
https://kawalpemilu.org#53173,"PANGGUNGJATI, TAKTAKAN, KOTA SERANG, BANTEN",3,34,178,212
https://kawalpemilu.org#53173,"PANGGUNGJATI, TAKTAKAN, KOTA SERANG, BANTEN",4,28,168,196
https://kawalpemilu.org#53173,"PANGGUNGJATI, TAKTAKAN, KOTA SERANG, BANTEN",5,20,177,197
https://kawalpemilu.org#53173,"PANGGUNGJATI, TAKTAKAN, KOTA SERANG, BANTEN",6,39,166,205
https://kawalpemilu.org#53173,"PANGGUNGJATI, TAKTAKAN, KOTA SERANG, BANTEN",7,50,185,235
https://kawalpemilu.org#53173,"PANGGUNGJATI, TAKTAKAN, KOTA SERANG, BANTEN",8,52,181,233
https://kawalpemilu.org#53173,"PANGGUNGJATI, TAKTAKAN, KOTA SERANG, BANTEN",9,56,186,242
https://kawalpemilu.org#53173,"PANGGUNGJATI, TAKTAKAN, KOTA SERANG, BANTEN",10,77,140,217
https://kawalpemilu.org#53173,"PANGGUNGJATI, TAKTAKAN, KOTA SERANG, BANTEN",11,58,168,226
https://kawalpemilu.org#53173,"PANGGUNGJATI, TAKTAKAN, KOTA SERANG, BANTEN",12,52,175,227
https://kawalpemilu.org#53173,"PANGGUNGJATI, TAKTAKAN, KOTA SERANG, BANTEN",13,65,159,224
https://kawalpemilu.org#53173,"PANGGUNGJATI, TAKTAKAN, KOTA SERANG, BANTEN",14,73,138,211
https://kawalpemilu.org#53173,"PANGGUNGJATI, TAKTAKAN, KOTA SERANG, BANTEN",15,74,139,213
https://kawalpemilu.org#53173,"PANGGUNGJATI, TAKTAKAN, KOTA SERANG, BANTEN",16,59,152,211
https://kawalpemilu.org#53173,"PANGGUNGJATI, TAKTAKAN, KOTA SERANG, BANTEN",17,65,125,190
https://kawalpemilu.org#53173,"PANGGUNGJATI, TAKTAKAN, KOTA SERANG, BANTEN",18,69,212,281
https://kawalpemilu.org#53173,"PANGGUNGJATI, TAKTAKAN, KOTA SERANG, BANTEN",19,67,134,201
https://kawalpemilu.org#53173,"PANGGUNGJATI, TAKTAKAN, KOTA SERANG, BANTEN",20,78,159,237
https://kawalpemilu.org#53174,"DRANGONG, TAKTAKAN, KOTA SERANG, BANTEN",1,44,107,151
https://kawalpemilu.org#53174,"DRANGONG, TAKTAKAN, KOTA SERANG, BANTEN",2,72,178,250
https://kawalpemilu.org#53174,"DRANGONG, TAKTAKAN, KOTA SERANG, BANTEN",3,36,227,263
https://kawalpemilu.org#53174,"DRANGONG, TAKTAKAN, KOTA SERANG, BANTEN",4,90,184,274
https://kawalpemilu.org#53174,"DRANGONG, TAKTAKAN, KOTA SERANG, BANTEN",5,96,152,0
https://kawalpemilu.org#53174,"DRANGONG, TAKTAKAN, KOTA SERANG, BANTEN",6,58,139,197
https://kawalpemilu.org#53174,"DRANGONG, TAKTAKAN, KOTA SERANG, BANTEN",7,106,101,207
https://kawalpemilu.org#53174,"DRANGONG, TAKTAKAN, KOTA SERANG, BANTEN",8,93,151,244
https://kawalpemilu.org#53174,"DRANGONG, TAKTAKAN, KOTA SERANG, BANTEN",9,83,141,224
https://kawalpemilu.org#53174,"DRANGONG, TAKTAKAN, KOTA SERANG, BANTEN",10,56,162,218
https://kawalpemilu.org#53174,"DRANGONG, TAKTAKAN, KOTA SERANG, BANTEN",11,78,154,232
https://kawalpemilu.org#53174,"DRANGONG, TAKTAKAN, KOTA SERANG, BANTEN",12,101,150,251
https://kawalpemilu.org#53174,"DRANGONG, TAKTAKAN, KOTA SERANG, BANTEN",13,54,201,255
https://kawalpemilu.org#53174,"DRANGONG, TAKTAKAN, KOTA SERANG, BANTEN",14,87,168,255
https://kawalpemilu.org#53174,"DRANGONG, TAKTAKAN, KOTA SERANG, BANTEN",15,50,199,249
https://kawalpemilu.org#53174,"DRANGONG, TAKTAKAN, KOTA SERANG, BANTEN",16,42,184,226
https://kawalpemilu.org#53174,"DRANGONG, TAKTAKAN, KOTA SERANG, BANTEN",17,38,183,221
https://kawalpemilu.org#53174,"DRANGONG, TAKTAKAN, KOTA SERANG, BANTEN",18,52,177,229
https://kawalpemilu.org#53174,"DRANGONG, TAKTAKAN, KOTA SERANG, BANTEN",19,82,118,200
https://kawalpemilu.org#53174,"DRANGONG, TAKTAKAN, KOTA SERANG, BANTEN",20,54,123,177
https://kawalpemilu.org#53174,"DRANGONG, TAKTAKAN, KOTA SERANG, BANTEN",21,51,170,221
https://kawalpemilu.org#53174,"DRANGONG, TAKTAKAN, KOTA SERANG, BANTEN",22,60,191,251
https://kawalpemilu.org#53174,"DRANGONG, TAKTAKAN, KOTA SERANG, BANTEN",23,67,152,219
https://kawalpemilu.org#53174,"DRANGONG, TAKTAKAN, KOTA SERANG, BANTEN",24,28,186,214
https://kawalpemilu.org#53174,"DRANGONG, TAKTAKAN, KOTA SERANG, BANTEN",25,96,167,263
https://kawalpemilu.org#53174,"DRANGONG, TAKTAKAN, KOTA SERANG, BANTEN",26,41,150,191
https://kawalpemilu.org#53174,"DRANGONG, TAKTAKAN, KOTA SERANG, BANTEN",27,50,144,194
https://kawalpemilu.org#53174,"DRANGONG, TAKTAKAN, KOTA SERANG, BANTEN",28,59,146,205
https://kawalpemilu.org#53174,"DRANGONG, TAKTAKAN, KOTA SERANG, BANTEN",29,50,167,217
https://kawalpemilu.org#53174,"DRANGONG, TAKTAKAN, KOTA SERANG, BANTEN",30,52,170,222
https://kawalpemilu.org#53174,"DRANGONG, TAKTAKAN, KOTA SERANG, BANTEN",31,45,55,100
https://kawalpemilu.org#53174,"DRANGONG, TAKTAKAN, KOTA SERANG, BANTEN",32,129,152,281
https://kawalpemilu.org#53174,"DRANGONG, TAKTAKAN, KOTA SERANG, BANTEN",33,40,195,235
https://kawalpemilu.org#53174,"DRANGONG, TAKTAKAN, KOTA SERANG, BANTEN",34,47,192,239
https://kawalpemilu.org#53174,"DRANGONG, TAKTAKAN, KOTA SERANG, BANTEN",35,62,141,203
https://kawalpemilu.org#53174,"DRANGONG, TAKTAKAN, KOTA SERANG, BANTEN",36,60,114,174
https://kawalpemilu.org#53174,"DRANGONG, TAKTAKAN, KOTA SERANG, BANTEN",37,45,202,247
https://kawalpemilu.org#53174,"DRANGONG, TAKTAKAN, KOTA SERANG, BANTEN",38,48,165,213
https://kawalpemilu.org#53174,"DRANGONG, TAKTAKAN, KOTA SERANG, BANTEN",39,33,173,206
https://kawalpemilu.org#53174,"DRANGONG, TAKTAKAN, KOTA SERANG, BANTEN",40,76,115,191
https://kawalpemilu.org#53174,"DRANGONG, TAKTAKAN, KOTA SERANG, BANTEN",41,59,134,193
https://kawalpemilu.org#53174,"DRANGONG, TAKTAKAN, KOTA SERANG, BANTEN",42,43,206,249
https://kawalpemilu.org#53174,"DRANGONG, TAKTAKAN, KOTA SERANG, BANTEN",43,46,200,246
https://kawalpemilu.org#53174,"DRANGONG, TAKTAKAN, KOTA SERANG, BANTEN",44,47,210,257
https://kawalpemilu.org#53174,"DRANGONG, TAKTAKAN, KOTA SERANG, BANTEN",45,15,185,200
https://kawalpemilu.org#53174,"DRANGONG, TAKTAKAN, KOTA SERANG, BANTEN",46,71,151,222
https://kawalpemilu.org#53174,"DRANGONG, TAKTAKAN, KOTA SERANG, BANTEN",47,67,158,225
https://kawalpemilu.org#53174,"DRANGONG, TAKTAKAN, KOTA SERANG, BANTEN",48,68,129,197
https://kawalpemilu.org#53174,"DRANGONG, TAKTAKAN, KOTA SERANG, BANTEN",49,53,192,245
https://kawalpemilu.org#53174,"DRANGONG, TAKTAKAN, KOTA SERANG, BANTEN",50,97,180,277
https://kawalpemilu.org#53174,"DRANGONG, TAKTAKAN, KOTA SERANG, BANTEN",51,32,46,78
https://kawalpemilu.org#53174,"DRANGONG, TAKTAKAN, KOTA SERANG, BANTEN",52,12,43,55
https://kawalpemilu.org#53175,"UMBUL TENGAH, TAKTAKAN, KOTA SERANG, BANTEN",1,52,222,274
https://kawalpemilu.org#53175,"UMBUL TENGAH, TAKTAKAN, KOTA SERANG, BANTEN",2,23,242,265
https://kawalpemilu.org#53175,"UMBUL TENGAH, TAKTAKAN, KOTA SERANG, BANTEN",3,36,212,248
https://kawalpemilu.org#53175,"UMBUL TENGAH, TAKTAKAN, KOTA SERANG, BANTEN",4,27,217,244
https://kawalpemilu.org#53175,"UMBUL TENGAH, TAKTAKAN, KOTA SERANG, BANTEN",5,43,206,249
https://kawalpemilu.org#53175,"UMBUL TENGAH, TAKTAKAN, KOTA SERANG, BANTEN",6,41,216,257
https://kawalpemilu.org#53175,"UMBUL TENGAH, TAKTAKAN, KOTA SERANG, BANTEN",7,58,195,253
https://kawalpemilu.org#53175,"UMBUL TENGAH, TAKTAKAN, KOTA SERANG, BANTEN",8,14,245,259
https://kawalpemilu.org#53175,"UMBUL TENGAH, TAKTAKAN, KOTA SERANG, BANTEN",9,16,232,246
https://kawalpemilu.org#53175,"UMBUL TENGAH, TAKTAKAN, KOTA SERANG, BANTEN",10,14,195,209
https://kawalpemilu.org#53175,"UMBUL TENGAH, TAKTAKAN, KOTA SERANG, BANTEN",11,43,192,235
https://kawalpemilu.org#53175,"UMBUL TENGAH, TAKTAKAN, KOTA SERANG, BANTEN",12,57,199,256
https://kawalpemilu.org#53176,"SEPANG, TAKTAKAN, KOTA SERANG, BANTEN",1,60,158,218
https://kawalpemilu.org#53176,"SEPANG, TAKTAKAN, KOTA SERANG, BANTEN",2,48,171,219
https://kawalpemilu.org#53176,"SEPANG, TAKTAKAN, KOTA SERANG, BANTEN",3,40,161,201
https://kawalpemilu.org#53176,"SEPANG, TAKTAKAN, KOTA SERANG, BANTEN",4,70,176,246
https://kawalpemilu.org#53176,"SEPANG, TAKTAKAN, KOTA SERANG, BANTEN",5,69,189,258
https://kawalpemilu.org#53176,"SEPANG, TAKTAKAN, KOTA SERANG, BANTEN",6,38,149,187
https://kawalpemilu.org#53176,"SEPANG, TAKTAKAN, KOTA SERANG, BANTEN",7,44,136,180
https://kawalpemilu.org#53176,"SEPANG, TAKTAKAN, KOTA SERANG, BANTEN",8,50,214,264
https://kawalpemilu.org#53176,"SEPANG, TAKTAKAN, KOTA SERANG, BANTEN",9,57,224,281
https://kawalpemilu.org#53176,"SEPANG, TAKTAKAN, KOTA SERANG, BANTEN",10,73,147,220
https://kawalpemilu.org#53176,"SEPANG, TAKTAKAN, KOTA SERANG, BANTEN",11,49,159,208
https://kawalpemilu.org#53176,"SEPANG, TAKTAKAN, KOTA SERANG, BANTEN",12,61,144,205
https://kawalpemilu.org#53176,"SEPANG, TAKTAKAN, KOTA SERANG, BANTEN",13,41,213,254
https://kawalpemilu.org#53176,"SEPANG, TAKTAKAN, KOTA SERANG, BANTEN",14,56,193,249
https://kawalpemilu.org#53176,"SEPANG, TAKTAKAN, KOTA SERANG, BANTEN",15,52,151,203
https://kawalpemilu.org#53176,"SEPANG, TAKTAKAN, KOTA SERANG, BANTEN",16,39,153,192
https://kawalpemilu.org#53176,"SEPANG, TAKTAKAN, KOTA SERANG, BANTEN",17,43,161,204
https://kawalpemilu.org#53176,"SEPANG, TAKTAKAN, KOTA SERANG, BANTEN",18,38,176,214
https://kawalpemilu.org#53176,"SEPANG, TAKTAKAN, KOTA SERANG, BANTEN",19,52,215,267
https://kawalpemilu.org#53176,"SEPANG, TAKTAKAN, KOTA SERANG, BANTEN",20,54,190,244
https://kawalpemilu.org#53176,"SEPANG, TAKTAKAN, KOTA SERANG, BANTEN",21,60,201,261
https://kawalpemilu.org#53176,"SEPANG, TAKTAKAN, KOTA SERANG, BANTEN",22,67,184,251
https://kawalpemilu.org#53176,"SEPANG, TAKTAKAN, KOTA SERANG, BANTEN",23,58,200,258
https://kawalpemilu.org#53176,"SEPANG, TAKTAKAN, KOTA SERANG, BANTEN",24,54,211,265
https://kawalpemilu.org#53176,"SEPANG, TAKTAKAN, KOTA SERANG, BANTEN",25,63,144,207
https://kawalpemilu.org#53176,"SEPANG, TAKTAKAN, KOTA SERANG, BANTEN",26,35,146,181
https://kawalpemilu.org#53177,"LIALANG, TAKTAKAN, KOTA SERANG, BANTEN",1,36,205,241
https://kawalpemilu.org#53177,"LIALANG, TAKTAKAN, KOTA SERANG, BANTEN",2,37,167,204
https://kawalpemilu.org#53177,"LIALANG, TAKTAKAN, KOTA SERANG, BANTEN",3,25,241,266
https://kawalpemilu.org#53177,"LIALANG, TAKTAKAN, KOTA SERANG, BANTEN",4,37,224,261
https://kawalpemilu.org#53177,"LIALANG, TAKTAKAN, KOTA SERANG, BANTEN",5,54,222,276
https://kawalpemilu.org#53177,"LIALANG, TAKTAKAN, KOTA SERANG, BANTEN",6,47,128,175
https://kawalpemilu.org#53177,"LIALANG, TAKTAKAN, KOTA SERANG, BANTEN",7,37,121,158
https://kawalpemilu.org#53177,"LIALANG, TAKTAKAN, KOTA SERANG, BANTEN",8,42,125,167
https://kawalpemilu.org#53177,"LIALANG, TAKTAKAN, KOTA SERANG, BANTEN",9,55,111,166
https://kawalpemilu.org#53177,"LIALANG, TAKTAKAN, KOTA SERANG, BANTEN",10,47,120,167
https://kawalpemilu.org#53177,"LIALANG, TAKTAKAN, KOTA SERANG, BANTEN",11,28,128,156
https://kawalpemilu.org#53177,"LIALANG, TAKTAKAN, KOTA SERANG, BANTEN",12,92,117,209
https://kawalpemilu.org#53177,"LIALANG, TAKTAKAN, KOTA SERANG, BANTEN",13,97,153,246
https://kawalpemilu.org#53177,"LIALANG, TAKTAKAN, KOTA SERANG, BANTEN",14,64,180,244
https://kawalpemilu.org#53177,"LIALANG, TAKTAKAN, KOTA SERANG, BANTEN",15,37,219,258
https://kawalpemilu.org#53177,"LIALANG, TAKTAKAN, KOTA SERANG, BANTEN",16,62,199,261
https://kawalpemilu.org#53177,"LIALANG, TAKTAKAN, KOTA SERANG, BANTEN",17,50,131,181
https://kawalpemilu.org#53177,"LIALANG, TAKTAKAN, KOTA SERANG, BANTEN",18,39,109,148
https://kawalpemilu.org#53177,"LIALANG, TAKTAKAN, KOTA SERANG, BANTEN",19,59,149,208
https://kawalpemilu.org#53178,"TAMAN BARU, TAKTAKAN, KOTA SERANG, BANTEN",1,8,199,207
https://kawalpemilu.org#53178,"TAMAN BARU, TAKTAKAN, KOTA SERANG, BANTEN",2,7,173,180
https://kawalpemilu.org#53178,"TAMAN BARU, TAKTAKAN, KOTA SERANG, BANTEN",3,14,165,179
https://kawalpemilu.org#53178,"TAMAN BARU, TAKTAKAN, KOTA SERANG, BANTEN",5,46,190,236
https://kawalpemilu.org#53178,"TAMAN BARU, TAKTAKAN, KOTA SERANG, BANTEN",6,31,105,136
https://kawalpemilu.org#53178,"TAMAN BARU, TAKTAKAN, KOTA SERANG, BANTEN",7,64,184,248
https://kawalpemilu.org#53178,"TAMAN BARU, TAKTAKAN, KOTA SERANG, BANTEN",8,67,164,231
https://kawalpemilu.org#53178,"TAMAN BARU, TAKTAKAN, KOTA SERANG, BANTEN",9,33,216,249
https://kawalpemilu.org#53178,"TAMAN BARU, TAKTAKAN, KOTA SERANG, BANTEN",10,49,197,246
https://kawalpemilu.org#53178,"TAMAN BARU, TAKTAKAN, KOTA SERANG, BANTEN",11,87,153,240
https://kawalpemilu.org#53178,"TAMAN BARU, TAKTAKAN, KOTA SERANG, BANTEN",12,69,165,234
https://kawalpemilu.org#53178,"TAMAN BARU, TAKTAKAN, KOTA SERANG, BANTEN",13,56,209,265
https://kawalpemilu.org#53178,"TAMAN BARU, TAKTAKAN, KOTA SERANG, BANTEN",14,31,237,268
https://kawalpemilu.org#53178,"TAMAN BARU, TAKTAKAN, KOTA SERANG, BANTEN",15,61,202,263
https://kawalpemilu.org#53181,"CIATER, SERPONG, KOTA TANGERANG SELATAN, BANTEN",1,97,76,173
https://kawalpemilu.org#53181,"CIATER, SERPONG, KOTA TANGERANG SELATAN, BANTEN",2,112,72,184
https://kawalpemilu.org#53181,"CIATER, SERPONG, KOTA TANGERANG SELATAN, BANTEN",3,84,164,248
https://kawalpemilu.org#53181,"CIATER, SERPONG, KOTA TANGERANG SELATAN, BANTEN",4,90,135,225
https://kawalpemilu.org#53181,"CIATER, SERPONG, KOTA TANGERANG SELATAN, BANTEN",5,138,95,233
https://kawalpemilu.org#53181,"CIATER, SERPONG, KOTA TANGERANG SELATAN, BANTEN",6,119,124,243
https://kawalpemilu.org#53181,"CIATER, SERPONG, KOTA TANGERANG SELATAN, BANTEN",7,98,111,209
https://kawalpemilu.org#53181,"CIATER, SERPONG, KOTA TANGERANG SELATAN, BANTEN",8,60,62,122
https://kawalpemilu.org#53181,"CIATER, SERPONG, KOTA TANGERANG SELATAN, BANTEN",9,82,157,239
https://kawalpemilu.org#53181,"CIATER, SERPONG, KOTA TANGERANG SELATAN, BANTEN",10,57,151,208
https://kawalpemilu.org#53181,"CIATER, SERPONG, KOTA TANGERANG SELATAN, BANTEN",11,130,148,278
https://kawalpemilu.org#53181,"CIATER, SERPONG, KOTA TANGERANG SELATAN, BANTEN",12,155,98,253
https://kawalpemilu.org#53181,"CIATER, SERPONG, KOTA TANGERANG SELATAN, BANTEN",13,95,143,238
https://kawalpemilu.org#53181,"CIATER, SERPONG, KOTA TANGERANG SELATAN, BANTEN",14,106,132,238
https://kawalpemilu.org#53181,"CIATER, SERPONG, KOTA TANGERANG SELATAN, BANTEN",15,115,117,232
https://kawalpemilu.org#53181,"CIATER, SERPONG, KOTA TANGERANG SELATAN, BANTEN",16,66,162,228
https://kawalpemilu.org#53181,"CIATER, SERPONG, KOTA TANGERANG SELATAN, BANTEN",17,140,101,241
https://kawalpemilu.org#53181,"CIATER, SERPONG, KOTA TANGERANG SELATAN, BANTEN",18,172,96,268
https://kawalpemilu.org#53181,"CIATER, SERPONG, KOTA TANGERANG SELATAN, BANTEN",19,174,93,267
https://kawalpemilu.org#53181,"CIATER, SERPONG, KOTA TANGERANG SELATAN, BANTEN",20,128,160,288
https://kawalpemilu.org#53181,"CIATER, SERPONG, KOTA TANGERANG SELATAN, BANTEN",21,121,158,279
https://kawalpemilu.org#53181,"CIATER, SERPONG, KOTA TANGERANG SELATAN, BANTEN",22,123,123,246
https://kawalpemilu.org#53181,"CIATER, SERPONG, KOTA TANGERANG SELATAN, BANTEN",23,135,122,257
https://kawalpemilu.org#53181,"CIATER, SERPONG, KOTA TANGERANG SELATAN, BANTEN",24,132,162,294
https://kawalpemilu.org#53181,"CIATER, SERPONG, KOTA TANGERANG SELATAN, BANTEN",25,142,108,250
https://kawalpemilu.org#53181,"CIATER, SERPONG, KOTA TANGERANG SELATAN, BANTEN",26,101,145,246
https://kawalpemilu.org#53181,"CIATER, SERPONG, KOTA TANGERANG SELATAN, BANTEN",27,135,117,252
https://kawalpemilu.org#53181,"CIATER, SERPONG, KOTA TANGERANG SELATAN, BANTEN",28,124,140,264
https://kawalpemilu.org#53181,"CIATER, SERPONG, KOTA TANGERANG SELATAN, BANTEN",29,0,0,0
https://kawalpemilu.org#53181,"CIATER, SERPONG, KOTA TANGERANG SELATAN, BANTEN",30,161,76,237
https://kawalpemilu.org#53181,"CIATER, SERPONG, KOTA TANGERANG SELATAN, BANTEN",31,81,92,173
https://kawalpemilu.org#53181,"CIATER, SERPONG, KOTA TANGERANG SELATAN, BANTEN",32,131,58,189
https://kawalpemilu.org#53181,"CIATER, SERPONG, KOTA TANGERANG SELATAN, BANTEN",33,104,122,226
https://kawalpemilu.org#53181,"CIATER, SERPONG, KOTA TANGERANG SELATAN, BANTEN",34,148,89,237
https://kawalpemilu.org#53181,"CIATER, SERPONG, KOTA TANGERANG SELATAN, BANTEN",35,117,100,217
https://kawalpemilu.org#53181,"CIATER, SERPONG, KOTA TANGERANG SELATAN, BANTEN",36,78,150,228
https://kawalpemilu.org#53181,"CIATER, SERPONG, KOTA TANGERANG SELATAN, BANTEN",37,173,39,212
https://kawalpemilu.org#53181,"CIATER, SERPONG, KOTA TANGERANG SELATAN, BANTEN",38,144,52,196
https://kawalpemilu.org#53181,"CIATER, SERPONG, KOTA TANGERANG SELATAN, BANTEN",39,96,107,203
https://kawalpemilu.org#53181,"CIATER, SERPONG, KOTA TANGERANG SELATAN, BANTEN",40,113,113,226
https://kawalpemilu.org#53181,"CIATER, SERPONG, KOTA TANGERANG SELATAN, BANTEN",41,72,90,162
https://kawalpemilu.org#53181,"CIATER, SERPONG, KOTA TANGERANG SELATAN, BANTEN",42,60,84,144
https://kawalpemilu.org#53181,"CIATER, SERPONG, KOTA TANGERANG SELATAN, BANTEN",43,145,47,192
https://kawalpemilu.org#53181,"CIATER, SERPONG, KOTA TANGERANG SELATAN, BANTEN",44,145,24,169
https://kawalpemilu.org#53181,"CIATER, SERPONG, KOTA TANGERANG SELATAN, BANTEN",45,81,87,168
https://kawalpemilu.org#53181,"CIATER, SERPONG, KOTA TANGERANG SELATAN, BANTEN",46,112,58,170
https://kawalpemilu.org#53181,"CIATER, SERPONG, KOTA TANGERANG SELATAN, BANTEN",47,107,120,227
https://kawalpemilu.org#53181,"CIATER, SERPONG, KOTA TANGERANG SELATAN, BANTEN",48,102,121,223
https://kawalpemilu.org#53181,"CIATER, SERPONG, KOTA TANGERANG SELATAN, BANTEN",49,98,128,226
https://kawalpemilu.org#53181,"CIATER, SERPONG, KOTA TANGERANG SELATAN, BANTEN",50,89,103,192
https://kawalpemilu.org#53181,"CIATER, SERPONG, KOTA TANGERANG SELATAN, BANTEN",51,99,149,248
https://kawalpemilu.org#53181,"CIATER, SERPONG, KOTA TANGERANG SELATAN, BANTEN",52,111,143,254
https://kawalpemilu.org#53181,"CIATER, SERPONG, KOTA TANGERANG SELATAN, BANTEN",53,109,121,230
https://kawalpemilu.org#53181,"CIATER, SERPONG, KOTA TANGERANG SELATAN, BANTEN",54,91,108,199
https://kawalpemilu.org#53181,"CIATER, SERPONG, KOTA TANGERANG SELATAN, BANTEN",55,90,106,196
https://kawalpemilu.org#53181,"CIATER, SERPONG, KOTA TANGERANG SELATAN, BANTEN",56,84,130,173
https://kawalpemilu.org#53181,"CIATER, SERPONG, KOTA TANGERANG SELATAN, BANTEN",57,88,128,216
https://kawalpemilu.org#53181,"CIATER, SERPONG, KOTA TANGERANG SELATAN, BANTEN",58,0,0,0
https://kawalpemilu.org#53181,"CIATER, SERPONG, KOTA TANGERANG SELATAN, BANTEN",59,83,108,191
https://kawalpemilu.org#53181,"CIATER, SERPONG, KOTA TANGERANG SELATAN, BANTEN",60,75,116,191
https://kawalpemilu.org#53181,"CIATER, SERPONG, KOTA TANGERANG SELATAN, BANTEN",61,178,72,250
https://kawalpemilu.org#53181,"CIATER, SERPONG, KOTA TANGERANG SELATAN, BANTEN",62,122,115,237
https://kawalpemilu.org#53181,"CIATER, SERPONG, KOTA TANGERANG SELATAN, BANTEN",63,132,97,229
https://kawalpemilu.org#53182,"RAWA BUNTU, SERPONG, KOTA TANGERANG SELATAN, BANTEN",1,42,92,134
https://kawalpemilu.org#53182,"RAWA BUNTU, SERPONG, KOTA TANGERANG SELATAN, BANTEN",2,56,95,151
https://kawalpemilu.org#53182,"RAWA BUNTU, SERPONG, KOTA TANGERANG SELATAN, BANTEN",3,87,91,178
https://kawalpemilu.org#53182,"RAWA BUNTU, SERPONG, KOTA TANGERANG SELATAN, BANTEN",4,67,102,169
https://kawalpemilu.org#53182,"RAWA BUNTU, SERPONG, KOTA TANGERANG SELATAN, BANTEN",5,53,92,145
https://kawalpemilu.org#53182,"RAWA BUNTU, SERPONG, KOTA TANGERANG SELATAN, BANTEN",6,67,136,203
https://kawalpemilu.org#53182,"RAWA BUNTU, SERPONG, KOTA TANGERANG SELATAN, BANTEN",7,87,90,177
https://kawalpemilu.org#53182,"RAWA BUNTU, SERPONG, KOTA TANGERANG SELATAN, BANTEN",8,126,92,218
https://kawalpemilu.org#53182,"RAWA BUNTU, SERPONG, KOTA TANGERANG SELATAN, BANTEN",9,113,117,230
https://kawalpemilu.org#53182,"RAWA BUNTU, SERPONG, KOTA TANGERANG SELATAN, BANTEN",10,72,97,169
https://kawalpemilu.org#53182,"RAWA BUNTU, SERPONG, KOTA TANGERANG SELATAN, BANTEN",11,42,102,146
https://kawalpemilu.org#53182,"RAWA BUNTU, SERPONG, KOTA TANGERANG SELATAN, BANTEN",12,44,98,142
https://kawalpemilu.org#53182,"RAWA BUNTU, SERPONG, KOTA TANGERANG SELATAN, BANTEN",13,111,151,262
https://kawalpemilu.org#53182,"RAWA BUNTU, SERPONG, KOTA TANGERANG SELATAN, BANTEN",14,78,90,168
https://kawalpemilu.org#53182,"RAWA BUNTU, SERPONG, KOTA TANGERANG SELATAN, BANTEN",15,71,143,214
https://kawalpemilu.org#53182,"RAWA BUNTU, SERPONG, KOTA TANGERANG SELATAN, BANTEN",16,91,139,230
https://kawalpemilu.org#53182,"RAWA BUNTU, SERPONG, KOTA TANGERANG SELATAN, BANTEN",17,65,116,181
https://kawalpemilu.org#53182,"RAWA BUNTU, SERPONG, KOTA TANGERANG SELATAN, BANTEN",18,95,142,237
https://kawalpemilu.org#53182,"RAWA BUNTU, SERPONG, KOTA TANGERANG SELATAN, BANTEN",19,105,146,251
https://kawalpemilu.org#53182,"RAWA BUNTU, SERPONG, KOTA TANGERANG SELATAN, BANTEN",20,76,162,238
https://kawalpemilu.org#53182,"RAWA BUNTU, SERPONG, KOTA TANGERANG SELATAN, BANTEN",21,104,118,222
https://kawalpemilu.org#53182,"RAWA BUNTU, SERPONG, KOTA TANGERANG SELATAN, BANTEN",22,78,127,205
https://kawalpemilu.org#53182,"RAWA BUNTU, SERPONG, KOTA TANGERANG SELATAN, BANTEN",23,122,106,228
https://kawalpemilu.org#53182,"RAWA BUNTU, SERPONG, KOTA TANGERANG SELATAN, BANTEN",24,85,137,222
https://kawalpemilu.org#53182,"RAWA BUNTU, SERPONG, KOTA TANGERANG SELATAN, BANTEN",25,85,116,201
https://kawalpemilu.org#53182,"RAWA BUNTU, SERPONG, KOTA TANGERANG SELATAN, BANTEN",26,72,122,194
https://kawalpemilu.org#53182,"RAWA BUNTU, SERPONG, KOTA TANGERANG SELATAN, BANTEN",27,107,43,150
https://kawalpemilu.org#53182,"RAWA BUNTU, SERPONG, KOTA TANGERANG SELATAN, BANTEN",28,110,47,157
https://kawalpemilu.org#53182,"RAWA BUNTU, SERPONG, KOTA TANGERANG SELATAN, BANTEN",29,125,30,155
https://kawalpemilu.org#53182,"RAWA BUNTU, SERPONG, KOTA TANGERANG SELATAN, BANTEN",30,91,31,122
https://kawalpemilu.org#53182,"RAWA BUNTU, SERPONG, KOTA TANGERANG SELATAN, BANTEN",31,140,72,212
https://kawalpemilu.org#53182,"RAWA BUNTU, SERPONG, KOTA TANGERANG SELATAN, BANTEN",32,162,101,263
https://kawalpemilu.org#53182,"RAWA BUNTU, SERPONG, KOTA TANGERANG SELATAN, BANTEN",33,209,57,266
https://kawalpemilu.org#53182,"RAWA BUNTU, SERPONG, KOTA TANGERANG SELATAN, BANTEN",34,182,41,223
https://kawalpemilu.org#53182,"RAWA BUNTU, SERPONG, KOTA TANGERANG SELATAN, BANTEN",35,187,47,234
https://kawalpemilu.org#53182,"RAWA BUNTU, SERPONG, KOTA TANGERANG SELATAN, BANTEN",36,141,41,182
https://kawalpemilu.org#53182,"RAWA BUNTU, SERPONG, KOTA TANGERANG SELATAN, BANTEN",37,129,78,207
https://kawalpemilu.org#53182,"RAWA BUNTU, SERPONG, KOTA TANGERANG SELATAN, BANTEN",38,131,44,175
https://kawalpemilu.org#53182,"RAWA BUNTU, SERPONG, KOTA TANGERANG SELATAN, BANTEN",39,141,35,176
https://kawalpemilu.org#53182,"RAWA BUNTU, SERPONG, KOTA TANGERANG SELATAN, BANTEN",40,119,42,161
https://kawalpemilu.org#53182,"RAWA BUNTU, SERPONG, KOTA TANGERANG SELATAN, BANTEN",41,152,58,210
https://kawalpemilu.org#53182,"RAWA BUNTU, SERPONG, KOTA TANGERANG SELATAN, BANTEN",42,97,66,163
https://kawalpemilu.org#53182,"RAWA BUNTU, SERPONG, KOTA TANGERANG SELATAN, BANTEN",43,174,88,262
https://kawalpemilu.org#53182,"RAWA BUNTU, SERPONG, KOTA TANGERANG SELATAN, BANTEN",44,183,106,289
https://kawalpemilu.org#53182,"RAWA BUNTU, SERPONG, KOTA TANGERANG SELATAN, BANTEN",45,115,63,178
https://kawalpemilu.org#53182,"RAWA BUNTU, SERPONG, KOTA TANGERANG SELATAN, BANTEN",46,119,83,202
https://kawalpemilu.org#53182,"RAWA BUNTU, SERPONG, KOTA TANGERANG SELATAN, BANTEN",47,165,25,190
https://kawalpemilu.org#53182,"RAWA BUNTU, SERPONG, KOTA TANGERANG SELATAN, BANTEN",48,147,55,1
https://kawalpemilu.org#53182,"RAWA BUNTU, SERPONG, KOTA TANGERANG SELATAN, BANTEN",49,151,53,204
https://kawalpemilu.org#53182,"RAWA BUNTU, SERPONG, KOTA TANGERANG SELATAN, BANTEN",50,101,36,137
https://kawalpemilu.org#53182,"RAWA BUNTU, SERPONG, KOTA TANGERANG SELATAN, BANTEN",51,147,50,197
https://kawalpemilu.org#53182,"RAWA BUNTU, SERPONG, KOTA TANGERANG SELATAN, BANTEN",52,146,36,182
https://kawalpemilu.org#53182,"RAWA BUNTU, SERPONG, KOTA TANGERANG SELATAN, BANTEN",53,146,29,2
https://kawalpemilu.org#53182,"RAWA BUNTU, SERPONG, KOTA TANGERANG SELATAN, BANTEN",54,96,26,122
https://kawalpemilu.org#53182,"RAWA BUNTU, SERPONG, KOTA TANGERANG SELATAN, BANTEN",55,157,46,203
https://kawalpemilu.org#53182,"RAWA BUNTU, SERPONG, KOTA TANGERANG SELATAN, BANTEN",56,162,16,178
https://kawalpemilu.org#53182,"RAWA BUNTU, SERPONG, KOTA TANGERANG SELATAN, BANTEN",57,172,33,205
https://kawalpemilu.org#53182,"RAWA BUNTU, SERPONG, KOTA TANGERANG SELATAN, BANTEN",58,129,38,167
https://kawalpemilu.org#53182,"RAWA BUNTU, SERPONG, KOTA TANGERANG SELATAN, BANTEN",59,111,76,187
https://kawalpemilu.org#53182,"RAWA BUNTU, SERPONG, KOTA TANGERANG SELATAN, BANTEN",60,129,76,205
https://kawalpemilu.org#53182,"RAWA BUNTU, SERPONG, KOTA TANGERANG SELATAN, BANTEN",61,138,49,187
https://kawalpemilu.org#53182,"RAWA BUNTU, SERPONG, KOTA TANGERANG SELATAN, BANTEN",62,107,58,165
https://kawalpemilu.org#53182,"RAWA BUNTU, SERPONG, KOTA TANGERANG SELATAN, BANTEN",63,148,52,200
https://kawalpemilu.org#53182,"RAWA BUNTU, SERPONG, KOTA TANGERANG SELATAN, BANTEN",64,113,45,158
https://kawalpemilu.org#53182,"RAWA BUNTU, SERPONG, KOTA TANGERANG SELATAN, BANTEN",65,167,98,265
https://kawalpemilu.org#53182,"RAWA BUNTU, SERPONG, KOTA TANGERANG SELATAN, BANTEN",66,118,67,185
https://kawalpemilu.org#53182,"RAWA BUNTU, SERPONG, KOTA TANGERANG SELATAN, BANTEN",67,99,58,157
https://kawalpemilu.org#53182,"RAWA BUNTU, SERPONG, KOTA TANGERANG SELATAN, BANTEN",68,135,64,199
https://kawalpemilu.org#53182,"RAWA BUNTU, SERPONG, KOTA TANGERANG SELATAN, BANTEN",69,111,67,178
https://kawalpemilu.org#53182,"RAWA BUNTU, SERPONG, KOTA TANGERANG SELATAN, BANTEN",70,68,38,106
https://kawalpemilu.org#53182,"RAWA BUNTU, SERPONG, KOTA TANGERANG SELATAN, BANTEN",71,149,88,237
https://kawalpemilu.org#53182,"RAWA BUNTU, SERPONG, KOTA TANGERANG SELATAN, BANTEN",72,119,71,190
https://kawalpemilu.org#53182,"RAWA BUNTU, SERPONG, KOTA TANGERANG SELATAN, BANTEN",73,132,70,202
https://kawalpemilu.org#53182,"RAWA BUNTU, SERPONG, KOTA TANGERANG SELATAN, BANTEN",74,126,68,194
https://kawalpemilu.org#53182,"RAWA BUNTU, SERPONG, KOTA TANGERANG SELATAN, BANTEN",75,97,52,149
https://kawalpemilu.org#53182,"RAWA BUNTU, SERPONG, KOTA TANGERANG SELATAN, BANTEN",76,182,96,278
https://kawalpemilu.org#53182,"RAWA BUNTU, SERPONG, KOTA TANGERANG SELATAN, BANTEN",77,185,43,228
https://kawalpemilu.org#53182,"RAWA BUNTU, SERPONG, KOTA TANGERANG SELATAN, BANTEN",78,95,54,149
https://kawalpemilu.org#53182,"RAWA BUNTU, SERPONG, KOTA TANGERANG SELATAN, BANTEN",79,137,48,185
https://kawalpemilu.org#53182,"RAWA BUNTU, SERPONG, KOTA TANGERANG SELATAN, BANTEN",80,145,96,241
https://kawalpemilu.org#53182,"RAWA BUNTU, SERPONG, KOTA TANGERANG SELATAN, BANTEN",81,195,97,292
https://kawalpemilu.org#53182,"RAWA BUNTU, SERPONG, KOTA TANGERANG SELATAN, BANTEN",82,199,73,272
https://kawalpemilu.org#53182,"RAWA BUNTU, SERPONG, KOTA TANGERANG SELATAN, BANTEN",83,163,34,197
https://kawalpemilu.org#53182,"RAWA BUNTU, SERPONG, KOTA TANGERANG SELATAN, BANTEN",84,89,71,160
https://kawalpemilu.org#53182,"RAWA BUNTU, SERPONG, KOTA TANGERANG SELATAN, BANTEN",85,102,44,146
https://kawalpemilu.org#53182,"RAWA BUNTU, SERPONG, KOTA TANGERANG SELATAN, BANTEN",86,162,109,271
https://kawalpemilu.org#53182,"RAWA BUNTU, SERPONG, KOTA TANGERANG SELATAN, BANTEN",87,123,137,260
https://kawalpemilu.org#53183,"RAWA MEKAR JAYA, SERPONG, KOTA TANGERANG SELATAN, BANTEN",1,98,92,190
https://kawalpemilu.org#53183,"RAWA MEKAR JAYA, SERPONG, KOTA TANGERANG SELATAN, BANTEN",2,140,82,222
https://kawalpemilu.org#53183,"RAWA MEKAR JAYA, SERPONG, KOTA TANGERANG SELATAN, BANTEN",3,125,90,215
https://kawalpemilu.org#53183,"RAWA MEKAR JAYA, SERPONG, KOTA TANGERANG SELATAN, BANTEN",4,109,117,226
https://kawalpemilu.org#53183,"RAWA MEKAR JAYA, SERPONG, KOTA TANGERANG SELATAN, BANTEN",5,79,134,213
https://kawalpemilu.org#53183,"RAWA MEKAR JAYA, SERPONG, KOTA TANGERANG SELATAN, BANTEN",6,101,151,252
https://kawalpemilu.org#53183,"RAWA MEKAR JAYA, SERPONG, KOTA TANGERANG SELATAN, BANTEN",7,81,149,230
https://kawalpemilu.org#53183,"RAWA MEKAR JAYA, SERPONG, KOTA TANGERANG SELATAN, BANTEN",8,92,125,217
https://kawalpemilu.org#53183,"RAWA MEKAR JAYA, SERPONG, KOTA TANGERANG SELATAN, BANTEN",9,73,104,177
https://kawalpemilu.org#53183,"RAWA MEKAR JAYA, SERPONG, KOTA TANGERANG SELATAN, BANTEN",10,105,127,232
https://kawalpemilu.org#53183,"RAWA MEKAR JAYA, SERPONG, KOTA TANGERANG SELATAN, BANTEN",11,75,180,255
https://kawalpemilu.org#53183,"RAWA MEKAR JAYA, SERPONG, KOTA TANGERANG SELATAN, BANTEN",12,98,135,233
https://kawalpemilu.org#53183,"RAWA MEKAR JAYA, SERPONG, KOTA TANGERANG SELATAN, BANTEN",13,102,142,244
https://kawalpemilu.org#53183,"RAWA MEKAR JAYA, SERPONG, KOTA TANGERANG SELATAN, BANTEN",14,183,74,257
https://kawalpemilu.org#53183,"RAWA MEKAR JAYA, SERPONG, KOTA TANGERANG SELATAN, BANTEN",15,94,129,223
https://kawalpemilu.org#53183,"RAWA MEKAR JAYA, SERPONG, KOTA TANGERANG SELATAN, BANTEN",16,96,112,208
https://kawalpemilu.org#53183,"RAWA MEKAR JAYA, SERPONG, KOTA TANGERANG SELATAN, BANTEN",17,87,183,270
https://kawalpemilu.org#53183,"RAWA MEKAR JAYA, SERPONG, KOTA TANGERANG SELATAN, BANTEN",18,85,139,224
https://kawalpemilu.org#53183,"RAWA MEKAR JAYA, SERPONG, KOTA TANGERANG SELATAN, BANTEN",19,72,153,225
https://kawalpemilu.org#53183,"RAWA MEKAR JAYA, SERPONG, KOTA TANGERANG SELATAN, BANTEN",20,82,171,253
https://kawalpemilu.org#53183,"RAWA MEKAR JAYA, SERPONG, KOTA TANGERANG SELATAN, BANTEN",21,82,134,216
https://kawalpemilu.org#53183,"RAWA MEKAR JAYA, SERPONG, KOTA TANGERANG SELATAN, BANTEN",22,159,66,225
https://kawalpemilu.org#53183,"RAWA MEKAR JAYA, SERPONG, KOTA TANGERANG SELATAN, BANTEN",23,159,87,246
https://kawalpemilu.org#53183,"RAWA MEKAR JAYA, SERPONG, KOTA TANGERANG SELATAN, BANTEN",24,165,83,248
https://kawalpemilu.org#53183,"RAWA MEKAR JAYA, SERPONG, KOTA TANGERANG SELATAN, BANTEN",25,153,59,212
https://kawalpemilu.org#53183,"RAWA MEKAR JAYA, SERPONG, KOTA TANGERANG SELATAN, BANTEN",27,75,38,113
https://kawalpemilu.org#53183,"RAWA MEKAR JAYA, SERPONG, KOTA TANGERANG SELATAN, BANTEN",28,78,115,193
https://kawalpemilu.org#53183,"RAWA MEKAR JAYA, SERPONG, KOTA TANGERANG SELATAN, BANTEN",29,105,102,207
https://kawalpemilu.org#53183,"RAWA MEKAR JAYA, SERPONG, KOTA TANGERANG SELATAN, BANTEN",30,125,103,228
https://kawalpemilu.org#53183,"RAWA MEKAR JAYA, SERPONG, KOTA TANGERANG SELATAN, BANTEN",31,160,92,252
https://kawalpemilu.org#53183,"RAWA MEKAR JAYA, SERPONG, KOTA TANGERANG SELATAN, BANTEN",32,224,74,298
https://kawalpemilu.org#53183,"RAWA MEKAR JAYA, SERPONG, KOTA TANGERANG SELATAN, BANTEN",33,198,24,222
https://kawalpemilu.org#53183,"RAWA MEKAR JAYA, SERPONG, KOTA TANGERANG SELATAN, BANTEN",34,172,7,179
https://kawalpemilu.org#53183,"RAWA MEKAR JAYA, SERPONG, KOTA TANGERANG SELATAN, BANTEN",35,156,43,199
https://kawalpemilu.org#53183,"RAWA MEKAR JAYA, SERPONG, KOTA TANGERANG SELATAN, BANTEN",36,236,28,264
https://kawalpemilu.org#53183,"RAWA MEKAR JAYA, SERPONG, KOTA TANGERANG SELATAN, BANTEN",37,206,26,232
https://kawalpemilu.org#53183,"RAWA MEKAR JAYA, SERPONG, KOTA TANGERANG SELATAN, BANTEN",38,252,28,280
https://kawalpemilu.org#53183,"RAWA MEKAR JAYA, SERPONG, KOTA TANGERANG SELATAN, BANTEN",39,202,43,245
https://kawalpemilu.org#53183,"RAWA MEKAR JAYA, SERPONG, KOTA TANGERANG SELATAN, BANTEN",40,173,31,204
https://kawalpemilu.org#53183,"RAWA MEKAR JAYA, SERPONG, KOTA TANGERANG SELATAN, BANTEN",41,173,33,206
https://kawalpemilu.org#53183,"RAWA MEKAR JAYA, SERPONG, KOTA TANGERANG SELATAN, BANTEN",42,172,59,231
https://kawalpemilu.org#53183,"RAWA MEKAR JAYA, SERPONG, KOTA TANGERANG SELATAN, BANTEN",43,160,56,216
https://kawalpemilu.org#53183,"RAWA MEKAR JAYA, SERPONG, KOTA TANGERANG SELATAN, BANTEN",44,0,0,0
https://kawalpemilu.org#53183,"RAWA MEKAR JAYA, SERPONG, KOTA TANGERANG SELATAN, BANTEN",45,173,72,245
https://kawalpemilu.org#53183,"RAWA MEKAR JAYA, SERPONG, KOTA TANGERANG SELATAN, BANTEN",46,175,86,261
https://kawalpemilu.org#53184,"LENGKONG GUDANG, SERPONG, KOTA TANGERANG SELATAN, BANTEN",1,65,200,265
https://kawalpemilu.org#53184,"LENGKONG GUDANG, SERPONG, KOTA TANGERANG SELATAN, BANTEN",2,62,151,213
https://kawalpemilu.org#53184,"LENGKONG GUDANG, SERPONG, KOTA TANGERANG SELATAN, BANTEN",3,85,175,260
https://kawalpemilu.org#53184,"LENGKONG GUDANG, SERPONG, KOTA TANGERANG SELATAN, BANTEN",4,223,20,243
https://kawalpemilu.org#53184,"LENGKONG GUDANG, SERPONG, KOTA TANGERANG SELATAN, BANTEN",5,64,199,263
https://kawalpemilu.org#53184,"LENGKONG GUDANG, SERPONG, KOTA TANGERANG SELATAN, BANTEN",6,53,219,272
https://kawalpemilu.org#53184,"LENGKONG GUDANG, SERPONG, KOTA TANGERANG SELATAN, BANTEN",7,110,151,261
https://kawalpemilu.org#53184,"LENGKONG GUDANG, SERPONG, KOTA TANGERANG SELATAN, BANTEN",8,224,29,253
https://kawalpemilu.org#53184,"LENGKONG GUDANG, SERPONG, KOTA TANGERANG SELATAN, BANTEN",9,223,20,243
https://kawalpemilu.org#53184,"LENGKONG GUDANG, SERPONG, KOTA TANGERANG SELATAN, BANTEN",10,160,97,257
https://kawalpemilu.org#53184,"LENGKONG GUDANG, SERPONG, KOTA TANGERANG SELATAN, BANTEN",11,82,135,217
https://kawalpemilu.org#53184,"LENGKONG GUDANG, SERPONG, KOTA TANGERANG SELATAN, BANTEN",12,79,149,228
https://kawalpemilu.org#53184,"LENGKONG GUDANG, SERPONG, KOTA TANGERANG SELATAN, BANTEN",13,102,135,237
https://kawalpemilu.org#53184,"LENGKONG GUDANG, SERPONG, KOTA TANGERANG SELATAN, BANTEN",14,87,156,243
https://kawalpemilu.org#53184,"LENGKONG GUDANG, SERPONG, KOTA TANGERANG SELATAN, BANTEN",15,64,140,204
https://kawalpemilu.org#53184,"LENGKONG GUDANG, SERPONG, KOTA TANGERANG SELATAN, BANTEN",16,60,184,244
https://kawalpemilu.org#53184,"LENGKONG GUDANG, SERPONG, KOTA TANGERANG SELATAN, BANTEN",17,95,97,192
https://kawalpemilu.org#53184,"LENGKONG GUDANG, SERPONG, KOTA TANGERANG SELATAN, BANTEN",18,97,157,254
https://kawalpemilu.org#53184,"LENGKONG GUDANG, SERPONG, KOTA TANGERANG SELATAN, BANTEN",19,70,139,209
https://kawalpemilu.org#53184,"LENGKONG GUDANG, SERPONG, KOTA TANGERANG SELATAN, BANTEN",20,87,187,274
https://kawalpemilu.org#53184,"LENGKONG GUDANG, SERPONG, KOTA TANGERANG SELATAN, BANTEN",21,102,141,243
https://kawalpemilu.org#53184,"LENGKONG GUDANG, SERPONG, KOTA TANGERANG SELATAN, BANTEN",22,168,45,213
https://kawalpemilu.org#53184,"LENGKONG GUDANG, SERPONG, KOTA TANGERANG SELATAN, BANTEN",23,151,62,213
https://kawalpemilu.org#53184,"LENGKONG GUDANG, SERPONG, KOTA TANGERANG SELATAN, BANTEN",24,161,66,227
https://kawalpemilu.org#53184,"LENGKONG GUDANG, SERPONG, KOTA TANGERANG SELATAN, BANTEN",25,156,83,239
https://kawalpemilu.org#53184,"LENGKONG GUDANG, SERPONG, KOTA TANGERANG SELATAN, BANTEN",26,144,51,195
https://kawalpemilu.org#53184,"LENGKONG GUDANG, SERPONG, KOTA TANGERANG SELATAN, BANTEN",27,144,46,190
https://kawalpemilu.org#53184,"LENGKONG GUDANG, SERPONG, KOTA TANGERANG SELATAN, BANTEN",28,105,80,185
https://kawalpemilu.org#53184,"LENGKONG GUDANG, SERPONG, KOTA TANGERANG SELATAN, BANTEN",29,127,85,212
https://kawalpemilu.org#53184,"LENGKONG GUDANG, SERPONG, KOTA TANGERANG SELATAN, BANTEN",30,149,87,236
https://kawalpemilu.org#53184,"LENGKONG GUDANG, SERPONG, KOTA TANGERANG SELATAN, BANTEN",31,82,214,296
https://kawalpemilu.org#53185,"LENGKONG WETAN, SERPONG, KOTA TANGERANG SELATAN, BANTEN",1,44,211,255
https://kawalpemilu.org#53185,"LENGKONG WETAN, SERPONG, KOTA TANGERANG SELATAN, BANTEN",2,54,190,244
https://kawalpemilu.org#53185,"LENGKONG WETAN, SERPONG, KOTA TANGERANG SELATAN, BANTEN",3,0,0,0
https://kawalpemilu.org#53185,"LENGKONG WETAN, SERPONG, KOTA TANGERANG SELATAN, BANTEN",4,156,66,222
https://kawalpemilu.org#53185,"LENGKONG WETAN, SERPONG, KOTA TANGERANG SELATAN, BANTEN",5,197,49,246
https://kawalpemilu.org#53185,"LENGKONG WETAN, SERPONG, KOTA TANGERANG SELATAN, BANTEN",6,176,25,201
https://kawalpemilu.org#53185,"LENGKONG WETAN, SERPONG, KOTA TANGERANG SELATAN, BANTEN",7,153,45,198
https://kawalpemilu.org#53185,"LENGKONG WETAN, SERPONG, KOTA TANGERANG SELATAN, BANTEN",8,167,14,181
https://kawalpemilu.org#53185,"LENGKONG WETAN, SERPONG, KOTA TANGERANG SELATAN, BANTEN",9,175,45,220
https://kawalpemilu.org#53185,"LENGKONG WETAN, SERPONG, KOTA TANGERANG SELATAN, BANTEN",10,153,46,199
https://kawalpemilu.org#53185,"LENGKONG WETAN, SERPONG, KOTA TANGERANG SELATAN, BANTEN",11,162,30,192
https://kawalpemilu.org#53185,"LENGKONG WETAN, SERPONG, KOTA TANGERANG SELATAN, BANTEN",12,97,16,113
https://kawalpemilu.org#53185,"LENGKONG WETAN, SERPONG, KOTA TANGERANG SELATAN, BANTEN",13,136,22,158
https://kawalpemilu.org#53185,"LENGKONG WETAN, SERPONG, KOTA TANGERANG SELATAN, BANTEN",14,115,128,243
https://kawalpemilu.org#53185,"LENGKONG WETAN, SERPONG, KOTA TANGERANG SELATAN, BANTEN",15,140,116,256
https://kawalpemilu.org#53185,"LENGKONG WETAN, SERPONG, KOTA TANGERANG SELATAN, BANTEN",16,98,148,246
https://kawalpemilu.org#53185,"LENGKONG WETAN, SERPONG, KOTA TANGERANG SELATAN, BANTEN",17,84,165,249
https://kawalpemilu.org#53185,"LENGKONG WETAN, SERPONG, KOTA TANGERANG SELATAN, BANTEN",18,92,165,257
https://kawalpemilu.org#53185,"LENGKONG WETAN, SERPONG, KOTA TANGERANG SELATAN, BANTEN",19,78,112,190
https://kawalpemilu.org#53185,"LENGKONG WETAN, SERPONG, KOTA TANGERANG SELATAN, BANTEN",20,110,113,223
https://kawalpemilu.org#53185,"LENGKONG WETAN, SERPONG, KOTA TANGERANG SELATAN, BANTEN",21,70,134,204
https://kawalpemilu.org#53185,"LENGKONG WETAN, SERPONG, KOTA TANGERANG SELATAN, BANTEN",22,168,63,231
https://kawalpemilu.org#53185,"LENGKONG WETAN, SERPONG, KOTA TANGERANG SELATAN, BANTEN",23,118,134,252
https://kawalpemilu.org#53185,"LENGKONG WETAN, SERPONG, KOTA TANGERANG SELATAN, BANTEN",24,85,183,268
https://kawalpemilu.org#53185,"LENGKONG WETAN, SERPONG, KOTA TANGERANG SELATAN, BANTEN",25,88,156,244
https://kawalpemilu.org#53185,"LENGKONG WETAN, SERPONG, KOTA TANGERANG SELATAN, BANTEN",26,70,154,224
https://kawalpemilu.org#53185,"LENGKONG WETAN, SERPONG, KOTA TANGERANG SELATAN, BANTEN",27,92,127,219
https://kawalpemilu.org#53186,"BUARAN, SERPONG, KOTA TANGERANG SELATAN, BANTEN",1,156,100,256
https://kawalpemilu.org#53186,"BUARAN, SERPONG, KOTA TANGERANG SELATAN, BANTEN",2,102,140,242
https://kawalpemilu.org#53186,"BUARAN, SERPONG, KOTA TANGERANG SELATAN, BANTEN",3,89,158,247
https://kawalpemilu.org#53186,"BUARAN, SERPONG, KOTA TANGERANG SELATAN, BANTEN",4,89,157,246
https://kawalpemilu.org#53186,"BUARAN, SERPONG, KOTA TANGERANG SELATAN, BANTEN",5,121,134,255
https://kawalpemilu.org#53186,"BUARAN, SERPONG, KOTA TANGERANG SELATAN, BANTEN",6,109,154,263
https://kawalpemilu.org#53186,"BUARAN, SERPONG, KOTA TANGERANG SELATAN, BANTEN",7,121,138,259
https://kawalpemilu.org#53186,"BUARAN, SERPONG, KOTA TANGERANG SELATAN, BANTEN",8,126,146,272
https://kawalpemilu.org#53186,"BUARAN, SERPONG, KOTA TANGERANG SELATAN, BANTEN",9,140,108,248
https://kawalpemilu.org#53186,"BUARAN, SERPONG, KOTA TANGERANG SELATAN, BANTEN",10,87,119,206
https://kawalpemilu.org#53186,"BUARAN, SERPONG, KOTA TANGERANG SELATAN, BANTEN",11,115,127,242
https://kawalpemilu.org#53186,"BUARAN, SERPONG, KOTA TANGERANG SELATAN, BANTEN",12,120,136,256
https://kawalpemilu.org#53186,"BUARAN, SERPONG, KOTA TANGERANG SELATAN, BANTEN",13,144,84,228
https://kawalpemilu.org#53186,"BUARAN, SERPONG, KOTA TANGERANG SELATAN, BANTEN",14,112,153,265
https://kawalpemilu.org#53186,"BUARAN, SERPONG, KOTA TANGERANG SELATAN, BANTEN",15,99,151,250
https://kawalpemilu.org#53186,"BUARAN, SERPONG, KOTA TANGERANG SELATAN, BANTEN",16,144,134,278
https://kawalpemilu.org#53186,"BUARAN, SERPONG, KOTA TANGERANG SELATAN, BANTEN",17,99,132,231
https://kawalpemilu.org#53186,"BUARAN, SERPONG, KOTA TANGERANG SELATAN, BANTEN",18,73,122,195
https://kawalpemilu.org#53186,"BUARAN, SERPONG, KOTA TANGERANG SELATAN, BANTEN",19,101,145,246
https://kawalpemilu.org#53186,"BUARAN, SERPONG, KOTA TANGERANG SELATAN, BANTEN",20,121,146,267
https://kawalpemilu.org#53186,"BUARAN, SERPONG, KOTA TANGERANG SELATAN, BANTEN",21,108,161,269
https://kawalpemilu.org#53186,"BUARAN, SERPONG, KOTA TANGERANG SELATAN, BANTEN",22,110,160,270
https://kawalpemilu.org#53186,"BUARAN, SERPONG, KOTA TANGERANG SELATAN, BANTEN",23,119,114,233
https://kawalpemilu.org#53186,"BUARAN, SERPONG, KOTA TANGERANG SELATAN, BANTEN",24,89,139,228
https://kawalpemilu.org#53186,"BUARAN, SERPONG, KOTA TANGERANG SELATAN, BANTEN",25,100,136,236
https://kawalpemilu.org#53186,"BUARAN, SERPONG, KOTA TANGERANG SELATAN, BANTEN",26,103,127,230
https://kawalpemilu.org#53186,"BUARAN, SERPONG, KOTA TANGERANG SELATAN, BANTEN",27,112,113,225
https://kawalpemilu.org#53186,"BUARAN, SERPONG, KOTA TANGERANG SELATAN, BANTEN",28,93,117,210
https://kawalpemilu.org#53186,"BUARAN, SERPONG, KOTA TANGERANG SELATAN, BANTEN",29,159,106,265
https://kawalpemilu.org#53186,"BUARAN, SERPONG, KOTA TANGERANG SELATAN, BANTEN",30,108,139,247
https://kawalpemilu.org#53186,"BUARAN, SERPONG, KOTA TANGERANG SELATAN, BANTEN",31,126,133,259
https://kawalpemilu.org#53186,"BUARAN, SERPONG, KOTA TANGERANG SELATAN, BANTEN",32,121,101,222
https://kawalpemilu.org#53186,"BUARAN, SERPONG, KOTA TANGERANG SELATAN, BANTEN",33,143,135,278
https://kawalpemilu.org#53186,"BUARAN, SERPONG, KOTA TANGERANG SELATAN, BANTEN",34,104,119,223
https://kawalpemilu.org#53186,"BUARAN, SERPONG, KOTA TANGERANG SELATAN, BANTEN",35,88,142,230
https://kawalpemilu.org#53186,"BUARAN, SERPONG, KOTA TANGERANG SELATAN, BANTEN",36,115,141,256
https://kawalpemilu.org#53186,"BUARAN, SERPONG, KOTA TANGERANG SELATAN, BANTEN",37,136,135,271
https://kawalpemilu.org#53186,"BUARAN, SERPONG, KOTA TANGERANG SELATAN, BANTEN",38,164,114,278
https://kawalpemilu.org#53186,"BUARAN, SERPONG, KOTA TANGERANG SELATAN, BANTEN",39,119,135,254
https://kawalpemilu.org#53186,"BUARAN, SERPONG, KOTA TANGERANG SELATAN, BANTEN",40,81,132,213
https://kawalpemilu.org#53186,"BUARAN, SERPONG, KOTA TANGERANG SELATAN, BANTEN",41,122,106,228
https://kawalpemilu.org#53186,"BUARAN, SERPONG, KOTA TANGERANG SELATAN, BANTEN",42,71,93,164
https://kawalpemilu.org#53186,"BUARAN, SERPONG, KOTA TANGERANG SELATAN, BANTEN",43,74,73,147
https://kawalpemilu.org#53187,"LENGKONG GUDANG TIMUR, SERPONG, KOTA TANGERANG SELATAN, BANTEN",1,67,79,161
https://kawalpemilu.org#53187,"LENGKONG GUDANG TIMUR, SERPONG, KOTA TANGERANG SELATAN, BANTEN",2,78,138,216
https://kawalpemilu.org#53187,"LENGKONG GUDANG TIMUR, SERPONG, KOTA TANGERANG SELATAN, BANTEN",3,95,165,260
https://kawalpemilu.org#53187,"LENGKONG GUDANG TIMUR, SERPONG, KOTA TANGERANG SELATAN, BANTEN",4,129,151,280
https://kawalpemilu.org#53187,"LENGKONG GUDANG TIMUR, SERPONG, KOTA TANGERANG SELATAN, BANTEN",6,108,131,239
https://kawalpemilu.org#53187,"LENGKONG GUDANG TIMUR, SERPONG, KOTA TANGERANG SELATAN, BANTEN",7,142,151,293
https://kawalpemilu.org#53187,"LENGKONG GUDANG TIMUR, SERPONG, KOTA TANGERANG SELATAN, BANTEN",8,130,134,264
https://kawalpemilu.org#53187,"LENGKONG GUDANG TIMUR, SERPONG, KOTA TANGERANG SELATAN, BANTEN",9,115,123,238
https://kawalpemilu.org#53187,"LENGKONG GUDANG TIMUR, SERPONG, KOTA TANGERANG SELATAN, BANTEN",10,119,146,265
https://kawalpemilu.org#53187,"LENGKONG GUDANG TIMUR, SERPONG, KOTA TANGERANG SELATAN, BANTEN",11,78,159,237
https://kawalpemilu.org#53187,"LENGKONG GUDANG TIMUR, SERPONG, KOTA TANGERANG SELATAN, BANTEN",12,79,171,250
https://kawalpemilu.org#53187,"LENGKONG GUDANG TIMUR, SERPONG, KOTA TANGERANG SELATAN, BANTEN",13,114,143,257
https://kawalpemilu.org#53187,"LENGKONG GUDANG TIMUR, SERPONG, KOTA TANGERANG SELATAN, BANTEN",14,116,131,247
https://kawalpemilu.org#53187,"LENGKONG GUDANG TIMUR, SERPONG, KOTA TANGERANG SELATAN, BANTEN",16,76,169,245
https://kawalpemilu.org#53187,"LENGKONG GUDANG TIMUR, SERPONG, KOTA TANGERANG SELATAN, BANTEN",17,122,116,232
https://kawalpemilu.org#53187,"LENGKONG GUDANG TIMUR, SERPONG, KOTA TANGERANG SELATAN, BANTEN",18,117,13,130
https://kawalpemilu.org#53187,"LENGKONG GUDANG TIMUR, SERPONG, KOTA TANGERANG SELATAN, BANTEN",19,134,9,143
https://kawalpemilu.org#53187,"LENGKONG GUDANG TIMUR, SERPONG, KOTA TANGERANG SELATAN, BANTEN",20,161,58,219
https://kawalpemilu.org#53187,"LENGKONG GUDANG TIMUR, SERPONG, KOTA TANGERANG SELATAN, BANTEN",21,150,72,222
https://kawalpemilu.org#53187,"LENGKONG GUDANG TIMUR, SERPONG, KOTA TANGERANG SELATAN, BANTEN",22,134,36,170
https://kawalpemilu.org#53187,"LENGKONG GUDANG TIMUR, SERPONG, KOTA TANGERANG SELATAN, BANTEN",23,123,49,172
https://kawalpemilu.org#53187,"LENGKONG GUDANG TIMUR, SERPONG, KOTA TANGERANG SELATAN, BANTEN",24,114,46,160
https://kawalpemilu.org#53187,"LENGKONG GUDANG TIMUR, SERPONG, KOTA TANGERANG SELATAN, BANTEN",25,125,9,134
https://kawalpemilu.org#53187,"LENGKONG GUDANG TIMUR, SERPONG, KOTA TANGERANG SELATAN, BANTEN",26,166,35,201
https://kawalpemilu.org#53187,"LENGKONG GUDANG TIMUR, SERPONG, KOTA TANGERANG SELATAN, BANTEN",27,193,34,227
https://kawalpemilu.org#53187,"LENGKONG GUDANG TIMUR, SERPONG, KOTA TANGERANG SELATAN, BANTEN",28,131,26,157
https://kawalpemilu.org#53187,"LENGKONG GUDANG TIMUR, SERPONG, KOTA TANGERANG SELATAN, BANTEN",29,129,31,160
https://kawalpemilu.org#53187,"LENGKONG GUDANG TIMUR, SERPONG, KOTA TANGERANG SELATAN, BANTEN",30,150,12,162
https://kawalpemilu.org#53187,"LENGKONG GUDANG TIMUR, SERPONG, KOTA TANGERANG SELATAN, BANTEN",31,128,26,154
https://kawalpemilu.org#53187,"LENGKONG GUDANG TIMUR, SERPONG, KOTA TANGERANG SELATAN, BANTEN",32,153,32,185
https://kawalpemilu.org#53187,"LENGKONG GUDANG TIMUR, SERPONG, KOTA TANGERANG SELATAN, BANTEN",33,203,27,230
https://kawalpemilu.org#53187,"LENGKONG GUDANG TIMUR, SERPONG, KOTA TANGERANG SELATAN, BANTEN",34,110,38,148
https://kawalpemilu.org#53188,"CILENGGANG, SERPONG, KOTA TANGERANG SELATAN, BANTEN",1,227,64,291
https://kawalpemilu.org#53188,"CILENGGANG, SERPONG, KOTA TANGERANG SELATAN, BANTEN",2,144,44,188
https://kawalpemilu.org#53188,"CILENGGANG, SERPONG, KOTA TANGERANG SELATAN, BANTEN",3,188,43,231
https://kawalpemilu.org#53188,"CILENGGANG, SERPONG, KOTA TANGERANG SELATAN, BANTEN",4,215,36,251
https://kawalpemilu.org#53188,"CILENGGANG, SERPONG, KOTA TANGERANG SELATAN, BANTEN",5,93,157,250
https://kawalpemilu.org#53188,"CILENGGANG, SERPONG, KOTA TANGERANG SELATAN, BANTEN",6,72,128,200
https://kawalpemilu.org#53188,"CILENGGANG, SERPONG, KOTA TANGERANG SELATAN, BANTEN",7,99,125,224
https://kawalpemilu.org#53188,"CILENGGANG, SERPONG, KOTA TANGERANG SELATAN, BANTEN",8,81,134,215
https://kawalpemilu.org#53188,"CILENGGANG, SERPONG, KOTA TANGERANG SELATAN, BANTEN",9,63,121,184
https://kawalpemilu.org#53188,"CILENGGANG, SERPONG, KOTA TANGERANG SELATAN, BANTEN",10,112,142,254
https://kawalpemilu.org#53188,"CILENGGANG, SERPONG, KOTA TANGERANG SELATAN, BANTEN",11,83,168,251
https://kawalpemilu.org#53188,"CILENGGANG, SERPONG, KOTA TANGERANG SELATAN, BANTEN",12,103,145,248
https://kawalpemilu.org#53188,"CILENGGANG, SERPONG, KOTA TANGERANG SELATAN, BANTEN",13,97,163,260
https://kawalpemilu.org#53188,"CILENGGANG, SERPONG, KOTA TANGERANG SELATAN, BANTEN",14,117,151,268
https://kawalpemilu.org#53188,"CILENGGANG, SERPONG, KOTA TANGERANG SELATAN, BANTEN",15,60,137,197
https://kawalpemilu.org#53188,"CILENGGANG, SERPONG, KOTA TANGERANG SELATAN, BANTEN",16,67,122,189
https://kawalpemilu.org#53188,"CILENGGANG, SERPONG, KOTA TANGERANG SELATAN, BANTEN",17,79,117,196
https://kawalpemilu.org#53188,"CILENGGANG, SERPONG, KOTA TANGERANG SELATAN, BANTEN",18,67,129,196
https://kawalpemilu.org#53188,"CILENGGANG, SERPONG, KOTA TANGERANG SELATAN, BANTEN",19,53,157,210
https://kawalpemilu.org#53188,"CILENGGANG, SERPONG, KOTA TANGERANG SELATAN, BANTEN",20,100,173,273
https://kawalpemilu.org#53188,"CILENGGANG, SERPONG, KOTA TANGERANG SELATAN, BANTEN",21,93,153,246
https://kawalpemilu.org#53188,"CILENGGANG, SERPONG, KOTA TANGERANG SELATAN, BANTEN",22,82,126,208
https://kawalpemilu.org#53188,"CILENGGANG, SERPONG, KOTA TANGERANG SELATAN, BANTEN",23,108,146,254
https://kawalpemilu.org#53188,"CILENGGANG, SERPONG, KOTA TANGERANG SELATAN, BANTEN",24,112,116,228
https://kawalpemilu.org#53188,"CILENGGANG, SERPONG, KOTA TANGERANG SELATAN, BANTEN",25,112,114,226
https://kawalpemilu.org#53188,"CILENGGANG, SERPONG, KOTA TANGERANG SELATAN, BANTEN",26,232,22,254
https://kawalpemilu.org#53188,"CILENGGANG, SERPONG, KOTA TANGERANG SELATAN, BANTEN",27,213,23,236
https://kawalpemilu.org#53189,"SERPONG, SERPONG, KOTA TANGERANG SELATAN, BANTEN",1,76,181,257
https://kawalpemilu.org#53189,"SERPONG, SERPONG, KOTA TANGERANG SELATAN, BANTEN",2,73,141,214
https://kawalpemilu.org#53189,"SERPONG, SERPONG, KOTA TANGERANG SELATAN, BANTEN",3,89,182,271
https://kawalpemilu.org#53189,"SERPONG, SERPONG, KOTA TANGERANG SELATAN, BANTEN",4,62,184,246
https://kawalpemilu.org#53189,"SERPONG, SERPONG, KOTA TANGERANG SELATAN, BANTEN",5,77,148,225
https://kawalpemilu.org#53189,"SERPONG, SERPONG, KOTA TANGERANG SELATAN, BANTEN",6,99,178,277
https://kawalpemilu.org#53189,"SERPONG, SERPONG, KOTA TANGERANG SELATAN, BANTEN",7,117,105,222
https://kawalpemilu.org#53189,"SERPONG, SERPONG, KOTA TANGERANG SELATAN, BANTEN",8,109,97,206
https://kawalpemilu.org#53189,"SERPONG, SERPONG, KOTA TANGERANG SELATAN, BANTEN",9,85,89,174
https://kawalpemilu.org#53189,"SERPONG, SERPONG, KOTA TANGERANG SELATAN, BANTEN",10,71,146,217
https://kawalpemilu.org#53189,"SERPONG, SERPONG, KOTA TANGERANG SELATAN, BANTEN",11,70,118,188
https://kawalpemilu.org#53189,"SERPONG, SERPONG, KOTA TANGERANG SELATAN, BANTEN",12,78,140,218
https://kawalpemilu.org#53189,"SERPONG, SERPONG, KOTA TANGERANG SELATAN, BANTEN",13,96,173,269
https://kawalpemilu.org#53189,"SERPONG, SERPONG, KOTA TANGERANG SELATAN, BANTEN",14,97,169,266
https://kawalpemilu.org#53189,"SERPONG, SERPONG, KOTA TANGERANG SELATAN, BANTEN",15,115,138,253
https://kawalpemilu.org#53189,"SERPONG, SERPONG, KOTA TANGERANG SELATAN, BANTEN",16,110,136,246
https://kawalpemilu.org#53189,"SERPONG, SERPONG, KOTA TANGERANG SELATAN, BANTEN",17,92,114,206
https://kawalpemilu.org#53189,"SERPONG, SERPONG, KOTA TANGERANG SELATAN, BANTEN",18,64,133,197
https://kawalpemilu.org#53189,"SERPONG, SERPONG, KOTA TANGERANG SELATAN, BANTEN",19,76,113,189
https://kawalpemilu.org#53189,"SERPONG, SERPONG, KOTA TANGERANG SELATAN, BANTEN",20,64,208,272
https://kawalpemilu.org#53189,"SERPONG, SERPONG, KOTA TANGERANG SELATAN, BANTEN",21,105,166,271
https://kawalpemilu.org#53189,"SERPONG, SERPONG, KOTA TANGERANG SELATAN, BANTEN",23,70,135,205
https://kawalpemilu.org#53189,"SERPONG, SERPONG, KOTA TANGERANG SELATAN, BANTEN",24,82,186,268
https://kawalpemilu.org#53189,"SERPONG, SERPONG, KOTA TANGERANG SELATAN, BANTEN",25,97,157,254
https://kawalpemilu.org#53189,"SERPONG, SERPONG, KOTA TANGERANG SELATAN, BANTEN",26,89,147,236
https://kawalpemilu.org#53189,"SERPONG, SERPONG, KOTA TANGERANG SELATAN, BANTEN",27,118,116,234
https://kawalpemilu.org#53189,"SERPONG, SERPONG, KOTA TANGERANG SELATAN, BANTEN",28,113,120,233
https://kawalpemilu.org#53189,"SERPONG, SERPONG, KOTA TANGERANG SELATAN, BANTEN",29,164,99,263
https://kawalpemilu.org#53189,"SERPONG, SERPONG, KOTA TANGERANG SELATAN, BANTEN",30,146,83,229
https://kawalpemilu.org#53189,"SERPONG, SERPONG, KOTA TANGERANG SELATAN, BANTEN",31,89,107,196
https://kawalpemilu.org#53189,"SERPONG, SERPONG, KOTA TANGERANG SELATAN, BANTEN",32,70,112,182
https://kawalpemilu.org#53189,"SERPONG, SERPONG, KOTA TANGERANG SELATAN, BANTEN",33,129,73,202
https://kawalpemilu.org#53189,"SERPONG, SERPONG, KOTA TANGERANG SELATAN, BANTEN",34,69,100,169
https://kawalpemilu.org#53189,"SERPONG, SERPONG, KOTA TANGERANG SELATAN, BANTEN",35,62,99,161
https://kawalpemilu.org#53189,"SERPONG, SERPONG, KOTA TANGERANG SELATAN, BANTEN",36,111,120,231
https://kawalpemilu.org#53189,"SERPONG, SERPONG, KOTA TANGERANG SELATAN, BANTEN",37,102,80,182
https://kawalpemilu.org#53189,"SERPONG, SERPONG, KOTA TANGERANG SELATAN, BANTEN",38,89,103,192
https://kawalpemilu.org#53189,"SERPONG, SERPONG, KOTA TANGERANG SELATAN, BANTEN",39,107,111,227
https://kawalpemilu.org#53189,"SERPONG, SERPONG, KOTA TANGERANG SELATAN, BANTEN",40,103,151,254
https://kawalpemilu.org#53189,"SERPONG, SERPONG, KOTA TANGERANG SELATAN, BANTEN",41,124,147,271
https://kawalpemilu.org#53189,"SERPONG, SERPONG, KOTA TANGERANG SELATAN, BANTEN",42,68,131,199
https://kawalpemilu.org#53189,"SERPONG, SERPONG, KOTA TANGERANG SELATAN, BANTEN",43,43,76,119
https://kawalpemilu.org#53189,"SERPONG, SERPONG, KOTA TANGERANG SELATAN, BANTEN",44,69,100,169
https://kawalpemilu.org#53189,"SERPONG, SERPONG, KOTA TANGERANG SELATAN, BANTEN",45,87,114,201
https://kawalpemilu.org#53189,"SERPONG, SERPONG, KOTA TANGERANG SELATAN, BANTEN",46,98,111,209
https://kawalpemilu.org#53189,"SERPONG, SERPONG, KOTA TANGERANG SELATAN, BANTEN",47,74,109,183
https://kawalpemilu.org#53189,"SERPONG, SERPONG, KOTA TANGERANG SELATAN, BANTEN",48,97,79,176
https://kawalpemilu.org#53189,"SERPONG, SERPONG, KOTA TANGERANG SELATAN, BANTEN",49,87,90,177
https://kawalpemilu.org#53189,"SERPONG, SERPONG, KOTA TANGERANG SELATAN, BANTEN",50,232,45,277
https://kawalpemilu.org#53189,"SERPONG, SERPONG, KOTA TANGERANG SELATAN, BANTEN",51,198,88,286
https://kawalpemilu.org#53189,"SERPONG, SERPONG, KOTA TANGERANG SELATAN, BANTEN",52,219,80,299
https://kawalpemilu.org#53191,"PAKULONAN, SERPONG UTARA, KOTA TANGERANG SELATAN, BANTEN",1,122,158,280
https://kawalpemilu.org#53191,"PAKULONAN, SERPONG UTARA, KOTA TANGERANG SELATAN, BANTEN",2,140,72,212
https://kawalpemilu.org#53191,"PAKULONAN, SERPONG UTARA, KOTA TANGERANG SELATAN, BANTEN",3,71,98,169
https://kawalpemilu.org#53191,"PAKULONAN, SERPONG UTARA, KOTA TANGERANG SELATAN, BANTEN",4,118,107,225
https://kawalpemilu.org#53191,"PAKULONAN, SERPONG UTARA, KOTA TANGERANG SELATAN, BANTEN",5,73,109,182
https://kawalpemilu.org#53191,"PAKULONAN, SERPONG UTARA, KOTA TANGERANG SELATAN, BANTEN",6,73,96,169
https://kawalpemilu.org#53191,"PAKULONAN, SERPONG UTARA, KOTA TANGERANG SELATAN, BANTEN",7,66,101,167
https://kawalpemilu.org#53191,"PAKULONAN, SERPONG UTARA, KOTA TANGERANG SELATAN, BANTEN",8,81,164,245
https://kawalpemilu.org#53191,"PAKULONAN, SERPONG UTARA, KOTA TANGERANG SELATAN, BANTEN",9,119,134,253
https://kawalpemilu.org#53191,"PAKULONAN, SERPONG UTARA, KOTA TANGERANG SELATAN, BANTEN",10,111,88,199
https://kawalpemilu.org#53191,"PAKULONAN, SERPONG UTARA, KOTA TANGERANG SELATAN, BANTEN",11,107,130,237
https://kawalpemilu.org#53191,"PAKULONAN, SERPONG UTARA, KOTA TANGERANG SELATAN, BANTEN",12,99,92,191
https://kawalpemilu.org#53191,"PAKULONAN, SERPONG UTARA, KOTA TANGERANG SELATAN, BANTEN",13,78,93,171
https://kawalpemilu.org#53191,"PAKULONAN, SERPONG UTARA, KOTA TANGERANG SELATAN, BANTEN",14,126,147,273
https://kawalpemilu.org#53191,"PAKULONAN, SERPONG UTARA, KOTA TANGERANG SELATAN, BANTEN",15,106,184,290
https://kawalpemilu.org#53191,"PAKULONAN, SERPONG UTARA, KOTA TANGERANG SELATAN, BANTEN",16,68,73,141
https://kawalpemilu.org#53191,"PAKULONAN, SERPONG UTARA, KOTA TANGERANG SELATAN, BANTEN",17,78,86,164
https://kawalpemilu.org#53191,"PAKULONAN, SERPONG UTARA, KOTA TANGERANG SELATAN, BANTEN",18,126,155,281
https://kawalpemilu.org#53191,"PAKULONAN, SERPONG UTARA, KOTA TANGERANG SELATAN, BANTEN",19,46,177,223
https://kawalpemilu.org#53191,"PAKULONAN, SERPONG UTARA, KOTA TANGERANG SELATAN, BANTEN",20,32,217,249
https://kawalpemilu.org#53191,"PAKULONAN, SERPONG UTARA, KOTA TANGERANG SELATAN, BANTEN",21,111,123,234
https://kawalpemilu.org#53191,"PAKULONAN, SERPONG UTARA, KOTA TANGERANG SELATAN, BANTEN",22,115,168,283
https://kawalpemilu.org#53191,"PAKULONAN, SERPONG UTARA, KOTA TANGERANG SELATAN, BANTEN",23,100,151,251
https://kawalpemilu.org#53191,"PAKULONAN, SERPONG UTARA, KOTA TANGERANG SELATAN, BANTEN",24,141,125,266
https://kawalpemilu.org#53191,"PAKULONAN, SERPONG UTARA, KOTA TANGERANG SELATAN, BANTEN",25,175,56,231
https://kawalpemilu.org#53191,"PAKULONAN, SERPONG UTARA, KOTA TANGERANG SELATAN, BANTEN",26,75,36,111
https://kawalpemilu.org#53191,"PAKULONAN, SERPONG UTARA, KOTA TANGERANG SELATAN, BANTEN",27,160,4,164
https://kawalpemilu.org#53191,"PAKULONAN, SERPONG UTARA, KOTA TANGERANG SELATAN, BANTEN",28,212,19,231
https://kawalpemilu.org#53191,"PAKULONAN, SERPONG UTARA, KOTA TANGERANG SELATAN, BANTEN",29,189,16,205
https://kawalpemilu.org#53191,"PAKULONAN, SERPONG UTARA, KOTA TANGERANG SELATAN, BANTEN",30,107,105,212
https://kawalpemilu.org#53191,"PAKULONAN, SERPONG UTARA, KOTA TANGERANG SELATAN, BANTEN",31,113,87,200
https://kawalpemilu.org#53191,"PAKULONAN, SERPONG UTARA, KOTA TANGERANG SELATAN, BANTEN",32,82,83,165
https://kawalpemilu.org#53192,"PAKUALAM, SERPONG UTARA, KOTA TANGERANG SELATAN, BANTEN",1,87,135,222
https://kawalpemilu.org#53192,"PAKUALAM, SERPONG UTARA, KOTA TANGERANG SELATAN, BANTEN",2,137,141,278
https://kawalpemilu.org#53192,"PAKUALAM, SERPONG UTARA, KOTA TANGERANG SELATAN, BANTEN",3,84,127,211
https://kawalpemilu.org#53192,"PAKUALAM, SERPONG UTARA, KOTA TANGERANG SELATAN, BANTEN",4,104,107,211
https://kawalpemilu.org#53192,"PAKUALAM, SERPONG UTARA, KOTA TANGERANG SELATAN, BANTEN",5,101,121,222
https://kawalpemilu.org#53192,"PAKUALAM, SERPONG UTARA, KOTA TANGERANG SELATAN, BANTEN",6,98,106,204
https://kawalpemilu.org#53192,"PAKUALAM, SERPONG UTARA, KOTA TANGERANG SELATAN, BANTEN",7,115,105,220
https://kawalpemilu.org#53192,"PAKUALAM, SERPONG UTARA, KOTA TANGERANG SELATAN, BANTEN",8,87,100,187
https://kawalpemilu.org#53192,"PAKUALAM, SERPONG UTARA, KOTA TANGERANG SELATAN, BANTEN",9,89,121,210
https://kawalpemilu.org#53192,"PAKUALAM, SERPONG UTARA, KOTA TANGERANG SELATAN, BANTEN",10,102,90,192
https://kawalpemilu.org#53192,"PAKUALAM, SERPONG UTARA, KOTA TANGERANG SELATAN, BANTEN",11,100,181,281
https://kawalpemilu.org#53192,"PAKUALAM, SERPONG UTARA, KOTA TANGERANG SELATAN, BANTEN",12,127,139,266
https://kawalpemilu.org#53192,"PAKUALAM, SERPONG UTARA, KOTA TANGERANG SELATAN, BANTEN",13,77,157,234
https://kawalpemilu.org#53192,"PAKUALAM, SERPONG UTARA, KOTA TANGERANG SELATAN, BANTEN",14,202,54,256
https://kawalpemilu.org#53192,"PAKUALAM, SERPONG UTARA, KOTA TANGERANG SELATAN, BANTEN",15,54,193,247
https://kawalpemilu.org#53192,"PAKUALAM, SERPONG UTARA, KOTA TANGERANG SELATAN, BANTEN",16,84,197,281
https://kawalpemilu.org#53192,"PAKUALAM, SERPONG UTARA, KOTA TANGERANG SELATAN, BANTEN",17,67,196,263
https://kawalpemilu.org#53192,"PAKUALAM, SERPONG UTARA, KOTA TANGERANG SELATAN, BANTEN",18,94,115,209
https://kawalpemilu.org#53192,"PAKUALAM, SERPONG UTARA, KOTA TANGERANG SELATAN, BANTEN",19,109,150,259
https://kawalpemilu.org#53192,"PAKUALAM, SERPONG UTARA, KOTA TANGERANG SELATAN, BANTEN",20,147,138,285
https://kawalpemilu.org#53192,"PAKUALAM, SERPONG UTARA, KOTA TANGERANG SELATAN, BANTEN",21,81,140,221
https://kawalpemilu.org#53192,"PAKUALAM, SERPONG UTARA, KOTA TANGERANG SELATAN, BANTEN",22,103,79,182
https://kawalpemilu.org#53192,"PAKUALAM, SERPONG UTARA, KOTA TANGERANG SELATAN, BANTEN",23,64,117,181
https://kawalpemilu.org#53192,"PAKUALAM, SERPONG UTARA, KOTA TANGERANG SELATAN, BANTEN",24,99,88,187
https://kawalpemilu.org#53192,"PAKUALAM, SERPONG UTARA, KOTA TANGERANG SELATAN, BANTEN",25,115,95,210
https://kawalpemilu.org#53192,"PAKUALAM, SERPONG UTARA, KOTA TANGERANG SELATAN, BANTEN",26,114,134,248
https://kawalpemilu.org#53192,"PAKUALAM, SERPONG UTARA, KOTA TANGERANG SELATAN, BANTEN",27,258,20,278
https://kawalpemilu.org#53192,"PAKUALAM, SERPONG UTARA, KOTA TANGERANG SELATAN, BANTEN",28,52,104,156
https://kawalpemilu.org#53192,"PAKUALAM, SERPONG UTARA, KOTA TANGERANG SELATAN, BANTEN",29,156,62,218
https://kawalpemilu.org#53192,"PAKUALAM, SERPONG UTARA, KOTA TANGERANG SELATAN, BANTEN",30,116,80,196
https://kawalpemilu.org#53192,"PAKUALAM, SERPONG UTARA, KOTA TANGERANG SELATAN, BANTEN",31,121,17,138
https://kawalpemilu.org#53192,"PAKUALAM, SERPONG UTARA, KOTA TANGERANG SELATAN, BANTEN",32,167,26,193
https://kawalpemilu.org#53192,"PAKUALAM, SERPONG UTARA, KOTA TANGERANG SELATAN, BANTEN",33,83,158,241
https://kawalpemilu.org#53192,"PAKUALAM, SERPONG UTARA, KOTA TANGERANG SELATAN, BANTEN",34,130,130,260
https://kawalpemilu.org#53192,"PAKUALAM, SERPONG UTARA, KOTA TANGERANG SELATAN, BANTEN",35,103,190,293
https://kawalpemilu.org#53192,"PAKUALAM, SERPONG UTARA, KOTA TANGERANG SELATAN, BANTEN",36,85,90,175
https://kawalpemilu.org#53192,"PAKUALAM, SERPONG UTARA, KOTA TANGERANG SELATAN, BANTEN",37,113,118,231
https://kawalpemilu.org#53192,"PAKUALAM, SERPONG UTARA, KOTA TANGERANG SELATAN, BANTEN",38,123,135,258
https://kawalpemilu.org#53192,"PAKUALAM, SERPONG UTARA, KOTA TANGERANG SELATAN, BANTEN",39,222,20,242
https://kawalpemilu.org#53193,"PAKU JAYA, SERPONG UTARA, KOTA TANGERANG SELATAN, BANTEN",1,111,119,230
https://kawalpemilu.org#53193,"PAKU JAYA, SERPONG UTARA, KOTA TANGERANG SELATAN, BANTEN",2,76,141,217
https://kawalpemilu.org#53193,"PAKU JAYA, SERPONG UTARA, KOTA TANGERANG SELATAN, BANTEN",3,92,164,256
https://kawalpemilu.org#53193,"PAKU JAYA, SERPONG UTARA, KOTA TANGERANG SELATAN, BANTEN",4,88,204,292
https://kawalpemilu.org#53193,"PAKU JAYA, SERPONG UTARA, KOTA TANGERANG SELATAN, BANTEN",5,61,109,170
https://kawalpemilu.org#53193,"PAKU JAYA, SERPONG UTARA, KOTA TANGERANG SELATAN, BANTEN",7,95,154,249
https://kawalpemilu.org#53193,"PAKU JAYA, SERPONG UTARA, KOTA TANGERANG SELATAN, BANTEN",8,88,165,253
https://kawalpemilu.org#53193,"PAKU JAYA, SERPONG UTARA, KOTA TANGERANG SELATAN, BANTEN",9,133,110,243
https://kawalpemilu.org#53193,"PAKU JAYA, SERPONG UTARA, KOTA TANGERANG SELATAN, BANTEN",10,97,96,193
https://kawalpemilu.org#53193,"PAKU JAYA, SERPONG UTARA, KOTA TANGERANG SELATAN, BANTEN",11,94,109,203
https://kawalpemilu.org#53193,"PAKU JAYA, SERPONG UTARA, KOTA TANGERANG SELATAN, BANTEN",12,99,116,215
https://kawalpemilu.org#53193,"PAKU JAYA, SERPONG UTARA, KOTA TANGERANG SELATAN, BANTEN",13,105,122,227
https://kawalpemilu.org#53193,"PAKU JAYA, SERPONG UTARA, KOTA TANGERANG SELATAN, BANTEN",15,77,153,230
https://kawalpemilu.org#53193,"PAKU JAYA, SERPONG UTARA, KOTA TANGERANG SELATAN, BANTEN",16,85,93,178
https://kawalpemilu.org#53193,"PAKU JAYA, SERPONG UTARA, KOTA TANGERANG SELATAN, BANTEN",18,50,26,76
https://kawalpemilu.org#53193,"PAKU JAYA, SERPONG UTARA, KOTA TANGERANG SELATAN, BANTEN",20,152,128,280
https://kawalpemilu.org#53193,"PAKU JAYA, SERPONG UTARA, KOTA TANGERANG SELATAN, BANTEN",21,92,156,248
https://kawalpemilu.org#53193,"PAKU JAYA, SERPONG UTARA, KOTA TANGERANG SELATAN, BANTEN",22,139,120,259
https://kawalpemilu.org#53193,"PAKU JAYA, SERPONG UTARA, KOTA TANGERANG SELATAN, BANTEN",23,102,104,206
https://kawalpemilu.org#53193,"PAKU JAYA, SERPONG UTARA, KOTA TANGERANG SELATAN, BANTEN",24,58,136,194
https://kawalpemilu.org#53193,"PAKU JAYA, SERPONG UTARA, KOTA TANGERANG SELATAN, BANTEN",25,83,90,173
https://kawalpemilu.org#53193,"PAKU JAYA, SERPONG UTARA, KOTA TANGERANG SELATAN, BANTEN",26,122,143,265
https://kawalpemilu.org#53193,"PAKU JAYA, SERPONG UTARA, KOTA TANGERANG SELATAN, BANTEN",27,98,180,278
https://kawalpemilu.org#53193,"PAKU JAYA, SERPONG UTARA, KOTA TANGERANG SELATAN, BANTEN",28,68,143,211
https://kawalpemilu.org#53193,"PAKU JAYA, SERPONG UTARA, KOTA TANGERANG SELATAN, BANTEN",29,79,159,238
https://kawalpemilu.org#53193,"PAKU JAYA, SERPONG UTARA, KOTA TANGERANG SELATAN, BANTEN",30,77,90,167
https://kawalpemilu.org#53193,"PAKU JAYA, SERPONG UTARA, KOTA TANGERANG SELATAN, BANTEN",31,121,125,246
https://kawalpemilu.org#53193,"PAKU JAYA, SERPONG UTARA, KOTA TANGERANG SELATAN, BANTEN",32,160,92,252
https://kawalpemilu.org#53193,"PAKU JAYA, SERPONG UTARA, KOTA TANGERANG SELATAN, BANTEN",33,143,102,245
https://kawalpemilu.org#53193,"PAKU JAYA, SERPONG UTARA, KOTA TANGERANG SELATAN, BANTEN",34,123,95,218
https://kawalpemilu.org#53193,"PAKU JAYA, SERPONG UTARA, KOTA TANGERANG SELATAN, BANTEN",35,130,133,263
https://kawalpemilu.org#53193,"PAKU JAYA, SERPONG UTARA, KOTA TANGERANG SELATAN, BANTEN",36,112,155,267
https://kawalpemilu.org#53193,"PAKU JAYA, SERPONG UTARA, KOTA TANGERANG SELATAN, BANTEN",37,179,69,248
https://kawalpemilu.org#53193,"PAKU JAYA, SERPONG UTARA, KOTA TANGERANG SELATAN, BANTEN",38,169,69,238
https://kawalpemilu.org#53193,"PAKU JAYA, SERPONG UTARA, KOTA TANGERANG SELATAN, BANTEN",40,106,48,154
https://kawalpemilu.org#53193,"PAKU JAYA, SERPONG UTARA, KOTA TANGERANG SELATAN, BANTEN",41,138,15,153
https://kawalpemilu.org#53193,"PAKU JAYA, SERPONG UTARA, KOTA TANGERANG SELATAN, BANTEN",42,91,50,141
https://kawalpemilu.org#53193,"PAKU JAYA, SERPONG UTARA, KOTA TANGERANG SELATAN, BANTEN",43,130,53,183
https://kawalpemilu.org#53193,"PAKU JAYA, SERPONG UTARA, KOTA TANGERANG SELATAN, BANTEN",44,224,33,257
https://kawalpemilu.org#53193,"PAKU JAYA, SERPONG UTARA, KOTA TANGERANG SELATAN, BANTEN",45,102,69,171
https://kawalpemilu.org#53193,"PAKU JAYA, SERPONG UTARA, KOTA TANGERANG SELATAN, BANTEN",46,171,67,238
https://kawalpemilu.org#53193,"PAKU JAYA, SERPONG UTARA, KOTA TANGERANG SELATAN, BANTEN",47,166,72,238
https://kawalpemilu.org#53193,"PAKU JAYA, SERPONG UTARA, KOTA TANGERANG SELATAN, BANTEN",48,150,54,204
https://kawalpemilu.org#53193,"PAKU JAYA, SERPONG UTARA, KOTA TANGERANG SELATAN, BANTEN",49,114,76,190
https://kawalpemilu.org#53193,"PAKU JAYA, SERPONG UTARA, KOTA TANGERANG SELATAN, BANTEN",50,132,46,178
https://kawalpemilu.org#53193,"PAKU JAYA, SERPONG UTARA, KOTA TANGERANG SELATAN, BANTEN",51,72,61,133
https://kawalpemilu.org#53193,"PAKU JAYA, SERPONG UTARA, KOTA TANGERANG SELATAN, BANTEN",52,86,122,208
https://kawalpemilu.org#53193,"PAKU JAYA, SERPONG UTARA, KOTA TANGERANG SELATAN, BANTEN",53,93,152,245
https://kawalpemilu.org#53193,"PAKU JAYA, SERPONG UTARA, KOTA TANGERANG SELATAN, BANTEN",55,70,112,182
https://kawalpemilu.org#53193,"PAKU JAYA, SERPONG UTARA, KOTA TANGERANG SELATAN, BANTEN",56,127,125,252
https://kawalpemilu.org#53193,"PAKU JAYA, SERPONG UTARA, KOTA TANGERANG SELATAN, BANTEN",57,108,88,196
https://kawalpemilu.org#53193,"PAKU JAYA, SERPONG UTARA, KOTA TANGERANG SELATAN, BANTEN",58,171,81,252
https://kawalpemilu.org#53193,"PAKU JAYA, SERPONG UTARA, KOTA TANGERANG SELATAN, BANTEN",59,125,87,212
https://kawalpemilu.org#53193,"PAKU JAYA, SERPONG UTARA, KOTA TANGERANG SELATAN, BANTEN",60,107,87,194
https://kawalpemilu.org#53193,"PAKU JAYA, SERPONG UTARA, KOTA TANGERANG SELATAN, BANTEN",61,120,104,224
https://kawalpemilu.org#53193,"PAKU JAYA, SERPONG UTARA, KOTA TANGERANG SELATAN, BANTEN",62,147,75,222
https://kawalpemilu.org#53193,"PAKU JAYA, SERPONG UTARA, KOTA TANGERANG SELATAN, BANTEN",63,114,85,199
https://kawalpemilu.org#53193,"PAKU JAYA, SERPONG UTARA, KOTA TANGERANG SELATAN, BANTEN",64,146,64,210
https://kawalpemilu.org#53193,"PAKU JAYA, SERPONG UTARA, KOTA TANGERANG SELATAN, BANTEN",65,70,129,199
https://kawalpemilu.org#53193,"PAKU JAYA, SERPONG UTARA, KOTA TANGERANG SELATAN, BANTEN",66,86,113,199
https://kawalpemilu.org#53193,"PAKU JAYA, SERPONG UTARA, KOTA TANGERANG SELATAN, BANTEN",67,57,120,177
https://kawalpemilu.org#53193,"PAKU JAYA, SERPONG UTARA, KOTA TANGERANG SELATAN, BANTEN",68,81,190,271
https://kawalpemilu.org#53193,"PAKU JAYA, SERPONG UTARA, KOTA TANGERANG SELATAN, BANTEN",69,64,58,122
https://kawalpemilu.org#53193,"PAKU JAYA, SERPONG UTARA, KOTA TANGERANG SELATAN, BANTEN",70,34,54,88
https://kawalpemilu.org#53193,"PAKU JAYA, SERPONG UTARA, KOTA TANGERANG SELATAN, BANTEN",71,94,35,129
https://kawalpemilu.org#53193,"PAKU JAYA, SERPONG UTARA, KOTA TANGERANG SELATAN, BANTEN",72,87,107,194
https://kawalpemilu.org#53193,"PAKU JAYA, SERPONG UTARA, KOTA TANGERANG SELATAN, BANTEN",73,81,128,209
https://kawalpemilu.org#53194,"PONDOK JAGUNG, SERPONG UTARA, KOTA TANGERANG SELATAN, BANTEN",1,78,143,221
https://kawalpemilu.org#53194,"PONDOK JAGUNG, SERPONG UTARA, KOTA TANGERANG SELATAN, BANTEN",2,115,122,237
https://kawalpemilu.org#53194,"PONDOK JAGUNG, SERPONG UTARA, KOTA TANGERANG SELATAN, BANTEN",3,112,109,221
https://kawalpemilu.org#53194,"PONDOK JAGUNG, SERPONG UTARA, KOTA TANGERANG SELATAN, BANTEN",4,114,105,219
https://kawalpemilu.org#53194,"PONDOK JAGUNG, SERPONG UTARA, KOTA TANGERANG SELATAN, BANTEN",5,89,92,181
https://kawalpemilu.org#53194,"PONDOK JAGUNG, SERPONG UTARA, KOTA TANGERANG SELATAN, BANTEN",6,96,112,208
https://kawalpemilu.org#53194,"PONDOK JAGUNG, SERPONG UTARA, KOTA TANGERANG SELATAN, BANTEN",7,82,88,170
https://kawalpemilu.org#53194,"PONDOK JAGUNG, SERPONG UTARA, KOTA TANGERANG SELATAN, BANTEN",8,185,39,224
https://kawalpemilu.org#53194,"PONDOK JAGUNG, SERPONG UTARA, KOTA TANGERANG SELATAN, BANTEN",9,114,109,223
https://kawalpemilu.org#53194,"PONDOK JAGUNG, SERPONG UTARA, KOTA TANGERANG SELATAN, BANTEN",10,129,142,271
https://kawalpemilu.org#53194,"PONDOK JAGUNG, SERPONG UTARA, KOTA TANGERANG SELATAN, BANTEN",11,129,130,259
https://kawalpemilu.org#53194,"PONDOK JAGUNG, SERPONG UTARA, KOTA TANGERANG SELATAN, BANTEN",12,140,96,236
https://kawalpemilu.org#53194,"PONDOK JAGUNG, SERPONG UTARA, KOTA TANGERANG SELATAN, BANTEN",13,155,85,240
https://kawalpemilu.org#53194,"PONDOK JAGUNG, SERPONG UTARA, KOTA TANGERANG SELATAN, BANTEN",14,13,149,162
https://kawalpemilu.org#53194,"PONDOK JAGUNG, SERPONG UTARA, KOTA TANGERANG SELATAN, BANTEN",15,21,133,154
https://kawalpemilu.org#53194,"PONDOK JAGUNG, SERPONG UTARA, KOTA TANGERANG SELATAN, BANTEN",16,9,135,144
https://kawalpemilu.org#53194,"PONDOK JAGUNG, SERPONG UTARA, KOTA TANGERANG SELATAN, BANTEN",17,89,123,212
https://kawalpemilu.org#53194,"PONDOK JAGUNG, SERPONG UTARA, KOTA TANGERANG SELATAN, BANTEN",18,73,122,195
https://kawalpemilu.org#53194,"PONDOK JAGUNG, SERPONG UTARA, KOTA TANGERANG SELATAN, BANTEN",19,94,142,236
https://kawalpemilu.org#53194,"PONDOK JAGUNG, SERPONG UTARA, KOTA TANGERANG SELATAN, BANTEN",20,137,114,251
https://kawalpemilu.org#53194,"PONDOK JAGUNG, SERPONG UTARA, KOTA TANGERANG SELATAN, BANTEN",21,130,86,216
https://kawalpemilu.org#53194,"PONDOK JAGUNG, SERPONG UTARA, KOTA TANGERANG SELATAN, BANTEN",22,133,125,258
https://kawalpemilu.org#53194,"PONDOK JAGUNG, SERPONG UTARA, KOTA TANGERANG SELATAN, BANTEN",23,127,108,235
https://kawalpemilu.org#53194,"PONDOK JAGUNG, SERPONG UTARA, KOTA TANGERANG SELATAN, BANTEN",24,107,127,234
https://kawalpemilu.org#53194,"PONDOK JAGUNG, SERPONG UTARA, KOTA TANGERANG SELATAN, BANTEN",25,92,126,218
https://kawalpemilu.org#53194,"PONDOK JAGUNG, SERPONG UTARA, KOTA TANGERANG SELATAN, BANTEN",26,116,97,213
https://kawalpemilu.org#53194,"PONDOK JAGUNG, SERPONG UTARA, KOTA TANGERANG SELATAN, BANTEN",27,124,79,203
https://kawalpemilu.org#53194,"PONDOK JAGUNG, SERPONG UTARA, KOTA TANGERANG SELATAN, BANTEN",28,123,83,206
https://kawalpemilu.org#53194,"PONDOK JAGUNG, SERPONG UTARA, KOTA TANGERANG SELATAN, BANTEN",29,132,61,193
https://kawalpemilu.org#53194,"PONDOK JAGUNG, SERPONG UTARA, KOTA TANGERANG SELATAN, BANTEN",30,130,33,163
https://kawalpemilu.org#53194,"PONDOK JAGUNG, SERPONG UTARA, KOTA TANGERANG SELATAN, BANTEN",31,149,24,173
https://kawalpemilu.org#53194,"PONDOK JAGUNG, SERPONG UTARA, KOTA TANGERANG SELATAN, BANTEN",32,153,15,168
https://kawalpemilu.org#53194,"PONDOK JAGUNG, SERPONG UTARA, KOTA TANGERANG SELATAN, BANTEN",33,235,21,256
https://kawalpemilu.org#53194,"PONDOK JAGUNG, SERPONG UTARA, KOTA TANGERANG SELATAN, BANTEN",34,208,34,242
https://kawalpemilu.org#53194,"PONDOK JAGUNG, SERPONG UTARA, KOTA TANGERANG SELATAN, BANTEN",35,207,21,228
https://kawalpemilu.org#53194,"PONDOK JAGUNG, SERPONG UTARA, KOTA TANGERANG SELATAN, BANTEN",36,123,40,163
https://kawalpemilu.org#53194,"PONDOK JAGUNG, SERPONG UTARA, KOTA TANGERANG SELATAN, BANTEN",37,162,20,182
https://kawalpemilu.org#53194,"PONDOK JAGUNG, SERPONG UTARA, KOTA TANGERANG SELATAN, BANTEN",38,216,40,256
https://kawalpemilu.org#53194,"PONDOK JAGUNG, SERPONG UTARA, KOTA TANGERANG SELATAN, BANTEN",39,208,34,242
https://kawalpemilu.org#53194,"PONDOK JAGUNG, SERPONG UTARA, KOTA TANGERANG SELATAN, BANTEN",40,231,30,261
https://kawalpemilu.org#53194,"PONDOK JAGUNG, SERPONG UTARA, KOTA TANGERANG SELATAN, BANTEN",41,103,68,171
https://kawalpemilu.org#53194,"PONDOK JAGUNG, SERPONG UTARA, KOTA TANGERANG SELATAN, BANTEN",42,140,43,183
https://kawalpemilu.org#53194,"PONDOK JAGUNG, SERPONG UTARA, KOTA TANGERANG SELATAN, BANTEN",43,277,6,283
https://kawalpemilu.org#53194,"PONDOK JAGUNG, SERPONG UTARA, KOTA TANGERANG SELATAN, BANTEN",44,165,8,173
https://kawalpemilu.org#53194,"PONDOK JAGUNG, SERPONG UTARA, KOTA TANGERANG SELATAN, BANTEN",45,200,12,212
https://kawalpemilu.org#53194,"PONDOK JAGUNG, SERPONG UTARA, KOTA TANGERANG SELATAN, BANTEN",46,188,10,198
https://kawalpemilu.org#53194,"PONDOK JAGUNG, SERPONG UTARA, KOTA TANGERANG SELATAN, BANTEN",47,189,9,198
https://kawalpemilu.org#53194,"PONDOK JAGUNG, SERPONG UTARA, KOTA TANGERANG SELATAN, BANTEN",48,259,12,271
https://kawalpemilu.org#53194,"PONDOK JAGUNG, SERPONG UTARA, KOTA TANGERANG SELATAN, BANTEN",49,195,9,204
https://kawalpemilu.org#53194,"PONDOK JAGUNG, SERPONG UTARA, KOTA TANGERANG SELATAN, BANTEN",50,215,3,218
https://kawalpemilu.org#53194,"PONDOK JAGUNG, SERPONG UTARA, KOTA TANGERANG SELATAN, BANTEN",51,209,12,221
https://kawalpemilu.org#53194,"PONDOK JAGUNG, SERPONG UTARA, KOTA TANGERANG SELATAN, BANTEN",52,191,15,206
https://kawalpemilu.org#53194,"PONDOK JAGUNG, SERPONG UTARA, KOTA TANGERANG SELATAN, BANTEN",53,213,16,229
https://kawalpemilu.org#53194,"PONDOK JAGUNG, SERPONG UTARA, KOTA TANGERANG SELATAN, BANTEN",54,208,27,235
https://kawalpemilu.org#53195,"PONDOK JAGUNG TIMUR, SERPONG UTARA, KOTA TANGERANG SELATAN, BANTEN",1,241,14,255
https://kawalpemilu.org#53195,"PONDOK JAGUNG TIMUR, SERPONG UTARA, KOTA TANGERANG SELATAN, BANTEN",2,234,14,248
https://kawalpemilu.org#53195,"PONDOK JAGUNG TIMUR, SERPONG UTARA, KOTA TANGERANG SELATAN, BANTEN",3,244,17,261
https://kawalpemilu.org#53195,"PONDOK JAGUNG TIMUR, SERPONG UTARA, KOTA TANGERANG SELATAN, BANTEN",4,190,13,203
https://kawalpemilu.org#53195,"PONDOK JAGUNG TIMUR, SERPONG UTARA, KOTA TANGERANG SELATAN, BANTEN",5,192,6,198
https://kawalpemilu.org#53195,"PONDOK JAGUNG TIMUR, SERPONG UTARA, KOTA TANGERANG SELATAN, BANTEN",6,209,6,215
https://kawalpemilu.org#53195,"PONDOK JAGUNG TIMUR, SERPONG UTARA, KOTA TANGERANG SELATAN, BANTEN",7,220,10,230
https://kawalpemilu.org#53195,"PONDOK JAGUNG TIMUR, SERPONG UTARA, KOTA TANGERANG SELATAN, BANTEN",8,125,2,127
https://kawalpemilu.org#53195,"PONDOK JAGUNG TIMUR, SERPONG UTARA, KOTA TANGERANG SELATAN, BANTEN",9,74,119,193
https://kawalpemilu.org#53195,"PONDOK JAGUNG TIMUR, SERPONG UTARA, KOTA TANGERANG SELATAN, BANTEN",10,85,101,186
https://kawalpemilu.org#53195,"PONDOK JAGUNG TIMUR, SERPONG UTARA, KOTA TANGERANG SELATAN, BANTEN",11,102,119,221
https://kawalpemilu.org#53195,"PONDOK JAGUNG TIMUR, SERPONG UTARA, KOTA TANGERANG SELATAN, BANTEN",12,43,78,121
https://kawalpemilu.org#53195,"PONDOK JAGUNG TIMUR, SERPONG UTARA, KOTA TANGERANG SELATAN, BANTEN",13,104,112,216
https://kawalpemilu.org#53195,"PONDOK JAGUNG TIMUR, SERPONG UTARA, KOTA TANGERANG SELATAN, BANTEN",14,97,132,229
https://kawalpemilu.org#53195,"PONDOK JAGUNG TIMUR, SERPONG UTARA, KOTA TANGERANG SELATAN, BANTEN",15,128,136,264
https://kawalpemilu.org#53195,"PONDOK JAGUNG TIMUR, SERPONG UTARA, KOTA TANGERANG SELATAN, BANTEN",16,100,129,229
https://kawalpemilu.org#53195,"PONDOK JAGUNG TIMUR, SERPONG UTARA, KOTA TANGERANG SELATAN, BANTEN",17,86,124,210
https://kawalpemilu.org#53195,"PONDOK JAGUNG TIMUR, SERPONG UTARA, KOTA TANGERANG SELATAN, BANTEN",18,94,186,280
https://kawalpemilu.org#53195,"PONDOK JAGUNG TIMUR, SERPONG UTARA, KOTA TANGERANG SELATAN, BANTEN",19,81,154,235
https://kawalpemilu.org#53195,"PONDOK JAGUNG TIMUR, SERPONG UTARA, KOTA TANGERANG SELATAN, BANTEN",20,136,58,194
https://kawalpemilu.org#53195,"PONDOK JAGUNG TIMUR, SERPONG UTARA, KOTA TANGERANG SELATAN, BANTEN",21,119,64,183
https://kawalpemilu.org#53195,"PONDOK JAGUNG TIMUR, SERPONG UTARA, KOTA TANGERANG SELATAN, BANTEN",22,78,19,97
https://kawalpemilu.org#53195,"PONDOK JAGUNG TIMUR, SERPONG UTARA, KOTA TANGERANG SELATAN, BANTEN",23,181,72,253
https://kawalpemilu.org#53195,"PONDOK JAGUNG TIMUR, SERPONG UTARA, KOTA TANGERANG SELATAN, BANTEN",24,191,58,249
https://kawalpemilu.org#53195,"PONDOK JAGUNG TIMUR, SERPONG UTARA, KOTA TANGERANG SELATAN, BANTEN",25,137,136,273
https://kawalpemilu.org#53195,"PONDOK JAGUNG TIMUR, SERPONG UTARA, KOTA TANGERANG SELATAN, BANTEN",26,108,117,225
https://kawalpemilu.org#53195,"PONDOK JAGUNG TIMUR, SERPONG UTARA, KOTA TANGERANG SELATAN, BANTEN",27,161,94,255
https://kawalpemilu.org#53195,"PONDOK JAGUNG TIMUR, SERPONG UTARA, KOTA TANGERANG SELATAN, BANTEN",28,135,129,264
https://kawalpemilu.org#53195,"PONDOK JAGUNG TIMUR, SERPONG UTARA, KOTA TANGERANG SELATAN, BANTEN",29,166,72,238
https://kawalpemilu.org#53195,"PONDOK JAGUNG TIMUR, SERPONG UTARA, KOTA TANGERANG SELATAN, BANTEN",30,174,92,266
https://kawalpemilu.org#53195,"PONDOK JAGUNG TIMUR, SERPONG UTARA, KOTA TANGERANG SELATAN, BANTEN",31,99,125,224
https://kawalpemilu.org#53195,"PONDOK JAGUNG TIMUR, SERPONG UTARA, KOTA TANGERANG SELATAN, BANTEN",32,95,116,211
https://kawalpemilu.org#53195,"PONDOK JAGUNG TIMUR, SERPONG UTARA, KOTA TANGERANG SELATAN, BANTEN",33,106,125,231
https://kawalpemilu.org#53195,"PONDOK JAGUNG TIMUR, SERPONG UTARA, KOTA TANGERANG SELATAN, BANTEN",34,112,119,231
https://kawalpemilu.org#53195,"PONDOK JAGUNG TIMUR, SERPONG UTARA, KOTA TANGERANG SELATAN, BANTEN",35,141,74,215
https://kawalpemilu.org#53195,"PONDOK JAGUNG TIMUR, SERPONG UTARA, KOTA TANGERANG SELATAN, BANTEN",36,60,149,209
https://kawalpemilu.org#53195,"PONDOK JAGUNG TIMUR, SERPONG UTARA, KOTA TANGERANG SELATAN, BANTEN",37,126,83,209
https://kawalpemilu.org#53195,"PONDOK JAGUNG TIMUR, SERPONG UTARA, KOTA TANGERANG SELATAN, BANTEN",38,100,95,195
https://kawalpemilu.org#53195,"PONDOK JAGUNG TIMUR, SERPONG UTARA, KOTA TANGERANG SELATAN, BANTEN",39,147,58,205
https://kawalpemilu.org#53195,"PONDOK JAGUNG TIMUR, SERPONG UTARA, KOTA TANGERANG SELATAN, BANTEN",40,80,102,182
https://kawalpemilu.org#53195,"PONDOK JAGUNG TIMUR, SERPONG UTARA, KOTA TANGERANG SELATAN, BANTEN",41,178,101,279
https://kawalpemilu.org#53195,"PONDOK JAGUNG TIMUR, SERPONG UTARA, KOTA TANGERANG SELATAN, BANTEN",42,113,133,246
https://kawalpemilu.org#53195,"PONDOK JAGUNG TIMUR, SERPONG UTARA, KOTA TANGERANG SELATAN, BANTEN",43,144,113,257
https://kawalpemilu.org#53195,"PONDOK JAGUNG TIMUR, SERPONG UTARA, KOTA TANGERANG SELATAN, BANTEN",44,136,141,277
https://kawalpemilu.org#53195,"PONDOK JAGUNG TIMUR, SERPONG UTARA, KOTA TANGERANG SELATAN, BANTEN",45,167,109,276
https://kawalpemilu.org#53195,"PONDOK JAGUNG TIMUR, SERPONG UTARA, KOTA TANGERANG SELATAN, BANTEN",46,125,140,265
https://kawalpemilu.org#53196,"JELUPANG, SERPONG UTARA, KOTA TANGERANG SELATAN, BANTEN",1,164,88,252
https://kawalpemilu.org#53196,"JELUPANG, SERPONG UTARA, KOTA TANGERANG SELATAN, BANTEN",2,162,82,244
https://kawalpemilu.org#53196,"JELUPANG, SERPONG UTARA, KOTA TANGERANG SELATAN, BANTEN",3,122,112,234
https://kawalpemilu.org#53196,"JELUPANG, SERPONG UTARA, KOTA TANGERANG SELATAN, BANTEN",4,159,126,285
https://kawalpemilu.org#53196,"JELUPANG, SERPONG UTARA, KOTA TANGERANG SELATAN, BANTEN",5,177,108,285
https://kawalpemilu.org#53196,"JELUPANG, SERPONG UTARA, KOTA TANGERANG SELATAN, BANTEN",6,134,103,237
https://kawalpemilu.org#53196,"JELUPANG, SERPONG UTARA, KOTA TANGERANG SELATAN, BANTEN",7,138,88,224
https://kawalpemilu.org#53196,"JELUPANG, SERPONG UTARA, KOTA TANGERANG SELATAN, BANTEN",8,164,87,251
https://kawalpemilu.org#53196,"JELUPANG, SERPONG UTARA, KOTA TANGERANG SELATAN, BANTEN",9,138,89,227
https://kawalpemilu.org#53196,"JELUPANG, SERPONG UTARA, KOTA TANGERANG SELATAN, BANTEN",10,60,85,145
https://kawalpemilu.org#53196,"JELUPANG, SERPONG UTARA, KOTA TANGERANG SELATAN, BANTEN",11,126,101,227
https://kawalpemilu.org#53196,"JELUPANG, SERPONG UTARA, KOTA TANGERANG SELATAN, BANTEN",12,112,121,233
https://kawalpemilu.org#53196,"JELUPANG, SERPONG UTARA, KOTA TANGERANG SELATAN, BANTEN",13,103,119,222
https://kawalpemilu.org#53196,"JELUPANG, SERPONG UTARA, KOTA TANGERANG SELATAN, BANTEN",14,128,122,250
https://kawalpemilu.org#53196,"JELUPANG, SERPONG UTARA, KOTA TANGERANG SELATAN, BANTEN",15,128,121,249
https://kawalpemilu.org#53196,"JELUPANG, SERPONG UTARA, KOTA TANGERANG SELATAN, BANTEN",16,75,177,252
https://kawalpemilu.org#53196,"JELUPANG, SERPONG UTARA, KOTA TANGERANG SELATAN, BANTEN",17,92,163,255
https://kawalpemilu.org#53196,"JELUPANG, SERPONG UTARA, KOTA TANGERANG SELATAN, BANTEN",18,95,137,232
https://kawalpemilu.org#53196,"JELUPANG, SERPONG UTARA, KOTA TANGERANG SELATAN, BANTEN",19,93,160,253
https://kawalpemilu.org#53196,"JELUPANG, SERPONG UTARA, KOTA TANGERANG SELATAN, BANTEN",20,85,117,202
https://kawalpemilu.org#53196,"JELUPANG, SERPONG UTARA, KOTA TANGERANG SELATAN, BANTEN",21,86,152,238
https://kawalpemilu.org#53196,"JELUPANG, SERPONG UTARA, KOTA TANGERANG SELATAN, BANTEN",22,83,131,214
https://kawalpemilu.org#53196,"JELUPANG, SERPONG UTARA, KOTA TANGERANG SELATAN, BANTEN",23,66,113,179
https://kawalpemilu.org#53196,"JELUPANG, SERPONG UTARA, KOTA TANGERANG SELATAN, BANTEN",24,179,80,259
https://kawalpemilu.org#53196,"JELUPANG, SERPONG UTARA, KOTA TANGERANG SELATAN, BANTEN",25,190,93,283
https://kawalpemilu.org#53196,"JELUPANG, SERPONG UTARA, KOTA TANGERANG SELATAN, BANTEN",26,163,53,216
https://kawalpemilu.org#53196,"JELUPANG, SERPONG UTARA, KOTA TANGERANG SELATAN, BANTEN",27,178,61,239
https://kawalpemilu.org#53196,"JELUPANG, SERPONG UTARA, KOTA TANGERANG SELATAN, BANTEN",28,218,49,267
https://kawalpemilu.org#53196,"JELUPANG, SERPONG UTARA, KOTA TANGERANG SELATAN, BANTEN",29,238,29,267
https://kawalpemilu.org#53196,"JELUPANG, SERPONG UTARA, KOTA TANGERANG SELATAN, BANTEN",30,78,64,142
https://kawalpemilu.org#53196,"JELUPANG, SERPONG UTARA, KOTA TANGERANG SELATAN, BANTEN",31,68,60,128
https://kawalpemilu.org#53196,"JELUPANG, SERPONG UTARA, KOTA TANGERANG SELATAN, BANTEN",32,72,78,150
https://kawalpemilu.org#53196,"JELUPANG, SERPONG UTARA, KOTA TANGERANG SELATAN, BANTEN",33,93,94,187
https://kawalpemilu.org#53196,"JELUPANG, SERPONG UTARA, KOTA TANGERANG SELATAN, BANTEN",34,73,85,158
https://kawalpemilu.org#53196,"JELUPANG, SERPONG UTARA, KOTA TANGERANG SELATAN, BANTEN",35,110,102,212
https://kawalpemilu.org#53196,"JELUPANG, SERPONG UTARA, KOTA TANGERANG SELATAN, BANTEN",36,82,97,179
https://kawalpemilu.org#53196,"JELUPANG, SERPONG UTARA, KOTA TANGERANG SELATAN, BANTEN",37,113,88,201
https://kawalpemilu.org#53196,"JELUPANG, SERPONG UTARA, KOTA TANGERANG SELATAN, BANTEN",38,100,58,158
https://kawalpemilu.org#53196,"JELUPANG, SERPONG UTARA, KOTA TANGERANG SELATAN, BANTEN",39,109,103,212
https://kawalpemilu.org#53196,"JELUPANG, SERPONG UTARA, KOTA TANGERANG SELATAN, BANTEN",40,61,72,133
https://kawalpemilu.org#53196,"JELUPANG, SERPONG UTARA, KOTA TANGERANG SELATAN, BANTEN",41,151,116,267
https://kawalpemilu.org#53196,"JELUPANG, SERPONG UTARA, KOTA TANGERANG SELATAN, BANTEN",42,148,149,297
https://kawalpemilu.org#53196,"JELUPANG, SERPONG UTARA, KOTA TANGERANG SELATAN, BANTEN",43,82,131,213
https://kawalpemilu.org#53196,"JELUPANG, SERPONG UTARA, KOTA TANGERANG SELATAN, BANTEN",44,125,138,263
https://kawalpemilu.org#53196,"JELUPANG, SERPONG UTARA, KOTA TANGERANG SELATAN, BANTEN",45,130,84,214
https://kawalpemilu.org#53196,"JELUPANG, SERPONG UTARA, KOTA TANGERANG SELATAN, BANTEN",46,117,96,213
https://kawalpemilu.org#53196,"JELUPANG, SERPONG UTARA, KOTA TANGERANG SELATAN, BANTEN",47,135,95,230
https://kawalpemilu.org#53196,"JELUPANG, SERPONG UTARA, KOTA TANGERANG SELATAN, BANTEN",48,165,104,269
https://kawalpemilu.org#53196,"JELUPANG, SERPONG UTARA, KOTA TANGERANG SELATAN, BANTEN",49,49,139,188
https://kawalpemilu.org#53196,"JELUPANG, SERPONG UTARA, KOTA TANGERANG SELATAN, BANTEN",50,151,24,175
https://kawalpemilu.org#53196,"JELUPANG, SERPONG UTARA, KOTA TANGERANG SELATAN, BANTEN",51,107,73,180
https://kawalpemilu.org#53196,"JELUPANG, SERPONG UTARA, KOTA TANGERANG SELATAN, BANTEN",52,107,81,188
https://kawalpemilu.org#53196,"JELUPANG, SERPONG UTARA, KOTA TANGERANG SELATAN, BANTEN",53,133,69,202
https://kawalpemilu.org#53196,"JELUPANG, SERPONG UTARA, KOTA TANGERANG SELATAN, BANTEN",54,233,38,271
https://kawalpemilu.org#53196,"JELUPANG, SERPONG UTARA, KOTA TANGERANG SELATAN, BANTEN",55,187,31,218
https://kawalpemilu.org#53196,"JELUPANG, SERPONG UTARA, KOTA TANGERANG SELATAN, BANTEN",56,169,42,211
https://kawalpemilu.org#53196,"JELUPANG, SERPONG UTARA, KOTA TANGERANG SELATAN, BANTEN",57,235,22,257
https://kawalpemilu.org#53196,"JELUPANG, SERPONG UTARA, KOTA TANGERANG SELATAN, BANTEN",58,246,46,292
https://kawalpemilu.org#53196,"JELUPANG, SERPONG UTARA, KOTA TANGERANG SELATAN, BANTEN",59,145,18,163
https://kawalpemilu.org#53196,"JELUPANG, SERPONG UTARA, KOTA TANGERANG SELATAN, BANTEN",60,239,13,252
https://kawalpemilu.org#53196,"JELUPANG, SERPONG UTARA, KOTA TANGERANG SELATAN, BANTEN",61,140,15,155
https://kawalpemilu.org#53196,"JELUPANG, SERPONG UTARA, KOTA TANGERANG SELATAN, BANTEN",62,163,16,179
https://kawalpemilu.org#53196,"JELUPANG, SERPONG UTARA, KOTA TANGERANG SELATAN, BANTEN",63,150,19,169
https://kawalpemilu.org#53196,"JELUPANG, SERPONG UTARA, KOTA TANGERANG SELATAN, BANTEN",64,165,11,176
https://kawalpemilu.org#53196,"JELUPANG, SERPONG UTARA, KOTA TANGERANG SELATAN, BANTEN",65,165,5,170
https://kawalpemilu.org#53196,"JELUPANG, SERPONG UTARA, KOTA TANGERANG SELATAN, BANTEN",66,224,17,241
https://kawalpemilu.org#53196,"JELUPANG, SERPONG UTARA, KOTA TANGERANG SELATAN, BANTEN",67,219,14,233
https://kawalpemilu.org#53196,"JELUPANG, SERPONG UTARA, KOTA TANGERANG SELATAN, BANTEN",68,149,49,198
https://kawalpemilu.org#53196,"JELUPANG, SERPONG UTARA, KOTA TANGERANG SELATAN, BANTEN",69,110,20,130
https://kawalpemilu.org#53196,"JELUPANG, SERPONG UTARA, KOTA TANGERANG SELATAN, BANTEN",70,187,10,197
https://kawalpemilu.org#53196,"JELUPANG, SERPONG UTARA, KOTA TANGERANG SELATAN, BANTEN",71,150,26,176
https://kawalpemilu.org#53196,"JELUPANG, SERPONG UTARA, KOTA TANGERANG SELATAN, BANTEN",72,167,35,202
https://kawalpemilu.org#53196,"JELUPANG, SERPONG UTARA, KOTA TANGERANG SELATAN, BANTEN",73,145,26,171
https://kawalpemilu.org#53196,"JELUPANG, SERPONG UTARA, KOTA TANGERANG SELATAN, BANTEN",74,245,13,258
https://kawalpemilu.org#53196,"JELUPANG, SERPONG UTARA, KOTA TANGERANG SELATAN, BANTEN",75,146,40,186
https://kawalpemilu.org#53196,"JELUPANG, SERPONG UTARA, KOTA TANGERANG SELATAN, BANTEN",76,150,20,170
https://kawalpemilu.org#53196,"JELUPANG, SERPONG UTARA, KOTA TANGERANG SELATAN, BANTEN",77,162,15,177
https://kawalpemilu.org#53196,"JELUPANG, SERPONG UTARA, KOTA TANGERANG SELATAN, BANTEN",78,169,20,189
https://kawalpemilu.org#53196,"JELUPANG, SERPONG UTARA, KOTA TANGERANG SELATAN, BANTEN",79,172,36,208
https://kawalpemilu.org#53196,"JELUPANG, SERPONG UTARA, KOTA TANGERANG SELATAN, BANTEN",81,180,30,210
https://kawalpemilu.org#53196,"JELUPANG, SERPONG UTARA, KOTA TANGERANG SELATAN, BANTEN",82,191,27,218
https://kawalpemilu.org#53196,"JELUPANG, SERPONG UTARA, KOTA TANGERANG SELATAN, BANTEN",83,224,16,240
https://kawalpemilu.org#53196,"JELUPANG, SERPONG UTARA, KOTA TANGERANG SELATAN, BANTEN",84,157,25,182
https://kawalpemilu.org#53196,"JELUPANG, SERPONG UTARA, KOTA TANGERANG SELATAN, BANTEN",85,155,31,186
https://kawalpemilu.org#53196,"JELUPANG, SERPONG UTARA, KOTA TANGERANG SELATAN, BANTEN",86,178,29,207
https://kawalpemilu.org#53196,"JELUPANG, SERPONG UTARA, KOTA TANGERANG SELATAN, BANTEN",87,138,54,192
https://kawalpemilu.org#53196,"JELUPANG, SERPONG UTARA, KOTA TANGERANG SELATAN, BANTEN",88,122,13,135
https://kawalpemilu.org#53196,"JELUPANG, SERPONG UTARA, KOTA TANGERANG SELATAN, BANTEN",89,179,10,189
https://kawalpemilu.org#53197,"LENGKONG KARYA, SERPONG UTARA, KOTA TANGERANG SELATAN, BANTEN",1,228,23,251
https://kawalpemilu.org#53197,"LENGKONG KARYA, SERPONG UTARA, KOTA TANGERANG SELATAN, BANTEN",2,205,44,249
https://kawalpemilu.org#53197,"LENGKONG KARYA, SERPONG UTARA, KOTA TANGERANG SELATAN, BANTEN",3,160,41,201
https://kawalpemilu.org#53197,"LENGKONG KARYA, SERPONG UTARA, KOTA TANGERANG SELATAN, BANTEN",4,186,30,216
https://kawalpemilu.org#53197,"LENGKONG KARYA, SERPONG UTARA, KOTA TANGERANG SELATAN, BANTEN",5,165,76,241
https://kawalpemilu.org#53197,"LENGKONG KARYA, SERPONG UTARA, KOTA TANGERANG SELATAN, BANTEN",6,104,133,237
https://kawalpemilu.org#53197,"LENGKONG KARYA, SERPONG UTARA, KOTA TANGERANG SELATAN, BANTEN",7,84,176,260
https://kawalpemilu.org#53197,"LENGKONG KARYA, SERPONG UTARA, KOTA TANGERANG SELATAN, BANTEN",8,96,146,242
https://kawalpemilu.org#53197,"LENGKONG KARYA, SERPONG UTARA, KOTA TANGERANG SELATAN, BANTEN",9,138,51,189
https://kawalpemilu.org#53197,"LENGKONG KARYA, SERPONG UTARA, KOTA TANGERANG SELATAN, BANTEN",10,86,105,191
https://kawalpemilu.org#53197,"LENGKONG KARYA, SERPONG UTARA, KOTA TANGERANG SELATAN, BANTEN",12,107,134,241
https://kawalpemilu.org#53197,"LENGKONG KARYA, SERPONG UTARA, KOTA TANGERANG SELATAN, BANTEN",13,111,132,243
https://kawalpemilu.org#53197,"LENGKONG KARYA, SERPONG UTARA, KOTA TANGERANG SELATAN, BANTEN",14,85,179,264
https://kawalpemilu.org#53197,"LENGKONG KARYA, SERPONG UTARA, KOTA TANGERANG SELATAN, BANTEN",15,89,102,191
https://kawalpemilu.org#53197,"LENGKONG KARYA, SERPONG UTARA, KOTA TANGERANG SELATAN, BANTEN",16,79,88,167
https://kawalpemilu.org#53197,"LENGKONG KARYA, SERPONG UTARA, KOTA TANGERANG SELATAN, BANTEN",17,91,139,230
https://kawalpemilu.org#53197,"LENGKONG KARYA, SERPONG UTARA, KOTA TANGERANG SELATAN, BANTEN",18,124,128,252
https://kawalpemilu.org#53197,"LENGKONG KARYA, SERPONG UTARA, KOTA TANGERANG SELATAN, BANTEN",19,76,101,177
https://kawalpemilu.org#53197,"LENGKONG KARYA, SERPONG UTARA, KOTA TANGERANG SELATAN, BANTEN",20,69,103,172
https://kawalpemilu.org#53199,"PONDOK BETUNG, PONDOK AREN, KOTA TANGERANG SELATAN, BANTEN",1,110,115,225
https://kawalpemilu.org#53199,"PONDOK BETUNG, PONDOK AREN, KOTA TANGERANG SELATAN, BANTEN",2,107,101,208
https://kawalpemilu.org#53199,"PONDOK BETUNG, PONDOK AREN, KOTA TANGERANG SELATAN, BANTEN",3,95,118,213
https://kawalpemilu.org#53199,"PONDOK BETUNG, PONDOK AREN, KOTA TANGERANG SELATAN, BANTEN",4,119,114,233
https://kawalpemilu.org#53199,"PONDOK BETUNG, PONDOK AREN, KOTA TANGERANG SELATAN, BANTEN",5,110,98,208
https://kawalpemilu.org#53199,"PONDOK BETUNG, PONDOK AREN, KOTA TANGERANG SELATAN, BANTEN",6,115,121,236
https://kawalpemilu.org#53199,"PONDOK BETUNG, PONDOK AREN, KOTA TANGERANG SELATAN, BANTEN",7,118,129,247
https://kawalpemilu.org#53199,"PONDOK BETUNG, PONDOK AREN, KOTA TANGERANG SELATAN, BANTEN",8,145,72,217
https://kawalpemilu.org#53199,"PONDOK BETUNG, PONDOK AREN, KOTA TANGERANG SELATAN, BANTEN",9,110,63,173
https://kawalpemilu.org#53199,"PONDOK BETUNG, PONDOK AREN, KOTA TANGERANG SELATAN, BANTEN",10,85,87,172
https://kawalpemilu.org#53199,"PONDOK BETUNG, PONDOK AREN, KOTA TANGERANG SELATAN, BANTEN",11,68,87,155
https://kawalpemilu.org#53199,"PONDOK BETUNG, PONDOK AREN, KOTA TANGERANG SELATAN, BANTEN",12,117,111,228
https://kawalpemilu.org#53199,"PONDOK BETUNG, PONDOK AREN, KOTA TANGERANG SELATAN, BANTEN",13,119,124,243
https://kawalpemilu.org#53199,"PONDOK BETUNG, PONDOK AREN, KOTA TANGERANG SELATAN, BANTEN",14,152,93,245
https://kawalpemilu.org#53199,"PONDOK BETUNG, PONDOK AREN, KOTA TANGERANG SELATAN, BANTEN",15,117,85,202
https://kawalpemilu.org#53199,"PONDOK BETUNG, PONDOK AREN, KOTA TANGERANG SELATAN, BANTEN",16,115,105,220
https://kawalpemilu.org#53199,"PONDOK BETUNG, PONDOK AREN, KOTA TANGERANG SELATAN, BANTEN",17,110,101,211
https://kawalpemilu.org#53199,"PONDOK BETUNG, PONDOK AREN, KOTA TANGERANG SELATAN, BANTEN",18,117,72,189
https://kawalpemilu.org#53199,"PONDOK BETUNG, PONDOK AREN, KOTA TANGERANG SELATAN, BANTEN",19,152,90,242
https://kawalpemilu.org#53199,"PONDOK BETUNG, PONDOK AREN, KOTA TANGERANG SELATAN, BANTEN",20,127,98,225
https://kawalpemilu.org#53199,"PONDOK BETUNG, PONDOK AREN, KOTA TANGERANG SELATAN, BANTEN",21,114,106,223
https://kawalpemilu.org#53199,"PONDOK BETUNG, PONDOK AREN, KOTA TANGERANG SELATAN, BANTEN",22,96,86,182
https://kawalpemilu.org#53199,"PONDOK BETUNG, PONDOK AREN, KOTA TANGERANG SELATAN, BANTEN",23,118,94,212
https://kawalpemilu.org#53199,"PONDOK BETUNG, PONDOK AREN, KOTA TANGERANG SELATAN, BANTEN",24,111,71,182
https://kawalpemilu.org#53199,"PONDOK BETUNG, PONDOK AREN, KOTA TANGERANG SELATAN, BANTEN",25,103,152,255
https://kawalpemilu.org#53199,"PONDOK BETUNG, PONDOK AREN, KOTA TANGERANG SELATAN, BANTEN",26,148,100,248
https://kawalpemilu.org#53199,"PONDOK BETUNG, PONDOK AREN, KOTA TANGERANG SELATAN, BANTEN",27,147,70,0
https://kawalpemilu.org#53199,"PONDOK BETUNG, PONDOK AREN, KOTA TANGERANG SELATAN, BANTEN",28,130,73,203
https://kawalpemilu.org#53199,"PONDOK BETUNG, PONDOK AREN, KOTA TANGERANG SELATAN, BANTEN",29,89,83,172
https://kawalpemilu.org#53199,"PONDOK BETUNG, PONDOK AREN, KOTA TANGERANG SELATAN, BANTEN",30,142,113,255
https://kawalpemilu.org#53199,"PONDOK BETUNG, PONDOK AREN, KOTA TANGERANG SELATAN, BANTEN",31,110,60,170
https://kawalpemilu.org#53199,"PONDOK BETUNG, PONDOK AREN, KOTA TANGERANG SELATAN, BANTEN",32,101,88,189
https://kawalpemilu.org#53199,"PONDOK BETUNG, PONDOK AREN, KOTA TANGERANG SELATAN, BANTEN",33,86,80,166
https://kawalpemilu.org#53199,"PONDOK BETUNG, PONDOK AREN, KOTA TANGERANG SELATAN, BANTEN",34,128,75,203
https://kawalpemilu.org#53199,"PONDOK BETUNG, PONDOK AREN, KOTA TANGERANG SELATAN, BANTEN",35,123,90,213
https://kawalpemilu.org#53199,"PONDOK BETUNG, PONDOK AREN, KOTA TANGERANG SELATAN, BANTEN",36,138,68,206
https://kawalpemilu.org#53199,"PONDOK BETUNG, PONDOK AREN, KOTA TANGERANG SELATAN, BANTEN",37,104,74,178
https://kawalpemilu.org#53199,"PONDOK BETUNG, PONDOK AREN, KOTA TANGERANG SELATAN, BANTEN",38,115,88,203
https://kawalpemilu.org#53199,"PONDOK BETUNG, PONDOK AREN, KOTA TANGERANG SELATAN, BANTEN",39,122,67,189
https://kawalpemilu.org#53199,"PONDOK BETUNG, PONDOK AREN, KOTA TANGERANG SELATAN, BANTEN",40,150,78,228
https://kawalpemilu.org#53199,"PONDOK BETUNG, PONDOK AREN, KOTA TANGERANG SELATAN, BANTEN",41,133,56,189
https://kawalpemilu.org#53199,"PONDOK BETUNG, PONDOK AREN, KOTA TANGERANG SELATAN, BANTEN",42,116,64,180
https://kawalpemilu.org#53199,"PONDOK BETUNG, PONDOK AREN, KOTA TANGERANG SELATAN, BANTEN",43,132,98,230
https://kawalpemilu.org#53199,"PONDOK BETUNG, PONDOK AREN, KOTA TANGERANG SELATAN, BANTEN",44,155,82,237
https://kawalpemilu.org#53199,"PONDOK BETUNG, PONDOK AREN, KOTA TANGERANG SELATAN, BANTEN",45,110,13,123
https://kawalpemilu.org#53199,"PONDOK BETUNG, PONDOK AREN, KOTA TANGERANG SELATAN, BANTEN",46,84,141,225
https://kawalpemilu.org#53199,"PONDOK BETUNG, PONDOK AREN, KOTA TANGERANG SELATAN, BANTEN",47,109,117,226
https://kawalpemilu.org#53199,"PONDOK BETUNG, PONDOK AREN, KOTA TANGERANG SELATAN, BANTEN",48,139,96,235
https://kawalpemilu.org#53199,"PONDOK BETUNG, PONDOK AREN, KOTA TANGERANG SELATAN, BANTEN",49,121,99,220
https://kawalpemilu.org#53199,"PONDOK BETUNG, PONDOK AREN, KOTA TANGERANG SELATAN, BANTEN",50,115,137,252
https://kawalpemilu.org#53199,"PONDOK BETUNG, PONDOK AREN, KOTA TANGERANG SELATAN, BANTEN",51,142,93,235
https://kawalpemilu.org#53199,"PONDOK BETUNG, PONDOK AREN, KOTA TANGERANG SELATAN, BANTEN",52,133,77,210
https://kawalpemilu.org#53199,"PONDOK BETUNG, PONDOK AREN, KOTA TANGERANG SELATAN, BANTEN",53,127,107,234
https://kawalpemilu.org#53199,"PONDOK BETUNG, PONDOK AREN, KOTA TANGERANG SELATAN, BANTEN",54,111,100,211
https://kawalpemilu.org#53199,"PONDOK BETUNG, PONDOK AREN, KOTA TANGERANG SELATAN, BANTEN",55,106,88,194
https://kawalpemilu.org#53199,"PONDOK BETUNG, PONDOK AREN, KOTA TANGERANG SELATAN, BANTEN",56,104,94,198
https://kawalpemilu.org#53199,"PONDOK BETUNG, PONDOK AREN, KOTA TANGERANG SELATAN, BANTEN",57,125,87,212
https://kawalpemilu.org#53199,"PONDOK BETUNG, PONDOK AREN, KOTA TANGERANG SELATAN, BANTEN",58,184,83,267
https://kawalpemilu.org#53199,"PONDOK BETUNG, PONDOK AREN, KOTA TANGERANG SELATAN, BANTEN",59,124,84,208
https://kawalpemilu.org#53199,"PONDOK BETUNG, PONDOK AREN, KOTA TANGERANG SELATAN, BANTEN",60,116,134,250
https://kawalpemilu.org#53199,"PONDOK BETUNG, PONDOK AREN, KOTA TANGERANG SELATAN, BANTEN",61,135,58,193
https://kawalpemilu.org#53199,"PONDOK BETUNG, PONDOK AREN, KOTA TANGERANG SELATAN, BANTEN",62,125,61,186
https://kawalpemilu.org#53199,"PONDOK BETUNG, PONDOK AREN, KOTA TANGERANG SELATAN, BANTEN",63,146,59,205
https://kawalpemilu.org#53199,"PONDOK BETUNG, PONDOK AREN, KOTA TANGERANG SELATAN, BANTEN",64,138,85,0
https://kawalpemilu.org#53199,"PONDOK BETUNG, PONDOK AREN, KOTA TANGERANG SELATAN, BANTEN",65,103,99,202
https://kawalpemilu.org#53199,"PONDOK BETUNG, PONDOK AREN, KOTA TANGERANG SELATAN, BANTEN",66,79,100,179
https://kawalpemilu.org#53199,"PONDOK BETUNG, PONDOK AREN, KOTA TANGERANG SELATAN, BANTEN",67,79,113,192
https://kawalpemilu.org#53199,"PONDOK BETUNG, PONDOK AREN, KOTA TANGERANG SELATAN, BANTEN",68,89,107,196
https://kawalpemilu.org#53199,"PONDOK BETUNG, PONDOK AREN, KOTA TANGERANG SELATAN, BANTEN",69,90,66,156
https://kawalpemilu.org#53199,"PONDOK BETUNG, PONDOK AREN, KOTA TANGERANG SELATAN, BANTEN",70,84,110,194
https://kawalpemilu.org#53199,"PONDOK BETUNG, PONDOK AREN, KOTA TANGERANG SELATAN, BANTEN",71,73,111,184
https://kawalpemilu.org#53199,"PONDOK BETUNG, PONDOK AREN, KOTA TANGERANG SELATAN, BANTEN",72,90,60,150
https://kawalpemilu.org#53199,"PONDOK BETUNG, PONDOK AREN, KOTA TANGERANG SELATAN, BANTEN",73,102,61,163
https://kawalpemilu.org#53199,"PONDOK BETUNG, PONDOK AREN, KOTA TANGERANG SELATAN, BANTEN",74,80,81,161
https://kawalpemilu.org#53199,"PONDOK BETUNG, PONDOK AREN, KOTA TANGERANG SELATAN, BANTEN",75,84,79,163
https://kawalpemilu.org#53199,"PONDOK BETUNG, PONDOK AREN, KOTA TANGERANG SELATAN, BANTEN",76,93,104,197
https://kawalpemilu.org#53199,"PONDOK BETUNG, PONDOK AREN, KOTA TANGERANG SELATAN, BANTEN",77,107,128,235
https://kawalpemilu.org#53199,"PONDOK BETUNG, PONDOK AREN, KOTA TANGERANG SELATAN, BANTEN",78,125,124,249
https://kawalpemilu.org#53199,"PONDOK BETUNG, PONDOK AREN, KOTA TANGERANG SELATAN, BANTEN",79,134,98,232
https://kawalpemilu.org#53199,"PONDOK BETUNG, PONDOK AREN, KOTA TANGERANG SELATAN, BANTEN",80,160,101,261
https://kawalpemilu.org#53199,"PONDOK BETUNG, PONDOK AREN, KOTA TANGERANG SELATAN, BANTEN",81,68,104,172
https://kawalpemilu.org#53199,"PONDOK BETUNG, PONDOK AREN, KOTA TANGERANG SELATAN, BANTEN",82,106,130,236
https://kawalpemilu.org#53199,"PONDOK BETUNG, PONDOK AREN, KOTA TANGERANG SELATAN, BANTEN",83,84,129,213
https://kawalpemilu.org#53199,"PONDOK BETUNG, PONDOK AREN, KOTA TANGERANG SELATAN, BANTEN",84,98,146,244
https://kawalpemilu.org#53199,"PONDOK BETUNG, PONDOK AREN, KOTA TANGERANG SELATAN, BANTEN",85,88,141,229
https://kawalpemilu.org#53199,"PONDOK BETUNG, PONDOK AREN, KOTA TANGERANG SELATAN, BANTEN",86,131,60,191
https://kawalpemilu.org#53199,"PONDOK BETUNG, PONDOK AREN, KOTA TANGERANG SELATAN, BANTEN",87,142,113,255
https://kawalpemilu.org#53199,"PONDOK BETUNG, PONDOK AREN, KOTA TANGERANG SELATAN, BANTEN",88,126,120,246
https://kawalpemilu.org#53199,"PONDOK BETUNG, PONDOK AREN, KOTA TANGERANG SELATAN, BANTEN",89,116,82,198
https://kawalpemilu.org#53199,"PONDOK BETUNG, PONDOK AREN, KOTA TANGERANG SELATAN, BANTEN",90,121,78,199
https://kawalpemilu.org#53199,"PONDOK BETUNG, PONDOK AREN, KOTA TANGERANG SELATAN, BANTEN",91,151,103,254
https://kawalpemilu.org#53199,"PONDOK BETUNG, PONDOK AREN, KOTA TANGERANG SELATAN, BANTEN",92,79,102,181
https://kawalpemilu.org#53199,"PONDOK BETUNG, PONDOK AREN, KOTA TANGERANG SELATAN, BANTEN",93,80,85,165
https://kawalpemilu.org#53199,"PONDOK BETUNG, PONDOK AREN, KOTA TANGERANG SELATAN, BANTEN",94,115,73,188
https://kawalpemilu.org#53199,"PONDOK BETUNG, PONDOK AREN, KOTA TANGERANG SELATAN, BANTEN",95,80,96,176
https://kawalpemilu.org#53199,"PONDOK BETUNG, PONDOK AREN, KOTA TANGERANG SELATAN, BANTEN",96,107,88,195
https://kawalpemilu.org#53199,"PONDOK BETUNG, PONDOK AREN, KOTA TANGERANG SELATAN, BANTEN",97,93,64,157
https://kawalpemilu.org#53199,"PONDOK BETUNG, PONDOK AREN, KOTA TANGERANG SELATAN, BANTEN",98,88,66,154
https://kawalpemilu.org#53199,"PONDOK BETUNG, PONDOK AREN, KOTA TANGERANG SELATAN, BANTEN",99,144,64,208
https://kawalpemilu.org#53199,"PONDOK BETUNG, PONDOK AREN, KOTA TANGERANG SELATAN, BANTEN",100,167,85,252
https://kawalpemilu.org#53199,"PONDOK BETUNG, PONDOK AREN, KOTA TANGERANG SELATAN, BANTEN",101,168,46,214
https://kawalpemilu.org#53199,"PONDOK BETUNG, PONDOK AREN, KOTA TANGERANG SELATAN, BANTEN",102,127,54,181
https://kawalpemilu.org#53199,"PONDOK BETUNG, PONDOK AREN, KOTA TANGERANG SELATAN, BANTEN",103,166,47,213
https://kawalpemilu.org#53199,"PONDOK BETUNG, PONDOK AREN, KOTA TANGERANG SELATAN, BANTEN",104,132,78,210
https://kawalpemilu.org#53199,"PONDOK BETUNG, PONDOK AREN, KOTA TANGERANG SELATAN, BANTEN",105,165,62,227
https://kawalpemilu.org#53199,"PONDOK BETUNG, PONDOK AREN, KOTA TANGERANG SELATAN, BANTEN",106,113,46,159
https://kawalpemilu.org#53200,"PONDOK PUCUNG, PONDOK AREN, KOTA TANGERANG SELATAN, BANTEN",1,101,112,213
https://kawalpemilu.org#53200,"PONDOK PUCUNG, PONDOK AREN, KOTA TANGERANG SELATAN, BANTEN",2,90,123,213
https://kawalpemilu.org#53200,"PONDOK PUCUNG, PONDOK AREN, KOTA TANGERANG SELATAN, BANTEN",3,92,96,188
https://kawalpemilu.org#53200,"PONDOK PUCUNG, PONDOK AREN, KOTA TANGERANG SELATAN, BANTEN",4,124,122,246
https://kawalpemilu.org#53200,"PONDOK PUCUNG, PONDOK AREN, KOTA TANGERANG SELATAN, BANTEN",5,127,93,220
https://kawalpemilu.org#53200,"PONDOK PUCUNG, PONDOK AREN, KOTA TANGERANG SELATAN, BANTEN",6,120,137,257
https://kawalpemilu.org#53200,"PONDOK PUCUNG, PONDOK AREN, KOTA TANGERANG SELATAN, BANTEN",7,117,124,241
https://kawalpemilu.org#53200,"PONDOK PUCUNG, PONDOK AREN, KOTA TANGERANG SELATAN, BANTEN",8,113,118,231
https://kawalpemilu.org#53200,"PONDOK PUCUNG, PONDOK AREN, KOTA TANGERANG SELATAN, BANTEN",9,110,132,242
https://kawalpemilu.org#53200,"PONDOK PUCUNG, PONDOK AREN, KOTA TANGERANG SELATAN, BANTEN",10,133,60,193
https://kawalpemilu.org#53200,"PONDOK PUCUNG, PONDOK AREN, KOTA TANGERANG SELATAN, BANTEN",11,98,111,209
https://kawalpemilu.org#53200,"PONDOK PUCUNG, PONDOK AREN, KOTA TANGERANG SELATAN, BANTEN",12,101,90,191
https://kawalpemilu.org#53200,"PONDOK PUCUNG, PONDOK AREN, KOTA TANGERANG SELATAN, BANTEN",13,150,70,220
https://kawalpemilu.org#53200,"PONDOK PUCUNG, PONDOK AREN, KOTA TANGERANG SELATAN, BANTEN",14,119,111,230
https://kawalpemilu.org#53200,"PONDOK PUCUNG, PONDOK AREN, KOTA TANGERANG SELATAN, BANTEN",16,83,119,202
https://kawalpemilu.org#53200,"PONDOK PUCUNG, PONDOK AREN, KOTA TANGERANG SELATAN, BANTEN",17,145,99,244
https://kawalpemilu.org#53200,"PONDOK PUCUNG, PONDOK AREN, KOTA TANGERANG SELATAN, BANTEN",18,149,98,247
https://kawalpemilu.org#53200,"PONDOK PUCUNG, PONDOK AREN, KOTA TANGERANG SELATAN, BANTEN",19,151,108,259
https://kawalpemilu.org#53200,"PONDOK PUCUNG, PONDOK AREN, KOTA TANGERANG SELATAN, BANTEN",20,120,124,244
https://kawalpemilu.org#53200,"PONDOK PUCUNG, PONDOK AREN, KOTA TANGERANG SELATAN, BANTEN",21,83,46,129
https://kawalpemilu.org#53200,"PONDOK PUCUNG, PONDOK AREN, KOTA TANGERANG SELATAN, BANTEN",22,105,107,212
https://kawalpemilu.org#53200,"PONDOK PUCUNG, PONDOK AREN, KOTA TANGERANG SELATAN, BANTEN",23,137,100,237
https://kawalpemilu.org#53200,"PONDOK PUCUNG, PONDOK AREN, KOTA TANGERANG SELATAN, BANTEN",24,93,111,204
https://kawalpemilu.org#53200,"PONDOK PUCUNG, PONDOK AREN, KOTA TANGERANG SELATAN, BANTEN",25,103,121,224
https://kawalpemilu.org#53200,"PONDOK PUCUNG, PONDOK AREN, KOTA TANGERANG SELATAN, BANTEN",26,150,130,280
https://kawalpemilu.org#53200,"PONDOK PUCUNG, PONDOK AREN, KOTA TANGERANG SELATAN, BANTEN",27,106,117,223
https://kawalpemilu.org#53200,"PONDOK PUCUNG, PONDOK AREN, KOTA TANGERANG SELATAN, BANTEN",28,132,115,247
https://kawalpemilu.org#53200,"PONDOK PUCUNG, PONDOK AREN, KOTA TANGERANG SELATAN, BANTEN",29,119,115,234
https://kawalpemilu.org#53200,"PONDOK PUCUNG, PONDOK AREN, KOTA TANGERANG SELATAN, BANTEN",30,160,112,272
https://kawalpemilu.org#53200,"PONDOK PUCUNG, PONDOK AREN, KOTA TANGERANG SELATAN, BANTEN",31,142,137,279
https://kawalpemilu.org#53200,"PONDOK PUCUNG, PONDOK AREN, KOTA TANGERANG SELATAN, BANTEN",32,98,120,218
https://kawalpemilu.org#53200,"PONDOK PUCUNG, PONDOK AREN, KOTA TANGERANG SELATAN, BANTEN",33,143,110,253
https://kawalpemilu.org#53200,"PONDOK PUCUNG, PONDOK AREN, KOTA TANGERANG SELATAN, BANTEN",34,107,114,221
https://kawalpemilu.org#53200,"PONDOK PUCUNG, PONDOK AREN, KOTA TANGERANG SELATAN, BANTEN",35,132,139,271
https://kawalpemilu.org#53200,"PONDOK PUCUNG, PONDOK AREN, KOTA TANGERANG SELATAN, BANTEN",36,114,123,237
https://kawalpemilu.org#53200,"PONDOK PUCUNG, PONDOK AREN, KOTA TANGERANG SELATAN, BANTEN",37,173,51,224
https://kawalpemilu.org#53200,"PONDOK PUCUNG, PONDOK AREN, KOTA TANGERANG SELATAN, BANTEN",38,126,129,255
https://kawalpemilu.org#53200,"PONDOK PUCUNG, PONDOK AREN, KOTA TANGERANG SELATAN, BANTEN",39,130,107,237
https://kawalpemilu.org#53200,"PONDOK PUCUNG, PONDOK AREN, KOTA TANGERANG SELATAN, BANTEN",40,141,113,254
https://kawalpemilu.org#53200,"PONDOK PUCUNG, PONDOK AREN, KOTA TANGERANG SELATAN, BANTEN",41,134,113,247
https://kawalpemilu.org#53200,"PONDOK PUCUNG, PONDOK AREN, KOTA TANGERANG SELATAN, BANTEN",42,163,65,228
https://kawalpemilu.org#53200,"PONDOK PUCUNG, PONDOK AREN, KOTA TANGERANG SELATAN, BANTEN",43,183,69,252
https://kawalpemilu.org#53200,"PONDOK PUCUNG, PONDOK AREN, KOTA TANGERANG SELATAN, BANTEN",44,176,72,248
https://kawalpemilu.org#53200,"PONDOK PUCUNG, PONDOK AREN, KOTA TANGERANG SELATAN, BANTEN",45,208,66,274
https://kawalpemilu.org#53200,"PONDOK PUCUNG, PONDOK AREN, KOTA TANGERANG SELATAN, BANTEN",46,119,41,160
https://kawalpemilu.org#53200,"PONDOK PUCUNG, PONDOK AREN, KOTA TANGERANG SELATAN, BANTEN",47,166,61,227
https://kawalpemilu.org#53200,"PONDOK PUCUNG, PONDOK AREN, KOTA TANGERANG SELATAN, BANTEN",48,182,66,248
https://kawalpemilu.org#53200,"PONDOK PUCUNG, PONDOK AREN, KOTA TANGERANG SELATAN, BANTEN",49,158,86,244
https://kawalpemilu.org#53200,"PONDOK PUCUNG, PONDOK AREN, KOTA TANGERANG SELATAN, BANTEN",50,170,94,264
https://kawalpemilu.org#53200,"PONDOK PUCUNG, PONDOK AREN, KOTA TANGERANG SELATAN, BANTEN",51,146,94,240
https://kawalpemilu.org#53200,"PONDOK PUCUNG, PONDOK AREN, KOTA TANGERANG SELATAN, BANTEN",52,140,63,203
https://kawalpemilu.org#53200,"PONDOK PUCUNG, PONDOK AREN, KOTA TANGERANG SELATAN, BANTEN",53,174,74,248
https://kawalpemilu.org#53200,"PONDOK PUCUNG, PONDOK AREN, KOTA TANGERANG SELATAN, BANTEN",54,152,70,222
https://kawalpemilu.org#53200,"PONDOK PUCUNG, PONDOK AREN, KOTA TANGERANG SELATAN, BANTEN",55,182,67,249
https://kawalpemilu.org#53200,"PONDOK PUCUNG, PONDOK AREN, KOTA TANGERANG SELATAN, BANTEN",56,175,82,257
https://kawalpemilu.org#53200,"PONDOK PUCUNG, PONDOK AREN, KOTA TANGERANG SELATAN, BANTEN",57,177,68,245
https://kawalpemilu.org#53200,"PONDOK PUCUNG, PONDOK AREN, KOTA TANGERANG SELATAN, BANTEN",58,138,46,184
https://kawalpemilu.org#53200,"PONDOK PUCUNG, PONDOK AREN, KOTA TANGERANG SELATAN, BANTEN",59,105,69,174
https://kawalpemilu.org#53200,"PONDOK PUCUNG, PONDOK AREN, KOTA TANGERANG SELATAN, BANTEN",60,111,62,173
https://kawalpemilu.org#53200,"PONDOK PUCUNG, PONDOK AREN, KOTA TANGERANG SELATAN, BANTEN",61,126,129,255
https://kawalpemilu.org#53200,"PONDOK PUCUNG, PONDOK AREN, KOTA TANGERANG SELATAN, BANTEN",62,126,131,257
https://kawalpemilu.org#53200,"PONDOK PUCUNG, PONDOK AREN, KOTA TANGERANG SELATAN, BANTEN",63,107,105,212
https://kawalpemilu.org#53200,"PONDOK PUCUNG, PONDOK AREN, KOTA TANGERANG SELATAN, BANTEN",64,115,76,191
https://kawalpemilu.org#53200,"PONDOK PUCUNG, PONDOK AREN, KOTA TANGERANG SELATAN, BANTEN",65,103,106,212
https://kawalpemilu.org#53200,"PONDOK PUCUNG, PONDOK AREN, KOTA TANGERANG SELATAN, BANTEN",66,97,68,165
https://kawalpemilu.org#53200,"PONDOK PUCUNG, PONDOK AREN, KOTA TANGERANG SELATAN, BANTEN",67,85,78,163
https://kawalpemilu.org#53200,"PONDOK PUCUNG, PONDOK AREN, KOTA TANGERANG SELATAN, BANTEN",68,103,100,203
https://kawalpemilu.org#53200,"PONDOK PUCUNG, PONDOK AREN, KOTA TANGERANG SELATAN, BANTEN",69,98,81,179
https://kawalpemilu.org#53200,"PONDOK PUCUNG, PONDOK AREN, KOTA TANGERANG SELATAN, BANTEN",70,127,131,258
https://kawalpemilu.org#53200,"PONDOK PUCUNG, PONDOK AREN, KOTA TANGERANG SELATAN, BANTEN",71,82,68,141
https://kawalpemilu.org#53200,"PONDOK PUCUNG, PONDOK AREN, KOTA TANGERANG SELATAN, BANTEN",72,91,84,175
https://kawalpemilu.org#53200,"PONDOK PUCUNG, PONDOK AREN, KOTA TANGERANG SELATAN, BANTEN",73,94,29,123
https://kawalpemilu.org#53200,"PONDOK PUCUNG, PONDOK AREN, KOTA TANGERANG SELATAN, BANTEN",74,115,55,170
https://kawalpemilu.org#53201,"PONDOK KARYA, PONDOK AREN, KOTA TANGERANG SELATAN, BANTEN",1,118,108,226
https://kawalpemilu.org#53201,"PONDOK KARYA, PONDOK AREN, KOTA TANGERANG SELATAN, BANTEN",2,120,91,211
https://kawalpemilu.org#53201,"PONDOK KARYA, PONDOK AREN, KOTA TANGERANG SELATAN, BANTEN",3,78,154,232
https://kawalpemilu.org#53201,"PONDOK KARYA, PONDOK AREN, KOTA TANGERANG SELATAN, BANTEN",4,103,131,234
https://kawalpemilu.org#53201,"PONDOK KARYA, PONDOK AREN, KOTA TANGERANG SELATAN, BANTEN",5,79,86,165
https://kawalpemilu.org#53201,"PONDOK KARYA, PONDOK AREN, KOTA TANGERANG SELATAN, BANTEN",6,67,76,143
https://kawalpemilu.org#53201,"PONDOK KARYA, PONDOK AREN, KOTA TANGERANG SELATAN, BANTEN",7,72,65,137
https://kawalpemilu.org#53201,"PONDOK KARYA, PONDOK AREN, KOTA TANGERANG SELATAN, BANTEN",8,85,68,153
https://kawalpemilu.org#53201,"PONDOK KARYA, PONDOK AREN, KOTA TANGERANG SELATAN, BANTEN",9,82,74,156
https://kawalpemilu.org#53201,"PONDOK KARYA, PONDOK AREN, KOTA TANGERANG SELATAN, BANTEN",10,96,83,179
https://kawalpemilu.org#53201,"PONDOK KARYA, PONDOK AREN, KOTA TANGERANG SELATAN, BANTEN",11,79,85,164
https://kawalpemilu.org#53201,"PONDOK KARYA, PONDOK AREN, KOTA TANGERANG SELATAN, BANTEN",12,91,119,210
https://kawalpemilu.org#53201,"PONDOK KARYA, PONDOK AREN, KOTA TANGERANG SELATAN, BANTEN",13,89,102,191
https://kawalpemilu.org#53201,"PONDOK KARYA, PONDOK AREN, KOTA TANGERANG SELATAN, BANTEN",14,95,90,185
https://kawalpemilu.org#53201,"PONDOK KARYA, PONDOK AREN, KOTA TANGERANG SELATAN, BANTEN",15,87,82,169
https://kawalpemilu.org#53201,"PONDOK KARYA, PONDOK AREN, KOTA TANGERANG SELATAN, BANTEN",16,124,93,217
https://kawalpemilu.org#53201,"PONDOK KARYA, PONDOK AREN, KOTA TANGERANG SELATAN, BANTEN",17,100,140,240
https://kawalpemilu.org#53201,"PONDOK KARYA, PONDOK AREN, KOTA TANGERANG SELATAN, BANTEN",18,95,103,198
https://kawalpemilu.org#53201,"PONDOK KARYA, PONDOK AREN, KOTA TANGERANG SELATAN, BANTEN",19,96,127,223
https://kawalpemilu.org#53201,"PONDOK KARYA, PONDOK AREN, KOTA TANGERANG SELATAN, BANTEN",20,108,115,223
https://kawalpemilu.org#53201,"PONDOK KARYA, PONDOK AREN, KOTA TANGERANG SELATAN, BANTEN",21,156,97,253
https://kawalpemilu.org#53201,"PONDOK KARYA, PONDOK AREN, KOTA TANGERANG SELATAN, BANTEN",22,85,117,202
https://kawalpemilu.org#53201,"PONDOK KARYA, PONDOK AREN, KOTA TANGERANG SELATAN, BANTEN",23,83,102,185
https://kawalpemilu.org#53201,"PONDOK KARYA, PONDOK AREN, KOTA TANGERANG SELATAN, BANTEN",24,83,83,166
https://kawalpemilu.org#53201,"PONDOK KARYA, PONDOK AREN, KOTA TANGERANG SELATAN, BANTEN",25,78,82,160
https://kawalpemilu.org#53201,"PONDOK KARYA, PONDOK AREN, KOTA TANGERANG SELATAN, BANTEN",26,84,79,163
https://kawalpemilu.org#53201,"PONDOK KARYA, PONDOK AREN, KOTA TANGERANG SELATAN, BANTEN",27,110,74,184
https://kawalpemilu.org#53201,"PONDOK KARYA, PONDOK AREN, KOTA TANGERANG SELATAN, BANTEN",28,95,114,209
https://kawalpemilu.org#53201,"PONDOK KARYA, PONDOK AREN, KOTA TANGERANG SELATAN, BANTEN",29,74,129,203
https://kawalpemilu.org#53201,"PONDOK KARYA, PONDOK AREN, KOTA TANGERANG SELATAN, BANTEN",30,95,59,154
https://kawalpemilu.org#53201,"PONDOK KARYA, PONDOK AREN, KOTA TANGERANG SELATAN, BANTEN",31,142,92,234
https://kawalpemilu.org#53201,"PONDOK KARYA, PONDOK AREN, KOTA TANGERANG SELATAN, BANTEN",32,159,82,241
https://kawalpemilu.org#53201,"PONDOK KARYA, PONDOK AREN, KOTA TANGERANG SELATAN, BANTEN",33,126,130,256
https://kawalpemilu.org#53201,"PONDOK KARYA, PONDOK AREN, KOTA TANGERANG SELATAN, BANTEN",34,128,127,255
https://kawalpemilu.org#53201,"PONDOK KARYA, PONDOK AREN, KOTA TANGERANG SELATAN, BANTEN",35,86,89,175
https://kawalpemilu.org#53201,"PONDOK KARYA, PONDOK AREN, KOTA TANGERANG SELATAN, BANTEN",36,124,81,205
https://kawalpemilu.org#53201,"PONDOK KARYA, PONDOK AREN, KOTA TANGERANG SELATAN, BANTEN",37,134,98,232
https://kawalpemilu.org#53201,"PONDOK KARYA, PONDOK AREN, KOTA TANGERANG SELATAN, BANTEN",38,132,119,251
https://kawalpemilu.org#53201,"PONDOK KARYA, PONDOK AREN, KOTA TANGERANG SELATAN, BANTEN",39,115,88,203
https://kawalpemilu.org#53201,"PONDOK KARYA, PONDOK AREN, KOTA TANGERANG SELATAN, BANTEN",40,124,82,206
https://kawalpemilu.org#53201,"PONDOK KARYA, PONDOK AREN, KOTA TANGERANG SELATAN, BANTEN",41,78,122,200
https://kawalpemilu.org#53201,"PONDOK KARYA, PONDOK AREN, KOTA TANGERANG SELATAN, BANTEN",42,136,128,264
https://kawalpemilu.org#53201,"PONDOK KARYA, PONDOK AREN, KOTA TANGERANG SELATAN, BANTEN",43,138,76,214
https://kawalpemilu.org#53201,"PONDOK KARYA, PONDOK AREN, KOTA TANGERANG SELATAN, BANTEN",44,132,92,224
https://kawalpemilu.org#53201,"PONDOK KARYA, PONDOK AREN, KOTA TANGERANG SELATAN, BANTEN",45,132,74,206
https://kawalpemilu.org#53201,"PONDOK KARYA, PONDOK AREN, KOTA TANGERANG SELATAN, BANTEN",46,126,113,239
https://kawalpemilu.org#53201,"PONDOK KARYA, PONDOK AREN, KOTA TANGERANG SELATAN, BANTEN",47,94,119,213
https://kawalpemilu.org#53201,"PONDOK KARYA, PONDOK AREN, KOTA TANGERANG SELATAN, BANTEN",48,114,112,226
https://kawalpemilu.org#53201,"PONDOK KARYA, PONDOK AREN, KOTA TANGERANG SELATAN, BANTEN",49,115,123,247
https://kawalpemilu.org#53201,"PONDOK KARYA, PONDOK AREN, KOTA TANGERANG SELATAN, BANTEN",50,161,46,207
https://kawalpemilu.org#53201,"PONDOK KARYA, PONDOK AREN, KOTA TANGERANG SELATAN, BANTEN",51,129,69,198
https://kawalpemilu.org#53201,"PONDOK KARYA, PONDOK AREN, KOTA TANGERANG SELATAN, BANTEN",52,130,92,222
https://kawalpemilu.org#53201,"PONDOK KARYA, PONDOK AREN, KOTA TANGERANG SELATAN, BANTEN",53,123,89,212
https://kawalpemilu.org#53201,"PONDOK KARYA, PONDOK AREN, KOTA TANGERANG SELATAN, BANTEN",54,164,110,274
https://kawalpemilu.org#53201,"PONDOK KARYA, PONDOK AREN, KOTA TANGERANG SELATAN, BANTEN",55,151,86,237
https://kawalpemilu.org#53201,"PONDOK KARYA, PONDOK AREN, KOTA TANGERANG SELATAN, BANTEN",56,152,77,229
https://kawalpemilu.org#53201,"PONDOK KARYA, PONDOK AREN, KOTA TANGERANG SELATAN, BANTEN",57,129,99,228
https://kawalpemilu.org#53201,"PONDOK KARYA, PONDOK AREN, KOTA TANGERANG SELATAN, BANTEN",58,143,86,229
https://kawalpemilu.org#53201,"PONDOK KARYA, PONDOK AREN, KOTA TANGERANG SELATAN, BANTEN",59,142,111,253
https://kawalpemilu.org#53201,"PONDOK KARYA, PONDOK AREN, KOTA TANGERANG SELATAN, BANTEN",60,161,125,286
https://kawalpemilu.org#53201,"PONDOK KARYA, PONDOK AREN, KOTA TANGERANG SELATAN, BANTEN",61,109,107,216
https://kawalpemilu.org#53201,"PONDOK KARYA, PONDOK AREN, KOTA TANGERANG SELATAN, BANTEN",62,135,109,244
https://kawalpemilu.org#53201,"PONDOK KARYA, PONDOK AREN, KOTA TANGERANG SELATAN, BANTEN",63,171,110,281
https://kawalpemilu.org#53201,"PONDOK KARYA, PONDOK AREN, KOTA TANGERANG SELATAN, BANTEN",64,132,133,265
https://kawalpemilu.org#53201,"PONDOK KARYA, PONDOK AREN, KOTA TANGERANG SELATAN, BANTEN",65,126,144,270
https://kawalpemilu.org#53201,"PONDOK KARYA, PONDOK AREN, KOTA TANGERANG SELATAN, BANTEN",66,62,33,95
https://kawalpemilu.org#53201,"PONDOK KARYA, PONDOK AREN, KOTA TANGERANG SELATAN, BANTEN",67,66,63,129
https://kawalpemilu.org#53201,"PONDOK KARYA, PONDOK AREN, KOTA TANGERANG SELATAN, BANTEN",68,50,57,107
https://kawalpemilu.org#53201,"PONDOK KARYA, PONDOK AREN, KOTA TANGERANG SELATAN, BANTEN",69,66,71,137
https://kawalpemilu.org#53201,"PONDOK KARYA, PONDOK AREN, KOTA TANGERANG SELATAN, BANTEN",70,160,47,207
https://kawalpemilu.org#53201,"PONDOK KARYA, PONDOK AREN, KOTA TANGERANG SELATAN, BANTEN",71,141,73,214
https://kawalpemilu.org#53201,"PONDOK KARYA, PONDOK AREN, KOTA TANGERANG SELATAN, BANTEN",72,149,68,217
https://kawalpemilu.org#53201,"PONDOK KARYA, PONDOK AREN, KOTA TANGERANG SELATAN, BANTEN",73,173,70,243
https://kawalpemilu.org#53201,"PONDOK KARYA, PONDOK AREN, KOTA TANGERANG SELATAN, BANTEN",74,167,53,220
https://kawalpemilu.org#53201,"PONDOK KARYA, PONDOK AREN, KOTA TANGERANG SELATAN, BANTEN",75,132,61,193
https://kawalpemilu.org#53201,"PONDOK KARYA, PONDOK AREN, KOTA TANGERANG SELATAN, BANTEN",76,136,53,189
https://kawalpemilu.org#53201,"PONDOK KARYA, PONDOK AREN, KOTA TANGERANG SELATAN, BANTEN",77,164,69,233
https://kawalpemilu.org#53201,"PONDOK KARYA, PONDOK AREN, KOTA TANGERANG SELATAN, BANTEN",78,162,64,226
https://kawalpemilu.org#53201,"PONDOK KARYA, PONDOK AREN, KOTA TANGERANG SELATAN, BANTEN",79,153,100,253
https://kawalpemilu.org#53202,"PONDOK JAYA, PONDOK AREN, KOTA TANGERANG SELATAN, BANTEN",1,116,148,264
https://kawalpemilu.org#53202,"PONDOK JAYA, PONDOK AREN, KOTA TANGERANG SELATAN, BANTEN",2,87,82,169
https://kawalpemilu.org#53202,"PONDOK JAYA, PONDOK AREN, KOTA TANGERANG SELATAN, BANTEN",3,104,183,287
https://kawalpemilu.org#53202,"PONDOK JAYA, PONDOK AREN, KOTA TANGERANG SELATAN, BANTEN",4,183,99,282
https://kawalpemilu.org#53202,"PONDOK JAYA, PONDOK AREN, KOTA TANGERANG SELATAN, BANTEN",5,143,93,236
https://kawalpemilu.org#53202,"PONDOK JAYA, PONDOK AREN, KOTA TANGERANG SELATAN, BANTEN",6,139,118,257
https://kawalpemilu.org#53202,"PONDOK JAYA, PONDOK AREN, KOTA TANGERANG SELATAN, BANTEN",7,154,95,249
https://kawalpemilu.org#53202,"PONDOK JAYA, PONDOK AREN, KOTA TANGERANG SELATAN, BANTEN",8,133,127,260
https://kawalpemilu.org#53202,"PONDOK JAYA, PONDOK AREN, KOTA TANGERANG SELATAN, BANTEN",9,102,148,250
https://kawalpemilu.org#53202,"PONDOK JAYA, PONDOK AREN, KOTA TANGERANG SELATAN, BANTEN",10,117,152,269
https://kawalpemilu.org#53202,"PONDOK JAYA, PONDOK AREN, KOTA TANGERANG SELATAN, BANTEN",11,98,141,239
https://kawalpemilu.org#53202,"PONDOK JAYA, PONDOK AREN, KOTA TANGERANG SELATAN, BANTEN",12,108,173,281
https://kawalpemilu.org#53202,"PONDOK JAYA, PONDOK AREN, KOTA TANGERANG SELATAN, BANTEN",13,111,123,234
https://kawalpemilu.org#53202,"PONDOK JAYA, PONDOK AREN, KOTA TANGERANG SELATAN, BANTEN",14,121,175,296
https://kawalpemilu.org#53202,"PONDOK JAYA, PONDOK AREN, KOTA TANGERANG SELATAN, BANTEN",15,125,118,243
https://kawalpemilu.org#53202,"PONDOK JAYA, PONDOK AREN, KOTA TANGERANG SELATAN, BANTEN",16,143,131,274
https://kawalpemilu.org#53202,"PONDOK JAYA, PONDOK AREN, KOTA TANGERANG SELATAN, BANTEN",17,161,89,250
https://kawalpemilu.org#53202,"PONDOK JAYA, PONDOK AREN, KOTA TANGERANG SELATAN, BANTEN",18,188,69,257
https://kawalpemilu.org#53202,"PONDOK JAYA, PONDOK AREN, KOTA TANGERANG SELATAN, BANTEN",19,120,85,205
https://kawalpemilu.org#53202,"PONDOK JAYA, PONDOK AREN, KOTA TANGERANG SELATAN, BANTEN",20,117,127,244
https://kawalpemilu.org#53202,"PONDOK JAYA, PONDOK AREN, KOTA TANGERANG SELATAN, BANTEN",21,83,168,251
https://kawalpemilu.org#53202,"PONDOK JAYA, PONDOK AREN, KOTA TANGERANG SELATAN, BANTEN",22,194,83,277
https://kawalpemilu.org#53202,"PONDOK JAYA, PONDOK AREN, KOTA TANGERANG SELATAN, BANTEN",23,176,57,233
https://kawalpemilu.org#53202,"PONDOK JAYA, PONDOK AREN, KOTA TANGERANG SELATAN, BANTEN",24,148,59,207
https://kawalpemilu.org#53202,"PONDOK JAYA, PONDOK AREN, KOTA TANGERANG SELATAN, BANTEN",25,142,70,212
https://kawalpemilu.org#53202,"PONDOK JAYA, PONDOK AREN, KOTA TANGERANG SELATAN, BANTEN",26,76,81,157
https://kawalpemilu.org#53203,"PONDOK AREN, PONDOK AREN, KOTA TANGERANG SELATAN, BANTEN",1,121,91,212
https://kawalpemilu.org#53203,"PONDOK AREN, PONDOK AREN, KOTA TANGERANG SELATAN, BANTEN",2,103,117,220
https://kawalpemilu.org#53203,"PONDOK AREN, PONDOK AREN, KOTA TANGERANG SELATAN, BANTEN",3,118,87,205
https://kawalpemilu.org#53203,"PONDOK AREN, PONDOK AREN, KOTA TANGERANG SELATAN, BANTEN",4,115,141,256
https://kawalpemilu.org#53203,"PONDOK AREN, PONDOK AREN, KOTA TANGERANG SELATAN, BANTEN",5,80,126,206
https://kawalpemilu.org#53203,"PONDOK AREN, PONDOK AREN, KOTA TANGERANG SELATAN, BANTEN",6,102,123,225
https://kawalpemilu.org#53203,"PONDOK AREN, PONDOK AREN, KOTA TANGERANG SELATAN, BANTEN",7,105,169,274
https://kawalpemilu.org#53203,"PONDOK AREN, PONDOK AREN, KOTA TANGERANG SELATAN, BANTEN",8,98,139,237
https://kawalpemilu.org#53203,"PONDOK AREN, PONDOK AREN, KOTA TANGERANG SELATAN, BANTEN",9,102,93,195
https://kawalpemilu.org#53203,"PONDOK AREN, PONDOK AREN, KOTA TANGERANG SELATAN, BANTEN",10,99,94,193
https://kawalpemilu.org#53203,"PONDOK AREN, PONDOK AREN, KOTA TANGERANG SELATAN, BANTEN",11,82,95,177
https://kawalpemilu.org#53203,"PONDOK AREN, PONDOK AREN, KOTA TANGERANG SELATAN, BANTEN",12,85,112,197
https://kawalpemilu.org#53203,"PONDOK AREN, PONDOK AREN, KOTA TANGERANG SELATAN, BANTEN",13,123,88,211
https://kawalpemilu.org#53203,"PONDOK AREN, PONDOK AREN, KOTA TANGERANG SELATAN, BANTEN",14,78,120,198
https://kawalpemilu.org#53203,"PONDOK AREN, PONDOK AREN, KOTA TANGERANG SELATAN, BANTEN",15,49,124,173
https://kawalpemilu.org#53203,"PONDOK AREN, PONDOK AREN, KOTA TANGERANG SELATAN, BANTEN",16,71,107,178
https://kawalpemilu.org#53203,"PONDOK AREN, PONDOK AREN, KOTA TANGERANG SELATAN, BANTEN",17,73,70,143
https://kawalpemilu.org#53203,"PONDOK AREN, PONDOK AREN, KOTA TANGERANG SELATAN, BANTEN",18,128,107,235
https://kawalpemilu.org#53203,"PONDOK AREN, PONDOK AREN, KOTA TANGERANG SELATAN, BANTEN",19,103,91,194
https://kawalpemilu.org#53203,"PONDOK AREN, PONDOK AREN, KOTA TANGERANG SELATAN, BANTEN",20,78,116,194
https://kawalpemilu.org#53203,"PONDOK AREN, PONDOK AREN, KOTA TANGERANG SELATAN, BANTEN",21,89,115,204
https://kawalpemilu.org#53203,"PONDOK AREN, PONDOK AREN, KOTA TANGERANG SELATAN, BANTEN",22,76,156,232
https://kawalpemilu.org#53203,"PONDOK AREN, PONDOK AREN, KOTA TANGERANG SELATAN, BANTEN",23,93,130,223
https://kawalpemilu.org#53203,"PONDOK AREN, PONDOK AREN, KOTA TANGERANG SELATAN, BANTEN",24,147,93,240
https://kawalpemilu.org#53203,"PONDOK AREN, PONDOK AREN, KOTA TANGERANG SELATAN, BANTEN",25,98,193,291
https://kawalpemilu.org#53203,"PONDOK AREN, PONDOK AREN, KOTA TANGERANG SELATAN, BANTEN",26,98,189,287
https://kawalpemilu.org#53203,"PONDOK AREN, PONDOK AREN, KOTA TANGERANG SELATAN, BANTEN",27,106,116,222
https://kawalpemilu.org#53203,"PONDOK AREN, PONDOK AREN, KOTA TANGERANG SELATAN, BANTEN",28,117,156,273
https://kawalpemilu.org#53203,"PONDOK AREN, PONDOK AREN, KOTA TANGERANG SELATAN, BANTEN",29,111,166,277
https://kawalpemilu.org#53203,"PONDOK AREN, PONDOK AREN, KOTA TANGERANG SELATAN, BANTEN",30,107,143,250
https://kawalpemilu.org#53203,"PONDOK AREN, PONDOK AREN, KOTA TANGERANG SELATAN, BANTEN",31,112,138,250
https://kawalpemilu.org#53203,"PONDOK AREN, PONDOK AREN, KOTA TANGERANG SELATAN, BANTEN",32,84,103,187
https://kawalpemilu.org#53203,"PONDOK AREN, PONDOK AREN, KOTA TANGERANG SELATAN, BANTEN",33,101,120,221
https://kawalpemilu.org#53203,"PONDOK AREN, PONDOK AREN, KOTA TANGERANG SELATAN, BANTEN",34,64,101,165
https://kawalpemilu.org#53203,"PONDOK AREN, PONDOK AREN, KOTA TANGERANG SELATAN, BANTEN",35,148,76,224
https://kawalpemilu.org#53203,"PONDOK AREN, PONDOK AREN, KOTA TANGERANG SELATAN, BANTEN",36,128,99,227
https://kawalpemilu.org#53203,"PONDOK AREN, PONDOK AREN, KOTA TANGERANG SELATAN, BANTEN",37,132,70,202
https://kawalpemilu.org#53203,"PONDOK AREN, PONDOK AREN, KOTA TANGERANG SELATAN, BANTEN",38,86,77,163
https://kawalpemilu.org#53203,"PONDOK AREN, PONDOK AREN, KOTA TANGERANG SELATAN, BANTEN",39,115,95,210
https://kawalpemilu.org#53203,"PONDOK AREN, PONDOK AREN, KOTA TANGERANG SELATAN, BANTEN",40,157,75,232
https://kawalpemilu.org#53203,"PONDOK AREN, PONDOK AREN, KOTA TANGERANG SELATAN, BANTEN",41,135,98,233
https://kawalpemilu.org#53203,"PONDOK AREN, PONDOK AREN, KOTA TANGERANG SELATAN, BANTEN",42,158,93,251
https://kawalpemilu.org#53203,"PONDOK AREN, PONDOK AREN, KOTA TANGERANG SELATAN, BANTEN",43,125,110,235
https://kawalpemilu.org#53203,"PONDOK AREN, PONDOK AREN, KOTA TANGERANG SELATAN, BANTEN",44,101,99,200
https://kawalpemilu.org#53203,"PONDOK AREN, PONDOK AREN, KOTA TANGERANG SELATAN, BANTEN",45,114,128,242
https://kawalpemilu.org#53203,"PONDOK AREN, PONDOK AREN, KOTA TANGERANG SELATAN, BANTEN",46,82,156,238
https://kawalpemilu.org#53203,"PONDOK AREN, PONDOK AREN, KOTA TANGERANG SELATAN, BANTEN",47,103,150,253
https://kawalpemilu.org#53203,"PONDOK AREN, PONDOK AREN, KOTA TANGERANG SELATAN, BANTEN",48,113,136,249
https://kawalpemilu.org#53203,"PONDOK AREN, PONDOK AREN, KOTA TANGERANG SELATAN, BANTEN",49,101,152,253
https://kawalpemilu.org#53203,"PONDOK AREN, PONDOK AREN, KOTA TANGERANG SELATAN, BANTEN",50,109,154,263
https://kawalpemilu.org#53203,"PONDOK AREN, PONDOK AREN, KOTA TANGERANG SELATAN, BANTEN",51,129,116,246
https://kawalpemilu.org#53203,"PONDOK AREN, PONDOK AREN, KOTA TANGERANG SELATAN, BANTEN",52,108,147,255
https://kawalpemilu.org#53203,"PONDOK AREN, PONDOK AREN, KOTA TANGERANG SELATAN, BANTEN",53,90,140,230
https://kawalpemilu.org#53203,"PONDOK AREN, PONDOK AREN, KOTA TANGERANG SELATAN, BANTEN",54,75,140,215
https://kawalpemilu.org#53203,"PONDOK AREN, PONDOK AREN, KOTA TANGERANG SELATAN, BANTEN",55,76,149,225
https://kawalpemilu.org#53203,"PONDOK AREN, PONDOK AREN, KOTA TANGERANG SELATAN, BANTEN",56,73,147,220
https://kawalpemilu.org#53203,"PONDOK AREN, PONDOK AREN, KOTA TANGERANG SELATAN, BANTEN",57,91,110,201
https://kawalpemilu.org#53203,"PONDOK AREN, PONDOK AREN, KOTA TANGERANG SELATAN, BANTEN",58,74,125,199
https://kawalpemilu.org#53203,"PONDOK AREN, PONDOK AREN, KOTA TANGERANG SELATAN, BANTEN",59,74,122,196
https://kawalpemilu.org#53203,"PONDOK AREN, PONDOK AREN, KOTA TANGERANG SELATAN, BANTEN",60,51,131,182
https://kawalpemilu.org#53203,"PONDOK AREN, PONDOK AREN, KOTA TANGERANG SELATAN, BANTEN",61,67,118,185
https://kawalpemilu.org#53203,"PONDOK AREN, PONDOK AREN, KOTA TANGERANG SELATAN, BANTEN",62,56,108,164
https://kawalpemilu.org#53203,"PONDOK AREN, PONDOK AREN, KOTA TANGERANG SELATAN, BANTEN",63,163,98,261
https://kawalpemilu.org#53203,"PONDOK AREN, PONDOK AREN, KOTA TANGERANG SELATAN, BANTEN",64,118,137,255
https://kawalpemilu.org#53203,"PONDOK AREN, PONDOK AREN, KOTA TANGERANG SELATAN, BANTEN",66,123,91,214
https://kawalpemilu.org#53203,"PONDOK AREN, PONDOK AREN, KOTA TANGERANG SELATAN, BANTEN",67,143,96,239
https://kawalpemilu.org#53203,"PONDOK AREN, PONDOK AREN, KOTA TANGERANG SELATAN, BANTEN",68,101,118,219
https://kawalpemilu.org#53203,"PONDOK AREN, PONDOK AREN, KOTA TANGERANG SELATAN, BANTEN",69,88,136,224
https://kawalpemilu.org#53203,"PONDOK AREN, PONDOK AREN, KOTA TANGERANG SELATAN, BANTEN",70,109,128,237
https://kawalpemilu.org#53203,"PONDOK AREN, PONDOK AREN, KOTA TANGERANG SELATAN, BANTEN",71,142,120,262
https://kawalpemilu.org#53203,"PONDOK AREN, PONDOK AREN, KOTA TANGERANG SELATAN, BANTEN",72,132,137,269
https://kawalpemilu.org#53203,"PONDOK AREN, PONDOK AREN, KOTA TANGERANG SELATAN, BANTEN",73,116,136,252
https://kawalpemilu.org#53203,"PONDOK AREN, PONDOK AREN, KOTA TANGERANG SELATAN, BANTEN",74,117,140,257
https://kawalpemilu.org#53203,"PONDOK AREN, PONDOK AREN, KOTA TANGERANG SELATAN, BANTEN",75,113,104,217
https://kawalpemilu.org#53203,"PONDOK AREN, PONDOK AREN, KOTA TANGERANG SELATAN, BANTEN",76,108,101,209
https://kawalpemilu.org#53203,"PONDOK AREN, PONDOK AREN, KOTA TANGERANG SELATAN, BANTEN",77,102,122,224
https://kawalpemilu.org#53203,"PONDOK AREN, PONDOK AREN, KOTA TANGERANG SELATAN, BANTEN",78,109,127,236
https://kawalpemilu.org#53203,"PONDOK AREN, PONDOK AREN, KOTA TANGERANG SELATAN, BANTEN",79,102,136,238
https://kawalpemilu.org#53203,"PONDOK AREN, PONDOK AREN, KOTA TANGERANG SELATAN, BANTEN",80,91,99,190
https://kawalpemilu.org#53203,"PONDOK AREN, PONDOK AREN, KOTA TANGERANG SELATAN, BANTEN",81,124,85,209
https://kawalpemilu.org#53203,"PONDOK AREN, PONDOK AREN, KOTA TANGERANG SELATAN, BANTEN",82,147,98,245
https://kawalpemilu.org#53204,"PONDOK KACANG BARAT, PONDOK AREN, KOTA TANGERANG SELATAN, BANTEN",1,68,138,222
https://kawalpemilu.org#53204,"PONDOK KACANG BARAT, PONDOK AREN, KOTA TANGERANG SELATAN, BANTEN",2,85,100,185
https://kawalpemilu.org#53204,"PONDOK KACANG BARAT, PONDOK AREN, KOTA TANGERANG SELATAN, BANTEN",3,108,154,262
https://kawalpemilu.org#53204,"PONDOK KACANG BARAT, PONDOK AREN, KOTA TANGERANG SELATAN, BANTEN",4,97,148,245
https://kawalpemilu.org#53204,"PONDOK KACANG BARAT, PONDOK AREN, KOTA TANGERANG SELATAN, BANTEN",5,73,138,211
https://kawalpemilu.org#53204,"PONDOK KACANG BARAT, PONDOK AREN, KOTA TANGERANG SELATAN, BANTEN",6,73,123,196
https://kawalpemilu.org#53204,"PONDOK KACANG BARAT, PONDOK AREN, KOTA TANGERANG SELATAN, BANTEN",7,91,105,196
https://kawalpemilu.org#53204,"PONDOK KACANG BARAT, PONDOK AREN, KOTA TANGERANG SELATAN, BANTEN",8,90,127,217
https://kawalpemilu.org#53204,"PONDOK KACANG BARAT, PONDOK AREN, KOTA TANGERANG SELATAN, BANTEN",9,81,127,208
https://kawalpemilu.org#53204,"PONDOK KACANG BARAT, PONDOK AREN, KOTA TANGERANG SELATAN, BANTEN",10,84,87,171
https://kawalpemilu.org#53204,"PONDOK KACANG BARAT, PONDOK AREN, KOTA TANGERANG SELATAN, BANTEN",11,95,183,278
https://kawalpemilu.org#53204,"PONDOK KACANG BARAT, PONDOK AREN, KOTA TANGERANG SELATAN, BANTEN",12,83,122,205
https://kawalpemilu.org#53204,"PONDOK KACANG BARAT, PONDOK AREN, KOTA TANGERANG SELATAN, BANTEN",13,76,138,214
https://kawalpemilu.org#53204,"PONDOK KACANG BARAT, PONDOK AREN, KOTA TANGERANG SELATAN, BANTEN",14,96,114,210
https://kawalpemilu.org#53204,"PONDOK KACANG BARAT, PONDOK AREN, KOTA TANGERANG SELATAN, BANTEN",15,101,114,215
https://kawalpemilu.org#53204,"PONDOK KACANG BARAT, PONDOK AREN, KOTA TANGERANG SELATAN, BANTEN",16,117,134,251
https://kawalpemilu.org#53204,"PONDOK KACANG BARAT, PONDOK AREN, KOTA TANGERANG SELATAN, BANTEN",17,74,140,214
https://kawalpemilu.org#53204,"PONDOK KACANG BARAT, PONDOK AREN, KOTA TANGERANG SELATAN, BANTEN",18,88,103,191
https://kawalpemilu.org#53204,"PONDOK KACANG BARAT, PONDOK AREN, KOTA TANGERANG SELATAN, BANTEN",19,93,129,222
https://kawalpemilu.org#53204,"PONDOK KACANG BARAT, PONDOK AREN, KOTA TANGERANG SELATAN, BANTEN",20,117,113,230
https://kawalpemilu.org#53204,"PONDOK KACANG BARAT, PONDOK AREN, KOTA TANGERANG SELATAN, BANTEN",21,91,162,253
https://kawalpemilu.org#53204,"PONDOK KACANG BARAT, PONDOK AREN, KOTA TANGERANG SELATAN, BANTEN",22,83,159,242
https://kawalpemilu.org#53204,"PONDOK KACANG BARAT, PONDOK AREN, KOTA TANGERANG SELATAN, BANTEN",23,87,153,240
https://kawalpemilu.org#53204,"PONDOK KACANG BARAT, PONDOK AREN, KOTA TANGERANG SELATAN, BANTEN",24,100,122,222
https://kawalpemilu.org#53204,"PONDOK KACANG BARAT, PONDOK AREN, KOTA TANGERANG SELATAN, BANTEN",25,111,137,248
https://kawalpemilu.org#53204,"PONDOK KACANG BARAT, PONDOK AREN, KOTA TANGERANG SELATAN, BANTEN",26,78,163,241
https://kawalpemilu.org#53204,"PONDOK KACANG BARAT, PONDOK AREN, KOTA TANGERANG SELATAN, BANTEN",27,73,74,147
https://kawalpemilu.org#53204,"PONDOK KACANG BARAT, PONDOK AREN, KOTA TANGERANG SELATAN, BANTEN",28,111,123,234
https://kawalpemilu.org#53204,"PONDOK KACANG BARAT, PONDOK AREN, KOTA TANGERANG SELATAN, BANTEN",29,87,145,232
https://kawalpemilu.org#53204,"PONDOK KACANG BARAT, PONDOK AREN, KOTA TANGERANG SELATAN, BANTEN",30,92,151,243
https://kawalpemilu.org#53204,"PONDOK KACANG BARAT, PONDOK AREN, KOTA TANGERANG SELATAN, BANTEN",31,74,128,210
https://kawalpemilu.org#53204,"PONDOK KACANG BARAT, PONDOK AREN, KOTA TANGERANG SELATAN, BANTEN",32,79,114,193
https://kawalpemilu.org#53204,"PONDOK KACANG BARAT, PONDOK AREN, KOTA TANGERANG SELATAN, BANTEN",33,73,149,222
https://kawalpemilu.org#53204,"PONDOK KACANG BARAT, PONDOK AREN, KOTA TANGERANG SELATAN, BANTEN",34,62,130,192
https://kawalpemilu.org#53204,"PONDOK KACANG BARAT, PONDOK AREN, KOTA TANGERANG SELATAN, BANTEN",35,112,116,228
https://kawalpemilu.org#53204,"PONDOK KACANG BARAT, PONDOK AREN, KOTA TANGERANG SELATAN, BANTEN",36,68,114,182
https://kawalpemilu.org#53204,"PONDOK KACANG BARAT, PONDOK AREN, KOTA TANGERANG SELATAN, BANTEN",37,75,109,184
https://kawalpemilu.org#53204,"PONDOK KACANG BARAT, PONDOK AREN, KOTA TANGERANG SELATAN, BANTEN",38,76,114,190
https://kawalpemilu.org#53204,"PONDOK KACANG BARAT, PONDOK AREN, KOTA TANGERANG SELATAN, BANTEN",39,65,156,221
https://kawalpemilu.org#53204,"PONDOK KACANG BARAT, PONDOK AREN, KOTA TANGERANG SELATAN, BANTEN",40,91,150,241
https://kawalpemilu.org#53204,"PONDOK KACANG BARAT, PONDOK AREN, KOTA TANGERANG SELATAN, BANTEN",41,128,68,196
https://kawalpemilu.org#53204,"PONDOK KACANG BARAT, PONDOK AREN, KOTA TANGERANG SELATAN, BANTEN",42,173,72,245
https://kawalpemilu.org#53204,"PONDOK KACANG BARAT, PONDOK AREN, KOTA TANGERANG SELATAN, BANTEN",43,147,59,206
https://kawalpemilu.org#53204,"PONDOK KACANG BARAT, PONDOK AREN, KOTA TANGERANG SELATAN, BANTEN",44,112,64,176
https://kawalpemilu.org#53204,"PONDOK KACANG BARAT, PONDOK AREN, KOTA TANGERANG SELATAN, BANTEN",45,161,98,259
https://kawalpemilu.org#53204,"PONDOK KACANG BARAT, PONDOK AREN, KOTA TANGERANG SELATAN, BANTEN",46,155,94,249
https://kawalpemilu.org#53204,"PONDOK KACANG BARAT, PONDOK AREN, KOTA TANGERANG SELATAN, BANTEN",47,141,139,280
https://kawalpemilu.org#53204,"PONDOK KACANG BARAT, PONDOK AREN, KOTA TANGERANG SELATAN, BANTEN",48,165,132,297
https://kawalpemilu.org#53204,"PONDOK KACANG BARAT, PONDOK AREN, KOTA TANGERANG SELATAN, BANTEN",49,97,77,174
https://kawalpemilu.org#53204,"PONDOK KACANG BARAT, PONDOK AREN, KOTA TANGERANG SELATAN, BANTEN",50,87,68,155
https://kawalpemilu.org#53204,"PONDOK KACANG BARAT, PONDOK AREN, KOTA TANGERANG SELATAN, BANTEN",51,175,93,268
https://kawalpemilu.org#53204,"PONDOK KACANG BARAT, PONDOK AREN, KOTA TANGERANG SELATAN, BANTEN",52,186,72,258
https://kawalpemilu.org#53204,"PONDOK KACANG BARAT, PONDOK AREN, KOTA TANGERANG SELATAN, BANTEN",53,117,136,253
https://kawalpemilu.org#53204,"PONDOK KACANG BARAT, PONDOK AREN, KOTA TANGERANG SELATAN, BANTEN",54,82,134,222
https://kawalpemilu.org#53204,"PONDOK KACANG BARAT, PONDOK AREN, KOTA TANGERANG SELATAN, BANTEN",55,85,170,255
https://kawalpemilu.org#53204,"PONDOK KACANG BARAT, PONDOK AREN, KOTA TANGERANG SELATAN, BANTEN",56,101,142,243
https://kawalpemilu.org#53204,"PONDOK KACANG BARAT, PONDOK AREN, KOTA TANGERANG SELATAN, BANTEN",57,94,168,262
https://kawalpemilu.org#53204,"PONDOK KACANG BARAT, PONDOK AREN, KOTA TANGERANG SELATAN, BANTEN",58,77,84,161
https://kawalpemilu.org#53205,"PONDOK KACANG TIMUR, PONDOK AREN, KOTA TANGERANG SELATAN, BANTEN",1,62,138,200
https://kawalpemilu.org#53205,"PONDOK KACANG TIMUR, PONDOK AREN, KOTA TANGERANG SELATAN, BANTEN",2,49,120,169
https://kawalpemilu.org#53205,"PONDOK KACANG TIMUR, PONDOK AREN, KOTA TANGERANG SELATAN, BANTEN",3,54,138,192
https://kawalpemilu.org#53205,"PONDOK KACANG TIMUR, PONDOK AREN, KOTA TANGERANG SELATAN, BANTEN",4,108,118,226
https://kawalpemilu.org#53205,"PONDOK KACANG TIMUR, PONDOK AREN, KOTA TANGERANG SELATAN, BANTEN",6,97,103,200
https://kawalpemilu.org#53205,"PONDOK KACANG TIMUR, PONDOK AREN, KOTA TANGERANG SELATAN, BANTEN",7,80,122,202
https://kawalpemilu.org#53205,"PONDOK KACANG TIMUR, PONDOK AREN, KOTA TANGERANG SELATAN, BANTEN",8,58,137,195
https://kawalpemilu.org#53205,"PONDOK KACANG TIMUR, PONDOK AREN, KOTA TANGERANG SELATAN, BANTEN",9,75,169,244
https://kawalpemilu.org#53205,"PONDOK KACANG TIMUR, PONDOK AREN, KOTA TANGERANG SELATAN, BANTEN",10,105,151,256
https://kawalpemilu.org#53205,"PONDOK KACANG TIMUR, PONDOK AREN, KOTA TANGERANG SELATAN, BANTEN",11,61,152,213
https://kawalpemilu.org#53205,"PONDOK KACANG TIMUR, PONDOK AREN, KOTA TANGERANG SELATAN, BANTEN",12,53,131,184
https://kawalpemilu.org#53205,"PONDOK KACANG TIMUR, PONDOK AREN, KOTA TANGERANG SELATAN, BANTEN",13,88,123,211
https://kawalpemilu.org#53205,"PONDOK KACANG TIMUR, PONDOK AREN, KOTA TANGERANG SELATAN, BANTEN",14,90,118,208
https://kawalpemilu.org#53205,"PONDOK KACANG TIMUR, PONDOK AREN, KOTA TANGERANG SELATAN, BANTEN",15,104,94,198
https://kawalpemilu.org#53205,"PONDOK KACANG TIMUR, PONDOK AREN, KOTA TANGERANG SELATAN, BANTEN",16,61,115,176
https://kawalpemilu.org#53205,"PONDOK KACANG TIMUR, PONDOK AREN, KOTA TANGERANG SELATAN, BANTEN",17,89,131,220
https://kawalpemilu.org#53205,"PONDOK KACANG TIMUR, PONDOK AREN, KOTA TANGERANG SELATAN, BANTEN",18,104,96,200
https://kawalpemilu.org#53205,"PONDOK KACANG TIMUR, PONDOK AREN, KOTA TANGERANG SELATAN, BANTEN",19,100,105,205
https://kawalpemilu.org#53205,"PONDOK KACANG TIMUR, PONDOK AREN, KOTA TANGERANG SELATAN, BANTEN",20,75,142,217
https://kawalpemilu.org#53205,"PONDOK KACANG TIMUR, PONDOK AREN, KOTA TANGERANG SELATAN, BANTEN",21,108,117,225
https://kawalpemilu.org#53205,"PONDOK KACANG TIMUR, PONDOK AREN, KOTA TANGERANG SELATAN, BANTEN",22,63,119,182
https://kawalpemilu.org#53205,"PONDOK KACANG TIMUR, PONDOK AREN, KOTA TANGERANG SELATAN, BANTEN",23,74,102,176
https://kawalpemilu.org#53205,"PONDOK KACANG TIMUR, PONDOK AREN, KOTA TANGERANG SELATAN, BANTEN",24,67,133,200
https://kawalpemilu.org#53205,"PONDOK KACANG TIMUR, PONDOK AREN, KOTA TANGERANG SELATAN, BANTEN",25,67,161,228
https://kawalpemilu.org#53205,"PONDOK KACANG TIMUR, PONDOK AREN, KOTA TANGERANG SELATAN, BANTEN",26,91,146,237
https://kawalpemilu.org#53205,"PONDOK KACANG TIMUR, PONDOK AREN, KOTA TANGERANG SELATAN, BANTEN",27,82,162,244
https://kawalpemilu.org#53205,"PONDOK KACANG TIMUR, PONDOK AREN, KOTA TANGERANG SELATAN, BANTEN",28,109,142,251
https://kawalpemilu.org#53205,"PONDOK KACANG TIMUR, PONDOK AREN, KOTA TANGERANG SELATAN, BANTEN",29,87,142,229
https://kawalpemilu.org#53205,"PONDOK KACANG TIMUR, PONDOK AREN, KOTA TANGERANG SELATAN, BANTEN",30,87,155,242
https://kawalpemilu.org#53205,"PONDOK KACANG TIMUR, PONDOK AREN, KOTA TANGERANG SELATAN, BANTEN",31,71,178,249
https://kawalpemilu.org#53205,"PONDOK KACANG TIMUR, PONDOK AREN, KOTA TANGERANG SELATAN, BANTEN",32,91,131,222
https://kawalpemilu.org#53205,"PONDOK KACANG TIMUR, PONDOK AREN, KOTA TANGERANG SELATAN, BANTEN",33,76,123,199
https://kawalpemilu.org#53205,"PONDOK KACANG TIMUR, PONDOK AREN, KOTA TANGERANG SELATAN, BANTEN",34,79,169,248
https://kawalpemilu.org#53205,"PONDOK KACANG TIMUR, PONDOK AREN, KOTA TANGERANG SELATAN, BANTEN",35,73,183,255
https://kawalpemilu.org#53205,"PONDOK KACANG TIMUR, PONDOK AREN, KOTA TANGERANG SELATAN, BANTEN",36,54,177,231
https://kawalpemilu.org#53205,"PONDOK KACANG TIMUR, PONDOK AREN, KOTA TANGERANG SELATAN, BANTEN",37,101,163,264
https://kawalpemilu.org#53205,"PONDOK KACANG TIMUR, PONDOK AREN, KOTA TANGERANG SELATAN, BANTEN",38,111,123,234
https://kawalpemilu.org#53205,"PONDOK KACANG TIMUR, PONDOK AREN, KOTA TANGERANG SELATAN, BANTEN",39,120,126,246
https://kawalpemilu.org#53205,"PONDOK KACANG TIMUR, PONDOK AREN, KOTA TANGERANG SELATAN, BANTEN",40,79,145,224
https://kawalpemilu.org#53205,"PONDOK KACANG TIMUR, PONDOK AREN, KOTA TANGERANG SELATAN, BANTEN",41,74,154,228
https://kawalpemilu.org#53205,"PONDOK KACANG TIMUR, PONDOK AREN, KOTA TANGERANG SELATAN, BANTEN",42,67,144,211
https://kawalpemilu.org#53205,"PONDOK KACANG TIMUR, PONDOK AREN, KOTA TANGERANG SELATAN, BANTEN",43,87,158,245
https://kawalpemilu.org#53205,"PONDOK KACANG TIMUR, PONDOK AREN, KOTA TANGERANG SELATAN, BANTEN",44,70,128,198
https://kawalpemilu.org#53205,"PONDOK KACANG TIMUR, PONDOK AREN, KOTA TANGERANG SELATAN, BANTEN",45,108,142,251
https://kawalpemilu.org#53205,"PONDOK KACANG TIMUR, PONDOK AREN, KOTA TANGERANG SELATAN, BANTEN",46,84,128,212
https://kawalpemilu.org#53205,"PONDOK KACANG TIMUR, PONDOK AREN, KOTA TANGERANG SELATAN, BANTEN",47,67,159,226
https://kawalpemilu.org#53205,"PONDOK KACANG TIMUR, PONDOK AREN, KOTA TANGERANG SELATAN, BANTEN",48,94,158,252
https://kawalpemilu.org#53205,"PONDOK KACANG TIMUR, PONDOK AREN, KOTA TANGERANG SELATAN, BANTEN",49,101,161,262
https://kawalpemilu.org#53205,"PONDOK KACANG TIMUR, PONDOK AREN, KOTA TANGERANG SELATAN, BANTEN",50,105,128,233
https://kawalpemilu.org#53205,"PONDOK KACANG TIMUR, PONDOK AREN, KOTA TANGERANG SELATAN, BANTEN",51,101,142,243
https://kawalpemilu.org#53205,"PONDOK KACANG TIMUR, PONDOK AREN, KOTA TANGERANG SELATAN, BANTEN",52,107,172,279
https://kawalpemilu.org#53205,"PONDOK KACANG TIMUR, PONDOK AREN, KOTA TANGERANG SELATAN, BANTEN",53,118,145,263
https://kawalpemilu.org#53205,"PONDOK KACANG TIMUR, PONDOK AREN, KOTA TANGERANG SELATAN, BANTEN",54,137,104,241
https://kawalpemilu.org#53205,"PONDOK KACANG TIMUR, PONDOK AREN, KOTA TANGERANG SELATAN, BANTEN",55,75,145,220
https://kawalpemilu.org#53205,"PONDOK KACANG TIMUR, PONDOK AREN, KOTA TANGERANG SELATAN, BANTEN",56,104,126,230
https://kawalpemilu.org#53205,"PONDOK KACANG TIMUR, PONDOK AREN, KOTA TANGERANG SELATAN, BANTEN",57,132,115,247
https://kawalpemilu.org#53205,"PONDOK KACANG TIMUR, PONDOK AREN, KOTA TANGERANG SELATAN, BANTEN",58,140,120,260
https://kawalpemilu.org#53205,"PONDOK KACANG TIMUR, PONDOK AREN, KOTA TANGERANG SELATAN, BANTEN",59,121,77,198
https://kawalpemilu.org#53205,"PONDOK KACANG TIMUR, PONDOK AREN, KOTA TANGERANG SELATAN, BANTEN",60,124,87,211
https://kawalpemilu.org#53205,"PONDOK KACANG TIMUR, PONDOK AREN, KOTA TANGERANG SELATAN, BANTEN",61,130,98,228
https://kawalpemilu.org#53205,"PONDOK KACANG TIMUR, PONDOK AREN, KOTA TANGERANG SELATAN, BANTEN",62,91,131,222
https://kawalpemilu.org#53205,"PONDOK KACANG TIMUR, PONDOK AREN, KOTA TANGERANG SELATAN, BANTEN",63,99,119,218
https://kawalpemilu.org#53205,"PONDOK KACANG TIMUR, PONDOK AREN, KOTA TANGERANG SELATAN, BANTEN",64,126,122,248
https://kawalpemilu.org#53205,"PONDOK KACANG TIMUR, PONDOK AREN, KOTA TANGERANG SELATAN, BANTEN",65,114,104,118
https://kawalpemilu.org#53205,"PONDOK KACANG TIMUR, PONDOK AREN, KOTA TANGERANG SELATAN, BANTEN",66,108,111,119
https://kawalpemilu.org#53205,"PONDOK KACANG TIMUR, PONDOK AREN, KOTA TANGERANG SELATAN, BANTEN",67,130,125,255
https://kawalpemilu.org#53205,"PONDOK KACANG TIMUR, PONDOK AREN, KOTA TANGERANG SELATAN, BANTEN",68,119,107,226
https://kawalpemilu.org#53205,"PONDOK KACANG TIMUR, PONDOK AREN, KOTA TANGERANG SELATAN, BANTEN",69,105,116,221
https://kawalpemilu.org#53205,"PONDOK KACANG TIMUR, PONDOK AREN, KOTA TANGERANG SELATAN, BANTEN",70,142,113,255
https://kawalpemilu.org#53205,"PONDOK KACANG TIMUR, PONDOK AREN, KOTA TANGERANG SELATAN, BANTEN",71,137,101,238
https://kawalpemilu.org#53205,"PONDOK KACANG TIMUR, PONDOK AREN, KOTA TANGERANG SELATAN, BANTEN",72,109,152,261
https://kawalpemilu.org#53205,"PONDOK KACANG TIMUR, PONDOK AREN, KOTA TANGERANG SELATAN, BANTEN",73,94,128,222
https://kawalpemilu.org#53205,"PONDOK KACANG TIMUR, PONDOK AREN, KOTA TANGERANG SELATAN, BANTEN",74,113,127,240
https://kawalpemilu.org#53205,"PONDOK KACANG TIMUR, PONDOK AREN, KOTA TANGERANG SELATAN, BANTEN",75,133,91,224
https://kawalpemilu.org#53205,"PONDOK KACANG TIMUR, PONDOK AREN, KOTA TANGERANG SELATAN, BANTEN",76,123,127,250
https://kawalpemilu.org#53205,"PONDOK KACANG TIMUR, PONDOK AREN, KOTA TANGERANG SELATAN, BANTEN",77,111,140,251
https://kawalpemilu.org#53205,"PONDOK KACANG TIMUR, PONDOK AREN, KOTA TANGERANG SELATAN, BANTEN",78,99,119,218
https://kawalpemilu.org#53205,"PONDOK KACANG TIMUR, PONDOK AREN, KOTA TANGERANG SELATAN, BANTEN",79,110,142,252
https://kawalpemilu.org#53205,"PONDOK KACANG TIMUR, PONDOK AREN, KOTA TANGERANG SELATAN, BANTEN",80,126,105,231
https://kawalpemilu.org#53205,"PONDOK KACANG TIMUR, PONDOK AREN, KOTA TANGERANG SELATAN, BANTEN",81,112,110,222
https://kawalpemilu.org#53205,"PONDOK KACANG TIMUR, PONDOK AREN, KOTA TANGERANG SELATAN, BANTEN",82,124,142,266
https://kawalpemilu.org#53205,"PONDOK KACANG TIMUR, PONDOK AREN, KOTA TANGERANG SELATAN, BANTEN",83,106,140,246
https://kawalpemilu.org#53205,"PONDOK KACANG TIMUR, PONDOK AREN, KOTA TANGERANG SELATAN, BANTEN",84,106,111,217
https://kawalpemilu.org#53205,"PONDOK KACANG TIMUR, PONDOK AREN, KOTA TANGERANG SELATAN, BANTEN",85,102,149,251
https://kawalpemilu.org#53205,"PONDOK KACANG TIMUR, PONDOK AREN, KOTA TANGERANG SELATAN, BANTEN",86,120,123,243
https://kawalpemilu.org#53205,"PONDOK KACANG TIMUR, PONDOK AREN, KOTA TANGERANG SELATAN, BANTEN",87,120,125,245
https://kawalpemilu.org#53205,"PONDOK KACANG TIMUR, PONDOK AREN, KOTA TANGERANG SELATAN, BANTEN",88,133,120,253
https://kawalpemilu.org#53205,"PONDOK KACANG TIMUR, PONDOK AREN, KOTA TANGERANG SELATAN, BANTEN",89,123,83,206
https://kawalpemilu.org#53205,"PONDOK KACANG TIMUR, PONDOK AREN, KOTA TANGERANG SELATAN, BANTEN",90,79,124,203
https://kawalpemilu.org#53205,"PONDOK KACANG TIMUR, PONDOK AREN, KOTA TANGERANG SELATAN, BANTEN",91,81,100,181
https://kawalpemilu.org#53205,"PONDOK KACANG TIMUR, PONDOK AREN, KOTA TANGERANG SELATAN, BANTEN",92,121,86,207
https://kawalpemilu.org#53205,"PONDOK KACANG TIMUR, PONDOK AREN, KOTA TANGERANG SELATAN, BANTEN",93,128,111,239
https://kawalpemilu.org#53205,"PONDOK KACANG TIMUR, PONDOK AREN, KOTA TANGERANG SELATAN, BANTEN",94,123,89,212
https://kawalpemilu.org#53205,"PONDOK KACANG TIMUR, PONDOK AREN, KOTA TANGERANG SELATAN, BANTEN",95,150,60,210
https://kawalpemilu.org#53205,"PONDOK KACANG TIMUR, PONDOK AREN, KOTA TANGERANG SELATAN, BANTEN",96,138,74,212
https://kawalpemilu.org#53205,"PONDOK KACANG TIMUR, PONDOK AREN, KOTA TANGERANG SELATAN, BANTEN",97,129,87,216
https://kawalpemilu.org#53205,"PONDOK KACANG TIMUR, PONDOK AREN, KOTA TANGERANG SELATAN, BANTEN",98,144,88,232
https://kawalpemilu.org#53205,"PONDOK KACANG TIMUR, PONDOK AREN, KOTA TANGERANG SELATAN, BANTEN",99,128,90,218
https://kawalpemilu.org#53205,"PONDOK KACANG TIMUR, PONDOK AREN, KOTA TANGERANG SELATAN, BANTEN",100,122,90,212
https://kawalpemilu.org#53205,"PONDOK KACANG TIMUR, PONDOK AREN, KOTA TANGERANG SELATAN, BANTEN",101,104,95,199
https://kawalpemilu.org#53206,"PARIGI LAMA, PONDOK AREN, KOTA TANGERANG SELATAN, BANTEN",2,46,80,126
https://kawalpemilu.org#53206,"PARIGI LAMA, PONDOK AREN, KOTA TANGERANG SELATAN, BANTEN",3,73,116,189
https://kawalpemilu.org#53206,"PARIGI LAMA, PONDOK AREN, KOTA TANGERANG SELATAN, BANTEN",4,93,129,222
https://kawalpemilu.org#53206,"PARIGI LAMA, PONDOK AREN, KOTA TANGERANG SELATAN, BANTEN",5,67,81,148
https://kawalpemilu.org#53206,"PARIGI LAMA, PONDOK AREN, KOTA TANGERANG SELATAN, BANTEN",6,72,122,194
https://kawalpemilu.org#53206,"PARIGI LAMA, PONDOK AREN, KOTA TANGERANG SELATAN, BANTEN",7,46,113,159
https://kawalpemilu.org#53206,"PARIGI LAMA, PONDOK AREN, KOTA TANGERANG SELATAN, BANTEN",8,49,134,183
https://kawalpemilu.org#53206,"PARIGI LAMA, PONDOK AREN, KOTA TANGERANG SELATAN, BANTEN",9,46,112,158
https://kawalpemilu.org#53206,"PARIGI LAMA, PONDOK AREN, KOTA TANGERANG SELATAN, BANTEN",10,55,133,188
https://kawalpemilu.org#53206,"PARIGI LAMA, PONDOK AREN, KOTA TANGERANG SELATAN, BANTEN",11,143,93,236
https://kawalpemilu.org#53206,"PARIGI LAMA, PONDOK AREN, KOTA TANGERANG SELATAN, BANTEN",12,76,145,221
https://kawalpemilu.org#53206,"PARIGI LAMA, PONDOK AREN, KOTA TANGERANG SELATAN, BANTEN",13,64,90,154
https://kawalpemilu.org#53206,"PARIGI LAMA, PONDOK AREN, KOTA TANGERANG SELATAN, BANTEN",14,60,110,170
https://kawalpemilu.org#53206,"PARIGI LAMA, PONDOK AREN, KOTA TANGERANG SELATAN, BANTEN",15,74,140,214
https://kawalpemilu.org#53206,"PARIGI LAMA, PONDOK AREN, KOTA TANGERANG SELATAN, BANTEN",17,68,103,171
https://kawalpemilu.org#53206,"PARIGI LAMA, PONDOK AREN, KOTA TANGERANG SELATAN, BANTEN",18,51,89,140
https://kawalpemilu.org#53206,"PARIGI LAMA, PONDOK AREN, KOTA TANGERANG SELATAN, BANTEN",19,82,115,197
https://kawalpemilu.org#53206,"PARIGI LAMA, PONDOK AREN, KOTA TANGERANG SELATAN, BANTEN",20,89,109,198
https://kawalpemilu.org#53206,"PARIGI LAMA, PONDOK AREN, KOTA TANGERANG SELATAN, BANTEN",21,92,133,225
https://kawalpemilu.org#53206,"PARIGI LAMA, PONDOK AREN, KOTA TANGERANG SELATAN, BANTEN",22,119,132,251
https://kawalpemilu.org#53206,"PARIGI LAMA, PONDOK AREN, KOTA TANGERANG SELATAN, BANTEN",23,94,93,187
https://kawalpemilu.org#53206,"PARIGI LAMA, PONDOK AREN, KOTA TANGERANG SELATAN, BANTEN",24,115,95,210
https://kawalpemilu.org#53206,"PARIGI LAMA, PONDOK AREN, KOTA TANGERANG SELATAN, BANTEN",25,26,95,121
https://kawalpemilu.org#53206,"PARIGI LAMA, PONDOK AREN, KOTA TANGERANG SELATAN, BANTEN",26,73,83,156
https://kawalpemilu.org#53206,"PARIGI LAMA, PONDOK AREN, KOTA TANGERANG SELATAN, BANTEN",27,114,115,229
https://kawalpemilu.org#53206,"PARIGI LAMA, PONDOK AREN, KOTA TANGERANG SELATAN, BANTEN",29,116,98,214
https://kawalpemilu.org#53206,"PARIGI LAMA, PONDOK AREN, KOTA TANGERANG SELATAN, BANTEN",30,70,84,154
https://kawalpemilu.org#53206,"PARIGI LAMA, PONDOK AREN, KOTA TANGERANG SELATAN, BANTEN",31,63,173,236
https://kawalpemilu.org#53206,"PARIGI LAMA, PONDOK AREN, KOTA TANGERANG SELATAN, BANTEN",32,81,58,139
https://kawalpemilu.org#53206,"PARIGI LAMA, PONDOK AREN, KOTA TANGERANG SELATAN, BANTEN",33,66,61,127
https://kawalpemilu.org#53206,"PARIGI LAMA, PONDOK AREN, KOTA TANGERANG SELATAN, BANTEN",34,97,75,172
https://kawalpemilu.org#53206,"PARIGI LAMA, PONDOK AREN, KOTA TANGERANG SELATAN, BANTEN",35,147,100,247
https://kawalpemilu.org#53206,"PARIGI LAMA, PONDOK AREN, KOTA TANGERANG SELATAN, BANTEN",37,102,86,188
https://kawalpemilu.org#53206,"PARIGI LAMA, PONDOK AREN, KOTA TANGERANG SELATAN, BANTEN",38,121,103,224
https://kawalpemilu.org#53206,"PARIGI LAMA, PONDOK AREN, KOTA TANGERANG SELATAN, BANTEN",39,134,88,222
https://kawalpemilu.org#53206,"PARIGI LAMA, PONDOK AREN, KOTA TANGERANG SELATAN, BANTEN",40,135,101,236
https://kawalpemilu.org#53206,"PARIGI LAMA, PONDOK AREN, KOTA TANGERANG SELATAN, BANTEN",41,99,56,155
https://kawalpemilu.org#53206,"PARIGI LAMA, PONDOK AREN, KOTA TANGERANG SELATAN, BANTEN",42,97,62,159
https://kawalpemilu.org#53206,"PARIGI LAMA, PONDOK AREN, KOTA TANGERANG SELATAN, BANTEN",43,132,66,198
https://kawalpemilu.org#53206,"PARIGI LAMA, PONDOK AREN, KOTA TANGERANG SELATAN, BANTEN",45,81,79,160
https://kawalpemilu.org#53206,"PARIGI LAMA, PONDOK AREN, KOTA TANGERANG SELATAN, BANTEN",46,79,52,131
https://kawalpemilu.org#53206,"PARIGI LAMA, PONDOK AREN, KOTA TANGERANG SELATAN, BANTEN",47,64,64,128
https://kawalpemilu.org#53206,"PARIGI LAMA, PONDOK AREN, KOTA TANGERANG SELATAN, BANTEN",49,73,121,194
https://kawalpemilu.org#53206,"PARIGI LAMA, PONDOK AREN, KOTA TANGERANG SELATAN, BANTEN",50,70,57,127
https://kawalpemilu.org#53206,"PARIGI LAMA, PONDOK AREN, KOTA TANGERANG SELATAN, BANTEN",51,123,49,172
https://kawalpemilu.org#53206,"PARIGI LAMA, PONDOK AREN, KOTA TANGERANG SELATAN, BANTEN",52,143,86,229
https://kawalpemilu.org#53206,"PARIGI LAMA, PONDOK AREN, KOTA TANGERANG SELATAN, BANTEN",53,105,61,166
https://kawalpemilu.org#53206,"PARIGI LAMA, PONDOK AREN, KOTA TANGERANG SELATAN, BANTEN",54,155,71,226
https://kawalpemilu.org#53206,"PARIGI LAMA, PONDOK AREN, KOTA TANGERANG SELATAN, BANTEN",55,164,75,239
https://kawalpemilu.org#53206,"PARIGI LAMA, PONDOK AREN, KOTA TANGERANG SELATAN, BANTEN",56,146,81,227
https://kawalpemilu.org#53206,"PARIGI LAMA, PONDOK AREN, KOTA TANGERANG SELATAN, BANTEN",57,137,90,227
https://kawalpemilu.org#53206,"PARIGI LAMA, PONDOK AREN, KOTA TANGERANG SELATAN, BANTEN",58,171,108,279
https://kawalpemilu.org#53206,"PARIGI LAMA, PONDOK AREN, KOTA TANGERANG SELATAN, BANTEN",59,150,101,251
https://kawalpemilu.org#53206,"PARIGI LAMA, PONDOK AREN, KOTA TANGERANG SELATAN, BANTEN",60,199,100,299
https://kawalpemilu.org#53207,"PARIGI BARU, PONDOK AREN, KOTA TANGERANG SELATAN, BANTEN",1,73,163,236
https://kawalpemilu.org#53207,"PARIGI BARU, PONDOK AREN, KOTA TANGERANG SELATAN, BANTEN",2,79,132,211
https://kawalpemilu.org#53207,"PARIGI BARU, PONDOK AREN, KOTA TANGERANG SELATAN, BANTEN",3,91,159,250
https://kawalpemilu.org#53207,"PARIGI BARU, PONDOK AREN, KOTA TANGERANG SELATAN, BANTEN",4,65,80,145
https://kawalpemilu.org#53207,"PARIGI BARU, PONDOK AREN, KOTA TANGERANG SELATAN, BANTEN",5,158,93,251
https://kawalpemilu.org#53207,"PARIGI BARU, PONDOK AREN, KOTA TANGERANG SELATAN, BANTEN",6,96,67,163
https://kawalpemilu.org#53207,"PARIGI BARU, PONDOK AREN, KOTA TANGERANG SELATAN, BANTEN",7,64,35,99
https://kawalpemilu.org#53207,"PARIGI BARU, PONDOK AREN, KOTA TANGERANG SELATAN, BANTEN",9,57,133,190
https://kawalpemilu.org#53207,"PARIGI BARU, PONDOK AREN, KOTA TANGERANG SELATAN, BANTEN",10,56,150,206
https://kawalpemilu.org#53207,"PARIGI BARU, PONDOK AREN, KOTA TANGERANG SELATAN, BANTEN",11,57,140,197
https://kawalpemilu.org#53207,"PARIGI BARU, PONDOK AREN, KOTA TANGERANG SELATAN, BANTEN",12,76,144,220
https://kawalpemilu.org#53207,"PARIGI BARU, PONDOK AREN, KOTA TANGERANG SELATAN, BANTEN",13,91,140,231
https://kawalpemilu.org#53207,"PARIGI BARU, PONDOK AREN, KOTA TANGERANG SELATAN, BANTEN",14,100,139,239
https://kawalpemilu.org#53207,"PARIGI BARU, PONDOK AREN, KOTA TANGERANG SELATAN, BANTEN",15,82,141,223
https://kawalpemilu.org#53207,"PARIGI BARU, PONDOK AREN, KOTA TANGERANG SELATAN, BANTEN",16,76,147,223
https://kawalpemilu.org#53207,"PARIGI BARU, PONDOK AREN, KOTA TANGERANG SELATAN, BANTEN",17,71,141,212
https://kawalpemilu.org#53207,"PARIGI BARU, PONDOK AREN, KOTA TANGERANG SELATAN, BANTEN",18,87,134,221
https://kawalpemilu.org#53207,"PARIGI BARU, PONDOK AREN, KOTA TANGERANG SELATAN, BANTEN",19,83,148,231
https://kawalpemilu.org#53207,"PARIGI BARU, PONDOK AREN, KOTA TANGERANG SELATAN, BANTEN",20,68,128,197
https://kawalpemilu.org#53207,"PARIGI BARU, PONDOK AREN, KOTA TANGERANG SELATAN, BANTEN",21,76,118,194
https://kawalpemilu.org#53207,"PARIGI BARU, PONDOK AREN, KOTA TANGERANG SELATAN, BANTEN",22,114,128,242
https://kawalpemilu.org#53207,"PARIGI BARU, PONDOK AREN, KOTA TANGERANG SELATAN, BANTEN",23,100,157,257
https://kawalpemilu.org#53207,"PARIGI BARU, PONDOK AREN, KOTA TANGERANG SELATAN, BANTEN",24,70,113,183
https://kawalpemilu.org#53207,"PARIGI BARU, PONDOK AREN, KOTA TANGERANG SELATAN, BANTEN",25,59,100,159
https://kawalpemilu.org#53207,"PARIGI BARU, PONDOK AREN, KOTA TANGERANG SELATAN, BANTEN",26,84,135,219
https://kawalpemilu.org#53207,"PARIGI BARU, PONDOK AREN, KOTA TANGERANG SELATAN, BANTEN",27,78,160,238
https://kawalpemilu.org#53207,"PARIGI BARU, PONDOK AREN, KOTA TANGERANG SELATAN, BANTEN",28,91,140,231
https://kawalpemilu.org#53207,"PARIGI BARU, PONDOK AREN, KOTA TANGERANG SELATAN, BANTEN",29,88,102,190
https://kawalpemilu.org#53207,"PARIGI BARU, PONDOK AREN, KOTA TANGERANG SELATAN, BANTEN",30,100,113,213
https://kawalpemilu.org#53207,"PARIGI BARU, PONDOK AREN, KOTA TANGERANG SELATAN, BANTEN",31,136,130,266
https://kawalpemilu.org#53207,"PARIGI BARU, PONDOK AREN, KOTA TANGERANG SELATAN, BANTEN",32,116,129,245
https://kawalpemilu.org#53207,"PARIGI BARU, PONDOK AREN, KOTA TANGERANG SELATAN, BANTEN",33,91,123,214
https://kawalpemilu.org#53207,"PARIGI BARU, PONDOK AREN, KOTA TANGERANG SELATAN, BANTEN",34,48,74,122
https://kawalpemilu.org#53207,"PARIGI BARU, PONDOK AREN, KOTA TANGERANG SELATAN, BANTEN",35,69,80,149
https://kawalpemilu.org#53208,"JURANGMANGU TIMUR, PONDOK AREN, KOTA TANGERANG SELATAN, BANTEN",1,106,97,203
https://kawalpemilu.org#53208,"JURANGMANGU TIMUR, PONDOK AREN, KOTA TANGERANG SELATAN, BANTEN",2,119,87,206
https://kawalpemilu.org#53208,"JURANGMANGU TIMUR, PONDOK AREN, KOTA TANGERANG SELATAN, BANTEN",3,96,96,192
https://kawalpemilu.org#53208,"JURANGMANGU TIMUR, PONDOK AREN, KOTA TANGERANG SELATAN, BANTEN",4,91,96,187
https://kawalpemilu.org#53208,"JURANGMANGU TIMUR, PONDOK AREN, KOTA TANGERANG SELATAN, BANTEN",5,94,154,148
https://kawalpemilu.org#53208,"JURANGMANGU TIMUR, PONDOK AREN, KOTA TANGERANG SELATAN, BANTEN",6,113,144,257
https://kawalpemilu.org#53208,"JURANGMANGU TIMUR, PONDOK AREN, KOTA TANGERANG SELATAN, BANTEN",7,131,141,272
https://kawalpemilu.org#53208,"JURANGMANGU TIMUR, PONDOK AREN, KOTA TANGERANG SELATAN, BANTEN",8,109,136,8
https://kawalpemilu.org#53208,"JURANGMANGU TIMUR, PONDOK AREN, KOTA TANGERANG SELATAN, BANTEN",9,106,139,245
https://kawalpemilu.org#53208,"JURANGMANGU TIMUR, PONDOK AREN, KOTA TANGERANG SELATAN, BANTEN",10,106,113,219
https://kawalpemilu.org#53208,"JURANGMANGU TIMUR, PONDOK AREN, KOTA TANGERANG SELATAN, BANTEN",11,77,162,239
https://kawalpemilu.org#53208,"JURANGMANGU TIMUR, PONDOK AREN, KOTA TANGERANG SELATAN, BANTEN",12,96,191,287
https://kawalpemilu.org#53208,"JURANGMANGU TIMUR, PONDOK AREN, KOTA TANGERANG SELATAN, BANTEN",13,98,137,235
https://kawalpemilu.org#53208,"JURANGMANGU TIMUR, PONDOK AREN, KOTA TANGERANG SELATAN, BANTEN",14,113,135,248
https://kawalpemilu.org#53208,"JURANGMANGU TIMUR, PONDOK AREN, KOTA TANGERANG SELATAN, BANTEN",15,121,123,244
https://kawalpemilu.org#53208,"JURANGMANGU TIMUR, PONDOK AREN, KOTA TANGERANG SELATAN, BANTEN",16,96,174,270
https://kawalpemilu.org#53208,"JURANGMANGU TIMUR, PONDOK AREN, KOTA TANGERANG SELATAN, BANTEN",17,89,105,194
https://kawalpemilu.org#53208,"JURANGMANGU TIMUR, PONDOK AREN, KOTA TANGERANG SELATAN, BANTEN",18,76,124,200
https://kawalpemilu.org#53208,"JURANGMANGU TIMUR, PONDOK AREN, KOTA TANGERANG SELATAN, BANTEN",19,129,128,257
https://kawalpemilu.org#53208,"JURANGMANGU TIMUR, PONDOK AREN, KOTA TANGERANG SELATAN, BANTEN",20,89,114,203
https://kawalpemilu.org#53208,"JURANGMANGU TIMUR, PONDOK AREN, KOTA TANGERANG SELATAN, BANTEN",21,92,128,220
https://kawalpemilu.org#53208,"JURANGMANGU TIMUR, PONDOK AREN, KOTA TANGERANG SELATAN, BANTEN",22,104,130,234
https://kawalpemilu.org#53208,"JURANGMANGU TIMUR, PONDOK AREN, KOTA TANGERANG SELATAN, BANTEN",23,100,143,243
https://kawalpemilu.org#53208,"JURANGMANGU TIMUR, PONDOK AREN, KOTA TANGERANG SELATAN, BANTEN",24,104,126,230
https://kawalpemilu.org#53208,"JURANGMANGU TIMUR, PONDOK AREN, KOTA TANGERANG SELATAN, BANTEN",25,95,178,273
https://kawalpemilu.org#53208,"JURANGMANGU TIMUR, PONDOK AREN, KOTA TANGERANG SELATAN, BANTEN",26,90,138,228
https://kawalpemilu.org#53208,"JURANGMANGU TIMUR, PONDOK AREN, KOTA TANGERANG SELATAN, BANTEN",27,82,130,212
https://kawalpemilu.org#53208,"JURANGMANGU TIMUR, PONDOK AREN, KOTA TANGERANG SELATAN, BANTEN",28,107,119,226
https://kawalpemilu.org#53208,"JURANGMANGU TIMUR, PONDOK AREN, KOTA TANGERANG SELATAN, BANTEN",29,137,130,267
https://kawalpemilu.org#53208,"JURANGMANGU TIMUR, PONDOK AREN, KOTA TANGERANG SELATAN, BANTEN",30,115,122,237
https://kawalpemilu.org#53208,"JURANGMANGU TIMUR, PONDOK AREN, KOTA TANGERANG SELATAN, BANTEN",31,140,80,220
https://kawalpemilu.org#53208,"JURANGMANGU TIMUR, PONDOK AREN, KOTA TANGERANG SELATAN, BANTEN",32,113,90,203
https://kawalpemilu.org#53208,"JURANGMANGU TIMUR, PONDOK AREN, KOTA TANGERANG SELATAN, BANTEN",33,123,89,212
https://kawalpemilu.org#53208,"JURANGMANGU TIMUR, PONDOK AREN, KOTA TANGERANG SELATAN, BANTEN",34,121,108,229
https://kawalpemilu.org#53208,"JURANGMANGU TIMUR, PONDOK AREN, KOTA TANGERANG SELATAN, BANTEN",35,113,121,234
https://kawalpemilu.org#53208,"JURANGMANGU TIMUR, PONDOK AREN, KOTA TANGERANG SELATAN, BANTEN",36,110,100,210
https://kawalpemilu.org#53208,"JURANGMANGU TIMUR, PONDOK AREN, KOTA TANGERANG SELATAN, BANTEN",37,121,123,244
https://kawalpemilu.org#53208,"JURANGMANGU TIMUR, PONDOK AREN, KOTA TANGERANG SELATAN, BANTEN",38,91,136,227
https://kawalpemilu.org#53208,"JURANGMANGU TIMUR, PONDOK AREN, KOTA TANGERANG SELATAN, BANTEN",39,79,141,220
https://kawalpemilu.org#53208,"JURANGMANGU TIMUR, PONDOK AREN, KOTA TANGERANG SELATAN, BANTEN",40,108,118,226
https://kawalpemilu.org#53208,"JURANGMANGU TIMUR, PONDOK AREN, KOTA TANGERANG SELATAN, BANTEN",41,80,124,204
https://kawalpemilu.org#53208,"JURANGMANGU TIMUR, PONDOK AREN, KOTA TANGERANG SELATAN, BANTEN",42,83,146,229
https://kawalpemilu.org#53208,"JURANGMANGU TIMUR, PONDOK AREN, KOTA TANGERANG SELATAN, BANTEN",43,94,160,254
https://kawalpemilu.org#53208,"JURANGMANGU TIMUR, PONDOK AREN, KOTA TANGERANG SELATAN, BANTEN",44,92,144,236
https://kawalpemilu.org#53208,"JURANGMANGU TIMUR, PONDOK AREN, KOTA TANGERANG SELATAN, BANTEN",45,102,137,239
https://kawalpemilu.org#53208,"JURANGMANGU TIMUR, PONDOK AREN, KOTA TANGERANG SELATAN, BANTEN",46,94,154,248
https://kawalpemilu.org#53208,"JURANGMANGU TIMUR, PONDOK AREN, KOTA TANGERANG SELATAN, BANTEN",47,85,145,230
https://kawalpemilu.org#53208,"JURANGMANGU TIMUR, PONDOK AREN, KOTA TANGERANG SELATAN, BANTEN",48,83,177,266
https://kawalpemilu.org#53208,"JURANGMANGU TIMUR, PONDOK AREN, KOTA TANGERANG SELATAN, BANTEN",49,131,122,253
https://kawalpemilu.org#53208,"JURANGMANGU TIMUR, PONDOK AREN, KOTA TANGERANG SELATAN, BANTEN",50,101,139,340
https://kawalpemilu.org#53208,"JURANGMANGU TIMUR, PONDOK AREN, KOTA TANGERANG SELATAN, BANTEN",51,49,171,220
https://kawalpemilu.org#53208,"JURANGMANGU TIMUR, PONDOK AREN, KOTA TANGERANG SELATAN, BANTEN",52,95,108,203
https://kawalpemilu.org#53208,"JURANGMANGU TIMUR, PONDOK AREN, KOTA TANGERANG SELATAN, BANTEN",53,104,93,197
https://kawalpemilu.org#53208,"JURANGMANGU TIMUR, PONDOK AREN, KOTA TANGERANG SELATAN, BANTEN",54,105,143,248
https://kawalpemilu.org#53208,"JURANGMANGU TIMUR, PONDOK AREN, KOTA TANGERANG SELATAN, BANTEN",55,109,150,259
https://kawalpemilu.org#53208,"JURANGMANGU TIMUR, PONDOK AREN, KOTA TANGERANG SELATAN, BANTEN",56,166,58,224
https://kawalpemilu.org#53208,"JURANGMANGU TIMUR, PONDOK AREN, KOTA TANGERANG SELATAN, BANTEN",57,161,70,231
https://kawalpemilu.org#53208,"JURANGMANGU TIMUR, PONDOK AREN, KOTA TANGERANG SELATAN, BANTEN",58,126,127,253
https://kawalpemilu.org#53208,"JURANGMANGU TIMUR, PONDOK AREN, KOTA TANGERANG SELATAN, BANTEN",59,151,88,239
https://kawalpemilu.org#53208,"JURANGMANGU TIMUR, PONDOK AREN, KOTA TANGERANG SELATAN, BANTEN",60,143,71,214
https://kawalpemilu.org#53208,"JURANGMANGU TIMUR, PONDOK AREN, KOTA TANGERANG SELATAN, BANTEN",61,153,73,226
https://kawalpemilu.org#53208,"JURANGMANGU TIMUR, PONDOK AREN, KOTA TANGERANG SELATAN, BANTEN",62,148,53,201
https://kawalpemilu.org#53208,"JURANGMANGU TIMUR, PONDOK AREN, KOTA TANGERANG SELATAN, BANTEN",63,150,103,253
https://kawalpemilu.org#53208,"JURANGMANGU TIMUR, PONDOK AREN, KOTA TANGERANG SELATAN, BANTEN",64,113,139,252
https://kawalpemilu.org#53208,"JURANGMANGU TIMUR, PONDOK AREN, KOTA TANGERANG SELATAN, BANTEN",65,101,176,277
https://kawalpemilu.org#53208,"JURANGMANGU TIMUR, PONDOK AREN, KOTA TANGERANG SELATAN, BANTEN",66,154,74,228
https://kawalpemilu.org#53208,"JURANGMANGU TIMUR, PONDOK AREN, KOTA TANGERANG SELATAN, BANTEN",67,138,49,187
https://kawalpemilu.org#53208,"JURANGMANGU TIMUR, PONDOK AREN, KOTA TANGERANG SELATAN, BANTEN",68,153,61,214
https://kawalpemilu.org#53208,"JURANGMANGU TIMUR, PONDOK AREN, KOTA TANGERANG SELATAN, BANTEN",69,153,91,244
https://kawalpemilu.org#53208,"JURANGMANGU TIMUR, PONDOK AREN, KOTA TANGERANG SELATAN, BANTEN",70,183,67,250
https://kawalpemilu.org#53208,"JURANGMANGU TIMUR, PONDOK AREN, KOTA TANGERANG SELATAN, BANTEN",71,219,42,261
https://kawalpemilu.org#53208,"JURANGMANGU TIMUR, PONDOK AREN, KOTA TANGERANG SELATAN, BANTEN",72,126,45,171
https://kawalpemilu.org#53208,"JURANGMANGU TIMUR, PONDOK AREN, KOTA TANGERANG SELATAN, BANTEN",73,134,57,191
https://kawalpemilu.org#53208,"JURANGMANGU TIMUR, PONDOK AREN, KOTA TANGERANG SELATAN, BANTEN",74,131,58,189
https://kawalpemilu.org#53208,"JURANGMANGU TIMUR, PONDOK AREN, KOTA TANGERANG SELATAN, BANTEN",75,88,148,236
https://kawalpemilu.org#53208,"JURANGMANGU TIMUR, PONDOK AREN, KOTA TANGERANG SELATAN, BANTEN",76,124,132,256
https://kawalpemilu.org#53208,"JURANGMANGU TIMUR, PONDOK AREN, KOTA TANGERANG SELATAN, BANTEN",77,78,171,249
https://kawalpemilu.org#53208,"JURANGMANGU TIMUR, PONDOK AREN, KOTA TANGERANG SELATAN, BANTEN",78,110,153,263
https://kawalpemilu.org#53208,"JURANGMANGU TIMUR, PONDOK AREN, KOTA TANGERANG SELATAN, BANTEN",79,108,139,247
https://kawalpemilu.org#53208,"JURANGMANGU TIMUR, PONDOK AREN, KOTA TANGERANG SELATAN, BANTEN",80,91,162,253
https://kawalpemilu.org#53208,"JURANGMANGU TIMUR, PONDOK AREN, KOTA TANGERANG SELATAN, BANTEN",81,145,107,252
https://kawalpemilu.org#53208,"JURANGMANGU TIMUR, PONDOK AREN, KOTA TANGERANG SELATAN, BANTEN",82,148,98,245
https://kawalpemilu.org#53209,"JURANGMANGU BARAT, PONDOK AREN, KOTA TANGERANG SELATAN, BANTEN",1,164,87,251
https://kawalpemilu.org#53209,"JURANGMANGU BARAT, PONDOK AREN, KOTA TANGERANG SELATAN, BANTEN",2,130,97,227
https://kawalpemilu.org#53209,"JURANGMANGU BARAT, PONDOK AREN, KOTA TANGERANG SELATAN, BANTEN",3,107,136,243
https://kawalpemilu.org#53209,"JURANGMANGU BARAT, PONDOK AREN, KOTA TANGERANG SELATAN, BANTEN",4,114,117,231
https://kawalpemilu.org#53209,"JURANGMANGU BARAT, PONDOK AREN, KOTA TANGERANG SELATAN, BANTEN",5,134,144,278
https://kawalpemilu.org#53209,"JURANGMANGU BARAT, PONDOK AREN, KOTA TANGERANG SELATAN, BANTEN",6,100,94,194
https://kawalpemilu.org#53209,"JURANGMANGU BARAT, PONDOK AREN, KOTA TANGERANG SELATAN, BANTEN",7,123,115,238
https://kawalpemilu.org#53209,"JURANGMANGU BARAT, PONDOK AREN, KOTA TANGERANG SELATAN, BANTEN",8,137,122,259
https://kawalpemilu.org#53209,"JURANGMANGU BARAT, PONDOK AREN, KOTA TANGERANG SELATAN, BANTEN",9,97,71,168
https://kawalpemilu.org#53209,"JURANGMANGU BARAT, PONDOK AREN, KOTA TANGERANG SELATAN, BANTEN",10,152,125,277
https://kawalpemilu.org#53209,"JURANGMANGU BARAT, PONDOK AREN, KOTA TANGERANG SELATAN, BANTEN",11,108,119,227
https://kawalpemilu.org#53209,"JURANGMANGU BARAT, PONDOK AREN, KOTA TANGERANG SELATAN, BANTEN",12,103,128,231
https://kawalpemilu.org#53209,"JURANGMANGU BARAT, PONDOK AREN, KOTA TANGERANG SELATAN, BANTEN",13,113,94,207
https://kawalpemilu.org#53209,"JURANGMANGU BARAT, PONDOK AREN, KOTA TANGERANG SELATAN, BANTEN",14,133,110,243
https://kawalpemilu.org#53209,"JURANGMANGU BARAT, PONDOK AREN, KOTA TANGERANG SELATAN, BANTEN",15,116,102,218
https://kawalpemilu.org#53209,"JURANGMANGU BARAT, PONDOK AREN, KOTA TANGERANG SELATAN, BANTEN",16,97,134,231
https://kawalpemilu.org#53209,"JURANGMANGU BARAT, PONDOK AREN, KOTA TANGERANG SELATAN, BANTEN",17,89,161,250
https://kawalpemilu.org#53209,"JURANGMANGU BARAT, PONDOK AREN, KOTA TANGERANG SELATAN, BANTEN",18,100,119,219
https://kawalpemilu.org#53209,"JURANGMANGU BARAT, PONDOK AREN, KOTA TANGERANG SELATAN, BANTEN",19,98,126,229
https://kawalpemilu.org#53209,"JURANGMANGU BARAT, PONDOK AREN, KOTA TANGERANG SELATAN, BANTEN",20,249,66,315
https://kawalpemilu.org#53209,"JURANGMANGU BARAT, PONDOK AREN, KOTA TANGERANG SELATAN, BANTEN",21,142,83,225
https://kawalpemilu.org#53209,"JURANGMANGU BARAT, PONDOK AREN, KOTA TANGERANG SELATAN, BANTEN",22,122,130,252
https://kawalpemilu.org#53209,"JURANGMANGU BARAT, PONDOK AREN, KOTA TANGERANG SELATAN, BANTEN",23,94,123,217
https://kawalpemilu.org#53209,"JURANGMANGU BARAT, PONDOK AREN, KOTA TANGERANG SELATAN, BANTEN",24,119,119,238
https://kawalpemilu.org#53209,"JURANGMANGU BARAT, PONDOK AREN, KOTA TANGERANG SELATAN, BANTEN",25,102,160,262
https://kawalpemilu.org#53209,"JURANGMANGU BARAT, PONDOK AREN, KOTA TANGERANG SELATAN, BANTEN",26,110,128,238
https://kawalpemilu.org#53209,"JURANGMANGU BARAT, PONDOK AREN, KOTA TANGERANG SELATAN, BANTEN",27,118,148,266
https://kawalpemilu.org#53209,"JURANGMANGU BARAT, PONDOK AREN, KOTA TANGERANG SELATAN, BANTEN",28,117,134,251
https://kawalpemilu.org#53209,"JURANGMANGU BARAT, PONDOK AREN, KOTA TANGERANG SELATAN, BANTEN",29,76,152,228
https://kawalpemilu.org#53209,"JURANGMANGU BARAT, PONDOK AREN, KOTA TANGERANG SELATAN, BANTEN",30,70,196,266
https://kawalpemilu.org#53209,"JURANGMANGU BARAT, PONDOK AREN, KOTA TANGERANG SELATAN, BANTEN",31,64,198,262
https://kawalpemilu.org#53209,"JURANGMANGU BARAT, PONDOK AREN, KOTA TANGERANG SELATAN, BANTEN",32,90,177,267
https://kawalpemilu.org#53209,"JURANGMANGU BARAT, PONDOK AREN, KOTA TANGERANG SELATAN, BANTEN",33,86,161,247
https://kawalpemilu.org#53209,"JURANGMANGU BARAT, PONDOK AREN, KOTA TANGERANG SELATAN, BANTEN",34,79,143,222
https://kawalpemilu.org#53209,"JURANGMANGU BARAT, PONDOK AREN, KOTA TANGERANG SELATAN, BANTEN",35,91,186,277
https://kawalpemilu.org#53209,"JURANGMANGU BARAT, PONDOK AREN, KOTA TANGERANG SELATAN, BANTEN",36,118,155,273
https://kawalpemilu.org#53209,"JURANGMANGU BARAT, PONDOK AREN, KOTA TANGERANG SELATAN, BANTEN",37,77,139,216
https://kawalpemilu.org#53209,"JURANGMANGU BARAT, PONDOK AREN, KOTA TANGERANG SELATAN, BANTEN",38,66,184,250
https://kawalpemilu.org#53209,"JURANGMANGU BARAT, PONDOK AREN, KOTA TANGERANG SELATAN, BANTEN",39,70,141,211
https://kawalpemilu.org#53209,"JURANGMANGU BARAT, PONDOK AREN, KOTA TANGERANG SELATAN, BANTEN",40,73,186,259
https://kawalpemilu.org#53209,"JURANGMANGU BARAT, PONDOK AREN, KOTA TANGERANG SELATAN, BANTEN",41,81,163,244
https://kawalpemilu.org#53209,"JURANGMANGU BARAT, PONDOK AREN, KOTA TANGERANG SELATAN, BANTEN",42,97,127,224
https://kawalpemilu.org#53209,"JURANGMANGU BARAT, PONDOK AREN, KOTA TANGERANG SELATAN, BANTEN",43,109,131,240
https://kawalpemilu.org#53209,"JURANGMANGU BARAT, PONDOK AREN, KOTA TANGERANG SELATAN, BANTEN",44,127,144,271
https://kawalpemilu.org#53209,"JURANGMANGU BARAT, PONDOK AREN, KOTA TANGERANG SELATAN, BANTEN",45,107,124,231
https://kawalpemilu.org#53209,"JURANGMANGU BARAT, PONDOK AREN, KOTA TANGERANG SELATAN, BANTEN",46,82,147,229
https://kawalpemilu.org#53209,"JURANGMANGU BARAT, PONDOK AREN, KOTA TANGERANG SELATAN, BANTEN",47,118,115,233
https://kawalpemilu.org#53209,"JURANGMANGU BARAT, PONDOK AREN, KOTA TANGERANG SELATAN, BANTEN",48,121,121,242
https://kawalpemilu.org#53209,"JURANGMANGU BARAT, PONDOK AREN, KOTA TANGERANG SELATAN, BANTEN",49,89,139,228
https://kawalpemilu.org#53209,"JURANGMANGU BARAT, PONDOK AREN, KOTA TANGERANG SELATAN, BANTEN",50,67,158,225
https://kawalpemilu.org#53209,"JURANGMANGU BARAT, PONDOK AREN, KOTA TANGERANG SELATAN, BANTEN",51,162,81,243
https://kawalpemilu.org#53209,"JURANGMANGU BARAT, PONDOK AREN, KOTA TANGERANG SELATAN, BANTEN",52,174,47,221
https://kawalpemilu.org#53209,"JURANGMANGU BARAT, PONDOK AREN, KOTA TANGERANG SELATAN, BANTEN",53,145,101,246
https://kawalpemilu.org#53209,"JURANGMANGU BARAT, PONDOK AREN, KOTA TANGERANG SELATAN, BANTEN",54,114,106,220
https://kawalpemilu.org#53209,"JURANGMANGU BARAT, PONDOK AREN, KOTA TANGERANG SELATAN, BANTEN",55,160,73,233
https://kawalpemilu.org#53209,"JURANGMANGU BARAT, PONDOK AREN, KOTA TANGERANG SELATAN, BANTEN",56,122,77,199
https://kawalpemilu.org#53209,"JURANGMANGU BARAT, PONDOK AREN, KOTA TANGERANG SELATAN, BANTEN",57,114,88,202
https://kawalpemilu.org#53209,"JURANGMANGU BARAT, PONDOK AREN, KOTA TANGERANG SELATAN, BANTEN",58,108,73,181
https://kawalpemilu.org#53209,"JURANGMANGU BARAT, PONDOK AREN, KOTA TANGERANG SELATAN, BANTEN",59,132,64,196
https://kawalpemilu.org#53209,"JURANGMANGU BARAT, PONDOK AREN, KOTA TANGERANG SELATAN, BANTEN",60,131,69,200
https://kawalpemilu.org#53209,"JURANGMANGU BARAT, PONDOK AREN, KOTA TANGERANG SELATAN, BANTEN",61,133,79,212
https://kawalpemilu.org#53209,"JURANGMANGU BARAT, PONDOK AREN, KOTA TANGERANG SELATAN, BANTEN",62,104,81,185
https://kawalpemilu.org#53209,"JURANGMANGU BARAT, PONDOK AREN, KOTA TANGERANG SELATAN, BANTEN",63,116,54,170
https://kawalpemilu.org#53209,"JURANGMANGU BARAT, PONDOK AREN, KOTA TANGERANG SELATAN, BANTEN",64,137,93,230
https://kawalpemilu.org#53209,"JURANGMANGU BARAT, PONDOK AREN, KOTA TANGERANG SELATAN, BANTEN",65,84,107,191
https://kawalpemilu.org#53209,"JURANGMANGU BARAT, PONDOK AREN, KOTA TANGERANG SELATAN, BANTEN",66,78,143,221
https://kawalpemilu.org#53209,"JURANGMANGU BARAT, PONDOK AREN, KOTA TANGERANG SELATAN, BANTEN",67,102,142,244
https://kawalpemilu.org#53209,"JURANGMANGU BARAT, PONDOK AREN, KOTA TANGERANG SELATAN, BANTEN",68,122,136,258
https://kawalpemilu.org#53209,"JURANGMANGU BARAT, PONDOK AREN, KOTA TANGERANG SELATAN, BANTEN",69,105,140,245
https://kawalpemilu.org#53209,"JURANGMANGU BARAT, PONDOK AREN, KOTA TANGERANG SELATAN, BANTEN",70,78,191,269
https://kawalpemilu.org#53209,"JURANGMANGU BARAT, PONDOK AREN, KOTA TANGERANG SELATAN, BANTEN",71,92,146,238
https://kawalpemilu.org#53209,"JURANGMANGU BARAT, PONDOK AREN, KOTA TANGERANG SELATAN, BANTEN",72,120,155,275
https://kawalpemilu.org#53209,"JURANGMANGU BARAT, PONDOK AREN, KOTA TANGERANG SELATAN, BANTEN",73,92,161,253
https://kawalpemilu.org#53209,"JURANGMANGU BARAT, PONDOK AREN, KOTA TANGERANG SELATAN, BANTEN",74,124,165,289
https://kawalpemilu.org#53209,"JURANGMANGU BARAT, PONDOK AREN, KOTA TANGERANG SELATAN, BANTEN",75,108,99,207
https://kawalpemilu.org#53209,"JURANGMANGU BARAT, PONDOK AREN, KOTA TANGERANG SELATAN, BANTEN",76,128,87,215
https://kawalpemilu.org#53209,"JURANGMANGU BARAT, PONDOK AREN, KOTA TANGERANG SELATAN, BANTEN",77,96,115,211
https://kawalpemilu.org#53209,"JURANGMANGU BARAT, PONDOK AREN, KOTA TANGERANG SELATAN, BANTEN",78,140,94,234
https://kawalpemilu.org#53209,"JURANGMANGU BARAT, PONDOK AREN, KOTA TANGERANG SELATAN, BANTEN",79,151,73,224
https://kawalpemilu.org#53209,"JURANGMANGU BARAT, PONDOK AREN, KOTA TANGERANG SELATAN, BANTEN",80,135,123,258
https://kawalpemilu.org#53209,"JURANGMANGU BARAT, PONDOK AREN, KOTA TANGERANG SELATAN, BANTEN",81,127,116,243
https://kawalpemilu.org#53209,"JURANGMANGU BARAT, PONDOK AREN, KOTA TANGERANG SELATAN, BANTEN",82,99,148,247
https://kawalpemilu.org#53209,"JURANGMANGU BARAT, PONDOK AREN, KOTA TANGERANG SELATAN, BANTEN",83,111,154,265
https://kawalpemilu.org#53209,"JURANGMANGU BARAT, PONDOK AREN, KOTA TANGERANG SELATAN, BANTEN",84,108,140,248
https://kawalpemilu.org#53209,"JURANGMANGU BARAT, PONDOK AREN, KOTA TANGERANG SELATAN, BANTEN",85,107,164,271
https://kawalpemilu.org#53209,"JURANGMANGU BARAT, PONDOK AREN, KOTA TANGERANG SELATAN, BANTEN",86,80,151,231
https://kawalpemilu.org#53209,"JURANGMANGU BARAT, PONDOK AREN, KOTA TANGERANG SELATAN, BANTEN",87,82,150,232
https://kawalpemilu.org#53209,"JURANGMANGU BARAT, PONDOK AREN, KOTA TANGERANG SELATAN, BANTEN",88,137,100,237
https://kawalpemilu.org#53209,"JURANGMANGU BARAT, PONDOK AREN, KOTA TANGERANG SELATAN, BANTEN",89,137,80,217
https://kawalpemilu.org#53209,"JURANGMANGU BARAT, PONDOK AREN, KOTA TANGERANG SELATAN, BANTEN",90,161,74,235
https://kawalpemilu.org#53209,"JURANGMANGU BARAT, PONDOK AREN, KOTA TANGERANG SELATAN, BANTEN",91,115,93,208
https://kawalpemilu.org#53209,"JURANGMANGU BARAT, PONDOK AREN, KOTA TANGERANG SELATAN, BANTEN",92,117,102,219
https://kawalpemilu.org#53209,"JURANGMANGU BARAT, PONDOK AREN, KOTA TANGERANG SELATAN, BANTEN",93,84,68,152
https://kawalpemilu.org#53209,"JURANGMANGU BARAT, PONDOK AREN, KOTA TANGERANG SELATAN, BANTEN",94,113,102,215
https://kawalpemilu.org#53209,"JURANGMANGU BARAT, PONDOK AREN, KOTA TANGERANG SELATAN, BANTEN",95,115,104,219
https://kawalpemilu.org#53209,"JURANGMANGU BARAT, PONDOK AREN, KOTA TANGERANG SELATAN, BANTEN",96,113,121,234
https://kawalpemilu.org#53211,"SAWAH BARU, CIPUTAT, KOTA TANGERANG SELATAN, BANTEN",1,128,110,238
https://kawalpemilu.org#53211,"SAWAH BARU, CIPUTAT, KOTA TANGERANG SELATAN, BANTEN",2,134,88,222
https://kawalpemilu.org#53211,"SAWAH BARU, CIPUTAT, KOTA TANGERANG SELATAN, BANTEN",3,133,80,213
https://kawalpemilu.org#53211,"SAWAH BARU, CIPUTAT, KOTA TANGERANG SELATAN, BANTEN",4,146,119,265
https://kawalpemilu.org#53211,"SAWAH BARU, CIPUTAT, KOTA TANGERANG SELATAN, BANTEN",5,118,134,252
https://kawalpemilu.org#53211,"SAWAH BARU, CIPUTAT, KOTA TANGERANG SELATAN, BANTEN",6,58,62,125
https://kawalpemilu.org#53211,"SAWAH BARU, CIPUTAT, KOTA TANGERANG SELATAN, BANTEN",7,93,86,179
https://kawalpemilu.org#53211,"SAWAH BARU, CIPUTAT, KOTA TANGERANG SELATAN, BANTEN",8,107,122,229
https://kawalpemilu.org#53211,"SAWAH BARU, CIPUTAT, KOTA TANGERANG SELATAN, BANTEN",9,78,63,141
https://kawalpemilu.org#53211,"SAWAH BARU, CIPUTAT, KOTA TANGERANG SELATAN, BANTEN",10,74,121,195
https://kawalpemilu.org#53211,"SAWAH BARU, CIPUTAT, KOTA TANGERANG SELATAN, BANTEN",11,140,89,229
https://kawalpemilu.org#53211,"SAWAH BARU, CIPUTAT, KOTA TANGERANG SELATAN, BANTEN",12,116,101,217
https://kawalpemilu.org#53211,"SAWAH BARU, CIPUTAT, KOTA TANGERANG SELATAN, BANTEN",13,116,124,240
https://kawalpemilu.org#53211,"SAWAH BARU, CIPUTAT, KOTA TANGERANG SELATAN, BANTEN",14,133,86,219
https://kawalpemilu.org#53211,"SAWAH BARU, CIPUTAT, KOTA TANGERANG SELATAN, BANTEN",15,106,146,252
https://kawalpemilu.org#53211,"SAWAH BARU, CIPUTAT, KOTA TANGERANG SELATAN, BANTEN",16,106,146,252
https://kawalpemilu.org#53211,"SAWAH BARU, CIPUTAT, KOTA TANGERANG SELATAN, BANTEN",17,111,128,239
https://kawalpemilu.org#53211,"SAWAH BARU, CIPUTAT, KOTA TANGERANG SELATAN, BANTEN",18,115,120,235
https://kawalpemilu.org#53211,"SAWAH BARU, CIPUTAT, KOTA TANGERANG SELATAN, BANTEN",19,126,148,274
https://kawalpemilu.org#53211,"SAWAH BARU, CIPUTAT, KOTA TANGERANG SELATAN, BANTEN",20,99,136,235
https://kawalpemilu.org#53211,"SAWAH BARU, CIPUTAT, KOTA TANGERANG SELATAN, BANTEN",21,102,133,235
https://kawalpemilu.org#53211,"SAWAH BARU, CIPUTAT, KOTA TANGERANG SELATAN, BANTEN",22,113,132,245
https://kawalpemilu.org#53211,"SAWAH BARU, CIPUTAT, KOTA TANGERANG SELATAN, BANTEN",23,121,87,208
https://kawalpemilu.org#53211,"SAWAH BARU, CIPUTAT, KOTA TANGERANG SELATAN, BANTEN",24,138,112,250
https://kawalpemilu.org#53211,"SAWAH BARU, CIPUTAT, KOTA TANGERANG SELATAN, BANTEN",25,69,96,165
https://kawalpemilu.org#53211,"SAWAH BARU, CIPUTAT, KOTA TANGERANG SELATAN, BANTEN",26,128,62,190
https://kawalpemilu.org#53211,"SAWAH BARU, CIPUTAT, KOTA TANGERANG SELATAN, BANTEN",27,87,117,204
https://kawalpemilu.org#53211,"SAWAH BARU, CIPUTAT, KOTA TANGERANG SELATAN, BANTEN",28,101,100,201
https://kawalpemilu.org#53211,"SAWAH BARU, CIPUTAT, KOTA TANGERANG SELATAN, BANTEN",29,87,123,210
https://kawalpemilu.org#53211,"SAWAH BARU, CIPUTAT, KOTA TANGERANG SELATAN, BANTEN",30,99,142,241
https://kawalpemilu.org#53211,"SAWAH BARU, CIPUTAT, KOTA TANGERANG SELATAN, BANTEN",31,110,133,243
https://kawalpemilu.org#53211,"SAWAH BARU, CIPUTAT, KOTA TANGERANG SELATAN, BANTEN",32,113,76,189
https://kawalpemilu.org#53211,"SAWAH BARU, CIPUTAT, KOTA TANGERANG SELATAN, BANTEN",33,114,96,210
https://kawalpemilu.org#53211,"SAWAH BARU, CIPUTAT, KOTA TANGERANG SELATAN, BANTEN",34,115,87,202
https://kawalpemilu.org#53211,"SAWAH BARU, CIPUTAT, KOTA TANGERANG SELATAN, BANTEN",35,68,44,112
https://kawalpemilu.org#53211,"SAWAH BARU, CIPUTAT, KOTA TANGERANG SELATAN, BANTEN",36,96,113,209
https://kawalpemilu.org#53211,"SAWAH BARU, CIPUTAT, KOTA TANGERANG SELATAN, BANTEN",37,108,117,225
https://kawalpemilu.org#53211,"SAWAH BARU, CIPUTAT, KOTA TANGERANG SELATAN, BANTEN",38,122,117,239
https://kawalpemilu.org#53211,"SAWAH BARU, CIPUTAT, KOTA TANGERANG SELATAN, BANTEN",39,126,74,200
https://kawalpemilu.org#53211,"SAWAH BARU, CIPUTAT, KOTA TANGERANG SELATAN, BANTEN",40,148,116,264
https://kawalpemilu.org#53211,"SAWAH BARU, CIPUTAT, KOTA TANGERANG SELATAN, BANTEN",41,143,109,252
https://kawalpemilu.org#53211,"SAWAH BARU, CIPUTAT, KOTA TANGERANG SELATAN, BANTEN",42,89,112,201
https://kawalpemilu.org#53211,"SAWAH BARU, CIPUTAT, KOTA TANGERANG SELATAN, BANTEN",43,83,104,187
https://kawalpemilu.org#53211,"SAWAH BARU, CIPUTAT, KOTA TANGERANG SELATAN, BANTEN",44,73,52,125
https://kawalpemilu.org#53211,"SAWAH BARU, CIPUTAT, KOTA TANGERANG SELATAN, BANTEN",45,77,54,131
https://kawalpemilu.org#53211,"SAWAH BARU, CIPUTAT, KOTA TANGERANG SELATAN, BANTEN",46,97,114,211
https://kawalpemilu.org#53211,"SAWAH BARU, CIPUTAT, KOTA TANGERANG SELATAN, BANTEN",47,97,147,244
https://kawalpemilu.org#53211,"SAWAH BARU, CIPUTAT, KOTA TANGERANG SELATAN, BANTEN",48,99,134,233
https://kawalpemilu.org#53211,"SAWAH BARU, CIPUTAT, KOTA TANGERANG SELATAN, BANTEN",49,114,79,193
https://kawalpemilu.org#53211,"SAWAH BARU, CIPUTAT, KOTA TANGERANG SELATAN, BANTEN",50,135,115,250
https://kawalpemilu.org#53211,"SAWAH BARU, CIPUTAT, KOTA TANGERANG SELATAN, BANTEN",51,126,125,251
https://kawalpemilu.org#53211,"SAWAH BARU, CIPUTAT, KOTA TANGERANG SELATAN, BANTEN",52,97,80,177
https://kawalpemilu.org#53211,"SAWAH BARU, CIPUTAT, KOTA TANGERANG SELATAN, BANTEN",53,118,106,224
https://kawalpemilu.org#53211,"SAWAH BARU, CIPUTAT, KOTA TANGERANG SELATAN, BANTEN",54,108,97,205
https://kawalpemilu.org#53211,"SAWAH BARU, CIPUTAT, KOTA TANGERANG SELATAN, BANTEN",55,153,108,261
https://kawalpemilu.org#53211,"SAWAH BARU, CIPUTAT, KOTA TANGERANG SELATAN, BANTEN",56,129,88,217
https://kawalpemilu.org#53211,"SAWAH BARU, CIPUTAT, KOTA TANGERANG SELATAN, BANTEN",57,150,79,229
https://kawalpemilu.org#53211,"SAWAH BARU, CIPUTAT, KOTA TANGERANG SELATAN, BANTEN",58,119,80,199
https://kawalpemilu.org#53211,"SAWAH BARU, CIPUTAT, KOTA TANGERANG SELATAN, BANTEN",59,126,114,240
https://kawalpemilu.org#53211,"SAWAH BARU, CIPUTAT, KOTA TANGERANG SELATAN, BANTEN",60,118,137,255
https://kawalpemilu.org#53211,"SAWAH BARU, CIPUTAT, KOTA TANGERANG SELATAN, BANTEN",61,143,103,246
https://kawalpemilu.org#53211,"SAWAH BARU, CIPUTAT, KOTA TANGERANG SELATAN, BANTEN",62,96,137,233
https://kawalpemilu.org#53211,"SAWAH BARU, CIPUTAT, KOTA TANGERANG SELATAN, BANTEN",63,115,94,209
https://kawalpemilu.org#53211,"SAWAH BARU, CIPUTAT, KOTA TANGERANG SELATAN, BANTEN",64,138,133,271
https://kawalpemilu.org#53211,"SAWAH BARU, CIPUTAT, KOTA TANGERANG SELATAN, BANTEN",65,110,105,215
https://kawalpemilu.org#53211,"SAWAH BARU, CIPUTAT, KOTA TANGERANG SELATAN, BANTEN",66,124,124,248
https://kawalpemilu.org#53211,"SAWAH BARU, CIPUTAT, KOTA TANGERANG SELATAN, BANTEN",67,165,60,225
https://kawalpemilu.org#53211,"SAWAH BARU, CIPUTAT, KOTA TANGERANG SELATAN, BANTEN",68,106,73,179
https://kawalpemilu.org#53211,"SAWAH BARU, CIPUTAT, KOTA TANGERANG SELATAN, BANTEN",69,153,53,206
https://kawalpemilu.org#53211,"SAWAH BARU, CIPUTAT, KOTA TANGERANG SELATAN, BANTEN",70,139,68,207
https://kawalpemilu.org#53211,"SAWAH BARU, CIPUTAT, KOTA TANGERANG SELATAN, BANTEN",71,127,60,187
https://kawalpemilu.org#53211,"SAWAH BARU, CIPUTAT, KOTA TANGERANG SELATAN, BANTEN",72,158,69,227
https://kawalpemilu.org#53211,"SAWAH BARU, CIPUTAT, KOTA TANGERANG SELATAN, BANTEN",73,173,69,242
https://kawalpemilu.org#53211,"SAWAH BARU, CIPUTAT, KOTA TANGERANG SELATAN, BANTEN",74,117,54,171
https://kawalpemilu.org#53212,"SERUA, CIPUTAT, KOTA TANGERANG SELATAN, BANTEN",1,117,98,215
https://kawalpemilu.org#53212,"SERUA, CIPUTAT, KOTA TANGERANG SELATAN, BANTEN",2,113,97,210
https://kawalpemilu.org#53212,"SERUA, CIPUTAT, KOTA TANGERANG SELATAN, BANTEN",3,114,107,221
https://kawalpemilu.org#53212,"SERUA, CIPUTAT, KOTA TANGERANG SELATAN, BANTEN",4,103,88,191
https://kawalpemilu.org#53212,"SERUA, CIPUTAT, KOTA TANGERANG SELATAN, BANTEN",5,69,107,176
https://kawalpemilu.org#53212,"SERUA, CIPUTAT, KOTA TANGERANG SELATAN, BANTEN",6,131,117,248
https://kawalpemilu.org#53212,"SERUA, CIPUTAT, KOTA TANGERANG SELATAN, BANTEN",7,102,106,208
https://kawalpemilu.org#53212,"SERUA, CIPUTAT, KOTA TANGERANG SELATAN, BANTEN",8,106,132,238
https://kawalpemilu.org#53212,"SERUA, CIPUTAT, KOTA TANGERANG SELATAN, BANTEN",9,151,76,227
https://kawalpemilu.org#53212,"SERUA, CIPUTAT, KOTA TANGERANG SELATAN, BANTEN",10,144,80,224
https://kawalpemilu.org#53212,"SERUA, CIPUTAT, KOTA TANGERANG SELATAN, BANTEN",11,117,64,181
https://kawalpemilu.org#53212,"SERUA, CIPUTAT, KOTA TANGERANG SELATAN, BANTEN",12,105,94,199
https://kawalpemilu.org#53212,"SERUA, CIPUTAT, KOTA TANGERANG SELATAN, BANTEN",13,98,73,171
https://kawalpemilu.org#53212,"SERUA, CIPUTAT, KOTA TANGERANG SELATAN, BANTEN",14,104,124,228
https://kawalpemilu.org#53212,"SERUA, CIPUTAT, KOTA TANGERANG SELATAN, BANTEN",15,131,113,244
https://kawalpemilu.org#53212,"SERUA, CIPUTAT, KOTA TANGERANG SELATAN, BANTEN",16,122,105,227
https://kawalpemilu.org#53212,"SERUA, CIPUTAT, KOTA TANGERANG SELATAN, BANTEN",17,105,116,221
https://kawalpemilu.org#53212,"SERUA, CIPUTAT, KOTA TANGERANG SELATAN, BANTEN",18,88,103,191
https://kawalpemilu.org#53212,"SERUA, CIPUTAT, KOTA TANGERANG SELATAN, BANTEN",19,115,71,186
https://kawalpemilu.org#53212,"SERUA, CIPUTAT, KOTA TANGERANG SELATAN, BANTEN",20,99,104,203
https://kawalpemilu.org#53212,"SERUA, CIPUTAT, KOTA TANGERANG SELATAN, BANTEN",21,131,117,248
https://kawalpemilu.org#53212,"SERUA, CIPUTAT, KOTA TANGERANG SELATAN, BANTEN",22,110,82,192
https://kawalpemilu.org#53212,"SERUA, CIPUTAT, KOTA TANGERANG SELATAN, BANTEN",23,110,95,205
https://kawalpemilu.org#53212,"SERUA, CIPUTAT, KOTA TANGERANG SELATAN, BANTEN",24,92,105,197
https://kawalpemilu.org#53212,"SERUA, CIPUTAT, KOTA TANGERANG SELATAN, BANTEN",25,85,101,186
https://kawalpemilu.org#53212,"SERUA, CIPUTAT, KOTA TANGERANG SELATAN, BANTEN",26,67,104,171
https://kawalpemilu.org#53212,"SERUA, CIPUTAT, KOTA TANGERANG SELATAN, BANTEN",27,122,140,262
https://kawalpemilu.org#53212,"SERUA, CIPUTAT, KOTA TANGERANG SELATAN, BANTEN",28,158,51,209
https://kawalpemilu.org#53212,"SERUA, CIPUTAT, KOTA TANGERANG SELATAN, BANTEN",29,75,102,177
https://kawalpemilu.org#53212,"SERUA, CIPUTAT, KOTA TANGERANG SELATAN, BANTEN",30,83,91,174
https://kawalpemilu.org#53212,"SERUA, CIPUTAT, KOTA TANGERANG SELATAN, BANTEN",31,107,82,189
https://kawalpemilu.org#53212,"SERUA, CIPUTAT, KOTA TANGERANG SELATAN, BANTEN",32,77,41,118
https://kawalpemilu.org#53212,"SERUA, CIPUTAT, KOTA TANGERANG SELATAN, BANTEN",33,64,97,161
https://kawalpemilu.org#53212,"SERUA, CIPUTAT, KOTA TANGERANG SELATAN, BANTEN",35,86,112,198
https://kawalpemilu.org#53212,"SERUA, CIPUTAT, KOTA TANGERANG SELATAN, BANTEN",36,102,138,240
https://kawalpemilu.org#53212,"SERUA, CIPUTAT, KOTA TANGERANG SELATAN, BANTEN",37,103,119,222
https://kawalpemilu.org#53212,"SERUA, CIPUTAT, KOTA TANGERANG SELATAN, BANTEN",38,88,125,213
https://kawalpemilu.org#53212,"SERUA, CIPUTAT, KOTA TANGERANG SELATAN, BANTEN",39,74,145,219
https://kawalpemilu.org#53212,"SERUA, CIPUTAT, KOTA TANGERANG SELATAN, BANTEN",40,70,127,197
https://kawalpemilu.org#53212,"SERUA, CIPUTAT, KOTA TANGERANG SELATAN, BANTEN",41,83,108,191
https://kawalpemilu.org#53212,"SERUA, CIPUTAT, KOTA TANGERANG SELATAN, BANTEN",42,84,114,198
https://kawalpemilu.org#53212,"SERUA, CIPUTAT, KOTA TANGERANG SELATAN, BANTEN",43,74,109,183
https://kawalpemilu.org#53212,"SERUA, CIPUTAT, KOTA TANGERANG SELATAN, BANTEN",44,85,92,177
https://kawalpemilu.org#53212,"SERUA, CIPUTAT, KOTA TANGERANG SELATAN, BANTEN",45,103,90,193
https://kawalpemilu.org#53212,"SERUA, CIPUTAT, KOTA TANGERANG SELATAN, BANTEN",46,122,76,198
https://kawalpemilu.org#53212,"SERUA, CIPUTAT, KOTA TANGERANG SELATAN, BANTEN",47,107,87,194
https://kawalpemilu.org#53212,"SERUA, CIPUTAT, KOTA TANGERANG SELATAN, BANTEN",48,110,101,211
https://kawalpemilu.org#53212,"SERUA, CIPUTAT, KOTA TANGERANG SELATAN, BANTEN",49,103,88,191
https://kawalpemilu.org#53212,"SERUA, CIPUTAT, KOTA TANGERANG SELATAN, BANTEN",50,102,76,178
https://kawalpemilu.org#53212,"SERUA, CIPUTAT, KOTA TANGERANG SELATAN, BANTEN",51,88,76,164
https://kawalpemilu.org#53212,"SERUA, CIPUTAT, KOTA TANGERANG SELATAN, BANTEN",52,140,122,262
https://kawalpemilu.org#53212,"SERUA, CIPUTAT, KOTA TANGERANG SELATAN, BANTEN",53,123,72,195
https://kawalpemilu.org#53212,"SERUA, CIPUTAT, KOTA TANGERANG SELATAN, BANTEN",54,156,78,234
https://kawalpemilu.org#53212,"SERUA, CIPUTAT, KOTA TANGERANG SELATAN, BANTEN",55,101,91,192
https://kawalpemilu.org#53212,"SERUA, CIPUTAT, KOTA TANGERANG SELATAN, BANTEN",56,95,66,161
https://kawalpemilu.org#53212,"SERUA, CIPUTAT, KOTA TANGERANG SELATAN, BANTEN",58,171,91,262
https://kawalpemilu.org#53212,"SERUA, CIPUTAT, KOTA TANGERANG SELATAN, BANTEN",59,106,93,199
https://kawalpemilu.org#53212,"SERUA, CIPUTAT, KOTA TANGERANG SELATAN, BANTEN",60,100,81,181
https://kawalpemilu.org#53212,"SERUA, CIPUTAT, KOTA TANGERANG SELATAN, BANTEN",61,120,91,211
https://kawalpemilu.org#53212,"SERUA, CIPUTAT, KOTA TANGERANG SELATAN, BANTEN",62,133,99,232
https://kawalpemilu.org#53212,"SERUA, CIPUTAT, KOTA TANGERANG SELATAN, BANTEN",63,120,76,196
https://kawalpemilu.org#53212,"SERUA, CIPUTAT, KOTA TANGERANG SELATAN, BANTEN",64,123,102,225
https://kawalpemilu.org#53212,"SERUA, CIPUTAT, KOTA TANGERANG SELATAN, BANTEN",65,100,20,120
https://kawalpemilu.org#53212,"SERUA, CIPUTAT, KOTA TANGERANG SELATAN, BANTEN",66,156,118,274
https://kawalpemilu.org#53212,"SERUA, CIPUTAT, KOTA TANGERANG SELATAN, BANTEN",67,131,138,269
https://kawalpemilu.org#53212,"SERUA, CIPUTAT, KOTA TANGERANG SELATAN, BANTEN",68,83,82,165
https://kawalpemilu.org#53212,"SERUA, CIPUTAT, KOTA TANGERANG SELATAN, BANTEN",69,84,84,168
https://kawalpemilu.org#53212,"SERUA, CIPUTAT, KOTA TANGERANG SELATAN, BANTEN",70,113,96,209
https://kawalpemilu.org#53212,"SERUA, CIPUTAT, KOTA TANGERANG SELATAN, BANTEN",71,94,57,151
https://kawalpemilu.org#53212,"SERUA, CIPUTAT, KOTA TANGERANG SELATAN, BANTEN",72,141,72,213
https://kawalpemilu.org#53212,"SERUA, CIPUTAT, KOTA TANGERANG SELATAN, BANTEN",73,156,65,221
https://kawalpemilu.org#53212,"SERUA, CIPUTAT, KOTA TANGERANG SELATAN, BANTEN",74,115,128,243
https://kawalpemilu.org#53212,"SERUA, CIPUTAT, KOTA TANGERANG SELATAN, BANTEN",75,148,69,217
https://kawalpemilu.org#53212,"SERUA, CIPUTAT, KOTA TANGERANG SELATAN, BANTEN",76,138,47,185
https://kawalpemilu.org#53212,"SERUA, CIPUTAT, KOTA TANGERANG SELATAN, BANTEN",77,139,92,231
https://kawalpemilu.org#53212,"SERUA, CIPUTAT, KOTA TANGERANG SELATAN, BANTEN",78,138,66,204
https://kawalpemilu.org#53212,"SERUA, CIPUTAT, KOTA TANGERANG SELATAN, BANTEN",79,102,58,160
https://kawalpemilu.org#53212,"SERUA, CIPUTAT, KOTA TANGERANG SELATAN, BANTEN",80,150,48,198
https://kawalpemilu.org#53212,"SERUA, CIPUTAT, KOTA TANGERANG SELATAN, BANTEN",81,120,59,179
https://kawalpemilu.org#53212,"SERUA, CIPUTAT, KOTA TANGERANG SELATAN, BANTEN",82,120,99,219
https://kawalpemilu.org#53212,"SERUA, CIPUTAT, KOTA TANGERANG SELATAN, BANTEN",83,100,77,177
https://kawalpemilu.org#53212,"SERUA, CIPUTAT, KOTA TANGERANG SELATAN, BANTEN",84,122,31,153
https://kawalpemilu.org#53212,"SERUA, CIPUTAT, KOTA TANGERANG SELATAN, BANTEN",85,86,43,129
https://kawalpemilu.org#53212,"SERUA, CIPUTAT, KOTA TANGERANG SELATAN, BANTEN",86,114,68,182
https://kawalpemilu.org#53212,"SERUA, CIPUTAT, KOTA TANGERANG SELATAN, BANTEN",87,98,63,161
https://kawalpemilu.org#53212,"SERUA, CIPUTAT, KOTA TANGERANG SELATAN, BANTEN",88,141,82,223
https://kawalpemilu.org#53212,"SERUA, CIPUTAT, KOTA TANGERANG SELATAN, BANTEN",89,124,93,217
https://kawalpemilu.org#53212,"SERUA, CIPUTAT, KOTA TANGERANG SELATAN, BANTEN",90,129,51,180
https://kawalpemilu.org#53212,"SERUA, CIPUTAT, KOTA TANGERANG SELATAN, BANTEN",91,129,45,174
https://kawalpemilu.org#53212,"SERUA, CIPUTAT, KOTA TANGERANG SELATAN, BANTEN",92,89,140,229
https://kawalpemilu.org#53212,"SERUA, CIPUTAT, KOTA TANGERANG SELATAN, BANTEN",93,92,142,234
https://kawalpemilu.org#53212,"SERUA, CIPUTAT, KOTA TANGERANG SELATAN, BANTEN",94,130,129,259
https://kawalpemilu.org#53212,"SERUA, CIPUTAT, KOTA TANGERANG SELATAN, BANTEN",95,68,116,184
https://kawalpemilu.org#53212,"SERUA, CIPUTAT, KOTA TANGERANG SELATAN, BANTEN",96,102,69,171
https://kawalpemilu.org#53212,"SERUA, CIPUTAT, KOTA TANGERANG SELATAN, BANTEN",97,77,84,161
https://kawalpemilu.org#53212,"SERUA, CIPUTAT, KOTA TANGERANG SELATAN, BANTEN",98,110,104,214
https://kawalpemilu.org#53212,"SERUA, CIPUTAT, KOTA TANGERANG SELATAN, BANTEN",99,114,104,218
https://kawalpemilu.org#53212,"SERUA, CIPUTAT, KOTA TANGERANG SELATAN, BANTEN",100,89,102,191
https://kawalpemilu.org#53212,"SERUA, CIPUTAT, KOTA TANGERANG SELATAN, BANTEN",101,86,122,208
https://kawalpemilu.org#53212,"SERUA, CIPUTAT, KOTA TANGERANG SELATAN, BANTEN",102,107,127,234
https://kawalpemilu.org#53212,"SERUA, CIPUTAT, KOTA TANGERANG SELATAN, BANTEN",103,155,117,272
https://kawalpemilu.org#53212,"SERUA, CIPUTAT, KOTA TANGERANG SELATAN, BANTEN",104,129,137,266
https://kawalpemilu.org#53212,"SERUA, CIPUTAT, KOTA TANGERANG SELATAN, BANTEN",105,109,133,242
https://kawalpemilu.org#53212,"SERUA, CIPUTAT, KOTA TANGERANG SELATAN, BANTEN",106,125,104,229
https://kawalpemilu.org#53212,"SERUA, CIPUTAT, KOTA TANGERANG SELATAN, BANTEN",107,123,116,239
https://kawalpemilu.org#53212,"SERUA, CIPUTAT, KOTA TANGERANG SELATAN, BANTEN",108,105,152,257
https://kawalpemilu.org#53212,"SERUA, CIPUTAT, KOTA TANGERANG SELATAN, BANTEN",109,91,139,230
https://kawalpemilu.org#53212,"SERUA, CIPUTAT, KOTA TANGERANG SELATAN, BANTEN",110,92,94,186
https://kawalpemilu.org#53212,"SERUA, CIPUTAT, KOTA TANGERANG SELATAN, BANTEN",111,145,90,235
https://kawalpemilu.org#53212,"SERUA, CIPUTAT, KOTA TANGERANG SELATAN, BANTEN",112,118,139,257
https://kawalpemilu.org#53213,"CIPUTAT, CIPUTAT, KOTA TANGERANG SELATAN, BANTEN",1,131,136,267
https://kawalpemilu.org#53213,"CIPUTAT, CIPUTAT, KOTA TANGERANG SELATAN, BANTEN",2,80,110,190
https://kawalpemilu.org#53213,"CIPUTAT, CIPUTAT, KOTA TANGERANG SELATAN, BANTEN",3,106,148,254
https://kawalpemilu.org#53213,"CIPUTAT, CIPUTAT, KOTA TANGERANG SELATAN, BANTEN",4,117,136,253
https://kawalpemilu.org#53213,"CIPUTAT, CIPUTAT, KOTA TANGERANG SELATAN, BANTEN",5,72,73,145
https://kawalpemilu.org#53213,"CIPUTAT, CIPUTAT, KOTA TANGERANG SELATAN, BANTEN",6,102,144,246
https://kawalpemilu.org#53213,"CIPUTAT, CIPUTAT, KOTA TANGERANG SELATAN, BANTEN",7,64,89,153
https://kawalpemilu.org#53213,"CIPUTAT, CIPUTAT, KOTA TANGERANG SELATAN, BANTEN",8,79,136,215
https://kawalpemilu.org#53213,"CIPUTAT, CIPUTAT, KOTA TANGERANG SELATAN, BANTEN",9,112,146,258
https://kawalpemilu.org#53213,"CIPUTAT, CIPUTAT, KOTA TANGERANG SELATAN, BANTEN",10,104,150,254
https://kawalpemilu.org#53213,"CIPUTAT, CIPUTAT, KOTA TANGERANG SELATAN, BANTEN",11,97,121,218
https://kawalpemilu.org#53213,"CIPUTAT, CIPUTAT, KOTA TANGERANG SELATAN, BANTEN",12,99,117,216
https://kawalpemilu.org#53213,"CIPUTAT, CIPUTAT, KOTA TANGERANG SELATAN, BANTEN",13,80,71,151
https://kawalpemilu.org#53213,"CIPUTAT, CIPUTAT, KOTA TANGERANG SELATAN, BANTEN",14,58,69,127
https://kawalpemilu.org#53213,"CIPUTAT, CIPUTAT, KOTA TANGERANG SELATAN, BANTEN",15,133,104,237
https://kawalpemilu.org#53213,"CIPUTAT, CIPUTAT, KOTA TANGERANG SELATAN, BANTEN",16,161,106,267
https://kawalpemilu.org#53213,"CIPUTAT, CIPUTAT, KOTA TANGERANG SELATAN, BANTEN",17,183,92,275
https://kawalpemilu.org#53213,"CIPUTAT, CIPUTAT, KOTA TANGERANG SELATAN, BANTEN",18,105,117,222
https://kawalpemilu.org#53213,"CIPUTAT, CIPUTAT, KOTA TANGERANG SELATAN, BANTEN",19,95,134,229
https://kawalpemilu.org#53213,"CIPUTAT, CIPUTAT, KOTA TANGERANG SELATAN, BANTEN",20,141,98,239
https://kawalpemilu.org#53213,"CIPUTAT, CIPUTAT, KOTA TANGERANG SELATAN, BANTEN",21,90,107,197
https://kawalpemilu.org#53213,"CIPUTAT, CIPUTAT, KOTA TANGERANG SELATAN, BANTEN",22,108,131,239
https://kawalpemilu.org#53213,"CIPUTAT, CIPUTAT, KOTA TANGERANG SELATAN, BANTEN",23,105,61,166
https://kawalpemilu.org#53213,"CIPUTAT, CIPUTAT, KOTA TANGERANG SELATAN, BANTEN",24,91,74,165
https://kawalpemilu.org#53213,"CIPUTAT, CIPUTAT, KOTA TANGERANG SELATAN, BANTEN",25,84,143,227
https://kawalpemilu.org#53213,"CIPUTAT, CIPUTAT, KOTA TANGERANG SELATAN, BANTEN",26,59,86,145
https://kawalpemilu.org#53213,"CIPUTAT, CIPUTAT, KOTA TANGERANG SELATAN, BANTEN",27,54,74,128
https://kawalpemilu.org#53213,"CIPUTAT, CIPUTAT, KOTA TANGERANG SELATAN, BANTEN",28,188,81,269
https://kawalpemilu.org#53213,"CIPUTAT, CIPUTAT, KOTA TANGERANG SELATAN, BANTEN",29,86,101,187
https://kawalpemilu.org#53213,"CIPUTAT, CIPUTAT, KOTA TANGERANG SELATAN, BANTEN",30,68,99,167
https://kawalpemilu.org#53213,"CIPUTAT, CIPUTAT, KOTA TANGERANG SELATAN, BANTEN",31,81,63,144
https://kawalpemilu.org#53213,"CIPUTAT, CIPUTAT, KOTA TANGERANG SELATAN, BANTEN",32,95,87,182
https://kawalpemilu.org#53213,"CIPUTAT, CIPUTAT, KOTA TANGERANG SELATAN, BANTEN",33,118,99,217
https://kawalpemilu.org#53213,"CIPUTAT, CIPUTAT, KOTA TANGERANG SELATAN, BANTEN",34,86,117,203
https://kawalpemilu.org#53213,"CIPUTAT, CIPUTAT, KOTA TANGERANG SELATAN, BANTEN",35,82,117,199
https://kawalpemilu.org#53213,"CIPUTAT, CIPUTAT, KOTA TANGERANG SELATAN, BANTEN",36,56,95,151
https://kawalpemilu.org#53213,"CIPUTAT, CIPUTAT, KOTA TANGERANG SELATAN, BANTEN",37,88,172,260
https://kawalpemilu.org#53213,"CIPUTAT, CIPUTAT, KOTA TANGERANG SELATAN, BANTEN",38,104,87,191
https://kawalpemilu.org#53213,"CIPUTAT, CIPUTAT, KOTA TANGERANG SELATAN, BANTEN",39,70,96,166
https://kawalpemilu.org#53213,"CIPUTAT, CIPUTAT, KOTA TANGERANG SELATAN, BANTEN",40,188,53,241
https://kawalpemilu.org#53213,"CIPUTAT, CIPUTAT, KOTA TANGERANG SELATAN, BANTEN",41,112,87,199
https://kawalpemilu.org#53213,"CIPUTAT, CIPUTAT, KOTA TANGERANG SELATAN, BANTEN",42,120,66,186
https://kawalpemilu.org#53213,"CIPUTAT, CIPUTAT, KOTA TANGERANG SELATAN, BANTEN",43,86,127,213
https://kawalpemilu.org#53213,"CIPUTAT, CIPUTAT, KOTA TANGERANG SELATAN, BANTEN",44,63,59,122
https://kawalpemilu.org#53213,"CIPUTAT, CIPUTAT, KOTA TANGERANG SELATAN, BANTEN",45,54,115,169
https://kawalpemilu.org#53213,"CIPUTAT, CIPUTAT, KOTA TANGERANG SELATAN, BANTEN",46,39,126,165
https://kawalpemilu.org#53213,"CIPUTAT, CIPUTAT, KOTA TANGERANG SELATAN, BANTEN",47,92,153,245
https://kawalpemilu.org#53213,"CIPUTAT, CIPUTAT, KOTA TANGERANG SELATAN, BANTEN",48,86,127,213
https://kawalpemilu.org#53213,"CIPUTAT, CIPUTAT, KOTA TANGERANG SELATAN, BANTEN",49,55,131,186
https://kawalpemilu.org#53213,"CIPUTAT, CIPUTAT, KOTA TANGERANG SELATAN, BANTEN",50,53,122,175
https://kawalpemilu.org#53213,"CIPUTAT, CIPUTAT, KOTA TANGERANG SELATAN, BANTEN",51,91,172,263
https://kawalpemilu.org#53213,"CIPUTAT, CIPUTAT, KOTA TANGERANG SELATAN, BANTEN",52,105,98,203
https://kawalpemilu.org#53213,"CIPUTAT, CIPUTAT, KOTA TANGERANG SELATAN, BANTEN",53,96,81,177
https://kawalpemilu.org#53213,"CIPUTAT, CIPUTAT, KOTA TANGERANG SELATAN, BANTEN",54,62,115,177
https://kawalpemilu.org#53213,"CIPUTAT, CIPUTAT, KOTA TANGERANG SELATAN, BANTEN",55,68,110,178
https://kawalpemilu.org#53213,"CIPUTAT, CIPUTAT, KOTA TANGERANG SELATAN, BANTEN",56,100,70,170
https://kawalpemilu.org#53213,"CIPUTAT, CIPUTAT, KOTA TANGERANG SELATAN, BANTEN",57,83,94,179
https://kawalpemilu.org#53213,"CIPUTAT, CIPUTAT, KOTA TANGERANG SELATAN, BANTEN",58,114,98,212
https://kawalpemilu.org#53213,"CIPUTAT, CIPUTAT, KOTA TANGERANG SELATAN, BANTEN",59,130,99,229
https://kawalpemilu.org#53213,"CIPUTAT, CIPUTAT, KOTA TANGERANG SELATAN, BANTEN",60,123,93,216
https://kawalpemilu.org#53213,"CIPUTAT, CIPUTAT, KOTA TANGERANG SELATAN, BANTEN",61,152,67,219
https://kawalpemilu.org#53213,"CIPUTAT, CIPUTAT, KOTA TANGERANG SELATAN, BANTEN",62,132,110,242
https://kawalpemilu.org#53213,"CIPUTAT, CIPUTAT, KOTA TANGERANG SELATAN, BANTEN",63,68,37,105
https://kawalpemilu.org#53213,"CIPUTAT, CIPUTAT, KOTA TANGERANG SELATAN, BANTEN",64,165,25,190
https://kawalpemilu.org#53213,"CIPUTAT, CIPUTAT, KOTA TANGERANG SELATAN, BANTEN",65,195,32,227
https://kawalpemilu.org#53213,"CIPUTAT, CIPUTAT, KOTA TANGERANG SELATAN, BANTEN",66,130,54,184
https://kawalpemilu.org#53213,"CIPUTAT, CIPUTAT, KOTA TANGERANG SELATAN, BANTEN",67,131,138,269
https://kawalpemilu.org#53213,"CIPUTAT, CIPUTAT, KOTA TANGERANG SELATAN, BANTEN",68,73,59,132
https://kawalpemilu.org#53213,"CIPUTAT, CIPUTAT, KOTA TANGERANG SELATAN, BANTEN",69,43,74,117
https://kawalpemilu.org#53213,"CIPUTAT, CIPUTAT, KOTA TANGERANG SELATAN, BANTEN",70,100,137,237
https://kawalpemilu.org#53213,"CIPUTAT, CIPUTAT, KOTA TANGERANG SELATAN, BANTEN",71,98,102,200
https://kawalpemilu.org#53213,"CIPUTAT, CIPUTAT, KOTA TANGERANG SELATAN, BANTEN",72,93,54,147
https://kawalpemilu.org#53213,"CIPUTAT, CIPUTAT, KOTA TANGERANG SELATAN, BANTEN",73,103,77,180
https://kawalpemilu.org#53213,"CIPUTAT, CIPUTAT, KOTA TANGERANG SELATAN, BANTEN",74,82,107,189
https://kawalpemilu.org#53214,"SAWAH, CIPUTAT, KOTA TANGERANG SELATAN, BANTEN",1,125,64,189
https://kawalpemilu.org#53214,"SAWAH, CIPUTAT, KOTA TANGERANG SELATAN, BANTEN",2,133,125,258
https://kawalpemilu.org#53214,"SAWAH, CIPUTAT, KOTA TANGERANG SELATAN, BANTEN",3,113,77,190
https://kawalpemilu.org#53214,"SAWAH, CIPUTAT, KOTA TANGERANG SELATAN, BANTEN",4,122,93,215
https://kawalpemilu.org#53214,"SAWAH, CIPUTAT, KOTA TANGERANG SELATAN, BANTEN",5,155,97,252
https://kawalpemilu.org#53214,"SAWAH, CIPUTAT, KOTA TANGERANG SELATAN, BANTEN",6,127,98,225
https://kawalpemilu.org#53214,"SAWAH, CIPUTAT, KOTA TANGERANG SELATAN, BANTEN",7,114,88,202
https://kawalpemilu.org#53214,"SAWAH, CIPUTAT, KOTA TANGERANG SELATAN, BANTEN",8,99,134,233
https://kawalpemilu.org#53214,"SAWAH, CIPUTAT, KOTA TANGERANG SELATAN, BANTEN",9,107,89,196
https://kawalpemilu.org#53214,"SAWAH, CIPUTAT, KOTA TANGERANG SELATAN, BANTEN",10,126,85,211
https://kawalpemilu.org#53214,"SAWAH, CIPUTAT, KOTA TANGERANG SELATAN, BANTEN",11,110,88,198
https://kawalpemilu.org#53214,"SAWAH, CIPUTAT, KOTA TANGERANG SELATAN, BANTEN",12,122,90,212
https://kawalpemilu.org#53214,"SAWAH, CIPUTAT, KOTA TANGERANG SELATAN, BANTEN",13,99,53,152
https://kawalpemilu.org#53214,"SAWAH, CIPUTAT, KOTA TANGERANG SELATAN, BANTEN",14,107,74,181
https://kawalpemilu.org#53214,"SAWAH, CIPUTAT, KOTA TANGERANG SELATAN, BANTEN",16,118,120,238
https://kawalpemilu.org#53214,"SAWAH, CIPUTAT, KOTA TANGERANG SELATAN, BANTEN",17,121,121,242
https://kawalpemilu.org#53214,"SAWAH, CIPUTAT, KOTA TANGERANG SELATAN, BANTEN",18,64,91,155
https://kawalpemilu.org#53214,"SAWAH, CIPUTAT, KOTA TANGERANG SELATAN, BANTEN",19,72,84,156
https://kawalpemilu.org#53214,"SAWAH, CIPUTAT, KOTA TANGERANG SELATAN, BANTEN",20,72,80,152
https://kawalpemilu.org#53214,"SAWAH, CIPUTAT, KOTA TANGERANG SELATAN, BANTEN",21,146,110,256
https://kawalpemilu.org#53214,"SAWAH, CIPUTAT, KOTA TANGERANG SELATAN, BANTEN",22,123,101,224
https://kawalpemilu.org#53214,"SAWAH, CIPUTAT, KOTA TANGERANG SELATAN, BANTEN",23,101,86,187
https://kawalpemilu.org#53214,"SAWAH, CIPUTAT, KOTA TANGERANG SELATAN, BANTEN",24,101,105,206
https://kawalpemilu.org#53214,"SAWAH, CIPUTAT, KOTA TANGERANG SELATAN, BANTEN",25,121,125,246
https://kawalpemilu.org#53214,"SAWAH, CIPUTAT, KOTA TANGERANG SELATAN, BANTEN",26,96,117,213
https://kawalpemilu.org#53214,"SAWAH, CIPUTAT, KOTA TANGERANG SELATAN, BANTEN",27,120,103,223
https://kawalpemilu.org#53214,"SAWAH, CIPUTAT, KOTA TANGERANG SELATAN, BANTEN",28,116,81,197
https://kawalpemilu.org#53214,"SAWAH, CIPUTAT, KOTA TANGERANG SELATAN, BANTEN",29,110,90,200
https://kawalpemilu.org#53214,"SAWAH, CIPUTAT, KOTA TANGERANG SELATAN, BANTEN",30,124,104,228
https://kawalpemilu.org#53214,"SAWAH, CIPUTAT, KOTA TANGERANG SELATAN, BANTEN",31,130,109,239
https://kawalpemilu.org#53214,"SAWAH, CIPUTAT, KOTA TANGERANG SELATAN, BANTEN",32,127,87,214
https://kawalpemilu.org#53214,"SAWAH, CIPUTAT, KOTA TANGERANG SELATAN, BANTEN",33,98,80,178
https://kawalpemilu.org#53214,"SAWAH, CIPUTAT, KOTA TANGERANG SELATAN, BANTEN",34,133,65,196
https://kawalpemilu.org#53214,"SAWAH, CIPUTAT, KOTA TANGERANG SELATAN, BANTEN",35,118,73,191
https://kawalpemilu.org#53214,"SAWAH, CIPUTAT, KOTA TANGERANG SELATAN, BANTEN",36,178,88,266
https://kawalpemilu.org#53214,"SAWAH, CIPUTAT, KOTA TANGERANG SELATAN, BANTEN",37,149,93,242
https://kawalpemilu.org#53214,"SAWAH, CIPUTAT, KOTA TANGERANG SELATAN, BANTEN",38,97,94,191
https://kawalpemilu.org#53214,"SAWAH, CIPUTAT, KOTA TANGERANG SELATAN, BANTEN",39,114,72,186
https://kawalpemilu.org#53214,"SAWAH, CIPUTAT, KOTA TANGERANG SELATAN, BANTEN",40,89,81,170
https://kawalpemilu.org#53214,"SAWAH, CIPUTAT, KOTA TANGERANG SELATAN, BANTEN",41,87,82,169
https://kawalpemilu.org#53214,"SAWAH, CIPUTAT, KOTA TANGERANG SELATAN, BANTEN",42,95,111,206
https://kawalpemilu.org#53214,"SAWAH, CIPUTAT, KOTA TANGERANG SELATAN, BANTEN",43,73,85,158
https://kawalpemilu.org#53214,"SAWAH, CIPUTAT, KOTA TANGERANG SELATAN, BANTEN",44,98,85,183
https://kawalpemilu.org#53214,"SAWAH, CIPUTAT, KOTA TANGERANG SELATAN, BANTEN",45,126,80,206
https://kawalpemilu.org#53214,"SAWAH, CIPUTAT, KOTA TANGERANG SELATAN, BANTEN",46,136,80,216
https://kawalpemilu.org#53214,"SAWAH, CIPUTAT, KOTA TANGERANG SELATAN, BANTEN",47,116,76,4
https://kawalpemilu.org#53214,"SAWAH, CIPUTAT, KOTA TANGERANG SELATAN, BANTEN",48,124,70,194
https://kawalpemilu.org#53214,"SAWAH, CIPUTAT, KOTA TANGERANG SELATAN, BANTEN",49,85,110,195
https://kawalpemilu.org#53214,"SAWAH, CIPUTAT, KOTA TANGERANG SELATAN, BANTEN",50,89,97,186
https://kawalpemilu.org#53214,"SAWAH, CIPUTAT, KOTA TANGERANG SELATAN, BANTEN",51,80,79,159
https://kawalpemilu.org#53214,"SAWAH, CIPUTAT, KOTA TANGERANG SELATAN, BANTEN",52,114,111,225
https://kawalpemilu.org#53214,"SAWAH, CIPUTAT, KOTA TANGERANG SELATAN, BANTEN",53,118,97,215
https://kawalpemilu.org#53214,"SAWAH, CIPUTAT, KOTA TANGERANG SELATAN, BANTEN",54,87,100,187
https://kawalpemilu.org#53214,"SAWAH, CIPUTAT, KOTA TANGERANG SELATAN, BANTEN",55,89,86,175
https://kawalpemilu.org#53214,"SAWAH, CIPUTAT, KOTA TANGERANG SELATAN, BANTEN",56,130,50,180
https://kawalpemilu.org#53214,"SAWAH, CIPUTAT, KOTA TANGERANG SELATAN, BANTEN",57,100,64,164
https://kawalpemilu.org#53214,"SAWAH, CIPUTAT, KOTA TANGERANG SELATAN, BANTEN",58,136,87,223
https://kawalpemilu.org#53214,"SAWAH, CIPUTAT, KOTA TANGERANG SELATAN, BANTEN",59,149,77,226
https://kawalpemilu.org#53214,"SAWAH, CIPUTAT, KOTA TANGERANG SELATAN, BANTEN",60,89,113,202
https://kawalpemilu.org#53214,"SAWAH, CIPUTAT, KOTA TANGERANG SELATAN, BANTEN",61,96,103,199
https://kawalpemilu.org#53214,"SAWAH, CIPUTAT, KOTA TANGERANG SELATAN, BANTEN",62,92,122,214
https://kawalpemilu.org#53214,"SAWAH, CIPUTAT, KOTA TANGERANG SELATAN, BANTEN",63,152,136,288
https://kawalpemilu.org#53214,"SAWAH, CIPUTAT, KOTA TANGERANG SELATAN, BANTEN",64,135,127,262
https://kawalpemilu.org#53214,"SAWAH, CIPUTAT, KOTA TANGERANG SELATAN, BANTEN",65,94,158,252
https://kawalpemilu.org#53214,"SAWAH, CIPUTAT, KOTA TANGERANG SELATAN, BANTEN",66,72,131,203
https://kawalpemilu.org#53214,"SAWAH, CIPUTAT, KOTA TANGERANG SELATAN, BANTEN",67,123,122,245
https://kawalpemilu.org#53214,"SAWAH, CIPUTAT, KOTA TANGERANG SELATAN, BANTEN",68,137,119,256
https://kawalpemilu.org#53214,"SAWAH, CIPUTAT, KOTA TANGERANG SELATAN, BANTEN",69,102,59,161
https://kawalpemilu.org#53214,"SAWAH, CIPUTAT, KOTA TANGERANG SELATAN, BANTEN",70,121,57,178
https://kawalpemilu.org#53214,"SAWAH, CIPUTAT, KOTA TANGERANG SELATAN, BANTEN",71,103,82,185
https://kawalpemilu.org#53214,"SAWAH, CIPUTAT, KOTA TANGERANG SELATAN, BANTEN",72,105,46,151
https://kawalpemilu.org#53214,"SAWAH, CIPUTAT, KOTA TANGERANG SELATAN, BANTEN",73,72,52,124
https://kawalpemilu.org#53214,"SAWAH, CIPUTAT, KOTA TANGERANG SELATAN, BANTEN",74,133,102,235
https://kawalpemilu.org#53214,"SAWAH, CIPUTAT, KOTA TANGERANG SELATAN, BANTEN",75,149,89,238
https://kawalpemilu.org#53214,"SAWAH, CIPUTAT, KOTA TANGERANG SELATAN, BANTEN",76,98,123,221
https://kawalpemilu.org#53214,"SAWAH, CIPUTAT, KOTA TANGERANG SELATAN, BANTEN",77,106,99,205
https://kawalpemilu.org#53214,"SAWAH, CIPUTAT, KOTA TANGERANG SELATAN, BANTEN",78,122,112,234
https://kawalpemilu.org#53214,"SAWAH, CIPUTAT, KOTA TANGERANG SELATAN, BANTEN",79,120,87,207
https://kawalpemilu.org#53214,"SAWAH, CIPUTAT, KOTA TANGERANG SELATAN, BANTEN",80,121,59,180
https://kawalpemilu.org#53214,"SAWAH, CIPUTAT, KOTA TANGERANG SELATAN, BANTEN",81,56,56,112
https://kawalpemilu.org#53214,"SAWAH, CIPUTAT, KOTA TANGERANG SELATAN, BANTEN",82,91,104,195
https://kawalpemilu.org#53214,"SAWAH, CIPUTAT, KOTA TANGERANG SELATAN, BANTEN",83,71,87,158
https://kawalpemilu.org#53214,"SAWAH, CIPUTAT, KOTA TANGERANG SELATAN, BANTEN",84,97,77,174
https://kawalpemilu.org#53214,"SAWAH, CIPUTAT, KOTA TANGERANG SELATAN, BANTEN",85,73,82,155
https://kawalpemilu.org#53214,"SAWAH, CIPUTAT, KOTA TANGERANG SELATAN, BANTEN",86,87,112,199
https://kawalpemilu.org#53214,"SAWAH, CIPUTAT, KOTA TANGERANG SELATAN, BANTEN",87,144,82,226
https://kawalpemilu.org#53214,"SAWAH, CIPUTAT, KOTA TANGERANG SELATAN, BANTEN",88,144,95,239
https://kawalpemilu.org#53214,"SAWAH, CIPUTAT, KOTA TANGERANG SELATAN, BANTEN",89,136,98,234
https://kawalpemilu.org#53214,"SAWAH, CIPUTAT, KOTA TANGERANG SELATAN, BANTEN",90,84,51,135
https://kawalpemilu.org#53215,"SERUA INDAH, CIPUTAT, KOTA TANGERANG SELATAN, BANTEN",1,84,116,200
https://kawalpemilu.org#53215,"SERUA INDAH, CIPUTAT, KOTA TANGERANG SELATAN, BANTEN",2,90,117,207
https://kawalpemilu.org#53215,"SERUA INDAH, CIPUTAT, KOTA TANGERANG SELATAN, BANTEN",3,81,140,221
https://kawalpemilu.org#53215,"SERUA INDAH, CIPUTAT, KOTA TANGERANG SELATAN, BANTEN",4,114,104,218
https://kawalpemilu.org#53215,"SERUA INDAH, CIPUTAT, KOTA TANGERANG SELATAN, BANTEN",5,77,69,146
https://kawalpemilu.org#53215,"SERUA INDAH, CIPUTAT, KOTA TANGERANG SELATAN, BANTEN",6,51,77,128
https://kawalpemilu.org#53215,"SERUA INDAH, CIPUTAT, KOTA TANGERANG SELATAN, BANTEN",7,112,106,218
https://kawalpemilu.org#53215,"SERUA INDAH, CIPUTAT, KOTA TANGERANG SELATAN, BANTEN",8,101,101,202
https://kawalpemilu.org#53215,"SERUA INDAH, CIPUTAT, KOTA TANGERANG SELATAN, BANTEN",9,139,105,244
https://kawalpemilu.org#53215,"SERUA INDAH, CIPUTAT, KOTA TANGERANG SELATAN, BANTEN",10,95,99,194
https://kawalpemilu.org#53215,"SERUA INDAH, CIPUTAT, KOTA TANGERANG SELATAN, BANTEN",11,119,110,229
https://kawalpemilu.org#53215,"SERUA INDAH, CIPUTAT, KOTA TANGERANG SELATAN, BANTEN",12,119,78,197
https://kawalpemilu.org#53215,"SERUA INDAH, CIPUTAT, KOTA TANGERANG SELATAN, BANTEN",13,106,67,173
https://kawalpemilu.org#53215,"SERUA INDAH, CIPUTAT, KOTA TANGERANG SELATAN, BANTEN",14,94,69,163
https://kawalpemilu.org#53215,"SERUA INDAH, CIPUTAT, KOTA TANGERANG SELATAN, BANTEN",15,110,77,187
https://kawalpemilu.org#53215,"SERUA INDAH, CIPUTAT, KOTA TANGERANG SELATAN, BANTEN",16,99,126,225
https://kawalpemilu.org#53215,"SERUA INDAH, CIPUTAT, KOTA TANGERANG SELATAN, BANTEN",17,103,153,256
https://kawalpemilu.org#53215,"SERUA INDAH, CIPUTAT, KOTA TANGERANG SELATAN, BANTEN",18,131,116,247
https://kawalpemilu.org#53215,"SERUA INDAH, CIPUTAT, KOTA TANGERANG SELATAN, BANTEN",19,70,122,192
https://kawalpemilu.org#53215,"SERUA INDAH, CIPUTAT, KOTA TANGERANG SELATAN, BANTEN",20,91,105,196
https://kawalpemilu.org#53215,"SERUA INDAH, CIPUTAT, KOTA TANGERANG SELATAN, BANTEN",21,144,91,235
https://kawalpemilu.org#53215,"SERUA INDAH, CIPUTAT, KOTA TANGERANG SELATAN, BANTEN",22,180,109,289
https://kawalpemilu.org#53215,"SERUA INDAH, CIPUTAT, KOTA TANGERANG SELATAN, BANTEN",23,129,88,217
https://kawalpemilu.org#53215,"SERUA INDAH, CIPUTAT, KOTA TANGERANG SELATAN, BANTEN",24,0,0,0
https://kawalpemilu.org#53215,"SERUA INDAH, CIPUTAT, KOTA TANGERANG SELATAN, BANTEN",25,89,107,196
https://kawalpemilu.org#53215,"SERUA INDAH, CIPUTAT, KOTA TANGERANG SELATAN, BANTEN",26,103,61,164
https://kawalpemilu.org#53215,"SERUA INDAH, CIPUTAT, KOTA TANGERANG SELATAN, BANTEN",27,136,108,244
https://kawalpemilu.org#53215,"SERUA INDAH, CIPUTAT, KOTA TANGERANG SELATAN, BANTEN",28,147,64,211
https://kawalpemilu.org#53215,"SERUA INDAH, CIPUTAT, KOTA TANGERANG SELATAN, BANTEN",29,116,101,217
https://kawalpemilu.org#53215,"SERUA INDAH, CIPUTAT, KOTA TANGERANG SELATAN, BANTEN",30,105,105,210
https://kawalpemilu.org#53215,"SERUA INDAH, CIPUTAT, KOTA TANGERANG SELATAN, BANTEN",31,65,95,160
https://kawalpemilu.org#53215,"SERUA INDAH, CIPUTAT, KOTA TANGERANG SELATAN, BANTEN",32,50,48,98
https://kawalpemilu.org#53215,"SERUA INDAH, CIPUTAT, KOTA TANGERANG SELATAN, BANTEN",33,55,116,171
https://kawalpemilu.org#53215,"SERUA INDAH, CIPUTAT, KOTA TANGERANG SELATAN, BANTEN",34,56,79,135
https://kawalpemilu.org#53215,"SERUA INDAH, CIPUTAT, KOTA TANGERANG SELATAN, BANTEN",35,124,128,252
https://kawalpemilu.org#53215,"SERUA INDAH, CIPUTAT, KOTA TANGERANG SELATAN, BANTEN",36,125,63,188
https://kawalpemilu.org#53215,"SERUA INDAH, CIPUTAT, KOTA TANGERANG SELATAN, BANTEN",37,101,96,197
https://kawalpemilu.org#53215,"SERUA INDAH, CIPUTAT, KOTA TANGERANG SELATAN, BANTEN",38,147,81,228
https://kawalpemilu.org#53215,"SERUA INDAH, CIPUTAT, KOTA TANGERANG SELATAN, BANTEN",39,123,113,236
https://kawalpemilu.org#53215,"SERUA INDAH, CIPUTAT, KOTA TANGERANG SELATAN, BANTEN",40,94,77,177
https://kawalpemilu.org#53215,"SERUA INDAH, CIPUTAT, KOTA TANGERANG SELATAN, BANTEN",41,94,72,166
https://kawalpemilu.org#53215,"SERUA INDAH, CIPUTAT, KOTA TANGERANG SELATAN, BANTEN",42,114,107,221
https://kawalpemilu.org#53215,"SERUA INDAH, CIPUTAT, KOTA TANGERANG SELATAN, BANTEN",43,107,75,182
https://kawalpemilu.org#53215,"SERUA INDAH, CIPUTAT, KOTA TANGERANG SELATAN, BANTEN",44,63,82,145
https://kawalpemilu.org#53215,"SERUA INDAH, CIPUTAT, KOTA TANGERANG SELATAN, BANTEN",45,89,64,153
https://kawalpemilu.org#53215,"SERUA INDAH, CIPUTAT, KOTA TANGERANG SELATAN, BANTEN",46,67,74,141
https://kawalpemilu.org#53215,"SERUA INDAH, CIPUTAT, KOTA TANGERANG SELATAN, BANTEN",47,102,144,246
https://kawalpemilu.org#53215,"SERUA INDAH, CIPUTAT, KOTA TANGERANG SELATAN, BANTEN",48,74,84,158
https://kawalpemilu.org#53215,"SERUA INDAH, CIPUTAT, KOTA TANGERANG SELATAN, BANTEN",49,104,68,172
https://kawalpemilu.org#53215,"SERUA INDAH, CIPUTAT, KOTA TANGERANG SELATAN, BANTEN",50,93,127,220
https://kawalpemilu.org#53215,"SERUA INDAH, CIPUTAT, KOTA TANGERANG SELATAN, BANTEN",51,92,121,213
https://kawalpemilu.org#53215,"SERUA INDAH, CIPUTAT, KOTA TANGERANG SELATAN, BANTEN",52,139,63,202
https://kawalpemilu.org#53215,"SERUA INDAH, CIPUTAT, KOTA TANGERANG SELATAN, BANTEN",53,57,106,163
https://kawalpemilu.org#53215,"SERUA INDAH, CIPUTAT, KOTA TANGERANG SELATAN, BANTEN",54,62,100,162
https://kawalpemilu.org#53215,"SERUA INDAH, CIPUTAT, KOTA TANGERANG SELATAN, BANTEN",55,51,103,154
https://kawalpemilu.org#53215,"SERUA INDAH, CIPUTAT, KOTA TANGERANG SELATAN, BANTEN",56,105,111,216
https://kawalpemilu.org#53215,"SERUA INDAH, CIPUTAT, KOTA TANGERANG SELATAN, BANTEN",57,65,103,168
https://kawalpemilu.org#53215,"SERUA INDAH, CIPUTAT, KOTA TANGERANG SELATAN, BANTEN",58,97,118,215
https://kawalpemilu.org#53215,"SERUA INDAH, CIPUTAT, KOTA TANGERANG SELATAN, BANTEN",59,67,86,153
https://kawalpemilu.org#53216,"JOMBANG, CIPUTAT, KOTA TANGERANG SELATAN, BANTEN",1,95,94,189
https://kawalpemilu.org#53216,"JOMBANG, CIPUTAT, KOTA TANGERANG SELATAN, BANTEN",2,113,91,204
https://kawalpemilu.org#53216,"JOMBANG, CIPUTAT, KOTA TANGERANG SELATAN, BANTEN",3,113,91,204
https://kawalpemilu.org#53216,"JOMBANG, CIPUTAT, KOTA TANGERANG SELATAN, BANTEN",4,100,129,229
https://kawalpemilu.org#53216,"JOMBANG, CIPUTAT, KOTA TANGERANG SELATAN, BANTEN",5,118,117,235
https://kawalpemilu.org#53216,"JOMBANG, CIPUTAT, KOTA TANGERANG SELATAN, BANTEN",6,112,157,269
https://kawalpemilu.org#53216,"JOMBANG, CIPUTAT, KOTA TANGERANG SELATAN, BANTEN",7,133,68,201
https://kawalpemilu.org#53216,"JOMBANG, CIPUTAT, KOTA TANGERANG SELATAN, BANTEN",8,141,88,229
https://kawalpemilu.org#53216,"JOMBANG, CIPUTAT, KOTA TANGERANG SELATAN, BANTEN",9,108,62,170
https://kawalpemilu.org#53216,"JOMBANG, CIPUTAT, KOTA TANGERANG SELATAN, BANTEN",10,76,92,168
https://kawalpemilu.org#53216,"JOMBANG, CIPUTAT, KOTA TANGERANG SELATAN, BANTEN",11,64,102,166
https://kawalpemilu.org#53216,"JOMBANG, CIPUTAT, KOTA TANGERANG SELATAN, BANTEN",12,94,87,181
https://kawalpemilu.org#53216,"JOMBANG, CIPUTAT, KOTA TANGERANG SELATAN, BANTEN",13,76,159,235
https://kawalpemilu.org#53216,"JOMBANG, CIPUTAT, KOTA TANGERANG SELATAN, BANTEN",14,103,89,191
https://kawalpemilu.org#53216,"JOMBANG, CIPUTAT, KOTA TANGERANG SELATAN, BANTEN",15,111,88,199
https://kawalpemilu.org#53216,"JOMBANG, CIPUTAT, KOTA TANGERANG SELATAN, BANTEN",16,109,109,218
https://kawalpemilu.org#53216,"JOMBANG, CIPUTAT, KOTA TANGERANG SELATAN, BANTEN",17,82,64,146
https://kawalpemilu.org#53216,"JOMBANG, CIPUTAT, KOTA TANGERANG SELATAN, BANTEN",18,60,97,157
https://kawalpemilu.org#53216,"JOMBANG, CIPUTAT, KOTA TANGERANG SELATAN, BANTEN",19,135,94,229
https://kawalpemilu.org#53216,"JOMBANG, CIPUTAT, KOTA TANGERANG SELATAN, BANTEN",20,109,95,204
https://kawalpemilu.org#53216,"JOMBANG, CIPUTAT, KOTA TANGERANG SELATAN, BANTEN",21,108,125,233
https://kawalpemilu.org#53216,"JOMBANG, CIPUTAT, KOTA TANGERANG SELATAN, BANTEN",22,155,111,266
https://kawalpemilu.org#53216,"JOMBANG, CIPUTAT, KOTA TANGERANG SELATAN, BANTEN",23,78,89,167
https://kawalpemilu.org#53216,"JOMBANG, CIPUTAT, KOTA TANGERANG SELATAN, BANTEN",24,121,84,205
https://kawalpemilu.org#53216,"JOMBANG, CIPUTAT, KOTA TANGERANG SELATAN, BANTEN",25,87,95,182
https://kawalpemilu.org#53216,"JOMBANG, CIPUTAT, KOTA TANGERANG SELATAN, BANTEN",26,143,100,243
https://kawalpemilu.org#53216,"JOMBANG, CIPUTAT, KOTA TANGERANG SELATAN, BANTEN",27,136,119,255
https://kawalpemilu.org#53216,"JOMBANG, CIPUTAT, KOTA TANGERANG SELATAN, BANTEN",29,122,74,196
https://kawalpemilu.org#53216,"JOMBANG, CIPUTAT, KOTA TANGERANG SELATAN, BANTEN",30,106,89,195
https://kawalpemilu.org#53216,"JOMBANG, CIPUTAT, KOTA TANGERANG SELATAN, BANTEN",31,90,41,131
https://kawalpemilu.org#53216,"JOMBANG, CIPUTAT, KOTA TANGERANG SELATAN, BANTEN",32,77,74,151
https://kawalpemilu.org#53216,"JOMBANG, CIPUTAT, KOTA TANGERANG SELATAN, BANTEN",33,88,59,147
https://kawalpemilu.org#53216,"JOMBANG, CIPUTAT, KOTA TANGERANG SELATAN, BANTEN",34,146,120,266
https://kawalpemilu.org#53216,"JOMBANG, CIPUTAT, KOTA TANGERANG SELATAN, BANTEN",35,149,80,229
https://kawalpemilu.org#53216,"JOMBANG, CIPUTAT, KOTA TANGERANG SELATAN, BANTEN",36,120,68,188
https://kawalpemilu.org#53216,"JOMBANG, CIPUTAT, KOTA TANGERANG SELATAN, BANTEN",37,100,72,172
https://kawalpemilu.org#53216,"JOMBANG, CIPUTAT, KOTA TANGERANG SELATAN, BANTEN",38,97,98,195
https://kawalpemilu.org#53216,"JOMBANG, CIPUTAT, KOTA TANGERANG SELATAN, BANTEN",39,95,76,171
https://kawalpemilu.org#53216,"JOMBANG, CIPUTAT, KOTA TANGERANG SELATAN, BANTEN",40,125,86,211
https://kawalpemilu.org#53216,"JOMBANG, CIPUTAT, KOTA TANGERANG SELATAN, BANTEN",41,94,112,206
https://kawalpemilu.org#53216,"JOMBANG, CIPUTAT, KOTA TANGERANG SELATAN, BANTEN",42,103,81,184
https://kawalpemilu.org#53216,"JOMBANG, CIPUTAT, KOTA TANGERANG SELATAN, BANTEN",43,108,70,178
https://kawalpemilu.org#53216,"JOMBANG, CIPUTAT, KOTA TANGERANG SELATAN, BANTEN",44,86,57,143
https://kawalpemilu.org#53216,"JOMBANG, CIPUTAT, KOTA TANGERANG SELATAN, BANTEN",45,150,99,249
https://kawalpemilu.org#53216,"JOMBANG, CIPUTAT, KOTA TANGERANG SELATAN, BANTEN",46,83,54,137
https://kawalpemilu.org#53216,"JOMBANG, CIPUTAT, KOTA TANGERANG SELATAN, BANTEN",47,82,35,117
https://kawalpemilu.org#53216,"JOMBANG, CIPUTAT, KOTA TANGERANG SELATAN, BANTEN",48,73,24,97
https://kawalpemilu.org#53216,"JOMBANG, CIPUTAT, KOTA TANGERANG SELATAN, BANTEN",49,70,40,110
https://kawalpemilu.org#53216,"JOMBANG, CIPUTAT, KOTA TANGERANG SELATAN, BANTEN",50,50,37,87
https://kawalpemilu.org#53216,"JOMBANG, CIPUTAT, KOTA TANGERANG SELATAN, BANTEN",51,69,66,135
https://kawalpemilu.org#53216,"JOMBANG, CIPUTAT, KOTA TANGERANG SELATAN, BANTEN",52,64,36,100
https://kawalpemilu.org#53216,"JOMBANG, CIPUTAT, KOTA TANGERANG SELATAN, BANTEN",53,66,35,101
https://kawalpemilu.org#53216,"JOMBANG, CIPUTAT, KOTA TANGERANG SELATAN, BANTEN",54,53,53,106
https://kawalpemilu.org#53216,"JOMBANG, CIPUTAT, KOTA TANGERANG SELATAN, BANTEN",55,69,72,141
https://kawalpemilu.org#53216,"JOMBANG, CIPUTAT, KOTA TANGERANG SELATAN, BANTEN",56,65,77,142
https://kawalpemilu.org#53216,"JOMBANG, CIPUTAT, KOTA TANGERANG SELATAN, BANTEN",57,76,48,124
https://kawalpemilu.org#53216,"JOMBANG, CIPUTAT, KOTA TANGERANG SELATAN, BANTEN",58,81,60,141
https://kawalpemilu.org#53216,"JOMBANG, CIPUTAT, KOTA TANGERANG SELATAN, BANTEN",59,121,95,216
https://kawalpemilu.org#53216,"JOMBANG, CIPUTAT, KOTA TANGERANG SELATAN, BANTEN",60,110,92,202
https://kawalpemilu.org#53216,"JOMBANG, CIPUTAT, KOTA TANGERANG SELATAN, BANTEN",61,123,120,243
https://kawalpemilu.org#53216,"JOMBANG, CIPUTAT, KOTA TANGERANG SELATAN, BANTEN",62,180,101,281
https://kawalpemilu.org#53216,"JOMBANG, CIPUTAT, KOTA TANGERANG SELATAN, BANTEN",63,109,139,247
https://kawalpemilu.org#53216,"JOMBANG, CIPUTAT, KOTA TANGERANG SELATAN, BANTEN",64,74,78,152
https://kawalpemilu.org#53216,"JOMBANG, CIPUTAT, KOTA TANGERANG SELATAN, BANTEN",65,65,56,121
https://kawalpemilu.org#53216,"JOMBANG, CIPUTAT, KOTA TANGERANG SELATAN, BANTEN",66,64,91,155
https://kawalpemilu.org#53216,"JOMBANG, CIPUTAT, KOTA TANGERANG SELATAN, BANTEN",67,73,73,146
https://kawalpemilu.org#53216,"JOMBANG, CIPUTAT, KOTA TANGERANG SELATAN, BANTEN",68,83,122,205
https://kawalpemilu.org#53216,"JOMBANG, CIPUTAT, KOTA TANGERANG SELATAN, BANTEN",69,89,133,222
https://kawalpemilu.org#53216,"JOMBANG, CIPUTAT, KOTA TANGERANG SELATAN, BANTEN",70,111,82,193
https://kawalpemilu.org#53216,"JOMBANG, CIPUTAT, KOTA TANGERANG SELATAN, BANTEN",71,116,68,184
https://kawalpemilu.org#53216,"JOMBANG, CIPUTAT, KOTA TANGERANG SELATAN, BANTEN",72,141,97,238
https://kawalpemilu.org#53216,"JOMBANG, CIPUTAT, KOTA TANGERANG SELATAN, BANTEN",73,157,120,277
https://kawalpemilu.org#53216,"JOMBANG, CIPUTAT, KOTA TANGERANG SELATAN, BANTEN",74,143,87,230
https://kawalpemilu.org#53216,"JOMBANG, CIPUTAT, KOTA TANGERANG SELATAN, BANTEN",75,113,115,228
https://kawalpemilu.org#53216,"JOMBANG, CIPUTAT, KOTA TANGERANG SELATAN, BANTEN",76,72,119,191
https://kawalpemilu.org#53216,"JOMBANG, CIPUTAT, KOTA TANGERANG SELATAN, BANTEN",77,47,105,152
https://kawalpemilu.org#53216,"JOMBANG, CIPUTAT, KOTA TANGERANG SELATAN, BANTEN",78,48,95,143
https://kawalpemilu.org#53216,"JOMBANG, CIPUTAT, KOTA TANGERANG SELATAN, BANTEN",79,95,104,199
https://kawalpemilu.org#53216,"JOMBANG, CIPUTAT, KOTA TANGERANG SELATAN, BANTEN",80,97,104,0
https://kawalpemilu.org#53216,"JOMBANG, CIPUTAT, KOTA TANGERANG SELATAN, BANTEN",81,144,93,237
https://kawalpemilu.org#53216,"JOMBANG, CIPUTAT, KOTA TANGERANG SELATAN, BANTEN",82,125,107,232
https://kawalpemilu.org#53216,"JOMBANG, CIPUTAT, KOTA TANGERANG SELATAN, BANTEN",84,105,111,216
https://kawalpemilu.org#53216,"JOMBANG, CIPUTAT, KOTA TANGERANG SELATAN, BANTEN",85,118,132,250
https://kawalpemilu.org#53216,"JOMBANG, CIPUTAT, KOTA TANGERANG SELATAN, BANTEN",86,104,115,219
https://kawalpemilu.org#53216,"JOMBANG, CIPUTAT, KOTA TANGERANG SELATAN, BANTEN",87,134,105,239
https://kawalpemilu.org#53216,"JOMBANG, CIPUTAT, KOTA TANGERANG SELATAN, BANTEN",88,111,130,241
https://kawalpemilu.org#53216,"JOMBANG, CIPUTAT, KOTA TANGERANG SELATAN, BANTEN",89,125,101,226
https://kawalpemilu.org#53216,"JOMBANG, CIPUTAT, KOTA TANGERANG SELATAN, BANTEN",90,93,69,162
https://kawalpemilu.org#53216,"JOMBANG, CIPUTAT, KOTA TANGERANG SELATAN, BANTEN",91,91,90,181
https://kawalpemilu.org#53216,"JOMBANG, CIPUTAT, KOTA TANGERANG SELATAN, BANTEN",92,126,126,252
https://kawalpemilu.org#53216,"JOMBANG, CIPUTAT, KOTA TANGERANG SELATAN, BANTEN",93,113,84,197
https://kawalpemilu.org#53216,"JOMBANG, CIPUTAT, KOTA TANGERANG SELATAN, BANTEN",94,103,92,195
https://kawalpemilu.org#53216,"JOMBANG, CIPUTAT, KOTA TANGERANG SELATAN, BANTEN",95,99,128,227
https://kawalpemilu.org#53216,"JOMBANG, CIPUTAT, KOTA TANGERANG SELATAN, BANTEN",96,129,100,229
https://kawalpemilu.org#53216,"JOMBANG, CIPUTAT, KOTA TANGERANG SELATAN, BANTEN",97,104,124,228
https://kawalpemilu.org#53216,"JOMBANG, CIPUTAT, KOTA TANGERANG SELATAN, BANTEN",98,100,115,215
https://kawalpemilu.org#53216,"JOMBANG, CIPUTAT, KOTA TANGERANG SELATAN, BANTEN",99,54,136,190
https://kawalpemilu.org#53216,"JOMBANG, CIPUTAT, KOTA TANGERANG SELATAN, BANTEN",100,94,130,224
https://kawalpemilu.org#53216,"JOMBANG, CIPUTAT, KOTA TANGERANG SELATAN, BANTEN",102,97,124,221
https://kawalpemilu.org#53216,"JOMBANG, CIPUTAT, KOTA TANGERANG SELATAN, BANTEN",103,91,133,224
https://kawalpemilu.org#53216,"JOMBANG, CIPUTAT, KOTA TANGERANG SELATAN, BANTEN",104,93,115,208
https://kawalpemilu.org#53216,"JOMBANG, CIPUTAT, KOTA TANGERANG SELATAN, BANTEN",105,106,95,201
https://kawalpemilu.org#53216,"JOMBANG, CIPUTAT, KOTA TANGERANG SELATAN, BANTEN",106,81,122,203
https://kawalpemilu.org#53216,"JOMBANG, CIPUTAT, KOTA TANGERANG SELATAN, BANTEN",107,99,149,248
https://kawalpemilu.org#53216,"JOMBANG, CIPUTAT, KOTA TANGERANG SELATAN, BANTEN",108,111,84,195
https://kawalpemilu.org#53216,"JOMBANG, CIPUTAT, KOTA TANGERANG SELATAN, BANTEN",109,108,77,185
https://kawalpemilu.org#53216,"JOMBANG, CIPUTAT, KOTA TANGERANG SELATAN, BANTEN",110,127,105,232
https://kawalpemilu.org#53216,"JOMBANG, CIPUTAT, KOTA TANGERANG SELATAN, BANTEN",111,104,105,209
https://kawalpemilu.org#53216,"JOMBANG, CIPUTAT, KOTA TANGERANG SELATAN, BANTEN",112,103,122,225
https://kawalpemilu.org#53216,"JOMBANG, CIPUTAT, KOTA TANGERANG SELATAN, BANTEN",113,113,98,211
https://kawalpemilu.org#53216,"JOMBANG, CIPUTAT, KOTA TANGERANG SELATAN, BANTEN",116,95,81,176
https://kawalpemilu.org#53216,"JOMBANG, CIPUTAT, KOTA TANGERANG SELATAN, BANTEN",117,147,119,266
https://kawalpemilu.org#53216,"JOMBANG, CIPUTAT, KOTA TANGERANG SELATAN, BANTEN",118,155,107,262
https://kawalpemilu.org#53217,"CIPAYUNG, CIPUTAT, KOTA TANGERANG SELATAN, BANTEN",1,38,43,154
https://kawalpemilu.org#53217,"CIPAYUNG, CIPUTAT, KOTA TANGERANG SELATAN, BANTEN",2,65,81,146
https://kawalpemilu.org#53217,"CIPAYUNG, CIPUTAT, KOTA TANGERANG SELATAN, BANTEN",3,41,85,126
https://kawalpemilu.org#53217,"CIPAYUNG, CIPUTAT, KOTA TANGERANG SELATAN, BANTEN",4,113,89,202
https://kawalpemilu.org#53217,"CIPAYUNG, CIPUTAT, KOTA TANGERANG SELATAN, BANTEN",5,97,105,202
https://kawalpemilu.org#53217,"CIPAYUNG, CIPUTAT, KOTA TANGERANG SELATAN, BANTEN",6,89,128,217
https://kawalpemilu.org#53217,"CIPAYUNG, CIPUTAT, KOTA TANGERANG SELATAN, BANTEN",7,71,134,205
https://kawalpemilu.org#53217,"CIPAYUNG, CIPUTAT, KOTA TANGERANG SELATAN, BANTEN",8,102,138,240
https://kawalpemilu.org#53217,"CIPAYUNG, CIPUTAT, KOTA TANGERANG SELATAN, BANTEN",9,83,156,239
https://kawalpemilu.org#53217,"CIPAYUNG, CIPUTAT, KOTA TANGERANG SELATAN, BANTEN",10,88,131,219
https://kawalpemilu.org#53217,"CIPAYUNG, CIPUTAT, KOTA TANGERANG SELATAN, BANTEN",11,100,130,230
https://kawalpemilu.org#53217,"CIPAYUNG, CIPUTAT, KOTA TANGERANG SELATAN, BANTEN",12,63,94,157
https://kawalpemilu.org#53217,"CIPAYUNG, CIPUTAT, KOTA TANGERANG SELATAN, BANTEN",13,62,69,131
https://kawalpemilu.org#53217,"CIPAYUNG, CIPUTAT, KOTA TANGERANG SELATAN, BANTEN",14,98,145,243
https://kawalpemilu.org#53217,"CIPAYUNG, CIPUTAT, KOTA TANGERANG SELATAN, BANTEN",15,63,96,159
https://kawalpemilu.org#53217,"CIPAYUNG, CIPUTAT, KOTA TANGERANG SELATAN, BANTEN",16,65,70,135
https://kawalpemilu.org#53217,"CIPAYUNG, CIPUTAT, KOTA TANGERANG SELATAN, BANTEN",17,45,98,143
https://kawalpemilu.org#53217,"CIPAYUNG, CIPUTAT, KOTA TANGERANG SELATAN, BANTEN",18,45,94,139
https://kawalpemilu.org#53217,"CIPAYUNG, CIPUTAT, KOTA TANGERANG SELATAN, BANTEN",19,64,91,155
https://kawalpemilu.org#53217,"CIPAYUNG, CIPUTAT, KOTA TANGERANG SELATAN, BANTEN",20,46,91,137
https://kawalpemilu.org#53217,"CIPAYUNG, CIPUTAT, KOTA TANGERANG SELATAN, BANTEN",21,36,97,133
https://kawalpemilu.org#53217,"CIPAYUNG, CIPUTAT, KOTA TANGERANG SELATAN, BANTEN",22,25,60,85
https://kawalpemilu.org#53217,"CIPAYUNG, CIPUTAT, KOTA TANGERANG SELATAN, BANTEN",23,72,112,184
https://kawalpemilu.org#53217,"CIPAYUNG, CIPUTAT, KOTA TANGERANG SELATAN, BANTEN",24,106,159,265
https://kawalpemilu.org#53217,"CIPAYUNG, CIPUTAT, KOTA TANGERANG SELATAN, BANTEN",25,75,192,267
https://kawalpemilu.org#53217,"CIPAYUNG, CIPUTAT, KOTA TANGERANG SELATAN, BANTEN",26,81,178,259
https://kawalpemilu.org#53217,"CIPAYUNG, CIPUTAT, KOTA TANGERANG SELATAN, BANTEN",27,72,87,159
https://kawalpemilu.org#53217,"CIPAYUNG, CIPUTAT, KOTA TANGERANG SELATAN, BANTEN",28,68,94,162
https://kawalpemilu.org#53217,"CIPAYUNG, CIPUTAT, KOTA TANGERANG SELATAN, BANTEN",29,39,94,133
https://kawalpemilu.org#53217,"CIPAYUNG, CIPUTAT, KOTA TANGERANG SELATAN, BANTEN",30,59,156,215
https://kawalpemilu.org#53217,"CIPAYUNG, CIPUTAT, KOTA TANGERANG SELATAN, BANTEN",31,55,140,195
https://kawalpemilu.org#53217,"CIPAYUNG, CIPUTAT, KOTA TANGERANG SELATAN, BANTEN",32,139,120,259
https://kawalpemilu.org#53217,"CIPAYUNG, CIPUTAT, KOTA TANGERANG SELATAN, BANTEN",33,103,98,201
https://kawalpemilu.org#53217,"CIPAYUNG, CIPUTAT, KOTA TANGERANG SELATAN, BANTEN",34,125,125,250
https://kawalpemilu.org#53217,"CIPAYUNG, CIPUTAT, KOTA TANGERANG SELATAN, BANTEN",35,91,103,194
https://kawalpemilu.org#53217,"CIPAYUNG, CIPUTAT, KOTA TANGERANG SELATAN, BANTEN",36,77,95,172
https://kawalpemilu.org#53217,"CIPAYUNG, CIPUTAT, KOTA TANGERANG SELATAN, BANTEN",37,97,103,200
https://kawalpemilu.org#53217,"CIPAYUNG, CIPUTAT, KOTA TANGERANG SELATAN, BANTEN",38,115,92,207
https://kawalpemilu.org#53217,"CIPAYUNG, CIPUTAT, KOTA TANGERANG SELATAN, BANTEN",39,113,101,214
https://kawalpemilu.org#53217,"CIPAYUNG, CIPUTAT, KOTA TANGERANG SELATAN, BANTEN",40,94,93,187
https://kawalpemilu.org#53217,"CIPAYUNG, CIPUTAT, KOTA TANGERANG SELATAN, BANTEN",41,99,163,262
https://kawalpemilu.org#53217,"CIPAYUNG, CIPUTAT, KOTA TANGERANG SELATAN, BANTEN",42,72,159,231
https://kawalpemilu.org#53217,"CIPAYUNG, CIPUTAT, KOTA TANGERANG SELATAN, BANTEN",43,77,152,229
https://kawalpemilu.org#53217,"CIPAYUNG, CIPUTAT, KOTA TANGERANG SELATAN, BANTEN",44,108,116,224
https://kawalpemilu.org#53217,"CIPAYUNG, CIPUTAT, KOTA TANGERANG SELATAN, BANTEN",45,87,109,196
https://kawalpemilu.org#53217,"CIPAYUNG, CIPUTAT, KOTA TANGERANG SELATAN, BANTEN",46,103,152,255
https://kawalpemilu.org#53217,"CIPAYUNG, CIPUTAT, KOTA TANGERANG SELATAN, BANTEN",47,79,107,186
https://kawalpemilu.org#53217,"CIPAYUNG, CIPUTAT, KOTA TANGERANG SELATAN, BANTEN",48,96,141,237
https://kawalpemilu.org#53217,"CIPAYUNG, CIPUTAT, KOTA TANGERANG SELATAN, BANTEN",49,95,121,216
https://kawalpemilu.org#53217,"CIPAYUNG, CIPUTAT, KOTA TANGERANG SELATAN, BANTEN",50,57,153,210
https://kawalpemilu.org#53217,"CIPAYUNG, CIPUTAT, KOTA TANGERANG SELATAN, BANTEN",51,42,93,135
https://kawalpemilu.org#53217,"CIPAYUNG, CIPUTAT, KOTA TANGERANG SELATAN, BANTEN",52,90,129,219
https://kawalpemilu.org#53217,"CIPAYUNG, CIPUTAT, KOTA TANGERANG SELATAN, BANTEN",53,80,107,187
https://kawalpemilu.org#53217,"CIPAYUNG, CIPUTAT, KOTA TANGERANG SELATAN, BANTEN",54,41,98,139
https://kawalpemilu.org#53217,"CIPAYUNG, CIPUTAT, KOTA TANGERANG SELATAN, BANTEN",55,59,136,195
https://kawalpemilu.org#53217,"CIPAYUNG, CIPUTAT, KOTA TANGERANG SELATAN, BANTEN",56,63,114,177
https://kawalpemilu.org#53217,"CIPAYUNG, CIPUTAT, KOTA TANGERANG SELATAN, BANTEN",57,73,82,155
https://kawalpemilu.org#53217,"CIPAYUNG, CIPUTAT, KOTA TANGERANG SELATAN, BANTEN",58,63,71,134
https://kawalpemilu.org#53217,"CIPAYUNG, CIPUTAT, KOTA TANGERANG SELATAN, BANTEN",59,123,99,222
https://kawalpemilu.org#53217,"CIPAYUNG, CIPUTAT, KOTA TANGERANG SELATAN, BANTEN",60,82,102,184
https://kawalpemilu.org#53217,"CIPAYUNG, CIPUTAT, KOTA TANGERANG SELATAN, BANTEN",61,86,101,187
https://kawalpemilu.org#53217,"CIPAYUNG, CIPUTAT, KOTA TANGERANG SELATAN, BANTEN",62,119,86,205
https://kawalpemilu.org#53217,"CIPAYUNG, CIPUTAT, KOTA TANGERANG SELATAN, BANTEN",63,80,52,132
https://kawalpemilu.org#53217,"CIPAYUNG, CIPUTAT, KOTA TANGERANG SELATAN, BANTEN",64,86,114,200
https://kawalpemilu.org#53217,"CIPAYUNG, CIPUTAT, KOTA TANGERANG SELATAN, BANTEN",65,111,82,193
https://kawalpemilu.org#53217,"CIPAYUNG, CIPUTAT, KOTA TANGERANG SELATAN, BANTEN",66,108,129,237
https://kawalpemilu.org#53217,"CIPAYUNG, CIPUTAT, KOTA TANGERANG SELATAN, BANTEN",67,128,120,248
https://kawalpemilu.org#53217,"CIPAYUNG, CIPUTAT, KOTA TANGERANG SELATAN, BANTEN",68,119,160,279
https://kawalpemilu.org#53217,"CIPAYUNG, CIPUTAT, KOTA TANGERANG SELATAN, BANTEN",69,66,90,156
https://kawalpemilu.org#53217,"CIPAYUNG, CIPUTAT, KOTA TANGERANG SELATAN, BANTEN",70,67,79,146
https://kawalpemilu.org#53217,"CIPAYUNG, CIPUTAT, KOTA TANGERANG SELATAN, BANTEN",71,109,146,255
https://kawalpemilu.org#53217,"CIPAYUNG, CIPUTAT, KOTA TANGERANG SELATAN, BANTEN",72,115,128,243
https://kawalpemilu.org#53217,"CIPAYUNG, CIPUTAT, KOTA TANGERANG SELATAN, BANTEN",73,119,103,222
https://kawalpemilu.org#53217,"CIPAYUNG, CIPUTAT, KOTA TANGERANG SELATAN, BANTEN",74,146,93,239
https://kawalpemilu.org#53217,"CIPAYUNG, CIPUTAT, KOTA TANGERANG SELATAN, BANTEN",75,89,90,179
https://kawalpemilu.org#53217,"CIPAYUNG, CIPUTAT, KOTA TANGERANG SELATAN, BANTEN",76,70,109,179
https://kawalpemilu.org#53217,"CIPAYUNG, CIPUTAT, KOTA TANGERANG SELATAN, BANTEN",77,88,129,217
https://kawalpemilu.org#53217,"CIPAYUNG, CIPUTAT, KOTA TANGERANG SELATAN, BANTEN",78,96,118,214
https://kawalpemilu.org#53217,"CIPAYUNG, CIPUTAT, KOTA TANGERANG SELATAN, BANTEN",79,77,151,228
https://kawalpemilu.org#53217,"CIPAYUNG, CIPUTAT, KOTA TANGERANG SELATAN, BANTEN",80,111,67,178
https://kawalpemilu.org#53219,"CEMPAKA PUTIH, CIPUTAT TIMUR, KOTA TANGERANG SELATAN, BANTEN",1,99,130,229
https://kawalpemilu.org#53219,"CEMPAKA PUTIH, CIPUTAT TIMUR, KOTA TANGERANG SELATAN, BANTEN",2,76,132,208
https://kawalpemilu.org#53219,"CEMPAKA PUTIH, CIPUTAT TIMUR, KOTA TANGERANG SELATAN, BANTEN",3,95,116,211
https://kawalpemilu.org#53219,"CEMPAKA PUTIH, CIPUTAT TIMUR, KOTA TANGERANG SELATAN, BANTEN",4,91,115,206
https://kawalpemilu.org#53219,"CEMPAKA PUTIH, CIPUTAT TIMUR, KOTA TANGERANG SELATAN, BANTEN",5,85,155,240
https://kawalpemilu.org#53219,"CEMPAKA PUTIH, CIPUTAT TIMUR, KOTA TANGERANG SELATAN, BANTEN",6,64,137,201
https://kawalpemilu.org#53219,"CEMPAKA PUTIH, CIPUTAT TIMUR, KOTA TANGERANG SELATAN, BANTEN",7,61,103,164
https://kawalpemilu.org#53219,"CEMPAKA PUTIH, CIPUTAT TIMUR, KOTA TANGERANG SELATAN, BANTEN",8,68,90,158
https://kawalpemilu.org#53219,"CEMPAKA PUTIH, CIPUTAT TIMUR, KOTA TANGERANG SELATAN, BANTEN",9,158,59,217
https://kawalpemilu.org#53219,"CEMPAKA PUTIH, CIPUTAT TIMUR, KOTA TANGERANG SELATAN, BANTEN",10,98,64,162
https://kawalpemilu.org#53219,"CEMPAKA PUTIH, CIPUTAT TIMUR, KOTA TANGERANG SELATAN, BANTEN",11,73,110,183
https://kawalpemilu.org#53219,"CEMPAKA PUTIH, CIPUTAT TIMUR, KOTA TANGERANG SELATAN, BANTEN",12,83,122,205
https://kawalpemilu.org#53219,"CEMPAKA PUTIH, CIPUTAT TIMUR, KOTA TANGERANG SELATAN, BANTEN",13,52,72,124
https://kawalpemilu.org#53219,"CEMPAKA PUTIH, CIPUTAT TIMUR, KOTA TANGERANG SELATAN, BANTEN",14,58,88,146
https://kawalpemilu.org#53219,"CEMPAKA PUTIH, CIPUTAT TIMUR, KOTA TANGERANG SELATAN, BANTEN",15,77,102,179
https://kawalpemilu.org#53219,"CEMPAKA PUTIH, CIPUTAT TIMUR, KOTA TANGERANG SELATAN, BANTEN",16,78,119,197
https://kawalpemilu.org#53219,"CEMPAKA PUTIH, CIPUTAT TIMUR, KOTA TANGERANG SELATAN, BANTEN",17,90,154,244
https://kawalpemilu.org#53219,"CEMPAKA PUTIH, CIPUTAT TIMUR, KOTA TANGERANG SELATAN, BANTEN",18,56,114,170
https://kawalpemilu.org#53219,"CEMPAKA PUTIH, CIPUTAT TIMUR, KOTA TANGERANG SELATAN, BANTEN",19,73,101,174
https://kawalpemilu.org#53219,"CEMPAKA PUTIH, CIPUTAT TIMUR, KOTA TANGERANG SELATAN, BANTEN",20,98,117,215
https://kawalpemilu.org#53219,"CEMPAKA PUTIH, CIPUTAT TIMUR, KOTA TANGERANG SELATAN, BANTEN",21,80,116,196
https://kawalpemilu.org#53219,"CEMPAKA PUTIH, CIPUTAT TIMUR, KOTA TANGERANG SELATAN, BANTEN",22,81,140,221
https://kawalpemilu.org#53219,"CEMPAKA PUTIH, CIPUTAT TIMUR, KOTA TANGERANG SELATAN, BANTEN",23,83,155,238
https://kawalpemilu.org#53219,"CEMPAKA PUTIH, CIPUTAT TIMUR, KOTA TANGERANG SELATAN, BANTEN",24,67,133,200
https://kawalpemilu.org#53219,"CEMPAKA PUTIH, CIPUTAT TIMUR, KOTA TANGERANG SELATAN, BANTEN",25,77,97,174
https://kawalpemilu.org#53219,"CEMPAKA PUTIH, CIPUTAT TIMUR, KOTA TANGERANG SELATAN, BANTEN",26,83,97,180
https://kawalpemilu.org#53219,"CEMPAKA PUTIH, CIPUTAT TIMUR, KOTA TANGERANG SELATAN, BANTEN",27,62,131,193
https://kawalpemilu.org#53219,"CEMPAKA PUTIH, CIPUTAT TIMUR, KOTA TANGERANG SELATAN, BANTEN",28,73,131,204
https://kawalpemilu.org#53219,"CEMPAKA PUTIH, CIPUTAT TIMUR, KOTA TANGERANG SELATAN, BANTEN",29,56,145,201
https://kawalpemilu.org#53219,"CEMPAKA PUTIH, CIPUTAT TIMUR, KOTA TANGERANG SELATAN, BANTEN",30,79,118,197
https://kawalpemilu.org#53219,"CEMPAKA PUTIH, CIPUTAT TIMUR, KOTA TANGERANG SELATAN, BANTEN",31,122,105,227
https://kawalpemilu.org#53219,"CEMPAKA PUTIH, CIPUTAT TIMUR, KOTA TANGERANG SELATAN, BANTEN",32,147,100,247
https://kawalpemilu.org#53219,"CEMPAKA PUTIH, CIPUTAT TIMUR, KOTA TANGERANG SELATAN, BANTEN",33,97,78,175
https://kawalpemilu.org#53219,"CEMPAKA PUTIH, CIPUTAT TIMUR, KOTA TANGERANG SELATAN, BANTEN",34,86,96,182
https://kawalpemilu.org#53219,"CEMPAKA PUTIH, CIPUTAT TIMUR, KOTA TANGERANG SELATAN, BANTEN",35,57,190,247
https://kawalpemilu.org#53219,"CEMPAKA PUTIH, CIPUTAT TIMUR, KOTA TANGERANG SELATAN, BANTEN",36,58,165,223
https://kawalpemilu.org#53219,"CEMPAKA PUTIH, CIPUTAT TIMUR, KOTA TANGERANG SELATAN, BANTEN",37,75,101,176
https://kawalpemilu.org#53219,"CEMPAKA PUTIH, CIPUTAT TIMUR, KOTA TANGERANG SELATAN, BANTEN",38,85,128,213
https://kawalpemilu.org#53219,"CEMPAKA PUTIH, CIPUTAT TIMUR, KOTA TANGERANG SELATAN, BANTEN",39,91,128,219
https://kawalpemilu.org#53219,"CEMPAKA PUTIH, CIPUTAT TIMUR, KOTA TANGERANG SELATAN, BANTEN",40,94,98,192
https://kawalpemilu.org#53219,"CEMPAKA PUTIH, CIPUTAT TIMUR, KOTA TANGERANG SELATAN, BANTEN",41,83,104,187
https://kawalpemilu.org#53219,"CEMPAKA PUTIH, CIPUTAT TIMUR, KOTA TANGERANG SELATAN, BANTEN",42,61,97,158
https://kawalpemilu.org#53219,"CEMPAKA PUTIH, CIPUTAT TIMUR, KOTA TANGERANG SELATAN, BANTEN",43,74,68,142
https://kawalpemilu.org#53219,"CEMPAKA PUTIH, CIPUTAT TIMUR, KOTA TANGERANG SELATAN, BANTEN",44,45,83,128
https://kawalpemilu.org#53219,"CEMPAKA PUTIH, CIPUTAT TIMUR, KOTA TANGERANG SELATAN, BANTEN",45,165,85,250
https://kawalpemilu.org#53219,"CEMPAKA PUTIH, CIPUTAT TIMUR, KOTA TANGERANG SELATAN, BANTEN",46,163,81,244
https://kawalpemilu.org#53219,"CEMPAKA PUTIH, CIPUTAT TIMUR, KOTA TANGERANG SELATAN, BANTEN",47,81,51,132
https://kawalpemilu.org#53219,"CEMPAKA PUTIH, CIPUTAT TIMUR, KOTA TANGERANG SELATAN, BANTEN",48,44,50,94
https://kawalpemilu.org#53219,"CEMPAKA PUTIH, CIPUTAT TIMUR, KOTA TANGERANG SELATAN, BANTEN",49,69,43,112
https://kawalpemilu.org#53219,"CEMPAKA PUTIH, CIPUTAT TIMUR, KOTA TANGERANG SELATAN, BANTEN",50,88,32,120
https://kawalpemilu.org#53219,"CEMPAKA PUTIH, CIPUTAT TIMUR, KOTA TANGERANG SELATAN, BANTEN",51,128,92,220
https://kawalpemilu.org#53219,"CEMPAKA PUTIH, CIPUTAT TIMUR, KOTA TANGERANG SELATAN, BANTEN",52,153,68,221
https://kawalpemilu.org#53219,"CEMPAKA PUTIH, CIPUTAT TIMUR, KOTA TANGERANG SELATAN, BANTEN",53,117,129,246
https://kawalpemilu.org#53219,"CEMPAKA PUTIH, CIPUTAT TIMUR, KOTA TANGERANG SELATAN, BANTEN",54,120,107,227
https://kawalpemilu.org#53219,"CEMPAKA PUTIH, CIPUTAT TIMUR, KOTA TANGERANG SELATAN, BANTEN",55,114,135,249
https://kawalpemilu.org#53219,"CEMPAKA PUTIH, CIPUTAT TIMUR, KOTA TANGERANG SELATAN, BANTEN",56,109,109,218
https://kawalpemilu.org#53219,"CEMPAKA PUTIH, CIPUTAT TIMUR, KOTA TANGERANG SELATAN, BANTEN",57,89,91,180
https://kawalpemilu.org#53219,"CEMPAKA PUTIH, CIPUTAT TIMUR, KOTA TANGERANG SELATAN, BANTEN",58,89,92,181
https://kawalpemilu.org#53219,"CEMPAKA PUTIH, CIPUTAT TIMUR, KOTA TANGERANG SELATAN, BANTEN",59,97,70,167
https://kawalpemilu.org#53219,"CEMPAKA PUTIH, CIPUTAT TIMUR, KOTA TANGERANG SELATAN, BANTEN",60,67,87,154
https://kawalpemilu.org#53219,"CEMPAKA PUTIH, CIPUTAT TIMUR, KOTA TANGERANG SELATAN, BANTEN",61,97,81,178
https://kawalpemilu.org#53219,"CEMPAKA PUTIH, CIPUTAT TIMUR, KOTA TANGERANG SELATAN, BANTEN",62,81,61,142
https://kawalpemilu.org#53219,"CEMPAKA PUTIH, CIPUTAT TIMUR, KOTA TANGERANG SELATAN, BANTEN",63,80,71,151
https://kawalpemilu.org#53219,"CEMPAKA PUTIH, CIPUTAT TIMUR, KOTA TANGERANG SELATAN, BANTEN",64,76,93,169
https://kawalpemilu.org#53219,"CEMPAKA PUTIH, CIPUTAT TIMUR, KOTA TANGERANG SELATAN, BANTEN",65,132,98,230
https://kawalpemilu.org#53219,"CEMPAKA PUTIH, CIPUTAT TIMUR, KOTA TANGERANG SELATAN, BANTEN",66,139,112,251
https://kawalpemilu.org#53219,"CEMPAKA PUTIH, CIPUTAT TIMUR, KOTA TANGERANG SELATAN, BANTEN",67,164,91,255
https://kawalpemilu.org#53219,"CEMPAKA PUTIH, CIPUTAT TIMUR, KOTA TANGERANG SELATAN, BANTEN",68,110,68,178
https://kawalpemilu.org#53219,"CEMPAKA PUTIH, CIPUTAT TIMUR, KOTA TANGERANG SELATAN, BANTEN",69,103,115,218
https://kawalpemilu.org#53219,"CEMPAKA PUTIH, CIPUTAT TIMUR, KOTA TANGERANG SELATAN, BANTEN",70,117,86,203
https://kawalpemilu.org#53219,"CEMPAKA PUTIH, CIPUTAT TIMUR, KOTA TANGERANG SELATAN, BANTEN",71,128,134,262
https://kawalpemilu.org#53219,"CEMPAKA PUTIH, CIPUTAT TIMUR, KOTA TANGERANG SELATAN, BANTEN",72,121,131,252
https://kawalpemilu.org#53219,"CEMPAKA PUTIH, CIPUTAT TIMUR, KOTA TANGERANG SELATAN, BANTEN",73,132,130,262
https://kawalpemilu.org#53219,"CEMPAKA PUTIH, CIPUTAT TIMUR, KOTA TANGERANG SELATAN, BANTEN",74,94,166,260
https://kawalpemilu.org#53219,"CEMPAKA PUTIH, CIPUTAT TIMUR, KOTA TANGERANG SELATAN, BANTEN",75,93,157,250
https://kawalpemilu.org#53219,"CEMPAKA PUTIH, CIPUTAT TIMUR, KOTA TANGERANG SELATAN, BANTEN",76,97,150,247
https://kawalpemilu.org#53219,"CEMPAKA PUTIH, CIPUTAT TIMUR, KOTA TANGERANG SELATAN, BANTEN",77,113,71,184
https://kawalpemilu.org#53219,"CEMPAKA PUTIH, CIPUTAT TIMUR, KOTA TANGERANG SELATAN, BANTEN",78,101,79,180
https://kawalpemilu.org#53219,"CEMPAKA PUTIH, CIPUTAT TIMUR, KOTA TANGERANG SELATAN, BANTEN",79,132,87,219
https://kawalpemilu.org#53220,"PONDOK RANJI, CIPUTAT TIMUR, KOTA TANGERANG SELATAN, BANTEN",1,92,89,181
https://kawalpemilu.org#53220,"PONDOK RANJI, CIPUTAT TIMUR, KOTA TANGERANG SELATAN, BANTEN",2,107,83,190
https://kawalpemilu.org#53220,"PONDOK RANJI, CIPUTAT TIMUR, KOTA TANGERANG SELATAN, BANTEN",3,160,86,246
https://kawalpemilu.org#53220,"PONDOK RANJI, CIPUTAT TIMUR, KOTA TANGERANG SELATAN, BANTEN",4,133,67,200
https://kawalpemilu.org#53220,"PONDOK RANJI, CIPUTAT TIMUR, KOTA TANGERANG SELATAN, BANTEN",5,138,70,208
https://kawalpemilu.org#53220,"PONDOK RANJI, CIPUTAT TIMUR, KOTA TANGERANG SELATAN, BANTEN",6,103,90,193
https://kawalpemilu.org#53220,"PONDOK RANJI, CIPUTAT TIMUR, KOTA TANGERANG SELATAN, BANTEN",7,161,92,253
https://kawalpemilu.org#53220,"PONDOK RANJI, CIPUTAT TIMUR, KOTA TANGERANG SELATAN, BANTEN",8,105,24,129
https://kawalpemilu.org#53220,"PONDOK RANJI, CIPUTAT TIMUR, KOTA TANGERANG SELATAN, BANTEN",9,153,140,293
https://kawalpemilu.org#53220,"PONDOK RANJI, CIPUTAT TIMUR, KOTA TANGERANG SELATAN, BANTEN",10,87,69,156
https://kawalpemilu.org#53220,"PONDOK RANJI, CIPUTAT TIMUR, KOTA TANGERANG SELATAN, BANTEN",11,110,86,196
https://kawalpemilu.org#53220,"PONDOK RANJI, CIPUTAT TIMUR, KOTA TANGERANG SELATAN, BANTEN",12,91,76,167
https://kawalpemilu.org#53220,"PONDOK RANJI, CIPUTAT TIMUR, KOTA TANGERANG SELATAN, BANTEN",13,67,80,147
https://kawalpemilu.org#53220,"PONDOK RANJI, CIPUTAT TIMUR, KOTA TANGERANG SELATAN, BANTEN",14,97,57,154
https://kawalpemilu.org#53220,"PONDOK RANJI, CIPUTAT TIMUR, KOTA TANGERANG SELATAN, BANTEN",15,71,64,135
https://kawalpemilu.org#53220,"PONDOK RANJI, CIPUTAT TIMUR, KOTA TANGERANG SELATAN, BANTEN",16,77,67,144
https://kawalpemilu.org#53220,"PONDOK RANJI, CIPUTAT TIMUR, KOTA TANGERANG SELATAN, BANTEN",17,72,46,118
https://kawalpemilu.org#53220,"PONDOK RANJI, CIPUTAT TIMUR, KOTA TANGERANG SELATAN, BANTEN",18,137,98,235
https://kawalpemilu.org#53220,"PONDOK RANJI, CIPUTAT TIMUR, KOTA TANGERANG SELATAN, BANTEN",19,88,53,141
https://kawalpemilu.org#53220,"PONDOK RANJI, CIPUTAT TIMUR, KOTA TANGERANG SELATAN, BANTEN",20,132,86,218
https://kawalpemilu.org#53220,"PONDOK RANJI, CIPUTAT TIMUR, KOTA TANGERANG SELATAN, BANTEN",21,107,143,250
https://kawalpemilu.org#53220,"PONDOK RANJI, CIPUTAT TIMUR, KOTA TANGERANG SELATAN, BANTEN",22,141,131,272
https://kawalpemilu.org#53220,"PONDOK RANJI, CIPUTAT TIMUR, KOTA TANGERANG SELATAN, BANTEN",23,147,100,247
https://kawalpemilu.org#53220,"PONDOK RANJI, CIPUTAT TIMUR, KOTA TANGERANG SELATAN, BANTEN",24,111,114,225
https://kawalpemilu.org#53220,"PONDOK RANJI, CIPUTAT TIMUR, KOTA TANGERANG SELATAN, BANTEN",25,156,115,271
https://kawalpemilu.org#53220,"PONDOK RANJI, CIPUTAT TIMUR, KOTA TANGERANG SELATAN, BANTEN",26,144,115,259
https://kawalpemilu.org#53220,"PONDOK RANJI, CIPUTAT TIMUR, KOTA TANGERANG SELATAN, BANTEN",27,0,0,0
https://kawalpemilu.org#53220,"PONDOK RANJI, CIPUTAT TIMUR, KOTA TANGERANG SELATAN, BANTEN",28,104,105,209
https://kawalpemilu.org#53220,"PONDOK RANJI, CIPUTAT TIMUR, KOTA TANGERANG SELATAN, BANTEN",29,133,78,211
https://kawalpemilu.org#53220,"PONDOK RANJI, CIPUTAT TIMUR, KOTA TANGERANG SELATAN, BANTEN",30,108,73,181
https://kawalpemilu.org#53220,"PONDOK RANJI, CIPUTAT TIMUR, KOTA TANGERANG SELATAN, BANTEN",31,90,142,232
https://kawalpemilu.org#53220,"PONDOK RANJI, CIPUTAT TIMUR, KOTA TANGERANG SELATAN, BANTEN",33,113,129,242
https://kawalpemilu.org#53220,"PONDOK RANJI, CIPUTAT TIMUR, KOTA TANGERANG SELATAN, BANTEN",34,120,95,215
https://kawalpemilu.org#53220,"PONDOK RANJI, CIPUTAT TIMUR, KOTA TANGERANG SELATAN, BANTEN",35,89,117,217
https://kawalpemilu.org#53220,"PONDOK RANJI, CIPUTAT TIMUR, KOTA TANGERANG SELATAN, BANTEN",36,83,109,192
https://kawalpemilu.org#53220,"PONDOK RANJI, CIPUTAT TIMUR, KOTA TANGERANG SELATAN, BANTEN",37,122,170,292
https://kawalpemilu.org#53220,"PONDOK RANJI, CIPUTAT TIMUR, KOTA TANGERANG SELATAN, BANTEN",38,94,129,223
https://kawalpemilu.org#53220,"PONDOK RANJI, CIPUTAT TIMUR, KOTA TANGERANG SELATAN, BANTEN",39,33,66,99
https://kawalpemilu.org#53220,"PONDOK RANJI, CIPUTAT TIMUR, KOTA TANGERANG SELATAN, BANTEN",40,65,92,157
https://kawalpemilu.org#53220,"PONDOK RANJI, CIPUTAT TIMUR, KOTA TANGERANG SELATAN, BANTEN",41,127,121,248
https://kawalpemilu.org#53220,"PONDOK RANJI, CIPUTAT TIMUR, KOTA TANGERANG SELATAN, BANTEN",42,97,108,205
https://kawalpemilu.org#53220,"PONDOK RANJI, CIPUTAT TIMUR, KOTA TANGERANG SELATAN, BANTEN",43,102,110,212
https://kawalpemilu.org#53220,"PONDOK RANJI, CIPUTAT TIMUR, KOTA TANGERANG SELATAN, BANTEN",44,96,90,186
https://kawalpemilu.org#53220,"PONDOK RANJI, CIPUTAT TIMUR, KOTA TANGERANG SELATAN, BANTEN",45,151,86,237
https://kawalpemilu.org#53220,"PONDOK RANJI, CIPUTAT TIMUR, KOTA TANGERANG SELATAN, BANTEN",46,171,92,263
https://kawalpemilu.org#53220,"PONDOK RANJI, CIPUTAT TIMUR, KOTA TANGERANG SELATAN, BANTEN",47,161,111,272
https://kawalpemilu.org#53220,"PONDOK RANJI, CIPUTAT TIMUR, KOTA TANGERANG SELATAN, BANTEN",48,107,94,201
https://kawalpemilu.org#53220,"PONDOK RANJI, CIPUTAT TIMUR, KOTA TANGERANG SELATAN, BANTEN",49,71,99,170
https://kawalpemilu.org#53220,"PONDOK RANJI, CIPUTAT TIMUR, KOTA TANGERANG SELATAN, BANTEN",50,144,99,243
https://kawalpemilu.org#53220,"PONDOK RANJI, CIPUTAT TIMUR, KOTA TANGERANG SELATAN, BANTEN",51,131,88,219
https://kawalpemilu.org#53220,"PONDOK RANJI, CIPUTAT TIMUR, KOTA TANGERANG SELATAN, BANTEN",52,135,99,234
https://kawalpemilu.org#53220,"PONDOK RANJI, CIPUTAT TIMUR, KOTA TANGERANG SELATAN, BANTEN",53,67,57,124
https://kawalpemilu.org#53220,"PONDOK RANJI, CIPUTAT TIMUR, KOTA TANGERANG SELATAN, BANTEN",54,94,119,213
https://kawalpemilu.org#53220,"PONDOK RANJI, CIPUTAT TIMUR, KOTA TANGERANG SELATAN, BANTEN",55,106,39,145
https://kawalpemilu.org#53220,"PONDOK RANJI, CIPUTAT TIMUR, KOTA TANGERANG SELATAN, BANTEN",56,98,56,154
https://kawalpemilu.org#53220,"PONDOK RANJI, CIPUTAT TIMUR, KOTA TANGERANG SELATAN, BANTEN",57,61,44,105
https://kawalpemilu.org#53220,"PONDOK RANJI, CIPUTAT TIMUR, KOTA TANGERANG SELATAN, BANTEN",58,95,80,175
https://kawalpemilu.org#53220,"PONDOK RANJI, CIPUTAT TIMUR, KOTA TANGERANG SELATAN, BANTEN",59,53,80,133
https://kawalpemilu.org#53220,"PONDOK RANJI, CIPUTAT TIMUR, KOTA TANGERANG SELATAN, BANTEN",60,61,62,123
https://kawalpemilu.org#53220,"PONDOK RANJI, CIPUTAT TIMUR, KOTA TANGERANG SELATAN, BANTEN",61,91,96,187
https://kawalpemilu.org#53220,"PONDOK RANJI, CIPUTAT TIMUR, KOTA TANGERANG SELATAN, BANTEN",62,100,97,197
https://kawalpemilu.org#53220,"PONDOK RANJI, CIPUTAT TIMUR, KOTA TANGERANG SELATAN, BANTEN",63,97,64,161
https://kawalpemilu.org#53220,"PONDOK RANJI, CIPUTAT TIMUR, KOTA TANGERANG SELATAN, BANTEN",64,123,118,241
https://kawalpemilu.org#53220,"PONDOK RANJI, CIPUTAT TIMUR, KOTA TANGERANG SELATAN, BANTEN",65,162,83,245
https://kawalpemilu.org#53220,"PONDOK RANJI, CIPUTAT TIMUR, KOTA TANGERANG SELATAN, BANTEN",66,108,57,165
https://kawalpemilu.org#53220,"PONDOK RANJI, CIPUTAT TIMUR, KOTA TANGERANG SELATAN, BANTEN",67,94,27,121
https://kawalpemilu.org#53220,"PONDOK RANJI, CIPUTAT TIMUR, KOTA TANGERANG SELATAN, BANTEN",68,106,32,138
https://kawalpemilu.org#53220,"PONDOK RANJI, CIPUTAT TIMUR, KOTA TANGERANG SELATAN, BANTEN",69,121,63,184
https://kawalpemilu.org#53220,"PONDOK RANJI, CIPUTAT TIMUR, KOTA TANGERANG SELATAN, BANTEN",70,109,36,145
https://kawalpemilu.org#53220,"PONDOK RANJI, CIPUTAT TIMUR, KOTA TANGERANG SELATAN, BANTEN",71,92,57,149
https://kawalpemilu.org#53220,"PONDOK RANJI, CIPUTAT TIMUR, KOTA TANGERANG SELATAN, BANTEN",72,132,82,214
https://kawalpemilu.org#53220,"PONDOK RANJI, CIPUTAT TIMUR, KOTA TANGERANG SELATAN, BANTEN",73,118,48,166
https://kawalpemilu.org#53220,"PONDOK RANJI, CIPUTAT TIMUR, KOTA TANGERANG SELATAN, BANTEN",74,125,51,176
https://kawalpemilu.org#53220,"PONDOK RANJI, CIPUTAT TIMUR, KOTA TANGERANG SELATAN, BANTEN",75,86,39,125
https://kawalpemilu.org#53220,"PONDOK RANJI, CIPUTAT TIMUR, KOTA TANGERANG SELATAN, BANTEN",76,104,109,213
https://kawalpemilu.org#53220,"PONDOK RANJI, CIPUTAT TIMUR, KOTA TANGERANG SELATAN, BANTEN",77,82,74,156
https://kawalpemilu.org#53220,"PONDOK RANJI, CIPUTAT TIMUR, KOTA TANGERANG SELATAN, BANTEN",78,159,101,260
https://kawalpemilu.org#53220,"PONDOK RANJI, CIPUTAT TIMUR, KOTA TANGERANG SELATAN, BANTEN",79,113,105,218
https://kawalpemilu.org#53220,"PONDOK RANJI, CIPUTAT TIMUR, KOTA TANGERANG SELATAN, BANTEN",80,111,94,205
https://kawalpemilu.org#53220,"PONDOK RANJI, CIPUTAT TIMUR, KOTA TANGERANG SELATAN, BANTEN",81,121,96,217
https://kawalpemilu.org#53220,"PONDOK RANJI, CIPUTAT TIMUR, KOTA TANGERANG SELATAN, BANTEN",82,102,62,164
https://kawalpemilu.org#53220,"PONDOK RANJI, CIPUTAT TIMUR, KOTA TANGERANG SELATAN, BANTEN",83,98,72,170
https://kawalpemilu.org#53220,"PONDOK RANJI, CIPUTAT TIMUR, KOTA TANGERANG SELATAN, BANTEN",84,90,73,163
https://kawalpemilu.org#53220,"PONDOK RANJI, CIPUTAT TIMUR, KOTA TANGERANG SELATAN, BANTEN",85,76,94,170
https://kawalpemilu.org#53220,"PONDOK RANJI, CIPUTAT TIMUR, KOTA TANGERANG SELATAN, BANTEN",86,110,90,200
https://kawalpemilu.org#53221,"PISANGAN, CIPUTAT TIMUR, KOTA TANGERANG SELATAN, BANTEN",1,106,105,211
https://kawalpemilu.org#53221,"PISANGAN, CIPUTAT TIMUR, KOTA TANGERANG SELATAN, BANTEN",2,93,124,217
https://kawalpemilu.org#53221,"PISANGAN, CIPUTAT TIMUR, KOTA TANGERANG SELATAN, BANTEN",3,94,101,195
https://kawalpemilu.org#53221,"PISANGAN, CIPUTAT TIMUR, KOTA TANGERANG SELATAN, BANTEN",4,128,105,233
https://kawalpemilu.org#53221,"PISANGAN, CIPUTAT TIMUR, KOTA TANGERANG SELATAN, BANTEN",5,92,106,198
https://kawalpemilu.org#53221,"PISANGAN, CIPUTAT TIMUR, KOTA TANGERANG SELATAN, BANTEN",6,108,120,228
https://kawalpemilu.org#53221,"PISANGAN, CIPUTAT TIMUR, KOTA TANGERANG SELATAN, BANTEN",7,107,106,213
https://kawalpemilu.org#53221,"PISANGAN, CIPUTAT TIMUR, KOTA TANGERANG SELATAN, BANTEN",8,106,133,239
https://kawalpemilu.org#53221,"PISANGAN, CIPUTAT TIMUR, KOTA TANGERANG SELATAN, BANTEN",9,80,124,204
https://kawalpemilu.org#53221,"PISANGAN, CIPUTAT TIMUR, KOTA TANGERANG SELATAN, BANTEN",10,94,107,201
https://kawalpemilu.org#53221,"PISANGAN, CIPUTAT TIMUR, KOTA TANGERANG SELATAN, BANTEN",11,92,101,193
https://kawalpemilu.org#53221,"PISANGAN, CIPUTAT TIMUR, KOTA TANGERANG SELATAN, BANTEN",12,142,105,247
https://kawalpemilu.org#53221,"PISANGAN, CIPUTAT TIMUR, KOTA TANGERANG SELATAN, BANTEN",13,129,100,229
https://kawalpemilu.org#53221,"PISANGAN, CIPUTAT TIMUR, KOTA TANGERANG SELATAN, BANTEN",15,103,123,226
https://kawalpemilu.org#53221,"PISANGAN, CIPUTAT TIMUR, KOTA TANGERANG SELATAN, BANTEN",16,91,123,214
https://kawalpemilu.org#53221,"PISANGAN, CIPUTAT TIMUR, KOTA TANGERANG SELATAN, BANTEN",17,112,81,193
https://kawalpemilu.org#53221,"PISANGAN, CIPUTAT TIMUR, KOTA TANGERANG SELATAN, BANTEN",18,78,71,149
https://kawalpemilu.org#53221,"PISANGAN, CIPUTAT TIMUR, KOTA TANGERANG SELATAN, BANTEN",19,119,130,249
https://kawalpemilu.org#53221,"PISANGAN, CIPUTAT TIMUR, KOTA TANGERANG SELATAN, BANTEN",20,100,129,229
https://kawalpemilu.org#53221,"PISANGAN, CIPUTAT TIMUR, KOTA TANGERANG SELATAN, BANTEN",21,94,140,234
https://kawalpemilu.org#53221,"PISANGAN, CIPUTAT TIMUR, KOTA TANGERANG SELATAN, BANTEN",22,86,75,161
https://kawalpemilu.org#53221,"PISANGAN, CIPUTAT TIMUR, KOTA TANGERANG SELATAN, BANTEN",23,93,71,164
https://kawalpemilu.org#53221,"PISANGAN, CIPUTAT TIMUR, KOTA TANGERANG SELATAN, BANTEN",24,64,130,194
https://kawalpemilu.org#53221,"PISANGAN, CIPUTAT TIMUR, KOTA TANGERANG SELATAN, BANTEN",25,95,97,192
https://kawalpemilu.org#53221,"PISANGAN, CIPUTAT TIMUR, KOTA TANGERANG SELATAN, BANTEN",26,96,106,202
https://kawalpemilu.org#53221,"PISANGAN, CIPUTAT TIMUR, KOTA TANGERANG SELATAN, BANTEN",27,120,93,213
https://kawalpemilu.org#53221,"PISANGAN, CIPUTAT TIMUR, KOTA TANGERANG SELATAN, BANTEN",28,96,93,189
https://kawalpemilu.org#53221,"PISANGAN, CIPUTAT TIMUR, KOTA TANGERANG SELATAN, BANTEN",29,89,92,181
https://kawalpemilu.org#53221,"PISANGAN, CIPUTAT TIMUR, KOTA TANGERANG SELATAN, BANTEN",30,85,105,190
https://kawalpemilu.org#53221,"PISANGAN, CIPUTAT TIMUR, KOTA TANGERANG SELATAN, BANTEN",31,116,146,262
https://kawalpemilu.org#53221,"PISANGAN, CIPUTAT TIMUR, KOTA TANGERANG SELATAN, BANTEN",32,113,126,239
https://kawalpemilu.org#53221,"PISANGAN, CIPUTAT TIMUR, KOTA TANGERANG SELATAN, BANTEN",33,92,145,237
https://kawalpemilu.org#53221,"PISANGAN, CIPUTAT TIMUR, KOTA TANGERANG SELATAN, BANTEN",34,109,122,231
https://kawalpemilu.org#53221,"PISANGAN, CIPUTAT TIMUR, KOTA TANGERANG SELATAN, BANTEN",35,117,117,234
https://kawalpemilu.org#53221,"PISANGAN, CIPUTAT TIMUR, KOTA TANGERANG SELATAN, BANTEN",36,105,121,226
https://kawalpemilu.org#53221,"PISANGAN, CIPUTAT TIMUR, KOTA TANGERANG SELATAN, BANTEN",37,95,136,231
https://kawalpemilu.org#53221,"PISANGAN, CIPUTAT TIMUR, KOTA TANGERANG SELATAN, BANTEN",38,94,115,209
https://kawalpemilu.org#53221,"PISANGAN, CIPUTAT TIMUR, KOTA TANGERANG SELATAN, BANTEN",39,91,170,261
https://kawalpemilu.org#53221,"PISANGAN, CIPUTAT TIMUR, KOTA TANGERANG SELATAN, BANTEN",40,86,133,219
https://kawalpemilu.org#53221,"PISANGAN, CIPUTAT TIMUR, KOTA TANGERANG SELATAN, BANTEN",41,102,120,222
https://kawalpemilu.org#53221,"PISANGAN, CIPUTAT TIMUR, KOTA TANGERANG SELATAN, BANTEN",42,115,120,235
https://kawalpemilu.org#53221,"PISANGAN, CIPUTAT TIMUR, KOTA TANGERANG SELATAN, BANTEN",43,145,125,270
https://kawalpemilu.org#53221,"PISANGAN, CIPUTAT TIMUR, KOTA TANGERANG SELATAN, BANTEN",44,68,158,226
https://kawalpemilu.org#53221,"PISANGAN, CIPUTAT TIMUR, KOTA TANGERANG SELATAN, BANTEN",45,96,139,235
https://kawalpemilu.org#53221,"PISANGAN, CIPUTAT TIMUR, KOTA TANGERANG SELATAN, BANTEN",46,116,67,183
https://kawalpemilu.org#53221,"PISANGAN, CIPUTAT TIMUR, KOTA TANGERANG SELATAN, BANTEN",47,123,111,234
https://kawalpemilu.org#53221,"PISANGAN, CIPUTAT TIMUR, KOTA TANGERANG SELATAN, BANTEN",48,120,79,199
https://kawalpemilu.org#53221,"PISANGAN, CIPUTAT TIMUR, KOTA TANGERANG SELATAN, BANTEN",50,76,69,145
https://kawalpemilu.org#53221,"PISANGAN, CIPUTAT TIMUR, KOTA TANGERANG SELATAN, BANTEN",51,120,72,192
https://kawalpemilu.org#53221,"PISANGAN, CIPUTAT TIMUR, KOTA TANGERANG SELATAN, BANTEN",52,83,147,230
https://kawalpemilu.org#53221,"PISANGAN, CIPUTAT TIMUR, KOTA TANGERANG SELATAN, BANTEN",53,71,129,200
https://kawalpemilu.org#53221,"PISANGAN, CIPUTAT TIMUR, KOTA TANGERANG SELATAN, BANTEN",54,108,98,206
https://kawalpemilu.org#53221,"PISANGAN, CIPUTAT TIMUR, KOTA TANGERANG SELATAN, BANTEN",55,101,89,190
https://kawalpemilu.org#53221,"PISANGAN, CIPUTAT TIMUR, KOTA TANGERANG SELATAN, BANTEN",56,103,105,208
https://kawalpemilu.org#53221,"PISANGAN, CIPUTAT TIMUR, KOTA TANGERANG SELATAN, BANTEN",57,99,135,234
https://kawalpemilu.org#53221,"PISANGAN, CIPUTAT TIMUR, KOTA TANGERANG SELATAN, BANTEN",58,139,122,261
https://kawalpemilu.org#53221,"PISANGAN, CIPUTAT TIMUR, KOTA TANGERANG SELATAN, BANTEN",59,106,177,283
https://kawalpemilu.org#53221,"PISANGAN, CIPUTAT TIMUR, KOTA TANGERANG SELATAN, BANTEN",60,147,90,237
https://kawalpemilu.org#53221,"PISANGAN, CIPUTAT TIMUR, KOTA TANGERANG SELATAN, BANTEN",61,57,132,189
https://kawalpemilu.org#53221,"PISANGAN, CIPUTAT TIMUR, KOTA TANGERANG SELATAN, BANTEN",62,61,136,197
https://kawalpemilu.org#53221,"PISANGAN, CIPUTAT TIMUR, KOTA TANGERANG SELATAN, BANTEN",63,82,183,265
https://kawalpemilu.org#53221,"PISANGAN, CIPUTAT TIMUR, KOTA TANGERANG SELATAN, BANTEN",64,71,195,266
https://kawalpemilu.org#53221,"PISANGAN, CIPUTAT TIMUR, KOTA TANGERANG SELATAN, BANTEN",65,87,163,250
https://kawalpemilu.org#53221,"PISANGAN, CIPUTAT TIMUR, KOTA TANGERANG SELATAN, BANTEN",66,116,178,294
https://kawalpemilu.org#53221,"PISANGAN, CIPUTAT TIMUR, KOTA TANGERANG SELATAN, BANTEN",67,72,80,152
https://kawalpemilu.org#53221,"PISANGAN, CIPUTAT TIMUR, KOTA TANGERANG SELATAN, BANTEN",68,135,98,233
https://kawalpemilu.org#53221,"PISANGAN, CIPUTAT TIMUR, KOTA TANGERANG SELATAN, BANTEN",69,134,109,243
https://kawalpemilu.org#53221,"PISANGAN, CIPUTAT TIMUR, KOTA TANGERANG SELATAN, BANTEN",70,147,100,247
https://kawalpemilu.org#53221,"PISANGAN, CIPUTAT TIMUR, KOTA TANGERANG SELATAN, BANTEN",71,130,86,216
https://kawalpemilu.org#53221,"PISANGAN, CIPUTAT TIMUR, KOTA TANGERANG SELATAN, BANTEN",72,102,85,187
https://kawalpemilu.org#53221,"PISANGAN, CIPUTAT TIMUR, KOTA TANGERANG SELATAN, BANTEN",73,126,122,248
https://kawalpemilu.org#53221,"PISANGAN, CIPUTAT TIMUR, KOTA TANGERANG SELATAN, BANTEN",74,81,89,170
https://kawalpemilu.org#53221,"PISANGAN, CIPUTAT TIMUR, KOTA TANGERANG SELATAN, BANTEN",75,86,114,200
https://kawalpemilu.org#53221,"PISANGAN, CIPUTAT TIMUR, KOTA TANGERANG SELATAN, BANTEN",76,128,80,208
https://kawalpemilu.org#53221,"PISANGAN, CIPUTAT TIMUR, KOTA TANGERANG SELATAN, BANTEN",77,150,72,222
https://kawalpemilu.org#53221,"PISANGAN, CIPUTAT TIMUR, KOTA TANGERANG SELATAN, BANTEN",78,130,85,215
https://kawalpemilu.org#53221,"PISANGAN, CIPUTAT TIMUR, KOTA TANGERANG SELATAN, BANTEN",79,136,132,268
https://kawalpemilu.org#53221,"PISANGAN, CIPUTAT TIMUR, KOTA TANGERANG SELATAN, BANTEN",80,113,122,235
https://kawalpemilu.org#53221,"PISANGAN, CIPUTAT TIMUR, KOTA TANGERANG SELATAN, BANTEN",81,92,96,188
https://kawalpemilu.org#53221,"PISANGAN, CIPUTAT TIMUR, KOTA TANGERANG SELATAN, BANTEN",82,75,75,150
https://kawalpemilu.org#53221,"PISANGAN, CIPUTAT TIMUR, KOTA TANGERANG SELATAN, BANTEN",83,72,109,181
https://kawalpemilu.org#53221,"PISANGAN, CIPUTAT TIMUR, KOTA TANGERANG SELATAN, BANTEN",84,152,83,235
https://kawalpemilu.org#53221,"PISANGAN, CIPUTAT TIMUR, KOTA TANGERANG SELATAN, BANTEN",85,149,75,224
https://kawalpemilu.org#53221,"PISANGAN, CIPUTAT TIMUR, KOTA TANGERANG SELATAN, BANTEN",86,104,108,212
https://kawalpemilu.org#53221,"PISANGAN, CIPUTAT TIMUR, KOTA TANGERANG SELATAN, BANTEN",87,147,33,180
https://kawalpemilu.org#53221,"PISANGAN, CIPUTAT TIMUR, KOTA TANGERANG SELATAN, BANTEN",88,155,24,179
https://kawalpemilu.org#53221,"PISANGAN, CIPUTAT TIMUR, KOTA TANGERANG SELATAN, BANTEN",89,173,52,225
https://kawalpemilu.org#53221,"PISANGAN, CIPUTAT TIMUR, KOTA TANGERANG SELATAN, BANTEN",90,150,42,192
https://kawalpemilu.org#53221,"PISANGAN, CIPUTAT TIMUR, KOTA TANGERANG SELATAN, BANTEN",91,94,94,188
https://kawalpemilu.org#53221,"PISANGAN, CIPUTAT TIMUR, KOTA TANGERANG SELATAN, BANTEN",92,71,134,205
https://kawalpemilu.org#53221,"PISANGAN, CIPUTAT TIMUR, KOTA TANGERANG SELATAN, BANTEN",93,112,42,154
https://kawalpemilu.org#53221,"PISANGAN, CIPUTAT TIMUR, KOTA TANGERANG SELATAN, BANTEN",94,93,49,142
https://kawalpemilu.org#53221,"PISANGAN, CIPUTAT TIMUR, KOTA TANGERANG SELATAN, BANTEN",95,90,59,149
https://kawalpemilu.org#53221,"PISANGAN, CIPUTAT TIMUR, KOTA TANGERANG SELATAN, BANTEN",96,109,59,168
https://kawalpemilu.org#53221,"PISANGAN, CIPUTAT TIMUR, KOTA TANGERANG SELATAN, BANTEN",97,78,64,142
https://kawalpemilu.org#53221,"PISANGAN, CIPUTAT TIMUR, KOTA TANGERANG SELATAN, BANTEN",98,85,76,161
https://kawalpemilu.org#53221,"PISANGAN, CIPUTAT TIMUR, KOTA TANGERANG SELATAN, BANTEN",99,136,97,233
https://kawalpemilu.org#53221,"PISANGAN, CIPUTAT TIMUR, KOTA TANGERANG SELATAN, BANTEN",100,113,134,247
https://kawalpemilu.org#53221,"PISANGAN, CIPUTAT TIMUR, KOTA TANGERANG SELATAN, BANTEN",101,115,77,192
https://kawalpemilu.org#53221,"PISANGAN, CIPUTAT TIMUR, KOTA TANGERANG SELATAN, BANTEN",102,88,140,228
https://kawalpemilu.org#53221,"PISANGAN, CIPUTAT TIMUR, KOTA TANGERANG SELATAN, BANTEN",103,68,66,134
https://kawalpemilu.org#53221,"PISANGAN, CIPUTAT TIMUR, KOTA TANGERANG SELATAN, BANTEN",104,88,106,194
https://kawalpemilu.org#53221,"PISANGAN, CIPUTAT TIMUR, KOTA TANGERANG SELATAN, BANTEN",105,108,129,237
https://kawalpemilu.org#53221,"PISANGAN, CIPUTAT TIMUR, KOTA TANGERANG SELATAN, BANTEN",106,56,81,137
https://kawalpemilu.org#53222,"CIREUNDEU, CIPUTAT TIMUR, KOTA TANGERANG SELATAN, BANTEN",1,136,108,244
https://kawalpemilu.org#53222,"CIREUNDEU, CIPUTAT TIMUR, KOTA TANGERANG SELATAN, BANTEN",2,103,93,196
https://kawalpemilu.org#53222,"CIREUNDEU, CIPUTAT TIMUR, KOTA TANGERANG SELATAN, BANTEN",3,119,114,233
https://kawalpemilu.org#53222,"CIREUNDEU, CIPUTAT TIMUR, KOTA TANGERANG SELATAN, BANTEN",4,115,108,223
https://kawalpemilu.org#53222,"CIREUNDEU, CIPUTAT TIMUR, KOTA TANGERANG SELATAN, BANTEN",5,102,88,190
https://kawalpemilu.org#53222,"CIREUNDEU, CIPUTAT TIMUR, KOTA TANGERANG SELATAN, BANTEN",6,130,102,232
https://kawalpemilu.org#53222,"CIREUNDEU, CIPUTAT TIMUR, KOTA TANGERANG SELATAN, BANTEN",7,114,83,197
https://kawalpemilu.org#53222,"CIREUNDEU, CIPUTAT TIMUR, KOTA TANGERANG SELATAN, BANTEN",8,132,120,252
https://kawalpemilu.org#53222,"CIREUNDEU, CIPUTAT TIMUR, KOTA TANGERANG SELATAN, BANTEN",9,124,117,241
https://kawalpemilu.org#53222,"CIREUNDEU, CIPUTAT TIMUR, KOTA TANGERANG SELATAN, BANTEN",10,94,140,234
https://kawalpemilu.org#53222,"CIREUNDEU, CIPUTAT TIMUR, KOTA TANGERANG SELATAN, BANTEN",11,81,127,208
https://kawalpemilu.org#53222,"CIREUNDEU, CIPUTAT TIMUR, KOTA TANGERANG SELATAN, BANTEN",12,98,90,188
https://kawalpemilu.org#53222,"CIREUNDEU, CIPUTAT TIMUR, KOTA TANGERANG SELATAN, BANTEN",13,92,75,167
https://kawalpemilu.org#53222,"CIREUNDEU, CIPUTAT TIMUR, KOTA TANGERANG SELATAN, BANTEN",14,63,187,250
https://kawalpemilu.org#53222,"CIREUNDEU, CIPUTAT TIMUR, KOTA TANGERANG SELATAN, BANTEN",15,76,164,240
https://kawalpemilu.org#53222,"CIREUNDEU, CIPUTAT TIMUR, KOTA TANGERANG SELATAN, BANTEN",16,67,177,244
https://kawalpemilu.org#53222,"CIREUNDEU, CIPUTAT TIMUR, KOTA TANGERANG SELATAN, BANTEN",17,148,89,237
https://kawalpemilu.org#53222,"CIREUNDEU, CIPUTAT TIMUR, KOTA TANGERANG SELATAN, BANTEN",18,135,77,212
https://kawalpemilu.org#53222,"CIREUNDEU, CIPUTAT TIMUR, KOTA TANGERANG SELATAN, BANTEN",19,136,86,222
https://kawalpemilu.org#53222,"CIREUNDEU, CIPUTAT TIMUR, KOTA TANGERANG SELATAN, BANTEN",20,128,119,247
https://kawalpemilu.org#53222,"CIREUNDEU, CIPUTAT TIMUR, KOTA TANGERANG SELATAN, BANTEN",21,155,84,239
https://kawalpemilu.org#53222,"CIREUNDEU, CIPUTAT TIMUR, KOTA TANGERANG SELATAN, BANTEN",22,125,156,281
https://kawalpemilu.org#53222,"CIREUNDEU, CIPUTAT TIMUR, KOTA TANGERANG SELATAN, BANTEN",23,106,156,262
https://kawalpemilu.org#53222,"CIREUNDEU, CIPUTAT TIMUR, KOTA TANGERANG SELATAN, BANTEN",24,104,143,247
https://kawalpemilu.org#53222,"CIREUNDEU, CIPUTAT TIMUR, KOTA TANGERANG SELATAN, BANTEN",25,110,115,225
https://kawalpemilu.org#53222,"CIREUNDEU, CIPUTAT TIMUR, KOTA TANGERANG SELATAN, BANTEN",26,76,160,236
https://kawalpemilu.org#53222,"CIREUNDEU, CIPUTAT TIMUR, KOTA TANGERANG SELATAN, BANTEN",27,78,165,243
https://kawalpemilu.org#53222,"CIREUNDEU, CIPUTAT TIMUR, KOTA TANGERANG SELATAN, BANTEN",28,108,140,248
https://kawalpemilu.org#53222,"CIREUNDEU, CIPUTAT TIMUR, KOTA TANGERANG SELATAN, BANTEN",29,91,124,215
https://kawalpemilu.org#53222,"CIREUNDEU, CIPUTAT TIMUR, KOTA TANGERANG SELATAN, BANTEN",30,112,86,198
https://kawalpemilu.org#53222,"CIREUNDEU, CIPUTAT TIMUR, KOTA TANGERANG SELATAN, BANTEN",31,153,64,217
https://kawalpemilu.org#53222,"CIREUNDEU, CIPUTAT TIMUR, KOTA TANGERANG SELATAN, BANTEN",32,99,122,221
https://kawalpemilu.org#53222,"CIREUNDEU, CIPUTAT TIMUR, KOTA TANGERANG SELATAN, BANTEN",33,111,134,245
https://kawalpemilu.org#53222,"CIREUNDEU, CIPUTAT TIMUR, KOTA TANGERANG SELATAN, BANTEN",34,140,128,268
https://kawalpemilu.org#53222,"CIREUNDEU, CIPUTAT TIMUR, KOTA TANGERANG SELATAN, BANTEN",35,129,110,239
https://kawalpemilu.org#53222,"CIREUNDEU, CIPUTAT TIMUR, KOTA TANGERANG SELATAN, BANTEN",36,102,111,213
https://kawalpemilu.org#53222,"CIREUNDEU, CIPUTAT TIMUR, KOTA TANGERANG SELATAN, BANTEN",37,64,75,139
https://kawalpemilu.org#53222,"CIREUNDEU, CIPUTAT TIMUR, KOTA TANGERANG SELATAN, BANTEN",38,85,114,199
https://kawalpemilu.org#53222,"CIREUNDEU, CIPUTAT TIMUR, KOTA TANGERANG SELATAN, BANTEN",39,82,98,180
https://kawalpemilu.org#53222,"CIREUNDEU, CIPUTAT TIMUR, KOTA TANGERANG SELATAN, BANTEN",40,100,91,191
https://kawalpemilu.org#53222,"CIREUNDEU, CIPUTAT TIMUR, KOTA TANGERANG SELATAN, BANTEN",41,75,124,199
https://kawalpemilu.org#53222,"CIREUNDEU, CIPUTAT TIMUR, KOTA TANGERANG SELATAN, BANTEN",42,89,149,238
https://kawalpemilu.org#53222,"CIREUNDEU, CIPUTAT TIMUR, KOTA TANGERANG SELATAN, BANTEN",43,115,110,225
https://kawalpemilu.org#53222,"CIREUNDEU, CIPUTAT TIMUR, KOTA TANGERANG SELATAN, BANTEN",44,109,124,233
https://kawalpemilu.org#53222,"CIREUNDEU, CIPUTAT TIMUR, KOTA TANGERANG SELATAN, BANTEN",45,108,67,175
https://kawalpemilu.org#53222,"CIREUNDEU, CIPUTAT TIMUR, KOTA TANGERANG SELATAN, BANTEN",46,95,62,157
https://kawalpemilu.org#53222,"CIREUNDEU, CIPUTAT TIMUR, KOTA TANGERANG SELATAN, BANTEN",47,132,86,218
https://kawalpemilu.org#53222,"CIREUNDEU, CIPUTAT TIMUR, KOTA TANGERANG SELATAN, BANTEN",48,91,155,246
https://kawalpemilu.org#53222,"CIREUNDEU, CIPUTAT TIMUR, KOTA TANGERANG SELATAN, BANTEN",49,114,111,225
https://kawalpemilu.org#53222,"CIREUNDEU, CIPUTAT TIMUR, KOTA TANGERANG SELATAN, BANTEN",50,149,112,261
https://kawalpemilu.org#53222,"CIREUNDEU, CIPUTAT TIMUR, KOTA TANGERANG SELATAN, BANTEN",51,121,152,273
https://kawalpemilu.org#53222,"CIREUNDEU, CIPUTAT TIMUR, KOTA TANGERANG SELATAN, BANTEN",52,112,92,204
https://kawalpemilu.org#53222,"CIREUNDEU, CIPUTAT TIMUR, KOTA TANGERANG SELATAN, BANTEN",53,118,109,227
https://kawalpemilu.org#53222,"CIREUNDEU, CIPUTAT TIMUR, KOTA TANGERANG SELATAN, BANTEN",54,111,105,216
https://kawalpemilu.org#53222,"CIREUNDEU, CIPUTAT TIMUR, KOTA TANGERANG SELATAN, BANTEN",55,92,108,200
https://kawalpemilu.org#53222,"CIREUNDEU, CIPUTAT TIMUR, KOTA TANGERANG SELATAN, BANTEN",56,103,167,270
https://kawalpemilu.org#53222,"CIREUNDEU, CIPUTAT TIMUR, KOTA TANGERANG SELATAN, BANTEN",57,87,154,241
https://kawalpemilu.org#53222,"CIREUNDEU, CIPUTAT TIMUR, KOTA TANGERANG SELATAN, BANTEN",58,97,112,209
https://kawalpemilu.org#53222,"CIREUNDEU, CIPUTAT TIMUR, KOTA TANGERANG SELATAN, BANTEN",59,103,117,220
https://kawalpemilu.org#53222,"CIREUNDEU, CIPUTAT TIMUR, KOTA TANGERANG SELATAN, BANTEN",60,93,96,189
https://kawalpemilu.org#53222,"CIREUNDEU, CIPUTAT TIMUR, KOTA TANGERANG SELATAN, BANTEN",61,100,104,204
https://kawalpemilu.org#53222,"CIREUNDEU, CIPUTAT TIMUR, KOTA TANGERANG SELATAN, BANTEN",62,95,107,202
https://kawalpemilu.org#53222,"CIREUNDEU, CIPUTAT TIMUR, KOTA TANGERANG SELATAN, BANTEN",63,110,118,228
https://kawalpemilu.org#53222,"CIREUNDEU, CIPUTAT TIMUR, KOTA TANGERANG SELATAN, BANTEN",64,116,114,230
https://kawalpemilu.org#53222,"CIREUNDEU, CIPUTAT TIMUR, KOTA TANGERANG SELATAN, BANTEN",65,83,144,227
https://kawalpemilu.org#53222,"CIREUNDEU, CIPUTAT TIMUR, KOTA TANGERANG SELATAN, BANTEN",66,75,121,196
https://kawalpemilu.org#53222,"CIREUNDEU, CIPUTAT TIMUR, KOTA TANGERANG SELATAN, BANTEN",67,80,127,207
https://kawalpemilu.org#53222,"CIREUNDEU, CIPUTAT TIMUR, KOTA TANGERANG SELATAN, BANTEN",68,124,100,224
https://kawalpemilu.org#53222,"CIREUNDEU, CIPUTAT TIMUR, KOTA TANGERANG SELATAN, BANTEN",69,121,112,233
https://kawalpemilu.org#53222,"CIREUNDEU, CIPUTAT TIMUR, KOTA TANGERANG SELATAN, BANTEN",70,126,110,236
https://kawalpemilu.org#53222,"CIREUNDEU, CIPUTAT TIMUR, KOTA TANGERANG SELATAN, BANTEN",71,128,112,240
https://kawalpemilu.org#53222,"CIREUNDEU, CIPUTAT TIMUR, KOTA TANGERANG SELATAN, BANTEN",72,146,57,203
https://kawalpemilu.org#53223,"REMPOA, CIPUTAT TIMUR, KOTA TANGERANG SELATAN, BANTEN",1,73,114,187
https://kawalpemilu.org#53223,"REMPOA, CIPUTAT TIMUR, KOTA TANGERANG SELATAN, BANTEN",2,77,100,177
https://kawalpemilu.org#53223,"REMPOA, CIPUTAT TIMUR, KOTA TANGERANG SELATAN, BANTEN",3,95,123,218
https://kawalpemilu.org#53223,"REMPOA, CIPUTAT TIMUR, KOTA TANGERANG SELATAN, BANTEN",4,112,106,218
https://kawalpemilu.org#53223,"REMPOA, CIPUTAT TIMUR, KOTA TANGERANG SELATAN, BANTEN",5,90,89,179
https://kawalpemilu.org#53223,"REMPOA, CIPUTAT TIMUR, KOTA TANGERANG SELATAN, BANTEN",6,75,88,163
https://kawalpemilu.org#53223,"REMPOA, CIPUTAT TIMUR, KOTA TANGERANG SELATAN, BANTEN",7,110,83,193
https://kawalpemilu.org#53223,"REMPOA, CIPUTAT TIMUR, KOTA TANGERANG SELATAN, BANTEN",8,65,62,127
https://kawalpemilu.org#53223,"REMPOA, CIPUTAT TIMUR, KOTA TANGERANG SELATAN, BANTEN",9,111,88,199
https://kawalpemilu.org#53223,"REMPOA, CIPUTAT TIMUR, KOTA TANGERANG SELATAN, BANTEN",10,113,91,204
https://kawalpemilu.org#53223,"REMPOA, CIPUTAT TIMUR, KOTA TANGERANG SELATAN, BANTEN",11,96,120,216
https://kawalpemilu.org#53223,"REMPOA, CIPUTAT TIMUR, KOTA TANGERANG SELATAN, BANTEN",12,62,71,133
https://kawalpemilu.org#53223,"REMPOA, CIPUTAT TIMUR, KOTA TANGERANG SELATAN, BANTEN",13,70,87,157
https://kawalpemilu.org#53223,"REMPOA, CIPUTAT TIMUR, KOTA TANGERANG SELATAN, BANTEN",14,91,84,174
https://kawalpemilu.org#53223,"REMPOA, CIPUTAT TIMUR, KOTA TANGERANG SELATAN, BANTEN",15,97,86,183
https://kawalpemilu.org#53223,"REMPOA, CIPUTAT TIMUR, KOTA TANGERANG SELATAN, BANTEN",16,69,98,167
https://kawalpemilu.org#53223,"REMPOA, CIPUTAT TIMUR, KOTA TANGERANG SELATAN, BANTEN",17,90,84,174
https://kawalpemilu.org#53223,"REMPOA, CIPUTAT TIMUR, KOTA TANGERANG SELATAN, BANTEN",18,142,82,224
https://kawalpemilu.org#53223,"REMPOA, CIPUTAT TIMUR, KOTA TANGERANG SELATAN, BANTEN",19,124,120,244
https://kawalpemilu.org#53223,"REMPOA, CIPUTAT TIMUR, KOTA TANGERANG SELATAN, BANTEN",20,88,80,168
https://kawalpemilu.org#53223,"REMPOA, CIPUTAT TIMUR, KOTA TANGERANG SELATAN, BANTEN",21,56,65,121
https://kawalpemilu.org#53223,"REMPOA, CIPUTAT TIMUR, KOTA TANGERANG SELATAN, BANTEN",22,48,89,137
https://kawalpemilu.org#53223,"REMPOA, CIPUTAT TIMUR, KOTA TANGERANG SELATAN, BANTEN",23,121,57,178
https://kawalpemilu.org#53223,"REMPOA, CIPUTAT TIMUR, KOTA TANGERANG SELATAN, BANTEN",24,124,47,171
https://kawalpemilu.org#53223,"REMPOA, CIPUTAT TIMUR, KOTA TANGERANG SELATAN, BANTEN",25,145,82,227
https://kawalpemilu.org#53223,"REMPOA, CIPUTAT TIMUR, KOTA TANGERANG SELATAN, BANTEN",26,77,83,159
https://kawalpemilu.org#53223,"REMPOA, CIPUTAT TIMUR, KOTA TANGERANG SELATAN, BANTEN",27,68,69,137
https://kawalpemilu.org#53223,"REMPOA, CIPUTAT TIMUR, KOTA TANGERANG SELATAN, BANTEN",28,73,78,151
https://kawalpemilu.org#53223,"REMPOA, CIPUTAT TIMUR, KOTA TANGERANG SELATAN, BANTEN",29,94,66,160
https://kawalpemilu.org#53223,"REMPOA, CIPUTAT TIMUR, KOTA TANGERANG SELATAN, BANTEN",30,55,58,113
https://kawalpemilu.org#53223,"REMPOA, CIPUTAT TIMUR, KOTA TANGERANG SELATAN, BANTEN",31,63,63,126
https://kawalpemilu.org#53223,"REMPOA, CIPUTAT TIMUR, KOTA TANGERANG SELATAN, BANTEN",32,57,110,167
https://kawalpemilu.org#53223,"REMPOA, CIPUTAT TIMUR, KOTA TANGERANG SELATAN, BANTEN",33,53,105,158
https://kawalpemilu.org#53223,"REMPOA, CIPUTAT TIMUR, KOTA TANGERANG SELATAN, BANTEN",34,82,87,169
https://kawalpemilu.org#53223,"REMPOA, CIPUTAT TIMUR, KOTA TANGERANG SELATAN, BANTEN",35,77,70,147
https://kawalpemilu.org#53223,"REMPOA, CIPUTAT TIMUR, KOTA TANGERANG SELATAN, BANTEN",36,98,89,187
https://kawalpemilu.org#53223,"REMPOA, CIPUTAT TIMUR, KOTA TANGERANG SELATAN, BANTEN",37,106,101,207
https://kawalpemilu.org#53223,"REMPOA, CIPUTAT TIMUR, KOTA TANGERANG SELATAN, BANTEN",38,136,79,215
https://kawalpemilu.org#53223,"REMPOA, CIPUTAT TIMUR, KOTA TANGERANG SELATAN, BANTEN",39,124,104,228
https://kawalpemilu.org#53223,"REMPOA, CIPUTAT TIMUR, KOTA TANGERANG SELATAN, BANTEN",40,95,114,209
https://kawalpemilu.org#53223,"REMPOA, CIPUTAT TIMUR, KOTA TANGERANG SELATAN, BANTEN",41,75,123,198
https://kawalpemilu.org#53223,"REMPOA, CIPUTAT TIMUR, KOTA TANGERANG SELATAN, BANTEN",42,138,78,216
https://kawalpemilu.org#53223,"REMPOA, CIPUTAT TIMUR, KOTA TANGERANG SELATAN, BANTEN",43,112,89,201
https://kawalpemilu.org#53223,"REMPOA, CIPUTAT TIMUR, KOTA TANGERANG SELATAN, BANTEN",44,149,106,255
https://kawalpemilu.org#53223,"REMPOA, CIPUTAT TIMUR, KOTA TANGERANG SELATAN, BANTEN",45,66,65,131
https://kawalpemilu.org#53223,"REMPOA, CIPUTAT TIMUR, KOTA TANGERANG SELATAN, BANTEN",46,95,54,149
https://kawalpemilu.org#53223,"REMPOA, CIPUTAT TIMUR, KOTA TANGERANG SELATAN, BANTEN",47,65,67,132
https://kawalpemilu.org#53223,"REMPOA, CIPUTAT TIMUR, KOTA TANGERANG SELATAN, BANTEN",48,81,82,163
https://kawalpemilu.org#53223,"REMPOA, CIPUTAT TIMUR, KOTA TANGERANG SELATAN, BANTEN",49,93,117,210
https://kawalpemilu.org#53223,"REMPOA, CIPUTAT TIMUR, KOTA TANGERANG SELATAN, BANTEN",50,107,99,206
https://kawalpemilu.org#53223,"REMPOA, CIPUTAT TIMUR, KOTA TANGERANG SELATAN, BANTEN",51,105,64,169
https://kawalpemilu.org#53223,"REMPOA, CIPUTAT TIMUR, KOTA TANGERANG SELATAN, BANTEN",52,87,142,229
https://kawalpemilu.org#53223,"REMPOA, CIPUTAT TIMUR, KOTA TANGERANG SELATAN, BANTEN",53,95,99,194
https://kawalpemilu.org#53223,"REMPOA, CIPUTAT TIMUR, KOTA TANGERANG SELATAN, BANTEN",54,113,112,225
https://kawalpemilu.org#53223,"REMPOA, CIPUTAT TIMUR, KOTA TANGERANG SELATAN, BANTEN",55,119,94,213
https://kawalpemilu.org#53223,"REMPOA, CIPUTAT TIMUR, KOTA TANGERANG SELATAN, BANTEN",56,125,143,268
https://kawalpemilu.org#53223,"REMPOA, CIPUTAT TIMUR, KOTA TANGERANG SELATAN, BANTEN",57,100,103,2
https://kawalpemilu.org#53223,"REMPOA, CIPUTAT TIMUR, KOTA TANGERANG SELATAN, BANTEN",58,78,108,186
https://kawalpemilu.org#53223,"REMPOA, CIPUTAT TIMUR, KOTA TANGERANG SELATAN, BANTEN",59,118,123,241
https://kawalpemilu.org#53223,"REMPOA, CIPUTAT TIMUR, KOTA TANGERANG SELATAN, BANTEN",60,127,97,224
https://kawalpemilu.org#53223,"REMPOA, CIPUTAT TIMUR, KOTA TANGERANG SELATAN, BANTEN",61,136,70,206
https://kawalpemilu.org#53223,"REMPOA, CIPUTAT TIMUR, KOTA TANGERANG SELATAN, BANTEN",62,124,114,238
https://kawalpemilu.org#53223,"REMPOA, CIPUTAT TIMUR, KOTA TANGERANG SELATAN, BANTEN",63,107,105,212
https://kawalpemilu.org#53223,"REMPOA, CIPUTAT TIMUR, KOTA TANGERANG SELATAN, BANTEN",64,114,72,186
https://kawalpemilu.org#53223,"REMPOA, CIPUTAT TIMUR, KOTA TANGERANG SELATAN, BANTEN",65,158,52,210
https://kawalpemilu.org#53223,"REMPOA, CIPUTAT TIMUR, KOTA TANGERANG SELATAN, BANTEN",66,84,56,140
https://kawalpemilu.org#53223,"REMPOA, CIPUTAT TIMUR, KOTA TANGERANG SELATAN, BANTEN",67,77,60,137
https://kawalpemilu.org#53223,"REMPOA, CIPUTAT TIMUR, KOTA TANGERANG SELATAN, BANTEN",68,98,92,190
https://kawalpemilu.org#53223,"REMPOA, CIPUTAT TIMUR, KOTA TANGERANG SELATAN, BANTEN",69,115,90,205
https://kawalpemilu.org#53223,"REMPOA, CIPUTAT TIMUR, KOTA TANGERANG SELATAN, BANTEN",70,101,126,227
https://kawalpemilu.org#53223,"REMPOA, CIPUTAT TIMUR, KOTA TANGERANG SELATAN, BANTEN",71,83,118,201
https://kawalpemilu.org#53223,"REMPOA, CIPUTAT TIMUR, KOTA TANGERANG SELATAN, BANTEN",72,75,113,188
https://kawalpemilu.org#53223,"REMPOA, CIPUTAT TIMUR, KOTA TANGERANG SELATAN, BANTEN",73,124,118,242
https://kawalpemilu.org#53223,"REMPOA, CIPUTAT TIMUR, KOTA TANGERANG SELATAN, BANTEN",74,84,141,225
https://kawalpemilu.org#53223,"REMPOA, CIPUTAT TIMUR, KOTA TANGERANG SELATAN, BANTEN",75,113,103,216
https://kawalpemilu.org#53223,"REMPOA, CIPUTAT TIMUR, KOTA TANGERANG SELATAN, BANTEN",76,136,141,277
https://kawalpemilu.org#53223,"REMPOA, CIPUTAT TIMUR, KOTA TANGERANG SELATAN, BANTEN",77,145,71,216
https://kawalpemilu.org#53223,"REMPOA, CIPUTAT TIMUR, KOTA TANGERANG SELATAN, BANTEN",78,158,61,219
https://kawalpemilu.org#53223,"REMPOA, CIPUTAT TIMUR, KOTA TANGERANG SELATAN, BANTEN",79,99,129,228
https://kawalpemilu.org#53223,"REMPOA, CIPUTAT TIMUR, KOTA TANGERANG SELATAN, BANTEN",80,111,107,218
https://kawalpemilu.org#53223,"REMPOA, CIPUTAT TIMUR, KOTA TANGERANG SELATAN, BANTEN",81,36,141,177
https://kawalpemilu.org#53223,"REMPOA, CIPUTAT TIMUR, KOTA TANGERANG SELATAN, BANTEN",82,45,115,160
https://kawalpemilu.org#53223,"REMPOA, CIPUTAT TIMUR, KOTA TANGERANG SELATAN, BANTEN",83,29,180,209
https://kawalpemilu.org#53223,"REMPOA, CIPUTAT TIMUR, KOTA TANGERANG SELATAN, BANTEN",84,133,47,180
https://kawalpemilu.org#53223,"REMPOA, CIPUTAT TIMUR, KOTA TANGERANG SELATAN, BANTEN",85,117,77,194
https://kawalpemilu.org#53223,"REMPOA, CIPUTAT TIMUR, KOTA TANGERANG SELATAN, BANTEN",86,172,69,241
https://kawalpemilu.org#53223,"REMPOA, CIPUTAT TIMUR, KOTA TANGERANG SELATAN, BANTEN",87,128,84,212
https://kawalpemilu.org#53223,"REMPOA, CIPUTAT TIMUR, KOTA TANGERANG SELATAN, BANTEN",88,93,110,203
https://kawalpemilu.org#53223,"REMPOA, CIPUTAT TIMUR, KOTA TANGERANG SELATAN, BANTEN",89,92,35,127
https://kawalpemilu.org#53223,"REMPOA, CIPUTAT TIMUR, KOTA TANGERANG SELATAN, BANTEN",90,121,114,235
https://kawalpemilu.org#53224,"RENGAS, CIPUTAT TIMUR, KOTA TANGERANG SELATAN, BANTEN",1,68,22,90
https://kawalpemilu.org#53224,"RENGAS, CIPUTAT TIMUR, KOTA TANGERANG SELATAN, BANTEN",2,139,71,210
https://kawalpemilu.org#53224,"RENGAS, CIPUTAT TIMUR, KOTA TANGERANG SELATAN, BANTEN",3,142,73,215
https://kawalpemilu.org#53224,"RENGAS, CIPUTAT TIMUR, KOTA TANGERANG SELATAN, BANTEN",4,110,83,193
https://kawalpemilu.org#53224,"RENGAS, CIPUTAT TIMUR, KOTA TANGERANG SELATAN, BANTEN",5,162,59,221
https://kawalpemilu.org#53224,"RENGAS, CIPUTAT TIMUR, KOTA TANGERANG SELATAN, BANTEN",6,122,80,202
https://kawalpemilu.org#53224,"RENGAS, CIPUTAT TIMUR, KOTA TANGERANG SELATAN, BANTEN",7,123,78,201
https://kawalpemilu.org#53224,"RENGAS, CIPUTAT TIMUR, KOTA TANGERANG SELATAN, BANTEN",8,100,88,188
https://kawalpemilu.org#53224,"RENGAS, CIPUTAT TIMUR, KOTA TANGERANG SELATAN, BANTEN",9,117,39,156
https://kawalpemilu.org#53224,"RENGAS, CIPUTAT TIMUR, KOTA TANGERANG SELATAN, BANTEN",10,148,104,252
https://kawalpemilu.org#53224,"RENGAS, CIPUTAT TIMUR, KOTA TANGERANG SELATAN, BANTEN",11,100,125,225
https://kawalpemilu.org#53224,"RENGAS, CIPUTAT TIMUR, KOTA TANGERANG SELATAN, BANTEN",12,106,49,155
https://kawalpemilu.org#53224,"RENGAS, CIPUTAT TIMUR, KOTA TANGERANG SELATAN, BANTEN",13,103,81,184
https://kawalpemilu.org#53224,"RENGAS, CIPUTAT TIMUR, KOTA TANGERANG SELATAN, BANTEN",14,93,73,166
https://kawalpemilu.org#53224,"RENGAS, CIPUTAT TIMUR, KOTA TANGERANG SELATAN, BANTEN",15,131,79,210
https://kawalpemilu.org#53224,"RENGAS, CIPUTAT TIMUR, KOTA TANGERANG SELATAN, BANTEN",16,139,69,208
https://kawalpemilu.org#53224,"RENGAS, CIPUTAT TIMUR, KOTA TANGERANG SELATAN, BANTEN",17,124,92,216
https://kawalpemilu.org#53224,"RENGAS, CIPUTAT TIMUR, KOTA TANGERANG SELATAN, BANTEN",18,96,63,159
https://kawalpemilu.org#53224,"RENGAS, CIPUTAT TIMUR, KOTA TANGERANG SELATAN, BANTEN",19,97,92,189
https://kawalpemilu.org#53224,"RENGAS, CIPUTAT TIMUR, KOTA TANGERANG SELATAN, BANTEN",20,142,85,227
https://kawalpemilu.org#53224,"RENGAS, CIPUTAT TIMUR, KOTA TANGERANG SELATAN, BANTEN",21,177,83,260
https://kawalpemilu.org#53224,"RENGAS, CIPUTAT TIMUR, KOTA TANGERANG SELATAN, BANTEN",22,116,106,222
https://kawalpemilu.org#53224,"RENGAS, CIPUTAT TIMUR, KOTA TANGERANG SELATAN, BANTEN",23,100,103,203
https://kawalpemilu.org#53224,"RENGAS, CIPUTAT TIMUR, KOTA TANGERANG SELATAN, BANTEN",24,112,94,206
https://kawalpemilu.org#53224,"RENGAS, CIPUTAT TIMUR, KOTA TANGERANG SELATAN, BANTEN",25,84,86,170
https://kawalpemilu.org#53224,"RENGAS, CIPUTAT TIMUR, KOTA TANGERANG SELATAN, BANTEN",26,93,68,161
https://kawalpemilu.org#53224,"RENGAS, CIPUTAT TIMUR, KOTA TANGERANG SELATAN, BANTEN",27,77,87,164
https://kawalpemilu.org#53224,"RENGAS, CIPUTAT TIMUR, KOTA TANGERANG SELATAN, BANTEN",28,101,116,217
https://kawalpemilu.org#53224,"RENGAS, CIPUTAT TIMUR, KOTA TANGERANG SELATAN, BANTEN",29,95,109,204
https://kawalpemilu.org#53224,"RENGAS, CIPUTAT TIMUR, KOTA TANGERANG SELATAN, BANTEN",30,145,110,255
https://kawalpemilu.org#53224,"RENGAS, CIPUTAT TIMUR, KOTA TANGERANG SELATAN, BANTEN",31,222,220,442
https://kawalpemilu.org#53224,"RENGAS, CIPUTAT TIMUR, KOTA TANGERANG SELATAN, BANTEN",32,132,76,208
https://kawalpemilu.org#53224,"RENGAS, CIPUTAT TIMUR, KOTA TANGERANG SELATAN, BANTEN",33,103,103,206
https://kawalpemilu.org#53224,"RENGAS, CIPUTAT TIMUR, KOTA TANGERANG SELATAN, BANTEN",34,116,94,210
https://kawalpemilu.org#53224,"RENGAS, CIPUTAT TIMUR, KOTA TANGERANG SELATAN, BANTEN",35,140,103,243
https://kawalpemilu.org#53224,"RENGAS, CIPUTAT TIMUR, KOTA TANGERANG SELATAN, BANTEN",36,150,100,250
https://kawalpemilu.org#53224,"RENGAS, CIPUTAT TIMUR, KOTA TANGERANG SELATAN, BANTEN",37,141,121,262
https://kawalpemilu.org#53224,"RENGAS, CIPUTAT TIMUR, KOTA TANGERANG SELATAN, BANTEN",38,110,65,176
https://kawalpemilu.org#53224,"RENGAS, CIPUTAT TIMUR, KOTA TANGERANG SELATAN, BANTEN",39,143,90,233
https://kawalpemilu.org#53224,"RENGAS, CIPUTAT TIMUR, KOTA TANGERANG SELATAN, BANTEN",40,155,62,217
https://kawalpemilu.org#53224,"RENGAS, CIPUTAT TIMUR, KOTA TANGERANG SELATAN, BANTEN",41,139,120,259
https://kawalpemilu.org#53224,"RENGAS, CIPUTAT TIMUR, KOTA TANGERANG SELATAN, BANTEN",42,164,104,268
https://kawalpemilu.org#53224,"RENGAS, CIPUTAT TIMUR, KOTA TANGERANG SELATAN, BANTEN",43,133,104,237
https://kawalpemilu.org#53224,"RENGAS, CIPUTAT TIMUR, KOTA TANGERANG SELATAN, BANTEN",44,103,66,169
https://kawalpemilu.org#53224,"RENGAS, CIPUTAT TIMUR, KOTA TANGERANG SELATAN, BANTEN",45,76,80,156
https://kawalpemilu.org#53224,"RENGAS, CIPUTAT TIMUR, KOTA TANGERANG SELATAN, BANTEN",46,108,78,186
https://kawalpemilu.org#53224,"RENGAS, CIPUTAT TIMUR, KOTA TANGERANG SELATAN, BANTEN",47,79,83,162
https://kawalpemilu.org#53224,"RENGAS, CIPUTAT TIMUR, KOTA TANGERANG SELATAN, BANTEN",48,74,50,124
https://kawalpemilu.org#53224,"RENGAS, CIPUTAT TIMUR, KOTA TANGERANG SELATAN, BANTEN",49,127,90,217
https://kawalpemilu.org#53224,"RENGAS, CIPUTAT TIMUR, KOTA TANGERANG SELATAN, BANTEN",50,120,99,219
https://kawalpemilu.org#53224,"RENGAS, CIPUTAT TIMUR, KOTA TANGERANG SELATAN, BANTEN",51,116,84,200
https://kawalpemilu.org#53224,"RENGAS, CIPUTAT TIMUR, KOTA TANGERANG SELATAN, BANTEN",52,137,94,231
https://kawalpemilu.org#53224,"RENGAS, CIPUTAT TIMUR, KOTA TANGERANG SELATAN, BANTEN",53,148,80,228
https://kawalpemilu.org#53224,"RENGAS, CIPUTAT TIMUR, KOTA TANGERANG SELATAN, BANTEN",54,127,84,211
https://kawalpemilu.org#53224,"RENGAS, CIPUTAT TIMUR, KOTA TANGERANG SELATAN, BANTEN",55,83,68,151
https://kawalpemilu.org#53224,"RENGAS, CIPUTAT TIMUR, KOTA TANGERANG SELATAN, BANTEN",56,104,88,192
https://kawalpemilu.org#53224,"RENGAS, CIPUTAT TIMUR, KOTA TANGERANG SELATAN, BANTEN",57,166,94,260
https://kawalpemilu.org#53224,"RENGAS, CIPUTAT TIMUR, KOTA TANGERANG SELATAN, BANTEN",58,144,100,244
https://kawalpemilu.org#53224,"RENGAS, CIPUTAT TIMUR, KOTA TANGERANG SELATAN, BANTEN",59,149,85,234
https://kawalpemilu.org#53224,"RENGAS, CIPUTAT TIMUR, KOTA TANGERANG SELATAN, BANTEN",60,151,68,219
https://kawalpemilu.org#53224,"RENGAS, CIPUTAT TIMUR, KOTA TANGERANG SELATAN, BANTEN",61,162,64,226
https://kawalpemilu.org#53224,"RENGAS, CIPUTAT TIMUR, KOTA TANGERANG SELATAN, BANTEN",62,167,43,210
https://kawalpemilu.org#53224,"RENGAS, CIPUTAT TIMUR, KOTA TANGERANG SELATAN, BANTEN",63,148,55,203
https://kawalpemilu.org#53224,"RENGAS, CIPUTAT TIMUR, KOTA TANGERANG SELATAN, BANTEN",64,138,39,177
https://kawalpemilu.org#53224,"RENGAS, CIPUTAT TIMUR, KOTA TANGERANG SELATAN, BANTEN",65,135,48,183
https://kawalpemilu.org#53224,"RENGAS, CIPUTAT TIMUR, KOTA TANGERANG SELATAN, BANTEN",66,94,48,142
https://kawalpemilu.org#53224,"RENGAS, CIPUTAT TIMUR, KOTA TANGERANG SELATAN, BANTEN",67,125,55,180
https://kawalpemilu.org#53224,"RENGAS, CIPUTAT TIMUR, KOTA TANGERANG SELATAN, BANTEN",68,164,54,218
https://kawalpemilu.org#53224,"RENGAS, CIPUTAT TIMUR, KOTA TANGERANG SELATAN, BANTEN",69,153,43,196
https://kawalpemilu.org#53224,"RENGAS, CIPUTAT TIMUR, KOTA TANGERANG SELATAN, BANTEN",70,119,41,160
https://kawalpemilu.org#53224,"RENGAS, CIPUTAT TIMUR, KOTA TANGERANG SELATAN, BANTEN",71,102,59,161
https://kawalpemilu.org#53224,"RENGAS, CIPUTAT TIMUR, KOTA TANGERANG SELATAN, BANTEN",72,142,62,204
https://kawalpemilu.org#53226,"PAMULANG BARAT, PAMULANG, KOTA TANGERANG SELATAN, BANTEN",1,118,94,212
https://kawalpemilu.org#53226,"PAMULANG BARAT, PAMULANG, KOTA TANGERANG SELATAN, BANTEN",2,96,76,172
https://kawalpemilu.org#53226,"PAMULANG BARAT, PAMULANG, KOTA TANGERANG SELATAN, BANTEN",3,98,99,197
https://kawalpemilu.org#53226,"PAMULANG BARAT, PAMULANG, KOTA TANGERANG SELATAN, BANTEN",4,131,114,245
https://kawalpemilu.org#53226,"PAMULANG BARAT, PAMULANG, KOTA TANGERANG SELATAN, BANTEN",5,138,130,268
https://kawalpemilu.org#53226,"PAMULANG BARAT, PAMULANG, KOTA TANGERANG SELATAN, BANTEN",6,120,98,218
https://kawalpemilu.org#53226,"PAMULANG BARAT, PAMULANG, KOTA TANGERANG SELATAN, BANTEN",7,91,136,227
https://kawalpemilu.org#53226,"PAMULANG BARAT, PAMULANG, KOTA TANGERANG SELATAN, BANTEN",8,104,71,175
https://kawalpemilu.org#53226,"PAMULANG BARAT, PAMULANG, KOTA TANGERANG SELATAN, BANTEN",9,66,174,240
https://kawalpemilu.org#53226,"PAMULANG BARAT, PAMULANG, KOTA TANGERANG SELATAN, BANTEN",10,91,123,214
https://kawalpemilu.org#53226,"PAMULANG BARAT, PAMULANG, KOTA TANGERANG SELATAN, BANTEN",12,84,113,197
https://kawalpemilu.org#53226,"PAMULANG BARAT, PAMULANG, KOTA TANGERANG SELATAN, BANTEN",13,92,106,198
https://kawalpemilu.org#53226,"PAMULANG BARAT, PAMULANG, KOTA TANGERANG SELATAN, BANTEN",14,114,115,229
https://kawalpemilu.org#53226,"PAMULANG BARAT, PAMULANG, KOTA TANGERANG SELATAN, BANTEN",15,85,98,183
https://kawalpemilu.org#53226,"PAMULANG BARAT, PAMULANG, KOTA TANGERANG SELATAN, BANTEN",16,67,82,149
https://kawalpemilu.org#53226,"PAMULANG BARAT, PAMULANG, KOTA TANGERANG SELATAN, BANTEN",17,96,117,213
https://kawalpemilu.org#53226,"PAMULANG BARAT, PAMULANG, KOTA TANGERANG SELATAN, BANTEN",18,86,81,167
https://kawalpemilu.org#53226,"PAMULANG BARAT, PAMULANG, KOTA TANGERANG SELATAN, BANTEN",19,81,99,180
https://kawalpemilu.org#53226,"PAMULANG BARAT, PAMULANG, KOTA TANGERANG SELATAN, BANTEN",20,109,128,237
https://kawalpemilu.org#53226,"PAMULANG BARAT, PAMULANG, KOTA TANGERANG SELATAN, BANTEN",21,132,98,230
https://kawalpemilu.org#53226,"PAMULANG BARAT, PAMULANG, KOTA TANGERANG SELATAN, BANTEN",22,96,129,225
https://kawalpemilu.org#53226,"PAMULANG BARAT, PAMULANG, KOTA TANGERANG SELATAN, BANTEN",23,100,97,197
https://kawalpemilu.org#53226,"PAMULANG BARAT, PAMULANG, KOTA TANGERANG SELATAN, BANTEN",24,102,103,205
https://kawalpemilu.org#53226,"PAMULANG BARAT, PAMULANG, KOTA TANGERANG SELATAN, BANTEN",25,106,87,193
https://kawalpemilu.org#53226,"PAMULANG BARAT, PAMULANG, KOTA TANGERANG SELATAN, BANTEN",26,109,114,223
https://kawalpemilu.org#53226,"PAMULANG BARAT, PAMULANG, KOTA TANGERANG SELATAN, BANTEN",27,89,66,155
https://kawalpemilu.org#53226,"PAMULANG BARAT, PAMULANG, KOTA TANGERANG SELATAN, BANTEN",28,121,114,235
https://kawalpemilu.org#53226,"PAMULANG BARAT, PAMULANG, KOTA TANGERANG SELATAN, BANTEN",29,84,102,186
https://kawalpemilu.org#53226,"PAMULANG BARAT, PAMULANG, KOTA TANGERANG SELATAN, BANTEN",30,68,103,171
https://kawalpemilu.org#53226,"PAMULANG BARAT, PAMULANG, KOTA TANGERANG SELATAN, BANTEN",31,86,104,190
https://kawalpemilu.org#53226,"PAMULANG BARAT, PAMULANG, KOTA TANGERANG SELATAN, BANTEN",32,117,86,203
https://kawalpemilu.org#53226,"PAMULANG BARAT, PAMULANG, KOTA TANGERANG SELATAN, BANTEN",34,91,50,141
https://kawalpemilu.org#53226,"PAMULANG BARAT, PAMULANG, KOTA TANGERANG SELATAN, BANTEN",35,71,103,174
https://kawalpemilu.org#53226,"PAMULANG BARAT, PAMULANG, KOTA TANGERANG SELATAN, BANTEN",36,52,99,151
https://kawalpemilu.org#53226,"PAMULANG BARAT, PAMULANG, KOTA TANGERANG SELATAN, BANTEN",37,57,79,136
https://kawalpemilu.org#53226,"PAMULANG BARAT, PAMULANG, KOTA TANGERANG SELATAN, BANTEN",38,92,90,182
https://kawalpemilu.org#53226,"PAMULANG BARAT, PAMULANG, KOTA TANGERANG SELATAN, BANTEN",39,104,106,210
https://kawalpemilu.org#53226,"PAMULANG BARAT, PAMULANG, KOTA TANGERANG SELATAN, BANTEN",40,84,87,171
https://kawalpemilu.org#53226,"PAMULANG BARAT, PAMULANG, KOTA TANGERANG SELATAN, BANTEN",41,83,103,186
https://kawalpemilu.org#53226,"PAMULANG BARAT, PAMULANG, KOTA TANGERANG SELATAN, BANTEN",42,77,134,211
https://kawalpemilu.org#53226,"PAMULANG BARAT, PAMULANG, KOTA TANGERANG SELATAN, BANTEN",43,66,128,194
https://kawalpemilu.org#53226,"PAMULANG BARAT, PAMULANG, KOTA TANGERANG SELATAN, BANTEN",44,85,96,181
https://kawalpemilu.org#53226,"PAMULANG BARAT, PAMULANG, KOTA TANGERANG SELATAN, BANTEN",45,56,105,161
https://kawalpemilu.org#53226,"PAMULANG BARAT, PAMULANG, KOTA TANGERANG SELATAN, BANTEN",46,92,115,207
https://kawalpemilu.org#53226,"PAMULANG BARAT, PAMULANG, KOTA TANGERANG SELATAN, BANTEN",47,82,128,210
https://kawalpemilu.org#53226,"PAMULANG BARAT, PAMULANG, KOTA TANGERANG SELATAN, BANTEN",48,74,102,176
https://kawalpemilu.org#53226,"PAMULANG BARAT, PAMULANG, KOTA TANGERANG SELATAN, BANTEN",49,74,99,173
https://kawalpemilu.org#53226,"PAMULANG BARAT, PAMULANG, KOTA TANGERANG SELATAN, BANTEN",50,97,88,185
https://kawalpemilu.org#53226,"PAMULANG BARAT, PAMULANG, KOTA TANGERANG SELATAN, BANTEN",51,59,97,156
https://kawalpemilu.org#53226,"PAMULANG BARAT, PAMULANG, KOTA TANGERANG SELATAN, BANTEN",52,67,80,147
https://kawalpemilu.org#53226,"PAMULANG BARAT, PAMULANG, KOTA TANGERANG SELATAN, BANTEN",53,113,115,228
https://kawalpemilu.org#53226,"PAMULANG BARAT, PAMULANG, KOTA TANGERANG SELATAN, BANTEN",54,80,124,204
https://kawalpemilu.org#53226,"PAMULANG BARAT, PAMULANG, KOTA TANGERANG SELATAN, BANTEN",55,106,113,219
https://kawalpemilu.org#53226,"PAMULANG BARAT, PAMULANG, KOTA TANGERANG SELATAN, BANTEN",56,109,101,210
https://kawalpemilu.org#53226,"PAMULANG BARAT, PAMULANG, KOTA TANGERANG SELATAN, BANTEN",57,90,141,231
https://kawalpemilu.org#53226,"PAMULANG BARAT, PAMULANG, KOTA TANGERANG SELATAN, BANTEN",58,84,115,199
https://kawalpemilu.org#53226,"PAMULANG BARAT, PAMULANG, KOTA TANGERANG SELATAN, BANTEN",59,87,144,231
https://kawalpemilu.org#53226,"PAMULANG BARAT, PAMULANG, KOTA TANGERANG SELATAN, BANTEN",60,92,139,231
https://kawalpemilu.org#53226,"PAMULANG BARAT, PAMULANG, KOTA TANGERANG SELATAN, BANTEN",61,83,113,196
https://kawalpemilu.org#53226,"PAMULANG BARAT, PAMULANG, KOTA TANGERANG SELATAN, BANTEN",62,77,109,186
https://kawalpemilu.org#53226,"PAMULANG BARAT, PAMULANG, KOTA TANGERANG SELATAN, BANTEN",63,78,102,180
https://kawalpemilu.org#53226,"PAMULANG BARAT, PAMULANG, KOTA TANGERANG SELATAN, BANTEN",64,62,103,165
https://kawalpemilu.org#53226,"PAMULANG BARAT, PAMULANG, KOTA TANGERANG SELATAN, BANTEN",65,86,47,133
https://kawalpemilu.org#53226,"PAMULANG BARAT, PAMULANG, KOTA TANGERANG SELATAN, BANTEN",66,88,46,134
https://kawalpemilu.org#53226,"PAMULANG BARAT, PAMULANG, KOTA TANGERANG SELATAN, BANTEN",67,108,121,229
https://kawalpemilu.org#53226,"PAMULANG BARAT, PAMULANG, KOTA TANGERANG SELATAN, BANTEN",68,108,98,206
https://kawalpemilu.org#53226,"PAMULANG BARAT, PAMULANG, KOTA TANGERANG SELATAN, BANTEN",69,88,119,207
https://kawalpemilu.org#53226,"PAMULANG BARAT, PAMULANG, KOTA TANGERANG SELATAN, BANTEN",70,107,93,200
https://kawalpemilu.org#53226,"PAMULANG BARAT, PAMULANG, KOTA TANGERANG SELATAN, BANTEN",71,93,57,150
https://kawalpemilu.org#53226,"PAMULANG BARAT, PAMULANG, KOTA TANGERANG SELATAN, BANTEN",72,120,127,247
https://kawalpemilu.org#53226,"PAMULANG BARAT, PAMULANG, KOTA TANGERANG SELATAN, BANTEN",73,130,130,260
https://kawalpemilu.org#53226,"PAMULANG BARAT, PAMULANG, KOTA TANGERANG SELATAN, BANTEN",74,113,44,157
https://kawalpemilu.org#53226,"PAMULANG BARAT, PAMULANG, KOTA TANGERANG SELATAN, BANTEN",75,144,71,215
https://kawalpemilu.org#53226,"PAMULANG BARAT, PAMULANG, KOTA TANGERANG SELATAN, BANTEN",76,87,43,130
https://kawalpemilu.org#53226,"PAMULANG BARAT, PAMULANG, KOTA TANGERANG SELATAN, BANTEN",77,151,85,236
https://kawalpemilu.org#53226,"PAMULANG BARAT, PAMULANG, KOTA TANGERANG SELATAN, BANTEN",78,137,79,216
https://kawalpemilu.org#53226,"PAMULANG BARAT, PAMULANG, KOTA TANGERANG SELATAN, BANTEN",79,164,65,229
https://kawalpemilu.org#53226,"PAMULANG BARAT, PAMULANG, KOTA TANGERANG SELATAN, BANTEN",80,151,64,215
https://kawalpemilu.org#53226,"PAMULANG BARAT, PAMULANG, KOTA TANGERANG SELATAN, BANTEN",81,127,89,216
https://kawalpemilu.org#53226,"PAMULANG BARAT, PAMULANG, KOTA TANGERANG SELATAN, BANTEN",82,153,70,223
https://kawalpemilu.org#53226,"PAMULANG BARAT, PAMULANG, KOTA TANGERANG SELATAN, BANTEN",83,137,80,217
https://kawalpemilu.org#53226,"PAMULANG BARAT, PAMULANG, KOTA TANGERANG SELATAN, BANTEN",84,136,50,186
https://kawalpemilu.org#53226,"PAMULANG BARAT, PAMULANG, KOTA TANGERANG SELATAN, BANTEN",85,102,54,156
https://kawalpemilu.org#53226,"PAMULANG BARAT, PAMULANG, KOTA TANGERANG SELATAN, BANTEN",86,90,79,169
https://kawalpemilu.org#53226,"PAMULANG BARAT, PAMULANG, KOTA TANGERANG SELATAN, BANTEN",87,131,60,191
https://kawalpemilu.org#53226,"PAMULANG BARAT, PAMULANG, KOTA TANGERANG SELATAN, BANTEN",88,96,87,183
https://kawalpemilu.org#53226,"PAMULANG BARAT, PAMULANG, KOTA TANGERANG SELATAN, BANTEN",89,119,18,137
https://kawalpemilu.org#53226,"PAMULANG BARAT, PAMULANG, KOTA TANGERANG SELATAN, BANTEN",90,162,59,221
https://kawalpemilu.org#53226,"PAMULANG BARAT, PAMULANG, KOTA TANGERANG SELATAN, BANTEN",91,175,63,238
https://kawalpemilu.org#53226,"PAMULANG BARAT, PAMULANG, KOTA TANGERANG SELATAN, BANTEN",92,116,72,188
https://kawalpemilu.org#53226,"PAMULANG BARAT, PAMULANG, KOTA TANGERANG SELATAN, BANTEN",93,131,55,189
https://kawalpemilu.org#53226,"PAMULANG BARAT, PAMULANG, KOTA TANGERANG SELATAN, BANTEN",94,122,61,183
https://kawalpemilu.org#53226,"PAMULANG BARAT, PAMULANG, KOTA TANGERANG SELATAN, BANTEN",95,120,29,149
https://kawalpemilu.org#53226,"PAMULANG BARAT, PAMULANG, KOTA TANGERANG SELATAN, BANTEN",96,110,78,188
https://kawalpemilu.org#53226,"PAMULANG BARAT, PAMULANG, KOTA TANGERANG SELATAN, BANTEN",97,132,99,231
https://kawalpemilu.org#53226,"PAMULANG BARAT, PAMULANG, KOTA TANGERANG SELATAN, BANTEN",98,113,64,177
https://kawalpemilu.org#53226,"PAMULANG BARAT, PAMULANG, KOTA TANGERANG SELATAN, BANTEN",99,137,67,204
https://kawalpemilu.org#53226,"PAMULANG BARAT, PAMULANG, KOTA TANGERANG SELATAN, BANTEN",100,135,69,204
https://kawalpemilu.org#53226,"PAMULANG BARAT, PAMULANG, KOTA TANGERANG SELATAN, BANTEN",101,165,74,239
https://kawalpemilu.org#53226,"PAMULANG BARAT, PAMULANG, KOTA TANGERANG SELATAN, BANTEN",102,160,82,242
https://kawalpemilu.org#53226,"PAMULANG BARAT, PAMULANG, KOTA TANGERANG SELATAN, BANTEN",103,148,84,232
https://kawalpemilu.org#53226,"PAMULANG BARAT, PAMULANG, KOTA TANGERANG SELATAN, BANTEN",104,145,55,200
https://kawalpemilu.org#53226,"PAMULANG BARAT, PAMULANG, KOTA TANGERANG SELATAN, BANTEN",105,174,90,264
https://kawalpemilu.org#53226,"PAMULANG BARAT, PAMULANG, KOTA TANGERANG SELATAN, BANTEN",106,151,63,214
https://kawalpemilu.org#53226,"PAMULANG BARAT, PAMULANG, KOTA TANGERANG SELATAN, BANTEN",107,139,52,191
https://kawalpemilu.org#53226,"PAMULANG BARAT, PAMULANG, KOTA TANGERANG SELATAN, BANTEN",108,130,93,223
https://kawalpemilu.org#53226,"PAMULANG BARAT, PAMULANG, KOTA TANGERANG SELATAN, BANTEN",109,155,95,250
https://kawalpemilu.org#53226,"PAMULANG BARAT, PAMULANG, KOTA TANGERANG SELATAN, BANTEN",110,112,100,212
https://kawalpemilu.org#53226,"PAMULANG BARAT, PAMULANG, KOTA TANGERANG SELATAN, BANTEN",111,155,68,223
https://kawalpemilu.org#53226,"PAMULANG BARAT, PAMULANG, KOTA TANGERANG SELATAN, BANTEN",112,114,70,184
https://kawalpemilu.org#53226,"PAMULANG BARAT, PAMULANG, KOTA TANGERANG SELATAN, BANTEN",113,129,43,172
https://kawalpemilu.org#53226,"PAMULANG BARAT, PAMULANG, KOTA TANGERANG SELATAN, BANTEN",114,135,93,228
https://kawalpemilu.org#53226,"PAMULANG BARAT, PAMULANG, KOTA TANGERANG SELATAN, BANTEN",115,119,69,188
https://kawalpemilu.org#53226,"PAMULANG BARAT, PAMULANG, KOTA TANGERANG SELATAN, BANTEN",116,127,81,208
https://kawalpemilu.org#53226,"PAMULANG BARAT, PAMULANG, KOTA TANGERANG SELATAN, BANTEN",117,111,100,211
https://kawalpemilu.org#53226,"PAMULANG BARAT, PAMULANG, KOTA TANGERANG SELATAN, BANTEN",118,83,77,160
https://kawalpemilu.org#53226,"PAMULANG BARAT, PAMULANG, KOTA TANGERANG SELATAN, BANTEN",119,117,49,166
https://kawalpemilu.org#53226,"PAMULANG BARAT, PAMULANG, KOTA TANGERANG SELATAN, BANTEN",120,117,65,182
https://kawalpemilu.org#53226,"PAMULANG BARAT, PAMULANG, KOTA TANGERANG SELATAN, BANTEN",121,107,53,160
https://kawalpemilu.org#53226,"PAMULANG BARAT, PAMULANG, KOTA TANGERANG SELATAN, BANTEN",122,107,75,182
https://kawalpemilu.org#53226,"PAMULANG BARAT, PAMULANG, KOTA TANGERANG SELATAN, BANTEN",123,97,60,157
https://kawalpemilu.org#53226,"PAMULANG BARAT, PAMULANG, KOTA TANGERANG SELATAN, BANTEN",124,113,97,210
https://kawalpemilu.org#53226,"PAMULANG BARAT, PAMULANG, KOTA TANGERANG SELATAN, BANTEN",125,135,89,224
https://kawalpemilu.org#53226,"PAMULANG BARAT, PAMULANG, KOTA TANGERANG SELATAN, BANTEN",126,98,97,195
https://kawalpemilu.org#53226,"PAMULANG BARAT, PAMULANG, KOTA TANGERANG SELATAN, BANTEN",127,82,58,140
https://kawalpemilu.org#53226,"PAMULANG BARAT, PAMULANG, KOTA TANGERANG SELATAN, BANTEN",128,115,92,207
https://kawalpemilu.org#53226,"PAMULANG BARAT, PAMULANG, KOTA TANGERANG SELATAN, BANTEN",129,80,141,221
https://kawalpemilu.org#53226,"PAMULANG BARAT, PAMULANG, KOTA TANGERANG SELATAN, BANTEN",130,85,80,165
https://kawalpemilu.org#53226,"PAMULANG BARAT, PAMULANG, KOTA TANGERANG SELATAN, BANTEN",131,130,91,221
https://kawalpemilu.org#53226,"PAMULANG BARAT, PAMULANG, KOTA TANGERANG SELATAN, BANTEN",132,124,117,241
https://kawalpemilu.org#53226,"PAMULANG BARAT, PAMULANG, KOTA TANGERANG SELATAN, BANTEN",133,156,83,239
https://kawalpemilu.org#53226,"PAMULANG BARAT, PAMULANG, KOTA TANGERANG SELATAN, BANTEN",134,101,103,204
https://kawalpemilu.org#53226,"PAMULANG BARAT, PAMULANG, KOTA TANGERANG SELATAN, BANTEN",135,117,75,192
https://kawalpemilu.org#53226,"PAMULANG BARAT, PAMULANG, KOTA TANGERANG SELATAN, BANTEN",136,123,55,178
https://kawalpemilu.org#53226,"PAMULANG BARAT, PAMULANG, KOTA TANGERANG SELATAN, BANTEN",137,104,54,158
https://kawalpemilu.org#53226,"PAMULANG BARAT, PAMULANG, KOTA TANGERANG SELATAN, BANTEN",138,68,35,103
https://kawalpemilu.org#53226,"PAMULANG BARAT, PAMULANG, KOTA TANGERANG SELATAN, BANTEN",139,106,59,165
https://kawalpemilu.org#53226,"PAMULANG BARAT, PAMULANG, KOTA TANGERANG SELATAN, BANTEN",140,52,76,128
https://kawalpemilu.org#53226,"PAMULANG BARAT, PAMULANG, KOTA TANGERANG SELATAN, BANTEN",141,92,66,158
https://kawalpemilu.org#53226,"PAMULANG BARAT, PAMULANG, KOTA TANGERANG SELATAN, BANTEN",142,111,99,210
https://kawalpemilu.org#53226,"PAMULANG BARAT, PAMULANG, KOTA TANGERANG SELATAN, BANTEN",144,146,115,261
https://kawalpemilu.org#53226,"PAMULANG BARAT, PAMULANG, KOTA TANGERANG SELATAN, BANTEN",145,116,113,229
https://kawalpemilu.org#53226,"PAMULANG BARAT, PAMULANG, KOTA TANGERANG SELATAN, BANTEN",146,123,116,239
https://kawalpemilu.org#53226,"PAMULANG BARAT, PAMULANG, KOTA TANGERANG SELATAN, BANTEN",147,121,89,210
https://kawalpemilu.org#53226,"PAMULANG BARAT, PAMULANG, KOTA TANGERANG SELATAN, BANTEN",148,112,111,223
https://kawalpemilu.org#53226,"PAMULANG BARAT, PAMULANG, KOTA TANGERANG SELATAN, BANTEN",150,118,132,250
https://kawalpemilu.org#53226,"PAMULANG BARAT, PAMULANG, KOTA TANGERANG SELATAN, BANTEN",151,138,86,224
https://kawalpemilu.org#53226,"PAMULANG BARAT, PAMULANG, KOTA TANGERANG SELATAN, BANTEN",152,132,46,178
https://kawalpemilu.org#53226,"PAMULANG BARAT, PAMULANG, KOTA TANGERANG SELATAN, BANTEN",153,132,74,206
https://kawalpemilu.org#53226,"PAMULANG BARAT, PAMULANG, KOTA TANGERANG SELATAN, BANTEN",154,155,57,212
https://kawalpemilu.org#53226,"PAMULANG BARAT, PAMULANG, KOTA TANGERANG SELATAN, BANTEN",155,132,58,190
https://kawalpemilu.org#53226,"PAMULANG BARAT, PAMULANG, KOTA TANGERANG SELATAN, BANTEN",156,103,121,224
https://kawalpemilu.org#53226,"PAMULANG BARAT, PAMULANG, KOTA TANGERANG SELATAN, BANTEN",157,94,70,164
https://kawalpemilu.org#53226,"PAMULANG BARAT, PAMULANG, KOTA TANGERANG SELATAN, BANTEN",158,97,54,151
https://kawalpemilu.org#53226,"PAMULANG BARAT, PAMULANG, KOTA TANGERANG SELATAN, BANTEN",159,127,114,241
https://kawalpemilu.org#53226,"PAMULANG BARAT, PAMULANG, KOTA TANGERANG SELATAN, BANTEN",160,133,123,256
https://kawalpemilu.org#53226,"PAMULANG BARAT, PAMULANG, KOTA TANGERANG SELATAN, BANTEN",161,59,80,139
https://kawalpemilu.org#53227,"BENDA BARU, PAMULANG, KOTA TANGERANG SELATAN, BANTEN",1,82,161,243
https://kawalpemilu.org#53227,"BENDA BARU, PAMULANG, KOTA TANGERANG SELATAN, BANTEN",2,65,160,225
https://kawalpemilu.org#53227,"BENDA BARU, PAMULANG, KOTA TANGERANG SELATAN, BANTEN",3,79,143,222
https://kawalpemilu.org#53227,"BENDA BARU, PAMULANG, KOTA TANGERANG SELATAN, BANTEN",4,57,138,195
https://kawalpemilu.org#53227,"BENDA BARU, PAMULANG, KOTA TANGERANG SELATAN, BANTEN",5,60,184,244
https://kawalpemilu.org#53227,"BENDA BARU, PAMULANG, KOTA TANGERANG SELATAN, BANTEN",6,86,148,234
https://kawalpemilu.org#53227,"BENDA BARU, PAMULANG, KOTA TANGERANG SELATAN, BANTEN",7,80,137,217
https://kawalpemilu.org#53227,"BENDA BARU, PAMULANG, KOTA TANGERANG SELATAN, BANTEN",8,64,138,202
https://kawalpemilu.org#53227,"BENDA BARU, PAMULANG, KOTA TANGERANG SELATAN, BANTEN",9,63,165,228
https://kawalpemilu.org#53227,"BENDA BARU, PAMULANG, KOTA TANGERANG SELATAN, BANTEN",10,75,148,223
https://kawalpemilu.org#53227,"BENDA BARU, PAMULANG, KOTA TANGERANG SELATAN, BANTEN",11,71,136,207
https://kawalpemilu.org#53227,"BENDA BARU, PAMULANG, KOTA TANGERANG SELATAN, BANTEN",12,72,135,207
https://kawalpemilu.org#53227,"BENDA BARU, PAMULANG, KOTA TANGERANG SELATAN, BANTEN",13,99,192,291
https://kawalpemilu.org#53227,"BENDA BARU, PAMULANG, KOTA TANGERANG SELATAN, BANTEN",14,105,137,242
https://kawalpemilu.org#53227,"BENDA BARU, PAMULANG, KOTA TANGERANG SELATAN, BANTEN",15,102,159,261
https://kawalpemilu.org#53227,"BENDA BARU, PAMULANG, KOTA TANGERANG SELATAN, BANTEN",16,80,113,193
https://kawalpemilu.org#53227,"BENDA BARU, PAMULANG, KOTA TANGERANG SELATAN, BANTEN",17,84,119,203
https://kawalpemilu.org#53227,"BENDA BARU, PAMULANG, KOTA TANGERANG SELATAN, BANTEN",18,133,131,264
https://kawalpemilu.org#53227,"BENDA BARU, PAMULANG, KOTA TANGERANG SELATAN, BANTEN",19,90,132,222
https://kawalpemilu.org#53227,"BENDA BARU, PAMULANG, KOTA TANGERANG SELATAN, BANTEN",20,96,117,213
https://kawalpemilu.org#53227,"BENDA BARU, PAMULANG, KOTA TANGERANG SELATAN, BANTEN",21,85,146,231
https://kawalpemilu.org#53227,"BENDA BARU, PAMULANG, KOTA TANGERANG SELATAN, BANTEN",22,97,142,239
https://kawalpemilu.org#53227,"BENDA BARU, PAMULANG, KOTA TANGERANG SELATAN, BANTEN",23,134,91,225
https://kawalpemilu.org#53227,"BENDA BARU, PAMULANG, KOTA TANGERANG SELATAN, BANTEN",24,87,78,165
https://kawalpemilu.org#53227,"BENDA BARU, PAMULANG, KOTA TANGERANG SELATAN, BANTEN",25,86,126,212
https://kawalpemilu.org#53227,"BENDA BARU, PAMULANG, KOTA TANGERANG SELATAN, BANTEN",26,124,68,192
https://kawalpemilu.org#53227,"BENDA BARU, PAMULANG, KOTA TANGERANG SELATAN, BANTEN",27,97,119,216
https://kawalpemilu.org#53227,"BENDA BARU, PAMULANG, KOTA TANGERANG SELATAN, BANTEN",28,87,105,192
https://kawalpemilu.org#53227,"BENDA BARU, PAMULANG, KOTA TANGERANG SELATAN, BANTEN",29,91,101,192
https://kawalpemilu.org#53227,"BENDA BARU, PAMULANG, KOTA TANGERANG SELATAN, BANTEN",30,92,51,143
https://kawalpemilu.org#53227,"BENDA BARU, PAMULANG, KOTA TANGERANG SELATAN, BANTEN",31,86,103,189
https://kawalpemilu.org#53227,"BENDA BARU, PAMULANG, KOTA TANGERANG SELATAN, BANTEN",32,116,55,171
https://kawalpemilu.org#53227,"BENDA BARU, PAMULANG, KOTA TANGERANG SELATAN, BANTEN",33,103,91,194
https://kawalpemilu.org#53227,"BENDA BARU, PAMULANG, KOTA TANGERANG SELATAN, BANTEN",34,107,84,191
https://kawalpemilu.org#53227,"BENDA BARU, PAMULANG, KOTA TANGERANG SELATAN, BANTEN",35,85,105,190
https://kawalpemilu.org#53227,"BENDA BARU, PAMULANG, KOTA TANGERANG SELATAN, BANTEN",36,89,127,216
https://kawalpemilu.org#53227,"BENDA BARU, PAMULANG, KOTA TANGERANG SELATAN, BANTEN",37,110,96,206
https://kawalpemilu.org#53227,"BENDA BARU, PAMULANG, KOTA TANGERANG SELATAN, BANTEN",38,72,91,163
https://kawalpemilu.org#53227,"BENDA BARU, PAMULANG, KOTA TANGERANG SELATAN, BANTEN",39,103,61,164
https://kawalpemilu.org#53227,"BENDA BARU, PAMULANG, KOTA TANGERANG SELATAN, BANTEN",40,98,95,193
https://kawalpemilu.org#53227,"BENDA BARU, PAMULANG, KOTA TANGERANG SELATAN, BANTEN",41,98,82,180
https://kawalpemilu.org#53227,"BENDA BARU, PAMULANG, KOTA TANGERANG SELATAN, BANTEN",42,51,64,115
https://kawalpemilu.org#53227,"BENDA BARU, PAMULANG, KOTA TANGERANG SELATAN, BANTEN",43,89,95,184
https://kawalpemilu.org#53227,"BENDA BARU, PAMULANG, KOTA TANGERANG SELATAN, BANTEN",44,116,64,180
https://kawalpemilu.org#53227,"BENDA BARU, PAMULANG, KOTA TANGERANG SELATAN, BANTEN",45,118,127,245
https://kawalpemilu.org#53227,"BENDA BARU, PAMULANG, KOTA TANGERANG SELATAN, BANTEN",46,143,79,222
https://kawalpemilu.org#53227,"BENDA BARU, PAMULANG, KOTA TANGERANG SELATAN, BANTEN",47,77,40,117
https://kawalpemilu.org#53227,"BENDA BARU, PAMULANG, KOTA TANGERANG SELATAN, BANTEN",48,93,61,154
https://kawalpemilu.org#53227,"BENDA BARU, PAMULANG, KOTA TANGERANG SELATAN, BANTEN",49,68,75,143
https://kawalpemilu.org#53227,"BENDA BARU, PAMULANG, KOTA TANGERANG SELATAN, BANTEN",50,98,86,184
https://kawalpemilu.org#53227,"BENDA BARU, PAMULANG, KOTA TANGERANG SELATAN, BANTEN",51,93,106,199
https://kawalpemilu.org#53227,"BENDA BARU, PAMULANG, KOTA TANGERANG SELATAN, BANTEN",52,98,88,186
https://kawalpemilu.org#53227,"BENDA BARU, PAMULANG, KOTA TANGERANG SELATAN, BANTEN",53,71,122,193
https://kawalpemilu.org#53227,"BENDA BARU, PAMULANG, KOTA TANGERANG SELATAN, BANTEN",55,52,103,155
https://kawalpemilu.org#53227,"BENDA BARU, PAMULANG, KOTA TANGERANG SELATAN, BANTEN",56,107,76,183
https://kawalpemilu.org#53227,"BENDA BARU, PAMULANG, KOTA TANGERANG SELATAN, BANTEN",57,105,103,208
https://kawalpemilu.org#53227,"BENDA BARU, PAMULANG, KOTA TANGERANG SELATAN, BANTEN",58,94,110,204
https://kawalpemilu.org#53227,"BENDA BARU, PAMULANG, KOTA TANGERANG SELATAN, BANTEN",59,79,69,148
https://kawalpemilu.org#53227,"BENDA BARU, PAMULANG, KOTA TANGERANG SELATAN, BANTEN",60,91,95,186
https://kawalpemilu.org#53227,"BENDA BARU, PAMULANG, KOTA TANGERANG SELATAN, BANTEN",61,61,85,146
https://kawalpemilu.org#53227,"BENDA BARU, PAMULANG, KOTA TANGERANG SELATAN, BANTEN",62,97,133,230
https://kawalpemilu.org#53227,"BENDA BARU, PAMULANG, KOTA TANGERANG SELATAN, BANTEN",63,101,119,220
https://kawalpemilu.org#53227,"BENDA BARU, PAMULANG, KOTA TANGERANG SELATAN, BANTEN",64,129,56,185
https://kawalpemilu.org#53227,"BENDA BARU, PAMULANG, KOTA TANGERANG SELATAN, BANTEN",65,76,86,162
https://kawalpemilu.org#53227,"BENDA BARU, PAMULANG, KOTA TANGERANG SELATAN, BANTEN",66,79,73,152
https://kawalpemilu.org#53227,"BENDA BARU, PAMULANG, KOTA TANGERANG SELATAN, BANTEN",67,90,32,122
https://kawalpemilu.org#53227,"BENDA BARU, PAMULANG, KOTA TANGERANG SELATAN, BANTEN",68,136,100,236
https://kawalpemilu.org#53227,"BENDA BARU, PAMULANG, KOTA TANGERANG SELATAN, BANTEN",69,95,94,5
https://kawalpemilu.org#53227,"BENDA BARU, PAMULANG, KOTA TANGERANG SELATAN, BANTEN",70,109,97,206
https://kawalpemilu.org#53227,"BENDA BARU, PAMULANG, KOTA TANGERANG SELATAN, BANTEN",71,81,108,189
https://kawalpemilu.org#53227,"BENDA BARU, PAMULANG, KOTA TANGERANG SELATAN, BANTEN",72,120,91,211
https://kawalpemilu.org#53227,"BENDA BARU, PAMULANG, KOTA TANGERANG SELATAN, BANTEN",73,112,120,232
https://kawalpemilu.org#53227,"BENDA BARU, PAMULANG, KOTA TANGERANG SELATAN, BANTEN",74,108,122,230
https://kawalpemilu.org#53227,"BENDA BARU, PAMULANG, KOTA TANGERANG SELATAN, BANTEN",75,108,51,159
https://kawalpemilu.org#53227,"BENDA BARU, PAMULANG, KOTA TANGERANG SELATAN, BANTEN",76,99,111,210
https://kawalpemilu.org#53227,"BENDA BARU, PAMULANG, KOTA TANGERANG SELATAN, BANTEN",77,113,147,260
https://kawalpemilu.org#53227,"BENDA BARU, PAMULANG, KOTA TANGERANG SELATAN, BANTEN",78,113,100,213
https://kawalpemilu.org#53227,"BENDA BARU, PAMULANG, KOTA TANGERANG SELATAN, BANTEN",79,71,58,129
https://kawalpemilu.org#53227,"BENDA BARU, PAMULANG, KOTA TANGERANG SELATAN, BANTEN",80,116,95,211
https://kawalpemilu.org#53227,"BENDA BARU, PAMULANG, KOTA TANGERANG SELATAN, BANTEN",81,88,59,147
https://kawalpemilu.org#53227,"BENDA BARU, PAMULANG, KOTA TANGERANG SELATAN, BANTEN",83,137,76,213
https://kawalpemilu.org#53227,"BENDA BARU, PAMULANG, KOTA TANGERANG SELATAN, BANTEN",84,75,76,151
https://kawalpemilu.org#53227,"BENDA BARU, PAMULANG, KOTA TANGERANG SELATAN, BANTEN",85,86,95,181
https://kawalpemilu.org#53227,"BENDA BARU, PAMULANG, KOTA TANGERANG SELATAN, BANTEN",86,128,88,216
https://kawalpemilu.org#53227,"BENDA BARU, PAMULANG, KOTA TANGERANG SELATAN, BANTEN",87,84,93,177
https://kawalpemilu.org#53227,"BENDA BARU, PAMULANG, KOTA TANGERANG SELATAN, BANTEN",88,119,98,217
https://kawalpemilu.org#53227,"BENDA BARU, PAMULANG, KOTA TANGERANG SELATAN, BANTEN",89,121,93,214
https://kawalpemilu.org#53227,"BENDA BARU, PAMULANG, KOTA TANGERANG SELATAN, BANTEN",90,150,72,222
https://kawalpemilu.org#53227,"BENDA BARU, PAMULANG, KOTA TANGERANG SELATAN, BANTEN",91,70,77,147
https://kawalpemilu.org#53227,"BENDA BARU, PAMULANG, KOTA TANGERANG SELATAN, BANTEN",92,76,68,144
https://kawalpemilu.org#53227,"BENDA BARU, PAMULANG, KOTA TANGERANG SELATAN, BANTEN",93,139,83,222
https://kawalpemilu.org#53227,"BENDA BARU, PAMULANG, KOTA TANGERANG SELATAN, BANTEN",94,126,55,181
https://kawalpemilu.org#53227,"BENDA BARU, PAMULANG, KOTA TANGERANG SELATAN, BANTEN",95,81,79,160
https://kawalpemilu.org#53227,"BENDA BARU, PAMULANG, KOTA TANGERANG SELATAN, BANTEN",96,72,60,132
https://kawalpemilu.org#53227,"BENDA BARU, PAMULANG, KOTA TANGERANG SELATAN, BANTEN",97,92,71,163
https://kawalpemilu.org#53227,"BENDA BARU, PAMULANG, KOTA TANGERANG SELATAN, BANTEN",98,60,99,159
https://kawalpemilu.org#53227,"BENDA BARU, PAMULANG, KOTA TANGERANG SELATAN, BANTEN",99,90,148,238
https://kawalpemilu.org#53227,"BENDA BARU, PAMULANG, KOTA TANGERANG SELATAN, BANTEN",100,74,126,200
https://kawalpemilu.org#53227,"BENDA BARU, PAMULANG, KOTA TANGERANG SELATAN, BANTEN",101,105,136,241
https://kawalpemilu.org#53227,"BENDA BARU, PAMULANG, KOTA TANGERANG SELATAN, BANTEN",103,120,105,225
https://kawalpemilu.org#53227,"BENDA BARU, PAMULANG, KOTA TANGERANG SELATAN, BANTEN",104,123,116,239
https://kawalpemilu.org#53227,"BENDA BARU, PAMULANG, KOTA TANGERANG SELATAN, BANTEN",105,108,118,226
https://kawalpemilu.org#53227,"BENDA BARU, PAMULANG, KOTA TANGERANG SELATAN, BANTEN",106,110,135,245
https://kawalpemilu.org#53227,"BENDA BARU, PAMULANG, KOTA TANGERANG SELATAN, BANTEN",107,119,142,261
https://kawalpemilu.org#53227,"BENDA BARU, PAMULANG, KOTA TANGERANG SELATAN, BANTEN",108,104,96,200
https://kawalpemilu.org#53227,"BENDA BARU, PAMULANG, KOTA TANGERANG SELATAN, BANTEN",109,168,78,246
https://kawalpemilu.org#53227,"BENDA BARU, PAMULANG, KOTA TANGERANG SELATAN, BANTEN",110,140,57,197
https://kawalpemilu.org#53227,"BENDA BARU, PAMULANG, KOTA TANGERANG SELATAN, BANTEN",111,149,95,244
https://kawalpemilu.org#53227,"BENDA BARU, PAMULANG, KOTA TANGERANG SELATAN, BANTEN",112,116,145,261
https://kawalpemilu.org#53227,"BENDA BARU, PAMULANG, KOTA TANGERANG SELATAN, BANTEN",113,115,76,191
https://kawalpemilu.org#53227,"BENDA BARU, PAMULANG, KOTA TANGERANG SELATAN, BANTEN",114,104,95,199
https://kawalpemilu.org#53227,"BENDA BARU, PAMULANG, KOTA TANGERANG SELATAN, BANTEN",115,81,106,187
https://kawalpemilu.org#53227,"BENDA BARU, PAMULANG, KOTA TANGERANG SELATAN, BANTEN",116,44,74,118
https://kawalpemilu.org#53227,"BENDA BARU, PAMULANG, KOTA TANGERANG SELATAN, BANTEN",117,73,123,196
https://kawalpemilu.org#53227,"BENDA BARU, PAMULANG, KOTA TANGERANG SELATAN, BANTEN",118,84,124,208
https://kawalpemilu.org#53227,"BENDA BARU, PAMULANG, KOTA TANGERANG SELATAN, BANTEN",119,74,64,138
https://kawalpemilu.org#53227,"BENDA BARU, PAMULANG, KOTA TANGERANG SELATAN, BANTEN",120,130,120,250
https://kawalpemilu.org#53227,"BENDA BARU, PAMULANG, KOTA TANGERANG SELATAN, BANTEN",121,107,73,180
https://kawalpemilu.org#53227,"BENDA BARU, PAMULANG, KOTA TANGERANG SELATAN, BANTEN",122,108,78,186
https://kawalpemilu.org#53227,"BENDA BARU, PAMULANG, KOTA TANGERANG SELATAN, BANTEN",123,65,76,141
https://kawalpemilu.org#53227,"BENDA BARU, PAMULANG, KOTA TANGERANG SELATAN, BANTEN",124,82,60,142
https://kawalpemilu.org#53227,"BENDA BARU, PAMULANG, KOTA TANGERANG SELATAN, BANTEN",125,94,58,152
https://kawalpemilu.org#53227,"BENDA BARU, PAMULANG, KOTA TANGERANG SELATAN, BANTEN",126,91,111,202
https://kawalpemilu.org#53227,"BENDA BARU, PAMULANG, KOTA TANGERANG SELATAN, BANTEN",127,115,85,200
https://kawalpemilu.org#53227,"BENDA BARU, PAMULANG, KOTA TANGERANG SELATAN, BANTEN",128,85,109,194
https://kawalpemilu.org#53228,"PONDOK BENDA, PAMULANG, KOTA TANGERANG SELATAN, BANTEN",1,60,73,133
https://kawalpemilu.org#53228,"PONDOK BENDA, PAMULANG, KOTA TANGERANG SELATAN, BANTEN",2,75,101,176
https://kawalpemilu.org#53228,"PONDOK BENDA, PAMULANG, KOTA TANGERANG SELATAN, BANTEN",3,123,117,240
https://kawalpemilu.org#53228,"PONDOK BENDA, PAMULANG, KOTA TANGERANG SELATAN, BANTEN",4,79,131,210
https://kawalpemilu.org#53228,"PONDOK BENDA, PAMULANG, KOTA TANGERANG SELATAN, BANTEN",5,70,135,205
https://kawalpemilu.org#53228,"PONDOK BENDA, PAMULANG, KOTA TANGERANG SELATAN, BANTEN",6,132,107,239
https://kawalpemilu.org#53228,"PONDOK BENDA, PAMULANG, KOTA TANGERANG SELATAN, BANTEN",7,106,111,217
https://kawalpemilu.org#53228,"PONDOK BENDA, PAMULANG, KOTA TANGERANG SELATAN, BANTEN",8,124,120,244
https://kawalpemilu.org#53228,"PONDOK BENDA, PAMULANG, KOTA TANGERANG SELATAN, BANTEN",9,120,76,196
https://kawalpemilu.org#53228,"PONDOK BENDA, PAMULANG, KOTA TANGERANG SELATAN, BANTEN",10,87,133,220
https://kawalpemilu.org#53228,"PONDOK BENDA, PAMULANG, KOTA TANGERANG SELATAN, BANTEN",11,105,117,222
https://kawalpemilu.org#53228,"PONDOK BENDA, PAMULANG, KOTA TANGERANG SELATAN, BANTEN",12,106,139,245
https://kawalpemilu.org#53228,"PONDOK BENDA, PAMULANG, KOTA TANGERANG SELATAN, BANTEN",13,132,97,229
https://kawalpemilu.org#53228,"PONDOK BENDA, PAMULANG, KOTA TANGERANG SELATAN, BANTEN",14,119,92,211
https://kawalpemilu.org#53228,"PONDOK BENDA, PAMULANG, KOTA TANGERANG SELATAN, BANTEN",16,106,116,222
https://kawalpemilu.org#53228,"PONDOK BENDA, PAMULANG, KOTA TANGERANG SELATAN, BANTEN",17,97,163,260
https://kawalpemilu.org#53228,"PONDOK BENDA, PAMULANG, KOTA TANGERANG SELATAN, BANTEN",18,92,125,217
https://kawalpemilu.org#53228,"PONDOK BENDA, PAMULANG, KOTA TANGERANG SELATAN, BANTEN",19,99,133,232
https://kawalpemilu.org#53228,"PONDOK BENDA, PAMULANG, KOTA TANGERANG SELATAN, BANTEN",20,74,142,216
https://kawalpemilu.org#53228,"PONDOK BENDA, PAMULANG, KOTA TANGERANG SELATAN, BANTEN",21,81,166,247
https://kawalpemilu.org#53228,"PONDOK BENDA, PAMULANG, KOTA TANGERANG SELATAN, BANTEN",22,104,89,193
https://kawalpemilu.org#53228,"PONDOK BENDA, PAMULANG, KOTA TANGERANG SELATAN, BANTEN",23,134,91,225
https://kawalpemilu.org#53228,"PONDOK BENDA, PAMULANG, KOTA TANGERANG SELATAN, BANTEN",24,69,113,182
https://kawalpemilu.org#53228,"PONDOK BENDA, PAMULANG, KOTA TANGERANG SELATAN, BANTEN",25,98,103,201
https://kawalpemilu.org#53228,"PONDOK BENDA, PAMULANG, KOTA TANGERANG SELATAN, BANTEN",26,103,120,223
https://kawalpemilu.org#53228,"PONDOK BENDA, PAMULANG, KOTA TANGERANG SELATAN, BANTEN",27,113,132,245
https://kawalpemilu.org#53228,"PONDOK BENDA, PAMULANG, KOTA TANGERANG SELATAN, BANTEN",28,69,167,236
https://kawalpemilu.org#53228,"PONDOK BENDA, PAMULANG, KOTA TANGERANG SELATAN, BANTEN",29,101,96,197
https://kawalpemilu.org#53228,"PONDOK BENDA, PAMULANG, KOTA TANGERANG SELATAN, BANTEN",30,89,108,197
https://kawalpemilu.org#53228,"PONDOK BENDA, PAMULANG, KOTA TANGERANG SELATAN, BANTEN",31,86,103,189
https://kawalpemilu.org#53228,"PONDOK BENDA, PAMULANG, KOTA TANGERANG SELATAN, BANTEN",32,99,104,203
https://kawalpemilu.org#53228,"PONDOK BENDA, PAMULANG, KOTA TANGERANG SELATAN, BANTEN",33,94,117,211
https://kawalpemilu.org#53228,"PONDOK BENDA, PAMULANG, KOTA TANGERANG SELATAN, BANTEN",34,171,67,238
https://kawalpemilu.org#53228,"PONDOK BENDA, PAMULANG, KOTA TANGERANG SELATAN, BANTEN",35,85,105,190
https://kawalpemilu.org#53228,"PONDOK BENDA, PAMULANG, KOTA TANGERANG SELATAN, BANTEN",36,86,65,151
https://kawalpemilu.org#53228,"PONDOK BENDA, PAMULANG, KOTA TANGERANG SELATAN, BANTEN",37,152,56,208
https://kawalpemilu.org#53228,"PONDOK BENDA, PAMULANG, KOTA TANGERANG SELATAN, BANTEN",38,126,70,196
https://kawalpemilu.org#53228,"PONDOK BENDA, PAMULANG, KOTA TANGERANG SELATAN, BANTEN",39,57,102,159
https://kawalpemilu.org#53228,"PONDOK BENDA, PAMULANG, KOTA TANGERANG SELATAN, BANTEN",40,96,107,203
https://kawalpemilu.org#53228,"PONDOK BENDA, PAMULANG, KOTA TANGERANG SELATAN, BANTEN",41,109,97,206
https://kawalpemilu.org#53228,"PONDOK BENDA, PAMULANG, KOTA TANGERANG SELATAN, BANTEN",42,114,113,227
https://kawalpemilu.org#53228,"PONDOK BENDA, PAMULANG, KOTA TANGERANG SELATAN, BANTEN",43,153,92,245
https://kawalpemilu.org#53228,"PONDOK BENDA, PAMULANG, KOTA TANGERANG SELATAN, BANTEN",44,124,75,199
https://kawalpemilu.org#53228,"PONDOK BENDA, PAMULANG, KOTA TANGERANG SELATAN, BANTEN",45,119,111,230
https://kawalpemilu.org#53228,"PONDOK BENDA, PAMULANG, KOTA TANGERANG SELATAN, BANTEN",46,143,79,222
https://kawalpemilu.org#53228,"PONDOK BENDA, PAMULANG, KOTA TANGERANG SELATAN, BANTEN",47,128,122,250
https://kawalpemilu.org#53228,"PONDOK BENDA, PAMULANG, KOTA TANGERANG SELATAN, BANTEN",48,0,0,0
https://kawalpemilu.org#53228,"PONDOK BENDA, PAMULANG, KOTA TANGERANG SELATAN, BANTEN",49,112,120,232
https://kawalpemilu.org#53228,"PONDOK BENDA, PAMULANG, KOTA TANGERANG SELATAN, BANTEN",50,118,103,221
https://kawalpemilu.org#53228,"PONDOK BENDA, PAMULANG, KOTA TANGERANG SELATAN, BANTEN",51,118,91,209
https://kawalpemilu.org#53228,"PONDOK BENDA, PAMULANG, KOTA TANGERANG SELATAN, BANTEN",54,94,104,198
https://kawalpemilu.org#53228,"PONDOK BENDA, PAMULANG, KOTA TANGERANG SELATAN, BANTEN",55,159,113,272
https://kawalpemilu.org#53228,"PONDOK BENDA, PAMULANG, KOTA TANGERANG SELATAN, BANTEN",56,153,135,288
https://kawalpemilu.org#53228,"PONDOK BENDA, PAMULANG, KOTA TANGERANG SELATAN, BANTEN",57,97,81,178
https://kawalpemilu.org#53228,"PONDOK BENDA, PAMULANG, KOTA TANGERANG SELATAN, BANTEN",58,94,84,178
https://kawalpemilu.org#53228,"PONDOK BENDA, PAMULANG, KOTA TANGERANG SELATAN, BANTEN",59,147,112,259
https://kawalpemilu.org#53228,"PONDOK BENDA, PAMULANG, KOTA TANGERANG SELATAN, BANTEN",60,132,91,223
https://kawalpemilu.org#53228,"PONDOK BENDA, PAMULANG, KOTA TANGERANG SELATAN, BANTEN",61,109,84,193
https://kawalpemilu.org#53228,"PONDOK BENDA, PAMULANG, KOTA TANGERANG SELATAN, BANTEN",62,68,75,143
https://kawalpemilu.org#53228,"PONDOK BENDA, PAMULANG, KOTA TANGERANG SELATAN, BANTEN",63,123,109,232
https://kawalpemilu.org#53228,"PONDOK BENDA, PAMULANG, KOTA TANGERANG SELATAN, BANTEN",64,136,99,235
https://kawalpemilu.org#53228,"PONDOK BENDA, PAMULANG, KOTA TANGERANG SELATAN, BANTEN",65,132,94,226
https://kawalpemilu.org#53228,"PONDOK BENDA, PAMULANG, KOTA TANGERANG SELATAN, BANTEN",66,121,124,245
https://kawalpemilu.org#53228,"PONDOK BENDA, PAMULANG, KOTA TANGERANG SELATAN, BANTEN",67,109,93,202
https://kawalpemilu.org#53228,"PONDOK BENDA, PAMULANG, KOTA TANGERANG SELATAN, BANTEN",68,117,102,219
https://kawalpemilu.org#53228,"PONDOK BENDA, PAMULANG, KOTA TANGERANG SELATAN, BANTEN",69,96,90,186
https://kawalpemilu.org#53228,"PONDOK BENDA, PAMULANG, KOTA TANGERANG SELATAN, BANTEN",70,111,112,223
https://kawalpemilu.org#53228,"PONDOK BENDA, PAMULANG, KOTA TANGERANG SELATAN, BANTEN",71,144,94,238
https://kawalpemilu.org#53228,"PONDOK BENDA, PAMULANG, KOTA TANGERANG SELATAN, BANTEN",72,116,117,233
https://kawalpemilu.org#53228,"PONDOK BENDA, PAMULANG, KOTA TANGERANG SELATAN, BANTEN",73,101,120,221
https://kawalpemilu.org#53228,"PONDOK BENDA, PAMULANG, KOTA TANGERANG SELATAN, BANTEN",74,100,112,212
https://kawalpemilu.org#53228,"PONDOK BENDA, PAMULANG, KOTA TANGERANG SELATAN, BANTEN",75,109,103,212
https://kawalpemilu.org#53228,"PONDOK BENDA, PAMULANG, KOTA TANGERANG SELATAN, BANTEN",76,111,99,210
https://kawalpemilu.org#53228,"PONDOK BENDA, PAMULANG, KOTA TANGERANG SELATAN, BANTEN",77,113,105,218
https://kawalpemilu.org#53228,"PONDOK BENDA, PAMULANG, KOTA TANGERANG SELATAN, BANTEN",78,133,92,225
https://kawalpemilu.org#53228,"PONDOK BENDA, PAMULANG, KOTA TANGERANG SELATAN, BANTEN",79,133,101,234
https://kawalpemilu.org#53228,"PONDOK BENDA, PAMULANG, KOTA TANGERANG SELATAN, BANTEN",80,118,102,220
https://kawalpemilu.org#53228,"PONDOK BENDA, PAMULANG, KOTA TANGERANG SELATAN, BANTEN",81,109,124,233
https://kawalpemilu.org#53228,"PONDOK BENDA, PAMULANG, KOTA TANGERANG SELATAN, BANTEN",82,143,106,249
https://kawalpemilu.org#53228,"PONDOK BENDA, PAMULANG, KOTA TANGERANG SELATAN, BANTEN",83,69,143,212
https://kawalpemilu.org#53228,"PONDOK BENDA, PAMULANG, KOTA TANGERANG SELATAN, BANTEN",84,52,150,202
https://kawalpemilu.org#53228,"PONDOK BENDA, PAMULANG, KOTA TANGERANG SELATAN, BANTEN",85,141,99,240
https://kawalpemilu.org#53228,"PONDOK BENDA, PAMULANG, KOTA TANGERANG SELATAN, BANTEN",86,123,107,230
https://kawalpemilu.org#53228,"PONDOK BENDA, PAMULANG, KOTA TANGERANG SELATAN, BANTEN",87,134,91,225
https://kawalpemilu.org#53228,"PONDOK BENDA, PAMULANG, KOTA TANGERANG SELATAN, BANTEN",88,130,88,218
https://kawalpemilu.org#53228,"PONDOK BENDA, PAMULANG, KOTA TANGERANG SELATAN, BANTEN",89,144,92,236
https://kawalpemilu.org#53228,"PONDOK BENDA, PAMULANG, KOTA TANGERANG SELATAN, BANTEN",90,174,81,255
https://kawalpemilu.org#53228,"PONDOK BENDA, PAMULANG, KOTA TANGERANG SELATAN, BANTEN",91,127,98,225
https://kawalpemilu.org#53228,"PONDOK BENDA, PAMULANG, KOTA TANGERANG SELATAN, BANTEN",92,133,56,189
https://kawalpemilu.org#53228,"PONDOK BENDA, PAMULANG, KOTA TANGERANG SELATAN, BANTEN",93,79,84,163
https://kawalpemilu.org#53228,"PONDOK BENDA, PAMULANG, KOTA TANGERANG SELATAN, BANTEN",94,113,83,196
https://kawalpemilu.org#53228,"PONDOK BENDA, PAMULANG, KOTA TANGERANG SELATAN, BANTEN",95,127,107,234
https://kawalpemilu.org#53228,"PONDOK BENDA, PAMULANG, KOTA TANGERANG SELATAN, BANTEN",96,119,90,209
https://kawalpemilu.org#53228,"PONDOK BENDA, PAMULANG, KOTA TANGERANG SELATAN, BANTEN",97,92,117,209
https://kawalpemilu.org#53228,"PONDOK BENDA, PAMULANG, KOTA TANGERANG SELATAN, BANTEN",98,135,60,195
https://kawalpemilu.org#53228,"PONDOK BENDA, PAMULANG, KOTA TANGERANG SELATAN, BANTEN",99,135,100,235
https://kawalpemilu.org#53228,"PONDOK BENDA, PAMULANG, KOTA TANGERANG SELATAN, BANTEN",100,157,79,236
https://kawalpemilu.org#53228,"PONDOK BENDA, PAMULANG, KOTA TANGERANG SELATAN, BANTEN",101,123,91,214
https://kawalpemilu.org#53228,"PONDOK BENDA, PAMULANG, KOTA TANGERANG SELATAN, BANTEN",102,144,114,258
https://kawalpemilu.org#53228,"PONDOK BENDA, PAMULANG, KOTA TANGERANG SELATAN, BANTEN",103,79,86,165
https://kawalpemilu.org#53228,"PONDOK BENDA, PAMULANG, KOTA TANGERANG SELATAN, BANTEN",104,123,106,229
https://kawalpemilu.org#53228,"PONDOK BENDA, PAMULANG, KOTA TANGERANG SELATAN, BANTEN",105,131,76,207
https://kawalpemilu.org#53228,"PONDOK BENDA, PAMULANG, KOTA TANGERANG SELATAN, BANTEN",106,112,99,211
https://kawalpemilu.org#53228,"PONDOK BENDA, PAMULANG, KOTA TANGERANG SELATAN, BANTEN",107,114,134,248
https://kawalpemilu.org#53228,"PONDOK BENDA, PAMULANG, KOTA TANGERANG SELATAN, BANTEN",108,123,76,199
https://kawalpemilu.org#53228,"PONDOK BENDA, PAMULANG, KOTA TANGERANG SELATAN, BANTEN",109,149,70,219
https://kawalpemilu.org#53228,"PONDOK BENDA, PAMULANG, KOTA TANGERANG SELATAN, BANTEN",110,121,124,245
https://kawalpemilu.org#53228,"PONDOK BENDA, PAMULANG, KOTA TANGERANG SELATAN, BANTEN",111,124,156,280
https://kawalpemilu.org#53228,"PONDOK BENDA, PAMULANG, KOTA TANGERANG SELATAN, BANTEN",112,93,107,200
https://kawalpemilu.org#53228,"PONDOK BENDA, PAMULANG, KOTA TANGERANG SELATAN, BANTEN",113,116,97,213
https://kawalpemilu.org#53228,"PONDOK BENDA, PAMULANG, KOTA TANGERANG SELATAN, BANTEN",114,115,140,255
https://kawalpemilu.org#53228,"PONDOK BENDA, PAMULANG, KOTA TANGERANG SELATAN, BANTEN",115,155,124,279
https://kawalpemilu.org#53228,"PONDOK BENDA, PAMULANG, KOTA TANGERANG SELATAN, BANTEN",116,106,102,208
https://kawalpemilu.org#53228,"PONDOK BENDA, PAMULANG, KOTA TANGERANG SELATAN, BANTEN",117,74,94,168
https://kawalpemilu.org#53228,"PONDOK BENDA, PAMULANG, KOTA TANGERANG SELATAN, BANTEN",118,148,73,221
https://kawalpemilu.org#53228,"PONDOK BENDA, PAMULANG, KOTA TANGERANG SELATAN, BANTEN",119,115,96,211
https://kawalpemilu.org#53228,"PONDOK BENDA, PAMULANG, KOTA TANGERANG SELATAN, BANTEN",120,118,99,217
https://kawalpemilu.org#53228,"PONDOK BENDA, PAMULANG, KOTA TANGERANG SELATAN, BANTEN",122,121,107,228
https://kawalpemilu.org#53228,"PONDOK BENDA, PAMULANG, KOTA TANGERANG SELATAN, BANTEN",123,126,96,222
https://kawalpemilu.org#53228,"PONDOK BENDA, PAMULANG, KOTA TANGERANG SELATAN, BANTEN",124,127,113,240
https://kawalpemilu.org#53228,"PONDOK BENDA, PAMULANG, KOTA TANGERANG SELATAN, BANTEN",125,98,130,228
https://kawalpemilu.org#53228,"PONDOK BENDA, PAMULANG, KOTA TANGERANG SELATAN, BANTEN",126,140,111,251
https://kawalpemilu.org#53228,"PONDOK BENDA, PAMULANG, KOTA TANGERANG SELATAN, BANTEN",127,103,87,190
https://kawalpemilu.org#53228,"PONDOK BENDA, PAMULANG, KOTA TANGERANG SELATAN, BANTEN",128,130,104,234
https://kawalpemilu.org#53228,"PONDOK BENDA, PAMULANG, KOTA TANGERANG SELATAN, BANTEN",129,123,100,223
https://kawalpemilu.org#53228,"PONDOK BENDA, PAMULANG, KOTA TANGERANG SELATAN, BANTEN",130,67,141,208
https://kawalpemilu.org#53228,"PONDOK BENDA, PAMULANG, KOTA TANGERANG SELATAN, BANTEN",131,87,105,192
https://kawalpemilu.org#53228,"PONDOK BENDA, PAMULANG, KOTA TANGERANG SELATAN, BANTEN",132,89,125,214
https://kawalpemilu.org#53228,"PONDOK BENDA, PAMULANG, KOTA TANGERANG SELATAN, BANTEN",133,112,92,204
https://kawalpemilu.org#53228,"PONDOK BENDA, PAMULANG, KOTA TANGERANG SELATAN, BANTEN",134,91,81,172
https://kawalpemilu.org#53228,"PONDOK BENDA, PAMULANG, KOTA TANGERANG SELATAN, BANTEN",135,96,91,187
https://kawalpemilu.org#53228,"PONDOK BENDA, PAMULANG, KOTA TANGERANG SELATAN, BANTEN",136,84,91,175
https://kawalpemilu.org#53228,"PONDOK BENDA, PAMULANG, KOTA TANGERANG SELATAN, BANTEN",137,115,118,233
https://kawalpemilu.org#53229,"PONDOK CABE UDIK, PAMULANG, KOTA TANGERANG SELATAN, BANTEN",1,73,150,223
https://kawalpemilu.org#53229,"PONDOK CABE UDIK, PAMULANG, KOTA TANGERANG SELATAN, BANTEN",2,67,118,185
https://kawalpemilu.org#53229,"PONDOK CABE UDIK, PAMULANG, KOTA TANGERANG SELATAN, BANTEN",3,86,123,209
https://kawalpemilu.org#53229,"PONDOK CABE UDIK, PAMULANG, KOTA TANGERANG SELATAN, BANTEN",4,62,138,200
https://kawalpemilu.org#53229,"PONDOK CABE UDIK, PAMULANG, KOTA TANGERANG SELATAN, BANTEN",5,72,142,214
https://kawalpemilu.org#53229,"PONDOK CABE UDIK, PAMULANG, KOTA TANGERANG SELATAN, BANTEN",6,78,158,236
https://kawalpemilu.org#53229,"PONDOK CABE UDIK, PAMULANG, KOTA TANGERANG SELATAN, BANTEN",7,49,150,199
https://kawalpemilu.org#53229,"PONDOK CABE UDIK, PAMULANG, KOTA TANGERANG SELATAN, BANTEN",8,59,162,221
https://kawalpemilu.org#53229,"PONDOK CABE UDIK, PAMULANG, KOTA TANGERANG SELATAN, BANTEN",9,124,108,232
https://kawalpemilu.org#53229,"PONDOK CABE UDIK, PAMULANG, KOTA TANGERANG SELATAN, BANTEN",10,80,135,215
https://kawalpemilu.org#53229,"PONDOK CABE UDIK, PAMULANG, KOTA TANGERANG SELATAN, BANTEN",11,96,118,214
https://kawalpemilu.org#53229,"PONDOK CABE UDIK, PAMULANG, KOTA TANGERANG SELATAN, BANTEN",12,110,98,208
https://kawalpemilu.org#53229,"PONDOK CABE UDIK, PAMULANG, KOTA TANGERANG SELATAN, BANTEN",13,114,110,224
https://kawalpemilu.org#53229,"PONDOK CABE UDIK, PAMULANG, KOTA TANGERANG SELATAN, BANTEN",14,123,132,255
https://kawalpemilu.org#53229,"PONDOK CABE UDIK, PAMULANG, KOTA TANGERANG SELATAN, BANTEN",15,81,91,172
https://kawalpemilu.org#53229,"PONDOK CABE UDIK, PAMULANG, KOTA TANGERANG SELATAN, BANTEN",16,78,90,168
https://kawalpemilu.org#53229,"PONDOK CABE UDIK, PAMULANG, KOTA TANGERANG SELATAN, BANTEN",17,108,129,237
https://kawalpemilu.org#53229,"PONDOK CABE UDIK, PAMULANG, KOTA TANGERANG SELATAN, BANTEN",18,98,150,248
https://kawalpemilu.org#53229,"PONDOK CABE UDIK, PAMULANG, KOTA TANGERANG SELATAN, BANTEN",19,128,71,199
https://kawalpemilu.org#53229,"PONDOK CABE UDIK, PAMULANG, KOTA TANGERANG SELATAN, BANTEN",20,88,130,218
https://kawalpemilu.org#53229,"PONDOK CABE UDIK, PAMULANG, KOTA TANGERANG SELATAN, BANTEN",21,124,102,226
https://kawalpemilu.org#53229,"PONDOK CABE UDIK, PAMULANG, KOTA TANGERANG SELATAN, BANTEN",22,120,82,202
https://kawalpemilu.org#53229,"PONDOK CABE UDIK, PAMULANG, KOTA TANGERANG SELATAN, BANTEN",23,55,122,177
https://kawalpemilu.org#53229,"PONDOK CABE UDIK, PAMULANG, KOTA TANGERANG SELATAN, BANTEN",24,67,115,182
https://kawalpemilu.org#53229,"PONDOK CABE UDIK, PAMULANG, KOTA TANGERANG SELATAN, BANTEN",25,82,104,186
https://kawalpemilu.org#53229,"PONDOK CABE UDIK, PAMULANG, KOTA TANGERANG SELATAN, BANTEN",26,58,61,119
https://kawalpemilu.org#53229,"PONDOK CABE UDIK, PAMULANG, KOTA TANGERANG SELATAN, BANTEN",27,89,78,167
https://kawalpemilu.org#53229,"PONDOK CABE UDIK, PAMULANG, KOTA TANGERANG SELATAN, BANTEN",28,80,126,206
https://kawalpemilu.org#53229,"PONDOK CABE UDIK, PAMULANG, KOTA TANGERANG SELATAN, BANTEN",29,56,111,167
https://kawalpemilu.org#53229,"PONDOK CABE UDIK, PAMULANG, KOTA TANGERANG SELATAN, BANTEN",30,124,106,230
https://kawalpemilu.org#53229,"PONDOK CABE UDIK, PAMULANG, KOTA TANGERANG SELATAN, BANTEN",31,192,30,222
https://kawalpemilu.org#53229,"PONDOK CABE UDIK, PAMULANG, KOTA TANGERANG SELATAN, BANTEN",32,158,56,214
https://kawalpemilu.org#53229,"PONDOK CABE UDIK, PAMULANG, KOTA TANGERANG SELATAN, BANTEN",33,94,95,189
https://kawalpemilu.org#53229,"PONDOK CABE UDIK, PAMULANG, KOTA TANGERANG SELATAN, BANTEN",34,94,66,160
https://kawalpemilu.org#53229,"PONDOK CABE UDIK, PAMULANG, KOTA TANGERANG SELATAN, BANTEN",35,120,88,208
https://kawalpemilu.org#53229,"PONDOK CABE UDIK, PAMULANG, KOTA TANGERANG SELATAN, BANTEN",36,131,32,163
https://kawalpemilu.org#53229,"PONDOK CABE UDIK, PAMULANG, KOTA TANGERANG SELATAN, BANTEN",37,151,45,196
https://kawalpemilu.org#53229,"PONDOK CABE UDIK, PAMULANG, KOTA TANGERANG SELATAN, BANTEN",38,138,63,201
https://kawalpemilu.org#53229,"PONDOK CABE UDIK, PAMULANG, KOTA TANGERANG SELATAN, BANTEN",39,119,110,229
https://kawalpemilu.org#53229,"PONDOK CABE UDIK, PAMULANG, KOTA TANGERANG SELATAN, BANTEN",40,123,79,202
https://kawalpemilu.org#53229,"PONDOK CABE UDIK, PAMULANG, KOTA TANGERANG SELATAN, BANTEN",41,108,85,193
https://kawalpemilu.org#53229,"PONDOK CABE UDIK, PAMULANG, KOTA TANGERANG SELATAN, BANTEN",42,92,50,142
https://kawalpemilu.org#53229,"PONDOK CABE UDIK, PAMULANG, KOTA TANGERANG SELATAN, BANTEN",43,167,81,248
https://kawalpemilu.org#53229,"PONDOK CABE UDIK, PAMULANG, KOTA TANGERANG SELATAN, BANTEN",44,90,70,160
https://kawalpemilu.org#53229,"PONDOK CABE UDIK, PAMULANG, KOTA TANGERANG SELATAN, BANTEN",45,66,58,124
https://kawalpemilu.org#53229,"PONDOK CABE UDIK, PAMULANG, KOTA TANGERANG SELATAN, BANTEN",46,136,85,221
https://kawalpemilu.org#53229,"PONDOK CABE UDIK, PAMULANG, KOTA TANGERANG SELATAN, BANTEN",47,90,151,241
https://kawalpemilu.org#53229,"PONDOK CABE UDIK, PAMULANG, KOTA TANGERANG SELATAN, BANTEN",48,92,95,187
https://kawalpemilu.org#53229,"PONDOK CABE UDIK, PAMULANG, KOTA TANGERANG SELATAN, BANTEN",49,100,74,174
https://kawalpemilu.org#53229,"PONDOK CABE UDIK, PAMULANG, KOTA TANGERANG SELATAN, BANTEN",50,163,101,264
https://kawalpemilu.org#53229,"PONDOK CABE UDIK, PAMULANG, KOTA TANGERANG SELATAN, BANTEN",51,157,91,248
https://kawalpemilu.org#53229,"PONDOK CABE UDIK, PAMULANG, KOTA TANGERANG SELATAN, BANTEN",52,166,91,257
https://kawalpemilu.org#53229,"PONDOK CABE UDIK, PAMULANG, KOTA TANGERANG SELATAN, BANTEN",53,136,97,233
https://kawalpemilu.org#53229,"PONDOK CABE UDIK, PAMULANG, KOTA TANGERANG SELATAN, BANTEN",54,86,106,192
https://kawalpemilu.org#53229,"PONDOK CABE UDIK, PAMULANG, KOTA TANGERANG SELATAN, BANTEN",55,104,120,224
https://kawalpemilu.org#53229,"PONDOK CABE UDIK, PAMULANG, KOTA TANGERANG SELATAN, BANTEN",56,74,106,180
https://kawalpemilu.org#53229,"PONDOK CABE UDIK, PAMULANG, KOTA TANGERANG SELATAN, BANTEN",57,66,82,148
https://kawalpemilu.org#53229,"PONDOK CABE UDIK, PAMULANG, KOTA TANGERANG SELATAN, BANTEN",58,63,95,158
https://kawalpemilu.org#53229,"PONDOK CABE UDIK, PAMULANG, KOTA TANGERANG SELATAN, BANTEN",59,45,49,94
https://kawalpemilu.org#53229,"PONDOK CABE UDIK, PAMULANG, KOTA TANGERANG SELATAN, BANTEN",60,78,127,205
https://kawalpemilu.org#53229,"PONDOK CABE UDIK, PAMULANG, KOTA TANGERANG SELATAN, BANTEN",61,48,72,120
https://kawalpemilu.org#53229,"PONDOK CABE UDIK, PAMULANG, KOTA TANGERANG SELATAN, BANTEN",62,152,58,210
https://kawalpemilu.org#53229,"PONDOK CABE UDIK, PAMULANG, KOTA TANGERANG SELATAN, BANTEN",63,136,73,209
https://kawalpemilu.org#53229,"PONDOK CABE UDIK, PAMULANG, KOTA TANGERANG SELATAN, BANTEN",64,101,90,191
https://kawalpemilu.org#53229,"PONDOK CABE UDIK, PAMULANG, KOTA TANGERANG SELATAN, BANTEN",65,106,70,176
https://kawalpemilu.org#53230,"PONDOK CABE ILIR, PAMULANG, KOTA TANGERANG SELATAN, BANTEN",1,36,88,124
https://kawalpemilu.org#53230,"PONDOK CABE ILIR, PAMULANG, KOTA TANGERANG SELATAN, BANTEN",2,32,108,140
https://kawalpemilu.org#53230,"PONDOK CABE ILIR, PAMULANG, KOTA TANGERANG SELATAN, BANTEN",3,63,132,195
https://kawalpemilu.org#53230,"PONDOK CABE ILIR, PAMULANG, KOTA TANGERANG SELATAN, BANTEN",4,35,126,161
https://kawalpemilu.org#53230,"PONDOK CABE ILIR, PAMULANG, KOTA TANGERANG SELATAN, BANTEN",5,80,117,197
https://kawalpemilu.org#53230,"PONDOK CABE ILIR, PAMULANG, KOTA TANGERANG SELATAN, BANTEN",6,56,118,174
https://kawalpemilu.org#53230,"PONDOK CABE ILIR, PAMULANG, KOTA TANGERANG SELATAN, BANTEN",7,89,117,206
https://kawalpemilu.org#53230,"PONDOK CABE ILIR, PAMULANG, KOTA TANGERANG SELATAN, BANTEN",8,53,88,141
https://kawalpemilu.org#53230,"PONDOK CABE ILIR, PAMULANG, KOTA TANGERANG SELATAN, BANTEN",9,108,133,241
https://kawalpemilu.org#53230,"PONDOK CABE ILIR, PAMULANG, KOTA TANGERANG SELATAN, BANTEN",10,100,134,234
https://kawalpemilu.org#53230,"PONDOK CABE ILIR, PAMULANG, KOTA TANGERANG SELATAN, BANTEN",11,77,151,228
https://kawalpemilu.org#53230,"PONDOK CABE ILIR, PAMULANG, KOTA TANGERANG SELATAN, BANTEN",12,135,114,249
https://kawalpemilu.org#53230,"PONDOK CABE ILIR, PAMULANG, KOTA TANGERANG SELATAN, BANTEN",13,82,159,241
https://kawalpemilu.org#53230,"PONDOK CABE ILIR, PAMULANG, KOTA TANGERANG SELATAN, BANTEN",14,87,147,234
https://kawalpemilu.org#53230,"PONDOK CABE ILIR, PAMULANG, KOTA TANGERANG SELATAN, BANTEN",15,74,154,228
https://kawalpemilu.org#53230,"PONDOK CABE ILIR, PAMULANG, KOTA TANGERANG SELATAN, BANTEN",16,57,93,150
https://kawalpemilu.org#53230,"PONDOK CABE ILIR, PAMULANG, KOTA TANGERANG SELATAN, BANTEN",17,59,127,186
https://kawalpemilu.org#53230,"PONDOK CABE ILIR, PAMULANG, KOTA TANGERANG SELATAN, BANTEN",18,62,139,201
https://kawalpemilu.org#53230,"PONDOK CABE ILIR, PAMULANG, KOTA TANGERANG SELATAN, BANTEN",19,52,119,171
https://kawalpemilu.org#53230,"PONDOK CABE ILIR, PAMULANG, KOTA TANGERANG SELATAN, BANTEN",20,57,121,178
https://kawalpemilu.org#53230,"PONDOK CABE ILIR, PAMULANG, KOTA TANGERANG SELATAN, BANTEN",21,115,60,175
https://kawalpemilu.org#53230,"PONDOK CABE ILIR, PAMULANG, KOTA TANGERANG SELATAN, BANTEN",22,56,42,98
https://kawalpemilu.org#53230,"PONDOK CABE ILIR, PAMULANG, KOTA TANGERANG SELATAN, BANTEN",23,103,53,156
https://kawalpemilu.org#53230,"PONDOK CABE ILIR, PAMULANG, KOTA TANGERANG SELATAN, BANTEN",24,80,141,221
https://kawalpemilu.org#53230,"PONDOK CABE ILIR, PAMULANG, KOTA TANGERANG SELATAN, BANTEN",25,82,112,194
https://kawalpemilu.org#53230,"PONDOK CABE ILIR, PAMULANG, KOTA TANGERANG SELATAN, BANTEN",26,81,106,187
https://kawalpemilu.org#53230,"PONDOK CABE ILIR, PAMULANG, KOTA TANGERANG SELATAN, BANTEN",27,98,114,212
https://kawalpemilu.org#53230,"PONDOK CABE ILIR, PAMULANG, KOTA TANGERANG SELATAN, BANTEN",28,87,110,197
https://kawalpemilu.org#53230,"PONDOK CABE ILIR, PAMULANG, KOTA TANGERANG SELATAN, BANTEN",29,66,115,181
https://kawalpemilu.org#53230,"PONDOK CABE ILIR, PAMULANG, KOTA TANGERANG SELATAN, BANTEN",30,61,77,138
https://kawalpemilu.org#53230,"PONDOK CABE ILIR, PAMULANG, KOTA TANGERANG SELATAN, BANTEN",31,150,59,209
https://kawalpemilu.org#53230,"PONDOK CABE ILIR, PAMULANG, KOTA TANGERANG SELATAN, BANTEN",32,66,118,184
https://kawalpemilu.org#53230,"PONDOK CABE ILIR, PAMULANG, KOTA TANGERANG SELATAN, BANTEN",33,52,128,180
https://kawalpemilu.org#53230,"PONDOK CABE ILIR, PAMULANG, KOTA TANGERANG SELATAN, BANTEN",34,69,95,164
https://kawalpemilu.org#53230,"PONDOK CABE ILIR, PAMULANG, KOTA TANGERANG SELATAN, BANTEN",35,39,73,112
https://kawalpemilu.org#53230,"PONDOK CABE ILIR, PAMULANG, KOTA TANGERANG SELATAN, BANTEN",36,90,136,226
https://kawalpemilu.org#53230,"PONDOK CABE ILIR, PAMULANG, KOTA TANGERANG SELATAN, BANTEN",37,74,74,148
https://kawalpemilu.org#53230,"PONDOK CABE ILIR, PAMULANG, KOTA TANGERANG SELATAN, BANTEN",39,75,112,187
https://kawalpemilu.org#53230,"PONDOK CABE ILIR, PAMULANG, KOTA TANGERANG SELATAN, BANTEN",40,64,120,184
https://kawalpemilu.org#53230,"PONDOK CABE ILIR, PAMULANG, KOTA TANGERANG SELATAN, BANTEN",41,87,42,129
https://kawalpemilu.org#53230,"PONDOK CABE ILIR, PAMULANG, KOTA TANGERANG SELATAN, BANTEN",42,76,130,206
https://kawalpemilu.org#53230,"PONDOK CABE ILIR, PAMULANG, KOTA TANGERANG SELATAN, BANTEN",43,95,118,213
https://kawalpemilu.org#53230,"PONDOK CABE ILIR, PAMULANG, KOTA TANGERANG SELATAN, BANTEN",44,72,121,193
https://kawalpemilu.org#53230,"PONDOK CABE ILIR, PAMULANG, KOTA TANGERANG SELATAN, BANTEN",45,94,91,185
https://kawalpemilu.org#53230,"PONDOK CABE ILIR, PAMULANG, KOTA TANGERANG SELATAN, BANTEN",46,49,67,116
https://kawalpemilu.org#53230,"PONDOK CABE ILIR, PAMULANG, KOTA TANGERANG SELATAN, BANTEN",47,52,80,132
https://kawalpemilu.org#53230,"PONDOK CABE ILIR, PAMULANG, KOTA TANGERANG SELATAN, BANTEN",48,40,83,123
https://kawalpemilu.org#53230,"PONDOK CABE ILIR, PAMULANG, KOTA TANGERANG SELATAN, BANTEN",49,37,80,117
https://kawalpemilu.org#53230,"PONDOK CABE ILIR, PAMULANG, KOTA TANGERANG SELATAN, BANTEN",50,87,128,215
https://kawalpemilu.org#53230,"PONDOK CABE ILIR, PAMULANG, KOTA TANGERANG SELATAN, BANTEN",51,64,98,162
https://kawalpemilu.org#53230,"PONDOK CABE ILIR, PAMULANG, KOTA TANGERANG SELATAN, BANTEN",52,79,134,213
https://kawalpemilu.org#53230,"PONDOK CABE ILIR, PAMULANG, KOTA TANGERANG SELATAN, BANTEN",53,134,49,183
https://kawalpemilu.org#53230,"PONDOK CABE ILIR, PAMULANG, KOTA TANGERANG SELATAN, BANTEN",54,76,154,230
https://kawalpemilu.org#53230,"PONDOK CABE ILIR, PAMULANG, KOTA TANGERANG SELATAN, BANTEN",55,73,159,232
https://kawalpemilu.org#53230,"PONDOK CABE ILIR, PAMULANG, KOTA TANGERANG SELATAN, BANTEN",56,62,110,172
https://kawalpemilu.org#53230,"PONDOK CABE ILIR, PAMULANG, KOTA TANGERANG SELATAN, BANTEN",57,72,93,165
https://kawalpemilu.org#53230,"PONDOK CABE ILIR, PAMULANG, KOTA TANGERANG SELATAN, BANTEN",58,38,113,151
https://kawalpemilu.org#53230,"PONDOK CABE ILIR, PAMULANG, KOTA TANGERANG SELATAN, BANTEN",59,101,80,181
https://kawalpemilu.org#53230,"PONDOK CABE ILIR, PAMULANG, KOTA TANGERANG SELATAN, BANTEN",60,90,92,182
https://kawalpemilu.org#53230,"PONDOK CABE ILIR, PAMULANG, KOTA TANGERANG SELATAN, BANTEN",61,80,93,173
https://kawalpemilu.org#53230,"PONDOK CABE ILIR, PAMULANG, KOTA TANGERANG SELATAN, BANTEN",62,81,123,204
https://kawalpemilu.org#53230,"PONDOK CABE ILIR, PAMULANG, KOTA TANGERANG SELATAN, BANTEN",63,58,98,156
https://kawalpemilu.org#53230,"PONDOK CABE ILIR, PAMULANG, KOTA TANGERANG SELATAN, BANTEN",64,81,103,184
https://kawalpemilu.org#53230,"PONDOK CABE ILIR, PAMULANG, KOTA TANGERANG SELATAN, BANTEN",65,67,143,210
https://kawalpemilu.org#53230,"PONDOK CABE ILIR, PAMULANG, KOTA TANGERANG SELATAN, BANTEN",66,49,142,191
https://kawalpemilu.org#53230,"PONDOK CABE ILIR, PAMULANG, KOTA TANGERANG SELATAN, BANTEN",67,53,97,150
https://kawalpemilu.org#53230,"PONDOK CABE ILIR, PAMULANG, KOTA TANGERANG SELATAN, BANTEN",68,96,107,203
https://kawalpemilu.org#53230,"PONDOK CABE ILIR, PAMULANG, KOTA TANGERANG SELATAN, BANTEN",69,97,74,171
https://kawalpemilu.org#53230,"PONDOK CABE ILIR, PAMULANG, KOTA TANGERANG SELATAN, BANTEN",70,96,92,188
https://kawalpemilu.org#53230,"PONDOK CABE ILIR, PAMULANG, KOTA TANGERANG SELATAN, BANTEN",71,66,93,159
https://kawalpemilu.org#53230,"PONDOK CABE ILIR, PAMULANG, KOTA TANGERANG SELATAN, BANTEN",72,65,98,163
https://kawalpemilu.org#53230,"PONDOK CABE ILIR, PAMULANG, KOTA TANGERANG SELATAN, BANTEN",73,67,90,157
https://kawalpemilu.org#53230,"PONDOK CABE ILIR, PAMULANG, KOTA TANGERANG SELATAN, BANTEN",74,88,150,238
https://kawalpemilu.org#53230,"PONDOK CABE ILIR, PAMULANG, KOTA TANGERANG SELATAN, BANTEN",75,60,161,221
https://kawalpemilu.org#53230,"PONDOK CABE ILIR, PAMULANG, KOTA TANGERANG SELATAN, BANTEN",76,66,130,196
https://kawalpemilu.org#53230,"PONDOK CABE ILIR, PAMULANG, KOTA TANGERANG SELATAN, BANTEN",77,52,140,192
https://kawalpemilu.org#53230,"PONDOK CABE ILIR, PAMULANG, KOTA TANGERANG SELATAN, BANTEN",78,56,134,190
https://kawalpemilu.org#53230,"PONDOK CABE ILIR, PAMULANG, KOTA TANGERANG SELATAN, BANTEN",79,116,71,187
https://kawalpemilu.org#53230,"PONDOK CABE ILIR, PAMULANG, KOTA TANGERANG SELATAN, BANTEN",80,92,72,164
https://kawalpemilu.org#53230,"PONDOK CABE ILIR, PAMULANG, KOTA TANGERANG SELATAN, BANTEN",81,58,79,137
https://kawalpemilu.org#53230,"PONDOK CABE ILIR, PAMULANG, KOTA TANGERANG SELATAN, BANTEN",82,80,114,194
https://kawalpemilu.org#53230,"PONDOK CABE ILIR, PAMULANG, KOTA TANGERANG SELATAN, BANTEN",83,68,110,178
https://kawalpemilu.org#53230,"PONDOK CABE ILIR, PAMULANG, KOTA TANGERANG SELATAN, BANTEN",84,73,110,183
https://kawalpemilu.org#53230,"PONDOK CABE ILIR, PAMULANG, KOTA TANGERANG SELATAN, BANTEN",85,52,115,167
https://kawalpemilu.org#53230,"PONDOK CABE ILIR, PAMULANG, KOTA TANGERANG SELATAN, BANTEN",86,64,88,152
https://kawalpemilu.org#53230,"PONDOK CABE ILIR, PAMULANG, KOTA TANGERANG SELATAN, BANTEN",87,85,124,209
https://kawalpemilu.org#53230,"PONDOK CABE ILIR, PAMULANG, KOTA TANGERANG SELATAN, BANTEN",88,104,100,204
https://kawalpemilu.org#53230,"PONDOK CABE ILIR, PAMULANG, KOTA TANGERANG SELATAN, BANTEN",89,108,90,198
https://kawalpemilu.org#53230,"PONDOK CABE ILIR, PAMULANG, KOTA TANGERANG SELATAN, BANTEN",90,70,107,0
https://kawalpemilu.org#53230,"PONDOK CABE ILIR, PAMULANG, KOTA TANGERANG SELATAN, BANTEN",91,85,94,179
https://kawalpemilu.org#53230,"PONDOK CABE ILIR, PAMULANG, KOTA TANGERANG SELATAN, BANTEN",92,82,104,186
https://kawalpemilu.org#53230,"PONDOK CABE ILIR, PAMULANG, KOTA TANGERANG SELATAN, BANTEN",93,114,115,229
https://kawalpemilu.org#53230,"PONDOK CABE ILIR, PAMULANG, KOTA TANGERANG SELATAN, BANTEN",94,85,105,190
https://kawalpemilu.org#53230,"PONDOK CABE ILIR, PAMULANG, KOTA TANGERANG SELATAN, BANTEN",95,74,107,181
https://kawalpemilu.org#53230,"PONDOK CABE ILIR, PAMULANG, KOTA TANGERANG SELATAN, BANTEN",96,73,91,164
https://kawalpemilu.org#53230,"PONDOK CABE ILIR, PAMULANG, KOTA TANGERANG SELATAN, BANTEN",97,94,110,204
https://kawalpemilu.org#53230,"PONDOK CABE ILIR, PAMULANG, KOTA TANGERANG SELATAN, BANTEN",98,75,65,140
https://kawalpemilu.org#53230,"PONDOK CABE ILIR, PAMULANG, KOTA TANGERANG SELATAN, BANTEN",99,68,73,141
https://kawalpemilu.org#53230,"PONDOK CABE ILIR, PAMULANG, KOTA TANGERANG SELATAN, BANTEN",100,76,59,135
https://kawalpemilu.org#53230,"PONDOK CABE ILIR, PAMULANG, KOTA TANGERANG SELATAN, BANTEN",101,77,43,120
https://kawalpemilu.org#53230,"PONDOK CABE ILIR, PAMULANG, KOTA TANGERANG SELATAN, BANTEN",102,109,98,207
https://kawalpemilu.org#53230,"PONDOK CABE ILIR, PAMULANG, KOTA TANGERANG SELATAN, BANTEN",103,83,81,164
https://kawalpemilu.org#53230,"PONDOK CABE ILIR, PAMULANG, KOTA TANGERANG SELATAN, BANTEN",104,62,68,130
https://kawalpemilu.org#53230,"PONDOK CABE ILIR, PAMULANG, KOTA TANGERANG SELATAN, BANTEN",105,84,67,151
https://kawalpemilu.org#53230,"PONDOK CABE ILIR, PAMULANG, KOTA TANGERANG SELATAN, BANTEN",106,68,103,171
https://kawalpemilu.org#53230,"PONDOK CABE ILIR, PAMULANG, KOTA TANGERANG SELATAN, BANTEN",107,55,74,129
https://kawalpemilu.org#53230,"PONDOK CABE ILIR, PAMULANG, KOTA TANGERANG SELATAN, BANTEN",108,63,90,153
https://kawalpemilu.org#53230,"PONDOK CABE ILIR, PAMULANG, KOTA TANGERANG SELATAN, BANTEN",109,118,106,224
https://kawalpemilu.org#53230,"PONDOK CABE ILIR, PAMULANG, KOTA TANGERANG SELATAN, BANTEN",110,90,82,172
https://kawalpemilu.org#53230,"PONDOK CABE ILIR, PAMULANG, KOTA TANGERANG SELATAN, BANTEN",111,87,110,197
https://kawalpemilu.org#53230,"PONDOK CABE ILIR, PAMULANG, KOTA TANGERANG SELATAN, BANTEN",112,55,96,151
https://kawalpemilu.org#53230,"PONDOK CABE ILIR, PAMULANG, KOTA TANGERANG SELATAN, BANTEN",113,99,62,161
https://kawalpemilu.org#53230,"PONDOK CABE ILIR, PAMULANG, KOTA TANGERANG SELATAN, BANTEN",114,86,45,131
https://kawalpemilu.org#53230,"PONDOK CABE ILIR, PAMULANG, KOTA TANGERANG SELATAN, BANTEN",115,80,58,138
https://kawalpemilu.org#53230,"PONDOK CABE ILIR, PAMULANG, KOTA TANGERANG SELATAN, BANTEN",116,57,93,150
https://kawalpemilu.org#53230,"PONDOK CABE ILIR, PAMULANG, KOTA TANGERANG SELATAN, BANTEN",117,54,65,119
https://kawalpemilu.org#53230,"PONDOK CABE ILIR, PAMULANG, KOTA TANGERANG SELATAN, BANTEN",118,81,113,194
https://kawalpemilu.org#53230,"PONDOK CABE ILIR, PAMULANG, KOTA TANGERANG SELATAN, BANTEN",119,56,96,152
https://kawalpemilu.org#53230,"PONDOK CABE ILIR, PAMULANG, KOTA TANGERANG SELATAN, BANTEN",120,47,78,125
https://kawalpemilu.org#53231,"KEDAUNG, PAMULANG, KOTA TANGERANG SELATAN, BANTEN",1,88,112,200
https://kawalpemilu.org#53231,"KEDAUNG, PAMULANG, KOTA TANGERANG SELATAN, BANTEN",2,93,106,199
https://kawalpemilu.org#53231,"KEDAUNG, PAMULANG, KOTA TANGERANG SELATAN, BANTEN",3,147,95,242
https://kawalpemilu.org#53231,"KEDAUNG, PAMULANG, KOTA TANGERANG SELATAN, BANTEN",4,112,111,223
https://kawalpemilu.org#53231,"KEDAUNG, PAMULANG, KOTA TANGERANG SELATAN, BANTEN",5,102,117,219
https://kawalpemilu.org#53231,"KEDAUNG, PAMULANG, KOTA TANGERANG SELATAN, BANTEN",6,100,92,192
https://kawalpemilu.org#53231,"KEDAUNG, PAMULANG, KOTA TANGERANG SELATAN, BANTEN",7,103,88,191
https://kawalpemilu.org#53231,"KEDAUNG, PAMULANG, KOTA TANGERANG SELATAN, BANTEN",8,133,83,216
https://kawalpemilu.org#53231,"KEDAUNG, PAMULANG, KOTA TANGERANG SELATAN, BANTEN",9,131,113,244
https://kawalpemilu.org#53231,"KEDAUNG, PAMULANG, KOTA TANGERANG SELATAN, BANTEN",10,107,85,192
https://kawalpemilu.org#53231,"KEDAUNG, PAMULANG, KOTA TANGERANG SELATAN, BANTEN",11,99,70,169
https://kawalpemilu.org#53231,"KEDAUNG, PAMULANG, KOTA TANGERANG SELATAN, BANTEN",12,100,130,230
https://kawalpemilu.org#53231,"KEDAUNG, PAMULANG, KOTA TANGERANG SELATAN, BANTEN",13,75,90,165
https://kawalpemilu.org#53231,"KEDAUNG, PAMULANG, KOTA TANGERANG SELATAN, BANTEN",14,76,74,150
https://kawalpemilu.org#53231,"KEDAUNG, PAMULANG, KOTA TANGERANG SELATAN, BANTEN",15,105,122,227
https://kawalpemilu.org#53231,"KEDAUNG, PAMULANG, KOTA TANGERANG SELATAN, BANTEN",16,136,106,242
https://kawalpemilu.org#53231,"KEDAUNG, PAMULANG, KOTA TANGERANG SELATAN, BANTEN",17,128,115,243
https://kawalpemilu.org#53231,"KEDAUNG, PAMULANG, KOTA TANGERANG SELATAN, BANTEN",18,125,131,256
https://kawalpemilu.org#53231,"KEDAUNG, PAMULANG, KOTA TANGERANG SELATAN, BANTEN",19,107,121,228
https://kawalpemilu.org#53231,"KEDAUNG, PAMULANG, KOTA TANGERANG SELATAN, BANTEN",20,91,98,189
https://kawalpemilu.org#53231,"KEDAUNG, PAMULANG, KOTA TANGERANG SELATAN, BANTEN",21,88,122,210
https://kawalpemilu.org#53231,"KEDAUNG, PAMULANG, KOTA TANGERANG SELATAN, BANTEN",22,77,106,183
https://kawalpemilu.org#53231,"KEDAUNG, PAMULANG, KOTA TANGERANG SELATAN, BANTEN",23,104,66,170
https://kawalpemilu.org#53231,"KEDAUNG, PAMULANG, KOTA TANGERANG SELATAN, BANTEN",24,115,78,193
https://kawalpemilu.org#53231,"KEDAUNG, PAMULANG, KOTA TANGERANG SELATAN, BANTEN",25,111,77,189
https://kawalpemilu.org#53231,"KEDAUNG, PAMULANG, KOTA TANGERANG SELATAN, BANTEN",26,84,115,199
https://kawalpemilu.org#53231,"KEDAUNG, PAMULANG, KOTA TANGERANG SELATAN, BANTEN",27,47,110,157
https://kawalpemilu.org#53231,"KEDAUNG, PAMULANG, KOTA TANGERANG SELATAN, BANTEN",28,96,124,220
https://kawalpemilu.org#53231,"KEDAUNG, PAMULANG, KOTA TANGERANG SELATAN, BANTEN",29,106,117,223
https://kawalpemilu.org#53231,"KEDAUNG, PAMULANG, KOTA TANGERANG SELATAN, BANTEN",30,99,127,226
https://kawalpemilu.org#53231,"KEDAUNG, PAMULANG, KOTA TANGERANG SELATAN, BANTEN",31,89,112,201
https://kawalpemilu.org#53231,"KEDAUNG, PAMULANG, KOTA TANGERANG SELATAN, BANTEN",32,91,98,189
https://kawalpemilu.org#53231,"KEDAUNG, PAMULANG, KOTA TANGERANG SELATAN, BANTEN",33,102,85,187
https://kawalpemilu.org#53231,"KEDAUNG, PAMULANG, KOTA TANGERANG SELATAN, BANTEN",34,108,83,191
https://kawalpemilu.org#53231,"KEDAUNG, PAMULANG, KOTA TANGERANG SELATAN, BANTEN",36,83,68,151
https://kawalpemilu.org#53231,"KEDAUNG, PAMULANG, KOTA TANGERANG SELATAN, BANTEN",37,68,120,188
https://kawalpemilu.org#53231,"KEDAUNG, PAMULANG, KOTA TANGERANG SELATAN, BANTEN",38,98,110,208
https://kawalpemilu.org#53231,"KEDAUNG, PAMULANG, KOTA TANGERANG SELATAN, BANTEN",39,68,113,181
https://kawalpemilu.org#53231,"KEDAUNG, PAMULANG, KOTA TANGERANG SELATAN, BANTEN",40,107,100,207
https://kawalpemilu.org#53231,"KEDAUNG, PAMULANG, KOTA TANGERANG SELATAN, BANTEN",41,97,85,182
https://kawalpemilu.org#53231,"KEDAUNG, PAMULANG, KOTA TANGERANG SELATAN, BANTEN",42,192,42,234
https://kawalpemilu.org#53231,"KEDAUNG, PAMULANG, KOTA TANGERANG SELATAN, BANTEN",43,132,42,174
https://kawalpemilu.org#53231,"KEDAUNG, PAMULANG, KOTA TANGERANG SELATAN, BANTEN",44,184,50,234
https://kawalpemilu.org#53231,"KEDAUNG, PAMULANG, KOTA TANGERANG SELATAN, BANTEN",45,130,37,167
https://kawalpemilu.org#53231,"KEDAUNG, PAMULANG, KOTA TANGERANG SELATAN, BANTEN",46,122,88,210
https://kawalpemilu.org#53231,"KEDAUNG, PAMULANG, KOTA TANGERANG SELATAN, BANTEN",47,101,81,182
https://kawalpemilu.org#53231,"KEDAUNG, PAMULANG, KOTA TANGERANG SELATAN, BANTEN",48,86,75,161
https://kawalpemilu.org#53231,"KEDAUNG, PAMULANG, KOTA TANGERANG SELATAN, BANTEN",49,113,58,171
https://kawalpemilu.org#53231,"KEDAUNG, PAMULANG, KOTA TANGERANG SELATAN, BANTEN",50,91,60,151
https://kawalpemilu.org#53231,"KEDAUNG, PAMULANG, KOTA TANGERANG SELATAN, BANTEN",51,94,63,157
https://kawalpemilu.org#53231,"KEDAUNG, PAMULANG, KOTA TANGERANG SELATAN, BANTEN",52,87,87,174
https://kawalpemilu.org#53231,"KEDAUNG, PAMULANG, KOTA TANGERANG SELATAN, BANTEN",53,122,101,223
https://kawalpemilu.org#53231,"KEDAUNG, PAMULANG, KOTA TANGERANG SELATAN, BANTEN",54,119,77,196
https://kawalpemilu.org#53231,"KEDAUNG, PAMULANG, KOTA TANGERANG SELATAN, BANTEN",55,86,71,157
https://kawalpemilu.org#53231,"KEDAUNG, PAMULANG, KOTA TANGERANG SELATAN, BANTEN",56,50,80,130
https://kawalpemilu.org#53231,"KEDAUNG, PAMULANG, KOTA TANGERANG SELATAN, BANTEN",57,113,94,207
https://kawalpemilu.org#53231,"KEDAUNG, PAMULANG, KOTA TANGERANG SELATAN, BANTEN",58,124,118,242
https://kawalpemilu.org#53231,"KEDAUNG, PAMULANG, KOTA TANGERANG SELATAN, BANTEN",59,65,84,149
https://kawalpemilu.org#53231,"KEDAUNG, PAMULANG, KOTA TANGERANG SELATAN, BANTEN",60,73,59,132
https://kawalpemilu.org#53231,"KEDAUNG, PAMULANG, KOTA TANGERANG SELATAN, BANTEN",61,49,66,115
https://kawalpemilu.org#53231,"KEDAUNG, PAMULANG, KOTA TANGERANG SELATAN, BANTEN",62,68,65,133
https://kawalpemilu.org#53231,"KEDAUNG, PAMULANG, KOTA TANGERANG SELATAN, BANTEN",63,60,72,132
https://kawalpemilu.org#53231,"KEDAUNG, PAMULANG, KOTA TANGERANG SELATAN, BANTEN",64,102,67,169
https://kawalpemilu.org#53231,"KEDAUNG, PAMULANG, KOTA TANGERANG SELATAN, BANTEN",65,102,101,203
https://kawalpemilu.org#53231,"KEDAUNG, PAMULANG, KOTA TANGERANG SELATAN, BANTEN",66,147,91,238
https://kawalpemilu.org#53231,"KEDAUNG, PAMULANG, KOTA TANGERANG SELATAN, BANTEN",67,93,101,194
https://kawalpemilu.org#53231,"KEDAUNG, PAMULANG, KOTA TANGERANG SELATAN, BANTEN",68,85,88,173
https://kawalpemilu.org#53231,"KEDAUNG, PAMULANG, KOTA TANGERANG SELATAN, BANTEN",69,110,99,208
https://kawalpemilu.org#53231,"KEDAUNG, PAMULANG, KOTA TANGERANG SELATAN, BANTEN",70,82,86,168
https://kawalpemilu.org#53231,"KEDAUNG, PAMULANG, KOTA TANGERANG SELATAN, BANTEN",71,116,105,221
https://kawalpemilu.org#53231,"KEDAUNG, PAMULANG, KOTA TANGERANG SELATAN, BANTEN",72,78,116,194
https://kawalpemilu.org#53231,"KEDAUNG, PAMULANG, KOTA TANGERANG SELATAN, BANTEN",73,92,106,198
https://kawalpemilu.org#53231,"KEDAUNG, PAMULANG, KOTA TANGERANG SELATAN, BANTEN",74,74,56,130
https://kawalpemilu.org#53231,"KEDAUNG, PAMULANG, KOTA TANGERANG SELATAN, BANTEN",75,100,65,165
https://kawalpemilu.org#53231,"KEDAUNG, PAMULANG, KOTA TANGERANG SELATAN, BANTEN",76,102,70,172
https://kawalpemilu.org#53231,"KEDAUNG, PAMULANG, KOTA TANGERANG SELATAN, BANTEN",77,102,100,202
https://kawalpemilu.org#53231,"KEDAUNG, PAMULANG, KOTA TANGERANG SELATAN, BANTEN",78,93,120,213
https://kawalpemilu.org#53231,"KEDAUNG, PAMULANG, KOTA TANGERANG SELATAN, BANTEN",79,100,98,198
https://kawalpemilu.org#53231,"KEDAUNG, PAMULANG, KOTA TANGERANG SELATAN, BANTEN",80,87,81,168
https://kawalpemilu.org#53231,"KEDAUNG, PAMULANG, KOTA TANGERANG SELATAN, BANTEN",81,61,92,153
https://kawalpemilu.org#53231,"KEDAUNG, PAMULANG, KOTA TANGERANG SELATAN, BANTEN",82,102,106,208
https://kawalpemilu.org#53231,"KEDAUNG, PAMULANG, KOTA TANGERANG SELATAN, BANTEN",83,95,101,196
https://kawalpemilu.org#53231,"KEDAUNG, PAMULANG, KOTA TANGERANG SELATAN, BANTEN",84,111,62,173
https://kawalpemilu.org#53231,"KEDAUNG, PAMULANG, KOTA TANGERANG SELATAN, BANTEN",85,144,66,210
https://kawalpemilu.org#53231,"KEDAUNG, PAMULANG, KOTA TANGERANG SELATAN, BANTEN",86,102,128,230
https://kawalpemilu.org#53231,"KEDAUNG, PAMULANG, KOTA TANGERANG SELATAN, BANTEN",87,101,134,235
https://kawalpemilu.org#53231,"KEDAUNG, PAMULANG, KOTA TANGERANG SELATAN, BANTEN",88,83,99,182
https://kawalpemilu.org#53231,"KEDAUNG, PAMULANG, KOTA TANGERANG SELATAN, BANTEN",89,102,62,164
https://kawalpemilu.org#53231,"KEDAUNG, PAMULANG, KOTA TANGERANG SELATAN, BANTEN",90,94,133,227
https://kawalpemilu.org#53231,"KEDAUNG, PAMULANG, KOTA TANGERANG SELATAN, BANTEN",91,126,120,246
https://kawalpemilu.org#53231,"KEDAUNG, PAMULANG, KOTA TANGERANG SELATAN, BANTEN",92,108,65,173
https://kawalpemilu.org#53231,"KEDAUNG, PAMULANG, KOTA TANGERANG SELATAN, BANTEN",93,128,81,209
https://kawalpemilu.org#53231,"KEDAUNG, PAMULANG, KOTA TANGERANG SELATAN, BANTEN",94,125,114,239
https://kawalpemilu.org#53231,"KEDAUNG, PAMULANG, KOTA TANGERANG SELATAN, BANTEN",95,124,111,235
https://kawalpemilu.org#53231,"KEDAUNG, PAMULANG, KOTA TANGERANG SELATAN, BANTEN",96,139,108,247
https://kawalpemilu.org#53231,"KEDAUNG, PAMULANG, KOTA TANGERANG SELATAN, BANTEN",97,132,112,244
https://kawalpemilu.org#53231,"KEDAUNG, PAMULANG, KOTA TANGERANG SELATAN, BANTEN",98,111,102,213
https://kawalpemilu.org#53231,"KEDAUNG, PAMULANG, KOTA TANGERANG SELATAN, BANTEN",99,116,88,204
https://kawalpemilu.org#53231,"KEDAUNG, PAMULANG, KOTA TANGERANG SELATAN, BANTEN",100,147,88,235
https://kawalpemilu.org#53231,"KEDAUNG, PAMULANG, KOTA TANGERANG SELATAN, BANTEN",101,133,103,236
https://kawalpemilu.org#53231,"KEDAUNG, PAMULANG, KOTA TANGERANG SELATAN, BANTEN",102,126,76,202
https://kawalpemilu.org#53231,"KEDAUNG, PAMULANG, KOTA TANGERANG SELATAN, BANTEN",103,161,100,261
https://kawalpemilu.org#53231,"KEDAUNG, PAMULANG, KOTA TANGERANG SELATAN, BANTEN",104,108,77,185
https://kawalpemilu.org#53231,"KEDAUNG, PAMULANG, KOTA TANGERANG SELATAN, BANTEN",105,176,75,251
https://kawalpemilu.org#53231,"KEDAUNG, PAMULANG, KOTA TANGERANG SELATAN, BANTEN",106,99,125,224
https://kawalpemilu.org#53231,"KEDAUNG, PAMULANG, KOTA TANGERANG SELATAN, BANTEN",107,101,107,208
https://kawalpemilu.org#53231,"KEDAUNG, PAMULANG, KOTA TANGERANG SELATAN, BANTEN",108,88,113,201
https://kawalpemilu.org#53231,"KEDAUNG, PAMULANG, KOTA TANGERANG SELATAN, BANTEN",109,63,65,128
https://kawalpemilu.org#53231,"KEDAUNG, PAMULANG, KOTA TANGERANG SELATAN, BANTEN",110,114,89,203
https://kawalpemilu.org#53231,"KEDAUNG, PAMULANG, KOTA TANGERANG SELATAN, BANTEN",111,112,85,197
https://kawalpemilu.org#53231,"KEDAUNG, PAMULANG, KOTA TANGERANG SELATAN, BANTEN",112,95,118,213
https://kawalpemilu.org#53231,"KEDAUNG, PAMULANG, KOTA TANGERANG SELATAN, BANTEN",113,77,78,155
https://kawalpemilu.org#53231,"KEDAUNG, PAMULANG, KOTA TANGERANG SELATAN, BANTEN",114,93,81,174
https://kawalpemilu.org#53231,"KEDAUNG, PAMULANG, KOTA TANGERANG SELATAN, BANTEN",115,124,109,233
https://kawalpemilu.org#53231,"KEDAUNG, PAMULANG, KOTA TANGERANG SELATAN, BANTEN",117,80,88,8
https://kawalpemilu.org#53231,"KEDAUNG, PAMULANG, KOTA TANGERANG SELATAN, BANTEN",118,41,99,140
https://kawalpemilu.org#53231,"KEDAUNG, PAMULANG, KOTA TANGERANG SELATAN, BANTEN",119,80,155,235
https://kawalpemilu.org#53231,"KEDAUNG, PAMULANG, KOTA TANGERANG SELATAN, BANTEN",120,87,134,221
https://kawalpemilu.org#53231,"KEDAUNG, PAMULANG, KOTA TANGERANG SELATAN, BANTEN",121,64,62,126
https://kawalpemilu.org#53231,"KEDAUNG, PAMULANG, KOTA TANGERANG SELATAN, BANTEN",122,40,76,116
https://kawalpemilu.org#53231,"KEDAUNG, PAMULANG, KOTA TANGERANG SELATAN, BANTEN",123,100,99,199
https://kawalpemilu.org#53231,"KEDAUNG, PAMULANG, KOTA TANGERANG SELATAN, BANTEN",124,112,101,213
https://kawalpemilu.org#53231,"KEDAUNG, PAMULANG, KOTA TANGERANG SELATAN, BANTEN",125,96,121,217
https://kawalpemilu.org#53231,"KEDAUNG, PAMULANG, KOTA TANGERANG SELATAN, BANTEN",126,69,112,181
https://kawalpemilu.org#53231,"KEDAUNG, PAMULANG, KOTA TANGERANG SELATAN, BANTEN",128,71,84,155
https://kawalpemilu.org#53231,"KEDAUNG, PAMULANG, KOTA TANGERANG SELATAN, BANTEN",129,56,88,143
https://kawalpemilu.org#53231,"KEDAUNG, PAMULANG, KOTA TANGERANG SELATAN, BANTEN",130,122,103,225
https://kawalpemilu.org#53231,"KEDAUNG, PAMULANG, KOTA TANGERANG SELATAN, BANTEN",132,84,114,198
https://kawalpemilu.org#53231,"KEDAUNG, PAMULANG, KOTA TANGERANG SELATAN, BANTEN",133,108,109,217
https://kawalpemilu.org#53231,"KEDAUNG, PAMULANG, KOTA TANGERANG SELATAN, BANTEN",134,93,161,254
https://kawalpemilu.org#53231,"KEDAUNG, PAMULANG, KOTA TANGERANG SELATAN, BANTEN",135,79,128,207
https://kawalpemilu.org#53231,"KEDAUNG, PAMULANG, KOTA TANGERANG SELATAN, BANTEN",136,60,90,150
https://kawalpemilu.org#53231,"KEDAUNG, PAMULANG, KOTA TANGERANG SELATAN, BANTEN",137,46,69,115
https://kawalpemilu.org#53231,"KEDAUNG, PAMULANG, KOTA TANGERANG SELATAN, BANTEN",138,79,120,199
https://kawalpemilu.org#53231,"KEDAUNG, PAMULANG, KOTA TANGERANG SELATAN, BANTEN",139,76,151,227
https://kawalpemilu.org#53231,"KEDAUNG, PAMULANG, KOTA TANGERANG SELATAN, BANTEN",140,114,127,241
https://kawalpemilu.org#53231,"KEDAUNG, PAMULANG, KOTA TANGERANG SELATAN, BANTEN",141,98,114,212
https://kawalpemilu.org#53231,"KEDAUNG, PAMULANG, KOTA TANGERANG SELATAN, BANTEN",143,70,104,174
https://kawalpemilu.org#53231,"KEDAUNG, PAMULANG, KOTA TANGERANG SELATAN, BANTEN",144,92,77,169
https://kawalpemilu.org#53231,"KEDAUNG, PAMULANG, KOTA TANGERANG SELATAN, BANTEN",145,106,106,212
https://kawalpemilu.org#53231,"KEDAUNG, PAMULANG, KOTA TANGERANG SELATAN, BANTEN",146,115,102,217
https://kawalpemilu.org#53231,"KEDAUNG, PAMULANG, KOTA TANGERANG SELATAN, BANTEN",147,94,97,191
https://kawalpemilu.org#53231,"KEDAUNG, PAMULANG, KOTA TANGERANG SELATAN, BANTEN",148,106,57,163
https://kawalpemilu.org#53231,"KEDAUNG, PAMULANG, KOTA TANGERANG SELATAN, BANTEN",149,86,45,131
https://kawalpemilu.org#53231,"KEDAUNG, PAMULANG, KOTA TANGERANG SELATAN, BANTEN",150,138,72,210
https://kawalpemilu.org#53231,"KEDAUNG, PAMULANG, KOTA TANGERANG SELATAN, BANTEN",151,79,77,156
https://kawalpemilu.org#53231,"KEDAUNG, PAMULANG, KOTA TANGERANG SELATAN, BANTEN",152,99,58,157
https://kawalpemilu.org#53231,"KEDAUNG, PAMULANG, KOTA TANGERANG SELATAN, BANTEN",153,119,62,181
https://kawalpemilu.org#53231,"KEDAUNG, PAMULANG, KOTA TANGERANG SELATAN, BANTEN",154,83,75,158
https://kawalpemilu.org#53232,"BAMBU APUS, PAMULANG, KOTA TANGERANG SELATAN, BANTEN",1,102,98,200
https://kawalpemilu.org#53232,"BAMBU APUS, PAMULANG, KOTA TANGERANG SELATAN, BANTEN",2,77,95,172
https://kawalpemilu.org#53232,"BAMBU APUS, PAMULANG, KOTA TANGERANG SELATAN, BANTEN",3,79,89,168
https://kawalpemilu.org#53232,"BAMBU APUS, PAMULANG, KOTA TANGERANG SELATAN, BANTEN",4,84,69,153
https://kawalpemilu.org#53232,"BAMBU APUS, PAMULANG, KOTA TANGERANG SELATAN, BANTEN",5,83,163,246
https://kawalpemilu.org#53232,"BAMBU APUS, PAMULANG, KOTA TANGERANG SELATAN, BANTEN",6,111,131,242
https://kawalpemilu.org#53232,"BAMBU APUS, PAMULANG, KOTA TANGERANG SELATAN, BANTEN",7,89,133,222
https://kawalpemilu.org#53232,"BAMBU APUS, PAMULANG, KOTA TANGERANG SELATAN, BANTEN",8,101,155,256
https://kawalpemilu.org#53232,"BAMBU APUS, PAMULANG, KOTA TANGERANG SELATAN, BANTEN",9,124,115,239
https://kawalpemilu.org#53232,"BAMBU APUS, PAMULANG, KOTA TANGERANG SELATAN, BANTEN",11,125,80,205
https://kawalpemilu.org#53232,"BAMBU APUS, PAMULANG, KOTA TANGERANG SELATAN, BANTEN",12,109,112,221
https://kawalpemilu.org#53232,"BAMBU APUS, PAMULANG, KOTA TANGERANG SELATAN, BANTEN",13,62,89,151
https://kawalpemilu.org#53232,"BAMBU APUS, PAMULANG, KOTA TANGERANG SELATAN, BANTEN",14,115,100,215
https://kawalpemilu.org#53232,"BAMBU APUS, PAMULANG, KOTA TANGERANG SELATAN, BANTEN",15,122,113,235
https://kawalpemilu.org#53232,"BAMBU APUS, PAMULANG, KOTA TANGERANG SELATAN, BANTEN",16,132,99,231
https://kawalpemilu.org#53232,"BAMBU APUS, PAMULANG, KOTA TANGERANG SELATAN, BANTEN",17,116,141,257
https://kawalpemilu.org#53232,"BAMBU APUS, PAMULANG, KOTA TANGERANG SELATAN, BANTEN",18,100,148,248
https://kawalpemilu.org#53232,"BAMBU APUS, PAMULANG, KOTA TANGERANG SELATAN, BANTEN",19,119,105,224
https://kawalpemilu.org#53232,"BAMBU APUS, PAMULANG, KOTA TANGERANG SELATAN, BANTEN",20,99,115,214
https://kawalpemilu.org#53232,"BAMBU APUS, PAMULANG, KOTA TANGERANG SELATAN, BANTEN",22,122,84,206
https://kawalpemilu.org#53232,"BAMBU APUS, PAMULANG, KOTA TANGERANG SELATAN, BANTEN",23,115,105,220
https://kawalpemilu.org#53232,"BAMBU APUS, PAMULANG, KOTA TANGERANG SELATAN, BANTEN",24,94,94,188
https://kawalpemilu.org#53232,"BAMBU APUS, PAMULANG, KOTA TANGERANG SELATAN, BANTEN",25,84,92,176
https://kawalpemilu.org#53232,"BAMBU APUS, PAMULANG, KOTA TANGERANG SELATAN, BANTEN",26,67,57,124
https://kawalpemilu.org#53232,"BAMBU APUS, PAMULANG, KOTA TANGERANG SELATAN, BANTEN",27,66,78,144
https://kawalpemilu.org#53232,"BAMBU APUS, PAMULANG, KOTA TANGERANG SELATAN, BANTEN",28,82,63,145
https://kawalpemilu.org#53232,"BAMBU APUS, PAMULANG, KOTA TANGERANG SELATAN, BANTEN",29,82,63,145
https://kawalpemilu.org#53232,"BAMBU APUS, PAMULANG, KOTA TANGERANG SELATAN, BANTEN",30,97,122,219
https://kawalpemilu.org#53232,"BAMBU APUS, PAMULANG, KOTA TANGERANG SELATAN, BANTEN",31,98,89,187
https://kawalpemilu.org#53232,"BAMBU APUS, PAMULANG, KOTA TANGERANG SELATAN, BANTEN",32,96,89,185
https://kawalpemilu.org#53232,"BAMBU APUS, PAMULANG, KOTA TANGERANG SELATAN, BANTEN",33,126,89,215
https://kawalpemilu.org#53232,"BAMBU APUS, PAMULANG, KOTA TANGERANG SELATAN, BANTEN",34,183,37,220
https://kawalpemilu.org#53232,"BAMBU APUS, PAMULANG, KOTA TANGERANG SELATAN, BANTEN",35,95,86,181
https://kawalpemilu.org#53232,"BAMBU APUS, PAMULANG, KOTA TANGERANG SELATAN, BANTEN",36,129,94,223
https://kawalpemilu.org#53232,"BAMBU APUS, PAMULANG, KOTA TANGERANG SELATAN, BANTEN",37,117,95,212
https://kawalpemilu.org#53232,"BAMBU APUS, PAMULANG, KOTA TANGERANG SELATAN, BANTEN",38,106,108,214
https://kawalpemilu.org#53232,"BAMBU APUS, PAMULANG, KOTA TANGERANG SELATAN, BANTEN",39,95,129,224
https://kawalpemilu.org#53232,"BAMBU APUS, PAMULANG, KOTA TANGERANG SELATAN, BANTEN",40,89,120,209
https://kawalpemilu.org#53232,"BAMBU APUS, PAMULANG, KOTA TANGERANG SELATAN, BANTEN",41,93,106,199
https://kawalpemilu.org#53232,"BAMBU APUS, PAMULANG, KOTA TANGERANG SELATAN, BANTEN",42,122,77,199
https://kawalpemilu.org#53232,"BAMBU APUS, PAMULANG, KOTA TANGERANG SELATAN, BANTEN",43,118,86,204
https://kawalpemilu.org#53232,"BAMBU APUS, PAMULANG, KOTA TANGERANG SELATAN, BANTEN",44,114,117,231
https://kawalpemilu.org#53232,"BAMBU APUS, PAMULANG, KOTA TANGERANG SELATAN, BANTEN",45,132,110,242
https://kawalpemilu.org#53232,"BAMBU APUS, PAMULANG, KOTA TANGERANG SELATAN, BANTEN",46,142,124,266
https://kawalpemilu.org#53232,"BAMBU APUS, PAMULANG, KOTA TANGERANG SELATAN, BANTEN",47,105,131,236
https://kawalpemilu.org#53232,"BAMBU APUS, PAMULANG, KOTA TANGERANG SELATAN, BANTEN",48,112,128,240
https://kawalpemilu.org#53232,"BAMBU APUS, PAMULANG, KOTA TANGERANG SELATAN, BANTEN",49,88,122,210
https://kawalpemilu.org#53232,"BAMBU APUS, PAMULANG, KOTA TANGERANG SELATAN, BANTEN",50,68,127,195
https://kawalpemilu.org#53232,"BAMBU APUS, PAMULANG, KOTA TANGERANG SELATAN, BANTEN",51,77,107,184
https://kawalpemilu.org#53232,"BAMBU APUS, PAMULANG, KOTA TANGERANG SELATAN, BANTEN",52,75,101,176
https://kawalpemilu.org#53232,"BAMBU APUS, PAMULANG, KOTA TANGERANG SELATAN, BANTEN",53,88,125,213
https://kawalpemilu.org#53232,"BAMBU APUS, PAMULANG, KOTA TANGERANG SELATAN, BANTEN",54,117,96,213
https://kawalpemilu.org#53232,"BAMBU APUS, PAMULANG, KOTA TANGERANG SELATAN, BANTEN",55,86,111,197
https://kawalpemilu.org#53232,"BAMBU APUS, PAMULANG, KOTA TANGERANG SELATAN, BANTEN",56,96,95,191
https://kawalpemilu.org#53232,"BAMBU APUS, PAMULANG, KOTA TANGERANG SELATAN, BANTEN",57,94,99,193
https://kawalpemilu.org#53232,"BAMBU APUS, PAMULANG, KOTA TANGERANG SELATAN, BANTEN",58,110,77,187
https://kawalpemilu.org#53232,"BAMBU APUS, PAMULANG, KOTA TANGERANG SELATAN, BANTEN",59,146,86,232
https://kawalpemilu.org#53232,"BAMBU APUS, PAMULANG, KOTA TANGERANG SELATAN, BANTEN",60,141,102,243
https://kawalpemilu.org#53232,"BAMBU APUS, PAMULANG, KOTA TANGERANG SELATAN, BANTEN",61,115,123,238
https://kawalpemilu.org#53232,"BAMBU APUS, PAMULANG, KOTA TANGERANG SELATAN, BANTEN",62,114,88,202
https://kawalpemilu.org#53232,"BAMBU APUS, PAMULANG, KOTA TANGERANG SELATAN, BANTEN",63,124,81,205
https://kawalpemilu.org#53232,"BAMBU APUS, PAMULANG, KOTA TANGERANG SELATAN, BANTEN",64,155,88,243
https://kawalpemilu.org#53232,"BAMBU APUS, PAMULANG, KOTA TANGERANG SELATAN, BANTEN",65,156,65,221
https://kawalpemilu.org#53232,"BAMBU APUS, PAMULANG, KOTA TANGERANG SELATAN, BANTEN",66,157,82,239
https://kawalpemilu.org#53232,"BAMBU APUS, PAMULANG, KOTA TANGERANG SELATAN, BANTEN",67,65,140,205
https://kawalpemilu.org#53232,"BAMBU APUS, PAMULANG, KOTA TANGERANG SELATAN, BANTEN",68,59,136,195
https://kawalpemilu.org#53232,"BAMBU APUS, PAMULANG, KOTA TANGERANG SELATAN, BANTEN",69,157,87,244
https://kawalpemilu.org#53232,"BAMBU APUS, PAMULANG, KOTA TANGERANG SELATAN, BANTEN",70,128,101,229
https://kawalpemilu.org#53232,"BAMBU APUS, PAMULANG, KOTA TANGERANG SELATAN, BANTEN",71,139,112,251
https://kawalpemilu.org#53232,"BAMBU APUS, PAMULANG, KOTA TANGERANG SELATAN, BANTEN",72,128,136,264
https://kawalpemilu.org#53232,"BAMBU APUS, PAMULANG, KOTA TANGERANG SELATAN, BANTEN",73,99,123,222
https://kawalpemilu.org#53232,"BAMBU APUS, PAMULANG, KOTA TANGERANG SELATAN, BANTEN",74,119,100,219
https://kawalpemilu.org#53232,"BAMBU APUS, PAMULANG, KOTA TANGERANG SELATAN, BANTEN",75,83,120,203
https://kawalpemilu.org#53232,"BAMBU APUS, PAMULANG, KOTA TANGERANG SELATAN, BANTEN",76,104,71,175
https://kawalpemilu.org#53233,"PAMULANG TIMUR, PAMULANG, KOTA TANGERANG SELATAN, BANTEN",1,145,51,196
https://kawalpemilu.org#53233,"PAMULANG TIMUR, PAMULANG, KOTA TANGERANG SELATAN, BANTEN",2,150,78,228
https://kawalpemilu.org#53233,"PAMULANG TIMUR, PAMULANG, KOTA TANGERANG SELATAN, BANTEN",3,144,84,228
https://kawalpemilu.org#53233,"PAMULANG TIMUR, PAMULANG, KOTA TANGERANG SELATAN, BANTEN",4,94,65,159
https://kawalpemilu.org#53233,"PAMULANG TIMUR, PAMULANG, KOTA TANGERANG SELATAN, BANTEN",5,100,78,178
https://kawalpemilu.org#53233,"PAMULANG TIMUR, PAMULANG, KOTA TANGERANG SELATAN, BANTEN",6,122,129,251
https://kawalpemilu.org#53233,"PAMULANG TIMUR, PAMULANG, KOTA TANGERANG SELATAN, BANTEN",7,122,123,245
https://kawalpemilu.org#53233,"PAMULANG TIMUR, PAMULANG, KOTA TANGERANG SELATAN, BANTEN",8,108,106,214
https://kawalpemilu.org#53233,"PAMULANG TIMUR, PAMULANG, KOTA TANGERANG SELATAN, BANTEN",9,139,118,257
https://kawalpemilu.org#53233,"PAMULANG TIMUR, PAMULANG, KOTA TANGERANG SELATAN, BANTEN",10,117,96,213
https://kawalpemilu.org#53233,"PAMULANG TIMUR, PAMULANG, KOTA TANGERANG SELATAN, BANTEN",11,108,93,201
https://kawalpemilu.org#53233,"PAMULANG TIMUR, PAMULANG, KOTA TANGERANG SELATAN, BANTEN",12,124,126,250
https://kawalpemilu.org#53233,"PAMULANG TIMUR, PAMULANG, KOTA TANGERANG SELATAN, BANTEN",13,75,139,214
https://kawalpemilu.org#53233,"PAMULANG TIMUR, PAMULANG, KOTA TANGERANG SELATAN, BANTEN",14,88,112,200
https://kawalpemilu.org#53233,"PAMULANG TIMUR, PAMULANG, KOTA TANGERANG SELATAN, BANTEN",15,107,134,241
https://kawalpemilu.org#53233,"PAMULANG TIMUR, PAMULANG, KOTA TANGERANG SELATAN, BANTEN",16,107,129,236
https://kawalpemilu.org#53233,"PAMULANG TIMUR, PAMULANG, KOTA TANGERANG SELATAN, BANTEN",17,102,115,217
https://kawalpemilu.org#53233,"PAMULANG TIMUR, PAMULANG, KOTA TANGERANG SELATAN, BANTEN",18,83,138,221
https://kawalpemilu.org#53233,"PAMULANG TIMUR, PAMULANG, KOTA TANGERANG SELATAN, BANTEN",19,120,97,217
https://kawalpemilu.org#53233,"PAMULANG TIMUR, PAMULANG, KOTA TANGERANG SELATAN, BANTEN",20,95,118,213
https://kawalpemilu.org#53233,"PAMULANG TIMUR, PAMULANG, KOTA TANGERANG SELATAN, BANTEN",21,91,97,188
https://kawalpemilu.org#53233,"PAMULANG TIMUR, PAMULANG, KOTA TANGERANG SELATAN, BANTEN",22,120,126,246
https://kawalpemilu.org#53233,"PAMULANG TIMUR, PAMULANG, KOTA TANGERANG SELATAN, BANTEN",23,97,142,239
https://kawalpemilu.org#53233,"PAMULANG TIMUR, PAMULANG, KOTA TANGERANG SELATAN, BANTEN",24,114,127,241
https://kawalpemilu.org#53233,"PAMULANG TIMUR, PAMULANG, KOTA TANGERANG SELATAN, BANTEN",25,142,101,243
https://kawalpemilu.org#53233,"PAMULANG TIMUR, PAMULANG, KOTA TANGERANG SELATAN, BANTEN",26,136,95,231
https://kawalpemilu.org#53233,"PAMULANG TIMUR, PAMULANG, KOTA TANGERANG SELATAN, BANTEN",27,144,89,233
https://kawalpemilu.org#53233,"PAMULANG TIMUR, PAMULANG, KOTA TANGERANG SELATAN, BANTEN",28,114,85,199
https://kawalpemilu.org#53233,"PAMULANG TIMUR, PAMULANG, KOTA TANGERANG SELATAN, BANTEN",29,125,134,259
https://kawalpemilu.org#53233,"PAMULANG TIMUR, PAMULANG, KOTA TANGERANG SELATAN, BANTEN",30,112,65,177
https://kawalpemilu.org#53233,"PAMULANG TIMUR, PAMULANG, KOTA TANGERANG SELATAN, BANTEN",31,99,87,186
https://kawalpemilu.org#53233,"PAMULANG TIMUR, PAMULANG, KOTA TANGERANG SELATAN, BANTEN",32,122,58,180
https://kawalpemilu.org#53233,"PAMULANG TIMUR, PAMULANG, KOTA TANGERANG SELATAN, BANTEN",33,110,41,151
https://kawalpemilu.org#53233,"PAMULANG TIMUR, PAMULANG, KOTA TANGERANG SELATAN, BANTEN",34,130,89,219
https://kawalpemilu.org#53233,"PAMULANG TIMUR, PAMULANG, KOTA TANGERANG SELATAN, BANTEN",35,100,63,163
https://kawalpemilu.org#53233,"PAMULANG TIMUR, PAMULANG, KOTA TANGERANG SELATAN, BANTEN",36,66,69,135
https://kawalpemilu.org#53233,"PAMULANG TIMUR, PAMULANG, KOTA TANGERANG SELATAN, BANTEN",37,121,117,238
https://kawalpemilu.org#53233,"PAMULANG TIMUR, PAMULANG, KOTA TANGERANG SELATAN, BANTEN",38,112,127,239
https://kawalpemilu.org#53233,"PAMULANG TIMUR, PAMULANG, KOTA TANGERANG SELATAN, BANTEN",39,91,135,226
https://kawalpemilu.org#53233,"PAMULANG TIMUR, PAMULANG, KOTA TANGERANG SELATAN, BANTEN",40,101,100,201
https://kawalpemilu.org#53233,"PAMULANG TIMUR, PAMULANG, KOTA TANGERANG SELATAN, BANTEN",41,139,105,244
https://kawalpemilu.org#53233,"PAMULANG TIMUR, PAMULANG, KOTA TANGERANG SELATAN, BANTEN",42,144,104,248
https://kawalpemilu.org#53233,"PAMULANG TIMUR, PAMULANG, KOTA TANGERANG SELATAN, BANTEN",43,95,95,190
https://kawalpemilu.org#53233,"PAMULANG TIMUR, PAMULANG, KOTA TANGERANG SELATAN, BANTEN",44,68,123,191
https://kawalpemilu.org#53233,"PAMULANG TIMUR, PAMULANG, KOTA TANGERANG SELATAN, BANTEN",45,82,147,229
https://kawalpemilu.org#53233,"PAMULANG TIMUR, PAMULANG, KOTA TANGERANG SELATAN, BANTEN",46,74,124,194
https://kawalpemilu.org#53233,"PAMULANG TIMUR, PAMULANG, KOTA TANGERANG SELATAN, BANTEN",47,90,105,195
https://kawalpemilu.org#53233,"PAMULANG TIMUR, PAMULANG, KOTA TANGERANG SELATAN, BANTEN",48,54,155,209
https://kawalpemilu.org#53233,"PAMULANG TIMUR, PAMULANG, KOTA TANGERANG SELATAN, BANTEN",49,70,102,172
https://kawalpemilu.org#53233,"PAMULANG TIMUR, PAMULANG, KOTA TANGERANG SELATAN, BANTEN",50,103,99,202
https://kawalpemilu.org#53233,"PAMULANG TIMUR, PAMULANG, KOTA TANGERANG SELATAN, BANTEN",51,100,99,199
https://kawalpemilu.org#53233,"PAMULANG TIMUR, PAMULANG, KOTA TANGERANG SELATAN, BANTEN",52,141,113,254
https://kawalpemilu.org#53233,"PAMULANG TIMUR, PAMULANG, KOTA TANGERANG SELATAN, BANTEN",53,123,87,210
https://kawalpemilu.org#53233,"PAMULANG TIMUR, PAMULANG, KOTA TANGERANG SELATAN, BANTEN",54,114,68,182
https://kawalpemilu.org#53233,"PAMULANG TIMUR, PAMULANG, KOTA TANGERANG SELATAN, BANTEN",55,60,121,181
https://kawalpemilu.org#53233,"PAMULANG TIMUR, PAMULANG, KOTA TANGERANG SELATAN, BANTEN",56,79,129,208
https://kawalpemilu.org#53233,"PAMULANG TIMUR, PAMULANG, KOTA TANGERANG SELATAN, BANTEN",57,98,138,236
https://kawalpemilu.org#53233,"PAMULANG TIMUR, PAMULANG, KOTA TANGERANG SELATAN, BANTEN",58,68,174,242
https://kawalpemilu.org#53233,"PAMULANG TIMUR, PAMULANG, KOTA TANGERANG SELATAN, BANTEN",59,49,96,145
https://kawalpemilu.org#53233,"PAMULANG TIMUR, PAMULANG, KOTA TANGERANG SELATAN, BANTEN",60,128,80,208
https://kawalpemilu.org#53233,"PAMULANG TIMUR, PAMULANG, KOTA TANGERANG SELATAN, BANTEN",61,90,66,156
https://kawalpemilu.org#53233,"PAMULANG TIMUR, PAMULANG, KOTA TANGERANG SELATAN, BANTEN",62,70,75,145
https://kawalpemilu.org#53233,"PAMULANG TIMUR, PAMULANG, KOTA TANGERANG SELATAN, BANTEN",63,127,94,221
https://kawalpemilu.org#53233,"PAMULANG TIMUR, PAMULANG, KOTA TANGERANG SELATAN, BANTEN",64,146,65,211
https://kawalpemilu.org#53233,"PAMULANG TIMUR, PAMULANG, KOTA TANGERANG SELATAN, BANTEN",65,150,84,234
https://kawalpemilu.org#53233,"PAMULANG TIMUR, PAMULANG, KOTA TANGERANG SELATAN, BANTEN",66,154,80,234
https://kawalpemilu.org#53233,"PAMULANG TIMUR, PAMULANG, KOTA TANGERANG SELATAN, BANTEN",67,156,80,236
https://kawalpemilu.org#53233,"PAMULANG TIMUR, PAMULANG, KOTA TANGERANG SELATAN, BANTEN",68,106,118,224
https://kawalpemilu.org#53233,"PAMULANG TIMUR, PAMULANG, KOTA TANGERANG SELATAN, BANTEN",69,52,66,118
https://kawalpemilu.org#53233,"PAMULANG TIMUR, PAMULANG, KOTA TANGERANG SELATAN, BANTEN",70,91,152,243
https://kawalpemilu.org#53233,"PAMULANG TIMUR, PAMULANG, KOTA TANGERANG SELATAN, BANTEN",71,114,154,268
https://kawalpemilu.org#53233,"PAMULANG TIMUR, PAMULANG, KOTA TANGERANG SELATAN, BANTEN",72,80,117,197
https://kawalpemilu.org#53233,"PAMULANG TIMUR, PAMULANG, KOTA TANGERANG SELATAN, BANTEN",73,124,131,255
https://kawalpemilu.org#53233,"PAMULANG TIMUR, PAMULANG, KOTA TANGERANG SELATAN, BANTEN",74,118,120,238
https://kawalpemilu.org#53233,"PAMULANG TIMUR, PAMULANG, KOTA TANGERANG SELATAN, BANTEN",75,112,157,269
https://kawalpemilu.org#53233,"PAMULANG TIMUR, PAMULANG, KOTA TANGERANG SELATAN, BANTEN",76,78,165,243
https://kawalpemilu.org#53233,"PAMULANG TIMUR, PAMULANG, KOTA TANGERANG SELATAN, BANTEN",77,87,123,210
https://kawalpemilu.org#53233,"PAMULANG TIMUR, PAMULANG, KOTA TANGERANG SELATAN, BANTEN",78,113,106,219
https://kawalpemilu.org#53233,"PAMULANG TIMUR, PAMULANG, KOTA TANGERANG SELATAN, BANTEN",79,134,77,211
https://kawalpemilu.org#53233,"PAMULANG TIMUR, PAMULANG, KOTA TANGERANG SELATAN, BANTEN",80,82,135,217
https://kawalpemilu.org#53233,"PAMULANG TIMUR, PAMULANG, KOTA TANGERANG SELATAN, BANTEN",81,100,91,191
https://kawalpemilu.org#53233,"PAMULANG TIMUR, PAMULANG, KOTA TANGERANG SELATAN, BANTEN",82,76,119,195
https://kawalpemilu.org#53233,"PAMULANG TIMUR, PAMULANG, KOTA TANGERANG SELATAN, BANTEN",83,73,100,173
https://kawalpemilu.org#53233,"PAMULANG TIMUR, PAMULANG, KOTA TANGERANG SELATAN, BANTEN",84,73,126,199
https://kawalpemilu.org#53233,"PAMULANG TIMUR, PAMULANG, KOTA TANGERANG SELATAN, BANTEN",85,68,132,200
https://kawalpemilu.org#53233,"PAMULANG TIMUR, PAMULANG, KOTA TANGERANG SELATAN, BANTEN",86,86,86,172
https://kawalpemilu.org#53233,"PAMULANG TIMUR, PAMULANG, KOTA TANGERANG SELATAN, BANTEN",87,70,127,197
https://kawalpemilu.org#53233,"PAMULANG TIMUR, PAMULANG, KOTA TANGERANG SELATAN, BANTEN",88,70,67,137
https://kawalpemilu.org#53233,"PAMULANG TIMUR, PAMULANG, KOTA TANGERANG SELATAN, BANTEN",89,77,67,144
https://kawalpemilu.org#53233,"PAMULANG TIMUR, PAMULANG, KOTA TANGERANG SELATAN, BANTEN",90,133,84,217
https://kawalpemilu.org#53235,"MUNCUL, SETU, KOTA TANGERANG SELATAN, BANTEN",1,92,114,206
https://kawalpemilu.org#53235,"MUNCUL, SETU, KOTA TANGERANG SELATAN, BANTEN",2,106,98,204
https://kawalpemilu.org#53235,"MUNCUL, SETU, KOTA TANGERANG SELATAN, BANTEN",3,78,102,180
https://kawalpemilu.org#53235,"MUNCUL, SETU, KOTA TANGERANG SELATAN, BANTEN",4,84,170,254
https://kawalpemilu.org#53235,"MUNCUL, SETU, KOTA TANGERANG SELATAN, BANTEN",5,78,180,258
https://kawalpemilu.org#53235,"MUNCUL, SETU, KOTA TANGERANG SELATAN, BANTEN",6,94,109,203
https://kawalpemilu.org#53235,"MUNCUL, SETU, KOTA TANGERANG SELATAN, BANTEN",7,96,134,230
https://kawalpemilu.org#53235,"MUNCUL, SETU, KOTA TANGERANG SELATAN, BANTEN",8,77,131,208
https://kawalpemilu.org#53235,"MUNCUL, SETU, KOTA TANGERANG SELATAN, BANTEN",9,82,160,242
https://kawalpemilu.org#53235,"MUNCUL, SETU, KOTA TANGERANG SELATAN, BANTEN",10,79,160,239
https://kawalpemilu.org#53235,"MUNCUL, SETU, KOTA TANGERANG SELATAN, BANTEN",11,90,158,248
https://kawalpemilu.org#53235,"MUNCUL, SETU, KOTA TANGERANG SELATAN, BANTEN",12,98,110,208
https://kawalpemilu.org#53235,"MUNCUL, SETU, KOTA TANGERANG SELATAN, BANTEN",13,122,100,222
https://kawalpemilu.org#53235,"MUNCUL, SETU, KOTA TANGERANG SELATAN, BANTEN",14,111,137,248
https://kawalpemilu.org#53235,"MUNCUL, SETU, KOTA TANGERANG SELATAN, BANTEN",15,35,153,188
https://kawalpemilu.org#53235,"MUNCUL, SETU, KOTA TANGERANG SELATAN, BANTEN",16,38,149,187
https://kawalpemilu.org#53235,"MUNCUL, SETU, KOTA TANGERANG SELATAN, BANTEN",17,73,166,239
https://kawalpemilu.org#53235,"MUNCUL, SETU, KOTA TANGERANG SELATAN, BANTEN",18,94,130,224
https://kawalpemilu.org#53235,"MUNCUL, SETU, KOTA TANGERANG SELATAN, BANTEN",19,85,133,218
https://kawalpemilu.org#53235,"MUNCUL, SETU, KOTA TANGERANG SELATAN, BANTEN",20,111,130,241
https://kawalpemilu.org#53235,"MUNCUL, SETU, KOTA TANGERANG SELATAN, BANTEN",21,82,130,212
https://kawalpemilu.org#53235,"MUNCUL, SETU, KOTA TANGERANG SELATAN, BANTEN",22,85,70,155
https://kawalpemilu.org#53235,"MUNCUL, SETU, KOTA TANGERANG SELATAN, BANTEN",23,78,129,207
https://kawalpemilu.org#53235,"MUNCUL, SETU, KOTA TANGERANG SELATAN, BANTEN",24,103,134,237
https://kawalpemilu.org#53235,"MUNCUL, SETU, KOTA TANGERANG SELATAN, BANTEN",25,84,116,200
https://kawalpemilu.org#53235,"MUNCUL, SETU, KOTA TANGERANG SELATAN, BANTEN",26,75,119,194
https://kawalpemilu.org#53235,"MUNCUL, SETU, KOTA TANGERANG SELATAN, BANTEN",27,106,106,212
https://kawalpemilu.org#53236,"SETU, SETU, KOTA TANGERANG SELATAN, BANTEN",1,137,146,283
https://kawalpemilu.org#53236,"SETU, SETU, KOTA TANGERANG SELATAN, BANTEN",2,111,142,253
https://kawalpemilu.org#53236,"SETU, SETU, KOTA TANGERANG SELATAN, BANTEN",3,134,125,259
https://kawalpemilu.org#53236,"SETU, SETU, KOTA TANGERANG SELATAN, BANTEN",4,204,44,248
https://kawalpemilu.org#53236,"SETU, SETU, KOTA TANGERANG SELATAN, BANTEN",5,103,116,219
https://kawalpemilu.org#53236,"SETU, SETU, KOTA TANGERANG SELATAN, BANTEN",6,104,118,222
https://kawalpemilu.org#53236,"SETU, SETU, KOTA TANGERANG SELATAN, BANTEN",7,97,163,260
https://kawalpemilu.org#53236,"SETU, SETU, KOTA TANGERANG SELATAN, BANTEN",8,117,141,258
https://kawalpemilu.org#53236,"SETU, SETU, KOTA TANGERANG SELATAN, BANTEN",9,125,107,232
https://kawalpemilu.org#53236,"SETU, SETU, KOTA TANGERANG SELATAN, BANTEN",10,140,123,263
https://kawalpemilu.org#53236,"SETU, SETU, KOTA TANGERANG SELATAN, BANTEN",11,130,107,237
https://kawalpemilu.org#53236,"SETU, SETU, KOTA TANGERANG SELATAN, BANTEN",12,131,126,257
https://kawalpemilu.org#53236,"SETU, SETU, KOTA TANGERANG SELATAN, BANTEN",13,111,126,237
https://kawalpemilu.org#53236,"SETU, SETU, KOTA TANGERANG SELATAN, BANTEN",14,101,127,228
https://kawalpemilu.org#53236,"SETU, SETU, KOTA TANGERANG SELATAN, BANTEN",15,130,119,249
https://kawalpemilu.org#53236,"SETU, SETU, KOTA TANGERANG SELATAN, BANTEN",16,137,116,253
https://kawalpemilu.org#53236,"SETU, SETU, KOTA TANGERANG SELATAN, BANTEN",17,86,143,229
https://kawalpemilu.org#53236,"SETU, SETU, KOTA TANGERANG SELATAN, BANTEN",18,114,123,237
https://kawalpemilu.org#53236,"SETU, SETU, KOTA TANGERANG SELATAN, BANTEN",19,151,130,281
https://kawalpemilu.org#53236,"SETU, SETU, KOTA TANGERANG SELATAN, BANTEN",20,119,152,271
https://kawalpemilu.org#53236,"SETU, SETU, KOTA TANGERANG SELATAN, BANTEN",21,126,171,297
https://kawalpemilu.org#53236,"SETU, SETU, KOTA TANGERANG SELATAN, BANTEN",22,93,130,223
https://kawalpemilu.org#53236,"SETU, SETU, KOTA TANGERANG SELATAN, BANTEN",23,94,110,204
https://kawalpemilu.org#53236,"SETU, SETU, KOTA TANGERANG SELATAN, BANTEN",24,126,128,224
https://kawalpemilu.org#53236,"SETU, SETU, KOTA TANGERANG SELATAN, BANTEN",25,74,126,200
https://kawalpemilu.org#53236,"SETU, SETU, KOTA TANGERANG SELATAN, BANTEN",26,97,139,236
https://kawalpemilu.org#53236,"SETU, SETU, KOTA TANGERANG SELATAN, BANTEN",27,125,95,220
https://kawalpemilu.org#53236,"SETU, SETU, KOTA TANGERANG SELATAN, BANTEN",28,60,156,216
https://kawalpemilu.org#53236,"SETU, SETU, KOTA TANGERANG SELATAN, BANTEN",29,69,141,210
https://kawalpemilu.org#53236,"SETU, SETU, KOTA TANGERANG SELATAN, BANTEN",30,72,135,207
https://kawalpemilu.org#53236,"SETU, SETU, KOTA TANGERANG SELATAN, BANTEN",31,143,113,256
https://kawalpemilu.org#53236,"SETU, SETU, KOTA TANGERANG SELATAN, BANTEN",32,80,156,236
https://kawalpemilu.org#53236,"SETU, SETU, KOTA TANGERANG SELATAN, BANTEN",33,96,151,247
https://kawalpemilu.org#53237,"KRANGGAN, SETU, KOTA TANGERANG SELATAN, BANTEN",1,73,161,234
https://kawalpemilu.org#53237,"KRANGGAN, SETU, KOTA TANGERANG SELATAN, BANTEN",2,57,171,228
https://kawalpemilu.org#53237,"KRANGGAN, SETU, KOTA TANGERANG SELATAN, BANTEN",3,61,157,218
https://kawalpemilu.org#53237,"KRANGGAN, SETU, KOTA TANGERANG SELATAN, BANTEN",4,69,197,266
https://kawalpemilu.org#53237,"KRANGGAN, SETU, KOTA TANGERANG SELATAN, BANTEN",5,74,184,258
https://kawalpemilu.org#53237,"KRANGGAN, SETU, KOTA TANGERANG SELATAN, BANTEN",6,69,188,257
https://kawalpemilu.org#53237,"KRANGGAN, SETU, KOTA TANGERANG SELATAN, BANTEN",7,62,119,181
https://kawalpemilu.org#53237,"KRANGGAN, SETU, KOTA TANGERANG SELATAN, BANTEN",8,131,133,264
https://kawalpemilu.org#53237,"KRANGGAN, SETU, KOTA TANGERANG SELATAN, BANTEN",9,107,152,259
https://kawalpemilu.org#53237,"KRANGGAN, SETU, KOTA TANGERANG SELATAN, BANTEN",10,81,173,254
https://kawalpemilu.org#53237,"KRANGGAN, SETU, KOTA TANGERANG SELATAN, BANTEN",11,77,168,245
https://kawalpemilu.org#53237,"KRANGGAN, SETU, KOTA TANGERANG SELATAN, BANTEN",12,88,172,260
https://kawalpemilu.org#53237,"KRANGGAN, SETU, KOTA TANGERANG SELATAN, BANTEN",13,69,152,221
https://kawalpemilu.org#53237,"KRANGGAN, SETU, KOTA TANGERANG SELATAN, BANTEN",14,72,134,206
https://kawalpemilu.org#53237,"KRANGGAN, SETU, KOTA TANGERANG SELATAN, BANTEN",15,85,154,239
https://kawalpemilu.org#53237,"KRANGGAN, SETU, KOTA TANGERANG SELATAN, BANTEN",16,87,177,264
https://kawalpemilu.org#53237,"KRANGGAN, SETU, KOTA TANGERANG SELATAN, BANTEN",17,74,183,257
https://kawalpemilu.org#53237,"KRANGGAN, SETU, KOTA TANGERANG SELATAN, BANTEN",18,71,168,239
https://kawalpemilu.org#53237,"KRANGGAN, SETU, KOTA TANGERANG SELATAN, BANTEN",19,63,203,266
https://kawalpemilu.org#53238,"KADEMANGAN, SETU, KOTA TANGERANG SELATAN, BANTEN",1,93,110,203
https://kawalpemilu.org#53238,"KADEMANGAN, SETU, KOTA TANGERANG SELATAN, BANTEN",2,91,90,181
https://kawalpemilu.org#53238,"KADEMANGAN, SETU, KOTA TANGERANG SELATAN, BANTEN",3,121,118,239
https://kawalpemilu.org#53238,"KADEMANGAN, SETU, KOTA TANGERANG SELATAN, BANTEN",4,88,148,236
https://kawalpemilu.org#53238,"KADEMANGAN, SETU, KOTA TANGERANG SELATAN, BANTEN",5,108,132,240
https://kawalpemilu.org#53238,"KADEMANGAN, SETU, KOTA TANGERANG SELATAN, BANTEN",6,108,122,230
https://kawalpemilu.org#53238,"KADEMANGAN, SETU, KOTA TANGERANG SELATAN, BANTEN",7,115,189,304
https://kawalpemilu.org#53238,"KADEMANGAN, SETU, KOTA TANGERANG SELATAN, BANTEN",9,88,133,221
https://kawalpemilu.org#53238,"KADEMANGAN, SETU, KOTA TANGERANG SELATAN, BANTEN",10,61,101,162
https://kawalpemilu.org#53238,"KADEMANGAN, SETU, KOTA TANGERANG SELATAN, BANTEN",11,59,123,182
https://kawalpemilu.org#53238,"KADEMANGAN, SETU, KOTA TANGERANG SELATAN, BANTEN",12,65,83,148
https://kawalpemilu.org#53238,"KADEMANGAN, SETU, KOTA TANGERANG SELATAN, BANTEN",13,91,125,216
https://kawalpemilu.org#53238,"KADEMANGAN, SETU, KOTA TANGERANG SELATAN, BANTEN",14,56,79,135
https://kawalpemilu.org#53238,"KADEMANGAN, SETU, KOTA TANGERANG SELATAN, BANTEN",15,129,152,281
https://kawalpemilu.org#53238,"KADEMANGAN, SETU, KOTA TANGERANG SELATAN, BANTEN",16,95,158,253
https://kawalpemilu.org#53238,"KADEMANGAN, SETU, KOTA TANGERANG SELATAN, BANTEN",17,112,108,220
https://kawalpemilu.org#53238,"KADEMANGAN, SETU, KOTA TANGERANG SELATAN, BANTEN",18,92,165,257
https://kawalpemilu.org#53238,"KADEMANGAN, SETU, KOTA TANGERANG SELATAN, BANTEN",19,70,188,258
https://kawalpemilu.org#53238,"KADEMANGAN, SETU, KOTA TANGERANG SELATAN, BANTEN",20,109,149,258
https://kawalpemilu.org#53238,"KADEMANGAN, SETU, KOTA TANGERANG SELATAN, BANTEN",21,96,183,279
https://kawalpemilu.org#53238,"KADEMANGAN, SETU, KOTA TANGERANG SELATAN, BANTEN",22,97,133,230
https://kawalpemilu.org#53238,"KADEMANGAN, SETU, KOTA TANGERANG SELATAN, BANTEN",23,86,181,267
https://kawalpemilu.org#53238,"KADEMANGAN, SETU, KOTA TANGERANG SELATAN, BANTEN",24,90,189,279
https://kawalpemilu.org#53238,"KADEMANGAN, SETU, KOTA TANGERANG SELATAN, BANTEN",25,93,131,224
https://kawalpemilu.org#53238,"KADEMANGAN, SETU, KOTA TANGERANG SELATAN, BANTEN",26,108,120,228
https://kawalpemilu.org#53238,"KADEMANGAN, SETU, KOTA TANGERANG SELATAN, BANTEN",27,97,157,254
https://kawalpemilu.org#53238,"KADEMANGAN, SETU, KOTA TANGERANG SELATAN, BANTEN",28,68,169,237
https://kawalpemilu.org#53238,"KADEMANGAN, SETU, KOTA TANGERANG SELATAN, BANTEN",29,71,168,239
https://kawalpemilu.org#53238,"KADEMANGAN, SETU, KOTA TANGERANG SELATAN, BANTEN",30,92,114,206
https://kawalpemilu.org#53238,"KADEMANGAN, SETU, KOTA TANGERANG SELATAN, BANTEN",31,104,98,202
https://kawalpemilu.org#53238,"KADEMANGAN, SETU, KOTA TANGERANG SELATAN, BANTEN",32,106,135,241
https://kawalpemilu.org#53238,"KADEMANGAN, SETU, KOTA TANGERANG SELATAN, BANTEN",33,96,177,273
https://kawalpemilu.org#53238,"KADEMANGAN, SETU, KOTA TANGERANG SELATAN, BANTEN",34,84,178,262
https://kawalpemilu.org#53238,"KADEMANGAN, SETU, KOTA TANGERANG SELATAN, BANTEN",35,91,127,218
https://kawalpemilu.org#53238,"KADEMANGAN, SETU, KOTA TANGERANG SELATAN, BANTEN",36,140,112,252
https://kawalpemilu.org#53238,"KADEMANGAN, SETU, KOTA TANGERANG SELATAN, BANTEN",37,67,63,130
https://kawalpemilu.org#53238,"KADEMANGAN, SETU, KOTA TANGERANG SELATAN, BANTEN",38,115,100,215
https://kawalpemilu.org#53238,"KADEMANGAN, SETU, KOTA TANGERANG SELATAN, BANTEN",39,98,112,210
https://kawalpemilu.org#53238,"KADEMANGAN, SETU, KOTA TANGERANG SELATAN, BANTEN",40,86,154,240
https://kawalpemilu.org#53238,"KADEMANGAN, SETU, KOTA TANGERANG SELATAN, BANTEN",41,84,122,206
https://kawalpemilu.org#53238,"KADEMANGAN, SETU, KOTA TANGERANG SELATAN, BANTEN",42,44,93,137
https://kawalpemilu.org#53238,"KADEMANGAN, SETU, KOTA TANGERANG SELATAN, BANTEN",43,82,136,218
https://kawalpemilu.org#53238,"KADEMANGAN, SETU, KOTA TANGERANG SELATAN, BANTEN",44,77,116,193
https://kawalpemilu.org#53238,"KADEMANGAN, SETU, KOTA TANGERANG SELATAN, BANTEN",45,69,117,186
https://kawalpemilu.org#53238,"KADEMANGAN, SETU, KOTA TANGERANG SELATAN, BANTEN",46,79,125,204
https://kawalpemilu.org#53238,"KADEMANGAN, SETU, KOTA TANGERANG SELATAN, BANTEN",47,43,107,150
https://kawalpemilu.org#53238,"KADEMANGAN, SETU, KOTA TANGERANG SELATAN, BANTEN",48,74,154,228
https://kawalpemilu.org#53238,"KADEMANGAN, SETU, KOTA TANGERANG SELATAN, BANTEN",49,82,140,222
https://kawalpemilu.org#53238,"KADEMANGAN, SETU, KOTA TANGERANG SELATAN, BANTEN",50,76,126,202
https://kawalpemilu.org#53238,"KADEMANGAN, SETU, KOTA TANGERANG SELATAN, BANTEN",51,61,92,153
https://kawalpemilu.org#53238,"KADEMANGAN, SETU, KOTA TANGERANG SELATAN, BANTEN",52,95,121,216
https://kawalpemilu.org#53238,"KADEMANGAN, SETU, KOTA TANGERANG SELATAN, BANTEN",53,86,143,229
https://kawalpemilu.org#53238,"KADEMANGAN, SETU, KOTA TANGERANG SELATAN, BANTEN",54,94,89,183
https://kawalpemilu.org#53238,"KADEMANGAN, SETU, KOTA TANGERANG SELATAN, BANTEN",55,102,92,194
https://kawalpemilu.org#53238,"KADEMANGAN, SETU, KOTA TANGERANG SELATAN, BANTEN",56,85,154,239
https://kawalpemilu.org#53238,"KADEMANGAN, SETU, KOTA TANGERANG SELATAN, BANTEN",57,78,122,200
https://kawalpemilu.org#53238,"KADEMANGAN, SETU, KOTA TANGERANG SELATAN, BANTEN",58,91,94,185
https://kawalpemilu.org#53238,"KADEMANGAN, SETU, KOTA TANGERANG SELATAN, BANTEN",59,102,152,254
https://kawalpemilu.org#53238,"KADEMANGAN, SETU, KOTA TANGERANG SELATAN, BANTEN",60,136,130,266
https://kawalpemilu.org#53239,"BABAKAN, SETU, KOTA TANGERANG SELATAN, BANTEN",1,88,96,184
https://kawalpemilu.org#53239,"BABAKAN, SETU, KOTA TANGERANG SELATAN, BANTEN",2,139,78,217
https://kawalpemilu.org#53239,"BABAKAN, SETU, KOTA TANGERANG SELATAN, BANTEN",3,164,112,276
https://kawalpemilu.org#53239,"BABAKAN, SETU, KOTA TANGERANG SELATAN, BANTEN",4,137,91,228
https://kawalpemilu.org#53239,"BABAKAN, SETU, KOTA TANGERANG SELATAN, BANTEN",5,124,124,248
https://kawalpemilu.org#53239,"BABAKAN, SETU, KOTA TANGERANG SELATAN, BANTEN",6,132,127,259
https://kawalpemilu.org#53239,"BABAKAN, SETU, KOTA TANGERANG SELATAN, BANTEN",7,135,104,139
https://kawalpemilu.org#53239,"BABAKAN, SETU, KOTA TANGERANG SELATAN, BANTEN",8,154,89,243
https://kawalpemilu.org#53239,"BABAKAN, SETU, KOTA TANGERANG SELATAN, BANTEN",9,123,119,242
https://kawalpemilu.org#53239,"BABAKAN, SETU, KOTA TANGERANG SELATAN, BANTEN",10,115,126,241
https://kawalpemilu.org#53239,"BABAKAN, SETU, KOTA TANGERANG SELATAN, BANTEN",11,142,97,239
https://kawalpemilu.org#53239,"BABAKAN, SETU, KOTA TANGERANG SELATAN, BANTEN",12,142,85,227
https://kawalpemilu.org#53239,"BABAKAN, SETU, KOTA TANGERANG SELATAN, BANTEN",13,110,114,224
https://kawalpemilu.org#53239,"BABAKAN, SETU, KOTA TANGERANG SELATAN, BANTEN",14,101,126,227
https://kawalpemilu.org#53239,"BABAKAN, SETU, KOTA TANGERANG SELATAN, BANTEN",15,95,109,204
https://kawalpemilu.org#53239,"BABAKAN, SETU, KOTA TANGERANG SELATAN, BANTEN",16,117,116,233
https://kawalpemilu.org#53239,"BABAKAN, SETU, KOTA TANGERANG SELATAN, BANTEN",17,56,96,152
https://kawalpemilu.org#53239,"BABAKAN, SETU, KOTA TANGERANG SELATAN, BANTEN",18,85,113,198
https://kawalpemilu.org#53239,"BABAKAN, SETU, KOTA TANGERANG SELATAN, BANTEN",19,101,92,193
https://kawalpemilu.org#53239,"BABAKAN, SETU, KOTA TANGERANG SELATAN, BANTEN",20,99,164,263
https://kawalpemilu.org#53239,"BABAKAN, SETU, KOTA TANGERANG SELATAN, BANTEN",21,127,140,267
https://kawalpemilu.org#53239,"BABAKAN, SETU, KOTA TANGERANG SELATAN, BANTEN",22,111,133,244
https://kawalpemilu.org#53239,"BABAKAN, SETU, KOTA TANGERANG SELATAN, BANTEN",23,93,107,200
https://kawalpemilu.org#53239,"BABAKAN, SETU, KOTA TANGERANG SELATAN, BANTEN",24,161,142,303
https://kawalpemilu.org#53239,"BABAKAN, SETU, KOTA TANGERANG SELATAN, BANTEN",25,155,129,284
https://kawalpemilu.org#53239,"BABAKAN, SETU, KOTA TANGERANG SELATAN, BANTEN",26,146,73,219
https://kawalpemilu.org#53239,"BABAKAN, SETU, KOTA TANGERANG SELATAN, BANTEN",27,135,78,213
https://kawalpemilu.org#53240,"BAKTI JAYA, SETU, KOTA TANGERANG SELATAN, BANTEN",1,93,120,213
https://kawalpemilu.org#53240,"BAKTI JAYA, SETU, KOTA TANGERANG SELATAN, BANTEN",2,82,101,183
https://kawalpemilu.org#53240,"BAKTI JAYA, SETU, KOTA TANGERANG SELATAN, BANTEN",3,86,76,162
https://kawalpemilu.org#53240,"BAKTI JAYA, SETU, KOTA TANGERANG SELATAN, BANTEN",4,123,137,260
https://kawalpemilu.org#53240,"BAKTI JAYA, SETU, KOTA TANGERANG SELATAN, BANTEN",5,128,125,253
https://kawalpemilu.org#53240,"BAKTI JAYA, SETU, KOTA TANGERANG SELATAN, BANTEN",6,109,136,245
https://kawalpemilu.org#53240,"BAKTI JAYA, SETU, KOTA TANGERANG SELATAN, BANTEN",7,104,152,256
https://kawalpemilu.org#53240,"BAKTI JAYA, SETU, KOTA TANGERANG SELATAN, BANTEN",8,121,119,240
https://kawalpemilu.org#53240,"BAKTI JAYA, SETU, KOTA TANGERANG SELATAN, BANTEN",9,90,121,211
https://kawalpemilu.org#53240,"BAKTI JAYA, SETU, KOTA TANGERANG SELATAN, BANTEN",10,111,132,243
https://kawalpemilu.org#53240,"BAKTI JAYA, SETU, KOTA TANGERANG SELATAN, BANTEN",11,156,125,281
https://kawalpemilu.org#53240,"BAKTI JAYA, SETU, KOTA TANGERANG SELATAN, BANTEN",12,127,93,220
https://kawalpemilu.org#53240,"BAKTI JAYA, SETU, KOTA TANGERANG SELATAN, BANTEN",13,111,90,201
https://kawalpemilu.org#53240,"BAKTI JAYA, SETU, KOTA TANGERANG SELATAN, BANTEN",14,102,88,190
https://kawalpemilu.org#53240,"BAKTI JAYA, SETU, KOTA TANGERANG SELATAN, BANTEN",15,82,111,193
https://kawalpemilu.org#53240,"BAKTI JAYA, SETU, KOTA TANGERANG SELATAN, BANTEN",16,116,112,228
https://kawalpemilu.org#53240,"BAKTI JAYA, SETU, KOTA TANGERANG SELATAN, BANTEN",17,93,87,180
https://kawalpemilu.org#53240,"BAKTI JAYA, SETU, KOTA TANGERANG SELATAN, BANTEN",18,80,99,179
https://kawalpemilu.org#53240,"BAKTI JAYA, SETU, KOTA TANGERANG SELATAN, BANTEN",19,77,91,168
https://kawalpemilu.org#53240,"BAKTI JAYA, SETU, KOTA TANGERANG SELATAN, BANTEN",20,133,92,225
https://kawalpemilu.org#53240,"BAKTI JAYA, SETU, KOTA TANGERANG SELATAN, BANTEN",21,142,137,279
https://kawalpemilu.org#53240,"BAKTI JAYA, SETU, KOTA TANGERANG SELATAN, BANTEN",22,106,137,243
https://kawalpemilu.org#53240,"BAKTI JAYA, SETU, KOTA TANGERANG SELATAN, BANTEN",23,115,70,185
https://kawalpemilu.org#53240,"BAKTI JAYA, SETU, KOTA TANGERANG SELATAN, BANTEN",24,152,89,241
https://kawalpemilu.org#53240,"BAKTI JAYA, SETU, KOTA TANGERANG SELATAN, BANTEN",25,117,122,239
https://kawalpemilu.org#53240,"BAKTI JAYA, SETU, KOTA TANGERANG SELATAN, BANTEN",26,95,130,225
https://kawalpemilu.org#53240,"BAKTI JAYA, SETU, KOTA TANGERANG SELATAN, BANTEN",27,150,99,249
https://kawalpemilu.org#53240,"BAKTI JAYA, SETU, KOTA TANGERANG SELATAN, BANTEN",28,126,115,241
https://kawalpemilu.org#53240,"BAKTI JAYA, SETU, KOTA TANGERANG SELATAN, BANTEN",29,76,90,166
https://kawalpemilu.org#53240,"BAKTI JAYA, SETU, KOTA TANGERANG SELATAN, BANTEN",30,119,100,219
https://kawalpemilu.org#53240,"BAKTI JAYA, SETU, KOTA TANGERANG SELATAN, BANTEN",31,123,85,208
https://kawalpemilu.org#53240,"BAKTI JAYA, SETU, KOTA TANGERANG SELATAN, BANTEN",32,83,61,144
https://kawalpemilu.org#53240,"BAKTI JAYA, SETU, KOTA TANGERANG SELATAN, BANTEN",33,100,95,195
https://kawalpemilu.org#53240,"BAKTI JAYA, SETU, KOTA TANGERANG SELATAN, BANTEN",34,98,95,193
https://kawalpemilu.org#53240,"BAKTI JAYA, SETU, KOTA TANGERANG SELATAN, BANTEN",35,126,98,224
https://kawalpemilu.org#53240,"BAKTI JAYA, SETU, KOTA TANGERANG SELATAN, BANTEN",36,0,0,0
https://kawalpemilu.org#53240,"BAKTI JAYA, SETU, KOTA TANGERANG SELATAN, BANTEN",37,102,90,192
https://kawalpemilu.org#53240,"BAKTI JAYA, SETU, KOTA TANGERANG SELATAN, BANTEN",38,110,72,182
https://kawalpemilu.org#53240,"BAKTI JAYA, SETU, KOTA TANGERANG SELATAN, BANTEN",39,105,84,189
https://kawalpemilu.org#53240,"BAKTI JAYA, SETU, KOTA TANGERANG SELATAN, BANTEN",40,149,75,224
https://kawalpemilu.org#53240,"BAKTI JAYA, SETU, KOTA TANGERANG SELATAN, BANTEN",41,155,100,255
https://kawalpemilu.org#53240,"BAKTI JAYA, SETU, KOTA TANGERANG SELATAN, BANTEN",42,149,103,252
https://kawalpemilu.org#53240,"BAKTI JAYA, SETU, KOTA TANGERANG SELATAN, BANTEN",43,165,68,233
https://kawalpemilu.org#53240,"BAKTI JAYA, SETU, KOTA TANGERANG SELATAN, BANTEN",44,109,94,203
https://kawalpemilu.org#53240,"BAKTI JAYA, SETU, KOTA TANGERANG SELATAN, BANTEN",45,105,99,204
https://kawalpemilu.org#53240,"BAKTI JAYA, SETU, KOTA TANGERANG SELATAN, BANTEN",46,111,49,160
https://kawalpemilu.org#53240,"BAKTI JAYA, SETU, KOTA TANGERANG SELATAN, BANTEN",47,168,77,245
https://kawalpemilu.org#53240,"BAKTI JAYA, SETU, KOTA TANGERANG SELATAN, BANTEN",48,99,79,178
