Link KawalPemilu,Nama Kelurahan,Nomor TPS,Suara 01,Suara 02,Suara Sah
https://kawalpemilu.org#20805,"TABA TERUNJAM, KARANG TINGGI, BENGKULU TENGAH, BENGKULU",1,88,105,193
https://kawalpemilu.org#20805,"TABA TERUNJAM, KARANG TINGGI, BENGKULU TENGAH, BENGKULU",2,70,138,208
https://kawalpemilu.org#20805,"TABA TERUNJAM, KARANG TINGGI, BENGKULU TENGAH, BENGKULU",3,101,89,190
https://kawalpemilu.org#20806,"TALANG EMPAT, KARANG TINGGI, BENGKULU TENGAH, BENGKULU",1,125,83,208
https://kawalpemilu.org#20806,"TALANG EMPAT, KARANG TINGGI, BENGKULU TENGAH, BENGKULU",2,145,83,228
https://kawalpemilu.org#20806,"TALANG EMPAT, KARANG TINGGI, BENGKULU TENGAH, BENGKULU",3,142,81,223
https://kawalpemilu.org#20807,"PADANG TAMBAK, KARANG TINGGI, BENGKULU TENGAH, BENGKULU",1,64,196,260
https://kawalpemilu.org#20807,"PADANG TAMBAK, KARANG TINGGI, BENGKULU TENGAH, BENGKULU",2,100,149,249
https://kawalpemilu.org#20808,"DURIAN DEMANG, KARANG TINGGI, BENGKULU TENGAH, BENGKULU",1,73,125,198
https://kawalpemilu.org#20808,"DURIAN DEMANG, KARANG TINGGI, BENGKULU TENGAH, BENGKULU",2,80,98,178
https://kawalpemilu.org#20808,"DURIAN DEMANG, KARANG TINGGI, BENGKULU TENGAH, BENGKULU",4,76,119,195
https://kawalpemilu.org#20808,"DURIAN DEMANG, KARANG TINGGI, BENGKULU TENGAH, BENGKULU",5,93,134,227
https://kawalpemilu.org#20809,"PELAJAU, KARANG TINGGI, BENGKULU TENGAH, BENGKULU",1,63,128,191
https://kawalpemilu.org#20809,"PELAJAU, KARANG TINGGI, BENGKULU TENGAH, BENGKULU",2,48,99,147
https://kawalpemilu.org#20810,"KARANG NANDING, KARANG TINGGI, BENGKULU TENGAH, BENGKULU",1,65,71,136
https://kawalpemilu.org#20810,"KARANG NANDING, KARANG TINGGI, BENGKULU TENGAH, BENGKULU",2,91,55,146
https://kawalpemilu.org#20811,"DUSUN BARU II, KARANG TINGGI, BENGKULU TENGAH, BENGKULU",1,98,147,245
https://kawalpemilu.org#20811,"DUSUN BARU II, KARANG TINGGI, BENGKULU TENGAH, BENGKULU",2,116,110,226
https://kawalpemilu.org#20811,"DUSUN BARU II, KARANG TINGGI, BENGKULU TENGAH, BENGKULU",3,133,113,246
https://kawalpemilu.org#20812,"PENANDING, KARANG TINGGI, BENGKULU TENGAH, BENGKULU",1,97,77,174
https://kawalpemilu.org#20812,"PENANDING, KARANG TINGGI, BENGKULU TENGAH, BENGKULU",2,150,115,265
https://kawalpemilu.org#20812,"PENANDING, KARANG TINGGI, BENGKULU TENGAH, BENGKULU",3,61,180,241
https://kawalpemilu.org#20813,"KARANG TINGGI, KARANG TINGGI, BENGKULU TENGAH, BENGKULU",1,126,114,240
https://kawalpemilu.org#20813,"KARANG TINGGI, KARANG TINGGI, BENGKULU TENGAH, BENGKULU",2,74,137,211
https://kawalpemilu.org#20813,"KARANG TINGGI, KARANG TINGGI, BENGKULU TENGAH, BENGKULU",3,89,135,224
https://kawalpemilu.org#20813,"KARANG TINGGI, KARANG TINGGI, BENGKULU TENGAH, BENGKULU",4,68,133,201
https://kawalpemilu.org#20813,"KARANG TINGGI, KARANG TINGGI, BENGKULU TENGAH, BENGKULU",5,68,131,199
https://kawalpemilu.org#20814,"RENAH LEBAR, KARANG TINGGI, BENGKULU TENGAH, BENGKULU",1,55,105,160
https://kawalpemilu.org#20814,"RENAH LEBAR, KARANG TINGGI, BENGKULU TENGAH, BENGKULU",2,27,120,147
https://kawalpemilu.org#20815,"KANCING, KARANG TINGGI, BENGKULU TENGAH, BENGKULU",1,79,110,189
https://kawalpemilu.org#20815,"KANCING, KARANG TINGGI, BENGKULU TENGAH, BENGKULU",2,88,61,149
https://kawalpemilu.org#20816,"UJUNG KARANG, KARANG TINGGI, BENGKULU TENGAH, BENGKULU",1,131,97,228
https://kawalpemilu.org#20816,"UJUNG KARANG, KARANG TINGGI, BENGKULU TENGAH, BENGKULU",2,111,130,241
https://kawalpemilu.org#20816,"UJUNG KARANG, KARANG TINGGI, BENGKULU TENGAH, BENGKULU",3,90,125,215
https://kawalpemilu.org#20817,"TABA MUTUNG, KARANG TINGGI, BENGKULU TENGAH, BENGKULU",1,58,76,134
https://kawalpemilu.org#20817,"TABA MUTUNG, KARANG TINGGI, BENGKULU TENGAH, BENGKULU",2,72,63,135
https://kawalpemilu.org#84773,"SEMIDANG, KARANG TINGGI, BENGKULU TENGAH, BENGKULU",1,54,63,117
https://kawalpemilu.org#84773,"SEMIDANG, KARANG TINGGI, BENGKULU TENGAH, BENGKULU",2,61,72,133
https://kawalpemilu.org#84774,"RENAH SEMANEK, KARANG TINGGI, BENGKULU TENGAH, BENGKULU",1,77,147,224
https://kawalpemilu.org#84774,"RENAH SEMANEK, KARANG TINGGI, BENGKULU TENGAH, BENGKULU",2,61,182,243
https://kawalpemilu.org#87767,"PAGAR GUNUNG, KARANG TINGGI, BENGKULU TENGAH, BENGKULU",1,66,66,132
https://kawalpemilu.org#87768,"GAJAH MATI, KARANG TINGGI, BENGKULU TENGAH, BENGKULU",1,97,87,184
https://kawalpemilu.org#87768,"GAJAH MATI, KARANG TINGGI, BENGKULU TENGAH, BENGKULU",2,90,56,146
https://kawalpemilu.org#89230,"PADANG SIRING, KARANG TINGGI, BENGKULU TENGAH, BENGKULU",1,53,65,118
https://kawalpemilu.org#20819,"AIR SEBAKUL, TALANG EMPAT, BENGKULU TENGAH, BENGKULU",1,133,61,194
https://kawalpemilu.org#20819,"AIR SEBAKUL, TALANG EMPAT, BENGKULU TENGAH, BENGKULU",2,128,45,173
https://kawalpemilu.org#20819,"AIR SEBAKUL, TALANG EMPAT, BENGKULU TENGAH, BENGKULU",3,151,49,200
https://kawalpemilu.org#20819,"AIR SEBAKUL, TALANG EMPAT, BENGKULU TENGAH, BENGKULU",4,123,48,171
https://kawalpemilu.org#20819,"AIR SEBAKUL, TALANG EMPAT, BENGKULU TENGAH, BENGKULU",5,157,60,217
https://kawalpemilu.org#20820,"LAGAN BUNGIN, TALANG EMPAT, BENGKULU TENGAH, BENGKULU",1,117,62,179
https://kawalpemilu.org#20820,"LAGAN BUNGIN, TALANG EMPAT, BENGKULU TENGAH, BENGKULU",2,52,157,209
https://kawalpemilu.org#20822,"TABA PASMAH, TALANG EMPAT, BENGKULU TENGAH, BENGKULU",1,123,106,229
https://kawalpemilu.org#20822,"TABA PASMAH, TALANG EMPAT, BENGKULU TENGAH, BENGKULU",2,103,116,219
https://kawalpemilu.org#20822,"TABA PASMAH, TALANG EMPAT, BENGKULU TENGAH, BENGKULU",3,91,119,210
https://kawalpemilu.org#20823,"KEMBANG SERI, TALANG EMPAT, BENGKULU TENGAH, BENGKULU",1,67,115,182
https://kawalpemilu.org#20823,"KEMBANG SERI, TALANG EMPAT, BENGKULU TENGAH, BENGKULU",2,93,130,223
https://kawalpemilu.org#20823,"KEMBANG SERI, TALANG EMPAT, BENGKULU TENGAH, BENGKULU",3,94,106,200
https://kawalpemilu.org#20823,"KEMBANG SERI, TALANG EMPAT, BENGKULU TENGAH, BENGKULU",4,91,127,218
https://kawalpemilu.org#20823,"KEMBANG SERI, TALANG EMPAT, BENGKULU TENGAH, BENGKULU",5,79,132,211
https://kawalpemilu.org#20823,"KEMBANG SERI, TALANG EMPAT, BENGKULU TENGAH, BENGKULU",6,93,129,222
https://kawalpemilu.org#20823,"KEMBANG SERI, TALANG EMPAT, BENGKULU TENGAH, BENGKULU",7,102,144,246
https://kawalpemilu.org#20823,"KEMBANG SERI, TALANG EMPAT, BENGKULU TENGAH, BENGKULU",8,87,145,232
https://kawalpemilu.org#20824,"TENGAH PADANG, TALANG EMPAT, BENGKULU TENGAH, BENGKULU",1,88,113,201
https://kawalpemilu.org#20824,"TENGAH PADANG, TALANG EMPAT, BENGKULU TENGAH, BENGKULU",2,98,133,231
https://kawalpemilu.org#20824,"TENGAH PADANG, TALANG EMPAT, BENGKULU TENGAH, BENGKULU",3,113,101,214
https://kawalpemilu.org#20824,"TENGAH PADANG, TALANG EMPAT, BENGKULU TENGAH, BENGKULU",4,99,134,233
https://kawalpemilu.org#20825,"JAYAKARTA, TALANG EMPAT, BENGKULU TENGAH, BENGKULU",1,150,97,247
https://kawalpemilu.org#20825,"JAYAKARTA, TALANG EMPAT, BENGKULU TENGAH, BENGKULU",2,181,43,224
https://kawalpemilu.org#20826,"NAKAU, TALANG EMPAT, BENGKULU TENGAH, BENGKULU",1,125,61,186
https://kawalpemilu.org#20826,"NAKAU, TALANG EMPAT, BENGKULU TENGAH, BENGKULU",2,118,94,212
https://kawalpemilu.org#20826,"NAKAU, TALANG EMPAT, BENGKULU TENGAH, BENGKULU",3,161,79,240
https://kawalpemilu.org#20827,"PULAU PANGGUNG, TALANG EMPAT, BENGKULU TENGAH, BENGKULU",1,104,142,246
https://kawalpemilu.org#20827,"PULAU PANGGUNG, TALANG EMPAT, BENGKULU TENGAH, BENGKULU",2,81,163,244
https://kawalpemilu.org#20827,"PULAU PANGGUNG, TALANG EMPAT, BENGKULU TENGAH, BENGKULU",3,76,119,195
https://kawalpemilu.org#20828,"LAGAN, TALANG EMPAT, BENGKULU TENGAH, BENGKULU",1,58,128,186
https://kawalpemilu.org#20828,"LAGAN, TALANG EMPAT, BENGKULU TENGAH, BENGKULU",2,57,30,87
https://kawalpemilu.org#20829,"TABA LAGAN, TALANG EMPAT, BENGKULU TENGAH, BENGKULU",1,108,70,178
https://kawalpemilu.org#20829,"TABA LAGAN, TALANG EMPAT, BENGKULU TENGAH, BENGKULU",2,129,102,231
https://kawalpemilu.org#20829,"TABA LAGAN, TALANG EMPAT, BENGKULU TENGAH, BENGKULU",3,165,68,233
https://kawalpemilu.org#20831,"BUKIT, TALANG EMPAT, BENGKULU TENGAH, BENGKULU",1,110,98,208
https://kawalpemilu.org#20831,"BUKIT, TALANG EMPAT, BENGKULU TENGAH, BENGKULU",2,93,87,180
https://kawalpemilu.org#20831,"BUKIT, TALANG EMPAT, BENGKULU TENGAH, BENGKULU",3,93,3,96
https://kawalpemilu.org#83979,"PAGAR JATI, TALANG EMPAT, BENGKULU TENGAH, BENGKULU",1,116,34,150
https://kawalpemilu.org#83979,"PAGAR JATI, TALANG EMPAT, BENGKULU TENGAH, BENGKULU",2,97,45,142
https://kawalpemilu.org#83981,"PADANG ULAK TANJUNG, TALANG EMPAT, BENGKULU TENGAH, BENGKULU",1,89,15,104
https://kawalpemilu.org#83981,"PADANG ULAK TANJUNG, TALANG EMPAT, BENGKULU TENGAH, BENGKULU",2,104,78,182
https://kawalpemilu.org#83981,"PADANG ULAK TANJUNG, TALANG EMPAT, BENGKULU TENGAH, BENGKULU",3,78,65,143
https://kawalpemilu.org#84775,"JUM'AT, TALANG EMPAT, BENGKULU TENGAH, BENGKULU",1,96,61,157
https://kawalpemilu.org#84775,"JUM'AT, TALANG EMPAT, BENGKULU TENGAH, BENGKULU",2,136,25,161
https://kawalpemilu.org#89239,"AIR PUTIH, TALANG EMPAT, BENGKULU TENGAH, BENGKULU",1,158,62,220
https://kawalpemilu.org#89239,"AIR PUTIH, TALANG EMPAT, BENGKULU TENGAH, BENGKULU",2,111,72,183
https://kawalpemilu.org#20841,"TALANG PAUH, PONDOK KELAPA, BENGKULU TENGAH, BENGKULU",1,91,112,203
https://kawalpemilu.org#20841,"TALANG PAUH, PONDOK KELAPA, BENGKULU TENGAH, BENGKULU",2,74,107,181
https://kawalpemilu.org#20841,"TALANG PAUH, PONDOK KELAPA, BENGKULU TENGAH, BENGKULU",3,67,107,174
https://kawalpemilu.org#20841,"TALANG PAUH, PONDOK KELAPA, BENGKULU TENGAH, BENGKULU",4,80,90,170
https://kawalpemilu.org#20841,"TALANG PAUH, PONDOK KELAPA, BENGKULU TENGAH, BENGKULU",5,113,84,197
https://kawalpemilu.org#20841,"TALANG PAUH, PONDOK KELAPA, BENGKULU TENGAH, BENGKULU",6,115,124,239
https://kawalpemilu.org#20842,"SRIKATON, PONDOK KELAPA, BENGKULU TENGAH, BENGKULU",1,108,98,206
https://kawalpemilu.org#20842,"SRIKATON, PONDOK KELAPA, BENGKULU TENGAH, BENGKULU",2,120,73,193
https://kawalpemilu.org#20842,"SRIKATON, PONDOK KELAPA, BENGKULU TENGAH, BENGKULU",3,123,79,202
https://kawalpemilu.org#20843,"PEKIK NYARING, PONDOK KELAPA, BENGKULU TENGAH, BENGKULU",1,117,83,200
https://kawalpemilu.org#20843,"PEKIK NYARING, PONDOK KELAPA, BENGKULU TENGAH, BENGKULU",2,74,113,187
https://kawalpemilu.org#20843,"PEKIK NYARING, PONDOK KELAPA, BENGKULU TENGAH, BENGKULU",3,103,84,187
https://kawalpemilu.org#20843,"PEKIK NYARING, PONDOK KELAPA, BENGKULU TENGAH, BENGKULU",4,66,72,138
https://kawalpemilu.org#20843,"PEKIK NYARING, PONDOK KELAPA, BENGKULU TENGAH, BENGKULU",5,104,96,200
https://kawalpemilu.org#20843,"PEKIK NYARING, PONDOK KELAPA, BENGKULU TENGAH, BENGKULU",6,155,94,249
https://kawalpemilu.org#20843,"PEKIK NYARING, PONDOK KELAPA, BENGKULU TENGAH, BENGKULU",7,144,75,219
https://kawalpemilu.org#20843,"PEKIK NYARING, PONDOK KELAPA, BENGKULU TENGAH, BENGKULU",8,100,85,185
https://kawalpemilu.org#20843,"PEKIK NYARING, PONDOK KELAPA, BENGKULU TENGAH, BENGKULU",9,165,95,260
https://kawalpemilu.org#20843,"PEKIK NYARING, PONDOK KELAPA, BENGKULU TENGAH, BENGKULU",10,156,87,243
https://kawalpemilu.org#20843,"PEKIK NYARING, PONDOK KELAPA, BENGKULU TENGAH, BENGKULU",11,116,97,213
https://kawalpemilu.org#20843,"PEKIK NYARING, PONDOK KELAPA, BENGKULU TENGAH, BENGKULU",12,115,100,215
https://kawalpemilu.org#20843,"PEKIK NYARING, PONDOK KELAPA, BENGKULU TENGAH, BENGKULU",13,146,58,204
https://kawalpemilu.org#20844,"PASAR PEDATI, PONDOK KELAPA, BENGKULU TENGAH, BENGKULU",1,109,105,214
https://kawalpemilu.org#20844,"PASAR PEDATI, PONDOK KELAPA, BENGKULU TENGAH, BENGKULU",2,84,144,228
https://kawalpemilu.org#20844,"PASAR PEDATI, PONDOK KELAPA, BENGKULU TENGAH, BENGKULU",3,126,90,216
https://kawalpemilu.org#20844,"PASAR PEDATI, PONDOK KELAPA, BENGKULU TENGAH, BENGKULU",4,96,76,172
https://kawalpemilu.org#20844,"PASAR PEDATI, PONDOK KELAPA, BENGKULU TENGAH, BENGKULU",5,54,47,101
https://kawalpemilu.org#20844,"PASAR PEDATI, PONDOK KELAPA, BENGKULU TENGAH, BENGKULU",6,147,95,242
https://kawalpemilu.org#20844,"PASAR PEDATI, PONDOK KELAPA, BENGKULU TENGAH, BENGKULU",7,80,85,165
https://kawalpemilu.org#20844,"PASAR PEDATI, PONDOK KELAPA, BENGKULU TENGAH, BENGKULU",8,88,112,200
https://kawalpemilu.org#20844,"PASAR PEDATI, PONDOK KELAPA, BENGKULU TENGAH, BENGKULU",9,127,105,232
https://kawalpemilu.org#20844,"PASAR PEDATI, PONDOK KELAPA, BENGKULU TENGAH, BENGKULU",10,135,97,232
https://kawalpemilu.org#20844,"PASAR PEDATI, PONDOK KELAPA, BENGKULU TENGAH, BENGKULU",11,76,109,185
https://kawalpemilu.org#20844,"PASAR PEDATI, PONDOK KELAPA, BENGKULU TENGAH, BENGKULU",12,73,35,108
https://kawalpemilu.org#20844,"PASAR PEDATI, PONDOK KELAPA, BENGKULU TENGAH, BENGKULU",13,88,88,176
https://kawalpemilu.org#20844,"PASAR PEDATI, PONDOK KELAPA, BENGKULU TENGAH, BENGKULU",14,131,106,237
https://kawalpemilu.org#20845,"SUNDA KELAPA, PONDOK KELAPA, BENGKULU TENGAH, BENGKULU",1,123,78,201
https://kawalpemilu.org#20845,"SUNDA KELAPA, PONDOK KELAPA, BENGKULU TENGAH, BENGKULU",2,224,34,258
https://kawalpemilu.org#20845,"SUNDA KELAPA, PONDOK KELAPA, BENGKULU TENGAH, BENGKULU",3,117,69,186
https://kawalpemilu.org#20845,"SUNDA KELAPA, PONDOK KELAPA, BENGKULU TENGAH, BENGKULU",4,142,28,170
https://kawalpemilu.org#20846,"PONDOK KELAPA, PONDOK KELAPA, BENGKULU TENGAH, BENGKULU",1,113,101,214
https://kawalpemilu.org#20846,"PONDOK KELAPA, PONDOK KELAPA, BENGKULU TENGAH, BENGKULU",2,99,100,199
https://kawalpemilu.org#20846,"PONDOK KELAPA, PONDOK KELAPA, BENGKULU TENGAH, BENGKULU",3,125,81,206
https://kawalpemilu.org#20846,"PONDOK KELAPA, PONDOK KELAPA, BENGKULU TENGAH, BENGKULU",4,111,78,189
https://kawalpemilu.org#20846,"PONDOK KELAPA, PONDOK KELAPA, BENGKULU TENGAH, BENGKULU",5,99,126,225
https://kawalpemilu.org#20846,"PONDOK KELAPA, PONDOK KELAPA, BENGKULU TENGAH, BENGKULU",6,69,115,184
https://kawalpemilu.org#20846,"PONDOK KELAPA, PONDOK KELAPA, BENGKULU TENGAH, BENGKULU",7,69,39,108
https://kawalpemilu.org#20846,"PONDOK KELAPA, PONDOK KELAPA, BENGKULU TENGAH, BENGKULU",8,76,76,152
https://kawalpemilu.org#20846,"PONDOK KELAPA, PONDOK KELAPA, BENGKULU TENGAH, BENGKULU",9,83,129,212
https://kawalpemilu.org#20846,"PONDOK KELAPA, PONDOK KELAPA, BENGKULU TENGAH, BENGKULU",10,57,138,195
https://kawalpemilu.org#20846,"PONDOK KELAPA, PONDOK KELAPA, BENGKULU TENGAH, BENGKULU",11,102,88,190
https://kawalpemilu.org#20846,"PONDOK KELAPA, PONDOK KELAPA, BENGKULU TENGAH, BENGKULU",12,78,32,110
https://kawalpemilu.org#20846,"PONDOK KELAPA, PONDOK KELAPA, BENGKULU TENGAH, BENGKULU",13,80,67,147
https://kawalpemilu.org#20847,"PADANG BETUAH, PONDOK KELAPA, BENGKULU TENGAH, BENGKULU",1,124,128,252
https://kawalpemilu.org#20847,"PADANG BETUAH, PONDOK KELAPA, BENGKULU TENGAH, BENGKULU",2,113,130,243
https://kawalpemilu.org#20847,"PADANG BETUAH, PONDOK KELAPA, BENGKULU TENGAH, BENGKULU",3,119,49,168
https://kawalpemilu.org#20847,"PADANG BETUAH, PONDOK KELAPA, BENGKULU TENGAH, BENGKULU",4,71,100,171
https://kawalpemilu.org#20848,"SIDOREJO, PONDOK KELAPA, BENGKULU TENGAH, BENGKULU",1,104,53,157
https://kawalpemilu.org#20848,"SIDOREJO, PONDOK KELAPA, BENGKULU TENGAH, BENGKULU",2,75,76,151
https://kawalpemilu.org#20848,"SIDOREJO, PONDOK KELAPA, BENGKULU TENGAH, BENGKULU",3,148,91,239
https://kawalpemilu.org#20848,"SIDOREJO, PONDOK KELAPA, BENGKULU TENGAH, BENGKULU",4,149,69,218
https://kawalpemilu.org#20848,"SIDOREJO, PONDOK KELAPA, BENGKULU TENGAH, BENGKULU",5,133,82,215
https://kawalpemilu.org#20848,"SIDOREJO, PONDOK KELAPA, BENGKULU TENGAH, BENGKULU",6,135,45,180
https://kawalpemilu.org#20849,"SIDODADI, PONDOK KELAPA, BENGKULU TENGAH, BENGKULU",1,167,47,214
https://kawalpemilu.org#20849,"SIDODADI, PONDOK KELAPA, BENGKULU TENGAH, BENGKULU",2,94,94,188
https://kawalpemilu.org#20849,"SIDODADI, PONDOK KELAPA, BENGKULU TENGAH, BENGKULU",3,157,47,204
https://kawalpemilu.org#20849,"SIDODADI, PONDOK KELAPA, BENGKULU TENGAH, BENGKULU",4,170,23,193
https://kawalpemilu.org#20849,"SIDODADI, PONDOK KELAPA, BENGKULU TENGAH, BENGKULU",5,147,64,211
https://kawalpemilu.org#20849,"SIDODADI, PONDOK KELAPA, BENGKULU TENGAH, BENGKULU",6,90,101,191
https://kawalpemilu.org#20849,"SIDODADI, PONDOK KELAPA, BENGKULU TENGAH, BENGKULU",7,162,54,216
https://kawalpemilu.org#20850,"TALANG BOSENG, PONDOK KELAPA, BENGKULU TENGAH, BENGKULU",1,94,120,214
https://kawalpemilu.org#20850,"TALANG BOSENG, PONDOK KELAPA, BENGKULU TENGAH, BENGKULU",2,90,110,200
https://kawalpemilu.org#20851,"PAGAR DEWA, PONDOK KELAPA, BENGKULU TENGAH, BENGKULU",1,54,68,122
https://kawalpemilu.org#20851,"PAGAR DEWA, PONDOK KELAPA, BENGKULU TENGAH, BENGKULU",2,75,63,138
https://kawalpemilu.org#20852,"KEMBANG AYUN, PONDOK KELAPA, BENGKULU TENGAH, BENGKULU",1,123,126,249
https://kawalpemilu.org#20852,"KEMBANG AYUN, PONDOK KELAPA, BENGKULU TENGAH, BENGKULU",2,106,78,184
https://kawalpemilu.org#20853,"PANCA MUKTI, PONDOK KELAPA, BENGKULU TENGAH, BENGKULU",1,161,51,212
https://kawalpemilu.org#20853,"PANCA MUKTI, PONDOK KELAPA, BENGKULU TENGAH, BENGKULU",2,139,59,198
https://kawalpemilu.org#20853,"PANCA MUKTI, PONDOK KELAPA, BENGKULU TENGAH, BENGKULU",3,141,62,203
https://kawalpemilu.org#20853,"PANCA MUKTI, PONDOK KELAPA, BENGKULU TENGAH, BENGKULU",4,112,95,207
https://kawalpemilu.org#20854,"SRI KUNCORO, PONDOK KELAPA, BENGKULU TENGAH, BENGKULU",1,113,92,205
https://kawalpemilu.org#20854,"SRI KUNCORO, PONDOK KELAPA, BENGKULU TENGAH, BENGKULU",2,151,49,200
https://kawalpemilu.org#20854,"SRI KUNCORO, PONDOK KELAPA, BENGKULU TENGAH, BENGKULU",3,152,53,205
https://kawalpemilu.org#20854,"SRI KUNCORO, PONDOK KELAPA, BENGKULU TENGAH, BENGKULU",4,148,62,210
https://kawalpemilu.org#20854,"SRI KUNCORO, PONDOK KELAPA, BENGKULU TENGAH, BENGKULU",5,125,81,206
https://kawalpemilu.org#20855,"BINTANG SELATAN, PONDOK KELAPA, BENGKULU TENGAH, BENGKULU",1,34,105,139
https://kawalpemilu.org#20855,"BINTANG SELATAN, PONDOK KELAPA, BENGKULU TENGAH, BENGKULU",2,49,120,169
https://kawalpemilu.org#84776,"ABU SAKIM, PONDOK KELAPA, BENGKULU TENGAH, BENGKULU",1,96,94,190
https://kawalpemilu.org#84776,"ABU SAKIM, PONDOK KELAPA, BENGKULU TENGAH, BENGKULU",2,139,48,187
https://kawalpemilu.org#84776,"ABU SAKIM, PONDOK KELAPA, BENGKULU TENGAH, BENGKULU",3,171,16,187
https://kawalpemilu.org#89232,"HARAPAN, PONDOK KELAPA, BENGKULU TENGAH, BENGKULU",1,181,75,256
https://kawalpemilu.org#89232,"HARAPAN, PONDOK KELAPA, BENGKULU TENGAH, BENGKULU",2,172,83,255
https://kawalpemilu.org#89232,"HARAPAN, PONDOK KELAPA, BENGKULU TENGAH, BENGKULU",3,44,162,206
https://kawalpemilu.org#89232,"HARAPAN, PONDOK KELAPA, BENGKULU TENGAH, BENGKULU",4,54,145,199
https://kawalpemilu.org#20858,"ATURAN MUMPO, PEMATANG TIGA, BENGKULU TENGAH, BENGKULU",1,75,105,180
https://kawalpemilu.org#20858,"ATURAN MUMPO, PEMATANG TIGA, BENGKULU TENGAH, BENGKULU",2,69,74,143
https://kawalpemilu.org#20859,"TALANG TENGAH II, PEMATANG TIGA, BENGKULU TENGAH, BENGKULU",1,46,123,169
https://kawalpemilu.org#20859,"TALANG TENGAH II, PEMATANG TIGA, BENGKULU TENGAH, BENGKULU",2,53,115,168
https://kawalpemilu.org#20860,"KOTA TITIK, PEMATANG TIGA, BENGKULU TENGAH, BENGKULU",1,61,55,116
https://kawalpemilu.org#20860,"KOTA TITIK, PEMATANG TIGA, BENGKULU TENGAH, BENGKULU",2,28,96,124
https://kawalpemilu.org#20863,"SENABAH, PEMATANG TIGA, BENGKULU TENGAH, BENGKULU",1,49,203,252
https://kawalpemilu.org#20871,"AIR KOTOK, PEMATANG TIGA, BENGKULU TENGAH, BENGKULU",1,105,125,230
https://kawalpemilu.org#20871,"AIR KOTOK, PEMATANG TIGA, BENGKULU TENGAH, BENGKULU",2,64,44,108
https://kawalpemilu.org#20872,"BATU BERIANG, PEMATANG TIGA, BENGKULU TENGAH, BENGKULU",1,108,114,222
https://kawalpemilu.org#20872,"BATU BERIANG, PEMATANG TIGA, BENGKULU TENGAH, BENGKULU",2,99,111,210
https://kawalpemilu.org#20873,"PEMATANG TIGA, PEMATANG TIGA, BENGKULU TENGAH, BENGKULU",1,80,133,213
https://kawalpemilu.org#20873,"PEMATANG TIGA, PEMATANG TIGA, BENGKULU TENGAH, BENGKULU",2,81,167,248
https://kawalpemilu.org#20874,"TIAMBANG, PEMATANG TIGA, BENGKULU TENGAH, BENGKULU",1,55,113,168
https://kawalpemilu.org#20874,"TIAMBANG, PEMATANG TIGA, BENGKULU TENGAH, BENGKULU",2,46,103,149
https://kawalpemilu.org#20875,"KEBUN LEBAR, PEMATANG TIGA, BENGKULU TENGAH, BENGKULU",1,39,115,154
https://kawalpemilu.org#20875,"KEBUN LEBAR, PEMATANG TIGA, BENGKULU TENGAH, BENGKULU",2,68,134,202
https://kawalpemilu.org#20876,"TANJUNG KEPAHYANG, PEMATANG TIGA, BENGKULU TENGAH, BENGKULU",1,91,82,173
https://kawalpemilu.org#20876,"TANJUNG KEPAHYANG, PEMATANG TIGA, BENGKULU TENGAH, BENGKULU",2,62,105,167
https://kawalpemilu.org#83973,"ATURAN MUMPO II, PEMATANG TIGA, BENGKULU TENGAH, BENGKULU",1,40,218,258
https://kawalpemilu.org#83973,"ATURAN MUMPO II, PEMATANG TIGA, BENGKULU TENGAH, BENGKULU",2,36,191,227
https://kawalpemilu.org#83974,"GENTING DABUK, PEMATANG TIGA, BENGKULU TENGAH, BENGKULU",1,79,136,215
https://kawalpemilu.org#83974,"GENTING DABUK, PEMATANG TIGA, BENGKULU TENGAH, BENGKULU",2,54,72,126
https://kawalpemilu.org#83975,"PEMATANG TIGA LAMA, PEMATANG TIGA, BENGKULU TENGAH, BENGKULU",1,82,68,150
https://kawalpemilu.org#83975,"PEMATANG TIGA LAMA, PEMATANG TIGA, BENGKULU TENGAH, BENGKULU",2,82,68,150
https://kawalpemilu.org#20883,"TEMIANG, PAGAR JATI, BENGKULU TENGAH, BENGKULU",1,68,116,184
https://kawalpemilu.org#20883,"TEMIANG, PAGAR JATI, BENGKULU TENGAH, BENGKULU",2,75,111,186
https://kawalpemilu.org#20885,"TABA RENAH, PAGAR JATI, BENGKULU TENGAH, BENGKULU",1,72,145,217
https://kawalpemilu.org#20886,"KERTA PATI, PAGAR JATI, BENGKULU TENGAH, BENGKULU",1,28,159,187
https://kawalpemilu.org#20886,"KERTA PATI, PAGAR JATI, BENGKULU TENGAH, BENGKULU",2,30,161,191
https://kawalpemilu.org#20886,"KERTA PATI, PAGAR JATI, BENGKULU TENGAH, BENGKULU",3,28,99,127
https://kawalpemilu.org#20886,"KERTA PATI, PAGAR JATI, BENGKULU TENGAH, BENGKULU",4,11,73,84
https://kawalpemilu.org#20887,"PAGAR JATI, PAGAR JATI, BENGKULU TENGAH, BENGKULU",1,35,125,160
https://kawalpemilu.org#20887,"PAGAR JATI, PAGAR JATI, BENGKULU TENGAH, BENGKULU",2,56,99,155
https://kawalpemilu.org#20889,"KARANG ARE, PAGAR JATI, BENGKULU TENGAH, BENGKULU",1,82,135,217
https://kawalpemilu.org#20890,"DATAR PENOKOT, PAGAR JATI, BENGKULU TENGAH, BENGKULU",1,66,148,214
https://kawalpemilu.org#20891,"LAYANG LEKAT, PAGAR JATI, BENGKULU TENGAH, BENGKULU",1,37,94,131
https://kawalpemilu.org#20892,"TUMBUK, PAGAR JATI, BENGKULU TENGAH, BENGKULU",1,34,103,137
https://kawalpemilu.org#20892,"TUMBUK, PAGAR JATI, BENGKULU TENGAH, BENGKULU",2,46,89,135
https://kawalpemilu.org#20893,"TALANG CURUP, PAGAR JATI, BENGKULU TENGAH, BENGKULU",1,53,125,178
https://kawalpemilu.org#20894,"RENA KANDIS, PAGAR JATI, BENGKULU TENGAH, BENGKULU",1,43,108,151
https://kawalpemilu.org#20894,"RENA KANDIS, PAGAR JATI, BENGKULU TENGAH, BENGKULU",2,49,97,146
https://kawalpemilu.org#20895,"ARGA INDAH I, PAGAR JATI, BENGKULU TENGAH, BENGKULU",1,107,48,155
https://kawalpemilu.org#20895,"ARGA INDAH I, PAGAR JATI, BENGKULU TENGAH, BENGKULU",2,119,47,166
https://kawalpemilu.org#83970,"KEROYA, PAGAR JATI, BENGKULU TENGAH, BENGKULU",1,130,129,259
https://kawalpemilu.org#83970,"KEROYA, PAGAR JATI, BENGKULU TENGAH, BENGKULU",2,89,147,236
https://kawalpemilu.org#83971,"KERTAPATI MUDIK, PAGAR JATI, BENGKULU TENGAH, BENGKULU",1,48,118,166
https://kawalpemilu.org#83971,"KERTAPATI MUDIK, PAGAR JATI, BENGKULU TENGAH, BENGKULU",2,35,153,188
https://kawalpemilu.org#83971,"KERTAPATI MUDIK, PAGAR JATI, BENGKULU TENGAH, BENGKULU",3,37,122,159
https://kawalpemilu.org#83972,"RENA JAYA, PAGAR JATI, BENGKULU TENGAH, BENGKULU",1,46,123,169
https://kawalpemilu.org#20900,"TABA PENANJUNG, TABA PENANJUNG, BENGKULU TENGAH, BENGKULU",1,48,125,173
https://kawalpemilu.org#20900,"TABA PENANJUNG, TABA PENANJUNG, BENGKULU TENGAH, BENGKULU",2,56,141,197
https://kawalpemilu.org#20900,"TABA PENANJUNG, TABA PENANJUNG, BENGKULU TENGAH, BENGKULU",3,45,146,191
https://kawalpemilu.org#20900,"TABA PENANJUNG, TABA PENANJUNG, BENGKULU TENGAH, BENGKULU",4,28,154,182
https://kawalpemilu.org#20901,"KOTA NIUR, TABA PENANJUNG, BENGKULU TENGAH, BENGKULU",1,104,98,202
https://kawalpemilu.org#20901,"KOTA NIUR, TABA PENANJUNG, BENGKULU TENGAH, BENGKULU",2,96,57,153
https://kawalpemilu.org#20902,"TANJUNG RAMAN, TABA PENANJUNG, BENGKULU TENGAH, BENGKULU",1,36,134,170
https://kawalpemilu.org#20902,"TANJUNG RAMAN, TABA PENANJUNG, BENGKULU TENGAH, BENGKULU",2,50,123,173
https://kawalpemilu.org#20903,"SUKARAMI, TABA PENANJUNG, BENGKULU TENGAH, BENGKULU",1,115,126,241
https://kawalpemilu.org#20903,"SUKARAMI, TABA PENANJUNG, BENGKULU TENGAH, BENGKULU",2,92,148,240
https://kawalpemilu.org#20903,"SUKARAMI, TABA PENANJUNG, BENGKULU TENGAH, BENGKULU",3,74,178,252
https://kawalpemilu.org#20903,"SUKARAMI, TABA PENANJUNG, BENGKULU TENGAH, BENGKULU",4,77,129,206
https://kawalpemilu.org#20903,"SUKARAMI, TABA PENANJUNG, BENGKULU TENGAH, BENGKULU",5,78,140,218
https://kawalpemilu.org#20904,"KARANG TENGAH, TABA PENANJUNG, BENGKULU TENGAH, BENGKULU",1,79,141,220
https://kawalpemilu.org#20905,"LUBUK SINI, TABA PENANJUNG, BENGKULU TENGAH, BENGKULU",1,66,99,165
https://kawalpemilu.org#20905,"LUBUK SINI, TABA PENANJUNG, BENGKULU TENGAH, BENGKULU",2,83,123,206
https://kawalpemilu.org#20905,"LUBUK SINI, TABA PENANJUNG, BENGKULU TENGAH, BENGKULU",3,81,154,235
https://kawalpemilu.org#20905,"LUBUK SINI, TABA PENANJUNG, BENGKULU TENGAH, BENGKULU",4,77,96,173
https://kawalpemilu.org#20907,"TABA TERET, TABA PENANJUNG, BENGKULU TENGAH, BENGKULU",1,85,104,189
https://kawalpemilu.org#20907,"TABA TERET, TABA PENANJUNG, BENGKULU TENGAH, BENGKULU",2,64,107,171
https://kawalpemilu.org#20907,"TABA TERET, TABA PENANJUNG, BENGKULU TENGAH, BENGKULU",3,54,109,163
https://kawalpemilu.org#20908,"SURAU, TABA PENANJUNG, BENGKULU TENGAH, BENGKULU",1,49,136,185
https://kawalpemilu.org#20908,"SURAU, TABA PENANJUNG, BENGKULU TENGAH, BENGKULU",2,71,94,165
https://kawalpemilu.org#20909,"RINDU HATI, TABA PENANJUNG, BENGKULU TENGAH, BENGKULU",1,87,101,188
https://kawalpemilu.org#20909,"RINDU HATI, TABA PENANJUNG, BENGKULU TENGAH, BENGKULU",2,74,103,177
https://kawalpemilu.org#20909,"RINDU HATI, TABA PENANJUNG, BENGKULU TENGAH, BENGKULU",3,116,78,194
https://kawalpemilu.org#20909,"RINDU HATI, TABA PENANJUNG, BENGKULU TENGAH, BENGKULU",4,118,56,174
https://kawalpemilu.org#20910,"TANJUNG HERAN, TABA PENANJUNG, BENGKULU TENGAH, BENGKULU",1,58,119,177
https://kawalpemilu.org#20910,"TANJUNG HERAN, TABA PENANJUNG, BENGKULU TENGAH, BENGKULU",2,92,112,204
https://kawalpemilu.org#20911,"DATAR LEBAR, TABA PENANJUNG, BENGKULU TENGAH, BENGKULU",1,75,105,180
https://kawalpemilu.org#20911,"DATAR LEBAR, TABA PENANJUNG, BENGKULU TENGAH, BENGKULU",2,27,94,121
https://kawalpemilu.org#20912,"PENUM, TABA PENANJUNG, BENGKULU TENGAH, BENGKULU",1,71,106,177
https://kawalpemilu.org#20912,"PENUM, TABA PENANJUNG, BENGKULU TENGAH, BENGKULU",2,49,83,132
https://kawalpemilu.org#20920,"BAJAK I, TABA PENANJUNG, BENGKULU TENGAH, BENGKULU",1,110,159,269
https://kawalpemilu.org#20920,"BAJAK I, TABA PENANJUNG, BENGKULU TENGAH, BENGKULU",2,108,111,219
https://kawalpemilu.org#20920,"BAJAK I, TABA PENANJUNG, BENGKULU TENGAH, BENGKULU",3,108,125,233
https://kawalpemilu.org#20920,"BAJAK I, TABA PENANJUNG, BENGKULU TENGAH, BENGKULU",4,43,98,141
https://kawalpemilu.org#20920,"BAJAK I, TABA PENANJUNG, BENGKULU TENGAH, BENGKULU",5,63,87,150
https://kawalpemilu.org#83978,"TABA BARU, TABA PENANJUNG, BENGKULU TENGAH, BENGKULU",1,77,108,185
https://kawalpemilu.org#83978,"TABA BARU, TABA PENANJUNG, BENGKULU TENGAH, BENGKULU",2,56,102,158
https://kawalpemilu.org#20906,"PUNGGUK KETUPAK, MERIGI KELINDANG, BENGKULU TENGAH, BENGKULU",1,116,117,233
https://kawalpemilu.org#20913,"JAMBU, MERIGI KELINDANG, BENGKULU TENGAH, BENGKULU",1,78,108,186
https://kawalpemilu.org#20913,"JAMBU, MERIGI KELINDANG, BENGKULU TENGAH, BENGKULU",2,72,114,186
https://kawalpemilu.org#20913,"JAMBU, MERIGI KELINDANG, BENGKULU TENGAH, BENGKULU",3,86,104,190
https://kawalpemilu.org#20913,"JAMBU, MERIGI KELINDANG, BENGKULU TENGAH, BENGKULU",4,87,117,204
https://kawalpemilu.org#20914,"KELINDANG, MERIGI KELINDANG, BENGKULU TENGAH, BENGKULU",1,72,71,143
https://kawalpemilu.org#20914,"KELINDANG, MERIGI KELINDANG, BENGKULU TENGAH, BENGKULU",2,78,61,139
https://kawalpemilu.org#20915,"ULAK LEBAR, MERIGI KELINDANG, BENGKULU TENGAH, BENGKULU",1,135,88,223
https://kawalpemilu.org#20916,"PENEMBANG, MERIGI KELINDANG, BENGKULU TENGAH, BENGKULU",1,82,155,237
https://kawalpemilu.org#20916,"PENEMBANG, MERIGI KELINDANG, BENGKULU TENGAH, BENGKULU",2,79,147,226
https://kawalpemilu.org#20917,"PUNGGUK BERINGIN, MERIGI KELINDANG, BENGKULU TENGAH, BENGKULU",1,84,156,240
https://kawalpemilu.org#20918,"LUBUK UNEN, MERIGI KELINDANG, BENGKULU TENGAH, BENGKULU",1,77,125,202
https://kawalpemilu.org#20918,"LUBUK UNEN, MERIGI KELINDANG, BENGKULU TENGAH, BENGKULU",2,79,122,201
https://kawalpemilu.org#20918,"LUBUK UNEN, MERIGI KELINDANG, BENGKULU TENGAH, BENGKULU",3,68,98,166
https://kawalpemilu.org#20919,"TABA DURIAN SEBAKUL, MERIGI KELINDANG, BENGKULU TENGAH, BENGKULU",1,50,107,157
https://kawalpemilu.org#20919,"TABA DURIAN SEBAKUL, MERIGI KELINDANG, BENGKULU TENGAH, BENGKULU",2,86,71,157
https://kawalpemilu.org#20922,"BAJAK II, MERIGI KELINDANG, BENGKULU TENGAH, BENGKULU",1,80,102,182
https://kawalpemilu.org#20922,"BAJAK II, MERIGI KELINDANG, BENGKULU TENGAH, BENGKULU",2,92,98,190
https://kawalpemilu.org#83920,"LUBUK UNEN BARU, MERIGI KELINDANG, BENGKULU TENGAH, BENGKULU",1,82,139,221
https://kawalpemilu.org#83920,"LUBUK UNEN BARU, MERIGI KELINDANG, BENGKULU TENGAH, BENGKULU",2,92,148,240
https://kawalpemilu.org#84777,"TALANG AMBUNG, MERIGI KELINDANG, BENGKULU TENGAH, BENGKULU",1,34,67,101
https://kawalpemilu.org#84779,"PADANG KEDEPER, MERIGI KELINDANG, BENGKULU TENGAH, BENGKULU",1,101,62,163
https://kawalpemilu.org#84780,"KELINDANG ATAS, MERIGI KELINDANG, BENGKULU TENGAH, BENGKULU",1,96,62,158
https://kawalpemilu.org#84780,"KELINDANG ATAS, MERIGI KELINDANG, BENGKULU TENGAH, BENGKULU",2,91,54,145
https://kawalpemilu.org#20878,"PUNJUNG, MERIGI SAKTI, BENGKULU TENGAH, BENGKULU",1,53,119,172
https://kawalpemilu.org#20878,"PUNJUNG, MERIGI SAKTI, BENGKULU TENGAH, BENGKULU",2,75,93,11
https://kawalpemilu.org#20879,"KOMERING, MERIGI SAKTI, BENGKULU TENGAH, BENGKULU",1,101,108,209
https://kawalpemilu.org#20879,"KOMERING, MERIGI SAKTI, BENGKULU TENGAH, BENGKULU",2,119,101,220
https://kawalpemilu.org#20880,"LUBUK PUAR, MERIGI SAKTI, BENGKULU TENGAH, BENGKULU",1,84,32,116
https://kawalpemilu.org#20881,"KARANG PANGGUNG, MERIGI SAKTI, BENGKULU TENGAH, BENGKULU",1,42,76,118
https://kawalpemilu.org#20882,"LUBUK PENDAM, MERIGI SAKTI, BENGKULU TENGAH, BENGKULU",1,64,165,229
https://kawalpemilu.org#20884,"CURUP, MERIGI SAKTI, BENGKULU TENGAH, BENGKULU",1,93,96,189
https://kawalpemilu.org#20888,"RAJAK BESI, MERIGI SAKTI, BENGKULU TENGAH, BENGKULU",1,33,159,192
https://kawalpemilu.org#20888,"RAJAK BESI, MERIGI SAKTI, BENGKULU TENGAH, BENGKULU",2,44,103,147
https://kawalpemilu.org#20897,"ARGA INDAH II, MERIGI SAKTI, BENGKULU TENGAH, BENGKULU",1,106,52,158
https://kawalpemilu.org#20897,"ARGA INDAH II, MERIGI SAKTI, BENGKULU TENGAH, BENGKULU",2,100,90,190
https://kawalpemilu.org#20897,"ARGA INDAH II, MERIGI SAKTI, BENGKULU TENGAH, BENGKULU",3,112,67,179
https://kawalpemilu.org#20898,"SUSUP, MERIGI SAKTI, BENGKULU TENGAH, BENGKULU",1,47,122,169
https://kawalpemilu.org#83929,"PUNGGUK JAYA, MERIGI SAKTI, BENGKULU TENGAH, BENGKULU",1,76,65,141
https://kawalpemilu.org#83931,"BAJAK TIGA, MERIGI SAKTI, BENGKULU TENGAH, BENGKULU",1,95,133,228
https://kawalpemilu.org#83934,"DURIAN LEBAR, MERIGI SAKTI, BENGKULU TENGAH, BENGKULU",1,63,64,127
https://kawalpemilu.org#83934,"DURIAN LEBAR, MERIGI SAKTI, BENGKULU TENGAH, BENGKULU",2,83,105,188
https://kawalpemilu.org#83938,"PAGAR AGUNG, MERIGI SAKTI, BENGKULU TENGAH, BENGKULU",1,108,79,187
https://kawalpemilu.org#83942,"TABA GEMANTUNG, MERIGI SAKTI, BENGKULU TENGAH, BENGKULU",1,87,101,188
https://kawalpemilu.org#84782,"PAGAR BESI, MERIGI SAKTI, BENGKULU TENGAH, BENGKULU",1,76,75,151
https://kawalpemilu.org#84782,"PAGAR BESI, MERIGI SAKTI, BENGKULU TENGAH, BENGKULU",2,30,63,93
https://kawalpemilu.org#20821,"DUSUN BARU I, PONDOK KUBANG, BENGKULU TENGAH, BENGKULU",1,137,108,245
https://kawalpemilu.org#20821,"DUSUN BARU I, PONDOK KUBANG, BENGKULU TENGAH, BENGKULU",2,136,59,195
https://kawalpemilu.org#20830,"HARAPAN MAKMUR, PONDOK KUBANG, BENGKULU TENGAH, BENGKULU",1,183,61,244
https://kawalpemilu.org#20830,"HARAPAN MAKMUR, PONDOK KUBANG, BENGKULU TENGAH, BENGKULU",2,185,73,258
https://kawalpemilu.org#20830,"HARAPAN MAKMUR, PONDOK KUBANG, BENGKULU TENGAH, BENGKULU",3,177,39,216
https://kawalpemilu.org#20833,"TANJUNG TERDANA, PONDOK KUBANG, BENGKULU TENGAH, BENGKULU",1,86,108,194
https://kawalpemilu.org#20833,"TANJUNG TERDANA, PONDOK KUBANG, BENGKULU TENGAH, BENGKULU",2,75,102,177
https://kawalpemilu.org#20833,"TANJUNG TERDANA, PONDOK KUBANG, BENGKULU TENGAH, BENGKULU",3,132,106,238
https://kawalpemilu.org#20834,"DUSUN ANYAR, PONDOK KUBANG, BENGKULU TENGAH, BENGKULU",1,31,92,123
https://kawalpemilu.org#20835,"PONDOK KUBANG, PONDOK KUBANG, BENGKULU TENGAH, BENGKULU",1,86,107,193
https://kawalpemilu.org#20835,"PONDOK KUBANG, PONDOK KUBANG, BENGKULU TENGAH, BENGKULU",2,70,137,207
https://kawalpemilu.org#20835,"PONDOK KUBANG, PONDOK KUBANG, BENGKULU TENGAH, BENGKULU",3,45,172,217
https://kawalpemilu.org#20836,"TANJUNG DALAM, PONDOK KUBANG, BENGKULU TENGAH, BENGKULU",1,27,134,161
https://kawalpemilu.org#20837,"PAKU HAJI, PONDOK KUBANG, BENGKULU TENGAH, BENGKULU",1,86,94,180
https://kawalpemilu.org#20837,"PAKU HAJI, PONDOK KUBANG, BENGKULU TENGAH, BENGKULU",2,64,88,152
https://kawalpemilu.org#20838,"BATU RAJA, PONDOK KUBANG, BENGKULU TENGAH, BENGKULU",1,46,208,254
https://kawalpemilu.org#20838,"BATU RAJA, PONDOK KUBANG, BENGKULU TENGAH, BENGKULU",2,83,161,244
https://kawalpemilu.org#20839,"TALANG TENGAH I, PONDOK KUBANG, BENGKULU TENGAH, BENGKULU",1,52,91,143
https://kawalpemilu.org#20839,"TALANG TENGAH I, PONDOK KUBANG, BENGKULU TENGAH, BENGKULU",2,74,77,151
https://kawalpemilu.org#20840,"LINGGAR GALING, PONDOK KUBANG, BENGKULU TENGAH, BENGKULU",1,158,84,242
https://kawalpemilu.org#20840,"LINGGAR GALING, PONDOK KUBANG, BENGKULU TENGAH, BENGKULU",2,141,101,242
https://kawalpemilu.org#20840,"LINGGAR GALING, PONDOK KUBANG, BENGKULU TENGAH, BENGKULU",3,150,27,177
https://kawalpemilu.org#84783,"TABA JAMBU, PONDOK KUBANG, BENGKULU TENGAH, BENGKULU",1,97,131,228
https://kawalpemilu.org#84783,"TABA JAMBU, PONDOK KUBANG, BENGKULU TENGAH, BENGKULU",2,90,116,206
https://kawalpemilu.org#84783,"TABA JAMBU, PONDOK KUBANG, BENGKULU TENGAH, BENGKULU",3,73,92,165
https://kawalpemilu.org#84783,"TABA JAMBU, PONDOK KUBANG, BENGKULU TENGAH, BENGKULU",4,61,42,103
https://kawalpemilu.org#89284,"MARGO MULYO, PONDOK KUBANG, BENGKULU TENGAH, BENGKULU",1,145,56,201
https://kawalpemilu.org#89284,"MARGO MULYO, PONDOK KUBANG, BENGKULU TENGAH, BENGKULU",2,166,68,234
https://kawalpemilu.org#89284,"MARGO MULYO, PONDOK KUBANG, BENGKULU TENGAH, BENGKULU",3,155,33,188
https://kawalpemilu.org#89284,"MARGO MULYO, PONDOK KUBANG, BENGKULU TENGAH, BENGKULU",4,176,41,217
https://kawalpemilu.org#83907,"AIR NAPAL, BANG HAJI, BENGKULU TENGAH, BENGKULU",1,147,62,209
https://kawalpemilu.org#83907,"AIR NAPAL, BANG HAJI, BENGKULU TENGAH, BENGKULU",2,136,120,256
https://kawalpemilu.org#83908,"GENTING, BANG HAJI, BENGKULU TENGAH, BENGKULU",1,173,39,212
https://kawalpemilu.org#83909,"LUBUK LANGKAP, BANG HAJI, BENGKULU TENGAH, BENGKULU",1,79,81,160
https://kawalpemilu.org#83909,"LUBUK LANGKAP, BANG HAJI, BENGKULU TENGAH, BENGKULU",2,124,65,189
https://kawalpemilu.org#83910,"PADANG BERUNAI, BANG HAJI, BENGKULU TENGAH, BENGKULU",1,121,92,213
https://kawalpemilu.org#83910,"PADANG BERUNAI, BANG HAJI, BENGKULU TENGAH, BENGKULU",2,96,79,175
https://kawalpemilu.org#83912,"SEKAYUN, BANG HAJI, BENGKULU TENGAH, BENGKULU",1,99,114,213
https://kawalpemilu.org#83912,"SEKAYUN, BANG HAJI, BENGKULU TENGAH, BENGKULU",2,127,99,226
https://kawalpemilu.org#83913,"SEKAYUN MUDIK, BANG HAJI, BENGKULU TENGAH, BENGKULU",1,89,112,201
https://kawalpemilu.org#83913,"SEKAYUN MUDIK, BANG HAJI, BENGKULU TENGAH, BENGKULU",2,94,105,199
https://kawalpemilu.org#83913,"SEKAYUN MUDIK, BANG HAJI, BENGKULU TENGAH, BENGKULU",3,61,80,141
https://kawalpemilu.org#83914,"TABA TENGAH, BANG HAJI, BENGKULU TENGAH, BENGKULU",1,85,152,237
https://kawalpemilu.org#83915,"TALANG DONOK, BANG HAJI, BENGKULU TENGAH, BENGKULU",1,94,67,161
https://kawalpemilu.org#83915,"TALANG DONOK, BANG HAJI, BENGKULU TENGAH, BENGKULU",2,117,75,192
https://kawalpemilu.org#83915,"TALANG DONOK, BANG HAJI, BENGKULU TENGAH, BENGKULU",3,99,43,142
https://kawalpemilu.org#83916,"TALANG PANJANG, BANG HAJI, BENGKULU TENGAH, BENGKULU",1,147,70,217
https://kawalpemilu.org#84784,"SEKAYUN HILIR, BANG HAJI, BENGKULU TENGAH, BENGKULU",1,103,146,249
https://kawalpemilu.org#84786,"SUNGKAI BERAYUN, BANG HAJI, BENGKULU TENGAH, BENGKULU",1,62,153,215
https://kawalpemilu.org#89238,"BANG HAJI, BANG HAJI, BENGKULU TENGAH, BENGKULU",1,98,143,241
https://kawalpemilu.org#89238,"BANG HAJI, BANG HAJI, BENGKULU TENGAH, BENGKULU",2,103,100,203
https://kawalpemilu.org#20925,"BATU AMPAR, KEDURANG, BENGKULU SELATAN, BENGKULU",1,84,70,154
https://kawalpemilu.org#20925,"BATU AMPAR, KEDURANG, BENGKULU SELATAN, BENGKULU",2,114,53,167
https://kawalpemilu.org#20925,"BATU AMPAR, KEDURANG, BENGKULU SELATAN, BENGKULU",3,78,57,135
https://kawalpemilu.org#20926,"RANTAU SIALANG, KEDURANG, BENGKULU SELATAN, BENGKULU",1,123,85,208
https://kawalpemilu.org#20926,"RANTAU SIALANG, KEDURANG, BENGKULU SELATAN, BENGKULU",2,106,37,143
https://kawalpemilu.org#20927,"BUMI AGUNG, KEDURANG, BENGKULU SELATAN, BENGKULU",1,103,46,149
https://kawalpemilu.org#20927,"BUMI AGUNG, KEDURANG, BENGKULU SELATAN, BENGKULU",2,37,90,127
https://kawalpemilu.org#20928,"PALAK SIRING, KEDURANG, BENGKULU SELATAN, BENGKULU",1,24,146,170
https://kawalpemilu.org#20928,"PALAK SIRING, KEDURANG, BENGKULU SELATAN, BENGKULU",2,37,108,145
https://kawalpemilu.org#20928,"PALAK SIRING, KEDURANG, BENGKULU SELATAN, BENGKULU",3,48,121,169
https://kawalpemilu.org#20928,"PALAK SIRING, KEDURANG, BENGKULU SELATAN, BENGKULU",4,43,101,144
https://kawalpemilu.org#20929,"KEBAN AGUNG I, KEDURANG, BENGKULU SELATAN, BENGKULU",1,46,118,164
https://kawalpemilu.org#20929,"KEBAN AGUNG I, KEDURANG, BENGKULU SELATAN, BENGKULU",2,23,62,85
https://kawalpemilu.org#20929,"KEBAN AGUNG I, KEDURANG, BENGKULU SELATAN, BENGKULU",3,76,46,122
https://kawalpemilu.org#20930,"KEBAN AGUNG II, KEDURANG, BENGKULU SELATAN, BENGKULU",1,59,69,128
https://kawalpemilu.org#20930,"KEBAN AGUNG II, KEDURANG, BENGKULU SELATAN, BENGKULU",2,60,81,141
https://kawalpemilu.org#20930,"KEBAN AGUNG II, KEDURANG, BENGKULU SELATAN, BENGKULU",3,60,78,138
https://kawalpemilu.org#20931,"TANJUNG ALAM, KEDURANG, BENGKULU SELATAN, BENGKULU",1,96,70,166
https://kawalpemilu.org#20931,"TANJUNG ALAM, KEDURANG, BENGKULU SELATAN, BENGKULU",2,67,60,127
https://kawalpemilu.org#20931,"TANJUNG ALAM, KEDURANG, BENGKULU SELATAN, BENGKULU",3,48,72,120
https://kawalpemilu.org#20931,"TANJUNG ALAM, KEDURANG, BENGKULU SELATAN, BENGKULU",4,73,56,129
https://kawalpemilu.org#20932,"TANJUNG NEGARA, KEDURANG, BENGKULU SELATAN, BENGKULU",1,66,68,134
https://kawalpemilu.org#20932,"TANJUNG NEGARA, KEDURANG, BENGKULU SELATAN, BENGKULU",2,68,83,151
https://kawalpemilu.org#20933,"KEBAN AGUNG III, KEDURANG, BENGKULU SELATAN, BENGKULU",1,57,77,134
https://kawalpemilu.org#20933,"KEBAN AGUNG III, KEDURANG, BENGKULU SELATAN, BENGKULU",2,75,55,130
https://kawalpemilu.org#20934,"SUKA NANTI, KEDURANG, BENGKULU SELATAN, BENGKULU",1,55,66,117
https://kawalpemilu.org#20934,"SUKA NANTI, KEDURANG, BENGKULU SELATAN, BENGKULU",2,69,74,143
https://kawalpemilu.org#20935,"MUARA TIGA, KEDURANG, BENGKULU SELATAN, BENGKULU",1,131,71,202
https://kawalpemilu.org#20935,"MUARA TIGA, KEDURANG, BENGKULU SELATAN, BENGKULU",2,64,34,98
https://kawalpemilu.org#20936,"TANJUNG BESAR, KEDURANG, BENGKULU SELATAN, BENGKULU",1,65,37,102
https://kawalpemilu.org#20936,"TANJUNG BESAR, KEDURANG, BENGKULU SELATAN, BENGKULU",2,41,63,104
https://kawalpemilu.org#20937,"PAJAR BULAN, KEDURANG, BENGKULU SELATAN, BENGKULU",1,34,80,114
https://kawalpemilu.org#20937,"PAJAR BULAN, KEDURANG, BENGKULU SELATAN, BENGKULU",2,85,69,154
https://kawalpemilu.org#20937,"PAJAR BULAN, KEDURANG, BENGKULU SELATAN, BENGKULU",3,56,61,117
https://kawalpemilu.org#20938,"DURIAN SEBATANG, KEDURANG, BENGKULU SELATAN, BENGKULU",1,107,41,148
https://kawalpemilu.org#20938,"DURIAN SEBATANG, KEDURANG, BENGKULU SELATAN, BENGKULU",2,104,53,157
https://kawalpemilu.org#20938,"DURIAN SEBATANG, KEDURANG, BENGKULU SELATAN, BENGKULU",3,30,89,119
https://kawalpemilu.org#20938,"DURIAN SEBATANG, KEDURANG, BENGKULU SELATAN, BENGKULU",4,42,79,121
https://kawalpemilu.org#20938,"DURIAN SEBATANG, KEDURANG, BENGKULU SELATAN, BENGKULU",5,58,115,173
https://kawalpemilu.org#20939,"LAWANG AGUNG, KEDURANG, BENGKULU SELATAN, BENGKULU",1,127,28,155
https://kawalpemilu.org#20939,"LAWANG AGUNG, KEDURANG, BENGKULU SELATAN, BENGKULU",2,110,41,151
https://kawalpemilu.org#20939,"LAWANG AGUNG, KEDURANG, BENGKULU SELATAN, BENGKULU",3,95,25,120
https://kawalpemilu.org#20939,"LAWANG AGUNG, KEDURANG, BENGKULU SELATAN, BENGKULU",4,91,35,126
https://kawalpemilu.org#20939,"LAWANG AGUNG, KEDURANG, BENGKULU SELATAN, BENGKULU",5,106,26,132
https://kawalpemilu.org#20940,"NANTI AGUNG, KEDURANG, BENGKULU SELATAN, BENGKULU",1,67,66,133
https://kawalpemilu.org#20940,"NANTI AGUNG, KEDURANG, BENGKULU SELATAN, BENGKULU",2,68,76,144
https://kawalpemilu.org#20941,"KARANG AGUNG, KEDURANG, BENGKULU SELATAN, BENGKULU",1,74,90,164
https://kawalpemilu.org#20941,"KARANG AGUNG, KEDURANG, BENGKULU SELATAN, BENGKULU",2,47,70,117
https://kawalpemilu.org#20941,"KARANG AGUNG, KEDURANG, BENGKULU SELATAN, BENGKULU",3,61,99,160
https://kawalpemilu.org#20942,"LUBUK RESAM, KEDURANG, BENGKULU SELATAN, BENGKULU",1,131,69,200
https://kawalpemilu.org#20942,"LUBUK RESAM, KEDURANG, BENGKULU SELATAN, BENGKULU",2,99,41,140
https://kawalpemilu.org#20943,"MUARA TIGA ILIR, KEDURANG, BENGKULU SELATAN, BENGKULU",1,74,31,105
https://kawalpemilu.org#20943,"MUARA TIGA ILIR, KEDURANG, BENGKULU SELATAN, BENGKULU",2,55,50,105
https://kawalpemilu.org#20945,"PASAR BARU, SEGINIM, BENGKULU SELATAN, BENGKULU",1,75,72,147
https://kawalpemilu.org#20945,"PASAR BARU, SEGINIM, BENGKULU SELATAN, BENGKULU",2,88,47,135
https://kawalpemilu.org#20945,"PASAR BARU, SEGINIM, BENGKULU SELATAN, BENGKULU",3,86,45,131
https://kawalpemilu.org#20945,"PASAR BARU, SEGINIM, BENGKULU SELATAN, BENGKULU",4,59,44,103
https://kawalpemilu.org#20946,"PADANG LEBAR, SEGINIM, BENGKULU SELATAN, BENGKULU",1,91,10,101
https://kawalpemilu.org#20947,"SUKARAJA, SEGINIM, BENGKULU SELATAN, BENGKULU",1,111,82,193
https://kawalpemilu.org#20947,"SUKARAJA, SEGINIM, BENGKULU SELATAN, BENGKULU",2,102,81,183
https://kawalpemilu.org#20947,"SUKARAJA, SEGINIM, BENGKULU SELATAN, BENGKULU",3,131,50,181
https://kawalpemilu.org#20948,"TANJUNG MENANG, SEGINIM, BENGKULU SELATAN, BENGKULU",1,110,21,131
https://kawalpemilu.org#20948,"TANJUNG MENANG, SEGINIM, BENGKULU SELATAN, BENGKULU",2,97,22,119
https://kawalpemilu.org#20948,"TANJUNG MENANG, SEGINIM, BENGKULU SELATAN, BENGKULU",3,110,19,129
https://kawalpemilu.org#20949,"DARAT SAWAH ILIR, SEGINIM, BENGKULU SELATAN, BENGKULU",1,115,52,167
https://kawalpemilu.org#20949,"DARAT SAWAH ILIR, SEGINIM, BENGKULU SELATAN, BENGKULU",2,115,34,149
https://kawalpemilu.org#20949,"DARAT SAWAH ILIR, SEGINIM, BENGKULU SELATAN, BENGKULU",3,104,49,153
https://kawalpemilu.org#20949,"DARAT SAWAH ILIR, SEGINIM, BENGKULU SELATAN, BENGKULU",4,106,12,118
https://kawalpemilu.org#20949,"DARAT SAWAH ILIR, SEGINIM, BENGKULU SELATAN, BENGKULU",5,72,30,102
https://kawalpemilu.org#20949,"DARAT SAWAH ILIR, SEGINIM, BENGKULU SELATAN, BENGKULU",6,147,32,179
https://kawalpemilu.org#20949,"DARAT SAWAH ILIR, SEGINIM, BENGKULU SELATAN, BENGKULU",7,100,40,140
https://kawalpemilu.org#20949,"DARAT SAWAH ILIR, SEGINIM, BENGKULU SELATAN, BENGKULU",8,99,33,132
https://kawalpemilu.org#20950,"KOTA AGUNG, SEGINIM, BENGKULU SELATAN, BENGKULU",1,69,44,113
https://kawalpemilu.org#20950,"KOTA AGUNG, SEGINIM, BENGKULU SELATAN, BENGKULU",2,86,22,108
https://kawalpemilu.org#20950,"KOTA AGUNG, SEGINIM, BENGKULU SELATAN, BENGKULU",3,106,10,116
https://kawalpemilu.org#20951,"BABATAN ILIR, SEGINIM, BENGKULU SELATAN, BENGKULU",1,105,67,172
https://kawalpemilu.org#20951,"BABATAN ILIR, SEGINIM, BENGKULU SELATAN, BENGKULU",2,125,76,201
https://kawalpemilu.org#20952,"BABATAN ULU, SEGINIM, BENGKULU SELATAN, BENGKULU",1,57,35,92
https://kawalpemilu.org#20952,"BABATAN ULU, SEGINIM, BENGKULU SELATAN, BENGKULU",2,66,23,89
https://kawalpemilu.org#20952,"BABATAN ULU, SEGINIM, BENGKULU SELATAN, BENGKULU",3,116,41,157
https://kawalpemilu.org#20952,"BABATAN ULU, SEGINIM, BENGKULU SELATAN, BENGKULU",4,73,56,129
https://kawalpemilu.org#20953,"MUARA DANAU, SEGINIM, BENGKULU SELATAN, BENGKULU",1,78,38,116
https://kawalpemilu.org#20953,"MUARA DANAU, SEGINIM, BENGKULU SELATAN, BENGKULU",2,102,38,140
https://kawalpemilu.org#20954,"GUNUNG AYU II, SEGINIM, BENGKULU SELATAN, BENGKULU",1,128,35,163
https://kawalpemilu.org#20954,"GUNUNG AYU II, SEGINIM, BENGKULU SELATAN, BENGKULU",2,123,30,153
https://kawalpemilu.org#20954,"GUNUNG AYU II, SEGINIM, BENGKULU SELATAN, BENGKULU",3,134,27,161
https://kawalpemilu.org#20955,"MUARA PULUTAN, SEGINIM, BENGKULU SELATAN, BENGKULU",1,114,57,171
https://kawalpemilu.org#20955,"MUARA PULUTAN, SEGINIM, BENGKULU SELATAN, BENGKULU",2,90,43,133
https://kawalpemilu.org#20955,"MUARA PULUTAN, SEGINIM, BENGKULU SELATAN, BENGKULU",3,66,82,148
https://kawalpemilu.org#20955,"MUARA PULUTAN, SEGINIM, BENGKULU SELATAN, BENGKULU",4,109,46,155
https://kawalpemilu.org#20955,"MUARA PULUTAN, SEGINIM, BENGKULU SELATAN, BENGKULU",5,98,34,132
https://kawalpemilu.org#20956,"KOTA BUMI BARU, SEGINIM, BENGKULU SELATAN, BENGKULU",1,121,45,166
https://kawalpemilu.org#20956,"KOTA BUMI BARU, SEGINIM, BENGKULU SELATAN, BENGKULU",2,104,53,157
https://kawalpemilu.org#20956,"KOTA BUMI BARU, SEGINIM, BENGKULU SELATAN, BENGKULU",3,76,35,111
https://kawalpemilu.org#20957,"SINDANG BULAN, SEGINIM, BENGKULU SELATAN, BENGKULU",1,140,46,186
https://kawalpemilu.org#20957,"SINDANG BULAN, SEGINIM, BENGKULU SELATAN, BENGKULU",2,113,52,165
https://kawalpemilu.org#20958,"MUARA PAYANG, SEGINIM, BENGKULU SELATAN, BENGKULU",1,64,48,112
https://kawalpemilu.org#20958,"MUARA PAYANG, SEGINIM, BENGKULU SELATAN, BENGKULU",2,122,38,160
https://kawalpemilu.org#20958,"MUARA PAYANG, SEGINIM, BENGKULU SELATAN, BENGKULU",3,99,47,146
https://kawalpemilu.org#20958,"MUARA PAYANG, SEGINIM, BENGKULU SELATAN, BENGKULU",4,68,71,139
https://kawalpemilu.org#20959,"DURIAN SEGINIM, SEGINIM, BENGKULU SELATAN, BENGKULU",1,52,45,97
https://kawalpemilu.org#20959,"DURIAN SEGINIM, SEGINIM, BENGKULU SELATAN, BENGKULU",2,82,93,175
https://kawalpemilu.org#20959,"DURIAN SEGINIM, SEGINIM, BENGKULU SELATAN, BENGKULU",3,63,111,174
https://kawalpemilu.org#20959,"DURIAN SEGINIM, SEGINIM, BENGKULU SELATAN, BENGKULU",4,98,74,172
https://kawalpemilu.org#20959,"DURIAN SEGINIM, SEGINIM, BENGKULU SELATAN, BENGKULU",5,74,72,146
https://kawalpemilu.org#20960,"BANDING AGUNG, SEGINIM, BENGKULU SELATAN, BENGKULU",1,78,129,207
https://kawalpemilu.org#20960,"BANDING AGUNG, SEGINIM, BENGKULU SELATAN, BENGKULU",2,81,70,151
https://kawalpemilu.org#20960,"BANDING AGUNG, SEGINIM, BENGKULU SELATAN, BENGKULU",3,77,60,137
https://kawalpemilu.org#20961,"PAJAR BULAN, SEGINIM, BENGKULU SELATAN, BENGKULU",1,98,70,168
https://kawalpemilu.org#20961,"PAJAR BULAN, SEGINIM, BENGKULU SELATAN, BENGKULU",2,112,67,179
https://kawalpemilu.org#20962,"DUSUN TENGAH, SEGINIM, BENGKULU SELATAN, BENGKULU",1,74,79,153
https://kawalpemilu.org#20962,"DUSUN TENGAH, SEGINIM, BENGKULU SELATAN, BENGKULU",2,77,49,126
https://kawalpemilu.org#20962,"DUSUN TENGAH, SEGINIM, BENGKULU SELATAN, BENGKULU",3,73,47,120
https://kawalpemilu.org#20963,"PADANG SIRING, SEGINIM, BENGKULU SELATAN, BENGKULU",1,99,52,151
https://kawalpemilu.org#20963,"PADANG SIRING, SEGINIM, BENGKULU SELATAN, BENGKULU",2,69,77,146
https://kawalpemilu.org#20963,"PADANG SIRING, SEGINIM, BENGKULU SELATAN, BENGKULU",3,68,59,127
https://kawalpemilu.org#20964,"DARAT SAWAH ULU, SEGINIM, BENGKULU SELATAN, BENGKULU",1,154,46,200
https://kawalpemilu.org#20964,"DARAT SAWAH ULU, SEGINIM, BENGKULU SELATAN, BENGKULU",2,112,35,147
https://kawalpemilu.org#20964,"DARAT SAWAH ULU, SEGINIM, BENGKULU SELATAN, BENGKULU",3,82,30,112
https://kawalpemilu.org#20964,"DARAT SAWAH ULU, SEGINIM, BENGKULU SELATAN, BENGKULU",4,128,27,155
https://kawalpemilu.org#20965,"TANJUNG AGUNG, SEGINIM, BENGKULU SELATAN, BENGKULU",1,122,43,165
https://kawalpemilu.org#20965,"TANJUNG AGUNG, SEGINIM, BENGKULU SELATAN, BENGKULU",2,120,54,174
https://kawalpemilu.org#20966,"DUSUN BARU, SEGINIM, BENGKULU SELATAN, BENGKULU",1,98,55,153
https://kawalpemilu.org#20966,"DUSUN BARU, SEGINIM, BENGKULU SELATAN, BENGKULU",2,77,84,161
https://kawalpemilu.org#20968,"MASAT, PINO, BENGKULU SELATAN, BENGKULU",1,70,111,181
https://kawalpemilu.org#20968,"MASAT, PINO, BENGKULU SELATAN, BENGKULU",2,83,126,209
https://kawalpemilu.org#20968,"MASAT, PINO, BENGKULU SELATAN, BENGKULU",3,111,109,220
https://kawalpemilu.org#20968,"MASAT, PINO, BENGKULU SELATAN, BENGKULU",4,118,94,212
https://kawalpemilu.org#20968,"MASAT, PINO, BENGKULU SELATAN, BENGKULU",5,84,21,105
https://kawalpemilu.org#20969,"TANJUNG AUR I, PINO, BENGKULU SELATAN, BENGKULU",1,113,114,227
https://kawalpemilu.org#20969,"TANJUNG AUR I, PINO, BENGKULU SELATAN, BENGKULU",2,55,137,192
https://kawalpemilu.org#20970,"ANGGUT, PINO, BENGKULU SELATAN, BENGKULU",1,63,77,140
https://kawalpemilu.org#20970,"ANGGUT, PINO, BENGKULU SELATAN, BENGKULU",2,55,90,145
https://kawalpemilu.org#20971,"TANJUNG ERAN, PINO, BENGKULU SELATAN, BENGKULU",1,92,104,196
https://kawalpemilu.org#20971,"TANJUNG ERAN, PINO, BENGKULU SELATAN, BENGKULU",2,165,81,246
https://kawalpemilu.org#20972,"PADANG LEBAR, PINO, BENGKULU SELATAN, BENGKULU",1,94,146,240
https://kawalpemilu.org#20972,"PADANG LEBAR, PINO, BENGKULU SELATAN, BENGKULU",2,105,133,238
https://kawalpemilu.org#20972,"PADANG LEBAR, PINO, BENGKULU SELATAN, BENGKULU",3,78,136,214
https://kawalpemilu.org#20973,"GEDUNG AGUNG, PINO, BENGKULU SELATAN, BENGKULU",1,82,101,183
https://kawalpemilu.org#20973,"GEDUNG AGUNG, PINO, BENGKULU SELATAN, BENGKULU",2,96,120,216
https://kawalpemilu.org#20973,"GEDUNG AGUNG, PINO, BENGKULU SELATAN, BENGKULU",3,151,46,197
https://kawalpemilu.org#20974,"BATU BANDUNG, PINO, BENGKULU SELATAN, BENGKULU",1,58,94,152
https://kawalpemilu.org#20974,"BATU BANDUNG, PINO, BENGKULU SELATAN, BENGKULU",2,53,73,126
https://kawalpemilu.org#20975,"ULAK LEBAR, PINO, BENGKULU SELATAN, BENGKULU",1,99,110,209
https://kawalpemilu.org#20975,"ULAK LEBAR, PINO, BENGKULU SELATAN, BENGKULU",2,90,105,195
https://kawalpemilu.org#20975,"ULAK LEBAR, PINO, BENGKULU SELATAN, BENGKULU",3,95,92,187
https://kawalpemilu.org#20975,"ULAK LEBAR, PINO, BENGKULU SELATAN, BENGKULU",4,81,88,169
https://kawalpemilu.org#20975,"ULAK LEBAR, PINO, BENGKULU SELATAN, BENGKULU",5,98,111,209
https://kawalpemilu.org#20976,"KOTA BUMI, PINO, BENGKULU SELATAN, BENGKULU",1,123,42,165
https://kawalpemilu.org#20976,"KOTA BUMI, PINO, BENGKULU SELATAN, BENGKULU",2,59,28,87
https://kawalpemilu.org#20977,"AIR UMBAN, PINO, BENGKULU SELATAN, BENGKULU",1,96,117,213
https://kawalpemilu.org#20977,"AIR UMBAN, PINO, BENGKULU SELATAN, BENGKULU",2,109,104,213
https://kawalpemilu.org#20977,"AIR UMBAN, PINO, BENGKULU SELATAN, BENGKULU",3,102,113,215
https://kawalpemilu.org#20978,"SEBILO, PINO, BENGKULU SELATAN, BENGKULU",1,100,56,156
https://kawalpemilu.org#20978,"SEBILO, PINO, BENGKULU SELATAN, BENGKULU",2,127,37,164
https://kawalpemilu.org#20979,"GANJUH, PINO, BENGKULU SELATAN, BENGKULU",1,125,52,177
https://kawalpemilu.org#20979,"GANJUH, PINO, BENGKULU SELATAN, BENGKULU",2,75,20,95
https://kawalpemilu.org#20979,"GANJUH, PINO, BENGKULU SELATAN, BENGKULU",3,90,51,141
https://kawalpemilu.org#20980,"PUDING, PINO, BENGKULU SELATAN, BENGKULU",1,116,66,182
https://kawalpemilu.org#20980,"PUDING, PINO, BENGKULU SELATAN, BENGKULU",2,70,118,188
https://kawalpemilu.org#20980,"PUDING, PINO, BENGKULU SELATAN, BENGKULU",3,142,95,237
https://kawalpemilu.org#20981,"PADANG TAMBAK, PINO, BENGKULU SELATAN, BENGKULU",1,64,129,193
https://kawalpemilu.org#20981,"PADANG TAMBAK, PINO, BENGKULU SELATAN, BENGKULU",2,79,94,174
https://kawalpemilu.org#20982,"PADANG MUMPO, PINO, BENGKULU SELATAN, BENGKULU",1,127,94,221
https://kawalpemilu.org#20982,"PADANG MUMPO, PINO, BENGKULU SELATAN, BENGKULU",2,110,60,170
https://kawalpemilu.org#20983,"BERINGIN DATAR, PINO, BENGKULU SELATAN, BENGKULU",1,79,84,163
https://kawalpemilu.org#20983,"BERINGIN DATAR, PINO, BENGKULU SELATAN, BENGKULU",2,84,78,162
https://kawalpemilu.org#20985,"KAYU KUNYIT, MANNA, BENGKULU SELATAN, BENGKULU",1,73,195,268
https://kawalpemilu.org#20985,"KAYU KUNYIT, MANNA, BENGKULU SELATAN, BENGKULU",2,86,133,219
https://kawalpemilu.org#20985,"KAYU KUNYIT, MANNA, BENGKULU SELATAN, BENGKULU",3,90,139,229
https://kawalpemilu.org#20985,"KAYU KUNYIT, MANNA, BENGKULU SELATAN, BENGKULU",4,62,184,246
https://kawalpemilu.org#20985,"KAYU KUNYIT, MANNA, BENGKULU SELATAN, BENGKULU",5,60,183,243
https://kawalpemilu.org#20986,"TANJUNG RAMAN, MANNA, BENGKULU SELATAN, BENGKULU",1,90,118,208
https://kawalpemilu.org#20986,"TANJUNG RAMAN, MANNA, BENGKULU SELATAN, BENGKULU",2,85,109,194
https://kawalpemilu.org#20987,"TANJUNG BESAR, MANNA, BENGKULU SELATAN, BENGKULU",1,100,120,220
https://kawalpemilu.org#20987,"TANJUNG BESAR, MANNA, BENGKULU SELATAN, BENGKULU",2,86,127,213
https://kawalpemilu.org#20988,"MANGGUL, MANNA, BENGKULU SELATAN, BENGKULU",1,62,71,133
https://kawalpemilu.org#20988,"MANGGUL, MANNA, BENGKULU SELATAN, BENGKULU",2,61,71,132
https://kawalpemilu.org#20989,"TERULUNG, MANNA, BENGKULU SELATAN, BENGKULU",1,108,134,242
https://kawalpemilu.org#20989,"TERULUNG, MANNA, BENGKULU SELATAN, BENGKULU",2,109,104,213
https://kawalpemilu.org#20990,"KETAPING, MANNA, BENGKULU SELATAN, BENGKULU",1,125,127,252
https://kawalpemilu.org#20990,"KETAPING, MANNA, BENGKULU SELATAN, BENGKULU",2,89,125,214
https://kawalpemilu.org#20990,"KETAPING, MANNA, BENGKULU SELATAN, BENGKULU",3,66,143,209
https://kawalpemilu.org#20990,"KETAPING, MANNA, BENGKULU SELATAN, BENGKULU",4,104,127,231
https://kawalpemilu.org#20990,"KETAPING, MANNA, BENGKULU SELATAN, BENGKULU",5,129,111,240
https://kawalpemilu.org#20991,"LUBUK SIRIH ULU, MANNA, BENGKULU SELATAN, BENGKULU",1,167,94,261
https://kawalpemilu.org#20992,"LUBUK SIRIH ILIR, MANNA, BENGKULU SELATAN, BENGKULU",1,120,86,206
https://kawalpemilu.org#20992,"LUBUK SIRIH ILIR, MANNA, BENGKULU SELATAN, BENGKULU",2,127,86,213
https://kawalpemilu.org#20992,"LUBUK SIRIH ILIR, MANNA, BENGKULU SELATAN, BENGKULU",3,149,82,231
https://kawalpemilu.org#20993,"KOTA PADANG, MANNA, BENGKULU SELATAN, BENGKULU",1,116,87,203
https://kawalpemilu.org#20993,"KOTA PADANG, MANNA, BENGKULU SELATAN, BENGKULU",2,106,90,196
https://kawalpemilu.org#20994,"MELAO, MANNA, BENGKULU SELATAN, BENGKULU",1,84,55,139
https://kawalpemilu.org#20994,"MELAO, MANNA, BENGKULU SELATAN, BENGKULU",2,86,85,171
https://kawalpemilu.org#20995,"GUNUNG SAKTI, MANNA, BENGKULU SELATAN, BENGKULU",1,101,76,177
https://kawalpemilu.org#20995,"GUNUNG SAKTI, MANNA, BENGKULU SELATAN, BENGKULU",2,115,75,190
https://kawalpemilu.org#20996,"JERANGLAH RENDAH, MANNA, BENGKULU SELATAN, BENGKULU",1,123,91,214
https://kawalpemilu.org#20996,"JERANGLAH RENDAH, MANNA, BENGKULU SELATAN, BENGKULU",2,148,57,205
https://kawalpemilu.org#20997,"JERANGLAH TINGGI, MANNA, BENGKULU SELATAN, BENGKULU",1,109,101,210
https://kawalpemilu.org#20997,"JERANGLAH TINGGI, MANNA, BENGKULU SELATAN, BENGKULU",2,127,97,224
https://kawalpemilu.org#20997,"JERANGLAH TINGGI, MANNA, BENGKULU SELATAN, BENGKULU",3,91,93,184
https://kawalpemilu.org#20997,"JERANGLAH TINGGI, MANNA, BENGKULU SELATAN, BENGKULU",4,95,119,214
https://kawalpemilu.org#20998,"KEMBANG AYUN, MANNA, BENGKULU SELATAN, BENGKULU",1,133,95,228
https://kawalpemilu.org#20999,"TAMBANGAN, MANNA, BENGKULU SELATAN, BENGKULU",1,143,95,238
https://kawalpemilu.org#20999,"TAMBANGAN, MANNA, BENGKULU SELATAN, BENGKULU",2,122,121,243
https://kawalpemilu.org#21000,"PADANG MANIS, MANNA, BENGKULU SELATAN, BENGKULU",1,87,108,195
https://kawalpemilu.org#21000,"PADANG MANIS, MANNA, BENGKULU SELATAN, BENGKULU",2,99,88,187
https://kawalpemilu.org#21001,"PADANG PANDAN, MANNA, BENGKULU SELATAN, BENGKULU",1,104,106,210
https://kawalpemilu.org#21001,"PADANG PANDAN, MANNA, BENGKULU SELATAN, BENGKULU",2,146,79,225
https://kawalpemilu.org#21001,"PADANG PANDAN, MANNA, BENGKULU SELATAN, BENGKULU",3,175,54,229
https://kawalpemilu.org#21002,"GUNUNG KEMBANG, MANNA, BENGKULU SELATAN, BENGKULU",1,65,123,188
https://kawalpemilu.org#21002,"GUNUNG KEMBANG, MANNA, BENGKULU SELATAN, BENGKULU",2,76,118,194
https://kawalpemilu.org#21002,"GUNUNG KEMBANG, MANNA, BENGKULU SELATAN, BENGKULU",3,49,115,164
https://kawalpemilu.org#21004,"GUNUNG AYU I, KOTA MANNA, BENGKULU SELATAN, BENGKULU",1,74,101,175
https://kawalpemilu.org#21004,"GUNUNG AYU I, KOTA MANNA, BENGKULU SELATAN, BENGKULU",2,78,148,226
https://kawalpemilu.org#21004,"GUNUNG AYU I, KOTA MANNA, BENGKULU SELATAN, BENGKULU",3,114,149,263
https://kawalpemilu.org#21004,"GUNUNG AYU I, KOTA MANNA, BENGKULU SELATAN, BENGKULU",4,104,163,267
https://kawalpemilu.org#21004,"GUNUNG AYU I, KOTA MANNA, BENGKULU SELATAN, BENGKULU",5,91,147,238
https://kawalpemilu.org#21004,"GUNUNG AYU I, KOTA MANNA, BENGKULU SELATAN, BENGKULU",6,87,167,254
https://kawalpemilu.org#21005,"KOTA MEDAN, KOTA MANNA, BENGKULU SELATAN, BENGKULU",1,74,179,253
https://kawalpemilu.org#21005,"KOTA MEDAN, KOTA MANNA, BENGKULU SELATAN, BENGKULU",2,70,150,220
https://kawalpemilu.org#21005,"KOTA MEDAN, KOTA MANNA, BENGKULU SELATAN, BENGKULU",3,74,200,274
https://kawalpemilu.org#21005,"KOTA MEDAN, KOTA MANNA, BENGKULU SELATAN, BENGKULU",4,74,175,249
https://kawalpemilu.org#21005,"KOTA MEDAN, KOTA MANNA, BENGKULU SELATAN, BENGKULU",5,77,199,276
https://kawalpemilu.org#21005,"KOTA MEDAN, KOTA MANNA, BENGKULU SELATAN, BENGKULU",6,81,99,180
https://kawalpemilu.org#21005,"KOTA MEDAN, KOTA MANNA, BENGKULU SELATAN, BENGKULU",7,113,162,275
https://kawalpemilu.org#21005,"KOTA MEDAN, KOTA MANNA, BENGKULU SELATAN, BENGKULU",8,76,212,288
https://kawalpemilu.org#21005,"KOTA MEDAN, KOTA MANNA, BENGKULU SELATAN, BENGKULU",9,100,159,259
https://kawalpemilu.org#21005,"KOTA MEDAN, KOTA MANNA, BENGKULU SELATAN, BENGKULU",10,110,137,247
https://kawalpemilu.org#21005,"KOTA MEDAN, KOTA MANNA, BENGKULU SELATAN, BENGKULU",11,71,177,248
https://kawalpemilu.org#21005,"KOTA MEDAN, KOTA MANNA, BENGKULU SELATAN, BENGKULU",12,127,162,289
https://kawalpemilu.org#21005,"KOTA MEDAN, KOTA MANNA, BENGKULU SELATAN, BENGKULU",13,89,131,220
https://kawalpemilu.org#21005,"KOTA MEDAN, KOTA MANNA, BENGKULU SELATAN, BENGKULU",14,95,66,161
https://kawalpemilu.org#21006,"KAMPUNG BARU, KOTA MANNA, BENGKULU SELATAN, BENGKULU",1,54,151,205
https://kawalpemilu.org#21006,"KAMPUNG BARU, KOTA MANNA, BENGKULU SELATAN, BENGKULU",2,62,115,177
https://kawalpemilu.org#21006,"KAMPUNG BARU, KOTA MANNA, BENGKULU SELATAN, BENGKULU",3,67,156,223
https://kawalpemilu.org#21006,"KAMPUNG BARU, KOTA MANNA, BENGKULU SELATAN, BENGKULU",4,58,141,199
https://kawalpemilu.org#21007,"PASAR BARU, KOTA MANNA, BENGKULU SELATAN, BENGKULU",1,64,120,184
https://kawalpemilu.org#21007,"PASAR BARU, KOTA MANNA, BENGKULU SELATAN, BENGKULU",2,67,148,215
https://kawalpemilu.org#21007,"PASAR BARU, KOTA MANNA, BENGKULU SELATAN, BENGKULU",3,84,150,234
https://kawalpemilu.org#21007,"PASAR BARU, KOTA MANNA, BENGKULU SELATAN, BENGKULU",4,59,71,130
https://kawalpemilu.org#21007,"PASAR BARU, KOTA MANNA, BENGKULU SELATAN, BENGKULU",5,56,109,165
https://kawalpemilu.org#21007,"PASAR BARU, KOTA MANNA, BENGKULU SELATAN, BENGKULU",6,48,81,129
https://kawalpemilu.org#21007,"PASAR BARU, KOTA MANNA, BENGKULU SELATAN, BENGKULU",7,32,93,125
https://kawalpemilu.org#21007,"PASAR BARU, KOTA MANNA, BENGKULU SELATAN, BENGKULU",8,35,141,176
https://kawalpemilu.org#21007,"PASAR BARU, KOTA MANNA, BENGKULU SELATAN, BENGKULU",9,45,116,161
https://kawalpemilu.org#21007,"PASAR BARU, KOTA MANNA, BENGKULU SELATAN, BENGKULU",10,111,150,261
https://kawalpemilu.org#21007,"PASAR BARU, KOTA MANNA, BENGKULU SELATAN, BENGKULU",11,50,92,142
https://kawalpemilu.org#21007,"PASAR BARU, KOTA MANNA, BENGKULU SELATAN, BENGKULU",12,62,90,152
https://kawalpemilu.org#21007,"PASAR BARU, KOTA MANNA, BENGKULU SELATAN, BENGKULU",13,58,179,237
https://kawalpemilu.org#21007,"PASAR BARU, KOTA MANNA, BENGKULU SELATAN, BENGKULU",14,26,104,130
https://kawalpemilu.org#21007,"PASAR BARU, KOTA MANNA, BENGKULU SELATAN, BENGKULU",15,44,127,171
https://kawalpemilu.org#21008,"IBUL, KOTA MANNA, BENGKULU SELATAN, BENGKULU",1,94,152,246
https://kawalpemilu.org#21008,"IBUL, KOTA MANNA, BENGKULU SELATAN, BENGKULU",2,105,121,226
https://kawalpemilu.org#21008,"IBUL, KOTA MANNA, BENGKULU SELATAN, BENGKULU",3,115,166,281
https://kawalpemilu.org#21008,"IBUL, KOTA MANNA, BENGKULU SELATAN, BENGKULU",4,89,174,263
https://kawalpemilu.org#21008,"IBUL, KOTA MANNA, BENGKULU SELATAN, BENGKULU",5,115,141,256
https://kawalpemilu.org#21008,"IBUL, KOTA MANNA, BENGKULU SELATAN, BENGKULU",6,55,106,161
https://kawalpemilu.org#21008,"IBUL, KOTA MANNA, BENGKULU SELATAN, BENGKULU",7,93,138,231
https://kawalpemilu.org#21008,"IBUL, KOTA MANNA, BENGKULU SELATAN, BENGKULU",8,70,171,241
https://kawalpemilu.org#21008,"IBUL, KOTA MANNA, BENGKULU SELATAN, BENGKULU",9,48,80,128
https://kawalpemilu.org#21008,"IBUL, KOTA MANNA, BENGKULU SELATAN, BENGKULU",10,37,92,129
https://kawalpemilu.org#21008,"IBUL, KOTA MANNA, BENGKULU SELATAN, BENGKULU",11,92,146,238
https://kawalpemilu.org#21008,"IBUL, KOTA MANNA, BENGKULU SELATAN, BENGKULU",12,124,104,228
https://kawalpemilu.org#21008,"IBUL, KOTA MANNA, BENGKULU SELATAN, BENGKULU",13,78,51,129
https://kawalpemilu.org#21008,"IBUL, KOTA MANNA, BENGKULU SELATAN, BENGKULU",14,82,99,181
https://kawalpemilu.org#21009,"PADANG KAPUK, KOTA MANNA, BENGKULU SELATAN, BENGKULU",1,59,114,173
https://kawalpemilu.org#21009,"PADANG KAPUK, KOTA MANNA, BENGKULU SELATAN, BENGKULU",2,55,146,201
https://kawalpemilu.org#21009,"PADANG KAPUK, KOTA MANNA, BENGKULU SELATAN, BENGKULU",3,72,94,166
https://kawalpemilu.org#21009,"PADANG KAPUK, KOTA MANNA, BENGKULU SELATAN, BENGKULU",4,82,105,187
https://kawalpemilu.org#21009,"PADANG KAPUK, KOTA MANNA, BENGKULU SELATAN, BENGKULU",5,43,144,187
https://kawalpemilu.org#21009,"PADANG KAPUK, KOTA MANNA, BENGKULU SELATAN, BENGKULU",6,80,152,232
https://kawalpemilu.org#21009,"PADANG KAPUK, KOTA MANNA, BENGKULU SELATAN, BENGKULU",7,65,91,156
https://kawalpemilu.org#21009,"PADANG KAPUK, KOTA MANNA, BENGKULU SELATAN, BENGKULU",8,81,154,235
https://kawalpemilu.org#21009,"PADANG KAPUK, KOTA MANNA, BENGKULU SELATAN, BENGKULU",9,75,148,223
https://kawalpemilu.org#21009,"PADANG KAPUK, KOTA MANNA, BENGKULU SELATAN, BENGKULU",10,86,185,271
https://kawalpemilu.org#21009,"PADANG KAPUK, KOTA MANNA, BENGKULU SELATAN, BENGKULU",11,117,93,210
https://kawalpemilu.org#21009,"PADANG KAPUK, KOTA MANNA, BENGKULU SELATAN, BENGKULU",12,70,184,254
https://kawalpemilu.org#21009,"PADANG KAPUK, KOTA MANNA, BENGKULU SELATAN, BENGKULU",13,90,143,233
https://kawalpemilu.org#21009,"PADANG KAPUK, KOTA MANNA, BENGKULU SELATAN, BENGKULU",14,38,161,199
https://kawalpemilu.org#21010,"PAGAR DEWA, KOTA MANNA, BENGKULU SELATAN, BENGKULU",1,108,117,225
https://kawalpemilu.org#21010,"PAGAR DEWA, KOTA MANNA, BENGKULU SELATAN, BENGKULU",2,112,122,234
https://kawalpemilu.org#21010,"PAGAR DEWA, KOTA MANNA, BENGKULU SELATAN, BENGKULU",3,124,97,221
https://kawalpemilu.org#21010,"PAGAR DEWA, KOTA MANNA, BENGKULU SELATAN, BENGKULU",4,129,105,234
https://kawalpemilu.org#21010,"PAGAR DEWA, KOTA MANNA, BENGKULU SELATAN, BENGKULU",5,60,185,245
https://kawalpemilu.org#21010,"PAGAR DEWA, KOTA MANNA, BENGKULU SELATAN, BENGKULU",6,102,129,231
https://kawalpemilu.org#21010,"PAGAR DEWA, KOTA MANNA, BENGKULU SELATAN, BENGKULU",7,139,104,243
https://kawalpemilu.org#21011,"PADANG NIUR, KOTA MANNA, BENGKULU SELATAN, BENGKULU",1,64,139,203
https://kawalpemilu.org#21011,"PADANG NIUR, KOTA MANNA, BENGKULU SELATAN, BENGKULU",2,69,107,176
https://kawalpemilu.org#21011,"PADANG NIUR, KOTA MANNA, BENGKULU SELATAN, BENGKULU",3,65,116,181
https://kawalpemilu.org#21012,"TEBAT KUBU, KOTA MANNA, BENGKULU SELATAN, BENGKULU",1,91,114,205
https://kawalpemilu.org#21012,"TEBAT KUBU, KOTA MANNA, BENGKULU SELATAN, BENGKULU",2,108,125,233
https://kawalpemilu.org#21012,"TEBAT KUBU, KOTA MANNA, BENGKULU SELATAN, BENGKULU",3,73,153,226
https://kawalpemilu.org#21012,"TEBAT KUBU, KOTA MANNA, BENGKULU SELATAN, BENGKULU",4,67,99,166
https://kawalpemilu.org#21013,"GELUMBANG, KOTA MANNA, BENGKULU SELATAN, BENGKULU",1,70,88,161
https://kawalpemilu.org#21013,"GELUMBANG, KOTA MANNA, BENGKULU SELATAN, BENGKULU",2,86,82,168
https://kawalpemilu.org#21013,"GELUMBANG, KOTA MANNA, BENGKULU SELATAN, BENGKULU",3,92,117,209
https://kawalpemilu.org#21014,"PADANG BERANGIN, KOTA MANNA, BENGKULU SELATAN, BENGKULU",1,67,185,252
https://kawalpemilu.org#21016,"SELALI, PINO RAYA, BENGKULU SELATAN, BENGKULU",1,101,114,215
https://kawalpemilu.org#21016,"SELALI, PINO RAYA, BENGKULU SELATAN, BENGKULU",2,96,85,181
https://kawalpemilu.org#21016,"SELALI, PINO RAYA, BENGKULU SELATAN, BENGKULU",3,130,73,203
https://kawalpemilu.org#21016,"SELALI, PINO RAYA, BENGKULU SELATAN, BENGKULU",4,107,139,239
https://kawalpemilu.org#21016,"SELALI, PINO RAYA, BENGKULU SELATAN, BENGKULU",5,99,103,202
https://kawalpemilu.org#21017,"AIR KEMANG, PINO RAYA, BENGKULU SELATAN, BENGKULU",1,84,110,194
https://kawalpemilu.org#21017,"AIR KEMANG, PINO RAYA, BENGKULU SELATAN, BENGKULU",2,113,96,209
https://kawalpemilu.org#21017,"AIR KEMANG, PINO RAYA, BENGKULU SELATAN, BENGKULU",3,71,114,185
https://kawalpemilu.org#21018,"PASAR PINO, PINO RAYA, BENGKULU SELATAN, BENGKULU",1,106,151,257
https://kawalpemilu.org#21018,"PASAR PINO, PINO RAYA, BENGKULU SELATAN, BENGKULU",2,111,138,249
https://kawalpemilu.org#21018,"PASAR PINO, PINO RAYA, BENGKULU SELATAN, BENGKULU",3,49,88,137
https://kawalpemilu.org#21018,"PASAR PINO, PINO RAYA, BENGKULU SELATAN, BENGKULU",4,85,157,242
https://kawalpemilu.org#21018,"PASAR PINO, PINO RAYA, BENGKULU SELATAN, BENGKULU",5,111,98,209
https://kawalpemilu.org#21018,"PASAR PINO, PINO RAYA, BENGKULU SELATAN, BENGKULU",6,152,56,208
https://kawalpemilu.org#21019,"TANGGO RASO, PINO RAYA, BENGKULU SELATAN, BENGKULU",1,103,87,190
https://kawalpemilu.org#21019,"TANGGO RASO, PINO RAYA, BENGKULU SELATAN, BENGKULU",2,91,107,198
https://kawalpemilu.org#21019,"TANGGO RASO, PINO RAYA, BENGKULU SELATAN, BENGKULU",3,97,99,196
https://kawalpemilu.org#21019,"TANGGO RASO, PINO RAYA, BENGKULU SELATAN, BENGKULU",4,124,61,185
https://kawalpemilu.org#21020,"TALANG PADANG, PINO RAYA, BENGKULU SELATAN, BENGKULU",1,117,91,208
https://kawalpemilu.org#21020,"TALANG PADANG, PINO RAYA, BENGKULU SELATAN, BENGKULU",2,61,68,129
https://kawalpemilu.org#21020,"TALANG PADANG, PINO RAYA, BENGKULU SELATAN, BENGKULU",3,74,86,160
https://kawalpemilu.org#21021,"TUNGKAL I, PINO RAYA, BENGKULU SELATAN, BENGKULU",1,78,60,138
https://kawalpemilu.org#21021,"TUNGKAL I, PINO RAYA, BENGKULU SELATAN, BENGKULU",2,117,82,199
https://kawalpemilu.org#21021,"TUNGKAL I, PINO RAYA, BENGKULU SELATAN, BENGKULU",3,112,56,168
https://kawalpemilu.org#21021,"TUNGKAL I, PINO RAYA, BENGKULU SELATAN, BENGKULU",4,109,48,157
https://kawalpemilu.org#21022,"TUNGKAL II, PINO RAYA, BENGKULU SELATAN, BENGKULU",1,129,61,190
https://kawalpemilu.org#21022,"TUNGKAL II, PINO RAYA, BENGKULU SELATAN, BENGKULU",2,131,51,182
https://kawalpemilu.org#21023,"BANDUNG AYU, PINO RAYA, BENGKULU SELATAN, BENGKULU",1,158,56,214
https://kawalpemilu.org#21023,"BANDUNG AYU, PINO RAYA, BENGKULU SELATAN, BENGKULU",2,140,50,190
https://kawalpemilu.org#21023,"BANDUNG AYU, PINO RAYA, BENGKULU SELATAN, BENGKULU",3,156,63,219
https://kawalpemilu.org#21024,"NAPAL MELINTANG, PINO RAYA, BENGKULU SELATAN, BENGKULU",1,137,48,185
https://kawalpemilu.org#21024,"NAPAL MELINTANG, PINO RAYA, BENGKULU SELATAN, BENGKULU",2,120,49,169
https://kawalpemilu.org#21025,"SERANG BULAN, PINO RAYA, BENGKULU SELATAN, BENGKULU",1,130,40,170
https://kawalpemilu.org#21025,"SERANG BULAN, PINO RAYA, BENGKULU SELATAN, BENGKULU",2,114,65,179
https://kawalpemilu.org#21026,"SUKA BANDUNG, PINO RAYA, BENGKULU SELATAN, BENGKULU",1,165,57,222
https://kawalpemilu.org#21026,"SUKA BANDUNG, PINO RAYA, BENGKULU SELATAN, BENGKULU",2,91,49,140
https://kawalpemilu.org#21027,"PAGAR GADING, PINO RAYA, BENGKULU SELATAN, BENGKULU",1,109,82,191
https://kawalpemilu.org#21027,"PAGAR GADING, PINO RAYA, BENGKULU SELATAN, BENGKULU",2,74,94,168
https://kawalpemilu.org#21027,"PAGAR GADING, PINO RAYA, BENGKULU SELATAN, BENGKULU",3,113,64,177
https://kawalpemilu.org#21027,"PAGAR GADING, PINO RAYA, BENGKULU SELATAN, BENGKULU",4,123,65,188
https://kawalpemilu.org#21028,"CINTO MANDI, PINO RAYA, BENGKULU SELATAN, BENGKULU",1,86,31,117
https://kawalpemilu.org#21028,"CINTO MANDI, PINO RAYA, BENGKULU SELATAN, BENGKULU",2,88,13,101
https://kawalpemilu.org#21029,"KEMBANG SERI, PINO RAYA, BENGKULU SELATAN, BENGKULU",1,118,49,167
https://kawalpemilu.org#21029,"KEMBANG SERI, PINO RAYA, BENGKULU SELATAN, BENGKULU",2,115,32,147
https://kawalpemilu.org#21029,"KEMBANG SERI, PINO RAYA, BENGKULU SELATAN, BENGKULU",3,108,10,118
https://kawalpemilu.org#21030,"KARANG CAYO, PINO RAYA, BENGKULU SELATAN, BENGKULU",1,119,34,153
https://kawalpemilu.org#21030,"KARANG CAYO, PINO RAYA, BENGKULU SELATAN, BENGKULU",2,133,40,173
https://kawalpemilu.org#21030,"KARANG CAYO, PINO RAYA, BENGKULU SELATAN, BENGKULU",3,128,26,154
https://kawalpemilu.org#21030,"KARANG CAYO, PINO RAYA, BENGKULU SELATAN, BENGKULU",4,132,17,149
https://kawalpemilu.org#21030,"KARANG CAYO, PINO RAYA, BENGKULU SELATAN, BENGKULU",5,80,17,97
https://kawalpemilu.org#21031,"TANJUNG AUR, PINO RAYA, BENGKULU SELATAN, BENGKULU",1,160,92,252
https://kawalpemilu.org#21031,"TANJUNG AUR, PINO RAYA, BENGKULU SELATAN, BENGKULU",2,169,64,233
https://kawalpemilu.org#21031,"TANJUNG AUR, PINO RAYA, BENGKULU SELATAN, BENGKULU",3,211,47,258
https://kawalpemilu.org#21031,"TANJUNG AUR, PINO RAYA, BENGKULU SELATAN, BENGKULU",4,106,19,125
https://kawalpemilu.org#21032,"NANJUNGAN, PINO RAYA, BENGKULU SELATAN, BENGKULU",1,110,99,209
https://kawalpemilu.org#21032,"NANJUNGAN, PINO RAYA, BENGKULU SELATAN, BENGKULU",2,77,108,185
https://kawalpemilu.org#21032,"NANJUNGAN, PINO RAYA, BENGKULU SELATAN, BENGKULU",3,109,102,211
https://kawalpemilu.org#21032,"NANJUNGAN, PINO RAYA, BENGKULU SELATAN, BENGKULU",4,119,77,196
https://kawalpemilu.org#21032,"NANJUNGAN, PINO RAYA, BENGKULU SELATAN, BENGKULU",5,171,60,231
https://kawalpemilu.org#21032,"NANJUNGAN, PINO RAYA, BENGKULU SELATAN, BENGKULU",6,167,49,216
https://kawalpemilu.org#21033,"KEMANG MANIS, PINO RAYA, BENGKULU SELATAN, BENGKULU",1,80,104,184
https://kawalpemilu.org#21033,"KEMANG MANIS, PINO RAYA, BENGKULU SELATAN, BENGKULU",2,34,91,125
https://kawalpemilu.org#21033,"KEMANG MANIS, PINO RAYA, BENGKULU SELATAN, BENGKULU",3,68,169,237
https://kawalpemilu.org#21034,"PADANG BERIANG, PINO RAYA, BENGKULU SELATAN, BENGKULU",1,122,40,162
https://kawalpemilu.org#21034,"PADANG BERIANG, PINO RAYA, BENGKULU SELATAN, BENGKULU",2,71,85,154
https://kawalpemilu.org#21034,"PADANG BERIANG, PINO RAYA, BENGKULU SELATAN, BENGKULU",3,131,54,185
https://kawalpemilu.org#21034,"PADANG BERIANG, PINO RAYA, BENGKULU SELATAN, BENGKULU",4,102,43,145
https://kawalpemilu.org#21035,"PADANG SERASAN, PINO RAYA, BENGKULU SELATAN, BENGKULU",1,122,114,236
https://kawalpemilu.org#21035,"PADANG SERASAN, PINO RAYA, BENGKULU SELATAN, BENGKULU",2,102,87,189
https://kawalpemilu.org#21035,"PADANG SERASAN, PINO RAYA, BENGKULU SELATAN, BENGKULU",3,76,51,127
https://kawalpemilu.org#21036,"TELAGA DALAM, PINO RAYA, BENGKULU SELATAN, BENGKULU",1,109,40,149
https://kawalpemilu.org#21036,"TELAGA DALAM, PINO RAYA, BENGKULU SELATAN, BENGKULU",2,148,35,183
https://kawalpemilu.org#21038,"KARANG CAYA, KEDURANG ILIR, BENGKULU SELATAN, BENGKULU",1,99,20,119
https://kawalpemilu.org#21038,"KARANG CAYA, KEDURANG ILIR, BENGKULU SELATAN, BENGKULU",2,87,32,119
https://kawalpemilu.org#21039,"BETUNGAN, KEDURANG ILIR, BENGKULU SELATAN, BENGKULU",1,96,36,132
https://kawalpemilu.org#21039,"BETUNGAN, KEDURANG ILIR, BENGKULU SELATAN, BENGKULU",2,56,51,107
https://kawalpemilu.org#21039,"BETUNGAN, KEDURANG ILIR, BENGKULU SELATAN, BENGKULU",3,62,77,139
https://kawalpemilu.org#21040,"PAGAR BANYU, KEDURANG ILIR, BENGKULU SELATAN, BENGKULU",1,108,83,191
https://kawalpemilu.org#21041,"NANJUNGAN, KEDURANG ILIR, BENGKULU SELATAN, BENGKULU",1,54,67,121
https://kawalpemilu.org#21041,"NANJUNGAN, KEDURANG ILIR, BENGKULU SELATAN, BENGKULU",2,64,57,121
https://kawalpemilu.org#21042,"SUKARAMI I, KEDURANG ILIR, BENGKULU SELATAN, BENGKULU",1,106,77,183
https://kawalpemilu.org#21042,"SUKARAMI I, KEDURANG ILIR, BENGKULU SELATAN, BENGKULU",2,114,45,159
https://kawalpemilu.org#21042,"SUKARAMI I, KEDURANG ILIR, BENGKULU SELATAN, BENGKULU",3,98,18,116
https://kawalpemilu.org#21043,"PADANG BINDU, KEDURANG ILIR, BENGKULU SELATAN, BENGKULU",1,58,91,149
https://kawalpemilu.org#21043,"PADANG BINDU, KEDURANG ILIR, BENGKULU SELATAN, BENGKULU",2,81,60,141
https://kawalpemilu.org#21044,"PENINDAIAN, KEDURANG ILIR, BENGKULU SELATAN, BENGKULU",1,72,69,141
https://kawalpemilu.org#21044,"PENINDAIAN, KEDURANG ILIR, BENGKULU SELATAN, BENGKULU",2,84,75,159
https://kawalpemilu.org#21045,"LIMUS, KEDURANG ILIR, BENGKULU SELATAN, BENGKULU",1,121,31,152
https://kawalpemilu.org#21045,"LIMUS, KEDURANG ILIR, BENGKULU SELATAN, BENGKULU",2,121,46,167
https://kawalpemilu.org#21046,"SUKARAJA, KEDURANG ILIR, BENGKULU SELATAN, BENGKULU",1,125,59,184
https://kawalpemilu.org#21047,"LUBUK LADUNG, KEDURANG ILIR, BENGKULU SELATAN, BENGKULU",1,88,73,161
https://kawalpemilu.org#21047,"LUBUK LADUNG, KEDURANG ILIR, BENGKULU SELATAN, BENGKULU",2,84,40,124
https://kawalpemilu.org#21047,"LUBUK LADUNG, KEDURANG ILIR, BENGKULU SELATAN, BENGKULU",3,86,66,152
https://kawalpemilu.org#21047,"LUBUK LADUNG, KEDURANG ILIR, BENGKULU SELATAN, BENGKULU",4,67,29,96
https://kawalpemilu.org#21047,"LUBUK LADUNG, KEDURANG ILIR, BENGKULU SELATAN, BENGKULU",5,80,44,124
https://kawalpemilu.org#21047,"LUBUK LADUNG, KEDURANG ILIR, BENGKULU SELATAN, BENGKULU",6,111,70,181
https://kawalpemilu.org#21048,"AIR SULAU, KEDURANG ILIR, BENGKULU SELATAN, BENGKULU",1,109,79,188
https://kawalpemilu.org#21048,"AIR SULAU, KEDURANG ILIR, BENGKULU SELATAN, BENGKULU",2,82,69,151
https://kawalpemilu.org#21048,"AIR SULAU, KEDURANG ILIR, BENGKULU SELATAN, BENGKULU",3,112,52,164
https://kawalpemilu.org#21048,"AIR SULAU, KEDURANG ILIR, BENGKULU SELATAN, BENGKULU",4,107,41,148
https://kawalpemilu.org#21048,"AIR SULAU, KEDURANG ILIR, BENGKULU SELATAN, BENGKULU",5,149,58,207
https://kawalpemilu.org#21048,"AIR SULAU, KEDURANG ILIR, BENGKULU SELATAN, BENGKULU",6,84,28,112
https://kawalpemilu.org#21048,"AIR SULAU, KEDURANG ILIR, BENGKULU SELATAN, BENGKULU",7,123,82,205
https://kawalpemilu.org#21048,"AIR SULAU, KEDURANG ILIR, BENGKULU SELATAN, BENGKULU",8,101,48,149
https://kawalpemilu.org#21049,"SUKA JAYA, KEDURANG ILIR, BENGKULU SELATAN, BENGKULU",1,97,68,165
https://kawalpemilu.org#21049,"SUKA JAYA, KEDURANG ILIR, BENGKULU SELATAN, BENGKULU",2,94,44,138
https://kawalpemilu.org#21049,"SUKA JAYA, KEDURANG ILIR, BENGKULU SELATAN, BENGKULU",3,89,53,142
https://kawalpemilu.org#21051,"KEBAN JATI, AIR NIPIS, BENGKULU SELATAN, BENGKULU",1,101,32,133
https://kawalpemilu.org#21051,"KEBAN JATI, AIR NIPIS, BENGKULU SELATAN, BENGKULU",2,82,42,124
https://kawalpemilu.org#21052,"TANJUNG BERINGIN, AIR NIPIS, BENGKULU SELATAN, BENGKULU",1,123,24,147
https://kawalpemilu.org#21052,"TANJUNG BERINGIN, AIR NIPIS, BENGKULU SELATAN, BENGKULU",2,92,37,129
https://kawalpemilu.org#21052,"TANJUNG BERINGIN, AIR NIPIS, BENGKULU SELATAN, BENGKULU",3,162,37,199
https://kawalpemilu.org#21052,"TANJUNG BERINGIN, AIR NIPIS, BENGKULU SELATAN, BENGKULU",4,139,35,174
https://kawalpemilu.org#21053,"SUKA NEGERI, AIR NIPIS, BENGKULU SELATAN, BENGKULU",1,128,36,164
https://kawalpemilu.org#21053,"SUKA NEGERI, AIR NIPIS, BENGKULU SELATAN, BENGKULU",2,119,25,144
https://kawalpemilu.org#21053,"SUKA NEGERI, AIR NIPIS, BENGKULU SELATAN, BENGKULU",3,153,23,176
https://kawalpemilu.org#21053,"SUKA NEGERI, AIR NIPIS, BENGKULU SELATAN, BENGKULU",4,133,30,163
https://kawalpemilu.org#21053,"SUKA NEGERI, AIR NIPIS, BENGKULU SELATAN, BENGKULU",5,99,60,159
https://kawalpemilu.org#21053,"SUKA NEGERI, AIR NIPIS, BENGKULU SELATAN, BENGKULU",6,106,30,136
https://kawalpemilu.org#21053,"SUKA NEGERI, AIR NIPIS, BENGKULU SELATAN, BENGKULU",7,148,27,175
https://kawalpemilu.org#21053,"SUKA NEGERI, AIR NIPIS, BENGKULU SELATAN, BENGKULU",8,149,23,172
https://kawalpemilu.org#21054,"SUKARAMI, AIR NIPIS, BENGKULU SELATAN, BENGKULU",1,134,64,198
https://kawalpemilu.org#21054,"SUKARAMI, AIR NIPIS, BENGKULU SELATAN, BENGKULU",2,99,45,144
https://kawalpemilu.org#21054,"SUKARAMI, AIR NIPIS, BENGKULU SELATAN, BENGKULU",3,93,97,190
https://kawalpemilu.org#21054,"SUKARAMI, AIR NIPIS, BENGKULU SELATAN, BENGKULU",4,107,78,185
https://kawalpemilu.org#21054,"SUKARAMI, AIR NIPIS, BENGKULU SELATAN, BENGKULU",5,105,64,169
https://kawalpemilu.org#21054,"SUKARAMI, AIR NIPIS, BENGKULU SELATAN, BENGKULU",6,116,32,148
https://kawalpemilu.org#21055,"PALAK BENGKERUNG, AIR NIPIS, BENGKULU SELATAN, BENGKULU",1,125,70,195
https://kawalpemilu.org#21055,"PALAK BENGKERUNG, AIR NIPIS, BENGKULU SELATAN, BENGKULU",2,51,71,122
https://kawalpemilu.org#21055,"PALAK BENGKERUNG, AIR NIPIS, BENGKULU SELATAN, BENGKULU",3,99,22,121
https://kawalpemilu.org#21055,"PALAK BENGKERUNG, AIR NIPIS, BENGKULU SELATAN, BENGKULU",4,144,45,189
https://kawalpemilu.org#21055,"PALAK BENGKERUNG, AIR NIPIS, BENGKULU SELATAN, BENGKULU",5,137,26,163
https://kawalpemilu.org#21055,"PALAK BENGKERUNG, AIR NIPIS, BENGKULU SELATAN, BENGKULU",6,101,51,152
https://kawalpemilu.org#21055,"PALAK BENGKERUNG, AIR NIPIS, BENGKULU SELATAN, BENGKULU",7,114,43,157
https://kawalpemilu.org#21055,"PALAK BENGKERUNG, AIR NIPIS, BENGKULU SELATAN, BENGKULU",8,154,14,168
https://kawalpemilu.org#21056,"SUKAMAJU, AIR NIPIS, BENGKULU SELATAN, BENGKULU",1,121,87,208
https://kawalpemilu.org#21056,"SUKAMAJU, AIR NIPIS, BENGKULU SELATAN, BENGKULU",2,142,40,182
https://kawalpemilu.org#21056,"SUKAMAJU, AIR NIPIS, BENGKULU SELATAN, BENGKULU",3,162,24,186
https://kawalpemilu.org#21056,"SUKAMAJU, AIR NIPIS, BENGKULU SELATAN, BENGKULU",4,116,25,141
https://kawalpemilu.org#21056,"SUKAMAJU, AIR NIPIS, BENGKULU SELATAN, BENGKULU",5,84,41,125
https://kawalpemilu.org#21056,"SUKAMAJU, AIR NIPIS, BENGKULU SELATAN, BENGKULU",6,52,38,90
https://kawalpemilu.org#21057,"PINO BARU, AIR NIPIS, BENGKULU SELATAN, BENGKULU",1,136,20,156
https://kawalpemilu.org#21057,"PINO BARU, AIR NIPIS, BENGKULU SELATAN, BENGKULU",2,137,24,161
https://kawalpemilu.org#21057,"PINO BARU, AIR NIPIS, BENGKULU SELATAN, BENGKULU",3,140,34,174
https://kawalpemilu.org#21057,"PINO BARU, AIR NIPIS, BENGKULU SELATAN, BENGKULU",4,134,18,152
https://kawalpemilu.org#21057,"PINO BARU, AIR NIPIS, BENGKULU SELATAN, BENGKULU",5,116,30,146
https://kawalpemilu.org#21058,"PENANDINGAN, AIR NIPIS, BENGKULU SELATAN, BENGKULU",1,97,59,156
https://kawalpemilu.org#21058,"PENANDINGAN, AIR NIPIS, BENGKULU SELATAN, BENGKULU",2,97,40,137
https://kawalpemilu.org#21059,"SUKA BANDUNG, AIR NIPIS, BENGKULU SELATAN, BENGKULU",1,100,73,173
https://kawalpemilu.org#21060,"MARAS, AIR NIPIS, BENGKULU SELATAN, BENGKULU",1,130,69,199
https://kawalpemilu.org#21060,"MARAS, AIR NIPIS, BENGKULU SELATAN, BENGKULU",2,137,37,174
https://kawalpemilu.org#21060,"MARAS, AIR NIPIS, BENGKULU SELATAN, BENGKULU",3,114,63,177
https://kawalpemilu.org#21060,"MARAS, AIR NIPIS, BENGKULU SELATAN, BENGKULU",4,119,44,163
https://kawalpemilu.org#21062,"BATU PANCO, ULU MANNA, BENGKULU SELATAN, BENGKULU",1,63,41,104
https://kawalpemilu.org#21063,"BATU KUNING, ULU MANNA, BENGKULU SELATAN, BENGKULU",1,78,141,219
https://kawalpemilu.org#21063,"BATU KUNING, ULU MANNA, BENGKULU SELATAN, BENGKULU",2,52,67,119
https://kawalpemilu.org#21063,"BATU KUNING, ULU MANNA, BENGKULU SELATAN, BENGKULU",3,81,98,179
https://kawalpemilu.org#21064,"BANDAR AGUNG, ULU MANNA, BENGKULU SELATAN, BENGKULU",1,96,83,179
https://kawalpemilu.org#21064,"BANDAR AGUNG, ULU MANNA, BENGKULU SELATAN, BENGKULU",2,142,53,195
https://kawalpemilu.org#21064,"BANDAR AGUNG, ULU MANNA, BENGKULU SELATAN, BENGKULU",3,105,46,151
https://kawalpemilu.org#21064,"BANDAR AGUNG, ULU MANNA, BENGKULU SELATAN, BENGKULU",4,107,65,172
https://kawalpemilu.org#21064,"BANDAR AGUNG, ULU MANNA, BENGKULU SELATAN, BENGKULU",5,78,24,102
https://kawalpemilu.org#21065,"MERAMBUNG, ULU MANNA, BENGKULU SELATAN, BENGKULU",1,74,71,145
https://kawalpemilu.org#21065,"MERAMBUNG, ULU MANNA, BENGKULU SELATAN, BENGKULU",2,135,92,227
https://kawalpemilu.org#21066,"SIMPANG PINO, ULU MANNA, BENGKULU SELATAN, BENGKULU",1,98,138,228
https://kawalpemilu.org#21066,"SIMPANG PINO, ULU MANNA, BENGKULU SELATAN, BENGKULU",2,129,60,189
https://kawalpemilu.org#21066,"SIMPANG PINO, ULU MANNA, BENGKULU SELATAN, BENGKULU",3,126,93,219
https://kawalpemilu.org#21067,"TALANG TINGGI, ULU MANNA, BENGKULU SELATAN, BENGKULU",1,131,41,172
https://kawalpemilu.org#21067,"TALANG TINGGI, ULU MANNA, BENGKULU SELATAN, BENGKULU",2,91,69,160
https://kawalpemilu.org#21067,"TALANG TINGGI, ULU MANNA, BENGKULU SELATAN, BENGKULU",3,101,54,155
https://kawalpemilu.org#21067,"TALANG TINGGI, ULU MANNA, BENGKULU SELATAN, BENGKULU",4,91,67,158
https://kawalpemilu.org#21068,"KEBAN JATI, ULU MANNA, BENGKULU SELATAN, BENGKULU",1,110,80,190
https://kawalpemilu.org#21068,"KEBAN JATI, ULU MANNA, BENGKULU SELATAN, BENGKULU",2,127,69,196
https://kawalpemilu.org#21068,"KEBAN JATI, ULU MANNA, BENGKULU SELATAN, BENGKULU",3,94,63,157
https://kawalpemilu.org#21069,"LUBUK TAPI, ULU MANNA, BENGKULU SELATAN, BENGKULU",1,87,94,181
https://kawalpemilu.org#21069,"LUBUK TAPI, ULU MANNA, BENGKULU SELATAN, BENGKULU",2,97,68,165
https://kawalpemilu.org#21069,"LUBUK TAPI, ULU MANNA, BENGKULU SELATAN, BENGKULU",3,115,54,169
https://kawalpemilu.org#21069,"LUBUK TAPI, ULU MANNA, BENGKULU SELATAN, BENGKULU",4,126,53,179
https://kawalpemilu.org#21070,"KAYU AJARAN, ULU MANNA, BENGKULU SELATAN, BENGKULU",1,214,33,247
https://kawalpemilu.org#21070,"KAYU AJARAN, ULU MANNA, BENGKULU SELATAN, BENGKULU",2,183,33,216
https://kawalpemilu.org#21070,"KAYU AJARAN, ULU MANNA, BENGKULU SELATAN, BENGKULU",3,192,25,217
https://kawalpemilu.org#21071,"AIR TENAM, ULU MANNA, BENGKULU SELATAN, BENGKULU",1,31,54,85
https://kawalpemilu.org#21073,"TUMBUK TEBING, BUNGA MAS, BENGKULU SELATAN, BENGKULU",1,124,93,217
https://kawalpemilu.org#21073,"TUMBUK TEBING, BUNGA MAS, BENGKULU SELATAN, BENGKULU",2,39,114,153
https://kawalpemilu.org#21074,"GUNUNG KAYO, BUNGA MAS, BENGKULU SELATAN, BENGKULU",1,78,100,178
https://kawalpemilu.org#21074,"GUNUNG KAYO, BUNGA MAS, BENGKULU SELATAN, BENGKULU",2,93,82,175
https://kawalpemilu.org#21075,"GINDOSULI, BUNGA MAS, BENGKULU SELATAN, BENGKULU",1,78,82,160
https://kawalpemilu.org#21075,"GINDOSULI, BUNGA MAS, BENGKULU SELATAN, BENGKULU",2,112,60,172
https://kawalpemilu.org#21075,"GINDOSULI, BUNGA MAS, BENGKULU SELATAN, BENGKULU",3,74,64,138
https://kawalpemilu.org#21075,"GINDOSULI, BUNGA MAS, BENGKULU SELATAN, BENGKULU",4,82,59,141
https://kawalpemilu.org#21076,"TALANG INDAH, BUNGA MAS, BENGKULU SELATAN, BENGKULU",1,105,48,153
https://kawalpemilu.org#21076,"TALANG INDAH, BUNGA MAS, BENGKULU SELATAN, BENGKULU",2,85,79,164
https://kawalpemilu.org#21076,"TALANG INDAH, BUNGA MAS, BENGKULU SELATAN, BENGKULU",3,86,77,163
https://kawalpemilu.org#21077,"KURIPAN, BUNGA MAS, BENGKULU SELATAN, BENGKULU",1,92,54,146
https://kawalpemilu.org#21077,"KURIPAN, BUNGA MAS, BENGKULU SELATAN, BENGKULU",2,44,56,100
https://kawalpemilu.org#21078,"PADANG NIBUNG, BUNGA MAS, BENGKULU SELATAN, BENGKULU",1,89,38,127
https://kawalpemilu.org#21078,"PADANG NIBUNG, BUNGA MAS, BENGKULU SELATAN, BENGKULU",2,86,39,125
https://kawalpemilu.org#21079,"TANJUNG TEBAT, BUNGA MAS, BENGKULU SELATAN, BENGKULU",1,84,77,161
https://kawalpemilu.org#21079,"TANJUNG TEBAT, BUNGA MAS, BENGKULU SELATAN, BENGKULU",2,88,81,169
https://kawalpemilu.org#21079,"TANJUNG TEBAT, BUNGA MAS, BENGKULU SELATAN, BENGKULU",3,71,79,150
https://kawalpemilu.org#21080,"PADANG JAWI, BUNGA MAS, BENGKULU SELATAN, BENGKULU",1,111,59,170
https://kawalpemilu.org#21080,"PADANG JAWI, BUNGA MAS, BENGKULU SELATAN, BENGKULU",2,90,66,156
https://kawalpemilu.org#21080,"PADANG JAWI, BUNGA MAS, BENGKULU SELATAN, BENGKULU",3,88,50,138
https://kawalpemilu.org#21080,"PADANG JAWI, BUNGA MAS, BENGKULU SELATAN, BENGKULU",4,78,65,143
https://kawalpemilu.org#21081,"TANJUNG AUR, BUNGA MAS, BENGKULU SELATAN, BENGKULU",1,72,147,219
https://kawalpemilu.org#21081,"TANJUNG AUR, BUNGA MAS, BENGKULU SELATAN, BENGKULU",2,55,119,174
https://kawalpemilu.org#21082,"PADANG BURNAI, BUNGA MAS, BENGKULU SELATAN, BENGKULU",1,92,99,191
https://kawalpemilu.org#21082,"PADANG BURNAI, BUNGA MAS, BENGKULU SELATAN, BENGKULU",2,76,99,175
https://kawalpemilu.org#21084,"TANJUNG MULIA, PASAR MANNA, BENGKULU SELATAN, BENGKULU",1,29,144,173
https://kawalpemilu.org#21084,"TANJUNG MULIA, PASAR MANNA, BENGKULU SELATAN, BENGKULU",2,60,113,173
https://kawalpemilu.org#21084,"TANJUNG MULIA, PASAR MANNA, BENGKULU SELATAN, BENGKULU",3,49,104,153
https://kawalpemilu.org#21084,"TANJUNG MULIA, PASAR MANNA, BENGKULU SELATAN, BENGKULU",4,75,97,172
https://kawalpemilu.org#21084,"TANJUNG MULIA, PASAR MANNA, BENGKULU SELATAN, BENGKULU",5,78,142,220
https://kawalpemilu.org#21084,"TANJUNG MULIA, PASAR MANNA, BENGKULU SELATAN, BENGKULU",6,66,188,254
https://kawalpemilu.org#21084,"TANJUNG MULIA, PASAR MANNA, BENGKULU SELATAN, BENGKULU",7,103,164,267
https://kawalpemilu.org#21084,"TANJUNG MULIA, PASAR MANNA, BENGKULU SELATAN, BENGKULU",8,68,104,172
https://kawalpemilu.org#21084,"TANJUNG MULIA, PASAR MANNA, BENGKULU SELATAN, BENGKULU",9,67,157,224
https://kawalpemilu.org#21084,"TANJUNG MULIA, PASAR MANNA, BENGKULU SELATAN, BENGKULU",10,59,194,253
https://kawalpemilu.org#21084,"TANJUNG MULIA, PASAR MANNA, BENGKULU SELATAN, BENGKULU",11,70,161,231
https://kawalpemilu.org#21084,"TANJUNG MULIA, PASAR MANNA, BENGKULU SELATAN, BENGKULU",12,64,182,246
https://kawalpemilu.org#21085,"PASAR MULIA, PASAR MANNA, BENGKULU SELATAN, BENGKULU",1,66,201,267
https://kawalpemilu.org#21085,"PASAR MULIA, PASAR MANNA, BENGKULU SELATAN, BENGKULU",2,32,143,175
https://kawalpemilu.org#21085,"PASAR MULIA, PASAR MANNA, BENGKULU SELATAN, BENGKULU",3,65,86,151
https://kawalpemilu.org#21085,"PASAR MULIA, PASAR MANNA, BENGKULU SELATAN, BENGKULU",4,54,145,199
https://kawalpemilu.org#21085,"PASAR MULIA, PASAR MANNA, BENGKULU SELATAN, BENGKULU",5,60,171,231
https://kawalpemilu.org#21086,"BELAKANG GEDUNG, PASAR MANNA, BENGKULU SELATAN, BENGKULU",1,41,135,176
https://kawalpemilu.org#21086,"BELAKANG GEDUNG, PASAR MANNA, BENGKULU SELATAN, BENGKULU",2,36,186,222
https://kawalpemilu.org#21086,"BELAKANG GEDUNG, PASAR MANNA, BENGKULU SELATAN, BENGKULU",3,54,124,178
https://kawalpemilu.org#21087,"GUNUNG MESIR, PASAR MANNA, BENGKULU SELATAN, BENGKULU",1,55,113,168
https://kawalpemilu.org#21087,"GUNUNG MESIR, PASAR MANNA, BENGKULU SELATAN, BENGKULU",2,56,187,243
https://kawalpemilu.org#21087,"GUNUNG MESIR, PASAR MANNA, BENGKULU SELATAN, BENGKULU",3,73,152,225
https://kawalpemilu.org#21087,"GUNUNG MESIR, PASAR MANNA, BENGKULU SELATAN, BENGKULU",4,46,164,210
https://kawalpemilu.org#21088,"PADANG SIALANG, PASAR MANNA, BENGKULU SELATAN, BENGKULU",1,67,176,243
https://kawalpemilu.org#21088,"PADANG SIALANG, PASAR MANNA, BENGKULU SELATAN, BENGKULU",2,39,154,193
https://kawalpemilu.org#21088,"PADANG SIALANG, PASAR MANNA, BENGKULU SELATAN, BENGKULU",3,39,116,155
https://kawalpemilu.org#21088,"PADANG SIALANG, PASAR MANNA, BENGKULU SELATAN, BENGKULU",4,48,133,181
https://kawalpemilu.org#21088,"PADANG SIALANG, PASAR MANNA, BENGKULU SELATAN, BENGKULU",5,34,82,116
https://kawalpemilu.org#21088,"PADANG SIALANG, PASAR MANNA, BENGKULU SELATAN, BENGKULU",6,37,153,190
https://kawalpemilu.org#21088,"PADANG SIALANG, PASAR MANNA, BENGKULU SELATAN, BENGKULU",7,74,177,251
https://kawalpemilu.org#21088,"PADANG SIALANG, PASAR MANNA, BENGKULU SELATAN, BENGKULU",8,1,0,1
https://kawalpemilu.org#21089,"KETAPANG BESAR, PASAR MANNA, BENGKULU SELATAN, BENGKULU",1,84,158,242
https://kawalpemilu.org#21089,"KETAPANG BESAR, PASAR MANNA, BENGKULU SELATAN, BENGKULU",2,82,194,276
https://kawalpemilu.org#21089,"KETAPANG BESAR, PASAR MANNA, BENGKULU SELATAN, BENGKULU",3,84,188,272
https://kawalpemilu.org#21089,"KETAPANG BESAR, PASAR MANNA, BENGKULU SELATAN, BENGKULU",4,70,187,257
https://kawalpemilu.org#21089,"KETAPANG BESAR, PASAR MANNA, BENGKULU SELATAN, BENGKULU",5,74,171,245
https://kawalpemilu.org#21089,"KETAPANG BESAR, PASAR MANNA, BENGKULU SELATAN, BENGKULU",6,61,189,250
https://kawalpemilu.org#21090,"PASAR BAWAH, PASAR MANNA, BENGKULU SELATAN, BENGKULU",1,125,133,258
https://kawalpemilu.org#21090,"PASAR BAWAH, PASAR MANNA, BENGKULU SELATAN, BENGKULU",2,90,140,230
https://kawalpemilu.org#21090,"PASAR BAWAH, PASAR MANNA, BENGKULU SELATAN, BENGKULU",3,77,107,184
https://kawalpemilu.org#21090,"PASAR BAWAH, PASAR MANNA, BENGKULU SELATAN, BENGKULU",4,52,104,156
https://kawalpemilu.org#21090,"PASAR BAWAH, PASAR MANNA, BENGKULU SELATAN, BENGKULU",5,43,168,211
https://kawalpemilu.org#21090,"PASAR BAWAH, PASAR MANNA, BENGKULU SELATAN, BENGKULU",6,89,113,202
https://kawalpemilu.org#21090,"PASAR BAWAH, PASAR MANNA, BENGKULU SELATAN, BENGKULU",7,49,168,217
https://kawalpemilu.org#21090,"PASAR BAWAH, PASAR MANNA, BENGKULU SELATAN, BENGKULU",8,41,129,170
https://kawalpemilu.org#21091,"BATU KUNING, PASAR MANNA, BENGKULU SELATAN, BENGKULU",1,90,125,215
https://kawalpemilu.org#21091,"BATU KUNING, PASAR MANNA, BENGKULU SELATAN, BENGKULU",2,72,124,196
https://kawalpemilu.org#21092,"BATU LAMBANG, PASAR MANNA, BENGKULU SELATAN, BENGKULU",1,111,132,243
https://kawalpemilu.org#21092,"BATU LAMBANG, PASAR MANNA, BENGKULU SELATAN, BENGKULU",2,90,181,271
https://kawalpemilu.org#21092,"BATU LAMBANG, PASAR MANNA, BENGKULU SELATAN, BENGKULU",3,100,161,261
https://kawalpemilu.org#21095,"KOTA PADANG, KOTA PADANG, REJANG LEBONG, BENGKULU",1,29,140,169
https://kawalpemilu.org#21095,"KOTA PADANG, KOTA PADANG, REJANG LEBONG, BENGKULU",2,50,157,207
https://kawalpemilu.org#21095,"KOTA PADANG, KOTA PADANG, REJANG LEBONG, BENGKULU",3,32,135,167
https://kawalpemilu.org#21095,"KOTA PADANG, KOTA PADANG, REJANG LEBONG, BENGKULU",4,45,132,177
https://kawalpemilu.org#21095,"KOTA PADANG, KOTA PADANG, REJANG LEBONG, BENGKULU",5,72,102,174
https://kawalpemilu.org#21095,"KOTA PADANG, KOTA PADANG, REJANG LEBONG, BENGKULU",6,29,116,145
https://kawalpemilu.org#21095,"KOTA PADANG, KOTA PADANG, REJANG LEBONG, BENGKULU",7,43,85,128
https://kawalpemilu.org#21096,"BEDENG SS., KOTA PADANG, REJANG LEBONG, BENGKULU",1,30,141,171
https://kawalpemilu.org#21096,"BEDENG SS., KOTA PADANG, REJANG LEBONG, BENGKULU",2,36,131,167
https://kawalpemilu.org#21096,"BEDENG SS., KOTA PADANG, REJANG LEBONG, BENGKULU",3,52,70,122
https://kawalpemilu.org#21096,"BEDENG SS., KOTA PADANG, REJANG LEBONG, BENGKULU",4,27,69,96
https://kawalpemilu.org#21097,"DUSUN BARU, KOTA PADANG, REJANG LEBONG, BENGKULU",1,26,130,156
https://kawalpemilu.org#21097,"DUSUN BARU, KOTA PADANG, REJANG LEBONG, BENGKULU",2,32,119,151
https://kawalpemilu.org#21097,"DUSUN BARU, KOTA PADANG, REJANG LEBONG, BENGKULU",3,29,114,143
https://kawalpemilu.org#21098,"DERATI, KOTA PADANG, REJANG LEBONG, BENGKULU",1,22,127,149
https://kawalpemilu.org#21098,"DERATI, KOTA PADANG, REJANG LEBONG, BENGKULU",2,14,119,133
https://kawalpemilu.org#21098,"DERATI, KOTA PADANG, REJANG LEBONG, BENGKULU",3,16,158,174
https://kawalpemilu.org#21098,"DERATI, KOTA PADANG, REJANG LEBONG, BENGKULU",4,13,148,161
https://kawalpemilu.org#21099,"TABA ANYAR, KOTA PADANG, REJANG LEBONG, BENGKULU",1,34,130,164
https://kawalpemilu.org#21099,"TABA ANYAR, KOTA PADANG, REJANG LEBONG, BENGKULU",2,16,122,138
https://kawalpemilu.org#21099,"TABA ANYAR, KOTA PADANG, REJANG LEBONG, BENGKULU",3,28,152,180
https://kawalpemilu.org#21100,"SUKA RAMI, KOTA PADANG, REJANG LEBONG, BENGKULU",1,49,147,196
https://kawalpemilu.org#21100,"SUKA RAMI, KOTA PADANG, REJANG LEBONG, BENGKULU",2,41,135,176
https://kawalpemilu.org#21100,"SUKA RAMI, KOTA PADANG, REJANG LEBONG, BENGKULU",3,49,128,177
https://kawalpemilu.org#21101,"LUBUK MUMPO, KOTA PADANG, REJANG LEBONG, BENGKULU",1,23,189,212
https://kawalpemilu.org#21101,"LUBUK MUMPO, KOTA PADANG, REJANG LEBONG, BENGKULU",2,29,151,180
https://kawalpemilu.org#21101,"LUBUK MUMPO, KOTA PADANG, REJANG LEBONG, BENGKULU",3,31,141,172
https://kawalpemilu.org#21101,"LUBUK MUMPO, KOTA PADANG, REJANG LEBONG, BENGKULU",4,30,131,161
https://kawalpemilu.org#21101,"LUBUK MUMPO, KOTA PADANG, REJANG LEBONG, BENGKULU",5,23,146,169
https://kawalpemilu.org#21101,"LUBUK MUMPO, KOTA PADANG, REJANG LEBONG, BENGKULU",6,33,98,131
https://kawalpemilu.org#21101,"LUBUK MUMPO, KOTA PADANG, REJANG LEBONG, BENGKULU",7,15,80,95
https://kawalpemilu.org#21102,"DURIAN MAS, KOTA PADANG, REJANG LEBONG, BENGKULU",1,36,147,183
https://kawalpemilu.org#21102,"DURIAN MAS, KOTA PADANG, REJANG LEBONG, BENGKULU",2,56,98,154
https://kawalpemilu.org#21102,"DURIAN MAS, KOTA PADANG, REJANG LEBONG, BENGKULU",3,51,127,178
https://kawalpemilu.org#21102,"DURIAN MAS, KOTA PADANG, REJANG LEBONG, BENGKULU",4,62,131,193
https://kawalpemilu.org#21102,"DURIAN MAS, KOTA PADANG, REJANG LEBONG, BENGKULU",5,25,158,183
https://kawalpemilu.org#21102,"DURIAN MAS, KOTA PADANG, REJANG LEBONG, BENGKULU",6,48,133,181
https://kawalpemilu.org#21103,"KOTA PADANG BARU, KOTA PADANG, REJANG LEBONG, BENGKULU",1,53,104,157
https://kawalpemilu.org#21103,"KOTA PADANG BARU, KOTA PADANG, REJANG LEBONG, BENGKULU",2,31,51,82
https://kawalpemilu.org#21104,"TANJUNG GELANG, KOTA PADANG, REJANG LEBONG, BENGKULU",1,27,107,134
https://kawalpemilu.org#21104,"TANJUNG GELANG, KOTA PADANG, REJANG LEBONG, BENGKULU",2,85,60,145
https://kawalpemilu.org#21104,"TANJUNG GELANG, KOTA PADANG, REJANG LEBONG, BENGKULU",3,32,60,92
https://kawalpemilu.org#21106,"PASAR PU TANDING, PADANG ULAK TANDING, REJANG LEBONG, BENGKULU",1,73,143,216
https://kawalpemilu.org#21106,"PASAR PU TANDING, PADANG ULAK TANDING, REJANG LEBONG, BENGKULU",2,76,109,185
https://kawalpemilu.org#21106,"PASAR PU TANDING, PADANG ULAK TANDING, REJANG LEBONG, BENGKULU",3,54,145,199
https://kawalpemilu.org#21106,"PASAR PU TANDING, PADANG ULAK TANDING, REJANG LEBONG, BENGKULU",4,61,143,204
https://kawalpemilu.org#21106,"PASAR PU TANDING, PADANG ULAK TANDING, REJANG LEBONG, BENGKULU",5,56,107,163
https://kawalpemilu.org#21106,"PASAR PU TANDING, PADANG ULAK TANDING, REJANG LEBONG, BENGKULU",6,49,124,173
https://kawalpemilu.org#21107,"KARANG BARU, PADANG ULAK TANDING, REJANG LEBONG, BENGKULU",1,59,164,223
https://kawalpemilu.org#21107,"KARANG BARU, PADANG ULAK TANDING, REJANG LEBONG, BENGKULU",2,48,158,206
https://kawalpemilu.org#21107,"KARANG BARU, PADANG ULAK TANDING, REJANG LEBONG, BENGKULU",3,69,117,186
https://kawalpemilu.org#21107,"KARANG BARU, PADANG ULAK TANDING, REJANG LEBONG, BENGKULU",4,78,146,224
https://kawalpemilu.org#21107,"KARANG BARU, PADANG ULAK TANDING, REJANG LEBONG, BENGKULU",5,43,160,203
https://kawalpemilu.org#21108,"GURU AGUNG, PADANG ULAK TANDING, REJANG LEBONG, BENGKULU",2,23,181,204
https://kawalpemilu.org#21108,"GURU AGUNG, PADANG ULAK TANDING, REJANG LEBONG, BENGKULU",3,19,174,193
https://kawalpemilu.org#21108,"GURU AGUNG, PADANG ULAK TANDING, REJANG LEBONG, BENGKULU",4,31,98,129
https://kawalpemilu.org#21109,"BELUMAI II, PADANG ULAK TANDING, REJANG LEBONG, BENGKULU",1,146,94,240
https://kawalpemilu.org#21109,"BELUMAI II, PADANG ULAK TANDING, REJANG LEBONG, BENGKULU",2,197,48,245
https://kawalpemilu.org#21109,"BELUMAI II, PADANG ULAK TANDING, REJANG LEBONG, BENGKULU",3,191,61,252
https://kawalpemilu.org#21109,"BELUMAI II, PADANG ULAK TANDING, REJANG LEBONG, BENGKULU",4,191,47,238
https://kawalpemilu.org#21110,"BELUMAI I, PADANG ULAK TANDING, REJANG LEBONG, BENGKULU",1,61,161,222
https://kawalpemilu.org#21110,"BELUMAI I, PADANG ULAK TANDING, REJANG LEBONG, BENGKULU",2,69,162,231
https://kawalpemilu.org#21110,"BELUMAI I, PADANG ULAK TANDING, REJANG LEBONG, BENGKULU",3,76,134,210
https://kawalpemilu.org#21111,"ULAK TANDING, PADANG ULAK TANDING, REJANG LEBONG, BENGKULU",1,53,133,186
https://kawalpemilu.org#21111,"ULAK TANDING, PADANG ULAK TANDING, REJANG LEBONG, BENGKULU",2,37,115,152
https://kawalpemilu.org#21111,"ULAK TANDING, PADANG ULAK TANDING, REJANG LEBONG, BENGKULU",3,21,126,147
https://kawalpemilu.org#21112,"TANJUNG SANAI I, PADANG ULAK TANDING, REJANG LEBONG, BENGKULU",1,104,122,226
https://kawalpemilu.org#21112,"TANJUNG SANAI I, PADANG ULAK TANDING, REJANG LEBONG, BENGKULU",2,66,137,203
https://kawalpemilu.org#21112,"TANJUNG SANAI I, PADANG ULAK TANDING, REJANG LEBONG, BENGKULU",3,94,122,216
https://kawalpemilu.org#21112,"TANJUNG SANAI I, PADANG ULAK TANDING, REJANG LEBONG, BENGKULU",4,78,130,208
https://kawalpemilu.org#21112,"TANJUNG SANAI I, PADANG ULAK TANDING, REJANG LEBONG, BENGKULU",5,93,123,213
https://kawalpemilu.org#21113,"MUARA TELITA, PADANG ULAK TANDING, REJANG LEBONG, BENGKULU",1,51,160,211
https://kawalpemilu.org#21113,"MUARA TELITA, PADANG ULAK TANDING, REJANG LEBONG, BENGKULU",2,52,184,236
https://kawalpemilu.org#21113,"MUARA TELITA, PADANG ULAK TANDING, REJANG LEBONG, BENGKULU",3,22,76,98
https://kawalpemilu.org#21114,"UJAN PANAS, PADANG ULAK TANDING, REJANG LEBONG, BENGKULU",1,57,133,190
https://kawalpemilu.org#21114,"UJAN PANAS, PADANG ULAK TANDING, REJANG LEBONG, BENGKULU",2,31,102,133
https://kawalpemilu.org#21115,"TABA TINGGI, PADANG ULAK TANDING, REJANG LEBONG, BENGKULU",1,70,159,229
https://kawalpemilu.org#21115,"TABA TINGGI, PADANG ULAK TANDING, REJANG LEBONG, BENGKULU",2,46,188,234
https://kawalpemilu.org#21115,"TABA TINGGI, PADANG ULAK TANDING, REJANG LEBONG, BENGKULU",3,180,57,237
https://kawalpemilu.org#21115,"TABA TINGGI, PADANG ULAK TANDING, REJANG LEBONG, BENGKULU",4,30,134,164
https://kawalpemilu.org#21116,"TANJUNG SANAI II, PADANG ULAK TANDING, REJANG LEBONG, BENGKULU",1,52,128,180
https://kawalpemilu.org#21116,"TANJUNG SANAI II, PADANG ULAK TANDING, REJANG LEBONG, BENGKULU",2,37,163,200
https://kawalpemilu.org#21116,"TANJUNG SANAI II, PADANG ULAK TANDING, REJANG LEBONG, BENGKULU",3,41,165,206
https://kawalpemilu.org#21116,"TANJUNG SANAI II, PADANG ULAK TANDING, REJANG LEBONG, BENGKULU",4,52,139,191
https://kawalpemilu.org#21116,"TANJUNG SANAI II, PADANG ULAK TANDING, REJANG LEBONG, BENGKULU",5,58,132,190
https://kawalpemilu.org#21117,"TAKTOI, PADANG ULAK TANDING, REJANG LEBONG, BENGKULU",1,20,205,225
https://kawalpemilu.org#21117,"TAKTOI, PADANG ULAK TANDING, REJANG LEBONG, BENGKULU",2,167,46,213
https://kawalpemilu.org#21117,"TAKTOI, PADANG ULAK TANDING, REJANG LEBONG, BENGKULU",3,23,121,144
https://kawalpemilu.org#21118,"KASIE KASUBUN, PADANG ULAK TANDING, REJANG LEBONG, BENGKULU",1,54,184,238
https://kawalpemilu.org#21118,"KASIE KASUBUN, PADANG ULAK TANDING, REJANG LEBONG, BENGKULU",2,51,219,270
https://kawalpemilu.org#21118,"KASIE KASUBUN, PADANG ULAK TANDING, REJANG LEBONG, BENGKULU",3,38,215,253
https://kawalpemilu.org#21118,"KASIE KASUBUN, PADANG ULAK TANDING, REJANG LEBONG, BENGKULU",4,147,68,215
https://kawalpemilu.org#21118,"KASIE KASUBUN, PADANG ULAK TANDING, REJANG LEBONG, BENGKULU",5,34,230,264
https://kawalpemilu.org#21119,"AIR KATI, PADANG ULAK TANDING, REJANG LEBONG, BENGKULU",1,107,112,219
https://kawalpemilu.org#21119,"AIR KATI, PADANG ULAK TANDING, REJANG LEBONG, BENGKULU",2,126,67,193
https://kawalpemilu.org#21119,"AIR KATI, PADANG ULAK TANDING, REJANG LEBONG, BENGKULU",3,86,101,187
https://kawalpemilu.org#21120,"BUKIT BATU, PADANG ULAK TANDING, REJANG LEBONG, BENGKULU",1,86,105,191
https://kawalpemilu.org#21120,"BUKIT BATU, PADANG ULAK TANDING, REJANG LEBONG, BENGKULU",2,95,98,193
https://kawalpemilu.org#21120,"BUKIT BATU, PADANG ULAK TANDING, REJANG LEBONG, BENGKULU",3,77,103,180
https://kawalpemilu.org#21120,"BUKIT BATU, PADANG ULAK TANDING, REJANG LEBONG, BENGKULU",4,90,79,169
https://kawalpemilu.org#21120,"BUKIT BATU, PADANG ULAK TANDING, REJANG LEBONG, BENGKULU",5,52,74,126
https://kawalpemilu.org#21122,"BERINGIN TIGA, SINDANG KELINGI, REJANG LEBONG, BENGKULU",1,136,80,216
https://kawalpemilu.org#21122,"BERINGIN TIGA, SINDANG KELINGI, REJANG LEBONG, BENGKULU",2,116,52,168
https://kawalpemilu.org#21122,"BERINGIN TIGA, SINDANG KELINGI, REJANG LEBONG, BENGKULU",3,135,54,189
https://kawalpemilu.org#21122,"BERINGIN TIGA, SINDANG KELINGI, REJANG LEBONG, BENGKULU",4,130,59,189
https://kawalpemilu.org#21123,"SINDANG JAYA, SINDANG KELINGI, REJANG LEBONG, BENGKULU",1,157,83,240
https://kawalpemilu.org#21123,"SINDANG JAYA, SINDANG KELINGI, REJANG LEBONG, BENGKULU",2,171,86,257
https://kawalpemilu.org#21123,"SINDANG JAYA, SINDANG KELINGI, REJANG LEBONG, BENGKULU",3,120,79,199
https://kawalpemilu.org#21123,"SINDANG JAYA, SINDANG KELINGI, REJANG LEBONG, BENGKULU",4,143,74,217
https://kawalpemilu.org#21124,"SINDANG JATI, SINDANG KELINGI, REJANG LEBONG, BENGKULU",1,131,65,196
https://kawalpemilu.org#21124,"SINDANG JATI, SINDANG KELINGI, REJANG LEBONG, BENGKULU",2,120,84,204
https://kawalpemilu.org#21124,"SINDANG JATI, SINDANG KELINGI, REJANG LEBONG, BENGKULU",3,177,55,232
https://kawalpemilu.org#21124,"SINDANG JATI, SINDANG KELINGI, REJANG LEBONG, BENGKULU",4,167,46,213
https://kawalpemilu.org#21124,"SINDANG JATI, SINDANG KELINGI, REJANG LEBONG, BENGKULU",5,136,70,206
https://kawalpemilu.org#21125,"BELITAR MUKA, SINDANG KELINGI, REJANG LEBONG, BENGKULU",1,177,64,241
https://kawalpemilu.org#21125,"BELITAR MUKA, SINDANG KELINGI, REJANG LEBONG, BENGKULU",2,117,117,234
https://kawalpemilu.org#21125,"BELITAR MUKA, SINDANG KELINGI, REJANG LEBONG, BENGKULU",3,124,74,198
https://kawalpemilu.org#21125,"BELITAR MUKA, SINDANG KELINGI, REJANG LEBONG, BENGKULU",4,131,103,234
https://kawalpemilu.org#21125,"BELITAR MUKA, SINDANG KELINGI, REJANG LEBONG, BENGKULU",5,133,108,241
https://kawalpemilu.org#21125,"BELITAR MUKA, SINDANG KELINGI, REJANG LEBONG, BENGKULU",6,111,119,230
https://kawalpemilu.org#21125,"BELITAR MUKA, SINDANG KELINGI, REJANG LEBONG, BENGKULU",7,125,75,200
https://kawalpemilu.org#21126,"PELALO, SINDANG KELINGI, REJANG LEBONG, BENGKULU",1,112,126,238
https://kawalpemilu.org#21126,"PELALO, SINDANG KELINGI, REJANG LEBONG, BENGKULU",2,113,110,223
https://kawalpemilu.org#21126,"PELALO, SINDANG KELINGI, REJANG LEBONG, BENGKULU",3,117,118,235
https://kawalpemilu.org#21126,"PELALO, SINDANG KELINGI, REJANG LEBONG, BENGKULU",4,132,63,195
https://kawalpemilu.org#21126,"PELALO, SINDANG KELINGI, REJANG LEBONG, BENGKULU",5,140,77,217
https://kawalpemilu.org#21127,"KAYU MANIS, SINDANG KELINGI, REJANG LEBONG, BENGKULU",1,113,78,191
https://kawalpemilu.org#21127,"KAYU MANIS, SINDANG KELINGI, REJANG LEBONG, BENGKULU",2,141,85,226
https://kawalpemilu.org#21129,"AIR DINGIN, SINDANG KELINGI, REJANG LEBONG, BENGKULU",1,204,55,259
https://kawalpemilu.org#21129,"AIR DINGIN, SINDANG KELINGI, REJANG LEBONG, BENGKULU",2,219,43,262
https://kawalpemilu.org#21130,"BELITAR SEBERANG, SINDANG KELINGI, REJANG LEBONG, BENGKULU",1,157,50,207
https://kawalpemilu.org#21130,"BELITAR SEBERANG, SINDANG KELINGI, REJANG LEBONG, BENGKULU",2,162,57,219
https://kawalpemilu.org#21130,"BELITAR SEBERANG, SINDANG KELINGI, REJANG LEBONG, BENGKULU",3,150,53,203
https://kawalpemilu.org#21132,"CAHAYA NEGERI, SINDANG KELINGI, REJANG LEBONG, BENGKULU",1,86,61,147
https://kawalpemilu.org#21132,"CAHAYA NEGERI, SINDANG KELINGI, REJANG LEBONG, BENGKULU",2,102,92,194
https://kawalpemilu.org#21132,"CAHAYA NEGERI, SINDANG KELINGI, REJANG LEBONG, BENGKULU",3,73,65,138
https://kawalpemilu.org#21133,"TANJUNG AUR, SINDANG KELINGI, REJANG LEBONG, BENGKULU",1,105,80,185
https://kawalpemilu.org#21133,"TANJUNG AUR, SINDANG KELINGI, REJANG LEBONG, BENGKULU",2,122,62,184
https://kawalpemilu.org#21133,"TANJUNG AUR, SINDANG KELINGI, REJANG LEBONG, BENGKULU",3,109,88,197
https://kawalpemilu.org#21135,"DWI TUNGGAL, CURUP, REJANG LEBONG, BENGKULU",1,95,161,256
https://kawalpemilu.org#21135,"DWI TUNGGAL, CURUP, REJANG LEBONG, BENGKULU",2,69,156,225
https://kawalpemilu.org#21135,"DWI TUNGGAL, CURUP, REJANG LEBONG, BENGKULU",3,74,160,234
https://kawalpemilu.org#21135,"DWI TUNGGAL, CURUP, REJANG LEBONG, BENGKULU",4,82,182,264
https://kawalpemilu.org#21135,"DWI TUNGGAL, CURUP, REJANG LEBONG, BENGKULU",5,100,122,222
https://kawalpemilu.org#21135,"DWI TUNGGAL, CURUP, REJANG LEBONG, BENGKULU",6,67,117,184
https://kawalpemilu.org#21135,"DWI TUNGGAL, CURUP, REJANG LEBONG, BENGKULU",7,53,164,217
https://kawalpemilu.org#21136,"AIR PUTIH LAMA, CURUP, REJANG LEBONG, BENGKULU",1,80,148,228
https://kawalpemilu.org#21136,"AIR PUTIH LAMA, CURUP, REJANG LEBONG, BENGKULU",2,55,129,184
https://kawalpemilu.org#21136,"AIR PUTIH LAMA, CURUP, REJANG LEBONG, BENGKULU",3,32,113,145
https://kawalpemilu.org#21136,"AIR PUTIH LAMA, CURUP, REJANG LEBONG, BENGKULU",4,81,109,190
https://kawalpemilu.org#21136,"AIR PUTIH LAMA, CURUP, REJANG LEBONG, BENGKULU",5,50,116,166
https://kawalpemilu.org#21136,"AIR PUTIH LAMA, CURUP, REJANG LEBONG, BENGKULU",6,57,140,197
https://kawalpemilu.org#21136,"AIR PUTIH LAMA, CURUP, REJANG LEBONG, BENGKULU",7,44,125,169
https://kawalpemilu.org#21136,"AIR PUTIH LAMA, CURUP, REJANG LEBONG, BENGKULU",8,42,147,189
https://kawalpemilu.org#21136,"AIR PUTIH LAMA, CURUP, REJANG LEBONG, BENGKULU",9,63,159,222
https://kawalpemilu.org#21137,"ADIREJO, CURUP, REJANG LEBONG, BENGKULU",1,80,91,171
https://kawalpemilu.org#21137,"ADIREJO, CURUP, REJANG LEBONG, BENGKULU",2,21,74,95
https://kawalpemilu.org#21137,"ADIREJO, CURUP, REJANG LEBONG, BENGKULU",3,74,98,172
https://kawalpemilu.org#21137,"ADIREJO, CURUP, REJANG LEBONG, BENGKULU",4,48,163,211
https://kawalpemilu.org#21137,"ADIREJO, CURUP, REJANG LEBONG, BENGKULU",5,36,142,178
https://kawalpemilu.org#21138,"AIR RAMBAI, CURUP, REJANG LEBONG, BENGKULU",1,65,145,210
https://kawalpemilu.org#21138,"AIR RAMBAI, CURUP, REJANG LEBONG, BENGKULU",2,64,186,250
https://kawalpemilu.org#21138,"AIR RAMBAI, CURUP, REJANG LEBONG, BENGKULU",3,69,181,250
https://kawalpemilu.org#21138,"AIR RAMBAI, CURUP, REJANG LEBONG, BENGKULU",4,82,169,251
https://kawalpemilu.org#21138,"AIR RAMBAI, CURUP, REJANG LEBONG, BENGKULU",5,43,212,255
https://kawalpemilu.org#21138,"AIR RAMBAI, CURUP, REJANG LEBONG, BENGKULU",6,44,142,186
https://kawalpemilu.org#21138,"AIR RAMBAI, CURUP, REJANG LEBONG, BENGKULU",7,85,118,203
https://kawalpemilu.org#21138,"AIR RAMBAI, CURUP, REJANG LEBONG, BENGKULU",8,40,80,120
https://kawalpemilu.org#21138,"AIR RAMBAI, CURUP, REJANG LEBONG, BENGKULU",9,36,110,146
https://kawalpemilu.org#21138,"AIR RAMBAI, CURUP, REJANG LEBONG, BENGKULU",10,67,172,239
https://kawalpemilu.org#21139,"PASAR BARU, CURUP, REJANG LEBONG, BENGKULU",1,94,149,243
https://kawalpemilu.org#21139,"PASAR BARU, CURUP, REJANG LEBONG, BENGKULU",2,108,130,238
https://kawalpemilu.org#21139,"PASAR BARU, CURUP, REJANG LEBONG, BENGKULU",3,57,96,153
https://kawalpemilu.org#21140,"PASAR TENGAH, CURUP, REJANG LEBONG, BENGKULU",1,68,170,238
https://kawalpemilu.org#21140,"PASAR TENGAH, CURUP, REJANG LEBONG, BENGKULU",2,69,158,227
https://kawalpemilu.org#21140,"PASAR TENGAH, CURUP, REJANG LEBONG, BENGKULU",3,76,72,148
https://kawalpemilu.org#21140,"PASAR TENGAH, CURUP, REJANG LEBONG, BENGKULU",4,60,104,164
https://kawalpemilu.org#21141,"JALAN BARU, CURUP, REJANG LEBONG, BENGKULU",1,72,124,196
https://kawalpemilu.org#21141,"JALAN BARU, CURUP, REJANG LEBONG, BENGKULU",2,71,145,216
https://kawalpemilu.org#21141,"JALAN BARU, CURUP, REJANG LEBONG, BENGKULU",3,72,155,227
https://kawalpemilu.org#21141,"JALAN BARU, CURUP, REJANG LEBONG, BENGKULU",4,69,148,217
https://kawalpemilu.org#21141,"JALAN BARU, CURUP, REJANG LEBONG, BENGKULU",5,64,153,217
https://kawalpemilu.org#21141,"JALAN BARU, CURUP, REJANG LEBONG, BENGKULU",6,108,101,209
https://kawalpemilu.org#21141,"JALAN BARU, CURUP, REJANG LEBONG, BENGKULU",7,81,105,186
https://kawalpemilu.org#21141,"JALAN BARU, CURUP, REJANG LEBONG, BENGKULU",8,86,94,180
https://kawalpemilu.org#21141,"JALAN BARU, CURUP, REJANG LEBONG, BENGKULU",9,92,100,192
https://kawalpemilu.org#21141,"JALAN BARU, CURUP, REJANG LEBONG, BENGKULU",10,89,126,216
https://kawalpemilu.org#21141,"JALAN BARU, CURUP, REJANG LEBONG, BENGKULU",11,71,122,193
https://kawalpemilu.org#21141,"JALAN BARU, CURUP, REJANG LEBONG, BENGKULU",12,67,142,209
https://kawalpemilu.org#21142,"TALANG BENIH, CURUP, REJANG LEBONG, BENGKULU",1,133,111,244
https://kawalpemilu.org#21142,"TALANG BENIH, CURUP, REJANG LEBONG, BENGKULU",2,74,143,217
https://kawalpemilu.org#21142,"TALANG BENIH, CURUP, REJANG LEBONG, BENGKULU",3,89,159,248
https://kawalpemilu.org#21142,"TALANG BENIH, CURUP, REJANG LEBONG, BENGKULU",4,80,178,258
https://kawalpemilu.org#21142,"TALANG BENIH, CURUP, REJANG LEBONG, BENGKULU",5,79,148,227
https://kawalpemilu.org#21142,"TALANG BENIH, CURUP, REJANG LEBONG, BENGKULU",6,69,175,244
https://kawalpemilu.org#21142,"TALANG BENIH, CURUP, REJANG LEBONG, BENGKULU",7,79,182,261
https://kawalpemilu.org#21142,"TALANG BENIH, CURUP, REJANG LEBONG, BENGKULU",8,84,174,258
https://kawalpemilu.org#21142,"TALANG BENIH, CURUP, REJANG LEBONG, BENGKULU",9,91,148,239
https://kawalpemilu.org#21142,"TALANG BENIH, CURUP, REJANG LEBONG, BENGKULU",10,97,155,252
https://kawalpemilu.org#21142,"TALANG BENIH, CURUP, REJANG LEBONG, BENGKULU",11,95,79,174
https://kawalpemilu.org#21142,"TALANG BENIH, CURUP, REJANG LEBONG, BENGKULU",12,100,158,258
https://kawalpemilu.org#21142,"TALANG BENIH, CURUP, REJANG LEBONG, BENGKULU",13,84,144,228
https://kawalpemilu.org#21142,"TALANG BENIH, CURUP, REJANG LEBONG, BENGKULU",14,93,151,244
https://kawalpemilu.org#21142,"TALANG BENIH, CURUP, REJANG LEBONG, BENGKULU",15,92,133,225
https://kawalpemilu.org#21142,"TALANG BENIH, CURUP, REJANG LEBONG, BENGKULU",16,114,142,256
https://kawalpemilu.org#21142,"TALANG BENIH, CURUP, REJANG LEBONG, BENGKULU",17,87,121,208
https://kawalpemilu.org#21143,"TIMBUL REJO, CURUP, REJANG LEBONG, BENGKULU",1,56,131,187
https://kawalpemilu.org#21143,"TIMBUL REJO, CURUP, REJANG LEBONG, BENGKULU",2,68,162,230
https://kawalpemilu.org#21143,"TIMBUL REJO, CURUP, REJANG LEBONG, BENGKULU",3,92,104,196
https://kawalpemilu.org#21143,"TIMBUL REJO, CURUP, REJANG LEBONG, BENGKULU",4,81,161,242
https://kawalpemilu.org#21143,"TIMBUL REJO, CURUP, REJANG LEBONG, BENGKULU",5,55,179,234
https://kawalpemilu.org#21143,"TIMBUL REJO, CURUP, REJANG LEBONG, BENGKULU",6,63,148,211
https://kawalpemilu.org#21143,"TIMBUL REJO, CURUP, REJANG LEBONG, BENGKULU",7,45,101,146
https://kawalpemilu.org#21145,"AIR MUNDU, BERMANI ULU, REJANG LEBONG, BENGKULU",1,145,82,227
https://kawalpemilu.org#21146,"TEBAT TENONG DALAM, BERMANI ULU, REJANG LEBONG, BENGKULU",1,83,95,178
https://kawalpemilu.org#21146,"TEBAT TENONG DALAM, BERMANI ULU, REJANG LEBONG, BENGKULU",2,106,113,219
https://kawalpemilu.org#21146,"TEBAT TENONG DALAM, BERMANI ULU, REJANG LEBONG, BENGKULU",3,119,87,206
https://kawalpemilu.org#21147,"BARU MANIS, BERMANI ULU, REJANG LEBONG, BENGKULU",1,122,79,201
https://kawalpemilu.org#21147,"BARU MANIS, BERMANI ULU, REJANG LEBONG, BENGKULU",2,139,83,222
https://kawalpemilu.org#21147,"BARU MANIS, BERMANI ULU, REJANG LEBONG, BENGKULU",3,123,99,222
https://kawalpemilu.org#21147,"BARU MANIS, BERMANI ULU, REJANG LEBONG, BENGKULU",4,124,102,226
https://kawalpemilu.org#21147,"BARU MANIS, BERMANI ULU, REJANG LEBONG, BENGKULU",5,142,105,247
https://kawalpemilu.org#21147,"BARU MANIS, BERMANI ULU, REJANG LEBONG, BENGKULU",6,148,95,243
https://kawalpemilu.org#21147,"BARU MANIS, BERMANI ULU, REJANG LEBONG, BENGKULU",7,92,77,169
https://kawalpemilu.org#21148,"KAMPUNG MELAYU, BERMANI ULU, REJANG LEBONG, BENGKULU",1,149,82,231
https://kawalpemilu.org#21148,"KAMPUNG MELAYU, BERMANI ULU, REJANG LEBONG, BENGKULU",2,140,86,226
https://kawalpemilu.org#21148,"KAMPUNG MELAYU, BERMANI ULU, REJANG LEBONG, BENGKULU",3,137,108,245
https://kawalpemilu.org#21148,"KAMPUNG MELAYU, BERMANI ULU, REJANG LEBONG, BENGKULU",4,142,78,220
https://kawalpemilu.org#21148,"KAMPUNG MELAYU, BERMANI ULU, REJANG LEBONG, BENGKULU",5,129,93,222
https://kawalpemilu.org#21149,"SENTRAL BARU, BERMANI ULU, REJANG LEBONG, BENGKULU",1,97,118,215
https://kawalpemilu.org#21149,"SENTRAL BARU, BERMANI ULU, REJANG LEBONG, BENGKULU",2,122,80,202
https://kawalpemilu.org#21149,"SENTRAL BARU, BERMANI ULU, REJANG LEBONG, BENGKULU",3,147,87,234
https://kawalpemilu.org#21150,"KAMPUNG SAJAD, BERMANI ULU, REJANG LEBONG, BENGKULU",1,107,59,166
https://kawalpemilu.org#21150,"KAMPUNG SAJAD, BERMANI ULU, REJANG LEBONG, BENGKULU",2,122,53,175
https://kawalpemilu.org#21151,"SUKA RAMI, BERMANI ULU, REJANG LEBONG, BENGKULU",1,133,115,248
https://kawalpemilu.org#21151,"SUKA RAMI, BERMANI ULU, REJANG LEBONG, BENGKULU",2,125,124,249
https://kawalpemilu.org#21151,"SUKA RAMI, BERMANI ULU, REJANG LEBONG, BENGKULU",3,122,132,254
https://kawalpemilu.org#21151,"SUKA RAMI, BERMANI ULU, REJANG LEBONG, BENGKULU",4,110,140,250
https://kawalpemilu.org#21151,"SUKA RAMI, BERMANI ULU, REJANG LEBONG, BENGKULU",5,43,37,80
https://kawalpemilu.org#21152,"PAGAR GUNUNG, BERMANI ULU, REJANG LEBONG, BENGKULU",1,156,50,206
https://kawalpemilu.org#21152,"PAGAR GUNUNG, BERMANI ULU, REJANG LEBONG, BENGKULU",2,152,94,246
https://kawalpemilu.org#21153,"SELAMAT SUDIARJO, BERMANI ULU, REJANG LEBONG, BENGKULU",1,94,69,163
https://kawalpemilu.org#21153,"SELAMAT SUDIARJO, BERMANI ULU, REJANG LEBONG, BENGKULU",2,87,68,155
https://kawalpemilu.org#21154,"PURWODADI, BERMANI ULU, REJANG LEBONG, BENGKULU",1,96,44,140
https://kawalpemilu.org#21154,"PURWODADI, BERMANI ULU, REJANG LEBONG, BENGKULU",2,160,85,245
https://kawalpemilu.org#21155,"AIR PIKAT, BERMANI ULU, REJANG LEBONG, BENGKULU",1,118,102,220
https://kawalpemilu.org#21155,"AIR PIKAT, BERMANI ULU, REJANG LEBONG, BENGKULU",2,114,133,247
https://kawalpemilu.org#21155,"AIR PIKAT, BERMANI ULU, REJANG LEBONG, BENGKULU",3,104,99,203
https://kawalpemilu.org#21155,"AIR PIKAT, BERMANI ULU, REJANG LEBONG, BENGKULU",4,118,103,221
https://kawalpemilu.org#21156,"TEBAT PULAU, BERMANI ULU, REJANG LEBONG, BENGKULU",1,135,98,233
https://kawalpemilu.org#21156,"TEBAT PULAU, BERMANI ULU, REJANG LEBONG, BENGKULU",2,105,79,184
https://kawalpemilu.org#21156,"TEBAT PULAU, BERMANI ULU, REJANG LEBONG, BENGKULU",3,115,63,178
https://kawalpemilu.org#21156,"TEBAT PULAU, BERMANI ULU, REJANG LEBONG, BENGKULU",4,60,47,107
https://kawalpemilu.org#21128,"MOJOREJO, SELUPU REJANG, REJANG LEBONG, BENGKULU",1,108,125,233
https://kawalpemilu.org#21128,"MOJOREJO, SELUPU REJANG, REJANG LEBONG, BENGKULU",2,132,93,225
https://kawalpemilu.org#21128,"MOJOREJO, SELUPU REJANG, REJANG LEBONG, BENGKULU",3,120,82,202
https://kawalpemilu.org#21128,"MOJOREJO, SELUPU REJANG, REJANG LEBONG, BENGKULU",4,124,108,232
https://kawalpemilu.org#21128,"MOJOREJO, SELUPU REJANG, REJANG LEBONG, BENGKULU",5,108,124,232
https://kawalpemilu.org#21128,"MOJOREJO, SELUPU REJANG, REJANG LEBONG, BENGKULU",6,134,94,228
https://kawalpemilu.org#21131,"TALANG LAHAT, SELUPU REJANG, REJANG LEBONG, BENGKULU",1,90,153,243
https://kawalpemilu.org#21158,"AIR DUKU, SELUPU REJANG, REJANG LEBONG, BENGKULU",1,139,104,243
https://kawalpemilu.org#21158,"AIR DUKU, SELUPU REJANG, REJANG LEBONG, BENGKULU",2,104,123,227
https://kawalpemilu.org#21158,"AIR DUKU, SELUPU REJANG, REJANG LEBONG, BENGKULU",3,100,153,253
https://kawalpemilu.org#21158,"AIR DUKU, SELUPU REJANG, REJANG LEBONG, BENGKULU",4,74,59,133
https://kawalpemilu.org#21158,"AIR DUKU, SELUPU REJANG, REJANG LEBONG, BENGKULU",5,122,121,243
https://kawalpemilu.org#21158,"AIR DUKU, SELUPU REJANG, REJANG LEBONG, BENGKULU",6,87,79,166
https://kawalpemilu.org#21158,"AIR DUKU, SELUPU REJANG, REJANG LEBONG, BENGKULU",7,94,83,177
https://kawalpemilu.org#21158,"AIR DUKU, SELUPU REJANG, REJANG LEBONG, BENGKULU",8,122,94,216
https://kawalpemilu.org#21158,"AIR DUKU, SELUPU REJANG, REJANG LEBONG, BENGKULU",9,62,47,109
https://kawalpemilu.org#21159,"AIR PUTIH KALI BANDUNG, SELUPU REJANG, REJANG LEBONG, BENGKULU",1,58,109,167
https://kawalpemilu.org#21159,"AIR PUTIH KALI BANDUNG, SELUPU REJANG, REJANG LEBONG, BENGKULU",2,64,80,144
https://kawalpemilu.org#21159,"AIR PUTIH KALI BANDUNG, SELUPU REJANG, REJANG LEBONG, BENGKULU",3,73,86,159
https://kawalpemilu.org#21159,"AIR PUTIH KALI BANDUNG, SELUPU REJANG, REJANG LEBONG, BENGKULU",4,124,66,190
https://kawalpemilu.org#21160,"AIR MELES ATAS, SELUPU REJANG, REJANG LEBONG, BENGKULU",1,159,61,220
https://kawalpemilu.org#21160,"AIR MELES ATAS, SELUPU REJANG, REJANG LEBONG, BENGKULU",2,90,84,174
https://kawalpemilu.org#21160,"AIR MELES ATAS, SELUPU REJANG, REJANG LEBONG, BENGKULU",3,88,71,159
https://kawalpemilu.org#21160,"AIR MELES ATAS, SELUPU REJANG, REJANG LEBONG, BENGKULU",4,78,127,205
https://kawalpemilu.org#21160,"AIR MELES ATAS, SELUPU REJANG, REJANG LEBONG, BENGKULU",5,121,73,194
https://kawalpemilu.org#21160,"AIR MELES ATAS, SELUPU REJANG, REJANG LEBONG, BENGKULU",6,111,124,235
https://kawalpemilu.org#21160,"AIR MELES ATAS, SELUPU REJANG, REJANG LEBONG, BENGKULU",7,94,84,178
https://kawalpemilu.org#21160,"AIR MELES ATAS, SELUPU REJANG, REJANG LEBONG, BENGKULU",8,57,88,145
https://kawalpemilu.org#21161,"SAMBIREJO, SELUPU REJANG, REJANG LEBONG, BENGKULU",1,103,114,217
https://kawalpemilu.org#21161,"SAMBIREJO, SELUPU REJANG, REJANG LEBONG, BENGKULU",2,144,108,252
https://kawalpemilu.org#21161,"SAMBIREJO, SELUPU REJANG, REJANG LEBONG, BENGKULU",3,118,62,180
https://kawalpemilu.org#21161,"SAMBIREJO, SELUPU REJANG, REJANG LEBONG, BENGKULU",4,118,103,221
https://kawalpemilu.org#21161,"SAMBIREJO, SELUPU REJANG, REJANG LEBONG, BENGKULU",5,79,117,196
https://kawalpemilu.org#21161,"SAMBIREJO, SELUPU REJANG, REJANG LEBONG, BENGKULU",6,114,138,252
https://kawalpemilu.org#21161,"SAMBIREJO, SELUPU REJANG, REJANG LEBONG, BENGKULU",7,119,117,236
https://kawalpemilu.org#21161,"SAMBIREJO, SELUPU REJANG, REJANG LEBONG, BENGKULU",8,126,95,221
https://kawalpemilu.org#21161,"SAMBIREJO, SELUPU REJANG, REJANG LEBONG, BENGKULU",9,131,93,224
https://kawalpemilu.org#21161,"SAMBIREJO, SELUPU REJANG, REJANG LEBONG, BENGKULU",10,102,113,215
https://kawalpemilu.org#21162,"SUBAN AYAM, SELUPU REJANG, REJANG LEBONG, BENGKULU",1,138,120,258
https://kawalpemilu.org#21162,"SUBAN AYAM, SELUPU REJANG, REJANG LEBONG, BENGKULU",2,97,112,209
https://kawalpemilu.org#21162,"SUBAN AYAM, SELUPU REJANG, REJANG LEBONG, BENGKULU",3,133,123,256
https://kawalpemilu.org#21162,"SUBAN AYAM, SELUPU REJANG, REJANG LEBONG, BENGKULU",4,146,108,254
https://kawalpemilu.org#21162,"SUBAN AYAM, SELUPU REJANG, REJANG LEBONG, BENGKULU",5,95,150,245
https://kawalpemilu.org#21162,"SUBAN AYAM, SELUPU REJANG, REJANG LEBONG, BENGKULU",6,131,119,250
https://kawalpemilu.org#21162,"SUBAN AYAM, SELUPU REJANG, REJANG LEBONG, BENGKULU",7,89,78,167
https://kawalpemilu.org#21163,"CAWANG BARU, SELUPU REJANG, REJANG LEBONG, BENGKULU",1,93,132,225
https://kawalpemilu.org#21163,"CAWANG BARU, SELUPU REJANG, REJANG LEBONG, BENGKULU",2,68,121,189
https://kawalpemilu.org#21163,"CAWANG BARU, SELUPU REJANG, REJANG LEBONG, BENGKULU",3,68,146,214
https://kawalpemilu.org#21163,"CAWANG BARU, SELUPU REJANG, REJANG LEBONG, BENGKULU",4,108,74,182
https://kawalpemilu.org#21163,"CAWANG BARU, SELUPU REJANG, REJANG LEBONG, BENGKULU",5,71,142,213
https://kawalpemilu.org#21164,"CAWANG LAMA, SELUPU REJANG, REJANG LEBONG, BENGKULU",1,127,79,206
https://kawalpemilu.org#21164,"CAWANG LAMA, SELUPU REJANG, REJANG LEBONG, BENGKULU",2,84,83,167
https://kawalpemilu.org#21164,"CAWANG LAMA, SELUPU REJANG, REJANG LEBONG, BENGKULU",3,113,66,179
https://kawalpemilu.org#21164,"CAWANG LAMA, SELUPU REJANG, REJANG LEBONG, BENGKULU",4,108,74,182
https://kawalpemilu.org#21165,"SIMPANG NANGKA, SELUPU REJANG, REJANG LEBONG, BENGKULU",1,122,87,209
https://kawalpemilu.org#21165,"SIMPANG NANGKA, SELUPU REJANG, REJANG LEBONG, BENGKULU",2,118,79,197
https://kawalpemilu.org#21165,"SIMPANG NANGKA, SELUPU REJANG, REJANG LEBONG, BENGKULU",3,112,79,191
https://kawalpemilu.org#21165,"SIMPANG NANGKA, SELUPU REJANG, REJANG LEBONG, BENGKULU",4,93,99,192
https://kawalpemilu.org#21165,"SIMPANG NANGKA, SELUPU REJANG, REJANG LEBONG, BENGKULU",5,92,97,189
https://kawalpemilu.org#21166,"SUMBER URIP, SELUPU REJANG, REJANG LEBONG, BENGKULU",1,172,74,246
https://kawalpemilu.org#21166,"SUMBER URIP, SELUPU REJANG, REJANG LEBONG, BENGKULU",2,143,62,205
https://kawalpemilu.org#21166,"SUMBER URIP, SELUPU REJANG, REJANG LEBONG, BENGKULU",3,154,84,238
https://kawalpemilu.org#21166,"SUMBER URIP, SELUPU REJANG, REJANG LEBONG, BENGKULU",4,105,69,174
https://kawalpemilu.org#21166,"SUMBER URIP, SELUPU REJANG, REJANG LEBONG, BENGKULU",5,120,100,220
https://kawalpemilu.org#21166,"SUMBER URIP, SELUPU REJANG, REJANG LEBONG, BENGKULU",6,162,64,226
https://kawalpemilu.org#21166,"SUMBER URIP, SELUPU REJANG, REJANG LEBONG, BENGKULU",7,137,90,227
https://kawalpemilu.org#21167,"SUMBER BENING, SELUPU REJANG, REJANG LEBONG, BENGKULU",1,67,146,213
https://kawalpemilu.org#21167,"SUMBER BENING, SELUPU REJANG, REJANG LEBONG, BENGKULU",2,94,108,202
https://kawalpemilu.org#21167,"SUMBER BENING, SELUPU REJANG, REJANG LEBONG, BENGKULU",3,110,136,246
https://kawalpemilu.org#21167,"SUMBER BENING, SELUPU REJANG, REJANG LEBONG, BENGKULU",4,168,81,249
https://kawalpemilu.org#21167,"SUMBER BENING, SELUPU REJANG, REJANG LEBONG, BENGKULU",5,118,114,232
https://kawalpemilu.org#21167,"SUMBER BENING, SELUPU REJANG, REJANG LEBONG, BENGKULU",6,151,56,207
https://kawalpemilu.org#21167,"SUMBER BENING, SELUPU REJANG, REJANG LEBONG, BENGKULU",7,83,124,207
https://kawalpemilu.org#21167,"SUMBER BENING, SELUPU REJANG, REJANG LEBONG, BENGKULU",8,85,96,181
https://kawalpemilu.org#21167,"SUMBER BENING, SELUPU REJANG, REJANG LEBONG, BENGKULU",9,82,84,166
https://kawalpemilu.org#21167,"SUMBER BENING, SELUPU REJANG, REJANG LEBONG, BENGKULU",10,135,57,192
https://kawalpemilu.org#21167,"SUMBER BENING, SELUPU REJANG, REJANG LEBONG, BENGKULU",11,97,69,166
https://kawalpemilu.org#21167,"SUMBER BENING, SELUPU REJANG, REJANG LEBONG, BENGKULU",12,94,107,201
https://kawalpemilu.org#21167,"SUMBER BENING, SELUPU REJANG, REJANG LEBONG, BENGKULU",13,91,55,146
https://kawalpemilu.org#21168,"KARANG JAYA, SELUPU REJANG, REJANG LEBONG, BENGKULU",1,182,71,253
https://kawalpemilu.org#21168,"KARANG JAYA, SELUPU REJANG, REJANG LEBONG, BENGKULU",2,133,100,233
https://kawalpemilu.org#21168,"KARANG JAYA, SELUPU REJANG, REJANG LEBONG, BENGKULU",3,132,60,192
https://kawalpemilu.org#21168,"KARANG JAYA, SELUPU REJANG, REJANG LEBONG, BENGKULU",4,102,58,160
https://kawalpemilu.org#21168,"KARANG JAYA, SELUPU REJANG, REJANG LEBONG, BENGKULU",5,140,105,245
https://kawalpemilu.org#21168,"KARANG JAYA, SELUPU REJANG, REJANG LEBONG, BENGKULU",6,154,90,244
https://kawalpemilu.org#21168,"KARANG JAYA, SELUPU REJANG, REJANG LEBONG, BENGKULU",7,79,61,140
https://kawalpemilu.org#21168,"KARANG JAYA, SELUPU REJANG, REJANG LEBONG, BENGKULU",8,150,104,254
https://kawalpemilu.org#21169,"KAYU MANIS, SELUPU REJANG, REJANG LEBONG, BENGKULU",1,179,53,232
https://kawalpemilu.org#21169,"KAYU MANIS, SELUPU REJANG, REJANG LEBONG, BENGKULU",2,180,54,234
https://kawalpemilu.org#21169,"KAYU MANIS, SELUPU REJANG, REJANG LEBONG, BENGKULU",3,94,39,133
https://kawalpemilu.org#21170,"KAMPUNG BARU, SELUPU REJANG, REJANG LEBONG, BENGKULU",1,118,87,205
https://kawalpemilu.org#21170,"KAMPUNG BARU, SELUPU REJANG, REJANG LEBONG, BENGKULU",2,96,144,240
https://kawalpemilu.org#21170,"KAMPUNG BARU, SELUPU REJANG, REJANG LEBONG, BENGKULU",3,118,102,220
https://kawalpemilu.org#21170,"KAMPUNG BARU, SELUPU REJANG, REJANG LEBONG, BENGKULU",4,126,111,237
https://kawalpemilu.org#21170,"KAMPUNG BARU, SELUPU REJANG, REJANG LEBONG, BENGKULU",5,117,80,197
https://kawalpemilu.org#21170,"KAMPUNG BARU, SELUPU REJANG, REJANG LEBONG, BENGKULU",6,104,133,237
https://kawalpemilu.org#21170,"KAMPUNG BARU, SELUPU REJANG, REJANG LEBONG, BENGKULU",7,124,106,230
https://kawalpemilu.org#21170,"KAMPUNG BARU, SELUPU REJANG, REJANG LEBONG, BENGKULU",8,63,58,121
https://kawalpemilu.org#21171,"KALI PADANG, SELUPU REJANG, REJANG LEBONG, BENGKULU",1,61,133,194
https://kawalpemilu.org#21171,"KALI PADANG, SELUPU REJANG, REJANG LEBONG, BENGKULU",2,94,108,202
https://kawalpemilu.org#21171,"KALI PADANG, SELUPU REJANG, REJANG LEBONG, BENGKULU",3,72,123,195
https://kawalpemilu.org#21173,"DUSUN CURUP, CURUP UTARA, REJANG LEBONG, BENGKULU",1,52,139,191
https://kawalpemilu.org#21173,"DUSUN CURUP, CURUP UTARA, REJANG LEBONG, BENGKULU",2,48,156,204
https://kawalpemilu.org#21173,"DUSUN CURUP, CURUP UTARA, REJANG LEBONG, BENGKULU",3,51,150,201
https://kawalpemilu.org#21173,"DUSUN CURUP, CURUP UTARA, REJANG LEBONG, BENGKULU",4,58,143,201
https://kawalpemilu.org#21173,"DUSUN CURUP, CURUP UTARA, REJANG LEBONG, BENGKULU",5,66,116,182
https://kawalpemilu.org#21173,"DUSUN CURUP, CURUP UTARA, REJANG LEBONG, BENGKULU",6,37,99,136
https://kawalpemilu.org#21174,"TUNAS HARAPAN, CURUP UTARA, REJANG LEBONG, BENGKULU",1,68,157,225
https://kawalpemilu.org#21174,"TUNAS HARAPAN, CURUP UTARA, REJANG LEBONG, BENGKULU",2,87,136,223
https://kawalpemilu.org#21174,"TUNAS HARAPAN, CURUP UTARA, REJANG LEBONG, BENGKULU",3,71,124,195
https://kawalpemilu.org#21174,"TUNAS HARAPAN, CURUP UTARA, REJANG LEBONG, BENGKULU",4,77,159,236
https://kawalpemilu.org#21174,"TUNAS HARAPAN, CURUP UTARA, REJANG LEBONG, BENGKULU",5,64,124,188
https://kawalpemilu.org#21174,"TUNAS HARAPAN, CURUP UTARA, REJANG LEBONG, BENGKULU",6,62,109,171
https://kawalpemilu.org#21175,"BATU DEWA, CURUP UTARA, REJANG LEBONG, BENGKULU",1,65,131,196
https://kawalpemilu.org#21175,"BATU DEWA, CURUP UTARA, REJANG LEBONG, BENGKULU",2,81,125,206
https://kawalpemilu.org#21175,"BATU DEWA, CURUP UTARA, REJANG LEBONG, BENGKULU",3,126,94,220
https://kawalpemilu.org#21176,"PERBO, CURUP UTARA, REJANG LEBONG, BENGKULU",1,78,112,190
https://kawalpemilu.org#21176,"PERBO, CURUP UTARA, REJANG LEBONG, BENGKULU",2,63,120,183
https://kawalpemilu.org#21176,"PERBO, CURUP UTARA, REJANG LEBONG, BENGKULU",3,54,139,193
https://kawalpemilu.org#21177,"BATU PANCO, CURUP UTARA, REJANG LEBONG, BENGKULU",1,114,123,241
https://kawalpemilu.org#21177,"BATU PANCO, CURUP UTARA, REJANG LEBONG, BENGKULU",2,138,108,246
https://kawalpemilu.org#21177,"BATU PANCO, CURUP UTARA, REJANG LEBONG, BENGKULU",3,105,138,243
https://kawalpemilu.org#21177,"BATU PANCO, CURUP UTARA, REJANG LEBONG, BENGKULU",4,63,140,203
https://kawalpemilu.org#21178,"DUSUN SAWAH, CURUP UTARA, REJANG LEBONG, BENGKULU",1,62,70,132
https://kawalpemilu.org#21178,"DUSUN SAWAH, CURUP UTARA, REJANG LEBONG, BENGKULU",2,70,100,170
https://kawalpemilu.org#21178,"DUSUN SAWAH, CURUP UTARA, REJANG LEBONG, BENGKULU",3,87,79,166
https://kawalpemilu.org#21178,"DUSUN SAWAH, CURUP UTARA, REJANG LEBONG, BENGKULU",4,115,69,184
https://kawalpemilu.org#21178,"DUSUN SAWAH, CURUP UTARA, REJANG LEBONG, BENGKULU",5,60,69,129
https://kawalpemilu.org#21178,"DUSUN SAWAH, CURUP UTARA, REJANG LEBONG, BENGKULU",6,68,80,148
https://kawalpemilu.org#21178,"DUSUN SAWAH, CURUP UTARA, REJANG LEBONG, BENGKULU",7,46,39,85
https://kawalpemilu.org#21179,"LUBUK KEMBANG, CURUP UTARA, REJANG LEBONG, BENGKULU",1,54,163,217
https://kawalpemilu.org#21179,"LUBUK KEMBANG, CURUP UTARA, REJANG LEBONG, BENGKULU",2,95,105,200
https://kawalpemilu.org#21179,"LUBUK KEMBANG, CURUP UTARA, REJANG LEBONG, BENGKULU",3,56,137,193
https://kawalpemilu.org#21179,"LUBUK KEMBANG, CURUP UTARA, REJANG LEBONG, BENGKULU",4,83,122,205
https://kawalpemilu.org#21180,"SUKA DATANG, CURUP UTARA, REJANG LEBONG, BENGKULU",1,117,104,221
https://kawalpemilu.org#21180,"SUKA DATANG, CURUP UTARA, REJANG LEBONG, BENGKULU",2,110,92,202
https://kawalpemilu.org#21180,"SUKA DATANG, CURUP UTARA, REJANG LEBONG, BENGKULU",3,93,85,178
https://kawalpemilu.org#21181,"TABARENAH, CURUP UTARA, REJANG LEBONG, BENGKULU",1,135,128,263
https://kawalpemilu.org#21181,"TABARENAH, CURUP UTARA, REJANG LEBONG, BENGKULU",2,145,118,263
https://kawalpemilu.org#21181,"TABARENAH, CURUP UTARA, REJANG LEBONG, BENGKULU",3,98,62,160
https://kawalpemilu.org#21182,"PAHLAWAN, CURUP UTARA, REJANG LEBONG, BENGKULU",1,72,124,196
https://kawalpemilu.org#21182,"PAHLAWAN, CURUP UTARA, REJANG LEBONG, BENGKULU",2,74,113,187
https://kawalpemilu.org#21182,"PAHLAWAN, CURUP UTARA, REJANG LEBONG, BENGKULU",3,73,99,172
https://kawalpemilu.org#21183,"TASIK MALAYA, CURUP UTARA, REJANG LEBONG, BENGKULU",1,141,97,238
https://kawalpemilu.org#21183,"TASIK MALAYA, CURUP UTARA, REJANG LEBONG, BENGKULU",2,89,124,213
https://kawalpemilu.org#21183,"TASIK MALAYA, CURUP UTARA, REJANG LEBONG, BENGKULU",3,149,81,230
https://kawalpemilu.org#21183,"TASIK MALAYA, CURUP UTARA, REJANG LEBONG, BENGKULU",4,104,89,193
https://kawalpemilu.org#21184,"TANJUNG BERINGIN, CURUP UTARA, REJANG LEBONG, BENGKULU",1,114,110,224
https://kawalpemilu.org#21184,"TANJUNG BERINGIN, CURUP UTARA, REJANG LEBONG, BENGKULU",2,89,156,245
https://kawalpemilu.org#21184,"TANJUNG BERINGIN, CURUP UTARA, REJANG LEBONG, BENGKULU",3,95,130,225
https://kawalpemilu.org#21185,"KOTA PAGU, CURUP UTARA, REJANG LEBONG, BENGKULU",1,86,86,172
https://kawalpemilu.org#21185,"KOTA PAGU, CURUP UTARA, REJANG LEBONG, BENGKULU",2,107,57,164
https://kawalpemilu.org#21185,"KOTA PAGU, CURUP UTARA, REJANG LEBONG, BENGKULU",3,119,118,237
https://kawalpemilu.org#21186,"SEGURING, CURUP UTARA, REJANG LEBONG, BENGKULU",1,133,101,234
https://kawalpemilu.org#21186,"SEGURING, CURUP UTARA, REJANG LEBONG, BENGKULU",2,121,134,255
https://kawalpemilu.org#21186,"SEGURING, CURUP UTARA, REJANG LEBONG, BENGKULU",3,67,41,108
https://kawalpemilu.org#21188,"SUKARAJA, CURUP TIMUR, REJANG LEBONG, BENGKULU",1,103,121,224
https://kawalpemilu.org#21188,"SUKARAJA, CURUP TIMUR, REJANG LEBONG, BENGKULU",2,68,130,198
https://kawalpemilu.org#21188,"SUKARAJA, CURUP TIMUR, REJANG LEBONG, BENGKULU",3,85,135,220
https://kawalpemilu.org#21188,"SUKARAJA, CURUP TIMUR, REJANG LEBONG, BENGKULU",4,57,139,196
https://kawalpemilu.org#21188,"SUKARAJA, CURUP TIMUR, REJANG LEBONG, BENGKULU",5,99,140,239
https://kawalpemilu.org#21188,"SUKARAJA, CURUP TIMUR, REJANG LEBONG, BENGKULU",6,61,141,202
https://kawalpemilu.org#21188,"SUKARAJA, CURUP TIMUR, REJANG LEBONG, BENGKULU",7,107,105,212
https://kawalpemilu.org#21188,"SUKARAJA, CURUP TIMUR, REJANG LEBONG, BENGKULU",8,75,127,202
https://kawalpemilu.org#21189,"KESAMBE BARU, CURUP TIMUR, REJANG LEBONG, BENGKULU",1,64,129,193
https://kawalpemilu.org#21189,"KESAMBE BARU, CURUP TIMUR, REJANG LEBONG, BENGKULU",2,88,109,197
https://kawalpemilu.org#21189,"KESAMBE BARU, CURUP TIMUR, REJANG LEBONG, BENGKULU",3,93,126,219
https://kawalpemilu.org#21189,"KESAMBE BARU, CURUP TIMUR, REJANG LEBONG, BENGKULU",4,61,82,143
https://kawalpemilu.org#21189,"KESAMBE BARU, CURUP TIMUR, REJANG LEBONG, BENGKULU",5,60,94,154
https://kawalpemilu.org#21189,"KESAMBE BARU, CURUP TIMUR, REJANG LEBONG, BENGKULU",6,60,146,206
https://kawalpemilu.org#21189,"KESAMBE BARU, CURUP TIMUR, REJANG LEBONG, BENGKULU",7,52,113,165
https://kawalpemilu.org#21189,"KESAMBE BARU, CURUP TIMUR, REJANG LEBONG, BENGKULU",8,65,111,176
https://kawalpemilu.org#21190,"KARANG ANYAR, CURUP TIMUR, REJANG LEBONG, BENGKULU",1,91,142,233
https://kawalpemilu.org#21190,"KARANG ANYAR, CURUP TIMUR, REJANG LEBONG, BENGKULU",2,60,113,173
https://kawalpemilu.org#21190,"KARANG ANYAR, CURUP TIMUR, REJANG LEBONG, BENGKULU",3,62,86,148
https://kawalpemilu.org#21190,"KARANG ANYAR, CURUP TIMUR, REJANG LEBONG, BENGKULU",4,103,120,223
https://kawalpemilu.org#21190,"KARANG ANYAR, CURUP TIMUR, REJANG LEBONG, BENGKULU",5,53,160,213
https://kawalpemilu.org#21190,"KARANG ANYAR, CURUP TIMUR, REJANG LEBONG, BENGKULU",6,52,156,208
https://kawalpemilu.org#21190,"KARANG ANYAR, CURUP TIMUR, REJANG LEBONG, BENGKULU",7,76,139,215
https://kawalpemilu.org#21190,"KARANG ANYAR, CURUP TIMUR, REJANG LEBONG, BENGKULU",8,61,103,164
https://kawalpemilu.org#21190,"KARANG ANYAR, CURUP TIMUR, REJANG LEBONG, BENGKULU",9,54,88,142
https://kawalpemilu.org#21190,"KARANG ANYAR, CURUP TIMUR, REJANG LEBONG, BENGKULU",10,56,103,159
https://kawalpemilu.org#21190,"KARANG ANYAR, CURUP TIMUR, REJANG LEBONG, BENGKULU",11,55,136,191
https://kawalpemilu.org#21190,"KARANG ANYAR, CURUP TIMUR, REJANG LEBONG, BENGKULU",12,67,151,218
https://kawalpemilu.org#21190,"KARANG ANYAR, CURUP TIMUR, REJANG LEBONG, BENGKULU",13,55,132,187
https://kawalpemilu.org#21190,"KARANG ANYAR, CURUP TIMUR, REJANG LEBONG, BENGKULU",14,69,102,171
https://kawalpemilu.org#21190,"KARANG ANYAR, CURUP TIMUR, REJANG LEBONG, BENGKULU",15,58,86,138
https://kawalpemilu.org#21191,"TALANG ULU, CURUP TIMUR, REJANG LEBONG, BENGKULU",1,96,120,216
https://kawalpemilu.org#21191,"TALANG ULU, CURUP TIMUR, REJANG LEBONG, BENGKULU",2,92,161,253
https://kawalpemilu.org#21191,"TALANG ULU, CURUP TIMUR, REJANG LEBONG, BENGKULU",3,94,78,172
https://kawalpemilu.org#21191,"TALANG ULU, CURUP TIMUR, REJANG LEBONG, BENGKULU",4,91,120,211
https://kawalpemilu.org#21191,"TALANG ULU, CURUP TIMUR, REJANG LEBONG, BENGKULU",5,82,155,237
https://kawalpemilu.org#21191,"TALANG ULU, CURUP TIMUR, REJANG LEBONG, BENGKULU",6,121,111,232
https://kawalpemilu.org#21191,"TALANG ULU, CURUP TIMUR, REJANG LEBONG, BENGKULU",7,85,152,237
https://kawalpemilu.org#21191,"TALANG ULU, CURUP TIMUR, REJANG LEBONG, BENGKULU",8,109,89,198
https://kawalpemilu.org#21192,"DUKU ULU, CURUP TIMUR, REJANG LEBONG, BENGKULU",1,119,86,205
https://kawalpemilu.org#21192,"DUKU ULU, CURUP TIMUR, REJANG LEBONG, BENGKULU",2,80,98,178
https://kawalpemilu.org#21192,"DUKU ULU, CURUP TIMUR, REJANG LEBONG, BENGKULU",3,78,118,196
https://kawalpemilu.org#21192,"DUKU ULU, CURUP TIMUR, REJANG LEBONG, BENGKULU",4,106,95,201
https://kawalpemilu.org#21193,"DUKU ILIR, CURUP TIMUR, REJANG LEBONG, BENGKULU",1,44,152,196
https://kawalpemilu.org#21193,"DUKU ILIR, CURUP TIMUR, REJANG LEBONG, BENGKULU",2,85,155,240
https://kawalpemilu.org#21193,"DUKU ILIR, CURUP TIMUR, REJANG LEBONG, BENGKULU",3,56,96,152
https://kawalpemilu.org#21194,"AIR MELES BAWAH, CURUP TIMUR, REJANG LEBONG, BENGKULU",1,98,104,202
https://kawalpemilu.org#21194,"AIR MELES BAWAH, CURUP TIMUR, REJANG LEBONG, BENGKULU",2,116,104,220
https://kawalpemilu.org#21194,"AIR MELES BAWAH, CURUP TIMUR, REJANG LEBONG, BENGKULU",3,72,85,157
https://kawalpemilu.org#21194,"AIR MELES BAWAH, CURUP TIMUR, REJANG LEBONG, BENGKULU",4,75,122,197
https://kawalpemilu.org#21194,"AIR MELES BAWAH, CURUP TIMUR, REJANG LEBONG, BENGKULU",5,70,132,202
https://kawalpemilu.org#21194,"AIR MELES BAWAH, CURUP TIMUR, REJANG LEBONG, BENGKULU",6,110,85,195
https://kawalpemilu.org#21194,"AIR MELES BAWAH, CURUP TIMUR, REJANG LEBONG, BENGKULU",7,123,99,222
https://kawalpemilu.org#21194,"AIR MELES BAWAH, CURUP TIMUR, REJANG LEBONG, BENGKULU",8,66,124,190
https://kawalpemilu.org#21194,"AIR MELES BAWAH, CURUP TIMUR, REJANG LEBONG, BENGKULU",9,64,159,223
https://kawalpemilu.org#21194,"AIR MELES BAWAH, CURUP TIMUR, REJANG LEBONG, BENGKULU",10,81,129,210
https://kawalpemilu.org#21194,"AIR MELES BAWAH, CURUP TIMUR, REJANG LEBONG, BENGKULU",11,72,137,209
https://kawalpemilu.org#21194,"AIR MELES BAWAH, CURUP TIMUR, REJANG LEBONG, BENGKULU",12,92,104,196
https://kawalpemilu.org#21194,"AIR MELES BAWAH, CURUP TIMUR, REJANG LEBONG, BENGKULU",13,54,80,134
https://kawalpemilu.org#21194,"AIR MELES BAWAH, CURUP TIMUR, REJANG LEBONG, BENGKULU",14,86,104,190
https://kawalpemilu.org#21195,"KAMPUNG DELIMA, CURUP TIMUR, REJANG LEBONG, BENGKULU",1,108,116,224
https://kawalpemilu.org#21195,"KAMPUNG DELIMA, CURUP TIMUR, REJANG LEBONG, BENGKULU",2,120,103,223
https://kawalpemilu.org#21195,"KAMPUNG DELIMA, CURUP TIMUR, REJANG LEBONG, BENGKULU",3,108,119,227
https://kawalpemilu.org#21195,"KAMPUNG DELIMA, CURUP TIMUR, REJANG LEBONG, BENGKULU",4,107,115,222
https://kawalpemilu.org#21195,"KAMPUNG DELIMA, CURUP TIMUR, REJANG LEBONG, BENGKULU",5,102,123,225
https://kawalpemilu.org#21196,"KESAMBE LAMA, CURUP TIMUR, REJANG LEBONG, BENGKULU",1,81,157,238
https://kawalpemilu.org#21196,"KESAMBE LAMA, CURUP TIMUR, REJANG LEBONG, BENGKULU",2,79,164,243
https://kawalpemilu.org#21196,"KESAMBE LAMA, CURUP TIMUR, REJANG LEBONG, BENGKULU",3,70,149,219
https://kawalpemilu.org#21196,"KESAMBE LAMA, CURUP TIMUR, REJANG LEBONG, BENGKULU",4,77,151,228
https://kawalpemilu.org#21196,"KESAMBE LAMA, CURUP TIMUR, REJANG LEBONG, BENGKULU",5,84,144,228
https://kawalpemilu.org#21198,"AIR PUTIH BARU, CURUP SELATAN, REJANG LEBONG, BENGKULU",1,67,182,249
https://kawalpemilu.org#21198,"AIR PUTIH BARU, CURUP SELATAN, REJANG LEBONG, BENGKULU",2,38,179,217
https://kawalpemilu.org#21198,"AIR PUTIH BARU, CURUP SELATAN, REJANG LEBONG, BENGKULU",3,79,156,235
https://kawalpemilu.org#21198,"AIR PUTIH BARU, CURUP SELATAN, REJANG LEBONG, BENGKULU",4,57,157,214
https://kawalpemilu.org#21198,"AIR PUTIH BARU, CURUP SELATAN, REJANG LEBONG, BENGKULU",5,79,130,209
https://kawalpemilu.org#21198,"AIR PUTIH BARU, CURUP SELATAN, REJANG LEBONG, BENGKULU",6,51,149,200
https://kawalpemilu.org#21198,"AIR PUTIH BARU, CURUP SELATAN, REJANG LEBONG, BENGKULU",7,47,104,151
https://kawalpemilu.org#21198,"AIR PUTIH BARU, CURUP SELATAN, REJANG LEBONG, BENGKULU",8,52,156,208
https://kawalpemilu.org#21198,"AIR PUTIH BARU, CURUP SELATAN, REJANG LEBONG, BENGKULU",9,111,152,263
https://kawalpemilu.org#21198,"AIR PUTIH BARU, CURUP SELATAN, REJANG LEBONG, BENGKULU",10,65,157,222
https://kawalpemilu.org#21199,"TEMPEL REJO, CURUP SELATAN, REJANG LEBONG, BENGKULU",1,67,126,193
https://kawalpemilu.org#21199,"TEMPEL REJO, CURUP SELATAN, REJANG LEBONG, BENGKULU",2,89,117,206
https://kawalpemilu.org#21199,"TEMPEL REJO, CURUP SELATAN, REJANG LEBONG, BENGKULU",3,83,156,239
https://kawalpemilu.org#21199,"TEMPEL REJO, CURUP SELATAN, REJANG LEBONG, BENGKULU",4,92,138,230
https://kawalpemilu.org#21199,"TEMPEL REJO, CURUP SELATAN, REJANG LEBONG, BENGKULU",5,49,127,176
https://kawalpemilu.org#21199,"TEMPEL REJO, CURUP SELATAN, REJANG LEBONG, BENGKULU",6,91,138,229
https://kawalpemilu.org#21199,"TEMPEL REJO, CURUP SELATAN, REJANG LEBONG, BENGKULU",7,54,175,229
https://kawalpemilu.org#21199,"TEMPEL REJO, CURUP SELATAN, REJANG LEBONG, BENGKULU",8,87,136,223
https://kawalpemilu.org#21199,"TEMPEL REJO, CURUP SELATAN, REJANG LEBONG, BENGKULU",9,77,167,244
https://kawalpemilu.org#21199,"TEMPEL REJO, CURUP SELATAN, REJANG LEBONG, BENGKULU",10,64,139,203
https://kawalpemilu.org#21199,"TEMPEL REJO, CURUP SELATAN, REJANG LEBONG, BENGKULU",11,52,163,215
https://kawalpemilu.org#21199,"TEMPEL REJO, CURUP SELATAN, REJANG LEBONG, BENGKULU",12,71,191,262
https://kawalpemilu.org#21199,"TEMPEL REJO, CURUP SELATAN, REJANG LEBONG, BENGKULU",13,97,155,252
https://kawalpemilu.org#21199,"TEMPEL REJO, CURUP SELATAN, REJANG LEBONG, BENGKULU",14,72,141,213
https://kawalpemilu.org#21200,"RIMBO RECAP, CURUP SELATAN, REJANG LEBONG, BENGKULU",1,77,158,235
https://kawalpemilu.org#21200,"RIMBO RECAP, CURUP SELATAN, REJANG LEBONG, BENGKULU",2,84,132,216
https://kawalpemilu.org#21200,"RIMBO RECAP, CURUP SELATAN, REJANG LEBONG, BENGKULU",3,73,133,206
https://kawalpemilu.org#21200,"RIMBO RECAP, CURUP SELATAN, REJANG LEBONG, BENGKULU",4,78,131,209
https://kawalpemilu.org#21201,"WATAS MARGA, CURUP SELATAN, REJANG LEBONG, BENGKULU",1,53,94,147
https://kawalpemilu.org#21201,"WATAS MARGA, CURUP SELATAN, REJANG LEBONG, BENGKULU",2,88,122,210
https://kawalpemilu.org#21201,"WATAS MARGA, CURUP SELATAN, REJANG LEBONG, BENGKULU",3,27,110,137
https://kawalpemilu.org#21201,"WATAS MARGA, CURUP SELATAN, REJANG LEBONG, BENGKULU",4,33,94,127
https://kawalpemilu.org#21202,"TELADAN, CURUP SELATAN, REJANG LEBONG, BENGKULU",1,56,146,202
https://kawalpemilu.org#21202,"TELADAN, CURUP SELATAN, REJANG LEBONG, BENGKULU",2,40,180,220
https://kawalpemilu.org#21202,"TELADAN, CURUP SELATAN, REJANG LEBONG, BENGKULU",3,60,163,223
https://kawalpemilu.org#21202,"TELADAN, CURUP SELATAN, REJANG LEBONG, BENGKULU",4,32,189,221
https://kawalpemilu.org#21202,"TELADAN, CURUP SELATAN, REJANG LEBONG, BENGKULU",5,30,167,197
https://kawalpemilu.org#21202,"TELADAN, CURUP SELATAN, REJANG LEBONG, BENGKULU",6,90,151,241
https://kawalpemilu.org#21202,"TELADAN, CURUP SELATAN, REJANG LEBONG, BENGKULU",7,55,155,210
https://kawalpemilu.org#21202,"TELADAN, CURUP SELATAN, REJANG LEBONG, BENGKULU",8,41,110,151
https://kawalpemilu.org#21203,"SUKA MARGA, CURUP SELATAN, REJANG LEBONG, BENGKULU",1,77,176,253
https://kawalpemilu.org#21203,"SUKA MARGA, CURUP SELATAN, REJANG LEBONG, BENGKULU",2,92,121,213
https://kawalpemilu.org#21204,"LUBUK UBAR, CURUP SELATAN, REJANG LEBONG, BENGKULU",1,74,177,251
https://kawalpemilu.org#21204,"LUBUK UBAR, CURUP SELATAN, REJANG LEBONG, BENGKULU",2,51,160,211
https://kawalpemilu.org#21204,"LUBUK UBAR, CURUP SELATAN, REJANG LEBONG, BENGKULU",3,99,123,222
https://kawalpemilu.org#21205,"PUNGGUK LALANG, CURUP SELATAN, REJANG LEBONG, BENGKULU",1,70,164,234
https://kawalpemilu.org#21205,"PUNGGUK LALANG, CURUP SELATAN, REJANG LEBONG, BENGKULU",2,75,180,255
https://kawalpemilu.org#21205,"PUNGGUK LALANG, CURUP SELATAN, REJANG LEBONG, BENGKULU",3,83,148,231
https://kawalpemilu.org#21205,"PUNGGUK LALANG, CURUP SELATAN, REJANG LEBONG, BENGKULU",4,95,131,226
https://kawalpemilu.org#21205,"PUNGGUK LALANG, CURUP SELATAN, REJANG LEBONG, BENGKULU",5,107,148,255
https://kawalpemilu.org#21206,"TURAN BARU, CURUP SELATAN, REJANG LEBONG, BENGKULU",1,77,91,168
https://kawalpemilu.org#21206,"TURAN BARU, CURUP SELATAN, REJANG LEBONG, BENGKULU",2,85,104,189
https://kawalpemilu.org#21206,"TURAN BARU, CURUP SELATAN, REJANG LEBONG, BENGKULU",3,65,91,156
https://kawalpemilu.org#21207,"TANJUNG DALAM, CURUP SELATAN, REJANG LEBONG, BENGKULU",1,82,148,230
https://kawalpemilu.org#21207,"TANJUNG DALAM, CURUP SELATAN, REJANG LEBONG, BENGKULU",2,80,167,247
https://kawalpemilu.org#21207,"TANJUNG DALAM, CURUP SELATAN, REJANG LEBONG, BENGKULU",3,104,120,224
https://kawalpemilu.org#21208,"AIR LANANG, CURUP SELATAN, REJANG LEBONG, BENGKULU",1,64,119,183
https://kawalpemilu.org#21208,"AIR LANANG, CURUP SELATAN, REJANG LEBONG, BENGKULU",2,90,103,193
https://kawalpemilu.org#21208,"AIR LANANG, CURUP SELATAN, REJANG LEBONG, BENGKULU",3,77,85,162
https://kawalpemilu.org#21208,"AIR LANANG, CURUP SELATAN, REJANG LEBONG, BENGKULU",4,77,110,187
https://kawalpemilu.org#21208,"AIR LANANG, CURUP SELATAN, REJANG LEBONG, BENGKULU",5,46,76,124
https://kawalpemilu.org#21210,"KEPALA SIRING, CURUP TENGAH, REJANG LEBONG, BENGKULU",1,62,84,146
https://kawalpemilu.org#21210,"KEPALA SIRING, CURUP TENGAH, REJANG LEBONG, BENGKULU",2,55,110,165
https://kawalpemilu.org#21210,"KEPALA SIRING, CURUP TENGAH, REJANG LEBONG, BENGKULU",3,28,106,134
https://kawalpemilu.org#21210,"KEPALA SIRING, CURUP TENGAH, REJANG LEBONG, BENGKULU",4,49,84,134
https://kawalpemilu.org#21210,"KEPALA SIRING, CURUP TENGAH, REJANG LEBONG, BENGKULU",5,53,105,158
https://kawalpemilu.org#21210,"KEPALA SIRING, CURUP TENGAH, REJANG LEBONG, BENGKULU",6,34,123,157
https://kawalpemilu.org#21210,"KEPALA SIRING, CURUP TENGAH, REJANG LEBONG, BENGKULU",7,65,76,141
https://kawalpemilu.org#21210,"KEPALA SIRING, CURUP TENGAH, REJANG LEBONG, BENGKULU",8,62,115,177
https://kawalpemilu.org#21210,"KEPALA SIRING, CURUP TENGAH, REJANG LEBONG, BENGKULU",9,49,106,155
https://kawalpemilu.org#21211,"TALANG RIMBO BARU, CURUP TENGAH, REJANG LEBONG, BENGKULU",1,98,121,219
https://kawalpemilu.org#21211,"TALANG RIMBO BARU, CURUP TENGAH, REJANG LEBONG, BENGKULU",2,86,103,189
https://kawalpemilu.org#21211,"TALANG RIMBO BARU, CURUP TENGAH, REJANG LEBONG, BENGKULU",3,59,69,128
https://kawalpemilu.org#21211,"TALANG RIMBO BARU, CURUP TENGAH, REJANG LEBONG, BENGKULU",4,39,70,109
https://kawalpemilu.org#21211,"TALANG RIMBO BARU, CURUP TENGAH, REJANG LEBONG, BENGKULU",5,35,66,101
https://kawalpemilu.org#21211,"TALANG RIMBO BARU, CURUP TENGAH, REJANG LEBONG, BENGKULU",6,65,78,143
https://kawalpemilu.org#21211,"TALANG RIMBO BARU, CURUP TENGAH, REJANG LEBONG, BENGKULU",7,55,111,166
https://kawalpemilu.org#21211,"TALANG RIMBO BARU, CURUP TENGAH, REJANG LEBONG, BENGKULU",8,54,92,146
https://kawalpemilu.org#21211,"TALANG RIMBO BARU, CURUP TENGAH, REJANG LEBONG, BENGKULU",9,75,191,266
https://kawalpemilu.org#21211,"TALANG RIMBO BARU, CURUP TENGAH, REJANG LEBONG, BENGKULU",10,71,124,195
https://kawalpemilu.org#21211,"TALANG RIMBO BARU, CURUP TENGAH, REJANG LEBONG, BENGKULU",11,79,152,231
https://kawalpemilu.org#21211,"TALANG RIMBO BARU, CURUP TENGAH, REJANG LEBONG, BENGKULU",12,37,111,148
https://kawalpemilu.org#21211,"TALANG RIMBO BARU, CURUP TENGAH, REJANG LEBONG, BENGKULU",13,45,111,156
https://kawalpemilu.org#21211,"TALANG RIMBO BARU, CURUP TENGAH, REJANG LEBONG, BENGKULU",14,49,99,148
https://kawalpemilu.org#21211,"TALANG RIMBO BARU, CURUP TENGAH, REJANG LEBONG, BENGKULU",15,52,148,200
https://kawalpemilu.org#21211,"TALANG RIMBO BARU, CURUP TENGAH, REJANG LEBONG, BENGKULU",16,54,134,188
https://kawalpemilu.org#21211,"TALANG RIMBO BARU, CURUP TENGAH, REJANG LEBONG, BENGKULU",17,39,141,180
https://kawalpemilu.org#21211,"TALANG RIMBO BARU, CURUP TENGAH, REJANG LEBONG, BENGKULU",18,45,158,203
https://kawalpemilu.org#21211,"TALANG RIMBO BARU, CURUP TENGAH, REJANG LEBONG, BENGKULU",19,74,149,223
https://kawalpemilu.org#21212,"TALANG RIMBO LAMA, CURUP TENGAH, REJANG LEBONG, BENGKULU",1,94,151,245
https://kawalpemilu.org#21212,"TALANG RIMBO LAMA, CURUP TENGAH, REJANG LEBONG, BENGKULU",2,111,165,276
https://kawalpemilu.org#21212,"TALANG RIMBO LAMA, CURUP TENGAH, REJANG LEBONG, BENGKULU",3,128,145,273
https://kawalpemilu.org#21212,"TALANG RIMBO LAMA, CURUP TENGAH, REJANG LEBONG, BENGKULU",4,90,181,271
https://kawalpemilu.org#21212,"TALANG RIMBO LAMA, CURUP TENGAH, REJANG LEBONG, BENGKULU",5,48,202,250
https://kawalpemilu.org#21212,"TALANG RIMBO LAMA, CURUP TENGAH, REJANG LEBONG, BENGKULU",6,72,184,256
https://kawalpemilu.org#21212,"TALANG RIMBO LAMA, CURUP TENGAH, REJANG LEBONG, BENGKULU",7,87,158,245
https://kawalpemilu.org#21212,"TALANG RIMBO LAMA, CURUP TENGAH, REJANG LEBONG, BENGKULU",8,92,129,221
https://kawalpemilu.org#21212,"TALANG RIMBO LAMA, CURUP TENGAH, REJANG LEBONG, BENGKULU",9,74,150,224
https://kawalpemilu.org#21212,"TALANG RIMBO LAMA, CURUP TENGAH, REJANG LEBONG, BENGKULU",10,55,101,156
https://kawalpemilu.org#21212,"TALANG RIMBO LAMA, CURUP TENGAH, REJANG LEBONG, BENGKULU",11,46,158,204
https://kawalpemilu.org#21212,"TALANG RIMBO LAMA, CURUP TENGAH, REJANG LEBONG, BENGKULU",12,80,151,231
https://kawalpemilu.org#21213,"SIDEREJO, CURUP TENGAH, REJANG LEBONG, BENGKULU",2,82,151,233
https://kawalpemilu.org#21213,"SIDEREJO, CURUP TENGAH, REJANG LEBONG, BENGKULU",3,95,132,227
https://kawalpemilu.org#21213,"SIDEREJO, CURUP TENGAH, REJANG LEBONG, BENGKULU",4,85,138,223
https://kawalpemilu.org#21213,"SIDEREJO, CURUP TENGAH, REJANG LEBONG, BENGKULU",5,97,133,230
https://kawalpemilu.org#21213,"SIDEREJO, CURUP TENGAH, REJANG LEBONG, BENGKULU",6,74,160,234
https://kawalpemilu.org#21213,"SIDEREJO, CURUP TENGAH, REJANG LEBONG, BENGKULU",7,110,129,239
https://kawalpemilu.org#21213,"SIDEREJO, CURUP TENGAH, REJANG LEBONG, BENGKULU",8,79,152,231
https://kawalpemilu.org#21213,"SIDEREJO, CURUP TENGAH, REJANG LEBONG, BENGKULU",9,85,143,228
https://kawalpemilu.org#21213,"SIDEREJO, CURUP TENGAH, REJANG LEBONG, BENGKULU",10,53,99,152
https://kawalpemilu.org#21214,"KAMPUNG JAWA, CURUP TENGAH, REJANG LEBONG, BENGKULU",1,84,121,205
https://kawalpemilu.org#21214,"KAMPUNG JAWA, CURUP TENGAH, REJANG LEBONG, BENGKULU",2,58,172,230
https://kawalpemilu.org#21214,"KAMPUNG JAWA, CURUP TENGAH, REJANG LEBONG, BENGKULU",3,85,128,213
https://kawalpemilu.org#21214,"KAMPUNG JAWA, CURUP TENGAH, REJANG LEBONG, BENGKULU",4,52,74,126
https://kawalpemilu.org#21215,"AIR BANG, CURUP TENGAH, REJANG LEBONG, BENGKULU",1,115,96,211
https://kawalpemilu.org#21215,"AIR BANG, CURUP TENGAH, REJANG LEBONG, BENGKULU",2,104,106,210
https://kawalpemilu.org#21215,"AIR BANG, CURUP TENGAH, REJANG LEBONG, BENGKULU",3,64,171,235
https://kawalpemilu.org#21215,"AIR BANG, CURUP TENGAH, REJANG LEBONG, BENGKULU",4,106,135,241
https://kawalpemilu.org#21215,"AIR BANG, CURUP TENGAH, REJANG LEBONG, BENGKULU",5,114,146,260
https://kawalpemilu.org#21215,"AIR BANG, CURUP TENGAH, REJANG LEBONG, BENGKULU",6,96,132,228
https://kawalpemilu.org#21215,"AIR BANG, CURUP TENGAH, REJANG LEBONG, BENGKULU",7,105,109,214
https://kawalpemilu.org#21215,"AIR BANG, CURUP TENGAH, REJANG LEBONG, BENGKULU",8,70,127,197
https://kawalpemilu.org#21215,"AIR BANG, CURUP TENGAH, REJANG LEBONG, BENGKULU",9,76,157,233
https://kawalpemilu.org#21215,"AIR BANG, CURUP TENGAH, REJANG LEBONG, BENGKULU",10,110,153,263
https://kawalpemilu.org#21215,"AIR BANG, CURUP TENGAH, REJANG LEBONG, BENGKULU",11,76,105,181
https://kawalpemilu.org#21215,"AIR BANG, CURUP TENGAH, REJANG LEBONG, BENGKULU",12,127,130,257
https://kawalpemilu.org#21215,"AIR BANG, CURUP TENGAH, REJANG LEBONG, BENGKULU",13,95,107,202
https://kawalpemilu.org#21215,"AIR BANG, CURUP TENGAH, REJANG LEBONG, BENGKULU",14,60,175,235
https://kawalpemilu.org#21215,"AIR BANG, CURUP TENGAH, REJANG LEBONG, BENGKULU",15,98,100,198
https://kawalpemilu.org#21215,"AIR BANG, CURUP TENGAH, REJANG LEBONG, BENGKULU",16,94,173,267
https://kawalpemilu.org#21215,"AIR BANG, CURUP TENGAH, REJANG LEBONG, BENGKULU",17,54,203,257
https://kawalpemilu.org#21215,"AIR BANG, CURUP TENGAH, REJANG LEBONG, BENGKULU",18,81,177,258
https://kawalpemilu.org#21215,"AIR BANG, CURUP TENGAH, REJANG LEBONG, BENGKULU",19,104,107,211
https://kawalpemilu.org#21215,"AIR BANG, CURUP TENGAH, REJANG LEBONG, BENGKULU",20,72,165,237
https://kawalpemilu.org#21216,"BATU GALING, CURUP TENGAH, REJANG LEBONG, BENGKULU",1,64,148,212
https://kawalpemilu.org#21216,"BATU GALING, CURUP TENGAH, REJANG LEBONG, BENGKULU",2,89,152,241
https://kawalpemilu.org#21216,"BATU GALING, CURUP TENGAH, REJANG LEBONG, BENGKULU",3,79,174,253
https://kawalpemilu.org#21216,"BATU GALING, CURUP TENGAH, REJANG LEBONG, BENGKULU",4,79,166,245
https://kawalpemilu.org#21216,"BATU GALING, CURUP TENGAH, REJANG LEBONG, BENGKULU",5,54,205,259
https://kawalpemilu.org#21216,"BATU GALING, CURUP TENGAH, REJANG LEBONG, BENGKULU",6,99,160,261
https://kawalpemilu.org#21216,"BATU GALING, CURUP TENGAH, REJANG LEBONG, BENGKULU",7,62,143,205
https://kawalpemilu.org#21217,"BANYU MAS, CURUP TENGAH, REJANG LEBONG, BENGKULU",1,69,116,185
https://kawalpemilu.org#21217,"BANYU MAS, CURUP TENGAH, REJANG LEBONG, BENGKULU",2,59,101,160
https://kawalpemilu.org#21217,"BANYU MAS, CURUP TENGAH, REJANG LEBONG, BENGKULU",3,46,98,144
https://kawalpemilu.org#21217,"BANYU MAS, CURUP TENGAH, REJANG LEBONG, BENGKULU",4,66,81,147
https://kawalpemilu.org#21217,"BANYU MAS, CURUP TENGAH, REJANG LEBONG, BENGKULU",5,92,105,197
https://kawalpemilu.org#21218,"PELABUHAN BARU, CURUP TENGAH, REJANG LEBONG, BENGKULU",1,55,134,189
https://kawalpemilu.org#21218,"PELABUHAN BARU, CURUP TENGAH, REJANG LEBONG, BENGKULU",2,48,123,171
https://kawalpemilu.org#21218,"PELABUHAN BARU, CURUP TENGAH, REJANG LEBONG, BENGKULU",3,73,114,187
https://kawalpemilu.org#21218,"PELABUHAN BARU, CURUP TENGAH, REJANG LEBONG, BENGKULU",4,74,112,186
https://kawalpemilu.org#21219,"AIR MERAH, CURUP TENGAH, REJANG LEBONG, BENGKULU",1,106,108,214
https://kawalpemilu.org#21219,"AIR MERAH, CURUP TENGAH, REJANG LEBONG, BENGKULU",2,71,112,183
https://kawalpemilu.org#21219,"AIR MERAH, CURUP TENGAH, REJANG LEBONG, BENGKULU",3,90,106,196
https://kawalpemilu.org#21219,"AIR MERAH, CURUP TENGAH, REJANG LEBONG, BENGKULU",4,107,114,221
https://kawalpemilu.org#21221,"KEPALA CURUP, BINDURIANG, REJANG LEBONG, BENGKULU",1,91,84,175
https://kawalpemilu.org#21221,"KEPALA CURUP, BINDURIANG, REJANG LEBONG, BENGKULU",2,85,55,140
https://kawalpemilu.org#21221,"KEPALA CURUP, BINDURIANG, REJANG LEBONG, BENGKULU",3,65,69,134
https://kawalpemilu.org#21221,"KEPALA CURUP, BINDURIANG, REJANG LEBONG, BENGKULU",4,101,83,182
https://kawalpemilu.org#21221,"KEPALA CURUP, BINDURIANG, REJANG LEBONG, BENGKULU",5,103,91,194
https://kawalpemilu.org#21221,"KEPALA CURUP, BINDURIANG, REJANG LEBONG, BENGKULU",6,72,72,144
https://kawalpemilu.org#21221,"KEPALA CURUP, BINDURIANG, REJANG LEBONG, BENGKULU",7,69,76,145
https://kawalpemilu.org#21222,"KAMPUNG JERUK, BINDURIANG, REJANG LEBONG, BENGKULU",1,111,63,174
https://kawalpemilu.org#21222,"KAMPUNG JERUK, BINDURIANG, REJANG LEBONG, BENGKULU",2,103,104,207
https://kawalpemilu.org#21222,"KAMPUNG JERUK, BINDURIANG, REJANG LEBONG, BENGKULU",3,95,86,181
https://kawalpemilu.org#21222,"KAMPUNG JERUK, BINDURIANG, REJANG LEBONG, BENGKULU",4,99,94,193
https://kawalpemilu.org#21222,"KAMPUNG JERUK, BINDURIANG, REJANG LEBONG, BENGKULU",5,51,45,96
https://kawalpemilu.org#21222,"KAMPUNG JERUK, BINDURIANG, REJANG LEBONG, BENGKULU",6,85,63,148
https://kawalpemilu.org#21222,"KAMPUNG JERUK, BINDURIANG, REJANG LEBONG, BENGKULU",7,69,55,124
https://kawalpemilu.org#21223,"SIMPANG BELITI, BINDURIANG, REJANG LEBONG, BENGKULU",1,71,111,182
https://kawalpemilu.org#21223,"SIMPANG BELITI, BINDURIANG, REJANG LEBONG, BENGKULU",2,78,91,169
https://kawalpemilu.org#21223,"SIMPANG BELITI, BINDURIANG, REJANG LEBONG, BENGKULU",3,90,75,165
https://kawalpemilu.org#21223,"SIMPANG BELITI, BINDURIANG, REJANG LEBONG, BENGKULU",4,116,97,213
https://kawalpemilu.org#21223,"SIMPANG BELITI, BINDURIANG, REJANG LEBONG, BENGKULU",5,92,95,187
https://kawalpemilu.org#21223,"SIMPANG BELITI, BINDURIANG, REJANG LEBONG, BENGKULU",6,116,79,195
https://kawalpemilu.org#21223,"SIMPANG BELITI, BINDURIANG, REJANG LEBONG, BENGKULU",7,66,104,170
https://kawalpemilu.org#21223,"SIMPANG BELITI, BINDURIANG, REJANG LEBONG, BENGKULU",8,72,77,149
https://kawalpemilu.org#21224,"TABA PADANG, BINDURIANG, REJANG LEBONG, BENGKULU",1,101,90,191
https://kawalpemilu.org#21224,"TABA PADANG, BINDURIANG, REJANG LEBONG, BENGKULU",2,66,129,195
https://kawalpemilu.org#21224,"TABA PADANG, BINDURIANG, REJANG LEBONG, BENGKULU",3,52,113,165
https://kawalpemilu.org#21225,"AIR APO, BINDURIANG, REJANG LEBONG, BENGKULU",1,75,101,176
https://kawalpemilu.org#21225,"AIR APO, BINDURIANG, REJANG LEBONG, BENGKULU",2,55,89,144
https://kawalpemilu.org#21225,"AIR APO, BINDURIANG, REJANG LEBONG, BENGKULU",3,64,99,163
https://kawalpemilu.org#21225,"AIR APO, BINDURIANG, REJANG LEBONG, BENGKULU",4,92,65,157
https://kawalpemilu.org#21225,"AIR APO, BINDURIANG, REJANG LEBONG, BENGKULU",5,50,94,144
https://kawalpemilu.org#21225,"AIR APO, BINDURIANG, REJANG LEBONG, BENGKULU",6,66,101,167
https://kawalpemilu.org#21227,"APUR, SINDANG BELITI ULU, REJANG LEBONG, BENGKULU",1,53,141,194
https://kawalpemilu.org#21227,"APUR, SINDANG BELITI ULU, REJANG LEBONG, BENGKULU",2,64,113,177
https://kawalpemilu.org#21227,"APUR, SINDANG BELITI ULU, REJANG LEBONG, BENGKULU",3,66,120,186
https://kawalpemilu.org#21227,"APUR, SINDANG BELITI ULU, REJANG LEBONG, BENGKULU",4,75,97,172
https://kawalpemilu.org#21227,"APUR, SINDANG BELITI ULU, REJANG LEBONG, BENGKULU",5,81,102,183
https://kawalpemilu.org#21227,"APUR, SINDANG BELITI ULU, REJANG LEBONG, BENGKULU",6,61,115,176
https://kawalpemilu.org#21227,"APUR, SINDANG BELITI ULU, REJANG LEBONG, BENGKULU",7,40,100,140
https://kawalpemilu.org#21227,"APUR, SINDANG BELITI ULU, REJANG LEBONG, BENGKULU",8,58,83,141
https://kawalpemilu.org#21228,"LAWANG AGUNG, SINDANG BELITI ULU, REJANG LEBONG, BENGKULU",1,79,147,226
https://kawalpemilu.org#21228,"LAWANG AGUNG, SINDANG BELITI ULU, REJANG LEBONG, BENGKULU",2,69,100,169
https://kawalpemilu.org#21228,"LAWANG AGUNG, SINDANG BELITI ULU, REJANG LEBONG, BENGKULU",3,86,115,201
https://kawalpemilu.org#21228,"LAWANG AGUNG, SINDANG BELITI ULU, REJANG LEBONG, BENGKULU",4,76,116,192
https://kawalpemilu.org#21228,"LAWANG AGUNG, SINDANG BELITI ULU, REJANG LEBONG, BENGKULU",5,87,85,172
https://kawalpemilu.org#21228,"LAWANG AGUNG, SINDANG BELITI ULU, REJANG LEBONG, BENGKULU",6,68,95,163
https://kawalpemilu.org#21229,"LUBUK ALAI, SINDANG BELITI ULU, REJANG LEBONG, BENGKULU",1,104,91,195
https://kawalpemilu.org#21229,"LUBUK ALAI, SINDANG BELITI ULU, REJANG LEBONG, BENGKULU",2,70,98,168
https://kawalpemilu.org#21229,"LUBUK ALAI, SINDANG BELITI ULU, REJANG LEBONG, BENGKULU",3,101,126,227
https://kawalpemilu.org#21229,"LUBUK ALAI, SINDANG BELITI ULU, REJANG LEBONG, BENGKULU",4,68,67,135
https://kawalpemilu.org#21229,"LUBUK ALAI, SINDANG BELITI ULU, REJANG LEBONG, BENGKULU",5,44,125,169
https://kawalpemilu.org#21229,"LUBUK ALAI, SINDANG BELITI ULU, REJANG LEBONG, BENGKULU",6,77,90,167
https://kawalpemilu.org#21229,"LUBUK ALAI, SINDANG BELITI ULU, REJANG LEBONG, BENGKULU",7,78,92,170
https://kawalpemilu.org#21229,"LUBUK ALAI, SINDANG BELITI ULU, REJANG LEBONG, BENGKULU",8,69,101,170
https://kawalpemilu.org#21230,"KARANG PINANG, SINDANG BELITI ULU, REJANG LEBONG, BENGKULU",1,90,118,208
https://kawalpemilu.org#21230,"KARANG PINANG, SINDANG BELITI ULU, REJANG LEBONG, BENGKULU",2,125,85,210
https://kawalpemilu.org#21230,"KARANG PINANG, SINDANG BELITI ULU, REJANG LEBONG, BENGKULU",3,120,67,187
https://kawalpemilu.org#21230,"KARANG PINANG, SINDANG BELITI ULU, REJANG LEBONG, BENGKULU",4,90,110,200
https://kawalpemilu.org#21231,"TANJUNG AGUNG, SINDANG BELITI ULU, REJANG LEBONG, BENGKULU",1,95,110,205
https://kawalpemilu.org#21231,"TANJUNG AGUNG, SINDANG BELITI ULU, REJANG LEBONG, BENGKULU",2,93,109,202
https://kawalpemilu.org#21231,"TANJUNG AGUNG, SINDANG BELITI ULU, REJANG LEBONG, BENGKULU",3,59,83,142
https://kawalpemilu.org#21232,"PENGAMBANG, SINDANG BELITI ULU, REJANG LEBONG, BENGKULU",1,50,162,212
https://kawalpemilu.org#21232,"PENGAMBANG, SINDANG BELITI ULU, REJANG LEBONG, BENGKULU",2,41,139,180
https://kawalpemilu.org#21232,"PENGAMBANG, SINDANG BELITI ULU, REJANG LEBONG, BENGKULU",3,49,165,214
https://kawalpemilu.org#21232,"PENGAMBANG, SINDANG BELITI ULU, REJANG LEBONG, BENGKULU",4,48,175,223
https://kawalpemilu.org#21233,"JABI, SINDANG BELITI ULU, REJANG LEBONG, BENGKULU",1,79,130,209
https://kawalpemilu.org#21233,"JABI, SINDANG BELITI ULU, REJANG LEBONG, BENGKULU",2,49,142,191
https://kawalpemilu.org#21233,"JABI, SINDANG BELITI ULU, REJANG LEBONG, BENGKULU",3,40,137,177
https://kawalpemilu.org#21234,"TANJUNG HERAN, SINDANG BELITI ULU, REJANG LEBONG, BENGKULU",1,57,140,197
https://kawalpemilu.org#21234,"TANJUNG HERAN, SINDANG BELITI ULU, REJANG LEBONG, BENGKULU",2,72,108,180
https://kawalpemilu.org#21234,"TANJUNG HERAN, SINDANG BELITI ULU, REJANG LEBONG, BENGKULU",3,47,76,123
https://kawalpemilu.org#21235,"AIR NAU, SINDANG BELITI ULU, REJANG LEBONG, BENGKULU",1,143,94,237
https://kawalpemilu.org#21235,"AIR NAU, SINDANG BELITI ULU, REJANG LEBONG, BENGKULU",2,141,73,214
https://kawalpemilu.org#21237,"IV SUKU MENANTI, SINDANG DATARAN, REJANG LEBONG, BENGKULU",1,164,55,219
https://kawalpemilu.org#21237,"IV SUKU MENANTI, SINDANG DATARAN, REJANG LEBONG, BENGKULU",2,150,77,227
https://kawalpemilu.org#21237,"IV SUKU MENANTI, SINDANG DATARAN, REJANG LEBONG, BENGKULU",3,152,72,224
https://kawalpemilu.org#21237,"IV SUKU MENANTI, SINDANG DATARAN, REJANG LEBONG, BENGKULU",4,118,80,198
https://kawalpemilu.org#21237,"IV SUKU MENANTI, SINDANG DATARAN, REJANG LEBONG, BENGKULU",5,137,69,206
https://kawalpemilu.org#21237,"IV SUKU MENANTI, SINDANG DATARAN, REJANG LEBONG, BENGKULU",6,148,65,213
https://kawalpemilu.org#21237,"IV SUKU MENANTI, SINDANG DATARAN, REJANG LEBONG, BENGKULU",7,147,81,228
https://kawalpemilu.org#21237,"IV SUKU MENANTI, SINDANG DATARAN, REJANG LEBONG, BENGKULU",8,130,69,199
https://kawalpemilu.org#21237,"IV SUKU MENANTI, SINDANG DATARAN, REJANG LEBONG, BENGKULU",9,95,52,117
https://kawalpemilu.org#21238,"AIR RUSA, SINDANG DATARAN, REJANG LEBONG, BENGKULU",1,185,73,258
https://kawalpemilu.org#21238,"AIR RUSA, SINDANG DATARAN, REJANG LEBONG, BENGKULU",2,169,65,234
https://kawalpemilu.org#21238,"AIR RUSA, SINDANG DATARAN, REJANG LEBONG, BENGKULU",3,135,66,201
https://kawalpemilu.org#21238,"AIR RUSA, SINDANG DATARAN, REJANG LEBONG, BENGKULU",4,108,77,185
https://kawalpemilu.org#21239,"BENGKO, SINDANG DATARAN, REJANG LEBONG, BENGKULU",1,130,78,208
https://kawalpemilu.org#21239,"BENGKO, SINDANG DATARAN, REJANG LEBONG, BENGKULU",2,157,70,227
https://kawalpemilu.org#21239,"BENGKO, SINDANG DATARAN, REJANG LEBONG, BENGKULU",3,212,34,246
https://kawalpemilu.org#21239,"BENGKO, SINDANG DATARAN, REJANG LEBONG, BENGKULU",4,69,31,100
https://kawalpemilu.org#21239,"BENGKO, SINDANG DATARAN, REJANG LEBONG, BENGKULU",5,139,84,223
https://kawalpemilu.org#21239,"BENGKO, SINDANG DATARAN, REJANG LEBONG, BENGKULU",6,151,25,176
https://kawalpemilu.org#21239,"BENGKO, SINDANG DATARAN, REJANG LEBONG, BENGKULU",7,127,39,166
https://kawalpemilu.org#21240,"SINAR GUNUNG, SINDANG DATARAN, REJANG LEBONG, BENGKULU",1,135,80,215
https://kawalpemilu.org#21240,"SINAR GUNUNG, SINDANG DATARAN, REJANG LEBONG, BENGKULU",2,87,66,153
https://kawalpemilu.org#21240,"SINAR GUNUNG, SINDANG DATARAN, REJANG LEBONG, BENGKULU",3,76,102,178
https://kawalpemilu.org#21240,"SINAR GUNUNG, SINDANG DATARAN, REJANG LEBONG, BENGKULU",4,93,77,170
https://kawalpemilu.org#21240,"SINAR GUNUNG, SINDANG DATARAN, REJANG LEBONG, BENGKULU",5,82,61,143
https://kawalpemilu.org#21240,"SINAR GUNUNG, SINDANG DATARAN, REJANG LEBONG, BENGKULU",6,72,53,125
https://kawalpemilu.org#21240,"SINAR GUNUNG, SINDANG DATARAN, REJANG LEBONG, BENGKULU",7,31,19,50
https://kawalpemilu.org#21240,"SINAR GUNUNG, SINDANG DATARAN, REJANG LEBONG, BENGKULU",8,18,10,28
https://kawalpemilu.org#21240,"SINAR GUNUNG, SINDANG DATARAN, REJANG LEBONG, BENGKULU",9,34,60,94
https://kawalpemilu.org#21241,"TALANG BELITAR, SINDANG DATARAN, REJANG LEBONG, BENGKULU",1,187,73,260
https://kawalpemilu.org#21241,"TALANG BELITAR, SINDANG DATARAN, REJANG LEBONG, BENGKULU",2,87,49,136
https://kawalpemilu.org#21241,"TALANG BELITAR, SINDANG DATARAN, REJANG LEBONG, BENGKULU",3,171,24,213
https://kawalpemilu.org#21241,"TALANG BELITAR, SINDANG DATARAN, REJANG LEBONG, BENGKULU",4,105,59,164
https://kawalpemilu.org#21242,"WARUNG POJOK, SINDANG DATARAN, REJANG LEBONG, BENGKULU",1,107,32,139
https://kawalpemilu.org#21242,"WARUNG POJOK, SINDANG DATARAN, REJANG LEBONG, BENGKULU",2,82,81,163
https://kawalpemilu.org#21242,"WARUNG POJOK, SINDANG DATARAN, REJANG LEBONG, BENGKULU",3,78,30,108
https://kawalpemilu.org#21244,"MERANTAU, SINDANG BELITI ILIR, REJANG LEBONG, BENGKULU",1,72,123,195
https://kawalpemilu.org#21244,"MERANTAU, SINDANG BELITI ILIR, REJANG LEBONG, BENGKULU",2,28,150,178
https://kawalpemilu.org#21244,"MERANTAU, SINDANG BELITI ILIR, REJANG LEBONG, BENGKULU",3,32,143,175
https://kawalpemilu.org#21245,"PERIANG, SINDANG BELITI ILIR, REJANG LEBONG, BENGKULU",1,43,135,178
https://kawalpemilu.org#21245,"PERIANG, SINDANG BELITI ILIR, REJANG LEBONG, BENGKULU",3,32,145,177
https://kawalpemilu.org#21246,"BALAI BUNTAR, SINDANG BELITI ILIR, REJANG LEBONG, BENGKULU",1,24,171,195
https://kawalpemilu.org#21246,"BALAI BUNTAR, SINDANG BELITI ILIR, REJANG LEBONG, BENGKULU",2,31,184,215
https://kawalpemilu.org#21247,"LUBUK TUNJUNG, SINDANG BELITI ILIR, REJANG LEBONG, BENGKULU",1,33,98,131
https://kawalpemilu.org#21247,"LUBUK TUNJUNG, SINDANG BELITI ILIR, REJANG LEBONG, BENGKULU",2,46,104,150
https://kawalpemilu.org#21248,"LUBUK BELIMBING I, SINDANG BELITI ILIR, REJANG LEBONG, BENGKULU",1,64,149,213
https://kawalpemilu.org#21248,"LUBUK BELIMBING I, SINDANG BELITI ILIR, REJANG LEBONG, BENGKULU",2,41,184,225
https://kawalpemilu.org#21248,"LUBUK BELIMBING I, SINDANG BELITI ILIR, REJANG LEBONG, BENGKULU",3,39,166,205
https://kawalpemilu.org#21248,"LUBUK BELIMBING I, SINDANG BELITI ILIR, REJANG LEBONG, BENGKULU",5,66,147,213
https://kawalpemilu.org#21249,"LUBUK BELIMBING II, SINDANG BELITI ILIR, REJANG LEBONG, BENGKULU",1,46,195,241
https://kawalpemilu.org#21249,"LUBUK BELIMBING II, SINDANG BELITI ILIR, REJANG LEBONG, BENGKULU",2,33,212,245
https://kawalpemilu.org#21249,"LUBUK BELIMBING II, SINDANG BELITI ILIR, REJANG LEBONG, BENGKULU",3,35,193,228
https://kawalpemilu.org#21249,"LUBUK BELIMBING II, SINDANG BELITI ILIR, REJANG LEBONG, BENGKULU",4,33,170,203
https://kawalpemilu.org#21249,"LUBUK BELIMBING II, SINDANG BELITI ILIR, REJANG LEBONG, BENGKULU",5,32,80,112
https://kawalpemilu.org#21250,"LUBUK BINGIN BARU, SINDANG BELITI ILIR, REJANG LEBONG, BENGKULU",1,31,160,191
https://kawalpemilu.org#21250,"LUBUK BINGIN BARU, SINDANG BELITI ILIR, REJANG LEBONG, BENGKULU",2,31,96,127
https://kawalpemilu.org#21250,"LUBUK BINGIN BARU, SINDANG BELITI ILIR, REJANG LEBONG, BENGKULU",3,30,161,191
https://kawalpemilu.org#21251,"SARI PULAU, SINDANG BELITI ILIR, REJANG LEBONG, BENGKULU",1,44,138,182
https://kawalpemilu.org#21252,"SUKA MERINDU, SINDANG BELITI ILIR, REJANG LEBONG, BENGKULU",1,98,108,206
https://kawalpemilu.org#21252,"SUKA MERINDU, SINDANG BELITI ILIR, REJANG LEBONG, BENGKULU",2,54,172,226
https://kawalpemilu.org#21252,"SUKA MERINDU, SINDANG BELITI ILIR, REJANG LEBONG, BENGKULU",3,80,60,140
https://kawalpemilu.org#21252,"SUKA MERINDU, SINDANG BELITI ILIR, REJANG LEBONG, BENGKULU",4,73,122,195
https://kawalpemilu.org#21253,"SUKA KARYA, SINDANG BELITI ILIR, REJANG LEBONG, BENGKULU",1,51,91,142
https://kawalpemilu.org#21255,"DATARAN TAPUS, BERMANI ULU RAYA, REJANG LEBONG, BENGKULU",1,158,74,232
https://kawalpemilu.org#21256,"BANDUNG MARGA, BERMANI ULU RAYA, REJANG LEBONG, BENGKULU",1,176,73,249
https://kawalpemilu.org#21256,"BANDUNG MARGA, BERMANI ULU RAYA, REJANG LEBONG, BENGKULU",2,109,91,200
https://kawalpemilu.org#21256,"BANDUNG MARGA, BERMANI ULU RAYA, REJANG LEBONG, BENGKULU",3,70,63,133
https://kawalpemilu.org#21257,"PAL SERATUS, BERMANI ULU RAYA, REJANG LEBONG, BENGKULU",1,120,33,153
https://kawalpemilu.org#21257,"PAL SERATUS, BERMANI ULU RAYA, REJANG LEBONG, BENGKULU",2,111,31,142
https://kawalpemilu.org#21258,"PAL VII, BERMANI ULU RAYA, REJANG LEBONG, BENGKULU",1,143,46,189
https://kawalpemilu.org#21258,"PAL VII, BERMANI ULU RAYA, REJANG LEBONG, BENGKULU",2,129,47,176
https://kawalpemilu.org#21258,"PAL VII, BERMANI ULU RAYA, REJANG LEBONG, BENGKULU",3,118,65,183
https://kawalpemilu.org#21259,"PAL VIII, BERMANI ULU RAYA, REJANG LEBONG, BENGKULU",1,152,86,238
https://kawalpemilu.org#21259,"PAL VIII, BERMANI ULU RAYA, REJANG LEBONG, BENGKULU",2,151,96,247
https://kawalpemilu.org#21259,"PAL VIII, BERMANI ULU RAYA, REJANG LEBONG, BENGKULU",3,166,86,252
https://kawalpemilu.org#21259,"PAL VIII, BERMANI ULU RAYA, REJANG LEBONG, BENGKULU",4,170,70,240
https://kawalpemilu.org#21260,"TEBAT TENONG LUAR, BERMANI ULU RAYA, REJANG LEBONG, BENGKULU",1,127,109,236
https://kawalpemilu.org#21260,"TEBAT TENONG LUAR, BERMANI ULU RAYA, REJANG LEBONG, BENGKULU",2,131,94,225
https://kawalpemilu.org#21261,"BANGUN JAYA, BERMANI ULU RAYA, REJANG LEBONG, BENGKULU",1,188,48,236
https://kawalpemilu.org#21261,"BANGUN JAYA, BERMANI ULU RAYA, REJANG LEBONG, BENGKULU",2,160,70,230
https://kawalpemilu.org#21261,"BANGUN JAYA, BERMANI ULU RAYA, REJANG LEBONG, BENGKULU",3,87,46,133
https://kawalpemilu.org#21262,"BABAKAN BARU, BERMANI ULU RAYA, REJANG LEBONG, BENGKULU",1,153,51,204
https://kawalpemilu.org#21262,"BABAKAN BARU, BERMANI ULU RAYA, REJANG LEBONG, BENGKULU",2,145,77,223
https://kawalpemilu.org#21262,"BABAKAN BARU, BERMANI ULU RAYA, REJANG LEBONG, BENGKULU",3,145,103,248
https://kawalpemilu.org#21262,"BABAKAN BARU, BERMANI ULU RAYA, REJANG LEBONG, BENGKULU",4,84,57,141
https://kawalpemilu.org#21262,"BABAKAN BARU, BERMANI ULU RAYA, REJANG LEBONG, BENGKULU",5,120,26,146
https://kawalpemilu.org#21262,"BABAKAN BARU, BERMANI ULU RAYA, REJANG LEBONG, BENGKULU",6,103,74,177
https://kawalpemilu.org#21263,"SUMBEREJO TRANSAD, BERMANI ULU RAYA, REJANG LEBONG, BENGKULU",1,118,81,199
https://kawalpemilu.org#21263,"SUMBEREJO TRANSAD, BERMANI ULU RAYA, REJANG LEBONG, BENGKULU",2,130,100,230
https://kawalpemilu.org#21263,"SUMBEREJO TRANSAD, BERMANI ULU RAYA, REJANG LEBONG, BENGKULU",3,119,129,248
https://kawalpemilu.org#21263,"SUMBEREJO TRANSAD, BERMANI ULU RAYA, REJANG LEBONG, BENGKULU",4,122,102,224
https://kawalpemilu.org#21264,"AIR BENING, BERMANI ULU RAYA, REJANG LEBONG, BENGKULU",1,124,65,189
https://kawalpemilu.org#21264,"AIR BENING, BERMANI ULU RAYA, REJANG LEBONG, BENGKULU",2,152,58,210
https://kawalpemilu.org#21264,"AIR BENING, BERMANI ULU RAYA, REJANG LEBONG, BENGKULU",3,159,66,225
https://kawalpemilu.org#21264,"AIR BENING, BERMANI ULU RAYA, REJANG LEBONG, BENGKULU",4,153,67,220
https://kawalpemilu.org#21264,"AIR BENING, BERMANI ULU RAYA, REJANG LEBONG, BENGKULU",5,140,56,196
https://kawalpemilu.org#21264,"AIR BENING, BERMANI ULU RAYA, REJANG LEBONG, BENGKULU",6,140,59,199
https://kawalpemilu.org#21267,"BANJAR SARI, ENGGANO, BENGKULU UTARA, BENGKULU",1,123,38,161
https://kawalpemilu.org#21267,"BANJAR SARI, ENGGANO, BENGKULU UTARA, BENGKULU",2,181,24,205
https://kawalpemilu.org#21267,"BANJAR SARI, ENGGANO, BENGKULU UTARA, BENGKULU",3,108,28,136
https://kawalpemilu.org#21268,"MEOK, ENGGANO, BENGKULU UTARA, BENGKULU",1,156,11,167
https://kawalpemilu.org#21268,"MEOK, ENGGANO, BENGKULU UTARA, BENGKULU",2,218,26,244
https://kawalpemilu.org#21269,"MALAKONI, ENGGANO, BENGKULU UTARA, BENGKULU",1,130,38,168
https://kawalpemilu.org#21269,"MALAKONI, ENGGANO, BENGKULU UTARA, BENGKULU",2,159,80,239
https://kawalpemilu.org#21270,"KAANA, ENGGANO, BENGKULU UTARA, BENGKULU",2,113,66,179
https://kawalpemilu.org#21271,"KAHYAPU, ENGGANO, BENGKULU UTARA, BENGKULU",1,150,38,188
https://kawalpemilu.org#21271,"KAHYAPU, ENGGANO, BENGKULU UTARA, BENGKULU",2,78,16,94
https://kawalpemilu.org#21272,"APOHO, ENGGANO, BENGKULU UTARA, BENGKULU",1,121,24,145
https://kawalpemilu.org#21274,"LUBUK DURIAN, KERKAP, BENGKULU UTARA, BENGKULU",1,79,105,184
https://kawalpemilu.org#21274,"LUBUK DURIAN, KERKAP, BENGKULU UTARA, BENGKULU",2,71,158,229
https://kawalpemilu.org#21274,"LUBUK DURIAN, KERKAP, BENGKULU UTARA, BENGKULU",3,62,98,160
https://kawalpemilu.org#21275,"TALANG JAMBU, KERKAP, BENGKULU UTARA, BENGKULU",1,57,104,161
https://kawalpemilu.org#21275,"TALANG JAMBU, KERKAP, BENGKULU UTARA, BENGKULU",2,83,86,169
https://kawalpemilu.org#21275,"TALANG JAMBU, KERKAP, BENGKULU UTARA, BENGKULU",3,100,65,165
https://kawalpemilu.org#21276,"TEBAT PACUR, KERKAP, BENGKULU UTARA, BENGKULU",1,56,115,171
https://kawalpemilu.org#21276,"TEBAT PACUR, KERKAP, BENGKULU UTARA, BENGKULU",2,51,126,177
https://kawalpemilu.org#21277,"TALANG CURUP, KERKAP, BENGKULU UTARA, BENGKULU",1,42,127,169
https://kawalpemilu.org#21277,"TALANG CURUP, KERKAP, BENGKULU UTARA, BENGKULU",2,48,100,148
https://kawalpemilu.org#21278,"BANYUMAS, KERKAP, BENGKULU UTARA, BENGKULU",1,93,91,184
https://kawalpemilu.org#21279,"SALAM HARJO, KERKAP, BENGKULU UTARA, BENGKULU",1,93,69,162
https://kawalpemilu.org#21279,"SALAM HARJO, KERKAP, BENGKULU UTARA, BENGKULU",2,66,79,145
https://kawalpemilu.org#21280,"JOGJA BARU, KERKAP, BENGKULU UTARA, BENGKULU",1,115,124,239
https://kawalpemilu.org#21281,"TALANG PASAK, KERKAP, BENGKULU UTARA, BENGKULU",1,56,216,272
https://kawalpemilu.org#21282,"PERBO, KERKAP, BENGKULU UTARA, BENGKULU",1,75,144,219
https://kawalpemilu.org#21282,"PERBO, KERKAP, BENGKULU UTARA, BENGKULU",2,89,140,229
https://kawalpemilu.org#21283,"LUBUK JALE, KERKAP, BENGKULU UTARA, BENGKULU",1,107,123,230
https://kawalpemilu.org#21283,"LUBUK JALE, KERKAP, BENGKULU UTARA, BENGKULU",2,124,76,200
https://kawalpemilu.org#21284,"SIMPANG KETENONG, KERKAP, BENGKULU UTARA, BENGKULU",1,64,87,151
https://kawalpemilu.org#21284,"SIMPANG KETENONG, KERKAP, BENGKULU UTARA, BENGKULU",2,76,103,179
https://kawalpemilu.org#21285,"AUR GADING, KERKAP, BENGKULU UTARA, BENGKULU",1,158,103,261
https://kawalpemilu.org#21285,"AUR GADING, KERKAP, BENGKULU UTARA, BENGKULU",2,168,74,242
https://kawalpemilu.org#21285,"AUR GADING, KERKAP, BENGKULU UTARA, BENGKULU",3,186,53,239
https://kawalpemilu.org#21285,"AUR GADING, KERKAP, BENGKULU UTARA, BENGKULU",4,116,72,188
https://kawalpemilu.org#21285,"AUR GADING, KERKAP, BENGKULU UTARA, BENGKULU",5,144,77,221
https://kawalpemilu.org#21297,"KEDU BARU, KERKAP, BENGKULU UTARA, BENGKULU",1,122,51,173
https://kawalpemilu.org#21299,"SERUMBUNG, KERKAP, BENGKULU UTARA, BENGKULU",1,110,72,182
https://kawalpemilu.org#21299,"SERUMBUNG, KERKAP, BENGKULU UTARA, BENGKULU",2,106,49,155
https://kawalpemilu.org#21300,"MAGELANG, KERKAP, BENGKULU UTARA, BENGKULU",1,103,60,163
https://kawalpemilu.org#21300,"MAGELANG, KERKAP, BENGKULU UTARA, BENGKULU",2,114,54,168
https://kawalpemilu.org#21301,"TANJUNG PUTUS, KERKAP, BENGKULU UTARA, BENGKULU",1,107,98,205
https://kawalpemilu.org#21301,"TANJUNG PUTUS, KERKAP, BENGKULU UTARA, BENGKULU",2,125,110,235
https://kawalpemilu.org#21301,"TANJUNG PUTUS, KERKAP, BENGKULU UTARA, BENGKULU",3,62,106,168
https://kawalpemilu.org#21301,"TANJUNG PUTUS, KERKAP, BENGKULU UTARA, BENGKULU",4,158,29,187
https://kawalpemilu.org#21302,"PENYANGKAK, KERKAP, BENGKULU UTARA, BENGKULU",1,125,123,248
https://kawalpemilu.org#21302,"PENYANGKAK, KERKAP, BENGKULU UTARA, BENGKULU",2,87,115,202
https://kawalpemilu.org#21302,"PENYANGKAK, KERKAP, BENGKULU UTARA, BENGKULU",3,66,95,161
https://kawalpemilu.org#21304,"BANYUMAS BARU, KERKAP, BENGKULU UTARA, BENGKULU",1,56,28,84
https://kawalpemilu.org#21304,"BANYUMAS BARU, KERKAP, BENGKULU UTARA, BENGKULU",2,95,99,194
https://kawalpemilu.org#21304,"BANYUMAS BARU, KERKAP, BENGKULU UTARA, BENGKULU",3,79,83,162
https://kawalpemilu.org#21311,"PURWODADI, ARGA MAKMUR, BENGKULU UTARA, BENGKULU",1,48,134,182
https://kawalpemilu.org#21311,"PURWODADI, ARGA MAKMUR, BENGKULU UTARA, BENGKULU",2,54,191,245
https://kawalpemilu.org#21311,"PURWODADI, ARGA MAKMUR, BENGKULU UTARA, BENGKULU",3,120,136,256
https://kawalpemilu.org#21311,"PURWODADI, ARGA MAKMUR, BENGKULU UTARA, BENGKULU",4,112,117,229
https://kawalpemilu.org#21311,"PURWODADI, ARGA MAKMUR, BENGKULU UTARA, BENGKULU",5,86,119,205
https://kawalpemilu.org#21311,"PURWODADI, ARGA MAKMUR, BENGKULU UTARA, BENGKULU",6,81,138,219
https://kawalpemilu.org#21311,"PURWODADI, ARGA MAKMUR, BENGKULU UTARA, BENGKULU",7,70,211,281
https://kawalpemilu.org#21311,"PURWODADI, ARGA MAKMUR, BENGKULU UTARA, BENGKULU",8,103,149,252
https://kawalpemilu.org#21311,"PURWODADI, ARGA MAKMUR, BENGKULU UTARA, BENGKULU",9,70,195,265
https://kawalpemilu.org#21311,"PURWODADI, ARGA MAKMUR, BENGKULU UTARA, BENGKULU",10,98,118,216
https://kawalpemilu.org#21311,"PURWODADI, ARGA MAKMUR, BENGKULU UTARA, BENGKULU",11,98,175,273
https://kawalpemilu.org#21311,"PURWODADI, ARGA MAKMUR, BENGKULU UTARA, BENGKULU",12,48,197,245
https://kawalpemilu.org#21311,"PURWODADI, ARGA MAKMUR, BENGKULU UTARA, BENGKULU",13,42,127,169
https://kawalpemilu.org#21311,"PURWODADI, ARGA MAKMUR, BENGKULU UTARA, BENGKULU",14,43,117,160
https://kawalpemilu.org#21311,"PURWODADI, ARGA MAKMUR, BENGKULU UTARA, BENGKULU",15,28,134,162
https://kawalpemilu.org#21311,"PURWODADI, ARGA MAKMUR, BENGKULU UTARA, BENGKULU",16,67,117,184
https://kawalpemilu.org#21311,"PURWODADI, ARGA MAKMUR, BENGKULU UTARA, BENGKULU",17,73,105,178
https://kawalpemilu.org#21311,"PURWODADI, ARGA MAKMUR, BENGKULU UTARA, BENGKULU",18,90,107,197
https://kawalpemilu.org#21311,"PURWODADI, ARGA MAKMUR, BENGKULU UTARA, BENGKULU",19,56,142,198
https://kawalpemilu.org#21311,"PURWODADI, ARGA MAKMUR, BENGKULU UTARA, BENGKULU",20,43,150,193
https://kawalpemilu.org#21311,"PURWODADI, ARGA MAKMUR, BENGKULU UTARA, BENGKULU",21,93,142,235
https://kawalpemilu.org#21312,"GUNUNG ALAM, ARGA MAKMUR, BENGKULU UTARA, BENGKULU",1,137,108,245
https://kawalpemilu.org#21312,"GUNUNG ALAM, ARGA MAKMUR, BENGKULU UTARA, BENGKULU",2,115,126,241
https://kawalpemilu.org#21312,"GUNUNG ALAM, ARGA MAKMUR, BENGKULU UTARA, BENGKULU",3,71,143,214
https://kawalpemilu.org#21312,"GUNUNG ALAM, ARGA MAKMUR, BENGKULU UTARA, BENGKULU",4,76,170,246
https://kawalpemilu.org#21312,"GUNUNG ALAM, ARGA MAKMUR, BENGKULU UTARA, BENGKULU",5,38,102,140
https://kawalpemilu.org#21312,"GUNUNG ALAM, ARGA MAKMUR, BENGKULU UTARA, BENGKULU",6,58,89,147
https://kawalpemilu.org#21312,"GUNUNG ALAM, ARGA MAKMUR, BENGKULU UTARA, BENGKULU",7,69,74,143
https://kawalpemilu.org#21312,"GUNUNG ALAM, ARGA MAKMUR, BENGKULU UTARA, BENGKULU",8,64,150,214
https://kawalpemilu.org#21312,"GUNUNG ALAM, ARGA MAKMUR, BENGKULU UTARA, BENGKULU",9,103,167,270
https://kawalpemilu.org#21312,"GUNUNG ALAM, ARGA MAKMUR, BENGKULU UTARA, BENGKULU",10,41,90,131
https://kawalpemilu.org#21312,"GUNUNG ALAM, ARGA MAKMUR, BENGKULU UTARA, BENGKULU",11,92,90,182
https://kawalpemilu.org#21312,"GUNUNG ALAM, ARGA MAKMUR, BENGKULU UTARA, BENGKULU",12,67,71,138
https://kawalpemilu.org#21313,"TANJUNG RAMAN, ARGA MAKMUR, BENGKULU UTARA, BENGKULU",1,98,152,250
https://kawalpemilu.org#21313,"TANJUNG RAMAN, ARGA MAKMUR, BENGKULU UTARA, BENGKULU",2,107,147,254
https://kawalpemilu.org#21313,"TANJUNG RAMAN, ARGA MAKMUR, BENGKULU UTARA, BENGKULU",3,76,80,156
https://kawalpemilu.org#21314,"LUBUK SAHUNG, ARGA MAKMUR, BENGKULU UTARA, BENGKULU",1,97,139,236
https://kawalpemilu.org#21314,"LUBUK SAHUNG, ARGA MAKMUR, BENGKULU UTARA, BENGKULU",2,127,135,262
https://kawalpemilu.org#21314,"LUBUK SAHUNG, ARGA MAKMUR, BENGKULU UTARA, BENGKULU",3,96,171,267
https://kawalpemilu.org#21314,"LUBUK SAHUNG, ARGA MAKMUR, BENGKULU UTARA, BENGKULU",4,78,109,187
https://kawalpemilu.org#21315,"KURO TIDUR, ARGA MAKMUR, BENGKULU UTARA, BENGKULU",1,154,62,216
https://kawalpemilu.org#21315,"KURO TIDUR, ARGA MAKMUR, BENGKULU UTARA, BENGKULU",2,148,89,237
https://kawalpemilu.org#21315,"KURO TIDUR, ARGA MAKMUR, BENGKULU UTARA, BENGKULU",3,143,52,195
https://kawalpemilu.org#21315,"KURO TIDUR, ARGA MAKMUR, BENGKULU UTARA, BENGKULU",4,146,53,199
https://kawalpemilu.org#21315,"KURO TIDUR, ARGA MAKMUR, BENGKULU UTARA, BENGKULU",5,112,13,125
https://kawalpemilu.org#21315,"KURO TIDUR, ARGA MAKMUR, BENGKULU UTARA, BENGKULU",6,171,90,261
https://kawalpemilu.org#21315,"KURO TIDUR, ARGA MAKMUR, BENGKULU UTARA, BENGKULU",7,101,57,158
https://kawalpemilu.org#21315,"KURO TIDUR, ARGA MAKMUR, BENGKULU UTARA, BENGKULU",8,114,49,163
https://kawalpemilu.org#21316,"KARANG SUCI, ARGA MAKMUR, BENGKULU UTARA, BENGKULU",1,60,208,268
https://kawalpemilu.org#21316,"KARANG SUCI, ARGA MAKMUR, BENGKULU UTARA, BENGKULU",2,61,209,270
https://kawalpemilu.org#21316,"KARANG SUCI, ARGA MAKMUR, BENGKULU UTARA, BENGKULU",3,85,160,245
https://kawalpemilu.org#21316,"KARANG SUCI, ARGA MAKMUR, BENGKULU UTARA, BENGKULU",4,94,164,258
https://kawalpemilu.org#21316,"KARANG SUCI, ARGA MAKMUR, BENGKULU UTARA, BENGKULU",5,78,98,176
https://kawalpemilu.org#21316,"KARANG SUCI, ARGA MAKMUR, BENGKULU UTARA, BENGKULU",6,109,114,223
https://kawalpemilu.org#21316,"KARANG SUCI, ARGA MAKMUR, BENGKULU UTARA, BENGKULU",7,64,101,165
https://kawalpemilu.org#21316,"KARANG SUCI, ARGA MAKMUR, BENGKULU UTARA, BENGKULU",8,88,101,189
https://kawalpemilu.org#21316,"KARANG SUCI, ARGA MAKMUR, BENGKULU UTARA, BENGKULU",9,51,181,232
https://kawalpemilu.org#21317,"RAMA AGUNG, ARGA MAKMUR, BENGKULU UTARA, BENGKULU",1,191,49,240
https://kawalpemilu.org#21317,"RAMA AGUNG, ARGA MAKMUR, BENGKULU UTARA, BENGKULU",2,193,32,225
https://kawalpemilu.org#21317,"RAMA AGUNG, ARGA MAKMUR, BENGKULU UTARA, BENGKULU",3,147,13,160
https://kawalpemilu.org#21317,"RAMA AGUNG, ARGA MAKMUR, BENGKULU UTARA, BENGKULU",4,165,31,196
https://kawalpemilu.org#21317,"RAMA AGUNG, ARGA MAKMUR, BENGKULU UTARA, BENGKULU",5,146,38,184
https://kawalpemilu.org#21317,"RAMA AGUNG, ARGA MAKMUR, BENGKULU UTARA, BENGKULU",6,100,69,169
https://kawalpemilu.org#21317,"RAMA AGUNG, ARGA MAKMUR, BENGKULU UTARA, BENGKULU",7,106,51,157
https://kawalpemilu.org#21317,"RAMA AGUNG, ARGA MAKMUR, BENGKULU UTARA, BENGKULU",8,86,106,192
https://kawalpemilu.org#21317,"RAMA AGUNG, ARGA MAKMUR, BENGKULU UTARA, BENGKULU",9,110,62,172
https://kawalpemilu.org#21320,"TALANG DENAU, ARGA MAKMUR, BENGKULU UTARA, BENGKULU",1,119,115,234
https://kawalpemilu.org#21321,"GUNUNG SELAN, ARGA MAKMUR, BENGKULU UTARA, BENGKULU",1,78,159,237
https://kawalpemilu.org#21321,"GUNUNG SELAN, ARGA MAKMUR, BENGKULU UTARA, BENGKULU",2,103,148,251
https://kawalpemilu.org#21321,"GUNUNG SELAN, ARGA MAKMUR, BENGKULU UTARA, BENGKULU",3,104,174,278
https://kawalpemilu.org#21321,"GUNUNG SELAN, ARGA MAKMUR, BENGKULU UTARA, BENGKULU",4,103,145,248
https://kawalpemilu.org#21321,"GUNUNG SELAN, ARGA MAKMUR, BENGKULU UTARA, BENGKULU",5,106,142,248
https://kawalpemilu.org#21321,"GUNUNG SELAN, ARGA MAKMUR, BENGKULU UTARA, BENGKULU",6,85,102,187
https://kawalpemilu.org#21321,"GUNUNG SELAN, ARGA MAKMUR, BENGKULU UTARA, BENGKULU",7,93,101,194
https://kawalpemilu.org#21322,"DATAR RUYUNG, ARGA MAKMUR, BENGKULU UTARA, BENGKULU",1,98,139,237
https://kawalpemilu.org#21322,"DATAR RUYUNG, ARGA MAKMUR, BENGKULU UTARA, BENGKULU",2,104,116,220
https://kawalpemilu.org#21323,"SENALI, ARGA MAKMUR, BENGKULU UTARA, BENGKULU",1,121,89,210
https://kawalpemilu.org#21323,"SENALI, ARGA MAKMUR, BENGKULU UTARA, BENGKULU",2,87,127,214
https://kawalpemilu.org#21323,"SENALI, ARGA MAKMUR, BENGKULU UTARA, BENGKULU",3,101,120,221
https://kawalpemilu.org#21323,"SENALI, ARGA MAKMUR, BENGKULU UTARA, BENGKULU",4,94,103,197
https://kawalpemilu.org#21324,"GUNUNG AGUNG, ARGA MAKMUR, BENGKULU UTARA, BENGKULU",1,82,155,237
https://kawalpemilu.org#21324,"GUNUNG AGUNG, ARGA MAKMUR, BENGKULU UTARA, BENGKULU",2,105,125,230
https://kawalpemilu.org#21324,"GUNUNG AGUNG, ARGA MAKMUR, BENGKULU UTARA, BENGKULU",3,62,142,204
https://kawalpemilu.org#21324,"GUNUNG AGUNG, ARGA MAKMUR, BENGKULU UTARA, BENGKULU",4,100,111,211
https://kawalpemilu.org#21324,"GUNUNG AGUNG, ARGA MAKMUR, BENGKULU UTARA, BENGKULU",5,51,127,178
https://kawalpemilu.org#21324,"GUNUNG AGUNG, ARGA MAKMUR, BENGKULU UTARA, BENGKULU",6,72,117,189
https://kawalpemilu.org#21324,"GUNUNG AGUNG, ARGA MAKMUR, BENGKULU UTARA, BENGKULU",7,69,95,164
https://kawalpemilu.org#21324,"GUNUNG AGUNG, ARGA MAKMUR, BENGKULU UTARA, BENGKULU",8,25,65,90
https://kawalpemilu.org#21326,"SIDO URIP, ARGA MAKMUR, BENGKULU UTARA, BENGKULU",1,150,60,210
https://kawalpemilu.org#21326,"SIDO URIP, ARGA MAKMUR, BENGKULU UTARA, BENGKULU",2,132,65,197
https://kawalpemilu.org#21326,"SIDO URIP, ARGA MAKMUR, BENGKULU UTARA, BENGKULU",3,163,71,234
https://kawalpemilu.org#21326,"SIDO URIP, ARGA MAKMUR, BENGKULU UTARA, BENGKULU",4,157,103,260
https://kawalpemilu.org#21326,"SIDO URIP, ARGA MAKMUR, BENGKULU UTARA, BENGKULU",5,152,114,266
https://kawalpemilu.org#21327,"KARANG ANYAR I, ARGA MAKMUR, BENGKULU UTARA, BENGKULU",1,94,120,214
https://kawalpemilu.org#21327,"KARANG ANYAR I, ARGA MAKMUR, BENGKULU UTARA, BENGKULU",2,50,159,209
https://kawalpemilu.org#21327,"KARANG ANYAR I, ARGA MAKMUR, BENGKULU UTARA, BENGKULU",3,43,129,172
https://kawalpemilu.org#21327,"KARANG ANYAR I, ARGA MAKMUR, BENGKULU UTARA, BENGKULU",4,80,173,253
https://kawalpemilu.org#21327,"KARANG ANYAR I, ARGA MAKMUR, BENGKULU UTARA, BENGKULU",5,50,153,203
https://kawalpemilu.org#21327,"KARANG ANYAR I, ARGA MAKMUR, BENGKULU UTARA, BENGKULU",6,47,147,194
https://kawalpemilu.org#21328,"TABA TEMBILANG, ARGA MAKMUR, BENGKULU UTARA, BENGKULU",1,124,148,272
https://kawalpemilu.org#21328,"TABA TEMBILANG, ARGA MAKMUR, BENGKULU UTARA, BENGKULU",2,116,150,266
https://kawalpemilu.org#21328,"TABA TEMBILANG, ARGA MAKMUR, BENGKULU UTARA, BENGKULU",3,102,126,228
https://kawalpemilu.org#21328,"TABA TEMBILANG, ARGA MAKMUR, BENGKULU UTARA, BENGKULU",4,112,100,214
https://kawalpemilu.org#21328,"TABA TEMBILANG, ARGA MAKMUR, BENGKULU UTARA, BENGKULU",5,98,136,234
https://kawalpemilu.org#21328,"TABA TEMBILANG, ARGA MAKMUR, BENGKULU UTARA, BENGKULU",6,71,67,138
https://kawalpemilu.org#21328,"TABA TEMBILANG, ARGA MAKMUR, BENGKULU UTARA, BENGKULU",7,90,119,209
https://kawalpemilu.org#21328,"TABA TEMBILANG, ARGA MAKMUR, BENGKULU UTARA, BENGKULU",8,91,103,194
https://kawalpemilu.org#21334,"KARANG ANYAR II, ARGA MAKMUR, BENGKULU UTARA, BENGKULU",1,60,149,209
https://kawalpemilu.org#21334,"KARANG ANYAR II, ARGA MAKMUR, BENGKULU UTARA, BENGKULU",2,85,140,225
https://kawalpemilu.org#21334,"KARANG ANYAR II, ARGA MAKMUR, BENGKULU UTARA, BENGKULU",3,69,169,238
https://kawalpemilu.org#21334,"KARANG ANYAR II, ARGA MAKMUR, BENGKULU UTARA, BENGKULU",4,106,153,259
https://kawalpemilu.org#21334,"KARANG ANYAR II, ARGA MAKMUR, BENGKULU UTARA, BENGKULU",5,67,181,248
https://kawalpemilu.org#21334,"KARANG ANYAR II, ARGA MAKMUR, BENGKULU UTARA, BENGKULU",6,97,155,252
https://kawalpemilu.org#21334,"KARANG ANYAR II, ARGA MAKMUR, BENGKULU UTARA, BENGKULU",7,78,206,284
https://kawalpemilu.org#21334,"KARANG ANYAR II, ARGA MAKMUR, BENGKULU UTARA, BENGKULU",8,96,92,188
https://kawalpemilu.org#21334,"KARANG ANYAR II, ARGA MAKMUR, BENGKULU UTARA, BENGKULU",9,64,97,161
https://kawalpemilu.org#21340,"TANJUNG ANOM, GIRI MULYA, BENGKULU UTARA, BENGKULU",1,196,54,250
https://kawalpemilu.org#21340,"TANJUNG ANOM, GIRI MULYA, BENGKULU UTARA, BENGKULU",2,206,53,259
https://kawalpemilu.org#21340,"TANJUNG ANOM, GIRI MULYA, BENGKULU UTARA, BENGKULU",3,236,28,264
https://kawalpemilu.org#21340,"TANJUNG ANOM, GIRI MULYA, BENGKULU UTARA, BENGKULU",4,181,35,216
https://kawalpemilu.org#21340,"TANJUNG ANOM, GIRI MULYA, BENGKULU UTARA, BENGKULU",5,149,49,198
https://kawalpemilu.org#21340,"TANJUNG ANOM, GIRI MULYA, BENGKULU UTARA, BENGKULU",6,178,12,190
https://kawalpemilu.org#21340,"TANJUNG ANOM, GIRI MULYA, BENGKULU UTARA, BENGKULU",7,56,47,103
https://kawalpemilu.org#21340,"TANJUNG ANOM, GIRI MULYA, BENGKULU UTARA, BENGKULU",8,151,47,198
https://kawalpemilu.org#21341,"SUKA MAKMUR, GIRI MULYA, BENGKULU UTARA, BENGKULU",1,219,54,273
https://kawalpemilu.org#21341,"SUKA MAKMUR, GIRI MULYA, BENGKULU UTARA, BENGKULU",2,167,80,247
https://kawalpemilu.org#21341,"SUKA MAKMUR, GIRI MULYA, BENGKULU UTARA, BENGKULU",3,184,76,260
https://kawalpemilu.org#21341,"SUKA MAKMUR, GIRI MULYA, BENGKULU UTARA, BENGKULU",4,196,54,250
https://kawalpemilu.org#21341,"SUKA MAKMUR, GIRI MULYA, BENGKULU UTARA, BENGKULU",5,217,40,257
https://kawalpemilu.org#21341,"SUKA MAKMUR, GIRI MULYA, BENGKULU UTARA, BENGKULU",6,174,55,229
https://kawalpemilu.org#21341,"SUKA MAKMUR, GIRI MULYA, BENGKULU UTARA, BENGKULU",7,189,19,208
https://kawalpemilu.org#21341,"SUKA MAKMUR, GIRI MULYA, BENGKULU UTARA, BENGKULU",8,179,51,230
https://kawalpemilu.org#21341,"SUKA MAKMUR, GIRI MULYA, BENGKULU UTARA, BENGKULU",9,92,22,114
https://kawalpemilu.org#21342,"WONO HARJO, GIRI MULYA, BENGKULU UTARA, BENGKULU",1,195,44,269
https://kawalpemilu.org#21342,"WONO HARJO, GIRI MULYA, BENGKULU UTARA, BENGKULU",2,185,59,244
https://kawalpemilu.org#21342,"WONO HARJO, GIRI MULYA, BENGKULU UTARA, BENGKULU",3,187,89,276
https://kawalpemilu.org#21342,"WONO HARJO, GIRI MULYA, BENGKULU UTARA, BENGKULU",4,167,76,243
https://kawalpemilu.org#21342,"WONO HARJO, GIRI MULYA, BENGKULU UTARA, BENGKULU",5,156,88,244
https://kawalpemilu.org#21342,"WONO HARJO, GIRI MULYA, BENGKULU UTARA, BENGKULU",6,208,47,255
https://kawalpemilu.org#21342,"WONO HARJO, GIRI MULYA, BENGKULU UTARA, BENGKULU",7,191,54,245
https://kawalpemilu.org#21343,"GIRI MULYA, GIRI MULYA, BENGKULU UTARA, BENGKULU",1,154,65,219
https://kawalpemilu.org#21343,"GIRI MULYA, GIRI MULYA, BENGKULU UTARA, BENGKULU",2,173,78,251
https://kawalpemilu.org#21343,"GIRI MULYA, GIRI MULYA, BENGKULU UTARA, BENGKULU",3,166,65,231
https://kawalpemilu.org#21343,"GIRI MULYA, GIRI MULYA, BENGKULU UTARA, BENGKULU",4,150,64,214
https://kawalpemilu.org#21343,"GIRI MULYA, GIRI MULYA, BENGKULU UTARA, BENGKULU",5,188,37,225
https://kawalpemilu.org#21343,"GIRI MULYA, GIRI MULYA, BENGKULU UTARA, BENGKULU",6,180,27,207
https://kawalpemilu.org#21343,"GIRI MULYA, GIRI MULYA, BENGKULU UTARA, BENGKULU",7,175,36,211
https://kawalpemilu.org#21343,"GIRI MULYA, GIRI MULYA, BENGKULU UTARA, BENGKULU",8,176,24,200
https://kawalpemilu.org#21343,"GIRI MULYA, GIRI MULYA, BENGKULU UTARA, BENGKULU",9,210,20,230
https://kawalpemilu.org#21343,"GIRI MULYA, GIRI MULYA, BENGKULU UTARA, BENGKULU",10,194,38,232
https://kawalpemilu.org#21344,"RENA JAYA, GIRI MULYA, BENGKULU UTARA, BENGKULU",1,163,55,218
https://kawalpemilu.org#21344,"RENA JAYA, GIRI MULYA, BENGKULU UTARA, BENGKULU",2,128,105,233
https://kawalpemilu.org#21344,"RENA JAYA, GIRI MULYA, BENGKULU UTARA, BENGKULU",3,155,78,233
https://kawalpemilu.org#21344,"RENA JAYA, GIRI MULYA, BENGKULU UTARA, BENGKULU",4,112,46,158
https://kawalpemilu.org#21344,"RENA JAYA, GIRI MULYA, BENGKULU UTARA, BENGKULU",5,163,52,215
https://kawalpemilu.org#21344,"RENA JAYA, GIRI MULYA, BENGKULU UTARA, BENGKULU",6,123,23,146
https://kawalpemilu.org#87338,"SUKA MULYA, GIRI MULYA, BENGKULU UTARA, BENGKULU",1,94,32,126
https://kawalpemilu.org#87338,"SUKA MULYA, GIRI MULYA, BENGKULU UTARA, BENGKULU",2,57,6,63
https://kawalpemilu.org#87338,"SUKA MULYA, GIRI MULYA, BENGKULU UTARA, BENGKULU",3,155,31,186
https://kawalpemilu.org#87338,"SUKA MULYA, GIRI MULYA, BENGKULU UTARA, BENGKULU",4,146,15,161
https://kawalpemilu.org#21346,"LUBUK BANYAU, PADANG JAYA, BENGKULU UTARA, BENGKULU",1,126,99,225
https://kawalpemilu.org#21346,"LUBUK BANYAU, PADANG JAYA, BENGKULU UTARA, BENGKULU",2,150,54,204
https://kawalpemilu.org#21346,"LUBUK BANYAU, PADANG JAYA, BENGKULU UTARA, BENGKULU",3,139,105,244
https://kawalpemilu.org#21346,"LUBUK BANYAU, PADANG JAYA, BENGKULU UTARA, BENGKULU",4,94,118,212
https://kawalpemilu.org#21346,"LUBUK BANYAU, PADANG JAYA, BENGKULU UTARA, BENGKULU",5,73,24,97
https://kawalpemilu.org#21347,"TALANG TUA, PADANG JAYA, BENGKULU UTARA, BENGKULU",1,72,115,187
https://kawalpemilu.org#21347,"TALANG TUA, PADANG JAYA, BENGKULU UTARA, BENGKULU",2,77,48,125
https://kawalpemilu.org#21347,"TALANG TUA, PADANG JAYA, BENGKULU UTARA, BENGKULU",3,58,0,58
https://kawalpemilu.org#21347,"TALANG TUA, PADANG JAYA, BENGKULU UTARA, BENGKULU",4,117,11,128
https://kawalpemilu.org#21348,"MARGA SAKTI, PADANG JAYA, BENGKULU UTARA, BENGKULU",1,132,103,235
https://kawalpemilu.org#21348,"MARGA SAKTI, PADANG JAYA, BENGKULU UTARA, BENGKULU",2,128,57,185
https://kawalpemilu.org#21348,"MARGA SAKTI, PADANG JAYA, BENGKULU UTARA, BENGKULU",3,133,81,214
https://kawalpemilu.org#21348,"MARGA SAKTI, PADANG JAYA, BENGKULU UTARA, BENGKULU",4,134,117,251
https://kawalpemilu.org#21348,"MARGA SAKTI, PADANG JAYA, BENGKULU UTARA, BENGKULU",5,101,149,250
https://kawalpemilu.org#21348,"MARGA SAKTI, PADANG JAYA, BENGKULU UTARA, BENGKULU",6,161,56,217
https://kawalpemilu.org#21348,"MARGA SAKTI, PADANG JAYA, BENGKULU UTARA, BENGKULU",7,122,114,236
https://kawalpemilu.org#21348,"MARGA SAKTI, PADANG JAYA, BENGKULU UTARA, BENGKULU",8,147,84,231
https://kawalpemilu.org#21348,"MARGA SAKTI, PADANG JAYA, BENGKULU UTARA, BENGKULU",9,158,75,233
https://kawalpemilu.org#21348,"MARGA SAKTI, PADANG JAYA, BENGKULU UTARA, BENGKULU",10,210,30,240
https://kawalpemilu.org#21348,"MARGA SAKTI, PADANG JAYA, BENGKULU UTARA, BENGKULU",11,143,61,204
https://kawalpemilu.org#21348,"MARGA SAKTI, PADANG JAYA, BENGKULU UTARA, BENGKULU",12,183,67,250
https://kawalpemilu.org#21348,"MARGA SAKTI, PADANG JAYA, BENGKULU UTARA, BENGKULU",13,144,61,205
https://kawalpemilu.org#21348,"MARGA SAKTI, PADANG JAYA, BENGKULU UTARA, BENGKULU",14,193,41,234
https://kawalpemilu.org#21348,"MARGA SAKTI, PADANG JAYA, BENGKULU UTARA, BENGKULU",15,126,137,263
https://kawalpemilu.org#21348,"MARGA SAKTI, PADANG JAYA, BENGKULU UTARA, BENGKULU",16,137,49,186
https://kawalpemilu.org#21349,"TANJUNG HARAPAN, PADANG JAYA, BENGKULU UTARA, BENGKULU",1,204,37,241
https://kawalpemilu.org#21349,"TANJUNG HARAPAN, PADANG JAYA, BENGKULU UTARA, BENGKULU",2,176,58,234
https://kawalpemilu.org#21349,"TANJUNG HARAPAN, PADANG JAYA, BENGKULU UTARA, BENGKULU",3,162,76,238
https://kawalpemilu.org#21349,"TANJUNG HARAPAN, PADANG JAYA, BENGKULU UTARA, BENGKULU",4,133,85,218
https://kawalpemilu.org#21349,"TANJUNG HARAPAN, PADANG JAYA, BENGKULU UTARA, BENGKULU",5,188,45,233
https://kawalpemilu.org#21349,"TANJUNG HARAPAN, PADANG JAYA, BENGKULU UTARA, BENGKULU",6,137,61,198
https://kawalpemilu.org#21350,"PADANG JAYA, PADANG JAYA, BENGKULU UTARA, BENGKULU",1,138,64,202
https://kawalpemilu.org#21350,"PADANG JAYA, PADANG JAYA, BENGKULU UTARA, BENGKULU",2,148,71,219
https://kawalpemilu.org#21350,"PADANG JAYA, PADANG JAYA, BENGKULU UTARA, BENGKULU",3,0,0,0
https://kawalpemilu.org#21350,"PADANG JAYA, PADANG JAYA, BENGKULU UTARA, BENGKULU",4,105,97,202
https://kawalpemilu.org#21350,"PADANG JAYA, PADANG JAYA, BENGKULU UTARA, BENGKULU",5,136,61,197
https://kawalpemilu.org#21350,"PADANG JAYA, PADANG JAYA, BENGKULU UTARA, BENGKULU",6,143,75,218
https://kawalpemilu.org#21350,"PADANG JAYA, PADANG JAYA, BENGKULU UTARA, BENGKULU",7,129,61,190
https://kawalpemilu.org#21350,"PADANG JAYA, PADANG JAYA, BENGKULU UTARA, BENGKULU",8,161,50,211
https://kawalpemilu.org#21350,"PADANG JAYA, PADANG JAYA, BENGKULU UTARA, BENGKULU",9,181,35,216
https://kawalpemilu.org#21350,"PADANG JAYA, PADANG JAYA, BENGKULU UTARA, BENGKULU",10,169,53,222
https://kawalpemilu.org#21350,"PADANG JAYA, PADANG JAYA, BENGKULU UTARA, BENGKULU",11,147,40,187
https://kawalpemilu.org#21350,"PADANG JAYA, PADANG JAYA, BENGKULU UTARA, BENGKULU",12,173,60,233
https://kawalpemilu.org#21350,"PADANG JAYA, PADANG JAYA, BENGKULU UTARA, BENGKULU",13,130,84,214
https://kawalpemilu.org#21350,"PADANG JAYA, PADANG JAYA, BENGKULU UTARA, BENGKULU",14,148,55,203
https://kawalpemilu.org#21350,"PADANG JAYA, PADANG JAYA, BENGKULU UTARA, BENGKULU",15,167,73,240
https://kawalpemilu.org#21351,"ARGA MULYA, PADANG JAYA, BENGKULU UTARA, BENGKULU",1,148,81,229
https://kawalpemilu.org#21351,"ARGA MULYA, PADANG JAYA, BENGKULU UTARA, BENGKULU",2,155,55,210
https://kawalpemilu.org#21351,"ARGA MULYA, PADANG JAYA, BENGKULU UTARA, BENGKULU",3,169,90,259
https://kawalpemilu.org#21351,"ARGA MULYA, PADANG JAYA, BENGKULU UTARA, BENGKULU",4,151,72,223
https://kawalpemilu.org#21351,"ARGA MULYA, PADANG JAYA, BENGKULU UTARA, BENGKULU",5,104,70,174
https://kawalpemilu.org#21351,"ARGA MULYA, PADANG JAYA, BENGKULU UTARA, BENGKULU",6,160,44,204
https://kawalpemilu.org#21351,"ARGA MULYA, PADANG JAYA, BENGKULU UTARA, BENGKULU",7,219,40,259
https://kawalpemilu.org#21351,"ARGA MULYA, PADANG JAYA, BENGKULU UTARA, BENGKULU",8,183,55,238
https://kawalpemilu.org#21351,"ARGA MULYA, PADANG JAYA, BENGKULU UTARA, BENGKULU",9,176,73,249
https://kawalpemilu.org#21352,"SIDO MUKTI, PADANG JAYA, BENGKULU UTARA, BENGKULU",1,116,129,245
https://kawalpemilu.org#21352,"SIDO MUKTI, PADANG JAYA, BENGKULU UTARA, BENGKULU",2,118,103,221
https://kawalpemilu.org#21352,"SIDO MUKTI, PADANG JAYA, BENGKULU UTARA, BENGKULU",3,175,50,225
https://kawalpemilu.org#21352,"SIDO MUKTI, PADANG JAYA, BENGKULU UTARA, BENGKULU",4,140,84,224
https://kawalpemilu.org#21352,"SIDO MUKTI, PADANG JAYA, BENGKULU UTARA, BENGKULU",5,154,65,219
https://kawalpemilu.org#21352,"SIDO MUKTI, PADANG JAYA, BENGKULU UTARA, BENGKULU",6,93,88,181
https://kawalpemilu.org#21352,"SIDO MUKTI, PADANG JAYA, BENGKULU UTARA, BENGKULU",7,197,59,256
https://kawalpemilu.org#21352,"SIDO MUKTI, PADANG JAYA, BENGKULU UTARA, BENGKULU",8,132,86,218
https://kawalpemilu.org#21352,"SIDO MUKTI, PADANG JAYA, BENGKULU UTARA, BENGKULU",9,171,30,201
https://kawalpemilu.org#21353,"TANAH HITAM, PADANG JAYA, BENGKULU UTARA, BENGKULU",1,199,48,247
https://kawalpemilu.org#21353,"TANAH HITAM, PADANG JAYA, BENGKULU UTARA, BENGKULU",2,196,56,252
https://kawalpemilu.org#21353,"TANAH HITAM, PADANG JAYA, BENGKULU UTARA, BENGKULU",3,166,43,209
https://kawalpemilu.org#21354,"MARGA JAYA, PADANG JAYA, BENGKULU UTARA, BENGKULU",1,100,57,157
https://kawalpemilu.org#21354,"MARGA JAYA, PADANG JAYA, BENGKULU UTARA, BENGKULU",2,169,44,213
https://kawalpemilu.org#21354,"MARGA JAYA, PADANG JAYA, BENGKULU UTARA, BENGKULU",3,0,0,0
https://kawalpemilu.org#21354,"MARGA JAYA, PADANG JAYA, BENGKULU UTARA, BENGKULU",4,152,37,189
https://kawalpemilu.org#21355,"TAMBAK REJO, PADANG JAYA, BENGKULU UTARA, BENGKULU",1,180,82,262
https://kawalpemilu.org#21355,"TAMBAK REJO, PADANG JAYA, BENGKULU UTARA, BENGKULU",2,210,45,255
https://kawalpemilu.org#21355,"TAMBAK REJO, PADANG JAYA, BENGKULU UTARA, BENGKULU",3,158,77,235
https://kawalpemilu.org#21355,"TAMBAK REJO, PADANG JAYA, BENGKULU UTARA, BENGKULU",4,178,67,245
https://kawalpemilu.org#21355,"TAMBAK REJO, PADANG JAYA, BENGKULU UTARA, BENGKULU",5,193,71,264
https://kawalpemilu.org#21355,"TAMBAK REJO, PADANG JAYA, BENGKULU UTARA, BENGKULU",6,171,91,262
https://kawalpemilu.org#87339,"SIDO LUHUR, PADANG JAYA, BENGKULU UTARA, BENGKULU",1,168,49,217
https://kawalpemilu.org#87339,"SIDO LUHUR, PADANG JAYA, BENGKULU UTARA, BENGKULU",2,145,67,212
https://kawalpemilu.org#87339,"SIDO LUHUR, PADANG JAYA, BENGKULU UTARA, BENGKULU",3,175,80,255
https://kawalpemilu.org#87339,"SIDO LUHUR, PADANG JAYA, BENGKULU UTARA, BENGKULU",4,124,60,184
https://kawalpemilu.org#87340,"TANAH TINGGI, PADANG JAYA, BENGKULU UTARA, BENGKULU",1,130,65,195
https://kawalpemilu.org#87340,"TANAH TINGGI, PADANG JAYA, BENGKULU UTARA, BENGKULU",2,172,72,244
https://kawalpemilu.org#87340,"TANAH TINGGI, PADANG JAYA, BENGKULU UTARA, BENGKULU",3,129,61,190
https://kawalpemilu.org#87340,"TANAH TINGGI, PADANG JAYA, BENGKULU UTARA, BENGKULU",4,145,78,223
https://kawalpemilu.org#21357,"PASAR LAIS, LAIS, BENGKULU UTARA, BENGKULU",1,117,146,263
https://kawalpemilu.org#21357,"PASAR LAIS, LAIS, BENGKULU UTARA, BENGKULU",2,140,102,242
https://kawalpemilu.org#21365,"DATAR LEBAR, LAIS, BENGKULU UTARA, BENGKULU",1,122,81,203
https://kawalpemilu.org#21366,"AIR PADANG, LAIS, BENGKULU UTARA, BENGKULU",1,124,76,200
https://kawalpemilu.org#21367,"DURIAN DAUN, LAIS, BENGKULU UTARA, BENGKULU",1,110,88,198
https://kawalpemilu.org#21367,"DURIAN DAUN, LAIS, BENGKULU UTARA, BENGKULU",2,108,90,198
https://kawalpemilu.org#21368,"DUSUN RAJA, LAIS, BENGKULU UTARA, BENGKULU",1,82,99,181
https://kawalpemilu.org#21368,"DUSUN RAJA, LAIS, BENGKULU UTARA, BENGKULU",2,85,95,180
https://kawalpemilu.org#21369,"LUBUK LESUNG, LAIS, BENGKULU UTARA, BENGKULU",1,86,131,217
https://kawalpemilu.org#21370,"PAL 30, LAIS, BENGKULU UTARA, BENGKULU",1,126,122,248
https://kawalpemilu.org#21370,"PAL 30, LAIS, BENGKULU UTARA, BENGKULU",2,46,79,125
https://kawalpemilu.org#21370,"PAL 30, LAIS, BENGKULU UTARA, BENGKULU",3,115,167,282
https://kawalpemilu.org#21370,"PAL 30, LAIS, BENGKULU UTARA, BENGKULU",4,85,112,197
https://kawalpemilu.org#21371,"JAGOBAYO, LAIS, BENGKULU UTARA, BENGKULU",1,64,158,222
https://kawalpemilu.org#21371,"JAGOBAYO, LAIS, BENGKULU UTARA, BENGKULU",2,74,130,204
https://kawalpemilu.org#21371,"JAGOBAYO, LAIS, BENGKULU UTARA, BENGKULU",3,61,185,246
https://kawalpemilu.org#21371,"JAGOBAYO, LAIS, BENGKULU UTARA, BENGKULU",4,62,146,208
https://kawalpemilu.org#21373,"TALANG RASAU, LAIS, BENGKULU UTARA, BENGKULU",1,94,138,232
https://kawalpemilu.org#21373,"TALANG RASAU, LAIS, BENGKULU UTARA, BENGKULU",2,92,137,229
https://kawalpemilu.org#21373,"TALANG RASAU, LAIS, BENGKULU UTARA, BENGKULU",3,84,154,238
https://kawalpemilu.org#21373,"TALANG RASAU, LAIS, BENGKULU UTARA, BENGKULU",5,55,148,203
https://kawalpemilu.org#21373,"TALANG RASAU, LAIS, BENGKULU UTARA, BENGKULU",6,45,97,142
https://kawalpemilu.org#21374,"LUBUK GEDANG, LAIS, BENGKULU UTARA, BENGKULU",1,88,153,241
https://kawalpemilu.org#21374,"LUBUK GEDANG, LAIS, BENGKULU UTARA, BENGKULU",2,102,131,233
https://kawalpemilu.org#21374,"LUBUK GEDANG, LAIS, BENGKULU UTARA, BENGKULU",3,74,101,175
https://kawalpemilu.org#21374,"LUBUK GEDANG, LAIS, BENGKULU UTARA, BENGKULU",4,111,124,235
https://kawalpemilu.org#21374,"LUBUK GEDANG, LAIS, BENGKULU UTARA, BENGKULU",5,99,108,207
https://kawalpemilu.org#21375,"SUKA LANGU, LAIS, BENGKULU UTARA, BENGKULU",1,51,135,186
https://kawalpemilu.org#21376,"TABA BARU, LAIS, BENGKULU UTARA, BENGKULU",1,60,149,209
https://kawalpemilu.org#21376,"TABA BARU, LAIS, BENGKULU UTARA, BENGKULU",2,55,169,224
https://kawalpemilu.org#21376,"TABA BARU, LAIS, BENGKULU UTARA, BENGKULU",3,35,186,221
https://kawalpemilu.org#21376,"TABA BARU, LAIS, BENGKULU UTARA, BENGKULU",4,34,195,229
https://kawalpemilu.org#21376,"TABA BARU, LAIS, BENGKULU UTARA, BENGKULU",5,58,169,227
https://kawalpemilu.org#21376,"TABA BARU, LAIS, BENGKULU UTARA, BENGKULU",6,36,171,207
https://kawalpemilu.org#21377,"KALBANG, LAIS, BENGKULU UTARA, BENGKULU",1,68,111,179
https://kawalpemilu.org#21377,"KALBANG, LAIS, BENGKULU UTARA, BENGKULU",2,89,97,186
https://kawalpemilu.org#21381,"SERANGAI, BATIK NAU, BENGKULU UTARA, BENGKULU",1,84,107,191
https://kawalpemilu.org#21381,"SERANGAI, BATIK NAU, BENGKULU UTARA, BENGKULU",2,189,55,244
https://kawalpemilu.org#21381,"SERANGAI, BATIK NAU, BENGKULU UTARA, BENGKULU",3,89,123,212
https://kawalpemilu.org#21382,"SELOLONG, BATIK NAU, BENGKULU UTARA, BENGKULU",1,110,102,212
https://kawalpemilu.org#21382,"SELOLONG, BATIK NAU, BENGKULU UTARA, BENGKULU",2,182,66,248
https://kawalpemilu.org#21383,"AIR LAKOK, BATIK NAU, BENGKULU UTARA, BENGKULU",1,94,131,225
https://kawalpemilu.org#21383,"AIR LAKOK, BATIK NAU, BENGKULU UTARA, BENGKULU",2,42,130,172
https://kawalpemilu.org#21384,"BINTUNAN, BATIK NAU, BENGKULU UTARA, BENGKULU",1,151,31,182
https://kawalpemilu.org#21384,"BINTUNAN, BATIK NAU, BENGKULU UTARA, BENGKULU",2,80,49,129
https://kawalpemilu.org#21384,"BINTUNAN, BATIK NAU, BENGKULU UTARA, BENGKULU",3,91,58,149
https://kawalpemilu.org#21385,"SUKA MARGA, BATIK NAU, BENGKULU UTARA, BENGKULU",1,63,94,157
https://kawalpemilu.org#21386,"BATIK NAU, BATIK NAU, BENGKULU UTARA, BENGKULU",1,134,124,258
https://kawalpemilu.org#21386,"BATIK NAU, BATIK NAU, BENGKULU UTARA, BENGKULU",2,167,74,241
https://kawalpemilu.org#21387,"PAGAR RUYUNG, BATIK NAU, BENGKULU UTARA, BENGKULU",1,105,90,195
https://kawalpemilu.org#21387,"PAGAR RUYUNG, BATIK NAU, BENGKULU UTARA, BENGKULU",2,82,79,161
https://kawalpemilu.org#21388,"DURIAN AMPARAN, BATIK NAU, BENGKULU UTARA, BENGKULU",1,100,60,160
https://kawalpemilu.org#21388,"DURIAN AMPARAN, BATIK NAU, BENGKULU UTARA, BENGKULU",2,124,104,228
https://kawalpemilu.org#21388,"DURIAN AMPARAN, BATIK NAU, BENGKULU UTARA, BENGKULU",3,67,41,108
https://kawalpemilu.org#21388,"DURIAN AMPARAN, BATIK NAU, BENGKULU UTARA, BENGKULU",4,124,25,149
https://kawalpemilu.org#21389,"TABA KELINTANG, BATIK NAU, BENGKULU UTARA, BENGKULU",1,72,63,135
https://kawalpemilu.org#21389,"TABA KELINTANG, BATIK NAU, BENGKULU UTARA, BENGKULU",2,87,50,137
https://kawalpemilu.org#21390,"ULAK TANDING, BATIK NAU, BENGKULU UTARA, BENGKULU",1,72,83,155
https://kawalpemilu.org#21390,"ULAK TANDING, BATIK NAU, BENGKULU UTARA, BENGKULU",2,47,100,147
https://kawalpemilu.org#21391,"SEBERANG TUNGGAL, BATIK NAU, BENGKULU UTARA, BENGKULU",1,53,86,139
https://kawalpemilu.org#21392,"SEKIAU, BATIK NAU, BENGKULU UTARA, BENGKULU",1,42,113,155
https://kawalpemilu.org#21393,"SAMBAN JAYA, BATIK NAU, BENGKULU UTARA, BENGKULU",1,159,66,225
https://kawalpemilu.org#21393,"SAMBAN JAYA, BATIK NAU, BENGKULU UTARA, BENGKULU",2,136,20,156
https://kawalpemilu.org#21393,"SAMBAN JAYA, BATIK NAU, BENGKULU UTARA, BENGKULU",3,204,56,260
https://kawalpemilu.org#21393,"SAMBAN JAYA, BATIK NAU, BENGKULU UTARA, BENGKULU",4,188,85,273
https://kawalpemilu.org#21393,"SAMBAN JAYA, BATIK NAU, BENGKULU UTARA, BENGKULU",5,159,57,216
https://kawalpemilu.org#21393,"SAMBAN JAYA, BATIK NAU, BENGKULU UTARA, BENGKULU",6,191,40,231
https://kawalpemilu.org#21393,"SAMBAN JAYA, BATIK NAU, BENGKULU UTARA, BENGKULU",7,102,41,143
https://kawalpemilu.org#21394,"PENINJAU, BATIK NAU, BENGKULU UTARA, BENGKULU",1,184,37,221
https://kawalpemilu.org#21394,"PENINJAU, BATIK NAU, BENGKULU UTARA, BENGKULU",2,160,38,198
https://kawalpemilu.org#21394,"PENINJAU, BATIK NAU, BENGKULU UTARA, BENGKULU",3,163,33,196
https://kawalpemilu.org#21394,"PENINJAU, BATIK NAU, BENGKULU UTARA, BENGKULU",4,157,87,244
https://kawalpemilu.org#21394,"PENINJAU, BATIK NAU, BENGKULU UTARA, BENGKULU",5,194,67,261
https://kawalpemilu.org#21394,"PENINJAU, BATIK NAU, BENGKULU UTARA, BENGKULU",6,218,27,245
https://kawalpemilu.org#21395,"AIR MANGAYAU, BATIK NAU, BENGKULU UTARA, BENGKULU",1,170,78,248
https://kawalpemilu.org#21395,"AIR MANGAYAU, BATIK NAU, BENGKULU UTARA, BENGKULU",2,103,135,238
https://kawalpemilu.org#21395,"AIR MANGAYAU, BATIK NAU, BENGKULU UTARA, BENGKULU",3,86,57,143
https://kawalpemilu.org#21395,"AIR MANGAYAU, BATIK NAU, BENGKULU UTARA, BENGKULU",4,78,68,146
https://kawalpemilu.org#21397,"URAI, KETAHUN, BENGKULU UTARA, BENGKULU",1,87,93,180
https://kawalpemilu.org#21397,"URAI, KETAHUN, BENGKULU UTARA, BENGKULU",2,83,104,187
https://kawalpemilu.org#21397,"URAI, KETAHUN, BENGKULU UTARA, BENGKULU",3,91,72,163
https://kawalpemilu.org#21397,"URAI, KETAHUN, BENGKULU UTARA, BENGKULU",4,70,55,125
https://kawalpemilu.org#21397,"URAI, KETAHUN, BENGKULU UTARA, BENGKULU",5,90,60,150
https://kawalpemilu.org#21397,"URAI, KETAHUN, BENGKULU UTARA, BENGKULU",6,102,14,116
https://kawalpemilu.org#21397,"URAI, KETAHUN, BENGKULU UTARA, BENGKULU",7,220,15,235
https://kawalpemilu.org#21397,"URAI, KETAHUN, BENGKULU UTARA, BENGKULU",8,180,97,277
https://kawalpemilu.org#21397,"URAI, KETAHUN, BENGKULU UTARA, BENGKULU",9,212,23,235
https://kawalpemilu.org#21397,"URAI, KETAHUN, BENGKULU UTARA, BENGKULU",10,36,57,93
https://kawalpemilu.org#21397,"URAI, KETAHUN, BENGKULU UTARA, BENGKULU",11,208,41,249
https://kawalpemilu.org#21397,"URAI, KETAHUN, BENGKULU UTARA, BENGKULU",12,140,4,144
https://kawalpemilu.org#21397,"URAI, KETAHUN, BENGKULU UTARA, BENGKULU",13,123,24,147
https://kawalpemilu.org#21397,"URAI, KETAHUN, BENGKULU UTARA, BENGKULU",14,103,12,115
https://kawalpemilu.org#21397,"URAI, KETAHUN, BENGKULU UTARA, BENGKULU",15,101,35,136
https://kawalpemilu.org#21397,"URAI, KETAHUN, BENGKULU UTARA, BENGKULU",16,60,16,76
https://kawalpemilu.org#21397,"URAI, KETAHUN, BENGKULU UTARA, BENGKULU",18,104,29,133
https://kawalpemilu.org#21397,"URAI, KETAHUN, BENGKULU UTARA, BENGKULU",19,57,9,66
https://kawalpemilu.org#21397,"URAI, KETAHUN, BENGKULU UTARA, BENGKULU",20,49,32,81
https://kawalpemilu.org#21397,"URAI, KETAHUN, BENGKULU UTARA, BENGKULU",21,73,17,90
https://kawalpemilu.org#21397,"URAI, KETAHUN, BENGKULU UTARA, BENGKULU",22,27,21,48
https://kawalpemilu.org#21397,"URAI, KETAHUN, BENGKULU UTARA, BENGKULU",23,54,47,101
https://kawalpemilu.org#21398,"PASAR KETAHUN, KETAHUN, BENGKULU UTARA, BENGKULU",1,82,119,201
https://kawalpemilu.org#21398,"PASAR KETAHUN, KETAHUN, BENGKULU UTARA, BENGKULU",2,88,146,234
https://kawalpemilu.org#21398,"PASAR KETAHUN, KETAHUN, BENGKULU UTARA, BENGKULU",3,52,75,127
https://kawalpemilu.org#21398,"PASAR KETAHUN, KETAHUN, BENGKULU UTARA, BENGKULU",4,52,117,170
https://kawalpemilu.org#21398,"PASAR KETAHUN, KETAHUN, BENGKULU UTARA, BENGKULU",5,62,83,145
https://kawalpemilu.org#21398,"PASAR KETAHUN, KETAHUN, BENGKULU UTARA, BENGKULU",6,35,75,110
https://kawalpemilu.org#21398,"PASAR KETAHUN, KETAHUN, BENGKULU UTARA, BENGKULU",7,59,44,103
https://kawalpemilu.org#21398,"PASAR KETAHUN, KETAHUN, BENGKULU UTARA, BENGKULU",8,89,60,149
https://kawalpemilu.org#21398,"PASAR KETAHUN, KETAHUN, BENGKULU UTARA, BENGKULU",9,130,24,154
https://kawalpemilu.org#21398,"PASAR KETAHUN, KETAHUN, BENGKULU UTARA, BENGKULU",10,150,21,171
https://kawalpemilu.org#21398,"PASAR KETAHUN, KETAHUN, BENGKULU UTARA, BENGKULU",11,102,14,116
https://kawalpemilu.org#21399,"GIRI KENCANA, KETAHUN, BENGKULU UTARA, BENGKULU",1,159,82,241
https://kawalpemilu.org#21399,"GIRI KENCANA, KETAHUN, BENGKULU UTARA, BENGKULU",2,133,84,217
https://kawalpemilu.org#21399,"GIRI KENCANA, KETAHUN, BENGKULU UTARA, BENGKULU",3,96,75,171
https://kawalpemilu.org#21399,"GIRI KENCANA, KETAHUN, BENGKULU UTARA, BENGKULU",4,116,80,196
https://kawalpemilu.org#21399,"GIRI KENCANA, KETAHUN, BENGKULU UTARA, BENGKULU",5,160,63,223
https://kawalpemilu.org#21399,"GIRI KENCANA, KETAHUN, BENGKULU UTARA, BENGKULU",6,63,125,188
https://kawalpemilu.org#21399,"GIRI KENCANA, KETAHUN, BENGKULU UTARA, BENGKULU",7,69,112,181
https://kawalpemilu.org#21399,"GIRI KENCANA, KETAHUN, BENGKULU UTARA, BENGKULU",8,119,54,173
https://kawalpemilu.org#21399,"GIRI KENCANA, KETAHUN, BENGKULU UTARA, BENGKULU",9,99,81,180
https://kawalpemilu.org#21399,"GIRI KENCANA, KETAHUN, BENGKULU UTARA, BENGKULU",10,134,75,209
https://kawalpemilu.org#21399,"GIRI KENCANA, KETAHUN, BENGKULU UTARA, BENGKULU",11,106,96,202
https://kawalpemilu.org#21399,"GIRI KENCANA, KETAHUN, BENGKULU UTARA, BENGKULU",12,114,58,172
https://kawalpemilu.org#21399,"GIRI KENCANA, KETAHUN, BENGKULU UTARA, BENGKULU",13,59,52,111
https://kawalpemilu.org#21399,"GIRI KENCANA, KETAHUN, BENGKULU UTARA, BENGKULU",14,133,73,206
https://kawalpemilu.org#21400,"KUALA LANGI, KETAHUN, BENGKULU UTARA, BENGKULU",1,202,63,265
https://kawalpemilu.org#21400,"KUALA LANGI, KETAHUN, BENGKULU UTARA, BENGKULU",2,92,90,182
https://kawalpemilu.org#21400,"KUALA LANGI, KETAHUN, BENGKULU UTARA, BENGKULU",3,155,52,207
https://kawalpemilu.org#21401,"DUSUN RAJA, KETAHUN, BENGKULU UTARA, BENGKULU",1,134,52,186
https://kawalpemilu.org#21401,"DUSUN RAJA, KETAHUN, BENGKULU UTARA, BENGKULU",2,93,100,193
https://kawalpemilu.org#21401,"DUSUN RAJA, KETAHUN, BENGKULU UTARA, BENGKULU",3,75,150,225
https://kawalpemilu.org#21401,"DUSUN RAJA, KETAHUN, BENGKULU UTARA, BENGKULU",4,55,82,137
https://kawalpemilu.org#21408,"LUBUK MINDAI, KETAHUN, BENGKULU UTARA, BENGKULU",1,94,162,256
https://kawalpemilu.org#21408,"LUBUK MINDAI, KETAHUN, BENGKULU UTARA, BENGKULU",2,71,183,254
https://kawalpemilu.org#21408,"LUBUK MINDAI, KETAHUN, BENGKULU UTARA, BENGKULU",3,98,102,200
https://kawalpemilu.org#21409,"FAJAR BARU, KETAHUN, BENGKULU UTARA, BENGKULU",1,154,56,210
https://kawalpemilu.org#21409,"FAJAR BARU, KETAHUN, BENGKULU UTARA, BENGKULU",2,151,30,181
https://kawalpemilu.org#21409,"FAJAR BARU, KETAHUN, BENGKULU UTARA, BENGKULU",3,201,36,237
https://kawalpemilu.org#21409,"FAJAR BARU, KETAHUN, BENGKULU UTARA, BENGKULU",4,195,34,229
https://kawalpemilu.org#21409,"FAJAR BARU, KETAHUN, BENGKULU UTARA, BENGKULU",5,203,61,264
https://kawalpemilu.org#21409,"FAJAR BARU, KETAHUN, BENGKULU UTARA, BENGKULU",6,216,48,264
https://kawalpemilu.org#21409,"FAJAR BARU, KETAHUN, BENGKULU UTARA, BENGKULU",7,167,92,259
https://kawalpemilu.org#21409,"FAJAR BARU, KETAHUN, BENGKULU UTARA, BENGKULU",8,198,57,255
https://kawalpemilu.org#21410,"TALANG BARU, KETAHUN, BENGKULU UTARA, BENGKULU",1,89,141,230
https://kawalpemilu.org#21414,"BUKIT TINGGI, KETAHUN, BENGKULU UTARA, BENGKULU",1,158,36,194
https://kawalpemilu.org#21414,"BUKIT TINGGI, KETAHUN, BENGKULU UTARA, BENGKULU",2,128,40,168
https://kawalpemilu.org#21414,"BUKIT TINGGI, KETAHUN, BENGKULU UTARA, BENGKULU",3,122,15,137
https://kawalpemilu.org#21414,"BUKIT TINGGI, KETAHUN, BENGKULU UTARA, BENGKULU",4,158,35,193
https://kawalpemilu.org#21414,"BUKIT TINGGI, KETAHUN, BENGKULU UTARA, BENGKULU",5,136,48,184
https://kawalpemilu.org#21415,"MELATI HARJO K1, KETAHUN, BENGKULU UTARA, BENGKULU",1,179,11,190
https://kawalpemilu.org#21415,"MELATI HARJO K1, KETAHUN, BENGKULU UTARA, BENGKULU",2,185,18,203
https://kawalpemilu.org#21415,"MELATI HARJO K1, KETAHUN, BENGKULU UTARA, BENGKULU",3,206,23,229
https://kawalpemilu.org#21415,"MELATI HARJO K1, KETAHUN, BENGKULU UTARA, BENGKULU",4,162,34,196
https://kawalpemilu.org#21416,"BUKIT INDAH, KETAHUN, BENGKULU UTARA, BENGKULU",1,94,162,256
https://kawalpemilu.org#21416,"BUKIT INDAH, KETAHUN, BENGKULU UTARA, BENGKULU",2,71,183,254
https://kawalpemilu.org#21416,"BUKIT INDAH, KETAHUN, BENGKULU UTARA, BENGKULU",3,107,111,218
https://kawalpemilu.org#21420,"TANJUNGALAI, NAPAL PUTIH, BENGKULU UTARA, BENGKULU",1,130,64,194
https://kawalpemilu.org#21420,"TANJUNGALAI, NAPAL PUTIH, BENGKULU UTARA, BENGKULU",2,119,43,162
https://kawalpemilu.org#21421,"JABI, NAPAL PUTIH, BENGKULU UTARA, BENGKULU",1,72,72,144
https://kawalpemilu.org#21422,"NAPAL PUTIH, NAPAL PUTIH, BENGKULU UTARA, BENGKULU",1,143,85,228
https://kawalpemilu.org#21422,"NAPAL PUTIH, NAPAL PUTIH, BENGKULU UTARA, BENGKULU",2,118,77,195
https://kawalpemilu.org#21422,"NAPAL PUTIH, NAPAL PUTIH, BENGKULU UTARA, BENGKULU",3,120,63,183
https://kawalpemilu.org#21423,"AIR TENANG, NAPAL PUTIH, BENGKULU UTARA, BENGKULU",1,153,79,232
https://kawalpemilu.org#21423,"AIR TENANG, NAPAL PUTIH, BENGKULU UTARA, BENGKULU",2,113,34,147
https://kawalpemilu.org#21423,"AIR TENANG, NAPAL PUTIH, BENGKULU UTARA, BENGKULU",3,166,56,222
https://kawalpemilu.org#21424,"TELUK ANGGUNG, NAPAL PUTIH, BENGKULU UTARA, BENGKULU",1,60,127,187
https://kawalpemilu.org#21424,"TELUK ANGGUNG, NAPAL PUTIH, BENGKULU UTARA, BENGKULU",2,94,17,111
https://kawalpemilu.org#21424,"TELUK ANGGUNG, NAPAL PUTIH, BENGKULU UTARA, BENGKULU",3,55,25,80
https://kawalpemilu.org#21425,"TANJUNG KEMENYAN, NAPAL PUTIH, BENGKULU UTARA, BENGKULU",1,51,134,185
https://kawalpemilu.org#21425,"TANJUNG KEMENYAN, NAPAL PUTIH, BENGKULU UTARA, BENGKULU",2,97,68,165
https://kawalpemilu.org#21425,"TANJUNG KEMENYAN, NAPAL PUTIH, BENGKULU UTARA, BENGKULU",3,114,30,144
https://kawalpemilu.org#21425,"TANJUNG KEMENYAN, NAPAL PUTIH, BENGKULU UTARA, BENGKULU",4,87,21,108
https://kawalpemilu.org#21426,"MUARA SANTAN, NAPAL PUTIH, BENGKULU UTARA, BENGKULU",1,35,103,138
https://kawalpemilu.org#21426,"MUARA SANTAN, NAPAL PUTIH, BENGKULU UTARA, BENGKULU",2,85,75,158
https://kawalpemilu.org#21426,"MUARA SANTAN, NAPAL PUTIH, BENGKULU UTARA, BENGKULU",3,35,103,138
https://kawalpemilu.org#21426,"MUARA SANTAN, NAPAL PUTIH, BENGKULU UTARA, BENGKULU",4,34,95,129
https://kawalpemilu.org#21427,"GEMBUNG RAYA, NAPAL PUTIH, BENGKULU UTARA, BENGKULU",1,213,45,258
https://kawalpemilu.org#21427,"GEMBUNG RAYA, NAPAL PUTIH, BENGKULU UTARA, BENGKULU",3,187,46,233
https://kawalpemilu.org#21427,"GEMBUNG RAYA, NAPAL PUTIH, BENGKULU UTARA, BENGKULU",4,102,91,193
https://kawalpemilu.org#21427,"GEMBUNG RAYA, NAPAL PUTIH, BENGKULU UTARA, BENGKULU",5,37,12,49
https://kawalpemilu.org#21433,"LEBONG TANDAI, NAPAL PUTIH, BENGKULU UTARA, BENGKULU",1,165,29,194
https://kawalpemilu.org#21435,"KINAL JAYA, NAPAL PUTIH, BENGKULU UTARA, BENGKULU",1,112,50,162
https://kawalpemilu.org#21435,"KINAL JAYA, NAPAL PUTIH, BENGKULU UTARA, BENGKULU",2,83,45,128
https://kawalpemilu.org#21435,"KINAL JAYA, NAPAL PUTIH, BENGKULU UTARA, BENGKULU",3,142,37,179
https://kawalpemilu.org#21435,"KINAL JAYA, NAPAL PUTIH, BENGKULU UTARA, BENGKULU",4,77,58,135
https://kawalpemilu.org#21443,"TALANG ARAH, PUTRI HIJAU, BENGKULU UTARA, BENGKULU",1,76,82,158
https://kawalpemilu.org#21443,"TALANG ARAH, PUTRI HIJAU, BENGKULU UTARA, BENGKULU",2,105,103,208
https://kawalpemilu.org#21443,"TALANG ARAH, PUTRI HIJAU, BENGKULU UTARA, BENGKULU",3,165,18,183
https://kawalpemilu.org#21443,"TALANG ARAH, PUTRI HIJAU, BENGKULU UTARA, BENGKULU",4,131,14,145
https://kawalpemilu.org#21444,"PASAR SEBELAT, PUTRI HIJAU, BENGKULU UTARA, BENGKULU",1,146,117,263
https://kawalpemilu.org#21444,"PASAR SEBELAT, PUTRI HIJAU, BENGKULU UTARA, BENGKULU",2,127,111,238
https://kawalpemilu.org#21444,"PASAR SEBELAT, PUTRI HIJAU, BENGKULU UTARA, BENGKULU",3,68,6,74
https://kawalpemilu.org#21444,"PASAR SEBELAT, PUTRI HIJAU, BENGKULU UTARA, BENGKULU",4,154,71,225
https://kawalpemilu.org#21444,"PASAR SEBELAT, PUTRI HIJAU, BENGKULU UTARA, BENGKULU",5,168,86,254
https://kawalpemilu.org#21444,"PASAR SEBELAT, PUTRI HIJAU, BENGKULU UTARA, BENGKULU",6,61,17,78
https://kawalpemilu.org#21444,"PASAR SEBELAT, PUTRI HIJAU, BENGKULU UTARA, BENGKULU",7,99,12,111
https://kawalpemilu.org#21444,"PASAR SEBELAT, PUTRI HIJAU, BENGKULU UTARA, BENGKULU",8,55,7,62
https://kawalpemilu.org#21444,"PASAR SEBELAT, PUTRI HIJAU, BENGKULU UTARA, BENGKULU",9,98,11,109
https://kawalpemilu.org#21444,"PASAR SEBELAT, PUTRI HIJAU, BENGKULU UTARA, BENGKULU",10,49,11,60
https://kawalpemilu.org#21444,"PASAR SEBELAT, PUTRI HIJAU, BENGKULU UTARA, BENGKULU",11,44,5,49
https://kawalpemilu.org#21444,"PASAR SEBELAT, PUTRI HIJAU, BENGKULU UTARA, BENGKULU",12,55,38,93
https://kawalpemilu.org#21444,"PASAR SEBELAT, PUTRI HIJAU, BENGKULU UTARA, BENGKULU",13,41,39,80
https://kawalpemilu.org#21444,"PASAR SEBELAT, PUTRI HIJAU, BENGKULU UTARA, BENGKULU",14,18,3,21
https://kawalpemilu.org#21445,"KOTA BANI, PUTRI HIJAU, BENGKULU UTARA, BENGKULU",1,90,99,189
https://kawalpemilu.org#21445,"KOTA BANI, PUTRI HIJAU, BENGKULU UTARA, BENGKULU",2,107,79,186
https://kawalpemilu.org#21445,"KOTA BANI, PUTRI HIJAU, BENGKULU UTARA, BENGKULU",3,179,18,197
https://kawalpemilu.org#21445,"KOTA BANI, PUTRI HIJAU, BENGKULU UTARA, BENGKULU",4,136,89,225
https://kawalpemilu.org#21445,"KOTA BANI, PUTRI HIJAU, BENGKULU UTARA, BENGKULU",5,132,63,195
https://kawalpemilu.org#21445,"KOTA BANI, PUTRI HIJAU, BENGKULU UTARA, BENGKULU",6,119,85,204
https://kawalpemilu.org#21445,"KOTA BANI, PUTRI HIJAU, BENGKULU UTARA, BENGKULU",8,93,107,200
https://kawalpemilu.org#21445,"KOTA BANI, PUTRI HIJAU, BENGKULU UTARA, BENGKULU",9,136,43,179
https://kawalpemilu.org#21445,"KOTA BANI, PUTRI HIJAU, BENGKULU UTARA, BENGKULU",10,117,31,148
https://kawalpemilu.org#21445,"KOTA BANI, PUTRI HIJAU, BENGKULU UTARA, BENGKULU",11,138,27,165
https://kawalpemilu.org#21445,"KOTA BANI, PUTRI HIJAU, BENGKULU UTARA, BENGKULU",12,176,19,195
https://kawalpemilu.org#21445,"KOTA BANI, PUTRI HIJAU, BENGKULU UTARA, BENGKULU",13,179,18,197
https://kawalpemilu.org#21449,"AIR MURING, PUTRI HIJAU, BENGKULU UTARA, BENGKULU",1,86,121,207
https://kawalpemilu.org#21449,"AIR MURING, PUTRI HIJAU, BENGKULU UTARA, BENGKULU",2,181,46,227
https://kawalpemilu.org#21449,"AIR MURING, PUTRI HIJAU, BENGKULU UTARA, BENGKULU",3,149,60,209
https://kawalpemilu.org#21449,"AIR MURING, PUTRI HIJAU, BENGKULU UTARA, BENGKULU",4,133,100,233
https://kawalpemilu.org#21449,"AIR MURING, PUTRI HIJAU, BENGKULU UTARA, BENGKULU",5,102,70,172
https://kawalpemilu.org#21449,"AIR MURING, PUTRI HIJAU, BENGKULU UTARA, BENGKULU",6,135,62,197
https://kawalpemilu.org#21449,"AIR MURING, PUTRI HIJAU, BENGKULU UTARA, BENGKULU",7,133,62,195
https://kawalpemilu.org#21449,"AIR MURING, PUTRI HIJAU, BENGKULU UTARA, BENGKULU",8,146,63,209
https://kawalpemilu.org#21450,"AIR PANDAN, PUTRI HIJAU, BENGKULU UTARA, BENGKULU",1,158,29,187
https://kawalpemilu.org#21450,"AIR PANDAN, PUTRI HIJAU, BENGKULU UTARA, BENGKULU",2,125,14,139
https://kawalpemilu.org#21450,"AIR PANDAN, PUTRI HIJAU, BENGKULU UTARA, BENGKULU",3,159,16,175
https://kawalpemilu.org#21451,"CIPTA MULYA, PUTRI HIJAU, BENGKULU UTARA, BENGKULU",1,168,36,204
https://kawalpemilu.org#21451,"CIPTA MULYA, PUTRI HIJAU, BENGKULU UTARA, BENGKULU",2,206,43,249
https://kawalpemilu.org#21451,"CIPTA MULYA, PUTRI HIJAU, BENGKULU UTARA, BENGKULU",3,175,41,216
https://kawalpemilu.org#21451,"CIPTA MULYA, PUTRI HIJAU, BENGKULU UTARA, BENGKULU",4,158,22,180
https://kawalpemilu.org#21451,"CIPTA MULYA, PUTRI HIJAU, BENGKULU UTARA, BENGKULU",5,163,7,170
https://kawalpemilu.org#21453,"AIR PETAI, PUTRI HIJAU, BENGKULU UTARA, BENGKULU",1,218,29,247
https://kawalpemilu.org#21453,"AIR PETAI, PUTRI HIJAU, BENGKULU UTARA, BENGKULU",2,179,42,221
https://kawalpemilu.org#21453,"AIR PETAI, PUTRI HIJAU, BENGKULU UTARA, BENGKULU",3,270,13,283
https://kawalpemilu.org#21453,"AIR PETAI, PUTRI HIJAU, BENGKULU UTARA, BENGKULU",4,256,14,270
https://kawalpemilu.org#21453,"AIR PETAI, PUTRI HIJAU, BENGKULU UTARA, BENGKULU",5,256,13,269
https://kawalpemilu.org#21453,"AIR PETAI, PUTRI HIJAU, BENGKULU UTARA, BENGKULU",6,230,28,258
https://kawalpemilu.org#21453,"AIR PETAI, PUTRI HIJAU, BENGKULU UTARA, BENGKULU",7,197,50,247
https://kawalpemilu.org#21453,"AIR PETAI, PUTRI HIJAU, BENGKULU UTARA, BENGKULU",8,185,26,211
https://kawalpemilu.org#21453,"AIR PETAI, PUTRI HIJAU, BENGKULU UTARA, BENGKULU",9,176,17,193
https://kawalpemilu.org#21453,"AIR PETAI, PUTRI HIJAU, BENGKULU UTARA, BENGKULU",10,149,18,167
https://kawalpemilu.org#21453,"AIR PETAI, PUTRI HIJAU, BENGKULU UTARA, BENGKULU",11,142,16,158
https://kawalpemilu.org#21454,"KARANG TENGAH, PUTRI HIJAU, BENGKULU UTARA, BENGKULU",1,151,4,155
https://kawalpemilu.org#21454,"KARANG TENGAH, PUTRI HIJAU, BENGKULU UTARA, BENGKULU",2,134,14,148
https://kawalpemilu.org#21454,"KARANG TENGAH, PUTRI HIJAU, BENGKULU UTARA, BENGKULU",3,176,32,208
https://kawalpemilu.org#21454,"KARANG TENGAH, PUTRI HIJAU, BENGKULU UTARA, BENGKULU",4,129,19,148
https://kawalpemilu.org#21454,"KARANG TENGAH, PUTRI HIJAU, BENGKULU UTARA, BENGKULU",5,0,0,0
https://kawalpemilu.org#21454,"KARANG TENGAH, PUTRI HIJAU, BENGKULU UTARA, BENGKULU",6,144,5,149
https://kawalpemilu.org#21454,"KARANG TENGAH, PUTRI HIJAU, BENGKULU UTARA, BENGKULU",7,154,30,184
https://kawalpemilu.org#21454,"KARANG TENGAH, PUTRI HIJAU, BENGKULU UTARA, BENGKULU",8,68,3,71
https://kawalpemilu.org#21455,"KARANG PULAU, PUTRI HIJAU, BENGKULU UTARA, BENGKULU",1,126,39,165
https://kawalpemilu.org#21455,"KARANG PULAU, PUTRI HIJAU, BENGKULU UTARA, BENGKULU",2,153,52,205
https://kawalpemilu.org#21455,"KARANG PULAU, PUTRI HIJAU, BENGKULU UTARA, BENGKULU",3,155,58,213
https://kawalpemilu.org#21455,"KARANG PULAU, PUTRI HIJAU, BENGKULU UTARA, BENGKULU",4,164,61,225
https://kawalpemilu.org#21455,"KARANG PULAU, PUTRI HIJAU, BENGKULU UTARA, BENGKULU",5,192,53,245
https://kawalpemilu.org#21455,"KARANG PULAU, PUTRI HIJAU, BENGKULU UTARA, BENGKULU",6,156,94,250
https://kawalpemilu.org#21455,"KARANG PULAU, PUTRI HIJAU, BENGKULU UTARA, BENGKULU",7,163,51,214
https://kawalpemilu.org#21455,"KARANG PULAU, PUTRI HIJAU, BENGKULU UTARA, BENGKULU",8,198,46,244
https://kawalpemilu.org#21455,"KARANG PULAU, PUTRI HIJAU, BENGKULU UTARA, BENGKULU",9,186,30,216
https://kawalpemilu.org#21459,"GENTING PERANGKAP, AIR BESI, BENGKULU UTARA, BENGKULU",1,66,140,206
https://kawalpemilu.org#21460,"LUBUK BALAM, AIR BESI, BENGKULU UTARA, BENGKULU",1,21,150,171
https://kawalpemilu.org#21460,"LUBUK BALAM, AIR BESI, BENGKULU UTARA, BENGKULU",2,50,144,194
https://kawalpemilu.org#21460,"LUBUK BALAM, AIR BESI, BENGKULU UTARA, BENGKULU",3,36,164,200
https://kawalpemilu.org#21460,"LUBUK BALAM, AIR BESI, BENGKULU UTARA, BENGKULU",4,28,126,154
https://kawalpemilu.org#21461,"DATAR MACANG, AIR BESI, BENGKULU UTARA, BENGKULU",1,17,101,118
https://kawalpemilu.org#21461,"DATAR MACANG, AIR BESI, BENGKULU UTARA, BENGKULU",2,33,137,170
https://kawalpemilu.org#21461,"DATAR MACANG, AIR BESI, BENGKULU UTARA, BENGKULU",3,42,148,190
https://kawalpemilu.org#21461,"DATAR MACANG, AIR BESI, BENGKULU UTARA, BENGKULU",4,31,121,152
https://kawalpemilu.org#21462,"TANJUNG GENTING, AIR BESI, BENGKULU UTARA, BENGKULU",1,52,94,146
https://kawalpemilu.org#21462,"TANJUNG GENTING, AIR BESI, BENGKULU UTARA, BENGKULU",2,55,89,144
https://kawalpemilu.org#21463,"TALANG RENAH, AIR BESI, BENGKULU UTARA, BENGKULU",1,85,102,187
https://kawalpemilu.org#21464,"KOTA AGUNG, AIR BESI, BENGKULU UTARA, BENGKULU",1,106,100,206
https://kawalpemilu.org#21464,"KOTA AGUNG, AIR BESI, BENGKULU UTARA, BENGKULU",2,79,105,184
https://kawalpemilu.org#21464,"KOTA AGUNG, AIR BESI, BENGKULU UTARA, BENGKULU",3,126,66,192
https://kawalpemilu.org#21464,"KOTA AGUNG, AIR BESI, BENGKULU UTARA, BENGKULU",4,93,85,178
https://kawalpemilu.org#21464,"KOTA AGUNG, AIR BESI, BENGKULU UTARA, BENGKULU",5,114,31,145
https://kawalpemilu.org#21465,"TALANG LEMBAK, AIR BESI, BENGKULU UTARA, BENGKULU",1,117,107,224
https://kawalpemilu.org#21466,"KERTAPATI, AIR BESI, BENGKULU UTARA, BENGKULU",1,64,101,165
https://kawalpemilu.org#21466,"KERTAPATI, AIR BESI, BENGKULU UTARA, BENGKULU",2,33,165,198
https://kawalpemilu.org#21466,"KERTAPATI, AIR BESI, BENGKULU UTARA, BENGKULU",3,32,152,184
https://kawalpemilu.org#21467,"TALANG PUNGGUK, AIR BESI, BENGKULU UTARA, BENGKULU",1,31,200,231
https://kawalpemilu.org#21468,"TALANG BARU GINTING, AIR BESI, BENGKULU UTARA, BENGKULU",1,43,101,144
https://kawalpemilu.org#21469,"TANJUNG KARET, AIR BESI, BENGKULU UTARA, BENGKULU",1,41,125,166
https://kawalpemilu.org#21469,"TANJUNG KARET, AIR BESI, BENGKULU UTARA, BENGKULU",2,54,140,194
https://kawalpemilu.org#21470,"TALANG GINTING, AIR BESI, BENGKULU UTARA, BENGKULU",1,43,101,144
https://kawalpemilu.org#21470,"TALANG GINTING, AIR BESI, BENGKULU UTARA, BENGKULU",2,28,120,148
https://kawalpemilu.org#21472,"DUSUN CURUP, AIR BESI, BENGKULU UTARA, BENGKULU",1,68,167,235
https://kawalpemilu.org#21472,"DUSUN CURUP, AIR BESI, BENGKULU UTARA, BENGKULU",2,68,167,235
https://kawalpemilu.org#21472,"DUSUN CURUP, AIR BESI, BENGKULU UTARA, BENGKULU",3,78,170,248
https://kawalpemilu.org#21473,"PENYANGKAK, AIR BESI, BENGKULU UTARA, BENGKULU",1,98,38,136
https://kawalpemilu.org#21473,"PENYANGKAK, AIR BESI, BENGKULU UTARA, BENGKULU",2,78,83,161
https://kawalpemilu.org#21475,"PASAR BEMBAH, AIR NAPAL, BENGKULU UTARA, BENGKULU",1,139,87,226
https://kawalpemilu.org#21475,"PASAR BEMBAH, AIR NAPAL, BENGKULU UTARA, BENGKULU",2,106,63,169
https://kawalpemilu.org#21475,"PASAR BEMBAH, AIR NAPAL, BENGKULU UTARA, BENGKULU",3,109,125,234
https://kawalpemilu.org#21476,"TEPI LAUT, AIR NAPAL, BENGKULU UTARA, BENGKULU",1,143,94,237
https://kawalpemilu.org#21476,"TEPI LAUT, AIR NAPAL, BENGKULU UTARA, BENGKULU",2,105,81,186
https://kawalpemilu.org#21477,"PASAR KERKAP, AIR NAPAL, BENGKULU UTARA, BENGKULU",1,96,120,216
https://kawalpemilu.org#21477,"PASAR KERKAP, AIR NAPAL, BENGKULU UTARA, BENGKULU",2,88,127,215
https://kawalpemilu.org#21477,"PASAR KERKAP, AIR NAPAL, BENGKULU UTARA, BENGKULU",3,97,134,231
https://kawalpemilu.org#21477,"PASAR KERKAP, AIR NAPAL, BENGKULU UTARA, BENGKULU",4,83,121,204
https://kawalpemilu.org#21479,"AIR NAPAL, AIR NAPAL, BENGKULU UTARA, BENGKULU",1,97,117,214
https://kawalpemilu.org#21479,"AIR NAPAL, AIR NAPAL, BENGKULU UTARA, BENGKULU",2,101,96,197
https://kawalpemilu.org#21480,"TALANG KERING, AIR NAPAL, BENGKULU UTARA, BENGKULU",1,90,81,171
https://kawalpemilu.org#21480,"TALANG KERING, AIR NAPAL, BENGKULU UTARA, BENGKULU",2,67,85,152
https://kawalpemilu.org#21481,"SELUBUK, AIR NAPAL, BENGKULU UTARA, BENGKULU",1,143,137,280
https://kawalpemilu.org#21481,"SELUBUK, AIR NAPAL, BENGKULU UTARA, BENGKULU",2,60,196,256
https://kawalpemilu.org#21481,"SELUBUK, AIR NAPAL, BENGKULU UTARA, BENGKULU",3,78,137,215
https://kawalpemilu.org#21482,"PASAR TEBAT, AIR NAPAL, BENGKULU UTARA, BENGKULU",1,42,172,215
https://kawalpemilu.org#21482,"PASAR TEBAT, AIR NAPAL, BENGKULU UTARA, BENGKULU",2,68,147,215
https://kawalpemilu.org#21483,"LUBUK TANJUNG, AIR NAPAL, BENGKULU UTARA, BENGKULU",1,85,154,239
https://kawalpemilu.org#21483,"LUBUK TANJUNG, AIR NAPAL, BENGKULU UTARA, BENGKULU",2,68,161,229
https://kawalpemilu.org#21485,"PUKUR, AIR NAPAL, BENGKULU UTARA, BENGKULU",1,75,166,241
https://kawalpemilu.org#21485,"PUKUR, AIR NAPAL, BENGKULU UTARA, BENGKULU",2,49,173,222
https://kawalpemilu.org#21488,"PASAR PALIK, AIR NAPAL, BENGKULU UTARA, BENGKULU",1,75,173,248
https://kawalpemilu.org#21488,"PASAR PALIK, AIR NAPAL, BENGKULU UTARA, BENGKULU",2,140,117,257
https://kawalpemilu.org#21489,"TEBING KANDANG, AIR NAPAL, BENGKULU UTARA, BENGKULU",1,150,94,244
https://kawalpemilu.org#21489,"TEBING KANDANG, AIR NAPAL, BENGKULU UTARA, BENGKULU",2,143,101,244
https://kawalpemilu.org#21490,"TALANG JARANG, AIR NAPAL, BENGKULU UTARA, BENGKULU",1,86,95,181
https://kawalpemilu.org#21490,"TALANG JARANG, AIR NAPAL, BENGKULU UTARA, BENGKULU",2,61,79,140
https://kawalpemilu.org#21287,"PADANG BENDAR, HULU PALIK, BENGKULU UTARA, BENGKULU",1,111,101,212
https://kawalpemilu.org#21287,"PADANG BENDAR, HULU PALIK, BENGKULU UTARA, BENGKULU",2,92,94,186
https://kawalpemilu.org#21287,"PADANG BENDAR, HULU PALIK, BENGKULU UTARA, BENGKULU",3,90,68,158
https://kawalpemilu.org#21287,"PADANG BENDAR, HULU PALIK, BENGKULU UTARA, BENGKULU",4,83,59,142
https://kawalpemilu.org#21289,"TABA PADANG KOL, HULU PALIK, BENGKULU UTARA, BENGKULU",1,101,110,211
https://kawalpemilu.org#21290,"BATU RAJA KOL, HULU PALIK, BENGKULU UTARA, BENGKULU",1,92,97,189
https://kawalpemilu.org#21291,"BATU RAJA REJANG, HULU PALIK, BENGKULU UTARA, BENGKULU",1,141,70,211
https://kawalpemilu.org#21291,"BATU RAJA REJANG, HULU PALIK, BENGKULU UTARA, BENGKULU",2,111,76,187
https://kawalpemilu.org#21291,"BATU RAJA REJANG, HULU PALIK, BENGKULU UTARA, BENGKULU",4,60,8,68
https://kawalpemilu.org#21292,"BATU ROTO, HULU PALIK, BENGKULU UTARA, BENGKULU",1,113,63,176
https://kawalpemilu.org#21292,"BATU ROTO, HULU PALIK, BENGKULU UTARA, BENGKULU",3,100,71,171
https://kawalpemilu.org#21293,"PEMATANG BALAM, HULU PALIK, BENGKULU UTARA, BENGKULU",1,183,62,245
https://kawalpemilu.org#21293,"PEMATANG BALAM, HULU PALIK, BENGKULU UTARA, BENGKULU",2,130,50,180
https://kawalpemilu.org#21293,"PEMATANG BALAM, HULU PALIK, BENGKULU UTARA, BENGKULU",3,138,57,195
https://kawalpemilu.org#21293,"PEMATANG BALAM, HULU PALIK, BENGKULU UTARA, BENGKULU",4,142,41,183
https://kawalpemilu.org#21293,"PEMATANG BALAM, HULU PALIK, BENGKULU UTARA, BENGKULU",5,122,50,172
https://kawalpemilu.org#21294,"TALANG RENDAH, HULU PALIK, BENGKULU UTARA, BENGKULU",1,160,80,240
https://kawalpemilu.org#21294,"TALANG RENDAH, HULU PALIK, BENGKULU UTARA, BENGKULU",2,168,81,249
https://kawalpemilu.org#21294,"TALANG RENDAH, HULU PALIK, BENGKULU UTARA, BENGKULU",3,91,71,162
https://kawalpemilu.org#21295,"SUMBER REJO, HULU PALIK, BENGKULU UTARA, BENGKULU",1,145,62,207
https://kawalpemilu.org#21295,"SUMBER REJO, HULU PALIK, BENGKULU UTARA, BENGKULU",2,119,40,159
https://kawalpemilu.org#21295,"SUMBER REJO, HULU PALIK, BENGKULU UTARA, BENGKULU",4,140,62,202
https://kawalpemilu.org#21295,"SUMBER REJO, HULU PALIK, BENGKULU UTARA, BENGKULU",5,171,55,226
https://kawalpemilu.org#21295,"SUMBER REJO, HULU PALIK, BENGKULU UTARA, BENGKULU",6,90,29,119
https://kawalpemilu.org#21296,"AIR BAUS I, HULU PALIK, BENGKULU UTARA, BENGKULU",1,109,12,121
https://kawalpemilu.org#21296,"AIR BAUS I, HULU PALIK, BENGKULU UTARA, BENGKULU",2,95,30,125
https://kawalpemilu.org#21298,"KOTA LEKAT, HULU PALIK, BENGKULU UTARA, BENGKULU",1,65,154,219
https://kawalpemilu.org#21305,"AIR BAUS II, HULU PALIK, BENGKULU UTARA, BENGKULU",1,127,24,151
https://kawalpemilu.org#21305,"AIR BAUS II, HULU PALIK, BENGKULU UTARA, BENGKULU",2,122,27,149
https://kawalpemilu.org#21306,"AIR BANAI, HULU PALIK, BENGKULU UTARA, BENGKULU",1,122,68,190
https://kawalpemilu.org#83985,"BATU LAYANG, HULU PALIK, BENGKULU UTARA, BENGKULU",1,149,52,201
https://kawalpemilu.org#84721,"TABA PADANG R, HULU PALIK, BENGKULU UTARA, BENGKULU",1,99,112,211
https://kawalpemilu.org#84721,"TABA PADANG R, HULU PALIK, BENGKULU UTARA, BENGKULU",2,97,101,198
https://kawalpemilu.org#87327,"KOTA LEKAT MUDIK, HULU PALIK, BENGKULU UTARA, BENGKULU",1,66,137,203
https://kawalpemilu.org#87327,"KOTA LEKAT MUDIK, HULU PALIK, BENGKULU UTARA, BENGKULU",2,82,136,218
https://kawalpemilu.org#21359,"TELUK AJANG, AIR PADANG, BENGKULU UTARA, BENGKULU",1,141,104,245
https://kawalpemilu.org#21359,"TELUK AJANG, AIR PADANG, BENGKULU UTARA, BENGKULU",2,154,100,254
https://kawalpemilu.org#21360,"PADANG KALA, AIR PADANG, BENGKULU UTARA, BENGKULU",1,122,128,250
https://kawalpemilu.org#21360,"PADANG KALA, AIR PADANG, BENGKULU UTARA, BENGKULU",2,78,113,191
https://kawalpemilu.org#21360,"PADANG KALA, AIR PADANG, BENGKULU UTARA, BENGKULU",3,98,59,157
https://kawalpemilu.org#21360,"PADANG KALA, AIR PADANG, BENGKULU UTARA, BENGKULU",4,120,89,209
https://kawalpemilu.org#21361,"KEMBANG MANIS, AIR PADANG, BENGKULU UTARA, BENGKULU",1,132,114,246
https://kawalpemilu.org#21361,"KEMBANG MANIS, AIR PADANG, BENGKULU UTARA, BENGKULU",2,118,61,179
https://kawalpemilu.org#21361,"KEMBANG MANIS, AIR PADANG, BENGKULU UTARA, BENGKULU",3,103,64,167
https://kawalpemilu.org#21362,"TALANG ULU, AIR PADANG, BENGKULU UTARA, BENGKULU",1,87,108,195
https://kawalpemilu.org#21363,"MESIGIT, AIR PADANG, BENGKULU UTARA, BENGKULU",1,109,108,217
https://kawalpemilu.org#21364,"LUBUK MUMPO, AIR PADANG, BENGKULU UTARA, BENGKULU",1,77,76,153
https://kawalpemilu.org#21364,"LUBUK MUMPO, AIR PADANG, BENGKULU UTARA, BENGKULU",2,111,85,196
https://kawalpemilu.org#21372,"TANJUNG AUR, AIR PADANG, BENGKULU UTARA, BENGKULU",1,49,90,139
https://kawalpemilu.org#21372,"TANJUNG AUR, AIR PADANG, BENGKULU UTARA, BENGKULU",2,42,25,67
https://kawalpemilu.org#21372,"TANJUNG AUR, AIR PADANG, BENGKULU UTARA, BENGKULU",3,47,90,137
https://kawalpemilu.org#21378,"SUKA RAMI, AIR PADANG, BENGKULU UTARA, BENGKULU",1,77,166,243
https://kawalpemilu.org#21378,"SUKA RAMI, AIR PADANG, BENGKULU UTARA, BENGKULU",2,64,143,207
https://kawalpemilu.org#21379,"RETES, AIR PADANG, BENGKULU UTARA, BENGKULU",1,45,81,126
https://kawalpemilu.org#87337,"BALAM, AIR PADANG, BENGKULU UTARA, BENGKULU",1,103,118,221
https://kawalpemilu.org#21310,"KEMUMU, ARMA JAYA, BENGKULU UTARA, BENGKULU",1,112,93,205
https://kawalpemilu.org#21310,"KEMUMU, ARMA JAYA, BENGKULU UTARA, BENGKULU",2,156,44,200
https://kawalpemilu.org#21310,"KEMUMU, ARMA JAYA, BENGKULU UTARA, BENGKULU",3,160,95,255
https://kawalpemilu.org#21310,"KEMUMU, ARMA JAYA, BENGKULU UTARA, BENGKULU",4,166,84,250
https://kawalpemilu.org#21310,"KEMUMU, ARMA JAYA, BENGKULU UTARA, BENGKULU",5,91,70,161
https://kawalpemilu.org#21310,"KEMUMU, ARMA JAYA, BENGKULU UTARA, BENGKULU",6,104,53,157
https://kawalpemilu.org#21310,"KEMUMU, ARMA JAYA, BENGKULU UTARA, BENGKULU",7,121,50,171
https://kawalpemilu.org#21310,"KEMUMU, ARMA JAYA, BENGKULU UTARA, BENGKULU",8,140,73,213
https://kawalpemilu.org#21319,"AIR MERAH, ARMA JAYA, BENGKULU UTARA, BENGKULU",1,76,150,226
https://kawalpemilu.org#21319,"AIR MERAH, ARMA JAYA, BENGKULU UTARA, BENGKULU",2,79,158,237
https://kawalpemilu.org#21319,"AIR MERAH, ARMA JAYA, BENGKULU UTARA, BENGKULU",3,76,110,186
https://kawalpemilu.org#21325,"KALI, ARMA JAYA, BENGKULU UTARA, BENGKULU",1,81,111,192
https://kawalpemilu.org#21325,"KALI, ARMA JAYA, BENGKULU UTARA, BENGKULU",2,128,125,253
https://kawalpemilu.org#21325,"KALI, ARMA JAYA, BENGKULU UTARA, BENGKULU",3,62,111,173
https://kawalpemilu.org#21329,"SUMBER AGUNG, ARMA JAYA, BENGKULU UTARA, BENGKULU",1,125,89,214
https://kawalpemilu.org#21329,"SUMBER AGUNG, ARMA JAYA, BENGKULU UTARA, BENGKULU",2,147,75,222
https://kawalpemilu.org#21329,"SUMBER AGUNG, ARMA JAYA, BENGKULU UTARA, BENGKULU",3,198,44,242
https://kawalpemilu.org#21329,"SUMBER AGUNG, ARMA JAYA, BENGKULU UTARA, BENGKULU",4,188,75,263
https://kawalpemilu.org#21330,"PEMATANG SAPANG, ARMA JAYA, BENGKULU UTARA, BENGKULU",1,105,121,226
https://kawalpemilu.org#21330,"PEMATANG SAPANG, ARMA JAYA, BENGKULU UTARA, BENGKULU",2,103,73,176
https://kawalpemilu.org#21330,"PEMATANG SAPANG, ARMA JAYA, BENGKULU UTARA, BENGKULU",3,65,61,126
https://kawalpemilu.org#21331,"PAGAR BANYU, ARMA JAYA, BENGKULU UTARA, BENGKULU",1,85,127,212
https://kawalpemilu.org#21331,"PAGAR BANYU, ARMA JAYA, BENGKULU UTARA, BENGKULU",2,87,124,211
https://kawalpemilu.org#21331,"PAGAR BANYU, ARMA JAYA, BENGKULU UTARA, BENGKULU",3,110,158,268
https://kawalpemilu.org#21332,"GARDU, ARMA JAYA, BENGKULU UTARA, BENGKULU",1,36,90,126
https://kawalpemilu.org#21332,"GARDU, ARMA JAYA, BENGKULU UTARA, BENGKULU",2,38,94,132
https://kawalpemilu.org#21333,"PAGAR RUYUNG, ARMA JAYA, BENGKULU UTARA, BENGKULU",1,75,94,169
https://kawalpemilu.org#21335,"TEBING KANING, ARMA JAYA, BENGKULU UTARA, BENGKULU",1,148,44,192
https://kawalpemilu.org#21335,"TEBING KANING, ARMA JAYA, BENGKULU UTARA, BENGKULU",2,112,63,175
https://kawalpemilu.org#21335,"TEBING KANING, ARMA JAYA, BENGKULU UTARA, BENGKULU",3,129,88,217
https://kawalpemilu.org#21336,"SIDODADI, ARMA JAYA, BENGKULU UTARA, BENGKULU",1,150,33,183
https://kawalpemilu.org#21336,"SIDODADI, ARMA JAYA, BENGKULU UTARA, BENGKULU",2,141,52,193
https://kawalpemilu.org#21336,"SIDODADI, ARMA JAYA, BENGKULU UTARA, BENGKULU",3,137,46,183
https://kawalpemilu.org#21338,"KALAI DUAI, ARMA JAYA, BENGKULU UTARA, BENGKULU",1,88,127,215
https://kawalpemilu.org#21338,"KALAI DUAI, ARMA JAYA, BENGKULU UTARA, BENGKULU",2,87,104,191
https://kawalpemilu.org#84722,"GUNUNG BESAR, ARMA JAYA, BENGKULU UTARA, BENGKULU",1,75,177,252
https://kawalpemilu.org#84722,"GUNUNG BESAR, ARMA JAYA, BENGKULU UTARA, BENGKULU",2,63,120,183
https://kawalpemilu.org#21418,"PONDOK BAKIL, ULOK KUPAI, BENGKULU UTARA, BENGKULU",1,107,114,221
https://kawalpemilu.org#21418,"PONDOK BAKIL, ULOK KUPAI, BENGKULU UTARA, BENGKULU",2,45,39,84
https://kawalpemilu.org#21419,"TALANG BERANTAI, ULOK KUPAI, BENGKULU UTARA, BENGKULU",2,73,73,146
https://kawalpemilu.org#21429,"AIR LELANGI, ULOK KUPAI, BENGKULU UTARA, BENGKULU",1,188,78,266
https://kawalpemilu.org#21429,"AIR LELANGI, ULOK KUPAI, BENGKULU UTARA, BENGKULU",2,122,83,205
https://kawalpemilu.org#21429,"AIR LELANGI, ULOK KUPAI, BENGKULU UTARA, BENGKULU",3,98,59,157
https://kawalpemilu.org#21434,"BANGUN KARYA, ULOK KUPAI, BENGKULU UTARA, BENGKULU",1,201,42,243
https://kawalpemilu.org#21434,"BANGUN KARYA, ULOK KUPAI, BENGKULU UTARA, BENGKULU",2,108,41,149
https://kawalpemilu.org#21434,"BANGUN KARYA, ULOK KUPAI, BENGKULU UTARA, BENGKULU",3,90,19,109
https://kawalpemilu.org#84723,"BUKIT BERLIAN, ULOK KUPAI, BENGKULU UTARA, BENGKULU",1,116,144,260
https://kawalpemilu.org#84723,"BUKIT BERLIAN, ULOK KUPAI, BENGKULU UTARA, BENGKULU",2,159,92,251
https://kawalpemilu.org#84723,"BUKIT BERLIAN, ULOK KUPAI, BENGKULU UTARA, BENGKULU",3,67,119,186
https://kawalpemilu.org#84724,"TANJUNG DALAM, ULOK KUPAI, BENGKULU UTARA, BENGKULU",1,102,130,232
https://kawalpemilu.org#84724,"TANJUNG DALAM, ULOK KUPAI, BENGKULU UTARA, BENGKULU",2,101,124,225
https://kawalpemilu.org#84724,"TANJUNG DALAM, ULOK KUPAI, BENGKULU UTARA, BENGKULU",3,115,97,212
https://kawalpemilu.org#84724,"TANJUNG DALAM, ULOK KUPAI, BENGKULU UTARA, BENGKULU",4,153,91,244
https://kawalpemilu.org#84724,"TANJUNG DALAM, ULOK KUPAI, BENGKULU UTARA, BENGKULU",5,154,41,195
https://kawalpemilu.org#84724,"TANJUNG DALAM, ULOK KUPAI, BENGKULU UTARA, BENGKULU",6,169,55,224
https://kawalpemilu.org#84724,"TANJUNG DALAM, ULOK KUPAI, BENGKULU UTARA, BENGKULU",7,154,60,214
https://kawalpemilu.org#84725,"BUKIT SARI, ULOK KUPAI, BENGKULU UTARA, BENGKULU",1,112,83,195
https://kawalpemilu.org#84725,"BUKIT SARI, ULOK KUPAI, BENGKULU UTARA, BENGKULU",2,156,57,213
https://kawalpemilu.org#87304,"PAGARDIN, ULOK KUPAI, BENGKULU UTARA, BENGKULU",1,163,83,246
https://kawalpemilu.org#87304,"PAGARDIN, ULOK KUPAI, BENGKULU UTARA, BENGKULU",2,84,154,238
https://kawalpemilu.org#87304,"PAGARDIN, ULOK KUPAI, BENGKULU UTARA, BENGKULU",3,77,177,254
https://kawalpemilu.org#87304,"PAGARDIN, ULOK KUPAI, BENGKULU UTARA, BENGKULU",4,66,166,232
https://kawalpemilu.org#87335,"TANJUNG HARAPAN, ULOK KUPAI, BENGKULU UTARA, BENGKULU",1,141,101,242
https://kawalpemilu.org#87335,"TANJUNG HARAPAN, ULOK KUPAI, BENGKULU UTARA, BENGKULU",2,171,69,240
https://kawalpemilu.org#87335,"TANJUNG HARAPAN, ULOK KUPAI, BENGKULU UTARA, BENGKULU",3,195,21,216
https://kawalpemilu.org#87335,"TANJUNG HARAPAN, ULOK KUPAI, BENGKULU UTARA, BENGKULU",4,125,61,186
https://kawalpemilu.org#87335,"TANJUNG HARAPAN, ULOK KUPAI, BENGKULU UTARA, BENGKULU",5,135,64,199
https://kawalpemilu.org#87335,"TANJUNG HARAPAN, ULOK KUPAI, BENGKULU UTARA, BENGKULU",6,161,55,216
https://kawalpemilu.org#87336,"TANJUNG SARI, ULOK KUPAI, BENGKULU UTARA, BENGKULU",1,183,28,211
https://kawalpemilu.org#87336,"TANJUNG SARI, ULOK KUPAI, BENGKULU UTARA, BENGKULU",2,171,50,221
https://kawalpemilu.org#87336,"TANJUNG SARI, ULOK KUPAI, BENGKULU UTARA, BENGKULU",3,131,22,153
https://kawalpemilu.org#87336,"TANJUNG SARI, ULOK KUPAI, BENGKULU UTARA, BENGKULU",4,170,21,191
https://kawalpemilu.org#21303,"SENGKUANG, TANJUNGAGUNG PALIK, BENGKULU UTARA, BENGKULU",1,77,92,169
https://kawalpemilu.org#21303,"SENGKUANG, TANJUNGAGUNG PALIK, BENGKULU UTARA, BENGKULU",2,96,71,167
https://kawalpemilu.org#21303,"SENGKUANG, TANJUNGAGUNG PALIK, BENGKULU UTARA, BENGKULU",3,69,84,153
https://kawalpemilu.org#21308,"LUBUK PENDAM, TANJUNGAGUNG PALIK, BENGKULU UTARA, BENGKULU",1,62,117,179
https://kawalpemilu.org#21308,"LUBUK PENDAM, TANJUNGAGUNG PALIK, BENGKULU UTARA, BENGKULU",2,53,100,153
https://kawalpemilu.org#21457,"PADANG SEPAN, TANJUNGAGUNG PALIK, BENGKULU UTARA, BENGKULU",1,55,179,234
https://kawalpemilu.org#21457,"PADANG SEPAN, TANJUNGAGUNG PALIK, BENGKULU UTARA, BENGKULU",2,48,186,234
https://kawalpemilu.org#21478,"SAWANG LEBAR, TANJUNGAGUNG PALIK, BENGKULU UTARA, BENGKULU",1,96,106,202
https://kawalpemilu.org#21478,"SAWANG LEBAR, TANJUNGAGUNG PALIK, BENGKULU UTARA, BENGKULU",2,103,80,183
https://kawalpemilu.org#21478,"SAWANG LEBAR, TANJUNGAGUNG PALIK, BENGKULU UTARA, BENGKULU",3,105,112,217
https://kawalpemilu.org#21478,"SAWANG LEBAR, TANJUNGAGUNG PALIK, BENGKULU UTARA, BENGKULU",4,103,105,208
https://kawalpemilu.org#21484,"LUBUK SEMANTUNG, TANJUNGAGUNG PALIK, BENGKULU UTARA, BENGKULU",1,57,146,203
https://kawalpemilu.org#21484,"LUBUK SEMANTUNG, TANJUNGAGUNG PALIK, BENGKULU UTARA, BENGKULU",2,99,108,207
https://kawalpemilu.org#21486,"KETAPI, TANJUNGAGUNG PALIK, BENGKULU UTARA, BENGKULU",1,19,74,93
https://kawalpemilu.org#21487,"LUBUK GADING, TANJUNGAGUNG PALIK, BENGKULU UTARA, BENGKULU",1,90,90,180
https://kawalpemilu.org#21487,"LUBUK GADING, TANJUNGAGUNG PALIK, BENGKULU UTARA, BENGKULU",2,85,84,169
https://kawalpemilu.org#21491,"SAWANG LEBAR ILIR, TANJUNGAGUNG PALIK, BENGKULU UTARA, BENGKULU",1,42,161,203
https://kawalpemilu.org#21491,"SAWANG LEBAR ILIR, TANJUNGAGUNG PALIK, BENGKULU UTARA, BENGKULU",2,48,177,225
https://kawalpemilu.org#21491,"SAWANG LEBAR ILIR, TANJUNGAGUNG PALIK, BENGKULU UTARA, BENGKULU",3,60,153,213
https://kawalpemilu.org#87333,"ALUN DUA, TANJUNGAGUNG PALIK, BENGKULU UTARA, BENGKULU",1,119,98,217
https://kawalpemilu.org#87333,"ALUN DUA, TANJUNGAGUNG PALIK, BENGKULU UTARA, BENGKULU",2,110,117,227
https://kawalpemilu.org#87334,"TANJUNG AGUNG, TANJUNGAGUNG PALIK, BENGKULU UTARA, BENGKULU",1,65,115,180
https://kawalpemilu.org#87334,"TANJUNG AGUNG, TANJUNGAGUNG PALIK, BENGKULU UTARA, BENGKULU",2,70,143,213
https://kawalpemilu.org#87334,"TANJUNG AGUNG, TANJUNGAGUNG PALIK, BENGKULU UTARA, BENGKULU",3,116,86,202
https://kawalpemilu.org#87334,"TANJUNG AGUNG, TANJUNGAGUNG PALIK, BENGKULU UTARA, BENGKULU",4,59,118,177
https://kawalpemilu.org#87334,"TANJUNG AGUNG, TANJUNGAGUNG PALIK, BENGKULU UTARA, BENGKULU",5,92,104,196
https://kawalpemilu.org#21402,"BUKIT MAKMUR, PINANG RAYA, BENGKULU UTARA, BENGKULU",1,113,44,157
https://kawalpemilu.org#21402,"BUKIT MAKMUR, PINANG RAYA, BENGKULU UTARA, BENGKULU",2,189,61,250
https://kawalpemilu.org#21402,"BUKIT MAKMUR, PINANG RAYA, BENGKULU UTARA, BENGKULU",3,152,88,240
https://kawalpemilu.org#21402,"BUKIT MAKMUR, PINANG RAYA, BENGKULU UTARA, BENGKULU",4,146,72,218
https://kawalpemilu.org#21402,"BUKIT MAKMUR, PINANG RAYA, BENGKULU UTARA, BENGKULU",5,212,30,242
https://kawalpemilu.org#21402,"BUKIT MAKMUR, PINANG RAYA, BENGKULU UTARA, BENGKULU",6,216,35,251
https://kawalpemilu.org#21402,"BUKIT MAKMUR, PINANG RAYA, BENGKULU UTARA, BENGKULU",7,149,14,163
https://kawalpemilu.org#21402,"BUKIT MAKMUR, PINANG RAYA, BENGKULU UTARA, BENGKULU",8,111,33,144
https://kawalpemilu.org#21402,"BUKIT MAKMUR, PINANG RAYA, BENGKULU UTARA, BENGKULU",10,254,23,277
https://kawalpemilu.org#21402,"BUKIT MAKMUR, PINANG RAYA, BENGKULU UTARA, BENGKULU",11,118,21,139
https://kawalpemilu.org#21402,"BUKIT MAKMUR, PINANG RAYA, BENGKULU UTARA, BENGKULU",12,161,28,189
https://kawalpemilu.org#21402,"BUKIT MAKMUR, PINANG RAYA, BENGKULU UTARA, BENGKULU",13,183,37,220
https://kawalpemilu.org#21403,"MARGA BHAKTI, PINANG RAYA, BENGKULU UTARA, BENGKULU",1,207,47,254
https://kawalpemilu.org#21403,"MARGA BHAKTI, PINANG RAYA, BENGKULU UTARA, BENGKULU",2,245,33,278
https://kawalpemilu.org#21403,"MARGA BHAKTI, PINANG RAYA, BENGKULU UTARA, BENGKULU",3,202,23,225
https://kawalpemilu.org#21403,"MARGA BHAKTI, PINANG RAYA, BENGKULU UTARA, BENGKULU",4,235,23,258
https://kawalpemilu.org#21403,"MARGA BHAKTI, PINANG RAYA, BENGKULU UTARA, BENGKULU",5,173,68,241
https://kawalpemilu.org#21403,"MARGA BHAKTI, PINANG RAYA, BENGKULU UTARA, BENGKULU",6,251,16,267
https://kawalpemilu.org#21403,"MARGA BHAKTI, PINANG RAYA, BENGKULU UTARA, BENGKULU",7,196,69,265
https://kawalpemilu.org#21404,"AIR SIMPANG, PINANG RAYA, BENGKULU UTARA, BENGKULU",1,216,43,259
https://kawalpemilu.org#21404,"AIR SIMPANG, PINANG RAYA, BENGKULU UTARA, BENGKULU",2,170,33,203
https://kawalpemilu.org#21404,"AIR SIMPANG, PINANG RAYA, BENGKULU UTARA, BENGKULU",3,89,133,222
https://kawalpemilu.org#21404,"AIR SIMPANG, PINANG RAYA, BENGKULU UTARA, BENGKULU",4,157,36,193
https://kawalpemilu.org#21404,"AIR SIMPANG, PINANG RAYA, BENGKULU UTARA, BENGKULU",5,133,73,206
https://kawalpemilu.org#21405,"AIR SEKAMANAK, PINANG RAYA, BENGKULU UTARA, BENGKULU",1,223,17,240
https://kawalpemilu.org#21405,"AIR SEKAMANAK, PINANG RAYA, BENGKULU UTARA, BENGKULU",2,239,35,274
https://kawalpemilu.org#21405,"AIR SEKAMANAK, PINANG RAYA, BENGKULU UTARA, BENGKULU",3,199,32,231
https://kawalpemilu.org#21405,"AIR SEKAMANAK, PINANG RAYA, BENGKULU UTARA, BENGKULU",4,197,26,223
https://kawalpemilu.org#21405,"AIR SEKAMANAK, PINANG RAYA, BENGKULU UTARA, BENGKULU",5,104,80,184
https://kawalpemilu.org#21406,"BUKIT HARAPAN, PINANG RAYA, BENGKULU UTARA, BENGKULU",1,229,39,268
https://kawalpemilu.org#21406,"BUKIT HARAPAN, PINANG RAYA, BENGKULU UTARA, BENGKULU",2,181,53,234
https://kawalpemilu.org#21406,"BUKIT HARAPAN, PINANG RAYA, BENGKULU UTARA, BENGKULU",3,201,48,249
https://kawalpemilu.org#21406,"BUKIT HARAPAN, PINANG RAYA, BENGKULU UTARA, BENGKULU",4,199,49,248
https://kawalpemilu.org#21406,"BUKIT HARAPAN, PINANG RAYA, BENGKULU UTARA, BENGKULU",5,108,65,173
https://kawalpemilu.org#21406,"BUKIT HARAPAN, PINANG RAYA, BENGKULU UTARA, BENGKULU",7,66,36,102
https://kawalpemilu.org#21406,"BUKIT HARAPAN, PINANG RAYA, BENGKULU UTARA, BENGKULU",8,126,1,127
https://kawalpemilu.org#21406,"BUKIT HARAPAN, PINANG RAYA, BENGKULU UTARA, BENGKULU",9,69,4,73
https://kawalpemilu.org#21406,"BUKIT HARAPAN, PINANG RAYA, BENGKULU UTARA, BENGKULU",10,110,42,152
https://kawalpemilu.org#21406,"BUKIT HARAPAN, PINANG RAYA, BENGKULU UTARA, BENGKULU",12,126,43,169
https://kawalpemilu.org#21407,"GUNUNG PAYUNG, PINANG RAYA, BENGKULU UTARA, BENGKULU",1,152,67,219
https://kawalpemilu.org#21411,"AIR SEBAYUR, PINANG RAYA, BENGKULU UTARA, BENGKULU",1,150,65,215
https://kawalpemilu.org#21411,"AIR SEBAYUR, PINANG RAYA, BENGKULU UTARA, BENGKULU",2,146,31,177
https://kawalpemilu.org#21411,"AIR SEBAYUR, PINANG RAYA, BENGKULU UTARA, BENGKULU",3,163,16,179
https://kawalpemilu.org#21411,"AIR SEBAYUR, PINANG RAYA, BENGKULU UTARA, BENGKULU",4,94,147,241
https://kawalpemilu.org#21411,"AIR SEBAYUR, PINANG RAYA, BENGKULU UTARA, BENGKULU",5,50,70,120
https://kawalpemilu.org#21411,"AIR SEBAYUR, PINANG RAYA, BENGKULU UTARA, BENGKULU",6,185,46,231
https://kawalpemilu.org#21411,"AIR SEBAYUR, PINANG RAYA, BENGKULU UTARA, BENGKULU",7,243,50,293
https://kawalpemilu.org#21411,"AIR SEBAYUR, PINANG RAYA, BENGKULU UTARA, BENGKULU",8,168,11,179
https://kawalpemilu.org#21411,"AIR SEBAYUR, PINANG RAYA, BENGKULU UTARA, BENGKULU",9,174,54,228
https://kawalpemilu.org#21411,"AIR SEBAYUR, PINANG RAYA, BENGKULU UTARA, BENGKULU",10,116,53,166
https://kawalpemilu.org#21412,"SUMBER MULYA, PINANG RAYA, BENGKULU UTARA, BENGKULU",1,187,30,217
https://kawalpemilu.org#21412,"SUMBER MULYA, PINANG RAYA, BENGKULU UTARA, BENGKULU",2,204,34,238
https://kawalpemilu.org#21412,"SUMBER MULYA, PINANG RAYA, BENGKULU UTARA, BENGKULU",4,181,38,219
https://kawalpemilu.org#21413,"BUMI HARJO, PINANG RAYA, BENGKULU UTARA, BENGKULU",1,138,52,190
https://kawalpemilu.org#21413,"BUMI HARJO, PINANG RAYA, BENGKULU UTARA, BENGKULU",2,137,80,217
https://kawalpemilu.org#21413,"BUMI HARJO, PINANG RAYA, BENGKULU UTARA, BENGKULU",4,138,94,232
https://kawalpemilu.org#87341,"TANJUNG MUARA, PINANG RAYA, BENGKULU UTARA, BENGKULU",1,188,43,231
https://kawalpemilu.org#87341,"TANJUNG MUARA, PINANG RAYA, BENGKULU UTARA, BENGKULU",2,75,51,126
https://kawalpemilu.org#87341,"TANJUNG MUARA, PINANG RAYA, BENGKULU UTARA, BENGKULU",3,136,93,229
https://kawalpemilu.org#87341,"TANJUNG MUARA, PINANG RAYA, BENGKULU UTARA, BENGKULU",4,117,25,142
https://kawalpemilu.org#21437,"KARYA BHAKTI, MARGA SAKTI SEBELAT, BENGKULU UTARA, BENGKULU",1,217,28,245
https://kawalpemilu.org#21437,"KARYA BHAKTI, MARGA SAKTI SEBELAT, BENGKULU UTARA, BENGKULU",2,229,43,272
https://kawalpemilu.org#21437,"KARYA BHAKTI, MARGA SAKTI SEBELAT, BENGKULU UTARA, BENGKULU",3,212,54,266
https://kawalpemilu.org#21437,"KARYA BHAKTI, MARGA SAKTI SEBELAT, BENGKULU UTARA, BENGKULU",4,197,39,236
https://kawalpemilu.org#21437,"KARYA BHAKTI, MARGA SAKTI SEBELAT, BENGKULU UTARA, BENGKULU",5,100,20,120
https://kawalpemilu.org#21437,"KARYA BHAKTI, MARGA SAKTI SEBELAT, BENGKULU UTARA, BENGKULU",6,121,15,136
https://kawalpemilu.org#21438,"SUKA BARU, MARGA SAKTI SEBELAT, BENGKULU UTARA, BENGKULU",1,157,55,212
https://kawalpemilu.org#21438,"SUKA BARU, MARGA SAKTI SEBELAT, BENGKULU UTARA, BENGKULU",2,176,20,196
https://kawalpemilu.org#21438,"SUKA BARU, MARGA SAKTI SEBELAT, BENGKULU UTARA, BENGKULU",3,90,22,112
https://kawalpemilu.org#21438,"SUKA BARU, MARGA SAKTI SEBELAT, BENGKULU UTARA, BENGKULU",4,140,59,199
https://kawalpemilu.org#21439,"SUKA MAJU, MARGA SAKTI SEBELAT, BENGKULU UTARA, BENGKULU",1,120,74,194
https://kawalpemilu.org#21439,"SUKA MAJU, MARGA SAKTI SEBELAT, BENGKULU UTARA, BENGKULU",2,166,38,204
https://kawalpemilu.org#21439,"SUKA MAJU, MARGA SAKTI SEBELAT, BENGKULU UTARA, BENGKULU",3,162,10,172
https://kawalpemilu.org#21439,"SUKA MAJU, MARGA SAKTI SEBELAT, BENGKULU UTARA, BENGKULU",4,150,10,160
https://kawalpemilu.org#21440,"SUKA MERINDU, MARGA SAKTI SEBELAT, BENGKULU UTARA, BENGKULU",1,140,93,233
https://kawalpemilu.org#21440,"SUKA MERINDU, MARGA SAKTI SEBELAT, BENGKULU UTARA, BENGKULU",2,57,111,168
https://kawalpemilu.org#21441,"SUKA MEDAN, MARGA SAKTI SEBELAT, BENGKULU UTARA, BENGKULU",1,107,63,170
https://kawalpemilu.org#21441,"SUKA MEDAN, MARGA SAKTI SEBELAT, BENGKULU UTARA, BENGKULU",2,136,91,227
https://kawalpemilu.org#21441,"SUKA MEDAN, MARGA SAKTI SEBELAT, BENGKULU UTARA, BENGKULU",3,82,93,175
https://kawalpemilu.org#21442,"SUKA NEGARA, MARGA SAKTI SEBELAT, BENGKULU UTARA, BENGKULU",1,67,75,142
https://kawalpemilu.org#21442,"SUKA NEGARA, MARGA SAKTI SEBELAT, BENGKULU UTARA, BENGKULU",2,73,123,196
https://kawalpemilu.org#21442,"SUKA NEGARA, MARGA SAKTI SEBELAT, BENGKULU UTARA, BENGKULU",3,86,108,194
https://kawalpemilu.org#21446,"KARYA JAYA, MARGA SAKTI SEBELAT, BENGKULU UTARA, BENGKULU",1,168,11,179
https://kawalpemilu.org#21446,"KARYA JAYA, MARGA SAKTI SEBELAT, BENGKULU UTARA, BENGKULU",2,168,11,179
https://kawalpemilu.org#21447,"SUKA MAKMUR, MARGA SAKTI SEBELAT, BENGKULU UTARA, BENGKULU",1,132,49,181
https://kawalpemilu.org#21447,"SUKA MAKMUR, MARGA SAKTI SEBELAT, BENGKULU UTARA, BENGKULU",2,135,54,189
https://kawalpemilu.org#21447,"SUKA MAKMUR, MARGA SAKTI SEBELAT, BENGKULU UTARA, BENGKULU",3,141,43,184
https://kawalpemilu.org#21447,"SUKA MAKMUR, MARGA SAKTI SEBELAT, BENGKULU UTARA, BENGKULU",4,135,48,183
https://kawalpemilu.org#21447,"SUKA MAKMUR, MARGA SAKTI SEBELAT, BENGKULU UTARA, BENGKULU",5,194,36,230
https://kawalpemilu.org#21447,"SUKA MAKMUR, MARGA SAKTI SEBELAT, BENGKULU UTARA, BENGKULU",6,192,15,207
https://kawalpemilu.org#21447,"SUKA MAKMUR, MARGA SAKTI SEBELAT, BENGKULU UTARA, BENGKULU",7,117,44,161
https://kawalpemilu.org#21447,"SUKA MAKMUR, MARGA SAKTI SEBELAT, BENGKULU UTARA, BENGKULU",8,120,48,168
https://kawalpemilu.org#21447,"SUKA MAKMUR, MARGA SAKTI SEBELAT, BENGKULU UTARA, BENGKULU",9,115,43,158
https://kawalpemilu.org#21447,"SUKA MAKMUR, MARGA SAKTI SEBELAT, BENGKULU UTARA, BENGKULU",10,144,63,207
https://kawalpemilu.org#21447,"SUKA MAKMUR, MARGA SAKTI SEBELAT, BENGKULU UTARA, BENGKULU",11,128,47,175
https://kawalpemilu.org#21447,"SUKA MAKMUR, MARGA SAKTI SEBELAT, BENGKULU UTARA, BENGKULU",12,163,39,202
https://kawalpemilu.org#21448,"AIR PUTIH, MARGA SAKTI SEBELAT, BENGKULU UTARA, BENGKULU",1,187,37,224
https://kawalpemilu.org#21448,"AIR PUTIH, MARGA SAKTI SEBELAT, BENGKULU UTARA, BENGKULU",2,197,32,229
https://kawalpemilu.org#21448,"AIR PUTIH, MARGA SAKTI SEBELAT, BENGKULU UTARA, BENGKULU",3,151,59,210
https://kawalpemilu.org#21448,"AIR PUTIH, MARGA SAKTI SEBELAT, BENGKULU UTARA, BENGKULU",4,150,49,199
https://kawalpemilu.org#21448,"AIR PUTIH, MARGA SAKTI SEBELAT, BENGKULU UTARA, BENGKULU",5,136,80,216
https://kawalpemilu.org#21448,"AIR PUTIH, MARGA SAKTI SEBELAT, BENGKULU UTARA, BENGKULU",6,98,44,142
https://kawalpemilu.org#21448,"AIR PUTIH, MARGA SAKTI SEBELAT, BENGKULU UTARA, BENGKULU",7,152,36,188
https://kawalpemilu.org#21448,"AIR PUTIH, MARGA SAKTI SEBELAT, BENGKULU UTARA, BENGKULU",8,146,53,199
https://kawalpemilu.org#21452,"KARYA PELITA, MARGA SAKTI SEBELAT, BENGKULU UTARA, BENGKULU",1,159,103,262
https://kawalpemilu.org#21452,"KARYA PELITA, MARGA SAKTI SEBELAT, BENGKULU UTARA, BENGKULU",2,138,99,237
https://kawalpemilu.org#21452,"KARYA PELITA, MARGA SAKTI SEBELAT, BENGKULU UTARA, BENGKULU",3,155,80,235
https://kawalpemilu.org#21494,"GEDUNG WANI, KINAL, KAUR, BENGKULU",1,105,83,188
https://kawalpemilu.org#21495,"PENANDINGAN, KINAL, KAUR, BENGKULU",1,50,108,158
https://kawalpemilu.org#21495,"PENANDINGAN, KINAL, KAUR, BENGKULU",2,55,88,143
https://kawalpemilu.org#21496,"GERAMAT, KINAL, KAUR, BENGKULU",1,167,81,248
https://kawalpemilu.org#21497,"TANJUNG ALAM, KINAL, KAUR, BENGKULU",1,112,71,183
https://kawalpemilu.org#21498,"TANJUNG BARU, KINAL, KAUR, BENGKULU",1,60,63,123
https://kawalpemilu.org#21498,"TANJUNG BARU, KINAL, KAUR, BENGKULU",2,55,71,126
https://kawalpemilu.org#21499,"PENGURUNG, KINAL, KAUR, BENGKULU",1,89,50,139
https://kawalpemilu.org#21500,"PINANG JAWA, KINAL, KAUR, BENGKULU",1,92,42,134
https://kawalpemilu.org#21501,"GUNUNG TERANG, KINAL, KAUR, BENGKULU",1,100,55,155
https://kawalpemilu.org#21501,"GUNUNG TERANG, KINAL, KAUR, BENGKULU",2,99,92,191
https://kawalpemilu.org#21502,"TALANG PADANG, KINAL, KAUR, BENGKULU",1,101,59,160
https://kawalpemilu.org#21502,"TALANG PADANG, KINAL, KAUR, BENGKULU",2,69,91,160
https://kawalpemilu.org#21503,"GUNUNG MEGANG, KINAL, KAUR, BENGKULU",1,68,82,150
https://kawalpemilu.org#21503,"GUNUNG MEGANG, KINAL, KAUR, BENGKULU",2,52,16,68
https://kawalpemilu.org#21504,"TALANG BERANGIN, KINAL, KAUR, BENGKULU",1,82,15,97
https://kawalpemilu.org#21505,"JAWI, KINAL, KAUR, BENGKULU",1,42,87,129
https://kawalpemilu.org#21505,"JAWI, KINAL, KAUR, BENGKULU",2,57,113,170
https://kawalpemilu.org#21506,"PAPAHAN, KINAL, KAUR, BENGKULU",1,80,48,128
https://kawalpemilu.org#21507,"PINANG JAWA II, KINAL, KAUR, BENGKULU",1,115,88,203
https://kawalpemilu.org#21509,"TINGGI ARI, TANJUNG KEMUNING, KAUR, BENGKULU",1,152,73,225
https://kawalpemilu.org#21509,"TINGGI ARI, TANJUNG KEMUNING, KAUR, BENGKULU",2,159,64,223
https://kawalpemilu.org#21510,"TANJUNG AUR, TANJUNG KEMUNING, KAUR, BENGKULU",1,102,70,172
https://kawalpemilu.org#21510,"TANJUNG AUR, TANJUNG KEMUNING, KAUR, BENGKULU",2,96,66,162
https://kawalpemilu.org#21511,"AUR RINGIT, TANJUNG KEMUNING, KAUR, BENGKULU",1,110,54,164
https://kawalpemilu.org#21511,"AUR RINGIT, TANJUNG KEMUNING, KAUR, BENGKULU",2,107,69,176
https://kawalpemilu.org#21511,"AUR RINGIT, TANJUNG KEMUNING, KAUR, BENGKULU",3,110,69,179
https://kawalpemilu.org#21512,"PELAJARAN I, TANJUNG KEMUNING, KAUR, BENGKULU",1,54,83,137
https://kawalpemilu.org#21512,"PELAJARAN I, TANJUNG KEMUNING, KAUR, BENGKULU",2,48,87,135
https://kawalpemilu.org#21513,"TANJUNG KEMUNING, TANJUNG KEMUNING, KAUR, BENGKULU",1,69,94,163
https://kawalpemilu.org#21513,"TANJUNG KEMUNING, TANJUNG KEMUNING, KAUR, BENGKULU",2,63,82,145
https://kawalpemilu.org#21514,"SELIKA I, TANJUNG KEMUNING, KAUR, BENGKULU",1,91,149,240
https://kawalpemilu.org#21515,"TANJUNG IMAN, TANJUNG KEMUNING, KAUR, BENGKULU",1,128,55,183
https://kawalpemilu.org#21515,"TANJUNG IMAN, TANJUNG KEMUNING, KAUR, BENGKULU",2,115,57,172
https://kawalpemilu.org#21516,"PADANG LEBAN, TANJUNG KEMUNING, KAUR, BENGKULU",1,147,112,259
https://kawalpemilu.org#21516,"PADANG LEBAN, TANJUNG KEMUNING, KAUR, BENGKULU",2,142,73,215
https://kawalpemilu.org#21516,"PADANG LEBAN, TANJUNG KEMUNING, KAUR, BENGKULU",3,166,96,262
https://kawalpemilu.org#21516,"PADANG LEBAN, TANJUNG KEMUNING, KAUR, BENGKULU",4,95,104,199
https://kawalpemilu.org#21517,"BERIANG TINGGI, TANJUNG KEMUNING, KAUR, BENGKULU",1,196,93,289
https://kawalpemilu.org#21517,"BERIANG TINGGI, TANJUNG KEMUNING, KAUR, BENGKULU",2,132,90,222
https://kawalpemilu.org#21517,"BERIANG TINGGI, TANJUNG KEMUNING, KAUR, BENGKULU",3,90,58,147
https://kawalpemilu.org#21518,"TANJUNG BULAN, TANJUNG KEMUNING, KAUR, BENGKULU",1,120,101,221
https://kawalpemilu.org#21518,"TANJUNG BULAN, TANJUNG KEMUNING, KAUR, BENGKULU",2,145,87,232
https://kawalpemilu.org#21518,"TANJUNG BULAN, TANJUNG KEMUNING, KAUR, BENGKULU",3,122,67,189
https://kawalpemilu.org#21519,"PELAJARAN II, TANJUNG KEMUNING, KAUR, BENGKULU",1,121,75,196
https://kawalpemilu.org#21520,"SELIKA II, TANJUNG KEMUNING, KAUR, BENGKULU",1,66,80,146
https://kawalpemilu.org#21520,"SELIKA II, TANJUNG KEMUNING, KAUR, BENGKULU",2,67,75,142
https://kawalpemilu.org#21521,"SULAUWANGI, TANJUNG KEMUNING, KAUR, BENGKULU",1,110,77,187
https://kawalpemilu.org#21521,"SULAUWANGI, TANJUNG KEMUNING, KAUR, BENGKULU",2,112,70,182
https://kawalpemilu.org#21522,"PADANG KEDONDONG, TANJUNG KEMUNING, KAUR, BENGKULU",1,85,83,168
https://kawalpemilu.org#21522,"PADANG KEDONDONG, TANJUNG KEMUNING, KAUR, BENGKULU",2,96,63,159
https://kawalpemilu.org#21523,"PADANG TINGGI, TANJUNG KEMUNING, KAUR, BENGKULU",1,153,74,227
https://kawalpemilu.org#21524,"TANJUNG KEMUNING II, TANJUNG KEMUNING, KAUR, BENGKULU",1,78,143,221
https://kawalpemilu.org#21524,"TANJUNG KEMUNING II, TANJUNG KEMUNING, KAUR, BENGKULU",2,72,163,235
https://kawalpemilu.org#21525,"TANJUNG KEMUNING III, TANJUNG KEMUNING, KAUR, BENGKULU",1,81,109,190
https://kawalpemilu.org#21525,"TANJUNG KEMUNING III, TANJUNG KEMUNING, KAUR, BENGKULU",2,76,109,185
https://kawalpemilu.org#21526,"TANJUNG AUR II, TANJUNG KEMUNING, KAUR, BENGKULU",1,89,59,148
https://kawalpemilu.org#21526,"TANJUNG AUR II, TANJUNG KEMUNING, KAUR, BENGKULU",2,82,43,125
https://kawalpemilu.org#21527,"TANJUNG IMAN II, TANJUNG KEMUNING, KAUR, BENGKULU",1,129,50,179
https://kawalpemilu.org#21527,"TANJUNG IMAN II, TANJUNG KEMUNING, KAUR, BENGKULU",2,148,32,180
https://kawalpemilu.org#21528,"SELIKA III, TANJUNG KEMUNING, KAUR, BENGKULU",1,95,102,197
https://kawalpemilu.org#21528,"SELIKA III, TANJUNG KEMUNING, KAUR, BENGKULU",2,78,96,174
https://kawalpemilu.org#21530,"SIMPANG TIGA, KAUR UTARA, KAUR, BENGKULU",1,112,91,203
https://kawalpemilu.org#21530,"SIMPANG TIGA, KAUR UTARA, KAUR, BENGKULU",2,140,98,238
https://kawalpemilu.org#21530,"SIMPANG TIGA, KAUR UTARA, KAUR, BENGKULU",3,111,136,247
https://kawalpemilu.org#21530,"SIMPANG TIGA, KAUR UTARA, KAUR, BENGKULU",4,102,68,170
https://kawalpemilu.org#21530,"SIMPANG TIGA, KAUR UTARA, KAUR, BENGKULU",5,103,61,164
https://kawalpemilu.org#21530,"SIMPANG TIGA, KAUR UTARA, KAUR, BENGKULU",6,130,116,246
https://kawalpemilu.org#21531,"TANJUNG BETUNG I, KAUR UTARA, KAUR, BENGKULU",1,67,94,161
https://kawalpemilu.org#21531,"TANJUNG BETUNG I, KAUR UTARA, KAUR, BENGKULU",2,37,62,99
https://kawalpemilu.org#21532,"PADANG MANIS, KAUR UTARA, KAUR, BENGKULU",1,120,64,184
https://kawalpemilu.org#21532,"PADANG MANIS, KAUR UTARA, KAUR, BENGKULU",2,108,85,193
https://kawalpemilu.org#21533,"GURU AGUNG, KAUR UTARA, KAUR, BENGKULU",1,75,81,156
https://kawalpemilu.org#21533,"GURU AGUNG, KAUR UTARA, KAUR, BENGKULU",2,69,65,134
https://kawalpemilu.org#21534,"GUNUNG AGUNG, KAUR UTARA, KAUR, BENGKULU",1,99,72,171
https://kawalpemilu.org#21534,"GUNUNG AGUNG, KAUR UTARA, KAUR, BENGKULU",2,56,91,147
https://kawalpemilu.org#21535,"BANDU AGUNG, KAUR UTARA, KAUR, BENGKULU",1,142,101,243
https://kawalpemilu.org#21535,"BANDU AGUNG, KAUR UTARA, KAUR, BENGKULU",2,131,91,222
https://kawalpemilu.org#21536,"TANJUNG BETUNG II, KAUR UTARA, KAUR, BENGKULU",1,107,91,198
https://kawalpemilu.org#21537,"COKO ENAU, KAUR UTARA, KAUR, BENGKULU",1,68,116,184
https://kawalpemilu.org#21537,"COKO ENAU, KAUR UTARA, KAUR, BENGKULU",2,33,89,122
https://kawalpemilu.org#21538,"PANCUR NEGARA, KAUR UTARA, KAUR, BENGKULU",1,78,91,169
https://kawalpemilu.org#21538,"PANCUR NEGARA, KAUR UTARA, KAUR, BENGKULU",2,50,64,114
https://kawalpemilu.org#21539,"PERUGAIAN, KAUR UTARA, KAUR, BENGKULU",1,105,75,180
https://kawalpemilu.org#21539,"PERUGAIAN, KAUR UTARA, KAUR, BENGKULU",2,100,88,188
https://kawalpemilu.org#21540,"GURU AGUNG II, KAUR UTARA, KAUR, BENGKULU",1,76,59,135
https://kawalpemilu.org#21540,"GURU AGUNG II, KAUR UTARA, KAUR, BENGKULU",2,75,76,151
https://kawalpemilu.org#21542,"TANJUNG IMAN, KAUR TENGAH, KAUR, BENGKULU",1,46,191,237
https://kawalpemilu.org#21542,"TANJUNG IMAN, KAUR TENGAH, KAUR, BENGKULU",2,41,210,251
https://kawalpemilu.org#21542,"TANJUNG IMAN, KAUR TENGAH, KAUR, BENGKULU",3,31,198,229
https://kawalpemilu.org#21542,"TANJUNG IMAN, KAUR TENGAH, KAUR, BENGKULU",4,56,128,184
https://kawalpemilu.org#21543,"SUKARAMI, KAUR TENGAH, KAUR, BENGKULU",1,58,165,223
https://kawalpemilu.org#21543,"SUKARAMI, KAUR TENGAH, KAUR, BENGKULU",2,75,125,200
https://kawalpemilu.org#21544,"PAJAR BULAN, KAUR TENGAH, KAUR, BENGKULU",1,68,201,269
https://kawalpemilu.org#21545,"PADANG HANGAT, KAUR TENGAH, KAUR, BENGKULU",1,28,194,222
https://kawalpemilu.org#21545,"PADANG HANGAT, KAUR TENGAH, KAUR, BENGKULU",2,29,187,216
https://kawalpemilu.org#21546,"KEMANG MANIS, KAUR TENGAH, KAUR, BENGKULU",1,20,134,154
https://kawalpemilu.org#21547,"PENYANDINGAN, KAUR TENGAH, KAUR, BENGKULU",1,25,95,120
https://kawalpemilu.org#21548,"SINAR JAYA, KAUR TENGAH, KAUR, BENGKULU",1,33,99,132
https://kawalpemilu.org#21548,"SINAR JAYA, KAUR TENGAH, KAUR, BENGKULU",2,45,95,140
https://kawalpemilu.org#21549,"TANJUNG PANDAN, KAUR TENGAH, KAUR, BENGKULU",1,62,110,172
https://kawalpemilu.org#21549,"TANJUNG PANDAN, KAUR TENGAH, KAUR, BENGKULU",2,46,105,151
https://kawalpemilu.org#21550,"PADANG BARU, KAUR TENGAH, KAUR, BENGKULU",1,39,207,246
https://kawalpemilu.org#21552,"BANDAR BINTUHAN, KAUR SELATAN, KAUR, BENGKULU",1,47,216,263
https://kawalpemilu.org#21552,"BANDAR BINTUHAN, KAUR SELATAN, KAUR, BENGKULU",2,61,161,222
https://kawalpemilu.org#21552,"BANDAR BINTUHAN, KAUR SELATAN, KAUR, BENGKULU",3,59,133,191
https://kawalpemilu.org#21553,"SEKUNYIT, KAUR SELATAN, KAUR, BENGKULU",1,43,170,213
https://kawalpemilu.org#21553,"SEKUNYIT, KAUR SELATAN, KAUR, BENGKULU",2,80,167,247
https://kawalpemilu.org#21553,"SEKUNYIT, KAUR SELATAN, KAUR, BENGKULU",3,58,162,220
https://kawalpemilu.org#21554,"SUKA BANDUNG, KAUR SELATAN, KAUR, BENGKULU",1,74,190,264
https://kawalpemilu.org#21554,"SUKA BANDUNG, KAUR SELATAN, KAUR, BENGKULU",2,67,118,185
https://kawalpemilu.org#21555,"AIR DINGIN, KAUR SELATAN, KAUR, BENGKULU",1,88,190,278
https://kawalpemilu.org#21555,"AIR DINGIN, KAUR SELATAN, KAUR, BENGKULU",2,56,98,154
https://kawalpemilu.org#21556,"PASAR BARU, KAUR SELATAN, KAUR, BENGKULU",1,83,196,279
https://kawalpemilu.org#21556,"PASAR BARU, KAUR SELATAN, KAUR, BENGKULU",2,76,197,273
https://kawalpemilu.org#21557,"PASAR LAMA, KAUR SELATAN, KAUR, BENGKULU",1,125,131,256
https://kawalpemilu.org#21557,"PASAR LAMA, KAUR SELATAN, KAUR, BENGKULU",2,156,130,286
https://kawalpemilu.org#21557,"PASAR LAMA, KAUR SELATAN, KAUR, BENGKULU",3,159,102,261
https://kawalpemilu.org#21558,"GEDUNG SAKO, KAUR SELATAN, KAUR, BENGKULU",1,97,91,188
https://kawalpemilu.org#21558,"GEDUNG SAKO, KAUR SELATAN, KAUR, BENGKULU",2,88,97,185
https://kawalpemilu.org#21559,"JEMBATAN DUA, KAUR SELATAN, KAUR, BENGKULU",1,124,159,283
https://kawalpemilu.org#21559,"JEMBATAN DUA, KAUR SELATAN, KAUR, BENGKULU",2,135,135,270
https://kawalpemilu.org#21559,"JEMBATAN DUA, KAUR SELATAN, KAUR, BENGKULU",3,112,164,276
https://kawalpemilu.org#21559,"JEMBATAN DUA, KAUR SELATAN, KAUR, BENGKULU",4,82,101,183
https://kawalpemilu.org#21560,"TANJUNG BESAR, KAUR SELATAN, KAUR, BENGKULU",1,165,133,298
https://kawalpemilu.org#21560,"TANJUNG BESAR, KAUR SELATAN, KAUR, BENGKULU",2,134,128,262
https://kawalpemilu.org#21561,"PENGUBAIAN, KAUR SELATAN, KAUR, BENGKULU",1,111,104,215
https://kawalpemilu.org#21562,"PAHLAWAN RATU, KAUR SELATAN, KAUR, BENGKULU",1,76,199,275
https://kawalpemilu.org#21562,"PAHLAWAN RATU, KAUR SELATAN, KAUR, BENGKULU",2,102,125,227
https://kawalpemilu.org#21563,"PASAR SAOH, KAUR SELATAN, KAUR, BENGKULU",1,72,152,224
https://kawalpemilu.org#21563,"PASAR SAOH, KAUR SELATAN, KAUR, BENGKULU",2,77,148,225
https://kawalpemilu.org#21564,"KEPALA PASAR, KAUR SELATAN, KAUR, BENGKULU",1,80,154,234
https://kawalpemilu.org#21564,"KEPALA PASAR, KAUR SELATAN, KAUR, BENGKULU",2,61,145,206
https://kawalpemilu.org#21564,"KEPALA PASAR, KAUR SELATAN, KAUR, BENGKULU",3,68,153,221
https://kawalpemilu.org#21565,"PADANG PETRON, KAUR SELATAN, KAUR, BENGKULU",1,53,234,287
https://kawalpemilu.org#21565,"PADANG PETRON, KAUR SELATAN, KAUR, BENGKULU",2,29,129,158
https://kawalpemilu.org#21565,"PADANG PETRON, KAUR SELATAN, KAUR, BENGKULU",3,63,74,137
https://kawalpemilu.org#21566,"SAWAH JANGKUNG, KAUR SELATAN, KAUR, BENGKULU",1,101,150,251
https://kawalpemilu.org#21567,"SELASIH, KAUR SELATAN, KAUR, BENGKULU",1,58,89,147
https://kawalpemilu.org#21567,"SELASIH, KAUR SELATAN, KAUR, BENGKULU",2,42,98,140
https://kawalpemilu.org#21568,"PADANG GENTENG, KAUR SELATAN, KAUR, BENGKULU",1,91,187,278
https://kawalpemilu.org#21568,"PADANG GENTENG, KAUR SELATAN, KAUR, BENGKULU",2,41,72,112
https://kawalpemilu.org#21569,"GEDUNG SAKO II, KAUR SELATAN, KAUR, BENGKULU",1,139,117,256
https://kawalpemilu.org#21569,"GEDUNG SAKO II, KAUR SELATAN, KAUR, BENGKULU",2,70,79,149
https://kawalpemilu.org#21570,"SINAR PAGI, KAUR SELATAN, KAUR, BENGKULU",1,81,186,267
https://kawalpemilu.org#21570,"SINAR PAGI, KAUR SELATAN, KAUR, BENGKULU",2,28,110,138
https://kawalpemilu.org#21570,"SINAR PAGI, KAUR SELATAN, KAUR, BENGKULU",3,21,78,99
https://kawalpemilu.org#21572,"PARDA SUKA, MAJE, KAUR, BENGKULU",1,92,99,191
https://kawalpemilu.org#21572,"PARDA SUKA, MAJE, KAUR, BENGKULU",2,188,58,246
https://kawalpemilu.org#21572,"PARDA SUKA, MAJE, KAUR, BENGKULU",3,113,67,180
https://kawalpemilu.org#21573,"AIR LONG, MAJE, KAUR, BENGKULU",1,160,87,247
https://kawalpemilu.org#21574,"LINAU, MAJE, KAUR, BENGKULU",1,176,94,270
https://kawalpemilu.org#21574,"LINAU, MAJE, KAUR, BENGKULU",2,126,133,259
https://kawalpemilu.org#21574,"LINAU, MAJE, KAUR, BENGKULU",3,36,45,81
https://kawalpemilu.org#21575,"WAY HAWANG, MAJE, KAUR, BENGKULU",1,150,64,214
https://kawalpemilu.org#21575,"WAY HAWANG, MAJE, KAUR, BENGKULU",2,192,61,253
https://kawalpemilu.org#21576,"TANJUNG BARU, MAJE, KAUR, BENGKULU",1,144,99,243
https://kawalpemilu.org#21576,"TANJUNG BARU, MAJE, KAUR, BENGKULU",2,184,88,272
https://kawalpemilu.org#21576,"TANJUNG BARU, MAJE, KAUR, BENGKULU",3,206,49,255
https://kawalpemilu.org#21577,"TANJUNG GANTI, MAJE, KAUR, BENGKULU",1,66,54,120
https://kawalpemilu.org#21578,"KEDATARAN, MAJE, KAUR, BENGKULU",1,71,76,147
https://kawalpemilu.org#21578,"KEDATARAN, MAJE, KAUR, BENGKULU",2,162,12,174
https://kawalpemilu.org#21578,"KEDATARAN, MAJE, KAUR, BENGKULU",3,125,9,134
https://kawalpemilu.org#21578,"KEDATARAN, MAJE, KAUR, BENGKULU",4,144,17,161
https://kawalpemilu.org#21578,"KEDATARAN, MAJE, KAUR, BENGKULU",5,18,37,55
https://kawalpemilu.org#21578,"KEDATARAN, MAJE, KAUR, BENGKULU",6,81,36,117
https://kawalpemilu.org#21578,"KEDATARAN, MAJE, KAUR, BENGKULU",7,108,13,121
https://kawalpemilu.org#21579,"TANJUNG AUR, MAJE, KAUR, BENGKULU",1,179,35,214
https://kawalpemilu.org#21579,"TANJUNG AUR, MAJE, KAUR, BENGKULU",2,178,15,193
https://kawalpemilu.org#21580,"PENYANDINGAN, MAJE, KAUR, BENGKULU",1,37,15,52
https://kawalpemilu.org#21580,"PENYANDINGAN, MAJE, KAUR, BENGKULU",2,79,17,96
https://kawalpemilu.org#21581,"SUKA MENANTI, MAJE, KAUR, BENGKULU",1,149,63,212
https://kawalpemilu.org#21581,"SUKA MENANTI, MAJE, KAUR, BENGKULU",2,187,62,249
https://kawalpemilu.org#21582,"Sinar Mulya, MAJE, KAUR, BENGKULU",1,205,43,248
https://kawalpemilu.org#21582,"Sinar Mulya, MAJE, KAUR, BENGKULU",2,165,30,195
https://kawalpemilu.org#21582,"Sinar Mulya, MAJE, KAUR, BENGKULU",3,111,41,152
https://kawalpemilu.org#21582,"Sinar Mulya, MAJE, KAUR, BENGKULU",4,102,27,129
https://kawalpemilu.org#21583,"BENTENG HARAPAN, MAJE, KAUR, BENGKULU",1,134,96,230
https://kawalpemilu.org#21583,"BENTENG HARAPAN, MAJE, KAUR, BENGKULU",2,116,110,226
https://kawalpemilu.org#21584,"BAKAL MAKMUR, MAJE, KAUR, BENGKULU",1,103,70,173
https://kawalpemilu.org#21584,"BAKAL MAKMUR, MAJE, KAUR, BENGKULU",2,68,50,118
https://kawalpemilu.org#21585,"MUARA JAYA, MAJE, KAUR, BENGKULU",1,139,26,165
https://kawalpemilu.org#21586,"TANJUNG AGUNG, MAJE, KAUR, BENGKULU",1,120,108,228
https://kawalpemilu.org#21586,"TANJUNG AGUNG, MAJE, KAUR, BENGKULU",2,136,107,243
https://kawalpemilu.org#21587,"ARGA MULYA, MAJE, KAUR, BENGKULU",1,141,32,173
https://kawalpemilu.org#21587,"ARGA MULYA, MAJE, KAUR, BENGKULU",2,214,18,232
https://kawalpemilu.org#21588,"AIR JELATANG, MAJE, KAUR, BENGKULU",1,126,77,203
https://kawalpemilu.org#21589,"SUMBER HARAPAN, MAJE, KAUR, BENGKULU",1,142,73,215
https://kawalpemilu.org#21590,"TANJUNG BERINGIN, MAJE, KAUR, BENGKULU",1,175,84,259
https://kawalpemilu.org#21590,"TANJUNG BERINGIN, MAJE, KAUR, BENGKULU",2,204,42,246
https://kawalpemilu.org#21590,"TANJUNG BERINGIN, MAJE, KAUR, BENGKULU",3,137,64,201
https://kawalpemilu.org#21592,"MUARA DUA, NASAL, KAUR, BENGKULU",1,166,66,231
https://kawalpemilu.org#21592,"MUARA DUA, NASAL, KAUR, BENGKULU",2,138,51,189
https://kawalpemilu.org#21592,"MUARA DUA, NASAL, KAUR, BENGKULU",3,185,31,216
https://kawalpemilu.org#21592,"MUARA DUA, NASAL, KAUR, BENGKULU",4,192,3,132
https://kawalpemilu.org#21593,"GEDUNG MENUNG, NASAL, KAUR, BENGKULU",1,93,108,201
https://kawalpemilu.org#21594,"ULAK PANDAN, NASAL, KAUR, BENGKULU",1,110,103,213
https://kawalpemilu.org#21594,"ULAK PANDAN, NASAL, KAUR, BENGKULU",2,64,75,139
https://kawalpemilu.org#21594,"ULAK PANDAN, NASAL, KAUR, BENGKULU",3,144,89,233
https://kawalpemilu.org#21594,"ULAK PANDAN, NASAL, KAUR, BENGKULU",4,82,14,96
https://kawalpemilu.org#21595,"AIR PALAWAN, NASAL, KAUR, BENGKULU",1,142,75,217
https://kawalpemilu.org#21595,"AIR PALAWAN, NASAL, KAUR, BENGKULU",2,86,40,126
https://kawalpemilu.org#21595,"AIR PALAWAN, NASAL, KAUR, BENGKULU",3,89,49,138
https://kawalpemilu.org#21595,"AIR PALAWAN, NASAL, KAUR, BENGKULU",4,173,33,206
https://kawalpemilu.org#21596,"MERPAS, NASAL, KAUR, BENGKULU",1,139,77,216
https://kawalpemilu.org#21596,"MERPAS, NASAL, KAUR, BENGKULU",2,94,101,195
https://kawalpemilu.org#21596,"MERPAS, NASAL, KAUR, BENGKULU",3,76,9,85
https://kawalpemilu.org#21596,"MERPAS, NASAL, KAUR, BENGKULU",4,148,3,151
https://kawalpemilu.org#21596,"MERPAS, NASAL, KAUR, BENGKULU",5,154,83,237
https://kawalpemilu.org#21596,"MERPAS, NASAL, KAUR, BENGKULU",6,43,30,73
https://kawalpemilu.org#21597,"TANJUNG BETUAH, NASAL, KAUR, BENGKULU",1,90,163,253
https://kawalpemilu.org#21597,"TANJUNG BETUAH, NASAL, KAUR, BENGKULU",2,56,24,80
https://kawalpemilu.org#21598,"TEBING RAMBUTAN, NASAL, KAUR, BENGKULU",1,216,43,259
https://kawalpemilu.org#21598,"TEBING RAMBUTAN, NASAL, KAUR, BENGKULU",2,207,22,229
https://kawalpemilu.org#21598,"TEBING RAMBUTAN, NASAL, KAUR, BENGKULU",3,121,17,138
https://kawalpemilu.org#21599,"BATU LUNGUN, NASAL, KAUR, BENGKULU",1,98,114,212
https://kawalpemilu.org#21599,"BATU LUNGUN, NASAL, KAUR, BENGKULU",2,140,56,196
https://kawalpemilu.org#21599,"BATU LUNGUN, NASAL, KAUR, BENGKULU",3,32,3,35
https://kawalpemilu.org#21599,"BATU LUNGUN, NASAL, KAUR, BENGKULU",4,141,16,157
https://kawalpemilu.org#21599,"BATU LUNGUN, NASAL, KAUR, BENGKULU",5,83,38,121
https://kawalpemilu.org#21600,"SUMBER HARAPAN, NASAL, KAUR, BENGKULU",1,186,25,211
https://kawalpemilu.org#21600,"SUMBER HARAPAN, NASAL, KAUR, BENGKULU",2,122,13,135
https://kawalpemilu.org#21600,"SUMBER HARAPAN, NASAL, KAUR, BENGKULU",3,188,22,210
https://kawalpemilu.org#21600,"SUMBER HARAPAN, NASAL, KAUR, BENGKULU",4,172,27,199
https://kawalpemilu.org#21601,"SUKU TIGA, NASAL, KAUR, BENGKULU",1,176,97,273
https://kawalpemilu.org#21601,"SUKU TIGA, NASAL, KAUR, BENGKULU",2,105,50,155
https://kawalpemilu.org#21602,"BUKIT INDAH, NASAL, KAUR, BENGKULU",1,180,20,200
https://kawalpemilu.org#21602,"BUKIT INDAH, NASAL, KAUR, BENGKULU",2,146,37,183
https://kawalpemilu.org#21602,"BUKIT INDAH, NASAL, KAUR, BENGKULU",3,150,32,182
https://kawalpemilu.org#21603,"SUKA JAYA, NASAL, KAUR, BENGKULU",1,169,73,242
https://kawalpemilu.org#21603,"SUKA JAYA, NASAL, KAUR, BENGKULU",2,200,12,212
https://kawalpemilu.org#21604,"PASAR BARU, NASAL, KAUR, BENGKULU",1,102,57,159
https://kawalpemilu.org#21604,"PASAR BARU, NASAL, KAUR, BENGKULU",2,104,53,157
https://kawalpemilu.org#21604,"PASAR BARU, NASAL, KAUR, BENGKULU",3,139,66,205
https://kawalpemilu.org#21605,"TRI JAYA, NASAL, KAUR, BENGKULU",1,181,77,258
https://kawalpemilu.org#21605,"TRI JAYA, NASAL, KAUR, BENGKULU",2,60,16,76
https://kawalpemilu.org#21605,"TRI JAYA, NASAL, KAUR, BENGKULU",3,41,16,57
https://kawalpemilu.org#21606,"AIR BATANG, NASAL, KAUR, BENGKULU",1,212,71,283
https://kawalpemilu.org#21606,"AIR BATANG, NASAL, KAUR, BENGKULU",2,170,16,186
https://kawalpemilu.org#21606,"AIR BATANG, NASAL, KAUR, BENGKULU",3,170,48,218
https://kawalpemilu.org#21607,"SINAR BANTEN, NASAL, KAUR, BENGKULU",1,161,49,210
https://kawalpemilu.org#21608,"PASAR JUM'AT, NASAL, KAUR, BENGKULU",1,187,54,241
https://kawalpemilu.org#21610,"BUNGA MELUR, SEMIDANG GUMAY, KAUR, BENGKULU",1,115,85,200
https://kawalpemilu.org#21610,"BUNGA MELUR, SEMIDANG GUMAY, KAUR, BENGKULU",2,120,97,217
https://kawalpemilu.org#21611,"KARANG DAPO, SEMIDANG GUMAY, KAUR, BENGKULU",1,63,59,122
https://kawalpemilu.org#21611,"KARANG DAPO, SEMIDANG GUMAY, KAUR, BENGKULU",2,92,49,141
https://kawalpemilu.org#21612,"LUBUK GUNG, SEMIDANG GUMAY, KAUR, BENGKULU",1,48,112,160
https://kawalpemilu.org#21613,"GUNUNG TIGA, SEMIDANG GUMAY, KAUR, BENGKULU",1,73,170,243
https://kawalpemilu.org#21614,"SUKA MERINDU, SEMIDANG GUMAY, KAUR, BENGKULU",1,32,88,120
https://kawalpemilu.org#21614,"SUKA MERINDU, SEMIDANG GUMAY, KAUR, BENGKULU",2,70,78,148
https://kawalpemilu.org#21615,"MENTIRING, SEMIDANG GUMAY, KAUR, BENGKULU",1,50,105,155
https://kawalpemilu.org#21615,"MENTIRING, SEMIDANG GUMAY, KAUR, BENGKULU",2,14,144,158
https://kawalpemilu.org#21616,"CAHAYA BATIN, SEMIDANG GUMAY, KAUR, BENGKULU",1,61,188,249
https://kawalpemilu.org#21616,"CAHAYA BATIN, SEMIDANG GUMAY, KAUR, BENGKULU",2,119,64,183
https://kawalpemilu.org#21616,"CAHAYA BATIN, SEMIDANG GUMAY, KAUR, BENGKULU",3,127,57,184
https://kawalpemilu.org#21617,"AWAT MATA, SEMIDANG GUMAY, KAUR, BENGKULU",1,65,137,202
https://kawalpemilu.org#21617,"AWAT MATA, SEMIDANG GUMAY, KAUR, BENGKULU",2,62,114,176
https://kawalpemilu.org#21618,"NUSUK, SEMIDANG GUMAY, KAUR, BENGKULU",1,96,61,157
https://kawalpemilu.org#21618,"NUSUK, SEMIDANG GUMAY, KAUR, BENGKULU",2,103,102,205
https://kawalpemilu.org#21619,"TANJUNG HARAPAN, SEMIDANG GUMAY, KAUR, BENGKULU",1,88,91,179
https://kawalpemilu.org#21619,"TANJUNG HARAPAN, SEMIDANG GUMAY, KAUR, BENGKULU",2,94,83,177
https://kawalpemilu.org#21620,"GUNUNG TIGA II, SEMIDANG GUMAY, KAUR, BENGKULU",1,108,120,228
https://kawalpemilu.org#21621,"PADANG PANJANG, SEMIDANG GUMAY, KAUR, BENGKULU",1,86,99,185
https://kawalpemilu.org#21622,"MASRIA BARU, SEMIDANG GUMAY, KAUR, BENGKULU",1,24,159,183
https://kawalpemilu.org#21624,"TANJUNG GANTI I, KELAM TENGAH, KAUR, BENGKULU",1,54,101,155
https://kawalpemilu.org#21624,"TANJUNG GANTI I, KELAM TENGAH, KAUR, BENGKULU",2,76,148,224
https://kawalpemilu.org#21625,"TANJUNG GANTI II, KELAM TENGAH, KAUR, BENGKULU",1,60,140,200
https://kawalpemilu.org#21625,"TANJUNG GANTI II, KELAM TENGAH, KAUR, BENGKULU",2,66,118,184
https://kawalpemilu.org#21626,"RIGANGAN I, KELAM TENGAH, KAUR, BENGKULU",1,42,153,195
https://kawalpemilu.org#21626,"RIGANGAN I, KELAM TENGAH, KAUR, BENGKULU",2,78,104,182
https://kawalpemilu.org#21627,"RIGANGAN II, KELAM TENGAH, KAUR, BENGKULU",1,83,108,191
https://kawalpemilu.org#21627,"RIGANGAN II, KELAM TENGAH, KAUR, BENGKULU",2,86,116,202
https://kawalpemilu.org#21628,"RIGANGAN III, KELAM TENGAH, KAUR, BENGKULU",1,90,111,201
https://kawalpemilu.org#21628,"RIGANGAN III, KELAM TENGAH, KAUR, BENGKULU",2,113,120,233
https://kawalpemilu.org#21629,"SUKARAMI, KELAM TENGAH, KAUR, BENGKULU",1,62,71,133
https://kawalpemilu.org#21629,"SUKARAMI, KELAM TENGAH, KAUR, BENGKULU",2,84,74,158
https://kawalpemilu.org#21629,"SUKARAMI, KELAM TENGAH, KAUR, BENGKULU",3,72,74,146
https://kawalpemilu.org#21630,"DARAT SAWAH, KELAM TENGAH, KAUR, BENGKULU",1,70,76,146
https://kawalpemilu.org#21630,"DARAT SAWAH, KELAM TENGAH, KAUR, BENGKULU",2,81,68,149
https://kawalpemilu.org#21631,"SIRING AGUNG, KELAM TENGAH, KAUR, BENGKULU",1,115,51,166
https://kawalpemilu.org#21631,"SIRING AGUNG, KELAM TENGAH, KAUR, BENGKULU",2,114,47,161
https://kawalpemilu.org#21632,"PENANTIAN, KELAM TENGAH, KAUR, BENGKULU",1,89,40,129
https://kawalpemilu.org#21632,"PENANTIAN, KELAM TENGAH, KAUR, BENGKULU",2,64,63,127
https://kawalpemilu.org#21633,"TALANG TAIS, KELAM TENGAH, KAUR, BENGKULU",1,75,62,137
https://kawalpemilu.org#21633,"TALANG TAIS, KELAM TENGAH, KAUR, BENGKULU",2,118,70,188
https://kawalpemilu.org#21634,"PAGAR DEWA, KELAM TENGAH, KAUR, BENGKULU",1,117,80,197
https://kawalpemilu.org#21634,"PAGAR DEWA, KELAM TENGAH, KAUR, BENGKULU",2,136,87,223
https://kawalpemilu.org#21635,"TALANG MARAP, KELAM TENGAH, KAUR, BENGKULU",1,94,84,178
https://kawalpemilu.org#21635,"TALANG MARAP, KELAM TENGAH, KAUR, BENGKULU",2,96,110,206
https://kawalpemilu.org#21636,"SUKA RAMI II, KELAM TENGAH, KAUR, BENGKULU",1,54,72,126
https://kawalpemilu.org#21638,"BANGUN JIWA, LUAS, KAUR, BENGKULU",1,35,109,144
https://kawalpemilu.org#21638,"BANGUN JIWA, LUAS, KAUR, BENGKULU",2,51,79,130
https://kawalpemilu.org#21639,"CAHAYA NEGERI, LUAS, KAUR, BENGKULU",1,55,154,209
https://kawalpemilu.org#21639,"CAHAYA NEGERI, LUAS, KAUR, BENGKULU",2,58,141,199
https://kawalpemilu.org#21640,"PADANG JATI, LUAS, KAUR, BENGKULU",1,72,146,218
https://kawalpemilu.org#21641,"DURIAN BESAR, LUAS, KAUR, BENGKULU",1,41,170,211
https://kawalpemilu.org#21642,"TANJUNG BERINGIN, LUAS, KAUR, BENGKULU",1,40,112,152
https://kawalpemilu.org#21642,"TANJUNG BERINGIN, LUAS, KAUR, BENGKULU",2,35,96,131
https://kawalpemilu.org#21643,"UMBUL, LUAS, KAUR, BENGKULU",1,46,111,157
https://kawalpemilu.org#21643,"UMBUL, LUAS, KAUR, BENGKULU",2,56,61,117
https://kawalpemilu.org#21644,"BENUA RATU, LUAS, KAUR, BENGKULU",1,59,142,201
https://kawalpemilu.org#21644,"BENUA RATU, LUAS, KAUR, BENGKULU",2,49,123,172
https://kawalpemilu.org#21645,"TUGUK, LUAS, KAUR, BENGKULU",1,53,110,163
https://kawalpemilu.org#21646,"KEPAHYANG, LUAS, KAUR, BENGKULU",1,40,133,173
https://kawalpemilu.org#21646,"KEPAHYANG, LUAS, KAUR, BENGKULU",2,53,105,158
https://kawalpemilu.org#21647,"PULAU PANGGUNG, LUAS, KAUR, BENGKULU",1,68,161,229
https://kawalpemilu.org#21647,"PULAU PANGGUNG, LUAS, KAUR, BENGKULU",2,42,186,228
https://kawalpemilu.org#21648,"GANDA SULI, LUAS, KAUR, BENGKULU",1,22,99,121
https://kawalpemilu.org#21648,"GANDA SULI, LUAS, KAUR, BENGKULU",2,32,83,115
https://kawalpemilu.org#927554,"SERDANG INDAH, LUAS, KAUR, BENGKULU",1,91,55,146
https://kawalpemilu.org#927554,"SERDANG INDAH, LUAS, KAUR, BENGKULU",2,65,39,104
https://kawalpemilu.org#21650,"MUARA SAHUNG, MUARA SAHUNG, KAUR, BENGKULU",1,83,147,230
https://kawalpemilu.org#21650,"MUARA SAHUNG, MUARA SAHUNG, KAUR, BENGKULU",2,100,141,241
https://kawalpemilu.org#21650,"MUARA SAHUNG, MUARA SAHUNG, KAUR, BENGKULU",3,28,74,102
https://kawalpemilu.org#21651,"TRI TUNGGAL BAKTI, MUARA SAHUNG, KAUR, BENGKULU",1,102,32,134
https://kawalpemilu.org#21651,"TRI TUNGGAL BAKTI, MUARA SAHUNG, KAUR, BENGKULU",2,161,58,219
https://kawalpemilu.org#21652,"ULAK LEBAR, MUARA SAHUNG, KAUR, BENGKULU",1,98,119,217
https://kawalpemilu.org#21652,"ULAK LEBAR, MUARA SAHUNG, KAUR, BENGKULU",2,105,101,206
https://kawalpemilu.org#21652,"ULAK LEBAR, MUARA SAHUNG, KAUR, BENGKULU",3,90,52,142
https://kawalpemilu.org#21652,"ULAK LEBAR, MUARA SAHUNG, KAUR, BENGKULU",4,139,47,186
https://kawalpemilu.org#21653,"SUMBER MAKMUR, MUARA SAHUNG, KAUR, BENGKULU",1,141,57,198
https://kawalpemilu.org#21654,"ULAK BANDUNG, MUARA SAHUNG, KAUR, BENGKULU",1,55,96,151
https://kawalpemilu.org#21654,"ULAK BANDUNG, MUARA SAHUNG, KAUR, BENGKULU",2,110,138,248
https://kawalpemilu.org#21654,"ULAK BANDUNG, MUARA SAHUNG, KAUR, BENGKULU",3,85,135,220
https://kawalpemilu.org#21654,"ULAK BANDUNG, MUARA SAHUNG, KAUR, BENGKULU",4,71,117,188
https://kawalpemilu.org#21654,"ULAK BANDUNG, MUARA SAHUNG, KAUR, BENGKULU",5,40,64,107
https://kawalpemilu.org#21654,"ULAK BANDUNG, MUARA SAHUNG, KAUR, BENGKULU",6,88,38,126
https://kawalpemilu.org#21654,"ULAK BANDUNG, MUARA SAHUNG, KAUR, BENGKULU",7,98,12,110
https://kawalpemilu.org#21654,"ULAK BANDUNG, MUARA SAHUNG, KAUR, BENGKULU",8,76,15,91
https://kawalpemilu.org#21655,"CINTA MAKMUR, MUARA SAHUNG, KAUR, BENGKULU",1,53,45,98
https://kawalpemilu.org#21655,"CINTA MAKMUR, MUARA SAHUNG, KAUR, BENGKULU",2,50,36,86
https://kawalpemilu.org#21656,"BUKIT MAKMUR, MUARA SAHUNG, KAUR, BENGKULU",1,190,43,233
https://kawalpemilu.org#21656,"BUKIT MAKMUR, MUARA SAHUNG, KAUR, BENGKULU",2,96,69,165
https://kawalpemilu.org#21656,"BUKIT MAKMUR, MUARA SAHUNG, KAUR, BENGKULU",3,137,60,197
https://kawalpemilu.org#21656,"BUKIT MAKMUR, MUARA SAHUNG, KAUR, BENGKULU",4,49,14,63
https://kawalpemilu.org#21656,"BUKIT MAKMUR, MUARA SAHUNG, KAUR, BENGKULU",5,82,25,107
https://kawalpemilu.org#21658,"SUKA BANJAR, TETAP, KAUR, BENGKULU",1,81,121,202
https://kawalpemilu.org#21658,"SUKA BANJAR, TETAP, KAUR, BENGKULU",2,59,98,157
https://kawalpemilu.org#21659,"TANJUNG BUNGA, TETAP, KAUR, BENGKULU",1,70,91,161
https://kawalpemilu.org#21659,"TANJUNG BUNGA, TETAP, KAUR, BENGKULU",2,72,88,160
https://kawalpemilu.org#21660,"CUCUPAN, TETAP, KAUR, BENGKULU",1,57,158,215
https://kawalpemilu.org#21661,"PAGAR DEWA, TETAP, KAUR, BENGKULU",1,30,131,161
https://kawalpemilu.org#21662,"TANJUNG AGUNG, TETAP, KAUR, BENGKULU",1,66,135,201
https://kawalpemilu.org#21662,"TANJUNG AGUNG, TETAP, KAUR, BENGKULU",2,50,111,161
https://kawalpemilu.org#21662,"TANJUNG AGUNG, TETAP, KAUR, BENGKULU",3,101,46,147
https://kawalpemilu.org#21662,"TANJUNG AGUNG, TETAP, KAUR, BENGKULU",4,129,43,172
https://kawalpemilu.org#21663,"BABAT, TETAP, KAUR, BENGKULU",1,52,150,202
https://kawalpemilu.org#21663,"BABAT, TETAP, KAUR, BENGKULU",2,47,150,197
https://kawalpemilu.org#21664,"KEPAHYANG, TETAP, KAUR, BENGKULU",1,121,124,245
https://kawalpemilu.org#21665,"TANJUNG DALAM, TETAP, KAUR, BENGKULU",1,81,171,252
https://kawalpemilu.org#21666,"MUARA TETAP, TETAP, KAUR, BENGKULU",1,64,152,216
https://kawalpemilu.org#21666,"MUARA TETAP, TETAP, KAUR, BENGKULU",2,67,103,170
https://kawalpemilu.org#21667,"KASUK BARU, TETAP, KAUR, BENGKULU",1,84,127,211
https://kawalpemilu.org#21667,"KASUK BARU, TETAP, KAUR, BENGKULU",2,104,124,228
https://kawalpemilu.org#21668,"PADANG BINJAI, TETAP, KAUR, BENGKULU",1,77,147,224
https://kawalpemilu.org#21668,"PADANG BINJAI, TETAP, KAUR, BENGKULU",2,59,152,211
https://kawalpemilu.org#21669,"SUKARAJA, TETAP, KAUR, BENGKULU",1,77,147,224
https://kawalpemilu.org#21669,"SUKARAJA, TETAP, KAUR, BENGKULU",2,81,167,248
https://kawalpemilu.org#21671,"DATAR LEBAR, LUNGKANG KULE, KAUR, BENGKULU",1,84,65,149
https://kawalpemilu.org#21671,"DATAR LEBAR, LUNGKANG KULE, KAUR, BENGKULU",2,100,45,145
https://kawalpemilu.org#21672,"TANJUNG BUNIAN, LUNGKANG KULE, KAUR, BENGKULU",1,56,120,176
https://kawalpemilu.org#21672,"TANJUNG BUNIAN, LUNGKANG KULE, KAUR, BENGKULU",2,41,77,118
https://kawalpemilu.org#21673,"SINAR BULAN, LUNGKANG KULE, KAUR, BENGKULU",1,43,59,102
https://kawalpemilu.org#21673,"SINAR BULAN, LUNGKANG KULE, KAUR, BENGKULU",2,64,44,108
https://kawalpemilu.org#21674,"SUKANANTI, LUNGKANG KULE, KAUR, BENGKULU",1,94,58,152
https://kawalpemilu.org#21675,"LAWANG AGUNG, LUNGKANG KULE, KAUR, BENGKULU",1,91,52,143
https://kawalpemilu.org#21675,"LAWANG AGUNG, LUNGKANG KULE, KAUR, BENGKULU",2,88,63,151
https://kawalpemilu.org#21676,"TANJUNG KURUNG, LUNGKANG KULE, KAUR, BENGKULU",1,54,52,106
https://kawalpemilu.org#21676,"TANJUNG KURUNG, LUNGKANG KULE, KAUR, BENGKULU",2,74,63,137
https://kawalpemilu.org#21676,"TANJUNG KURUNG, LUNGKANG KULE, KAUR, BENGKULU",3,49,42,91
https://kawalpemilu.org#21677,"SENAK, LUNGKANG KULE, KAUR, BENGKULU",1,67,96,163
https://kawalpemilu.org#21678,"DATAR LEBAR II, LUNGKANG KULE, KAUR, BENGKULU",1,136,70,206
https://kawalpemilu.org#21679,"AUR GADING, LUNGKANG KULE, KAUR, BENGKULU",1,127,43,170
https://kawalpemilu.org#21681,"PULAU PANGGUNG, PADANG GUCI HILIR, KAUR, BENGKULU",1,67,60,127
https://kawalpemilu.org#21681,"PULAU PANGGUNG, PADANG GUCI HILIR, KAUR, BENGKULU",2,61,43,104
https://kawalpemilu.org#21682,"TALANG BESAR, PADANG GUCI HILIR, KAUR, BENGKULU",1,105,48,153
https://kawalpemilu.org#21682,"TALANG BESAR, PADANG GUCI HILIR, KAUR, BENGKULU",2,76,62,138
https://kawalpemilu.org#21683,"TALANG JAWI I, PADANG GUCI HILIR, KAUR, BENGKULU",1,77,64,141
https://kawalpemilu.org#21683,"TALANG JAWI I, PADANG GUCI HILIR, KAUR, BENGKULU",2,70,45,115
https://kawalpemilu.org#21684,"TALANG JAWI II, PADANG GUCI HILIR, KAUR, BENGKULU",1,55,71,126
https://kawalpemilu.org#21684,"TALANG JAWI II, PADANG GUCI HILIR, KAUR, BENGKULU",2,60,54,114
https://kawalpemilu.org#21685,"AIR KERING, PADANG GUCI HILIR, KAUR, BENGKULU",1,49,73,122
https://kawalpemilu.org#21685,"AIR KERING, PADANG GUCI HILIR, KAUR, BENGKULU",2,42,69,111
https://kawalpemilu.org#21686,"GUNUNG KAYA, PADANG GUCI HILIR, KAUR, BENGKULU",1,56,69,125
https://kawalpemilu.org#21686,"GUNUNG KAYA, PADANG GUCI HILIR, KAUR, BENGKULU",2,106,121,233
https://kawalpemilu.org#21687,"ULAK AGUNG, PADANG GUCI HILIR, KAUR, BENGKULU",1,89,61,150
https://kawalpemilu.org#21687,"ULAK AGUNG, PADANG GUCI HILIR, KAUR, BENGKULU",2,101,80,181
https://kawalpemilu.org#21688,"TALANG PADANG, PADANG GUCI HILIR, KAUR, BENGKULU",1,72,70,142
https://kawalpemilu.org#21688,"TALANG PADANG, PADANG GUCI HILIR, KAUR, BENGKULU",2,95,99,194
https://kawalpemilu.org#21689,"AIR KERING II, PADANG GUCI HILIR, KAUR, BENGKULU",1,55,132,187
https://kawalpemilu.org#21691,"NAGARANTAI, PADANG GUCI HULU, KAUR, BENGKULU",1,134,109,243
https://kawalpemilu.org#21691,"NAGARANTAI, PADANG GUCI HULU, KAUR, BENGKULU",2,155,82,237
https://kawalpemilu.org#21692,"BUNGIN TAMBUN I, PADANG GUCI HULU, KAUR, BENGKULU",1,128,82,210
https://kawalpemilu.org#21692,"BUNGIN TAMBUN I, PADANG GUCI HULU, KAUR, BENGKULU",2,100,115,215
https://kawalpemilu.org#21692,"BUNGIN TAMBUN I, PADANG GUCI HULU, KAUR, BENGKULU",3,106,87,193
https://kawalpemilu.org#21693,"BUNGIN TAMBUN II, PADANG GUCI HULU, KAUR, BENGKULU",1,164,63,227
https://kawalpemilu.org#21693,"BUNGIN TAMBUN II, PADANG GUCI HULU, KAUR, BENGKULU",2,90,116,206
https://kawalpemilu.org#21693,"BUNGIN TAMBUN II, PADANG GUCI HULU, KAUR, BENGKULU",3,89,84,173
https://kawalpemilu.org#21694,"BUNGIN TAMBUN III, PADANG GUCI HULU, KAUR, BENGKULU",1,94,87,181
https://kawalpemilu.org#21694,"BUNGIN TAMBUN III, PADANG GUCI HULU, KAUR, BENGKULU",2,111,74,185
https://kawalpemilu.org#21695,"MANAU IX I, PADANG GUCI HULU, KAUR, BENGKULU",1,64,99,163
https://kawalpemilu.org#21695,"MANAU IX I, PADANG GUCI HULU, KAUR, BENGKULU",2,102,73,175
https://kawalpemilu.org#21695,"MANAU IX I, PADANG GUCI HULU, KAUR, BENGKULU",3,110,73,183
https://kawalpemilu.org#21696,"MANAU IX 2, PADANG GUCI HULU, KAUR, BENGKULU",1,82,92,174
https://kawalpemilu.org#21696,"MANAU IX 2, PADANG GUCI HULU, KAUR, BENGKULU",2,115,56,171
https://kawalpemilu.org#21696,"MANAU IX 2, PADANG GUCI HULU, KAUR, BENGKULU",3,99,56,155
https://kawalpemilu.org#21696,"MANAU IX 2, PADANG GUCI HULU, KAUR, BENGKULU",4,69,59,128
https://kawalpemilu.org#21697,"PAGAR ALAM, PADANG GUCI HULU, KAUR, BENGKULU",1,68,96,164
https://kawalpemilu.org#21697,"PAGAR ALAM, PADANG GUCI HULU, KAUR, BENGKULU",2,58,123,181
https://kawalpemilu.org#21697,"PAGAR ALAM, PADANG GUCI HULU, KAUR, BENGKULU",3,75,75,150
https://kawalpemilu.org#21698,"PAGAR GUNUNG, PADANG GUCI HULU, KAUR, BENGKULU",1,91,83,174
https://kawalpemilu.org#21698,"PAGAR GUNUNG, PADANG GUCI HULU, KAUR, BENGKULU",2,120,76,196
https://kawalpemilu.org#21698,"PAGAR GUNUNG, PADANG GUCI HULU, KAUR, BENGKULU",3,90,61,151
https://kawalpemilu.org#21699,"CUKUH BETUNG, PADANG GUCI HULU, KAUR, BENGKULU",1,101,76,177
https://kawalpemilu.org#21699,"CUKUH BETUNG, PADANG GUCI HULU, KAUR, BENGKULU",2,55,80,135
https://kawalpemilu.org#21701,"JATI MULYO, PADANG GUCI HULU, KAUR, BENGKULU",1,131,35,166
https://kawalpemilu.org#927555,"MARGO MULYO, PADANG GUCI HULU, KAUR, BENGKULU",1,92,8,100
https://kawalpemilu.org#21704,"SUKARAJA, SUKARAJA, SELUMA, BENGKULU",1,90,158,248
https://kawalpemilu.org#21704,"SUKARAJA, SUKARAJA, SELUMA, BENGKULU",2,117,102,219
https://kawalpemilu.org#21704,"SUKARAJA, SUKARAJA, SELUMA, BENGKULU",3,94,135,229
https://kawalpemilu.org#21704,"SUKARAJA, SUKARAJA, SELUMA, BENGKULU",4,104,65,169
https://kawalpemilu.org#21704,"SUKARAJA, SUKARAJA, SELUMA, BENGKULU",5,91,70,161
https://kawalpemilu.org#21704,"SUKARAJA, SUKARAJA, SELUMA, BENGKULU",6,119,49,168
https://kawalpemilu.org#21705,"BABATAN, SUKARAJA, SELUMA, BENGKULU",1,80,113,193
https://kawalpemilu.org#21705,"BABATAN, SUKARAJA, SELUMA, BENGKULU",2,118,80,198
https://kawalpemilu.org#21705,"BABATAN, SUKARAJA, SELUMA, BENGKULU",3,76,43,119
https://kawalpemilu.org#21705,"BABATAN, SUKARAJA, SELUMA, BENGKULU",4,47,130,177
https://kawalpemilu.org#21705,"BABATAN, SUKARAJA, SELUMA, BENGKULU",5,119,20,139
https://kawalpemilu.org#21705,"BABATAN, SUKARAJA, SELUMA, BENGKULU",6,64,127,191
https://kawalpemilu.org#21705,"BABATAN, SUKARAJA, SELUMA, BENGKULU",7,135,116,251
https://kawalpemilu.org#21705,"BABATAN, SUKARAJA, SELUMA, BENGKULU",8,86,11,97
https://kawalpemilu.org#21706,"NIUR, SUKARAJA, SELUMA, BENGKULU",1,63,49,112
https://kawalpemilu.org#21706,"NIUR, SUKARAJA, SELUMA, BENGKULU",2,99,106,205
https://kawalpemilu.org#21706,"NIUR, SUKARAJA, SELUMA, BENGKULU",3,109,105,214
https://kawalpemilu.org#21706,"NIUR, SUKARAJA, SELUMA, BENGKULU",4,62,108,170
https://kawalpemilu.org#21706,"NIUR, SUKARAJA, SELUMA, BENGKULU",5,81,71,152
https://kawalpemilu.org#21707,"LUBUK SAHUNG, SUKARAJA, SELUMA, BENGKULU",1,153,105,258
https://kawalpemilu.org#21707,"LUBUK SAHUNG, SUKARAJA, SELUMA, BENGKULU",2,101,90,191
https://kawalpemilu.org#21707,"LUBUK SAHUNG, SUKARAJA, SELUMA, BENGKULU",3,113,117,230
https://kawalpemilu.org#21708,"BUKIT PENINJAUAN I, SUKARAJA, SELUMA, BENGKULU",1,163,38,201
https://kawalpemilu.org#21708,"BUKIT PENINJAUAN I, SUKARAJA, SELUMA, BENGKULU",2,152,48,200
https://kawalpemilu.org#21708,"BUKIT PENINJAUAN I, SUKARAJA, SELUMA, BENGKULU",3,193,32,225
https://kawalpemilu.org#21708,"BUKIT PENINJAUAN I, SUKARAJA, SELUMA, BENGKULU",4,179,31,210
https://kawalpemilu.org#21708,"BUKIT PENINJAUAN I, SUKARAJA, SELUMA, BENGKULU",5,193,18,211
https://kawalpemilu.org#21708,"BUKIT PENINJAUAN I, SUKARAJA, SELUMA, BENGKULU",6,151,58,209
https://kawalpemilu.org#21709,"PADANG PELAWI, SUKARAJA, SELUMA, BENGKULU",1,141,144,285
https://kawalpemilu.org#21709,"PADANG PELAWI, SUKARAJA, SELUMA, BENGKULU",2,55,67,122
https://kawalpemilu.org#21709,"PADANG PELAWI, SUKARAJA, SELUMA, BENGKULU",3,103,100,203
https://kawalpemilu.org#21709,"PADANG PELAWI, SUKARAJA, SELUMA, BENGKULU",4,35,184,219
https://kawalpemilu.org#21709,"PADANG PELAWI, SUKARAJA, SELUMA, BENGKULU",5,46,182,228
https://kawalpemilu.org#21709,"PADANG PELAWI, SUKARAJA, SELUMA, BENGKULU",6,37,149,186
https://kawalpemilu.org#21710,"KAYU ARANG, SUKARAJA, SELUMA, BENGKULU",1,34,43,77
https://kawalpemilu.org#21710,"KAYU ARANG, SUKARAJA, SELUMA, BENGKULU",2,43,46,89
https://kawalpemilu.org#21710,"KAYU ARANG, SUKARAJA, SELUMA, BENGKULU",3,100,119,219
https://kawalpemilu.org#21710,"KAYU ARANG, SUKARAJA, SELUMA, BENGKULU",4,110,109,219
https://kawalpemilu.org#21711,"JENGGALU, SUKARAJA, SELUMA, BENGKULU",1,119,156,275
https://kawalpemilu.org#21711,"JENGGALU, SUKARAJA, SELUMA, BENGKULU",2,89,75,164
https://kawalpemilu.org#21711,"JENGGALU, SUKARAJA, SELUMA, BENGKULU",3,199,17,216
https://kawalpemilu.org#21711,"JENGGALU, SUKARAJA, SELUMA, BENGKULU",4,66,57,123
https://kawalpemilu.org#21712,"CAHAYA NEGERI, SUKARAJA, SELUMA, BENGKULU",1,109,143,252
https://kawalpemilu.org#21712,"CAHAYA NEGERI, SUKARAJA, SELUMA, BENGKULU",2,136,123,259
https://kawalpemilu.org#21712,"CAHAYA NEGERI, SUKARAJA, SELUMA, BENGKULU",3,119,100,219
https://kawalpemilu.org#21712,"CAHAYA NEGERI, SUKARAJA, SELUMA, BENGKULU",4,74,96,170
https://kawalpemilu.org#21712,"CAHAYA NEGERI, SUKARAJA, SELUMA, BENGKULU",5,118,147,265
https://kawalpemilu.org#21712,"CAHAYA NEGERI, SUKARAJA, SELUMA, BENGKULU",6,131,104,235
https://kawalpemilu.org#21712,"CAHAYA NEGERI, SUKARAJA, SELUMA, BENGKULU",7,128,99,227
https://kawalpemilu.org#21713,"BUKIT PENINJAUAN II, SUKARAJA, SELUMA, BENGKULU",1,190,33,223
https://kawalpemilu.org#21713,"BUKIT PENINJAUAN II, SUKARAJA, SELUMA, BENGKULU",2,178,49,227
https://kawalpemilu.org#21713,"BUKIT PENINJAUAN II, SUKARAJA, SELUMA, BENGKULU",3,195,37,232
https://kawalpemilu.org#21713,"BUKIT PENINJAUAN II, SUKARAJA, SELUMA, BENGKULU",4,89,85,174
https://kawalpemilu.org#21713,"BUKIT PENINJAUAN II, SUKARAJA, SELUMA, BENGKULU",5,73,65,138
https://kawalpemilu.org#21713,"BUKIT PENINJAUAN II, SUKARAJA, SELUMA, BENGKULU",6,74,71,145
https://kawalpemilu.org#21714,"RIAK SIABUN, SUKARAJA, SELUMA, BENGKULU",1,177,56,233
https://kawalpemilu.org#21714,"RIAK SIABUN, SUKARAJA, SELUMA, BENGKULU",2,183,52,235
https://kawalpemilu.org#21714,"RIAK SIABUN, SUKARAJA, SELUMA, BENGKULU",3,227,36,263
https://kawalpemilu.org#21714,"RIAK SIABUN, SUKARAJA, SELUMA, BENGKULU",4,191,16,207
https://kawalpemilu.org#21714,"RIAK SIABUN, SUKARAJA, SELUMA, BENGKULU",5,175,80,255
https://kawalpemilu.org#21714,"RIAK SIABUN, SUKARAJA, SELUMA, BENGKULU",6,242,25,267
https://kawalpemilu.org#21715,"PADANG KUAS, SUKARAJA, SELUMA, BENGKULU",1,122,52,174
https://kawalpemilu.org#21715,"PADANG KUAS, SUKARAJA, SELUMA, BENGKULU",2,137,61,198
https://kawalpemilu.org#21715,"PADANG KUAS, SUKARAJA, SELUMA, BENGKULU",3,80,90,170
https://kawalpemilu.org#21716,"KUTI AGUNG, SUKARAJA, SELUMA, BENGKULU",1,57,26,83
https://kawalpemilu.org#21716,"KUTI AGUNG, SUKARAJA, SELUMA, BENGKULU",2,94,64,158
https://kawalpemilu.org#21716,"KUTI AGUNG, SUKARAJA, SELUMA, BENGKULU",3,55,55,110
https://kawalpemilu.org#21716,"KUTI AGUNG, SUKARAJA, SELUMA, BENGKULU",4,63,37,100
https://kawalpemilu.org#21717,"RIAK SIABUN I, SUKARAJA, SELUMA, BENGKULU",1,136,50,186
https://kawalpemilu.org#21717,"RIAK SIABUN I, SUKARAJA, SELUMA, BENGKULU",2,165,44,209
https://kawalpemilu.org#21717,"RIAK SIABUN I, SUKARAJA, SELUMA, BENGKULU",3,204,22,226
https://kawalpemilu.org#21718,"SIDO LUHUR, SUKARAJA, SELUMA, BENGKULU",1,131,52,183
https://kawalpemilu.org#21718,"SIDO LUHUR, SUKARAJA, SELUMA, BENGKULU",2,224,34,258
https://kawalpemilu.org#21718,"SIDO LUHUR, SUKARAJA, SELUMA, BENGKULU",3,187,44,231
https://kawalpemilu.org#21718,"SIDO LUHUR, SUKARAJA, SELUMA, BENGKULU",4,154,43,197
https://kawalpemilu.org#21718,"SIDO LUHUR, SUKARAJA, SELUMA, BENGKULU",5,218,35,253
https://kawalpemilu.org#21718,"SIDO LUHUR, SUKARAJA, SELUMA, BENGKULU",6,104,34,138
https://kawalpemilu.org#21719,"SUMBER ARUM, SUKARAJA, SELUMA, BENGKULU",1,198,38,236
https://kawalpemilu.org#21719,"SUMBER ARUM, SUKARAJA, SELUMA, BENGKULU",2,182,47,229
https://kawalpemilu.org#21719,"SUMBER ARUM, SUKARAJA, SELUMA, BENGKULU",3,206,39,245
https://kawalpemilu.org#21720,"SIDO SARI, SUKARAJA, SELUMA, BENGKULU",1,146,59,205
https://kawalpemilu.org#21720,"SIDO SARI, SUKARAJA, SELUMA, BENGKULU",2,125,94,219
https://kawalpemilu.org#21720,"SIDO SARI, SUKARAJA, SELUMA, BENGKULU",3,124,75,199
https://kawalpemilu.org#21720,"SIDO SARI, SUKARAJA, SELUMA, BENGKULU",4,140,69,209
https://kawalpemilu.org#21720,"SIDO SARI, SUKARAJA, SELUMA, BENGKULU",5,132,42,174
https://kawalpemilu.org#21721,"SARI MULYO, SUKARAJA, SELUMA, BENGKULU",1,121,51,172
https://kawalpemilu.org#21721,"SARI MULYO, SUKARAJA, SELUMA, BENGKULU",2,132,52,184
https://kawalpemilu.org#21721,"SARI MULYO, SUKARAJA, SELUMA, BENGKULU",3,137,77,214
https://kawalpemilu.org#21721,"SARI MULYO, SUKARAJA, SELUMA, BENGKULU",4,169,63,232
https://kawalpemilu.org#21721,"SARI MULYO, SUKARAJA, SELUMA, BENGKULU",5,231,27,258
https://kawalpemilu.org#21721,"SARI MULYO, SUKARAJA, SELUMA, BENGKULU",6,103,6,109
https://kawalpemilu.org#87965,"AIR KEMUNING, SUKARAJA, SELUMA, BENGKULU",1,135,74,209
https://kawalpemilu.org#87965,"AIR KEMUNING, SUKARAJA, SELUMA, BENGKULU",2,99,112,211
https://kawalpemilu.org#87965,"AIR KEMUNING, SUKARAJA, SELUMA, BENGKULU",3,78,84,162
https://kawalpemilu.org#87967,"SUMBER MAKMUR, SUKARAJA, SELUMA, BENGKULU",1,87,16,103
https://kawalpemilu.org#87967,"SUMBER MAKMUR, SUKARAJA, SELUMA, BENGKULU",2,67,9,76
https://kawalpemilu.org#87968,"AIR PETAI, SUKARAJA, SELUMA, BENGKULU",1,128,20,148
https://kawalpemilu.org#87968,"AIR PETAI, SUKARAJA, SELUMA, BENGKULU",2,138,20,158
https://kawalpemilu.org#87968,"AIR PETAI, SUKARAJA, SELUMA, BENGKULU",3,118,55,173
https://kawalpemilu.org#21723,"PASAR TAIS, SELUMA, SELUMA, BENGKULU",1,56,178,234
https://kawalpemilu.org#21723,"PASAR TAIS, SELUMA, SELUMA, BENGKULU",2,32,76,108
https://kawalpemilu.org#21723,"PASAR TAIS, SELUMA, SELUMA, BENGKULU",3,35,97,132
https://kawalpemilu.org#21723,"PASAR TAIS, SELUMA, SELUMA, BENGKULU",4,75,133,208
https://kawalpemilu.org#21723,"PASAR TAIS, SELUMA, SELUMA, BENGKULU",5,34,83,117
https://kawalpemilu.org#21723,"PASAR TAIS, SELUMA, SELUMA, BENGKULU",6,60,91,151
https://kawalpemilu.org#21723,"PASAR TAIS, SELUMA, SELUMA, BENGKULU",7,90,135,225
https://kawalpemilu.org#21723,"PASAR TAIS, SELUMA, SELUMA, BENGKULU",8,64,121,185
https://kawalpemilu.org#21724,"LUBUK KEBUR, SELUMA, SELUMA, BENGKULU",1,86,131,217
https://kawalpemilu.org#21724,"LUBUK KEBUR, SELUMA, SELUMA, BENGKULU",2,51,128,179
https://kawalpemilu.org#21724,"LUBUK KEBUR, SELUMA, SELUMA, BENGKULU",3,57,115,172
https://kawalpemilu.org#21725,"LUBUK LINTANG, SELUMA, SELUMA, BENGKULU",1,71,130,201
https://kawalpemilu.org#21725,"LUBUK LINTANG, SELUMA, SELUMA, BENGKULU",2,62,132,194
https://kawalpemilu.org#21725,"LUBUK LINTANG, SELUMA, SELUMA, BENGKULU",3,78,123,201
https://kawalpemilu.org#21725,"LUBUK LINTANG, SELUMA, SELUMA, BENGKULU",4,51,195,246
https://kawalpemilu.org#21726,"TALANG SALING, SELUMA, SELUMA, BENGKULU",1,68,115,183
https://kawalpemilu.org#21726,"TALANG SALING, SELUMA, SELUMA, BENGKULU",2,52,156,208
https://kawalpemilu.org#21726,"TALANG SALING, SELUMA, SELUMA, BENGKULU",3,85,109,194
https://kawalpemilu.org#21727,"DUSUN BARU, SELUMA, SELUMA, BENGKULU",1,73,146,219
https://kawalpemilu.org#21727,"DUSUN BARU, SELUMA, SELUMA, BENGKULU",2,48,128,176
https://kawalpemilu.org#21727,"DUSUN BARU, SELUMA, SELUMA, BENGKULU",3,64,88,152
https://kawalpemilu.org#21727,"DUSUN BARU, SELUMA, SELUMA, BENGKULU",4,71,149,220
https://kawalpemilu.org#21728,"TALANG DANTUK, SELUMA, SELUMA, BENGKULU",1,90,130,220
https://kawalpemilu.org#21728,"TALANG DANTUK, SELUMA, SELUMA, BENGKULU",2,79,109,188
https://kawalpemilu.org#21728,"TALANG DANTUK, SELUMA, SELUMA, BENGKULU",3,104,113,217
https://kawalpemilu.org#21729,"NAPAL, SELUMA, SELUMA, BENGKULU",1,65,147,212
https://kawalpemilu.org#21729,"NAPAL, SELUMA, SELUMA, BENGKULU",2,99,99,198
https://kawalpemilu.org#21729,"NAPAL, SELUMA, SELUMA, BENGKULU",3,98,153,251
https://kawalpemilu.org#21729,"NAPAL, SELUMA, SELUMA, BENGKULU",4,99,90,189
https://kawalpemilu.org#21729,"NAPAL, SELUMA, SELUMA, BENGKULU",5,58,112,170
https://kawalpemilu.org#21731,"MASMAMBANG, TALO, SELUMA, BENGKULU",1,69,130,199
https://kawalpemilu.org#21731,"MASMAMBANG, TALO, SELUMA, BENGKULU",2,64,187,251
https://kawalpemilu.org#21731,"MASMAMBANG, TALO, SELUMA, BENGKULU",3,50,163,213
https://kawalpemilu.org#21731,"MASMAMBANG, TALO, SELUMA, BENGKULU",4,29,224,253
https://kawalpemilu.org#21732,"NAPAL MELINTANG, TALO, SELUMA, BENGKULU",1,43,97,140
https://kawalpemilu.org#21732,"NAPAL MELINTANG, TALO, SELUMA, BENGKULU",2,31,91,122
https://kawalpemilu.org#21733,"SERAMBI GUNUNG, TALO, SELUMA, BENGKULU",1,52,123,175
https://kawalpemilu.org#21733,"SERAMBI GUNUNG, TALO, SELUMA, BENGKULU",2,53,155,208
https://kawalpemilu.org#21733,"SERAMBI GUNUNG, TALO, SELUMA, BENGKULU",3,49,163,212
https://kawalpemilu.org#21733,"SERAMBI GUNUNG, TALO, SELUMA, BENGKULU",4,57,138,195
https://kawalpemilu.org#21733,"SERAMBI GUNUNG, TALO, SELUMA, BENGKULU",5,67,138,205
https://kawalpemilu.org#21733,"SERAMBI GUNUNG, TALO, SELUMA, BENGKULU",6,56,130,186
https://kawalpemilu.org#21734,"AIR PAYANGAN, TALO, SELUMA, BENGKULU",1,46,57,103
https://kawalpemilu.org#21734,"AIR PAYANGAN, TALO, SELUMA, BENGKULU",2,48,48,96
https://kawalpemilu.org#21735,"BATU TUGU, TALO, SELUMA, BENGKULU",1,82,84,166
https://kawalpemilu.org#21736,"KAMPAI, TALO, SELUMA, BENGKULU",1,75,122,197
https://kawalpemilu.org#21736,"KAMPAI, TALO, SELUMA, BENGKULU",2,114,110,224
https://kawalpemilu.org#21736,"KAMPAI, TALO, SELUMA, BENGKULU",3,54,132,186
https://kawalpemilu.org#21736,"KAMPAI, TALO, SELUMA, BENGKULU",4,80,81,161
https://kawalpemilu.org#21737,"LUBUK NGANTUNGAN, TALO, SELUMA, BENGKULU",1,73,124,197
https://kawalpemilu.org#21738,"DURIAN BUBUR, TALO, SELUMA, BENGKULU",1,36,99,135
https://kawalpemilu.org#21738,"DURIAN BUBUR, TALO, SELUMA, BENGKULU",2,56,112,168
https://kawalpemilu.org#21738,"DURIAN BUBUR, TALO, SELUMA, BENGKULU",3,33,98,131
https://kawalpemilu.org#21738,"DURIAN BUBUR, TALO, SELUMA, BENGKULU",4,26,92,118
https://kawalpemilu.org#21739,"MUARA DANAU, TALO, SELUMA, BENGKULU",1,70,115,185
https://kawalpemilu.org#21740,"LUBUK GIO, TALO, SELUMA, BENGKULU",1,67,96,163
https://kawalpemilu.org#21740,"LUBUK GIO, TALO, SELUMA, BENGKULU",2,60,90,150
https://kawalpemilu.org#21741,"KEMBANG SERI, TALO, SELUMA, BENGKULU",1,68,109,177
https://kawalpemilu.org#21741,"KEMBANG SERI, TALO, SELUMA, BENGKULU",2,65,104,169
https://kawalpemilu.org#21742,"BUNUT TINGGI, TALO, SELUMA, BENGKULU",1,39,148,187
https://kawalpemilu.org#21742,"BUNUT TINGGI, TALO, SELUMA, BENGKULU",2,38,139,177
https://kawalpemilu.org#21742,"BUNUT TINGGI, TALO, SELUMA, BENGKULU",3,39,135,174
https://kawalpemilu.org#21742,"BUNUT TINGGI, TALO, SELUMA, BENGKULU",4,54,168,222
https://kawalpemilu.org#21743,"AIR TERAS, TALO, SELUMA, BENGKULU",1,85,138,223
https://kawalpemilu.org#21743,"AIR TERAS, TALO, SELUMA, BENGKULU",2,82,125,207
https://kawalpemilu.org#21744,"LUBUK GADIS, TALO, SELUMA, BENGKULU",1,65,54,119
https://kawalpemilu.org#21744,"LUBUK GADIS, TALO, SELUMA, BENGKULU",2,30,85,115
https://kawalpemilu.org#87969,"SIMPANG TIGA PAGAR GASING, TALO, SELUMA, BENGKULU",1,35,190,225
https://kawalpemilu.org#87969,"SIMPANG TIGA PAGAR GASING, TALO, SELUMA, BENGKULU",2,57,146,203
https://kawalpemilu.org#928238,"HARAPAN MULYA, TALO, SELUMA, BENGKULU",1,90,41,131
https://kawalpemilu.org#21746,"MARAS JAUH, SEMIDANG ALAS, SELUMA, BENGKULU",1,69,34,103
https://kawalpemilu.org#21746,"MARAS JAUH, SEMIDANG ALAS, SELUMA, BENGKULU",2,100,48,148
https://kawalpemilu.org#21746,"MARAS JAUH, SEMIDANG ALAS, SELUMA, BENGKULU",3,98,45,143
https://kawalpemilu.org#21747,"BANDUNG AGUNG, SEMIDANG ALAS, SELUMA, BENGKULU",1,95,75,170
https://kawalpemilu.org#21747,"BANDUNG AGUNG, SEMIDANG ALAS, SELUMA, BENGKULU",2,101,60,161
https://kawalpemilu.org#21748,"PINJU LAYANG, SEMIDANG ALAS, SELUMA, BENGKULU",1,86,100,186
https://kawalpemilu.org#21748,"PINJU LAYANG, SEMIDANG ALAS, SELUMA, BENGKULU",2,59,147,206
https://kawalpemilu.org#21748,"PINJU LAYANG, SEMIDANG ALAS, SELUMA, BENGKULU",3,75,119,194
https://kawalpemilu.org#21749,"NANJUNGAN, SEMIDANG ALAS, SELUMA, BENGKULU",1,141,44,185
https://kawalpemilu.org#21749,"NANJUNGAN, SEMIDANG ALAS, SELUMA, BENGKULU",2,113,65,178
https://kawalpemilu.org#21750,"PAJAR BULAN, SEMIDANG ALAS, SELUMA, BENGKULU",1,63,108,171
https://kawalpemilu.org#21750,"PAJAR BULAN, SEMIDANG ALAS, SELUMA, BENGKULU",2,85,106,191
https://kawalpemilu.org#21750,"PAJAR BULAN, SEMIDANG ALAS, SELUMA, BENGKULU",3,76,95,171
https://kawalpemilu.org#21750,"PAJAR BULAN, SEMIDANG ALAS, SELUMA, BENGKULU",4,55,98,153
https://kawalpemilu.org#21751,"PETAI KAYU, SEMIDANG ALAS, SELUMA, BENGKULU",1,72,85,157
https://kawalpemilu.org#21751,"PETAI KAYU, SEMIDANG ALAS, SELUMA, BENGKULU",2,80,71,151
https://kawalpemilu.org#21751,"PETAI KAYU, SEMIDANG ALAS, SELUMA, BENGKULU",3,59,82,141
https://kawalpemilu.org#21752,"NAPALAN, SEMIDANG ALAS, SELUMA, BENGKULU",1,82,29,111
https://kawalpemilu.org#21753,"RENAH GAJAH MATI I, SEMIDANG ALAS, SELUMA, BENGKULU",1,161,32,193
https://kawalpemilu.org#21753,"RENAH GAJAH MATI I, SEMIDANG ALAS, SELUMA, BENGKULU",2,110,12,122
https://kawalpemilu.org#21754,"RENAH GAJAH MATI II, SEMIDANG ALAS, SELUMA, BENGKULU",1,89,109,198
https://kawalpemilu.org#21754,"RENAH GAJAH MATI II, SEMIDANG ALAS, SELUMA, BENGKULU",2,141,61,202
https://kawalpemilu.org#21755,"CUGUNG LANGU, SEMIDANG ALAS, SELUMA, BENGKULU",1,70,159,229
https://kawalpemilu.org#21756,"RANTAU PANJANG, SEMIDANG ALAS, SELUMA, BENGKULU",1,23,124,147
https://kawalpemilu.org#21756,"RANTAU PANJANG, SEMIDANG ALAS, SELUMA, BENGKULU",2,49,114,163
https://kawalpemilu.org#21756,"RANTAU PANJANG, SEMIDANG ALAS, SELUMA, BENGKULU",3,50,107,157
https://kawalpemilu.org#21757,"AIR MELANCAR, SEMIDANG ALAS, SELUMA, BENGKULU",1,66,157,223
https://kawalpemilu.org#21758,"MUARA DUA, SEMIDANG ALAS, SELUMA, BENGKULU",1,118,44,162
https://kawalpemilu.org#21759,"NANTI AGUNG, SEMIDANG ALAS, SELUMA, BENGKULU",1,72,78,150
https://kawalpemilu.org#21759,"NANTI AGUNG, SEMIDANG ALAS, SELUMA, BENGKULU",2,96,49,145
https://kawalpemilu.org#21760,"TALANG DURIAN, SEMIDANG ALAS, SELUMA, BENGKULU",1,70,111,181
https://kawalpemilu.org#21760,"TALANG DURIAN, SEMIDANG ALAS, SELUMA, BENGKULU",2,74,117,191
https://kawalpemilu.org#21761,"GUNUNG MESIR, SEMIDANG ALAS, SELUMA, BENGKULU",1,94,82,176
https://kawalpemilu.org#21761,"GUNUNG MESIR, SEMIDANG ALAS, SELUMA, BENGKULU",2,80,75,155
https://kawalpemilu.org#21761,"GUNUNG MESIR, SEMIDANG ALAS, SELUMA, BENGKULU",3,69,96,165
https://kawalpemilu.org#21762,"KAYU ELANG, SEMIDANG ALAS, SELUMA, BENGKULU",1,177,48,225
https://kawalpemilu.org#21762,"KAYU ELANG, SEMIDANG ALAS, SELUMA, BENGKULU",2,141,49,190
https://kawalpemilu.org#21762,"KAYU ELANG, SEMIDANG ALAS, SELUMA, BENGKULU",3,171,38,209
https://kawalpemilu.org#21763,"PADANG SERUNAIAN, SEMIDANG ALAS, SELUMA, BENGKULU",1,57,95,152
https://kawalpemilu.org#21763,"PADANG SERUNAIAN, SEMIDANG ALAS, SELUMA, BENGKULU",2,53,98,151
https://kawalpemilu.org#21764,"TEBAT GUNUNG, SEMIDANG ALAS, SELUMA, BENGKULU",1,121,83,204
https://kawalpemilu.org#21764,"TEBAT GUNUNG, SEMIDANG ALAS, SELUMA, BENGKULU",2,158,68,226
https://kawalpemilu.org#21764,"TEBAT GUNUNG, SEMIDANG ALAS, SELUMA, BENGKULU",3,134,57,191
https://kawalpemilu.org#21764,"TEBAT GUNUNG, SEMIDANG ALAS, SELUMA, BENGKULU",4,144,59,203
https://kawalpemilu.org#21765,"MEKAR SARI MUKTI, SEMIDANG ALAS, SELUMA, BENGKULU",1,69,18,87
https://kawalpemilu.org#87970,"KEMANG MANIS, SEMIDANG ALAS, SELUMA, BENGKULU",1,90,31,121
https://kawalpemilu.org#87970,"KEMANG MANIS, SEMIDANG ALAS, SELUMA, BENGKULU",2,103,17,120
https://kawalpemilu.org#87971,"GUNUNG MEGANG, SEMIDANG ALAS, SELUMA, BENGKULU",1,86,36,122
https://kawalpemilu.org#87971,"GUNUNG MEGANG, SEMIDANG ALAS, SELUMA, BENGKULU",2,83,37,120
https://kawalpemilu.org#87972,"TELATAN, SEMIDANG ALAS, SELUMA, BENGKULU",1,130,70,200
https://kawalpemilu.org#87972,"TELATAN, SEMIDANG ALAS, SELUMA, BENGKULU",2,130,59,189
https://kawalpemilu.org#87972,"TELATAN, SEMIDANG ALAS, SELUMA, BENGKULU",3,120,58,178
https://kawalpemilu.org#87974,"SUBAN, SEMIDANG ALAS, SELUMA, BENGKULU",1,66,20,86
https://kawalpemilu.org#21767,"SENDAWAR, SEMIDANG ALAS MARAS, SELUMA, BENGKULU",1,57,159,216
https://kawalpemilu.org#21767,"SENDAWAR, SEMIDANG ALAS MARAS, SELUMA, BENGKULU",2,48,149,197
https://kawalpemilu.org#21767,"SENDAWAR, SEMIDANG ALAS MARAS, SELUMA, BENGKULU",3,65,119,184
https://kawalpemilu.org#21767,"SENDAWAR, SEMIDANG ALAS MARAS, SELUMA, BENGKULU",4,37,159,196
https://kawalpemilu.org#21768,"GELOMBANG, SEMIDANG ALAS MARAS, SELUMA, BENGKULU",1,66,137,203
https://kawalpemilu.org#21768,"GELOMBANG, SEMIDANG ALAS MARAS, SELUMA, BENGKULU",2,56,135,191
https://kawalpemilu.org#21768,"GELOMBANG, SEMIDANG ALAS MARAS, SELUMA, BENGKULU",3,85,130,215
https://kawalpemilu.org#21768,"GELOMBANG, SEMIDANG ALAS MARAS, SELUMA, BENGKULU",4,90,114,204
https://kawalpemilu.org#21769,"LUBUK BETUNG, SEMIDANG ALAS MARAS, SELUMA, BENGKULU",1,92,58,150
https://kawalpemilu.org#21769,"LUBUK BETUNG, SEMIDANG ALAS MARAS, SELUMA, BENGKULU",2,105,56,161
https://kawalpemilu.org#21769,"LUBUK BETUNG, SEMIDANG ALAS MARAS, SELUMA, BENGKULU",3,84,31,115
https://kawalpemilu.org#21770,"PADANG PERI, SEMIDANG ALAS MARAS, SELUMA, BENGKULU",1,152,47,199
https://kawalpemilu.org#21770,"PADANG PERI, SEMIDANG ALAS MARAS, SELUMA, BENGKULU",2,91,77,168
https://kawalpemilu.org#21770,"PADANG PERI, SEMIDANG ALAS MARAS, SELUMA, BENGKULU",3,125,67,192
https://kawalpemilu.org#21770,"PADANG PERI, SEMIDANG ALAS MARAS, SELUMA, BENGKULU",4,113,60,173
https://kawalpemilu.org#21770,"PADANG PERI, SEMIDANG ALAS MARAS, SELUMA, BENGKULU",5,42,111,153
https://kawalpemilu.org#21770,"PADANG PERI, SEMIDANG ALAS MARAS, SELUMA, BENGKULU",6,75,104,179
https://kawalpemilu.org#21771,"KEMBANG MUMPO, SEMIDANG ALAS MARAS, SELUMA, BENGKULU",1,99,74,173
https://kawalpemilu.org#21771,"KEMBANG MUMPO, SEMIDANG ALAS MARAS, SELUMA, BENGKULU",2,80,89,169
https://kawalpemilu.org#21771,"KEMBANG MUMPO, SEMIDANG ALAS MARAS, SELUMA, BENGKULU",3,115,84,199
https://kawalpemilu.org#21771,"KEMBANG MUMPO, SEMIDANG ALAS MARAS, SELUMA, BENGKULU",4,85,77,162
https://kawalpemilu.org#21772,"KARANG ANYAR, SEMIDANG ALAS MARAS, SELUMA, BENGKULU",1,91,72,163
https://kawalpemilu.org#21772,"KARANG ANYAR, SEMIDANG ALAS MARAS, SELUMA, BENGKULU",2,57,73,130
https://kawalpemilu.org#21772,"KARANG ANYAR, SEMIDANG ALAS MARAS, SELUMA, BENGKULU",3,33,47,80
https://kawalpemilu.org#21772,"KARANG ANYAR, SEMIDANG ALAS MARAS, SELUMA, BENGKULU",4,27,85,112
https://kawalpemilu.org#21773,"UJUNG PADANG, SEMIDANG ALAS MARAS, SELUMA, BENGKULU",1,62,141,203
https://kawalpemilu.org#21773,"UJUNG PADANG, SEMIDANG ALAS MARAS, SELUMA, BENGKULU",2,104,97,201
https://kawalpemilu.org#21773,"UJUNG PADANG, SEMIDANG ALAS MARAS, SELUMA, BENGKULU",3,94,94,188
https://kawalpemilu.org#21773,"UJUNG PADANG, SEMIDANG ALAS MARAS, SELUMA, BENGKULU",4,79,122,201
https://kawalpemilu.org#21773,"UJUNG PADANG, SEMIDANG ALAS MARAS, SELUMA, BENGKULU",5,97,92,189
https://kawalpemilu.org#21774,"KETAPANG BARU, SEMIDANG ALAS MARAS, SELUMA, BENGKULU",1,95,67,162
https://kawalpemilu.org#21774,"KETAPANG BARU, SEMIDANG ALAS MARAS, SELUMA, BENGKULU",2,93,79,172
https://kawalpemilu.org#21774,"KETAPANG BARU, SEMIDANG ALAS MARAS, SELUMA, BENGKULU",3,81,136,217
https://kawalpemilu.org#21774,"KETAPANG BARU, SEMIDANG ALAS MARAS, SELUMA, BENGKULU",4,68,140,208
https://kawalpemilu.org#21775,"TEDUNAN, SEMIDANG ALAS MARAS, SELUMA, BENGKULU",1,65,84,149
https://kawalpemilu.org#21775,"TEDUNAN, SEMIDANG ALAS MARAS, SELUMA, BENGKULU",2,50,106,156
https://kawalpemilu.org#21775,"TEDUNAN, SEMIDANG ALAS MARAS, SELUMA, BENGKULU",3,77,118,195
https://kawalpemilu.org#21776,"TALANG ALAI, SEMIDANG ALAS MARAS, SELUMA, BENGKULU",1,91,65,156
https://kawalpemilu.org#21776,"TALANG ALAI, SEMIDANG ALAS MARAS, SELUMA, BENGKULU",2,105,67,172
https://kawalpemilu.org#21776,"TALANG ALAI, SEMIDANG ALAS MARAS, SELUMA, BENGKULU",3,90,47,137
https://kawalpemilu.org#21776,"TALANG ALAI, SEMIDANG ALAS MARAS, SELUMA, BENGKULU",4,102,53,155
https://kawalpemilu.org#21777,"PADANG BAKUNG, SEMIDANG ALAS MARAS, SELUMA, BENGKULU",1,106,60,166
https://kawalpemilu.org#21777,"PADANG BAKUNG, SEMIDANG ALAS MARAS, SELUMA, BENGKULU",2,89,59,148
https://kawalpemilu.org#21778,"JAMBAT AKAR, SEMIDANG ALAS MARAS, SELUMA, BENGKULU",1,35,83,118
https://kawalpemilu.org#21778,"JAMBAT AKAR, SEMIDANG ALAS MARAS, SELUMA, BENGKULU",2,28,94,122
https://kawalpemilu.org#21778,"JAMBAT AKAR, SEMIDANG ALAS MARAS, SELUMA, BENGKULU",3,44,67,111
https://kawalpemilu.org#21778,"JAMBAT AKAR, SEMIDANG ALAS MARAS, SELUMA, BENGKULU",4,33,67,100
https://kawalpemilu.org#21779,"GUNUNG KEMBANG, SEMIDANG ALAS MARAS, SELUMA, BENGKULU",1,92,66,158
https://kawalpemilu.org#21779,"GUNUNG KEMBANG, SEMIDANG ALAS MARAS, SELUMA, BENGKULU",2,68,125,193
https://kawalpemilu.org#21779,"GUNUNG KEMBANG, SEMIDANG ALAS MARAS, SELUMA, BENGKULU",3,94,105,199
https://kawalpemilu.org#21780,"GUNUNG BANTAN, SEMIDANG ALAS MARAS, SELUMA, BENGKULU",1,71,82,153
https://kawalpemilu.org#21780,"GUNUNG BANTAN, SEMIDANG ALAS MARAS, SELUMA, BENGKULU",2,91,96,187
https://kawalpemilu.org#21780,"GUNUNG BANTAN, SEMIDANG ALAS MARAS, SELUMA, BENGKULU",3,84,97,181
https://kawalpemilu.org#21781,"MARAS TENGAH, SEMIDANG ALAS MARAS, SELUMA, BENGKULU",1,99,79,178
https://kawalpemilu.org#21781,"MARAS TENGAH, SEMIDANG ALAS MARAS, SELUMA, BENGKULU",2,159,55,214
https://kawalpemilu.org#21781,"MARAS TENGAH, SEMIDANG ALAS MARAS, SELUMA, BENGKULU",3,101,43,144
https://kawalpemilu.org#21781,"MARAS TENGAH, SEMIDANG ALAS MARAS, SELUMA, BENGKULU",4,143,22,165
https://kawalpemilu.org#21782,"PADANG KELAPO, SEMIDANG ALAS MARAS, SELUMA, BENGKULU",1,78,72,150
https://kawalpemilu.org#21782,"PADANG KELAPO, SEMIDANG ALAS MARAS, SELUMA, BENGKULU",2,53,92,145
https://kawalpemilu.org#21782,"PADANG KELAPO, SEMIDANG ALAS MARAS, SELUMA, BENGKULU",3,79,113,192
https://kawalpemilu.org#21782,"PADANG KELAPO, SEMIDANG ALAS MARAS, SELUMA, BENGKULU",4,79,76,155
https://kawalpemilu.org#21783,"PEMATANG RIDING, SEMIDANG ALAS MARAS, SELUMA, BENGKULU",1,131,43,176
https://kawalpemilu.org#21783,"PEMATANG RIDING, SEMIDANG ALAS MARAS, SELUMA, BENGKULU",2,70,110,180
https://kawalpemilu.org#21783,"PEMATANG RIDING, SEMIDANG ALAS MARAS, SELUMA, BENGKULU",3,57,141,198
https://kawalpemilu.org#21784,"TALANG BERINGIN, SEMIDANG ALAS MARAS, SELUMA, BENGKULU",1,95,115,210
https://kawalpemilu.org#21784,"TALANG BERINGIN, SEMIDANG ALAS MARAS, SELUMA, BENGKULU",2,63,124,187
https://kawalpemilu.org#21784,"TALANG BERINGIN, SEMIDANG ALAS MARAS, SELUMA, BENGKULU",3,68,62,130
https://kawalpemilu.org#21785,"GENTING JUAR, SEMIDANG ALAS MARAS, SELUMA, BENGKULU",1,69,106,175
https://kawalpemilu.org#21785,"GENTING JUAR, SEMIDANG ALAS MARAS, SELUMA, BENGKULU",2,66,58,124
https://kawalpemilu.org#21785,"GENTING JUAR, SEMIDANG ALAS MARAS, SELUMA, BENGKULU",3,58,99,157
https://kawalpemilu.org#21786,"MUARA MARAS, SEMIDANG ALAS MARAS, SELUMA, BENGKULU",1,74,86,160
https://kawalpemilu.org#21786,"MUARA MARAS, SEMIDANG ALAS MARAS, SELUMA, BENGKULU",2,86,69,155
https://kawalpemilu.org#21786,"MUARA MARAS, SEMIDANG ALAS MARAS, SELUMA, BENGKULU",3,85,57,142
https://kawalpemilu.org#87975,"RIMBO BESAK, SEMIDANG ALAS MARAS, SELUMA, BENGKULU",1,84,40,124
https://kawalpemilu.org#87975,"RIMBO BESAK, SEMIDANG ALAS MARAS, SELUMA, BENGKULU",2,90,46,136
https://kawalpemilu.org#87976,"MUARA TIMPUT, SEMIDANG ALAS MARAS, SELUMA, BENGKULU",1,98,58,156
https://kawalpemilu.org#87976,"MUARA TIMPUT, SEMIDANG ALAS MARAS, SELUMA, BENGKULU",2,102,54,156
https://kawalpemilu.org#87977,"SERIAN BANDUNG, SEMIDANG ALAS MARAS, SELUMA, BENGKULU",1,143,95,238
https://kawalpemilu.org#87977,"SERIAN BANDUNG, SEMIDANG ALAS MARAS, SELUMA, BENGKULU",2,184,74,258
https://kawalpemilu.org#87978,"TALANG KEMANG, SEMIDANG ALAS MARAS, SELUMA, BENGKULU",1,49,108,157
https://kawalpemilu.org#87978,"TALANG KEMANG, SEMIDANG ALAS MARAS, SELUMA, BENGKULU",2,57,106,163
https://kawalpemilu.org#87979,"MARAS BANTAN, SEMIDANG ALAS MARAS, SELUMA, BENGKULU",1,82,37,119
https://kawalpemilu.org#87979,"MARAS BANTAN, SEMIDANG ALAS MARAS, SELUMA, BENGKULU",2,76,43,119
https://kawalpemilu.org#87979,"MARAS BANTAN, SEMIDANG ALAS MARAS, SELUMA, BENGKULU",3,74,48,122
https://kawalpemilu.org#928239,"KARANG DAPO, SEMIDANG ALAS MARAS, SELUMA, BENGKULU",1,50,119,169
https://kawalpemilu.org#928239,"KARANG DAPO, SEMIDANG ALAS MARAS, SELUMA, BENGKULU",2,43,127,170
https://kawalpemilu.org#928239,"KARANG DAPO, SEMIDANG ALAS MARAS, SELUMA, BENGKULU",3,66,106,172
https://kawalpemilu.org#21788,"SUKAMAJU, AIR PERIUKAN, SELUMA, BENGKULU",1,57,186,243
https://kawalpemilu.org#21788,"SUKAMAJU, AIR PERIUKAN, SELUMA, BENGKULU",2,69,101,170
https://kawalpemilu.org#21788,"SUKAMAJU, AIR PERIUKAN, SELUMA, BENGKULU",3,58,146,204
https://kawalpemilu.org#21788,"SUKAMAJU, AIR PERIUKAN, SELUMA, BENGKULU",4,58,153,211
https://kawalpemilu.org#21789,"TALANG ALAI, AIR PERIUKAN, SELUMA, BENGKULU",1,80,89,169
https://kawalpemilu.org#21789,"TALANG ALAI, AIR PERIUKAN, SELUMA, BENGKULU",2,112,95,207
https://kawalpemilu.org#21789,"TALANG ALAI, AIR PERIUKAN, SELUMA, BENGKULU",3,116,95,211
https://kawalpemilu.org#21789,"TALANG ALAI, AIR PERIUKAN, SELUMA, BENGKULU",4,102,84,186
https://kawalpemilu.org#21790,"TALANG BENUANG, AIR PERIUKAN, SELUMA, BENGKULU",1,119,81,200
https://kawalpemilu.org#21790,"TALANG BENUANG, AIR PERIUKAN, SELUMA, BENGKULU",2,119,49,168
https://kawalpemilu.org#21790,"TALANG BENUANG, AIR PERIUKAN, SELUMA, BENGKULU",3,102,62,164
https://kawalpemilu.org#21790,"TALANG BENUANG, AIR PERIUKAN, SELUMA, BENGKULU",4,126,89,215
https://kawalpemilu.org#21790,"TALANG BENUANG, AIR PERIUKAN, SELUMA, BENGKULU",5,200,23,223
https://kawalpemilu.org#21791,"PADANG PELASAN, AIR PERIUKAN, SELUMA, BENGKULU",1,80,72,152
https://kawalpemilu.org#21791,"PADANG PELASAN, AIR PERIUKAN, SELUMA, BENGKULU",2,59,106,165
https://kawalpemilu.org#21791,"PADANG PELASAN, AIR PERIUKAN, SELUMA, BENGKULU",3,104,137,241
https://kawalpemilu.org#21791,"PADANG PELASAN, AIR PERIUKAN, SELUMA, BENGKULU",4,48,71,119
https://kawalpemilu.org#21791,"PADANG PELASAN, AIR PERIUKAN, SELUMA, BENGKULU",5,75,120,195
https://kawalpemilu.org#21792,"AIR PERIUKAN, AIR PERIUKAN, SELUMA, BENGKULU",1,72,148,220
https://kawalpemilu.org#21792,"AIR PERIUKAN, AIR PERIUKAN, SELUMA, BENGKULU",2,70,107,177
https://kawalpemilu.org#21792,"AIR PERIUKAN, AIR PERIUKAN, SELUMA, BENGKULU",3,63,103,166
https://kawalpemilu.org#21792,"AIR PERIUKAN, AIR PERIUKAN, SELUMA, BENGKULU",4,109,94,203
https://kawalpemilu.org#21793,"DERMAYU, AIR PERIUKAN, SELUMA, BENGKULU",1,69,136,205
https://kawalpemilu.org#21793,"DERMAYU, AIR PERIUKAN, SELUMA, BENGKULU",2,90,159,249
https://kawalpemilu.org#21793,"DERMAYU, AIR PERIUKAN, SELUMA, BENGKULU",3,74,101,175
https://kawalpemilu.org#21793,"DERMAYU, AIR PERIUKAN, SELUMA, BENGKULU",5,138,140,278
https://kawalpemilu.org#21793,"DERMAYU, AIR PERIUKAN, SELUMA, BENGKULU",6,95,17,112
https://kawalpemilu.org#21794,"KEBAN AGUNG, AIR PERIUKAN, SELUMA, BENGKULU",2,65,95,160
https://kawalpemilu.org#21794,"KEBAN AGUNG, AIR PERIUKAN, SELUMA, BENGKULU",3,110,140,250
https://kawalpemilu.org#21795,"PASAR NGALAM, AIR PERIUKAN, SELUMA, BENGKULU",1,126,89,215
https://kawalpemilu.org#21795,"PASAR NGALAM, AIR PERIUKAN, SELUMA, BENGKULU",2,106,128,234
https://kawalpemilu.org#21795,"PASAR NGALAM, AIR PERIUKAN, SELUMA, BENGKULU",3,122,79,201
https://kawalpemilu.org#21795,"PASAR NGALAM, AIR PERIUKAN, SELUMA, BENGKULU",4,147,58,205
https://kawalpemilu.org#21795,"PASAR NGALAM, AIR PERIUKAN, SELUMA, BENGKULU",5,131,73,204
https://kawalpemilu.org#21796,"SUKASARI, AIR PERIUKAN, SELUMA, BENGKULU",1,230,25,255
https://kawalpemilu.org#21796,"SUKASARI, AIR PERIUKAN, SELUMA, BENGKULU",2,203,35,238
https://kawalpemilu.org#21796,"SUKASARI, AIR PERIUKAN, SELUMA, BENGKULU",3,246,37,283
https://kawalpemilu.org#21796,"SUKASARI, AIR PERIUKAN, SELUMA, BENGKULU",4,168,25,193
https://kawalpemilu.org#21796,"SUKASARI, AIR PERIUKAN, SELUMA, BENGKULU",5,219,31,250
https://kawalpemilu.org#21797,"KUNGKAI BARU, AIR PERIUKAN, SELUMA, BENGKULU",1,175,22,197
https://kawalpemilu.org#21797,"KUNGKAI BARU, AIR PERIUKAN, SELUMA, BENGKULU",2,175,15,190
https://kawalpemilu.org#21797,"KUNGKAI BARU, AIR PERIUKAN, SELUMA, BENGKULU",3,194,22,216
https://kawalpemilu.org#21797,"KUNGKAI BARU, AIR PERIUKAN, SELUMA, BENGKULU",4,213,12,225
https://kawalpemilu.org#21797,"KUNGKAI BARU, AIR PERIUKAN, SELUMA, BENGKULU",5,202,12,214
https://kawalpemilu.org#21798,"TAWANG REJO, AIR PERIUKAN, SELUMA, BENGKULU",1,173,19,192
https://kawalpemilu.org#21798,"TAWANG REJO, AIR PERIUKAN, SELUMA, BENGKULU",2,176,22,198
https://kawalpemilu.org#21798,"TAWANG REJO, AIR PERIUKAN, SELUMA, BENGKULU",3,168,16,184
https://kawalpemilu.org#21798,"TAWANG REJO, AIR PERIUKAN, SELUMA, BENGKULU",4,175,46,221
https://kawalpemilu.org#21798,"TAWANG REJO, AIR PERIUKAN, SELUMA, BENGKULU",5,74,27,101
https://kawalpemilu.org#21799,"LAWANG AGUNG, AIR PERIUKAN, SELUMA, BENGKULU",1,119,139,258
https://kawalpemilu.org#21799,"LAWANG AGUNG, AIR PERIUKAN, SELUMA, BENGKULU",2,87,182,269
https://kawalpemilu.org#21799,"LAWANG AGUNG, AIR PERIUKAN, SELUMA, BENGKULU",3,104,137,241
https://kawalpemilu.org#87980,"TABA LUBUK PUDING, AIR PERIUKAN, SELUMA, BENGKULU",1,92,36,128
https://kawalpemilu.org#87980,"TABA LUBUK PUDING, AIR PERIUKAN, SELUMA, BENGKULU",2,24,110,134
https://kawalpemilu.org#87980,"TABA LUBUK PUDING, AIR PERIUKAN, SELUMA, BENGKULU",3,43,55,98
https://kawalpemilu.org#87981,"TALANG SEBARIS, AIR PERIUKAN, SELUMA, BENGKULU",1,73,121,194
https://kawalpemilu.org#87981,"TALANG SEBARIS, AIR PERIUKAN, SELUMA, BENGKULU",2,82,101,183
https://kawalpemilu.org#87981,"TALANG SEBARIS, AIR PERIUKAN, SELUMA, BENGKULU",3,124,62,186
https://kawalpemilu.org#87982,"LUBUK GILANG, AIR PERIUKAN, SELUMA, BENGKULU",1,121,57,178
https://kawalpemilu.org#87982,"LUBUK GILANG, AIR PERIUKAN, SELUMA, BENGKULU",2,129,70,199
https://kawalpemilu.org#87982,"LUBUK GILANG, AIR PERIUKAN, SELUMA, BENGKULU",3,102,67,169
https://kawalpemilu.org#87983,"LOKASI BARU, AIR PERIUKAN, SELUMA, BENGKULU",1,198,45,243
https://kawalpemilu.org#87983,"LOKASI BARU, AIR PERIUKAN, SELUMA, BENGKULU",2,177,34,211
https://kawalpemilu.org#87983,"LOKASI BARU, AIR PERIUKAN, SELUMA, BENGKULU",3,109,61,170
https://kawalpemilu.org#87983,"LOKASI BARU, AIR PERIUKAN, SELUMA, BENGKULU",4,198,50,248
https://kawalpemilu.org#21801,"TALANG GIRING, LUBUK SANDI, SELUMA, BENGKULU",1,17,161,178
https://kawalpemilu.org#21801,"TALANG GIRING, LUBUK SANDI, SELUMA, BENGKULU",2,76,80,156
https://kawalpemilu.org#21801,"TALANG GIRING, LUBUK SANDI, SELUMA, BENGKULU",3,81,24,105
https://kawalpemilu.org#21802,"PADANG CAPO ILIR, LUBUK SANDI, SELUMA, BENGKULU",1,90,61,151
https://kawalpemilu.org#21802,"PADANG CAPO ILIR, LUBUK SANDI, SELUMA, BENGKULU",2,33,45,78
https://kawalpemilu.org#21802,"PADANG CAPO ILIR, LUBUK SANDI, SELUMA, BENGKULU",3,83,38,121
https://kawalpemilu.org#21803,"PADANG CAPO ULU, LUBUK SANDI, SELUMA, BENGKULU",1,62,93,155
https://kawalpemilu.org#21803,"PADANG CAPO ULU, LUBUK SANDI, SELUMA, BENGKULU",2,78,88,166
https://kawalpemilu.org#21804,"TALANG KEBUN, LUBUK SANDI, SELUMA, BENGKULU",1,101,41,142
https://kawalpemilu.org#21804,"TALANG KEBUN, LUBUK SANDI, SELUMA, BENGKULU",2,54,43,97
https://kawalpemilu.org#21804,"TALANG KEBUN, LUBUK SANDI, SELUMA, BENGKULU",3,60,106,166
https://kawalpemilu.org#21805,"GUNUNG AGUNG, LUBUK SANDI, SELUMA, BENGKULU",1,81,103,184
https://kawalpemilu.org#21805,"GUNUNG AGUNG, LUBUK SANDI, SELUMA, BENGKULU",2,37,77,114
https://kawalpemilu.org#21805,"GUNUNG AGUNG, LUBUK SANDI, SELUMA, BENGKULU",3,74,76,150
https://kawalpemilu.org#21806,"CAWANG, LUBUK SANDI, SELUMA, BENGKULU",1,62,89,151
https://kawalpemilu.org#21806,"CAWANG, LUBUK SANDI, SELUMA, BENGKULU",2,73,68,141
https://kawalpemilu.org#21807,"ARANG SAPAT, LUBUK SANDI, SELUMA, BENGKULU",1,61,127,188
https://kawalpemilu.org#21807,"ARANG SAPAT, LUBUK SANDI, SELUMA, BENGKULU",2,74,126,200
https://kawalpemilu.org#21807,"ARANG SAPAT, LUBUK SANDI, SELUMA, BENGKULU",3,56,130,186
https://kawalpemilu.org#21808,"DUSUN TENGAH, LUBUK SANDI, SELUMA, BENGKULU",1,85,115,200
https://kawalpemilu.org#21808,"DUSUN TENGAH, LUBUK SANDI, SELUMA, BENGKULU",2,56,71,127
https://kawalpemilu.org#21808,"DUSUN TENGAH, LUBUK SANDI, SELUMA, BENGKULU",3,71,143,214
https://kawalpemilu.org#21809,"TANJUNG KUAW, LUBUK SANDI, SELUMA, BENGKULU",1,57,96,153
https://kawalpemilu.org#21809,"TANJUNG KUAW, LUBUK SANDI, SELUMA, BENGKULU",2,62,96,158
https://kawalpemilu.org#21809,"TANJUNG KUAW, LUBUK SANDI, SELUMA, BENGKULU",3,80,32,112
https://kawalpemilu.org#21810,"NAPAL JUNGUR, LUBUK SANDI, SELUMA, BENGKULU",1,78,142,220
https://kawalpemilu.org#21810,"NAPAL JUNGUR, LUBUK SANDI, SELUMA, BENGKULU",2,105,98,203
https://kawalpemilu.org#21810,"NAPAL JUNGUR, LUBUK SANDI, SELUMA, BENGKULU",3,133,39,172
https://kawalpemilu.org#21811,"TUMBU'AN, LUBUK SANDI, SELUMA, BENGKULU",1,63,150,213
https://kawalpemilu.org#21811,"TUMBU'AN, LUBUK SANDI, SELUMA, BENGKULU",2,77,136,213
https://kawalpemilu.org#21811,"TUMBU'AN, LUBUK SANDI, SELUMA, BENGKULU",3,70,122,192
https://kawalpemilu.org#21811,"TUMBU'AN, LUBUK SANDI, SELUMA, BENGKULU",4,78,112,190
https://kawalpemilu.org#21811,"TUMBU'AN, LUBUK SANDI, SELUMA, BENGKULU",5,109,149,258
https://kawalpemilu.org#21811,"TUMBU'AN, LUBUK SANDI, SELUMA, BENGKULU",6,118,23,141
https://kawalpemilu.org#21812,"RENAH PANJANG, LUBUK SANDI, SELUMA, BENGKULU",1,51,152,203
https://kawalpemilu.org#21812,"RENAH PANJANG, LUBUK SANDI, SELUMA, BENGKULU",2,98,153,251
https://kawalpemilu.org#21812,"RENAH PANJANG, LUBUK SANDI, SELUMA, BENGKULU",3,89,112,201
https://kawalpemilu.org#87963,"SAKAIAN, LUBUK SANDI, SELUMA, BENGKULU",1,114,142,256
https://kawalpemilu.org#87964,"LUBUK TERENTANG, LUBUK SANDI, SELUMA, BENGKULU",1,120,146,266
https://kawalpemilu.org#21814,"TANJUNG AGUNG, SELUMA BARAT, SELUMA, BENGKULU",1,50,79,129
https://kawalpemilu.org#21814,"TANJUNG AGUNG, SELUMA BARAT, SELUMA, BENGKULU",2,53,62,115
https://kawalpemilu.org#21815,"AIR LATAK, SELUMA BARAT, SELUMA, BENGKULU",1,86,134,220
https://kawalpemilu.org#21815,"AIR LATAK, SELUMA BARAT, SELUMA, BENGKULU",2,57,134,191
https://kawalpemilu.org#21816,"TALANG PERAPAT, SELUMA BARAT, SELUMA, BENGKULU",1,162,103,265
https://kawalpemilu.org#21816,"TALANG PERAPAT, SELUMA BARAT, SELUMA, BENGKULU",2,116,147,263
https://kawalpemilu.org#21816,"TALANG PERAPAT, SELUMA BARAT, SELUMA, BENGKULU",3,136,118,254
https://kawalpemilu.org#21816,"TALANG PERAPAT, SELUMA BARAT, SELUMA, BENGKULU",4,77,5,82
https://kawalpemilu.org#21817,"PAGAR AGUNG, SELUMA BARAT, SELUMA, BENGKULU",1,74,77,151
https://kawalpemilu.org#21817,"PAGAR AGUNG, SELUMA BARAT, SELUMA, BENGKULU",2,93,81,174
https://kawalpemilu.org#21817,"PAGAR AGUNG, SELUMA BARAT, SELUMA, BENGKULU",3,75,78,153
https://kawalpemilu.org#21818,"TALANG TINGGI, SELUMA BARAT, SELUMA, BENGKULU",1,67,154,221
https://kawalpemilu.org#21818,"TALANG TINGGI, SELUMA BARAT, SELUMA, BENGKULU",2,61,145,206
https://kawalpemilu.org#21818,"TALANG TINGGI, SELUMA BARAT, SELUMA, BENGKULU",3,48,153,201
https://kawalpemilu.org#21819,"LUNJUK, SELUMA BARAT, SELUMA, BENGKULU",1,128,109,237
https://kawalpemilu.org#21819,"LUNJUK, SELUMA BARAT, SELUMA, BENGKULU",2,106,142,248
https://kawalpemilu.org#21820,"LUBUK LAGAN, SELUMA BARAT, SELUMA, BENGKULU",1,74,133,207
https://kawalpemilu.org#21820,"LUBUK LAGAN, SELUMA BARAT, SELUMA, BENGKULU",2,44,152,196
https://kawalpemilu.org#21820,"LUBUK LAGAN, SELUMA BARAT, SELUMA, BENGKULU",3,34,172,206
https://kawalpemilu.org#21820,"LUBUK LAGAN, SELUMA BARAT, SELUMA, BENGKULU",4,42,192,234
https://kawalpemilu.org#21820,"LUBUK LAGAN, SELUMA BARAT, SELUMA, BENGKULU",5,37,164,201
https://kawalpemilu.org#21821,"PURBOSARI, SELUMA BARAT, SELUMA, BENGKULU",1,119,10,129
https://kawalpemilu.org#21821,"PURBOSARI, SELUMA BARAT, SELUMA, BENGKULU",2,96,12,108
https://kawalpemilu.org#21821,"PURBOSARI, SELUMA BARAT, SELUMA, BENGKULU",3,156,31,187
https://kawalpemilu.org#21821,"PURBOSARI, SELUMA BARAT, SELUMA, BENGKULU",4,156,19,175
https://kawalpemilu.org#21821,"PURBOSARI, SELUMA BARAT, SELUMA, BENGKULU",6,195,32,227
https://kawalpemilu.org#21821,"PURBOSARI, SELUMA BARAT, SELUMA, BENGKULU",7,176,25,201
https://kawalpemilu.org#87984,"SENGKUANG JAYA, SELUMA BARAT, SELUMA, BENGKULU",1,60,111,171
https://kawalpemilu.org#87984,"SENGKUANG JAYA, SELUMA BARAT, SELUMA, BENGKULU",2,57,129,186
https://kawalpemilu.org#21823,"TALANG SALI, SELUMA TIMUR, SELUMA, BENGKULU",1,87,131,218
https://kawalpemilu.org#21823,"TALANG SALI, SELUMA TIMUR, SELUMA, BENGKULU",2,104,102,206
https://kawalpemilu.org#21823,"TALANG SALI, SELUMA TIMUR, SELUMA, BENGKULU",3,102,120,222
https://kawalpemilu.org#21823,"TALANG SALI, SELUMA TIMUR, SELUMA, BENGKULU",4,82,156,238
https://kawalpemilu.org#21823,"TALANG SALI, SELUMA TIMUR, SELUMA, BENGKULU",5,111,126,237
https://kawalpemilu.org#21824,"KUNDURAN, SELUMA TIMUR, SELUMA, BENGKULU",1,58,117,175
https://kawalpemilu.org#21824,"KUNDURAN, SELUMA TIMUR, SELUMA, BENGKULU",2,89,118,207
https://kawalpemilu.org#21824,"KUNDURAN, SELUMA TIMUR, SELUMA, BENGKULU",3,67,55,122
https://kawalpemilu.org#21825,"KOTA AGUNG, SELUMA TIMUR, SELUMA, BENGKULU",1,61,176,237
https://kawalpemilu.org#21825,"KOTA AGUNG, SELUMA TIMUR, SELUMA, BENGKULU",2,52,145,197
https://kawalpemilu.org#21825,"KOTA AGUNG, SELUMA TIMUR, SELUMA, BENGKULU",3,54,123,177
https://kawalpemilu.org#21826,"SELEBAR, SELUMA TIMUR, SELUMA, BENGKULU",1,80,150,230
https://kawalpemilu.org#21826,"SELEBAR, SELUMA TIMUR, SELUMA, BENGKULU",2,57,134,191
https://kawalpemilu.org#21826,"SELEBAR, SELUMA TIMUR, SELUMA, BENGKULU",3,64,143,207
https://kawalpemilu.org#21827,"SEMBAYAT, SELUMA TIMUR, SELUMA, BENGKULU",1,68,139,207
https://kawalpemilu.org#21827,"SEMBAYAT, SELUMA TIMUR, SELUMA, BENGKULU",2,71,143,214
https://kawalpemilu.org#21827,"SEMBAYAT, SELUMA TIMUR, SELUMA, BENGKULU",3,67,150,217
https://kawalpemilu.org#21827,"SEMBAYAT, SELUMA TIMUR, SELUMA, BENGKULU",4,78,142,220
https://kawalpemilu.org#21828,"BUNGA MAS, SELUMA TIMUR, SELUMA, BENGKULU",1,69,128,197
https://kawalpemilu.org#21828,"BUNGA MAS, SELUMA TIMUR, SELUMA, BENGKULU",2,70,121,191
https://kawalpemilu.org#21828,"BUNGA MAS, SELUMA TIMUR, SELUMA, BENGKULU",3,67,155,222
https://kawalpemilu.org#21828,"BUNGA MAS, SELUMA TIMUR, SELUMA, BENGKULU",4,56,135,191
https://kawalpemilu.org#21828,"BUNGA MAS, SELUMA TIMUR, SELUMA, BENGKULU",5,66,126,192
https://kawalpemilu.org#21828,"BUNGA MAS, SELUMA TIMUR, SELUMA, BENGKULU",6,64,135,199
https://kawalpemilu.org#21829,"TENANGAN, SELUMA TIMUR, SELUMA, BENGKULU",1,123,59,182
https://kawalpemilu.org#21829,"TENANGAN, SELUMA TIMUR, SELUMA, BENGKULU",2,137,81,218
https://kawalpemilu.org#21829,"TENANGAN, SELUMA TIMUR, SELUMA, BENGKULU",3,146,82,228
https://kawalpemilu.org#21829,"TENANGAN, SELUMA TIMUR, SELUMA, BENGKULU",4,104,80,184
https://kawalpemilu.org#21830,"RAWA SARI, SELUMA TIMUR, SELUMA, BENGKULU",1,191,61,252
https://kawalpemilu.org#21830,"RAWA SARI, SELUMA TIMUR, SELUMA, BENGKULU",2,206,58,264
https://kawalpemilu.org#21830,"RAWA SARI, SELUMA TIMUR, SELUMA, BENGKULU",3,159,25,184
https://kawalpemilu.org#21832,"TALANG RAMI, SELUMA UTARA, SELUMA, BENGKULU",1,62,53,115
https://kawalpemilu.org#21832,"TALANG RAMI, SELUMA UTARA, SELUMA, BENGKULU",2,89,55,144
https://kawalpemilu.org#21832,"TALANG RAMI, SELUMA UTARA, SELUMA, BENGKULU",3,90,131,221
https://kawalpemilu.org#21833,"TALANG BERINGIN, SELUMA UTARA, SELUMA, BENGKULU",1,39,149,188
https://kawalpemilu.org#21833,"TALANG BERINGIN, SELUMA UTARA, SELUMA, BENGKULU",2,18,155,173
https://kawalpemilu.org#21833,"TALANG BERINGIN, SELUMA UTARA, SELUMA, BENGKULU",3,28,153,181
https://kawalpemilu.org#21833,"TALANG BERINGIN, SELUMA UTARA, SELUMA, BENGKULU",4,40,81,121
https://kawalpemilu.org#21833,"TALANG BERINGIN, SELUMA UTARA, SELUMA, BENGKULU",5,24,214,238
https://kawalpemilu.org#21834,"PUGUK, SELUMA UTARA, SELUMA, BENGKULU",1,51,98,149
https://kawalpemilu.org#21834,"PUGUK, SELUMA UTARA, SELUMA, BENGKULU",2,37,108,145
https://kawalpemilu.org#21834,"PUGUK, SELUMA UTARA, SELUMA, BENGKULU",3,46,117,163
https://kawalpemilu.org#21834,"PUGUK, SELUMA UTARA, SELUMA, BENGKULU",4,37,126,163
https://kawalpemilu.org#21834,"PUGUK, SELUMA UTARA, SELUMA, BENGKULU",5,38,101,139
https://kawalpemilu.org#21834,"PUGUK, SELUMA UTARA, SELUMA, BENGKULU",6,39,137,176
https://kawalpemilu.org#21834,"PUGUK, SELUMA UTARA, SELUMA, BENGKULU",7,42,120,162
https://kawalpemilu.org#21835,"PANDAN, SELUMA UTARA, SELUMA, BENGKULU",1,31,129,160
https://kawalpemilu.org#21835,"PANDAN, SELUMA UTARA, SELUMA, BENGKULU",2,65,101,166
https://kawalpemilu.org#21835,"PANDAN, SELUMA UTARA, SELUMA, BENGKULU",3,78,72,150
https://kawalpemilu.org#21835,"PANDAN, SELUMA UTARA, SELUMA, BENGKULU",4,53,163,216
https://kawalpemilu.org#21836,"SELINGSINGAN, SELUMA UTARA, SELUMA, BENGKULU",1,62,122,184
https://kawalpemilu.org#21836,"SELINGSINGAN, SELUMA UTARA, SELUMA, BENGKULU",2,78,112,190
https://kawalpemilu.org#21836,"SELINGSINGAN, SELUMA UTARA, SELUMA, BENGKULU",3,49,123,172
https://kawalpemilu.org#21837,"SIMPANG, SELUMA UTARA, SELUMA, BENGKULU",1,79,72,151
https://kawalpemilu.org#21837,"SIMPANG, SELUMA UTARA, SELUMA, BENGKULU",2,99,79,178
https://kawalpemilu.org#21838,"SEKALAK, SELUMA UTARA, SELUMA, BENGKULU",1,97,12,109
https://kawalpemilu.org#21838,"SEKALAK, SELUMA UTARA, SELUMA, BENGKULU",2,100,38,138
https://kawalpemilu.org#21838,"SEKALAK, SELUMA UTARA, SELUMA, BENGKULU",3,18,50,68
https://kawalpemilu.org#21839,"LUBUK RESAM, SELUMA UTARA, SELUMA, BENGKULU",1,51,118,169
https://kawalpemilu.org#21839,"LUBUK RESAM, SELUMA UTARA, SELUMA, BENGKULU",2,64,147,211
https://kawalpemilu.org#21839,"LUBUK RESAM, SELUMA UTARA, SELUMA, BENGKULU",3,70,105,175
https://kawalpemilu.org#21839,"LUBUK RESAM, SELUMA UTARA, SELUMA, BENGKULU",4,70,105,175
https://kawalpemilu.org#88023,"SINAR PAGI, SELUMA UTARA, SELUMA, BENGKULU",1,50,79,129
https://kawalpemilu.org#88023,"SINAR PAGI, SELUMA UTARA, SELUMA, BENGKULU",2,49,74,123
https://kawalpemilu.org#88024,"TALANG EMPAT, SELUMA UTARA, SELUMA, BENGKULU",1,62,109,171
https://kawalpemilu.org#88024,"TALANG EMPAT, SELUMA UTARA, SELUMA, BENGKULU",2,45,86,131
https://kawalpemilu.org#88024,"TALANG EMPAT, SELUMA UTARA, SELUMA, BENGKULU",3,50,91,141
https://kawalpemilu.org#21841,"SUKARAMI, SELUMA SELATAN, SELUMA, BENGKULU",1,78,108,186
https://kawalpemilu.org#21841,"SUKARAMI, SELUMA SELATAN, SELUMA, BENGKULU",2,82,101,183
https://kawalpemilu.org#21842,"TANJUNG SERU, SELUMA SELATAN, SELUMA, BENGKULU",1,38,75,113
https://kawalpemilu.org#21842,"TANJUNG SERU, SELUMA SELATAN, SELUMA, BENGKULU",2,57,104,161
https://kawalpemilu.org#21842,"TANJUNG SERU, SELUMA SELATAN, SELUMA, BENGKULU",3,50,100,150
https://kawalpemilu.org#21843,"TANJUNGAN, SELUMA SELATAN, SELUMA, BENGKULU",1,77,72,149
https://kawalpemilu.org#21843,"TANJUNGAN, SELUMA SELATAN, SELUMA, BENGKULU",2,77,85,162
https://kawalpemilu.org#21844,"PASAR SELUMA, SELUMA SELATAN, SELUMA, BENGKULU",1,165,74,239
https://kawalpemilu.org#21844,"PASAR SELUMA, SELUMA SELATAN, SELUMA, BENGKULU",2,107,60,167
https://kawalpemilu.org#21844,"PASAR SELUMA, SELUMA SELATAN, SELUMA, BENGKULU",3,132,72,204
https://kawalpemilu.org#21845,"PADANG GENTING, SELUMA SELATAN, SELUMA, BENGKULU",1,71,80,151
https://kawalpemilu.org#21845,"PADANG GENTING, SELUMA SELATAN, SELUMA, BENGKULU",2,76,78,154
https://kawalpemilu.org#21845,"PADANG GENTING, SELUMA SELATAN, SELUMA, BENGKULU",3,74,92,166
https://kawalpemilu.org#21845,"PADANG GENTING, SELUMA SELATAN, SELUMA, BENGKULU",4,100,65,165
https://kawalpemilu.org#21846,"SENGKUANG, SELUMA SELATAN, SELUMA, BENGKULU",1,90,102,192
https://kawalpemilu.org#21846,"SENGKUANG, SELUMA SELATAN, SELUMA, BENGKULU",2,87,101,188
https://kawalpemilu.org#21846,"SENGKUANG, SELUMA SELATAN, SELUMA, BENGKULU",3,86,101,187
https://kawalpemilu.org#21847,"TANGGA BATU, SELUMA SELATAN, SELUMA, BENGKULU",1,64,116,180
https://kawalpemilu.org#21847,"TANGGA BATU, SELUMA SELATAN, SELUMA, BENGKULU",2,79,94,173
https://kawalpemilu.org#21847,"TANGGA BATU, SELUMA SELATAN, SELUMA, BENGKULU",3,70,99,169
https://kawalpemilu.org#21848,"RIMBO KEDUI, SELUMA SELATAN, SELUMA, BENGKULU",1,126,88,214
https://kawalpemilu.org#21848,"RIMBO KEDUI, SELUMA SELATAN, SELUMA, BENGKULU",2,140,56,196
https://kawalpemilu.org#21848,"RIMBO KEDUI, SELUMA SELATAN, SELUMA, BENGKULU",3,205,45,250
https://kawalpemilu.org#21848,"RIMBO KEDUI, SELUMA SELATAN, SELUMA, BENGKULU",4,167,80,247
https://kawalpemilu.org#21848,"RIMBO KEDUI, SELUMA SELATAN, SELUMA, BENGKULU",5,125,131,256
https://kawalpemilu.org#21849,"TANJUNG SELUAI, SELUMA SELATAN, SELUMA, BENGKULU",1,112,64,176
https://kawalpemilu.org#21849,"TANJUNG SELUAI, SELUMA SELATAN, SELUMA, BENGKULU",2,116,64,180
https://kawalpemilu.org#21849,"TANJUNG SELUAI, SELUMA SELATAN, SELUMA, BENGKULU",3,82,84,166
https://kawalpemilu.org#21850,"PADANG RAMBUN, SELUMA SELATAN, SELUMA, BENGKULU",1,165,41,206
https://kawalpemilu.org#21850,"PADANG RAMBUN, SELUMA SELATAN, SELUMA, BENGKULU",2,169,72,241
https://kawalpemilu.org#21850,"PADANG RAMBUN, SELUMA SELATAN, SELUMA, BENGKULU",3,147,65,212
https://kawalpemilu.org#21850,"PADANG RAMBUN, SELUMA SELATAN, SELUMA, BENGKULU",4,100,117,217
https://kawalpemilu.org#21850,"PADANG RAMBUN, SELUMA SELATAN, SELUMA, BENGKULU",5,88,88,176
https://kawalpemilu.org#21850,"PADANG RAMBUN, SELUMA SELATAN, SELUMA, BENGKULU",6,113,56,169
https://kawalpemilu.org#21851,"SIDO MULYO, SELUMA SELATAN, SELUMA, BENGKULU",1,125,129,254
https://kawalpemilu.org#21851,"SIDO MULYO, SELUMA SELATAN, SELUMA, BENGKULU",2,152,78,230
https://kawalpemilu.org#21851,"SIDO MULYO, SELUMA SELATAN, SELUMA, BENGKULU",3,126,82,208
https://kawalpemilu.org#21851,"SIDO MULYO, SELUMA SELATAN, SELUMA, BENGKULU",4,159,53,212
https://kawalpemilu.org#88025,"PADANG MERBAU, SELUMA SELATAN, SELUMA, BENGKULU",1,136,103,239
https://kawalpemilu.org#88025,"PADANG MERBAU, SELUMA SELATAN, SELUMA, BENGKULU",2,106,131,237
https://kawalpemilu.org#21853,"PERING BARU, TALO KECIL, SELUMA, BENGKULU",1,115,76,191
https://kawalpemilu.org#21853,"PERING BARU, TALO KECIL, SELUMA, BENGKULU",2,103,82,185
https://kawalpemilu.org#21853,"PERING BARU, TALO KECIL, SELUMA, BENGKULU",3,93,96,189
https://kawalpemilu.org#21853,"PERING BARU, TALO KECIL, SELUMA, BENGKULU",4,103,66,169
https://kawalpemilu.org#21853,"PERING BARU, TALO KECIL, SELUMA, BENGKULU",5,19,46,65
https://kawalpemilu.org#21854,"TALANG PADANG, TALO KECIL, SELUMA, BENGKULU",1,89,131,220
https://kawalpemilu.org#21854,"TALANG PADANG, TALO KECIL, SELUMA, BENGKULU",2,85,121,206
https://kawalpemilu.org#21855,"SUKA MERINDU, TALO KECIL, SELUMA, BENGKULU",1,40,184,224
https://kawalpemilu.org#21855,"SUKA MERINDU, TALO KECIL, SELUMA, BENGKULU",2,40,179,219
https://kawalpemilu.org#21855,"SUKA MERINDU, TALO KECIL, SELUMA, BENGKULU",3,55,128,183
https://kawalpemilu.org#21856,"NAPALAN, TALO KECIL, SELUMA, BENGKULU",1,46,176,222
https://kawalpemilu.org#21856,"NAPALAN, TALO KECIL, SELUMA, BENGKULU",2,55,139,194
https://kawalpemilu.org#21856,"NAPALAN, TALO KECIL, SELUMA, BENGKULU",3,55,135,190
https://kawalpemilu.org#21857,"TABA, TALO KECIL, SELUMA, BENGKULU",1,108,124,232
https://kawalpemilu.org#21857,"TABA, TALO KECIL, SELUMA, BENGKULU",2,92,118,210
https://kawalpemilu.org#21857,"TABA, TALO KECIL, SELUMA, BENGKULU",3,32,134,166
https://kawalpemilu.org#21857,"TABA, TALO KECIL, SELUMA, BENGKULU",4,38,100,138
https://kawalpemilu.org#21857,"TABA, TALO KECIL, SELUMA, BENGKULU",5,51,107,158
https://kawalpemilu.org#21858,"BAKAL DALAM, TALO KECIL, SELUMA, BENGKULU",1,43,141,184
https://kawalpemilu.org#21858,"BAKAL DALAM, TALO KECIL, SELUMA, BENGKULU",2,44,164,208
https://kawalpemilu.org#21858,"BAKAL DALAM, TALO KECIL, SELUMA, BENGKULU",3,48,161,209
https://kawalpemilu.org#21858,"BAKAL DALAM, TALO KECIL, SELUMA, BENGKULU",4,60,127,187
https://kawalpemilu.org#21859,"LUBUK LAGAN, TALO KECIL, SELUMA, BENGKULU",1,52,111,163
https://kawalpemilu.org#21859,"LUBUK LAGAN, TALO KECIL, SELUMA, BENGKULU",2,67,108,175
https://kawalpemilu.org#21859,"LUBUK LAGAN, TALO KECIL, SELUMA, BENGKULU",3,65,105,170
https://kawalpemilu.org#21859,"LUBUK LAGAN, TALO KECIL, SELUMA, BENGKULU",4,49,92,141
https://kawalpemilu.org#21860,"SUNGAI PETAI, TALO KECIL, SELUMA, BENGKULU",1,65,86,151
https://kawalpemilu.org#21860,"SUNGAI PETAI, TALO KECIL, SELUMA, BENGKULU",2,74,69,143
https://kawalpemilu.org#21860,"SUNGAI PETAI, TALO KECIL, SELUMA, BENGKULU",3,48,69,117
https://kawalpemilu.org#21860,"SUNGAI PETAI, TALO KECIL, SELUMA, BENGKULU",4,35,86,121
https://kawalpemilu.org#21861,"SUKA BULAN, TALO KECIL, SELUMA, BENGKULU",1,75,99,174
https://kawalpemilu.org#21861,"SUKA BULAN, TALO KECIL, SELUMA, BENGKULU",2,66,141,207
https://kawalpemilu.org#21861,"SUKA BULAN, TALO KECIL, SELUMA, BENGKULU",3,54,111,165
https://kawalpemilu.org#88026,"TEBAT SIBUN, TALO KECIL, SELUMA, BENGKULU",1,65,101,166
https://kawalpemilu.org#88026,"TEBAT SIBUN, TALO KECIL, SELUMA, BENGKULU",2,55,88,143
https://kawalpemilu.org#928240,"BATU BALAI, TALO KECIL, SELUMA, BENGKULU",1,58,22,80
https://kawalpemilu.org#928240,"BATU BALAI, TALO KECIL, SELUMA, BENGKULU",2,44,24,68
https://kawalpemilu.org#21863,"PAGAR, ULU TALO, SELUMA, BENGKULU",1,35,112,147
https://kawalpemilu.org#21863,"PAGAR, ULU TALO, SELUMA, BENGKULU",2,54,105,159
https://kawalpemilu.org#21863,"PAGAR, ULU TALO, SELUMA, BENGKULU",3,62,105,167
https://kawalpemilu.org#21864,"MUARA SIMPUR, ULU TALO, SELUMA, BENGKULU",1,24,86,110
https://kawalpemilu.org#21865,"PAGAR AGUNG, ULU TALO, SELUMA, BENGKULU",1,14,64,78
https://kawalpemilu.org#21866,"PAGAR BANYU, ULU TALO, SELUMA, BENGKULU",1,110,72,182
https://kawalpemilu.org#21866,"PAGAR BANYU, ULU TALO, SELUMA, BENGKULU",2,72,30,102
https://kawalpemilu.org#21867,"SIMPUR IJANG, ULU TALO, SELUMA, BENGKULU",1,131,27,158
https://kawalpemilu.org#21868,"AIR KERUH, ULU TALO, SELUMA, BENGKULU",1,58,87,145
https://kawalpemilu.org#21868,"AIR KERUH, ULU TALO, SELUMA, BENGKULU",2,44,121,165
https://kawalpemilu.org#21869,"HARGO BINANGUN, ULU TALO, SELUMA, BENGKULU",1,124,39,163
https://kawalpemilu.org#21869,"HARGO BINANGUN, ULU TALO, SELUMA, BENGKULU",2,154,31,185
https://kawalpemilu.org#21869,"HARGO BINANGUN, ULU TALO, SELUMA, BENGKULU",3,113,68,181
https://kawalpemilu.org#21869,"HARGO BINANGUN, ULU TALO, SELUMA, BENGKULU",4,141,56,197
https://kawalpemilu.org#21870,"MEKAR JAYA, ULU TALO, SELUMA, BENGKULU",1,129,59,188
https://kawalpemilu.org#21870,"MEKAR JAYA, ULU TALO, SELUMA, BENGKULU",2,133,47,180
https://kawalpemilu.org#21870,"MEKAR JAYA, ULU TALO, SELUMA, BENGKULU",3,117,59,176
https://kawalpemilu.org#21871,"GIRI NANTO, ULU TALO, SELUMA, BENGKULU",1,113,27,140
https://kawalpemilu.org#88027,"BANYU KENCANA, ULU TALO, SELUMA, BENGKULU",1,116,24,140
https://kawalpemilu.org#88028,"MUARA NIBUNG, ULU TALO, SELUMA, BENGKULU",1,104,116,220
https://kawalpemilu.org#88029,"TANJUNG AGUNG, ULU TALO, SELUMA, BENGKULU",1,49,118,167
https://kawalpemilu.org#88030,"GIRI MULYA, ULU TALO, SELUMA, BENGKULU",1,81,84,165
https://kawalpemilu.org#21873,"PASAR TALO, ILIR TALO, SELUMA, BENGKULU",1,54,127,181
https://kawalpemilu.org#21873,"PASAR TALO, ILIR TALO, SELUMA, BENGKULU",2,45,80,125
https://kawalpemilu.org#21873,"PASAR TALO, ILIR TALO, SELUMA, BENGKULU",3,52,97,149
https://kawalpemilu.org#21874,"DUSUN BARU, ILIR TALO, SELUMA, BENGKULU",1,40,125,165
https://kawalpemilu.org#21874,"DUSUN BARU, ILIR TALO, SELUMA, BENGKULU",2,46,155,201
https://kawalpemilu.org#21874,"DUSUN BARU, ILIR TALO, SELUMA, BENGKULU",3,67,94,161
https://kawalpemilu.org#21874,"DUSUN BARU, ILIR TALO, SELUMA, BENGKULU",4,60,101,161
https://kawalpemilu.org#21874,"DUSUN BARU, ILIR TALO, SELUMA, BENGKULU",5,58,150,208
https://kawalpemilu.org#21875,"TALANG KABU, ILIR TALO, SELUMA, BENGKULU",1,81,174,255
https://kawalpemilu.org#21875,"TALANG KABU, ILIR TALO, SELUMA, BENGKULU",2,76,162,238
https://kawalpemilu.org#21875,"TALANG KABU, ILIR TALO, SELUMA, BENGKULU",3,94,132,226
https://kawalpemilu.org#21875,"TALANG KABU, ILIR TALO, SELUMA, BENGKULU",4,93,129,222
https://kawalpemilu.org#21875,"TALANG KABU, ILIR TALO, SELUMA, BENGKULU",5,102,23,123
https://kawalpemilu.org#21876,"TANAH ABANG, ILIR TALO, SELUMA, BENGKULU",1,70,144,214
https://kawalpemilu.org#21876,"TANAH ABANG, ILIR TALO, SELUMA, BENGKULU",2,35,173,208
https://kawalpemilu.org#21876,"TANAH ABANG, ILIR TALO, SELUMA, BENGKULU",3,37,134,171
https://kawalpemilu.org#21876,"TANAH ABANG, ILIR TALO, SELUMA, BENGKULU",4,46,86,132
https://kawalpemilu.org#21877,"PENAGO BARU, ILIR TALO, SELUMA, BENGKULU",1,116,69,185
https://kawalpemilu.org#21877,"PENAGO BARU, ILIR TALO, SELUMA, BENGKULU",2,117,87,204
https://kawalpemilu.org#21877,"PENAGO BARU, ILIR TALO, SELUMA, BENGKULU",3,158,44,202
https://kawalpemilu.org#21878,"NANTI AGUNG, ILIR TALO, SELUMA, BENGKULU",1,87,106,193
https://kawalpemilu.org#21878,"NANTI AGUNG, ILIR TALO, SELUMA, BENGKULU",2,72,103,175
https://kawalpemilu.org#21879,"TALANG PANJANG, ILIR TALO, SELUMA, BENGKULU",1,61,115,176
https://kawalpemilu.org#21879,"TALANG PANJANG, ILIR TALO, SELUMA, BENGKULU",2,51,91,142
https://kawalpemilu.org#21879,"TALANG PANJANG, ILIR TALO, SELUMA, BENGKULU",3,69,99,168
https://kawalpemilu.org#21879,"TALANG PANJANG, ILIR TALO, SELUMA, BENGKULU",4,75,108,183
https://kawalpemilu.org#21880,"PENAGO I, ILIR TALO, SELUMA, BENGKULU",1,42,35,77
https://kawalpemilu.org#21880,"PENAGO I, ILIR TALO, SELUMA, BENGKULU",2,57,87,144
https://kawalpemilu.org#21880,"PENAGO I, ILIR TALO, SELUMA, BENGKULU",3,75,102,177
https://kawalpemilu.org#21880,"PENAGO I, ILIR TALO, SELUMA, BENGKULU",4,71,70,141
https://kawalpemilu.org#21881,"PENAGO II, ILIR TALO, SELUMA, BENGKULU",1,91,110,201
https://kawalpemilu.org#21881,"PENAGO II, ILIR TALO, SELUMA, BENGKULU",2,120,73,193
https://kawalpemilu.org#21881,"PENAGO II, ILIR TALO, SELUMA, BENGKULU",3,119,89,208
https://kawalpemilu.org#21881,"PENAGO II, ILIR TALO, SELUMA, BENGKULU",4,78,51,129
https://kawalpemilu.org#21881,"PENAGO II, ILIR TALO, SELUMA, BENGKULU",5,108,75,183
https://kawalpemilu.org#21882,"RAWAH INDAH, ILIR TALO, SELUMA, BENGKULU",1,133,117,250
https://kawalpemilu.org#21882,"RAWAH INDAH, ILIR TALO, SELUMA, BENGKULU",2,192,50,242
https://kawalpemilu.org#21882,"RAWAH INDAH, ILIR TALO, SELUMA, BENGKULU",3,160,56,216
https://kawalpemilu.org#21882,"RAWAH INDAH, ILIR TALO, SELUMA, BENGKULU",4,79,15,94
https://kawalpemilu.org#21882,"RAWAH INDAH, ILIR TALO, SELUMA, BENGKULU",5,116,63,179
https://kawalpemilu.org#21883,"PADANG CEKUR, ILIR TALO, SELUMA, BENGKULU",1,66,149,215
https://kawalpemilu.org#21883,"PADANG CEKUR, ILIR TALO, SELUMA, BENGKULU",2,82,78,160
https://kawalpemilu.org#21883,"PADANG CEKUR, ILIR TALO, SELUMA, BENGKULU",3,89,116,205
https://kawalpemilu.org#21884,"PADANG BATU, ILIR TALO, SELUMA, BENGKULU",1,87,128,215
https://kawalpemilu.org#21884,"PADANG BATU, ILIR TALO, SELUMA, BENGKULU",2,80,100,180
https://kawalpemilu.org#88031,"PALUWA TERAP, ILIR TALO, SELUMA, BENGKULU",1,75,80,155
https://kawalpemilu.org#88031,"PALUWA TERAP, ILIR TALO, SELUMA, BENGKULU",2,55,91,146
https://kawalpemilu.org#88032,"MARGO SARI, ILIR TALO, SELUMA, BENGKULU",1,128,59,187
https://kawalpemilu.org#88032,"MARGO SARI, ILIR TALO, SELUMA, BENGKULU",2,112,27,139
https://kawalpemilu.org#88033,"MEKAR SARI, ILIR TALO, SELUMA, BENGKULU",1,90,81,171
https://kawalpemilu.org#88033,"MEKAR SARI, ILIR TALO, SELUMA, BENGKULU",2,71,120,191
https://kawalpemilu.org#88033,"MEKAR SARI, ILIR TALO, SELUMA, BENGKULU",3,80,105,185
https://kawalpemilu.org#21887,"SUKA PINDAH, LUBUK PINANG, MUKOMUKO, BENGKULU",1,58,104,162
https://kawalpemilu.org#21887,"SUKA PINDAH, LUBUK PINANG, MUKOMUKO, BENGKULU",2,69,108,177
https://kawalpemilu.org#21887,"SUKA PINDAH, LUBUK PINANG, MUKOMUKO, BENGKULU",3,103,58,161
https://kawalpemilu.org#21888,"LUBUK PINANG, LUBUK PINANG, MUKOMUKO, BENGKULU",1,72,127,199
https://kawalpemilu.org#21888,"LUBUK PINANG, LUBUK PINANG, MUKOMUKO, BENGKULU",2,91,150,241
https://kawalpemilu.org#21888,"LUBUK PINANG, LUBUK PINANG, MUKOMUKO, BENGKULU",3,91,150,241
https://kawalpemilu.org#21888,"LUBUK PINANG, LUBUK PINANG, MUKOMUKO, BENGKULU",4,60,157,217
https://kawalpemilu.org#21888,"LUBUK PINANG, LUBUK PINANG, MUKOMUKO, BENGKULU",5,47,131,178
https://kawalpemilu.org#21888,"LUBUK PINANG, LUBUK PINANG, MUKOMUKO, BENGKULU",6,41,128,169
https://kawalpemilu.org#21888,"LUBUK PINANG, LUBUK PINANG, MUKOMUKO, BENGKULU",7,39,111,150
https://kawalpemilu.org#21888,"LUBUK PINANG, LUBUK PINANG, MUKOMUKO, BENGKULU",8,55,95,150
https://kawalpemilu.org#21888,"LUBUK PINANG, LUBUK PINANG, MUKOMUKO, BENGKULU",9,65,85,150
https://kawalpemilu.org#21889,"ARAH TIGA, LUBUK PINANG, MUKOMUKO, BENGKULU",1,76,154,230
https://kawalpemilu.org#21889,"ARAH TIGA, LUBUK PINANG, MUKOMUKO, BENGKULU",2,77,185,262
https://kawalpemilu.org#21889,"ARAH TIGA, LUBUK PINANG, MUKOMUKO, BENGKULU",3,61,172,233
https://kawalpemilu.org#21889,"ARAH TIGA, LUBUK PINANG, MUKOMUKO, BENGKULU",4,49,83,132
https://kawalpemilu.org#21889,"ARAH TIGA, LUBUK PINANG, MUKOMUKO, BENGKULU",5,57,74,131
https://kawalpemilu.org#21889,"ARAH TIGA, LUBUK PINANG, MUKOMUKO, BENGKULU",6,64,99,163
https://kawalpemilu.org#21889,"ARAH TIGA, LUBUK PINANG, MUKOMUKO, BENGKULU",7,59,67,126
https://kawalpemilu.org#21890,"LUBUK GEDANG, LUBUK PINANG, MUKOMUKO, BENGKULU",1,86,138,224
https://kawalpemilu.org#21890,"LUBUK GEDANG, LUBUK PINANG, MUKOMUKO, BENGKULU",2,60,134,194
https://kawalpemilu.org#21890,"LUBUK GEDANG, LUBUK PINANG, MUKOMUKO, BENGKULU",3,72,136,208
https://kawalpemilu.org#21890,"LUBUK GEDANG, LUBUK PINANG, MUKOMUKO, BENGKULU",4,88,145,233
https://kawalpemilu.org#21890,"LUBUK GEDANG, LUBUK PINANG, MUKOMUKO, BENGKULU",5,56,126,182
https://kawalpemilu.org#21891,"TANJUNG ALAI, LUBUK PINANG, MUKOMUKO, BENGKULU",1,53,170,223
https://kawalpemilu.org#21891,"TANJUNG ALAI, LUBUK PINANG, MUKOMUKO, BENGKULU",2,85,146,231
https://kawalpemilu.org#21891,"TANJUNG ALAI, LUBUK PINANG, MUKOMUKO, BENGKULU",3,53,135,188
https://kawalpemilu.org#21891,"TANJUNG ALAI, LUBUK PINANG, MUKOMUKO, BENGKULU",4,103,73,176
https://kawalpemilu.org#21892,"SUMBER MAKMUR, LUBUK PINANG, MUKOMUKO, BENGKULU",1,191,28,219
https://kawalpemilu.org#21892,"SUMBER MAKMUR, LUBUK PINANG, MUKOMUKO, BENGKULU",2,212,22,234
https://kawalpemilu.org#21892,"SUMBER MAKMUR, LUBUK PINANG, MUKOMUKO, BENGKULU",3,202,25,227
https://kawalpemilu.org#21892,"SUMBER MAKMUR, LUBUK PINANG, MUKOMUKO, BENGKULU",4,172,39,211
https://kawalpemilu.org#21892,"SUMBER MAKMUR, LUBUK PINANG, MUKOMUKO, BENGKULU",5,187,22,209
https://kawalpemilu.org#21892,"SUMBER MAKMUR, LUBUK PINANG, MUKOMUKO, BENGKULU",6,168,40,208
https://kawalpemilu.org#21892,"SUMBER MAKMUR, LUBUK PINANG, MUKOMUKO, BENGKULU",7,136,54,190
https://kawalpemilu.org#21892,"SUMBER MAKMUR, LUBUK PINANG, MUKOMUKO, BENGKULU",8,136,23,159
https://kawalpemilu.org#21892,"SUMBER MAKMUR, LUBUK PINANG, MUKOMUKO, BENGKULU",9,159,28,187
https://kawalpemilu.org#21892,"SUMBER MAKMUR, LUBUK PINANG, MUKOMUKO, BENGKULU",10,92,6,98
https://kawalpemilu.org#21893,"RANAH KARYA, LUBUK PINANG, MUKOMUKO, BENGKULU",1,70,153,223
https://kawalpemilu.org#21893,"RANAH KARYA, LUBUK PINANG, MUKOMUKO, BENGKULU",2,84,120,204
https://kawalpemilu.org#21893,"RANAH KARYA, LUBUK PINANG, MUKOMUKO, BENGKULU",3,77,112,189
https://kawalpemilu.org#21893,"RANAH KARYA, LUBUK PINANG, MUKOMUKO, BENGKULU",4,63,121,184
https://kawalpemilu.org#21893,"RANAH KARYA, LUBUK PINANG, MUKOMUKO, BENGKULU",5,57,158,215
https://kawalpemilu.org#21895,"PASAR MUKO-MUKO, KOTA MUKOMUKO, MUKOMUKO, BENGKULU",1,41,96,137
https://kawalpemilu.org#21895,"PASAR MUKO-MUKO, KOTA MUKOMUKO, MUKOMUKO, BENGKULU",2,46,140,186
https://kawalpemilu.org#21895,"PASAR MUKO-MUKO, KOTA MUKOMUKO, MUKOMUKO, BENGKULU",3,33,83,116
https://kawalpemilu.org#21895,"PASAR MUKO-MUKO, KOTA MUKOMUKO, MUKOMUKO, BENGKULU",4,58,152,210
https://kawalpemilu.org#21895,"PASAR MUKO-MUKO, KOTA MUKOMUKO, MUKOMUKO, BENGKULU",5,61,193,254
https://kawalpemilu.org#21895,"PASAR MUKO-MUKO, KOTA MUKOMUKO, MUKOMUKO, BENGKULU",6,43,117,160
https://kawalpemilu.org#21895,"PASAR MUKO-MUKO, KOTA MUKOMUKO, MUKOMUKO, BENGKULU",7,74,90,164
https://kawalpemilu.org#21896,"KOTO JAYA, KOTA MUKOMUKO, MUKOMUKO, BENGKULU",1,69,198,267
https://kawalpemilu.org#21896,"KOTO JAYA, KOTA MUKOMUKO, MUKOMUKO, BENGKULU",2,47,211,258
https://kawalpemilu.org#21896,"KOTO JAYA, KOTA MUKOMUKO, MUKOMUKO, BENGKULU",3,67,151,218
https://kawalpemilu.org#21896,"KOTO JAYA, KOTA MUKOMUKO, MUKOMUKO, BENGKULU",4,58,141,199
https://kawalpemilu.org#21896,"KOTO JAYA, KOTA MUKOMUKO, MUKOMUKO, BENGKULU",5,51,100,151
https://kawalpemilu.org#21896,"KOTO JAYA, KOTA MUKOMUKO, MUKOMUKO, BENGKULU",6,43,93,136
https://kawalpemilu.org#21897,"BANDAR RATU, KOTA MUKOMUKO, MUKOMUKO, BENGKULU",1,54,179,233
https://kawalpemilu.org#21897,"BANDAR RATU, KOTA MUKOMUKO, MUKOMUKO, BENGKULU",2,41,161,202
https://kawalpemilu.org#21897,"BANDAR RATU, KOTA MUKOMUKO, MUKOMUKO, BENGKULU",3,70,181,251
https://kawalpemilu.org#21897,"BANDAR RATU, KOTA MUKOMUKO, MUKOMUKO, BENGKULU",4,109,86,195
https://kawalpemilu.org#21897,"BANDAR RATU, KOTA MUKOMUKO, MUKOMUKO, BENGKULU",5,60,27,87
https://kawalpemilu.org#21897,"BANDAR RATU, KOTA MUKOMUKO, MUKOMUKO, BENGKULU",6,69,53,122
https://kawalpemilu.org#21897,"BANDAR RATU, KOTA MUKOMUKO, MUKOMUKO, BENGKULU",7,78,72,150
https://kawalpemilu.org#21897,"BANDAR RATU, KOTA MUKOMUKO, MUKOMUKO, BENGKULU",8,46,126,172
https://kawalpemilu.org#21897,"BANDAR RATU, KOTA MUKOMUKO, MUKOMUKO, BENGKULU",9,47,164,211
https://kawalpemilu.org#21897,"BANDAR RATU, KOTA MUKOMUKO, MUKOMUKO, BENGKULU",10,50,190,240
https://kawalpemilu.org#21897,"BANDAR RATU, KOTA MUKOMUKO, MUKOMUKO, BENGKULU",11,22,120,142
https://kawalpemilu.org#21897,"BANDAR RATU, KOTA MUKOMUKO, MUKOMUKO, BENGKULU",12,50,138,188
https://kawalpemilu.org#21898,"PASAR SEBELAH, KOTA MUKOMUKO, MUKOMUKO, BENGKULU",1,71,137,208
https://kawalpemilu.org#21898,"PASAR SEBELAH, KOTA MUKOMUKO, MUKOMUKO, BENGKULU",2,53,128,181
https://kawalpemilu.org#21898,"PASAR SEBELAH, KOTA MUKOMUKO, MUKOMUKO, BENGKULU",3,132,75,207
https://kawalpemilu.org#21899,"UJUNG PANDANG, KOTA MUKOMUKO, MUKOMUKO, BENGKULU",1,40,126,166
https://kawalpemilu.org#21899,"UJUNG PANDANG, KOTA MUKOMUKO, MUKOMUKO, BENGKULU",2,53,105,158
https://kawalpemilu.org#21899,"UJUNG PANDANG, KOTA MUKOMUKO, MUKOMUKO, BENGKULU",3,40,138,178
https://kawalpemilu.org#21899,"UJUNG PANDANG, KOTA MUKOMUKO, MUKOMUKO, BENGKULU",4,57,144,201
https://kawalpemilu.org#21899,"UJUNG PANDANG, KOTA MUKOMUKO, MUKOMUKO, BENGKULU",5,45,173,218
https://kawalpemilu.org#21899,"UJUNG PANDANG, KOTA MUKOMUKO, MUKOMUKO, BENGKULU",6,44,196,240
https://kawalpemilu.org#21900,"PONDOK BATU, KOTA MUKOMUKO, MUKOMUKO, BENGKULU",1,45,139,184
https://kawalpemilu.org#21900,"PONDOK BATU, KOTA MUKOMUKO, MUKOMUKO, BENGKULU",2,37,147,184
https://kawalpemilu.org#21900,"PONDOK BATU, KOTA MUKOMUKO, MUKOMUKO, BENGKULU",3,55,132,187
https://kawalpemilu.org#21900,"PONDOK BATU, KOTA MUKOMUKO, MUKOMUKO, BENGKULU",4,93,50,143
https://kawalpemilu.org#21900,"PONDOK BATU, KOTA MUKOMUKO, MUKOMUKO, BENGKULU",5,129,14,143
https://kawalpemilu.org#21901,"TANAH REKAH, KOTA MUKOMUKO, MUKOMUKO, BENGKULU",1,29,80,109
https://kawalpemilu.org#21901,"TANAH REKAH, KOTA MUKOMUKO, MUKOMUKO, BENGKULU",2,29,96,125
https://kawalpemilu.org#21901,"TANAH REKAH, KOTA MUKOMUKO, MUKOMUKO, BENGKULU",3,41,205,246
https://kawalpemilu.org#21901,"TANAH REKAH, KOTA MUKOMUKO, MUKOMUKO, BENGKULU",4,71,31,102
https://kawalpemilu.org#21902,"SELAGAN JAYA, KOTA MUKOMUKO, MUKOMUKO, BENGKULU",1,119,19,138
https://kawalpemilu.org#21902,"SELAGAN JAYA, KOTA MUKOMUKO, MUKOMUKO, BENGKULU",2,118,28,146
https://kawalpemilu.org#21902,"SELAGAN JAYA, KOTA MUKOMUKO, MUKOMUKO, BENGKULU",3,107,42,149
https://kawalpemilu.org#21902,"SELAGAN JAYA, KOTA MUKOMUKO, MUKOMUKO, BENGKULU",4,120,48,168
https://kawalpemilu.org#21902,"SELAGAN JAYA, KOTA MUKOMUKO, MUKOMUKO, BENGKULU",5,134,26,160
https://kawalpemilu.org#21902,"SELAGAN JAYA, KOTA MUKOMUKO, MUKOMUKO, BENGKULU",6,132,52,184
https://kawalpemilu.org#21903,"TANAH HARAPAN, KOTA MUKOMUKO, MUKOMUKO, BENGKULU",1,30,178,208
https://kawalpemilu.org#21903,"TANAH HARAPAN, KOTA MUKOMUKO, MUKOMUKO, BENGKULU",2,41,155,196
https://kawalpemilu.org#21903,"TANAH HARAPAN, KOTA MUKOMUKO, MUKOMUKO, BENGKULU",3,154,30,184
https://kawalpemilu.org#21903,"TANAH HARAPAN, KOTA MUKOMUKO, MUKOMUKO, BENGKULU",4,21,170,191
https://kawalpemilu.org#21903,"TANAH HARAPAN, KOTA MUKOMUKO, MUKOMUKO, BENGKULU",5,116,50,166
https://kawalpemilu.org#21903,"TANAH HARAPAN, KOTA MUKOMUKO, MUKOMUKO, BENGKULU",6,119,60,179
https://kawalpemilu.org#21905,"TERAS TERUNJAM, TERAS TERUNJAM, MUKOMUKO, BENGKULU",1,58,120,178
https://kawalpemilu.org#21905,"TERAS TERUNJAM, TERAS TERUNJAM, MUKOMUKO, BENGKULU",2,62,119,181
https://kawalpemilu.org#21906,"PONDOK KOPI, TERAS TERUNJAM, MUKOMUKO, BENGKULU",1,46,197,243
https://kawalpemilu.org#21906,"PONDOK KOPI, TERAS TERUNJAM, MUKOMUKO, BENGKULU",2,58,186,244
https://kawalpemilu.org#21906,"PONDOK KOPI, TERAS TERUNJAM, MUKOMUKO, BENGKULU",3,43,170,213
https://kawalpemilu.org#21907,"SETIA BUDI, TERAS TERUNJAM, MUKOMUKO, BENGKULU",1,163,33,196
https://kawalpemilu.org#21907,"SETIA BUDI, TERAS TERUNJAM, MUKOMUKO, BENGKULU",2,185,42,227
https://kawalpemilu.org#21907,"SETIA BUDI, TERAS TERUNJAM, MUKOMUKO, BENGKULU",3,218,31,249
https://kawalpemilu.org#21907,"SETIA BUDI, TERAS TERUNJAM, MUKOMUKO, BENGKULU",4,177,55,232
https://kawalpemilu.org#21908,"TUNGGAL JAYA, TERAS TERUNJAM, MUKOMUKO, BENGKULU",1,145,79,224
https://kawalpemilu.org#21908,"TUNGGAL JAYA, TERAS TERUNJAM, MUKOMUKO, BENGKULU",2,171,35,206
https://kawalpemilu.org#21908,"TUNGGAL JAYA, TERAS TERUNJAM, MUKOMUKO, BENGKULU",3,104,55,159
https://kawalpemilu.org#21909,"TALANG KUNING, TERAS TERUNJAM, MUKOMUKO, BENGKULU",1,81,162,243
https://kawalpemilu.org#21909,"TALANG KUNING, TERAS TERUNJAM, MUKOMUKO, BENGKULU",2,114,99,213
https://kawalpemilu.org#21909,"TALANG KUNING, TERAS TERUNJAM, MUKOMUKO, BENGKULU",3,171,25,196
https://kawalpemilu.org#21910,"TERUNTUNG, TERAS TERUNJAM, MUKOMUKO, BENGKULU",1,73,178,251
https://kawalpemilu.org#21910,"TERUNTUNG, TERAS TERUNJAM, MUKOMUKO, BENGKULU",2,75,109,184
https://kawalpemilu.org#21910,"TERUNTUNG, TERAS TERUNJAM, MUKOMUKO, BENGKULU",3,95,88,183
https://kawalpemilu.org#21910,"TERUNTUNG, TERAS TERUNJAM, MUKOMUKO, BENGKULU",4,75,48,123
https://kawalpemilu.org#21911,"KARANG JAYA, TERAS TERUNJAM, MUKOMUKO, BENGKULU",1,110,74,184
https://kawalpemilu.org#21911,"KARANG JAYA, TERAS TERUNJAM, MUKOMUKO, BENGKULU",2,142,74,216
https://kawalpemilu.org#21912,"MEKAR JAYA, TERAS TERUNJAM, MUKOMUKO, BENGKULU",1,164,45,209
https://kawalpemilu.org#21912,"MEKAR JAYA, TERAS TERUNJAM, MUKOMUKO, BENGKULU",2,161,48,209
https://kawalpemilu.org#21914,"AIR BIKUK, PONDOK SUGUH, MUKOMUKO, BENGKULU",1,64,109,173
https://kawalpemilu.org#21914,"AIR BIKUK, PONDOK SUGUH, MUKOMUKO, BENGKULU",2,64,142,206
https://kawalpemilu.org#21914,"AIR BIKUK, PONDOK SUGUH, MUKOMUKO, BENGKULU",3,70,133,203
https://kawalpemilu.org#21914,"AIR BIKUK, PONDOK SUGUH, MUKOMUKO, BENGKULU",4,82,169,251
https://kawalpemilu.org#21914,"AIR BIKUK, PONDOK SUGUH, MUKOMUKO, BENGKULU",5,97,24,121
https://kawalpemilu.org#21914,"AIR BIKUK, PONDOK SUGUH, MUKOMUKO, BENGKULU",6,87,32,119
https://kawalpemilu.org#21915,"TUNGGANG, PONDOK SUGUH, MUKOMUKO, BENGKULU",1,141,95,236
https://kawalpemilu.org#21915,"TUNGGANG, PONDOK SUGUH, MUKOMUKO, BENGKULU",2,149,57,206
https://kawalpemilu.org#21915,"TUNGGANG, PONDOK SUGUH, MUKOMUKO, BENGKULU",3,76,53,129
https://kawalpemilu.org#21915,"TUNGGANG, PONDOK SUGUH, MUKOMUKO, BENGKULU",4,134,64,198
https://kawalpemilu.org#21915,"TUNGGANG, PONDOK SUGUH, MUKOMUKO, BENGKULU",5,109,110,219
https://kawalpemilu.org#21915,"TUNGGANG, PONDOK SUGUH, MUKOMUKO, BENGKULU",6,159,105,264
https://kawalpemilu.org#21915,"TUNGGANG, PONDOK SUGUH, MUKOMUKO, BENGKULU",7,93,49,142
https://kawalpemilu.org#21915,"TUNGGANG, PONDOK SUGUH, MUKOMUKO, BENGKULU",8,114,30,144
https://kawalpemilu.org#21916,"PONDOK SUGUH, PONDOK SUGUH, MUKOMUKO, BENGKULU",1,66,131,197
https://kawalpemilu.org#21916,"PONDOK SUGUH, PONDOK SUGUH, MUKOMUKO, BENGKULU",2,60,128,188
https://kawalpemilu.org#21916,"PONDOK SUGUH, PONDOK SUGUH, MUKOMUKO, BENGKULU",3,56,134,190
https://kawalpemilu.org#21916,"PONDOK SUGUH, PONDOK SUGUH, MUKOMUKO, BENGKULU",4,56,131,187
https://kawalpemilu.org#21917,"AIR BERAU, PONDOK SUGUH, MUKOMUKO, BENGKULU",1,53,110,163
https://kawalpemilu.org#21917,"AIR BERAU, PONDOK SUGUH, MUKOMUKO, BENGKULU",2,46,91,137
https://kawalpemilu.org#21917,"AIR BERAU, PONDOK SUGUH, MUKOMUKO, BENGKULU",3,98,39,137
https://kawalpemilu.org#21918,"AIR HITAM, PONDOK SUGUH, MUKOMUKO, BENGKULU",1,106,45,151
https://kawalpemilu.org#21918,"AIR HITAM, PONDOK SUGUH, MUKOMUKO, BENGKULU",2,88,73,161
https://kawalpemilu.org#21918,"AIR HITAM, PONDOK SUGUH, MUKOMUKO, BENGKULU",3,129,71,200
https://kawalpemilu.org#21918,"AIR HITAM, PONDOK SUGUH, MUKOMUKO, BENGKULU",4,96,129,225
https://kawalpemilu.org#21919,"PONDOK KANDANG, PONDOK SUGUH, MUKOMUKO, BENGKULU",1,104,104,208
https://kawalpemilu.org#21919,"PONDOK KANDANG, PONDOK SUGUH, MUKOMUKO, BENGKULU",2,87,107,194
https://kawalpemilu.org#21920,"LUBUK BENTO, PONDOK SUGUH, MUKOMUKO, BENGKULU",1,75,105,180
https://kawalpemilu.org#21920,"LUBUK BENTO, PONDOK SUGUH, MUKOMUKO, BENGKULU",2,78,105,183
https://kawalpemilu.org#21920,"LUBUK BENTO, PONDOK SUGUH, MUKOMUKO, BENGKULU",3,125,96,221
https://kawalpemilu.org#21921,"SINAR LAUT, PONDOK SUGUH, MUKOMUKO, BENGKULU",1,81,62,143
https://kawalpemilu.org#21921,"SINAR LAUT, PONDOK SUGUH, MUKOMUKO, BENGKULU",2,149,26,175
https://kawalpemilu.org#21922,"BUMI MEKAR JAYA, PONDOK SUGUH, MUKOMUKO, BENGKULU",1,145,88,233
https://kawalpemilu.org#21922,"BUMI MEKAR JAYA, PONDOK SUGUH, MUKOMUKO, BENGKULU",2,114,99,213
https://kawalpemilu.org#21922,"BUMI MEKAR JAYA, PONDOK SUGUH, MUKOMUKO, BENGKULU",3,111,81,192
https://kawalpemilu.org#21922,"BUMI MEKAR JAYA, PONDOK SUGUH, MUKOMUKO, BENGKULU",4,88,140,228
https://kawalpemilu.org#21922,"BUMI MEKAR JAYA, PONDOK SUGUH, MUKOMUKO, BENGKULU",5,148,52,200
https://kawalpemilu.org#21923,"KARYA MULYA, PONDOK SUGUH, MUKOMUKO, BENGKULU",1,118,123,241
https://kawalpemilu.org#21923,"KARYA MULYA, PONDOK SUGUH, MUKOMUKO, BENGKULU",2,143,87,230
https://kawalpemilu.org#21923,"KARYA MULYA, PONDOK SUGUH, MUKOMUKO, BENGKULU",3,87,60,147
https://kawalpemilu.org#21924,"TELUK BAKUNG, PONDOK SUGUH, MUKOMUKO, BENGKULU",1,174,15,189
https://kawalpemilu.org#21926,"AIR BULUH, IPUH, MUKOMUKO, BENGKULU",1,52,147,199
https://kawalpemilu.org#21926,"AIR BULUH, IPUH, MUKOMUKO, BENGKULU",2,40,138,178
https://kawalpemilu.org#21926,"AIR BULUH, IPUH, MUKOMUKO, BENGKULU",3,51,171,222
https://kawalpemilu.org#21926,"AIR BULUH, IPUH, MUKOMUKO, BENGKULU",4,52,26,78
https://kawalpemilu.org#21926,"AIR BULUH, IPUH, MUKOMUKO, BENGKULU",5,60,37,97
https://kawalpemilu.org#21927,"PULAU BARU, IPUH, MUKOMUKO, BENGKULU",1,106,102,208
https://kawalpemilu.org#21927,"PULAU BARU, IPUH, MUKOMUKO, BENGKULU",2,80,107,187
https://kawalpemilu.org#21927,"PULAU BARU, IPUH, MUKOMUKO, BENGKULU",3,75,97,172
https://kawalpemilu.org#21928,"PASAR IPUH, IPUH, MUKOMUKO, BENGKULU",1,68,132,200
https://kawalpemilu.org#21928,"PASAR IPUH, IPUH, MUKOMUKO, BENGKULU",2,55,122,177
https://kawalpemilu.org#21929,"MEDAN JAYA, IPUH, MUKOMUKO, BENGKULU",1,68,153,221
https://kawalpemilu.org#21929,"MEDAN JAYA, IPUH, MUKOMUKO, BENGKULU",2,62,120,182
https://kawalpemilu.org#21929,"MEDAN JAYA, IPUH, MUKOMUKO, BENGKULU",3,48,170,218
https://kawalpemilu.org#21929,"MEDAN JAYA, IPUH, MUKOMUKO, BENGKULU",4,57,104,161
https://kawalpemilu.org#21929,"MEDAN JAYA, IPUH, MUKOMUKO, BENGKULU",5,37,123,160
https://kawalpemilu.org#21929,"MEDAN JAYA, IPUH, MUKOMUKO, BENGKULU",6,43,141,184
https://kawalpemilu.org#21930,"SIBAK, IPUH, MUKOMUKO, BENGKULU",1,35,188,223
https://kawalpemilu.org#21930,"SIBAK, IPUH, MUKOMUKO, BENGKULU",2,50,185,235
https://kawalpemilu.org#21930,"SIBAK, IPUH, MUKOMUKO, BENGKULU",3,38,187,225
https://kawalpemilu.org#21930,"SIBAK, IPUH, MUKOMUKO, BENGKULU",4,40,186,226
https://kawalpemilu.org#21930,"SIBAK, IPUH, MUKOMUKO, BENGKULU",5,32,96,128
https://kawalpemilu.org#21930,"SIBAK, IPUH, MUKOMUKO, BENGKULU",6,45,89,134
https://kawalpemilu.org#21930,"SIBAK, IPUH, MUKOMUKO, BENGKULU",7,23,83,106
https://kawalpemilu.org#21930,"SIBAK, IPUH, MUKOMUKO, BENGKULU",8,37,84,121
https://kawalpemilu.org#21930,"SIBAK, IPUH, MUKOMUKO, BENGKULU",9,32,36,68
https://kawalpemilu.org#21930,"SIBAK, IPUH, MUKOMUKO, BENGKULU",10,63,59,122
https://kawalpemilu.org#21930,"SIBAK, IPUH, MUKOMUKO, BENGKULU",11,41,38,79
https://kawalpemilu.org#21931,"SEMUNDAM, IPUH, MUKOMUKO, BENGKULU",1,72,155,227
https://kawalpemilu.org#21931,"SEMUNDAM, IPUH, MUKOMUKO, BENGKULU",2,47,137,184
https://kawalpemilu.org#21931,"SEMUNDAM, IPUH, MUKOMUKO, BENGKULU",3,90,121,211
https://kawalpemilu.org#21932,"RETAK ILIR, IPUH, MUKOMUKO, BENGKULU",1,66,197,263
https://kawalpemilu.org#21932,"RETAK ILIR, IPUH, MUKOMUKO, BENGKULU",2,132,67,199
https://kawalpemilu.org#21933,"TANJUNG HARAPAN, IPUH, MUKOMUKO, BENGKULU",1,49,180,229
https://kawalpemilu.org#21933,"TANJUNG HARAPAN, IPUH, MUKOMUKO, BENGKULU",2,28,161,189
https://kawalpemilu.org#21933,"TANJUNG HARAPAN, IPUH, MUKOMUKO, BENGKULU",3,44,167,211
https://kawalpemilu.org#21933,"TANJUNG HARAPAN, IPUH, MUKOMUKO, BENGKULU",4,28,169,197
https://kawalpemilu.org#21934,"TANJUNG JAYA, IPUH, MUKOMUKO, BENGKULU",1,142,129,271
https://kawalpemilu.org#21934,"TANJUNG JAYA, IPUH, MUKOMUKO, BENGKULU",2,169,93,262
https://kawalpemilu.org#21934,"TANJUNG JAYA, IPUH, MUKOMUKO, BENGKULU",3,154,103,257
https://kawalpemilu.org#21935,"MANUNGGAL JAYA, IPUH, MUKOMUKO, BENGKULU",1,84,87,171
https://kawalpemilu.org#21935,"MANUNGGAL JAYA, IPUH, MUKOMUKO, BENGKULU",2,104,36,140
https://kawalpemilu.org#21935,"MANUNGGAL JAYA, IPUH, MUKOMUKO, BENGKULU",3,93,61,154
https://kawalpemilu.org#21936,"PULAI PAYUNG, IPUH, MUKOMUKO, BENGKULU",1,35,123,158
https://kawalpemilu.org#21936,"PULAI PAYUNG, IPUH, MUKOMUKO, BENGKULU",2,71,157,228
https://kawalpemilu.org#21936,"PULAI PAYUNG, IPUH, MUKOMUKO, BENGKULU",3,68,160,228
https://kawalpemilu.org#21936,"PULAI PAYUNG, IPUH, MUKOMUKO, BENGKULU",4,62,112,174
https://kawalpemilu.org#21936,"PULAI PAYUNG, IPUH, MUKOMUKO, BENGKULU",5,128,93,221
https://kawalpemilu.org#21937,"TANJUNG MEDAN, IPUH, MUKOMUKO, BENGKULU",1,108,56,164
https://kawalpemilu.org#21938,"TIRTA MULYA, IPUH, MUKOMUKO, BENGKULU",1,176,75,251
https://kawalpemilu.org#21938,"TIRTA MULYA, IPUH, MUKOMUKO, BENGKULU",2,170,84,254
https://kawalpemilu.org#21939,"PASAR BARU, IPUH, MUKOMUKO, BENGKULU",1,40,170,210
https://kawalpemilu.org#21939,"PASAR BARU, IPUH, MUKOMUKO, BENGKULU",2,59,109,168
https://kawalpemilu.org#21940,"PULAU MAKMUR, IPUH, MUKOMUKO, BENGKULU",1,85,97,182
https://kawalpemilu.org#21940,"PULAU MAKMUR, IPUH, MUKOMUKO, BENGKULU",2,56,135,191
https://kawalpemilu.org#21941,"MUNDAM MARAP, IPUH, MUKOMUKO, BENGKULU",1,37,118,155
https://kawalpemilu.org#21941,"MUNDAM MARAP, IPUH, MUKOMUKO, BENGKULU",2,80,116,196
https://kawalpemilu.org#21943,"TALANG ARAH, MALIN DEMAN, MUKOMUKO, BENGKULU",1,41,137,178
https://kawalpemilu.org#21943,"TALANG ARAH, MALIN DEMAN, MUKOMUKO, BENGKULU",2,49,156,205
https://kawalpemilu.org#21943,"TALANG ARAH, MALIN DEMAN, MUKOMUKO, BENGKULU",3,45,173,218
https://kawalpemilu.org#21944,"SERAMI BARU, MALIN DEMAN, MUKOMUKO, BENGKULU",1,31,101,132
https://kawalpemilu.org#21944,"SERAMI BARU, MALIN DEMAN, MUKOMUKO, BENGKULU",2,60,104,164
https://kawalpemilu.org#21944,"SERAMI BARU, MALIN DEMAN, MUKOMUKO, BENGKULU",3,41,24,65
https://kawalpemilu.org#21945,"LUBUK TALANG, MALIN DEMAN, MUKOMUKO, BENGKULU",1,29,166,195
https://kawalpemilu.org#21945,"LUBUK TALANG, MALIN DEMAN, MUKOMUKO, BENGKULU",2,61,122,183
https://kawalpemilu.org#21945,"LUBUK TALANG, MALIN DEMAN, MUKOMUKO, BENGKULU",3,34,41,75
https://kawalpemilu.org#21945,"LUBUK TALANG, MALIN DEMAN, MUKOMUKO, BENGKULU",5,59,28,87
https://kawalpemilu.org#21945,"LUBUK TALANG, MALIN DEMAN, MUKOMUKO, BENGKULU",6,73,43,116
https://kawalpemilu.org#21946,"GAJAH MAKMUR, MALIN DEMAN, MUKOMUKO, BENGKULU",1,115,30,145
https://kawalpemilu.org#21946,"GAJAH MAKMUR, MALIN DEMAN, MUKOMUKO, BENGKULU",3,192,27,219
https://kawalpemilu.org#21946,"GAJAH MAKMUR, MALIN DEMAN, MUKOMUKO, BENGKULU",4,50,51,101
https://kawalpemilu.org#21946,"GAJAH MAKMUR, MALIN DEMAN, MUKOMUKO, BENGKULU",5,43,12,55
https://kawalpemilu.org#21946,"GAJAH MAKMUR, MALIN DEMAN, MUKOMUKO, BENGKULU",6,32,12,44
https://kawalpemilu.org#21946,"GAJAH MAKMUR, MALIN DEMAN, MUKOMUKO, BENGKULU",7,75,54,129
https://kawalpemilu.org#21947,"SEMAMBANG MAKMUR, MALIN DEMAN, MUKOMUKO, BENGKULU",1,96,65,161
https://kawalpemilu.org#21948,"TALANG BARU, MALIN DEMAN, MUKOMUKO, BENGKULU",1,77,164,241
https://kawalpemilu.org#21948,"TALANG BARU, MALIN DEMAN, MUKOMUKO, BENGKULU",2,51,184,235
https://kawalpemilu.org#21948,"TALANG BARU, MALIN DEMAN, MUKOMUKO, BENGKULU",3,47,202,249
https://kawalpemilu.org#21949,"AIR MERAH, MALIN DEMAN, MUKOMUKO, BENGKULU",1,40,143,183
https://kawalpemilu.org#21949,"AIR MERAH, MALIN DEMAN, MUKOMUKO, BENGKULU",2,36,122,158
https://kawalpemilu.org#21949,"AIR MERAH, MALIN DEMAN, MUKOMUKO, BENGKULU",3,35,184,219
https://kawalpemilu.org#21951,"ARGA JAYA, AIR RAMI, MUKOMUKO, BENGKULU",1,141,80,221
https://kawalpemilu.org#21951,"ARGA JAYA, AIR RAMI, MUKOMUKO, BENGKULU",2,146,69,215
https://kawalpemilu.org#21951,"ARGA JAYA, AIR RAMI, MUKOMUKO, BENGKULU",3,85,113,198
https://kawalpemilu.org#21951,"ARGA JAYA, AIR RAMI, MUKOMUKO, BENGKULU",4,102,121,223
https://kawalpemilu.org#21951,"ARGA JAYA, AIR RAMI, MUKOMUKO, BENGKULU",5,119,118,237
https://kawalpemilu.org#21951,"ARGA JAYA, AIR RAMI, MUKOMUKO, BENGKULU",6,133,65,198
https://kawalpemilu.org#21952,"AIR RAMI, AIR RAMI, MUKOMUKO, BENGKULU",1,73,139,212
https://kawalpemilu.org#21952,"AIR RAMI, AIR RAMI, MUKOMUKO, BENGKULU",2,81,140,221
https://kawalpemilu.org#21952,"AIR RAMI, AIR RAMI, MUKOMUKO, BENGKULU",3,99,146,245
https://kawalpemilu.org#21953,"RAMI MULIA, AIR RAMI, MUKOMUKO, BENGKULU",1,154,35,189
https://kawalpemilu.org#21953,"RAMI MULIA, AIR RAMI, MUKOMUKO, BENGKULU",2,88,129,217
https://kawalpemilu.org#21953,"RAMI MULIA, AIR RAMI, MUKOMUKO, BENGKULU",3,66,74,140
https://kawalpemilu.org#21953,"RAMI MULIA, AIR RAMI, MUKOMUKO, BENGKULU",4,205,42,247
https://kawalpemilu.org#21954,"TALANG RIO, AIR RAMI, MUKOMUKO, BENGKULU",1,24,160,184
https://kawalpemilu.org#21954,"TALANG RIO, AIR RAMI, MUKOMUKO, BENGKULU",2,11,200,211
https://kawalpemilu.org#21955,"MAKMUR JAYA, AIR RAMI, MUKOMUKO, BENGKULU",1,160,70,230
https://kawalpemilu.org#21955,"MAKMUR JAYA, AIR RAMI, MUKOMUKO, BENGKULU",2,158,58,216
https://kawalpemilu.org#21956,"MARGA MULIA, AIR RAMI, MUKOMUKO, BENGKULU",1,128,127,255
https://kawalpemilu.org#21956,"MARGA MULIA, AIR RAMI, MUKOMUKO, BENGKULU",2,132,117,249
https://kawalpemilu.org#21956,"MARGA MULIA, AIR RAMI, MUKOMUKO, BENGKULU",3,85,166,251
https://kawalpemilu.org#21957,"MEKAR JAYA, AIR RAMI, MUKOMUKO, BENGKULU",1,136,103,239
https://kawalpemilu.org#21957,"MEKAR JAYA, AIR RAMI, MUKOMUKO, BENGKULU",2,124,116,240
https://kawalpemilu.org#21957,"MEKAR JAYA, AIR RAMI, MUKOMUKO, BENGKULU",3,135,81,216
https://kawalpemilu.org#21958,"DUSUN PULAU, AIR RAMI, MUKOMUKO, BENGKULU",1,54,156,210
https://kawalpemilu.org#21958,"DUSUN PULAU, AIR RAMI, MUKOMUKO, BENGKULU",2,60,187,247
https://kawalpemilu.org#21958,"DUSUN PULAU, AIR RAMI, MUKOMUKO, BENGKULU",3,109,113,222
https://kawalpemilu.org#21959,"BUKIT HARAPAN, AIR RAMI, MUKOMUKO, BENGKULU",1,122,62,184
https://kawalpemilu.org#21959,"BUKIT HARAPAN, AIR RAMI, MUKOMUKO, BENGKULU",2,100,75,175
https://kawalpemilu.org#21959,"BUKIT HARAPAN, AIR RAMI, MUKOMUKO, BENGKULU",3,94,75,169
https://kawalpemilu.org#21960,"TIRTA KENCANA, AIR RAMI, MUKOMUKO, BENGKULU",1,121,62,183
https://kawalpemilu.org#21960,"TIRTA KENCANA, AIR RAMI, MUKOMUKO, BENGKULU",2,132,61,193
https://kawalpemilu.org#21960,"TIRTA KENCANA, AIR RAMI, MUKOMUKO, BENGKULU",3,125,66,191
https://kawalpemilu.org#21961,"BUKIT MULYA, AIR RAMI, MUKOMUKO, BENGKULU",1,127,50,177
https://kawalpemilu.org#21961,"BUKIT MULYA, AIR RAMI, MUKOMUKO, BENGKULU",2,152,29,181
https://kawalpemilu.org#21961,"BUKIT MULYA, AIR RAMI, MUKOMUKO, BENGKULU",3,135,30,165
https://kawalpemilu.org#21962,"CINTA ASIH, AIR RAMI, MUKOMUKO, BENGKULU",1,98,75,173
https://kawalpemilu.org#21962,"CINTA ASIH, AIR RAMI, MUKOMUKO, BENGKULU",2,131,86,217
https://kawalpemilu.org#21964,"PASAR BANTAL, TERAMANG JAYA, MUKOMUKO, BENGKULU",1,57,57,114
https://kawalpemilu.org#21964,"PASAR BANTAL, TERAMANG JAYA, MUKOMUKO, BENGKULU",2,76,150,226
https://kawalpemilu.org#21964,"PASAR BANTAL, TERAMANG JAYA, MUKOMUKO, BENGKULU",3,71,130,201
https://kawalpemilu.org#21964,"PASAR BANTAL, TERAMANG JAYA, MUKOMUKO, BENGKULU",4,63,157,220
https://kawalpemilu.org#21965,"NENGGALO, TERAMANG JAYA, MUKOMUKO, BENGKULU",1,26,71,97
https://kawalpemilu.org#21965,"NENGGALO, TERAMANG JAYA, MUKOMUKO, BENGKULU",2,62,111,173
https://kawalpemilu.org#21966,"PONDOK BARU, TERAMANG JAYA, MUKOMUKO, BENGKULU",1,82,125,207
https://kawalpemilu.org#21966,"PONDOK BARU, TERAMANG JAYA, MUKOMUKO, BENGKULU",2,85,151,236
https://kawalpemilu.org#21967,"BUNGA TANJUNG, TERAMANG JAYA, MUKOMUKO, BENGKULU",1,93,92,185
https://kawalpemilu.org#21967,"BUNGA TANJUNG, TERAMANG JAYA, MUKOMUKO, BENGKULU",2,136,76,212
https://kawalpemilu.org#21967,"BUNGA TANJUNG, TERAMANG JAYA, MUKOMUKO, BENGKULU",3,92,115,207
https://kawalpemilu.org#21967,"BUNGA TANJUNG, TERAMANG JAYA, MUKOMUKO, BENGKULU",4,81,63,144
https://kawalpemilu.org#21967,"BUNGA TANJUNG, TERAMANG JAYA, MUKOMUKO, BENGKULU",5,122,57,179
https://kawalpemilu.org#21967,"BUNGA TANJUNG, TERAMANG JAYA, MUKOMUKO, BENGKULU",6,127,53,180
https://kawalpemilu.org#21968,"BANDAR JAYA, TERAMANG JAYA, MUKOMUKO, BENGKULU",1,174,77,251
https://kawalpemilu.org#21968,"BANDAR JAYA, TERAMANG JAYA, MUKOMUKO, BENGKULU",2,208,35,243
https://kawalpemilu.org#21968,"BANDAR JAYA, TERAMANG JAYA, MUKOMUKO, BENGKULU",3,214,32,246
https://kawalpemilu.org#21968,"BANDAR JAYA, TERAMANG JAYA, MUKOMUKO, BENGKULU",4,121,23,144
https://kawalpemilu.org#21969,"TERAMANG JAYA, TERAMANG JAYA, MUKOMUKO, BENGKULU",1,176,28,204
https://kawalpemilu.org#21970,"BRANGAN MULYA, TERAMANG JAYA, MUKOMUKO, BENGKULU",1,60,121,181
https://kawalpemilu.org#21970,"BRANGAN MULYA, TERAMANG JAYA, MUKOMUKO, BENGKULU",2,43,70,113
https://kawalpemilu.org#21972,"LUBUK SELANDAK, TERAMANG JAYA, MUKOMUKO, BENGKULU",1,220,18,238
https://kawalpemilu.org#21972,"LUBUK SELANDAK, TERAMANG JAYA, MUKOMUKO, BENGKULU",2,59,17,76
https://kawalpemilu.org#21973,"NELAN INDAH, TERAMANG JAYA, MUKOMUKO, BENGKULU",1,74,107,181
https://kawalpemilu.org#21973,"NELAN INDAH, TERAMANG JAYA, MUKOMUKO, BENGKULU",2,70,107,177
https://kawalpemilu.org#21973,"NELAN INDAH, TERAMANG JAYA, MUKOMUKO, BENGKULU",3,60,92,152
https://kawalpemilu.org#21974,"MANDI ANGIN JAYA, TERAMANG JAYA, MUKOMUKO, BENGKULU",1,68,106,174
https://kawalpemilu.org#21974,"MANDI ANGIN JAYA, TERAMANG JAYA, MUKOMUKO, BENGKULU",2,63,112,175
https://kawalpemilu.org#21974,"MANDI ANGIN JAYA, TERAMANG JAYA, MUKOMUKO, BENGKULU",3,67,108,175
https://kawalpemilu.org#21975,"BATU EJUNG, TERAMANG JAYA, MUKOMUKO, BENGKULU",1,104,84,188
https://kawalpemilu.org#21975,"BATU EJUNG, TERAMANG JAYA, MUKOMUKO, BENGKULU",2,80,100,180
https://kawalpemilu.org#21975,"BATU EJUNG, TERAMANG JAYA, MUKOMUKO, BENGKULU",3,74,137,211
https://kawalpemilu.org#21976,"PERNYAH, TERAMANG JAYA, MUKOMUKO, BENGKULU",1,64,178,242
https://kawalpemilu.org#21976,"PERNYAH, TERAMANG JAYA, MUKOMUKO, BENGKULU",2,74,169,243
https://kawalpemilu.org#927465,"SIDO MAKMUR, TERAMANG JAYA, MUKOMUKO, BENGKULU",1,158,32,190
https://kawalpemilu.org#927465,"SIDO MAKMUR, TERAMANG JAYA, MUKOMUKO, BENGKULU",3,204,44,248
https://kawalpemilu.org#21978,"SUNGAI IPUH, SELAGAN RAYA, MUKOMUKO, BENGKULU",1,97,138,235
https://kawalpemilu.org#21978,"SUNGAI IPUH, SELAGAN RAYA, MUKOMUKO, BENGKULU",2,69,97,166
https://kawalpemilu.org#21979,"LUBUK SAHUNG, SELAGAN RAYA, MUKOMUKO, BENGKULU",1,69,128,197
https://kawalpemilu.org#21979,"LUBUK SAHUNG, SELAGAN RAYA, MUKOMUKO, BENGKULU",2,60,143,203
https://kawalpemilu.org#21980,"SURIAN BUNGKAL, SELAGAN RAYA, MUKOMUKO, BENGKULU",1,19,120,139
https://kawalpemilu.org#21980,"SURIAN BUNGKAL, SELAGAN RAYA, MUKOMUKO, BENGKULU",2,42,175,217
https://kawalpemilu.org#21981,"SUNGAI GADING, SELAGAN RAYA, MUKOMUKO, BENGKULU",1,17,163,180
https://kawalpemilu.org#21981,"SUNGAI GADING, SELAGAN RAYA, MUKOMUKO, BENGKULU",2,35,146,181
https://kawalpemilu.org#21981,"SUNGAI GADING, SELAGAN RAYA, MUKOMUKO, BENGKULU",3,23,133,156
https://kawalpemilu.org#21981,"SUNGAI GADING, SELAGAN RAYA, MUKOMUKO, BENGKULU",4,31,159,190
https://kawalpemilu.org#21982,"PONDOK BARU, SELAGAN RAYA, MUKOMUKO, BENGKULU",1,48,125,173
https://kawalpemilu.org#21982,"PONDOK BARU, SELAGAN RAYA, MUKOMUKO, BENGKULU",2,47,145,192
https://kawalpemilu.org#21983,"SUNGAI JERINJING, SELAGAN RAYA, MUKOMUKO, BENGKULU",1,32,158,190
https://kawalpemilu.org#21983,"SUNGAI JERINJING, SELAGAN RAYA, MUKOMUKO, BENGKULU",2,26,103,129
https://kawalpemilu.org#927476,"LUBUK BANGKO, SELAGAN RAYA, MUKOMUKO, BENGKULU",1,45,124,169
https://kawalpemilu.org#927476,"LUBUK BANGKO, SELAGAN RAYA, MUKOMUKO, BENGKULU",2,32,154,186
https://kawalpemilu.org#927476,"LUBUK BANGKO, SELAGAN RAYA, MUKOMUKO, BENGKULU",3,53,127,180
https://kawalpemilu.org#927476,"LUBUK BANGKO, SELAGAN RAYA, MUKOMUKO, BENGKULU",4,38,149,187
https://kawalpemilu.org#927478,"TALANG BUAI, SELAGAN RAYA, MUKOMUKO, BENGKULU",1,18,145,163
https://kawalpemilu.org#927478,"TALANG BUAI, SELAGAN RAYA, MUKOMUKO, BENGKULU",2,16,149,165
https://kawalpemilu.org#927478,"TALANG BUAI, SELAGAN RAYA, MUKOMUKO, BENGKULU",3,26,193,219
https://kawalpemilu.org#927478,"TALANG BUAI, SELAGAN RAYA, MUKOMUKO, BENGKULU",4,22,172,194
https://kawalpemilu.org#927482,"AUR CINA, SELAGAN RAYA, MUKOMUKO, BENGKULU",1,60,117,177
https://kawalpemilu.org#927482,"AUR CINA, SELAGAN RAYA, MUKOMUKO, BENGKULU",2,49,128,177
https://kawalpemilu.org#927483,"TALANG MEDAN, SELAGAN RAYA, MUKOMUKO, BENGKULU",1,47,151,198
https://kawalpemilu.org#927483,"TALANG MEDAN, SELAGAN RAYA, MUKOMUKO, BENGKULU",2,101,121,222
https://kawalpemilu.org#927483,"TALANG MEDAN, SELAGAN RAYA, MUKOMUKO, BENGKULU",3,59,68,127
https://kawalpemilu.org#927483,"TALANG MEDAN, SELAGAN RAYA, MUKOMUKO, BENGKULU",4,118,61,179
https://kawalpemilu.org#927484,"SUNGAI IPUH SATU, SELAGAN RAYA, MUKOMUKO, BENGKULU",1,71,124,195
https://kawalpemilu.org#927485,"SUNGAI IPUH DUA, SELAGAN RAYA, MUKOMUKO, BENGKULU",1,53,70,123
https://kawalpemilu.org#927485,"SUNGAI IPUH DUA, SELAGAN RAYA, MUKOMUKO, BENGKULU",2,52,106,158
https://kawalpemilu.org#927485,"SUNGAI IPUH DUA, SELAGAN RAYA, MUKOMUKO, BENGKULU",3,49,109,158
https://kawalpemilu.org#21991,"PENARIK, PENARIK, MUKOMUKO, BENGKULU",1,90,96,186
https://kawalpemilu.org#21991,"PENARIK, PENARIK, MUKOMUKO, BENGKULU",2,96,147,243
https://kawalpemilu.org#21991,"PENARIK, PENARIK, MUKOMUKO, BENGKULU",3,102,110,212
https://kawalpemilu.org#21991,"PENARIK, PENARIK, MUKOMUKO, BENGKULU",4,47,128,175
https://kawalpemilu.org#21991,"PENARIK, PENARIK, MUKOMUKO, BENGKULU",5,86,151,237
https://kawalpemilu.org#21991,"PENARIK, PENARIK, MUKOMUKO, BENGKULU",6,149,60,209
https://kawalpemilu.org#21991,"PENARIK, PENARIK, MUKOMUKO, BENGKULU",7,213,32,245
https://kawalpemilu.org#21991,"PENARIK, PENARIK, MUKOMUKO, BENGKULU",8,134,21,155
https://kawalpemilu.org#21991,"PENARIK, PENARIK, MUKOMUKO, BENGKULU",9,151,78,229
https://kawalpemilu.org#21991,"PENARIK, PENARIK, MUKOMUKO, BENGKULU",10,145,79,224
https://kawalpemilu.org#21991,"PENARIK, PENARIK, MUKOMUKO, BENGKULU",11,77,111,188
https://kawalpemilu.org#21992,"LUBUK MUKTI, PENARIK, MUKOMUKO, BENGKULU",1,189,50,239
https://kawalpemilu.org#21992,"LUBUK MUKTI, PENARIK, MUKOMUKO, BENGKULU",2,169,53,222
https://kawalpemilu.org#21992,"LUBUK MUKTI, PENARIK, MUKOMUKO, BENGKULU",3,146,46,192
https://kawalpemilu.org#21992,"LUBUK MUKTI, PENARIK, MUKOMUKO, BENGKULU",4,178,14,192
https://kawalpemilu.org#21992,"LUBUK MUKTI, PENARIK, MUKOMUKO, BENGKULU",5,220,10,230
https://kawalpemilu.org#21992,"LUBUK MUKTI, PENARIK, MUKOMUKO, BENGKULU",6,130,38,168
https://kawalpemilu.org#21992,"LUBUK MUKTI, PENARIK, MUKOMUKO, BENGKULU",7,108,82,190
https://kawalpemilu.org#21993,"BUMI MULYA, PENARIK, MUKOMUKO, BENGKULU",1,142,23,165
https://kawalpemilu.org#21993,"BUMI MULYA, PENARIK, MUKOMUKO, BENGKULU",2,120,51,171
https://kawalpemilu.org#21993,"BUMI MULYA, PENARIK, MUKOMUKO, BENGKULU",3,127,58,185
https://kawalpemilu.org#21993,"BUMI MULYA, PENARIK, MUKOMUKO, BENGKULU",4,111,87,198
https://kawalpemilu.org#21993,"BUMI MULYA, PENARIK, MUKOMUKO, BENGKULU",5,186,65,251
https://kawalpemilu.org#21993,"BUMI MULYA, PENARIK, MUKOMUKO, BENGKULU",6,116,51,167
https://kawalpemilu.org#21993,"BUMI MULYA, PENARIK, MUKOMUKO, BENGKULU",7,189,44,233
https://kawalpemilu.org#21994,"SUKA MAJU, PENARIK, MUKOMUKO, BENGKULU",1,130,87,217
https://kawalpemilu.org#21994,"SUKA MAJU, PENARIK, MUKOMUKO, BENGKULU",2,144,57,201
https://kawalpemilu.org#21994,"SUKA MAJU, PENARIK, MUKOMUKO, BENGKULU",3,161,45,206
https://kawalpemilu.org#21994,"SUKA MAJU, PENARIK, MUKOMUKO, BENGKULU",4,175,18,193
https://kawalpemilu.org#21994,"SUKA MAJU, PENARIK, MUKOMUKO, BENGKULU",5,118,66,184
https://kawalpemilu.org#21995,"BUKIT MAKMUR, PENARIK, MUKOMUKO, BENGKULU",1,138,49,187
https://kawalpemilu.org#21995,"BUKIT MAKMUR, PENARIK, MUKOMUKO, BENGKULU",2,109,67,176
https://kawalpemilu.org#21995,"BUKIT MAKMUR, PENARIK, MUKOMUKO, BENGKULU",3,171,25,196
https://kawalpemilu.org#21996,"SUMBER MULYA, PENARIK, MUKOMUKO, BENGKULU",1,183,13,196
https://kawalpemilu.org#21996,"SUMBER MULYA, PENARIK, MUKOMUKO, BENGKULU",2,186,50,236
https://kawalpemilu.org#21996,"SUMBER MULYA, PENARIK, MUKOMUKO, BENGKULU",3,169,58,227
https://kawalpemilu.org#21997,"SIDODADI, PENARIK, MUKOMUKO, BENGKULU",1,175,74,249
https://kawalpemilu.org#21997,"SIDODADI, PENARIK, MUKOMUKO, BENGKULU",2,168,62,230
https://kawalpemilu.org#21997,"SIDODADI, PENARIK, MUKOMUKO, BENGKULU",3,99,72,171
https://kawalpemilu.org#21997,"SIDODADI, PENARIK, MUKOMUKO, BENGKULU",4,77,92,169
https://kawalpemilu.org#21997,"SIDODADI, PENARIK, MUKOMUKO, BENGKULU",5,121,75,196
https://kawalpemilu.org#21998,"MAJU MAKMUR, PENARIK, MUKOMUKO, BENGKULU",1,149,36,185
https://kawalpemilu.org#21998,"MAJU MAKMUR, PENARIK, MUKOMUKO, BENGKULU",2,179,49,228
https://kawalpemilu.org#21998,"MAJU MAKMUR, PENARIK, MUKOMUKO, BENGKULU",3,126,43,169
https://kawalpemilu.org#21999,"SENDANG MULYO, PENARIK, MUKOMUKO, BENGKULU",1,123,14,137
https://kawalpemilu.org#21999,"SENDANG MULYO, PENARIK, MUKOMUKO, BENGKULU",2,114,9,123
https://kawalpemilu.org#22000,"MARGA MULYA SAKTI, PENARIK, MUKOMUKO, BENGKULU",1,205,38,243
https://kawalpemilu.org#22000,"MARGA MULYA SAKTI, PENARIK, MUKOMUKO, BENGKULU",2,203,21,224
https://kawalpemilu.org#22000,"MARGA MULYA SAKTI, PENARIK, MUKOMUKO, BENGKULU",3,147,67,214
https://kawalpemilu.org#927477,"WONOSOBO, PENARIK, MUKOMUKO, BENGKULU",1,165,33,198
https://kawalpemilu.org#927477,"WONOSOBO, PENARIK, MUKOMUKO, BENGKULU",2,194,22,216
https://kawalpemilu.org#927477,"WONOSOBO, PENARIK, MUKOMUKO, BENGKULU",3,185,26,211
https://kawalpemilu.org#927477,"WONOSOBO, PENARIK, MUKOMUKO, BENGKULU",4,189,26,215
https://kawalpemilu.org#927477,"WONOSOBO, PENARIK, MUKOMUKO, BENGKULU",5,220,21,241
https://kawalpemilu.org#927477,"WONOSOBO, PENARIK, MUKOMUKO, BENGKULU",6,166,37,203
https://kawalpemilu.org#927479,"MEKAR MULYA, PENARIK, MUKOMUKO, BENGKULU",1,142,88,230
https://kawalpemilu.org#927479,"MEKAR MULYA, PENARIK, MUKOMUKO, BENGKULU",2,158,61,219
https://kawalpemilu.org#927479,"MEKAR MULYA, PENARIK, MUKOMUKO, BENGKULU",3,141,35,176
https://kawalpemilu.org#927479,"MEKAR MULYA, PENARIK, MUKOMUKO, BENGKULU",4,145,17,162
https://kawalpemilu.org#927479,"MEKAR MULYA, PENARIK, MUKOMUKO, BENGKULU",5,189,67,256
https://kawalpemilu.org#927479,"MEKAR MULYA, PENARIK, MUKOMUKO, BENGKULU",6,149,70,219
https://kawalpemilu.org#927479,"MEKAR MULYA, PENARIK, MUKOMUKO, BENGKULU",7,142,28,170
https://kawalpemilu.org#927479,"MEKAR MULYA, PENARIK, MUKOMUKO, BENGKULU",8,178,29,207
https://kawalpemilu.org#927480,"SIDO MULYO, PENARIK, MUKOMUKO, BENGKULU",1,170,48,218
https://kawalpemilu.org#927480,"SIDO MULYO, PENARIK, MUKOMUKO, BENGKULU",2,134,23,157
https://kawalpemilu.org#927480,"SIDO MULYO, PENARIK, MUKOMUKO, BENGKULU",3,160,23,183
https://kawalpemilu.org#927481,"MARGA MUKTI, PENARIK, MUKOMUKO, BENGKULU",1,139,22,161
https://kawalpemilu.org#927481,"MARGA MUKTI, PENARIK, MUKOMUKO, BENGKULU",2,143,15,158
https://kawalpemilu.org#927481,"MARGA MUKTI, PENARIK, MUKOMUKO, BENGKULU",3,140,14,154
https://kawalpemilu.org#927481,"MARGA MUKTI, PENARIK, MUKOMUKO, BENGKULU",4,173,47,220
https://kawalpemilu.org#22006,"LUBUK SANAI, XIV KOTO, MUKOMUKO, BENGKULU",1,77,145,222
https://kawalpemilu.org#22006,"LUBUK SANAI, XIV KOTO, MUKOMUKO, BENGKULU",2,59,124,183
https://kawalpemilu.org#22006,"LUBUK SANAI, XIV KOTO, MUKOMUKO, BENGKULU",3,39,149,188
https://kawalpemilu.org#22006,"LUBUK SANAI, XIV KOTO, MUKOMUKO, BENGKULU",4,34,142,176
https://kawalpemilu.org#22006,"LUBUK SANAI, XIV KOTO, MUKOMUKO, BENGKULU",5,60,129,189
https://kawalpemilu.org#22006,"LUBUK SANAI, XIV KOTO, MUKOMUKO, BENGKULU",6,45,85,130
https://kawalpemilu.org#22007,"RAWA MULYA, XIV KOTO, MUKOMUKO, BENGKULU",1,162,42,204
https://kawalpemilu.org#22007,"RAWA MULYA, XIV KOTO, MUKOMUKO, BENGKULU",2,207,24,231
https://kawalpemilu.org#22007,"RAWA MULYA, XIV KOTO, MUKOMUKO, BENGKULU",4,175,39,214
https://kawalpemilu.org#22007,"RAWA MULYA, XIV KOTO, MUKOMUKO, BENGKULU",5,100,58,158
https://kawalpemilu.org#22007,"RAWA MULYA, XIV KOTO, MUKOMUKO, BENGKULU",6,111,31,142
https://kawalpemilu.org#22008,"RAWA BANGUN, XIV KOTO, MUKOMUKO, BENGKULU",1,195,42,237
https://kawalpemilu.org#22008,"RAWA BANGUN, XIV KOTO, MUKOMUKO, BENGKULU",2,201,15,216
https://kawalpemilu.org#22008,"RAWA BANGUN, XIV KOTO, MUKOMUKO, BENGKULU",3,193,44,237
https://kawalpemilu.org#22009,"TANJUNG MULYA, XIV KOTO, MUKOMUKO, BENGKULU",1,166,78,244
https://kawalpemilu.org#22009,"TANJUNG MULYA, XIV KOTO, MUKOMUKO, BENGKULU",2,189,33,222
https://kawalpemilu.org#22009,"TANJUNG MULYA, XIV KOTO, MUKOMUKO, BENGKULU",3,147,70,217
https://kawalpemilu.org#22009,"TANJUNG MULYA, XIV KOTO, MUKOMUKO, BENGKULU",4,189,19,208
https://kawalpemilu.org#22009,"TANJUNG MULYA, XIV KOTO, MUKOMUKO, BENGKULU",5,169,43,217
https://kawalpemilu.org#22009,"TANJUNG MULYA, XIV KOTO, MUKOMUKO, BENGKULU",6,133,29,162
https://kawalpemilu.org#22009,"TANJUNG MULYA, XIV KOTO, MUKOMUKO, BENGKULU",7,193,45,238
https://kawalpemilu.org#22010,"PAUH TARENJA, XIV KOTO, MUKOMUKO, BENGKULU",1,124,119,243
https://kawalpemilu.org#22010,"PAUH TARENJA, XIV KOTO, MUKOMUKO, BENGKULU",2,172,71,243
https://kawalpemilu.org#22010,"PAUH TARENJA, XIV KOTO, MUKOMUKO, BENGKULU",3,67,164,231
https://kawalpemilu.org#22010,"PAUH TARENJA, XIV KOTO, MUKOMUKO, BENGKULU",4,87,159,246
https://kawalpemilu.org#22011,"DUSUN BARU PELOKAN, XIV KOTO, MUKOMUKO, BENGKULU",1,40,176,216
https://kawalpemilu.org#22011,"DUSUN BARU PELOKAN, XIV KOTO, MUKOMUKO, BENGKULU",2,30,154,184
https://kawalpemilu.org#22011,"DUSUN BARU PELOKAN, XIV KOTO, MUKOMUKO, BENGKULU",3,52,161,213
https://kawalpemilu.org#22011,"DUSUN BARU PELOKAN, XIV KOTO, MUKOMUKO, BENGKULU",4,44,155,199
https://kawalpemilu.org#22011,"DUSUN BARU PELOKAN, XIV KOTO, MUKOMUKO, BENGKULU",5,157,55,212
https://kawalpemilu.org#22011,"DUSUN BARU PELOKAN, XIV KOTO, MUKOMUKO, BENGKULU",6,179,53,232
https://kawalpemilu.org#22012,"LUBUK SANAI II, XIV KOTO, MUKOMUKO, BENGKULU",2,118,77,195
https://kawalpemilu.org#22012,"LUBUK SANAI II, XIV KOTO, MUKOMUKO, BENGKULU",3,125,29,154
https://kawalpemilu.org#22013,"LUBUK SANAI III, XIV KOTO, MUKOMUKO, BENGKULU",1,94,142,236
https://kawalpemilu.org#22013,"LUBUK SANAI III, XIV KOTO, MUKOMUKO, BENGKULU",2,99,102,201
https://kawalpemilu.org#22013,"LUBUK SANAI III, XIV KOTO, MUKOMUKO, BENGKULU",3,170,71,241
https://kawalpemilu.org#22015,"LALANG LUAS, V KOTO, MUKOMUKO, BENGKULU",1,53,121,174
https://kawalpemilu.org#22015,"LALANG LUAS, V KOTO, MUKOMUKO, BENGKULU",2,82,94,176
https://kawalpemilu.org#22015,"LALANG LUAS, V KOTO, MUKOMUKO, BENGKULU",3,67,116,183
https://kawalpemilu.org#22016,"RESNO, V KOTO, MUKOMUKO, BENGKULU",1,66,120,186
https://kawalpemilu.org#22016,"RESNO, V KOTO, MUKOMUKO, BENGKULU",2,78,133,211
https://kawalpemilu.org#22017,"PONDOK PANJANG, V KOTO, MUKOMUKO, BENGKULU",1,104,89,193
https://kawalpemilu.org#22017,"PONDOK PANJANG, V KOTO, MUKOMUKO, BENGKULU",2,50,86,136
https://kawalpemilu.org#22017,"PONDOK PANJANG, V KOTO, MUKOMUKO, BENGKULU",3,101,101,202
https://kawalpemilu.org#22018,"TALANG PETAI, V KOTO, MUKOMUKO, BENGKULU",1,46,163,209
https://kawalpemilu.org#22019,"SUNGAI LINTANG, V KOTO, MUKOMUKO, BENGKULU",1,20,116,136
https://kawalpemilu.org#22019,"SUNGAI LINTANG, V KOTO, MUKOMUKO, BENGKULU",2,17,119,136
https://kawalpemilu.org#22020,"PONDOK TENGAH, V KOTO, MUKOMUKO, BENGKULU",1,75,110,185
https://kawalpemilu.org#22020,"PONDOK TENGAH, V KOTO, MUKOMUKO, BENGKULU",2,43,91,134
https://kawalpemilu.org#22020,"PONDOK TENGAH, V KOTO, MUKOMUKO, BENGKULU",3,75,112,187
https://kawalpemilu.org#22021,"TALANG SAKTI, V KOTO, MUKOMUKO, BENGKULU",1,49,173,222
https://kawalpemilu.org#22021,"TALANG SAKTI, V KOTO, MUKOMUKO, BENGKULU",2,27,195,222
https://kawalpemilu.org#22022,"TALANG SEPAKAT, V KOTO, MUKOMUKO, BENGKULU",1,32,123,155
https://kawalpemilu.org#22022,"TALANG SEPAKAT, V KOTO, MUKOMUKO, BENGKULU",2,167,47,214
https://kawalpemilu.org#22022,"TALANG SEPAKAT, V KOTO, MUKOMUKO, BENGKULU",3,27,125,152
https://kawalpemilu.org#22023,"LUBUK CABAU, V KOTO, MUKOMUKO, BENGKULU",1,66,77,143
https://kawalpemilu.org#22023,"LUBUK CABAU, V KOTO, MUKOMUKO, BENGKULU",2,54,88,142
https://kawalpemilu.org#22023,"LUBUK CABAU, V KOTO, MUKOMUKO, BENGKULU",3,131,31,162
https://kawalpemilu.org#22023,"LUBUK CABAU, V KOTO, MUKOMUKO, BENGKULU",4,116,24,140
https://kawalpemilu.org#22024,"SUNGAI RENGAS, V KOTO, MUKOMUKO, BENGKULU",1,52,104,156
https://kawalpemilu.org#22024,"SUNGAI RENGAS, V KOTO, MUKOMUKO, BENGKULU",2,41,83,124
https://kawalpemilu.org#22026,"PONDOK MAKMUR, AIR MAJUNTO, MUKOMUKO, BENGKULU",1,157,87,244
https://kawalpemilu.org#22026,"PONDOK MAKMUR, AIR MAJUNTO, MUKOMUKO, BENGKULU",2,181,24,205
https://kawalpemilu.org#22026,"PONDOK MAKMUR, AIR MAJUNTO, MUKOMUKO, BENGKULU",3,142,46,188
https://kawalpemilu.org#22026,"PONDOK MAKMUR, AIR MAJUNTO, MUKOMUKO, BENGKULU",4,128,73,201
https://kawalpemilu.org#22027,"MANJUTO JAYA, AIR MAJUNTO, MUKOMUKO, BENGKULU",1,126,74,200
https://kawalpemilu.org#22027,"MANJUTO JAYA, AIR MAJUNTO, MUKOMUKO, BENGKULU",2,158,79,237
https://kawalpemilu.org#22027,"MANJUTO JAYA, AIR MAJUNTO, MUKOMUKO, BENGKULU",3,149,32,181
https://kawalpemilu.org#22028,"TIRTA MAKMUR, AIR MAJUNTO, MUKOMUKO, BENGKULU",1,194,23,217
https://kawalpemilu.org#22028,"TIRTA MAKMUR, AIR MAJUNTO, MUKOMUKO, BENGKULU",2,155,51,206
https://kawalpemilu.org#22028,"TIRTA MAKMUR, AIR MAJUNTO, MUKOMUKO, BENGKULU",3,165,79,244
https://kawalpemilu.org#22028,"TIRTA MAKMUR, AIR MAJUNTO, MUKOMUKO, BENGKULU",4,188,34,222
https://kawalpemilu.org#22028,"TIRTA MAKMUR, AIR MAJUNTO, MUKOMUKO, BENGKULU",5,202,13,215
https://kawalpemilu.org#22029,"AGUNG JAYA, AIR MAJUNTO, MUKOMUKO, BENGKULU",1,117,75,192
https://kawalpemilu.org#22029,"AGUNG JAYA, AIR MAJUNTO, MUKOMUKO, BENGKULU",2,149,61,210
https://kawalpemilu.org#22029,"AGUNG JAYA, AIR MAJUNTO, MUKOMUKO, BENGKULU",3,216,29,245
https://kawalpemilu.org#22029,"AGUNG JAYA, AIR MAJUNTO, MUKOMUKO, BENGKULU",4,181,39,220
https://kawalpemilu.org#22029,"AGUNG JAYA, AIR MAJUNTO, MUKOMUKO, BENGKULU",5,176,33,209
https://kawalpemilu.org#22030,"TIRTA MULYA, AIR MAJUNTO, MUKOMUKO, BENGKULU",1,145,41,186
https://kawalpemilu.org#22030,"TIRTA MULYA, AIR MAJUNTO, MUKOMUKO, BENGKULU",2,159,43,202
https://kawalpemilu.org#22030,"TIRTA MULYA, AIR MAJUNTO, MUKOMUKO, BENGKULU",3,164,26,190
https://kawalpemilu.org#22030,"TIRTA MULYA, AIR MAJUNTO, MUKOMUKO, BENGKULU",4,215,29,244
https://kawalpemilu.org#22030,"TIRTA MULYA, AIR MAJUNTO, MUKOMUKO, BENGKULU",5,212,37,249
https://kawalpemilu.org#22031,"KOTA PRAJA, AIR MAJUNTO, MUKOMUKO, BENGKULU",1,176,56,232
https://kawalpemilu.org#22031,"KOTA PRAJA, AIR MAJUNTO, MUKOMUKO, BENGKULU",2,209,33,242
https://kawalpemilu.org#22031,"KOTA PRAJA, AIR MAJUNTO, MUKOMUKO, BENGKULU",3,178,74,252
https://kawalpemilu.org#22032,"SINAR JAYA, AIR MAJUNTO, MUKOMUKO, BENGKULU",1,145,89,234
https://kawalpemilu.org#22032,"SINAR JAYA, AIR MAJUNTO, MUKOMUKO, BENGKULU",2,136,119,255
https://kawalpemilu.org#22032,"SINAR JAYA, AIR MAJUNTO, MUKOMUKO, BENGKULU",3,109,108,217
https://kawalpemilu.org#22033,"SIDO MAKMUR, AIR MAJUNTO, MUKOMUKO, BENGKULU",1,161,55,216
https://kawalpemilu.org#22033,"SIDO MAKMUR, AIR MAJUNTO, MUKOMUKO, BENGKULU",2,169,39,208
https://kawalpemilu.org#22033,"SIDO MAKMUR, AIR MAJUNTO, MUKOMUKO, BENGKULU",3,184,26,210
https://kawalpemilu.org#22033,"SIDO MAKMUR, AIR MAJUNTO, MUKOMUKO, BENGKULU",4,103,80,183
https://kawalpemilu.org#22035,"DUSUN BARU V KOTO, AIR DIKIT, MUKOMUKO, BENGKULU",1,144,89,233
https://kawalpemilu.org#22035,"DUSUN BARU V KOTO, AIR DIKIT, MUKOMUKO, BENGKULU",2,70,184,254
https://kawalpemilu.org#22036,"AIR DIKIT, AIR DIKIT, MUKOMUKO, BENGKULU",1,140,98,238
https://kawalpemilu.org#22036,"AIR DIKIT, AIR DIKIT, MUKOMUKO, BENGKULU",2,109,63,172
https://kawalpemilu.org#22036,"AIR DIKIT, AIR DIKIT, MUKOMUKO, BENGKULU",3,115,126,241
https://kawalpemilu.org#22036,"AIR DIKIT, AIR DIKIT, MUKOMUKO, BENGKULU",4,120,94,214
https://kawalpemilu.org#22036,"AIR DIKIT, AIR DIKIT, MUKOMUKO, BENGKULU",5,55,39,94
https://kawalpemilu.org#22036,"AIR DIKIT, AIR DIKIT, MUKOMUKO, BENGKULU",6,75,53,128
https://kawalpemilu.org#22037,"PONDOK LUNANG, AIR DIKIT, MUKOMUKO, BENGKULU",1,151,103,254
https://kawalpemilu.org#22037,"PONDOK LUNANG, AIR DIKIT, MUKOMUKO, BENGKULU",2,70,149,219
https://kawalpemilu.org#22037,"PONDOK LUNANG, AIR DIKIT, MUKOMUKO, BENGKULU",3,84,120,204
https://kawalpemilu.org#22038,"SARI BULAN, AIR DIKIT, MUKOMUKO, BENGKULU",1,95,104,199
https://kawalpemilu.org#22038,"SARI BULAN, AIR DIKIT, MUKOMUKO, BENGKULU",2,117,92,209
https://kawalpemilu.org#22038,"SARI BULAN, AIR DIKIT, MUKOMUKO, BENGKULU",3,142,72,214
https://kawalpemilu.org#22039,"SARI MAKMUR, AIR DIKIT, MUKOMUKO, BENGKULU",1,201,31,232
https://kawalpemilu.org#22040,"SUMBER SARI, AIR DIKIT, MUKOMUKO, BENGKULU",1,147,37,184
https://kawalpemilu.org#22040,"SUMBER SARI, AIR DIKIT, MUKOMUKO, BENGKULU",2,119,43,162
https://kawalpemilu.org#22040,"SUMBER SARI, AIR DIKIT, MUKOMUKO, BENGKULU",3,101,68,169
https://kawalpemilu.org#22041,"AIR KASAI, AIR DIKIT, MUKOMUKO, BENGKULU",1,142,100,242
https://kawalpemilu.org#22041,"AIR KASAI, AIR DIKIT, MUKOMUKO, BENGKULU",2,84,53,137
https://kawalpemilu.org#22043,"RETAK MUDIK, SUNGAI RUMBAI, MUKOMUKO, BENGKULU",1,91,157,248
https://kawalpemilu.org#22043,"RETAK MUDIK, SUNGAI RUMBAI, MUKOMUKO, BENGKULU",2,68,164,232
https://kawalpemilu.org#22043,"RETAK MUDIK, SUNGAI RUMBAI, MUKOMUKO, BENGKULU",3,34,202,236
https://kawalpemilu.org#22044,"PADANG GADING, SUNGAI RUMBAI, MUKOMUKO, BENGKULU",1,181,34,215
https://kawalpemilu.org#22044,"PADANG GADING, SUNGAI RUMBAI, MUKOMUKO, BENGKULU",2,143,16,159
https://kawalpemilu.org#22044,"PADANG GADING, SUNGAI RUMBAI, MUKOMUKO, BENGKULU",3,159,34,193
https://kawalpemilu.org#22044,"PADANG GADING, SUNGAI RUMBAI, MUKOMUKO, BENGKULU",4,169,34,203
https://kawalpemilu.org#22045,"GAJAH MATI, SUNGAI RUMBAI, MUKOMUKO, BENGKULU",1,30,162,192
https://kawalpemilu.org#22045,"GAJAH MATI, SUNGAI RUMBAI, MUKOMUKO, BENGKULU",2,53,110,163
https://kawalpemilu.org#22045,"GAJAH MATI, SUNGAI RUMBAI, MUKOMUKO, BENGKULU",3,61,134,195
https://kawalpemilu.org#22046,"MEKAR SARI, SUNGAI RUMBAI, MUKOMUKO, BENGKULU",1,173,16,189
https://kawalpemilu.org#22046,"MEKAR SARI, SUNGAI RUMBAI, MUKOMUKO, BENGKULU",2,187,43,230
https://kawalpemilu.org#22046,"MEKAR SARI, SUNGAI RUMBAI, MUKOMUKO, BENGKULU",3,154,46,200
https://kawalpemilu.org#22047,"SIDO DADI, SUNGAI RUMBAI, MUKOMUKO, BENGKULU",1,167,32,199
https://kawalpemilu.org#22047,"SIDO DADI, SUNGAI RUMBAI, MUKOMUKO, BENGKULU",2,197,46,243
https://kawalpemilu.org#22047,"SIDO DADI, SUNGAI RUMBAI, MUKOMUKO, BENGKULU",3,178,40,218
https://kawalpemilu.org#22048,"SUMBER MAKMUR, SUNGAI RUMBAI, MUKOMUKO, BENGKULU",1,149,42,191
https://kawalpemilu.org#22048,"SUMBER MAKMUR, SUNGAI RUMBAI, MUKOMUKO, BENGKULU",2,134,46,180
https://kawalpemilu.org#22048,"SUMBER MAKMUR, SUNGAI RUMBAI, MUKOMUKO, BENGKULU",3,173,69,242
https://kawalpemilu.org#22048,"SUMBER MAKMUR, SUNGAI RUMBAI, MUKOMUKO, BENGKULU",4,174,62,236
https://kawalpemilu.org#22049,"TALANG GADING, SUNGAI RUMBAI, MUKOMUKO, BENGKULU",1,127,56,183
https://kawalpemilu.org#22049,"TALANG GADING, SUNGAI RUMBAI, MUKOMUKO, BENGKULU",2,144,64,208
https://kawalpemilu.org#22050,"GADING JAYA, SUNGAI RUMBAI, MUKOMUKO, BENGKULU",1,59,95,154
https://kawalpemilu.org#22050,"GADING JAYA, SUNGAI RUMBAI, MUKOMUKO, BENGKULU",2,109,72,181
https://kawalpemilu.org#22051,"BANJAR SARI, SUNGAI RUMBAI, MUKOMUKO, BENGKULU",1,167,13,180
https://kawalpemilu.org#22051,"BANJAR SARI, SUNGAI RUMBAI, MUKOMUKO, BENGKULU",2,180,22,202
https://kawalpemilu.org#22051,"BANJAR SARI, SUNGAI RUMBAI, MUKOMUKO, BENGKULU",3,140,33,173
https://kawalpemilu.org#22054,"BIOA SENGOK, RIMBO PENGADANG, LEBONG, BENGKULU",1,128,58,186
https://kawalpemilu.org#22054,"BIOA SENGOK, RIMBO PENGADANG, LEBONG, BENGKULU",2,142,55,197
https://kawalpemilu.org#22054,"BIOA SENGOK, RIMBO PENGADANG, LEBONG, BENGKULU",3,162,75,237
https://kawalpemilu.org#22054,"BIOA SENGOK, RIMBO PENGADANG, LEBONG, BENGKULU",4,134,63,197
https://kawalpemilu.org#22055,"RIMBO PENGADANG, RIMBO PENGADANG, LEBONG, BENGKULU",1,100,71,171
https://kawalpemilu.org#22055,"RIMBO PENGADANG, RIMBO PENGADANG, LEBONG, BENGKULU",2,123,65,188
https://kawalpemilu.org#22055,"RIMBO PENGADANG, RIMBO PENGADANG, LEBONG, BENGKULU",3,92,83,175
https://kawalpemilu.org#22055,"RIMBO PENGADANG, RIMBO PENGADANG, LEBONG, BENGKULU",4,117,78,195
https://kawalpemilu.org#22061,"TIK KUTO, RIMBO PENGADANG, LEBONG, BENGKULU",1,159,66,225
https://kawalpemilu.org#22061,"TIK KUTO, RIMBO PENGADANG, LEBONG, BENGKULU",2,15,4,19
https://kawalpemilu.org#22062,"TALANG RATAU, RIMBO PENGADANG, LEBONG, BENGKULU",1,130,55,185
https://kawalpemilu.org#22062,"TALANG RATAU, RIMBO PENGADANG, LEBONG, BENGKULU",2,130,61,191
https://kawalpemilu.org#22062,"TALANG RATAU, RIMBO PENGADANG, LEBONG, BENGKULU",3,107,39,146
https://kawalpemilu.org#89499,"BAJOK, RIMBO PENGADANG, LEBONG, BENGKULU",1,92,41,133
https://kawalpemilu.org#89499,"BAJOK, RIMBO PENGADANG, LEBONG, BENGKULU",2,105,29,134
https://kawalpemilu.org#89502,"TELUK DIEN, RIMBO PENGADANG, LEBONG, BENGKULU",1,120,52,172
https://kawalpemilu.org#89502,"TELUK DIEN, RIMBO PENGADANG, LEBONG, BENGKULU",2,89,44,133
https://kawalpemilu.org#22064,"SUKA SARI, LEBONG SELATAN, LEBONG, BENGKULU",1,158,53,211
https://kawalpemilu.org#22064,"SUKA SARI, LEBONG SELATAN, LEBONG, BENGKULU",2,109,50,159
https://kawalpemilu.org#22064,"SUKA SARI, LEBONG SELATAN, LEBONG, BENGKULU",3,120,77,197
https://kawalpemilu.org#22065,"KUTAI DONOK, LEBONG SELATAN, LEBONG, BENGKULU",1,121,41,162
https://kawalpemilu.org#22065,"KUTAI DONOK, LEBONG SELATAN, LEBONG, BENGKULU",2,135,51,186
https://kawalpemilu.org#22065,"KUTAI DONOK, LEBONG SELATAN, LEBONG, BENGKULU",3,84,50,134
https://kawalpemilu.org#22065,"KUTAI DONOK, LEBONG SELATAN, LEBONG, BENGKULU",4,115,58,173
https://kawalpemilu.org#22065,"KUTAI DONOK, LEBONG SELATAN, LEBONG, BENGKULU",5,53,2,55
https://kawalpemilu.org#22066,"MANGKURAJO, LEBONG SELATAN, LEBONG, BENGKULU",1,202,44,246
https://kawalpemilu.org#22066,"MANGKURAJO, LEBONG SELATAN, LEBONG, BENGKULU",2,170,69,239
https://kawalpemilu.org#22066,"MANGKURAJO, LEBONG SELATAN, LEBONG, BENGKULU",3,206,46,252
https://kawalpemilu.org#22067,"TES, LEBONG SELATAN, LEBONG, BENGKULU",1,132,46,178
https://kawalpemilu.org#22067,"TES, LEBONG SELATAN, LEBONG, BENGKULU",2,161,38,199
https://kawalpemilu.org#22067,"TES, LEBONG SELATAN, LEBONG, BENGKULU",3,120,33,153
https://kawalpemilu.org#22067,"TES, LEBONG SELATAN, LEBONG, BENGKULU",4,99,47,146
https://kawalpemilu.org#22067,"TES, LEBONG SELATAN, LEBONG, BENGKULU",5,90,38,128
https://kawalpemilu.org#22067,"TES, LEBONG SELATAN, LEBONG, BENGKULU",6,78,83,161
https://kawalpemilu.org#22067,"TES, LEBONG SELATAN, LEBONG, BENGKULU",7,83,51,134
https://kawalpemilu.org#22067,"TES, LEBONG SELATAN, LEBONG, BENGKULU",8,106,37,143
https://kawalpemilu.org#22067,"TES, LEBONG SELATAN, LEBONG, BENGKULU",9,87,47,134
https://kawalpemilu.org#22067,"TES, LEBONG SELATAN, LEBONG, BENGKULU",10,112,57,169
https://kawalpemilu.org#22067,"TES, LEBONG SELATAN, LEBONG, BENGKULU",11,99,43,142
https://kawalpemilu.org#22067,"TES, LEBONG SELATAN, LEBONG, BENGKULU",12,108,48,156
https://kawalpemilu.org#22068,"TABA ANYAR, LEBONG SELATAN, LEBONG, BENGKULU",1,118,55,173
https://kawalpemilu.org#22068,"TABA ANYAR, LEBONG SELATAN, LEBONG, BENGKULU",2,133,75,208
https://kawalpemilu.org#22068,"TABA ANYAR, LEBONG SELATAN, LEBONG, BENGKULU",3,91,37,128
https://kawalpemilu.org#22068,"TABA ANYAR, LEBONG SELATAN, LEBONG, BENGKULU",4,140,62,202
https://kawalpemilu.org#22068,"TABA ANYAR, LEBONG SELATAN, LEBONG, BENGKULU",5,118,45,163
https://kawalpemilu.org#22068,"TABA ANYAR, LEBONG SELATAN, LEBONG, BENGKULU",6,101,72,173
https://kawalpemilu.org#22068,"TABA ANYAR, LEBONG SELATAN, LEBONG, BENGKULU",7,119,92,211
https://kawalpemilu.org#22068,"TABA ANYAR, LEBONG SELATAN, LEBONG, BENGKULU",8,102,69,171
https://kawalpemilu.org#22068,"TABA ANYAR, LEBONG SELATAN, LEBONG, BENGKULU",9,102,55,157
https://kawalpemilu.org#22068,"TABA ANYAR, LEBONG SELATAN, LEBONG, BENGKULU",10,119,65,184
https://kawalpemilu.org#22069,"TURAN TIGING, LEBONG SELATAN, LEBONG, BENGKULU",1,110,56,166
https://kawalpemilu.org#22069,"TURAN TIGING, LEBONG SELATAN, LEBONG, BENGKULU",2,103,63,166
https://kawalpemilu.org#22069,"TURAN TIGING, LEBONG SELATAN, LEBONG, BENGKULU",3,104,51,155
https://kawalpemilu.org#22070,"MUBAI, LEBONG SELATAN, LEBONG, BENGKULU",1,133,49,182
https://kawalpemilu.org#22070,"MUBAI, LEBONG SELATAN, LEBONG, BENGKULU",2,96,51,147
https://kawalpemilu.org#22070,"MUBAI, LEBONG SELATAN, LEBONG, BENGKULU",3,125,38,163
https://kawalpemilu.org#22070,"MUBAI, LEBONG SELATAN, LEBONG, BENGKULU",4,135,67,202
https://kawalpemilu.org#22070,"MUBAI, LEBONG SELATAN, LEBONG, BENGKULU",5,156,37,193
https://kawalpemilu.org#22071,"TURAN LALANG, LEBONG SELATAN, LEBONG, BENGKULU",1,88,80,168
https://kawalpemilu.org#22071,"TURAN LALANG, LEBONG SELATAN, LEBONG, BENGKULU",2,82,56,138
https://kawalpemilu.org#22071,"TURAN LALANG, LEBONG SELATAN, LEBONG, BENGKULU",3,118,48,166
https://kawalpemilu.org#22071,"TURAN LALANG, LEBONG SELATAN, LEBONG, BENGKULU",4,84,64,148
https://kawalpemilu.org#22071,"TURAN LALANG, LEBONG SELATAN, LEBONG, BENGKULU",5,81,68,149
https://kawalpemilu.org#22071,"TURAN LALANG, LEBONG SELATAN, LEBONG, BENGKULU",6,123,45,168
https://kawalpemilu.org#929014,"TIK JENIAK, LEBONG SELATAN, LEBONG, BENGKULU",1,149,70,219
https://kawalpemilu.org#929014,"TIK JENIAK, LEBONG SELATAN, LEBONG, BENGKULU",2,145,87,232
https://kawalpemilu.org#929014,"TIK JENIAK, LEBONG SELATAN, LEBONG, BENGKULU",3,151,102,253
https://kawalpemilu.org#929015,"MANAI BLAU, LEBONG SELATAN, LEBONG, BENGKULU",1,148,49,197
https://kawalpemilu.org#929015,"MANAI BLAU, LEBONG SELATAN, LEBONG, BENGKULU",2,132,40,172
https://kawalpemilu.org#929015,"MANAI BLAU, LEBONG SELATAN, LEBONG, BENGKULU",3,130,74,204
https://kawalpemilu.org#22082,"SUKA DAMAI, LEBONG TENGAH, LEBONG, BENGKULU",1,79,87,166
https://kawalpemilu.org#22082,"SUKA DAMAI, LEBONG TENGAH, LEBONG, BENGKULU",2,66,118,184
https://kawalpemilu.org#22082,"SUKA DAMAI, LEBONG TENGAH, LEBONG, BENGKULU",3,65,119,184
https://kawalpemilu.org#22082,"SUKA DAMAI, LEBONG TENGAH, LEBONG, BENGKULU",4,89,130,219
https://kawalpemilu.org#22083,"KARANG ANYAR, LEBONG TENGAH, LEBONG, BENGKULU",1,101,103,204
https://kawalpemilu.org#22083,"KARANG ANYAR, LEBONG TENGAH, LEBONG, BENGKULU",2,135,83,218
https://kawalpemilu.org#22084,"TANJUNG BUNGAI I, LEBONG TENGAH, LEBONG, BENGKULU",1,81,132,213
https://kawalpemilu.org#22084,"TANJUNG BUNGAI I, LEBONG TENGAH, LEBONG, BENGKULU",2,72,131,203
https://kawalpemilu.org#22084,"TANJUNG BUNGAI I, LEBONG TENGAH, LEBONG, BENGKULU",3,80,107,187
https://kawalpemilu.org#22084,"TANJUNG BUNGAI I, LEBONG TENGAH, LEBONG, BENGKULU",4,77,101,178
https://kawalpemilu.org#22085,"PAGAR AGUNG, LEBONG TENGAH, LEBONG, BENGKULU",2,54,158,212
https://kawalpemilu.org#22085,"PAGAR AGUNG, LEBONG TENGAH, LEBONG, BENGKULU",3,45,164,209
https://kawalpemilu.org#22086,"EMBONG PANJANG, LEBONG TENGAH, LEBONG, BENGKULU",1,74,88,162
https://kawalpemilu.org#22086,"EMBONG PANJANG, LEBONG TENGAH, LEBONG, BENGKULU",2,58,108,166
https://kawalpemilu.org#22086,"EMBONG PANJANG, LEBONG TENGAH, LEBONG, BENGKULU",3,56,113,169
https://kawalpemilu.org#22086,"EMBONG PANJANG, LEBONG TENGAH, LEBONG, BENGKULU",4,84,119,203
https://kawalpemilu.org#84727,"SEMELAKO II, LEBONG TENGAH, LEBONG, BENGKULU",1,73,110,183
https://kawalpemilu.org#84727,"SEMELAKO II, LEBONG TENGAH, LEBONG, BENGKULU",2,93,77,170
https://kawalpemilu.org#84727,"SEMELAKO II, LEBONG TENGAH, LEBONG, BENGKULU",3,86,78,164
https://kawalpemilu.org#84727,"SEMELAKO II, LEBONG TENGAH, LEBONG, BENGKULU",4,96,74,170
https://kawalpemilu.org#84727,"SEMELAKO II, LEBONG TENGAH, LEBONG, BENGKULU",5,110,74,184
https://kawalpemilu.org#84728,"SEMELAKO III, LEBONG TENGAH, LEBONG, BENGKULU",1,116,67,183
https://kawalpemilu.org#84728,"SEMELAKO III, LEBONG TENGAH, LEBONG, BENGKULU",2,112,66,178
https://kawalpemilu.org#84729,"SEMELAKO ATAS, LEBONG TENGAH, LEBONG, BENGKULU",1,130,78,208
https://kawalpemilu.org#84729,"SEMELAKO ATAS, LEBONG TENGAH, LEBONG, BENGKULU",2,141,70,211
https://kawalpemilu.org#84729,"SEMELAKO ATAS, LEBONG TENGAH, LEBONG, BENGKULU",3,117,77,194
https://kawalpemilu.org#84729,"SEMELAKO ATAS, LEBONG TENGAH, LEBONG, BENGKULU",4,142,64,206
https://kawalpemilu.org#84730,"DANAU LIANG, LEBONG TENGAH, LEBONG, BENGKULU",1,83,24,107
https://kawalpemilu.org#84730,"DANAU LIANG, LEBONG TENGAH, LEBONG, BENGKULU",2,98,41,139
https://kawalpemilu.org#84731,"TANJUNG BUNGAI II, LEBONG TENGAH, LEBONG, BENGKULU",1,72,111,183
https://kawalpemilu.org#84731,"TANJUNG BUNGAI II, LEBONG TENGAH, LEBONG, BENGKULU",2,80,114,194
https://kawalpemilu.org#84731,"TANJUNG BUNGAI II, LEBONG TENGAH, LEBONG, BENGKULU",3,72,96,168
https://kawalpemilu.org#84731,"TANJUNG BUNGAI II, LEBONG TENGAH, LEBONG, BENGKULU",4,62,116,178
https://kawalpemilu.org#89524,"SEMELAKO I, LEBONG TENGAH, LEBONG, BENGKULU",1,144,99,243
https://kawalpemilu.org#89524,"SEMELAKO I, LEBONG TENGAH, LEBONG, BENGKULU",2,125,95,220
https://kawalpemilu.org#89524,"SEMELAKO I, LEBONG TENGAH, LEBONG, BENGKULU",3,111,112,223
https://kawalpemilu.org#22094,"TIK TEBING, LEBONG ATAS, LEBONG, BENGKULU",1,71,97,168
https://kawalpemilu.org#22094,"TIK TEBING, LEBONG ATAS, LEBONG, BENGKULU",2,95,113,208
https://kawalpemilu.org#22094,"TIK TEBING, LEBONG ATAS, LEBONG, BENGKULU",3,94,91,185
https://kawalpemilu.org#89544,"TABEAK BLAU I, LEBONG ATAS, LEBONG, BENGKULU",1,78,119,197
https://kawalpemilu.org#89544,"TABEAK BLAU I, LEBONG ATAS, LEBONG, BENGKULU",2,70,109,179
https://kawalpemilu.org#89544,"TABEAK BLAU I, LEBONG ATAS, LEBONG, BENGKULU",3,89,96,185
https://kawalpemilu.org#93367,"BLAU, LEBONG ATAS, LEBONG, BENGKULU",1,150,125,275
https://kawalpemilu.org#93368,"DANEU, LEBONG ATAS, LEBONG, BENGKULU",1,89,115,204
https://kawalpemilu.org#93368,"DANEU, LEBONG ATAS, LEBONG, BENGKULU",2,74,124,198
https://kawalpemilu.org#93368,"DANEU, LEBONG ATAS, LEBONG, BENGKULU",3,92,105,197
https://kawalpemilu.org#93368,"DANEU, LEBONG ATAS, LEBONG, BENGKULU",4,80,105,185
https://kawalpemilu.org#93369,"TABEAK BLAU, LEBONG ATAS, LEBONG, BENGKULU",1,71,82,153
https://kawalpemilu.org#93369,"TABEAK BLAU, LEBONG ATAS, LEBONG, BENGKULU",2,80,76,156
https://kawalpemilu.org#93369,"TABEAK BLAU, LEBONG ATAS, LEBONG, BENGKULU",3,74,117,191
https://kawalpemilu.org#93369,"TABEAK BLAU, LEBONG ATAS, LEBONG, BENGKULU",4,85,111,196
https://kawalpemilu.org#93370,"SUKAU KAYO, LEBONG ATAS, LEBONG, BENGKULU",1,118,75,193
https://kawalpemilu.org#93370,"SUKAU KAYO, LEBONG ATAS, LEBONG, BENGKULU",2,105,112,217
https://kawalpemilu.org#22107,"TALANG ULU, LEBONG UTARA, LEBONG, BENGKULU",1,58,116,174
https://kawalpemilu.org#22107,"TALANG ULU, LEBONG UTARA, LEBONG, BENGKULU",2,54,116,170
https://kawalpemilu.org#22107,"TALANG ULU, LEBONG UTARA, LEBONG, BENGKULU",3,67,103,170
https://kawalpemilu.org#22108,"KAMPUNG MUARA AMAN, LEBONG UTARA, LEBONG, BENGKULU",1,56,89,145
https://kawalpemilu.org#22108,"KAMPUNG MUARA AMAN, LEBONG UTARA, LEBONG, BENGKULU",2,77,78,155
https://kawalpemilu.org#22108,"KAMPUNG MUARA AMAN, LEBONG UTARA, LEBONG, BENGKULU",3,77,57,134
https://kawalpemilu.org#22108,"KAMPUNG MUARA AMAN, LEBONG UTARA, LEBONG, BENGKULU",4,56,60,116
https://kawalpemilu.org#22108,"KAMPUNG MUARA AMAN, LEBONG UTARA, LEBONG, BENGKULU",5,87,72,159
https://kawalpemilu.org#22108,"KAMPUNG MUARA AMAN, LEBONG UTARA, LEBONG, BENGKULU",6,70,72,142
https://kawalpemilu.org#22108,"KAMPUNG MUARA AMAN, LEBONG UTARA, LEBONG, BENGKULU",7,53,89,142
https://kawalpemilu.org#22108,"KAMPUNG MUARA AMAN, LEBONG UTARA, LEBONG, BENGKULU",8,89,118,207
https://kawalpemilu.org#22122,"PASAR MUARA AMAN, LEBONG UTARA, LEBONG, BENGKULU",1,68,73,141
https://kawalpemilu.org#22122,"PASAR MUARA AMAN, LEBONG UTARA, LEBONG, BENGKULU",3,56,84,140
https://kawalpemilu.org#22122,"PASAR MUARA AMAN, LEBONG UTARA, LEBONG, BENGKULU",4,58,56,114
https://kawalpemilu.org#22122,"PASAR MUARA AMAN, LEBONG UTARA, LEBONG, BENGKULU",5,61,70,131
https://kawalpemilu.org#22122,"PASAR MUARA AMAN, LEBONG UTARA, LEBONG, BENGKULU",6,71,106,177
https://kawalpemilu.org#22123,"KAMPUNG JAWA, LEBONG UTARA, LEBONG, BENGKULU",1,105,120,225
https://kawalpemilu.org#22123,"KAMPUNG JAWA, LEBONG UTARA, LEBONG, BENGKULU",2,82,107,189
https://kawalpemilu.org#22123,"KAMPUNG JAWA, LEBONG UTARA, LEBONG, BENGKULU",3,69,109,178
https://kawalpemilu.org#22123,"KAMPUNG JAWA, LEBONG UTARA, LEBONG, BENGKULU",4,93,107,200
https://kawalpemilu.org#22123,"KAMPUNG JAWA, LEBONG UTARA, LEBONG, BENGKULU",5,66,84,150
https://kawalpemilu.org#22123,"KAMPUNG JAWA, LEBONG UTARA, LEBONG, BENGKULU",6,37,98,135
https://kawalpemilu.org#22123,"KAMPUNG JAWA, LEBONG UTARA, LEBONG, BENGKULU",7,67,143,210
https://kawalpemilu.org#22123,"KAMPUNG JAWA, LEBONG UTARA, LEBONG, BENGKULU",8,51,152,203
https://kawalpemilu.org#22124,"GANDUNG, LEBONG UTARA, LEBONG, BENGKULU",1,104,111,215
https://kawalpemilu.org#22124,"GANDUNG, LEBONG UTARA, LEBONG, BENGKULU",2,100,86,186
https://kawalpemilu.org#22124,"GANDUNG, LEBONG UTARA, LEBONG, BENGKULU",3,105,83,188
https://kawalpemilu.org#22124,"GANDUNG, LEBONG UTARA, LEBONG, BENGKULU",4,128,106,234
https://kawalpemilu.org#22125,"LOKASARI, LEBONG UTARA, LEBONG, BENGKULU",1,84,94,178
https://kawalpemilu.org#22125,"LOKASARI, LEBONG UTARA, LEBONG, BENGKULU",2,94,107,201
https://kawalpemilu.org#22125,"LOKASARI, LEBONG UTARA, LEBONG, BENGKULU",3,71,74,145
https://kawalpemilu.org#22126,"LEBONG TAMBANG, LEBONG UTARA, LEBONG, BENGKULU",1,79,100,179
https://kawalpemilu.org#22126,"LEBONG TAMBANG, LEBONG UTARA, LEBONG, BENGKULU",2,69,108,177
https://kawalpemilu.org#22126,"LEBONG TAMBANG, LEBONG UTARA, LEBONG, BENGKULU",3,103,120,223
https://kawalpemilu.org#22126,"LEBONG TAMBANG, LEBONG UTARA, LEBONG, BENGKULU",4,98,113,211
https://kawalpemilu.org#22126,"LEBONG TAMBANG, LEBONG UTARA, LEBONG, BENGKULU",5,69,139,208
https://kawalpemilu.org#22126,"LEBONG TAMBANG, LEBONG UTARA, LEBONG, BENGKULU",6,86,130,216
https://kawalpemilu.org#22126,"LEBONG TAMBANG, LEBONG UTARA, LEBONG, BENGKULU",7,100,124,224
https://kawalpemilu.org#22127,"KAMPUNG DALAM, LEBONG UTARA, LEBONG, BENGKULU",1,92,109,201
https://kawalpemilu.org#22127,"KAMPUNG DALAM, LEBONG UTARA, LEBONG, BENGKULU",2,83,116,199
https://kawalpemilu.org#22128,"LADANG PALEMBANG, LEBONG UTARA, LEBONG, BENGKULU",1,94,82,176
https://kawalpemilu.org#22128,"LADANG PALEMBANG, LEBONG UTARA, LEBONG, BENGKULU",2,67,118,185
https://kawalpemilu.org#22128,"LADANG PALEMBANG, LEBONG UTARA, LEBONG, BENGKULU",3,102,65,167
https://kawalpemilu.org#22129,"TUNGGANG, LEBONG UTARA, LEBONG, BENGKULU",1,89,115,204
https://kawalpemilu.org#22129,"TUNGGANG, LEBONG UTARA, LEBONG, BENGKULU",2,90,103,193
https://kawalpemilu.org#22129,"TUNGGANG, LEBONG UTARA, LEBONG, BENGKULU",3,72,113,185
https://kawalpemilu.org#22129,"TUNGGANG, LEBONG UTARA, LEBONG, BENGKULU",4,84,84,168
https://kawalpemilu.org#22129,"TUNGGANG, LEBONG UTARA, LEBONG, BENGKULU",5,99,114,213
https://kawalpemilu.org#22129,"TUNGGANG, LEBONG UTARA, LEBONG, BENGKULU",6,118,134,252
https://kawalpemilu.org#84736,"NANGAI AMEN, LEBONG UTARA, LEBONG, BENGKULU",1,107,78,185
https://kawalpemilu.org#84736,"NANGAI AMEN, LEBONG UTARA, LEBONG, BENGKULU",2,107,58,165
https://kawalpemilu.org#84736,"NANGAI AMEN, LEBONG UTARA, LEBONG, BENGKULU",3,91,51,142
https://kawalpemilu.org#84736,"NANGAI AMEN, LEBONG UTARA, LEBONG, BENGKULU",4,91,65,156
https://kawalpemilu.org#84737,"GANDUNG BARU, LEBONG UTARA, LEBONG, BENGKULU",1,108,80,188
https://kawalpemilu.org#84737,"GANDUNG BARU, LEBONG UTARA, LEBONG, BENGKULU",2,122,69,191
https://kawalpemilu.org#84737,"GANDUNG BARU, LEBONG UTARA, LEBONG, BENGKULU",3,131,51,182
https://kawalpemilu.org#22057,"TALANG DONOK, TOPOS, LEBONG, BENGKULU",1,76,82,158
https://kawalpemilu.org#22057,"TALANG DONOK, TOPOS, LEBONG, BENGKULU",2,81,67,148
https://kawalpemilu.org#22060,"SUKA NEGERI, TOPOS, LEBONG, BENGKULU",1,117,100,217
https://kawalpemilu.org#22060,"SUKA NEGERI, TOPOS, LEBONG, BENGKULU",2,97,90,187
https://kawalpemilu.org#22060,"SUKA NEGERI, TOPOS, LEBONG, BENGKULU",3,89,93,182
https://kawalpemilu.org#22060,"SUKA NEGERI, TOPOS, LEBONG, BENGKULU",4,120,99,219
https://kawalpemilu.org#22060,"SUKA NEGERI, TOPOS, LEBONG, BENGKULU",5,110,116,226
https://kawalpemilu.org#84738,"TIK SIRONG, TOPOS, LEBONG, BENGKULU",1,130,73,203
https://kawalpemilu.org#84738,"TIK SIRONG, TOPOS, LEBONG, BENGKULU",2,130,73,203
https://kawalpemilu.org#84739,"AJAI SIANG, TOPOS, LEBONG, BENGKULU",1,98,89,187
https://kawalpemilu.org#84739,"AJAI SIANG, TOPOS, LEBONG, BENGKULU",2,125,83,208
https://kawalpemilu.org#84740,"TALANG DONOK I, TOPOS, LEBONG, BENGKULU",1,104,85,189
https://kawalpemilu.org#84740,"TALANG DONOK I, TOPOS, LEBONG, BENGKULU",2,115,72,187
https://kawalpemilu.org#84741,"TALANG BARU I, TOPOS, LEBONG, BENGKULU",1,82,53,135
https://kawalpemilu.org#84741,"TALANG BARU I, TOPOS, LEBONG, BENGKULU",2,87,60,147
https://kawalpemilu.org#84741,"TALANG BARU I, TOPOS, LEBONG, BENGKULU",3,77,53,130
https://kawalpemilu.org#84742,"TALANG BARU II, TOPOS, LEBONG, BENGKULU",1,81,114,195
https://kawalpemilu.org#84742,"TALANG BARU II, TOPOS, LEBONG, BENGKULU",2,105,134,239
https://kawalpemilu.org#89423,"TOPOS, TOPOS, LEBONG, BENGKULU",1,128,77,205
https://kawalpemilu.org#89423,"TOPOS, TOPOS, LEBONG, BENGKULU",2,108,76,184
https://kawalpemilu.org#89423,"TOPOS, TOPOS, LEBONG, BENGKULU",3,103,68,171
https://kawalpemilu.org#89423,"TOPOS, TOPOS, LEBONG, BENGKULU",4,108,83,191
https://kawalpemilu.org#89423,"TOPOS, TOPOS, LEBONG, BENGKULU",5,109,106,215
https://kawalpemilu.org#22072,"KARANG DAPO ATAS, BINGIN KUNING, LEBONG, BENGKULU",1,142,50,192
https://kawalpemilu.org#22072,"KARANG DAPO ATAS, BINGIN KUNING, LEBONG, BENGKULU",2,103,69,172
https://kawalpemilu.org#22072,"KARANG DAPO ATAS, BINGIN KUNING, LEBONG, BENGKULU",3,112,63,175
https://kawalpemilu.org#22072,"KARANG DAPO ATAS, BINGIN KUNING, LEBONG, BENGKULU",4,122,50,172
https://kawalpemilu.org#22072,"KARANG DAPO ATAS, BINGIN KUNING, LEBONG, BENGKULU",5,115,79,194
https://kawalpemilu.org#22073,"KARANG DAPO BAWAH, BINGIN KUNING, LEBONG, BENGKULU",1,162,57,219
https://kawalpemilu.org#22073,"KARANG DAPO BAWAH, BINGIN KUNING, LEBONG, BENGKULU",2,144,57,201
https://kawalpemilu.org#22073,"KARANG DAPO BAWAH, BINGIN KUNING, LEBONG, BENGKULU",3,140,99,239
https://kawalpemilu.org#22074,"PUNGGUK PEDARO, BINGIN KUNING, LEBONG, BENGKULU",1,104,83,187
https://kawalpemilu.org#22074,"PUNGGUK PEDARO, BINGIN KUNING, LEBONG, BENGKULU",2,126,59,185
https://kawalpemilu.org#22074,"PUNGGUK PEDARO, BINGIN KUNING, LEBONG, BENGKULU",3,75,66,141
https://kawalpemilu.org#22074,"PUNGGUK PEDARO, BINGIN KUNING, LEBONG, BENGKULU",4,92,68,160
https://kawalpemilu.org#22074,"PUNGGUK PEDARO, BINGIN KUNING, LEBONG, BENGKULU",5,107,68,175
https://kawalpemilu.org#22074,"PUNGGUK PEDARO, BINGIN KUNING, LEBONG, BENGKULU",6,79,88,167
https://kawalpemilu.org#22074,"PUNGGUK PEDARO, BINGIN KUNING, LEBONG, BENGKULU",7,77,104,183
https://kawalpemilu.org#22075,"TALANG KERINCI, BINGIN KUNING, LEBONG, BENGKULU",1,133,83,216
https://kawalpemilu.org#22075,"TALANG KERINCI, BINGIN KUNING, LEBONG, BENGKULU",2,146,62,208
https://kawalpemilu.org#22078,"BUNGIN, BINGIN KUNING, LEBONG, BENGKULU",2,101,75,176
https://kawalpemilu.org#22078,"BUNGIN, BINGIN KUNING, LEBONG, BENGKULU",3,131,80,211
https://kawalpemilu.org#22078,"BUNGIN, BINGIN KUNING, LEBONG, BENGKULU",4,102,73,175
https://kawalpemilu.org#84743,"BUKIT NIBUNG, BINGIN KUNING, LEBONG, BENGKULU",1,161,24,185
https://kawalpemilu.org#84744,"PELABUHAN TALANG LIAK, BINGIN KUNING, LEBONG, BENGKULU",1,90,70,160
https://kawalpemilu.org#84744,"PELABUHAN TALANG LIAK, BINGIN KUNING, LEBONG, BENGKULU",2,93,67,160
https://kawalpemilu.org#84744,"PELABUHAN TALANG LIAK, BINGIN KUNING, LEBONG, BENGKULU",3,136,48,184
https://kawalpemilu.org#84744,"PELABUHAN TALANG LIAK, BINGIN KUNING, LEBONG, BENGKULU",4,77,62,139
https://kawalpemilu.org#84745,"TALANG LIAK I, BINGIN KUNING, LEBONG, BENGKULU",1,117,72,189
https://kawalpemilu.org#84745,"TALANG LIAK I, BINGIN KUNING, LEBONG, BENGKULU",2,128,70,198
https://kawalpemilu.org#84745,"TALANG LIAK I, BINGIN KUNING, LEBONG, BENGKULU",3,121,71,192
https://kawalpemilu.org#84745,"TALANG LIAK I, BINGIN KUNING, LEBONG, BENGKULU",4,127,63,190
https://kawalpemilu.org#84745,"TALANG LIAK I, BINGIN KUNING, LEBONG, BENGKULU",5,129,54,183
https://kawalpemilu.org#84745,"TALANG LIAK I, BINGIN KUNING, LEBONG, BENGKULU",6,133,65,198
https://kawalpemilu.org#84746,"TALANG LIAK II, BINGIN KUNING, LEBONG, BENGKULU",1,131,39,170
https://kawalpemilu.org#84746,"TALANG LIAK II, BINGIN KUNING, LEBONG, BENGKULU",2,124,40,164
https://kawalpemilu.org#84746,"TALANG LIAK II, BINGIN KUNING, LEBONG, BENGKULU",3,105,39,144
https://kawalpemilu.org#84746,"TALANG LIAK II, BINGIN KUNING, LEBONG, BENGKULU",4,117,41,158
https://kawalpemilu.org#84746,"TALANG LIAK II, BINGIN KUNING, LEBONG, BENGKULU",5,130,47,177
https://kawalpemilu.org#22087,"SUKA BUMI, LEBONG SAKTI, LEBONG, BENGKULU",1,108,162,270
https://kawalpemilu.org#22087,"SUKA BUMI, LEBONG SAKTI, LEBONG, BENGKULU",2,119,139,258
https://kawalpemilu.org#22087,"SUKA BUMI, LEBONG SAKTI, LEBONG, BENGKULU",3,133,116,249
https://kawalpemilu.org#22090,"MAGELANG BARU, LEBONG SAKTI, LEBONG, BENGKULU",1,113,78,191
https://kawalpemilu.org#22090,"MAGELANG BARU, LEBONG SAKTI, LEBONG, BENGKULU",2,123,58,181
https://kawalpemilu.org#22090,"MAGELANG BARU, LEBONG SAKTI, LEBONG, BENGKULU",3,107,64,171
https://kawalpemilu.org#22090,"MAGELANG BARU, LEBONG SAKTI, LEBONG, BENGKULU",4,106,54,160
https://kawalpemilu.org#22090,"MAGELANG BARU, LEBONG SAKTI, LEBONG, BENGKULU",5,99,61,160
https://kawalpemilu.org#84747,"MUNING AGUNG, LEBONG SAKTI, LEBONG, BENGKULU",1,136,112,248
https://kawalpemilu.org#84747,"MUNING AGUNG, LEBONG SAKTI, LEBONG, BENGKULU",2,133,116,249
https://kawalpemilu.org#84748,"UJUNG TANJUNG III, LEBONG SAKTI, LEBONG, BENGKULU",1,98,110,208
https://kawalpemilu.org#84748,"UJUNG TANJUNG III, LEBONG SAKTI, LEBONG, BENGKULU",2,103,82,185
https://kawalpemilu.org#84749,"LEMEU PIT, LEBONG SAKTI, LEBONG, BENGKULU",1,108,64,172
https://kawalpemilu.org#84749,"LEMEU PIT, LEBONG SAKTI, LEBONG, BENGKULU",2,90,63,153
https://kawalpemilu.org#84749,"LEMEU PIT, LEBONG SAKTI, LEBONG, BENGKULU",3,91,68,159
https://kawalpemilu.org#84749,"LEMEU PIT, LEBONG SAKTI, LEBONG, BENGKULU",4,85,65,150
https://kawalpemilu.org#84750,"TABEAK KAUK, LEBONG SAKTI, LEBONG, BENGKULU",1,108,103,211
https://kawalpemilu.org#84750,"TABEAK KAUK, LEBONG SAKTI, LEBONG, BENGKULU",2,106,94,200
https://kawalpemilu.org#84751,"TABEAK DIPOA, LEBONG SAKTI, LEBONG, BENGKULU",1,101,128,229
https://kawalpemilu.org#84751,"TABEAK DIPOA, LEBONG SAKTI, LEBONG, BENGKULU",2,102,107,209
https://kawalpemilu.org#89432,"UJUNG TANJUNG I, LEBONG SAKTI, LEBONG, BENGKULU",1,106,64,170
https://kawalpemilu.org#89432,"UJUNG TANJUNG I, LEBONG SAKTI, LEBONG, BENGKULU",2,103,53,156
https://kawalpemilu.org#89432,"UJUNG TANJUNG I, LEBONG SAKTI, LEBONG, BENGKULU",3,117,46,163
https://kawalpemilu.org#89432,"UJUNG TANJUNG I, LEBONG SAKTI, LEBONG, BENGKULU",4,129,57,186
https://kawalpemilu.org#89432,"UJUNG TANJUNG I, LEBONG SAKTI, LEBONG, BENGKULU",5,92,69,161
https://kawalpemilu.org#89432,"UJUNG TANJUNG I, LEBONG SAKTI, LEBONG, BENGKULU",6,98,79,177
https://kawalpemilu.org#89433,"UJUNG TANJUNG II, LEBONG SAKTI, LEBONG, BENGKULU",1,121,68,189
https://kawalpemilu.org#89433,"UJUNG TANJUNG II, LEBONG SAKTI, LEBONG, BENGKULU",2,102,61,163
https://kawalpemilu.org#89433,"UJUNG TANJUNG II, LEBONG SAKTI, LEBONG, BENGKULU",3,109,57,166
https://kawalpemilu.org#89433,"UJUNG TANJUNG II, LEBONG SAKTI, LEBONG, BENGKULU",4,101,26,127
https://kawalpemilu.org#89433,"UJUNG TANJUNG II, LEBONG SAKTI, LEBONG, BENGKULU",5,82,33,115
https://kawalpemilu.org#89433,"UJUNG TANJUNG II, LEBONG SAKTI, LEBONG, BENGKULU",6,95,69,164
https://kawalpemilu.org#89433,"UJUNG TANJUNG II, LEBONG SAKTI, LEBONG, BENGKULU",7,66,60,126
https://kawalpemilu.org#22097,"KOTA BARU SANTAN, PELABAI, LEBONG, BENGKULU",1,73,123,196
https://kawalpemilu.org#22097,"KOTA BARU SANTAN, PELABAI, LEBONG, BENGKULU",2,120,118,238
https://kawalpemilu.org#22104,"GUNUNG ALAM, PELABAI, LEBONG, BENGKULU",1,84,79,163
https://kawalpemilu.org#22104,"GUNUNG ALAM, PELABAI, LEBONG, BENGKULU",2,88,106,194
https://kawalpemilu.org#22104,"GUNUNG ALAM, PELABAI, LEBONG, BENGKULU",3,84,69,153
https://kawalpemilu.org#22105,"TANJUNG AGUNG, PELABAI, LEBONG, BENGKULU",1,80,101,181
https://kawalpemilu.org#22105,"TANJUNG AGUNG, PELABAI, LEBONG, BENGKULU",2,68,81,149
https://kawalpemilu.org#22105,"TANJUNG AGUNG, PELABAI, LEBONG, BENGKULU",3,83,85,168
https://kawalpemilu.org#22105,"TANJUNG AGUNG, PELABAI, LEBONG, BENGKULU",4,65,98,163
https://kawalpemilu.org#84752,"SUKAU DATANG, PELABAI, LEBONG, BENGKULU",1,76,120,196
https://kawalpemilu.org#84752,"SUKAU DATANG, PELABAI, LEBONG, BENGKULU",2,87,100,187
https://kawalpemilu.org#84752,"SUKAU DATANG, PELABAI, LEBONG, BENGKULU",3,84,96,180
https://kawalpemilu.org#84752,"SUKAU DATANG, PELABAI, LEBONG, BENGKULU",4,98,118,216
https://kawalpemilu.org#84753,"SUKAU DATANG I, PELABAI, LEBONG, BENGKULU",1,111,108,219
https://kawalpemilu.org#84753,"SUKAU DATANG I, PELABAI, LEBONG, BENGKULU",2,101,135,236
https://kawalpemilu.org#84754,"TABEAK BLAU II, PELABAI, LEBONG, BENGKULU",1,118,82,200
https://kawalpemilu.org#84754,"TABEAK BLAU II, PELABAI, LEBONG, BENGKULU",2,72,96,168
https://kawalpemilu.org#84755,"TIK TELEU, PELABAI, LEBONG, BENGKULU",1,64,76,140
https://kawalpemilu.org#84755,"TIK TELEU, PELABAI, LEBONG, BENGKULU",2,105,71,176
https://kawalpemilu.org#84755,"TIK TELEU, PELABAI, LEBONG, BENGKULU",3,89,100,189
https://kawalpemilu.org#89434,"PELABAI, PELABAI, LEBONG, BENGKULU",1,100,104,204
https://kawalpemilu.org#89434,"PELABAI, PELABAI, LEBONG, BENGKULU",2,102,101,203
https://kawalpemilu.org#89434,"PELABAI, PELABAI, LEBONG, BENGKULU",3,129,113,242
https://kawalpemilu.org#22113,"GARUT, AMEN, LEBONG, BENGKULU",1,97,91,188
https://kawalpemilu.org#22113,"GARUT, AMEN, LEBONG, BENGKULU",2,78,112,190
https://kawalpemilu.org#22113,"GARUT, AMEN, LEBONG, BENGKULU",3,84,102,186
https://kawalpemilu.org#22119,"TALANG BUNUT, AMEN, LEBONG, BENGKULU",2,137,72,209
https://kawalpemilu.org#84757,"NANGAI TAYAU, AMEN, LEBONG, BENGKULU",1,90,109,199
https://kawalpemilu.org#84757,"NANGAI TAYAU, AMEN, LEBONG, BENGKULU",2,88,96,184
https://kawalpemilu.org#84757,"NANGAI TAYAU, AMEN, LEBONG, BENGKULU",3,78,103,181
https://kawalpemilu.org#84758,"NANGAI TAYAU I, AMEN, LEBONG, BENGKULU",1,130,133,263
https://kawalpemilu.org#84758,"NANGAI TAYAU I, AMEN, LEBONG, BENGKULU",2,130,103,233
https://kawalpemilu.org#84759,"PYANG MBIK, AMEN, LEBONG, BENGKULU",1,106,75,181
https://kawalpemilu.org#84759,"PYANG MBIK, AMEN, LEBONG, BENGKULU",2,106,86,192
https://kawalpemilu.org#84759,"PYANG MBIK, AMEN, LEBONG, BENGKULU",3,102,86,188
https://kawalpemilu.org#84760,"SUKAU MERGO, AMEN, LEBONG, BENGKULU",1,93,75,168
https://kawalpemilu.org#84760,"SUKAU MERGO, AMEN, LEBONG, BENGKULU",2,84,87,171
https://kawalpemilu.org#84760,"SUKAU MERGO, AMEN, LEBONG, BENGKULU",3,85,67,152
https://kawalpemilu.org#84761,"SUKAU RAJO, AMEN, LEBONG, BENGKULU",1,105,179,284
https://kawalpemilu.org#84762,"SELEBAR JAYA, AMEN, LEBONG, BENGKULU",1,84,94,178
https://kawalpemilu.org#84762,"SELEBAR JAYA, AMEN, LEBONG, BENGKULU",2,74,102,176
https://kawalpemilu.org#89308,"SUNGAI GERONG, AMEN, LEBONG, BENGKULU",1,78,105,183
https://kawalpemilu.org#89308,"SUNGAI GERONG, AMEN, LEBONG, BENGKULU",2,65,112,177
https://kawalpemilu.org#89308,"SUNGAI GERONG, AMEN, LEBONG, BENGKULU",3,69,115,184
https://kawalpemilu.org#89422,"AMEN, AMEN, LEBONG, BENGKULU",2,120,97,217
https://kawalpemilu.org#89422,"AMEN, AMEN, LEBONG, BENGKULU",3,105,108,213
https://kawalpemilu.org#89422,"AMEN, AMEN, LEBONG, BENGKULU",4,88,95,183
https://kawalpemilu.org#22114,"EMBONG, URAM JAYA, LEBONG, BENGKULU",1,121,86,207
https://kawalpemilu.org#22114,"EMBONG, URAM JAYA, LEBONG, BENGKULU",2,91,105,196
https://kawalpemilu.org#22115,"KOTA BARU, URAM JAYA, LEBONG, BENGKULU",1,123,120,243
https://kawalpemilu.org#22115,"KOTA BARU, URAM JAYA, LEBONG, BENGKULU",2,100,118,218
https://kawalpemilu.org#22116,"KOTA AGUNG, URAM JAYA, LEBONG, BENGKULU",1,68,123,191
https://kawalpemilu.org#22116,"KOTA AGUNG, URAM JAYA, LEBONG, BENGKULU",2,71,107,178
https://kawalpemilu.org#22116,"KOTA AGUNG, URAM JAYA, LEBONG, BENGKULU",3,80,101,181
https://kawalpemilu.org#22116,"KOTA AGUNG, URAM JAYA, LEBONG, BENGKULU",4,44,87,131
https://kawalpemilu.org#22116,"KOTA AGUNG, URAM JAYA, LEBONG, BENGKULU",5,64,80,144
https://kawalpemilu.org#84763,"EMBONG I, URAM JAYA, LEBONG, BENGKULU",1,94,79,173
https://kawalpemilu.org#84763,"EMBONG I, URAM JAYA, LEBONG, BENGKULU",2,67,85,152
https://kawalpemilu.org#84764,"LEMEU, URAM JAYA, LEBONG, BENGKULU",1,69,102,171
https://kawalpemilu.org#84764,"LEMEU, URAM JAYA, LEBONG, BENGKULU",2,80,89,169
https://kawalpemilu.org#84764,"LEMEU, URAM JAYA, LEBONG, BENGKULU",3,65,90,155
https://kawalpemilu.org#84764,"LEMEU, URAM JAYA, LEBONG, BENGKULU",4,82,90,172
https://kawalpemilu.org#84764,"LEMEU, URAM JAYA, LEBONG, BENGKULU",5,80,116,196
https://kawalpemilu.org#84765,"TANGUA, URAM JAYA, LEBONG, BENGKULU",1,75,95,170
https://kawalpemilu.org#84765,"TANGUA, URAM JAYA, LEBONG, BENGKULU",2,70,84,154
https://kawalpemilu.org#84765,"TANGUA, URAM JAYA, LEBONG, BENGKULU",3,83,76,159
https://kawalpemilu.org#89309,"PANGKALAN, URAM JAYA, LEBONG, BENGKULU",1,84,91,175
https://kawalpemilu.org#89309,"PANGKALAN, URAM JAYA, LEBONG, BENGKULU",2,81,96,177
https://kawalpemilu.org#22130,"AIR KOPRAS, PINANG BELAPIS, LEBONG, BENGKULU",1,81,86,167
https://kawalpemilu.org#22130,"AIR KOPRAS, PINANG BELAPIS, LEBONG, BENGKULU",2,66,126,192
https://kawalpemilu.org#22130,"AIR KOPRAS, PINANG BELAPIS, LEBONG, BENGKULU",3,68,95,163
https://kawalpemilu.org#22130,"AIR KOPRAS, PINANG BELAPIS, LEBONG, BENGKULU",4,84,105,189
https://kawalpemilu.org#22130,"AIR KOPRAS, PINANG BELAPIS, LEBONG, BENGKULU",5,87,101,188
https://kawalpemilu.org#84766,"KETENONG I, PINANG BELAPIS, LEBONG, BENGKULU",1,147,51,198
https://kawalpemilu.org#84766,"KETENONG I, PINANG BELAPIS, LEBONG, BENGKULU",2,126,48,174
https://kawalpemilu.org#84767,"KETENONG II, PINANG BELAPIS, LEBONG, BENGKULU",1,121,46,167
https://kawalpemilu.org#84767,"KETENONG II, PINANG BELAPIS, LEBONG, BENGKULU",2,128,54,182
https://kawalpemilu.org#84768,"KETENONG JAYA, PINANG BELAPIS, LEBONG, BENGKULU",1,192,25,217
https://kawalpemilu.org#84768,"KETENONG JAYA, PINANG BELAPIS, LEBONG, BENGKULU",2,151,37,188
https://kawalpemilu.org#84769,"TAMBANG SAWEAK, PINANG BELAPIS, LEBONG, BENGKULU",1,95,140,235
https://kawalpemilu.org#84769,"TAMBANG SAWEAK, PINANG BELAPIS, LEBONG, BENGKULU",2,116,116,232
https://kawalpemilu.org#84770,"BIOA PUTIAK, PINANG BELAPIS, LEBONG, BENGKULU",1,83,59,142
https://kawalpemilu.org#84770,"BIOA PUTIAK, PINANG BELAPIS, LEBONG, BENGKULU",2,81,60,141
https://kawalpemilu.org#84770,"BIOA PUTIAK, PINANG BELAPIS, LEBONG, BENGKULU",3,95,77,172
https://kawalpemilu.org#84771,"SEBELAT, PINANG BELAPIS, LEBONG, BENGKULU",1,138,44,183
https://kawalpemilu.org#84772,"SUNGAI LISAI, PINANG BELAPIS, LEBONG, BENGKULU",1,80,36,116
https://kawalpemilu.org#84772,"SUNGAI LISAI, PINANG BELAPIS, LEBONG, BENGKULU",2,28,7,35
https://kawalpemilu.org#22137,"KEBAN AGUNG, BERMANI ILIR, KEPAHIANG, BENGKULU",1,28,100,128
https://kawalpemilu.org#22137,"KEBAN AGUNG, BERMANI ILIR, KEPAHIANG, BENGKULU",2,48,72,120
https://kawalpemilu.org#22137,"KEBAN AGUNG, BERMANI ILIR, KEPAHIANG, BENGKULU",3,51,130,181
https://kawalpemilu.org#22137,"KEBAN AGUNG, BERMANI ILIR, KEPAHIANG, BENGKULU",4,51,91,142
https://kawalpemilu.org#22137,"KEBAN AGUNG, BERMANI ILIR, KEPAHIANG, BENGKULU",5,70,74,144
https://kawalpemilu.org#22137,"KEBAN AGUNG, BERMANI ILIR, KEPAHIANG, BENGKULU",6,147,58,205
https://kawalpemilu.org#22137,"KEBAN AGUNG, BERMANI ILIR, KEPAHIANG, BENGKULU",7,97,23,120
https://kawalpemilu.org#22138,"KOTA AGUNG, BERMANI ILIR, KEPAHIANG, BENGKULU",1,50,114,164
https://kawalpemilu.org#22138,"KOTA AGUNG, BERMANI ILIR, KEPAHIANG, BENGKULU",2,51,124,175
https://kawalpemilu.org#22139,"KEMBANG SERI, BERMANI ILIR, KEPAHIANG, BENGKULU",1,54,119,173
https://kawalpemilu.org#22139,"KEMBANG SERI, BERMANI ILIR, KEPAHIANG, BENGKULU",2,69,150,219
https://kawalpemilu.org#22139,"KEMBANG SERI, BERMANI ILIR, KEPAHIANG, BENGKULU",3,68,86,154
https://kawalpemilu.org#22139,"KEMBANG SERI, BERMANI ILIR, KEPAHIANG, BENGKULU",4,46,143,189
https://kawalpemilu.org#22140,"PAGAR AGUNG, BERMANI ILIR, KEPAHIANG, BENGKULU",1,52,112,164
https://kawalpemilu.org#22140,"PAGAR AGUNG, BERMANI ILIR, KEPAHIANG, BENGKULU",2,38,101,139
https://kawalpemilu.org#22140,"PAGAR AGUNG, BERMANI ILIR, KEPAHIANG, BENGKULU",3,46,61,107
https://kawalpemilu.org#22141,"EMBONG IJUK, BERMANI ILIR, KEPAHIANG, BENGKULU",1,53,111,164
https://kawalpemilu.org#22141,"EMBONG IJUK, BERMANI ILIR, KEPAHIANG, BENGKULU",2,65,128,193
https://kawalpemilu.org#22141,"EMBONG IJUK, BERMANI ILIR, KEPAHIANG, BENGKULU",3,47,143,190
https://kawalpemilu.org#22141,"EMBONG IJUK, BERMANI ILIR, KEPAHIANG, BENGKULU",4,53,101,154
https://kawalpemilu.org#22141,"EMBONG IJUK, BERMANI ILIR, KEPAHIANG, BENGKULU",5,55,136,191
https://kawalpemilu.org#22141,"EMBONG IJUK, BERMANI ILIR, KEPAHIANG, BENGKULU",6,42,125,167
https://kawalpemilu.org#22142,"GUNUNG AGUNG, BERMANI ILIR, KEPAHIANG, BENGKULU",1,51,78,129
https://kawalpemilu.org#22142,"GUNUNG AGUNG, BERMANI ILIR, KEPAHIANG, BENGKULU",2,49,84,133
https://kawalpemilu.org#22142,"GUNUNG AGUNG, BERMANI ILIR, KEPAHIANG, BENGKULU",3,67,109,176
https://kawalpemilu.org#22143,"TALANG PITO, BERMANI ILIR, KEPAHIANG, BENGKULU",1,80,115,195
https://kawalpemilu.org#22144,"CINTO MANDI, BERMANI ILIR, KEPAHIANG, BENGKULU",1,31,114,145
https://kawalpemilu.org#22144,"CINTO MANDI, BERMANI ILIR, KEPAHIANG, BENGKULU",2,39,117,156
https://kawalpemilu.org#22144,"CINTO MANDI, BERMANI ILIR, KEPAHIANG, BENGKULU",3,31,83,114
https://kawalpemilu.org#22144,"CINTO MANDI, BERMANI ILIR, KEPAHIANG, BENGKULU",4,37,103,140
https://kawalpemilu.org#22145,"LIMBUR LAMA, BERMANI ILIR, KEPAHIANG, BENGKULU",1,53,71,124
https://kawalpemilu.org#22145,"LIMBUR LAMA, BERMANI ILIR, KEPAHIANG, BENGKULU",2,38,92,130
https://kawalpemilu.org#22146,"TABA BARU, BERMANI ILIR, KEPAHIANG, BENGKULU",1,29,75,104
https://kawalpemilu.org#22146,"TABA BARU, BERMANI ILIR, KEPAHIANG, BENGKULU",2,28,117,145
https://kawalpemilu.org#22147,"BUKIT MENYAN, BERMANI ILIR, KEPAHIANG, BENGKULU",1,167,76,243
https://kawalpemilu.org#22147,"BUKIT MENYAN, BERMANI ILIR, KEPAHIANG, BENGKULU",2,166,73,239
https://kawalpemilu.org#22147,"BUKIT MENYAN, BERMANI ILIR, KEPAHIANG, BENGKULU",3,145,73,218
https://kawalpemilu.org#22148,"BATU BELARIK, BERMANI ILIR, KEPAHIANG, BENGKULU",1,47,91,138
https://kawalpemilu.org#22148,"BATU BELARIK, BERMANI ILIR, KEPAHIANG, BENGKULU",2,77,116,193
https://kawalpemilu.org#22148,"BATU BELARIK, BERMANI ILIR, KEPAHIANG, BENGKULU",3,69,114,183
https://kawalpemilu.org#22149,"EMBONG SIDO, BERMANI ILIR, KEPAHIANG, BENGKULU",1,51,117,168
https://kawalpemilu.org#22149,"EMBONG SIDO, BERMANI ILIR, KEPAHIANG, BENGKULU",2,57,118,175
https://kawalpemilu.org#22149,"EMBONG SIDO, BERMANI ILIR, KEPAHIANG, BENGKULU",3,71,127,198
https://kawalpemilu.org#22150,"TALANG SAWAH, BERMANI ILIR, KEPAHIANG, BENGKULU",1,35,112,147
https://kawalpemilu.org#22150,"TALANG SAWAH, BERMANI ILIR, KEPAHIANG, BENGKULU",2,27,106,133
https://kawalpemilu.org#22150,"TALANG SAWAH, BERMANI ILIR, KEPAHIANG, BENGKULU",3,58,63,121
https://kawalpemilu.org#22151,"SOSOKAN CINTA MANDI, BERMANI ILIR, KEPAHIANG, BENGKULU",1,77,132,209
https://kawalpemilu.org#22151,"SOSOKAN CINTA MANDI, BERMANI ILIR, KEPAHIANG, BENGKULU",2,62,152,214
https://kawalpemilu.org#22151,"SOSOKAN CINTA MANDI, BERMANI ILIR, KEPAHIANG, BENGKULU",3,58,95,153
https://kawalpemilu.org#22152,"MUARA LANGKAP, BERMANI ILIR, KEPAHIANG, BENGKULU",1,52,91,143
https://kawalpemilu.org#22152,"MUARA LANGKAP, BERMANI ILIR, KEPAHIANG, BENGKULU",2,82,64,146
https://kawalpemilu.org#22153,"AIR RAMAN, BERMANI ILIR, KEPAHIANG, BENGKULU",1,70,97,167
https://kawalpemilu.org#22153,"AIR RAMAN, BERMANI ILIR, KEPAHIANG, BENGKULU",2,35,64,99
https://kawalpemilu.org#22153,"AIR RAMAN, BERMANI ILIR, KEPAHIANG, BENGKULU",3,59,84,143
https://kawalpemilu.org#928210,"LANGGAR JAYA, BERMANI ILIR, KEPAHIANG, BENGKULU",1,28,61,89
https://kawalpemilu.org#928210,"LANGGAR JAYA, BERMANI ILIR, KEPAHIANG, BENGKULU",2,63,53,116
https://kawalpemilu.org#928211,"CINTA MANDI BARU, BERMANI ILIR, KEPAHIANG, BENGKULU",1,76,115,191
https://kawalpemilu.org#22155,"UJAN MAS ATAS, UJAN MAS, KEPAHIANG, BENGKULU",1,60,79,139
https://kawalpemilu.org#22155,"UJAN MAS ATAS, UJAN MAS, KEPAHIANG, BENGKULU",2,57,71,128
https://kawalpemilu.org#22155,"UJAN MAS ATAS, UJAN MAS, KEPAHIANG, BENGKULU",4,68,66,134
https://kawalpemilu.org#22155,"UJAN MAS ATAS, UJAN MAS, KEPAHIANG, BENGKULU",5,74,85,159
https://kawalpemilu.org#22155,"UJAN MAS ATAS, UJAN MAS, KEPAHIANG, BENGKULU",7,70,95,165
https://kawalpemilu.org#22155,"UJAN MAS ATAS, UJAN MAS, KEPAHIANG, BENGKULU",8,65,56,121
https://kawalpemilu.org#22155,"UJAN MAS ATAS, UJAN MAS, KEPAHIANG, BENGKULU",9,80,47,127
https://kawalpemilu.org#22155,"UJAN MAS ATAS, UJAN MAS, KEPAHIANG, BENGKULU",10,86,75,161
https://kawalpemilu.org#22155,"UJAN MAS ATAS, UJAN MAS, KEPAHIANG, BENGKULU",11,75,49,124
https://kawalpemilu.org#22155,"UJAN MAS ATAS, UJAN MAS, KEPAHIANG, BENGKULU",12,67,75,142
https://kawalpemilu.org#22155,"UJAN MAS ATAS, UJAN MAS, KEPAHIANG, BENGKULU",13,74,61,135
https://kawalpemilu.org#22155,"UJAN MAS ATAS, UJAN MAS, KEPAHIANG, BENGKULU",14,68,48,116
https://kawalpemilu.org#22156,"DASPETAH, UJAN MAS, KEPAHIANG, BENGKULU",1,84,28,112
https://kawalpemilu.org#22156,"DASPETAH, UJAN MAS, KEPAHIANG, BENGKULU",2,69,28,97
https://kawalpemilu.org#22156,"DASPETAH, UJAN MAS, KEPAHIANG, BENGKULU",3,148,53,201
https://kawalpemilu.org#22156,"DASPETAH, UJAN MAS, KEPAHIANG, BENGKULU",4,129,39,168
https://kawalpemilu.org#22156,"DASPETAH, UJAN MAS, KEPAHIANG, BENGKULU",6,110,40,150
https://kawalpemilu.org#22156,"DASPETAH, UJAN MAS, KEPAHIANG, BENGKULU",7,85,43,128
https://kawalpemilu.org#22156,"DASPETAH, UJAN MAS, KEPAHIANG, BENGKULU",8,153,29,182
https://kawalpemilu.org#22156,"DASPETAH, UJAN MAS, KEPAHIANG, BENGKULU",9,136,40,176
https://kawalpemilu.org#22156,"DASPETAH, UJAN MAS, KEPAHIANG, BENGKULU",10,105,40,145
https://kawalpemilu.org#22157,"SURO LEMBAK, UJAN MAS, KEPAHIANG, BENGKULU",1,111,105,216
https://kawalpemilu.org#22157,"SURO LEMBAK, UJAN MAS, KEPAHIANG, BENGKULU",2,111,123,234
https://kawalpemilu.org#22158,"TANJUNG ALAM, UJAN MAS, KEPAHIANG, BENGKULU",1,18,83,101
https://kawalpemilu.org#22158,"TANJUNG ALAM, UJAN MAS, KEPAHIANG, BENGKULU",2,26,96,122
https://kawalpemilu.org#22158,"TANJUNG ALAM, UJAN MAS, KEPAHIANG, BENGKULU",3,88,135,223
https://kawalpemilu.org#22158,"TANJUNG ALAM, UJAN MAS, KEPAHIANG, BENGKULU",4,56,149,205
https://kawalpemilu.org#22159,"SURO ILIR, UJAN MAS, KEPAHIANG, BENGKULU",1,74,91,165
https://kawalpemilu.org#22159,"SURO ILIR, UJAN MAS, KEPAHIANG, BENGKULU",2,90,89,179
https://kawalpemilu.org#22159,"SURO ILIR, UJAN MAS, KEPAHIANG, BENGKULU",3,90,94,184
https://kawalpemilu.org#22159,"SURO ILIR, UJAN MAS, KEPAHIANG, BENGKULU",4,78,109,187
https://kawalpemilu.org#22160,"SURO MUNCAR, UJAN MAS, KEPAHIANG, BENGKULU",1,102,98,200
https://kawalpemilu.org#22160,"SURO MUNCAR, UJAN MAS, KEPAHIANG, BENGKULU",2,99,68,167
https://kawalpemilu.org#22160,"SURO MUNCAR, UJAN MAS, KEPAHIANG, BENGKULU",3,81,92,173
https://kawalpemilu.org#22160,"SURO MUNCAR, UJAN MAS, KEPAHIANG, BENGKULU",4,99,101,200
https://kawalpemilu.org#22161,"SURO BARU, UJAN MAS, KEPAHIANG, BENGKULU",1,91,66,157
https://kawalpemilu.org#22161,"SURO BARU, UJAN MAS, KEPAHIANG, BENGKULU",2,86,70,156
https://kawalpemilu.org#22161,"SURO BARU, UJAN MAS, KEPAHIANG, BENGKULU",3,72,65,137
https://kawalpemilu.org#22161,"SURO BARU, UJAN MAS, KEPAHIANG, BENGKULU",4,65,75,140
https://kawalpemilu.org#22162,"PEKALONGAN, UJAN MAS, KEPAHIANG, BENGKULU",2,71,80,151
https://kawalpemilu.org#22162,"PEKALONGAN, UJAN MAS, KEPAHIANG, BENGKULU",3,94,79,173
https://kawalpemilu.org#22162,"PEKALONGAN, UJAN MAS, KEPAHIANG, BENGKULU",4,104,81,185
https://kawalpemilu.org#22162,"PEKALONGAN, UJAN MAS, KEPAHIANG, BENGKULU",5,94,90,184
https://kawalpemilu.org#22162,"PEKALONGAN, UJAN MAS, KEPAHIANG, BENGKULU",6,86,87,173
https://kawalpemilu.org#22163,"BUMI SARI, UJAN MAS, KEPAHIANG, BENGKULU",1,44,163,207
https://kawalpemilu.org#22163,"BUMI SARI, UJAN MAS, KEPAHIANG, BENGKULU",2,49,106,153
https://kawalpemilu.org#22163,"BUMI SARI, UJAN MAS, KEPAHIANG, BENGKULU",3,39,98,137
https://kawalpemilu.org#22163,"BUMI SARI, UJAN MAS, KEPAHIANG, BENGKULU",4,75,134,209
https://kawalpemilu.org#22163,"BUMI SARI, UJAN MAS, KEPAHIANG, BENGKULU",5,73,121,194
https://kawalpemilu.org#22163,"BUMI SARI, UJAN MAS, KEPAHIANG, BENGKULU",6,72,125,197
https://kawalpemilu.org#22164,"CUGUNG LALANG, UJAN MAS, KEPAHIANG, BENGKULU",1,64,90,154
https://kawalpemilu.org#22164,"CUGUNG LALANG, UJAN MAS, KEPAHIANG, BENGKULU",2,61,84,145
https://kawalpemilu.org#22165,"UJAN MAS BAWAH, UJAN MAS, KEPAHIANG, BENGKULU",1,87,73,160
https://kawalpemilu.org#22165,"UJAN MAS BAWAH, UJAN MAS, KEPAHIANG, BENGKULU",2,75,44,119
https://kawalpemilu.org#22165,"UJAN MAS BAWAH, UJAN MAS, KEPAHIANG, BENGKULU",3,79,66,145
https://kawalpemilu.org#22165,"UJAN MAS BAWAH, UJAN MAS, KEPAHIANG, BENGKULU",4,81,43,124
https://kawalpemilu.org#22166,"SURO BALI, UJAN MAS, KEPAHIANG, BENGKULU",1,104,39,143
https://kawalpemilu.org#22166,"SURO BALI, UJAN MAS, KEPAHIANG, BENGKULU",2,90,59,149
https://kawalpemilu.org#22167,"PUNGGUK MERANTI, UJAN MAS, KEPAHIANG, BENGKULU",1,81,168,249
https://kawalpemilu.org#22167,"PUNGGUK MERANTI, UJAN MAS, KEPAHIANG, BENGKULU",2,65,146,211
https://kawalpemilu.org#22167,"PUNGGUK MERANTI, UJAN MAS, KEPAHIANG, BENGKULU",3,62,127,189
https://kawalpemilu.org#22167,"PUNGGUK MERANTI, UJAN MAS, KEPAHIANG, BENGKULU",4,57,114,171
https://kawalpemilu.org#22168,"PUNGGUK BERINGANG, UJAN MAS, KEPAHIANG, BENGKULU",1,184,64,248
https://kawalpemilu.org#22168,"PUNGGUK BERINGANG, UJAN MAS, KEPAHIANG, BENGKULU",2,109,60,169
https://kawalpemilu.org#22169,"MERANTI JAYA, UJAN MAS, KEPAHIANG, BENGKULU",1,48,171,219
https://kawalpemilu.org#22169,"MERANTI JAYA, UJAN MAS, KEPAHIANG, BENGKULU",2,28,138,166
https://kawalpemilu.org#22169,"MERANTI JAYA, UJAN MAS, KEPAHIANG, BENGKULU",3,59,160,219
https://kawalpemilu.org#22169,"MERANTI JAYA, UJAN MAS, KEPAHIANG, BENGKULU",4,45,99,144
https://kawalpemilu.org#22169,"MERANTI JAYA, UJAN MAS, KEPAHIANG, BENGKULU",5,47,124,171
https://kawalpemilu.org#22169,"MERANTI JAYA, UJAN MAS, KEPAHIANG, BENGKULU",6,33,111,144
https://kawalpemilu.org#22170,"AIR HITAM, UJAN MAS, KEPAHIANG, BENGKULU",1,42,118,160
https://kawalpemilu.org#22170,"AIR HITAM, UJAN MAS, KEPAHIANG, BENGKULU",2,26,114,140
https://kawalpemilu.org#22171,"DASPETAH II, UJAN MAS, KEPAHIANG, BENGKULU",1,124,45,169
https://kawalpemilu.org#22171,"DASPETAH II, UJAN MAS, KEPAHIANG, BENGKULU",2,105,85,190
https://kawalpemilu.org#22171,"DASPETAH II, UJAN MAS, KEPAHIANG, BENGKULU",3,59,25,84
https://kawalpemilu.org#22171,"DASPETAH II, UJAN MAS, KEPAHIANG, BENGKULU",4,128,31,159
https://kawalpemilu.org#22171,"DASPETAH II, UJAN MAS, KEPAHIANG, BENGKULU",5,118,31,149
https://kawalpemilu.org#22171,"DASPETAH II, UJAN MAS, KEPAHIANG, BENGKULU",6,107,24,131
https://kawalpemilu.org#22173,"TEBAT KARAI, TEBAT KARAI, KEPAHIANG, BENGKULU",1,62,79,141
https://kawalpemilu.org#22173,"TEBAT KARAI, TEBAT KARAI, KEPAHIANG, BENGKULU",2,67,92,159
https://kawalpemilu.org#22173,"TEBAT KARAI, TEBAT KARAI, KEPAHIANG, BENGKULU",3,79,60,139
https://kawalpemilu.org#22173,"TEBAT KARAI, TEBAT KARAI, KEPAHIANG, BENGKULU",4,94,115,209
https://kawalpemilu.org#22173,"TEBAT KARAI, TEBAT KARAI, KEPAHIANG, BENGKULU",5,41,69,110
https://kawalpemilu.org#22173,"TEBAT KARAI, TEBAT KARAI, KEPAHIANG, BENGKULU",6,103,75,178
https://kawalpemilu.org#22174,"TABA SATING, TEBAT KARAI, KEPAHIANG, BENGKULU",1,92,86,178
https://kawalpemilu.org#22174,"TABA SATING, TEBAT KARAI, KEPAHIANG, BENGKULU",2,133,82,215
https://kawalpemilu.org#22175,"TERTIK, TEBAT KARAI, KEPAHIANG, BENGKULU",1,50,101,151
https://kawalpemilu.org#22175,"TERTIK, TEBAT KARAI, KEPAHIANG, BENGKULU",2,68,106,174
https://kawalpemilu.org#22175,"TERTIK, TEBAT KARAI, KEPAHIANG, BENGKULU",3,88,165,253
https://kawalpemilu.org#22176,"TALANG KARET, TEBAT KARAI, KEPAHIANG, BENGKULU",1,138,112,250
https://kawalpemilu.org#22176,"TALANG KARET, TEBAT KARAI, KEPAHIANG, BENGKULU",2,55,63,118
https://kawalpemilu.org#22176,"TALANG KARET, TEBAT KARAI, KEPAHIANG, BENGKULU",3,49,74,123
https://kawalpemilu.org#22176,"TALANG KARET, TEBAT KARAI, KEPAHIANG, BENGKULU",4,70,113,183
https://kawalpemilu.org#22176,"TALANG KARET, TEBAT KARAI, KEPAHIANG, BENGKULU",5,56,114,170
https://kawalpemilu.org#22176,"TALANG KARET, TEBAT KARAI, KEPAHIANG, BENGKULU",6,58,119,177
https://kawalpemilu.org#22177,"PERADUAN BINJAI, TEBAT KARAI, KEPAHIANG, BENGKULU",1,65,111,176
https://kawalpemilu.org#22177,"PERADUAN BINJAI, TEBAT KARAI, KEPAHIANG, BENGKULU",2,40,43,83
https://kawalpemilu.org#22177,"PERADUAN BINJAI, TEBAT KARAI, KEPAHIANG, BENGKULU",3,32,70,102
https://kawalpemilu.org#22177,"PERADUAN BINJAI, TEBAT KARAI, KEPAHIANG, BENGKULU",4,94,96,190
https://kawalpemilu.org#22177,"PERADUAN BINJAI, TEBAT KARAI, KEPAHIANG, BENGKULU",5,79,133,212
https://kawalpemilu.org#22178,"PENANJUNG PANJANG, TEBAT KARAI, KEPAHIANG, BENGKULU",1,86,95,181
https://kawalpemilu.org#22178,"PENANJUNG PANJANG, TEBAT KARAI, KEPAHIANG, BENGKULU",2,60,112,172
https://kawalpemilu.org#22178,"PENANJUNG PANJANG, TEBAT KARAI, KEPAHIANG, BENGKULU",3,47,100,147
https://kawalpemilu.org#22179,"NANTI AGUNG, TEBAT KARAI, KEPAHIANG, BENGKULU",1,53,74,127
https://kawalpemilu.org#22179,"NANTI AGUNG, TEBAT KARAI, KEPAHIANG, BENGKULU",2,76,67,143
https://kawalpemilu.org#22179,"NANTI AGUNG, TEBAT KARAI, KEPAHIANG, BENGKULU",3,44,102,146
https://kawalpemilu.org#22179,"NANTI AGUNG, TEBAT KARAI, KEPAHIANG, BENGKULU",4,76,145,221
https://kawalpemilu.org#22180,"TABA AIR PAUH, TEBAT KARAI, KEPAHIANG, BENGKULU",1,65,103,168
https://kawalpemilu.org#22180,"TABA AIR PAUH, TEBAT KARAI, KEPAHIANG, BENGKULU",2,63,52,115
https://kawalpemilu.org#22180,"TABA AIR PAUH, TEBAT KARAI, KEPAHIANG, BENGKULU",3,46,101,147
https://kawalpemilu.org#22180,"TABA AIR PAUH, TEBAT KARAI, KEPAHIANG, BENGKULU",4,69,101,170
https://kawalpemilu.org#22181,"KARANG TENGAH, TEBAT KARAI, KEPAHIANG, BENGKULU",1,73,65,138
https://kawalpemilu.org#22181,"KARANG TENGAH, TEBAT KARAI, KEPAHIANG, BENGKULU",2,51,87,138
https://kawalpemilu.org#22181,"KARANG TENGAH, TEBAT KARAI, KEPAHIANG, BENGKULU",3,61,104,165
https://kawalpemilu.org#22181,"KARANG TENGAH, TEBAT KARAI, KEPAHIANG, BENGKULU",4,50,86,136
https://kawalpemilu.org#22182,"TAPAK GEDUNG, TEBAT KARAI, KEPAHIANG, BENGKULU",1,111,109,220
https://kawalpemilu.org#22182,"TAPAK GEDUNG, TEBAT KARAI, KEPAHIANG, BENGKULU",2,71,129,200
https://kawalpemilu.org#22182,"TAPAK GEDUNG, TEBAT KARAI, KEPAHIANG, BENGKULU",3,77,59,136
https://kawalpemilu.org#22183,"TEBING PENYAMUN, TEBAT KARAI, KEPAHIANG, BENGKULU",1,64,151,215
https://kawalpemilu.org#22183,"TEBING PENYAMUN, TEBAT KARAI, KEPAHIANG, BENGKULU",2,84,133,217
https://kawalpemilu.org#22183,"TEBING PENYAMUN, TEBAT KARAI, KEPAHIANG, BENGKULU",3,60,101,161
https://kawalpemilu.org#22183,"TEBING PENYAMUN, TEBAT KARAI, KEPAHIANG, BENGKULU",4,80,127,207
https://kawalpemilu.org#22184,"SINAR GUNUNG, TEBAT KARAI, KEPAHIANG, BENGKULU",1,76,160,236
https://kawalpemilu.org#22184,"SINAR GUNUNG, TEBAT KARAI, KEPAHIANG, BENGKULU",2,118,124,242
https://kawalpemilu.org#22185,"TABA SALING, TEBAT KARAI, KEPAHIANG, BENGKULU",1,76,88,164
https://kawalpemilu.org#22185,"TABA SALING, TEBAT KARAI, KEPAHIANG, BENGKULU",2,81,103,184
https://kawalpemilu.org#22186,"PENANJUNG PANJANG ATAS, TEBAT KARAI, KEPAHIANG, BENGKULU",1,47,94,141
https://kawalpemilu.org#22186,"PENANJUNG PANJANG ATAS, TEBAT KARAI, KEPAHIANG, BENGKULU",2,52,127,179
https://kawalpemilu.org#22186,"PENANJUNG PANJANG ATAS, TEBAT KARAI, KEPAHIANG, BENGKULU",3,81,135,216
https://kawalpemilu.org#22186,"PENANJUNG PANJANG ATAS, TEBAT KARAI, KEPAHIANG, BENGKULU",4,46,85,131
https://kawalpemilu.org#22188,"PENSIUNAN, KEPAHIANG, KEPAHIANG, BENGKULU",1,23,69,92
https://kawalpemilu.org#22188,"PENSIUNAN, KEPAHIANG, KEPAHIANG, BENGKULU",2,40,132,172
https://kawalpemilu.org#22188,"PENSIUNAN, KEPAHIANG, KEPAHIANG, BENGKULU",3,56,121,177
https://kawalpemilu.org#22188,"PENSIUNAN, KEPAHIANG, KEPAHIANG, BENGKULU",4,65,215,280
https://kawalpemilu.org#22188,"PENSIUNAN, KEPAHIANG, KEPAHIANG, BENGKULU",5,30,77,107
https://kawalpemilu.org#22188,"PENSIUNAN, KEPAHIANG, KEPAHIANG, BENGKULU",6,24,69,93
https://kawalpemilu.org#22188,"PENSIUNAN, KEPAHIANG, KEPAHIANG, BENGKULU",7,51,94,145
https://kawalpemilu.org#22188,"PENSIUNAN, KEPAHIANG, KEPAHIANG, BENGKULU",8,23,74,97
https://kawalpemilu.org#22188,"PENSIUNAN, KEPAHIANG, KEPAHIANG, BENGKULU",9,69,172,241
https://kawalpemilu.org#22188,"PENSIUNAN, KEPAHIANG, KEPAHIANG, BENGKULU",10,32,81,113
https://kawalpemilu.org#22188,"PENSIUNAN, KEPAHIANG, KEPAHIANG, BENGKULU",11,57,62,119
https://kawalpemilu.org#22188,"PENSIUNAN, KEPAHIANG, KEPAHIANG, BENGKULU",12,34,67,101
https://kawalpemilu.org#22188,"PENSIUNAN, KEPAHIANG, KEPAHIANG, BENGKULU",13,89,121,210
https://kawalpemilu.org#22189,"PASAR KEPAHIANG, KEPAHIANG, KEPAHIANG, BENGKULU",1,19,109,128
https://kawalpemilu.org#22189,"PASAR KEPAHIANG, KEPAHIANG, KEPAHIANG, BENGKULU",2,44,108,152
https://kawalpemilu.org#22189,"PASAR KEPAHIANG, KEPAHIANG, KEPAHIANG, BENGKULU",3,28,122,150
https://kawalpemilu.org#22189,"PASAR KEPAHIANG, KEPAHIANG, KEPAHIANG, BENGKULU",4,34,35,69
https://kawalpemilu.org#22189,"PASAR KEPAHIANG, KEPAHIANG, KEPAHIANG, BENGKULU",5,30,55,85
https://kawalpemilu.org#22189,"PASAR KEPAHIANG, KEPAHIANG, KEPAHIANG, BENGKULU",6,32,77,109
https://kawalpemilu.org#22189,"PASAR KEPAHIANG, KEPAHIANG, KEPAHIANG, BENGKULU",7,42,83,125
https://kawalpemilu.org#22189,"PASAR KEPAHIANG, KEPAHIANG, KEPAHIANG, BENGKULU",8,99,116,215
https://kawalpemilu.org#22189,"PASAR KEPAHIANG, KEPAHIANG, KEPAHIANG, BENGKULU",9,78,105,183
https://kawalpemilu.org#22189,"PASAR KEPAHIANG, KEPAHIANG, KEPAHIANG, BENGKULU",10,30,80,110
https://kawalpemilu.org#22189,"PASAR KEPAHIANG, KEPAHIANG, KEPAHIANG, BENGKULU",11,94,132,226
https://kawalpemilu.org#22189,"PASAR KEPAHIANG, KEPAHIANG, KEPAHIANG, BENGKULU",12,53,75,128
https://kawalpemilu.org#22189,"PASAR KEPAHIANG, KEPAHIANG, KEPAHIANG, BENGKULU",13,25,88,113
https://kawalpemilu.org#22190,"PASAR UJUNG, KEPAHIANG, KEPAHIANG, BENGKULU",1,63,163,197
https://kawalpemilu.org#22190,"PASAR UJUNG, KEPAHIANG, KEPAHIANG, BENGKULU",2,85,140,225
https://kawalpemilu.org#22190,"PASAR UJUNG, KEPAHIANG, KEPAHIANG, BENGKULU",3,50,49,99
https://kawalpemilu.org#22190,"PASAR UJUNG, KEPAHIANG, KEPAHIANG, BENGKULU",4,93,97,190
https://kawalpemilu.org#22190,"PASAR UJUNG, KEPAHIANG, KEPAHIANG, BENGKULU",5,83,115,198
https://kawalpemilu.org#22190,"PASAR UJUNG, KEPAHIANG, KEPAHIANG, BENGKULU",6,52,103,155
https://kawalpemilu.org#22190,"PASAR UJUNG, KEPAHIANG, KEPAHIANG, BENGKULU",7,42,86,128
https://kawalpemilu.org#22190,"PASAR UJUNG, KEPAHIANG, KEPAHIANG, BENGKULU",8,52,131,184
https://kawalpemilu.org#22190,"PASAR UJUNG, KEPAHIANG, KEPAHIANG, BENGKULU",9,63,152,215
https://kawalpemilu.org#22190,"PASAR UJUNG, KEPAHIANG, KEPAHIANG, BENGKULU",10,47,133,180
https://kawalpemilu.org#22190,"PASAR UJUNG, KEPAHIANG, KEPAHIANG, BENGKULU",11,121,113,234
https://kawalpemilu.org#22190,"PASAR UJUNG, KEPAHIANG, KEPAHIANG, BENGKULU",12,75,73,148
https://kawalpemilu.org#22190,"PASAR UJUNG, KEPAHIANG, KEPAHIANG, BENGKULU",13,72,59,131
https://kawalpemilu.org#22190,"PASAR UJUNG, KEPAHIANG, KEPAHIANG, BENGKULU",14,65,98,163
https://kawalpemilu.org#22190,"PASAR UJUNG, KEPAHIANG, KEPAHIANG, BENGKULU",15,42,82,124
https://kawalpemilu.org#22190,"PASAR UJUNG, KEPAHIANG, KEPAHIANG, BENGKULU",16,55,149,204
https://kawalpemilu.org#22190,"PASAR UJUNG, KEPAHIANG, KEPAHIANG, BENGKULU",17,52,128,180
https://kawalpemilu.org#22191,"DUSUN KEPAHIANG, KEPAHIANG, KEPAHIANG, BENGKULU",1,62,87,149
https://kawalpemilu.org#22191,"DUSUN KEPAHIANG, KEPAHIANG, KEPAHIANG, BENGKULU",2,60,150,210
https://kawalpemilu.org#22191,"DUSUN KEPAHIANG, KEPAHIANG, KEPAHIANG, BENGKULU",3,87,189,276
https://kawalpemilu.org#22191,"DUSUN KEPAHIANG, KEPAHIANG, KEPAHIANG, BENGKULU",4,79,128,207
https://kawalpemilu.org#22191,"DUSUN KEPAHIANG, KEPAHIANG, KEPAHIANG, BENGKULU",5,75,100,175
https://kawalpemilu.org#22191,"DUSUN KEPAHIANG, KEPAHIANG, KEPAHIANG, BENGKULU",6,70,131,201
https://kawalpemilu.org#22191,"DUSUN KEPAHIANG, KEPAHIANG, KEPAHIANG, BENGKULU",7,75,75,150
https://kawalpemilu.org#22191,"DUSUN KEPAHIANG, KEPAHIANG, KEPAHIANG, BENGKULU",8,93,109,202
https://kawalpemilu.org#22191,"DUSUN KEPAHIANG, KEPAHIANG, KEPAHIANG, BENGKULU",9,58,65,125
https://kawalpemilu.org#22191,"DUSUN KEPAHIANG, KEPAHIANG, KEPAHIANG, BENGKULU",10,86,119,205
https://kawalpemilu.org#22192,"KELILIK, KEPAHIANG, KEPAHIANG, BENGKULU",1,65,144,209
https://kawalpemilu.org#22192,"KELILIK, KEPAHIANG, KEPAHIANG, BENGKULU",2,84,180,264
https://kawalpemilu.org#22193,"TEBAT MONOK, KEPAHIANG, KEPAHIANG, BENGKULU",1,63,116,179
https://kawalpemilu.org#22193,"TEBAT MONOK, KEPAHIANG, KEPAHIANG, BENGKULU",2,67,126,193
https://kawalpemilu.org#22193,"TEBAT MONOK, KEPAHIANG, KEPAHIANG, BENGKULU",3,49,149,198
https://kawalpemilu.org#22193,"TEBAT MONOK, KEPAHIANG, KEPAHIANG, BENGKULU",4,64,148,212
https://kawalpemilu.org#22193,"TEBAT MONOK, KEPAHIANG, KEPAHIANG, BENGKULU",5,72,151,223
https://kawalpemilu.org#22193,"TEBAT MONOK, KEPAHIANG, KEPAHIANG, BENGKULU",6,63,136,199
https://kawalpemilu.org#22193,"TEBAT MONOK, KEPAHIANG, KEPAHIANG, BENGKULU",7,66,142,208
https://kawalpemilu.org#22193,"TEBAT MONOK, KEPAHIANG, KEPAHIANG, BENGKULU",8,61,125,186
https://kawalpemilu.org#22193,"TEBAT MONOK, KEPAHIANG, KEPAHIANG, BENGKULU",9,55,105,160
https://kawalpemilu.org#22193,"TEBAT MONOK, KEPAHIANG, KEPAHIANG, BENGKULU",10,74,143,217
https://kawalpemilu.org#22193,"TEBAT MONOK, KEPAHIANG, KEPAHIANG, BENGKULU",11,88,169,257
https://kawalpemilu.org#22194,"PERMU, KEPAHIANG, KEPAHIANG, BENGKULU",1,86,113,199
https://kawalpemilu.org#22194,"PERMU, KEPAHIANG, KEPAHIANG, BENGKULU",2,66,109,175
https://kawalpemilu.org#22194,"PERMU, KEPAHIANG, KEPAHIANG, BENGKULU",3,77,125,202
https://kawalpemilu.org#22195,"IMIGRASI PERMU, KEPAHIANG, KEPAHIANG, BENGKULU",1,79,107,186
https://kawalpemilu.org#22195,"IMIGRASI PERMU, KEPAHIANG, KEPAHIANG, BENGKULU",2,70,110,180
https://kawalpemilu.org#22195,"IMIGRASI PERMU, KEPAHIANG, KEPAHIANG, BENGKULU",3,77,89,166
https://kawalpemilu.org#22195,"IMIGRASI PERMU, KEPAHIANG, KEPAHIANG, BENGKULU",4,111,85,196
https://kawalpemilu.org#22195,"IMIGRASI PERMU, KEPAHIANG, KEPAHIANG, BENGKULU",5,81,95,176
https://kawalpemilu.org#22195,"IMIGRASI PERMU, KEPAHIANG, KEPAHIANG, BENGKULU",6,78,102,180
https://kawalpemilu.org#22196,"KARANG ENDAH, KEPAHIANG, KEPAHIANG, BENGKULU",1,71,137,208
https://kawalpemilu.org#22197,"WESKUST, KEPAHIANG, KEPAHIANG, BENGKULU",1,68,110,178
https://kawalpemilu.org#22197,"WESKUST, KEPAHIANG, KEPAHIANG, BENGKULU",2,51,127,178
https://kawalpemilu.org#22197,"WESKUST, KEPAHIANG, KEPAHIANG, BENGKULU",3,66,73,139
https://kawalpemilu.org#22197,"WESKUST, KEPAHIANG, KEPAHIANG, BENGKULU",4,63,100,163
https://kawalpemilu.org#22198,"KAMPUNG BOGOR, KEPAHIANG, KEPAHIANG, BENGKULU",1,94,152,246
https://kawalpemilu.org#22198,"KAMPUNG BOGOR, KEPAHIANG, KEPAHIANG, BENGKULU",2,96,111,207
https://kawalpemilu.org#22198,"KAMPUNG BOGOR, KEPAHIANG, KEPAHIANG, BENGKULU",3,128,80,208
https://kawalpemilu.org#22198,"KAMPUNG BOGOR, KEPAHIANG, KEPAHIANG, BENGKULU",4,151,77,228
https://kawalpemilu.org#22199,"KUTO REJO, KEPAHIANG, KEPAHIANG, BENGKULU",1,109,147,256
https://kawalpemilu.org#22199,"KUTO REJO, KEPAHIANG, KEPAHIANG, BENGKULU",2,105,121,226
https://kawalpemilu.org#22199,"KUTO REJO, KEPAHIANG, KEPAHIANG, BENGKULU",3,107,153,260
https://kawalpemilu.org#22199,"KUTO REJO, KEPAHIANG, KEPAHIANG, BENGKULU",4,121,123,244
https://kawalpemilu.org#22200,"KARANG ANYAR, KEPAHIANG, KEPAHIANG, BENGKULU",1,115,141,256
https://kawalpemilu.org#22200,"KARANG ANYAR, KEPAHIANG, KEPAHIANG, BENGKULU",2,79,127,206
https://kawalpemilu.org#22201,"TABA TEBELET, KEPAHIANG, KEPAHIANG, BENGKULU",1,101,170,271
https://kawalpemilu.org#22201,"TABA TEBELET, KEPAHIANG, KEPAHIANG, BENGKULU",2,51,113,164
https://kawalpemilu.org#22201,"TABA TEBELET, KEPAHIANG, KEPAHIANG, BENGKULU",3,107,111,218
https://kawalpemilu.org#22201,"TABA TEBELET, KEPAHIANG, KEPAHIANG, BENGKULU",4,58,134,192
https://kawalpemilu.org#22202,"PELANGKIAN, KEPAHIANG, KEPAHIANG, BENGKULU",1,145,94,239
https://kawalpemilu.org#22202,"PELANGKIAN, KEPAHIANG, KEPAHIANG, BENGKULU",2,125,68,193
https://kawalpemilu.org#22202,"PELANGKIAN, KEPAHIANG, KEPAHIANG, BENGKULU",3,95,62,157
https://kawalpemilu.org#22202,"PELANGKIAN, KEPAHIANG, KEPAHIANG, BENGKULU",4,93,127,220
https://kawalpemilu.org#22203,"KELOBAK, KEPAHIANG, KEPAHIANG, BENGKULU",1,61,52,113
https://kawalpemilu.org#22203,"KELOBAK, KEPAHIANG, KEPAHIANG, BENGKULU",2,86,52,138
https://kawalpemilu.org#22203,"KELOBAK, KEPAHIANG, KEPAHIANG, BENGKULU",3,72,47,119
https://kawalpemilu.org#22203,"KELOBAK, KEPAHIANG, KEPAHIANG, BENGKULU",4,61,58,119
https://kawalpemilu.org#22203,"KELOBAK, KEPAHIANG, KEPAHIANG, BENGKULU",5,153,43,196
https://kawalpemilu.org#22203,"KELOBAK, KEPAHIANG, KEPAHIANG, BENGKULU",6,135,52,187
https://kawalpemilu.org#22204,"PAGAR GUNUNG, KEPAHIANG, KEPAHIANG, BENGKULU",1,119,77,196
https://kawalpemilu.org#22204,"PAGAR GUNUNG, KEPAHIANG, KEPAHIANG, BENGKULU",2,161,71,232
https://kawalpemilu.org#22204,"PAGAR GUNUNG, KEPAHIANG, KEPAHIANG, BENGKULU",3,148,64,212
https://kawalpemilu.org#22204,"PAGAR GUNUNG, KEPAHIANG, KEPAHIANG, BENGKULU",4,179,65,244
https://kawalpemilu.org#22205,"SUKAMERINDU, KEPAHIANG, KEPAHIANG, BENGKULU",1,62,103,165
https://kawalpemilu.org#22205,"SUKAMERINDU, KEPAHIANG, KEPAHIANG, BENGKULU",2,58,51,109
https://kawalpemilu.org#22205,"SUKAMERINDU, KEPAHIANG, KEPAHIANG, BENGKULU",3,48,54,102
https://kawalpemilu.org#22205,"SUKAMERINDU, KEPAHIANG, KEPAHIANG, BENGKULU",4,69,45,114
https://kawalpemilu.org#928212,"KAMPUNG PENSIUNAN, KEPAHIANG, KEPAHIANG, BENGKULU",1,64,123,187
https://kawalpemilu.org#928212,"KAMPUNG PENSIUNAN, KEPAHIANG, KEPAHIANG, BENGKULU",2,31,80,111
https://kawalpemilu.org#928212,"KAMPUNG PENSIUNAN, KEPAHIANG, KEPAHIANG, BENGKULU",3,56,84,140
https://kawalpemilu.org#928212,"KAMPUNG PENSIUNAN, KEPAHIANG, KEPAHIANG, BENGKULU",4,77,67,144
https://kawalpemilu.org#928212,"KAMPUNG PENSIUNAN, KEPAHIANG, KEPAHIANG, BENGKULU",5,57,113,170
https://kawalpemilu.org#928212,"KAMPUNG PENSIUNAN, KEPAHIANG, KEPAHIANG, BENGKULU",6,53,71,124
https://kawalpemilu.org#928212,"KAMPUNG PENSIUNAN, KEPAHIANG, KEPAHIANG, BENGKULU",7,79,86,165
https://kawalpemilu.org#928212,"KAMPUNG PENSIUNAN, KEPAHIANG, KEPAHIANG, BENGKULU",8,62,81,143
https://kawalpemilu.org#928213,"PASAR SEJANTUNG, KEPAHIANG, KEPAHIANG, BENGKULU",1,58,101,159
https://kawalpemilu.org#928213,"PASAR SEJANTUNG, KEPAHIANG, KEPAHIANG, BENGKULU",2,37,84,121
https://kawalpemilu.org#928213,"PASAR SEJANTUNG, KEPAHIANG, KEPAHIANG, BENGKULU",3,37,74,111
https://kawalpemilu.org#928213,"PASAR SEJANTUNG, KEPAHIANG, KEPAHIANG, BENGKULU",4,90,95,185
https://kawalpemilu.org#928213,"PASAR SEJANTUNG, KEPAHIANG, KEPAHIANG, BENGKULU",5,39,93,132
https://kawalpemilu.org#928213,"PASAR SEJANTUNG, KEPAHIANG, KEPAHIANG, BENGKULU",6,45,96,141
https://kawalpemilu.org#928213,"PASAR SEJANTUNG, KEPAHIANG, KEPAHIANG, BENGKULU",7,81,125,206
https://kawalpemilu.org#928213,"PASAR SEJANTUNG, KEPAHIANG, KEPAHIANG, BENGKULU",8,57,123,180
https://kawalpemilu.org#928214,"PADANG LEKAT, KEPAHIANG, KEPAHIANG, BENGKULU",1,90,204,294
https://kawalpemilu.org#928214,"PADANG LEKAT, KEPAHIANG, KEPAHIANG, BENGKULU",2,50,131,186
https://kawalpemilu.org#928214,"PADANG LEKAT, KEPAHIANG, KEPAHIANG, BENGKULU",3,66,166,232
https://kawalpemilu.org#928214,"PADANG LEKAT, KEPAHIANG, KEPAHIANG, BENGKULU",4,58,138,196
https://kawalpemilu.org#928214,"PADANG LEKAT, KEPAHIANG, KEPAHIANG, BENGKULU",5,64,179,243
https://kawalpemilu.org#928214,"PADANG LEKAT, KEPAHIANG, KEPAHIANG, BENGKULU",7,75,130,205
https://kawalpemilu.org#928214,"PADANG LEKAT, KEPAHIANG, KEPAHIANG, BENGKULU",8,59,172,231
https://kawalpemilu.org#928214,"PADANG LEKAT, KEPAHIANG, KEPAHIANG, BENGKULU",9,58,108,166
https://kawalpemilu.org#928214,"PADANG LEKAT, KEPAHIANG, KEPAHIANG, BENGKULU",10,40,131,171
https://kawalpemilu.org#928214,"PADANG LEKAT, KEPAHIANG, KEPAHIANG, BENGKULU",11,60,140,200
https://kawalpemilu.org#928214,"PADANG LEKAT, KEPAHIANG, KEPAHIANG, BENGKULU",12,68,159,227
https://kawalpemilu.org#928215,"BOGOR BARU, KEPAHIANG, KEPAHIANG, BENGKULU",1,95,147,242
https://kawalpemilu.org#928215,"BOGOR BARU, KEPAHIANG, KEPAHIANG, BENGKULU",2,99,161,260
https://kawalpemilu.org#928215,"BOGOR BARU, KEPAHIANG, KEPAHIANG, BENGKULU",3,102,146,248
https://kawalpemilu.org#928215,"BOGOR BARU, KEPAHIANG, KEPAHIANG, BENGKULU",4,139,146,285
https://kawalpemilu.org#928216,"PERMU BAWAH, KEPAHIANG, KEPAHIANG, BENGKULU",1,86,149,235
https://kawalpemilu.org#928216,"PERMU BAWAH, KEPAHIANG, KEPAHIANG, BENGKULU",2,106,119,225
https://kawalpemilu.org#22207,"DURIAN DEPUN, MERIGI, KEPAHIANG, BENGKULU",1,96,110,206
https://kawalpemilu.org#22207,"DURIAN DEPUN, MERIGI, KEPAHIANG, BENGKULU",2,98,119,217
https://kawalpemilu.org#22207,"DURIAN DEPUN, MERIGI, KEPAHIANG, BENGKULU",3,56,135,191
https://kawalpemilu.org#22207,"DURIAN DEPUN, MERIGI, KEPAHIANG, BENGKULU",4,75,141,216
https://kawalpemilu.org#22207,"DURIAN DEPUN, MERIGI, KEPAHIANG, BENGKULU",5,71,167,238
https://kawalpemilu.org#22207,"DURIAN DEPUN, MERIGI, KEPAHIANG, BENGKULU",6,66,175,241
https://kawalpemilu.org#22207,"DURIAN DEPUN, MERIGI, KEPAHIANG, BENGKULU",7,43,159,202
https://kawalpemilu.org#22207,"DURIAN DEPUN, MERIGI, KEPAHIANG, BENGKULU",8,38,101,139
https://kawalpemilu.org#22207,"DURIAN DEPUN, MERIGI, KEPAHIANG, BENGKULU",9,59,164,223
https://kawalpemilu.org#22207,"DURIAN DEPUN, MERIGI, KEPAHIANG, BENGKULU",10,62,137,199
https://kawalpemilu.org#22208,"PULO GETO, MERIGI, KEPAHIANG, BENGKULU",1,38,97,135
https://kawalpemilu.org#22208,"PULO GETO, MERIGI, KEPAHIANG, BENGKULU",2,55,116,171
https://kawalpemilu.org#22208,"PULO GETO, MERIGI, KEPAHIANG, BENGKULU",3,84,132,216
https://kawalpemilu.org#22208,"PULO GETO, MERIGI, KEPAHIANG, BENGKULU",4,56,92,148
https://kawalpemilu.org#22208,"PULO GETO, MERIGI, KEPAHIANG, BENGKULU",5,48,97,145
https://kawalpemilu.org#22209,"TABA MULAN, MERIGI, KEPAHIANG, BENGKULU",1,69,83,152
https://kawalpemilu.org#22209,"TABA MULAN, MERIGI, KEPAHIANG, BENGKULU",2,92,111,203
https://kawalpemilu.org#22209,"TABA MULAN, MERIGI, KEPAHIANG, BENGKULU",3,52,101,153
https://kawalpemilu.org#22209,"TABA MULAN, MERIGI, KEPAHIANG, BENGKULU",4,81,119,200
https://kawalpemilu.org#22210,"LUBUK PENYAMUN, MERIGI, KEPAHIANG, BENGKULU",1,50,102,152
https://kawalpemilu.org#22210,"LUBUK PENYAMUN, MERIGI, KEPAHIANG, BENGKULU",2,79,84,163
https://kawalpemilu.org#22210,"LUBUK PENYAMUN, MERIGI, KEPAHIANG, BENGKULU",3,114,107,221
https://kawalpemilu.org#22211,"SIMPANG KOTA BINGIN, MERIGI, KEPAHIANG, BENGKULU",1,62,130,192
https://kawalpemilu.org#22211,"SIMPANG KOTA BINGIN, MERIGI, KEPAHIANG, BENGKULU",2,61,121,182
https://kawalpemilu.org#22211,"SIMPANG KOTA BINGIN, MERIGI, KEPAHIANG, BENGKULU",3,82,124,206
https://kawalpemilu.org#22211,"SIMPANG KOTA BINGIN, MERIGI, KEPAHIANG, BENGKULU",4,83,143,226
https://kawalpemilu.org#22212,"BUKIT BARISAN, MERIGI, KEPAHIANG, BENGKULU",1,91,76,167
https://kawalpemilu.org#22212,"BUKIT BARISAN, MERIGI, KEPAHIANG, BENGKULU",2,98,51,149
https://kawalpemilu.org#22212,"BUKIT BARISAN, MERIGI, KEPAHIANG, BENGKULU",3,58,74,132
https://kawalpemilu.org#22212,"BUKIT BARISAN, MERIGI, KEPAHIANG, BENGKULU",4,90,51,141
https://kawalpemilu.org#22213,"BATU AMPAR, MERIGI, KEPAHIANG, BENGKULU",1,70,84,154
https://kawalpemilu.org#22213,"BATU AMPAR, MERIGI, KEPAHIANG, BENGKULU",2,76,111,187
https://kawalpemilu.org#22214,"PULO GETO BARU, MERIGI, KEPAHIANG, BENGKULU",1,49,172,221
https://kawalpemilu.org#22214,"PULO GETO BARU, MERIGI, KEPAHIANG, BENGKULU",2,55,116,171
https://kawalpemilu.org#22214,"PULO GETO BARU, MERIGI, KEPAHIANG, BENGKULU",3,26,136,162
https://kawalpemilu.org#22216,"TANGSI BARU, KABAWETAN, KEPAHIANG, BENGKULU",1,100,83,183
https://kawalpemilu.org#22216,"TANGSI BARU, KABAWETAN, KEPAHIANG, BENGKULU",2,87,52,139
https://kawalpemilu.org#22216,"TANGSI BARU, KABAWETAN, KEPAHIANG, BENGKULU",3,151,100,251
https://kawalpemilu.org#22216,"TANGSI BARU, KABAWETAN, KEPAHIANG, BENGKULU",4,97,76,173
https://kawalpemilu.org#22216,"TANGSI BARU, KABAWETAN, KEPAHIANG, BENGKULU",5,87,72,159
https://kawalpemilu.org#22216,"TANGSI BARU, KABAWETAN, KEPAHIANG, BENGKULU",6,111,103,214
https://kawalpemilu.org#22217,"BANDUNG BARU, KABAWETAN, KEPAHIANG, BENGKULU",1,129,33,162
https://kawalpemilu.org#22217,"BANDUNG BARU, KABAWETAN, KEPAHIANG, BENGKULU",2,139,19,158
https://kawalpemilu.org#22217,"BANDUNG BARU, KABAWETAN, KEPAHIANG, BENGKULU",3,47,31,78
https://kawalpemilu.org#22217,"BANDUNG BARU, KABAWETAN, KEPAHIANG, BENGKULU",4,165,17,182
https://kawalpemilu.org#22218,"BUKIT SARI, KABAWETAN, KEPAHIANG, BENGKULU",1,167,15,182
https://kawalpemilu.org#22218,"BUKIT SARI, KABAWETAN, KEPAHIANG, BENGKULU",2,142,24,166
https://kawalpemilu.org#22219,"TUGU REJO, KABAWETAN, KEPAHIANG, BENGKULU",1,171,37,208
https://kawalpemilu.org#22219,"TUGU REJO, KABAWETAN, KEPAHIANG, BENGKULU",2,191,52,243
https://kawalpemilu.org#22220,"SUKA SARI, KABAWETAN, KEPAHIANG, BENGKULU",1,134,60,194
https://kawalpemilu.org#22220,"SUKA SARI, KABAWETAN, KEPAHIANG, BENGKULU",2,153,47,200
https://kawalpemilu.org#22220,"SUKA SARI, KABAWETAN, KEPAHIANG, BENGKULU",3,133,18,151
https://kawalpemilu.org#22221,"AIR SEMPIANG, KABAWETAN, KEPAHIANG, BENGKULU",1,150,92,242
https://kawalpemilu.org#22221,"AIR SEMPIANG, KABAWETAN, KEPAHIANG, BENGKULU",2,170,74,244
https://kawalpemilu.org#22222,"TANGSI DUREN, KABAWETAN, KEPAHIANG, BENGKULU",1,121,77,198
https://kawalpemilu.org#22222,"TANGSI DUREN, KABAWETAN, KEPAHIANG, BENGKULU",2,145,61,206
https://kawalpemilu.org#22222,"TANGSI DUREN, KABAWETAN, KEPAHIANG, BENGKULU",3,141,62,203
https://kawalpemilu.org#22223,"BABAKAN BOGOR, KABAWETAN, KEPAHIANG, BENGKULU",1,82,80,162
https://kawalpemilu.org#22223,"BABAKAN BOGOR, KABAWETAN, KEPAHIANG, BENGKULU",2,107,50,157
https://kawalpemilu.org#22223,"BABAKAN BOGOR, KABAWETAN, KEPAHIANG, BENGKULU",3,113,63,176
https://kawalpemilu.org#22224,"BARAT WETAN, KABAWETAN, KEPAHIANG, BENGKULU",2,162,61,223
https://kawalpemilu.org#22224,"BARAT WETAN, KABAWETAN, KEPAHIANG, BENGKULU",3,121,62,183
https://kawalpemilu.org#22225,"PEMATANG DONOK, KABAWETAN, KEPAHIANG, BENGKULU",1,62,43,105
https://kawalpemilu.org#22225,"PEMATANG DONOK, KABAWETAN, KEPAHIANG, BENGKULU",2,56,56,112
https://kawalpemilu.org#22225,"PEMATANG DONOK, KABAWETAN, KEPAHIANG, BENGKULU",3,81,53,134
https://kawalpemilu.org#22225,"PEMATANG DONOK, KABAWETAN, KEPAHIANG, BENGKULU",4,103,75,178
https://kawalpemilu.org#22226,"SUMBER SARI, KABAWETAN, KEPAHIANG, BENGKULU",1,120,18,138
https://kawalpemilu.org#22226,"SUMBER SARI, KABAWETAN, KEPAHIANG, BENGKULU",2,130,19,149
https://kawalpemilu.org#22226,"SUMBER SARI, KABAWETAN, KEPAHIANG, BENGKULU",3,162,14,176
https://kawalpemilu.org#22226,"SUMBER SARI, KABAWETAN, KEPAHIANG, BENGKULU",4,130,25,155
https://kawalpemilu.org#22227,"MEKAR SARI, KABAWETAN, KEPAHIANG, BENGKULU",1,153,25,178
https://kawalpemilu.org#22227,"MEKAR SARI, KABAWETAN, KEPAHIANG, BENGKULU",2,200,28,228
https://kawalpemilu.org#22228,"SIDO MAKMUR, KABAWETAN, KEPAHIANG, BENGKULU",1,133,129,262
https://kawalpemilu.org#928217,"SIDO REJO, KABAWETAN, KEPAHIANG, BENGKULU",1,169,46,215
https://kawalpemilu.org#928217,"SIDO REJO, KABAWETAN, KEPAHIANG, BENGKULU",2,189,41,230
https://kawalpemilu.org#928218,"BANDUNG JAYA, KABAWETAN, KEPAHIANG, BENGKULU",1,172,22,194
https://kawalpemilu.org#928218,"BANDUNG JAYA, KABAWETAN, KEPAHIANG, BENGKULU",2,100,22,129
https://kawalpemilu.org#22231,"BENUANG GALING, SEBERANG MUSI, KEPAHIANG, BENGKULU",1,65,67,132
https://kawalpemilu.org#22231,"BENUANG GALING, SEBERANG MUSI, KEPAHIANG, BENGKULU",2,92,105,197
https://kawalpemilu.org#22231,"BENUANG GALING, SEBERANG MUSI, KEPAHIANG, BENGKULU",3,59,96,155
https://kawalpemilu.org#22231,"BENUANG GALING, SEBERANG MUSI, KEPAHIANG, BENGKULU",4,92,115,207
https://kawalpemilu.org#22232,"AIR SELIMANG, SEBERANG MUSI, KEPAHIANG, BENGKULU",1,95,43,138
https://kawalpemilu.org#22232,"AIR SELIMANG, SEBERANG MUSI, KEPAHIANG, BENGKULU",2,104,31,135
https://kawalpemilu.org#22232,"AIR SELIMANG, SEBERANG MUSI, KEPAHIANG, BENGKULU",3,95,44,139
https://kawalpemilu.org#22232,"AIR SELIMANG, SEBERANG MUSI, KEPAHIANG, BENGKULU",4,77,44,121
https://kawalpemilu.org#22233,"TEBAT LAUT, SEBERANG MUSI, KEPAHIANG, BENGKULU",1,79,127,206
https://kawalpemilu.org#22233,"TEBAT LAUT, SEBERANG MUSI, KEPAHIANG, BENGKULU",2,82,110,192
https://kawalpemilu.org#22234,"TEMDAK, SEBERANG MUSI, KEPAHIANG, BENGKULU",1,96,81,177
https://kawalpemilu.org#22234,"TEMDAK, SEBERANG MUSI, KEPAHIANG, BENGKULU",2,100,30,130
https://kawalpemilu.org#22235,"TABA PADANG, SEBERANG MUSI, KEPAHIANG, BENGKULU",1,145,62,207
https://kawalpemilu.org#22236,"LUBUK SAUNG, SEBERANG MUSI, KEPAHIANG, BENGKULU",1,93,137,230
https://kawalpemilu.org#22237,"KANDANG, SEBERANG MUSI, KEPAHIANG, BENGKULU",1,94,115,209
https://kawalpemilu.org#22237,"KANDANG, SEBERANG MUSI, KEPAHIANG, BENGKULU",2,63,68,131
https://kawalpemilu.org#22237,"KANDANG, SEBERANG MUSI, KEPAHIANG, BENGKULU",3,72,75,147
https://kawalpemilu.org#22238,"CIREBON BARU, SEBERANG MUSI, KEPAHIANG, BENGKULU",1,108,99,207
https://kawalpemilu.org#22238,"CIREBON BARU, SEBERANG MUSI, KEPAHIANG, BENGKULU",2,88,91,179
https://kawalpemilu.org#22239,"TALANG GELOMPOK, SEBERANG MUSI, KEPAHIANG, BENGKULU",1,130,116,246
https://kawalpemilu.org#22240,"AIR PESI, SEBERANG MUSI, KEPAHIANG, BENGKULU",1,106,66,172
https://kawalpemilu.org#22240,"AIR PESI, SEBERANG MUSI, KEPAHIANG, BENGKULU",2,131,63,194
https://kawalpemilu.org#928219,"TALANG BABATAN, SEBERANG MUSI, KEPAHIANG, BENGKULU",1,105,72,177
https://kawalpemilu.org#928219,"TALANG BABATAN, SEBERANG MUSI, KEPAHIANG, BENGKULU",2,115,93,208
https://kawalpemilu.org#928220,"BAYUNG, SEBERANG MUSI, KEPAHIANG, BENGKULU",1,66,60,126
https://kawalpemilu.org#928220,"BAYUNG, SEBERANG MUSI, KEPAHIANG, BENGKULU",2,81,66,147
https://kawalpemilu.org#928221,"SUNGAI JERNIH, SEBERANG MUSI, KEPAHIANG, BENGKULU",1,94,26,120
https://kawalpemilu.org#928221,"SUNGAI JERNIH, SEBERANG MUSI, KEPAHIANG, BENGKULU",2,75,30,105
https://kawalpemilu.org#22242,"LIMBUR BARU, MUARA KEMUMU, KEPAHIANG, BENGKULU",1,114,87,201
https://kawalpemilu.org#22242,"LIMBUR BARU, MUARA KEMUMU, KEPAHIANG, BENGKULU",2,115,88,203
https://kawalpemilu.org#22243,"BATU KALUNG, MUARA KEMUMU, KEPAHIANG, BENGKULU",1,76,135,211
https://kawalpemilu.org#22243,"BATU KALUNG, MUARA KEMUMU, KEPAHIANG, BENGKULU",2,68,98,166
https://kawalpemilu.org#22243,"BATU KALUNG, MUARA KEMUMU, KEPAHIANG, BENGKULU",3,66,109,175
https://kawalpemilu.org#22243,"BATU KALUNG, MUARA KEMUMU, KEPAHIANG, BENGKULU",4,48,77,125
https://kawalpemilu.org#22243,"BATU KALUNG, MUARA KEMUMU, KEPAHIANG, BENGKULU",5,68,88,156
https://kawalpemilu.org#22243,"BATU KALUNG, MUARA KEMUMU, KEPAHIANG, BENGKULU",6,50,90,140
https://kawalpemilu.org#22243,"BATU KALUNG, MUARA KEMUMU, KEPAHIANG, BENGKULU",7,55,82,137
https://kawalpemilu.org#22243,"BATU KALUNG, MUARA KEMUMU, KEPAHIANG, BENGKULU",8,74,108,182
https://kawalpemilu.org#22244,"BATU BANDUNG, MUARA KEMUMU, KEPAHIANG, BENGKULU",1,82,114,196
https://kawalpemilu.org#22244,"BATU BANDUNG, MUARA KEMUMU, KEPAHIANG, BENGKULU",2,61,124,185
https://kawalpemilu.org#22244,"BATU BANDUNG, MUARA KEMUMU, KEPAHIANG, BENGKULU",3,74,161,235
https://kawalpemilu.org#22244,"BATU BANDUNG, MUARA KEMUMU, KEPAHIANG, BENGKULU",4,29,91,120
https://kawalpemilu.org#22244,"BATU BANDUNG, MUARA KEMUMU, KEPAHIANG, BENGKULU",5,45,111,156
https://kawalpemilu.org#22244,"BATU BANDUNG, MUARA KEMUMU, KEPAHIANG, BENGKULU",6,56,34,90
https://kawalpemilu.org#22244,"BATU BANDUNG, MUARA KEMUMU, KEPAHIANG, BENGKULU",7,92,84,176
https://kawalpemilu.org#22244,"BATU BANDUNG, MUARA KEMUMU, KEPAHIANG, BENGKULU",8,67,71,138
https://kawalpemilu.org#22244,"BATU BANDUNG, MUARA KEMUMU, KEPAHIANG, BENGKULU",9,92,143,235
https://kawalpemilu.org#22244,"BATU BANDUNG, MUARA KEMUMU, KEPAHIANG, BENGKULU",10,45,55,97
https://kawalpemilu.org#22244,"BATU BANDUNG, MUARA KEMUMU, KEPAHIANG, BENGKULU",11,75,66,141
https://kawalpemilu.org#22244,"BATU BANDUNG, MUARA KEMUMU, KEPAHIANG, BENGKULU",12,77,169,246
https://kawalpemilu.org#22244,"BATU BANDUNG, MUARA KEMUMU, KEPAHIANG, BENGKULU",13,47,100,147
https://kawalpemilu.org#22244,"BATU BANDUNG, MUARA KEMUMU, KEPAHIANG, BENGKULU",14,74,55,129
https://kawalpemilu.org#22244,"BATU BANDUNG, MUARA KEMUMU, KEPAHIANG, BENGKULU",15,54,60,114
https://kawalpemilu.org#22244,"BATU BANDUNG, MUARA KEMUMU, KEPAHIANG, BENGKULU",16,40,120,160
https://kawalpemilu.org#22244,"BATU BANDUNG, MUARA KEMUMU, KEPAHIANG, BENGKULU",17,78,72,150
https://kawalpemilu.org#22244,"BATU BANDUNG, MUARA KEMUMU, KEPAHIANG, BENGKULU",18,86,96,182
https://kawalpemilu.org#22244,"BATU BANDUNG, MUARA KEMUMU, KEPAHIANG, BENGKULU",19,99,41,140
https://kawalpemilu.org#22244,"BATU BANDUNG, MUARA KEMUMU, KEPAHIANG, BENGKULU",20,130,59,189
https://kawalpemilu.org#22244,"BATU BANDUNG, MUARA KEMUMU, KEPAHIANG, BENGKULU",21,106,58,164
https://kawalpemilu.org#22244,"BATU BANDUNG, MUARA KEMUMU, KEPAHIANG, BENGKULU",22,120,64,184
https://kawalpemilu.org#22244,"BATU BANDUNG, MUARA KEMUMU, KEPAHIANG, BENGKULU",23,126,75,201
https://kawalpemilu.org#22244,"BATU BANDUNG, MUARA KEMUMU, KEPAHIANG, BENGKULU",24,85,104,189
https://kawalpemilu.org#22244,"BATU BANDUNG, MUARA KEMUMU, KEPAHIANG, BENGKULU",25,87,73,159
https://kawalpemilu.org#22244,"BATU BANDUNG, MUARA KEMUMU, KEPAHIANG, BENGKULU",26,82,65,147
https://kawalpemilu.org#22244,"BATU BANDUNG, MUARA KEMUMU, KEPAHIANG, BENGKULU",27,14,99,113
https://kawalpemilu.org#22244,"BATU BANDUNG, MUARA KEMUMU, KEPAHIANG, BENGKULU",28,42,55,97
https://kawalpemilu.org#22245,"SOSOKAN BARU, MUARA KEMUMU, KEPAHIANG, BENGKULU",1,64,127,191
https://kawalpemilu.org#22245,"SOSOKAN BARU, MUARA KEMUMU, KEPAHIANG, BENGKULU",2,52,117,169
https://kawalpemilu.org#22245,"SOSOKAN BARU, MUARA KEMUMU, KEPAHIANG, BENGKULU",3,64,114,178
https://kawalpemilu.org#22245,"SOSOKAN BARU, MUARA KEMUMU, KEPAHIANG, BENGKULU",4,62,108,170
https://kawalpemilu.org#22246,"SOSOKAN TABA, MUARA KEMUMU, KEPAHIANG, BENGKULU",1,113,153,266
https://kawalpemilu.org#22246,"SOSOKAN TABA, MUARA KEMUMU, KEPAHIANG, BENGKULU",2,80,141,221
https://kawalpemilu.org#22246,"SOSOKAN TABA, MUARA KEMUMU, KEPAHIANG, BENGKULU",3,114,129,243
https://kawalpemilu.org#22246,"SOSOKAN TABA, MUARA KEMUMU, KEPAHIANG, BENGKULU",4,85,103,188
https://kawalpemilu.org#22246,"SOSOKAN TABA, MUARA KEMUMU, KEPAHIANG, BENGKULU",5,62,133,195
https://kawalpemilu.org#22246,"SOSOKAN TABA, MUARA KEMUMU, KEPAHIANG, BENGKULU",6,59,114,173
https://kawalpemilu.org#22246,"SOSOKAN TABA, MUARA KEMUMU, KEPAHIANG, BENGKULU",7,58,83,141
https://kawalpemilu.org#22246,"SOSOKAN TABA, MUARA KEMUMU, KEPAHIANG, BENGKULU",8,60,108,168
https://kawalpemilu.org#22246,"SOSOKAN TABA, MUARA KEMUMU, KEPAHIANG, BENGKULU",9,67,120,187
https://kawalpemilu.org#22246,"SOSOKAN TABA, MUARA KEMUMU, KEPAHIANG, BENGKULU",10,72,116,188
https://kawalpemilu.org#22246,"SOSOKAN TABA, MUARA KEMUMU, KEPAHIANG, BENGKULU",11,84,93,177
https://kawalpemilu.org#22246,"SOSOKAN TABA, MUARA KEMUMU, KEPAHIANG, BENGKULU",12,71,123,194
https://kawalpemilu.org#22246,"SOSOKAN TABA, MUARA KEMUMU, KEPAHIANG, BENGKULU",13,105,47,152
https://kawalpemilu.org#22246,"SOSOKAN TABA, MUARA KEMUMU, KEPAHIANG, BENGKULU",14,149,119,268
https://kawalpemilu.org#22246,"SOSOKAN TABA, MUARA KEMUMU, KEPAHIANG, BENGKULU",15,92,80,172
https://kawalpemilu.org#22246,"SOSOKAN TABA, MUARA KEMUMU, KEPAHIANG, BENGKULU",16,102,71,173
https://kawalpemilu.org#22246,"SOSOKAN TABA, MUARA KEMUMU, KEPAHIANG, BENGKULU",17,25,218,243
https://kawalpemilu.org#22247,"TALANG TIGE, MUARA KEMUMU, KEPAHIANG, BENGKULU",1,70,77,147
https://kawalpemilu.org#22247,"TALANG TIGE, MUARA KEMUMU, KEPAHIANG, BENGKULU",2,92,141,233
https://kawalpemilu.org#22247,"TALANG TIGE, MUARA KEMUMU, KEPAHIANG, BENGKULU",3,105,81,186
https://kawalpemilu.org#22247,"TALANG TIGE, MUARA KEMUMU, KEPAHIANG, BENGKULU",4,138,125,263
https://kawalpemilu.org#22248,"RENAH KURUNG, MUARA KEMUMU, KEPAHIANG, BENGKULU",1,117,89,206
https://kawalpemilu.org#22248,"RENAH KURUNG, MUARA KEMUMU, KEPAHIANG, BENGKULU",2,133,88,221
https://kawalpemilu.org#22248,"RENAH KURUNG, MUARA KEMUMU, KEPAHIANG, BENGKULU",3,90,76,166
https://kawalpemilu.org#22248,"RENAH KURUNG, MUARA KEMUMU, KEPAHIANG, BENGKULU",4,104,103,207
https://kawalpemilu.org#22248,"RENAH KURUNG, MUARA KEMUMU, KEPAHIANG, BENGKULU",5,83,114,197
https://kawalpemilu.org#22248,"RENAH KURUNG, MUARA KEMUMU, KEPAHIANG, BENGKULU",6,115,50,165
https://kawalpemilu.org#928222,"WARUNG POJOK, MUARA KEMUMU, KEPAHIANG, BENGKULU",1,92,58,150
https://kawalpemilu.org#928222,"WARUNG POJOK, MUARA KEMUMU, KEPAHIANG, BENGKULU",2,81,64,145
https://kawalpemilu.org#928222,"WARUNG POJOK, MUARA KEMUMU, KEPAHIANG, BENGKULU",3,111,72,183
https://kawalpemilu.org#928222,"WARUNG POJOK, MUARA KEMUMU, KEPAHIANG, BENGKULU",4,80,26,106
https://kawalpemilu.org#22254,"SUKARAMI, SELEBAR, KOTA BENGKULU, BENGKULU",1,83,172,255
https://kawalpemilu.org#22254,"SUKARAMI, SELEBAR, KOTA BENGKULU, BENGKULU",2,87,182,269
https://kawalpemilu.org#22254,"SUKARAMI, SELEBAR, KOTA BENGKULU, BENGKULU",3,62,146,208
https://kawalpemilu.org#22254,"SUKARAMI, SELEBAR, KOTA BENGKULU, BENGKULU",4,76,148,224
https://kawalpemilu.org#22254,"SUKARAMI, SELEBAR, KOTA BENGKULU, BENGKULU",5,56,142,198
https://kawalpemilu.org#22254,"SUKARAMI, SELEBAR, KOTA BENGKULU, BENGKULU",6,60,164,224
https://kawalpemilu.org#22254,"SUKARAMI, SELEBAR, KOTA BENGKULU, BENGKULU",7,64,77,141
https://kawalpemilu.org#22254,"SUKARAMI, SELEBAR, KOTA BENGKULU, BENGKULU",8,86,163,249
https://kawalpemilu.org#22254,"SUKARAMI, SELEBAR, KOTA BENGKULU, BENGKULU",9,77,118,195
https://kawalpemilu.org#22254,"SUKARAMI, SELEBAR, KOTA BENGKULU, BENGKULU",10,75,113,188
https://kawalpemilu.org#22254,"SUKARAMI, SELEBAR, KOTA BENGKULU, BENGKULU",11,79,103,182
https://kawalpemilu.org#22254,"SUKARAMI, SELEBAR, KOTA BENGKULU, BENGKULU",12,90,183,273
https://kawalpemilu.org#22254,"SUKARAMI, SELEBAR, KOTA BENGKULU, BENGKULU",13,43,146,189
https://kawalpemilu.org#22254,"SUKARAMI, SELEBAR, KOTA BENGKULU, BENGKULU",14,36,107,143
https://kawalpemilu.org#22254,"SUKARAMI, SELEBAR, KOTA BENGKULU, BENGKULU",15,45,96,141
https://kawalpemilu.org#22254,"SUKARAMI, SELEBAR, KOTA BENGKULU, BENGKULU",16,59,151,210
https://kawalpemilu.org#22254,"SUKARAMI, SELEBAR, KOTA BENGKULU, BENGKULU",17,87,61,148
https://kawalpemilu.org#22254,"SUKARAMI, SELEBAR, KOTA BENGKULU, BENGKULU",18,117,127,244
https://kawalpemilu.org#22254,"SUKARAMI, SELEBAR, KOTA BENGKULU, BENGKULU",19,109,100,209
https://kawalpemilu.org#22254,"SUKARAMI, SELEBAR, KOTA BENGKULU, BENGKULU",20,150,114,264
https://kawalpemilu.org#22254,"SUKARAMI, SELEBAR, KOTA BENGKULU, BENGKULU",21,89,143,232
https://kawalpemilu.org#22254,"SUKARAMI, SELEBAR, KOTA BENGKULU, BENGKULU",22,88,174,262
https://kawalpemilu.org#22254,"SUKARAMI, SELEBAR, KOTA BENGKULU, BENGKULU",23,101,107,208
https://kawalpemilu.org#22254,"SUKARAMI, SELEBAR, KOTA BENGKULU, BENGKULU",24,84,138,222
https://kawalpemilu.org#22254,"SUKARAMI, SELEBAR, KOTA BENGKULU, BENGKULU",25,110,66,176
https://kawalpemilu.org#22254,"SUKARAMI, SELEBAR, KOTA BENGKULU, BENGKULU",26,107,58,165
https://kawalpemilu.org#22254,"SUKARAMI, SELEBAR, KOTA BENGKULU, BENGKULU",27,50,83,133
https://kawalpemilu.org#22254,"SUKARAMI, SELEBAR, KOTA BENGKULU, BENGKULU",28,76,101,177
https://kawalpemilu.org#22254,"SUKARAMI, SELEBAR, KOTA BENGKULU, BENGKULU",29,93,150,243
https://kawalpemilu.org#22254,"SUKARAMI, SELEBAR, KOTA BENGKULU, BENGKULU",30,103,112,215
https://kawalpemilu.org#22254,"SUKARAMI, SELEBAR, KOTA BENGKULU, BENGKULU",31,93,82,175
https://kawalpemilu.org#22254,"SUKARAMI, SELEBAR, KOTA BENGKULU, BENGKULU",32,112,117,229
https://kawalpemilu.org#22255,"PAGAR DEWA, SELEBAR, KOTA BENGKULU, BENGKULU",1,116,95,211
https://kawalpemilu.org#22255,"PAGAR DEWA, SELEBAR, KOTA BENGKULU, BENGKULU",2,93,159,252
https://kawalpemilu.org#22255,"PAGAR DEWA, SELEBAR, KOTA BENGKULU, BENGKULU",3,65,100,165
https://kawalpemilu.org#22255,"PAGAR DEWA, SELEBAR, KOTA BENGKULU, BENGKULU",4,80,139,219
https://kawalpemilu.org#22255,"PAGAR DEWA, SELEBAR, KOTA BENGKULU, BENGKULU",5,36,121,157
https://kawalpemilu.org#22255,"PAGAR DEWA, SELEBAR, KOTA BENGKULU, BENGKULU",6,99,101,200
https://kawalpemilu.org#22255,"PAGAR DEWA, SELEBAR, KOTA BENGKULU, BENGKULU",7,107,109,216
https://kawalpemilu.org#22255,"PAGAR DEWA, SELEBAR, KOTA BENGKULU, BENGKULU",8,124,102,226
https://kawalpemilu.org#22255,"PAGAR DEWA, SELEBAR, KOTA BENGKULU, BENGKULU",9,94,115,209
https://kawalpemilu.org#22255,"PAGAR DEWA, SELEBAR, KOTA BENGKULU, BENGKULU",10,72,125,197
https://kawalpemilu.org#22255,"PAGAR DEWA, SELEBAR, KOTA BENGKULU, BENGKULU",11,69,100,169
https://kawalpemilu.org#22255,"PAGAR DEWA, SELEBAR, KOTA BENGKULU, BENGKULU",12,108,106,214
https://kawalpemilu.org#22255,"PAGAR DEWA, SELEBAR, KOTA BENGKULU, BENGKULU",13,78,86,164
https://kawalpemilu.org#22255,"PAGAR DEWA, SELEBAR, KOTA BENGKULU, BENGKULU",14,70,111,181
https://kawalpemilu.org#22255,"PAGAR DEWA, SELEBAR, KOTA BENGKULU, BENGKULU",15,56,39,95
https://kawalpemilu.org#22255,"PAGAR DEWA, SELEBAR, KOTA BENGKULU, BENGKULU",16,90,162,252
https://kawalpemilu.org#22255,"PAGAR DEWA, SELEBAR, KOTA BENGKULU, BENGKULU",17,83,76,159
https://kawalpemilu.org#22255,"PAGAR DEWA, SELEBAR, KOTA BENGKULU, BENGKULU",18,100,77,177
https://kawalpemilu.org#22255,"PAGAR DEWA, SELEBAR, KOTA BENGKULU, BENGKULU",19,77,85,162
https://kawalpemilu.org#22255,"PAGAR DEWA, SELEBAR, KOTA BENGKULU, BENGKULU",20,62,162,224
https://kawalpemilu.org#22255,"PAGAR DEWA, SELEBAR, KOTA BENGKULU, BENGKULU",21,36,81,117
https://kawalpemilu.org#22255,"PAGAR DEWA, SELEBAR, KOTA BENGKULU, BENGKULU",22,38,86,124
https://kawalpemilu.org#22255,"PAGAR DEWA, SELEBAR, KOTA BENGKULU, BENGKULU",23,57,57,133
https://kawalpemilu.org#22255,"PAGAR DEWA, SELEBAR, KOTA BENGKULU, BENGKULU",24,90,124,214
https://kawalpemilu.org#22255,"PAGAR DEWA, SELEBAR, KOTA BENGKULU, BENGKULU",25,96,95,191
https://kawalpemilu.org#22255,"PAGAR DEWA, SELEBAR, KOTA BENGKULU, BENGKULU",26,96,132,228
https://kawalpemilu.org#22255,"PAGAR DEWA, SELEBAR, KOTA BENGKULU, BENGKULU",27,80,50,130
https://kawalpemilu.org#22255,"PAGAR DEWA, SELEBAR, KOTA BENGKULU, BENGKULU",28,96,103,199
https://kawalpemilu.org#22255,"PAGAR DEWA, SELEBAR, KOTA BENGKULU, BENGKULU",29,85,132,217
https://kawalpemilu.org#22255,"PAGAR DEWA, SELEBAR, KOTA BENGKULU, BENGKULU",30,93,121,214
https://kawalpemilu.org#22255,"PAGAR DEWA, SELEBAR, KOTA BENGKULU, BENGKULU",31,117,104,221
https://kawalpemilu.org#22255,"PAGAR DEWA, SELEBAR, KOTA BENGKULU, BENGKULU",32,92,99,191
https://kawalpemilu.org#22255,"PAGAR DEWA, SELEBAR, KOTA BENGKULU, BENGKULU",33,129,141,270
https://kawalpemilu.org#22255,"PAGAR DEWA, SELEBAR, KOTA BENGKULU, BENGKULU",34,98,70,168
https://kawalpemilu.org#22255,"PAGAR DEWA, SELEBAR, KOTA BENGKULU, BENGKULU",35,73,103,176
https://kawalpemilu.org#22255,"PAGAR DEWA, SELEBAR, KOTA BENGKULU, BENGKULU",36,65,91,156
https://kawalpemilu.org#22255,"PAGAR DEWA, SELEBAR, KOTA BENGKULU, BENGKULU",37,60,73,133
https://kawalpemilu.org#22255,"PAGAR DEWA, SELEBAR, KOTA BENGKULU, BENGKULU",38,64,83,147
https://kawalpemilu.org#22255,"PAGAR DEWA, SELEBAR, KOTA BENGKULU, BENGKULU",39,113,144,257
https://kawalpemilu.org#22255,"PAGAR DEWA, SELEBAR, KOTA BENGKULU, BENGKULU",40,65,109,174
https://kawalpemilu.org#22255,"PAGAR DEWA, SELEBAR, KOTA BENGKULU, BENGKULU",41,66,77,143
https://kawalpemilu.org#22255,"PAGAR DEWA, SELEBAR, KOTA BENGKULU, BENGKULU",42,99,91,190
https://kawalpemilu.org#22255,"PAGAR DEWA, SELEBAR, KOTA BENGKULU, BENGKULU",43,44,72,116
https://kawalpemilu.org#22255,"PAGAR DEWA, SELEBAR, KOTA BENGKULU, BENGKULU",44,135,104,239
https://kawalpemilu.org#22255,"PAGAR DEWA, SELEBAR, KOTA BENGKULU, BENGKULU",45,102,57,159
https://kawalpemilu.org#22255,"PAGAR DEWA, SELEBAR, KOTA BENGKULU, BENGKULU",46,97,70,167
https://kawalpemilu.org#22255,"PAGAR DEWA, SELEBAR, KOTA BENGKULU, BENGKULU",47,104,103,207
https://kawalpemilu.org#22255,"PAGAR DEWA, SELEBAR, KOTA BENGKULU, BENGKULU",48,90,139,229
https://kawalpemilu.org#22255,"PAGAR DEWA, SELEBAR, KOTA BENGKULU, BENGKULU",49,89,106,195
https://kawalpemilu.org#22255,"PAGAR DEWA, SELEBAR, KOTA BENGKULU, BENGKULU",50,61,123,184
https://kawalpemilu.org#22255,"PAGAR DEWA, SELEBAR, KOTA BENGKULU, BENGKULU",51,109,110,219
https://kawalpemilu.org#22255,"PAGAR DEWA, SELEBAR, KOTA BENGKULU, BENGKULU",52,98,116,214
https://kawalpemilu.org#22255,"PAGAR DEWA, SELEBAR, KOTA BENGKULU, BENGKULU",53,102,136,238
https://kawalpemilu.org#22255,"PAGAR DEWA, SELEBAR, KOTA BENGKULU, BENGKULU",54,90,100,190
https://kawalpemilu.org#22255,"PAGAR DEWA, SELEBAR, KOTA BENGKULU, BENGKULU",55,77,79,156
https://kawalpemilu.org#22255,"PAGAR DEWA, SELEBAR, KOTA BENGKULU, BENGKULU",56,67,84,151
https://kawalpemilu.org#22255,"PAGAR DEWA, SELEBAR, KOTA BENGKULU, BENGKULU",57,74,66,140
https://kawalpemilu.org#22255,"PAGAR DEWA, SELEBAR, KOTA BENGKULU, BENGKULU",58,101,83,184
https://kawalpemilu.org#22255,"PAGAR DEWA, SELEBAR, KOTA BENGKULU, BENGKULU",59,71,66,137
https://kawalpemilu.org#22255,"PAGAR DEWA, SELEBAR, KOTA BENGKULU, BENGKULU",60,68,76,144
https://kawalpemilu.org#22255,"PAGAR DEWA, SELEBAR, KOTA BENGKULU, BENGKULU",61,45,56,101
https://kawalpemilu.org#22255,"PAGAR DEWA, SELEBAR, KOTA BENGKULU, BENGKULU",62,77,81,158
https://kawalpemilu.org#22256,"BETUNGAN, SELEBAR, KOTA BENGKULU, BENGKULU",1,82,96,178
https://kawalpemilu.org#22256,"BETUNGAN, SELEBAR, KOTA BENGKULU, BENGKULU",2,66,85,151
https://kawalpemilu.org#22256,"BETUNGAN, SELEBAR, KOTA BENGKULU, BENGKULU",3,74,101,175
https://kawalpemilu.org#22256,"BETUNGAN, SELEBAR, KOTA BENGKULU, BENGKULU",4,70,135,205
https://kawalpemilu.org#22256,"BETUNGAN, SELEBAR, KOTA BENGKULU, BENGKULU",5,73,136,209
https://kawalpemilu.org#22256,"BETUNGAN, SELEBAR, KOTA BENGKULU, BENGKULU",6,71,126,197
https://kawalpemilu.org#22256,"BETUNGAN, SELEBAR, KOTA BENGKULU, BENGKULU",7,83,72,155
https://kawalpemilu.org#22256,"BETUNGAN, SELEBAR, KOTA BENGKULU, BENGKULU",8,127,113,240
https://kawalpemilu.org#22256,"BETUNGAN, SELEBAR, KOTA BENGKULU, BENGKULU",9,158,61,219
https://kawalpemilu.org#22256,"BETUNGAN, SELEBAR, KOTA BENGKULU, BENGKULU",10,76,71,147
https://kawalpemilu.org#22256,"BETUNGAN, SELEBAR, KOTA BENGKULU, BENGKULU",11,110,66,176
https://kawalpemilu.org#22256,"BETUNGAN, SELEBAR, KOTA BENGKULU, BENGKULU",12,82,118,200
https://kawalpemilu.org#22256,"BETUNGAN, SELEBAR, KOTA BENGKULU, BENGKULU",13,86,130,216
https://kawalpemilu.org#22256,"BETUNGAN, SELEBAR, KOTA BENGKULU, BENGKULU",14,145,97,242
https://kawalpemilu.org#22256,"BETUNGAN, SELEBAR, KOTA BENGKULU, BENGKULU",15,141,86,227
https://kawalpemilu.org#22256,"BETUNGAN, SELEBAR, KOTA BENGKULU, BENGKULU",16,73,147,220
https://kawalpemilu.org#22256,"BETUNGAN, SELEBAR, KOTA BENGKULU, BENGKULU",17,82,100,182
https://kawalpemilu.org#22256,"BETUNGAN, SELEBAR, KOTA BENGKULU, BENGKULU",18,80,44,124
https://kawalpemilu.org#22256,"BETUNGAN, SELEBAR, KOTA BENGKULU, BENGKULU",19,129,94,223
https://kawalpemilu.org#22256,"BETUNGAN, SELEBAR, KOTA BENGKULU, BENGKULU",20,179,86,265
https://kawalpemilu.org#22256,"BETUNGAN, SELEBAR, KOTA BENGKULU, BENGKULU",21,110,58,168
https://kawalpemilu.org#22256,"BETUNGAN, SELEBAR, KOTA BENGKULU, BENGKULU",22,91,162,253
https://kawalpemilu.org#22256,"BETUNGAN, SELEBAR, KOTA BENGKULU, BENGKULU",23,107,141,248
https://kawalpemilu.org#22256,"BETUNGAN, SELEBAR, KOTA BENGKULU, BENGKULU",24,133,119,252
https://kawalpemilu.org#22256,"BETUNGAN, SELEBAR, KOTA BENGKULU, BENGKULU",25,129,91,220
https://kawalpemilu.org#22256,"BETUNGAN, SELEBAR, KOTA BENGKULU, BENGKULU",26,101,109,210
https://kawalpemilu.org#22256,"BETUNGAN, SELEBAR, KOTA BENGKULU, BENGKULU",27,67,163,230
https://kawalpemilu.org#22256,"BETUNGAN, SELEBAR, KOTA BENGKULU, BENGKULU",28,80,172,252
https://kawalpemilu.org#22256,"BETUNGAN, SELEBAR, KOTA BENGKULU, BENGKULU",29,27,136,163
https://kawalpemilu.org#22256,"BETUNGAN, SELEBAR, KOTA BENGKULU, BENGKULU",30,69,154,223
https://kawalpemilu.org#22256,"BETUNGAN, SELEBAR, KOTA BENGKULU, BENGKULU",31,49,115,164
https://kawalpemilu.org#22256,"BETUNGAN, SELEBAR, KOTA BENGKULU, BENGKULU",32,80,127,207
https://kawalpemilu.org#22257,"PEKAN SABTU, SELEBAR, KOTA BENGKULU, BENGKULU",1,161,87,248
https://kawalpemilu.org#22257,"PEKAN SABTU, SELEBAR, KOTA BENGKULU, BENGKULU",2,129,101,230
https://kawalpemilu.org#22257,"PEKAN SABTU, SELEBAR, KOTA BENGKULU, BENGKULU",3,109,132,241
https://kawalpemilu.org#22257,"PEKAN SABTU, SELEBAR, KOTA BENGKULU, BENGKULU",4,80,129,209
https://kawalpemilu.org#22257,"PEKAN SABTU, SELEBAR, KOTA BENGKULU, BENGKULU",5,61,146,207
https://kawalpemilu.org#22257,"PEKAN SABTU, SELEBAR, KOTA BENGKULU, BENGKULU",6,84,171,255
https://kawalpemilu.org#22257,"PEKAN SABTU, SELEBAR, KOTA BENGKULU, BENGKULU",7,74,130,204
https://kawalpemilu.org#22257,"PEKAN SABTU, SELEBAR, KOTA BENGKULU, BENGKULU",8,72,159,231
https://kawalpemilu.org#22257,"PEKAN SABTU, SELEBAR, KOTA BENGKULU, BENGKULU",9,60,166,226
https://kawalpemilu.org#22257,"PEKAN SABTU, SELEBAR, KOTA BENGKULU, BENGKULU",10,80,168,248
https://kawalpemilu.org#22257,"PEKAN SABTU, SELEBAR, KOTA BENGKULU, BENGKULU",11,113,132,245
https://kawalpemilu.org#22257,"PEKAN SABTU, SELEBAR, KOTA BENGKULU, BENGKULU",12,61,136,197
https://kawalpemilu.org#22257,"PEKAN SABTU, SELEBAR, KOTA BENGKULU, BENGKULU",13,68,100,168
https://kawalpemilu.org#22257,"PEKAN SABTU, SELEBAR, KOTA BENGKULU, BENGKULU",14,73,89,162
https://kawalpemilu.org#22257,"PEKAN SABTU, SELEBAR, KOTA BENGKULU, BENGKULU",15,81,145,226
https://kawalpemilu.org#22257,"PEKAN SABTU, SELEBAR, KOTA BENGKULU, BENGKULU",16,74,155,229
https://kawalpemilu.org#22257,"PEKAN SABTU, SELEBAR, KOTA BENGKULU, BENGKULU",17,64,144,208
https://kawalpemilu.org#22257,"PEKAN SABTU, SELEBAR, KOTA BENGKULU, BENGKULU",18,68,135,203
https://kawalpemilu.org#22257,"PEKAN SABTU, SELEBAR, KOTA BENGKULU, BENGKULU",19,81,104,185
https://kawalpemilu.org#22258,"BUMI AYU, SELEBAR, KOTA BENGKULU, BENGKULU",1,88,101,189
https://kawalpemilu.org#22258,"BUMI AYU, SELEBAR, KOTA BENGKULU, BENGKULU",2,103,122,225
https://kawalpemilu.org#22258,"BUMI AYU, SELEBAR, KOTA BENGKULU, BENGKULU",3,44,53,97
https://kawalpemilu.org#22258,"BUMI AYU, SELEBAR, KOTA BENGKULU, BENGKULU",4,91,103,194
https://kawalpemilu.org#22258,"BUMI AYU, SELEBAR, KOTA BENGKULU, BENGKULU",5,126,94,220
https://kawalpemilu.org#22258,"BUMI AYU, SELEBAR, KOTA BENGKULU, BENGKULU",6,120,105,225
https://kawalpemilu.org#22258,"BUMI AYU, SELEBAR, KOTA BENGKULU, BENGKULU",7,60,82,142
https://kawalpemilu.org#22258,"BUMI AYU, SELEBAR, KOTA BENGKULU, BENGKULU",8,42,120,162
https://kawalpemilu.org#22258,"BUMI AYU, SELEBAR, KOTA BENGKULU, BENGKULU",9,124,147,271
https://kawalpemilu.org#22258,"BUMI AYU, SELEBAR, KOTA BENGKULU, BENGKULU",10,119,100,219
https://kawalpemilu.org#22258,"BUMI AYU, SELEBAR, KOTA BENGKULU, BENGKULU",11,86,141,227
https://kawalpemilu.org#22258,"BUMI AYU, SELEBAR, KOTA BENGKULU, BENGKULU",12,89,129,218
https://kawalpemilu.org#22258,"BUMI AYU, SELEBAR, KOTA BENGKULU, BENGKULU",13,97,159,256
https://kawalpemilu.org#22258,"BUMI AYU, SELEBAR, KOTA BENGKULU, BENGKULU",14,148,57,205
https://kawalpemilu.org#22258,"BUMI AYU, SELEBAR, KOTA BENGKULU, BENGKULU",15,88,167,255
https://kawalpemilu.org#22258,"BUMI AYU, SELEBAR, KOTA BENGKULU, BENGKULU",16,47,112,159
https://kawalpemilu.org#22258,"BUMI AYU, SELEBAR, KOTA BENGKULU, BENGKULU",17,67,75,142
https://kawalpemilu.org#22258,"BUMI AYU, SELEBAR, KOTA BENGKULU, BENGKULU",18,120,134,254
https://kawalpemilu.org#22258,"BUMI AYU, SELEBAR, KOTA BENGKULU, BENGKULU",19,78,62,140
https://kawalpemilu.org#22258,"BUMI AYU, SELEBAR, KOTA BENGKULU, BENGKULU",20,71,152,223
https://kawalpemilu.org#22258,"BUMI AYU, SELEBAR, KOTA BENGKULU, BENGKULU",21,73,103,176
https://kawalpemilu.org#22258,"BUMI AYU, SELEBAR, KOTA BENGKULU, BENGKULU",22,98,110,208
https://kawalpemilu.org#22258,"BUMI AYU, SELEBAR, KOTA BENGKULU, BENGKULU",23,83,58,141
https://kawalpemilu.org#22258,"BUMI AYU, SELEBAR, KOTA BENGKULU, BENGKULU",24,30,29,59
https://kawalpemilu.org#22258,"BUMI AYU, SELEBAR, KOTA BENGKULU, BENGKULU",25,62,62,124
https://kawalpemilu.org#22258,"BUMI AYU, SELEBAR, KOTA BENGKULU, BENGKULU",26,103,37,140
https://kawalpemilu.org#22258,"BUMI AYU, SELEBAR, KOTA BENGKULU, BENGKULU",27,83,105,188
https://kawalpemilu.org#22259,"SUMUR DEWA, SELEBAR, KOTA BENGKULU, BENGKULU",1,107,167,274
https://kawalpemilu.org#22259,"SUMUR DEWA, SELEBAR, KOTA BENGKULU, BENGKULU",2,76,138,214
https://kawalpemilu.org#22259,"SUMUR DEWA, SELEBAR, KOTA BENGKULU, BENGKULU",3,105,123,228
https://kawalpemilu.org#22259,"SUMUR DEWA, SELEBAR, KOTA BENGKULU, BENGKULU",4,90,123,213
https://kawalpemilu.org#22259,"SUMUR DEWA, SELEBAR, KOTA BENGKULU, BENGKULU",5,116,116,232
https://kawalpemilu.org#22259,"SUMUR DEWA, SELEBAR, KOTA BENGKULU, BENGKULU",6,90,109,199
https://kawalpemilu.org#22259,"SUMUR DEWA, SELEBAR, KOTA BENGKULU, BENGKULU",7,169,83,252
https://kawalpemilu.org#22259,"SUMUR DEWA, SELEBAR, KOTA BENGKULU, BENGKULU",8,71,58,129
https://kawalpemilu.org#22259,"SUMUR DEWA, SELEBAR, KOTA BENGKULU, BENGKULU",9,90,69,159
https://kawalpemilu.org#22259,"SUMUR DEWA, SELEBAR, KOTA BENGKULU, BENGKULU",10,93,129,222
https://kawalpemilu.org#22259,"SUMUR DEWA, SELEBAR, KOTA BENGKULU, BENGKULU",11,70,142,212
https://kawalpemilu.org#22259,"SUMUR DEWA, SELEBAR, KOTA BENGKULU, BENGKULU",12,92,155,247
https://kawalpemilu.org#22259,"SUMUR DEWA, SELEBAR, KOTA BENGKULU, BENGKULU",13,92,150,242
https://kawalpemilu.org#22259,"SUMUR DEWA, SELEBAR, KOTA BENGKULU, BENGKULU",14,75,178,253
https://kawalpemilu.org#22259,"SUMUR DEWA, SELEBAR, KOTA BENGKULU, BENGKULU",15,138,95,233
https://kawalpemilu.org#22259,"SUMUR DEWA, SELEBAR, KOTA BENGKULU, BENGKULU",16,105,133,238
https://kawalpemilu.org#22259,"SUMUR DEWA, SELEBAR, KOTA BENGKULU, BENGKULU",17,169,83,252
https://kawalpemilu.org#22259,"SUMUR DEWA, SELEBAR, KOTA BENGKULU, BENGKULU",18,121,27,148
https://kawalpemilu.org#22259,"SUMUR DEWA, SELEBAR, KOTA BENGKULU, BENGKULU",19,103,144,247
https://kawalpemilu.org#22259,"SUMUR DEWA, SELEBAR, KOTA BENGKULU, BENGKULU",20,41,84,125
https://kawalpemilu.org#22259,"SUMUR DEWA, SELEBAR, KOTA BENGKULU, BENGKULU",21,68,119,187
https://kawalpemilu.org#22259,"SUMUR DEWA, SELEBAR, KOTA BENGKULU, BENGKULU",22,81,69,150
https://kawalpemilu.org#22259,"SUMUR DEWA, SELEBAR, KOTA BENGKULU, BENGKULU",23,66,160,226
https://kawalpemilu.org#22261,"PADANG HARAPAN, GADING CEMPAKA, KOTA BENGKULU, BENGKULU",1,82,111,193
https://kawalpemilu.org#22261,"PADANG HARAPAN, GADING CEMPAKA, KOTA BENGKULU, BENGKULU",2,90,188,278
https://kawalpemilu.org#22261,"PADANG HARAPAN, GADING CEMPAKA, KOTA BENGKULU, BENGKULU",3,35,99,134
https://kawalpemilu.org#22261,"PADANG HARAPAN, GADING CEMPAKA, KOTA BENGKULU, BENGKULU",4,62,131,193
https://kawalpemilu.org#22261,"PADANG HARAPAN, GADING CEMPAKA, KOTA BENGKULU, BENGKULU",5,93,144,237
https://kawalpemilu.org#22261,"PADANG HARAPAN, GADING CEMPAKA, KOTA BENGKULU, BENGKULU",6,81,184,265
https://kawalpemilu.org#22261,"PADANG HARAPAN, GADING CEMPAKA, KOTA BENGKULU, BENGKULU",7,71,104,175
https://kawalpemilu.org#22261,"PADANG HARAPAN, GADING CEMPAKA, KOTA BENGKULU, BENGKULU",8,36,90,126
https://kawalpemilu.org#22261,"PADANG HARAPAN, GADING CEMPAKA, KOTA BENGKULU, BENGKULU",9,52,126,178
https://kawalpemilu.org#22261,"PADANG HARAPAN, GADING CEMPAKA, KOTA BENGKULU, BENGKULU",10,122,132,254
https://kawalpemilu.org#22261,"PADANG HARAPAN, GADING CEMPAKA, KOTA BENGKULU, BENGKULU",11,78,70,148
https://kawalpemilu.org#22261,"PADANG HARAPAN, GADING CEMPAKA, KOTA BENGKULU, BENGKULU",12,77,194,271
https://kawalpemilu.org#22261,"PADANG HARAPAN, GADING CEMPAKA, KOTA BENGKULU, BENGKULU",13,118,92,210
https://kawalpemilu.org#22261,"PADANG HARAPAN, GADING CEMPAKA, KOTA BENGKULU, BENGKULU",14,61,173,234
https://kawalpemilu.org#22261,"PADANG HARAPAN, GADING CEMPAKA, KOTA BENGKULU, BENGKULU",15,32,69,101
https://kawalpemilu.org#22264,"JALAN GEDANG, GADING CEMPAKA, KOTA BENGKULU, BENGKULU",1,101,67,168
https://kawalpemilu.org#22264,"JALAN GEDANG, GADING CEMPAKA, KOTA BENGKULU, BENGKULU",2,93,132,225
https://kawalpemilu.org#22264,"JALAN GEDANG, GADING CEMPAKA, KOTA BENGKULU, BENGKULU",3,76,106,182
https://kawalpemilu.org#22264,"JALAN GEDANG, GADING CEMPAKA, KOTA BENGKULU, BENGKULU",4,54,96,150
https://kawalpemilu.org#22264,"JALAN GEDANG, GADING CEMPAKA, KOTA BENGKULU, BENGKULU",5,119,114,233
https://kawalpemilu.org#22264,"JALAN GEDANG, GADING CEMPAKA, KOTA BENGKULU, BENGKULU",6,81,120,201
https://kawalpemilu.org#22264,"JALAN GEDANG, GADING CEMPAKA, KOTA BENGKULU, BENGKULU",7,80,144,224
https://kawalpemilu.org#22264,"JALAN GEDANG, GADING CEMPAKA, KOTA BENGKULU, BENGKULU",8,87,149,236
https://kawalpemilu.org#22264,"JALAN GEDANG, GADING CEMPAKA, KOTA BENGKULU, BENGKULU",9,92,138,230
https://kawalpemilu.org#22264,"JALAN GEDANG, GADING CEMPAKA, KOTA BENGKULU, BENGKULU",10,137,130,267
https://kawalpemilu.org#22264,"JALAN GEDANG, GADING CEMPAKA, KOTA BENGKULU, BENGKULU",11,69,93,162
https://kawalpemilu.org#22264,"JALAN GEDANG, GADING CEMPAKA, KOTA BENGKULU, BENGKULU",12,84,164,248
https://kawalpemilu.org#22264,"JALAN GEDANG, GADING CEMPAKA, KOTA BENGKULU, BENGKULU",13,71,101,172
https://kawalpemilu.org#22264,"JALAN GEDANG, GADING CEMPAKA, KOTA BENGKULU, BENGKULU",14,83,121,204
https://kawalpemilu.org#22264,"JALAN GEDANG, GADING CEMPAKA, KOTA BENGKULU, BENGKULU",15,84,144,228
https://kawalpemilu.org#22264,"JALAN GEDANG, GADING CEMPAKA, KOTA BENGKULU, BENGKULU",16,110,150,260
https://kawalpemilu.org#22264,"JALAN GEDANG, GADING CEMPAKA, KOTA BENGKULU, BENGKULU",17,82,81,163
https://kawalpemilu.org#22265,"LINGKAR BARAT, GADING CEMPAKA, KOTA BENGKULU, BENGKULU",1,85,115,200
https://kawalpemilu.org#22265,"LINGKAR BARAT, GADING CEMPAKA, KOTA BENGKULU, BENGKULU",2,100,127,228
https://kawalpemilu.org#22265,"LINGKAR BARAT, GADING CEMPAKA, KOTA BENGKULU, BENGKULU",3,96,139,235
https://kawalpemilu.org#22265,"LINGKAR BARAT, GADING CEMPAKA, KOTA BENGKULU, BENGKULU",4,68,165,233
https://kawalpemilu.org#22265,"LINGKAR BARAT, GADING CEMPAKA, KOTA BENGKULU, BENGKULU",5,124,135,259
https://kawalpemilu.org#22265,"LINGKAR BARAT, GADING CEMPAKA, KOTA BENGKULU, BENGKULU",6,85,143,228
https://kawalpemilu.org#22265,"LINGKAR BARAT, GADING CEMPAKA, KOTA BENGKULU, BENGKULU",7,89,133,230
https://kawalpemilu.org#22265,"LINGKAR BARAT, GADING CEMPAKA, KOTA BENGKULU, BENGKULU",8,82,137,219
https://kawalpemilu.org#22265,"LINGKAR BARAT, GADING CEMPAKA, KOTA BENGKULU, BENGKULU",9,115,96,211
https://kawalpemilu.org#22265,"LINGKAR BARAT, GADING CEMPAKA, KOTA BENGKULU, BENGKULU",10,117,65,182
https://kawalpemilu.org#22265,"LINGKAR BARAT, GADING CEMPAKA, KOTA BENGKULU, BENGKULU",11,96,140,236
https://kawalpemilu.org#22265,"LINGKAR BARAT, GADING CEMPAKA, KOTA BENGKULU, BENGKULU",12,97,170,267
https://kawalpemilu.org#22265,"LINGKAR BARAT, GADING CEMPAKA, KOTA BENGKULU, BENGKULU",13,90,177,267
https://kawalpemilu.org#22265,"LINGKAR BARAT, GADING CEMPAKA, KOTA BENGKULU, BENGKULU",14,130,127,257
https://kawalpemilu.org#22265,"LINGKAR BARAT, GADING CEMPAKA, KOTA BENGKULU, BENGKULU",15,174,95,269
https://kawalpemilu.org#22265,"LINGKAR BARAT, GADING CEMPAKA, KOTA BENGKULU, BENGKULU",16,112,137,249
https://kawalpemilu.org#22265,"LINGKAR BARAT, GADING CEMPAKA, KOTA BENGKULU, BENGKULU",17,98,150,248
https://kawalpemilu.org#22265,"LINGKAR BARAT, GADING CEMPAKA, KOTA BENGKULU, BENGKULU",18,84,195,279
https://kawalpemilu.org#22265,"LINGKAR BARAT, GADING CEMPAKA, KOTA BENGKULU, BENGKULU",19,70,99,169
https://kawalpemilu.org#22265,"LINGKAR BARAT, GADING CEMPAKA, KOTA BENGKULU, BENGKULU",20,82,97,179
https://kawalpemilu.org#22265,"LINGKAR BARAT, GADING CEMPAKA, KOTA BENGKULU, BENGKULU",21,104,119,223
https://kawalpemilu.org#22265,"LINGKAR BARAT, GADING CEMPAKA, KOTA BENGKULU, BENGKULU",22,100,148,248
https://kawalpemilu.org#22269,"SIDO MULYO, GADING CEMPAKA, KOTA BENGKULU, BENGKULU",1,135,107,242
https://kawalpemilu.org#22269,"SIDO MULYO, GADING CEMPAKA, KOTA BENGKULU, BENGKULU",2,107,113,220
https://kawalpemilu.org#22269,"SIDO MULYO, GADING CEMPAKA, KOTA BENGKULU, BENGKULU",3,63,178,241
https://kawalpemilu.org#22269,"SIDO MULYO, GADING CEMPAKA, KOTA BENGKULU, BENGKULU",4,63,148,211
https://kawalpemilu.org#22269,"SIDO MULYO, GADING CEMPAKA, KOTA BENGKULU, BENGKULU",5,68,124,192
https://kawalpemilu.org#22269,"SIDO MULYO, GADING CEMPAKA, KOTA BENGKULU, BENGKULU",6,63,94,157
https://kawalpemilu.org#22269,"SIDO MULYO, GADING CEMPAKA, KOTA BENGKULU, BENGKULU",7,82,88,170
https://kawalpemilu.org#22269,"SIDO MULYO, GADING CEMPAKA, KOTA BENGKULU, BENGKULU",8,116,130,246
https://kawalpemilu.org#22269,"SIDO MULYO, GADING CEMPAKA, KOTA BENGKULU, BENGKULU",9,74,154,228
https://kawalpemilu.org#22269,"SIDO MULYO, GADING CEMPAKA, KOTA BENGKULU, BENGKULU",10,56,99,155
https://kawalpemilu.org#22269,"SIDO MULYO, GADING CEMPAKA, KOTA BENGKULU, BENGKULU",11,54,112,166
https://kawalpemilu.org#22269,"SIDO MULYO, GADING CEMPAKA, KOTA BENGKULU, BENGKULU",12,70,101,171
https://kawalpemilu.org#22269,"SIDO MULYO, GADING CEMPAKA, KOTA BENGKULU, BENGKULU",13,116,132,248
https://kawalpemilu.org#22269,"SIDO MULYO, GADING CEMPAKA, KOTA BENGKULU, BENGKULU",14,98,142,240
https://kawalpemilu.org#22269,"SIDO MULYO, GADING CEMPAKA, KOTA BENGKULU, BENGKULU",15,84,135,219
https://kawalpemilu.org#22269,"SIDO MULYO, GADING CEMPAKA, KOTA BENGKULU, BENGKULU",16,66,148,214
https://kawalpemilu.org#22269,"SIDO MULYO, GADING CEMPAKA, KOTA BENGKULU, BENGKULU",17,86,150,236
https://kawalpemilu.org#22269,"SIDO MULYO, GADING CEMPAKA, KOTA BENGKULU, BENGKULU",18,42,98,140
https://kawalpemilu.org#22269,"SIDO MULYO, GADING CEMPAKA, KOTA BENGKULU, BENGKULU",19,124,121,245
https://kawalpemilu.org#22269,"SIDO MULYO, GADING CEMPAKA, KOTA BENGKULU, BENGKULU",20,83,74,157
https://kawalpemilu.org#22269,"SIDO MULYO, GADING CEMPAKA, KOTA BENGKULU, BENGKULU",21,95,157,252
https://kawalpemilu.org#22269,"SIDO MULYO, GADING CEMPAKA, KOTA BENGKULU, BENGKULU",22,90,140,230
https://kawalpemilu.org#22269,"SIDO MULYO, GADING CEMPAKA, KOTA BENGKULU, BENGKULU",23,52,136,188
https://kawalpemilu.org#22269,"SIDO MULYO, GADING CEMPAKA, KOTA BENGKULU, BENGKULU",24,53,95,148
https://kawalpemilu.org#22269,"SIDO MULYO, GADING CEMPAKA, KOTA BENGKULU, BENGKULU",25,40,110,150
https://kawalpemilu.org#22269,"SIDO MULYO, GADING CEMPAKA, KOTA BENGKULU, BENGKULU",26,49,147,196
https://kawalpemilu.org#22269,"SIDO MULYO, GADING CEMPAKA, KOTA BENGKULU, BENGKULU",27,59,213,272
https://kawalpemilu.org#22269,"SIDO MULYO, GADING CEMPAKA, KOTA BENGKULU, BENGKULU",28,106,158,264
https://kawalpemilu.org#22269,"SIDO MULYO, GADING CEMPAKA, KOTA BENGKULU, BENGKULU",29,35,66,101
https://kawalpemilu.org#22269,"SIDO MULYO, GADING CEMPAKA, KOTA BENGKULU, BENGKULU",30,100,99,199
https://kawalpemilu.org#22269,"SIDO MULYO, GADING CEMPAKA, KOTA BENGKULU, BENGKULU",31,81,112,193
https://kawalpemilu.org#22269,"SIDO MULYO, GADING CEMPAKA, KOTA BENGKULU, BENGKULU",32,107,148,255
https://kawalpemilu.org#22269,"SIDO MULYO, GADING CEMPAKA, KOTA BENGKULU, BENGKULU",33,95,133,228
https://kawalpemilu.org#22269,"SIDO MULYO, GADING CEMPAKA, KOTA BENGKULU, BENGKULU",34,90,140,230
https://kawalpemilu.org#22269,"SIDO MULYO, GADING CEMPAKA, KOTA BENGKULU, BENGKULU",35,78,150,228
https://kawalpemilu.org#22269,"SIDO MULYO, GADING CEMPAKA, KOTA BENGKULU, BENGKULU",36,26,95,121
https://kawalpemilu.org#22270,"CEMPAKA PERMAI, GADING CEMPAKA, KOTA BENGKULU, BENGKULU",1,105,144,249
https://kawalpemilu.org#22270,"CEMPAKA PERMAI, GADING CEMPAKA, KOTA BENGKULU, BENGKULU",2,118,114,232
https://kawalpemilu.org#22270,"CEMPAKA PERMAI, GADING CEMPAKA, KOTA BENGKULU, BENGKULU",3,106,104,210
https://kawalpemilu.org#22270,"CEMPAKA PERMAI, GADING CEMPAKA, KOTA BENGKULU, BENGKULU",4,79,148,227
https://kawalpemilu.org#22270,"CEMPAKA PERMAI, GADING CEMPAKA, KOTA BENGKULU, BENGKULU",5,72,149,221
https://kawalpemilu.org#22270,"CEMPAKA PERMAI, GADING CEMPAKA, KOTA BENGKULU, BENGKULU",6,119,128,247
https://kawalpemilu.org#22270,"CEMPAKA PERMAI, GADING CEMPAKA, KOTA BENGKULU, BENGKULU",7,74,161,235
https://kawalpemilu.org#22270,"CEMPAKA PERMAI, GADING CEMPAKA, KOTA BENGKULU, BENGKULU",8,90,157,247
https://kawalpemilu.org#22270,"CEMPAKA PERMAI, GADING CEMPAKA, KOTA BENGKULU, BENGKULU",9,93,183,276
https://kawalpemilu.org#22270,"CEMPAKA PERMAI, GADING CEMPAKA, KOTA BENGKULU, BENGKULU",10,106,127,233
https://kawalpemilu.org#22270,"CEMPAKA PERMAI, GADING CEMPAKA, KOTA BENGKULU, BENGKULU",11,87,168,255
https://kawalpemilu.org#22270,"CEMPAKA PERMAI, GADING CEMPAKA, KOTA BENGKULU, BENGKULU",12,62,203,265
https://kawalpemilu.org#22270,"CEMPAKA PERMAI, GADING CEMPAKA, KOTA BENGKULU, BENGKULU",13,80,146,226
https://kawalpemilu.org#22270,"CEMPAKA PERMAI, GADING CEMPAKA, KOTA BENGKULU, BENGKULU",14,77,136,213
https://kawalpemilu.org#22270,"CEMPAKA PERMAI, GADING CEMPAKA, KOTA BENGKULU, BENGKULU",15,68,156,224
https://kawalpemilu.org#22273,"BERKAS, TELUK SEGARA, KOTA BENGKULU, BENGKULU",1,119,106,225
https://kawalpemilu.org#22273,"BERKAS, TELUK SEGARA, KOTA BENGKULU, BENGKULU",2,114,115,229
https://kawalpemilu.org#22273,"BERKAS, TELUK SEGARA, KOTA BENGKULU, BENGKULU",3,58,169,227
https://kawalpemilu.org#22273,"BERKAS, TELUK SEGARA, KOTA BENGKULU, BENGKULU",4,101,145,246
https://kawalpemilu.org#22273,"BERKAS, TELUK SEGARA, KOTA BENGKULU, BENGKULU",5,132,92,224
https://kawalpemilu.org#22274,"PASAR BARU, TELUK SEGARA, KOTA BENGKULU, BENGKULU",1,88,135,223
https://kawalpemilu.org#22274,"PASAR BARU, TELUK SEGARA, KOTA BENGKULU, BENGKULU",2,59,89,148
https://kawalpemilu.org#22274,"PASAR BARU, TELUK SEGARA, KOTA BENGKULU, BENGKULU",3,108,128,236
https://kawalpemilu.org#22275,"JITRA, TELUK SEGARA, KOTA BENGKULU, BENGKULU",1,103,106,209
https://kawalpemilu.org#22275,"JITRA, TELUK SEGARA, KOTA BENGKULU, BENGKULU",2,93,136,229
https://kawalpemilu.org#22275,"JITRA, TELUK SEGARA, KOTA BENGKULU, BENGKULU",3,102,84,186
https://kawalpemilu.org#22276,"PASAR MELINTANG, TELUK SEGARA, KOTA BENGKULU, BENGKULU",1,91,80,171
https://kawalpemilu.org#22276,"PASAR MELINTANG, TELUK SEGARA, KOTA BENGKULU, BENGKULU",2,115,127,242
https://kawalpemilu.org#22276,"PASAR MELINTANG, TELUK SEGARA, KOTA BENGKULU, BENGKULU",3,125,146,271
https://kawalpemilu.org#22276,"PASAR MELINTANG, TELUK SEGARA, KOTA BENGKULU, BENGKULU",4,98,131,229
https://kawalpemilu.org#22277,"KEBUN ROS, TELUK SEGARA, KOTA BENGKULU, BENGKULU",1,89,125,214
https://kawalpemilu.org#22277,"KEBUN ROS, TELUK SEGARA, KOTA BENGKULU, BENGKULU",2,115,88,203
https://kawalpemilu.org#22277,"KEBUN ROS, TELUK SEGARA, KOTA BENGKULU, BENGKULU",3,136,96,232
https://kawalpemilu.org#22277,"KEBUN ROS, TELUK SEGARA, KOTA BENGKULU, BENGKULU",4,99,106,225
https://kawalpemilu.org#22277,"KEBUN ROS, TELUK SEGARA, KOTA BENGKULU, BENGKULU",5,95,161,256
https://kawalpemilu.org#22278,"PINTU BATU, TELUK SEGARA, KOTA BENGKULU, BENGKULU",1,79,89,168
https://kawalpemilu.org#22278,"PINTU BATU, TELUK SEGARA, KOTA BENGKULU, BENGKULU",2,65,126,191
https://kawalpemilu.org#22278,"PINTU BATU, TELUK SEGARA, KOTA BENGKULU, BENGKULU",3,99,124,223
https://kawalpemilu.org#22279,"KEBUN KELING, TELUK SEGARA, KOTA BENGKULU, BENGKULU",1,107,109,216
https://kawalpemilu.org#22279,"KEBUN KELING, TELUK SEGARA, KOTA BENGKULU, BENGKULU",2,70,135,205
https://kawalpemilu.org#22279,"KEBUN KELING, TELUK SEGARA, KOTA BENGKULU, BENGKULU",3,87,123,210
https://kawalpemilu.org#22279,"KEBUN KELING, TELUK SEGARA, KOTA BENGKULU, BENGKULU",4,117,93,210
https://kawalpemilu.org#22280,"PONDOK BESI, TELUK SEGARA, KOTA BENGKULU, BENGKULU",1,115,143,258
https://kawalpemilu.org#22280,"PONDOK BESI, TELUK SEGARA, KOTA BENGKULU, BENGKULU",2,101,139,240
https://kawalpemilu.org#22280,"PONDOK BESI, TELUK SEGARA, KOTA BENGKULU, BENGKULU",3,102,150,252
https://kawalpemilu.org#22280,"PONDOK BESI, TELUK SEGARA, KOTA BENGKULU, BENGKULU",4,113,127,240
https://kawalpemilu.org#22281,"SUMUR MELELEH, TELUK SEGARA, KOTA BENGKULU, BENGKULU",1,112,128,240
https://kawalpemilu.org#22281,"SUMUR MELELEH, TELUK SEGARA, KOTA BENGKULU, BENGKULU",2,108,138,246
https://kawalpemilu.org#22281,"SUMUR MELELEH, TELUK SEGARA, KOTA BENGKULU, BENGKULU",3,54,140,194
https://kawalpemilu.org#22282,"BAJAK, TELUK SEGARA, KOTA BENGKULU, BENGKULU",1,72,96,168
https://kawalpemilu.org#22282,"BAJAK, TELUK SEGARA, KOTA BENGKULU, BENGKULU",2,70,104,174
https://kawalpemilu.org#22282,"BAJAK, TELUK SEGARA, KOTA BENGKULU, BENGKULU",3,111,108,219
https://kawalpemilu.org#22282,"BAJAK, TELUK SEGARA, KOTA BENGKULU, BENGKULU",4,91,81,172
https://kawalpemilu.org#22282,"BAJAK, TELUK SEGARA, KOTA BENGKULU, BENGKULU",5,48,90,138
https://kawalpemilu.org#22282,"BAJAK, TELUK SEGARA, KOTA BENGKULU, BENGKULU",6,113,120,233
https://kawalpemilu.org#22282,"BAJAK, TELUK SEGARA, KOTA BENGKULU, BENGKULU",7,80,98,178
https://kawalpemilu.org#22282,"BAJAK, TELUK SEGARA, KOTA BENGKULU, BENGKULU",8,98,108,206
https://kawalpemilu.org#22283,"TENGAH PADANG, TELUK SEGARA, KOTA BENGKULU, BENGKULU",1,113,140,253
https://kawalpemilu.org#22283,"TENGAH PADANG, TELUK SEGARA, KOTA BENGKULU, BENGKULU",2,91,117,208
https://kawalpemilu.org#22283,"TENGAH PADANG, TELUK SEGARA, KOTA BENGKULU, BENGKULU",3,79,124,203
https://kawalpemilu.org#22283,"TENGAH PADANG, TELUK SEGARA, KOTA BENGKULU, BENGKULU",4,87,80,167
https://kawalpemilu.org#22283,"TENGAH PADANG, TELUK SEGARA, KOTA BENGKULU, BENGKULU",5,80,125,205
https://kawalpemilu.org#22283,"TENGAH PADANG, TELUK SEGARA, KOTA BENGKULU, BENGKULU",6,98,62,160
https://kawalpemilu.org#22283,"TENGAH PADANG, TELUK SEGARA, KOTA BENGKULU, BENGKULU",7,75,123,198
https://kawalpemilu.org#22283,"TENGAH PADANG, TELUK SEGARA, KOTA BENGKULU, BENGKULU",8,74,111,185
https://kawalpemilu.org#22283,"TENGAH PADANG, TELUK SEGARA, KOTA BENGKULU, BENGKULU",9,98,120,218
https://kawalpemilu.org#22283,"TENGAH PADANG, TELUK SEGARA, KOTA BENGKULU, BENGKULU",10,100,137,237
https://kawalpemilu.org#22283,"TENGAH PADANG, TELUK SEGARA, KOTA BENGKULU, BENGKULU",11,102,114,216
https://kawalpemilu.org#22284,"KAMPUNG BALI, TELUK SEGARA, KOTA BENGKULU, BENGKULU",1,89,123,212
https://kawalpemilu.org#22284,"KAMPUNG BALI, TELUK SEGARA, KOTA BENGKULU, BENGKULU",2,125,130,255
https://kawalpemilu.org#22284,"KAMPUNG BALI, TELUK SEGARA, KOTA BENGKULU, BENGKULU",3,77,111,188
https://kawalpemilu.org#22284,"KAMPUNG BALI, TELUK SEGARA, KOTA BENGKULU, BENGKULU",4,63,148,211
https://kawalpemilu.org#22285,"MALABERO, TELUK SEGARA, KOTA BENGKULU, BENGKULU",1,69,167,236
https://kawalpemilu.org#22285,"MALABERO, TELUK SEGARA, KOTA BENGKULU, BENGKULU",2,63,169,232
https://kawalpemilu.org#22285,"MALABERO, TELUK SEGARA, KOTA BENGKULU, BENGKULU",3,103,132,235
https://kawalpemilu.org#22285,"MALABERO, TELUK SEGARA, KOTA BENGKULU, BENGKULU",4,83,142,225
https://kawalpemilu.org#22285,"MALABERO, TELUK SEGARA, KOTA BENGKULU, BENGKULU",5,98,123,221
https://kawalpemilu.org#22285,"MALABERO, TELUK SEGARA, KOTA BENGKULU, BENGKULU",7,19,78,97
https://kawalpemilu.org#22287,"KANDANG LIMUN, MUARA BANGKA HULU, KOTA BENGKULU, BENGKULU",1,77,146,223
https://kawalpemilu.org#22287,"KANDANG LIMUN, MUARA BANGKA HULU, KOTA BENGKULU, BENGKULU",2,47,79,126
https://kawalpemilu.org#22287,"KANDANG LIMUN, MUARA BANGKA HULU, KOTA BENGKULU, BENGKULU",3,95,114,209
https://kawalpemilu.org#22287,"KANDANG LIMUN, MUARA BANGKA HULU, KOTA BENGKULU, BENGKULU",4,75,48,123
https://kawalpemilu.org#22287,"KANDANG LIMUN, MUARA BANGKA HULU, KOTA BENGKULU, BENGKULU",5,77,128,205
https://kawalpemilu.org#22287,"KANDANG LIMUN, MUARA BANGKA HULU, KOTA BENGKULU, BENGKULU",6,71,80,151
https://kawalpemilu.org#22287,"KANDANG LIMUN, MUARA BANGKA HULU, KOTA BENGKULU, BENGKULU",7,61,74,135
https://kawalpemilu.org#22287,"KANDANG LIMUN, MUARA BANGKA HULU, KOTA BENGKULU, BENGKULU",8,124,123,247
https://kawalpemilu.org#22287,"KANDANG LIMUN, MUARA BANGKA HULU, KOTA BENGKULU, BENGKULU",9,95,141,236
https://kawalpemilu.org#22287,"KANDANG LIMUN, MUARA BANGKA HULU, KOTA BENGKULU, BENGKULU",10,81,133,214
https://kawalpemilu.org#22287,"KANDANG LIMUN, MUARA BANGKA HULU, KOTA BENGKULU, BENGKULU",11,91,127,218
https://kawalpemilu.org#22287,"KANDANG LIMUN, MUARA BANGKA HULU, KOTA BENGKULU, BENGKULU",12,48,81,129
https://kawalpemilu.org#22287,"KANDANG LIMUN, MUARA BANGKA HULU, KOTA BENGKULU, BENGKULU",13,132,121,253
https://kawalpemilu.org#22287,"KANDANG LIMUN, MUARA BANGKA HULU, KOTA BENGKULU, BENGKULU",14,130,118,248
https://kawalpemilu.org#22287,"KANDANG LIMUN, MUARA BANGKA HULU, KOTA BENGKULU, BENGKULU",15,136,115,251
https://kawalpemilu.org#22287,"KANDANG LIMUN, MUARA BANGKA HULU, KOTA BENGKULU, BENGKULU",16,108,138,246
https://kawalpemilu.org#22287,"KANDANG LIMUN, MUARA BANGKA HULU, KOTA BENGKULU, BENGKULU",17,61,136,197
https://kawalpemilu.org#22287,"KANDANG LIMUN, MUARA BANGKA HULU, KOTA BENGKULU, BENGKULU",18,63,52,115
https://kawalpemilu.org#22287,"KANDANG LIMUN, MUARA BANGKA HULU, KOTA BENGKULU, BENGKULU",19,4,20,24
https://kawalpemilu.org#22288,"BENTIRING, MUARA BANGKA HULU, KOTA BENGKULU, BENGKULU",1,158,103,261
https://kawalpemilu.org#22288,"BENTIRING, MUARA BANGKA HULU, KOTA BENGKULU, BENGKULU",2,83,74,157
https://kawalpemilu.org#22288,"BENTIRING, MUARA BANGKA HULU, KOTA BENGKULU, BENGKULU",3,109,131,240
https://kawalpemilu.org#22288,"BENTIRING, MUARA BANGKA HULU, KOTA BENGKULU, BENGKULU",4,64,126,190
https://kawalpemilu.org#22288,"BENTIRING, MUARA BANGKA HULU, KOTA BENGKULU, BENGKULU",5,91,123,214
https://kawalpemilu.org#22288,"BENTIRING, MUARA BANGKA HULU, KOTA BENGKULU, BENGKULU",6,32,85,108
https://kawalpemilu.org#22288,"BENTIRING, MUARA BANGKA HULU, KOTA BENGKULU, BENGKULU",7,103,142,245
https://kawalpemilu.org#22288,"BENTIRING, MUARA BANGKA HULU, KOTA BENGKULU, BENGKULU",8,66,109,175
https://kawalpemilu.org#22288,"BENTIRING, MUARA BANGKA HULU, KOTA BENGKULU, BENGKULU",9,126,119,245
https://kawalpemilu.org#22288,"BENTIRING, MUARA BANGKA HULU, KOTA BENGKULU, BENGKULU",10,94,142,236
https://kawalpemilu.org#22288,"BENTIRING, MUARA BANGKA HULU, KOTA BENGKULU, BENGKULU",11,75,184,259
https://kawalpemilu.org#22288,"BENTIRING, MUARA BANGKA HULU, KOTA BENGKULU, BENGKULU",12,61,144,205
https://kawalpemilu.org#22288,"BENTIRING, MUARA BANGKA HULU, KOTA BENGKULU, BENGKULU",13,50,153,203
https://kawalpemilu.org#22288,"BENTIRING, MUARA BANGKA HULU, KOTA BENGKULU, BENGKULU",14,103,172,275
https://kawalpemilu.org#22288,"BENTIRING, MUARA BANGKA HULU, KOTA BENGKULU, BENGKULU",15,99,162,261
https://kawalpemilu.org#22288,"BENTIRING, MUARA BANGKA HULU, KOTA BENGKULU, BENGKULU",16,133,140,273
https://kawalpemilu.org#22288,"BENTIRING, MUARA BANGKA HULU, KOTA BENGKULU, BENGKULU",17,52,121,173
https://kawalpemilu.org#22288,"BENTIRING, MUARA BANGKA HULU, KOTA BENGKULU, BENGKULU",18,81,85,166
https://kawalpemilu.org#22288,"BENTIRING, MUARA BANGKA HULU, KOTA BENGKULU, BENGKULU",19,46,145,191
https://kawalpemilu.org#22288,"BENTIRING, MUARA BANGKA HULU, KOTA BENGKULU, BENGKULU",20,87,83,170
https://kawalpemilu.org#22288,"BENTIRING, MUARA BANGKA HULU, KOTA BENGKULU, BENGKULU",21,20,71,91
https://kawalpemilu.org#22289,"PEMATANG GUBERNUR, MUARA BANGKA HULU, KOTA BENGKULU, BENGKULU",1,86,157,243
https://kawalpemilu.org#22289,"PEMATANG GUBERNUR, MUARA BANGKA HULU, KOTA BENGKULU, BENGKULU",2,67,176,243
https://kawalpemilu.org#22289,"PEMATANG GUBERNUR, MUARA BANGKA HULU, KOTA BENGKULU, BENGKULU",3,73,147,220
https://kawalpemilu.org#22289,"PEMATANG GUBERNUR, MUARA BANGKA HULU, KOTA BENGKULU, BENGKULU",4,65,149,214
https://kawalpemilu.org#22289,"PEMATANG GUBERNUR, MUARA BANGKA HULU, KOTA BENGKULU, BENGKULU",5,91,148,239
https://kawalpemilu.org#22289,"PEMATANG GUBERNUR, MUARA BANGKA HULU, KOTA BENGKULU, BENGKULU",6,66,146,212
https://kawalpemilu.org#22289,"PEMATANG GUBERNUR, MUARA BANGKA HULU, KOTA BENGKULU, BENGKULU",7,60,150,210
https://kawalpemilu.org#22289,"PEMATANG GUBERNUR, MUARA BANGKA HULU, KOTA BENGKULU, BENGKULU",8,70,127,197
https://kawalpemilu.org#22289,"PEMATANG GUBERNUR, MUARA BANGKA HULU, KOTA BENGKULU, BENGKULU",9,94,138,232
https://kawalpemilu.org#22289,"PEMATANG GUBERNUR, MUARA BANGKA HULU, KOTA BENGKULU, BENGKULU",10,59,116,175
https://kawalpemilu.org#22289,"PEMATANG GUBERNUR, MUARA BANGKA HULU, KOTA BENGKULU, BENGKULU",11,80,80,160
https://kawalpemilu.org#22289,"PEMATANG GUBERNUR, MUARA BANGKA HULU, KOTA BENGKULU, BENGKULU",12,106,127,233
https://kawalpemilu.org#22289,"PEMATANG GUBERNUR, MUARA BANGKA HULU, KOTA BENGKULU, BENGKULU",13,102,155,257
https://kawalpemilu.org#22289,"PEMATANG GUBERNUR, MUARA BANGKA HULU, KOTA BENGKULU, BENGKULU",14,77,140,217
https://kawalpemilu.org#22289,"PEMATANG GUBERNUR, MUARA BANGKA HULU, KOTA BENGKULU, BENGKULU",15,35,152,187
https://kawalpemilu.org#22289,"PEMATANG GUBERNUR, MUARA BANGKA HULU, KOTA BENGKULU, BENGKULU",16,74,116,190
https://kawalpemilu.org#22289,"PEMATANG GUBERNUR, MUARA BANGKA HULU, KOTA BENGKULU, BENGKULU",17,50,91,141
https://kawalpemilu.org#22289,"PEMATANG GUBERNUR, MUARA BANGKA HULU, KOTA BENGKULU, BENGKULU",18,116,111,227
https://kawalpemilu.org#22289,"PEMATANG GUBERNUR, MUARA BANGKA HULU, KOTA BENGKULU, BENGKULU",19,86,161,247
https://kawalpemilu.org#22289,"PEMATANG GUBERNUR, MUARA BANGKA HULU, KOTA BENGKULU, BENGKULU",20,120,116,236
https://kawalpemilu.org#22289,"PEMATANG GUBERNUR, MUARA BANGKA HULU, KOTA BENGKULU, BENGKULU",21,99,138,237
https://kawalpemilu.org#22289,"PEMATANG GUBERNUR, MUARA BANGKA HULU, KOTA BENGKULU, BENGKULU",22,65,184,249
https://kawalpemilu.org#22289,"PEMATANG GUBERNUR, MUARA BANGKA HULU, KOTA BENGKULU, BENGKULU",23,101,177,278
https://kawalpemilu.org#22289,"PEMATANG GUBERNUR, MUARA BANGKA HULU, KOTA BENGKULU, BENGKULU",24,106,118,224
https://kawalpemilu.org#22290,"RAWA MAKMUR, MUARA BANGKA HULU, KOTA BENGKULU, BENGKULU",1,97,135,232
https://kawalpemilu.org#22290,"RAWA MAKMUR, MUARA BANGKA HULU, KOTA BENGKULU, BENGKULU",2,53,93,146
https://kawalpemilu.org#22290,"RAWA MAKMUR, MUARA BANGKA HULU, KOTA BENGKULU, BENGKULU",3,114,66,180
https://kawalpemilu.org#22290,"RAWA MAKMUR, MUARA BANGKA HULU, KOTA BENGKULU, BENGKULU",4,47,148,195
https://kawalpemilu.org#22290,"RAWA MAKMUR, MUARA BANGKA HULU, KOTA BENGKULU, BENGKULU",5,71,169,240
https://kawalpemilu.org#22290,"RAWA MAKMUR, MUARA BANGKA HULU, KOTA BENGKULU, BENGKULU",6,99,106,205
https://kawalpemilu.org#22290,"RAWA MAKMUR, MUARA BANGKA HULU, KOTA BENGKULU, BENGKULU",7,53,163,216
https://kawalpemilu.org#22290,"RAWA MAKMUR, MUARA BANGKA HULU, KOTA BENGKULU, BENGKULU",8,70,158,228
https://kawalpemilu.org#22290,"RAWA MAKMUR, MUARA BANGKA HULU, KOTA BENGKULU, BENGKULU",9,87,150,237
https://kawalpemilu.org#22290,"RAWA MAKMUR, MUARA BANGKA HULU, KOTA BENGKULU, BENGKULU",10,62,78,140
https://kawalpemilu.org#22290,"RAWA MAKMUR, MUARA BANGKA HULU, KOTA BENGKULU, BENGKULU",11,66,118,183
https://kawalpemilu.org#22290,"RAWA MAKMUR, MUARA BANGKA HULU, KOTA BENGKULU, BENGKULU",12,129,86,215
https://kawalpemilu.org#22290,"RAWA MAKMUR, MUARA BANGKA HULU, KOTA BENGKULU, BENGKULU",13,91,94,185
https://kawalpemilu.org#22290,"RAWA MAKMUR, MUARA BANGKA HULU, KOTA BENGKULU, BENGKULU",14,77,135,212
https://kawalpemilu.org#22290,"RAWA MAKMUR, MUARA BANGKA HULU, KOTA BENGKULU, BENGKULU",15,72,111,183
https://kawalpemilu.org#22290,"RAWA MAKMUR, MUARA BANGKA HULU, KOTA BENGKULU, BENGKULU",16,38,85,123
https://kawalpemilu.org#22290,"RAWA MAKMUR, MUARA BANGKA HULU, KOTA BENGKULU, BENGKULU",17,50,100,150
https://kawalpemilu.org#22290,"RAWA MAKMUR, MUARA BANGKA HULU, KOTA BENGKULU, BENGKULU",18,34,94,128
https://kawalpemilu.org#22290,"RAWA MAKMUR, MUARA BANGKA HULU, KOTA BENGKULU, BENGKULU",19,53,112,165
https://kawalpemilu.org#22290,"RAWA MAKMUR, MUARA BANGKA HULU, KOTA BENGKULU, BENGKULU",20,156,78,234
https://kawalpemilu.org#22290,"RAWA MAKMUR, MUARA BANGKA HULU, KOTA BENGKULU, BENGKULU",21,40,86,126
https://kawalpemilu.org#22290,"RAWA MAKMUR, MUARA BANGKA HULU, KOTA BENGKULU, BENGKULU",22,67,76,143
https://kawalpemilu.org#22291,"BERINGIN RAYA, MUARA BANGKA HULU, KOTA BENGKULU, BENGKULU",1,82,67,149
https://kawalpemilu.org#22291,"BERINGIN RAYA, MUARA BANGKA HULU, KOTA BENGKULU, BENGKULU",2,66,114,180
https://kawalpemilu.org#22291,"BERINGIN RAYA, MUARA BANGKA HULU, KOTA BENGKULU, BENGKULU",3,62,75,137
https://kawalpemilu.org#22291,"BERINGIN RAYA, MUARA BANGKA HULU, KOTA BENGKULU, BENGKULU",4,76,131,207
https://kawalpemilu.org#22291,"BERINGIN RAYA, MUARA BANGKA HULU, KOTA BENGKULU, BENGKULU",5,84,88,172
https://kawalpemilu.org#22291,"BERINGIN RAYA, MUARA BANGKA HULU, KOTA BENGKULU, BENGKULU",6,82,84,166
https://kawalpemilu.org#22291,"BERINGIN RAYA, MUARA BANGKA HULU, KOTA BENGKULU, BENGKULU",7,70,73,143
https://kawalpemilu.org#22292,"BENTIRING PERMAI, MUARA BANGKA HULU, KOTA BENGKULU, BENGKULU",1,93,90,183
https://kawalpemilu.org#22292,"BENTIRING PERMAI, MUARA BANGKA HULU, KOTA BENGKULU, BENGKULU",2,68,131,199
https://kawalpemilu.org#22292,"BENTIRING PERMAI, MUARA BANGKA HULU, KOTA BENGKULU, BENGKULU",3,68,109,177
https://kawalpemilu.org#22292,"BENTIRING PERMAI, MUARA BANGKA HULU, KOTA BENGKULU, BENGKULU",4,77,130,207
https://kawalpemilu.org#22292,"BENTIRING PERMAI, MUARA BANGKA HULU, KOTA BENGKULU, BENGKULU",5,107,157,264
https://kawalpemilu.org#22292,"BENTIRING PERMAI, MUARA BANGKA HULU, KOTA BENGKULU, BENGKULU",6,52,161,191
https://kawalpemilu.org#22292,"BENTIRING PERMAI, MUARA BANGKA HULU, KOTA BENGKULU, BENGKULU",7,90,84,174
https://kawalpemilu.org#22292,"BENTIRING PERMAI, MUARA BANGKA HULU, KOTA BENGKULU, BENGKULU",8,64,55,119
https://kawalpemilu.org#22292,"BENTIRING PERMAI, MUARA BANGKA HULU, KOTA BENGKULU, BENGKULU",9,89,114,203
https://kawalpemilu.org#22292,"BENTIRING PERMAI, MUARA BANGKA HULU, KOTA BENGKULU, BENGKULU",10,75,101,176
https://kawalpemilu.org#22292,"BENTIRING PERMAI, MUARA BANGKA HULU, KOTA BENGKULU, BENGKULU",11,56,86,142
https://kawalpemilu.org#22292,"BENTIRING PERMAI, MUARA BANGKA HULU, KOTA BENGKULU, BENGKULU",12,45,53,98
https://kawalpemilu.org#22292,"BENTIRING PERMAI, MUARA BANGKA HULU, KOTA BENGKULU, BENGKULU",13,42,90,132
https://kawalpemilu.org#22292,"BENTIRING PERMAI, MUARA BANGKA HULU, KOTA BENGKULU, BENGKULU",14,26,121,147
https://kawalpemilu.org#22292,"BENTIRING PERMAI, MUARA BANGKA HULU, KOTA BENGKULU, BENGKULU",15,80,111,191
https://kawalpemilu.org#22292,"BENTIRING PERMAI, MUARA BANGKA HULU, KOTA BENGKULU, BENGKULU",16,65,76,141
https://kawalpemilu.org#22292,"BENTIRING PERMAI, MUARA BANGKA HULU, KOTA BENGKULU, BENGKULU",17,83,98,181
https://kawalpemilu.org#22292,"BENTIRING PERMAI, MUARA BANGKA HULU, KOTA BENGKULU, BENGKULU",18,84,75,159
https://kawalpemilu.org#22292,"BENTIRING PERMAI, MUARA BANGKA HULU, KOTA BENGKULU, BENGKULU",19,45,59,104
https://kawalpemilu.org#22292,"BENTIRING PERMAI, MUARA BANGKA HULU, KOTA BENGKULU, BENGKULU",20,119,129,248
https://kawalpemilu.org#22292,"BENTIRING PERMAI, MUARA BANGKA HULU, KOTA BENGKULU, BENGKULU",21,90,103,193
https://kawalpemilu.org#22292,"BENTIRING PERMAI, MUARA BANGKA HULU, KOTA BENGKULU, BENGKULU",22,66,150,216
https://kawalpemilu.org#22292,"BENTIRING PERMAI, MUARA BANGKA HULU, KOTA BENGKULU, BENGKULU",23,58,112,170
https://kawalpemilu.org#22292,"BENTIRING PERMAI, MUARA BANGKA HULU, KOTA BENGKULU, BENGKULU",24,33,80,113
https://kawalpemilu.org#22292,"BENTIRING PERMAI, MUARA BANGKA HULU, KOTA BENGKULU, BENGKULU",25,56,79,135
https://kawalpemilu.org#22292,"BENTIRING PERMAI, MUARA BANGKA HULU, KOTA BENGKULU, BENGKULU",26,57,95,152
https://kawalpemilu.org#22293,"RAWA MAKMUR PERMAI, MUARA BANGKA HULU, KOTA BENGKULU, BENGKULU",1,93,131,224
https://kawalpemilu.org#22293,"RAWA MAKMUR PERMAI, MUARA BANGKA HULU, KOTA BENGKULU, BENGKULU",2,43,86,129
https://kawalpemilu.org#22293,"RAWA MAKMUR PERMAI, MUARA BANGKA HULU, KOTA BENGKULU, BENGKULU",3,92,80,172
https://kawalpemilu.org#22293,"RAWA MAKMUR PERMAI, MUARA BANGKA HULU, KOTA BENGKULU, BENGKULU",4,61,148,209
https://kawalpemilu.org#22293,"RAWA MAKMUR PERMAI, MUARA BANGKA HULU, KOTA BENGKULU, BENGKULU",5,63,90,153
https://kawalpemilu.org#22293,"RAWA MAKMUR PERMAI, MUARA BANGKA HULU, KOTA BENGKULU, BENGKULU",6,89,86,175
https://kawalpemilu.org#22293,"RAWA MAKMUR PERMAI, MUARA BANGKA HULU, KOTA BENGKULU, BENGKULU",7,83,76,159
https://kawalpemilu.org#22293,"RAWA MAKMUR PERMAI, MUARA BANGKA HULU, KOTA BENGKULU, BENGKULU",8,62,66,128
https://kawalpemilu.org#22293,"RAWA MAKMUR PERMAI, MUARA BANGKA HULU, KOTA BENGKULU, BENGKULU",9,64,89,153
https://kawalpemilu.org#22293,"RAWA MAKMUR PERMAI, MUARA BANGKA HULU, KOTA BENGKULU, BENGKULU",10,53,64,117
https://kawalpemilu.org#22293,"RAWA MAKMUR PERMAI, MUARA BANGKA HULU, KOTA BENGKULU, BENGKULU",11,120,124,244
https://kawalpemilu.org#22293,"RAWA MAKMUR PERMAI, MUARA BANGKA HULU, KOTA BENGKULU, BENGKULU",12,69,56,125
https://kawalpemilu.org#22293,"RAWA MAKMUR PERMAI, MUARA BANGKA HULU, KOTA BENGKULU, BENGKULU",13,119,122,241
https://kawalpemilu.org#22293,"RAWA MAKMUR PERMAI, MUARA BANGKA HULU, KOTA BENGKULU, BENGKULU",14,74,70,144
https://kawalpemilu.org#22293,"RAWA MAKMUR PERMAI, MUARA BANGKA HULU, KOTA BENGKULU, BENGKULU",15,49,59,108
https://kawalpemilu.org#22293,"RAWA MAKMUR PERMAI, MUARA BANGKA HULU, KOTA BENGKULU, BENGKULU",16,40,66,106
https://kawalpemilu.org#22293,"RAWA MAKMUR PERMAI, MUARA BANGKA HULU, KOTA BENGKULU, BENGKULU",17,76,96,172
https://kawalpemilu.org#22295,"KANDANG, KAMPUNG MELAYU, KOTA BENGKULU, BENGKULU",1,125,69,194
https://kawalpemilu.org#22295,"KANDANG, KAMPUNG MELAYU, KOTA BENGKULU, BENGKULU",2,82,85,167
https://kawalpemilu.org#22295,"KANDANG, KAMPUNG MELAYU, KOTA BENGKULU, BENGKULU",3,98,108,206
https://kawalpemilu.org#22295,"KANDANG, KAMPUNG MELAYU, KOTA BENGKULU, BENGKULU",4,95,92,187
https://kawalpemilu.org#22295,"KANDANG, KAMPUNG MELAYU, KOTA BENGKULU, BENGKULU",5,106,59,165
https://kawalpemilu.org#22295,"KANDANG, KAMPUNG MELAYU, KOTA BENGKULU, BENGKULU",6,50,40,90
https://kawalpemilu.org#22295,"KANDANG, KAMPUNG MELAYU, KOTA BENGKULU, BENGKULU",7,109,90,199
https://kawalpemilu.org#22295,"KANDANG, KAMPUNG MELAYU, KOTA BENGKULU, BENGKULU",8,106,113,219
https://kawalpemilu.org#22295,"KANDANG, KAMPUNG MELAYU, KOTA BENGKULU, BENGKULU",9,113,148,261
https://kawalpemilu.org#22295,"KANDANG, KAMPUNG MELAYU, KOTA BENGKULU, BENGKULU",10,105,89,194
https://kawalpemilu.org#22295,"KANDANG, KAMPUNG MELAYU, KOTA BENGKULU, BENGKULU",11,113,77,190
https://kawalpemilu.org#22295,"KANDANG, KAMPUNG MELAYU, KOTA BENGKULU, BENGKULU",12,116,77,193
https://kawalpemilu.org#22295,"KANDANG, KAMPUNG MELAYU, KOTA BENGKULU, BENGKULU",13,113,63,176
https://kawalpemilu.org#22295,"KANDANG, KAMPUNG MELAYU, KOTA BENGKULU, BENGKULU",14,106,68,174
https://kawalpemilu.org#22295,"KANDANG, KAMPUNG MELAYU, KOTA BENGKULU, BENGKULU",15,43,89,132
https://kawalpemilu.org#22295,"KANDANG, KAMPUNG MELAYU, KOTA BENGKULU, BENGKULU",16,118,138,256
https://kawalpemilu.org#22295,"KANDANG, KAMPUNG MELAYU, KOTA BENGKULU, BENGKULU",17,77,86,163
https://kawalpemilu.org#22295,"KANDANG, KAMPUNG MELAYU, KOTA BENGKULU, BENGKULU",18,113,108,221
https://kawalpemilu.org#22295,"KANDANG, KAMPUNG MELAYU, KOTA BENGKULU, BENGKULU",19,79,106,185
https://kawalpemilu.org#22295,"KANDANG, KAMPUNG MELAYU, KOTA BENGKULU, BENGKULU",20,63,45,108
https://kawalpemilu.org#22295,"KANDANG, KAMPUNG MELAYU, KOTA BENGKULU, BENGKULU",21,113,72,185
https://kawalpemilu.org#22295,"KANDANG, KAMPUNG MELAYU, KOTA BENGKULU, BENGKULU",22,75,81,156
https://kawalpemilu.org#22296,"PADANG SERAI, KAMPUNG MELAYU, KOTA BENGKULU, BENGKULU",1,169,47,216
https://kawalpemilu.org#22296,"PADANG SERAI, KAMPUNG MELAYU, KOTA BENGKULU, BENGKULU",2,136,78,214
https://kawalpemilu.org#22296,"PADANG SERAI, KAMPUNG MELAYU, KOTA BENGKULU, BENGKULU",3,129,48,177
https://kawalpemilu.org#22296,"PADANG SERAI, KAMPUNG MELAYU, KOTA BENGKULU, BENGKULU",4,111,75,186
https://kawalpemilu.org#22296,"PADANG SERAI, KAMPUNG MELAYU, KOTA BENGKULU, BENGKULU",5,117,65,182
https://kawalpemilu.org#22296,"PADANG SERAI, KAMPUNG MELAYU, KOTA BENGKULU, BENGKULU",6,80,60,140
https://kawalpemilu.org#22296,"PADANG SERAI, KAMPUNG MELAYU, KOTA BENGKULU, BENGKULU",7,131,78,209
https://kawalpemilu.org#22296,"PADANG SERAI, KAMPUNG MELAYU, KOTA BENGKULU, BENGKULU",8,62,39,101
https://kawalpemilu.org#22296,"PADANG SERAI, KAMPUNG MELAYU, KOTA BENGKULU, BENGKULU",9,116,62,178
https://kawalpemilu.org#22296,"PADANG SERAI, KAMPUNG MELAYU, KOTA BENGKULU, BENGKULU",10,123,38,161
https://kawalpemilu.org#22296,"PADANG SERAI, KAMPUNG MELAYU, KOTA BENGKULU, BENGKULU",11,90,69,159
https://kawalpemilu.org#22296,"PADANG SERAI, KAMPUNG MELAYU, KOTA BENGKULU, BENGKULU",12,98,32,130
https://kawalpemilu.org#22296,"PADANG SERAI, KAMPUNG MELAYU, KOTA BENGKULU, BENGKULU",13,94,76,170
https://kawalpemilu.org#22296,"PADANG SERAI, KAMPUNG MELAYU, KOTA BENGKULU, BENGKULU",14,101,56,157
https://kawalpemilu.org#22296,"PADANG SERAI, KAMPUNG MELAYU, KOTA BENGKULU, BENGKULU",15,156,106,258
https://kawalpemilu.org#22296,"PADANG SERAI, KAMPUNG MELAYU, KOTA BENGKULU, BENGKULU",16,137,47,184
https://kawalpemilu.org#22296,"PADANG SERAI, KAMPUNG MELAYU, KOTA BENGKULU, BENGKULU",17,164,73,237
https://kawalpemilu.org#22296,"PADANG SERAI, KAMPUNG MELAYU, KOTA BENGKULU, BENGKULU",18,104,21,125
https://kawalpemilu.org#22297,"KANDANG MAS, KAMPUNG MELAYU, KOTA BENGKULU, BENGKULU",1,118,131,249
https://kawalpemilu.org#22297,"KANDANG MAS, KAMPUNG MELAYU, KOTA BENGKULU, BENGKULU",2,83,154,237
https://kawalpemilu.org#22297,"KANDANG MAS, KAMPUNG MELAYU, KOTA BENGKULU, BENGKULU",3,88,160,248
https://kawalpemilu.org#22297,"KANDANG MAS, KAMPUNG MELAYU, KOTA BENGKULU, BENGKULU",4,85,160,245
https://kawalpemilu.org#22297,"KANDANG MAS, KAMPUNG MELAYU, KOTA BENGKULU, BENGKULU",5,72,194,266
https://kawalpemilu.org#22297,"KANDANG MAS, KAMPUNG MELAYU, KOTA BENGKULU, BENGKULU",6,103,148,251
https://kawalpemilu.org#22297,"KANDANG MAS, KAMPUNG MELAYU, KOTA BENGKULU, BENGKULU",7,106,111,217
https://kawalpemilu.org#22297,"KANDANG MAS, KAMPUNG MELAYU, KOTA BENGKULU, BENGKULU",8,114,140,254
https://kawalpemilu.org#22297,"KANDANG MAS, KAMPUNG MELAYU, KOTA BENGKULU, BENGKULU",9,102,162,264
https://kawalpemilu.org#22297,"KANDANG MAS, KAMPUNG MELAYU, KOTA BENGKULU, BENGKULU",10,109,129,238
https://kawalpemilu.org#22297,"KANDANG MAS, KAMPUNG MELAYU, KOTA BENGKULU, BENGKULU",11,122,155,277
https://kawalpemilu.org#22297,"KANDANG MAS, KAMPUNG MELAYU, KOTA BENGKULU, BENGKULU",12,120,122,242
https://kawalpemilu.org#22297,"KANDANG MAS, KAMPUNG MELAYU, KOTA BENGKULU, BENGKULU",13,107,150,257
https://kawalpemilu.org#22297,"KANDANG MAS, KAMPUNG MELAYU, KOTA BENGKULU, BENGKULU",14,120,125,245
https://kawalpemilu.org#22297,"KANDANG MAS, KAMPUNG MELAYU, KOTA BENGKULU, BENGKULU",15,106,100,206
https://kawalpemilu.org#22297,"KANDANG MAS, KAMPUNG MELAYU, KOTA BENGKULU, BENGKULU",16,121,119,240
https://kawalpemilu.org#22297,"KANDANG MAS, KAMPUNG MELAYU, KOTA BENGKULU, BENGKULU",17,98,104,202
https://kawalpemilu.org#22297,"KANDANG MAS, KAMPUNG MELAYU, KOTA BENGKULU, BENGKULU",18,132,67,199
https://kawalpemilu.org#22297,"KANDANG MAS, KAMPUNG MELAYU, KOTA BENGKULU, BENGKULU",19,72,109,181
https://kawalpemilu.org#22297,"KANDANG MAS, KAMPUNG MELAYU, KOTA BENGKULU, BENGKULU",20,84,123,207
https://kawalpemilu.org#22297,"KANDANG MAS, KAMPUNG MELAYU, KOTA BENGKULU, BENGKULU",21,112,89,201
https://kawalpemilu.org#22297,"KANDANG MAS, KAMPUNG MELAYU, KOTA BENGKULU, BENGKULU",22,95,122,217
https://kawalpemilu.org#22297,"KANDANG MAS, KAMPUNG MELAYU, KOTA BENGKULU, BENGKULU",23,99,150,249
https://kawalpemilu.org#22297,"KANDANG MAS, KAMPUNG MELAYU, KOTA BENGKULU, BENGKULU",24,108,127,235
https://kawalpemilu.org#22297,"KANDANG MAS, KAMPUNG MELAYU, KOTA BENGKULU, BENGKULU",25,86,105,191
https://kawalpemilu.org#22297,"KANDANG MAS, KAMPUNG MELAYU, KOTA BENGKULU, BENGKULU",26,93,164,257
https://kawalpemilu.org#22297,"KANDANG MAS, KAMPUNG MELAYU, KOTA BENGKULU, BENGKULU",27,125,75,200
https://kawalpemilu.org#22297,"KANDANG MAS, KAMPUNG MELAYU, KOTA BENGKULU, BENGKULU",28,153,76,229
https://kawalpemilu.org#22297,"KANDANG MAS, KAMPUNG MELAYU, KOTA BENGKULU, BENGKULU",29,112,122,234
https://kawalpemilu.org#22298,"TELUK SEPANG, KAMPUNG MELAYU, KOTA BENGKULU, BENGKULU",1,121,87,208
https://kawalpemilu.org#22298,"TELUK SEPANG, KAMPUNG MELAYU, KOTA BENGKULU, BENGKULU",2,149,56,205
https://kawalpemilu.org#22298,"TELUK SEPANG, KAMPUNG MELAYU, KOTA BENGKULU, BENGKULU",3,139,79,218
https://kawalpemilu.org#22298,"TELUK SEPANG, KAMPUNG MELAYU, KOTA BENGKULU, BENGKULU",4,118,95,213
https://kawalpemilu.org#22298,"TELUK SEPANG, KAMPUNG MELAYU, KOTA BENGKULU, BENGKULU",6,175,57,232
https://kawalpemilu.org#22298,"TELUK SEPANG, KAMPUNG MELAYU, KOTA BENGKULU, BENGKULU",7,113,16,129
https://kawalpemilu.org#22298,"TELUK SEPANG, KAMPUNG MELAYU, KOTA BENGKULU, BENGKULU",8,138,22,160
https://kawalpemilu.org#22298,"TELUK SEPANG, KAMPUNG MELAYU, KOTA BENGKULU, BENGKULU",9,116,44,160
https://kawalpemilu.org#22299,"SUMBER JAYA, KAMPUNG MELAYU, KOTA BENGKULU, BENGKULU",1,172,24,196
https://kawalpemilu.org#22299,"SUMBER JAYA, KAMPUNG MELAYU, KOTA BENGKULU, BENGKULU",2,164,22,186
https://kawalpemilu.org#22299,"SUMBER JAYA, KAMPUNG MELAYU, KOTA BENGKULU, BENGKULU",3,163,60,223
https://kawalpemilu.org#22299,"SUMBER JAYA, KAMPUNG MELAYU, KOTA BENGKULU, BENGKULU",4,205,52,257
https://kawalpemilu.org#22299,"SUMBER JAYA, KAMPUNG MELAYU, KOTA BENGKULU, BENGKULU",5,172,28,200
https://kawalpemilu.org#22299,"SUMBER JAYA, KAMPUNG MELAYU, KOTA BENGKULU, BENGKULU",6,163,31,194
https://kawalpemilu.org#22299,"SUMBER JAYA, KAMPUNG MELAYU, KOTA BENGKULU, BENGKULU",7,174,49,223
https://kawalpemilu.org#22299,"SUMBER JAYA, KAMPUNG MELAYU, KOTA BENGKULU, BENGKULU",8,156,69,225
https://kawalpemilu.org#22299,"SUMBER JAYA, KAMPUNG MELAYU, KOTA BENGKULU, BENGKULU",9,188,25,213
https://kawalpemilu.org#22299,"SUMBER JAYA, KAMPUNG MELAYU, KOTA BENGKULU, BENGKULU",10,112,31,143
https://kawalpemilu.org#22299,"SUMBER JAYA, KAMPUNG MELAYU, KOTA BENGKULU, BENGKULU",11,62,36,98
https://kawalpemilu.org#22299,"SUMBER JAYA, KAMPUNG MELAYU, KOTA BENGKULU, BENGKULU",12,98,85,183
https://kawalpemilu.org#22299,"SUMBER JAYA, KAMPUNG MELAYU, KOTA BENGKULU, BENGKULU",13,97,97,194
https://kawalpemilu.org#22299,"SUMBER JAYA, KAMPUNG MELAYU, KOTA BENGKULU, BENGKULU",14,91,75,166
https://kawalpemilu.org#22299,"SUMBER JAYA, KAMPUNG MELAYU, KOTA BENGKULU, BENGKULU",15,133,109,242
https://kawalpemilu.org#22299,"SUMBER JAYA, KAMPUNG MELAYU, KOTA BENGKULU, BENGKULU",16,114,89,203
https://kawalpemilu.org#22299,"SUMBER JAYA, KAMPUNG MELAYU, KOTA BENGKULU, BENGKULU",17,125,96,221
https://kawalpemilu.org#22299,"SUMBER JAYA, KAMPUNG MELAYU, KOTA BENGKULU, BENGKULU",18,128,66,194
https://kawalpemilu.org#22299,"SUMBER JAYA, KAMPUNG MELAYU, KOTA BENGKULU, BENGKULU",19,96,44,140
https://kawalpemilu.org#22299,"SUMBER JAYA, KAMPUNG MELAYU, KOTA BENGKULU, BENGKULU",20,132,67,199
https://kawalpemilu.org#22299,"SUMBER JAYA, KAMPUNG MELAYU, KOTA BENGKULU, BENGKULU",21,127,116,243
https://kawalpemilu.org#22299,"SUMBER JAYA, KAMPUNG MELAYU, KOTA BENGKULU, BENGKULU",22,158,36,194
https://kawalpemilu.org#22299,"SUMBER JAYA, KAMPUNG MELAYU, KOTA BENGKULU, BENGKULU",23,146,39,185
https://kawalpemilu.org#22299,"SUMBER JAYA, KAMPUNG MELAYU, KOTA BENGKULU, BENGKULU",24,91,13,104
https://kawalpemilu.org#22300,"MUARA DUA, KAMPUNG MELAYU, KOTA BENGKULU, BENGKULU",1,52,89,141
https://kawalpemilu.org#22300,"MUARA DUA, KAMPUNG MELAYU, KOTA BENGKULU, BENGKULU",2,61,89,150
https://kawalpemilu.org#22300,"MUARA DUA, KAMPUNG MELAYU, KOTA BENGKULU, BENGKULU",3,53,70,123
https://kawalpemilu.org#22300,"MUARA DUA, KAMPUNG MELAYU, KOTA BENGKULU, BENGKULU",4,91,67,158
https://kawalpemilu.org#22300,"MUARA DUA, KAMPUNG MELAYU, KOTA BENGKULU, BENGKULU",5,87,116,203
https://kawalpemilu.org#22300,"MUARA DUA, KAMPUNG MELAYU, KOTA BENGKULU, BENGKULU",6,88,73,161
https://kawalpemilu.org#22300,"MUARA DUA, KAMPUNG MELAYU, KOTA BENGKULU, BENGKULU",7,98,31,129
https://kawalpemilu.org#22302,"KEBUN TEBENG, RATU AGUNG, KOTA BENGKULU, BENGKULU",1,73,106,179
https://kawalpemilu.org#22302,"KEBUN TEBENG, RATU AGUNG, KOTA BENGKULU, BENGKULU",2,84,83,167
https://kawalpemilu.org#22302,"KEBUN TEBENG, RATU AGUNG, KOTA BENGKULU, BENGKULU",3,82,148,230
https://kawalpemilu.org#22302,"KEBUN TEBENG, RATU AGUNG, KOTA BENGKULU, BENGKULU",4,98,115,213
https://kawalpemilu.org#22302,"KEBUN TEBENG, RATU AGUNG, KOTA BENGKULU, BENGKULU",5,110,131,241
https://kawalpemilu.org#22302,"KEBUN TEBENG, RATU AGUNG, KOTA BENGKULU, BENGKULU",6,104,134,238
https://kawalpemilu.org#22302,"KEBUN TEBENG, RATU AGUNG, KOTA BENGKULU, BENGKULU",7,92,134,226
https://kawalpemilu.org#22302,"KEBUN TEBENG, RATU AGUNG, KOTA BENGKULU, BENGKULU",8,101,169,270
https://kawalpemilu.org#22302,"KEBUN TEBENG, RATU AGUNG, KOTA BENGKULU, BENGKULU",9,127,125,252
https://kawalpemilu.org#22302,"KEBUN TEBENG, RATU AGUNG, KOTA BENGKULU, BENGKULU",10,121,117,238
https://kawalpemilu.org#22302,"KEBUN TEBENG, RATU AGUNG, KOTA BENGKULU, BENGKULU",11,108,125,233
https://kawalpemilu.org#22302,"KEBUN TEBENG, RATU AGUNG, KOTA BENGKULU, BENGKULU",12,134,112,246
https://kawalpemilu.org#22302,"KEBUN TEBENG, RATU AGUNG, KOTA BENGKULU, BENGKULU",13,82,141,223
https://kawalpemilu.org#22302,"KEBUN TEBENG, RATU AGUNG, KOTA BENGKULU, BENGKULU",14,93,139,232
https://kawalpemilu.org#22302,"KEBUN TEBENG, RATU AGUNG, KOTA BENGKULU, BENGKULU",15,121,131,252
https://kawalpemilu.org#22303,"TANAH PATAH, RATU AGUNG, KOTA BENGKULU, BENGKULU",1,89,142,231
https://kawalpemilu.org#22303,"TANAH PATAH, RATU AGUNG, KOTA BENGKULU, BENGKULU",2,121,100,221
https://kawalpemilu.org#22303,"TANAH PATAH, RATU AGUNG, KOTA BENGKULU, BENGKULU",3,125,148,273
https://kawalpemilu.org#22303,"TANAH PATAH, RATU AGUNG, KOTA BENGKULU, BENGKULU",4,146,92,238
https://kawalpemilu.org#22303,"TANAH PATAH, RATU AGUNG, KOTA BENGKULU, BENGKULU",5,86,118,204
https://kawalpemilu.org#22303,"TANAH PATAH, RATU AGUNG, KOTA BENGKULU, BENGKULU",6,93,122,215
https://kawalpemilu.org#22303,"TANAH PATAH, RATU AGUNG, KOTA BENGKULU, BENGKULU",7,95,140,235
https://kawalpemilu.org#22303,"TANAH PATAH, RATU AGUNG, KOTA BENGKULU, BENGKULU",8,95,128,223
https://kawalpemilu.org#22303,"TANAH PATAH, RATU AGUNG, KOTA BENGKULU, BENGKULU",9,130,130,260
https://kawalpemilu.org#22303,"TANAH PATAH, RATU AGUNG, KOTA BENGKULU, BENGKULU",10,65,140,205
https://kawalpemilu.org#22303,"TANAH PATAH, RATU AGUNG, KOTA BENGKULU, BENGKULU",11,105,138,243
https://kawalpemilu.org#22303,"TANAH PATAH, RATU AGUNG, KOTA BENGKULU, BENGKULU",12,87,132,219
https://kawalpemilu.org#22303,"TANAH PATAH, RATU AGUNG, KOTA BENGKULU, BENGKULU",13,95,159,254
https://kawalpemilu.org#22303,"TANAH PATAH, RATU AGUNG, KOTA BENGKULU, BENGKULU",14,120,136,256
https://kawalpemilu.org#22303,"TANAH PATAH, RATU AGUNG, KOTA BENGKULU, BENGKULU",15,103,136,239
https://kawalpemilu.org#22303,"TANAH PATAH, RATU AGUNG, KOTA BENGKULU, BENGKULU",16,46,108,154
https://kawalpemilu.org#22303,"TANAH PATAH, RATU AGUNG, KOTA BENGKULU, BENGKULU",17,65,48,113
https://kawalpemilu.org#22304,"NUSA INDAH, RATU AGUNG, KOTA BENGKULU, BENGKULU",1,78,134,212
https://kawalpemilu.org#22304,"NUSA INDAH, RATU AGUNG, KOTA BENGKULU, BENGKULU",2,71,145,216
https://kawalpemilu.org#22304,"NUSA INDAH, RATU AGUNG, KOTA BENGKULU, BENGKULU",3,59,95,154
https://kawalpemilu.org#22304,"NUSA INDAH, RATU AGUNG, KOTA BENGKULU, BENGKULU",4,61,164,225
https://kawalpemilu.org#22304,"NUSA INDAH, RATU AGUNG, KOTA BENGKULU, BENGKULU",5,91,134,225
https://kawalpemilu.org#22304,"NUSA INDAH, RATU AGUNG, KOTA BENGKULU, BENGKULU",6,74,181,255
https://kawalpemilu.org#22304,"NUSA INDAH, RATU AGUNG, KOTA BENGKULU, BENGKULU",7,75,132,207
https://kawalpemilu.org#22304,"NUSA INDAH, RATU AGUNG, KOTA BENGKULU, BENGKULU",8,68,147,215
https://kawalpemilu.org#22304,"NUSA INDAH, RATU AGUNG, KOTA BENGKULU, BENGKULU",9,74,122,196
https://kawalpemilu.org#22304,"NUSA INDAH, RATU AGUNG, KOTA BENGKULU, BENGKULU",10,108,125,233
https://kawalpemilu.org#22304,"NUSA INDAH, RATU AGUNG, KOTA BENGKULU, BENGKULU",11,70,168,238
https://kawalpemilu.org#22304,"NUSA INDAH, RATU AGUNG, KOTA BENGKULU, BENGKULU",12,82,99,181
https://kawalpemilu.org#22304,"NUSA INDAH, RATU AGUNG, KOTA BENGKULU, BENGKULU",13,62,92,154
https://kawalpemilu.org#22304,"NUSA INDAH, RATU AGUNG, KOTA BENGKULU, BENGKULU",14,78,126,204
https://kawalpemilu.org#22304,"NUSA INDAH, RATU AGUNG, KOTA BENGKULU, BENGKULU",15,48,83,131
https://kawalpemilu.org#22304,"NUSA INDAH, RATU AGUNG, KOTA BENGKULU, BENGKULU",16,46,103,149
https://kawalpemilu.org#22305,"KEBUN BELER, RATU AGUNG, KOTA BENGKULU, BENGKULU",1,105,71,176
https://kawalpemilu.org#22305,"KEBUN BELER, RATU AGUNG, KOTA BENGKULU, BENGKULU",2,84,90,174
https://kawalpemilu.org#22305,"KEBUN BELER, RATU AGUNG, KOTA BENGKULU, BENGKULU",3,107,149,256
https://kawalpemilu.org#22305,"KEBUN BELER, RATU AGUNG, KOTA BENGKULU, BENGKULU",4,78,149,227
https://kawalpemilu.org#22305,"KEBUN BELER, RATU AGUNG, KOTA BENGKULU, BENGKULU",5,82,160,242
https://kawalpemilu.org#22305,"KEBUN BELER, RATU AGUNG, KOTA BENGKULU, BENGKULU",6,83,142,225
https://kawalpemilu.org#22305,"KEBUN BELER, RATU AGUNG, KOTA BENGKULU, BENGKULU",7,113,88,201
https://kawalpemilu.org#22305,"KEBUN BELER, RATU AGUNG, KOTA BENGKULU, BENGKULU",8,78,137,215
https://kawalpemilu.org#22305,"KEBUN BELER, RATU AGUNG, KOTA BENGKULU, BENGKULU",9,97,119,216
https://kawalpemilu.org#22305,"KEBUN BELER, RATU AGUNG, KOTA BENGKULU, BENGKULU",10,110,77,187
https://kawalpemilu.org#22305,"KEBUN BELER, RATU AGUNG, KOTA BENGKULU, BENGKULU",11,101,100,201
https://kawalpemilu.org#22306,"KEBUN KENANGA, RATU AGUNG, KOTA BENGKULU, BENGKULU",1,80,119,199
https://kawalpemilu.org#22306,"KEBUN KENANGA, RATU AGUNG, KOTA BENGKULU, BENGKULU",2,76,109,185
https://kawalpemilu.org#22306,"KEBUN KENANGA, RATU AGUNG, KOTA BENGKULU, BENGKULU",3,87,134,221
https://kawalpemilu.org#22306,"KEBUN KENANGA, RATU AGUNG, KOTA BENGKULU, BENGKULU",4,71,123,194
https://kawalpemilu.org#22306,"KEBUN KENANGA, RATU AGUNG, KOTA BENGKULU, BENGKULU",5,80,134,214
https://kawalpemilu.org#22306,"KEBUN KENANGA, RATU AGUNG, KOTA BENGKULU, BENGKULU",6,74,168,242
https://kawalpemilu.org#22306,"KEBUN KENANGA, RATU AGUNG, KOTA BENGKULU, BENGKULU",7,66,172,238
https://kawalpemilu.org#22306,"KEBUN KENANGA, RATU AGUNG, KOTA BENGKULU, BENGKULU",8,91,75,166
https://kawalpemilu.org#22306,"KEBUN KENANGA, RATU AGUNG, KOTA BENGKULU, BENGKULU",9,89,128,217
https://kawalpemilu.org#22306,"KEBUN KENANGA, RATU AGUNG, KOTA BENGKULU, BENGKULU",10,110,121,231
https://kawalpemilu.org#22306,"KEBUN KENANGA, RATU AGUNG, KOTA BENGKULU, BENGKULU",11,85,171,256
https://kawalpemilu.org#22306,"KEBUN KENANGA, RATU AGUNG, KOTA BENGKULU, BENGKULU",12,82,116,198
https://kawalpemilu.org#22306,"KEBUN KENANGA, RATU AGUNG, KOTA BENGKULU, BENGKULU",13,78,104,182
https://kawalpemilu.org#22306,"KEBUN KENANGA, RATU AGUNG, KOTA BENGKULU, BENGKULU",14,90,95,185
https://kawalpemilu.org#22306,"KEBUN KENANGA, RATU AGUNG, KOTA BENGKULU, BENGKULU",15,71,104,175
https://kawalpemilu.org#22306,"KEBUN KENANGA, RATU AGUNG, KOTA BENGKULU, BENGKULU",16,107,47,154
https://kawalpemilu.org#22307,"SAWAH LEBAR, RATU AGUNG, KOTA BENGKULU, BENGKULU",1,107,152,266
https://kawalpemilu.org#22307,"SAWAH LEBAR, RATU AGUNG, KOTA BENGKULU, BENGKULU",2,85,153,238
https://kawalpemilu.org#22307,"SAWAH LEBAR, RATU AGUNG, KOTA BENGKULU, BENGKULU",3,66,119,185
https://kawalpemilu.org#22307,"SAWAH LEBAR, RATU AGUNG, KOTA BENGKULU, BENGKULU",4,78,72,150
https://kawalpemilu.org#22307,"SAWAH LEBAR, RATU AGUNG, KOTA BENGKULU, BENGKULU",5,111,117,228
https://kawalpemilu.org#22307,"SAWAH LEBAR, RATU AGUNG, KOTA BENGKULU, BENGKULU",6,63,138,201
https://kawalpemilu.org#22307,"SAWAH LEBAR, RATU AGUNG, KOTA BENGKULU, BENGKULU",7,121,119,240
https://kawalpemilu.org#22307,"SAWAH LEBAR, RATU AGUNG, KOTA BENGKULU, BENGKULU",8,80,92,172
https://kawalpemilu.org#22307,"SAWAH LEBAR, RATU AGUNG, KOTA BENGKULU, BENGKULU",9,65,103,168
https://kawalpemilu.org#22307,"SAWAH LEBAR, RATU AGUNG, KOTA BENGKULU, BENGKULU",10,87,142,229
https://kawalpemilu.org#22307,"SAWAH LEBAR, RATU AGUNG, KOTA BENGKULU, BENGKULU",11,70,137,207
https://kawalpemilu.org#22307,"SAWAH LEBAR, RATU AGUNG, KOTA BENGKULU, BENGKULU",12,111,110,221
https://kawalpemilu.org#22307,"SAWAH LEBAR, RATU AGUNG, KOTA BENGKULU, BENGKULU",13,83,123,206
https://kawalpemilu.org#22307,"SAWAH LEBAR, RATU AGUNG, KOTA BENGKULU, BENGKULU",14,105,121,226
https://kawalpemilu.org#22307,"SAWAH LEBAR, RATU AGUNG, KOTA BENGKULU, BENGKULU",15,99,118,217
https://kawalpemilu.org#22307,"SAWAH LEBAR, RATU AGUNG, KOTA BENGKULU, BENGKULU",16,55,163,218
https://kawalpemilu.org#22307,"SAWAH LEBAR, RATU AGUNG, KOTA BENGKULU, BENGKULU",17,94,148,242
https://kawalpemilu.org#22307,"SAWAH LEBAR, RATU AGUNG, KOTA BENGKULU, BENGKULU",18,111,140,251
https://kawalpemilu.org#22307,"SAWAH LEBAR, RATU AGUNG, KOTA BENGKULU, BENGKULU",19,72,164,236
https://kawalpemilu.org#22307,"SAWAH LEBAR, RATU AGUNG, KOTA BENGKULU, BENGKULU",20,95,171,266
https://kawalpemilu.org#22307,"SAWAH LEBAR, RATU AGUNG, KOTA BENGKULU, BENGKULU",21,51,160,211
https://kawalpemilu.org#22307,"SAWAH LEBAR, RATU AGUNG, KOTA BENGKULU, BENGKULU",22,88,127,215
https://kawalpemilu.org#22307,"SAWAH LEBAR, RATU AGUNG, KOTA BENGKULU, BENGKULU",23,81,128,209
https://kawalpemilu.org#22308,"SAWAH LEBAR BARU, RATU AGUNG, KOTA BENGKULU, BENGKULU",1,126,133,259
https://kawalpemilu.org#22308,"SAWAH LEBAR BARU, RATU AGUNG, KOTA BENGKULU, BENGKULU",2,83,163,246
https://kawalpemilu.org#22308,"SAWAH LEBAR BARU, RATU AGUNG, KOTA BENGKULU, BENGKULU",3,60,161,221
https://kawalpemilu.org#22308,"SAWAH LEBAR BARU, RATU AGUNG, KOTA BENGKULU, BENGKULU",4,53,115,168
https://kawalpemilu.org#22308,"SAWAH LEBAR BARU, RATU AGUNG, KOTA BENGKULU, BENGKULU",5,85,155,240
https://kawalpemilu.org#22308,"SAWAH LEBAR BARU, RATU AGUNG, KOTA BENGKULU, BENGKULU",6,105,131,236
https://kawalpemilu.org#22308,"SAWAH LEBAR BARU, RATU AGUNG, KOTA BENGKULU, BENGKULU",7,52,61,113
https://kawalpemilu.org#22308,"SAWAH LEBAR BARU, RATU AGUNG, KOTA BENGKULU, BENGKULU",8,102,185,287
https://kawalpemilu.org#22308,"SAWAH LEBAR BARU, RATU AGUNG, KOTA BENGKULU, BENGKULU",9,59,127,186
https://kawalpemilu.org#22308,"SAWAH LEBAR BARU, RATU AGUNG, KOTA BENGKULU, BENGKULU",10,75,125,200
https://kawalpemilu.org#22308,"SAWAH LEBAR BARU, RATU AGUNG, KOTA BENGKULU, BENGKULU",11,79,169,248
https://kawalpemilu.org#22308,"SAWAH LEBAR BARU, RATU AGUNG, KOTA BENGKULU, BENGKULU",12,82,188,270
https://kawalpemilu.org#22308,"SAWAH LEBAR BARU, RATU AGUNG, KOTA BENGKULU, BENGKULU",13,74,117,191
https://kawalpemilu.org#22308,"SAWAH LEBAR BARU, RATU AGUNG, KOTA BENGKULU, BENGKULU",14,105,154,259
https://kawalpemilu.org#22308,"SAWAH LEBAR BARU, RATU AGUNG, KOTA BENGKULU, BENGKULU",15,69,111,180
https://kawalpemilu.org#22308,"SAWAH LEBAR BARU, RATU AGUNG, KOTA BENGKULU, BENGKULU",16,112,129,241
https://kawalpemilu.org#22308,"SAWAH LEBAR BARU, RATU AGUNG, KOTA BENGKULU, BENGKULU",17,142,132,274
https://kawalpemilu.org#22308,"SAWAH LEBAR BARU, RATU AGUNG, KOTA BENGKULU, BENGKULU",18,88,130,218
https://kawalpemilu.org#22308,"SAWAH LEBAR BARU, RATU AGUNG, KOTA BENGKULU, BENGKULU",19,75,152,227
https://kawalpemilu.org#22308,"SAWAH LEBAR BARU, RATU AGUNG, KOTA BENGKULU, BENGKULU",20,73,133,206
https://kawalpemilu.org#22308,"SAWAH LEBAR BARU, RATU AGUNG, KOTA BENGKULU, BENGKULU",21,62,139,201
https://kawalpemilu.org#22308,"SAWAH LEBAR BARU, RATU AGUNG, KOTA BENGKULU, BENGKULU",22,74,111,185
https://kawalpemilu.org#22308,"SAWAH LEBAR BARU, RATU AGUNG, KOTA BENGKULU, BENGKULU",23,48,97,145
https://kawalpemilu.org#22308,"SAWAH LEBAR BARU, RATU AGUNG, KOTA BENGKULU, BENGKULU",24,48,84,132
https://kawalpemilu.org#22309,"LEMPUING, RATU AGUNG, KOTA BENGKULU, BENGKULU",1,118,112,230
https://kawalpemilu.org#22309,"LEMPUING, RATU AGUNG, KOTA BENGKULU, BENGKULU",2,88,104,192
https://kawalpemilu.org#22309,"LEMPUING, RATU AGUNG, KOTA BENGKULU, BENGKULU",3,102,107,209
https://kawalpemilu.org#22309,"LEMPUING, RATU AGUNG, KOTA BENGKULU, BENGKULU",4,124,119,243
https://kawalpemilu.org#22309,"LEMPUING, RATU AGUNG, KOTA BENGKULU, BENGKULU",5,119,112,231
https://kawalpemilu.org#22309,"LEMPUING, RATU AGUNG, KOTA BENGKULU, BENGKULU",6,140,97,237
https://kawalpemilu.org#22309,"LEMPUING, RATU AGUNG, KOTA BENGKULU, BENGKULU",7,114,141,255
https://kawalpemilu.org#22309,"LEMPUING, RATU AGUNG, KOTA BENGKULU, BENGKULU",8,85,106,191
https://kawalpemilu.org#22309,"LEMPUING, RATU AGUNG, KOTA BENGKULU, BENGKULU",9,87,92,179
https://kawalpemilu.org#22309,"LEMPUING, RATU AGUNG, KOTA BENGKULU, BENGKULU",10,130,117,247
https://kawalpemilu.org#22309,"LEMPUING, RATU AGUNG, KOTA BENGKULU, BENGKULU",11,115,115,230
https://kawalpemilu.org#22309,"LEMPUING, RATU AGUNG, KOTA BENGKULU, BENGKULU",12,126,101,227
https://kawalpemilu.org#22309,"LEMPUING, RATU AGUNG, KOTA BENGKULU, BENGKULU",13,74,101,175
https://kawalpemilu.org#22309,"LEMPUING, RATU AGUNG, KOTA BENGKULU, BENGKULU",14,84,134,218
https://kawalpemilu.org#22311,"PENURUNAN, RATU SAMBAN, KOTA BENGKULU, BENGKULU",1,79,84,163
https://kawalpemilu.org#22311,"PENURUNAN, RATU SAMBAN, KOTA BENGKULU, BENGKULU",2,102,75,177
https://kawalpemilu.org#22311,"PENURUNAN, RATU SAMBAN, KOTA BENGKULU, BENGKULU",3,57,77,134
https://kawalpemilu.org#22311,"PENURUNAN, RATU SAMBAN, KOTA BENGKULU, BENGKULU",4,72,83,155
https://kawalpemilu.org#22311,"PENURUNAN, RATU SAMBAN, KOTA BENGKULU, BENGKULU",5,52,152,204
https://kawalpemilu.org#22311,"PENURUNAN, RATU SAMBAN, KOTA BENGKULU, BENGKULU",6,73,121,194
https://kawalpemilu.org#22311,"PENURUNAN, RATU SAMBAN, KOTA BENGKULU, BENGKULU",7,74,122,196
https://kawalpemilu.org#22311,"PENURUNAN, RATU SAMBAN, KOTA BENGKULU, BENGKULU",8,97,157,254
https://kawalpemilu.org#22311,"PENURUNAN, RATU SAMBAN, KOTA BENGKULU, BENGKULU",9,76,119,195
https://kawalpemilu.org#22311,"PENURUNAN, RATU SAMBAN, KOTA BENGKULU, BENGKULU",10,65,133,198
https://kawalpemilu.org#22311,"PENURUNAN, RATU SAMBAN, KOTA BENGKULU, BENGKULU",11,132,54,186
https://kawalpemilu.org#22311,"PENURUNAN, RATU SAMBAN, KOTA BENGKULU, BENGKULU",12,96,130,226
https://kawalpemilu.org#22311,"PENURUNAN, RATU SAMBAN, KOTA BENGKULU, BENGKULU",13,127,83,210
https://kawalpemilu.org#22311,"PENURUNAN, RATU SAMBAN, KOTA BENGKULU, BENGKULU",14,63,116,179
https://kawalpemilu.org#22311,"PENURUNAN, RATU SAMBAN, KOTA BENGKULU, BENGKULU",15,54,99,153
https://kawalpemilu.org#22311,"PENURUNAN, RATU SAMBAN, KOTA BENGKULU, BENGKULU",16,75,106,181
https://kawalpemilu.org#22312,"KEBUN DAHRI, RATU SAMBAN, KOTA BENGKULU, BENGKULU",1,41,164,205
https://kawalpemilu.org#22312,"KEBUN DAHRI, RATU SAMBAN, KOTA BENGKULU, BENGKULU",2,32,150,182
https://kawalpemilu.org#22312,"KEBUN DAHRI, RATU SAMBAN, KOTA BENGKULU, BENGKULU",3,38,134,172
https://kawalpemilu.org#22312,"KEBUN DAHRI, RATU SAMBAN, KOTA BENGKULU, BENGKULU",4,83,56,139
https://kawalpemilu.org#22312,"KEBUN DAHRI, RATU SAMBAN, KOTA BENGKULU, BENGKULU",5,53,114,167
https://kawalpemilu.org#22312,"KEBUN DAHRI, RATU SAMBAN, KOTA BENGKULU, BENGKULU",6,61,100,161
https://kawalpemilu.org#22313,"BELAKANG PONDOK, RATU SAMBAN, KOTA BENGKULU, BENGKULU",1,52,108,160
https://kawalpemilu.org#22313,"BELAKANG PONDOK, RATU SAMBAN, KOTA BENGKULU, BENGKULU",2,60,105,165
https://kawalpemilu.org#22313,"BELAKANG PONDOK, RATU SAMBAN, KOTA BENGKULU, BENGKULU",3,57,72,129
https://kawalpemilu.org#22313,"BELAKANG PONDOK, RATU SAMBAN, KOTA BENGKULU, BENGKULU",4,47,142,189
https://kawalpemilu.org#22313,"BELAKANG PONDOK, RATU SAMBAN, KOTA BENGKULU, BENGKULU",5,47,152,199
https://kawalpemilu.org#22313,"BELAKANG PONDOK, RATU SAMBAN, KOTA BENGKULU, BENGKULU",6,60,99,159
https://kawalpemilu.org#22313,"BELAKANG PONDOK, RATU SAMBAN, KOTA BENGKULU, BENGKULU",7,52,79,131
https://kawalpemilu.org#22313,"BELAKANG PONDOK, RATU SAMBAN, KOTA BENGKULU, BENGKULU",8,62,97,159
https://kawalpemilu.org#22313,"BELAKANG PONDOK, RATU SAMBAN, KOTA BENGKULU, BENGKULU",9,54,89,143
https://kawalpemilu.org#22314,"ANGGUT DALAM, RATU SAMBAN, KOTA BENGKULU, BENGKULU",1,67,109,176
https://kawalpemilu.org#22314,"ANGGUT DALAM, RATU SAMBAN, KOTA BENGKULU, BENGKULU",2,76,112,188
https://kawalpemilu.org#22314,"ANGGUT DALAM, RATU SAMBAN, KOTA BENGKULU, BENGKULU",3,78,100,178
https://kawalpemilu.org#22314,"ANGGUT DALAM, RATU SAMBAN, KOTA BENGKULU, BENGKULU",4,92,90,182
https://kawalpemilu.org#22314,"ANGGUT DALAM, RATU SAMBAN, KOTA BENGKULU, BENGKULU",5,68,119,187
https://kawalpemilu.org#22315,"KEBUN GERAN, RATU SAMBAN, KOTA BENGKULU, BENGKULU",1,103,80,183
https://kawalpemilu.org#22315,"KEBUN GERAN, RATU SAMBAN, KOTA BENGKULU, BENGKULU",2,128,93,221
https://kawalpemilu.org#22315,"KEBUN GERAN, RATU SAMBAN, KOTA BENGKULU, BENGKULU",3,95,143,238
https://kawalpemilu.org#22315,"KEBUN GERAN, RATU SAMBAN, KOTA BENGKULU, BENGKULU",4,93,117,210
https://kawalpemilu.org#22315,"KEBUN GERAN, RATU SAMBAN, KOTA BENGKULU, BENGKULU",5,107,110,217
https://kawalpemilu.org#22316,"ANGGUT ATAS, RATU SAMBAN, KOTA BENGKULU, BENGKULU",1,54,147,201
https://kawalpemilu.org#22316,"ANGGUT ATAS, RATU SAMBAN, KOTA BENGKULU, BENGKULU",2,71,144,215
https://kawalpemilu.org#22316,"ANGGUT ATAS, RATU SAMBAN, KOTA BENGKULU, BENGKULU",3,95,127,222
https://kawalpemilu.org#22316,"ANGGUT ATAS, RATU SAMBAN, KOTA BENGKULU, BENGKULU",4,111,114,225
https://kawalpemilu.org#22316,"ANGGUT ATAS, RATU SAMBAN, KOTA BENGKULU, BENGKULU",5,90,122,212
https://kawalpemilu.org#22316,"ANGGUT ATAS, RATU SAMBAN, KOTA BENGKULU, BENGKULU",6,100,139,239
https://kawalpemilu.org#22316,"ANGGUT ATAS, RATU SAMBAN, KOTA BENGKULU, BENGKULU",7,76,113,189
https://kawalpemilu.org#22317,"ANGGUT BAWAH, RATU SAMBAN, KOTA BENGKULU, BENGKULU",1,70,85,155
https://kawalpemilu.org#22317,"ANGGUT BAWAH, RATU SAMBAN, KOTA BENGKULU, BENGKULU",2,78,92,170
https://kawalpemilu.org#22317,"ANGGUT BAWAH, RATU SAMBAN, KOTA BENGKULU, BENGKULU",3,68,85,153
https://kawalpemilu.org#22318,"PADANG JATI, RATU SAMBAN, KOTA BENGKULU, BENGKULU",1,81,112,193
https://kawalpemilu.org#22318,"PADANG JATI, RATU SAMBAN, KOTA BENGKULU, BENGKULU",2,77,132,209
https://kawalpemilu.org#22318,"PADANG JATI, RATU SAMBAN, KOTA BENGKULU, BENGKULU",3,105,105,210
https://kawalpemilu.org#22318,"PADANG JATI, RATU SAMBAN, KOTA BENGKULU, BENGKULU",4,84,120,204
https://kawalpemilu.org#22318,"PADANG JATI, RATU SAMBAN, KOTA BENGKULU, BENGKULU",5,73,151,224
https://kawalpemilu.org#22318,"PADANG JATI, RATU SAMBAN, KOTA BENGKULU, BENGKULU",6,67,105,172
https://kawalpemilu.org#22318,"PADANG JATI, RATU SAMBAN, KOTA BENGKULU, BENGKULU",7,102,114,216
https://kawalpemilu.org#22318,"PADANG JATI, RATU SAMBAN, KOTA BENGKULU, BENGKULU",8,78,51,129
https://kawalpemilu.org#22318,"PADANG JATI, RATU SAMBAN, KOTA BENGKULU, BENGKULU",9,59,63,122
https://kawalpemilu.org#22318,"PADANG JATI, RATU SAMBAN, KOTA BENGKULU, BENGKULU",10,92,86,178
https://kawalpemilu.org#84788,"PENGANTUNGAN, RATU SAMBAN, KOTA BENGKULU, BENGKULU",1,69,172,241
https://kawalpemilu.org#84788,"PENGANTUNGAN, RATU SAMBAN, KOTA BENGKULU, BENGKULU",2,62,160,222
https://kawalpemilu.org#84788,"PENGANTUNGAN, RATU SAMBAN, KOTA BENGKULU, BENGKULU",3,74,147,221
https://kawalpemilu.org#84788,"PENGANTUNGAN, RATU SAMBAN, KOTA BENGKULU, BENGKULU",4,36,187,223
https://kawalpemilu.org#84788,"PENGANTUNGAN, RATU SAMBAN, KOTA BENGKULU, BENGKULU",5,30,180,210
https://kawalpemilu.org#84788,"PENGANTUNGAN, RATU SAMBAN, KOTA BENGKULU, BENGKULU",6,84,144,228
https://kawalpemilu.org#84788,"PENGANTUNGAN, RATU SAMBAN, KOTA BENGKULU, BENGKULU",7,59,144,203
https://kawalpemilu.org#84788,"PENGANTUNGAN, RATU SAMBAN, KOTA BENGKULU, BENGKULU",8,40,161,201
https://kawalpemilu.org#22321,"KAMPUNG KELAWI, SUNGAI SERUT, KOTA BENGKULU, BENGKULU",1,93,129,222
https://kawalpemilu.org#22321,"KAMPUNG KELAWI, SUNGAI SERUT, KOTA BENGKULU, BENGKULU",2,131,102,233
https://kawalpemilu.org#22321,"KAMPUNG KELAWI, SUNGAI SERUT, KOTA BENGKULU, BENGKULU",3,101,101,202
https://kawalpemilu.org#22321,"KAMPUNG KELAWI, SUNGAI SERUT, KOTA BENGKULU, BENGKULU",4,96,125,221
https://kawalpemilu.org#22321,"KAMPUNG KELAWI, SUNGAI SERUT, KOTA BENGKULU, BENGKULU",5,123,120,243
https://kawalpemilu.org#22321,"KAMPUNG KELAWI, SUNGAI SERUT, KOTA BENGKULU, BENGKULU",6,154,97,251
https://kawalpemilu.org#22322,"SEMARANG, SUNGAI SERUT, KOTA BENGKULU, BENGKULU",1,83,166,249
https://kawalpemilu.org#22322,"SEMARANG, SUNGAI SERUT, KOTA BENGKULU, BENGKULU",2,121,127,248
https://kawalpemilu.org#22322,"SEMARANG, SUNGAI SERUT, KOTA BENGKULU, BENGKULU",3,111,140,251
https://kawalpemilu.org#22322,"SEMARANG, SUNGAI SERUT, KOTA BENGKULU, BENGKULU",4,117,149,266
https://kawalpemilu.org#22322,"SEMARANG, SUNGAI SERUT, KOTA BENGKULU, BENGKULU",5,121,117,238
https://kawalpemilu.org#22323,"TANJUNG AGUNG, SUNGAI SERUT, KOTA BENGKULU, BENGKULU",1,127,124,251
https://kawalpemilu.org#22323,"TANJUNG AGUNG, SUNGAI SERUT, KOTA BENGKULU, BENGKULU",2,92,120,212
https://kawalpemilu.org#22323,"TANJUNG AGUNG, SUNGAI SERUT, KOTA BENGKULU, BENGKULU",3,94,82,176
https://kawalpemilu.org#22324,"TANJUNG JAYA, SUNGAI SERUT, KOTA BENGKULU, BENGKULU",1,76,112,188
https://kawalpemilu.org#22324,"TANJUNG JAYA, SUNGAI SERUT, KOTA BENGKULU, BENGKULU",2,79,94,173
https://kawalpemilu.org#22324,"TANJUNG JAYA, SUNGAI SERUT, KOTA BENGKULU, BENGKULU",3,111,138,249
https://kawalpemilu.org#22324,"TANJUNG JAYA, SUNGAI SERUT, KOTA BENGKULU, BENGKULU",4,106,156,262
https://kawalpemilu.org#22325,"SURABAYA, SUNGAI SERUT, KOTA BENGKULU, BENGKULU",1,135,124,259
https://kawalpemilu.org#22325,"SURABAYA, SUNGAI SERUT, KOTA BENGKULU, BENGKULU",2,99,137,236
https://kawalpemilu.org#22325,"SURABAYA, SUNGAI SERUT, KOTA BENGKULU, BENGKULU",3,123,166,289
https://kawalpemilu.org#22325,"SURABAYA, SUNGAI SERUT, KOTA BENGKULU, BENGKULU",4,172,100,272
https://kawalpemilu.org#22325,"SURABAYA, SUNGAI SERUT, KOTA BENGKULU, BENGKULU",5,69,137,206
https://kawalpemilu.org#22325,"SURABAYA, SUNGAI SERUT, KOTA BENGKULU, BENGKULU",6,62,112,174
https://kawalpemilu.org#22325,"SURABAYA, SUNGAI SERUT, KOTA BENGKULU, BENGKULU",7,84,176,260
https://kawalpemilu.org#22325,"SURABAYA, SUNGAI SERUT, KOTA BENGKULU, BENGKULU",8,67,152,219
https://kawalpemilu.org#22325,"SURABAYA, SUNGAI SERUT, KOTA BENGKULU, BENGKULU",9,90,179,269
https://kawalpemilu.org#22325,"SURABAYA, SUNGAI SERUT, KOTA BENGKULU, BENGKULU",10,78,124,202
https://kawalpemilu.org#22325,"SURABAYA, SUNGAI SERUT, KOTA BENGKULU, BENGKULU",11,99,155,254
https://kawalpemilu.org#22325,"SURABAYA, SUNGAI SERUT, KOTA BENGKULU, BENGKULU",12,75,107,182
https://kawalpemilu.org#22325,"SURABAYA, SUNGAI SERUT, KOTA BENGKULU, BENGKULU",13,98,109,207
https://kawalpemilu.org#22325,"SURABAYA, SUNGAI SERUT, KOTA BENGKULU, BENGKULU",14,113,144,257
https://kawalpemilu.org#22325,"SURABAYA, SUNGAI SERUT, KOTA BENGKULU, BENGKULU",15,44,87,131
https://kawalpemilu.org#22325,"SURABAYA, SUNGAI SERUT, KOTA BENGKULU, BENGKULU",17,88,158,246
https://kawalpemilu.org#22325,"SURABAYA, SUNGAI SERUT, KOTA BENGKULU, BENGKULU",18,63,202,265
https://kawalpemilu.org#22325,"SURABAYA, SUNGAI SERUT, KOTA BENGKULU, BENGKULU",19,91,101,192
https://kawalpemilu.org#22325,"SURABAYA, SUNGAI SERUT, KOTA BENGKULU, BENGKULU",20,113,160,273
https://kawalpemilu.org#22325,"SURABAYA, SUNGAI SERUT, KOTA BENGKULU, BENGKULU",21,61,181,242
https://kawalpemilu.org#22326,"PASAR BENGKULU, SUNGAI SERUT, KOTA BENGKULU, BENGKULU",1,104,112,216
https://kawalpemilu.org#22326,"PASAR BENGKULU, SUNGAI SERUT, KOTA BENGKULU, BENGKULU",2,120,122,242
https://kawalpemilu.org#22326,"PASAR BENGKULU, SUNGAI SERUT, KOTA BENGKULU, BENGKULU",3,68,152,220
https://kawalpemilu.org#22326,"PASAR BENGKULU, SUNGAI SERUT, KOTA BENGKULU, BENGKULU",4,90,123,213
https://kawalpemilu.org#22326,"PASAR BENGKULU, SUNGAI SERUT, KOTA BENGKULU, BENGKULU",5,106,111,217
https://kawalpemilu.org#22327,"SUKA MERINDU, SUNGAI SERUT, KOTA BENGKULU, BENGKULU",1,41,129,170
https://kawalpemilu.org#22327,"SUKA MERINDU, SUNGAI SERUT, KOTA BENGKULU, BENGKULU",2,81,93,174
https://kawalpemilu.org#22327,"SUKA MERINDU, SUNGAI SERUT, KOTA BENGKULU, BENGKULU",3,73,188,258
https://kawalpemilu.org#22327,"SUKA MERINDU, SUNGAI SERUT, KOTA BENGKULU, BENGKULU",4,56,97,153
https://kawalpemilu.org#22327,"SUKA MERINDU, SUNGAI SERUT, KOTA BENGKULU, BENGKULU",5,63,105,168
https://kawalpemilu.org#22327,"SUKA MERINDU, SUNGAI SERUT, KOTA BENGKULU, BENGKULU",6,63,84,147
https://kawalpemilu.org#22327,"SUKA MERINDU, SUNGAI SERUT, KOTA BENGKULU, BENGKULU",7,81,105,186
https://kawalpemilu.org#22327,"SUKA MERINDU, SUNGAI SERUT, KOTA BENGKULU, BENGKULU",8,109,104,213
https://kawalpemilu.org#22327,"SUKA MERINDU, SUNGAI SERUT, KOTA BENGKULU, BENGKULU",9,64,133,197
https://kawalpemilu.org#22327,"SUKA MERINDU, SUNGAI SERUT, KOTA BENGKULU, BENGKULU",10,59,85,144
https://kawalpemilu.org#22327,"SUKA MERINDU, SUNGAI SERUT, KOTA BENGKULU, BENGKULU",11,89,128,217
https://kawalpemilu.org#22327,"SUKA MERINDU, SUNGAI SERUT, KOTA BENGKULU, BENGKULU",12,75,79,154
https://kawalpemilu.org#22327,"SUKA MERINDU, SUNGAI SERUT, KOTA BENGKULU, BENGKULU",13,79,134,213
https://kawalpemilu.org#22327,"SUKA MERINDU, SUNGAI SERUT, KOTA BENGKULU, BENGKULU",14,88,105,193
https://kawalpemilu.org#22327,"SUKA MERINDU, SUNGAI SERUT, KOTA BENGKULU, BENGKULU",15,65,100,165
https://kawalpemilu.org#22327,"SUKA MERINDU, SUNGAI SERUT, KOTA BENGKULU, BENGKULU",16,84,114,198
https://kawalpemilu.org#22327,"SUKA MERINDU, SUNGAI SERUT, KOTA BENGKULU, BENGKULU",17,95,139,234
https://kawalpemilu.org#22327,"SUKA MERINDU, SUNGAI SERUT, KOTA BENGKULU, BENGKULU",18,75,117,192
https://kawalpemilu.org#22262,"PANORAMA, SINGARAN PATI, KOTA BENGKULU, BENGKULU",1,42,134,176
https://kawalpemilu.org#22262,"PANORAMA, SINGARAN PATI, KOTA BENGKULU, BENGKULU",2,53,99,152
https://kawalpemilu.org#22262,"PANORAMA, SINGARAN PATI, KOTA BENGKULU, BENGKULU",3,86,54,140
https://kawalpemilu.org#22262,"PANORAMA, SINGARAN PATI, KOTA BENGKULU, BENGKULU",4,87,163,250
https://kawalpemilu.org#22262,"PANORAMA, SINGARAN PATI, KOTA BENGKULU, BENGKULU",5,84,105,189
https://kawalpemilu.org#22262,"PANORAMA, SINGARAN PATI, KOTA BENGKULU, BENGKULU",6,67,107,174
https://kawalpemilu.org#22262,"PANORAMA, SINGARAN PATI, KOTA BENGKULU, BENGKULU",7,77,77,154
https://kawalpemilu.org#22262,"PANORAMA, SINGARAN PATI, KOTA BENGKULU, BENGKULU",8,67,59,126
https://kawalpemilu.org#22262,"PANORAMA, SINGARAN PATI, KOTA BENGKULU, BENGKULU",9,64,137,201
https://kawalpemilu.org#22262,"PANORAMA, SINGARAN PATI, KOTA BENGKULU, BENGKULU",10,109,127,236
https://kawalpemilu.org#22262,"PANORAMA, SINGARAN PATI, KOTA BENGKULU, BENGKULU",11,72,120,192
https://kawalpemilu.org#22262,"PANORAMA, SINGARAN PATI, KOTA BENGKULU, BENGKULU",12,59,112,171
https://kawalpemilu.org#22262,"PANORAMA, SINGARAN PATI, KOTA BENGKULU, BENGKULU",13,65,78,143
https://kawalpemilu.org#22262,"PANORAMA, SINGARAN PATI, KOTA BENGKULU, BENGKULU",14,48,83,131
https://kawalpemilu.org#22262,"PANORAMA, SINGARAN PATI, KOTA BENGKULU, BENGKULU",15,43,66,109
https://kawalpemilu.org#22262,"PANORAMA, SINGARAN PATI, KOTA BENGKULU, BENGKULU",16,114,103,217
https://kawalpemilu.org#22262,"PANORAMA, SINGARAN PATI, KOTA BENGKULU, BENGKULU",17,75,84,159
https://kawalpemilu.org#22262,"PANORAMA, SINGARAN PATI, KOTA BENGKULU, BENGKULU",18,85,103,188
https://kawalpemilu.org#22262,"PANORAMA, SINGARAN PATI, KOTA BENGKULU, BENGKULU",19,47,97,144
https://kawalpemilu.org#22262,"PANORAMA, SINGARAN PATI, KOTA BENGKULU, BENGKULU",20,74,66,140
https://kawalpemilu.org#22262,"PANORAMA, SINGARAN PATI, KOTA BENGKULU, BENGKULU",21,64,75,139
https://kawalpemilu.org#22262,"PANORAMA, SINGARAN PATI, KOTA BENGKULU, BENGKULU",22,66,86,152
https://kawalpemilu.org#22262,"PANORAMA, SINGARAN PATI, KOTA BENGKULU, BENGKULU",23,69,89,158
https://kawalpemilu.org#22262,"PANORAMA, SINGARAN PATI, KOTA BENGKULU, BENGKULU",24,60,40,100
https://kawalpemilu.org#22262,"PANORAMA, SINGARAN PATI, KOTA BENGKULU, BENGKULU",25,86,76,162
https://kawalpemilu.org#22262,"PANORAMA, SINGARAN PATI, KOTA BENGKULU, BENGKULU",26,67,71,138
https://kawalpemilu.org#22262,"PANORAMA, SINGARAN PATI, KOTA BENGKULU, BENGKULU",27,76,74,150
https://kawalpemilu.org#22262,"PANORAMA, SINGARAN PATI, KOTA BENGKULU, BENGKULU",28,117,76,193
https://kawalpemilu.org#22262,"PANORAMA, SINGARAN PATI, KOTA BENGKULU, BENGKULU",29,78,78,156
https://kawalpemilu.org#22262,"PANORAMA, SINGARAN PATI, KOTA BENGKULU, BENGKULU",30,78,76,154
https://kawalpemilu.org#22262,"PANORAMA, SINGARAN PATI, KOTA BENGKULU, BENGKULU",31,67,51,118
https://kawalpemilu.org#22262,"PANORAMA, SINGARAN PATI, KOTA BENGKULU, BENGKULU",32,85,84,169
https://kawalpemilu.org#22262,"PANORAMA, SINGARAN PATI, KOTA BENGKULU, BENGKULU",33,85,158,243
https://kawalpemilu.org#22262,"PANORAMA, SINGARAN PATI, KOTA BENGKULU, BENGKULU",34,62,98,160
https://kawalpemilu.org#22262,"PANORAMA, SINGARAN PATI, KOTA BENGKULU, BENGKULU",35,50,85,135
https://kawalpemilu.org#22262,"PANORAMA, SINGARAN PATI, KOTA BENGKULU, BENGKULU",36,40,58,98
https://kawalpemilu.org#22262,"PANORAMA, SINGARAN PATI, KOTA BENGKULU, BENGKULU",37,87,119,206
https://kawalpemilu.org#22262,"PANORAMA, SINGARAN PATI, KOTA BENGKULU, BENGKULU",38,80,92,172
https://kawalpemilu.org#22262,"PANORAMA, SINGARAN PATI, KOTA BENGKULU, BENGKULU",39,69,73,142
https://kawalpemilu.org#22262,"PANORAMA, SINGARAN PATI, KOTA BENGKULU, BENGKULU",40,126,116,242
https://kawalpemilu.org#22262,"PANORAMA, SINGARAN PATI, KOTA BENGKULU, BENGKULU",41,96,94,190
https://kawalpemilu.org#22262,"PANORAMA, SINGARAN PATI, KOTA BENGKULU, BENGKULU",42,92,146,238
https://kawalpemilu.org#22262,"PANORAMA, SINGARAN PATI, KOTA BENGKULU, BENGKULU",43,73,67,140
https://kawalpemilu.org#22262,"PANORAMA, SINGARAN PATI, KOTA BENGKULU, BENGKULU",44,65,82,147
https://kawalpemilu.org#22262,"PANORAMA, SINGARAN PATI, KOTA BENGKULU, BENGKULU",45,85,95,180
https://kawalpemilu.org#22262,"PANORAMA, SINGARAN PATI, KOTA BENGKULU, BENGKULU",46,58,68,126
https://kawalpemilu.org#22262,"PANORAMA, SINGARAN PATI, KOTA BENGKULU, BENGKULU",47,72,102,174
https://kawalpemilu.org#22262,"PANORAMA, SINGARAN PATI, KOTA BENGKULU, BENGKULU",48,59,66,125
https://kawalpemilu.org#22263,"JEMBATAN KECIL, SINGARAN PATI, KOTA BENGKULU, BENGKULU",1,111,189,296
https://kawalpemilu.org#22263,"JEMBATAN KECIL, SINGARAN PATI, KOTA BENGKULU, BENGKULU",2,103,124,227
https://kawalpemilu.org#22263,"JEMBATAN KECIL, SINGARAN PATI, KOTA BENGKULU, BENGKULU",3,118,109,227
https://kawalpemilu.org#22263,"JEMBATAN KECIL, SINGARAN PATI, KOTA BENGKULU, BENGKULU",4,67,91,158
https://kawalpemilu.org#22263,"JEMBATAN KECIL, SINGARAN PATI, KOTA BENGKULU, BENGKULU",5,70,105,175
https://kawalpemilu.org#22263,"JEMBATAN KECIL, SINGARAN PATI, KOTA BENGKULU, BENGKULU",6,77,90,167
https://kawalpemilu.org#22263,"JEMBATAN KECIL, SINGARAN PATI, KOTA BENGKULU, BENGKULU",7,72,99,171
https://kawalpemilu.org#22263,"JEMBATAN KECIL, SINGARAN PATI, KOTA BENGKULU, BENGKULU",8,83,88,171
https://kawalpemilu.org#22263,"JEMBATAN KECIL, SINGARAN PATI, KOTA BENGKULU, BENGKULU",9,56,52,108
https://kawalpemilu.org#22263,"JEMBATAN KECIL, SINGARAN PATI, KOTA BENGKULU, BENGKULU",10,69,147,216
https://kawalpemilu.org#22266,"DUSUN BESAR, SINGARAN PATI, KOTA BENGKULU, BENGKULU",1,101,98,199
https://kawalpemilu.org#22266,"DUSUN BESAR, SINGARAN PATI, KOTA BENGKULU, BENGKULU",2,96,74,170
https://kawalpemilu.org#22266,"DUSUN BESAR, SINGARAN PATI, KOTA BENGKULU, BENGKULU",3,55,79,134
https://kawalpemilu.org#22266,"DUSUN BESAR, SINGARAN PATI, KOTA BENGKULU, BENGKULU",4,87,163,250
https://kawalpemilu.org#22266,"DUSUN BESAR, SINGARAN PATI, KOTA BENGKULU, BENGKULU",5,87,143,230
https://kawalpemilu.org#22266,"DUSUN BESAR, SINGARAN PATI, KOTA BENGKULU, BENGKULU",6,68,77,145
https://kawalpemilu.org#22266,"DUSUN BESAR, SINGARAN PATI, KOTA BENGKULU, BENGKULU",7,89,70,159
https://kawalpemilu.org#22266,"DUSUN BESAR, SINGARAN PATI, KOTA BENGKULU, BENGKULU",8,70,126,196
https://kawalpemilu.org#22266,"DUSUN BESAR, SINGARAN PATI, KOTA BENGKULU, BENGKULU",9,41,89,130
https://kawalpemilu.org#22266,"DUSUN BESAR, SINGARAN PATI, KOTA BENGKULU, BENGKULU",10,69,117,186
https://kawalpemilu.org#22266,"DUSUN BESAR, SINGARAN PATI, KOTA BENGKULU, BENGKULU",11,118,132,250
https://kawalpemilu.org#22266,"DUSUN BESAR, SINGARAN PATI, KOTA BENGKULU, BENGKULU",12,65,94,159
https://kawalpemilu.org#22266,"DUSUN BESAR, SINGARAN PATI, KOTA BENGKULU, BENGKULU",13,67,69,136
https://kawalpemilu.org#22266,"DUSUN BESAR, SINGARAN PATI, KOTA BENGKULU, BENGKULU",14,86,101,187
https://kawalpemilu.org#22266,"DUSUN BESAR, SINGARAN PATI, KOTA BENGKULU, BENGKULU",15,68,86,154
https://kawalpemilu.org#22266,"DUSUN BESAR, SINGARAN PATI, KOTA BENGKULU, BENGKULU",16,63,130,193
https://kawalpemilu.org#22266,"DUSUN BESAR, SINGARAN PATI, KOTA BENGKULU, BENGKULU",17,99,165,264
https://kawalpemilu.org#22266,"DUSUN BESAR, SINGARAN PATI, KOTA BENGKULU, BENGKULU",18,105,136,241
https://kawalpemilu.org#22266,"DUSUN BESAR, SINGARAN PATI, KOTA BENGKULU, BENGKULU",19,43,63,106
https://kawalpemilu.org#22266,"DUSUN BESAR, SINGARAN PATI, KOTA BENGKULU, BENGKULU",20,84,75,159
https://kawalpemilu.org#22266,"DUSUN BESAR, SINGARAN PATI, KOTA BENGKULU, BENGKULU",21,83,115,198
https://kawalpemilu.org#22266,"DUSUN BESAR, SINGARAN PATI, KOTA BENGKULU, BENGKULU",22,80,84,164
https://kawalpemilu.org#22266,"DUSUN BESAR, SINGARAN PATI, KOTA BENGKULU, BENGKULU",23,65,80,145
https://kawalpemilu.org#22267,"PADANG NANGKA, SINGARAN PATI, KOTA BENGKULU, BENGKULU",1,81,132,213
https://kawalpemilu.org#22267,"PADANG NANGKA, SINGARAN PATI, KOTA BENGKULU, BENGKULU",2,75,125,200
https://kawalpemilu.org#22267,"PADANG NANGKA, SINGARAN PATI, KOTA BENGKULU, BENGKULU",3,51,235,286
https://kawalpemilu.org#22267,"PADANG NANGKA, SINGARAN PATI, KOTA BENGKULU, BENGKULU",4,100,173,273
https://kawalpemilu.org#22267,"PADANG NANGKA, SINGARAN PATI, KOTA BENGKULU, BENGKULU",5,98,114,212
https://kawalpemilu.org#22267,"PADANG NANGKA, SINGARAN PATI, KOTA BENGKULU, BENGKULU",6,96,144,240
https://kawalpemilu.org#22267,"PADANG NANGKA, SINGARAN PATI, KOTA BENGKULU, BENGKULU",7,95,88,183
https://kawalpemilu.org#22267,"PADANG NANGKA, SINGARAN PATI, KOTA BENGKULU, BENGKULU",8,62,50,112
https://kawalpemilu.org#22267,"PADANG NANGKA, SINGARAN PATI, KOTA BENGKULU, BENGKULU",9,52,67,119
https://kawalpemilu.org#22267,"PADANG NANGKA, SINGARAN PATI, KOTA BENGKULU, BENGKULU",10,73,45,118
https://kawalpemilu.org#22267,"PADANG NANGKA, SINGARAN PATI, KOTA BENGKULU, BENGKULU",11,51,92,143
https://kawalpemilu.org#22267,"PADANG NANGKA, SINGARAN PATI, KOTA BENGKULU, BENGKULU",12,42,60,102
https://kawalpemilu.org#22267,"PADANG NANGKA, SINGARAN PATI, KOTA BENGKULU, BENGKULU",13,93,104,197
https://kawalpemilu.org#22267,"PADANG NANGKA, SINGARAN PATI, KOTA BENGKULU, BENGKULU",14,27,145,172
https://kawalpemilu.org#22267,"PADANG NANGKA, SINGARAN PATI, KOTA BENGKULU, BENGKULU",15,82,74,156
https://kawalpemilu.org#22267,"PADANG NANGKA, SINGARAN PATI, KOTA BENGKULU, BENGKULU",16,59,78,137
https://kawalpemilu.org#22267,"PADANG NANGKA, SINGARAN PATI, KOTA BENGKULU, BENGKULU",17,129,67,196
https://kawalpemilu.org#22267,"PADANG NANGKA, SINGARAN PATI, KOTA BENGKULU, BENGKULU",18,118,90,208
https://kawalpemilu.org#22267,"PADANG NANGKA, SINGARAN PATI, KOTA BENGKULU, BENGKULU",19,51,91,142
https://kawalpemilu.org#22267,"PADANG NANGKA, SINGARAN PATI, KOTA BENGKULU, BENGKULU",20,73,92,165
https://kawalpemilu.org#22267,"PADANG NANGKA, SINGARAN PATI, KOTA BENGKULU, BENGKULU",21,74,152,226
https://kawalpemilu.org#22267,"PADANG NANGKA, SINGARAN PATI, KOTA BENGKULU, BENGKULU",22,58,145,203
https://kawalpemilu.org#22268,"TIMUR INDAH, SINGARAN PATI, KOTA BENGKULU, BENGKULU",1,68,92,160
https://kawalpemilu.org#22268,"TIMUR INDAH, SINGARAN PATI, KOTA BENGKULU, BENGKULU",2,53,92,145
https://kawalpemilu.org#22268,"TIMUR INDAH, SINGARAN PATI, KOTA BENGKULU, BENGKULU",3,66,63,129
https://kawalpemilu.org#22268,"TIMUR INDAH, SINGARAN PATI, KOTA BENGKULU, BENGKULU",4,52,72,124
https://kawalpemilu.org#22268,"TIMUR INDAH, SINGARAN PATI, KOTA BENGKULU, BENGKULU",5,60,90,150
https://kawalpemilu.org#22268,"TIMUR INDAH, SINGARAN PATI, KOTA BENGKULU, BENGKULU",6,76,105,181
https://kawalpemilu.org#22268,"TIMUR INDAH, SINGARAN PATI, KOTA BENGKULU, BENGKULU",7,77,148,225
https://kawalpemilu.org#22268,"TIMUR INDAH, SINGARAN PATI, KOTA BENGKULU, BENGKULU",8,76,148,224
https://kawalpemilu.org#22268,"TIMUR INDAH, SINGARAN PATI, KOTA BENGKULU, BENGKULU",9,42,128,170
https://kawalpemilu.org#22268,"TIMUR INDAH, SINGARAN PATI, KOTA BENGKULU, BENGKULU",10,81,145,226
https://kawalpemilu.org#22268,"TIMUR INDAH, SINGARAN PATI, KOTA BENGKULU, BENGKULU",11,91,118,209
https://kawalpemilu.org#22268,"TIMUR INDAH, SINGARAN PATI, KOTA BENGKULU, BENGKULU",12,72,107,179
https://kawalpemilu.org#22268,"TIMUR INDAH, SINGARAN PATI, KOTA BENGKULU, BENGKULU",13,40,108,148
https://kawalpemilu.org#22271,"LINGKAR TIMUR, SINGARAN PATI, KOTA BENGKULU, BENGKULU",1,104,140,244
https://kawalpemilu.org#22271,"LINGKAR TIMUR, SINGARAN PATI, KOTA BENGKULU, BENGKULU",2,60,192,252
https://kawalpemilu.org#22271,"LINGKAR TIMUR, SINGARAN PATI, KOTA BENGKULU, BENGKULU",3,71,187,258
https://kawalpemilu.org#22271,"LINGKAR TIMUR, SINGARAN PATI, KOTA BENGKULU, BENGKULU",4,61,107,168
https://kawalpemilu.org#22271,"LINGKAR TIMUR, SINGARAN PATI, KOTA BENGKULU, BENGKULU",5,84,162,246
https://kawalpemilu.org#22271,"LINGKAR TIMUR, SINGARAN PATI, KOTA BENGKULU, BENGKULU",6,115,128,243
https://kawalpemilu.org#22271,"LINGKAR TIMUR, SINGARAN PATI, KOTA BENGKULU, BENGKULU",7,108,153,261
https://kawalpemilu.org#22271,"LINGKAR TIMUR, SINGARAN PATI, KOTA BENGKULU, BENGKULU",8,72,76,148
https://kawalpemilu.org#22271,"LINGKAR TIMUR, SINGARAN PATI, KOTA BENGKULU, BENGKULU",9,41,121,162
https://kawalpemilu.org#22271,"LINGKAR TIMUR, SINGARAN PATI, KOTA BENGKULU, BENGKULU",10,55,171,226
https://kawalpemilu.org#22271,"LINGKAR TIMUR, SINGARAN PATI, KOTA BENGKULU, BENGKULU",11,86,125,211
https://kawalpemilu.org#22271,"LINGKAR TIMUR, SINGARAN PATI, KOTA BENGKULU, BENGKULU",12,41,83,124
https://kawalpemilu.org#22271,"LINGKAR TIMUR, SINGARAN PATI, KOTA BENGKULU, BENGKULU",13,33,77,110
https://kawalpemilu.org#22271,"LINGKAR TIMUR, SINGARAN PATI, KOTA BENGKULU, BENGKULU",14,160,24,184
