Link KawalPemilu,Nama Kelurahan,Nomor TPS,Suara 01,Suara 02,Suara Sah
https://kawalpemilu.org#41866,"JANGKARAN, TEMON, KULON PROGO, DAERAH ISTIMEWA YOGYAKARTA",1,166,87,253
https://kawalpemilu.org#41866,"JANGKARAN, TEMON, KULON PROGO, DAERAH ISTIMEWA YOGYAKARTA",2,174,61,235
https://kawalpemilu.org#41866,"JANGKARAN, TEMON, KULON PROGO, DAERAH ISTIMEWA YOGYAKARTA",3,207,52,259
https://kawalpemilu.org#41866,"JANGKARAN, TEMON, KULON PROGO, DAERAH ISTIMEWA YOGYAKARTA",4,164,86,250
https://kawalpemilu.org#41867,"SINDUTAN, TEMON, KULON PROGO, DAERAH ISTIMEWA YOGYAKARTA",1,199,27,226
https://kawalpemilu.org#41867,"SINDUTAN, TEMON, KULON PROGO, DAERAH ISTIMEWA YOGYAKARTA",2,167,59,226
https://kawalpemilu.org#41867,"SINDUTAN, TEMON, KULON PROGO, DAERAH ISTIMEWA YOGYAKARTA",3,215,35,250
https://kawalpemilu.org#41867,"SINDUTAN, TEMON, KULON PROGO, DAERAH ISTIMEWA YOGYAKARTA",4,130,68,198
https://kawalpemilu.org#41867,"SINDUTAN, TEMON, KULON PROGO, DAERAH ISTIMEWA YOGYAKARTA",5,152,94,246
https://kawalpemilu.org#41867,"SINDUTAN, TEMON, KULON PROGO, DAERAH ISTIMEWA YOGYAKARTA",6,149,68,217
https://kawalpemilu.org#41868,"PALIHAN, TEMON, KULON PROGO, DAERAH ISTIMEWA YOGYAKARTA",1,201,35,236
https://kawalpemilu.org#41868,"PALIHAN, TEMON, KULON PROGO, DAERAH ISTIMEWA YOGYAKARTA",2,160,66,226
https://kawalpemilu.org#41868,"PALIHAN, TEMON, KULON PROGO, DAERAH ISTIMEWA YOGYAKARTA",3,137,61,198
https://kawalpemilu.org#41868,"PALIHAN, TEMON, KULON PROGO, DAERAH ISTIMEWA YOGYAKARTA",4,118,53,171
https://kawalpemilu.org#41868,"PALIHAN, TEMON, KULON PROGO, DAERAH ISTIMEWA YOGYAKARTA",5,132,61,193
https://kawalpemilu.org#41868,"PALIHAN, TEMON, KULON PROGO, DAERAH ISTIMEWA YOGYAKARTA",6,159,67,226
https://kawalpemilu.org#41868,"PALIHAN, TEMON, KULON PROGO, DAERAH ISTIMEWA YOGYAKARTA",7,150,63,213
https://kawalpemilu.org#41869,"GLAGAH, TEMON, KULON PROGO, DAERAH ISTIMEWA YOGYAKARTA",1,100,103,203
https://kawalpemilu.org#41869,"GLAGAH, TEMON, KULON PROGO, DAERAH ISTIMEWA YOGYAKARTA",2,131,103,234
https://kawalpemilu.org#41869,"GLAGAH, TEMON, KULON PROGO, DAERAH ISTIMEWA YOGYAKARTA",3,144,70,214
https://kawalpemilu.org#41869,"GLAGAH, TEMON, KULON PROGO, DAERAH ISTIMEWA YOGYAKARTA",4,137,72,209
https://kawalpemilu.org#41869,"GLAGAH, TEMON, KULON PROGO, DAERAH ISTIMEWA YOGYAKARTA",5,174,69,243
https://kawalpemilu.org#41869,"GLAGAH, TEMON, KULON PROGO, DAERAH ISTIMEWA YOGYAKARTA",6,160,88,248
https://kawalpemilu.org#41869,"GLAGAH, TEMON, KULON PROGO, DAERAH ISTIMEWA YOGYAKARTA",7,145,78,223
https://kawalpemilu.org#41869,"GLAGAH, TEMON, KULON PROGO, DAERAH ISTIMEWA YOGYAKARTA",8,168,80,248
https://kawalpemilu.org#41870,"KALIDENGEN, TEMON, KULON PROGO, DAERAH ISTIMEWA YOGYAKARTA",1,167,67,234
https://kawalpemilu.org#41870,"KALIDENGEN, TEMON, KULON PROGO, DAERAH ISTIMEWA YOGYAKARTA",2,157,63,220
https://kawalpemilu.org#41870,"KALIDENGEN, TEMON, KULON PROGO, DAERAH ISTIMEWA YOGYAKARTA",3,93,83,176
https://kawalpemilu.org#41870,"KALIDENGEN, TEMON, KULON PROGO, DAERAH ISTIMEWA YOGYAKARTA",4,171,77,248
https://kawalpemilu.org#41871,"PLUMBON, TEMON, KULON PROGO, DAERAH ISTIMEWA YOGYAKARTA",1,142,99,241
https://kawalpemilu.org#41871,"PLUMBON, TEMON, KULON PROGO, DAERAH ISTIMEWA YOGYAKARTA",2,117,85,202
https://kawalpemilu.org#41871,"PLUMBON, TEMON, KULON PROGO, DAERAH ISTIMEWA YOGYAKARTA",3,118,95,213
https://kawalpemilu.org#41871,"PLUMBON, TEMON, KULON PROGO, DAERAH ISTIMEWA YOGYAKARTA",4,116,93,209
https://kawalpemilu.org#41871,"PLUMBON, TEMON, KULON PROGO, DAERAH ISTIMEWA YOGYAKARTA",5,112,84,196
https://kawalpemilu.org#41871,"PLUMBON, TEMON, KULON PROGO, DAERAH ISTIMEWA YOGYAKARTA",6,112,76,188
https://kawalpemilu.org#41871,"PLUMBON, TEMON, KULON PROGO, DAERAH ISTIMEWA YOGYAKARTA",7,143,106,249
https://kawalpemilu.org#41872,"KEDUNDANG, TEMON, KULON PROGO, DAERAH ISTIMEWA YOGYAKARTA",1,77,161,238
https://kawalpemilu.org#41872,"KEDUNDANG, TEMON, KULON PROGO, DAERAH ISTIMEWA YOGYAKARTA",2,123,114,237
https://kawalpemilu.org#41872,"KEDUNDANG, TEMON, KULON PROGO, DAERAH ISTIMEWA YOGYAKARTA",3,71,151,222
https://kawalpemilu.org#41872,"KEDUNDANG, TEMON, KULON PROGO, DAERAH ISTIMEWA YOGYAKARTA",4,104,89,193
https://kawalpemilu.org#41872,"KEDUNDANG, TEMON, KULON PROGO, DAERAH ISTIMEWA YOGYAKARTA",5,66,77,143
https://kawalpemilu.org#41872,"KEDUNDANG, TEMON, KULON PROGO, DAERAH ISTIMEWA YOGYAKARTA",6,147,89,236
https://kawalpemilu.org#41872,"KEDUNDANG, TEMON, KULON PROGO, DAERAH ISTIMEWA YOGYAKARTA",7,111,135,246
https://kawalpemilu.org#41873,"DEMEN, TEMON, KULON PROGO, DAERAH ISTIMEWA YOGYAKARTA",1,140,67,207
https://kawalpemilu.org#41873,"DEMEN, TEMON, KULON PROGO, DAERAH ISTIMEWA YOGYAKARTA",2,169,64,233
https://kawalpemilu.org#41873,"DEMEN, TEMON, KULON PROGO, DAERAH ISTIMEWA YOGYAKARTA",3,117,121,238
https://kawalpemilu.org#41873,"DEMEN, TEMON, KULON PROGO, DAERAH ISTIMEWA YOGYAKARTA",4,136,80,216
https://kawalpemilu.org#41874,"KULUR, TEMON, KULON PROGO, DAERAH ISTIMEWA YOGYAKARTA",1,230,43,273
https://kawalpemilu.org#41874,"KULUR, TEMON, KULON PROGO, DAERAH ISTIMEWA YOGYAKARTA",2,197,43,240
https://kawalpemilu.org#41874,"KULUR, TEMON, KULON PROGO, DAERAH ISTIMEWA YOGYAKARTA",3,171,91,262
https://kawalpemilu.org#41874,"KULUR, TEMON, KULON PROGO, DAERAH ISTIMEWA YOGYAKARTA",4,133,75,208
https://kawalpemilu.org#41874,"KULUR, TEMON, KULON PROGO, DAERAH ISTIMEWA YOGYAKARTA",5,148,41,189
https://kawalpemilu.org#41874,"KULUR, TEMON, KULON PROGO, DAERAH ISTIMEWA YOGYAKARTA",6,132,87,219
https://kawalpemilu.org#41874,"KULUR, TEMON, KULON PROGO, DAERAH ISTIMEWA YOGYAKARTA",7,168,37,205
https://kawalpemilu.org#41874,"KULUR, TEMON, KULON PROGO, DAERAH ISTIMEWA YOGYAKARTA",8,173,41,214
https://kawalpemilu.org#41875,"KALIGINTUNG, TEMON, KULON PROGO, DAERAH ISTIMEWA YOGYAKARTA",2,156,83,239
https://kawalpemilu.org#41875,"KALIGINTUNG, TEMON, KULON PROGO, DAERAH ISTIMEWA YOGYAKARTA",4,136,84,220
https://kawalpemilu.org#41875,"KALIGINTUNG, TEMON, KULON PROGO, DAERAH ISTIMEWA YOGYAKARTA",5,128,58,186
https://kawalpemilu.org#41876,"TEMON WETAN, TEMON, KULON PROGO, DAERAH ISTIMEWA YOGYAKARTA",1,151,69,220
https://kawalpemilu.org#41876,"TEMON WETAN, TEMON, KULON PROGO, DAERAH ISTIMEWA YOGYAKARTA",2,143,42,185
https://kawalpemilu.org#41876,"TEMON WETAN, TEMON, KULON PROGO, DAERAH ISTIMEWA YOGYAKARTA",3,146,77,223
https://kawalpemilu.org#41876,"TEMON WETAN, TEMON, KULON PROGO, DAERAH ISTIMEWA YOGYAKARTA",4,127,52,179
https://kawalpemilu.org#41876,"TEMON WETAN, TEMON, KULON PROGO, DAERAH ISTIMEWA YOGYAKARTA",5,108,97,205
https://kawalpemilu.org#41877,"TEMON KULON, TEMON, KULON PROGO, DAERAH ISTIMEWA YOGYAKARTA",1,152,28,180
https://kawalpemilu.org#41877,"TEMON KULON, TEMON, KULON PROGO, DAERAH ISTIMEWA YOGYAKARTA",2,118,99,217
https://kawalpemilu.org#41877,"TEMON KULON, TEMON, KULON PROGO, DAERAH ISTIMEWA YOGYAKARTA",3,165,78,243
https://kawalpemilu.org#41877,"TEMON KULON, TEMON, KULON PROGO, DAERAH ISTIMEWA YOGYAKARTA",4,186,64,250
https://kawalpemilu.org#41877,"TEMON KULON, TEMON, KULON PROGO, DAERAH ISTIMEWA YOGYAKARTA",5,179,73,252
https://kawalpemilu.org#41878,"KEBON REJO, TEMON, KULON PROGO, DAERAH ISTIMEWA YOGYAKARTA",1,176,58,234
https://kawalpemilu.org#41878,"KEBON REJO, TEMON, KULON PROGO, DAERAH ISTIMEWA YOGYAKARTA",2,149,88,237
https://kawalpemilu.org#41878,"KEBON REJO, TEMON, KULON PROGO, DAERAH ISTIMEWA YOGYAKARTA",3,184,63,247
https://kawalpemilu.org#41878,"KEBON REJO, TEMON, KULON PROGO, DAERAH ISTIMEWA YOGYAKARTA",4,213,38,251
https://kawalpemilu.org#41879,"JANTEN, TEMON, KULON PROGO, DAERAH ISTIMEWA YOGYAKARTA",1,117,77,194
https://kawalpemilu.org#41879,"JANTEN, TEMON, KULON PROGO, DAERAH ISTIMEWA YOGYAKARTA",2,125,79,204
https://kawalpemilu.org#41879,"JANTEN, TEMON, KULON PROGO, DAERAH ISTIMEWA YOGYAKARTA",3,144,47,191
https://kawalpemilu.org#41879,"JANTEN, TEMON, KULON PROGO, DAERAH ISTIMEWA YOGYAKARTA",4,201,18,219
https://kawalpemilu.org#41880,"KARANGWULUH, TEMON, KULON PROGO, DAERAH ISTIMEWA YOGYAKARTA",1,128,104,232
https://kawalpemilu.org#41880,"KARANGWULUH, TEMON, KULON PROGO, DAERAH ISTIMEWA YOGYAKARTA",2,129,83,212
https://kawalpemilu.org#41880,"KARANGWULUH, TEMON, KULON PROGO, DAERAH ISTIMEWA YOGYAKARTA",3,160,78,238
https://kawalpemilu.org#41882,"KARANGWUNI, WATES, KULON PROGO, DAERAH ISTIMEWA YOGYAKARTA",1,190,75,265
https://kawalpemilu.org#41882,"KARANGWUNI, WATES, KULON PROGO, DAERAH ISTIMEWA YOGYAKARTA",2,0,0,0
https://kawalpemilu.org#41882,"KARANGWUNI, WATES, KULON PROGO, DAERAH ISTIMEWA YOGYAKARTA",3,173,84,257
https://kawalpemilu.org#41882,"KARANGWUNI, WATES, KULON PROGO, DAERAH ISTIMEWA YOGYAKARTA",4,189,72,261
https://kawalpemilu.org#41882,"KARANGWUNI, WATES, KULON PROGO, DAERAH ISTIMEWA YOGYAKARTA",5,189,65,254
https://kawalpemilu.org#41882,"KARANGWUNI, WATES, KULON PROGO, DAERAH ISTIMEWA YOGYAKARTA",6,198,54,252
https://kawalpemilu.org#41882,"KARANGWUNI, WATES, KULON PROGO, DAERAH ISTIMEWA YOGYAKARTA",7,187,54,241
https://kawalpemilu.org#41882,"KARANGWUNI, WATES, KULON PROGO, DAERAH ISTIMEWA YOGYAKARTA",8,158,83,241
https://kawalpemilu.org#41882,"KARANGWUNI, WATES, KULON PROGO, DAERAH ISTIMEWA YOGYAKARTA",9,157,60,217
https://kawalpemilu.org#41883,"SOGAN, WATES, KULON PROGO, DAERAH ISTIMEWA YOGYAKARTA",1,170,58,228
https://kawalpemilu.org#41883,"SOGAN, WATES, KULON PROGO, DAERAH ISTIMEWA YOGYAKARTA",2,136,63,199
https://kawalpemilu.org#41883,"SOGAN, WATES, KULON PROGO, DAERAH ISTIMEWA YOGYAKARTA",3,140,68,208
https://kawalpemilu.org#41883,"SOGAN, WATES, KULON PROGO, DAERAH ISTIMEWA YOGYAKARTA",4,155,66,221
https://kawalpemilu.org#41883,"SOGAN, WATES, KULON PROGO, DAERAH ISTIMEWA YOGYAKARTA",5,139,75,214
https://kawalpemilu.org#41883,"SOGAN, WATES, KULON PROGO, DAERAH ISTIMEWA YOGYAKARTA",6,173,53,226
https://kawalpemilu.org#41884,"KULWARU, WATES, KULON PROGO, DAERAH ISTIMEWA YOGYAKARTA",1,181,63,244
https://kawalpemilu.org#41884,"KULWARU, WATES, KULON PROGO, DAERAH ISTIMEWA YOGYAKARTA",2,130,94,224
https://kawalpemilu.org#41884,"KULWARU, WATES, KULON PROGO, DAERAH ISTIMEWA YOGYAKARTA",3,167,72,239
https://kawalpemilu.org#41884,"KULWARU, WATES, KULON PROGO, DAERAH ISTIMEWA YOGYAKARTA",4,162,84,246
https://kawalpemilu.org#41884,"KULWARU, WATES, KULON PROGO, DAERAH ISTIMEWA YOGYAKARTA",5,116,116,232
https://kawalpemilu.org#41884,"KULWARU, WATES, KULON PROGO, DAERAH ISTIMEWA YOGYAKARTA",6,134,88,222
https://kawalpemilu.org#41884,"KULWARU, WATES, KULON PROGO, DAERAH ISTIMEWA YOGYAKARTA",7,126,103,229
https://kawalpemilu.org#41884,"KULWARU, WATES, KULON PROGO, DAERAH ISTIMEWA YOGYAKARTA",8,168,62,230
https://kawalpemilu.org#41885,"NGESTIHARJO, WATES, KULON PROGO, DAERAH ISTIMEWA YOGYAKARTA",1,175,79,254
https://kawalpemilu.org#41885,"NGESTIHARJO, WATES, KULON PROGO, DAERAH ISTIMEWA YOGYAKARTA",2,186,69,255
https://kawalpemilu.org#41885,"NGESTIHARJO, WATES, KULON PROGO, DAERAH ISTIMEWA YOGYAKARTA",3,196,39,235
https://kawalpemilu.org#41885,"NGESTIHARJO, WATES, KULON PROGO, DAERAH ISTIMEWA YOGYAKARTA",4,222,37,259
https://kawalpemilu.org#41885,"NGESTIHARJO, WATES, KULON PROGO, DAERAH ISTIMEWA YOGYAKARTA",5,141,86,227
https://kawalpemilu.org#41885,"NGESTIHARJO, WATES, KULON PROGO, DAERAH ISTIMEWA YOGYAKARTA",6,141,99,240
https://kawalpemilu.org#41885,"NGESTIHARJO, WATES, KULON PROGO, DAERAH ISTIMEWA YOGYAKARTA",7,159,93,252
https://kawalpemilu.org#41885,"NGESTIHARJO, WATES, KULON PROGO, DAERAH ISTIMEWA YOGYAKARTA",8,103,148,251
https://kawalpemilu.org#41885,"NGESTIHARJO, WATES, KULON PROGO, DAERAH ISTIMEWA YOGYAKARTA",9,93,143,236
https://kawalpemilu.org#41886,"BENDUNGAN, WATES, KULON PROGO, DAERAH ISTIMEWA YOGYAKARTA",1,200,54,254
https://kawalpemilu.org#41886,"BENDUNGAN, WATES, KULON PROGO, DAERAH ISTIMEWA YOGYAKARTA",2,162,66,228
https://kawalpemilu.org#41886,"BENDUNGAN, WATES, KULON PROGO, DAERAH ISTIMEWA YOGYAKARTA",3,199,50,249
https://kawalpemilu.org#41886,"BENDUNGAN, WATES, KULON PROGO, DAERAH ISTIMEWA YOGYAKARTA",4,210,62,272
https://kawalpemilu.org#41886,"BENDUNGAN, WATES, KULON PROGO, DAERAH ISTIMEWA YOGYAKARTA",5,192,65,257
https://kawalpemilu.org#41886,"BENDUNGAN, WATES, KULON PROGO, DAERAH ISTIMEWA YOGYAKARTA",6,173,73,246
https://kawalpemilu.org#41886,"BENDUNGAN, WATES, KULON PROGO, DAERAH ISTIMEWA YOGYAKARTA",7,168,95,263
https://kawalpemilu.org#41886,"BENDUNGAN, WATES, KULON PROGO, DAERAH ISTIMEWA YOGYAKARTA",8,155,37,192
https://kawalpemilu.org#41886,"BENDUNGAN, WATES, KULON PROGO, DAERAH ISTIMEWA YOGYAKARTA",9,137,124,261
https://kawalpemilu.org#41886,"BENDUNGAN, WATES, KULON PROGO, DAERAH ISTIMEWA YOGYAKARTA",11,183,55,238
https://kawalpemilu.org#41886,"BENDUNGAN, WATES, KULON PROGO, DAERAH ISTIMEWA YOGYAKARTA",12,161,55,216
https://kawalpemilu.org#41886,"BENDUNGAN, WATES, KULON PROGO, DAERAH ISTIMEWA YOGYAKARTA",13,140,94,234
https://kawalpemilu.org#41886,"BENDUNGAN, WATES, KULON PROGO, DAERAH ISTIMEWA YOGYAKARTA",14,171,73,244
https://kawalpemilu.org#41886,"BENDUNGAN, WATES, KULON PROGO, DAERAH ISTIMEWA YOGYAKARTA",15,150,40,190
https://kawalpemilu.org#41886,"BENDUNGAN, WATES, KULON PROGO, DAERAH ISTIMEWA YOGYAKARTA",16,153,66,219
https://kawalpemilu.org#41886,"BENDUNGAN, WATES, KULON PROGO, DAERAH ISTIMEWA YOGYAKARTA",17,175,55,230
https://kawalpemilu.org#41886,"BENDUNGAN, WATES, KULON PROGO, DAERAH ISTIMEWA YOGYAKARTA",18,159,64,223
https://kawalpemilu.org#41886,"BENDUNGAN, WATES, KULON PROGO, DAERAH ISTIMEWA YOGYAKARTA",19,159,43,202
https://kawalpemilu.org#41887,"TRIHARJO, WATES, KULON PROGO, DAERAH ISTIMEWA YOGYAKARTA",1,148,91,239
https://kawalpemilu.org#41887,"TRIHARJO, WATES, KULON PROGO, DAERAH ISTIMEWA YOGYAKARTA",2,135,92,227
https://kawalpemilu.org#41887,"TRIHARJO, WATES, KULON PROGO, DAERAH ISTIMEWA YOGYAKARTA",3,168,93,261
https://kawalpemilu.org#41887,"TRIHARJO, WATES, KULON PROGO, DAERAH ISTIMEWA YOGYAKARTA",4,181,53,234
https://kawalpemilu.org#41887,"TRIHARJO, WATES, KULON PROGO, DAERAH ISTIMEWA YOGYAKARTA",5,198,60,258
https://kawalpemilu.org#41887,"TRIHARJO, WATES, KULON PROGO, DAERAH ISTIMEWA YOGYAKARTA",6,196,61,257
https://kawalpemilu.org#41887,"TRIHARJO, WATES, KULON PROGO, DAERAH ISTIMEWA YOGYAKARTA",7,143,93,236
https://kawalpemilu.org#41887,"TRIHARJO, WATES, KULON PROGO, DAERAH ISTIMEWA YOGYAKARTA",8,166,84,250
https://kawalpemilu.org#41887,"TRIHARJO, WATES, KULON PROGO, DAERAH ISTIMEWA YOGYAKARTA",9,179,60,239
https://kawalpemilu.org#41887,"TRIHARJO, WATES, KULON PROGO, DAERAH ISTIMEWA YOGYAKARTA",10,203,26,229
https://kawalpemilu.org#41887,"TRIHARJO, WATES, KULON PROGO, DAERAH ISTIMEWA YOGYAKARTA",11,154,92,246
https://kawalpemilu.org#41887,"TRIHARJO, WATES, KULON PROGO, DAERAH ISTIMEWA YOGYAKARTA",12,116,64,180
https://kawalpemilu.org#41887,"TRIHARJO, WATES, KULON PROGO, DAERAH ISTIMEWA YOGYAKARTA",13,133,84,217
https://kawalpemilu.org#41887,"TRIHARJO, WATES, KULON PROGO, DAERAH ISTIMEWA YOGYAKARTA",14,133,62,195
https://kawalpemilu.org#41887,"TRIHARJO, WATES, KULON PROGO, DAERAH ISTIMEWA YOGYAKARTA",15,126,105,231
https://kawalpemilu.org#41887,"TRIHARJO, WATES, KULON PROGO, DAERAH ISTIMEWA YOGYAKARTA",16,133,98,231
https://kawalpemilu.org#41887,"TRIHARJO, WATES, KULON PROGO, DAERAH ISTIMEWA YOGYAKARTA",17,154,90,244
https://kawalpemilu.org#41887,"TRIHARJO, WATES, KULON PROGO, DAERAH ISTIMEWA YOGYAKARTA",18,118,116,234
https://kawalpemilu.org#41887,"TRIHARJO, WATES, KULON PROGO, DAERAH ISTIMEWA YOGYAKARTA",19,70,122,192
https://kawalpemilu.org#41887,"TRIHARJO, WATES, KULON PROGO, DAERAH ISTIMEWA YOGYAKARTA",20,125,114,239
https://kawalpemilu.org#41888,"GIRIPENI, WATES, KULON PROGO, DAERAH ISTIMEWA YOGYAKARTA",1,145,87,232
https://kawalpemilu.org#41888,"GIRIPENI, WATES, KULON PROGO, DAERAH ISTIMEWA YOGYAKARTA",2,121,133,254
https://kawalpemilu.org#41888,"GIRIPENI, WATES, KULON PROGO, DAERAH ISTIMEWA YOGYAKARTA",3,156,66,222
https://kawalpemilu.org#41888,"GIRIPENI, WATES, KULON PROGO, DAERAH ISTIMEWA YOGYAKARTA",4,138,103,241
https://kawalpemilu.org#41888,"GIRIPENI, WATES, KULON PROGO, DAERAH ISTIMEWA YOGYAKARTA",5,140,98,238
https://kawalpemilu.org#41888,"GIRIPENI, WATES, KULON PROGO, DAERAH ISTIMEWA YOGYAKARTA",6,207,40,247
https://kawalpemilu.org#41888,"GIRIPENI, WATES, KULON PROGO, DAERAH ISTIMEWA YOGYAKARTA",7,180,57,237
https://kawalpemilu.org#41888,"GIRIPENI, WATES, KULON PROGO, DAERAH ISTIMEWA YOGYAKARTA",8,159,68,227
https://kawalpemilu.org#41888,"GIRIPENI, WATES, KULON PROGO, DAERAH ISTIMEWA YOGYAKARTA",9,146,89,235
https://kawalpemilu.org#41888,"GIRIPENI, WATES, KULON PROGO, DAERAH ISTIMEWA YOGYAKARTA",10,133,90,223
https://kawalpemilu.org#41888,"GIRIPENI, WATES, KULON PROGO, DAERAH ISTIMEWA YOGYAKARTA",11,124,107,231
https://kawalpemilu.org#41888,"GIRIPENI, WATES, KULON PROGO, DAERAH ISTIMEWA YOGYAKARTA",12,182,43,225
https://kawalpemilu.org#41888,"GIRIPENI, WATES, KULON PROGO, DAERAH ISTIMEWA YOGYAKARTA",13,149,77,226
https://kawalpemilu.org#41888,"GIRIPENI, WATES, KULON PROGO, DAERAH ISTIMEWA YOGYAKARTA",14,201,39,240
https://kawalpemilu.org#41888,"GIRIPENI, WATES, KULON PROGO, DAERAH ISTIMEWA YOGYAKARTA",15,204,35,239
https://kawalpemilu.org#41888,"GIRIPENI, WATES, KULON PROGO, DAERAH ISTIMEWA YOGYAKARTA",16,152,86,238
https://kawalpemilu.org#41888,"GIRIPENI, WATES, KULON PROGO, DAERAH ISTIMEWA YOGYAKARTA",17,130,70,200
https://kawalpemilu.org#41888,"GIRIPENI, WATES, KULON PROGO, DAERAH ISTIMEWA YOGYAKARTA",18,141,112,253
https://kawalpemilu.org#41888,"GIRIPENI, WATES, KULON PROGO, DAERAH ISTIMEWA YOGYAKARTA",19,99,146,245
https://kawalpemilu.org#41888,"GIRIPENI, WATES, KULON PROGO, DAERAH ISTIMEWA YOGYAKARTA",20,143,30,173
https://kawalpemilu.org#41888,"GIRIPENI, WATES, KULON PROGO, DAERAH ISTIMEWA YOGYAKARTA",21,119,127,246
https://kawalpemilu.org#41888,"GIRIPENI, WATES, KULON PROGO, DAERAH ISTIMEWA YOGYAKARTA",22,199,51,250
https://kawalpemilu.org#41889,"WATES, WATES, KULON PROGO, DAERAH ISTIMEWA YOGYAKARTA",1,177,47,224
https://kawalpemilu.org#41889,"WATES, WATES, KULON PROGO, DAERAH ISTIMEWA YOGYAKARTA",2,192,73,265
https://kawalpemilu.org#41889,"WATES, WATES, KULON PROGO, DAERAH ISTIMEWA YOGYAKARTA",3,122,107,229
https://kawalpemilu.org#41889,"WATES, WATES, KULON PROGO, DAERAH ISTIMEWA YOGYAKARTA",4,150,58,208
https://kawalpemilu.org#41889,"WATES, WATES, KULON PROGO, DAERAH ISTIMEWA YOGYAKARTA",5,102,111,213
https://kawalpemilu.org#41889,"WATES, WATES, KULON PROGO, DAERAH ISTIMEWA YOGYAKARTA",6,103,113,216
https://kawalpemilu.org#41889,"WATES, WATES, KULON PROGO, DAERAH ISTIMEWA YOGYAKARTA",7,133,109,242
https://kawalpemilu.org#41889,"WATES, WATES, KULON PROGO, DAERAH ISTIMEWA YOGYAKARTA",8,181,87,268
https://kawalpemilu.org#41889,"WATES, WATES, KULON PROGO, DAERAH ISTIMEWA YOGYAKARTA",9,155,90,245
https://kawalpemilu.org#41889,"WATES, WATES, KULON PROGO, DAERAH ISTIMEWA YOGYAKARTA",10,177,55,232
https://kawalpemilu.org#41889,"WATES, WATES, KULON PROGO, DAERAH ISTIMEWA YOGYAKARTA",11,151,76,227
https://kawalpemilu.org#41889,"WATES, WATES, KULON PROGO, DAERAH ISTIMEWA YOGYAKARTA",12,146,99,245
https://kawalpemilu.org#41889,"WATES, WATES, KULON PROGO, DAERAH ISTIMEWA YOGYAKARTA",13,125,104,229
https://kawalpemilu.org#41889,"WATES, WATES, KULON PROGO, DAERAH ISTIMEWA YOGYAKARTA",14,136,112,248
https://kawalpemilu.org#41889,"WATES, WATES, KULON PROGO, DAERAH ISTIMEWA YOGYAKARTA",15,171,69,240
https://kawalpemilu.org#41889,"WATES, WATES, KULON PROGO, DAERAH ISTIMEWA YOGYAKARTA",16,153,105,258
https://kawalpemilu.org#41889,"WATES, WATES, KULON PROGO, DAERAH ISTIMEWA YOGYAKARTA",17,171,53,224
https://kawalpemilu.org#41889,"WATES, WATES, KULON PROGO, DAERAH ISTIMEWA YOGYAKARTA",18,157,75,232
https://kawalpemilu.org#41889,"WATES, WATES, KULON PROGO, DAERAH ISTIMEWA YOGYAKARTA",19,132,92,224
https://kawalpemilu.org#41889,"WATES, WATES, KULON PROGO, DAERAH ISTIMEWA YOGYAKARTA",20,129,112,241
https://kawalpemilu.org#41889,"WATES, WATES, KULON PROGO, DAERAH ISTIMEWA YOGYAKARTA",21,181,55,236
https://kawalpemilu.org#41889,"WATES, WATES, KULON PROGO, DAERAH ISTIMEWA YOGYAKARTA",22,147,112,259
https://kawalpemilu.org#41889,"WATES, WATES, KULON PROGO, DAERAH ISTIMEWA YOGYAKARTA",23,131,113,244
https://kawalpemilu.org#41889,"WATES, WATES, KULON PROGO, DAERAH ISTIMEWA YOGYAKARTA",24,109,109,218
https://kawalpemilu.org#41889,"WATES, WATES, KULON PROGO, DAERAH ISTIMEWA YOGYAKARTA",25,93,67,160
https://kawalpemilu.org#41889,"WATES, WATES, KULON PROGO, DAERAH ISTIMEWA YOGYAKARTA",26,122,128,250
https://kawalpemilu.org#41889,"WATES, WATES, KULON PROGO, DAERAH ISTIMEWA YOGYAKARTA",27,154,97,251
https://kawalpemilu.org#41889,"WATES, WATES, KULON PROGO, DAERAH ISTIMEWA YOGYAKARTA",28,108,110,218
https://kawalpemilu.org#41889,"WATES, WATES, KULON PROGO, DAERAH ISTIMEWA YOGYAKARTA",29,116,108,224
https://kawalpemilu.org#41889,"WATES, WATES, KULON PROGO, DAERAH ISTIMEWA YOGYAKARTA",30,134,116,250
https://kawalpemilu.org#41889,"WATES, WATES, KULON PROGO, DAERAH ISTIMEWA YOGYAKARTA",31,81,103,184
https://kawalpemilu.org#41889,"WATES, WATES, KULON PROGO, DAERAH ISTIMEWA YOGYAKARTA",32,0,0,0
https://kawalpemilu.org#41889,"WATES, WATES, KULON PROGO, DAERAH ISTIMEWA YOGYAKARTA",33,108,120,228
https://kawalpemilu.org#41889,"WATES, WATES, KULON PROGO, DAERAH ISTIMEWA YOGYAKARTA",34,94,64,158
https://kawalpemilu.org#41889,"WATES, WATES, KULON PROGO, DAERAH ISTIMEWA YOGYAKARTA",35,89,161,250
https://kawalpemilu.org#41889,"WATES, WATES, KULON PROGO, DAERAH ISTIMEWA YOGYAKARTA",36,136,105,241
https://kawalpemilu.org#41889,"WATES, WATES, KULON PROGO, DAERAH ISTIMEWA YOGYAKARTA",37,158,105,263
https://kawalpemilu.org#41889,"WATES, WATES, KULON PROGO, DAERAH ISTIMEWA YOGYAKARTA",38,134,74,208
https://kawalpemilu.org#41889,"WATES, WATES, KULON PROGO, DAERAH ISTIMEWA YOGYAKARTA",39,121,86,207
https://kawalpemilu.org#41889,"WATES, WATES, KULON PROGO, DAERAH ISTIMEWA YOGYAKARTA",40,47,34,81
https://kawalpemilu.org#41889,"WATES, WATES, KULON PROGO, DAERAH ISTIMEWA YOGYAKARTA",41,44,36,80
https://kawalpemilu.org#41891,"GARONGAN, PANJATAN, KULON PROGO, DAERAH ISTIMEWA YOGYAKARTA",1,103,145,248
https://kawalpemilu.org#41891,"GARONGAN, PANJATAN, KULON PROGO, DAERAH ISTIMEWA YOGYAKARTA",2,153,79,232
https://kawalpemilu.org#41891,"GARONGAN, PANJATAN, KULON PROGO, DAERAH ISTIMEWA YOGYAKARTA",3,124,128,252
https://kawalpemilu.org#41891,"GARONGAN, PANJATAN, KULON PROGO, DAERAH ISTIMEWA YOGYAKARTA",4,108,154,262
https://kawalpemilu.org#41891,"GARONGAN, PANJATAN, KULON PROGO, DAERAH ISTIMEWA YOGYAKARTA",5,72,139,211
https://kawalpemilu.org#41891,"GARONGAN, PANJATAN, KULON PROGO, DAERAH ISTIMEWA YOGYAKARTA",6,114,129,243
https://kawalpemilu.org#41891,"GARONGAN, PANJATAN, KULON PROGO, DAERAH ISTIMEWA YOGYAKARTA",7,100,132,232
https://kawalpemilu.org#41891,"GARONGAN, PANJATAN, KULON PROGO, DAERAH ISTIMEWA YOGYAKARTA",8,117,100,217
https://kawalpemilu.org#41891,"GARONGAN, PANJATAN, KULON PROGO, DAERAH ISTIMEWA YOGYAKARTA",9,116,100,216
https://kawalpemilu.org#41891,"GARONGAN, PANJATAN, KULON PROGO, DAERAH ISTIMEWA YOGYAKARTA",10,124,112,236
https://kawalpemilu.org#41892,"PLERET, PANJATAN, KULON PROGO, DAERAH ISTIMEWA YOGYAKARTA",1,159,83,242
https://kawalpemilu.org#41892,"PLERET, PANJATAN, KULON PROGO, DAERAH ISTIMEWA YOGYAKARTA",2,144,93,237
https://kawalpemilu.org#41892,"PLERET, PANJATAN, KULON PROGO, DAERAH ISTIMEWA YOGYAKARTA",3,170,85,255
https://kawalpemilu.org#41892,"PLERET, PANJATAN, KULON PROGO, DAERAH ISTIMEWA YOGYAKARTA",4,129,124,253
https://kawalpemilu.org#41892,"PLERET, PANJATAN, KULON PROGO, DAERAH ISTIMEWA YOGYAKARTA",5,141,100,241
https://kawalpemilu.org#41892,"PLERET, PANJATAN, KULON PROGO, DAERAH ISTIMEWA YOGYAKARTA",6,141,110,251
https://kawalpemilu.org#41892,"PLERET, PANJATAN, KULON PROGO, DAERAH ISTIMEWA YOGYAKARTA",7,93,143,236
https://kawalpemilu.org#41892,"PLERET, PANJATAN, KULON PROGO, DAERAH ISTIMEWA YOGYAKARTA",8,120,134,254
https://kawalpemilu.org#41892,"PLERET, PANJATAN, KULON PROGO, DAERAH ISTIMEWA YOGYAKARTA",9,99,128,227
https://kawalpemilu.org#41892,"PLERET, PANJATAN, KULON PROGO, DAERAH ISTIMEWA YOGYAKARTA",10,136,75,211
https://kawalpemilu.org#41892,"PLERET, PANJATAN, KULON PROGO, DAERAH ISTIMEWA YOGYAKARTA",11,178,60,238
https://kawalpemilu.org#41892,"PLERET, PANJATAN, KULON PROGO, DAERAH ISTIMEWA YOGYAKARTA",12,198,32,230
https://kawalpemilu.org#41892,"PLERET, PANJATAN, KULON PROGO, DAERAH ISTIMEWA YOGYAKARTA",13,155,74,229
https://kawalpemilu.org#41893,"BUGEL, PANJATAN, KULON PROGO, DAERAH ISTIMEWA YOGYAKARTA",1,132,136,268
https://kawalpemilu.org#41893,"BUGEL, PANJATAN, KULON PROGO, DAERAH ISTIMEWA YOGYAKARTA",2,90,172,262
https://kawalpemilu.org#41893,"BUGEL, PANJATAN, KULON PROGO, DAERAH ISTIMEWA YOGYAKARTA",3,120,117,237
https://kawalpemilu.org#41893,"BUGEL, PANJATAN, KULON PROGO, DAERAH ISTIMEWA YOGYAKARTA",4,141,113,254
https://kawalpemilu.org#41893,"BUGEL, PANJATAN, KULON PROGO, DAERAH ISTIMEWA YOGYAKARTA",5,113,136,249
https://kawalpemilu.org#41893,"BUGEL, PANJATAN, KULON PROGO, DAERAH ISTIMEWA YOGYAKARTA",6,177,44,221
https://kawalpemilu.org#41893,"BUGEL, PANJATAN, KULON PROGO, DAERAH ISTIMEWA YOGYAKARTA",7,159,39,198
https://kawalpemilu.org#41893,"BUGEL, PANJATAN, KULON PROGO, DAERAH ISTIMEWA YOGYAKARTA",8,129,66,195
https://kawalpemilu.org#41893,"BUGEL, PANJATAN, KULON PROGO, DAERAH ISTIMEWA YOGYAKARTA",9,146,84,230
https://kawalpemilu.org#41893,"BUGEL, PANJATAN, KULON PROGO, DAERAH ISTIMEWA YOGYAKARTA",10,149,82,231
https://kawalpemilu.org#41893,"BUGEL, PANJATAN, KULON PROGO, DAERAH ISTIMEWA YOGYAKARTA",11,131,94,225
https://kawalpemilu.org#41893,"BUGEL, PANJATAN, KULON PROGO, DAERAH ISTIMEWA YOGYAKARTA",12,175,63,238
https://kawalpemilu.org#41894,"KANOMAN, PANJATAN, KULON PROGO, DAERAH ISTIMEWA YOGYAKARTA",1,137,98,235
https://kawalpemilu.org#41894,"KANOMAN, PANJATAN, KULON PROGO, DAERAH ISTIMEWA YOGYAKARTA",2,140,97,237
https://kawalpemilu.org#41894,"KANOMAN, PANJATAN, KULON PROGO, DAERAH ISTIMEWA YOGYAKARTA",3,141,86,227
https://kawalpemilu.org#41894,"KANOMAN, PANJATAN, KULON PROGO, DAERAH ISTIMEWA YOGYAKARTA",4,96,152,248
https://kawalpemilu.org#41894,"KANOMAN, PANJATAN, KULON PROGO, DAERAH ISTIMEWA YOGYAKARTA",5,119,95,214
https://kawalpemilu.org#41894,"KANOMAN, PANJATAN, KULON PROGO, DAERAH ISTIMEWA YOGYAKARTA",6,166,69,235
https://kawalpemilu.org#41895,"DEPOK, PANJATAN, KULON PROGO, DAERAH ISTIMEWA YOGYAKARTA",1,144,68,212
https://kawalpemilu.org#41895,"DEPOK, PANJATAN, KULON PROGO, DAERAH ISTIMEWA YOGYAKARTA",2,127,83,210
https://kawalpemilu.org#41895,"DEPOK, PANJATAN, KULON PROGO, DAERAH ISTIMEWA YOGYAKARTA",3,157,66,223
https://kawalpemilu.org#41895,"DEPOK, PANJATAN, KULON PROGO, DAERAH ISTIMEWA YOGYAKARTA",4,120,81,201
https://kawalpemilu.org#41895,"DEPOK, PANJATAN, KULON PROGO, DAERAH ISTIMEWA YOGYAKARTA",5,159,55,214
https://kawalpemilu.org#41895,"DEPOK, PANJATAN, KULON PROGO, DAERAH ISTIMEWA YOGYAKARTA",6,160,30,190
https://kawalpemilu.org#41895,"DEPOK, PANJATAN, KULON PROGO, DAERAH ISTIMEWA YOGYAKARTA",7,127,93,220
https://kawalpemilu.org#41895,"DEPOK, PANJATAN, KULON PROGO, DAERAH ISTIMEWA YOGYAKARTA",8,160,90,250
https://kawalpemilu.org#41895,"DEPOK, PANJATAN, KULON PROGO, DAERAH ISTIMEWA YOGYAKARTA",9,147,89,236
https://kawalpemilu.org#41896,"BOJONG, PANJATAN, KULON PROGO, DAERAH ISTIMEWA YOGYAKARTA",1,149,88,237
https://kawalpemilu.org#41896,"BOJONG, PANJATAN, KULON PROGO, DAERAH ISTIMEWA YOGYAKARTA",2,182,49,231
https://kawalpemilu.org#41896,"BOJONG, PANJATAN, KULON PROGO, DAERAH ISTIMEWA YOGYAKARTA",3,202,41,243
https://kawalpemilu.org#41896,"BOJONG, PANJATAN, KULON PROGO, DAERAH ISTIMEWA YOGYAKARTA",4,175,83,258
https://kawalpemilu.org#41896,"BOJONG, PANJATAN, KULON PROGO, DAERAH ISTIMEWA YOGYAKARTA",5,187,65,252
https://kawalpemilu.org#41896,"BOJONG, PANJATAN, KULON PROGO, DAERAH ISTIMEWA YOGYAKARTA",6,173,65,238
https://kawalpemilu.org#41896,"BOJONG, PANJATAN, KULON PROGO, DAERAH ISTIMEWA YOGYAKARTA",7,214,35,249
https://kawalpemilu.org#41896,"BOJONG, PANJATAN, KULON PROGO, DAERAH ISTIMEWA YOGYAKARTA",8,155,56,211
https://kawalpemilu.org#41896,"BOJONG, PANJATAN, KULON PROGO, DAERAH ISTIMEWA YOGYAKARTA",9,182,49,231
https://kawalpemilu.org#41896,"BOJONG, PANJATAN, KULON PROGO, DAERAH ISTIMEWA YOGYAKARTA",10,185,51,236
https://kawalpemilu.org#41896,"BOJONG, PANJATAN, KULON PROGO, DAERAH ISTIMEWA YOGYAKARTA",11,179,38,217
https://kawalpemilu.org#41896,"BOJONG, PANJATAN, KULON PROGO, DAERAH ISTIMEWA YOGYAKARTA",12,163,36,199
https://kawalpemilu.org#41897,"TAYUBAN, PANJATAN, KULON PROGO, DAERAH ISTIMEWA YOGYAKARTA",1,146,86,232
https://kawalpemilu.org#41897,"TAYUBAN, PANJATAN, KULON PROGO, DAERAH ISTIMEWA YOGYAKARTA",2,150,71,221
https://kawalpemilu.org#41897,"TAYUBAN, PANJATAN, KULON PROGO, DAERAH ISTIMEWA YOGYAKARTA",3,150,77,227
https://kawalpemilu.org#41897,"TAYUBAN, PANJATAN, KULON PROGO, DAERAH ISTIMEWA YOGYAKARTA",5,98,67,165
https://kawalpemilu.org#41897,"TAYUBAN, PANJATAN, KULON PROGO, DAERAH ISTIMEWA YOGYAKARTA",6,166,70,236
https://kawalpemilu.org#41897,"TAYUBAN, PANJATAN, KULON PROGO, DAERAH ISTIMEWA YOGYAKARTA",7,131,59,190
https://kawalpemilu.org#41898,"GOTAKAN, PANJATAN, KULON PROGO, DAERAH ISTIMEWA YOGYAKARTA",1,131,53,184
https://kawalpemilu.org#41898,"GOTAKAN, PANJATAN, KULON PROGO, DAERAH ISTIMEWA YOGYAKARTA",2,173,72,245
https://kawalpemilu.org#41898,"GOTAKAN, PANJATAN, KULON PROGO, DAERAH ISTIMEWA YOGYAKARTA",3,165,67,232
https://kawalpemilu.org#41898,"GOTAKAN, PANJATAN, KULON PROGO, DAERAH ISTIMEWA YOGYAKARTA",4,176,47,223
https://kawalpemilu.org#41898,"GOTAKAN, PANJATAN, KULON PROGO, DAERAH ISTIMEWA YOGYAKARTA",5,128,84,212
https://kawalpemilu.org#41898,"GOTAKAN, PANJATAN, KULON PROGO, DAERAH ISTIMEWA YOGYAKARTA",6,187,24,211
https://kawalpemilu.org#41898,"GOTAKAN, PANJATAN, KULON PROGO, DAERAH ISTIMEWA YOGYAKARTA",7,129,48,177
https://kawalpemilu.org#41898,"GOTAKAN, PANJATAN, KULON PROGO, DAERAH ISTIMEWA YOGYAKARTA",8,159,48,207
https://kawalpemilu.org#41898,"GOTAKAN, PANJATAN, KULON PROGO, DAERAH ISTIMEWA YOGYAKARTA",9,179,43,222
https://kawalpemilu.org#41899,"PANJATAN, PANJATAN, KULON PROGO, DAERAH ISTIMEWA YOGYAKARTA",1,136,112,248
https://kawalpemilu.org#41899,"PANJATAN, PANJATAN, KULON PROGO, DAERAH ISTIMEWA YOGYAKARTA",2,141,111,252
https://kawalpemilu.org#41899,"PANJATAN, PANJATAN, KULON PROGO, DAERAH ISTIMEWA YOGYAKARTA",3,145,112,257
https://kawalpemilu.org#41899,"PANJATAN, PANJATAN, KULON PROGO, DAERAH ISTIMEWA YOGYAKARTA",4,126,115,241
https://kawalpemilu.org#41900,"CERME, PANJATAN, KULON PROGO, DAERAH ISTIMEWA YOGYAKARTA",1,145,56,201
https://kawalpemilu.org#41900,"CERME, PANJATAN, KULON PROGO, DAERAH ISTIMEWA YOGYAKARTA",2,148,47,195
https://kawalpemilu.org#41900,"CERME, PANJATAN, KULON PROGO, DAERAH ISTIMEWA YOGYAKARTA",3,163,23,186
https://kawalpemilu.org#41900,"CERME, PANJATAN, KULON PROGO, DAERAH ISTIMEWA YOGYAKARTA",4,140,55,195
https://kawalpemilu.org#41900,"CERME, PANJATAN, KULON PROGO, DAERAH ISTIMEWA YOGYAKARTA",5,108,87,195
https://kawalpemilu.org#41900,"CERME, PANJATAN, KULON PROGO, DAERAH ISTIMEWA YOGYAKARTA",6,137,94,231
https://kawalpemilu.org#41900,"CERME, PANJATAN, KULON PROGO, DAERAH ISTIMEWA YOGYAKARTA",7,116,82,198
https://kawalpemilu.org#41900,"CERME, PANJATAN, KULON PROGO, DAERAH ISTIMEWA YOGYAKARTA",8,129,69,198
https://kawalpemilu.org#41900,"CERME, PANJATAN, KULON PROGO, DAERAH ISTIMEWA YOGYAKARTA",9,174,61,235
https://kawalpemilu.org#41900,"CERME, PANJATAN, KULON PROGO, DAERAH ISTIMEWA YOGYAKARTA",10,151,99,250
https://kawalpemilu.org#41900,"CERME, PANJATAN, KULON PROGO, DAERAH ISTIMEWA YOGYAKARTA",11,126,26,152
https://kawalpemilu.org#41900,"CERME, PANJATAN, KULON PROGO, DAERAH ISTIMEWA YOGYAKARTA",12,74,68,142
https://kawalpemilu.org#41901,"KREMBANGAN, PANJATAN, KULON PROGO, DAERAH ISTIMEWA YOGYAKARTA",1,119,111,230
https://kawalpemilu.org#41901,"KREMBANGAN, PANJATAN, KULON PROGO, DAERAH ISTIMEWA YOGYAKARTA",2,177,74,251
https://kawalpemilu.org#41901,"KREMBANGAN, PANJATAN, KULON PROGO, DAERAH ISTIMEWA YOGYAKARTA",3,133,81,214
https://kawalpemilu.org#41901,"KREMBANGAN, PANJATAN, KULON PROGO, DAERAH ISTIMEWA YOGYAKARTA",4,183,64,247
https://kawalpemilu.org#41901,"KREMBANGAN, PANJATAN, KULON PROGO, DAERAH ISTIMEWA YOGYAKARTA",5,144,107,251
https://kawalpemilu.org#41901,"KREMBANGAN, PANJATAN, KULON PROGO, DAERAH ISTIMEWA YOGYAKARTA",6,170,60,230
https://kawalpemilu.org#41901,"KREMBANGAN, PANJATAN, KULON PROGO, DAERAH ISTIMEWA YOGYAKARTA",7,158,77,235
https://kawalpemilu.org#41901,"KREMBANGAN, PANJATAN, KULON PROGO, DAERAH ISTIMEWA YOGYAKARTA",8,151,86,237
https://kawalpemilu.org#41901,"KREMBANGAN, PANJATAN, KULON PROGO, DAERAH ISTIMEWA YOGYAKARTA",9,132,79,211
https://kawalpemilu.org#41901,"KREMBANGAN, PANJATAN, KULON PROGO, DAERAH ISTIMEWA YOGYAKARTA",10,210,22,232
https://kawalpemilu.org#41901,"KREMBANGAN, PANJATAN, KULON PROGO, DAERAH ISTIMEWA YOGYAKARTA",11,182,46,228
https://kawalpemilu.org#41901,"KREMBANGAN, PANJATAN, KULON PROGO, DAERAH ISTIMEWA YOGYAKARTA",12,167,58,225
https://kawalpemilu.org#41901,"KREMBANGAN, PANJATAN, KULON PROGO, DAERAH ISTIMEWA YOGYAKARTA",13,133,65,198
https://kawalpemilu.org#41901,"KREMBANGAN, PANJATAN, KULON PROGO, DAERAH ISTIMEWA YOGYAKARTA",14,128,76,204
https://kawalpemilu.org#41901,"KREMBANGAN, PANJATAN, KULON PROGO, DAERAH ISTIMEWA YOGYAKARTA",15,152,71,223
https://kawalpemilu.org#41903,"BANARAN, GALUR, KULON PROGO, DAERAH ISTIMEWA YOGYAKARTA",1,141,104,245
https://kawalpemilu.org#41903,"BANARAN, GALUR, KULON PROGO, DAERAH ISTIMEWA YOGYAKARTA",2,169,79,248
https://kawalpemilu.org#41903,"BANARAN, GALUR, KULON PROGO, DAERAH ISTIMEWA YOGYAKARTA",3,103,149,252
https://kawalpemilu.org#41903,"BANARAN, GALUR, KULON PROGO, DAERAH ISTIMEWA YOGYAKARTA",4,109,125,234
https://kawalpemilu.org#41903,"BANARAN, GALUR, KULON PROGO, DAERAH ISTIMEWA YOGYAKARTA",5,134,104,238
https://kawalpemilu.org#41903,"BANARAN, GALUR, KULON PROGO, DAERAH ISTIMEWA YOGYAKARTA",6,160,89,249
https://kawalpemilu.org#41903,"BANARAN, GALUR, KULON PROGO, DAERAH ISTIMEWA YOGYAKARTA",7,0,0,0
https://kawalpemilu.org#41903,"BANARAN, GALUR, KULON PROGO, DAERAH ISTIMEWA YOGYAKARTA",8,167,88,255
https://kawalpemilu.org#41903,"BANARAN, GALUR, KULON PROGO, DAERAH ISTIMEWA YOGYAKARTA",9,117,126,243
https://kawalpemilu.org#41903,"BANARAN, GALUR, KULON PROGO, DAERAH ISTIMEWA YOGYAKARTA",10,153,92,245
https://kawalpemilu.org#41903,"BANARAN, GALUR, KULON PROGO, DAERAH ISTIMEWA YOGYAKARTA",11,152,79,231
https://kawalpemilu.org#41903,"BANARAN, GALUR, KULON PROGO, DAERAH ISTIMEWA YOGYAKARTA",12,90,145,235
https://kawalpemilu.org#41903,"BANARAN, GALUR, KULON PROGO, DAERAH ISTIMEWA YOGYAKARTA",14,109,119,228
https://kawalpemilu.org#41903,"BANARAN, GALUR, KULON PROGO, DAERAH ISTIMEWA YOGYAKARTA",15,167,110,277
https://kawalpemilu.org#41904,"KRANGGAN, GALUR, KULON PROGO, DAERAH ISTIMEWA YOGYAKARTA",1,132,122,254
https://kawalpemilu.org#41904,"KRANGGAN, GALUR, KULON PROGO, DAERAH ISTIMEWA YOGYAKARTA",2,153,104,257
https://kawalpemilu.org#41904,"KRANGGAN, GALUR, KULON PROGO, DAERAH ISTIMEWA YOGYAKARTA",3,131,104,235
https://kawalpemilu.org#41904,"KRANGGAN, GALUR, KULON PROGO, DAERAH ISTIMEWA YOGYAKARTA",4,134,99,233
https://kawalpemilu.org#41904,"KRANGGAN, GALUR, KULON PROGO, DAERAH ISTIMEWA YOGYAKARTA",5,121,116,237
https://kawalpemilu.org#41904,"KRANGGAN, GALUR, KULON PROGO, DAERAH ISTIMEWA YOGYAKARTA",6,108,113,221
https://kawalpemilu.org#41904,"KRANGGAN, GALUR, KULON PROGO, DAERAH ISTIMEWA YOGYAKARTA",7,96,164,260
https://kawalpemilu.org#41905,"NOMPOREJO, GALUR, KULON PROGO, DAERAH ISTIMEWA YOGYAKARTA",1,121,126,247
https://kawalpemilu.org#41905,"NOMPOREJO, GALUR, KULON PROGO, DAERAH ISTIMEWA YOGYAKARTA",2,99,132,231
https://kawalpemilu.org#41905,"NOMPOREJO, GALUR, KULON PROGO, DAERAH ISTIMEWA YOGYAKARTA",3,135,99,234
https://kawalpemilu.org#41905,"NOMPOREJO, GALUR, KULON PROGO, DAERAH ISTIMEWA YOGYAKARTA",4,128,103,231
https://kawalpemilu.org#41905,"NOMPOREJO, GALUR, KULON PROGO, DAERAH ISTIMEWA YOGYAKARTA",5,123,107,230
https://kawalpemilu.org#41905,"NOMPOREJO, GALUR, KULON PROGO, DAERAH ISTIMEWA YOGYAKARTA",6,149,93,242
https://kawalpemilu.org#41906,"KARANGSEWU, GALUR, KULON PROGO, DAERAH ISTIMEWA YOGYAKARTA",1,137,110,247
https://kawalpemilu.org#41906,"KARANGSEWU, GALUR, KULON PROGO, DAERAH ISTIMEWA YOGYAKARTA",2,137,99,236
https://kawalpemilu.org#41906,"KARANGSEWU, GALUR, KULON PROGO, DAERAH ISTIMEWA YOGYAKARTA",3,139,105,244
https://kawalpemilu.org#41906,"KARANGSEWU, GALUR, KULON PROGO, DAERAH ISTIMEWA YOGYAKARTA",4,101,139,240
https://kawalpemilu.org#41906,"KARANGSEWU, GALUR, KULON PROGO, DAERAH ISTIMEWA YOGYAKARTA",5,171,76,247
https://kawalpemilu.org#41906,"KARANGSEWU, GALUR, KULON PROGO, DAERAH ISTIMEWA YOGYAKARTA",6,190,70,260
https://kawalpemilu.org#41906,"KARANGSEWU, GALUR, KULON PROGO, DAERAH ISTIMEWA YOGYAKARTA",7,190,38,228
https://kawalpemilu.org#41906,"KARANGSEWU, GALUR, KULON PROGO, DAERAH ISTIMEWA YOGYAKARTA",8,112,70,182
https://kawalpemilu.org#41906,"KARANGSEWU, GALUR, KULON PROGO, DAERAH ISTIMEWA YOGYAKARTA",9,151,56,207
https://kawalpemilu.org#41906,"KARANGSEWU, GALUR, KULON PROGO, DAERAH ISTIMEWA YOGYAKARTA",10,168,71,233
https://kawalpemilu.org#41906,"KARANGSEWU, GALUR, KULON PROGO, DAERAH ISTIMEWA YOGYAKARTA",11,196,57,253
https://kawalpemilu.org#41906,"KARANGSEWU, GALUR, KULON PROGO, DAERAH ISTIMEWA YOGYAKARTA",12,118,79,197
https://kawalpemilu.org#41906,"KARANGSEWU, GALUR, KULON PROGO, DAERAH ISTIMEWA YOGYAKARTA",14,186,51,237
https://kawalpemilu.org#41906,"KARANGSEWU, GALUR, KULON PROGO, DAERAH ISTIMEWA YOGYAKARTA",15,88,164,252
https://kawalpemilu.org#41906,"KARANGSEWU, GALUR, KULON PROGO, DAERAH ISTIMEWA YOGYAKARTA",16,158,65,223
https://kawalpemilu.org#41906,"KARANGSEWU, GALUR, KULON PROGO, DAERAH ISTIMEWA YOGYAKARTA",17,163,68,231
https://kawalpemilu.org#41906,"KARANGSEWU, GALUR, KULON PROGO, DAERAH ISTIMEWA YOGYAKARTA",18,113,136,249
https://kawalpemilu.org#41906,"KARANGSEWU, GALUR, KULON PROGO, DAERAH ISTIMEWA YOGYAKARTA",19,123,120,243
https://kawalpemilu.org#41906,"KARANGSEWU, GALUR, KULON PROGO, DAERAH ISTIMEWA YOGYAKARTA",20,105,125,230
https://kawalpemilu.org#41906,"KARANGSEWU, GALUR, KULON PROGO, DAERAH ISTIMEWA YOGYAKARTA",21,152,93,245
https://kawalpemilu.org#41906,"KARANGSEWU, GALUR, KULON PROGO, DAERAH ISTIMEWA YOGYAKARTA",22,97,59,156
https://kawalpemilu.org#41906,"KARANGSEWU, GALUR, KULON PROGO, DAERAH ISTIMEWA YOGYAKARTA",23,118,84,202
https://kawalpemilu.org#41907,"TIRTORAHAYU, GALUR, KULON PROGO, DAERAH ISTIMEWA YOGYAKARTA",1,148,96,244
https://kawalpemilu.org#41907,"TIRTORAHAYU, GALUR, KULON PROGO, DAERAH ISTIMEWA YOGYAKARTA",2,150,96,246
https://kawalpemilu.org#41907,"TIRTORAHAYU, GALUR, KULON PROGO, DAERAH ISTIMEWA YOGYAKARTA",3,162,86,248
https://kawalpemilu.org#41907,"TIRTORAHAYU, GALUR, KULON PROGO, DAERAH ISTIMEWA YOGYAKARTA",4,128,106,234
https://kawalpemilu.org#41907,"TIRTORAHAYU, GALUR, KULON PROGO, DAERAH ISTIMEWA YOGYAKARTA",5,119,110,229
https://kawalpemilu.org#41907,"TIRTORAHAYU, GALUR, KULON PROGO, DAERAH ISTIMEWA YOGYAKARTA",6,181,48,229
https://kawalpemilu.org#41907,"TIRTORAHAYU, GALUR, KULON PROGO, DAERAH ISTIMEWA YOGYAKARTA",7,154,62,216
https://kawalpemilu.org#41907,"TIRTORAHAYU, GALUR, KULON PROGO, DAERAH ISTIMEWA YOGYAKARTA",8,127,125,252
https://kawalpemilu.org#41907,"TIRTORAHAYU, GALUR, KULON PROGO, DAERAH ISTIMEWA YOGYAKARTA",9,125,106,231
https://kawalpemilu.org#41907,"TIRTORAHAYU, GALUR, KULON PROGO, DAERAH ISTIMEWA YOGYAKARTA",10,92,150,242
https://kawalpemilu.org#41907,"TIRTORAHAYU, GALUR, KULON PROGO, DAERAH ISTIMEWA YOGYAKARTA",11,143,108,251
https://kawalpemilu.org#41907,"TIRTORAHAYU, GALUR, KULON PROGO, DAERAH ISTIMEWA YOGYAKARTA",12,143,75,218
https://kawalpemilu.org#41907,"TIRTORAHAYU, GALUR, KULON PROGO, DAERAH ISTIMEWA YOGYAKARTA",13,165,77,242
https://kawalpemilu.org#41907,"TIRTORAHAYU, GALUR, KULON PROGO, DAERAH ISTIMEWA YOGYAKARTA",14,189,55,244
https://kawalpemilu.org#41907,"TIRTORAHAYU, GALUR, KULON PROGO, DAERAH ISTIMEWA YOGYAKARTA",15,159,82,241
https://kawalpemilu.org#41907,"TIRTORAHAYU, GALUR, KULON PROGO, DAERAH ISTIMEWA YOGYAKARTA",16,178,75,253
https://kawalpemilu.org#41907,"TIRTORAHAYU, GALUR, KULON PROGO, DAERAH ISTIMEWA YOGYAKARTA",17,196,54,250
https://kawalpemilu.org#41907,"TIRTORAHAYU, GALUR, KULON PROGO, DAERAH ISTIMEWA YOGYAKARTA",18,115,132,247
https://kawalpemilu.org#41907,"TIRTORAHAYU, GALUR, KULON PROGO, DAERAH ISTIMEWA YOGYAKARTA",19,137,89,226
https://kawalpemilu.org#41908,"PANDOWAN, GALUR, KULON PROGO, DAERAH ISTIMEWA YOGYAKARTA",1,133,87,220
https://kawalpemilu.org#41908,"PANDOWAN, GALUR, KULON PROGO, DAERAH ISTIMEWA YOGYAKARTA",2,119,104,223
https://kawalpemilu.org#41908,"PANDOWAN, GALUR, KULON PROGO, DAERAH ISTIMEWA YOGYAKARTA",3,164,59,223
https://kawalpemilu.org#41908,"PANDOWAN, GALUR, KULON PROGO, DAERAH ISTIMEWA YOGYAKARTA",4,114,120,234
https://kawalpemilu.org#41908,"PANDOWAN, GALUR, KULON PROGO, DAERAH ISTIMEWA YOGYAKARTA",5,173,57,230
https://kawalpemilu.org#41908,"PANDOWAN, GALUR, KULON PROGO, DAERAH ISTIMEWA YOGYAKARTA",6,171,53,224
https://kawalpemilu.org#41909,"BROSOT, GALUR, KULON PROGO, DAERAH ISTIMEWA YOGYAKARTA",1,138,106,244
https://kawalpemilu.org#41909,"BROSOT, GALUR, KULON PROGO, DAERAH ISTIMEWA YOGYAKARTA",2,126,103,229
https://kawalpemilu.org#41909,"BROSOT, GALUR, KULON PROGO, DAERAH ISTIMEWA YOGYAKARTA",3,161,70,231
https://kawalpemilu.org#41909,"BROSOT, GALUR, KULON PROGO, DAERAH ISTIMEWA YOGYAKARTA",4,154,84,238
https://kawalpemilu.org#41909,"BROSOT, GALUR, KULON PROGO, DAERAH ISTIMEWA YOGYAKARTA",5,136,59,195
https://kawalpemilu.org#41909,"BROSOT, GALUR, KULON PROGO, DAERAH ISTIMEWA YOGYAKARTA",6,161,88,249
https://kawalpemilu.org#41909,"BROSOT, GALUR, KULON PROGO, DAERAH ISTIMEWA YOGYAKARTA",7,147,78,225
https://kawalpemilu.org#41909,"BROSOT, GALUR, KULON PROGO, DAERAH ISTIMEWA YOGYAKARTA",8,131,104,235
https://kawalpemilu.org#41909,"BROSOT, GALUR, KULON PROGO, DAERAH ISTIMEWA YOGYAKARTA",9,122,113,235
https://kawalpemilu.org#41909,"BROSOT, GALUR, KULON PROGO, DAERAH ISTIMEWA YOGYAKARTA",10,158,85,243
https://kawalpemilu.org#41909,"BROSOT, GALUR, KULON PROGO, DAERAH ISTIMEWA YOGYAKARTA",11,122,116,238
https://kawalpemilu.org#41909,"BROSOT, GALUR, KULON PROGO, DAERAH ISTIMEWA YOGYAKARTA",12,112,82,194
https://kawalpemilu.org#41909,"BROSOT, GALUR, KULON PROGO, DAERAH ISTIMEWA YOGYAKARTA",13,103,83,186
https://kawalpemilu.org#41909,"BROSOT, GALUR, KULON PROGO, DAERAH ISTIMEWA YOGYAKARTA",14,101,79,180
https://kawalpemilu.org#41911,"WAHYUHARJO, LENDAH, KULON PROGO, DAERAH ISTIMEWA YOGYAKARTA",1,95,98,193
https://kawalpemilu.org#41911,"WAHYUHARJO, LENDAH, KULON PROGO, DAERAH ISTIMEWA YOGYAKARTA",2,101,88,189
https://kawalpemilu.org#41911,"WAHYUHARJO, LENDAH, KULON PROGO, DAERAH ISTIMEWA YOGYAKARTA",3,157,88,245
https://kawalpemilu.org#41911,"WAHYUHARJO, LENDAH, KULON PROGO, DAERAH ISTIMEWA YOGYAKARTA",4,130,77,207
https://kawalpemilu.org#41911,"WAHYUHARJO, LENDAH, KULON PROGO, DAERAH ISTIMEWA YOGYAKARTA",5,114,104,218
https://kawalpemilu.org#41911,"WAHYUHARJO, LENDAH, KULON PROGO, DAERAH ISTIMEWA YOGYAKARTA",6,125,104,229
https://kawalpemilu.org#41912,"BUMIREJO, LENDAH, KULON PROGO, DAERAH ISTIMEWA YOGYAKARTA",1,103,124,227
https://kawalpemilu.org#41912,"BUMIREJO, LENDAH, KULON PROGO, DAERAH ISTIMEWA YOGYAKARTA",2,156,87,243
https://kawalpemilu.org#41912,"BUMIREJO, LENDAH, KULON PROGO, DAERAH ISTIMEWA YOGYAKARTA",3,115,104,219
https://kawalpemilu.org#41912,"BUMIREJO, LENDAH, KULON PROGO, DAERAH ISTIMEWA YOGYAKARTA",4,159,61,220
https://kawalpemilu.org#41912,"BUMIREJO, LENDAH, KULON PROGO, DAERAH ISTIMEWA YOGYAKARTA",5,148,92,240
https://kawalpemilu.org#41912,"BUMIREJO, LENDAH, KULON PROGO, DAERAH ISTIMEWA YOGYAKARTA",6,160,66,226
https://kawalpemilu.org#41912,"BUMIREJO, LENDAH, KULON PROGO, DAERAH ISTIMEWA YOGYAKARTA",7,137,103,240
https://kawalpemilu.org#41912,"BUMIREJO, LENDAH, KULON PROGO, DAERAH ISTIMEWA YOGYAKARTA",8,165,65,230
https://kawalpemilu.org#41912,"BUMIREJO, LENDAH, KULON PROGO, DAERAH ISTIMEWA YOGYAKARTA",9,164,80,244
https://kawalpemilu.org#41912,"BUMIREJO, LENDAH, KULON PROGO, DAERAH ISTIMEWA YOGYAKARTA",10,133,108,241
https://kawalpemilu.org#41912,"BUMIREJO, LENDAH, KULON PROGO, DAERAH ISTIMEWA YOGYAKARTA",11,165,68,233
https://kawalpemilu.org#41912,"BUMIREJO, LENDAH, KULON PROGO, DAERAH ISTIMEWA YOGYAKARTA",12,154,78,232
https://kawalpemilu.org#41912,"BUMIREJO, LENDAH, KULON PROGO, DAERAH ISTIMEWA YOGYAKARTA",13,138,77,215
https://kawalpemilu.org#41912,"BUMIREJO, LENDAH, KULON PROGO, DAERAH ISTIMEWA YOGYAKARTA",14,159,57,216
https://kawalpemilu.org#41912,"BUMIREJO, LENDAH, KULON PROGO, DAERAH ISTIMEWA YOGYAKARTA",15,185,67,252
https://kawalpemilu.org#41912,"BUMIREJO, LENDAH, KULON PROGO, DAERAH ISTIMEWA YOGYAKARTA",16,159,83,242
https://kawalpemilu.org#41912,"BUMIREJO, LENDAH, KULON PROGO, DAERAH ISTIMEWA YOGYAKARTA",17,190,70,260
https://kawalpemilu.org#41912,"BUMIREJO, LENDAH, KULON PROGO, DAERAH ISTIMEWA YOGYAKARTA",18,216,38,254
https://kawalpemilu.org#41912,"BUMIREJO, LENDAH, KULON PROGO, DAERAH ISTIMEWA YOGYAKARTA",19,206,37,243
https://kawalpemilu.org#41912,"BUMIREJO, LENDAH, KULON PROGO, DAERAH ISTIMEWA YOGYAKARTA",20,153,101,254
https://kawalpemilu.org#41912,"BUMIREJO, LENDAH, KULON PROGO, DAERAH ISTIMEWA YOGYAKARTA",21,144,107,251
https://kawalpemilu.org#41912,"BUMIREJO, LENDAH, KULON PROGO, DAERAH ISTIMEWA YOGYAKARTA",22,167,69,236
https://kawalpemilu.org#41912,"BUMIREJO, LENDAH, KULON PROGO, DAERAH ISTIMEWA YOGYAKARTA",23,161,94,255
https://kawalpemilu.org#41912,"BUMIREJO, LENDAH, KULON PROGO, DAERAH ISTIMEWA YOGYAKARTA",24,149,84,233
https://kawalpemilu.org#41912,"BUMIREJO, LENDAH, KULON PROGO, DAERAH ISTIMEWA YOGYAKARTA",25,136,105,241
https://kawalpemilu.org#41913,"JATIREJO, LENDAH, KULON PROGO, DAERAH ISTIMEWA YOGYAKARTA",1,121,117,238
https://kawalpemilu.org#41913,"JATIREJO, LENDAH, KULON PROGO, DAERAH ISTIMEWA YOGYAKARTA",2,138,114,252
https://kawalpemilu.org#41913,"JATIREJO, LENDAH, KULON PROGO, DAERAH ISTIMEWA YOGYAKARTA",3,138,102,240
https://kawalpemilu.org#41913,"JATIREJO, LENDAH, KULON PROGO, DAERAH ISTIMEWA YOGYAKARTA",4,138,105,243
https://kawalpemilu.org#41913,"JATIREJO, LENDAH, KULON PROGO, DAERAH ISTIMEWA YOGYAKARTA",5,124,86,210
https://kawalpemilu.org#41913,"JATIREJO, LENDAH, KULON PROGO, DAERAH ISTIMEWA YOGYAKARTA",6,138,104,242
https://kawalpemilu.org#41913,"JATIREJO, LENDAH, KULON PROGO, DAERAH ISTIMEWA YOGYAKARTA",7,144,98,242
https://kawalpemilu.org#41913,"JATIREJO, LENDAH, KULON PROGO, DAERAH ISTIMEWA YOGYAKARTA",8,175,74,249
https://kawalpemilu.org#41913,"JATIREJO, LENDAH, KULON PROGO, DAERAH ISTIMEWA YOGYAKARTA",9,136,106,242
https://kawalpemilu.org#41913,"JATIREJO, LENDAH, KULON PROGO, DAERAH ISTIMEWA YOGYAKARTA",10,102,134,236
https://kawalpemilu.org#41913,"JATIREJO, LENDAH, KULON PROGO, DAERAH ISTIMEWA YOGYAKARTA",11,128,104,232
https://kawalpemilu.org#41913,"JATIREJO, LENDAH, KULON PROGO, DAERAH ISTIMEWA YOGYAKARTA",12,137,104,241
https://kawalpemilu.org#41913,"JATIREJO, LENDAH, KULON PROGO, DAERAH ISTIMEWA YOGYAKARTA",13,122,107,229
https://kawalpemilu.org#41913,"JATIREJO, LENDAH, KULON PROGO, DAERAH ISTIMEWA YOGYAKARTA",14,141,96,237
https://kawalpemilu.org#41913,"JATIREJO, LENDAH, KULON PROGO, DAERAH ISTIMEWA YOGYAKARTA",15,165,65,230
https://kawalpemilu.org#41913,"JATIREJO, LENDAH, KULON PROGO, DAERAH ISTIMEWA YOGYAKARTA",16,163,72,235
https://kawalpemilu.org#41913,"JATIREJO, LENDAH, KULON PROGO, DAERAH ISTIMEWA YOGYAKARTA",17,212,39,251
https://kawalpemilu.org#41913,"JATIREJO, LENDAH, KULON PROGO, DAERAH ISTIMEWA YOGYAKARTA",18,159,97,256
https://kawalpemilu.org#41913,"JATIREJO, LENDAH, KULON PROGO, DAERAH ISTIMEWA YOGYAKARTA",19,188,74,262
https://kawalpemilu.org#41914,"SIDOREJO, LENDAH, KULON PROGO, DAERAH ISTIMEWA YOGYAKARTA",1,188,67,255
https://kawalpemilu.org#41914,"SIDOREJO, LENDAH, KULON PROGO, DAERAH ISTIMEWA YOGYAKARTA",2,145,103,248
https://kawalpemilu.org#41914,"SIDOREJO, LENDAH, KULON PROGO, DAERAH ISTIMEWA YOGYAKARTA",3,143,63,206
https://kawalpemilu.org#41914,"SIDOREJO, LENDAH, KULON PROGO, DAERAH ISTIMEWA YOGYAKARTA",4,176,58,234
https://kawalpemilu.org#41914,"SIDOREJO, LENDAH, KULON PROGO, DAERAH ISTIMEWA YOGYAKARTA",5,100,106,206
https://kawalpemilu.org#41914,"SIDOREJO, LENDAH, KULON PROGO, DAERAH ISTIMEWA YOGYAKARTA",6,125,95,220
https://kawalpemilu.org#41914,"SIDOREJO, LENDAH, KULON PROGO, DAERAH ISTIMEWA YOGYAKARTA",7,128,107,235
https://kawalpemilu.org#41914,"SIDOREJO, LENDAH, KULON PROGO, DAERAH ISTIMEWA YOGYAKARTA",8,149,86,235
https://kawalpemilu.org#41914,"SIDOREJO, LENDAH, KULON PROGO, DAERAH ISTIMEWA YOGYAKARTA",9,170,66,236
https://kawalpemilu.org#41914,"SIDOREJO, LENDAH, KULON PROGO, DAERAH ISTIMEWA YOGYAKARTA",10,153,87,240
https://kawalpemilu.org#41914,"SIDOREJO, LENDAH, KULON PROGO, DAERAH ISTIMEWA YOGYAKARTA",11,131,105,236
https://kawalpemilu.org#41914,"SIDOREJO, LENDAH, KULON PROGO, DAERAH ISTIMEWA YOGYAKARTA",12,194,55,249
https://kawalpemilu.org#41914,"SIDOREJO, LENDAH, KULON PROGO, DAERAH ISTIMEWA YOGYAKARTA",13,134,102,236
https://kawalpemilu.org#41914,"SIDOREJO, LENDAH, KULON PROGO, DAERAH ISTIMEWA YOGYAKARTA",14,129,91,220
https://kawalpemilu.org#41914,"SIDOREJO, LENDAH, KULON PROGO, DAERAH ISTIMEWA YOGYAKARTA",15,162,101,263
https://kawalpemilu.org#41914,"SIDOREJO, LENDAH, KULON PROGO, DAERAH ISTIMEWA YOGYAKARTA",16,204,42,246
https://kawalpemilu.org#41914,"SIDOREJO, LENDAH, KULON PROGO, DAERAH ISTIMEWA YOGYAKARTA",17,158,104,262
https://kawalpemilu.org#41914,"SIDOREJO, LENDAH, KULON PROGO, DAERAH ISTIMEWA YOGYAKARTA",18,145,104,249
https://kawalpemilu.org#41914,"SIDOREJO, LENDAH, KULON PROGO, DAERAH ISTIMEWA YOGYAKARTA",19,133,114,247
https://kawalpemilu.org#41914,"SIDOREJO, LENDAH, KULON PROGO, DAERAH ISTIMEWA YOGYAKARTA",20,137,120,257
https://kawalpemilu.org#41914,"SIDOREJO, LENDAH, KULON PROGO, DAERAH ISTIMEWA YOGYAKARTA",21,201,51,252
https://kawalpemilu.org#41914,"SIDOREJO, LENDAH, KULON PROGO, DAERAH ISTIMEWA YOGYAKARTA",22,189,56,245
https://kawalpemilu.org#41915,"GULUREJO, LENDAH, KULON PROGO, DAERAH ISTIMEWA YOGYAKARTA",1,186,50,236
https://kawalpemilu.org#41915,"GULUREJO, LENDAH, KULON PROGO, DAERAH ISTIMEWA YOGYAKARTA",2,180,51,231
https://kawalpemilu.org#41915,"GULUREJO, LENDAH, KULON PROGO, DAERAH ISTIMEWA YOGYAKARTA",3,185,49,234
https://kawalpemilu.org#41915,"GULUREJO, LENDAH, KULON PROGO, DAERAH ISTIMEWA YOGYAKARTA",4,147,88,234
https://kawalpemilu.org#41915,"GULUREJO, LENDAH, KULON PROGO, DAERAH ISTIMEWA YOGYAKARTA",5,128,92,220
https://kawalpemilu.org#41915,"GULUREJO, LENDAH, KULON PROGO, DAERAH ISTIMEWA YOGYAKARTA",6,120,115,235
https://kawalpemilu.org#41915,"GULUREJO, LENDAH, KULON PROGO, DAERAH ISTIMEWA YOGYAKARTA",7,75,174,249
https://kawalpemilu.org#41915,"GULUREJO, LENDAH, KULON PROGO, DAERAH ISTIMEWA YOGYAKARTA",8,178,53,231
https://kawalpemilu.org#41915,"GULUREJO, LENDAH, KULON PROGO, DAERAH ISTIMEWA YOGYAKARTA",9,205,50,255
https://kawalpemilu.org#41915,"GULUREJO, LENDAH, KULON PROGO, DAERAH ISTIMEWA YOGYAKARTA",10,82,72,254
https://kawalpemilu.org#41915,"GULUREJO, LENDAH, KULON PROGO, DAERAH ISTIMEWA YOGYAKARTA",11,181,92,273
https://kawalpemilu.org#41915,"GULUREJO, LENDAH, KULON PROGO, DAERAH ISTIMEWA YOGYAKARTA",12,193,73,266
https://kawalpemilu.org#41915,"GULUREJO, LENDAH, KULON PROGO, DAERAH ISTIMEWA YOGYAKARTA",13,207,42,249
https://kawalpemilu.org#41915,"GULUREJO, LENDAH, KULON PROGO, DAERAH ISTIMEWA YOGYAKARTA",14,209,36,245
https://kawalpemilu.org#41915,"GULUREJO, LENDAH, KULON PROGO, DAERAH ISTIMEWA YOGYAKARTA",15,229,44,273
https://kawalpemilu.org#41915,"GULUREJO, LENDAH, KULON PROGO, DAERAH ISTIMEWA YOGYAKARTA",16,191,69,260
https://kawalpemilu.org#41915,"GULUREJO, LENDAH, KULON PROGO, DAERAH ISTIMEWA YOGYAKARTA",17,149,94,243
https://kawalpemilu.org#41915,"GULUREJO, LENDAH, KULON PROGO, DAERAH ISTIMEWA YOGYAKARTA",18,162,65,227
https://kawalpemilu.org#41915,"GULUREJO, LENDAH, KULON PROGO, DAERAH ISTIMEWA YOGYAKARTA",19,192,60,252
https://kawalpemilu.org#41915,"GULUREJO, LENDAH, KULON PROGO, DAERAH ISTIMEWA YOGYAKARTA",20,206,42,248
https://kawalpemilu.org#41916,"NGENTAKREJO, LENDAH, KULON PROGO, DAERAH ISTIMEWA YOGYAKARTA",1,182,97,279
https://kawalpemilu.org#41916,"NGENTAKREJO, LENDAH, KULON PROGO, DAERAH ISTIMEWA YOGYAKARTA",2,189,81,270
https://kawalpemilu.org#41916,"NGENTAKREJO, LENDAH, KULON PROGO, DAERAH ISTIMEWA YOGYAKARTA",3,182,69,251
https://kawalpemilu.org#41916,"NGENTAKREJO, LENDAH, KULON PROGO, DAERAH ISTIMEWA YOGYAKARTA",4,191,58,249
https://kawalpemilu.org#41916,"NGENTAKREJO, LENDAH, KULON PROGO, DAERAH ISTIMEWA YOGYAKARTA",5,147,99,246
https://kawalpemilu.org#41916,"NGENTAKREJO, LENDAH, KULON PROGO, DAERAH ISTIMEWA YOGYAKARTA",6,87,142,229
https://kawalpemilu.org#41916,"NGENTAKREJO, LENDAH, KULON PROGO, DAERAH ISTIMEWA YOGYAKARTA",7,86,167,253
https://kawalpemilu.org#41916,"NGENTAKREJO, LENDAH, KULON PROGO, DAERAH ISTIMEWA YOGYAKARTA",8,92,163,255
https://kawalpemilu.org#41916,"NGENTAKREJO, LENDAH, KULON PROGO, DAERAH ISTIMEWA YOGYAKARTA",9,112,125,237
https://kawalpemilu.org#41916,"NGENTAKREJO, LENDAH, KULON PROGO, DAERAH ISTIMEWA YOGYAKARTA",10,118,128,246
https://kawalpemilu.org#41916,"NGENTAKREJO, LENDAH, KULON PROGO, DAERAH ISTIMEWA YOGYAKARTA",11,176,61,237
https://kawalpemilu.org#41916,"NGENTAKREJO, LENDAH, KULON PROGO, DAERAH ISTIMEWA YOGYAKARTA",12,173,80,253
https://kawalpemilu.org#41916,"NGENTAKREJO, LENDAH, KULON PROGO, DAERAH ISTIMEWA YOGYAKARTA",13,139,105,244
https://kawalpemilu.org#41916,"NGENTAKREJO, LENDAH, KULON PROGO, DAERAH ISTIMEWA YOGYAKARTA",14,140,123,263
https://kawalpemilu.org#41916,"NGENTAKREJO, LENDAH, KULON PROGO, DAERAH ISTIMEWA YOGYAKARTA",15,166,99,265
https://kawalpemilu.org#41916,"NGENTAKREJO, LENDAH, KULON PROGO, DAERAH ISTIMEWA YOGYAKARTA",16,159,77,236
https://kawalpemilu.org#41916,"NGENTAKREJO, LENDAH, KULON PROGO, DAERAH ISTIMEWA YOGYAKARTA",17,201,44,245
https://kawalpemilu.org#41916,"NGENTAKREJO, LENDAH, KULON PROGO, DAERAH ISTIMEWA YOGYAKARTA",18,226,38,264
https://kawalpemilu.org#41916,"NGENTAKREJO, LENDAH, KULON PROGO, DAERAH ISTIMEWA YOGYAKARTA",19,201,63,264
https://kawalpemilu.org#41916,"NGENTAKREJO, LENDAH, KULON PROGO, DAERAH ISTIMEWA YOGYAKARTA",20,221,31,252
https://kawalpemilu.org#41918,"DEMANGREJO, SENTOLO, KULON PROGO, DAERAH ISTIMEWA YOGYAKARTA",1,136,99,235
https://kawalpemilu.org#41918,"DEMANGREJO, SENTOLO, KULON PROGO, DAERAH ISTIMEWA YOGYAKARTA",2,177,77,254
https://kawalpemilu.org#41918,"DEMANGREJO, SENTOLO, KULON PROGO, DAERAH ISTIMEWA YOGYAKARTA",3,183,64,247
https://kawalpemilu.org#41918,"DEMANGREJO, SENTOLO, KULON PROGO, DAERAH ISTIMEWA YOGYAKARTA",4,149,87,236
https://kawalpemilu.org#41918,"DEMANGREJO, SENTOLO, KULON PROGO, DAERAH ISTIMEWA YOGYAKARTA",5,125,105,230
https://kawalpemilu.org#41918,"DEMANGREJO, SENTOLO, KULON PROGO, DAERAH ISTIMEWA YOGYAKARTA",6,157,84,241
https://kawalpemilu.org#41918,"DEMANGREJO, SENTOLO, KULON PROGO, DAERAH ISTIMEWA YOGYAKARTA",7,215,35,250
https://kawalpemilu.org#41918,"DEMANGREJO, SENTOLO, KULON PROGO, DAERAH ISTIMEWA YOGYAKARTA",8,208,37,245
https://kawalpemilu.org#41918,"DEMANGREJO, SENTOLO, KULON PROGO, DAERAH ISTIMEWA YOGYAKARTA",9,182,55,237
https://kawalpemilu.org#41919,"SRIKAYANGAN, SENTOLO, KULON PROGO, DAERAH ISTIMEWA YOGYAKARTA",1,209,53,262
https://kawalpemilu.org#41919,"SRIKAYANGAN, SENTOLO, KULON PROGO, DAERAH ISTIMEWA YOGYAKARTA",2,187,57,244
https://kawalpemilu.org#41919,"SRIKAYANGAN, SENTOLO, KULON PROGO, DAERAH ISTIMEWA YOGYAKARTA",3,184,76,260
https://kawalpemilu.org#41919,"SRIKAYANGAN, SENTOLO, KULON PROGO, DAERAH ISTIMEWA YOGYAKARTA",4,162,87,249
https://kawalpemilu.org#41919,"SRIKAYANGAN, SENTOLO, KULON PROGO, DAERAH ISTIMEWA YOGYAKARTA",5,146,97,243
https://kawalpemilu.org#41919,"SRIKAYANGAN, SENTOLO, KULON PROGO, DAERAH ISTIMEWA YOGYAKARTA",6,134,91,225
https://kawalpemilu.org#41919,"SRIKAYANGAN, SENTOLO, KULON PROGO, DAERAH ISTIMEWA YOGYAKARTA",7,95,179,274
https://kawalpemilu.org#41919,"SRIKAYANGAN, SENTOLO, KULON PROGO, DAERAH ISTIMEWA YOGYAKARTA",8,165,100,265
https://kawalpemilu.org#41919,"SRIKAYANGAN, SENTOLO, KULON PROGO, DAERAH ISTIMEWA YOGYAKARTA",9,171,74,245
https://kawalpemilu.org#41919,"SRIKAYANGAN, SENTOLO, KULON PROGO, DAERAH ISTIMEWA YOGYAKARTA",10,166,99,265
https://kawalpemilu.org#41919,"SRIKAYANGAN, SENTOLO, KULON PROGO, DAERAH ISTIMEWA YOGYAKARTA",11,171,70,241
https://kawalpemilu.org#41919,"SRIKAYANGAN, SENTOLO, KULON PROGO, DAERAH ISTIMEWA YOGYAKARTA",12,184,67,251
https://kawalpemilu.org#41919,"SRIKAYANGAN, SENTOLO, KULON PROGO, DAERAH ISTIMEWA YOGYAKARTA",13,190,49,239
https://kawalpemilu.org#41920,"TUKSONO, SENTOLO, KULON PROGO, DAERAH ISTIMEWA YOGYAKARTA",1,139,86,225
https://kawalpemilu.org#41920,"TUKSONO, SENTOLO, KULON PROGO, DAERAH ISTIMEWA YOGYAKARTA",2,154,55,209
https://kawalpemilu.org#41920,"TUKSONO, SENTOLO, KULON PROGO, DAERAH ISTIMEWA YOGYAKARTA",3,112,144,156
https://kawalpemilu.org#41920,"TUKSONO, SENTOLO, KULON PROGO, DAERAH ISTIMEWA YOGYAKARTA",4,128,115,243
https://kawalpemilu.org#41920,"TUKSONO, SENTOLO, KULON PROGO, DAERAH ISTIMEWA YOGYAKARTA",5,136,100,236
https://kawalpemilu.org#41920,"TUKSONO, SENTOLO, KULON PROGO, DAERAH ISTIMEWA YOGYAKARTA",6,135,51,186
https://kawalpemilu.org#41920,"TUKSONO, SENTOLO, KULON PROGO, DAERAH ISTIMEWA YOGYAKARTA",7,216,23,239
https://kawalpemilu.org#41920,"TUKSONO, SENTOLO, KULON PROGO, DAERAH ISTIMEWA YOGYAKARTA",8,209,45,254
https://kawalpemilu.org#41920,"TUKSONO, SENTOLO, KULON PROGO, DAERAH ISTIMEWA YOGYAKARTA",9,181,51,232
https://kawalpemilu.org#41920,"TUKSONO, SENTOLO, KULON PROGO, DAERAH ISTIMEWA YOGYAKARTA",10,178,57,235
https://kawalpemilu.org#41920,"TUKSONO, SENTOLO, KULON PROGO, DAERAH ISTIMEWA YOGYAKARTA",11,177,49,226
https://kawalpemilu.org#41920,"TUKSONO, SENTOLO, KULON PROGO, DAERAH ISTIMEWA YOGYAKARTA",12,179,63,242
https://kawalpemilu.org#41920,"TUKSONO, SENTOLO, KULON PROGO, DAERAH ISTIMEWA YOGYAKARTA",14,199,66,265
https://kawalpemilu.org#41920,"TUKSONO, SENTOLO, KULON PROGO, DAERAH ISTIMEWA YOGYAKARTA",15,173,69,242
https://kawalpemilu.org#41920,"TUKSONO, SENTOLO, KULON PROGO, DAERAH ISTIMEWA YOGYAKARTA",16,160,38,198
https://kawalpemilu.org#41920,"TUKSONO, SENTOLO, KULON PROGO, DAERAH ISTIMEWA YOGYAKARTA",17,163,65,228
https://kawalpemilu.org#41920,"TUKSONO, SENTOLO, KULON PROGO, DAERAH ISTIMEWA YOGYAKARTA",18,197,39,236
https://kawalpemilu.org#41920,"TUKSONO, SENTOLO, KULON PROGO, DAERAH ISTIMEWA YOGYAKARTA",19,171,83,254
https://kawalpemilu.org#41920,"TUKSONO, SENTOLO, KULON PROGO, DAERAH ISTIMEWA YOGYAKARTA",20,208,48,256
https://kawalpemilu.org#41920,"TUKSONO, SENTOLO, KULON PROGO, DAERAH ISTIMEWA YOGYAKARTA",21,193,72,265
https://kawalpemilu.org#41920,"TUKSONO, SENTOLO, KULON PROGO, DAERAH ISTIMEWA YOGYAKARTA",22,197,49,246
https://kawalpemilu.org#41920,"TUKSONO, SENTOLO, KULON PROGO, DAERAH ISTIMEWA YOGYAKARTA",23,161,77,238
https://kawalpemilu.org#41920,"TUKSONO, SENTOLO, KULON PROGO, DAERAH ISTIMEWA YOGYAKARTA",24,186,51,237
https://kawalpemilu.org#41921,"SALAMREJO, SENTOLO, KULON PROGO, DAERAH ISTIMEWA YOGYAKARTA",1,124,119,243
https://kawalpemilu.org#41921,"SALAMREJO, SENTOLO, KULON PROGO, DAERAH ISTIMEWA YOGYAKARTA",2,139,112,251
https://kawalpemilu.org#41921,"SALAMREJO, SENTOLO, KULON PROGO, DAERAH ISTIMEWA YOGYAKARTA",3,165,85,250
https://kawalpemilu.org#41921,"SALAMREJO, SENTOLO, KULON PROGO, DAERAH ISTIMEWA YOGYAKARTA",4,215,54,269
https://kawalpemilu.org#41921,"SALAMREJO, SENTOLO, KULON PROGO, DAERAH ISTIMEWA YOGYAKARTA",5,148,91,239
https://kawalpemilu.org#41921,"SALAMREJO, SENTOLO, KULON PROGO, DAERAH ISTIMEWA YOGYAKARTA",6,144,120,264
https://kawalpemilu.org#41921,"SALAMREJO, SENTOLO, KULON PROGO, DAERAH ISTIMEWA YOGYAKARTA",7,191,62,253
https://kawalpemilu.org#41921,"SALAMREJO, SENTOLO, KULON PROGO, DAERAH ISTIMEWA YOGYAKARTA",8,192,42,234
https://kawalpemilu.org#41921,"SALAMREJO, SENTOLO, KULON PROGO, DAERAH ISTIMEWA YOGYAKARTA",9,196,61,257
https://kawalpemilu.org#41921,"SALAMREJO, SENTOLO, KULON PROGO, DAERAH ISTIMEWA YOGYAKARTA",11,208,39,47
https://kawalpemilu.org#41921,"SALAMREJO, SENTOLO, KULON PROGO, DAERAH ISTIMEWA YOGYAKARTA",12,166,75,241
https://kawalpemilu.org#41921,"SALAMREJO, SENTOLO, KULON PROGO, DAERAH ISTIMEWA YOGYAKARTA",13,149,72,221
https://kawalpemilu.org#41921,"SALAMREJO, SENTOLO, KULON PROGO, DAERAH ISTIMEWA YOGYAKARTA",14,199,48,247
https://kawalpemilu.org#41921,"SALAMREJO, SENTOLO, KULON PROGO, DAERAH ISTIMEWA YOGYAKARTA",15,217,31,248
https://kawalpemilu.org#41922,"SUKORENO, SENTOLO, KULON PROGO, DAERAH ISTIMEWA YOGYAKARTA",1,175,66,241
https://kawalpemilu.org#41922,"SUKORENO, SENTOLO, KULON PROGO, DAERAH ISTIMEWA YOGYAKARTA",2,152,100,252
https://kawalpemilu.org#41922,"SUKORENO, SENTOLO, KULON PROGO, DAERAH ISTIMEWA YOGYAKARTA",3,169,66,235
https://kawalpemilu.org#41922,"SUKORENO, SENTOLO, KULON PROGO, DAERAH ISTIMEWA YOGYAKARTA",4,162,71,233
https://kawalpemilu.org#41922,"SUKORENO, SENTOLO, KULON PROGO, DAERAH ISTIMEWA YOGYAKARTA",5,140,115,255
https://kawalpemilu.org#41922,"SUKORENO, SENTOLO, KULON PROGO, DAERAH ISTIMEWA YOGYAKARTA",7,111,144,255
https://kawalpemilu.org#41922,"SUKORENO, SENTOLO, KULON PROGO, DAERAH ISTIMEWA YOGYAKARTA",8,177,80,257
https://kawalpemilu.org#41922,"SUKORENO, SENTOLO, KULON PROGO, DAERAH ISTIMEWA YOGYAKARTA",9,188,80,268
https://kawalpemilu.org#41922,"SUKORENO, SENTOLO, KULON PROGO, DAERAH ISTIMEWA YOGYAKARTA",10,149,91,240
https://kawalpemilu.org#41922,"SUKORENO, SENTOLO, KULON PROGO, DAERAH ISTIMEWA YOGYAKARTA",11,143,87,230
https://kawalpemilu.org#41922,"SUKORENO, SENTOLO, KULON PROGO, DAERAH ISTIMEWA YOGYAKARTA",12,131,88,219
https://kawalpemilu.org#41922,"SUKORENO, SENTOLO, KULON PROGO, DAERAH ISTIMEWA YOGYAKARTA",13,189,77,266
https://kawalpemilu.org#41922,"SUKORENO, SENTOLO, KULON PROGO, DAERAH ISTIMEWA YOGYAKARTA",14,61,186,247
https://kawalpemilu.org#41922,"SUKORENO, SENTOLO, KULON PROGO, DAERAH ISTIMEWA YOGYAKARTA",15,152,97,249
https://kawalpemilu.org#41922,"SUKORENO, SENTOLO, KULON PROGO, DAERAH ISTIMEWA YOGYAKARTA",16,178,49,227
https://kawalpemilu.org#41922,"SUKORENO, SENTOLO, KULON PROGO, DAERAH ISTIMEWA YOGYAKARTA",17,184,71,255
https://kawalpemilu.org#41922,"SUKORENO, SENTOLO, KULON PROGO, DAERAH ISTIMEWA YOGYAKARTA",18,169,68,237
https://kawalpemilu.org#41922,"SUKORENO, SENTOLO, KULON PROGO, DAERAH ISTIMEWA YOGYAKARTA",19,207,47,254
https://kawalpemilu.org#41922,"SUKORENO, SENTOLO, KULON PROGO, DAERAH ISTIMEWA YOGYAKARTA",20,155,57,212
https://kawalpemilu.org#41922,"SUKORENO, SENTOLO, KULON PROGO, DAERAH ISTIMEWA YOGYAKARTA",21,196,53,249
https://kawalpemilu.org#41922,"SUKORENO, SENTOLO, KULON PROGO, DAERAH ISTIMEWA YOGYAKARTA",22,170,56,226
https://kawalpemilu.org#41923,"KALI AGUNG, SENTOLO, KULON PROGO, DAERAH ISTIMEWA YOGYAKARTA",1,223,28,251
https://kawalpemilu.org#41923,"KALI AGUNG, SENTOLO, KULON PROGO, DAERAH ISTIMEWA YOGYAKARTA",2,192,62,254
https://kawalpemilu.org#41923,"KALI AGUNG, SENTOLO, KULON PROGO, DAERAH ISTIMEWA YOGYAKARTA",3,142,103,245
https://kawalpemilu.org#41923,"KALI AGUNG, SENTOLO, KULON PROGO, DAERAH ISTIMEWA YOGYAKARTA",4,217,42,259
https://kawalpemilu.org#41923,"KALI AGUNG, SENTOLO, KULON PROGO, DAERAH ISTIMEWA YOGYAKARTA",5,184,81,265
https://kawalpemilu.org#41923,"KALI AGUNG, SENTOLO, KULON PROGO, DAERAH ISTIMEWA YOGYAKARTA",6,186,82,268
https://kawalpemilu.org#41923,"KALI AGUNG, SENTOLO, KULON PROGO, DAERAH ISTIMEWA YOGYAKARTA",7,171,81,252
https://kawalpemilu.org#41923,"KALI AGUNG, SENTOLO, KULON PROGO, DAERAH ISTIMEWA YOGYAKARTA",8,203,54,257
https://kawalpemilu.org#41923,"KALI AGUNG, SENTOLO, KULON PROGO, DAERAH ISTIMEWA YOGYAKARTA",9,189,74,263
https://kawalpemilu.org#41923,"KALI AGUNG, SENTOLO, KULON PROGO, DAERAH ISTIMEWA YOGYAKARTA",10,177,56,233
https://kawalpemilu.org#41923,"KALI AGUNG, SENTOLO, KULON PROGO, DAERAH ISTIMEWA YOGYAKARTA",11,196,48,244
https://kawalpemilu.org#41923,"KALI AGUNG, SENTOLO, KULON PROGO, DAERAH ISTIMEWA YOGYAKARTA",12,187,69,256
https://kawalpemilu.org#41923,"KALI AGUNG, SENTOLO, KULON PROGO, DAERAH ISTIMEWA YOGYAKARTA",13,205,60,265
https://kawalpemilu.org#41923,"KALI AGUNG, SENTOLO, KULON PROGO, DAERAH ISTIMEWA YOGYAKARTA",14,222,42,264
https://kawalpemilu.org#41923,"KALI AGUNG, SENTOLO, KULON PROGO, DAERAH ISTIMEWA YOGYAKARTA",15,179,82,261
https://kawalpemilu.org#41923,"KALI AGUNG, SENTOLO, KULON PROGO, DAERAH ISTIMEWA YOGYAKARTA",16,177,60,237
https://kawalpemilu.org#41924,"SENTOLO, SENTOLO, KULON PROGO, DAERAH ISTIMEWA YOGYAKARTA",1,93,145,238
https://kawalpemilu.org#41924,"SENTOLO, SENTOLO, KULON PROGO, DAERAH ISTIMEWA YOGYAKARTA",2,138,118,256
https://kawalpemilu.org#41924,"SENTOLO, SENTOLO, KULON PROGO, DAERAH ISTIMEWA YOGYAKARTA",3,157,106,263
https://kawalpemilu.org#41924,"SENTOLO, SENTOLO, KULON PROGO, DAERAH ISTIMEWA YOGYAKARTA",4,129,117,246
https://kawalpemilu.org#41924,"SENTOLO, SENTOLO, KULON PROGO, DAERAH ISTIMEWA YOGYAKARTA",5,155,86,241
https://kawalpemilu.org#41924,"SENTOLO, SENTOLO, KULON PROGO, DAERAH ISTIMEWA YOGYAKARTA",6,145,107,252
https://kawalpemilu.org#41924,"SENTOLO, SENTOLO, KULON PROGO, DAERAH ISTIMEWA YOGYAKARTA",7,166,106,272
https://kawalpemilu.org#41924,"SENTOLO, SENTOLO, KULON PROGO, DAERAH ISTIMEWA YOGYAKARTA",8,163,78,241
https://kawalpemilu.org#41924,"SENTOLO, SENTOLO, KULON PROGO, DAERAH ISTIMEWA YOGYAKARTA",9,155,102,257
https://kawalpemilu.org#41924,"SENTOLO, SENTOLO, KULON PROGO, DAERAH ISTIMEWA YOGYAKARTA",10,160,92,252
https://kawalpemilu.org#41924,"SENTOLO, SENTOLO, KULON PROGO, DAERAH ISTIMEWA YOGYAKARTA",11,154,51,205
https://kawalpemilu.org#41924,"SENTOLO, SENTOLO, KULON PROGO, DAERAH ISTIMEWA YOGYAKARTA",12,151,76,227
https://kawalpemilu.org#41924,"SENTOLO, SENTOLO, KULON PROGO, DAERAH ISTIMEWA YOGYAKARTA",13,170,81,251
https://kawalpemilu.org#41924,"SENTOLO, SENTOLO, KULON PROGO, DAERAH ISTIMEWA YOGYAKARTA",14,158,76,234
https://kawalpemilu.org#41924,"SENTOLO, SENTOLO, KULON PROGO, DAERAH ISTIMEWA YOGYAKARTA",15,194,65,259
https://kawalpemilu.org#41924,"SENTOLO, SENTOLO, KULON PROGO, DAERAH ISTIMEWA YOGYAKARTA",16,206,65,271
https://kawalpemilu.org#41924,"SENTOLO, SENTOLO, KULON PROGO, DAERAH ISTIMEWA YOGYAKARTA",17,169,78,247
https://kawalpemilu.org#41924,"SENTOLO, SENTOLO, KULON PROGO, DAERAH ISTIMEWA YOGYAKARTA",18,201,59,260
https://kawalpemilu.org#41924,"SENTOLO, SENTOLO, KULON PROGO, DAERAH ISTIMEWA YOGYAKARTA",19,134,129,263
https://kawalpemilu.org#41924,"SENTOLO, SENTOLO, KULON PROGO, DAERAH ISTIMEWA YOGYAKARTA",20,176,78,254
https://kawalpemilu.org#41924,"SENTOLO, SENTOLO, KULON PROGO, DAERAH ISTIMEWA YOGYAKARTA",21,154,87,241
https://kawalpemilu.org#41924,"SENTOLO, SENTOLO, KULON PROGO, DAERAH ISTIMEWA YOGYAKARTA",22,113,108,221
https://kawalpemilu.org#41925,"BANGUNCIPTO, SENTOLO, KULON PROGO, DAERAH ISTIMEWA YOGYAKARTA",1,125,143,268
https://kawalpemilu.org#41925,"BANGUNCIPTO, SENTOLO, KULON PROGO, DAERAH ISTIMEWA YOGYAKARTA",2,97,150,247
https://kawalpemilu.org#41925,"BANGUNCIPTO, SENTOLO, KULON PROGO, DAERAH ISTIMEWA YOGYAKARTA",3,101,138,239
https://kawalpemilu.org#41925,"BANGUNCIPTO, SENTOLO, KULON PROGO, DAERAH ISTIMEWA YOGYAKARTA",4,107,156,263
https://kawalpemilu.org#41925,"BANGUNCIPTO, SENTOLO, KULON PROGO, DAERAH ISTIMEWA YOGYAKARTA",5,129,131,260
https://kawalpemilu.org#41925,"BANGUNCIPTO, SENTOLO, KULON PROGO, DAERAH ISTIMEWA YOGYAKARTA",6,194,62,256
https://kawalpemilu.org#41925,"BANGUNCIPTO, SENTOLO, KULON PROGO, DAERAH ISTIMEWA YOGYAKARTA",7,151,94,245
https://kawalpemilu.org#41925,"BANGUNCIPTO, SENTOLO, KULON PROGO, DAERAH ISTIMEWA YOGYAKARTA",8,157,84,241
https://kawalpemilu.org#41925,"BANGUNCIPTO, SENTOLO, KULON PROGO, DAERAH ISTIMEWA YOGYAKARTA",10,162,76,238
https://kawalpemilu.org#41927,"TAWANGSARI, PENGASIH, KULON PROGO, DAERAH ISTIMEWA YOGYAKARTA",1,160,72,232
https://kawalpemilu.org#41927,"TAWANGSARI, PENGASIH, KULON PROGO, DAERAH ISTIMEWA YOGYAKARTA",2,170,76,246
https://kawalpemilu.org#41927,"TAWANGSARI, PENGASIH, KULON PROGO, DAERAH ISTIMEWA YOGYAKARTA",3,160,76,236
https://kawalpemilu.org#41927,"TAWANGSARI, PENGASIH, KULON PROGO, DAERAH ISTIMEWA YOGYAKARTA",4,149,95,244
https://kawalpemilu.org#41927,"TAWANGSARI, PENGASIH, KULON PROGO, DAERAH ISTIMEWA YOGYAKARTA",5,154,79,233
https://kawalpemilu.org#41927,"TAWANGSARI, PENGASIH, KULON PROGO, DAERAH ISTIMEWA YOGYAKARTA",6,167,75,242
https://kawalpemilu.org#41927,"TAWANGSARI, PENGASIH, KULON PROGO, DAERAH ISTIMEWA YOGYAKARTA",7,165,79,244
https://kawalpemilu.org#41927,"TAWANGSARI, PENGASIH, KULON PROGO, DAERAH ISTIMEWA YOGYAKARTA",8,157,85,242
https://kawalpemilu.org#41927,"TAWANGSARI, PENGASIH, KULON PROGO, DAERAH ISTIMEWA YOGYAKARTA",9,149,84,233
https://kawalpemilu.org#41927,"TAWANGSARI, PENGASIH, KULON PROGO, DAERAH ISTIMEWA YOGYAKARTA",10,102,137,239
https://kawalpemilu.org#41927,"TAWANGSARI, PENGASIH, KULON PROGO, DAERAH ISTIMEWA YOGYAKARTA",11,147,95,3
https://kawalpemilu.org#41927,"TAWANGSARI, PENGASIH, KULON PROGO, DAERAH ISTIMEWA YOGYAKARTA",12,166,60,226
https://kawalpemilu.org#41927,"TAWANGSARI, PENGASIH, KULON PROGO, DAERAH ISTIMEWA YOGYAKARTA",13,122,96,218
https://kawalpemilu.org#41928,"KARANGSARI, PENGASIH, KULON PROGO, DAERAH ISTIMEWA YOGYAKARTA",1,188,56,244
https://kawalpemilu.org#41928,"KARANGSARI, PENGASIH, KULON PROGO, DAERAH ISTIMEWA YOGYAKARTA",2,150,80,230
https://kawalpemilu.org#41928,"KARANGSARI, PENGASIH, KULON PROGO, DAERAH ISTIMEWA YOGYAKARTA",3,185,54,239
https://kawalpemilu.org#41928,"KARANGSARI, PENGASIH, KULON PROGO, DAERAH ISTIMEWA YOGYAKARTA",4,150,102,252
https://kawalpemilu.org#41928,"KARANGSARI, PENGASIH, KULON PROGO, DAERAH ISTIMEWA YOGYAKARTA",5,171,50,221
https://kawalpemilu.org#41928,"KARANGSARI, PENGASIH, KULON PROGO, DAERAH ISTIMEWA YOGYAKARTA",6,179,60,239
https://kawalpemilu.org#41928,"KARANGSARI, PENGASIH, KULON PROGO, DAERAH ISTIMEWA YOGYAKARTA",7,179,45,224
https://kawalpemilu.org#41928,"KARANGSARI, PENGASIH, KULON PROGO, DAERAH ISTIMEWA YOGYAKARTA",8,127,47,174
https://kawalpemilu.org#41928,"KARANGSARI, PENGASIH, KULON PROGO, DAERAH ISTIMEWA YOGYAKARTA",9,150,102,252
https://kawalpemilu.org#41928,"KARANGSARI, PENGASIH, KULON PROGO, DAERAH ISTIMEWA YOGYAKARTA",10,154,81,235
https://kawalpemilu.org#41928,"KARANGSARI, PENGASIH, KULON PROGO, DAERAH ISTIMEWA YOGYAKARTA",11,108,63,171
https://kawalpemilu.org#41928,"KARANGSARI, PENGASIH, KULON PROGO, DAERAH ISTIMEWA YOGYAKARTA",12,115,71,186
https://kawalpemilu.org#41928,"KARANGSARI, PENGASIH, KULON PROGO, DAERAH ISTIMEWA YOGYAKARTA",13,144,83,227
https://kawalpemilu.org#41928,"KARANGSARI, PENGASIH, KULON PROGO, DAERAH ISTIMEWA YOGYAKARTA",14,191,63,254
https://kawalpemilu.org#41928,"KARANGSARI, PENGASIH, KULON PROGO, DAERAH ISTIMEWA YOGYAKARTA",15,192,60,252
https://kawalpemilu.org#41928,"KARANGSARI, PENGASIH, KULON PROGO, DAERAH ISTIMEWA YOGYAKARTA",16,165,59,224
https://kawalpemilu.org#41928,"KARANGSARI, PENGASIH, KULON PROGO, DAERAH ISTIMEWA YOGYAKARTA",17,155,46,201
https://kawalpemilu.org#41928,"KARANGSARI, PENGASIH, KULON PROGO, DAERAH ISTIMEWA YOGYAKARTA",18,129,54,183
https://kawalpemilu.org#41928,"KARANGSARI, PENGASIH, KULON PROGO, DAERAH ISTIMEWA YOGYAKARTA",19,147,51,198
https://kawalpemilu.org#41928,"KARANGSARI, PENGASIH, KULON PROGO, DAERAH ISTIMEWA YOGYAKARTA",20,183,53,236
https://kawalpemilu.org#41928,"KARANGSARI, PENGASIH, KULON PROGO, DAERAH ISTIMEWA YOGYAKARTA",21,179,63,242
https://kawalpemilu.org#41928,"KARANGSARI, PENGASIH, KULON PROGO, DAERAH ISTIMEWA YOGYAKARTA",22,135,73,208
https://kawalpemilu.org#41928,"KARANGSARI, PENGASIH, KULON PROGO, DAERAH ISTIMEWA YOGYAKARTA",23,123,75,198
https://kawalpemilu.org#41928,"KARANGSARI, PENGASIH, KULON PROGO, DAERAH ISTIMEWA YOGYAKARTA",24,209,40,249
https://kawalpemilu.org#41928,"KARANGSARI, PENGASIH, KULON PROGO, DAERAH ISTIMEWA YOGYAKARTA",25,177,70,247
https://kawalpemilu.org#41928,"KARANGSARI, PENGASIH, KULON PROGO, DAERAH ISTIMEWA YOGYAKARTA",26,147,84,231
https://kawalpemilu.org#41928,"KARANGSARI, PENGASIH, KULON PROGO, DAERAH ISTIMEWA YOGYAKARTA",27,140,80,220
https://kawalpemilu.org#41928,"KARANGSARI, PENGASIH, KULON PROGO, DAERAH ISTIMEWA YOGYAKARTA",28,156,75,231
https://kawalpemilu.org#41928,"KARANGSARI, PENGASIH, KULON PROGO, DAERAH ISTIMEWA YOGYAKARTA",29,151,104,255
https://kawalpemilu.org#41928,"KARANGSARI, PENGASIH, KULON PROGO, DAERAH ISTIMEWA YOGYAKARTA",30,159,97,256
https://kawalpemilu.org#41928,"KARANGSARI, PENGASIH, KULON PROGO, DAERAH ISTIMEWA YOGYAKARTA",31,173,81,254
https://kawalpemilu.org#41929,"KEDUNGSARI, PENGASIH, KULON PROGO, DAERAH ISTIMEWA YOGYAKARTA",1,137,54,191
https://kawalpemilu.org#41929,"KEDUNGSARI, PENGASIH, KULON PROGO, DAERAH ISTIMEWA YOGYAKARTA",2,183,34,217
https://kawalpemilu.org#41929,"KEDUNGSARI, PENGASIH, KULON PROGO, DAERAH ISTIMEWA YOGYAKARTA",3,180,31,211
https://kawalpemilu.org#41929,"KEDUNGSARI, PENGASIH, KULON PROGO, DAERAH ISTIMEWA YOGYAKARTA",4,195,39,234
https://kawalpemilu.org#41929,"KEDUNGSARI, PENGASIH, KULON PROGO, DAERAH ISTIMEWA YOGYAKARTA",5,140,104,244
https://kawalpemilu.org#41929,"KEDUNGSARI, PENGASIH, KULON PROGO, DAERAH ISTIMEWA YOGYAKARTA",6,135,90,225
https://kawalpemilu.org#41929,"KEDUNGSARI, PENGASIH, KULON PROGO, DAERAH ISTIMEWA YOGYAKARTA",7,174,71,245
https://kawalpemilu.org#41929,"KEDUNGSARI, PENGASIH, KULON PROGO, DAERAH ISTIMEWA YOGYAKARTA",8,180,71,251
https://kawalpemilu.org#41929,"KEDUNGSARI, PENGASIH, KULON PROGO, DAERAH ISTIMEWA YOGYAKARTA",9,170,91,261
https://kawalpemilu.org#41929,"KEDUNGSARI, PENGASIH, KULON PROGO, DAERAH ISTIMEWA YOGYAKARTA",10,206,54,260
https://kawalpemilu.org#41929,"KEDUNGSARI, PENGASIH, KULON PROGO, DAERAH ISTIMEWA YOGYAKARTA",11,188,53,241
https://kawalpemilu.org#41929,"KEDUNGSARI, PENGASIH, KULON PROGO, DAERAH ISTIMEWA YOGYAKARTA",12,179,65,244
https://kawalpemilu.org#41929,"KEDUNGSARI, PENGASIH, KULON PROGO, DAERAH ISTIMEWA YOGYAKARTA",13,180,69,249
https://kawalpemilu.org#41930,"MARGOSARI, PENGASIH, KULON PROGO, DAERAH ISTIMEWA YOGYAKARTA",1,121,139,260
https://kawalpemilu.org#41930,"MARGOSARI, PENGASIH, KULON PROGO, DAERAH ISTIMEWA YOGYAKARTA",2,142,104,246
https://kawalpemilu.org#41930,"MARGOSARI, PENGASIH, KULON PROGO, DAERAH ISTIMEWA YOGYAKARTA",3,179,79,258
https://kawalpemilu.org#41930,"MARGOSARI, PENGASIH, KULON PROGO, DAERAH ISTIMEWA YOGYAKARTA",4,147,102,249
https://kawalpemilu.org#41930,"MARGOSARI, PENGASIH, KULON PROGO, DAERAH ISTIMEWA YOGYAKARTA",5,167,93,260
https://kawalpemilu.org#41930,"MARGOSARI, PENGASIH, KULON PROGO, DAERAH ISTIMEWA YOGYAKARTA",6,150,100,250
https://kawalpemilu.org#41930,"MARGOSARI, PENGASIH, KULON PROGO, DAERAH ISTIMEWA YOGYAKARTA",7,158,94,252
https://kawalpemilu.org#41930,"MARGOSARI, PENGASIH, KULON PROGO, DAERAH ISTIMEWA YOGYAKARTA",8,178,84,262
https://kawalpemilu.org#41930,"MARGOSARI, PENGASIH, KULON PROGO, DAERAH ISTIMEWA YOGYAKARTA",9,203,53,256
https://kawalpemilu.org#41930,"MARGOSARI, PENGASIH, KULON PROGO, DAERAH ISTIMEWA YOGYAKARTA",10,167,63,230
https://kawalpemilu.org#41930,"MARGOSARI, PENGASIH, KULON PROGO, DAERAH ISTIMEWA YOGYAKARTA",11,128,111,239
https://kawalpemilu.org#41930,"MARGOSARI, PENGASIH, KULON PROGO, DAERAH ISTIMEWA YOGYAKARTA",12,191,43,234
https://kawalpemilu.org#41930,"MARGOSARI, PENGASIH, KULON PROGO, DAERAH ISTIMEWA YOGYAKARTA",14,137,121,258
https://kawalpemilu.org#41930,"MARGOSARI, PENGASIH, KULON PROGO, DAERAH ISTIMEWA YOGYAKARTA",15,167,98,265
https://kawalpemilu.org#41930,"MARGOSARI, PENGASIH, KULON PROGO, DAERAH ISTIMEWA YOGYAKARTA",16,165,90,255
https://kawalpemilu.org#41931,"PENGASIH, PENGASIH, KULON PROGO, DAERAH ISTIMEWA YOGYAKARTA",1,151,119,270
https://kawalpemilu.org#41931,"PENGASIH, PENGASIH, KULON PROGO, DAERAH ISTIMEWA YOGYAKARTA",2,130,143,273
https://kawalpemilu.org#41931,"PENGASIH, PENGASIH, KULON PROGO, DAERAH ISTIMEWA YOGYAKARTA",3,141,123,264
https://kawalpemilu.org#41931,"PENGASIH, PENGASIH, KULON PROGO, DAERAH ISTIMEWA YOGYAKARTA",4,168,108,276
https://kawalpemilu.org#41931,"PENGASIH, PENGASIH, KULON PROGO, DAERAH ISTIMEWA YOGYAKARTA",5,159,103,262
https://kawalpemilu.org#41931,"PENGASIH, PENGASIH, KULON PROGO, DAERAH ISTIMEWA YOGYAKARTA",6,130,138,268
https://kawalpemilu.org#41931,"PENGASIH, PENGASIH, KULON PROGO, DAERAH ISTIMEWA YOGYAKARTA",7,160,92,252
https://kawalpemilu.org#41931,"PENGASIH, PENGASIH, KULON PROGO, DAERAH ISTIMEWA YOGYAKARTA",8,166,94,260
https://kawalpemilu.org#41931,"PENGASIH, PENGASIH, KULON PROGO, DAERAH ISTIMEWA YOGYAKARTA",9,143,95,238
https://kawalpemilu.org#41931,"PENGASIH, PENGASIH, KULON PROGO, DAERAH ISTIMEWA YOGYAKARTA",10,147,108,255
https://kawalpemilu.org#41931,"PENGASIH, PENGASIH, KULON PROGO, DAERAH ISTIMEWA YOGYAKARTA",11,163,109,272
https://kawalpemilu.org#41931,"PENGASIH, PENGASIH, KULON PROGO, DAERAH ISTIMEWA YOGYAKARTA",12,202,58,260
https://kawalpemilu.org#41931,"PENGASIH, PENGASIH, KULON PROGO, DAERAH ISTIMEWA YOGYAKARTA",13,174,77,251
https://kawalpemilu.org#41931,"PENGASIH, PENGASIH, KULON PROGO, DAERAH ISTIMEWA YOGYAKARTA",14,174,85,259
https://kawalpemilu.org#41931,"PENGASIH, PENGASIH, KULON PROGO, DAERAH ISTIMEWA YOGYAKARTA",15,195,56,251
https://kawalpemilu.org#41931,"PENGASIH, PENGASIH, KULON PROGO, DAERAH ISTIMEWA YOGYAKARTA",16,225,47,272
https://kawalpemilu.org#41931,"PENGASIH, PENGASIH, KULON PROGO, DAERAH ISTIMEWA YOGYAKARTA",17,233,31,264
https://kawalpemilu.org#41931,"PENGASIH, PENGASIH, KULON PROGO, DAERAH ISTIMEWA YOGYAKARTA",18,215,54,269
https://kawalpemilu.org#41931,"PENGASIH, PENGASIH, KULON PROGO, DAERAH ISTIMEWA YOGYAKARTA",19,131,124,255
https://kawalpemilu.org#41931,"PENGASIH, PENGASIH, KULON PROGO, DAERAH ISTIMEWA YOGYAKARTA",20,137,103,240
https://kawalpemilu.org#41931,"PENGASIH, PENGASIH, KULON PROGO, DAERAH ISTIMEWA YOGYAKARTA",21,154,83,237
https://kawalpemilu.org#41931,"PENGASIH, PENGASIH, KULON PROGO, DAERAH ISTIMEWA YOGYAKARTA",22,172,79,251
https://kawalpemilu.org#41931,"PENGASIH, PENGASIH, KULON PROGO, DAERAH ISTIMEWA YOGYAKARTA",23,164,96,260
https://kawalpemilu.org#41931,"PENGASIH, PENGASIH, KULON PROGO, DAERAH ISTIMEWA YOGYAKARTA",24,150,113,263
https://kawalpemilu.org#41932,"SENDANGSARI, PENGASIH, KULON PROGO, DAERAH ISTIMEWA YOGYAKARTA",1,148,97,245
https://kawalpemilu.org#41932,"SENDANGSARI, PENGASIH, KULON PROGO, DAERAH ISTIMEWA YOGYAKARTA",2,155,82,237
https://kawalpemilu.org#41932,"SENDANGSARI, PENGASIH, KULON PROGO, DAERAH ISTIMEWA YOGYAKARTA",3,179,67,246
https://kawalpemilu.org#41932,"SENDANGSARI, PENGASIH, KULON PROGO, DAERAH ISTIMEWA YOGYAKARTA",4,158,93,251
https://kawalpemilu.org#41932,"SENDANGSARI, PENGASIH, KULON PROGO, DAERAH ISTIMEWA YOGYAKARTA",5,216,45,261
https://kawalpemilu.org#41932,"SENDANGSARI, PENGASIH, KULON PROGO, DAERAH ISTIMEWA YOGYAKARTA",6,206,39,245
https://kawalpemilu.org#41932,"SENDANGSARI, PENGASIH, KULON PROGO, DAERAH ISTIMEWA YOGYAKARTA",7,182,67,249
https://kawalpemilu.org#41932,"SENDANGSARI, PENGASIH, KULON PROGO, DAERAH ISTIMEWA YOGYAKARTA",8,137,74,211
https://kawalpemilu.org#41932,"SENDANGSARI, PENGASIH, KULON PROGO, DAERAH ISTIMEWA YOGYAKARTA",9,168,71,239
https://kawalpemilu.org#41932,"SENDANGSARI, PENGASIH, KULON PROGO, DAERAH ISTIMEWA YOGYAKARTA",10,163,66,229
https://kawalpemilu.org#41932,"SENDANGSARI, PENGASIH, KULON PROGO, DAERAH ISTIMEWA YOGYAKARTA",11,155,98,253
https://kawalpemilu.org#41932,"SENDANGSARI, PENGASIH, KULON PROGO, DAERAH ISTIMEWA YOGYAKARTA",12,159,80,239
https://kawalpemilu.org#41932,"SENDANGSARI, PENGASIH, KULON PROGO, DAERAH ISTIMEWA YOGYAKARTA",13,139,112,251
https://kawalpemilu.org#41932,"SENDANGSARI, PENGASIH, KULON PROGO, DAERAH ISTIMEWA YOGYAKARTA",14,168,82,250
https://kawalpemilu.org#41932,"SENDANGSARI, PENGASIH, KULON PROGO, DAERAH ISTIMEWA YOGYAKARTA",16,125,134,259
https://kawalpemilu.org#41932,"SENDANGSARI, PENGASIH, KULON PROGO, DAERAH ISTIMEWA YOGYAKARTA",17,188,69,257
https://kawalpemilu.org#41932,"SENDANGSARI, PENGASIH, KULON PROGO, DAERAH ISTIMEWA YOGYAKARTA",18,163,78,241
https://kawalpemilu.org#41932,"SENDANGSARI, PENGASIH, KULON PROGO, DAERAH ISTIMEWA YOGYAKARTA",19,177,76,253
https://kawalpemilu.org#41932,"SENDANGSARI, PENGASIH, KULON PROGO, DAERAH ISTIMEWA YOGYAKARTA",20,126,122,248
https://kawalpemilu.org#41932,"SENDANGSARI, PENGASIH, KULON PROGO, DAERAH ISTIMEWA YOGYAKARTA",21,159,89,248
https://kawalpemilu.org#41932,"SENDANGSARI, PENGASIH, KULON PROGO, DAERAH ISTIMEWA YOGYAKARTA",22,176,77,253
https://kawalpemilu.org#41932,"SENDANGSARI, PENGASIH, KULON PROGO, DAERAH ISTIMEWA YOGYAKARTA",23,189,68,257
https://kawalpemilu.org#41932,"SENDANGSARI, PENGASIH, KULON PROGO, DAERAH ISTIMEWA YOGYAKARTA",24,170,79,249
https://kawalpemilu.org#41932,"SENDANGSARI, PENGASIH, KULON PROGO, DAERAH ISTIMEWA YOGYAKARTA",25,156,80,236
https://kawalpemilu.org#41932,"SENDANGSARI, PENGASIH, KULON PROGO, DAERAH ISTIMEWA YOGYAKARTA",26,148,108,256
https://kawalpemilu.org#41933,"SIDOMULYO, PENGASIH, KULON PROGO, DAERAH ISTIMEWA YOGYAKARTA",1,102,118,220
https://kawalpemilu.org#41933,"SIDOMULYO, PENGASIH, KULON PROGO, DAERAH ISTIMEWA YOGYAKARTA",2,116,130,246
https://kawalpemilu.org#41933,"SIDOMULYO, PENGASIH, KULON PROGO, DAERAH ISTIMEWA YOGYAKARTA",3,135,119,254
https://kawalpemilu.org#41933,"SIDOMULYO, PENGASIH, KULON PROGO, DAERAH ISTIMEWA YOGYAKARTA",4,103,145,248
https://kawalpemilu.org#41933,"SIDOMULYO, PENGASIH, KULON PROGO, DAERAH ISTIMEWA YOGYAKARTA",5,133,112,245
https://kawalpemilu.org#41933,"SIDOMULYO, PENGASIH, KULON PROGO, DAERAH ISTIMEWA YOGYAKARTA",6,167,72,239
https://kawalpemilu.org#41933,"SIDOMULYO, PENGASIH, KULON PROGO, DAERAH ISTIMEWA YOGYAKARTA",7,84,141,225
https://kawalpemilu.org#41933,"SIDOMULYO, PENGASIH, KULON PROGO, DAERAH ISTIMEWA YOGYAKARTA",8,168,54,222
https://kawalpemilu.org#41933,"SIDOMULYO, PENGASIH, KULON PROGO, DAERAH ISTIMEWA YOGYAKARTA",9,161,67,228
https://kawalpemilu.org#41933,"SIDOMULYO, PENGASIH, KULON PROGO, DAERAH ISTIMEWA YOGYAKARTA",10,147,57,204
https://kawalpemilu.org#41933,"SIDOMULYO, PENGASIH, KULON PROGO, DAERAH ISTIMEWA YOGYAKARTA",11,76,110,186
https://kawalpemilu.org#41933,"SIDOMULYO, PENGASIH, KULON PROGO, DAERAH ISTIMEWA YOGYAKARTA",13,146,75,221
https://kawalpemilu.org#41933,"SIDOMULYO, PENGASIH, KULON PROGO, DAERAH ISTIMEWA YOGYAKARTA",15,173,51,224
https://kawalpemilu.org#41933,"SIDOMULYO, PENGASIH, KULON PROGO, DAERAH ISTIMEWA YOGYAKARTA",16,143,85,228
https://kawalpemilu.org#41935,"HARGOMULYO, KOKAP, KULON PROGO, DAERAH ISTIMEWA YOGYAKARTA",1,0,0,0
https://kawalpemilu.org#41935,"HARGOMULYO, KOKAP, KULON PROGO, DAERAH ISTIMEWA YOGYAKARTA",2,166,71,237
https://kawalpemilu.org#41935,"HARGOMULYO, KOKAP, KULON PROGO, DAERAH ISTIMEWA YOGYAKARTA",3,152,96,248
https://kawalpemilu.org#41935,"HARGOMULYO, KOKAP, KULON PROGO, DAERAH ISTIMEWA YOGYAKARTA",4,154,58,212
https://kawalpemilu.org#41935,"HARGOMULYO, KOKAP, KULON PROGO, DAERAH ISTIMEWA YOGYAKARTA",5,167,43,210
https://kawalpemilu.org#41935,"HARGOMULYO, KOKAP, KULON PROGO, DAERAH ISTIMEWA YOGYAKARTA",6,183,38,221
https://kawalpemilu.org#41935,"HARGOMULYO, KOKAP, KULON PROGO, DAERAH ISTIMEWA YOGYAKARTA",7,180,57,237
https://kawalpemilu.org#41935,"HARGOMULYO, KOKAP, KULON PROGO, DAERAH ISTIMEWA YOGYAKARTA",8,187,28,215
https://kawalpemilu.org#41935,"HARGOMULYO, KOKAP, KULON PROGO, DAERAH ISTIMEWA YOGYAKARTA",9,203,26,229
https://kawalpemilu.org#41935,"HARGOMULYO, KOKAP, KULON PROGO, DAERAH ISTIMEWA YOGYAKARTA",10,162,56,218
https://kawalpemilu.org#41935,"HARGOMULYO, KOKAP, KULON PROGO, DAERAH ISTIMEWA YOGYAKARTA",11,154,62,216
https://kawalpemilu.org#41935,"HARGOMULYO, KOKAP, KULON PROGO, DAERAH ISTIMEWA YOGYAKARTA",12,141,108,249
https://kawalpemilu.org#41935,"HARGOMULYO, KOKAP, KULON PROGO, DAERAH ISTIMEWA YOGYAKARTA",13,166,55,221
https://kawalpemilu.org#41935,"HARGOMULYO, KOKAP, KULON PROGO, DAERAH ISTIMEWA YOGYAKARTA",14,162,41,203
https://kawalpemilu.org#41935,"HARGOMULYO, KOKAP, KULON PROGO, DAERAH ISTIMEWA YOGYAKARTA",15,176,78,254
https://kawalpemilu.org#41935,"HARGOMULYO, KOKAP, KULON PROGO, DAERAH ISTIMEWA YOGYAKARTA",16,165,79,244
https://kawalpemilu.org#41935,"HARGOMULYO, KOKAP, KULON PROGO, DAERAH ISTIMEWA YOGYAKARTA",17,197,31,228
https://kawalpemilu.org#41935,"HARGOMULYO, KOKAP, KULON PROGO, DAERAH ISTIMEWA YOGYAKARTA",18,194,35,229
https://kawalpemilu.org#41935,"HARGOMULYO, KOKAP, KULON PROGO, DAERAH ISTIMEWA YOGYAKARTA",19,195,29,224
https://kawalpemilu.org#41935,"HARGOMULYO, KOKAP, KULON PROGO, DAERAH ISTIMEWA YOGYAKARTA",20,196,27,223
https://kawalpemilu.org#41935,"HARGOMULYO, KOKAP, KULON PROGO, DAERAH ISTIMEWA YOGYAKARTA",21,167,54,221
https://kawalpemilu.org#41935,"HARGOMULYO, KOKAP, KULON PROGO, DAERAH ISTIMEWA YOGYAKARTA",22,158,64,222
https://kawalpemilu.org#41936,"HARGOREJO, KOKAP, KULON PROGO, DAERAH ISTIMEWA YOGYAKARTA",1,174,30,204
https://kawalpemilu.org#41936,"HARGOREJO, KOKAP, KULON PROGO, DAERAH ISTIMEWA YOGYAKARTA",2,150,39,189
https://kawalpemilu.org#41936,"HARGOREJO, KOKAP, KULON PROGO, DAERAH ISTIMEWA YOGYAKARTA",3,166,35,201
https://kawalpemilu.org#41936,"HARGOREJO, KOKAP, KULON PROGO, DAERAH ISTIMEWA YOGYAKARTA",4,123,95,218
https://kawalpemilu.org#41936,"HARGOREJO, KOKAP, KULON PROGO, DAERAH ISTIMEWA YOGYAKARTA",5,134,86,220
https://kawalpemilu.org#41936,"HARGOREJO, KOKAP, KULON PROGO, DAERAH ISTIMEWA YOGYAKARTA",6,131,98,229
https://kawalpemilu.org#41936,"HARGOREJO, KOKAP, KULON PROGO, DAERAH ISTIMEWA YOGYAKARTA",7,146,108,254
https://kawalpemilu.org#41936,"HARGOREJO, KOKAP, KULON PROGO, DAERAH ISTIMEWA YOGYAKARTA",8,185,50,243
https://kawalpemilu.org#41936,"HARGOREJO, KOKAP, KULON PROGO, DAERAH ISTIMEWA YOGYAKARTA",9,157,56,213
https://kawalpemilu.org#41936,"HARGOREJO, KOKAP, KULON PROGO, DAERAH ISTIMEWA YOGYAKARTA",10,186,16,202
https://kawalpemilu.org#41936,"HARGOREJO, KOKAP, KULON PROGO, DAERAH ISTIMEWA YOGYAKARTA",11,150,109,259
https://kawalpemilu.org#41936,"HARGOREJO, KOKAP, KULON PROGO, DAERAH ISTIMEWA YOGYAKARTA",12,135,105,240
https://kawalpemilu.org#41936,"HARGOREJO, KOKAP, KULON PROGO, DAERAH ISTIMEWA YOGYAKARTA",13,154,60,214
https://kawalpemilu.org#41936,"HARGOREJO, KOKAP, KULON PROGO, DAERAH ISTIMEWA YOGYAKARTA",14,153,85,238
https://kawalpemilu.org#41936,"HARGOREJO, KOKAP, KULON PROGO, DAERAH ISTIMEWA YOGYAKARTA",15,200,55,255
https://kawalpemilu.org#41936,"HARGOREJO, KOKAP, KULON PROGO, DAERAH ISTIMEWA YOGYAKARTA",16,140,23,163
https://kawalpemilu.org#41936,"HARGOREJO, KOKAP, KULON PROGO, DAERAH ISTIMEWA YOGYAKARTA",17,179,69,248
https://kawalpemilu.org#41936,"HARGOREJO, KOKAP, KULON PROGO, DAERAH ISTIMEWA YOGYAKARTA",18,153,87,240
https://kawalpemilu.org#41936,"HARGOREJO, KOKAP, KULON PROGO, DAERAH ISTIMEWA YOGYAKARTA",19,204,41,245
https://kawalpemilu.org#41936,"HARGOREJO, KOKAP, KULON PROGO, DAERAH ISTIMEWA YOGYAKARTA",20,193,31,224
https://kawalpemilu.org#41936,"HARGOREJO, KOKAP, KULON PROGO, DAERAH ISTIMEWA YOGYAKARTA",21,158,42,200
https://kawalpemilu.org#41936,"HARGOREJO, KOKAP, KULON PROGO, DAERAH ISTIMEWA YOGYAKARTA",22,182,41,223
https://kawalpemilu.org#41936,"HARGOREJO, KOKAP, KULON PROGO, DAERAH ISTIMEWA YOGYAKARTA",23,173,46,219
https://kawalpemilu.org#41936,"HARGOREJO, KOKAP, KULON PROGO, DAERAH ISTIMEWA YOGYAKARTA",24,168,47,215
https://kawalpemilu.org#41936,"HARGOREJO, KOKAP, KULON PROGO, DAERAH ISTIMEWA YOGYAKARTA",25,187,28,215
https://kawalpemilu.org#41936,"HARGOREJO, KOKAP, KULON PROGO, DAERAH ISTIMEWA YOGYAKARTA",26,196,44,240
https://kawalpemilu.org#41936,"HARGOREJO, KOKAP, KULON PROGO, DAERAH ISTIMEWA YOGYAKARTA",27,151,69,220
https://kawalpemilu.org#41936,"HARGOREJO, KOKAP, KULON PROGO, DAERAH ISTIMEWA YOGYAKARTA",28,169,34,203
https://kawalpemilu.org#41937,"HARGOWILIS, KOKAP, KULON PROGO, DAERAH ISTIMEWA YOGYAKARTA",1,199,34,233
https://kawalpemilu.org#41937,"HARGOWILIS, KOKAP, KULON PROGO, DAERAH ISTIMEWA YOGYAKARTA",2,171,35,206
https://kawalpemilu.org#41937,"HARGOWILIS, KOKAP, KULON PROGO, DAERAH ISTIMEWA YOGYAKARTA",3,194,36,230
https://kawalpemilu.org#41937,"HARGOWILIS, KOKAP, KULON PROGO, DAERAH ISTIMEWA YOGYAKARTA",4,196,29,225
https://kawalpemilu.org#41937,"HARGOWILIS, KOKAP, KULON PROGO, DAERAH ISTIMEWA YOGYAKARTA",5,172,85,257
https://kawalpemilu.org#41937,"HARGOWILIS, KOKAP, KULON PROGO, DAERAH ISTIMEWA YOGYAKARTA",6,177,38,215
https://kawalpemilu.org#41937,"HARGOWILIS, KOKAP, KULON PROGO, DAERAH ISTIMEWA YOGYAKARTA",7,183,42,225
https://kawalpemilu.org#41937,"HARGOWILIS, KOKAP, KULON PROGO, DAERAH ISTIMEWA YOGYAKARTA",8,166,56,222
https://kawalpemilu.org#41937,"HARGOWILIS, KOKAP, KULON PROGO, DAERAH ISTIMEWA YOGYAKARTA",9,146,93,239
https://kawalpemilu.org#41937,"HARGOWILIS, KOKAP, KULON PROGO, DAERAH ISTIMEWA YOGYAKARTA",10,167,61,228
https://kawalpemilu.org#41937,"HARGOWILIS, KOKAP, KULON PROGO, DAERAH ISTIMEWA YOGYAKARTA",11,152,74,226
https://kawalpemilu.org#41937,"HARGOWILIS, KOKAP, KULON PROGO, DAERAH ISTIMEWA YOGYAKARTA",12,171,90,261
https://kawalpemilu.org#41937,"HARGOWILIS, KOKAP, KULON PROGO, DAERAH ISTIMEWA YOGYAKARTA",13,157,105,262
https://kawalpemilu.org#41937,"HARGOWILIS, KOKAP, KULON PROGO, DAERAH ISTIMEWA YOGYAKARTA",14,144,98,242
https://kawalpemilu.org#41937,"HARGOWILIS, KOKAP, KULON PROGO, DAERAH ISTIMEWA YOGYAKARTA",15,145,57,202
https://kawalpemilu.org#41937,"HARGOWILIS, KOKAP, KULON PROGO, DAERAH ISTIMEWA YOGYAKARTA",16,128,41,169
https://kawalpemilu.org#41937,"HARGOWILIS, KOKAP, KULON PROGO, DAERAH ISTIMEWA YOGYAKARTA",17,160,51,211
https://kawalpemilu.org#41937,"HARGOWILIS, KOKAP, KULON PROGO, DAERAH ISTIMEWA YOGYAKARTA",18,121,93,214
https://kawalpemilu.org#41937,"HARGOWILIS, KOKAP, KULON PROGO, DAERAH ISTIMEWA YOGYAKARTA",19,193,28,221
https://kawalpemilu.org#41938,"KALIREJO, KOKAP, KULON PROGO, DAERAH ISTIMEWA YOGYAKARTA",1,205,35,240
https://kawalpemilu.org#41938,"KALIREJO, KOKAP, KULON PROGO, DAERAH ISTIMEWA YOGYAKARTA",2,166,33,199
https://kawalpemilu.org#41938,"KALIREJO, KOKAP, KULON PROGO, DAERAH ISTIMEWA YOGYAKARTA",3,177,29,206
https://kawalpemilu.org#41938,"KALIREJO, KOKAP, KULON PROGO, DAERAH ISTIMEWA YOGYAKARTA",4,188,25,213
https://kawalpemilu.org#41938,"KALIREJO, KOKAP, KULON PROGO, DAERAH ISTIMEWA YOGYAKARTA",5,184,40,224
https://kawalpemilu.org#41938,"KALIREJO, KOKAP, KULON PROGO, DAERAH ISTIMEWA YOGYAKARTA",6,176,26,202
https://kawalpemilu.org#41938,"KALIREJO, KOKAP, KULON PROGO, DAERAH ISTIMEWA YOGYAKARTA",7,140,15,155
https://kawalpemilu.org#41938,"KALIREJO, KOKAP, KULON PROGO, DAERAH ISTIMEWA YOGYAKARTA",8,177,25,202
https://kawalpemilu.org#41938,"KALIREJO, KOKAP, KULON PROGO, DAERAH ISTIMEWA YOGYAKARTA",9,175,40,215
https://kawalpemilu.org#41938,"KALIREJO, KOKAP, KULON PROGO, DAERAH ISTIMEWA YOGYAKARTA",10,189,10,199
https://kawalpemilu.org#41938,"KALIREJO, KOKAP, KULON PROGO, DAERAH ISTIMEWA YOGYAKARTA",11,157,15,172
https://kawalpemilu.org#41938,"KALIREJO, KOKAP, KULON PROGO, DAERAH ISTIMEWA YOGYAKARTA",12,166,24,190
https://kawalpemilu.org#41938,"KALIREJO, KOKAP, KULON PROGO, DAERAH ISTIMEWA YOGYAKARTA",13,133,36,169
https://kawalpemilu.org#41938,"KALIREJO, KOKAP, KULON PROGO, DAERAH ISTIMEWA YOGYAKARTA",14,184,30,214
https://kawalpemilu.org#41938,"KALIREJO, KOKAP, KULON PROGO, DAERAH ISTIMEWA YOGYAKARTA",15,184,21,205
https://kawalpemilu.org#41939,"HARGOTIRTO, KOKAP, KULON PROGO, DAERAH ISTIMEWA YOGYAKARTA",1,153,62,215
https://kawalpemilu.org#41939,"HARGOTIRTO, KOKAP, KULON PROGO, DAERAH ISTIMEWA YOGYAKARTA",2,187,14,201
https://kawalpemilu.org#41939,"HARGOTIRTO, KOKAP, KULON PROGO, DAERAH ISTIMEWA YOGYAKARTA",3,126,55,181
https://kawalpemilu.org#41939,"HARGOTIRTO, KOKAP, KULON PROGO, DAERAH ISTIMEWA YOGYAKARTA",4,146,58,204
https://kawalpemilu.org#41939,"HARGOTIRTO, KOKAP, KULON PROGO, DAERAH ISTIMEWA YOGYAKARTA",5,133,70,203
https://kawalpemilu.org#41939,"HARGOTIRTO, KOKAP, KULON PROGO, DAERAH ISTIMEWA YOGYAKARTA",6,179,48,227
https://kawalpemilu.org#41939,"HARGOTIRTO, KOKAP, KULON PROGO, DAERAH ISTIMEWA YOGYAKARTA",7,172,13,185
https://kawalpemilu.org#41939,"HARGOTIRTO, KOKAP, KULON PROGO, DAERAH ISTIMEWA YOGYAKARTA",8,165,64,229
https://kawalpemilu.org#41939,"HARGOTIRTO, KOKAP, KULON PROGO, DAERAH ISTIMEWA YOGYAKARTA",9,163,51,214
https://kawalpemilu.org#41939,"HARGOTIRTO, KOKAP, KULON PROGO, DAERAH ISTIMEWA YOGYAKARTA",10,152,50,202
https://kawalpemilu.org#41939,"HARGOTIRTO, KOKAP, KULON PROGO, DAERAH ISTIMEWA YOGYAKARTA",11,178,32,210
https://kawalpemilu.org#41939,"HARGOTIRTO, KOKAP, KULON PROGO, DAERAH ISTIMEWA YOGYAKARTA",12,160,53,213
https://kawalpemilu.org#41939,"HARGOTIRTO, KOKAP, KULON PROGO, DAERAH ISTIMEWA YOGYAKARTA",13,171,58,229
https://kawalpemilu.org#41939,"HARGOTIRTO, KOKAP, KULON PROGO, DAERAH ISTIMEWA YOGYAKARTA",14,165,61,226
https://kawalpemilu.org#41939,"HARGOTIRTO, KOKAP, KULON PROGO, DAERAH ISTIMEWA YOGYAKARTA",15,209,42,251
https://kawalpemilu.org#41939,"HARGOTIRTO, KOKAP, KULON PROGO, DAERAH ISTIMEWA YOGYAKARTA",16,165,46,211
https://kawalpemilu.org#41939,"HARGOTIRTO, KOKAP, KULON PROGO, DAERAH ISTIMEWA YOGYAKARTA",17,128,86,214
https://kawalpemilu.org#41939,"HARGOTIRTO, KOKAP, KULON PROGO, DAERAH ISTIMEWA YOGYAKARTA",18,185,36,221
https://kawalpemilu.org#41939,"HARGOTIRTO, KOKAP, KULON PROGO, DAERAH ISTIMEWA YOGYAKARTA",19,208,32,240
https://kawalpemilu.org#41939,"HARGOTIRTO, KOKAP, KULON PROGO, DAERAH ISTIMEWA YOGYAKARTA",20,173,38,211
https://kawalpemilu.org#41939,"HARGOTIRTO, KOKAP, KULON PROGO, DAERAH ISTIMEWA YOGYAKARTA",21,121,85,206
https://kawalpemilu.org#41939,"HARGOTIRTO, KOKAP, KULON PROGO, DAERAH ISTIMEWA YOGYAKARTA",22,186,38,224
https://kawalpemilu.org#41941,"JATIMULYO, GIRIMULYO, KULON PROGO, DAERAH ISTIMEWA YOGYAKARTA",1,185,57,242
https://kawalpemilu.org#41941,"JATIMULYO, GIRIMULYO, KULON PROGO, DAERAH ISTIMEWA YOGYAKARTA",2,175,70,245
https://kawalpemilu.org#41941,"JATIMULYO, GIRIMULYO, KULON PROGO, DAERAH ISTIMEWA YOGYAKARTA",3,188,35,223
https://kawalpemilu.org#41941,"JATIMULYO, GIRIMULYO, KULON PROGO, DAERAH ISTIMEWA YOGYAKARTA",4,144,46,190
https://kawalpemilu.org#41941,"JATIMULYO, GIRIMULYO, KULON PROGO, DAERAH ISTIMEWA YOGYAKARTA",5,164,35,199
https://kawalpemilu.org#41941,"JATIMULYO, GIRIMULYO, KULON PROGO, DAERAH ISTIMEWA YOGYAKARTA",6,183,38,221
https://kawalpemilu.org#41941,"JATIMULYO, GIRIMULYO, KULON PROGO, DAERAH ISTIMEWA YOGYAKARTA",7,195,27,222
https://kawalpemilu.org#41941,"JATIMULYO, GIRIMULYO, KULON PROGO, DAERAH ISTIMEWA YOGYAKARTA",8,184,36,220
https://kawalpemilu.org#41941,"JATIMULYO, GIRIMULYO, KULON PROGO, DAERAH ISTIMEWA YOGYAKARTA",9,190,37,227
https://kawalpemilu.org#41941,"JATIMULYO, GIRIMULYO, KULON PROGO, DAERAH ISTIMEWA YOGYAKARTA",10,160,60,220
https://kawalpemilu.org#41941,"JATIMULYO, GIRIMULYO, KULON PROGO, DAERAH ISTIMEWA YOGYAKARTA",11,133,35,168
https://kawalpemilu.org#41941,"JATIMULYO, GIRIMULYO, KULON PROGO, DAERAH ISTIMEWA YOGYAKARTA",12,178,28,206
https://kawalpemilu.org#41941,"JATIMULYO, GIRIMULYO, KULON PROGO, DAERAH ISTIMEWA YOGYAKARTA",13,132,18,150
https://kawalpemilu.org#41941,"JATIMULYO, GIRIMULYO, KULON PROGO, DAERAH ISTIMEWA YOGYAKARTA",14,119,16,135
https://kawalpemilu.org#41941,"JATIMULYO, GIRIMULYO, KULON PROGO, DAERAH ISTIMEWA YOGYAKARTA",15,205,37,242
https://kawalpemilu.org#41941,"JATIMULYO, GIRIMULYO, KULON PROGO, DAERAH ISTIMEWA YOGYAKARTA",16,156,80,236
https://kawalpemilu.org#41941,"JATIMULYO, GIRIMULYO, KULON PROGO, DAERAH ISTIMEWA YOGYAKARTA",17,196,13,209
https://kawalpemilu.org#41941,"JATIMULYO, GIRIMULYO, KULON PROGO, DAERAH ISTIMEWA YOGYAKARTA",18,156,87,243
https://kawalpemilu.org#41941,"JATIMULYO, GIRIMULYO, KULON PROGO, DAERAH ISTIMEWA YOGYAKARTA",19,203,56,259
https://kawalpemilu.org#41941,"JATIMULYO, GIRIMULYO, KULON PROGO, DAERAH ISTIMEWA YOGYAKARTA",20,60,92,152
https://kawalpemilu.org#41941,"JATIMULYO, GIRIMULYO, KULON PROGO, DAERAH ISTIMEWA YOGYAKARTA",21,52,108,160
https://kawalpemilu.org#41941,"JATIMULYO, GIRIMULYO, KULON PROGO, DAERAH ISTIMEWA YOGYAKARTA",22,112,110,222
https://kawalpemilu.org#41941,"JATIMULYO, GIRIMULYO, KULON PROGO, DAERAH ISTIMEWA YOGYAKARTA",23,140,46,186
https://kawalpemilu.org#41942,"GIRIPURWO, GIRIMULYO, KULON PROGO, DAERAH ISTIMEWA YOGYAKARTA",1,139,104,243
https://kawalpemilu.org#41942,"GIRIPURWO, GIRIMULYO, KULON PROGO, DAERAH ISTIMEWA YOGYAKARTA",2,159,56,215
https://kawalpemilu.org#41942,"GIRIPURWO, GIRIMULYO, KULON PROGO, DAERAH ISTIMEWA YOGYAKARTA",3,212,43,255
https://kawalpemilu.org#41942,"GIRIPURWO, GIRIMULYO, KULON PROGO, DAERAH ISTIMEWA YOGYAKARTA",4,183,79,262
https://kawalpemilu.org#41942,"GIRIPURWO, GIRIMULYO, KULON PROGO, DAERAH ISTIMEWA YOGYAKARTA",5,153,65,218
https://kawalpemilu.org#41942,"GIRIPURWO, GIRIMULYO, KULON PROGO, DAERAH ISTIMEWA YOGYAKARTA",6,65,41,106
https://kawalpemilu.org#41942,"GIRIPURWO, GIRIMULYO, KULON PROGO, DAERAH ISTIMEWA YOGYAKARTA",7,128,67,195
https://kawalpemilu.org#41942,"GIRIPURWO, GIRIMULYO, KULON PROGO, DAERAH ISTIMEWA YOGYAKARTA",8,124,48,172
https://kawalpemilu.org#41942,"GIRIPURWO, GIRIMULYO, KULON PROGO, DAERAH ISTIMEWA YOGYAKARTA",9,149,34,183
https://kawalpemilu.org#41942,"GIRIPURWO, GIRIMULYO, KULON PROGO, DAERAH ISTIMEWA YOGYAKARTA",10,149,98,247
https://kawalpemilu.org#41942,"GIRIPURWO, GIRIMULYO, KULON PROGO, DAERAH ISTIMEWA YOGYAKARTA",11,195,41,236
https://kawalpemilu.org#41942,"GIRIPURWO, GIRIMULYO, KULON PROGO, DAERAH ISTIMEWA YOGYAKARTA",12,152,33,185
https://kawalpemilu.org#41942,"GIRIPURWO, GIRIMULYO, KULON PROGO, DAERAH ISTIMEWA YOGYAKARTA",13,147,25,172
https://kawalpemilu.org#41942,"GIRIPURWO, GIRIMULYO, KULON PROGO, DAERAH ISTIMEWA YOGYAKARTA",14,112,23,135
https://kawalpemilu.org#41942,"GIRIPURWO, GIRIMULYO, KULON PROGO, DAERAH ISTIMEWA YOGYAKARTA",15,162,35,197
https://kawalpemilu.org#41942,"GIRIPURWO, GIRIMULYO, KULON PROGO, DAERAH ISTIMEWA YOGYAKARTA",16,118,71,189
https://kawalpemilu.org#41942,"GIRIPURWO, GIRIMULYO, KULON PROGO, DAERAH ISTIMEWA YOGYAKARTA",17,101,64,165
https://kawalpemilu.org#41942,"GIRIPURWO, GIRIMULYO, KULON PROGO, DAERAH ISTIMEWA YOGYAKARTA",18,150,67,217
https://kawalpemilu.org#41942,"GIRIPURWO, GIRIMULYO, KULON PROGO, DAERAH ISTIMEWA YOGYAKARTA",19,158,56,214
https://kawalpemilu.org#41942,"GIRIPURWO, GIRIMULYO, KULON PROGO, DAERAH ISTIMEWA YOGYAKARTA",20,147,78,225
https://kawalpemilu.org#41942,"GIRIPURWO, GIRIMULYO, KULON PROGO, DAERAH ISTIMEWA YOGYAKARTA",21,185,31,216
https://kawalpemilu.org#41942,"GIRIPURWO, GIRIMULYO, KULON PROGO, DAERAH ISTIMEWA YOGYAKARTA",23,166,40,206
https://kawalpemilu.org#41943,"PENDOWOREJO, GIRIMULYO, KULON PROGO, DAERAH ISTIMEWA YOGYAKARTA",1,122,41,163
https://kawalpemilu.org#41943,"PENDOWOREJO, GIRIMULYO, KULON PROGO, DAERAH ISTIMEWA YOGYAKARTA",2,117,79,196
https://kawalpemilu.org#41943,"PENDOWOREJO, GIRIMULYO, KULON PROGO, DAERAH ISTIMEWA YOGYAKARTA",3,84,41,125
https://kawalpemilu.org#41943,"PENDOWOREJO, GIRIMULYO, KULON PROGO, DAERAH ISTIMEWA YOGYAKARTA",4,95,4,99
https://kawalpemilu.org#41943,"PENDOWOREJO, GIRIMULYO, KULON PROGO, DAERAH ISTIMEWA YOGYAKARTA",5,103,34,137
https://kawalpemilu.org#41943,"PENDOWOREJO, GIRIMULYO, KULON PROGO, DAERAH ISTIMEWA YOGYAKARTA",6,109,74,183
https://kawalpemilu.org#41943,"PENDOWOREJO, GIRIMULYO, KULON PROGO, DAERAH ISTIMEWA YOGYAKARTA",7,65,69,134
https://kawalpemilu.org#41943,"PENDOWOREJO, GIRIMULYO, KULON PROGO, DAERAH ISTIMEWA YOGYAKARTA",8,109,94,203
https://kawalpemilu.org#41943,"PENDOWOREJO, GIRIMULYO, KULON PROGO, DAERAH ISTIMEWA YOGYAKARTA",9,184,73,257
https://kawalpemilu.org#41943,"PENDOWOREJO, GIRIMULYO, KULON PROGO, DAERAH ISTIMEWA YOGYAKARTA",10,101,39,140
https://kawalpemilu.org#41943,"PENDOWOREJO, GIRIMULYO, KULON PROGO, DAERAH ISTIMEWA YOGYAKARTA",11,111,35,146
https://kawalpemilu.org#41943,"PENDOWOREJO, GIRIMULYO, KULON PROGO, DAERAH ISTIMEWA YOGYAKARTA",12,142,38,180
https://kawalpemilu.org#41943,"PENDOWOREJO, GIRIMULYO, KULON PROGO, DAERAH ISTIMEWA YOGYAKARTA",13,126,15,141
https://kawalpemilu.org#41943,"PENDOWOREJO, GIRIMULYO, KULON PROGO, DAERAH ISTIMEWA YOGYAKARTA",14,128,23,151
https://kawalpemilu.org#41943,"PENDOWOREJO, GIRIMULYO, KULON PROGO, DAERAH ISTIMEWA YOGYAKARTA",15,176,28,204
https://kawalpemilu.org#41943,"PENDOWOREJO, GIRIMULYO, KULON PROGO, DAERAH ISTIMEWA YOGYAKARTA",16,134,37,171
https://kawalpemilu.org#41943,"PENDOWOREJO, GIRIMULYO, KULON PROGO, DAERAH ISTIMEWA YOGYAKARTA",17,121,24,145
https://kawalpemilu.org#41943,"PENDOWOREJO, GIRIMULYO, KULON PROGO, DAERAH ISTIMEWA YOGYAKARTA",18,110,23,133
https://kawalpemilu.org#41943,"PENDOWOREJO, GIRIMULYO, KULON PROGO, DAERAH ISTIMEWA YOGYAKARTA",19,123,32,155
https://kawalpemilu.org#41943,"PENDOWOREJO, GIRIMULYO, KULON PROGO, DAERAH ISTIMEWA YOGYAKARTA",20,156,40,196
https://kawalpemilu.org#41943,"PENDOWOREJO, GIRIMULYO, KULON PROGO, DAERAH ISTIMEWA YOGYAKARTA",21,107,113,220
https://kawalpemilu.org#41943,"PENDOWOREJO, GIRIMULYO, KULON PROGO, DAERAH ISTIMEWA YOGYAKARTA",22,178,43,221
https://kawalpemilu.org#41944,"PURWOSARI, GIRIMULYO, KULON PROGO, DAERAH ISTIMEWA YOGYAKARTA",1,117,27,144
https://kawalpemilu.org#41944,"PURWOSARI, GIRIMULYO, KULON PROGO, DAERAH ISTIMEWA YOGYAKARTA",2,132,19,151
https://kawalpemilu.org#41944,"PURWOSARI, GIRIMULYO, KULON PROGO, DAERAH ISTIMEWA YOGYAKARTA",3,181,62,243
https://kawalpemilu.org#41944,"PURWOSARI, GIRIMULYO, KULON PROGO, DAERAH ISTIMEWA YOGYAKARTA",4,157,49,206
https://kawalpemilu.org#41944,"PURWOSARI, GIRIMULYO, KULON PROGO, DAERAH ISTIMEWA YOGYAKARTA",5,194,42,236
https://kawalpemilu.org#41944,"PURWOSARI, GIRIMULYO, KULON PROGO, DAERAH ISTIMEWA YOGYAKARTA",6,248,8,256
https://kawalpemilu.org#41944,"PURWOSARI, GIRIMULYO, KULON PROGO, DAERAH ISTIMEWA YOGYAKARTA",7,99,39,138
https://kawalpemilu.org#41944,"PURWOSARI, GIRIMULYO, KULON PROGO, DAERAH ISTIMEWA YOGYAKARTA",8,102,53,155
https://kawalpemilu.org#41944,"PURWOSARI, GIRIMULYO, KULON PROGO, DAERAH ISTIMEWA YOGYAKARTA",9,150,48,198
https://kawalpemilu.org#41944,"PURWOSARI, GIRIMULYO, KULON PROGO, DAERAH ISTIMEWA YOGYAKARTA",10,156,46,202
https://kawalpemilu.org#41944,"PURWOSARI, GIRIMULYO, KULON PROGO, DAERAH ISTIMEWA YOGYAKARTA",11,150,77,227
https://kawalpemilu.org#41944,"PURWOSARI, GIRIMULYO, KULON PROGO, DAERAH ISTIMEWA YOGYAKARTA",12,130,29,159
https://kawalpemilu.org#41944,"PURWOSARI, GIRIMULYO, KULON PROGO, DAERAH ISTIMEWA YOGYAKARTA",13,124,35,159
https://kawalpemilu.org#41944,"PURWOSARI, GIRIMULYO, KULON PROGO, DAERAH ISTIMEWA YOGYAKARTA",14,60,53,113
https://kawalpemilu.org#41944,"PURWOSARI, GIRIMULYO, KULON PROGO, DAERAH ISTIMEWA YOGYAKARTA",15,136,44,180
https://kawalpemilu.org#41944,"PURWOSARI, GIRIMULYO, KULON PROGO, DAERAH ISTIMEWA YOGYAKARTA",16,180,45,225
https://kawalpemilu.org#41944,"PURWOSARI, GIRIMULYO, KULON PROGO, DAERAH ISTIMEWA YOGYAKARTA",17,165,42,207
https://kawalpemilu.org#41946,"BANYUROTO, NANGGULAN, KULON PROGO, DAERAH ISTIMEWA YOGYAKARTA",1,91,140,231
https://kawalpemilu.org#41946,"BANYUROTO, NANGGULAN, KULON PROGO, DAERAH ISTIMEWA YOGYAKARTA",2,140,99,239
https://kawalpemilu.org#41946,"BANYUROTO, NANGGULAN, KULON PROGO, DAERAH ISTIMEWA YOGYAKARTA",3,173,65,238
https://kawalpemilu.org#41946,"BANYUROTO, NANGGULAN, KULON PROGO, DAERAH ISTIMEWA YOGYAKARTA",4,0,0,0
https://kawalpemilu.org#41946,"BANYUROTO, NANGGULAN, KULON PROGO, DAERAH ISTIMEWA YOGYAKARTA",5,152,96,248
https://kawalpemilu.org#41946,"BANYUROTO, NANGGULAN, KULON PROGO, DAERAH ISTIMEWA YOGYAKARTA",6,176,51,227
https://kawalpemilu.org#41946,"BANYUROTO, NANGGULAN, KULON PROGO, DAERAH ISTIMEWA YOGYAKARTA",7,171,61,232
https://kawalpemilu.org#41946,"BANYUROTO, NANGGULAN, KULON PROGO, DAERAH ISTIMEWA YOGYAKARTA",8,181,51,232
https://kawalpemilu.org#41946,"BANYUROTO, NANGGULAN, KULON PROGO, DAERAH ISTIMEWA YOGYAKARTA",9,151,74,225
https://kawalpemilu.org#41946,"BANYUROTO, NANGGULAN, KULON PROGO, DAERAH ISTIMEWA YOGYAKARTA",10,206,26,232
https://kawalpemilu.org#41946,"BANYUROTO, NANGGULAN, KULON PROGO, DAERAH ISTIMEWA YOGYAKARTA",11,166,73,239
https://kawalpemilu.org#41947,"DONOMULYO, NANGGULAN, KULON PROGO, DAERAH ISTIMEWA YOGYAKARTA",1,199,47,246
https://kawalpemilu.org#41947,"DONOMULYO, NANGGULAN, KULON PROGO, DAERAH ISTIMEWA YOGYAKARTA",2,184,74,258
https://kawalpemilu.org#41947,"DONOMULYO, NANGGULAN, KULON PROGO, DAERAH ISTIMEWA YOGYAKARTA",3,140,84,224
https://kawalpemilu.org#41947,"DONOMULYO, NANGGULAN, KULON PROGO, DAERAH ISTIMEWA YOGYAKARTA",4,188,44,232
https://kawalpemilu.org#41947,"DONOMULYO, NANGGULAN, KULON PROGO, DAERAH ISTIMEWA YOGYAKARTA",5,155,98,253
https://kawalpemilu.org#41947,"DONOMULYO, NANGGULAN, KULON PROGO, DAERAH ISTIMEWA YOGYAKARTA",6,132,98,230
https://kawalpemilu.org#41947,"DONOMULYO, NANGGULAN, KULON PROGO, DAERAH ISTIMEWA YOGYAKARTA",7,153,63,216
https://kawalpemilu.org#41947,"DONOMULYO, NANGGULAN, KULON PROGO, DAERAH ISTIMEWA YOGYAKARTA",8,145,98,243
https://kawalpemilu.org#41947,"DONOMULYO, NANGGULAN, KULON PROGO, DAERAH ISTIMEWA YOGYAKARTA",9,167,86,253
https://kawalpemilu.org#41947,"DONOMULYO, NANGGULAN, KULON PROGO, DAERAH ISTIMEWA YOGYAKARTA",10,210,29,239
https://kawalpemilu.org#41947,"DONOMULYO, NANGGULAN, KULON PROGO, DAERAH ISTIMEWA YOGYAKARTA",11,140,87,227
https://kawalpemilu.org#41947,"DONOMULYO, NANGGULAN, KULON PROGO, DAERAH ISTIMEWA YOGYAKARTA",12,204,42,246
https://kawalpemilu.org#41947,"DONOMULYO, NANGGULAN, KULON PROGO, DAERAH ISTIMEWA YOGYAKARTA",13,204,29,233
https://kawalpemilu.org#41947,"DONOMULYO, NANGGULAN, KULON PROGO, DAERAH ISTIMEWA YOGYAKARTA",14,174,47,221
https://kawalpemilu.org#41947,"DONOMULYO, NANGGULAN, KULON PROGO, DAERAH ISTIMEWA YOGYAKARTA",15,172,67,239
https://kawalpemilu.org#41947,"DONOMULYO, NANGGULAN, KULON PROGO, DAERAH ISTIMEWA YOGYAKARTA",16,192,40,232
https://kawalpemilu.org#41947,"DONOMULYO, NANGGULAN, KULON PROGO, DAERAH ISTIMEWA YOGYAKARTA",17,182,45,227
https://kawalpemilu.org#41947,"DONOMULYO, NANGGULAN, KULON PROGO, DAERAH ISTIMEWA YOGYAKARTA",18,186,56,242
https://kawalpemilu.org#41948,"WIJIMULYO, NANGGULAN, KULON PROGO, DAERAH ISTIMEWA YOGYAKARTA",1,159,98,257
https://kawalpemilu.org#41948,"WIJIMULYO, NANGGULAN, KULON PROGO, DAERAH ISTIMEWA YOGYAKARTA",2,81,172,253
https://kawalpemilu.org#41948,"WIJIMULYO, NANGGULAN, KULON PROGO, DAERAH ISTIMEWA YOGYAKARTA",3,107,134,241
https://kawalpemilu.org#41948,"WIJIMULYO, NANGGULAN, KULON PROGO, DAERAH ISTIMEWA YOGYAKARTA",4,108,128,236
https://kawalpemilu.org#41948,"WIJIMULYO, NANGGULAN, KULON PROGO, DAERAH ISTIMEWA YOGYAKARTA",5,130,124,254
https://kawalpemilu.org#41948,"WIJIMULYO, NANGGULAN, KULON PROGO, DAERAH ISTIMEWA YOGYAKARTA",6,113,98,211
https://kawalpemilu.org#41948,"WIJIMULYO, NANGGULAN, KULON PROGO, DAERAH ISTIMEWA YOGYAKARTA",7,156,94,250
https://kawalpemilu.org#41948,"WIJIMULYO, NANGGULAN, KULON PROGO, DAERAH ISTIMEWA YOGYAKARTA",8,168,66,234
https://kawalpemilu.org#41948,"WIJIMULYO, NANGGULAN, KULON PROGO, DAERAH ISTIMEWA YOGYAKARTA",9,181,75,256
https://kawalpemilu.org#41948,"WIJIMULYO, NANGGULAN, KULON PROGO, DAERAH ISTIMEWA YOGYAKARTA",10,160,63,223
https://kawalpemilu.org#41948,"WIJIMULYO, NANGGULAN, KULON PROGO, DAERAH ISTIMEWA YOGYAKARTA",11,161,89,250
https://kawalpemilu.org#41948,"WIJIMULYO, NANGGULAN, KULON PROGO, DAERAH ISTIMEWA YOGYAKARTA",12,140,97,237
https://kawalpemilu.org#41948,"WIJIMULYO, NANGGULAN, KULON PROGO, DAERAH ISTIMEWA YOGYAKARTA",13,159,95,254
https://kawalpemilu.org#41948,"WIJIMULYO, NANGGULAN, KULON PROGO, DAERAH ISTIMEWA YOGYAKARTA",14,173,72,245
https://kawalpemilu.org#41948,"WIJIMULYO, NANGGULAN, KULON PROGO, DAERAH ISTIMEWA YOGYAKARTA",15,149,83,232
https://kawalpemilu.org#41949,"TANJUNGHARJO, NANGGULAN, KULON PROGO, DAERAH ISTIMEWA YOGYAKARTA",1,120,102,222
https://kawalpemilu.org#41949,"TANJUNGHARJO, NANGGULAN, KULON PROGO, DAERAH ISTIMEWA YOGYAKARTA",2,141,71,212
https://kawalpemilu.org#41949,"TANJUNGHARJO, NANGGULAN, KULON PROGO, DAERAH ISTIMEWA YOGYAKARTA",3,132,62,194
https://kawalpemilu.org#41949,"TANJUNGHARJO, NANGGULAN, KULON PROGO, DAERAH ISTIMEWA YOGYAKARTA",4,171,75,246
https://kawalpemilu.org#41949,"TANJUNGHARJO, NANGGULAN, KULON PROGO, DAERAH ISTIMEWA YOGYAKARTA",5,104,129,233
https://kawalpemilu.org#41949,"TANJUNGHARJO, NANGGULAN, KULON PROGO, DAERAH ISTIMEWA YOGYAKARTA",6,152,81,233
https://kawalpemilu.org#41949,"TANJUNGHARJO, NANGGULAN, KULON PROGO, DAERAH ISTIMEWA YOGYAKARTA",7,143,93,236
https://kawalpemilu.org#41949,"TANJUNGHARJO, NANGGULAN, KULON PROGO, DAERAH ISTIMEWA YOGYAKARTA",8,165,77,242
https://kawalpemilu.org#41949,"TANJUNGHARJO, NANGGULAN, KULON PROGO, DAERAH ISTIMEWA YOGYAKARTA",9,134,93,227
https://kawalpemilu.org#41949,"TANJUNGHARJO, NANGGULAN, KULON PROGO, DAERAH ISTIMEWA YOGYAKARTA",10,172,61,233
https://kawalpemilu.org#41949,"TANJUNGHARJO, NANGGULAN, KULON PROGO, DAERAH ISTIMEWA YOGYAKARTA",11,149,102,251
https://kawalpemilu.org#41949,"TANJUNGHARJO, NANGGULAN, KULON PROGO, DAERAH ISTIMEWA YOGYAKARTA",12,185,51,236
https://kawalpemilu.org#41949,"TANJUNGHARJO, NANGGULAN, KULON PROGO, DAERAH ISTIMEWA YOGYAKARTA",13,163,82,245
https://kawalpemilu.org#41950,"JATISARONO, NANGGULAN, KULON PROGO, DAERAH ISTIMEWA YOGYAKARTA",1,106,126,232
https://kawalpemilu.org#41950,"JATISARONO, NANGGULAN, KULON PROGO, DAERAH ISTIMEWA YOGYAKARTA",2,173,37,210
https://kawalpemilu.org#41950,"JATISARONO, NANGGULAN, KULON PROGO, DAERAH ISTIMEWA YOGYAKARTA",3,159,83,242
https://kawalpemilu.org#41950,"JATISARONO, NANGGULAN, KULON PROGO, DAERAH ISTIMEWA YOGYAKARTA",4,143,104,247
https://kawalpemilu.org#41950,"JATISARONO, NANGGULAN, KULON PROGO, DAERAH ISTIMEWA YOGYAKARTA",5,172,85,257
https://kawalpemilu.org#41950,"JATISARONO, NANGGULAN, KULON PROGO, DAERAH ISTIMEWA YOGYAKARTA",6,136,115,251
https://kawalpemilu.org#41950,"JATISARONO, NANGGULAN, KULON PROGO, DAERAH ISTIMEWA YOGYAKARTA",7,174,81,255
https://kawalpemilu.org#41950,"JATISARONO, NANGGULAN, KULON PROGO, DAERAH ISTIMEWA YOGYAKARTA",8,180,80,260
https://kawalpemilu.org#41950,"JATISARONO, NANGGULAN, KULON PROGO, DAERAH ISTIMEWA YOGYAKARTA",9,175,74,249
https://kawalpemilu.org#41950,"JATISARONO, NANGGULAN, KULON PROGO, DAERAH ISTIMEWA YOGYAKARTA",10,168,87,255
https://kawalpemilu.org#41950,"JATISARONO, NANGGULAN, KULON PROGO, DAERAH ISTIMEWA YOGYAKARTA",11,169,74,243
https://kawalpemilu.org#41950,"JATISARONO, NANGGULAN, KULON PROGO, DAERAH ISTIMEWA YOGYAKARTA",12,150,107,257
https://kawalpemilu.org#41950,"JATISARONO, NANGGULAN, KULON PROGO, DAERAH ISTIMEWA YOGYAKARTA",13,160,77,237
https://kawalpemilu.org#41950,"JATISARONO, NANGGULAN, KULON PROGO, DAERAH ISTIMEWA YOGYAKARTA",14,192,60,252
https://kawalpemilu.org#41951,"KEMBANG, NANGGULAN, KULON PROGO, DAERAH ISTIMEWA YOGYAKARTA",1,109,148,257
https://kawalpemilu.org#41951,"KEMBANG, NANGGULAN, KULON PROGO, DAERAH ISTIMEWA YOGYAKARTA",2,137,129,266
https://kawalpemilu.org#41951,"KEMBANG, NANGGULAN, KULON PROGO, DAERAH ISTIMEWA YOGYAKARTA",3,101,133,234
https://kawalpemilu.org#41951,"KEMBANG, NANGGULAN, KULON PROGO, DAERAH ISTIMEWA YOGYAKARTA",4,158,93,251
https://kawalpemilu.org#41951,"KEMBANG, NANGGULAN, KULON PROGO, DAERAH ISTIMEWA YOGYAKARTA",5,144,83,227
https://kawalpemilu.org#41951,"KEMBANG, NANGGULAN, KULON PROGO, DAERAH ISTIMEWA YOGYAKARTA",6,230,39,269
https://kawalpemilu.org#41951,"KEMBANG, NANGGULAN, KULON PROGO, DAERAH ISTIMEWA YOGYAKARTA",7,146,106,252
https://kawalpemilu.org#41951,"KEMBANG, NANGGULAN, KULON PROGO, DAERAH ISTIMEWA YOGYAKARTA",8,193,55,248
https://kawalpemilu.org#41951,"KEMBANG, NANGGULAN, KULON PROGO, DAERAH ISTIMEWA YOGYAKARTA",9,208,40,248
https://kawalpemilu.org#41951,"KEMBANG, NANGGULAN, KULON PROGO, DAERAH ISTIMEWA YOGYAKARTA",10,192,49,241
https://kawalpemilu.org#41951,"KEMBANG, NANGGULAN, KULON PROGO, DAERAH ISTIMEWA YOGYAKARTA",11,188,61,249
https://kawalpemilu.org#41951,"KEMBANG, NANGGULAN, KULON PROGO, DAERAH ISTIMEWA YOGYAKARTA",12,206,54,260
https://kawalpemilu.org#41951,"KEMBANG, NANGGULAN, KULON PROGO, DAERAH ISTIMEWA YOGYAKARTA",13,186,54,240
https://kawalpemilu.org#41953,"KEBONHARJO, SAMIGALUH, KULON PROGO, DAERAH ISTIMEWA YOGYAKARTA",1,166,51,217
https://kawalpemilu.org#41953,"KEBONHARJO, SAMIGALUH, KULON PROGO, DAERAH ISTIMEWA YOGYAKARTA",2,159,52,211
https://kawalpemilu.org#41953,"KEBONHARJO, SAMIGALUH, KULON PROGO, DAERAH ISTIMEWA YOGYAKARTA",3,145,39,184
https://kawalpemilu.org#41953,"KEBONHARJO, SAMIGALUH, KULON PROGO, DAERAH ISTIMEWA YOGYAKARTA",4,137,98,235
https://kawalpemilu.org#41953,"KEBONHARJO, SAMIGALUH, KULON PROGO, DAERAH ISTIMEWA YOGYAKARTA",5,196,48,244
https://kawalpemilu.org#41953,"KEBONHARJO, SAMIGALUH, KULON PROGO, DAERAH ISTIMEWA YOGYAKARTA",6,205,23,228
https://kawalpemilu.org#41953,"KEBONHARJO, SAMIGALUH, KULON PROGO, DAERAH ISTIMEWA YOGYAKARTA",7,180,60,240
https://kawalpemilu.org#41954,"BANJARSARI, SAMIGALUH, KULON PROGO, DAERAH ISTIMEWA YOGYAKARTA",1,185,54,239
https://kawalpemilu.org#41954,"BANJARSARI, SAMIGALUH, KULON PROGO, DAERAH ISTIMEWA YOGYAKARTA",2,177,59,236
https://kawalpemilu.org#41954,"BANJARSARI, SAMIGALUH, KULON PROGO, DAERAH ISTIMEWA YOGYAKARTA",3,192,36,228
https://kawalpemilu.org#41954,"BANJARSARI, SAMIGALUH, KULON PROGO, DAERAH ISTIMEWA YOGYAKARTA",4,174,16,190
https://kawalpemilu.org#41954,"BANJARSARI, SAMIGALUH, KULON PROGO, DAERAH ISTIMEWA YOGYAKARTA",5,120,51,171
https://kawalpemilu.org#41954,"BANJARSARI, SAMIGALUH, KULON PROGO, DAERAH ISTIMEWA YOGYAKARTA",6,128,119,247
https://kawalpemilu.org#41954,"BANJARSARI, SAMIGALUH, KULON PROGO, DAERAH ISTIMEWA YOGYAKARTA",7,115,40,155
https://kawalpemilu.org#41954,"BANJARSARI, SAMIGALUH, KULON PROGO, DAERAH ISTIMEWA YOGYAKARTA",8,124,67,191
https://kawalpemilu.org#41954,"BANJARSARI, SAMIGALUH, KULON PROGO, DAERAH ISTIMEWA YOGYAKARTA",9,143,35,178
https://kawalpemilu.org#41954,"BANJARSARI, SAMIGALUH, KULON PROGO, DAERAH ISTIMEWA YOGYAKARTA",10,155,47,202
https://kawalpemilu.org#41955,"PURWOHARJO, SAMIGALUH, KULON PROGO, DAERAH ISTIMEWA YOGYAKARTA",1,171,62,233
https://kawalpemilu.org#41955,"PURWOHARJO, SAMIGALUH, KULON PROGO, DAERAH ISTIMEWA YOGYAKARTA",2,178,71,249
https://kawalpemilu.org#41955,"PURWOHARJO, SAMIGALUH, KULON PROGO, DAERAH ISTIMEWA YOGYAKARTA",3,161,73,234
https://kawalpemilu.org#41955,"PURWOHARJO, SAMIGALUH, KULON PROGO, DAERAH ISTIMEWA YOGYAKARTA",4,132,77,209
https://kawalpemilu.org#41955,"PURWOHARJO, SAMIGALUH, KULON PROGO, DAERAH ISTIMEWA YOGYAKARTA",5,173,39,210
https://kawalpemilu.org#41955,"PURWOHARJO, SAMIGALUH, KULON PROGO, DAERAH ISTIMEWA YOGYAKARTA",6,186,41,227
https://kawalpemilu.org#41955,"PURWOHARJO, SAMIGALUH, KULON PROGO, DAERAH ISTIMEWA YOGYAKARTA",7,163,25,188
https://kawalpemilu.org#41955,"PURWOHARJO, SAMIGALUH, KULON PROGO, DAERAH ISTIMEWA YOGYAKARTA",8,78,26,104
https://kawalpemilu.org#41955,"PURWOHARJO, SAMIGALUH, KULON PROGO, DAERAH ISTIMEWA YOGYAKARTA",9,113,37,150
https://kawalpemilu.org#41955,"PURWOHARJO, SAMIGALUH, KULON PROGO, DAERAH ISTIMEWA YOGYAKARTA",10,125,29,154
https://kawalpemilu.org#41955,"PURWOHARJO, SAMIGALUH, KULON PROGO, DAERAH ISTIMEWA YOGYAKARTA",11,121,44,165
https://kawalpemilu.org#41955,"PURWOHARJO, SAMIGALUH, KULON PROGO, DAERAH ISTIMEWA YOGYAKARTA",12,146,92,238
https://kawalpemilu.org#41956,"SIDOHARJO, SAMIGALUH, KULON PROGO, DAERAH ISTIMEWA YOGYAKARTA",1,198,19,217
https://kawalpemilu.org#41956,"SIDOHARJO, SAMIGALUH, KULON PROGO, DAERAH ISTIMEWA YOGYAKARTA",2,200,40,240
https://kawalpemilu.org#41956,"SIDOHARJO, SAMIGALUH, KULON PROGO, DAERAH ISTIMEWA YOGYAKARTA",3,94,90,184
https://kawalpemilu.org#41956,"SIDOHARJO, SAMIGALUH, KULON PROGO, DAERAH ISTIMEWA YOGYAKARTA",4,171,57,228
https://kawalpemilu.org#41956,"SIDOHARJO, SAMIGALUH, KULON PROGO, DAERAH ISTIMEWA YOGYAKARTA",5,129,124,253
https://kawalpemilu.org#41956,"SIDOHARJO, SAMIGALUH, KULON PROGO, DAERAH ISTIMEWA YOGYAKARTA",6,124,115,239
https://kawalpemilu.org#41956,"SIDOHARJO, SAMIGALUH, KULON PROGO, DAERAH ISTIMEWA YOGYAKARTA",7,109,0,109
https://kawalpemilu.org#41956,"SIDOHARJO, SAMIGALUH, KULON PROGO, DAERAH ISTIMEWA YOGYAKARTA",8,105,122,227
https://kawalpemilu.org#41956,"SIDOHARJO, SAMIGALUH, KULON PROGO, DAERAH ISTIMEWA YOGYAKARTA",9,66,122,188
https://kawalpemilu.org#41956,"SIDOHARJO, SAMIGALUH, KULON PROGO, DAERAH ISTIMEWA YOGYAKARTA",10,174,63,237
https://kawalpemilu.org#41956,"SIDOHARJO, SAMIGALUH, KULON PROGO, DAERAH ISTIMEWA YOGYAKARTA",11,149,98,247
https://kawalpemilu.org#41956,"SIDOHARJO, SAMIGALUH, KULON PROGO, DAERAH ISTIMEWA YOGYAKARTA",12,96,89,185
https://kawalpemilu.org#41956,"SIDOHARJO, SAMIGALUH, KULON PROGO, DAERAH ISTIMEWA YOGYAKARTA",13,88,68,156
https://kawalpemilu.org#41956,"SIDOHARJO, SAMIGALUH, KULON PROGO, DAERAH ISTIMEWA YOGYAKARTA",14,105,142,247
https://kawalpemilu.org#41956,"SIDOHARJO, SAMIGALUH, KULON PROGO, DAERAH ISTIMEWA YOGYAKARTA",15,198,47,245
https://kawalpemilu.org#41956,"SIDOHARJO, SAMIGALUH, KULON PROGO, DAERAH ISTIMEWA YOGYAKARTA",16,141,87,228
https://kawalpemilu.org#41957,"GERBOSARI, SAMIGALUH, KULON PROGO, DAERAH ISTIMEWA YOGYAKARTA",1,139,61,200
https://kawalpemilu.org#41957,"GERBOSARI, SAMIGALUH, KULON PROGO, DAERAH ISTIMEWA YOGYAKARTA",2,151,97,248
https://kawalpemilu.org#41957,"GERBOSARI, SAMIGALUH, KULON PROGO, DAERAH ISTIMEWA YOGYAKARTA",3,87,105,192
https://kawalpemilu.org#41957,"GERBOSARI, SAMIGALUH, KULON PROGO, DAERAH ISTIMEWA YOGYAKARTA",4,126,82,208
https://kawalpemilu.org#41957,"GERBOSARI, SAMIGALUH, KULON PROGO, DAERAH ISTIMEWA YOGYAKARTA",5,172,80,252
https://kawalpemilu.org#41957,"GERBOSARI, SAMIGALUH, KULON PROGO, DAERAH ISTIMEWA YOGYAKARTA",6,168,69,237
https://kawalpemilu.org#41957,"GERBOSARI, SAMIGALUH, KULON PROGO, DAERAH ISTIMEWA YOGYAKARTA",7,122,132,254
https://kawalpemilu.org#41957,"GERBOSARI, SAMIGALUH, KULON PROGO, DAERAH ISTIMEWA YOGYAKARTA",8,157,75,232
https://kawalpemilu.org#41957,"GERBOSARI, SAMIGALUH, KULON PROGO, DAERAH ISTIMEWA YOGYAKARTA",9,140,71,211
https://kawalpemilu.org#41957,"GERBOSARI, SAMIGALUH, KULON PROGO, DAERAH ISTIMEWA YOGYAKARTA",10,116,124,240
https://kawalpemilu.org#41957,"GERBOSARI, SAMIGALUH, KULON PROGO, DAERAH ISTIMEWA YOGYAKARTA",11,172,62,234
https://kawalpemilu.org#41957,"GERBOSARI, SAMIGALUH, KULON PROGO, DAERAH ISTIMEWA YOGYAKARTA",12,190,27,217
https://kawalpemilu.org#41957,"GERBOSARI, SAMIGALUH, KULON PROGO, DAERAH ISTIMEWA YOGYAKARTA",13,126,22,148
https://kawalpemilu.org#41957,"GERBOSARI, SAMIGALUH, KULON PROGO, DAERAH ISTIMEWA YOGYAKARTA",14,127,38,165
https://kawalpemilu.org#41958,"NGARGOSARI, SAMIGALUH, KULON PROGO, DAERAH ISTIMEWA YOGYAKARTA",1,167,53,220
https://kawalpemilu.org#41958,"NGARGOSARI, SAMIGALUH, KULON PROGO, DAERAH ISTIMEWA YOGYAKARTA",2,131,82,213
https://kawalpemilu.org#41958,"NGARGOSARI, SAMIGALUH, KULON PROGO, DAERAH ISTIMEWA YOGYAKARTA",3,174,53,227
https://kawalpemilu.org#41958,"NGARGOSARI, SAMIGALUH, KULON PROGO, DAERAH ISTIMEWA YOGYAKARTA",4,210,17,227
https://kawalpemilu.org#41958,"NGARGOSARI, SAMIGALUH, KULON PROGO, DAERAH ISTIMEWA YOGYAKARTA",5,182,46,228
https://kawalpemilu.org#41958,"NGARGOSARI, SAMIGALUH, KULON PROGO, DAERAH ISTIMEWA YOGYAKARTA",6,148,97,245
https://kawalpemilu.org#41958,"NGARGOSARI, SAMIGALUH, KULON PROGO, DAERAH ISTIMEWA YOGYAKARTA",7,230,31,261
https://kawalpemilu.org#41958,"NGARGOSARI, SAMIGALUH, KULON PROGO, DAERAH ISTIMEWA YOGYAKARTA",8,185,29,214
https://kawalpemilu.org#41958,"NGARGOSARI, SAMIGALUH, KULON PROGO, DAERAH ISTIMEWA YOGYAKARTA",9,166,55,221
https://kawalpemilu.org#41958,"NGARGOSARI, SAMIGALUH, KULON PROGO, DAERAH ISTIMEWA YOGYAKARTA",10,221,15,236
https://kawalpemilu.org#41958,"NGARGOSARI, SAMIGALUH, KULON PROGO, DAERAH ISTIMEWA YOGYAKARTA",11,169,50,219
https://kawalpemilu.org#41958,"NGARGOSARI, SAMIGALUH, KULON PROGO, DAERAH ISTIMEWA YOGYAKARTA",12,167,65,232
https://kawalpemilu.org#41959,"PAGERHARJO, SAMIGALUH, KULON PROGO, DAERAH ISTIMEWA YOGYAKARTA",1,181,66,247
https://kawalpemilu.org#41959,"PAGERHARJO, SAMIGALUH, KULON PROGO, DAERAH ISTIMEWA YOGYAKARTA",2,159,42,201
https://kawalpemilu.org#41959,"PAGERHARJO, SAMIGALUH, KULON PROGO, DAERAH ISTIMEWA YOGYAKARTA",3,153,53,206
https://kawalpemilu.org#41959,"PAGERHARJO, SAMIGALUH, KULON PROGO, DAERAH ISTIMEWA YOGYAKARTA",4,169,46,215
https://kawalpemilu.org#41959,"PAGERHARJO, SAMIGALUH, KULON PROGO, DAERAH ISTIMEWA YOGYAKARTA",5,184,43,227
https://kawalpemilu.org#41959,"PAGERHARJO, SAMIGALUH, KULON PROGO, DAERAH ISTIMEWA YOGYAKARTA",6,158,57,215
https://kawalpemilu.org#41959,"PAGERHARJO, SAMIGALUH, KULON PROGO, DAERAH ISTIMEWA YOGYAKARTA",7,174,39,213
https://kawalpemilu.org#41959,"PAGERHARJO, SAMIGALUH, KULON PROGO, DAERAH ISTIMEWA YOGYAKARTA",8,220,18,238
https://kawalpemilu.org#41959,"PAGERHARJO, SAMIGALUH, KULON PROGO, DAERAH ISTIMEWA YOGYAKARTA",9,161,68,229
https://kawalpemilu.org#41959,"PAGERHARJO, SAMIGALUH, KULON PROGO, DAERAH ISTIMEWA YOGYAKARTA",11,179,47,226
https://kawalpemilu.org#41959,"PAGERHARJO, SAMIGALUH, KULON PROGO, DAERAH ISTIMEWA YOGYAKARTA",13,115,45,160
https://kawalpemilu.org#41959,"PAGERHARJO, SAMIGALUH, KULON PROGO, DAERAH ISTIMEWA YOGYAKARTA",14,191,52,243
https://kawalpemilu.org#41959,"PAGERHARJO, SAMIGALUH, KULON PROGO, DAERAH ISTIMEWA YOGYAKARTA",15,130,26,156
https://kawalpemilu.org#41961,"BANJARARUM, KALIBAWANG, KULON PROGO, DAERAH ISTIMEWA YOGYAKARTA",1,154,70,224
https://kawalpemilu.org#41961,"BANJARARUM, KALIBAWANG, KULON PROGO, DAERAH ISTIMEWA YOGYAKARTA",2,94,143,237
https://kawalpemilu.org#41961,"BANJARARUM, KALIBAWANG, KULON PROGO, DAERAH ISTIMEWA YOGYAKARTA",3,120,124,244
https://kawalpemilu.org#41961,"BANJARARUM, KALIBAWANG, KULON PROGO, DAERAH ISTIMEWA YOGYAKARTA",6,118,108,226
https://kawalpemilu.org#41961,"BANJARARUM, KALIBAWANG, KULON PROGO, DAERAH ISTIMEWA YOGYAKARTA",7,106,131,237
https://kawalpemilu.org#41961,"BANJARARUM, KALIBAWANG, KULON PROGO, DAERAH ISTIMEWA YOGYAKARTA",8,68,55,123
https://kawalpemilu.org#41961,"BANJARARUM, KALIBAWANG, KULON PROGO, DAERAH ISTIMEWA YOGYAKARTA",9,95,149,244
https://kawalpemilu.org#41961,"BANJARARUM, KALIBAWANG, KULON PROGO, DAERAH ISTIMEWA YOGYAKARTA",10,0,0,0
https://kawalpemilu.org#41961,"BANJARARUM, KALIBAWANG, KULON PROGO, DAERAH ISTIMEWA YOGYAKARTA",11,113,131,244
https://kawalpemilu.org#41961,"BANJARARUM, KALIBAWANG, KULON PROGO, DAERAH ISTIMEWA YOGYAKARTA",12,102,75,177
https://kawalpemilu.org#41961,"BANJARARUM, KALIBAWANG, KULON PROGO, DAERAH ISTIMEWA YOGYAKARTA",13,120,75,195
https://kawalpemilu.org#41961,"BANJARARUM, KALIBAWANG, KULON PROGO, DAERAH ISTIMEWA YOGYAKARTA",14,109,79,188
https://kawalpemilu.org#41961,"BANJARARUM, KALIBAWANG, KULON PROGO, DAERAH ISTIMEWA YOGYAKARTA",15,79,91,170
https://kawalpemilu.org#41961,"BANJARARUM, KALIBAWANG, KULON PROGO, DAERAH ISTIMEWA YOGYAKARTA",16,97,101,198
https://kawalpemilu.org#41961,"BANJARARUM, KALIBAWANG, KULON PROGO, DAERAH ISTIMEWA YOGYAKARTA",17,100,128,228
https://kawalpemilu.org#41961,"BANJARARUM, KALIBAWANG, KULON PROGO, DAERAH ISTIMEWA YOGYAKARTA",18,128,96,224
https://kawalpemilu.org#41961,"BANJARARUM, KALIBAWANG, KULON PROGO, DAERAH ISTIMEWA YOGYAKARTA",19,115,112,227
https://kawalpemilu.org#41961,"BANJARARUM, KALIBAWANG, KULON PROGO, DAERAH ISTIMEWA YOGYAKARTA",20,150,69,219
https://kawalpemilu.org#41961,"BANJARARUM, KALIBAWANG, KULON PROGO, DAERAH ISTIMEWA YOGYAKARTA",21,151,32,183
https://kawalpemilu.org#41961,"BANJARARUM, KALIBAWANG, KULON PROGO, DAERAH ISTIMEWA YOGYAKARTA",22,162,26,188
https://kawalpemilu.org#41961,"BANJARARUM, KALIBAWANG, KULON PROGO, DAERAH ISTIMEWA YOGYAKARTA",23,160,16,176
https://kawalpemilu.org#41961,"BANJARARUM, KALIBAWANG, KULON PROGO, DAERAH ISTIMEWA YOGYAKARTA",24,125,81,205
https://kawalpemilu.org#41961,"BANJARARUM, KALIBAWANG, KULON PROGO, DAERAH ISTIMEWA YOGYAKARTA",25,150,75,225
https://kawalpemilu.org#41961,"BANJARARUM, KALIBAWANG, KULON PROGO, DAERAH ISTIMEWA YOGYAKARTA",26,126,102,228
https://kawalpemilu.org#41961,"BANJARARUM, KALIBAWANG, KULON PROGO, DAERAH ISTIMEWA YOGYAKARTA",27,127,119,246
https://kawalpemilu.org#41961,"BANJARARUM, KALIBAWANG, KULON PROGO, DAERAH ISTIMEWA YOGYAKARTA",28,78,56,2
https://kawalpemilu.org#41961,"BANJARARUM, KALIBAWANG, KULON PROGO, DAERAH ISTIMEWA YOGYAKARTA",29,132,6,138
https://kawalpemilu.org#41962,"BANJARASRI, KALIBAWANG, KULON PROGO, DAERAH ISTIMEWA YOGYAKARTA",1,171,5,176
https://kawalpemilu.org#41962,"BANJARASRI, KALIBAWANG, KULON PROGO, DAERAH ISTIMEWA YOGYAKARTA",2,150,4,154
https://kawalpemilu.org#41962,"BANJARASRI, KALIBAWANG, KULON PROGO, DAERAH ISTIMEWA YOGYAKARTA",3,161,7,168
https://kawalpemilu.org#41962,"BANJARASRI, KALIBAWANG, KULON PROGO, DAERAH ISTIMEWA YOGYAKARTA",4,128,53,181
https://kawalpemilu.org#41962,"BANJARASRI, KALIBAWANG, KULON PROGO, DAERAH ISTIMEWA YOGYAKARTA",5,199,1,200
https://kawalpemilu.org#41962,"BANJARASRI, KALIBAWANG, KULON PROGO, DAERAH ISTIMEWA YOGYAKARTA",6,121,2,123
https://kawalpemilu.org#41962,"BANJARASRI, KALIBAWANG, KULON PROGO, DAERAH ISTIMEWA YOGYAKARTA",7,120,8,128
https://kawalpemilu.org#41962,"BANJARASRI, KALIBAWANG, KULON PROGO, DAERAH ISTIMEWA YOGYAKARTA",8,87,23,110
https://kawalpemilu.org#41962,"BANJARASRI, KALIBAWANG, KULON PROGO, DAERAH ISTIMEWA YOGYAKARTA",9,128,20,148
https://kawalpemilu.org#41962,"BANJARASRI, KALIBAWANG, KULON PROGO, DAERAH ISTIMEWA YOGYAKARTA",10,190,17,207
https://kawalpemilu.org#41962,"BANJARASRI, KALIBAWANG, KULON PROGO, DAERAH ISTIMEWA YOGYAKARTA",11,153,21,174
https://kawalpemilu.org#41962,"BANJARASRI, KALIBAWANG, KULON PROGO, DAERAH ISTIMEWA YOGYAKARTA",12,151,1,152
https://kawalpemilu.org#41962,"BANJARASRI, KALIBAWANG, KULON PROGO, DAERAH ISTIMEWA YOGYAKARTA",13,143,18,161
https://kawalpemilu.org#41962,"BANJARASRI, KALIBAWANG, KULON PROGO, DAERAH ISTIMEWA YOGYAKARTA",14,103,61,164
https://kawalpemilu.org#41962,"BANJARASRI, KALIBAWANG, KULON PROGO, DAERAH ISTIMEWA YOGYAKARTA",15,125,66,191
https://kawalpemilu.org#41962,"BANJARASRI, KALIBAWANG, KULON PROGO, DAERAH ISTIMEWA YOGYAKARTA",16,105,90,195
https://kawalpemilu.org#41962,"BANJARASRI, KALIBAWANG, KULON PROGO, DAERAH ISTIMEWA YOGYAKARTA",17,151,61,212
https://kawalpemilu.org#41962,"BANJARASRI, KALIBAWANG, KULON PROGO, DAERAH ISTIMEWA YOGYAKARTA",18,126,19,145
https://kawalpemilu.org#41963,"BANJARHARJO, KALIBAWANG, KULON PROGO, DAERAH ISTIMEWA YOGYAKARTA",1,127,8,135
https://kawalpemilu.org#41963,"BANJARHARJO, KALIBAWANG, KULON PROGO, DAERAH ISTIMEWA YOGYAKARTA",2,193,33,226
https://kawalpemilu.org#41963,"BANJARHARJO, KALIBAWANG, KULON PROGO, DAERAH ISTIMEWA YOGYAKARTA",3,135,113,248
https://kawalpemilu.org#41963,"BANJARHARJO, KALIBAWANG, KULON PROGO, DAERAH ISTIMEWA YOGYAKARTA",4,172,53,225
https://kawalpemilu.org#41963,"BANJARHARJO, KALIBAWANG, KULON PROGO, DAERAH ISTIMEWA YOGYAKARTA",5,159,38,197
https://kawalpemilu.org#41963,"BANJARHARJO, KALIBAWANG, KULON PROGO, DAERAH ISTIMEWA YOGYAKARTA",6,167,78,245
https://kawalpemilu.org#41963,"BANJARHARJO, KALIBAWANG, KULON PROGO, DAERAH ISTIMEWA YOGYAKARTA",7,159,87,246
https://kawalpemilu.org#41963,"BANJARHARJO, KALIBAWANG, KULON PROGO, DAERAH ISTIMEWA YOGYAKARTA",8,172,68,240
https://kawalpemilu.org#41963,"BANJARHARJO, KALIBAWANG, KULON PROGO, DAERAH ISTIMEWA YOGYAKARTA",9,147,103,250
https://kawalpemilu.org#41963,"BANJARHARJO, KALIBAWANG, KULON PROGO, DAERAH ISTIMEWA YOGYAKARTA",10,129,40,169
https://kawalpemilu.org#41963,"BANJARHARJO, KALIBAWANG, KULON PROGO, DAERAH ISTIMEWA YOGYAKARTA",11,75,77,152
https://kawalpemilu.org#41963,"BANJARHARJO, KALIBAWANG, KULON PROGO, DAERAH ISTIMEWA YOGYAKARTA",12,152,24,176
https://kawalpemilu.org#41963,"BANJARHARJO, KALIBAWANG, KULON PROGO, DAERAH ISTIMEWA YOGYAKARTA",13,106,33,139
https://kawalpemilu.org#41963,"BANJARHARJO, KALIBAWANG, KULON PROGO, DAERAH ISTIMEWA YOGYAKARTA",14,133,98,231
https://kawalpemilu.org#41963,"BANJARHARJO, KALIBAWANG, KULON PROGO, DAERAH ISTIMEWA YOGYAKARTA",15,94,62,156
https://kawalpemilu.org#41963,"BANJARHARJO, KALIBAWANG, KULON PROGO, DAERAH ISTIMEWA YOGYAKARTA",16,165,68,233
https://kawalpemilu.org#41963,"BANJARHARJO, KALIBAWANG, KULON PROGO, DAERAH ISTIMEWA YOGYAKARTA",17,167,64,231
https://kawalpemilu.org#41963,"BANJARHARJO, KALIBAWANG, KULON PROGO, DAERAH ISTIMEWA YOGYAKARTA",18,169,57,226
https://kawalpemilu.org#41963,"BANJARHARJO, KALIBAWANG, KULON PROGO, DAERAH ISTIMEWA YOGYAKARTA",19,153,93,246
https://kawalpemilu.org#41963,"BANJARHARJO, KALIBAWANG, KULON PROGO, DAERAH ISTIMEWA YOGYAKARTA",21,141,42,183
https://kawalpemilu.org#41963,"BANJARHARJO, KALIBAWANG, KULON PROGO, DAERAH ISTIMEWA YOGYAKARTA",22,140,44,184
https://kawalpemilu.org#41963,"BANJARHARJO, KALIBAWANG, KULON PROGO, DAERAH ISTIMEWA YOGYAKARTA",23,174,54,228
https://kawalpemilu.org#41963,"BANJARHARJO, KALIBAWANG, KULON PROGO, DAERAH ISTIMEWA YOGYAKARTA",24,160,35,195
https://kawalpemilu.org#41964,"BANJAROYO, KALIBAWANG, KULON PROGO, DAERAH ISTIMEWA YOGYAKARTA",1,133,86,219
https://kawalpemilu.org#41964,"BANJAROYO, KALIBAWANG, KULON PROGO, DAERAH ISTIMEWA YOGYAKARTA",2,156,69,225
https://kawalpemilu.org#41964,"BANJAROYO, KALIBAWANG, KULON PROGO, DAERAH ISTIMEWA YOGYAKARTA",3,149,67,216
https://kawalpemilu.org#41964,"BANJAROYO, KALIBAWANG, KULON PROGO, DAERAH ISTIMEWA YOGYAKARTA",4,131,71,202
https://kawalpemilu.org#41964,"BANJAROYO, KALIBAWANG, KULON PROGO, DAERAH ISTIMEWA YOGYAKARTA",5,108,64,172
https://kawalpemilu.org#41964,"BANJAROYO, KALIBAWANG, KULON PROGO, DAERAH ISTIMEWA YOGYAKARTA",6,120,97,217
https://kawalpemilu.org#41964,"BANJAROYO, KALIBAWANG, KULON PROGO, DAERAH ISTIMEWA YOGYAKARTA",7,146,70,216
https://kawalpemilu.org#41964,"BANJAROYO, KALIBAWANG, KULON PROGO, DAERAH ISTIMEWA YOGYAKARTA",8,208,30,238
https://kawalpemilu.org#41964,"BANJAROYO, KALIBAWANG, KULON PROGO, DAERAH ISTIMEWA YOGYAKARTA",9,228,32,260
https://kawalpemilu.org#41964,"BANJAROYO, KALIBAWANG, KULON PROGO, DAERAH ISTIMEWA YOGYAKARTA",10,182,52,235
https://kawalpemilu.org#41964,"BANJAROYO, KALIBAWANG, KULON PROGO, DAERAH ISTIMEWA YOGYAKARTA",11,174,35,209
https://kawalpemilu.org#41964,"BANJAROYO, KALIBAWANG, KULON PROGO, DAERAH ISTIMEWA YOGYAKARTA",12,183,46,229
https://kawalpemilu.org#41964,"BANJAROYO, KALIBAWANG, KULON PROGO, DAERAH ISTIMEWA YOGYAKARTA",13,188,47,235
https://kawalpemilu.org#41964,"BANJAROYO, KALIBAWANG, KULON PROGO, DAERAH ISTIMEWA YOGYAKARTA",14,181,42,223
https://kawalpemilu.org#41964,"BANJAROYO, KALIBAWANG, KULON PROGO, DAERAH ISTIMEWA YOGYAKARTA",15,144,46,190
https://kawalpemilu.org#41964,"BANJAROYO, KALIBAWANG, KULON PROGO, DAERAH ISTIMEWA YOGYAKARTA",16,205,12,217
https://kawalpemilu.org#41964,"BANJAROYO, KALIBAWANG, KULON PROGO, DAERAH ISTIMEWA YOGYAKARTA",17,104,37,141
https://kawalpemilu.org#41964,"BANJAROYO, KALIBAWANG, KULON PROGO, DAERAH ISTIMEWA YOGYAKARTA",18,209,13,222
https://kawalpemilu.org#41964,"BANJAROYO, KALIBAWANG, KULON PROGO, DAERAH ISTIMEWA YOGYAKARTA",19,196,11,207
https://kawalpemilu.org#41964,"BANJAROYO, KALIBAWANG, KULON PROGO, DAERAH ISTIMEWA YOGYAKARTA",20,136,99,235
https://kawalpemilu.org#41964,"BANJAROYO, KALIBAWANG, KULON PROGO, DAERAH ISTIMEWA YOGYAKARTA",21,150,4,154
https://kawalpemilu.org#41964,"BANJAROYO, KALIBAWANG, KULON PROGO, DAERAH ISTIMEWA YOGYAKARTA",22,207,3,210
https://kawalpemilu.org#41964,"BANJAROYO, KALIBAWANG, KULON PROGO, DAERAH ISTIMEWA YOGYAKARTA",23,191,1,192
https://kawalpemilu.org#41964,"BANJAROYO, KALIBAWANG, KULON PROGO, DAERAH ISTIMEWA YOGYAKARTA",24,146,39,185
https://kawalpemilu.org#41964,"BANJAROYO, KALIBAWANG, KULON PROGO, DAERAH ISTIMEWA YOGYAKARTA",25,89,50,139
https://kawalpemilu.org#41964,"BANJAROYO, KALIBAWANG, KULON PROGO, DAERAH ISTIMEWA YOGYAKARTA",26,203,34,237
https://kawalpemilu.org#41964,"BANJAROYO, KALIBAWANG, KULON PROGO, DAERAH ISTIMEWA YOGYAKARTA",27,195,44,239
https://kawalpemilu.org#41967,"PONCOSARI, SRANDAKAN, BANTUL, DAERAH ISTIMEWA YOGYAKARTA",1,79,58,137
https://kawalpemilu.org#41967,"PONCOSARI, SRANDAKAN, BANTUL, DAERAH ISTIMEWA YOGYAKARTA",2,127,34,161
https://kawalpemilu.org#41967,"PONCOSARI, SRANDAKAN, BANTUL, DAERAH ISTIMEWA YOGYAKARTA",3,96,59,155
https://kawalpemilu.org#41967,"PONCOSARI, SRANDAKAN, BANTUL, DAERAH ISTIMEWA YOGYAKARTA",5,128,58,186
https://kawalpemilu.org#41967,"PONCOSARI, SRANDAKAN, BANTUL, DAERAH ISTIMEWA YOGYAKARTA",6,156,20,176
https://kawalpemilu.org#41967,"PONCOSARI, SRANDAKAN, BANTUL, DAERAH ISTIMEWA YOGYAKARTA",7,123,46,169
https://kawalpemilu.org#41967,"PONCOSARI, SRANDAKAN, BANTUL, DAERAH ISTIMEWA YOGYAKARTA",8,74,67,141
https://kawalpemilu.org#41967,"PONCOSARI, SRANDAKAN, BANTUL, DAERAH ISTIMEWA YOGYAKARTA",9,87,72,159
https://kawalpemilu.org#41967,"PONCOSARI, SRANDAKAN, BANTUL, DAERAH ISTIMEWA YOGYAKARTA",10,93,29,122
https://kawalpemilu.org#41967,"PONCOSARI, SRANDAKAN, BANTUL, DAERAH ISTIMEWA YOGYAKARTA",11,110,34,144
https://kawalpemilu.org#41967,"PONCOSARI, SRANDAKAN, BANTUL, DAERAH ISTIMEWA YOGYAKARTA",12,110,36,146
https://kawalpemilu.org#41967,"PONCOSARI, SRANDAKAN, BANTUL, DAERAH ISTIMEWA YOGYAKARTA",13,117,19,136
https://kawalpemilu.org#41967,"PONCOSARI, SRANDAKAN, BANTUL, DAERAH ISTIMEWA YOGYAKARTA",14,109,47,156
https://kawalpemilu.org#41967,"PONCOSARI, SRANDAKAN, BANTUL, DAERAH ISTIMEWA YOGYAKARTA",15,105,0,167
https://kawalpemilu.org#41967,"PONCOSARI, SRANDAKAN, BANTUL, DAERAH ISTIMEWA YOGYAKARTA",16,99,70,169
https://kawalpemilu.org#41967,"PONCOSARI, SRANDAKAN, BANTUL, DAERAH ISTIMEWA YOGYAKARTA",17,115,39,154
https://kawalpemilu.org#41967,"PONCOSARI, SRANDAKAN, BANTUL, DAERAH ISTIMEWA YOGYAKARTA",18,131,41,172
https://kawalpemilu.org#41967,"PONCOSARI, SRANDAKAN, BANTUL, DAERAH ISTIMEWA YOGYAKARTA",19,99,88,187
https://kawalpemilu.org#41967,"PONCOSARI, SRANDAKAN, BANTUL, DAERAH ISTIMEWA YOGYAKARTA",20,133,49,182
https://kawalpemilu.org#41967,"PONCOSARI, SRANDAKAN, BANTUL, DAERAH ISTIMEWA YOGYAKARTA",21,111,51,162
https://kawalpemilu.org#41967,"PONCOSARI, SRANDAKAN, BANTUL, DAERAH ISTIMEWA YOGYAKARTA",22,156,64,220
https://kawalpemilu.org#41967,"PONCOSARI, SRANDAKAN, BANTUL, DAERAH ISTIMEWA YOGYAKARTA",23,124,35,159
https://kawalpemilu.org#41967,"PONCOSARI, SRANDAKAN, BANTUL, DAERAH ISTIMEWA YOGYAKARTA",24,143,75,218
https://kawalpemilu.org#41967,"PONCOSARI, SRANDAKAN, BANTUL, DAERAH ISTIMEWA YOGYAKARTA",25,131,47,178
https://kawalpemilu.org#41967,"PONCOSARI, SRANDAKAN, BANTUL, DAERAH ISTIMEWA YOGYAKARTA",26,153,26,179
https://kawalpemilu.org#41967,"PONCOSARI, SRANDAKAN, BANTUL, DAERAH ISTIMEWA YOGYAKARTA",27,154,58,212
https://kawalpemilu.org#41967,"PONCOSARI, SRANDAKAN, BANTUL, DAERAH ISTIMEWA YOGYAKARTA",28,62,57,119
https://kawalpemilu.org#41967,"PONCOSARI, SRANDAKAN, BANTUL, DAERAH ISTIMEWA YOGYAKARTA",29,79,54,133
https://kawalpemilu.org#41967,"PONCOSARI, SRANDAKAN, BANTUL, DAERAH ISTIMEWA YOGYAKARTA",30,82,61,143
https://kawalpemilu.org#41967,"PONCOSARI, SRANDAKAN, BANTUL, DAERAH ISTIMEWA YOGYAKARTA",31,82,30,112
https://kawalpemilu.org#41967,"PONCOSARI, SRANDAKAN, BANTUL, DAERAH ISTIMEWA YOGYAKARTA",32,125,66,191
https://kawalpemilu.org#41967,"PONCOSARI, SRANDAKAN, BANTUL, DAERAH ISTIMEWA YOGYAKARTA",33,107,50,157
https://kawalpemilu.org#41967,"PONCOSARI, SRANDAKAN, BANTUL, DAERAH ISTIMEWA YOGYAKARTA",34,99,74,173
https://kawalpemilu.org#41967,"PONCOSARI, SRANDAKAN, BANTUL, DAERAH ISTIMEWA YOGYAKARTA",35,100,86,186
https://kawalpemilu.org#41967,"PONCOSARI, SRANDAKAN, BANTUL, DAERAH ISTIMEWA YOGYAKARTA",36,154,37,191
https://kawalpemilu.org#41967,"PONCOSARI, SRANDAKAN, BANTUL, DAERAH ISTIMEWA YOGYAKARTA",37,119,38,157
https://kawalpemilu.org#41967,"PONCOSARI, SRANDAKAN, BANTUL, DAERAH ISTIMEWA YOGYAKARTA",38,97,31,128
https://kawalpemilu.org#41967,"PONCOSARI, SRANDAKAN, BANTUL, DAERAH ISTIMEWA YOGYAKARTA",39,137,23,160
https://kawalpemilu.org#41967,"PONCOSARI, SRANDAKAN, BANTUL, DAERAH ISTIMEWA YOGYAKARTA",40,115,46,161
https://kawalpemilu.org#41967,"PONCOSARI, SRANDAKAN, BANTUL, DAERAH ISTIMEWA YOGYAKARTA",41,71,74,145
https://kawalpemilu.org#41967,"PONCOSARI, SRANDAKAN, BANTUL, DAERAH ISTIMEWA YOGYAKARTA",42,62,103,165
https://kawalpemilu.org#41967,"PONCOSARI, SRANDAKAN, BANTUL, DAERAH ISTIMEWA YOGYAKARTA",43,83,96,179
https://kawalpemilu.org#41967,"PONCOSARI, SRANDAKAN, BANTUL, DAERAH ISTIMEWA YOGYAKARTA",44,154,49,203
https://kawalpemilu.org#41967,"PONCOSARI, SRANDAKAN, BANTUL, DAERAH ISTIMEWA YOGYAKARTA",45,118,82,200
https://kawalpemilu.org#41967,"PONCOSARI, SRANDAKAN, BANTUL, DAERAH ISTIMEWA YOGYAKARTA",46,194,40,234
https://kawalpemilu.org#41967,"PONCOSARI, SRANDAKAN, BANTUL, DAERAH ISTIMEWA YOGYAKARTA",47,180,37,217
https://kawalpemilu.org#41967,"PONCOSARI, SRANDAKAN, BANTUL, DAERAH ISTIMEWA YOGYAKARTA",48,147,71,218
https://kawalpemilu.org#41967,"PONCOSARI, SRANDAKAN, BANTUL, DAERAH ISTIMEWA YOGYAKARTA",50,155,61,216
https://kawalpemilu.org#41967,"PONCOSARI, SRANDAKAN, BANTUL, DAERAH ISTIMEWA YOGYAKARTA",51,136,44,180
https://kawalpemilu.org#41967,"PONCOSARI, SRANDAKAN, BANTUL, DAERAH ISTIMEWA YOGYAKARTA",52,114,51,165
https://kawalpemilu.org#41968,"TRIMURTI, SRANDAKAN, BANTUL, DAERAH ISTIMEWA YOGYAKARTA",1,130,45,175
https://kawalpemilu.org#41968,"TRIMURTI, SRANDAKAN, BANTUL, DAERAH ISTIMEWA YOGYAKARTA",2,125,47,172
https://kawalpemilu.org#41968,"TRIMURTI, SRANDAKAN, BANTUL, DAERAH ISTIMEWA YOGYAKARTA",3,170,74,244
https://kawalpemilu.org#41968,"TRIMURTI, SRANDAKAN, BANTUL, DAERAH ISTIMEWA YOGYAKARTA",4,148,62,210
https://kawalpemilu.org#41968,"TRIMURTI, SRANDAKAN, BANTUL, DAERAH ISTIMEWA YOGYAKARTA",5,186,49,235
https://kawalpemilu.org#41968,"TRIMURTI, SRANDAKAN, BANTUL, DAERAH ISTIMEWA YOGYAKARTA",6,164,48,212
https://kawalpemilu.org#41968,"TRIMURTI, SRANDAKAN, BANTUL, DAERAH ISTIMEWA YOGYAKARTA",7,144,75,219
https://kawalpemilu.org#41968,"TRIMURTI, SRANDAKAN, BANTUL, DAERAH ISTIMEWA YOGYAKARTA",8,124,46,170
https://kawalpemilu.org#41968,"TRIMURTI, SRANDAKAN, BANTUL, DAERAH ISTIMEWA YOGYAKARTA",9,125,68,193
https://kawalpemilu.org#41968,"TRIMURTI, SRANDAKAN, BANTUL, DAERAH ISTIMEWA YOGYAKARTA",10,79,113,192
https://kawalpemilu.org#41968,"TRIMURTI, SRANDAKAN, BANTUL, DAERAH ISTIMEWA YOGYAKARTA",11,116,57,173
https://kawalpemilu.org#41968,"TRIMURTI, SRANDAKAN, BANTUL, DAERAH ISTIMEWA YOGYAKARTA",12,124,64,188
https://kawalpemilu.org#41968,"TRIMURTI, SRANDAKAN, BANTUL, DAERAH ISTIMEWA YOGYAKARTA",13,161,44,205
https://kawalpemilu.org#41968,"TRIMURTI, SRANDAKAN, BANTUL, DAERAH ISTIMEWA YOGYAKARTA",14,169,51,220
https://kawalpemilu.org#41968,"TRIMURTI, SRANDAKAN, BANTUL, DAERAH ISTIMEWA YOGYAKARTA",15,169,47,216
https://kawalpemilu.org#41968,"TRIMURTI, SRANDAKAN, BANTUL, DAERAH ISTIMEWA YOGYAKARTA",16,128,43,171
https://kawalpemilu.org#41968,"TRIMURTI, SRANDAKAN, BANTUL, DAERAH ISTIMEWA YOGYAKARTA",17,133,44,177
https://kawalpemilu.org#41968,"TRIMURTI, SRANDAKAN, BANTUL, DAERAH ISTIMEWA YOGYAKARTA",18,167,45,212
https://kawalpemilu.org#41968,"TRIMURTI, SRANDAKAN, BANTUL, DAERAH ISTIMEWA YOGYAKARTA",19,134,45,179
https://kawalpemilu.org#41968,"TRIMURTI, SRANDAKAN, BANTUL, DAERAH ISTIMEWA YOGYAKARTA",20,79,102,181
https://kawalpemilu.org#41968,"TRIMURTI, SRANDAKAN, BANTUL, DAERAH ISTIMEWA YOGYAKARTA",21,122,87,209
https://kawalpemilu.org#41968,"TRIMURTI, SRANDAKAN, BANTUL, DAERAH ISTIMEWA YOGYAKARTA",22,117,66,183
https://kawalpemilu.org#41968,"TRIMURTI, SRANDAKAN, BANTUL, DAERAH ISTIMEWA YOGYAKARTA",23,113,84,197
https://kawalpemilu.org#41968,"TRIMURTI, SRANDAKAN, BANTUL, DAERAH ISTIMEWA YOGYAKARTA",24,93,77,170
https://kawalpemilu.org#41968,"TRIMURTI, SRANDAKAN, BANTUL, DAERAH ISTIMEWA YOGYAKARTA",25,112,58,170
https://kawalpemilu.org#41968,"TRIMURTI, SRANDAKAN, BANTUL, DAERAH ISTIMEWA YOGYAKARTA",26,190,40,230
https://kawalpemilu.org#41968,"TRIMURTI, SRANDAKAN, BANTUL, DAERAH ISTIMEWA YOGYAKARTA",27,140,81,221
https://kawalpemilu.org#41968,"TRIMURTI, SRANDAKAN, BANTUL, DAERAH ISTIMEWA YOGYAKARTA",28,115,116,231
https://kawalpemilu.org#41968,"TRIMURTI, SRANDAKAN, BANTUL, DAERAH ISTIMEWA YOGYAKARTA",29,128,82,210
https://kawalpemilu.org#41968,"TRIMURTI, SRANDAKAN, BANTUL, DAERAH ISTIMEWA YOGYAKARTA",30,94,54,148
https://kawalpemilu.org#41968,"TRIMURTI, SRANDAKAN, BANTUL, DAERAH ISTIMEWA YOGYAKARTA",31,156,59,215
https://kawalpemilu.org#41968,"TRIMURTI, SRANDAKAN, BANTUL, DAERAH ISTIMEWA YOGYAKARTA",32,141,40,181
https://kawalpemilu.org#41968,"TRIMURTI, SRANDAKAN, BANTUL, DAERAH ISTIMEWA YOGYAKARTA",33,115,52,167
https://kawalpemilu.org#41968,"TRIMURTI, SRANDAKAN, BANTUL, DAERAH ISTIMEWA YOGYAKARTA",34,164,55,219
https://kawalpemilu.org#41968,"TRIMURTI, SRANDAKAN, BANTUL, DAERAH ISTIMEWA YOGYAKARTA",35,142,61,224
https://kawalpemilu.org#41968,"TRIMURTI, SRANDAKAN, BANTUL, DAERAH ISTIMEWA YOGYAKARTA",36,100,124,224
https://kawalpemilu.org#41968,"TRIMURTI, SRANDAKAN, BANTUL, DAERAH ISTIMEWA YOGYAKARTA",37,156,43,199
https://kawalpemilu.org#41968,"TRIMURTI, SRANDAKAN, BANTUL, DAERAH ISTIMEWA YOGYAKARTA",38,131,46,177
https://kawalpemilu.org#41968,"TRIMURTI, SRANDAKAN, BANTUL, DAERAH ISTIMEWA YOGYAKARTA",39,137,70,207
https://kawalpemilu.org#41968,"TRIMURTI, SRANDAKAN, BANTUL, DAERAH ISTIMEWA YOGYAKARTA",40,151,46,197
https://kawalpemilu.org#41968,"TRIMURTI, SRANDAKAN, BANTUL, DAERAH ISTIMEWA YOGYAKARTA",41,140,69,209
https://kawalpemilu.org#41968,"TRIMURTI, SRANDAKAN, BANTUL, DAERAH ISTIMEWA YOGYAKARTA",42,156,73,229
https://kawalpemilu.org#41968,"TRIMURTI, SRANDAKAN, BANTUL, DAERAH ISTIMEWA YOGYAKARTA",43,122,72,194
https://kawalpemilu.org#41968,"TRIMURTI, SRANDAKAN, BANTUL, DAERAH ISTIMEWA YOGYAKARTA",44,165,52,217
https://kawalpemilu.org#41968,"TRIMURTI, SRANDAKAN, BANTUL, DAERAH ISTIMEWA YOGYAKARTA",45,131,79,210
https://kawalpemilu.org#41968,"TRIMURTI, SRANDAKAN, BANTUL, DAERAH ISTIMEWA YOGYAKARTA",46,114,72,186
https://kawalpemilu.org#41968,"TRIMURTI, SRANDAKAN, BANTUL, DAERAH ISTIMEWA YOGYAKARTA",47,84,118,202
https://kawalpemilu.org#41968,"TRIMURTI, SRANDAKAN, BANTUL, DAERAH ISTIMEWA YOGYAKARTA",48,100,106,206
https://kawalpemilu.org#41968,"TRIMURTI, SRANDAKAN, BANTUL, DAERAH ISTIMEWA YOGYAKARTA",49,113,131,244
https://kawalpemilu.org#41968,"TRIMURTI, SRANDAKAN, BANTUL, DAERAH ISTIMEWA YOGYAKARTA",50,114,124,238
https://kawalpemilu.org#41968,"TRIMURTI, SRANDAKAN, BANTUL, DAERAH ISTIMEWA YOGYAKARTA",51,200,53,253
https://kawalpemilu.org#41968,"TRIMURTI, SRANDAKAN, BANTUL, DAERAH ISTIMEWA YOGYAKARTA",52,149,61,210
https://kawalpemilu.org#41968,"TRIMURTI, SRANDAKAN, BANTUL, DAERAH ISTIMEWA YOGYAKARTA",53,154,59,213
https://kawalpemilu.org#41968,"TRIMURTI, SRANDAKAN, BANTUL, DAERAH ISTIMEWA YOGYAKARTA",54,148,68,216
https://kawalpemilu.org#41968,"TRIMURTI, SRANDAKAN, BANTUL, DAERAH ISTIMEWA YOGYAKARTA",55,133,47,180
https://kawalpemilu.org#41968,"TRIMURTI, SRANDAKAN, BANTUL, DAERAH ISTIMEWA YOGYAKARTA",56,118,75,193
https://kawalpemilu.org#41968,"TRIMURTI, SRANDAKAN, BANTUL, DAERAH ISTIMEWA YOGYAKARTA",57,132,49,181
https://kawalpemilu.org#41968,"TRIMURTI, SRANDAKAN, BANTUL, DAERAH ISTIMEWA YOGYAKARTA",58,135,47,182
https://kawalpemilu.org#41968,"TRIMURTI, SRANDAKAN, BANTUL, DAERAH ISTIMEWA YOGYAKARTA",59,138,42,180
https://kawalpemilu.org#41968,"TRIMURTI, SRANDAKAN, BANTUL, DAERAH ISTIMEWA YOGYAKARTA",60,121,60,181
https://kawalpemilu.org#41968,"TRIMURTI, SRANDAKAN, BANTUL, DAERAH ISTIMEWA YOGYAKARTA",61,119,86,205
https://kawalpemilu.org#41970,"GADINGSARI, SANDEN, BANTUL, DAERAH ISTIMEWA YOGYAKARTA",1,90,89,179
https://kawalpemilu.org#41970,"GADINGSARI, SANDEN, BANTUL, DAERAH ISTIMEWA YOGYAKARTA",2,108,87,195
https://kawalpemilu.org#41970,"GADINGSARI, SANDEN, BANTUL, DAERAH ISTIMEWA YOGYAKARTA",3,139,82,221
https://kawalpemilu.org#41970,"GADINGSARI, SANDEN, BANTUL, DAERAH ISTIMEWA YOGYAKARTA",4,168,59,227
https://kawalpemilu.org#41970,"GADINGSARI, SANDEN, BANTUL, DAERAH ISTIMEWA YOGYAKARTA",5,61,69,130
https://kawalpemilu.org#41970,"GADINGSARI, SANDEN, BANTUL, DAERAH ISTIMEWA YOGYAKARTA",6,101,43,144
https://kawalpemilu.org#41970,"GADINGSARI, SANDEN, BANTUL, DAERAH ISTIMEWA YOGYAKARTA",7,151,51,202
https://kawalpemilu.org#41970,"GADINGSARI, SANDEN, BANTUL, DAERAH ISTIMEWA YOGYAKARTA",8,135,68,203
https://kawalpemilu.org#41970,"GADINGSARI, SANDEN, BANTUL, DAERAH ISTIMEWA YOGYAKARTA",9,104,77,181
https://kawalpemilu.org#41970,"GADINGSARI, SANDEN, BANTUL, DAERAH ISTIMEWA YOGYAKARTA",10,91,70,161
https://kawalpemilu.org#41970,"GADINGSARI, SANDEN, BANTUL, DAERAH ISTIMEWA YOGYAKARTA",11,81,67,148
https://kawalpemilu.org#41970,"GADINGSARI, SANDEN, BANTUL, DAERAH ISTIMEWA YOGYAKARTA",12,97,72,169
https://kawalpemilu.org#41970,"GADINGSARI, SANDEN, BANTUL, DAERAH ISTIMEWA YOGYAKARTA",13,108,54,162
https://kawalpemilu.org#41970,"GADINGSARI, SANDEN, BANTUL, DAERAH ISTIMEWA YOGYAKARTA",14,80,61,141
https://kawalpemilu.org#41970,"GADINGSARI, SANDEN, BANTUL, DAERAH ISTIMEWA YOGYAKARTA",15,107,50,157
https://kawalpemilu.org#41970,"GADINGSARI, SANDEN, BANTUL, DAERAH ISTIMEWA YOGYAKARTA",16,97,84,181
https://kawalpemilu.org#41970,"GADINGSARI, SANDEN, BANTUL, DAERAH ISTIMEWA YOGYAKARTA",17,80,93,173
https://kawalpemilu.org#41970,"GADINGSARI, SANDEN, BANTUL, DAERAH ISTIMEWA YOGYAKARTA",18,144,59,203
https://kawalpemilu.org#41970,"GADINGSARI, SANDEN, BANTUL, DAERAH ISTIMEWA YOGYAKARTA",19,100,42,142
https://kawalpemilu.org#41970,"GADINGSARI, SANDEN, BANTUL, DAERAH ISTIMEWA YOGYAKARTA",20,79,65,144
https://kawalpemilu.org#41970,"GADINGSARI, SANDEN, BANTUL, DAERAH ISTIMEWA YOGYAKARTA",21,83,51,134
https://kawalpemilu.org#41970,"GADINGSARI, SANDEN, BANTUL, DAERAH ISTIMEWA YOGYAKARTA",22,170,28,198
https://kawalpemilu.org#41970,"GADINGSARI, SANDEN, BANTUL, DAERAH ISTIMEWA YOGYAKARTA",23,107,90,197
https://kawalpemilu.org#41970,"GADINGSARI, SANDEN, BANTUL, DAERAH ISTIMEWA YOGYAKARTA",24,139,89,228
https://kawalpemilu.org#41970,"GADINGSARI, SANDEN, BANTUL, DAERAH ISTIMEWA YOGYAKARTA",25,131,103,234
https://kawalpemilu.org#41970,"GADINGSARI, SANDEN, BANTUL, DAERAH ISTIMEWA YOGYAKARTA",26,65,47,112
https://kawalpemilu.org#41970,"GADINGSARI, SANDEN, BANTUL, DAERAH ISTIMEWA YOGYAKARTA",27,55,52,107
https://kawalpemilu.org#41970,"GADINGSARI, SANDEN, BANTUL, DAERAH ISTIMEWA YOGYAKARTA",28,105,50,155
https://kawalpemilu.org#41970,"GADINGSARI, SANDEN, BANTUL, DAERAH ISTIMEWA YOGYAKARTA",29,90,97,187
https://kawalpemilu.org#41970,"GADINGSARI, SANDEN, BANTUL, DAERAH ISTIMEWA YOGYAKARTA",30,124,85,209
https://kawalpemilu.org#41970,"GADINGSARI, SANDEN, BANTUL, DAERAH ISTIMEWA YOGYAKARTA",31,99,50,149
https://kawalpemilu.org#41970,"GADINGSARI, SANDEN, BANTUL, DAERAH ISTIMEWA YOGYAKARTA",32,82,82,164
https://kawalpemilu.org#41970,"GADINGSARI, SANDEN, BANTUL, DAERAH ISTIMEWA YOGYAKARTA",33,84,69,153
https://kawalpemilu.org#41970,"GADINGSARI, SANDEN, BANTUL, DAERAH ISTIMEWA YOGYAKARTA",34,106,49,155
https://kawalpemilu.org#41970,"GADINGSARI, SANDEN, BANTUL, DAERAH ISTIMEWA YOGYAKARTA",35,143,44,187
https://kawalpemilu.org#41970,"GADINGSARI, SANDEN, BANTUL, DAERAH ISTIMEWA YOGYAKARTA",36,145,32,177
https://kawalpemilu.org#41970,"GADINGSARI, SANDEN, BANTUL, DAERAH ISTIMEWA YOGYAKARTA",37,146,29,175
https://kawalpemilu.org#41970,"GADINGSARI, SANDEN, BANTUL, DAERAH ISTIMEWA YOGYAKARTA",38,137,31,168
https://kawalpemilu.org#41970,"GADINGSARI, SANDEN, BANTUL, DAERAH ISTIMEWA YOGYAKARTA",39,78,60,138
https://kawalpemilu.org#41970,"GADINGSARI, SANDEN, BANTUL, DAERAH ISTIMEWA YOGYAKARTA",40,78,85,163
https://kawalpemilu.org#41971,"GADINGHARJO, SANDEN, BANTUL, DAERAH ISTIMEWA YOGYAKARTA",1,78,103,181
https://kawalpemilu.org#41971,"GADINGHARJO, SANDEN, BANTUL, DAERAH ISTIMEWA YOGYAKARTA",2,108,100,208
https://kawalpemilu.org#41971,"GADINGHARJO, SANDEN, BANTUL, DAERAH ISTIMEWA YOGYAKARTA",3,57,72,129
https://kawalpemilu.org#41971,"GADINGHARJO, SANDEN, BANTUL, DAERAH ISTIMEWA YOGYAKARTA",4,105,62,167
https://kawalpemilu.org#41971,"GADINGHARJO, SANDEN, BANTUL, DAERAH ISTIMEWA YOGYAKARTA",5,122,50,172
https://kawalpemilu.org#41971,"GADINGHARJO, SANDEN, BANTUL, DAERAH ISTIMEWA YOGYAKARTA",6,119,76,195
https://kawalpemilu.org#41971,"GADINGHARJO, SANDEN, BANTUL, DAERAH ISTIMEWA YOGYAKARTA",7,72,48,120
https://kawalpemilu.org#41971,"GADINGHARJO, SANDEN, BANTUL, DAERAH ISTIMEWA YOGYAKARTA",8,122,91,213
https://kawalpemilu.org#41971,"GADINGHARJO, SANDEN, BANTUL, DAERAH ISTIMEWA YOGYAKARTA",9,117,26,143
https://kawalpemilu.org#41971,"GADINGHARJO, SANDEN, BANTUL, DAERAH ISTIMEWA YOGYAKARTA",10,99,45,144
https://kawalpemilu.org#41971,"GADINGHARJO, SANDEN, BANTUL, DAERAH ISTIMEWA YOGYAKARTA",11,67,23,90
https://kawalpemilu.org#41971,"GADINGHARJO, SANDEN, BANTUL, DAERAH ISTIMEWA YOGYAKARTA",12,112,46,158
https://kawalpemilu.org#41971,"GADINGHARJO, SANDEN, BANTUL, DAERAH ISTIMEWA YOGYAKARTA",13,143,59,202
https://kawalpemilu.org#41971,"GADINGHARJO, SANDEN, BANTUL, DAERAH ISTIMEWA YOGYAKARTA",14,152,41,193
https://kawalpemilu.org#41971,"GADINGHARJO, SANDEN, BANTUL, DAERAH ISTIMEWA YOGYAKARTA",15,160,56,216
https://kawalpemilu.org#41972,"SRIGADING, SANDEN, BANTUL, DAERAH ISTIMEWA YOGYAKARTA",1,106,57,163
https://kawalpemilu.org#41972,"SRIGADING, SANDEN, BANTUL, DAERAH ISTIMEWA YOGYAKARTA",2,128,51,179
https://kawalpemilu.org#41972,"SRIGADING, SANDEN, BANTUL, DAERAH ISTIMEWA YOGYAKARTA",3,103,55,158
https://kawalpemilu.org#41972,"SRIGADING, SANDEN, BANTUL, DAERAH ISTIMEWA YOGYAKARTA",4,111,33,144
https://kawalpemilu.org#41972,"SRIGADING, SANDEN, BANTUL, DAERAH ISTIMEWA YOGYAKARTA",5,139,54,193
https://kawalpemilu.org#41972,"SRIGADING, SANDEN, BANTUL, DAERAH ISTIMEWA YOGYAKARTA",6,81,42,123
https://kawalpemilu.org#41972,"SRIGADING, SANDEN, BANTUL, DAERAH ISTIMEWA YOGYAKARTA",7,52,92,144
https://kawalpemilu.org#41972,"SRIGADING, SANDEN, BANTUL, DAERAH ISTIMEWA YOGYAKARTA",8,93,51,144
https://kawalpemilu.org#41972,"SRIGADING, SANDEN, BANTUL, DAERAH ISTIMEWA YOGYAKARTA",9,97,125,222
https://kawalpemilu.org#41972,"SRIGADING, SANDEN, BANTUL, DAERAH ISTIMEWA YOGYAKARTA",10,132,69,201
https://kawalpemilu.org#41972,"SRIGADING, SANDEN, BANTUL, DAERAH ISTIMEWA YOGYAKARTA",11,93,68,161
https://kawalpemilu.org#41972,"SRIGADING, SANDEN, BANTUL, DAERAH ISTIMEWA YOGYAKARTA",12,107,63,170
https://kawalpemilu.org#41972,"SRIGADING, SANDEN, BANTUL, DAERAH ISTIMEWA YOGYAKARTA",13,136,53,189
https://kawalpemilu.org#41972,"SRIGADING, SANDEN, BANTUL, DAERAH ISTIMEWA YOGYAKARTA",14,122,57,179
https://kawalpemilu.org#41972,"SRIGADING, SANDEN, BANTUL, DAERAH ISTIMEWA YOGYAKARTA",15,88,28,116
https://kawalpemilu.org#41972,"SRIGADING, SANDEN, BANTUL, DAERAH ISTIMEWA YOGYAKARTA",16,74,46,120
https://kawalpemilu.org#41972,"SRIGADING, SANDEN, BANTUL, DAERAH ISTIMEWA YOGYAKARTA",17,92,59,151
https://kawalpemilu.org#41972,"SRIGADING, SANDEN, BANTUL, DAERAH ISTIMEWA YOGYAKARTA",18,107,58,165
https://kawalpemilu.org#41972,"SRIGADING, SANDEN, BANTUL, DAERAH ISTIMEWA YOGYAKARTA",19,152,71,223
https://kawalpemilu.org#41972,"SRIGADING, SANDEN, BANTUL, DAERAH ISTIMEWA YOGYAKARTA",20,77,74,151
https://kawalpemilu.org#41972,"SRIGADING, SANDEN, BANTUL, DAERAH ISTIMEWA YOGYAKARTA",21,79,71,150
https://kawalpemilu.org#41972,"SRIGADING, SANDEN, BANTUL, DAERAH ISTIMEWA YOGYAKARTA",22,148,60,208
https://kawalpemilu.org#41972,"SRIGADING, SANDEN, BANTUL, DAERAH ISTIMEWA YOGYAKARTA",23,123,68,191
https://kawalpemilu.org#41972,"SRIGADING, SANDEN, BANTUL, DAERAH ISTIMEWA YOGYAKARTA",24,123,50,173
https://kawalpemilu.org#41972,"SRIGADING, SANDEN, BANTUL, DAERAH ISTIMEWA YOGYAKARTA",25,135,61,196
https://kawalpemilu.org#41972,"SRIGADING, SANDEN, BANTUL, DAERAH ISTIMEWA YOGYAKARTA",26,128,30,158
https://kawalpemilu.org#41972,"SRIGADING, SANDEN, BANTUL, DAERAH ISTIMEWA YOGYAKARTA",27,128,33,161
https://kawalpemilu.org#41972,"SRIGADING, SANDEN, BANTUL, DAERAH ISTIMEWA YOGYAKARTA",28,67,11,78
https://kawalpemilu.org#41972,"SRIGADING, SANDEN, BANTUL, DAERAH ISTIMEWA YOGYAKARTA",29,126,21,147
https://kawalpemilu.org#41972,"SRIGADING, SANDEN, BANTUL, DAERAH ISTIMEWA YOGYAKARTA",30,112,48,160
https://kawalpemilu.org#41972,"SRIGADING, SANDEN, BANTUL, DAERAH ISTIMEWA YOGYAKARTA",31,155,27,182
https://kawalpemilu.org#41972,"SRIGADING, SANDEN, BANTUL, DAERAH ISTIMEWA YOGYAKARTA",32,167,58,226
https://kawalpemilu.org#41972,"SRIGADING, SANDEN, BANTUL, DAERAH ISTIMEWA YOGYAKARTA",33,148,45,193
https://kawalpemilu.org#41972,"SRIGADING, SANDEN, BANTUL, DAERAH ISTIMEWA YOGYAKARTA",34,107,69,176
https://kawalpemilu.org#41972,"SRIGADING, SANDEN, BANTUL, DAERAH ISTIMEWA YOGYAKARTA",35,95,30,125
https://kawalpemilu.org#41972,"SRIGADING, SANDEN, BANTUL, DAERAH ISTIMEWA YOGYAKARTA",36,156,34,190
https://kawalpemilu.org#41972,"SRIGADING, SANDEN, BANTUL, DAERAH ISTIMEWA YOGYAKARTA",37,174,49,223
https://kawalpemilu.org#41972,"SRIGADING, SANDEN, BANTUL, DAERAH ISTIMEWA YOGYAKARTA",38,105,18,123
https://kawalpemilu.org#41972,"SRIGADING, SANDEN, BANTUL, DAERAH ISTIMEWA YOGYAKARTA",39,142,42,184
https://kawalpemilu.org#41972,"SRIGADING, SANDEN, BANTUL, DAERAH ISTIMEWA YOGYAKARTA",40,86,40,126
https://kawalpemilu.org#41973,"MURTIGADING, SANDEN, BANTUL, DAERAH ISTIMEWA YOGYAKARTA",1,96,72,168
https://kawalpemilu.org#41973,"MURTIGADING, SANDEN, BANTUL, DAERAH ISTIMEWA YOGYAKARTA",2,118,62,180
https://kawalpemilu.org#41973,"MURTIGADING, SANDEN, BANTUL, DAERAH ISTIMEWA YOGYAKARTA",3,97,131,228
https://kawalpemilu.org#41973,"MURTIGADING, SANDEN, BANTUL, DAERAH ISTIMEWA YOGYAKARTA",4,156,56,212
https://kawalpemilu.org#41973,"MURTIGADING, SANDEN, BANTUL, DAERAH ISTIMEWA YOGYAKARTA",5,78,88,166
https://kawalpemilu.org#41973,"MURTIGADING, SANDEN, BANTUL, DAERAH ISTIMEWA YOGYAKARTA",6,90,83,173
https://kawalpemilu.org#41973,"MURTIGADING, SANDEN, BANTUL, DAERAH ISTIMEWA YOGYAKARTA",7,106,135,241
https://kawalpemilu.org#41973,"MURTIGADING, SANDEN, BANTUL, DAERAH ISTIMEWA YOGYAKARTA",8,111,99,210
https://kawalpemilu.org#41973,"MURTIGADING, SANDEN, BANTUL, DAERAH ISTIMEWA YOGYAKARTA",9,69,131,200
https://kawalpemilu.org#41973,"MURTIGADING, SANDEN, BANTUL, DAERAH ISTIMEWA YOGYAKARTA",10,98,53,151
https://kawalpemilu.org#41973,"MURTIGADING, SANDEN, BANTUL, DAERAH ISTIMEWA YOGYAKARTA",11,84,80,164
https://kawalpemilu.org#41973,"MURTIGADING, SANDEN, BANTUL, DAERAH ISTIMEWA YOGYAKARTA",12,73,85,158
https://kawalpemilu.org#41973,"MURTIGADING, SANDEN, BANTUL, DAERAH ISTIMEWA YOGYAKARTA",13,70,92,162
https://kawalpemilu.org#41973,"MURTIGADING, SANDEN, BANTUL, DAERAH ISTIMEWA YOGYAKARTA",14,83,89,172
https://kawalpemilu.org#41973,"MURTIGADING, SANDEN, BANTUL, DAERAH ISTIMEWA YOGYAKARTA",15,116,84,200
https://kawalpemilu.org#41973,"MURTIGADING, SANDEN, BANTUL, DAERAH ISTIMEWA YOGYAKARTA",16,164,88,252
https://kawalpemilu.org#41973,"MURTIGADING, SANDEN, BANTUL, DAERAH ISTIMEWA YOGYAKARTA",17,113,82,195
https://kawalpemilu.org#41973,"MURTIGADING, SANDEN, BANTUL, DAERAH ISTIMEWA YOGYAKARTA",18,69,77,146
https://kawalpemilu.org#41973,"MURTIGADING, SANDEN, BANTUL, DAERAH ISTIMEWA YOGYAKARTA",19,70,71,141
https://kawalpemilu.org#41973,"MURTIGADING, SANDEN, BANTUL, DAERAH ISTIMEWA YOGYAKARTA",20,67,55,122
https://kawalpemilu.org#41973,"MURTIGADING, SANDEN, BANTUL, DAERAH ISTIMEWA YOGYAKARTA",21,81,36,117
https://kawalpemilu.org#41973,"MURTIGADING, SANDEN, BANTUL, DAERAH ISTIMEWA YOGYAKARTA",22,84,52,136
https://kawalpemilu.org#41973,"MURTIGADING, SANDEN, BANTUL, DAERAH ISTIMEWA YOGYAKARTA",23,95,82,177
https://kawalpemilu.org#41973,"MURTIGADING, SANDEN, BANTUL, DAERAH ISTIMEWA YOGYAKARTA",24,100,53,153
https://kawalpemilu.org#41973,"MURTIGADING, SANDEN, BANTUL, DAERAH ISTIMEWA YOGYAKARTA",25,72,48,120
https://kawalpemilu.org#41973,"MURTIGADING, SANDEN, BANTUL, DAERAH ISTIMEWA YOGYAKARTA",26,89,122,211
https://kawalpemilu.org#41973,"MURTIGADING, SANDEN, BANTUL, DAERAH ISTIMEWA YOGYAKARTA",27,61,106,167
https://kawalpemilu.org#41973,"MURTIGADING, SANDEN, BANTUL, DAERAH ISTIMEWA YOGYAKARTA",28,88,105,193
https://kawalpemilu.org#41973,"MURTIGADING, SANDEN, BANTUL, DAERAH ISTIMEWA YOGYAKARTA",29,96,21,117
https://kawalpemilu.org#41973,"MURTIGADING, SANDEN, BANTUL, DAERAH ISTIMEWA YOGYAKARTA",30,59,51,110
https://kawalpemilu.org#41973,"MURTIGADING, SANDEN, BANTUL, DAERAH ISTIMEWA YOGYAKARTA",31,70,36,106
https://kawalpemilu.org#41973,"MURTIGADING, SANDEN, BANTUL, DAERAH ISTIMEWA YOGYAKARTA",32,61,49,110
https://kawalpemilu.org#41973,"MURTIGADING, SANDEN, BANTUL, DAERAH ISTIMEWA YOGYAKARTA",33,120,27,147
https://kawalpemilu.org#41973,"MURTIGADING, SANDEN, BANTUL, DAERAH ISTIMEWA YOGYAKARTA",34,165,55,220
https://kawalpemilu.org#41975,"TIRTOMULYO, KRETEK, BANTUL, DAERAH ISTIMEWA YOGYAKARTA",1,102,72,174
https://kawalpemilu.org#41975,"TIRTOMULYO, KRETEK, BANTUL, DAERAH ISTIMEWA YOGYAKARTA",2,116,68,184
https://kawalpemilu.org#41975,"TIRTOMULYO, KRETEK, BANTUL, DAERAH ISTIMEWA YOGYAKARTA",3,125,65,190
https://kawalpemilu.org#41975,"TIRTOMULYO, KRETEK, BANTUL, DAERAH ISTIMEWA YOGYAKARTA",4,114,25,139
https://kawalpemilu.org#41975,"TIRTOMULYO, KRETEK, BANTUL, DAERAH ISTIMEWA YOGYAKARTA",5,114,65,179
https://kawalpemilu.org#41975,"TIRTOMULYO, KRETEK, BANTUL, DAERAH ISTIMEWA YOGYAKARTA",6,154,42,196
https://kawalpemilu.org#41975,"TIRTOMULYO, KRETEK, BANTUL, DAERAH ISTIMEWA YOGYAKARTA",7,98,44,142
https://kawalpemilu.org#41975,"TIRTOMULYO, KRETEK, BANTUL, DAERAH ISTIMEWA YOGYAKARTA",8,97,55,152
https://kawalpemilu.org#41975,"TIRTOMULYO, KRETEK, BANTUL, DAERAH ISTIMEWA YOGYAKARTA",9,91,58,149
https://kawalpemilu.org#41975,"TIRTOMULYO, KRETEK, BANTUL, DAERAH ISTIMEWA YOGYAKARTA",10,58,74,132
https://kawalpemilu.org#41975,"TIRTOMULYO, KRETEK, BANTUL, DAERAH ISTIMEWA YOGYAKARTA",11,76,31,107
https://kawalpemilu.org#41975,"TIRTOMULYO, KRETEK, BANTUL, DAERAH ISTIMEWA YOGYAKARTA",12,132,27,159
https://kawalpemilu.org#41975,"TIRTOMULYO, KRETEK, BANTUL, DAERAH ISTIMEWA YOGYAKARTA",13,160,86,246
https://kawalpemilu.org#41975,"TIRTOMULYO, KRETEK, BANTUL, DAERAH ISTIMEWA YOGYAKARTA",14,102,33,135
https://kawalpemilu.org#41975,"TIRTOMULYO, KRETEK, BANTUL, DAERAH ISTIMEWA YOGYAKARTA",15,110,38,148
https://kawalpemilu.org#41975,"TIRTOMULYO, KRETEK, BANTUL, DAERAH ISTIMEWA YOGYAKARTA",17,130,37,167
https://kawalpemilu.org#41975,"TIRTOMULYO, KRETEK, BANTUL, DAERAH ISTIMEWA YOGYAKARTA",18,99,61,160
https://kawalpemilu.org#41975,"TIRTOMULYO, KRETEK, BANTUL, DAERAH ISTIMEWA YOGYAKARTA",19,110,42,152
https://kawalpemilu.org#41975,"TIRTOMULYO, KRETEK, BANTUL, DAERAH ISTIMEWA YOGYAKARTA",20,141,37,178
https://kawalpemilu.org#41975,"TIRTOMULYO, KRETEK, BANTUL, DAERAH ISTIMEWA YOGYAKARTA",21,176,30,206
https://kawalpemilu.org#41975,"TIRTOMULYO, KRETEK, BANTUL, DAERAH ISTIMEWA YOGYAKARTA",22,114,36,150
https://kawalpemilu.org#41975,"TIRTOMULYO, KRETEK, BANTUL, DAERAH ISTIMEWA YOGYAKARTA",23,125,41,166
https://kawalpemilu.org#41975,"TIRTOMULYO, KRETEK, BANTUL, DAERAH ISTIMEWA YOGYAKARTA",24,125,35,160
https://kawalpemilu.org#41975,"TIRTOMULYO, KRETEK, BANTUL, DAERAH ISTIMEWA YOGYAKARTA",25,114,52,166
https://kawalpemilu.org#41975,"TIRTOMULYO, KRETEK, BANTUL, DAERAH ISTIMEWA YOGYAKARTA",26,144,30,174
https://kawalpemilu.org#41975,"TIRTOMULYO, KRETEK, BANTUL, DAERAH ISTIMEWA YOGYAKARTA",27,53,85,138
https://kawalpemilu.org#41975,"TIRTOMULYO, KRETEK, BANTUL, DAERAH ISTIMEWA YOGYAKARTA",28,98,57,155
https://kawalpemilu.org#41975,"TIRTOMULYO, KRETEK, BANTUL, DAERAH ISTIMEWA YOGYAKARTA",29,164,51,215
https://kawalpemilu.org#41976,"PARANGTRITIS, KRETEK, BANTUL, DAERAH ISTIMEWA YOGYAKARTA",1,77,117,194
https://kawalpemilu.org#41976,"PARANGTRITIS, KRETEK, BANTUL, DAERAH ISTIMEWA YOGYAKARTA",2,69,69,138
https://kawalpemilu.org#41976,"PARANGTRITIS, KRETEK, BANTUL, DAERAH ISTIMEWA YOGYAKARTA",3,100,101,201
https://kawalpemilu.org#41976,"PARANGTRITIS, KRETEK, BANTUL, DAERAH ISTIMEWA YOGYAKARTA",4,93,75,168
https://kawalpemilu.org#41976,"PARANGTRITIS, KRETEK, BANTUL, DAERAH ISTIMEWA YOGYAKARTA",5,145,102,247
https://kawalpemilu.org#41976,"PARANGTRITIS, KRETEK, BANTUL, DAERAH ISTIMEWA YOGYAKARTA",6,103,88,191
https://kawalpemilu.org#41976,"PARANGTRITIS, KRETEK, BANTUL, DAERAH ISTIMEWA YOGYAKARTA",7,70,156,226
https://kawalpemilu.org#41976,"PARANGTRITIS, KRETEK, BANTUL, DAERAH ISTIMEWA YOGYAKARTA",8,28,200,228
https://kawalpemilu.org#41976,"PARANGTRITIS, KRETEK, BANTUL, DAERAH ISTIMEWA YOGYAKARTA",9,41,52,93
https://kawalpemilu.org#41976,"PARANGTRITIS, KRETEK, BANTUL, DAERAH ISTIMEWA YOGYAKARTA",10,124,126,250
https://kawalpemilu.org#41976,"PARANGTRITIS, KRETEK, BANTUL, DAERAH ISTIMEWA YOGYAKARTA",11,98,138,236
https://kawalpemilu.org#41976,"PARANGTRITIS, KRETEK, BANTUL, DAERAH ISTIMEWA YOGYAKARTA",12,102,108,210
https://kawalpemilu.org#41976,"PARANGTRITIS, KRETEK, BANTUL, DAERAH ISTIMEWA YOGYAKARTA",13,113,64,177
https://kawalpemilu.org#41976,"PARANGTRITIS, KRETEK, BANTUL, DAERAH ISTIMEWA YOGYAKARTA",14,104,63,167
https://kawalpemilu.org#41976,"PARANGTRITIS, KRETEK, BANTUL, DAERAH ISTIMEWA YOGYAKARTA",15,107,45,152
https://kawalpemilu.org#41976,"PARANGTRITIS, KRETEK, BANTUL, DAERAH ISTIMEWA YOGYAKARTA",16,177,59,236
https://kawalpemilu.org#41976,"PARANGTRITIS, KRETEK, BANTUL, DAERAH ISTIMEWA YOGYAKARTA",17,168,53,221
https://kawalpemilu.org#41976,"PARANGTRITIS, KRETEK, BANTUL, DAERAH ISTIMEWA YOGYAKARTA",18,94,74,168
https://kawalpemilu.org#41976,"PARANGTRITIS, KRETEK, BANTUL, DAERAH ISTIMEWA YOGYAKARTA",19,121,50,171
https://kawalpemilu.org#41976,"PARANGTRITIS, KRETEK, BANTUL, DAERAH ISTIMEWA YOGYAKARTA",20,93,52,145
https://kawalpemilu.org#41976,"PARANGTRITIS, KRETEK, BANTUL, DAERAH ISTIMEWA YOGYAKARTA",21,88,58,146
https://kawalpemilu.org#41976,"PARANGTRITIS, KRETEK, BANTUL, DAERAH ISTIMEWA YOGYAKARTA",22,119,38,157
https://kawalpemilu.org#41976,"PARANGTRITIS, KRETEK, BANTUL, DAERAH ISTIMEWA YOGYAKARTA",23,96,34,130
https://kawalpemilu.org#41976,"PARANGTRITIS, KRETEK, BANTUL, DAERAH ISTIMEWA YOGYAKARTA",24,187,53,240
https://kawalpemilu.org#41976,"PARANGTRITIS, KRETEK, BANTUL, DAERAH ISTIMEWA YOGYAKARTA",25,181,56,237
https://kawalpemilu.org#41976,"PARANGTRITIS, KRETEK, BANTUL, DAERAH ISTIMEWA YOGYAKARTA",26,182,34,216
https://kawalpemilu.org#41976,"PARANGTRITIS, KRETEK, BANTUL, DAERAH ISTIMEWA YOGYAKARTA",27,159,55,214
https://kawalpemilu.org#41976,"PARANGTRITIS, KRETEK, BANTUL, DAERAH ISTIMEWA YOGYAKARTA",28,165,54,219
https://kawalpemilu.org#41977,"DONOTIRTO, KRETEK, BANTUL, DAERAH ISTIMEWA YOGYAKARTA",1,128,28,156
https://kawalpemilu.org#41977,"DONOTIRTO, KRETEK, BANTUL, DAERAH ISTIMEWA YOGYAKARTA",2,146,34,180
https://kawalpemilu.org#41977,"DONOTIRTO, KRETEK, BANTUL, DAERAH ISTIMEWA YOGYAKARTA",3,112,37,149
https://kawalpemilu.org#41977,"DONOTIRTO, KRETEK, BANTUL, DAERAH ISTIMEWA YOGYAKARTA",4,90,89,179
https://kawalpemilu.org#41977,"DONOTIRTO, KRETEK, BANTUL, DAERAH ISTIMEWA YOGYAKARTA",5,106,77,183
https://kawalpemilu.org#41977,"DONOTIRTO, KRETEK, BANTUL, DAERAH ISTIMEWA YOGYAKARTA",6,142,82,224
https://kawalpemilu.org#41977,"DONOTIRTO, KRETEK, BANTUL, DAERAH ISTIMEWA YOGYAKARTA",7,123,104,227
https://kawalpemilu.org#41977,"DONOTIRTO, KRETEK, BANTUL, DAERAH ISTIMEWA YOGYAKARTA",8,98,91,189
https://kawalpemilu.org#41977,"DONOTIRTO, KRETEK, BANTUL, DAERAH ISTIMEWA YOGYAKARTA",9,106,82,188
https://kawalpemilu.org#41977,"DONOTIRTO, KRETEK, BANTUL, DAERAH ISTIMEWA YOGYAKARTA",10,106,83,189
https://kawalpemilu.org#41977,"DONOTIRTO, KRETEK, BANTUL, DAERAH ISTIMEWA YOGYAKARTA",11,187,39,226
https://kawalpemilu.org#41977,"DONOTIRTO, KRETEK, BANTUL, DAERAH ISTIMEWA YOGYAKARTA",12,154,62,216
https://kawalpemilu.org#41977,"DONOTIRTO, KRETEK, BANTUL, DAERAH ISTIMEWA YOGYAKARTA",13,146,55,201
https://kawalpemilu.org#41977,"DONOTIRTO, KRETEK, BANTUL, DAERAH ISTIMEWA YOGYAKARTA",14,115,93,208
https://kawalpemilu.org#41977,"DONOTIRTO, KRETEK, BANTUL, DAERAH ISTIMEWA YOGYAKARTA",15,109,49,158
https://kawalpemilu.org#41977,"DONOTIRTO, KRETEK, BANTUL, DAERAH ISTIMEWA YOGYAKARTA",16,107,62,169
https://kawalpemilu.org#41977,"DONOTIRTO, KRETEK, BANTUL, DAERAH ISTIMEWA YOGYAKARTA",17,85,81,166
https://kawalpemilu.org#41977,"DONOTIRTO, KRETEK, BANTUL, DAERAH ISTIMEWA YOGYAKARTA",18,86,89,175
https://kawalpemilu.org#41977,"DONOTIRTO, KRETEK, BANTUL, DAERAH ISTIMEWA YOGYAKARTA",19,116,41,157
https://kawalpemilu.org#41977,"DONOTIRTO, KRETEK, BANTUL, DAERAH ISTIMEWA YOGYAKARTA",20,120,51,171
https://kawalpemilu.org#41977,"DONOTIRTO, KRETEK, BANTUL, DAERAH ISTIMEWA YOGYAKARTA",21,145,96,241
https://kawalpemilu.org#41977,"DONOTIRTO, KRETEK, BANTUL, DAERAH ISTIMEWA YOGYAKARTA",22,155,74,229
https://kawalpemilu.org#41977,"DONOTIRTO, KRETEK, BANTUL, DAERAH ISTIMEWA YOGYAKARTA",23,182,48,230
https://kawalpemilu.org#41977,"DONOTIRTO, KRETEK, BANTUL, DAERAH ISTIMEWA YOGYAKARTA",24,165,71,236
https://kawalpemilu.org#41977,"DONOTIRTO, KRETEK, BANTUL, DAERAH ISTIMEWA YOGYAKARTA",25,197,47,244
https://kawalpemilu.org#41977,"DONOTIRTO, KRETEK, BANTUL, DAERAH ISTIMEWA YOGYAKARTA",26,186,56,242
https://kawalpemilu.org#41977,"DONOTIRTO, KRETEK, BANTUL, DAERAH ISTIMEWA YOGYAKARTA",27,127,47,174
https://kawalpemilu.org#41977,"DONOTIRTO, KRETEK, BANTUL, DAERAH ISTIMEWA YOGYAKARTA",28,151,47,198
https://kawalpemilu.org#41977,"DONOTIRTO, KRETEK, BANTUL, DAERAH ISTIMEWA YOGYAKARTA",29,154,47,201
https://kawalpemilu.org#41978,"TIRTOSARI, KRETEK, BANTUL, DAERAH ISTIMEWA YOGYAKARTA",1,127,64,191
https://kawalpemilu.org#41978,"TIRTOSARI, KRETEK, BANTUL, DAERAH ISTIMEWA YOGYAKARTA",4,86,28,114
https://kawalpemilu.org#41978,"TIRTOSARI, KRETEK, BANTUL, DAERAH ISTIMEWA YOGYAKARTA",5,138,36,174
https://kawalpemilu.org#41978,"TIRTOSARI, KRETEK, BANTUL, DAERAH ISTIMEWA YOGYAKARTA",6,105,46,151
https://kawalpemilu.org#41978,"TIRTOSARI, KRETEK, BANTUL, DAERAH ISTIMEWA YOGYAKARTA",7,112,51,163
https://kawalpemilu.org#41978,"TIRTOSARI, KRETEK, BANTUL, DAERAH ISTIMEWA YOGYAKARTA",8,193,44,237
https://kawalpemilu.org#41978,"TIRTOSARI, KRETEK, BANTUL, DAERAH ISTIMEWA YOGYAKARTA",9,174,70,244
https://kawalpemilu.org#41978,"TIRTOSARI, KRETEK, BANTUL, DAERAH ISTIMEWA YOGYAKARTA",10,144,42,186
https://kawalpemilu.org#41978,"TIRTOSARI, KRETEK, BANTUL, DAERAH ISTIMEWA YOGYAKARTA",11,119,42,161
https://kawalpemilu.org#41978,"TIRTOSARI, KRETEK, BANTUL, DAERAH ISTIMEWA YOGYAKARTA",12,124,46,170
https://kawalpemilu.org#41978,"TIRTOSARI, KRETEK, BANTUL, DAERAH ISTIMEWA YOGYAKARTA",13,126,56,182
https://kawalpemilu.org#41978,"TIRTOSARI, KRETEK, BANTUL, DAERAH ISTIMEWA YOGYAKARTA",14,137,43,180
https://kawalpemilu.org#41978,"TIRTOSARI, KRETEK, BANTUL, DAERAH ISTIMEWA YOGYAKARTA",15,86,57,143
https://kawalpemilu.org#41978,"TIRTOSARI, KRETEK, BANTUL, DAERAH ISTIMEWA YOGYAKARTA",16,113,51,164
https://kawalpemilu.org#41978,"TIRTOSARI, KRETEK, BANTUL, DAERAH ISTIMEWA YOGYAKARTA",17,114,52,166
https://kawalpemilu.org#41979,"TIRTOHARGO, KRETEK, BANTUL, DAERAH ISTIMEWA YOGYAKARTA",1,157,31,188
https://kawalpemilu.org#41979,"TIRTOHARGO, KRETEK, BANTUL, DAERAH ISTIMEWA YOGYAKARTA",2,181,35,216
https://kawalpemilu.org#41979,"TIRTOHARGO, KRETEK, BANTUL, DAERAH ISTIMEWA YOGYAKARTA",3,199,31,230
https://kawalpemilu.org#41979,"TIRTOHARGO, KRETEK, BANTUL, DAERAH ISTIMEWA YOGYAKARTA",4,155,40,195
https://kawalpemilu.org#41979,"TIRTOHARGO, KRETEK, BANTUL, DAERAH ISTIMEWA YOGYAKARTA",5,91,39,130
https://kawalpemilu.org#41979,"TIRTOHARGO, KRETEK, BANTUL, DAERAH ISTIMEWA YOGYAKARTA",6,74,26,100
https://kawalpemilu.org#41979,"TIRTOHARGO, KRETEK, BANTUL, DAERAH ISTIMEWA YOGYAKARTA",7,120,50,170
https://kawalpemilu.org#41979,"TIRTOHARGO, KRETEK, BANTUL, DAERAH ISTIMEWA YOGYAKARTA",8,107,48,155
https://kawalpemilu.org#41979,"TIRTOHARGO, KRETEK, BANTUL, DAERAH ISTIMEWA YOGYAKARTA",9,132,68,200
https://kawalpemilu.org#41979,"TIRTOHARGO, KRETEK, BANTUL, DAERAH ISTIMEWA YOGYAKARTA",10,107,39,146
https://kawalpemilu.org#41979,"TIRTOHARGO, KRETEK, BANTUL, DAERAH ISTIMEWA YOGYAKARTA",11,161,17,178
https://kawalpemilu.org#41979,"TIRTOHARGO, KRETEK, BANTUL, DAERAH ISTIMEWA YOGYAKARTA",12,142,36,178
https://kawalpemilu.org#41981,"SELOHARJO, PUNDONG, BANTUL, DAERAH ISTIMEWA YOGYAKARTA",1,170,90,260
https://kawalpemilu.org#41981,"SELOHARJO, PUNDONG, BANTUL, DAERAH ISTIMEWA YOGYAKARTA",2,184,49,233
https://kawalpemilu.org#41981,"SELOHARJO, PUNDONG, BANTUL, DAERAH ISTIMEWA YOGYAKARTA",3,128,38,166
https://kawalpemilu.org#41981,"SELOHARJO, PUNDONG, BANTUL, DAERAH ISTIMEWA YOGYAKARTA",4,153,48,201
https://kawalpemilu.org#41981,"SELOHARJO, PUNDONG, BANTUL, DAERAH ISTIMEWA YOGYAKARTA",5,102,162,264
https://kawalpemilu.org#41981,"SELOHARJO, PUNDONG, BANTUL, DAERAH ISTIMEWA YOGYAKARTA",6,130,80,210
https://kawalpemilu.org#41981,"SELOHARJO, PUNDONG, BANTUL, DAERAH ISTIMEWA YOGYAKARTA",7,77,68,145
https://kawalpemilu.org#41981,"SELOHARJO, PUNDONG, BANTUL, DAERAH ISTIMEWA YOGYAKARTA",8,100,102,202
https://kawalpemilu.org#41981,"SELOHARJO, PUNDONG, BANTUL, DAERAH ISTIMEWA YOGYAKARTA",9,84,66,150
https://kawalpemilu.org#41981,"SELOHARJO, PUNDONG, BANTUL, DAERAH ISTIMEWA YOGYAKARTA",10,172,76,248
https://kawalpemilu.org#41981,"SELOHARJO, PUNDONG, BANTUL, DAERAH ISTIMEWA YOGYAKARTA",11,162,24,186
https://kawalpemilu.org#41981,"SELOHARJO, PUNDONG, BANTUL, DAERAH ISTIMEWA YOGYAKARTA",12,76,44,120
https://kawalpemilu.org#41981,"SELOHARJO, PUNDONG, BANTUL, DAERAH ISTIMEWA YOGYAKARTA",13,147,48,195
https://kawalpemilu.org#41981,"SELOHARJO, PUNDONG, BANTUL, DAERAH ISTIMEWA YOGYAKARTA",14,184,60,244
https://kawalpemilu.org#41981,"SELOHARJO, PUNDONG, BANTUL, DAERAH ISTIMEWA YOGYAKARTA",15,145,89,234
https://kawalpemilu.org#41981,"SELOHARJO, PUNDONG, BANTUL, DAERAH ISTIMEWA YOGYAKARTA",16,136,29,165
https://kawalpemilu.org#41981,"SELOHARJO, PUNDONG, BANTUL, DAERAH ISTIMEWA YOGYAKARTA",17,110,40,150
https://kawalpemilu.org#41981,"SELOHARJO, PUNDONG, BANTUL, DAERAH ISTIMEWA YOGYAKARTA",18,84,28,112
https://kawalpemilu.org#41981,"SELOHARJO, PUNDONG, BANTUL, DAERAH ISTIMEWA YOGYAKARTA",19,184,46,230
https://kawalpemilu.org#41981,"SELOHARJO, PUNDONG, BANTUL, DAERAH ISTIMEWA YOGYAKARTA",20,172,54,226
https://kawalpemilu.org#41981,"SELOHARJO, PUNDONG, BANTUL, DAERAH ISTIMEWA YOGYAKARTA",21,155,59,214
https://kawalpemilu.org#41981,"SELOHARJO, PUNDONG, BANTUL, DAERAH ISTIMEWA YOGYAKARTA",22,142,53,195
https://kawalpemilu.org#41981,"SELOHARJO, PUNDONG, BANTUL, DAERAH ISTIMEWA YOGYAKARTA",23,127,54,181
https://kawalpemilu.org#41981,"SELOHARJO, PUNDONG, BANTUL, DAERAH ISTIMEWA YOGYAKARTA",24,171,38,209
https://kawalpemilu.org#41981,"SELOHARJO, PUNDONG, BANTUL, DAERAH ISTIMEWA YOGYAKARTA",25,125,60,185
https://kawalpemilu.org#41981,"SELOHARJO, PUNDONG, BANTUL, DAERAH ISTIMEWA YOGYAKARTA",26,97,94,191
https://kawalpemilu.org#41981,"SELOHARJO, PUNDONG, BANTUL, DAERAH ISTIMEWA YOGYAKARTA",27,63,69,132
https://kawalpemilu.org#41981,"SELOHARJO, PUNDONG, BANTUL, DAERAH ISTIMEWA YOGYAKARTA",28,68,160,228
https://kawalpemilu.org#41981,"SELOHARJO, PUNDONG, BANTUL, DAERAH ISTIMEWA YOGYAKARTA",29,117,92,209
https://kawalpemilu.org#41981,"SELOHARJO, PUNDONG, BANTUL, DAERAH ISTIMEWA YOGYAKARTA",30,189,64,253
https://kawalpemilu.org#41981,"SELOHARJO, PUNDONG, BANTUL, DAERAH ISTIMEWA YOGYAKARTA",31,112,36,148
https://kawalpemilu.org#41981,"SELOHARJO, PUNDONG, BANTUL, DAERAH ISTIMEWA YOGYAKARTA",32,80,74,154
https://kawalpemilu.org#41981,"SELOHARJO, PUNDONG, BANTUL, DAERAH ISTIMEWA YOGYAKARTA",33,146,115,261
https://kawalpemilu.org#41981,"SELOHARJO, PUNDONG, BANTUL, DAERAH ISTIMEWA YOGYAKARTA",34,104,29,133
https://kawalpemilu.org#41981,"SELOHARJO, PUNDONG, BANTUL, DAERAH ISTIMEWA YOGYAKARTA",35,104,77,181
https://kawalpemilu.org#41981,"SELOHARJO, PUNDONG, BANTUL, DAERAH ISTIMEWA YOGYAKARTA",36,151,34,185
https://kawalpemilu.org#41981,"SELOHARJO, PUNDONG, BANTUL, DAERAH ISTIMEWA YOGYAKARTA",37,129,56,185
https://kawalpemilu.org#41981,"SELOHARJO, PUNDONG, BANTUL, DAERAH ISTIMEWA YOGYAKARTA",38,151,64,215
https://kawalpemilu.org#41981,"SELOHARJO, PUNDONG, BANTUL, DAERAH ISTIMEWA YOGYAKARTA",39,179,54,233
https://kawalpemilu.org#41981,"SELOHARJO, PUNDONG, BANTUL, DAERAH ISTIMEWA YOGYAKARTA",40,161,35,196
https://kawalpemilu.org#41981,"SELOHARJO, PUNDONG, BANTUL, DAERAH ISTIMEWA YOGYAKARTA",41,130,40,170
https://kawalpemilu.org#41982,"PANJANGREJO, PUNDONG, BANTUL, DAERAH ISTIMEWA YOGYAKARTA",1,124,43,167
https://kawalpemilu.org#41982,"PANJANGREJO, PUNDONG, BANTUL, DAERAH ISTIMEWA YOGYAKARTA",2,164,25,189
https://kawalpemilu.org#41982,"PANJANGREJO, PUNDONG, BANTUL, DAERAH ISTIMEWA YOGYAKARTA",3,147,47,194
https://kawalpemilu.org#41982,"PANJANGREJO, PUNDONG, BANTUL, DAERAH ISTIMEWA YOGYAKARTA",4,143,53,196
https://kawalpemilu.org#41982,"PANJANGREJO, PUNDONG, BANTUL, DAERAH ISTIMEWA YOGYAKARTA",5,95,41,136
https://kawalpemilu.org#41982,"PANJANGREJO, PUNDONG, BANTUL, DAERAH ISTIMEWA YOGYAKARTA",6,174,38,212
https://kawalpemilu.org#41982,"PANJANGREJO, PUNDONG, BANTUL, DAERAH ISTIMEWA YOGYAKARTA",7,154,27,181
https://kawalpemilu.org#41982,"PANJANGREJO, PUNDONG, BANTUL, DAERAH ISTIMEWA YOGYAKARTA",8,171,37,208
https://kawalpemilu.org#41982,"PANJANGREJO, PUNDONG, BANTUL, DAERAH ISTIMEWA YOGYAKARTA",9,192,24,216
https://kawalpemilu.org#41982,"PANJANGREJO, PUNDONG, BANTUL, DAERAH ISTIMEWA YOGYAKARTA",10,150,42,192
https://kawalpemilu.org#41982,"PANJANGREJO, PUNDONG, BANTUL, DAERAH ISTIMEWA YOGYAKARTA",11,127,75,202
https://kawalpemilu.org#41982,"PANJANGREJO, PUNDONG, BANTUL, DAERAH ISTIMEWA YOGYAKARTA",12,214,52,226
https://kawalpemilu.org#41982,"PANJANGREJO, PUNDONG, BANTUL, DAERAH ISTIMEWA YOGYAKARTA",13,174,37,211
https://kawalpemilu.org#41982,"PANJANGREJO, PUNDONG, BANTUL, DAERAH ISTIMEWA YOGYAKARTA",14,107,27,134
https://kawalpemilu.org#41982,"PANJANGREJO, PUNDONG, BANTUL, DAERAH ISTIMEWA YOGYAKARTA",15,149,53,202
https://kawalpemilu.org#41982,"PANJANGREJO, PUNDONG, BANTUL, DAERAH ISTIMEWA YOGYAKARTA",16,151,39,190
https://kawalpemilu.org#41982,"PANJANGREJO, PUNDONG, BANTUL, DAERAH ISTIMEWA YOGYAKARTA",17,156,24,180
https://kawalpemilu.org#41982,"PANJANGREJO, PUNDONG, BANTUL, DAERAH ISTIMEWA YOGYAKARTA",18,145,27,172
https://kawalpemilu.org#41982,"PANJANGREJO, PUNDONG, BANTUL, DAERAH ISTIMEWA YOGYAKARTA",19,129,45,174
https://kawalpemilu.org#41982,"PANJANGREJO, PUNDONG, BANTUL, DAERAH ISTIMEWA YOGYAKARTA",20,158,32,190
https://kawalpemilu.org#41982,"PANJANGREJO, PUNDONG, BANTUL, DAERAH ISTIMEWA YOGYAKARTA",21,145,68,213
https://kawalpemilu.org#41982,"PANJANGREJO, PUNDONG, BANTUL, DAERAH ISTIMEWA YOGYAKARTA",22,51,50,101
https://kawalpemilu.org#41982,"PANJANGREJO, PUNDONG, BANTUL, DAERAH ISTIMEWA YOGYAKARTA",23,115,30,145
https://kawalpemilu.org#41982,"PANJANGREJO, PUNDONG, BANTUL, DAERAH ISTIMEWA YOGYAKARTA",24,109,39,148
https://kawalpemilu.org#41982,"PANJANGREJO, PUNDONG, BANTUL, DAERAH ISTIMEWA YOGYAKARTA",25,139,35,174
https://kawalpemilu.org#41982,"PANJANGREJO, PUNDONG, BANTUL, DAERAH ISTIMEWA YOGYAKARTA",26,148,37,185
https://kawalpemilu.org#41982,"PANJANGREJO, PUNDONG, BANTUL, DAERAH ISTIMEWA YOGYAKARTA",27,164,64,228
https://kawalpemilu.org#41982,"PANJANGREJO, PUNDONG, BANTUL, DAERAH ISTIMEWA YOGYAKARTA",28,144,80,224
https://kawalpemilu.org#41982,"PANJANGREJO, PUNDONG, BANTUL, DAERAH ISTIMEWA YOGYAKARTA",29,151,43,194
https://kawalpemilu.org#41982,"PANJANGREJO, PUNDONG, BANTUL, DAERAH ISTIMEWA YOGYAKARTA",30,175,31,206
https://kawalpemilu.org#41982,"PANJANGREJO, PUNDONG, BANTUL, DAERAH ISTIMEWA YOGYAKARTA",31,119,21,140
https://kawalpemilu.org#41982,"PANJANGREJO, PUNDONG, BANTUL, DAERAH ISTIMEWA YOGYAKARTA",32,157,48,205
https://kawalpemilu.org#41982,"PANJANGREJO, PUNDONG, BANTUL, DAERAH ISTIMEWA YOGYAKARTA",33,162,11,173
https://kawalpemilu.org#41982,"PANJANGREJO, PUNDONG, BANTUL, DAERAH ISTIMEWA YOGYAKARTA",34,122,40,162
https://kawalpemilu.org#41982,"PANJANGREJO, PUNDONG, BANTUL, DAERAH ISTIMEWA YOGYAKARTA",35,159,47,206
https://kawalpemilu.org#41983,"SRIHARDONO, PUNDONG, BANTUL, DAERAH ISTIMEWA YOGYAKARTA",1,154,68,222
https://kawalpemilu.org#41983,"SRIHARDONO, PUNDONG, BANTUL, DAERAH ISTIMEWA YOGYAKARTA",2,124,55,179
https://kawalpemilu.org#41983,"SRIHARDONO, PUNDONG, BANTUL, DAERAH ISTIMEWA YOGYAKARTA",3,151,56,207
https://kawalpemilu.org#41983,"SRIHARDONO, PUNDONG, BANTUL, DAERAH ISTIMEWA YOGYAKARTA",4,121,35,156
https://kawalpemilu.org#41983,"SRIHARDONO, PUNDONG, BANTUL, DAERAH ISTIMEWA YOGYAKARTA",5,144,53,197
https://kawalpemilu.org#41983,"SRIHARDONO, PUNDONG, BANTUL, DAERAH ISTIMEWA YOGYAKARTA",6,169,62,231
https://kawalpemilu.org#41983,"SRIHARDONO, PUNDONG, BANTUL, DAERAH ISTIMEWA YOGYAKARTA",7,107,44,151
https://kawalpemilu.org#41983,"SRIHARDONO, PUNDONG, BANTUL, DAERAH ISTIMEWA YOGYAKARTA",8,137,53,190
https://kawalpemilu.org#41983,"SRIHARDONO, PUNDONG, BANTUL, DAERAH ISTIMEWA YOGYAKARTA",9,207,33,240
https://kawalpemilu.org#41983,"SRIHARDONO, PUNDONG, BANTUL, DAERAH ISTIMEWA YOGYAKARTA",10,154,37,191
https://kawalpemilu.org#41983,"SRIHARDONO, PUNDONG, BANTUL, DAERAH ISTIMEWA YOGYAKARTA",11,157,52,209
https://kawalpemilu.org#41983,"SRIHARDONO, PUNDONG, BANTUL, DAERAH ISTIMEWA YOGYAKARTA",12,169,32,201
https://kawalpemilu.org#41983,"SRIHARDONO, PUNDONG, BANTUL, DAERAH ISTIMEWA YOGYAKARTA",13,132,51,183
https://kawalpemilu.org#41983,"SRIHARDONO, PUNDONG, BANTUL, DAERAH ISTIMEWA YOGYAKARTA",14,111,94,205
https://kawalpemilu.org#41983,"SRIHARDONO, PUNDONG, BANTUL, DAERAH ISTIMEWA YOGYAKARTA",15,149,56,205
https://kawalpemilu.org#41983,"SRIHARDONO, PUNDONG, BANTUL, DAERAH ISTIMEWA YOGYAKARTA",16,196,33,229
https://kawalpemilu.org#41983,"SRIHARDONO, PUNDONG, BANTUL, DAERAH ISTIMEWA YOGYAKARTA",17,128,120,248
https://kawalpemilu.org#41983,"SRIHARDONO, PUNDONG, BANTUL, DAERAH ISTIMEWA YOGYAKARTA",18,124,39,163
https://kawalpemilu.org#41983,"SRIHARDONO, PUNDONG, BANTUL, DAERAH ISTIMEWA YOGYAKARTA",19,120,59,179
https://kawalpemilu.org#41983,"SRIHARDONO, PUNDONG, BANTUL, DAERAH ISTIMEWA YOGYAKARTA",20,173,63,236
https://kawalpemilu.org#41983,"SRIHARDONO, PUNDONG, BANTUL, DAERAH ISTIMEWA YOGYAKARTA",21,137,65,202
https://kawalpemilu.org#41983,"SRIHARDONO, PUNDONG, BANTUL, DAERAH ISTIMEWA YOGYAKARTA",22,151,53,204
https://kawalpemilu.org#41983,"SRIHARDONO, PUNDONG, BANTUL, DAERAH ISTIMEWA YOGYAKARTA",23,66,39,105
https://kawalpemilu.org#41983,"SRIHARDONO, PUNDONG, BANTUL, DAERAH ISTIMEWA YOGYAKARTA",24,129,62,191
https://kawalpemilu.org#41983,"SRIHARDONO, PUNDONG, BANTUL, DAERAH ISTIMEWA YOGYAKARTA",25,145,41,186
https://kawalpemilu.org#41983,"SRIHARDONO, PUNDONG, BANTUL, DAERAH ISTIMEWA YOGYAKARTA",26,199,41,240
https://kawalpemilu.org#41983,"SRIHARDONO, PUNDONG, BANTUL, DAERAH ISTIMEWA YOGYAKARTA",27,171,50,221
https://kawalpemilu.org#41983,"SRIHARDONO, PUNDONG, BANTUL, DAERAH ISTIMEWA YOGYAKARTA",28,148,97,245
https://kawalpemilu.org#41983,"SRIHARDONO, PUNDONG, BANTUL, DAERAH ISTIMEWA YOGYAKARTA",29,182,35,217
https://kawalpemilu.org#41983,"SRIHARDONO, PUNDONG, BANTUL, DAERAH ISTIMEWA YOGYAKARTA",30,105,48,153
https://kawalpemilu.org#41983,"SRIHARDONO, PUNDONG, BANTUL, DAERAH ISTIMEWA YOGYAKARTA",31,166,38,204
https://kawalpemilu.org#41983,"SRIHARDONO, PUNDONG, BANTUL, DAERAH ISTIMEWA YOGYAKARTA",32,115,34,149
https://kawalpemilu.org#41983,"SRIHARDONO, PUNDONG, BANTUL, DAERAH ISTIMEWA YOGYAKARTA",33,204,65,269
https://kawalpemilu.org#41983,"SRIHARDONO, PUNDONG, BANTUL, DAERAH ISTIMEWA YOGYAKARTA",34,156,49,205
https://kawalpemilu.org#41983,"SRIHARDONO, PUNDONG, BANTUL, DAERAH ISTIMEWA YOGYAKARTA",35,125,72,197
https://kawalpemilu.org#41983,"SRIHARDONO, PUNDONG, BANTUL, DAERAH ISTIMEWA YOGYAKARTA",36,163,26,189
https://kawalpemilu.org#41983,"SRIHARDONO, PUNDONG, BANTUL, DAERAH ISTIMEWA YOGYAKARTA",37,232,19,251
https://kawalpemilu.org#41983,"SRIHARDONO, PUNDONG, BANTUL, DAERAH ISTIMEWA YOGYAKARTA",38,104,123,227
https://kawalpemilu.org#41983,"SRIHARDONO, PUNDONG, BANTUL, DAERAH ISTIMEWA YOGYAKARTA",39,125,105,230
https://kawalpemilu.org#41983,"SRIHARDONO, PUNDONG, BANTUL, DAERAH ISTIMEWA YOGYAKARTA",40,180,27,207
https://kawalpemilu.org#41983,"SRIHARDONO, PUNDONG, BANTUL, DAERAH ISTIMEWA YOGYAKARTA",41,160,38,198
https://kawalpemilu.org#41983,"SRIHARDONO, PUNDONG, BANTUL, DAERAH ISTIMEWA YOGYAKARTA",42,167,43,210
https://kawalpemilu.org#41983,"SRIHARDONO, PUNDONG, BANTUL, DAERAH ISTIMEWA YOGYAKARTA",43,182,29,211
https://kawalpemilu.org#41983,"SRIHARDONO, PUNDONG, BANTUL, DAERAH ISTIMEWA YOGYAKARTA",44,181,39,220
https://kawalpemilu.org#41983,"SRIHARDONO, PUNDONG, BANTUL, DAERAH ISTIMEWA YOGYAKARTA",45,129,31,160
https://kawalpemilu.org#41983,"SRIHARDONO, PUNDONG, BANTUL, DAERAH ISTIMEWA YOGYAKARTA",46,113,41,154
https://kawalpemilu.org#41983,"SRIHARDONO, PUNDONG, BANTUL, DAERAH ISTIMEWA YOGYAKARTA",47,146,18,164
https://kawalpemilu.org#41983,"SRIHARDONO, PUNDONG, BANTUL, DAERAH ISTIMEWA YOGYAKARTA",48,123,46,169
https://kawalpemilu.org#41985,"SIDOMULYO, BAMBANGLIPURO, BANTUL, DAERAH ISTIMEWA YOGYAKARTA",1,181,68,249
https://kawalpemilu.org#41985,"SIDOMULYO, BAMBANGLIPURO, BANTUL, DAERAH ISTIMEWA YOGYAKARTA",2,149,110,259
https://kawalpemilu.org#41985,"SIDOMULYO, BAMBANGLIPURO, BANTUL, DAERAH ISTIMEWA YOGYAKARTA",3,136,81,217
https://kawalpemilu.org#41985,"SIDOMULYO, BAMBANGLIPURO, BANTUL, DAERAH ISTIMEWA YOGYAKARTA",4,106,95,201
https://kawalpemilu.org#41985,"SIDOMULYO, BAMBANGLIPURO, BANTUL, DAERAH ISTIMEWA YOGYAKARTA",5,150,33,183
https://kawalpemilu.org#41985,"SIDOMULYO, BAMBANGLIPURO, BANTUL, DAERAH ISTIMEWA YOGYAKARTA",6,171,66,237
https://kawalpemilu.org#41985,"SIDOMULYO, BAMBANGLIPURO, BANTUL, DAERAH ISTIMEWA YOGYAKARTA",7,117,47,164
https://kawalpemilu.org#41985,"SIDOMULYO, BAMBANGLIPURO, BANTUL, DAERAH ISTIMEWA YOGYAKARTA",8,121,50,171
https://kawalpemilu.org#41985,"SIDOMULYO, BAMBANGLIPURO, BANTUL, DAERAH ISTIMEWA YOGYAKARTA",9,135,63,198
https://kawalpemilu.org#41985,"SIDOMULYO, BAMBANGLIPURO, BANTUL, DAERAH ISTIMEWA YOGYAKARTA",10,108,70,178
https://kawalpemilu.org#41985,"SIDOMULYO, BAMBANGLIPURO, BANTUL, DAERAH ISTIMEWA YOGYAKARTA",11,102,15,117
https://kawalpemilu.org#41985,"SIDOMULYO, BAMBANGLIPURO, BANTUL, DAERAH ISTIMEWA YOGYAKARTA",12,131,34,165
https://kawalpemilu.org#41985,"SIDOMULYO, BAMBANGLIPURO, BANTUL, DAERAH ISTIMEWA YOGYAKARTA",13,116,41,157
https://kawalpemilu.org#41985,"SIDOMULYO, BAMBANGLIPURO, BANTUL, DAERAH ISTIMEWA YOGYAKARTA",14,83,71,154
https://kawalpemilu.org#41985,"SIDOMULYO, BAMBANGLIPURO, BANTUL, DAERAH ISTIMEWA YOGYAKARTA",15,129,34,163
https://kawalpemilu.org#41985,"SIDOMULYO, BAMBANGLIPURO, BANTUL, DAERAH ISTIMEWA YOGYAKARTA",16,152,95,247
https://kawalpemilu.org#41985,"SIDOMULYO, BAMBANGLIPURO, BANTUL, DAERAH ISTIMEWA YOGYAKARTA",17,162,55,217
https://kawalpemilu.org#41985,"SIDOMULYO, BAMBANGLIPURO, BANTUL, DAERAH ISTIMEWA YOGYAKARTA",18,105,31,136
https://kawalpemilu.org#41985,"SIDOMULYO, BAMBANGLIPURO, BANTUL, DAERAH ISTIMEWA YOGYAKARTA",19,168,60,228
https://kawalpemilu.org#41985,"SIDOMULYO, BAMBANGLIPURO, BANTUL, DAERAH ISTIMEWA YOGYAKARTA",20,121,38,159
https://kawalpemilu.org#41985,"SIDOMULYO, BAMBANGLIPURO, BANTUL, DAERAH ISTIMEWA YOGYAKARTA",21,112,53,165
https://kawalpemilu.org#41985,"SIDOMULYO, BAMBANGLIPURO, BANTUL, DAERAH ISTIMEWA YOGYAKARTA",22,118,39,157
https://kawalpemilu.org#41985,"SIDOMULYO, BAMBANGLIPURO, BANTUL, DAERAH ISTIMEWA YOGYAKARTA",23,132,55,187
https://kawalpemilu.org#41985,"SIDOMULYO, BAMBANGLIPURO, BANTUL, DAERAH ISTIMEWA YOGYAKARTA",24,148,81,229
https://kawalpemilu.org#41985,"SIDOMULYO, BAMBANGLIPURO, BANTUL, DAERAH ISTIMEWA YOGYAKARTA",25,140,40,184
https://kawalpemilu.org#41985,"SIDOMULYO, BAMBANGLIPURO, BANTUL, DAERAH ISTIMEWA YOGYAKARTA",26,104,79,183
https://kawalpemilu.org#41985,"SIDOMULYO, BAMBANGLIPURO, BANTUL, DAERAH ISTIMEWA YOGYAKARTA",27,86,86,172
https://kawalpemilu.org#41985,"SIDOMULYO, BAMBANGLIPURO, BANTUL, DAERAH ISTIMEWA YOGYAKARTA",28,146,62,208
https://kawalpemilu.org#41985,"SIDOMULYO, BAMBANGLIPURO, BANTUL, DAERAH ISTIMEWA YOGYAKARTA",29,168,78,246
https://kawalpemilu.org#41985,"SIDOMULYO, BAMBANGLIPURO, BANTUL, DAERAH ISTIMEWA YOGYAKARTA",30,130,100,230
https://kawalpemilu.org#41985,"SIDOMULYO, BAMBANGLIPURO, BANTUL, DAERAH ISTIMEWA YOGYAKARTA",31,135,34,169
https://kawalpemilu.org#41985,"SIDOMULYO, BAMBANGLIPURO, BANTUL, DAERAH ISTIMEWA YOGYAKARTA",32,117,28,145
https://kawalpemilu.org#41985,"SIDOMULYO, BAMBANGLIPURO, BANTUL, DAERAH ISTIMEWA YOGYAKARTA",33,0,0,0
https://kawalpemilu.org#41985,"SIDOMULYO, BAMBANGLIPURO, BANTUL, DAERAH ISTIMEWA YOGYAKARTA",34,173,57,230
https://kawalpemilu.org#41985,"SIDOMULYO, BAMBANGLIPURO, BANTUL, DAERAH ISTIMEWA YOGYAKARTA",35,150,93,243
https://kawalpemilu.org#41985,"SIDOMULYO, BAMBANGLIPURO, BANTUL, DAERAH ISTIMEWA YOGYAKARTA",36,94,66,160
https://kawalpemilu.org#41985,"SIDOMULYO, BAMBANGLIPURO, BANTUL, DAERAH ISTIMEWA YOGYAKARTA",37,127,9,136
https://kawalpemilu.org#41985,"SIDOMULYO, BAMBANGLIPURO, BANTUL, DAERAH ISTIMEWA YOGYAKARTA",38,156,70,226
https://kawalpemilu.org#41985,"SIDOMULYO, BAMBANGLIPURO, BANTUL, DAERAH ISTIMEWA YOGYAKARTA",39,126,37,163
https://kawalpemilu.org#41985,"SIDOMULYO, BAMBANGLIPURO, BANTUL, DAERAH ISTIMEWA YOGYAKARTA",40,168,31,199
https://kawalpemilu.org#41985,"SIDOMULYO, BAMBANGLIPURO, BANTUL, DAERAH ISTIMEWA YOGYAKARTA",41,130,84,214
https://kawalpemilu.org#41985,"SIDOMULYO, BAMBANGLIPURO, BANTUL, DAERAH ISTIMEWA YOGYAKARTA",42,158,46,204
https://kawalpemilu.org#41985,"SIDOMULYO, BAMBANGLIPURO, BANTUL, DAERAH ISTIMEWA YOGYAKARTA",43,188,30,218
https://kawalpemilu.org#41985,"SIDOMULYO, BAMBANGLIPURO, BANTUL, DAERAH ISTIMEWA YOGYAKARTA",44,159,78,237
https://kawalpemilu.org#41985,"SIDOMULYO, BAMBANGLIPURO, BANTUL, DAERAH ISTIMEWA YOGYAKARTA",45,113,72,185
https://kawalpemilu.org#41985,"SIDOMULYO, BAMBANGLIPURO, BANTUL, DAERAH ISTIMEWA YOGYAKARTA",46,154,37,191
https://kawalpemilu.org#41985,"SIDOMULYO, BAMBANGLIPURO, BANTUL, DAERAH ISTIMEWA YOGYAKARTA",47,179,42,221
https://kawalpemilu.org#41986,"MULYODADI, BAMBANGLIPURO, BANTUL, DAERAH ISTIMEWA YOGYAKARTA",1,159,89,248
https://kawalpemilu.org#41986,"MULYODADI, BAMBANGLIPURO, BANTUL, DAERAH ISTIMEWA YOGYAKARTA",2,133,39,172
https://kawalpemilu.org#41986,"MULYODADI, BAMBANGLIPURO, BANTUL, DAERAH ISTIMEWA YOGYAKARTA",3,146,51,197
https://kawalpemilu.org#41986,"MULYODADI, BAMBANGLIPURO, BANTUL, DAERAH ISTIMEWA YOGYAKARTA",4,161,36,197
https://kawalpemilu.org#41986,"MULYODADI, BAMBANGLIPURO, BANTUL, DAERAH ISTIMEWA YOGYAKARTA",5,131,65,196
https://kawalpemilu.org#41986,"MULYODADI, BAMBANGLIPURO, BANTUL, DAERAH ISTIMEWA YOGYAKARTA",6,75,129,204
https://kawalpemilu.org#41986,"MULYODADI, BAMBANGLIPURO, BANTUL, DAERAH ISTIMEWA YOGYAKARTA",7,179,55,234
https://kawalpemilu.org#41986,"MULYODADI, BAMBANGLIPURO, BANTUL, DAERAH ISTIMEWA YOGYAKARTA",8,74,109,183
https://kawalpemilu.org#41986,"MULYODADI, BAMBANGLIPURO, BANTUL, DAERAH ISTIMEWA YOGYAKARTA",9,89,101,190
https://kawalpemilu.org#41986,"MULYODADI, BAMBANGLIPURO, BANTUL, DAERAH ISTIMEWA YOGYAKARTA",10,106,76,182
https://kawalpemilu.org#41986,"MULYODADI, BAMBANGLIPURO, BANTUL, DAERAH ISTIMEWA YOGYAKARTA",11,127,54,181
https://kawalpemilu.org#41986,"MULYODADI, BAMBANGLIPURO, BANTUL, DAERAH ISTIMEWA YOGYAKARTA",12,98,69,167
https://kawalpemilu.org#41986,"MULYODADI, BAMBANGLIPURO, BANTUL, DAERAH ISTIMEWA YOGYAKARTA",13,139,35,174
https://kawalpemilu.org#41986,"MULYODADI, BAMBANGLIPURO, BANTUL, DAERAH ISTIMEWA YOGYAKARTA",14,148,40,188
https://kawalpemilu.org#41986,"MULYODADI, BAMBANGLIPURO, BANTUL, DAERAH ISTIMEWA YOGYAKARTA",15,143,69,212
https://kawalpemilu.org#41986,"MULYODADI, BAMBANGLIPURO, BANTUL, DAERAH ISTIMEWA YOGYAKARTA",16,137,63,200
https://kawalpemilu.org#41986,"MULYODADI, BAMBANGLIPURO, BANTUL, DAERAH ISTIMEWA YOGYAKARTA",17,129,95,224
https://kawalpemilu.org#41986,"MULYODADI, BAMBANGLIPURO, BANTUL, DAERAH ISTIMEWA YOGYAKARTA",18,94,112,206
https://kawalpemilu.org#41986,"MULYODADI, BAMBANGLIPURO, BANTUL, DAERAH ISTIMEWA YOGYAKARTA",19,86,88,174
https://kawalpemilu.org#41986,"MULYODADI, BAMBANGLIPURO, BANTUL, DAERAH ISTIMEWA YOGYAKARTA",20,134,46,180
https://kawalpemilu.org#41986,"MULYODADI, BAMBANGLIPURO, BANTUL, DAERAH ISTIMEWA YOGYAKARTA",21,144,48,192
https://kawalpemilu.org#41986,"MULYODADI, BAMBANGLIPURO, BANTUL, DAERAH ISTIMEWA YOGYAKARTA",22,131,28,159
https://kawalpemilu.org#41986,"MULYODADI, BAMBANGLIPURO, BANTUL, DAERAH ISTIMEWA YOGYAKARTA",23,159,28,187
https://kawalpemilu.org#41986,"MULYODADI, BAMBANGLIPURO, BANTUL, DAERAH ISTIMEWA YOGYAKARTA",24,164,47,211
https://kawalpemilu.org#41986,"MULYODADI, BAMBANGLIPURO, BANTUL, DAERAH ISTIMEWA YOGYAKARTA",25,190,58,248
https://kawalpemilu.org#41986,"MULYODADI, BAMBANGLIPURO, BANTUL, DAERAH ISTIMEWA YOGYAKARTA",26,149,78,227
https://kawalpemilu.org#41986,"MULYODADI, BAMBANGLIPURO, BANTUL, DAERAH ISTIMEWA YOGYAKARTA",27,124,40,164
https://kawalpemilu.org#41986,"MULYODADI, BAMBANGLIPURO, BANTUL, DAERAH ISTIMEWA YOGYAKARTA",28,116,58,174
https://kawalpemilu.org#41986,"MULYODADI, BAMBANGLIPURO, BANTUL, DAERAH ISTIMEWA YOGYAKARTA",29,107,114,221
https://kawalpemilu.org#41986,"MULYODADI, BAMBANGLIPURO, BANTUL, DAERAH ISTIMEWA YOGYAKARTA",30,129,86,215
https://kawalpemilu.org#41986,"MULYODADI, BAMBANGLIPURO, BANTUL, DAERAH ISTIMEWA YOGYAKARTA",31,102,102,204
https://kawalpemilu.org#41986,"MULYODADI, BAMBANGLIPURO, BANTUL, DAERAH ISTIMEWA YOGYAKARTA",32,114,108,222
https://kawalpemilu.org#41986,"MULYODADI, BAMBANGLIPURO, BANTUL, DAERAH ISTIMEWA YOGYAKARTA",33,164,81,245
https://kawalpemilu.org#41986,"MULYODADI, BAMBANGLIPURO, BANTUL, DAERAH ISTIMEWA YOGYAKARTA",34,195,35,230
https://kawalpemilu.org#41986,"MULYODADI, BAMBANGLIPURO, BANTUL, DAERAH ISTIMEWA YOGYAKARTA",35,137,56,193
https://kawalpemilu.org#41986,"MULYODADI, BAMBANGLIPURO, BANTUL, DAERAH ISTIMEWA YOGYAKARTA",36,142,35,177
https://kawalpemilu.org#41986,"MULYODADI, BAMBANGLIPURO, BANTUL, DAERAH ISTIMEWA YOGYAKARTA",37,116,55,171
https://kawalpemilu.org#41986,"MULYODADI, BAMBANGLIPURO, BANTUL, DAERAH ISTIMEWA YOGYAKARTA",38,196,47,243
https://kawalpemilu.org#41986,"MULYODADI, BAMBANGLIPURO, BANTUL, DAERAH ISTIMEWA YOGYAKARTA",39,159,6,255
https://kawalpemilu.org#41986,"MULYODADI, BAMBANGLIPURO, BANTUL, DAERAH ISTIMEWA YOGYAKARTA",40,0,0,204
https://kawalpemilu.org#41987,"SUMBERMULYO, BAMBANGLIPURO, BANTUL, DAERAH ISTIMEWA YOGYAKARTA",1,168,26,194
https://kawalpemilu.org#41987,"SUMBERMULYO, BAMBANGLIPURO, BANTUL, DAERAH ISTIMEWA YOGYAKARTA",2,210,4,214
https://kawalpemilu.org#41987,"SUMBERMULYO, BAMBANGLIPURO, BANTUL, DAERAH ISTIMEWA YOGYAKARTA",3,162,10,172
https://kawalpemilu.org#41987,"SUMBERMULYO, BAMBANGLIPURO, BANTUL, DAERAH ISTIMEWA YOGYAKARTA",4,138,12,150
https://kawalpemilu.org#41987,"SUMBERMULYO, BAMBANGLIPURO, BANTUL, DAERAH ISTIMEWA YOGYAKARTA",5,164,34,198
https://kawalpemilu.org#41987,"SUMBERMULYO, BAMBANGLIPURO, BANTUL, DAERAH ISTIMEWA YOGYAKARTA",6,130,44,174
https://kawalpemilu.org#41987,"SUMBERMULYO, BAMBANGLIPURO, BANTUL, DAERAH ISTIMEWA YOGYAKARTA",7,192,37,229
https://kawalpemilu.org#41987,"SUMBERMULYO, BAMBANGLIPURO, BANTUL, DAERAH ISTIMEWA YOGYAKARTA",8,111,23,134
https://kawalpemilu.org#41987,"SUMBERMULYO, BAMBANGLIPURO, BANTUL, DAERAH ISTIMEWA YOGYAKARTA",9,161,88,249
https://kawalpemilu.org#41987,"SUMBERMULYO, BAMBANGLIPURO, BANTUL, DAERAH ISTIMEWA YOGYAKARTA",10,178,70,248
https://kawalpemilu.org#41987,"SUMBERMULYO, BAMBANGLIPURO, BANTUL, DAERAH ISTIMEWA YOGYAKARTA",11,122,81,203
https://kawalpemilu.org#41987,"SUMBERMULYO, BAMBANGLIPURO, BANTUL, DAERAH ISTIMEWA YOGYAKARTA",12,145,65,210
https://kawalpemilu.org#41987,"SUMBERMULYO, BAMBANGLIPURO, BANTUL, DAERAH ISTIMEWA YOGYAKARTA",13,165,70,235
https://kawalpemilu.org#41987,"SUMBERMULYO, BAMBANGLIPURO, BANTUL, DAERAH ISTIMEWA YOGYAKARTA",14,133,84,217
https://kawalpemilu.org#41987,"SUMBERMULYO, BAMBANGLIPURO, BANTUL, DAERAH ISTIMEWA YOGYAKARTA",15,174,53,227
https://kawalpemilu.org#41987,"SUMBERMULYO, BAMBANGLIPURO, BANTUL, DAERAH ISTIMEWA YOGYAKARTA",16,129,63,192
https://kawalpemilu.org#41987,"SUMBERMULYO, BAMBANGLIPURO, BANTUL, DAERAH ISTIMEWA YOGYAKARTA",17,180,55,235
https://kawalpemilu.org#41987,"SUMBERMULYO, BAMBANGLIPURO, BANTUL, DAERAH ISTIMEWA YOGYAKARTA",18,137,36,173
https://kawalpemilu.org#41987,"SUMBERMULYO, BAMBANGLIPURO, BANTUL, DAERAH ISTIMEWA YOGYAKARTA",19,132,34,166
https://kawalpemilu.org#41987,"SUMBERMULYO, BAMBANGLIPURO, BANTUL, DAERAH ISTIMEWA YOGYAKARTA",20,185,27,212
https://kawalpemilu.org#41987,"SUMBERMULYO, BAMBANGLIPURO, BANTUL, DAERAH ISTIMEWA YOGYAKARTA",21,153,35,188
https://kawalpemilu.org#41987,"SUMBERMULYO, BAMBANGLIPURO, BANTUL, DAERAH ISTIMEWA YOGYAKARTA",22,165,87,252
https://kawalpemilu.org#41987,"SUMBERMULYO, BAMBANGLIPURO, BANTUL, DAERAH ISTIMEWA YOGYAKARTA",23,78,51,129
https://kawalpemilu.org#41987,"SUMBERMULYO, BAMBANGLIPURO, BANTUL, DAERAH ISTIMEWA YOGYAKARTA",24,108,52,160
https://kawalpemilu.org#41987,"SUMBERMULYO, BAMBANGLIPURO, BANTUL, DAERAH ISTIMEWA YOGYAKARTA",25,137,17,154
https://kawalpemilu.org#41987,"SUMBERMULYO, BAMBANGLIPURO, BANTUL, DAERAH ISTIMEWA YOGYAKARTA",26,151,13,164
https://kawalpemilu.org#41987,"SUMBERMULYO, BAMBANGLIPURO, BANTUL, DAERAH ISTIMEWA YOGYAKARTA",27,170,49,219
https://kawalpemilu.org#41987,"SUMBERMULYO, BAMBANGLIPURO, BANTUL, DAERAH ISTIMEWA YOGYAKARTA",28,154,58,212
https://kawalpemilu.org#41987,"SUMBERMULYO, BAMBANGLIPURO, BANTUL, DAERAH ISTIMEWA YOGYAKARTA",29,102,32,134
https://kawalpemilu.org#41987,"SUMBERMULYO, BAMBANGLIPURO, BANTUL, DAERAH ISTIMEWA YOGYAKARTA",30,130,77,207
https://kawalpemilu.org#41987,"SUMBERMULYO, BAMBANGLIPURO, BANTUL, DAERAH ISTIMEWA YOGYAKARTA",31,162,51,213
https://kawalpemilu.org#41987,"SUMBERMULYO, BAMBANGLIPURO, BANTUL, DAERAH ISTIMEWA YOGYAKARTA",32,81,79,160
https://kawalpemilu.org#41987,"SUMBERMULYO, BAMBANGLIPURO, BANTUL, DAERAH ISTIMEWA YOGYAKARTA",33,124,58,182
https://kawalpemilu.org#41987,"SUMBERMULYO, BAMBANGLIPURO, BANTUL, DAERAH ISTIMEWA YOGYAKARTA",34,165,34,199
https://kawalpemilu.org#41987,"SUMBERMULYO, BAMBANGLIPURO, BANTUL, DAERAH ISTIMEWA YOGYAKARTA",35,185,16,201
https://kawalpemilu.org#41987,"SUMBERMULYO, BAMBANGLIPURO, BANTUL, DAERAH ISTIMEWA YOGYAKARTA",36,161,74,235
https://kawalpemilu.org#41987,"SUMBERMULYO, BAMBANGLIPURO, BANTUL, DAERAH ISTIMEWA YOGYAKARTA",37,139,56,195
https://kawalpemilu.org#41987,"SUMBERMULYO, BAMBANGLIPURO, BANTUL, DAERAH ISTIMEWA YOGYAKARTA",38,117,49,166
https://kawalpemilu.org#41987,"SUMBERMULYO, BAMBANGLIPURO, BANTUL, DAERAH ISTIMEWA YOGYAKARTA",39,137,65,202
https://kawalpemilu.org#41987,"SUMBERMULYO, BAMBANGLIPURO, BANTUL, DAERAH ISTIMEWA YOGYAKARTA",40,193,46,239
https://kawalpemilu.org#41987,"SUMBERMULYO, BAMBANGLIPURO, BANTUL, DAERAH ISTIMEWA YOGYAKARTA",41,114,64,178
https://kawalpemilu.org#41987,"SUMBERMULYO, BAMBANGLIPURO, BANTUL, DAERAH ISTIMEWA YOGYAKARTA",42,138,42,180
https://kawalpemilu.org#41987,"SUMBERMULYO, BAMBANGLIPURO, BANTUL, DAERAH ISTIMEWA YOGYAKARTA",43,119,59,178
https://kawalpemilu.org#41987,"SUMBERMULYO, BAMBANGLIPURO, BANTUL, DAERAH ISTIMEWA YOGYAKARTA",44,149,127,276
https://kawalpemilu.org#41987,"SUMBERMULYO, BAMBANGLIPURO, BANTUL, DAERAH ISTIMEWA YOGYAKARTA",45,105,49,154
https://kawalpemilu.org#41987,"SUMBERMULYO, BAMBANGLIPURO, BANTUL, DAERAH ISTIMEWA YOGYAKARTA",46,131,42,173
https://kawalpemilu.org#41987,"SUMBERMULYO, BAMBANGLIPURO, BANTUL, DAERAH ISTIMEWA YOGYAKARTA",47,163,53,216
https://kawalpemilu.org#41987,"SUMBERMULYO, BAMBANGLIPURO, BANTUL, DAERAH ISTIMEWA YOGYAKARTA",48,155,31,186
https://kawalpemilu.org#41987,"SUMBERMULYO, BAMBANGLIPURO, BANTUL, DAERAH ISTIMEWA YOGYAKARTA",49,88,74,162
https://kawalpemilu.org#41987,"SUMBERMULYO, BAMBANGLIPURO, BANTUL, DAERAH ISTIMEWA YOGYAKARTA",50,177,65,242
https://kawalpemilu.org#41987,"SUMBERMULYO, BAMBANGLIPURO, BANTUL, DAERAH ISTIMEWA YOGYAKARTA",51,152,82,234
https://kawalpemilu.org#41987,"SUMBERMULYO, BAMBANGLIPURO, BANTUL, DAERAH ISTIMEWA YOGYAKARTA",52,123,50,173
https://kawalpemilu.org#41987,"SUMBERMULYO, BAMBANGLIPURO, BANTUL, DAERAH ISTIMEWA YOGYAKARTA",53,184,72,256
https://kawalpemilu.org#41987,"SUMBERMULYO, BAMBANGLIPURO, BANTUL, DAERAH ISTIMEWA YOGYAKARTA",54,196,28,224
https://kawalpemilu.org#41987,"SUMBERMULYO, BAMBANGLIPURO, BANTUL, DAERAH ISTIMEWA YOGYAKARTA",55,73,46,119
https://kawalpemilu.org#41989,"CATURHARJO, PANDAK, BANTUL, DAERAH ISTIMEWA YOGYAKARTA",1,115,50,165
https://kawalpemilu.org#41989,"CATURHARJO, PANDAK, BANTUL, DAERAH ISTIMEWA YOGYAKARTA",2,98,39,137
https://kawalpemilu.org#41989,"CATURHARJO, PANDAK, BANTUL, DAERAH ISTIMEWA YOGYAKARTA",3,61,70,131
https://kawalpemilu.org#41989,"CATURHARJO, PANDAK, BANTUL, DAERAH ISTIMEWA YOGYAKARTA",4,175,45,220
https://kawalpemilu.org#41989,"CATURHARJO, PANDAK, BANTUL, DAERAH ISTIMEWA YOGYAKARTA",5,145,76,221
https://kawalpemilu.org#41989,"CATURHARJO, PANDAK, BANTUL, DAERAH ISTIMEWA YOGYAKARTA",6,102,113,215
https://kawalpemilu.org#41989,"CATURHARJO, PANDAK, BANTUL, DAERAH ISTIMEWA YOGYAKARTA",7,112,69,181
https://kawalpemilu.org#41989,"CATURHARJO, PANDAK, BANTUL, DAERAH ISTIMEWA YOGYAKARTA",8,165,44,209
https://kawalpemilu.org#41989,"CATURHARJO, PANDAK, BANTUL, DAERAH ISTIMEWA YOGYAKARTA",9,134,75,209
https://kawalpemilu.org#41989,"CATURHARJO, PANDAK, BANTUL, DAERAH ISTIMEWA YOGYAKARTA",10,138,97,235
https://kawalpemilu.org#41989,"CATURHARJO, PANDAK, BANTUL, DAERAH ISTIMEWA YOGYAKARTA",11,183,49,232
https://kawalpemilu.org#41989,"CATURHARJO, PANDAK, BANTUL, DAERAH ISTIMEWA YOGYAKARTA",12,157,45,202
https://kawalpemilu.org#41989,"CATURHARJO, PANDAK, BANTUL, DAERAH ISTIMEWA YOGYAKARTA",13,112,27,139
https://kawalpemilu.org#41989,"CATURHARJO, PANDAK, BANTUL, DAERAH ISTIMEWA YOGYAKARTA",14,118,48,166
https://kawalpemilu.org#41989,"CATURHARJO, PANDAK, BANTUL, DAERAH ISTIMEWA YOGYAKARTA",15,130,42,172
https://kawalpemilu.org#41989,"CATURHARJO, PANDAK, BANTUL, DAERAH ISTIMEWA YOGYAKARTA",16,149,31,180
https://kawalpemilu.org#41989,"CATURHARJO, PANDAK, BANTUL, DAERAH ISTIMEWA YOGYAKARTA",17,105,72,177
https://kawalpemilu.org#41989,"CATURHARJO, PANDAK, BANTUL, DAERAH ISTIMEWA YOGYAKARTA",18,125,57,182
https://kawalpemilu.org#41989,"CATURHARJO, PANDAK, BANTUL, DAERAH ISTIMEWA YOGYAKARTA",19,118,42,160
https://kawalpemilu.org#41989,"CATURHARJO, PANDAK, BANTUL, DAERAH ISTIMEWA YOGYAKARTA",20,106,100,206
https://kawalpemilu.org#41989,"CATURHARJO, PANDAK, BANTUL, DAERAH ISTIMEWA YOGYAKARTA",21,103,77,180
https://kawalpemilu.org#41989,"CATURHARJO, PANDAK, BANTUL, DAERAH ISTIMEWA YOGYAKARTA",22,134,82,216
https://kawalpemilu.org#41989,"CATURHARJO, PANDAK, BANTUL, DAERAH ISTIMEWA YOGYAKARTA",23,59,76,135
https://kawalpemilu.org#41989,"CATURHARJO, PANDAK, BANTUL, DAERAH ISTIMEWA YOGYAKARTA",24,74,119,193
https://kawalpemilu.org#41989,"CATURHARJO, PANDAK, BANTUL, DAERAH ISTIMEWA YOGYAKARTA",25,38,156,194
https://kawalpemilu.org#41989,"CATURHARJO, PANDAK, BANTUL, DAERAH ISTIMEWA YOGYAKARTA",26,37,119,156
https://kawalpemilu.org#41989,"CATURHARJO, PANDAK, BANTUL, DAERAH ISTIMEWA YOGYAKARTA",27,80,114,194
https://kawalpemilu.org#41989,"CATURHARJO, PANDAK, BANTUL, DAERAH ISTIMEWA YOGYAKARTA",28,53,114,167
https://kawalpemilu.org#41989,"CATURHARJO, PANDAK, BANTUL, DAERAH ISTIMEWA YOGYAKARTA",29,97,79,176
https://kawalpemilu.org#41989,"CATURHARJO, PANDAK, BANTUL, DAERAH ISTIMEWA YOGYAKARTA",30,85,131,216
https://kawalpemilu.org#41989,"CATURHARJO, PANDAK, BANTUL, DAERAH ISTIMEWA YOGYAKARTA",31,94,144,238
https://kawalpemilu.org#41989,"CATURHARJO, PANDAK, BANTUL, DAERAH ISTIMEWA YOGYAKARTA",32,58,152,210
https://kawalpemilu.org#41989,"CATURHARJO, PANDAK, BANTUL, DAERAH ISTIMEWA YOGYAKARTA",33,143,62,205
https://kawalpemilu.org#41989,"CATURHARJO, PANDAK, BANTUL, DAERAH ISTIMEWA YOGYAKARTA",34,116,41,157
https://kawalpemilu.org#41989,"CATURHARJO, PANDAK, BANTUL, DAERAH ISTIMEWA YOGYAKARTA",35,114,43,157
https://kawalpemilu.org#41989,"CATURHARJO, PANDAK, BANTUL, DAERAH ISTIMEWA YOGYAKARTA",36,103,72,175
https://kawalpemilu.org#41989,"CATURHARJO, PANDAK, BANTUL, DAERAH ISTIMEWA YOGYAKARTA",37,89,68,157
https://kawalpemilu.org#41989,"CATURHARJO, PANDAK, BANTUL, DAERAH ISTIMEWA YOGYAKARTA",38,182,46,228
https://kawalpemilu.org#41989,"CATURHARJO, PANDAK, BANTUL, DAERAH ISTIMEWA YOGYAKARTA",39,162,53,215
https://kawalpemilu.org#41989,"CATURHARJO, PANDAK, BANTUL, DAERAH ISTIMEWA YOGYAKARTA",40,166,79,245
https://kawalpemilu.org#41989,"CATURHARJO, PANDAK, BANTUL, DAERAH ISTIMEWA YOGYAKARTA",41,139,97,236
https://kawalpemilu.org#41990,"TRIHARJO, PANDAK, BANTUL, DAERAH ISTIMEWA YOGYAKARTA",1,157,43,200
https://kawalpemilu.org#41990,"TRIHARJO, PANDAK, BANTUL, DAERAH ISTIMEWA YOGYAKARTA",2,165,23,188
https://kawalpemilu.org#41990,"TRIHARJO, PANDAK, BANTUL, DAERAH ISTIMEWA YOGYAKARTA",3,166,39,205
https://kawalpemilu.org#41990,"TRIHARJO, PANDAK, BANTUL, DAERAH ISTIMEWA YOGYAKARTA",4,146,59,205
https://kawalpemilu.org#41990,"TRIHARJO, PANDAK, BANTUL, DAERAH ISTIMEWA YOGYAKARTA",5,114,75,189
https://kawalpemilu.org#41990,"TRIHARJO, PANDAK, BANTUL, DAERAH ISTIMEWA YOGYAKARTA",6,156,74,230
https://kawalpemilu.org#41990,"TRIHARJO, PANDAK, BANTUL, DAERAH ISTIMEWA YOGYAKARTA",7,174,57,231
https://kawalpemilu.org#41990,"TRIHARJO, PANDAK, BANTUL, DAERAH ISTIMEWA YOGYAKARTA",8,157,68,225
https://kawalpemilu.org#41990,"TRIHARJO, PANDAK, BANTUL, DAERAH ISTIMEWA YOGYAKARTA",9,159,53,212
https://kawalpemilu.org#41990,"TRIHARJO, PANDAK, BANTUL, DAERAH ISTIMEWA YOGYAKARTA",10,186,58,244
https://kawalpemilu.org#41990,"TRIHARJO, PANDAK, BANTUL, DAERAH ISTIMEWA YOGYAKARTA",11,189,65,254
https://kawalpemilu.org#41990,"TRIHARJO, PANDAK, BANTUL, DAERAH ISTIMEWA YOGYAKARTA",12,202,59,261
https://kawalpemilu.org#41990,"TRIHARJO, PANDAK, BANTUL, DAERAH ISTIMEWA YOGYAKARTA",13,207,51,258
https://kawalpemilu.org#41990,"TRIHARJO, PANDAK, BANTUL, DAERAH ISTIMEWA YOGYAKARTA",14,139,68,207
https://kawalpemilu.org#41990,"TRIHARJO, PANDAK, BANTUL, DAERAH ISTIMEWA YOGYAKARTA",15,175,61,236
https://kawalpemilu.org#41990,"TRIHARJO, PANDAK, BANTUL, DAERAH ISTIMEWA YOGYAKARTA",16,116,79,195
https://kawalpemilu.org#41990,"TRIHARJO, PANDAK, BANTUL, DAERAH ISTIMEWA YOGYAKARTA",17,130,72,202
https://kawalpemilu.org#41990,"TRIHARJO, PANDAK, BANTUL, DAERAH ISTIMEWA YOGYAKARTA",18,101,67,168
https://kawalpemilu.org#41990,"TRIHARJO, PANDAK, BANTUL, DAERAH ISTIMEWA YOGYAKARTA",19,186,32,218
https://kawalpemilu.org#41990,"TRIHARJO, PANDAK, BANTUL, DAERAH ISTIMEWA YOGYAKARTA",20,173,75,248
https://kawalpemilu.org#41990,"TRIHARJO, PANDAK, BANTUL, DAERAH ISTIMEWA YOGYAKARTA",21,182,61,243
https://kawalpemilu.org#41990,"TRIHARJO, PANDAK, BANTUL, DAERAH ISTIMEWA YOGYAKARTA",22,91,29,120
https://kawalpemilu.org#41990,"TRIHARJO, PANDAK, BANTUL, DAERAH ISTIMEWA YOGYAKARTA",23,194,40,234
https://kawalpemilu.org#41990,"TRIHARJO, PANDAK, BANTUL, DAERAH ISTIMEWA YOGYAKARTA",24,159,56,215
https://kawalpemilu.org#41990,"TRIHARJO, PANDAK, BANTUL, DAERAH ISTIMEWA YOGYAKARTA",25,226,32,258
https://kawalpemilu.org#41990,"TRIHARJO, PANDAK, BANTUL, DAERAH ISTIMEWA YOGYAKARTA",26,202,35,237
https://kawalpemilu.org#41990,"TRIHARJO, PANDAK, BANTUL, DAERAH ISTIMEWA YOGYAKARTA",27,196,24,220
https://kawalpemilu.org#41990,"TRIHARJO, PANDAK, BANTUL, DAERAH ISTIMEWA YOGYAKARTA",28,187,26,213
https://kawalpemilu.org#41990,"TRIHARJO, PANDAK, BANTUL, DAERAH ISTIMEWA YOGYAKARTA",29,184,24,208
https://kawalpemilu.org#41990,"TRIHARJO, PANDAK, BANTUL, DAERAH ISTIMEWA YOGYAKARTA",30,174,48,222
https://kawalpemilu.org#41990,"TRIHARJO, PANDAK, BANTUL, DAERAH ISTIMEWA YOGYAKARTA",31,139,100,239
https://kawalpemilu.org#41990,"TRIHARJO, PANDAK, BANTUL, DAERAH ISTIMEWA YOGYAKARTA",32,154,59,213
https://kawalpemilu.org#41990,"TRIHARJO, PANDAK, BANTUL, DAERAH ISTIMEWA YOGYAKARTA",33,178,38,216
https://kawalpemilu.org#41990,"TRIHARJO, PANDAK, BANTUL, DAERAH ISTIMEWA YOGYAKARTA",34,176,24,200
https://kawalpemilu.org#41990,"TRIHARJO, PANDAK, BANTUL, DAERAH ISTIMEWA YOGYAKARTA",35,170,44,214
https://kawalpemilu.org#41990,"TRIHARJO, PANDAK, BANTUL, DAERAH ISTIMEWA YOGYAKARTA",36,157,51,208
https://kawalpemilu.org#41990,"TRIHARJO, PANDAK, BANTUL, DAERAH ISTIMEWA YOGYAKARTA",37,160,50,210
https://kawalpemilu.org#41990,"TRIHARJO, PANDAK, BANTUL, DAERAH ISTIMEWA YOGYAKARTA",38,110,54,164
https://kawalpemilu.org#41990,"TRIHARJO, PANDAK, BANTUL, DAERAH ISTIMEWA YOGYAKARTA",39,194,28,222
https://kawalpemilu.org#41990,"TRIHARJO, PANDAK, BANTUL, DAERAH ISTIMEWA YOGYAKARTA",40,161,65,226
https://kawalpemilu.org#41990,"TRIHARJO, PANDAK, BANTUL, DAERAH ISTIMEWA YOGYAKARTA",41,164,76,240
https://kawalpemilu.org#41991,"GILANGHARJO, PANDAK, BANTUL, DAERAH ISTIMEWA YOGYAKARTA",1,209,45,254
https://kawalpemilu.org#41991,"GILANGHARJO, PANDAK, BANTUL, DAERAH ISTIMEWA YOGYAKARTA",2,171,65,236
https://kawalpemilu.org#41991,"GILANGHARJO, PANDAK, BANTUL, DAERAH ISTIMEWA YOGYAKARTA",3,173,95,268
https://kawalpemilu.org#41991,"GILANGHARJO, PANDAK, BANTUL, DAERAH ISTIMEWA YOGYAKARTA",4,133,41,174
https://kawalpemilu.org#41991,"GILANGHARJO, PANDAK, BANTUL, DAERAH ISTIMEWA YOGYAKARTA",5,120,24,144
https://kawalpemilu.org#41991,"GILANGHARJO, PANDAK, BANTUL, DAERAH ISTIMEWA YOGYAKARTA",6,163,27,190
https://kawalpemilu.org#41991,"GILANGHARJO, PANDAK, BANTUL, DAERAH ISTIMEWA YOGYAKARTA",7,109,42,151
https://kawalpemilu.org#41991,"GILANGHARJO, PANDAK, BANTUL, DAERAH ISTIMEWA YOGYAKARTA",8,141,36,177
https://kawalpemilu.org#41991,"GILANGHARJO, PANDAK, BANTUL, DAERAH ISTIMEWA YOGYAKARTA",9,114,114,228
https://kawalpemilu.org#41991,"GILANGHARJO, PANDAK, BANTUL, DAERAH ISTIMEWA YOGYAKARTA",10,103,67,170
https://kawalpemilu.org#41991,"GILANGHARJO, PANDAK, BANTUL, DAERAH ISTIMEWA YOGYAKARTA",11,139,30,169
https://kawalpemilu.org#41991,"GILANGHARJO, PANDAK, BANTUL, DAERAH ISTIMEWA YOGYAKARTA",12,133,109,242
https://kawalpemilu.org#41991,"GILANGHARJO, PANDAK, BANTUL, DAERAH ISTIMEWA YOGYAKARTA",13,192,52,244
https://kawalpemilu.org#41991,"GILANGHARJO, PANDAK, BANTUL, DAERAH ISTIMEWA YOGYAKARTA",14,155,81,236
https://kawalpemilu.org#41991,"GILANGHARJO, PANDAK, BANTUL, DAERAH ISTIMEWA YOGYAKARTA",15,197,53,250
https://kawalpemilu.org#41991,"GILANGHARJO, PANDAK, BANTUL, DAERAH ISTIMEWA YOGYAKARTA",16,100,60,160
https://kawalpemilu.org#41991,"GILANGHARJO, PANDAK, BANTUL, DAERAH ISTIMEWA YOGYAKARTA",17,193,52,245
https://kawalpemilu.org#41991,"GILANGHARJO, PANDAK, BANTUL, DAERAH ISTIMEWA YOGYAKARTA",18,125,34,159
https://kawalpemilu.org#41991,"GILANGHARJO, PANDAK, BANTUL, DAERAH ISTIMEWA YOGYAKARTA",19,174,58,232
https://kawalpemilu.org#41991,"GILANGHARJO, PANDAK, BANTUL, DAERAH ISTIMEWA YOGYAKARTA",20,183,58,241
https://kawalpemilu.org#41991,"GILANGHARJO, PANDAK, BANTUL, DAERAH ISTIMEWA YOGYAKARTA",21,195,43,238
https://kawalpemilu.org#41991,"GILANGHARJO, PANDAK, BANTUL, DAERAH ISTIMEWA YOGYAKARTA",22,140,69,209
https://kawalpemilu.org#41991,"GILANGHARJO, PANDAK, BANTUL, DAERAH ISTIMEWA YOGYAKARTA",23,161,6,167
https://kawalpemilu.org#41991,"GILANGHARJO, PANDAK, BANTUL, DAERAH ISTIMEWA YOGYAKARTA",24,144,42,186
https://kawalpemilu.org#41991,"GILANGHARJO, PANDAK, BANTUL, DAERAH ISTIMEWA YOGYAKARTA",25,200,50,250
https://kawalpemilu.org#41991,"GILANGHARJO, PANDAK, BANTUL, DAERAH ISTIMEWA YOGYAKARTA",26,163,49,212
https://kawalpemilu.org#41991,"GILANGHARJO, PANDAK, BANTUL, DAERAH ISTIMEWA YOGYAKARTA",27,210,41,251
https://kawalpemilu.org#41991,"GILANGHARJO, PANDAK, BANTUL, DAERAH ISTIMEWA YOGYAKARTA",28,135,50,185
https://kawalpemilu.org#41991,"GILANGHARJO, PANDAK, BANTUL, DAERAH ISTIMEWA YOGYAKARTA",29,108,36,144
https://kawalpemilu.org#41991,"GILANGHARJO, PANDAK, BANTUL, DAERAH ISTIMEWA YOGYAKARTA",30,184,37,221
https://kawalpemilu.org#41991,"GILANGHARJO, PANDAK, BANTUL, DAERAH ISTIMEWA YOGYAKARTA",31,174,78,252
https://kawalpemilu.org#41991,"GILANGHARJO, PANDAK, BANTUL, DAERAH ISTIMEWA YOGYAKARTA",32,161,79,240
https://kawalpemilu.org#41991,"GILANGHARJO, PANDAK, BANTUL, DAERAH ISTIMEWA YOGYAKARTA",33,208,39,247
https://kawalpemilu.org#41991,"GILANGHARJO, PANDAK, BANTUL, DAERAH ISTIMEWA YOGYAKARTA",34,136,30,166
https://kawalpemilu.org#41991,"GILANGHARJO, PANDAK, BANTUL, DAERAH ISTIMEWA YOGYAKARTA",35,141,18,159
https://kawalpemilu.org#41991,"GILANGHARJO, PANDAK, BANTUL, DAERAH ISTIMEWA YOGYAKARTA",36,172,34,206
https://kawalpemilu.org#41991,"GILANGHARJO, PANDAK, BANTUL, DAERAH ISTIMEWA YOGYAKARTA",37,159,19,178
https://kawalpemilu.org#41991,"GILANGHARJO, PANDAK, BANTUL, DAERAH ISTIMEWA YOGYAKARTA",38,182,28,210
https://kawalpemilu.org#41991,"GILANGHARJO, PANDAK, BANTUL, DAERAH ISTIMEWA YOGYAKARTA",39,147,7,154
https://kawalpemilu.org#41991,"GILANGHARJO, PANDAK, BANTUL, DAERAH ISTIMEWA YOGYAKARTA",40,181,34,215
https://kawalpemilu.org#41991,"GILANGHARJO, PANDAK, BANTUL, DAERAH ISTIMEWA YOGYAKARTA",41,143,34,177
https://kawalpemilu.org#41991,"GILANGHARJO, PANDAK, BANTUL, DAERAH ISTIMEWA YOGYAKARTA",42,150,35,185
https://kawalpemilu.org#41991,"GILANGHARJO, PANDAK, BANTUL, DAERAH ISTIMEWA YOGYAKARTA",43,142,29,171
https://kawalpemilu.org#41991,"GILANGHARJO, PANDAK, BANTUL, DAERAH ISTIMEWA YOGYAKARTA",44,125,31,156
https://kawalpemilu.org#41991,"GILANGHARJO, PANDAK, BANTUL, DAERAH ISTIMEWA YOGYAKARTA",45,176,28,204
https://kawalpemilu.org#41991,"GILANGHARJO, PANDAK, BANTUL, DAERAH ISTIMEWA YOGYAKARTA",46,227,29,256
https://kawalpemilu.org#41991,"GILANGHARJO, PANDAK, BANTUL, DAERAH ISTIMEWA YOGYAKARTA",47,169,41,210
https://kawalpemilu.org#41991,"GILANGHARJO, PANDAK, BANTUL, DAERAH ISTIMEWA YOGYAKARTA",48,167,34,201
https://kawalpemilu.org#41991,"GILANGHARJO, PANDAK, BANTUL, DAERAH ISTIMEWA YOGYAKARTA",49,169,41,210
https://kawalpemilu.org#41991,"GILANGHARJO, PANDAK, BANTUL, DAERAH ISTIMEWA YOGYAKARTA",50,149,57,206
https://kawalpemilu.org#41991,"GILANGHARJO, PANDAK, BANTUL, DAERAH ISTIMEWA YOGYAKARTA",51,154,36,190
https://kawalpemilu.org#41991,"GILANGHARJO, PANDAK, BANTUL, DAERAH ISTIMEWA YOGYAKARTA",52,178,52,230
https://kawalpemilu.org#41991,"GILANGHARJO, PANDAK, BANTUL, DAERAH ISTIMEWA YOGYAKARTA",53,160,35,195
https://kawalpemilu.org#41992,"WIJIREJO, PANDAK, BANTUL, DAERAH ISTIMEWA YOGYAKARTA",1,176,50,226
https://kawalpemilu.org#41992,"WIJIREJO, PANDAK, BANTUL, DAERAH ISTIMEWA YOGYAKARTA",2,188,66,254
https://kawalpemilu.org#41992,"WIJIREJO, PANDAK, BANTUL, DAERAH ISTIMEWA YOGYAKARTA",3,157,72,229
https://kawalpemilu.org#41992,"WIJIREJO, PANDAK, BANTUL, DAERAH ISTIMEWA YOGYAKARTA",4,174,84,258
https://kawalpemilu.org#41992,"WIJIREJO, PANDAK, BANTUL, DAERAH ISTIMEWA YOGYAKARTA",5,201,54,255
https://kawalpemilu.org#41992,"WIJIREJO, PANDAK, BANTUL, DAERAH ISTIMEWA YOGYAKARTA",6,153,43,196
https://kawalpemilu.org#41992,"WIJIREJO, PANDAK, BANTUL, DAERAH ISTIMEWA YOGYAKARTA",7,142,37,179
https://kawalpemilu.org#41992,"WIJIREJO, PANDAK, BANTUL, DAERAH ISTIMEWA YOGYAKARTA",8,112,24,136
https://kawalpemilu.org#41992,"WIJIREJO, PANDAK, BANTUL, DAERAH ISTIMEWA YOGYAKARTA",9,170,60,230
https://kawalpemilu.org#41992,"WIJIREJO, PANDAK, BANTUL, DAERAH ISTIMEWA YOGYAKARTA",10,127,59,186
https://kawalpemilu.org#41992,"WIJIREJO, PANDAK, BANTUL, DAERAH ISTIMEWA YOGYAKARTA",11,126,37,163
https://kawalpemilu.org#41992,"WIJIREJO, PANDAK, BANTUL, DAERAH ISTIMEWA YOGYAKARTA",12,127,26,153
https://kawalpemilu.org#41992,"WIJIREJO, PANDAK, BANTUL, DAERAH ISTIMEWA YOGYAKARTA",13,141,53,194
https://kawalpemilu.org#41992,"WIJIREJO, PANDAK, BANTUL, DAERAH ISTIMEWA YOGYAKARTA",14,165,28,193
https://kawalpemilu.org#41992,"WIJIREJO, PANDAK, BANTUL, DAERAH ISTIMEWA YOGYAKARTA",15,154,40,194
https://kawalpemilu.org#41992,"WIJIREJO, PANDAK, BANTUL, DAERAH ISTIMEWA YOGYAKARTA",16,194,20,214
https://kawalpemilu.org#41992,"WIJIREJO, PANDAK, BANTUL, DAERAH ISTIMEWA YOGYAKARTA",17,160,56,216
https://kawalpemilu.org#41992,"WIJIREJO, PANDAK, BANTUL, DAERAH ISTIMEWA YOGYAKARTA",18,162,36,198
https://kawalpemilu.org#41992,"WIJIREJO, PANDAK, BANTUL, DAERAH ISTIMEWA YOGYAKARTA",19,174,51,225
https://kawalpemilu.org#41992,"WIJIREJO, PANDAK, BANTUL, DAERAH ISTIMEWA YOGYAKARTA",20,152,69,221
https://kawalpemilu.org#41992,"WIJIREJO, PANDAK, BANTUL, DAERAH ISTIMEWA YOGYAKARTA",21,112,24,136
https://kawalpemilu.org#41992,"WIJIREJO, PANDAK, BANTUL, DAERAH ISTIMEWA YOGYAKARTA",22,110,30,140
https://kawalpemilu.org#41992,"WIJIREJO, PANDAK, BANTUL, DAERAH ISTIMEWA YOGYAKARTA",23,157,86,243
https://kawalpemilu.org#41992,"WIJIREJO, PANDAK, BANTUL, DAERAH ISTIMEWA YOGYAKARTA",24,173,65,238
https://kawalpemilu.org#41992,"WIJIREJO, PANDAK, BANTUL, DAERAH ISTIMEWA YOGYAKARTA",25,154,33,187
https://kawalpemilu.org#41992,"WIJIREJO, PANDAK, BANTUL, DAERAH ISTIMEWA YOGYAKARTA",26,135,41,176
https://kawalpemilu.org#41992,"WIJIREJO, PANDAK, BANTUL, DAERAH ISTIMEWA YOGYAKARTA",27,98,34,132
https://kawalpemilu.org#41992,"WIJIREJO, PANDAK, BANTUL, DAERAH ISTIMEWA YOGYAKARTA",28,149,70,219
https://kawalpemilu.org#41992,"WIJIREJO, PANDAK, BANTUL, DAERAH ISTIMEWA YOGYAKARTA",29,130,73,203
https://kawalpemilu.org#41992,"WIJIREJO, PANDAK, BANTUL, DAERAH ISTIMEWA YOGYAKARTA",30,193,28,221
https://kawalpemilu.org#41992,"WIJIREJO, PANDAK, BANTUL, DAERAH ISTIMEWA YOGYAKARTA",31,173,37,210
https://kawalpemilu.org#41992,"WIJIREJO, PANDAK, BANTUL, DAERAH ISTIMEWA YOGYAKARTA",32,189,31,220
https://kawalpemilu.org#41992,"WIJIREJO, PANDAK, BANTUL, DAERAH ISTIMEWA YOGYAKARTA",33,187,65,252
https://kawalpemilu.org#41992,"WIJIREJO, PANDAK, BANTUL, DAERAH ISTIMEWA YOGYAKARTA",34,175,59,234
https://kawalpemilu.org#41992,"WIJIREJO, PANDAK, BANTUL, DAERAH ISTIMEWA YOGYAKARTA",35,155,87,242
https://kawalpemilu.org#41992,"WIJIREJO, PANDAK, BANTUL, DAERAH ISTIMEWA YOGYAKARTA",36,182,51,233
https://kawalpemilu.org#41992,"WIJIREJO, PANDAK, BANTUL, DAERAH ISTIMEWA YOGYAKARTA",37,175,51,226
https://kawalpemilu.org#41994,"TRIWIDADI, PAJANGAN, BANTUL, DAERAH ISTIMEWA YOGYAKARTA",1,94,45,139
https://kawalpemilu.org#41994,"TRIWIDADI, PAJANGAN, BANTUL, DAERAH ISTIMEWA YOGYAKARTA",2,169,44,213
https://kawalpemilu.org#41994,"TRIWIDADI, PAJANGAN, BANTUL, DAERAH ISTIMEWA YOGYAKARTA",3,142,65,207
https://kawalpemilu.org#41994,"TRIWIDADI, PAJANGAN, BANTUL, DAERAH ISTIMEWA YOGYAKARTA",4,156,60,216
https://kawalpemilu.org#41994,"TRIWIDADI, PAJANGAN, BANTUL, DAERAH ISTIMEWA YOGYAKARTA",5,135,47,182
https://kawalpemilu.org#41994,"TRIWIDADI, PAJANGAN, BANTUL, DAERAH ISTIMEWA YOGYAKARTA",6,178,49,227
https://kawalpemilu.org#41994,"TRIWIDADI, PAJANGAN, BANTUL, DAERAH ISTIMEWA YOGYAKARTA",7,78,69,147
https://kawalpemilu.org#41994,"TRIWIDADI, PAJANGAN, BANTUL, DAERAH ISTIMEWA YOGYAKARTA",8,100,33,133
https://kawalpemilu.org#41994,"TRIWIDADI, PAJANGAN, BANTUL, DAERAH ISTIMEWA YOGYAKARTA",9,135,58,193
https://kawalpemilu.org#41994,"TRIWIDADI, PAJANGAN, BANTUL, DAERAH ISTIMEWA YOGYAKARTA",10,101,12,113
https://kawalpemilu.org#41994,"TRIWIDADI, PAJANGAN, BANTUL, DAERAH ISTIMEWA YOGYAKARTA",11,120,82,202
https://kawalpemilu.org#41994,"TRIWIDADI, PAJANGAN, BANTUL, DAERAH ISTIMEWA YOGYAKARTA",12,213,20,233
https://kawalpemilu.org#41994,"TRIWIDADI, PAJANGAN, BANTUL, DAERAH ISTIMEWA YOGYAKARTA",13,145,91,236
https://kawalpemilu.org#41994,"TRIWIDADI, PAJANGAN, BANTUL, DAERAH ISTIMEWA YOGYAKARTA",14,194,45,239
https://kawalpemilu.org#41994,"TRIWIDADI, PAJANGAN, BANTUL, DAERAH ISTIMEWA YOGYAKARTA",15,108,31,139
https://kawalpemilu.org#41994,"TRIWIDADI, PAJANGAN, BANTUL, DAERAH ISTIMEWA YOGYAKARTA",16,136,27,163
https://kawalpemilu.org#41994,"TRIWIDADI, PAJANGAN, BANTUL, DAERAH ISTIMEWA YOGYAKARTA",17,100,62,162
https://kawalpemilu.org#41994,"TRIWIDADI, PAJANGAN, BANTUL, DAERAH ISTIMEWA YOGYAKARTA",18,117,73,190
https://kawalpemilu.org#41994,"TRIWIDADI, PAJANGAN, BANTUL, DAERAH ISTIMEWA YOGYAKARTA",19,45,86,131
https://kawalpemilu.org#41994,"TRIWIDADI, PAJANGAN, BANTUL, DAERAH ISTIMEWA YOGYAKARTA",20,67,116,183
https://kawalpemilu.org#41994,"TRIWIDADI, PAJANGAN, BANTUL, DAERAH ISTIMEWA YOGYAKARTA",21,155,23,178
https://kawalpemilu.org#41994,"TRIWIDADI, PAJANGAN, BANTUL, DAERAH ISTIMEWA YOGYAKARTA",22,119,36,155
https://kawalpemilu.org#41994,"TRIWIDADI, PAJANGAN, BANTUL, DAERAH ISTIMEWA YOGYAKARTA",23,194,40,234
https://kawalpemilu.org#41994,"TRIWIDADI, PAJANGAN, BANTUL, DAERAH ISTIMEWA YOGYAKARTA",24,182,82,264
https://kawalpemilu.org#41994,"TRIWIDADI, PAJANGAN, BANTUL, DAERAH ISTIMEWA YOGYAKARTA",25,140,43,183
https://kawalpemilu.org#41994,"TRIWIDADI, PAJANGAN, BANTUL, DAERAH ISTIMEWA YOGYAKARTA",26,110,32,142
https://kawalpemilu.org#41994,"TRIWIDADI, PAJANGAN, BANTUL, DAERAH ISTIMEWA YOGYAKARTA",27,113,83,196
https://kawalpemilu.org#41994,"TRIWIDADI, PAJANGAN, BANTUL, DAERAH ISTIMEWA YOGYAKARTA",28,154,103,257
https://kawalpemilu.org#41994,"TRIWIDADI, PAJANGAN, BANTUL, DAERAH ISTIMEWA YOGYAKARTA",29,93,42,135
https://kawalpemilu.org#41994,"TRIWIDADI, PAJANGAN, BANTUL, DAERAH ISTIMEWA YOGYAKARTA",30,91,48,139
https://kawalpemilu.org#41994,"TRIWIDADI, PAJANGAN, BANTUL, DAERAH ISTIMEWA YOGYAKARTA",31,133,55,188
https://kawalpemilu.org#41994,"TRIWIDADI, PAJANGAN, BANTUL, DAERAH ISTIMEWA YOGYAKARTA",32,135,61,196
https://kawalpemilu.org#41994,"TRIWIDADI, PAJANGAN, BANTUL, DAERAH ISTIMEWA YOGYAKARTA",33,184,75,259
https://kawalpemilu.org#41994,"TRIWIDADI, PAJANGAN, BANTUL, DAERAH ISTIMEWA YOGYAKARTA",34,111,48,159
https://kawalpemilu.org#41994,"TRIWIDADI, PAJANGAN, BANTUL, DAERAH ISTIMEWA YOGYAKARTA",35,86,39,125
https://kawalpemilu.org#41994,"TRIWIDADI, PAJANGAN, BANTUL, DAERAH ISTIMEWA YOGYAKARTA",36,131,47,178
https://kawalpemilu.org#41994,"TRIWIDADI, PAJANGAN, BANTUL, DAERAH ISTIMEWA YOGYAKARTA",37,139,84,223
https://kawalpemilu.org#41994,"TRIWIDADI, PAJANGAN, BANTUL, DAERAH ISTIMEWA YOGYAKARTA",38,149,59,208
https://kawalpemilu.org#41994,"TRIWIDADI, PAJANGAN, BANTUL, DAERAH ISTIMEWA YOGYAKARTA",39,101,103,204
https://kawalpemilu.org#41994,"TRIWIDADI, PAJANGAN, BANTUL, DAERAH ISTIMEWA YOGYAKARTA",40,139,54,193
https://kawalpemilu.org#41995,"SENDANGSARI, PAJANGAN, BANTUL, DAERAH ISTIMEWA YOGYAKARTA",1,114,33,147
https://kawalpemilu.org#41995,"SENDANGSARI, PAJANGAN, BANTUL, DAERAH ISTIMEWA YOGYAKARTA",2,190,33,223
https://kawalpemilu.org#41995,"SENDANGSARI, PAJANGAN, BANTUL, DAERAH ISTIMEWA YOGYAKARTA",3,138,35,173
https://kawalpemilu.org#41995,"SENDANGSARI, PAJANGAN, BANTUL, DAERAH ISTIMEWA YOGYAKARTA",4,143,39,182
https://kawalpemilu.org#41995,"SENDANGSARI, PAJANGAN, BANTUL, DAERAH ISTIMEWA YOGYAKARTA",5,137,43,180
https://kawalpemilu.org#41995,"SENDANGSARI, PAJANGAN, BANTUL, DAERAH ISTIMEWA YOGYAKARTA",6,109,74,183
https://kawalpemilu.org#41995,"SENDANGSARI, PAJANGAN, BANTUL, DAERAH ISTIMEWA YOGYAKARTA",7,98,40,138
https://kawalpemilu.org#41995,"SENDANGSARI, PAJANGAN, BANTUL, DAERAH ISTIMEWA YOGYAKARTA",8,121,83,204
https://kawalpemilu.org#41995,"SENDANGSARI, PAJANGAN, BANTUL, DAERAH ISTIMEWA YOGYAKARTA",9,160,75,235
https://kawalpemilu.org#41995,"SENDANGSARI, PAJANGAN, BANTUL, DAERAH ISTIMEWA YOGYAKARTA",10,185,42,227
https://kawalpemilu.org#41995,"SENDANGSARI, PAJANGAN, BANTUL, DAERAH ISTIMEWA YOGYAKARTA",11,119,42,161
https://kawalpemilu.org#41995,"SENDANGSARI, PAJANGAN, BANTUL, DAERAH ISTIMEWA YOGYAKARTA",12,177,37,214
https://kawalpemilu.org#41995,"SENDANGSARI, PAJANGAN, BANTUL, DAERAH ISTIMEWA YOGYAKARTA",13,211,65,276
https://kawalpemilu.org#41995,"SENDANGSARI, PAJANGAN, BANTUL, DAERAH ISTIMEWA YOGYAKARTA",14,141,42,183
https://kawalpemilu.org#41995,"SENDANGSARI, PAJANGAN, BANTUL, DAERAH ISTIMEWA YOGYAKARTA",15,0,0,0
https://kawalpemilu.org#41995,"SENDANGSARI, PAJANGAN, BANTUL, DAERAH ISTIMEWA YOGYAKARTA",16,114,17,131
https://kawalpemilu.org#41995,"SENDANGSARI, PAJANGAN, BANTUL, DAERAH ISTIMEWA YOGYAKARTA",17,125,12,137
https://kawalpemilu.org#41995,"SENDANGSARI, PAJANGAN, BANTUL, DAERAH ISTIMEWA YOGYAKARTA",18,216,43,259
https://kawalpemilu.org#41995,"SENDANGSARI, PAJANGAN, BANTUL, DAERAH ISTIMEWA YOGYAKARTA",19,165,38,203
https://kawalpemilu.org#41995,"SENDANGSARI, PAJANGAN, BANTUL, DAERAH ISTIMEWA YOGYAKARTA",20,200,31,231
https://kawalpemilu.org#41995,"SENDANGSARI, PAJANGAN, BANTUL, DAERAH ISTIMEWA YOGYAKARTA",21,182,42,224
https://kawalpemilu.org#41995,"SENDANGSARI, PAJANGAN, BANTUL, DAERAH ISTIMEWA YOGYAKARTA",22,209,21,230
https://kawalpemilu.org#41995,"SENDANGSARI, PAJANGAN, BANTUL, DAERAH ISTIMEWA YOGYAKARTA",23,234,28,262
https://kawalpemilu.org#41995,"SENDANGSARI, PAJANGAN, BANTUL, DAERAH ISTIMEWA YOGYAKARTA",24,246,29,275
https://kawalpemilu.org#41995,"SENDANGSARI, PAJANGAN, BANTUL, DAERAH ISTIMEWA YOGYAKARTA",25,201,52,253
https://kawalpemilu.org#41995,"SENDANGSARI, PAJANGAN, BANTUL, DAERAH ISTIMEWA YOGYAKARTA",26,222,50,272
https://kawalpemilu.org#41995,"SENDANGSARI, PAJANGAN, BANTUL, DAERAH ISTIMEWA YOGYAKARTA",27,162,29,191
https://kawalpemilu.org#41995,"SENDANGSARI, PAJANGAN, BANTUL, DAERAH ISTIMEWA YOGYAKARTA",28,167,50,217
https://kawalpemilu.org#41995,"SENDANGSARI, PAJANGAN, BANTUL, DAERAH ISTIMEWA YOGYAKARTA",29,183,51,234
https://kawalpemilu.org#41995,"SENDANGSARI, PAJANGAN, BANTUL, DAERAH ISTIMEWA YOGYAKARTA",30,160,20,180
https://kawalpemilu.org#41995,"SENDANGSARI, PAJANGAN, BANTUL, DAERAH ISTIMEWA YOGYAKARTA",31,190,51,241
https://kawalpemilu.org#41995,"SENDANGSARI, PAJANGAN, BANTUL, DAERAH ISTIMEWA YOGYAKARTA",32,202,41,243
https://kawalpemilu.org#41995,"SENDANGSARI, PAJANGAN, BANTUL, DAERAH ISTIMEWA YOGYAKARTA",33,157,61,218
https://kawalpemilu.org#41995,"SENDANGSARI, PAJANGAN, BANTUL, DAERAH ISTIMEWA YOGYAKARTA",34,193,44,237
https://kawalpemilu.org#41995,"SENDANGSARI, PAJANGAN, BANTUL, DAERAH ISTIMEWA YOGYAKARTA",35,181,65,246
https://kawalpemilu.org#41995,"SENDANGSARI, PAJANGAN, BANTUL, DAERAH ISTIMEWA YOGYAKARTA",36,171,51,222
https://kawalpemilu.org#41995,"SENDANGSARI, PAJANGAN, BANTUL, DAERAH ISTIMEWA YOGYAKARTA",37,199,53,252
https://kawalpemilu.org#41995,"SENDANGSARI, PAJANGAN, BANTUL, DAERAH ISTIMEWA YOGYAKARTA",38,101,54,160
https://kawalpemilu.org#41995,"SENDANGSARI, PAJANGAN, BANTUL, DAERAH ISTIMEWA YOGYAKARTA",39,111,78,189
https://kawalpemilu.org#41996,"GUWOSARI, PAJANGAN, BANTUL, DAERAH ISTIMEWA YOGYAKARTA",1,130,52,182
https://kawalpemilu.org#41996,"GUWOSARI, PAJANGAN, BANTUL, DAERAH ISTIMEWA YOGYAKARTA",2,207,43,250
https://kawalpemilu.org#41996,"GUWOSARI, PAJANGAN, BANTUL, DAERAH ISTIMEWA YOGYAKARTA",3,140,86,226
https://kawalpemilu.org#41996,"GUWOSARI, PAJANGAN, BANTUL, DAERAH ISTIMEWA YOGYAKARTA",4,113,43,156
https://kawalpemilu.org#41996,"GUWOSARI, PAJANGAN, BANTUL, DAERAH ISTIMEWA YOGYAKARTA",5,157,37,194
https://kawalpemilu.org#41996,"GUWOSARI, PAJANGAN, BANTUL, DAERAH ISTIMEWA YOGYAKARTA",6,155,30,185
https://kawalpemilu.org#41996,"GUWOSARI, PAJANGAN, BANTUL, DAERAH ISTIMEWA YOGYAKARTA",7,146,53,199
https://kawalpemilu.org#41996,"GUWOSARI, PAJANGAN, BANTUL, DAERAH ISTIMEWA YOGYAKARTA",8,107,107,214
https://kawalpemilu.org#41996,"GUWOSARI, PAJANGAN, BANTUL, DAERAH ISTIMEWA YOGYAKARTA",9,165,64,229
https://kawalpemilu.org#41996,"GUWOSARI, PAJANGAN, BANTUL, DAERAH ISTIMEWA YOGYAKARTA",10,145,51,196
https://kawalpemilu.org#41996,"GUWOSARI, PAJANGAN, BANTUL, DAERAH ISTIMEWA YOGYAKARTA",11,91,36,127
https://kawalpemilu.org#41996,"GUWOSARI, PAJANGAN, BANTUL, DAERAH ISTIMEWA YOGYAKARTA",12,127,24,151
https://kawalpemilu.org#41996,"GUWOSARI, PAJANGAN, BANTUL, DAERAH ISTIMEWA YOGYAKARTA",13,159,51,210
https://kawalpemilu.org#41996,"GUWOSARI, PAJANGAN, BANTUL, DAERAH ISTIMEWA YOGYAKARTA",14,143,37,180
https://kawalpemilu.org#41996,"GUWOSARI, PAJANGAN, BANTUL, DAERAH ISTIMEWA YOGYAKARTA",15,186,61,247
https://kawalpemilu.org#41996,"GUWOSARI, PAJANGAN, BANTUL, DAERAH ISTIMEWA YOGYAKARTA",16,120,64,184
https://kawalpemilu.org#41996,"GUWOSARI, PAJANGAN, BANTUL, DAERAH ISTIMEWA YOGYAKARTA",17,112,45,157
https://kawalpemilu.org#41996,"GUWOSARI, PAJANGAN, BANTUL, DAERAH ISTIMEWA YOGYAKARTA",18,115,89,204
https://kawalpemilu.org#41996,"GUWOSARI, PAJANGAN, BANTUL, DAERAH ISTIMEWA YOGYAKARTA",19,144,90,234
https://kawalpemilu.org#41996,"GUWOSARI, PAJANGAN, BANTUL, DAERAH ISTIMEWA YOGYAKARTA",20,155,23,178
https://kawalpemilu.org#41996,"GUWOSARI, PAJANGAN, BANTUL, DAERAH ISTIMEWA YOGYAKARTA",21,194,56,250
https://kawalpemilu.org#41996,"GUWOSARI, PAJANGAN, BANTUL, DAERAH ISTIMEWA YOGYAKARTA",22,153,32,185
https://kawalpemilu.org#41996,"GUWOSARI, PAJANGAN, BANTUL, DAERAH ISTIMEWA YOGYAKARTA",23,179,39,218
https://kawalpemilu.org#41996,"GUWOSARI, PAJANGAN, BANTUL, DAERAH ISTIMEWA YOGYAKARTA",24,172,32,204
https://kawalpemilu.org#41996,"GUWOSARI, PAJANGAN, BANTUL, DAERAH ISTIMEWA YOGYAKARTA",25,173,29,202
https://kawalpemilu.org#41996,"GUWOSARI, PAJANGAN, BANTUL, DAERAH ISTIMEWA YOGYAKARTA",26,167,30,197
https://kawalpemilu.org#41996,"GUWOSARI, PAJANGAN, BANTUL, DAERAH ISTIMEWA YOGYAKARTA",27,151,50,201
https://kawalpemilu.org#41996,"GUWOSARI, PAJANGAN, BANTUL, DAERAH ISTIMEWA YOGYAKARTA",28,156,41,197
https://kawalpemilu.org#41996,"GUWOSARI, PAJANGAN, BANTUL, DAERAH ISTIMEWA YOGYAKARTA",29,136,92,228
https://kawalpemilu.org#41996,"GUWOSARI, PAJANGAN, BANTUL, DAERAH ISTIMEWA YOGYAKARTA",30,116,87,203
https://kawalpemilu.org#41996,"GUWOSARI, PAJANGAN, BANTUL, DAERAH ISTIMEWA YOGYAKARTA",31,130,65,198
https://kawalpemilu.org#41996,"GUWOSARI, PAJANGAN, BANTUL, DAERAH ISTIMEWA YOGYAKARTA",32,151,50,201
https://kawalpemilu.org#41996,"GUWOSARI, PAJANGAN, BANTUL, DAERAH ISTIMEWA YOGYAKARTA",33,99,23,122
https://kawalpemilu.org#41996,"GUWOSARI, PAJANGAN, BANTUL, DAERAH ISTIMEWA YOGYAKARTA",34,195,29,224
https://kawalpemilu.org#41996,"GUWOSARI, PAJANGAN, BANTUL, DAERAH ISTIMEWA YOGYAKARTA",35,154,31,185
https://kawalpemilu.org#41996,"GUWOSARI, PAJANGAN, BANTUL, DAERAH ISTIMEWA YOGYAKARTA",36,108,20,128
https://kawalpemilu.org#41996,"GUWOSARI, PAJANGAN, BANTUL, DAERAH ISTIMEWA YOGYAKARTA",37,145,42,187
https://kawalpemilu.org#41996,"GUWOSARI, PAJANGAN, BANTUL, DAERAH ISTIMEWA YOGYAKARTA",38,180,71,251
https://kawalpemilu.org#41996,"GUWOSARI, PAJANGAN, BANTUL, DAERAH ISTIMEWA YOGYAKARTA",39,195,40,235
https://kawalpemilu.org#41996,"GUWOSARI, PAJANGAN, BANTUL, DAERAH ISTIMEWA YOGYAKARTA",40,181,87,268
https://kawalpemilu.org#41996,"GUWOSARI, PAJANGAN, BANTUL, DAERAH ISTIMEWA YOGYAKARTA",41,170,83,253
https://kawalpemilu.org#41996,"GUWOSARI, PAJANGAN, BANTUL, DAERAH ISTIMEWA YOGYAKARTA",42,130,67,197
https://kawalpemilu.org#41996,"GUWOSARI, PAJANGAN, BANTUL, DAERAH ISTIMEWA YOGYAKARTA",43,164,87,251
https://kawalpemilu.org#41996,"GUWOSARI, PAJANGAN, BANTUL, DAERAH ISTIMEWA YOGYAKARTA",44,123,89,212
https://kawalpemilu.org#41998,"PALBAPANG, BANTUL, BANTUL, DAERAH ISTIMEWA YOGYAKARTA",1,119,94,213
https://kawalpemilu.org#41998,"PALBAPANG, BANTUL, BANTUL, DAERAH ISTIMEWA YOGYAKARTA",2,136,110,246
https://kawalpemilu.org#41998,"PALBAPANG, BANTUL, BANTUL, DAERAH ISTIMEWA YOGYAKARTA",3,80,94,174
https://kawalpemilu.org#41998,"PALBAPANG, BANTUL, BANTUL, DAERAH ISTIMEWA YOGYAKARTA",4,133,115,248
https://kawalpemilu.org#41998,"PALBAPANG, BANTUL, BANTUL, DAERAH ISTIMEWA YOGYAKARTA",5,130,81,211
https://kawalpemilu.org#41998,"PALBAPANG, BANTUL, BANTUL, DAERAH ISTIMEWA YOGYAKARTA",7,136,51,187
https://kawalpemilu.org#41998,"PALBAPANG, BANTUL, BANTUL, DAERAH ISTIMEWA YOGYAKARTA",8,164,103,267
https://kawalpemilu.org#41998,"PALBAPANG, BANTUL, BANTUL, DAERAH ISTIMEWA YOGYAKARTA",9,88,72,160
https://kawalpemilu.org#41998,"PALBAPANG, BANTUL, BANTUL, DAERAH ISTIMEWA YOGYAKARTA",10,156,61,217
https://kawalpemilu.org#41998,"PALBAPANG, BANTUL, BANTUL, DAERAH ISTIMEWA YOGYAKARTA",11,156,46,202
https://kawalpemilu.org#41998,"PALBAPANG, BANTUL, BANTUL, DAERAH ISTIMEWA YOGYAKARTA",12,176,57,233
https://kawalpemilu.org#41998,"PALBAPANG, BANTUL, BANTUL, DAERAH ISTIMEWA YOGYAKARTA",14,171,44,215
https://kawalpemilu.org#41998,"PALBAPANG, BANTUL, BANTUL, DAERAH ISTIMEWA YOGYAKARTA",16,157,52,209
https://kawalpemilu.org#41998,"PALBAPANG, BANTUL, BANTUL, DAERAH ISTIMEWA YOGYAKARTA",18,182,60,242
https://kawalpemilu.org#41998,"PALBAPANG, BANTUL, BANTUL, DAERAH ISTIMEWA YOGYAKARTA",19,149,75,224
https://kawalpemilu.org#41998,"PALBAPANG, BANTUL, BANTUL, DAERAH ISTIMEWA YOGYAKARTA",20,210,52,262
https://kawalpemilu.org#41998,"PALBAPANG, BANTUL, BANTUL, DAERAH ISTIMEWA YOGYAKARTA",21,226,46,272
https://kawalpemilu.org#41998,"PALBAPANG, BANTUL, BANTUL, DAERAH ISTIMEWA YOGYAKARTA",22,177,80,257
https://kawalpemilu.org#41998,"PALBAPANG, BANTUL, BANTUL, DAERAH ISTIMEWA YOGYAKARTA",23,177,66,243
https://kawalpemilu.org#41998,"PALBAPANG, BANTUL, BANTUL, DAERAH ISTIMEWA YOGYAKARTA",24,183,58,241
https://kawalpemilu.org#41998,"PALBAPANG, BANTUL, BANTUL, DAERAH ISTIMEWA YOGYAKARTA",25,144,80,224
https://kawalpemilu.org#41998,"PALBAPANG, BANTUL, BANTUL, DAERAH ISTIMEWA YOGYAKARTA",26,145,88,233
https://kawalpemilu.org#41998,"PALBAPANG, BANTUL, BANTUL, DAERAH ISTIMEWA YOGYAKARTA",27,169,78,247
https://kawalpemilu.org#41998,"PALBAPANG, BANTUL, BANTUL, DAERAH ISTIMEWA YOGYAKARTA",28,163,65,228
https://kawalpemilu.org#41998,"PALBAPANG, BANTUL, BANTUL, DAERAH ISTIMEWA YOGYAKARTA",29,184,58,242
https://kawalpemilu.org#41998,"PALBAPANG, BANTUL, BANTUL, DAERAH ISTIMEWA YOGYAKARTA",30,216,56,272
https://kawalpemilu.org#41998,"PALBAPANG, BANTUL, BANTUL, DAERAH ISTIMEWA YOGYAKARTA",31,166,66,232
https://kawalpemilu.org#41998,"PALBAPANG, BANTUL, BANTUL, DAERAH ISTIMEWA YOGYAKARTA",32,153,52,205
https://kawalpemilu.org#41998,"PALBAPANG, BANTUL, BANTUL, DAERAH ISTIMEWA YOGYAKARTA",33,148,101,249
https://kawalpemilu.org#41998,"PALBAPANG, BANTUL, BANTUL, DAERAH ISTIMEWA YOGYAKARTA",34,170,75,245
https://kawalpemilu.org#41998,"PALBAPANG, BANTUL, BANTUL, DAERAH ISTIMEWA YOGYAKARTA",35,187,64,251
https://kawalpemilu.org#41998,"PALBAPANG, BANTUL, BANTUL, DAERAH ISTIMEWA YOGYAKARTA",36,153,81,234
https://kawalpemilu.org#41998,"PALBAPANG, BANTUL, BANTUL, DAERAH ISTIMEWA YOGYAKARTA",37,129,78,207
https://kawalpemilu.org#41998,"PALBAPANG, BANTUL, BANTUL, DAERAH ISTIMEWA YOGYAKARTA",38,132,114,246
https://kawalpemilu.org#41998,"PALBAPANG, BANTUL, BANTUL, DAERAH ISTIMEWA YOGYAKARTA",39,174,69,243
https://kawalpemilu.org#41998,"PALBAPANG, BANTUL, BANTUL, DAERAH ISTIMEWA YOGYAKARTA",40,172,59,231
https://kawalpemilu.org#41998,"PALBAPANG, BANTUL, BANTUL, DAERAH ISTIMEWA YOGYAKARTA",41,128,67,195
https://kawalpemilu.org#41999,"RINGINHARJO, BANTUL, BANTUL, DAERAH ISTIMEWA YOGYAKARTA",1,182,48,230
https://kawalpemilu.org#41999,"RINGINHARJO, BANTUL, BANTUL, DAERAH ISTIMEWA YOGYAKARTA",2,143,99,242
https://kawalpemilu.org#41999,"RINGINHARJO, BANTUL, BANTUL, DAERAH ISTIMEWA YOGYAKARTA",3,152,72,224
https://kawalpemilu.org#41999,"RINGINHARJO, BANTUL, BANTUL, DAERAH ISTIMEWA YOGYAKARTA",4,186,63,249
https://kawalpemilu.org#41999,"RINGINHARJO, BANTUL, BANTUL, DAERAH ISTIMEWA YOGYAKARTA",5,164,39,203
https://kawalpemilu.org#41999,"RINGINHARJO, BANTUL, BANTUL, DAERAH ISTIMEWA YOGYAKARTA",6,155,50,205
https://kawalpemilu.org#41999,"RINGINHARJO, BANTUL, BANTUL, DAERAH ISTIMEWA YOGYAKARTA",7,124,53,177
https://kawalpemilu.org#41999,"RINGINHARJO, BANTUL, BANTUL, DAERAH ISTIMEWA YOGYAKARTA",8,156,37,193
https://kawalpemilu.org#41999,"RINGINHARJO, BANTUL, BANTUL, DAERAH ISTIMEWA YOGYAKARTA",9,162,40,202
https://kawalpemilu.org#41999,"RINGINHARJO, BANTUL, BANTUL, DAERAH ISTIMEWA YOGYAKARTA",10,157,82,239
https://kawalpemilu.org#41999,"RINGINHARJO, BANTUL, BANTUL, DAERAH ISTIMEWA YOGYAKARTA",11,147,91,238
https://kawalpemilu.org#41999,"RINGINHARJO, BANTUL, BANTUL, DAERAH ISTIMEWA YOGYAKARTA",12,143,119,262
https://kawalpemilu.org#41999,"RINGINHARJO, BANTUL, BANTUL, DAERAH ISTIMEWA YOGYAKARTA",13,127,95,222
https://kawalpemilu.org#41999,"RINGINHARJO, BANTUL, BANTUL, DAERAH ISTIMEWA YOGYAKARTA",14,128,93,221
https://kawalpemilu.org#41999,"RINGINHARJO, BANTUL, BANTUL, DAERAH ISTIMEWA YOGYAKARTA",15,179,49,228
https://kawalpemilu.org#41999,"RINGINHARJO, BANTUL, BANTUL, DAERAH ISTIMEWA YOGYAKARTA",16,165,75,240
https://kawalpemilu.org#41999,"RINGINHARJO, BANTUL, BANTUL, DAERAH ISTIMEWA YOGYAKARTA",17,99,28,127
https://kawalpemilu.org#41999,"RINGINHARJO, BANTUL, BANTUL, DAERAH ISTIMEWA YOGYAKARTA",18,136,107,243
https://kawalpemilu.org#41999,"RINGINHARJO, BANTUL, BANTUL, DAERAH ISTIMEWA YOGYAKARTA",19,107,101,208
https://kawalpemilu.org#41999,"RINGINHARJO, BANTUL, BANTUL, DAERAH ISTIMEWA YOGYAKARTA",20,168,49,217
https://kawalpemilu.org#41999,"RINGINHARJO, BANTUL, BANTUL, DAERAH ISTIMEWA YOGYAKARTA",21,111,104,215
https://kawalpemilu.org#41999,"RINGINHARJO, BANTUL, BANTUL, DAERAH ISTIMEWA YOGYAKARTA",22,76,93,169
https://kawalpemilu.org#41999,"RINGINHARJO, BANTUL, BANTUL, DAERAH ISTIMEWA YOGYAKARTA",23,96,116,212
https://kawalpemilu.org#41999,"RINGINHARJO, BANTUL, BANTUL, DAERAH ISTIMEWA YOGYAKARTA",24,204,78,282
https://kawalpemilu.org#41999,"RINGINHARJO, BANTUL, BANTUL, DAERAH ISTIMEWA YOGYAKARTA",25,120,118,238
https://kawalpemilu.org#42000,"BANTUL, BANTUL, BANTUL, DAERAH ISTIMEWA YOGYAKARTA",1,112,87,199
https://kawalpemilu.org#42000,"BANTUL, BANTUL, BANTUL, DAERAH ISTIMEWA YOGYAKARTA",2,129,67,196
https://kawalpemilu.org#42000,"BANTUL, BANTUL, BANTUL, DAERAH ISTIMEWA YOGYAKARTA",3,143,72,215
https://kawalpemilu.org#42000,"BANTUL, BANTUL, BANTUL, DAERAH ISTIMEWA YOGYAKARTA",4,149,70,219
https://kawalpemilu.org#42000,"BANTUL, BANTUL, BANTUL, DAERAH ISTIMEWA YOGYAKARTA",5,131,97,228
https://kawalpemilu.org#42000,"BANTUL, BANTUL, BANTUL, DAERAH ISTIMEWA YOGYAKARTA",6,120,94,214
https://kawalpemilu.org#42000,"BANTUL, BANTUL, BANTUL, DAERAH ISTIMEWA YOGYAKARTA",7,161,44,205
https://kawalpemilu.org#42000,"BANTUL, BANTUL, BANTUL, DAERAH ISTIMEWA YOGYAKARTA",8,137,63,200
https://kawalpemilu.org#42000,"BANTUL, BANTUL, BANTUL, DAERAH ISTIMEWA YOGYAKARTA",9,120,112,232
https://kawalpemilu.org#42000,"BANTUL, BANTUL, BANTUL, DAERAH ISTIMEWA YOGYAKARTA",10,118,94,212
https://kawalpemilu.org#42000,"BANTUL, BANTUL, BANTUL, DAERAH ISTIMEWA YOGYAKARTA",11,115,73,188
https://kawalpemilu.org#42000,"BANTUL, BANTUL, BANTUL, DAERAH ISTIMEWA YOGYAKARTA",12,127,86,213
https://kawalpemilu.org#42000,"BANTUL, BANTUL, BANTUL, DAERAH ISTIMEWA YOGYAKARTA",13,83,158,241
https://kawalpemilu.org#42000,"BANTUL, BANTUL, BANTUL, DAERAH ISTIMEWA YOGYAKARTA",14,111,115,226
https://kawalpemilu.org#42000,"BANTUL, BANTUL, BANTUL, DAERAH ISTIMEWA YOGYAKARTA",15,129,118,247
https://kawalpemilu.org#42000,"BANTUL, BANTUL, BANTUL, DAERAH ISTIMEWA YOGYAKARTA",16,105,132,237
https://kawalpemilu.org#42000,"BANTUL, BANTUL, BANTUL, DAERAH ISTIMEWA YOGYAKARTA",17,113,97,210
https://kawalpemilu.org#42000,"BANTUL, BANTUL, BANTUL, DAERAH ISTIMEWA YOGYAKARTA",18,78,77,155
https://kawalpemilu.org#42000,"BANTUL, BANTUL, BANTUL, DAERAH ISTIMEWA YOGYAKARTA",19,97,61,158
https://kawalpemilu.org#42000,"BANTUL, BANTUL, BANTUL, DAERAH ISTIMEWA YOGYAKARTA",20,135,92,227
https://kawalpemilu.org#42000,"BANTUL, BANTUL, BANTUL, DAERAH ISTIMEWA YOGYAKARTA",21,169,92,261
https://kawalpemilu.org#42000,"BANTUL, BANTUL, BANTUL, DAERAH ISTIMEWA YOGYAKARTA",22,147,73,220
https://kawalpemilu.org#42000,"BANTUL, BANTUL, BANTUL, DAERAH ISTIMEWA YOGYAKARTA",23,112,38,150
https://kawalpemilu.org#42000,"BANTUL, BANTUL, BANTUL, DAERAH ISTIMEWA YOGYAKARTA",24,151,60,211
https://kawalpemilu.org#42000,"BANTUL, BANTUL, BANTUL, DAERAH ISTIMEWA YOGYAKARTA",25,134,34,168
https://kawalpemilu.org#42000,"BANTUL, BANTUL, BANTUL, DAERAH ISTIMEWA YOGYAKARTA",26,111,106,217
https://kawalpemilu.org#42000,"BANTUL, BANTUL, BANTUL, DAERAH ISTIMEWA YOGYAKARTA",27,110,103,213
https://kawalpemilu.org#42000,"BANTUL, BANTUL, BANTUL, DAERAH ISTIMEWA YOGYAKARTA",28,66,52,118
https://kawalpemilu.org#42000,"BANTUL, BANTUL, BANTUL, DAERAH ISTIMEWA YOGYAKARTA",29,96,113,209
https://kawalpemilu.org#42000,"BANTUL, BANTUL, BANTUL, DAERAH ISTIMEWA YOGYAKARTA",30,115,59,174
https://kawalpemilu.org#42000,"BANTUL, BANTUL, BANTUL, DAERAH ISTIMEWA YOGYAKARTA",31,151,66,217
https://kawalpemilu.org#42000,"BANTUL, BANTUL, BANTUL, DAERAH ISTIMEWA YOGYAKARTA",32,165,85,250
https://kawalpemilu.org#42000,"BANTUL, BANTUL, BANTUL, DAERAH ISTIMEWA YOGYAKARTA",33,178,57,235
https://kawalpemilu.org#42000,"BANTUL, BANTUL, BANTUL, DAERAH ISTIMEWA YOGYAKARTA",34,170,73,243
https://kawalpemilu.org#42000,"BANTUL, BANTUL, BANTUL, DAERAH ISTIMEWA YOGYAKARTA",35,133,107,240
https://kawalpemilu.org#42000,"BANTUL, BANTUL, BANTUL, DAERAH ISTIMEWA YOGYAKARTA",36,159,110,269
https://kawalpemilu.org#42000,"BANTUL, BANTUL, BANTUL, DAERAH ISTIMEWA YOGYAKARTA",37,203,41,244
https://kawalpemilu.org#42000,"BANTUL, BANTUL, BANTUL, DAERAH ISTIMEWA YOGYAKARTA",38,195,68,263
https://kawalpemilu.org#42000,"BANTUL, BANTUL, BANTUL, DAERAH ISTIMEWA YOGYAKARTA",39,115,82,197
https://kawalpemilu.org#42000,"BANTUL, BANTUL, BANTUL, DAERAH ISTIMEWA YOGYAKARTA",40,97,96,193
https://kawalpemilu.org#42000,"BANTUL, BANTUL, BANTUL, DAERAH ISTIMEWA YOGYAKARTA",41,113,103,216
https://kawalpemilu.org#42000,"BANTUL, BANTUL, BANTUL, DAERAH ISTIMEWA YOGYAKARTA",43,149,64,213
https://kawalpemilu.org#42000,"BANTUL, BANTUL, BANTUL, DAERAH ISTIMEWA YOGYAKARTA",44,163,80,243
https://kawalpemilu.org#42000,"BANTUL, BANTUL, BANTUL, DAERAH ISTIMEWA YOGYAKARTA",45,179,64,243
https://kawalpemilu.org#42000,"BANTUL, BANTUL, BANTUL, DAERAH ISTIMEWA YOGYAKARTA",46,67,24,91
https://kawalpemilu.org#42000,"BANTUL, BANTUL, BANTUL, DAERAH ISTIMEWA YOGYAKARTA",47,153,54,207
https://kawalpemilu.org#42000,"BANTUL, BANTUL, BANTUL, DAERAH ISTIMEWA YOGYAKARTA",48,105,91,196
https://kawalpemilu.org#42000,"BANTUL, BANTUL, BANTUL, DAERAH ISTIMEWA YOGYAKARTA",49,166,69,235
https://kawalpemilu.org#42000,"BANTUL, BANTUL, BANTUL, DAERAH ISTIMEWA YOGYAKARTA",50,176,66,242
https://kawalpemilu.org#42000,"BANTUL, BANTUL, BANTUL, DAERAH ISTIMEWA YOGYAKARTA",51,173,56,229
https://kawalpemilu.org#42001,"TRIRENGGO, BANTUL, BANTUL, DAERAH ISTIMEWA YOGYAKARTA",1,167,90,257
https://kawalpemilu.org#42001,"TRIRENGGO, BANTUL, BANTUL, DAERAH ISTIMEWA YOGYAKARTA",2,157,65,222
https://kawalpemilu.org#42001,"TRIRENGGO, BANTUL, BANTUL, DAERAH ISTIMEWA YOGYAKARTA",3,157,93,250
https://kawalpemilu.org#42001,"TRIRENGGO, BANTUL, BANTUL, DAERAH ISTIMEWA YOGYAKARTA",4,111,64,175
https://kawalpemilu.org#42001,"TRIRENGGO, BANTUL, BANTUL, DAERAH ISTIMEWA YOGYAKARTA",5,134,112,246
https://kawalpemilu.org#42001,"TRIRENGGO, BANTUL, BANTUL, DAERAH ISTIMEWA YOGYAKARTA",6,107,73,180
https://kawalpemilu.org#42001,"TRIRENGGO, BANTUL, BANTUL, DAERAH ISTIMEWA YOGYAKARTA",7,217,52,269
https://kawalpemilu.org#42001,"TRIRENGGO, BANTUL, BANTUL, DAERAH ISTIMEWA YOGYAKARTA",8,205,60,265
https://kawalpemilu.org#42001,"TRIRENGGO, BANTUL, BANTUL, DAERAH ISTIMEWA YOGYAKARTA",9,185,77,262
https://kawalpemilu.org#42001,"TRIRENGGO, BANTUL, BANTUL, DAERAH ISTIMEWA YOGYAKARTA",11,129,75,204
https://kawalpemilu.org#42001,"TRIRENGGO, BANTUL, BANTUL, DAERAH ISTIMEWA YOGYAKARTA",12,183,84,267
https://kawalpemilu.org#42001,"TRIRENGGO, BANTUL, BANTUL, DAERAH ISTIMEWA YOGYAKARTA",13,161,76,237
https://kawalpemilu.org#42001,"TRIRENGGO, BANTUL, BANTUL, DAERAH ISTIMEWA YOGYAKARTA",14,157,120,277
https://kawalpemilu.org#42001,"TRIRENGGO, BANTUL, BANTUL, DAERAH ISTIMEWA YOGYAKARTA",15,158,112,270
https://kawalpemilu.org#42001,"TRIRENGGO, BANTUL, BANTUL, DAERAH ISTIMEWA YOGYAKARTA",16,111,70,181
https://kawalpemilu.org#42001,"TRIRENGGO, BANTUL, BANTUL, DAERAH ISTIMEWA YOGYAKARTA",17,78,110,188
https://kawalpemilu.org#42001,"TRIRENGGO, BANTUL, BANTUL, DAERAH ISTIMEWA YOGYAKARTA",18,184,61,245
https://kawalpemilu.org#42001,"TRIRENGGO, BANTUL, BANTUL, DAERAH ISTIMEWA YOGYAKARTA",19,51,169,220
https://kawalpemilu.org#42001,"TRIRENGGO, BANTUL, BANTUL, DAERAH ISTIMEWA YOGYAKARTA",20,98,138,236
https://kawalpemilu.org#42001,"TRIRENGGO, BANTUL, BANTUL, DAERAH ISTIMEWA YOGYAKARTA",21,128,78,206
https://kawalpemilu.org#42001,"TRIRENGGO, BANTUL, BANTUL, DAERAH ISTIMEWA YOGYAKARTA",22,128,105,233
https://kawalpemilu.org#42001,"TRIRENGGO, BANTUL, BANTUL, DAERAH ISTIMEWA YOGYAKARTA",23,116,101,217
https://kawalpemilu.org#42001,"TRIRENGGO, BANTUL, BANTUL, DAERAH ISTIMEWA YOGYAKARTA",24,120,92,212
https://kawalpemilu.org#42001,"TRIRENGGO, BANTUL, BANTUL, DAERAH ISTIMEWA YOGYAKARTA",25,163,89,252
https://kawalpemilu.org#42001,"TRIRENGGO, BANTUL, BANTUL, DAERAH ISTIMEWA YOGYAKARTA",26,164,26,190
https://kawalpemilu.org#42001,"TRIRENGGO, BANTUL, BANTUL, DAERAH ISTIMEWA YOGYAKARTA",27,155,50,205
https://kawalpemilu.org#42001,"TRIRENGGO, BANTUL, BANTUL, DAERAH ISTIMEWA YOGYAKARTA",28,182,24,206
https://kawalpemilu.org#42001,"TRIRENGGO, BANTUL, BANTUL, DAERAH ISTIMEWA YOGYAKARTA",29,128,40,168
https://kawalpemilu.org#42001,"TRIRENGGO, BANTUL, BANTUL, DAERAH ISTIMEWA YOGYAKARTA",30,123,87,210
https://kawalpemilu.org#42001,"TRIRENGGO, BANTUL, BANTUL, DAERAH ISTIMEWA YOGYAKARTA",31,118,76,194
https://kawalpemilu.org#42001,"TRIRENGGO, BANTUL, BANTUL, DAERAH ISTIMEWA YOGYAKARTA",32,168,46,214
https://kawalpemilu.org#42001,"TRIRENGGO, BANTUL, BANTUL, DAERAH ISTIMEWA YOGYAKARTA",33,104,53,157
https://kawalpemilu.org#42001,"TRIRENGGO, BANTUL, BANTUL, DAERAH ISTIMEWA YOGYAKARTA",34,95,92,187
https://kawalpemilu.org#42001,"TRIRENGGO, BANTUL, BANTUL, DAERAH ISTIMEWA YOGYAKARTA",35,119,44,163
https://kawalpemilu.org#42001,"TRIRENGGO, BANTUL, BANTUL, DAERAH ISTIMEWA YOGYAKARTA",36,142,52,194
https://kawalpemilu.org#42001,"TRIRENGGO, BANTUL, BANTUL, DAERAH ISTIMEWA YOGYAKARTA",37,148,47,195
https://kawalpemilu.org#42001,"TRIRENGGO, BANTUL, BANTUL, DAERAH ISTIMEWA YOGYAKARTA",38,140,48,188
https://kawalpemilu.org#42001,"TRIRENGGO, BANTUL, BANTUL, DAERAH ISTIMEWA YOGYAKARTA",39,120,66,186
https://kawalpemilu.org#42001,"TRIRENGGO, BANTUL, BANTUL, DAERAH ISTIMEWA YOGYAKARTA",40,150,63,213
https://kawalpemilu.org#42001,"TRIRENGGO, BANTUL, BANTUL, DAERAH ISTIMEWA YOGYAKARTA",41,178,48,224
https://kawalpemilu.org#42001,"TRIRENGGO, BANTUL, BANTUL, DAERAH ISTIMEWA YOGYAKARTA",42,152,43,195
https://kawalpemilu.org#42001,"TRIRENGGO, BANTUL, BANTUL, DAERAH ISTIMEWA YOGYAKARTA",43,176,46,222
https://kawalpemilu.org#42001,"TRIRENGGO, BANTUL, BANTUL, DAERAH ISTIMEWA YOGYAKARTA",44,171,60,231
https://kawalpemilu.org#42001,"TRIRENGGO, BANTUL, BANTUL, DAERAH ISTIMEWA YOGYAKARTA",45,195,56,251
https://kawalpemilu.org#42001,"TRIRENGGO, BANTUL, BANTUL, DAERAH ISTIMEWA YOGYAKARTA",46,130,74,204
https://kawalpemilu.org#42001,"TRIRENGGO, BANTUL, BANTUL, DAERAH ISTIMEWA YOGYAKARTA",47,117,88,205
https://kawalpemilu.org#42001,"TRIRENGGO, BANTUL, BANTUL, DAERAH ISTIMEWA YOGYAKARTA",48,150,62,212
https://kawalpemilu.org#42001,"TRIRENGGO, BANTUL, BANTUL, DAERAH ISTIMEWA YOGYAKARTA",49,210,32,242
https://kawalpemilu.org#42001,"TRIRENGGO, BANTUL, BANTUL, DAERAH ISTIMEWA YOGYAKARTA",50,158,52,210
https://kawalpemilu.org#42001,"TRIRENGGO, BANTUL, BANTUL, DAERAH ISTIMEWA YOGYAKARTA",51,149,59,208
https://kawalpemilu.org#42001,"TRIRENGGO, BANTUL, BANTUL, DAERAH ISTIMEWA YOGYAKARTA",53,166,42,208
https://kawalpemilu.org#42001,"TRIRENGGO, BANTUL, BANTUL, DAERAH ISTIMEWA YOGYAKARTA",54,163,49,212
https://kawalpemilu.org#42001,"TRIRENGGO, BANTUL, BANTUL, DAERAH ISTIMEWA YOGYAKARTA",55,110,86,196
https://kawalpemilu.org#42001,"TRIRENGGO, BANTUL, BANTUL, DAERAH ISTIMEWA YOGYAKARTA",56,135,66,201
https://kawalpemilu.org#42002,"SABDODADI, BANTUL, BANTUL, DAERAH ISTIMEWA YOGYAKARTA",1,208,36,244
https://kawalpemilu.org#42002,"SABDODADI, BANTUL, BANTUL, DAERAH ISTIMEWA YOGYAKARTA",2,183,54,237
https://kawalpemilu.org#42002,"SABDODADI, BANTUL, BANTUL, DAERAH ISTIMEWA YOGYAKARTA",3,140,98,238
https://kawalpemilu.org#42002,"SABDODADI, BANTUL, BANTUL, DAERAH ISTIMEWA YOGYAKARTA",4,160,90,250
https://kawalpemilu.org#42002,"SABDODADI, BANTUL, BANTUL, DAERAH ISTIMEWA YOGYAKARTA",5,149,83,232
https://kawalpemilu.org#42002,"SABDODADI, BANTUL, BANTUL, DAERAH ISTIMEWA YOGYAKARTA",6,171,94,265
https://kawalpemilu.org#42002,"SABDODADI, BANTUL, BANTUL, DAERAH ISTIMEWA YOGYAKARTA",7,152,56,208
https://kawalpemilu.org#42002,"SABDODADI, BANTUL, BANTUL, DAERAH ISTIMEWA YOGYAKARTA",8,131,50,181
https://kawalpemilu.org#42002,"SABDODADI, BANTUL, BANTUL, DAERAH ISTIMEWA YOGYAKARTA",9,159,45,204
https://kawalpemilu.org#42002,"SABDODADI, BANTUL, BANTUL, DAERAH ISTIMEWA YOGYAKARTA",10,143,107,250
https://kawalpemilu.org#42002,"SABDODADI, BANTUL, BANTUL, DAERAH ISTIMEWA YOGYAKARTA",11,174,68,242
https://kawalpemilu.org#42002,"SABDODADI, BANTUL, BANTUL, DAERAH ISTIMEWA YOGYAKARTA",12,164,59,223
https://kawalpemilu.org#42002,"SABDODADI, BANTUL, BANTUL, DAERAH ISTIMEWA YOGYAKARTA",13,147,81,228
https://kawalpemilu.org#42002,"SABDODADI, BANTUL, BANTUL, DAERAH ISTIMEWA YOGYAKARTA",14,192,50,242
https://kawalpemilu.org#42002,"SABDODADI, BANTUL, BANTUL, DAERAH ISTIMEWA YOGYAKARTA",15,135,120,255
https://kawalpemilu.org#42002,"SABDODADI, BANTUL, BANTUL, DAERAH ISTIMEWA YOGYAKARTA",16,91,152,243
https://kawalpemilu.org#42002,"SABDODADI, BANTUL, BANTUL, DAERAH ISTIMEWA YOGYAKARTA",17,181,61,242
https://kawalpemilu.org#42002,"SABDODADI, BANTUL, BANTUL, DAERAH ISTIMEWA YOGYAKARTA",18,167,54,221
https://kawalpemilu.org#42002,"SABDODADI, BANTUL, BANTUL, DAERAH ISTIMEWA YOGYAKARTA",19,156,67,223
https://kawalpemilu.org#42002,"SABDODADI, BANTUL, BANTUL, DAERAH ISTIMEWA YOGYAKARTA",20,218,34,252
https://kawalpemilu.org#42004,"PATALAN, JETIS, BANTUL, DAERAH ISTIMEWA YOGYAKARTA",1,116,40,156
https://kawalpemilu.org#42004,"PATALAN, JETIS, BANTUL, DAERAH ISTIMEWA YOGYAKARTA",2,120,55,175
https://kawalpemilu.org#42004,"PATALAN, JETIS, BANTUL, DAERAH ISTIMEWA YOGYAKARTA",3,111,60,171
https://kawalpemilu.org#42004,"PATALAN, JETIS, BANTUL, DAERAH ISTIMEWA YOGYAKARTA",4,133,82,215
https://kawalpemilu.org#42004,"PATALAN, JETIS, BANTUL, DAERAH ISTIMEWA YOGYAKARTA",5,96,94,190
https://kawalpemilu.org#42004,"PATALAN, JETIS, BANTUL, DAERAH ISTIMEWA YOGYAKARTA",6,151,41,192
https://kawalpemilu.org#42004,"PATALAN, JETIS, BANTUL, DAERAH ISTIMEWA YOGYAKARTA",7,124,52,176
https://kawalpemilu.org#42004,"PATALAN, JETIS, BANTUL, DAERAH ISTIMEWA YOGYAKARTA",8,145,99,244
https://kawalpemilu.org#42004,"PATALAN, JETIS, BANTUL, DAERAH ISTIMEWA YOGYAKARTA",9,157,48,205
https://kawalpemilu.org#42004,"PATALAN, JETIS, BANTUL, DAERAH ISTIMEWA YOGYAKARTA",10,116,12,128
https://kawalpemilu.org#42004,"PATALAN, JETIS, BANTUL, DAERAH ISTIMEWA YOGYAKARTA",11,137,22,159
https://kawalpemilu.org#42004,"PATALAN, JETIS, BANTUL, DAERAH ISTIMEWA YOGYAKARTA",12,109,53,162
https://kawalpemilu.org#42004,"PATALAN, JETIS, BANTUL, DAERAH ISTIMEWA YOGYAKARTA",13,125,32,157
https://kawalpemilu.org#42004,"PATALAN, JETIS, BANTUL, DAERAH ISTIMEWA YOGYAKARTA",14,146,39,185
https://kawalpemilu.org#42004,"PATALAN, JETIS, BANTUL, DAERAH ISTIMEWA YOGYAKARTA",15,151,70,221
https://kawalpemilu.org#42004,"PATALAN, JETIS, BANTUL, DAERAH ISTIMEWA YOGYAKARTA",16,129,45,174
https://kawalpemilu.org#42004,"PATALAN, JETIS, BANTUL, DAERAH ISTIMEWA YOGYAKARTA",17,154,64,218
https://kawalpemilu.org#42004,"PATALAN, JETIS, BANTUL, DAERAH ISTIMEWA YOGYAKARTA",18,181,52,233
https://kawalpemilu.org#42004,"PATALAN, JETIS, BANTUL, DAERAH ISTIMEWA YOGYAKARTA",19,127,64,191
https://kawalpemilu.org#42004,"PATALAN, JETIS, BANTUL, DAERAH ISTIMEWA YOGYAKARTA",20,122,122,244
https://kawalpemilu.org#42004,"PATALAN, JETIS, BANTUL, DAERAH ISTIMEWA YOGYAKARTA",21,152,46,198
https://kawalpemilu.org#42004,"PATALAN, JETIS, BANTUL, DAERAH ISTIMEWA YOGYAKARTA",22,146,62,208
https://kawalpemilu.org#42004,"PATALAN, JETIS, BANTUL, DAERAH ISTIMEWA YOGYAKARTA",23,116,34,150
https://kawalpemilu.org#42004,"PATALAN, JETIS, BANTUL, DAERAH ISTIMEWA YOGYAKARTA",24,166,70,236
https://kawalpemilu.org#42004,"PATALAN, JETIS, BANTUL, DAERAH ISTIMEWA YOGYAKARTA",25,168,80,248
https://kawalpemilu.org#42004,"PATALAN, JETIS, BANTUL, DAERAH ISTIMEWA YOGYAKARTA",26,156,49,205
https://kawalpemilu.org#42004,"PATALAN, JETIS, BANTUL, DAERAH ISTIMEWA YOGYAKARTA",27,104,57,161
https://kawalpemilu.org#42004,"PATALAN, JETIS, BANTUL, DAERAH ISTIMEWA YOGYAKARTA",28,144,76,220
https://kawalpemilu.org#42004,"PATALAN, JETIS, BANTUL, DAERAH ISTIMEWA YOGYAKARTA",29,139,74,213
https://kawalpemilu.org#42004,"PATALAN, JETIS, BANTUL, DAERAH ISTIMEWA YOGYAKARTA",30,147,76,223
https://kawalpemilu.org#42004,"PATALAN, JETIS, BANTUL, DAERAH ISTIMEWA YOGYAKARTA",31,105,47,152
https://kawalpemilu.org#42004,"PATALAN, JETIS, BANTUL, DAERAH ISTIMEWA YOGYAKARTA",32,89,23,112
https://kawalpemilu.org#42004,"PATALAN, JETIS, BANTUL, DAERAH ISTIMEWA YOGYAKARTA",33,97,37,134
https://kawalpemilu.org#42004,"PATALAN, JETIS, BANTUL, DAERAH ISTIMEWA YOGYAKARTA",34,139,91,230
https://kawalpemilu.org#42004,"PATALAN, JETIS, BANTUL, DAERAH ISTIMEWA YOGYAKARTA",35,132,62,194
https://kawalpemilu.org#42004,"PATALAN, JETIS, BANTUL, DAERAH ISTIMEWA YOGYAKARTA",36,178,70,248
https://kawalpemilu.org#42004,"PATALAN, JETIS, BANTUL, DAERAH ISTIMEWA YOGYAKARTA",37,190,22,212
https://kawalpemilu.org#42004,"PATALAN, JETIS, BANTUL, DAERAH ISTIMEWA YOGYAKARTA",38,148,31,179
https://kawalpemilu.org#42004,"PATALAN, JETIS, BANTUL, DAERAH ISTIMEWA YOGYAKARTA",39,104,53,157
https://kawalpemilu.org#42004,"PATALAN, JETIS, BANTUL, DAERAH ISTIMEWA YOGYAKARTA",40,91,54,145
https://kawalpemilu.org#42004,"PATALAN, JETIS, BANTUL, DAERAH ISTIMEWA YOGYAKARTA",41,114,51,165
https://kawalpemilu.org#42004,"PATALAN, JETIS, BANTUL, DAERAH ISTIMEWA YOGYAKARTA",42,133,60,193
https://kawalpemilu.org#42004,"PATALAN, JETIS, BANTUL, DAERAH ISTIMEWA YOGYAKARTA",43,150,47,197
https://kawalpemilu.org#42005,"CANDEN, JETIS, BANTUL, DAERAH ISTIMEWA YOGYAKARTA",1,163,45,208
https://kawalpemilu.org#42005,"CANDEN, JETIS, BANTUL, DAERAH ISTIMEWA YOGYAKARTA",2,171,48,219
https://kawalpemilu.org#42005,"CANDEN, JETIS, BANTUL, DAERAH ISTIMEWA YOGYAKARTA",3,137,48,185
https://kawalpemilu.org#42005,"CANDEN, JETIS, BANTUL, DAERAH ISTIMEWA YOGYAKARTA",4,102,57,159
https://kawalpemilu.org#42005,"CANDEN, JETIS, BANTUL, DAERAH ISTIMEWA YOGYAKARTA",5,113,55,168
https://kawalpemilu.org#42005,"CANDEN, JETIS, BANTUL, DAERAH ISTIMEWA YOGYAKARTA",6,112,71,183
https://kawalpemilu.org#42005,"CANDEN, JETIS, BANTUL, DAERAH ISTIMEWA YOGYAKARTA",7,160,37,197
https://kawalpemilu.org#42005,"CANDEN, JETIS, BANTUL, DAERAH ISTIMEWA YOGYAKARTA",8,154,50,204
https://kawalpemilu.org#42005,"CANDEN, JETIS, BANTUL, DAERAH ISTIMEWA YOGYAKARTA",9,181,44,225
https://kawalpemilu.org#42005,"CANDEN, JETIS, BANTUL, DAERAH ISTIMEWA YOGYAKARTA",10,119,50,169
https://kawalpemilu.org#42005,"CANDEN, JETIS, BANTUL, DAERAH ISTIMEWA YOGYAKARTA",11,146,56,202
https://kawalpemilu.org#42005,"CANDEN, JETIS, BANTUL, DAERAH ISTIMEWA YOGYAKARTA",12,159,43,202
https://kawalpemilu.org#42005,"CANDEN, JETIS, BANTUL, DAERAH ISTIMEWA YOGYAKARTA",13,129,72,201
https://kawalpemilu.org#42005,"CANDEN, JETIS, BANTUL, DAERAH ISTIMEWA YOGYAKARTA",14,169,43,212
https://kawalpemilu.org#42005,"CANDEN, JETIS, BANTUL, DAERAH ISTIMEWA YOGYAKARTA",15,172,50,222
https://kawalpemilu.org#42005,"CANDEN, JETIS, BANTUL, DAERAH ISTIMEWA YOGYAKARTA",16,166,37,203
https://kawalpemilu.org#42005,"CANDEN, JETIS, BANTUL, DAERAH ISTIMEWA YOGYAKARTA",17,166,53,219
https://kawalpemilu.org#42005,"CANDEN, JETIS, BANTUL, DAERAH ISTIMEWA YOGYAKARTA",18,121,107,228
https://kawalpemilu.org#42005,"CANDEN, JETIS, BANTUL, DAERAH ISTIMEWA YOGYAKARTA",19,143,80,223
https://kawalpemilu.org#42005,"CANDEN, JETIS, BANTUL, DAERAH ISTIMEWA YOGYAKARTA",20,126,81,207
https://kawalpemilu.org#42005,"CANDEN, JETIS, BANTUL, DAERAH ISTIMEWA YOGYAKARTA",21,163,51,214
https://kawalpemilu.org#42005,"CANDEN, JETIS, BANTUL, DAERAH ISTIMEWA YOGYAKARTA",22,161,48,209
https://kawalpemilu.org#42005,"CANDEN, JETIS, BANTUL, DAERAH ISTIMEWA YOGYAKARTA",23,163,61,224
https://kawalpemilu.org#42005,"CANDEN, JETIS, BANTUL, DAERAH ISTIMEWA YOGYAKARTA",24,115,37,152
https://kawalpemilu.org#42005,"CANDEN, JETIS, BANTUL, DAERAH ISTIMEWA YOGYAKARTA",25,118,26,144
https://kawalpemilu.org#42005,"CANDEN, JETIS, BANTUL, DAERAH ISTIMEWA YOGYAKARTA",26,127,86,213
https://kawalpemilu.org#42005,"CANDEN, JETIS, BANTUL, DAERAH ISTIMEWA YOGYAKARTA",27,113,71,184
https://kawalpemilu.org#42005,"CANDEN, JETIS, BANTUL, DAERAH ISTIMEWA YOGYAKARTA",28,119,91,210
https://kawalpemilu.org#42005,"CANDEN, JETIS, BANTUL, DAERAH ISTIMEWA YOGYAKARTA",29,117,75,192
https://kawalpemilu.org#42005,"CANDEN, JETIS, BANTUL, DAERAH ISTIMEWA YOGYAKARTA",30,158,52,210
https://kawalpemilu.org#42005,"CANDEN, JETIS, BANTUL, DAERAH ISTIMEWA YOGYAKARTA",31,131,85,216
https://kawalpemilu.org#42005,"CANDEN, JETIS, BANTUL, DAERAH ISTIMEWA YOGYAKARTA",32,113,62,175
https://kawalpemilu.org#42005,"CANDEN, JETIS, BANTUL, DAERAH ISTIMEWA YOGYAKARTA",33,144,46,190
https://kawalpemilu.org#42005,"CANDEN, JETIS, BANTUL, DAERAH ISTIMEWA YOGYAKARTA",34,129,29,158
https://kawalpemilu.org#42005,"CANDEN, JETIS, BANTUL, DAERAH ISTIMEWA YOGYAKARTA",35,163,51,214
https://kawalpemilu.org#42005,"CANDEN, JETIS, BANTUL, DAERAH ISTIMEWA YOGYAKARTA",36,122,78,200
https://kawalpemilu.org#42005,"CANDEN, JETIS, BANTUL, DAERAH ISTIMEWA YOGYAKARTA",37,212,68,280
https://kawalpemilu.org#42005,"CANDEN, JETIS, BANTUL, DAERAH ISTIMEWA YOGYAKARTA",38,186,83,269
https://kawalpemilu.org#42005,"CANDEN, JETIS, BANTUL, DAERAH ISTIMEWA YOGYAKARTA",39,152,37,189
https://kawalpemilu.org#42005,"CANDEN, JETIS, BANTUL, DAERAH ISTIMEWA YOGYAKARTA",40,181,53,234
https://kawalpemilu.org#42006,"SUMBERAGUNG, JETIS, BANTUL, DAERAH ISTIMEWA YOGYAKARTA",1,143,54,197
https://kawalpemilu.org#42006,"SUMBERAGUNG, JETIS, BANTUL, DAERAH ISTIMEWA YOGYAKARTA",2,132,68,200
https://kawalpemilu.org#42006,"SUMBERAGUNG, JETIS, BANTUL, DAERAH ISTIMEWA YOGYAKARTA",3,92,38,130
https://kawalpemilu.org#42006,"SUMBERAGUNG, JETIS, BANTUL, DAERAH ISTIMEWA YOGYAKARTA",4,159,55,214
https://kawalpemilu.org#42006,"SUMBERAGUNG, JETIS, BANTUL, DAERAH ISTIMEWA YOGYAKARTA",5,132,65,197
https://kawalpemilu.org#42006,"SUMBERAGUNG, JETIS, BANTUL, DAERAH ISTIMEWA YOGYAKARTA",6,119,31,150
https://kawalpemilu.org#42006,"SUMBERAGUNG, JETIS, BANTUL, DAERAH ISTIMEWA YOGYAKARTA",7,158,26,184
https://kawalpemilu.org#42006,"SUMBERAGUNG, JETIS, BANTUL, DAERAH ISTIMEWA YOGYAKARTA",8,110,53,163
https://kawalpemilu.org#42006,"SUMBERAGUNG, JETIS, BANTUL, DAERAH ISTIMEWA YOGYAKARTA",9,78,75,153
https://kawalpemilu.org#42006,"SUMBERAGUNG, JETIS, BANTUL, DAERAH ISTIMEWA YOGYAKARTA",10,149,54,203
https://kawalpemilu.org#42006,"SUMBERAGUNG, JETIS, BANTUL, DAERAH ISTIMEWA YOGYAKARTA",11,146,72,218
https://kawalpemilu.org#42006,"SUMBERAGUNG, JETIS, BANTUL, DAERAH ISTIMEWA YOGYAKARTA",12,185,56,241
https://kawalpemilu.org#42006,"SUMBERAGUNG, JETIS, BANTUL, DAERAH ISTIMEWA YOGYAKARTA",13,143,25,168
https://kawalpemilu.org#42006,"SUMBERAGUNG, JETIS, BANTUL, DAERAH ISTIMEWA YOGYAKARTA",14,120,42,162
https://kawalpemilu.org#42006,"SUMBERAGUNG, JETIS, BANTUL, DAERAH ISTIMEWA YOGYAKARTA",15,173,58,231
https://kawalpemilu.org#42006,"SUMBERAGUNG, JETIS, BANTUL, DAERAH ISTIMEWA YOGYAKARTA",16,128,62,190
https://kawalpemilu.org#42006,"SUMBERAGUNG, JETIS, BANTUL, DAERAH ISTIMEWA YOGYAKARTA",17,102,78,180
https://kawalpemilu.org#42006,"SUMBERAGUNG, JETIS, BANTUL, DAERAH ISTIMEWA YOGYAKARTA",18,134,71,205
https://kawalpemilu.org#42006,"SUMBERAGUNG, JETIS, BANTUL, DAERAH ISTIMEWA YOGYAKARTA",19,144,81,225
https://kawalpemilu.org#42006,"SUMBERAGUNG, JETIS, BANTUL, DAERAH ISTIMEWA YOGYAKARTA",20,121,52,173
https://kawalpemilu.org#42006,"SUMBERAGUNG, JETIS, BANTUL, DAERAH ISTIMEWA YOGYAKARTA",21,98,75,173
https://kawalpemilu.org#42006,"SUMBERAGUNG, JETIS, BANTUL, DAERAH ISTIMEWA YOGYAKARTA",22,95,93,188
https://kawalpemilu.org#42006,"SUMBERAGUNG, JETIS, BANTUL, DAERAH ISTIMEWA YOGYAKARTA",23,152,52,204
https://kawalpemilu.org#42006,"SUMBERAGUNG, JETIS, BANTUL, DAERAH ISTIMEWA YOGYAKARTA",24,143,89,232
https://kawalpemilu.org#42006,"SUMBERAGUNG, JETIS, BANTUL, DAERAH ISTIMEWA YOGYAKARTA",25,141,67,208
https://kawalpemilu.org#42006,"SUMBERAGUNG, JETIS, BANTUL, DAERAH ISTIMEWA YOGYAKARTA",26,142,70,212
https://kawalpemilu.org#42006,"SUMBERAGUNG, JETIS, BANTUL, DAERAH ISTIMEWA YOGYAKARTA",27,119,51,170
https://kawalpemilu.org#42006,"SUMBERAGUNG, JETIS, BANTUL, DAERAH ISTIMEWA YOGYAKARTA",28,118,39,157
https://kawalpemilu.org#42006,"SUMBERAGUNG, JETIS, BANTUL, DAERAH ISTIMEWA YOGYAKARTA",29,139,48,187
https://kawalpemilu.org#42006,"SUMBERAGUNG, JETIS, BANTUL, DAERAH ISTIMEWA YOGYAKARTA",30,119,36,155
https://kawalpemilu.org#42006,"SUMBERAGUNG, JETIS, BANTUL, DAERAH ISTIMEWA YOGYAKARTA",31,142,30,172
https://kawalpemilu.org#42006,"SUMBERAGUNG, JETIS, BANTUL, DAERAH ISTIMEWA YOGYAKARTA",32,148,37,185
https://kawalpemilu.org#42006,"SUMBERAGUNG, JETIS, BANTUL, DAERAH ISTIMEWA YOGYAKARTA",33,133,66,199
https://kawalpemilu.org#42006,"SUMBERAGUNG, JETIS, BANTUL, DAERAH ISTIMEWA YOGYAKARTA",34,147,39,186
https://kawalpemilu.org#42006,"SUMBERAGUNG, JETIS, BANTUL, DAERAH ISTIMEWA YOGYAKARTA",35,121,58,179
https://kawalpemilu.org#42006,"SUMBERAGUNG, JETIS, BANTUL, DAERAH ISTIMEWA YOGYAKARTA",36,88,58,146
https://kawalpemilu.org#42006,"SUMBERAGUNG, JETIS, BANTUL, DAERAH ISTIMEWA YOGYAKARTA",37,144,41,185
https://kawalpemilu.org#42006,"SUMBERAGUNG, JETIS, BANTUL, DAERAH ISTIMEWA YOGYAKARTA",38,96,46,142
https://kawalpemilu.org#42006,"SUMBERAGUNG, JETIS, BANTUL, DAERAH ISTIMEWA YOGYAKARTA",39,137,81,218
https://kawalpemilu.org#42006,"SUMBERAGUNG, JETIS, BANTUL, DAERAH ISTIMEWA YOGYAKARTA",40,121,140,261
https://kawalpemilu.org#42006,"SUMBERAGUNG, JETIS, BANTUL, DAERAH ISTIMEWA YOGYAKARTA",41,43,114,157
https://kawalpemilu.org#42006,"SUMBERAGUNG, JETIS, BANTUL, DAERAH ISTIMEWA YOGYAKARTA",42,126,111,237
https://kawalpemilu.org#42006,"SUMBERAGUNG, JETIS, BANTUL, DAERAH ISTIMEWA YOGYAKARTA",43,104,42,146
https://kawalpemilu.org#42006,"SUMBERAGUNG, JETIS, BANTUL, DAERAH ISTIMEWA YOGYAKARTA",44,152,41,193
https://kawalpemilu.org#42006,"SUMBERAGUNG, JETIS, BANTUL, DAERAH ISTIMEWA YOGYAKARTA",45,134,49,183
https://kawalpemilu.org#42006,"SUMBERAGUNG, JETIS, BANTUL, DAERAH ISTIMEWA YOGYAKARTA",46,179,60,239
https://kawalpemilu.org#42006,"SUMBERAGUNG, JETIS, BANTUL, DAERAH ISTIMEWA YOGYAKARTA",47,119,40,159
https://kawalpemilu.org#42006,"SUMBERAGUNG, JETIS, BANTUL, DAERAH ISTIMEWA YOGYAKARTA",48,153,51,204
https://kawalpemilu.org#42006,"SUMBERAGUNG, JETIS, BANTUL, DAERAH ISTIMEWA YOGYAKARTA",49,214,52,266
https://kawalpemilu.org#42006,"SUMBERAGUNG, JETIS, BANTUL, DAERAH ISTIMEWA YOGYAKARTA",50,205,45,250
https://kawalpemilu.org#42006,"SUMBERAGUNG, JETIS, BANTUL, DAERAH ISTIMEWA YOGYAKARTA",51,169,46,215
https://kawalpemilu.org#42006,"SUMBERAGUNG, JETIS, BANTUL, DAERAH ISTIMEWA YOGYAKARTA",52,171,60,231
https://kawalpemilu.org#42006,"SUMBERAGUNG, JETIS, BANTUL, DAERAH ISTIMEWA YOGYAKARTA",53,143,50,193
https://kawalpemilu.org#42007,"TRIMULYO, JETIS, BANTUL, DAERAH ISTIMEWA YOGYAKARTA",1,61,144,205
https://kawalpemilu.org#42007,"TRIMULYO, JETIS, BANTUL, DAERAH ISTIMEWA YOGYAKARTA",2,35,143,178
https://kawalpemilu.org#42007,"TRIMULYO, JETIS, BANTUL, DAERAH ISTIMEWA YOGYAKARTA",3,68,51,119
https://kawalpemilu.org#42007,"TRIMULYO, JETIS, BANTUL, DAERAH ISTIMEWA YOGYAKARTA",4,201,47,248
https://kawalpemilu.org#42007,"TRIMULYO, JETIS, BANTUL, DAERAH ISTIMEWA YOGYAKARTA",5,74,131,205
https://kawalpemilu.org#42007,"TRIMULYO, JETIS, BANTUL, DAERAH ISTIMEWA YOGYAKARTA",6,92,138,230
https://kawalpemilu.org#42007,"TRIMULYO, JETIS, BANTUL, DAERAH ISTIMEWA YOGYAKARTA",7,54,140,194
https://kawalpemilu.org#42007,"TRIMULYO, JETIS, BANTUL, DAERAH ISTIMEWA YOGYAKARTA",8,81,151,232
https://kawalpemilu.org#42007,"TRIMULYO, JETIS, BANTUL, DAERAH ISTIMEWA YOGYAKARTA",9,138,98,236
https://kawalpemilu.org#42007,"TRIMULYO, JETIS, BANTUL, DAERAH ISTIMEWA YOGYAKARTA",10,174,95,269
https://kawalpemilu.org#42007,"TRIMULYO, JETIS, BANTUL, DAERAH ISTIMEWA YOGYAKARTA",11,157,72,229
https://kawalpemilu.org#42007,"TRIMULYO, JETIS, BANTUL, DAERAH ISTIMEWA YOGYAKARTA",12,161,106,267
https://kawalpemilu.org#42007,"TRIMULYO, JETIS, BANTUL, DAERAH ISTIMEWA YOGYAKARTA",13,115,92,207
https://kawalpemilu.org#42007,"TRIMULYO, JETIS, BANTUL, DAERAH ISTIMEWA YOGYAKARTA",14,167,59,226
https://kawalpemilu.org#42007,"TRIMULYO, JETIS, BANTUL, DAERAH ISTIMEWA YOGYAKARTA",15,156,86,242
https://kawalpemilu.org#42007,"TRIMULYO, JETIS, BANTUL, DAERAH ISTIMEWA YOGYAKARTA",16,165,49,214
https://kawalpemilu.org#42007,"TRIMULYO, JETIS, BANTUL, DAERAH ISTIMEWA YOGYAKARTA",17,101,99,200
https://kawalpemilu.org#42007,"TRIMULYO, JETIS, BANTUL, DAERAH ISTIMEWA YOGYAKARTA",18,112,120,232
https://kawalpemilu.org#42007,"TRIMULYO, JETIS, BANTUL, DAERAH ISTIMEWA YOGYAKARTA",19,130,78,208
https://kawalpemilu.org#42007,"TRIMULYO, JETIS, BANTUL, DAERAH ISTIMEWA YOGYAKARTA",20,123,64,187
https://kawalpemilu.org#42007,"TRIMULYO, JETIS, BANTUL, DAERAH ISTIMEWA YOGYAKARTA",21,114,101,215
https://kawalpemilu.org#42007,"TRIMULYO, JETIS, BANTUL, DAERAH ISTIMEWA YOGYAKARTA",22,179,91,270
https://kawalpemilu.org#42007,"TRIMULYO, JETIS, BANTUL, DAERAH ISTIMEWA YOGYAKARTA",23,182,87,269
https://kawalpemilu.org#42007,"TRIMULYO, JETIS, BANTUL, DAERAH ISTIMEWA YOGYAKARTA",24,110,80,190
https://kawalpemilu.org#42007,"TRIMULYO, JETIS, BANTUL, DAERAH ISTIMEWA YOGYAKARTA",25,163,56,219
https://kawalpemilu.org#42007,"TRIMULYO, JETIS, BANTUL, DAERAH ISTIMEWA YOGYAKARTA",26,168,57,225
https://kawalpemilu.org#42007,"TRIMULYO, JETIS, BANTUL, DAERAH ISTIMEWA YOGYAKARTA",27,243,37,243
https://kawalpemilu.org#42007,"TRIMULYO, JETIS, BANTUL, DAERAH ISTIMEWA YOGYAKARTA",28,130,68,198
https://kawalpemilu.org#42007,"TRIMULYO, JETIS, BANTUL, DAERAH ISTIMEWA YOGYAKARTA",29,120,139,259
https://kawalpemilu.org#42007,"TRIMULYO, JETIS, BANTUL, DAERAH ISTIMEWA YOGYAKARTA",30,145,60,205
https://kawalpemilu.org#42007,"TRIMULYO, JETIS, BANTUL, DAERAH ISTIMEWA YOGYAKARTA",31,148,82,230
https://kawalpemilu.org#42007,"TRIMULYO, JETIS, BANTUL, DAERAH ISTIMEWA YOGYAKARTA",32,146,53,199
https://kawalpemilu.org#42007,"TRIMULYO, JETIS, BANTUL, DAERAH ISTIMEWA YOGYAKARTA",33,188,40,228
https://kawalpemilu.org#42007,"TRIMULYO, JETIS, BANTUL, DAERAH ISTIMEWA YOGYAKARTA",34,131,74,205
https://kawalpemilu.org#42007,"TRIMULYO, JETIS, BANTUL, DAERAH ISTIMEWA YOGYAKARTA",35,143,100,243
https://kawalpemilu.org#42007,"TRIMULYO, JETIS, BANTUL, DAERAH ISTIMEWA YOGYAKARTA",36,157,87,244
https://kawalpemilu.org#42007,"TRIMULYO, JETIS, BANTUL, DAERAH ISTIMEWA YOGYAKARTA",37,149,79,228
https://kawalpemilu.org#42007,"TRIMULYO, JETIS, BANTUL, DAERAH ISTIMEWA YOGYAKARTA",38,158,63,221
https://kawalpemilu.org#42007,"TRIMULYO, JETIS, BANTUL, DAERAH ISTIMEWA YOGYAKARTA",39,156,87,243
https://kawalpemilu.org#42007,"TRIMULYO, JETIS, BANTUL, DAERAH ISTIMEWA YOGYAKARTA",40,163,55,218
https://kawalpemilu.org#42007,"TRIMULYO, JETIS, BANTUL, DAERAH ISTIMEWA YOGYAKARTA",41,163,77,240
https://kawalpemilu.org#42007,"TRIMULYO, JETIS, BANTUL, DAERAH ISTIMEWA YOGYAKARTA",42,170,62,232
https://kawalpemilu.org#42007,"TRIMULYO, JETIS, BANTUL, DAERAH ISTIMEWA YOGYAKARTA",43,95,88,183
https://kawalpemilu.org#42007,"TRIMULYO, JETIS, BANTUL, DAERAH ISTIMEWA YOGYAKARTA",44,161,58,219
https://kawalpemilu.org#42007,"TRIMULYO, JETIS, BANTUL, DAERAH ISTIMEWA YOGYAKARTA",45,123,83,206
https://kawalpemilu.org#42007,"TRIMULYO, JETIS, BANTUL, DAERAH ISTIMEWA YOGYAKARTA",46,142,81,223
https://kawalpemilu.org#42007,"TRIMULYO, JETIS, BANTUL, DAERAH ISTIMEWA YOGYAKARTA",47,175,48,223
https://kawalpemilu.org#42007,"TRIMULYO, JETIS, BANTUL, DAERAH ISTIMEWA YOGYAKARTA",48,177,69,246
https://kawalpemilu.org#42007,"TRIMULYO, JETIS, BANTUL, DAERAH ISTIMEWA YOGYAKARTA",49,154,67,221
https://kawalpemilu.org#42007,"TRIMULYO, JETIS, BANTUL, DAERAH ISTIMEWA YOGYAKARTA",50,157,84,241
https://kawalpemilu.org#42007,"TRIMULYO, JETIS, BANTUL, DAERAH ISTIMEWA YOGYAKARTA",51,144,58,202
https://kawalpemilu.org#42007,"TRIMULYO, JETIS, BANTUL, DAERAH ISTIMEWA YOGYAKARTA",52,143,76,219
https://kawalpemilu.org#42007,"TRIMULYO, JETIS, BANTUL, DAERAH ISTIMEWA YOGYAKARTA",53,149,61,210
https://kawalpemilu.org#42007,"TRIMULYO, JETIS, BANTUL, DAERAH ISTIMEWA YOGYAKARTA",54,112,76,188
https://kawalpemilu.org#42007,"TRIMULYO, JETIS, BANTUL, DAERAH ISTIMEWA YOGYAKARTA",55,167,63,230
https://kawalpemilu.org#42007,"TRIMULYO, JETIS, BANTUL, DAERAH ISTIMEWA YOGYAKARTA",56,68,152,220
https://kawalpemilu.org#42009,"SELOPAMIORO, IMOGIRI, BANTUL, DAERAH ISTIMEWA YOGYAKARTA",1,129,31,0
https://kawalpemilu.org#42009,"SELOPAMIORO, IMOGIRI, BANTUL, DAERAH ISTIMEWA YOGYAKARTA",2,121,37,158
https://kawalpemilu.org#42009,"SELOPAMIORO, IMOGIRI, BANTUL, DAERAH ISTIMEWA YOGYAKARTA",3,101,53,154
https://kawalpemilu.org#42009,"SELOPAMIORO, IMOGIRI, BANTUL, DAERAH ISTIMEWA YOGYAKARTA",4,184,50,234
https://kawalpemilu.org#42009,"SELOPAMIORO, IMOGIRI, BANTUL, DAERAH ISTIMEWA YOGYAKARTA",5,167,68,235
https://kawalpemilu.org#42009,"SELOPAMIORO, IMOGIRI, BANTUL, DAERAH ISTIMEWA YOGYAKARTA",6,166,31,197
https://kawalpemilu.org#42009,"SELOPAMIORO, IMOGIRI, BANTUL, DAERAH ISTIMEWA YOGYAKARTA",7,125,16,141
https://kawalpemilu.org#42009,"SELOPAMIORO, IMOGIRI, BANTUL, DAERAH ISTIMEWA YOGYAKARTA",8,148,52,200
https://kawalpemilu.org#42009,"SELOPAMIORO, IMOGIRI, BANTUL, DAERAH ISTIMEWA YOGYAKARTA",9,175,24,199
https://kawalpemilu.org#42009,"SELOPAMIORO, IMOGIRI, BANTUL, DAERAH ISTIMEWA YOGYAKARTA",10,180,38,218
https://kawalpemilu.org#42009,"SELOPAMIORO, IMOGIRI, BANTUL, DAERAH ISTIMEWA YOGYAKARTA",11,158,40,198
https://kawalpemilu.org#42009,"SELOPAMIORO, IMOGIRI, BANTUL, DAERAH ISTIMEWA YOGYAKARTA",12,179,22,201
https://kawalpemilu.org#42009,"SELOPAMIORO, IMOGIRI, BANTUL, DAERAH ISTIMEWA YOGYAKARTA",13,146,45,191
https://kawalpemilu.org#42009,"SELOPAMIORO, IMOGIRI, BANTUL, DAERAH ISTIMEWA YOGYAKARTA",14,163,12,175
https://kawalpemilu.org#42009,"SELOPAMIORO, IMOGIRI, BANTUL, DAERAH ISTIMEWA YOGYAKARTA",15,145,19,164
https://kawalpemilu.org#42009,"SELOPAMIORO, IMOGIRI, BANTUL, DAERAH ISTIMEWA YOGYAKARTA",16,60,76,136
https://kawalpemilu.org#42009,"SELOPAMIORO, IMOGIRI, BANTUL, DAERAH ISTIMEWA YOGYAKARTA",17,148,80,228
https://kawalpemilu.org#42009,"SELOPAMIORO, IMOGIRI, BANTUL, DAERAH ISTIMEWA YOGYAKARTA",18,108,119,227
https://kawalpemilu.org#42009,"SELOPAMIORO, IMOGIRI, BANTUL, DAERAH ISTIMEWA YOGYAKARTA",19,140,84,224
https://kawalpemilu.org#42009,"SELOPAMIORO, IMOGIRI, BANTUL, DAERAH ISTIMEWA YOGYAKARTA",20,134,67,201
https://kawalpemilu.org#42009,"SELOPAMIORO, IMOGIRI, BANTUL, DAERAH ISTIMEWA YOGYAKARTA",21,121,35,156
https://kawalpemilu.org#42009,"SELOPAMIORO, IMOGIRI, BANTUL, DAERAH ISTIMEWA YOGYAKARTA",22,175,13,188
https://kawalpemilu.org#42009,"SELOPAMIORO, IMOGIRI, BANTUL, DAERAH ISTIMEWA YOGYAKARTA",23,173,23,196
https://kawalpemilu.org#42009,"SELOPAMIORO, IMOGIRI, BANTUL, DAERAH ISTIMEWA YOGYAKARTA",24,147,21,168
https://kawalpemilu.org#42009,"SELOPAMIORO, IMOGIRI, BANTUL, DAERAH ISTIMEWA YOGYAKARTA",25,144,45,189
https://kawalpemilu.org#42009,"SELOPAMIORO, IMOGIRI, BANTUL, DAERAH ISTIMEWA YOGYAKARTA",26,111,37,148
https://kawalpemilu.org#42009,"SELOPAMIORO, IMOGIRI, BANTUL, DAERAH ISTIMEWA YOGYAKARTA",27,152,34,186
https://kawalpemilu.org#42009,"SELOPAMIORO, IMOGIRI, BANTUL, DAERAH ISTIMEWA YOGYAKARTA",28,120,60,180
https://kawalpemilu.org#42009,"SELOPAMIORO, IMOGIRI, BANTUL, DAERAH ISTIMEWA YOGYAKARTA",29,120,44,164
https://kawalpemilu.org#42009,"SELOPAMIORO, IMOGIRI, BANTUL, DAERAH ISTIMEWA YOGYAKARTA",30,166,42,208
https://kawalpemilu.org#42009,"SELOPAMIORO, IMOGIRI, BANTUL, DAERAH ISTIMEWA YOGYAKARTA",31,157,18,175
https://kawalpemilu.org#42009,"SELOPAMIORO, IMOGIRI, BANTUL, DAERAH ISTIMEWA YOGYAKARTA",32,121,58,179
https://kawalpemilu.org#42009,"SELOPAMIORO, IMOGIRI, BANTUL, DAERAH ISTIMEWA YOGYAKARTA",33,174,51,225
https://kawalpemilu.org#42009,"SELOPAMIORO, IMOGIRI, BANTUL, DAERAH ISTIMEWA YOGYAKARTA",34,183,31,214
https://kawalpemilu.org#42009,"SELOPAMIORO, IMOGIRI, BANTUL, DAERAH ISTIMEWA YOGYAKARTA",35,160,49,209
https://kawalpemilu.org#42009,"SELOPAMIORO, IMOGIRI, BANTUL, DAERAH ISTIMEWA YOGYAKARTA",36,155,50,205
https://kawalpemilu.org#42009,"SELOPAMIORO, IMOGIRI, BANTUL, DAERAH ISTIMEWA YOGYAKARTA",37,69,58,127
https://kawalpemilu.org#42009,"SELOPAMIORO, IMOGIRI, BANTUL, DAERAH ISTIMEWA YOGYAKARTA",38,91,43,134
https://kawalpemilu.org#42009,"SELOPAMIORO, IMOGIRI, BANTUL, DAERAH ISTIMEWA YOGYAKARTA",39,225,31,256
https://kawalpemilu.org#42009,"SELOPAMIORO, IMOGIRI, BANTUL, DAERAH ISTIMEWA YOGYAKARTA",40,187,22,209
https://kawalpemilu.org#42009,"SELOPAMIORO, IMOGIRI, BANTUL, DAERAH ISTIMEWA YOGYAKARTA",41,189,25,214
https://kawalpemilu.org#42009,"SELOPAMIORO, IMOGIRI, BANTUL, DAERAH ISTIMEWA YOGYAKARTA",42,107,27,134
https://kawalpemilu.org#42009,"SELOPAMIORO, IMOGIRI, BANTUL, DAERAH ISTIMEWA YOGYAKARTA",43,186,15,201
https://kawalpemilu.org#42009,"SELOPAMIORO, IMOGIRI, BANTUL, DAERAH ISTIMEWA YOGYAKARTA",44,161,14,175
https://kawalpemilu.org#42009,"SELOPAMIORO, IMOGIRI, BANTUL, DAERAH ISTIMEWA YOGYAKARTA",45,166,42,208
https://kawalpemilu.org#42009,"SELOPAMIORO, IMOGIRI, BANTUL, DAERAH ISTIMEWA YOGYAKARTA",46,129,33,162
https://kawalpemilu.org#42009,"SELOPAMIORO, IMOGIRI, BANTUL, DAERAH ISTIMEWA YOGYAKARTA",47,158,29,187
https://kawalpemilu.org#42009,"SELOPAMIORO, IMOGIRI, BANTUL, DAERAH ISTIMEWA YOGYAKARTA",48,180,50,230
https://kawalpemilu.org#42009,"SELOPAMIORO, IMOGIRI, BANTUL, DAERAH ISTIMEWA YOGYAKARTA",49,172,22,194
https://kawalpemilu.org#42009,"SELOPAMIORO, IMOGIRI, BANTUL, DAERAH ISTIMEWA YOGYAKARTA",50,133,55,188
https://kawalpemilu.org#42009,"SELOPAMIORO, IMOGIRI, BANTUL, DAERAH ISTIMEWA YOGYAKARTA",51,139,45,184
https://kawalpemilu.org#42009,"SELOPAMIORO, IMOGIRI, BANTUL, DAERAH ISTIMEWA YOGYAKARTA",52,157,50,207
https://kawalpemilu.org#42009,"SELOPAMIORO, IMOGIRI, BANTUL, DAERAH ISTIMEWA YOGYAKARTA",53,100,44,144
https://kawalpemilu.org#42009,"SELOPAMIORO, IMOGIRI, BANTUL, DAERAH ISTIMEWA YOGYAKARTA",54,107,50,157
https://kawalpemilu.org#42010,"SRIHARJO, IMOGIRI, BANTUL, DAERAH ISTIMEWA YOGYAKARTA",1,186,39,225
https://kawalpemilu.org#42010,"SRIHARJO, IMOGIRI, BANTUL, DAERAH ISTIMEWA YOGYAKARTA",2,145,85,230
https://kawalpemilu.org#42010,"SRIHARJO, IMOGIRI, BANTUL, DAERAH ISTIMEWA YOGYAKARTA",3,108,77,185
https://kawalpemilu.org#42010,"SRIHARJO, IMOGIRI, BANTUL, DAERAH ISTIMEWA YOGYAKARTA",4,104,75,179
https://kawalpemilu.org#42010,"SRIHARJO, IMOGIRI, BANTUL, DAERAH ISTIMEWA YOGYAKARTA",5,160,26,186
https://kawalpemilu.org#42010,"SRIHARJO, IMOGIRI, BANTUL, DAERAH ISTIMEWA YOGYAKARTA",6,163,60,223
https://kawalpemilu.org#42010,"SRIHARJO, IMOGIRI, BANTUL, DAERAH ISTIMEWA YOGYAKARTA",7,110,51,161
https://kawalpemilu.org#42010,"SRIHARJO, IMOGIRI, BANTUL, DAERAH ISTIMEWA YOGYAKARTA",8,143,43,186
https://kawalpemilu.org#42010,"SRIHARJO, IMOGIRI, BANTUL, DAERAH ISTIMEWA YOGYAKARTA",9,137,82,219
https://kawalpemilu.org#42010,"SRIHARJO, IMOGIRI, BANTUL, DAERAH ISTIMEWA YOGYAKARTA",10,143,45,188
https://kawalpemilu.org#42010,"SRIHARJO, IMOGIRI, BANTUL, DAERAH ISTIMEWA YOGYAKARTA",11,77,139,216
https://kawalpemilu.org#42010,"SRIHARJO, IMOGIRI, BANTUL, DAERAH ISTIMEWA YOGYAKARTA",12,120,69,189
https://kawalpemilu.org#42010,"SRIHARJO, IMOGIRI, BANTUL, DAERAH ISTIMEWA YOGYAKARTA",13,118,69,187
https://kawalpemilu.org#42010,"SRIHARJO, IMOGIRI, BANTUL, DAERAH ISTIMEWA YOGYAKARTA",14,167,48,215
https://kawalpemilu.org#42010,"SRIHARJO, IMOGIRI, BANTUL, DAERAH ISTIMEWA YOGYAKARTA",15,117,52,169
https://kawalpemilu.org#42010,"SRIHARJO, IMOGIRI, BANTUL, DAERAH ISTIMEWA YOGYAKARTA",16,124,33,157
https://kawalpemilu.org#42010,"SRIHARJO, IMOGIRI, BANTUL, DAERAH ISTIMEWA YOGYAKARTA",17,105,80,185
https://kawalpemilu.org#42010,"SRIHARJO, IMOGIRI, BANTUL, DAERAH ISTIMEWA YOGYAKARTA",18,122,52,174
https://kawalpemilu.org#42010,"SRIHARJO, IMOGIRI, BANTUL, DAERAH ISTIMEWA YOGYAKARTA",19,174,86,260
https://kawalpemilu.org#42010,"SRIHARJO, IMOGIRI, BANTUL, DAERAH ISTIMEWA YOGYAKARTA",20,170,46,216
https://kawalpemilu.org#42010,"SRIHARJO, IMOGIRI, BANTUL, DAERAH ISTIMEWA YOGYAKARTA",21,161,64,225
https://kawalpemilu.org#42010,"SRIHARJO, IMOGIRI, BANTUL, DAERAH ISTIMEWA YOGYAKARTA",22,73,29,102
https://kawalpemilu.org#42010,"SRIHARJO, IMOGIRI, BANTUL, DAERAH ISTIMEWA YOGYAKARTA",23,124,31,155
https://kawalpemilu.org#42010,"SRIHARJO, IMOGIRI, BANTUL, DAERAH ISTIMEWA YOGYAKARTA",24,151,38,189
https://kawalpemilu.org#42010,"SRIHARJO, IMOGIRI, BANTUL, DAERAH ISTIMEWA YOGYAKARTA",25,93,119,212
https://kawalpemilu.org#42010,"SRIHARJO, IMOGIRI, BANTUL, DAERAH ISTIMEWA YOGYAKARTA",26,141,96,237
https://kawalpemilu.org#42010,"SRIHARJO, IMOGIRI, BANTUL, DAERAH ISTIMEWA YOGYAKARTA",27,90,17,107
https://kawalpemilu.org#42010,"SRIHARJO, IMOGIRI, BANTUL, DAERAH ISTIMEWA YOGYAKARTA",28,70,20,90
https://kawalpemilu.org#42010,"SRIHARJO, IMOGIRI, BANTUL, DAERAH ISTIMEWA YOGYAKARTA",29,189,31,220
https://kawalpemilu.org#42010,"SRIHARJO, IMOGIRI, BANTUL, DAERAH ISTIMEWA YOGYAKARTA",30,156,73,229
https://kawalpemilu.org#42010,"SRIHARJO, IMOGIRI, BANTUL, DAERAH ISTIMEWA YOGYAKARTA",31,159,32,191
https://kawalpemilu.org#42010,"SRIHARJO, IMOGIRI, BANTUL, DAERAH ISTIMEWA YOGYAKARTA",32,142,37,179
https://kawalpemilu.org#42010,"SRIHARJO, IMOGIRI, BANTUL, DAERAH ISTIMEWA YOGYAKARTA",33,72,15,87
https://kawalpemilu.org#42010,"SRIHARJO, IMOGIRI, BANTUL, DAERAH ISTIMEWA YOGYAKARTA",34,127,11,138
https://kawalpemilu.org#42011,"WUKIRSARI, IMOGIRI, BANTUL, DAERAH ISTIMEWA YOGYAKARTA",1,149,41,190
https://kawalpemilu.org#42011,"WUKIRSARI, IMOGIRI, BANTUL, DAERAH ISTIMEWA YOGYAKARTA",2,166,70,236
https://kawalpemilu.org#42011,"WUKIRSARI, IMOGIRI, BANTUL, DAERAH ISTIMEWA YOGYAKARTA",3,185,62,247
https://kawalpemilu.org#42011,"WUKIRSARI, IMOGIRI, BANTUL, DAERAH ISTIMEWA YOGYAKARTA",4,137,43,180
https://kawalpemilu.org#42011,"WUKIRSARI, IMOGIRI, BANTUL, DAERAH ISTIMEWA YOGYAKARTA",5,124,52,176
https://kawalpemilu.org#42011,"WUKIRSARI, IMOGIRI, BANTUL, DAERAH ISTIMEWA YOGYAKARTA",6,96,58,154
https://kawalpemilu.org#42011,"WUKIRSARI, IMOGIRI, BANTUL, DAERAH ISTIMEWA YOGYAKARTA",7,155,64,219
https://kawalpemilu.org#42011,"WUKIRSARI, IMOGIRI, BANTUL, DAERAH ISTIMEWA YOGYAKARTA",8,133,115,248
https://kawalpemilu.org#42011,"WUKIRSARI, IMOGIRI, BANTUL, DAERAH ISTIMEWA YOGYAKARTA",9,134,113,247
https://kawalpemilu.org#42011,"WUKIRSARI, IMOGIRI, BANTUL, DAERAH ISTIMEWA YOGYAKARTA",10,154,82,236
https://kawalpemilu.org#42011,"WUKIRSARI, IMOGIRI, BANTUL, DAERAH ISTIMEWA YOGYAKARTA",11,177,35,212
https://kawalpemilu.org#42011,"WUKIRSARI, IMOGIRI, BANTUL, DAERAH ISTIMEWA YOGYAKARTA",12,174,61,235
https://kawalpemilu.org#42011,"WUKIRSARI, IMOGIRI, BANTUL, DAERAH ISTIMEWA YOGYAKARTA",13,139,51,190
https://kawalpemilu.org#42011,"WUKIRSARI, IMOGIRI, BANTUL, DAERAH ISTIMEWA YOGYAKARTA",14,161,16,177
https://kawalpemilu.org#42011,"WUKIRSARI, IMOGIRI, BANTUL, DAERAH ISTIMEWA YOGYAKARTA",15,139,27,166
https://kawalpemilu.org#42011,"WUKIRSARI, IMOGIRI, BANTUL, DAERAH ISTIMEWA YOGYAKARTA",16,122,28,150
https://kawalpemilu.org#42011,"WUKIRSARI, IMOGIRI, BANTUL, DAERAH ISTIMEWA YOGYAKARTA",17,136,52,188
https://kawalpemilu.org#42011,"WUKIRSARI, IMOGIRI, BANTUL, DAERAH ISTIMEWA YOGYAKARTA",18,194,52,246
https://kawalpemilu.org#42011,"WUKIRSARI, IMOGIRI, BANTUL, DAERAH ISTIMEWA YOGYAKARTA",19,184,56,240
https://kawalpemilu.org#42011,"WUKIRSARI, IMOGIRI, BANTUL, DAERAH ISTIMEWA YOGYAKARTA",20,136,59,195
https://kawalpemilu.org#42011,"WUKIRSARI, IMOGIRI, BANTUL, DAERAH ISTIMEWA YOGYAKARTA",21,167,60,227
https://kawalpemilu.org#42011,"WUKIRSARI, IMOGIRI, BANTUL, DAERAH ISTIMEWA YOGYAKARTA",22,198,47,245
https://kawalpemilu.org#42011,"WUKIRSARI, IMOGIRI, BANTUL, DAERAH ISTIMEWA YOGYAKARTA",23,207,19,226
https://kawalpemilu.org#42011,"WUKIRSARI, IMOGIRI, BANTUL, DAERAH ISTIMEWA YOGYAKARTA",24,180,57,237
https://kawalpemilu.org#42011,"WUKIRSARI, IMOGIRI, BANTUL, DAERAH ISTIMEWA YOGYAKARTA",25,202,26,228
https://kawalpemilu.org#42011,"WUKIRSARI, IMOGIRI, BANTUL, DAERAH ISTIMEWA YOGYAKARTA",26,190,49,239
https://kawalpemilu.org#42011,"WUKIRSARI, IMOGIRI, BANTUL, DAERAH ISTIMEWA YOGYAKARTA",27,163,22,185
https://kawalpemilu.org#42011,"WUKIRSARI, IMOGIRI, BANTUL, DAERAH ISTIMEWA YOGYAKARTA",28,160,45,205
https://kawalpemilu.org#42011,"WUKIRSARI, IMOGIRI, BANTUL, DAERAH ISTIMEWA YOGYAKARTA",29,175,19,194
https://kawalpemilu.org#42011,"WUKIRSARI, IMOGIRI, BANTUL, DAERAH ISTIMEWA YOGYAKARTA",30,127,31,158
https://kawalpemilu.org#42011,"WUKIRSARI, IMOGIRI, BANTUL, DAERAH ISTIMEWA YOGYAKARTA",31,129,14,143
https://kawalpemilu.org#42011,"WUKIRSARI, IMOGIRI, BANTUL, DAERAH ISTIMEWA YOGYAKARTA",32,131,46,177
https://kawalpemilu.org#42011,"WUKIRSARI, IMOGIRI, BANTUL, DAERAH ISTIMEWA YOGYAKARTA",33,194,29,223
https://kawalpemilu.org#42011,"WUKIRSARI, IMOGIRI, BANTUL, DAERAH ISTIMEWA YOGYAKARTA",34,147,35,182
https://kawalpemilu.org#42011,"WUKIRSARI, IMOGIRI, BANTUL, DAERAH ISTIMEWA YOGYAKARTA",35,85,48,133
https://kawalpemilu.org#42011,"WUKIRSARI, IMOGIRI, BANTUL, DAERAH ISTIMEWA YOGYAKARTA",36,124,37,161
https://kawalpemilu.org#42011,"WUKIRSARI, IMOGIRI, BANTUL, DAERAH ISTIMEWA YOGYAKARTA",37,168,28,196
https://kawalpemilu.org#42011,"WUKIRSARI, IMOGIRI, BANTUL, DAERAH ISTIMEWA YOGYAKARTA",38,192,40,232
https://kawalpemilu.org#42011,"WUKIRSARI, IMOGIRI, BANTUL, DAERAH ISTIMEWA YOGYAKARTA",39,98,81,179
https://kawalpemilu.org#42011,"WUKIRSARI, IMOGIRI, BANTUL, DAERAH ISTIMEWA YOGYAKARTA",40,221,42,263
https://kawalpemilu.org#42011,"WUKIRSARI, IMOGIRI, BANTUL, DAERAH ISTIMEWA YOGYAKARTA",41,198,66,264
https://kawalpemilu.org#42011,"WUKIRSARI, IMOGIRI, BANTUL, DAERAH ISTIMEWA YOGYAKARTA",42,186,23,209
https://kawalpemilu.org#42011,"WUKIRSARI, IMOGIRI, BANTUL, DAERAH ISTIMEWA YOGYAKARTA",43,143,24,167
https://kawalpemilu.org#42011,"WUKIRSARI, IMOGIRI, BANTUL, DAERAH ISTIMEWA YOGYAKARTA",44,222,23,245
https://kawalpemilu.org#42011,"WUKIRSARI, IMOGIRI, BANTUL, DAERAH ISTIMEWA YOGYAKARTA",45,150,31,181
https://kawalpemilu.org#42011,"WUKIRSARI, IMOGIRI, BANTUL, DAERAH ISTIMEWA YOGYAKARTA",46,229,21,250
https://kawalpemilu.org#42011,"WUKIRSARI, IMOGIRI, BANTUL, DAERAH ISTIMEWA YOGYAKARTA",47,130,25,155
https://kawalpemilu.org#42011,"WUKIRSARI, IMOGIRI, BANTUL, DAERAH ISTIMEWA YOGYAKARTA",48,164,39,203
https://kawalpemilu.org#42011,"WUKIRSARI, IMOGIRI, BANTUL, DAERAH ISTIMEWA YOGYAKARTA",49,97,39,136
https://kawalpemilu.org#42011,"WUKIRSARI, IMOGIRI, BANTUL, DAERAH ISTIMEWA YOGYAKARTA",50,149,41,190
https://kawalpemilu.org#42011,"WUKIRSARI, IMOGIRI, BANTUL, DAERAH ISTIMEWA YOGYAKARTA",51,93,51,144
https://kawalpemilu.org#42011,"WUKIRSARI, IMOGIRI, BANTUL, DAERAH ISTIMEWA YOGYAKARTA",52,100,88,188
https://kawalpemilu.org#42011,"WUKIRSARI, IMOGIRI, BANTUL, DAERAH ISTIMEWA YOGYAKARTA",53,88,91,179
https://kawalpemilu.org#42011,"WUKIRSARI, IMOGIRI, BANTUL, DAERAH ISTIMEWA YOGYAKARTA",54,158,66,224
https://kawalpemilu.org#42011,"WUKIRSARI, IMOGIRI, BANTUL, DAERAH ISTIMEWA YOGYAKARTA",55,195,63,258
https://kawalpemilu.org#42012,"KEBONAGUNG, IMOGIRI, BANTUL, DAERAH ISTIMEWA YOGYAKARTA",1,140,67,207
https://kawalpemilu.org#42012,"KEBONAGUNG, IMOGIRI, BANTUL, DAERAH ISTIMEWA YOGYAKARTA",2,105,92,197
https://kawalpemilu.org#42012,"KEBONAGUNG, IMOGIRI, BANTUL, DAERAH ISTIMEWA YOGYAKARTA",3,100,40,140
https://kawalpemilu.org#42012,"KEBONAGUNG, IMOGIRI, BANTUL, DAERAH ISTIMEWA YOGYAKARTA",4,115,62,177
https://kawalpemilu.org#42012,"KEBONAGUNG, IMOGIRI, BANTUL, DAERAH ISTIMEWA YOGYAKARTA",5,147,64,211
https://kawalpemilu.org#42012,"KEBONAGUNG, IMOGIRI, BANTUL, DAERAH ISTIMEWA YOGYAKARTA",6,99,28,127
https://kawalpemilu.org#42012,"KEBONAGUNG, IMOGIRI, BANTUL, DAERAH ISTIMEWA YOGYAKARTA",7,103,39,142
https://kawalpemilu.org#42012,"KEBONAGUNG, IMOGIRI, BANTUL, DAERAH ISTIMEWA YOGYAKARTA",8,134,14,148
https://kawalpemilu.org#42012,"KEBONAGUNG, IMOGIRI, BANTUL, DAERAH ISTIMEWA YOGYAKARTA",9,163,10,173
https://kawalpemilu.org#42012,"KEBONAGUNG, IMOGIRI, BANTUL, DAERAH ISTIMEWA YOGYAKARTA",10,130,27,157
https://kawalpemilu.org#42012,"KEBONAGUNG, IMOGIRI, BANTUL, DAERAH ISTIMEWA YOGYAKARTA",11,166,53,219
https://kawalpemilu.org#42012,"KEBONAGUNG, IMOGIRI, BANTUL, DAERAH ISTIMEWA YOGYAKARTA",12,151,61,212
https://kawalpemilu.org#42012,"KEBONAGUNG, IMOGIRI, BANTUL, DAERAH ISTIMEWA YOGYAKARTA",13,108,35,143
https://kawalpemilu.org#42012,"KEBONAGUNG, IMOGIRI, BANTUL, DAERAH ISTIMEWA YOGYAKARTA",14,109,46,155
https://kawalpemilu.org#42012,"KEBONAGUNG, IMOGIRI, BANTUL, DAERAH ISTIMEWA YOGYAKARTA",15,165,37,202
https://kawalpemilu.org#42013,"KARANGTENGAH, IMOGIRI, BANTUL, DAERAH ISTIMEWA YOGYAKARTA",1,82,161,243
https://kawalpemilu.org#42013,"KARANGTENGAH, IMOGIRI, BANTUL, DAERAH ISTIMEWA YOGYAKARTA",2,75,162,237
https://kawalpemilu.org#42013,"KARANGTENGAH, IMOGIRI, BANTUL, DAERAH ISTIMEWA YOGYAKARTA",3,63,150,213
https://kawalpemilu.org#42013,"KARANGTENGAH, IMOGIRI, BANTUL, DAERAH ISTIMEWA YOGYAKARTA",4,105,120,225
https://kawalpemilu.org#42013,"KARANGTENGAH, IMOGIRI, BANTUL, DAERAH ISTIMEWA YOGYAKARTA",5,134,67,201
https://kawalpemilu.org#42013,"KARANGTENGAH, IMOGIRI, BANTUL, DAERAH ISTIMEWA YOGYAKARTA",6,120,79,199
https://kawalpemilu.org#42013,"KARANGTENGAH, IMOGIRI, BANTUL, DAERAH ISTIMEWA YOGYAKARTA",7,175,29,204
https://kawalpemilu.org#42013,"KARANGTENGAH, IMOGIRI, BANTUL, DAERAH ISTIMEWA YOGYAKARTA",8,223,53,276
https://kawalpemilu.org#42013,"KARANGTENGAH, IMOGIRI, BANTUL, DAERAH ISTIMEWA YOGYAKARTA",9,177,15,192
https://kawalpemilu.org#42013,"KARANGTENGAH, IMOGIRI, BANTUL, DAERAH ISTIMEWA YOGYAKARTA",10,148,49,197
https://kawalpemilu.org#42013,"KARANGTENGAH, IMOGIRI, BANTUL, DAERAH ISTIMEWA YOGYAKARTA",11,133,44,177
https://kawalpemilu.org#42013,"KARANGTENGAH, IMOGIRI, BANTUL, DAERAH ISTIMEWA YOGYAKARTA",12,134,42,176
https://kawalpemilu.org#42013,"KARANGTENGAH, IMOGIRI, BANTUL, DAERAH ISTIMEWA YOGYAKARTA",13,99,69,168
https://kawalpemilu.org#42013,"KARANGTENGAH, IMOGIRI, BANTUL, DAERAH ISTIMEWA YOGYAKARTA",14,144,41,185
https://kawalpemilu.org#42013,"KARANGTENGAH, IMOGIRI, BANTUL, DAERAH ISTIMEWA YOGYAKARTA",15,171,33,204
https://kawalpemilu.org#42013,"KARANGTENGAH, IMOGIRI, BANTUL, DAERAH ISTIMEWA YOGYAKARTA",16,159,51,210
https://kawalpemilu.org#42013,"KARANGTENGAH, IMOGIRI, BANTUL, DAERAH ISTIMEWA YOGYAKARTA",17,177,45,222
https://kawalpemilu.org#42013,"KARANGTENGAH, IMOGIRI, BANTUL, DAERAH ISTIMEWA YOGYAKARTA",18,186,21,207
https://kawalpemilu.org#42014,"GIRIREJO, IMOGIRI, BANTUL, DAERAH ISTIMEWA YOGYAKARTA",1,170,50,220
https://kawalpemilu.org#42014,"GIRIREJO, IMOGIRI, BANTUL, DAERAH ISTIMEWA YOGYAKARTA",2,192,45,237
https://kawalpemilu.org#42014,"GIRIREJO, IMOGIRI, BANTUL, DAERAH ISTIMEWA YOGYAKARTA",3,174,56,230
https://kawalpemilu.org#42014,"GIRIREJO, IMOGIRI, BANTUL, DAERAH ISTIMEWA YOGYAKARTA",4,99,94,193
https://kawalpemilu.org#42014,"GIRIREJO, IMOGIRI, BANTUL, DAERAH ISTIMEWA YOGYAKARTA",5,188,55,243
https://kawalpemilu.org#42014,"GIRIREJO, IMOGIRI, BANTUL, DAERAH ISTIMEWA YOGYAKARTA",6,156,28,184
https://kawalpemilu.org#42014,"GIRIREJO, IMOGIRI, BANTUL, DAERAH ISTIMEWA YOGYAKARTA",7,126,36,162
https://kawalpemilu.org#42014,"GIRIREJO, IMOGIRI, BANTUL, DAERAH ISTIMEWA YOGYAKARTA",8,145,59,204
https://kawalpemilu.org#42014,"GIRIREJO, IMOGIRI, BANTUL, DAERAH ISTIMEWA YOGYAKARTA",9,148,88,236
https://kawalpemilu.org#42014,"GIRIREJO, IMOGIRI, BANTUL, DAERAH ISTIMEWA YOGYAKARTA",10,155,48,203
https://kawalpemilu.org#42014,"GIRIREJO, IMOGIRI, BANTUL, DAERAH ISTIMEWA YOGYAKARTA",11,129,58,187
https://kawalpemilu.org#42014,"GIRIREJO, IMOGIRI, BANTUL, DAERAH ISTIMEWA YOGYAKARTA",12,192,56,248
https://kawalpemilu.org#42014,"GIRIREJO, IMOGIRI, BANTUL, DAERAH ISTIMEWA YOGYAKARTA",13,101,133,234
https://kawalpemilu.org#42014,"GIRIREJO, IMOGIRI, BANTUL, DAERAH ISTIMEWA YOGYAKARTA",14,83,57,140
https://kawalpemilu.org#42014,"GIRIREJO, IMOGIRI, BANTUL, DAERAH ISTIMEWA YOGYAKARTA",15,99,92,191
https://kawalpemilu.org#42015,"KARANGTALUN, IMOGIRI, BANTUL, DAERAH ISTIMEWA YOGYAKARTA",1,164,37,201
https://kawalpemilu.org#42015,"KARANGTALUN, IMOGIRI, BANTUL, DAERAH ISTIMEWA YOGYAKARTA",2,124,20,144
https://kawalpemilu.org#42015,"KARANGTALUN, IMOGIRI, BANTUL, DAERAH ISTIMEWA YOGYAKARTA",3,144,37,181
https://kawalpemilu.org#42015,"KARANGTALUN, IMOGIRI, BANTUL, DAERAH ISTIMEWA YOGYAKARTA",4,190,70,260
https://kawalpemilu.org#42015,"KARANGTALUN, IMOGIRI, BANTUL, DAERAH ISTIMEWA YOGYAKARTA",5,181,81,262
https://kawalpemilu.org#42015,"KARANGTALUN, IMOGIRI, BANTUL, DAERAH ISTIMEWA YOGYAKARTA",6,137,55,192
https://kawalpemilu.org#42015,"KARANGTALUN, IMOGIRI, BANTUL, DAERAH ISTIMEWA YOGYAKARTA",7,88,45,133
https://kawalpemilu.org#42015,"KARANGTALUN, IMOGIRI, BANTUL, DAERAH ISTIMEWA YOGYAKARTA",8,84,88,172
https://kawalpemilu.org#42015,"KARANGTALUN, IMOGIRI, BANTUL, DAERAH ISTIMEWA YOGYAKARTA",9,106,56,162
https://kawalpemilu.org#42015,"KARANGTALUN, IMOGIRI, BANTUL, DAERAH ISTIMEWA YOGYAKARTA",10,127,33,160
https://kawalpemilu.org#42015,"KARANGTALUN, IMOGIRI, BANTUL, DAERAH ISTIMEWA YOGYAKARTA",11,108,30,138
https://kawalpemilu.org#42015,"KARANGTALUN, IMOGIRI, BANTUL, DAERAH ISTIMEWA YOGYAKARTA",12,99,25,124
https://kawalpemilu.org#42016,"IMOGIRI, IMOGIRI, BANTUL, DAERAH ISTIMEWA YOGYAKARTA",1,147,33,180
https://kawalpemilu.org#42016,"IMOGIRI, IMOGIRI, BANTUL, DAERAH ISTIMEWA YOGYAKARTA",2,116,49,165
https://kawalpemilu.org#42016,"IMOGIRI, IMOGIRI, BANTUL, DAERAH ISTIMEWA YOGYAKARTA",3,137,64,201
https://kawalpemilu.org#42016,"IMOGIRI, IMOGIRI, BANTUL, DAERAH ISTIMEWA YOGYAKARTA",4,92,94,186
https://kawalpemilu.org#42016,"IMOGIRI, IMOGIRI, BANTUL, DAERAH ISTIMEWA YOGYAKARTA",5,90,127,217
https://kawalpemilu.org#42016,"IMOGIRI, IMOGIRI, BANTUL, DAERAH ISTIMEWA YOGYAKARTA",6,122,94,216
https://kawalpemilu.org#42016,"IMOGIRI, IMOGIRI, BANTUL, DAERAH ISTIMEWA YOGYAKARTA",7,126,115,241
https://kawalpemilu.org#42016,"IMOGIRI, IMOGIRI, BANTUL, DAERAH ISTIMEWA YOGYAKARTA",8,90,107,197
https://kawalpemilu.org#42016,"IMOGIRI, IMOGIRI, BANTUL, DAERAH ISTIMEWA YOGYAKARTA",9,134,77,211
https://kawalpemilu.org#42016,"IMOGIRI, IMOGIRI, BANTUL, DAERAH ISTIMEWA YOGYAKARTA",10,141,102,243
https://kawalpemilu.org#42016,"IMOGIRI, IMOGIRI, BANTUL, DAERAH ISTIMEWA YOGYAKARTA",11,145,56,201
https://kawalpemilu.org#42016,"IMOGIRI, IMOGIRI, BANTUL, DAERAH ISTIMEWA YOGYAKARTA",12,145,59,204
https://kawalpemilu.org#42016,"IMOGIRI, IMOGIRI, BANTUL, DAERAH ISTIMEWA YOGYAKARTA",13,96,90,186
https://kawalpemilu.org#42016,"IMOGIRI, IMOGIRI, BANTUL, DAERAH ISTIMEWA YOGYAKARTA",14,127,66,193
https://kawalpemilu.org#42018,"MANGUNAN, DLINGO, BANTUL, DAERAH ISTIMEWA YOGYAKARTA",1,161,12,173
https://kawalpemilu.org#42018,"MANGUNAN, DLINGO, BANTUL, DAERAH ISTIMEWA YOGYAKARTA",2,183,16,199
https://kawalpemilu.org#42018,"MANGUNAN, DLINGO, BANTUL, DAERAH ISTIMEWA YOGYAKARTA",3,241,25,266
https://kawalpemilu.org#42018,"MANGUNAN, DLINGO, BANTUL, DAERAH ISTIMEWA YOGYAKARTA",4,189,61,250
https://kawalpemilu.org#42018,"MANGUNAN, DLINGO, BANTUL, DAERAH ISTIMEWA YOGYAKARTA",5,200,43,243
https://kawalpemilu.org#42018,"MANGUNAN, DLINGO, BANTUL, DAERAH ISTIMEWA YOGYAKARTA",6,136,40,176
https://kawalpemilu.org#42018,"MANGUNAN, DLINGO, BANTUL, DAERAH ISTIMEWA YOGYAKARTA",7,176,37,213
https://kawalpemilu.org#42018,"MANGUNAN, DLINGO, BANTUL, DAERAH ISTIMEWA YOGYAKARTA",8,127,24,151
https://kawalpemilu.org#42018,"MANGUNAN, DLINGO, BANTUL, DAERAH ISTIMEWA YOGYAKARTA",9,146,25,171
https://kawalpemilu.org#42018,"MANGUNAN, DLINGO, BANTUL, DAERAH ISTIMEWA YOGYAKARTA",10,185,37,222
https://kawalpemilu.org#42018,"MANGUNAN, DLINGO, BANTUL, DAERAH ISTIMEWA YOGYAKARTA",11,195,32,227
https://kawalpemilu.org#42018,"MANGUNAN, DLINGO, BANTUL, DAERAH ISTIMEWA YOGYAKARTA",12,164,28,192
https://kawalpemilu.org#42018,"MANGUNAN, DLINGO, BANTUL, DAERAH ISTIMEWA YOGYAKARTA",13,175,24,199
https://kawalpemilu.org#42018,"MANGUNAN, DLINGO, BANTUL, DAERAH ISTIMEWA YOGYAKARTA",14,129,36,165
https://kawalpemilu.org#42018,"MANGUNAN, DLINGO, BANTUL, DAERAH ISTIMEWA YOGYAKARTA",15,225,14,239
https://kawalpemilu.org#42018,"MANGUNAN, DLINGO, BANTUL, DAERAH ISTIMEWA YOGYAKARTA",16,190,22,212
https://kawalpemilu.org#42019,"MUNTUK, DLINGO, BANTUL, DAERAH ISTIMEWA YOGYAKARTA",1,129,8,137
https://kawalpemilu.org#42019,"MUNTUK, DLINGO, BANTUL, DAERAH ISTIMEWA YOGYAKARTA",2,138,48,186
https://kawalpemilu.org#42019,"MUNTUK, DLINGO, BANTUL, DAERAH ISTIMEWA YOGYAKARTA",3,128,28,156
https://kawalpemilu.org#42019,"MUNTUK, DLINGO, BANTUL, DAERAH ISTIMEWA YOGYAKARTA",4,203,23,226
https://kawalpemilu.org#42019,"MUNTUK, DLINGO, BANTUL, DAERAH ISTIMEWA YOGYAKARTA",5,192,16,208
https://kawalpemilu.org#42019,"MUNTUK, DLINGO, BANTUL, DAERAH ISTIMEWA YOGYAKARTA",6,156,47,203
https://kawalpemilu.org#42019,"MUNTUK, DLINGO, BANTUL, DAERAH ISTIMEWA YOGYAKARTA",7,140,19,159
https://kawalpemilu.org#42019,"MUNTUK, DLINGO, BANTUL, DAERAH ISTIMEWA YOGYAKARTA",8,194,20,214
https://kawalpemilu.org#42019,"MUNTUK, DLINGO, BANTUL, DAERAH ISTIMEWA YOGYAKARTA",9,225,28,253
https://kawalpemilu.org#42019,"MUNTUK, DLINGO, BANTUL, DAERAH ISTIMEWA YOGYAKARTA",10,214,16,230
https://kawalpemilu.org#42019,"MUNTUK, DLINGO, BANTUL, DAERAH ISTIMEWA YOGYAKARTA",11,224,25,249
https://kawalpemilu.org#42019,"MUNTUK, DLINGO, BANTUL, DAERAH ISTIMEWA YOGYAKARTA",12,198,22,220
https://kawalpemilu.org#42019,"MUNTUK, DLINGO, BANTUL, DAERAH ISTIMEWA YOGYAKARTA",13,230,25,255
https://kawalpemilu.org#42019,"MUNTUK, DLINGO, BANTUL, DAERAH ISTIMEWA YOGYAKARTA",14,155,83,238
https://kawalpemilu.org#42019,"MUNTUK, DLINGO, BANTUL, DAERAH ISTIMEWA YOGYAKARTA",15,154,64,216
https://kawalpemilu.org#42019,"MUNTUK, DLINGO, BANTUL, DAERAH ISTIMEWA YOGYAKARTA",16,203,26,229
https://kawalpemilu.org#42019,"MUNTUK, DLINGO, BANTUL, DAERAH ISTIMEWA YOGYAKARTA",17,210,22,232
https://kawalpemilu.org#42019,"MUNTUK, DLINGO, BANTUL, DAERAH ISTIMEWA YOGYAKARTA",18,196,10,206
https://kawalpemilu.org#42019,"MUNTUK, DLINGO, BANTUL, DAERAH ISTIMEWA YOGYAKARTA",19,123,6,129
https://kawalpemilu.org#42019,"MUNTUK, DLINGO, BANTUL, DAERAH ISTIMEWA YOGYAKARTA",20,153,6,159
https://kawalpemilu.org#42019,"MUNTUK, DLINGO, BANTUL, DAERAH ISTIMEWA YOGYAKARTA",21,195,18,213
https://kawalpemilu.org#42019,"MUNTUK, DLINGO, BANTUL, DAERAH ISTIMEWA YOGYAKARTA",22,135,6,141
https://kawalpemilu.org#42019,"MUNTUK, DLINGO, BANTUL, DAERAH ISTIMEWA YOGYAKARTA",23,158,65,223
https://kawalpemilu.org#42019,"MUNTUK, DLINGO, BANTUL, DAERAH ISTIMEWA YOGYAKARTA",24,223,23,246
https://kawalpemilu.org#42019,"MUNTUK, DLINGO, BANTUL, DAERAH ISTIMEWA YOGYAKARTA",25,184,49,233
https://kawalpemilu.org#42019,"MUNTUK, DLINGO, BANTUL, DAERAH ISTIMEWA YOGYAKARTA",26,218,39,257
https://kawalpemilu.org#42019,"MUNTUK, DLINGO, BANTUL, DAERAH ISTIMEWA YOGYAKARTA",27,155,82,237
https://kawalpemilu.org#42019,"MUNTUK, DLINGO, BANTUL, DAERAH ISTIMEWA YOGYAKARTA",28,92,94,186
https://kawalpemilu.org#42019,"MUNTUK, DLINGO, BANTUL, DAERAH ISTIMEWA YOGYAKARTA",29,103,25,128
https://kawalpemilu.org#42020,"DLINGO, DLINGO, BANTUL, DAERAH ISTIMEWA YOGYAKARTA",1,91,4,95
https://kawalpemilu.org#42020,"DLINGO, DLINGO, BANTUL, DAERAH ISTIMEWA YOGYAKARTA",2,198,23,221
https://kawalpemilu.org#42020,"DLINGO, DLINGO, BANTUL, DAERAH ISTIMEWA YOGYAKARTA",3,213,18,231
https://kawalpemilu.org#42020,"DLINGO, DLINGO, BANTUL, DAERAH ISTIMEWA YOGYAKARTA",4,94,67,161
https://kawalpemilu.org#42020,"DLINGO, DLINGO, BANTUL, DAERAH ISTIMEWA YOGYAKARTA",5,236,37,273
https://kawalpemilu.org#42020,"DLINGO, DLINGO, BANTUL, DAERAH ISTIMEWA YOGYAKARTA",6,137,67,201
https://kawalpemilu.org#42020,"DLINGO, DLINGO, BANTUL, DAERAH ISTIMEWA YOGYAKARTA",7,141,65,206
https://kawalpemilu.org#42020,"DLINGO, DLINGO, BANTUL, DAERAH ISTIMEWA YOGYAKARTA",8,135,76,211
https://kawalpemilu.org#42020,"DLINGO, DLINGO, BANTUL, DAERAH ISTIMEWA YOGYAKARTA",9,138,44,182
https://kawalpemilu.org#42020,"DLINGO, DLINGO, BANTUL, DAERAH ISTIMEWA YOGYAKARTA",10,81,64,145
https://kawalpemilu.org#42020,"DLINGO, DLINGO, BANTUL, DAERAH ISTIMEWA YOGYAKARTA",11,178,39,217
https://kawalpemilu.org#42020,"DLINGO, DLINGO, BANTUL, DAERAH ISTIMEWA YOGYAKARTA",12,180,51,231
https://kawalpemilu.org#42020,"DLINGO, DLINGO, BANTUL, DAERAH ISTIMEWA YOGYAKARTA",13,186,42,228
https://kawalpemilu.org#42020,"DLINGO, DLINGO, BANTUL, DAERAH ISTIMEWA YOGYAKARTA",14,146,49,195
https://kawalpemilu.org#42020,"DLINGO, DLINGO, BANTUL, DAERAH ISTIMEWA YOGYAKARTA",15,0,0,0
https://kawalpemilu.org#42020,"DLINGO, DLINGO, BANTUL, DAERAH ISTIMEWA YOGYAKARTA",16,114,27,141
https://kawalpemilu.org#42020,"DLINGO, DLINGO, BANTUL, DAERAH ISTIMEWA YOGYAKARTA",17,130,23,153
https://kawalpemilu.org#42020,"DLINGO, DLINGO, BANTUL, DAERAH ISTIMEWA YOGYAKARTA",18,179,31,210
https://kawalpemilu.org#42020,"DLINGO, DLINGO, BANTUL, DAERAH ISTIMEWA YOGYAKARTA",19,135,39,2
https://kawalpemilu.org#42020,"DLINGO, DLINGO, BANTUL, DAERAH ISTIMEWA YOGYAKARTA",20,183,14,197
https://kawalpemilu.org#42020,"DLINGO, DLINGO, BANTUL, DAERAH ISTIMEWA YOGYAKARTA",21,137,27,164
https://kawalpemilu.org#42021,"TEMUWUH, DLINGO, BANTUL, DAERAH ISTIMEWA YOGYAKARTA",1,162,30,192
https://kawalpemilu.org#42021,"TEMUWUH, DLINGO, BANTUL, DAERAH ISTIMEWA YOGYAKARTA",2,164,11,175
https://kawalpemilu.org#42021,"TEMUWUH, DLINGO, BANTUL, DAERAH ISTIMEWA YOGYAKARTA",3,204,38,242
https://kawalpemilu.org#42021,"TEMUWUH, DLINGO, BANTUL, DAERAH ISTIMEWA YOGYAKARTA",4,175,89,264
https://kawalpemilu.org#42021,"TEMUWUH, DLINGO, BANTUL, DAERAH ISTIMEWA YOGYAKARTA",5,177,37,214
https://kawalpemilu.org#42021,"TEMUWUH, DLINGO, BANTUL, DAERAH ISTIMEWA YOGYAKARTA",6,167,37,204
https://kawalpemilu.org#42021,"TEMUWUH, DLINGO, BANTUL, DAERAH ISTIMEWA YOGYAKARTA",7,217,26,243
https://kawalpemilu.org#42021,"TEMUWUH, DLINGO, BANTUL, DAERAH ISTIMEWA YOGYAKARTA",8,181,33,214
https://kawalpemilu.org#42021,"TEMUWUH, DLINGO, BANTUL, DAERAH ISTIMEWA YOGYAKARTA",9,99,23,122
https://kawalpemilu.org#42021,"TEMUWUH, DLINGO, BANTUL, DAERAH ISTIMEWA YOGYAKARTA",10,191,22,213
https://kawalpemilu.org#42021,"TEMUWUH, DLINGO, BANTUL, DAERAH ISTIMEWA YOGYAKARTA",11,135,47,182
https://kawalpemilu.org#42021,"TEMUWUH, DLINGO, BANTUL, DAERAH ISTIMEWA YOGYAKARTA",12,202,35,237
https://kawalpemilu.org#42021,"TEMUWUH, DLINGO, BANTUL, DAERAH ISTIMEWA YOGYAKARTA",13,219,14,233
https://kawalpemilu.org#42021,"TEMUWUH, DLINGO, BANTUL, DAERAH ISTIMEWA YOGYAKARTA",14,189,10,199
https://kawalpemilu.org#42021,"TEMUWUH, DLINGO, BANTUL, DAERAH ISTIMEWA YOGYAKARTA",15,162,15,177
https://kawalpemilu.org#42021,"TEMUWUH, DLINGO, BANTUL, DAERAH ISTIMEWA YOGYAKARTA",16,144,12,156
https://kawalpemilu.org#42021,"TEMUWUH, DLINGO, BANTUL, DAERAH ISTIMEWA YOGYAKARTA",17,134,15,149
https://kawalpemilu.org#42021,"TEMUWUH, DLINGO, BANTUL, DAERAH ISTIMEWA YOGYAKARTA",18,196,30,226
https://kawalpemilu.org#42021,"TEMUWUH, DLINGO, BANTUL, DAERAH ISTIMEWA YOGYAKARTA",19,100,33,133
https://kawalpemilu.org#42021,"TEMUWUH, DLINGO, BANTUL, DAERAH ISTIMEWA YOGYAKARTA",20,179,20,199
https://kawalpemilu.org#42021,"TEMUWUH, DLINGO, BANTUL, DAERAH ISTIMEWA YOGYAKARTA",21,177,47,224
https://kawalpemilu.org#42021,"TEMUWUH, DLINGO, BANTUL, DAERAH ISTIMEWA YOGYAKARTA",22,191,28,219
https://kawalpemilu.org#42021,"TEMUWUH, DLINGO, BANTUL, DAERAH ISTIMEWA YOGYAKARTA",23,195,26,221
https://kawalpemilu.org#42021,"TEMUWUH, DLINGO, BANTUL, DAERAH ISTIMEWA YOGYAKARTA",24,138,9,147
https://kawalpemilu.org#42021,"TEMUWUH, DLINGO, BANTUL, DAERAH ISTIMEWA YOGYAKARTA",25,111,20,131
https://kawalpemilu.org#42021,"TEMUWUH, DLINGO, BANTUL, DAERAH ISTIMEWA YOGYAKARTA",26,148,19,167
https://kawalpemilu.org#42022,"TERONG, DLINGO, BANTUL, DAERAH ISTIMEWA YOGYAKARTA",1,98,54,152
https://kawalpemilu.org#42022,"TERONG, DLINGO, BANTUL, DAERAH ISTIMEWA YOGYAKARTA",2,103,78,181
https://kawalpemilu.org#42022,"TERONG, DLINGO, BANTUL, DAERAH ISTIMEWA YOGYAKARTA",3,162,19,181
https://kawalpemilu.org#42022,"TERONG, DLINGO, BANTUL, DAERAH ISTIMEWA YOGYAKARTA",4,143,8,151
https://kawalpemilu.org#42022,"TERONG, DLINGO, BANTUL, DAERAH ISTIMEWA YOGYAKARTA",5,165,19,184
https://kawalpemilu.org#42022,"TERONG, DLINGO, BANTUL, DAERAH ISTIMEWA YOGYAKARTA",6,174,38,212
https://kawalpemilu.org#42022,"TERONG, DLINGO, BANTUL, DAERAH ISTIMEWA YOGYAKARTA",7,179,55,234
https://kawalpemilu.org#42022,"TERONG, DLINGO, BANTUL, DAERAH ISTIMEWA YOGYAKARTA",8,181,48,229
https://kawalpemilu.org#42022,"TERONG, DLINGO, BANTUL, DAERAH ISTIMEWA YOGYAKARTA",9,182,66,248
https://kawalpemilu.org#42022,"TERONG, DLINGO, BANTUL, DAERAH ISTIMEWA YOGYAKARTA",10,133,42,175
https://kawalpemilu.org#42022,"TERONG, DLINGO, BANTUL, DAERAH ISTIMEWA YOGYAKARTA",11,143,92,235
https://kawalpemilu.org#42022,"TERONG, DLINGO, BANTUL, DAERAH ISTIMEWA YOGYAKARTA",12,158,86,244
https://kawalpemilu.org#42022,"TERONG, DLINGO, BANTUL, DAERAH ISTIMEWA YOGYAKARTA",13,98,103,201
https://kawalpemilu.org#42022,"TERONG, DLINGO, BANTUL, DAERAH ISTIMEWA YOGYAKARTA",14,136,103,239
https://kawalpemilu.org#42022,"TERONG, DLINGO, BANTUL, DAERAH ISTIMEWA YOGYAKARTA",15,179,31,210
https://kawalpemilu.org#42022,"TERONG, DLINGO, BANTUL, DAERAH ISTIMEWA YOGYAKARTA",16,232,18,250
https://kawalpemilu.org#42022,"TERONG, DLINGO, BANTUL, DAERAH ISTIMEWA YOGYAKARTA",17,228,23,251
https://kawalpemilu.org#42022,"TERONG, DLINGO, BANTUL, DAERAH ISTIMEWA YOGYAKARTA",18,165,36,201
https://kawalpemilu.org#42022,"TERONG, DLINGO, BANTUL, DAERAH ISTIMEWA YOGYAKARTA",19,183,19,202
https://kawalpemilu.org#42023,"JATIMULYO, DLINGO, BANTUL, DAERAH ISTIMEWA YOGYAKARTA",1,187,29,216
https://kawalpemilu.org#42023,"JATIMULYO, DLINGO, BANTUL, DAERAH ISTIMEWA YOGYAKARTA",2,238,11,249
https://kawalpemilu.org#42023,"JATIMULYO, DLINGO, BANTUL, DAERAH ISTIMEWA YOGYAKARTA",3,157,26,183
https://kawalpemilu.org#42023,"JATIMULYO, DLINGO, BANTUL, DAERAH ISTIMEWA YOGYAKARTA",4,172,31,203
https://kawalpemilu.org#42023,"JATIMULYO, DLINGO, BANTUL, DAERAH ISTIMEWA YOGYAKARTA",5,114,34,148
https://kawalpemilu.org#42023,"JATIMULYO, DLINGO, BANTUL, DAERAH ISTIMEWA YOGYAKARTA",6,144,8,152
https://kawalpemilu.org#42023,"JATIMULYO, DLINGO, BANTUL, DAERAH ISTIMEWA YOGYAKARTA",7,140,45,185
https://kawalpemilu.org#42023,"JATIMULYO, DLINGO, BANTUL, DAERAH ISTIMEWA YOGYAKARTA",8,147,54,201
https://kawalpemilu.org#42023,"JATIMULYO, DLINGO, BANTUL, DAERAH ISTIMEWA YOGYAKARTA",9,132,21,153
https://kawalpemilu.org#42023,"JATIMULYO, DLINGO, BANTUL, DAERAH ISTIMEWA YOGYAKARTA",10,167,17,184
https://kawalpemilu.org#42023,"JATIMULYO, DLINGO, BANTUL, DAERAH ISTIMEWA YOGYAKARTA",11,190,44,234
https://kawalpemilu.org#42023,"JATIMULYO, DLINGO, BANTUL, DAERAH ISTIMEWA YOGYAKARTA",12,230,40,270
https://kawalpemilu.org#42023,"JATIMULYO, DLINGO, BANTUL, DAERAH ISTIMEWA YOGYAKARTA",13,213,29,242
https://kawalpemilu.org#42023,"JATIMULYO, DLINGO, BANTUL, DAERAH ISTIMEWA YOGYAKARTA",14,179,39,218
https://kawalpemilu.org#42023,"JATIMULYO, DLINGO, BANTUL, DAERAH ISTIMEWA YOGYAKARTA",15,140,17,157
https://kawalpemilu.org#42023,"JATIMULYO, DLINGO, BANTUL, DAERAH ISTIMEWA YOGYAKARTA",16,150,32,182
https://kawalpemilu.org#42023,"JATIMULYO, DLINGO, BANTUL, DAERAH ISTIMEWA YOGYAKARTA",17,216,15,231
https://kawalpemilu.org#42023,"JATIMULYO, DLINGO, BANTUL, DAERAH ISTIMEWA YOGYAKARTA",18,205,17,222
https://kawalpemilu.org#42023,"JATIMULYO, DLINGO, BANTUL, DAERAH ISTIMEWA YOGYAKARTA",19,169,13,182
https://kawalpemilu.org#42023,"JATIMULYO, DLINGO, BANTUL, DAERAH ISTIMEWA YOGYAKARTA",20,244,19,263
https://kawalpemilu.org#42023,"JATIMULYO, DLINGO, BANTUL, DAERAH ISTIMEWA YOGYAKARTA",21,215,36,251
https://kawalpemilu.org#42023,"JATIMULYO, DLINGO, BANTUL, DAERAH ISTIMEWA YOGYAKARTA",22,183,36,219
https://kawalpemilu.org#42023,"JATIMULYO, DLINGO, BANTUL, DAERAH ISTIMEWA YOGYAKARTA",23,199,45,244
https://kawalpemilu.org#42025,"BATURETNO, BANGUNTAPAN, BANTUL, DAERAH ISTIMEWA YOGYAKARTA",1,192,65,257
https://kawalpemilu.org#42025,"BATURETNO, BANGUNTAPAN, BANTUL, DAERAH ISTIMEWA YOGYAKARTA",2,172,87,259
https://kawalpemilu.org#42025,"BATURETNO, BANGUNTAPAN, BANTUL, DAERAH ISTIMEWA YOGYAKARTA",3,202,44,246
https://kawalpemilu.org#42025,"BATURETNO, BANGUNTAPAN, BANTUL, DAERAH ISTIMEWA YOGYAKARTA",4,151,71,222
https://kawalpemilu.org#42025,"BATURETNO, BANGUNTAPAN, BANTUL, DAERAH ISTIMEWA YOGYAKARTA",5,178,77,255
https://kawalpemilu.org#42025,"BATURETNO, BANGUNTAPAN, BANTUL, DAERAH ISTIMEWA YOGYAKARTA",6,152,113,265
https://kawalpemilu.org#42025,"BATURETNO, BANGUNTAPAN, BANTUL, DAERAH ISTIMEWA YOGYAKARTA",7,198,81,279
https://kawalpemilu.org#42025,"BATURETNO, BANGUNTAPAN, BANTUL, DAERAH ISTIMEWA YOGYAKARTA",8,186,72,258
https://kawalpemilu.org#42025,"BATURETNO, BANGUNTAPAN, BANTUL, DAERAH ISTIMEWA YOGYAKARTA",9,127,97,224
https://kawalpemilu.org#42025,"BATURETNO, BANGUNTAPAN, BANTUL, DAERAH ISTIMEWA YOGYAKARTA",10,141,104,245
https://kawalpemilu.org#42025,"BATURETNO, BANGUNTAPAN, BANTUL, DAERAH ISTIMEWA YOGYAKARTA",11,174,72,246
https://kawalpemilu.org#42025,"BATURETNO, BANGUNTAPAN, BANTUL, DAERAH ISTIMEWA YOGYAKARTA",12,132,89,221
https://kawalpemilu.org#42025,"BATURETNO, BANGUNTAPAN, BANTUL, DAERAH ISTIMEWA YOGYAKARTA",13,131,89,220
https://kawalpemilu.org#42025,"BATURETNO, BANGUNTAPAN, BANTUL, DAERAH ISTIMEWA YOGYAKARTA",14,162,88,250
https://kawalpemilu.org#42025,"BATURETNO, BANGUNTAPAN, BANTUL, DAERAH ISTIMEWA YOGYAKARTA",15,126,108,234
https://kawalpemilu.org#42025,"BATURETNO, BANGUNTAPAN, BANTUL, DAERAH ISTIMEWA YOGYAKARTA",16,107,149,256
https://kawalpemilu.org#42025,"BATURETNO, BANGUNTAPAN, BANTUL, DAERAH ISTIMEWA YOGYAKARTA",17,129,104,233
https://kawalpemilu.org#42025,"BATURETNO, BANGUNTAPAN, BANTUL, DAERAH ISTIMEWA YOGYAKARTA",18,109,141,250
https://kawalpemilu.org#42025,"BATURETNO, BANGUNTAPAN, BANTUL, DAERAH ISTIMEWA YOGYAKARTA",19,68,208,276
https://kawalpemilu.org#42025,"BATURETNO, BANGUNTAPAN, BANTUL, DAERAH ISTIMEWA YOGYAKARTA",20,90,184,274
https://kawalpemilu.org#42025,"BATURETNO, BANGUNTAPAN, BANTUL, DAERAH ISTIMEWA YOGYAKARTA",21,122,155,277
https://kawalpemilu.org#42025,"BATURETNO, BANGUNTAPAN, BANTUL, DAERAH ISTIMEWA YOGYAKARTA",22,79,63,142
https://kawalpemilu.org#42025,"BATURETNO, BANGUNTAPAN, BANTUL, DAERAH ISTIMEWA YOGYAKARTA",23,139,87,226
https://kawalpemilu.org#42025,"BATURETNO, BANGUNTAPAN, BANTUL, DAERAH ISTIMEWA YOGYAKARTA",24,99,166,265
https://kawalpemilu.org#42025,"BATURETNO, BANGUNTAPAN, BANTUL, DAERAH ISTIMEWA YOGYAKARTA",25,135,117,252
https://kawalpemilu.org#42025,"BATURETNO, BANGUNTAPAN, BANTUL, DAERAH ISTIMEWA YOGYAKARTA",26,117,143,260
https://kawalpemilu.org#42025,"BATURETNO, BANGUNTAPAN, BANTUL, DAERAH ISTIMEWA YOGYAKARTA",27,114,120,234
https://kawalpemilu.org#42025,"BATURETNO, BANGUNTAPAN, BANTUL, DAERAH ISTIMEWA YOGYAKARTA",28,93,133,226
https://kawalpemilu.org#42025,"BATURETNO, BANGUNTAPAN, BANTUL, DAERAH ISTIMEWA YOGYAKARTA",29,64,131,195
https://kawalpemilu.org#42025,"BATURETNO, BANGUNTAPAN, BANTUL, DAERAH ISTIMEWA YOGYAKARTA",30,100,89,189
https://kawalpemilu.org#42025,"BATURETNO, BANGUNTAPAN, BANTUL, DAERAH ISTIMEWA YOGYAKARTA",31,110,62,172
https://kawalpemilu.org#42025,"BATURETNO, BANGUNTAPAN, BANTUL, DAERAH ISTIMEWA YOGYAKARTA",32,106,66,172
https://kawalpemilu.org#42025,"BATURETNO, BANGUNTAPAN, BANTUL, DAERAH ISTIMEWA YOGYAKARTA",33,104,141,245
https://kawalpemilu.org#42025,"BATURETNO, BANGUNTAPAN, BANTUL, DAERAH ISTIMEWA YOGYAKARTA",34,84,135,219
https://kawalpemilu.org#42025,"BATURETNO, BANGUNTAPAN, BANTUL, DAERAH ISTIMEWA YOGYAKARTA",35,153,67,220
https://kawalpemilu.org#42025,"BATURETNO, BANGUNTAPAN, BANTUL, DAERAH ISTIMEWA YOGYAKARTA",36,165,108,273
https://kawalpemilu.org#42025,"BATURETNO, BANGUNTAPAN, BANTUL, DAERAH ISTIMEWA YOGYAKARTA",37,85,85,170
https://kawalpemilu.org#42025,"BATURETNO, BANGUNTAPAN, BANTUL, DAERAH ISTIMEWA YOGYAKARTA",38,89,70,159
https://kawalpemilu.org#42025,"BATURETNO, BANGUNTAPAN, BANTUL, DAERAH ISTIMEWA YOGYAKARTA",39,123,131,254
https://kawalpemilu.org#42025,"BATURETNO, BANGUNTAPAN, BANTUL, DAERAH ISTIMEWA YOGYAKARTA",40,120,66,186
https://kawalpemilu.org#42025,"BATURETNO, BANGUNTAPAN, BANTUL, DAERAH ISTIMEWA YOGYAKARTA",41,108,74,182
https://kawalpemilu.org#42025,"BATURETNO, BANGUNTAPAN, BANTUL, DAERAH ISTIMEWA YOGYAKARTA",42,99,96,195
https://kawalpemilu.org#42025,"BATURETNO, BANGUNTAPAN, BANTUL, DAERAH ISTIMEWA YOGYAKARTA",43,163,71,234
https://kawalpemilu.org#42025,"BATURETNO, BANGUNTAPAN, BANTUL, DAERAH ISTIMEWA YOGYAKARTA",44,114,106,220
https://kawalpemilu.org#42025,"BATURETNO, BANGUNTAPAN, BANTUL, DAERAH ISTIMEWA YOGYAKARTA",45,70,72,142
https://kawalpemilu.org#42025,"BATURETNO, BANGUNTAPAN, BANTUL, DAERAH ISTIMEWA YOGYAKARTA",46,144,92,236
https://kawalpemilu.org#42025,"BATURETNO, BANGUNTAPAN, BANTUL, DAERAH ISTIMEWA YOGYAKARTA",47,102,84,186
https://kawalpemilu.org#42026,"BANGUNTAPAN, BANGUNTAPAN, BANTUL, DAERAH ISTIMEWA YOGYAKARTA",1,132,54,186
https://kawalpemilu.org#42026,"BANGUNTAPAN, BANGUNTAPAN, BANTUL, DAERAH ISTIMEWA YOGYAKARTA",2,137,92,229
https://kawalpemilu.org#42026,"BANGUNTAPAN, BANGUNTAPAN, BANTUL, DAERAH ISTIMEWA YOGYAKARTA",3,157,69,226
https://kawalpemilu.org#42026,"BANGUNTAPAN, BANGUNTAPAN, BANTUL, DAERAH ISTIMEWA YOGYAKARTA",4,139,80,219
https://kawalpemilu.org#42026,"BANGUNTAPAN, BANGUNTAPAN, BANTUL, DAERAH ISTIMEWA YOGYAKARTA",5,123,85,208
https://kawalpemilu.org#42026,"BANGUNTAPAN, BANGUNTAPAN, BANTUL, DAERAH ISTIMEWA YOGYAKARTA",6,124,126,250
https://kawalpemilu.org#42026,"BANGUNTAPAN, BANGUNTAPAN, BANTUL, DAERAH ISTIMEWA YOGYAKARTA",7,126,125,251
https://kawalpemilu.org#42026,"BANGUNTAPAN, BANGUNTAPAN, BANTUL, DAERAH ISTIMEWA YOGYAKARTA",8,158,94,252
https://kawalpemilu.org#42026,"BANGUNTAPAN, BANGUNTAPAN, BANTUL, DAERAH ISTIMEWA YOGYAKARTA",9,169,76,245
https://kawalpemilu.org#42026,"BANGUNTAPAN, BANGUNTAPAN, BANTUL, DAERAH ISTIMEWA YOGYAKARTA",10,165,84,249
https://kawalpemilu.org#42026,"BANGUNTAPAN, BANGUNTAPAN, BANTUL, DAERAH ISTIMEWA YOGYAKARTA",11,134,84,218
https://kawalpemilu.org#42026,"BANGUNTAPAN, BANGUNTAPAN, BANTUL, DAERAH ISTIMEWA YOGYAKARTA",12,131,71,202
https://kawalpemilu.org#42026,"BANGUNTAPAN, BANGUNTAPAN, BANTUL, DAERAH ISTIMEWA YOGYAKARTA",13,110,86,196
https://kawalpemilu.org#42026,"BANGUNTAPAN, BANGUNTAPAN, BANTUL, DAERAH ISTIMEWA YOGYAKARTA",14,106,68,174
https://kawalpemilu.org#42026,"BANGUNTAPAN, BANGUNTAPAN, BANTUL, DAERAH ISTIMEWA YOGYAKARTA",15,141,80,221
https://kawalpemilu.org#42026,"BANGUNTAPAN, BANGUNTAPAN, BANTUL, DAERAH ISTIMEWA YOGYAKARTA",16,109,35,144
https://kawalpemilu.org#42026,"BANGUNTAPAN, BANGUNTAPAN, BANTUL, DAERAH ISTIMEWA YOGYAKARTA",17,165,61,226
https://kawalpemilu.org#42026,"BANGUNTAPAN, BANGUNTAPAN, BANTUL, DAERAH ISTIMEWA YOGYAKARTA",18,146,113,259
https://kawalpemilu.org#42026,"BANGUNTAPAN, BANGUNTAPAN, BANTUL, DAERAH ISTIMEWA YOGYAKARTA",19,120,85,205
https://kawalpemilu.org#42026,"BANGUNTAPAN, BANGUNTAPAN, BANTUL, DAERAH ISTIMEWA YOGYAKARTA",20,115,60,175
https://kawalpemilu.org#42026,"BANGUNTAPAN, BANGUNTAPAN, BANTUL, DAERAH ISTIMEWA YOGYAKARTA",21,106,78,184
https://kawalpemilu.org#42026,"BANGUNTAPAN, BANGUNTAPAN, BANTUL, DAERAH ISTIMEWA YOGYAKARTA",22,103,72,175
https://kawalpemilu.org#42026,"BANGUNTAPAN, BANGUNTAPAN, BANTUL, DAERAH ISTIMEWA YOGYAKARTA",23,130,75,205
https://kawalpemilu.org#42026,"BANGUNTAPAN, BANGUNTAPAN, BANTUL, DAERAH ISTIMEWA YOGYAKARTA",24,102,64,166
https://kawalpemilu.org#42026,"BANGUNTAPAN, BANGUNTAPAN, BANTUL, DAERAH ISTIMEWA YOGYAKARTA",25,178,113,291
https://kawalpemilu.org#42026,"BANGUNTAPAN, BANGUNTAPAN, BANTUL, DAERAH ISTIMEWA YOGYAKARTA",26,135,79,214
https://kawalpemilu.org#42026,"BANGUNTAPAN, BANGUNTAPAN, BANTUL, DAERAH ISTIMEWA YOGYAKARTA",27,198,80,278
https://kawalpemilu.org#42026,"BANGUNTAPAN, BANGUNTAPAN, BANTUL, DAERAH ISTIMEWA YOGYAKARTA",28,147,95,242
https://kawalpemilu.org#42026,"BANGUNTAPAN, BANGUNTAPAN, BANTUL, DAERAH ISTIMEWA YOGYAKARTA",29,166,76,242
https://kawalpemilu.org#42026,"BANGUNTAPAN, BANGUNTAPAN, BANTUL, DAERAH ISTIMEWA YOGYAKARTA",30,70,97,167
https://kawalpemilu.org#42026,"BANGUNTAPAN, BANGUNTAPAN, BANTUL, DAERAH ISTIMEWA YOGYAKARTA",31,128,80,208
https://kawalpemilu.org#42026,"BANGUNTAPAN, BANGUNTAPAN, BANTUL, DAERAH ISTIMEWA YOGYAKARTA",32,68,94,162
https://kawalpemilu.org#42026,"BANGUNTAPAN, BANGUNTAPAN, BANTUL, DAERAH ISTIMEWA YOGYAKARTA",33,169,72,241
https://kawalpemilu.org#42026,"BANGUNTAPAN, BANGUNTAPAN, BANTUL, DAERAH ISTIMEWA YOGYAKARTA",34,182,66,248
https://kawalpemilu.org#42026,"BANGUNTAPAN, BANGUNTAPAN, BANTUL, DAERAH ISTIMEWA YOGYAKARTA",35,131,42,173
https://kawalpemilu.org#42026,"BANGUNTAPAN, BANGUNTAPAN, BANTUL, DAERAH ISTIMEWA YOGYAKARTA",36,211,62,273
https://kawalpemilu.org#42026,"BANGUNTAPAN, BANGUNTAPAN, BANTUL, DAERAH ISTIMEWA YOGYAKARTA",37,201,84,285
https://kawalpemilu.org#42026,"BANGUNTAPAN, BANGUNTAPAN, BANTUL, DAERAH ISTIMEWA YOGYAKARTA",38,161,55,216
https://kawalpemilu.org#42026,"BANGUNTAPAN, BANGUNTAPAN, BANTUL, DAERAH ISTIMEWA YOGYAKARTA",39,191,83,274
https://kawalpemilu.org#42026,"BANGUNTAPAN, BANGUNTAPAN, BANTUL, DAERAH ISTIMEWA YOGYAKARTA",40,203,83,286
https://kawalpemilu.org#42026,"BANGUNTAPAN, BANGUNTAPAN, BANTUL, DAERAH ISTIMEWA YOGYAKARTA",41,99,68,167
https://kawalpemilu.org#42026,"BANGUNTAPAN, BANGUNTAPAN, BANTUL, DAERAH ISTIMEWA YOGYAKARTA",42,161,98,259
https://kawalpemilu.org#42026,"BANGUNTAPAN, BANGUNTAPAN, BANTUL, DAERAH ISTIMEWA YOGYAKARTA",43,106,120,226
https://kawalpemilu.org#42026,"BANGUNTAPAN, BANGUNTAPAN, BANTUL, DAERAH ISTIMEWA YOGYAKARTA",44,99,144,243
https://kawalpemilu.org#42026,"BANGUNTAPAN, BANGUNTAPAN, BANTUL, DAERAH ISTIMEWA YOGYAKARTA",45,138,74,212
https://kawalpemilu.org#42026,"BANGUNTAPAN, BANGUNTAPAN, BANTUL, DAERAH ISTIMEWA YOGYAKARTA",46,152,93,245
https://kawalpemilu.org#42026,"BANGUNTAPAN, BANGUNTAPAN, BANTUL, DAERAH ISTIMEWA YOGYAKARTA",47,182,85,267
https://kawalpemilu.org#42026,"BANGUNTAPAN, BANGUNTAPAN, BANTUL, DAERAH ISTIMEWA YOGYAKARTA",48,167,110,277
https://kawalpemilu.org#42026,"BANGUNTAPAN, BANGUNTAPAN, BANTUL, DAERAH ISTIMEWA YOGYAKARTA",49,155,88,243
https://kawalpemilu.org#42026,"BANGUNTAPAN, BANGUNTAPAN, BANTUL, DAERAH ISTIMEWA YOGYAKARTA",50,173,110,283
https://kawalpemilu.org#42026,"BANGUNTAPAN, BANGUNTAPAN, BANTUL, DAERAH ISTIMEWA YOGYAKARTA",51,175,72,247
https://kawalpemilu.org#42026,"BANGUNTAPAN, BANGUNTAPAN, BANTUL, DAERAH ISTIMEWA YOGYAKARTA",52,199,69,268
https://kawalpemilu.org#42026,"BANGUNTAPAN, BANGUNTAPAN, BANTUL, DAERAH ISTIMEWA YOGYAKARTA",53,174,65,239
https://kawalpemilu.org#42026,"BANGUNTAPAN, BANGUNTAPAN, BANTUL, DAERAH ISTIMEWA YOGYAKARTA",54,142,95,237
https://kawalpemilu.org#42026,"BANGUNTAPAN, BANGUNTAPAN, BANTUL, DAERAH ISTIMEWA YOGYAKARTA",55,186,69,255
https://kawalpemilu.org#42026,"BANGUNTAPAN, BANGUNTAPAN, BANTUL, DAERAH ISTIMEWA YOGYAKARTA",56,149,41,190
https://kawalpemilu.org#42026,"BANGUNTAPAN, BANGUNTAPAN, BANTUL, DAERAH ISTIMEWA YOGYAKARTA",57,72,48,120
https://kawalpemilu.org#42026,"BANGUNTAPAN, BANGUNTAPAN, BANTUL, DAERAH ISTIMEWA YOGYAKARTA",58,84,55,139
https://kawalpemilu.org#42026,"BANGUNTAPAN, BANGUNTAPAN, BANTUL, DAERAH ISTIMEWA YOGYAKARTA",59,161,94,255
https://kawalpemilu.org#42026,"BANGUNTAPAN, BANGUNTAPAN, BANTUL, DAERAH ISTIMEWA YOGYAKARTA",60,168,89,257
https://kawalpemilu.org#42026,"BANGUNTAPAN, BANGUNTAPAN, BANTUL, DAERAH ISTIMEWA YOGYAKARTA",61,164,92,256
https://kawalpemilu.org#42026,"BANGUNTAPAN, BANGUNTAPAN, BANTUL, DAERAH ISTIMEWA YOGYAKARTA",62,156,99,255
https://kawalpemilu.org#42026,"BANGUNTAPAN, BANGUNTAPAN, BANTUL, DAERAH ISTIMEWA YOGYAKARTA",63,210,51,261
https://kawalpemilu.org#42026,"BANGUNTAPAN, BANGUNTAPAN, BANTUL, DAERAH ISTIMEWA YOGYAKARTA",64,102,110,212
https://kawalpemilu.org#42026,"BANGUNTAPAN, BANGUNTAPAN, BANTUL, DAERAH ISTIMEWA YOGYAKARTA",65,125,54,179
https://kawalpemilu.org#42026,"BANGUNTAPAN, BANGUNTAPAN, BANTUL, DAERAH ISTIMEWA YOGYAKARTA",66,60,35,95
https://kawalpemilu.org#42026,"BANGUNTAPAN, BANGUNTAPAN, BANTUL, DAERAH ISTIMEWA YOGYAKARTA",67,228,42,270
https://kawalpemilu.org#42026,"BANGUNTAPAN, BANGUNTAPAN, BANTUL, DAERAH ISTIMEWA YOGYAKARTA",68,205,38,243
https://kawalpemilu.org#42026,"BANGUNTAPAN, BANGUNTAPAN, BANTUL, DAERAH ISTIMEWA YOGYAKARTA",69,186,45,231
https://kawalpemilu.org#42026,"BANGUNTAPAN, BANGUNTAPAN, BANTUL, DAERAH ISTIMEWA YOGYAKARTA",70,180,42,222
https://kawalpemilu.org#42026,"BANGUNTAPAN, BANGUNTAPAN, BANTUL, DAERAH ISTIMEWA YOGYAKARTA",71,175,106,281
https://kawalpemilu.org#42026,"BANGUNTAPAN, BANGUNTAPAN, BANTUL, DAERAH ISTIMEWA YOGYAKARTA",72,184,43,227
https://kawalpemilu.org#42026,"BANGUNTAPAN, BANGUNTAPAN, BANTUL, DAERAH ISTIMEWA YOGYAKARTA",73,122,67,189
https://kawalpemilu.org#42026,"BANGUNTAPAN, BANGUNTAPAN, BANTUL, DAERAH ISTIMEWA YOGYAKARTA",74,208,52,260
https://kawalpemilu.org#42026,"BANGUNTAPAN, BANGUNTAPAN, BANTUL, DAERAH ISTIMEWA YOGYAKARTA",75,132,75,207
https://kawalpemilu.org#42026,"BANGUNTAPAN, BANGUNTAPAN, BANTUL, DAERAH ISTIMEWA YOGYAKARTA",76,132,63,195
https://kawalpemilu.org#42026,"BANGUNTAPAN, BANGUNTAPAN, BANTUL, DAERAH ISTIMEWA YOGYAKARTA",77,91,78,169
https://kawalpemilu.org#42026,"BANGUNTAPAN, BANGUNTAPAN, BANTUL, DAERAH ISTIMEWA YOGYAKARTA",78,133,46,179
https://kawalpemilu.org#42026,"BANGUNTAPAN, BANGUNTAPAN, BANTUL, DAERAH ISTIMEWA YOGYAKARTA",79,173,81,254
https://kawalpemilu.org#42026,"BANGUNTAPAN, BANGUNTAPAN, BANTUL, DAERAH ISTIMEWA YOGYAKARTA",80,166,76,242
https://kawalpemilu.org#42026,"BANGUNTAPAN, BANGUNTAPAN, BANTUL, DAERAH ISTIMEWA YOGYAKARTA",81,183,59,242
https://kawalpemilu.org#42026,"BANGUNTAPAN, BANGUNTAPAN, BANTUL, DAERAH ISTIMEWA YOGYAKARTA",82,156,80,236
https://kawalpemilu.org#42026,"BANGUNTAPAN, BANGUNTAPAN, BANTUL, DAERAH ISTIMEWA YOGYAKARTA",83,149,131,280
https://kawalpemilu.org#42026,"BANGUNTAPAN, BANGUNTAPAN, BANTUL, DAERAH ISTIMEWA YOGYAKARTA",84,137,115,252
https://kawalpemilu.org#42026,"BANGUNTAPAN, BANGUNTAPAN, BANTUL, DAERAH ISTIMEWA YOGYAKARTA",85,105,179,284
https://kawalpemilu.org#42026,"BANGUNTAPAN, BANGUNTAPAN, BANTUL, DAERAH ISTIMEWA YOGYAKARTA",86,141,111,252
https://kawalpemilu.org#42026,"BANGUNTAPAN, BANGUNTAPAN, BANTUL, DAERAH ISTIMEWA YOGYAKARTA",87,124,84,208
https://kawalpemilu.org#42026,"BANGUNTAPAN, BANGUNTAPAN, BANTUL, DAERAH ISTIMEWA YOGYAKARTA",88,129,74,203
https://kawalpemilu.org#42026,"BANGUNTAPAN, BANGUNTAPAN, BANTUL, DAERAH ISTIMEWA YOGYAKARTA",89,136,119,255
https://kawalpemilu.org#42026,"BANGUNTAPAN, BANGUNTAPAN, BANTUL, DAERAH ISTIMEWA YOGYAKARTA",90,75,71,146
https://kawalpemilu.org#42026,"BANGUNTAPAN, BANGUNTAPAN, BANTUL, DAERAH ISTIMEWA YOGYAKARTA",91,129,92,221
https://kawalpemilu.org#42026,"BANGUNTAPAN, BANGUNTAPAN, BANTUL, DAERAH ISTIMEWA YOGYAKARTA",92,169,64,233
https://kawalpemilu.org#42026,"BANGUNTAPAN, BANGUNTAPAN, BANTUL, DAERAH ISTIMEWA YOGYAKARTA",93,213,57,270
https://kawalpemilu.org#42026,"BANGUNTAPAN, BANGUNTAPAN, BANTUL, DAERAH ISTIMEWA YOGYAKARTA",94,167,94,261
https://kawalpemilu.org#42026,"BANGUNTAPAN, BANGUNTAPAN, BANTUL, DAERAH ISTIMEWA YOGYAKARTA",95,149,98,247
https://kawalpemilu.org#42026,"BANGUNTAPAN, BANGUNTAPAN, BANTUL, DAERAH ISTIMEWA YOGYAKARTA",96,167,67,3
https://kawalpemilu.org#42026,"BANGUNTAPAN, BANGUNTAPAN, BANTUL, DAERAH ISTIMEWA YOGYAKARTA",97,139,96,235
https://kawalpemilu.org#42026,"BANGUNTAPAN, BANGUNTAPAN, BANTUL, DAERAH ISTIMEWA YOGYAKARTA",98,137,63,200
https://kawalpemilu.org#42026,"BANGUNTAPAN, BANGUNTAPAN, BANTUL, DAERAH ISTIMEWA YOGYAKARTA",99,162,98,260
https://kawalpemilu.org#42026,"BANGUNTAPAN, BANGUNTAPAN, BANTUL, DAERAH ISTIMEWA YOGYAKARTA",100,0,0,0
https://kawalpemilu.org#42026,"BANGUNTAPAN, BANGUNTAPAN, BANTUL, DAERAH ISTIMEWA YOGYAKARTA",101,180,79,259
https://kawalpemilu.org#42026,"BANGUNTAPAN, BANGUNTAPAN, BANTUL, DAERAH ISTIMEWA YOGYAKARTA",102,115,102,217
https://kawalpemilu.org#42026,"BANGUNTAPAN, BANGUNTAPAN, BANTUL, DAERAH ISTIMEWA YOGYAKARTA",103,113,85,198
https://kawalpemilu.org#42026,"BANGUNTAPAN, BANGUNTAPAN, BANTUL, DAERAH ISTIMEWA YOGYAKARTA",104,57,127,184
https://kawalpemilu.org#42026,"BANGUNTAPAN, BANGUNTAPAN, BANTUL, DAERAH ISTIMEWA YOGYAKARTA",105,45,108,153
https://kawalpemilu.org#42026,"BANGUNTAPAN, BANGUNTAPAN, BANTUL, DAERAH ISTIMEWA YOGYAKARTA",106,52,60,154
https://kawalpemilu.org#42026,"BANGUNTAPAN, BANGUNTAPAN, BANTUL, DAERAH ISTIMEWA YOGYAKARTA",107,50,92,142
https://kawalpemilu.org#42026,"BANGUNTAPAN, BANGUNTAPAN, BANTUL, DAERAH ISTIMEWA YOGYAKARTA",108,39,104,143
https://kawalpemilu.org#42027,"JAGALAN, BANGUNTAPAN, BANTUL, DAERAH ISTIMEWA YOGYAKARTA",1,121,97,218
https://kawalpemilu.org#42027,"JAGALAN, BANGUNTAPAN, BANTUL, DAERAH ISTIMEWA YOGYAKARTA",2,100,133,233
https://kawalpemilu.org#42027,"JAGALAN, BANGUNTAPAN, BANTUL, DAERAH ISTIMEWA YOGYAKARTA",3,108,97,205
https://kawalpemilu.org#42027,"JAGALAN, BANGUNTAPAN, BANTUL, DAERAH ISTIMEWA YOGYAKARTA",4,125,95,220
https://kawalpemilu.org#42027,"JAGALAN, BANGUNTAPAN, BANTUL, DAERAH ISTIMEWA YOGYAKARTA",5,122,122,244
https://kawalpemilu.org#42027,"JAGALAN, BANGUNTAPAN, BANTUL, DAERAH ISTIMEWA YOGYAKARTA",6,127,80,207
https://kawalpemilu.org#42027,"JAGALAN, BANGUNTAPAN, BANTUL, DAERAH ISTIMEWA YOGYAKARTA",7,118,106,224
https://kawalpemilu.org#42027,"JAGALAN, BANGUNTAPAN, BANTUL, DAERAH ISTIMEWA YOGYAKARTA",8,89,163,252
https://kawalpemilu.org#42027,"JAGALAN, BANGUNTAPAN, BANTUL, DAERAH ISTIMEWA YOGYAKARTA",9,119,97,216
https://kawalpemilu.org#42028,"SINGOSAREN, BANGUNTAPAN, BANTUL, DAERAH ISTIMEWA YOGYAKARTA",1,76,158,234
https://kawalpemilu.org#42028,"SINGOSAREN, BANGUNTAPAN, BANTUL, DAERAH ISTIMEWA YOGYAKARTA",2,109,86,195
https://kawalpemilu.org#42028,"SINGOSAREN, BANGUNTAPAN, BANTUL, DAERAH ISTIMEWA YOGYAKARTA",3,71,71,142
https://kawalpemilu.org#42028,"SINGOSAREN, BANGUNTAPAN, BANTUL, DAERAH ISTIMEWA YOGYAKARTA",4,107,50,157
https://kawalpemilu.org#42028,"SINGOSAREN, BANGUNTAPAN, BANTUL, DAERAH ISTIMEWA YOGYAKARTA",5,84,82,166
https://kawalpemilu.org#42028,"SINGOSAREN, BANGUNTAPAN, BANTUL, DAERAH ISTIMEWA YOGYAKARTA",6,146,60,206
https://kawalpemilu.org#42028,"SINGOSAREN, BANGUNTAPAN, BANTUL, DAERAH ISTIMEWA YOGYAKARTA",7,111,144,255
https://kawalpemilu.org#42028,"SINGOSAREN, BANGUNTAPAN, BANTUL, DAERAH ISTIMEWA YOGYAKARTA",8,116,114,230
https://kawalpemilu.org#42028,"SINGOSAREN, BANGUNTAPAN, BANTUL, DAERAH ISTIMEWA YOGYAKARTA",9,134,121,255
https://kawalpemilu.org#42028,"SINGOSAREN, BANGUNTAPAN, BANTUL, DAERAH ISTIMEWA YOGYAKARTA",10,158,103,261
https://kawalpemilu.org#42028,"SINGOSAREN, BANGUNTAPAN, BANTUL, DAERAH ISTIMEWA YOGYAKARTA",11,156,71,227
https://kawalpemilu.org#42028,"SINGOSAREN, BANGUNTAPAN, BANTUL, DAERAH ISTIMEWA YOGYAKARTA",12,174,72,246
https://kawalpemilu.org#42029,"JAMBIDAN, BANGUNTAPAN, BANTUL, DAERAH ISTIMEWA YOGYAKARTA",1,191,75,266
https://kawalpemilu.org#42029,"JAMBIDAN, BANGUNTAPAN, BANTUL, DAERAH ISTIMEWA YOGYAKARTA",2,150,96,246
https://kawalpemilu.org#42029,"JAMBIDAN, BANGUNTAPAN, BANTUL, DAERAH ISTIMEWA YOGYAKARTA",3,147,88,235
https://kawalpemilu.org#42029,"JAMBIDAN, BANGUNTAPAN, BANTUL, DAERAH ISTIMEWA YOGYAKARTA",4,175,45,220
https://kawalpemilu.org#42029,"JAMBIDAN, BANGUNTAPAN, BANTUL, DAERAH ISTIMEWA YOGYAKARTA",5,155,59,214
https://kawalpemilu.org#42029,"JAMBIDAN, BANGUNTAPAN, BANTUL, DAERAH ISTIMEWA YOGYAKARTA",6,129,58,187
https://kawalpemilu.org#42029,"JAMBIDAN, BANGUNTAPAN, BANTUL, DAERAH ISTIMEWA YOGYAKARTA",7,46,110,174
https://kawalpemilu.org#42029,"JAMBIDAN, BANGUNTAPAN, BANTUL, DAERAH ISTIMEWA YOGYAKARTA",8,101,93,194
https://kawalpemilu.org#42029,"JAMBIDAN, BANGUNTAPAN, BANTUL, DAERAH ISTIMEWA YOGYAKARTA",9,166,94,260
https://kawalpemilu.org#42029,"JAMBIDAN, BANGUNTAPAN, BANTUL, DAERAH ISTIMEWA YOGYAKARTA",10,170,97,267
https://kawalpemilu.org#42029,"JAMBIDAN, BANGUNTAPAN, BANTUL, DAERAH ISTIMEWA YOGYAKARTA",11,199,74,273
https://kawalpemilu.org#42029,"JAMBIDAN, BANGUNTAPAN, BANTUL, DAERAH ISTIMEWA YOGYAKARTA",12,193,83,276
https://kawalpemilu.org#42029,"JAMBIDAN, BANGUNTAPAN, BANTUL, DAERAH ISTIMEWA YOGYAKARTA",13,118,161,279
https://kawalpemilu.org#42029,"JAMBIDAN, BANGUNTAPAN, BANTUL, DAERAH ISTIMEWA YOGYAKARTA",14,148,80,228
https://kawalpemilu.org#42029,"JAMBIDAN, BANGUNTAPAN, BANTUL, DAERAH ISTIMEWA YOGYAKARTA",15,174,70,244
https://kawalpemilu.org#42029,"JAMBIDAN, BANGUNTAPAN, BANTUL, DAERAH ISTIMEWA YOGYAKARTA",16,121,102,4
https://kawalpemilu.org#42029,"JAMBIDAN, BANGUNTAPAN, BANTUL, DAERAH ISTIMEWA YOGYAKARTA",17,152,70,222
https://kawalpemilu.org#42029,"JAMBIDAN, BANGUNTAPAN, BANTUL, DAERAH ISTIMEWA YOGYAKARTA",18,154,48,202
https://kawalpemilu.org#42029,"JAMBIDAN, BANGUNTAPAN, BANTUL, DAERAH ISTIMEWA YOGYAKARTA",19,103,151,254
https://kawalpemilu.org#42029,"JAMBIDAN, BANGUNTAPAN, BANTUL, DAERAH ISTIMEWA YOGYAKARTA",20,112,131,243
https://kawalpemilu.org#42029,"JAMBIDAN, BANGUNTAPAN, BANTUL, DAERAH ISTIMEWA YOGYAKARTA",21,145,118,263
https://kawalpemilu.org#42029,"JAMBIDAN, BANGUNTAPAN, BANTUL, DAERAH ISTIMEWA YOGYAKARTA",22,105,81,186
https://kawalpemilu.org#42029,"JAMBIDAN, BANGUNTAPAN, BANTUL, DAERAH ISTIMEWA YOGYAKARTA",23,135,66,201
https://kawalpemilu.org#42029,"JAMBIDAN, BANGUNTAPAN, BANTUL, DAERAH ISTIMEWA YOGYAKARTA",24,62,65,127
https://kawalpemilu.org#42029,"JAMBIDAN, BANGUNTAPAN, BANTUL, DAERAH ISTIMEWA YOGYAKARTA",25,82,73,155
https://kawalpemilu.org#42029,"JAMBIDAN, BANGUNTAPAN, BANTUL, DAERAH ISTIMEWA YOGYAKARTA",26,81,183,264
https://kawalpemilu.org#42029,"JAMBIDAN, BANGUNTAPAN, BANTUL, DAERAH ISTIMEWA YOGYAKARTA",27,175,67,242
https://kawalpemilu.org#42029,"JAMBIDAN, BANGUNTAPAN, BANTUL, DAERAH ISTIMEWA YOGYAKARTA",28,194,76,270
https://kawalpemilu.org#42029,"JAMBIDAN, BANGUNTAPAN, BANTUL, DAERAH ISTIMEWA YOGYAKARTA",29,149,81,230
https://kawalpemilu.org#42030,"POTORONO, BANGUNTAPAN, BANTUL, DAERAH ISTIMEWA YOGYAKARTA",1,166,83,249
https://kawalpemilu.org#42030,"POTORONO, BANGUNTAPAN, BANTUL, DAERAH ISTIMEWA YOGYAKARTA",2,163,69,232
https://kawalpemilu.org#42030,"POTORONO, BANGUNTAPAN, BANTUL, DAERAH ISTIMEWA YOGYAKARTA",3,195,71,266
https://kawalpemilu.org#42030,"POTORONO, BANGUNTAPAN, BANTUL, DAERAH ISTIMEWA YOGYAKARTA",4,76,56,132
https://kawalpemilu.org#42030,"POTORONO, BANGUNTAPAN, BANTUL, DAERAH ISTIMEWA YOGYAKARTA",5,156,87,246
https://kawalpemilu.org#42030,"POTORONO, BANGUNTAPAN, BANTUL, DAERAH ISTIMEWA YOGYAKARTA",6,158,93,251
https://kawalpemilu.org#42030,"POTORONO, BANGUNTAPAN, BANTUL, DAERAH ISTIMEWA YOGYAKARTA",7,181,97,278
https://kawalpemilu.org#42030,"POTORONO, BANGUNTAPAN, BANTUL, DAERAH ISTIMEWA YOGYAKARTA",8,153,90,243
https://kawalpemilu.org#42030,"POTORONO, BANGUNTAPAN, BANTUL, DAERAH ISTIMEWA YOGYAKARTA",9,143,99,242
https://kawalpemilu.org#42030,"POTORONO, BANGUNTAPAN, BANTUL, DAERAH ISTIMEWA YOGYAKARTA",10,175,85,260
https://kawalpemilu.org#42030,"POTORONO, BANGUNTAPAN, BANTUL, DAERAH ISTIMEWA YOGYAKARTA",11,147,68,215
https://kawalpemilu.org#42030,"POTORONO, BANGUNTAPAN, BANTUL, DAERAH ISTIMEWA YOGYAKARTA",12,118,139,257
https://kawalpemilu.org#42030,"POTORONO, BANGUNTAPAN, BANTUL, DAERAH ISTIMEWA YOGYAKARTA",13,107,148,255
https://kawalpemilu.org#42030,"POTORONO, BANGUNTAPAN, BANTUL, DAERAH ISTIMEWA YOGYAKARTA",14,152,100,252
https://kawalpemilu.org#42030,"POTORONO, BANGUNTAPAN, BANTUL, DAERAH ISTIMEWA YOGYAKARTA",15,131,81,212
https://kawalpemilu.org#42030,"POTORONO, BANGUNTAPAN, BANTUL, DAERAH ISTIMEWA YOGYAKARTA",16,63,59,122
https://kawalpemilu.org#42030,"POTORONO, BANGUNTAPAN, BANTUL, DAERAH ISTIMEWA YOGYAKARTA",17,94,60,154
https://kawalpemilu.org#42030,"POTORONO, BANGUNTAPAN, BANTUL, DAERAH ISTIMEWA YOGYAKARTA",18,99,65,164
https://kawalpemilu.org#42030,"POTORONO, BANGUNTAPAN, BANTUL, DAERAH ISTIMEWA YOGYAKARTA",19,62,100,162
https://kawalpemilu.org#42030,"POTORONO, BANGUNTAPAN, BANTUL, DAERAH ISTIMEWA YOGYAKARTA",20,56,102,158
https://kawalpemilu.org#42030,"POTORONO, BANGUNTAPAN, BANTUL, DAERAH ISTIMEWA YOGYAKARTA",21,94,78,172
https://kawalpemilu.org#42030,"POTORONO, BANGUNTAPAN, BANTUL, DAERAH ISTIMEWA YOGYAKARTA",22,193,71,264
https://kawalpemilu.org#42030,"POTORONO, BANGUNTAPAN, BANTUL, DAERAH ISTIMEWA YOGYAKARTA",23,150,126,276
https://kawalpemilu.org#42030,"POTORONO, BANGUNTAPAN, BANTUL, DAERAH ISTIMEWA YOGYAKARTA",24,145,101,246
https://kawalpemilu.org#42030,"POTORONO, BANGUNTAPAN, BANTUL, DAERAH ISTIMEWA YOGYAKARTA",25,147,105,252
https://kawalpemilu.org#42030,"POTORONO, BANGUNTAPAN, BANTUL, DAERAH ISTIMEWA YOGYAKARTA",26,59,180,239
https://kawalpemilu.org#42030,"POTORONO, BANGUNTAPAN, BANTUL, DAERAH ISTIMEWA YOGYAKARTA",27,161,103,264
https://kawalpemilu.org#42030,"POTORONO, BANGUNTAPAN, BANTUL, DAERAH ISTIMEWA YOGYAKARTA",28,139,98,237
https://kawalpemilu.org#42030,"POTORONO, BANGUNTAPAN, BANTUL, DAERAH ISTIMEWA YOGYAKARTA",29,156,72,228
https://kawalpemilu.org#42030,"POTORONO, BANGUNTAPAN, BANTUL, DAERAH ISTIMEWA YOGYAKARTA",30,131,134,265
https://kawalpemilu.org#42030,"POTORONO, BANGUNTAPAN, BANTUL, DAERAH ISTIMEWA YOGYAKARTA",31,105,151,256
https://kawalpemilu.org#42030,"POTORONO, BANGUNTAPAN, BANTUL, DAERAH ISTIMEWA YOGYAKARTA",32,126,114,240
https://kawalpemilu.org#42030,"POTORONO, BANGUNTAPAN, BANTUL, DAERAH ISTIMEWA YOGYAKARTA",33,125,88,213
https://kawalpemilu.org#42030,"POTORONO, BANGUNTAPAN, BANTUL, DAERAH ISTIMEWA YOGYAKARTA",34,135,61,196
https://kawalpemilu.org#42030,"POTORONO, BANGUNTAPAN, BANTUL, DAERAH ISTIMEWA YOGYAKARTA",35,76,42,118
https://kawalpemilu.org#42030,"POTORONO, BANGUNTAPAN, BANTUL, DAERAH ISTIMEWA YOGYAKARTA",36,150,116,266
https://kawalpemilu.org#42030,"POTORONO, BANGUNTAPAN, BANTUL, DAERAH ISTIMEWA YOGYAKARTA",37,116,83,199
https://kawalpemilu.org#42030,"POTORONO, BANGUNTAPAN, BANTUL, DAERAH ISTIMEWA YOGYAKARTA",38,170,95,265
https://kawalpemilu.org#42031,"TAMANAN, BANGUNTAPAN, BANTUL, DAERAH ISTIMEWA YOGYAKARTA",1,189,49,238
https://kawalpemilu.org#42031,"TAMANAN, BANGUNTAPAN, BANTUL, DAERAH ISTIMEWA YOGYAKARTA",2,0,0,0
https://kawalpemilu.org#42031,"TAMANAN, BANGUNTAPAN, BANTUL, DAERAH ISTIMEWA YOGYAKARTA",3,172,66,238
https://kawalpemilu.org#42031,"TAMANAN, BANGUNTAPAN, BANTUL, DAERAH ISTIMEWA YOGYAKARTA",4,192,69,261
https://kawalpemilu.org#42031,"TAMANAN, BANGUNTAPAN, BANTUL, DAERAH ISTIMEWA YOGYAKARTA",5,197,75,272
https://kawalpemilu.org#42031,"TAMANAN, BANGUNTAPAN, BANTUL, DAERAH ISTIMEWA YOGYAKARTA",6,182,65,247
https://kawalpemilu.org#42031,"TAMANAN, BANGUNTAPAN, BANTUL, DAERAH ISTIMEWA YOGYAKARTA",7,127,46,173
https://kawalpemilu.org#42031,"TAMANAN, BANGUNTAPAN, BANTUL, DAERAH ISTIMEWA YOGYAKARTA",8,188,65,253
https://kawalpemilu.org#42031,"TAMANAN, BANGUNTAPAN, BANTUL, DAERAH ISTIMEWA YOGYAKARTA",9,126,40,166
https://kawalpemilu.org#42031,"TAMANAN, BANGUNTAPAN, BANTUL, DAERAH ISTIMEWA YOGYAKARTA",10,134,64,198
https://kawalpemilu.org#42031,"TAMANAN, BANGUNTAPAN, BANTUL, DAERAH ISTIMEWA YOGYAKARTA",11,182,60,242
https://kawalpemilu.org#42031,"TAMANAN, BANGUNTAPAN, BANTUL, DAERAH ISTIMEWA YOGYAKARTA",12,162,76,238
https://kawalpemilu.org#42031,"TAMANAN, BANGUNTAPAN, BANTUL, DAERAH ISTIMEWA YOGYAKARTA",13,155,65,220
https://kawalpemilu.org#42031,"TAMANAN, BANGUNTAPAN, BANTUL, DAERAH ISTIMEWA YOGYAKARTA",14,203,73,276
https://kawalpemilu.org#42031,"TAMANAN, BANGUNTAPAN, BANTUL, DAERAH ISTIMEWA YOGYAKARTA",15,173,42,215
https://kawalpemilu.org#42031,"TAMANAN, BANGUNTAPAN, BANTUL, DAERAH ISTIMEWA YOGYAKARTA",16,137,37,174
https://kawalpemilu.org#42031,"TAMANAN, BANGUNTAPAN, BANTUL, DAERAH ISTIMEWA YOGYAKARTA",17,124,60,184
https://kawalpemilu.org#42031,"TAMANAN, BANGUNTAPAN, BANTUL, DAERAH ISTIMEWA YOGYAKARTA",18,177,50,227
https://kawalpemilu.org#42031,"TAMANAN, BANGUNTAPAN, BANTUL, DAERAH ISTIMEWA YOGYAKARTA",19,135,54,189
https://kawalpemilu.org#42031,"TAMANAN, BANGUNTAPAN, BANTUL, DAERAH ISTIMEWA YOGYAKARTA",20,126,74,200
https://kawalpemilu.org#42031,"TAMANAN, BANGUNTAPAN, BANTUL, DAERAH ISTIMEWA YOGYAKARTA",21,103,100,203
https://kawalpemilu.org#42031,"TAMANAN, BANGUNTAPAN, BANTUL, DAERAH ISTIMEWA YOGYAKARTA",22,126,78,204
https://kawalpemilu.org#42031,"TAMANAN, BANGUNTAPAN, BANTUL, DAERAH ISTIMEWA YOGYAKARTA",23,185,59,244
https://kawalpemilu.org#42031,"TAMANAN, BANGUNTAPAN, BANTUL, DAERAH ISTIMEWA YOGYAKARTA",24,150,100,250
https://kawalpemilu.org#42031,"TAMANAN, BANGUNTAPAN, BANTUL, DAERAH ISTIMEWA YOGYAKARTA",25,160,103,263
https://kawalpemilu.org#42031,"TAMANAN, BANGUNTAPAN, BANTUL, DAERAH ISTIMEWA YOGYAKARTA",26,173,94,267
https://kawalpemilu.org#42031,"TAMANAN, BANGUNTAPAN, BANTUL, DAERAH ISTIMEWA YOGYAKARTA",27,198,62,260
https://kawalpemilu.org#42031,"TAMANAN, BANGUNTAPAN, BANTUL, DAERAH ISTIMEWA YOGYAKARTA",28,147,101,248
https://kawalpemilu.org#42031,"TAMANAN, BANGUNTAPAN, BANTUL, DAERAH ISTIMEWA YOGYAKARTA",29,125,104,229
https://kawalpemilu.org#42031,"TAMANAN, BANGUNTAPAN, BANTUL, DAERAH ISTIMEWA YOGYAKARTA",30,157,77,234
https://kawalpemilu.org#42031,"TAMANAN, BANGUNTAPAN, BANTUL, DAERAH ISTIMEWA YOGYAKARTA",31,131,102,233
https://kawalpemilu.org#42031,"TAMANAN, BANGUNTAPAN, BANTUL, DAERAH ISTIMEWA YOGYAKARTA",32,88,44,132
https://kawalpemilu.org#42031,"TAMANAN, BANGUNTAPAN, BANTUL, DAERAH ISTIMEWA YOGYAKARTA",33,128,59,187
https://kawalpemilu.org#42031,"TAMANAN, BANGUNTAPAN, BANTUL, DAERAH ISTIMEWA YOGYAKARTA",34,106,72,178
https://kawalpemilu.org#42031,"TAMANAN, BANGUNTAPAN, BANTUL, DAERAH ISTIMEWA YOGYAKARTA",35,147,62,209
https://kawalpemilu.org#42031,"TAMANAN, BANGUNTAPAN, BANTUL, DAERAH ISTIMEWA YOGYAKARTA",36,81,100,181
https://kawalpemilu.org#42031,"TAMANAN, BANGUNTAPAN, BANTUL, DAERAH ISTIMEWA YOGYAKARTA",37,138,63,201
https://kawalpemilu.org#42032,"WIROKERTEN, BANGUNTAPAN, BANTUL, DAERAH ISTIMEWA YOGYAKARTA",1,191,74,265
https://kawalpemilu.org#42032,"WIROKERTEN, BANGUNTAPAN, BANTUL, DAERAH ISTIMEWA YOGYAKARTA",2,138,81,219
https://kawalpemilu.org#42032,"WIROKERTEN, BANGUNTAPAN, BANTUL, DAERAH ISTIMEWA YOGYAKARTA",3,116,73,189
https://kawalpemilu.org#42032,"WIROKERTEN, BANGUNTAPAN, BANTUL, DAERAH ISTIMEWA YOGYAKARTA",4,132,64,196
https://kawalpemilu.org#42032,"WIROKERTEN, BANGUNTAPAN, BANTUL, DAERAH ISTIMEWA YOGYAKARTA",5,162,49,211
https://kawalpemilu.org#42032,"WIROKERTEN, BANGUNTAPAN, BANTUL, DAERAH ISTIMEWA YOGYAKARTA",6,160,92,252
https://kawalpemilu.org#42032,"WIROKERTEN, BANGUNTAPAN, BANTUL, DAERAH ISTIMEWA YOGYAKARTA",7,191,68,259
https://kawalpemilu.org#42032,"WIROKERTEN, BANGUNTAPAN, BANTUL, DAERAH ISTIMEWA YOGYAKARTA",8,181,85,266
https://kawalpemilu.org#42032,"WIROKERTEN, BANGUNTAPAN, BANTUL, DAERAH ISTIMEWA YOGYAKARTA",9,186,72,258
https://kawalpemilu.org#42032,"WIROKERTEN, BANGUNTAPAN, BANTUL, DAERAH ISTIMEWA YOGYAKARTA",10,215,70,285
https://kawalpemilu.org#42032,"WIROKERTEN, BANGUNTAPAN, BANTUL, DAERAH ISTIMEWA YOGYAKARTA",11,142,119,261
https://kawalpemilu.org#42032,"WIROKERTEN, BANGUNTAPAN, BANTUL, DAERAH ISTIMEWA YOGYAKARTA",12,228,44,272
https://kawalpemilu.org#42032,"WIROKERTEN, BANGUNTAPAN, BANTUL, DAERAH ISTIMEWA YOGYAKARTA",13,131,83,214
https://kawalpemilu.org#42032,"WIROKERTEN, BANGUNTAPAN, BANTUL, DAERAH ISTIMEWA YOGYAKARTA",14,140,35,179
https://kawalpemilu.org#42032,"WIROKERTEN, BANGUNTAPAN, BANTUL, DAERAH ISTIMEWA YOGYAKARTA",15,152,99,251
https://kawalpemilu.org#42032,"WIROKERTEN, BANGUNTAPAN, BANTUL, DAERAH ISTIMEWA YOGYAKARTA",16,140,87,227
https://kawalpemilu.org#42032,"WIROKERTEN, BANGUNTAPAN, BANTUL, DAERAH ISTIMEWA YOGYAKARTA",17,151,75,226
https://kawalpemilu.org#42032,"WIROKERTEN, BANGUNTAPAN, BANTUL, DAERAH ISTIMEWA YOGYAKARTA",18,101,126,227
https://kawalpemilu.org#42032,"WIROKERTEN, BANGUNTAPAN, BANTUL, DAERAH ISTIMEWA YOGYAKARTA",19,97,115,212
https://kawalpemilu.org#42032,"WIROKERTEN, BANGUNTAPAN, BANTUL, DAERAH ISTIMEWA YOGYAKARTA",20,191,68,259
https://kawalpemilu.org#42032,"WIROKERTEN, BANGUNTAPAN, BANTUL, DAERAH ISTIMEWA YOGYAKARTA",21,118,138,256
https://kawalpemilu.org#42032,"WIROKERTEN, BANGUNTAPAN, BANTUL, DAERAH ISTIMEWA YOGYAKARTA",22,85,104,189
https://kawalpemilu.org#42032,"WIROKERTEN, BANGUNTAPAN, BANTUL, DAERAH ISTIMEWA YOGYAKARTA",23,150,102,252
https://kawalpemilu.org#42032,"WIROKERTEN, BANGUNTAPAN, BANTUL, DAERAH ISTIMEWA YOGYAKARTA",24,90,170,260
https://kawalpemilu.org#42032,"WIROKERTEN, BANGUNTAPAN, BANTUL, DAERAH ISTIMEWA YOGYAKARTA",25,118,118,236
https://kawalpemilu.org#42032,"WIROKERTEN, BANGUNTAPAN, BANTUL, DAERAH ISTIMEWA YOGYAKARTA",27,4,249,253
https://kawalpemilu.org#42032,"WIROKERTEN, BANGUNTAPAN, BANTUL, DAERAH ISTIMEWA YOGYAKARTA",29,164,83,247
https://kawalpemilu.org#42032,"WIROKERTEN, BANGUNTAPAN, BANTUL, DAERAH ISTIMEWA YOGYAKARTA",30,138,91,229
https://kawalpemilu.org#42032,"WIROKERTEN, BANGUNTAPAN, BANTUL, DAERAH ISTIMEWA YOGYAKARTA",31,132,122,254
https://kawalpemilu.org#42032,"WIROKERTEN, BANGUNTAPAN, BANTUL, DAERAH ISTIMEWA YOGYAKARTA",32,162,126,288
https://kawalpemilu.org#42032,"WIROKERTEN, BANGUNTAPAN, BANTUL, DAERAH ISTIMEWA YOGYAKARTA",33,40,122,162
https://kawalpemilu.org#42032,"WIROKERTEN, BANGUNTAPAN, BANTUL, DAERAH ISTIMEWA YOGYAKARTA",34,100,90,190
https://kawalpemilu.org#42032,"WIROKERTEN, BANGUNTAPAN, BANTUL, DAERAH ISTIMEWA YOGYAKARTA",35,166,93,259
https://kawalpemilu.org#42032,"WIROKERTEN, BANGUNTAPAN, BANTUL, DAERAH ISTIMEWA YOGYAKARTA",36,109,115,224
https://kawalpemilu.org#42032,"WIROKERTEN, BANGUNTAPAN, BANTUL, DAERAH ISTIMEWA YOGYAKARTA",37,69,84,153
https://kawalpemilu.org#42032,"WIROKERTEN, BANGUNTAPAN, BANTUL, DAERAH ISTIMEWA YOGYAKARTA",38,70,104,174
https://kawalpemilu.org#42034,"WONOKROMO, PLERET, BANTUL, DAERAH ISTIMEWA YOGYAKARTA",1,64,134,198
https://kawalpemilu.org#42034,"WONOKROMO, PLERET, BANTUL, DAERAH ISTIMEWA YOGYAKARTA",2,142,119,261
https://kawalpemilu.org#42034,"WONOKROMO, PLERET, BANTUL, DAERAH ISTIMEWA YOGYAKARTA",3,78,137,215
https://kawalpemilu.org#42034,"WONOKROMO, PLERET, BANTUL, DAERAH ISTIMEWA YOGYAKARTA",4,135,73,208
https://kawalpemilu.org#42034,"WONOKROMO, PLERET, BANTUL, DAERAH ISTIMEWA YOGYAKARTA",5,142,44,189
https://kawalpemilu.org#42034,"WONOKROMO, PLERET, BANTUL, DAERAH ISTIMEWA YOGYAKARTA",6,164,54,218
https://kawalpemilu.org#42034,"WONOKROMO, PLERET, BANTUL, DAERAH ISTIMEWA YOGYAKARTA",7,139,26,165
https://kawalpemilu.org#42034,"WONOKROMO, PLERET, BANTUL, DAERAH ISTIMEWA YOGYAKARTA",8,118,48,166
https://kawalpemilu.org#42034,"WONOKROMO, PLERET, BANTUL, DAERAH ISTIMEWA YOGYAKARTA",9,195,41,236
https://kawalpemilu.org#42034,"WONOKROMO, PLERET, BANTUL, DAERAH ISTIMEWA YOGYAKARTA",10,192,54,246
https://kawalpemilu.org#42034,"WONOKROMO, PLERET, BANTUL, DAERAH ISTIMEWA YOGYAKARTA",11,143,57,200
https://kawalpemilu.org#42034,"WONOKROMO, PLERET, BANTUL, DAERAH ISTIMEWA YOGYAKARTA",12,110,58,168
https://kawalpemilu.org#42034,"WONOKROMO, PLERET, BANTUL, DAERAH ISTIMEWA YOGYAKARTA",13,203,44,247
https://kawalpemilu.org#42034,"WONOKROMO, PLERET, BANTUL, DAERAH ISTIMEWA YOGYAKARTA",14,152,68,220
https://kawalpemilu.org#42034,"WONOKROMO, PLERET, BANTUL, DAERAH ISTIMEWA YOGYAKARTA",15,128,64,192
https://kawalpemilu.org#42034,"WONOKROMO, PLERET, BANTUL, DAERAH ISTIMEWA YOGYAKARTA",16,186,53,239
https://kawalpemilu.org#42034,"WONOKROMO, PLERET, BANTUL, DAERAH ISTIMEWA YOGYAKARTA",17,175,39,214
https://kawalpemilu.org#42034,"WONOKROMO, PLERET, BANTUL, DAERAH ISTIMEWA YOGYAKARTA",18,162,70,232
https://kawalpemilu.org#42034,"WONOKROMO, PLERET, BANTUL, DAERAH ISTIMEWA YOGYAKARTA",19,220,52,272
https://kawalpemilu.org#42034,"WONOKROMO, PLERET, BANTUL, DAERAH ISTIMEWA YOGYAKARTA",20,190,70,260
https://kawalpemilu.org#42034,"WONOKROMO, PLERET, BANTUL, DAERAH ISTIMEWA YOGYAKARTA",21,195,47,242
https://kawalpemilu.org#42034,"WONOKROMO, PLERET, BANTUL, DAERAH ISTIMEWA YOGYAKARTA",22,169,72,241
https://kawalpemilu.org#42034,"WONOKROMO, PLERET, BANTUL, DAERAH ISTIMEWA YOGYAKARTA",23,158,70,228
https://kawalpemilu.org#42034,"WONOKROMO, PLERET, BANTUL, DAERAH ISTIMEWA YOGYAKARTA",24,115,101,216
https://kawalpemilu.org#42034,"WONOKROMO, PLERET, BANTUL, DAERAH ISTIMEWA YOGYAKARTA",25,167,75,242
https://kawalpemilu.org#42034,"WONOKROMO, PLERET, BANTUL, DAERAH ISTIMEWA YOGYAKARTA",26,119,118,237
https://kawalpemilu.org#42034,"WONOKROMO, PLERET, BANTUL, DAERAH ISTIMEWA YOGYAKARTA",27,136,65,201
https://kawalpemilu.org#42034,"WONOKROMO, PLERET, BANTUL, DAERAH ISTIMEWA YOGYAKARTA",28,127,83,210
https://kawalpemilu.org#42034,"WONOKROMO, PLERET, BANTUL, DAERAH ISTIMEWA YOGYAKARTA",29,153,81,234
https://kawalpemilu.org#42034,"WONOKROMO, PLERET, BANTUL, DAERAH ISTIMEWA YOGYAKARTA",30,176,70,246
https://kawalpemilu.org#42034,"WONOKROMO, PLERET, BANTUL, DAERAH ISTIMEWA YOGYAKARTA",31,173,51,224
https://kawalpemilu.org#42034,"WONOKROMO, PLERET, BANTUL, DAERAH ISTIMEWA YOGYAKARTA",32,169,34,203
https://kawalpemilu.org#42034,"WONOKROMO, PLERET, BANTUL, DAERAH ISTIMEWA YOGYAKARTA",33,149,42,191
https://kawalpemilu.org#42034,"WONOKROMO, PLERET, BANTUL, DAERAH ISTIMEWA YOGYAKARTA",34,137,98,235
https://kawalpemilu.org#42034,"WONOKROMO, PLERET, BANTUL, DAERAH ISTIMEWA YOGYAKARTA",35,154,63,217
https://kawalpemilu.org#42034,"WONOKROMO, PLERET, BANTUL, DAERAH ISTIMEWA YOGYAKARTA",36,169,88,257
https://kawalpemilu.org#42034,"WONOKROMO, PLERET, BANTUL, DAERAH ISTIMEWA YOGYAKARTA",37,175,86,261
https://kawalpemilu.org#42034,"WONOKROMO, PLERET, BANTUL, DAERAH ISTIMEWA YOGYAKARTA",38,120,151,271
https://kawalpemilu.org#42034,"WONOKROMO, PLERET, BANTUL, DAERAH ISTIMEWA YOGYAKARTA",39,96,177,273
https://kawalpemilu.org#42034,"WONOKROMO, PLERET, BANTUL, DAERAH ISTIMEWA YOGYAKARTA",40,139,96,235
https://kawalpemilu.org#42034,"WONOKROMO, PLERET, BANTUL, DAERAH ISTIMEWA YOGYAKARTA",41,114,95,214
https://kawalpemilu.org#42035,"PLERET, PLERET, BANTUL, DAERAH ISTIMEWA YOGYAKARTA",1,118,122,240
https://kawalpemilu.org#42035,"PLERET, PLERET, BANTUL, DAERAH ISTIMEWA YOGYAKARTA",2,149,74,223
https://kawalpemilu.org#42035,"PLERET, PLERET, BANTUL, DAERAH ISTIMEWA YOGYAKARTA",3,92,143,235
https://kawalpemilu.org#42035,"PLERET, PLERET, BANTUL, DAERAH ISTIMEWA YOGYAKARTA",4,132,104,236
https://kawalpemilu.org#42035,"PLERET, PLERET, BANTUL, DAERAH ISTIMEWA YOGYAKARTA",5,131,94,225
https://kawalpemilu.org#42035,"PLERET, PLERET, BANTUL, DAERAH ISTIMEWA YOGYAKARTA",6,164,50,214
https://kawalpemilu.org#42035,"PLERET, PLERET, BANTUL, DAERAH ISTIMEWA YOGYAKARTA",7,149,126,275
https://kawalpemilu.org#42035,"PLERET, PLERET, BANTUL, DAERAH ISTIMEWA YOGYAKARTA",8,163,82,245
https://kawalpemilu.org#42035,"PLERET, PLERET, BANTUL, DAERAH ISTIMEWA YOGYAKARTA",9,142,103,245
https://kawalpemilu.org#42035,"PLERET, PLERET, BANTUL, DAERAH ISTIMEWA YOGYAKARTA",10,122,63,185
https://kawalpemilu.org#42035,"PLERET, PLERET, BANTUL, DAERAH ISTIMEWA YOGYAKARTA",11,106,105,211
https://kawalpemilu.org#42035,"PLERET, PLERET, BANTUL, DAERAH ISTIMEWA YOGYAKARTA",12,96,66,162
https://kawalpemilu.org#42035,"PLERET, PLERET, BANTUL, DAERAH ISTIMEWA YOGYAKARTA",13,131,42,173
https://kawalpemilu.org#42035,"PLERET, PLERET, BANTUL, DAERAH ISTIMEWA YOGYAKARTA",14,173,95,268
https://kawalpemilu.org#42035,"PLERET, PLERET, BANTUL, DAERAH ISTIMEWA YOGYAKARTA",15,176,85,261
https://kawalpemilu.org#42035,"PLERET, PLERET, BANTUL, DAERAH ISTIMEWA YOGYAKARTA",16,151,54,205
https://kawalpemilu.org#42035,"PLERET, PLERET, BANTUL, DAERAH ISTIMEWA YOGYAKARTA",17,152,75,227
https://kawalpemilu.org#42035,"PLERET, PLERET, BANTUL, DAERAH ISTIMEWA YOGYAKARTA",18,160,82,242
https://kawalpemilu.org#42035,"PLERET, PLERET, BANTUL, DAERAH ISTIMEWA YOGYAKARTA",19,159,67,226
https://kawalpemilu.org#42035,"PLERET, PLERET, BANTUL, DAERAH ISTIMEWA YOGYAKARTA",20,97,57,154
https://kawalpemilu.org#42035,"PLERET, PLERET, BANTUL, DAERAH ISTIMEWA YOGYAKARTA",21,135,46,181
https://kawalpemilu.org#42035,"PLERET, PLERET, BANTUL, DAERAH ISTIMEWA YOGYAKARTA",22,174,60,234
https://kawalpemilu.org#42035,"PLERET, PLERET, BANTUL, DAERAH ISTIMEWA YOGYAKARTA",23,151,44,195
https://kawalpemilu.org#42035,"PLERET, PLERET, BANTUL, DAERAH ISTIMEWA YOGYAKARTA",24,106,63,169
https://kawalpemilu.org#42035,"PLERET, PLERET, BANTUL, DAERAH ISTIMEWA YOGYAKARTA",25,109,93,202
https://kawalpemilu.org#42035,"PLERET, PLERET, BANTUL, DAERAH ISTIMEWA YOGYAKARTA",26,122,54,176
https://kawalpemilu.org#42035,"PLERET, PLERET, BANTUL, DAERAH ISTIMEWA YOGYAKARTA",27,180,82,262
https://kawalpemilu.org#42035,"PLERET, PLERET, BANTUL, DAERAH ISTIMEWA YOGYAKARTA",28,116,54,170
https://kawalpemilu.org#42035,"PLERET, PLERET, BANTUL, DAERAH ISTIMEWA YOGYAKARTA",29,113,76,189
https://kawalpemilu.org#42035,"PLERET, PLERET, BANTUL, DAERAH ISTIMEWA YOGYAKARTA",30,126,106,232
https://kawalpemilu.org#42035,"PLERET, PLERET, BANTUL, DAERAH ISTIMEWA YOGYAKARTA",31,157,70,227
https://kawalpemilu.org#42035,"PLERET, PLERET, BANTUL, DAERAH ISTIMEWA YOGYAKARTA",32,121,55,176
https://kawalpemilu.org#42035,"PLERET, PLERET, BANTUL, DAERAH ISTIMEWA YOGYAKARTA",33,75,160,235
https://kawalpemilu.org#42035,"PLERET, PLERET, BANTUL, DAERAH ISTIMEWA YOGYAKARTA",34,68,170,238
https://kawalpemilu.org#42035,"PLERET, PLERET, BANTUL, DAERAH ISTIMEWA YOGYAKARTA",35,135,74,209
https://kawalpemilu.org#42035,"PLERET, PLERET, BANTUL, DAERAH ISTIMEWA YOGYAKARTA",36,105,88,193
https://kawalpemilu.org#42035,"PLERET, PLERET, BANTUL, DAERAH ISTIMEWA YOGYAKARTA",37,154,102,256
https://kawalpemilu.org#42035,"PLERET, PLERET, BANTUL, DAERAH ISTIMEWA YOGYAKARTA",38,76,66,142
https://kawalpemilu.org#42035,"PLERET, PLERET, BANTUL, DAERAH ISTIMEWA YOGYAKARTA",39,133,48,181
https://kawalpemilu.org#42035,"PLERET, PLERET, BANTUL, DAERAH ISTIMEWA YOGYAKARTA",40,174,60,234
https://kawalpemilu.org#42035,"PLERET, PLERET, BANTUL, DAERAH ISTIMEWA YOGYAKARTA",41,139,73,212
https://kawalpemilu.org#42036,"SEGOROYOSO, PLERET, BANTUL, DAERAH ISTIMEWA YOGYAKARTA",1,139,14,153
https://kawalpemilu.org#42036,"SEGOROYOSO, PLERET, BANTUL, DAERAH ISTIMEWA YOGYAKARTA",2,191,33,224
https://kawalpemilu.org#42036,"SEGOROYOSO, PLERET, BANTUL, DAERAH ISTIMEWA YOGYAKARTA",3,221,32,253
https://kawalpemilu.org#42036,"SEGOROYOSO, PLERET, BANTUL, DAERAH ISTIMEWA YOGYAKARTA",4,200,45,245
https://kawalpemilu.org#42036,"SEGOROYOSO, PLERET, BANTUL, DAERAH ISTIMEWA YOGYAKARTA",5,163,81,244
https://kawalpemilu.org#42036,"SEGOROYOSO, PLERET, BANTUL, DAERAH ISTIMEWA YOGYAKARTA",6,147,65,212
https://kawalpemilu.org#42036,"SEGOROYOSO, PLERET, BANTUL, DAERAH ISTIMEWA YOGYAKARTA",7,159,76,235
https://kawalpemilu.org#42036,"SEGOROYOSO, PLERET, BANTUL, DAERAH ISTIMEWA YOGYAKARTA",8,153,54,207
https://kawalpemilu.org#42036,"SEGOROYOSO, PLERET, BANTUL, DAERAH ISTIMEWA YOGYAKARTA",9,158,116,274
https://kawalpemilu.org#42036,"SEGOROYOSO, PLERET, BANTUL, DAERAH ISTIMEWA YOGYAKARTA",10,78,150,228
https://kawalpemilu.org#42036,"SEGOROYOSO, PLERET, BANTUL, DAERAH ISTIMEWA YOGYAKARTA",11,99,100,199
https://kawalpemilu.org#42036,"SEGOROYOSO, PLERET, BANTUL, DAERAH ISTIMEWA YOGYAKARTA",12,109,58,167
https://kawalpemilu.org#42036,"SEGOROYOSO, PLERET, BANTUL, DAERAH ISTIMEWA YOGYAKARTA",13,117,69,186
https://kawalpemilu.org#42036,"SEGOROYOSO, PLERET, BANTUL, DAERAH ISTIMEWA YOGYAKARTA",14,184,31,215
https://kawalpemilu.org#42036,"SEGOROYOSO, PLERET, BANTUL, DAERAH ISTIMEWA YOGYAKARTA",15,160,69,229
https://kawalpemilu.org#42036,"SEGOROYOSO, PLERET, BANTUL, DAERAH ISTIMEWA YOGYAKARTA",16,116,27,143
https://kawalpemilu.org#42036,"SEGOROYOSO, PLERET, BANTUL, DAERAH ISTIMEWA YOGYAKARTA",17,205,67,272
https://kawalpemilu.org#42036,"SEGOROYOSO, PLERET, BANTUL, DAERAH ISTIMEWA YOGYAKARTA",18,69,114,183
https://kawalpemilu.org#42036,"SEGOROYOSO, PLERET, BANTUL, DAERAH ISTIMEWA YOGYAKARTA",19,224,37,261
https://kawalpemilu.org#42036,"SEGOROYOSO, PLERET, BANTUL, DAERAH ISTIMEWA YOGYAKARTA",20,89,152,241
https://kawalpemilu.org#42036,"SEGOROYOSO, PLERET, BANTUL, DAERAH ISTIMEWA YOGYAKARTA",21,93,116,209
https://kawalpemilu.org#42036,"SEGOROYOSO, PLERET, BANTUL, DAERAH ISTIMEWA YOGYAKARTA",22,86,143,229
https://kawalpemilu.org#42036,"SEGOROYOSO, PLERET, BANTUL, DAERAH ISTIMEWA YOGYAKARTA",23,167,98,265
https://kawalpemilu.org#42036,"SEGOROYOSO, PLERET, BANTUL, DAERAH ISTIMEWA YOGYAKARTA",24,93,111,204
https://kawalpemilu.org#42036,"SEGOROYOSO, PLERET, BANTUL, DAERAH ISTIMEWA YOGYAKARTA",25,138,34,172
https://kawalpemilu.org#42036,"SEGOROYOSO, PLERET, BANTUL, DAERAH ISTIMEWA YOGYAKARTA",26,241,15,256
https://kawalpemilu.org#42036,"SEGOROYOSO, PLERET, BANTUL, DAERAH ISTIMEWA YOGYAKARTA",27,130,26,156
https://kawalpemilu.org#42037,"BAWURAN, PLERET, BANTUL, DAERAH ISTIMEWA YOGYAKARTA",1,145,119,264
https://kawalpemilu.org#42037,"BAWURAN, PLERET, BANTUL, DAERAH ISTIMEWA YOGYAKARTA",2,163,94,257
https://kawalpemilu.org#42037,"BAWURAN, PLERET, BANTUL, DAERAH ISTIMEWA YOGYAKARTA",3,201,71,272
https://kawalpemilu.org#42037,"BAWURAN, PLERET, BANTUL, DAERAH ISTIMEWA YOGYAKARTA",4,171,45,216
https://kawalpemilu.org#42037,"BAWURAN, PLERET, BANTUL, DAERAH ISTIMEWA YOGYAKARTA",5,117,46,163
https://kawalpemilu.org#42037,"BAWURAN, PLERET, BANTUL, DAERAH ISTIMEWA YOGYAKARTA",6,215,40,255
https://kawalpemilu.org#42037,"BAWURAN, PLERET, BANTUL, DAERAH ISTIMEWA YOGYAKARTA",7,164,26,190
https://kawalpemilu.org#42037,"BAWURAN, PLERET, BANTUL, DAERAH ISTIMEWA YOGYAKARTA",8,171,46,217
https://kawalpemilu.org#42037,"BAWURAN, PLERET, BANTUL, DAERAH ISTIMEWA YOGYAKARTA",9,215,38,253
https://kawalpemilu.org#42037,"BAWURAN, PLERET, BANTUL, DAERAH ISTIMEWA YOGYAKARTA",10,114,117,231
https://kawalpemilu.org#42037,"BAWURAN, PLERET, BANTUL, DAERAH ISTIMEWA YOGYAKARTA",11,206,51,257
https://kawalpemilu.org#42037,"BAWURAN, PLERET, BANTUL, DAERAH ISTIMEWA YOGYAKARTA",12,127,101,228
https://kawalpemilu.org#42037,"BAWURAN, PLERET, BANTUL, DAERAH ISTIMEWA YOGYAKARTA",13,198,21,219
https://kawalpemilu.org#42037,"BAWURAN, PLERET, BANTUL, DAERAH ISTIMEWA YOGYAKARTA",14,182,24,206
https://kawalpemilu.org#42037,"BAWURAN, PLERET, BANTUL, DAERAH ISTIMEWA YOGYAKARTA",15,244,16,260
https://kawalpemilu.org#42037,"BAWURAN, PLERET, BANTUL, DAERAH ISTIMEWA YOGYAKARTA",16,147,127,274
https://kawalpemilu.org#42037,"BAWURAN, PLERET, BANTUL, DAERAH ISTIMEWA YOGYAKARTA",17,226,24,250
https://kawalpemilu.org#42037,"BAWURAN, PLERET, BANTUL, DAERAH ISTIMEWA YOGYAKARTA",18,205,35,240
https://kawalpemilu.org#42038,"WONOLELO, PLERET, BANTUL, DAERAH ISTIMEWA YOGYAKARTA",1,239,38,277
https://kawalpemilu.org#42038,"WONOLELO, PLERET, BANTUL, DAERAH ISTIMEWA YOGYAKARTA",2,232,42,274
https://kawalpemilu.org#42038,"WONOLELO, PLERET, BANTUL, DAERAH ISTIMEWA YOGYAKARTA",3,228,20,248
https://kawalpemilu.org#42038,"WONOLELO, PLERET, BANTUL, DAERAH ISTIMEWA YOGYAKARTA",4,192,52,224
https://kawalpemilu.org#42038,"WONOLELO, PLERET, BANTUL, DAERAH ISTIMEWA YOGYAKARTA",5,128,27,155
https://kawalpemilu.org#42038,"WONOLELO, PLERET, BANTUL, DAERAH ISTIMEWA YOGYAKARTA",6,240,14,254
https://kawalpemilu.org#42038,"WONOLELO, PLERET, BANTUL, DAERAH ISTIMEWA YOGYAKARTA",7,200,20,220
https://kawalpemilu.org#42038,"WONOLELO, PLERET, BANTUL, DAERAH ISTIMEWA YOGYAKARTA",8,180,32,212
https://kawalpemilu.org#42038,"WONOLELO, PLERET, BANTUL, DAERAH ISTIMEWA YOGYAKARTA",9,194,45,239
https://kawalpemilu.org#42038,"WONOLELO, PLERET, BANTUL, DAERAH ISTIMEWA YOGYAKARTA",10,217,17,234
https://kawalpemilu.org#42038,"WONOLELO, PLERET, BANTUL, DAERAH ISTIMEWA YOGYAKARTA",11,189,59,248
https://kawalpemilu.org#42038,"WONOLELO, PLERET, BANTUL, DAERAH ISTIMEWA YOGYAKARTA",12,101,78,179
https://kawalpemilu.org#42038,"WONOLELO, PLERET, BANTUL, DAERAH ISTIMEWA YOGYAKARTA",13,127,85,212
https://kawalpemilu.org#42038,"WONOLELO, PLERET, BANTUL, DAERAH ISTIMEWA YOGYAKARTA",14,98,55,153
https://kawalpemilu.org#42038,"WONOLELO, PLERET, BANTUL, DAERAH ISTIMEWA YOGYAKARTA",15,126,23,149
https://kawalpemilu.org#42040,"SITIMULYO, PIYUNGAN, BANTUL, DAERAH ISTIMEWA YOGYAKARTA",1,222,50,272
https://kawalpemilu.org#42040,"SITIMULYO, PIYUNGAN, BANTUL, DAERAH ISTIMEWA YOGYAKARTA",2,127,61,188
https://kawalpemilu.org#42040,"SITIMULYO, PIYUNGAN, BANTUL, DAERAH ISTIMEWA YOGYAKARTA",3,129,82,211
https://kawalpemilu.org#42040,"SITIMULYO, PIYUNGAN, BANTUL, DAERAH ISTIMEWA YOGYAKARTA",4,75,63,138
https://kawalpemilu.org#42040,"SITIMULYO, PIYUNGAN, BANTUL, DAERAH ISTIMEWA YOGYAKARTA",5,172,91,263
https://kawalpemilu.org#42040,"SITIMULYO, PIYUNGAN, BANTUL, DAERAH ISTIMEWA YOGYAKARTA",6,129,57,186
https://kawalpemilu.org#42040,"SITIMULYO, PIYUNGAN, BANTUL, DAERAH ISTIMEWA YOGYAKARTA",7,84,57,141
https://kawalpemilu.org#42040,"SITIMULYO, PIYUNGAN, BANTUL, DAERAH ISTIMEWA YOGYAKARTA",8,80,57,137
https://kawalpemilu.org#42040,"SITIMULYO, PIYUNGAN, BANTUL, DAERAH ISTIMEWA YOGYAKARTA",9,107,82,189
https://kawalpemilu.org#42040,"SITIMULYO, PIYUNGAN, BANTUL, DAERAH ISTIMEWA YOGYAKARTA",10,112,59,171
https://kawalpemilu.org#42040,"SITIMULYO, PIYUNGAN, BANTUL, DAERAH ISTIMEWA YOGYAKARTA",11,108,129,237
https://kawalpemilu.org#42040,"SITIMULYO, PIYUNGAN, BANTUL, DAERAH ISTIMEWA YOGYAKARTA",12,134,127,261
https://kawalpemilu.org#42040,"SITIMULYO, PIYUNGAN, BANTUL, DAERAH ISTIMEWA YOGYAKARTA",13,147,64,211
https://kawalpemilu.org#42040,"SITIMULYO, PIYUNGAN, BANTUL, DAERAH ISTIMEWA YOGYAKARTA",14,120,51,171
https://kawalpemilu.org#42040,"SITIMULYO, PIYUNGAN, BANTUL, DAERAH ISTIMEWA YOGYAKARTA",15,103,46,149
https://kawalpemilu.org#42040,"SITIMULYO, PIYUNGAN, BANTUL, DAERAH ISTIMEWA YOGYAKARTA",16,100,103,203
https://kawalpemilu.org#42040,"SITIMULYO, PIYUNGAN, BANTUL, DAERAH ISTIMEWA YOGYAKARTA",17,80,161,241
https://kawalpemilu.org#42040,"SITIMULYO, PIYUNGAN, BANTUL, DAERAH ISTIMEWA YOGYAKARTA",18,181,73,254
https://kawalpemilu.org#42040,"SITIMULYO, PIYUNGAN, BANTUL, DAERAH ISTIMEWA YOGYAKARTA",19,115,84,199
https://kawalpemilu.org#42040,"SITIMULYO, PIYUNGAN, BANTUL, DAERAH ISTIMEWA YOGYAKARTA",20,90,141,231
https://kawalpemilu.org#42040,"SITIMULYO, PIYUNGAN, BANTUL, DAERAH ISTIMEWA YOGYAKARTA",21,84,55,139
https://kawalpemilu.org#42040,"SITIMULYO, PIYUNGAN, BANTUL, DAERAH ISTIMEWA YOGYAKARTA",22,77,101,178
https://kawalpemilu.org#42040,"SITIMULYO, PIYUNGAN, BANTUL, DAERAH ISTIMEWA YOGYAKARTA",23,165,107,272
https://kawalpemilu.org#42040,"SITIMULYO, PIYUNGAN, BANTUL, DAERAH ISTIMEWA YOGYAKARTA",24,43,209,252
https://kawalpemilu.org#42040,"SITIMULYO, PIYUNGAN, BANTUL, DAERAH ISTIMEWA YOGYAKARTA",25,120,118,238
https://kawalpemilu.org#42040,"SITIMULYO, PIYUNGAN, BANTUL, DAERAH ISTIMEWA YOGYAKARTA",26,124,132,256
https://kawalpemilu.org#42040,"SITIMULYO, PIYUNGAN, BANTUL, DAERAH ISTIMEWA YOGYAKARTA",27,152,78,230
https://kawalpemilu.org#42040,"SITIMULYO, PIYUNGAN, BANTUL, DAERAH ISTIMEWA YOGYAKARTA",28,122,110,232
https://kawalpemilu.org#42040,"SITIMULYO, PIYUNGAN, BANTUL, DAERAH ISTIMEWA YOGYAKARTA",29,131,106,237
https://kawalpemilu.org#42040,"SITIMULYO, PIYUNGAN, BANTUL, DAERAH ISTIMEWA YOGYAKARTA",30,107,91,198
https://kawalpemilu.org#42040,"SITIMULYO, PIYUNGAN, BANTUL, DAERAH ISTIMEWA YOGYAKARTA",31,100,63,163
https://kawalpemilu.org#42040,"SITIMULYO, PIYUNGAN, BANTUL, DAERAH ISTIMEWA YOGYAKARTA",32,179,66,245
https://kawalpemilu.org#42040,"SITIMULYO, PIYUNGAN, BANTUL, DAERAH ISTIMEWA YOGYAKARTA",33,118,99,217
https://kawalpemilu.org#42040,"SITIMULYO, PIYUNGAN, BANTUL, DAERAH ISTIMEWA YOGYAKARTA",34,178,73,251
https://kawalpemilu.org#42040,"SITIMULYO, PIYUNGAN, BANTUL, DAERAH ISTIMEWA YOGYAKARTA",36,176,41,217
https://kawalpemilu.org#42040,"SITIMULYO, PIYUNGAN, BANTUL, DAERAH ISTIMEWA YOGYAKARTA",37,141,30,171
https://kawalpemilu.org#42040,"SITIMULYO, PIYUNGAN, BANTUL, DAERAH ISTIMEWA YOGYAKARTA",38,144,52,196
https://kawalpemilu.org#42040,"SITIMULYO, PIYUNGAN, BANTUL, DAERAH ISTIMEWA YOGYAKARTA",39,160,63,223
https://kawalpemilu.org#42040,"SITIMULYO, PIYUNGAN, BANTUL, DAERAH ISTIMEWA YOGYAKARTA",40,129,75,204
https://kawalpemilu.org#42040,"SITIMULYO, PIYUNGAN, BANTUL, DAERAH ISTIMEWA YOGYAKARTA",41,133,75,208
https://kawalpemilu.org#42040,"SITIMULYO, PIYUNGAN, BANTUL, DAERAH ISTIMEWA YOGYAKARTA",42,139,46,185
https://kawalpemilu.org#42040,"SITIMULYO, PIYUNGAN, BANTUL, DAERAH ISTIMEWA YOGYAKARTA",43,163,79,242
https://kawalpemilu.org#42040,"SITIMULYO, PIYUNGAN, BANTUL, DAERAH ISTIMEWA YOGYAKARTA",44,136,77,213
https://kawalpemilu.org#42040,"SITIMULYO, PIYUNGAN, BANTUL, DAERAH ISTIMEWA YOGYAKARTA",45,169,37,206
https://kawalpemilu.org#42040,"SITIMULYO, PIYUNGAN, BANTUL, DAERAH ISTIMEWA YOGYAKARTA",46,205,60,265
https://kawalpemilu.org#42040,"SITIMULYO, PIYUNGAN, BANTUL, DAERAH ISTIMEWA YOGYAKARTA",47,148,119,267
https://kawalpemilu.org#42040,"SITIMULYO, PIYUNGAN, BANTUL, DAERAH ISTIMEWA YOGYAKARTA",48,142,40,182
https://kawalpemilu.org#42040,"SITIMULYO, PIYUNGAN, BANTUL, DAERAH ISTIMEWA YOGYAKARTA",49,103,71,174
https://kawalpemilu.org#42040,"SITIMULYO, PIYUNGAN, BANTUL, DAERAH ISTIMEWA YOGYAKARTA",50,131,51,182
https://kawalpemilu.org#42040,"SITIMULYO, PIYUNGAN, BANTUL, DAERAH ISTIMEWA YOGYAKARTA",51,174,74,248
https://kawalpemilu.org#42040,"SITIMULYO, PIYUNGAN, BANTUL, DAERAH ISTIMEWA YOGYAKARTA",52,174,55,229
https://kawalpemilu.org#42040,"SITIMULYO, PIYUNGAN, BANTUL, DAERAH ISTIMEWA YOGYAKARTA",53,152,86,238
https://kawalpemilu.org#42040,"SITIMULYO, PIYUNGAN, BANTUL, DAERAH ISTIMEWA YOGYAKARTA",54,106,76,182
https://kawalpemilu.org#42040,"SITIMULYO, PIYUNGAN, BANTUL, DAERAH ISTIMEWA YOGYAKARTA",55,153,77,230
https://kawalpemilu.org#42040,"SITIMULYO, PIYUNGAN, BANTUL, DAERAH ISTIMEWA YOGYAKARTA",56,166,82,248
https://kawalpemilu.org#42040,"SITIMULYO, PIYUNGAN, BANTUL, DAERAH ISTIMEWA YOGYAKARTA",57,187,25,212
https://kawalpemilu.org#42041,"SRIMULYO, PIYUNGAN, BANTUL, DAERAH ISTIMEWA YOGYAKARTA",1,137,82,219
https://kawalpemilu.org#42041,"SRIMULYO, PIYUNGAN, BANTUL, DAERAH ISTIMEWA YOGYAKARTA",2,111,75,186
https://kawalpemilu.org#42041,"SRIMULYO, PIYUNGAN, BANTUL, DAERAH ISTIMEWA YOGYAKARTA",3,110,58,168
https://kawalpemilu.org#42041,"SRIMULYO, PIYUNGAN, BANTUL, DAERAH ISTIMEWA YOGYAKARTA",4,66,24,90
https://kawalpemilu.org#42041,"SRIMULYO, PIYUNGAN, BANTUL, DAERAH ISTIMEWA YOGYAKARTA",5,154,95,249
https://kawalpemilu.org#42041,"SRIMULYO, PIYUNGAN, BANTUL, DAERAH ISTIMEWA YOGYAKARTA",6,172,77,249
https://kawalpemilu.org#42041,"SRIMULYO, PIYUNGAN, BANTUL, DAERAH ISTIMEWA YOGYAKARTA",7,171,105,276
https://kawalpemilu.org#42041,"SRIMULYO, PIYUNGAN, BANTUL, DAERAH ISTIMEWA YOGYAKARTA",8,124,76,200
https://kawalpemilu.org#42041,"SRIMULYO, PIYUNGAN, BANTUL, DAERAH ISTIMEWA YOGYAKARTA",9,118,68,186
https://kawalpemilu.org#42041,"SRIMULYO, PIYUNGAN, BANTUL, DAERAH ISTIMEWA YOGYAKARTA",10,170,66,236
https://kawalpemilu.org#42041,"SRIMULYO, PIYUNGAN, BANTUL, DAERAH ISTIMEWA YOGYAKARTA",11,202,54,256
https://kawalpemilu.org#42041,"SRIMULYO, PIYUNGAN, BANTUL, DAERAH ISTIMEWA YOGYAKARTA",12,179,75,254
https://kawalpemilu.org#42041,"SRIMULYO, PIYUNGAN, BANTUL, DAERAH ISTIMEWA YOGYAKARTA",13,164,92,256
https://kawalpemilu.org#42041,"SRIMULYO, PIYUNGAN, BANTUL, DAERAH ISTIMEWA YOGYAKARTA",14,107,51,158
https://kawalpemilu.org#42041,"SRIMULYO, PIYUNGAN, BANTUL, DAERAH ISTIMEWA YOGYAKARTA",15,103,34,137
https://kawalpemilu.org#42041,"SRIMULYO, PIYUNGAN, BANTUL, DAERAH ISTIMEWA YOGYAKARTA",16,90,67,157
https://kawalpemilu.org#42041,"SRIMULYO, PIYUNGAN, BANTUL, DAERAH ISTIMEWA YOGYAKARTA",17,195,68,263
https://kawalpemilu.org#42041,"SRIMULYO, PIYUNGAN, BANTUL, DAERAH ISTIMEWA YOGYAKARTA",18,165,80,245
https://kawalpemilu.org#42041,"SRIMULYO, PIYUNGAN, BANTUL, DAERAH ISTIMEWA YOGYAKARTA",19,109,34,143
https://kawalpemilu.org#42041,"SRIMULYO, PIYUNGAN, BANTUL, DAERAH ISTIMEWA YOGYAKARTA",20,117,70,187
https://kawalpemilu.org#42041,"SRIMULYO, PIYUNGAN, BANTUL, DAERAH ISTIMEWA YOGYAKARTA",21,79,85,164
https://kawalpemilu.org#42041,"SRIMULYO, PIYUNGAN, BANTUL, DAERAH ISTIMEWA YOGYAKARTA",22,68,62,130
https://kawalpemilu.org#42041,"SRIMULYO, PIYUNGAN, BANTUL, DAERAH ISTIMEWA YOGYAKARTA",23,110,55,165
https://kawalpemilu.org#42041,"SRIMULYO, PIYUNGAN, BANTUL, DAERAH ISTIMEWA YOGYAKARTA",24,133,102,235
https://kawalpemilu.org#42041,"SRIMULYO, PIYUNGAN, BANTUL, DAERAH ISTIMEWA YOGYAKARTA",25,168,51,219
https://kawalpemilu.org#42041,"SRIMULYO, PIYUNGAN, BANTUL, DAERAH ISTIMEWA YOGYAKARTA",26,173,72,245
https://kawalpemilu.org#42041,"SRIMULYO, PIYUNGAN, BANTUL, DAERAH ISTIMEWA YOGYAKARTA",27,116,60,176
https://kawalpemilu.org#42041,"SRIMULYO, PIYUNGAN, BANTUL, DAERAH ISTIMEWA YOGYAKARTA",28,158,48,206
https://kawalpemilu.org#42041,"SRIMULYO, PIYUNGAN, BANTUL, DAERAH ISTIMEWA YOGYAKARTA",29,183,72,255
https://kawalpemilu.org#42041,"SRIMULYO, PIYUNGAN, BANTUL, DAERAH ISTIMEWA YOGYAKARTA",30,109,58,167
https://kawalpemilu.org#42041,"SRIMULYO, PIYUNGAN, BANTUL, DAERAH ISTIMEWA YOGYAKARTA",31,98,67,165
https://kawalpemilu.org#42041,"SRIMULYO, PIYUNGAN, BANTUL, DAERAH ISTIMEWA YOGYAKARTA",32,141,54,195
https://kawalpemilu.org#42041,"SRIMULYO, PIYUNGAN, BANTUL, DAERAH ISTIMEWA YOGYAKARTA",33,97,46,143
https://kawalpemilu.org#42041,"SRIMULYO, PIYUNGAN, BANTUL, DAERAH ISTIMEWA YOGYAKARTA",34,172,35,207
https://kawalpemilu.org#42041,"SRIMULYO, PIYUNGAN, BANTUL, DAERAH ISTIMEWA YOGYAKARTA",35,114,21,135
https://kawalpemilu.org#42041,"SRIMULYO, PIYUNGAN, BANTUL, DAERAH ISTIMEWA YOGYAKARTA",36,178,76,254
https://kawalpemilu.org#42041,"SRIMULYO, PIYUNGAN, BANTUL, DAERAH ISTIMEWA YOGYAKARTA",37,141,54,195
https://kawalpemilu.org#42041,"SRIMULYO, PIYUNGAN, BANTUL, DAERAH ISTIMEWA YOGYAKARTA",38,152,45,197
https://kawalpemilu.org#42041,"SRIMULYO, PIYUNGAN, BANTUL, DAERAH ISTIMEWA YOGYAKARTA",39,179,83,262
https://kawalpemilu.org#42041,"SRIMULYO, PIYUNGAN, BANTUL, DAERAH ISTIMEWA YOGYAKARTA",40,144,70,214
https://kawalpemilu.org#42041,"SRIMULYO, PIYUNGAN, BANTUL, DAERAH ISTIMEWA YOGYAKARTA",41,156,92,248
https://kawalpemilu.org#42041,"SRIMULYO, PIYUNGAN, BANTUL, DAERAH ISTIMEWA YOGYAKARTA",42,181,70,251
https://kawalpemilu.org#42041,"SRIMULYO, PIYUNGAN, BANTUL, DAERAH ISTIMEWA YOGYAKARTA",43,96,93,189
https://kawalpemilu.org#42041,"SRIMULYO, PIYUNGAN, BANTUL, DAERAH ISTIMEWA YOGYAKARTA",44,67,147,214
https://kawalpemilu.org#42041,"SRIMULYO, PIYUNGAN, BANTUL, DAERAH ISTIMEWA YOGYAKARTA",45,106,97,203
https://kawalpemilu.org#42041,"SRIMULYO, PIYUNGAN, BANTUL, DAERAH ISTIMEWA YOGYAKARTA",46,107,101,208
https://kawalpemilu.org#42041,"SRIMULYO, PIYUNGAN, BANTUL, DAERAH ISTIMEWA YOGYAKARTA",47,84,140,224
https://kawalpemilu.org#42041,"SRIMULYO, PIYUNGAN, BANTUL, DAERAH ISTIMEWA YOGYAKARTA",48,58,35,93
https://kawalpemilu.org#42041,"SRIMULYO, PIYUNGAN, BANTUL, DAERAH ISTIMEWA YOGYAKARTA",49,94,112,206
https://kawalpemilu.org#42041,"SRIMULYO, PIYUNGAN, BANTUL, DAERAH ISTIMEWA YOGYAKARTA",50,103,71,174
https://kawalpemilu.org#42041,"SRIMULYO, PIYUNGAN, BANTUL, DAERAH ISTIMEWA YOGYAKARTA",51,165,17,182
https://kawalpemilu.org#42041,"SRIMULYO, PIYUNGAN, BANTUL, DAERAH ISTIMEWA YOGYAKARTA",52,142,29,171
https://kawalpemilu.org#42041,"SRIMULYO, PIYUNGAN, BANTUL, DAERAH ISTIMEWA YOGYAKARTA",53,148,65,213
https://kawalpemilu.org#42041,"SRIMULYO, PIYUNGAN, BANTUL, DAERAH ISTIMEWA YOGYAKARTA",54,184,32,216
https://kawalpemilu.org#42041,"SRIMULYO, PIYUNGAN, BANTUL, DAERAH ISTIMEWA YOGYAKARTA",55,147,78,225
https://kawalpemilu.org#42041,"SRIMULYO, PIYUNGAN, BANTUL, DAERAH ISTIMEWA YOGYAKARTA",56,167,90,257
https://kawalpemilu.org#42041,"SRIMULYO, PIYUNGAN, BANTUL, DAERAH ISTIMEWA YOGYAKARTA",57,189,58,247
https://kawalpemilu.org#42041,"SRIMULYO, PIYUNGAN, BANTUL, DAERAH ISTIMEWA YOGYAKARTA",58,146,52,198
https://kawalpemilu.org#42041,"SRIMULYO, PIYUNGAN, BANTUL, DAERAH ISTIMEWA YOGYAKARTA",59,123,43,166
https://kawalpemilu.org#42042,"SRIMARTANI, PIYUNGAN, BANTUL, DAERAH ISTIMEWA YOGYAKARTA",1,126,71,197
https://kawalpemilu.org#42042,"SRIMARTANI, PIYUNGAN, BANTUL, DAERAH ISTIMEWA YOGYAKARTA",2,155,78,233
https://kawalpemilu.org#42042,"SRIMARTANI, PIYUNGAN, BANTUL, DAERAH ISTIMEWA YOGYAKARTA",3,146,36,182
https://kawalpemilu.org#42042,"SRIMARTANI, PIYUNGAN, BANTUL, DAERAH ISTIMEWA YOGYAKARTA",4,163,95,258
https://kawalpemilu.org#42042,"SRIMARTANI, PIYUNGAN, BANTUL, DAERAH ISTIMEWA YOGYAKARTA",5,89,98,187
https://kawalpemilu.org#42042,"SRIMARTANI, PIYUNGAN, BANTUL, DAERAH ISTIMEWA YOGYAKARTA",6,138,83,221
https://kawalpemilu.org#42042,"SRIMARTANI, PIYUNGAN, BANTUL, DAERAH ISTIMEWA YOGYAKARTA",7,162,98,260
https://kawalpemilu.org#42042,"SRIMARTANI, PIYUNGAN, BANTUL, DAERAH ISTIMEWA YOGYAKARTA",8,146,123,268
https://kawalpemilu.org#42042,"SRIMARTANI, PIYUNGAN, BANTUL, DAERAH ISTIMEWA YOGYAKARTA",9,195,98,293
https://kawalpemilu.org#42042,"SRIMARTANI, PIYUNGAN, BANTUL, DAERAH ISTIMEWA YOGYAKARTA",10,101,124,225
https://kawalpemilu.org#42042,"SRIMARTANI, PIYUNGAN, BANTUL, DAERAH ISTIMEWA YOGYAKARTA",11,158,35,193
https://kawalpemilu.org#42042,"SRIMARTANI, PIYUNGAN, BANTUL, DAERAH ISTIMEWA YOGYAKARTA",12,103,34,137
https://kawalpemilu.org#42042,"SRIMARTANI, PIYUNGAN, BANTUL, DAERAH ISTIMEWA YOGYAKARTA",13,172,92,264
https://kawalpemilu.org#42042,"SRIMARTANI, PIYUNGAN, BANTUL, DAERAH ISTIMEWA YOGYAKARTA",14,197,67,264
https://kawalpemilu.org#42042,"SRIMARTANI, PIYUNGAN, BANTUL, DAERAH ISTIMEWA YOGYAKARTA",15,124,50,174
https://kawalpemilu.org#42042,"SRIMARTANI, PIYUNGAN, BANTUL, DAERAH ISTIMEWA YOGYAKARTA",16,153,85,238
https://kawalpemilu.org#42042,"SRIMARTANI, PIYUNGAN, BANTUL, DAERAH ISTIMEWA YOGYAKARTA",17,81,47,128
https://kawalpemilu.org#42042,"SRIMARTANI, PIYUNGAN, BANTUL, DAERAH ISTIMEWA YOGYAKARTA",18,173,60,233
https://kawalpemilu.org#42042,"SRIMARTANI, PIYUNGAN, BANTUL, DAERAH ISTIMEWA YOGYAKARTA",19,105,50,155
https://kawalpemilu.org#42042,"SRIMARTANI, PIYUNGAN, BANTUL, DAERAH ISTIMEWA YOGYAKARTA",20,126,61,187
https://kawalpemilu.org#42042,"SRIMARTANI, PIYUNGAN, BANTUL, DAERAH ISTIMEWA YOGYAKARTA",21,104,56,160
https://kawalpemilu.org#42042,"SRIMARTANI, PIYUNGAN, BANTUL, DAERAH ISTIMEWA YOGYAKARTA",22,186,51,237
https://kawalpemilu.org#42042,"SRIMARTANI, PIYUNGAN, BANTUL, DAERAH ISTIMEWA YOGYAKARTA",23,177,67,244
https://kawalpemilu.org#42042,"SRIMARTANI, PIYUNGAN, BANTUL, DAERAH ISTIMEWA YOGYAKARTA",24,149,87,236
https://kawalpemilu.org#42042,"SRIMARTANI, PIYUNGAN, BANTUL, DAERAH ISTIMEWA YOGYAKARTA",25,177,54,231
https://kawalpemilu.org#42042,"SRIMARTANI, PIYUNGAN, BANTUL, DAERAH ISTIMEWA YOGYAKARTA",26,192,21,213
https://kawalpemilu.org#42042,"SRIMARTANI, PIYUNGAN, BANTUL, DAERAH ISTIMEWA YOGYAKARTA",27,145,37,182
https://kawalpemilu.org#42042,"SRIMARTANI, PIYUNGAN, BANTUL, DAERAH ISTIMEWA YOGYAKARTA",28,134,42,176
https://kawalpemilu.org#42042,"SRIMARTANI, PIYUNGAN, BANTUL, DAERAH ISTIMEWA YOGYAKARTA",29,206,35,241
https://kawalpemilu.org#42042,"SRIMARTANI, PIYUNGAN, BANTUL, DAERAH ISTIMEWA YOGYAKARTA",30,164,29,193
https://kawalpemilu.org#42042,"SRIMARTANI, PIYUNGAN, BANTUL, DAERAH ISTIMEWA YOGYAKARTA",31,125,92,217
https://kawalpemilu.org#42042,"SRIMARTANI, PIYUNGAN, BANTUL, DAERAH ISTIMEWA YOGYAKARTA",32,126,29,155
https://kawalpemilu.org#42042,"SRIMARTANI, PIYUNGAN, BANTUL, DAERAH ISTIMEWA YOGYAKARTA",33,179,35,214
https://kawalpemilu.org#42042,"SRIMARTANI, PIYUNGAN, BANTUL, DAERAH ISTIMEWA YOGYAKARTA",34,135,31,166
https://kawalpemilu.org#42042,"SRIMARTANI, PIYUNGAN, BANTUL, DAERAH ISTIMEWA YOGYAKARTA",35,82,117,199
https://kawalpemilu.org#42042,"SRIMARTANI, PIYUNGAN, BANTUL, DAERAH ISTIMEWA YOGYAKARTA",36,173,65,238
https://kawalpemilu.org#42042,"SRIMARTANI, PIYUNGAN, BANTUL, DAERAH ISTIMEWA YOGYAKARTA",37,211,58,269
https://kawalpemilu.org#42042,"SRIMARTANI, PIYUNGAN, BANTUL, DAERAH ISTIMEWA YOGYAKARTA",38,145,22,167
https://kawalpemilu.org#42042,"SRIMARTANI, PIYUNGAN, BANTUL, DAERAH ISTIMEWA YOGYAKARTA",39,206,39,245
https://kawalpemilu.org#42042,"SRIMARTANI, PIYUNGAN, BANTUL, DAERAH ISTIMEWA YOGYAKARTA",40,231,38,269
https://kawalpemilu.org#42042,"SRIMARTANI, PIYUNGAN, BANTUL, DAERAH ISTIMEWA YOGYAKARTA",41,179,20,199
https://kawalpemilu.org#42042,"SRIMARTANI, PIYUNGAN, BANTUL, DAERAH ISTIMEWA YOGYAKARTA",42,222,16,238
https://kawalpemilu.org#42042,"SRIMARTANI, PIYUNGAN, BANTUL, DAERAH ISTIMEWA YOGYAKARTA",43,189,33,222
https://kawalpemilu.org#42042,"SRIMARTANI, PIYUNGAN, BANTUL, DAERAH ISTIMEWA YOGYAKARTA",44,180,37,217
https://kawalpemilu.org#42042,"SRIMARTANI, PIYUNGAN, BANTUL, DAERAH ISTIMEWA YOGYAKARTA",45,146,28,174
https://kawalpemilu.org#42042,"SRIMARTANI, PIYUNGAN, BANTUL, DAERAH ISTIMEWA YOGYAKARTA",46,149,43,192
https://kawalpemilu.org#42042,"SRIMARTANI, PIYUNGAN, BANTUL, DAERAH ISTIMEWA YOGYAKARTA",47,126,23,149
https://kawalpemilu.org#42042,"SRIMARTANI, PIYUNGAN, BANTUL, DAERAH ISTIMEWA YOGYAKARTA",48,96,12,108
https://kawalpemilu.org#42042,"SRIMARTANI, PIYUNGAN, BANTUL, DAERAH ISTIMEWA YOGYAKARTA",49,201,13,214
https://kawalpemilu.org#42042,"SRIMARTANI, PIYUNGAN, BANTUL, DAERAH ISTIMEWA YOGYAKARTA",50,127,56,183
https://kawalpemilu.org#42042,"SRIMARTANI, PIYUNGAN, BANTUL, DAERAH ISTIMEWA YOGYAKARTA",51,168,25,193
https://kawalpemilu.org#42042,"SRIMARTANI, PIYUNGAN, BANTUL, DAERAH ISTIMEWA YOGYAKARTA",52,122,33,155
https://kawalpemilu.org#42042,"SRIMARTANI, PIYUNGAN, BANTUL, DAERAH ISTIMEWA YOGYAKARTA",53,140,22,162
https://kawalpemilu.org#42044,"PENDOWOHARJO, SEWON, BANTUL, DAERAH ISTIMEWA YOGYAKARTA",1,158,74,232
https://kawalpemilu.org#42044,"PENDOWOHARJO, SEWON, BANTUL, DAERAH ISTIMEWA YOGYAKARTA",2,124,87,211
https://kawalpemilu.org#42044,"PENDOWOHARJO, SEWON, BANTUL, DAERAH ISTIMEWA YOGYAKARTA",3,104,77,181
https://kawalpemilu.org#42044,"PENDOWOHARJO, SEWON, BANTUL, DAERAH ISTIMEWA YOGYAKARTA",4,117,59,176
https://kawalpemilu.org#42044,"PENDOWOHARJO, SEWON, BANTUL, DAERAH ISTIMEWA YOGYAKARTA",5,156,59,215
https://kawalpemilu.org#42044,"PENDOWOHARJO, SEWON, BANTUL, DAERAH ISTIMEWA YOGYAKARTA",6,117,52,169
https://kawalpemilu.org#42044,"PENDOWOHARJO, SEWON, BANTUL, DAERAH ISTIMEWA YOGYAKARTA",7,194,73,267
https://kawalpemilu.org#42044,"PENDOWOHARJO, SEWON, BANTUL, DAERAH ISTIMEWA YOGYAKARTA",8,202,81,283
https://kawalpemilu.org#42044,"PENDOWOHARJO, SEWON, BANTUL, DAERAH ISTIMEWA YOGYAKARTA",9,139,123,262
https://kawalpemilu.org#42044,"PENDOWOHARJO, SEWON, BANTUL, DAERAH ISTIMEWA YOGYAKARTA",10,170,75,245
https://kawalpemilu.org#42044,"PENDOWOHARJO, SEWON, BANTUL, DAERAH ISTIMEWA YOGYAKARTA",11,144,82,226
https://kawalpemilu.org#42044,"PENDOWOHARJO, SEWON, BANTUL, DAERAH ISTIMEWA YOGYAKARTA",12,150,100,250
https://kawalpemilu.org#42044,"PENDOWOHARJO, SEWON, BANTUL, DAERAH ISTIMEWA YOGYAKARTA",13,127,93,220
https://kawalpemilu.org#42044,"PENDOWOHARJO, SEWON, BANTUL, DAERAH ISTIMEWA YOGYAKARTA",14,146,104,250
https://kawalpemilu.org#42044,"PENDOWOHARJO, SEWON, BANTUL, DAERAH ISTIMEWA YOGYAKARTA",15,190,62,252
https://kawalpemilu.org#42044,"PENDOWOHARJO, SEWON, BANTUL, DAERAH ISTIMEWA YOGYAKARTA",16,182,40,222
https://kawalpemilu.org#42044,"PENDOWOHARJO, SEWON, BANTUL, DAERAH ISTIMEWA YOGYAKARTA",17,194,74,268
https://kawalpemilu.org#42044,"PENDOWOHARJO, SEWON, BANTUL, DAERAH ISTIMEWA YOGYAKARTA",18,185,61,246
https://kawalpemilu.org#42044,"PENDOWOHARJO, SEWON, BANTUL, DAERAH ISTIMEWA YOGYAKARTA",19,165,61,226
https://kawalpemilu.org#42044,"PENDOWOHARJO, SEWON, BANTUL, DAERAH ISTIMEWA YOGYAKARTA",20,119,57,176
https://kawalpemilu.org#42044,"PENDOWOHARJO, SEWON, BANTUL, DAERAH ISTIMEWA YOGYAKARTA",21,141,52,193
https://kawalpemilu.org#42044,"PENDOWOHARJO, SEWON, BANTUL, DAERAH ISTIMEWA YOGYAKARTA",22,137,78,215
https://kawalpemilu.org#42044,"PENDOWOHARJO, SEWON, BANTUL, DAERAH ISTIMEWA YOGYAKARTA",23,143,48,191
https://kawalpemilu.org#42044,"PENDOWOHARJO, SEWON, BANTUL, DAERAH ISTIMEWA YOGYAKARTA",24,136,58,194
https://kawalpemilu.org#42044,"PENDOWOHARJO, SEWON, BANTUL, DAERAH ISTIMEWA YOGYAKARTA",25,149,86,235
https://kawalpemilu.org#42044,"PENDOWOHARJO, SEWON, BANTUL, DAERAH ISTIMEWA YOGYAKARTA",26,107,110,117
https://kawalpemilu.org#42044,"PENDOWOHARJO, SEWON, BANTUL, DAERAH ISTIMEWA YOGYAKARTA",27,117,101,218
https://kawalpemilu.org#42044,"PENDOWOHARJO, SEWON, BANTUL, DAERAH ISTIMEWA YOGYAKARTA",28,119,63,182
https://kawalpemilu.org#42044,"PENDOWOHARJO, SEWON, BANTUL, DAERAH ISTIMEWA YOGYAKARTA",29,155,51,206
https://kawalpemilu.org#42044,"PENDOWOHARJO, SEWON, BANTUL, DAERAH ISTIMEWA YOGYAKARTA",30,147,52,199
https://kawalpemilu.org#42044,"PENDOWOHARJO, SEWON, BANTUL, DAERAH ISTIMEWA YOGYAKARTA",31,142,47,189
https://kawalpemilu.org#42044,"PENDOWOHARJO, SEWON, BANTUL, DAERAH ISTIMEWA YOGYAKARTA",32,166,84,250
https://kawalpemilu.org#42044,"PENDOWOHARJO, SEWON, BANTUL, DAERAH ISTIMEWA YOGYAKARTA",33,147,75,222
https://kawalpemilu.org#42044,"PENDOWOHARJO, SEWON, BANTUL, DAERAH ISTIMEWA YOGYAKARTA",34,126,95,221
https://kawalpemilu.org#42044,"PENDOWOHARJO, SEWON, BANTUL, DAERAH ISTIMEWA YOGYAKARTA",35,185,59,244
https://kawalpemilu.org#42044,"PENDOWOHARJO, SEWON, BANTUL, DAERAH ISTIMEWA YOGYAKARTA",36,195,54,249
https://kawalpemilu.org#42044,"PENDOWOHARJO, SEWON, BANTUL, DAERAH ISTIMEWA YOGYAKARTA",37,205,37,242
https://kawalpemilu.org#42044,"PENDOWOHARJO, SEWON, BANTUL, DAERAH ISTIMEWA YOGYAKARTA",38,131,37,168
https://kawalpemilu.org#42044,"PENDOWOHARJO, SEWON, BANTUL, DAERAH ISTIMEWA YOGYAKARTA",39,122,94,216
https://kawalpemilu.org#42044,"PENDOWOHARJO, SEWON, BANTUL, DAERAH ISTIMEWA YOGYAKARTA",40,128,91,219
https://kawalpemilu.org#42044,"PENDOWOHARJO, SEWON, BANTUL, DAERAH ISTIMEWA YOGYAKARTA",41,173,92,265
https://kawalpemilu.org#42044,"PENDOWOHARJO, SEWON, BANTUL, DAERAH ISTIMEWA YOGYAKARTA",42,116,101,217
https://kawalpemilu.org#42044,"PENDOWOHARJO, SEWON, BANTUL, DAERAH ISTIMEWA YOGYAKARTA",43,90,61,151
https://kawalpemilu.org#42044,"PENDOWOHARJO, SEWON, BANTUL, DAERAH ISTIMEWA YOGYAKARTA",44,162,86,248
https://kawalpemilu.org#42044,"PENDOWOHARJO, SEWON, BANTUL, DAERAH ISTIMEWA YOGYAKARTA",45,135,102,237
https://kawalpemilu.org#42044,"PENDOWOHARJO, SEWON, BANTUL, DAERAH ISTIMEWA YOGYAKARTA",46,164,89,253
https://kawalpemilu.org#42044,"PENDOWOHARJO, SEWON, BANTUL, DAERAH ISTIMEWA YOGYAKARTA",47,159,102,261
https://kawalpemilu.org#42044,"PENDOWOHARJO, SEWON, BANTUL, DAERAH ISTIMEWA YOGYAKARTA",48,139,90,229
https://kawalpemilu.org#42044,"PENDOWOHARJO, SEWON, BANTUL, DAERAH ISTIMEWA YOGYAKARTA",49,113,114,227
https://kawalpemilu.org#42044,"PENDOWOHARJO, SEWON, BANTUL, DAERAH ISTIMEWA YOGYAKARTA",50,94,103,0
https://kawalpemilu.org#42044,"PENDOWOHARJO, SEWON, BANTUL, DAERAH ISTIMEWA YOGYAKARTA",51,113,114,227
https://kawalpemilu.org#42044,"PENDOWOHARJO, SEWON, BANTUL, DAERAH ISTIMEWA YOGYAKARTA",52,152,109,261
https://kawalpemilu.org#42044,"PENDOWOHARJO, SEWON, BANTUL, DAERAH ISTIMEWA YOGYAKARTA",53,123,113,236
https://kawalpemilu.org#42044,"PENDOWOHARJO, SEWON, BANTUL, DAERAH ISTIMEWA YOGYAKARTA",54,119,65,184
https://kawalpemilu.org#42044,"PENDOWOHARJO, SEWON, BANTUL, DAERAH ISTIMEWA YOGYAKARTA",55,101,107,208
https://kawalpemilu.org#42044,"PENDOWOHARJO, SEWON, BANTUL, DAERAH ISTIMEWA YOGYAKARTA",56,96,162,258
https://kawalpemilu.org#42044,"PENDOWOHARJO, SEWON, BANTUL, DAERAH ISTIMEWA YOGYAKARTA",57,158,113,271
https://kawalpemilu.org#42044,"PENDOWOHARJO, SEWON, BANTUL, DAERAH ISTIMEWA YOGYAKARTA",58,184,87,271
https://kawalpemilu.org#42044,"PENDOWOHARJO, SEWON, BANTUL, DAERAH ISTIMEWA YOGYAKARTA",59,137,71,208
https://kawalpemilu.org#42044,"PENDOWOHARJO, SEWON, BANTUL, DAERAH ISTIMEWA YOGYAKARTA",60,136,80,216
https://kawalpemilu.org#42044,"PENDOWOHARJO, SEWON, BANTUL, DAERAH ISTIMEWA YOGYAKARTA",61,153,78,231
https://kawalpemilu.org#42044,"PENDOWOHARJO, SEWON, BANTUL, DAERAH ISTIMEWA YOGYAKARTA",62,138,94,232
https://kawalpemilu.org#42044,"PENDOWOHARJO, SEWON, BANTUL, DAERAH ISTIMEWA YOGYAKARTA",63,137,120,257
https://kawalpemilu.org#42044,"PENDOWOHARJO, SEWON, BANTUL, DAERAH ISTIMEWA YOGYAKARTA",64,128,90,218
https://kawalpemilu.org#42044,"PENDOWOHARJO, SEWON, BANTUL, DAERAH ISTIMEWA YOGYAKARTA",65,151,86,237
https://kawalpemilu.org#42044,"PENDOWOHARJO, SEWON, BANTUL, DAERAH ISTIMEWA YOGYAKARTA",66,98,99,197
https://kawalpemilu.org#42045,"TIMBULHARJO, SEWON, BANTUL, DAERAH ISTIMEWA YOGYAKARTA",1,174,49,223
https://kawalpemilu.org#42045,"TIMBULHARJO, SEWON, BANTUL, DAERAH ISTIMEWA YOGYAKARTA",2,200,48,248
https://kawalpemilu.org#42045,"TIMBULHARJO, SEWON, BANTUL, DAERAH ISTIMEWA YOGYAKARTA",3,206,38,244
https://kawalpemilu.org#42045,"TIMBULHARJO, SEWON, BANTUL, DAERAH ISTIMEWA YOGYAKARTA",4,200,69,269
https://kawalpemilu.org#42045,"TIMBULHARJO, SEWON, BANTUL, DAERAH ISTIMEWA YOGYAKARTA",5,118,48,166
https://kawalpemilu.org#42045,"TIMBULHARJO, SEWON, BANTUL, DAERAH ISTIMEWA YOGYAKARTA",6,150,99,249
https://kawalpemilu.org#42045,"TIMBULHARJO, SEWON, BANTUL, DAERAH ISTIMEWA YOGYAKARTA",7,141,79,220
https://kawalpemilu.org#42045,"TIMBULHARJO, SEWON, BANTUL, DAERAH ISTIMEWA YOGYAKARTA",8,134,70,204
https://kawalpemilu.org#42045,"TIMBULHARJO, SEWON, BANTUL, DAERAH ISTIMEWA YOGYAKARTA",9,136,76,212
https://kawalpemilu.org#42045,"TIMBULHARJO, SEWON, BANTUL, DAERAH ISTIMEWA YOGYAKARTA",10,173,61,234
https://kawalpemilu.org#42045,"TIMBULHARJO, SEWON, BANTUL, DAERAH ISTIMEWA YOGYAKARTA",11,114,32,146
https://kawalpemilu.org#42045,"TIMBULHARJO, SEWON, BANTUL, DAERAH ISTIMEWA YOGYAKARTA",12,218,74,292
https://kawalpemilu.org#42045,"TIMBULHARJO, SEWON, BANTUL, DAERAH ISTIMEWA YOGYAKARTA",13,160,61,221
https://kawalpemilu.org#42045,"TIMBULHARJO, SEWON, BANTUL, DAERAH ISTIMEWA YOGYAKARTA",14,117,45,162
https://kawalpemilu.org#42045,"TIMBULHARJO, SEWON, BANTUL, DAERAH ISTIMEWA YOGYAKARTA",15,199,40,239
https://kawalpemilu.org#42045,"TIMBULHARJO, SEWON, BANTUL, DAERAH ISTIMEWA YOGYAKARTA",16,197,48,245
https://kawalpemilu.org#42045,"TIMBULHARJO, SEWON, BANTUL, DAERAH ISTIMEWA YOGYAKARTA",17,194,68,262
https://kawalpemilu.org#42045,"TIMBULHARJO, SEWON, BANTUL, DAERAH ISTIMEWA YOGYAKARTA",18,226,43,269
https://kawalpemilu.org#42045,"TIMBULHARJO, SEWON, BANTUL, DAERAH ISTIMEWA YOGYAKARTA",19,145,53,198
https://kawalpemilu.org#42045,"TIMBULHARJO, SEWON, BANTUL, DAERAH ISTIMEWA YOGYAKARTA",20,154,98,252
https://kawalpemilu.org#42045,"TIMBULHARJO, SEWON, BANTUL, DAERAH ISTIMEWA YOGYAKARTA",21,195,56,251
https://kawalpemilu.org#42045,"TIMBULHARJO, SEWON, BANTUL, DAERAH ISTIMEWA YOGYAKARTA",22,101,45,146
https://kawalpemilu.org#42045,"TIMBULHARJO, SEWON, BANTUL, DAERAH ISTIMEWA YOGYAKARTA",23,203,35,238
https://kawalpemilu.org#42045,"TIMBULHARJO, SEWON, BANTUL, DAERAH ISTIMEWA YOGYAKARTA",24,187,76,263
https://kawalpemilu.org#42045,"TIMBULHARJO, SEWON, BANTUL, DAERAH ISTIMEWA YOGYAKARTA",25,134,52,186
https://kawalpemilu.org#42045,"TIMBULHARJO, SEWON, BANTUL, DAERAH ISTIMEWA YOGYAKARTA",26,136,74,210
https://kawalpemilu.org#42045,"TIMBULHARJO, SEWON, BANTUL, DAERAH ISTIMEWA YOGYAKARTA",27,166,45,211
https://kawalpemilu.org#42045,"TIMBULHARJO, SEWON, BANTUL, DAERAH ISTIMEWA YOGYAKARTA",28,179,33,212
https://kawalpemilu.org#42045,"TIMBULHARJO, SEWON, BANTUL, DAERAH ISTIMEWA YOGYAKARTA",29,200,54,254
https://kawalpemilu.org#42045,"TIMBULHARJO, SEWON, BANTUL, DAERAH ISTIMEWA YOGYAKARTA",30,160,67,227
https://kawalpemilu.org#42045,"TIMBULHARJO, SEWON, BANTUL, DAERAH ISTIMEWA YOGYAKARTA",31,117,106,223
https://kawalpemilu.org#42045,"TIMBULHARJO, SEWON, BANTUL, DAERAH ISTIMEWA YOGYAKARTA",32,152,73,225
https://kawalpemilu.org#42045,"TIMBULHARJO, SEWON, BANTUL, DAERAH ISTIMEWA YOGYAKARTA",33,185,50,235
https://kawalpemilu.org#42045,"TIMBULHARJO, SEWON, BANTUL, DAERAH ISTIMEWA YOGYAKARTA",34,153,49,202
https://kawalpemilu.org#42045,"TIMBULHARJO, SEWON, BANTUL, DAERAH ISTIMEWA YOGYAKARTA",35,126,39,165
https://kawalpemilu.org#42045,"TIMBULHARJO, SEWON, BANTUL, DAERAH ISTIMEWA YOGYAKARTA",36,121,38,159
https://kawalpemilu.org#42045,"TIMBULHARJO, SEWON, BANTUL, DAERAH ISTIMEWA YOGYAKARTA",37,189,33,222
https://kawalpemilu.org#42045,"TIMBULHARJO, SEWON, BANTUL, DAERAH ISTIMEWA YOGYAKARTA",38,189,35,224
https://kawalpemilu.org#42045,"TIMBULHARJO, SEWON, BANTUL, DAERAH ISTIMEWA YOGYAKARTA",39,188,53,241
https://kawalpemilu.org#42045,"TIMBULHARJO, SEWON, BANTUL, DAERAH ISTIMEWA YOGYAKARTA",40,170,103,273
https://kawalpemilu.org#42045,"TIMBULHARJO, SEWON, BANTUL, DAERAH ISTIMEWA YOGYAKARTA",41,181,62,243
https://kawalpemilu.org#42045,"TIMBULHARJO, SEWON, BANTUL, DAERAH ISTIMEWA YOGYAKARTA",42,164,23,187
https://kawalpemilu.org#42045,"TIMBULHARJO, SEWON, BANTUL, DAERAH ISTIMEWA YOGYAKARTA",43,152,53,205
https://kawalpemilu.org#42045,"TIMBULHARJO, SEWON, BANTUL, DAERAH ISTIMEWA YOGYAKARTA",44,123,63,186
https://kawalpemilu.org#42045,"TIMBULHARJO, SEWON, BANTUL, DAERAH ISTIMEWA YOGYAKARTA",45,119,89,208
https://kawalpemilu.org#42045,"TIMBULHARJO, SEWON, BANTUL, DAERAH ISTIMEWA YOGYAKARTA",46,182,85,267
https://kawalpemilu.org#42045,"TIMBULHARJO, SEWON, BANTUL, DAERAH ISTIMEWA YOGYAKARTA",47,110,88,198
https://kawalpemilu.org#42045,"TIMBULHARJO, SEWON, BANTUL, DAERAH ISTIMEWA YOGYAKARTA",48,113,55,168
https://kawalpemilu.org#42045,"TIMBULHARJO, SEWON, BANTUL, DAERAH ISTIMEWA YOGYAKARTA",49,214,70,284
https://kawalpemilu.org#42045,"TIMBULHARJO, SEWON, BANTUL, DAERAH ISTIMEWA YOGYAKARTA",50,246,34,280
https://kawalpemilu.org#42045,"TIMBULHARJO, SEWON, BANTUL, DAERAH ISTIMEWA YOGYAKARTA",51,193,70,263
https://kawalpemilu.org#42045,"TIMBULHARJO, SEWON, BANTUL, DAERAH ISTIMEWA YOGYAKARTA",52,161,74,235
https://kawalpemilu.org#42045,"TIMBULHARJO, SEWON, BANTUL, DAERAH ISTIMEWA YOGYAKARTA",53,123,40,163
https://kawalpemilu.org#42045,"TIMBULHARJO, SEWON, BANTUL, DAERAH ISTIMEWA YOGYAKARTA",54,161,80,241
https://kawalpemilu.org#42045,"TIMBULHARJO, SEWON, BANTUL, DAERAH ISTIMEWA YOGYAKARTA",55,169,85,254
https://kawalpemilu.org#42045,"TIMBULHARJO, SEWON, BANTUL, DAERAH ISTIMEWA YOGYAKARTA",56,187,92,279
https://kawalpemilu.org#42045,"TIMBULHARJO, SEWON, BANTUL, DAERAH ISTIMEWA YOGYAKARTA",57,179,64,4
https://kawalpemilu.org#42045,"TIMBULHARJO, SEWON, BANTUL, DAERAH ISTIMEWA YOGYAKARTA",58,182,92,274
https://kawalpemilu.org#42045,"TIMBULHARJO, SEWON, BANTUL, DAERAH ISTIMEWA YOGYAKARTA",59,176,51,227
https://kawalpemilu.org#42045,"TIMBULHARJO, SEWON, BANTUL, DAERAH ISTIMEWA YOGYAKARTA",60,118,38,156
https://kawalpemilu.org#42045,"TIMBULHARJO, SEWON, BANTUL, DAERAH ISTIMEWA YOGYAKARTA",61,180,69,249
https://kawalpemilu.org#42045,"TIMBULHARJO, SEWON, BANTUL, DAERAH ISTIMEWA YOGYAKARTA",62,159,55,214
https://kawalpemilu.org#42045,"TIMBULHARJO, SEWON, BANTUL, DAERAH ISTIMEWA YOGYAKARTA",63,180,56,236
https://kawalpemilu.org#42045,"TIMBULHARJO, SEWON, BANTUL, DAERAH ISTIMEWA YOGYAKARTA",64,105,102,207
https://kawalpemilu.org#42045,"TIMBULHARJO, SEWON, BANTUL, DAERAH ISTIMEWA YOGYAKARTA",65,189,58,247
https://kawalpemilu.org#42045,"TIMBULHARJO, SEWON, BANTUL, DAERAH ISTIMEWA YOGYAKARTA",66,179,36,215
https://kawalpemilu.org#42045,"TIMBULHARJO, SEWON, BANTUL, DAERAH ISTIMEWA YOGYAKARTA",67,130,86,216
https://kawalpemilu.org#42045,"TIMBULHARJO, SEWON, BANTUL, DAERAH ISTIMEWA YOGYAKARTA",68,179,58,237
https://kawalpemilu.org#42046,"BANGUNHARJO, SEWON, BANTUL, DAERAH ISTIMEWA YOGYAKARTA",1,143,53,196
https://kawalpemilu.org#42046,"BANGUNHARJO, SEWON, BANTUL, DAERAH ISTIMEWA YOGYAKARTA",2,159,55,214
https://kawalpemilu.org#42046,"BANGUNHARJO, SEWON, BANTUL, DAERAH ISTIMEWA YOGYAKARTA",3,184,90,274
https://kawalpemilu.org#42046,"BANGUNHARJO, SEWON, BANTUL, DAERAH ISTIMEWA YOGYAKARTA",4,62,172,234
https://kawalpemilu.org#42046,"BANGUNHARJO, SEWON, BANTUL, DAERAH ISTIMEWA YOGYAKARTA",5,86,149,235
https://kawalpemilu.org#42046,"BANGUNHARJO, SEWON, BANTUL, DAERAH ISTIMEWA YOGYAKARTA",6,59,110,169
https://kawalpemilu.org#42046,"BANGUNHARJO, SEWON, BANTUL, DAERAH ISTIMEWA YOGYAKARTA",7,72,153,225
https://kawalpemilu.org#42046,"BANGUNHARJO, SEWON, BANTUL, DAERAH ISTIMEWA YOGYAKARTA",8,195,74,269
https://kawalpemilu.org#42046,"BANGUNHARJO, SEWON, BANTUL, DAERAH ISTIMEWA YOGYAKARTA",9,84,107,191
https://kawalpemilu.org#42046,"BANGUNHARJO, SEWON, BANTUL, DAERAH ISTIMEWA YOGYAKARTA",10,146,89,235
https://kawalpemilu.org#42046,"BANGUNHARJO, SEWON, BANTUL, DAERAH ISTIMEWA YOGYAKARTA",11,154,116,270
https://kawalpemilu.org#42046,"BANGUNHARJO, SEWON, BANTUL, DAERAH ISTIMEWA YOGYAKARTA",12,162,113,275
https://kawalpemilu.org#42046,"BANGUNHARJO, SEWON, BANTUL, DAERAH ISTIMEWA YOGYAKARTA",13,119,164,283
https://kawalpemilu.org#42046,"BANGUNHARJO, SEWON, BANTUL, DAERAH ISTIMEWA YOGYAKARTA",14,87,113,200
https://kawalpemilu.org#42046,"BANGUNHARJO, SEWON, BANTUL, DAERAH ISTIMEWA YOGYAKARTA",15,130,90,220
https://kawalpemilu.org#42046,"BANGUNHARJO, SEWON, BANTUL, DAERAH ISTIMEWA YOGYAKARTA",16,122,93,215
https://kawalpemilu.org#42046,"BANGUNHARJO, SEWON, BANTUL, DAERAH ISTIMEWA YOGYAKARTA",17,167,88,255
https://kawalpemilu.org#42046,"BANGUNHARJO, SEWON, BANTUL, DAERAH ISTIMEWA YOGYAKARTA",18,132,109,241
https://kawalpemilu.org#42046,"BANGUNHARJO, SEWON, BANTUL, DAERAH ISTIMEWA YOGYAKARTA",19,134,73,207
https://kawalpemilu.org#42046,"BANGUNHARJO, SEWON, BANTUL, DAERAH ISTIMEWA YOGYAKARTA",20,115,57,172
https://kawalpemilu.org#42046,"BANGUNHARJO, SEWON, BANTUL, DAERAH ISTIMEWA YOGYAKARTA",21,131,67,198
https://kawalpemilu.org#42046,"BANGUNHARJO, SEWON, BANTUL, DAERAH ISTIMEWA YOGYAKARTA",22,148,69,217
https://kawalpemilu.org#42046,"BANGUNHARJO, SEWON, BANTUL, DAERAH ISTIMEWA YOGYAKARTA",23,166,91,257
https://kawalpemilu.org#42046,"BANGUNHARJO, SEWON, BANTUL, DAERAH ISTIMEWA YOGYAKARTA",24,194,58,252
https://kawalpemilu.org#42046,"BANGUNHARJO, SEWON, BANTUL, DAERAH ISTIMEWA YOGYAKARTA",25,210,68,278
https://kawalpemilu.org#42046,"BANGUNHARJO, SEWON, BANTUL, DAERAH ISTIMEWA YOGYAKARTA",26,131,73,204
https://kawalpemilu.org#42046,"BANGUNHARJO, SEWON, BANTUL, DAERAH ISTIMEWA YOGYAKARTA",27,180,75,255
https://kawalpemilu.org#42046,"BANGUNHARJO, SEWON, BANTUL, DAERAH ISTIMEWA YOGYAKARTA",28,171,62,233
https://kawalpemilu.org#42046,"BANGUNHARJO, SEWON, BANTUL, DAERAH ISTIMEWA YOGYAKARTA",29,152,54,206
https://kawalpemilu.org#42046,"BANGUNHARJO, SEWON, BANTUL, DAERAH ISTIMEWA YOGYAKARTA",30,194,66,260
https://kawalpemilu.org#42046,"BANGUNHARJO, SEWON, BANTUL, DAERAH ISTIMEWA YOGYAKARTA",31,159,80,239
https://kawalpemilu.org#42046,"BANGUNHARJO, SEWON, BANTUL, DAERAH ISTIMEWA YOGYAKARTA",32,176,65,241
https://kawalpemilu.org#42046,"BANGUNHARJO, SEWON, BANTUL, DAERAH ISTIMEWA YOGYAKARTA",33,163,73,236
https://kawalpemilu.org#42046,"BANGUNHARJO, SEWON, BANTUL, DAERAH ISTIMEWA YOGYAKARTA",34,184,75,259
https://kawalpemilu.org#42046,"BANGUNHARJO, SEWON, BANTUL, DAERAH ISTIMEWA YOGYAKARTA",35,145,103,248
https://kawalpemilu.org#42046,"BANGUNHARJO, SEWON, BANTUL, DAERAH ISTIMEWA YOGYAKARTA",36,123,85,208
https://kawalpemilu.org#42046,"BANGUNHARJO, SEWON, BANTUL, DAERAH ISTIMEWA YOGYAKARTA",37,84,77,161
https://kawalpemilu.org#42046,"BANGUNHARJO, SEWON, BANTUL, DAERAH ISTIMEWA YOGYAKARTA",38,170,82,252
https://kawalpemilu.org#42046,"BANGUNHARJO, SEWON, BANTUL, DAERAH ISTIMEWA YOGYAKARTA",39,195,60,255
https://kawalpemilu.org#42046,"BANGUNHARJO, SEWON, BANTUL, DAERAH ISTIMEWA YOGYAKARTA",40,133,69,202
https://kawalpemilu.org#42046,"BANGUNHARJO, SEWON, BANTUL, DAERAH ISTIMEWA YOGYAKARTA",41,158,72,230
https://kawalpemilu.org#42046,"BANGUNHARJO, SEWON, BANTUL, DAERAH ISTIMEWA YOGYAKARTA",42,110,79,189
https://kawalpemilu.org#42046,"BANGUNHARJO, SEWON, BANTUL, DAERAH ISTIMEWA YOGYAKARTA",43,159,51,205
https://kawalpemilu.org#42046,"BANGUNHARJO, SEWON, BANTUL, DAERAH ISTIMEWA YOGYAKARTA",44,162,97,259
https://kawalpemilu.org#42046,"BANGUNHARJO, SEWON, BANTUL, DAERAH ISTIMEWA YOGYAKARTA",45,119,94,213
https://kawalpemilu.org#42046,"BANGUNHARJO, SEWON, BANTUL, DAERAH ISTIMEWA YOGYAKARTA",46,177,75,252
https://kawalpemilu.org#42046,"BANGUNHARJO, SEWON, BANTUL, DAERAH ISTIMEWA YOGYAKARTA",47,84,145,229
https://kawalpemilu.org#42046,"BANGUNHARJO, SEWON, BANTUL, DAERAH ISTIMEWA YOGYAKARTA",48,176,99,275
https://kawalpemilu.org#42046,"BANGUNHARJO, SEWON, BANTUL, DAERAH ISTIMEWA YOGYAKARTA",49,134,136,270
https://kawalpemilu.org#42046,"BANGUNHARJO, SEWON, BANTUL, DAERAH ISTIMEWA YOGYAKARTA",50,205,64,269
https://kawalpemilu.org#42046,"BANGUNHARJO, SEWON, BANTUL, DAERAH ISTIMEWA YOGYAKARTA",51,216,53,269
https://kawalpemilu.org#42046,"BANGUNHARJO, SEWON, BANTUL, DAERAH ISTIMEWA YOGYAKARTA",52,195,63,258
https://kawalpemilu.org#42046,"BANGUNHARJO, SEWON, BANTUL, DAERAH ISTIMEWA YOGYAKARTA",53,135,89,224
https://kawalpemilu.org#42046,"BANGUNHARJO, SEWON, BANTUL, DAERAH ISTIMEWA YOGYAKARTA",54,156,74,230
https://kawalpemilu.org#42046,"BANGUNHARJO, SEWON, BANTUL, DAERAH ISTIMEWA YOGYAKARTA",55,204,37,241
https://kawalpemilu.org#42046,"BANGUNHARJO, SEWON, BANTUL, DAERAH ISTIMEWA YOGYAKARTA",56,225,36,261
https://kawalpemilu.org#42046,"BANGUNHARJO, SEWON, BANTUL, DAERAH ISTIMEWA YOGYAKARTA",57,182,41,223
https://kawalpemilu.org#42046,"BANGUNHARJO, SEWON, BANTUL, DAERAH ISTIMEWA YOGYAKARTA",58,113,65,178
https://kawalpemilu.org#42046,"BANGUNHARJO, SEWON, BANTUL, DAERAH ISTIMEWA YOGYAKARTA",59,169,60,229
https://kawalpemilu.org#42046,"BANGUNHARJO, SEWON, BANTUL, DAERAH ISTIMEWA YOGYAKARTA",60,202,69,271
https://kawalpemilu.org#42046,"BANGUNHARJO, SEWON, BANTUL, DAERAH ISTIMEWA YOGYAKARTA",61,132,74,206
https://kawalpemilu.org#42046,"BANGUNHARJO, SEWON, BANTUL, DAERAH ISTIMEWA YOGYAKARTA",62,233,51,284
https://kawalpemilu.org#42046,"BANGUNHARJO, SEWON, BANTUL, DAERAH ISTIMEWA YOGYAKARTA",63,240,51,291
https://kawalpemilu.org#42046,"BANGUNHARJO, SEWON, BANTUL, DAERAH ISTIMEWA YOGYAKARTA",64,166,31,197
https://kawalpemilu.org#42046,"BANGUNHARJO, SEWON, BANTUL, DAERAH ISTIMEWA YOGYAKARTA",65,164,57,221
https://kawalpemilu.org#42046,"BANGUNHARJO, SEWON, BANTUL, DAERAH ISTIMEWA YOGYAKARTA",66,196,37,233
https://kawalpemilu.org#42046,"BANGUNHARJO, SEWON, BANTUL, DAERAH ISTIMEWA YOGYAKARTA",67,215,43,258
https://kawalpemilu.org#42046,"BANGUNHARJO, SEWON, BANTUL, DAERAH ISTIMEWA YOGYAKARTA",68,206,58,264
https://kawalpemilu.org#42046,"BANGUNHARJO, SEWON, BANTUL, DAERAH ISTIMEWA YOGYAKARTA",69,159,14,173
https://kawalpemilu.org#42046,"BANGUNHARJO, SEWON, BANTUL, DAERAH ISTIMEWA YOGYAKARTA",70,177,34,211
https://kawalpemilu.org#42046,"BANGUNHARJO, SEWON, BANTUL, DAERAH ISTIMEWA YOGYAKARTA",71,165,26,191
https://kawalpemilu.org#42046,"BANGUNHARJO, SEWON, BANTUL, DAERAH ISTIMEWA YOGYAKARTA",72,137,49,186
https://kawalpemilu.org#42046,"BANGUNHARJO, SEWON, BANTUL, DAERAH ISTIMEWA YOGYAKARTA",73,161,102,263
https://kawalpemilu.org#42046,"BANGUNHARJO, SEWON, BANTUL, DAERAH ISTIMEWA YOGYAKARTA",74,211,48,259
https://kawalpemilu.org#42046,"BANGUNHARJO, SEWON, BANTUL, DAERAH ISTIMEWA YOGYAKARTA",75,183,66,249
https://kawalpemilu.org#42047,"PANGGUNGHARJO, SEWON, BANTUL, DAERAH ISTIMEWA YOGYAKARTA",1,191,42,233
https://kawalpemilu.org#42047,"PANGGUNGHARJO, SEWON, BANTUL, DAERAH ISTIMEWA YOGYAKARTA",2,191,34,225
https://kawalpemilu.org#42047,"PANGGUNGHARJO, SEWON, BANTUL, DAERAH ISTIMEWA YOGYAKARTA",3,133,108,241
https://kawalpemilu.org#42047,"PANGGUNGHARJO, SEWON, BANTUL, DAERAH ISTIMEWA YOGYAKARTA",4,183,45,228
https://kawalpemilu.org#42047,"PANGGUNGHARJO, SEWON, BANTUL, DAERAH ISTIMEWA YOGYAKARTA",5,158,58,244
https://kawalpemilu.org#42047,"PANGGUNGHARJO, SEWON, BANTUL, DAERAH ISTIMEWA YOGYAKARTA",6,181,57,238
https://kawalpemilu.org#42047,"PANGGUNGHARJO, SEWON, BANTUL, DAERAH ISTIMEWA YOGYAKARTA",7,151,48,199
https://kawalpemilu.org#42047,"PANGGUNGHARJO, SEWON, BANTUL, DAERAH ISTIMEWA YOGYAKARTA",8,82,74,156
https://kawalpemilu.org#42047,"PANGGUNGHARJO, SEWON, BANTUL, DAERAH ISTIMEWA YOGYAKARTA",9,187,56,243
https://kawalpemilu.org#42047,"PANGGUNGHARJO, SEWON, BANTUL, DAERAH ISTIMEWA YOGYAKARTA",10,160,76,236
https://kawalpemilu.org#42047,"PANGGUNGHARJO, SEWON, BANTUL, DAERAH ISTIMEWA YOGYAKARTA",11,154,82,236
https://kawalpemilu.org#42047,"PANGGUNGHARJO, SEWON, BANTUL, DAERAH ISTIMEWA YOGYAKARTA",12,157,65,222
https://kawalpemilu.org#42047,"PANGGUNGHARJO, SEWON, BANTUL, DAERAH ISTIMEWA YOGYAKARTA",13,142,59,201
https://kawalpemilu.org#42047,"PANGGUNGHARJO, SEWON, BANTUL, DAERAH ISTIMEWA YOGYAKARTA",14,170,63,233
https://kawalpemilu.org#42047,"PANGGUNGHARJO, SEWON, BANTUL, DAERAH ISTIMEWA YOGYAKARTA",15,135,86,221
https://kawalpemilu.org#42047,"PANGGUNGHARJO, SEWON, BANTUL, DAERAH ISTIMEWA YOGYAKARTA",16,184,78,262
https://kawalpemilu.org#42047,"PANGGUNGHARJO, SEWON, BANTUL, DAERAH ISTIMEWA YOGYAKARTA",17,190,54,244
https://kawalpemilu.org#42047,"PANGGUNGHARJO, SEWON, BANTUL, DAERAH ISTIMEWA YOGYAKARTA",18,135,77,212
https://kawalpemilu.org#42047,"PANGGUNGHARJO, SEWON, BANTUL, DAERAH ISTIMEWA YOGYAKARTA",19,186,58,244
https://kawalpemilu.org#42047,"PANGGUNGHARJO, SEWON, BANTUL, DAERAH ISTIMEWA YOGYAKARTA",20,137,81,218
https://kawalpemilu.org#42047,"PANGGUNGHARJO, SEWON, BANTUL, DAERAH ISTIMEWA YOGYAKARTA",21,99,91,190
https://kawalpemilu.org#42047,"PANGGUNGHARJO, SEWON, BANTUL, DAERAH ISTIMEWA YOGYAKARTA",22,63,114,177
https://kawalpemilu.org#42047,"PANGGUNGHARJO, SEWON, BANTUL, DAERAH ISTIMEWA YOGYAKARTA",23,119,127,246
https://kawalpemilu.org#42047,"PANGGUNGHARJO, SEWON, BANTUL, DAERAH ISTIMEWA YOGYAKARTA",24,163,101,264
https://kawalpemilu.org#42047,"PANGGUNGHARJO, SEWON, BANTUL, DAERAH ISTIMEWA YOGYAKARTA",25,181,81,262
https://kawalpemilu.org#42047,"PANGGUNGHARJO, SEWON, BANTUL, DAERAH ISTIMEWA YOGYAKARTA",26,169,43,212
https://kawalpemilu.org#42047,"PANGGUNGHARJO, SEWON, BANTUL, DAERAH ISTIMEWA YOGYAKARTA",27,128,85,213
https://kawalpemilu.org#42047,"PANGGUNGHARJO, SEWON, BANTUL, DAERAH ISTIMEWA YOGYAKARTA",28,140,92,232
https://kawalpemilu.org#42047,"PANGGUNGHARJO, SEWON, BANTUL, DAERAH ISTIMEWA YOGYAKARTA",29,107,37,144
https://kawalpemilu.org#42047,"PANGGUNGHARJO, SEWON, BANTUL, DAERAH ISTIMEWA YOGYAKARTA",30,159,83,242
https://kawalpemilu.org#42047,"PANGGUNGHARJO, SEWON, BANTUL, DAERAH ISTIMEWA YOGYAKARTA",31,175,46,121
https://kawalpemilu.org#42047,"PANGGUNGHARJO, SEWON, BANTUL, DAERAH ISTIMEWA YOGYAKARTA",32,177,53,230
https://kawalpemilu.org#42047,"PANGGUNGHARJO, SEWON, BANTUL, DAERAH ISTIMEWA YOGYAKARTA",33,162,48,210
https://kawalpemilu.org#42047,"PANGGUNGHARJO, SEWON, BANTUL, DAERAH ISTIMEWA YOGYAKARTA",34,160,83,243
https://kawalpemilu.org#42047,"PANGGUNGHARJO, SEWON, BANTUL, DAERAH ISTIMEWA YOGYAKARTA",35,168,52,220
https://kawalpemilu.org#42047,"PANGGUNGHARJO, SEWON, BANTUL, DAERAH ISTIMEWA YOGYAKARTA",36,182,68,250
https://kawalpemilu.org#42047,"PANGGUNGHARJO, SEWON, BANTUL, DAERAH ISTIMEWA YOGYAKARTA",37,204,53,257
https://kawalpemilu.org#42047,"PANGGUNGHARJO, SEWON, BANTUL, DAERAH ISTIMEWA YOGYAKARTA",38,155,99,254
https://kawalpemilu.org#42047,"PANGGUNGHARJO, SEWON, BANTUL, DAERAH ISTIMEWA YOGYAKARTA",39,157,56,213
https://kawalpemilu.org#42047,"PANGGUNGHARJO, SEWON, BANTUL, DAERAH ISTIMEWA YOGYAKARTA",40,165,84,249
https://kawalpemilu.org#42047,"PANGGUNGHARJO, SEWON, BANTUL, DAERAH ISTIMEWA YOGYAKARTA",41,128,89,217
https://kawalpemilu.org#42047,"PANGGUNGHARJO, SEWON, BANTUL, DAERAH ISTIMEWA YOGYAKARTA",42,113,78,191
https://kawalpemilu.org#42047,"PANGGUNGHARJO, SEWON, BANTUL, DAERAH ISTIMEWA YOGYAKARTA",43,134,124,258
https://kawalpemilu.org#42047,"PANGGUNGHARJO, SEWON, BANTUL, DAERAH ISTIMEWA YOGYAKARTA",44,148,85,233
https://kawalpemilu.org#42047,"PANGGUNGHARJO, SEWON, BANTUL, DAERAH ISTIMEWA YOGYAKARTA",45,131,116,247
https://kawalpemilu.org#42047,"PANGGUNGHARJO, SEWON, BANTUL, DAERAH ISTIMEWA YOGYAKARTA",46,156,119,275
https://kawalpemilu.org#42047,"PANGGUNGHARJO, SEWON, BANTUL, DAERAH ISTIMEWA YOGYAKARTA",47,71,47,118
https://kawalpemilu.org#42047,"PANGGUNGHARJO, SEWON, BANTUL, DAERAH ISTIMEWA YOGYAKARTA",48,124,97,221
https://kawalpemilu.org#42047,"PANGGUNGHARJO, SEWON, BANTUL, DAERAH ISTIMEWA YOGYAKARTA",49,173,73,246
https://kawalpemilu.org#42047,"PANGGUNGHARJO, SEWON, BANTUL, DAERAH ISTIMEWA YOGYAKARTA",50,178,89,267
https://kawalpemilu.org#42047,"PANGGUNGHARJO, SEWON, BANTUL, DAERAH ISTIMEWA YOGYAKARTA",51,102,41,143
https://kawalpemilu.org#42047,"PANGGUNGHARJO, SEWON, BANTUL, DAERAH ISTIMEWA YOGYAKARTA",52,104,88,192
https://kawalpemilu.org#42047,"PANGGUNGHARJO, SEWON, BANTUL, DAERAH ISTIMEWA YOGYAKARTA",53,107,49,156
https://kawalpemilu.org#42047,"PANGGUNGHARJO, SEWON, BANTUL, DAERAH ISTIMEWA YOGYAKARTA",54,214,38,252
https://kawalpemilu.org#42047,"PANGGUNGHARJO, SEWON, BANTUL, DAERAH ISTIMEWA YOGYAKARTA",55,156,59,215
https://kawalpemilu.org#42047,"PANGGUNGHARJO, SEWON, BANTUL, DAERAH ISTIMEWA YOGYAKARTA",56,162,48,210
https://kawalpemilu.org#42047,"PANGGUNGHARJO, SEWON, BANTUL, DAERAH ISTIMEWA YOGYAKARTA",57,126,41,167
https://kawalpemilu.org#42047,"PANGGUNGHARJO, SEWON, BANTUL, DAERAH ISTIMEWA YOGYAKARTA",58,150,64,214
https://kawalpemilu.org#42047,"PANGGUNGHARJO, SEWON, BANTUL, DAERAH ISTIMEWA YOGYAKARTA",59,154,80,234
https://kawalpemilu.org#42047,"PANGGUNGHARJO, SEWON, BANTUL, DAERAH ISTIMEWA YOGYAKARTA",60,132,80,212
https://kawalpemilu.org#42047,"PANGGUNGHARJO, SEWON, BANTUL, DAERAH ISTIMEWA YOGYAKARTA",61,135,61,196
https://kawalpemilu.org#42047,"PANGGUNGHARJO, SEWON, BANTUL, DAERAH ISTIMEWA YOGYAKARTA",62,164,73,237
https://kawalpemilu.org#42047,"PANGGUNGHARJO, SEWON, BANTUL, DAERAH ISTIMEWA YOGYAKARTA",63,116,86,202
https://kawalpemilu.org#42047,"PANGGUNGHARJO, SEWON, BANTUL, DAERAH ISTIMEWA YOGYAKARTA",64,125,95,220
https://kawalpemilu.org#42047,"PANGGUNGHARJO, SEWON, BANTUL, DAERAH ISTIMEWA YOGYAKARTA",65,183,89,272
https://kawalpemilu.org#42047,"PANGGUNGHARJO, SEWON, BANTUL, DAERAH ISTIMEWA YOGYAKARTA",66,108,78,186
https://kawalpemilu.org#42047,"PANGGUNGHARJO, SEWON, BANTUL, DAERAH ISTIMEWA YOGYAKARTA",67,139,86,225
https://kawalpemilu.org#42047,"PANGGUNGHARJO, SEWON, BANTUL, DAERAH ISTIMEWA YOGYAKARTA",68,138,79,217
https://kawalpemilu.org#42047,"PANGGUNGHARJO, SEWON, BANTUL, DAERAH ISTIMEWA YOGYAKARTA",69,140,66,206
https://kawalpemilu.org#42047,"PANGGUNGHARJO, SEWON, BANTUL, DAERAH ISTIMEWA YOGYAKARTA",70,131,81,212
https://kawalpemilu.org#42047,"PANGGUNGHARJO, SEWON, BANTUL, DAERAH ISTIMEWA YOGYAKARTA",71,163,71,234
https://kawalpemilu.org#42047,"PANGGUNGHARJO, SEWON, BANTUL, DAERAH ISTIMEWA YOGYAKARTA",72,157,84,241
https://kawalpemilu.org#42047,"PANGGUNGHARJO, SEWON, BANTUL, DAERAH ISTIMEWA YOGYAKARTA",73,139,91,230
https://kawalpemilu.org#42047,"PANGGUNGHARJO, SEWON, BANTUL, DAERAH ISTIMEWA YOGYAKARTA",74,199,58,257
https://kawalpemilu.org#42047,"PANGGUNGHARJO, SEWON, BANTUL, DAERAH ISTIMEWA YOGYAKARTA",75,193,39,232
https://kawalpemilu.org#42047,"PANGGUNGHARJO, SEWON, BANTUL, DAERAH ISTIMEWA YOGYAKARTA",76,152,35,187
https://kawalpemilu.org#42047,"PANGGUNGHARJO, SEWON, BANTUL, DAERAH ISTIMEWA YOGYAKARTA",77,156,63,219
https://kawalpemilu.org#42047,"PANGGUNGHARJO, SEWON, BANTUL, DAERAH ISTIMEWA YOGYAKARTA",78,112,92,204
https://kawalpemilu.org#42047,"PANGGUNGHARJO, SEWON, BANTUL, DAERAH ISTIMEWA YOGYAKARTA",79,151,99,250
https://kawalpemilu.org#42047,"PANGGUNGHARJO, SEWON, BANTUL, DAERAH ISTIMEWA YOGYAKARTA",80,145,98,243
https://kawalpemilu.org#42047,"PANGGUNGHARJO, SEWON, BANTUL, DAERAH ISTIMEWA YOGYAKARTA",81,115,79,194
https://kawalpemilu.org#42047,"PANGGUNGHARJO, SEWON, BANTUL, DAERAH ISTIMEWA YOGYAKARTA",82,151,78,229
https://kawalpemilu.org#42047,"PANGGUNGHARJO, SEWON, BANTUL, DAERAH ISTIMEWA YOGYAKARTA",83,62,146,208
https://kawalpemilu.org#42047,"PANGGUNGHARJO, SEWON, BANTUL, DAERAH ISTIMEWA YOGYAKARTA",84,104,106,210
https://kawalpemilu.org#42047,"PANGGUNGHARJO, SEWON, BANTUL, DAERAH ISTIMEWA YOGYAKARTA",85,114,98,212
https://kawalpemilu.org#42049,"BANGUNJIWO, KASIHAN, BANTUL, DAERAH ISTIMEWA YOGYAKARTA",1,120,25,145
https://kawalpemilu.org#42049,"BANGUNJIWO, KASIHAN, BANTUL, DAERAH ISTIMEWA YOGYAKARTA",2,135,39,174
https://kawalpemilu.org#42049,"BANGUNJIWO, KASIHAN, BANTUL, DAERAH ISTIMEWA YOGYAKARTA",3,107,66,173
https://kawalpemilu.org#42049,"BANGUNJIWO, KASIHAN, BANTUL, DAERAH ISTIMEWA YOGYAKARTA",4,134,76,210
https://kawalpemilu.org#42049,"BANGUNJIWO, KASIHAN, BANTUL, DAERAH ISTIMEWA YOGYAKARTA",5,130,133,263
https://kawalpemilu.org#42049,"BANGUNJIWO, KASIHAN, BANTUL, DAERAH ISTIMEWA YOGYAKARTA",6,136,94,230
https://kawalpemilu.org#42049,"BANGUNJIWO, KASIHAN, BANTUL, DAERAH ISTIMEWA YOGYAKARTA",7,122,93,215
https://kawalpemilu.org#42049,"BANGUNJIWO, KASIHAN, BANTUL, DAERAH ISTIMEWA YOGYAKARTA",8,188,82,270
https://kawalpemilu.org#42049,"BANGUNJIWO, KASIHAN, BANTUL, DAERAH ISTIMEWA YOGYAKARTA",9,158,108,266
https://kawalpemilu.org#42049,"BANGUNJIWO, KASIHAN, BANTUL, DAERAH ISTIMEWA YOGYAKARTA",10,134,148,282
https://kawalpemilu.org#42049,"BANGUNJIWO, KASIHAN, BANTUL, DAERAH ISTIMEWA YOGYAKARTA",11,148,130,278
https://kawalpemilu.org#42049,"BANGUNJIWO, KASIHAN, BANTUL, DAERAH ISTIMEWA YOGYAKARTA",12,170,120,290
https://kawalpemilu.org#42049,"BANGUNJIWO, KASIHAN, BANTUL, DAERAH ISTIMEWA YOGYAKARTA",13,181,95,276
https://kawalpemilu.org#42049,"BANGUNJIWO, KASIHAN, BANTUL, DAERAH ISTIMEWA YOGYAKARTA",14,180,115,295
https://kawalpemilu.org#42049,"BANGUNJIWO, KASIHAN, BANTUL, DAERAH ISTIMEWA YOGYAKARTA",15,194,59,253
https://kawalpemilu.org#42049,"BANGUNJIWO, KASIHAN, BANTUL, DAERAH ISTIMEWA YOGYAKARTA",16,179,68,247
https://kawalpemilu.org#42049,"BANGUNJIWO, KASIHAN, BANTUL, DAERAH ISTIMEWA YOGYAKARTA",17,201,67,268
https://kawalpemilu.org#42049,"BANGUNJIWO, KASIHAN, BANTUL, DAERAH ISTIMEWA YOGYAKARTA",18,178,67,245
https://kawalpemilu.org#42049,"BANGUNJIWO, KASIHAN, BANTUL, DAERAH ISTIMEWA YOGYAKARTA",19,214,48,262
https://kawalpemilu.org#42049,"BANGUNJIWO, KASIHAN, BANTUL, DAERAH ISTIMEWA YOGYAKARTA",20,209,59,268
https://kawalpemilu.org#42049,"BANGUNJIWO, KASIHAN, BANTUL, DAERAH ISTIMEWA YOGYAKARTA",21,145,52,197
https://kawalpemilu.org#42049,"BANGUNJIWO, KASIHAN, BANTUL, DAERAH ISTIMEWA YOGYAKARTA",22,163,84,247
https://kawalpemilu.org#42049,"BANGUNJIWO, KASIHAN, BANTUL, DAERAH ISTIMEWA YOGYAKARTA",23,130,62,192
https://kawalpemilu.org#42049,"BANGUNJIWO, KASIHAN, BANTUL, DAERAH ISTIMEWA YOGYAKARTA",24,127,55,182
https://kawalpemilu.org#42049,"BANGUNJIWO, KASIHAN, BANTUL, DAERAH ISTIMEWA YOGYAKARTA",25,104,87,191
https://kawalpemilu.org#42049,"BANGUNJIWO, KASIHAN, BANTUL, DAERAH ISTIMEWA YOGYAKARTA",26,111,51,162
https://kawalpemilu.org#42049,"BANGUNJIWO, KASIHAN, BANTUL, DAERAH ISTIMEWA YOGYAKARTA",27,215,40,255
https://kawalpemilu.org#42049,"BANGUNJIWO, KASIHAN, BANTUL, DAERAH ISTIMEWA YOGYAKARTA",28,177,95,272
https://kawalpemilu.org#42049,"BANGUNJIWO, KASIHAN, BANTUL, DAERAH ISTIMEWA YOGYAKARTA",29,168,10,178
https://kawalpemilu.org#42049,"BANGUNJIWO, KASIHAN, BANTUL, DAERAH ISTIMEWA YOGYAKARTA",30,170,69,239
https://kawalpemilu.org#42049,"BANGUNJIWO, KASIHAN, BANTUL, DAERAH ISTIMEWA YOGYAKARTA",31,147,51,198
https://kawalpemilu.org#42049,"BANGUNJIWO, KASIHAN, BANTUL, DAERAH ISTIMEWA YOGYAKARTA",32,129,74,203
https://kawalpemilu.org#42049,"BANGUNJIWO, KASIHAN, BANTUL, DAERAH ISTIMEWA YOGYAKARTA",33,146,83,229
https://kawalpemilu.org#42049,"BANGUNJIWO, KASIHAN, BANTUL, DAERAH ISTIMEWA YOGYAKARTA",34,141,64,205
https://kawalpemilu.org#42049,"BANGUNJIWO, KASIHAN, BANTUL, DAERAH ISTIMEWA YOGYAKARTA",35,92,44,136
https://kawalpemilu.org#42049,"BANGUNJIWO, KASIHAN, BANTUL, DAERAH ISTIMEWA YOGYAKARTA",36,229,41,270
https://kawalpemilu.org#42049,"BANGUNJIWO, KASIHAN, BANTUL, DAERAH ISTIMEWA YOGYAKARTA",37,149,81,230
https://kawalpemilu.org#42049,"BANGUNJIWO, KASIHAN, BANTUL, DAERAH ISTIMEWA YOGYAKARTA",38,115,154,269
https://kawalpemilu.org#42049,"BANGUNJIWO, KASIHAN, BANTUL, DAERAH ISTIMEWA YOGYAKARTA",39,154,72,226
https://kawalpemilu.org#42049,"BANGUNJIWO, KASIHAN, BANTUL, DAERAH ISTIMEWA YOGYAKARTA",40,183,88,271
https://kawalpemilu.org#42049,"BANGUNJIWO, KASIHAN, BANTUL, DAERAH ISTIMEWA YOGYAKARTA",41,163,29,192
https://kawalpemilu.org#42049,"BANGUNJIWO, KASIHAN, BANTUL, DAERAH ISTIMEWA YOGYAKARTA",42,190,27,217
https://kawalpemilu.org#42049,"BANGUNJIWO, KASIHAN, BANTUL, DAERAH ISTIMEWA YOGYAKARTA",43,142,78,220
https://kawalpemilu.org#42049,"BANGUNJIWO, KASIHAN, BANTUL, DAERAH ISTIMEWA YOGYAKARTA",44,166,57,223
https://kawalpemilu.org#42049,"BANGUNJIWO, KASIHAN, BANTUL, DAERAH ISTIMEWA YOGYAKARTA",45,175,61,236
https://kawalpemilu.org#42049,"BANGUNJIWO, KASIHAN, BANTUL, DAERAH ISTIMEWA YOGYAKARTA",46,228,30,258
https://kawalpemilu.org#42049,"BANGUNJIWO, KASIHAN, BANTUL, DAERAH ISTIMEWA YOGYAKARTA",47,191,51,242
https://kawalpemilu.org#42049,"BANGUNJIWO, KASIHAN, BANTUL, DAERAH ISTIMEWA YOGYAKARTA",48,196,67,263
https://kawalpemilu.org#42049,"BANGUNJIWO, KASIHAN, BANTUL, DAERAH ISTIMEWA YOGYAKARTA",49,140,107,247
https://kawalpemilu.org#42049,"BANGUNJIWO, KASIHAN, BANTUL, DAERAH ISTIMEWA YOGYAKARTA",50,218,60,278
https://kawalpemilu.org#42049,"BANGUNJIWO, KASIHAN, BANTUL, DAERAH ISTIMEWA YOGYAKARTA",51,153,49,202
https://kawalpemilu.org#42049,"BANGUNJIWO, KASIHAN, BANTUL, DAERAH ISTIMEWA YOGYAKARTA",52,134,49,183
https://kawalpemilu.org#42049,"BANGUNJIWO, KASIHAN, BANTUL, DAERAH ISTIMEWA YOGYAKARTA",53,164,52,216
https://kawalpemilu.org#42049,"BANGUNJIWO, KASIHAN, BANTUL, DAERAH ISTIMEWA YOGYAKARTA",54,116,54,170
https://kawalpemilu.org#42049,"BANGUNJIWO, KASIHAN, BANTUL, DAERAH ISTIMEWA YOGYAKARTA",55,134,69,203
https://kawalpemilu.org#42049,"BANGUNJIWO, KASIHAN, BANTUL, DAERAH ISTIMEWA YOGYAKARTA",56,181,39,220
https://kawalpemilu.org#42049,"BANGUNJIWO, KASIHAN, BANTUL, DAERAH ISTIMEWA YOGYAKARTA",57,143,96,239
https://kawalpemilu.org#42049,"BANGUNJIWO, KASIHAN, BANTUL, DAERAH ISTIMEWA YOGYAKARTA",58,160,53,213
https://kawalpemilu.org#42049,"BANGUNJIWO, KASIHAN, BANTUL, DAERAH ISTIMEWA YOGYAKARTA",59,134,95,229
https://kawalpemilu.org#42049,"BANGUNJIWO, KASIHAN, BANTUL, DAERAH ISTIMEWA YOGYAKARTA",60,200,64,264
https://kawalpemilu.org#42049,"BANGUNJIWO, KASIHAN, BANTUL, DAERAH ISTIMEWA YOGYAKARTA",61,154,115,269
https://kawalpemilu.org#42049,"BANGUNJIWO, KASIHAN, BANTUL, DAERAH ISTIMEWA YOGYAKARTA",62,108,122,130
https://kawalpemilu.org#42049,"BANGUNJIWO, KASIHAN, BANTUL, DAERAH ISTIMEWA YOGYAKARTA",63,89,122,211
https://kawalpemilu.org#42049,"BANGUNJIWO, KASIHAN, BANTUL, DAERAH ISTIMEWA YOGYAKARTA",64,133,67,200
https://kawalpemilu.org#42049,"BANGUNJIWO, KASIHAN, BANTUL, DAERAH ISTIMEWA YOGYAKARTA",65,133,92,225
https://kawalpemilu.org#42049,"BANGUNJIWO, KASIHAN, BANTUL, DAERAH ISTIMEWA YOGYAKARTA",66,83,169,252
https://kawalpemilu.org#42049,"BANGUNJIWO, KASIHAN, BANTUL, DAERAH ISTIMEWA YOGYAKARTA",67,157,106,263
https://kawalpemilu.org#42049,"BANGUNJIWO, KASIHAN, BANTUL, DAERAH ISTIMEWA YOGYAKARTA",68,177,89,266
https://kawalpemilu.org#42049,"BANGUNJIWO, KASIHAN, BANTUL, DAERAH ISTIMEWA YOGYAKARTA",69,189,75,264
https://kawalpemilu.org#42049,"BANGUNJIWO, KASIHAN, BANTUL, DAERAH ISTIMEWA YOGYAKARTA",70,112,161,273
https://kawalpemilu.org#42049,"BANGUNJIWO, KASIHAN, BANTUL, DAERAH ISTIMEWA YOGYAKARTA",71,165,107,272
https://kawalpemilu.org#42049,"BANGUNJIWO, KASIHAN, BANTUL, DAERAH ISTIMEWA YOGYAKARTA",72,149,118,267
https://kawalpemilu.org#42049,"BANGUNJIWO, KASIHAN, BANTUL, DAERAH ISTIMEWA YOGYAKARTA",73,171,99,270
https://kawalpemilu.org#42049,"BANGUNJIWO, KASIHAN, BANTUL, DAERAH ISTIMEWA YOGYAKARTA",74,147,82,229
https://kawalpemilu.org#42049,"BANGUNJIWO, KASIHAN, BANTUL, DAERAH ISTIMEWA YOGYAKARTA",75,131,112,243
https://kawalpemilu.org#42049,"BANGUNJIWO, KASIHAN, BANTUL, DAERAH ISTIMEWA YOGYAKARTA",76,115,84,199
https://kawalpemilu.org#42049,"BANGUNJIWO, KASIHAN, BANTUL, DAERAH ISTIMEWA YOGYAKARTA",77,104,56,160
https://kawalpemilu.org#42050,"TIRTONIRMOLO, KASIHAN, BANTUL, DAERAH ISTIMEWA YOGYAKARTA",1,127,116,243
https://kawalpemilu.org#42050,"TIRTONIRMOLO, KASIHAN, BANTUL, DAERAH ISTIMEWA YOGYAKARTA",2,147,119,266
https://kawalpemilu.org#42050,"TIRTONIRMOLO, KASIHAN, BANTUL, DAERAH ISTIMEWA YOGYAKARTA",3,111,146,257
https://kawalpemilu.org#42050,"TIRTONIRMOLO, KASIHAN, BANTUL, DAERAH ISTIMEWA YOGYAKARTA",4,107,95,202
https://kawalpemilu.org#42050,"TIRTONIRMOLO, KASIHAN, BANTUL, DAERAH ISTIMEWA YOGYAKARTA",5,152,114,166
https://kawalpemilu.org#42050,"TIRTONIRMOLO, KASIHAN, BANTUL, DAERAH ISTIMEWA YOGYAKARTA",6,80,147,227
https://kawalpemilu.org#42050,"TIRTONIRMOLO, KASIHAN, BANTUL, DAERAH ISTIMEWA YOGYAKARTA",7,97,135,232
https://kawalpemilu.org#42050,"TIRTONIRMOLO, KASIHAN, BANTUL, DAERAH ISTIMEWA YOGYAKARTA",8,82,136,218
https://kawalpemilu.org#42050,"TIRTONIRMOLO, KASIHAN, BANTUL, DAERAH ISTIMEWA YOGYAKARTA",9,90,159,249
https://kawalpemilu.org#42050,"TIRTONIRMOLO, KASIHAN, BANTUL, DAERAH ISTIMEWA YOGYAKARTA",10,132,120,252
https://kawalpemilu.org#42050,"TIRTONIRMOLO, KASIHAN, BANTUL, DAERAH ISTIMEWA YOGYAKARTA",11,108,141,249
https://kawalpemilu.org#42050,"TIRTONIRMOLO, KASIHAN, BANTUL, DAERAH ISTIMEWA YOGYAKARTA",12,152,87,239
https://kawalpemilu.org#42050,"TIRTONIRMOLO, KASIHAN, BANTUL, DAERAH ISTIMEWA YOGYAKARTA",13,138,111,249
https://kawalpemilu.org#42050,"TIRTONIRMOLO, KASIHAN, BANTUL, DAERAH ISTIMEWA YOGYAKARTA",14,122,59,181
https://kawalpemilu.org#42050,"TIRTONIRMOLO, KASIHAN, BANTUL, DAERAH ISTIMEWA YOGYAKARTA",15,121,65,186
https://kawalpemilu.org#42050,"TIRTONIRMOLO, KASIHAN, BANTUL, DAERAH ISTIMEWA YOGYAKARTA",16,174,66,240
https://kawalpemilu.org#42050,"TIRTONIRMOLO, KASIHAN, BANTUL, DAERAH ISTIMEWA YOGYAKARTA",17,116,133,249
https://kawalpemilu.org#42050,"TIRTONIRMOLO, KASIHAN, BANTUL, DAERAH ISTIMEWA YOGYAKARTA",18,89,146,235
https://kawalpemilu.org#42050,"TIRTONIRMOLO, KASIHAN, BANTUL, DAERAH ISTIMEWA YOGYAKARTA",19,155,86,241
https://kawalpemilu.org#42050,"TIRTONIRMOLO, KASIHAN, BANTUL, DAERAH ISTIMEWA YOGYAKARTA",20,120,93,213
https://kawalpemilu.org#42050,"TIRTONIRMOLO, KASIHAN, BANTUL, DAERAH ISTIMEWA YOGYAKARTA",21,108,112,220
https://kawalpemilu.org#42050,"TIRTONIRMOLO, KASIHAN, BANTUL, DAERAH ISTIMEWA YOGYAKARTA",22,119,96,215
https://kawalpemilu.org#42050,"TIRTONIRMOLO, KASIHAN, BANTUL, DAERAH ISTIMEWA YOGYAKARTA",23,150,42,192
https://kawalpemilu.org#42050,"TIRTONIRMOLO, KASIHAN, BANTUL, DAERAH ISTIMEWA YOGYAKARTA",24,84,103,187
https://kawalpemilu.org#42050,"TIRTONIRMOLO, KASIHAN, BANTUL, DAERAH ISTIMEWA YOGYAKARTA",25,110,128,238
https://kawalpemilu.org#42050,"TIRTONIRMOLO, KASIHAN, BANTUL, DAERAH ISTIMEWA YOGYAKARTA",26,103,87,190
https://kawalpemilu.org#42050,"TIRTONIRMOLO, KASIHAN, BANTUL, DAERAH ISTIMEWA YOGYAKARTA",27,69,85,154
https://kawalpemilu.org#42050,"TIRTONIRMOLO, KASIHAN, BANTUL, DAERAH ISTIMEWA YOGYAKARTA",28,82,173,255
https://kawalpemilu.org#42050,"TIRTONIRMOLO, KASIHAN, BANTUL, DAERAH ISTIMEWA YOGYAKARTA",29,144,125,269
https://kawalpemilu.org#42050,"TIRTONIRMOLO, KASIHAN, BANTUL, DAERAH ISTIMEWA YOGYAKARTA",30,121,137,258
https://kawalpemilu.org#42050,"TIRTONIRMOLO, KASIHAN, BANTUL, DAERAH ISTIMEWA YOGYAKARTA",31,159,82,241
https://kawalpemilu.org#42050,"TIRTONIRMOLO, KASIHAN, BANTUL, DAERAH ISTIMEWA YOGYAKARTA",32,105,48,153
https://kawalpemilu.org#42050,"TIRTONIRMOLO, KASIHAN, BANTUL, DAERAH ISTIMEWA YOGYAKARTA",33,84,96,180
https://kawalpemilu.org#42050,"TIRTONIRMOLO, KASIHAN, BANTUL, DAERAH ISTIMEWA YOGYAKARTA",34,131,44,175
https://kawalpemilu.org#42050,"TIRTONIRMOLO, KASIHAN, BANTUL, DAERAH ISTIMEWA YOGYAKARTA",35,154,82,236
https://kawalpemilu.org#42050,"TIRTONIRMOLO, KASIHAN, BANTUL, DAERAH ISTIMEWA YOGYAKARTA",36,165,61,226
https://kawalpemilu.org#42050,"TIRTONIRMOLO, KASIHAN, BANTUL, DAERAH ISTIMEWA YOGYAKARTA",37,169,60,229
https://kawalpemilu.org#42050,"TIRTONIRMOLO, KASIHAN, BANTUL, DAERAH ISTIMEWA YOGYAKARTA",38,101,42,143
https://kawalpemilu.org#42050,"TIRTONIRMOLO, KASIHAN, BANTUL, DAERAH ISTIMEWA YOGYAKARTA",39,140,44,184
https://kawalpemilu.org#42050,"TIRTONIRMOLO, KASIHAN, BANTUL, DAERAH ISTIMEWA YOGYAKARTA",40,153,70,223
https://kawalpemilu.org#42050,"TIRTONIRMOLO, KASIHAN, BANTUL, DAERAH ISTIMEWA YOGYAKARTA",41,128,93,221
https://kawalpemilu.org#42050,"TIRTONIRMOLO, KASIHAN, BANTUL, DAERAH ISTIMEWA YOGYAKARTA",42,110,50,160
https://kawalpemilu.org#42050,"TIRTONIRMOLO, KASIHAN, BANTUL, DAERAH ISTIMEWA YOGYAKARTA",43,144,83,227
https://kawalpemilu.org#42050,"TIRTONIRMOLO, KASIHAN, BANTUL, DAERAH ISTIMEWA YOGYAKARTA",44,130,93,223
https://kawalpemilu.org#42050,"TIRTONIRMOLO, KASIHAN, BANTUL, DAERAH ISTIMEWA YOGYAKARTA",45,185,59,244
https://kawalpemilu.org#42050,"TIRTONIRMOLO, KASIHAN, BANTUL, DAERAH ISTIMEWA YOGYAKARTA",46,197,59,256
https://kawalpemilu.org#42050,"TIRTONIRMOLO, KASIHAN, BANTUL, DAERAH ISTIMEWA YOGYAKARTA",47,124,44,168
https://kawalpemilu.org#42050,"TIRTONIRMOLO, KASIHAN, BANTUL, DAERAH ISTIMEWA YOGYAKARTA",48,162,71,233
https://kawalpemilu.org#42050,"TIRTONIRMOLO, KASIHAN, BANTUL, DAERAH ISTIMEWA YOGYAKARTA",49,148,88,236
https://kawalpemilu.org#42050,"TIRTONIRMOLO, KASIHAN, BANTUL, DAERAH ISTIMEWA YOGYAKARTA",50,156,89,245
https://kawalpemilu.org#42050,"TIRTONIRMOLO, KASIHAN, BANTUL, DAERAH ISTIMEWA YOGYAKARTA",51,150,92,242
https://kawalpemilu.org#42050,"TIRTONIRMOLO, KASIHAN, BANTUL, DAERAH ISTIMEWA YOGYAKARTA",52,133,84,217
https://kawalpemilu.org#42050,"TIRTONIRMOLO, KASIHAN, BANTUL, DAERAH ISTIMEWA YOGYAKARTA",53,138,60,198
https://kawalpemilu.org#42050,"TIRTONIRMOLO, KASIHAN, BANTUL, DAERAH ISTIMEWA YOGYAKARTA",54,124,42,166
https://kawalpemilu.org#42050,"TIRTONIRMOLO, KASIHAN, BANTUL, DAERAH ISTIMEWA YOGYAKARTA",55,216,42,258
https://kawalpemilu.org#42050,"TIRTONIRMOLO, KASIHAN, BANTUL, DAERAH ISTIMEWA YOGYAKARTA",56,187,77,264
https://kawalpemilu.org#42050,"TIRTONIRMOLO, KASIHAN, BANTUL, DAERAH ISTIMEWA YOGYAKARTA",57,138,80,218
https://kawalpemilu.org#42050,"TIRTONIRMOLO, KASIHAN, BANTUL, DAERAH ISTIMEWA YOGYAKARTA",58,69,74,143
https://kawalpemilu.org#42050,"TIRTONIRMOLO, KASIHAN, BANTUL, DAERAH ISTIMEWA YOGYAKARTA",59,158,83,241
https://kawalpemilu.org#42050,"TIRTONIRMOLO, KASIHAN, BANTUL, DAERAH ISTIMEWA YOGYAKARTA",60,162,96,258
https://kawalpemilu.org#42050,"TIRTONIRMOLO, KASIHAN, BANTUL, DAERAH ISTIMEWA YOGYAKARTA",61,131,105,236
https://kawalpemilu.org#42050,"TIRTONIRMOLO, KASIHAN, BANTUL, DAERAH ISTIMEWA YOGYAKARTA",62,111,119,230
https://kawalpemilu.org#42050,"TIRTONIRMOLO, KASIHAN, BANTUL, DAERAH ISTIMEWA YOGYAKARTA",63,125,132,257
https://kawalpemilu.org#42050,"TIRTONIRMOLO, KASIHAN, BANTUL, DAERAH ISTIMEWA YOGYAKARTA",64,71,163,234
https://kawalpemilu.org#42050,"TIRTONIRMOLO, KASIHAN, BANTUL, DAERAH ISTIMEWA YOGYAKARTA",65,129,135,264
https://kawalpemilu.org#42050,"TIRTONIRMOLO, KASIHAN, BANTUL, DAERAH ISTIMEWA YOGYAKARTA",66,98,165,263
https://kawalpemilu.org#42050,"TIRTONIRMOLO, KASIHAN, BANTUL, DAERAH ISTIMEWA YOGYAKARTA",67,94,162,256
https://kawalpemilu.org#42050,"TIRTONIRMOLO, KASIHAN, BANTUL, DAERAH ISTIMEWA YOGYAKARTA",68,109,116,225
https://kawalpemilu.org#42051,"TAMANTIRTO, KASIHAN, BANTUL, DAERAH ISTIMEWA YOGYAKARTA",1,83,152,241
https://kawalpemilu.org#42051,"TAMANTIRTO, KASIHAN, BANTUL, DAERAH ISTIMEWA YOGYAKARTA",2,72,65,137
https://kawalpemilu.org#42051,"TAMANTIRTO, KASIHAN, BANTUL, DAERAH ISTIMEWA YOGYAKARTA",3,138,98,236
https://kawalpemilu.org#42051,"TAMANTIRTO, KASIHAN, BANTUL, DAERAH ISTIMEWA YOGYAKARTA",4,97,134,231
https://kawalpemilu.org#42051,"TAMANTIRTO, KASIHAN, BANTUL, DAERAH ISTIMEWA YOGYAKARTA",5,100,124,224
https://kawalpemilu.org#42051,"TAMANTIRTO, KASIHAN, BANTUL, DAERAH ISTIMEWA YOGYAKARTA",6,113,137,250
https://kawalpemilu.org#42051,"TAMANTIRTO, KASIHAN, BANTUL, DAERAH ISTIMEWA YOGYAKARTA",7,73,105,178
https://kawalpemilu.org#42051,"TAMANTIRTO, KASIHAN, BANTUL, DAERAH ISTIMEWA YOGYAKARTA",8,119,79,198
https://kawalpemilu.org#42051,"TAMANTIRTO, KASIHAN, BANTUL, DAERAH ISTIMEWA YOGYAKARTA",9,129,100,229
https://kawalpemilu.org#42051,"TAMANTIRTO, KASIHAN, BANTUL, DAERAH ISTIMEWA YOGYAKARTA",10,111,117,228
https://kawalpemilu.org#42051,"TAMANTIRTO, KASIHAN, BANTUL, DAERAH ISTIMEWA YOGYAKARTA",11,128,104,232
https://kawalpemilu.org#42051,"TAMANTIRTO, KASIHAN, BANTUL, DAERAH ISTIMEWA YOGYAKARTA",12,0,0,0
https://kawalpemilu.org#42051,"TAMANTIRTO, KASIHAN, BANTUL, DAERAH ISTIMEWA YOGYAKARTA",13,108,144,252
https://kawalpemilu.org#42051,"TAMANTIRTO, KASIHAN, BANTUL, DAERAH ISTIMEWA YOGYAKARTA",14,84,129,213
https://kawalpemilu.org#42051,"TAMANTIRTO, KASIHAN, BANTUL, DAERAH ISTIMEWA YOGYAKARTA",15,176,87,263
https://kawalpemilu.org#42051,"TAMANTIRTO, KASIHAN, BANTUL, DAERAH ISTIMEWA YOGYAKARTA",16,115,87,202
https://kawalpemilu.org#42051,"TAMANTIRTO, KASIHAN, BANTUL, DAERAH ISTIMEWA YOGYAKARTA",17,123,84,207
https://kawalpemilu.org#42051,"TAMANTIRTO, KASIHAN, BANTUL, DAERAH ISTIMEWA YOGYAKARTA",18,172,53,225
https://kawalpemilu.org#42051,"TAMANTIRTO, KASIHAN, BANTUL, DAERAH ISTIMEWA YOGYAKARTA",19,135,92,227
https://kawalpemilu.org#42051,"TAMANTIRTO, KASIHAN, BANTUL, DAERAH ISTIMEWA YOGYAKARTA",20,126,120,246
https://kawalpemilu.org#42051,"TAMANTIRTO, KASIHAN, BANTUL, DAERAH ISTIMEWA YOGYAKARTA",21,107,106,213
https://kawalpemilu.org#42051,"TAMANTIRTO, KASIHAN, BANTUL, DAERAH ISTIMEWA YOGYAKARTA",22,162,95,257
https://kawalpemilu.org#42051,"TAMANTIRTO, KASIHAN, BANTUL, DAERAH ISTIMEWA YOGYAKARTA",23,88,108,196
https://kawalpemilu.org#42051,"TAMANTIRTO, KASIHAN, BANTUL, DAERAH ISTIMEWA YOGYAKARTA",24,150,77,227
https://kawalpemilu.org#42051,"TAMANTIRTO, KASIHAN, BANTUL, DAERAH ISTIMEWA YOGYAKARTA",25,128,78,206
https://kawalpemilu.org#42051,"TAMANTIRTO, KASIHAN, BANTUL, DAERAH ISTIMEWA YOGYAKARTA",26,134,86,220
https://kawalpemilu.org#42051,"TAMANTIRTO, KASIHAN, BANTUL, DAERAH ISTIMEWA YOGYAKARTA",27,137,59,196
https://kawalpemilu.org#42051,"TAMANTIRTO, KASIHAN, BANTUL, DAERAH ISTIMEWA YOGYAKARTA",28,181,70,251
https://kawalpemilu.org#42051,"TAMANTIRTO, KASIHAN, BANTUL, DAERAH ISTIMEWA YOGYAKARTA",29,126,86,212
https://kawalpemilu.org#42051,"TAMANTIRTO, KASIHAN, BANTUL, DAERAH ISTIMEWA YOGYAKARTA",30,149,57,206
https://kawalpemilu.org#42051,"TAMANTIRTO, KASIHAN, BANTUL, DAERAH ISTIMEWA YOGYAKARTA",31,177,82,259
https://kawalpemilu.org#42051,"TAMANTIRTO, KASIHAN, BANTUL, DAERAH ISTIMEWA YOGYAKARTA",32,157,129,286
https://kawalpemilu.org#42051,"TAMANTIRTO, KASIHAN, BANTUL, DAERAH ISTIMEWA YOGYAKARTA",33,81,60,141
https://kawalpemilu.org#42051,"TAMANTIRTO, KASIHAN, BANTUL, DAERAH ISTIMEWA YOGYAKARTA",34,82,116,198
https://kawalpemilu.org#42051,"TAMANTIRTO, KASIHAN, BANTUL, DAERAH ISTIMEWA YOGYAKARTA",35,142,111,253
https://kawalpemilu.org#42051,"TAMANTIRTO, KASIHAN, BANTUL, DAERAH ISTIMEWA YOGYAKARTA",36,145,111,256
https://kawalpemilu.org#42051,"TAMANTIRTO, KASIHAN, BANTUL, DAERAH ISTIMEWA YOGYAKARTA",37,168,75,243
https://kawalpemilu.org#42051,"TAMANTIRTO, KASIHAN, BANTUL, DAERAH ISTIMEWA YOGYAKARTA",38,105,63,168
https://kawalpemilu.org#42051,"TAMANTIRTO, KASIHAN, BANTUL, DAERAH ISTIMEWA YOGYAKARTA",39,169,80,249
https://kawalpemilu.org#42051,"TAMANTIRTO, KASIHAN, BANTUL, DAERAH ISTIMEWA YOGYAKARTA",40,140,85,225
https://kawalpemilu.org#42051,"TAMANTIRTO, KASIHAN, BANTUL, DAERAH ISTIMEWA YOGYAKARTA",41,75,152,227
https://kawalpemilu.org#42051,"TAMANTIRTO, KASIHAN, BANTUL, DAERAH ISTIMEWA YOGYAKARTA",42,128,48,176
https://kawalpemilu.org#42051,"TAMANTIRTO, KASIHAN, BANTUL, DAERAH ISTIMEWA YOGYAKARTA",43,159,109,268
https://kawalpemilu.org#42051,"TAMANTIRTO, KASIHAN, BANTUL, DAERAH ISTIMEWA YOGYAKARTA",44,178,80,258
https://kawalpemilu.org#42051,"TAMANTIRTO, KASIHAN, BANTUL, DAERAH ISTIMEWA YOGYAKARTA",45,171,79,250
https://kawalpemilu.org#42051,"TAMANTIRTO, KASIHAN, BANTUL, DAERAH ISTIMEWA YOGYAKARTA",46,159,81,240
https://kawalpemilu.org#42051,"TAMANTIRTO, KASIHAN, BANTUL, DAERAH ISTIMEWA YOGYAKARTA",47,172,55,227
https://kawalpemilu.org#42051,"TAMANTIRTO, KASIHAN, BANTUL, DAERAH ISTIMEWA YOGYAKARTA",48,139,55,194
https://kawalpemilu.org#42051,"TAMANTIRTO, KASIHAN, BANTUL, DAERAH ISTIMEWA YOGYAKARTA",49,154,71,225
https://kawalpemilu.org#42051,"TAMANTIRTO, KASIHAN, BANTUL, DAERAH ISTIMEWA YOGYAKARTA",50,110,116,226
https://kawalpemilu.org#42051,"TAMANTIRTO, KASIHAN, BANTUL, DAERAH ISTIMEWA YOGYAKARTA",51,172,62,234
https://kawalpemilu.org#42051,"TAMANTIRTO, KASIHAN, BANTUL, DAERAH ISTIMEWA YOGYAKARTA",52,155,74,229
https://kawalpemilu.org#42051,"TAMANTIRTO, KASIHAN, BANTUL, DAERAH ISTIMEWA YOGYAKARTA",53,148,95,243
https://kawalpemilu.org#42051,"TAMANTIRTO, KASIHAN, BANTUL, DAERAH ISTIMEWA YOGYAKARTA",54,179,98,277
https://kawalpemilu.org#42051,"TAMANTIRTO, KASIHAN, BANTUL, DAERAH ISTIMEWA YOGYAKARTA",55,160,75,235
https://kawalpemilu.org#42051,"TAMANTIRTO, KASIHAN, BANTUL, DAERAH ISTIMEWA YOGYAKARTA",56,103,113,216
https://kawalpemilu.org#42051,"TAMANTIRTO, KASIHAN, BANTUL, DAERAH ISTIMEWA YOGYAKARTA",57,173,65,238
https://kawalpemilu.org#42051,"TAMANTIRTO, KASIHAN, BANTUL, DAERAH ISTIMEWA YOGYAKARTA",58,165,84,249
https://kawalpemilu.org#42051,"TAMANTIRTO, KASIHAN, BANTUL, DAERAH ISTIMEWA YOGYAKARTA",59,128,61,189
https://kawalpemilu.org#42051,"TAMANTIRTO, KASIHAN, BANTUL, DAERAH ISTIMEWA YOGYAKARTA",60,92,64,156
https://kawalpemilu.org#42051,"TAMANTIRTO, KASIHAN, BANTUL, DAERAH ISTIMEWA YOGYAKARTA",61,91,92,183
https://kawalpemilu.org#42051,"TAMANTIRTO, KASIHAN, BANTUL, DAERAH ISTIMEWA YOGYAKARTA",62,166,90,256
https://kawalpemilu.org#42051,"TAMANTIRTO, KASIHAN, BANTUL, DAERAH ISTIMEWA YOGYAKARTA",63,186,74,260
https://kawalpemilu.org#42051,"TAMANTIRTO, KASIHAN, BANTUL, DAERAH ISTIMEWA YOGYAKARTA",64,121,56,177
https://kawalpemilu.org#42051,"TAMANTIRTO, KASIHAN, BANTUL, DAERAH ISTIMEWA YOGYAKARTA",65,146,93,139
https://kawalpemilu.org#42051,"TAMANTIRTO, KASIHAN, BANTUL, DAERAH ISTIMEWA YOGYAKARTA",66,172,92,264
https://kawalpemilu.org#42051,"TAMANTIRTO, KASIHAN, BANTUL, DAERAH ISTIMEWA YOGYAKARTA",67,144,74,218
https://kawalpemilu.org#42051,"TAMANTIRTO, KASIHAN, BANTUL, DAERAH ISTIMEWA YOGYAKARTA",68,171,106,277
https://kawalpemilu.org#42051,"TAMANTIRTO, KASIHAN, BANTUL, DAERAH ISTIMEWA YOGYAKARTA",70,130,105,235
https://kawalpemilu.org#42051,"TAMANTIRTO, KASIHAN, BANTUL, DAERAH ISTIMEWA YOGYAKARTA",71,140,76,216
https://kawalpemilu.org#42052,"NGESTIHARJO, KASIHAN, BANTUL, DAERAH ISTIMEWA YOGYAKARTA",1,155,68,223
https://kawalpemilu.org#42052,"NGESTIHARJO, KASIHAN, BANTUL, DAERAH ISTIMEWA YOGYAKARTA",2,158,62,220
https://kawalpemilu.org#42052,"NGESTIHARJO, KASIHAN, BANTUL, DAERAH ISTIMEWA YOGYAKARTA",3,133,29,162
https://kawalpemilu.org#42052,"NGESTIHARJO, KASIHAN, BANTUL, DAERAH ISTIMEWA YOGYAKARTA",4,75,10,85
https://kawalpemilu.org#42052,"NGESTIHARJO, KASIHAN, BANTUL, DAERAH ISTIMEWA YOGYAKARTA",5,169,30,199
https://kawalpemilu.org#42052,"NGESTIHARJO, KASIHAN, BANTUL, DAERAH ISTIMEWA YOGYAKARTA",6,157,21,178
https://kawalpemilu.org#42052,"NGESTIHARJO, KASIHAN, BANTUL, DAERAH ISTIMEWA YOGYAKARTA",7,100,43,143
https://kawalpemilu.org#42052,"NGESTIHARJO, KASIHAN, BANTUL, DAERAH ISTIMEWA YOGYAKARTA",8,138,100,238
https://kawalpemilu.org#42052,"NGESTIHARJO, KASIHAN, BANTUL, DAERAH ISTIMEWA YOGYAKARTA",9,151,105,256
https://kawalpemilu.org#42052,"NGESTIHARJO, KASIHAN, BANTUL, DAERAH ISTIMEWA YOGYAKARTA",10,185,69,254
https://kawalpemilu.org#42052,"NGESTIHARJO, KASIHAN, BANTUL, DAERAH ISTIMEWA YOGYAKARTA",11,153,38,191
https://kawalpemilu.org#42052,"NGESTIHARJO, KASIHAN, BANTUL, DAERAH ISTIMEWA YOGYAKARTA",12,134,45,179
https://kawalpemilu.org#42052,"NGESTIHARJO, KASIHAN, BANTUL, DAERAH ISTIMEWA YOGYAKARTA",13,163,62,225
https://kawalpemilu.org#42052,"NGESTIHARJO, KASIHAN, BANTUL, DAERAH ISTIMEWA YOGYAKARTA",14,128,61,189
https://kawalpemilu.org#42052,"NGESTIHARJO, KASIHAN, BANTUL, DAERAH ISTIMEWA YOGYAKARTA",15,116,61,177
https://kawalpemilu.org#42052,"NGESTIHARJO, KASIHAN, BANTUL, DAERAH ISTIMEWA YOGYAKARTA",16,174,88,262
https://kawalpemilu.org#42052,"NGESTIHARJO, KASIHAN, BANTUL, DAERAH ISTIMEWA YOGYAKARTA",17,164,95,259
https://kawalpemilu.org#42052,"NGESTIHARJO, KASIHAN, BANTUL, DAERAH ISTIMEWA YOGYAKARTA",18,176,92,268
https://kawalpemilu.org#42052,"NGESTIHARJO, KASIHAN, BANTUL, DAERAH ISTIMEWA YOGYAKARTA",19,181,58,239
https://kawalpemilu.org#42052,"NGESTIHARJO, KASIHAN, BANTUL, DAERAH ISTIMEWA YOGYAKARTA",20,108,60,168
https://kawalpemilu.org#42052,"NGESTIHARJO, KASIHAN, BANTUL, DAERAH ISTIMEWA YOGYAKARTA",21,133,36,169
https://kawalpemilu.org#42052,"NGESTIHARJO, KASIHAN, BANTUL, DAERAH ISTIMEWA YOGYAKARTA",22,88,68,156
https://kawalpemilu.org#42052,"NGESTIHARJO, KASIHAN, BANTUL, DAERAH ISTIMEWA YOGYAKARTA",23,179,76,255
https://kawalpemilu.org#42052,"NGESTIHARJO, KASIHAN, BANTUL, DAERAH ISTIMEWA YOGYAKARTA",24,101,40,141
https://kawalpemilu.org#42052,"NGESTIHARJO, KASIHAN, BANTUL, DAERAH ISTIMEWA YOGYAKARTA",25,119,49,168
https://kawalpemilu.org#42052,"NGESTIHARJO, KASIHAN, BANTUL, DAERAH ISTIMEWA YOGYAKARTA",26,110,63,173
https://kawalpemilu.org#42052,"NGESTIHARJO, KASIHAN, BANTUL, DAERAH ISTIMEWA YOGYAKARTA",27,158,41,199
https://kawalpemilu.org#42052,"NGESTIHARJO, KASIHAN, BANTUL, DAERAH ISTIMEWA YOGYAKARTA",28,181,55,236
https://kawalpemilu.org#42052,"NGESTIHARJO, KASIHAN, BANTUL, DAERAH ISTIMEWA YOGYAKARTA",29,167,64,231
https://kawalpemilu.org#42052,"NGESTIHARJO, KASIHAN, BANTUL, DAERAH ISTIMEWA YOGYAKARTA",30,57,53,110
https://kawalpemilu.org#42052,"NGESTIHARJO, KASIHAN, BANTUL, DAERAH ISTIMEWA YOGYAKARTA",31,216,23,239
https://kawalpemilu.org#42052,"NGESTIHARJO, KASIHAN, BANTUL, DAERAH ISTIMEWA YOGYAKARTA",32,209,44,253
https://kawalpemilu.org#42052,"NGESTIHARJO, KASIHAN, BANTUL, DAERAH ISTIMEWA YOGYAKARTA",33,125,39,164
https://kawalpemilu.org#42052,"NGESTIHARJO, KASIHAN, BANTUL, DAERAH ISTIMEWA YOGYAKARTA",34,156,40,196
https://kawalpemilu.org#42052,"NGESTIHARJO, KASIHAN, BANTUL, DAERAH ISTIMEWA YOGYAKARTA",35,174,72,246
https://kawalpemilu.org#42052,"NGESTIHARJO, KASIHAN, BANTUL, DAERAH ISTIMEWA YOGYAKARTA",36,146,63,209
https://kawalpemilu.org#42052,"NGESTIHARJO, KASIHAN, BANTUL, DAERAH ISTIMEWA YOGYAKARTA",37,115,87,202
https://kawalpemilu.org#42052,"NGESTIHARJO, KASIHAN, BANTUL, DAERAH ISTIMEWA YOGYAKARTA",38,210,52,262
https://kawalpemilu.org#42052,"NGESTIHARJO, KASIHAN, BANTUL, DAERAH ISTIMEWA YOGYAKARTA",39,175,67,242
https://kawalpemilu.org#42052,"NGESTIHARJO, KASIHAN, BANTUL, DAERAH ISTIMEWA YOGYAKARTA",40,179,67,246
https://kawalpemilu.org#42052,"NGESTIHARJO, KASIHAN, BANTUL, DAERAH ISTIMEWA YOGYAKARTA",41,182,81,263
https://kawalpemilu.org#42052,"NGESTIHARJO, KASIHAN, BANTUL, DAERAH ISTIMEWA YOGYAKARTA",42,85,89,174
https://kawalpemilu.org#42052,"NGESTIHARJO, KASIHAN, BANTUL, DAERAH ISTIMEWA YOGYAKARTA",43,149,103,252
https://kawalpemilu.org#42052,"NGESTIHARJO, KASIHAN, BANTUL, DAERAH ISTIMEWA YOGYAKARTA",44,168,92,260
https://kawalpemilu.org#42052,"NGESTIHARJO, KASIHAN, BANTUL, DAERAH ISTIMEWA YOGYAKARTA",45,179,57,236
https://kawalpemilu.org#42052,"NGESTIHARJO, KASIHAN, BANTUL, DAERAH ISTIMEWA YOGYAKARTA",46,205,57,262
https://kawalpemilu.org#42052,"NGESTIHARJO, KASIHAN, BANTUL, DAERAH ISTIMEWA YOGYAKARTA",47,153,55,208
https://kawalpemilu.org#42052,"NGESTIHARJO, KASIHAN, BANTUL, DAERAH ISTIMEWA YOGYAKARTA",49,174,52,226
https://kawalpemilu.org#42052,"NGESTIHARJO, KASIHAN, BANTUL, DAERAH ISTIMEWA YOGYAKARTA",50,148,91,239
https://kawalpemilu.org#42052,"NGESTIHARJO, KASIHAN, BANTUL, DAERAH ISTIMEWA YOGYAKARTA",51,125,43,168
https://kawalpemilu.org#42052,"NGESTIHARJO, KASIHAN, BANTUL, DAERAH ISTIMEWA YOGYAKARTA",52,163,81,244
https://kawalpemilu.org#42052,"NGESTIHARJO, KASIHAN, BANTUL, DAERAH ISTIMEWA YOGYAKARTA",53,185,68,253
https://kawalpemilu.org#42052,"NGESTIHARJO, KASIHAN, BANTUL, DAERAH ISTIMEWA YOGYAKARTA",54,167,46,213
https://kawalpemilu.org#42052,"NGESTIHARJO, KASIHAN, BANTUL, DAERAH ISTIMEWA YOGYAKARTA",55,166,43,209
https://kawalpemilu.org#42052,"NGESTIHARJO, KASIHAN, BANTUL, DAERAH ISTIMEWA YOGYAKARTA",56,224,36,260
https://kawalpemilu.org#42052,"NGESTIHARJO, KASIHAN, BANTUL, DAERAH ISTIMEWA YOGYAKARTA",57,186,61,247
https://kawalpemilu.org#42052,"NGESTIHARJO, KASIHAN, BANTUL, DAERAH ISTIMEWA YOGYAKARTA",58,194,66,260
https://kawalpemilu.org#42052,"NGESTIHARJO, KASIHAN, BANTUL, DAERAH ISTIMEWA YOGYAKARTA",59,200,69,269
https://kawalpemilu.org#42052,"NGESTIHARJO, KASIHAN, BANTUL, DAERAH ISTIMEWA YOGYAKARTA",60,181,57,238
https://kawalpemilu.org#42052,"NGESTIHARJO, KASIHAN, BANTUL, DAERAH ISTIMEWA YOGYAKARTA",61,153,81,234
https://kawalpemilu.org#42052,"NGESTIHARJO, KASIHAN, BANTUL, DAERAH ISTIMEWA YOGYAKARTA",62,130,107,237
https://kawalpemilu.org#42052,"NGESTIHARJO, KASIHAN, BANTUL, DAERAH ISTIMEWA YOGYAKARTA",63,164,94,258
https://kawalpemilu.org#42052,"NGESTIHARJO, KASIHAN, BANTUL, DAERAH ISTIMEWA YOGYAKARTA",64,177,86,263
https://kawalpemilu.org#42052,"NGESTIHARJO, KASIHAN, BANTUL, DAERAH ISTIMEWA YOGYAKARTA",65,168,55,223
https://kawalpemilu.org#42052,"NGESTIHARJO, KASIHAN, BANTUL, DAERAH ISTIMEWA YOGYAKARTA",66,181,64,245
https://kawalpemilu.org#42052,"NGESTIHARJO, KASIHAN, BANTUL, DAERAH ISTIMEWA YOGYAKARTA",67,157,43,200
https://kawalpemilu.org#42052,"NGESTIHARJO, KASIHAN, BANTUL, DAERAH ISTIMEWA YOGYAKARTA",68,129,50,179
https://kawalpemilu.org#42052,"NGESTIHARJO, KASIHAN, BANTUL, DAERAH ISTIMEWA YOGYAKARTA",69,160,71,231
https://kawalpemilu.org#42052,"NGESTIHARJO, KASIHAN, BANTUL, DAERAH ISTIMEWA YOGYAKARTA",70,112,29,141
https://kawalpemilu.org#42052,"NGESTIHARJO, KASIHAN, BANTUL, DAERAH ISTIMEWA YOGYAKARTA",71,64,73,137
https://kawalpemilu.org#42052,"NGESTIHARJO, KASIHAN, BANTUL, DAERAH ISTIMEWA YOGYAKARTA",72,131,117,248
https://kawalpemilu.org#42052,"NGESTIHARJO, KASIHAN, BANTUL, DAERAH ISTIMEWA YOGYAKARTA",73,119,69,188
https://kawalpemilu.org#42052,"NGESTIHARJO, KASIHAN, BANTUL, DAERAH ISTIMEWA YOGYAKARTA",74,169,84,253
https://kawalpemilu.org#42052,"NGESTIHARJO, KASIHAN, BANTUL, DAERAH ISTIMEWA YOGYAKARTA",75,119,84,203
https://kawalpemilu.org#42052,"NGESTIHARJO, KASIHAN, BANTUL, DAERAH ISTIMEWA YOGYAKARTA",76,143,52,195
https://kawalpemilu.org#42052,"NGESTIHARJO, KASIHAN, BANTUL, DAERAH ISTIMEWA YOGYAKARTA",77,165,69,234
https://kawalpemilu.org#42052,"NGESTIHARJO, KASIHAN, BANTUL, DAERAH ISTIMEWA YOGYAKARTA",78,170,65,235
https://kawalpemilu.org#42052,"NGESTIHARJO, KASIHAN, BANTUL, DAERAH ISTIMEWA YOGYAKARTA",79,86,75,161
https://kawalpemilu.org#42052,"NGESTIHARJO, KASIHAN, BANTUL, DAERAH ISTIMEWA YOGYAKARTA",80,142,44,186
https://kawalpemilu.org#42052,"NGESTIHARJO, KASIHAN, BANTUL, DAERAH ISTIMEWA YOGYAKARTA",81,160,81,241
https://kawalpemilu.org#42052,"NGESTIHARJO, KASIHAN, BANTUL, DAERAH ISTIMEWA YOGYAKARTA",82,123,109,232
https://kawalpemilu.org#42052,"NGESTIHARJO, KASIHAN, BANTUL, DAERAH ISTIMEWA YOGYAKARTA",83,154,87,241
https://kawalpemilu.org#42052,"NGESTIHARJO, KASIHAN, BANTUL, DAERAH ISTIMEWA YOGYAKARTA",84,109,72,181
https://kawalpemilu.org#42052,"NGESTIHARJO, KASIHAN, BANTUL, DAERAH ISTIMEWA YOGYAKARTA",85,144,67,211
https://kawalpemilu.org#42052,"NGESTIHARJO, KASIHAN, BANTUL, DAERAH ISTIMEWA YOGYAKARTA",86,158,64,222
https://kawalpemilu.org#42052,"NGESTIHARJO, KASIHAN, BANTUL, DAERAH ISTIMEWA YOGYAKARTA",87,161,63,224
https://kawalpemilu.org#42052,"NGESTIHARJO, KASIHAN, BANTUL, DAERAH ISTIMEWA YOGYAKARTA",88,118,121,239
https://kawalpemilu.org#42052,"NGESTIHARJO, KASIHAN, BANTUL, DAERAH ISTIMEWA YOGYAKARTA",89,164,76,240
https://kawalpemilu.org#42052,"NGESTIHARJO, KASIHAN, BANTUL, DAERAH ISTIMEWA YOGYAKARTA",90,155,70,225
https://kawalpemilu.org#42052,"NGESTIHARJO, KASIHAN, BANTUL, DAERAH ISTIMEWA YOGYAKARTA",91,200,73,273
https://kawalpemilu.org#42052,"NGESTIHARJO, KASIHAN, BANTUL, DAERAH ISTIMEWA YOGYAKARTA",92,203,64,267
https://kawalpemilu.org#42054,"ARGODADI, SEDAYU, BANTUL, DAERAH ISTIMEWA YOGYAKARTA",1,172,50,222
https://kawalpemilu.org#42054,"ARGODADI, SEDAYU, BANTUL, DAERAH ISTIMEWA YOGYAKARTA",2,182,52,234
https://kawalpemilu.org#42054,"ARGODADI, SEDAYU, BANTUL, DAERAH ISTIMEWA YOGYAKARTA",3,165,46,211
https://kawalpemilu.org#42054,"ARGODADI, SEDAYU, BANTUL, DAERAH ISTIMEWA YOGYAKARTA",4,162,46,208
https://kawalpemilu.org#42054,"ARGODADI, SEDAYU, BANTUL, DAERAH ISTIMEWA YOGYAKARTA",5,176,25,201
https://kawalpemilu.org#42054,"ARGODADI, SEDAYU, BANTUL, DAERAH ISTIMEWA YOGYAKARTA",6,138,33,171
https://kawalpemilu.org#42054,"ARGODADI, SEDAYU, BANTUL, DAERAH ISTIMEWA YOGYAKARTA",7,162,40,202
https://kawalpemilu.org#42054,"ARGODADI, SEDAYU, BANTUL, DAERAH ISTIMEWA YOGYAKARTA",8,137,8,145
https://kawalpemilu.org#42054,"ARGODADI, SEDAYU, BANTUL, DAERAH ISTIMEWA YOGYAKARTA",9,155,21,176
https://kawalpemilu.org#42054,"ARGODADI, SEDAYU, BANTUL, DAERAH ISTIMEWA YOGYAKARTA",10,135,12,147
https://kawalpemilu.org#42054,"ARGODADI, SEDAYU, BANTUL, DAERAH ISTIMEWA YOGYAKARTA",11,160,12,172
https://kawalpemilu.org#42054,"ARGODADI, SEDAYU, BANTUL, DAERAH ISTIMEWA YOGYAKARTA",12,144,64,208
https://kawalpemilu.org#42054,"ARGODADI, SEDAYU, BANTUL, DAERAH ISTIMEWA YOGYAKARTA",13,102,88,190
https://kawalpemilu.org#42054,"ARGODADI, SEDAYU, BANTUL, DAERAH ISTIMEWA YOGYAKARTA",14,166,54,220
https://kawalpemilu.org#42054,"ARGODADI, SEDAYU, BANTUL, DAERAH ISTIMEWA YOGYAKARTA",15,145,26,171
https://kawalpemilu.org#42054,"ARGODADI, SEDAYU, BANTUL, DAERAH ISTIMEWA YOGYAKARTA",16,162,60,222
https://kawalpemilu.org#42054,"ARGODADI, SEDAYU, BANTUL, DAERAH ISTIMEWA YOGYAKARTA",17,194,44,238
https://kawalpemilu.org#42054,"ARGODADI, SEDAYU, BANTUL, DAERAH ISTIMEWA YOGYAKARTA",18,187,70,257
https://kawalpemilu.org#42054,"ARGODADI, SEDAYU, BANTUL, DAERAH ISTIMEWA YOGYAKARTA",19,158,72,230
https://kawalpemilu.org#42054,"ARGODADI, SEDAYU, BANTUL, DAERAH ISTIMEWA YOGYAKARTA",20,188,45,233
https://kawalpemilu.org#42054,"ARGODADI, SEDAYU, BANTUL, DAERAH ISTIMEWA YOGYAKARTA",21,114,87,201
https://kawalpemilu.org#42054,"ARGODADI, SEDAYU, BANTUL, DAERAH ISTIMEWA YOGYAKARTA",22,130,75,205
https://kawalpemilu.org#42054,"ARGODADI, SEDAYU, BANTUL, DAERAH ISTIMEWA YOGYAKARTA",23,134,52,186
https://kawalpemilu.org#42054,"ARGODADI, SEDAYU, BANTUL, DAERAH ISTIMEWA YOGYAKARTA",24,129,85,214
https://kawalpemilu.org#42054,"ARGODADI, SEDAYU, BANTUL, DAERAH ISTIMEWA YOGYAKARTA",25,157,67,224
https://kawalpemilu.org#42054,"ARGODADI, SEDAYU, BANTUL, DAERAH ISTIMEWA YOGYAKARTA",26,147,76,223
https://kawalpemilu.org#42054,"ARGODADI, SEDAYU, BANTUL, DAERAH ISTIMEWA YOGYAKARTA",27,130,41,171
https://kawalpemilu.org#42054,"ARGODADI, SEDAYU, BANTUL, DAERAH ISTIMEWA YOGYAKARTA",28,132,95,227
https://kawalpemilu.org#42054,"ARGODADI, SEDAYU, BANTUL, DAERAH ISTIMEWA YOGYAKARTA",29,106,94,200
https://kawalpemilu.org#42054,"ARGODADI, SEDAYU, BANTUL, DAERAH ISTIMEWA YOGYAKARTA",30,94,56,150
https://kawalpemilu.org#42054,"ARGODADI, SEDAYU, BANTUL, DAERAH ISTIMEWA YOGYAKARTA",31,103,123,226
https://kawalpemilu.org#42054,"ARGODADI, SEDAYU, BANTUL, DAERAH ISTIMEWA YOGYAKARTA",33,139,36,175
https://kawalpemilu.org#42054,"ARGODADI, SEDAYU, BANTUL, DAERAH ISTIMEWA YOGYAKARTA",34,125,46,171
https://kawalpemilu.org#42054,"ARGODADI, SEDAYU, BANTUL, DAERAH ISTIMEWA YOGYAKARTA",35,151,93,244
https://kawalpemilu.org#42054,"ARGODADI, SEDAYU, BANTUL, DAERAH ISTIMEWA YOGYAKARTA",36,149,52,201
https://kawalpemilu.org#42054,"ARGODADI, SEDAYU, BANTUL, DAERAH ISTIMEWA YOGYAKARTA",37,172,52,224
https://kawalpemilu.org#42054,"ARGODADI, SEDAYU, BANTUL, DAERAH ISTIMEWA YOGYAKARTA",38,168,67,235
https://kawalpemilu.org#42054,"ARGODADI, SEDAYU, BANTUL, DAERAH ISTIMEWA YOGYAKARTA",39,154,51,205
https://kawalpemilu.org#42055,"ARGOREJO, SEDAYU, BANTUL, DAERAH ISTIMEWA YOGYAKARTA",1,124,56,180
https://kawalpemilu.org#42055,"ARGOREJO, SEDAYU, BANTUL, DAERAH ISTIMEWA YOGYAKARTA",2,135,62,197
https://kawalpemilu.org#42055,"ARGOREJO, SEDAYU, BANTUL, DAERAH ISTIMEWA YOGYAKARTA",3,154,38,192
https://kawalpemilu.org#42055,"ARGOREJO, SEDAYU, BANTUL, DAERAH ISTIMEWA YOGYAKARTA",4,107,28,135
https://kawalpemilu.org#42055,"ARGOREJO, SEDAYU, BANTUL, DAERAH ISTIMEWA YOGYAKARTA",5,142,88,230
https://kawalpemilu.org#42055,"ARGOREJO, SEDAYU, BANTUL, DAERAH ISTIMEWA YOGYAKARTA",6,132,113,245
https://kawalpemilu.org#42055,"ARGOREJO, SEDAYU, BANTUL, DAERAH ISTIMEWA YOGYAKARTA",7,62,49,111
https://kawalpemilu.org#42055,"ARGOREJO, SEDAYU, BANTUL, DAERAH ISTIMEWA YOGYAKARTA",8,112,61,173
https://kawalpemilu.org#42055,"ARGOREJO, SEDAYU, BANTUL, DAERAH ISTIMEWA YOGYAKARTA",9,120,123,243
https://kawalpemilu.org#42055,"ARGOREJO, SEDAYU, BANTUL, DAERAH ISTIMEWA YOGYAKARTA",10,154,88,242
https://kawalpemilu.org#42055,"ARGOREJO, SEDAYU, BANTUL, DAERAH ISTIMEWA YOGYAKARTA",11,164,76,240
https://kawalpemilu.org#42055,"ARGOREJO, SEDAYU, BANTUL, DAERAH ISTIMEWA YOGYAKARTA",12,109,72,181
https://kawalpemilu.org#42055,"ARGOREJO, SEDAYU, BANTUL, DAERAH ISTIMEWA YOGYAKARTA",13,122,18,140
https://kawalpemilu.org#42055,"ARGOREJO, SEDAYU, BANTUL, DAERAH ISTIMEWA YOGYAKARTA",14,108,53,161
https://kawalpemilu.org#42055,"ARGOREJO, SEDAYU, BANTUL, DAERAH ISTIMEWA YOGYAKARTA",15,99,66,165
https://kawalpemilu.org#42055,"ARGOREJO, SEDAYU, BANTUL, DAERAH ISTIMEWA YOGYAKARTA",16,167,92,259
https://kawalpemilu.org#42055,"ARGOREJO, SEDAYU, BANTUL, DAERAH ISTIMEWA YOGYAKARTA",17,167,82,249
https://kawalpemilu.org#42055,"ARGOREJO, SEDAYU, BANTUL, DAERAH ISTIMEWA YOGYAKARTA",18,128,109,237
https://kawalpemilu.org#42055,"ARGOREJO, SEDAYU, BANTUL, DAERAH ISTIMEWA YOGYAKARTA",19,102,143,245
https://kawalpemilu.org#42055,"ARGOREJO, SEDAYU, BANTUL, DAERAH ISTIMEWA YOGYAKARTA",20,112,112,224
https://kawalpemilu.org#42055,"ARGOREJO, SEDAYU, BANTUL, DAERAH ISTIMEWA YOGYAKARTA",21,59,67,126
https://kawalpemilu.org#42055,"ARGOREJO, SEDAYU, BANTUL, DAERAH ISTIMEWA YOGYAKARTA",22,84,57,141
https://kawalpemilu.org#42055,"ARGOREJO, SEDAYU, BANTUL, DAERAH ISTIMEWA YOGYAKARTA",23,120,113,233
https://kawalpemilu.org#42055,"ARGOREJO, SEDAYU, BANTUL, DAERAH ISTIMEWA YOGYAKARTA",24,95,89,184
https://kawalpemilu.org#42055,"ARGOREJO, SEDAYU, BANTUL, DAERAH ISTIMEWA YOGYAKARTA",25,137,14,151
https://kawalpemilu.org#42055,"ARGOREJO, SEDAYU, BANTUL, DAERAH ISTIMEWA YOGYAKARTA",26,170,61,231
https://kawalpemilu.org#42055,"ARGOREJO, SEDAYU, BANTUL, DAERAH ISTIMEWA YOGYAKARTA",27,150,66,216
https://kawalpemilu.org#42055,"ARGOREJO, SEDAYU, BANTUL, DAERAH ISTIMEWA YOGYAKARTA",28,142,95,237
https://kawalpemilu.org#42055,"ARGOREJO, SEDAYU, BANTUL, DAERAH ISTIMEWA YOGYAKARTA",29,150,66,216
https://kawalpemilu.org#42055,"ARGOREJO, SEDAYU, BANTUL, DAERAH ISTIMEWA YOGYAKARTA",30,137,106,243
https://kawalpemilu.org#42055,"ARGOREJO, SEDAYU, BANTUL, DAERAH ISTIMEWA YOGYAKARTA",31,151,90,241
https://kawalpemilu.org#42055,"ARGOREJO, SEDAYU, BANTUL, DAERAH ISTIMEWA YOGYAKARTA",32,146,113,259
https://kawalpemilu.org#42055,"ARGOREJO, SEDAYU, BANTUL, DAERAH ISTIMEWA YOGYAKARTA",33,123,53,176
https://kawalpemilu.org#42055,"ARGOREJO, SEDAYU, BANTUL, DAERAH ISTIMEWA YOGYAKARTA",34,96,95,191
https://kawalpemilu.org#42055,"ARGOREJO, SEDAYU, BANTUL, DAERAH ISTIMEWA YOGYAKARTA",35,106,131,237
https://kawalpemilu.org#42055,"ARGOREJO, SEDAYU, BANTUL, DAERAH ISTIMEWA YOGYAKARTA",36,137,104,241
https://kawalpemilu.org#42055,"ARGOREJO, SEDAYU, BANTUL, DAERAH ISTIMEWA YOGYAKARTA",37,83,75,158
https://kawalpemilu.org#42055,"ARGOREJO, SEDAYU, BANTUL, DAERAH ISTIMEWA YOGYAKARTA",38,123,121,244
https://kawalpemilu.org#42055,"ARGOREJO, SEDAYU, BANTUL, DAERAH ISTIMEWA YOGYAKARTA",39,114,150,264
https://kawalpemilu.org#42056,"ARGOSARI, SEDAYU, BANTUL, DAERAH ISTIMEWA YOGYAKARTA",1,148,38,186
https://kawalpemilu.org#42056,"ARGOSARI, SEDAYU, BANTUL, DAERAH ISTIMEWA YOGYAKARTA",2,96,51,147
https://kawalpemilu.org#42056,"ARGOSARI, SEDAYU, BANTUL, DAERAH ISTIMEWA YOGYAKARTA",3,124,47,171
https://kawalpemilu.org#42056,"ARGOSARI, SEDAYU, BANTUL, DAERAH ISTIMEWA YOGYAKARTA",4,140,61,201
https://kawalpemilu.org#42056,"ARGOSARI, SEDAYU, BANTUL, DAERAH ISTIMEWA YOGYAKARTA",5,123,93,216
https://kawalpemilu.org#42056,"ARGOSARI, SEDAYU, BANTUL, DAERAH ISTIMEWA YOGYAKARTA",6,125,113,238
https://kawalpemilu.org#42056,"ARGOSARI, SEDAYU, BANTUL, DAERAH ISTIMEWA YOGYAKARTA",7,138,46,184
https://kawalpemilu.org#42056,"ARGOSARI, SEDAYU, BANTUL, DAERAH ISTIMEWA YOGYAKARTA",8,145,96,241
https://kawalpemilu.org#42056,"ARGOSARI, SEDAYU, BANTUL, DAERAH ISTIMEWA YOGYAKARTA",9,161,53,214
https://kawalpemilu.org#42056,"ARGOSARI, SEDAYU, BANTUL, DAERAH ISTIMEWA YOGYAKARTA",10,125,57,182
https://kawalpemilu.org#42056,"ARGOSARI, SEDAYU, BANTUL, DAERAH ISTIMEWA YOGYAKARTA",11,123,109,232
https://kawalpemilu.org#42056,"ARGOSARI, SEDAYU, BANTUL, DAERAH ISTIMEWA YOGYAKARTA",12,143,39,182
https://kawalpemilu.org#42056,"ARGOSARI, SEDAYU, BANTUL, DAERAH ISTIMEWA YOGYAKARTA",13,132,66,198
https://kawalpemilu.org#42056,"ARGOSARI, SEDAYU, BANTUL, DAERAH ISTIMEWA YOGYAKARTA",14,139,90,229
https://kawalpemilu.org#42056,"ARGOSARI, SEDAYU, BANTUL, DAERAH ISTIMEWA YOGYAKARTA",15,134,44,178
https://kawalpemilu.org#42056,"ARGOSARI, SEDAYU, BANTUL, DAERAH ISTIMEWA YOGYAKARTA",16,128,67,195
https://kawalpemilu.org#42056,"ARGOSARI, SEDAYU, BANTUL, DAERAH ISTIMEWA YOGYAKARTA",17,169,83,252
https://kawalpemilu.org#42056,"ARGOSARI, SEDAYU, BANTUL, DAERAH ISTIMEWA YOGYAKARTA",18,125,84,209
https://kawalpemilu.org#42056,"ARGOSARI, SEDAYU, BANTUL, DAERAH ISTIMEWA YOGYAKARTA",19,113,78,191
https://kawalpemilu.org#42056,"ARGOSARI, SEDAYU, BANTUL, DAERAH ISTIMEWA YOGYAKARTA",20,115,50,165
https://kawalpemilu.org#42056,"ARGOSARI, SEDAYU, BANTUL, DAERAH ISTIMEWA YOGYAKARTA",21,165,45,210
https://kawalpemilu.org#42056,"ARGOSARI, SEDAYU, BANTUL, DAERAH ISTIMEWA YOGYAKARTA",22,140,52,192
https://kawalpemilu.org#42056,"ARGOSARI, SEDAYU, BANTUL, DAERAH ISTIMEWA YOGYAKARTA",23,162,66,228
https://kawalpemilu.org#42056,"ARGOSARI, SEDAYU, BANTUL, DAERAH ISTIMEWA YOGYAKARTA",24,180,12,192
https://kawalpemilu.org#42056,"ARGOSARI, SEDAYU, BANTUL, DAERAH ISTIMEWA YOGYAKARTA",25,192,37,229
https://kawalpemilu.org#42056,"ARGOSARI, SEDAYU, BANTUL, DAERAH ISTIMEWA YOGYAKARTA",26,86,58,144
https://kawalpemilu.org#42056,"ARGOSARI, SEDAYU, BANTUL, DAERAH ISTIMEWA YOGYAKARTA",27,125,24,149
https://kawalpemilu.org#42056,"ARGOSARI, SEDAYU, BANTUL, DAERAH ISTIMEWA YOGYAKARTA",28,140,26,166
https://kawalpemilu.org#42056,"ARGOSARI, SEDAYU, BANTUL, DAERAH ISTIMEWA YOGYAKARTA",29,131,86,217
https://kawalpemilu.org#42056,"ARGOSARI, SEDAYU, BANTUL, DAERAH ISTIMEWA YOGYAKARTA",30,144,56,200
https://kawalpemilu.org#42056,"ARGOSARI, SEDAYU, BANTUL, DAERAH ISTIMEWA YOGYAKARTA",31,96,59,155
https://kawalpemilu.org#42057,"ARGOMULYO, SEDAYU, BANTUL, DAERAH ISTIMEWA YOGYAKARTA",1,129,110,239
https://kawalpemilu.org#42057,"ARGOMULYO, SEDAYU, BANTUL, DAERAH ISTIMEWA YOGYAKARTA",2,98,125,223
https://kawalpemilu.org#42057,"ARGOMULYO, SEDAYU, BANTUL, DAERAH ISTIMEWA YOGYAKARTA",3,87,89,176
https://kawalpemilu.org#42057,"ARGOMULYO, SEDAYU, BANTUL, DAERAH ISTIMEWA YOGYAKARTA",4,115,65,180
https://kawalpemilu.org#42057,"ARGOMULYO, SEDAYU, BANTUL, DAERAH ISTIMEWA YOGYAKARTA",5,94,67,161
https://kawalpemilu.org#42057,"ARGOMULYO, SEDAYU, BANTUL, DAERAH ISTIMEWA YOGYAKARTA",6,50,102,152
https://kawalpemilu.org#42057,"ARGOMULYO, SEDAYU, BANTUL, DAERAH ISTIMEWA YOGYAKARTA",7,69,127,196
https://kawalpemilu.org#42057,"ARGOMULYO, SEDAYU, BANTUL, DAERAH ISTIMEWA YOGYAKARTA",8,30,88,118
https://kawalpemilu.org#42057,"ARGOMULYO, SEDAYU, BANTUL, DAERAH ISTIMEWA YOGYAKARTA",9,54,140,194
https://kawalpemilu.org#42057,"ARGOMULYO, SEDAYU, BANTUL, DAERAH ISTIMEWA YOGYAKARTA",10,44,150,194
https://kawalpemilu.org#42057,"ARGOMULYO, SEDAYU, BANTUL, DAERAH ISTIMEWA YOGYAKARTA",11,17,103,120
https://kawalpemilu.org#42057,"ARGOMULYO, SEDAYU, BANTUL, DAERAH ISTIMEWA YOGYAKARTA",12,54,188,242
https://kawalpemilu.org#42057,"ARGOMULYO, SEDAYU, BANTUL, DAERAH ISTIMEWA YOGYAKARTA",13,48,113,161
https://kawalpemilu.org#42057,"ARGOMULYO, SEDAYU, BANTUL, DAERAH ISTIMEWA YOGYAKARTA",14,106,123,229
https://kawalpemilu.org#42057,"ARGOMULYO, SEDAYU, BANTUL, DAERAH ISTIMEWA YOGYAKARTA",15,120,145,265
https://kawalpemilu.org#42057,"ARGOMULYO, SEDAYU, BANTUL, DAERAH ISTIMEWA YOGYAKARTA",16,127,106,233
https://kawalpemilu.org#42057,"ARGOMULYO, SEDAYU, BANTUL, DAERAH ISTIMEWA YOGYAKARTA",17,85,136,221
https://kawalpemilu.org#42057,"ARGOMULYO, SEDAYU, BANTUL, DAERAH ISTIMEWA YOGYAKARTA",18,142,104,246
https://kawalpemilu.org#42057,"ARGOMULYO, SEDAYU, BANTUL, DAERAH ISTIMEWA YOGYAKARTA",19,136,93,229
https://kawalpemilu.org#42057,"ARGOMULYO, SEDAYU, BANTUL, DAERAH ISTIMEWA YOGYAKARTA",20,165,87,252
https://kawalpemilu.org#42057,"ARGOMULYO, SEDAYU, BANTUL, DAERAH ISTIMEWA YOGYAKARTA",21,106,55,161
https://kawalpemilu.org#42057,"ARGOMULYO, SEDAYU, BANTUL, DAERAH ISTIMEWA YOGYAKARTA",22,103,119,222
https://kawalpemilu.org#42057,"ARGOMULYO, SEDAYU, BANTUL, DAERAH ISTIMEWA YOGYAKARTA",23,49,160,209
https://kawalpemilu.org#42057,"ARGOMULYO, SEDAYU, BANTUL, DAERAH ISTIMEWA YOGYAKARTA",24,119,37,156
https://kawalpemilu.org#42057,"ARGOMULYO, SEDAYU, BANTUL, DAERAH ISTIMEWA YOGYAKARTA",25,119,134,253
https://kawalpemilu.org#42057,"ARGOMULYO, SEDAYU, BANTUL, DAERAH ISTIMEWA YOGYAKARTA",26,160,103,263
https://kawalpemilu.org#42057,"ARGOMULYO, SEDAYU, BANTUL, DAERAH ISTIMEWA YOGYAKARTA",27,104,89,193
https://kawalpemilu.org#42057,"ARGOMULYO, SEDAYU, BANTUL, DAERAH ISTIMEWA YOGYAKARTA",28,81,96,177
https://kawalpemilu.org#42057,"ARGOMULYO, SEDAYU, BANTUL, DAERAH ISTIMEWA YOGYAKARTA",29,126,104,230
https://kawalpemilu.org#42057,"ARGOMULYO, SEDAYU, BANTUL, DAERAH ISTIMEWA YOGYAKARTA",30,145,100,245
https://kawalpemilu.org#42057,"ARGOMULYO, SEDAYU, BANTUL, DAERAH ISTIMEWA YOGYAKARTA",31,166,83,249
https://kawalpemilu.org#42057,"ARGOMULYO, SEDAYU, BANTUL, DAERAH ISTIMEWA YOGYAKARTA",32,93,154,247
https://kawalpemilu.org#42057,"ARGOMULYO, SEDAYU, BANTUL, DAERAH ISTIMEWA YOGYAKARTA",33,125,132,257
https://kawalpemilu.org#42057,"ARGOMULYO, SEDAYU, BANTUL, DAERAH ISTIMEWA YOGYAKARTA",34,128,123,251
https://kawalpemilu.org#42057,"ARGOMULYO, SEDAYU, BANTUL, DAERAH ISTIMEWA YOGYAKARTA",35,106,69,175
https://kawalpemilu.org#42057,"ARGOMULYO, SEDAYU, BANTUL, DAERAH ISTIMEWA YOGYAKARTA",36,136,116,252
https://kawalpemilu.org#42057,"ARGOMULYO, SEDAYU, BANTUL, DAERAH ISTIMEWA YOGYAKARTA",37,132,68,200
https://kawalpemilu.org#42057,"ARGOMULYO, SEDAYU, BANTUL, DAERAH ISTIMEWA YOGYAKARTA",38,114,47,161
https://kawalpemilu.org#42057,"ARGOMULYO, SEDAYU, BANTUL, DAERAH ISTIMEWA YOGYAKARTA",39,120,98,218
https://kawalpemilu.org#42057,"ARGOMULYO, SEDAYU, BANTUL, DAERAH ISTIMEWA YOGYAKARTA",40,139,100,239
https://kawalpemilu.org#42057,"ARGOMULYO, SEDAYU, BANTUL, DAERAH ISTIMEWA YOGYAKARTA",41,102,123,225
https://kawalpemilu.org#42057,"ARGOMULYO, SEDAYU, BANTUL, DAERAH ISTIMEWA YOGYAKARTA",42,89,143,232
https://kawalpemilu.org#42057,"ARGOMULYO, SEDAYU, BANTUL, DAERAH ISTIMEWA YOGYAKARTA",43,94,69,163
https://kawalpemilu.org#42057,"ARGOMULYO, SEDAYU, BANTUL, DAERAH ISTIMEWA YOGYAKARTA",44,98,63,161
https://kawalpemilu.org#42057,"ARGOMULYO, SEDAYU, BANTUL, DAERAH ISTIMEWA YOGYAKARTA",45,53,95,148
https://kawalpemilu.org#42057,"ARGOMULYO, SEDAYU, BANTUL, DAERAH ISTIMEWA YOGYAKARTA",46,83,116,199
https://kawalpemilu.org#42060,"WONOSARI, WONOSARI, GUNUNGKIDUL, DAERAH ISTIMEWA YOGYAKARTA",1,132,77,209
https://kawalpemilu.org#42060,"WONOSARI, WONOSARI, GUNUNGKIDUL, DAERAH ISTIMEWA YOGYAKARTA",2,136,95,231
https://kawalpemilu.org#42060,"WONOSARI, WONOSARI, GUNUNGKIDUL, DAERAH ISTIMEWA YOGYAKARTA",3,129,43,172
https://kawalpemilu.org#42060,"WONOSARI, WONOSARI, GUNUNGKIDUL, DAERAH ISTIMEWA YOGYAKARTA",4,135,65,200
https://kawalpemilu.org#42060,"WONOSARI, WONOSARI, GUNUNGKIDUL, DAERAH ISTIMEWA YOGYAKARTA",5,134,56,190
https://kawalpemilu.org#42060,"WONOSARI, WONOSARI, GUNUNGKIDUL, DAERAH ISTIMEWA YOGYAKARTA",6,136,53,189
https://kawalpemilu.org#42060,"WONOSARI, WONOSARI, GUNUNGKIDUL, DAERAH ISTIMEWA YOGYAKARTA",7,134,100,234
https://kawalpemilu.org#42060,"WONOSARI, WONOSARI, GUNUNGKIDUL, DAERAH ISTIMEWA YOGYAKARTA",8,186,44,230
https://kawalpemilu.org#42060,"WONOSARI, WONOSARI, GUNUNGKIDUL, DAERAH ISTIMEWA YOGYAKARTA",9,127,50,177
https://kawalpemilu.org#42060,"WONOSARI, WONOSARI, GUNUNGKIDUL, DAERAH ISTIMEWA YOGYAKARTA",10,183,50,233
https://kawalpemilu.org#42060,"WONOSARI, WONOSARI, GUNUNGKIDUL, DAERAH ISTIMEWA YOGYAKARTA",11,139,54,193
https://kawalpemilu.org#42060,"WONOSARI, WONOSARI, GUNUNGKIDUL, DAERAH ISTIMEWA YOGYAKARTA",12,195,65,260
https://kawalpemilu.org#42060,"WONOSARI, WONOSARI, GUNUNGKIDUL, DAERAH ISTIMEWA YOGYAKARTA",13,151,70,221
https://kawalpemilu.org#42060,"WONOSARI, WONOSARI, GUNUNGKIDUL, DAERAH ISTIMEWA YOGYAKARTA",14,145,59,204
https://kawalpemilu.org#42060,"WONOSARI, WONOSARI, GUNUNGKIDUL, DAERAH ISTIMEWA YOGYAKARTA",15,208,33,241
https://kawalpemilu.org#42060,"WONOSARI, WONOSARI, GUNUNGKIDUL, DAERAH ISTIMEWA YOGYAKARTA",16,153,108,261
https://kawalpemilu.org#42060,"WONOSARI, WONOSARI, GUNUNGKIDUL, DAERAH ISTIMEWA YOGYAKARTA",17,196,57,253
https://kawalpemilu.org#42060,"WONOSARI, WONOSARI, GUNUNGKIDUL, DAERAH ISTIMEWA YOGYAKARTA",18,179,70,249
https://kawalpemilu.org#42060,"WONOSARI, WONOSARI, GUNUNGKIDUL, DAERAH ISTIMEWA YOGYAKARTA",19,188,37,225
https://kawalpemilu.org#42060,"WONOSARI, WONOSARI, GUNUNGKIDUL, DAERAH ISTIMEWA YOGYAKARTA",20,136,58,194
https://kawalpemilu.org#42060,"WONOSARI, WONOSARI, GUNUNGKIDUL, DAERAH ISTIMEWA YOGYAKARTA",21,140,58,198
https://kawalpemilu.org#42060,"WONOSARI, WONOSARI, GUNUNGKIDUL, DAERAH ISTIMEWA YOGYAKARTA",22,160,55,215
https://kawalpemilu.org#42060,"WONOSARI, WONOSARI, GUNUNGKIDUL, DAERAH ISTIMEWA YOGYAKARTA",23,87,112,199
https://kawalpemilu.org#42060,"WONOSARI, WONOSARI, GUNUNGKIDUL, DAERAH ISTIMEWA YOGYAKARTA",24,160,87,247
https://kawalpemilu.org#42060,"WONOSARI, WONOSARI, GUNUNGKIDUL, DAERAH ISTIMEWA YOGYAKARTA",25,118,65,183
https://kawalpemilu.org#42060,"WONOSARI, WONOSARI, GUNUNGKIDUL, DAERAH ISTIMEWA YOGYAKARTA",26,169,73,242
https://kawalpemilu.org#42060,"WONOSARI, WONOSARI, GUNUNGKIDUL, DAERAH ISTIMEWA YOGYAKARTA",27,121,75,196
https://kawalpemilu.org#42060,"WONOSARI, WONOSARI, GUNUNGKIDUL, DAERAH ISTIMEWA YOGYAKARTA",28,156,88,244
https://kawalpemilu.org#42061,"KEPEK, WONOSARI, GUNUNGKIDUL, DAERAH ISTIMEWA YOGYAKARTA",1,138,87,225
https://kawalpemilu.org#42061,"KEPEK, WONOSARI, GUNUNGKIDUL, DAERAH ISTIMEWA YOGYAKARTA",2,147,93,240
https://kawalpemilu.org#42061,"KEPEK, WONOSARI, GUNUNGKIDUL, DAERAH ISTIMEWA YOGYAKARTA",3,175,89,264
https://kawalpemilu.org#42061,"KEPEK, WONOSARI, GUNUNGKIDUL, DAERAH ISTIMEWA YOGYAKARTA",4,208,50,258
https://kawalpemilu.org#42061,"KEPEK, WONOSARI, GUNUNGKIDUL, DAERAH ISTIMEWA YOGYAKARTA",5,201,73,274
https://kawalpemilu.org#42061,"KEPEK, WONOSARI, GUNUNGKIDUL, DAERAH ISTIMEWA YOGYAKARTA",6,195,63,258
https://kawalpemilu.org#42061,"KEPEK, WONOSARI, GUNUNGKIDUL, DAERAH ISTIMEWA YOGYAKARTA",7,162,82,244
https://kawalpemilu.org#42061,"KEPEK, WONOSARI, GUNUNGKIDUL, DAERAH ISTIMEWA YOGYAKARTA",8,162,38,200
https://kawalpemilu.org#42061,"KEPEK, WONOSARI, GUNUNGKIDUL, DAERAH ISTIMEWA YOGYAKARTA",9,153,79,232
https://kawalpemilu.org#42061,"KEPEK, WONOSARI, GUNUNGKIDUL, DAERAH ISTIMEWA YOGYAKARTA",10,134,78,212
https://kawalpemilu.org#42061,"KEPEK, WONOSARI, GUNUNGKIDUL, DAERAH ISTIMEWA YOGYAKARTA",11,213,51,264
https://kawalpemilu.org#42061,"KEPEK, WONOSARI, GUNUNGKIDUL, DAERAH ISTIMEWA YOGYAKARTA",12,148,67,215
https://kawalpemilu.org#42061,"KEPEK, WONOSARI, GUNUNGKIDUL, DAERAH ISTIMEWA YOGYAKARTA",13,118,79,197
https://kawalpemilu.org#42061,"KEPEK, WONOSARI, GUNUNGKIDUL, DAERAH ISTIMEWA YOGYAKARTA",14,123,84,207
https://kawalpemilu.org#42061,"KEPEK, WONOSARI, GUNUNGKIDUL, DAERAH ISTIMEWA YOGYAKARTA",15,146,78,224
https://kawalpemilu.org#42061,"KEPEK, WONOSARI, GUNUNGKIDUL, DAERAH ISTIMEWA YOGYAKARTA",16,127,53,180
https://kawalpemilu.org#42061,"KEPEK, WONOSARI, GUNUNGKIDUL, DAERAH ISTIMEWA YOGYAKARTA",17,160,82,242
https://kawalpemilu.org#42061,"KEPEK, WONOSARI, GUNUNGKIDUL, DAERAH ISTIMEWA YOGYAKARTA",18,159,97,256
https://kawalpemilu.org#42061,"KEPEK, WONOSARI, GUNUNGKIDUL, DAERAH ISTIMEWA YOGYAKARTA",19,177,64,241
https://kawalpemilu.org#42061,"KEPEK, WONOSARI, GUNUNGKIDUL, DAERAH ISTIMEWA YOGYAKARTA",20,134,101,235
https://kawalpemilu.org#42061,"KEPEK, WONOSARI, GUNUNGKIDUL, DAERAH ISTIMEWA YOGYAKARTA",21,94,123,217
https://kawalpemilu.org#42061,"KEPEK, WONOSARI, GUNUNGKIDUL, DAERAH ISTIMEWA YOGYAKARTA",22,152,94,246
https://kawalpemilu.org#42061,"KEPEK, WONOSARI, GUNUNGKIDUL, DAERAH ISTIMEWA YOGYAKARTA",23,117,113,230
https://kawalpemilu.org#42061,"KEPEK, WONOSARI, GUNUNGKIDUL, DAERAH ISTIMEWA YOGYAKARTA",24,143,93,236
https://kawalpemilu.org#42061,"KEPEK, WONOSARI, GUNUNGKIDUL, DAERAH ISTIMEWA YOGYAKARTA",25,117,85,202
https://kawalpemilu.org#42061,"KEPEK, WONOSARI, GUNUNGKIDUL, DAERAH ISTIMEWA YOGYAKARTA",26,109,86,195
https://kawalpemilu.org#42061,"KEPEK, WONOSARI, GUNUNGKIDUL, DAERAH ISTIMEWA YOGYAKARTA",27,149,113,262
https://kawalpemilu.org#42061,"KEPEK, WONOSARI, GUNUNGKIDUL, DAERAH ISTIMEWA YOGYAKARTA",28,152,93,245
https://kawalpemilu.org#42061,"KEPEK, WONOSARI, GUNUNGKIDUL, DAERAH ISTIMEWA YOGYAKARTA",29,132,88,220
https://kawalpemilu.org#42061,"KEPEK, WONOSARI, GUNUNGKIDUL, DAERAH ISTIMEWA YOGYAKARTA",30,110,39,149
https://kawalpemilu.org#42061,"KEPEK, WONOSARI, GUNUNGKIDUL, DAERAH ISTIMEWA YOGYAKARTA",31,103,90,193
https://kawalpemilu.org#42061,"KEPEK, WONOSARI, GUNUNGKIDUL, DAERAH ISTIMEWA YOGYAKARTA",32,127,114,241
https://kawalpemilu.org#42061,"KEPEK, WONOSARI, GUNUNGKIDUL, DAERAH ISTIMEWA YOGYAKARTA",33,139,77,216
https://kawalpemilu.org#42062,"PIYAMAN, WONOSARI, GUNUNGKIDUL, DAERAH ISTIMEWA YOGYAKARTA",1,193,51,244
https://kawalpemilu.org#42062,"PIYAMAN, WONOSARI, GUNUNGKIDUL, DAERAH ISTIMEWA YOGYAKARTA",2,70,89,159
https://kawalpemilu.org#42062,"PIYAMAN, WONOSARI, GUNUNGKIDUL, DAERAH ISTIMEWA YOGYAKARTA",3,83,76,159
https://kawalpemilu.org#42062,"PIYAMAN, WONOSARI, GUNUNGKIDUL, DAERAH ISTIMEWA YOGYAKARTA",4,157,81,238
https://kawalpemilu.org#42062,"PIYAMAN, WONOSARI, GUNUNGKIDUL, DAERAH ISTIMEWA YOGYAKARTA",5,166,54,220
https://kawalpemilu.org#42062,"PIYAMAN, WONOSARI, GUNUNGKIDUL, DAERAH ISTIMEWA YOGYAKARTA",6,118,75,193
https://kawalpemilu.org#42062,"PIYAMAN, WONOSARI, GUNUNGKIDUL, DAERAH ISTIMEWA YOGYAKARTA",7,144,113,257
https://kawalpemilu.org#42062,"PIYAMAN, WONOSARI, GUNUNGKIDUL, DAERAH ISTIMEWA YOGYAKARTA",8,77,74,151
https://kawalpemilu.org#42062,"PIYAMAN, WONOSARI, GUNUNGKIDUL, DAERAH ISTIMEWA YOGYAKARTA",9,82,74,156
https://kawalpemilu.org#42062,"PIYAMAN, WONOSARI, GUNUNGKIDUL, DAERAH ISTIMEWA YOGYAKARTA",10,125,119,244
https://kawalpemilu.org#42062,"PIYAMAN, WONOSARI, GUNUNGKIDUL, DAERAH ISTIMEWA YOGYAKARTA",11,95,163,258
https://kawalpemilu.org#42062,"PIYAMAN, WONOSARI, GUNUNGKIDUL, DAERAH ISTIMEWA YOGYAKARTA",12,106,155,261
https://kawalpemilu.org#42062,"PIYAMAN, WONOSARI, GUNUNGKIDUL, DAERAH ISTIMEWA YOGYAKARTA",13,111,152,263
https://kawalpemilu.org#42062,"PIYAMAN, WONOSARI, GUNUNGKIDUL, DAERAH ISTIMEWA YOGYAKARTA",14,202,61,263
https://kawalpemilu.org#42062,"PIYAMAN, WONOSARI, GUNUNGKIDUL, DAERAH ISTIMEWA YOGYAKARTA",15,128,124,252
https://kawalpemilu.org#42062,"PIYAMAN, WONOSARI, GUNUNGKIDUL, DAERAH ISTIMEWA YOGYAKARTA",16,180,87,267
https://kawalpemilu.org#42062,"PIYAMAN, WONOSARI, GUNUNGKIDUL, DAERAH ISTIMEWA YOGYAKARTA",17,185,75,260
https://kawalpemilu.org#42062,"PIYAMAN, WONOSARI, GUNUNGKIDUL, DAERAH ISTIMEWA YOGYAKARTA",18,172,86,258
https://kawalpemilu.org#42062,"PIYAMAN, WONOSARI, GUNUNGKIDUL, DAERAH ISTIMEWA YOGYAKARTA",19,150,89,239
https://kawalpemilu.org#42062,"PIYAMAN, WONOSARI, GUNUNGKIDUL, DAERAH ISTIMEWA YOGYAKARTA",20,86,116,202
https://kawalpemilu.org#42062,"PIYAMAN, WONOSARI, GUNUNGKIDUL, DAERAH ISTIMEWA YOGYAKARTA",21,178,32,210
https://kawalpemilu.org#42062,"PIYAMAN, WONOSARI, GUNUNGKIDUL, DAERAH ISTIMEWA YOGYAKARTA",22,135,38,172
https://kawalpemilu.org#42062,"PIYAMAN, WONOSARI, GUNUNGKIDUL, DAERAH ISTIMEWA YOGYAKARTA",23,208,45,253
https://kawalpemilu.org#42062,"PIYAMAN, WONOSARI, GUNUNGKIDUL, DAERAH ISTIMEWA YOGYAKARTA",24,158,58,216
https://kawalpemilu.org#42062,"PIYAMAN, WONOSARI, GUNUNGKIDUL, DAERAH ISTIMEWA YOGYAKARTA",25,108,63,171
https://kawalpemilu.org#42062,"PIYAMAN, WONOSARI, GUNUNGKIDUL, DAERAH ISTIMEWA YOGYAKARTA",26,137,88,225
https://kawalpemilu.org#42063,"GARI, WONOSARI, GUNUNGKIDUL, DAERAH ISTIMEWA YOGYAKARTA",1,224,13,237
https://kawalpemilu.org#42063,"GARI, WONOSARI, GUNUNGKIDUL, DAERAH ISTIMEWA YOGYAKARTA",2,105,54,159
https://kawalpemilu.org#42063,"GARI, WONOSARI, GUNUNGKIDUL, DAERAH ISTIMEWA YOGYAKARTA",3,123,81,204
https://kawalpemilu.org#42063,"GARI, WONOSARI, GUNUNGKIDUL, DAERAH ISTIMEWA YOGYAKARTA",4,89,58,147
https://kawalpemilu.org#42063,"GARI, WONOSARI, GUNUNGKIDUL, DAERAH ISTIMEWA YOGYAKARTA",5,156,52,208
https://kawalpemilu.org#42063,"GARI, WONOSARI, GUNUNGKIDUL, DAERAH ISTIMEWA YOGYAKARTA",6,118,72,190
https://kawalpemilu.org#42063,"GARI, WONOSARI, GUNUNGKIDUL, DAERAH ISTIMEWA YOGYAKARTA",7,158,81,239
https://kawalpemilu.org#42063,"GARI, WONOSARI, GUNUNGKIDUL, DAERAH ISTIMEWA YOGYAKARTA",8,185,29,214
https://kawalpemilu.org#42063,"GARI, WONOSARI, GUNUNGKIDUL, DAERAH ISTIMEWA YOGYAKARTA",9,119,69,188
https://kawalpemilu.org#42063,"GARI, WONOSARI, GUNUNGKIDUL, DAERAH ISTIMEWA YOGYAKARTA",10,180,52,232
https://kawalpemilu.org#42063,"GARI, WONOSARI, GUNUNGKIDUL, DAERAH ISTIMEWA YOGYAKARTA",11,110,81,191
https://kawalpemilu.org#42063,"GARI, WONOSARI, GUNUNGKIDUL, DAERAH ISTIMEWA YOGYAKARTA",12,143,37,180
https://kawalpemilu.org#42063,"GARI, WONOSARI, GUNUNGKIDUL, DAERAH ISTIMEWA YOGYAKARTA",13,123,52,175
https://kawalpemilu.org#42063,"GARI, WONOSARI, GUNUNGKIDUL, DAERAH ISTIMEWA YOGYAKARTA",14,98,58,156
https://kawalpemilu.org#42063,"GARI, WONOSARI, GUNUNGKIDUL, DAERAH ISTIMEWA YOGYAKARTA",15,191,28,219
https://kawalpemilu.org#42063,"GARI, WONOSARI, GUNUNGKIDUL, DAERAH ISTIMEWA YOGYAKARTA",16,128,50,178
https://kawalpemilu.org#42063,"GARI, WONOSARI, GUNUNGKIDUL, DAERAH ISTIMEWA YOGYAKARTA",17,222,39,261
https://kawalpemilu.org#42063,"GARI, WONOSARI, GUNUNGKIDUL, DAERAH ISTIMEWA YOGYAKARTA",18,146,84,230
https://kawalpemilu.org#42063,"GARI, WONOSARI, GUNUNGKIDUL, DAERAH ISTIMEWA YOGYAKARTA",19,213,47,260
https://kawalpemilu.org#42063,"GARI, WONOSARI, GUNUNGKIDUL, DAERAH ISTIMEWA YOGYAKARTA",20,163,88,251
https://kawalpemilu.org#42063,"GARI, WONOSARI, GUNUNGKIDUL, DAERAH ISTIMEWA YOGYAKARTA",21,149,93,242
https://kawalpemilu.org#42064,"KARANG TENGAH, WONOSARI, GUNUNGKIDUL, DAERAH ISTIMEWA YOGYAKARTA",1,155,86,241
https://kawalpemilu.org#42064,"KARANG TENGAH, WONOSARI, GUNUNGKIDUL, DAERAH ISTIMEWA YOGYAKARTA",2,141,76,217
https://kawalpemilu.org#42064,"KARANG TENGAH, WONOSARI, GUNUNGKIDUL, DAERAH ISTIMEWA YOGYAKARTA",3,102,46,148
https://kawalpemilu.org#42064,"KARANG TENGAH, WONOSARI, GUNUNGKIDUL, DAERAH ISTIMEWA YOGYAKARTA",4,129,53,182
https://kawalpemilu.org#42064,"KARANG TENGAH, WONOSARI, GUNUNGKIDUL, DAERAH ISTIMEWA YOGYAKARTA",5,160,64,224
https://kawalpemilu.org#42064,"KARANG TENGAH, WONOSARI, GUNUNGKIDUL, DAERAH ISTIMEWA YOGYAKARTA",6,151,45,196
https://kawalpemilu.org#42064,"KARANG TENGAH, WONOSARI, GUNUNGKIDUL, DAERAH ISTIMEWA YOGYAKARTA",7,94,25,119
https://kawalpemilu.org#42064,"KARANG TENGAH, WONOSARI, GUNUNGKIDUL, DAERAH ISTIMEWA YOGYAKARTA",8,153,36,189
https://kawalpemilu.org#42064,"KARANG TENGAH, WONOSARI, GUNUNGKIDUL, DAERAH ISTIMEWA YOGYAKARTA",9,150,48,198
https://kawalpemilu.org#42064,"KARANG TENGAH, WONOSARI, GUNUNGKIDUL, DAERAH ISTIMEWA YOGYAKARTA",10,148,71,219
https://kawalpemilu.org#42064,"KARANG TENGAH, WONOSARI, GUNUNGKIDUL, DAERAH ISTIMEWA YOGYAKARTA",11,87,31,118
https://kawalpemilu.org#42064,"KARANG TENGAH, WONOSARI, GUNUNGKIDUL, DAERAH ISTIMEWA YOGYAKARTA",12,172,52,224
https://kawalpemilu.org#42064,"KARANG TENGAH, WONOSARI, GUNUNGKIDUL, DAERAH ISTIMEWA YOGYAKARTA",13,148,90,238
https://kawalpemilu.org#42064,"KARANG TENGAH, WONOSARI, GUNUNGKIDUL, DAERAH ISTIMEWA YOGYAKARTA",14,169,61,230
https://kawalpemilu.org#42064,"KARANG TENGAH, WONOSARI, GUNUNGKIDUL, DAERAH ISTIMEWA YOGYAKARTA",15,147,51,198
https://kawalpemilu.org#42064,"KARANG TENGAH, WONOSARI, GUNUNGKIDUL, DAERAH ISTIMEWA YOGYAKARTA",16,208,50,258
https://kawalpemilu.org#42064,"KARANG TENGAH, WONOSARI, GUNUNGKIDUL, DAERAH ISTIMEWA YOGYAKARTA",17,177,27,204
https://kawalpemilu.org#42064,"KARANG TENGAH, WONOSARI, GUNUNGKIDUL, DAERAH ISTIMEWA YOGYAKARTA",18,167,53,220
https://kawalpemilu.org#42064,"KARANG TENGAH, WONOSARI, GUNUNGKIDUL, DAERAH ISTIMEWA YOGYAKARTA",19,156,35,191
https://kawalpemilu.org#42064,"KARANG TENGAH, WONOSARI, GUNUNGKIDUL, DAERAH ISTIMEWA YOGYAKARTA",20,210,41,251
https://kawalpemilu.org#42064,"KARANG TENGAH, WONOSARI, GUNUNGKIDUL, DAERAH ISTIMEWA YOGYAKARTA",21,90,17,107
https://kawalpemilu.org#42064,"KARANG TENGAH, WONOSARI, GUNUNGKIDUL, DAERAH ISTIMEWA YOGYAKARTA",22,185,62,247
https://kawalpemilu.org#42064,"KARANG TENGAH, WONOSARI, GUNUNGKIDUL, DAERAH ISTIMEWA YOGYAKARTA",23,196,46,242
https://kawalpemilu.org#42064,"KARANG TENGAH, WONOSARI, GUNUNGKIDUL, DAERAH ISTIMEWA YOGYAKARTA",24,247,30,277
https://kawalpemilu.org#42064,"KARANG TENGAH, WONOSARI, GUNUNGKIDUL, DAERAH ISTIMEWA YOGYAKARTA",25,169,79,248
https://kawalpemilu.org#42064,"KARANG TENGAH, WONOSARI, GUNUNGKIDUL, DAERAH ISTIMEWA YOGYAKARTA",26,188,62,250
https://kawalpemilu.org#42064,"KARANG TENGAH, WONOSARI, GUNUNGKIDUL, DAERAH ISTIMEWA YOGYAKARTA",27,190,55,245
https://kawalpemilu.org#42064,"KARANG TENGAH, WONOSARI, GUNUNGKIDUL, DAERAH ISTIMEWA YOGYAKARTA",28,188,57,245
https://kawalpemilu.org#42065,"SELANG, WONOSARI, GUNUNGKIDUL, DAERAH ISTIMEWA YOGYAKARTA",1,158,60,218
https://kawalpemilu.org#42065,"SELANG, WONOSARI, GUNUNGKIDUL, DAERAH ISTIMEWA YOGYAKARTA",2,196,19,215
https://kawalpemilu.org#42065,"SELANG, WONOSARI, GUNUNGKIDUL, DAERAH ISTIMEWA YOGYAKARTA",3,193,43,236
https://kawalpemilu.org#42065,"SELANG, WONOSARI, GUNUNGKIDUL, DAERAH ISTIMEWA YOGYAKARTA",4,143,42,185
https://kawalpemilu.org#42065,"SELANG, WONOSARI, GUNUNGKIDUL, DAERAH ISTIMEWA YOGYAKARTA",5,169,37,206
https://kawalpemilu.org#42065,"SELANG, WONOSARI, GUNUNGKIDUL, DAERAH ISTIMEWA YOGYAKARTA",6,104,37,141
https://kawalpemilu.org#42065,"SELANG, WONOSARI, GUNUNGKIDUL, DAERAH ISTIMEWA YOGYAKARTA",7,116,51,167
https://kawalpemilu.org#42065,"SELANG, WONOSARI, GUNUNGKIDUL, DAERAH ISTIMEWA YOGYAKARTA",8,161,29,190
https://kawalpemilu.org#42065,"SELANG, WONOSARI, GUNUNGKIDUL, DAERAH ISTIMEWA YOGYAKARTA",9,198,43,241
https://kawalpemilu.org#42065,"SELANG, WONOSARI, GUNUNGKIDUL, DAERAH ISTIMEWA YOGYAKARTA",10,195,43,238
https://kawalpemilu.org#42065,"SELANG, WONOSARI, GUNUNGKIDUL, DAERAH ISTIMEWA YOGYAKARTA",11,188,58,246
https://kawalpemilu.org#42065,"SELANG, WONOSARI, GUNUNGKIDUL, DAERAH ISTIMEWA YOGYAKARTA",12,187,54,241
https://kawalpemilu.org#42065,"SELANG, WONOSARI, GUNUNGKIDUL, DAERAH ISTIMEWA YOGYAKARTA",13,114,40,154
https://kawalpemilu.org#42065,"SELANG, WONOSARI, GUNUNGKIDUL, DAERAH ISTIMEWA YOGYAKARTA",14,98,56,154
https://kawalpemilu.org#42065,"SELANG, WONOSARI, GUNUNGKIDUL, DAERAH ISTIMEWA YOGYAKARTA",15,77,55,132
https://kawalpemilu.org#42065,"SELANG, WONOSARI, GUNUNGKIDUL, DAERAH ISTIMEWA YOGYAKARTA",16,144,38,182
https://kawalpemilu.org#42066,"BALEHARJO, WONOSARI, GUNUNGKIDUL, DAERAH ISTIMEWA YOGYAKARTA",1,147,65,212
https://kawalpemilu.org#42066,"BALEHARJO, WONOSARI, GUNUNGKIDUL, DAERAH ISTIMEWA YOGYAKARTA",2,133,73,206
https://kawalpemilu.org#42066,"BALEHARJO, WONOSARI, GUNUNGKIDUL, DAERAH ISTIMEWA YOGYAKARTA",3,146,45,191
https://kawalpemilu.org#42066,"BALEHARJO, WONOSARI, GUNUNGKIDUL, DAERAH ISTIMEWA YOGYAKARTA",4,155,40,195
https://kawalpemilu.org#42066,"BALEHARJO, WONOSARI, GUNUNGKIDUL, DAERAH ISTIMEWA YOGYAKARTA",5,178,43,221
https://kawalpemilu.org#42066,"BALEHARJO, WONOSARI, GUNUNGKIDUL, DAERAH ISTIMEWA YOGYAKARTA",6,167,37,204
https://kawalpemilu.org#42066,"BALEHARJO, WONOSARI, GUNUNGKIDUL, DAERAH ISTIMEWA YOGYAKARTA",7,199,46,245
https://kawalpemilu.org#42066,"BALEHARJO, WONOSARI, GUNUNGKIDUL, DAERAH ISTIMEWA YOGYAKARTA",8,170,36,206
https://kawalpemilu.org#42066,"BALEHARJO, WONOSARI, GUNUNGKIDUL, DAERAH ISTIMEWA YOGYAKARTA",9,199,38,237
https://kawalpemilu.org#42066,"BALEHARJO, WONOSARI, GUNUNGKIDUL, DAERAH ISTIMEWA YOGYAKARTA",10,170,34,204
https://kawalpemilu.org#42066,"BALEHARJO, WONOSARI, GUNUNGKIDUL, DAERAH ISTIMEWA YOGYAKARTA",11,185,30,215
https://kawalpemilu.org#42066,"BALEHARJO, WONOSARI, GUNUNGKIDUL, DAERAH ISTIMEWA YOGYAKARTA",12,195,17,212
https://kawalpemilu.org#42066,"BALEHARJO, WONOSARI, GUNUNGKIDUL, DAERAH ISTIMEWA YOGYAKARTA",13,196,27,223
https://kawalpemilu.org#42066,"BALEHARJO, WONOSARI, GUNUNGKIDUL, DAERAH ISTIMEWA YOGYAKARTA",14,176,36,212
https://kawalpemilu.org#42066,"BALEHARJO, WONOSARI, GUNUNGKIDUL, DAERAH ISTIMEWA YOGYAKARTA",15,154,25,179
https://kawalpemilu.org#42066,"BALEHARJO, WONOSARI, GUNUNGKIDUL, DAERAH ISTIMEWA YOGYAKARTA",16,131,25,156
https://kawalpemilu.org#42066,"BALEHARJO, WONOSARI, GUNUNGKIDUL, DAERAH ISTIMEWA YOGYAKARTA",17,190,27,217
https://kawalpemilu.org#42066,"BALEHARJO, WONOSARI, GUNUNGKIDUL, DAERAH ISTIMEWA YOGYAKARTA",18,201,46,247
https://kawalpemilu.org#42066,"BALEHARJO, WONOSARI, GUNUNGKIDUL, DAERAH ISTIMEWA YOGYAKARTA",19,210,50,260
https://kawalpemilu.org#42066,"BALEHARJO, WONOSARI, GUNUNGKIDUL, DAERAH ISTIMEWA YOGYAKARTA",20,131,42,173
https://kawalpemilu.org#42066,"BALEHARJO, WONOSARI, GUNUNGKIDUL, DAERAH ISTIMEWA YOGYAKARTA",21,74,37,111
https://kawalpemilu.org#42067,"SIRAMAN, WONOSARI, GUNUNGKIDUL, DAERAH ISTIMEWA YOGYAKARTA",1,137,22,159
https://kawalpemilu.org#42067,"SIRAMAN, WONOSARI, GUNUNGKIDUL, DAERAH ISTIMEWA YOGYAKARTA",2,144,28,172
https://kawalpemilu.org#42067,"SIRAMAN, WONOSARI, GUNUNGKIDUL, DAERAH ISTIMEWA YOGYAKARTA",3,134,43,177
https://kawalpemilu.org#42067,"SIRAMAN, WONOSARI, GUNUNGKIDUL, DAERAH ISTIMEWA YOGYAKARTA",4,172,47,219
https://kawalpemilu.org#42067,"SIRAMAN, WONOSARI, GUNUNGKIDUL, DAERAH ISTIMEWA YOGYAKARTA",5,137,35,172
https://kawalpemilu.org#42067,"SIRAMAN, WONOSARI, GUNUNGKIDUL, DAERAH ISTIMEWA YOGYAKARTA",6,148,59,207
https://kawalpemilu.org#42067,"SIRAMAN, WONOSARI, GUNUNGKIDUL, DAERAH ISTIMEWA YOGYAKARTA",7,161,70,231
https://kawalpemilu.org#42067,"SIRAMAN, WONOSARI, GUNUNGKIDUL, DAERAH ISTIMEWA YOGYAKARTA",8,107,57,164
https://kawalpemilu.org#42067,"SIRAMAN, WONOSARI, GUNUNGKIDUL, DAERAH ISTIMEWA YOGYAKARTA",9,176,62,238
https://kawalpemilu.org#42067,"SIRAMAN, WONOSARI, GUNUNGKIDUL, DAERAH ISTIMEWA YOGYAKARTA",10,200,39,239
https://kawalpemilu.org#42067,"SIRAMAN, WONOSARI, GUNUNGKIDUL, DAERAH ISTIMEWA YOGYAKARTA",11,207,44,251
https://kawalpemilu.org#42067,"SIRAMAN, WONOSARI, GUNUNGKIDUL, DAERAH ISTIMEWA YOGYAKARTA",12,190,52,242
https://kawalpemilu.org#42067,"SIRAMAN, WONOSARI, GUNUNGKIDUL, DAERAH ISTIMEWA YOGYAKARTA",13,172,40,212
https://kawalpemilu.org#42067,"SIRAMAN, WONOSARI, GUNUNGKIDUL, DAERAH ISTIMEWA YOGYAKARTA",14,212,40,252
https://kawalpemilu.org#42067,"SIRAMAN, WONOSARI, GUNUNGKIDUL, DAERAH ISTIMEWA YOGYAKARTA",15,168,39,207
https://kawalpemilu.org#42067,"SIRAMAN, WONOSARI, GUNUNGKIDUL, DAERAH ISTIMEWA YOGYAKARTA",16,139,69,208
https://kawalpemilu.org#42067,"SIRAMAN, WONOSARI, GUNUNGKIDUL, DAERAH ISTIMEWA YOGYAKARTA",17,163,99,262
https://kawalpemilu.org#42067,"SIRAMAN, WONOSARI, GUNUNGKIDUL, DAERAH ISTIMEWA YOGYAKARTA",18,153,110,263
https://kawalpemilu.org#42068,"PULUTAN, WONOSARI, GUNUNGKIDUL, DAERAH ISTIMEWA YOGYAKARTA",1,228,10,238
https://kawalpemilu.org#42068,"PULUTAN, WONOSARI, GUNUNGKIDUL, DAERAH ISTIMEWA YOGYAKARTA",2,175,7,182
https://kawalpemilu.org#42068,"PULUTAN, WONOSARI, GUNUNGKIDUL, DAERAH ISTIMEWA YOGYAKARTA",3,99,56,155
https://kawalpemilu.org#42068,"PULUTAN, WONOSARI, GUNUNGKIDUL, DAERAH ISTIMEWA YOGYAKARTA",4,132,43,175
https://kawalpemilu.org#42068,"PULUTAN, WONOSARI, GUNUNGKIDUL, DAERAH ISTIMEWA YOGYAKARTA",5,125,56,181
https://kawalpemilu.org#42068,"PULUTAN, WONOSARI, GUNUNGKIDUL, DAERAH ISTIMEWA YOGYAKARTA",6,100,20,120
https://kawalpemilu.org#42068,"PULUTAN, WONOSARI, GUNUNGKIDUL, DAERAH ISTIMEWA YOGYAKARTA",7,153,98,251
https://kawalpemilu.org#42068,"PULUTAN, WONOSARI, GUNUNGKIDUL, DAERAH ISTIMEWA YOGYAKARTA",8,174,80,254
https://kawalpemilu.org#42068,"PULUTAN, WONOSARI, GUNUNGKIDUL, DAERAH ISTIMEWA YOGYAKARTA",9,80,63,143
https://kawalpemilu.org#42068,"PULUTAN, WONOSARI, GUNUNGKIDUL, DAERAH ISTIMEWA YOGYAKARTA",10,66,100,166
https://kawalpemilu.org#42068,"PULUTAN, WONOSARI, GUNUNGKIDUL, DAERAH ISTIMEWA YOGYAKARTA",11,68,56,124
https://kawalpemilu.org#42068,"PULUTAN, WONOSARI, GUNUNGKIDUL, DAERAH ISTIMEWA YOGYAKARTA",12,146,100,246
https://kawalpemilu.org#42068,"PULUTAN, WONOSARI, GUNUNGKIDUL, DAERAH ISTIMEWA YOGYAKARTA",13,151,16,167
https://kawalpemilu.org#42068,"PULUTAN, WONOSARI, GUNUNGKIDUL, DAERAH ISTIMEWA YOGYAKARTA",14,162,16,178
https://kawalpemilu.org#42068,"PULUTAN, WONOSARI, GUNUNGKIDUL, DAERAH ISTIMEWA YOGYAKARTA",15,125,21,146
https://kawalpemilu.org#42068,"PULUTAN, WONOSARI, GUNUNGKIDUL, DAERAH ISTIMEWA YOGYAKARTA",16,87,16,103
https://kawalpemilu.org#42069,"WARENG, WONOSARI, GUNUNGKIDUL, DAERAH ISTIMEWA YOGYAKARTA",1,148,60,208
https://kawalpemilu.org#42069,"WARENG, WONOSARI, GUNUNGKIDUL, DAERAH ISTIMEWA YOGYAKARTA",2,121,60,181
https://kawalpemilu.org#42069,"WARENG, WONOSARI, GUNUNGKIDUL, DAERAH ISTIMEWA YOGYAKARTA",3,137,66,203
https://kawalpemilu.org#42069,"WARENG, WONOSARI, GUNUNGKIDUL, DAERAH ISTIMEWA YOGYAKARTA",4,127,52,179
https://kawalpemilu.org#42069,"WARENG, WONOSARI, GUNUNGKIDUL, DAERAH ISTIMEWA YOGYAKARTA",5,128,61,189
https://kawalpemilu.org#42069,"WARENG, WONOSARI, GUNUNGKIDUL, DAERAH ISTIMEWA YOGYAKARTA",6,172,44,216
https://kawalpemilu.org#42069,"WARENG, WONOSARI, GUNUNGKIDUL, DAERAH ISTIMEWA YOGYAKARTA",7,139,41,180
https://kawalpemilu.org#42069,"WARENG, WONOSARI, GUNUNGKIDUL, DAERAH ISTIMEWA YOGYAKARTA",8,156,44,200
https://kawalpemilu.org#42069,"WARENG, WONOSARI, GUNUNGKIDUL, DAERAH ISTIMEWA YOGYAKARTA",9,143,72,215
https://kawalpemilu.org#42069,"WARENG, WONOSARI, GUNUNGKIDUL, DAERAH ISTIMEWA YOGYAKARTA",10,149,72,221
https://kawalpemilu.org#42069,"WARENG, WONOSARI, GUNUNGKIDUL, DAERAH ISTIMEWA YOGYAKARTA",11,164,61,225
https://kawalpemilu.org#42069,"WARENG, WONOSARI, GUNUNGKIDUL, DAERAH ISTIMEWA YOGYAKARTA",12,144,42,186
https://kawalpemilu.org#42069,"WARENG, WONOSARI, GUNUNGKIDUL, DAERAH ISTIMEWA YOGYAKARTA",13,125,64,189
https://kawalpemilu.org#42069,"WARENG, WONOSARI, GUNUNGKIDUL, DAERAH ISTIMEWA YOGYAKARTA",14,162,69,231
https://kawalpemilu.org#42070,"DUWET, WONOSARI, GUNUNGKIDUL, DAERAH ISTIMEWA YOGYAKARTA",1,160,36,196
https://kawalpemilu.org#42070,"DUWET, WONOSARI, GUNUNGKIDUL, DAERAH ISTIMEWA YOGYAKARTA",2,169,62,231
https://kawalpemilu.org#42070,"DUWET, WONOSARI, GUNUNGKIDUL, DAERAH ISTIMEWA YOGYAKARTA",3,158,67,225
https://kawalpemilu.org#42070,"DUWET, WONOSARI, GUNUNGKIDUL, DAERAH ISTIMEWA YOGYAKARTA",5,161,64,225
https://kawalpemilu.org#42070,"DUWET, WONOSARI, GUNUNGKIDUL, DAERAH ISTIMEWA YOGYAKARTA",6,184,62,246
https://kawalpemilu.org#42070,"DUWET, WONOSARI, GUNUNGKIDUL, DAERAH ISTIMEWA YOGYAKARTA",7,185,70,255
https://kawalpemilu.org#42070,"DUWET, WONOSARI, GUNUNGKIDUL, DAERAH ISTIMEWA YOGYAKARTA",8,149,44,193
https://kawalpemilu.org#42071,"MULO, WONOSARI, GUNUNGKIDUL, DAERAH ISTIMEWA YOGYAKARTA",1,141,47,188
https://kawalpemilu.org#42071,"MULO, WONOSARI, GUNUNGKIDUL, DAERAH ISTIMEWA YOGYAKARTA",2,151,66,217
https://kawalpemilu.org#42071,"MULO, WONOSARI, GUNUNGKIDUL, DAERAH ISTIMEWA YOGYAKARTA",3,174,58,232
https://kawalpemilu.org#42071,"MULO, WONOSARI, GUNUNGKIDUL, DAERAH ISTIMEWA YOGYAKARTA",4,173,44,217
https://kawalpemilu.org#42071,"MULO, WONOSARI, GUNUNGKIDUL, DAERAH ISTIMEWA YOGYAKARTA",5,163,70,233
https://kawalpemilu.org#42071,"MULO, WONOSARI, GUNUNGKIDUL, DAERAH ISTIMEWA YOGYAKARTA",6,123,61,184
https://kawalpemilu.org#42071,"MULO, WONOSARI, GUNUNGKIDUL, DAERAH ISTIMEWA YOGYAKARTA",7,116,73,189
https://kawalpemilu.org#42071,"MULO, WONOSARI, GUNUNGKIDUL, DAERAH ISTIMEWA YOGYAKARTA",8,172,77,249
https://kawalpemilu.org#42071,"MULO, WONOSARI, GUNUNGKIDUL, DAERAH ISTIMEWA YOGYAKARTA",9,181,56,237
https://kawalpemilu.org#42071,"MULO, WONOSARI, GUNUNGKIDUL, DAERAH ISTIMEWA YOGYAKARTA",10,169,66,235
https://kawalpemilu.org#42071,"MULO, WONOSARI, GUNUNGKIDUL, DAERAH ISTIMEWA YOGYAKARTA",11,142,83,225
https://kawalpemilu.org#42071,"MULO, WONOSARI, GUNUNGKIDUL, DAERAH ISTIMEWA YOGYAKARTA",12,183,56,239
https://kawalpemilu.org#42071,"MULO, WONOSARI, GUNUNGKIDUL, DAERAH ISTIMEWA YOGYAKARTA",13,153,57,210
https://kawalpemilu.org#42071,"MULO, WONOSARI, GUNUNGKIDUL, DAERAH ISTIMEWA YOGYAKARTA",14,180,27,207
https://kawalpemilu.org#42071,"MULO, WONOSARI, GUNUNGKIDUL, DAERAH ISTIMEWA YOGYAKARTA",15,169,23,192
https://kawalpemilu.org#42072,"WUNUNG, WONOSARI, GUNUNGKIDUL, DAERAH ISTIMEWA YOGYAKARTA",1,199,27,226
https://kawalpemilu.org#42072,"WUNUNG, WONOSARI, GUNUNGKIDUL, DAERAH ISTIMEWA YOGYAKARTA",2,168,40,208
https://kawalpemilu.org#42072,"WUNUNG, WONOSARI, GUNUNGKIDUL, DAERAH ISTIMEWA YOGYAKARTA",3,198,27,225
https://kawalpemilu.org#42072,"WUNUNG, WONOSARI, GUNUNGKIDUL, DAERAH ISTIMEWA YOGYAKARTA",4,135,34,169
https://kawalpemilu.org#42072,"WUNUNG, WONOSARI, GUNUNGKIDUL, DAERAH ISTIMEWA YOGYAKARTA",5,135,48,183
https://kawalpemilu.org#42072,"WUNUNG, WONOSARI, GUNUNGKIDUL, DAERAH ISTIMEWA YOGYAKARTA",6,137,58,195
https://kawalpemilu.org#42072,"WUNUNG, WONOSARI, GUNUNGKIDUL, DAERAH ISTIMEWA YOGYAKARTA",7,118,116,234
https://kawalpemilu.org#42072,"WUNUNG, WONOSARI, GUNUNGKIDUL, DAERAH ISTIMEWA YOGYAKARTA",8,128,90,218
https://kawalpemilu.org#42072,"WUNUNG, WONOSARI, GUNUNGKIDUL, DAERAH ISTIMEWA YOGYAKARTA",9,112,75,187
https://kawalpemilu.org#42072,"WUNUNG, WONOSARI, GUNUNGKIDUL, DAERAH ISTIMEWA YOGYAKARTA",10,126,45,171
https://kawalpemilu.org#42072,"WUNUNG, WONOSARI, GUNUNGKIDUL, DAERAH ISTIMEWA YOGYAKARTA",11,89,14,103
https://kawalpemilu.org#42072,"WUNUNG, WONOSARI, GUNUNGKIDUL, DAERAH ISTIMEWA YOGYAKARTA",12,108,37,145
https://kawalpemilu.org#42072,"WUNUNG, WONOSARI, GUNUNGKIDUL, DAERAH ISTIMEWA YOGYAKARTA",13,130,19,149
https://kawalpemilu.org#42073,"KARANGREJEK, WONOSARI, GUNUNGKIDUL, DAERAH ISTIMEWA YOGYAKARTA",1,157,65,222
https://kawalpemilu.org#42073,"KARANGREJEK, WONOSARI, GUNUNGKIDUL, DAERAH ISTIMEWA YOGYAKARTA",2,190,56,246
https://kawalpemilu.org#42073,"KARANGREJEK, WONOSARI, GUNUNGKIDUL, DAERAH ISTIMEWA YOGYAKARTA",3,115,99,214
https://kawalpemilu.org#42073,"KARANGREJEK, WONOSARI, GUNUNGKIDUL, DAERAH ISTIMEWA YOGYAKARTA",4,143,35,178
https://kawalpemilu.org#42073,"KARANGREJEK, WONOSARI, GUNUNGKIDUL, DAERAH ISTIMEWA YOGYAKARTA",5,122,53,175
https://kawalpemilu.org#42073,"KARANGREJEK, WONOSARI, GUNUNGKIDUL, DAERAH ISTIMEWA YOGYAKARTA",6,142,43,185
https://kawalpemilu.org#42073,"KARANGREJEK, WONOSARI, GUNUNGKIDUL, DAERAH ISTIMEWA YOGYAKARTA",7,122,74,196
https://kawalpemilu.org#42073,"KARANGREJEK, WONOSARI, GUNUNGKIDUL, DAERAH ISTIMEWA YOGYAKARTA",8,153,91,244
https://kawalpemilu.org#42073,"KARANGREJEK, WONOSARI, GUNUNGKIDUL, DAERAH ISTIMEWA YOGYAKARTA",9,112,59,171
https://kawalpemilu.org#42073,"KARANGREJEK, WONOSARI, GUNUNGKIDUL, DAERAH ISTIMEWA YOGYAKARTA",10,158,56,214
https://kawalpemilu.org#42073,"KARANGREJEK, WONOSARI, GUNUNGKIDUL, DAERAH ISTIMEWA YOGYAKARTA",11,178,31,209
https://kawalpemilu.org#42073,"KARANGREJEK, WONOSARI, GUNUNGKIDUL, DAERAH ISTIMEWA YOGYAKARTA",12,170,71,241
https://kawalpemilu.org#42073,"KARANGREJEK, WONOSARI, GUNUNGKIDUL, DAERAH ISTIMEWA YOGYAKARTA",13,152,69,221
https://kawalpemilu.org#42073,"KARANGREJEK, WONOSARI, GUNUNGKIDUL, DAERAH ISTIMEWA YOGYAKARTA",14,157,76,233
https://kawalpemilu.org#42073,"KARANGREJEK, WONOSARI, GUNUNGKIDUL, DAERAH ISTIMEWA YOGYAKARTA",15,168,67,235
https://kawalpemilu.org#42073,"KARANGREJEK, WONOSARI, GUNUNGKIDUL, DAERAH ISTIMEWA YOGYAKARTA",16,160,37,197
https://kawalpemilu.org#42073,"KARANGREJEK, WONOSARI, GUNUNGKIDUL, DAERAH ISTIMEWA YOGYAKARTA",17,156,37,193
https://kawalpemilu.org#42073,"KARANGREJEK, WONOSARI, GUNUNGKIDUL, DAERAH ISTIMEWA YOGYAKARTA",18,158,20,178
https://kawalpemilu.org#42075,"NATAH, NGLIPAR, GUNUNGKIDUL, DAERAH ISTIMEWA YOGYAKARTA",1,91,15,106
https://kawalpemilu.org#42075,"NATAH, NGLIPAR, GUNUNGKIDUL, DAERAH ISTIMEWA YOGYAKARTA",2,92,31,123
https://kawalpemilu.org#42075,"NATAH, NGLIPAR, GUNUNGKIDUL, DAERAH ISTIMEWA YOGYAKARTA",3,91,25,116
https://kawalpemilu.org#42075,"NATAH, NGLIPAR, GUNUNGKIDUL, DAERAH ISTIMEWA YOGYAKARTA",4,119,21,140
https://kawalpemilu.org#42075,"NATAH, NGLIPAR, GUNUNGKIDUL, DAERAH ISTIMEWA YOGYAKARTA",5,210,35,245
https://kawalpemilu.org#42075,"NATAH, NGLIPAR, GUNUNGKIDUL, DAERAH ISTIMEWA YOGYAKARTA",6,214,33,247
https://kawalpemilu.org#42075,"NATAH, NGLIPAR, GUNUNGKIDUL, DAERAH ISTIMEWA YOGYAKARTA",7,178,18,196
https://kawalpemilu.org#42075,"NATAH, NGLIPAR, GUNUNGKIDUL, DAERAH ISTIMEWA YOGYAKARTA",8,144,27,171
https://kawalpemilu.org#42075,"NATAH, NGLIPAR, GUNUNGKIDUL, DAERAH ISTIMEWA YOGYAKARTA",9,154,7,161
https://kawalpemilu.org#42075,"NATAH, NGLIPAR, GUNUNGKIDUL, DAERAH ISTIMEWA YOGYAKARTA",10,115,60,175
https://kawalpemilu.org#42075,"NATAH, NGLIPAR, GUNUNGKIDUL, DAERAH ISTIMEWA YOGYAKARTA",11,136,34,170
https://kawalpemilu.org#42075,"NATAH, NGLIPAR, GUNUNGKIDUL, DAERAH ISTIMEWA YOGYAKARTA",12,146,49,195
https://kawalpemilu.org#42075,"NATAH, NGLIPAR, GUNUNGKIDUL, DAERAH ISTIMEWA YOGYAKARTA",13,151,64,215
https://kawalpemilu.org#42075,"NATAH, NGLIPAR, GUNUNGKIDUL, DAERAH ISTIMEWA YOGYAKARTA",14,169,21,190
https://kawalpemilu.org#42076,"PILANGREJO, NGLIPAR, GUNUNGKIDUL, DAERAH ISTIMEWA YOGYAKARTA",1,103,61,164
https://kawalpemilu.org#42076,"PILANGREJO, NGLIPAR, GUNUNGKIDUL, DAERAH ISTIMEWA YOGYAKARTA",2,149,61,210
https://kawalpemilu.org#42076,"PILANGREJO, NGLIPAR, GUNUNGKIDUL, DAERAH ISTIMEWA YOGYAKARTA",3,136,81,217
https://kawalpemilu.org#42076,"PILANGREJO, NGLIPAR, GUNUNGKIDUL, DAERAH ISTIMEWA YOGYAKARTA",4,185,43,228
https://kawalpemilu.org#42076,"PILANGREJO, NGLIPAR, GUNUNGKIDUL, DAERAH ISTIMEWA YOGYAKARTA",5,157,37,194
https://kawalpemilu.org#42076,"PILANGREJO, NGLIPAR, GUNUNGKIDUL, DAERAH ISTIMEWA YOGYAKARTA",6,126,25,151
https://kawalpemilu.org#42076,"PILANGREJO, NGLIPAR, GUNUNGKIDUL, DAERAH ISTIMEWA YOGYAKARTA",7,117,30,147
https://kawalpemilu.org#42076,"PILANGREJO, NGLIPAR, GUNUNGKIDUL, DAERAH ISTIMEWA YOGYAKARTA",8,94,34,128
https://kawalpemilu.org#42076,"PILANGREJO, NGLIPAR, GUNUNGKIDUL, DAERAH ISTIMEWA YOGYAKARTA",9,161,55,216
https://kawalpemilu.org#42076,"PILANGREJO, NGLIPAR, GUNUNGKIDUL, DAERAH ISTIMEWA YOGYAKARTA",10,127,4,131
https://kawalpemilu.org#42076,"PILANGREJO, NGLIPAR, GUNUNGKIDUL, DAERAH ISTIMEWA YOGYAKARTA",11,148,67,215
https://kawalpemilu.org#42076,"PILANGREJO, NGLIPAR, GUNUNGKIDUL, DAERAH ISTIMEWA YOGYAKARTA",12,117,16,133
https://kawalpemilu.org#42076,"PILANGREJO, NGLIPAR, GUNUNGKIDUL, DAERAH ISTIMEWA YOGYAKARTA",13,152,30,152
https://kawalpemilu.org#42077,"KEDUNGPOH, NGLIPAR, GUNUNGKIDUL, DAERAH ISTIMEWA YOGYAKARTA",1,122,91,213
https://kawalpemilu.org#42077,"KEDUNGPOH, NGLIPAR, GUNUNGKIDUL, DAERAH ISTIMEWA YOGYAKARTA",2,111,79,190
https://kawalpemilu.org#42077,"KEDUNGPOH, NGLIPAR, GUNUNGKIDUL, DAERAH ISTIMEWA YOGYAKARTA",3,111,73,184
https://kawalpemilu.org#42077,"KEDUNGPOH, NGLIPAR, GUNUNGKIDUL, DAERAH ISTIMEWA YOGYAKARTA",4,71,148,219
https://kawalpemilu.org#42077,"KEDUNGPOH, NGLIPAR, GUNUNGKIDUL, DAERAH ISTIMEWA YOGYAKARTA",5,92,141,233
https://kawalpemilu.org#42077,"KEDUNGPOH, NGLIPAR, GUNUNGKIDUL, DAERAH ISTIMEWA YOGYAKARTA",6,111,68,179
https://kawalpemilu.org#42077,"KEDUNGPOH, NGLIPAR, GUNUNGKIDUL, DAERAH ISTIMEWA YOGYAKARTA",7,110,71,181
https://kawalpemilu.org#42077,"KEDUNGPOH, NGLIPAR, GUNUNGKIDUL, DAERAH ISTIMEWA YOGYAKARTA",8,147,49,196
https://kawalpemilu.org#42077,"KEDUNGPOH, NGLIPAR, GUNUNGKIDUL, DAERAH ISTIMEWA YOGYAKARTA",9,110,22,132
https://kawalpemilu.org#42077,"KEDUNGPOH, NGLIPAR, GUNUNGKIDUL, DAERAH ISTIMEWA YOGYAKARTA",10,96,53,149
https://kawalpemilu.org#42077,"KEDUNGPOH, NGLIPAR, GUNUNGKIDUL, DAERAH ISTIMEWA YOGYAKARTA",11,139,23,162
https://kawalpemilu.org#42077,"KEDUNGPOH, NGLIPAR, GUNUNGKIDUL, DAERAH ISTIMEWA YOGYAKARTA",12,90,54,144
https://kawalpemilu.org#42077,"KEDUNGPOH, NGLIPAR, GUNUNGKIDUL, DAERAH ISTIMEWA YOGYAKARTA",13,149,31,180
https://kawalpemilu.org#42077,"KEDUNGPOH, NGLIPAR, GUNUNGKIDUL, DAERAH ISTIMEWA YOGYAKARTA",14,112,42,154
https://kawalpemilu.org#42077,"KEDUNGPOH, NGLIPAR, GUNUNGKIDUL, DAERAH ISTIMEWA YOGYAKARTA",15,110,41,151
https://kawalpemilu.org#42077,"KEDUNGPOH, NGLIPAR, GUNUNGKIDUL, DAERAH ISTIMEWA YOGYAKARTA",16,87,73,160
https://kawalpemilu.org#42077,"KEDUNGPOH, NGLIPAR, GUNUNGKIDUL, DAERAH ISTIMEWA YOGYAKARTA",17,67,65,132
https://kawalpemilu.org#42077,"KEDUNGPOH, NGLIPAR, GUNUNGKIDUL, DAERAH ISTIMEWA YOGYAKARTA",18,133,39,172
https://kawalpemilu.org#42077,"KEDUNGPOH, NGLIPAR, GUNUNGKIDUL, DAERAH ISTIMEWA YOGYAKARTA",19,121,80,201
https://kawalpemilu.org#42077,"KEDUNGPOH, NGLIPAR, GUNUNGKIDUL, DAERAH ISTIMEWA YOGYAKARTA",20,88,37,125
https://kawalpemilu.org#42077,"KEDUNGPOH, NGLIPAR, GUNUNGKIDUL, DAERAH ISTIMEWA YOGYAKARTA",21,111,93,204
https://kawalpemilu.org#42077,"KEDUNGPOH, NGLIPAR, GUNUNGKIDUL, DAERAH ISTIMEWA YOGYAKARTA",22,163,52,215
https://kawalpemilu.org#42078,"PENGKOL, NGLIPAR, GUNUNGKIDUL, DAERAH ISTIMEWA YOGYAKARTA",1,162,44,206
https://kawalpemilu.org#42078,"PENGKOL, NGLIPAR, GUNUNGKIDUL, DAERAH ISTIMEWA YOGYAKARTA",2,128,48,176
https://kawalpemilu.org#42078,"PENGKOL, NGLIPAR, GUNUNGKIDUL, DAERAH ISTIMEWA YOGYAKARTA",3,151,30,181
https://kawalpemilu.org#42078,"PENGKOL, NGLIPAR, GUNUNGKIDUL, DAERAH ISTIMEWA YOGYAKARTA",4,151,31,182
https://kawalpemilu.org#42078,"PENGKOL, NGLIPAR, GUNUNGKIDUL, DAERAH ISTIMEWA YOGYAKARTA",5,123,31,154
https://kawalpemilu.org#42078,"PENGKOL, NGLIPAR, GUNUNGKIDUL, DAERAH ISTIMEWA YOGYAKARTA",6,113,46,159
https://kawalpemilu.org#42078,"PENGKOL, NGLIPAR, GUNUNGKIDUL, DAERAH ISTIMEWA YOGYAKARTA",7,51,44,95
https://kawalpemilu.org#42078,"PENGKOL, NGLIPAR, GUNUNGKIDUL, DAERAH ISTIMEWA YOGYAKARTA",8,136,67,203
https://kawalpemilu.org#42078,"PENGKOL, NGLIPAR, GUNUNGKIDUL, DAERAH ISTIMEWA YOGYAKARTA",9,145,52,197
https://kawalpemilu.org#42078,"PENGKOL, NGLIPAR, GUNUNGKIDUL, DAERAH ISTIMEWA YOGYAKARTA",10,106,16,122
https://kawalpemilu.org#42078,"PENGKOL, NGLIPAR, GUNUNGKIDUL, DAERAH ISTIMEWA YOGYAKARTA",11,118,44,162
https://kawalpemilu.org#42078,"PENGKOL, NGLIPAR, GUNUNGKIDUL, DAERAH ISTIMEWA YOGYAKARTA",12,127,51,178
https://kawalpemilu.org#42078,"PENGKOL, NGLIPAR, GUNUNGKIDUL, DAERAH ISTIMEWA YOGYAKARTA",13,181,49,230
https://kawalpemilu.org#42078,"PENGKOL, NGLIPAR, GUNUNGKIDUL, DAERAH ISTIMEWA YOGYAKARTA",14,138,41,179
https://kawalpemilu.org#42078,"PENGKOL, NGLIPAR, GUNUNGKIDUL, DAERAH ISTIMEWA YOGYAKARTA",15,154,29,183
https://kawalpemilu.org#42078,"PENGKOL, NGLIPAR, GUNUNGKIDUL, DAERAH ISTIMEWA YOGYAKARTA",16,151,22,173
https://kawalpemilu.org#42078,"PENGKOL, NGLIPAR, GUNUNGKIDUL, DAERAH ISTIMEWA YOGYAKARTA",17,160,59,219
https://kawalpemilu.org#42078,"PENGKOL, NGLIPAR, GUNUNGKIDUL, DAERAH ISTIMEWA YOGYAKARTA",18,160,53,213
https://kawalpemilu.org#42078,"PENGKOL, NGLIPAR, GUNUNGKIDUL, DAERAH ISTIMEWA YOGYAKARTA",19,156,45,201
https://kawalpemilu.org#42078,"PENGKOL, NGLIPAR, GUNUNGKIDUL, DAERAH ISTIMEWA YOGYAKARTA",20,222,13,235
https://kawalpemilu.org#42079,"KEDUNGKERIS, NGLIPAR, GUNUNGKIDUL, DAERAH ISTIMEWA YOGYAKARTA",1,132,55,187
https://kawalpemilu.org#42079,"KEDUNGKERIS, NGLIPAR, GUNUNGKIDUL, DAERAH ISTIMEWA YOGYAKARTA",2,172,39,211
https://kawalpemilu.org#42079,"KEDUNGKERIS, NGLIPAR, GUNUNGKIDUL, DAERAH ISTIMEWA YOGYAKARTA",3,125,65,190
https://kawalpemilu.org#42079,"KEDUNGKERIS, NGLIPAR, GUNUNGKIDUL, DAERAH ISTIMEWA YOGYAKARTA",4,136,45,181
https://kawalpemilu.org#42079,"KEDUNGKERIS, NGLIPAR, GUNUNGKIDUL, DAERAH ISTIMEWA YOGYAKARTA",5,166,66,232
https://kawalpemilu.org#42079,"KEDUNGKERIS, NGLIPAR, GUNUNGKIDUL, DAERAH ISTIMEWA YOGYAKARTA",6,184,64,248
https://kawalpemilu.org#42079,"KEDUNGKERIS, NGLIPAR, GUNUNGKIDUL, DAERAH ISTIMEWA YOGYAKARTA",7,177,26,203
https://kawalpemilu.org#42079,"KEDUNGKERIS, NGLIPAR, GUNUNGKIDUL, DAERAH ISTIMEWA YOGYAKARTA",8,124,47,171
https://kawalpemilu.org#42079,"KEDUNGKERIS, NGLIPAR, GUNUNGKIDUL, DAERAH ISTIMEWA YOGYAKARTA",9,145,51,196
https://kawalpemilu.org#42079,"KEDUNGKERIS, NGLIPAR, GUNUNGKIDUL, DAERAH ISTIMEWA YOGYAKARTA",10,139,27,166
https://kawalpemilu.org#42079,"KEDUNGKERIS, NGLIPAR, GUNUNGKIDUL, DAERAH ISTIMEWA YOGYAKARTA",11,172,28,200
https://kawalpemilu.org#42079,"KEDUNGKERIS, NGLIPAR, GUNUNGKIDUL, DAERAH ISTIMEWA YOGYAKARTA",12,161,50,211
https://kawalpemilu.org#42079,"KEDUNGKERIS, NGLIPAR, GUNUNGKIDUL, DAERAH ISTIMEWA YOGYAKARTA",13,188,27,215
https://kawalpemilu.org#42079,"KEDUNGKERIS, NGLIPAR, GUNUNGKIDUL, DAERAH ISTIMEWA YOGYAKARTA",14,109,36,145
https://kawalpemilu.org#42079,"KEDUNGKERIS, NGLIPAR, GUNUNGKIDUL, DAERAH ISTIMEWA YOGYAKARTA",15,141,44,185
https://kawalpemilu.org#42079,"KEDUNGKERIS, NGLIPAR, GUNUNGKIDUL, DAERAH ISTIMEWA YOGYAKARTA",16,103,25,128
https://kawalpemilu.org#42079,"KEDUNGKERIS, NGLIPAR, GUNUNGKIDUL, DAERAH ISTIMEWA YOGYAKARTA",17,79,53,132
https://kawalpemilu.org#42080,"NGLIPAR, NGLIPAR, GUNUNGKIDUL, DAERAH ISTIMEWA YOGYAKARTA",1,116,38,154
https://kawalpemilu.org#42080,"NGLIPAR, NGLIPAR, GUNUNGKIDUL, DAERAH ISTIMEWA YOGYAKARTA",2,106,39,145
https://kawalpemilu.org#42080,"NGLIPAR, NGLIPAR, GUNUNGKIDUL, DAERAH ISTIMEWA YOGYAKARTA",3,78,20,98
https://kawalpemilu.org#42080,"NGLIPAR, NGLIPAR, GUNUNGKIDUL, DAERAH ISTIMEWA YOGYAKARTA",4,179,50,229
https://kawalpemilu.org#42080,"NGLIPAR, NGLIPAR, GUNUNGKIDUL, DAERAH ISTIMEWA YOGYAKARTA",5,157,68,225
https://kawalpemilu.org#42080,"NGLIPAR, NGLIPAR, GUNUNGKIDUL, DAERAH ISTIMEWA YOGYAKARTA",6,68,88,156
https://kawalpemilu.org#42080,"NGLIPAR, NGLIPAR, GUNUNGKIDUL, DAERAH ISTIMEWA YOGYAKARTA",7,111,51,162
https://kawalpemilu.org#42080,"NGLIPAR, NGLIPAR, GUNUNGKIDUL, DAERAH ISTIMEWA YOGYAKARTA",8,184,51,235
https://kawalpemilu.org#42080,"NGLIPAR, NGLIPAR, GUNUNGKIDUL, DAERAH ISTIMEWA YOGYAKARTA",9,177,57,234
https://kawalpemilu.org#42080,"NGLIPAR, NGLIPAR, GUNUNGKIDUL, DAERAH ISTIMEWA YOGYAKARTA",10,165,57,222
https://kawalpemilu.org#42080,"NGLIPAR, NGLIPAR, GUNUNGKIDUL, DAERAH ISTIMEWA YOGYAKARTA",11,132,90,222
https://kawalpemilu.org#42080,"NGLIPAR, NGLIPAR, GUNUNGKIDUL, DAERAH ISTIMEWA YOGYAKARTA",12,168,44,212
https://kawalpemilu.org#42080,"NGLIPAR, NGLIPAR, GUNUNGKIDUL, DAERAH ISTIMEWA YOGYAKARTA",13,180,21,201
https://kawalpemilu.org#42080,"NGLIPAR, NGLIPAR, GUNUNGKIDUL, DAERAH ISTIMEWA YOGYAKARTA",14,128,37,165
https://kawalpemilu.org#42080,"NGLIPAR, NGLIPAR, GUNUNGKIDUL, DAERAH ISTIMEWA YOGYAKARTA",15,96,48,144
https://kawalpemilu.org#42081,"KATONGAN, NGLIPAR, GUNUNGKIDUL, DAERAH ISTIMEWA YOGYAKARTA",1,195,36,231
https://kawalpemilu.org#42081,"KATONGAN, NGLIPAR, GUNUNGKIDUL, DAERAH ISTIMEWA YOGYAKARTA",2,169,38,207
https://kawalpemilu.org#42081,"KATONGAN, NGLIPAR, GUNUNGKIDUL, DAERAH ISTIMEWA YOGYAKARTA",3,187,42,229
https://kawalpemilu.org#42081,"KATONGAN, NGLIPAR, GUNUNGKIDUL, DAERAH ISTIMEWA YOGYAKARTA",4,105,100,205
https://kawalpemilu.org#42081,"KATONGAN, NGLIPAR, GUNUNGKIDUL, DAERAH ISTIMEWA YOGYAKARTA",5,74,57,131
https://kawalpemilu.org#42081,"KATONGAN, NGLIPAR, GUNUNGKIDUL, DAERAH ISTIMEWA YOGYAKARTA",6,168,41,209
https://kawalpemilu.org#42081,"KATONGAN, NGLIPAR, GUNUNGKIDUL, DAERAH ISTIMEWA YOGYAKARTA",7,85,54,139
https://kawalpemilu.org#42081,"KATONGAN, NGLIPAR, GUNUNGKIDUL, DAERAH ISTIMEWA YOGYAKARTA",8,156,13,169
https://kawalpemilu.org#42081,"KATONGAN, NGLIPAR, GUNUNGKIDUL, DAERAH ISTIMEWA YOGYAKARTA",9,164,28,192
https://kawalpemilu.org#42081,"KATONGAN, NGLIPAR, GUNUNGKIDUL, DAERAH ISTIMEWA YOGYAKARTA",10,146,48,194
https://kawalpemilu.org#42081,"KATONGAN, NGLIPAR, GUNUNGKIDUL, DAERAH ISTIMEWA YOGYAKARTA",11,93,46,139
https://kawalpemilu.org#42081,"KATONGAN, NGLIPAR, GUNUNGKIDUL, DAERAH ISTIMEWA YOGYAKARTA",12,96,99,195
https://kawalpemilu.org#42081,"KATONGAN, NGLIPAR, GUNUNGKIDUL, DAERAH ISTIMEWA YOGYAKARTA",13,84,35,119
https://kawalpemilu.org#42081,"KATONGAN, NGLIPAR, GUNUNGKIDUL, DAERAH ISTIMEWA YOGYAKARTA",14,131,111,242
https://kawalpemilu.org#42081,"KATONGAN, NGLIPAR, GUNUNGKIDUL, DAERAH ISTIMEWA YOGYAKARTA",15,133,61,194
https://kawalpemilu.org#42081,"KATONGAN, NGLIPAR, GUNUNGKIDUL, DAERAH ISTIMEWA YOGYAKARTA",16,78,33,111
https://kawalpemilu.org#42081,"KATONGAN, NGLIPAR, GUNUNGKIDUL, DAERAH ISTIMEWA YOGYAKARTA",17,97,29,126
https://kawalpemilu.org#42081,"KATONGAN, NGLIPAR, GUNUNGKIDUL, DAERAH ISTIMEWA YOGYAKARTA",18,152,36,188
https://kawalpemilu.org#42083,"BANYUSOCO, PLAYEN, GUNUNGKIDUL, DAERAH ISTIMEWA YOGYAKARTA",1,115,59,174
https://kawalpemilu.org#42083,"BANYUSOCO, PLAYEN, GUNUNGKIDUL, DAERAH ISTIMEWA YOGYAKARTA",2,115,34,149
https://kawalpemilu.org#42083,"BANYUSOCO, PLAYEN, GUNUNGKIDUL, DAERAH ISTIMEWA YOGYAKARTA",3,132,18,150
https://kawalpemilu.org#42083,"BANYUSOCO, PLAYEN, GUNUNGKIDUL, DAERAH ISTIMEWA YOGYAKARTA",4,146,55,201
https://kawalpemilu.org#42083,"BANYUSOCO, PLAYEN, GUNUNGKIDUL, DAERAH ISTIMEWA YOGYAKARTA",5,178,47,225
https://kawalpemilu.org#42083,"BANYUSOCO, PLAYEN, GUNUNGKIDUL, DAERAH ISTIMEWA YOGYAKARTA",6,120,31,151
https://kawalpemilu.org#42083,"BANYUSOCO, PLAYEN, GUNUNGKIDUL, DAERAH ISTIMEWA YOGYAKARTA",7,119,91,210
https://kawalpemilu.org#42083,"BANYUSOCO, PLAYEN, GUNUNGKIDUL, DAERAH ISTIMEWA YOGYAKARTA",8,77,49,126
https://kawalpemilu.org#42083,"BANYUSOCO, PLAYEN, GUNUNGKIDUL, DAERAH ISTIMEWA YOGYAKARTA",9,89,31,120
https://kawalpemilu.org#42083,"BANYUSOCO, PLAYEN, GUNUNGKIDUL, DAERAH ISTIMEWA YOGYAKARTA",10,122,44,166
https://kawalpemilu.org#42083,"BANYUSOCO, PLAYEN, GUNUNGKIDUL, DAERAH ISTIMEWA YOGYAKARTA",11,143,26,169
https://kawalpemilu.org#42083,"BANYUSOCO, PLAYEN, GUNUNGKIDUL, DAERAH ISTIMEWA YOGYAKARTA",12,165,24,189
https://kawalpemilu.org#42083,"BANYUSOCO, PLAYEN, GUNUNGKIDUL, DAERAH ISTIMEWA YOGYAKARTA",13,143,32,175
https://kawalpemilu.org#42083,"BANYUSOCO, PLAYEN, GUNUNGKIDUL, DAERAH ISTIMEWA YOGYAKARTA",14,116,10,126
https://kawalpemilu.org#42083,"BANYUSOCO, PLAYEN, GUNUNGKIDUL, DAERAH ISTIMEWA YOGYAKARTA",15,166,20,186
https://kawalpemilu.org#42083,"BANYUSOCO, PLAYEN, GUNUNGKIDUL, DAERAH ISTIMEWA YOGYAKARTA",16,147,10,157
https://kawalpemilu.org#42083,"BANYUSOCO, PLAYEN, GUNUNGKIDUL, DAERAH ISTIMEWA YOGYAKARTA",17,131,22,153
https://kawalpemilu.org#42083,"BANYUSOCO, PLAYEN, GUNUNGKIDUL, DAERAH ISTIMEWA YOGYAKARTA",18,159,16,175
https://kawalpemilu.org#42083,"BANYUSOCO, PLAYEN, GUNUNGKIDUL, DAERAH ISTIMEWA YOGYAKARTA",19,146,14,160
https://kawalpemilu.org#42083,"BANYUSOCO, PLAYEN, GUNUNGKIDUL, DAERAH ISTIMEWA YOGYAKARTA",20,167,29,196
https://kawalpemilu.org#42083,"BANYUSOCO, PLAYEN, GUNUNGKIDUL, DAERAH ISTIMEWA YOGYAKARTA",21,170,28,198
https://kawalpemilu.org#42083,"BANYUSOCO, PLAYEN, GUNUNGKIDUL, DAERAH ISTIMEWA YOGYAKARTA",22,143,8,151
https://kawalpemilu.org#42083,"BANYUSOCO, PLAYEN, GUNUNGKIDUL, DAERAH ISTIMEWA YOGYAKARTA",23,111,8,119
https://kawalpemilu.org#42084,"PLEMBUTAN, PLAYEN, GUNUNGKIDUL, DAERAH ISTIMEWA YOGYAKARTA",1,114,47,161
https://kawalpemilu.org#42084,"PLEMBUTAN, PLAYEN, GUNUNGKIDUL, DAERAH ISTIMEWA YOGYAKARTA",2,161,29,190
https://kawalpemilu.org#42084,"PLEMBUTAN, PLAYEN, GUNUNGKIDUL, DAERAH ISTIMEWA YOGYAKARTA",3,123,32,155
https://kawalpemilu.org#42084,"PLEMBUTAN, PLAYEN, GUNUNGKIDUL, DAERAH ISTIMEWA YOGYAKARTA",4,128,28,156
https://kawalpemilu.org#42084,"PLEMBUTAN, PLAYEN, GUNUNGKIDUL, DAERAH ISTIMEWA YOGYAKARTA",5,214,27,241
https://kawalpemilu.org#42084,"PLEMBUTAN, PLAYEN, GUNUNGKIDUL, DAERAH ISTIMEWA YOGYAKARTA",6,103,17,120
https://kawalpemilu.org#42084,"PLEMBUTAN, PLAYEN, GUNUNGKIDUL, DAERAH ISTIMEWA YOGYAKARTA",7,109,37,146
https://kawalpemilu.org#42084,"PLEMBUTAN, PLAYEN, GUNUNGKIDUL, DAERAH ISTIMEWA YOGYAKARTA",8,92,32,124
https://kawalpemilu.org#42084,"PLEMBUTAN, PLAYEN, GUNUNGKIDUL, DAERAH ISTIMEWA YOGYAKARTA",9,96,50,146
https://kawalpemilu.org#42084,"PLEMBUTAN, PLAYEN, GUNUNGKIDUL, DAERAH ISTIMEWA YOGYAKARTA",10,69,50,119
https://kawalpemilu.org#42084,"PLEMBUTAN, PLAYEN, GUNUNGKIDUL, DAERAH ISTIMEWA YOGYAKARTA",11,160,49,209
https://kawalpemilu.org#42084,"PLEMBUTAN, PLAYEN, GUNUNGKIDUL, DAERAH ISTIMEWA YOGYAKARTA",12,90,64,154
https://kawalpemilu.org#42084,"PLEMBUTAN, PLAYEN, GUNUNGKIDUL, DAERAH ISTIMEWA YOGYAKARTA",13,126,26,152
https://kawalpemilu.org#42084,"PLEMBUTAN, PLAYEN, GUNUNGKIDUL, DAERAH ISTIMEWA YOGYAKARTA",14,136,31,167
https://kawalpemilu.org#42084,"PLEMBUTAN, PLAYEN, GUNUNGKIDUL, DAERAH ISTIMEWA YOGYAKARTA",15,120,19,139
https://kawalpemilu.org#42084,"PLEMBUTAN, PLAYEN, GUNUNGKIDUL, DAERAH ISTIMEWA YOGYAKARTA",16,111,35,146
https://kawalpemilu.org#42084,"PLEMBUTAN, PLAYEN, GUNUNGKIDUL, DAERAH ISTIMEWA YOGYAKARTA",17,110,17,127
https://kawalpemilu.org#42084,"PLEMBUTAN, PLAYEN, GUNUNGKIDUL, DAERAH ISTIMEWA YOGYAKARTA",18,73,4,77
https://kawalpemilu.org#42084,"PLEMBUTAN, PLAYEN, GUNUNGKIDUL, DAERAH ISTIMEWA YOGYAKARTA",19,93,31,124
https://kawalpemilu.org#42084,"PLEMBUTAN, PLAYEN, GUNUNGKIDUL, DAERAH ISTIMEWA YOGYAKARTA",20,78,17,95
https://kawalpemilu.org#42084,"PLEMBUTAN, PLAYEN, GUNUNGKIDUL, DAERAH ISTIMEWA YOGYAKARTA",21,120,25,145
https://kawalpemilu.org#42084,"PLEMBUTAN, PLAYEN, GUNUNGKIDUL, DAERAH ISTIMEWA YOGYAKARTA",22,82,15,97
https://kawalpemilu.org#42085,"BLEBERAN, PLAYEN, GUNUNGKIDUL, DAERAH ISTIMEWA YOGYAKARTA",1,146,33,179
https://kawalpemilu.org#42085,"BLEBERAN, PLAYEN, GUNUNGKIDUL, DAERAH ISTIMEWA YOGYAKARTA",2,185,64,249
https://kawalpemilu.org#42085,"BLEBERAN, PLAYEN, GUNUNGKIDUL, DAERAH ISTIMEWA YOGYAKARTA",3,133,39,172
https://kawalpemilu.org#42085,"BLEBERAN, PLAYEN, GUNUNGKIDUL, DAERAH ISTIMEWA YOGYAKARTA",4,148,53,201
https://kawalpemilu.org#42085,"BLEBERAN, PLAYEN, GUNUNGKIDUL, DAERAH ISTIMEWA YOGYAKARTA",5,162,25,187
https://kawalpemilu.org#42085,"BLEBERAN, PLAYEN, GUNUNGKIDUL, DAERAH ISTIMEWA YOGYAKARTA",6,117,29,146
https://kawalpemilu.org#42085,"BLEBERAN, PLAYEN, GUNUNGKIDUL, DAERAH ISTIMEWA YOGYAKARTA",7,123,32,155
https://kawalpemilu.org#42085,"BLEBERAN, PLAYEN, GUNUNGKIDUL, DAERAH ISTIMEWA YOGYAKARTA",8,137,26,163
https://kawalpemilu.org#42085,"BLEBERAN, PLAYEN, GUNUNGKIDUL, DAERAH ISTIMEWA YOGYAKARTA",9,97,15,112
https://kawalpemilu.org#42085,"BLEBERAN, PLAYEN, GUNUNGKIDUL, DAERAH ISTIMEWA YOGYAKARTA",10,100,62,162
https://kawalpemilu.org#42085,"BLEBERAN, PLAYEN, GUNUNGKIDUL, DAERAH ISTIMEWA YOGYAKARTA",11,87,26,113
https://kawalpemilu.org#42085,"BLEBERAN, PLAYEN, GUNUNGKIDUL, DAERAH ISTIMEWA YOGYAKARTA",12,119,43,162
https://kawalpemilu.org#42085,"BLEBERAN, PLAYEN, GUNUNGKIDUL, DAERAH ISTIMEWA YOGYAKARTA",13,146,26,172
https://kawalpemilu.org#42085,"BLEBERAN, PLAYEN, GUNUNGKIDUL, DAERAH ISTIMEWA YOGYAKARTA",14,166,26,192
https://kawalpemilu.org#42085,"BLEBERAN, PLAYEN, GUNUNGKIDUL, DAERAH ISTIMEWA YOGYAKARTA",15,131,25,156
https://kawalpemilu.org#42085,"BLEBERAN, PLAYEN, GUNUNGKIDUL, DAERAH ISTIMEWA YOGYAKARTA",16,144,33,177
https://kawalpemilu.org#42085,"BLEBERAN, PLAYEN, GUNUNGKIDUL, DAERAH ISTIMEWA YOGYAKARTA",17,135,40,175
https://kawalpemilu.org#42085,"BLEBERAN, PLAYEN, GUNUNGKIDUL, DAERAH ISTIMEWA YOGYAKARTA",18,159,25,184
https://kawalpemilu.org#42085,"BLEBERAN, PLAYEN, GUNUNGKIDUL, DAERAH ISTIMEWA YOGYAKARTA",19,151,45,196
https://kawalpemilu.org#42085,"BLEBERAN, PLAYEN, GUNUNGKIDUL, DAERAH ISTIMEWA YOGYAKARTA",20,171,8,179
https://kawalpemilu.org#42085,"BLEBERAN, PLAYEN, GUNUNGKIDUL, DAERAH ISTIMEWA YOGYAKARTA",21,162,16,178
https://kawalpemilu.org#42086,"GETAS, PLAYEN, GUNUNGKIDUL, DAERAH ISTIMEWA YOGYAKARTA",1,150,39,189
https://kawalpemilu.org#42086,"GETAS, PLAYEN, GUNUNGKIDUL, DAERAH ISTIMEWA YOGYAKARTA",2,169,19,188
https://kawalpemilu.org#42086,"GETAS, PLAYEN, GUNUNGKIDUL, DAERAH ISTIMEWA YOGYAKARTA",3,173,16,189
https://kawalpemilu.org#42086,"GETAS, PLAYEN, GUNUNGKIDUL, DAERAH ISTIMEWA YOGYAKARTA",4,215,22,237
https://kawalpemilu.org#42086,"GETAS, PLAYEN, GUNUNGKIDUL, DAERAH ISTIMEWA YOGYAKARTA",5,163,29,192
https://kawalpemilu.org#42086,"GETAS, PLAYEN, GUNUNGKIDUL, DAERAH ISTIMEWA YOGYAKARTA",6,128,15,143
https://kawalpemilu.org#42086,"GETAS, PLAYEN, GUNUNGKIDUL, DAERAH ISTIMEWA YOGYAKARTA",7,195,23,218
https://kawalpemilu.org#42086,"GETAS, PLAYEN, GUNUNGKIDUL, DAERAH ISTIMEWA YOGYAKARTA",8,197,29,226
https://kawalpemilu.org#42086,"GETAS, PLAYEN, GUNUNGKIDUL, DAERAH ISTIMEWA YOGYAKARTA",9,145,26,171
https://kawalpemilu.org#42086,"GETAS, PLAYEN, GUNUNGKIDUL, DAERAH ISTIMEWA YOGYAKARTA",10,132,31,163
https://kawalpemilu.org#42086,"GETAS, PLAYEN, GUNUNGKIDUL, DAERAH ISTIMEWA YOGYAKARTA",11,186,29,215
https://kawalpemilu.org#42086,"GETAS, PLAYEN, GUNUNGKIDUL, DAERAH ISTIMEWA YOGYAKARTA",12,147,28,175
https://kawalpemilu.org#42086,"GETAS, PLAYEN, GUNUNGKIDUL, DAERAH ISTIMEWA YOGYAKARTA",13,209,20,229
https://kawalpemilu.org#42086,"GETAS, PLAYEN, GUNUNGKIDUL, DAERAH ISTIMEWA YOGYAKARTA",14,135,26,161
https://kawalpemilu.org#42086,"GETAS, PLAYEN, GUNUNGKIDUL, DAERAH ISTIMEWA YOGYAKARTA",15,143,25,168
https://kawalpemilu.org#42086,"GETAS, PLAYEN, GUNUNGKIDUL, DAERAH ISTIMEWA YOGYAKARTA",16,160,23,183
https://kawalpemilu.org#42086,"GETAS, PLAYEN, GUNUNGKIDUL, DAERAH ISTIMEWA YOGYAKARTA",17,170,28,198
https://kawalpemilu.org#42086,"GETAS, PLAYEN, GUNUNGKIDUL, DAERAH ISTIMEWA YOGYAKARTA",18,179,64,243
https://kawalpemilu.org#42087,"DENGOK, PLAYEN, GUNUNGKIDUL, DAERAH ISTIMEWA YOGYAKARTA",1,111,16,127
https://kawalpemilu.org#42087,"DENGOK, PLAYEN, GUNUNGKIDUL, DAERAH ISTIMEWA YOGYAKARTA",2,114,20,134
https://kawalpemilu.org#42087,"DENGOK, PLAYEN, GUNUNGKIDUL, DAERAH ISTIMEWA YOGYAKARTA",3,59,32,91
https://kawalpemilu.org#42087,"DENGOK, PLAYEN, GUNUNGKIDUL, DAERAH ISTIMEWA YOGYAKARTA",4,109,35,144
https://kawalpemilu.org#42087,"DENGOK, PLAYEN, GUNUNGKIDUL, DAERAH ISTIMEWA YOGYAKARTA",5,142,37,179
https://kawalpemilu.org#42087,"DENGOK, PLAYEN, GUNUNGKIDUL, DAERAH ISTIMEWA YOGYAKARTA",6,92,48,140
https://kawalpemilu.org#42087,"DENGOK, PLAYEN, GUNUNGKIDUL, DAERAH ISTIMEWA YOGYAKARTA",7,89,23,112
https://kawalpemilu.org#42087,"DENGOK, PLAYEN, GUNUNGKIDUL, DAERAH ISTIMEWA YOGYAKARTA",8,164,51,215
https://kawalpemilu.org#42087,"DENGOK, PLAYEN, GUNUNGKIDUL, DAERAH ISTIMEWA YOGYAKARTA",9,116,52,168
https://kawalpemilu.org#42087,"DENGOK, PLAYEN, GUNUNGKIDUL, DAERAH ISTIMEWA YOGYAKARTA",10,166,34,200
https://kawalpemilu.org#42087,"DENGOK, PLAYEN, GUNUNGKIDUL, DAERAH ISTIMEWA YOGYAKARTA",11,129,35,164
https://kawalpemilu.org#42088,"NGUNUT, PLAYEN, GUNUNGKIDUL, DAERAH ISTIMEWA YOGYAKARTA",1,152,12,164
https://kawalpemilu.org#42088,"NGUNUT, PLAYEN, GUNUNGKIDUL, DAERAH ISTIMEWA YOGYAKARTA",2,128,20,148
https://kawalpemilu.org#42088,"NGUNUT, PLAYEN, GUNUNGKIDUL, DAERAH ISTIMEWA YOGYAKARTA",3,119,54,173
https://kawalpemilu.org#42088,"NGUNUT, PLAYEN, GUNUNGKIDUL, DAERAH ISTIMEWA YOGYAKARTA",4,69,45,114
https://kawalpemilu.org#42088,"NGUNUT, PLAYEN, GUNUNGKIDUL, DAERAH ISTIMEWA YOGYAKARTA",5,117,41,158
https://kawalpemilu.org#42088,"NGUNUT, PLAYEN, GUNUNGKIDUL, DAERAH ISTIMEWA YOGYAKARTA",6,159,47,206
https://kawalpemilu.org#42088,"NGUNUT, PLAYEN, GUNUNGKIDUL, DAERAH ISTIMEWA YOGYAKARTA",7,157,36,193
https://kawalpemilu.org#42088,"NGUNUT, PLAYEN, GUNUNGKIDUL, DAERAH ISTIMEWA YOGYAKARTA",8,153,27,180
https://kawalpemilu.org#42088,"NGUNUT, PLAYEN, GUNUNGKIDUL, DAERAH ISTIMEWA YOGYAKARTA",9,125,26,151
https://kawalpemilu.org#42089,"PLAYEN, PLAYEN, GUNUNGKIDUL, DAERAH ISTIMEWA YOGYAKARTA",1,70,68,138
https://kawalpemilu.org#42089,"PLAYEN, PLAYEN, GUNUNGKIDUL, DAERAH ISTIMEWA YOGYAKARTA",2,152,41,193
https://kawalpemilu.org#42089,"PLAYEN, PLAYEN, GUNUNGKIDUL, DAERAH ISTIMEWA YOGYAKARTA",3,115,57,172
https://kawalpemilu.org#42089,"PLAYEN, PLAYEN, GUNUNGKIDUL, DAERAH ISTIMEWA YOGYAKARTA",4,168,32,200
https://kawalpemilu.org#42089,"PLAYEN, PLAYEN, GUNUNGKIDUL, DAERAH ISTIMEWA YOGYAKARTA",5,154,56,210
https://kawalpemilu.org#42089,"PLAYEN, PLAYEN, GUNUNGKIDUL, DAERAH ISTIMEWA YOGYAKARTA",6,97,44,141
https://kawalpemilu.org#42089,"PLAYEN, PLAYEN, GUNUNGKIDUL, DAERAH ISTIMEWA YOGYAKARTA",7,73,40,113
https://kawalpemilu.org#42089,"PLAYEN, PLAYEN, GUNUNGKIDUL, DAERAH ISTIMEWA YOGYAKARTA",8,88,37,125
https://kawalpemilu.org#42089,"PLAYEN, PLAYEN, GUNUNGKIDUL, DAERAH ISTIMEWA YOGYAKARTA",9,154,26,180
https://kawalpemilu.org#42089,"PLAYEN, PLAYEN, GUNUNGKIDUL, DAERAH ISTIMEWA YOGYAKARTA",10,135,93,228
https://kawalpemilu.org#42089,"PLAYEN, PLAYEN, GUNUNGKIDUL, DAERAH ISTIMEWA YOGYAKARTA",11,106,56,162
https://kawalpemilu.org#42089,"PLAYEN, PLAYEN, GUNUNGKIDUL, DAERAH ISTIMEWA YOGYAKARTA",12,121,15,136
https://kawalpemilu.org#42089,"PLAYEN, PLAYEN, GUNUNGKIDUL, DAERAH ISTIMEWA YOGYAKARTA",13,81,61,142
https://kawalpemilu.org#42089,"PLAYEN, PLAYEN, GUNUNGKIDUL, DAERAH ISTIMEWA YOGYAKARTA",14,146,26,172
https://kawalpemilu.org#42089,"PLAYEN, PLAYEN, GUNUNGKIDUL, DAERAH ISTIMEWA YOGYAKARTA",15,120,69,189
https://kawalpemilu.org#42089,"PLAYEN, PLAYEN, GUNUNGKIDUL, DAERAH ISTIMEWA YOGYAKARTA",16,112,35,147
https://kawalpemilu.org#42089,"PLAYEN, PLAYEN, GUNUNGKIDUL, DAERAH ISTIMEWA YOGYAKARTA",17,79,60,139
https://kawalpemilu.org#42090,"NGAWU, PLAYEN, GUNUNGKIDUL, DAERAH ISTIMEWA YOGYAKARTA",1,141,42,183
https://kawalpemilu.org#42090,"NGAWU, PLAYEN, GUNUNGKIDUL, DAERAH ISTIMEWA YOGYAKARTA",2,162,73,235
https://kawalpemilu.org#42090,"NGAWU, PLAYEN, GUNUNGKIDUL, DAERAH ISTIMEWA YOGYAKARTA",3,128,28,156
https://kawalpemilu.org#42090,"NGAWU, PLAYEN, GUNUNGKIDUL, DAERAH ISTIMEWA YOGYAKARTA",4,173,51,224
https://kawalpemilu.org#42090,"NGAWU, PLAYEN, GUNUNGKIDUL, DAERAH ISTIMEWA YOGYAKARTA",5,178,55,233
https://kawalpemilu.org#42090,"NGAWU, PLAYEN, GUNUNGKIDUL, DAERAH ISTIMEWA YOGYAKARTA",6,169,50,215
https://kawalpemilu.org#42090,"NGAWU, PLAYEN, GUNUNGKIDUL, DAERAH ISTIMEWA YOGYAKARTA",7,99,77,176
https://kawalpemilu.org#42090,"NGAWU, PLAYEN, GUNUNGKIDUL, DAERAH ISTIMEWA YOGYAKARTA",8,129,103,232
https://kawalpemilu.org#42090,"NGAWU, PLAYEN, GUNUNGKIDUL, DAERAH ISTIMEWA YOGYAKARTA",9,111,82,193
https://kawalpemilu.org#42090,"NGAWU, PLAYEN, GUNUNGKIDUL, DAERAH ISTIMEWA YOGYAKARTA",10,153,54,207
https://kawalpemilu.org#42090,"NGAWU, PLAYEN, GUNUNGKIDUL, DAERAH ISTIMEWA YOGYAKARTA",11,138,62,200
https://kawalpemilu.org#42090,"NGAWU, PLAYEN, GUNUNGKIDUL, DAERAH ISTIMEWA YOGYAKARTA",12,105,70,175
https://kawalpemilu.org#42090,"NGAWU, PLAYEN, GUNUNGKIDUL, DAERAH ISTIMEWA YOGYAKARTA",13,106,91,197
https://kawalpemilu.org#42091,"BANDUNG, PLAYEN, GUNUNGKIDUL, DAERAH ISTIMEWA YOGYAKARTA",1,177,44,221
https://kawalpemilu.org#42091,"BANDUNG, PLAYEN, GUNUNGKIDUL, DAERAH ISTIMEWA YOGYAKARTA",2,176,38,214
https://kawalpemilu.org#42091,"BANDUNG, PLAYEN, GUNUNGKIDUL, DAERAH ISTIMEWA YOGYAKARTA",3,123,26,149
https://kawalpemilu.org#42091,"BANDUNG, PLAYEN, GUNUNGKIDUL, DAERAH ISTIMEWA YOGYAKARTA",4,143,24,167
https://kawalpemilu.org#42091,"BANDUNG, PLAYEN, GUNUNGKIDUL, DAERAH ISTIMEWA YOGYAKARTA",5,125,57,182
https://kawalpemilu.org#42091,"BANDUNG, PLAYEN, GUNUNGKIDUL, DAERAH ISTIMEWA YOGYAKARTA",6,81,47,128
https://kawalpemilu.org#42091,"BANDUNG, PLAYEN, GUNUNGKIDUL, DAERAH ISTIMEWA YOGYAKARTA",7,160,45,205
https://kawalpemilu.org#42091,"BANDUNG, PLAYEN, GUNUNGKIDUL, DAERAH ISTIMEWA YOGYAKARTA",8,151,105,256
https://kawalpemilu.org#42091,"BANDUNG, PLAYEN, GUNUNGKIDUL, DAERAH ISTIMEWA YOGYAKARTA",9,162,52,214
https://kawalpemilu.org#42091,"BANDUNG, PLAYEN, GUNUNGKIDUL, DAERAH ISTIMEWA YOGYAKARTA",10,128,92,220
https://kawalpemilu.org#42091,"BANDUNG, PLAYEN, GUNUNGKIDUL, DAERAH ISTIMEWA YOGYAKARTA",11,102,50,152
https://kawalpemilu.org#42091,"BANDUNG, PLAYEN, GUNUNGKIDUL, DAERAH ISTIMEWA YOGYAKARTA",12,114,45,159
https://kawalpemilu.org#42091,"BANDUNG, PLAYEN, GUNUNGKIDUL, DAERAH ISTIMEWA YOGYAKARTA",13,102,100,202
https://kawalpemilu.org#42091,"BANDUNG, PLAYEN, GUNUNGKIDUL, DAERAH ISTIMEWA YOGYAKARTA",14,59,83,142
https://kawalpemilu.org#42092,"LOGANDENG, PLAYEN, GUNUNGKIDUL, DAERAH ISTIMEWA YOGYAKARTA",1,163,59,222
https://kawalpemilu.org#42092,"LOGANDENG, PLAYEN, GUNUNGKIDUL, DAERAH ISTIMEWA YOGYAKARTA",2,159,70,229
https://kawalpemilu.org#42092,"LOGANDENG, PLAYEN, GUNUNGKIDUL, DAERAH ISTIMEWA YOGYAKARTA",3,99,87,186
https://kawalpemilu.org#42092,"LOGANDENG, PLAYEN, GUNUNGKIDUL, DAERAH ISTIMEWA YOGYAKARTA",4,168,59,227
https://kawalpemilu.org#42092,"LOGANDENG, PLAYEN, GUNUNGKIDUL, DAERAH ISTIMEWA YOGYAKARTA",5,169,86,255
https://kawalpemilu.org#42092,"LOGANDENG, PLAYEN, GUNUNGKIDUL, DAERAH ISTIMEWA YOGYAKARTA",6,164,60,224
https://kawalpemilu.org#42092,"LOGANDENG, PLAYEN, GUNUNGKIDUL, DAERAH ISTIMEWA YOGYAKARTA",7,162,73,235
https://kawalpemilu.org#42092,"LOGANDENG, PLAYEN, GUNUNGKIDUL, DAERAH ISTIMEWA YOGYAKARTA",8,138,115,253
https://kawalpemilu.org#42092,"LOGANDENG, PLAYEN, GUNUNGKIDUL, DAERAH ISTIMEWA YOGYAKARTA",9,140,106,246
https://kawalpemilu.org#42092,"LOGANDENG, PLAYEN, GUNUNGKIDUL, DAERAH ISTIMEWA YOGYAKARTA",10,93,39,132
https://kawalpemilu.org#42092,"LOGANDENG, PLAYEN, GUNUNGKIDUL, DAERAH ISTIMEWA YOGYAKARTA",11,169,62,231
https://kawalpemilu.org#42092,"LOGANDENG, PLAYEN, GUNUNGKIDUL, DAERAH ISTIMEWA YOGYAKARTA",12,134,74,208
https://kawalpemilu.org#42092,"LOGANDENG, PLAYEN, GUNUNGKIDUL, DAERAH ISTIMEWA YOGYAKARTA",13,128,89,217
https://kawalpemilu.org#42092,"LOGANDENG, PLAYEN, GUNUNGKIDUL, DAERAH ISTIMEWA YOGYAKARTA",14,73,37,110
https://kawalpemilu.org#42092,"LOGANDENG, PLAYEN, GUNUNGKIDUL, DAERAH ISTIMEWA YOGYAKARTA",15,101,90,191
https://kawalpemilu.org#42092,"LOGANDENG, PLAYEN, GUNUNGKIDUL, DAERAH ISTIMEWA YOGYAKARTA",16,101,60,161
https://kawalpemilu.org#42092,"LOGANDENG, PLAYEN, GUNUNGKIDUL, DAERAH ISTIMEWA YOGYAKARTA",17,111,108,219
https://kawalpemilu.org#42092,"LOGANDENG, PLAYEN, GUNUNGKIDUL, DAERAH ISTIMEWA YOGYAKARTA",18,143,44,187
https://kawalpemilu.org#42092,"LOGANDENG, PLAYEN, GUNUNGKIDUL, DAERAH ISTIMEWA YOGYAKARTA",19,137,63,200
https://kawalpemilu.org#42092,"LOGANDENG, PLAYEN, GUNUNGKIDUL, DAERAH ISTIMEWA YOGYAKARTA",20,145,105,250
https://kawalpemilu.org#42092,"LOGANDENG, PLAYEN, GUNUNGKIDUL, DAERAH ISTIMEWA YOGYAKARTA",21,92,106,198
https://kawalpemilu.org#42092,"LOGANDENG, PLAYEN, GUNUNGKIDUL, DAERAH ISTIMEWA YOGYAKARTA",22,91,59,150
https://kawalpemilu.org#42092,"LOGANDENG, PLAYEN, GUNUNGKIDUL, DAERAH ISTIMEWA YOGYAKARTA",23,110,27,137
https://kawalpemilu.org#42092,"LOGANDENG, PLAYEN, GUNUNGKIDUL, DAERAH ISTIMEWA YOGYAKARTA",24,65,132,197
https://kawalpemilu.org#42092,"LOGANDENG, PLAYEN, GUNUNGKIDUL, DAERAH ISTIMEWA YOGYAKARTA",25,140,61,201
https://kawalpemilu.org#42092,"LOGANDENG, PLAYEN, GUNUNGKIDUL, DAERAH ISTIMEWA YOGYAKARTA",26,160,67,227
https://kawalpemilu.org#42092,"LOGANDENG, PLAYEN, GUNUNGKIDUL, DAERAH ISTIMEWA YOGYAKARTA",27,71,74,145
https://kawalpemilu.org#42092,"LOGANDENG, PLAYEN, GUNUNGKIDUL, DAERAH ISTIMEWA YOGYAKARTA",28,112,59,171
https://kawalpemilu.org#42093,"GADING, PLAYEN, GUNUNGKIDUL, DAERAH ISTIMEWA YOGYAKARTA",1,136,114,250
https://kawalpemilu.org#42093,"GADING, PLAYEN, GUNUNGKIDUL, DAERAH ISTIMEWA YOGYAKARTA",2,136,73,209
https://kawalpemilu.org#42093,"GADING, PLAYEN, GUNUNGKIDUL, DAERAH ISTIMEWA YOGYAKARTA",3,96,48,144
https://kawalpemilu.org#42093,"GADING, PLAYEN, GUNUNGKIDUL, DAERAH ISTIMEWA YOGYAKARTA",4,105,76,181
https://kawalpemilu.org#42093,"GADING, PLAYEN, GUNUNGKIDUL, DAERAH ISTIMEWA YOGYAKARTA",5,118,52,170
https://kawalpemilu.org#42093,"GADING, PLAYEN, GUNUNGKIDUL, DAERAH ISTIMEWA YOGYAKARTA",6,139,80,219
https://kawalpemilu.org#42093,"GADING, PLAYEN, GUNUNGKIDUL, DAERAH ISTIMEWA YOGYAKARTA",7,82,50,132
https://kawalpemilu.org#42093,"GADING, PLAYEN, GUNUNGKIDUL, DAERAH ISTIMEWA YOGYAKARTA",8,108,37,145
https://kawalpemilu.org#42093,"GADING, PLAYEN, GUNUNGKIDUL, DAERAH ISTIMEWA YOGYAKARTA",9,74,59,133
https://kawalpemilu.org#42093,"GADING, PLAYEN, GUNUNGKIDUL, DAERAH ISTIMEWA YOGYAKARTA",10,84,63,147
https://kawalpemilu.org#42093,"GADING, PLAYEN, GUNUNGKIDUL, DAERAH ISTIMEWA YOGYAKARTA",11,174,24,198
https://kawalpemilu.org#42093,"GADING, PLAYEN, GUNUNGKIDUL, DAERAH ISTIMEWA YOGYAKARTA",12,136,58,194
https://kawalpemilu.org#42093,"GADING, PLAYEN, GUNUNGKIDUL, DAERAH ISTIMEWA YOGYAKARTA",13,115,20,135
https://kawalpemilu.org#42093,"GADING, PLAYEN, GUNUNGKIDUL, DAERAH ISTIMEWA YOGYAKARTA",14,151,26,177
https://kawalpemilu.org#42093,"GADING, PLAYEN, GUNUNGKIDUL, DAERAH ISTIMEWA YOGYAKARTA",15,183,35,218
https://kawalpemilu.org#42093,"GADING, PLAYEN, GUNUNGKIDUL, DAERAH ISTIMEWA YOGYAKARTA",16,166,25,191
https://kawalpemilu.org#42093,"GADING, PLAYEN, GUNUNGKIDUL, DAERAH ISTIMEWA YOGYAKARTA",17,162,55,217
https://kawalpemilu.org#42093,"GADING, PLAYEN, GUNUNGKIDUL, DAERAH ISTIMEWA YOGYAKARTA",18,146,13,159
https://kawalpemilu.org#42093,"GADING, PLAYEN, GUNUNGKIDUL, DAERAH ISTIMEWA YOGYAKARTA",19,139,33,172
https://kawalpemilu.org#42093,"GADING, PLAYEN, GUNUNGKIDUL, DAERAH ISTIMEWA YOGYAKARTA",20,181,53,234
https://kawalpemilu.org#42093,"GADING, PLAYEN, GUNUNGKIDUL, DAERAH ISTIMEWA YOGYAKARTA",21,159,49,208
https://kawalpemilu.org#42093,"GADING, PLAYEN, GUNUNGKIDUL, DAERAH ISTIMEWA YOGYAKARTA",22,100,56,156
https://kawalpemilu.org#42093,"GADING, PLAYEN, GUNUNGKIDUL, DAERAH ISTIMEWA YOGYAKARTA",23,143,60,203
https://kawalpemilu.org#42094,"BANARAN, PLAYEN, GUNUNGKIDUL, DAERAH ISTIMEWA YOGYAKARTA",1,134,95,229
https://kawalpemilu.org#42094,"BANARAN, PLAYEN, GUNUNGKIDUL, DAERAH ISTIMEWA YOGYAKARTA",2,141,62,203
https://kawalpemilu.org#42094,"BANARAN, PLAYEN, GUNUNGKIDUL, DAERAH ISTIMEWA YOGYAKARTA",3,108,60,168
https://kawalpemilu.org#42094,"BANARAN, PLAYEN, GUNUNGKIDUL, DAERAH ISTIMEWA YOGYAKARTA",4,104,49,153
https://kawalpemilu.org#42094,"BANARAN, PLAYEN, GUNUNGKIDUL, DAERAH ISTIMEWA YOGYAKARTA",5,81,59,140
https://kawalpemilu.org#42094,"BANARAN, PLAYEN, GUNUNGKIDUL, DAERAH ISTIMEWA YOGYAKARTA",6,105,51,156
https://kawalpemilu.org#42094,"BANARAN, PLAYEN, GUNUNGKIDUL, DAERAH ISTIMEWA YOGYAKARTA",7,107,66,173
https://kawalpemilu.org#42094,"BANARAN, PLAYEN, GUNUNGKIDUL, DAERAH ISTIMEWA YOGYAKARTA",8,73,83,156
https://kawalpemilu.org#42094,"BANARAN, PLAYEN, GUNUNGKIDUL, DAERAH ISTIMEWA YOGYAKARTA",9,112,52,164
https://kawalpemilu.org#42094,"BANARAN, PLAYEN, GUNUNGKIDUL, DAERAH ISTIMEWA YOGYAKARTA",10,142,49,191
https://kawalpemilu.org#42094,"BANARAN, PLAYEN, GUNUNGKIDUL, DAERAH ISTIMEWA YOGYAKARTA",11,90,33,123
https://kawalpemilu.org#42094,"BANARAN, PLAYEN, GUNUNGKIDUL, DAERAH ISTIMEWA YOGYAKARTA",12,103,20,123
https://kawalpemilu.org#42094,"BANARAN, PLAYEN, GUNUNGKIDUL, DAERAH ISTIMEWA YOGYAKARTA",13,102,41,143
https://kawalpemilu.org#42094,"BANARAN, PLAYEN, GUNUNGKIDUL, DAERAH ISTIMEWA YOGYAKARTA",14,125,21,146
https://kawalpemilu.org#42094,"BANARAN, PLAYEN, GUNUNGKIDUL, DAERAH ISTIMEWA YOGYAKARTA",15,146,25,171
https://kawalpemilu.org#42094,"BANARAN, PLAYEN, GUNUNGKIDUL, DAERAH ISTIMEWA YOGYAKARTA",16,127,30,157
https://kawalpemilu.org#42094,"BANARAN, PLAYEN, GUNUNGKIDUL, DAERAH ISTIMEWA YOGYAKARTA",17,183,63,246
https://kawalpemilu.org#42095,"NGLERI, PLAYEN, GUNUNGKIDUL, DAERAH ISTIMEWA YOGYAKARTA",1,100,12,112
https://kawalpemilu.org#42095,"NGLERI, PLAYEN, GUNUNGKIDUL, DAERAH ISTIMEWA YOGYAKARTA",2,122,19,141
https://kawalpemilu.org#42095,"NGLERI, PLAYEN, GUNUNGKIDUL, DAERAH ISTIMEWA YOGYAKARTA",3,90,19,109
https://kawalpemilu.org#42095,"NGLERI, PLAYEN, GUNUNGKIDUL, DAERAH ISTIMEWA YOGYAKARTA",4,119,32,151
https://kawalpemilu.org#42095,"NGLERI, PLAYEN, GUNUNGKIDUL, DAERAH ISTIMEWA YOGYAKARTA",5,113,22,135
https://kawalpemilu.org#42095,"NGLERI, PLAYEN, GUNUNGKIDUL, DAERAH ISTIMEWA YOGYAKARTA",6,84,34,118
https://kawalpemilu.org#42095,"NGLERI, PLAYEN, GUNUNGKIDUL, DAERAH ISTIMEWA YOGYAKARTA",7,134,36,170
https://kawalpemilu.org#42095,"NGLERI, PLAYEN, GUNUNGKIDUL, DAERAH ISTIMEWA YOGYAKARTA",8,103,27,130
https://kawalpemilu.org#42095,"NGLERI, PLAYEN, GUNUNGKIDUL, DAERAH ISTIMEWA YOGYAKARTA",9,169,38,207
https://kawalpemilu.org#42095,"NGLERI, PLAYEN, GUNUNGKIDUL, DAERAH ISTIMEWA YOGYAKARTA",10,117,54,171
https://kawalpemilu.org#42095,"NGLERI, PLAYEN, GUNUNGKIDUL, DAERAH ISTIMEWA YOGYAKARTA",11,124,52,176
https://kawalpemilu.org#42095,"NGLERI, PLAYEN, GUNUNGKIDUL, DAERAH ISTIMEWA YOGYAKARTA",12,129,14,143
https://kawalpemilu.org#42095,"NGLERI, PLAYEN, GUNUNGKIDUL, DAERAH ISTIMEWA YOGYAKARTA",13,46,10,56
https://kawalpemilu.org#42097,"BUNDER, PATUK, GUNUNGKIDUL, DAERAH ISTIMEWA YOGYAKARTA",1,124,100,224
https://kawalpemilu.org#42097,"BUNDER, PATUK, GUNUNGKIDUL, DAERAH ISTIMEWA YOGYAKARTA",2,157,40,197
https://kawalpemilu.org#42097,"BUNDER, PATUK, GUNUNGKIDUL, DAERAH ISTIMEWA YOGYAKARTA",3,140,63,203
https://kawalpemilu.org#42097,"BUNDER, PATUK, GUNUNGKIDUL, DAERAH ISTIMEWA YOGYAKARTA",4,156,102,258
https://kawalpemilu.org#42097,"BUNDER, PATUK, GUNUNGKIDUL, DAERAH ISTIMEWA YOGYAKARTA",5,150,62,212
https://kawalpemilu.org#42097,"BUNDER, PATUK, GUNUNGKIDUL, DAERAH ISTIMEWA YOGYAKARTA",6,169,49,218
https://kawalpemilu.org#42097,"BUNDER, PATUK, GUNUNGKIDUL, DAERAH ISTIMEWA YOGYAKARTA",7,129,75,204
https://kawalpemilu.org#42097,"BUNDER, PATUK, GUNUNGKIDUL, DAERAH ISTIMEWA YOGYAKARTA",8,165,83,248
https://kawalpemilu.org#42097,"BUNDER, PATUK, GUNUNGKIDUL, DAERAH ISTIMEWA YOGYAKARTA",9,115,101,216
https://kawalpemilu.org#42097,"BUNDER, PATUK, GUNUNGKIDUL, DAERAH ISTIMEWA YOGYAKARTA",10,142,83,225
https://kawalpemilu.org#42098,"BEJI, PATUK, GUNUNGKIDUL, DAERAH ISTIMEWA YOGYAKARTA",1,216,34,250
https://kawalpemilu.org#42098,"BEJI, PATUK, GUNUNGKIDUL, DAERAH ISTIMEWA YOGYAKARTA",2,163,69,232
https://kawalpemilu.org#42098,"BEJI, PATUK, GUNUNGKIDUL, DAERAH ISTIMEWA YOGYAKARTA",3,155,38,193
https://kawalpemilu.org#42098,"BEJI, PATUK, GUNUNGKIDUL, DAERAH ISTIMEWA YOGYAKARTA",4,200,55,255
https://kawalpemilu.org#42098,"BEJI, PATUK, GUNUNGKIDUL, DAERAH ISTIMEWA YOGYAKARTA",5,163,44,207
https://kawalpemilu.org#42098,"BEJI, PATUK, GUNUNGKIDUL, DAERAH ISTIMEWA YOGYAKARTA",6,198,43,241
https://kawalpemilu.org#42098,"BEJI, PATUK, GUNUNGKIDUL, DAERAH ISTIMEWA YOGYAKARTA",7,166,47,213
https://kawalpemilu.org#42098,"BEJI, PATUK, GUNUNGKIDUL, DAERAH ISTIMEWA YOGYAKARTA",8,204,16,220
https://kawalpemilu.org#42099,"PENGKOK, PATUK, GUNUNGKIDUL, DAERAH ISTIMEWA YOGYAKARTA",1,145,72,217
https://kawalpemilu.org#42099,"PENGKOK, PATUK, GUNUNGKIDUL, DAERAH ISTIMEWA YOGYAKARTA",2,181,60,241
https://kawalpemilu.org#42099,"PENGKOK, PATUK, GUNUNGKIDUL, DAERAH ISTIMEWA YOGYAKARTA",3,105,95,200
https://kawalpemilu.org#42099,"PENGKOK, PATUK, GUNUNGKIDUL, DAERAH ISTIMEWA YOGYAKARTA",4,150,65,215
https://kawalpemilu.org#42099,"PENGKOK, PATUK, GUNUNGKIDUL, DAERAH ISTIMEWA YOGYAKARTA",5,113,108,221
https://kawalpemilu.org#42099,"PENGKOK, PATUK, GUNUNGKIDUL, DAERAH ISTIMEWA YOGYAKARTA",6,172,24,196
https://kawalpemilu.org#42099,"PENGKOK, PATUK, GUNUNGKIDUL, DAERAH ISTIMEWA YOGYAKARTA",7,130,68,198
https://kawalpemilu.org#42099,"PENGKOK, PATUK, GUNUNGKIDUL, DAERAH ISTIMEWA YOGYAKARTA",8,174,36,210
https://kawalpemilu.org#42099,"PENGKOK, PATUK, GUNUNGKIDUL, DAERAH ISTIMEWA YOGYAKARTA",9,166,43,209
https://kawalpemilu.org#42100,"SEMOYO, PATUK, GUNUNGKIDUL, DAERAH ISTIMEWA YOGYAKARTA",1,194,42,236
https://kawalpemilu.org#42100,"SEMOYO, PATUK, GUNUNGKIDUL, DAERAH ISTIMEWA YOGYAKARTA",2,146,53,199
https://kawalpemilu.org#42100,"SEMOYO, PATUK, GUNUNGKIDUL, DAERAH ISTIMEWA YOGYAKARTA",3,155,62,217
https://kawalpemilu.org#42100,"SEMOYO, PATUK, GUNUNGKIDUL, DAERAH ISTIMEWA YOGYAKARTA",4,150,37,187
https://kawalpemilu.org#42100,"SEMOYO, PATUK, GUNUNGKIDUL, DAERAH ISTIMEWA YOGYAKARTA",5,175,57,232
https://kawalpemilu.org#42100,"SEMOYO, PATUK, GUNUNGKIDUL, DAERAH ISTIMEWA YOGYAKARTA",6,193,35,228
https://kawalpemilu.org#42100,"SEMOYO, PATUK, GUNUNGKIDUL, DAERAH ISTIMEWA YOGYAKARTA",7,188,51,239
https://kawalpemilu.org#42100,"SEMOYO, PATUK, GUNUNGKIDUL, DAERAH ISTIMEWA YOGYAKARTA",8,155,89,244
https://kawalpemilu.org#42101,"SALAM, PATUK, GUNUNGKIDUL, DAERAH ISTIMEWA YOGYAKARTA",1,201,30,231
https://kawalpemilu.org#42101,"SALAM, PATUK, GUNUNGKIDUL, DAERAH ISTIMEWA YOGYAKARTA",2,190,37,227
https://kawalpemilu.org#42101,"SALAM, PATUK, GUNUNGKIDUL, DAERAH ISTIMEWA YOGYAKARTA",3,163,48,211
https://kawalpemilu.org#42101,"SALAM, PATUK, GUNUNGKIDUL, DAERAH ISTIMEWA YOGYAKARTA",4,168,63,231
https://kawalpemilu.org#42101,"SALAM, PATUK, GUNUNGKIDUL, DAERAH ISTIMEWA YOGYAKARTA",5,190,48,238
https://kawalpemilu.org#42101,"SALAM, PATUK, GUNUNGKIDUL, DAERAH ISTIMEWA YOGYAKARTA",7,164,37,201
https://kawalpemilu.org#42101,"SALAM, PATUK, GUNUNGKIDUL, DAERAH ISTIMEWA YOGYAKARTA",8,168,76,244
https://kawalpemilu.org#42101,"SALAM, PATUK, GUNUNGKIDUL, DAERAH ISTIMEWA YOGYAKARTA",9,152,91,243
https://kawalpemilu.org#42102,"PATUK, PATUK, GUNUNGKIDUL, DAERAH ISTIMEWA YOGYAKARTA",1,132,112,244
https://kawalpemilu.org#42102,"PATUK, PATUK, GUNUNGKIDUL, DAERAH ISTIMEWA YOGYAKARTA",2,127,128,255
https://kawalpemilu.org#42102,"PATUK, PATUK, GUNUNGKIDUL, DAERAH ISTIMEWA YOGYAKARTA",3,140,103,243
https://kawalpemilu.org#42102,"PATUK, PATUK, GUNUNGKIDUL, DAERAH ISTIMEWA YOGYAKARTA",4,110,72,182
https://kawalpemilu.org#42102,"PATUK, PATUK, GUNUNGKIDUL, DAERAH ISTIMEWA YOGYAKARTA",5,153,81,234
https://kawalpemilu.org#42102,"PATUK, PATUK, GUNUNGKIDUL, DAERAH ISTIMEWA YOGYAKARTA",6,170,46,216
https://kawalpemilu.org#42102,"PATUK, PATUK, GUNUNGKIDUL, DAERAH ISTIMEWA YOGYAKARTA",7,198,65,263
https://kawalpemilu.org#42102,"PATUK, PATUK, GUNUNGKIDUL, DAERAH ISTIMEWA YOGYAKARTA",8,163,81,244
https://kawalpemilu.org#42103,"NGORO-ORO, PATUK, GUNUNGKIDUL, DAERAH ISTIMEWA YOGYAKARTA",1,123,44,167
https://kawalpemilu.org#42103,"NGORO-ORO, PATUK, GUNUNGKIDUL, DAERAH ISTIMEWA YOGYAKARTA",2,145,70,215
https://kawalpemilu.org#42103,"NGORO-ORO, PATUK, GUNUNGKIDUL, DAERAH ISTIMEWA YOGYAKARTA",3,170,20,190
https://kawalpemilu.org#42103,"NGORO-ORO, PATUK, GUNUNGKIDUL, DAERAH ISTIMEWA YOGYAKARTA",4,132,33,165
https://kawalpemilu.org#42103,"NGORO-ORO, PATUK, GUNUNGKIDUL, DAERAH ISTIMEWA YOGYAKARTA",5,195,22,217
https://kawalpemilu.org#42103,"NGORO-ORO, PATUK, GUNUNGKIDUL, DAERAH ISTIMEWA YOGYAKARTA",6,204,63,267
https://kawalpemilu.org#42103,"NGORO-ORO, PATUK, GUNUNGKIDUL, DAERAH ISTIMEWA YOGYAKARTA",7,148,57,205
https://kawalpemilu.org#42103,"NGORO-ORO, PATUK, GUNUNGKIDUL, DAERAH ISTIMEWA YOGYAKARTA",8,181,60,241
https://kawalpemilu.org#42103,"NGORO-ORO, PATUK, GUNUNGKIDUL, DAERAH ISTIMEWA YOGYAKARTA",9,172,73,245
https://kawalpemilu.org#42103,"NGORO-ORO, PATUK, GUNUNGKIDUL, DAERAH ISTIMEWA YOGYAKARTA",10,127,102,229
https://kawalpemilu.org#42103,"NGORO-ORO, PATUK, GUNUNGKIDUL, DAERAH ISTIMEWA YOGYAKARTA",11,147,70,217
https://kawalpemilu.org#42104,"NGLANGGERAN, PATUK, GUNUNGKIDUL, DAERAH ISTIMEWA YOGYAKARTA",1,183,54,237
https://kawalpemilu.org#42104,"NGLANGGERAN, PATUK, GUNUNGKIDUL, DAERAH ISTIMEWA YOGYAKARTA",2,165,24,189
https://kawalpemilu.org#42104,"NGLANGGERAN, PATUK, GUNUNGKIDUL, DAERAH ISTIMEWA YOGYAKARTA",3,154,33,187
https://kawalpemilu.org#42104,"NGLANGGERAN, PATUK, GUNUNGKIDUL, DAERAH ISTIMEWA YOGYAKARTA",4,163,41,204
https://kawalpemilu.org#42104,"NGLANGGERAN, PATUK, GUNUNGKIDUL, DAERAH ISTIMEWA YOGYAKARTA",5,170,58,228
https://kawalpemilu.org#42104,"NGLANGGERAN, PATUK, GUNUNGKIDUL, DAERAH ISTIMEWA YOGYAKARTA",6,189,41,230
https://kawalpemilu.org#42104,"NGLANGGERAN, PATUK, GUNUNGKIDUL, DAERAH ISTIMEWA YOGYAKARTA",7,180,20,200
https://kawalpemilu.org#42104,"NGLANGGERAN, PATUK, GUNUNGKIDUL, DAERAH ISTIMEWA YOGYAKARTA",8,142,89,231
https://kawalpemilu.org#42105,"PUTAT, PATUK, GUNUNGKIDUL, DAERAH ISTIMEWA YOGYAKARTA",1,195,62,257
https://kawalpemilu.org#42105,"PUTAT, PATUK, GUNUNGKIDUL, DAERAH ISTIMEWA YOGYAKARTA",2,166,104,270
https://kawalpemilu.org#42105,"PUTAT, PATUK, GUNUNGKIDUL, DAERAH ISTIMEWA YOGYAKARTA",3,184,66,250
https://kawalpemilu.org#42105,"PUTAT, PATUK, GUNUNGKIDUL, DAERAH ISTIMEWA YOGYAKARTA",4,180,51,231
https://kawalpemilu.org#42105,"PUTAT, PATUK, GUNUNGKIDUL, DAERAH ISTIMEWA YOGYAKARTA",5,119,58,177
https://kawalpemilu.org#42105,"PUTAT, PATUK, GUNUNGKIDUL, DAERAH ISTIMEWA YOGYAKARTA",6,157,67,224
https://kawalpemilu.org#42105,"PUTAT, PATUK, GUNUNGKIDUL, DAERAH ISTIMEWA YOGYAKARTA",7,131,52,183
https://kawalpemilu.org#42105,"PUTAT, PATUK, GUNUNGKIDUL, DAERAH ISTIMEWA YOGYAKARTA",8,146,66,212
https://kawalpemilu.org#42105,"PUTAT, PATUK, GUNUNGKIDUL, DAERAH ISTIMEWA YOGYAKARTA",9,197,43,240
https://kawalpemilu.org#42105,"PUTAT, PATUK, GUNUNGKIDUL, DAERAH ISTIMEWA YOGYAKARTA",10,176,78,254
https://kawalpemilu.org#42105,"PUTAT, PATUK, GUNUNGKIDUL, DAERAH ISTIMEWA YOGYAKARTA",11,173,56,229
https://kawalpemilu.org#42105,"PUTAT, PATUK, GUNUNGKIDUL, DAERAH ISTIMEWA YOGYAKARTA",12,119,91,210
https://kawalpemilu.org#42106,"NGLEGI, PATUK, GUNUNGKIDUL, DAERAH ISTIMEWA YOGYAKARTA",1,159,75,234
https://kawalpemilu.org#42106,"NGLEGI, PATUK, GUNUNGKIDUL, DAERAH ISTIMEWA YOGYAKARTA",3,155,65,220
https://kawalpemilu.org#42106,"NGLEGI, PATUK, GUNUNGKIDUL, DAERAH ISTIMEWA YOGYAKARTA",4,151,76,227
https://kawalpemilu.org#42106,"NGLEGI, PATUK, GUNUNGKIDUL, DAERAH ISTIMEWA YOGYAKARTA",5,179,61,240
https://kawalpemilu.org#42106,"NGLEGI, PATUK, GUNUNGKIDUL, DAERAH ISTIMEWA YOGYAKARTA",6,116,31,147
https://kawalpemilu.org#42106,"NGLEGI, PATUK, GUNUNGKIDUL, DAERAH ISTIMEWA YOGYAKARTA",7,179,42,221
https://kawalpemilu.org#42106,"NGLEGI, PATUK, GUNUNGKIDUL, DAERAH ISTIMEWA YOGYAKARTA",8,179,48,227
https://kawalpemilu.org#42106,"NGLEGI, PATUK, GUNUNGKIDUL, DAERAH ISTIMEWA YOGYAKARTA",9,99,67,166
https://kawalpemilu.org#42106,"NGLEGI, PATUK, GUNUNGKIDUL, DAERAH ISTIMEWA YOGYAKARTA",10,130,75,205
https://kawalpemilu.org#42107,"TERBAH, PATUK, GUNUNGKIDUL, DAERAH ISTIMEWA YOGYAKARTA",1,172,35,207
https://kawalpemilu.org#42107,"TERBAH, PATUK, GUNUNGKIDUL, DAERAH ISTIMEWA YOGYAKARTA",2,170,49,219
https://kawalpemilu.org#42107,"TERBAH, PATUK, GUNUNGKIDUL, DAERAH ISTIMEWA YOGYAKARTA",3,143,50,193
https://kawalpemilu.org#42107,"TERBAH, PATUK, GUNUNGKIDUL, DAERAH ISTIMEWA YOGYAKARTA",4,207,30,237
https://kawalpemilu.org#42107,"TERBAH, PATUK, GUNUNGKIDUL, DAERAH ISTIMEWA YOGYAKARTA",5,118,77,195
https://kawalpemilu.org#42107,"TERBAH, PATUK, GUNUNGKIDUL, DAERAH ISTIMEWA YOGYAKARTA",6,157,49,206
https://kawalpemilu.org#42107,"TERBAH, PATUK, GUNUNGKIDUL, DAERAH ISTIMEWA YOGYAKARTA",7,201,34,235
https://kawalpemilu.org#42107,"TERBAH, PATUK, GUNUNGKIDUL, DAERAH ISTIMEWA YOGYAKARTA",8,141,25,166
https://kawalpemilu.org#42109,"SODO, PALIYAN, GUNUNGKIDUL, DAERAH ISTIMEWA YOGYAKARTA",1,152,65,217
https://kawalpemilu.org#42109,"SODO, PALIYAN, GUNUNGKIDUL, DAERAH ISTIMEWA YOGYAKARTA",2,158,11,169
https://kawalpemilu.org#42109,"SODO, PALIYAN, GUNUNGKIDUL, DAERAH ISTIMEWA YOGYAKARTA",3,140,44,184
https://kawalpemilu.org#42109,"SODO, PALIYAN, GUNUNGKIDUL, DAERAH ISTIMEWA YOGYAKARTA",4,170,49,219
https://kawalpemilu.org#42109,"SODO, PALIYAN, GUNUNGKIDUL, DAERAH ISTIMEWA YOGYAKARTA",5,198,37,235
https://kawalpemilu.org#42109,"SODO, PALIYAN, GUNUNGKIDUL, DAERAH ISTIMEWA YOGYAKARTA",6,200,34,234
https://kawalpemilu.org#42109,"SODO, PALIYAN, GUNUNGKIDUL, DAERAH ISTIMEWA YOGYAKARTA",7,164,49,213
https://kawalpemilu.org#42109,"SODO, PALIYAN, GUNUNGKIDUL, DAERAH ISTIMEWA YOGYAKARTA",8,159,57,216
https://kawalpemilu.org#42109,"SODO, PALIYAN, GUNUNGKIDUL, DAERAH ISTIMEWA YOGYAKARTA",9,77,84,161
https://kawalpemilu.org#42109,"SODO, PALIYAN, GUNUNGKIDUL, DAERAH ISTIMEWA YOGYAKARTA",10,130,86,216
https://kawalpemilu.org#42109,"SODO, PALIYAN, GUNUNGKIDUL, DAERAH ISTIMEWA YOGYAKARTA",11,119,50,169
https://kawalpemilu.org#42109,"SODO, PALIYAN, GUNUNGKIDUL, DAERAH ISTIMEWA YOGYAKARTA",12,111,73,184
https://kawalpemilu.org#42109,"SODO, PALIYAN, GUNUNGKIDUL, DAERAH ISTIMEWA YOGYAKARTA",13,132,66,198
https://kawalpemilu.org#42109,"SODO, PALIYAN, GUNUNGKIDUL, DAERAH ISTIMEWA YOGYAKARTA",14,167,77,244
https://kawalpemilu.org#42109,"SODO, PALIYAN, GUNUNGKIDUL, DAERAH ISTIMEWA YOGYAKARTA",15,181,64,245
https://kawalpemilu.org#42110,"PAMPANG, PALIYAN, GUNUNGKIDUL, DAERAH ISTIMEWA YOGYAKARTA",1,184,36,220
https://kawalpemilu.org#42110,"PAMPANG, PALIYAN, GUNUNGKIDUL, DAERAH ISTIMEWA YOGYAKARTA",2,119,56,175
https://kawalpemilu.org#42110,"PAMPANG, PALIYAN, GUNUNGKIDUL, DAERAH ISTIMEWA YOGYAKARTA",3,98,45,143
https://kawalpemilu.org#42110,"PAMPANG, PALIYAN, GUNUNGKIDUL, DAERAH ISTIMEWA YOGYAKARTA",4,100,34,134
https://kawalpemilu.org#42110,"PAMPANG, PALIYAN, GUNUNGKIDUL, DAERAH ISTIMEWA YOGYAKARTA",5,155,76,231
https://kawalpemilu.org#42110,"PAMPANG, PALIYAN, GUNUNGKIDUL, DAERAH ISTIMEWA YOGYAKARTA",6,163,45,208
https://kawalpemilu.org#42110,"PAMPANG, PALIYAN, GUNUNGKIDUL, DAERAH ISTIMEWA YOGYAKARTA",7,169,59,228
https://kawalpemilu.org#42110,"PAMPANG, PALIYAN, GUNUNGKIDUL, DAERAH ISTIMEWA YOGYAKARTA",8,131,36,167
https://kawalpemilu.org#42110,"PAMPANG, PALIYAN, GUNUNGKIDUL, DAERAH ISTIMEWA YOGYAKARTA",9,153,45,198
https://kawalpemilu.org#42111,"GROGOL, PALIYAN, GUNUNGKIDUL, DAERAH ISTIMEWA YOGYAKARTA",1,100,63,163
https://kawalpemilu.org#42111,"GROGOL, PALIYAN, GUNUNGKIDUL, DAERAH ISTIMEWA YOGYAKARTA",2,63,69,132
https://kawalpemilu.org#42111,"GROGOL, PALIYAN, GUNUNGKIDUL, DAERAH ISTIMEWA YOGYAKARTA",3,146,79,225
https://kawalpemilu.org#42111,"GROGOL, PALIYAN, GUNUNGKIDUL, DAERAH ISTIMEWA YOGYAKARTA",4,156,71,227
https://kawalpemilu.org#42111,"GROGOL, PALIYAN, GUNUNGKIDUL, DAERAH ISTIMEWA YOGYAKARTA",5,89,39,128
https://kawalpemilu.org#42111,"GROGOL, PALIYAN, GUNUNGKIDUL, DAERAH ISTIMEWA YOGYAKARTA",6,105,27,132
https://kawalpemilu.org#42111,"GROGOL, PALIYAN, GUNUNGKIDUL, DAERAH ISTIMEWA YOGYAKARTA",7,97,42,139
https://kawalpemilu.org#42111,"GROGOL, PALIYAN, GUNUNGKIDUL, DAERAH ISTIMEWA YOGYAKARTA",8,150,46,196
https://kawalpemilu.org#42111,"GROGOL, PALIYAN, GUNUNGKIDUL, DAERAH ISTIMEWA YOGYAKARTA",9,121,46,167
https://kawalpemilu.org#42112,"KARANGDUWET, PALIYAN, GUNUNGKIDUL, DAERAH ISTIMEWA YOGYAKARTA",1,95,51,146
https://kawalpemilu.org#42112,"KARANGDUWET, PALIYAN, GUNUNGKIDUL, DAERAH ISTIMEWA YOGYAKARTA",2,82,73,155
https://kawalpemilu.org#42112,"KARANGDUWET, PALIYAN, GUNUNGKIDUL, DAERAH ISTIMEWA YOGYAKARTA",3,162,71,233
https://kawalpemilu.org#42112,"KARANGDUWET, PALIYAN, GUNUNGKIDUL, DAERAH ISTIMEWA YOGYAKARTA",4,158,75,233
https://kawalpemilu.org#42112,"KARANGDUWET, PALIYAN, GUNUNGKIDUL, DAERAH ISTIMEWA YOGYAKARTA",5,102,43,145
https://kawalpemilu.org#42112,"KARANGDUWET, PALIYAN, GUNUNGKIDUL, DAERAH ISTIMEWA YOGYAKARTA",6,88,38,126
https://kawalpemilu.org#42112,"KARANGDUWET, PALIYAN, GUNUNGKIDUL, DAERAH ISTIMEWA YOGYAKARTA",7,90,63,153
https://kawalpemilu.org#42112,"KARANGDUWET, PALIYAN, GUNUNGKIDUL, DAERAH ISTIMEWA YOGYAKARTA",8,116,21,137
https://kawalpemilu.org#42112,"KARANGDUWET, PALIYAN, GUNUNGKIDUL, DAERAH ISTIMEWA YOGYAKARTA",9,194,35,229
https://kawalpemilu.org#42112,"KARANGDUWET, PALIYAN, GUNUNGKIDUL, DAERAH ISTIMEWA YOGYAKARTA",10,150,35,185
https://kawalpemilu.org#42112,"KARANGDUWET, PALIYAN, GUNUNGKIDUL, DAERAH ISTIMEWA YOGYAKARTA",11,118,43,161
https://kawalpemilu.org#42112,"KARANGDUWET, PALIYAN, GUNUNGKIDUL, DAERAH ISTIMEWA YOGYAKARTA",12,103,55,158
https://kawalpemilu.org#42112,"KARANGDUWET, PALIYAN, GUNUNGKIDUL, DAERAH ISTIMEWA YOGYAKARTA",13,102,30,132
https://kawalpemilu.org#42112,"KARANGDUWET, PALIYAN, GUNUNGKIDUL, DAERAH ISTIMEWA YOGYAKARTA",14,100,112,212
https://kawalpemilu.org#42112,"KARANGDUWET, PALIYAN, GUNUNGKIDUL, DAERAH ISTIMEWA YOGYAKARTA",15,136,72,208
https://kawalpemilu.org#42112,"KARANGDUWET, PALIYAN, GUNUNGKIDUL, DAERAH ISTIMEWA YOGYAKARTA",16,90,102,192
https://kawalpemilu.org#42112,"KARANGDUWET, PALIYAN, GUNUNGKIDUL, DAERAH ISTIMEWA YOGYAKARTA",17,80,74,154
https://kawalpemilu.org#42112,"KARANGDUWET, PALIYAN, GUNUNGKIDUL, DAERAH ISTIMEWA YOGYAKARTA",18,75,106,181
https://kawalpemilu.org#42112,"KARANGDUWET, PALIYAN, GUNUNGKIDUL, DAERAH ISTIMEWA YOGYAKARTA",19,139,54,193
https://kawalpemilu.org#42112,"KARANGDUWET, PALIYAN, GUNUNGKIDUL, DAERAH ISTIMEWA YOGYAKARTA",20,110,48,158
https://kawalpemilu.org#42112,"KARANGDUWET, PALIYAN, GUNUNGKIDUL, DAERAH ISTIMEWA YOGYAKARTA",21,228,25,253
https://kawalpemilu.org#42112,"KARANGDUWET, PALIYAN, GUNUNGKIDUL, DAERAH ISTIMEWA YOGYAKARTA",22,140,37,177
https://kawalpemilu.org#42112,"KARANGDUWET, PALIYAN, GUNUNGKIDUL, DAERAH ISTIMEWA YOGYAKARTA",23,145,22,167
https://kawalpemilu.org#42112,"KARANGDUWET, PALIYAN, GUNUNGKIDUL, DAERAH ISTIMEWA YOGYAKARTA",24,141,39,180
https://kawalpemilu.org#42113,"KARANGASEM, PALIYAN, GUNUNGKIDUL, DAERAH ISTIMEWA YOGYAKARTA",1,147,53,200
https://kawalpemilu.org#42113,"KARANGASEM, PALIYAN, GUNUNGKIDUL, DAERAH ISTIMEWA YOGYAKARTA",2,123,42,165
https://kawalpemilu.org#42113,"KARANGASEM, PALIYAN, GUNUNGKIDUL, DAERAH ISTIMEWA YOGYAKARTA",3,168,53,221
https://kawalpemilu.org#42113,"KARANGASEM, PALIYAN, GUNUNGKIDUL, DAERAH ISTIMEWA YOGYAKARTA",4,206,39,245
https://kawalpemilu.org#42113,"KARANGASEM, PALIYAN, GUNUNGKIDUL, DAERAH ISTIMEWA YOGYAKARTA",5,117,40,157
https://kawalpemilu.org#42113,"KARANGASEM, PALIYAN, GUNUNGKIDUL, DAERAH ISTIMEWA YOGYAKARTA",6,132,55,187
https://kawalpemilu.org#42113,"KARANGASEM, PALIYAN, GUNUNGKIDUL, DAERAH ISTIMEWA YOGYAKARTA",7,156,21,177
https://kawalpemilu.org#42113,"KARANGASEM, PALIYAN, GUNUNGKIDUL, DAERAH ISTIMEWA YOGYAKARTA",8,139,66,205
https://kawalpemilu.org#42113,"KARANGASEM, PALIYAN, GUNUNGKIDUL, DAERAH ISTIMEWA YOGYAKARTA",9,174,69,243
https://kawalpemilu.org#42113,"KARANGASEM, PALIYAN, GUNUNGKIDUL, DAERAH ISTIMEWA YOGYAKARTA",10,203,46,249
https://kawalpemilu.org#42113,"KARANGASEM, PALIYAN, GUNUNGKIDUL, DAERAH ISTIMEWA YOGYAKARTA",11,139,41,180
https://kawalpemilu.org#42113,"KARANGASEM, PALIYAN, GUNUNGKIDUL, DAERAH ISTIMEWA YOGYAKARTA",12,199,51,250
https://kawalpemilu.org#42113,"KARANGASEM, PALIYAN, GUNUNGKIDUL, DAERAH ISTIMEWA YOGYAKARTA",13,138,31,169
https://kawalpemilu.org#42113,"KARANGASEM, PALIYAN, GUNUNGKIDUL, DAERAH ISTIMEWA YOGYAKARTA",14,108,33,141
https://kawalpemilu.org#42113,"KARANGASEM, PALIYAN, GUNUNGKIDUL, DAERAH ISTIMEWA YOGYAKARTA",15,85,56,141
https://kawalpemilu.org#42113,"KARANGASEM, PALIYAN, GUNUNGKIDUL, DAERAH ISTIMEWA YOGYAKARTA",16,123,81,204
https://kawalpemilu.org#42113,"KARANGASEM, PALIYAN, GUNUNGKIDUL, DAERAH ISTIMEWA YOGYAKARTA",17,96,66,162
https://kawalpemilu.org#42113,"KARANGASEM, PALIYAN, GUNUNGKIDUL, DAERAH ISTIMEWA YOGYAKARTA",18,139,92,231
https://kawalpemilu.org#42113,"KARANGASEM, PALIYAN, GUNUNGKIDUL, DAERAH ISTIMEWA YOGYAKARTA",19,128,122,250
https://kawalpemilu.org#42113,"KARANGASEM, PALIYAN, GUNUNGKIDUL, DAERAH ISTIMEWA YOGYAKARTA",20,139,99,238
https://kawalpemilu.org#42113,"KARANGASEM, PALIYAN, GUNUNGKIDUL, DAERAH ISTIMEWA YOGYAKARTA",21,118,65,183
https://kawalpemilu.org#42113,"KARANGASEM, PALIYAN, GUNUNGKIDUL, DAERAH ISTIMEWA YOGYAKARTA",22,120,43,163
https://kawalpemilu.org#42113,"KARANGASEM, PALIYAN, GUNUNGKIDUL, DAERAH ISTIMEWA YOGYAKARTA",23,106,82,188
https://kawalpemilu.org#42113,"KARANGASEM, PALIYAN, GUNUNGKIDUL, DAERAH ISTIMEWA YOGYAKARTA",24,78,88,166
https://kawalpemilu.org#42113,"KARANGASEM, PALIYAN, GUNUNGKIDUL, DAERAH ISTIMEWA YOGYAKARTA",25,96,50,146
https://kawalpemilu.org#42113,"KARANGASEM, PALIYAN, GUNUNGKIDUL, DAERAH ISTIMEWA YOGYAKARTA",26,140,79,219
https://kawalpemilu.org#42113,"KARANGASEM, PALIYAN, GUNUNGKIDUL, DAERAH ISTIMEWA YOGYAKARTA",27,152,64,216
https://kawalpemilu.org#42114,"MULUSAN, PALIYAN, GUNUNGKIDUL, DAERAH ISTIMEWA YOGYAKARTA",1,191,51,242
https://kawalpemilu.org#42114,"MULUSAN, PALIYAN, GUNUNGKIDUL, DAERAH ISTIMEWA YOGYAKARTA",2,169,48,217
https://kawalpemilu.org#42114,"MULUSAN, PALIYAN, GUNUNGKIDUL, DAERAH ISTIMEWA YOGYAKARTA",3,180,49,229
https://kawalpemilu.org#42114,"MULUSAN, PALIYAN, GUNUNGKIDUL, DAERAH ISTIMEWA YOGYAKARTA",4,178,12,190
https://kawalpemilu.org#42114,"MULUSAN, PALIYAN, GUNUNGKIDUL, DAERAH ISTIMEWA YOGYAKARTA",5,158,33,191
https://kawalpemilu.org#42114,"MULUSAN, PALIYAN, GUNUNGKIDUL, DAERAH ISTIMEWA YOGYAKARTA",6,120,39,159
https://kawalpemilu.org#42114,"MULUSAN, PALIYAN, GUNUNGKIDUL, DAERAH ISTIMEWA YOGYAKARTA",7,137,37,174
https://kawalpemilu.org#42114,"MULUSAN, PALIYAN, GUNUNGKIDUL, DAERAH ISTIMEWA YOGYAKARTA",8,181,27,208
https://kawalpemilu.org#42114,"MULUSAN, PALIYAN, GUNUNGKIDUL, DAERAH ISTIMEWA YOGYAKARTA",9,172,30,202
https://kawalpemilu.org#42114,"MULUSAN, PALIYAN, GUNUNGKIDUL, DAERAH ISTIMEWA YOGYAKARTA",10,171,38,209
https://kawalpemilu.org#42114,"MULUSAN, PALIYAN, GUNUNGKIDUL, DAERAH ISTIMEWA YOGYAKARTA",11,169,58,227
https://kawalpemilu.org#42114,"MULUSAN, PALIYAN, GUNUNGKIDUL, DAERAH ISTIMEWA YOGYAKARTA",12,134,53,187
https://kawalpemilu.org#42114,"MULUSAN, PALIYAN, GUNUNGKIDUL, DAERAH ISTIMEWA YOGYAKARTA",13,170,32,202
https://kawalpemilu.org#42114,"MULUSAN, PALIYAN, GUNUNGKIDUL, DAERAH ISTIMEWA YOGYAKARTA",14,53,112,165
https://kawalpemilu.org#42114,"MULUSAN, PALIYAN, GUNUNGKIDUL, DAERAH ISTIMEWA YOGYAKARTA",15,63,61,124
https://kawalpemilu.org#42114,"MULUSAN, PALIYAN, GUNUNGKIDUL, DAERAH ISTIMEWA YOGYAKARTA",16,109,116,225
https://kawalpemilu.org#42114,"MULUSAN, PALIYAN, GUNUNGKIDUL, DAERAH ISTIMEWA YOGYAKARTA",17,133,88,221
https://kawalpemilu.org#42115,"GIRING, PALIYAN, GUNUNGKIDUL, DAERAH ISTIMEWA YOGYAKARTA",1,185,34,219
https://kawalpemilu.org#42115,"GIRING, PALIYAN, GUNUNGKIDUL, DAERAH ISTIMEWA YOGYAKARTA",2,166,66,232
https://kawalpemilu.org#42115,"GIRING, PALIYAN, GUNUNGKIDUL, DAERAH ISTIMEWA YOGYAKARTA",3,183,64,247
https://kawalpemilu.org#42115,"GIRING, PALIYAN, GUNUNGKIDUL, DAERAH ISTIMEWA YOGYAKARTA",4,131,70,201
https://kawalpemilu.org#42115,"GIRING, PALIYAN, GUNUNGKIDUL, DAERAH ISTIMEWA YOGYAKARTA",5,115,71,186
https://kawalpemilu.org#42115,"GIRING, PALIYAN, GUNUNGKIDUL, DAERAH ISTIMEWA YOGYAKARTA",6,161,42,203
https://kawalpemilu.org#42115,"GIRING, PALIYAN, GUNUNGKIDUL, DAERAH ISTIMEWA YOGYAKARTA",7,132,60,192
https://kawalpemilu.org#42115,"GIRING, PALIYAN, GUNUNGKIDUL, DAERAH ISTIMEWA YOGYAKARTA",8,202,31,233
https://kawalpemilu.org#42115,"GIRING, PALIYAN, GUNUNGKIDUL, DAERAH ISTIMEWA YOGYAKARTA",9,171,60,231
https://kawalpemilu.org#42117,"GIRIKARTO, PANGGANG, GUNUNGKIDUL, DAERAH ISTIMEWA YOGYAKARTA",1,159,49,208
https://kawalpemilu.org#42117,"GIRIKARTO, PANGGANG, GUNUNGKIDUL, DAERAH ISTIMEWA YOGYAKARTA",2,150,91,241
https://kawalpemilu.org#42117,"GIRIKARTO, PANGGANG, GUNUNGKIDUL, DAERAH ISTIMEWA YOGYAKARTA",3,167,28,195
https://kawalpemilu.org#42117,"GIRIKARTO, PANGGANG, GUNUNGKIDUL, DAERAH ISTIMEWA YOGYAKARTA",4,38,12,50
https://kawalpemilu.org#42117,"GIRIKARTO, PANGGANG, GUNUNGKIDUL, DAERAH ISTIMEWA YOGYAKARTA",5,187,28,215
https://kawalpemilu.org#42117,"GIRIKARTO, PANGGANG, GUNUNGKIDUL, DAERAH ISTIMEWA YOGYAKARTA",6,199,37,236
https://kawalpemilu.org#42117,"GIRIKARTO, PANGGANG, GUNUNGKIDUL, DAERAH ISTIMEWA YOGYAKARTA",7,180,31,211
https://kawalpemilu.org#42117,"GIRIKARTO, PANGGANG, GUNUNGKIDUL, DAERAH ISTIMEWA YOGYAKARTA",8,160,59,219
https://kawalpemilu.org#42117,"GIRIKARTO, PANGGANG, GUNUNGKIDUL, DAERAH ISTIMEWA YOGYAKARTA",9,198,25,223
https://kawalpemilu.org#42117,"GIRIKARTO, PANGGANG, GUNUNGKIDUL, DAERAH ISTIMEWA YOGYAKARTA",10,157,32,189
https://kawalpemilu.org#42117,"GIRIKARTO, PANGGANG, GUNUNGKIDUL, DAERAH ISTIMEWA YOGYAKARTA",11,127,21,148
https://kawalpemilu.org#42117,"GIRIKARTO, PANGGANG, GUNUNGKIDUL, DAERAH ISTIMEWA YOGYAKARTA",12,201,35,236
https://kawalpemilu.org#42117,"GIRIKARTO, PANGGANG, GUNUNGKIDUL, DAERAH ISTIMEWA YOGYAKARTA",13,160,20,180
https://kawalpemilu.org#42117,"GIRIKARTO, PANGGANG, GUNUNGKIDUL, DAERAH ISTIMEWA YOGYAKARTA",14,108,12,120
https://kawalpemilu.org#42118,"GIRISEKAR, PANGGANG, GUNUNGKIDUL, DAERAH ISTIMEWA YOGYAKARTA",1,170,15,185
https://kawalpemilu.org#42118,"GIRISEKAR, PANGGANG, GUNUNGKIDUL, DAERAH ISTIMEWA YOGYAKARTA",2,120,23,143
https://kawalpemilu.org#42118,"GIRISEKAR, PANGGANG, GUNUNGKIDUL, DAERAH ISTIMEWA YOGYAKARTA",3,114,31,145
https://kawalpemilu.org#42118,"GIRISEKAR, PANGGANG, GUNUNGKIDUL, DAERAH ISTIMEWA YOGYAKARTA",4,133,25,158
https://kawalpemilu.org#42118,"GIRISEKAR, PANGGANG, GUNUNGKIDUL, DAERAH ISTIMEWA YOGYAKARTA",5,108,51,159
https://kawalpemilu.org#42118,"GIRISEKAR, PANGGANG, GUNUNGKIDUL, DAERAH ISTIMEWA YOGYAKARTA",6,127,142,269
https://kawalpemilu.org#42118,"GIRISEKAR, PANGGANG, GUNUNGKIDUL, DAERAH ISTIMEWA YOGYAKARTA",7,146,7,153
https://kawalpemilu.org#42118,"GIRISEKAR, PANGGANG, GUNUNGKIDUL, DAERAH ISTIMEWA YOGYAKARTA",8,208,32,240
https://kawalpemilu.org#42118,"GIRISEKAR, PANGGANG, GUNUNGKIDUL, DAERAH ISTIMEWA YOGYAKARTA",9,122,63,185
https://kawalpemilu.org#42118,"GIRISEKAR, PANGGANG, GUNUNGKIDUL, DAERAH ISTIMEWA YOGYAKARTA",10,130,47,177
https://kawalpemilu.org#42118,"GIRISEKAR, PANGGANG, GUNUNGKIDUL, DAERAH ISTIMEWA YOGYAKARTA",11,122,6,128
https://kawalpemilu.org#42118,"GIRISEKAR, PANGGANG, GUNUNGKIDUL, DAERAH ISTIMEWA YOGYAKARTA",12,170,13,183
https://kawalpemilu.org#42118,"GIRISEKAR, PANGGANG, GUNUNGKIDUL, DAERAH ISTIMEWA YOGYAKARTA",13,142,26,168
https://kawalpemilu.org#42118,"GIRISEKAR, PANGGANG, GUNUNGKIDUL, DAERAH ISTIMEWA YOGYAKARTA",14,155,14,169
https://kawalpemilu.org#42118,"GIRISEKAR, PANGGANG, GUNUNGKIDUL, DAERAH ISTIMEWA YOGYAKARTA",15,162,48,210
https://kawalpemilu.org#42118,"GIRISEKAR, PANGGANG, GUNUNGKIDUL, DAERAH ISTIMEWA YOGYAKARTA",16,107,42,149
https://kawalpemilu.org#42118,"GIRISEKAR, PANGGANG, GUNUNGKIDUL, DAERAH ISTIMEWA YOGYAKARTA",17,103,29,132
https://kawalpemilu.org#42118,"GIRISEKAR, PANGGANG, GUNUNGKIDUL, DAERAH ISTIMEWA YOGYAKARTA",18,142,24,166
https://kawalpemilu.org#42118,"GIRISEKAR, PANGGANG, GUNUNGKIDUL, DAERAH ISTIMEWA YOGYAKARTA",19,108,29,137
https://kawalpemilu.org#42118,"GIRISEKAR, PANGGANG, GUNUNGKIDUL, DAERAH ISTIMEWA YOGYAKARTA",20,129,51,180
https://kawalpemilu.org#42118,"GIRISEKAR, PANGGANG, GUNUNGKIDUL, DAERAH ISTIMEWA YOGYAKARTA",21,116,29,145
https://kawalpemilu.org#42118,"GIRISEKAR, PANGGANG, GUNUNGKIDUL, DAERAH ISTIMEWA YOGYAKARTA",22,152,40,192
https://kawalpemilu.org#42118,"GIRISEKAR, PANGGANG, GUNUNGKIDUL, DAERAH ISTIMEWA YOGYAKARTA",23,203,35,238
https://kawalpemilu.org#42118,"GIRISEKAR, PANGGANG, GUNUNGKIDUL, DAERAH ISTIMEWA YOGYAKARTA",24,143,12,155
https://kawalpemilu.org#42118,"GIRISEKAR, PANGGANG, GUNUNGKIDUL, DAERAH ISTIMEWA YOGYAKARTA",25,211,39,250
https://kawalpemilu.org#42118,"GIRISEKAR, PANGGANG, GUNUNGKIDUL, DAERAH ISTIMEWA YOGYAKARTA",26,188,38,226
https://kawalpemilu.org#42118,"GIRISEKAR, PANGGANG, GUNUNGKIDUL, DAERAH ISTIMEWA YOGYAKARTA",27,145,39,184
https://kawalpemilu.org#42118,"GIRISEKAR, PANGGANG, GUNUNGKIDUL, DAERAH ISTIMEWA YOGYAKARTA",28,164,38,202
https://kawalpemilu.org#42119,"GIRIMULYO, PANGGANG, GUNUNGKIDUL, DAERAH ISTIMEWA YOGYAKARTA",1,188,26,214
https://kawalpemilu.org#42119,"GIRIMULYO, PANGGANG, GUNUNGKIDUL, DAERAH ISTIMEWA YOGYAKARTA",2,204,31,235
https://kawalpemilu.org#42119,"GIRIMULYO, PANGGANG, GUNUNGKIDUL, DAERAH ISTIMEWA YOGYAKARTA",3,210,35,245
https://kawalpemilu.org#42119,"GIRIMULYO, PANGGANG, GUNUNGKIDUL, DAERAH ISTIMEWA YOGYAKARTA",4,150,29,179
https://kawalpemilu.org#42119,"GIRIMULYO, PANGGANG, GUNUNGKIDUL, DAERAH ISTIMEWA YOGYAKARTA",5,132,46,178
https://kawalpemilu.org#42119,"GIRIMULYO, PANGGANG, GUNUNGKIDUL, DAERAH ISTIMEWA YOGYAKARTA",6,194,38,232
https://kawalpemilu.org#42119,"GIRIMULYO, PANGGANG, GUNUNGKIDUL, DAERAH ISTIMEWA YOGYAKARTA",7,196,39,235
https://kawalpemilu.org#42119,"GIRIMULYO, PANGGANG, GUNUNGKIDUL, DAERAH ISTIMEWA YOGYAKARTA",8,198,23,221
https://kawalpemilu.org#42119,"GIRIMULYO, PANGGANG, GUNUNGKIDUL, DAERAH ISTIMEWA YOGYAKARTA",9,154,52,206
https://kawalpemilu.org#42119,"GIRIMULYO, PANGGANG, GUNUNGKIDUL, DAERAH ISTIMEWA YOGYAKARTA",10,132,26,158
https://kawalpemilu.org#42119,"GIRIMULYO, PANGGANG, GUNUNGKIDUL, DAERAH ISTIMEWA YOGYAKARTA",11,202,50,252
https://kawalpemilu.org#42119,"GIRIMULYO, PANGGANG, GUNUNGKIDUL, DAERAH ISTIMEWA YOGYAKARTA",12,199,21,220
https://kawalpemilu.org#42119,"GIRIMULYO, PANGGANG, GUNUNGKIDUL, DAERAH ISTIMEWA YOGYAKARTA",13,112,138,250
https://kawalpemilu.org#42119,"GIRIMULYO, PANGGANG, GUNUNGKIDUL, DAERAH ISTIMEWA YOGYAKARTA",14,176,75,251
https://kawalpemilu.org#42119,"GIRIMULYO, PANGGANG, GUNUNGKIDUL, DAERAH ISTIMEWA YOGYAKARTA",15,180,67,247
https://kawalpemilu.org#42119,"GIRIMULYO, PANGGANG, GUNUNGKIDUL, DAERAH ISTIMEWA YOGYAKARTA",16,118,51,169
https://kawalpemilu.org#42119,"GIRIMULYO, PANGGANG, GUNUNGKIDUL, DAERAH ISTIMEWA YOGYAKARTA",17,138,31,169
https://kawalpemilu.org#42119,"GIRIMULYO, PANGGANG, GUNUNGKIDUL, DAERAH ISTIMEWA YOGYAKARTA",18,170,12,182
https://kawalpemilu.org#42120,"GIRIWUNGU, PANGGANG, GUNUNGKIDUL, DAERAH ISTIMEWA YOGYAKARTA",1,152,56,208
https://kawalpemilu.org#42120,"GIRIWUNGU, PANGGANG, GUNUNGKIDUL, DAERAH ISTIMEWA YOGYAKARTA",2,135,50,185
https://kawalpemilu.org#42120,"GIRIWUNGU, PANGGANG, GUNUNGKIDUL, DAERAH ISTIMEWA YOGYAKARTA",3,126,19,145
https://kawalpemilu.org#42120,"GIRIWUNGU, PANGGANG, GUNUNGKIDUL, DAERAH ISTIMEWA YOGYAKARTA",4,147,85,232
https://kawalpemilu.org#42120,"GIRIWUNGU, PANGGANG, GUNUNGKIDUL, DAERAH ISTIMEWA YOGYAKARTA",5,220,42,262
https://kawalpemilu.org#42120,"GIRIWUNGU, PANGGANG, GUNUNGKIDUL, DAERAH ISTIMEWA YOGYAKARTA",6,168,33,201
https://kawalpemilu.org#42120,"GIRIWUNGU, PANGGANG, GUNUNGKIDUL, DAERAH ISTIMEWA YOGYAKARTA",7,128,44,172
https://kawalpemilu.org#42120,"GIRIWUNGU, PANGGANG, GUNUNGKIDUL, DAERAH ISTIMEWA YOGYAKARTA",8,121,41,162
https://kawalpemilu.org#42120,"GIRIWUNGU, PANGGANG, GUNUNGKIDUL, DAERAH ISTIMEWA YOGYAKARTA",9,137,18,155
https://kawalpemilu.org#42121,"GIRIHARJO, PANGGANG, GUNUNGKIDUL, DAERAH ISTIMEWA YOGYAKARTA",1,173,27,200
https://kawalpemilu.org#42121,"GIRIHARJO, PANGGANG, GUNUNGKIDUL, DAERAH ISTIMEWA YOGYAKARTA",2,176,30,206
https://kawalpemilu.org#42121,"GIRIHARJO, PANGGANG, GUNUNGKIDUL, DAERAH ISTIMEWA YOGYAKARTA",4,145,36,181
https://kawalpemilu.org#42121,"GIRIHARJO, PANGGANG, GUNUNGKIDUL, DAERAH ISTIMEWA YOGYAKARTA",5,135,50,185
https://kawalpemilu.org#42121,"GIRIHARJO, PANGGANG, GUNUNGKIDUL, DAERAH ISTIMEWA YOGYAKARTA",6,179,39,218
https://kawalpemilu.org#42121,"GIRIHARJO, PANGGANG, GUNUNGKIDUL, DAERAH ISTIMEWA YOGYAKARTA",7,131,59,190
https://kawalpemilu.org#42121,"GIRIHARJO, PANGGANG, GUNUNGKIDUL, DAERAH ISTIMEWA YOGYAKARTA",8,117,37,154
https://kawalpemilu.org#42121,"GIRIHARJO, PANGGANG, GUNUNGKIDUL, DAERAH ISTIMEWA YOGYAKARTA",9,134,95,229
https://kawalpemilu.org#42121,"GIRIHARJO, PANGGANG, GUNUNGKIDUL, DAERAH ISTIMEWA YOGYAKARTA",10,132,68,200
https://kawalpemilu.org#42121,"GIRIHARJO, PANGGANG, GUNUNGKIDUL, DAERAH ISTIMEWA YOGYAKARTA",11,134,97,231
https://kawalpemilu.org#42121,"GIRIHARJO, PANGGANG, GUNUNGKIDUL, DAERAH ISTIMEWA YOGYAKARTA",12,193,36,229
https://kawalpemilu.org#42121,"GIRIHARJO, PANGGANG, GUNUNGKIDUL, DAERAH ISTIMEWA YOGYAKARTA",13,174,60,234
https://kawalpemilu.org#42122,"GIRISUKO, PANGGANG, GUNUNGKIDUL, DAERAH ISTIMEWA YOGYAKARTA",1,174,42,216
https://kawalpemilu.org#42122,"GIRISUKO, PANGGANG, GUNUNGKIDUL, DAERAH ISTIMEWA YOGYAKARTA",2,115,46,161
https://kawalpemilu.org#42122,"GIRISUKO, PANGGANG, GUNUNGKIDUL, DAERAH ISTIMEWA YOGYAKARTA",3,146,51,197
https://kawalpemilu.org#42122,"GIRISUKO, PANGGANG, GUNUNGKIDUL, DAERAH ISTIMEWA YOGYAKARTA",4,122,78,200
https://kawalpemilu.org#42122,"GIRISUKO, PANGGANG, GUNUNGKIDUL, DAERAH ISTIMEWA YOGYAKARTA",5,161,50,211
https://kawalpemilu.org#42122,"GIRISUKO, PANGGANG, GUNUNGKIDUL, DAERAH ISTIMEWA YOGYAKARTA",6,216,25,241
https://kawalpemilu.org#42122,"GIRISUKO, PANGGANG, GUNUNGKIDUL, DAERAH ISTIMEWA YOGYAKARTA",7,207,18,225
https://kawalpemilu.org#42122,"GIRISUKO, PANGGANG, GUNUNGKIDUL, DAERAH ISTIMEWA YOGYAKARTA",8,192,30,222
https://kawalpemilu.org#42122,"GIRISUKO, PANGGANG, GUNUNGKIDUL, DAERAH ISTIMEWA YOGYAKARTA",9,203,37,240
https://kawalpemilu.org#42122,"GIRISUKO, PANGGANG, GUNUNGKIDUL, DAERAH ISTIMEWA YOGYAKARTA",10,178,24,202
https://kawalpemilu.org#42122,"GIRISUKO, PANGGANG, GUNUNGKIDUL, DAERAH ISTIMEWA YOGYAKARTA",11,183,27,210
https://kawalpemilu.org#42122,"GIRISUKO, PANGGANG, GUNUNGKIDUL, DAERAH ISTIMEWA YOGYAKARTA",12,165,30,195
https://kawalpemilu.org#42122,"GIRISUKO, PANGGANG, GUNUNGKIDUL, DAERAH ISTIMEWA YOGYAKARTA",13,145,31,176
https://kawalpemilu.org#42122,"GIRISUKO, PANGGANG, GUNUNGKIDUL, DAERAH ISTIMEWA YOGYAKARTA",14,172,39,211
https://kawalpemilu.org#42122,"GIRISUKO, PANGGANG, GUNUNGKIDUL, DAERAH ISTIMEWA YOGYAKARTA",15,162,39,201
https://kawalpemilu.org#42122,"GIRISUKO, PANGGANG, GUNUNGKIDUL, DAERAH ISTIMEWA YOGYAKARTA",16,102,31,133
https://kawalpemilu.org#42122,"GIRISUKO, PANGGANG, GUNUNGKIDUL, DAERAH ISTIMEWA YOGYAKARTA",17,113,36,149
https://kawalpemilu.org#42122,"GIRISUKO, PANGGANG, GUNUNGKIDUL, DAERAH ISTIMEWA YOGYAKARTA",18,129,59,188
https://kawalpemilu.org#42124,"GIRIPANGGUNG, TEPUS, GUNUNGKIDUL, DAERAH ISTIMEWA YOGYAKARTA",1,127,39,166
https://kawalpemilu.org#42124,"GIRIPANGGUNG, TEPUS, GUNUNGKIDUL, DAERAH ISTIMEWA YOGYAKARTA",2,101,13,114
https://kawalpemilu.org#42124,"GIRIPANGGUNG, TEPUS, GUNUNGKIDUL, DAERAH ISTIMEWA YOGYAKARTA",3,128,46,174
https://kawalpemilu.org#42124,"GIRIPANGGUNG, TEPUS, GUNUNGKIDUL, DAERAH ISTIMEWA YOGYAKARTA",4,112,33,145
https://kawalpemilu.org#42124,"GIRIPANGGUNG, TEPUS, GUNUNGKIDUL, DAERAH ISTIMEWA YOGYAKARTA",5,128,33,161
https://kawalpemilu.org#42124,"GIRIPANGGUNG, TEPUS, GUNUNGKIDUL, DAERAH ISTIMEWA YOGYAKARTA",6,169,29,198
https://kawalpemilu.org#42124,"GIRIPANGGUNG, TEPUS, GUNUNGKIDUL, DAERAH ISTIMEWA YOGYAKARTA",7,114,18,132
https://kawalpemilu.org#42124,"GIRIPANGGUNG, TEPUS, GUNUNGKIDUL, DAERAH ISTIMEWA YOGYAKARTA",8,124,38,162
https://kawalpemilu.org#42124,"GIRIPANGGUNG, TEPUS, GUNUNGKIDUL, DAERAH ISTIMEWA YOGYAKARTA",9,107,57,164
https://kawalpemilu.org#42124,"GIRIPANGGUNG, TEPUS, GUNUNGKIDUL, DAERAH ISTIMEWA YOGYAKARTA",10,133,41,174
https://kawalpemilu.org#42124,"GIRIPANGGUNG, TEPUS, GUNUNGKIDUL, DAERAH ISTIMEWA YOGYAKARTA",11,91,28,119
https://kawalpemilu.org#42124,"GIRIPANGGUNG, TEPUS, GUNUNGKIDUL, DAERAH ISTIMEWA YOGYAKARTA",12,137,28,165
https://kawalpemilu.org#42124,"GIRIPANGGUNG, TEPUS, GUNUNGKIDUL, DAERAH ISTIMEWA YOGYAKARTA",13,174,41,215
https://kawalpemilu.org#42124,"GIRIPANGGUNG, TEPUS, GUNUNGKIDUL, DAERAH ISTIMEWA YOGYAKARTA",14,156,29,185
https://kawalpemilu.org#42124,"GIRIPANGGUNG, TEPUS, GUNUNGKIDUL, DAERAH ISTIMEWA YOGYAKARTA",15,118,9,127
https://kawalpemilu.org#42124,"GIRIPANGGUNG, TEPUS, GUNUNGKIDUL, DAERAH ISTIMEWA YOGYAKARTA",16,127,30,157
https://kawalpemilu.org#42124,"GIRIPANGGUNG, TEPUS, GUNUNGKIDUL, DAERAH ISTIMEWA YOGYAKARTA",17,109,19,128
https://kawalpemilu.org#42124,"GIRIPANGGUNG, TEPUS, GUNUNGKIDUL, DAERAH ISTIMEWA YOGYAKARTA",18,115,47,162
https://kawalpemilu.org#42124,"GIRIPANGGUNG, TEPUS, GUNUNGKIDUL, DAERAH ISTIMEWA YOGYAKARTA",19,148,24,172
https://kawalpemilu.org#42124,"GIRIPANGGUNG, TEPUS, GUNUNGKIDUL, DAERAH ISTIMEWA YOGYAKARTA",20,112,28,140
https://kawalpemilu.org#42124,"GIRIPANGGUNG, TEPUS, GUNUNGKIDUL, DAERAH ISTIMEWA YOGYAKARTA",21,116,60,176
https://kawalpemilu.org#42124,"GIRIPANGGUNG, TEPUS, GUNUNGKIDUL, DAERAH ISTIMEWA YOGYAKARTA",22,68,51,119
https://kawalpemilu.org#42124,"GIRIPANGGUNG, TEPUS, GUNUNGKIDUL, DAERAH ISTIMEWA YOGYAKARTA",23,137,25,162
https://kawalpemilu.org#42124,"GIRIPANGGUNG, TEPUS, GUNUNGKIDUL, DAERAH ISTIMEWA YOGYAKARTA",24,150,43,193
https://kawalpemilu.org#42124,"GIRIPANGGUNG, TEPUS, GUNUNGKIDUL, DAERAH ISTIMEWA YOGYAKARTA",25,149,60,209
https://kawalpemilu.org#42124,"GIRIPANGGUNG, TEPUS, GUNUNGKIDUL, DAERAH ISTIMEWA YOGYAKARTA",26,114,23,137
https://kawalpemilu.org#42124,"GIRIPANGGUNG, TEPUS, GUNUNGKIDUL, DAERAH ISTIMEWA YOGYAKARTA",27,98,40,138
https://kawalpemilu.org#42125,"SUMBERWUNGU, TEPUS, GUNUNGKIDUL, DAERAH ISTIMEWA YOGYAKARTA",1,143,85,228
https://kawalpemilu.org#42125,"SUMBERWUNGU, TEPUS, GUNUNGKIDUL, DAERAH ISTIMEWA YOGYAKARTA",2,125,68,193
https://kawalpemilu.org#42125,"SUMBERWUNGU, TEPUS, GUNUNGKIDUL, DAERAH ISTIMEWA YOGYAKARTA",3,145,51,196
https://kawalpemilu.org#42125,"SUMBERWUNGU, TEPUS, GUNUNGKIDUL, DAERAH ISTIMEWA YOGYAKARTA",4,149,31,180
https://kawalpemilu.org#42125,"SUMBERWUNGU, TEPUS, GUNUNGKIDUL, DAERAH ISTIMEWA YOGYAKARTA",5,103,67,170
https://kawalpemilu.org#42125,"SUMBERWUNGU, TEPUS, GUNUNGKIDUL, DAERAH ISTIMEWA YOGYAKARTA",6,74,55,129
https://kawalpemilu.org#42125,"SUMBERWUNGU, TEPUS, GUNUNGKIDUL, DAERAH ISTIMEWA YOGYAKARTA",7,104,61,165
https://kawalpemilu.org#42125,"SUMBERWUNGU, TEPUS, GUNUNGKIDUL, DAERAH ISTIMEWA YOGYAKARTA",8,113,54,167
https://kawalpemilu.org#42125,"SUMBERWUNGU, TEPUS, GUNUNGKIDUL, DAERAH ISTIMEWA YOGYAKARTA",9,220,30,250
https://kawalpemilu.org#42125,"SUMBERWUNGU, TEPUS, GUNUNGKIDUL, DAERAH ISTIMEWA YOGYAKARTA",10,96,46,142
https://kawalpemilu.org#42125,"SUMBERWUNGU, TEPUS, GUNUNGKIDUL, DAERAH ISTIMEWA YOGYAKARTA",11,82,55,137
https://kawalpemilu.org#42125,"SUMBERWUNGU, TEPUS, GUNUNGKIDUL, DAERAH ISTIMEWA YOGYAKARTA",12,110,99,209
https://kawalpemilu.org#42125,"SUMBERWUNGU, TEPUS, GUNUNGKIDUL, DAERAH ISTIMEWA YOGYAKARTA",13,48,108,156
https://kawalpemilu.org#42125,"SUMBERWUNGU, TEPUS, GUNUNGKIDUL, DAERAH ISTIMEWA YOGYAKARTA",14,138,78,216
https://kawalpemilu.org#42125,"SUMBERWUNGU, TEPUS, GUNUNGKIDUL, DAERAH ISTIMEWA YOGYAKARTA",15,95,37,132
https://kawalpemilu.org#42125,"SUMBERWUNGU, TEPUS, GUNUNGKIDUL, DAERAH ISTIMEWA YOGYAKARTA",16,159,58,217
https://kawalpemilu.org#42125,"SUMBERWUNGU, TEPUS, GUNUNGKIDUL, DAERAH ISTIMEWA YOGYAKARTA",17,175,40,215
https://kawalpemilu.org#42125,"SUMBERWUNGU, TEPUS, GUNUNGKIDUL, DAERAH ISTIMEWA YOGYAKARTA",18,163,71,234
https://kawalpemilu.org#42125,"SUMBERWUNGU, TEPUS, GUNUNGKIDUL, DAERAH ISTIMEWA YOGYAKARTA",19,162,71,233
https://kawalpemilu.org#42125,"SUMBERWUNGU, TEPUS, GUNUNGKIDUL, DAERAH ISTIMEWA YOGYAKARTA",20,194,21,215
https://kawalpemilu.org#42125,"SUMBERWUNGU, TEPUS, GUNUNGKIDUL, DAERAH ISTIMEWA YOGYAKARTA",21,165,32,197
https://kawalpemilu.org#42125,"SUMBERWUNGU, TEPUS, GUNUNGKIDUL, DAERAH ISTIMEWA YOGYAKARTA",22,167,36,203
https://kawalpemilu.org#42125,"SUMBERWUNGU, TEPUS, GUNUNGKIDUL, DAERAH ISTIMEWA YOGYAKARTA",23,138,33,171
https://kawalpemilu.org#42126,"SIDOHARJO, TEPUS, GUNUNGKIDUL, DAERAH ISTIMEWA YOGYAKARTA",1,149,37,186
https://kawalpemilu.org#42126,"SIDOHARJO, TEPUS, GUNUNGKIDUL, DAERAH ISTIMEWA YOGYAKARTA",2,125,56,181
https://kawalpemilu.org#42126,"SIDOHARJO, TEPUS, GUNUNGKIDUL, DAERAH ISTIMEWA YOGYAKARTA",3,142,45,187
https://kawalpemilu.org#42126,"SIDOHARJO, TEPUS, GUNUNGKIDUL, DAERAH ISTIMEWA YOGYAKARTA",4,152,33,185
https://kawalpemilu.org#42126,"SIDOHARJO, TEPUS, GUNUNGKIDUL, DAERAH ISTIMEWA YOGYAKARTA",5,139,64,203
https://kawalpemilu.org#42126,"SIDOHARJO, TEPUS, GUNUNGKIDUL, DAERAH ISTIMEWA YOGYAKARTA",6,95,71,166
https://kawalpemilu.org#42126,"SIDOHARJO, TEPUS, GUNUNGKIDUL, DAERAH ISTIMEWA YOGYAKARTA",7,147,48,195
https://kawalpemilu.org#42126,"SIDOHARJO, TEPUS, GUNUNGKIDUL, DAERAH ISTIMEWA YOGYAKARTA",8,161,62,223
https://kawalpemilu.org#42126,"SIDOHARJO, TEPUS, GUNUNGKIDUL, DAERAH ISTIMEWA YOGYAKARTA",9,77,52,129
https://kawalpemilu.org#42126,"SIDOHARJO, TEPUS, GUNUNGKIDUL, DAERAH ISTIMEWA YOGYAKARTA",10,98,66,164
https://kawalpemilu.org#42126,"SIDOHARJO, TEPUS, GUNUNGKIDUL, DAERAH ISTIMEWA YOGYAKARTA",11,169,48,217
https://kawalpemilu.org#42126,"SIDOHARJO, TEPUS, GUNUNGKIDUL, DAERAH ISTIMEWA YOGYAKARTA",12,172,64,236
https://kawalpemilu.org#42126,"SIDOHARJO, TEPUS, GUNUNGKIDUL, DAERAH ISTIMEWA YOGYAKARTA",13,100,139,239
https://kawalpemilu.org#42126,"SIDOHARJO, TEPUS, GUNUNGKIDUL, DAERAH ISTIMEWA YOGYAKARTA",14,116,37,153
https://kawalpemilu.org#42126,"SIDOHARJO, TEPUS, GUNUNGKIDUL, DAERAH ISTIMEWA YOGYAKARTA",15,99,38,137
https://kawalpemilu.org#42126,"SIDOHARJO, TEPUS, GUNUNGKIDUL, DAERAH ISTIMEWA YOGYAKARTA",16,128,65,193
https://kawalpemilu.org#42126,"SIDOHARJO, TEPUS, GUNUNGKIDUL, DAERAH ISTIMEWA YOGYAKARTA",17,132,66,198
https://kawalpemilu.org#42126,"SIDOHARJO, TEPUS, GUNUNGKIDUL, DAERAH ISTIMEWA YOGYAKARTA",18,120,34,154
https://kawalpemilu.org#42126,"SIDOHARJO, TEPUS, GUNUNGKIDUL, DAERAH ISTIMEWA YOGYAKARTA",19,148,51,199
https://kawalpemilu.org#42126,"SIDOHARJO, TEPUS, GUNUNGKIDUL, DAERAH ISTIMEWA YOGYAKARTA",20,164,58,222
https://kawalpemilu.org#42126,"SIDOHARJO, TEPUS, GUNUNGKIDUL, DAERAH ISTIMEWA YOGYAKARTA",21,181,45,226
https://kawalpemilu.org#42126,"SIDOHARJO, TEPUS, GUNUNGKIDUL, DAERAH ISTIMEWA YOGYAKARTA",22,203,34,237
https://kawalpemilu.org#42126,"SIDOHARJO, TEPUS, GUNUNGKIDUL, DAERAH ISTIMEWA YOGYAKARTA",23,162,25,187
https://kawalpemilu.org#42126,"SIDOHARJO, TEPUS, GUNUNGKIDUL, DAERAH ISTIMEWA YOGYAKARTA",24,161,41,202
https://kawalpemilu.org#42126,"SIDOHARJO, TEPUS, GUNUNGKIDUL, DAERAH ISTIMEWA YOGYAKARTA",25,133,14,147
https://kawalpemilu.org#42127,"TEPUS, TEPUS, GUNUNGKIDUL, DAERAH ISTIMEWA YOGYAKARTA",1,132,17,149
https://kawalpemilu.org#42127,"TEPUS, TEPUS, GUNUNGKIDUL, DAERAH ISTIMEWA YOGYAKARTA",2,166,64,230
https://kawalpemilu.org#42127,"TEPUS, TEPUS, GUNUNGKIDUL, DAERAH ISTIMEWA YOGYAKARTA",3,140,35,175
https://kawalpemilu.org#42127,"TEPUS, TEPUS, GUNUNGKIDUL, DAERAH ISTIMEWA YOGYAKARTA",4,182,28,210
https://kawalpemilu.org#42127,"TEPUS, TEPUS, GUNUNGKIDUL, DAERAH ISTIMEWA YOGYAKARTA",5,149,36,185
https://kawalpemilu.org#42127,"TEPUS, TEPUS, GUNUNGKIDUL, DAERAH ISTIMEWA YOGYAKARTA",6,142,68,210
https://kawalpemilu.org#42127,"TEPUS, TEPUS, GUNUNGKIDUL, DAERAH ISTIMEWA YOGYAKARTA",7,157,54,211
https://kawalpemilu.org#42127,"TEPUS, TEPUS, GUNUNGKIDUL, DAERAH ISTIMEWA YOGYAKARTA",8,68,33,101
https://kawalpemilu.org#42127,"TEPUS, TEPUS, GUNUNGKIDUL, DAERAH ISTIMEWA YOGYAKARTA",9,122,26,148
https://kawalpemilu.org#42127,"TEPUS, TEPUS, GUNUNGKIDUL, DAERAH ISTIMEWA YOGYAKARTA",10,119,40,159
https://kawalpemilu.org#42127,"TEPUS, TEPUS, GUNUNGKIDUL, DAERAH ISTIMEWA YOGYAKARTA",11,85,73,158
https://kawalpemilu.org#42127,"TEPUS, TEPUS, GUNUNGKIDUL, DAERAH ISTIMEWA YOGYAKARTA",12,124,42,166
https://kawalpemilu.org#42127,"TEPUS, TEPUS, GUNUNGKIDUL, DAERAH ISTIMEWA YOGYAKARTA",13,112,46,158
https://kawalpemilu.org#42127,"TEPUS, TEPUS, GUNUNGKIDUL, DAERAH ISTIMEWA YOGYAKARTA",14,65,75,140
https://kawalpemilu.org#42127,"TEPUS, TEPUS, GUNUNGKIDUL, DAERAH ISTIMEWA YOGYAKARTA",15,187,74,261
https://kawalpemilu.org#42127,"TEPUS, TEPUS, GUNUNGKIDUL, DAERAH ISTIMEWA YOGYAKARTA",16,136,65,201
https://kawalpemilu.org#42127,"TEPUS, TEPUS, GUNUNGKIDUL, DAERAH ISTIMEWA YOGYAKARTA",17,66,25,91
https://kawalpemilu.org#42127,"TEPUS, TEPUS, GUNUNGKIDUL, DAERAH ISTIMEWA YOGYAKARTA",18,129,56,185
https://kawalpemilu.org#42127,"TEPUS, TEPUS, GUNUNGKIDUL, DAERAH ISTIMEWA YOGYAKARTA",19,83,55,138
https://kawalpemilu.org#42127,"TEPUS, TEPUS, GUNUNGKIDUL, DAERAH ISTIMEWA YOGYAKARTA",20,106,56,162
https://kawalpemilu.org#42127,"TEPUS, TEPUS, GUNUNGKIDUL, DAERAH ISTIMEWA YOGYAKARTA",21,143,54,197
https://kawalpemilu.org#42127,"TEPUS, TEPUS, GUNUNGKIDUL, DAERAH ISTIMEWA YOGYAKARTA",22,129,70,199
https://kawalpemilu.org#42127,"TEPUS, TEPUS, GUNUNGKIDUL, DAERAH ISTIMEWA YOGYAKARTA",23,146,40,186
https://kawalpemilu.org#42127,"TEPUS, TEPUS, GUNUNGKIDUL, DAERAH ISTIMEWA YOGYAKARTA",24,143,88,231
https://kawalpemilu.org#42127,"TEPUS, TEPUS, GUNUNGKIDUL, DAERAH ISTIMEWA YOGYAKARTA",25,53,30,83
https://kawalpemilu.org#42127,"TEPUS, TEPUS, GUNUNGKIDUL, DAERAH ISTIMEWA YOGYAKARTA",26,210,25,235
https://kawalpemilu.org#42127,"TEPUS, TEPUS, GUNUNGKIDUL, DAERAH ISTIMEWA YOGYAKARTA",27,165,38,203
https://kawalpemilu.org#42127,"TEPUS, TEPUS, GUNUNGKIDUL, DAERAH ISTIMEWA YOGYAKARTA",28,137,61,198
https://kawalpemilu.org#42127,"TEPUS, TEPUS, GUNUNGKIDUL, DAERAH ISTIMEWA YOGYAKARTA",29,89,35,124
https://kawalpemilu.org#42127,"TEPUS, TEPUS, GUNUNGKIDUL, DAERAH ISTIMEWA YOGYAKARTA",30,119,55,174
https://kawalpemilu.org#42127,"TEPUS, TEPUS, GUNUNGKIDUL, DAERAH ISTIMEWA YOGYAKARTA",31,99,34,133
https://kawalpemilu.org#42127,"TEPUS, TEPUS, GUNUNGKIDUL, DAERAH ISTIMEWA YOGYAKARTA",32,104,60,164
https://kawalpemilu.org#42127,"TEPUS, TEPUS, GUNUNGKIDUL, DAERAH ISTIMEWA YOGYAKARTA",33,52,53,105
https://kawalpemilu.org#42127,"TEPUS, TEPUS, GUNUNGKIDUL, DAERAH ISTIMEWA YOGYAKARTA",34,154,37,191
https://kawalpemilu.org#42127,"TEPUS, TEPUS, GUNUNGKIDUL, DAERAH ISTIMEWA YOGYAKARTA",35,103,14,117
https://kawalpemilu.org#42127,"TEPUS, TEPUS, GUNUNGKIDUL, DAERAH ISTIMEWA YOGYAKARTA",36,140,26,166
https://kawalpemilu.org#42128,"PURWODADI, TEPUS, GUNUNGKIDUL, DAERAH ISTIMEWA YOGYAKARTA",1,114,53,167
https://kawalpemilu.org#42128,"PURWODADI, TEPUS, GUNUNGKIDUL, DAERAH ISTIMEWA YOGYAKARTA",2,192,43,235
https://kawalpemilu.org#42128,"PURWODADI, TEPUS, GUNUNGKIDUL, DAERAH ISTIMEWA YOGYAKARTA",3,131,54,185
https://kawalpemilu.org#42128,"PURWODADI, TEPUS, GUNUNGKIDUL, DAERAH ISTIMEWA YOGYAKARTA",4,138,66,204
https://kawalpemilu.org#42128,"PURWODADI, TEPUS, GUNUNGKIDUL, DAERAH ISTIMEWA YOGYAKARTA",5,116,78,194
https://kawalpemilu.org#42128,"PURWODADI, TEPUS, GUNUNGKIDUL, DAERAH ISTIMEWA YOGYAKARTA",6,160,71,231
https://kawalpemilu.org#42128,"PURWODADI, TEPUS, GUNUNGKIDUL, DAERAH ISTIMEWA YOGYAKARTA",7,103,28,131
https://kawalpemilu.org#42128,"PURWODADI, TEPUS, GUNUNGKIDUL, DAERAH ISTIMEWA YOGYAKARTA",8,109,53,162
https://kawalpemilu.org#42128,"PURWODADI, TEPUS, GUNUNGKIDUL, DAERAH ISTIMEWA YOGYAKARTA",9,128,41,169
https://kawalpemilu.org#42128,"PURWODADI, TEPUS, GUNUNGKIDUL, DAERAH ISTIMEWA YOGYAKARTA",10,150,45,195
https://kawalpemilu.org#42128,"PURWODADI, TEPUS, GUNUNGKIDUL, DAERAH ISTIMEWA YOGYAKARTA",11,129,47,176
https://kawalpemilu.org#42128,"PURWODADI, TEPUS, GUNUNGKIDUL, DAERAH ISTIMEWA YOGYAKARTA",12,112,31,143
https://kawalpemilu.org#42128,"PURWODADI, TEPUS, GUNUNGKIDUL, DAERAH ISTIMEWA YOGYAKARTA",13,119,60,179
https://kawalpemilu.org#42128,"PURWODADI, TEPUS, GUNUNGKIDUL, DAERAH ISTIMEWA YOGYAKARTA",14,118,103,221
https://kawalpemilu.org#42128,"PURWODADI, TEPUS, GUNUNGKIDUL, DAERAH ISTIMEWA YOGYAKARTA",15,164,70,234
https://kawalpemilu.org#42128,"PURWODADI, TEPUS, GUNUNGKIDUL, DAERAH ISTIMEWA YOGYAKARTA",16,108,70,178
https://kawalpemilu.org#42128,"PURWODADI, TEPUS, GUNUNGKIDUL, DAERAH ISTIMEWA YOGYAKARTA",17,96,49,145
https://kawalpemilu.org#42128,"PURWODADI, TEPUS, GUNUNGKIDUL, DAERAH ISTIMEWA YOGYAKARTA",18,128,99,227
https://kawalpemilu.org#42128,"PURWODADI, TEPUS, GUNUNGKIDUL, DAERAH ISTIMEWA YOGYAKARTA",19,101,37,138
https://kawalpemilu.org#42128,"PURWODADI, TEPUS, GUNUNGKIDUL, DAERAH ISTIMEWA YOGYAKARTA",20,112,32,144
https://kawalpemilu.org#42128,"PURWODADI, TEPUS, GUNUNGKIDUL, DAERAH ISTIMEWA YOGYAKARTA",21,144,80,224
https://kawalpemilu.org#42128,"PURWODADI, TEPUS, GUNUNGKIDUL, DAERAH ISTIMEWA YOGYAKARTA",22,166,45,211
https://kawalpemilu.org#42128,"PURWODADI, TEPUS, GUNUNGKIDUL, DAERAH ISTIMEWA YOGYAKARTA",23,115,46,161
https://kawalpemilu.org#42128,"PURWODADI, TEPUS, GUNUNGKIDUL, DAERAH ISTIMEWA YOGYAKARTA",24,189,52,241
https://kawalpemilu.org#42128,"PURWODADI, TEPUS, GUNUNGKIDUL, DAERAH ISTIMEWA YOGYAKARTA",25,82,65,147
https://kawalpemilu.org#42128,"PURWODADI, TEPUS, GUNUNGKIDUL, DAERAH ISTIMEWA YOGYAKARTA",26,141,67,208
https://kawalpemilu.org#42128,"PURWODADI, TEPUS, GUNUNGKIDUL, DAERAH ISTIMEWA YOGYAKARTA",27,88,53,182
https://kawalpemilu.org#42128,"PURWODADI, TEPUS, GUNUNGKIDUL, DAERAH ISTIMEWA YOGYAKARTA",28,87,68,155
https://kawalpemilu.org#42130,"NGEPOSARI, SEMANU, GUNUNGKIDUL, DAERAH ISTIMEWA YOGYAKARTA",1,72,5,77
https://kawalpemilu.org#42130,"NGEPOSARI, SEMANU, GUNUNGKIDUL, DAERAH ISTIMEWA YOGYAKARTA",2,197,21,218
https://kawalpemilu.org#42130,"NGEPOSARI, SEMANU, GUNUNGKIDUL, DAERAH ISTIMEWA YOGYAKARTA",3,161,17,178
https://kawalpemilu.org#42130,"NGEPOSARI, SEMANU, GUNUNGKIDUL, DAERAH ISTIMEWA YOGYAKARTA",4,183,20,203
https://kawalpemilu.org#42130,"NGEPOSARI, SEMANU, GUNUNGKIDUL, DAERAH ISTIMEWA YOGYAKARTA",5,146,30,176
https://kawalpemilu.org#42130,"NGEPOSARI, SEMANU, GUNUNGKIDUL, DAERAH ISTIMEWA YOGYAKARTA",6,161,27,188
https://kawalpemilu.org#42130,"NGEPOSARI, SEMANU, GUNUNGKIDUL, DAERAH ISTIMEWA YOGYAKARTA",7,183,34,217
https://kawalpemilu.org#42130,"NGEPOSARI, SEMANU, GUNUNGKIDUL, DAERAH ISTIMEWA YOGYAKARTA",8,120,42,162
https://kawalpemilu.org#42130,"NGEPOSARI, SEMANU, GUNUNGKIDUL, DAERAH ISTIMEWA YOGYAKARTA",9,89,21,110
https://kawalpemilu.org#42130,"NGEPOSARI, SEMANU, GUNUNGKIDUL, DAERAH ISTIMEWA YOGYAKARTA",10,125,15,140
https://kawalpemilu.org#42130,"NGEPOSARI, SEMANU, GUNUNGKIDUL, DAERAH ISTIMEWA YOGYAKARTA",11,149,46,195
https://kawalpemilu.org#42130,"NGEPOSARI, SEMANU, GUNUNGKIDUL, DAERAH ISTIMEWA YOGYAKARTA",12,187,32,219
https://kawalpemilu.org#42130,"NGEPOSARI, SEMANU, GUNUNGKIDUL, DAERAH ISTIMEWA YOGYAKARTA",13,78,55,133
https://kawalpemilu.org#42130,"NGEPOSARI, SEMANU, GUNUNGKIDUL, DAERAH ISTIMEWA YOGYAKARTA",14,200,29,229
https://kawalpemilu.org#42130,"NGEPOSARI, SEMANU, GUNUNGKIDUL, DAERAH ISTIMEWA YOGYAKARTA",15,123,26,149
https://kawalpemilu.org#42130,"NGEPOSARI, SEMANU, GUNUNGKIDUL, DAERAH ISTIMEWA YOGYAKARTA",16,179,28,207
https://kawalpemilu.org#42130,"NGEPOSARI, SEMANU, GUNUNGKIDUL, DAERAH ISTIMEWA YOGYAKARTA",17,121,64,185
https://kawalpemilu.org#42130,"NGEPOSARI, SEMANU, GUNUNGKIDUL, DAERAH ISTIMEWA YOGYAKARTA",18,83,12,95
https://kawalpemilu.org#42130,"NGEPOSARI, SEMANU, GUNUNGKIDUL, DAERAH ISTIMEWA YOGYAKARTA",19,137,59,196
https://kawalpemilu.org#42130,"NGEPOSARI, SEMANU, GUNUNGKIDUL, DAERAH ISTIMEWA YOGYAKARTA",20,126,41,167
https://kawalpemilu.org#42130,"NGEPOSARI, SEMANU, GUNUNGKIDUL, DAERAH ISTIMEWA YOGYAKARTA",21,83,40,123
https://kawalpemilu.org#42130,"NGEPOSARI, SEMANU, GUNUNGKIDUL, DAERAH ISTIMEWA YOGYAKARTA",22,167,55,222
https://kawalpemilu.org#42130,"NGEPOSARI, SEMANU, GUNUNGKIDUL, DAERAH ISTIMEWA YOGYAKARTA",23,143,70,213
https://kawalpemilu.org#42130,"NGEPOSARI, SEMANU, GUNUNGKIDUL, DAERAH ISTIMEWA YOGYAKARTA",24,111,63,174
https://kawalpemilu.org#42130,"NGEPOSARI, SEMANU, GUNUNGKIDUL, DAERAH ISTIMEWA YOGYAKARTA",25,155,35,190
https://kawalpemilu.org#42130,"NGEPOSARI, SEMANU, GUNUNGKIDUL, DAERAH ISTIMEWA YOGYAKARTA",26,174,33,207
https://kawalpemilu.org#42130,"NGEPOSARI, SEMANU, GUNUNGKIDUL, DAERAH ISTIMEWA YOGYAKARTA",27,171,37,208
https://kawalpemilu.org#42130,"NGEPOSARI, SEMANU, GUNUNGKIDUL, DAERAH ISTIMEWA YOGYAKARTA",28,123,28,151
https://kawalpemilu.org#42130,"NGEPOSARI, SEMANU, GUNUNGKIDUL, DAERAH ISTIMEWA YOGYAKARTA",29,99,46,145
https://kawalpemilu.org#42130,"NGEPOSARI, SEMANU, GUNUNGKIDUL, DAERAH ISTIMEWA YOGYAKARTA",30,138,41,179
https://kawalpemilu.org#42130,"NGEPOSARI, SEMANU, GUNUNGKIDUL, DAERAH ISTIMEWA YOGYAKARTA",31,132,29,161
https://kawalpemilu.org#42130,"NGEPOSARI, SEMANU, GUNUNGKIDUL, DAERAH ISTIMEWA YOGYAKARTA",32,99,36,135
https://kawalpemilu.org#42130,"NGEPOSARI, SEMANU, GUNUNGKIDUL, DAERAH ISTIMEWA YOGYAKARTA",33,122,39,161
https://kawalpemilu.org#42130,"NGEPOSARI, SEMANU, GUNUNGKIDUL, DAERAH ISTIMEWA YOGYAKARTA",34,58,43,101
https://kawalpemilu.org#42130,"NGEPOSARI, SEMANU, GUNUNGKIDUL, DAERAH ISTIMEWA YOGYAKARTA",35,126,23,149
https://kawalpemilu.org#42130,"NGEPOSARI, SEMANU, GUNUNGKIDUL, DAERAH ISTIMEWA YOGYAKARTA",36,135,13,148
https://kawalpemilu.org#42130,"NGEPOSARI, SEMANU, GUNUNGKIDUL, DAERAH ISTIMEWA YOGYAKARTA",37,105,18,123
https://kawalpemilu.org#42130,"NGEPOSARI, SEMANU, GUNUNGKIDUL, DAERAH ISTIMEWA YOGYAKARTA",38,151,9,160
https://kawalpemilu.org#42130,"NGEPOSARI, SEMANU, GUNUNGKIDUL, DAERAH ISTIMEWA YOGYAKARTA",39,100,26,126
https://kawalpemilu.org#42130,"NGEPOSARI, SEMANU, GUNUNGKIDUL, DAERAH ISTIMEWA YOGYAKARTA",40,105,13,118
https://kawalpemilu.org#42131,"SEMANU, SEMANU, GUNUNGKIDUL, DAERAH ISTIMEWA YOGYAKARTA",1,155,13,168
https://kawalpemilu.org#42131,"SEMANU, SEMANU, GUNUNGKIDUL, DAERAH ISTIMEWA YOGYAKARTA",2,198,26,224
https://kawalpemilu.org#42131,"SEMANU, SEMANU, GUNUNGKIDUL, DAERAH ISTIMEWA YOGYAKARTA",3,149,59,208
https://kawalpemilu.org#42131,"SEMANU, SEMANU, GUNUNGKIDUL, DAERAH ISTIMEWA YOGYAKARTA",4,161,53,214
https://kawalpemilu.org#42131,"SEMANU, SEMANU, GUNUNGKIDUL, DAERAH ISTIMEWA YOGYAKARTA",5,126,39,165
https://kawalpemilu.org#42131,"SEMANU, SEMANU, GUNUNGKIDUL, DAERAH ISTIMEWA YOGYAKARTA",6,163,23,186
https://kawalpemilu.org#42131,"SEMANU, SEMANU, GUNUNGKIDUL, DAERAH ISTIMEWA YOGYAKARTA",7,151,26,177
https://kawalpemilu.org#42131,"SEMANU, SEMANU, GUNUNGKIDUL, DAERAH ISTIMEWA YOGYAKARTA",8,157,45,202
https://kawalpemilu.org#42131,"SEMANU, SEMANU, GUNUNGKIDUL, DAERAH ISTIMEWA YOGYAKARTA",9,129,17,146
https://kawalpemilu.org#42131,"SEMANU, SEMANU, GUNUNGKIDUL, DAERAH ISTIMEWA YOGYAKARTA",10,128,41,169
https://kawalpemilu.org#42131,"SEMANU, SEMANU, GUNUNGKIDUL, DAERAH ISTIMEWA YOGYAKARTA",11,183,47,230
https://kawalpemilu.org#42131,"SEMANU, SEMANU, GUNUNGKIDUL, DAERAH ISTIMEWA YOGYAKARTA",12,128,44,172
https://kawalpemilu.org#42131,"SEMANU, SEMANU, GUNUNGKIDUL, DAERAH ISTIMEWA YOGYAKARTA",13,152,32,184
https://kawalpemilu.org#42131,"SEMANU, SEMANU, GUNUNGKIDUL, DAERAH ISTIMEWA YOGYAKARTA",14,186,63,249
https://kawalpemilu.org#42131,"SEMANU, SEMANU, GUNUNGKIDUL, DAERAH ISTIMEWA YOGYAKARTA",15,185,55,240
https://kawalpemilu.org#42131,"SEMANU, SEMANU, GUNUNGKIDUL, DAERAH ISTIMEWA YOGYAKARTA",16,159,69,228
https://kawalpemilu.org#42131,"SEMANU, SEMANU, GUNUNGKIDUL, DAERAH ISTIMEWA YOGYAKARTA",17,168,66,234
https://kawalpemilu.org#42131,"SEMANU, SEMANU, GUNUNGKIDUL, DAERAH ISTIMEWA YOGYAKARTA",18,151,41,192
https://kawalpemilu.org#42131,"SEMANU, SEMANU, GUNUNGKIDUL, DAERAH ISTIMEWA YOGYAKARTA",19,153,54,207
https://kawalpemilu.org#42131,"SEMANU, SEMANU, GUNUNGKIDUL, DAERAH ISTIMEWA YOGYAKARTA",20,177,32,209
https://kawalpemilu.org#42131,"SEMANU, SEMANU, GUNUNGKIDUL, DAERAH ISTIMEWA YOGYAKARTA",21,191,37,228
https://kawalpemilu.org#42131,"SEMANU, SEMANU, GUNUNGKIDUL, DAERAH ISTIMEWA YOGYAKARTA",22,182,48,230
https://kawalpemilu.org#42131,"SEMANU, SEMANU, GUNUNGKIDUL, DAERAH ISTIMEWA YOGYAKARTA",23,175,54,229
https://kawalpemilu.org#42131,"SEMANU, SEMANU, GUNUNGKIDUL, DAERAH ISTIMEWA YOGYAKARTA",24,117,34,151
https://kawalpemilu.org#42131,"SEMANU, SEMANU, GUNUNGKIDUL, DAERAH ISTIMEWA YOGYAKARTA",25,142,33,175
https://kawalpemilu.org#42131,"SEMANU, SEMANU, GUNUNGKIDUL, DAERAH ISTIMEWA YOGYAKARTA",26,149,25,174
https://kawalpemilu.org#42131,"SEMANU, SEMANU, GUNUNGKIDUL, DAERAH ISTIMEWA YOGYAKARTA",27,125,19,144
https://kawalpemilu.org#42131,"SEMANU, SEMANU, GUNUNGKIDUL, DAERAH ISTIMEWA YOGYAKARTA",28,175,22,197
https://kawalpemilu.org#42131,"SEMANU, SEMANU, GUNUNGKIDUL, DAERAH ISTIMEWA YOGYAKARTA",29,139,23,162
https://kawalpemilu.org#42131,"SEMANU, SEMANU, GUNUNGKIDUL, DAERAH ISTIMEWA YOGYAKARTA",30,129,19,148
https://kawalpemilu.org#42131,"SEMANU, SEMANU, GUNUNGKIDUL, DAERAH ISTIMEWA YOGYAKARTA",31,121,24,145
https://kawalpemilu.org#42131,"SEMANU, SEMANU, GUNUNGKIDUL, DAERAH ISTIMEWA YOGYAKARTA",32,195,25,220
https://kawalpemilu.org#42131,"SEMANU, SEMANU, GUNUNGKIDUL, DAERAH ISTIMEWA YOGYAKARTA",33,199,26,225
https://kawalpemilu.org#42131,"SEMANU, SEMANU, GUNUNGKIDUL, DAERAH ISTIMEWA YOGYAKARTA",34,132,30,162
https://kawalpemilu.org#42131,"SEMANU, SEMANU, GUNUNGKIDUL, DAERAH ISTIMEWA YOGYAKARTA",35,170,47,217
https://kawalpemilu.org#42131,"SEMANU, SEMANU, GUNUNGKIDUL, DAERAH ISTIMEWA YOGYAKARTA",36,159,16,175
https://kawalpemilu.org#42131,"SEMANU, SEMANU, GUNUNGKIDUL, DAERAH ISTIMEWA YOGYAKARTA",37,120,14,134
https://kawalpemilu.org#42131,"SEMANU, SEMANU, GUNUNGKIDUL, DAERAH ISTIMEWA YOGYAKARTA",38,101,49,150
https://kawalpemilu.org#42131,"SEMANU, SEMANU, GUNUNGKIDUL, DAERAH ISTIMEWA YOGYAKARTA",39,166,55,221
https://kawalpemilu.org#42131,"SEMANU, SEMANU, GUNUNGKIDUL, DAERAH ISTIMEWA YOGYAKARTA",40,158,27,185
https://kawalpemilu.org#42131,"SEMANU, SEMANU, GUNUNGKIDUL, DAERAH ISTIMEWA YOGYAKARTA",41,109,37,146
https://kawalpemilu.org#42131,"SEMANU, SEMANU, GUNUNGKIDUL, DAERAH ISTIMEWA YOGYAKARTA",42,132,53,185
https://kawalpemilu.org#42131,"SEMANU, SEMANU, GUNUNGKIDUL, DAERAH ISTIMEWA YOGYAKARTA",43,137,39,176
https://kawalpemilu.org#42131,"SEMANU, SEMANU, GUNUNGKIDUL, DAERAH ISTIMEWA YOGYAKARTA",44,137,57,194
https://kawalpemilu.org#42131,"SEMANU, SEMANU, GUNUNGKIDUL, DAERAH ISTIMEWA YOGYAKARTA",45,116,63,179
https://kawalpemilu.org#42131,"SEMANU, SEMANU, GUNUNGKIDUL, DAERAH ISTIMEWA YOGYAKARTA",46,107,73,180
https://kawalpemilu.org#42131,"SEMANU, SEMANU, GUNUNGKIDUL, DAERAH ISTIMEWA YOGYAKARTA",47,120,58,178
https://kawalpemilu.org#42131,"SEMANU, SEMANU, GUNUNGKIDUL, DAERAH ISTIMEWA YOGYAKARTA",48,108,78,186
https://kawalpemilu.org#42131,"SEMANU, SEMANU, GUNUNGKIDUL, DAERAH ISTIMEWA YOGYAKARTA",49,81,92,173
https://kawalpemilu.org#42131,"SEMANU, SEMANU, GUNUNGKIDUL, DAERAH ISTIMEWA YOGYAKARTA",50,146,49,195
https://kawalpemilu.org#42131,"SEMANU, SEMANU, GUNUNGKIDUL, DAERAH ISTIMEWA YOGYAKARTA",51,195,39,234
https://kawalpemilu.org#42131,"SEMANU, SEMANU, GUNUNGKIDUL, DAERAH ISTIMEWA YOGYAKARTA",52,184,25,209
https://kawalpemilu.org#42131,"SEMANU, SEMANU, GUNUNGKIDUL, DAERAH ISTIMEWA YOGYAKARTA",53,105,60,165
https://kawalpemilu.org#42131,"SEMANU, SEMANU, GUNUNGKIDUL, DAERAH ISTIMEWA YOGYAKARTA",54,106,50,156
https://kawalpemilu.org#42131,"SEMANU, SEMANU, GUNUNGKIDUL, DAERAH ISTIMEWA YOGYAKARTA",55,120,45,165
https://kawalpemilu.org#42131,"SEMANU, SEMANU, GUNUNGKIDUL, DAERAH ISTIMEWA YOGYAKARTA",56,152,45,197
https://kawalpemilu.org#42131,"SEMANU, SEMANU, GUNUNGKIDUL, DAERAH ISTIMEWA YOGYAKARTA",57,132,61,193
https://kawalpemilu.org#42132,"PACAREJO, SEMANU, GUNUNGKIDUL, DAERAH ISTIMEWA YOGYAKARTA",1,136,80,216
https://kawalpemilu.org#42132,"PACAREJO, SEMANU, GUNUNGKIDUL, DAERAH ISTIMEWA YOGYAKARTA",2,130,54,184
https://kawalpemilu.org#42132,"PACAREJO, SEMANU, GUNUNGKIDUL, DAERAH ISTIMEWA YOGYAKARTA",3,162,43,205
https://kawalpemilu.org#42132,"PACAREJO, SEMANU, GUNUNGKIDUL, DAERAH ISTIMEWA YOGYAKARTA",4,132,99,231
https://kawalpemilu.org#42132,"PACAREJO, SEMANU, GUNUNGKIDUL, DAERAH ISTIMEWA YOGYAKARTA",5,163,42,205
https://kawalpemilu.org#42132,"PACAREJO, SEMANU, GUNUNGKIDUL, DAERAH ISTIMEWA YOGYAKARTA",6,178,35,213
https://kawalpemilu.org#42132,"PACAREJO, SEMANU, GUNUNGKIDUL, DAERAH ISTIMEWA YOGYAKARTA",7,193,31,224
https://kawalpemilu.org#42132,"PACAREJO, SEMANU, GUNUNGKIDUL, DAERAH ISTIMEWA YOGYAKARTA",8,185,47,232
https://kawalpemilu.org#42132,"PACAREJO, SEMANU, GUNUNGKIDUL, DAERAH ISTIMEWA YOGYAKARTA",9,119,100,219
https://kawalpemilu.org#42132,"PACAREJO, SEMANU, GUNUNGKIDUL, DAERAH ISTIMEWA YOGYAKARTA",10,176,38,214
https://kawalpemilu.org#42132,"PACAREJO, SEMANU, GUNUNGKIDUL, DAERAH ISTIMEWA YOGYAKARTA",11,144,22,166
https://kawalpemilu.org#42132,"PACAREJO, SEMANU, GUNUNGKIDUL, DAERAH ISTIMEWA YOGYAKARTA",12,169,37,206
https://kawalpemilu.org#42132,"PACAREJO, SEMANU, GUNUNGKIDUL, DAERAH ISTIMEWA YOGYAKARTA",13,136,42,178
https://kawalpemilu.org#42132,"PACAREJO, SEMANU, GUNUNGKIDUL, DAERAH ISTIMEWA YOGYAKARTA",14,220,34,254
https://kawalpemilu.org#42132,"PACAREJO, SEMANU, GUNUNGKIDUL, DAERAH ISTIMEWA YOGYAKARTA",15,236,26,262
https://kawalpemilu.org#42132,"PACAREJO, SEMANU, GUNUNGKIDUL, DAERAH ISTIMEWA YOGYAKARTA",16,208,33,241
https://kawalpemilu.org#42132,"PACAREJO, SEMANU, GUNUNGKIDUL, DAERAH ISTIMEWA YOGYAKARTA",17,194,47,241
https://kawalpemilu.org#42132,"PACAREJO, SEMANU, GUNUNGKIDUL, DAERAH ISTIMEWA YOGYAKARTA",18,140,55,195
https://kawalpemilu.org#42132,"PACAREJO, SEMANU, GUNUNGKIDUL, DAERAH ISTIMEWA YOGYAKARTA",19,81,27,108
https://kawalpemilu.org#42132,"PACAREJO, SEMANU, GUNUNGKIDUL, DAERAH ISTIMEWA YOGYAKARTA",20,184,41,225
https://kawalpemilu.org#42132,"PACAREJO, SEMANU, GUNUNGKIDUL, DAERAH ISTIMEWA YOGYAKARTA",21,149,60,209
https://kawalpemilu.org#42132,"PACAREJO, SEMANU, GUNUNGKIDUL, DAERAH ISTIMEWA YOGYAKARTA",22,147,11,158
https://kawalpemilu.org#42132,"PACAREJO, SEMANU, GUNUNGKIDUL, DAERAH ISTIMEWA YOGYAKARTA",23,85,30,115
https://kawalpemilu.org#42132,"PACAREJO, SEMANU, GUNUNGKIDUL, DAERAH ISTIMEWA YOGYAKARTA",24,143,52,195
https://kawalpemilu.org#42132,"PACAREJO, SEMANU, GUNUNGKIDUL, DAERAH ISTIMEWA YOGYAKARTA",25,144,22,166
https://kawalpemilu.org#42132,"PACAREJO, SEMANU, GUNUNGKIDUL, DAERAH ISTIMEWA YOGYAKARTA",26,162,33,195
https://kawalpemilu.org#42132,"PACAREJO, SEMANU, GUNUNGKIDUL, DAERAH ISTIMEWA YOGYAKARTA",27,109,20,129
https://kawalpemilu.org#42132,"PACAREJO, SEMANU, GUNUNGKIDUL, DAERAH ISTIMEWA YOGYAKARTA",28,142,51,193
https://kawalpemilu.org#42132,"PACAREJO, SEMANU, GUNUNGKIDUL, DAERAH ISTIMEWA YOGYAKARTA",29,218,18,236
https://kawalpemilu.org#42132,"PACAREJO, SEMANU, GUNUNGKIDUL, DAERAH ISTIMEWA YOGYAKARTA",30,204,17,221
https://kawalpemilu.org#42132,"PACAREJO, SEMANU, GUNUNGKIDUL, DAERAH ISTIMEWA YOGYAKARTA",31,151,25,176
https://kawalpemilu.org#42132,"PACAREJO, SEMANU, GUNUNGKIDUL, DAERAH ISTIMEWA YOGYAKARTA",32,171,9,180
https://kawalpemilu.org#42132,"PACAREJO, SEMANU, GUNUNGKIDUL, DAERAH ISTIMEWA YOGYAKARTA",33,168,10,178
https://kawalpemilu.org#42132,"PACAREJO, SEMANU, GUNUNGKIDUL, DAERAH ISTIMEWA YOGYAKARTA",34,136,36,172
https://kawalpemilu.org#42132,"PACAREJO, SEMANU, GUNUNGKIDUL, DAERAH ISTIMEWA YOGYAKARTA",35,113,46,159
https://kawalpemilu.org#42132,"PACAREJO, SEMANU, GUNUNGKIDUL, DAERAH ISTIMEWA YOGYAKARTA",36,127,68,195
https://kawalpemilu.org#42132,"PACAREJO, SEMANU, GUNUNGKIDUL, DAERAH ISTIMEWA YOGYAKARTA",37,138,48,186
https://kawalpemilu.org#42132,"PACAREJO, SEMANU, GUNUNGKIDUL, DAERAH ISTIMEWA YOGYAKARTA",38,161,27,188
https://kawalpemilu.org#42132,"PACAREJO, SEMANU, GUNUNGKIDUL, DAERAH ISTIMEWA YOGYAKARTA",39,97,33,130
https://kawalpemilu.org#42132,"PACAREJO, SEMANU, GUNUNGKIDUL, DAERAH ISTIMEWA YOGYAKARTA",40,145,61,206
https://kawalpemilu.org#42132,"PACAREJO, SEMANU, GUNUNGKIDUL, DAERAH ISTIMEWA YOGYAKARTA",41,91,32,123
https://kawalpemilu.org#42132,"PACAREJO, SEMANU, GUNUNGKIDUL, DAERAH ISTIMEWA YOGYAKARTA",42,128,29,157
https://kawalpemilu.org#42132,"PACAREJO, SEMANU, GUNUNGKIDUL, DAERAH ISTIMEWA YOGYAKARTA",43,118,35,153
https://kawalpemilu.org#42132,"PACAREJO, SEMANU, GUNUNGKIDUL, DAERAH ISTIMEWA YOGYAKARTA",44,163,30,193
https://kawalpemilu.org#42132,"PACAREJO, SEMANU, GUNUNGKIDUL, DAERAH ISTIMEWA YOGYAKARTA",45,209,24,233
https://kawalpemilu.org#42132,"PACAREJO, SEMANU, GUNUNGKIDUL, DAERAH ISTIMEWA YOGYAKARTA",46,195,19,214
https://kawalpemilu.org#42132,"PACAREJO, SEMANU, GUNUNGKIDUL, DAERAH ISTIMEWA YOGYAKARTA",47,184,24,208
https://kawalpemilu.org#42132,"PACAREJO, SEMANU, GUNUNGKIDUL, DAERAH ISTIMEWA YOGYAKARTA",48,178,22,200
https://kawalpemilu.org#42132,"PACAREJO, SEMANU, GUNUNGKIDUL, DAERAH ISTIMEWA YOGYAKARTA",49,134,42,176
https://kawalpemilu.org#42132,"PACAREJO, SEMANU, GUNUNGKIDUL, DAERAH ISTIMEWA YOGYAKARTA",50,165,39,204
https://kawalpemilu.org#42132,"PACAREJO, SEMANU, GUNUNGKIDUL, DAERAH ISTIMEWA YOGYAKARTA",51,182,56,238
https://kawalpemilu.org#42132,"PACAREJO, SEMANU, GUNUNGKIDUL, DAERAH ISTIMEWA YOGYAKARTA",52,198,33,231
https://kawalpemilu.org#42132,"PACAREJO, SEMANU, GUNUNGKIDUL, DAERAH ISTIMEWA YOGYAKARTA",53,156,53,209
https://kawalpemilu.org#42132,"PACAREJO, SEMANU, GUNUNGKIDUL, DAERAH ISTIMEWA YOGYAKARTA",54,84,25,109
https://kawalpemilu.org#42132,"PACAREJO, SEMANU, GUNUNGKIDUL, DAERAH ISTIMEWA YOGYAKARTA",55,111,49,160
https://kawalpemilu.org#42132,"PACAREJO, SEMANU, GUNUNGKIDUL, DAERAH ISTIMEWA YOGYAKARTA",56,135,59,194
https://kawalpemilu.org#42132,"PACAREJO, SEMANU, GUNUNGKIDUL, DAERAH ISTIMEWA YOGYAKARTA",57,117,38,155
https://kawalpemilu.org#42132,"PACAREJO, SEMANU, GUNUNGKIDUL, DAERAH ISTIMEWA YOGYAKARTA",58,97,31,128
https://kawalpemilu.org#42133,"CANDIREJO, SEMANU, GUNUNGKIDUL, DAERAH ISTIMEWA YOGYAKARTA",1,109,35,144
https://kawalpemilu.org#42133,"CANDIREJO, SEMANU, GUNUNGKIDUL, DAERAH ISTIMEWA YOGYAKARTA",2,82,39,121
https://kawalpemilu.org#42133,"CANDIREJO, SEMANU, GUNUNGKIDUL, DAERAH ISTIMEWA YOGYAKARTA",3,137,55,192
https://kawalpemilu.org#42133,"CANDIREJO, SEMANU, GUNUNGKIDUL, DAERAH ISTIMEWA YOGYAKARTA",4,98,42,140
https://kawalpemilu.org#42133,"CANDIREJO, SEMANU, GUNUNGKIDUL, DAERAH ISTIMEWA YOGYAKARTA",5,93,83,176
https://kawalpemilu.org#42133,"CANDIREJO, SEMANU, GUNUNGKIDUL, DAERAH ISTIMEWA YOGYAKARTA",6,72,95,167
https://kawalpemilu.org#42133,"CANDIREJO, SEMANU, GUNUNGKIDUL, DAERAH ISTIMEWA YOGYAKARTA",7,142,38,180
https://kawalpemilu.org#42133,"CANDIREJO, SEMANU, GUNUNGKIDUL, DAERAH ISTIMEWA YOGYAKARTA",8,129,31,160
https://kawalpemilu.org#42133,"CANDIREJO, SEMANU, GUNUNGKIDUL, DAERAH ISTIMEWA YOGYAKARTA",9,159,36,195
https://kawalpemilu.org#42133,"CANDIREJO, SEMANU, GUNUNGKIDUL, DAERAH ISTIMEWA YOGYAKARTA",10,165,26,191
https://kawalpemilu.org#42133,"CANDIREJO, SEMANU, GUNUNGKIDUL, DAERAH ISTIMEWA YOGYAKARTA",11,105,17,122
https://kawalpemilu.org#42133,"CANDIREJO, SEMANU, GUNUNGKIDUL, DAERAH ISTIMEWA YOGYAKARTA",12,98,14,112
https://kawalpemilu.org#42133,"CANDIREJO, SEMANU, GUNUNGKIDUL, DAERAH ISTIMEWA YOGYAKARTA",13,115,33,148
https://kawalpemilu.org#42133,"CANDIREJO, SEMANU, GUNUNGKIDUL, DAERAH ISTIMEWA YOGYAKARTA",14,122,19,141
https://kawalpemilu.org#42133,"CANDIREJO, SEMANU, GUNUNGKIDUL, DAERAH ISTIMEWA YOGYAKARTA",15,112,42,154
https://kawalpemilu.org#42133,"CANDIREJO, SEMANU, GUNUNGKIDUL, DAERAH ISTIMEWA YOGYAKARTA",16,137,78,215
https://kawalpemilu.org#42133,"CANDIREJO, SEMANU, GUNUNGKIDUL, DAERAH ISTIMEWA YOGYAKARTA",17,88,36,124
https://kawalpemilu.org#42133,"CANDIREJO, SEMANU, GUNUNGKIDUL, DAERAH ISTIMEWA YOGYAKARTA",18,95,59,154
https://kawalpemilu.org#42133,"CANDIREJO, SEMANU, GUNUNGKIDUL, DAERAH ISTIMEWA YOGYAKARTA",19,78,63,141
https://kawalpemilu.org#42133,"CANDIREJO, SEMANU, GUNUNGKIDUL, DAERAH ISTIMEWA YOGYAKARTA",20,105,79,184
https://kawalpemilu.org#42133,"CANDIREJO, SEMANU, GUNUNGKIDUL, DAERAH ISTIMEWA YOGYAKARTA",21,99,16,115
https://kawalpemilu.org#42133,"CANDIREJO, SEMANU, GUNUNGKIDUL, DAERAH ISTIMEWA YOGYAKARTA",22,124,36,160
https://kawalpemilu.org#42133,"CANDIREJO, SEMANU, GUNUNGKIDUL, DAERAH ISTIMEWA YOGYAKARTA",23,175,29,204
https://kawalpemilu.org#42133,"CANDIREJO, SEMANU, GUNUNGKIDUL, DAERAH ISTIMEWA YOGYAKARTA",24,114,13,127
https://kawalpemilu.org#42133,"CANDIREJO, SEMANU, GUNUNGKIDUL, DAERAH ISTIMEWA YOGYAKARTA",25,73,31,104
https://kawalpemilu.org#42133,"CANDIREJO, SEMANU, GUNUNGKIDUL, DAERAH ISTIMEWA YOGYAKARTA",26,157,35,192
https://kawalpemilu.org#42133,"CANDIREJO, SEMANU, GUNUNGKIDUL, DAERAH ISTIMEWA YOGYAKARTA",27,141,41,182
https://kawalpemilu.org#42133,"CANDIREJO, SEMANU, GUNUNGKIDUL, DAERAH ISTIMEWA YOGYAKARTA",28,105,30,135
https://kawalpemilu.org#42133,"CANDIREJO, SEMANU, GUNUNGKIDUL, DAERAH ISTIMEWA YOGYAKARTA",29,183,35,218
https://kawalpemilu.org#42133,"CANDIREJO, SEMANU, GUNUNGKIDUL, DAERAH ISTIMEWA YOGYAKARTA",30,146,10,156
https://kawalpemilu.org#42133,"CANDIREJO, SEMANU, GUNUNGKIDUL, DAERAH ISTIMEWA YOGYAKARTA",31,157,8,165
https://kawalpemilu.org#42133,"CANDIREJO, SEMANU, GUNUNGKIDUL, DAERAH ISTIMEWA YOGYAKARTA",32,121,30,151
https://kawalpemilu.org#42133,"CANDIREJO, SEMANU, GUNUNGKIDUL, DAERAH ISTIMEWA YOGYAKARTA",33,107,33,140
https://kawalpemilu.org#42133,"CANDIREJO, SEMANU, GUNUNGKIDUL, DAERAH ISTIMEWA YOGYAKARTA",34,190,14,204
https://kawalpemilu.org#42134,"DADAPAYU, SEMANU, GUNUNGKIDUL, DAERAH ISTIMEWA YOGYAKARTA",1,216,5,221
https://kawalpemilu.org#42134,"DADAPAYU, SEMANU, GUNUNGKIDUL, DAERAH ISTIMEWA YOGYAKARTA",2,166,33,199
https://kawalpemilu.org#42134,"DADAPAYU, SEMANU, GUNUNGKIDUL, DAERAH ISTIMEWA YOGYAKARTA",3,117,70,187
https://kawalpemilu.org#42134,"DADAPAYU, SEMANU, GUNUNGKIDUL, DAERAH ISTIMEWA YOGYAKARTA",4,116,46,162
https://kawalpemilu.org#42134,"DADAPAYU, SEMANU, GUNUNGKIDUL, DAERAH ISTIMEWA YOGYAKARTA",5,167,55,222
https://kawalpemilu.org#42134,"DADAPAYU, SEMANU, GUNUNGKIDUL, DAERAH ISTIMEWA YOGYAKARTA",6,93,46,139
https://kawalpemilu.org#42134,"DADAPAYU, SEMANU, GUNUNGKIDUL, DAERAH ISTIMEWA YOGYAKARTA",7,102,16,118
https://kawalpemilu.org#42134,"DADAPAYU, SEMANU, GUNUNGKIDUL, DAERAH ISTIMEWA YOGYAKARTA",8,132,20,152
https://kawalpemilu.org#42134,"DADAPAYU, SEMANU, GUNUNGKIDUL, DAERAH ISTIMEWA YOGYAKARTA",9,93,39,132
https://kawalpemilu.org#42134,"DADAPAYU, SEMANU, GUNUNGKIDUL, DAERAH ISTIMEWA YOGYAKARTA",10,120,59,179
https://kawalpemilu.org#42134,"DADAPAYU, SEMANU, GUNUNGKIDUL, DAERAH ISTIMEWA YOGYAKARTA",11,161,58,219
https://kawalpemilu.org#42134,"DADAPAYU, SEMANU, GUNUNGKIDUL, DAERAH ISTIMEWA YOGYAKARTA",12,215,27,242
https://kawalpemilu.org#42134,"DADAPAYU, SEMANU, GUNUNGKIDUL, DAERAH ISTIMEWA YOGYAKARTA",13,133,41,174
https://kawalpemilu.org#42134,"DADAPAYU, SEMANU, GUNUNGKIDUL, DAERAH ISTIMEWA YOGYAKARTA",14,151,11,162
https://kawalpemilu.org#42134,"DADAPAYU, SEMANU, GUNUNGKIDUL, DAERAH ISTIMEWA YOGYAKARTA",15,206,14,220
https://kawalpemilu.org#42134,"DADAPAYU, SEMANU, GUNUNGKIDUL, DAERAH ISTIMEWA YOGYAKARTA",16,141,34,175
https://kawalpemilu.org#42134,"DADAPAYU, SEMANU, GUNUNGKIDUL, DAERAH ISTIMEWA YOGYAKARTA",17,130,31,161
https://kawalpemilu.org#42134,"DADAPAYU, SEMANU, GUNUNGKIDUL, DAERAH ISTIMEWA YOGYAKARTA",18,134,52,186
https://kawalpemilu.org#42134,"DADAPAYU, SEMANU, GUNUNGKIDUL, DAERAH ISTIMEWA YOGYAKARTA",19,106,30,136
https://kawalpemilu.org#42134,"DADAPAYU, SEMANU, GUNUNGKIDUL, DAERAH ISTIMEWA YOGYAKARTA",20,204,56,260
https://kawalpemilu.org#42134,"DADAPAYU, SEMANU, GUNUNGKIDUL, DAERAH ISTIMEWA YOGYAKARTA",21,98,48,146
https://kawalpemilu.org#42134,"DADAPAYU, SEMANU, GUNUNGKIDUL, DAERAH ISTIMEWA YOGYAKARTA",22,122,33,155
https://kawalpemilu.org#42134,"DADAPAYU, SEMANU, GUNUNGKIDUL, DAERAH ISTIMEWA YOGYAKARTA",23,98,73,171
https://kawalpemilu.org#42134,"DADAPAYU, SEMANU, GUNUNGKIDUL, DAERAH ISTIMEWA YOGYAKARTA",24,96,45,141
https://kawalpemilu.org#42134,"DADAPAYU, SEMANU, GUNUNGKIDUL, DAERAH ISTIMEWA YOGYAKARTA",25,164,48,212
https://kawalpemilu.org#42134,"DADAPAYU, SEMANU, GUNUNGKIDUL, DAERAH ISTIMEWA YOGYAKARTA",26,111,10,121
https://kawalpemilu.org#42134,"DADAPAYU, SEMANU, GUNUNGKIDUL, DAERAH ISTIMEWA YOGYAKARTA",27,92,19,111
https://kawalpemilu.org#42134,"DADAPAYU, SEMANU, GUNUNGKIDUL, DAERAH ISTIMEWA YOGYAKARTA",28,86,23,109
https://kawalpemilu.org#42134,"DADAPAYU, SEMANU, GUNUNGKIDUL, DAERAH ISTIMEWA YOGYAKARTA",29,101,29,130
https://kawalpemilu.org#42134,"DADAPAYU, SEMANU, GUNUNGKIDUL, DAERAH ISTIMEWA YOGYAKARTA",30,117,34,151
https://kawalpemilu.org#42134,"DADAPAYU, SEMANU, GUNUNGKIDUL, DAERAH ISTIMEWA YOGYAKARTA",31,117,28,145
https://kawalpemilu.org#42134,"DADAPAYU, SEMANU, GUNUNGKIDUL, DAERAH ISTIMEWA YOGYAKARTA",32,119,32,151
https://kawalpemilu.org#42136,"BEJIHARJO, KARANGMOJO, GUNUNGKIDUL, DAERAH ISTIMEWA YOGYAKARTA",1,170,46,216
https://kawalpemilu.org#42136,"BEJIHARJO, KARANGMOJO, GUNUNGKIDUL, DAERAH ISTIMEWA YOGYAKARTA",2,215,40,255
https://kawalpemilu.org#42136,"BEJIHARJO, KARANGMOJO, GUNUNGKIDUL, DAERAH ISTIMEWA YOGYAKARTA",3,143,34,177
https://kawalpemilu.org#42136,"BEJIHARJO, KARANGMOJO, GUNUNGKIDUL, DAERAH ISTIMEWA YOGYAKARTA",4,176,35,211
https://kawalpemilu.org#42136,"BEJIHARJO, KARANGMOJO, GUNUNGKIDUL, DAERAH ISTIMEWA YOGYAKARTA",5,179,39,218
https://kawalpemilu.org#42136,"BEJIHARJO, KARANGMOJO, GUNUNGKIDUL, DAERAH ISTIMEWA YOGYAKARTA",6,204,18,188
https://kawalpemilu.org#42136,"BEJIHARJO, KARANGMOJO, GUNUNGKIDUL, DAERAH ISTIMEWA YOGYAKARTA",7,130,8,138
https://kawalpemilu.org#42136,"BEJIHARJO, KARANGMOJO, GUNUNGKIDUL, DAERAH ISTIMEWA YOGYAKARTA",8,147,11,158
https://kawalpemilu.org#42136,"BEJIHARJO, KARANGMOJO, GUNUNGKIDUL, DAERAH ISTIMEWA YOGYAKARTA",9,185,45,230
https://kawalpemilu.org#42136,"BEJIHARJO, KARANGMOJO, GUNUNGKIDUL, DAERAH ISTIMEWA YOGYAKARTA",10,192,45,237
https://kawalpemilu.org#42136,"BEJIHARJO, KARANGMOJO, GUNUNGKIDUL, DAERAH ISTIMEWA YOGYAKARTA",11,170,66,236
https://kawalpemilu.org#42136,"BEJIHARJO, KARANGMOJO, GUNUNGKIDUL, DAERAH ISTIMEWA YOGYAKARTA",12,162,37,199
https://kawalpemilu.org#42136,"BEJIHARJO, KARANGMOJO, GUNUNGKIDUL, DAERAH ISTIMEWA YOGYAKARTA",13,129,21,150
https://kawalpemilu.org#42136,"BEJIHARJO, KARANGMOJO, GUNUNGKIDUL, DAERAH ISTIMEWA YOGYAKARTA",14,156,42,198
https://kawalpemilu.org#42136,"BEJIHARJO, KARANGMOJO, GUNUNGKIDUL, DAERAH ISTIMEWA YOGYAKARTA",15,183,37,220
https://kawalpemilu.org#42136,"BEJIHARJO, KARANGMOJO, GUNUNGKIDUL, DAERAH ISTIMEWA YOGYAKARTA",16,130,13,143
https://kawalpemilu.org#42136,"BEJIHARJO, KARANGMOJO, GUNUNGKIDUL, DAERAH ISTIMEWA YOGYAKARTA",17,140,40,180
https://kawalpemilu.org#42136,"BEJIHARJO, KARANGMOJO, GUNUNGKIDUL, DAERAH ISTIMEWA YOGYAKARTA",18,126,23,149
https://kawalpemilu.org#42136,"BEJIHARJO, KARANGMOJO, GUNUNGKIDUL, DAERAH ISTIMEWA YOGYAKARTA",19,157,25,182
https://kawalpemilu.org#42136,"BEJIHARJO, KARANGMOJO, GUNUNGKIDUL, DAERAH ISTIMEWA YOGYAKARTA",20,85,49,134
https://kawalpemilu.org#42136,"BEJIHARJO, KARANGMOJO, GUNUNGKIDUL, DAERAH ISTIMEWA YOGYAKARTA",21,166,76,242
https://kawalpemilu.org#42136,"BEJIHARJO, KARANGMOJO, GUNUNGKIDUL, DAERAH ISTIMEWA YOGYAKARTA",22,114,33,147
https://kawalpemilu.org#42136,"BEJIHARJO, KARANGMOJO, GUNUNGKIDUL, DAERAH ISTIMEWA YOGYAKARTA",23,141,18,159
https://kawalpemilu.org#42136,"BEJIHARJO, KARANGMOJO, GUNUNGKIDUL, DAERAH ISTIMEWA YOGYAKARTA",24,134,23,157
https://kawalpemilu.org#42136,"BEJIHARJO, KARANGMOJO, GUNUNGKIDUL, DAERAH ISTIMEWA YOGYAKARTA",25,139,27,166
https://kawalpemilu.org#42136,"BEJIHARJO, KARANGMOJO, GUNUNGKIDUL, DAERAH ISTIMEWA YOGYAKARTA",26,88,41,129
https://kawalpemilu.org#42136,"BEJIHARJO, KARANGMOJO, GUNUNGKIDUL, DAERAH ISTIMEWA YOGYAKARTA",27,123,26,149
https://kawalpemilu.org#42136,"BEJIHARJO, KARANGMOJO, GUNUNGKIDUL, DAERAH ISTIMEWA YOGYAKARTA",28,166,43,209
https://kawalpemilu.org#42136,"BEJIHARJO, KARANGMOJO, GUNUNGKIDUL, DAERAH ISTIMEWA YOGYAKARTA",29,115,23,138
https://kawalpemilu.org#42136,"BEJIHARJO, KARANGMOJO, GUNUNGKIDUL, DAERAH ISTIMEWA YOGYAKARTA",30,134,16,150
https://kawalpemilu.org#42136,"BEJIHARJO, KARANGMOJO, GUNUNGKIDUL, DAERAH ISTIMEWA YOGYAKARTA",31,119,51,170
https://kawalpemilu.org#42136,"BEJIHARJO, KARANGMOJO, GUNUNGKIDUL, DAERAH ISTIMEWA YOGYAKARTA",32,162,36,198
https://kawalpemilu.org#42136,"BEJIHARJO, KARANGMOJO, GUNUNGKIDUL, DAERAH ISTIMEWA YOGYAKARTA",33,175,52,227
https://kawalpemilu.org#42136,"BEJIHARJO, KARANGMOJO, GUNUNGKIDUL, DAERAH ISTIMEWA YOGYAKARTA",34,193,42,235
https://kawalpemilu.org#42136,"BEJIHARJO, KARANGMOJO, GUNUNGKIDUL, DAERAH ISTIMEWA YOGYAKARTA",35,159,23,182
https://kawalpemilu.org#42136,"BEJIHARJO, KARANGMOJO, GUNUNGKIDUL, DAERAH ISTIMEWA YOGYAKARTA",36,200,28,228
https://kawalpemilu.org#42136,"BEJIHARJO, KARANGMOJO, GUNUNGKIDUL, DAERAH ISTIMEWA YOGYAKARTA",37,186,51,237
https://kawalpemilu.org#42136,"BEJIHARJO, KARANGMOJO, GUNUNGKIDUL, DAERAH ISTIMEWA YOGYAKARTA",38,190,26,216
https://kawalpemilu.org#42136,"BEJIHARJO, KARANGMOJO, GUNUNGKIDUL, DAERAH ISTIMEWA YOGYAKARTA",39,144,34,178
https://kawalpemilu.org#42136,"BEJIHARJO, KARANGMOJO, GUNUNGKIDUL, DAERAH ISTIMEWA YOGYAKARTA",40,202,34,236
https://kawalpemilu.org#42136,"BEJIHARJO, KARANGMOJO, GUNUNGKIDUL, DAERAH ISTIMEWA YOGYAKARTA",41,146,42,188
https://kawalpemilu.org#42136,"BEJIHARJO, KARANGMOJO, GUNUNGKIDUL, DAERAH ISTIMEWA YOGYAKARTA",42,230,25,255
https://kawalpemilu.org#42136,"BEJIHARJO, KARANGMOJO, GUNUNGKIDUL, DAERAH ISTIMEWA YOGYAKARTA",43,184,19,203
https://kawalpemilu.org#42136,"BEJIHARJO, KARANGMOJO, GUNUNGKIDUL, DAERAH ISTIMEWA YOGYAKARTA",44,156,41,197
https://kawalpemilu.org#42136,"BEJIHARJO, KARANGMOJO, GUNUNGKIDUL, DAERAH ISTIMEWA YOGYAKARTA",45,207,20,227
https://kawalpemilu.org#42136,"BEJIHARJO, KARANGMOJO, GUNUNGKIDUL, DAERAH ISTIMEWA YOGYAKARTA",46,176,26,202
https://kawalpemilu.org#42136,"BEJIHARJO, KARANGMOJO, GUNUNGKIDUL, DAERAH ISTIMEWA YOGYAKARTA",47,165,27,192
https://kawalpemilu.org#42136,"BEJIHARJO, KARANGMOJO, GUNUNGKIDUL, DAERAH ISTIMEWA YOGYAKARTA",48,167,33,200
https://kawalpemilu.org#42136,"BEJIHARJO, KARANGMOJO, GUNUNGKIDUL, DAERAH ISTIMEWA YOGYAKARTA",49,116,36,152
https://kawalpemilu.org#42136,"BEJIHARJO, KARANGMOJO, GUNUNGKIDUL, DAERAH ISTIMEWA YOGYAKARTA",50,104,20,124
https://kawalpemilu.org#42136,"BEJIHARJO, KARANGMOJO, GUNUNGKIDUL, DAERAH ISTIMEWA YOGYAKARTA",51,147,51,198
https://kawalpemilu.org#42136,"BEJIHARJO, KARANGMOJO, GUNUNGKIDUL, DAERAH ISTIMEWA YOGYAKARTA",52,166,39,205
https://kawalpemilu.org#42136,"BEJIHARJO, KARANGMOJO, GUNUNGKIDUL, DAERAH ISTIMEWA YOGYAKARTA",53,178,51,229
https://kawalpemilu.org#42136,"BEJIHARJO, KARANGMOJO, GUNUNGKIDUL, DAERAH ISTIMEWA YOGYAKARTA",54,136,84,220
https://kawalpemilu.org#42137,"WILADEG, KARANGMOJO, GUNUNGKIDUL, DAERAH ISTIMEWA YOGYAKARTA",1,162,22,184
https://kawalpemilu.org#42137,"WILADEG, KARANGMOJO, GUNUNGKIDUL, DAERAH ISTIMEWA YOGYAKARTA",2,162,16,178
https://kawalpemilu.org#42137,"WILADEG, KARANGMOJO, GUNUNGKIDUL, DAERAH ISTIMEWA YOGYAKARTA",3,201,48,249
https://kawalpemilu.org#42137,"WILADEG, KARANGMOJO, GUNUNGKIDUL, DAERAH ISTIMEWA YOGYAKARTA",4,154,20,174
https://kawalpemilu.org#42137,"WILADEG, KARANGMOJO, GUNUNGKIDUL, DAERAH ISTIMEWA YOGYAKARTA",5,130,61,191
https://kawalpemilu.org#42137,"WILADEG, KARANGMOJO, GUNUNGKIDUL, DAERAH ISTIMEWA YOGYAKARTA",6,148,63,211
https://kawalpemilu.org#42137,"WILADEG, KARANGMOJO, GUNUNGKIDUL, DAERAH ISTIMEWA YOGYAKARTA",7,156,98,254
https://kawalpemilu.org#42137,"WILADEG, KARANGMOJO, GUNUNGKIDUL, DAERAH ISTIMEWA YOGYAKARTA",8,92,95,187
https://kawalpemilu.org#42137,"WILADEG, KARANGMOJO, GUNUNGKIDUL, DAERAH ISTIMEWA YOGYAKARTA",9,108,103,211
https://kawalpemilu.org#42137,"WILADEG, KARANGMOJO, GUNUNGKIDUL, DAERAH ISTIMEWA YOGYAKARTA",10,103,63,166
https://kawalpemilu.org#42137,"WILADEG, KARANGMOJO, GUNUNGKIDUL, DAERAH ISTIMEWA YOGYAKARTA",11,115,47,162
https://kawalpemilu.org#42137,"WILADEG, KARANGMOJO, GUNUNGKIDUL, DAERAH ISTIMEWA YOGYAKARTA",12,104,28,132
https://kawalpemilu.org#42137,"WILADEG, KARANGMOJO, GUNUNGKIDUL, DAERAH ISTIMEWA YOGYAKARTA",13,166,13,179
https://kawalpemilu.org#42137,"WILADEG, KARANGMOJO, GUNUNGKIDUL, DAERAH ISTIMEWA YOGYAKARTA",14,180,36,216
https://kawalpemilu.org#42137,"WILADEG, KARANGMOJO, GUNUNGKIDUL, DAERAH ISTIMEWA YOGYAKARTA",15,194,33,227
https://kawalpemilu.org#42138,"BENDUNGAN, KARANGMOJO, GUNUNGKIDUL, DAERAH ISTIMEWA YOGYAKARTA",1,148,45,193
https://kawalpemilu.org#42138,"BENDUNGAN, KARANGMOJO, GUNUNGKIDUL, DAERAH ISTIMEWA YOGYAKARTA",2,103,26,129
https://kawalpemilu.org#42138,"BENDUNGAN, KARANGMOJO, GUNUNGKIDUL, DAERAH ISTIMEWA YOGYAKARTA",3,133,48,181
https://kawalpemilu.org#42138,"BENDUNGAN, KARANGMOJO, GUNUNGKIDUL, DAERAH ISTIMEWA YOGYAKARTA",4,148,30,178
https://kawalpemilu.org#42138,"BENDUNGAN, KARANGMOJO, GUNUNGKIDUL, DAERAH ISTIMEWA YOGYAKARTA",5,113,71,184
https://kawalpemilu.org#42138,"BENDUNGAN, KARANGMOJO, GUNUNGKIDUL, DAERAH ISTIMEWA YOGYAKARTA",6,87,68,155
https://kawalpemilu.org#42138,"BENDUNGAN, KARANGMOJO, GUNUNGKIDUL, DAERAH ISTIMEWA YOGYAKARTA",7,158,51,209
https://kawalpemilu.org#42138,"BENDUNGAN, KARANGMOJO, GUNUNGKIDUL, DAERAH ISTIMEWA YOGYAKARTA",8,157,54,211
https://kawalpemilu.org#42139,"KELOR, KARANGMOJO, GUNUNGKIDUL, DAERAH ISTIMEWA YOGYAKARTA",1,152,15,167
https://kawalpemilu.org#42139,"KELOR, KARANGMOJO, GUNUNGKIDUL, DAERAH ISTIMEWA YOGYAKARTA",2,165,17,182
https://kawalpemilu.org#42139,"KELOR, KARANGMOJO, GUNUNGKIDUL, DAERAH ISTIMEWA YOGYAKARTA",3,206,35,241
https://kawalpemilu.org#42139,"KELOR, KARANGMOJO, GUNUNGKIDUL, DAERAH ISTIMEWA YOGYAKARTA",4,175,9,184
https://kawalpemilu.org#42139,"KELOR, KARANGMOJO, GUNUNGKIDUL, DAERAH ISTIMEWA YOGYAKARTA",5,201,58,259
https://kawalpemilu.org#42139,"KELOR, KARANGMOJO, GUNUNGKIDUL, DAERAH ISTIMEWA YOGYAKARTA",6,124,77,201
https://kawalpemilu.org#42139,"KELOR, KARANGMOJO, GUNUNGKIDUL, DAERAH ISTIMEWA YOGYAKARTA",7,127,96,223
https://kawalpemilu.org#42139,"KELOR, KARANGMOJO, GUNUNGKIDUL, DAERAH ISTIMEWA YOGYAKARTA",8,125,24,149
https://kawalpemilu.org#42139,"KELOR, KARANGMOJO, GUNUNGKIDUL, DAERAH ISTIMEWA YOGYAKARTA",9,181,37,218
https://kawalpemilu.org#42139,"KELOR, KARANGMOJO, GUNUNGKIDUL, DAERAH ISTIMEWA YOGYAKARTA",10,124,42,169
https://kawalpemilu.org#42139,"KELOR, KARANGMOJO, GUNUNGKIDUL, DAERAH ISTIMEWA YOGYAKARTA",11,112,38,150
https://kawalpemilu.org#42140,"NGIPAK, KARANGMOJO, GUNUNGKIDUL, DAERAH ISTIMEWA YOGYAKARTA",1,183,30,213
https://kawalpemilu.org#42140,"NGIPAK, KARANGMOJO, GUNUNGKIDUL, DAERAH ISTIMEWA YOGYAKARTA",2,138,20,158
https://kawalpemilu.org#42140,"NGIPAK, KARANGMOJO, GUNUNGKIDUL, DAERAH ISTIMEWA YOGYAKARTA",3,102,60,162
https://kawalpemilu.org#42140,"NGIPAK, KARANGMOJO, GUNUNGKIDUL, DAERAH ISTIMEWA YOGYAKARTA",4,83,49,132
https://kawalpemilu.org#42140,"NGIPAK, KARANGMOJO, GUNUNGKIDUL, DAERAH ISTIMEWA YOGYAKARTA",5,156,61,217
https://kawalpemilu.org#42140,"NGIPAK, KARANGMOJO, GUNUNGKIDUL, DAERAH ISTIMEWA YOGYAKARTA",6,150,75,225
https://kawalpemilu.org#42140,"NGIPAK, KARANGMOJO, GUNUNGKIDUL, DAERAH ISTIMEWA YOGYAKARTA",7,134,42,176
https://kawalpemilu.org#42140,"NGIPAK, KARANGMOJO, GUNUNGKIDUL, DAERAH ISTIMEWA YOGYAKARTA",8,118,15,133
https://kawalpemilu.org#42140,"NGIPAK, KARANGMOJO, GUNUNGKIDUL, DAERAH ISTIMEWA YOGYAKARTA",9,122,38,160
https://kawalpemilu.org#42140,"NGIPAK, KARANGMOJO, GUNUNGKIDUL, DAERAH ISTIMEWA YOGYAKARTA",10,140,38,178
https://kawalpemilu.org#42140,"NGIPAK, KARANGMOJO, GUNUNGKIDUL, DAERAH ISTIMEWA YOGYAKARTA",11,216,26,242
https://kawalpemilu.org#42140,"NGIPAK, KARANGMOJO, GUNUNGKIDUL, DAERAH ISTIMEWA YOGYAKARTA",12,119,12,131
https://kawalpemilu.org#42140,"NGIPAK, KARANGMOJO, GUNUNGKIDUL, DAERAH ISTIMEWA YOGYAKARTA",13,96,29,125
https://kawalpemilu.org#42141,"KARANGMOJO, KARANGMOJO, GUNUNGKIDUL, DAERAH ISTIMEWA YOGYAKARTA",1,144,90,234
https://kawalpemilu.org#42141,"KARANGMOJO, KARANGMOJO, GUNUNGKIDUL, DAERAH ISTIMEWA YOGYAKARTA",2,85,56,141
https://kawalpemilu.org#42141,"KARANGMOJO, KARANGMOJO, GUNUNGKIDUL, DAERAH ISTIMEWA YOGYAKARTA",3,142,48,190
https://kawalpemilu.org#42141,"KARANGMOJO, KARANGMOJO, GUNUNGKIDUL, DAERAH ISTIMEWA YOGYAKARTA",4,145,61,206
https://kawalpemilu.org#42141,"KARANGMOJO, KARANGMOJO, GUNUNGKIDUL, DAERAH ISTIMEWA YOGYAKARTA",5,105,94,199
https://kawalpemilu.org#42141,"KARANGMOJO, KARANGMOJO, GUNUNGKIDUL, DAERAH ISTIMEWA YOGYAKARTA",6,211,34,245
https://kawalpemilu.org#42141,"KARANGMOJO, KARANGMOJO, GUNUNGKIDUL, DAERAH ISTIMEWA YOGYAKARTA",7,142,26,168
https://kawalpemilu.org#42141,"KARANGMOJO, KARANGMOJO, GUNUNGKIDUL, DAERAH ISTIMEWA YOGYAKARTA",8,110,42,152
https://kawalpemilu.org#42141,"KARANGMOJO, KARANGMOJO, GUNUNGKIDUL, DAERAH ISTIMEWA YOGYAKARTA",9,178,46,224
https://kawalpemilu.org#42141,"KARANGMOJO, KARANGMOJO, GUNUNGKIDUL, DAERAH ISTIMEWA YOGYAKARTA",10,96,16,112
https://kawalpemilu.org#42141,"KARANGMOJO, KARANGMOJO, GUNUNGKIDUL, DAERAH ISTIMEWA YOGYAKARTA",11,139,34,173
https://kawalpemilu.org#42141,"KARANGMOJO, KARANGMOJO, GUNUNGKIDUL, DAERAH ISTIMEWA YOGYAKARTA",12,129,24,153
https://kawalpemilu.org#42141,"KARANGMOJO, KARANGMOJO, GUNUNGKIDUL, DAERAH ISTIMEWA YOGYAKARTA",13,71,34,105
https://kawalpemilu.org#42141,"KARANGMOJO, KARANGMOJO, GUNUNGKIDUL, DAERAH ISTIMEWA YOGYAKARTA",14,160,15,175
https://kawalpemilu.org#42141,"KARANGMOJO, KARANGMOJO, GUNUNGKIDUL, DAERAH ISTIMEWA YOGYAKARTA",15,124,81,205
https://kawalpemilu.org#42141,"KARANGMOJO, KARANGMOJO, GUNUNGKIDUL, DAERAH ISTIMEWA YOGYAKARTA",16,102,5,107
https://kawalpemilu.org#42141,"KARANGMOJO, KARANGMOJO, GUNUNGKIDUL, DAERAH ISTIMEWA YOGYAKARTA",17,129,15,144
https://kawalpemilu.org#42141,"KARANGMOJO, KARANGMOJO, GUNUNGKIDUL, DAERAH ISTIMEWA YOGYAKARTA",18,111,22,133
https://kawalpemilu.org#42141,"KARANGMOJO, KARANGMOJO, GUNUNGKIDUL, DAERAH ISTIMEWA YOGYAKARTA",19,89,30,119
https://kawalpemilu.org#42141,"KARANGMOJO, KARANGMOJO, GUNUNGKIDUL, DAERAH ISTIMEWA YOGYAKARTA",20,119,32,151
https://kawalpemilu.org#42141,"KARANGMOJO, KARANGMOJO, GUNUNGKIDUL, DAERAH ISTIMEWA YOGYAKARTA",21,125,25,150
https://kawalpemilu.org#42141,"KARANGMOJO, KARANGMOJO, GUNUNGKIDUL, DAERAH ISTIMEWA YOGYAKARTA",22,159,94,253
https://kawalpemilu.org#42141,"KARANGMOJO, KARANGMOJO, GUNUNGKIDUL, DAERAH ISTIMEWA YOGYAKARTA",23,107,54,161
https://kawalpemilu.org#42141,"KARANGMOJO, KARANGMOJO, GUNUNGKIDUL, DAERAH ISTIMEWA YOGYAKARTA",24,142,64,206
https://kawalpemilu.org#42141,"KARANGMOJO, KARANGMOJO, GUNUNGKIDUL, DAERAH ISTIMEWA YOGYAKARTA",25,174,32,206
https://kawalpemilu.org#42141,"KARANGMOJO, KARANGMOJO, GUNUNGKIDUL, DAERAH ISTIMEWA YOGYAKARTA",26,153,40,193
https://kawalpemilu.org#42141,"KARANGMOJO, KARANGMOJO, GUNUNGKIDUL, DAERAH ISTIMEWA YOGYAKARTA",27,192,41,233
https://kawalpemilu.org#42141,"KARANGMOJO, KARANGMOJO, GUNUNGKIDUL, DAERAH ISTIMEWA YOGYAKARTA",28,118,14,131
https://kawalpemilu.org#42141,"KARANGMOJO, KARANGMOJO, GUNUNGKIDUL, DAERAH ISTIMEWA YOGYAKARTA",29,159,18,177
https://kawalpemilu.org#42141,"KARANGMOJO, KARANGMOJO, GUNUNGKIDUL, DAERAH ISTIMEWA YOGYAKARTA",30,99,24,123
https://kawalpemilu.org#42141,"KARANGMOJO, KARANGMOJO, GUNUNGKIDUL, DAERAH ISTIMEWA YOGYAKARTA",31,112,24,136
https://kawalpemilu.org#42141,"KARANGMOJO, KARANGMOJO, GUNUNGKIDUL, DAERAH ISTIMEWA YOGYAKARTA",32,174,43,217
https://kawalpemilu.org#42142,"GEDANGREJO, KARANGMOJO, GUNUNGKIDUL, DAERAH ISTIMEWA YOGYAKARTA",1,103,96,199
https://kawalpemilu.org#42142,"GEDANGREJO, KARANGMOJO, GUNUNGKIDUL, DAERAH ISTIMEWA YOGYAKARTA",2,117,96,213
https://kawalpemilu.org#42142,"GEDANGREJO, KARANGMOJO, GUNUNGKIDUL, DAERAH ISTIMEWA YOGYAKARTA",3,93,37,130
https://kawalpemilu.org#42142,"GEDANGREJO, KARANGMOJO, GUNUNGKIDUL, DAERAH ISTIMEWA YOGYAKARTA",4,74,88,162
https://kawalpemilu.org#42142,"GEDANGREJO, KARANGMOJO, GUNUNGKIDUL, DAERAH ISTIMEWA YOGYAKARTA",5,54,92,146
https://kawalpemilu.org#42142,"GEDANGREJO, KARANGMOJO, GUNUNGKIDUL, DAERAH ISTIMEWA YOGYAKARTA",6,87,66,153
https://kawalpemilu.org#42142,"GEDANGREJO, KARANGMOJO, GUNUNGKIDUL, DAERAH ISTIMEWA YOGYAKARTA",7,104,55,159
https://kawalpemilu.org#42142,"GEDANGREJO, KARANGMOJO, GUNUNGKIDUL, DAERAH ISTIMEWA YOGYAKARTA",8,110,42,152
https://kawalpemilu.org#42142,"GEDANGREJO, KARANGMOJO, GUNUNGKIDUL, DAERAH ISTIMEWA YOGYAKARTA",9,116,28,144
https://kawalpemilu.org#42142,"GEDANGREJO, KARANGMOJO, GUNUNGKIDUL, DAERAH ISTIMEWA YOGYAKARTA",10,130,60,190
https://kawalpemilu.org#42142,"GEDANGREJO, KARANGMOJO, GUNUNGKIDUL, DAERAH ISTIMEWA YOGYAKARTA",11,83,70,153
https://kawalpemilu.org#42142,"GEDANGREJO, KARANGMOJO, GUNUNGKIDUL, DAERAH ISTIMEWA YOGYAKARTA",12,85,76,161
https://kawalpemilu.org#42142,"GEDANGREJO, KARANGMOJO, GUNUNGKIDUL, DAERAH ISTIMEWA YOGYAKARTA",13,75,30,105
https://kawalpemilu.org#42142,"GEDANGREJO, KARANGMOJO, GUNUNGKIDUL, DAERAH ISTIMEWA YOGYAKARTA",14,162,51,213
https://kawalpemilu.org#42142,"GEDANGREJO, KARANGMOJO, GUNUNGKIDUL, DAERAH ISTIMEWA YOGYAKARTA",15,193,28,221
https://kawalpemilu.org#42142,"GEDANGREJO, KARANGMOJO, GUNUNGKIDUL, DAERAH ISTIMEWA YOGYAKARTA",16,103,35,138
https://kawalpemilu.org#42142,"GEDANGREJO, KARANGMOJO, GUNUNGKIDUL, DAERAH ISTIMEWA YOGYAKARTA",17,146,48,194
https://kawalpemilu.org#42142,"GEDANGREJO, KARANGMOJO, GUNUNGKIDUL, DAERAH ISTIMEWA YOGYAKARTA",18,120,37,157
https://kawalpemilu.org#42142,"GEDANGREJO, KARANGMOJO, GUNUNGKIDUL, DAERAH ISTIMEWA YOGYAKARTA",19,137,50,187
https://kawalpemilu.org#42142,"GEDANGREJO, KARANGMOJO, GUNUNGKIDUL, DAERAH ISTIMEWA YOGYAKARTA",20,80,47,127
https://kawalpemilu.org#42142,"GEDANGREJO, KARANGMOJO, GUNUNGKIDUL, DAERAH ISTIMEWA YOGYAKARTA",21,134,29,163
https://kawalpemilu.org#42142,"GEDANGREJO, KARANGMOJO, GUNUNGKIDUL, DAERAH ISTIMEWA YOGYAKARTA",22,140,26,166
https://kawalpemilu.org#42142,"GEDANGREJO, KARANGMOJO, GUNUNGKIDUL, DAERAH ISTIMEWA YOGYAKARTA",23,134,25,159
https://kawalpemilu.org#42142,"GEDANGREJO, KARANGMOJO, GUNUNGKIDUL, DAERAH ISTIMEWA YOGYAKARTA",24,155,31,186
https://kawalpemilu.org#42143,"NGAWIS, KARANGMOJO, GUNUNGKIDUL, DAERAH ISTIMEWA YOGYAKARTA",1,86,41,127
https://kawalpemilu.org#42143,"NGAWIS, KARANGMOJO, GUNUNGKIDUL, DAERAH ISTIMEWA YOGYAKARTA",2,98,31,129
https://kawalpemilu.org#42143,"NGAWIS, KARANGMOJO, GUNUNGKIDUL, DAERAH ISTIMEWA YOGYAKARTA",3,142,58,200
https://kawalpemilu.org#42143,"NGAWIS, KARANGMOJO, GUNUNGKIDUL, DAERAH ISTIMEWA YOGYAKARTA",4,73,24,97
https://kawalpemilu.org#42143,"NGAWIS, KARANGMOJO, GUNUNGKIDUL, DAERAH ISTIMEWA YOGYAKARTA",5,163,56,219
https://kawalpemilu.org#42143,"NGAWIS, KARANGMOJO, GUNUNGKIDUL, DAERAH ISTIMEWA YOGYAKARTA",6,131,24,155
https://kawalpemilu.org#42143,"NGAWIS, KARANGMOJO, GUNUNGKIDUL, DAERAH ISTIMEWA YOGYAKARTA",7,106,59,165
https://kawalpemilu.org#42143,"NGAWIS, KARANGMOJO, GUNUNGKIDUL, DAERAH ISTIMEWA YOGYAKARTA",8,80,44,124
https://kawalpemilu.org#42143,"NGAWIS, KARANGMOJO, GUNUNGKIDUL, DAERAH ISTIMEWA YOGYAKARTA",9,157,45,202
https://kawalpemilu.org#42143,"NGAWIS, KARANGMOJO, GUNUNGKIDUL, DAERAH ISTIMEWA YOGYAKARTA",10,175,63,238
https://kawalpemilu.org#42143,"NGAWIS, KARANGMOJO, GUNUNGKIDUL, DAERAH ISTIMEWA YOGYAKARTA",11,97,38,135
https://kawalpemilu.org#42143,"NGAWIS, KARANGMOJO, GUNUNGKIDUL, DAERAH ISTIMEWA YOGYAKARTA",12,72,50,122
https://kawalpemilu.org#42143,"NGAWIS, KARANGMOJO, GUNUNGKIDUL, DAERAH ISTIMEWA YOGYAKARTA",13,105,57,162
https://kawalpemilu.org#42143,"NGAWIS, KARANGMOJO, GUNUNGKIDUL, DAERAH ISTIMEWA YOGYAKARTA",14,39,80,119
https://kawalpemilu.org#42143,"NGAWIS, KARANGMOJO, GUNUNGKIDUL, DAERAH ISTIMEWA YOGYAKARTA",15,101,30,131
https://kawalpemilu.org#42143,"NGAWIS, KARANGMOJO, GUNUNGKIDUL, DAERAH ISTIMEWA YOGYAKARTA",16,121,31,152
https://kawalpemilu.org#42143,"NGAWIS, KARANGMOJO, GUNUNGKIDUL, DAERAH ISTIMEWA YOGYAKARTA",17,105,56,161
https://kawalpemilu.org#42144,"JATIAYU, KARANGMOJO, GUNUNGKIDUL, DAERAH ISTIMEWA YOGYAKARTA",1,165,23,188
https://kawalpemilu.org#42144,"JATIAYU, KARANGMOJO, GUNUNGKIDUL, DAERAH ISTIMEWA YOGYAKARTA",2,148,24,172
https://kawalpemilu.org#42144,"JATIAYU, KARANGMOJO, GUNUNGKIDUL, DAERAH ISTIMEWA YOGYAKARTA",3,143,54,197
https://kawalpemilu.org#42144,"JATIAYU, KARANGMOJO, GUNUNGKIDUL, DAERAH ISTIMEWA YOGYAKARTA",4,137,31,168
https://kawalpemilu.org#42144,"JATIAYU, KARANGMOJO, GUNUNGKIDUL, DAERAH ISTIMEWA YOGYAKARTA",5,176,38,214
https://kawalpemilu.org#42144,"JATIAYU, KARANGMOJO, GUNUNGKIDUL, DAERAH ISTIMEWA YOGYAKARTA",6,124,56,180
https://kawalpemilu.org#42144,"JATIAYU, KARANGMOJO, GUNUNGKIDUL, DAERAH ISTIMEWA YOGYAKARTA",7,121,31,152
https://kawalpemilu.org#42144,"JATIAYU, KARANGMOJO, GUNUNGKIDUL, DAERAH ISTIMEWA YOGYAKARTA",8,191,37,228
https://kawalpemilu.org#42144,"JATIAYU, KARANGMOJO, GUNUNGKIDUL, DAERAH ISTIMEWA YOGYAKARTA",9,162,48,210
https://kawalpemilu.org#42144,"JATIAYU, KARANGMOJO, GUNUNGKIDUL, DAERAH ISTIMEWA YOGYAKARTA",10,164,47,211
https://kawalpemilu.org#42144,"JATIAYU, KARANGMOJO, GUNUNGKIDUL, DAERAH ISTIMEWA YOGYAKARTA",11,174,36,210
https://kawalpemilu.org#42144,"JATIAYU, KARANGMOJO, GUNUNGKIDUL, DAERAH ISTIMEWA YOGYAKARTA",12,157,49,206
https://kawalpemilu.org#42144,"JATIAYU, KARANGMOJO, GUNUNGKIDUL, DAERAH ISTIMEWA YOGYAKARTA",13,122,63,185
https://kawalpemilu.org#42144,"JATIAYU, KARANGMOJO, GUNUNGKIDUL, DAERAH ISTIMEWA YOGYAKARTA",14,158,39,197
https://kawalpemilu.org#42144,"JATIAYU, KARANGMOJO, GUNUNGKIDUL, DAERAH ISTIMEWA YOGYAKARTA",15,158,34,192
https://kawalpemilu.org#42144,"JATIAYU, KARANGMOJO, GUNUNGKIDUL, DAERAH ISTIMEWA YOGYAKARTA",16,116,25,141
https://kawalpemilu.org#42144,"JATIAYU, KARANGMOJO, GUNUNGKIDUL, DAERAH ISTIMEWA YOGYAKARTA",17,97,31,128
https://kawalpemilu.org#42144,"JATIAYU, KARANGMOJO, GUNUNGKIDUL, DAERAH ISTIMEWA YOGYAKARTA",18,156,20,176
https://kawalpemilu.org#42144,"JATIAYU, KARANGMOJO, GUNUNGKIDUL, DAERAH ISTIMEWA YOGYAKARTA",19,165,38,203
https://kawalpemilu.org#42144,"JATIAYU, KARANGMOJO, GUNUNGKIDUL, DAERAH ISTIMEWA YOGYAKARTA",20,96,89,185
https://kawalpemilu.org#42144,"JATIAYU, KARANGMOJO, GUNUNGKIDUL, DAERAH ISTIMEWA YOGYAKARTA",21,100,61,161
https://kawalpemilu.org#42144,"JATIAYU, KARANGMOJO, GUNUNGKIDUL, DAERAH ISTIMEWA YOGYAKARTA",22,125,24,149
https://kawalpemilu.org#42144,"JATIAYU, KARANGMOJO, GUNUNGKIDUL, DAERAH ISTIMEWA YOGYAKARTA",23,113,24,137
https://kawalpemilu.org#42144,"JATIAYU, KARANGMOJO, GUNUNGKIDUL, DAERAH ISTIMEWA YOGYAKARTA",24,86,53,139
https://kawalpemilu.org#42144,"JATIAYU, KARANGMOJO, GUNUNGKIDUL, DAERAH ISTIMEWA YOGYAKARTA",25,145,23,168
https://kawalpemilu.org#42144,"JATIAYU, KARANGMOJO, GUNUNGKIDUL, DAERAH ISTIMEWA YOGYAKARTA",26,104,38,142
https://kawalpemilu.org#42146,"UMBULREJO, PONJONG, GUNUNGKIDUL, DAERAH ISTIMEWA YOGYAKARTA",1,88,29,117
https://kawalpemilu.org#42146,"UMBULREJO, PONJONG, GUNUNGKIDUL, DAERAH ISTIMEWA YOGYAKARTA",2,174,14,188
https://kawalpemilu.org#42146,"UMBULREJO, PONJONG, GUNUNGKIDUL, DAERAH ISTIMEWA YOGYAKARTA",3,82,15,97
https://kawalpemilu.org#42146,"UMBULREJO, PONJONG, GUNUNGKIDUL, DAERAH ISTIMEWA YOGYAKARTA",4,74,24,98
https://kawalpemilu.org#42146,"UMBULREJO, PONJONG, GUNUNGKIDUL, DAERAH ISTIMEWA YOGYAKARTA",5,93,68,161
https://kawalpemilu.org#42146,"UMBULREJO, PONJONG, GUNUNGKIDUL, DAERAH ISTIMEWA YOGYAKARTA",6,94,37,131
https://kawalpemilu.org#42146,"UMBULREJO, PONJONG, GUNUNGKIDUL, DAERAH ISTIMEWA YOGYAKARTA",7,98,19,117
https://kawalpemilu.org#42146,"UMBULREJO, PONJONG, GUNUNGKIDUL, DAERAH ISTIMEWA YOGYAKARTA",8,110,21,131
https://kawalpemilu.org#42146,"UMBULREJO, PONJONG, GUNUNGKIDUL, DAERAH ISTIMEWA YOGYAKARTA",9,57,10,67
https://kawalpemilu.org#42146,"UMBULREJO, PONJONG, GUNUNGKIDUL, DAERAH ISTIMEWA YOGYAKARTA",10,55,67,122
https://kawalpemilu.org#42146,"UMBULREJO, PONJONG, GUNUNGKIDUL, DAERAH ISTIMEWA YOGYAKARTA",11,97,29,126
https://kawalpemilu.org#42146,"UMBULREJO, PONJONG, GUNUNGKIDUL, DAERAH ISTIMEWA YOGYAKARTA",12,159,13,172
https://kawalpemilu.org#42146,"UMBULREJO, PONJONG, GUNUNGKIDUL, DAERAH ISTIMEWA YOGYAKARTA",13,111,17,128
https://kawalpemilu.org#42146,"UMBULREJO, PONJONG, GUNUNGKIDUL, DAERAH ISTIMEWA YOGYAKARTA",14,176,2,178
https://kawalpemilu.org#42146,"UMBULREJO, PONJONG, GUNUNGKIDUL, DAERAH ISTIMEWA YOGYAKARTA",15,82,25,107
https://kawalpemilu.org#42146,"UMBULREJO, PONJONG, GUNUNGKIDUL, DAERAH ISTIMEWA YOGYAKARTA",16,111,45,156
https://kawalpemilu.org#42146,"UMBULREJO, PONJONG, GUNUNGKIDUL, DAERAH ISTIMEWA YOGYAKARTA",17,85,68,153
https://kawalpemilu.org#42146,"UMBULREJO, PONJONG, GUNUNGKIDUL, DAERAH ISTIMEWA YOGYAKARTA",18,122,39,161
https://kawalpemilu.org#42146,"UMBULREJO, PONJONG, GUNUNGKIDUL, DAERAH ISTIMEWA YOGYAKARTA",19,172,18,190
https://kawalpemilu.org#42146,"UMBULREJO, PONJONG, GUNUNGKIDUL, DAERAH ISTIMEWA YOGYAKARTA",20,125,40,165
https://kawalpemilu.org#42146,"UMBULREJO, PONJONG, GUNUNGKIDUL, DAERAH ISTIMEWA YOGYAKARTA",21,178,28,206
https://kawalpemilu.org#42146,"UMBULREJO, PONJONG, GUNUNGKIDUL, DAERAH ISTIMEWA YOGYAKARTA",22,123,40,163
https://kawalpemilu.org#42146,"UMBULREJO, PONJONG, GUNUNGKIDUL, DAERAH ISTIMEWA YOGYAKARTA",23,113,20,133
https://kawalpemilu.org#42146,"UMBULREJO, PONJONG, GUNUNGKIDUL, DAERAH ISTIMEWA YOGYAKARTA",24,181,26,207
https://kawalpemilu.org#42146,"UMBULREJO, PONJONG, GUNUNGKIDUL, DAERAH ISTIMEWA YOGYAKARTA",25,188,20,208
https://kawalpemilu.org#42146,"UMBULREJO, PONJONG, GUNUNGKIDUL, DAERAH ISTIMEWA YOGYAKARTA",26,193,20,213
https://kawalpemilu.org#42146,"UMBULREJO, PONJONG, GUNUNGKIDUL, DAERAH ISTIMEWA YOGYAKARTA",27,123,19,142
https://kawalpemilu.org#42146,"UMBULREJO, PONJONG, GUNUNGKIDUL, DAERAH ISTIMEWA YOGYAKARTA",28,146,21,167
https://kawalpemilu.org#42146,"UMBULREJO, PONJONG, GUNUNGKIDUL, DAERAH ISTIMEWA YOGYAKARTA",29,147,14,161
https://kawalpemilu.org#42146,"UMBULREJO, PONJONG, GUNUNGKIDUL, DAERAH ISTIMEWA YOGYAKARTA",30,142,31,173
https://kawalpemilu.org#42146,"UMBULREJO, PONJONG, GUNUNGKIDUL, DAERAH ISTIMEWA YOGYAKARTA",31,59,65,124
https://kawalpemilu.org#42147,"SAWAHAN, PONJONG, GUNUNGKIDUL, DAERAH ISTIMEWA YOGYAKARTA",1,196,21,217
https://kawalpemilu.org#42147,"SAWAHAN, PONJONG, GUNUNGKIDUL, DAERAH ISTIMEWA YOGYAKARTA",2,98,8,106
https://kawalpemilu.org#42147,"SAWAHAN, PONJONG, GUNUNGKIDUL, DAERAH ISTIMEWA YOGYAKARTA",3,192,7,199
https://kawalpemilu.org#42147,"SAWAHAN, PONJONG, GUNUNGKIDUL, DAERAH ISTIMEWA YOGYAKARTA",4,120,25,145
https://kawalpemilu.org#42147,"SAWAHAN, PONJONG, GUNUNGKIDUL, DAERAH ISTIMEWA YOGYAKARTA",5,128,28,156
https://kawalpemilu.org#42147,"SAWAHAN, PONJONG, GUNUNGKIDUL, DAERAH ISTIMEWA YOGYAKARTA",6,85,21,106
https://kawalpemilu.org#42147,"SAWAHAN, PONJONG, GUNUNGKIDUL, DAERAH ISTIMEWA YOGYAKARTA",7,121,7,128
https://kawalpemilu.org#42147,"SAWAHAN, PONJONG, GUNUNGKIDUL, DAERAH ISTIMEWA YOGYAKARTA",8,139,22,161
https://kawalpemilu.org#42147,"SAWAHAN, PONJONG, GUNUNGKIDUL, DAERAH ISTIMEWA YOGYAKARTA",9,170,20,190
https://kawalpemilu.org#42147,"SAWAHAN, PONJONG, GUNUNGKIDUL, DAERAH ISTIMEWA YOGYAKARTA",10,82,17,99
https://kawalpemilu.org#42147,"SAWAHAN, PONJONG, GUNUNGKIDUL, DAERAH ISTIMEWA YOGYAKARTA",11,159,19,178
https://kawalpemilu.org#42147,"SAWAHAN, PONJONG, GUNUNGKIDUL, DAERAH ISTIMEWA YOGYAKARTA",12,89,27,116
https://kawalpemilu.org#42147,"SAWAHAN, PONJONG, GUNUNGKIDUL, DAERAH ISTIMEWA YOGYAKARTA",13,92,8,100
https://kawalpemilu.org#42147,"SAWAHAN, PONJONG, GUNUNGKIDUL, DAERAH ISTIMEWA YOGYAKARTA",14,75,31,106
https://kawalpemilu.org#42147,"SAWAHAN, PONJONG, GUNUNGKIDUL, DAERAH ISTIMEWA YOGYAKARTA",15,106,24,130
https://kawalpemilu.org#42147,"SAWAHAN, PONJONG, GUNUNGKIDUL, DAERAH ISTIMEWA YOGYAKARTA",16,128,45,173
https://kawalpemilu.org#42147,"SAWAHAN, PONJONG, GUNUNGKIDUL, DAERAH ISTIMEWA YOGYAKARTA",17,123,30,153
https://kawalpemilu.org#42147,"SAWAHAN, PONJONG, GUNUNGKIDUL, DAERAH ISTIMEWA YOGYAKARTA",18,128,15,143
https://kawalpemilu.org#42147,"SAWAHAN, PONJONG, GUNUNGKIDUL, DAERAH ISTIMEWA YOGYAKARTA",19,199,11,210
https://kawalpemilu.org#42147,"SAWAHAN, PONJONG, GUNUNGKIDUL, DAERAH ISTIMEWA YOGYAKARTA",20,131,16,147
https://kawalpemilu.org#42147,"SAWAHAN, PONJONG, GUNUNGKIDUL, DAERAH ISTIMEWA YOGYAKARTA",21,115,17,132
https://kawalpemilu.org#42147,"SAWAHAN, PONJONG, GUNUNGKIDUL, DAERAH ISTIMEWA YOGYAKARTA",22,99,12,111
https://kawalpemilu.org#42147,"SAWAHAN, PONJONG, GUNUNGKIDUL, DAERAH ISTIMEWA YOGYAKARTA",23,92,17,109
https://kawalpemilu.org#42147,"SAWAHAN, PONJONG, GUNUNGKIDUL, DAERAH ISTIMEWA YOGYAKARTA",24,126,20,146
https://kawalpemilu.org#42147,"SAWAHAN, PONJONG, GUNUNGKIDUL, DAERAH ISTIMEWA YOGYAKARTA",25,131,11,142
https://kawalpemilu.org#42148,"TAMBAKROMO, PONJONG, GUNUNGKIDUL, DAERAH ISTIMEWA YOGYAKARTA",1,173,36,209
https://kawalpemilu.org#42148,"TAMBAKROMO, PONJONG, GUNUNGKIDUL, DAERAH ISTIMEWA YOGYAKARTA",2,95,32,127
https://kawalpemilu.org#42148,"TAMBAKROMO, PONJONG, GUNUNGKIDUL, DAERAH ISTIMEWA YOGYAKARTA",3,181,35,216
https://kawalpemilu.org#42148,"TAMBAKROMO, PONJONG, GUNUNGKIDUL, DAERAH ISTIMEWA YOGYAKARTA",4,135,28,163
https://kawalpemilu.org#42148,"TAMBAKROMO, PONJONG, GUNUNGKIDUL, DAERAH ISTIMEWA YOGYAKARTA",5,132,73,205
https://kawalpemilu.org#42148,"TAMBAKROMO, PONJONG, GUNUNGKIDUL, DAERAH ISTIMEWA YOGYAKARTA",6,194,11,205
https://kawalpemilu.org#42148,"TAMBAKROMO, PONJONG, GUNUNGKIDUL, DAERAH ISTIMEWA YOGYAKARTA",7,147,17,164
https://kawalpemilu.org#42148,"TAMBAKROMO, PONJONG, GUNUNGKIDUL, DAERAH ISTIMEWA YOGYAKARTA",8,168,30,198
https://kawalpemilu.org#42148,"TAMBAKROMO, PONJONG, GUNUNGKIDUL, DAERAH ISTIMEWA YOGYAKARTA",9,151,12,163
https://kawalpemilu.org#42148,"TAMBAKROMO, PONJONG, GUNUNGKIDUL, DAERAH ISTIMEWA YOGYAKARTA",10,163,37,200
https://kawalpemilu.org#42148,"TAMBAKROMO, PONJONG, GUNUNGKIDUL, DAERAH ISTIMEWA YOGYAKARTA",11,162,32,194
https://kawalpemilu.org#42148,"TAMBAKROMO, PONJONG, GUNUNGKIDUL, DAERAH ISTIMEWA YOGYAKARTA",12,84,19,103
https://kawalpemilu.org#42148,"TAMBAKROMO, PONJONG, GUNUNGKIDUL, DAERAH ISTIMEWA YOGYAKARTA",13,101,27,128
https://kawalpemilu.org#42148,"TAMBAKROMO, PONJONG, GUNUNGKIDUL, DAERAH ISTIMEWA YOGYAKARTA",14,113,16,129
https://kawalpemilu.org#42148,"TAMBAKROMO, PONJONG, GUNUNGKIDUL, DAERAH ISTIMEWA YOGYAKARTA",15,161,7,168
https://kawalpemilu.org#42148,"TAMBAKROMO, PONJONG, GUNUNGKIDUL, DAERAH ISTIMEWA YOGYAKARTA",16,130,20,150
https://kawalpemilu.org#42149,"KENTENG, PONJONG, GUNUNGKIDUL, DAERAH ISTIMEWA YOGYAKARTA",1,131,19,150
https://kawalpemilu.org#42149,"KENTENG, PONJONG, GUNUNGKIDUL, DAERAH ISTIMEWA YOGYAKARTA",2,140,35,175
https://kawalpemilu.org#42149,"KENTENG, PONJONG, GUNUNGKIDUL, DAERAH ISTIMEWA YOGYAKARTA",3,235,17,252
https://kawalpemilu.org#42149,"KENTENG, PONJONG, GUNUNGKIDUL, DAERAH ISTIMEWA YOGYAKARTA",4,208,11,219
https://kawalpemilu.org#42149,"KENTENG, PONJONG, GUNUNGKIDUL, DAERAH ISTIMEWA YOGYAKARTA",5,175,9,184
https://kawalpemilu.org#42149,"KENTENG, PONJONG, GUNUNGKIDUL, DAERAH ISTIMEWA YOGYAKARTA",6,158,33,191
https://kawalpemilu.org#42149,"KENTENG, PONJONG, GUNUNGKIDUL, DAERAH ISTIMEWA YOGYAKARTA",7,197,13,210
https://kawalpemilu.org#42149,"KENTENG, PONJONG, GUNUNGKIDUL, DAERAH ISTIMEWA YOGYAKARTA",8,167,30,197
https://kawalpemilu.org#42149,"KENTENG, PONJONG, GUNUNGKIDUL, DAERAH ISTIMEWA YOGYAKARTA",9,199,21,220
https://kawalpemilu.org#42149,"KENTENG, PONJONG, GUNUNGKIDUL, DAERAH ISTIMEWA YOGYAKARTA",10,138,17,155
https://kawalpemilu.org#42149,"KENTENG, PONJONG, GUNUNGKIDUL, DAERAH ISTIMEWA YOGYAKARTA",11,92,34,126
https://kawalpemilu.org#42149,"KENTENG, PONJONG, GUNUNGKIDUL, DAERAH ISTIMEWA YOGYAKARTA",12,133,23,156
https://kawalpemilu.org#42150,"SUMBERGIRI, PONJONG, GUNUNGKIDUL, DAERAH ISTIMEWA YOGYAKARTA",1,137,41,178
https://kawalpemilu.org#42150,"SUMBERGIRI, PONJONG, GUNUNGKIDUL, DAERAH ISTIMEWA YOGYAKARTA",2,155,17,172
https://kawalpemilu.org#42150,"SUMBERGIRI, PONJONG, GUNUNGKIDUL, DAERAH ISTIMEWA YOGYAKARTA",3,119,6,125
https://kawalpemilu.org#42150,"SUMBERGIRI, PONJONG, GUNUNGKIDUL, DAERAH ISTIMEWA YOGYAKARTA",4,105,22,127
https://kawalpemilu.org#42150,"SUMBERGIRI, PONJONG, GUNUNGKIDUL, DAERAH ISTIMEWA YOGYAKARTA",5,193,38,231
https://kawalpemilu.org#42150,"SUMBERGIRI, PONJONG, GUNUNGKIDUL, DAERAH ISTIMEWA YOGYAKARTA",6,109,36,145
https://kawalpemilu.org#42150,"SUMBERGIRI, PONJONG, GUNUNGKIDUL, DAERAH ISTIMEWA YOGYAKARTA",7,99,40,139
https://kawalpemilu.org#42150,"SUMBERGIRI, PONJONG, GUNUNGKIDUL, DAERAH ISTIMEWA YOGYAKARTA",8,106,63,169
https://kawalpemilu.org#42150,"SUMBERGIRI, PONJONG, GUNUNGKIDUL, DAERAH ISTIMEWA YOGYAKARTA",9,108,32,140
https://kawalpemilu.org#42150,"SUMBERGIRI, PONJONG, GUNUNGKIDUL, DAERAH ISTIMEWA YOGYAKARTA",10,88,96,184
https://kawalpemilu.org#42150,"SUMBERGIRI, PONJONG, GUNUNGKIDUL, DAERAH ISTIMEWA YOGYAKARTA",11,133,37,170
https://kawalpemilu.org#42150,"SUMBERGIRI, PONJONG, GUNUNGKIDUL, DAERAH ISTIMEWA YOGYAKARTA",12,124,12,136
https://kawalpemilu.org#42150,"SUMBERGIRI, PONJONG, GUNUNGKIDUL, DAERAH ISTIMEWA YOGYAKARTA",13,107,26,133
https://kawalpemilu.org#42150,"SUMBERGIRI, PONJONG, GUNUNGKIDUL, DAERAH ISTIMEWA YOGYAKARTA",14,93,7,100
https://kawalpemilu.org#42150,"SUMBERGIRI, PONJONG, GUNUNGKIDUL, DAERAH ISTIMEWA YOGYAKARTA",15,63,93,156
https://kawalpemilu.org#42150,"SUMBERGIRI, PONJONG, GUNUNGKIDUL, DAERAH ISTIMEWA YOGYAKARTA",16,68,26,94
https://kawalpemilu.org#42150,"SUMBERGIRI, PONJONG, GUNUNGKIDUL, DAERAH ISTIMEWA YOGYAKARTA",17,63,94,157
https://kawalpemilu.org#42150,"SUMBERGIRI, PONJONG, GUNUNGKIDUL, DAERAH ISTIMEWA YOGYAKARTA",18,61,38,99
https://kawalpemilu.org#42150,"SUMBERGIRI, PONJONG, GUNUNGKIDUL, DAERAH ISTIMEWA YOGYAKARTA",19,94,75,169
https://kawalpemilu.org#42150,"SUMBERGIRI, PONJONG, GUNUNGKIDUL, DAERAH ISTIMEWA YOGYAKARTA",20,150,38,188
https://kawalpemilu.org#42151,"GENJAHAN, PONJONG, GUNUNGKIDUL, DAERAH ISTIMEWA YOGYAKARTA",1,98,28,126
https://kawalpemilu.org#42151,"GENJAHAN, PONJONG, GUNUNGKIDUL, DAERAH ISTIMEWA YOGYAKARTA",2,90,46,136
https://kawalpemilu.org#42151,"GENJAHAN, PONJONG, GUNUNGKIDUL, DAERAH ISTIMEWA YOGYAKARTA",3,139,42,181
https://kawalpemilu.org#42151,"GENJAHAN, PONJONG, GUNUNGKIDUL, DAERAH ISTIMEWA YOGYAKARTA",4,156,43,199
https://kawalpemilu.org#42151,"GENJAHAN, PONJONG, GUNUNGKIDUL, DAERAH ISTIMEWA YOGYAKARTA",5,102,50,152
https://kawalpemilu.org#42151,"GENJAHAN, PONJONG, GUNUNGKIDUL, DAERAH ISTIMEWA YOGYAKARTA",6,82,74,4
https://kawalpemilu.org#42151,"GENJAHAN, PONJONG, GUNUNGKIDUL, DAERAH ISTIMEWA YOGYAKARTA",7,124,29,153
https://kawalpemilu.org#42151,"GENJAHAN, PONJONG, GUNUNGKIDUL, DAERAH ISTIMEWA YOGYAKARTA",8,153,69,222
https://kawalpemilu.org#42151,"GENJAHAN, PONJONG, GUNUNGKIDUL, DAERAH ISTIMEWA YOGYAKARTA",9,118,64,182
https://kawalpemilu.org#42151,"GENJAHAN, PONJONG, GUNUNGKIDUL, DAERAH ISTIMEWA YOGYAKARTA",10,158,40,198
https://kawalpemilu.org#42151,"GENJAHAN, PONJONG, GUNUNGKIDUL, DAERAH ISTIMEWA YOGYAKARTA",11,132,30,162
https://kawalpemilu.org#42151,"GENJAHAN, PONJONG, GUNUNGKIDUL, DAERAH ISTIMEWA YOGYAKARTA",12,92,40,132
https://kawalpemilu.org#42151,"GENJAHAN, PONJONG, GUNUNGKIDUL, DAERAH ISTIMEWA YOGYAKARTA",13,125,21,146
https://kawalpemilu.org#42151,"GENJAHAN, PONJONG, GUNUNGKIDUL, DAERAH ISTIMEWA YOGYAKARTA",14,119,39,158
https://kawalpemilu.org#42151,"GENJAHAN, PONJONG, GUNUNGKIDUL, DAERAH ISTIMEWA YOGYAKARTA",15,109,12,121
https://kawalpemilu.org#42151,"GENJAHAN, PONJONG, GUNUNGKIDUL, DAERAH ISTIMEWA YOGYAKARTA",16,132,36,168
https://kawalpemilu.org#42151,"GENJAHAN, PONJONG, GUNUNGKIDUL, DAERAH ISTIMEWA YOGYAKARTA",17,109,40,149
https://kawalpemilu.org#42151,"GENJAHAN, PONJONG, GUNUNGKIDUL, DAERAH ISTIMEWA YOGYAKARTA",18,93,59,152
https://kawalpemilu.org#42151,"GENJAHAN, PONJONG, GUNUNGKIDUL, DAERAH ISTIMEWA YOGYAKARTA",19,76,39,115
https://kawalpemilu.org#42151,"GENJAHAN, PONJONG, GUNUNGKIDUL, DAERAH ISTIMEWA YOGYAKARTA",20,109,19,128
https://kawalpemilu.org#42151,"GENJAHAN, PONJONG, GUNUNGKIDUL, DAERAH ISTIMEWA YOGYAKARTA",21,92,51,143
https://kawalpemilu.org#42151,"GENJAHAN, PONJONG, GUNUNGKIDUL, DAERAH ISTIMEWA YOGYAKARTA",22,125,47,172
https://kawalpemilu.org#42151,"GENJAHAN, PONJONG, GUNUNGKIDUL, DAERAH ISTIMEWA YOGYAKARTA",23,137,27,164
https://kawalpemilu.org#42151,"GENJAHAN, PONJONG, GUNUNGKIDUL, DAERAH ISTIMEWA YOGYAKARTA",24,116,39,155
https://kawalpemilu.org#42152,"PONJONG, PONJONG, GUNUNGKIDUL, DAERAH ISTIMEWA YOGYAKARTA",1,73,50,123
https://kawalpemilu.org#42152,"PONJONG, PONJONG, GUNUNGKIDUL, DAERAH ISTIMEWA YOGYAKARTA",2,98,114,212
https://kawalpemilu.org#42152,"PONJONG, PONJONG, GUNUNGKIDUL, DAERAH ISTIMEWA YOGYAKARTA",3,105,74,179
https://kawalpemilu.org#42152,"PONJONG, PONJONG, GUNUNGKIDUL, DAERAH ISTIMEWA YOGYAKARTA",4,81,88,169
https://kawalpemilu.org#42152,"PONJONG, PONJONG, GUNUNGKIDUL, DAERAH ISTIMEWA YOGYAKARTA",5,64,90,154
https://kawalpemilu.org#42152,"PONJONG, PONJONG, GUNUNGKIDUL, DAERAH ISTIMEWA YOGYAKARTA",6,79,25,104
https://kawalpemilu.org#42152,"PONJONG, PONJONG, GUNUNGKIDUL, DAERAH ISTIMEWA YOGYAKARTA",7,77,58,135
https://kawalpemilu.org#42152,"PONJONG, PONJONG, GUNUNGKIDUL, DAERAH ISTIMEWA YOGYAKARTA",8,79,47,126
https://kawalpemilu.org#42152,"PONJONG, PONJONG, GUNUNGKIDUL, DAERAH ISTIMEWA YOGYAKARTA",9,116,36,152
https://kawalpemilu.org#42152,"PONJONG, PONJONG, GUNUNGKIDUL, DAERAH ISTIMEWA YOGYAKARTA",10,36,99,135
https://kawalpemilu.org#42152,"PONJONG, PONJONG, GUNUNGKIDUL, DAERAH ISTIMEWA YOGYAKARTA",11,68,86,154
https://kawalpemilu.org#42152,"PONJONG, PONJONG, GUNUNGKIDUL, DAERAH ISTIMEWA YOGYAKARTA",12,106,45,151
https://kawalpemilu.org#42152,"PONJONG, PONJONG, GUNUNGKIDUL, DAERAH ISTIMEWA YOGYAKARTA",13,84,36,120
https://kawalpemilu.org#42152,"PONJONG, PONJONG, GUNUNGKIDUL, DAERAH ISTIMEWA YOGYAKARTA",14,79,65,144
https://kawalpemilu.org#42152,"PONJONG, PONJONG, GUNUNGKIDUL, DAERAH ISTIMEWA YOGYAKARTA",15,85,61,146
https://kawalpemilu.org#42152,"PONJONG, PONJONG, GUNUNGKIDUL, DAERAH ISTIMEWA YOGYAKARTA",16,80,68,148
https://kawalpemilu.org#42152,"PONJONG, PONJONG, GUNUNGKIDUL, DAERAH ISTIMEWA YOGYAKARTA",17,76,31,107
https://kawalpemilu.org#42152,"PONJONG, PONJONG, GUNUNGKIDUL, DAERAH ISTIMEWA YOGYAKARTA",18,87,29,116
https://kawalpemilu.org#42152,"PONJONG, PONJONG, GUNUNGKIDUL, DAERAH ISTIMEWA YOGYAKARTA",19,94,56,150
https://kawalpemilu.org#42152,"PONJONG, PONJONG, GUNUNGKIDUL, DAERAH ISTIMEWA YOGYAKARTA",20,100,42,142
https://kawalpemilu.org#42152,"PONJONG, PONJONG, GUNUNGKIDUL, DAERAH ISTIMEWA YOGYAKARTA",21,107,31,138
https://kawalpemilu.org#42152,"PONJONG, PONJONG, GUNUNGKIDUL, DAERAH ISTIMEWA YOGYAKARTA",22,97,53,150
https://kawalpemilu.org#42152,"PONJONG, PONJONG, GUNUNGKIDUL, DAERAH ISTIMEWA YOGYAKARTA",23,51,64,115
https://kawalpemilu.org#42153,"KARANGASEM, PONJONG, GUNUNGKIDUL, DAERAH ISTIMEWA YOGYAKARTA",1,86,43,129
https://kawalpemilu.org#42153,"KARANGASEM, PONJONG, GUNUNGKIDUL, DAERAH ISTIMEWA YOGYAKARTA",2,83,31,114
https://kawalpemilu.org#42153,"KARANGASEM, PONJONG, GUNUNGKIDUL, DAERAH ISTIMEWA YOGYAKARTA",3,138,24,162
https://kawalpemilu.org#42153,"KARANGASEM, PONJONG, GUNUNGKIDUL, DAERAH ISTIMEWA YOGYAKARTA",4,192,12,204
https://kawalpemilu.org#42153,"KARANGASEM, PONJONG, GUNUNGKIDUL, DAERAH ISTIMEWA YOGYAKARTA",5,191,36,227
https://kawalpemilu.org#42153,"KARANGASEM, PONJONG, GUNUNGKIDUL, DAERAH ISTIMEWA YOGYAKARTA",6,157,24,181
https://kawalpemilu.org#42153,"KARANGASEM, PONJONG, GUNUNGKIDUL, DAERAH ISTIMEWA YOGYAKARTA",7,200,22,222
https://kawalpemilu.org#42153,"KARANGASEM, PONJONG, GUNUNGKIDUL, DAERAH ISTIMEWA YOGYAKARTA",8,158,26,184
https://kawalpemilu.org#42153,"KARANGASEM, PONJONG, GUNUNGKIDUL, DAERAH ISTIMEWA YOGYAKARTA",9,98,34,132
https://kawalpemilu.org#42153,"KARANGASEM, PONJONG, GUNUNGKIDUL, DAERAH ISTIMEWA YOGYAKARTA",10,151,20,171
https://kawalpemilu.org#42154,"BEDOYO, PONJONG, GUNUNGKIDUL, DAERAH ISTIMEWA YOGYAKARTA",1,166,38,204
https://kawalpemilu.org#42154,"BEDOYO, PONJONG, GUNUNGKIDUL, DAERAH ISTIMEWA YOGYAKARTA",2,191,48,239
https://kawalpemilu.org#42154,"BEDOYO, PONJONG, GUNUNGKIDUL, DAERAH ISTIMEWA YOGYAKARTA",3,117,29,146
https://kawalpemilu.org#42154,"BEDOYO, PONJONG, GUNUNGKIDUL, DAERAH ISTIMEWA YOGYAKARTA",4,135,46,181
https://kawalpemilu.org#42154,"BEDOYO, PONJONG, GUNUNGKIDUL, DAERAH ISTIMEWA YOGYAKARTA",5,74,56,130
https://kawalpemilu.org#42154,"BEDOYO, PONJONG, GUNUNGKIDUL, DAERAH ISTIMEWA YOGYAKARTA",6,154,49,203
https://kawalpemilu.org#42154,"BEDOYO, PONJONG, GUNUNGKIDUL, DAERAH ISTIMEWA YOGYAKARTA",7,127,38,165
https://kawalpemilu.org#42154,"BEDOYO, PONJONG, GUNUNGKIDUL, DAERAH ISTIMEWA YOGYAKARTA",8,133,54,187
https://kawalpemilu.org#42154,"BEDOYO, PONJONG, GUNUNGKIDUL, DAERAH ISTIMEWA YOGYAKARTA",9,184,52,236
https://kawalpemilu.org#42154,"BEDOYO, PONJONG, GUNUNGKIDUL, DAERAH ISTIMEWA YOGYAKARTA",10,140,25,165
https://kawalpemilu.org#42154,"BEDOYO, PONJONG, GUNUNGKIDUL, DAERAH ISTIMEWA YOGYAKARTA",11,87,38,125
https://kawalpemilu.org#42154,"BEDOYO, PONJONG, GUNUNGKIDUL, DAERAH ISTIMEWA YOGYAKARTA",12,196,48,244
https://kawalpemilu.org#42154,"BEDOYO, PONJONG, GUNUNGKIDUL, DAERAH ISTIMEWA YOGYAKARTA",13,153,26,179
https://kawalpemilu.org#42154,"BEDOYO, PONJONG, GUNUNGKIDUL, DAERAH ISTIMEWA YOGYAKARTA",14,154,45,199
https://kawalpemilu.org#42154,"BEDOYO, PONJONG, GUNUNGKIDUL, DAERAH ISTIMEWA YOGYAKARTA",15,107,20,127
https://kawalpemilu.org#42155,"SIDOREJO, PONJONG, GUNUNGKIDUL, DAERAH ISTIMEWA YOGYAKARTA",1,169,16,185
https://kawalpemilu.org#42155,"SIDOREJO, PONJONG, GUNUNGKIDUL, DAERAH ISTIMEWA YOGYAKARTA",2,145,24,169
https://kawalpemilu.org#42155,"SIDOREJO, PONJONG, GUNUNGKIDUL, DAERAH ISTIMEWA YOGYAKARTA",3,203,27,230
https://kawalpemilu.org#42155,"SIDOREJO, PONJONG, GUNUNGKIDUL, DAERAH ISTIMEWA YOGYAKARTA",4,167,14,181
https://kawalpemilu.org#42155,"SIDOREJO, PONJONG, GUNUNGKIDUL, DAERAH ISTIMEWA YOGYAKARTA",5,113,15,128
https://kawalpemilu.org#42155,"SIDOREJO, PONJONG, GUNUNGKIDUL, DAERAH ISTIMEWA YOGYAKARTA",6,148,41,189
https://kawalpemilu.org#42155,"SIDOREJO, PONJONG, GUNUNGKIDUL, DAERAH ISTIMEWA YOGYAKARTA",7,172,29,201
https://kawalpemilu.org#42155,"SIDOREJO, PONJONG, GUNUNGKIDUL, DAERAH ISTIMEWA YOGYAKARTA",8,184,31,215
https://kawalpemilu.org#42155,"SIDOREJO, PONJONG, GUNUNGKIDUL, DAERAH ISTIMEWA YOGYAKARTA",9,140,45,185
https://kawalpemilu.org#42155,"SIDOREJO, PONJONG, GUNUNGKIDUL, DAERAH ISTIMEWA YOGYAKARTA",10,173,54,227
https://kawalpemilu.org#42155,"SIDOREJO, PONJONG, GUNUNGKIDUL, DAERAH ISTIMEWA YOGYAKARTA",11,81,36,117
https://kawalpemilu.org#42155,"SIDOREJO, PONJONG, GUNUNGKIDUL, DAERAH ISTIMEWA YOGYAKARTA",12,102,23,125
https://kawalpemilu.org#42155,"SIDOREJO, PONJONG, GUNUNGKIDUL, DAERAH ISTIMEWA YOGYAKARTA",13,77,48,125
https://kawalpemilu.org#42155,"SIDOREJO, PONJONG, GUNUNGKIDUL, DAERAH ISTIMEWA YOGYAKARTA",14,139,40,179
https://kawalpemilu.org#42155,"SIDOREJO, PONJONG, GUNUNGKIDUL, DAERAH ISTIMEWA YOGYAKARTA",15,131,64,195
https://kawalpemilu.org#42155,"SIDOREJO, PONJONG, GUNUNGKIDUL, DAERAH ISTIMEWA YOGYAKARTA",16,152,16,168
https://kawalpemilu.org#42155,"SIDOREJO, PONJONG, GUNUNGKIDUL, DAERAH ISTIMEWA YOGYAKARTA",17,186,39,225
https://kawalpemilu.org#42155,"SIDOREJO, PONJONG, GUNUNGKIDUL, DAERAH ISTIMEWA YOGYAKARTA",18,117,14,131
https://kawalpemilu.org#42155,"SIDOREJO, PONJONG, GUNUNGKIDUL, DAERAH ISTIMEWA YOGYAKARTA",19,149,17,166
https://kawalpemilu.org#42155,"SIDOREJO, PONJONG, GUNUNGKIDUL, DAERAH ISTIMEWA YOGYAKARTA",20,185,35,220
https://kawalpemilu.org#42155,"SIDOREJO, PONJONG, GUNUNGKIDUL, DAERAH ISTIMEWA YOGYAKARTA",21,148,32,180
https://kawalpemilu.org#42155,"SIDOREJO, PONJONG, GUNUNGKIDUL, DAERAH ISTIMEWA YOGYAKARTA",22,153,20,173
https://kawalpemilu.org#42155,"SIDOREJO, PONJONG, GUNUNGKIDUL, DAERAH ISTIMEWA YOGYAKARTA",23,144,36,180
https://kawalpemilu.org#42155,"SIDOREJO, PONJONG, GUNUNGKIDUL, DAERAH ISTIMEWA YOGYAKARTA",24,162,56,218
https://kawalpemilu.org#42155,"SIDOREJO, PONJONG, GUNUNGKIDUL, DAERAH ISTIMEWA YOGYAKARTA",25,208,29,237
https://kawalpemilu.org#42155,"SIDOREJO, PONJONG, GUNUNGKIDUL, DAERAH ISTIMEWA YOGYAKARTA",26,109,14,123
https://kawalpemilu.org#42155,"SIDOREJO, PONJONG, GUNUNGKIDUL, DAERAH ISTIMEWA YOGYAKARTA",27,136,16,152
https://kawalpemilu.org#42155,"SIDOREJO, PONJONG, GUNUNGKIDUL, DAERAH ISTIMEWA YOGYAKARTA",28,150,5,155
https://kawalpemilu.org#42155,"SIDOREJO, PONJONG, GUNUNGKIDUL, DAERAH ISTIMEWA YOGYAKARTA",29,175,22,197
https://kawalpemilu.org#42155,"SIDOREJO, PONJONG, GUNUNGKIDUL, DAERAH ISTIMEWA YOGYAKARTA",30,167,37,204
https://kawalpemilu.org#42155,"SIDOREJO, PONJONG, GUNUNGKIDUL, DAERAH ISTIMEWA YOGYAKARTA",31,107,37,144
https://kawalpemilu.org#42155,"SIDOREJO, PONJONG, GUNUNGKIDUL, DAERAH ISTIMEWA YOGYAKARTA",32,88,32,120
https://kawalpemilu.org#42155,"SIDOREJO, PONJONG, GUNUNGKIDUL, DAERAH ISTIMEWA YOGYAKARTA",33,138,18,156
https://kawalpemilu.org#42155,"SIDOREJO, PONJONG, GUNUNGKIDUL, DAERAH ISTIMEWA YOGYAKARTA",34,146,9,155
https://kawalpemilu.org#42155,"SIDOREJO, PONJONG, GUNUNGKIDUL, DAERAH ISTIMEWA YOGYAKARTA",35,115,15,130
https://kawalpemilu.org#42156,"GOMBANG, PONJONG, GUNUNGKIDUL, DAERAH ISTIMEWA YOGYAKARTA",1,201,25,226
https://kawalpemilu.org#42156,"GOMBANG, PONJONG, GUNUNGKIDUL, DAERAH ISTIMEWA YOGYAKARTA",2,107,14,121
https://kawalpemilu.org#42156,"GOMBANG, PONJONG, GUNUNGKIDUL, DAERAH ISTIMEWA YOGYAKARTA",3,190,29,219
https://kawalpemilu.org#42156,"GOMBANG, PONJONG, GUNUNGKIDUL, DAERAH ISTIMEWA YOGYAKARTA",4,174,13,187
https://kawalpemilu.org#42156,"GOMBANG, PONJONG, GUNUNGKIDUL, DAERAH ISTIMEWA YOGYAKARTA",5,151,23,174
https://kawalpemilu.org#42156,"GOMBANG, PONJONG, GUNUNGKIDUL, DAERAH ISTIMEWA YOGYAKARTA",6,141,35,176
https://kawalpemilu.org#42156,"GOMBANG, PONJONG, GUNUNGKIDUL, DAERAH ISTIMEWA YOGYAKARTA",7,129,67,196
https://kawalpemilu.org#42156,"GOMBANG, PONJONG, GUNUNGKIDUL, DAERAH ISTIMEWA YOGYAKARTA",8,176,40,216
https://kawalpemilu.org#42156,"GOMBANG, PONJONG, GUNUNGKIDUL, DAERAH ISTIMEWA YOGYAKARTA",9,152,52,204
https://kawalpemilu.org#42156,"GOMBANG, PONJONG, GUNUNGKIDUL, DAERAH ISTIMEWA YOGYAKARTA",10,104,20,124
https://kawalpemilu.org#42156,"GOMBANG, PONJONG, GUNUNGKIDUL, DAERAH ISTIMEWA YOGYAKARTA",11,115,16,131
https://kawalpemilu.org#42156,"GOMBANG, PONJONG, GUNUNGKIDUL, DAERAH ISTIMEWA YOGYAKARTA",12,122,23,145
https://kawalpemilu.org#42158,"BOHOL, RONGKOP, GUNUNGKIDUL, DAERAH ISTIMEWA YOGYAKARTA",1,89,29,118
https://kawalpemilu.org#42158,"BOHOL, RONGKOP, GUNUNGKIDUL, DAERAH ISTIMEWA YOGYAKARTA",2,77,45,122
https://kawalpemilu.org#42158,"BOHOL, RONGKOP, GUNUNGKIDUL, DAERAH ISTIMEWA YOGYAKARTA",3,130,26,156
https://kawalpemilu.org#42158,"BOHOL, RONGKOP, GUNUNGKIDUL, DAERAH ISTIMEWA YOGYAKARTA",4,118,27,145
https://kawalpemilu.org#42158,"BOHOL, RONGKOP, GUNUNGKIDUL, DAERAH ISTIMEWA YOGYAKARTA",5,110,24,134
https://kawalpemilu.org#42158,"BOHOL, RONGKOP, GUNUNGKIDUL, DAERAH ISTIMEWA YOGYAKARTA",6,195,33,228
https://kawalpemilu.org#42159,"PRINGOMBO, RONGKOP, GUNUNGKIDUL, DAERAH ISTIMEWA YOGYAKARTA",1,166,25,191
https://kawalpemilu.org#42159,"PRINGOMBO, RONGKOP, GUNUNGKIDUL, DAERAH ISTIMEWA YOGYAKARTA",2,157,62,219
https://kawalpemilu.org#42159,"PRINGOMBO, RONGKOP, GUNUNGKIDUL, DAERAH ISTIMEWA YOGYAKARTA",3,100,41,141
https://kawalpemilu.org#42159,"PRINGOMBO, RONGKOP, GUNUNGKIDUL, DAERAH ISTIMEWA YOGYAKARTA",4,121,39,160
https://kawalpemilu.org#42159,"PRINGOMBO, RONGKOP, GUNUNGKIDUL, DAERAH ISTIMEWA YOGYAKARTA",5,171,41,212
https://kawalpemilu.org#42159,"PRINGOMBO, RONGKOP, GUNUNGKIDUL, DAERAH ISTIMEWA YOGYAKARTA",6,176,20,196
https://kawalpemilu.org#42159,"PRINGOMBO, RONGKOP, GUNUNGKIDUL, DAERAH ISTIMEWA YOGYAKARTA",7,160,14,174
https://kawalpemilu.org#42159,"PRINGOMBO, RONGKOP, GUNUNGKIDUL, DAERAH ISTIMEWA YOGYAKARTA",8,122,17,139
https://kawalpemilu.org#42159,"PRINGOMBO, RONGKOP, GUNUNGKIDUL, DAERAH ISTIMEWA YOGYAKARTA",9,110,40,150
https://kawalpemilu.org#42159,"PRINGOMBO, RONGKOP, GUNUNGKIDUL, DAERAH ISTIMEWA YOGYAKARTA",10,139,20,159
https://kawalpemilu.org#42159,"PRINGOMBO, RONGKOP, GUNUNGKIDUL, DAERAH ISTIMEWA YOGYAKARTA",11,118,10,128
https://kawalpemilu.org#42159,"PRINGOMBO, RONGKOP, GUNUNGKIDUL, DAERAH ISTIMEWA YOGYAKARTA",12,185,9,194
https://kawalpemilu.org#42159,"PRINGOMBO, RONGKOP, GUNUNGKIDUL, DAERAH ISTIMEWA YOGYAKARTA",13,108,7,115
https://kawalpemilu.org#42159,"PRINGOMBO, RONGKOP, GUNUNGKIDUL, DAERAH ISTIMEWA YOGYAKARTA",14,121,11,132
https://kawalpemilu.org#42159,"PRINGOMBO, RONGKOP, GUNUNGKIDUL, DAERAH ISTIMEWA YOGYAKARTA",15,165,32,197
https://kawalpemilu.org#42160,"BOTODAYAAN, RONGKOP, GUNUNGKIDUL, DAERAH ISTIMEWA YOGYAKARTA",1,125,48,173
https://kawalpemilu.org#42160,"BOTODAYAAN, RONGKOP, GUNUNGKIDUL, DAERAH ISTIMEWA YOGYAKARTA",2,96,18,114
https://kawalpemilu.org#42160,"BOTODAYAAN, RONGKOP, GUNUNGKIDUL, DAERAH ISTIMEWA YOGYAKARTA",3,98,17,115
https://kawalpemilu.org#42160,"BOTODAYAAN, RONGKOP, GUNUNGKIDUL, DAERAH ISTIMEWA YOGYAKARTA",4,169,27,196
https://kawalpemilu.org#42160,"BOTODAYAAN, RONGKOP, GUNUNGKIDUL, DAERAH ISTIMEWA YOGYAKARTA",5,149,16,165
https://kawalpemilu.org#42160,"BOTODAYAAN, RONGKOP, GUNUNGKIDUL, DAERAH ISTIMEWA YOGYAKARTA",6,140,26,166
https://kawalpemilu.org#42160,"BOTODAYAAN, RONGKOP, GUNUNGKIDUL, DAERAH ISTIMEWA YOGYAKARTA",7,141,45,186
https://kawalpemilu.org#42160,"BOTODAYAAN, RONGKOP, GUNUNGKIDUL, DAERAH ISTIMEWA YOGYAKARTA",8,136,45,181
https://kawalpemilu.org#42160,"BOTODAYAAN, RONGKOP, GUNUNGKIDUL, DAERAH ISTIMEWA YOGYAKARTA",9,88,35,123
https://kawalpemilu.org#42160,"BOTODAYAAN, RONGKOP, GUNUNGKIDUL, DAERAH ISTIMEWA YOGYAKARTA",10,146,40,186
https://kawalpemilu.org#42160,"BOTODAYAAN, RONGKOP, GUNUNGKIDUL, DAERAH ISTIMEWA YOGYAKARTA",11,150,62,212
https://kawalpemilu.org#42160,"BOTODAYAAN, RONGKOP, GUNUNGKIDUL, DAERAH ISTIMEWA YOGYAKARTA",12,94,57,151
https://kawalpemilu.org#42160,"BOTODAYAAN, RONGKOP, GUNUNGKIDUL, DAERAH ISTIMEWA YOGYAKARTA",13,177,48,225
https://kawalpemilu.org#42160,"BOTODAYAAN, RONGKOP, GUNUNGKIDUL, DAERAH ISTIMEWA YOGYAKARTA",14,99,36,135
https://kawalpemilu.org#42160,"BOTODAYAAN, RONGKOP, GUNUNGKIDUL, DAERAH ISTIMEWA YOGYAKARTA",15,81,86,167
https://kawalpemilu.org#42160,"BOTODAYAAN, RONGKOP, GUNUNGKIDUL, DAERAH ISTIMEWA YOGYAKARTA",16,86,52,138
https://kawalpemilu.org#42160,"BOTODAYAAN, RONGKOP, GUNUNGKIDUL, DAERAH ISTIMEWA YOGYAKARTA",17,112,29,141
https://kawalpemilu.org#42160,"BOTODAYAAN, RONGKOP, GUNUNGKIDUL, DAERAH ISTIMEWA YOGYAKARTA",18,110,12,122
https://kawalpemilu.org#42160,"BOTODAYAAN, RONGKOP, GUNUNGKIDUL, DAERAH ISTIMEWA YOGYAKARTA",19,152,30,182
https://kawalpemilu.org#42161,"PETIR, RONGKOP, GUNUNGKIDUL, DAERAH ISTIMEWA YOGYAKARTA",1,110,24,134
https://kawalpemilu.org#42161,"PETIR, RONGKOP, GUNUNGKIDUL, DAERAH ISTIMEWA YOGYAKARTA",2,143,36,179
https://kawalpemilu.org#42161,"PETIR, RONGKOP, GUNUNGKIDUL, DAERAH ISTIMEWA YOGYAKARTA",3,163,21,184
https://kawalpemilu.org#42161,"PETIR, RONGKOP, GUNUNGKIDUL, DAERAH ISTIMEWA YOGYAKARTA",4,145,83,228
https://kawalpemilu.org#42161,"PETIR, RONGKOP, GUNUNGKIDUL, DAERAH ISTIMEWA YOGYAKARTA",5,138,43,181
https://kawalpemilu.org#42161,"PETIR, RONGKOP, GUNUNGKIDUL, DAERAH ISTIMEWA YOGYAKARTA",6,150,57,207
https://kawalpemilu.org#42161,"PETIR, RONGKOP, GUNUNGKIDUL, DAERAH ISTIMEWA YOGYAKARTA",7,160,67,227
https://kawalpemilu.org#42161,"PETIR, RONGKOP, GUNUNGKIDUL, DAERAH ISTIMEWA YOGYAKARTA",8,121,43,164
https://kawalpemilu.org#42161,"PETIR, RONGKOP, GUNUNGKIDUL, DAERAH ISTIMEWA YOGYAKARTA",9,195,51,246
https://kawalpemilu.org#42161,"PETIR, RONGKOP, GUNUNGKIDUL, DAERAH ISTIMEWA YOGYAKARTA",10,160,49,209
https://kawalpemilu.org#42161,"PETIR, RONGKOP, GUNUNGKIDUL, DAERAH ISTIMEWA YOGYAKARTA",11,172,30,202
https://kawalpemilu.org#42161,"PETIR, RONGKOP, GUNUNGKIDUL, DAERAH ISTIMEWA YOGYAKARTA",12,165,37,202
https://kawalpemilu.org#42162,"PUCANGANOM, RONGKOP, GUNUNGKIDUL, DAERAH ISTIMEWA YOGYAKARTA",1,181,36,217
https://kawalpemilu.org#42162,"PUCANGANOM, RONGKOP, GUNUNGKIDUL, DAERAH ISTIMEWA YOGYAKARTA",2,138,22,160
https://kawalpemilu.org#42162,"PUCANGANOM, RONGKOP, GUNUNGKIDUL, DAERAH ISTIMEWA YOGYAKARTA",3,103,28,131
https://kawalpemilu.org#42162,"PUCANGANOM, RONGKOP, GUNUNGKIDUL, DAERAH ISTIMEWA YOGYAKARTA",4,125,49,174
https://kawalpemilu.org#42162,"PUCANGANOM, RONGKOP, GUNUNGKIDUL, DAERAH ISTIMEWA YOGYAKARTA",5,124,62,186
https://kawalpemilu.org#42162,"PUCANGANOM, RONGKOP, GUNUNGKIDUL, DAERAH ISTIMEWA YOGYAKARTA",6,161,28,189
https://kawalpemilu.org#42162,"PUCANGANOM, RONGKOP, GUNUNGKIDUL, DAERAH ISTIMEWA YOGYAKARTA",7,202,26,228
https://kawalpemilu.org#42162,"PUCANGANOM, RONGKOP, GUNUNGKIDUL, DAERAH ISTIMEWA YOGYAKARTA",8,150,38,188
https://kawalpemilu.org#42162,"PUCANGANOM, RONGKOP, GUNUNGKIDUL, DAERAH ISTIMEWA YOGYAKARTA",9,146,27,173
https://kawalpemilu.org#42162,"PUCANGANOM, RONGKOP, GUNUNGKIDUL, DAERAH ISTIMEWA YOGYAKARTA",10,138,11,149
https://kawalpemilu.org#42162,"PUCANGANOM, RONGKOP, GUNUNGKIDUL, DAERAH ISTIMEWA YOGYAKARTA",11,118,7,125
https://kawalpemilu.org#42162,"PUCANGANOM, RONGKOP, GUNUNGKIDUL, DAERAH ISTIMEWA YOGYAKARTA",12,152,19,171
https://kawalpemilu.org#42162,"PUCANGANOM, RONGKOP, GUNUNGKIDUL, DAERAH ISTIMEWA YOGYAKARTA",13,148,17,165
https://kawalpemilu.org#42162,"PUCANGANOM, RONGKOP, GUNUNGKIDUL, DAERAH ISTIMEWA YOGYAKARTA",14,133,9,142
https://kawalpemilu.org#42162,"PUCANGANOM, RONGKOP, GUNUNGKIDUL, DAERAH ISTIMEWA YOGYAKARTA",15,112,9,121
https://kawalpemilu.org#42162,"PUCANGANOM, RONGKOP, GUNUNGKIDUL, DAERAH ISTIMEWA YOGYAKARTA",16,125,11,136
https://kawalpemilu.org#42163,"SEMUGIH, RONGKOP, GUNUNGKIDUL, DAERAH ISTIMEWA YOGYAKARTA",1,161,44,205
https://kawalpemilu.org#42163,"SEMUGIH, RONGKOP, GUNUNGKIDUL, DAERAH ISTIMEWA YOGYAKARTA",2,202,38,240
https://kawalpemilu.org#42163,"SEMUGIH, RONGKOP, GUNUNGKIDUL, DAERAH ISTIMEWA YOGYAKARTA",3,162,69,231
https://kawalpemilu.org#42163,"SEMUGIH, RONGKOP, GUNUNGKIDUL, DAERAH ISTIMEWA YOGYAKARTA",4,126,80,206
https://kawalpemilu.org#42163,"SEMUGIH, RONGKOP, GUNUNGKIDUL, DAERAH ISTIMEWA YOGYAKARTA",5,169,51,220
https://kawalpemilu.org#42163,"SEMUGIH, RONGKOP, GUNUNGKIDUL, DAERAH ISTIMEWA YOGYAKARTA",6,136,69,205
https://kawalpemilu.org#42163,"SEMUGIH, RONGKOP, GUNUNGKIDUL, DAERAH ISTIMEWA YOGYAKARTA",7,52,84,136
https://kawalpemilu.org#42163,"SEMUGIH, RONGKOP, GUNUNGKIDUL, DAERAH ISTIMEWA YOGYAKARTA",8,63,59,122
https://kawalpemilu.org#42163,"SEMUGIH, RONGKOP, GUNUNGKIDUL, DAERAH ISTIMEWA YOGYAKARTA",9,90,40,130
https://kawalpemilu.org#42163,"SEMUGIH, RONGKOP, GUNUNGKIDUL, DAERAH ISTIMEWA YOGYAKARTA",10,138,40,178
https://kawalpemilu.org#42163,"SEMUGIH, RONGKOP, GUNUNGKIDUL, DAERAH ISTIMEWA YOGYAKARTA",11,163,39,202
https://kawalpemilu.org#42163,"SEMUGIH, RONGKOP, GUNUNGKIDUL, DAERAH ISTIMEWA YOGYAKARTA",12,103,51,154
https://kawalpemilu.org#42163,"SEMUGIH, RONGKOP, GUNUNGKIDUL, DAERAH ISTIMEWA YOGYAKARTA",13,96,47,143
https://kawalpemilu.org#42163,"SEMUGIH, RONGKOP, GUNUNGKIDUL, DAERAH ISTIMEWA YOGYAKARTA",14,123,45,168
https://kawalpemilu.org#42163,"SEMUGIH, RONGKOP, GUNUNGKIDUL, DAERAH ISTIMEWA YOGYAKARTA",15,131,40,171
https://kawalpemilu.org#42163,"SEMUGIH, RONGKOP, GUNUNGKIDUL, DAERAH ISTIMEWA YOGYAKARTA",16,165,43,208
https://kawalpemilu.org#42163,"SEMUGIH, RONGKOP, GUNUNGKIDUL, DAERAH ISTIMEWA YOGYAKARTA",17,151,63,214
https://kawalpemilu.org#42163,"SEMUGIH, RONGKOP, GUNUNGKIDUL, DAERAH ISTIMEWA YOGYAKARTA",18,135,34,169
https://kawalpemilu.org#42164,"MELIKAN, RONGKOP, GUNUNGKIDUL, DAERAH ISTIMEWA YOGYAKARTA",1,142,47,189
https://kawalpemilu.org#42164,"MELIKAN, RONGKOP, GUNUNGKIDUL, DAERAH ISTIMEWA YOGYAKARTA",2,111,28,139
https://kawalpemilu.org#42164,"MELIKAN, RONGKOP, GUNUNGKIDUL, DAERAH ISTIMEWA YOGYAKARTA",3,128,34,162
https://kawalpemilu.org#42164,"MELIKAN, RONGKOP, GUNUNGKIDUL, DAERAH ISTIMEWA YOGYAKARTA",4,170,11,181
https://kawalpemilu.org#42164,"MELIKAN, RONGKOP, GUNUNGKIDUL, DAERAH ISTIMEWA YOGYAKARTA",5,176,49,225
https://kawalpemilu.org#42164,"MELIKAN, RONGKOP, GUNUNGKIDUL, DAERAH ISTIMEWA YOGYAKARTA",6,182,47,229
https://kawalpemilu.org#42164,"MELIKAN, RONGKOP, GUNUNGKIDUL, DAERAH ISTIMEWA YOGYAKARTA",7,223,14,237
https://kawalpemilu.org#42164,"MELIKAN, RONGKOP, GUNUNGKIDUL, DAERAH ISTIMEWA YOGYAKARTA",8,205,33,238
https://kawalpemilu.org#42164,"MELIKAN, RONGKOP, GUNUNGKIDUL, DAERAH ISTIMEWA YOGYAKARTA",9,109,50,159
https://kawalpemilu.org#42164,"MELIKAN, RONGKOP, GUNUNGKIDUL, DAERAH ISTIMEWA YOGYAKARTA",10,160,64,224
https://kawalpemilu.org#42164,"MELIKAN, RONGKOP, GUNUNGKIDUL, DAERAH ISTIMEWA YOGYAKARTA",11,99,10,109
https://kawalpemilu.org#42164,"MELIKAN, RONGKOP, GUNUNGKIDUL, DAERAH ISTIMEWA YOGYAKARTA",12,139,27,166
https://kawalpemilu.org#42164,"MELIKAN, RONGKOP, GUNUNGKIDUL, DAERAH ISTIMEWA YOGYAKARTA",13,143,18,161
https://kawalpemilu.org#42165,"KARANGWUNI, RONGKOP, GUNUNGKIDUL, DAERAH ISTIMEWA YOGYAKARTA",1,131,100,231
https://kawalpemilu.org#42165,"KARANGWUNI, RONGKOP, GUNUNGKIDUL, DAERAH ISTIMEWA YOGYAKARTA",2,76,30,106
https://kawalpemilu.org#42165,"KARANGWUNI, RONGKOP, GUNUNGKIDUL, DAERAH ISTIMEWA YOGYAKARTA",3,110,36,146
https://kawalpemilu.org#42165,"KARANGWUNI, RONGKOP, GUNUNGKIDUL, DAERAH ISTIMEWA YOGYAKARTA",4,91,51,142
https://kawalpemilu.org#42165,"KARANGWUNI, RONGKOP, GUNUNGKIDUL, DAERAH ISTIMEWA YOGYAKARTA",5,119,42,161
https://kawalpemilu.org#42165,"KARANGWUNI, RONGKOP, GUNUNGKIDUL, DAERAH ISTIMEWA YOGYAKARTA",6,101,57,158
https://kawalpemilu.org#42165,"KARANGWUNI, RONGKOP, GUNUNGKIDUL, DAERAH ISTIMEWA YOGYAKARTA",7,171,31,202
https://kawalpemilu.org#42165,"KARANGWUNI, RONGKOP, GUNUNGKIDUL, DAERAH ISTIMEWA YOGYAKARTA",8,114,23,137
https://kawalpemilu.org#42165,"KARANGWUNI, RONGKOP, GUNUNGKIDUL, DAERAH ISTIMEWA YOGYAKARTA",9,148,35,183
https://kawalpemilu.org#42165,"KARANGWUNI, RONGKOP, GUNUNGKIDUL, DAERAH ISTIMEWA YOGYAKARTA",10,200,27,227
https://kawalpemilu.org#42165,"KARANGWUNI, RONGKOP, GUNUNGKIDUL, DAERAH ISTIMEWA YOGYAKARTA",11,99,32,131
https://kawalpemilu.org#42165,"KARANGWUNI, RONGKOP, GUNUNGKIDUL, DAERAH ISTIMEWA YOGYAKARTA",12,131,42,173
https://kawalpemilu.org#42165,"KARANGWUNI, RONGKOP, GUNUNGKIDUL, DAERAH ISTIMEWA YOGYAKARTA",13,89,49,138
https://kawalpemilu.org#42165,"KARANGWUNI, RONGKOP, GUNUNGKIDUL, DAERAH ISTIMEWA YOGYAKARTA",14,157,65,222
https://kawalpemilu.org#42165,"KARANGWUNI, RONGKOP, GUNUNGKIDUL, DAERAH ISTIMEWA YOGYAKARTA",15,197,47,244
https://kawalpemilu.org#42167,"KALITEKUK, SEMIN, GUNUNGKIDUL, DAERAH ISTIMEWA YOGYAKARTA",1,101,8,109
https://kawalpemilu.org#42167,"KALITEKUK, SEMIN, GUNUNGKIDUL, DAERAH ISTIMEWA YOGYAKARTA",2,119,45,164
https://kawalpemilu.org#42167,"KALITEKUK, SEMIN, GUNUNGKIDUL, DAERAH ISTIMEWA YOGYAKARTA",3,171,45,216
https://kawalpemilu.org#42167,"KALITEKUK, SEMIN, GUNUNGKIDUL, DAERAH ISTIMEWA YOGYAKARTA",4,176,15,191
https://kawalpemilu.org#42167,"KALITEKUK, SEMIN, GUNUNGKIDUL, DAERAH ISTIMEWA YOGYAKARTA",5,134,29,163
https://kawalpemilu.org#42167,"KALITEKUK, SEMIN, GUNUNGKIDUL, DAERAH ISTIMEWA YOGYAKARTA",6,155,41,196
https://kawalpemilu.org#42167,"KALITEKUK, SEMIN, GUNUNGKIDUL, DAERAH ISTIMEWA YOGYAKARTA",7,118,65,183
https://kawalpemilu.org#42167,"KALITEKUK, SEMIN, GUNUNGKIDUL, DAERAH ISTIMEWA YOGYAKARTA",8,170,31,201
https://kawalpemilu.org#42167,"KALITEKUK, SEMIN, GUNUNGKIDUL, DAERAH ISTIMEWA YOGYAKARTA",9,174,43,217
https://kawalpemilu.org#42167,"KALITEKUK, SEMIN, GUNUNGKIDUL, DAERAH ISTIMEWA YOGYAKARTA",10,160,23,183
https://kawalpemilu.org#42167,"KALITEKUK, SEMIN, GUNUNGKIDUL, DAERAH ISTIMEWA YOGYAKARTA",11,150,22,172
https://kawalpemilu.org#42167,"KALITEKUK, SEMIN, GUNUNGKIDUL, DAERAH ISTIMEWA YOGYAKARTA",12,154,36,190
https://kawalpemilu.org#42167,"KALITEKUK, SEMIN, GUNUNGKIDUL, DAERAH ISTIMEWA YOGYAKARTA",13,151,26,177
https://kawalpemilu.org#42167,"KALITEKUK, SEMIN, GUNUNGKIDUL, DAERAH ISTIMEWA YOGYAKARTA",14,112,18,130
https://kawalpemilu.org#42168,"KEMEJING, SEMIN, GUNUNGKIDUL, DAERAH ISTIMEWA YOGYAKARTA",1,140,8,148
https://kawalpemilu.org#42168,"KEMEJING, SEMIN, GUNUNGKIDUL, DAERAH ISTIMEWA YOGYAKARTA",2,130,54,184
https://kawalpemilu.org#42168,"KEMEJING, SEMIN, GUNUNGKIDUL, DAERAH ISTIMEWA YOGYAKARTA",3,168,5,173
https://kawalpemilu.org#42168,"KEMEJING, SEMIN, GUNUNGKIDUL, DAERAH ISTIMEWA YOGYAKARTA",4,165,18,183
https://kawalpemilu.org#42168,"KEMEJING, SEMIN, GUNUNGKIDUL, DAERAH ISTIMEWA YOGYAKARTA",5,201,34,235
https://kawalpemilu.org#42168,"KEMEJING, SEMIN, GUNUNGKIDUL, DAERAH ISTIMEWA YOGYAKARTA",6,143,40,183
https://kawalpemilu.org#42168,"KEMEJING, SEMIN, GUNUNGKIDUL, DAERAH ISTIMEWA YOGYAKARTA",7,94,38,132
https://kawalpemilu.org#42168,"KEMEJING, SEMIN, GUNUNGKIDUL, DAERAH ISTIMEWA YOGYAKARTA",8,127,18,145
https://kawalpemilu.org#42168,"KEMEJING, SEMIN, GUNUNGKIDUL, DAERAH ISTIMEWA YOGYAKARTA",9,151,36,187
https://kawalpemilu.org#42168,"KEMEJING, SEMIN, GUNUNGKIDUL, DAERAH ISTIMEWA YOGYAKARTA",10,146,16,162
https://kawalpemilu.org#42168,"KEMEJING, SEMIN, GUNUNGKIDUL, DAERAH ISTIMEWA YOGYAKARTA",11,138,48,186
https://kawalpemilu.org#42168,"KEMEJING, SEMIN, GUNUNGKIDUL, DAERAH ISTIMEWA YOGYAKARTA",12,193,12,205
https://kawalpemilu.org#42168,"KEMEJING, SEMIN, GUNUNGKIDUL, DAERAH ISTIMEWA YOGYAKARTA",13,148,14,162
https://kawalpemilu.org#42168,"KEMEJING, SEMIN, GUNUNGKIDUL, DAERAH ISTIMEWA YOGYAKARTA",14,110,20,130
https://kawalpemilu.org#42169,"BULUREJO, SEMIN, GUNUNGKIDUL, DAERAH ISTIMEWA YOGYAKARTA",1,181,34,215
https://kawalpemilu.org#42169,"BULUREJO, SEMIN, GUNUNGKIDUL, DAERAH ISTIMEWA YOGYAKARTA",2,133,64,197
https://kawalpemilu.org#42169,"BULUREJO, SEMIN, GUNUNGKIDUL, DAERAH ISTIMEWA YOGYAKARTA",3,87,57,144
https://kawalpemilu.org#42169,"BULUREJO, SEMIN, GUNUNGKIDUL, DAERAH ISTIMEWA YOGYAKARTA",4,112,32,144
https://kawalpemilu.org#42169,"BULUREJO, SEMIN, GUNUNGKIDUL, DAERAH ISTIMEWA YOGYAKARTA",5,135,37,172
https://kawalpemilu.org#42169,"BULUREJO, SEMIN, GUNUNGKIDUL, DAERAH ISTIMEWA YOGYAKARTA",6,123,19,142
https://kawalpemilu.org#42169,"BULUREJO, SEMIN, GUNUNGKIDUL, DAERAH ISTIMEWA YOGYAKARTA",7,105,57,162
https://kawalpemilu.org#42169,"BULUREJO, SEMIN, GUNUNGKIDUL, DAERAH ISTIMEWA YOGYAKARTA",8,173,52,225
https://kawalpemilu.org#42169,"BULUREJO, SEMIN, GUNUNGKIDUL, DAERAH ISTIMEWA YOGYAKARTA",9,137,45,182
https://kawalpemilu.org#42169,"BULUREJO, SEMIN, GUNUNGKIDUL, DAERAH ISTIMEWA YOGYAKARTA",10,166,25,191
https://kawalpemilu.org#42169,"BULUREJO, SEMIN, GUNUNGKIDUL, DAERAH ISTIMEWA YOGYAKARTA",11,171,28,199
https://kawalpemilu.org#42169,"BULUREJO, SEMIN, GUNUNGKIDUL, DAERAH ISTIMEWA YOGYAKARTA",12,113,35,148
https://kawalpemilu.org#42169,"BULUREJO, SEMIN, GUNUNGKIDUL, DAERAH ISTIMEWA YOGYAKARTA",13,63,54,117
https://kawalpemilu.org#42169,"BULUREJO, SEMIN, GUNUNGKIDUL, DAERAH ISTIMEWA YOGYAKARTA",14,132,15,147
https://kawalpemilu.org#42170,"SUMBEREJO, SEMIN, GUNUNGKIDUL, DAERAH ISTIMEWA YOGYAKARTA",1,115,26,141
https://kawalpemilu.org#42170,"SUMBEREJO, SEMIN, GUNUNGKIDUL, DAERAH ISTIMEWA YOGYAKARTA",2,133,19,152
https://kawalpemilu.org#42170,"SUMBEREJO, SEMIN, GUNUNGKIDUL, DAERAH ISTIMEWA YOGYAKARTA",3,162,39,201
https://kawalpemilu.org#42170,"SUMBEREJO, SEMIN, GUNUNGKIDUL, DAERAH ISTIMEWA YOGYAKARTA",4,127,9,136
https://kawalpemilu.org#42170,"SUMBEREJO, SEMIN, GUNUNGKIDUL, DAERAH ISTIMEWA YOGYAKARTA",5,110,9,119
https://kawalpemilu.org#42170,"SUMBEREJO, SEMIN, GUNUNGKIDUL, DAERAH ISTIMEWA YOGYAKARTA",6,107,16,123
https://kawalpemilu.org#42170,"SUMBEREJO, SEMIN, GUNUNGKIDUL, DAERAH ISTIMEWA YOGYAKARTA",7,62,27,89
https://kawalpemilu.org#42170,"SUMBEREJO, SEMIN, GUNUNGKIDUL, DAERAH ISTIMEWA YOGYAKARTA",8,126,35,161
https://kawalpemilu.org#42170,"SUMBEREJO, SEMIN, GUNUNGKIDUL, DAERAH ISTIMEWA YOGYAKARTA",9,129,16,145
https://kawalpemilu.org#42170,"SUMBEREJO, SEMIN, GUNUNGKIDUL, DAERAH ISTIMEWA YOGYAKARTA",10,133,31,164
https://kawalpemilu.org#42170,"SUMBEREJO, SEMIN, GUNUNGKIDUL, DAERAH ISTIMEWA YOGYAKARTA",11,92,52,144
https://kawalpemilu.org#42170,"SUMBEREJO, SEMIN, GUNUNGKIDUL, DAERAH ISTIMEWA YOGYAKARTA",12,127,13,140
https://kawalpemilu.org#42170,"SUMBEREJO, SEMIN, GUNUNGKIDUL, DAERAH ISTIMEWA YOGYAKARTA",13,148,24,172
https://kawalpemilu.org#42170,"SUMBEREJO, SEMIN, GUNUNGKIDUL, DAERAH ISTIMEWA YOGYAKARTA",14,121,44,165
https://kawalpemilu.org#42170,"SUMBEREJO, SEMIN, GUNUNGKIDUL, DAERAH ISTIMEWA YOGYAKARTA",15,128,28,156
https://kawalpemilu.org#42170,"SUMBEREJO, SEMIN, GUNUNGKIDUL, DAERAH ISTIMEWA YOGYAKARTA",16,119,17,136
https://kawalpemilu.org#42170,"SUMBEREJO, SEMIN, GUNUNGKIDUL, DAERAH ISTIMEWA YOGYAKARTA",17,126,28,154
https://kawalpemilu.org#42170,"SUMBEREJO, SEMIN, GUNUNGKIDUL, DAERAH ISTIMEWA YOGYAKARTA",18,144,16,160
https://kawalpemilu.org#42170,"SUMBEREJO, SEMIN, GUNUNGKIDUL, DAERAH ISTIMEWA YOGYAKARTA",19,170,46,216
https://kawalpemilu.org#42170,"SUMBEREJO, SEMIN, GUNUNGKIDUL, DAERAH ISTIMEWA YOGYAKARTA",20,138,54,192
https://kawalpemilu.org#42170,"SUMBEREJO, SEMIN, GUNUNGKIDUL, DAERAH ISTIMEWA YOGYAKARTA",21,83,26,109
https://kawalpemilu.org#42170,"SUMBEREJO, SEMIN, GUNUNGKIDUL, DAERAH ISTIMEWA YOGYAKARTA",22,94,38,132
https://kawalpemilu.org#42170,"SUMBEREJO, SEMIN, GUNUNGKIDUL, DAERAH ISTIMEWA YOGYAKARTA",23,130,15,145
https://kawalpemilu.org#42170,"SUMBEREJO, SEMIN, GUNUNGKIDUL, DAERAH ISTIMEWA YOGYAKARTA",24,129,15,144
https://kawalpemilu.org#42170,"SUMBEREJO, SEMIN, GUNUNGKIDUL, DAERAH ISTIMEWA YOGYAKARTA",25,113,19,132
https://kawalpemilu.org#42170,"SUMBEREJO, SEMIN, GUNUNGKIDUL, DAERAH ISTIMEWA YOGYAKARTA",26,145,22,167
https://kawalpemilu.org#42171,"BENDUNG, SEMIN, GUNUNGKIDUL, DAERAH ISTIMEWA YOGYAKARTA",1,79,45,124
https://kawalpemilu.org#42171,"BENDUNG, SEMIN, GUNUNGKIDUL, DAERAH ISTIMEWA YOGYAKARTA",2,135,65,200
https://kawalpemilu.org#42171,"BENDUNG, SEMIN, GUNUNGKIDUL, DAERAH ISTIMEWA YOGYAKARTA",3,155,34,189
https://kawalpemilu.org#42171,"BENDUNG, SEMIN, GUNUNGKIDUL, DAERAH ISTIMEWA YOGYAKARTA",4,72,69,141
https://kawalpemilu.org#42171,"BENDUNG, SEMIN, GUNUNGKIDUL, DAERAH ISTIMEWA YOGYAKARTA",5,90,93,183
https://kawalpemilu.org#42171,"BENDUNG, SEMIN, GUNUNGKIDUL, DAERAH ISTIMEWA YOGYAKARTA",6,110,49,159
https://kawalpemilu.org#42171,"BENDUNG, SEMIN, GUNUNGKIDUL, DAERAH ISTIMEWA YOGYAKARTA",7,152,11,163
https://kawalpemilu.org#42171,"BENDUNG, SEMIN, GUNUNGKIDUL, DAERAH ISTIMEWA YOGYAKARTA",8,122,66,188
https://kawalpemilu.org#42171,"BENDUNG, SEMIN, GUNUNGKIDUL, DAERAH ISTIMEWA YOGYAKARTA",9,160,28,188
https://kawalpemilu.org#42171,"BENDUNG, SEMIN, GUNUNGKIDUL, DAERAH ISTIMEWA YOGYAKARTA",10,118,70,188
https://kawalpemilu.org#42171,"BENDUNG, SEMIN, GUNUNGKIDUL, DAERAH ISTIMEWA YOGYAKARTA",11,135,59,194
https://kawalpemilu.org#42171,"BENDUNG, SEMIN, GUNUNGKIDUL, DAERAH ISTIMEWA YOGYAKARTA",12,135,87,222
https://kawalpemilu.org#42171,"BENDUNG, SEMIN, GUNUNGKIDUL, DAERAH ISTIMEWA YOGYAKARTA",13,132,58,190
https://kawalpemilu.org#42171,"BENDUNG, SEMIN, GUNUNGKIDUL, DAERAH ISTIMEWA YOGYAKARTA",14,84,64,148
https://kawalpemilu.org#42171,"BENDUNG, SEMIN, GUNUNGKIDUL, DAERAH ISTIMEWA YOGYAKARTA",15,112,14,126
https://kawalpemilu.org#42171,"BENDUNG, SEMIN, GUNUNGKIDUL, DAERAH ISTIMEWA YOGYAKARTA",16,133,12,145
https://kawalpemilu.org#42172,"CANDIREJO, SEMIN, GUNUNGKIDUL, DAERAH ISTIMEWA YOGYAKARTA",1,199,24,223
https://kawalpemilu.org#42172,"CANDIREJO, SEMIN, GUNUNGKIDUL, DAERAH ISTIMEWA YOGYAKARTA",2,157,21,178
https://kawalpemilu.org#42172,"CANDIREJO, SEMIN, GUNUNGKIDUL, DAERAH ISTIMEWA YOGYAKARTA",3,179,37,216
https://kawalpemilu.org#42172,"CANDIREJO, SEMIN, GUNUNGKIDUL, DAERAH ISTIMEWA YOGYAKARTA",4,182,22,204
https://kawalpemilu.org#42172,"CANDIREJO, SEMIN, GUNUNGKIDUL, DAERAH ISTIMEWA YOGYAKARTA",5,164,54,218
https://kawalpemilu.org#42172,"CANDIREJO, SEMIN, GUNUNGKIDUL, DAERAH ISTIMEWA YOGYAKARTA",6,86,59,145
https://kawalpemilu.org#42172,"CANDIREJO, SEMIN, GUNUNGKIDUL, DAERAH ISTIMEWA YOGYAKARTA",7,132,42,174
https://kawalpemilu.org#42172,"CANDIREJO, SEMIN, GUNUNGKIDUL, DAERAH ISTIMEWA YOGYAKARTA",8,100,29,129
https://kawalpemilu.org#42172,"CANDIREJO, SEMIN, GUNUNGKIDUL, DAERAH ISTIMEWA YOGYAKARTA",9,151,39,190
https://kawalpemilu.org#42172,"CANDIREJO, SEMIN, GUNUNGKIDUL, DAERAH ISTIMEWA YOGYAKARTA",10,120,19,139
https://kawalpemilu.org#42172,"CANDIREJO, SEMIN, GUNUNGKIDUL, DAERAH ISTIMEWA YOGYAKARTA",11,150,49,199
https://kawalpemilu.org#42172,"CANDIREJO, SEMIN, GUNUNGKIDUL, DAERAH ISTIMEWA YOGYAKARTA",12,133,27,160
https://kawalpemilu.org#42172,"CANDIREJO, SEMIN, GUNUNGKIDUL, DAERAH ISTIMEWA YOGYAKARTA",13,119,37,156
https://kawalpemilu.org#42172,"CANDIREJO, SEMIN, GUNUNGKIDUL, DAERAH ISTIMEWA YOGYAKARTA",14,87,17,104
https://kawalpemilu.org#42172,"CANDIREJO, SEMIN, GUNUNGKIDUL, DAERAH ISTIMEWA YOGYAKARTA",15,106,23,129
https://kawalpemilu.org#42172,"CANDIREJO, SEMIN, GUNUNGKIDUL, DAERAH ISTIMEWA YOGYAKARTA",16,167,34,201
https://kawalpemilu.org#42172,"CANDIREJO, SEMIN, GUNUNGKIDUL, DAERAH ISTIMEWA YOGYAKARTA",17,127,20,147
https://kawalpemilu.org#42172,"CANDIREJO, SEMIN, GUNUNGKIDUL, DAERAH ISTIMEWA YOGYAKARTA",18,102,34,136
https://kawalpemilu.org#42172,"CANDIREJO, SEMIN, GUNUNGKIDUL, DAERAH ISTIMEWA YOGYAKARTA",19,117,26,143
https://kawalpemilu.org#42172,"CANDIREJO, SEMIN, GUNUNGKIDUL, DAERAH ISTIMEWA YOGYAKARTA",20,108,21,129
https://kawalpemilu.org#42172,"CANDIREJO, SEMIN, GUNUNGKIDUL, DAERAH ISTIMEWA YOGYAKARTA",21,131,40,171
https://kawalpemilu.org#42172,"CANDIREJO, SEMIN, GUNUNGKIDUL, DAERAH ISTIMEWA YOGYAKARTA",22,141,46,187
https://kawalpemilu.org#42172,"CANDIREJO, SEMIN, GUNUNGKIDUL, DAERAH ISTIMEWA YOGYAKARTA",23,119,13,132
https://kawalpemilu.org#42172,"CANDIREJO, SEMIN, GUNUNGKIDUL, DAERAH ISTIMEWA YOGYAKARTA",24,130,10,140
https://kawalpemilu.org#42172,"CANDIREJO, SEMIN, GUNUNGKIDUL, DAERAH ISTIMEWA YOGYAKARTA",25,66,15,81
https://kawalpemilu.org#42172,"CANDIREJO, SEMIN, GUNUNGKIDUL, DAERAH ISTIMEWA YOGYAKARTA",26,119,62,181
https://kawalpemilu.org#42172,"CANDIREJO, SEMIN, GUNUNGKIDUL, DAERAH ISTIMEWA YOGYAKARTA",27,106,90,196
https://kawalpemilu.org#42172,"CANDIREJO, SEMIN, GUNUNGKIDUL, DAERAH ISTIMEWA YOGYAKARTA",28,166,52,218
https://kawalpemilu.org#42172,"CANDIREJO, SEMIN, GUNUNGKIDUL, DAERAH ISTIMEWA YOGYAKARTA",29,159,10,169
https://kawalpemilu.org#42173,"REJOSARI, SEMIN, GUNUNGKIDUL, DAERAH ISTIMEWA YOGYAKARTA",1,142,38,180
https://kawalpemilu.org#42173,"REJOSARI, SEMIN, GUNUNGKIDUL, DAERAH ISTIMEWA YOGYAKARTA",2,140,54,194
https://kawalpemilu.org#42173,"REJOSARI, SEMIN, GUNUNGKIDUL, DAERAH ISTIMEWA YOGYAKARTA",3,80,68,148
https://kawalpemilu.org#42173,"REJOSARI, SEMIN, GUNUNGKIDUL, DAERAH ISTIMEWA YOGYAKARTA",4,94,15,109
https://kawalpemilu.org#42173,"REJOSARI, SEMIN, GUNUNGKIDUL, DAERAH ISTIMEWA YOGYAKARTA",5,153,4,157
https://kawalpemilu.org#42173,"REJOSARI, SEMIN, GUNUNGKIDUL, DAERAH ISTIMEWA YOGYAKARTA",6,137,20,157
https://kawalpemilu.org#42173,"REJOSARI, SEMIN, GUNUNGKIDUL, DAERAH ISTIMEWA YOGYAKARTA",7,118,34,152
https://kawalpemilu.org#42173,"REJOSARI, SEMIN, GUNUNGKIDUL, DAERAH ISTIMEWA YOGYAKARTA",8,112,26,138
https://kawalpemilu.org#42173,"REJOSARI, SEMIN, GUNUNGKIDUL, DAERAH ISTIMEWA YOGYAKARTA",9,118,48,166
https://kawalpemilu.org#42173,"REJOSARI, SEMIN, GUNUNGKIDUL, DAERAH ISTIMEWA YOGYAKARTA",10,130,31,161
https://kawalpemilu.org#42173,"REJOSARI, SEMIN, GUNUNGKIDUL, DAERAH ISTIMEWA YOGYAKARTA",11,101,46,147
https://kawalpemilu.org#42173,"REJOSARI, SEMIN, GUNUNGKIDUL, DAERAH ISTIMEWA YOGYAKARTA",12,101,27,128
https://kawalpemilu.org#42173,"REJOSARI, SEMIN, GUNUNGKIDUL, DAERAH ISTIMEWA YOGYAKARTA",13,96,13,109
https://kawalpemilu.org#42173,"REJOSARI, SEMIN, GUNUNGKIDUL, DAERAH ISTIMEWA YOGYAKARTA",14,142,14,156
https://kawalpemilu.org#42173,"REJOSARI, SEMIN, GUNUNGKIDUL, DAERAH ISTIMEWA YOGYAKARTA",15,148,21,169
https://kawalpemilu.org#42173,"REJOSARI, SEMIN, GUNUNGKIDUL, DAERAH ISTIMEWA YOGYAKARTA",16,132,25,157
https://kawalpemilu.org#42173,"REJOSARI, SEMIN, GUNUNGKIDUL, DAERAH ISTIMEWA YOGYAKARTA",17,126,15,141
https://kawalpemilu.org#42173,"REJOSARI, SEMIN, GUNUNGKIDUL, DAERAH ISTIMEWA YOGYAKARTA",18,120,12,132
https://kawalpemilu.org#42173,"REJOSARI, SEMIN, GUNUNGKIDUL, DAERAH ISTIMEWA YOGYAKARTA",19,120,13,133
https://kawalpemilu.org#42173,"REJOSARI, SEMIN, GUNUNGKIDUL, DAERAH ISTIMEWA YOGYAKARTA",20,141,17,158
https://kawalpemilu.org#42173,"REJOSARI, SEMIN, GUNUNGKIDUL, DAERAH ISTIMEWA YOGYAKARTA",21,92,19,111
https://kawalpemilu.org#42173,"REJOSARI, SEMIN, GUNUNGKIDUL, DAERAH ISTIMEWA YOGYAKARTA",22,107,17,124
https://kawalpemilu.org#42174,"KARANGSARI, SEMIN, GUNUNGKIDUL, DAERAH ISTIMEWA YOGYAKARTA",1,159,15,174
https://kawalpemilu.org#42174,"KARANGSARI, SEMIN, GUNUNGKIDUL, DAERAH ISTIMEWA YOGYAKARTA",2,138,16,154
https://kawalpemilu.org#42174,"KARANGSARI, SEMIN, GUNUNGKIDUL, DAERAH ISTIMEWA YOGYAKARTA",3,100,12,112
https://kawalpemilu.org#42174,"KARANGSARI, SEMIN, GUNUNGKIDUL, DAERAH ISTIMEWA YOGYAKARTA",4,137,39,176
https://kawalpemilu.org#42174,"KARANGSARI, SEMIN, GUNUNGKIDUL, DAERAH ISTIMEWA YOGYAKARTA",5,144,19,163
https://kawalpemilu.org#42174,"KARANGSARI, SEMIN, GUNUNGKIDUL, DAERAH ISTIMEWA YOGYAKARTA",6,166,42,208
https://kawalpemilu.org#42174,"KARANGSARI, SEMIN, GUNUNGKIDUL, DAERAH ISTIMEWA YOGYAKARTA",7,161,26,142
https://kawalpemilu.org#42174,"KARANGSARI, SEMIN, GUNUNGKIDUL, DAERAH ISTIMEWA YOGYAKARTA",8,155,15,170
https://kawalpemilu.org#42174,"KARANGSARI, SEMIN, GUNUNGKIDUL, DAERAH ISTIMEWA YOGYAKARTA",9,113,41,154
https://kawalpemilu.org#42174,"KARANGSARI, SEMIN, GUNUNGKIDUL, DAERAH ISTIMEWA YOGYAKARTA",10,148,22,170
https://kawalpemilu.org#42174,"KARANGSARI, SEMIN, GUNUNGKIDUL, DAERAH ISTIMEWA YOGYAKARTA",11,77,13,90
https://kawalpemilu.org#42174,"KARANGSARI, SEMIN, GUNUNGKIDUL, DAERAH ISTIMEWA YOGYAKARTA",12,145,16,161
https://kawalpemilu.org#42174,"KARANGSARI, SEMIN, GUNUNGKIDUL, DAERAH ISTIMEWA YOGYAKARTA",13,121,19,140
https://kawalpemilu.org#42174,"KARANGSARI, SEMIN, GUNUNGKIDUL, DAERAH ISTIMEWA YOGYAKARTA",14,96,28,124
https://kawalpemilu.org#42174,"KARANGSARI, SEMIN, GUNUNGKIDUL, DAERAH ISTIMEWA YOGYAKARTA",15,116,22,138
https://kawalpemilu.org#42174,"KARANGSARI, SEMIN, GUNUNGKIDUL, DAERAH ISTIMEWA YOGYAKARTA",16,172,21,193
https://kawalpemilu.org#42174,"KARANGSARI, SEMIN, GUNUNGKIDUL, DAERAH ISTIMEWA YOGYAKARTA",17,158,7,165
https://kawalpemilu.org#42174,"KARANGSARI, SEMIN, GUNUNGKIDUL, DAERAH ISTIMEWA YOGYAKARTA",18,153,17,170
https://kawalpemilu.org#42174,"KARANGSARI, SEMIN, GUNUNGKIDUL, DAERAH ISTIMEWA YOGYAKARTA",19,103,20,123
https://kawalpemilu.org#42174,"KARANGSARI, SEMIN, GUNUNGKIDUL, DAERAH ISTIMEWA YOGYAKARTA",20,145,5,150
https://kawalpemilu.org#42174,"KARANGSARI, SEMIN, GUNUNGKIDUL, DAERAH ISTIMEWA YOGYAKARTA",21,182,26,208
https://kawalpemilu.org#42174,"KARANGSARI, SEMIN, GUNUNGKIDUL, DAERAH ISTIMEWA YOGYAKARTA",22,102,13,115
https://kawalpemilu.org#42174,"KARANGSARI, SEMIN, GUNUNGKIDUL, DAERAH ISTIMEWA YOGYAKARTA",23,160,19,179
https://kawalpemilu.org#42175,"PUNDUNGSARI, SEMIN, GUNUNGKIDUL, DAERAH ISTIMEWA YOGYAKARTA",1,117,25,142
https://kawalpemilu.org#42175,"PUNDUNGSARI, SEMIN, GUNUNGKIDUL, DAERAH ISTIMEWA YOGYAKARTA",2,170,10,180
https://kawalpemilu.org#42175,"PUNDUNGSARI, SEMIN, GUNUNGKIDUL, DAERAH ISTIMEWA YOGYAKARTA",3,137,15,152
https://kawalpemilu.org#42175,"PUNDUNGSARI, SEMIN, GUNUNGKIDUL, DAERAH ISTIMEWA YOGYAKARTA",4,116,13,129
https://kawalpemilu.org#42175,"PUNDUNGSARI, SEMIN, GUNUNGKIDUL, DAERAH ISTIMEWA YOGYAKARTA",5,147,9,156
https://kawalpemilu.org#42175,"PUNDUNGSARI, SEMIN, GUNUNGKIDUL, DAERAH ISTIMEWA YOGYAKARTA",6,135,22,157
https://kawalpemilu.org#42175,"PUNDUNGSARI, SEMIN, GUNUNGKIDUL, DAERAH ISTIMEWA YOGYAKARTA",7,162,6,168
https://kawalpemilu.org#42175,"PUNDUNGSARI, SEMIN, GUNUNGKIDUL, DAERAH ISTIMEWA YOGYAKARTA",8,202,12,214
https://kawalpemilu.org#42175,"PUNDUNGSARI, SEMIN, GUNUNGKIDUL, DAERAH ISTIMEWA YOGYAKARTA",9,179,19,198
https://kawalpemilu.org#42175,"PUNDUNGSARI, SEMIN, GUNUNGKIDUL, DAERAH ISTIMEWA YOGYAKARTA",10,208,35,243
https://kawalpemilu.org#42175,"PUNDUNGSARI, SEMIN, GUNUNGKIDUL, DAERAH ISTIMEWA YOGYAKARTA",11,185,40,225
https://kawalpemilu.org#42175,"PUNDUNGSARI, SEMIN, GUNUNGKIDUL, DAERAH ISTIMEWA YOGYAKARTA",12,99,12,111
https://kawalpemilu.org#42175,"PUNDUNGSARI, SEMIN, GUNUNGKIDUL, DAERAH ISTIMEWA YOGYAKARTA",13,157,10,167
https://kawalpemilu.org#42175,"PUNDUNGSARI, SEMIN, GUNUNGKIDUL, DAERAH ISTIMEWA YOGYAKARTA",14,209,21,230
https://kawalpemilu.org#42175,"PUNDUNGSARI, SEMIN, GUNUNGKIDUL, DAERAH ISTIMEWA YOGYAKARTA",15,128,50,178
https://kawalpemilu.org#42175,"PUNDUNGSARI, SEMIN, GUNUNGKIDUL, DAERAH ISTIMEWA YOGYAKARTA",16,155,55,210
https://kawalpemilu.org#42176,"SEMIN, SEMIN, GUNUNGKIDUL, DAERAH ISTIMEWA YOGYAKARTA",1,126,39,165
https://kawalpemilu.org#42176,"SEMIN, SEMIN, GUNUNGKIDUL, DAERAH ISTIMEWA YOGYAKARTA",2,128,63,191
https://kawalpemilu.org#42176,"SEMIN, SEMIN, GUNUNGKIDUL, DAERAH ISTIMEWA YOGYAKARTA",3,88,15,103
https://kawalpemilu.org#42176,"SEMIN, SEMIN, GUNUNGKIDUL, DAERAH ISTIMEWA YOGYAKARTA",4,106,26,132
https://kawalpemilu.org#42176,"SEMIN, SEMIN, GUNUNGKIDUL, DAERAH ISTIMEWA YOGYAKARTA",5,137,77,214
https://kawalpemilu.org#42176,"SEMIN, SEMIN, GUNUNGKIDUL, DAERAH ISTIMEWA YOGYAKARTA",6,93,54,147
https://kawalpemilu.org#42176,"SEMIN, SEMIN, GUNUNGKIDUL, DAERAH ISTIMEWA YOGYAKARTA",7,105,41,146
https://kawalpemilu.org#42176,"SEMIN, SEMIN, GUNUNGKIDUL, DAERAH ISTIMEWA YOGYAKARTA",8,58,33,91
https://kawalpemilu.org#42176,"SEMIN, SEMIN, GUNUNGKIDUL, DAERAH ISTIMEWA YOGYAKARTA",9,96,41,137
https://kawalpemilu.org#42176,"SEMIN, SEMIN, GUNUNGKIDUL, DAERAH ISTIMEWA YOGYAKARTA",10,89,44,133
https://kawalpemilu.org#42176,"SEMIN, SEMIN, GUNUNGKIDUL, DAERAH ISTIMEWA YOGYAKARTA",11,92,16,108
https://kawalpemilu.org#42176,"SEMIN, SEMIN, GUNUNGKIDUL, DAERAH ISTIMEWA YOGYAKARTA",12,91,39,130
https://kawalpemilu.org#42176,"SEMIN, SEMIN, GUNUNGKIDUL, DAERAH ISTIMEWA YOGYAKARTA",13,81,19,100
https://kawalpemilu.org#42176,"SEMIN, SEMIN, GUNUNGKIDUL, DAERAH ISTIMEWA YOGYAKARTA",14,180,25,205
https://kawalpemilu.org#42176,"SEMIN, SEMIN, GUNUNGKIDUL, DAERAH ISTIMEWA YOGYAKARTA",15,188,42,230
https://kawalpemilu.org#42176,"SEMIN, SEMIN, GUNUNGKIDUL, DAERAH ISTIMEWA YOGYAKARTA",16,156,26,182
https://kawalpemilu.org#42176,"SEMIN, SEMIN, GUNUNGKIDUL, DAERAH ISTIMEWA YOGYAKARTA",17,195,22,217
https://kawalpemilu.org#42176,"SEMIN, SEMIN, GUNUNGKIDUL, DAERAH ISTIMEWA YOGYAKARTA",18,209,26,235
https://kawalpemilu.org#42176,"SEMIN, SEMIN, GUNUNGKIDUL, DAERAH ISTIMEWA YOGYAKARTA",19,201,20,221
https://kawalpemilu.org#42176,"SEMIN, SEMIN, GUNUNGKIDUL, DAERAH ISTIMEWA YOGYAKARTA",20,199,18,217
https://kawalpemilu.org#42176,"SEMIN, SEMIN, GUNUNGKIDUL, DAERAH ISTIMEWA YOGYAKARTA",21,108,15,123
https://kawalpemilu.org#42176,"SEMIN, SEMIN, GUNUNGKIDUL, DAERAH ISTIMEWA YOGYAKARTA",22,168,31,199
https://kawalpemilu.org#42176,"SEMIN, SEMIN, GUNUNGKIDUL, DAERAH ISTIMEWA YOGYAKARTA",23,115,22,137
https://kawalpemilu.org#42176,"SEMIN, SEMIN, GUNUNGKIDUL, DAERAH ISTIMEWA YOGYAKARTA",24,160,26,186
https://kawalpemilu.org#42176,"SEMIN, SEMIN, GUNUNGKIDUL, DAERAH ISTIMEWA YOGYAKARTA",25,140,49,189
https://kawalpemilu.org#42176,"SEMIN, SEMIN, GUNUNGKIDUL, DAERAH ISTIMEWA YOGYAKARTA",26,132,27,159
https://kawalpemilu.org#42176,"SEMIN, SEMIN, GUNUNGKIDUL, DAERAH ISTIMEWA YOGYAKARTA",27,141,41,182
https://kawalpemilu.org#42176,"SEMIN, SEMIN, GUNUNGKIDUL, DAERAH ISTIMEWA YOGYAKARTA",28,192,37,229
https://kawalpemilu.org#42176,"SEMIN, SEMIN, GUNUNGKIDUL, DAERAH ISTIMEWA YOGYAKARTA",29,129,33,162
https://kawalpemilu.org#42176,"SEMIN, SEMIN, GUNUNGKIDUL, DAERAH ISTIMEWA YOGYAKARTA",30,159,40,199
https://kawalpemilu.org#42176,"SEMIN, SEMIN, GUNUNGKIDUL, DAERAH ISTIMEWA YOGYAKARTA",31,171,25,196
https://kawalpemilu.org#42176,"SEMIN, SEMIN, GUNUNGKIDUL, DAERAH ISTIMEWA YOGYAKARTA",32,153,35,188
https://kawalpemilu.org#42176,"SEMIN, SEMIN, GUNUNGKIDUL, DAERAH ISTIMEWA YOGYAKARTA",33,150,29,179
https://kawalpemilu.org#42176,"SEMIN, SEMIN, GUNUNGKIDUL, DAERAH ISTIMEWA YOGYAKARTA",34,157,32,189
https://kawalpemilu.org#42176,"SEMIN, SEMIN, GUNUNGKIDUL, DAERAH ISTIMEWA YOGYAKARTA",35,142,17,159
https://kawalpemilu.org#42176,"SEMIN, SEMIN, GUNUNGKIDUL, DAERAH ISTIMEWA YOGYAKARTA",36,181,28,209
https://kawalpemilu.org#42176,"SEMIN, SEMIN, GUNUNGKIDUL, DAERAH ISTIMEWA YOGYAKARTA",37,94,43,137
https://kawalpemilu.org#42176,"SEMIN, SEMIN, GUNUNGKIDUL, DAERAH ISTIMEWA YOGYAKARTA",38,127,29,156
https://kawalpemilu.org#42176,"SEMIN, SEMIN, GUNUNGKIDUL, DAERAH ISTIMEWA YOGYAKARTA",39,137,12,149
https://kawalpemilu.org#42176,"SEMIN, SEMIN, GUNUNGKIDUL, DAERAH ISTIMEWA YOGYAKARTA",40,179,4,183
https://kawalpemilu.org#42176,"SEMIN, SEMIN, GUNUNGKIDUL, DAERAH ISTIMEWA YOGYAKARTA",41,140,12,152
https://kawalpemilu.org#42176,"SEMIN, SEMIN, GUNUNGKIDUL, DAERAH ISTIMEWA YOGYAKARTA",42,148,6,154
https://kawalpemilu.org#42178,"TANCEP, NGAWEN, GUNUNGKIDUL, DAERAH ISTIMEWA YOGYAKARTA",1,223,10,233
https://kawalpemilu.org#42178,"TANCEP, NGAWEN, GUNUNGKIDUL, DAERAH ISTIMEWA YOGYAKARTA",2,247,10,257
https://kawalpemilu.org#42178,"TANCEP, NGAWEN, GUNUNGKIDUL, DAERAH ISTIMEWA YOGYAKARTA",3,197,33,230
https://kawalpemilu.org#42178,"TANCEP, NGAWEN, GUNUNGKIDUL, DAERAH ISTIMEWA YOGYAKARTA",4,161,31,192
https://kawalpemilu.org#42178,"TANCEP, NGAWEN, GUNUNGKIDUL, DAERAH ISTIMEWA YOGYAKARTA",5,196,37,233
https://kawalpemilu.org#42178,"TANCEP, NGAWEN, GUNUNGKIDUL, DAERAH ISTIMEWA YOGYAKARTA",6,173,36,209
https://kawalpemilu.org#42178,"TANCEP, NGAWEN, GUNUNGKIDUL, DAERAH ISTIMEWA YOGYAKARTA",7,177,12,189
https://kawalpemilu.org#42178,"TANCEP, NGAWEN, GUNUNGKIDUL, DAERAH ISTIMEWA YOGYAKARTA",8,221,30,251
https://kawalpemilu.org#42178,"TANCEP, NGAWEN, GUNUNGKIDUL, DAERAH ISTIMEWA YOGYAKARTA",9,123,15,138
https://kawalpemilu.org#42178,"TANCEP, NGAWEN, GUNUNGKIDUL, DAERAH ISTIMEWA YOGYAKARTA",10,104,34,138
https://kawalpemilu.org#42178,"TANCEP, NGAWEN, GUNUNGKIDUL, DAERAH ISTIMEWA YOGYAKARTA",11,145,20,165
https://kawalpemilu.org#42178,"TANCEP, NGAWEN, GUNUNGKIDUL, DAERAH ISTIMEWA YOGYAKARTA",12,251,1,252
https://kawalpemilu.org#42178,"TANCEP, NGAWEN, GUNUNGKIDUL, DAERAH ISTIMEWA YOGYAKARTA",13,134,8,142
https://kawalpemilu.org#42178,"TANCEP, NGAWEN, GUNUNGKIDUL, DAERAH ISTIMEWA YOGYAKARTA",14,175,8,183
https://kawalpemilu.org#42178,"TANCEP, NGAWEN, GUNUNGKIDUL, DAERAH ISTIMEWA YOGYAKARTA",15,89,49,138
https://kawalpemilu.org#42178,"TANCEP, NGAWEN, GUNUNGKIDUL, DAERAH ISTIMEWA YOGYAKARTA",16,122,107,229
https://kawalpemilu.org#42178,"TANCEP, NGAWEN, GUNUNGKIDUL, DAERAH ISTIMEWA YOGYAKARTA",17,193,54,247
https://kawalpemilu.org#42178,"TANCEP, NGAWEN, GUNUNGKIDUL, DAERAH ISTIMEWA YOGYAKARTA",18,96,65,161
https://kawalpemilu.org#42178,"TANCEP, NGAWEN, GUNUNGKIDUL, DAERAH ISTIMEWA YOGYAKARTA",19,52,148,200
https://kawalpemilu.org#42179,"SAMBIREJO, NGAWEN, GUNUNGKIDUL, DAERAH ISTIMEWA YOGYAKARTA",1,144,52,196
https://kawalpemilu.org#42179,"SAMBIREJO, NGAWEN, GUNUNGKIDUL, DAERAH ISTIMEWA YOGYAKARTA",2,132,15,147
https://kawalpemilu.org#42179,"SAMBIREJO, NGAWEN, GUNUNGKIDUL, DAERAH ISTIMEWA YOGYAKARTA",3,104,39,143
https://kawalpemilu.org#42179,"SAMBIREJO, NGAWEN, GUNUNGKIDUL, DAERAH ISTIMEWA YOGYAKARTA",4,132,36,168
https://kawalpemilu.org#42179,"SAMBIREJO, NGAWEN, GUNUNGKIDUL, DAERAH ISTIMEWA YOGYAKARTA",5,141,72,213
https://kawalpemilu.org#42179,"SAMBIREJO, NGAWEN, GUNUNGKIDUL, DAERAH ISTIMEWA YOGYAKARTA",6,166,20,186
https://kawalpemilu.org#42179,"SAMBIREJO, NGAWEN, GUNUNGKIDUL, DAERAH ISTIMEWA YOGYAKARTA",7,91,94,185
https://kawalpemilu.org#42179,"SAMBIREJO, NGAWEN, GUNUNGKIDUL, DAERAH ISTIMEWA YOGYAKARTA",8,124,78,202
https://kawalpemilu.org#42179,"SAMBIREJO, NGAWEN, GUNUNGKIDUL, DAERAH ISTIMEWA YOGYAKARTA",9,148,36,184
https://kawalpemilu.org#42179,"SAMBIREJO, NGAWEN, GUNUNGKIDUL, DAERAH ISTIMEWA YOGYAKARTA",10,122,71,193
https://kawalpemilu.org#42179,"SAMBIREJO, NGAWEN, GUNUNGKIDUL, DAERAH ISTIMEWA YOGYAKARTA",11,134,97,231
https://kawalpemilu.org#42179,"SAMBIREJO, NGAWEN, GUNUNGKIDUL, DAERAH ISTIMEWA YOGYAKARTA",12,127,81,208
https://kawalpemilu.org#42179,"SAMBIREJO, NGAWEN, GUNUNGKIDUL, DAERAH ISTIMEWA YOGYAKARTA",13,194,42,236
https://kawalpemilu.org#42179,"SAMBIREJO, NGAWEN, GUNUNGKIDUL, DAERAH ISTIMEWA YOGYAKARTA",14,220,24,244
https://kawalpemilu.org#42179,"SAMBIREJO, NGAWEN, GUNUNGKIDUL, DAERAH ISTIMEWA YOGYAKARTA",15,186,17,203
https://kawalpemilu.org#42179,"SAMBIREJO, NGAWEN, GUNUNGKIDUL, DAERAH ISTIMEWA YOGYAKARTA",16,186,15,201
https://kawalpemilu.org#42179,"SAMBIREJO, NGAWEN, GUNUNGKIDUL, DAERAH ISTIMEWA YOGYAKARTA",17,94,18,112
https://kawalpemilu.org#42179,"SAMBIREJO, NGAWEN, GUNUNGKIDUL, DAERAH ISTIMEWA YOGYAKARTA",18,158,15,173
https://kawalpemilu.org#42179,"SAMBIREJO, NGAWEN, GUNUNGKIDUL, DAERAH ISTIMEWA YOGYAKARTA",19,145,5,150
https://kawalpemilu.org#42179,"SAMBIREJO, NGAWEN, GUNUNGKIDUL, DAERAH ISTIMEWA YOGYAKARTA",20,95,48,143
https://kawalpemilu.org#42179,"SAMBIREJO, NGAWEN, GUNUNGKIDUL, DAERAH ISTIMEWA YOGYAKARTA",21,136,49,185
https://kawalpemilu.org#42179,"SAMBIREJO, NGAWEN, GUNUNGKIDUL, DAERAH ISTIMEWA YOGYAKARTA",22,146,19,165
https://kawalpemilu.org#42179,"SAMBIREJO, NGAWEN, GUNUNGKIDUL, DAERAH ISTIMEWA YOGYAKARTA",23,159,30,189
https://kawalpemilu.org#42179,"SAMBIREJO, NGAWEN, GUNUNGKIDUL, DAERAH ISTIMEWA YOGYAKARTA",24,147,45,192
https://kawalpemilu.org#42179,"SAMBIREJO, NGAWEN, GUNUNGKIDUL, DAERAH ISTIMEWA YOGYAKARTA",25,91,108,199
https://kawalpemilu.org#42180,"JURANGJERO, NGAWEN, GUNUNGKIDUL, DAERAH ISTIMEWA YOGYAKARTA",1,130,53,183
https://kawalpemilu.org#42180,"JURANGJERO, NGAWEN, GUNUNGKIDUL, DAERAH ISTIMEWA YOGYAKARTA",2,109,43,152
https://kawalpemilu.org#42180,"JURANGJERO, NGAWEN, GUNUNGKIDUL, DAERAH ISTIMEWA YOGYAKARTA",3,138,36,174
https://kawalpemilu.org#42180,"JURANGJERO, NGAWEN, GUNUNGKIDUL, DAERAH ISTIMEWA YOGYAKARTA",4,136,38,174
https://kawalpemilu.org#42180,"JURANGJERO, NGAWEN, GUNUNGKIDUL, DAERAH ISTIMEWA YOGYAKARTA",5,130,72,202
https://kawalpemilu.org#42180,"JURANGJERO, NGAWEN, GUNUNGKIDUL, DAERAH ISTIMEWA YOGYAKARTA",6,127,66,193
https://kawalpemilu.org#42180,"JURANGJERO, NGAWEN, GUNUNGKIDUL, DAERAH ISTIMEWA YOGYAKARTA",7,157,46,203
https://kawalpemilu.org#42180,"JURANGJERO, NGAWEN, GUNUNGKIDUL, DAERAH ISTIMEWA YOGYAKARTA",8,101,49,150
https://kawalpemilu.org#42180,"JURANGJERO, NGAWEN, GUNUNGKIDUL, DAERAH ISTIMEWA YOGYAKARTA",9,106,36,142
https://kawalpemilu.org#42180,"JURANGJERO, NGAWEN, GUNUNGKIDUL, DAERAH ISTIMEWA YOGYAKARTA",10,135,29,164
https://kawalpemilu.org#42180,"JURANGJERO, NGAWEN, GUNUNGKIDUL, DAERAH ISTIMEWA YOGYAKARTA",11,122,21,143
https://kawalpemilu.org#42180,"JURANGJERO, NGAWEN, GUNUNGKIDUL, DAERAH ISTIMEWA YOGYAKARTA",12,123,48,171
https://kawalpemilu.org#42180,"JURANGJERO, NGAWEN, GUNUNGKIDUL, DAERAH ISTIMEWA YOGYAKARTA",13,175,26,201
https://kawalpemilu.org#42180,"JURANGJERO, NGAWEN, GUNUNGKIDUL, DAERAH ISTIMEWA YOGYAKARTA",14,200,21,221
https://kawalpemilu.org#42180,"JURANGJERO, NGAWEN, GUNUNGKIDUL, DAERAH ISTIMEWA YOGYAKARTA",15,127,19,146
https://kawalpemilu.org#42180,"JURANGJERO, NGAWEN, GUNUNGKIDUL, DAERAH ISTIMEWA YOGYAKARTA",16,157,16,173
https://kawalpemilu.org#42180,"JURANGJERO, NGAWEN, GUNUNGKIDUL, DAERAH ISTIMEWA YOGYAKARTA",17,122,21,143
https://kawalpemilu.org#42181,"KAMPUNG, NGAWEN, GUNUNGKIDUL, DAERAH ISTIMEWA YOGYAKARTA",1,118,31,149
https://kawalpemilu.org#42181,"KAMPUNG, NGAWEN, GUNUNGKIDUL, DAERAH ISTIMEWA YOGYAKARTA",2,90,41,131
https://kawalpemilu.org#42181,"KAMPUNG, NGAWEN, GUNUNGKIDUL, DAERAH ISTIMEWA YOGYAKARTA",3,139,43,182
https://kawalpemilu.org#42181,"KAMPUNG, NGAWEN, GUNUNGKIDUL, DAERAH ISTIMEWA YOGYAKARTA",4,127,54,181
https://kawalpemilu.org#42181,"KAMPUNG, NGAWEN, GUNUNGKIDUL, DAERAH ISTIMEWA YOGYAKARTA",5,157,20,177
https://kawalpemilu.org#42181,"KAMPUNG, NGAWEN, GUNUNGKIDUL, DAERAH ISTIMEWA YOGYAKARTA",6,73,36,109
https://kawalpemilu.org#42181,"KAMPUNG, NGAWEN, GUNUNGKIDUL, DAERAH ISTIMEWA YOGYAKARTA",7,179,41,220
https://kawalpemilu.org#42181,"KAMPUNG, NGAWEN, GUNUNGKIDUL, DAERAH ISTIMEWA YOGYAKARTA",8,184,37,221
https://kawalpemilu.org#42181,"KAMPUNG, NGAWEN, GUNUNGKIDUL, DAERAH ISTIMEWA YOGYAKARTA",9,152,27,179
https://kawalpemilu.org#42181,"KAMPUNG, NGAWEN, GUNUNGKIDUL, DAERAH ISTIMEWA YOGYAKARTA",10,195,22,217
https://kawalpemilu.org#42181,"KAMPUNG, NGAWEN, GUNUNGKIDUL, DAERAH ISTIMEWA YOGYAKARTA",11,139,29,168
https://kawalpemilu.org#42181,"KAMPUNG, NGAWEN, GUNUNGKIDUL, DAERAH ISTIMEWA YOGYAKARTA",12,138,39,177
https://kawalpemilu.org#42181,"KAMPUNG, NGAWEN, GUNUNGKIDUL, DAERAH ISTIMEWA YOGYAKARTA",13,114,19,133
https://kawalpemilu.org#42181,"KAMPUNG, NGAWEN, GUNUNGKIDUL, DAERAH ISTIMEWA YOGYAKARTA",14,131,30,161
https://kawalpemilu.org#42181,"KAMPUNG, NGAWEN, GUNUNGKIDUL, DAERAH ISTIMEWA YOGYAKARTA",15,121,22,143
https://kawalpemilu.org#42181,"KAMPUNG, NGAWEN, GUNUNGKIDUL, DAERAH ISTIMEWA YOGYAKARTA",16,102,15,117
https://kawalpemilu.org#42181,"KAMPUNG, NGAWEN, GUNUNGKIDUL, DAERAH ISTIMEWA YOGYAKARTA",17,117,25,142
https://kawalpemilu.org#42181,"KAMPUNG, NGAWEN, GUNUNGKIDUL, DAERAH ISTIMEWA YOGYAKARTA",18,90,48,138
https://kawalpemilu.org#42181,"KAMPUNG, NGAWEN, GUNUNGKIDUL, DAERAH ISTIMEWA YOGYAKARTA",19,136,28,164
https://kawalpemilu.org#42181,"KAMPUNG, NGAWEN, GUNUNGKIDUL, DAERAH ISTIMEWA YOGYAKARTA",20,115,22,137
https://kawalpemilu.org#42181,"KAMPUNG, NGAWEN, GUNUNGKIDUL, DAERAH ISTIMEWA YOGYAKARTA",21,76,24,100
https://kawalpemilu.org#42181,"KAMPUNG, NGAWEN, GUNUNGKIDUL, DAERAH ISTIMEWA YOGYAKARTA",22,98,24,122
https://kawalpemilu.org#42181,"KAMPUNG, NGAWEN, GUNUNGKIDUL, DAERAH ISTIMEWA YOGYAKARTA",23,135,84,219
https://kawalpemilu.org#42181,"KAMPUNG, NGAWEN, GUNUNGKIDUL, DAERAH ISTIMEWA YOGYAKARTA",24,183,11,194
https://kawalpemilu.org#42181,"KAMPUNG, NGAWEN, GUNUNGKIDUL, DAERAH ISTIMEWA YOGYAKARTA",25,138,9,147
https://kawalpemilu.org#42181,"KAMPUNG, NGAWEN, GUNUNGKIDUL, DAERAH ISTIMEWA YOGYAKARTA",26,95,63,158
https://kawalpemilu.org#42181,"KAMPUNG, NGAWEN, GUNUNGKIDUL, DAERAH ISTIMEWA YOGYAKARTA",27,110,20,130
https://kawalpemilu.org#42182,"BEJI, NGAWEN, GUNUNGKIDUL, DAERAH ISTIMEWA YOGYAKARTA",1,167,23,190
https://kawalpemilu.org#42182,"BEJI, NGAWEN, GUNUNGKIDUL, DAERAH ISTIMEWA YOGYAKARTA",2,128,42,170
https://kawalpemilu.org#42182,"BEJI, NGAWEN, GUNUNGKIDUL, DAERAH ISTIMEWA YOGYAKARTA",3,122,37,159
https://kawalpemilu.org#42182,"BEJI, NGAWEN, GUNUNGKIDUL, DAERAH ISTIMEWA YOGYAKARTA",4,109,15,124
https://kawalpemilu.org#42182,"BEJI, NGAWEN, GUNUNGKIDUL, DAERAH ISTIMEWA YOGYAKARTA",5,149,43,192
https://kawalpemilu.org#42182,"BEJI, NGAWEN, GUNUNGKIDUL, DAERAH ISTIMEWA YOGYAKARTA",6,156,59,215
https://kawalpemilu.org#42182,"BEJI, NGAWEN, GUNUNGKIDUL, DAERAH ISTIMEWA YOGYAKARTA",7,119,57,176
https://kawalpemilu.org#42182,"BEJI, NGAWEN, GUNUNGKIDUL, DAERAH ISTIMEWA YOGYAKARTA",8,86,8,94
https://kawalpemilu.org#42182,"BEJI, NGAWEN, GUNUNGKIDUL, DAERAH ISTIMEWA YOGYAKARTA",9,138,26,164
https://kawalpemilu.org#42182,"BEJI, NGAWEN, GUNUNGKIDUL, DAERAH ISTIMEWA YOGYAKARTA",10,149,26,175
https://kawalpemilu.org#42182,"BEJI, NGAWEN, GUNUNGKIDUL, DAERAH ISTIMEWA YOGYAKARTA",11,112,47,159
https://kawalpemilu.org#42182,"BEJI, NGAWEN, GUNUNGKIDUL, DAERAH ISTIMEWA YOGYAKARTA",12,149,39,188
https://kawalpemilu.org#42182,"BEJI, NGAWEN, GUNUNGKIDUL, DAERAH ISTIMEWA YOGYAKARTA",13,102,22,124
https://kawalpemilu.org#42182,"BEJI, NGAWEN, GUNUNGKIDUL, DAERAH ISTIMEWA YOGYAKARTA",14,63,21,84
https://kawalpemilu.org#42182,"BEJI, NGAWEN, GUNUNGKIDUL, DAERAH ISTIMEWA YOGYAKARTA",15,102,15,117
https://kawalpemilu.org#42182,"BEJI, NGAWEN, GUNUNGKIDUL, DAERAH ISTIMEWA YOGYAKARTA",16,111,47,158
https://kawalpemilu.org#42182,"BEJI, NGAWEN, GUNUNGKIDUL, DAERAH ISTIMEWA YOGYAKARTA",17,144,22,136
https://kawalpemilu.org#42183,"WATUSIGAR, NGAWEN, GUNUNGKIDUL, DAERAH ISTIMEWA YOGYAKARTA",1,162,26,188
https://kawalpemilu.org#42183,"WATUSIGAR, NGAWEN, GUNUNGKIDUL, DAERAH ISTIMEWA YOGYAKARTA",2,129,18,147
https://kawalpemilu.org#42183,"WATUSIGAR, NGAWEN, GUNUNGKIDUL, DAERAH ISTIMEWA YOGYAKARTA",3,127,14,141
https://kawalpemilu.org#42183,"WATUSIGAR, NGAWEN, GUNUNGKIDUL, DAERAH ISTIMEWA YOGYAKARTA",4,186,53,239
https://kawalpemilu.org#42183,"WATUSIGAR, NGAWEN, GUNUNGKIDUL, DAERAH ISTIMEWA YOGYAKARTA",5,188,38,226
https://kawalpemilu.org#42183,"WATUSIGAR, NGAWEN, GUNUNGKIDUL, DAERAH ISTIMEWA YOGYAKARTA",6,197,27,224
https://kawalpemilu.org#42183,"WATUSIGAR, NGAWEN, GUNUNGKIDUL, DAERAH ISTIMEWA YOGYAKARTA",7,174,18,192
https://kawalpemilu.org#42183,"WATUSIGAR, NGAWEN, GUNUNGKIDUL, DAERAH ISTIMEWA YOGYAKARTA",8,136,21,157
https://kawalpemilu.org#42183,"WATUSIGAR, NGAWEN, GUNUNGKIDUL, DAERAH ISTIMEWA YOGYAKARTA",9,115,30,145
https://kawalpemilu.org#42183,"WATUSIGAR, NGAWEN, GUNUNGKIDUL, DAERAH ISTIMEWA YOGYAKARTA",10,188,40,228
https://kawalpemilu.org#42183,"WATUSIGAR, NGAWEN, GUNUNGKIDUL, DAERAH ISTIMEWA YOGYAKARTA",11,139,29,168
https://kawalpemilu.org#42183,"WATUSIGAR, NGAWEN, GUNUNGKIDUL, DAERAH ISTIMEWA YOGYAKARTA",12,141,57,198
https://kawalpemilu.org#42183,"WATUSIGAR, NGAWEN, GUNUNGKIDUL, DAERAH ISTIMEWA YOGYAKARTA",13,140,17,157
https://kawalpemilu.org#42183,"WATUSIGAR, NGAWEN, GUNUNGKIDUL, DAERAH ISTIMEWA YOGYAKARTA",14,203,24,227
https://kawalpemilu.org#42183,"WATUSIGAR, NGAWEN, GUNUNGKIDUL, DAERAH ISTIMEWA YOGYAKARTA",15,124,24,148
https://kawalpemilu.org#42183,"WATUSIGAR, NGAWEN, GUNUNGKIDUL, DAERAH ISTIMEWA YOGYAKARTA",16,120,43,163
https://kawalpemilu.org#42183,"WATUSIGAR, NGAWEN, GUNUNGKIDUL, DAERAH ISTIMEWA YOGYAKARTA",17,123,35,158
https://kawalpemilu.org#42183,"WATUSIGAR, NGAWEN, GUNUNGKIDUL, DAERAH ISTIMEWA YOGYAKARTA",18,89,16,105
https://kawalpemilu.org#42183,"WATUSIGAR, NGAWEN, GUNUNGKIDUL, DAERAH ISTIMEWA YOGYAKARTA",19,168,19,183
https://kawalpemilu.org#42183,"WATUSIGAR, NGAWEN, GUNUNGKIDUL, DAERAH ISTIMEWA YOGYAKARTA",20,82,14,96
https://kawalpemilu.org#42185,"HARGOMULYO, GEDANGSARI, GUNUNGKIDUL, DAERAH ISTIMEWA YOGYAKARTA",1,97,102,199
https://kawalpemilu.org#42185,"HARGOMULYO, GEDANGSARI, GUNUNGKIDUL, DAERAH ISTIMEWA YOGYAKARTA",2,128,58,186
https://kawalpemilu.org#42185,"HARGOMULYO, GEDANGSARI, GUNUNGKIDUL, DAERAH ISTIMEWA YOGYAKARTA",3,162,36,198
https://kawalpemilu.org#42185,"HARGOMULYO, GEDANGSARI, GUNUNGKIDUL, DAERAH ISTIMEWA YOGYAKARTA",4,150,55,205
https://kawalpemilu.org#42185,"HARGOMULYO, GEDANGSARI, GUNUNGKIDUL, DAERAH ISTIMEWA YOGYAKARTA",5,130,23,153
https://kawalpemilu.org#42185,"HARGOMULYO, GEDANGSARI, GUNUNGKIDUL, DAERAH ISTIMEWA YOGYAKARTA",6,177,55,232
https://kawalpemilu.org#42185,"HARGOMULYO, GEDANGSARI, GUNUNGKIDUL, DAERAH ISTIMEWA YOGYAKARTA",7,188,36,224
https://kawalpemilu.org#42185,"HARGOMULYO, GEDANGSARI, GUNUNGKIDUL, DAERAH ISTIMEWA YOGYAKARTA",8,191,10,201
https://kawalpemilu.org#42185,"HARGOMULYO, GEDANGSARI, GUNUNGKIDUL, DAERAH ISTIMEWA YOGYAKARTA",9,203,10,213
https://kawalpemilu.org#42185,"HARGOMULYO, GEDANGSARI, GUNUNGKIDUL, DAERAH ISTIMEWA YOGYAKARTA",10,219,3,222
https://kawalpemilu.org#42185,"HARGOMULYO, GEDANGSARI, GUNUNGKIDUL, DAERAH ISTIMEWA YOGYAKARTA",11,111,55,166
https://kawalpemilu.org#42185,"HARGOMULYO, GEDANGSARI, GUNUNGKIDUL, DAERAH ISTIMEWA YOGYAKARTA",12,138,51,189
https://kawalpemilu.org#42185,"HARGOMULYO, GEDANGSARI, GUNUNGKIDUL, DAERAH ISTIMEWA YOGYAKARTA",13,167,33,200
https://kawalpemilu.org#42185,"HARGOMULYO, GEDANGSARI, GUNUNGKIDUL, DAERAH ISTIMEWA YOGYAKARTA",14,175,25,204
https://kawalpemilu.org#42185,"HARGOMULYO, GEDANGSARI, GUNUNGKIDUL, DAERAH ISTIMEWA YOGYAKARTA",15,152,34,186
https://kawalpemilu.org#42185,"HARGOMULYO, GEDANGSARI, GUNUNGKIDUL, DAERAH ISTIMEWA YOGYAKARTA",16,148,16,164
https://kawalpemilu.org#42185,"HARGOMULYO, GEDANGSARI, GUNUNGKIDUL, DAERAH ISTIMEWA YOGYAKARTA",17,124,19,143
https://kawalpemilu.org#42185,"HARGOMULYO, GEDANGSARI, GUNUNGKIDUL, DAERAH ISTIMEWA YOGYAKARTA",18,190,15,205
https://kawalpemilu.org#42185,"HARGOMULYO, GEDANGSARI, GUNUNGKIDUL, DAERAH ISTIMEWA YOGYAKARTA",19,167,16,183
https://kawalpemilu.org#42185,"HARGOMULYO, GEDANGSARI, GUNUNGKIDUL, DAERAH ISTIMEWA YOGYAKARTA",20,135,13,148
https://kawalpemilu.org#42185,"HARGOMULYO, GEDANGSARI, GUNUNGKIDUL, DAERAH ISTIMEWA YOGYAKARTA",21,185,3,188
https://kawalpemilu.org#42185,"HARGOMULYO, GEDANGSARI, GUNUNGKIDUL, DAERAH ISTIMEWA YOGYAKARTA",22,155,7,162
https://kawalpemilu.org#42185,"HARGOMULYO, GEDANGSARI, GUNUNGKIDUL, DAERAH ISTIMEWA YOGYAKARTA",23,179,16,195
https://kawalpemilu.org#42185,"HARGOMULYO, GEDANGSARI, GUNUNGKIDUL, DAERAH ISTIMEWA YOGYAKARTA",24,147,13,160
https://kawalpemilu.org#42186,"MERTELU, GEDANGSARI, GUNUNGKIDUL, DAERAH ISTIMEWA YOGYAKARTA",1,122,61,183
https://kawalpemilu.org#42186,"MERTELU, GEDANGSARI, GUNUNGKIDUL, DAERAH ISTIMEWA YOGYAKARTA",2,129,53,182
https://kawalpemilu.org#42186,"MERTELU, GEDANGSARI, GUNUNGKIDUL, DAERAH ISTIMEWA YOGYAKARTA",3,144,63,207
https://kawalpemilu.org#42186,"MERTELU, GEDANGSARI, GUNUNGKIDUL, DAERAH ISTIMEWA YOGYAKARTA",4,138,44,182
https://kawalpemilu.org#42186,"MERTELU, GEDANGSARI, GUNUNGKIDUL, DAERAH ISTIMEWA YOGYAKARTA",5,152,75,227
https://kawalpemilu.org#42186,"MERTELU, GEDANGSARI, GUNUNGKIDUL, DAERAH ISTIMEWA YOGYAKARTA",6,180,32,212
https://kawalpemilu.org#42186,"MERTELU, GEDANGSARI, GUNUNGKIDUL, DAERAH ISTIMEWA YOGYAKARTA",7,136,102,238
https://kawalpemilu.org#42186,"MERTELU, GEDANGSARI, GUNUNGKIDUL, DAERAH ISTIMEWA YOGYAKARTA",8,124,94,218
https://kawalpemilu.org#42186,"MERTELU, GEDANGSARI, GUNUNGKIDUL, DAERAH ISTIMEWA YOGYAKARTA",9,200,13,213
https://kawalpemilu.org#42186,"MERTELU, GEDANGSARI, GUNUNGKIDUL, DAERAH ISTIMEWA YOGYAKARTA",10,186,35,221
https://kawalpemilu.org#42186,"MERTELU, GEDANGSARI, GUNUNGKIDUL, DAERAH ISTIMEWA YOGYAKARTA",11,149,61,210
https://kawalpemilu.org#42186,"MERTELU, GEDANGSARI, GUNUNGKIDUL, DAERAH ISTIMEWA YOGYAKARTA",12,78,32,110
https://kawalpemilu.org#42187,"WATUGAJAH, GEDANGSARI, GUNUNGKIDUL, DAERAH ISTIMEWA YOGYAKARTA",1,154,12,166
https://kawalpemilu.org#42187,"WATUGAJAH, GEDANGSARI, GUNUNGKIDUL, DAERAH ISTIMEWA YOGYAKARTA",2,166,6,172
https://kawalpemilu.org#42187,"WATUGAJAH, GEDANGSARI, GUNUNGKIDUL, DAERAH ISTIMEWA YOGYAKARTA",3,157,4,161
https://kawalpemilu.org#42187,"WATUGAJAH, GEDANGSARI, GUNUNGKIDUL, DAERAH ISTIMEWA YOGYAKARTA",4,144,39,183
https://kawalpemilu.org#42187,"WATUGAJAH, GEDANGSARI, GUNUNGKIDUL, DAERAH ISTIMEWA YOGYAKARTA",5,153,31,184
https://kawalpemilu.org#42187,"WATUGAJAH, GEDANGSARI, GUNUNGKIDUL, DAERAH ISTIMEWA YOGYAKARTA",6,206,30,236
https://kawalpemilu.org#42187,"WATUGAJAH, GEDANGSARI, GUNUNGKIDUL, DAERAH ISTIMEWA YOGYAKARTA",7,172,16,188
https://kawalpemilu.org#42187,"WATUGAJAH, GEDANGSARI, GUNUNGKIDUL, DAERAH ISTIMEWA YOGYAKARTA",8,168,14,182
https://kawalpemilu.org#42187,"WATUGAJAH, GEDANGSARI, GUNUNGKIDUL, DAERAH ISTIMEWA YOGYAKARTA",9,163,24,187
https://kawalpemilu.org#42187,"WATUGAJAH, GEDANGSARI, GUNUNGKIDUL, DAERAH ISTIMEWA YOGYAKARTA",10,220,16,236
https://kawalpemilu.org#42187,"WATUGAJAH, GEDANGSARI, GUNUNGKIDUL, DAERAH ISTIMEWA YOGYAKARTA",11,121,33,154
https://kawalpemilu.org#42187,"WATUGAJAH, GEDANGSARI, GUNUNGKIDUL, DAERAH ISTIMEWA YOGYAKARTA",12,142,31,173
https://kawalpemilu.org#42187,"WATUGAJAH, GEDANGSARI, GUNUNGKIDUL, DAERAH ISTIMEWA YOGYAKARTA",13,93,25,118
https://kawalpemilu.org#42187,"WATUGAJAH, GEDANGSARI, GUNUNGKIDUL, DAERAH ISTIMEWA YOGYAKARTA",14,89,26,115
https://kawalpemilu.org#42188,"SAMPANG, GEDANGSARI, GUNUNGKIDUL, DAERAH ISTIMEWA YOGYAKARTA",1,144,68,212
https://kawalpemilu.org#42188,"SAMPANG, GEDANGSARI, GUNUNGKIDUL, DAERAH ISTIMEWA YOGYAKARTA",2,156,55,211
https://kawalpemilu.org#42188,"SAMPANG, GEDANGSARI, GUNUNGKIDUL, DAERAH ISTIMEWA YOGYAKARTA",3,153,37,190
https://kawalpemilu.org#42188,"SAMPANG, GEDANGSARI, GUNUNGKIDUL, DAERAH ISTIMEWA YOGYAKARTA",4,145,41,186
https://kawalpemilu.org#42188,"SAMPANG, GEDANGSARI, GUNUNGKIDUL, DAERAH ISTIMEWA YOGYAKARTA",5,188,24,212
https://kawalpemilu.org#42188,"SAMPANG, GEDANGSARI, GUNUNGKIDUL, DAERAH ISTIMEWA YOGYAKARTA",6,149,33,182
https://kawalpemilu.org#42188,"SAMPANG, GEDANGSARI, GUNUNGKIDUL, DAERAH ISTIMEWA YOGYAKARTA",7,154,28,182
https://kawalpemilu.org#42188,"SAMPANG, GEDANGSARI, GUNUNGKIDUL, DAERAH ISTIMEWA YOGYAKARTA",8,152,12,164
https://kawalpemilu.org#42188,"SAMPANG, GEDANGSARI, GUNUNGKIDUL, DAERAH ISTIMEWA YOGYAKARTA",9,189,16,205
https://kawalpemilu.org#42189,"SERUT, GEDANGSARI, GUNUNGKIDUL, DAERAH ISTIMEWA YOGYAKARTA",1,160,50,210
https://kawalpemilu.org#42189,"SERUT, GEDANGSARI, GUNUNGKIDUL, DAERAH ISTIMEWA YOGYAKARTA",2,136,34,170
https://kawalpemilu.org#42189,"SERUT, GEDANGSARI, GUNUNGKIDUL, DAERAH ISTIMEWA YOGYAKARTA",3,161,21,182
https://kawalpemilu.org#42189,"SERUT, GEDANGSARI, GUNUNGKIDUL, DAERAH ISTIMEWA YOGYAKARTA",4,157,15,172
https://kawalpemilu.org#42189,"SERUT, GEDANGSARI, GUNUNGKIDUL, DAERAH ISTIMEWA YOGYAKARTA",5,141,13,154
https://kawalpemilu.org#42189,"SERUT, GEDANGSARI, GUNUNGKIDUL, DAERAH ISTIMEWA YOGYAKARTA",6,200,40,240
https://kawalpemilu.org#42189,"SERUT, GEDANGSARI, GUNUNGKIDUL, DAERAH ISTIMEWA YOGYAKARTA",7,209,11,220
https://kawalpemilu.org#42189,"SERUT, GEDANGSARI, GUNUNGKIDUL, DAERAH ISTIMEWA YOGYAKARTA",8,224,7,231
https://kawalpemilu.org#42189,"SERUT, GEDANGSARI, GUNUNGKIDUL, DAERAH ISTIMEWA YOGYAKARTA",9,136,20,156
https://kawalpemilu.org#42189,"SERUT, GEDANGSARI, GUNUNGKIDUL, DAERAH ISTIMEWA YOGYAKARTA",10,130,35,165
https://kawalpemilu.org#42189,"SERUT, GEDANGSARI, GUNUNGKIDUL, DAERAH ISTIMEWA YOGYAKARTA",11,179,39,218
https://kawalpemilu.org#42189,"SERUT, GEDANGSARI, GUNUNGKIDUL, DAERAH ISTIMEWA YOGYAKARTA",12,86,31,117
https://kawalpemilu.org#42189,"SERUT, GEDANGSARI, GUNUNGKIDUL, DAERAH ISTIMEWA YOGYAKARTA",13,155,30,185
https://kawalpemilu.org#42189,"SERUT, GEDANGSARI, GUNUNGKIDUL, DAERAH ISTIMEWA YOGYAKARTA",14,190,33,223
https://kawalpemilu.org#42189,"SERUT, GEDANGSARI, GUNUNGKIDUL, DAERAH ISTIMEWA YOGYAKARTA",15,169,11,180
https://kawalpemilu.org#42189,"SERUT, GEDANGSARI, GUNUNGKIDUL, DAERAH ISTIMEWA YOGYAKARTA",16,158,12,170
https://kawalpemilu.org#42189,"SERUT, GEDANGSARI, GUNUNGKIDUL, DAERAH ISTIMEWA YOGYAKARTA",17,97,35,132
https://kawalpemilu.org#42189,"SERUT, GEDANGSARI, GUNUNGKIDUL, DAERAH ISTIMEWA YOGYAKARTA",18,126,31,157
https://kawalpemilu.org#42190,"NGALANG, GEDANGSARI, GUNUNGKIDUL, DAERAH ISTIMEWA YOGYAKARTA",1,146,8,154
https://kawalpemilu.org#42190,"NGALANG, GEDANGSARI, GUNUNGKIDUL, DAERAH ISTIMEWA YOGYAKARTA",2,145,22,167
https://kawalpemilu.org#42190,"NGALANG, GEDANGSARI, GUNUNGKIDUL, DAERAH ISTIMEWA YOGYAKARTA",3,167,20,187
https://kawalpemilu.org#42190,"NGALANG, GEDANGSARI, GUNUNGKIDUL, DAERAH ISTIMEWA YOGYAKARTA",4,168,42,210
https://kawalpemilu.org#42190,"NGALANG, GEDANGSARI, GUNUNGKIDUL, DAERAH ISTIMEWA YOGYAKARTA",5,116,44,160
https://kawalpemilu.org#42190,"NGALANG, GEDANGSARI, GUNUNGKIDUL, DAERAH ISTIMEWA YOGYAKARTA",6,120,71,191
https://kawalpemilu.org#42190,"NGALANG, GEDANGSARI, GUNUNGKIDUL, DAERAH ISTIMEWA YOGYAKARTA",7,131,44,181
https://kawalpemilu.org#42190,"NGALANG, GEDANGSARI, GUNUNGKIDUL, DAERAH ISTIMEWA YOGYAKARTA",8,168,24,192
https://kawalpemilu.org#42190,"NGALANG, GEDANGSARI, GUNUNGKIDUL, DAERAH ISTIMEWA YOGYAKARTA",9,170,18,188
https://kawalpemilu.org#42190,"NGALANG, GEDANGSARI, GUNUNGKIDUL, DAERAH ISTIMEWA YOGYAKARTA",10,168,17,185
https://kawalpemilu.org#42190,"NGALANG, GEDANGSARI, GUNUNGKIDUL, DAERAH ISTIMEWA YOGYAKARTA",11,167,20,187
https://kawalpemilu.org#42190,"NGALANG, GEDANGSARI, GUNUNGKIDUL, DAERAH ISTIMEWA YOGYAKARTA",12,119,47,166
https://kawalpemilu.org#42190,"NGALANG, GEDANGSARI, GUNUNGKIDUL, DAERAH ISTIMEWA YOGYAKARTA",13,176,23,199
https://kawalpemilu.org#42190,"NGALANG, GEDANGSARI, GUNUNGKIDUL, DAERAH ISTIMEWA YOGYAKARTA",14,128,23,151
https://kawalpemilu.org#42190,"NGALANG, GEDANGSARI, GUNUNGKIDUL, DAERAH ISTIMEWA YOGYAKARTA",15,100,27,127
https://kawalpemilu.org#42190,"NGALANG, GEDANGSARI, GUNUNGKIDUL, DAERAH ISTIMEWA YOGYAKARTA",16,134,34,168
https://kawalpemilu.org#42190,"NGALANG, GEDANGSARI, GUNUNGKIDUL, DAERAH ISTIMEWA YOGYAKARTA",17,149,17,166
https://kawalpemilu.org#42190,"NGALANG, GEDANGSARI, GUNUNGKIDUL, DAERAH ISTIMEWA YOGYAKARTA",18,105,42,147
https://kawalpemilu.org#42190,"NGALANG, GEDANGSARI, GUNUNGKIDUL, DAERAH ISTIMEWA YOGYAKARTA",19,163,71,234
https://kawalpemilu.org#42190,"NGALANG, GEDANGSARI, GUNUNGKIDUL, DAERAH ISTIMEWA YOGYAKARTA",20,143,40,183
https://kawalpemilu.org#42190,"NGALANG, GEDANGSARI, GUNUNGKIDUL, DAERAH ISTIMEWA YOGYAKARTA",21,141,41,182
https://kawalpemilu.org#42190,"NGALANG, GEDANGSARI, GUNUNGKIDUL, DAERAH ISTIMEWA YOGYAKARTA",22,93,23,116
https://kawalpemilu.org#42190,"NGALANG, GEDANGSARI, GUNUNGKIDUL, DAERAH ISTIMEWA YOGYAKARTA",23,135,17,152
https://kawalpemilu.org#42190,"NGALANG, GEDANGSARI, GUNUNGKIDUL, DAERAH ISTIMEWA YOGYAKARTA",24,129,33,162
https://kawalpemilu.org#42190,"NGALANG, GEDANGSARI, GUNUNGKIDUL, DAERAH ISTIMEWA YOGYAKARTA",25,144,27,171
https://kawalpemilu.org#42190,"NGALANG, GEDANGSARI, GUNUNGKIDUL, DAERAH ISTIMEWA YOGYAKARTA",26,148,12,160
https://kawalpemilu.org#42190,"NGALANG, GEDANGSARI, GUNUNGKIDUL, DAERAH ISTIMEWA YOGYAKARTA",27,164,38,202
https://kawalpemilu.org#42190,"NGALANG, GEDANGSARI, GUNUNGKIDUL, DAERAH ISTIMEWA YOGYAKARTA",28,140,25,165
https://kawalpemilu.org#42190,"NGALANG, GEDANGSARI, GUNUNGKIDUL, DAERAH ISTIMEWA YOGYAKARTA",29,180,40,220
https://kawalpemilu.org#42190,"NGALANG, GEDANGSARI, GUNUNGKIDUL, DAERAH ISTIMEWA YOGYAKARTA",30,99,9,108
https://kawalpemilu.org#42190,"NGALANG, GEDANGSARI, GUNUNGKIDUL, DAERAH ISTIMEWA YOGYAKARTA",31,177,24,201
https://kawalpemilu.org#42191,"TEGALREJO, GEDANGSARI, GUNUNGKIDUL, DAERAH ISTIMEWA YOGYAKARTA",1,146,28,174
https://kawalpemilu.org#42191,"TEGALREJO, GEDANGSARI, GUNUNGKIDUL, DAERAH ISTIMEWA YOGYAKARTA",2,210,13,223
https://kawalpemilu.org#42191,"TEGALREJO, GEDANGSARI, GUNUNGKIDUL, DAERAH ISTIMEWA YOGYAKARTA",4,154,13,167
https://kawalpemilu.org#42191,"TEGALREJO, GEDANGSARI, GUNUNGKIDUL, DAERAH ISTIMEWA YOGYAKARTA",5,109,13,122
https://kawalpemilu.org#42191,"TEGALREJO, GEDANGSARI, GUNUNGKIDUL, DAERAH ISTIMEWA YOGYAKARTA",6,243,15,258
https://kawalpemilu.org#42191,"TEGALREJO, GEDANGSARI, GUNUNGKIDUL, DAERAH ISTIMEWA YOGYAKARTA",7,199,18,217
https://kawalpemilu.org#42191,"TEGALREJO, GEDANGSARI, GUNUNGKIDUL, DAERAH ISTIMEWA YOGYAKARTA",8,150,12,162
https://kawalpemilu.org#42191,"TEGALREJO, GEDANGSARI, GUNUNGKIDUL, DAERAH ISTIMEWA YOGYAKARTA",9,236,9,245
https://kawalpemilu.org#42191,"TEGALREJO, GEDANGSARI, GUNUNGKIDUL, DAERAH ISTIMEWA YOGYAKARTA",10,218,13,231
https://kawalpemilu.org#42191,"TEGALREJO, GEDANGSARI, GUNUNGKIDUL, DAERAH ISTIMEWA YOGYAKARTA",11,197,17,214
https://kawalpemilu.org#42191,"TEGALREJO, GEDANGSARI, GUNUNGKIDUL, DAERAH ISTIMEWA YOGYAKARTA",12,203,30,233
https://kawalpemilu.org#42191,"TEGALREJO, GEDANGSARI, GUNUNGKIDUL, DAERAH ISTIMEWA YOGYAKARTA",13,201,14,215
https://kawalpemilu.org#42191,"TEGALREJO, GEDANGSARI, GUNUNGKIDUL, DAERAH ISTIMEWA YOGYAKARTA",14,188,2,190
https://kawalpemilu.org#42191,"TEGALREJO, GEDANGSARI, GUNUNGKIDUL, DAERAH ISTIMEWA YOGYAKARTA",15,196,13,209
https://kawalpemilu.org#42191,"TEGALREJO, GEDANGSARI, GUNUNGKIDUL, DAERAH ISTIMEWA YOGYAKARTA",16,82,23,105
https://kawalpemilu.org#42191,"TEGALREJO, GEDANGSARI, GUNUNGKIDUL, DAERAH ISTIMEWA YOGYAKARTA",17,180,22,203
https://kawalpemilu.org#42191,"TEGALREJO, GEDANGSARI, GUNUNGKIDUL, DAERAH ISTIMEWA YOGYAKARTA",18,150,56,206
https://kawalpemilu.org#42191,"TEGALREJO, GEDANGSARI, GUNUNGKIDUL, DAERAH ISTIMEWA YOGYAKARTA",19,164,12,176
https://kawalpemilu.org#42191,"TEGALREJO, GEDANGSARI, GUNUNGKIDUL, DAERAH ISTIMEWA YOGYAKARTA",20,218,17,235
https://kawalpemilu.org#42191,"TEGALREJO, GEDANGSARI, GUNUNGKIDUL, DAERAH ISTIMEWA YOGYAKARTA",21,209,7,216
https://kawalpemilu.org#42191,"TEGALREJO, GEDANGSARI, GUNUNGKIDUL, DAERAH ISTIMEWA YOGYAKARTA",22,155,25,180
https://kawalpemilu.org#42191,"TEGALREJO, GEDANGSARI, GUNUNGKIDUL, DAERAH ISTIMEWA YOGYAKARTA",23,122,23,145
https://kawalpemilu.org#42193,"KRAMBILSAWIT, SAPTOSARI, GUNUNGKIDUL, DAERAH ISTIMEWA YOGYAKARTA",1,124,26,150
https://kawalpemilu.org#42193,"KRAMBILSAWIT, SAPTOSARI, GUNUNGKIDUL, DAERAH ISTIMEWA YOGYAKARTA",2,160,46,206
https://kawalpemilu.org#42193,"KRAMBILSAWIT, SAPTOSARI, GUNUNGKIDUL, DAERAH ISTIMEWA YOGYAKARTA",3,91,31,122
https://kawalpemilu.org#42193,"KRAMBILSAWIT, SAPTOSARI, GUNUNGKIDUL, DAERAH ISTIMEWA YOGYAKARTA",4,76,93,169
https://kawalpemilu.org#42193,"KRAMBILSAWIT, SAPTOSARI, GUNUNGKIDUL, DAERAH ISTIMEWA YOGYAKARTA",5,106,45,151
https://kawalpemilu.org#42193,"KRAMBILSAWIT, SAPTOSARI, GUNUNGKIDUL, DAERAH ISTIMEWA YOGYAKARTA",6,116,34,150
https://kawalpemilu.org#42193,"KRAMBILSAWIT, SAPTOSARI, GUNUNGKIDUL, DAERAH ISTIMEWA YOGYAKARTA",7,140,26,166
https://kawalpemilu.org#42193,"KRAMBILSAWIT, SAPTOSARI, GUNUNGKIDUL, DAERAH ISTIMEWA YOGYAKARTA",8,167,20,187
https://kawalpemilu.org#42193,"KRAMBILSAWIT, SAPTOSARI, GUNUNGKIDUL, DAERAH ISTIMEWA YOGYAKARTA",9,112,6,118
https://kawalpemilu.org#42193,"KRAMBILSAWIT, SAPTOSARI, GUNUNGKIDUL, DAERAH ISTIMEWA YOGYAKARTA",10,113,23,136
https://kawalpemilu.org#42193,"KRAMBILSAWIT, SAPTOSARI, GUNUNGKIDUL, DAERAH ISTIMEWA YOGYAKARTA",11,142,58,200
https://kawalpemilu.org#42193,"KRAMBILSAWIT, SAPTOSARI, GUNUNGKIDUL, DAERAH ISTIMEWA YOGYAKARTA",12,138,44,182
https://kawalpemilu.org#42193,"KRAMBILSAWIT, SAPTOSARI, GUNUNGKIDUL, DAERAH ISTIMEWA YOGYAKARTA",13,110,59,169
https://kawalpemilu.org#42193,"KRAMBILSAWIT, SAPTOSARI, GUNUNGKIDUL, DAERAH ISTIMEWA YOGYAKARTA",14,128,46,174
https://kawalpemilu.org#42193,"KRAMBILSAWIT, SAPTOSARI, GUNUNGKIDUL, DAERAH ISTIMEWA YOGYAKARTA",15,71,47,118
https://kawalpemilu.org#42193,"KRAMBILSAWIT, SAPTOSARI, GUNUNGKIDUL, DAERAH ISTIMEWA YOGYAKARTA",16,128,66,194
https://kawalpemilu.org#42193,"KRAMBILSAWIT, SAPTOSARI, GUNUNGKIDUL, DAERAH ISTIMEWA YOGYAKARTA",17,102,60,162
https://kawalpemilu.org#42193,"KRAMBILSAWIT, SAPTOSARI, GUNUNGKIDUL, DAERAH ISTIMEWA YOGYAKARTA",18,95,49,144
https://kawalpemilu.org#42193,"KRAMBILSAWIT, SAPTOSARI, GUNUNGKIDUL, DAERAH ISTIMEWA YOGYAKARTA",19,129,65,194
https://kawalpemilu.org#42193,"KRAMBILSAWIT, SAPTOSARI, GUNUNGKIDUL, DAERAH ISTIMEWA YOGYAKARTA",20,119,49,168
https://kawalpemilu.org#42193,"KRAMBILSAWIT, SAPTOSARI, GUNUNGKIDUL, DAERAH ISTIMEWA YOGYAKARTA",21,166,66,232
https://kawalpemilu.org#42193,"KRAMBILSAWIT, SAPTOSARI, GUNUNGKIDUL, DAERAH ISTIMEWA YOGYAKARTA",22,131,72,203
https://kawalpemilu.org#42193,"KRAMBILSAWIT, SAPTOSARI, GUNUNGKIDUL, DAERAH ISTIMEWA YOGYAKARTA",23,180,39,219
https://kawalpemilu.org#42193,"KRAMBILSAWIT, SAPTOSARI, GUNUNGKIDUL, DAERAH ISTIMEWA YOGYAKARTA",24,148,44,192
https://kawalpemilu.org#42194,"NGLORO, SAPTOSARI, GUNUNGKIDUL, DAERAH ISTIMEWA YOGYAKARTA",1,177,31,208
https://kawalpemilu.org#42194,"NGLORO, SAPTOSARI, GUNUNGKIDUL, DAERAH ISTIMEWA YOGYAKARTA",2,195,42,237
https://kawalpemilu.org#42194,"NGLORO, SAPTOSARI, GUNUNGKIDUL, DAERAH ISTIMEWA YOGYAKARTA",3,153,43,196
https://kawalpemilu.org#42194,"NGLORO, SAPTOSARI, GUNUNGKIDUL, DAERAH ISTIMEWA YOGYAKARTA",4,143,35,178
https://kawalpemilu.org#42194,"NGLORO, SAPTOSARI, GUNUNGKIDUL, DAERAH ISTIMEWA YOGYAKARTA",5,184,53,237
https://kawalpemilu.org#42194,"NGLORO, SAPTOSARI, GUNUNGKIDUL, DAERAH ISTIMEWA YOGYAKARTA",6,145,49,194
https://kawalpemilu.org#42194,"NGLORO, SAPTOSARI, GUNUNGKIDUL, DAERAH ISTIMEWA YOGYAKARTA",7,198,57,255
https://kawalpemilu.org#42194,"NGLORO, SAPTOSARI, GUNUNGKIDUL, DAERAH ISTIMEWA YOGYAKARTA",8,97,66,163
https://kawalpemilu.org#42194,"NGLORO, SAPTOSARI, GUNUNGKIDUL, DAERAH ISTIMEWA YOGYAKARTA",9,111,56,167
https://kawalpemilu.org#42194,"NGLORO, SAPTOSARI, GUNUNGKIDUL, DAERAH ISTIMEWA YOGYAKARTA",10,96,27,123
https://kawalpemilu.org#42194,"NGLORO, SAPTOSARI, GUNUNGKIDUL, DAERAH ISTIMEWA YOGYAKARTA",11,99,40,139
https://kawalpemilu.org#42194,"NGLORO, SAPTOSARI, GUNUNGKIDUL, DAERAH ISTIMEWA YOGYAKARTA",12,142,32,174
https://kawalpemilu.org#42194,"NGLORO, SAPTOSARI, GUNUNGKIDUL, DAERAH ISTIMEWA YOGYAKARTA",13,96,29,125
https://kawalpemilu.org#42195,"JETIS, SAPTOSARI, GUNUNGKIDUL, DAERAH ISTIMEWA YOGYAKARTA",1,131,86,217
https://kawalpemilu.org#42195,"JETIS, SAPTOSARI, GUNUNGKIDUL, DAERAH ISTIMEWA YOGYAKARTA",2,92,33,125
https://kawalpemilu.org#42195,"JETIS, SAPTOSARI, GUNUNGKIDUL, DAERAH ISTIMEWA YOGYAKARTA",3,160,35,195
https://kawalpemilu.org#42195,"JETIS, SAPTOSARI, GUNUNGKIDUL, DAERAH ISTIMEWA YOGYAKARTA",4,146,56,202
https://kawalpemilu.org#42195,"JETIS, SAPTOSARI, GUNUNGKIDUL, DAERAH ISTIMEWA YOGYAKARTA",5,141,81,222
https://kawalpemilu.org#42195,"JETIS, SAPTOSARI, GUNUNGKIDUL, DAERAH ISTIMEWA YOGYAKARTA",6,107,75,182
https://kawalpemilu.org#42195,"JETIS, SAPTOSARI, GUNUNGKIDUL, DAERAH ISTIMEWA YOGYAKARTA",7,160,64,224
https://kawalpemilu.org#42195,"JETIS, SAPTOSARI, GUNUNGKIDUL, DAERAH ISTIMEWA YOGYAKARTA",8,176,53,229
https://kawalpemilu.org#42195,"JETIS, SAPTOSARI, GUNUNGKIDUL, DAERAH ISTIMEWA YOGYAKARTA",9,193,43,236
https://kawalpemilu.org#42195,"JETIS, SAPTOSARI, GUNUNGKIDUL, DAERAH ISTIMEWA YOGYAKARTA",10,162,49,211
https://kawalpemilu.org#42195,"JETIS, SAPTOSARI, GUNUNGKIDUL, DAERAH ISTIMEWA YOGYAKARTA",11,138,73,211
https://kawalpemilu.org#42195,"JETIS, SAPTOSARI, GUNUNGKIDUL, DAERAH ISTIMEWA YOGYAKARTA",12,124,21,145
https://kawalpemilu.org#42195,"JETIS, SAPTOSARI, GUNUNGKIDUL, DAERAH ISTIMEWA YOGYAKARTA",13,122,50,172
https://kawalpemilu.org#42195,"JETIS, SAPTOSARI, GUNUNGKIDUL, DAERAH ISTIMEWA YOGYAKARTA",14,128,81,209
https://kawalpemilu.org#42195,"JETIS, SAPTOSARI, GUNUNGKIDUL, DAERAH ISTIMEWA YOGYAKARTA",15,112,72,184
https://kawalpemilu.org#42195,"JETIS, SAPTOSARI, GUNUNGKIDUL, DAERAH ISTIMEWA YOGYAKARTA",16,91,54,145
https://kawalpemilu.org#42195,"JETIS, SAPTOSARI, GUNUNGKIDUL, DAERAH ISTIMEWA YOGYAKARTA",17,186,28,214
https://kawalpemilu.org#42195,"JETIS, SAPTOSARI, GUNUNGKIDUL, DAERAH ISTIMEWA YOGYAKARTA",18,105,24,129
https://kawalpemilu.org#42196,"KEPEK, SAPTOSARI, GUNUNGKIDUL, DAERAH ISTIMEWA YOGYAKARTA",1,134,62,196
https://kawalpemilu.org#42196,"KEPEK, SAPTOSARI, GUNUNGKIDUL, DAERAH ISTIMEWA YOGYAKARTA",2,190,23,213
https://kawalpemilu.org#42196,"KEPEK, SAPTOSARI, GUNUNGKIDUL, DAERAH ISTIMEWA YOGYAKARTA",3,187,26,213
https://kawalpemilu.org#42196,"KEPEK, SAPTOSARI, GUNUNGKIDUL, DAERAH ISTIMEWA YOGYAKARTA",4,185,38,223
https://kawalpemilu.org#42196,"KEPEK, SAPTOSARI, GUNUNGKIDUL, DAERAH ISTIMEWA YOGYAKARTA",5,161,26,187
https://kawalpemilu.org#42196,"KEPEK, SAPTOSARI, GUNUNGKIDUL, DAERAH ISTIMEWA YOGYAKARTA",6,70,94,164
https://kawalpemilu.org#42196,"KEPEK, SAPTOSARI, GUNUNGKIDUL, DAERAH ISTIMEWA YOGYAKARTA",7,96,49,145
https://kawalpemilu.org#42196,"KEPEK, SAPTOSARI, GUNUNGKIDUL, DAERAH ISTIMEWA YOGYAKARTA",8,162,20,182
https://kawalpemilu.org#42196,"KEPEK, SAPTOSARI, GUNUNGKIDUL, DAERAH ISTIMEWA YOGYAKARTA",9,139,16,155
https://kawalpemilu.org#42196,"KEPEK, SAPTOSARI, GUNUNGKIDUL, DAERAH ISTIMEWA YOGYAKARTA",10,159,25,184
https://kawalpemilu.org#42196,"KEPEK, SAPTOSARI, GUNUNGKIDUL, DAERAH ISTIMEWA YOGYAKARTA",11,170,31,201
https://kawalpemilu.org#42196,"KEPEK, SAPTOSARI, GUNUNGKIDUL, DAERAH ISTIMEWA YOGYAKARTA",12,211,26,237
https://kawalpemilu.org#42196,"KEPEK, SAPTOSARI, GUNUNGKIDUL, DAERAH ISTIMEWA YOGYAKARTA",13,126,44,170
https://kawalpemilu.org#42196,"KEPEK, SAPTOSARI, GUNUNGKIDUL, DAERAH ISTIMEWA YOGYAKARTA",14,179,13,192
https://kawalpemilu.org#42196,"KEPEK, SAPTOSARI, GUNUNGKIDUL, DAERAH ISTIMEWA YOGYAKARTA",15,133,74,207
https://kawalpemilu.org#42196,"KEPEK, SAPTOSARI, GUNUNGKIDUL, DAERAH ISTIMEWA YOGYAKARTA",16,109,67,176
https://kawalpemilu.org#42196,"KEPEK, SAPTOSARI, GUNUNGKIDUL, DAERAH ISTIMEWA YOGYAKARTA",17,78,82,160
https://kawalpemilu.org#42196,"KEPEK, SAPTOSARI, GUNUNGKIDUL, DAERAH ISTIMEWA YOGYAKARTA",18,109,106,215
https://kawalpemilu.org#42196,"KEPEK, SAPTOSARI, GUNUNGKIDUL, DAERAH ISTIMEWA YOGYAKARTA",19,145,53,198
https://kawalpemilu.org#42196,"KEPEK, SAPTOSARI, GUNUNGKIDUL, DAERAH ISTIMEWA YOGYAKARTA",20,152,48,200
https://kawalpemilu.org#42196,"KEPEK, SAPTOSARI, GUNUNGKIDUL, DAERAH ISTIMEWA YOGYAKARTA",21,167,65,232
https://kawalpemilu.org#42197,"KANIGORO, SAPTOSARI, GUNUNGKIDUL, DAERAH ISTIMEWA YOGYAKARTA",1,105,39,144
https://kawalpemilu.org#42197,"KANIGORO, SAPTOSARI, GUNUNGKIDUL, DAERAH ISTIMEWA YOGYAKARTA",2,142,40,182
https://kawalpemilu.org#42197,"KANIGORO, SAPTOSARI, GUNUNGKIDUL, DAERAH ISTIMEWA YOGYAKARTA",3,130,32,162
https://kawalpemilu.org#42197,"KANIGORO, SAPTOSARI, GUNUNGKIDUL, DAERAH ISTIMEWA YOGYAKARTA",4,143,58,201
https://kawalpemilu.org#42197,"KANIGORO, SAPTOSARI, GUNUNGKIDUL, DAERAH ISTIMEWA YOGYAKARTA",5,171,24,195
https://kawalpemilu.org#42197,"KANIGORO, SAPTOSARI, GUNUNGKIDUL, DAERAH ISTIMEWA YOGYAKARTA",6,115,9,124
https://kawalpemilu.org#42197,"KANIGORO, SAPTOSARI, GUNUNGKIDUL, DAERAH ISTIMEWA YOGYAKARTA",7,135,23,158
https://kawalpemilu.org#42197,"KANIGORO, SAPTOSARI, GUNUNGKIDUL, DAERAH ISTIMEWA YOGYAKARTA",8,130,7,137
https://kawalpemilu.org#42197,"KANIGORO, SAPTOSARI, GUNUNGKIDUL, DAERAH ISTIMEWA YOGYAKARTA",9,160,16,176
https://kawalpemilu.org#42197,"KANIGORO, SAPTOSARI, GUNUNGKIDUL, DAERAH ISTIMEWA YOGYAKARTA",10,182,22,204
https://kawalpemilu.org#42197,"KANIGORO, SAPTOSARI, GUNUNGKIDUL, DAERAH ISTIMEWA YOGYAKARTA",11,173,37,210
https://kawalpemilu.org#42197,"KANIGORO, SAPTOSARI, GUNUNGKIDUL, DAERAH ISTIMEWA YOGYAKARTA",12,187,21,208
https://kawalpemilu.org#42197,"KANIGORO, SAPTOSARI, GUNUNGKIDUL, DAERAH ISTIMEWA YOGYAKARTA",13,160,30,190
https://kawalpemilu.org#42197,"KANIGORO, SAPTOSARI, GUNUNGKIDUL, DAERAH ISTIMEWA YOGYAKARTA",14,156,37,193
https://kawalpemilu.org#42197,"KANIGORO, SAPTOSARI, GUNUNGKIDUL, DAERAH ISTIMEWA YOGYAKARTA",15,108,26,134
https://kawalpemilu.org#42197,"KANIGORO, SAPTOSARI, GUNUNGKIDUL, DAERAH ISTIMEWA YOGYAKARTA",16,115,10,125
https://kawalpemilu.org#42197,"KANIGORO, SAPTOSARI, GUNUNGKIDUL, DAERAH ISTIMEWA YOGYAKARTA",17,131,19,150
https://kawalpemilu.org#42197,"KANIGORO, SAPTOSARI, GUNUNGKIDUL, DAERAH ISTIMEWA YOGYAKARTA",18,160,12,172
https://kawalpemilu.org#42197,"KANIGORO, SAPTOSARI, GUNUNGKIDUL, DAERAH ISTIMEWA YOGYAKARTA",19,152,17,169
https://kawalpemilu.org#42197,"KANIGORO, SAPTOSARI, GUNUNGKIDUL, DAERAH ISTIMEWA YOGYAKARTA",20,179,33,212
https://kawalpemilu.org#42197,"KANIGORO, SAPTOSARI, GUNUNGKIDUL, DAERAH ISTIMEWA YOGYAKARTA",21,139,19,158
https://kawalpemilu.org#42197,"KANIGORO, SAPTOSARI, GUNUNGKIDUL, DAERAH ISTIMEWA YOGYAKARTA",22,129,23,152
https://kawalpemilu.org#42197,"KANIGORO, SAPTOSARI, GUNUNGKIDUL, DAERAH ISTIMEWA YOGYAKARTA",23,135,10,145
https://kawalpemilu.org#42197,"KANIGORO, SAPTOSARI, GUNUNGKIDUL, DAERAH ISTIMEWA YOGYAKARTA",24,125,19,144
https://kawalpemilu.org#42197,"KANIGORO, SAPTOSARI, GUNUNGKIDUL, DAERAH ISTIMEWA YOGYAKARTA",25,93,5,98
https://kawalpemilu.org#42197,"KANIGORO, SAPTOSARI, GUNUNGKIDUL, DAERAH ISTIMEWA YOGYAKARTA",26,117,12,129
https://kawalpemilu.org#42197,"KANIGORO, SAPTOSARI, GUNUNGKIDUL, DAERAH ISTIMEWA YOGYAKARTA",27,124,17,141
https://kawalpemilu.org#42197,"KANIGORO, SAPTOSARI, GUNUNGKIDUL, DAERAH ISTIMEWA YOGYAKARTA",28,167,7,174
https://kawalpemilu.org#42198,"MONGGOL, SAPTOSARI, GUNUNGKIDUL, DAERAH ISTIMEWA YOGYAKARTA",1,143,13,156
https://kawalpemilu.org#42198,"MONGGOL, SAPTOSARI, GUNUNGKIDUL, DAERAH ISTIMEWA YOGYAKARTA",2,109,46,155
https://kawalpemilu.org#42198,"MONGGOL, SAPTOSARI, GUNUNGKIDUL, DAERAH ISTIMEWA YOGYAKARTA",3,102,74,176
https://kawalpemilu.org#42198,"MONGGOL, SAPTOSARI, GUNUNGKIDUL, DAERAH ISTIMEWA YOGYAKARTA",4,99,39,138
https://kawalpemilu.org#42198,"MONGGOL, SAPTOSARI, GUNUNGKIDUL, DAERAH ISTIMEWA YOGYAKARTA",5,106,30,136
https://kawalpemilu.org#42198,"MONGGOL, SAPTOSARI, GUNUNGKIDUL, DAERAH ISTIMEWA YOGYAKARTA",6,95,30,125
https://kawalpemilu.org#42198,"MONGGOL, SAPTOSARI, GUNUNGKIDUL, DAERAH ISTIMEWA YOGYAKARTA",7,82,18,100
https://kawalpemilu.org#42198,"MONGGOL, SAPTOSARI, GUNUNGKIDUL, DAERAH ISTIMEWA YOGYAKARTA",8,86,12,98
https://kawalpemilu.org#42198,"MONGGOL, SAPTOSARI, GUNUNGKIDUL, DAERAH ISTIMEWA YOGYAKARTA",9,118,22,140
https://kawalpemilu.org#42198,"MONGGOL, SAPTOSARI, GUNUNGKIDUL, DAERAH ISTIMEWA YOGYAKARTA",10,144,16,160
https://kawalpemilu.org#42198,"MONGGOL, SAPTOSARI, GUNUNGKIDUL, DAERAH ISTIMEWA YOGYAKARTA",11,164,43,207
https://kawalpemilu.org#42198,"MONGGOL, SAPTOSARI, GUNUNGKIDUL, DAERAH ISTIMEWA YOGYAKARTA",12,144,23,167
https://kawalpemilu.org#42198,"MONGGOL, SAPTOSARI, GUNUNGKIDUL, DAERAH ISTIMEWA YOGYAKARTA",13,183,12,195
https://kawalpemilu.org#42198,"MONGGOL, SAPTOSARI, GUNUNGKIDUL, DAERAH ISTIMEWA YOGYAKARTA",14,169,23,192
https://kawalpemilu.org#42198,"MONGGOL, SAPTOSARI, GUNUNGKIDUL, DAERAH ISTIMEWA YOGYAKARTA",15,147,22,169
https://kawalpemilu.org#42198,"MONGGOL, SAPTOSARI, GUNUNGKIDUL, DAERAH ISTIMEWA YOGYAKARTA",16,154,34,188
https://kawalpemilu.org#42198,"MONGGOL, SAPTOSARI, GUNUNGKIDUL, DAERAH ISTIMEWA YOGYAKARTA",17,87,17,104
https://kawalpemilu.org#42198,"MONGGOL, SAPTOSARI, GUNUNGKIDUL, DAERAH ISTIMEWA YOGYAKARTA",18,72,17,89
https://kawalpemilu.org#42198,"MONGGOL, SAPTOSARI, GUNUNGKIDUL, DAERAH ISTIMEWA YOGYAKARTA",19,191,24,215
https://kawalpemilu.org#42198,"MONGGOL, SAPTOSARI, GUNUNGKIDUL, DAERAH ISTIMEWA YOGYAKARTA",20,176,20,196
https://kawalpemilu.org#42198,"MONGGOL, SAPTOSARI, GUNUNGKIDUL, DAERAH ISTIMEWA YOGYAKARTA",21,170,33,203
https://kawalpemilu.org#42199,"PLANJAN, SAPTOSARI, GUNUNGKIDUL, DAERAH ISTIMEWA YOGYAKARTA",1,101,34,135
https://kawalpemilu.org#42199,"PLANJAN, SAPTOSARI, GUNUNGKIDUL, DAERAH ISTIMEWA YOGYAKARTA",2,133,32,165
https://kawalpemilu.org#42199,"PLANJAN, SAPTOSARI, GUNUNGKIDUL, DAERAH ISTIMEWA YOGYAKARTA",3,116,28,144
https://kawalpemilu.org#42199,"PLANJAN, SAPTOSARI, GUNUNGKIDUL, DAERAH ISTIMEWA YOGYAKARTA",4,129,47,176
https://kawalpemilu.org#42199,"PLANJAN, SAPTOSARI, GUNUNGKIDUL, DAERAH ISTIMEWA YOGYAKARTA",5,125,23,148
https://kawalpemilu.org#42199,"PLANJAN, SAPTOSARI, GUNUNGKIDUL, DAERAH ISTIMEWA YOGYAKARTA",6,123,42,165
https://kawalpemilu.org#42199,"PLANJAN, SAPTOSARI, GUNUNGKIDUL, DAERAH ISTIMEWA YOGYAKARTA",7,159,16,175
https://kawalpemilu.org#42199,"PLANJAN, SAPTOSARI, GUNUNGKIDUL, DAERAH ISTIMEWA YOGYAKARTA",8,139,12,151
https://kawalpemilu.org#42199,"PLANJAN, SAPTOSARI, GUNUNGKIDUL, DAERAH ISTIMEWA YOGYAKARTA",9,152,26,178
https://kawalpemilu.org#42199,"PLANJAN, SAPTOSARI, GUNUNGKIDUL, DAERAH ISTIMEWA YOGYAKARTA",10,144,6,150
https://kawalpemilu.org#42199,"PLANJAN, SAPTOSARI, GUNUNGKIDUL, DAERAH ISTIMEWA YOGYAKARTA",11,172,23,195
https://kawalpemilu.org#42199,"PLANJAN, SAPTOSARI, GUNUNGKIDUL, DAERAH ISTIMEWA YOGYAKARTA",12,125,16,141
https://kawalpemilu.org#42199,"PLANJAN, SAPTOSARI, GUNUNGKIDUL, DAERAH ISTIMEWA YOGYAKARTA",13,151,10,161
https://kawalpemilu.org#42199,"PLANJAN, SAPTOSARI, GUNUNGKIDUL, DAERAH ISTIMEWA YOGYAKARTA",14,133,63,196
https://kawalpemilu.org#42199,"PLANJAN, SAPTOSARI, GUNUNGKIDUL, DAERAH ISTIMEWA YOGYAKARTA",15,83,18,101
https://kawalpemilu.org#42199,"PLANJAN, SAPTOSARI, GUNUNGKIDUL, DAERAH ISTIMEWA YOGYAKARTA",16,102,38,140
https://kawalpemilu.org#42199,"PLANJAN, SAPTOSARI, GUNUNGKIDUL, DAERAH ISTIMEWA YOGYAKARTA",17,87,9,96
https://kawalpemilu.org#42199,"PLANJAN, SAPTOSARI, GUNUNGKIDUL, DAERAH ISTIMEWA YOGYAKARTA",18,134,16,150
https://kawalpemilu.org#42199,"PLANJAN, SAPTOSARI, GUNUNGKIDUL, DAERAH ISTIMEWA YOGYAKARTA",19,98,18,116
https://kawalpemilu.org#42199,"PLANJAN, SAPTOSARI, GUNUNGKIDUL, DAERAH ISTIMEWA YOGYAKARTA",20,95,5,100
https://kawalpemilu.org#42199,"PLANJAN, SAPTOSARI, GUNUNGKIDUL, DAERAH ISTIMEWA YOGYAKARTA",21,166,35,201
https://kawalpemilu.org#42199,"PLANJAN, SAPTOSARI, GUNUNGKIDUL, DAERAH ISTIMEWA YOGYAKARTA",22,124,25,149
https://kawalpemilu.org#42199,"PLANJAN, SAPTOSARI, GUNUNGKIDUL, DAERAH ISTIMEWA YOGYAKARTA",23,119,59,178
https://kawalpemilu.org#42199,"PLANJAN, SAPTOSARI, GUNUNGKIDUL, DAERAH ISTIMEWA YOGYAKARTA",24,87,91,178
https://kawalpemilu.org#42199,"PLANJAN, SAPTOSARI, GUNUNGKIDUL, DAERAH ISTIMEWA YOGYAKARTA",25,160,22,182
https://kawalpemilu.org#42199,"PLANJAN, SAPTOSARI, GUNUNGKIDUL, DAERAH ISTIMEWA YOGYAKARTA",26,166,37,203
https://kawalpemilu.org#42199,"PLANJAN, SAPTOSARI, GUNUNGKIDUL, DAERAH ISTIMEWA YOGYAKARTA",27,185,34,219
https://kawalpemilu.org#42201,"BALONG, GIRISUBO, GUNUNGKIDUL, DAERAH ISTIMEWA YOGYAKARTA",1,166,45,211
https://kawalpemilu.org#42201,"BALONG, GIRISUBO, GUNUNGKIDUL, DAERAH ISTIMEWA YOGYAKARTA",2,134,51,185
https://kawalpemilu.org#42201,"BALONG, GIRISUBO, GUNUNGKIDUL, DAERAH ISTIMEWA YOGYAKARTA",3,184,29,213
https://kawalpemilu.org#42201,"BALONG, GIRISUBO, GUNUNGKIDUL, DAERAH ISTIMEWA YOGYAKARTA",4,199,15,214
https://kawalpemilu.org#42201,"BALONG, GIRISUBO, GUNUNGKIDUL, DAERAH ISTIMEWA YOGYAKARTA",5,86,33,119
https://kawalpemilu.org#42201,"BALONG, GIRISUBO, GUNUNGKIDUL, DAERAH ISTIMEWA YOGYAKARTA",6,150,50,200
https://kawalpemilu.org#42201,"BALONG, GIRISUBO, GUNUNGKIDUL, DAERAH ISTIMEWA YOGYAKARTA",7,125,33,158
https://kawalpemilu.org#42201,"BALONG, GIRISUBO, GUNUNGKIDUL, DAERAH ISTIMEWA YOGYAKARTA",8,111,28,139
https://kawalpemilu.org#42201,"BALONG, GIRISUBO, GUNUNGKIDUL, DAERAH ISTIMEWA YOGYAKARTA",9,162,46,208
https://kawalpemilu.org#42201,"BALONG, GIRISUBO, GUNUNGKIDUL, DAERAH ISTIMEWA YOGYAKARTA",10,158,34,192
https://kawalpemilu.org#42201,"BALONG, GIRISUBO, GUNUNGKIDUL, DAERAH ISTIMEWA YOGYAKARTA",11,133,37,170
https://kawalpemilu.org#42201,"BALONG, GIRISUBO, GUNUNGKIDUL, DAERAH ISTIMEWA YOGYAKARTA",12,187,35,222
https://kawalpemilu.org#42201,"BALONG, GIRISUBO, GUNUNGKIDUL, DAERAH ISTIMEWA YOGYAKARTA",13,162,36,198
https://kawalpemilu.org#42202,"JEPITU, GIRISUBO, GUNUNGKIDUL, DAERAH ISTIMEWA YOGYAKARTA",1,152,53,205
https://kawalpemilu.org#42202,"JEPITU, GIRISUBO, GUNUNGKIDUL, DAERAH ISTIMEWA YOGYAKARTA",2,152,52,203
https://kawalpemilu.org#42202,"JEPITU, GIRISUBO, GUNUNGKIDUL, DAERAH ISTIMEWA YOGYAKARTA",3,154,61,215
https://kawalpemilu.org#42202,"JEPITU, GIRISUBO, GUNUNGKIDUL, DAERAH ISTIMEWA YOGYAKARTA",4,152,33,185
https://kawalpemilu.org#42202,"JEPITU, GIRISUBO, GUNUNGKIDUL, DAERAH ISTIMEWA YOGYAKARTA",5,180,34,214
https://kawalpemilu.org#42202,"JEPITU, GIRISUBO, GUNUNGKIDUL, DAERAH ISTIMEWA YOGYAKARTA",6,131,28,159
https://kawalpemilu.org#42202,"JEPITU, GIRISUBO, GUNUNGKIDUL, DAERAH ISTIMEWA YOGYAKARTA",7,136,32,168
https://kawalpemilu.org#42202,"JEPITU, GIRISUBO, GUNUNGKIDUL, DAERAH ISTIMEWA YOGYAKARTA",8,116,109,225
https://kawalpemilu.org#42202,"JEPITU, GIRISUBO, GUNUNGKIDUL, DAERAH ISTIMEWA YOGYAKARTA",9,118,93,211
https://kawalpemilu.org#42202,"JEPITU, GIRISUBO, GUNUNGKIDUL, DAERAH ISTIMEWA YOGYAKARTA",10,63,112,175
https://kawalpemilu.org#42202,"JEPITU, GIRISUBO, GUNUNGKIDUL, DAERAH ISTIMEWA YOGYAKARTA",11,108,47,155
https://kawalpemilu.org#42202,"JEPITU, GIRISUBO, GUNUNGKIDUL, DAERAH ISTIMEWA YOGYAKARTA",12,135,25,160
https://kawalpemilu.org#42202,"JEPITU, GIRISUBO, GUNUNGKIDUL, DAERAH ISTIMEWA YOGYAKARTA",13,153,21,174
https://kawalpemilu.org#42202,"JEPITU, GIRISUBO, GUNUNGKIDUL, DAERAH ISTIMEWA YOGYAKARTA",14,55,13,68
https://kawalpemilu.org#42202,"JEPITU, GIRISUBO, GUNUNGKIDUL, DAERAH ISTIMEWA YOGYAKARTA",15,82,91,173
https://kawalpemilu.org#42203,"KARANGAWEN, GIRISUBO, GUNUNGKIDUL, DAERAH ISTIMEWA YOGYAKARTA",1,160,46,206
https://kawalpemilu.org#42203,"KARANGAWEN, GIRISUBO, GUNUNGKIDUL, DAERAH ISTIMEWA YOGYAKARTA",2,181,47,228
https://kawalpemilu.org#42203,"KARANGAWEN, GIRISUBO, GUNUNGKIDUL, DAERAH ISTIMEWA YOGYAKARTA",3,179,41,220
https://kawalpemilu.org#42203,"KARANGAWEN, GIRISUBO, GUNUNGKIDUL, DAERAH ISTIMEWA YOGYAKARTA",4,166,49,215
https://kawalpemilu.org#42203,"KARANGAWEN, GIRISUBO, GUNUNGKIDUL, DAERAH ISTIMEWA YOGYAKARTA",5,175,47,222
https://kawalpemilu.org#42204,"NGLINDUR, GIRISUBO, GUNUNGKIDUL, DAERAH ISTIMEWA YOGYAKARTA",1,149,92,241
https://kawalpemilu.org#42204,"NGLINDUR, GIRISUBO, GUNUNGKIDUL, DAERAH ISTIMEWA YOGYAKARTA",2,172,54,226
https://kawalpemilu.org#42204,"NGLINDUR, GIRISUBO, GUNUNGKIDUL, DAERAH ISTIMEWA YOGYAKARTA",3,125,102,227
https://kawalpemilu.org#42204,"NGLINDUR, GIRISUBO, GUNUNGKIDUL, DAERAH ISTIMEWA YOGYAKARTA",4,159,72,231
https://kawalpemilu.org#42204,"NGLINDUR, GIRISUBO, GUNUNGKIDUL, DAERAH ISTIMEWA YOGYAKARTA",5,215,28,243
https://kawalpemilu.org#42204,"NGLINDUR, GIRISUBO, GUNUNGKIDUL, DAERAH ISTIMEWA YOGYAKARTA",6,191,42,233
https://kawalpemilu.org#42204,"NGLINDUR, GIRISUBO, GUNUNGKIDUL, DAERAH ISTIMEWA YOGYAKARTA",7,232,28,260
https://kawalpemilu.org#42204,"NGLINDUR, GIRISUBO, GUNUNGKIDUL, DAERAH ISTIMEWA YOGYAKARTA",8,199,16,215
https://kawalpemilu.org#42205,"JERUKWUDEL, GIRISUBO, GUNUNGKIDUL, DAERAH ISTIMEWA YOGYAKARTA",1,93,23,116
https://kawalpemilu.org#42205,"JERUKWUDEL, GIRISUBO, GUNUNGKIDUL, DAERAH ISTIMEWA YOGYAKARTA",2,116,43,159
https://kawalpemilu.org#42205,"JERUKWUDEL, GIRISUBO, GUNUNGKIDUL, DAERAH ISTIMEWA YOGYAKARTA",3,165,67,232
https://kawalpemilu.org#42205,"JERUKWUDEL, GIRISUBO, GUNUNGKIDUL, DAERAH ISTIMEWA YOGYAKARTA",4,86,16,102
https://kawalpemilu.org#42205,"JERUKWUDEL, GIRISUBO, GUNUNGKIDUL, DAERAH ISTIMEWA YOGYAKARTA",5,168,19,183
https://kawalpemilu.org#42205,"JERUKWUDEL, GIRISUBO, GUNUNGKIDUL, DAERAH ISTIMEWA YOGYAKARTA",6,154,9,163
https://kawalpemilu.org#42205,"JERUKWUDEL, GIRISUBO, GUNUNGKIDUL, DAERAH ISTIMEWA YOGYAKARTA",7,169,55,224
https://kawalpemilu.org#42206,"TILENG, GIRISUBO, GUNUNGKIDUL, DAERAH ISTIMEWA YOGYAKARTA",1,137,37,174
https://kawalpemilu.org#42206,"TILENG, GIRISUBO, GUNUNGKIDUL, DAERAH ISTIMEWA YOGYAKARTA",2,122,20,142
https://kawalpemilu.org#42206,"TILENG, GIRISUBO, GUNUNGKIDUL, DAERAH ISTIMEWA YOGYAKARTA",3,107,33,140
https://kawalpemilu.org#42206,"TILENG, GIRISUBO, GUNUNGKIDUL, DAERAH ISTIMEWA YOGYAKARTA",4,129,34,163
https://kawalpemilu.org#42206,"TILENG, GIRISUBO, GUNUNGKIDUL, DAERAH ISTIMEWA YOGYAKARTA",5,92,25,117
https://kawalpemilu.org#42206,"TILENG, GIRISUBO, GUNUNGKIDUL, DAERAH ISTIMEWA YOGYAKARTA",6,107,13,120
https://kawalpemilu.org#42206,"TILENG, GIRISUBO, GUNUNGKIDUL, DAERAH ISTIMEWA YOGYAKARTA",7,229,31,260
https://kawalpemilu.org#42206,"TILENG, GIRISUBO, GUNUNGKIDUL, DAERAH ISTIMEWA YOGYAKARTA",8,149,49,198
https://kawalpemilu.org#42206,"TILENG, GIRISUBO, GUNUNGKIDUL, DAERAH ISTIMEWA YOGYAKARTA",9,148,60,208
https://kawalpemilu.org#42206,"TILENG, GIRISUBO, GUNUNGKIDUL, DAERAH ISTIMEWA YOGYAKARTA",10,134,77,211
https://kawalpemilu.org#42206,"TILENG, GIRISUBO, GUNUNGKIDUL, DAERAH ISTIMEWA YOGYAKARTA",11,143,58,201
https://kawalpemilu.org#42206,"TILENG, GIRISUBO, GUNUNGKIDUL, DAERAH ISTIMEWA YOGYAKARTA",12,178,48,226
https://kawalpemilu.org#42206,"TILENG, GIRISUBO, GUNUNGKIDUL, DAERAH ISTIMEWA YOGYAKARTA",13,131,25,156
https://kawalpemilu.org#42206,"TILENG, GIRISUBO, GUNUNGKIDUL, DAERAH ISTIMEWA YOGYAKARTA",14,172,29,201
https://kawalpemilu.org#42206,"TILENG, GIRISUBO, GUNUNGKIDUL, DAERAH ISTIMEWA YOGYAKARTA",15,189,58,247
https://kawalpemilu.org#42206,"TILENG, GIRISUBO, GUNUNGKIDUL, DAERAH ISTIMEWA YOGYAKARTA",16,105,21,126
https://kawalpemilu.org#42207,"PUCUNG, GIRISUBO, GUNUNGKIDUL, DAERAH ISTIMEWA YOGYAKARTA",1,68,13,81
https://kawalpemilu.org#42207,"PUCUNG, GIRISUBO, GUNUNGKIDUL, DAERAH ISTIMEWA YOGYAKARTA",2,100,13,113
https://kawalpemilu.org#42207,"PUCUNG, GIRISUBO, GUNUNGKIDUL, DAERAH ISTIMEWA YOGYAKARTA",3,131,13,144
https://kawalpemilu.org#42207,"PUCUNG, GIRISUBO, GUNUNGKIDUL, DAERAH ISTIMEWA YOGYAKARTA",4,142,14,156
https://kawalpemilu.org#42207,"PUCUNG, GIRISUBO, GUNUNGKIDUL, DAERAH ISTIMEWA YOGYAKARTA",5,156,23,179
https://kawalpemilu.org#42207,"PUCUNG, GIRISUBO, GUNUNGKIDUL, DAERAH ISTIMEWA YOGYAKARTA",6,159,14,173
https://kawalpemilu.org#42207,"PUCUNG, GIRISUBO, GUNUNGKIDUL, DAERAH ISTIMEWA YOGYAKARTA",7,144,32,176
https://kawalpemilu.org#42207,"PUCUNG, GIRISUBO, GUNUNGKIDUL, DAERAH ISTIMEWA YOGYAKARTA",8,154,19,173
https://kawalpemilu.org#42207,"PUCUNG, GIRISUBO, GUNUNGKIDUL, DAERAH ISTIMEWA YOGYAKARTA",9,152,17,169
https://kawalpemilu.org#42207,"PUCUNG, GIRISUBO, GUNUNGKIDUL, DAERAH ISTIMEWA YOGYAKARTA",10,131,10,141
https://kawalpemilu.org#42207,"PUCUNG, GIRISUBO, GUNUNGKIDUL, DAERAH ISTIMEWA YOGYAKARTA",11,126,30,156
https://kawalpemilu.org#42207,"PUCUNG, GIRISUBO, GUNUNGKIDUL, DAERAH ISTIMEWA YOGYAKARTA",12,182,14,196
https://kawalpemilu.org#42207,"PUCUNG, GIRISUBO, GUNUNGKIDUL, DAERAH ISTIMEWA YOGYAKARTA",13,170,21,191
https://kawalpemilu.org#42208,"SONGBANYU, GIRISUBO, GUNUNGKIDUL, DAERAH ISTIMEWA YOGYAKARTA",1,152,38,190
https://kawalpemilu.org#42208,"SONGBANYU, GIRISUBO, GUNUNGKIDUL, DAERAH ISTIMEWA YOGYAKARTA",2,116,40,156
https://kawalpemilu.org#42208,"SONGBANYU, GIRISUBO, GUNUNGKIDUL, DAERAH ISTIMEWA YOGYAKARTA",3,151,29,180
https://kawalpemilu.org#42208,"SONGBANYU, GIRISUBO, GUNUNGKIDUL, DAERAH ISTIMEWA YOGYAKARTA",4,128,16,144
https://kawalpemilu.org#42208,"SONGBANYU, GIRISUBO, GUNUNGKIDUL, DAERAH ISTIMEWA YOGYAKARTA",5,100,108,208
https://kawalpemilu.org#42208,"SONGBANYU, GIRISUBO, GUNUNGKIDUL, DAERAH ISTIMEWA YOGYAKARTA",6,114,80,194
https://kawalpemilu.org#42208,"SONGBANYU, GIRISUBO, GUNUNGKIDUL, DAERAH ISTIMEWA YOGYAKARTA",7,144,65,209
https://kawalpemilu.org#42208,"SONGBANYU, GIRISUBO, GUNUNGKIDUL, DAERAH ISTIMEWA YOGYAKARTA",8,121,53,2
https://kawalpemilu.org#42208,"SONGBANYU, GIRISUBO, GUNUNGKIDUL, DAERAH ISTIMEWA YOGYAKARTA",9,172,54,226
https://kawalpemilu.org#42208,"SONGBANYU, GIRISUBO, GUNUNGKIDUL, DAERAH ISTIMEWA YOGYAKARTA",10,144,74,218
https://kawalpemilu.org#42208,"SONGBANYU, GIRISUBO, GUNUNGKIDUL, DAERAH ISTIMEWA YOGYAKARTA",11,139,48,187
https://kawalpemilu.org#42208,"SONGBANYU, GIRISUBO, GUNUNGKIDUL, DAERAH ISTIMEWA YOGYAKARTA",12,119,8,127
https://kawalpemilu.org#42210,"HARGOSARI, TANJUNGSARI, GUNUNGKIDUL, DAERAH ISTIMEWA YOGYAKARTA",1,194,44,238
https://kawalpemilu.org#42210,"HARGOSARI, TANJUNGSARI, GUNUNGKIDUL, DAERAH ISTIMEWA YOGYAKARTA",2,190,62,252
https://kawalpemilu.org#42210,"HARGOSARI, TANJUNGSARI, GUNUNGKIDUL, DAERAH ISTIMEWA YOGYAKARTA",3,182,45,227
https://kawalpemilu.org#42210,"HARGOSARI, TANJUNGSARI, GUNUNGKIDUL, DAERAH ISTIMEWA YOGYAKARTA",4,168,41,209
https://kawalpemilu.org#42210,"HARGOSARI, TANJUNGSARI, GUNUNGKIDUL, DAERAH ISTIMEWA YOGYAKARTA",5,169,36,205
https://kawalpemilu.org#42210,"HARGOSARI, TANJUNGSARI, GUNUNGKIDUL, DAERAH ISTIMEWA YOGYAKARTA",6,143,30,173
https://kawalpemilu.org#42210,"HARGOSARI, TANJUNGSARI, GUNUNGKIDUL, DAERAH ISTIMEWA YOGYAKARTA",7,136,30,166
https://kawalpemilu.org#42210,"HARGOSARI, TANJUNGSARI, GUNUNGKIDUL, DAERAH ISTIMEWA YOGYAKARTA",8,121,30,151
https://kawalpemilu.org#42210,"HARGOSARI, TANJUNGSARI, GUNUNGKIDUL, DAERAH ISTIMEWA YOGYAKARTA",9,150,38,188
https://kawalpemilu.org#42210,"HARGOSARI, TANJUNGSARI, GUNUNGKIDUL, DAERAH ISTIMEWA YOGYAKARTA",10,220,25,245
https://kawalpemilu.org#42210,"HARGOSARI, TANJUNGSARI, GUNUNGKIDUL, DAERAH ISTIMEWA YOGYAKARTA",11,184,48,232
https://kawalpemilu.org#42210,"HARGOSARI, TANJUNGSARI, GUNUNGKIDUL, DAERAH ISTIMEWA YOGYAKARTA",12,196,31,227
https://kawalpemilu.org#42210,"HARGOSARI, TANJUNGSARI, GUNUNGKIDUL, DAERAH ISTIMEWA YOGYAKARTA",13,170,22,192
https://kawalpemilu.org#42210,"HARGOSARI, TANJUNGSARI, GUNUNGKIDUL, DAERAH ISTIMEWA YOGYAKARTA",14,195,27,222
https://kawalpemilu.org#42210,"HARGOSARI, TANJUNGSARI, GUNUNGKIDUL, DAERAH ISTIMEWA YOGYAKARTA",15,128,21,149
https://kawalpemilu.org#42210,"HARGOSARI, TANJUNGSARI, GUNUNGKIDUL, DAERAH ISTIMEWA YOGYAKARTA",16,218,34,252
https://kawalpemilu.org#42210,"HARGOSARI, TANJUNGSARI, GUNUNGKIDUL, DAERAH ISTIMEWA YOGYAKARTA",17,159,40,199
https://kawalpemilu.org#42210,"HARGOSARI, TANJUNGSARI, GUNUNGKIDUL, DAERAH ISTIMEWA YOGYAKARTA",18,150,51,201
https://kawalpemilu.org#42210,"HARGOSARI, TANJUNGSARI, GUNUNGKIDUL, DAERAH ISTIMEWA YOGYAKARTA",19,151,31,182
https://kawalpemilu.org#42211,"KEMIRI, TANJUNGSARI, GUNUNGKIDUL, DAERAH ISTIMEWA YOGYAKARTA",1,141,26,167
https://kawalpemilu.org#42211,"KEMIRI, TANJUNGSARI, GUNUNGKIDUL, DAERAH ISTIMEWA YOGYAKARTA",2,149,21,170
https://kawalpemilu.org#42211,"KEMIRI, TANJUNGSARI, GUNUNGKIDUL, DAERAH ISTIMEWA YOGYAKARTA",3,156,37,193
https://kawalpemilu.org#42211,"KEMIRI, TANJUNGSARI, GUNUNGKIDUL, DAERAH ISTIMEWA YOGYAKARTA",4,136,69,205
https://kawalpemilu.org#42211,"KEMIRI, TANJUNGSARI, GUNUNGKIDUL, DAERAH ISTIMEWA YOGYAKARTA",5,110,75,185
https://kawalpemilu.org#42211,"KEMIRI, TANJUNGSARI, GUNUNGKIDUL, DAERAH ISTIMEWA YOGYAKARTA",6,119,85,204
https://kawalpemilu.org#42211,"KEMIRI, TANJUNGSARI, GUNUNGKIDUL, DAERAH ISTIMEWA YOGYAKARTA",7,94,37,131
https://kawalpemilu.org#42211,"KEMIRI, TANJUNGSARI, GUNUNGKIDUL, DAERAH ISTIMEWA YOGYAKARTA",8,124,26,150
https://kawalpemilu.org#42211,"KEMIRI, TANJUNGSARI, GUNUNGKIDUL, DAERAH ISTIMEWA YOGYAKARTA",9,144,53,197
https://kawalpemilu.org#42211,"KEMIRI, TANJUNGSARI, GUNUNGKIDUL, DAERAH ISTIMEWA YOGYAKARTA",10,145,81,226
https://kawalpemilu.org#42211,"KEMIRI, TANJUNGSARI, GUNUNGKIDUL, DAERAH ISTIMEWA YOGYAKARTA",11,120,96,216
https://kawalpemilu.org#42211,"KEMIRI, TANJUNGSARI, GUNUNGKIDUL, DAERAH ISTIMEWA YOGYAKARTA",12,171,49,220
https://kawalpemilu.org#42211,"KEMIRI, TANJUNGSARI, GUNUNGKIDUL, DAERAH ISTIMEWA YOGYAKARTA",13,182,71,253
https://kawalpemilu.org#42211,"KEMIRI, TANJUNGSARI, GUNUNGKIDUL, DAERAH ISTIMEWA YOGYAKARTA",14,142,63,205
https://kawalpemilu.org#42211,"KEMIRI, TANJUNGSARI, GUNUNGKIDUL, DAERAH ISTIMEWA YOGYAKARTA",15,134,14,148
https://kawalpemilu.org#42211,"KEMIRI, TANJUNGSARI, GUNUNGKIDUL, DAERAH ISTIMEWA YOGYAKARTA",16,121,18,139
https://kawalpemilu.org#42211,"KEMIRI, TANJUNGSARI, GUNUNGKIDUL, DAERAH ISTIMEWA YOGYAKARTA",17,171,27,198
https://kawalpemilu.org#42212,"KEMADANG, TANJUNGSARI, GUNUNGKIDUL, DAERAH ISTIMEWA YOGYAKARTA",1,196,36,232
https://kawalpemilu.org#42212,"KEMADANG, TANJUNGSARI, GUNUNGKIDUL, DAERAH ISTIMEWA YOGYAKARTA",2,138,114,252
https://kawalpemilu.org#42212,"KEMADANG, TANJUNGSARI, GUNUNGKIDUL, DAERAH ISTIMEWA YOGYAKARTA",3,155,101,256
https://kawalpemilu.org#42212,"KEMADANG, TANJUNGSARI, GUNUNGKIDUL, DAERAH ISTIMEWA YOGYAKARTA",4,113,62,175
https://kawalpemilu.org#42212,"KEMADANG, TANJUNGSARI, GUNUNGKIDUL, DAERAH ISTIMEWA YOGYAKARTA",5,161,102,263
https://kawalpemilu.org#42212,"KEMADANG, TANJUNGSARI, GUNUNGKIDUL, DAERAH ISTIMEWA YOGYAKARTA",6,164,82,246
https://kawalpemilu.org#42212,"KEMADANG, TANJUNGSARI, GUNUNGKIDUL, DAERAH ISTIMEWA YOGYAKARTA",7,144,94,238
https://kawalpemilu.org#42212,"KEMADANG, TANJUNGSARI, GUNUNGKIDUL, DAERAH ISTIMEWA YOGYAKARTA",8,79,45,124
https://kawalpemilu.org#42212,"KEMADANG, TANJUNGSARI, GUNUNGKIDUL, DAERAH ISTIMEWA YOGYAKARTA",9,195,39,234
https://kawalpemilu.org#42212,"KEMADANG, TANJUNGSARI, GUNUNGKIDUL, DAERAH ISTIMEWA YOGYAKARTA",10,178,58,236
https://kawalpemilu.org#42212,"KEMADANG, TANJUNGSARI, GUNUNGKIDUL, DAERAH ISTIMEWA YOGYAKARTA",11,130,22,152
https://kawalpemilu.org#42212,"KEMADANG, TANJUNGSARI, GUNUNGKIDUL, DAERAH ISTIMEWA YOGYAKARTA",12,168,19,187
https://kawalpemilu.org#42212,"KEMADANG, TANJUNGSARI, GUNUNGKIDUL, DAERAH ISTIMEWA YOGYAKARTA",13,115,35,150
https://kawalpemilu.org#42212,"KEMADANG, TANJUNGSARI, GUNUNGKIDUL, DAERAH ISTIMEWA YOGYAKARTA",14,138,40,178
https://kawalpemilu.org#42212,"KEMADANG, TANJUNGSARI, GUNUNGKIDUL, DAERAH ISTIMEWA YOGYAKARTA",15,78,106,184
https://kawalpemilu.org#42212,"KEMADANG, TANJUNGSARI, GUNUNGKIDUL, DAERAH ISTIMEWA YOGYAKARTA",16,104,110,214
https://kawalpemilu.org#42212,"KEMADANG, TANJUNGSARI, GUNUNGKIDUL, DAERAH ISTIMEWA YOGYAKARTA",17,89,117,206
https://kawalpemilu.org#42212,"KEMADANG, TANJUNGSARI, GUNUNGKIDUL, DAERAH ISTIMEWA YOGYAKARTA",18,135,62,197
https://kawalpemilu.org#42212,"KEMADANG, TANJUNGSARI, GUNUNGKIDUL, DAERAH ISTIMEWA YOGYAKARTA",19,180,32,212
https://kawalpemilu.org#42212,"KEMADANG, TANJUNGSARI, GUNUNGKIDUL, DAERAH ISTIMEWA YOGYAKARTA",20,131,51,182
https://kawalpemilu.org#42212,"KEMADANG, TANJUNGSARI, GUNUNGKIDUL, DAERAH ISTIMEWA YOGYAKARTA",21,109,74,183
https://kawalpemilu.org#42212,"KEMADANG, TANJUNGSARI, GUNUNGKIDUL, DAERAH ISTIMEWA YOGYAKARTA",22,105,36,141
https://kawalpemilu.org#42212,"KEMADANG, TANJUNGSARI, GUNUNGKIDUL, DAERAH ISTIMEWA YOGYAKARTA",23,108,43,151
https://kawalpemilu.org#42212,"KEMADANG, TANJUNGSARI, GUNUNGKIDUL, DAERAH ISTIMEWA YOGYAKARTA",24,205,45,250
https://kawalpemilu.org#42212,"KEMADANG, TANJUNGSARI, GUNUNGKIDUL, DAERAH ISTIMEWA YOGYAKARTA",25,93,41,134
https://kawalpemilu.org#42213,"BANJAREJO, TANJUNGSARI, GUNUNGKIDUL, DAERAH ISTIMEWA YOGYAKARTA",1,148,37,185
https://kawalpemilu.org#42213,"BANJAREJO, TANJUNGSARI, GUNUNGKIDUL, DAERAH ISTIMEWA YOGYAKARTA",2,112,41,153
https://kawalpemilu.org#42213,"BANJAREJO, TANJUNGSARI, GUNUNGKIDUL, DAERAH ISTIMEWA YOGYAKARTA",3,165,54,219
https://kawalpemilu.org#42213,"BANJAREJO, TANJUNGSARI, GUNUNGKIDUL, DAERAH ISTIMEWA YOGYAKARTA",4,192,58,250
https://kawalpemilu.org#42213,"BANJAREJO, TANJUNGSARI, GUNUNGKIDUL, DAERAH ISTIMEWA YOGYAKARTA",5,186,22,208
https://kawalpemilu.org#42213,"BANJAREJO, TANJUNGSARI, GUNUNGKIDUL, DAERAH ISTIMEWA YOGYAKARTA",6,159,37,196
https://kawalpemilu.org#42213,"BANJAREJO, TANJUNGSARI, GUNUNGKIDUL, DAERAH ISTIMEWA YOGYAKARTA",7,174,39,213
https://kawalpemilu.org#42213,"BANJAREJO, TANJUNGSARI, GUNUNGKIDUL, DAERAH ISTIMEWA YOGYAKARTA",8,133,22,155
https://kawalpemilu.org#42213,"BANJAREJO, TANJUNGSARI, GUNUNGKIDUL, DAERAH ISTIMEWA YOGYAKARTA",9,95,21,116
https://kawalpemilu.org#42213,"BANJAREJO, TANJUNGSARI, GUNUNGKIDUL, DAERAH ISTIMEWA YOGYAKARTA",10,96,22,118
https://kawalpemilu.org#42213,"BANJAREJO, TANJUNGSARI, GUNUNGKIDUL, DAERAH ISTIMEWA YOGYAKARTA",11,106,46,152
https://kawalpemilu.org#42213,"BANJAREJO, TANJUNGSARI, GUNUNGKIDUL, DAERAH ISTIMEWA YOGYAKARTA",12,109,57,166
https://kawalpemilu.org#42213,"BANJAREJO, TANJUNGSARI, GUNUNGKIDUL, DAERAH ISTIMEWA YOGYAKARTA",13,60,28,88
https://kawalpemilu.org#42213,"BANJAREJO, TANJUNGSARI, GUNUNGKIDUL, DAERAH ISTIMEWA YOGYAKARTA",14,126,62,188
https://kawalpemilu.org#42213,"BANJAREJO, TANJUNGSARI, GUNUNGKIDUL, DAERAH ISTIMEWA YOGYAKARTA",15,105,125,230
https://kawalpemilu.org#42213,"BANJAREJO, TANJUNGSARI, GUNUNGKIDUL, DAERAH ISTIMEWA YOGYAKARTA",16,70,49,119
https://kawalpemilu.org#42213,"BANJAREJO, TANJUNGSARI, GUNUNGKIDUL, DAERAH ISTIMEWA YOGYAKARTA",17,48,66,114
https://kawalpemilu.org#42213,"BANJAREJO, TANJUNGSARI, GUNUNGKIDUL, DAERAH ISTIMEWA YOGYAKARTA",18,211,49,260
https://kawalpemilu.org#42213,"BANJAREJO, TANJUNGSARI, GUNUNGKIDUL, DAERAH ISTIMEWA YOGYAKARTA",19,111,56,167
https://kawalpemilu.org#42213,"BANJAREJO, TANJUNGSARI, GUNUNGKIDUL, DAERAH ISTIMEWA YOGYAKARTA",20,142,56,198
https://kawalpemilu.org#42213,"BANJAREJO, TANJUNGSARI, GUNUNGKIDUL, DAERAH ISTIMEWA YOGYAKARTA",21,155,46,201
https://kawalpemilu.org#42213,"BANJAREJO, TANJUNGSARI, GUNUNGKIDUL, DAERAH ISTIMEWA YOGYAKARTA",22,68,26,94
https://kawalpemilu.org#42213,"BANJAREJO, TANJUNGSARI, GUNUNGKIDUL, DAERAH ISTIMEWA YOGYAKARTA",23,161,40,201
https://kawalpemilu.org#42213,"BANJAREJO, TANJUNGSARI, GUNUNGKIDUL, DAERAH ISTIMEWA YOGYAKARTA",24,126,29,155
https://kawalpemilu.org#42214,"NGESTIREJO, TANJUNGSARI, GUNUNGKIDUL, DAERAH ISTIMEWA YOGYAKARTA",1,175,46,221
https://kawalpemilu.org#42214,"NGESTIREJO, TANJUNGSARI, GUNUNGKIDUL, DAERAH ISTIMEWA YOGYAKARTA",2,125,21,146
https://kawalpemilu.org#42214,"NGESTIREJO, TANJUNGSARI, GUNUNGKIDUL, DAERAH ISTIMEWA YOGYAKARTA",3,157,26,183
https://kawalpemilu.org#42214,"NGESTIREJO, TANJUNGSARI, GUNUNGKIDUL, DAERAH ISTIMEWA YOGYAKARTA",4,183,28,211
https://kawalpemilu.org#42214,"NGESTIREJO, TANJUNGSARI, GUNUNGKIDUL, DAERAH ISTIMEWA YOGYAKARTA",5,145,31,176
https://kawalpemilu.org#42214,"NGESTIREJO, TANJUNGSARI, GUNUNGKIDUL, DAERAH ISTIMEWA YOGYAKARTA",6,115,18,133
https://kawalpemilu.org#42214,"NGESTIREJO, TANJUNGSARI, GUNUNGKIDUL, DAERAH ISTIMEWA YOGYAKARTA",7,108,48,156
https://kawalpemilu.org#42214,"NGESTIREJO, TANJUNGSARI, GUNUNGKIDUL, DAERAH ISTIMEWA YOGYAKARTA",8,101,17,118
https://kawalpemilu.org#42214,"NGESTIREJO, TANJUNGSARI, GUNUNGKIDUL, DAERAH ISTIMEWA YOGYAKARTA",9,124,71,195
https://kawalpemilu.org#42214,"NGESTIREJO, TANJUNGSARI, GUNUNGKIDUL, DAERAH ISTIMEWA YOGYAKARTA",10,172,39,211
https://kawalpemilu.org#42214,"NGESTIREJO, TANJUNGSARI, GUNUNGKIDUL, DAERAH ISTIMEWA YOGYAKARTA",11,211,40,251
https://kawalpemilu.org#42214,"NGESTIREJO, TANJUNGSARI, GUNUNGKIDUL, DAERAH ISTIMEWA YOGYAKARTA",12,173,34,207
https://kawalpemilu.org#42214,"NGESTIREJO, TANJUNGSARI, GUNUNGKIDUL, DAERAH ISTIMEWA YOGYAKARTA",13,185,39,224
https://kawalpemilu.org#42214,"NGESTIREJO, TANJUNGSARI, GUNUNGKIDUL, DAERAH ISTIMEWA YOGYAKARTA",14,138,90,228
https://kawalpemilu.org#42214,"NGESTIREJO, TANJUNGSARI, GUNUNGKIDUL, DAERAH ISTIMEWA YOGYAKARTA",15,119,43,162
https://kawalpemilu.org#42214,"NGESTIREJO, TANJUNGSARI, GUNUNGKIDUL, DAERAH ISTIMEWA YOGYAKARTA",16,186,66,252
https://kawalpemilu.org#42214,"NGESTIREJO, TANJUNGSARI, GUNUNGKIDUL, DAERAH ISTIMEWA YOGYAKARTA",17,69,64,133
https://kawalpemilu.org#42214,"NGESTIREJO, TANJUNGSARI, GUNUNGKIDUL, DAERAH ISTIMEWA YOGYAKARTA",18,103,90,193
https://kawalpemilu.org#42214,"NGESTIREJO, TANJUNGSARI, GUNUNGKIDUL, DAERAH ISTIMEWA YOGYAKARTA",19,119,51,170
https://kawalpemilu.org#42214,"NGESTIREJO, TANJUNGSARI, GUNUNGKIDUL, DAERAH ISTIMEWA YOGYAKARTA",20,90,54,144
https://kawalpemilu.org#42214,"NGESTIREJO, TANJUNGSARI, GUNUNGKIDUL, DAERAH ISTIMEWA YOGYAKARTA",21,81,123,204
https://kawalpemilu.org#42214,"NGESTIREJO, TANJUNGSARI, GUNUNGKIDUL, DAERAH ISTIMEWA YOGYAKARTA",22,89,74,163
https://kawalpemilu.org#42216,"GIRIPURWO, PURWOSARI, GUNUNGKIDUL, DAERAH ISTIMEWA YOGYAKARTA",1,184,26,210
https://kawalpemilu.org#42216,"GIRIPURWO, PURWOSARI, GUNUNGKIDUL, DAERAH ISTIMEWA YOGYAKARTA",2,146,48,194
https://kawalpemilu.org#42216,"GIRIPURWO, PURWOSARI, GUNUNGKIDUL, DAERAH ISTIMEWA YOGYAKARTA",3,177,27,204
https://kawalpemilu.org#42216,"GIRIPURWO, PURWOSARI, GUNUNGKIDUL, DAERAH ISTIMEWA YOGYAKARTA",4,127,51,178
https://kawalpemilu.org#42216,"GIRIPURWO, PURWOSARI, GUNUNGKIDUL, DAERAH ISTIMEWA YOGYAKARTA",5,149,70,219
https://kawalpemilu.org#42216,"GIRIPURWO, PURWOSARI, GUNUNGKIDUL, DAERAH ISTIMEWA YOGYAKARTA",6,93,51,144
https://kawalpemilu.org#42216,"GIRIPURWO, PURWOSARI, GUNUNGKIDUL, DAERAH ISTIMEWA YOGYAKARTA",7,167,41,208
https://kawalpemilu.org#42216,"GIRIPURWO, PURWOSARI, GUNUNGKIDUL, DAERAH ISTIMEWA YOGYAKARTA",8,156,55,211
https://kawalpemilu.org#42216,"GIRIPURWO, PURWOSARI, GUNUNGKIDUL, DAERAH ISTIMEWA YOGYAKARTA",9,134,35,169
https://kawalpemilu.org#42216,"GIRIPURWO, PURWOSARI, GUNUNGKIDUL, DAERAH ISTIMEWA YOGYAKARTA",10,184,26,210
https://kawalpemilu.org#42216,"GIRIPURWO, PURWOSARI, GUNUNGKIDUL, DAERAH ISTIMEWA YOGYAKARTA",11,170,45,215
https://kawalpemilu.org#42216,"GIRIPURWO, PURWOSARI, GUNUNGKIDUL, DAERAH ISTIMEWA YOGYAKARTA",12,131,29,160
https://kawalpemilu.org#42216,"GIRIPURWO, PURWOSARI, GUNUNGKIDUL, DAERAH ISTIMEWA YOGYAKARTA",13,161,43,204
https://kawalpemilu.org#42216,"GIRIPURWO, PURWOSARI, GUNUNGKIDUL, DAERAH ISTIMEWA YOGYAKARTA",14,146,81,227
https://kawalpemilu.org#42216,"GIRIPURWO, PURWOSARI, GUNUNGKIDUL, DAERAH ISTIMEWA YOGYAKARTA",15,126,85,211
https://kawalpemilu.org#42216,"GIRIPURWO, PURWOSARI, GUNUNGKIDUL, DAERAH ISTIMEWA YOGYAKARTA",16,94,6,100
https://kawalpemilu.org#42216,"GIRIPURWO, PURWOSARI, GUNUNGKIDUL, DAERAH ISTIMEWA YOGYAKARTA",17,118,13,131
https://kawalpemilu.org#42216,"GIRIPURWO, PURWOSARI, GUNUNGKIDUL, DAERAH ISTIMEWA YOGYAKARTA",18,170,23,193
https://kawalpemilu.org#42216,"GIRIPURWO, PURWOSARI, GUNUNGKIDUL, DAERAH ISTIMEWA YOGYAKARTA",19,161,24,185
https://kawalpemilu.org#42216,"GIRIPURWO, PURWOSARI, GUNUNGKIDUL, DAERAH ISTIMEWA YOGYAKARTA",20,112,35,147
https://kawalpemilu.org#42216,"GIRIPURWO, PURWOSARI, GUNUNGKIDUL, DAERAH ISTIMEWA YOGYAKARTA",21,142,9,151
https://kawalpemilu.org#42216,"GIRIPURWO, PURWOSARI, GUNUNGKIDUL, DAERAH ISTIMEWA YOGYAKARTA",22,112,28,140
https://kawalpemilu.org#42216,"GIRIPURWO, PURWOSARI, GUNUNGKIDUL, DAERAH ISTIMEWA YOGYAKARTA",23,196,36,232
https://kawalpemilu.org#42216,"GIRIPURWO, PURWOSARI, GUNUNGKIDUL, DAERAH ISTIMEWA YOGYAKARTA",24,144,27,171
https://kawalpemilu.org#42216,"GIRIPURWO, PURWOSARI, GUNUNGKIDUL, DAERAH ISTIMEWA YOGYAKARTA",25,133,48,181
https://kawalpemilu.org#42216,"GIRIPURWO, PURWOSARI, GUNUNGKIDUL, DAERAH ISTIMEWA YOGYAKARTA",26,78,126,204
https://kawalpemilu.org#42216,"GIRIPURWO, PURWOSARI, GUNUNGKIDUL, DAERAH ISTIMEWA YOGYAKARTA",27,151,88,239
https://kawalpemilu.org#42216,"GIRIPURWO, PURWOSARI, GUNUNGKIDUL, DAERAH ISTIMEWA YOGYAKARTA",28,171,41,212
https://kawalpemilu.org#42216,"GIRIPURWO, PURWOSARI, GUNUNGKIDUL, DAERAH ISTIMEWA YOGYAKARTA",29,91,92,183
https://kawalpemilu.org#42216,"GIRIPURWO, PURWOSARI, GUNUNGKIDUL, DAERAH ISTIMEWA YOGYAKARTA",30,176,27,203
https://kawalpemilu.org#42216,"GIRIPURWO, PURWOSARI, GUNUNGKIDUL, DAERAH ISTIMEWA YOGYAKARTA",31,141,26,167
https://kawalpemilu.org#42217,"GIRICAHYO, PURWOSARI, GUNUNGKIDUL, DAERAH ISTIMEWA YOGYAKARTA",1,145,63,208
https://kawalpemilu.org#42217,"GIRICAHYO, PURWOSARI, GUNUNGKIDUL, DAERAH ISTIMEWA YOGYAKARTA",2,157,55,212
https://kawalpemilu.org#42217,"GIRICAHYO, PURWOSARI, GUNUNGKIDUL, DAERAH ISTIMEWA YOGYAKARTA",3,182,68,250
https://kawalpemilu.org#42217,"GIRICAHYO, PURWOSARI, GUNUNGKIDUL, DAERAH ISTIMEWA YOGYAKARTA",4,192,41,233
https://kawalpemilu.org#42217,"GIRICAHYO, PURWOSARI, GUNUNGKIDUL, DAERAH ISTIMEWA YOGYAKARTA",5,177,37,214
https://kawalpemilu.org#42217,"GIRICAHYO, PURWOSARI, GUNUNGKIDUL, DAERAH ISTIMEWA YOGYAKARTA",6,155,62,217
https://kawalpemilu.org#42217,"GIRICAHYO, PURWOSARI, GUNUNGKIDUL, DAERAH ISTIMEWA YOGYAKARTA",7,210,27,237
https://kawalpemilu.org#42217,"GIRICAHYO, PURWOSARI, GUNUNGKIDUL, DAERAH ISTIMEWA YOGYAKARTA",8,190,58,248
https://kawalpemilu.org#42217,"GIRICAHYO, PURWOSARI, GUNUNGKIDUL, DAERAH ISTIMEWA YOGYAKARTA",9,192,46,238
https://kawalpemilu.org#42217,"GIRICAHYO, PURWOSARI, GUNUNGKIDUL, DAERAH ISTIMEWA YOGYAKARTA",10,163,49,212
https://kawalpemilu.org#42217,"GIRICAHYO, PURWOSARI, GUNUNGKIDUL, DAERAH ISTIMEWA YOGYAKARTA",11,150,61,211
https://kawalpemilu.org#42217,"GIRICAHYO, PURWOSARI, GUNUNGKIDUL, DAERAH ISTIMEWA YOGYAKARTA",12,153,82,235
https://kawalpemilu.org#42218,"GIRIJATI, PURWOSARI, GUNUNGKIDUL, DAERAH ISTIMEWA YOGYAKARTA",1,175,59,234
https://kawalpemilu.org#42218,"GIRIJATI, PURWOSARI, GUNUNGKIDUL, DAERAH ISTIMEWA YOGYAKARTA",2,125,69,194
https://kawalpemilu.org#42218,"GIRIJATI, PURWOSARI, GUNUNGKIDUL, DAERAH ISTIMEWA YOGYAKARTA",3,140,74,214
https://kawalpemilu.org#42218,"GIRIJATI, PURWOSARI, GUNUNGKIDUL, DAERAH ISTIMEWA YOGYAKARTA",4,158,65,223
https://kawalpemilu.org#42218,"GIRIJATI, PURWOSARI, GUNUNGKIDUL, DAERAH ISTIMEWA YOGYAKARTA",5,132,48,180
https://kawalpemilu.org#42218,"GIRIJATI, PURWOSARI, GUNUNGKIDUL, DAERAH ISTIMEWA YOGYAKARTA",6,130,54,184
https://kawalpemilu.org#42218,"GIRIJATI, PURWOSARI, GUNUNGKIDUL, DAERAH ISTIMEWA YOGYAKARTA",7,149,36,185
https://kawalpemilu.org#42219,"GIRIASIH, PURWOSARI, GUNUNGKIDUL, DAERAH ISTIMEWA YOGYAKARTA",1,144,63,207
https://kawalpemilu.org#42219,"GIRIASIH, PURWOSARI, GUNUNGKIDUL, DAERAH ISTIMEWA YOGYAKARTA",2,126,51,177
https://kawalpemilu.org#42219,"GIRIASIH, PURWOSARI, GUNUNGKIDUL, DAERAH ISTIMEWA YOGYAKARTA",3,220,20,240
https://kawalpemilu.org#42219,"GIRIASIH, PURWOSARI, GUNUNGKIDUL, DAERAH ISTIMEWA YOGYAKARTA",4,144,26,170
https://kawalpemilu.org#42219,"GIRIASIH, PURWOSARI, GUNUNGKIDUL, DAERAH ISTIMEWA YOGYAKARTA",5,144,48,192
https://kawalpemilu.org#42220,"GIRITIRTO, PURWOSARI, GUNUNGKIDUL, DAERAH ISTIMEWA YOGYAKARTA",1,176,61,237
https://kawalpemilu.org#42220,"GIRITIRTO, PURWOSARI, GUNUNGKIDUL, DAERAH ISTIMEWA YOGYAKARTA",2,168,57,225
https://kawalpemilu.org#42220,"GIRITIRTO, PURWOSARI, GUNUNGKIDUL, DAERAH ISTIMEWA YOGYAKARTA",3,131,118,249
https://kawalpemilu.org#42220,"GIRITIRTO, PURWOSARI, GUNUNGKIDUL, DAERAH ISTIMEWA YOGYAKARTA",4,179,62,241
https://kawalpemilu.org#42220,"GIRITIRTO, PURWOSARI, GUNUNGKIDUL, DAERAH ISTIMEWA YOGYAKARTA",5,171,44,215
https://kawalpemilu.org#42220,"GIRITIRTO, PURWOSARI, GUNUNGKIDUL, DAERAH ISTIMEWA YOGYAKARTA",6,163,23,186
https://kawalpemilu.org#42220,"GIRITIRTO, PURWOSARI, GUNUNGKIDUL, DAERAH ISTIMEWA YOGYAKARTA",7,143,83,226
https://kawalpemilu.org#42220,"GIRITIRTO, PURWOSARI, GUNUNGKIDUL, DAERAH ISTIMEWA YOGYAKARTA",8,188,62,250
https://kawalpemilu.org#42220,"GIRITIRTO, PURWOSARI, GUNUNGKIDUL, DAERAH ISTIMEWA YOGYAKARTA",9,246,30,276
https://kawalpemilu.org#42220,"GIRITIRTO, PURWOSARI, GUNUNGKIDUL, DAERAH ISTIMEWA YOGYAKARTA",10,236,25,261
https://kawalpemilu.org#42220,"GIRITIRTO, PURWOSARI, GUNUNGKIDUL, DAERAH ISTIMEWA YOGYAKARTA",11,163,25,188
https://kawalpemilu.org#42220,"GIRITIRTO, PURWOSARI, GUNUNGKIDUL, DAERAH ISTIMEWA YOGYAKARTA",12,179,27,206
https://kawalpemilu.org#42223,"BALECATUR, GAMPING, SLEMAN, DAERAH ISTIMEWA YOGYAKARTA",1,114,96,210
https://kawalpemilu.org#42223,"BALECATUR, GAMPING, SLEMAN, DAERAH ISTIMEWA YOGYAKARTA",2,131,65,196
https://kawalpemilu.org#42223,"BALECATUR, GAMPING, SLEMAN, DAERAH ISTIMEWA YOGYAKARTA",3,110,70,180
https://kawalpemilu.org#42223,"BALECATUR, GAMPING, SLEMAN, DAERAH ISTIMEWA YOGYAKARTA",4,161,91,252
https://kawalpemilu.org#42223,"BALECATUR, GAMPING, SLEMAN, DAERAH ISTIMEWA YOGYAKARTA",5,126,112,238
https://kawalpemilu.org#42223,"BALECATUR, GAMPING, SLEMAN, DAERAH ISTIMEWA YOGYAKARTA",6,134,77,211
https://kawalpemilu.org#42223,"BALECATUR, GAMPING, SLEMAN, DAERAH ISTIMEWA YOGYAKARTA",7,152,94,246
https://kawalpemilu.org#42223,"BALECATUR, GAMPING, SLEMAN, DAERAH ISTIMEWA YOGYAKARTA",8,175,83,258
https://kawalpemilu.org#42223,"BALECATUR, GAMPING, SLEMAN, DAERAH ISTIMEWA YOGYAKARTA",9,158,97,255
https://kawalpemilu.org#42223,"BALECATUR, GAMPING, SLEMAN, DAERAH ISTIMEWA YOGYAKARTA",10,179,42,221
https://kawalpemilu.org#42223,"BALECATUR, GAMPING, SLEMAN, DAERAH ISTIMEWA YOGYAKARTA",11,101,78,179
https://kawalpemilu.org#42223,"BALECATUR, GAMPING, SLEMAN, DAERAH ISTIMEWA YOGYAKARTA",12,80,81,161
https://kawalpemilu.org#42223,"BALECATUR, GAMPING, SLEMAN, DAERAH ISTIMEWA YOGYAKARTA",13,95,47,142
https://kawalpemilu.org#42223,"BALECATUR, GAMPING, SLEMAN, DAERAH ISTIMEWA YOGYAKARTA",14,143,87,230
https://kawalpemilu.org#42223,"BALECATUR, GAMPING, SLEMAN, DAERAH ISTIMEWA YOGYAKARTA",15,151,62,213
https://kawalpemilu.org#42223,"BALECATUR, GAMPING, SLEMAN, DAERAH ISTIMEWA YOGYAKARTA",16,166,45,211
https://kawalpemilu.org#42223,"BALECATUR, GAMPING, SLEMAN, DAERAH ISTIMEWA YOGYAKARTA",17,106,66,172
https://kawalpemilu.org#42223,"BALECATUR, GAMPING, SLEMAN, DAERAH ISTIMEWA YOGYAKARTA",21,137,70,207
https://kawalpemilu.org#42223,"BALECATUR, GAMPING, SLEMAN, DAERAH ISTIMEWA YOGYAKARTA",22,101,52,153
https://kawalpemilu.org#42223,"BALECATUR, GAMPING, SLEMAN, DAERAH ISTIMEWA YOGYAKARTA",23,127,88,215
https://kawalpemilu.org#42223,"BALECATUR, GAMPING, SLEMAN, DAERAH ISTIMEWA YOGYAKARTA",24,130,75,205
https://kawalpemilu.org#42223,"BALECATUR, GAMPING, SLEMAN, DAERAH ISTIMEWA YOGYAKARTA",25,191,62,253
https://kawalpemilu.org#42223,"BALECATUR, GAMPING, SLEMAN, DAERAH ISTIMEWA YOGYAKARTA",26,178,58,236
https://kawalpemilu.org#42223,"BALECATUR, GAMPING, SLEMAN, DAERAH ISTIMEWA YOGYAKARTA",27,136,67,203
https://kawalpemilu.org#42223,"BALECATUR, GAMPING, SLEMAN, DAERAH ISTIMEWA YOGYAKARTA",28,147,83,230
https://kawalpemilu.org#42223,"BALECATUR, GAMPING, SLEMAN, DAERAH ISTIMEWA YOGYAKARTA",29,116,155,271
https://kawalpemilu.org#42223,"BALECATUR, GAMPING, SLEMAN, DAERAH ISTIMEWA YOGYAKARTA",31,144,112,256
https://kawalpemilu.org#42223,"BALECATUR, GAMPING, SLEMAN, DAERAH ISTIMEWA YOGYAKARTA",32,150,104,254
https://kawalpemilu.org#42223,"BALECATUR, GAMPING, SLEMAN, DAERAH ISTIMEWA YOGYAKARTA",34,158,95,253
https://kawalpemilu.org#42223,"BALECATUR, GAMPING, SLEMAN, DAERAH ISTIMEWA YOGYAKARTA",35,176,76,251
https://kawalpemilu.org#42223,"BALECATUR, GAMPING, SLEMAN, DAERAH ISTIMEWA YOGYAKARTA",36,154,69,223
https://kawalpemilu.org#42223,"BALECATUR, GAMPING, SLEMAN, DAERAH ISTIMEWA YOGYAKARTA",37,155,93,248
https://kawalpemilu.org#42223,"BALECATUR, GAMPING, SLEMAN, DAERAH ISTIMEWA YOGYAKARTA",38,134,117,251
https://kawalpemilu.org#42223,"BALECATUR, GAMPING, SLEMAN, DAERAH ISTIMEWA YOGYAKARTA",39,113,71,184
https://kawalpemilu.org#42223,"BALECATUR, GAMPING, SLEMAN, DAERAH ISTIMEWA YOGYAKARTA",40,94,76,170
https://kawalpemilu.org#42223,"BALECATUR, GAMPING, SLEMAN, DAERAH ISTIMEWA YOGYAKARTA",41,199,76,275
https://kawalpemilu.org#42223,"BALECATUR, GAMPING, SLEMAN, DAERAH ISTIMEWA YOGYAKARTA",42,196,59,255
https://kawalpemilu.org#42223,"BALECATUR, GAMPING, SLEMAN, DAERAH ISTIMEWA YOGYAKARTA",43,168,83,251
https://kawalpemilu.org#42223,"BALECATUR, GAMPING, SLEMAN, DAERAH ISTIMEWA YOGYAKARTA",44,128,115,243
https://kawalpemilu.org#42223,"BALECATUR, GAMPING, SLEMAN, DAERAH ISTIMEWA YOGYAKARTA",45,135,64,199
https://kawalpemilu.org#42223,"BALECATUR, GAMPING, SLEMAN, DAERAH ISTIMEWA YOGYAKARTA",46,137,51,188
https://kawalpemilu.org#42223,"BALECATUR, GAMPING, SLEMAN, DAERAH ISTIMEWA YOGYAKARTA",47,177,85,262
https://kawalpemilu.org#42223,"BALECATUR, GAMPING, SLEMAN, DAERAH ISTIMEWA YOGYAKARTA",48,161,84,245
https://kawalpemilu.org#42223,"BALECATUR, GAMPING, SLEMAN, DAERAH ISTIMEWA YOGYAKARTA",49,77,80,157
https://kawalpemilu.org#42223,"BALECATUR, GAMPING, SLEMAN, DAERAH ISTIMEWA YOGYAKARTA",50,151,84,235
https://kawalpemilu.org#42223,"BALECATUR, GAMPING, SLEMAN, DAERAH ISTIMEWA YOGYAKARTA",51,210,40,250
https://kawalpemilu.org#42223,"BALECATUR, GAMPING, SLEMAN, DAERAH ISTIMEWA YOGYAKARTA",52,149,100,249
https://kawalpemilu.org#42223,"BALECATUR, GAMPING, SLEMAN, DAERAH ISTIMEWA YOGYAKARTA",53,158,87,245
https://kawalpemilu.org#42223,"BALECATUR, GAMPING, SLEMAN, DAERAH ISTIMEWA YOGYAKARTA",54,166,78,244
https://kawalpemilu.org#42223,"BALECATUR, GAMPING, SLEMAN, DAERAH ISTIMEWA YOGYAKARTA",55,133,115,248
https://kawalpemilu.org#42223,"BALECATUR, GAMPING, SLEMAN, DAERAH ISTIMEWA YOGYAKARTA",56,113,137,250
https://kawalpemilu.org#42223,"BALECATUR, GAMPING, SLEMAN, DAERAH ISTIMEWA YOGYAKARTA",57,140,45,185
https://kawalpemilu.org#42223,"BALECATUR, GAMPING, SLEMAN, DAERAH ISTIMEWA YOGYAKARTA",58,59,42,101
https://kawalpemilu.org#42224,"AMBARKETAWANG, GAMPING, SLEMAN, DAERAH ISTIMEWA YOGYAKARTA",1,193,74,267
https://kawalpemilu.org#42224,"AMBARKETAWANG, GAMPING, SLEMAN, DAERAH ISTIMEWA YOGYAKARTA",2,112,69,181
https://kawalpemilu.org#42224,"AMBARKETAWANG, GAMPING, SLEMAN, DAERAH ISTIMEWA YOGYAKARTA",3,189,67,256
https://kawalpemilu.org#42224,"AMBARKETAWANG, GAMPING, SLEMAN, DAERAH ISTIMEWA YOGYAKARTA",4,196,54,250
https://kawalpemilu.org#42224,"AMBARKETAWANG, GAMPING, SLEMAN, DAERAH ISTIMEWA YOGYAKARTA",5,119,94,213
https://kawalpemilu.org#42224,"AMBARKETAWANG, GAMPING, SLEMAN, DAERAH ISTIMEWA YOGYAKARTA",6,217,36,253
https://kawalpemilu.org#42224,"AMBARKETAWANG, GAMPING, SLEMAN, DAERAH ISTIMEWA YOGYAKARTA",7,180,30,210
https://kawalpemilu.org#42224,"AMBARKETAWANG, GAMPING, SLEMAN, DAERAH ISTIMEWA YOGYAKARTA",8,160,93,253
https://kawalpemilu.org#42224,"AMBARKETAWANG, GAMPING, SLEMAN, DAERAH ISTIMEWA YOGYAKARTA",10,126,88,214
https://kawalpemilu.org#42224,"AMBARKETAWANG, GAMPING, SLEMAN, DAERAH ISTIMEWA YOGYAKARTA",11,131,57,188
https://kawalpemilu.org#42224,"AMBARKETAWANG, GAMPING, SLEMAN, DAERAH ISTIMEWA YOGYAKARTA",12,162,70,232
https://kawalpemilu.org#42224,"AMBARKETAWANG, GAMPING, SLEMAN, DAERAH ISTIMEWA YOGYAKARTA",13,153,65,218
https://kawalpemilu.org#42224,"AMBARKETAWANG, GAMPING, SLEMAN, DAERAH ISTIMEWA YOGYAKARTA",14,115,54,169
https://kawalpemilu.org#42224,"AMBARKETAWANG, GAMPING, SLEMAN, DAERAH ISTIMEWA YOGYAKARTA",15,194,64,258
https://kawalpemilu.org#42224,"AMBARKETAWANG, GAMPING, SLEMAN, DAERAH ISTIMEWA YOGYAKARTA",16,177,82,259
https://kawalpemilu.org#42224,"AMBARKETAWANG, GAMPING, SLEMAN, DAERAH ISTIMEWA YOGYAKARTA",17,176,71,247
https://kawalpemilu.org#42224,"AMBARKETAWANG, GAMPING, SLEMAN, DAERAH ISTIMEWA YOGYAKARTA",18,147,92,239
https://kawalpemilu.org#42224,"AMBARKETAWANG, GAMPING, SLEMAN, DAERAH ISTIMEWA YOGYAKARTA",20,166,105,271
https://kawalpemilu.org#42224,"AMBARKETAWANG, GAMPING, SLEMAN, DAERAH ISTIMEWA YOGYAKARTA",21,140,123,263
https://kawalpemilu.org#42224,"AMBARKETAWANG, GAMPING, SLEMAN, DAERAH ISTIMEWA YOGYAKARTA",22,139,126,265
https://kawalpemilu.org#42224,"AMBARKETAWANG, GAMPING, SLEMAN, DAERAH ISTIMEWA YOGYAKARTA",23,145,103,248
https://kawalpemilu.org#42224,"AMBARKETAWANG, GAMPING, SLEMAN, DAERAH ISTIMEWA YOGYAKARTA",24,167,80,247
https://kawalpemilu.org#42224,"AMBARKETAWANG, GAMPING, SLEMAN, DAERAH ISTIMEWA YOGYAKARTA",25,162,77,239
https://kawalpemilu.org#42224,"AMBARKETAWANG, GAMPING, SLEMAN, DAERAH ISTIMEWA YOGYAKARTA",26,174,86,260
https://kawalpemilu.org#42224,"AMBARKETAWANG, GAMPING, SLEMAN, DAERAH ISTIMEWA YOGYAKARTA",27,126,89,215
https://kawalpemilu.org#42224,"AMBARKETAWANG, GAMPING, SLEMAN, DAERAH ISTIMEWA YOGYAKARTA",28,128,85,213
https://kawalpemilu.org#42224,"AMBARKETAWANG, GAMPING, SLEMAN, DAERAH ISTIMEWA YOGYAKARTA",29,157,87,244
https://kawalpemilu.org#42224,"AMBARKETAWANG, GAMPING, SLEMAN, DAERAH ISTIMEWA YOGYAKARTA",30,169,94,263
https://kawalpemilu.org#42224,"AMBARKETAWANG, GAMPING, SLEMAN, DAERAH ISTIMEWA YOGYAKARTA",31,144,102,246
https://kawalpemilu.org#42224,"AMBARKETAWANG, GAMPING, SLEMAN, DAERAH ISTIMEWA YOGYAKARTA",32,100,133,233
https://kawalpemilu.org#42224,"AMBARKETAWANG, GAMPING, SLEMAN, DAERAH ISTIMEWA YOGYAKARTA",33,170,99,269
https://kawalpemilu.org#42224,"AMBARKETAWANG, GAMPING, SLEMAN, DAERAH ISTIMEWA YOGYAKARTA",34,160,97,257
https://kawalpemilu.org#42224,"AMBARKETAWANG, GAMPING, SLEMAN, DAERAH ISTIMEWA YOGYAKARTA",35,147,105,252
https://kawalpemilu.org#42224,"AMBARKETAWANG, GAMPING, SLEMAN, DAERAH ISTIMEWA YOGYAKARTA",36,168,78,246
https://kawalpemilu.org#42224,"AMBARKETAWANG, GAMPING, SLEMAN, DAERAH ISTIMEWA YOGYAKARTA",37,130,124,254
https://kawalpemilu.org#42224,"AMBARKETAWANG, GAMPING, SLEMAN, DAERAH ISTIMEWA YOGYAKARTA",38,68,102,170
https://kawalpemilu.org#42224,"AMBARKETAWANG, GAMPING, SLEMAN, DAERAH ISTIMEWA YOGYAKARTA",39,107,96,203
https://kawalpemilu.org#42224,"AMBARKETAWANG, GAMPING, SLEMAN, DAERAH ISTIMEWA YOGYAKARTA",40,115,149,264
https://kawalpemilu.org#42224,"AMBARKETAWANG, GAMPING, SLEMAN, DAERAH ISTIMEWA YOGYAKARTA",41,91,144,235
https://kawalpemilu.org#42224,"AMBARKETAWANG, GAMPING, SLEMAN, DAERAH ISTIMEWA YOGYAKARTA",42,86,168,254
https://kawalpemilu.org#42224,"AMBARKETAWANG, GAMPING, SLEMAN, DAERAH ISTIMEWA YOGYAKARTA",43,131,122,253
https://kawalpemilu.org#42224,"AMBARKETAWANG, GAMPING, SLEMAN, DAERAH ISTIMEWA YOGYAKARTA",44,119,107,226
https://kawalpemilu.org#42224,"AMBARKETAWANG, GAMPING, SLEMAN, DAERAH ISTIMEWA YOGYAKARTA",45,183,76,259
https://kawalpemilu.org#42224,"AMBARKETAWANG, GAMPING, SLEMAN, DAERAH ISTIMEWA YOGYAKARTA",46,134,98,232
https://kawalpemilu.org#42224,"AMBARKETAWANG, GAMPING, SLEMAN, DAERAH ISTIMEWA YOGYAKARTA",47,114,97,211
https://kawalpemilu.org#42224,"AMBARKETAWANG, GAMPING, SLEMAN, DAERAH ISTIMEWA YOGYAKARTA",48,112,137,249
https://kawalpemilu.org#42224,"AMBARKETAWANG, GAMPING, SLEMAN, DAERAH ISTIMEWA YOGYAKARTA",49,134,85,219
https://kawalpemilu.org#42224,"AMBARKETAWANG, GAMPING, SLEMAN, DAERAH ISTIMEWA YOGYAKARTA",50,137,91,228
https://kawalpemilu.org#42224,"AMBARKETAWANG, GAMPING, SLEMAN, DAERAH ISTIMEWA YOGYAKARTA",51,127,72,199
https://kawalpemilu.org#42224,"AMBARKETAWANG, GAMPING, SLEMAN, DAERAH ISTIMEWA YOGYAKARTA",52,141,44,185
https://kawalpemilu.org#42224,"AMBARKETAWANG, GAMPING, SLEMAN, DAERAH ISTIMEWA YOGYAKARTA",53,142,66,208
https://kawalpemilu.org#42224,"AMBARKETAWANG, GAMPING, SLEMAN, DAERAH ISTIMEWA YOGYAKARTA",54,177,69,246
https://kawalpemilu.org#42224,"AMBARKETAWANG, GAMPING, SLEMAN, DAERAH ISTIMEWA YOGYAKARTA",55,151,85,236
https://kawalpemilu.org#42224,"AMBARKETAWANG, GAMPING, SLEMAN, DAERAH ISTIMEWA YOGYAKARTA",56,202,71,273
https://kawalpemilu.org#42224,"AMBARKETAWANG, GAMPING, SLEMAN, DAERAH ISTIMEWA YOGYAKARTA",57,107,89,196
https://kawalpemilu.org#42224,"AMBARKETAWANG, GAMPING, SLEMAN, DAERAH ISTIMEWA YOGYAKARTA",58,144,48,192
https://kawalpemilu.org#42224,"AMBARKETAWANG, GAMPING, SLEMAN, DAERAH ISTIMEWA YOGYAKARTA",59,136,69,205
https://kawalpemilu.org#42224,"AMBARKETAWANG, GAMPING, SLEMAN, DAERAH ISTIMEWA YOGYAKARTA",60,136,62,198
https://kawalpemilu.org#42224,"AMBARKETAWANG, GAMPING, SLEMAN, DAERAH ISTIMEWA YOGYAKARTA",61,109,109,218
https://kawalpemilu.org#42224,"AMBARKETAWANG, GAMPING, SLEMAN, DAERAH ISTIMEWA YOGYAKARTA",62,23,78,101
https://kawalpemilu.org#42225,"BANYURADEN, GAMPING, SLEMAN, DAERAH ISTIMEWA YOGYAKARTA",1,140,77,217
https://kawalpemilu.org#42225,"BANYURADEN, GAMPING, SLEMAN, DAERAH ISTIMEWA YOGYAKARTA",2,144,76,220
https://kawalpemilu.org#42225,"BANYURADEN, GAMPING, SLEMAN, DAERAH ISTIMEWA YOGYAKARTA",3,133,77,210
https://kawalpemilu.org#42225,"BANYURADEN, GAMPING, SLEMAN, DAERAH ISTIMEWA YOGYAKARTA",4,115,70,185
https://kawalpemilu.org#42225,"BANYURADEN, GAMPING, SLEMAN, DAERAH ISTIMEWA YOGYAKARTA",5,139,53,192
https://kawalpemilu.org#42225,"BANYURADEN, GAMPING, SLEMAN, DAERAH ISTIMEWA YOGYAKARTA",6,153,64,217
https://kawalpemilu.org#42225,"BANYURADEN, GAMPING, SLEMAN, DAERAH ISTIMEWA YOGYAKARTA",7,155,68,223
https://kawalpemilu.org#42225,"BANYURADEN, GAMPING, SLEMAN, DAERAH ISTIMEWA YOGYAKARTA",8,198,53,251
https://kawalpemilu.org#42225,"BANYURADEN, GAMPING, SLEMAN, DAERAH ISTIMEWA YOGYAKARTA",9,162,79,241
https://kawalpemilu.org#42225,"BANYURADEN, GAMPING, SLEMAN, DAERAH ISTIMEWA YOGYAKARTA",10,148,83,231
https://kawalpemilu.org#42225,"BANYURADEN, GAMPING, SLEMAN, DAERAH ISTIMEWA YOGYAKARTA",11,156,61,217
https://kawalpemilu.org#42225,"BANYURADEN, GAMPING, SLEMAN, DAERAH ISTIMEWA YOGYAKARTA",12,122,94,216
https://kawalpemilu.org#42225,"BANYURADEN, GAMPING, SLEMAN, DAERAH ISTIMEWA YOGYAKARTA",13,93,130,223
https://kawalpemilu.org#42225,"BANYURADEN, GAMPING, SLEMAN, DAERAH ISTIMEWA YOGYAKARTA",14,110,91,201
https://kawalpemilu.org#42225,"BANYURADEN, GAMPING, SLEMAN, DAERAH ISTIMEWA YOGYAKARTA",15,137,79,216
https://kawalpemilu.org#42225,"BANYURADEN, GAMPING, SLEMAN, DAERAH ISTIMEWA YOGYAKARTA",16,155,59,214
https://kawalpemilu.org#42225,"BANYURADEN, GAMPING, SLEMAN, DAERAH ISTIMEWA YOGYAKARTA",17,158,80,238
https://kawalpemilu.org#42225,"BANYURADEN, GAMPING, SLEMAN, DAERAH ISTIMEWA YOGYAKARTA",18,101,98,199
https://kawalpemilu.org#42225,"BANYURADEN, GAMPING, SLEMAN, DAERAH ISTIMEWA YOGYAKARTA",19,119,102,221
https://kawalpemilu.org#42225,"BANYURADEN, GAMPING, SLEMAN, DAERAH ISTIMEWA YOGYAKARTA",20,117,58,175
https://kawalpemilu.org#42225,"BANYURADEN, GAMPING, SLEMAN, DAERAH ISTIMEWA YOGYAKARTA",21,125,42,167
https://kawalpemilu.org#42225,"BANYURADEN, GAMPING, SLEMAN, DAERAH ISTIMEWA YOGYAKARTA",22,138,48,186
https://kawalpemilu.org#42225,"BANYURADEN, GAMPING, SLEMAN, DAERAH ISTIMEWA YOGYAKARTA",24,103,66,169
https://kawalpemilu.org#42225,"BANYURADEN, GAMPING, SLEMAN, DAERAH ISTIMEWA YOGYAKARTA",25,166,93,259
https://kawalpemilu.org#42225,"BANYURADEN, GAMPING, SLEMAN, DAERAH ISTIMEWA YOGYAKARTA",26,161,77,238
https://kawalpemilu.org#42225,"BANYURADEN, GAMPING, SLEMAN, DAERAH ISTIMEWA YOGYAKARTA",27,192,76,268
https://kawalpemilu.org#42225,"BANYURADEN, GAMPING, SLEMAN, DAERAH ISTIMEWA YOGYAKARTA",28,150,84,234
https://kawalpemilu.org#42225,"BANYURADEN, GAMPING, SLEMAN, DAERAH ISTIMEWA YOGYAKARTA",29,146,75,221
https://kawalpemilu.org#42225,"BANYURADEN, GAMPING, SLEMAN, DAERAH ISTIMEWA YOGYAKARTA",30,104,83,187
https://kawalpemilu.org#42225,"BANYURADEN, GAMPING, SLEMAN, DAERAH ISTIMEWA YOGYAKARTA",31,124,36,160
https://kawalpemilu.org#42225,"BANYURADEN, GAMPING, SLEMAN, DAERAH ISTIMEWA YOGYAKARTA",32,111,156,267
https://kawalpemilu.org#42225,"BANYURADEN, GAMPING, SLEMAN, DAERAH ISTIMEWA YOGYAKARTA",33,126,121,247
https://kawalpemilu.org#42225,"BANYURADEN, GAMPING, SLEMAN, DAERAH ISTIMEWA YOGYAKARTA",34,179,64,243
https://kawalpemilu.org#42225,"BANYURADEN, GAMPING, SLEMAN, DAERAH ISTIMEWA YOGYAKARTA",35,161,88,249
https://kawalpemilu.org#42225,"BANYURADEN, GAMPING, SLEMAN, DAERAH ISTIMEWA YOGYAKARTA",36,155,95,250
https://kawalpemilu.org#42225,"BANYURADEN, GAMPING, SLEMAN, DAERAH ISTIMEWA YOGYAKARTA",37,137,70,207
https://kawalpemilu.org#42225,"BANYURADEN, GAMPING, SLEMAN, DAERAH ISTIMEWA YOGYAKARTA",38,166,68,234
https://kawalpemilu.org#42225,"BANYURADEN, GAMPING, SLEMAN, DAERAH ISTIMEWA YOGYAKARTA",40,185,50,235
https://kawalpemilu.org#42225,"BANYURADEN, GAMPING, SLEMAN, DAERAH ISTIMEWA YOGYAKARTA",41,88,74,162
https://kawalpemilu.org#42225,"BANYURADEN, GAMPING, SLEMAN, DAERAH ISTIMEWA YOGYAKARTA",42,152,57,209
https://kawalpemilu.org#42225,"BANYURADEN, GAMPING, SLEMAN, DAERAH ISTIMEWA YOGYAKARTA",43,152,87,239
https://kawalpemilu.org#42225,"BANYURADEN, GAMPING, SLEMAN, DAERAH ISTIMEWA YOGYAKARTA",44,160,92,252
https://kawalpemilu.org#42225,"BANYURADEN, GAMPING, SLEMAN, DAERAH ISTIMEWA YOGYAKARTA",45,150,81,231
https://kawalpemilu.org#42225,"BANYURADEN, GAMPING, SLEMAN, DAERAH ISTIMEWA YOGYAKARTA",46,131,88,219
https://kawalpemilu.org#42225,"BANYURADEN, GAMPING, SLEMAN, DAERAH ISTIMEWA YOGYAKARTA",48,102,50,151
https://kawalpemilu.org#42225,"BANYURADEN, GAMPING, SLEMAN, DAERAH ISTIMEWA YOGYAKARTA",49,62,61,123
https://kawalpemilu.org#42226,"NOGOTIRTO, GAMPING, SLEMAN, DAERAH ISTIMEWA YOGYAKARTA",1,122,75,197
https://kawalpemilu.org#42226,"NOGOTIRTO, GAMPING, SLEMAN, DAERAH ISTIMEWA YOGYAKARTA",2,137,53,190
https://kawalpemilu.org#42226,"NOGOTIRTO, GAMPING, SLEMAN, DAERAH ISTIMEWA YOGYAKARTA",3,165,68,233
https://kawalpemilu.org#42226,"NOGOTIRTO, GAMPING, SLEMAN, DAERAH ISTIMEWA YOGYAKARTA",4,73,50,123
https://kawalpemilu.org#42226,"NOGOTIRTO, GAMPING, SLEMAN, DAERAH ISTIMEWA YOGYAKARTA",5,200,59,259
https://kawalpemilu.org#42226,"NOGOTIRTO, GAMPING, SLEMAN, DAERAH ISTIMEWA YOGYAKARTA",6,166,64,230
https://kawalpemilu.org#42226,"NOGOTIRTO, GAMPING, SLEMAN, DAERAH ISTIMEWA YOGYAKARTA",7,150,84,234
https://kawalpemilu.org#42226,"NOGOTIRTO, GAMPING, SLEMAN, DAERAH ISTIMEWA YOGYAKARTA",8,140,88,228
https://kawalpemilu.org#42226,"NOGOTIRTO, GAMPING, SLEMAN, DAERAH ISTIMEWA YOGYAKARTA",9,152,38,190
https://kawalpemilu.org#42226,"NOGOTIRTO, GAMPING, SLEMAN, DAERAH ISTIMEWA YOGYAKARTA",10,187,53,240
https://kawalpemilu.org#42226,"NOGOTIRTO, GAMPING, SLEMAN, DAERAH ISTIMEWA YOGYAKARTA",11,143,62,205
https://kawalpemilu.org#42226,"NOGOTIRTO, GAMPING, SLEMAN, DAERAH ISTIMEWA YOGYAKARTA",12,179,56,235
https://kawalpemilu.org#42226,"NOGOTIRTO, GAMPING, SLEMAN, DAERAH ISTIMEWA YOGYAKARTA",13,175,48,223
https://kawalpemilu.org#42226,"NOGOTIRTO, GAMPING, SLEMAN, DAERAH ISTIMEWA YOGYAKARTA",14,126,42,168
https://kawalpemilu.org#42226,"NOGOTIRTO, GAMPING, SLEMAN, DAERAH ISTIMEWA YOGYAKARTA",15,172,83,255
https://kawalpemilu.org#42226,"NOGOTIRTO, GAMPING, SLEMAN, DAERAH ISTIMEWA YOGYAKARTA",16,132,64,196
https://kawalpemilu.org#42226,"NOGOTIRTO, GAMPING, SLEMAN, DAERAH ISTIMEWA YOGYAKARTA",17,169,74,243
https://kawalpemilu.org#42226,"NOGOTIRTO, GAMPING, SLEMAN, DAERAH ISTIMEWA YOGYAKARTA",18,147,76,223
https://kawalpemilu.org#42226,"NOGOTIRTO, GAMPING, SLEMAN, DAERAH ISTIMEWA YOGYAKARTA",19,129,116,245
https://kawalpemilu.org#42226,"NOGOTIRTO, GAMPING, SLEMAN, DAERAH ISTIMEWA YOGYAKARTA",20,127,87,214
https://kawalpemilu.org#42226,"NOGOTIRTO, GAMPING, SLEMAN, DAERAH ISTIMEWA YOGYAKARTA",21,91,67,158
https://kawalpemilu.org#42226,"NOGOTIRTO, GAMPING, SLEMAN, DAERAH ISTIMEWA YOGYAKARTA",22,172,112,284
https://kawalpemilu.org#42226,"NOGOTIRTO, GAMPING, SLEMAN, DAERAH ISTIMEWA YOGYAKARTA",23,114,125,239
https://kawalpemilu.org#42226,"NOGOTIRTO, GAMPING, SLEMAN, DAERAH ISTIMEWA YOGYAKARTA",24,172,85,257
https://kawalpemilu.org#42226,"NOGOTIRTO, GAMPING, SLEMAN, DAERAH ISTIMEWA YOGYAKARTA",25,74,75,149
https://kawalpemilu.org#42226,"NOGOTIRTO, GAMPING, SLEMAN, DAERAH ISTIMEWA YOGYAKARTA",26,109,104,213
https://kawalpemilu.org#42226,"NOGOTIRTO, GAMPING, SLEMAN, DAERAH ISTIMEWA YOGYAKARTA",27,130,91,221
https://kawalpemilu.org#42226,"NOGOTIRTO, GAMPING, SLEMAN, DAERAH ISTIMEWA YOGYAKARTA",28,113,79,192
https://kawalpemilu.org#42226,"NOGOTIRTO, GAMPING, SLEMAN, DAERAH ISTIMEWA YOGYAKARTA",29,122,94,216
https://kawalpemilu.org#42226,"NOGOTIRTO, GAMPING, SLEMAN, DAERAH ISTIMEWA YOGYAKARTA",30,99,48,147
https://kawalpemilu.org#42226,"NOGOTIRTO, GAMPING, SLEMAN, DAERAH ISTIMEWA YOGYAKARTA",31,175,60,235
https://kawalpemilu.org#42226,"NOGOTIRTO, GAMPING, SLEMAN, DAERAH ISTIMEWA YOGYAKARTA",32,164,99,263
https://kawalpemilu.org#42226,"NOGOTIRTO, GAMPING, SLEMAN, DAERAH ISTIMEWA YOGYAKARTA",33,118,47,165
https://kawalpemilu.org#42226,"NOGOTIRTO, GAMPING, SLEMAN, DAERAH ISTIMEWA YOGYAKARTA",34,141,62,203
https://kawalpemilu.org#42226,"NOGOTIRTO, GAMPING, SLEMAN, DAERAH ISTIMEWA YOGYAKARTA",35,140,132,272
https://kawalpemilu.org#42226,"NOGOTIRTO, GAMPING, SLEMAN, DAERAH ISTIMEWA YOGYAKARTA",36,151,75,226
https://kawalpemilu.org#42226,"NOGOTIRTO, GAMPING, SLEMAN, DAERAH ISTIMEWA YOGYAKARTA",37,145,116,261
https://kawalpemilu.org#42226,"NOGOTIRTO, GAMPING, SLEMAN, DAERAH ISTIMEWA YOGYAKARTA",38,114,112,226
https://kawalpemilu.org#42226,"NOGOTIRTO, GAMPING, SLEMAN, DAERAH ISTIMEWA YOGYAKARTA",39,139,75,214
https://kawalpemilu.org#42226,"NOGOTIRTO, GAMPING, SLEMAN, DAERAH ISTIMEWA YOGYAKARTA",40,171,45,216
https://kawalpemilu.org#42226,"NOGOTIRTO, GAMPING, SLEMAN, DAERAH ISTIMEWA YOGYAKARTA",41,164,70,234
https://kawalpemilu.org#42226,"NOGOTIRTO, GAMPING, SLEMAN, DAERAH ISTIMEWA YOGYAKARTA",42,129,109,238
https://kawalpemilu.org#42226,"NOGOTIRTO, GAMPING, SLEMAN, DAERAH ISTIMEWA YOGYAKARTA",43,108,127,235
https://kawalpemilu.org#42226,"NOGOTIRTO, GAMPING, SLEMAN, DAERAH ISTIMEWA YOGYAKARTA",44,82,88,170
https://kawalpemilu.org#42226,"NOGOTIRTO, GAMPING, SLEMAN, DAERAH ISTIMEWA YOGYAKARTA",45,102,164,266
https://kawalpemilu.org#42226,"NOGOTIRTO, GAMPING, SLEMAN, DAERAH ISTIMEWA YOGYAKARTA",46,157,82,239
https://kawalpemilu.org#42226,"NOGOTIRTO, GAMPING, SLEMAN, DAERAH ISTIMEWA YOGYAKARTA",47,134,53,187
https://kawalpemilu.org#42226,"NOGOTIRTO, GAMPING, SLEMAN, DAERAH ISTIMEWA YOGYAKARTA",48,117,115,232
https://kawalpemilu.org#42226,"NOGOTIRTO, GAMPING, SLEMAN, DAERAH ISTIMEWA YOGYAKARTA",49,128,111,239
https://kawalpemilu.org#42226,"NOGOTIRTO, GAMPING, SLEMAN, DAERAH ISTIMEWA YOGYAKARTA",50,162,56,218
https://kawalpemilu.org#42226,"NOGOTIRTO, GAMPING, SLEMAN, DAERAH ISTIMEWA YOGYAKARTA",51,59,201,260
https://kawalpemilu.org#42226,"NOGOTIRTO, GAMPING, SLEMAN, DAERAH ISTIMEWA YOGYAKARTA",52,166,30,196
https://kawalpemilu.org#42226,"NOGOTIRTO, GAMPING, SLEMAN, DAERAH ISTIMEWA YOGYAKARTA",53,167,59,226
https://kawalpemilu.org#42226,"NOGOTIRTO, GAMPING, SLEMAN, DAERAH ISTIMEWA YOGYAKARTA",54,162,62,224
https://kawalpemilu.org#42226,"NOGOTIRTO, GAMPING, SLEMAN, DAERAH ISTIMEWA YOGYAKARTA",55,195,60,255
https://kawalpemilu.org#42226,"NOGOTIRTO, GAMPING, SLEMAN, DAERAH ISTIMEWA YOGYAKARTA",56,64,65,129
https://kawalpemilu.org#42226,"NOGOTIRTO, GAMPING, SLEMAN, DAERAH ISTIMEWA YOGYAKARTA",57,88,29,117
https://kawalpemilu.org#42226,"NOGOTIRTO, GAMPING, SLEMAN, DAERAH ISTIMEWA YOGYAKARTA",58,71,46,117
https://kawalpemilu.org#42227,"TRIHANGGO, GAMPING, SLEMAN, DAERAH ISTIMEWA YOGYAKARTA",1,183,52,235
https://kawalpemilu.org#42227,"TRIHANGGO, GAMPING, SLEMAN, DAERAH ISTIMEWA YOGYAKARTA",2,154,64,218
https://kawalpemilu.org#42227,"TRIHANGGO, GAMPING, SLEMAN, DAERAH ISTIMEWA YOGYAKARTA",4,173,107,280
https://kawalpemilu.org#42227,"TRIHANGGO, GAMPING, SLEMAN, DAERAH ISTIMEWA YOGYAKARTA",5,192,57,249
https://kawalpemilu.org#42227,"TRIHANGGO, GAMPING, SLEMAN, DAERAH ISTIMEWA YOGYAKARTA",6,179,82,261
https://kawalpemilu.org#42227,"TRIHANGGO, GAMPING, SLEMAN, DAERAH ISTIMEWA YOGYAKARTA",7,178,95,273
https://kawalpemilu.org#42227,"TRIHANGGO, GAMPING, SLEMAN, DAERAH ISTIMEWA YOGYAKARTA",9,187,81,268
https://kawalpemilu.org#42227,"TRIHANGGO, GAMPING, SLEMAN, DAERAH ISTIMEWA YOGYAKARTA",10,172,80,252
https://kawalpemilu.org#42227,"TRIHANGGO, GAMPING, SLEMAN, DAERAH ISTIMEWA YOGYAKARTA",11,118,71,189
https://kawalpemilu.org#42227,"TRIHANGGO, GAMPING, SLEMAN, DAERAH ISTIMEWA YOGYAKARTA",12,185,67,252
https://kawalpemilu.org#42227,"TRIHANGGO, GAMPING, SLEMAN, DAERAH ISTIMEWA YOGYAKARTA",13,190,82,272
https://kawalpemilu.org#42227,"TRIHANGGO, GAMPING, SLEMAN, DAERAH ISTIMEWA YOGYAKARTA",14,151,96,247
https://kawalpemilu.org#42227,"TRIHANGGO, GAMPING, SLEMAN, DAERAH ISTIMEWA YOGYAKARTA",15,166,95,261
https://kawalpemilu.org#42227,"TRIHANGGO, GAMPING, SLEMAN, DAERAH ISTIMEWA YOGYAKARTA",16,107,59,166
https://kawalpemilu.org#42227,"TRIHANGGO, GAMPING, SLEMAN, DAERAH ISTIMEWA YOGYAKARTA",17,137,120,257
https://kawalpemilu.org#42227,"TRIHANGGO, GAMPING, SLEMAN, DAERAH ISTIMEWA YOGYAKARTA",18,123,100,223
https://kawalpemilu.org#42227,"TRIHANGGO, GAMPING, SLEMAN, DAERAH ISTIMEWA YOGYAKARTA",19,113,117,230
https://kawalpemilu.org#42227,"TRIHANGGO, GAMPING, SLEMAN, DAERAH ISTIMEWA YOGYAKARTA",20,110,104,214
https://kawalpemilu.org#42227,"TRIHANGGO, GAMPING, SLEMAN, DAERAH ISTIMEWA YOGYAKARTA",21,138,35,173
https://kawalpemilu.org#42227,"TRIHANGGO, GAMPING, SLEMAN, DAERAH ISTIMEWA YOGYAKARTA",22,98,46,144
https://kawalpemilu.org#42227,"TRIHANGGO, GAMPING, SLEMAN, DAERAH ISTIMEWA YOGYAKARTA",23,122,125,247
https://kawalpemilu.org#42227,"TRIHANGGO, GAMPING, SLEMAN, DAERAH ISTIMEWA YOGYAKARTA",24,100,124,224
https://kawalpemilu.org#42227,"TRIHANGGO, GAMPING, SLEMAN, DAERAH ISTIMEWA YOGYAKARTA",25,127,79,206
https://kawalpemilu.org#42227,"TRIHANGGO, GAMPING, SLEMAN, DAERAH ISTIMEWA YOGYAKARTA",26,164,53,217
https://kawalpemilu.org#42227,"TRIHANGGO, GAMPING, SLEMAN, DAERAH ISTIMEWA YOGYAKARTA",27,195,77,272
https://kawalpemilu.org#42227,"TRIHANGGO, GAMPING, SLEMAN, DAERAH ISTIMEWA YOGYAKARTA",28,155,96,251
https://kawalpemilu.org#42227,"TRIHANGGO, GAMPING, SLEMAN, DAERAH ISTIMEWA YOGYAKARTA",29,198,58,256
https://kawalpemilu.org#42227,"TRIHANGGO, GAMPING, SLEMAN, DAERAH ISTIMEWA YOGYAKARTA",30,170,65,235
https://kawalpemilu.org#42227,"TRIHANGGO, GAMPING, SLEMAN, DAERAH ISTIMEWA YOGYAKARTA",31,139,38,177
https://kawalpemilu.org#42227,"TRIHANGGO, GAMPING, SLEMAN, DAERAH ISTIMEWA YOGYAKARTA",32,171,43,214
https://kawalpemilu.org#42227,"TRIHANGGO, GAMPING, SLEMAN, DAERAH ISTIMEWA YOGYAKARTA",33,149,63,212
https://kawalpemilu.org#42227,"TRIHANGGO, GAMPING, SLEMAN, DAERAH ISTIMEWA YOGYAKARTA",34,170,67,237
https://kawalpemilu.org#42227,"TRIHANGGO, GAMPING, SLEMAN, DAERAH ISTIMEWA YOGYAKARTA",35,180,67,247
https://kawalpemilu.org#42227,"TRIHANGGO, GAMPING, SLEMAN, DAERAH ISTIMEWA YOGYAKARTA",36,169,61,230
https://kawalpemilu.org#42227,"TRIHANGGO, GAMPING, SLEMAN, DAERAH ISTIMEWA YOGYAKARTA",37,116,57,173
https://kawalpemilu.org#42227,"TRIHANGGO, GAMPING, SLEMAN, DAERAH ISTIMEWA YOGYAKARTA",38,200,44,244
https://kawalpemilu.org#42227,"TRIHANGGO, GAMPING, SLEMAN, DAERAH ISTIMEWA YOGYAKARTA",39,230,26,256
https://kawalpemilu.org#42227,"TRIHANGGO, GAMPING, SLEMAN, DAERAH ISTIMEWA YOGYAKARTA",40,192,41,233
https://kawalpemilu.org#42227,"TRIHANGGO, GAMPING, SLEMAN, DAERAH ISTIMEWA YOGYAKARTA",41,146,106,252
https://kawalpemilu.org#42227,"TRIHANGGO, GAMPING, SLEMAN, DAERAH ISTIMEWA YOGYAKARTA",42,114,69,183
https://kawalpemilu.org#42227,"TRIHANGGO, GAMPING, SLEMAN, DAERAH ISTIMEWA YOGYAKARTA",43,197,54,251
https://kawalpemilu.org#42227,"TRIHANGGO, GAMPING, SLEMAN, DAERAH ISTIMEWA YOGYAKARTA",44,174,84,258
https://kawalpemilu.org#42227,"TRIHANGGO, GAMPING, SLEMAN, DAERAH ISTIMEWA YOGYAKARTA",45,107,59,166
https://kawalpemilu.org#42227,"TRIHANGGO, GAMPING, SLEMAN, DAERAH ISTIMEWA YOGYAKARTA",46,186,51,237
https://kawalpemilu.org#42227,"TRIHANGGO, GAMPING, SLEMAN, DAERAH ISTIMEWA YOGYAKARTA",47,174,62,236
https://kawalpemilu.org#42227,"TRIHANGGO, GAMPING, SLEMAN, DAERAH ISTIMEWA YOGYAKARTA",48,114,121,235
https://kawalpemilu.org#42227,"TRIHANGGO, GAMPING, SLEMAN, DAERAH ISTIMEWA YOGYAKARTA",49,118,123,241
https://kawalpemilu.org#42227,"TRIHANGGO, GAMPING, SLEMAN, DAERAH ISTIMEWA YOGYAKARTA",50,189,86,275
https://kawalpemilu.org#42227,"TRIHANGGO, GAMPING, SLEMAN, DAERAH ISTIMEWA YOGYAKARTA",51,76,57,133
https://kawalpemilu.org#42227,"TRIHANGGO, GAMPING, SLEMAN, DAERAH ISTIMEWA YOGYAKARTA",52,173,73,246
https://kawalpemilu.org#42229,"SIDOREJO, GODEAN, SLEMAN, DAERAH ISTIMEWA YOGYAKARTA",1,174,84,258
https://kawalpemilu.org#42229,"SIDOREJO, GODEAN, SLEMAN, DAERAH ISTIMEWA YOGYAKARTA",2,172,75,247
https://kawalpemilu.org#42229,"SIDOREJO, GODEAN, SLEMAN, DAERAH ISTIMEWA YOGYAKARTA",3,140,64,204
https://kawalpemilu.org#42229,"SIDOREJO, GODEAN, SLEMAN, DAERAH ISTIMEWA YOGYAKARTA",4,123,71,194
https://kawalpemilu.org#42229,"SIDOREJO, GODEAN, SLEMAN, DAERAH ISTIMEWA YOGYAKARTA",5,108,63,171
https://kawalpemilu.org#42229,"SIDOREJO, GODEAN, SLEMAN, DAERAH ISTIMEWA YOGYAKARTA",6,122,64,186
https://kawalpemilu.org#42229,"SIDOREJO, GODEAN, SLEMAN, DAERAH ISTIMEWA YOGYAKARTA",7,86,51,137
https://kawalpemilu.org#42229,"SIDOREJO, GODEAN, SLEMAN, DAERAH ISTIMEWA YOGYAKARTA",8,167,39,206
https://kawalpemilu.org#42229,"SIDOREJO, GODEAN, SLEMAN, DAERAH ISTIMEWA YOGYAKARTA",9,175,69,244
https://kawalpemilu.org#42229,"SIDOREJO, GODEAN, SLEMAN, DAERAH ISTIMEWA YOGYAKARTA",11,122,83,205
https://kawalpemilu.org#42229,"SIDOREJO, GODEAN, SLEMAN, DAERAH ISTIMEWA YOGYAKARTA",12,174,31,205
https://kawalpemilu.org#42229,"SIDOREJO, GODEAN, SLEMAN, DAERAH ISTIMEWA YOGYAKARTA",13,112,81,193
https://kawalpemilu.org#42229,"SIDOREJO, GODEAN, SLEMAN, DAERAH ISTIMEWA YOGYAKARTA",14,162,52,214
https://kawalpemilu.org#42229,"SIDOREJO, GODEAN, SLEMAN, DAERAH ISTIMEWA YOGYAKARTA",15,150,74,224
https://kawalpemilu.org#42229,"SIDOREJO, GODEAN, SLEMAN, DAERAH ISTIMEWA YOGYAKARTA",16,154,58,212
https://kawalpemilu.org#42229,"SIDOREJO, GODEAN, SLEMAN, DAERAH ISTIMEWA YOGYAKARTA",17,54,125,179
https://kawalpemilu.org#42229,"SIDOREJO, GODEAN, SLEMAN, DAERAH ISTIMEWA YOGYAKARTA",18,127,96,223
https://kawalpemilu.org#42229,"SIDOREJO, GODEAN, SLEMAN, DAERAH ISTIMEWA YOGYAKARTA",19,79,156,235
https://kawalpemilu.org#42229,"SIDOREJO, GODEAN, SLEMAN, DAERAH ISTIMEWA YOGYAKARTA",20,73,121,194
https://kawalpemilu.org#42229,"SIDOREJO, GODEAN, SLEMAN, DAERAH ISTIMEWA YOGYAKARTA",21,28,127,155
https://kawalpemilu.org#42229,"SIDOREJO, GODEAN, SLEMAN, DAERAH ISTIMEWA YOGYAKARTA",22,83,116,199
https://kawalpemilu.org#42229,"SIDOREJO, GODEAN, SLEMAN, DAERAH ISTIMEWA YOGYAKARTA",23,71,111,182
https://kawalpemilu.org#42230,"SIDOLUHUR, GODEAN, SLEMAN, DAERAH ISTIMEWA YOGYAKARTA",1,111,61,172
https://kawalpemilu.org#42230,"SIDOLUHUR, GODEAN, SLEMAN, DAERAH ISTIMEWA YOGYAKARTA",2,166,91,257
https://kawalpemilu.org#42230,"SIDOLUHUR, GODEAN, SLEMAN, DAERAH ISTIMEWA YOGYAKARTA",3,134,99,233
https://kawalpemilu.org#42230,"SIDOLUHUR, GODEAN, SLEMAN, DAERAH ISTIMEWA YOGYAKARTA",4,118,118,236
https://kawalpemilu.org#42230,"SIDOLUHUR, GODEAN, SLEMAN, DAERAH ISTIMEWA YOGYAKARTA",5,100,131,231
https://kawalpemilu.org#42230,"SIDOLUHUR, GODEAN, SLEMAN, DAERAH ISTIMEWA YOGYAKARTA",6,55,83,138
https://kawalpemilu.org#42230,"SIDOLUHUR, GODEAN, SLEMAN, DAERAH ISTIMEWA YOGYAKARTA",7,104,86,190
https://kawalpemilu.org#42230,"SIDOLUHUR, GODEAN, SLEMAN, DAERAH ISTIMEWA YOGYAKARTA",8,123,97,220
https://kawalpemilu.org#42230,"SIDOLUHUR, GODEAN, SLEMAN, DAERAH ISTIMEWA YOGYAKARTA",9,136,102,238
https://kawalpemilu.org#42230,"SIDOLUHUR, GODEAN, SLEMAN, DAERAH ISTIMEWA YOGYAKARTA",10,149,73,222
https://kawalpemilu.org#42230,"SIDOLUHUR, GODEAN, SLEMAN, DAERAH ISTIMEWA YOGYAKARTA",11,105,141,246
https://kawalpemilu.org#42230,"SIDOLUHUR, GODEAN, SLEMAN, DAERAH ISTIMEWA YOGYAKARTA",12,132,121,253
https://kawalpemilu.org#42230,"SIDOLUHUR, GODEAN, SLEMAN, DAERAH ISTIMEWA YOGYAKARTA",13,139,117,256
https://kawalpemilu.org#42230,"SIDOLUHUR, GODEAN, SLEMAN, DAERAH ISTIMEWA YOGYAKARTA",14,102,110,212
https://kawalpemilu.org#42230,"SIDOLUHUR, GODEAN, SLEMAN, DAERAH ISTIMEWA YOGYAKARTA",15,71,183,254
https://kawalpemilu.org#42230,"SIDOLUHUR, GODEAN, SLEMAN, DAERAH ISTIMEWA YOGYAKARTA",16,160,82,242
https://kawalpemilu.org#42230,"SIDOLUHUR, GODEAN, SLEMAN, DAERAH ISTIMEWA YOGYAKARTA",17,185,79,264
https://kawalpemilu.org#42230,"SIDOLUHUR, GODEAN, SLEMAN, DAERAH ISTIMEWA YOGYAKARTA",18,125,112,237
https://kawalpemilu.org#42230,"SIDOLUHUR, GODEAN, SLEMAN, DAERAH ISTIMEWA YOGYAKARTA",19,118,128,246
https://kawalpemilu.org#42230,"SIDOLUHUR, GODEAN, SLEMAN, DAERAH ISTIMEWA YOGYAKARTA",20,125,89,214
https://kawalpemilu.org#42230,"SIDOLUHUR, GODEAN, SLEMAN, DAERAH ISTIMEWA YOGYAKARTA",21,112,135,247
https://kawalpemilu.org#42230,"SIDOLUHUR, GODEAN, SLEMAN, DAERAH ISTIMEWA YOGYAKARTA",22,137,105,242
https://kawalpemilu.org#42230,"SIDOLUHUR, GODEAN, SLEMAN, DAERAH ISTIMEWA YOGYAKARTA",23,101,104,205
https://kawalpemilu.org#42230,"SIDOLUHUR, GODEAN, SLEMAN, DAERAH ISTIMEWA YOGYAKARTA",24,166,83,249
https://kawalpemilu.org#42230,"SIDOLUHUR, GODEAN, SLEMAN, DAERAH ISTIMEWA YOGYAKARTA",25,154,48,202
https://kawalpemilu.org#42230,"SIDOLUHUR, GODEAN, SLEMAN, DAERAH ISTIMEWA YOGYAKARTA",26,121,48,169
https://kawalpemilu.org#42230,"SIDOLUHUR, GODEAN, SLEMAN, DAERAH ISTIMEWA YOGYAKARTA",27,106,126,232
https://kawalpemilu.org#42230,"SIDOLUHUR, GODEAN, SLEMAN, DAERAH ISTIMEWA YOGYAKARTA",28,162,91,251
https://kawalpemilu.org#42230,"SIDOLUHUR, GODEAN, SLEMAN, DAERAH ISTIMEWA YOGYAKARTA",29,76,135,211
https://kawalpemilu.org#42230,"SIDOLUHUR, GODEAN, SLEMAN, DAERAH ISTIMEWA YOGYAKARTA",30,149,67,216
https://kawalpemilu.org#42231,"SIDOMULYO, GODEAN, SLEMAN, DAERAH ISTIMEWA YOGYAKARTA",1,145,73,218
https://kawalpemilu.org#42231,"SIDOMULYO, GODEAN, SLEMAN, DAERAH ISTIMEWA YOGYAKARTA",2,128,62,190
https://kawalpemilu.org#42231,"SIDOMULYO, GODEAN, SLEMAN, DAERAH ISTIMEWA YOGYAKARTA",3,122,75,197
https://kawalpemilu.org#42231,"SIDOMULYO, GODEAN, SLEMAN, DAERAH ISTIMEWA YOGYAKARTA",4,108,60,168
https://kawalpemilu.org#42231,"SIDOMULYO, GODEAN, SLEMAN, DAERAH ISTIMEWA YOGYAKARTA",5,163,25,188
https://kawalpemilu.org#42231,"SIDOMULYO, GODEAN, SLEMAN, DAERAH ISTIMEWA YOGYAKARTA",6,111,68,179
https://kawalpemilu.org#42231,"SIDOMULYO, GODEAN, SLEMAN, DAERAH ISTIMEWA YOGYAKARTA",7,93,67,160
https://kawalpemilu.org#42231,"SIDOMULYO, GODEAN, SLEMAN, DAERAH ISTIMEWA YOGYAKARTA",8,191,58,249
https://kawalpemilu.org#42231,"SIDOMULYO, GODEAN, SLEMAN, DAERAH ISTIMEWA YOGYAKARTA",9,190,72,262
https://kawalpemilu.org#42231,"SIDOMULYO, GODEAN, SLEMAN, DAERAH ISTIMEWA YOGYAKARTA",10,190,81,271
https://kawalpemilu.org#42231,"SIDOMULYO, GODEAN, SLEMAN, DAERAH ISTIMEWA YOGYAKARTA",11,204,47,251
https://kawalpemilu.org#42231,"SIDOMULYO, GODEAN, SLEMAN, DAERAH ISTIMEWA YOGYAKARTA",12,202,63,265
https://kawalpemilu.org#42231,"SIDOMULYO, GODEAN, SLEMAN, DAERAH ISTIMEWA YOGYAKARTA",13,88,62,150
https://kawalpemilu.org#42231,"SIDOMULYO, GODEAN, SLEMAN, DAERAH ISTIMEWA YOGYAKARTA",14,156,97,253
https://kawalpemilu.org#42231,"SIDOMULYO, GODEAN, SLEMAN, DAERAH ISTIMEWA YOGYAKARTA",15,161,89,250
https://kawalpemilu.org#42231,"SIDOMULYO, GODEAN, SLEMAN, DAERAH ISTIMEWA YOGYAKARTA",16,203,55,258
https://kawalpemilu.org#42231,"SIDOMULYO, GODEAN, SLEMAN, DAERAH ISTIMEWA YOGYAKARTA",17,122,105,227
https://kawalpemilu.org#42231,"SIDOMULYO, GODEAN, SLEMAN, DAERAH ISTIMEWA YOGYAKARTA",18,210,28,238
https://kawalpemilu.org#42231,"SIDOMULYO, GODEAN, SLEMAN, DAERAH ISTIMEWA YOGYAKARTA",19,216,40,256
https://kawalpemilu.org#42231,"SIDOMULYO, GODEAN, SLEMAN, DAERAH ISTIMEWA YOGYAKARTA",20,114,76,190
https://kawalpemilu.org#42232,"SIDOAGUNG, GODEAN, SLEMAN, DAERAH ISTIMEWA YOGYAKARTA",1,155,72,227
https://kawalpemilu.org#42232,"SIDOAGUNG, GODEAN, SLEMAN, DAERAH ISTIMEWA YOGYAKARTA",2,138,130,268
https://kawalpemilu.org#42232,"SIDOAGUNG, GODEAN, SLEMAN, DAERAH ISTIMEWA YOGYAKARTA",3,150,70,220
https://kawalpemilu.org#42232,"SIDOAGUNG, GODEAN, SLEMAN, DAERAH ISTIMEWA YOGYAKARTA",4,193,39,232
https://kawalpemilu.org#42232,"SIDOAGUNG, GODEAN, SLEMAN, DAERAH ISTIMEWA YOGYAKARTA",5,138,85,223
https://kawalpemilu.org#42232,"SIDOAGUNG, GODEAN, SLEMAN, DAERAH ISTIMEWA YOGYAKARTA",6,118,98,216
https://kawalpemilu.org#42232,"SIDOAGUNG, GODEAN, SLEMAN, DAERAH ISTIMEWA YOGYAKARTA",7,151,94,245
https://kawalpemilu.org#42232,"SIDOAGUNG, GODEAN, SLEMAN, DAERAH ISTIMEWA YOGYAKARTA",8,128,78,206
https://kawalpemilu.org#42232,"SIDOAGUNG, GODEAN, SLEMAN, DAERAH ISTIMEWA YOGYAKARTA",9,147,83,230
https://kawalpemilu.org#42232,"SIDOAGUNG, GODEAN, SLEMAN, DAERAH ISTIMEWA YOGYAKARTA",10,150,74,224
https://kawalpemilu.org#42232,"SIDOAGUNG, GODEAN, SLEMAN, DAERAH ISTIMEWA YOGYAKARTA",11,111,69,180
https://kawalpemilu.org#42232,"SIDOAGUNG, GODEAN, SLEMAN, DAERAH ISTIMEWA YOGYAKARTA",12,154,72,226
https://kawalpemilu.org#42232,"SIDOAGUNG, GODEAN, SLEMAN, DAERAH ISTIMEWA YOGYAKARTA",13,107,99,206
https://kawalpemilu.org#42232,"SIDOAGUNG, GODEAN, SLEMAN, DAERAH ISTIMEWA YOGYAKARTA",14,122,91,213
https://kawalpemilu.org#42232,"SIDOAGUNG, GODEAN, SLEMAN, DAERAH ISTIMEWA YOGYAKARTA",15,127,69,196
https://kawalpemilu.org#42232,"SIDOAGUNG, GODEAN, SLEMAN, DAERAH ISTIMEWA YOGYAKARTA",16,106,76,182
https://kawalpemilu.org#42232,"SIDOAGUNG, GODEAN, SLEMAN, DAERAH ISTIMEWA YOGYAKARTA",17,130,102,232
https://kawalpemilu.org#42232,"SIDOAGUNG, GODEAN, SLEMAN, DAERAH ISTIMEWA YOGYAKARTA",18,127,114,241
https://kawalpemilu.org#42232,"SIDOAGUNG, GODEAN, SLEMAN, DAERAH ISTIMEWA YOGYAKARTA",19,120,100,220
https://kawalpemilu.org#42232,"SIDOAGUNG, GODEAN, SLEMAN, DAERAH ISTIMEWA YOGYAKARTA",20,169,73,242
https://kawalpemilu.org#42232,"SIDOAGUNG, GODEAN, SLEMAN, DAERAH ISTIMEWA YOGYAKARTA",21,108,100,208
https://kawalpemilu.org#42232,"SIDOAGUNG, GODEAN, SLEMAN, DAERAH ISTIMEWA YOGYAKARTA",22,165,75,240
https://kawalpemilu.org#42232,"SIDOAGUNG, GODEAN, SLEMAN, DAERAH ISTIMEWA YOGYAKARTA",23,163,93,256
https://kawalpemilu.org#42232,"SIDOAGUNG, GODEAN, SLEMAN, DAERAH ISTIMEWA YOGYAKARTA",24,198,70,268
https://kawalpemilu.org#42232,"SIDOAGUNG, GODEAN, SLEMAN, DAERAH ISTIMEWA YOGYAKARTA",25,190,59,249
https://kawalpemilu.org#42232,"SIDOAGUNG, GODEAN, SLEMAN, DAERAH ISTIMEWA YOGYAKARTA",26,233,49,282
https://kawalpemilu.org#42232,"SIDOAGUNG, GODEAN, SLEMAN, DAERAH ISTIMEWA YOGYAKARTA",27,192,67,259
https://kawalpemilu.org#42233,"SIDOKARTO, GODEAN, SLEMAN, DAERAH ISTIMEWA YOGYAKARTA",1,151,56,207
https://kawalpemilu.org#42233,"SIDOKARTO, GODEAN, SLEMAN, DAERAH ISTIMEWA YOGYAKARTA",2,179,48,227
https://kawalpemilu.org#42233,"SIDOKARTO, GODEAN, SLEMAN, DAERAH ISTIMEWA YOGYAKARTA",3,163,70,233
https://kawalpemilu.org#42233,"SIDOKARTO, GODEAN, SLEMAN, DAERAH ISTIMEWA YOGYAKARTA",4,176,66,242
https://kawalpemilu.org#42233,"SIDOKARTO, GODEAN, SLEMAN, DAERAH ISTIMEWA YOGYAKARTA",5,154,61,215
https://kawalpemilu.org#42233,"SIDOKARTO, GODEAN, SLEMAN, DAERAH ISTIMEWA YOGYAKARTA",6,109,90,199
https://kawalpemilu.org#42233,"SIDOKARTO, GODEAN, SLEMAN, DAERAH ISTIMEWA YOGYAKARTA",7,144,75,219
https://kawalpemilu.org#42233,"SIDOKARTO, GODEAN, SLEMAN, DAERAH ISTIMEWA YOGYAKARTA",8,124,89,213
https://kawalpemilu.org#42233,"SIDOKARTO, GODEAN, SLEMAN, DAERAH ISTIMEWA YOGYAKARTA",9,125,95,220
https://kawalpemilu.org#42233,"SIDOKARTO, GODEAN, SLEMAN, DAERAH ISTIMEWA YOGYAKARTA",10,147,55,202
https://kawalpemilu.org#42233,"SIDOKARTO, GODEAN, SLEMAN, DAERAH ISTIMEWA YOGYAKARTA",11,146,79,225
https://kawalpemilu.org#42233,"SIDOKARTO, GODEAN, SLEMAN, DAERAH ISTIMEWA YOGYAKARTA",12,130,76,206
https://kawalpemilu.org#42233,"SIDOKARTO, GODEAN, SLEMAN, DAERAH ISTIMEWA YOGYAKARTA",13,158,64,222
https://kawalpemilu.org#42233,"SIDOKARTO, GODEAN, SLEMAN, DAERAH ISTIMEWA YOGYAKARTA",14,116,49,165
https://kawalpemilu.org#42233,"SIDOKARTO, GODEAN, SLEMAN, DAERAH ISTIMEWA YOGYAKARTA",15,179,63,242
https://kawalpemilu.org#42233,"SIDOKARTO, GODEAN, SLEMAN, DAERAH ISTIMEWA YOGYAKARTA",16,184,68,252
https://kawalpemilu.org#42233,"SIDOKARTO, GODEAN, SLEMAN, DAERAH ISTIMEWA YOGYAKARTA",17,91,131,222
https://kawalpemilu.org#42233,"SIDOKARTO, GODEAN, SLEMAN, DAERAH ISTIMEWA YOGYAKARTA",18,92,84,176
https://kawalpemilu.org#42233,"SIDOKARTO, GODEAN, SLEMAN, DAERAH ISTIMEWA YOGYAKARTA",20,140,66,206
https://kawalpemilu.org#42233,"SIDOKARTO, GODEAN, SLEMAN, DAERAH ISTIMEWA YOGYAKARTA",21,118,43,161
https://kawalpemilu.org#42233,"SIDOKARTO, GODEAN, SLEMAN, DAERAH ISTIMEWA YOGYAKARTA",22,168,27,195
https://kawalpemilu.org#42233,"SIDOKARTO, GODEAN, SLEMAN, DAERAH ISTIMEWA YOGYAKARTA",23,120,70,190
https://kawalpemilu.org#42233,"SIDOKARTO, GODEAN, SLEMAN, DAERAH ISTIMEWA YOGYAKARTA",24,90,123,213
https://kawalpemilu.org#42233,"SIDOKARTO, GODEAN, SLEMAN, DAERAH ISTIMEWA YOGYAKARTA",25,164,56,220
https://kawalpemilu.org#42233,"SIDOKARTO, GODEAN, SLEMAN, DAERAH ISTIMEWA YOGYAKARTA",26,133,79,212
https://kawalpemilu.org#42233,"SIDOKARTO, GODEAN, SLEMAN, DAERAH ISTIMEWA YOGYAKARTA",27,158,35,193
https://kawalpemilu.org#42233,"SIDOKARTO, GODEAN, SLEMAN, DAERAH ISTIMEWA YOGYAKARTA",28,161,37,198
https://kawalpemilu.org#42233,"SIDOKARTO, GODEAN, SLEMAN, DAERAH ISTIMEWA YOGYAKARTA",29,101,77,178
https://kawalpemilu.org#42233,"SIDOKARTO, GODEAN, SLEMAN, DAERAH ISTIMEWA YOGYAKARTA",30,131,77,208
https://kawalpemilu.org#42233,"SIDOKARTO, GODEAN, SLEMAN, DAERAH ISTIMEWA YOGYAKARTA",31,168,40,208
https://kawalpemilu.org#42233,"SIDOKARTO, GODEAN, SLEMAN, DAERAH ISTIMEWA YOGYAKARTA",32,160,55,215
https://kawalpemilu.org#42233,"SIDOKARTO, GODEAN, SLEMAN, DAERAH ISTIMEWA YOGYAKARTA",33,155,60,215
https://kawalpemilu.org#42233,"SIDOKARTO, GODEAN, SLEMAN, DAERAH ISTIMEWA YOGYAKARTA",34,142,64,206
https://kawalpemilu.org#42233,"SIDOKARTO, GODEAN, SLEMAN, DAERAH ISTIMEWA YOGYAKARTA",35,130,56,186
https://kawalpemilu.org#42233,"SIDOKARTO, GODEAN, SLEMAN, DAERAH ISTIMEWA YOGYAKARTA",36,133,36,169
https://kawalpemilu.org#42233,"SIDOKARTO, GODEAN, SLEMAN, DAERAH ISTIMEWA YOGYAKARTA",38,126,78,204
https://kawalpemilu.org#42234,"SIDOARUM, GODEAN, SLEMAN, DAERAH ISTIMEWA YOGYAKARTA",1,129,87,216
https://kawalpemilu.org#42234,"SIDOARUM, GODEAN, SLEMAN, DAERAH ISTIMEWA YOGYAKARTA",2,178,96,274
https://kawalpemilu.org#42234,"SIDOARUM, GODEAN, SLEMAN, DAERAH ISTIMEWA YOGYAKARTA",3,166,60,226
https://kawalpemilu.org#42234,"SIDOARUM, GODEAN, SLEMAN, DAERAH ISTIMEWA YOGYAKARTA",4,182,53,235
https://kawalpemilu.org#42234,"SIDOARUM, GODEAN, SLEMAN, DAERAH ISTIMEWA YOGYAKARTA",5,163,40,203
https://kawalpemilu.org#42234,"SIDOARUM, GODEAN, SLEMAN, DAERAH ISTIMEWA YOGYAKARTA",6,167,51,218
https://kawalpemilu.org#42234,"SIDOARUM, GODEAN, SLEMAN, DAERAH ISTIMEWA YOGYAKARTA",7,146,76,222
https://kawalpemilu.org#42234,"SIDOARUM, GODEAN, SLEMAN, DAERAH ISTIMEWA YOGYAKARTA",8,176,92,268
https://kawalpemilu.org#42234,"SIDOARUM, GODEAN, SLEMAN, DAERAH ISTIMEWA YOGYAKARTA",9,190,84,274
https://kawalpemilu.org#42234,"SIDOARUM, GODEAN, SLEMAN, DAERAH ISTIMEWA YOGYAKARTA",10,129,60,189
https://kawalpemilu.org#42234,"SIDOARUM, GODEAN, SLEMAN, DAERAH ISTIMEWA YOGYAKARTA",11,152,71,223
https://kawalpemilu.org#42234,"SIDOARUM, GODEAN, SLEMAN, DAERAH ISTIMEWA YOGYAKARTA",12,171,60,231
https://kawalpemilu.org#42234,"SIDOARUM, GODEAN, SLEMAN, DAERAH ISTIMEWA YOGYAKARTA",13,187,76,263
https://kawalpemilu.org#42234,"SIDOARUM, GODEAN, SLEMAN, DAERAH ISTIMEWA YOGYAKARTA",14,206,52,258
https://kawalpemilu.org#42234,"SIDOARUM, GODEAN, SLEMAN, DAERAH ISTIMEWA YOGYAKARTA",15,156,89,245
https://kawalpemilu.org#42234,"SIDOARUM, GODEAN, SLEMAN, DAERAH ISTIMEWA YOGYAKARTA",16,228,50,278
https://kawalpemilu.org#42234,"SIDOARUM, GODEAN, SLEMAN, DAERAH ISTIMEWA YOGYAKARTA",17,188,91,279
https://kawalpemilu.org#42234,"SIDOARUM, GODEAN, SLEMAN, DAERAH ISTIMEWA YOGYAKARTA",18,141,141,282
https://kawalpemilu.org#42234,"SIDOARUM, GODEAN, SLEMAN, DAERAH ISTIMEWA YOGYAKARTA",19,181,78,259
https://kawalpemilu.org#42234,"SIDOARUM, GODEAN, SLEMAN, DAERAH ISTIMEWA YOGYAKARTA",20,176,75,251
https://kawalpemilu.org#42234,"SIDOARUM, GODEAN, SLEMAN, DAERAH ISTIMEWA YOGYAKARTA",21,167,83,249
https://kawalpemilu.org#42234,"SIDOARUM, GODEAN, SLEMAN, DAERAH ISTIMEWA YOGYAKARTA",22,175,83,258
https://kawalpemilu.org#42234,"SIDOARUM, GODEAN, SLEMAN, DAERAH ISTIMEWA YOGYAKARTA",23,161,98,259
https://kawalpemilu.org#42234,"SIDOARUM, GODEAN, SLEMAN, DAERAH ISTIMEWA YOGYAKARTA",24,153,73,226
https://kawalpemilu.org#42234,"SIDOARUM, GODEAN, SLEMAN, DAERAH ISTIMEWA YOGYAKARTA",25,118,114,232
https://kawalpemilu.org#42234,"SIDOARUM, GODEAN, SLEMAN, DAERAH ISTIMEWA YOGYAKARTA",26,175,101,276
https://kawalpemilu.org#42234,"SIDOARUM, GODEAN, SLEMAN, DAERAH ISTIMEWA YOGYAKARTA",27,108,89,197
https://kawalpemilu.org#42234,"SIDOARUM, GODEAN, SLEMAN, DAERAH ISTIMEWA YOGYAKARTA",28,115,105,220
https://kawalpemilu.org#42234,"SIDOARUM, GODEAN, SLEMAN, DAERAH ISTIMEWA YOGYAKARTA",29,133,83,216
https://kawalpemilu.org#42234,"SIDOARUM, GODEAN, SLEMAN, DAERAH ISTIMEWA YOGYAKARTA",30,156,96,252
https://kawalpemilu.org#42234,"SIDOARUM, GODEAN, SLEMAN, DAERAH ISTIMEWA YOGYAKARTA",31,116,128,244
https://kawalpemilu.org#42234,"SIDOARUM, GODEAN, SLEMAN, DAERAH ISTIMEWA YOGYAKARTA",32,154,54,208
https://kawalpemilu.org#42234,"SIDOARUM, GODEAN, SLEMAN, DAERAH ISTIMEWA YOGYAKARTA",33,141,53,194
https://kawalpemilu.org#42234,"SIDOARUM, GODEAN, SLEMAN, DAERAH ISTIMEWA YOGYAKARTA",34,173,45,218
https://kawalpemilu.org#42234,"SIDOARUM, GODEAN, SLEMAN, DAERAH ISTIMEWA YOGYAKARTA",35,176,79,255
https://kawalpemilu.org#42234,"SIDOARUM, GODEAN, SLEMAN, DAERAH ISTIMEWA YOGYAKARTA",36,147,49,196
https://kawalpemilu.org#42234,"SIDOARUM, GODEAN, SLEMAN, DAERAH ISTIMEWA YOGYAKARTA",37,150,94,244
https://kawalpemilu.org#42234,"SIDOARUM, GODEAN, SLEMAN, DAERAH ISTIMEWA YOGYAKARTA",38,148,57,205
https://kawalpemilu.org#42234,"SIDOARUM, GODEAN, SLEMAN, DAERAH ISTIMEWA YOGYAKARTA",39,165,50,215
https://kawalpemilu.org#42234,"SIDOARUM, GODEAN, SLEMAN, DAERAH ISTIMEWA YOGYAKARTA",40,208,52,260
https://kawalpemilu.org#42234,"SIDOARUM, GODEAN, SLEMAN, DAERAH ISTIMEWA YOGYAKARTA",41,112,96,208
https://kawalpemilu.org#42234,"SIDOARUM, GODEAN, SLEMAN, DAERAH ISTIMEWA YOGYAKARTA",42,150,64,214
https://kawalpemilu.org#42234,"SIDOARUM, GODEAN, SLEMAN, DAERAH ISTIMEWA YOGYAKARTA",43,112,104,216
https://kawalpemilu.org#42234,"SIDOARUM, GODEAN, SLEMAN, DAERAH ISTIMEWA YOGYAKARTA",44,115,110,225
https://kawalpemilu.org#42234,"SIDOARUM, GODEAN, SLEMAN, DAERAH ISTIMEWA YOGYAKARTA",45,147,92,239
https://kawalpemilu.org#42234,"SIDOARUM, GODEAN, SLEMAN, DAERAH ISTIMEWA YOGYAKARTA",46,162,105,267
https://kawalpemilu.org#42235,"SIDOMOYO, GODEAN, SLEMAN, DAERAH ISTIMEWA YOGYAKARTA",1,124,39,163
https://kawalpemilu.org#42235,"SIDOMOYO, GODEAN, SLEMAN, DAERAH ISTIMEWA YOGYAKARTA",3,202,47,249
https://kawalpemilu.org#42235,"SIDOMOYO, GODEAN, SLEMAN, DAERAH ISTIMEWA YOGYAKARTA",4,172,88,260
https://kawalpemilu.org#42235,"SIDOMOYO, GODEAN, SLEMAN, DAERAH ISTIMEWA YOGYAKARTA",5,122,117,239
https://kawalpemilu.org#42235,"SIDOMOYO, GODEAN, SLEMAN, DAERAH ISTIMEWA YOGYAKARTA",6,165,86,251
https://kawalpemilu.org#42235,"SIDOMOYO, GODEAN, SLEMAN, DAERAH ISTIMEWA YOGYAKARTA",7,163,76,239
https://kawalpemilu.org#42235,"SIDOMOYO, GODEAN, SLEMAN, DAERAH ISTIMEWA YOGYAKARTA",8,184,53,237
https://kawalpemilu.org#42235,"SIDOMOYO, GODEAN, SLEMAN, DAERAH ISTIMEWA YOGYAKARTA",9,203,42,245
https://kawalpemilu.org#42235,"SIDOMOYO, GODEAN, SLEMAN, DAERAH ISTIMEWA YOGYAKARTA",10,143,43,186
https://kawalpemilu.org#42235,"SIDOMOYO, GODEAN, SLEMAN, DAERAH ISTIMEWA YOGYAKARTA",11,98,81,179
https://kawalpemilu.org#42235,"SIDOMOYO, GODEAN, SLEMAN, DAERAH ISTIMEWA YOGYAKARTA",12,147,77,224
https://kawalpemilu.org#42235,"SIDOMOYO, GODEAN, SLEMAN, DAERAH ISTIMEWA YOGYAKARTA",13,144,66,210
https://kawalpemilu.org#42235,"SIDOMOYO, GODEAN, SLEMAN, DAERAH ISTIMEWA YOGYAKARTA",14,187,64,251
https://kawalpemilu.org#42235,"SIDOMOYO, GODEAN, SLEMAN, DAERAH ISTIMEWA YOGYAKARTA",15,207,25,232
https://kawalpemilu.org#42235,"SIDOMOYO, GODEAN, SLEMAN, DAERAH ISTIMEWA YOGYAKARTA",16,218,61,279
https://kawalpemilu.org#42235,"SIDOMOYO, GODEAN, SLEMAN, DAERAH ISTIMEWA YOGYAKARTA",17,151,46,197
https://kawalpemilu.org#42235,"SIDOMOYO, GODEAN, SLEMAN, DAERAH ISTIMEWA YOGYAKARTA",18,158,33,191
https://kawalpemilu.org#42235,"SIDOMOYO, GODEAN, SLEMAN, DAERAH ISTIMEWA YOGYAKARTA",19,171,57,228
https://kawalpemilu.org#42235,"SIDOMOYO, GODEAN, SLEMAN, DAERAH ISTIMEWA YOGYAKARTA",20,145,113,258
https://kawalpemilu.org#42235,"SIDOMOYO, GODEAN, SLEMAN, DAERAH ISTIMEWA YOGYAKARTA",21,179,79,258
https://kawalpemilu.org#42235,"SIDOMOYO, GODEAN, SLEMAN, DAERAH ISTIMEWA YOGYAKARTA",22,135,83,218
https://kawalpemilu.org#42235,"SIDOMOYO, GODEAN, SLEMAN, DAERAH ISTIMEWA YOGYAKARTA",23,131,92,223
https://kawalpemilu.org#42235,"SIDOMOYO, GODEAN, SLEMAN, DAERAH ISTIMEWA YOGYAKARTA",24,128,49,177
https://kawalpemilu.org#42235,"SIDOMOYO, GODEAN, SLEMAN, DAERAH ISTIMEWA YOGYAKARTA",25,105,69,174
https://kawalpemilu.org#42235,"SIDOMOYO, GODEAN, SLEMAN, DAERAH ISTIMEWA YOGYAKARTA",26,116,56,172
https://kawalpemilu.org#42237,"SUMBERRAHAYU, MOYUDAN, SLEMAN, DAERAH ISTIMEWA YOGYAKARTA",1,104,133,237
https://kawalpemilu.org#42237,"SUMBERRAHAYU, MOYUDAN, SLEMAN, DAERAH ISTIMEWA YOGYAKARTA",2,79,161,240
https://kawalpemilu.org#42237,"SUMBERRAHAYU, MOYUDAN, SLEMAN, DAERAH ISTIMEWA YOGYAKARTA",3,132,64,196
https://kawalpemilu.org#42237,"SUMBERRAHAYU, MOYUDAN, SLEMAN, DAERAH ISTIMEWA YOGYAKARTA",4,97,91,188
https://kawalpemilu.org#42237,"SUMBERRAHAYU, MOYUDAN, SLEMAN, DAERAH ISTIMEWA YOGYAKARTA",6,34,82,116
https://kawalpemilu.org#42237,"SUMBERRAHAYU, MOYUDAN, SLEMAN, DAERAH ISTIMEWA YOGYAKARTA",7,60,101,161
https://kawalpemilu.org#42237,"SUMBERRAHAYU, MOYUDAN, SLEMAN, DAERAH ISTIMEWA YOGYAKARTA",8,144,68,212
https://kawalpemilu.org#42237,"SUMBERRAHAYU, MOYUDAN, SLEMAN, DAERAH ISTIMEWA YOGYAKARTA",9,122,71,193
https://kawalpemilu.org#42237,"SUMBERRAHAYU, MOYUDAN, SLEMAN, DAERAH ISTIMEWA YOGYAKARTA",10,76,104,180
https://kawalpemilu.org#42237,"SUMBERRAHAYU, MOYUDAN, SLEMAN, DAERAH ISTIMEWA YOGYAKARTA",11,84,101,185
https://kawalpemilu.org#42237,"SUMBERRAHAYU, MOYUDAN, SLEMAN, DAERAH ISTIMEWA YOGYAKARTA",12,88,81,169
https://kawalpemilu.org#42237,"SUMBERRAHAYU, MOYUDAN, SLEMAN, DAERAH ISTIMEWA YOGYAKARTA",13,66,100,166
https://kawalpemilu.org#42237,"SUMBERRAHAYU, MOYUDAN, SLEMAN, DAERAH ISTIMEWA YOGYAKARTA",14,47,92,139
https://kawalpemilu.org#42237,"SUMBERRAHAYU, MOYUDAN, SLEMAN, DAERAH ISTIMEWA YOGYAKARTA",15,31,133,164
https://kawalpemilu.org#42237,"SUMBERRAHAYU, MOYUDAN, SLEMAN, DAERAH ISTIMEWA YOGYAKARTA",16,44,142,186
https://kawalpemilu.org#42237,"SUMBERRAHAYU, MOYUDAN, SLEMAN, DAERAH ISTIMEWA YOGYAKARTA",17,77,87,164
https://kawalpemilu.org#42237,"SUMBERRAHAYU, MOYUDAN, SLEMAN, DAERAH ISTIMEWA YOGYAKARTA",18,113,69,182
https://kawalpemilu.org#42237,"SUMBERRAHAYU, MOYUDAN, SLEMAN, DAERAH ISTIMEWA YOGYAKARTA",19,80,72,152
https://kawalpemilu.org#42237,"SUMBERRAHAYU, MOYUDAN, SLEMAN, DAERAH ISTIMEWA YOGYAKARTA",20,27,83,110
https://kawalpemilu.org#42237,"SUMBERRAHAYU, MOYUDAN, SLEMAN, DAERAH ISTIMEWA YOGYAKARTA",21,103,92,195
https://kawalpemilu.org#42237,"SUMBERRAHAYU, MOYUDAN, SLEMAN, DAERAH ISTIMEWA YOGYAKARTA",22,86,91,177
https://kawalpemilu.org#42237,"SUMBERRAHAYU, MOYUDAN, SLEMAN, DAERAH ISTIMEWA YOGYAKARTA",23,41,120,161
https://kawalpemilu.org#42237,"SUMBERRAHAYU, MOYUDAN, SLEMAN, DAERAH ISTIMEWA YOGYAKARTA",24,61,49,110
https://kawalpemilu.org#42237,"SUMBERRAHAYU, MOYUDAN, SLEMAN, DAERAH ISTIMEWA YOGYAKARTA",25,30,126,156
https://kawalpemilu.org#42237,"SUMBERRAHAYU, MOYUDAN, SLEMAN, DAERAH ISTIMEWA YOGYAKARTA",27,151,79,230
https://kawalpemilu.org#42238,"SUMBERSARI, MOYUDAN, SLEMAN, DAERAH ISTIMEWA YOGYAKARTA",1,102,128,230
https://kawalpemilu.org#42238,"SUMBERSARI, MOYUDAN, SLEMAN, DAERAH ISTIMEWA YOGYAKARTA",2,52,137,189
https://kawalpemilu.org#42238,"SUMBERSARI, MOYUDAN, SLEMAN, DAERAH ISTIMEWA YOGYAKARTA",3,46,182,228
https://kawalpemilu.org#42238,"SUMBERSARI, MOYUDAN, SLEMAN, DAERAH ISTIMEWA YOGYAKARTA",4,109,142,251
https://kawalpemilu.org#42238,"SUMBERSARI, MOYUDAN, SLEMAN, DAERAH ISTIMEWA YOGYAKARTA",5,100,139,239
https://kawalpemilu.org#42238,"SUMBERSARI, MOYUDAN, SLEMAN, DAERAH ISTIMEWA YOGYAKARTA",6,101,151,252
https://kawalpemilu.org#42238,"SUMBERSARI, MOYUDAN, SLEMAN, DAERAH ISTIMEWA YOGYAKARTA",7,119,117,236
https://kawalpemilu.org#42238,"SUMBERSARI, MOYUDAN, SLEMAN, DAERAH ISTIMEWA YOGYAKARTA",8,106,110,216
https://kawalpemilu.org#42238,"SUMBERSARI, MOYUDAN, SLEMAN, DAERAH ISTIMEWA YOGYAKARTA",9,143,78,221
https://kawalpemilu.org#42238,"SUMBERSARI, MOYUDAN, SLEMAN, DAERAH ISTIMEWA YOGYAKARTA",10,150,87,237
https://kawalpemilu.org#42238,"SUMBERSARI, MOYUDAN, SLEMAN, DAERAH ISTIMEWA YOGYAKARTA",11,132,128,260
https://kawalpemilu.org#42238,"SUMBERSARI, MOYUDAN, SLEMAN, DAERAH ISTIMEWA YOGYAKARTA",12,128,140,268
https://kawalpemilu.org#42238,"SUMBERSARI, MOYUDAN, SLEMAN, DAERAH ISTIMEWA YOGYAKARTA",13,118,132,250
https://kawalpemilu.org#42238,"SUMBERSARI, MOYUDAN, SLEMAN, DAERAH ISTIMEWA YOGYAKARTA",14,191,64,255
https://kawalpemilu.org#42238,"SUMBERSARI, MOYUDAN, SLEMAN, DAERAH ISTIMEWA YOGYAKARTA",15,158,89,247
https://kawalpemilu.org#42238,"SUMBERSARI, MOYUDAN, SLEMAN, DAERAH ISTIMEWA YOGYAKARTA",16,112,91,203
https://kawalpemilu.org#42238,"SUMBERSARI, MOYUDAN, SLEMAN, DAERAH ISTIMEWA YOGYAKARTA",17,58,129,187
https://kawalpemilu.org#42238,"SUMBERSARI, MOYUDAN, SLEMAN, DAERAH ISTIMEWA YOGYAKARTA",18,57,163,220
https://kawalpemilu.org#42238,"SUMBERSARI, MOYUDAN, SLEMAN, DAERAH ISTIMEWA YOGYAKARTA",19,112,90,202
https://kawalpemilu.org#42238,"SUMBERSARI, MOYUDAN, SLEMAN, DAERAH ISTIMEWA YOGYAKARTA",20,128,112,240
https://kawalpemilu.org#42238,"SUMBERSARI, MOYUDAN, SLEMAN, DAERAH ISTIMEWA YOGYAKARTA",21,169,58,227
https://kawalpemilu.org#42238,"SUMBERSARI, MOYUDAN, SLEMAN, DAERAH ISTIMEWA YOGYAKARTA",22,159,87,246
https://kawalpemilu.org#42238,"SUMBERSARI, MOYUDAN, SLEMAN, DAERAH ISTIMEWA YOGYAKARTA",23,131,109,240
https://kawalpemilu.org#42238,"SUMBERSARI, MOYUDAN, SLEMAN, DAERAH ISTIMEWA YOGYAKARTA",24,100,97,197
https://kawalpemilu.org#42238,"SUMBERSARI, MOYUDAN, SLEMAN, DAERAH ISTIMEWA YOGYAKARTA",25,69,143,212
https://kawalpemilu.org#42239,"SUMBERAGUNG, MOYUDAN, SLEMAN, DAERAH ISTIMEWA YOGYAKARTA",1,140,104,244
https://kawalpemilu.org#42239,"SUMBERAGUNG, MOYUDAN, SLEMAN, DAERAH ISTIMEWA YOGYAKARTA",2,141,112,253
https://kawalpemilu.org#42239,"SUMBERAGUNG, MOYUDAN, SLEMAN, DAERAH ISTIMEWA YOGYAKARTA",3,83,80,162
https://kawalpemilu.org#42239,"SUMBERAGUNG, MOYUDAN, SLEMAN, DAERAH ISTIMEWA YOGYAKARTA",4,126,97,223
https://kawalpemilu.org#42239,"SUMBERAGUNG, MOYUDAN, SLEMAN, DAERAH ISTIMEWA YOGYAKARTA",5,93,128,221
https://kawalpemilu.org#42239,"SUMBERAGUNG, MOYUDAN, SLEMAN, DAERAH ISTIMEWA YOGYAKARTA",6,123,70,193
https://kawalpemilu.org#42239,"SUMBERAGUNG, MOYUDAN, SLEMAN, DAERAH ISTIMEWA YOGYAKARTA",7,105,143,248
https://kawalpemilu.org#42239,"SUMBERAGUNG, MOYUDAN, SLEMAN, DAERAH ISTIMEWA YOGYAKARTA",8,160,15,175
https://kawalpemilu.org#42239,"SUMBERAGUNG, MOYUDAN, SLEMAN, DAERAH ISTIMEWA YOGYAKARTA",9,188,37,225
https://kawalpemilu.org#42239,"SUMBERAGUNG, MOYUDAN, SLEMAN, DAERAH ISTIMEWA YOGYAKARTA",10,165,71,236
https://kawalpemilu.org#42239,"SUMBERAGUNG, MOYUDAN, SLEMAN, DAERAH ISTIMEWA YOGYAKARTA",11,132,40,172
https://kawalpemilu.org#42239,"SUMBERAGUNG, MOYUDAN, SLEMAN, DAERAH ISTIMEWA YOGYAKARTA",12,57,119,176
https://kawalpemilu.org#42239,"SUMBERAGUNG, MOYUDAN, SLEMAN, DAERAH ISTIMEWA YOGYAKARTA",13,37,109,146
https://kawalpemilu.org#42239,"SUMBERAGUNG, MOYUDAN, SLEMAN, DAERAH ISTIMEWA YOGYAKARTA",14,82,139,221
https://kawalpemilu.org#42239,"SUMBERAGUNG, MOYUDAN, SLEMAN, DAERAH ISTIMEWA YOGYAKARTA",15,18,189,207
https://kawalpemilu.org#42239,"SUMBERAGUNG, MOYUDAN, SLEMAN, DAERAH ISTIMEWA YOGYAKARTA",16,20,140,160
https://kawalpemilu.org#42239,"SUMBERAGUNG, MOYUDAN, SLEMAN, DAERAH ISTIMEWA YOGYAKARTA",17,84,86,170
https://kawalpemilu.org#42239,"SUMBERAGUNG, MOYUDAN, SLEMAN, DAERAH ISTIMEWA YOGYAKARTA",18,59,116,175
https://kawalpemilu.org#42239,"SUMBERAGUNG, MOYUDAN, SLEMAN, DAERAH ISTIMEWA YOGYAKARTA",19,60,75,135
https://kawalpemilu.org#42239,"SUMBERAGUNG, MOYUDAN, SLEMAN, DAERAH ISTIMEWA YOGYAKARTA",20,108,59,167
https://kawalpemilu.org#42239,"SUMBERAGUNG, MOYUDAN, SLEMAN, DAERAH ISTIMEWA YOGYAKARTA",21,65,61,126
https://kawalpemilu.org#42239,"SUMBERAGUNG, MOYUDAN, SLEMAN, DAERAH ISTIMEWA YOGYAKARTA",22,85,60,145
https://kawalpemilu.org#42239,"SUMBERAGUNG, MOYUDAN, SLEMAN, DAERAH ISTIMEWA YOGYAKARTA",23,109,80,189
https://kawalpemilu.org#42239,"SUMBERAGUNG, MOYUDAN, SLEMAN, DAERAH ISTIMEWA YOGYAKARTA",24,119,99,218
https://kawalpemilu.org#42239,"SUMBERAGUNG, MOYUDAN, SLEMAN, DAERAH ISTIMEWA YOGYAKARTA",25,120,121,241
https://kawalpemilu.org#42239,"SUMBERAGUNG, MOYUDAN, SLEMAN, DAERAH ISTIMEWA YOGYAKARTA",26,95,120,215
https://kawalpemilu.org#42239,"SUMBERAGUNG, MOYUDAN, SLEMAN, DAERAH ISTIMEWA YOGYAKARTA",27,87,121,208
https://kawalpemilu.org#42239,"SUMBERAGUNG, MOYUDAN, SLEMAN, DAERAH ISTIMEWA YOGYAKARTA",28,79,68,147
https://kawalpemilu.org#42239,"SUMBERAGUNG, MOYUDAN, SLEMAN, DAERAH ISTIMEWA YOGYAKARTA",29,125,94,219
https://kawalpemilu.org#42239,"SUMBERAGUNG, MOYUDAN, SLEMAN, DAERAH ISTIMEWA YOGYAKARTA",30,125,144,269
https://kawalpemilu.org#42239,"SUMBERAGUNG, MOYUDAN, SLEMAN, DAERAH ISTIMEWA YOGYAKARTA",31,80,129,209
https://kawalpemilu.org#42239,"SUMBERAGUNG, MOYUDAN, SLEMAN, DAERAH ISTIMEWA YOGYAKARTA",32,54,133,192
https://kawalpemilu.org#42239,"SUMBERAGUNG, MOYUDAN, SLEMAN, DAERAH ISTIMEWA YOGYAKARTA",33,118,55,173
https://kawalpemilu.org#42239,"SUMBERAGUNG, MOYUDAN, SLEMAN, DAERAH ISTIMEWA YOGYAKARTA",34,93,95,188
https://kawalpemilu.org#42239,"SUMBERAGUNG, MOYUDAN, SLEMAN, DAERAH ISTIMEWA YOGYAKARTA",35,143,115,258
https://kawalpemilu.org#42239,"SUMBERAGUNG, MOYUDAN, SLEMAN, DAERAH ISTIMEWA YOGYAKARTA",36,88,86,174
https://kawalpemilu.org#42239,"SUMBERAGUNG, MOYUDAN, SLEMAN, DAERAH ISTIMEWA YOGYAKARTA",37,134,125,259
https://kawalpemilu.org#42239,"SUMBERAGUNG, MOYUDAN, SLEMAN, DAERAH ISTIMEWA YOGYAKARTA",38,121,123,244
https://kawalpemilu.org#42239,"SUMBERAGUNG, MOYUDAN, SLEMAN, DAERAH ISTIMEWA YOGYAKARTA",39,95,130,225
https://kawalpemilu.org#42239,"SUMBERAGUNG, MOYUDAN, SLEMAN, DAERAH ISTIMEWA YOGYAKARTA",40,108,131,239
https://kawalpemilu.org#42240,"SUMBERARUM, MOYUDAN, SLEMAN, DAERAH ISTIMEWA YOGYAKARTA",1,170,72,242
https://kawalpemilu.org#42240,"SUMBERARUM, MOYUDAN, SLEMAN, DAERAH ISTIMEWA YOGYAKARTA",2,129,75,204
https://kawalpemilu.org#42240,"SUMBERARUM, MOYUDAN, SLEMAN, DAERAH ISTIMEWA YOGYAKARTA",3,181,29,210
https://kawalpemilu.org#42240,"SUMBERARUM, MOYUDAN, SLEMAN, DAERAH ISTIMEWA YOGYAKARTA",4,151,61,212
https://kawalpemilu.org#42240,"SUMBERARUM, MOYUDAN, SLEMAN, DAERAH ISTIMEWA YOGYAKARTA",5,123,15,138
https://kawalpemilu.org#42240,"SUMBERARUM, MOYUDAN, SLEMAN, DAERAH ISTIMEWA YOGYAKARTA",6,136,28,164
https://kawalpemilu.org#42240,"SUMBERARUM, MOYUDAN, SLEMAN, DAERAH ISTIMEWA YOGYAKARTA",7,168,75,243
https://kawalpemilu.org#42240,"SUMBERARUM, MOYUDAN, SLEMAN, DAERAH ISTIMEWA YOGYAKARTA",8,27,72,99
https://kawalpemilu.org#42240,"SUMBERARUM, MOYUDAN, SLEMAN, DAERAH ISTIMEWA YOGYAKARTA",9,128,88,216
https://kawalpemilu.org#42240,"SUMBERARUM, MOYUDAN, SLEMAN, DAERAH ISTIMEWA YOGYAKARTA",10,63,71,134
https://kawalpemilu.org#42240,"SUMBERARUM, MOYUDAN, SLEMAN, DAERAH ISTIMEWA YOGYAKARTA",11,78,75,153
https://kawalpemilu.org#42240,"SUMBERARUM, MOYUDAN, SLEMAN, DAERAH ISTIMEWA YOGYAKARTA",12,82,46,128
https://kawalpemilu.org#42240,"SUMBERARUM, MOYUDAN, SLEMAN, DAERAH ISTIMEWA YOGYAKARTA",13,83,67,150
https://kawalpemilu.org#42240,"SUMBERARUM, MOYUDAN, SLEMAN, DAERAH ISTIMEWA YOGYAKARTA",14,99,38,137
https://kawalpemilu.org#42240,"SUMBERARUM, MOYUDAN, SLEMAN, DAERAH ISTIMEWA YOGYAKARTA",15,65,54,119
https://kawalpemilu.org#42240,"SUMBERARUM, MOYUDAN, SLEMAN, DAERAH ISTIMEWA YOGYAKARTA",16,116,43,159
https://kawalpemilu.org#42240,"SUMBERARUM, MOYUDAN, SLEMAN, DAERAH ISTIMEWA YOGYAKARTA",18,80,42,122
https://kawalpemilu.org#42240,"SUMBERARUM, MOYUDAN, SLEMAN, DAERAH ISTIMEWA YOGYAKARTA",19,90,12,102
https://kawalpemilu.org#42240,"SUMBERARUM, MOYUDAN, SLEMAN, DAERAH ISTIMEWA YOGYAKARTA",20,126,44,170
https://kawalpemilu.org#42240,"SUMBERARUM, MOYUDAN, SLEMAN, DAERAH ISTIMEWA YOGYAKARTA",21,152,35,187
https://kawalpemilu.org#42240,"SUMBERARUM, MOYUDAN, SLEMAN, DAERAH ISTIMEWA YOGYAKARTA",22,101,125,226
https://kawalpemilu.org#42240,"SUMBERARUM, MOYUDAN, SLEMAN, DAERAH ISTIMEWA YOGYAKARTA",23,80,68,148
https://kawalpemilu.org#42240,"SUMBERARUM, MOYUDAN, SLEMAN, DAERAH ISTIMEWA YOGYAKARTA",24,48,82,130
https://kawalpemilu.org#42240,"SUMBERARUM, MOYUDAN, SLEMAN, DAERAH ISTIMEWA YOGYAKARTA",25,42,63,105
https://kawalpemilu.org#42240,"SUMBERARUM, MOYUDAN, SLEMAN, DAERAH ISTIMEWA YOGYAKARTA",26,109,89,198
https://kawalpemilu.org#42240,"SUMBERARUM, MOYUDAN, SLEMAN, DAERAH ISTIMEWA YOGYAKARTA",27,129,115,244
https://kawalpemilu.org#42240,"SUMBERARUM, MOYUDAN, SLEMAN, DAERAH ISTIMEWA YOGYAKARTA",28,102,93,195
https://kawalpemilu.org#42242,"SENDANGARUM, MINGGIR, SLEMAN, DAERAH ISTIMEWA YOGYAKARTA",1,206,35,241
https://kawalpemilu.org#42242,"SENDANGARUM, MINGGIR, SLEMAN, DAERAH ISTIMEWA YOGYAKARTA",2,148,41,189
https://kawalpemilu.org#42242,"SENDANGARUM, MINGGIR, SLEMAN, DAERAH ISTIMEWA YOGYAKARTA",3,150,26,176
https://kawalpemilu.org#42242,"SENDANGARUM, MINGGIR, SLEMAN, DAERAH ISTIMEWA YOGYAKARTA",4,156,12,168
https://kawalpemilu.org#42242,"SENDANGARUM, MINGGIR, SLEMAN, DAERAH ISTIMEWA YOGYAKARTA",5,142,78,220
https://kawalpemilu.org#42242,"SENDANGARUM, MINGGIR, SLEMAN, DAERAH ISTIMEWA YOGYAKARTA",6,129,27,156
https://kawalpemilu.org#42242,"SENDANGARUM, MINGGIR, SLEMAN, DAERAH ISTIMEWA YOGYAKARTA",7,138,76,214
https://kawalpemilu.org#42242,"SENDANGARUM, MINGGIR, SLEMAN, DAERAH ISTIMEWA YOGYAKARTA",8,63,59,122
https://kawalpemilu.org#42242,"SENDANGARUM, MINGGIR, SLEMAN, DAERAH ISTIMEWA YOGYAKARTA",9,82,125,207
https://kawalpemilu.org#42242,"SENDANGARUM, MINGGIR, SLEMAN, DAERAH ISTIMEWA YOGYAKARTA",10,45,194,239
https://kawalpemilu.org#42242,"SENDANGARUM, MINGGIR, SLEMAN, DAERAH ISTIMEWA YOGYAKARTA",11,52,118,170
https://kawalpemilu.org#42242,"SENDANGARUM, MINGGIR, SLEMAN, DAERAH ISTIMEWA YOGYAKARTA",12,16,207,223
https://kawalpemilu.org#42242,"SENDANGARUM, MINGGIR, SLEMAN, DAERAH ISTIMEWA YOGYAKARTA",13,57,166,223
https://kawalpemilu.org#42243,"SENDANGMULYO, MINGGIR, SLEMAN, DAERAH ISTIMEWA YOGYAKARTA",1,71,128,199
https://kawalpemilu.org#42243,"SENDANGMULYO, MINGGIR, SLEMAN, DAERAH ISTIMEWA YOGYAKARTA",2,81,50,131
https://kawalpemilu.org#42243,"SENDANGMULYO, MINGGIR, SLEMAN, DAERAH ISTIMEWA YOGYAKARTA",3,77,99,0
https://kawalpemilu.org#42243,"SENDANGMULYO, MINGGIR, SLEMAN, DAERAH ISTIMEWA YOGYAKARTA",4,115,112,227
https://kawalpemilu.org#42243,"SENDANGMULYO, MINGGIR, SLEMAN, DAERAH ISTIMEWA YOGYAKARTA",5,91,97,188
https://kawalpemilu.org#42243,"SENDANGMULYO, MINGGIR, SLEMAN, DAERAH ISTIMEWA YOGYAKARTA",6,67,63,130
https://kawalpemilu.org#42243,"SENDANGMULYO, MINGGIR, SLEMAN, DAERAH ISTIMEWA YOGYAKARTA",7,151,103,254
https://kawalpemilu.org#42243,"SENDANGMULYO, MINGGIR, SLEMAN, DAERAH ISTIMEWA YOGYAKARTA",8,181,12,193
https://kawalpemilu.org#42243,"SENDANGMULYO, MINGGIR, SLEMAN, DAERAH ISTIMEWA YOGYAKARTA",9,119,57,176
https://kawalpemilu.org#42243,"SENDANGMULYO, MINGGIR, SLEMAN, DAERAH ISTIMEWA YOGYAKARTA",10,154,76,230
https://kawalpemilu.org#42243,"SENDANGMULYO, MINGGIR, SLEMAN, DAERAH ISTIMEWA YOGYAKARTA",11,179,13,192
https://kawalpemilu.org#42243,"SENDANGMULYO, MINGGIR, SLEMAN, DAERAH ISTIMEWA YOGYAKARTA",12,198,12,210
https://kawalpemilu.org#42243,"SENDANGMULYO, MINGGIR, SLEMAN, DAERAH ISTIMEWA YOGYAKARTA",13,144,48,192
https://kawalpemilu.org#42243,"SENDANGMULYO, MINGGIR, SLEMAN, DAERAH ISTIMEWA YOGYAKARTA",14,50,125,175
https://kawalpemilu.org#42243,"SENDANGMULYO, MINGGIR, SLEMAN, DAERAH ISTIMEWA YOGYAKARTA",15,68,68,136
https://kawalpemilu.org#42243,"SENDANGMULYO, MINGGIR, SLEMAN, DAERAH ISTIMEWA YOGYAKARTA",16,123,125,248
https://kawalpemilu.org#42243,"SENDANGMULYO, MINGGIR, SLEMAN, DAERAH ISTIMEWA YOGYAKARTA",17,54,102,156
https://kawalpemilu.org#42243,"SENDANGMULYO, MINGGIR, SLEMAN, DAERAH ISTIMEWA YOGYAKARTA",18,94,103,197
https://kawalpemilu.org#42243,"SENDANGMULYO, MINGGIR, SLEMAN, DAERAH ISTIMEWA YOGYAKARTA",19,102,52,154
https://kawalpemilu.org#42243,"SENDANGMULYO, MINGGIR, SLEMAN, DAERAH ISTIMEWA YOGYAKARTA",21,129,28,157
https://kawalpemilu.org#42243,"SENDANGMULYO, MINGGIR, SLEMAN, DAERAH ISTIMEWA YOGYAKARTA",22,71,20,91
https://kawalpemilu.org#42243,"SENDANGMULYO, MINGGIR, SLEMAN, DAERAH ISTIMEWA YOGYAKARTA",23,78,104,182
https://kawalpemilu.org#42243,"SENDANGMULYO, MINGGIR, SLEMAN, DAERAH ISTIMEWA YOGYAKARTA",24,164,15,179
https://kawalpemilu.org#42243,"SENDANGMULYO, MINGGIR, SLEMAN, DAERAH ISTIMEWA YOGYAKARTA",25,169,26,195
https://kawalpemilu.org#42243,"SENDANGMULYO, MINGGIR, SLEMAN, DAERAH ISTIMEWA YOGYAKARTA",26,107,89,195
https://kawalpemilu.org#42244,"SENDANGAGUNG, MINGGIR, SLEMAN, DAERAH ISTIMEWA YOGYAKARTA",1,104,23,127
https://kawalpemilu.org#42244,"SENDANGAGUNG, MINGGIR, SLEMAN, DAERAH ISTIMEWA YOGYAKARTA",2,114,50,164
https://kawalpemilu.org#42244,"SENDANGAGUNG, MINGGIR, SLEMAN, DAERAH ISTIMEWA YOGYAKARTA",3,113,66,179
https://kawalpemilu.org#42244,"SENDANGAGUNG, MINGGIR, SLEMAN, DAERAH ISTIMEWA YOGYAKARTA",4,110,51,161
https://kawalpemilu.org#42244,"SENDANGAGUNG, MINGGIR, SLEMAN, DAERAH ISTIMEWA YOGYAKARTA",5,135,46,181
https://kawalpemilu.org#42244,"SENDANGAGUNG, MINGGIR, SLEMAN, DAERAH ISTIMEWA YOGYAKARTA",6,105,64,169
https://kawalpemilu.org#42244,"SENDANGAGUNG, MINGGIR, SLEMAN, DAERAH ISTIMEWA YOGYAKARTA",7,118,55,173
https://kawalpemilu.org#42244,"SENDANGAGUNG, MINGGIR, SLEMAN, DAERAH ISTIMEWA YOGYAKARTA",8,99,28,127
https://kawalpemilu.org#42244,"SENDANGAGUNG, MINGGIR, SLEMAN, DAERAH ISTIMEWA YOGYAKARTA",9,121,74,195
https://kawalpemilu.org#42244,"SENDANGAGUNG, MINGGIR, SLEMAN, DAERAH ISTIMEWA YOGYAKARTA",10,127,39,166
https://kawalpemilu.org#42244,"SENDANGAGUNG, MINGGIR, SLEMAN, DAERAH ISTIMEWA YOGYAKARTA",11,110,24,134
https://kawalpemilu.org#42244,"SENDANGAGUNG, MINGGIR, SLEMAN, DAERAH ISTIMEWA YOGYAKARTA",12,86,71,157
https://kawalpemilu.org#42244,"SENDANGAGUNG, MINGGIR, SLEMAN, DAERAH ISTIMEWA YOGYAKARTA",13,117,40,157
https://kawalpemilu.org#42244,"SENDANGAGUNG, MINGGIR, SLEMAN, DAERAH ISTIMEWA YOGYAKARTA",14,102,60,162
https://kawalpemilu.org#42244,"SENDANGAGUNG, MINGGIR, SLEMAN, DAERAH ISTIMEWA YOGYAKARTA",15,129,39,168
https://kawalpemilu.org#42244,"SENDANGAGUNG, MINGGIR, SLEMAN, DAERAH ISTIMEWA YOGYAKARTA",16,117,31,148
https://kawalpemilu.org#42244,"SENDANGAGUNG, MINGGIR, SLEMAN, DAERAH ISTIMEWA YOGYAKARTA",17,144,82,226
https://kawalpemilu.org#42244,"SENDANGAGUNG, MINGGIR, SLEMAN, DAERAH ISTIMEWA YOGYAKARTA",19,178,42,220
https://kawalpemilu.org#42244,"SENDANGAGUNG, MINGGIR, SLEMAN, DAERAH ISTIMEWA YOGYAKARTA",20,188,36,224
https://kawalpemilu.org#42244,"SENDANGAGUNG, MINGGIR, SLEMAN, DAERAH ISTIMEWA YOGYAKARTA",21,126,49,175
https://kawalpemilu.org#42244,"SENDANGAGUNG, MINGGIR, SLEMAN, DAERAH ISTIMEWA YOGYAKARTA",22,122,58,180
https://kawalpemilu.org#42244,"SENDANGAGUNG, MINGGIR, SLEMAN, DAERAH ISTIMEWA YOGYAKARTA",23,137,59,196
https://kawalpemilu.org#42244,"SENDANGAGUNG, MINGGIR, SLEMAN, DAERAH ISTIMEWA YOGYAKARTA",24,87,18,105
https://kawalpemilu.org#42244,"SENDANGAGUNG, MINGGIR, SLEMAN, DAERAH ISTIMEWA YOGYAKARTA",25,115,90,205
https://kawalpemilu.org#42244,"SENDANGAGUNG, MINGGIR, SLEMAN, DAERAH ISTIMEWA YOGYAKARTA",26,137,60,197
https://kawalpemilu.org#42244,"SENDANGAGUNG, MINGGIR, SLEMAN, DAERAH ISTIMEWA YOGYAKARTA",27,144,30,174
https://kawalpemilu.org#42244,"SENDANGAGUNG, MINGGIR, SLEMAN, DAERAH ISTIMEWA YOGYAKARTA",28,85,67,152
https://kawalpemilu.org#42244,"SENDANGAGUNG, MINGGIR, SLEMAN, DAERAH ISTIMEWA YOGYAKARTA",29,49,70,119
https://kawalpemilu.org#42244,"SENDANGAGUNG, MINGGIR, SLEMAN, DAERAH ISTIMEWA YOGYAKARTA",30,100,70,170
https://kawalpemilu.org#42244,"SENDANGAGUNG, MINGGIR, SLEMAN, DAERAH ISTIMEWA YOGYAKARTA",31,86,56,142
https://kawalpemilu.org#42244,"SENDANGAGUNG, MINGGIR, SLEMAN, DAERAH ISTIMEWA YOGYAKARTA",32,130,29,159
https://kawalpemilu.org#42244,"SENDANGAGUNG, MINGGIR, SLEMAN, DAERAH ISTIMEWA YOGYAKARTA",33,114,11,125
https://kawalpemilu.org#42245,"SENDANGSARI, MINGGIR, SLEMAN, DAERAH ISTIMEWA YOGYAKARTA",1,145,14,159
https://kawalpemilu.org#42245,"SENDANGSARI, MINGGIR, SLEMAN, DAERAH ISTIMEWA YOGYAKARTA",2,218,17,235
https://kawalpemilu.org#42245,"SENDANGSARI, MINGGIR, SLEMAN, DAERAH ISTIMEWA YOGYAKARTA",3,51,71,122
https://kawalpemilu.org#42245,"SENDANGSARI, MINGGIR, SLEMAN, DAERAH ISTIMEWA YOGYAKARTA",4,54,95,149
https://kawalpemilu.org#42245,"SENDANGSARI, MINGGIR, SLEMAN, DAERAH ISTIMEWA YOGYAKARTA",5,59,66,125
https://kawalpemilu.org#42245,"SENDANGSARI, MINGGIR, SLEMAN, DAERAH ISTIMEWA YOGYAKARTA",6,119,9,128
https://kawalpemilu.org#42245,"SENDANGSARI, MINGGIR, SLEMAN, DAERAH ISTIMEWA YOGYAKARTA",7,144,51,195
https://kawalpemilu.org#42245,"SENDANGSARI, MINGGIR, SLEMAN, DAERAH ISTIMEWA YOGYAKARTA",8,160,68,228
https://kawalpemilu.org#42245,"SENDANGSARI, MINGGIR, SLEMAN, DAERAH ISTIMEWA YOGYAKARTA",9,138,71,209
https://kawalpemilu.org#42245,"SENDANGSARI, MINGGIR, SLEMAN, DAERAH ISTIMEWA YOGYAKARTA",10,116,39,155
https://kawalpemilu.org#42245,"SENDANGSARI, MINGGIR, SLEMAN, DAERAH ISTIMEWA YOGYAKARTA",11,127,20,147
https://kawalpemilu.org#42245,"SENDANGSARI, MINGGIR, SLEMAN, DAERAH ISTIMEWA YOGYAKARTA",12,81,43,124
https://kawalpemilu.org#42245,"SENDANGSARI, MINGGIR, SLEMAN, DAERAH ISTIMEWA YOGYAKARTA",13,133,50,183
https://kawalpemilu.org#42245,"SENDANGSARI, MINGGIR, SLEMAN, DAERAH ISTIMEWA YOGYAKARTA",14,166,29,195
https://kawalpemilu.org#42245,"SENDANGSARI, MINGGIR, SLEMAN, DAERAH ISTIMEWA YOGYAKARTA",15,82,43,125
https://kawalpemilu.org#42245,"SENDANGSARI, MINGGIR, SLEMAN, DAERAH ISTIMEWA YOGYAKARTA",16,113,72,185
https://kawalpemilu.org#42245,"SENDANGSARI, MINGGIR, SLEMAN, DAERAH ISTIMEWA YOGYAKARTA",17,123,91,214
https://kawalpemilu.org#42245,"SENDANGSARI, MINGGIR, SLEMAN, DAERAH ISTIMEWA YOGYAKARTA",18,166,77,243
https://kawalpemilu.org#42245,"SENDANGSARI, MINGGIR, SLEMAN, DAERAH ISTIMEWA YOGYAKARTA",19,114,33,147
https://kawalpemilu.org#42245,"SENDANGSARI, MINGGIR, SLEMAN, DAERAH ISTIMEWA YOGYAKARTA",20,105,69,174
https://kawalpemilu.org#42246,"SENDANGREJO, MINGGIR, SLEMAN, DAERAH ISTIMEWA YOGYAKARTA",1,103,52,155
https://kawalpemilu.org#42246,"SENDANGREJO, MINGGIR, SLEMAN, DAERAH ISTIMEWA YOGYAKARTA",2,93,68,161
https://kawalpemilu.org#42246,"SENDANGREJO, MINGGIR, SLEMAN, DAERAH ISTIMEWA YOGYAKARTA",3,120,55,175
https://kawalpemilu.org#42246,"SENDANGREJO, MINGGIR, SLEMAN, DAERAH ISTIMEWA YOGYAKARTA",4,77,52,129
https://kawalpemilu.org#42246,"SENDANGREJO, MINGGIR, SLEMAN, DAERAH ISTIMEWA YOGYAKARTA",5,140,119,259
https://kawalpemilu.org#42246,"SENDANGREJO, MINGGIR, SLEMAN, DAERAH ISTIMEWA YOGYAKARTA",6,81,62,143
https://kawalpemilu.org#42246,"SENDANGREJO, MINGGIR, SLEMAN, DAERAH ISTIMEWA YOGYAKARTA",7,173,82,255
https://kawalpemilu.org#42246,"SENDANGREJO, MINGGIR, SLEMAN, DAERAH ISTIMEWA YOGYAKARTA",8,113,74,187
https://kawalpemilu.org#42246,"SENDANGREJO, MINGGIR, SLEMAN, DAERAH ISTIMEWA YOGYAKARTA",9,86,75,161
https://kawalpemilu.org#42246,"SENDANGREJO, MINGGIR, SLEMAN, DAERAH ISTIMEWA YOGYAKARTA",10,104,67,171
https://kawalpemilu.org#42246,"SENDANGREJO, MINGGIR, SLEMAN, DAERAH ISTIMEWA YOGYAKARTA",11,162,75,237
https://kawalpemilu.org#42246,"SENDANGREJO, MINGGIR, SLEMAN, DAERAH ISTIMEWA YOGYAKARTA",12,89,170,259
https://kawalpemilu.org#42246,"SENDANGREJO, MINGGIR, SLEMAN, DAERAH ISTIMEWA YOGYAKARTA",13,81,93,174
https://kawalpemilu.org#42246,"SENDANGREJO, MINGGIR, SLEMAN, DAERAH ISTIMEWA YOGYAKARTA",14,46,71,117
https://kawalpemilu.org#42246,"SENDANGREJO, MINGGIR, SLEMAN, DAERAH ISTIMEWA YOGYAKARTA",15,60,60,120
https://kawalpemilu.org#42246,"SENDANGREJO, MINGGIR, SLEMAN, DAERAH ISTIMEWA YOGYAKARTA",16,83,92,175
https://kawalpemilu.org#42246,"SENDANGREJO, MINGGIR, SLEMAN, DAERAH ISTIMEWA YOGYAKARTA",17,69,153,222
https://kawalpemilu.org#42246,"SENDANGREJO, MINGGIR, SLEMAN, DAERAH ISTIMEWA YOGYAKARTA",18,117,95,212
https://kawalpemilu.org#42246,"SENDANGREJO, MINGGIR, SLEMAN, DAERAH ISTIMEWA YOGYAKARTA",19,68,53,121
https://kawalpemilu.org#42246,"SENDANGREJO, MINGGIR, SLEMAN, DAERAH ISTIMEWA YOGYAKARTA",20,149,103,252
https://kawalpemilu.org#42246,"SENDANGREJO, MINGGIR, SLEMAN, DAERAH ISTIMEWA YOGYAKARTA",21,109,158,267
https://kawalpemilu.org#42246,"SENDANGREJO, MINGGIR, SLEMAN, DAERAH ISTIMEWA YOGYAKARTA",22,141,114,255
https://kawalpemilu.org#42246,"SENDANGREJO, MINGGIR, SLEMAN, DAERAH ISTIMEWA YOGYAKARTA",23,165,82,247
https://kawalpemilu.org#42246,"SENDANGREJO, MINGGIR, SLEMAN, DAERAH ISTIMEWA YOGYAKARTA",24,97,135,232
https://kawalpemilu.org#42246,"SENDANGREJO, MINGGIR, SLEMAN, DAERAH ISTIMEWA YOGYAKARTA",25,152,85,237
https://kawalpemilu.org#42246,"SENDANGREJO, MINGGIR, SLEMAN, DAERAH ISTIMEWA YOGYAKARTA",26,194,25,219
https://kawalpemilu.org#42246,"SENDANGREJO, MINGGIR, SLEMAN, DAERAH ISTIMEWA YOGYAKARTA",27,131,41,172
https://kawalpemilu.org#42246,"SENDANGREJO, MINGGIR, SLEMAN, DAERAH ISTIMEWA YOGYAKARTA",28,171,80,251
https://kawalpemilu.org#42246,"SENDANGREJO, MINGGIR, SLEMAN, DAERAH ISTIMEWA YOGYAKARTA",29,113,113,226
https://kawalpemilu.org#42246,"SENDANGREJO, MINGGIR, SLEMAN, DAERAH ISTIMEWA YOGYAKARTA",30,70,117,187
https://kawalpemilu.org#42248,"MARGOLUWIH, SEYEGAN, SLEMAN, DAERAH ISTIMEWA YOGYAKARTA",1,183,78,261
https://kawalpemilu.org#42248,"MARGOLUWIH, SEYEGAN, SLEMAN, DAERAH ISTIMEWA YOGYAKARTA",2,154,82,236
https://kawalpemilu.org#42248,"MARGOLUWIH, SEYEGAN, SLEMAN, DAERAH ISTIMEWA YOGYAKARTA",3,91,125,216
https://kawalpemilu.org#42248,"MARGOLUWIH, SEYEGAN, SLEMAN, DAERAH ISTIMEWA YOGYAKARTA",4,132,101,233
https://kawalpemilu.org#42248,"MARGOLUWIH, SEYEGAN, SLEMAN, DAERAH ISTIMEWA YOGYAKARTA",5,145,103,248
https://kawalpemilu.org#42248,"MARGOLUWIH, SEYEGAN, SLEMAN, DAERAH ISTIMEWA YOGYAKARTA",6,160,78,238
https://kawalpemilu.org#42248,"MARGOLUWIH, SEYEGAN, SLEMAN, DAERAH ISTIMEWA YOGYAKARTA",7,157,84,241
https://kawalpemilu.org#42248,"MARGOLUWIH, SEYEGAN, SLEMAN, DAERAH ISTIMEWA YOGYAKARTA",8,171,84,255
https://kawalpemilu.org#42248,"MARGOLUWIH, SEYEGAN, SLEMAN, DAERAH ISTIMEWA YOGYAKARTA",9,177,71,248
https://kawalpemilu.org#42248,"MARGOLUWIH, SEYEGAN, SLEMAN, DAERAH ISTIMEWA YOGYAKARTA",10,173,65,238
https://kawalpemilu.org#42248,"MARGOLUWIH, SEYEGAN, SLEMAN, DAERAH ISTIMEWA YOGYAKARTA",11,166,82,248
https://kawalpemilu.org#42248,"MARGOLUWIH, SEYEGAN, SLEMAN, DAERAH ISTIMEWA YOGYAKARTA",12,176,69,245
https://kawalpemilu.org#42248,"MARGOLUWIH, SEYEGAN, SLEMAN, DAERAH ISTIMEWA YOGYAKARTA",13,166,36,202
https://kawalpemilu.org#42248,"MARGOLUWIH, SEYEGAN, SLEMAN, DAERAH ISTIMEWA YOGYAKARTA",14,178,53,231
https://kawalpemilu.org#42248,"MARGOLUWIH, SEYEGAN, SLEMAN, DAERAH ISTIMEWA YOGYAKARTA",15,111,140,251
https://kawalpemilu.org#42248,"MARGOLUWIH, SEYEGAN, SLEMAN, DAERAH ISTIMEWA YOGYAKARTA",16,101,114,215
https://kawalpemilu.org#42248,"MARGOLUWIH, SEYEGAN, SLEMAN, DAERAH ISTIMEWA YOGYAKARTA",17,118,131,249
https://kawalpemilu.org#42248,"MARGOLUWIH, SEYEGAN, SLEMAN, DAERAH ISTIMEWA YOGYAKARTA",18,119,96,215
https://kawalpemilu.org#42248,"MARGOLUWIH, SEYEGAN, SLEMAN, DAERAH ISTIMEWA YOGYAKARTA",19,125,88,213
https://kawalpemilu.org#42248,"MARGOLUWIH, SEYEGAN, SLEMAN, DAERAH ISTIMEWA YOGYAKARTA",20,191,59,250
https://kawalpemilu.org#42248,"MARGOLUWIH, SEYEGAN, SLEMAN, DAERAH ISTIMEWA YOGYAKARTA",21,158,87,245
https://kawalpemilu.org#42248,"MARGOLUWIH, SEYEGAN, SLEMAN, DAERAH ISTIMEWA YOGYAKARTA",22,190,43,233
https://kawalpemilu.org#42248,"MARGOLUWIH, SEYEGAN, SLEMAN, DAERAH ISTIMEWA YOGYAKARTA",23,152,90,242
https://kawalpemilu.org#42248,"MARGOLUWIH, SEYEGAN, SLEMAN, DAERAH ISTIMEWA YOGYAKARTA",24,101,137,238
https://kawalpemilu.org#42248,"MARGOLUWIH, SEYEGAN, SLEMAN, DAERAH ISTIMEWA YOGYAKARTA",25,140,90,230
https://kawalpemilu.org#42248,"MARGOLUWIH, SEYEGAN, SLEMAN, DAERAH ISTIMEWA YOGYAKARTA",26,163,48,211
https://kawalpemilu.org#42248,"MARGOLUWIH, SEYEGAN, SLEMAN, DAERAH ISTIMEWA YOGYAKARTA",27,150,34,184
https://kawalpemilu.org#42248,"MARGOLUWIH, SEYEGAN, SLEMAN, DAERAH ISTIMEWA YOGYAKARTA",28,180,80,260
https://kawalpemilu.org#42248,"MARGOLUWIH, SEYEGAN, SLEMAN, DAERAH ISTIMEWA YOGYAKARTA",29,163,76,239
https://kawalpemilu.org#42248,"MARGOLUWIH, SEYEGAN, SLEMAN, DAERAH ISTIMEWA YOGYAKARTA",30,180,77,257
https://kawalpemilu.org#42249,"MARGODADI, SEYEGAN, SLEMAN, DAERAH ISTIMEWA YOGYAKARTA",1,189,80,269
https://kawalpemilu.org#42249,"MARGODADI, SEYEGAN, SLEMAN, DAERAH ISTIMEWA YOGYAKARTA",2,128,91,219
https://kawalpemilu.org#42249,"MARGODADI, SEYEGAN, SLEMAN, DAERAH ISTIMEWA YOGYAKARTA",3,166,66,232
https://kawalpemilu.org#42249,"MARGODADI, SEYEGAN, SLEMAN, DAERAH ISTIMEWA YOGYAKARTA",4,127,86,213
https://kawalpemilu.org#42249,"MARGODADI, SEYEGAN, SLEMAN, DAERAH ISTIMEWA YOGYAKARTA",5,118,142,260
https://kawalpemilu.org#42249,"MARGODADI, SEYEGAN, SLEMAN, DAERAH ISTIMEWA YOGYAKARTA",6,150,95,245
https://kawalpemilu.org#42249,"MARGODADI, SEYEGAN, SLEMAN, DAERAH ISTIMEWA YOGYAKARTA",7,129,22,151
https://kawalpemilu.org#42249,"MARGODADI, SEYEGAN, SLEMAN, DAERAH ISTIMEWA YOGYAKARTA",8,172,75,247
https://kawalpemilu.org#42249,"MARGODADI, SEYEGAN, SLEMAN, DAERAH ISTIMEWA YOGYAKARTA",9,142,52,194
https://kawalpemilu.org#42249,"MARGODADI, SEYEGAN, SLEMAN, DAERAH ISTIMEWA YOGYAKARTA",10,156,84,240
https://kawalpemilu.org#42249,"MARGODADI, SEYEGAN, SLEMAN, DAERAH ISTIMEWA YOGYAKARTA",11,114,88,202
https://kawalpemilu.org#42249,"MARGODADI, SEYEGAN, SLEMAN, DAERAH ISTIMEWA YOGYAKARTA",12,137,124,261
https://kawalpemilu.org#42249,"MARGODADI, SEYEGAN, SLEMAN, DAERAH ISTIMEWA YOGYAKARTA",13,145,104,249
https://kawalpemilu.org#42249,"MARGODADI, SEYEGAN, SLEMAN, DAERAH ISTIMEWA YOGYAKARTA",14,111,125,136
https://kawalpemilu.org#42249,"MARGODADI, SEYEGAN, SLEMAN, DAERAH ISTIMEWA YOGYAKARTA",15,83,169,252
https://kawalpemilu.org#42249,"MARGODADI, SEYEGAN, SLEMAN, DAERAH ISTIMEWA YOGYAKARTA",16,128,103,231
https://kawalpemilu.org#42249,"MARGODADI, SEYEGAN, SLEMAN, DAERAH ISTIMEWA YOGYAKARTA",17,132,91,223
https://kawalpemilu.org#42249,"MARGODADI, SEYEGAN, SLEMAN, DAERAH ISTIMEWA YOGYAKARTA",18,140,97,237
https://kawalpemilu.org#42249,"MARGODADI, SEYEGAN, SLEMAN, DAERAH ISTIMEWA YOGYAKARTA",19,211,45,256
https://kawalpemilu.org#42249,"MARGODADI, SEYEGAN, SLEMAN, DAERAH ISTIMEWA YOGYAKARTA",20,178,55,233
https://kawalpemilu.org#42249,"MARGODADI, SEYEGAN, SLEMAN, DAERAH ISTIMEWA YOGYAKARTA",21,173,88,261
https://kawalpemilu.org#42249,"MARGODADI, SEYEGAN, SLEMAN, DAERAH ISTIMEWA YOGYAKARTA",22,158,101,259
https://kawalpemilu.org#42249,"MARGODADI, SEYEGAN, SLEMAN, DAERAH ISTIMEWA YOGYAKARTA",23,147,92,239
https://kawalpemilu.org#42249,"MARGODADI, SEYEGAN, SLEMAN, DAERAH ISTIMEWA YOGYAKARTA",24,170,56,226
https://kawalpemilu.org#42249,"MARGODADI, SEYEGAN, SLEMAN, DAERAH ISTIMEWA YOGYAKARTA",25,193,65,258
https://kawalpemilu.org#42249,"MARGODADI, SEYEGAN, SLEMAN, DAERAH ISTIMEWA YOGYAKARTA",26,190,61,251
https://kawalpemilu.org#42250,"MARGOMULYO, SEYEGAN, SLEMAN, DAERAH ISTIMEWA YOGYAKARTA",1,149,72,221
https://kawalpemilu.org#42250,"MARGOMULYO, SEYEGAN, SLEMAN, DAERAH ISTIMEWA YOGYAKARTA",2,115,69,184
https://kawalpemilu.org#42250,"MARGOMULYO, SEYEGAN, SLEMAN, DAERAH ISTIMEWA YOGYAKARTA",3,123,125,248
https://kawalpemilu.org#42250,"MARGOMULYO, SEYEGAN, SLEMAN, DAERAH ISTIMEWA YOGYAKARTA",4,130,84,214
https://kawalpemilu.org#42250,"MARGOMULYO, SEYEGAN, SLEMAN, DAERAH ISTIMEWA YOGYAKARTA",5,106,151,257
https://kawalpemilu.org#42250,"MARGOMULYO, SEYEGAN, SLEMAN, DAERAH ISTIMEWA YOGYAKARTA",6,194,47,241
https://kawalpemilu.org#42250,"MARGOMULYO, SEYEGAN, SLEMAN, DAERAH ISTIMEWA YOGYAKARTA",7,167,43,210
https://kawalpemilu.org#42250,"MARGOMULYO, SEYEGAN, SLEMAN, DAERAH ISTIMEWA YOGYAKARTA",8,132,129,261
https://kawalpemilu.org#42250,"MARGOMULYO, SEYEGAN, SLEMAN, DAERAH ISTIMEWA YOGYAKARTA",9,114,105,219
https://kawalpemilu.org#42250,"MARGOMULYO, SEYEGAN, SLEMAN, DAERAH ISTIMEWA YOGYAKARTA",10,207,51,258
https://kawalpemilu.org#42250,"MARGOMULYO, SEYEGAN, SLEMAN, DAERAH ISTIMEWA YOGYAKARTA",11,192,52,244
https://kawalpemilu.org#42250,"MARGOMULYO, SEYEGAN, SLEMAN, DAERAH ISTIMEWA YOGYAKARTA",12,171,77,248
https://kawalpemilu.org#42250,"MARGOMULYO, SEYEGAN, SLEMAN, DAERAH ISTIMEWA YOGYAKARTA",13,189,77,266
https://kawalpemilu.org#42250,"MARGOMULYO, SEYEGAN, SLEMAN, DAERAH ISTIMEWA YOGYAKARTA",14,189,33,222
https://kawalpemilu.org#42250,"MARGOMULYO, SEYEGAN, SLEMAN, DAERAH ISTIMEWA YOGYAKARTA",15,181,51,232
https://kawalpemilu.org#42250,"MARGOMULYO, SEYEGAN, SLEMAN, DAERAH ISTIMEWA YOGYAKARTA",16,143,66,209
https://kawalpemilu.org#42250,"MARGOMULYO, SEYEGAN, SLEMAN, DAERAH ISTIMEWA YOGYAKARTA",17,173,74,247
https://kawalpemilu.org#42250,"MARGOMULYO, SEYEGAN, SLEMAN, DAERAH ISTIMEWA YOGYAKARTA",18,155,81,236
https://kawalpemilu.org#42250,"MARGOMULYO, SEYEGAN, SLEMAN, DAERAH ISTIMEWA YOGYAKARTA",19,152,60,212
https://kawalpemilu.org#42250,"MARGOMULYO, SEYEGAN, SLEMAN, DAERAH ISTIMEWA YOGYAKARTA",20,201,32,233
https://kawalpemilu.org#42250,"MARGOMULYO, SEYEGAN, SLEMAN, DAERAH ISTIMEWA YOGYAKARTA",21,116,91,207
https://kawalpemilu.org#42250,"MARGOMULYO, SEYEGAN, SLEMAN, DAERAH ISTIMEWA YOGYAKARTA",22,120,51,171
https://kawalpemilu.org#42250,"MARGOMULYO, SEYEGAN, SLEMAN, DAERAH ISTIMEWA YOGYAKARTA",23,165,53,218
https://kawalpemilu.org#42250,"MARGOMULYO, SEYEGAN, SLEMAN, DAERAH ISTIMEWA YOGYAKARTA",24,194,76,270
https://kawalpemilu.org#42250,"MARGOMULYO, SEYEGAN, SLEMAN, DAERAH ISTIMEWA YOGYAKARTA",25,121,88,209
https://kawalpemilu.org#42250,"MARGOMULYO, SEYEGAN, SLEMAN, DAERAH ISTIMEWA YOGYAKARTA",26,152,45,197
https://kawalpemilu.org#42250,"MARGOMULYO, SEYEGAN, SLEMAN, DAERAH ISTIMEWA YOGYAKARTA",27,125,37,162
https://kawalpemilu.org#42250,"MARGOMULYO, SEYEGAN, SLEMAN, DAERAH ISTIMEWA YOGYAKARTA",28,143,100,243
https://kawalpemilu.org#42250,"MARGOMULYO, SEYEGAN, SLEMAN, DAERAH ISTIMEWA YOGYAKARTA",29,157,37,194
https://kawalpemilu.org#42250,"MARGOMULYO, SEYEGAN, SLEMAN, DAERAH ISTIMEWA YOGYAKARTA",30,141,19,160
https://kawalpemilu.org#42250,"MARGOMULYO, SEYEGAN, SLEMAN, DAERAH ISTIMEWA YOGYAKARTA",31,157,57,214
https://kawalpemilu.org#42250,"MARGOMULYO, SEYEGAN, SLEMAN, DAERAH ISTIMEWA YOGYAKARTA",32,116,71,187
https://kawalpemilu.org#42250,"MARGOMULYO, SEYEGAN, SLEMAN, DAERAH ISTIMEWA YOGYAKARTA",33,90,47,137
https://kawalpemilu.org#42250,"MARGOMULYO, SEYEGAN, SLEMAN, DAERAH ISTIMEWA YOGYAKARTA",34,111,56,167
https://kawalpemilu.org#42250,"MARGOMULYO, SEYEGAN, SLEMAN, DAERAH ISTIMEWA YOGYAKARTA",35,122,90,212
https://kawalpemilu.org#42250,"MARGOMULYO, SEYEGAN, SLEMAN, DAERAH ISTIMEWA YOGYAKARTA",36,180,75,255
https://kawalpemilu.org#42250,"MARGOMULYO, SEYEGAN, SLEMAN, DAERAH ISTIMEWA YOGYAKARTA",37,197,56,253
https://kawalpemilu.org#42250,"MARGOMULYO, SEYEGAN, SLEMAN, DAERAH ISTIMEWA YOGYAKARTA",38,106,98,204
https://kawalpemilu.org#42250,"MARGOMULYO, SEYEGAN, SLEMAN, DAERAH ISTIMEWA YOGYAKARTA",39,78,68,146
https://kawalpemilu.org#42251,"MARGOKATON, SEYEGAN, SLEMAN, DAERAH ISTIMEWA YOGYAKARTA",1,168,56,224
https://kawalpemilu.org#42251,"MARGOKATON, SEYEGAN, SLEMAN, DAERAH ISTIMEWA YOGYAKARTA",2,143,60,203
https://kawalpemilu.org#42251,"MARGOKATON, SEYEGAN, SLEMAN, DAERAH ISTIMEWA YOGYAKARTA",3,169,57,226
https://kawalpemilu.org#42251,"MARGOKATON, SEYEGAN, SLEMAN, DAERAH ISTIMEWA YOGYAKARTA",4,131,79,210
https://kawalpemilu.org#42251,"MARGOKATON, SEYEGAN, SLEMAN, DAERAH ISTIMEWA YOGYAKARTA",5,158,73,231
https://kawalpemilu.org#42251,"MARGOKATON, SEYEGAN, SLEMAN, DAERAH ISTIMEWA YOGYAKARTA",6,184,57,241
https://kawalpemilu.org#42251,"MARGOKATON, SEYEGAN, SLEMAN, DAERAH ISTIMEWA YOGYAKARTA",7,171,46,217
https://kawalpemilu.org#42251,"MARGOKATON, SEYEGAN, SLEMAN, DAERAH ISTIMEWA YOGYAKARTA",8,152,37,189
https://kawalpemilu.org#42251,"MARGOKATON, SEYEGAN, SLEMAN, DAERAH ISTIMEWA YOGYAKARTA",9,136,35,171
https://kawalpemilu.org#42251,"MARGOKATON, SEYEGAN, SLEMAN, DAERAH ISTIMEWA YOGYAKARTA",10,135,105,240
https://kawalpemilu.org#42251,"MARGOKATON, SEYEGAN, SLEMAN, DAERAH ISTIMEWA YOGYAKARTA",11,150,99,249
https://kawalpemilu.org#42251,"MARGOKATON, SEYEGAN, SLEMAN, DAERAH ISTIMEWA YOGYAKARTA",12,107,113,220
https://kawalpemilu.org#42251,"MARGOKATON, SEYEGAN, SLEMAN, DAERAH ISTIMEWA YOGYAKARTA",13,111,123,234
https://kawalpemilu.org#42251,"MARGOKATON, SEYEGAN, SLEMAN, DAERAH ISTIMEWA YOGYAKARTA",14,67,158,225
https://kawalpemilu.org#42251,"MARGOKATON, SEYEGAN, SLEMAN, DAERAH ISTIMEWA YOGYAKARTA",15,89,151,240
https://kawalpemilu.org#42251,"MARGOKATON, SEYEGAN, SLEMAN, DAERAH ISTIMEWA YOGYAKARTA",16,155,68,223
https://kawalpemilu.org#42251,"MARGOKATON, SEYEGAN, SLEMAN, DAERAH ISTIMEWA YOGYAKARTA",17,131,74,205
https://kawalpemilu.org#42251,"MARGOKATON, SEYEGAN, SLEMAN, DAERAH ISTIMEWA YOGYAKARTA",18,110,78,188
https://kawalpemilu.org#42251,"MARGOKATON, SEYEGAN, SLEMAN, DAERAH ISTIMEWA YOGYAKARTA",19,139,47,186
https://kawalpemilu.org#42251,"MARGOKATON, SEYEGAN, SLEMAN, DAERAH ISTIMEWA YOGYAKARTA",20,100,78,178
https://kawalpemilu.org#42251,"MARGOKATON, SEYEGAN, SLEMAN, DAERAH ISTIMEWA YOGYAKARTA",21,154,58,212
https://kawalpemilu.org#42251,"MARGOKATON, SEYEGAN, SLEMAN, DAERAH ISTIMEWA YOGYAKARTA",22,201,41,242
https://kawalpemilu.org#42251,"MARGOKATON, SEYEGAN, SLEMAN, DAERAH ISTIMEWA YOGYAKARTA",23,183,56,239
https://kawalpemilu.org#42251,"MARGOKATON, SEYEGAN, SLEMAN, DAERAH ISTIMEWA YOGYAKARTA",24,178,24,202
https://kawalpemilu.org#42251,"MARGOKATON, SEYEGAN, SLEMAN, DAERAH ISTIMEWA YOGYAKARTA",25,125,39,164
https://kawalpemilu.org#42252,"MARGOAGUNG, SEYEGAN, SLEMAN, DAERAH ISTIMEWA YOGYAKARTA",1,135,49,184
https://kawalpemilu.org#42252,"MARGOAGUNG, SEYEGAN, SLEMAN, DAERAH ISTIMEWA YOGYAKARTA",2,118,66,184
https://kawalpemilu.org#42252,"MARGOAGUNG, SEYEGAN, SLEMAN, DAERAH ISTIMEWA YOGYAKARTA",3,127,51,178
https://kawalpemilu.org#42252,"MARGOAGUNG, SEYEGAN, SLEMAN, DAERAH ISTIMEWA YOGYAKARTA",4,163,38,201
https://kawalpemilu.org#42252,"MARGOAGUNG, SEYEGAN, SLEMAN, DAERAH ISTIMEWA YOGYAKARTA",5,159,46,205
https://kawalpemilu.org#42252,"MARGOAGUNG, SEYEGAN, SLEMAN, DAERAH ISTIMEWA YOGYAKARTA",6,165,38,203
https://kawalpemilu.org#42252,"MARGOAGUNG, SEYEGAN, SLEMAN, DAERAH ISTIMEWA YOGYAKARTA",7,142,33,175
https://kawalpemilu.org#42252,"MARGOAGUNG, SEYEGAN, SLEMAN, DAERAH ISTIMEWA YOGYAKARTA",8,131,53,184
https://kawalpemilu.org#42252,"MARGOAGUNG, SEYEGAN, SLEMAN, DAERAH ISTIMEWA YOGYAKARTA",9,144,62,206
https://kawalpemilu.org#42252,"MARGOAGUNG, SEYEGAN, SLEMAN, DAERAH ISTIMEWA YOGYAKARTA",10,152,47,199
https://kawalpemilu.org#42252,"MARGOAGUNG, SEYEGAN, SLEMAN, DAERAH ISTIMEWA YOGYAKARTA",11,142,74,216
https://kawalpemilu.org#42252,"MARGOAGUNG, SEYEGAN, SLEMAN, DAERAH ISTIMEWA YOGYAKARTA",12,156,52,208
https://kawalpemilu.org#42252,"MARGOAGUNG, SEYEGAN, SLEMAN, DAERAH ISTIMEWA YOGYAKARTA",13,158,50,208
https://kawalpemilu.org#42252,"MARGOAGUNG, SEYEGAN, SLEMAN, DAERAH ISTIMEWA YOGYAKARTA",14,194,54,248
https://kawalpemilu.org#42252,"MARGOAGUNG, SEYEGAN, SLEMAN, DAERAH ISTIMEWA YOGYAKARTA",15,135,123,258
https://kawalpemilu.org#42252,"MARGOAGUNG, SEYEGAN, SLEMAN, DAERAH ISTIMEWA YOGYAKARTA",16,215,48,263
https://kawalpemilu.org#42252,"MARGOAGUNG, SEYEGAN, SLEMAN, DAERAH ISTIMEWA YOGYAKARTA",17,188,65,253
https://kawalpemilu.org#42252,"MARGOAGUNG, SEYEGAN, SLEMAN, DAERAH ISTIMEWA YOGYAKARTA",18,177,80,257
https://kawalpemilu.org#42252,"MARGOAGUNG, SEYEGAN, SLEMAN, DAERAH ISTIMEWA YOGYAKARTA",19,117,67,184
https://kawalpemilu.org#42252,"MARGOAGUNG, SEYEGAN, SLEMAN, DAERAH ISTIMEWA YOGYAKARTA",20,147,28,175
https://kawalpemilu.org#42252,"MARGOAGUNG, SEYEGAN, SLEMAN, DAERAH ISTIMEWA YOGYAKARTA",21,140,55,195
https://kawalpemilu.org#42252,"MARGOAGUNG, SEYEGAN, SLEMAN, DAERAH ISTIMEWA YOGYAKARTA",22,160,26,186
https://kawalpemilu.org#42252,"MARGOAGUNG, SEYEGAN, SLEMAN, DAERAH ISTIMEWA YOGYAKARTA",23,170,69,239
https://kawalpemilu.org#42252,"MARGOAGUNG, SEYEGAN, SLEMAN, DAERAH ISTIMEWA YOGYAKARTA",24,156,61,217
https://kawalpemilu.org#42252,"MARGOAGUNG, SEYEGAN, SLEMAN, DAERAH ISTIMEWA YOGYAKARTA",25,184,45,229
https://kawalpemilu.org#42252,"MARGOAGUNG, SEYEGAN, SLEMAN, DAERAH ISTIMEWA YOGYAKARTA",26,144,42,186
https://kawalpemilu.org#42252,"MARGOAGUNG, SEYEGAN, SLEMAN, DAERAH ISTIMEWA YOGYAKARTA",27,131,51,182
https://kawalpemilu.org#42252,"MARGOAGUNG, SEYEGAN, SLEMAN, DAERAH ISTIMEWA YOGYAKARTA",28,179,61,240
https://kawalpemilu.org#42252,"MARGOAGUNG, SEYEGAN, SLEMAN, DAERAH ISTIMEWA YOGYAKARTA",29,166,61,227
https://kawalpemilu.org#42252,"MARGOAGUNG, SEYEGAN, SLEMAN, DAERAH ISTIMEWA YOGYAKARTA",30,154,84,238
https://kawalpemilu.org#42252,"MARGOAGUNG, SEYEGAN, SLEMAN, DAERAH ISTIMEWA YOGYAKARTA",31,146,24,170
https://kawalpemilu.org#42252,"MARGOAGUNG, SEYEGAN, SLEMAN, DAERAH ISTIMEWA YOGYAKARTA",32,155,28,183
https://kawalpemilu.org#42252,"MARGOAGUNG, SEYEGAN, SLEMAN, DAERAH ISTIMEWA YOGYAKARTA",33,135,49,184
https://kawalpemilu.org#42254,"SINDUADI, MLATI, SLEMAN, DAERAH ISTIMEWA YOGYAKARTA",1,131,56,187
https://kawalpemilu.org#42254,"SINDUADI, MLATI, SLEMAN, DAERAH ISTIMEWA YOGYAKARTA",2,165,63,228
https://kawalpemilu.org#42254,"SINDUADI, MLATI, SLEMAN, DAERAH ISTIMEWA YOGYAKARTA",3,133,104,237
https://kawalpemilu.org#42254,"SINDUADI, MLATI, SLEMAN, DAERAH ISTIMEWA YOGYAKARTA",4,147,92,239
https://kawalpemilu.org#42254,"SINDUADI, MLATI, SLEMAN, DAERAH ISTIMEWA YOGYAKARTA",5,150,92,242
https://kawalpemilu.org#42254,"SINDUADI, MLATI, SLEMAN, DAERAH ISTIMEWA YOGYAKARTA",6,140,82,222
https://kawalpemilu.org#42254,"SINDUADI, MLATI, SLEMAN, DAERAH ISTIMEWA YOGYAKARTA",7,201,76,277
https://kawalpemilu.org#42254,"SINDUADI, MLATI, SLEMAN, DAERAH ISTIMEWA YOGYAKARTA",8,203,65,268
https://kawalpemilu.org#42254,"SINDUADI, MLATI, SLEMAN, DAERAH ISTIMEWA YOGYAKARTA",9,102,25,127
https://kawalpemilu.org#42254,"SINDUADI, MLATI, SLEMAN, DAERAH ISTIMEWA YOGYAKARTA",10,184,58,242
https://kawalpemilu.org#42254,"SINDUADI, MLATI, SLEMAN, DAERAH ISTIMEWA YOGYAKARTA",11,160,70,230
https://kawalpemilu.org#42254,"SINDUADI, MLATI, SLEMAN, DAERAH ISTIMEWA YOGYAKARTA",12,165,54,219
https://kawalpemilu.org#42254,"SINDUADI, MLATI, SLEMAN, DAERAH ISTIMEWA YOGYAKARTA",13,155,56,211
https://kawalpemilu.org#42254,"SINDUADI, MLATI, SLEMAN, DAERAH ISTIMEWA YOGYAKARTA",14,181,57,238
https://kawalpemilu.org#42254,"SINDUADI, MLATI, SLEMAN, DAERAH ISTIMEWA YOGYAKARTA",15,177,58,235
https://kawalpemilu.org#42254,"SINDUADI, MLATI, SLEMAN, DAERAH ISTIMEWA YOGYAKARTA",16,175,75,250
https://kawalpemilu.org#42254,"SINDUADI, MLATI, SLEMAN, DAERAH ISTIMEWA YOGYAKARTA",17,192,77,269
https://kawalpemilu.org#42254,"SINDUADI, MLATI, SLEMAN, DAERAH ISTIMEWA YOGYAKARTA",18,150,45,195
https://kawalpemilu.org#42254,"SINDUADI, MLATI, SLEMAN, DAERAH ISTIMEWA YOGYAKARTA",19,132,129,261
https://kawalpemilu.org#42254,"SINDUADI, MLATI, SLEMAN, DAERAH ISTIMEWA YOGYAKARTA",20,140,69,209
https://kawalpemilu.org#42254,"SINDUADI, MLATI, SLEMAN, DAERAH ISTIMEWA YOGYAKARTA",21,157,87,244
https://kawalpemilu.org#42254,"SINDUADI, MLATI, SLEMAN, DAERAH ISTIMEWA YOGYAKARTA",22,109,90,199
https://kawalpemilu.org#42254,"SINDUADI, MLATI, SLEMAN, DAERAH ISTIMEWA YOGYAKARTA",23,136,68,204
https://kawalpemilu.org#42254,"SINDUADI, MLATI, SLEMAN, DAERAH ISTIMEWA YOGYAKARTA",24,120,72,192
https://kawalpemilu.org#42254,"SINDUADI, MLATI, SLEMAN, DAERAH ISTIMEWA YOGYAKARTA",25,134,76,210
https://kawalpemilu.org#42254,"SINDUADI, MLATI, SLEMAN, DAERAH ISTIMEWA YOGYAKARTA",26,125,69,194
https://kawalpemilu.org#42254,"SINDUADI, MLATI, SLEMAN, DAERAH ISTIMEWA YOGYAKARTA",27,132,87,219
https://kawalpemilu.org#42254,"SINDUADI, MLATI, SLEMAN, DAERAH ISTIMEWA YOGYAKARTA",28,141,47,188
https://kawalpemilu.org#42254,"SINDUADI, MLATI, SLEMAN, DAERAH ISTIMEWA YOGYAKARTA",29,142,60,202
https://kawalpemilu.org#42254,"SINDUADI, MLATI, SLEMAN, DAERAH ISTIMEWA YOGYAKARTA",30,148,46,194
https://kawalpemilu.org#42254,"SINDUADI, MLATI, SLEMAN, DAERAH ISTIMEWA YOGYAKARTA",31,163,81,244
https://kawalpemilu.org#42254,"SINDUADI, MLATI, SLEMAN, DAERAH ISTIMEWA YOGYAKARTA",32,205,78,283
https://kawalpemilu.org#42254,"SINDUADI, MLATI, SLEMAN, DAERAH ISTIMEWA YOGYAKARTA",33,204,49,253
https://kawalpemilu.org#42254,"SINDUADI, MLATI, SLEMAN, DAERAH ISTIMEWA YOGYAKARTA",34,112,78,190
https://kawalpemilu.org#42254,"SINDUADI, MLATI, SLEMAN, DAERAH ISTIMEWA YOGYAKARTA",35,111,68,179
https://kawalpemilu.org#42254,"SINDUADI, MLATI, SLEMAN, DAERAH ISTIMEWA YOGYAKARTA",36,191,74,265
https://kawalpemilu.org#42254,"SINDUADI, MLATI, SLEMAN, DAERAH ISTIMEWA YOGYAKARTA",37,175,73,248
https://kawalpemilu.org#42254,"SINDUADI, MLATI, SLEMAN, DAERAH ISTIMEWA YOGYAKARTA",38,195,60,255
https://kawalpemilu.org#42254,"SINDUADI, MLATI, SLEMAN, DAERAH ISTIMEWA YOGYAKARTA",39,167,46,213
https://kawalpemilu.org#42254,"SINDUADI, MLATI, SLEMAN, DAERAH ISTIMEWA YOGYAKARTA",40,180,65,245
https://kawalpemilu.org#42254,"SINDUADI, MLATI, SLEMAN, DAERAH ISTIMEWA YOGYAKARTA",41,143,42,185
https://kawalpemilu.org#42254,"SINDUADI, MLATI, SLEMAN, DAERAH ISTIMEWA YOGYAKARTA",42,135,66,201
https://kawalpemilu.org#42254,"SINDUADI, MLATI, SLEMAN, DAERAH ISTIMEWA YOGYAKARTA",43,162,67,229
https://kawalpemilu.org#42254,"SINDUADI, MLATI, SLEMAN, DAERAH ISTIMEWA YOGYAKARTA",44,175,55,230
https://kawalpemilu.org#42254,"SINDUADI, MLATI, SLEMAN, DAERAH ISTIMEWA YOGYAKARTA",45,137,73,210
https://kawalpemilu.org#42254,"SINDUADI, MLATI, SLEMAN, DAERAH ISTIMEWA YOGYAKARTA",46,148,65,213
https://kawalpemilu.org#42254,"SINDUADI, MLATI, SLEMAN, DAERAH ISTIMEWA YOGYAKARTA",47,125,94,219
https://kawalpemilu.org#42254,"SINDUADI, MLATI, SLEMAN, DAERAH ISTIMEWA YOGYAKARTA",48,111,43,154
https://kawalpemilu.org#42254,"SINDUADI, MLATI, SLEMAN, DAERAH ISTIMEWA YOGYAKARTA",49,124,85,209
https://kawalpemilu.org#42254,"SINDUADI, MLATI, SLEMAN, DAERAH ISTIMEWA YOGYAKARTA",50,171,92,263
https://kawalpemilu.org#42254,"SINDUADI, MLATI, SLEMAN, DAERAH ISTIMEWA YOGYAKARTA",51,129,69,198
https://kawalpemilu.org#42254,"SINDUADI, MLATI, SLEMAN, DAERAH ISTIMEWA YOGYAKARTA",52,186,94,280
https://kawalpemilu.org#42254,"SINDUADI, MLATI, SLEMAN, DAERAH ISTIMEWA YOGYAKARTA",53,90,50,140
https://kawalpemilu.org#42254,"SINDUADI, MLATI, SLEMAN, DAERAH ISTIMEWA YOGYAKARTA",54,205,64,269
https://kawalpemilu.org#42254,"SINDUADI, MLATI, SLEMAN, DAERAH ISTIMEWA YOGYAKARTA",55,118,65,183
https://kawalpemilu.org#42254,"SINDUADI, MLATI, SLEMAN, DAERAH ISTIMEWA YOGYAKARTA",56,153,56,209
https://kawalpemilu.org#42254,"SINDUADI, MLATI, SLEMAN, DAERAH ISTIMEWA YOGYAKARTA",57,91,84,175
https://kawalpemilu.org#42254,"SINDUADI, MLATI, SLEMAN, DAERAH ISTIMEWA YOGYAKARTA",58,138,89,227
https://kawalpemilu.org#42254,"SINDUADI, MLATI, SLEMAN, DAERAH ISTIMEWA YOGYAKARTA",59,124,60,184
https://kawalpemilu.org#42254,"SINDUADI, MLATI, SLEMAN, DAERAH ISTIMEWA YOGYAKARTA",60,146,62,208
https://kawalpemilu.org#42254,"SINDUADI, MLATI, SLEMAN, DAERAH ISTIMEWA YOGYAKARTA",61,174,89,263
https://kawalpemilu.org#42254,"SINDUADI, MLATI, SLEMAN, DAERAH ISTIMEWA YOGYAKARTA",62,129,56,185
https://kawalpemilu.org#42254,"SINDUADI, MLATI, SLEMAN, DAERAH ISTIMEWA YOGYAKARTA",63,143,84,227
https://kawalpemilu.org#42254,"SINDUADI, MLATI, SLEMAN, DAERAH ISTIMEWA YOGYAKARTA",64,159,77,236
https://kawalpemilu.org#42254,"SINDUADI, MLATI, SLEMAN, DAERAH ISTIMEWA YOGYAKARTA",65,200,82,282
https://kawalpemilu.org#42254,"SINDUADI, MLATI, SLEMAN, DAERAH ISTIMEWA YOGYAKARTA",66,181,49,230
https://kawalpemilu.org#42254,"SINDUADI, MLATI, SLEMAN, DAERAH ISTIMEWA YOGYAKARTA",67,190,23,213
https://kawalpemilu.org#42254,"SINDUADI, MLATI, SLEMAN, DAERAH ISTIMEWA YOGYAKARTA",68,141,41,182
https://kawalpemilu.org#42254,"SINDUADI, MLATI, SLEMAN, DAERAH ISTIMEWA YOGYAKARTA",69,137,44,181
https://kawalpemilu.org#42254,"SINDUADI, MLATI, SLEMAN, DAERAH ISTIMEWA YOGYAKARTA",70,171,17,188
https://kawalpemilu.org#42254,"SINDUADI, MLATI, SLEMAN, DAERAH ISTIMEWA YOGYAKARTA",71,125,43,168
https://kawalpemilu.org#42254,"SINDUADI, MLATI, SLEMAN, DAERAH ISTIMEWA YOGYAKARTA",72,169,63,232
https://kawalpemilu.org#42254,"SINDUADI, MLATI, SLEMAN, DAERAH ISTIMEWA YOGYAKARTA",73,160,64,224
https://kawalpemilu.org#42254,"SINDUADI, MLATI, SLEMAN, DAERAH ISTIMEWA YOGYAKARTA",74,114,100,214
https://kawalpemilu.org#42254,"SINDUADI, MLATI, SLEMAN, DAERAH ISTIMEWA YOGYAKARTA",75,136,81,217
https://kawalpemilu.org#42254,"SINDUADI, MLATI, SLEMAN, DAERAH ISTIMEWA YOGYAKARTA",76,123,63,186
https://kawalpemilu.org#42254,"SINDUADI, MLATI, SLEMAN, DAERAH ISTIMEWA YOGYAKARTA",77,165,73,238
https://kawalpemilu.org#42254,"SINDUADI, MLATI, SLEMAN, DAERAH ISTIMEWA YOGYAKARTA",78,101,111,212
https://kawalpemilu.org#42254,"SINDUADI, MLATI, SLEMAN, DAERAH ISTIMEWA YOGYAKARTA",79,126,66,192
https://kawalpemilu.org#42254,"SINDUADI, MLATI, SLEMAN, DAERAH ISTIMEWA YOGYAKARTA",80,171,98,269
https://kawalpemilu.org#42254,"SINDUADI, MLATI, SLEMAN, DAERAH ISTIMEWA YOGYAKARTA",81,94,44,138
https://kawalpemilu.org#42254,"SINDUADI, MLATI, SLEMAN, DAERAH ISTIMEWA YOGYAKARTA",82,196,75,271
https://kawalpemilu.org#42254,"SINDUADI, MLATI, SLEMAN, DAERAH ISTIMEWA YOGYAKARTA",83,133,69,202
https://kawalpemilu.org#42254,"SINDUADI, MLATI, SLEMAN, DAERAH ISTIMEWA YOGYAKARTA",84,154,52,206
https://kawalpemilu.org#42254,"SINDUADI, MLATI, SLEMAN, DAERAH ISTIMEWA YOGYAKARTA",85,155,52,207
https://kawalpemilu.org#42254,"SINDUADI, MLATI, SLEMAN, DAERAH ISTIMEWA YOGYAKARTA",86,118,60,178
https://kawalpemilu.org#42254,"SINDUADI, MLATI, SLEMAN, DAERAH ISTIMEWA YOGYAKARTA",87,128,82,210
https://kawalpemilu.org#42254,"SINDUADI, MLATI, SLEMAN, DAERAH ISTIMEWA YOGYAKARTA",88,141,66,207
https://kawalpemilu.org#42254,"SINDUADI, MLATI, SLEMAN, DAERAH ISTIMEWA YOGYAKARTA",89,173,67,240
https://kawalpemilu.org#42254,"SINDUADI, MLATI, SLEMAN, DAERAH ISTIMEWA YOGYAKARTA",90,134,111,245
https://kawalpemilu.org#42254,"SINDUADI, MLATI, SLEMAN, DAERAH ISTIMEWA YOGYAKARTA",91,146,39,185
https://kawalpemilu.org#42254,"SINDUADI, MLATI, SLEMAN, DAERAH ISTIMEWA YOGYAKARTA",92,159,69,228
https://kawalpemilu.org#42254,"SINDUADI, MLATI, SLEMAN, DAERAH ISTIMEWA YOGYAKARTA",93,168,65,233
https://kawalpemilu.org#42254,"SINDUADI, MLATI, SLEMAN, DAERAH ISTIMEWA YOGYAKARTA",94,199,79,278
https://kawalpemilu.org#42254,"SINDUADI, MLATI, SLEMAN, DAERAH ISTIMEWA YOGYAKARTA",95,132,85,217
https://kawalpemilu.org#42254,"SINDUADI, MLATI, SLEMAN, DAERAH ISTIMEWA YOGYAKARTA",96,133,106,239
https://kawalpemilu.org#42254,"SINDUADI, MLATI, SLEMAN, DAERAH ISTIMEWA YOGYAKARTA",97,146,76,222
https://kawalpemilu.org#42254,"SINDUADI, MLATI, SLEMAN, DAERAH ISTIMEWA YOGYAKARTA",98,161,97,258
https://kawalpemilu.org#42254,"SINDUADI, MLATI, SLEMAN, DAERAH ISTIMEWA YOGYAKARTA",99,166,93,259
https://kawalpemilu.org#42254,"SINDUADI, MLATI, SLEMAN, DAERAH ISTIMEWA YOGYAKARTA",100,168,59,227
https://kawalpemilu.org#42254,"SINDUADI, MLATI, SLEMAN, DAERAH ISTIMEWA YOGYAKARTA",101,122,62,184
https://kawalpemilu.org#42254,"SINDUADI, MLATI, SLEMAN, DAERAH ISTIMEWA YOGYAKARTA",102,139,76,215
https://kawalpemilu.org#42254,"SINDUADI, MLATI, SLEMAN, DAERAH ISTIMEWA YOGYAKARTA",103,0,0,222
https://kawalpemilu.org#42254,"SINDUADI, MLATI, SLEMAN, DAERAH ISTIMEWA YOGYAKARTA",104,107,80,187
https://kawalpemilu.org#42254,"SINDUADI, MLATI, SLEMAN, DAERAH ISTIMEWA YOGYAKARTA",105,117,67,193
https://kawalpemilu.org#42254,"SINDUADI, MLATI, SLEMAN, DAERAH ISTIMEWA YOGYAKARTA",106,104,89,193
https://kawalpemilu.org#42254,"SINDUADI, MLATI, SLEMAN, DAERAH ISTIMEWA YOGYAKARTA",107,107,54,161
https://kawalpemilu.org#42254,"SINDUADI, MLATI, SLEMAN, DAERAH ISTIMEWA YOGYAKARTA",108,102,91,193
https://kawalpemilu.org#42254,"SINDUADI, MLATI, SLEMAN, DAERAH ISTIMEWA YOGYAKARTA",109,104,95,199
https://kawalpemilu.org#42255,"SENDANGADI, MLATI, SLEMAN, DAERAH ISTIMEWA YOGYAKARTA",1,108,87,195
https://kawalpemilu.org#42255,"SENDANGADI, MLATI, SLEMAN, DAERAH ISTIMEWA YOGYAKARTA",2,125,84,209
https://kawalpemilu.org#42255,"SENDANGADI, MLATI, SLEMAN, DAERAH ISTIMEWA YOGYAKARTA",3,144,64,208
https://kawalpemilu.org#42255,"SENDANGADI, MLATI, SLEMAN, DAERAH ISTIMEWA YOGYAKARTA",4,159,53,212
https://kawalpemilu.org#42255,"SENDANGADI, MLATI, SLEMAN, DAERAH ISTIMEWA YOGYAKARTA",5,120,51,171
https://kawalpemilu.org#42255,"SENDANGADI, MLATI, SLEMAN, DAERAH ISTIMEWA YOGYAKARTA",6,90,37,127
https://kawalpemilu.org#42255,"SENDANGADI, MLATI, SLEMAN, DAERAH ISTIMEWA YOGYAKARTA",7,132,53,185
https://kawalpemilu.org#42255,"SENDANGADI, MLATI, SLEMAN, DAERAH ISTIMEWA YOGYAKARTA",8,136,72,208
https://kawalpemilu.org#42255,"SENDANGADI, MLATI, SLEMAN, DAERAH ISTIMEWA YOGYAKARTA",9,188,80,268
https://kawalpemilu.org#42255,"SENDANGADI, MLATI, SLEMAN, DAERAH ISTIMEWA YOGYAKARTA",10,166,81,247
https://kawalpemilu.org#42255,"SENDANGADI, MLATI, SLEMAN, DAERAH ISTIMEWA YOGYAKARTA",11,130,95,225
https://kawalpemilu.org#42255,"SENDANGADI, MLATI, SLEMAN, DAERAH ISTIMEWA YOGYAKARTA",12,170,78,248
https://kawalpemilu.org#42255,"SENDANGADI, MLATI, SLEMAN, DAERAH ISTIMEWA YOGYAKARTA",13,163,75,238
https://kawalpemilu.org#42255,"SENDANGADI, MLATI, SLEMAN, DAERAH ISTIMEWA YOGYAKARTA",14,190,73,263
https://kawalpemilu.org#42255,"SENDANGADI, MLATI, SLEMAN, DAERAH ISTIMEWA YOGYAKARTA",15,229,48,277
https://kawalpemilu.org#42255,"SENDANGADI, MLATI, SLEMAN, DAERAH ISTIMEWA YOGYAKARTA",16,187,65,252
https://kawalpemilu.org#42255,"SENDANGADI, MLATI, SLEMAN, DAERAH ISTIMEWA YOGYAKARTA",17,160,101,261
https://kawalpemilu.org#42255,"SENDANGADI, MLATI, SLEMAN, DAERAH ISTIMEWA YOGYAKARTA",18,163,53,216
https://kawalpemilu.org#42255,"SENDANGADI, MLATI, SLEMAN, DAERAH ISTIMEWA YOGYAKARTA",19,108,66,174
https://kawalpemilu.org#42255,"SENDANGADI, MLATI, SLEMAN, DAERAH ISTIMEWA YOGYAKARTA",20,106,64,170
https://kawalpemilu.org#42255,"SENDANGADI, MLATI, SLEMAN, DAERAH ISTIMEWA YOGYAKARTA",21,209,32,241
https://kawalpemilu.org#42255,"SENDANGADI, MLATI, SLEMAN, DAERAH ISTIMEWA YOGYAKARTA",22,163,59,222
https://kawalpemilu.org#42255,"SENDANGADI, MLATI, SLEMAN, DAERAH ISTIMEWA YOGYAKARTA",23,155,115,270
https://kawalpemilu.org#42255,"SENDANGADI, MLATI, SLEMAN, DAERAH ISTIMEWA YOGYAKARTA",24,140,84,224
https://kawalpemilu.org#42255,"SENDANGADI, MLATI, SLEMAN, DAERAH ISTIMEWA YOGYAKARTA",25,191,70,261
https://kawalpemilu.org#42255,"SENDANGADI, MLATI, SLEMAN, DAERAH ISTIMEWA YOGYAKARTA",26,141,98,239
https://kawalpemilu.org#42255,"SENDANGADI, MLATI, SLEMAN, DAERAH ISTIMEWA YOGYAKARTA",27,103,44,147
https://kawalpemilu.org#42255,"SENDANGADI, MLATI, SLEMAN, DAERAH ISTIMEWA YOGYAKARTA",28,141,44,185
https://kawalpemilu.org#42255,"SENDANGADI, MLATI, SLEMAN, DAERAH ISTIMEWA YOGYAKARTA",29,181,56,237
https://kawalpemilu.org#42255,"SENDANGADI, MLATI, SLEMAN, DAERAH ISTIMEWA YOGYAKARTA",30,164,46,210
https://kawalpemilu.org#42255,"SENDANGADI, MLATI, SLEMAN, DAERAH ISTIMEWA YOGYAKARTA",31,127,84,211
https://kawalpemilu.org#42255,"SENDANGADI, MLATI, SLEMAN, DAERAH ISTIMEWA YOGYAKARTA",32,154,78,232
https://kawalpemilu.org#42255,"SENDANGADI, MLATI, SLEMAN, DAERAH ISTIMEWA YOGYAKARTA",33,206,69,275
https://kawalpemilu.org#42255,"SENDANGADI, MLATI, SLEMAN, DAERAH ISTIMEWA YOGYAKARTA",34,192,72,264
https://kawalpemilu.org#42255,"SENDANGADI, MLATI, SLEMAN, DAERAH ISTIMEWA YOGYAKARTA",35,134,69,203
https://kawalpemilu.org#42255,"SENDANGADI, MLATI, SLEMAN, DAERAH ISTIMEWA YOGYAKARTA",36,133,72,205
https://kawalpemilu.org#42255,"SENDANGADI, MLATI, SLEMAN, DAERAH ISTIMEWA YOGYAKARTA",37,153,86,239
https://kawalpemilu.org#42255,"SENDANGADI, MLATI, SLEMAN, DAERAH ISTIMEWA YOGYAKARTA",38,127,81,208
https://kawalpemilu.org#42255,"SENDANGADI, MLATI, SLEMAN, DAERAH ISTIMEWA YOGYAKARTA",39,132,107,239
https://kawalpemilu.org#42255,"SENDANGADI, MLATI, SLEMAN, DAERAH ISTIMEWA YOGYAKARTA",40,169,53,222
https://kawalpemilu.org#42255,"SENDANGADI, MLATI, SLEMAN, DAERAH ISTIMEWA YOGYAKARTA",41,104,128,232
https://kawalpemilu.org#42255,"SENDANGADI, MLATI, SLEMAN, DAERAH ISTIMEWA YOGYAKARTA",42,172,90,262
https://kawalpemilu.org#42255,"SENDANGADI, MLATI, SLEMAN, DAERAH ISTIMEWA YOGYAKARTA",43,154,67,221
https://kawalpemilu.org#42255,"SENDANGADI, MLATI, SLEMAN, DAERAH ISTIMEWA YOGYAKARTA",44,184,68,252
https://kawalpemilu.org#42255,"SENDANGADI, MLATI, SLEMAN, DAERAH ISTIMEWA YOGYAKARTA",45,171,50,221
https://kawalpemilu.org#42255,"SENDANGADI, MLATI, SLEMAN, DAERAH ISTIMEWA YOGYAKARTA",46,150,44,194
https://kawalpemilu.org#42255,"SENDANGADI, MLATI, SLEMAN, DAERAH ISTIMEWA YOGYAKARTA",47,142,61,203
https://kawalpemilu.org#42255,"SENDANGADI, MLATI, SLEMAN, DAERAH ISTIMEWA YOGYAKARTA",48,187,48,235
https://kawalpemilu.org#42255,"SENDANGADI, MLATI, SLEMAN, DAERAH ISTIMEWA YOGYAKARTA",49,191,61,252
https://kawalpemilu.org#42255,"SENDANGADI, MLATI, SLEMAN, DAERAH ISTIMEWA YOGYAKARTA",50,183,66,249
https://kawalpemilu.org#42255,"SENDANGADI, MLATI, SLEMAN, DAERAH ISTIMEWA YOGYAKARTA",51,176,76,252
https://kawalpemilu.org#42256,"TLOGOADI, MLATI, SLEMAN, DAERAH ISTIMEWA YOGYAKARTA",1,198,72,270
https://kawalpemilu.org#42256,"TLOGOADI, MLATI, SLEMAN, DAERAH ISTIMEWA YOGYAKARTA",2,153,93,246
https://kawalpemilu.org#42256,"TLOGOADI, MLATI, SLEMAN, DAERAH ISTIMEWA YOGYAKARTA",3,180,64,244
https://kawalpemilu.org#42256,"TLOGOADI, MLATI, SLEMAN, DAERAH ISTIMEWA YOGYAKARTA",4,127,99,226
https://kawalpemilu.org#42256,"TLOGOADI, MLATI, SLEMAN, DAERAH ISTIMEWA YOGYAKARTA",5,199,53,252
https://kawalpemilu.org#42256,"TLOGOADI, MLATI, SLEMAN, DAERAH ISTIMEWA YOGYAKARTA",6,164,83,247
https://kawalpemilu.org#42256,"TLOGOADI, MLATI, SLEMAN, DAERAH ISTIMEWA YOGYAKARTA",7,175,52,227
https://kawalpemilu.org#42256,"TLOGOADI, MLATI, SLEMAN, DAERAH ISTIMEWA YOGYAKARTA",8,181,72,253
https://kawalpemilu.org#42256,"TLOGOADI, MLATI, SLEMAN, DAERAH ISTIMEWA YOGYAKARTA",9,142,111,253
https://kawalpemilu.org#42256,"TLOGOADI, MLATI, SLEMAN, DAERAH ISTIMEWA YOGYAKARTA",10,188,81,269
https://kawalpemilu.org#42256,"TLOGOADI, MLATI, SLEMAN, DAERAH ISTIMEWA YOGYAKARTA",11,171,91,262
https://kawalpemilu.org#42256,"TLOGOADI, MLATI, SLEMAN, DAERAH ISTIMEWA YOGYAKARTA",12,197,77,274
https://kawalpemilu.org#42256,"TLOGOADI, MLATI, SLEMAN, DAERAH ISTIMEWA YOGYAKARTA",13,178,32,210
https://kawalpemilu.org#42256,"TLOGOADI, MLATI, SLEMAN, DAERAH ISTIMEWA YOGYAKARTA",14,164,35,199
https://kawalpemilu.org#42256,"TLOGOADI, MLATI, SLEMAN, DAERAH ISTIMEWA YOGYAKARTA",15,174,34,211
https://kawalpemilu.org#42256,"TLOGOADI, MLATI, SLEMAN, DAERAH ISTIMEWA YOGYAKARTA",16,171,55,226
https://kawalpemilu.org#42256,"TLOGOADI, MLATI, SLEMAN, DAERAH ISTIMEWA YOGYAKARTA",17,158,55,213
https://kawalpemilu.org#42256,"TLOGOADI, MLATI, SLEMAN, DAERAH ISTIMEWA YOGYAKARTA",18,170,64,234
https://kawalpemilu.org#42256,"TLOGOADI, MLATI, SLEMAN, DAERAH ISTIMEWA YOGYAKARTA",19,150,92,242
https://kawalpemilu.org#42256,"TLOGOADI, MLATI, SLEMAN, DAERAH ISTIMEWA YOGYAKARTA",20,84,37,121
https://kawalpemilu.org#42256,"TLOGOADI, MLATI, SLEMAN, DAERAH ISTIMEWA YOGYAKARTA",21,166,66,232
https://kawalpemilu.org#42256,"TLOGOADI, MLATI, SLEMAN, DAERAH ISTIMEWA YOGYAKARTA",22,160,77,237
https://kawalpemilu.org#42256,"TLOGOADI, MLATI, SLEMAN, DAERAH ISTIMEWA YOGYAKARTA",23,149,34,183
https://kawalpemilu.org#42256,"TLOGOADI, MLATI, SLEMAN, DAERAH ISTIMEWA YOGYAKARTA",24,168,50,218
https://kawalpemilu.org#42256,"TLOGOADI, MLATI, SLEMAN, DAERAH ISTIMEWA YOGYAKARTA",25,139,49,188
https://kawalpemilu.org#42256,"TLOGOADI, MLATI, SLEMAN, DAERAH ISTIMEWA YOGYAKARTA",26,182,57,239
https://kawalpemilu.org#42256,"TLOGOADI, MLATI, SLEMAN, DAERAH ISTIMEWA YOGYAKARTA",27,165,49,214
https://kawalpemilu.org#42256,"TLOGOADI, MLATI, SLEMAN, DAERAH ISTIMEWA YOGYAKARTA",28,131,81,212
https://kawalpemilu.org#42256,"TLOGOADI, MLATI, SLEMAN, DAERAH ISTIMEWA YOGYAKARTA",29,163,42,205
https://kawalpemilu.org#42256,"TLOGOADI, MLATI, SLEMAN, DAERAH ISTIMEWA YOGYAKARTA",30,133,34,167
https://kawalpemilu.org#42256,"TLOGOADI, MLATI, SLEMAN, DAERAH ISTIMEWA YOGYAKARTA",31,149,32,181
https://kawalpemilu.org#42256,"TLOGOADI, MLATI, SLEMAN, DAERAH ISTIMEWA YOGYAKARTA",32,122,84,206
https://kawalpemilu.org#42256,"TLOGOADI, MLATI, SLEMAN, DAERAH ISTIMEWA YOGYAKARTA",33,187,67,254
https://kawalpemilu.org#42256,"TLOGOADI, MLATI, SLEMAN, DAERAH ISTIMEWA YOGYAKARTA",34,141,137,278
https://kawalpemilu.org#42256,"TLOGOADI, MLATI, SLEMAN, DAERAH ISTIMEWA YOGYAKARTA",35,202,39,241
https://kawalpemilu.org#42256,"TLOGOADI, MLATI, SLEMAN, DAERAH ISTIMEWA YOGYAKARTA",36,178,81,259
https://kawalpemilu.org#42256,"TLOGOADI, MLATI, SLEMAN, DAERAH ISTIMEWA YOGYAKARTA",37,156,89,245
https://kawalpemilu.org#42256,"TLOGOADI, MLATI, SLEMAN, DAERAH ISTIMEWA YOGYAKARTA",38,153,114,267
https://kawalpemilu.org#42257,"TIRTOADI, MLATI, SLEMAN, DAERAH ISTIMEWA YOGYAKARTA",1,167,107,274
https://kawalpemilu.org#42257,"TIRTOADI, MLATI, SLEMAN, DAERAH ISTIMEWA YOGYAKARTA",2,155,82,237
https://kawalpemilu.org#42257,"TIRTOADI, MLATI, SLEMAN, DAERAH ISTIMEWA YOGYAKARTA",3,118,119,237
https://kawalpemilu.org#42257,"TIRTOADI, MLATI, SLEMAN, DAERAH ISTIMEWA YOGYAKARTA",4,162,112,274
https://kawalpemilu.org#42257,"TIRTOADI, MLATI, SLEMAN, DAERAH ISTIMEWA YOGYAKARTA",5,149,89,238
https://kawalpemilu.org#42257,"TIRTOADI, MLATI, SLEMAN, DAERAH ISTIMEWA YOGYAKARTA",6,133,83,216
https://kawalpemilu.org#42257,"TIRTOADI, MLATI, SLEMAN, DAERAH ISTIMEWA YOGYAKARTA",7,162,78,240
https://kawalpemilu.org#42257,"TIRTOADI, MLATI, SLEMAN, DAERAH ISTIMEWA YOGYAKARTA",8,155,62,217
https://kawalpemilu.org#42257,"TIRTOADI, MLATI, SLEMAN, DAERAH ISTIMEWA YOGYAKARTA",9,125,59,184
https://kawalpemilu.org#42257,"TIRTOADI, MLATI, SLEMAN, DAERAH ISTIMEWA YOGYAKARTA",10,169,80,249
https://kawalpemilu.org#42257,"TIRTOADI, MLATI, SLEMAN, DAERAH ISTIMEWA YOGYAKARTA",11,182,85,267
https://kawalpemilu.org#42257,"TIRTOADI, MLATI, SLEMAN, DAERAH ISTIMEWA YOGYAKARTA",12,172,95,267
https://kawalpemilu.org#42257,"TIRTOADI, MLATI, SLEMAN, DAERAH ISTIMEWA YOGYAKARTA",13,149,99,248
https://kawalpemilu.org#42257,"TIRTOADI, MLATI, SLEMAN, DAERAH ISTIMEWA YOGYAKARTA",14,129,78,207
https://kawalpemilu.org#42257,"TIRTOADI, MLATI, SLEMAN, DAERAH ISTIMEWA YOGYAKARTA",15,141,102,243
https://kawalpemilu.org#42257,"TIRTOADI, MLATI, SLEMAN, DAERAH ISTIMEWA YOGYAKARTA",16,171,73,244
https://kawalpemilu.org#42257,"TIRTOADI, MLATI, SLEMAN, DAERAH ISTIMEWA YOGYAKARTA",17,120,62,182
https://kawalpemilu.org#42257,"TIRTOADI, MLATI, SLEMAN, DAERAH ISTIMEWA YOGYAKARTA",18,132,48,180
https://kawalpemilu.org#42257,"TIRTOADI, MLATI, SLEMAN, DAERAH ISTIMEWA YOGYAKARTA",19,136,48,184
https://kawalpemilu.org#42257,"TIRTOADI, MLATI, SLEMAN, DAERAH ISTIMEWA YOGYAKARTA",20,162,74,236
https://kawalpemilu.org#42257,"TIRTOADI, MLATI, SLEMAN, DAERAH ISTIMEWA YOGYAKARTA",21,187,59,246
https://kawalpemilu.org#42257,"TIRTOADI, MLATI, SLEMAN, DAERAH ISTIMEWA YOGYAKARTA",22,208,41,249
https://kawalpemilu.org#42257,"TIRTOADI, MLATI, SLEMAN, DAERAH ISTIMEWA YOGYAKARTA",23,151,88,239
https://kawalpemilu.org#42257,"TIRTOADI, MLATI, SLEMAN, DAERAH ISTIMEWA YOGYAKARTA",24,175,74,249
https://kawalpemilu.org#42257,"TIRTOADI, MLATI, SLEMAN, DAERAH ISTIMEWA YOGYAKARTA",25,154,65,219
https://kawalpemilu.org#42257,"TIRTOADI, MLATI, SLEMAN, DAERAH ISTIMEWA YOGYAKARTA",26,185,62,247
https://kawalpemilu.org#42257,"TIRTOADI, MLATI, SLEMAN, DAERAH ISTIMEWA YOGYAKARTA",28,165,29,194
https://kawalpemilu.org#42257,"TIRTOADI, MLATI, SLEMAN, DAERAH ISTIMEWA YOGYAKARTA",29,184,30,214
https://kawalpemilu.org#42257,"TIRTOADI, MLATI, SLEMAN, DAERAH ISTIMEWA YOGYAKARTA",30,151,49,200
https://kawalpemilu.org#42257,"TIRTOADI, MLATI, SLEMAN, DAERAH ISTIMEWA YOGYAKARTA",31,108,122,230
https://kawalpemilu.org#42258,"SUMBERADI, MLATI, SLEMAN, DAERAH ISTIMEWA YOGYAKARTA",1,170,98,268
https://kawalpemilu.org#42258,"SUMBERADI, MLATI, SLEMAN, DAERAH ISTIMEWA YOGYAKARTA",2,196,43,239
https://kawalpemilu.org#42258,"SUMBERADI, MLATI, SLEMAN, DAERAH ISTIMEWA YOGYAKARTA",3,162,55,217
https://kawalpemilu.org#42258,"SUMBERADI, MLATI, SLEMAN, DAERAH ISTIMEWA YOGYAKARTA",4,142,30,172
https://kawalpemilu.org#42258,"SUMBERADI, MLATI, SLEMAN, DAERAH ISTIMEWA YOGYAKARTA",5,217,28,245
https://kawalpemilu.org#42258,"SUMBERADI, MLATI, SLEMAN, DAERAH ISTIMEWA YOGYAKARTA",6,188,57,245
https://kawalpemilu.org#42258,"SUMBERADI, MLATI, SLEMAN, DAERAH ISTIMEWA YOGYAKARTA",7,166,58,224
https://kawalpemilu.org#42258,"SUMBERADI, MLATI, SLEMAN, DAERAH ISTIMEWA YOGYAKARTA",8,175,81,256
https://kawalpemilu.org#42258,"SUMBERADI, MLATI, SLEMAN, DAERAH ISTIMEWA YOGYAKARTA",9,194,58,252
https://kawalpemilu.org#42258,"SUMBERADI, MLATI, SLEMAN, DAERAH ISTIMEWA YOGYAKARTA",10,196,29,225
https://kawalpemilu.org#42258,"SUMBERADI, MLATI, SLEMAN, DAERAH ISTIMEWA YOGYAKARTA",11,174,39,213
https://kawalpemilu.org#42258,"SUMBERADI, MLATI, SLEMAN, DAERAH ISTIMEWA YOGYAKARTA",12,159,30,189
https://kawalpemilu.org#42258,"SUMBERADI, MLATI, SLEMAN, DAERAH ISTIMEWA YOGYAKARTA",13,142,98,240
https://kawalpemilu.org#42258,"SUMBERADI, MLATI, SLEMAN, DAERAH ISTIMEWA YOGYAKARTA",14,136,101,237
https://kawalpemilu.org#42258,"SUMBERADI, MLATI, SLEMAN, DAERAH ISTIMEWA YOGYAKARTA",15,176,58,232
https://kawalpemilu.org#42258,"SUMBERADI, MLATI, SLEMAN, DAERAH ISTIMEWA YOGYAKARTA",16,111,73,184
https://kawalpemilu.org#42258,"SUMBERADI, MLATI, SLEMAN, DAERAH ISTIMEWA YOGYAKARTA",17,178,45,223
https://kawalpemilu.org#42258,"SUMBERADI, MLATI, SLEMAN, DAERAH ISTIMEWA YOGYAKARTA",18,119,43,162
https://kawalpemilu.org#42258,"SUMBERADI, MLATI, SLEMAN, DAERAH ISTIMEWA YOGYAKARTA",19,136,85,221
https://kawalpemilu.org#42258,"SUMBERADI, MLATI, SLEMAN, DAERAH ISTIMEWA YOGYAKARTA",20,182,55,237
https://kawalpemilu.org#42258,"SUMBERADI, MLATI, SLEMAN, DAERAH ISTIMEWA YOGYAKARTA",21,209,52,261
https://kawalpemilu.org#42258,"SUMBERADI, MLATI, SLEMAN, DAERAH ISTIMEWA YOGYAKARTA",22,153,80,233
https://kawalpemilu.org#42258,"SUMBERADI, MLATI, SLEMAN, DAERAH ISTIMEWA YOGYAKARTA",23,165,66,231
https://kawalpemilu.org#42258,"SUMBERADI, MLATI, SLEMAN, DAERAH ISTIMEWA YOGYAKARTA",24,115,62,177
https://kawalpemilu.org#42258,"SUMBERADI, MLATI, SLEMAN, DAERAH ISTIMEWA YOGYAKARTA",25,159,74,233
https://kawalpemilu.org#42258,"SUMBERADI, MLATI, SLEMAN, DAERAH ISTIMEWA YOGYAKARTA",26,167,84,251
https://kawalpemilu.org#42258,"SUMBERADI, MLATI, SLEMAN, DAERAH ISTIMEWA YOGYAKARTA",27,169,54,223
https://kawalpemilu.org#42258,"SUMBERADI, MLATI, SLEMAN, DAERAH ISTIMEWA YOGYAKARTA",28,120,68,188
https://kawalpemilu.org#42258,"SUMBERADI, MLATI, SLEMAN, DAERAH ISTIMEWA YOGYAKARTA",29,180,73,253
https://kawalpemilu.org#42258,"SUMBERADI, MLATI, SLEMAN, DAERAH ISTIMEWA YOGYAKARTA",30,174,69,243
https://kawalpemilu.org#42258,"SUMBERADI, MLATI, SLEMAN, DAERAH ISTIMEWA YOGYAKARTA",31,94,68,162
https://kawalpemilu.org#42258,"SUMBERADI, MLATI, SLEMAN, DAERAH ISTIMEWA YOGYAKARTA",32,190,78,268
https://kawalpemilu.org#42258,"SUMBERADI, MLATI, SLEMAN, DAERAH ISTIMEWA YOGYAKARTA",33,212,39,251
https://kawalpemilu.org#42258,"SUMBERADI, MLATI, SLEMAN, DAERAH ISTIMEWA YOGYAKARTA",34,148,80,228
https://kawalpemilu.org#42258,"SUMBERADI, MLATI, SLEMAN, DAERAH ISTIMEWA YOGYAKARTA",35,147,70,217
https://kawalpemilu.org#42258,"SUMBERADI, MLATI, SLEMAN, DAERAH ISTIMEWA YOGYAKARTA",36,148,66,214
https://kawalpemilu.org#42258,"SUMBERADI, MLATI, SLEMAN, DAERAH ISTIMEWA YOGYAKARTA",37,126,58,184
https://kawalpemilu.org#42258,"SUMBERADI, MLATI, SLEMAN, DAERAH ISTIMEWA YOGYAKARTA",38,122,78,200
https://kawalpemilu.org#42258,"SUMBERADI, MLATI, SLEMAN, DAERAH ISTIMEWA YOGYAKARTA",39,127,64,191
https://kawalpemilu.org#42258,"SUMBERADI, MLATI, SLEMAN, DAERAH ISTIMEWA YOGYAKARTA",40,133,70,203
https://kawalpemilu.org#42258,"SUMBERADI, MLATI, SLEMAN, DAERAH ISTIMEWA YOGYAKARTA",41,162,55,217
https://kawalpemilu.org#42258,"SUMBERADI, MLATI, SLEMAN, DAERAH ISTIMEWA YOGYAKARTA",42,156,74,230
https://kawalpemilu.org#42258,"SUMBERADI, MLATI, SLEMAN, DAERAH ISTIMEWA YOGYAKARTA",43,191,69,260
https://kawalpemilu.org#42258,"SUMBERADI, MLATI, SLEMAN, DAERAH ISTIMEWA YOGYAKARTA",44,144,55,199
https://kawalpemilu.org#42258,"SUMBERADI, MLATI, SLEMAN, DAERAH ISTIMEWA YOGYAKARTA",45,183,58,241
https://kawalpemilu.org#42258,"SUMBERADI, MLATI, SLEMAN, DAERAH ISTIMEWA YOGYAKARTA",46,170,54,224
https://kawalpemilu.org#42258,"SUMBERADI, MLATI, SLEMAN, DAERAH ISTIMEWA YOGYAKARTA",47,80,79,159
https://kawalpemilu.org#42260,"CATURTUNGGAL, DEPOK, SLEMAN, DAERAH ISTIMEWA YOGYAKARTA",1,144,78,222
https://kawalpemilu.org#42260,"CATURTUNGGAL, DEPOK, SLEMAN, DAERAH ISTIMEWA YOGYAKARTA",2,166,56,222
https://kawalpemilu.org#42260,"CATURTUNGGAL, DEPOK, SLEMAN, DAERAH ISTIMEWA YOGYAKARTA",3,152,54,206
https://kawalpemilu.org#42260,"CATURTUNGGAL, DEPOK, SLEMAN, DAERAH ISTIMEWA YOGYAKARTA",4,187,76,263
https://kawalpemilu.org#42260,"CATURTUNGGAL, DEPOK, SLEMAN, DAERAH ISTIMEWA YOGYAKARTA",5,187,77,264
https://kawalpemilu.org#42260,"CATURTUNGGAL, DEPOK, SLEMAN, DAERAH ISTIMEWA YOGYAKARTA",6,158,65,223
https://kawalpemilu.org#42260,"CATURTUNGGAL, DEPOK, SLEMAN, DAERAH ISTIMEWA YOGYAKARTA",7,112,70,182
https://kawalpemilu.org#42260,"CATURTUNGGAL, DEPOK, SLEMAN, DAERAH ISTIMEWA YOGYAKARTA",8,178,113,291
https://kawalpemilu.org#42260,"CATURTUNGGAL, DEPOK, SLEMAN, DAERAH ISTIMEWA YOGYAKARTA",9,192,75,267
https://kawalpemilu.org#42260,"CATURTUNGGAL, DEPOK, SLEMAN, DAERAH ISTIMEWA YOGYAKARTA",10,163,75,238
https://kawalpemilu.org#42260,"CATURTUNGGAL, DEPOK, SLEMAN, DAERAH ISTIMEWA YOGYAKARTA",11,185,112,297
https://kawalpemilu.org#42260,"CATURTUNGGAL, DEPOK, SLEMAN, DAERAH ISTIMEWA YOGYAKARTA",12,112,95,207
https://kawalpemilu.org#42260,"CATURTUNGGAL, DEPOK, SLEMAN, DAERAH ISTIMEWA YOGYAKARTA",13,144,81,225
https://kawalpemilu.org#42260,"CATURTUNGGAL, DEPOK, SLEMAN, DAERAH ISTIMEWA YOGYAKARTA",14,175,73,248
https://kawalpemilu.org#42260,"CATURTUNGGAL, DEPOK, SLEMAN, DAERAH ISTIMEWA YOGYAKARTA",15,160,53,213
https://kawalpemilu.org#42260,"CATURTUNGGAL, DEPOK, SLEMAN, DAERAH ISTIMEWA YOGYAKARTA",16,192,49,241
https://kawalpemilu.org#42260,"CATURTUNGGAL, DEPOK, SLEMAN, DAERAH ISTIMEWA YOGYAKARTA",17,109,64,173
https://kawalpemilu.org#42260,"CATURTUNGGAL, DEPOK, SLEMAN, DAERAH ISTIMEWA YOGYAKARTA",18,122,76,198
https://kawalpemilu.org#42260,"CATURTUNGGAL, DEPOK, SLEMAN, DAERAH ISTIMEWA YOGYAKARTA",19,103,38,141
https://kawalpemilu.org#42260,"CATURTUNGGAL, DEPOK, SLEMAN, DAERAH ISTIMEWA YOGYAKARTA",20,106,31,137
https://kawalpemilu.org#42260,"CATURTUNGGAL, DEPOK, SLEMAN, DAERAH ISTIMEWA YOGYAKARTA",21,138,45,183
https://kawalpemilu.org#42260,"CATURTUNGGAL, DEPOK, SLEMAN, DAERAH ISTIMEWA YOGYAKARTA",22,190,59,249
https://kawalpemilu.org#42260,"CATURTUNGGAL, DEPOK, SLEMAN, DAERAH ISTIMEWA YOGYAKARTA",23,156,39,195
https://kawalpemilu.org#42260,"CATURTUNGGAL, DEPOK, SLEMAN, DAERAH ISTIMEWA YOGYAKARTA",24,175,59,234
https://kawalpemilu.org#42260,"CATURTUNGGAL, DEPOK, SLEMAN, DAERAH ISTIMEWA YOGYAKARTA",25,170,53,223
https://kawalpemilu.org#42260,"CATURTUNGGAL, DEPOK, SLEMAN, DAERAH ISTIMEWA YOGYAKARTA",26,209,82,291
https://kawalpemilu.org#42260,"CATURTUNGGAL, DEPOK, SLEMAN, DAERAH ISTIMEWA YOGYAKARTA",27,131,56,187
https://kawalpemilu.org#42260,"CATURTUNGGAL, DEPOK, SLEMAN, DAERAH ISTIMEWA YOGYAKARTA",28,160,73,233
https://kawalpemilu.org#42260,"CATURTUNGGAL, DEPOK, SLEMAN, DAERAH ISTIMEWA YOGYAKARTA",29,169,78,247
https://kawalpemilu.org#42260,"CATURTUNGGAL, DEPOK, SLEMAN, DAERAH ISTIMEWA YOGYAKARTA",30,157,72,229
https://kawalpemilu.org#42260,"CATURTUNGGAL, DEPOK, SLEMAN, DAERAH ISTIMEWA YOGYAKARTA",31,184,66,250
https://kawalpemilu.org#42260,"CATURTUNGGAL, DEPOK, SLEMAN, DAERAH ISTIMEWA YOGYAKARTA",32,132,82,214
https://kawalpemilu.org#42260,"CATURTUNGGAL, DEPOK, SLEMAN, DAERAH ISTIMEWA YOGYAKARTA",33,132,95,227
https://kawalpemilu.org#42260,"CATURTUNGGAL, DEPOK, SLEMAN, DAERAH ISTIMEWA YOGYAKARTA",34,138,82,220
https://kawalpemilu.org#42260,"CATURTUNGGAL, DEPOK, SLEMAN, DAERAH ISTIMEWA YOGYAKARTA",35,130,98,228
https://kawalpemilu.org#42260,"CATURTUNGGAL, DEPOK, SLEMAN, DAERAH ISTIMEWA YOGYAKARTA",36,152,70,222
https://kawalpemilu.org#42260,"CATURTUNGGAL, DEPOK, SLEMAN, DAERAH ISTIMEWA YOGYAKARTA",38,162,95,257
https://kawalpemilu.org#42260,"CATURTUNGGAL, DEPOK, SLEMAN, DAERAH ISTIMEWA YOGYAKARTA",39,131,100,231
https://kawalpemilu.org#42260,"CATURTUNGGAL, DEPOK, SLEMAN, DAERAH ISTIMEWA YOGYAKARTA",40,181,90,271
https://kawalpemilu.org#42260,"CATURTUNGGAL, DEPOK, SLEMAN, DAERAH ISTIMEWA YOGYAKARTA",41,204,62,266
https://kawalpemilu.org#42260,"CATURTUNGGAL, DEPOK, SLEMAN, DAERAH ISTIMEWA YOGYAKARTA",42,165,64,229
https://kawalpemilu.org#42260,"CATURTUNGGAL, DEPOK, SLEMAN, DAERAH ISTIMEWA YOGYAKARTA",43,63,42,105
https://kawalpemilu.org#42260,"CATURTUNGGAL, DEPOK, SLEMAN, DAERAH ISTIMEWA YOGYAKARTA",44,156,41,197
https://kawalpemilu.org#42260,"CATURTUNGGAL, DEPOK, SLEMAN, DAERAH ISTIMEWA YOGYAKARTA",45,174,36,210
https://kawalpemilu.org#42260,"CATURTUNGGAL, DEPOK, SLEMAN, DAERAH ISTIMEWA YOGYAKARTA",46,159,66,225
https://kawalpemilu.org#42260,"CATURTUNGGAL, DEPOK, SLEMAN, DAERAH ISTIMEWA YOGYAKARTA",47,195,98,293
https://kawalpemilu.org#42260,"CATURTUNGGAL, DEPOK, SLEMAN, DAERAH ISTIMEWA YOGYAKARTA",48,182,104,286
https://kawalpemilu.org#42260,"CATURTUNGGAL, DEPOK, SLEMAN, DAERAH ISTIMEWA YOGYAKARTA",49,130,66,196
https://kawalpemilu.org#42260,"CATURTUNGGAL, DEPOK, SLEMAN, DAERAH ISTIMEWA YOGYAKARTA",50,204,73,277
https://kawalpemilu.org#42260,"CATURTUNGGAL, DEPOK, SLEMAN, DAERAH ISTIMEWA YOGYAKARTA",51,187,34,221
https://kawalpemilu.org#42260,"CATURTUNGGAL, DEPOK, SLEMAN, DAERAH ISTIMEWA YOGYAKARTA",52,204,65,269
https://kawalpemilu.org#42260,"CATURTUNGGAL, DEPOK, SLEMAN, DAERAH ISTIMEWA YOGYAKARTA",53,149,32,181
https://kawalpemilu.org#42260,"CATURTUNGGAL, DEPOK, SLEMAN, DAERAH ISTIMEWA YOGYAKARTA",54,190,56,246
https://kawalpemilu.org#42260,"CATURTUNGGAL, DEPOK, SLEMAN, DAERAH ISTIMEWA YOGYAKARTA",55,173,58,231
https://kawalpemilu.org#42260,"CATURTUNGGAL, DEPOK, SLEMAN, DAERAH ISTIMEWA YOGYAKARTA",56,197,45,242
https://kawalpemilu.org#42260,"CATURTUNGGAL, DEPOK, SLEMAN, DAERAH ISTIMEWA YOGYAKARTA",57,182,73,255
https://kawalpemilu.org#42260,"CATURTUNGGAL, DEPOK, SLEMAN, DAERAH ISTIMEWA YOGYAKARTA",58,151,60,211
https://kawalpemilu.org#42260,"CATURTUNGGAL, DEPOK, SLEMAN, DAERAH ISTIMEWA YOGYAKARTA",59,181,59,240
https://kawalpemilu.org#42260,"CATURTUNGGAL, DEPOK, SLEMAN, DAERAH ISTIMEWA YOGYAKARTA",60,173,90,263
https://kawalpemilu.org#42260,"CATURTUNGGAL, DEPOK, SLEMAN, DAERAH ISTIMEWA YOGYAKARTA",61,94,109,203
https://kawalpemilu.org#42260,"CATURTUNGGAL, DEPOK, SLEMAN, DAERAH ISTIMEWA YOGYAKARTA",62,170,42,212
https://kawalpemilu.org#42260,"CATURTUNGGAL, DEPOK, SLEMAN, DAERAH ISTIMEWA YOGYAKARTA",63,191,56,247
https://kawalpemilu.org#42260,"CATURTUNGGAL, DEPOK, SLEMAN, DAERAH ISTIMEWA YOGYAKARTA",64,237,51,288
https://kawalpemilu.org#42260,"CATURTUNGGAL, DEPOK, SLEMAN, DAERAH ISTIMEWA YOGYAKARTA",65,129,75,204
https://kawalpemilu.org#42260,"CATURTUNGGAL, DEPOK, SLEMAN, DAERAH ISTIMEWA YOGYAKARTA",66,150,56,206
https://kawalpemilu.org#42260,"CATURTUNGGAL, DEPOK, SLEMAN, DAERAH ISTIMEWA YOGYAKARTA",67,152,44,196
https://kawalpemilu.org#42260,"CATURTUNGGAL, DEPOK, SLEMAN, DAERAH ISTIMEWA YOGYAKARTA",68,166,73,239
https://kawalpemilu.org#42260,"CATURTUNGGAL, DEPOK, SLEMAN, DAERAH ISTIMEWA YOGYAKARTA",69,176,45,221
https://kawalpemilu.org#42260,"CATURTUNGGAL, DEPOK, SLEMAN, DAERAH ISTIMEWA YOGYAKARTA",70,151,72,223
https://kawalpemilu.org#42260,"CATURTUNGGAL, DEPOK, SLEMAN, DAERAH ISTIMEWA YOGYAKARTA",71,150,56,206
https://kawalpemilu.org#42260,"CATURTUNGGAL, DEPOK, SLEMAN, DAERAH ISTIMEWA YOGYAKARTA",72,182,88,270
https://kawalpemilu.org#42260,"CATURTUNGGAL, DEPOK, SLEMAN, DAERAH ISTIMEWA YOGYAKARTA",73,171,56,227
https://kawalpemilu.org#42260,"CATURTUNGGAL, DEPOK, SLEMAN, DAERAH ISTIMEWA YOGYAKARTA",74,140,43,183
https://kawalpemilu.org#42260,"CATURTUNGGAL, DEPOK, SLEMAN, DAERAH ISTIMEWA YOGYAKARTA",75,160,66,226
https://kawalpemilu.org#42260,"CATURTUNGGAL, DEPOK, SLEMAN, DAERAH ISTIMEWA YOGYAKARTA",76,152,43,195
https://kawalpemilu.org#42260,"CATURTUNGGAL, DEPOK, SLEMAN, DAERAH ISTIMEWA YOGYAKARTA",77,109,62,171
https://kawalpemilu.org#42260,"CATURTUNGGAL, DEPOK, SLEMAN, DAERAH ISTIMEWA YOGYAKARTA",78,115,76,191
https://kawalpemilu.org#42260,"CATURTUNGGAL, DEPOK, SLEMAN, DAERAH ISTIMEWA YOGYAKARTA",79,164,68,232
https://kawalpemilu.org#42260,"CATURTUNGGAL, DEPOK, SLEMAN, DAERAH ISTIMEWA YOGYAKARTA",80,155,61,216
https://kawalpemilu.org#42260,"CATURTUNGGAL, DEPOK, SLEMAN, DAERAH ISTIMEWA YOGYAKARTA",81,165,63,228
https://kawalpemilu.org#42260,"CATURTUNGGAL, DEPOK, SLEMAN, DAERAH ISTIMEWA YOGYAKARTA",82,127,59,189
https://kawalpemilu.org#42260,"CATURTUNGGAL, DEPOK, SLEMAN, DAERAH ISTIMEWA YOGYAKARTA",83,135,46,181
https://kawalpemilu.org#42260,"CATURTUNGGAL, DEPOK, SLEMAN, DAERAH ISTIMEWA YOGYAKARTA",84,131,47,178
https://kawalpemilu.org#42260,"CATURTUNGGAL, DEPOK, SLEMAN, DAERAH ISTIMEWA YOGYAKARTA",85,154,77,231
https://kawalpemilu.org#42260,"CATURTUNGGAL, DEPOK, SLEMAN, DAERAH ISTIMEWA YOGYAKARTA",86,174,64,238
https://kawalpemilu.org#42260,"CATURTUNGGAL, DEPOK, SLEMAN, DAERAH ISTIMEWA YOGYAKARTA",87,170,71,241
https://kawalpemilu.org#42260,"CATURTUNGGAL, DEPOK, SLEMAN, DAERAH ISTIMEWA YOGYAKARTA",88,150,71,221
https://kawalpemilu.org#42260,"CATURTUNGGAL, DEPOK, SLEMAN, DAERAH ISTIMEWA YOGYAKARTA",89,184,64,248
https://kawalpemilu.org#42260,"CATURTUNGGAL, DEPOK, SLEMAN, DAERAH ISTIMEWA YOGYAKARTA",90,163,71,234
https://kawalpemilu.org#42260,"CATURTUNGGAL, DEPOK, SLEMAN, DAERAH ISTIMEWA YOGYAKARTA",91,162,69,231
https://kawalpemilu.org#42260,"CATURTUNGGAL, DEPOK, SLEMAN, DAERAH ISTIMEWA YOGYAKARTA",92,164,45,209
https://kawalpemilu.org#42260,"CATURTUNGGAL, DEPOK, SLEMAN, DAERAH ISTIMEWA YOGYAKARTA",93,192,81,273
https://kawalpemilu.org#42260,"CATURTUNGGAL, DEPOK, SLEMAN, DAERAH ISTIMEWA YOGYAKARTA",94,150,45,195
https://kawalpemilu.org#42260,"CATURTUNGGAL, DEPOK, SLEMAN, DAERAH ISTIMEWA YOGYAKARTA",95,164,51,215
https://kawalpemilu.org#42260,"CATURTUNGGAL, DEPOK, SLEMAN, DAERAH ISTIMEWA YOGYAKARTA",96,177,56,233
https://kawalpemilu.org#42260,"CATURTUNGGAL, DEPOK, SLEMAN, DAERAH ISTIMEWA YOGYAKARTA",97,195,46,241
https://kawalpemilu.org#42260,"CATURTUNGGAL, DEPOK, SLEMAN, DAERAH ISTIMEWA YOGYAKARTA",98,157,79,236
https://kawalpemilu.org#42260,"CATURTUNGGAL, DEPOK, SLEMAN, DAERAH ISTIMEWA YOGYAKARTA",99,176,55,231
https://kawalpemilu.org#42260,"CATURTUNGGAL, DEPOK, SLEMAN, DAERAH ISTIMEWA YOGYAKARTA",100,218,43,261
https://kawalpemilu.org#42260,"CATURTUNGGAL, DEPOK, SLEMAN, DAERAH ISTIMEWA YOGYAKARTA",101,185,50,235
https://kawalpemilu.org#42260,"CATURTUNGGAL, DEPOK, SLEMAN, DAERAH ISTIMEWA YOGYAKARTA",102,190,59,249
https://kawalpemilu.org#42260,"CATURTUNGGAL, DEPOK, SLEMAN, DAERAH ISTIMEWA YOGYAKARTA",103,195,53,248
https://kawalpemilu.org#42260,"CATURTUNGGAL, DEPOK, SLEMAN, DAERAH ISTIMEWA YOGYAKARTA",104,159,63,222
https://kawalpemilu.org#42260,"CATURTUNGGAL, DEPOK, SLEMAN, DAERAH ISTIMEWA YOGYAKARTA",105,191,54,245
https://kawalpemilu.org#42260,"CATURTUNGGAL, DEPOK, SLEMAN, DAERAH ISTIMEWA YOGYAKARTA",106,119,227,226
https://kawalpemilu.org#42260,"CATURTUNGGAL, DEPOK, SLEMAN, DAERAH ISTIMEWA YOGYAKARTA",107,165,51,216
https://kawalpemilu.org#42260,"CATURTUNGGAL, DEPOK, SLEMAN, DAERAH ISTIMEWA YOGYAKARTA",108,148,58,206
https://kawalpemilu.org#42260,"CATURTUNGGAL, DEPOK, SLEMAN, DAERAH ISTIMEWA YOGYAKARTA",109,132,81,213
https://kawalpemilu.org#42260,"CATURTUNGGAL, DEPOK, SLEMAN, DAERAH ISTIMEWA YOGYAKARTA",110,170,82,252
https://kawalpemilu.org#42260,"CATURTUNGGAL, DEPOK, SLEMAN, DAERAH ISTIMEWA YOGYAKARTA",111,140,48,188
https://kawalpemilu.org#42260,"CATURTUNGGAL, DEPOK, SLEMAN, DAERAH ISTIMEWA YOGYAKARTA",112,114,84,198
https://kawalpemilu.org#42260,"CATURTUNGGAL, DEPOK, SLEMAN, DAERAH ISTIMEWA YOGYAKARTA",113,147,78,225
https://kawalpemilu.org#42260,"CATURTUNGGAL, DEPOK, SLEMAN, DAERAH ISTIMEWA YOGYAKARTA",114,166,29,195
https://kawalpemilu.org#42260,"CATURTUNGGAL, DEPOK, SLEMAN, DAERAH ISTIMEWA YOGYAKARTA",115,144,43,187
https://kawalpemilu.org#42260,"CATURTUNGGAL, DEPOK, SLEMAN, DAERAH ISTIMEWA YOGYAKARTA",116,117,50,167
https://kawalpemilu.org#42260,"CATURTUNGGAL, DEPOK, SLEMAN, DAERAH ISTIMEWA YOGYAKARTA",117,156,60,216
https://kawalpemilu.org#42260,"CATURTUNGGAL, DEPOK, SLEMAN, DAERAH ISTIMEWA YOGYAKARTA",118,135,71,206
https://kawalpemilu.org#42260,"CATURTUNGGAL, DEPOK, SLEMAN, DAERAH ISTIMEWA YOGYAKARTA",119,196,61,257
https://kawalpemilu.org#42260,"CATURTUNGGAL, DEPOK, SLEMAN, DAERAH ISTIMEWA YOGYAKARTA",120,195,58,153
https://kawalpemilu.org#42260,"CATURTUNGGAL, DEPOK, SLEMAN, DAERAH ISTIMEWA YOGYAKARTA",121,182,63,245
https://kawalpemilu.org#42260,"CATURTUNGGAL, DEPOK, SLEMAN, DAERAH ISTIMEWA YOGYAKARTA",122,132,46,178
https://kawalpemilu.org#42260,"CATURTUNGGAL, DEPOK, SLEMAN, DAERAH ISTIMEWA YOGYAKARTA",123,137,81,218
https://kawalpemilu.org#42260,"CATURTUNGGAL, DEPOK, SLEMAN, DAERAH ISTIMEWA YOGYAKARTA",124,158,64,222
https://kawalpemilu.org#42260,"CATURTUNGGAL, DEPOK, SLEMAN, DAERAH ISTIMEWA YOGYAKARTA",125,132,47,179
https://kawalpemilu.org#42260,"CATURTUNGGAL, DEPOK, SLEMAN, DAERAH ISTIMEWA YOGYAKARTA",126,154,43,197
https://kawalpemilu.org#42260,"CATURTUNGGAL, DEPOK, SLEMAN, DAERAH ISTIMEWA YOGYAKARTA",127,142,51,193
https://kawalpemilu.org#42260,"CATURTUNGGAL, DEPOK, SLEMAN, DAERAH ISTIMEWA YOGYAKARTA",128,176,51,227
https://kawalpemilu.org#42260,"CATURTUNGGAL, DEPOK, SLEMAN, DAERAH ISTIMEWA YOGYAKARTA",130,185,46,231
https://kawalpemilu.org#42260,"CATURTUNGGAL, DEPOK, SLEMAN, DAERAH ISTIMEWA YOGYAKARTA",131,194,66,260
https://kawalpemilu.org#42260,"CATURTUNGGAL, DEPOK, SLEMAN, DAERAH ISTIMEWA YOGYAKARTA",132,146,40,186
https://kawalpemilu.org#42260,"CATURTUNGGAL, DEPOK, SLEMAN, DAERAH ISTIMEWA YOGYAKARTA",133,147,36,183
https://kawalpemilu.org#42260,"CATURTUNGGAL, DEPOK, SLEMAN, DAERAH ISTIMEWA YOGYAKARTA",134,148,79,227
https://kawalpemilu.org#42260,"CATURTUNGGAL, DEPOK, SLEMAN, DAERAH ISTIMEWA YOGYAKARTA",135,149,73,222
https://kawalpemilu.org#42260,"CATURTUNGGAL, DEPOK, SLEMAN, DAERAH ISTIMEWA YOGYAKARTA",136,149,62,211
https://kawalpemilu.org#42260,"CATURTUNGGAL, DEPOK, SLEMAN, DAERAH ISTIMEWA YOGYAKARTA",137,163,60,223
https://kawalpemilu.org#42260,"CATURTUNGGAL, DEPOK, SLEMAN, DAERAH ISTIMEWA YOGYAKARTA",138,163,30,193
https://kawalpemilu.org#42260,"CATURTUNGGAL, DEPOK, SLEMAN, DAERAH ISTIMEWA YOGYAKARTA",139,175,78,253
https://kawalpemilu.org#42260,"CATURTUNGGAL, DEPOK, SLEMAN, DAERAH ISTIMEWA YOGYAKARTA",140,161,71,232
https://kawalpemilu.org#42260,"CATURTUNGGAL, DEPOK, SLEMAN, DAERAH ISTIMEWA YOGYAKARTA",141,103,57,160
https://kawalpemilu.org#42260,"CATURTUNGGAL, DEPOK, SLEMAN, DAERAH ISTIMEWA YOGYAKARTA",142,142,41,183
https://kawalpemilu.org#42261,"MAGUWOHARJO, DEPOK, SLEMAN, DAERAH ISTIMEWA YOGYAKARTA",1,104,77,181
https://kawalpemilu.org#42261,"MAGUWOHARJO, DEPOK, SLEMAN, DAERAH ISTIMEWA YOGYAKARTA",2,105,109,214
https://kawalpemilu.org#42261,"MAGUWOHARJO, DEPOK, SLEMAN, DAERAH ISTIMEWA YOGYAKARTA",3,105,113,218
https://kawalpemilu.org#42261,"MAGUWOHARJO, DEPOK, SLEMAN, DAERAH ISTIMEWA YOGYAKARTA",4,106,34,140
https://kawalpemilu.org#42261,"MAGUWOHARJO, DEPOK, SLEMAN, DAERAH ISTIMEWA YOGYAKARTA",5,115,28,143
https://kawalpemilu.org#42261,"MAGUWOHARJO, DEPOK, SLEMAN, DAERAH ISTIMEWA YOGYAKARTA",6,81,26,107
https://kawalpemilu.org#42261,"MAGUWOHARJO, DEPOK, SLEMAN, DAERAH ISTIMEWA YOGYAKARTA",7,165,93,258
https://kawalpemilu.org#42261,"MAGUWOHARJO, DEPOK, SLEMAN, DAERAH ISTIMEWA YOGYAKARTA",8,144,63,207
https://kawalpemilu.org#42261,"MAGUWOHARJO, DEPOK, SLEMAN, DAERAH ISTIMEWA YOGYAKARTA",9,127,82,209
https://kawalpemilu.org#42261,"MAGUWOHARJO, DEPOK, SLEMAN, DAERAH ISTIMEWA YOGYAKARTA",10,172,87,259
https://kawalpemilu.org#42261,"MAGUWOHARJO, DEPOK, SLEMAN, DAERAH ISTIMEWA YOGYAKARTA",11,161,57,218
https://kawalpemilu.org#42261,"MAGUWOHARJO, DEPOK, SLEMAN, DAERAH ISTIMEWA YOGYAKARTA",12,93,58,151
https://kawalpemilu.org#42261,"MAGUWOHARJO, DEPOK, SLEMAN, DAERAH ISTIMEWA YOGYAKARTA",13,90,57,147
https://kawalpemilu.org#42261,"MAGUWOHARJO, DEPOK, SLEMAN, DAERAH ISTIMEWA YOGYAKARTA",14,138,99,237
https://kawalpemilu.org#42261,"MAGUWOHARJO, DEPOK, SLEMAN, DAERAH ISTIMEWA YOGYAKARTA",15,109,38,147
https://kawalpemilu.org#42261,"MAGUWOHARJO, DEPOK, SLEMAN, DAERAH ISTIMEWA YOGYAKARTA",16,46,20,66
https://kawalpemilu.org#42261,"MAGUWOHARJO, DEPOK, SLEMAN, DAERAH ISTIMEWA YOGYAKARTA",17,126,87,213
https://kawalpemilu.org#42261,"MAGUWOHARJO, DEPOK, SLEMAN, DAERAH ISTIMEWA YOGYAKARTA",18,127,71,198
https://kawalpemilu.org#42261,"MAGUWOHARJO, DEPOK, SLEMAN, DAERAH ISTIMEWA YOGYAKARTA",19,81,45,126
https://kawalpemilu.org#42261,"MAGUWOHARJO, DEPOK, SLEMAN, DAERAH ISTIMEWA YOGYAKARTA",20,152,35,187
https://kawalpemilu.org#42261,"MAGUWOHARJO, DEPOK, SLEMAN, DAERAH ISTIMEWA YOGYAKARTA",21,104,60,164
https://kawalpemilu.org#42261,"MAGUWOHARJO, DEPOK, SLEMAN, DAERAH ISTIMEWA YOGYAKARTA",22,89,15,104
https://kawalpemilu.org#42261,"MAGUWOHARJO, DEPOK, SLEMAN, DAERAH ISTIMEWA YOGYAKARTA",23,133,59,192
https://kawalpemilu.org#42261,"MAGUWOHARJO, DEPOK, SLEMAN, DAERAH ISTIMEWA YOGYAKARTA",24,166,64,230
https://kawalpemilu.org#42261,"MAGUWOHARJO, DEPOK, SLEMAN, DAERAH ISTIMEWA YOGYAKARTA",25,143,58,201
https://kawalpemilu.org#42261,"MAGUWOHARJO, DEPOK, SLEMAN, DAERAH ISTIMEWA YOGYAKARTA",26,101,49,150
https://kawalpemilu.org#42261,"MAGUWOHARJO, DEPOK, SLEMAN, DAERAH ISTIMEWA YOGYAKARTA",27,119,55,174
https://kawalpemilu.org#42261,"MAGUWOHARJO, DEPOK, SLEMAN, DAERAH ISTIMEWA YOGYAKARTA",28,118,36,154
https://kawalpemilu.org#42261,"MAGUWOHARJO, DEPOK, SLEMAN, DAERAH ISTIMEWA YOGYAKARTA",29,89,54,143
https://kawalpemilu.org#42261,"MAGUWOHARJO, DEPOK, SLEMAN, DAERAH ISTIMEWA YOGYAKARTA",30,90,49,139
https://kawalpemilu.org#42261,"MAGUWOHARJO, DEPOK, SLEMAN, DAERAH ISTIMEWA YOGYAKARTA",31,135,64,199
https://kawalpemilu.org#42261,"MAGUWOHARJO, DEPOK, SLEMAN, DAERAH ISTIMEWA YOGYAKARTA",32,128,137,265
https://kawalpemilu.org#42261,"MAGUWOHARJO, DEPOK, SLEMAN, DAERAH ISTIMEWA YOGYAKARTA",33,105,48,153
https://kawalpemilu.org#42261,"MAGUWOHARJO, DEPOK, SLEMAN, DAERAH ISTIMEWA YOGYAKARTA",34,0,0,0
https://kawalpemilu.org#42261,"MAGUWOHARJO, DEPOK, SLEMAN, DAERAH ISTIMEWA YOGYAKARTA",35,117,34,151
https://kawalpemilu.org#42261,"MAGUWOHARJO, DEPOK, SLEMAN, DAERAH ISTIMEWA YOGYAKARTA",36,148,43,191
https://kawalpemilu.org#42261,"MAGUWOHARJO, DEPOK, SLEMAN, DAERAH ISTIMEWA YOGYAKARTA",37,174,74,248
https://kawalpemilu.org#42261,"MAGUWOHARJO, DEPOK, SLEMAN, DAERAH ISTIMEWA YOGYAKARTA",38,193,49,242
https://kawalpemilu.org#42261,"MAGUWOHARJO, DEPOK, SLEMAN, DAERAH ISTIMEWA YOGYAKARTA",39,122,53,175
https://kawalpemilu.org#42261,"MAGUWOHARJO, DEPOK, SLEMAN, DAERAH ISTIMEWA YOGYAKARTA",40,128,28,156
https://kawalpemilu.org#42261,"MAGUWOHARJO, DEPOK, SLEMAN, DAERAH ISTIMEWA YOGYAKARTA",41,103,32,135
https://kawalpemilu.org#42261,"MAGUWOHARJO, DEPOK, SLEMAN, DAERAH ISTIMEWA YOGYAKARTA",42,118,34,152
https://kawalpemilu.org#42261,"MAGUWOHARJO, DEPOK, SLEMAN, DAERAH ISTIMEWA YOGYAKARTA",43,140,108,248
https://kawalpemilu.org#42261,"MAGUWOHARJO, DEPOK, SLEMAN, DAERAH ISTIMEWA YOGYAKARTA",44,135,44,179
https://kawalpemilu.org#42261,"MAGUWOHARJO, DEPOK, SLEMAN, DAERAH ISTIMEWA YOGYAKARTA",45,84,48,132
https://kawalpemilu.org#42261,"MAGUWOHARJO, DEPOK, SLEMAN, DAERAH ISTIMEWA YOGYAKARTA",46,111,33,144
https://kawalpemilu.org#42261,"MAGUWOHARJO, DEPOK, SLEMAN, DAERAH ISTIMEWA YOGYAKARTA",47,161,65,226
https://kawalpemilu.org#42261,"MAGUWOHARJO, DEPOK, SLEMAN, DAERAH ISTIMEWA YOGYAKARTA",49,120,35,155
https://kawalpemilu.org#42261,"MAGUWOHARJO, DEPOK, SLEMAN, DAERAH ISTIMEWA YOGYAKARTA",50,89,31,120
https://kawalpemilu.org#42261,"MAGUWOHARJO, DEPOK, SLEMAN, DAERAH ISTIMEWA YOGYAKARTA",51,152,39,191
https://kawalpemilu.org#42261,"MAGUWOHARJO, DEPOK, SLEMAN, DAERAH ISTIMEWA YOGYAKARTA",52,139,24,163
https://kawalpemilu.org#42261,"MAGUWOHARJO, DEPOK, SLEMAN, DAERAH ISTIMEWA YOGYAKARTA",53,91,46,137
https://kawalpemilu.org#42261,"MAGUWOHARJO, DEPOK, SLEMAN, DAERAH ISTIMEWA YOGYAKARTA",54,128,45,173
https://kawalpemilu.org#42261,"MAGUWOHARJO, DEPOK, SLEMAN, DAERAH ISTIMEWA YOGYAKARTA",55,153,90,243
https://kawalpemilu.org#42261,"MAGUWOHARJO, DEPOK, SLEMAN, DAERAH ISTIMEWA YOGYAKARTA",56,136,57,193
https://kawalpemilu.org#42261,"MAGUWOHARJO, DEPOK, SLEMAN, DAERAH ISTIMEWA YOGYAKARTA",57,198,73,271
https://kawalpemilu.org#42261,"MAGUWOHARJO, DEPOK, SLEMAN, DAERAH ISTIMEWA YOGYAKARTA",58,113,56,169
https://kawalpemilu.org#42261,"MAGUWOHARJO, DEPOK, SLEMAN, DAERAH ISTIMEWA YOGYAKARTA",59,134,60,194
https://kawalpemilu.org#42261,"MAGUWOHARJO, DEPOK, SLEMAN, DAERAH ISTIMEWA YOGYAKARTA",60,76,26,102
https://kawalpemilu.org#42261,"MAGUWOHARJO, DEPOK, SLEMAN, DAERAH ISTIMEWA YOGYAKARTA",61,185,75,210
https://kawalpemilu.org#42261,"MAGUWOHARJO, DEPOK, SLEMAN, DAERAH ISTIMEWA YOGYAKARTA",62,54,37,91
https://kawalpemilu.org#42261,"MAGUWOHARJO, DEPOK, SLEMAN, DAERAH ISTIMEWA YOGYAKARTA",63,115,47,162
https://kawalpemilu.org#42261,"MAGUWOHARJO, DEPOK, SLEMAN, DAERAH ISTIMEWA YOGYAKARTA",64,110,57,167
https://kawalpemilu.org#42261,"MAGUWOHARJO, DEPOK, SLEMAN, DAERAH ISTIMEWA YOGYAKARTA",65,134,45,179
https://kawalpemilu.org#42261,"MAGUWOHARJO, DEPOK, SLEMAN, DAERAH ISTIMEWA YOGYAKARTA",66,94,34,128
https://kawalpemilu.org#42261,"MAGUWOHARJO, DEPOK, SLEMAN, DAERAH ISTIMEWA YOGYAKARTA",67,83,28,111
https://kawalpemilu.org#42261,"MAGUWOHARJO, DEPOK, SLEMAN, DAERAH ISTIMEWA YOGYAKARTA",68,103,55,158
https://kawalpemilu.org#42261,"MAGUWOHARJO, DEPOK, SLEMAN, DAERAH ISTIMEWA YOGYAKARTA",69,92,36,128
https://kawalpemilu.org#42261,"MAGUWOHARJO, DEPOK, SLEMAN, DAERAH ISTIMEWA YOGYAKARTA",70,179,84,263
https://kawalpemilu.org#42261,"MAGUWOHARJO, DEPOK, SLEMAN, DAERAH ISTIMEWA YOGYAKARTA",71,80,32,112
https://kawalpemilu.org#42261,"MAGUWOHARJO, DEPOK, SLEMAN, DAERAH ISTIMEWA YOGYAKARTA",72,187,52,239
https://kawalpemilu.org#42261,"MAGUWOHARJO, DEPOK, SLEMAN, DAERAH ISTIMEWA YOGYAKARTA",73,91,46,137
https://kawalpemilu.org#42261,"MAGUWOHARJO, DEPOK, SLEMAN, DAERAH ISTIMEWA YOGYAKARTA",74,144,86,230
https://kawalpemilu.org#42261,"MAGUWOHARJO, DEPOK, SLEMAN, DAERAH ISTIMEWA YOGYAKARTA",75,175,75,250
https://kawalpemilu.org#42261,"MAGUWOHARJO, DEPOK, SLEMAN, DAERAH ISTIMEWA YOGYAKARTA",76,167,70,237
https://kawalpemilu.org#42261,"MAGUWOHARJO, DEPOK, SLEMAN, DAERAH ISTIMEWA YOGYAKARTA",77,139,68,207
https://kawalpemilu.org#42261,"MAGUWOHARJO, DEPOK, SLEMAN, DAERAH ISTIMEWA YOGYAKARTA",79,115,77,192
https://kawalpemilu.org#42261,"MAGUWOHARJO, DEPOK, SLEMAN, DAERAH ISTIMEWA YOGYAKARTA",80,110,65,175
https://kawalpemilu.org#42261,"MAGUWOHARJO, DEPOK, SLEMAN, DAERAH ISTIMEWA YOGYAKARTA",81,90,50,140
https://kawalpemilu.org#42261,"MAGUWOHARJO, DEPOK, SLEMAN, DAERAH ISTIMEWA YOGYAKARTA",82,83,38,121
https://kawalpemilu.org#42261,"MAGUWOHARJO, DEPOK, SLEMAN, DAERAH ISTIMEWA YOGYAKARTA",83,130,49,179
https://kawalpemilu.org#42261,"MAGUWOHARJO, DEPOK, SLEMAN, DAERAH ISTIMEWA YOGYAKARTA",84,87,32,119
https://kawalpemilu.org#42261,"MAGUWOHARJO, DEPOK, SLEMAN, DAERAH ISTIMEWA YOGYAKARTA",85,191,81,272
https://kawalpemilu.org#42261,"MAGUWOHARJO, DEPOK, SLEMAN, DAERAH ISTIMEWA YOGYAKARTA",88,0,0,0
https://kawalpemilu.org#42261,"MAGUWOHARJO, DEPOK, SLEMAN, DAERAH ISTIMEWA YOGYAKARTA",89,132,52,184
https://kawalpemilu.org#42261,"MAGUWOHARJO, DEPOK, SLEMAN, DAERAH ISTIMEWA YOGYAKARTA",90,96,42,138
https://kawalpemilu.org#42261,"MAGUWOHARJO, DEPOK, SLEMAN, DAERAH ISTIMEWA YOGYAKARTA",92,119,55,174
https://kawalpemilu.org#42261,"MAGUWOHARJO, DEPOK, SLEMAN, DAERAH ISTIMEWA YOGYAKARTA",95,154,44,198
https://kawalpemilu.org#42261,"MAGUWOHARJO, DEPOK, SLEMAN, DAERAH ISTIMEWA YOGYAKARTA",96,169,76,245
https://kawalpemilu.org#42261,"MAGUWOHARJO, DEPOK, SLEMAN, DAERAH ISTIMEWA YOGYAKARTA",97,96,27,123
https://kawalpemilu.org#42261,"MAGUWOHARJO, DEPOK, SLEMAN, DAERAH ISTIMEWA YOGYAKARTA",98,102,112,214
https://kawalpemilu.org#42261,"MAGUWOHARJO, DEPOK, SLEMAN, DAERAH ISTIMEWA YOGYAKARTA",99,113,59,172
https://kawalpemilu.org#42261,"MAGUWOHARJO, DEPOK, SLEMAN, DAERAH ISTIMEWA YOGYAKARTA",101,105,44,149
https://kawalpemilu.org#42261,"MAGUWOHARJO, DEPOK, SLEMAN, DAERAH ISTIMEWA YOGYAKARTA",102,146,82,228
https://kawalpemilu.org#42261,"MAGUWOHARJO, DEPOK, SLEMAN, DAERAH ISTIMEWA YOGYAKARTA",103,82,24,106
https://kawalpemilu.org#42261,"MAGUWOHARJO, DEPOK, SLEMAN, DAERAH ISTIMEWA YOGYAKARTA",104,185,88,273
https://kawalpemilu.org#42261,"MAGUWOHARJO, DEPOK, SLEMAN, DAERAH ISTIMEWA YOGYAKARTA",105,149,75,224
https://kawalpemilu.org#42261,"MAGUWOHARJO, DEPOK, SLEMAN, DAERAH ISTIMEWA YOGYAKARTA",106,94,48,142
https://kawalpemilu.org#42261,"MAGUWOHARJO, DEPOK, SLEMAN, DAERAH ISTIMEWA YOGYAKARTA",107,188,62,250
https://kawalpemilu.org#42261,"MAGUWOHARJO, DEPOK, SLEMAN, DAERAH ISTIMEWA YOGYAKARTA",108,134,41,175
https://kawalpemilu.org#42261,"MAGUWOHARJO, DEPOK, SLEMAN, DAERAH ISTIMEWA YOGYAKARTA",109,72,74,146
https://kawalpemilu.org#42261,"MAGUWOHARJO, DEPOK, SLEMAN, DAERAH ISTIMEWA YOGYAKARTA",110,105,44,149
https://kawalpemilu.org#42261,"MAGUWOHARJO, DEPOK, SLEMAN, DAERAH ISTIMEWA YOGYAKARTA",111,89,28,117
https://kawalpemilu.org#42261,"MAGUWOHARJO, DEPOK, SLEMAN, DAERAH ISTIMEWA YOGYAKARTA",112,179,92,271
https://kawalpemilu.org#42261,"MAGUWOHARJO, DEPOK, SLEMAN, DAERAH ISTIMEWA YOGYAKARTA",113,100,36,136
https://kawalpemilu.org#42261,"MAGUWOHARJO, DEPOK, SLEMAN, DAERAH ISTIMEWA YOGYAKARTA",114,166,29,195
https://kawalpemilu.org#42261,"MAGUWOHARJO, DEPOK, SLEMAN, DAERAH ISTIMEWA YOGYAKARTA",115,134,47,181
https://kawalpemilu.org#42261,"MAGUWOHARJO, DEPOK, SLEMAN, DAERAH ISTIMEWA YOGYAKARTA",116,147,52,199
https://kawalpemilu.org#42261,"MAGUWOHARJO, DEPOK, SLEMAN, DAERAH ISTIMEWA YOGYAKARTA",117,47,25,72
https://kawalpemilu.org#42261,"MAGUWOHARJO, DEPOK, SLEMAN, DAERAH ISTIMEWA YOGYAKARTA",118,153,74,227
https://kawalpemilu.org#42261,"MAGUWOHARJO, DEPOK, SLEMAN, DAERAH ISTIMEWA YOGYAKARTA",120,80,40,120
https://kawalpemilu.org#42261,"MAGUWOHARJO, DEPOK, SLEMAN, DAERAH ISTIMEWA YOGYAKARTA",121,90,38,128
https://kawalpemilu.org#42261,"MAGUWOHARJO, DEPOK, SLEMAN, DAERAH ISTIMEWA YOGYAKARTA",122,80,43,123
https://kawalpemilu.org#42261,"MAGUWOHARJO, DEPOK, SLEMAN, DAERAH ISTIMEWA YOGYAKARTA",123,185,35,220
https://kawalpemilu.org#42261,"MAGUWOHARJO, DEPOK, SLEMAN, DAERAH ISTIMEWA YOGYAKARTA",125,168,33,201
https://kawalpemilu.org#42261,"MAGUWOHARJO, DEPOK, SLEMAN, DAERAH ISTIMEWA YOGYAKARTA",126,99,25,124
https://kawalpemilu.org#42261,"MAGUWOHARJO, DEPOK, SLEMAN, DAERAH ISTIMEWA YOGYAKARTA",127,107,37,144
https://kawalpemilu.org#42261,"MAGUWOHARJO, DEPOK, SLEMAN, DAERAH ISTIMEWA YOGYAKARTA",128,95,51,146
https://kawalpemilu.org#42261,"MAGUWOHARJO, DEPOK, SLEMAN, DAERAH ISTIMEWA YOGYAKARTA",129,176,108,284
https://kawalpemilu.org#42262,"CONDONGCATUR, DEPOK, SLEMAN, DAERAH ISTIMEWA YOGYAKARTA",1,202,88,290
https://kawalpemilu.org#42262,"CONDONGCATUR, DEPOK, SLEMAN, DAERAH ISTIMEWA YOGYAKARTA",2,189,56,245
https://kawalpemilu.org#42262,"CONDONGCATUR, DEPOK, SLEMAN, DAERAH ISTIMEWA YOGYAKARTA",3,162,75,237
https://kawalpemilu.org#42262,"CONDONGCATUR, DEPOK, SLEMAN, DAERAH ISTIMEWA YOGYAKARTA",4,112,75,187
https://kawalpemilu.org#42262,"CONDONGCATUR, DEPOK, SLEMAN, DAERAH ISTIMEWA YOGYAKARTA",5,164,49,213
https://kawalpemilu.org#42262,"CONDONGCATUR, DEPOK, SLEMAN, DAERAH ISTIMEWA YOGYAKARTA",6,176,61,237
https://kawalpemilu.org#42262,"CONDONGCATUR, DEPOK, SLEMAN, DAERAH ISTIMEWA YOGYAKARTA",7,137,52,189
https://kawalpemilu.org#42262,"CONDONGCATUR, DEPOK, SLEMAN, DAERAH ISTIMEWA YOGYAKARTA",8,145,65,210
https://kawalpemilu.org#42262,"CONDONGCATUR, DEPOK, SLEMAN, DAERAH ISTIMEWA YOGYAKARTA",9,175,63,238
https://kawalpemilu.org#42262,"CONDONGCATUR, DEPOK, SLEMAN, DAERAH ISTIMEWA YOGYAKARTA",10,96,67,163
https://kawalpemilu.org#42262,"CONDONGCATUR, DEPOK, SLEMAN, DAERAH ISTIMEWA YOGYAKARTA",11,130,50,149
https://kawalpemilu.org#42262,"CONDONGCATUR, DEPOK, SLEMAN, DAERAH ISTIMEWA YOGYAKARTA",12,142,61,203
https://kawalpemilu.org#42262,"CONDONGCATUR, DEPOK, SLEMAN, DAERAH ISTIMEWA YOGYAKARTA",13,99,57,156
https://kawalpemilu.org#42262,"CONDONGCATUR, DEPOK, SLEMAN, DAERAH ISTIMEWA YOGYAKARTA",14,172,98,270
https://kawalpemilu.org#42262,"CONDONGCATUR, DEPOK, SLEMAN, DAERAH ISTIMEWA YOGYAKARTA",15,143,59,202
https://kawalpemilu.org#42262,"CONDONGCATUR, DEPOK, SLEMAN, DAERAH ISTIMEWA YOGYAKARTA",16,139,51,190
https://kawalpemilu.org#42262,"CONDONGCATUR, DEPOK, SLEMAN, DAERAH ISTIMEWA YOGYAKARTA",17,162,91,253
https://kawalpemilu.org#42262,"CONDONGCATUR, DEPOK, SLEMAN, DAERAH ISTIMEWA YOGYAKARTA",18,130,30,160
https://kawalpemilu.org#42262,"CONDONGCATUR, DEPOK, SLEMAN, DAERAH ISTIMEWA YOGYAKARTA",19,173,95,267
https://kawalpemilu.org#42262,"CONDONGCATUR, DEPOK, SLEMAN, DAERAH ISTIMEWA YOGYAKARTA",20,175,41,216
https://kawalpemilu.org#42262,"CONDONGCATUR, DEPOK, SLEMAN, DAERAH ISTIMEWA YOGYAKARTA",21,159,52,211
https://kawalpemilu.org#42262,"CONDONGCATUR, DEPOK, SLEMAN, DAERAH ISTIMEWA YOGYAKARTA",22,132,90,224
https://kawalpemilu.org#42262,"CONDONGCATUR, DEPOK, SLEMAN, DAERAH ISTIMEWA YOGYAKARTA",23,150,75,225
https://kawalpemilu.org#42262,"CONDONGCATUR, DEPOK, SLEMAN, DAERAH ISTIMEWA YOGYAKARTA",24,166,35,201
https://kawalpemilu.org#42262,"CONDONGCATUR, DEPOK, SLEMAN, DAERAH ISTIMEWA YOGYAKARTA",25,83,47,130
https://kawalpemilu.org#42262,"CONDONGCATUR, DEPOK, SLEMAN, DAERAH ISTIMEWA YOGYAKARTA",26,167,71,238
https://kawalpemilu.org#42262,"CONDONGCATUR, DEPOK, SLEMAN, DAERAH ISTIMEWA YOGYAKARTA",27,198,67,265
https://kawalpemilu.org#42262,"CONDONGCATUR, DEPOK, SLEMAN, DAERAH ISTIMEWA YOGYAKARTA",28,178,67,245
https://kawalpemilu.org#42262,"CONDONGCATUR, DEPOK, SLEMAN, DAERAH ISTIMEWA YOGYAKARTA",29,119,75,194
https://kawalpemilu.org#42262,"CONDONGCATUR, DEPOK, SLEMAN, DAERAH ISTIMEWA YOGYAKARTA",30,136,52,188
https://kawalpemilu.org#42262,"CONDONGCATUR, DEPOK, SLEMAN, DAERAH ISTIMEWA YOGYAKARTA",31,153,58,211
https://kawalpemilu.org#42262,"CONDONGCATUR, DEPOK, SLEMAN, DAERAH ISTIMEWA YOGYAKARTA",32,121,76,197
https://kawalpemilu.org#42262,"CONDONGCATUR, DEPOK, SLEMAN, DAERAH ISTIMEWA YOGYAKARTA",33,124,67,191
https://kawalpemilu.org#42262,"CONDONGCATUR, DEPOK, SLEMAN, DAERAH ISTIMEWA YOGYAKARTA",34,163,78,241
https://kawalpemilu.org#42262,"CONDONGCATUR, DEPOK, SLEMAN, DAERAH ISTIMEWA YOGYAKARTA",35,125,87,212
https://kawalpemilu.org#42262,"CONDONGCATUR, DEPOK, SLEMAN, DAERAH ISTIMEWA YOGYAKARTA",36,94,96,190
https://kawalpemilu.org#42262,"CONDONGCATUR, DEPOK, SLEMAN, DAERAH ISTIMEWA YOGYAKARTA",37,142,76,218
https://kawalpemilu.org#42262,"CONDONGCATUR, DEPOK, SLEMAN, DAERAH ISTIMEWA YOGYAKARTA",38,214,60,274
https://kawalpemilu.org#42262,"CONDONGCATUR, DEPOK, SLEMAN, DAERAH ISTIMEWA YOGYAKARTA",39,142,73,215
https://kawalpemilu.org#42262,"CONDONGCATUR, DEPOK, SLEMAN, DAERAH ISTIMEWA YOGYAKARTA",40,103,84,187
https://kawalpemilu.org#42262,"CONDONGCATUR, DEPOK, SLEMAN, DAERAH ISTIMEWA YOGYAKARTA",41,131,92,223
https://kawalpemilu.org#42262,"CONDONGCATUR, DEPOK, SLEMAN, DAERAH ISTIMEWA YOGYAKARTA",42,139,91,230
https://kawalpemilu.org#42262,"CONDONGCATUR, DEPOK, SLEMAN, DAERAH ISTIMEWA YOGYAKARTA",43,113,91,204
https://kawalpemilu.org#42262,"CONDONGCATUR, DEPOK, SLEMAN, DAERAH ISTIMEWA YOGYAKARTA",44,151,61,212
https://kawalpemilu.org#42262,"CONDONGCATUR, DEPOK, SLEMAN, DAERAH ISTIMEWA YOGYAKARTA",45,122,87,209
https://kawalpemilu.org#42262,"CONDONGCATUR, DEPOK, SLEMAN, DAERAH ISTIMEWA YOGYAKARTA",46,173,56,229
https://kawalpemilu.org#42262,"CONDONGCATUR, DEPOK, SLEMAN, DAERAH ISTIMEWA YOGYAKARTA",47,181,48,229
https://kawalpemilu.org#42262,"CONDONGCATUR, DEPOK, SLEMAN, DAERAH ISTIMEWA YOGYAKARTA",48,172,85,257
https://kawalpemilu.org#42262,"CONDONGCATUR, DEPOK, SLEMAN, DAERAH ISTIMEWA YOGYAKARTA",49,153,65,218
https://kawalpemilu.org#42262,"CONDONGCATUR, DEPOK, SLEMAN, DAERAH ISTIMEWA YOGYAKARTA",50,153,67,220
https://kawalpemilu.org#42262,"CONDONGCATUR, DEPOK, SLEMAN, DAERAH ISTIMEWA YOGYAKARTA",51,204,35,239
https://kawalpemilu.org#42262,"CONDONGCATUR, DEPOK, SLEMAN, DAERAH ISTIMEWA YOGYAKARTA",52,192,76,268
https://kawalpemilu.org#42262,"CONDONGCATUR, DEPOK, SLEMAN, DAERAH ISTIMEWA YOGYAKARTA",53,125,70,195
https://kawalpemilu.org#42262,"CONDONGCATUR, DEPOK, SLEMAN, DAERAH ISTIMEWA YOGYAKARTA",54,131,100,231
https://kawalpemilu.org#42262,"CONDONGCATUR, DEPOK, SLEMAN, DAERAH ISTIMEWA YOGYAKARTA",55,128,76,204
https://kawalpemilu.org#42262,"CONDONGCATUR, DEPOK, SLEMAN, DAERAH ISTIMEWA YOGYAKARTA",56,140,90,230
https://kawalpemilu.org#42262,"CONDONGCATUR, DEPOK, SLEMAN, DAERAH ISTIMEWA YOGYAKARTA",57,146,80,226
https://kawalpemilu.org#42262,"CONDONGCATUR, DEPOK, SLEMAN, DAERAH ISTIMEWA YOGYAKARTA",58,168,58,226
https://kawalpemilu.org#42262,"CONDONGCATUR, DEPOK, SLEMAN, DAERAH ISTIMEWA YOGYAKARTA",59,184,70,254
https://kawalpemilu.org#42262,"CONDONGCATUR, DEPOK, SLEMAN, DAERAH ISTIMEWA YOGYAKARTA",60,147,93,240
https://kawalpemilu.org#42262,"CONDONGCATUR, DEPOK, SLEMAN, DAERAH ISTIMEWA YOGYAKARTA",61,177,69,246
https://kawalpemilu.org#42262,"CONDONGCATUR, DEPOK, SLEMAN, DAERAH ISTIMEWA YOGYAKARTA",62,193,83,276
https://kawalpemilu.org#42262,"CONDONGCATUR, DEPOK, SLEMAN, DAERAH ISTIMEWA YOGYAKARTA",63,160,90,250
https://kawalpemilu.org#42262,"CONDONGCATUR, DEPOK, SLEMAN, DAERAH ISTIMEWA YOGYAKARTA",64,148,80,228
https://kawalpemilu.org#42262,"CONDONGCATUR, DEPOK, SLEMAN, DAERAH ISTIMEWA YOGYAKARTA",65,164,65,229
https://kawalpemilu.org#42262,"CONDONGCATUR, DEPOK, SLEMAN, DAERAH ISTIMEWA YOGYAKARTA",66,178,41,219
https://kawalpemilu.org#42262,"CONDONGCATUR, DEPOK, SLEMAN, DAERAH ISTIMEWA YOGYAKARTA",67,125,73,198
https://kawalpemilu.org#42262,"CONDONGCATUR, DEPOK, SLEMAN, DAERAH ISTIMEWA YOGYAKARTA",68,119,57,176
https://kawalpemilu.org#42262,"CONDONGCATUR, DEPOK, SLEMAN, DAERAH ISTIMEWA YOGYAKARTA",69,94,45,139
https://kawalpemilu.org#42262,"CONDONGCATUR, DEPOK, SLEMAN, DAERAH ISTIMEWA YOGYAKARTA",70,126,30,156
https://kawalpemilu.org#42262,"CONDONGCATUR, DEPOK, SLEMAN, DAERAH ISTIMEWA YOGYAKARTA",71,172,79,251
https://kawalpemilu.org#42262,"CONDONGCATUR, DEPOK, SLEMAN, DAERAH ISTIMEWA YOGYAKARTA",72,149,71,220
https://kawalpemilu.org#42262,"CONDONGCATUR, DEPOK, SLEMAN, DAERAH ISTIMEWA YOGYAKARTA",73,139,62,201
https://kawalpemilu.org#42262,"CONDONGCATUR, DEPOK, SLEMAN, DAERAH ISTIMEWA YOGYAKARTA",74,178,48,226
https://kawalpemilu.org#42262,"CONDONGCATUR, DEPOK, SLEMAN, DAERAH ISTIMEWA YOGYAKARTA",75,138,74,212
https://kawalpemilu.org#42262,"CONDONGCATUR, DEPOK, SLEMAN, DAERAH ISTIMEWA YOGYAKARTA",76,136,63,199
https://kawalpemilu.org#42262,"CONDONGCATUR, DEPOK, SLEMAN, DAERAH ISTIMEWA YOGYAKARTA",77,109,85,194
https://kawalpemilu.org#42262,"CONDONGCATUR, DEPOK, SLEMAN, DAERAH ISTIMEWA YOGYAKARTA",78,96,106,202
https://kawalpemilu.org#42262,"CONDONGCATUR, DEPOK, SLEMAN, DAERAH ISTIMEWA YOGYAKARTA",79,136,37,173
https://kawalpemilu.org#42262,"CONDONGCATUR, DEPOK, SLEMAN, DAERAH ISTIMEWA YOGYAKARTA",80,153,49,202
https://kawalpemilu.org#42262,"CONDONGCATUR, DEPOK, SLEMAN, DAERAH ISTIMEWA YOGYAKARTA",81,175,56,231
https://kawalpemilu.org#42262,"CONDONGCATUR, DEPOK, SLEMAN, DAERAH ISTIMEWA YOGYAKARTA",82,199,44,243
https://kawalpemilu.org#42262,"CONDONGCATUR, DEPOK, SLEMAN, DAERAH ISTIMEWA YOGYAKARTA",83,132,49,181
https://kawalpemilu.org#42262,"CONDONGCATUR, DEPOK, SLEMAN, DAERAH ISTIMEWA YOGYAKARTA",85,138,48,186
https://kawalpemilu.org#42262,"CONDONGCATUR, DEPOK, SLEMAN, DAERAH ISTIMEWA YOGYAKARTA",86,159,92,251
https://kawalpemilu.org#42262,"CONDONGCATUR, DEPOK, SLEMAN, DAERAH ISTIMEWA YOGYAKARTA",87,185,51,236
https://kawalpemilu.org#42262,"CONDONGCATUR, DEPOK, SLEMAN, DAERAH ISTIMEWA YOGYAKARTA",88,160,52,212
https://kawalpemilu.org#42262,"CONDONGCATUR, DEPOK, SLEMAN, DAERAH ISTIMEWA YOGYAKARTA",89,208,59,267
https://kawalpemilu.org#42262,"CONDONGCATUR, DEPOK, SLEMAN, DAERAH ISTIMEWA YOGYAKARTA",90,204,30,234
https://kawalpemilu.org#42262,"CONDONGCATUR, DEPOK, SLEMAN, DAERAH ISTIMEWA YOGYAKARTA",91,189,54,243
https://kawalpemilu.org#42262,"CONDONGCATUR, DEPOK, SLEMAN, DAERAH ISTIMEWA YOGYAKARTA",92,183,66,249
https://kawalpemilu.org#42262,"CONDONGCATUR, DEPOK, SLEMAN, DAERAH ISTIMEWA YOGYAKARTA",93,178,81,259
https://kawalpemilu.org#42262,"CONDONGCATUR, DEPOK, SLEMAN, DAERAH ISTIMEWA YOGYAKARTA",94,155,40,195
https://kawalpemilu.org#42262,"CONDONGCATUR, DEPOK, SLEMAN, DAERAH ISTIMEWA YOGYAKARTA",95,121,32,153
https://kawalpemilu.org#42262,"CONDONGCATUR, DEPOK, SLEMAN, DAERAH ISTIMEWA YOGYAKARTA",96,141,75,216
https://kawalpemilu.org#42262,"CONDONGCATUR, DEPOK, SLEMAN, DAERAH ISTIMEWA YOGYAKARTA",97,134,65,199
https://kawalpemilu.org#42262,"CONDONGCATUR, DEPOK, SLEMAN, DAERAH ISTIMEWA YOGYAKARTA",98,124,63,187
https://kawalpemilu.org#42262,"CONDONGCATUR, DEPOK, SLEMAN, DAERAH ISTIMEWA YOGYAKARTA",99,129,102,231
https://kawalpemilu.org#42262,"CONDONGCATUR, DEPOK, SLEMAN, DAERAH ISTIMEWA YOGYAKARTA",100,118,96,214
https://kawalpemilu.org#42262,"CONDONGCATUR, DEPOK, SLEMAN, DAERAH ISTIMEWA YOGYAKARTA",101,137,102,239
https://kawalpemilu.org#42262,"CONDONGCATUR, DEPOK, SLEMAN, DAERAH ISTIMEWA YOGYAKARTA",102,160,88,248
https://kawalpemilu.org#42262,"CONDONGCATUR, DEPOK, SLEMAN, DAERAH ISTIMEWA YOGYAKARTA",103,130,59,189
https://kawalpemilu.org#42262,"CONDONGCATUR, DEPOK, SLEMAN, DAERAH ISTIMEWA YOGYAKARTA",104,82,91,173
https://kawalpemilu.org#42262,"CONDONGCATUR, DEPOK, SLEMAN, DAERAH ISTIMEWA YOGYAKARTA",105,153,60,213
https://kawalpemilu.org#42262,"CONDONGCATUR, DEPOK, SLEMAN, DAERAH ISTIMEWA YOGYAKARTA",106,147,76,223
https://kawalpemilu.org#42262,"CONDONGCATUR, DEPOK, SLEMAN, DAERAH ISTIMEWA YOGYAKARTA",107,136,84,220
https://kawalpemilu.org#42262,"CONDONGCATUR, DEPOK, SLEMAN, DAERAH ISTIMEWA YOGYAKARTA",108,145,114,159
https://kawalpemilu.org#42262,"CONDONGCATUR, DEPOK, SLEMAN, DAERAH ISTIMEWA YOGYAKARTA",109,129,128,257
https://kawalpemilu.org#42262,"CONDONGCATUR, DEPOK, SLEMAN, DAERAH ISTIMEWA YOGYAKARTA",110,89,71,160
https://kawalpemilu.org#42262,"CONDONGCATUR, DEPOK, SLEMAN, DAERAH ISTIMEWA YOGYAKARTA",111,53,129,182
https://kawalpemilu.org#42262,"CONDONGCATUR, DEPOK, SLEMAN, DAERAH ISTIMEWA YOGYAKARTA",112,142,46,188
https://kawalpemilu.org#42262,"CONDONGCATUR, DEPOK, SLEMAN, DAERAH ISTIMEWA YOGYAKARTA",113,162,50,212
https://kawalpemilu.org#42262,"CONDONGCATUR, DEPOK, SLEMAN, DAERAH ISTIMEWA YOGYAKARTA",114,146,40,186
https://kawalpemilu.org#42262,"CONDONGCATUR, DEPOK, SLEMAN, DAERAH ISTIMEWA YOGYAKARTA",115,152,25,177
https://kawalpemilu.org#42262,"CONDONGCATUR, DEPOK, SLEMAN, DAERAH ISTIMEWA YOGYAKARTA",116,136,67,203
https://kawalpemilu.org#42262,"CONDONGCATUR, DEPOK, SLEMAN, DAERAH ISTIMEWA YOGYAKARTA",117,67,82,149
https://kawalpemilu.org#42262,"CONDONGCATUR, DEPOK, SLEMAN, DAERAH ISTIMEWA YOGYAKARTA",118,154,44,198
https://kawalpemilu.org#42262,"CONDONGCATUR, DEPOK, SLEMAN, DAERAH ISTIMEWA YOGYAKARTA",119,120,74,194
https://kawalpemilu.org#42262,"CONDONGCATUR, DEPOK, SLEMAN, DAERAH ISTIMEWA YOGYAKARTA",120,135,69,204
https://kawalpemilu.org#42262,"CONDONGCATUR, DEPOK, SLEMAN, DAERAH ISTIMEWA YOGYAKARTA",121,147,88,235
https://kawalpemilu.org#42262,"CONDONGCATUR, DEPOK, SLEMAN, DAERAH ISTIMEWA YOGYAKARTA",122,136,53,189
https://kawalpemilu.org#42262,"CONDONGCATUR, DEPOK, SLEMAN, DAERAH ISTIMEWA YOGYAKARTA",123,158,80,238
https://kawalpemilu.org#42262,"CONDONGCATUR, DEPOK, SLEMAN, DAERAH ISTIMEWA YOGYAKARTA",124,154,61,215
https://kawalpemilu.org#42262,"CONDONGCATUR, DEPOK, SLEMAN, DAERAH ISTIMEWA YOGYAKARTA",125,157,47,204
https://kawalpemilu.org#42262,"CONDONGCATUR, DEPOK, SLEMAN, DAERAH ISTIMEWA YOGYAKARTA",126,154,34,188
https://kawalpemilu.org#42262,"CONDONGCATUR, DEPOK, SLEMAN, DAERAH ISTIMEWA YOGYAKARTA",127,217,14,231
https://kawalpemilu.org#42262,"CONDONGCATUR, DEPOK, SLEMAN, DAERAH ISTIMEWA YOGYAKARTA",128,193,60,253
https://kawalpemilu.org#42262,"CONDONGCATUR, DEPOK, SLEMAN, DAERAH ISTIMEWA YOGYAKARTA",129,120,119,239
https://kawalpemilu.org#42262,"CONDONGCATUR, DEPOK, SLEMAN, DAERAH ISTIMEWA YOGYAKARTA",130,144,60,204
https://kawalpemilu.org#42262,"CONDONGCATUR, DEPOK, SLEMAN, DAERAH ISTIMEWA YOGYAKARTA",131,168,49,217
https://kawalpemilu.org#42262,"CONDONGCATUR, DEPOK, SLEMAN, DAERAH ISTIMEWA YOGYAKARTA",132,155,45,200
https://kawalpemilu.org#42262,"CONDONGCATUR, DEPOK, SLEMAN, DAERAH ISTIMEWA YOGYAKARTA",133,158,73,231
https://kawalpemilu.org#42264,"SENDANGTIRTO, BERBAH, SLEMAN, DAERAH ISTIMEWA YOGYAKARTA",1,113,64,177
https://kawalpemilu.org#42264,"SENDANGTIRTO, BERBAH, SLEMAN, DAERAH ISTIMEWA YOGYAKARTA",3,121,61,182
https://kawalpemilu.org#42264,"SENDANGTIRTO, BERBAH, SLEMAN, DAERAH ISTIMEWA YOGYAKARTA",4,109,120,229
https://kawalpemilu.org#42264,"SENDANGTIRTO, BERBAH, SLEMAN, DAERAH ISTIMEWA YOGYAKARTA",5,84,128,212
https://kawalpemilu.org#42264,"SENDANGTIRTO, BERBAH, SLEMAN, DAERAH ISTIMEWA YOGYAKARTA",6,124,112,236
https://kawalpemilu.org#42264,"SENDANGTIRTO, BERBAH, SLEMAN, DAERAH ISTIMEWA YOGYAKARTA",7,92,152,244
https://kawalpemilu.org#42264,"SENDANGTIRTO, BERBAH, SLEMAN, DAERAH ISTIMEWA YOGYAKARTA",8,101,136,237
https://kawalpemilu.org#42264,"SENDANGTIRTO, BERBAH, SLEMAN, DAERAH ISTIMEWA YOGYAKARTA",9,61,149,210
https://kawalpemilu.org#42264,"SENDANGTIRTO, BERBAH, SLEMAN, DAERAH ISTIMEWA YOGYAKARTA",10,105,118,223
https://kawalpemilu.org#42264,"SENDANGTIRTO, BERBAH, SLEMAN, DAERAH ISTIMEWA YOGYAKARTA",11,159,49,208
https://kawalpemilu.org#42264,"SENDANGTIRTO, BERBAH, SLEMAN, DAERAH ISTIMEWA YOGYAKARTA",12,86,119,205
https://kawalpemilu.org#42264,"SENDANGTIRTO, BERBAH, SLEMAN, DAERAH ISTIMEWA YOGYAKARTA",13,126,63,189
https://kawalpemilu.org#42264,"SENDANGTIRTO, BERBAH, SLEMAN, DAERAH ISTIMEWA YOGYAKARTA",14,99,87,186
https://kawalpemilu.org#42264,"SENDANGTIRTO, BERBAH, SLEMAN, DAERAH ISTIMEWA YOGYAKARTA",15,93,95,188
https://kawalpemilu.org#42264,"SENDANGTIRTO, BERBAH, SLEMAN, DAERAH ISTIMEWA YOGYAKARTA",16,160,45,205
https://kawalpemilu.org#42264,"SENDANGTIRTO, BERBAH, SLEMAN, DAERAH ISTIMEWA YOGYAKARTA",17,150,59,209
https://kawalpemilu.org#42264,"SENDANGTIRTO, BERBAH, SLEMAN, DAERAH ISTIMEWA YOGYAKARTA",19,184,58,242
https://kawalpemilu.org#42264,"SENDANGTIRTO, BERBAH, SLEMAN, DAERAH ISTIMEWA YOGYAKARTA",20,131,71,202
https://kawalpemilu.org#42264,"SENDANGTIRTO, BERBAH, SLEMAN, DAERAH ISTIMEWA YOGYAKARTA",21,135,64,199
https://kawalpemilu.org#42264,"SENDANGTIRTO, BERBAH, SLEMAN, DAERAH ISTIMEWA YOGYAKARTA",22,181,49,230
https://kawalpemilu.org#42264,"SENDANGTIRTO, BERBAH, SLEMAN, DAERAH ISTIMEWA YOGYAKARTA",23,145,86,231
https://kawalpemilu.org#42264,"SENDANGTIRTO, BERBAH, SLEMAN, DAERAH ISTIMEWA YOGYAKARTA",24,146,49,195
https://kawalpemilu.org#42264,"SENDANGTIRTO, BERBAH, SLEMAN, DAERAH ISTIMEWA YOGYAKARTA",25,119,71,190
https://kawalpemilu.org#42264,"SENDANGTIRTO, BERBAH, SLEMAN, DAERAH ISTIMEWA YOGYAKARTA",26,148,77,225
https://kawalpemilu.org#42264,"SENDANGTIRTO, BERBAH, SLEMAN, DAERAH ISTIMEWA YOGYAKARTA",27,113,95,208
https://kawalpemilu.org#42264,"SENDANGTIRTO, BERBAH, SLEMAN, DAERAH ISTIMEWA YOGYAKARTA",28,87,75,163
https://kawalpemilu.org#42264,"SENDANGTIRTO, BERBAH, SLEMAN, DAERAH ISTIMEWA YOGYAKARTA",29,109,67,176
https://kawalpemilu.org#42264,"SENDANGTIRTO, BERBAH, SLEMAN, DAERAH ISTIMEWA YOGYAKARTA",30,135,59,194
https://kawalpemilu.org#42264,"SENDANGTIRTO, BERBAH, SLEMAN, DAERAH ISTIMEWA YOGYAKARTA",31,131,74,205
https://kawalpemilu.org#42264,"SENDANGTIRTO, BERBAH, SLEMAN, DAERAH ISTIMEWA YOGYAKARTA",32,136,58,194
https://kawalpemilu.org#42264,"SENDANGTIRTO, BERBAH, SLEMAN, DAERAH ISTIMEWA YOGYAKARTA",33,137,67,204
https://kawalpemilu.org#42264,"SENDANGTIRTO, BERBAH, SLEMAN, DAERAH ISTIMEWA YOGYAKARTA",34,155,41,196
https://kawalpemilu.org#42264,"SENDANGTIRTO, BERBAH, SLEMAN, DAERAH ISTIMEWA YOGYAKARTA",35,128,81,209
https://kawalpemilu.org#42264,"SENDANGTIRTO, BERBAH, SLEMAN, DAERAH ISTIMEWA YOGYAKARTA",37,155,47,202
https://kawalpemilu.org#42264,"SENDANGTIRTO, BERBAH, SLEMAN, DAERAH ISTIMEWA YOGYAKARTA",39,154,80,234
https://kawalpemilu.org#42264,"SENDANGTIRTO, BERBAH, SLEMAN, DAERAH ISTIMEWA YOGYAKARTA",40,149,85,234
https://kawalpemilu.org#42264,"SENDANGTIRTO, BERBAH, SLEMAN, DAERAH ISTIMEWA YOGYAKARTA",41,146,72,218
https://kawalpemilu.org#42264,"SENDANGTIRTO, BERBAH, SLEMAN, DAERAH ISTIMEWA YOGYAKARTA",43,179,20,199
https://kawalpemilu.org#42264,"SENDANGTIRTO, BERBAH, SLEMAN, DAERAH ISTIMEWA YOGYAKARTA",44,96,96,192
https://kawalpemilu.org#42264,"SENDANGTIRTO, BERBAH, SLEMAN, DAERAH ISTIMEWA YOGYAKARTA",46,76,99,175
https://kawalpemilu.org#42264,"SENDANGTIRTO, BERBAH, SLEMAN, DAERAH ISTIMEWA YOGYAKARTA",47,109,115,224
https://kawalpemilu.org#42264,"SENDANGTIRTO, BERBAH, SLEMAN, DAERAH ISTIMEWA YOGYAKARTA",48,84,110,194
https://kawalpemilu.org#42264,"SENDANGTIRTO, BERBAH, SLEMAN, DAERAH ISTIMEWA YOGYAKARTA",49,127,52,179
https://kawalpemilu.org#42264,"SENDANGTIRTO, BERBAH, SLEMAN, DAERAH ISTIMEWA YOGYAKARTA",50,156,50,206
https://kawalpemilu.org#42264,"SENDANGTIRTO, BERBAH, SLEMAN, DAERAH ISTIMEWA YOGYAKARTA",51,141,52,193
https://kawalpemilu.org#42264,"SENDANGTIRTO, BERBAH, SLEMAN, DAERAH ISTIMEWA YOGYAKARTA",52,118,84,202
https://kawalpemilu.org#42264,"SENDANGTIRTO, BERBAH, SLEMAN, DAERAH ISTIMEWA YOGYAKARTA",54,161,36,197
https://kawalpemilu.org#42264,"SENDANGTIRTO, BERBAH, SLEMAN, DAERAH ISTIMEWA YOGYAKARTA",55,155,59,214
https://kawalpemilu.org#42264,"SENDANGTIRTO, BERBAH, SLEMAN, DAERAH ISTIMEWA YOGYAKARTA",56,151,52,203
https://kawalpemilu.org#42265,"TEGALTIRTO, BERBAH, SLEMAN, DAERAH ISTIMEWA YOGYAKARTA",1,154,91,245
https://kawalpemilu.org#42265,"TEGALTIRTO, BERBAH, SLEMAN, DAERAH ISTIMEWA YOGYAKARTA",2,117,44,161
https://kawalpemilu.org#42265,"TEGALTIRTO, BERBAH, SLEMAN, DAERAH ISTIMEWA YOGYAKARTA",3,177,58,235
https://kawalpemilu.org#42265,"TEGALTIRTO, BERBAH, SLEMAN, DAERAH ISTIMEWA YOGYAKARTA",4,98,45,143
https://kawalpemilu.org#42265,"TEGALTIRTO, BERBAH, SLEMAN, DAERAH ISTIMEWA YOGYAKARTA",5,103,50,153
https://kawalpemilu.org#42265,"TEGALTIRTO, BERBAH, SLEMAN, DAERAH ISTIMEWA YOGYAKARTA",6,127,75,202
https://kawalpemilu.org#42265,"TEGALTIRTO, BERBAH, SLEMAN, DAERAH ISTIMEWA YOGYAKARTA",7,102,63,165
https://kawalpemilu.org#42265,"TEGALTIRTO, BERBAH, SLEMAN, DAERAH ISTIMEWA YOGYAKARTA",8,119,53,172
https://kawalpemilu.org#42265,"TEGALTIRTO, BERBAH, SLEMAN, DAERAH ISTIMEWA YOGYAKARTA",9,166,48,214
https://kawalpemilu.org#42265,"TEGALTIRTO, BERBAH, SLEMAN, DAERAH ISTIMEWA YOGYAKARTA",10,128,41,169
https://kawalpemilu.org#42265,"TEGALTIRTO, BERBAH, SLEMAN, DAERAH ISTIMEWA YOGYAKARTA",11,136,57,193
https://kawalpemilu.org#42265,"TEGALTIRTO, BERBAH, SLEMAN, DAERAH ISTIMEWA YOGYAKARTA",12,99,60,159
https://kawalpemilu.org#42265,"TEGALTIRTO, BERBAH, SLEMAN, DAERAH ISTIMEWA YOGYAKARTA",13,119,58,177
https://kawalpemilu.org#42265,"TEGALTIRTO, BERBAH, SLEMAN, DAERAH ISTIMEWA YOGYAKARTA",14,115,40,155
https://kawalpemilu.org#42265,"TEGALTIRTO, BERBAH, SLEMAN, DAERAH ISTIMEWA YOGYAKARTA",15,108,112,220
https://kawalpemilu.org#42265,"TEGALTIRTO, BERBAH, SLEMAN, DAERAH ISTIMEWA YOGYAKARTA",16,129,93,222
https://kawalpemilu.org#42265,"TEGALTIRTO, BERBAH, SLEMAN, DAERAH ISTIMEWA YOGYAKARTA",17,147,79,226
https://kawalpemilu.org#42265,"TEGALTIRTO, BERBAH, SLEMAN, DAERAH ISTIMEWA YOGYAKARTA",18,155,60,215
https://kawalpemilu.org#42265,"TEGALTIRTO, BERBAH, SLEMAN, DAERAH ISTIMEWA YOGYAKARTA",19,96,87,183
https://kawalpemilu.org#42265,"TEGALTIRTO, BERBAH, SLEMAN, DAERAH ISTIMEWA YOGYAKARTA",20,124,69,193
https://kawalpemilu.org#42265,"TEGALTIRTO, BERBAH, SLEMAN, DAERAH ISTIMEWA YOGYAKARTA",21,126,39,165
https://kawalpemilu.org#42265,"TEGALTIRTO, BERBAH, SLEMAN, DAERAH ISTIMEWA YOGYAKARTA",22,125,55,180
https://kawalpemilu.org#42265,"TEGALTIRTO, BERBAH, SLEMAN, DAERAH ISTIMEWA YOGYAKARTA",23,96,94,190
https://kawalpemilu.org#42265,"TEGALTIRTO, BERBAH, SLEMAN, DAERAH ISTIMEWA YOGYAKARTA",24,95,74,169
https://kawalpemilu.org#42265,"TEGALTIRTO, BERBAH, SLEMAN, DAERAH ISTIMEWA YOGYAKARTA",25,90,90,180
https://kawalpemilu.org#42265,"TEGALTIRTO, BERBAH, SLEMAN, DAERAH ISTIMEWA YOGYAKARTA",26,86,64,150
https://kawalpemilu.org#42265,"TEGALTIRTO, BERBAH, SLEMAN, DAERAH ISTIMEWA YOGYAKARTA",27,80,59,139
https://kawalpemilu.org#42265,"TEGALTIRTO, BERBAH, SLEMAN, DAERAH ISTIMEWA YOGYAKARTA",28,154,55,209
https://kawalpemilu.org#42265,"TEGALTIRTO, BERBAH, SLEMAN, DAERAH ISTIMEWA YOGYAKARTA",29,141,41,182
https://kawalpemilu.org#42265,"TEGALTIRTO, BERBAH, SLEMAN, DAERAH ISTIMEWA YOGYAKARTA",30,161,46,207
https://kawalpemilu.org#42265,"TEGALTIRTO, BERBAH, SLEMAN, DAERAH ISTIMEWA YOGYAKARTA",31,117,28,145
https://kawalpemilu.org#42265,"TEGALTIRTO, BERBAH, SLEMAN, DAERAH ISTIMEWA YOGYAKARTA",32,176,63,239
https://kawalpemilu.org#42265,"TEGALTIRTO, BERBAH, SLEMAN, DAERAH ISTIMEWA YOGYAKARTA",33,125,51,176
https://kawalpemilu.org#42265,"TEGALTIRTO, BERBAH, SLEMAN, DAERAH ISTIMEWA YOGYAKARTA",34,110,58,168
https://kawalpemilu.org#42265,"TEGALTIRTO, BERBAH, SLEMAN, DAERAH ISTIMEWA YOGYAKARTA",35,167,52,219
https://kawalpemilu.org#42265,"TEGALTIRTO, BERBAH, SLEMAN, DAERAH ISTIMEWA YOGYAKARTA",36,98,40,138
https://kawalpemilu.org#42265,"TEGALTIRTO, BERBAH, SLEMAN, DAERAH ISTIMEWA YOGYAKARTA",37,120,34,154
https://kawalpemilu.org#42265,"TEGALTIRTO, BERBAH, SLEMAN, DAERAH ISTIMEWA YOGYAKARTA",38,86,57,143
https://kawalpemilu.org#42265,"TEGALTIRTO, BERBAH, SLEMAN, DAERAH ISTIMEWA YOGYAKARTA",39,89,46,135
https://kawalpemilu.org#42265,"TEGALTIRTO, BERBAH, SLEMAN, DAERAH ISTIMEWA YOGYAKARTA",40,115,55,170
https://kawalpemilu.org#42265,"TEGALTIRTO, BERBAH, SLEMAN, DAERAH ISTIMEWA YOGYAKARTA",41,139,75,214
https://kawalpemilu.org#42265,"TEGALTIRTO, BERBAH, SLEMAN, DAERAH ISTIMEWA YOGYAKARTA",42,113,77,190
https://kawalpemilu.org#42265,"TEGALTIRTO, BERBAH, SLEMAN, DAERAH ISTIMEWA YOGYAKARTA",43,123,82,205
https://kawalpemilu.org#42265,"TEGALTIRTO, BERBAH, SLEMAN, DAERAH ISTIMEWA YOGYAKARTA",44,152,86,238
https://kawalpemilu.org#42266,"KALITIRTO, BERBAH, SLEMAN, DAERAH ISTIMEWA YOGYAKARTA",1,155,58,213
https://kawalpemilu.org#42266,"KALITIRTO, BERBAH, SLEMAN, DAERAH ISTIMEWA YOGYAKARTA",2,103,32,135
https://kawalpemilu.org#42266,"KALITIRTO, BERBAH, SLEMAN, DAERAH ISTIMEWA YOGYAKARTA",3,151,55,206
https://kawalpemilu.org#42266,"KALITIRTO, BERBAH, SLEMAN, DAERAH ISTIMEWA YOGYAKARTA",4,173,55,228
https://kawalpemilu.org#42266,"KALITIRTO, BERBAH, SLEMAN, DAERAH ISTIMEWA YOGYAKARTA",5,189,46,235
https://kawalpemilu.org#42266,"KALITIRTO, BERBAH, SLEMAN, DAERAH ISTIMEWA YOGYAKARTA",6,125,52,177
https://kawalpemilu.org#42266,"KALITIRTO, BERBAH, SLEMAN, DAERAH ISTIMEWA YOGYAKARTA",7,166,83,249
https://kawalpemilu.org#42266,"KALITIRTO, BERBAH, SLEMAN, DAERAH ISTIMEWA YOGYAKARTA",8,95,29,124
https://kawalpemilu.org#42266,"KALITIRTO, BERBAH, SLEMAN, DAERAH ISTIMEWA YOGYAKARTA",9,190,87,277
https://kawalpemilu.org#42266,"KALITIRTO, BERBAH, SLEMAN, DAERAH ISTIMEWA YOGYAKARTA",10,160,60,220
https://kawalpemilu.org#42266,"KALITIRTO, BERBAH, SLEMAN, DAERAH ISTIMEWA YOGYAKARTA",11,154,69,223
https://kawalpemilu.org#42266,"KALITIRTO, BERBAH, SLEMAN, DAERAH ISTIMEWA YOGYAKARTA",12,155,90,245
https://kawalpemilu.org#42266,"KALITIRTO, BERBAH, SLEMAN, DAERAH ISTIMEWA YOGYAKARTA",13,171,83,254
https://kawalpemilu.org#42266,"KALITIRTO, BERBAH, SLEMAN, DAERAH ISTIMEWA YOGYAKARTA",14,171,74,245
https://kawalpemilu.org#42266,"KALITIRTO, BERBAH, SLEMAN, DAERAH ISTIMEWA YOGYAKARTA",15,120,66,186
https://kawalpemilu.org#42266,"KALITIRTO, BERBAH, SLEMAN, DAERAH ISTIMEWA YOGYAKARTA",16,133,76,209
https://kawalpemilu.org#42266,"KALITIRTO, BERBAH, SLEMAN, DAERAH ISTIMEWA YOGYAKARTA",17,150,59,209
https://kawalpemilu.org#42266,"KALITIRTO, BERBAH, SLEMAN, DAERAH ISTIMEWA YOGYAKARTA",18,173,34,207
https://kawalpemilu.org#42266,"KALITIRTO, BERBAH, SLEMAN, DAERAH ISTIMEWA YOGYAKARTA",19,128,43,171
https://kawalpemilu.org#42266,"KALITIRTO, BERBAH, SLEMAN, DAERAH ISTIMEWA YOGYAKARTA",20,65,40,105
https://kawalpemilu.org#42266,"KALITIRTO, BERBAH, SLEMAN, DAERAH ISTIMEWA YOGYAKARTA",21,142,64,206
https://kawalpemilu.org#42266,"KALITIRTO, BERBAH, SLEMAN, DAERAH ISTIMEWA YOGYAKARTA",22,167,59,226
https://kawalpemilu.org#42266,"KALITIRTO, BERBAH, SLEMAN, DAERAH ISTIMEWA YOGYAKARTA",23,141,73,214
https://kawalpemilu.org#42266,"KALITIRTO, BERBAH, SLEMAN, DAERAH ISTIMEWA YOGYAKARTA",24,134,59,193
https://kawalpemilu.org#42266,"KALITIRTO, BERBAH, SLEMAN, DAERAH ISTIMEWA YOGYAKARTA",25,133,72,205
https://kawalpemilu.org#42266,"KALITIRTO, BERBAH, SLEMAN, DAERAH ISTIMEWA YOGYAKARTA",26,148,76,224
https://kawalpemilu.org#42266,"KALITIRTO, BERBAH, SLEMAN, DAERAH ISTIMEWA YOGYAKARTA",27,138,77,215
https://kawalpemilu.org#42266,"KALITIRTO, BERBAH, SLEMAN, DAERAH ISTIMEWA YOGYAKARTA",28,169,36,205
https://kawalpemilu.org#42266,"KALITIRTO, BERBAH, SLEMAN, DAERAH ISTIMEWA YOGYAKARTA",29,128,42,170
https://kawalpemilu.org#42266,"KALITIRTO, BERBAH, SLEMAN, DAERAH ISTIMEWA YOGYAKARTA",30,153,65,218
https://kawalpemilu.org#42266,"KALITIRTO, BERBAH, SLEMAN, DAERAH ISTIMEWA YOGYAKARTA",31,163,46,209
https://kawalpemilu.org#42266,"KALITIRTO, BERBAH, SLEMAN, DAERAH ISTIMEWA YOGYAKARTA",32,159,53,212
https://kawalpemilu.org#42266,"KALITIRTO, BERBAH, SLEMAN, DAERAH ISTIMEWA YOGYAKARTA",33,137,60,197
https://kawalpemilu.org#42266,"KALITIRTO, BERBAH, SLEMAN, DAERAH ISTIMEWA YOGYAKARTA",34,61,86,147
https://kawalpemilu.org#42266,"KALITIRTO, BERBAH, SLEMAN, DAERAH ISTIMEWA YOGYAKARTA",35,139,16,155
https://kawalpemilu.org#42266,"KALITIRTO, BERBAH, SLEMAN, DAERAH ISTIMEWA YOGYAKARTA",36,151,17,168
https://kawalpemilu.org#42266,"KALITIRTO, BERBAH, SLEMAN, DAERAH ISTIMEWA YOGYAKARTA",37,143,44,187
https://kawalpemilu.org#42266,"KALITIRTO, BERBAH, SLEMAN, DAERAH ISTIMEWA YOGYAKARTA",38,136,28,164
https://kawalpemilu.org#42266,"KALITIRTO, BERBAH, SLEMAN, DAERAH ISTIMEWA YOGYAKARTA",39,145,34,179
https://kawalpemilu.org#42266,"KALITIRTO, BERBAH, SLEMAN, DAERAH ISTIMEWA YOGYAKARTA",40,103,78,181
https://kawalpemilu.org#42266,"KALITIRTO, BERBAH, SLEMAN, DAERAH ISTIMEWA YOGYAKARTA",41,69,119,188
https://kawalpemilu.org#42266,"KALITIRTO, BERBAH, SLEMAN, DAERAH ISTIMEWA YOGYAKARTA",42,104,75,179
https://kawalpemilu.org#42266,"KALITIRTO, BERBAH, SLEMAN, DAERAH ISTIMEWA YOGYAKARTA",43,141,59,200
https://kawalpemilu.org#42266,"KALITIRTO, BERBAH, SLEMAN, DAERAH ISTIMEWA YOGYAKARTA",44,190,43,233
https://kawalpemilu.org#42266,"KALITIRTO, BERBAH, SLEMAN, DAERAH ISTIMEWA YOGYAKARTA",45,116,48,164
https://kawalpemilu.org#42267,"JOGOTIRTO, BERBAH, SLEMAN, DAERAH ISTIMEWA YOGYAKARTA",1,200,25,225
https://kawalpemilu.org#42267,"JOGOTIRTO, BERBAH, SLEMAN, DAERAH ISTIMEWA YOGYAKARTA",2,174,46,220
https://kawalpemilu.org#42267,"JOGOTIRTO, BERBAH, SLEMAN, DAERAH ISTIMEWA YOGYAKARTA",3,207,51,258
https://kawalpemilu.org#42267,"JOGOTIRTO, BERBAH, SLEMAN, DAERAH ISTIMEWA YOGYAKARTA",4,205,72,277
https://kawalpemilu.org#42267,"JOGOTIRTO, BERBAH, SLEMAN, DAERAH ISTIMEWA YOGYAKARTA",5,141,94,235
https://kawalpemilu.org#42267,"JOGOTIRTO, BERBAH, SLEMAN, DAERAH ISTIMEWA YOGYAKARTA",6,150,81,231
https://kawalpemilu.org#42267,"JOGOTIRTO, BERBAH, SLEMAN, DAERAH ISTIMEWA YOGYAKARTA",7,125,36,161
https://kawalpemilu.org#42267,"JOGOTIRTO, BERBAH, SLEMAN, DAERAH ISTIMEWA YOGYAKARTA",8,122,37,159
https://kawalpemilu.org#42267,"JOGOTIRTO, BERBAH, SLEMAN, DAERAH ISTIMEWA YOGYAKARTA",9,104,73,177
https://kawalpemilu.org#42267,"JOGOTIRTO, BERBAH, SLEMAN, DAERAH ISTIMEWA YOGYAKARTA",10,110,63,173
https://kawalpemilu.org#42267,"JOGOTIRTO, BERBAH, SLEMAN, DAERAH ISTIMEWA YOGYAKARTA",11,133,40,173
https://kawalpemilu.org#42267,"JOGOTIRTO, BERBAH, SLEMAN, DAERAH ISTIMEWA YOGYAKARTA",12,114,107,221
https://kawalpemilu.org#42267,"JOGOTIRTO, BERBAH, SLEMAN, DAERAH ISTIMEWA YOGYAKARTA",13,134,61,195
https://kawalpemilu.org#42267,"JOGOTIRTO, BERBAH, SLEMAN, DAERAH ISTIMEWA YOGYAKARTA",14,136,100,236
https://kawalpemilu.org#42267,"JOGOTIRTO, BERBAH, SLEMAN, DAERAH ISTIMEWA YOGYAKARTA",15,118,98,216
https://kawalpemilu.org#42267,"JOGOTIRTO, BERBAH, SLEMAN, DAERAH ISTIMEWA YOGYAKARTA",16,104,57,161
https://kawalpemilu.org#42267,"JOGOTIRTO, BERBAH, SLEMAN, DAERAH ISTIMEWA YOGYAKARTA",17,114,37,151
https://kawalpemilu.org#42267,"JOGOTIRTO, BERBAH, SLEMAN, DAERAH ISTIMEWA YOGYAKARTA",18,169,62,231
https://kawalpemilu.org#42267,"JOGOTIRTO, BERBAH, SLEMAN, DAERAH ISTIMEWA YOGYAKARTA",19,187,53,240
https://kawalpemilu.org#42267,"JOGOTIRTO, BERBAH, SLEMAN, DAERAH ISTIMEWA YOGYAKARTA",20,189,61,250
https://kawalpemilu.org#42267,"JOGOTIRTO, BERBAH, SLEMAN, DAERAH ISTIMEWA YOGYAKARTA",21,168,36,204
https://kawalpemilu.org#42267,"JOGOTIRTO, BERBAH, SLEMAN, DAERAH ISTIMEWA YOGYAKARTA",22,169,78,247
https://kawalpemilu.org#42267,"JOGOTIRTO, BERBAH, SLEMAN, DAERAH ISTIMEWA YOGYAKARTA",23,140,44,184
https://kawalpemilu.org#42267,"JOGOTIRTO, BERBAH, SLEMAN, DAERAH ISTIMEWA YOGYAKARTA",24,134,82,216
https://kawalpemilu.org#42267,"JOGOTIRTO, BERBAH, SLEMAN, DAERAH ISTIMEWA YOGYAKARTA",25,166,76,242
https://kawalpemilu.org#42267,"JOGOTIRTO, BERBAH, SLEMAN, DAERAH ISTIMEWA YOGYAKARTA",27,178,72,250
https://kawalpemilu.org#42267,"JOGOTIRTO, BERBAH, SLEMAN, DAERAH ISTIMEWA YOGYAKARTA",28,197,56,253
https://kawalpemilu.org#42267,"JOGOTIRTO, BERBAH, SLEMAN, DAERAH ISTIMEWA YOGYAKARTA",29,196,66,262
https://kawalpemilu.org#42267,"JOGOTIRTO, BERBAH, SLEMAN, DAERAH ISTIMEWA YOGYAKARTA",30,167,72,239
https://kawalpemilu.org#42267,"JOGOTIRTO, BERBAH, SLEMAN, DAERAH ISTIMEWA YOGYAKARTA",31,136,97,233
https://kawalpemilu.org#42267,"JOGOTIRTO, BERBAH, SLEMAN, DAERAH ISTIMEWA YOGYAKARTA",32,180,61,241
https://kawalpemilu.org#42267,"JOGOTIRTO, BERBAH, SLEMAN, DAERAH ISTIMEWA YOGYAKARTA",33,195,53,248
https://kawalpemilu.org#42269,"SUMBERHARJO, PRAMBANAN, SLEMAN, DAERAH ISTIMEWA YOGYAKARTA",1,166,86,252
https://kawalpemilu.org#42269,"SUMBERHARJO, PRAMBANAN, SLEMAN, DAERAH ISTIMEWA YOGYAKARTA",2,123,111,234
https://kawalpemilu.org#42269,"SUMBERHARJO, PRAMBANAN, SLEMAN, DAERAH ISTIMEWA YOGYAKARTA",3,97,67,164
https://kawalpemilu.org#42269,"SUMBERHARJO, PRAMBANAN, SLEMAN, DAERAH ISTIMEWA YOGYAKARTA",4,145,63,208
https://kawalpemilu.org#42269,"SUMBERHARJO, PRAMBANAN, SLEMAN, DAERAH ISTIMEWA YOGYAKARTA",5,133,30,163
https://kawalpemilu.org#42269,"SUMBERHARJO, PRAMBANAN, SLEMAN, DAERAH ISTIMEWA YOGYAKARTA",6,202,84,286
https://kawalpemilu.org#42269,"SUMBERHARJO, PRAMBANAN, SLEMAN, DAERAH ISTIMEWA YOGYAKARTA",7,187,88,275
https://kawalpemilu.org#42269,"SUMBERHARJO, PRAMBANAN, SLEMAN, DAERAH ISTIMEWA YOGYAKARTA",8,158,86,244
https://kawalpemilu.org#42269,"SUMBERHARJO, PRAMBANAN, SLEMAN, DAERAH ISTIMEWA YOGYAKARTA",9,208,51,259
https://kawalpemilu.org#42269,"SUMBERHARJO, PRAMBANAN, SLEMAN, DAERAH ISTIMEWA YOGYAKARTA",10,202,63,265
https://kawalpemilu.org#42269,"SUMBERHARJO, PRAMBANAN, SLEMAN, DAERAH ISTIMEWA YOGYAKARTA",11,164,59,223
https://kawalpemilu.org#42269,"SUMBERHARJO, PRAMBANAN, SLEMAN, DAERAH ISTIMEWA YOGYAKARTA",12,181,62,243
https://kawalpemilu.org#42269,"SUMBERHARJO, PRAMBANAN, SLEMAN, DAERAH ISTIMEWA YOGYAKARTA",13,149,116,265
https://kawalpemilu.org#42269,"SUMBERHARJO, PRAMBANAN, SLEMAN, DAERAH ISTIMEWA YOGYAKARTA",14,200,44,244
https://kawalpemilu.org#42269,"SUMBERHARJO, PRAMBANAN, SLEMAN, DAERAH ISTIMEWA YOGYAKARTA",15,137,48,185
https://kawalpemilu.org#42269,"SUMBERHARJO, PRAMBANAN, SLEMAN, DAERAH ISTIMEWA YOGYAKARTA",16,132,72,204
https://kawalpemilu.org#42269,"SUMBERHARJO, PRAMBANAN, SLEMAN, DAERAH ISTIMEWA YOGYAKARTA",17,46,149,195
https://kawalpemilu.org#42269,"SUMBERHARJO, PRAMBANAN, SLEMAN, DAERAH ISTIMEWA YOGYAKARTA",18,146,26,172
https://kawalpemilu.org#42269,"SUMBERHARJO, PRAMBANAN, SLEMAN, DAERAH ISTIMEWA YOGYAKARTA",19,146,68,214
https://kawalpemilu.org#42269,"SUMBERHARJO, PRAMBANAN, SLEMAN, DAERAH ISTIMEWA YOGYAKARTA",20,135,47,182
https://kawalpemilu.org#42269,"SUMBERHARJO, PRAMBANAN, SLEMAN, DAERAH ISTIMEWA YOGYAKARTA",21,169,35,204
https://kawalpemilu.org#42269,"SUMBERHARJO, PRAMBANAN, SLEMAN, DAERAH ISTIMEWA YOGYAKARTA",22,115,51,166
https://kawalpemilu.org#42269,"SUMBERHARJO, PRAMBANAN, SLEMAN, DAERAH ISTIMEWA YOGYAKARTA",23,103,63,166
https://kawalpemilu.org#42269,"SUMBERHARJO, PRAMBANAN, SLEMAN, DAERAH ISTIMEWA YOGYAKARTA",24,143,45,188
https://kawalpemilu.org#42269,"SUMBERHARJO, PRAMBANAN, SLEMAN, DAERAH ISTIMEWA YOGYAKARTA",25,232,47,279
https://kawalpemilu.org#42269,"SUMBERHARJO, PRAMBANAN, SLEMAN, DAERAH ISTIMEWA YOGYAKARTA",26,191,57,248
https://kawalpemilu.org#42269,"SUMBERHARJO, PRAMBANAN, SLEMAN, DAERAH ISTIMEWA YOGYAKARTA",27,220,33,253
https://kawalpemilu.org#42269,"SUMBERHARJO, PRAMBANAN, SLEMAN, DAERAH ISTIMEWA YOGYAKARTA",28,80,78,158
https://kawalpemilu.org#42269,"SUMBERHARJO, PRAMBANAN, SLEMAN, DAERAH ISTIMEWA YOGYAKARTA",29,109,53,162
https://kawalpemilu.org#42269,"SUMBERHARJO, PRAMBANAN, SLEMAN, DAERAH ISTIMEWA YOGYAKARTA",30,162,54,216
https://kawalpemilu.org#42269,"SUMBERHARJO, PRAMBANAN, SLEMAN, DAERAH ISTIMEWA YOGYAKARTA",31,91,89,180
https://kawalpemilu.org#42269,"SUMBERHARJO, PRAMBANAN, SLEMAN, DAERAH ISTIMEWA YOGYAKARTA",32,154,47,201
https://kawalpemilu.org#42269,"SUMBERHARJO, PRAMBANAN, SLEMAN, DAERAH ISTIMEWA YOGYAKARTA",33,123,46,169
https://kawalpemilu.org#42269,"SUMBERHARJO, PRAMBANAN, SLEMAN, DAERAH ISTIMEWA YOGYAKARTA",34,126,66,192
https://kawalpemilu.org#42269,"SUMBERHARJO, PRAMBANAN, SLEMAN, DAERAH ISTIMEWA YOGYAKARTA",35,93,51,144
https://kawalpemilu.org#42269,"SUMBERHARJO, PRAMBANAN, SLEMAN, DAERAH ISTIMEWA YOGYAKARTA",36,139,45,184
https://kawalpemilu.org#42269,"SUMBERHARJO, PRAMBANAN, SLEMAN, DAERAH ISTIMEWA YOGYAKARTA",37,132,58,190
https://kawalpemilu.org#42269,"SUMBERHARJO, PRAMBANAN, SLEMAN, DAERAH ISTIMEWA YOGYAKARTA",38,99,48,147
https://kawalpemilu.org#42269,"SUMBERHARJO, PRAMBANAN, SLEMAN, DAERAH ISTIMEWA YOGYAKARTA",39,154,28,182
https://kawalpemilu.org#42269,"SUMBERHARJO, PRAMBANAN, SLEMAN, DAERAH ISTIMEWA YOGYAKARTA",40,101,18,119
https://kawalpemilu.org#42269,"SUMBERHARJO, PRAMBANAN, SLEMAN, DAERAH ISTIMEWA YOGYAKARTA",41,155,12,167
https://kawalpemilu.org#42269,"SUMBERHARJO, PRAMBANAN, SLEMAN, DAERAH ISTIMEWA YOGYAKARTA",42,152,17,169
https://kawalpemilu.org#42269,"SUMBERHARJO, PRAMBANAN, SLEMAN, DAERAH ISTIMEWA YOGYAKARTA",43,186,30,216
https://kawalpemilu.org#42269,"SUMBERHARJO, PRAMBANAN, SLEMAN, DAERAH ISTIMEWA YOGYAKARTA",44,206,19,225
https://kawalpemilu.org#42269,"SUMBERHARJO, PRAMBANAN, SLEMAN, DAERAH ISTIMEWA YOGYAKARTA",45,120,47,167
https://kawalpemilu.org#42269,"SUMBERHARJO, PRAMBANAN, SLEMAN, DAERAH ISTIMEWA YOGYAKARTA",46,207,39,246
https://kawalpemilu.org#42269,"SUMBERHARJO, PRAMBANAN, SLEMAN, DAERAH ISTIMEWA YOGYAKARTA",47,173,80,253
https://kawalpemilu.org#42270,"WUKIRHARJO, PRAMBANAN, SLEMAN, DAERAH ISTIMEWA YOGYAKARTA",1,154,28,182
https://kawalpemilu.org#42270,"WUKIRHARJO, PRAMBANAN, SLEMAN, DAERAH ISTIMEWA YOGYAKARTA",2,199,31,230
https://kawalpemilu.org#42270,"WUKIRHARJO, PRAMBANAN, SLEMAN, DAERAH ISTIMEWA YOGYAKARTA",3,108,85,193
https://kawalpemilu.org#42270,"WUKIRHARJO, PRAMBANAN, SLEMAN, DAERAH ISTIMEWA YOGYAKARTA",4,164,47,211
https://kawalpemilu.org#42270,"WUKIRHARJO, PRAMBANAN, SLEMAN, DAERAH ISTIMEWA YOGYAKARTA",5,122,62,184
https://kawalpemilu.org#42270,"WUKIRHARJO, PRAMBANAN, SLEMAN, DAERAH ISTIMEWA YOGYAKARTA",6,191,46,237
https://kawalpemilu.org#42270,"WUKIRHARJO, PRAMBANAN, SLEMAN, DAERAH ISTIMEWA YOGYAKARTA",7,175,32,207
https://kawalpemilu.org#42270,"WUKIRHARJO, PRAMBANAN, SLEMAN, DAERAH ISTIMEWA YOGYAKARTA",8,145,38,183
https://kawalpemilu.org#42270,"WUKIRHARJO, PRAMBANAN, SLEMAN, DAERAH ISTIMEWA YOGYAKARTA",9,119,75,194
https://kawalpemilu.org#42271,"GAYAMHARJO, PRAMBANAN, SLEMAN, DAERAH ISTIMEWA YOGYAKARTA",1,170,57,227
https://kawalpemilu.org#42271,"GAYAMHARJO, PRAMBANAN, SLEMAN, DAERAH ISTIMEWA YOGYAKARTA",2,146,99,245
https://kawalpemilu.org#42271,"GAYAMHARJO, PRAMBANAN, SLEMAN, DAERAH ISTIMEWA YOGYAKARTA",3,167,3,170
https://kawalpemilu.org#42271,"GAYAMHARJO, PRAMBANAN, SLEMAN, DAERAH ISTIMEWA YOGYAKARTA",4,148,5,153
https://kawalpemilu.org#42271,"GAYAMHARJO, PRAMBANAN, SLEMAN, DAERAH ISTIMEWA YOGYAKARTA",5,75,36,111
https://kawalpemilu.org#42271,"GAYAMHARJO, PRAMBANAN, SLEMAN, DAERAH ISTIMEWA YOGYAKARTA",6,156,7,163
https://kawalpemilu.org#42271,"GAYAMHARJO, PRAMBANAN, SLEMAN, DAERAH ISTIMEWA YOGYAKARTA",7,142,7,149
https://kawalpemilu.org#42271,"GAYAMHARJO, PRAMBANAN, SLEMAN, DAERAH ISTIMEWA YOGYAKARTA",8,177,17,194
https://kawalpemilu.org#42271,"GAYAMHARJO, PRAMBANAN, SLEMAN, DAERAH ISTIMEWA YOGYAKARTA",9,169,35,204
https://kawalpemilu.org#42271,"GAYAMHARJO, PRAMBANAN, SLEMAN, DAERAH ISTIMEWA YOGYAKARTA",10,138,27,165
https://kawalpemilu.org#42271,"GAYAMHARJO, PRAMBANAN, SLEMAN, DAERAH ISTIMEWA YOGYAKARTA",11,109,45,154
https://kawalpemilu.org#42271,"GAYAMHARJO, PRAMBANAN, SLEMAN, DAERAH ISTIMEWA YOGYAKARTA",12,109,66,175
https://kawalpemilu.org#42271,"GAYAMHARJO, PRAMBANAN, SLEMAN, DAERAH ISTIMEWA YOGYAKARTA",13,150,70,220
https://kawalpemilu.org#42271,"GAYAMHARJO, PRAMBANAN, SLEMAN, DAERAH ISTIMEWA YOGYAKARTA",14,131,46,177
https://kawalpemilu.org#42271,"GAYAMHARJO, PRAMBANAN, SLEMAN, DAERAH ISTIMEWA YOGYAKARTA",15,56,62,118
https://kawalpemilu.org#42271,"GAYAMHARJO, PRAMBANAN, SLEMAN, DAERAH ISTIMEWA YOGYAKARTA",16,150,66,216
https://kawalpemilu.org#42271,"GAYAMHARJO, PRAMBANAN, SLEMAN, DAERAH ISTIMEWA YOGYAKARTA",17,94,68,162
https://kawalpemilu.org#42272,"SAMBIREJO, PRAMBANAN, SLEMAN, DAERAH ISTIMEWA YOGYAKARTA",1,169,56,225
https://kawalpemilu.org#42272,"SAMBIREJO, PRAMBANAN, SLEMAN, DAERAH ISTIMEWA YOGYAKARTA",2,118,46,164
https://kawalpemilu.org#42272,"SAMBIREJO, PRAMBANAN, SLEMAN, DAERAH ISTIMEWA YOGYAKARTA",3,139,27,166
https://kawalpemilu.org#42272,"SAMBIREJO, PRAMBANAN, SLEMAN, DAERAH ISTIMEWA YOGYAKARTA",4,213,41,254
https://kawalpemilu.org#42272,"SAMBIREJO, PRAMBANAN, SLEMAN, DAERAH ISTIMEWA YOGYAKARTA",5,204,39,243
https://kawalpemilu.org#42272,"SAMBIREJO, PRAMBANAN, SLEMAN, DAERAH ISTIMEWA YOGYAKARTA",6,214,30,244
https://kawalpemilu.org#42272,"SAMBIREJO, PRAMBANAN, SLEMAN, DAERAH ISTIMEWA YOGYAKARTA",7,157,53,210
https://kawalpemilu.org#42272,"SAMBIREJO, PRAMBANAN, SLEMAN, DAERAH ISTIMEWA YOGYAKARTA",8,134,27,161
https://kawalpemilu.org#42272,"SAMBIREJO, PRAMBANAN, SLEMAN, DAERAH ISTIMEWA YOGYAKARTA",9,140,29,169
https://kawalpemilu.org#42272,"SAMBIREJO, PRAMBANAN, SLEMAN, DAERAH ISTIMEWA YOGYAKARTA",10,212,55,267
https://kawalpemilu.org#42272,"SAMBIREJO, PRAMBANAN, SLEMAN, DAERAH ISTIMEWA YOGYAKARTA",11,164,61,225
https://kawalpemilu.org#42272,"SAMBIREJO, PRAMBANAN, SLEMAN, DAERAH ISTIMEWA YOGYAKARTA",12,160,52,212
https://kawalpemilu.org#42272,"SAMBIREJO, PRAMBANAN, SLEMAN, DAERAH ISTIMEWA YOGYAKARTA",13,129,100,229
https://kawalpemilu.org#42272,"SAMBIREJO, PRAMBANAN, SLEMAN, DAERAH ISTIMEWA YOGYAKARTA",14,210,51,261
https://kawalpemilu.org#42272,"SAMBIREJO, PRAMBANAN, SLEMAN, DAERAH ISTIMEWA YOGYAKARTA",15,182,47,229
https://kawalpemilu.org#42272,"SAMBIREJO, PRAMBANAN, SLEMAN, DAERAH ISTIMEWA YOGYAKARTA",16,161,26,187
https://kawalpemilu.org#42272,"SAMBIREJO, PRAMBANAN, SLEMAN, DAERAH ISTIMEWA YOGYAKARTA",17,195,25,220
https://kawalpemilu.org#42272,"SAMBIREJO, PRAMBANAN, SLEMAN, DAERAH ISTIMEWA YOGYAKARTA",18,106,70,176
https://kawalpemilu.org#42273,"MADUREJO, PRAMBANAN, SLEMAN, DAERAH ISTIMEWA YOGYAKARTA",1,101,114,215
https://kawalpemilu.org#42273,"MADUREJO, PRAMBANAN, SLEMAN, DAERAH ISTIMEWA YOGYAKARTA",2,163,42,205
https://kawalpemilu.org#42273,"MADUREJO, PRAMBANAN, SLEMAN, DAERAH ISTIMEWA YOGYAKARTA",3,187,15,202
https://kawalpemilu.org#42273,"MADUREJO, PRAMBANAN, SLEMAN, DAERAH ISTIMEWA YOGYAKARTA",4,150,30,180
https://kawalpemilu.org#42273,"MADUREJO, PRAMBANAN, SLEMAN, DAERAH ISTIMEWA YOGYAKARTA",5,167,77,244
https://kawalpemilu.org#42273,"MADUREJO, PRAMBANAN, SLEMAN, DAERAH ISTIMEWA YOGYAKARTA",6,144,51,195
https://kawalpemilu.org#42273,"MADUREJO, PRAMBANAN, SLEMAN, DAERAH ISTIMEWA YOGYAKARTA",7,121,72,193
https://kawalpemilu.org#42273,"MADUREJO, PRAMBANAN, SLEMAN, DAERAH ISTIMEWA YOGYAKARTA",8,136,54,190
https://kawalpemilu.org#42273,"MADUREJO, PRAMBANAN, SLEMAN, DAERAH ISTIMEWA YOGYAKARTA",9,157,39,196
https://kawalpemilu.org#42273,"MADUREJO, PRAMBANAN, SLEMAN, DAERAH ISTIMEWA YOGYAKARTA",10,112,78,190
https://kawalpemilu.org#42273,"MADUREJO, PRAMBANAN, SLEMAN, DAERAH ISTIMEWA YOGYAKARTA",11,115,74,189
https://kawalpemilu.org#42273,"MADUREJO, PRAMBANAN, SLEMAN, DAERAH ISTIMEWA YOGYAKARTA",12,108,74,182
https://kawalpemilu.org#42273,"MADUREJO, PRAMBANAN, SLEMAN, DAERAH ISTIMEWA YOGYAKARTA",13,77,113,190
https://kawalpemilu.org#42273,"MADUREJO, PRAMBANAN, SLEMAN, DAERAH ISTIMEWA YOGYAKARTA",14,157,31,188
https://kawalpemilu.org#42273,"MADUREJO, PRAMBANAN, SLEMAN, DAERAH ISTIMEWA YOGYAKARTA",15,145,76,221
https://kawalpemilu.org#42273,"MADUREJO, PRAMBANAN, SLEMAN, DAERAH ISTIMEWA YOGYAKARTA",16,135,48,183
https://kawalpemilu.org#42273,"MADUREJO, PRAMBANAN, SLEMAN, DAERAH ISTIMEWA YOGYAKARTA",17,152,37,189
https://kawalpemilu.org#42273,"MADUREJO, PRAMBANAN, SLEMAN, DAERAH ISTIMEWA YOGYAKARTA",18,145,45,190
https://kawalpemilu.org#42273,"MADUREJO, PRAMBANAN, SLEMAN, DAERAH ISTIMEWA YOGYAKARTA",19,111,49,160
https://kawalpemilu.org#42273,"MADUREJO, PRAMBANAN, SLEMAN, DAERAH ISTIMEWA YOGYAKARTA",20,94,79,173
https://kawalpemilu.org#42273,"MADUREJO, PRAMBANAN, SLEMAN, DAERAH ISTIMEWA YOGYAKARTA",21,146,75,221
https://kawalpemilu.org#42273,"MADUREJO, PRAMBANAN, SLEMAN, DAERAH ISTIMEWA YOGYAKARTA",22,139,79,218
https://kawalpemilu.org#42273,"MADUREJO, PRAMBANAN, SLEMAN, DAERAH ISTIMEWA YOGYAKARTA",23,130,104,234
https://kawalpemilu.org#42273,"MADUREJO, PRAMBANAN, SLEMAN, DAERAH ISTIMEWA YOGYAKARTA",24,120,127,247
https://kawalpemilu.org#42273,"MADUREJO, PRAMBANAN, SLEMAN, DAERAH ISTIMEWA YOGYAKARTA",25,159,56,215
https://kawalpemilu.org#42273,"MADUREJO, PRAMBANAN, SLEMAN, DAERAH ISTIMEWA YOGYAKARTA",26,110,70,180
https://kawalpemilu.org#42273,"MADUREJO, PRAMBANAN, SLEMAN, DAERAH ISTIMEWA YOGYAKARTA",27,135,84,219
https://kawalpemilu.org#42273,"MADUREJO, PRAMBANAN, SLEMAN, DAERAH ISTIMEWA YOGYAKARTA",28,150,96,246
https://kawalpemilu.org#42273,"MADUREJO, PRAMBANAN, SLEMAN, DAERAH ISTIMEWA YOGYAKARTA",29,135,97,232
https://kawalpemilu.org#42273,"MADUREJO, PRAMBANAN, SLEMAN, DAERAH ISTIMEWA YOGYAKARTA",30,141,87,228
https://kawalpemilu.org#42273,"MADUREJO, PRAMBANAN, SLEMAN, DAERAH ISTIMEWA YOGYAKARTA",31,108,97,205
https://kawalpemilu.org#42273,"MADUREJO, PRAMBANAN, SLEMAN, DAERAH ISTIMEWA YOGYAKARTA",32,142,41,183
https://kawalpemilu.org#42273,"MADUREJO, PRAMBANAN, SLEMAN, DAERAH ISTIMEWA YOGYAKARTA",33,140,56,196
https://kawalpemilu.org#42273,"MADUREJO, PRAMBANAN, SLEMAN, DAERAH ISTIMEWA YOGYAKARTA",34,124,77,201
https://kawalpemilu.org#42273,"MADUREJO, PRAMBANAN, SLEMAN, DAERAH ISTIMEWA YOGYAKARTA",35,179,68,247
https://kawalpemilu.org#42273,"MADUREJO, PRAMBANAN, SLEMAN, DAERAH ISTIMEWA YOGYAKARTA",36,173,65,238
https://kawalpemilu.org#42273,"MADUREJO, PRAMBANAN, SLEMAN, DAERAH ISTIMEWA YOGYAKARTA",37,138,77,215
https://kawalpemilu.org#42273,"MADUREJO, PRAMBANAN, SLEMAN, DAERAH ISTIMEWA YOGYAKARTA",38,107,72,179
https://kawalpemilu.org#42273,"MADUREJO, PRAMBANAN, SLEMAN, DAERAH ISTIMEWA YOGYAKARTA",39,134,53,187
https://kawalpemilu.org#42273,"MADUREJO, PRAMBANAN, SLEMAN, DAERAH ISTIMEWA YOGYAKARTA",40,155,76,231
https://kawalpemilu.org#42273,"MADUREJO, PRAMBANAN, SLEMAN, DAERAH ISTIMEWA YOGYAKARTA",41,129,63,192
https://kawalpemilu.org#42273,"MADUREJO, PRAMBANAN, SLEMAN, DAERAH ISTIMEWA YOGYAKARTA",42,109,46,155
https://kawalpemilu.org#42273,"MADUREJO, PRAMBANAN, SLEMAN, DAERAH ISTIMEWA YOGYAKARTA",43,131,50,181
https://kawalpemilu.org#42273,"MADUREJO, PRAMBANAN, SLEMAN, DAERAH ISTIMEWA YOGYAKARTA",44,166,27,193
https://kawalpemilu.org#42274,"BOKOHARJO, PRAMBANAN, SLEMAN, DAERAH ISTIMEWA YOGYAKARTA",1,112,83,195
https://kawalpemilu.org#42274,"BOKOHARJO, PRAMBANAN, SLEMAN, DAERAH ISTIMEWA YOGYAKARTA",2,127,117,244
https://kawalpemilu.org#42274,"BOKOHARJO, PRAMBANAN, SLEMAN, DAERAH ISTIMEWA YOGYAKARTA",3,136,72,208
https://kawalpemilu.org#42274,"BOKOHARJO, PRAMBANAN, SLEMAN, DAERAH ISTIMEWA YOGYAKARTA",4,119,81,200
https://kawalpemilu.org#42274,"BOKOHARJO, PRAMBANAN, SLEMAN, DAERAH ISTIMEWA YOGYAKARTA",5,92,56,148
https://kawalpemilu.org#42274,"BOKOHARJO, PRAMBANAN, SLEMAN, DAERAH ISTIMEWA YOGYAKARTA",6,130,97,227
https://kawalpemilu.org#42274,"BOKOHARJO, PRAMBANAN, SLEMAN, DAERAH ISTIMEWA YOGYAKARTA",7,152,87,239
https://kawalpemilu.org#42274,"BOKOHARJO, PRAMBANAN, SLEMAN, DAERAH ISTIMEWA YOGYAKARTA",9,154,53,207
https://kawalpemilu.org#42274,"BOKOHARJO, PRAMBANAN, SLEMAN, DAERAH ISTIMEWA YOGYAKARTA",10,124,66,190
https://kawalpemilu.org#42274,"BOKOHARJO, PRAMBANAN, SLEMAN, DAERAH ISTIMEWA YOGYAKARTA",11,153,57,210
https://kawalpemilu.org#42274,"BOKOHARJO, PRAMBANAN, SLEMAN, DAERAH ISTIMEWA YOGYAKARTA",12,201,41,242
https://kawalpemilu.org#42274,"BOKOHARJO, PRAMBANAN, SLEMAN, DAERAH ISTIMEWA YOGYAKARTA",13,94,71,165
https://kawalpemilu.org#42274,"BOKOHARJO, PRAMBANAN, SLEMAN, DAERAH ISTIMEWA YOGYAKARTA",14,147,69,216
https://kawalpemilu.org#42274,"BOKOHARJO, PRAMBANAN, SLEMAN, DAERAH ISTIMEWA YOGYAKARTA",15,77,76,153
https://kawalpemilu.org#42274,"BOKOHARJO, PRAMBANAN, SLEMAN, DAERAH ISTIMEWA YOGYAKARTA",17,109,115,224
https://kawalpemilu.org#42274,"BOKOHARJO, PRAMBANAN, SLEMAN, DAERAH ISTIMEWA YOGYAKARTA",18,131,108,239
https://kawalpemilu.org#42274,"BOKOHARJO, PRAMBANAN, SLEMAN, DAERAH ISTIMEWA YOGYAKARTA",19,97,57,154
https://kawalpemilu.org#42274,"BOKOHARJO, PRAMBANAN, SLEMAN, DAERAH ISTIMEWA YOGYAKARTA",20,109,111,220
https://kawalpemilu.org#42274,"BOKOHARJO, PRAMBANAN, SLEMAN, DAERAH ISTIMEWA YOGYAKARTA",21,106,104,210
https://kawalpemilu.org#42274,"BOKOHARJO, PRAMBANAN, SLEMAN, DAERAH ISTIMEWA YOGYAKARTA",22,102,120,222
https://kawalpemilu.org#42274,"BOKOHARJO, PRAMBANAN, SLEMAN, DAERAH ISTIMEWA YOGYAKARTA",23,108,101,209
https://kawalpemilu.org#42274,"BOKOHARJO, PRAMBANAN, SLEMAN, DAERAH ISTIMEWA YOGYAKARTA",24,151,80,231
https://kawalpemilu.org#42274,"BOKOHARJO, PRAMBANAN, SLEMAN, DAERAH ISTIMEWA YOGYAKARTA",25,136,117,253
https://kawalpemilu.org#42274,"BOKOHARJO, PRAMBANAN, SLEMAN, DAERAH ISTIMEWA YOGYAKARTA",26,128,106,234
https://kawalpemilu.org#42274,"BOKOHARJO, PRAMBANAN, SLEMAN, DAERAH ISTIMEWA YOGYAKARTA",27,148,80,228
https://kawalpemilu.org#42274,"BOKOHARJO, PRAMBANAN, SLEMAN, DAERAH ISTIMEWA YOGYAKARTA",28,150,96,246
https://kawalpemilu.org#42274,"BOKOHARJO, PRAMBANAN, SLEMAN, DAERAH ISTIMEWA YOGYAKARTA",29,153,92,245
https://kawalpemilu.org#42274,"BOKOHARJO, PRAMBANAN, SLEMAN, DAERAH ISTIMEWA YOGYAKARTA",30,139,81,220
https://kawalpemilu.org#42274,"BOKOHARJO, PRAMBANAN, SLEMAN, DAERAH ISTIMEWA YOGYAKARTA",31,125,82,207
https://kawalpemilu.org#42274,"BOKOHARJO, PRAMBANAN, SLEMAN, DAERAH ISTIMEWA YOGYAKARTA",32,78,62,140
https://kawalpemilu.org#42274,"BOKOHARJO, PRAMBANAN, SLEMAN, DAERAH ISTIMEWA YOGYAKARTA",33,136,82,218
https://kawalpemilu.org#42274,"BOKOHARJO, PRAMBANAN, SLEMAN, DAERAH ISTIMEWA YOGYAKARTA",34,146,73,219
https://kawalpemilu.org#42274,"BOKOHARJO, PRAMBANAN, SLEMAN, DAERAH ISTIMEWA YOGYAKARTA",35,147,61,208
https://kawalpemilu.org#42274,"BOKOHARJO, PRAMBANAN, SLEMAN, DAERAH ISTIMEWA YOGYAKARTA",36,74,91,165
https://kawalpemilu.org#42274,"BOKOHARJO, PRAMBANAN, SLEMAN, DAERAH ISTIMEWA YOGYAKARTA",37,116,67,183
https://kawalpemilu.org#42274,"BOKOHARJO, PRAMBANAN, SLEMAN, DAERAH ISTIMEWA YOGYAKARTA",38,125,54,179
https://kawalpemilu.org#42274,"BOKOHARJO, PRAMBANAN, SLEMAN, DAERAH ISTIMEWA YOGYAKARTA",39,138,71,209
https://kawalpemilu.org#42274,"BOKOHARJO, PRAMBANAN, SLEMAN, DAERAH ISTIMEWA YOGYAKARTA",40,86,57,143
https://kawalpemilu.org#42276,"PURWOMARTANI, KALASAN, SLEMAN, DAERAH ISTIMEWA YOGYAKARTA",1,208,48,256
https://kawalpemilu.org#42276,"PURWOMARTANI, KALASAN, SLEMAN, DAERAH ISTIMEWA YOGYAKARTA",2,196,35,231
https://kawalpemilu.org#42276,"PURWOMARTANI, KALASAN, SLEMAN, DAERAH ISTIMEWA YOGYAKARTA",3,121,47,168
https://kawalpemilu.org#42276,"PURWOMARTANI, KALASAN, SLEMAN, DAERAH ISTIMEWA YOGYAKARTA",4,200,23,223
https://kawalpemilu.org#42276,"PURWOMARTANI, KALASAN, SLEMAN, DAERAH ISTIMEWA YOGYAKARTA",5,138,90,228
https://kawalpemilu.org#42276,"PURWOMARTANI, KALASAN, SLEMAN, DAERAH ISTIMEWA YOGYAKARTA",6,159,66,225
https://kawalpemilu.org#42276,"PURWOMARTANI, KALASAN, SLEMAN, DAERAH ISTIMEWA YOGYAKARTA",7,192,45,237
https://kawalpemilu.org#42276,"PURWOMARTANI, KALASAN, SLEMAN, DAERAH ISTIMEWA YOGYAKARTA",8,131,87,218
https://kawalpemilu.org#42276,"PURWOMARTANI, KALASAN, SLEMAN, DAERAH ISTIMEWA YOGYAKARTA",9,109,69,178
https://kawalpemilu.org#42276,"PURWOMARTANI, KALASAN, SLEMAN, DAERAH ISTIMEWA YOGYAKARTA",10,150,78,228
https://kawalpemilu.org#42276,"PURWOMARTANI, KALASAN, SLEMAN, DAERAH ISTIMEWA YOGYAKARTA",11,133,74,207
https://kawalpemilu.org#42276,"PURWOMARTANI, KALASAN, SLEMAN, DAERAH ISTIMEWA YOGYAKARTA",12,196,81,277
https://kawalpemilu.org#42276,"PURWOMARTANI, KALASAN, SLEMAN, DAERAH ISTIMEWA YOGYAKARTA",13,158,74,232
https://kawalpemilu.org#42276,"PURWOMARTANI, KALASAN, SLEMAN, DAERAH ISTIMEWA YOGYAKARTA",14,170,72,242
https://kawalpemilu.org#42276,"PURWOMARTANI, KALASAN, SLEMAN, DAERAH ISTIMEWA YOGYAKARTA",15,126,79,205
https://kawalpemilu.org#42276,"PURWOMARTANI, KALASAN, SLEMAN, DAERAH ISTIMEWA YOGYAKARTA",16,152,72,224
https://kawalpemilu.org#42276,"PURWOMARTANI, KALASAN, SLEMAN, DAERAH ISTIMEWA YOGYAKARTA",17,183,77,260
https://kawalpemilu.org#42276,"PURWOMARTANI, KALASAN, SLEMAN, DAERAH ISTIMEWA YOGYAKARTA",18,170,86,256
https://kawalpemilu.org#42276,"PURWOMARTANI, KALASAN, SLEMAN, DAERAH ISTIMEWA YOGYAKARTA",19,155,75,230
https://kawalpemilu.org#42276,"PURWOMARTANI, KALASAN, SLEMAN, DAERAH ISTIMEWA YOGYAKARTA",20,152,91,243
https://kawalpemilu.org#42276,"PURWOMARTANI, KALASAN, SLEMAN, DAERAH ISTIMEWA YOGYAKARTA",21,150,74,224
https://kawalpemilu.org#42276,"PURWOMARTANI, KALASAN, SLEMAN, DAERAH ISTIMEWA YOGYAKARTA",22,132,80,212
https://kawalpemilu.org#42276,"PURWOMARTANI, KALASAN, SLEMAN, DAERAH ISTIMEWA YOGYAKARTA",23,180,85,265
https://kawalpemilu.org#42276,"PURWOMARTANI, KALASAN, SLEMAN, DAERAH ISTIMEWA YOGYAKARTA",24,169,49,218
https://kawalpemilu.org#42276,"PURWOMARTANI, KALASAN, SLEMAN, DAERAH ISTIMEWA YOGYAKARTA",25,185,59,244
https://kawalpemilu.org#42276,"PURWOMARTANI, KALASAN, SLEMAN, DAERAH ISTIMEWA YOGYAKARTA",26,155,75,230
https://kawalpemilu.org#42276,"PURWOMARTANI, KALASAN, SLEMAN, DAERAH ISTIMEWA YOGYAKARTA",27,179,74,253
https://kawalpemilu.org#42276,"PURWOMARTANI, KALASAN, SLEMAN, DAERAH ISTIMEWA YOGYAKARTA",28,127,102,229
https://kawalpemilu.org#42276,"PURWOMARTANI, KALASAN, SLEMAN, DAERAH ISTIMEWA YOGYAKARTA",29,121,106,227
https://kawalpemilu.org#42276,"PURWOMARTANI, KALASAN, SLEMAN, DAERAH ISTIMEWA YOGYAKARTA",30,108,117,225
https://kawalpemilu.org#42276,"PURWOMARTANI, KALASAN, SLEMAN, DAERAH ISTIMEWA YOGYAKARTA",31,122,133,255
https://kawalpemilu.org#42276,"PURWOMARTANI, KALASAN, SLEMAN, DAERAH ISTIMEWA YOGYAKARTA",32,95,142,237
https://kawalpemilu.org#42276,"PURWOMARTANI, KALASAN, SLEMAN, DAERAH ISTIMEWA YOGYAKARTA",33,90,73,163
https://kawalpemilu.org#42276,"PURWOMARTANI, KALASAN, SLEMAN, DAERAH ISTIMEWA YOGYAKARTA",34,157,64,221
https://kawalpemilu.org#42276,"PURWOMARTANI, KALASAN, SLEMAN, DAERAH ISTIMEWA YOGYAKARTA",35,148,70,218
https://kawalpemilu.org#42276,"PURWOMARTANI, KALASAN, SLEMAN, DAERAH ISTIMEWA YOGYAKARTA",36,183,47,230
https://kawalpemilu.org#42276,"PURWOMARTANI, KALASAN, SLEMAN, DAERAH ISTIMEWA YOGYAKARTA",37,167,58,225
https://kawalpemilu.org#42276,"PURWOMARTANI, KALASAN, SLEMAN, DAERAH ISTIMEWA YOGYAKARTA",38,191,54,245
https://kawalpemilu.org#42276,"PURWOMARTANI, KALASAN, SLEMAN, DAERAH ISTIMEWA YOGYAKARTA",39,140,82,222
https://kawalpemilu.org#42276,"PURWOMARTANI, KALASAN, SLEMAN, DAERAH ISTIMEWA YOGYAKARTA",40,171,61,232
https://kawalpemilu.org#42276,"PURWOMARTANI, KALASAN, SLEMAN, DAERAH ISTIMEWA YOGYAKARTA",41,148,69,217
https://kawalpemilu.org#42276,"PURWOMARTANI, KALASAN, SLEMAN, DAERAH ISTIMEWA YOGYAKARTA",42,171,68,239
https://kawalpemilu.org#42276,"PURWOMARTANI, KALASAN, SLEMAN, DAERAH ISTIMEWA YOGYAKARTA",43,187,50,237
https://kawalpemilu.org#42276,"PURWOMARTANI, KALASAN, SLEMAN, DAERAH ISTIMEWA YOGYAKARTA",44,144,56,200
https://kawalpemilu.org#42276,"PURWOMARTANI, KALASAN, SLEMAN, DAERAH ISTIMEWA YOGYAKARTA",45,150,83,233
https://kawalpemilu.org#42276,"PURWOMARTANI, KALASAN, SLEMAN, DAERAH ISTIMEWA YOGYAKARTA",46,108,79,187
https://kawalpemilu.org#42276,"PURWOMARTANI, KALASAN, SLEMAN, DAERAH ISTIMEWA YOGYAKARTA",47,148,54,202
https://kawalpemilu.org#42276,"PURWOMARTANI, KALASAN, SLEMAN, DAERAH ISTIMEWA YOGYAKARTA",48,154,65,219
https://kawalpemilu.org#42276,"PURWOMARTANI, KALASAN, SLEMAN, DAERAH ISTIMEWA YOGYAKARTA",49,130,78,208
https://kawalpemilu.org#42276,"PURWOMARTANI, KALASAN, SLEMAN, DAERAH ISTIMEWA YOGYAKARTA",50,137,69,206
https://kawalpemilu.org#42276,"PURWOMARTANI, KALASAN, SLEMAN, DAERAH ISTIMEWA YOGYAKARTA",51,129,69,198
https://kawalpemilu.org#42276,"PURWOMARTANI, KALASAN, SLEMAN, DAERAH ISTIMEWA YOGYAKARTA",52,121,50,171
https://kawalpemilu.org#42276,"PURWOMARTANI, KALASAN, SLEMAN, DAERAH ISTIMEWA YOGYAKARTA",53,109,68,177
https://kawalpemilu.org#42276,"PURWOMARTANI, KALASAN, SLEMAN, DAERAH ISTIMEWA YOGYAKARTA",54,101,33,134
https://kawalpemilu.org#42276,"PURWOMARTANI, KALASAN, SLEMAN, DAERAH ISTIMEWA YOGYAKARTA",55,105,38,143
https://kawalpemilu.org#42276,"PURWOMARTANI, KALASAN, SLEMAN, DAERAH ISTIMEWA YOGYAKARTA",56,153,92,245
https://kawalpemilu.org#42276,"PURWOMARTANI, KALASAN, SLEMAN, DAERAH ISTIMEWA YOGYAKARTA",57,127,99,221
https://kawalpemilu.org#42276,"PURWOMARTANI, KALASAN, SLEMAN, DAERAH ISTIMEWA YOGYAKARTA",58,169,74,243
https://kawalpemilu.org#42276,"PURWOMARTANI, KALASAN, SLEMAN, DAERAH ISTIMEWA YOGYAKARTA",59,162,80,242
https://kawalpemilu.org#42276,"PURWOMARTANI, KALASAN, SLEMAN, DAERAH ISTIMEWA YOGYAKARTA",60,134,59,193
https://kawalpemilu.org#42276,"PURWOMARTANI, KALASAN, SLEMAN, DAERAH ISTIMEWA YOGYAKARTA",61,171,37,208
https://kawalpemilu.org#42276,"PURWOMARTANI, KALASAN, SLEMAN, DAERAH ISTIMEWA YOGYAKARTA",62,154,53,207
https://kawalpemilu.org#42276,"PURWOMARTANI, KALASAN, SLEMAN, DAERAH ISTIMEWA YOGYAKARTA",63,144,90,234
https://kawalpemilu.org#42276,"PURWOMARTANI, KALASAN, SLEMAN, DAERAH ISTIMEWA YOGYAKARTA",64,167,54,221
https://kawalpemilu.org#42276,"PURWOMARTANI, KALASAN, SLEMAN, DAERAH ISTIMEWA YOGYAKARTA",65,176,42,218
https://kawalpemilu.org#42276,"PURWOMARTANI, KALASAN, SLEMAN, DAERAH ISTIMEWA YOGYAKARTA",66,166,34,200
https://kawalpemilu.org#42276,"PURWOMARTANI, KALASAN, SLEMAN, DAERAH ISTIMEWA YOGYAKARTA",67,158,39,197
https://kawalpemilu.org#42276,"PURWOMARTANI, KALASAN, SLEMAN, DAERAH ISTIMEWA YOGYAKARTA",68,165,50,215
https://kawalpemilu.org#42276,"PURWOMARTANI, KALASAN, SLEMAN, DAERAH ISTIMEWA YOGYAKARTA",69,132,28,160
https://kawalpemilu.org#42276,"PURWOMARTANI, KALASAN, SLEMAN, DAERAH ISTIMEWA YOGYAKARTA",70,119,60,179
https://kawalpemilu.org#42276,"PURWOMARTANI, KALASAN, SLEMAN, DAERAH ISTIMEWA YOGYAKARTA",71,111,45,156
https://kawalpemilu.org#42276,"PURWOMARTANI, KALASAN, SLEMAN, DAERAH ISTIMEWA YOGYAKARTA",72,178,49,227
https://kawalpemilu.org#42276,"PURWOMARTANI, KALASAN, SLEMAN, DAERAH ISTIMEWA YOGYAKARTA",73,165,36,201
https://kawalpemilu.org#42276,"PURWOMARTANI, KALASAN, SLEMAN, DAERAH ISTIMEWA YOGYAKARTA",74,161,43,204
https://kawalpemilu.org#42276,"PURWOMARTANI, KALASAN, SLEMAN, DAERAH ISTIMEWA YOGYAKARTA",75,177,65,242
https://kawalpemilu.org#42276,"PURWOMARTANI, KALASAN, SLEMAN, DAERAH ISTIMEWA YOGYAKARTA",76,137,74,211
https://kawalpemilu.org#42276,"PURWOMARTANI, KALASAN, SLEMAN, DAERAH ISTIMEWA YOGYAKARTA",77,162,72,234
https://kawalpemilu.org#42276,"PURWOMARTANI, KALASAN, SLEMAN, DAERAH ISTIMEWA YOGYAKARTA",78,176,54,230
https://kawalpemilu.org#42276,"PURWOMARTANI, KALASAN, SLEMAN, DAERAH ISTIMEWA YOGYAKARTA",79,154,60,214
https://kawalpemilu.org#42276,"PURWOMARTANI, KALASAN, SLEMAN, DAERAH ISTIMEWA YOGYAKARTA",80,161,55,216
https://kawalpemilu.org#42276,"PURWOMARTANI, KALASAN, SLEMAN, DAERAH ISTIMEWA YOGYAKARTA",81,156,38,194
https://kawalpemilu.org#42276,"PURWOMARTANI, KALASAN, SLEMAN, DAERAH ISTIMEWA YOGYAKARTA",82,185,37,222
https://kawalpemilu.org#42276,"PURWOMARTANI, KALASAN, SLEMAN, DAERAH ISTIMEWA YOGYAKARTA",83,123,64,187
https://kawalpemilu.org#42276,"PURWOMARTANI, KALASAN, SLEMAN, DAERAH ISTIMEWA YOGYAKARTA",84,122,71,193
https://kawalpemilu.org#42276,"PURWOMARTANI, KALASAN, SLEMAN, DAERAH ISTIMEWA YOGYAKARTA",85,147,76,223
https://kawalpemilu.org#42276,"PURWOMARTANI, KALASAN, SLEMAN, DAERAH ISTIMEWA YOGYAKARTA",86,183,51,234
https://kawalpemilu.org#42276,"PURWOMARTANI, KALASAN, SLEMAN, DAERAH ISTIMEWA YOGYAKARTA",87,165,56,221
https://kawalpemilu.org#42276,"PURWOMARTANI, KALASAN, SLEMAN, DAERAH ISTIMEWA YOGYAKARTA",88,208,62,270
https://kawalpemilu.org#42276,"PURWOMARTANI, KALASAN, SLEMAN, DAERAH ISTIMEWA YOGYAKARTA",89,223,47,270
https://kawalpemilu.org#42276,"PURWOMARTANI, KALASAN, SLEMAN, DAERAH ISTIMEWA YOGYAKARTA",90,200,51,251
https://kawalpemilu.org#42276,"PURWOMARTANI, KALASAN, SLEMAN, DAERAH ISTIMEWA YOGYAKARTA",91,201,53,254
https://kawalpemilu.org#42276,"PURWOMARTANI, KALASAN, SLEMAN, DAERAH ISTIMEWA YOGYAKARTA",92,200,52,252
https://kawalpemilu.org#42276,"PURWOMARTANI, KALASAN, SLEMAN, DAERAH ISTIMEWA YOGYAKARTA",93,230,47,277
https://kawalpemilu.org#42276,"PURWOMARTANI, KALASAN, SLEMAN, DAERAH ISTIMEWA YOGYAKARTA",94,205,64,269
https://kawalpemilu.org#42276,"PURWOMARTANI, KALASAN, SLEMAN, DAERAH ISTIMEWA YOGYAKARTA",95,182,38,220
https://kawalpemilu.org#42276,"PURWOMARTANI, KALASAN, SLEMAN, DAERAH ISTIMEWA YOGYAKARTA",96,179,49,228
https://kawalpemilu.org#42276,"PURWOMARTANI, KALASAN, SLEMAN, DAERAH ISTIMEWA YOGYAKARTA",97,208,56,264
https://kawalpemilu.org#42276,"PURWOMARTANI, KALASAN, SLEMAN, DAERAH ISTIMEWA YOGYAKARTA",98,242,19,261
https://kawalpemilu.org#42276,"PURWOMARTANI, KALASAN, SLEMAN, DAERAH ISTIMEWA YOGYAKARTA",99,216,60,276
https://kawalpemilu.org#42276,"PURWOMARTANI, KALASAN, SLEMAN, DAERAH ISTIMEWA YOGYAKARTA",100,218,47,265
https://kawalpemilu.org#42276,"PURWOMARTANI, KALASAN, SLEMAN, DAERAH ISTIMEWA YOGYAKARTA",101,225,45,270
https://kawalpemilu.org#42277,"TIRTOMARTANI, KALASAN, SLEMAN, DAERAH ISTIMEWA YOGYAKARTA",1,189,62,251
https://kawalpemilu.org#42277,"TIRTOMARTANI, KALASAN, SLEMAN, DAERAH ISTIMEWA YOGYAKARTA",2,168,89,257
https://kawalpemilu.org#42277,"TIRTOMARTANI, KALASAN, SLEMAN, DAERAH ISTIMEWA YOGYAKARTA",3,87,28,115
https://kawalpemilu.org#42277,"TIRTOMARTANI, KALASAN, SLEMAN, DAERAH ISTIMEWA YOGYAKARTA",4,119,48,167
https://kawalpemilu.org#42277,"TIRTOMARTANI, KALASAN, SLEMAN, DAERAH ISTIMEWA YOGYAKARTA",5,134,130,264
https://kawalpemilu.org#42277,"TIRTOMARTANI, KALASAN, SLEMAN, DAERAH ISTIMEWA YOGYAKARTA",6,143,69,212
https://kawalpemilu.org#42277,"TIRTOMARTANI, KALASAN, SLEMAN, DAERAH ISTIMEWA YOGYAKARTA",7,161,105,266
https://kawalpemilu.org#42277,"TIRTOMARTANI, KALASAN, SLEMAN, DAERAH ISTIMEWA YOGYAKARTA",8,106,67,173
https://kawalpemilu.org#42277,"TIRTOMARTANI, KALASAN, SLEMAN, DAERAH ISTIMEWA YOGYAKARTA",9,110,51,161
https://kawalpemilu.org#42277,"TIRTOMARTANI, KALASAN, SLEMAN, DAERAH ISTIMEWA YOGYAKARTA",10,126,23,149
https://kawalpemilu.org#42277,"TIRTOMARTANI, KALASAN, SLEMAN, DAERAH ISTIMEWA YOGYAKARTA",11,167,59,226
https://kawalpemilu.org#42277,"TIRTOMARTANI, KALASAN, SLEMAN, DAERAH ISTIMEWA YOGYAKARTA",12,179,68,247
https://kawalpemilu.org#42277,"TIRTOMARTANI, KALASAN, SLEMAN, DAERAH ISTIMEWA YOGYAKARTA",13,133,102,235
https://kawalpemilu.org#42277,"TIRTOMARTANI, KALASAN, SLEMAN, DAERAH ISTIMEWA YOGYAKARTA",14,178,39,217
https://kawalpemilu.org#42277,"TIRTOMARTANI, KALASAN, SLEMAN, DAERAH ISTIMEWA YOGYAKARTA",15,142,71,213
https://kawalpemilu.org#42277,"TIRTOMARTANI, KALASAN, SLEMAN, DAERAH ISTIMEWA YOGYAKARTA",16,133,60,193
https://kawalpemilu.org#42277,"TIRTOMARTANI, KALASAN, SLEMAN, DAERAH ISTIMEWA YOGYAKARTA",17,149,54,203
https://kawalpemilu.org#42277,"TIRTOMARTANI, KALASAN, SLEMAN, DAERAH ISTIMEWA YOGYAKARTA",18,180,36,216
https://kawalpemilu.org#42277,"TIRTOMARTANI, KALASAN, SLEMAN, DAERAH ISTIMEWA YOGYAKARTA",19,150,54,204
https://kawalpemilu.org#42277,"TIRTOMARTANI, KALASAN, SLEMAN, DAERAH ISTIMEWA YOGYAKARTA",20,139,57,196
https://kawalpemilu.org#42277,"TIRTOMARTANI, KALASAN, SLEMAN, DAERAH ISTIMEWA YOGYAKARTA",21,138,56,194
https://kawalpemilu.org#42277,"TIRTOMARTANI, KALASAN, SLEMAN, DAERAH ISTIMEWA YOGYAKARTA",22,156,41,197
https://kawalpemilu.org#42277,"TIRTOMARTANI, KALASAN, SLEMAN, DAERAH ISTIMEWA YOGYAKARTA",23,130,64,194
https://kawalpemilu.org#42277,"TIRTOMARTANI, KALASAN, SLEMAN, DAERAH ISTIMEWA YOGYAKARTA",24,124,57,181
https://kawalpemilu.org#42277,"TIRTOMARTANI, KALASAN, SLEMAN, DAERAH ISTIMEWA YOGYAKARTA",25,153,22,175
https://kawalpemilu.org#42277,"TIRTOMARTANI, KALASAN, SLEMAN, DAERAH ISTIMEWA YOGYAKARTA",26,132,101,233
https://kawalpemilu.org#42277,"TIRTOMARTANI, KALASAN, SLEMAN, DAERAH ISTIMEWA YOGYAKARTA",27,89,131,220
https://kawalpemilu.org#42277,"TIRTOMARTANI, KALASAN, SLEMAN, DAERAH ISTIMEWA YOGYAKARTA",28,135,141,276
https://kawalpemilu.org#42277,"TIRTOMARTANI, KALASAN, SLEMAN, DAERAH ISTIMEWA YOGYAKARTA",29,160,57,217
https://kawalpemilu.org#42277,"TIRTOMARTANI, KALASAN, SLEMAN, DAERAH ISTIMEWA YOGYAKARTA",30,165,68,233
https://kawalpemilu.org#42277,"TIRTOMARTANI, KALASAN, SLEMAN, DAERAH ISTIMEWA YOGYAKARTA",31,132,89,221
https://kawalpemilu.org#42277,"TIRTOMARTANI, KALASAN, SLEMAN, DAERAH ISTIMEWA YOGYAKARTA",32,150,66,216
https://kawalpemilu.org#42277,"TIRTOMARTANI, KALASAN, SLEMAN, DAERAH ISTIMEWA YOGYAKARTA",33,135,56,191
https://kawalpemilu.org#42277,"TIRTOMARTANI, KALASAN, SLEMAN, DAERAH ISTIMEWA YOGYAKARTA",34,129,87,216
https://kawalpemilu.org#42277,"TIRTOMARTANI, KALASAN, SLEMAN, DAERAH ISTIMEWA YOGYAKARTA",35,89,93,182
https://kawalpemilu.org#42277,"TIRTOMARTANI, KALASAN, SLEMAN, DAERAH ISTIMEWA YOGYAKARTA",36,119,58,177
https://kawalpemilu.org#42277,"TIRTOMARTANI, KALASAN, SLEMAN, DAERAH ISTIMEWA YOGYAKARTA",37,129,67,196
https://kawalpemilu.org#42277,"TIRTOMARTANI, KALASAN, SLEMAN, DAERAH ISTIMEWA YOGYAKARTA",38,142,49,191
https://kawalpemilu.org#42277,"TIRTOMARTANI, KALASAN, SLEMAN, DAERAH ISTIMEWA YOGYAKARTA",39,156,79,235
https://kawalpemilu.org#42277,"TIRTOMARTANI, KALASAN, SLEMAN, DAERAH ISTIMEWA YOGYAKARTA",40,164,71,235
https://kawalpemilu.org#42277,"TIRTOMARTANI, KALASAN, SLEMAN, DAERAH ISTIMEWA YOGYAKARTA",41,172,96,268
https://kawalpemilu.org#42277,"TIRTOMARTANI, KALASAN, SLEMAN, DAERAH ISTIMEWA YOGYAKARTA",42,162,82,244
https://kawalpemilu.org#42277,"TIRTOMARTANI, KALASAN, SLEMAN, DAERAH ISTIMEWA YOGYAKARTA",43,178,70,248
https://kawalpemilu.org#42277,"TIRTOMARTANI, KALASAN, SLEMAN, DAERAH ISTIMEWA YOGYAKARTA",44,107,106,213
https://kawalpemilu.org#42277,"TIRTOMARTANI, KALASAN, SLEMAN, DAERAH ISTIMEWA YOGYAKARTA",45,123,86,209
https://kawalpemilu.org#42277,"TIRTOMARTANI, KALASAN, SLEMAN, DAERAH ISTIMEWA YOGYAKARTA",46,117,93,210
https://kawalpemilu.org#42277,"TIRTOMARTANI, KALASAN, SLEMAN, DAERAH ISTIMEWA YOGYAKARTA",47,141,113,254
https://kawalpemilu.org#42277,"TIRTOMARTANI, KALASAN, SLEMAN, DAERAH ISTIMEWA YOGYAKARTA",48,125,92,217
https://kawalpemilu.org#42277,"TIRTOMARTANI, KALASAN, SLEMAN, DAERAH ISTIMEWA YOGYAKARTA",49,129,113,242
https://kawalpemilu.org#42277,"TIRTOMARTANI, KALASAN, SLEMAN, DAERAH ISTIMEWA YOGYAKARTA",50,165,92,257
https://kawalpemilu.org#42277,"TIRTOMARTANI, KALASAN, SLEMAN, DAERAH ISTIMEWA YOGYAKARTA",51,115,99,214
https://kawalpemilu.org#42277,"TIRTOMARTANI, KALASAN, SLEMAN, DAERAH ISTIMEWA YOGYAKARTA",52,140,95,235
https://kawalpemilu.org#42277,"TIRTOMARTANI, KALASAN, SLEMAN, DAERAH ISTIMEWA YOGYAKARTA",53,90,56,146
https://kawalpemilu.org#42278,"TAMANMARTANI, KALASAN, SLEMAN, DAERAH ISTIMEWA YOGYAKARTA",1,150,25,175
https://kawalpemilu.org#42278,"TAMANMARTANI, KALASAN, SLEMAN, DAERAH ISTIMEWA YOGYAKARTA",2,118,14,132
https://kawalpemilu.org#42278,"TAMANMARTANI, KALASAN, SLEMAN, DAERAH ISTIMEWA YOGYAKARTA",3,193,13,206
https://kawalpemilu.org#42278,"TAMANMARTANI, KALASAN, SLEMAN, DAERAH ISTIMEWA YOGYAKARTA",4,89,26,115
https://kawalpemilu.org#42278,"TAMANMARTANI, KALASAN, SLEMAN, DAERAH ISTIMEWA YOGYAKARTA",5,82,22,104
https://kawalpemilu.org#42278,"TAMANMARTANI, KALASAN, SLEMAN, DAERAH ISTIMEWA YOGYAKARTA",6,167,82,249
https://kawalpemilu.org#42278,"TAMANMARTANI, KALASAN, SLEMAN, DAERAH ISTIMEWA YOGYAKARTA",7,171,45,216
https://kawalpemilu.org#42278,"TAMANMARTANI, KALASAN, SLEMAN, DAERAH ISTIMEWA YOGYAKARTA",8,142,67,209
https://kawalpemilu.org#42278,"TAMANMARTANI, KALASAN, SLEMAN, DAERAH ISTIMEWA YOGYAKARTA",9,153,75,228
https://kawalpemilu.org#42278,"TAMANMARTANI, KALASAN, SLEMAN, DAERAH ISTIMEWA YOGYAKARTA",10,64,61,125
https://kawalpemilu.org#42278,"TAMANMARTANI, KALASAN, SLEMAN, DAERAH ISTIMEWA YOGYAKARTA",11,117,21,138
https://kawalpemilu.org#42278,"TAMANMARTANI, KALASAN, SLEMAN, DAERAH ISTIMEWA YOGYAKARTA",12,112,34,146
https://kawalpemilu.org#42278,"TAMANMARTANI, KALASAN, SLEMAN, DAERAH ISTIMEWA YOGYAKARTA",13,138,87,225
https://kawalpemilu.org#42278,"TAMANMARTANI, KALASAN, SLEMAN, DAERAH ISTIMEWA YOGYAKARTA",14,168,40,208
https://kawalpemilu.org#42278,"TAMANMARTANI, KALASAN, SLEMAN, DAERAH ISTIMEWA YOGYAKARTA",15,109,20,129
https://kawalpemilu.org#42278,"TAMANMARTANI, KALASAN, SLEMAN, DAERAH ISTIMEWA YOGYAKARTA",16,135,72,207
https://kawalpemilu.org#42278,"TAMANMARTANI, KALASAN, SLEMAN, DAERAH ISTIMEWA YOGYAKARTA",17,195,62,257
https://kawalpemilu.org#42278,"TAMANMARTANI, KALASAN, SLEMAN, DAERAH ISTIMEWA YOGYAKARTA",18,177,68,245
https://kawalpemilu.org#42278,"TAMANMARTANI, KALASAN, SLEMAN, DAERAH ISTIMEWA YOGYAKARTA",19,70,37,107
https://kawalpemilu.org#42278,"TAMANMARTANI, KALASAN, SLEMAN, DAERAH ISTIMEWA YOGYAKARTA",20,203,35,238
https://kawalpemilu.org#42278,"TAMANMARTANI, KALASAN, SLEMAN, DAERAH ISTIMEWA YOGYAKARTA",21,171,93,264
https://kawalpemilu.org#42278,"TAMANMARTANI, KALASAN, SLEMAN, DAERAH ISTIMEWA YOGYAKARTA",22,137,30,167
https://kawalpemilu.org#42278,"TAMANMARTANI, KALASAN, SLEMAN, DAERAH ISTIMEWA YOGYAKARTA",23,149,37,186
https://kawalpemilu.org#42278,"TAMANMARTANI, KALASAN, SLEMAN, DAERAH ISTIMEWA YOGYAKARTA",24,149,38,187
https://kawalpemilu.org#42278,"TAMANMARTANI, KALASAN, SLEMAN, DAERAH ISTIMEWA YOGYAKARTA",25,141,62,203
https://kawalpemilu.org#42278,"TAMANMARTANI, KALASAN, SLEMAN, DAERAH ISTIMEWA YOGYAKARTA",26,120,48,168
https://kawalpemilu.org#42278,"TAMANMARTANI, KALASAN, SLEMAN, DAERAH ISTIMEWA YOGYAKARTA",27,165,37,202
https://kawalpemilu.org#42278,"TAMANMARTANI, KALASAN, SLEMAN, DAERAH ISTIMEWA YOGYAKARTA",28,153,75,228
https://kawalpemilu.org#42278,"TAMANMARTANI, KALASAN, SLEMAN, DAERAH ISTIMEWA YOGYAKARTA",29,155,110,265
https://kawalpemilu.org#42278,"TAMANMARTANI, KALASAN, SLEMAN, DAERAH ISTIMEWA YOGYAKARTA",30,97,66,163
https://kawalpemilu.org#42278,"TAMANMARTANI, KALASAN, SLEMAN, DAERAH ISTIMEWA YOGYAKARTA",31,103,67,170
https://kawalpemilu.org#42278,"TAMANMARTANI, KALASAN, SLEMAN, DAERAH ISTIMEWA YOGYAKARTA",32,141,48,189
https://kawalpemilu.org#42278,"TAMANMARTANI, KALASAN, SLEMAN, DAERAH ISTIMEWA YOGYAKARTA",33,132,70,202
https://kawalpemilu.org#42278,"TAMANMARTANI, KALASAN, SLEMAN, DAERAH ISTIMEWA YOGYAKARTA",34,149,48,197
https://kawalpemilu.org#42278,"TAMANMARTANI, KALASAN, SLEMAN, DAERAH ISTIMEWA YOGYAKARTA",35,124,63,187
https://kawalpemilu.org#42278,"TAMANMARTANI, KALASAN, SLEMAN, DAERAH ISTIMEWA YOGYAKARTA",36,133,86,219
https://kawalpemilu.org#42278,"TAMANMARTANI, KALASAN, SLEMAN, DAERAH ISTIMEWA YOGYAKARTA",37,140,100,240
https://kawalpemilu.org#42278,"TAMANMARTANI, KALASAN, SLEMAN, DAERAH ISTIMEWA YOGYAKARTA",38,80,64,144
https://kawalpemilu.org#42278,"TAMANMARTANI, KALASAN, SLEMAN, DAERAH ISTIMEWA YOGYAKARTA",39,177,46,223
https://kawalpemilu.org#42278,"TAMANMARTANI, KALASAN, SLEMAN, DAERAH ISTIMEWA YOGYAKARTA",40,177,63,240
https://kawalpemilu.org#42278,"TAMANMARTANI, KALASAN, SLEMAN, DAERAH ISTIMEWA YOGYAKARTA",41,164,23,187
https://kawalpemilu.org#42278,"TAMANMARTANI, KALASAN, SLEMAN, DAERAH ISTIMEWA YOGYAKARTA",42,101,42,143
https://kawalpemilu.org#42278,"TAMANMARTANI, KALASAN, SLEMAN, DAERAH ISTIMEWA YOGYAKARTA",43,207,92,299
https://kawalpemilu.org#42278,"TAMANMARTANI, KALASAN, SLEMAN, DAERAH ISTIMEWA YOGYAKARTA",44,100,171,271
https://kawalpemilu.org#42278,"TAMANMARTANI, KALASAN, SLEMAN, DAERAH ISTIMEWA YOGYAKARTA",45,141,107,248
https://kawalpemilu.org#42278,"TAMANMARTANI, KALASAN, SLEMAN, DAERAH ISTIMEWA YOGYAKARTA",46,111,139,245
https://kawalpemilu.org#42278,"TAMANMARTANI, KALASAN, SLEMAN, DAERAH ISTIMEWA YOGYAKARTA",47,157,87,244
https://kawalpemilu.org#42278,"TAMANMARTANI, KALASAN, SLEMAN, DAERAH ISTIMEWA YOGYAKARTA",48,214,56,270
https://kawalpemilu.org#42278,"TAMANMARTANI, KALASAN, SLEMAN, DAERAH ISTIMEWA YOGYAKARTA",49,201,46,247
https://kawalpemilu.org#42278,"TAMANMARTANI, KALASAN, SLEMAN, DAERAH ISTIMEWA YOGYAKARTA",50,106,77,183
https://kawalpemilu.org#42278,"TAMANMARTANI, KALASAN, SLEMAN, DAERAH ISTIMEWA YOGYAKARTA",51,161,36,197
https://kawalpemilu.org#42278,"TAMANMARTANI, KALASAN, SLEMAN, DAERAH ISTIMEWA YOGYAKARTA",52,146,43,189
https://kawalpemilu.org#42278,"TAMANMARTANI, KALASAN, SLEMAN, DAERAH ISTIMEWA YOGYAKARTA",53,128,29,157
https://kawalpemilu.org#42278,"TAMANMARTANI, KALASAN, SLEMAN, DAERAH ISTIMEWA YOGYAKARTA",54,162,23,185
https://kawalpemilu.org#42279,"SELOMARTANI, KALASAN, SLEMAN, DAERAH ISTIMEWA YOGYAKARTA",1,161,62,222
https://kawalpemilu.org#42279,"SELOMARTANI, KALASAN, SLEMAN, DAERAH ISTIMEWA YOGYAKARTA",4,108,42,150
https://kawalpemilu.org#42279,"SELOMARTANI, KALASAN, SLEMAN, DAERAH ISTIMEWA YOGYAKARTA",5,155,45,200
https://kawalpemilu.org#42279,"SELOMARTANI, KALASAN, SLEMAN, DAERAH ISTIMEWA YOGYAKARTA",6,186,56,242
https://kawalpemilu.org#42279,"SELOMARTANI, KALASAN, SLEMAN, DAERAH ISTIMEWA YOGYAKARTA",7,117,36,153
https://kawalpemilu.org#42279,"SELOMARTANI, KALASAN, SLEMAN, DAERAH ISTIMEWA YOGYAKARTA",8,160,94,254
https://kawalpemilu.org#42279,"SELOMARTANI, KALASAN, SLEMAN, DAERAH ISTIMEWA YOGYAKARTA",9,168,89,257
https://kawalpemilu.org#42279,"SELOMARTANI, KALASAN, SLEMAN, DAERAH ISTIMEWA YOGYAKARTA",10,142,55,197
https://kawalpemilu.org#42279,"SELOMARTANI, KALASAN, SLEMAN, DAERAH ISTIMEWA YOGYAKARTA",11,110,81,191
https://kawalpemilu.org#42279,"SELOMARTANI, KALASAN, SLEMAN, DAERAH ISTIMEWA YOGYAKARTA",12,160,63,223
https://kawalpemilu.org#42279,"SELOMARTANI, KALASAN, SLEMAN, DAERAH ISTIMEWA YOGYAKARTA",13,155,44,199
https://kawalpemilu.org#42279,"SELOMARTANI, KALASAN, SLEMAN, DAERAH ISTIMEWA YOGYAKARTA",14,128,67,195
https://kawalpemilu.org#42279,"SELOMARTANI, KALASAN, SLEMAN, DAERAH ISTIMEWA YOGYAKARTA",15,106,90,196
https://kawalpemilu.org#42279,"SELOMARTANI, KALASAN, SLEMAN, DAERAH ISTIMEWA YOGYAKARTA",16,135,80,215
https://kawalpemilu.org#42279,"SELOMARTANI, KALASAN, SLEMAN, DAERAH ISTIMEWA YOGYAKARTA",17,115,53,168
https://kawalpemilu.org#42279,"SELOMARTANI, KALASAN, SLEMAN, DAERAH ISTIMEWA YOGYAKARTA",18,0,0,0
https://kawalpemilu.org#42279,"SELOMARTANI, KALASAN, SLEMAN, DAERAH ISTIMEWA YOGYAKARTA",19,130,40,170
https://kawalpemilu.org#42279,"SELOMARTANI, KALASAN, SLEMAN, DAERAH ISTIMEWA YOGYAKARTA",20,182,79,261
https://kawalpemilu.org#42279,"SELOMARTANI, KALASAN, SLEMAN, DAERAH ISTIMEWA YOGYAKARTA",21,167,42,209
https://kawalpemilu.org#42279,"SELOMARTANI, KALASAN, SLEMAN, DAERAH ISTIMEWA YOGYAKARTA",22,166,61,227
https://kawalpemilu.org#42279,"SELOMARTANI, KALASAN, SLEMAN, DAERAH ISTIMEWA YOGYAKARTA",23,117,87,204
https://kawalpemilu.org#42279,"SELOMARTANI, KALASAN, SLEMAN, DAERAH ISTIMEWA YOGYAKARTA",24,134,83,217
https://kawalpemilu.org#42279,"SELOMARTANI, KALASAN, SLEMAN, DAERAH ISTIMEWA YOGYAKARTA",25,127,35,162
https://kawalpemilu.org#42279,"SELOMARTANI, KALASAN, SLEMAN, DAERAH ISTIMEWA YOGYAKARTA",26,139,43,182
https://kawalpemilu.org#42279,"SELOMARTANI, KALASAN, SLEMAN, DAERAH ISTIMEWA YOGYAKARTA",27,243,20,263
https://kawalpemilu.org#42279,"SELOMARTANI, KALASAN, SLEMAN, DAERAH ISTIMEWA YOGYAKARTA",28,216,54,270
https://kawalpemilu.org#42279,"SELOMARTANI, KALASAN, SLEMAN, DAERAH ISTIMEWA YOGYAKARTA",29,94,28,122
https://kawalpemilu.org#42279,"SELOMARTANI, KALASAN, SLEMAN, DAERAH ISTIMEWA YOGYAKARTA",30,115,44,159
https://kawalpemilu.org#42279,"SELOMARTANI, KALASAN, SLEMAN, DAERAH ISTIMEWA YOGYAKARTA",31,87,74,161
https://kawalpemilu.org#42279,"SELOMARTANI, KALASAN, SLEMAN, DAERAH ISTIMEWA YOGYAKARTA",32,111,57,168
https://kawalpemilu.org#42279,"SELOMARTANI, KALASAN, SLEMAN, DAERAH ISTIMEWA YOGYAKARTA",33,109,66,175
https://kawalpemilu.org#42279,"SELOMARTANI, KALASAN, SLEMAN, DAERAH ISTIMEWA YOGYAKARTA",34,158,26,184
https://kawalpemilu.org#42279,"SELOMARTANI, KALASAN, SLEMAN, DAERAH ISTIMEWA YOGYAKARTA",35,148,50,198
https://kawalpemilu.org#42279,"SELOMARTANI, KALASAN, SLEMAN, DAERAH ISTIMEWA YOGYAKARTA",36,122,78,200
https://kawalpemilu.org#42279,"SELOMARTANI, KALASAN, SLEMAN, DAERAH ISTIMEWA YOGYAKARTA",37,145,35,180
https://kawalpemilu.org#42279,"SELOMARTANI, KALASAN, SLEMAN, DAERAH ISTIMEWA YOGYAKARTA",38,176,34,210
https://kawalpemilu.org#42279,"SELOMARTANI, KALASAN, SLEMAN, DAERAH ISTIMEWA YOGYAKARTA",39,102,42,144
https://kawalpemilu.org#42279,"SELOMARTANI, KALASAN, SLEMAN, DAERAH ISTIMEWA YOGYAKARTA",40,150,46,196
https://kawalpemilu.org#42279,"SELOMARTANI, KALASAN, SLEMAN, DAERAH ISTIMEWA YOGYAKARTA",41,123,20,143
https://kawalpemilu.org#42279,"SELOMARTANI, KALASAN, SLEMAN, DAERAH ISTIMEWA YOGYAKARTA",42,103,66,169
https://kawalpemilu.org#42279,"SELOMARTANI, KALASAN, SLEMAN, DAERAH ISTIMEWA YOGYAKARTA",43,116,69,185
https://kawalpemilu.org#42279,"SELOMARTANI, KALASAN, SLEMAN, DAERAH ISTIMEWA YOGYAKARTA",44,165,45,210
https://kawalpemilu.org#42279,"SELOMARTANI, KALASAN, SLEMAN, DAERAH ISTIMEWA YOGYAKARTA",45,146,32,178
https://kawalpemilu.org#42281,"SINDUMARTANI, NGEMPLAK, SLEMAN, DAERAH ISTIMEWA YOGYAKARTA",1,160,70,230
https://kawalpemilu.org#42281,"SINDUMARTANI, NGEMPLAK, SLEMAN, DAERAH ISTIMEWA YOGYAKARTA",2,171,52,223
https://kawalpemilu.org#42281,"SINDUMARTANI, NGEMPLAK, SLEMAN, DAERAH ISTIMEWA YOGYAKARTA",3,127,121,248
https://kawalpemilu.org#42281,"SINDUMARTANI, NGEMPLAK, SLEMAN, DAERAH ISTIMEWA YOGYAKARTA",4,137,63,200
https://kawalpemilu.org#42281,"SINDUMARTANI, NGEMPLAK, SLEMAN, DAERAH ISTIMEWA YOGYAKARTA",5,133,70,203
https://kawalpemilu.org#42281,"SINDUMARTANI, NGEMPLAK, SLEMAN, DAERAH ISTIMEWA YOGYAKARTA",6,191,31,222
https://kawalpemilu.org#42281,"SINDUMARTANI, NGEMPLAK, SLEMAN, DAERAH ISTIMEWA YOGYAKARTA",7,129,32,161
https://kawalpemilu.org#42281,"SINDUMARTANI, NGEMPLAK, SLEMAN, DAERAH ISTIMEWA YOGYAKARTA",8,152,47,199
https://kawalpemilu.org#42281,"SINDUMARTANI, NGEMPLAK, SLEMAN, DAERAH ISTIMEWA YOGYAKARTA",9,172,51,223
https://kawalpemilu.org#42281,"SINDUMARTANI, NGEMPLAK, SLEMAN, DAERAH ISTIMEWA YOGYAKARTA",10,162,62,224
https://kawalpemilu.org#42281,"SINDUMARTANI, NGEMPLAK, SLEMAN, DAERAH ISTIMEWA YOGYAKARTA",11,141,85,226
https://kawalpemilu.org#42281,"SINDUMARTANI, NGEMPLAK, SLEMAN, DAERAH ISTIMEWA YOGYAKARTA",12,97,118,215
https://kawalpemilu.org#42281,"SINDUMARTANI, NGEMPLAK, SLEMAN, DAERAH ISTIMEWA YOGYAKARTA",13,123,80,203
https://kawalpemilu.org#42281,"SINDUMARTANI, NGEMPLAK, SLEMAN, DAERAH ISTIMEWA YOGYAKARTA",14,117,35,152
https://kawalpemilu.org#42281,"SINDUMARTANI, NGEMPLAK, SLEMAN, DAERAH ISTIMEWA YOGYAKARTA",15,167,50,217
https://kawalpemilu.org#42281,"SINDUMARTANI, NGEMPLAK, SLEMAN, DAERAH ISTIMEWA YOGYAKARTA",16,209,40,249
https://kawalpemilu.org#42281,"SINDUMARTANI, NGEMPLAK, SLEMAN, DAERAH ISTIMEWA YOGYAKARTA",17,170,66,236
https://kawalpemilu.org#42281,"SINDUMARTANI, NGEMPLAK, SLEMAN, DAERAH ISTIMEWA YOGYAKARTA",18,173,71,244
https://kawalpemilu.org#42281,"SINDUMARTANI, NGEMPLAK, SLEMAN, DAERAH ISTIMEWA YOGYAKARTA",19,158,45,203
https://kawalpemilu.org#42281,"SINDUMARTANI, NGEMPLAK, SLEMAN, DAERAH ISTIMEWA YOGYAKARTA",20,144,68,212
https://kawalpemilu.org#42281,"SINDUMARTANI, NGEMPLAK, SLEMAN, DAERAH ISTIMEWA YOGYAKARTA",21,135,71,206
https://kawalpemilu.org#42281,"SINDUMARTANI, NGEMPLAK, SLEMAN, DAERAH ISTIMEWA YOGYAKARTA",22,127,21,148
https://kawalpemilu.org#42281,"SINDUMARTANI, NGEMPLAK, SLEMAN, DAERAH ISTIMEWA YOGYAKARTA",23,148,83,231
https://kawalpemilu.org#42281,"SINDUMARTANI, NGEMPLAK, SLEMAN, DAERAH ISTIMEWA YOGYAKARTA",24,120,68,188
https://kawalpemilu.org#42281,"SINDUMARTANI, NGEMPLAK, SLEMAN, DAERAH ISTIMEWA YOGYAKARTA",25,154,46,200
https://kawalpemilu.org#42282,"BIMOMARTANI, NGEMPLAK, SLEMAN, DAERAH ISTIMEWA YOGYAKARTA",1,160,40,200
https://kawalpemilu.org#42282,"BIMOMARTANI, NGEMPLAK, SLEMAN, DAERAH ISTIMEWA YOGYAKARTA",2,191,59,250
https://kawalpemilu.org#42282,"BIMOMARTANI, NGEMPLAK, SLEMAN, DAERAH ISTIMEWA YOGYAKARTA",3,171,62,233
https://kawalpemilu.org#42282,"BIMOMARTANI, NGEMPLAK, SLEMAN, DAERAH ISTIMEWA YOGYAKARTA",4,168,61,229
https://kawalpemilu.org#42282,"BIMOMARTANI, NGEMPLAK, SLEMAN, DAERAH ISTIMEWA YOGYAKARTA",5,186,45,231
https://kawalpemilu.org#42282,"BIMOMARTANI, NGEMPLAK, SLEMAN, DAERAH ISTIMEWA YOGYAKARTA",6,102,109,211
https://kawalpemilu.org#42282,"BIMOMARTANI, NGEMPLAK, SLEMAN, DAERAH ISTIMEWA YOGYAKARTA",7,72,88,160
https://kawalpemilu.org#42282,"BIMOMARTANI, NGEMPLAK, SLEMAN, DAERAH ISTIMEWA YOGYAKARTA",8,166,83,249
https://kawalpemilu.org#42282,"BIMOMARTANI, NGEMPLAK, SLEMAN, DAERAH ISTIMEWA YOGYAKARTA",9,180,66,246
https://kawalpemilu.org#42282,"BIMOMARTANI, NGEMPLAK, SLEMAN, DAERAH ISTIMEWA YOGYAKARTA",10,170,63,233
https://kawalpemilu.org#42282,"BIMOMARTANI, NGEMPLAK, SLEMAN, DAERAH ISTIMEWA YOGYAKARTA",11,168,40,208
https://kawalpemilu.org#42282,"BIMOMARTANI, NGEMPLAK, SLEMAN, DAERAH ISTIMEWA YOGYAKARTA",12,118,80,198
https://kawalpemilu.org#42282,"BIMOMARTANI, NGEMPLAK, SLEMAN, DAERAH ISTIMEWA YOGYAKARTA",13,107,100,207
https://kawalpemilu.org#42282,"BIMOMARTANI, NGEMPLAK, SLEMAN, DAERAH ISTIMEWA YOGYAKARTA",14,193,35,228
https://kawalpemilu.org#42282,"BIMOMARTANI, NGEMPLAK, SLEMAN, DAERAH ISTIMEWA YOGYAKARTA",15,129,44,173
https://kawalpemilu.org#42282,"BIMOMARTANI, NGEMPLAK, SLEMAN, DAERAH ISTIMEWA YOGYAKARTA",16,159,29,188
https://kawalpemilu.org#42282,"BIMOMARTANI, NGEMPLAK, SLEMAN, DAERAH ISTIMEWA YOGYAKARTA",17,152,41,193
https://kawalpemilu.org#42282,"BIMOMARTANI, NGEMPLAK, SLEMAN, DAERAH ISTIMEWA YOGYAKARTA",18,174,53,227
https://kawalpemilu.org#42282,"BIMOMARTANI, NGEMPLAK, SLEMAN, DAERAH ISTIMEWA YOGYAKARTA",19,197,46,243
https://kawalpemilu.org#42282,"BIMOMARTANI, NGEMPLAK, SLEMAN, DAERAH ISTIMEWA YOGYAKARTA",20,113,113,226
https://kawalpemilu.org#42282,"BIMOMARTANI, NGEMPLAK, SLEMAN, DAERAH ISTIMEWA YOGYAKARTA",21,94,127,221
https://kawalpemilu.org#42282,"BIMOMARTANI, NGEMPLAK, SLEMAN, DAERAH ISTIMEWA YOGYAKARTA",22,161,47,208
https://kawalpemilu.org#42282,"BIMOMARTANI, NGEMPLAK, SLEMAN, DAERAH ISTIMEWA YOGYAKARTA",23,142,63,205
https://kawalpemilu.org#42283,"WIDODOMARTANI, NGEMPLAK, SLEMAN, DAERAH ISTIMEWA YOGYAKARTA",1,142,42,184
https://kawalpemilu.org#42283,"WIDODOMARTANI, NGEMPLAK, SLEMAN, DAERAH ISTIMEWA YOGYAKARTA",2,147,56,203
https://kawalpemilu.org#42283,"WIDODOMARTANI, NGEMPLAK, SLEMAN, DAERAH ISTIMEWA YOGYAKARTA",3,158,36,194
https://kawalpemilu.org#42283,"WIDODOMARTANI, NGEMPLAK, SLEMAN, DAERAH ISTIMEWA YOGYAKARTA",4,133,62,195
https://kawalpemilu.org#42283,"WIDODOMARTANI, NGEMPLAK, SLEMAN, DAERAH ISTIMEWA YOGYAKARTA",5,144,46,190
https://kawalpemilu.org#42283,"WIDODOMARTANI, NGEMPLAK, SLEMAN, DAERAH ISTIMEWA YOGYAKARTA",6,132,89,221
https://kawalpemilu.org#42283,"WIDODOMARTANI, NGEMPLAK, SLEMAN, DAERAH ISTIMEWA YOGYAKARTA",7,96,79,175
https://kawalpemilu.org#42283,"WIDODOMARTANI, NGEMPLAK, SLEMAN, DAERAH ISTIMEWA YOGYAKARTA",8,194,55,249
https://kawalpemilu.org#42283,"WIDODOMARTANI, NGEMPLAK, SLEMAN, DAERAH ISTIMEWA YOGYAKARTA",9,150,101,251
https://kawalpemilu.org#42283,"WIDODOMARTANI, NGEMPLAK, SLEMAN, DAERAH ISTIMEWA YOGYAKARTA",10,133,111,244
https://kawalpemilu.org#42283,"WIDODOMARTANI, NGEMPLAK, SLEMAN, DAERAH ISTIMEWA YOGYAKARTA",11,137,114,251
https://kawalpemilu.org#42283,"WIDODOMARTANI, NGEMPLAK, SLEMAN, DAERAH ISTIMEWA YOGYAKARTA",12,113,60,173
https://kawalpemilu.org#42283,"WIDODOMARTANI, NGEMPLAK, SLEMAN, DAERAH ISTIMEWA YOGYAKARTA",13,123,76,199
https://kawalpemilu.org#42283,"WIDODOMARTANI, NGEMPLAK, SLEMAN, DAERAH ISTIMEWA YOGYAKARTA",14,118,99,217
https://kawalpemilu.org#42283,"WIDODOMARTANI, NGEMPLAK, SLEMAN, DAERAH ISTIMEWA YOGYAKARTA",15,139,47,186
https://kawalpemilu.org#42283,"WIDODOMARTANI, NGEMPLAK, SLEMAN, DAERAH ISTIMEWA YOGYAKARTA",16,91,58,149
https://kawalpemilu.org#42283,"WIDODOMARTANI, NGEMPLAK, SLEMAN, DAERAH ISTIMEWA YOGYAKARTA",17,110,71,181
https://kawalpemilu.org#42283,"WIDODOMARTANI, NGEMPLAK, SLEMAN, DAERAH ISTIMEWA YOGYAKARTA",18,119,89,208
https://kawalpemilu.org#42283,"WIDODOMARTANI, NGEMPLAK, SLEMAN, DAERAH ISTIMEWA YOGYAKARTA",19,111,81,192
https://kawalpemilu.org#42283,"WIDODOMARTANI, NGEMPLAK, SLEMAN, DAERAH ISTIMEWA YOGYAKARTA",20,212,52,264
https://kawalpemilu.org#42283,"WIDODOMARTANI, NGEMPLAK, SLEMAN, DAERAH ISTIMEWA YOGYAKARTA",21,169,61,230
https://kawalpemilu.org#42283,"WIDODOMARTANI, NGEMPLAK, SLEMAN, DAERAH ISTIMEWA YOGYAKARTA",22,183,63,246
https://kawalpemilu.org#42283,"WIDODOMARTANI, NGEMPLAK, SLEMAN, DAERAH ISTIMEWA YOGYAKARTA",23,195,72,267
https://kawalpemilu.org#42283,"WIDODOMARTANI, NGEMPLAK, SLEMAN, DAERAH ISTIMEWA YOGYAKARTA",24,201,62,263
https://kawalpemilu.org#42283,"WIDODOMARTANI, NGEMPLAK, SLEMAN, DAERAH ISTIMEWA YOGYAKARTA",25,153,80,233
https://kawalpemilu.org#42284,"WEDOMARTANI, NGEMPLAK, SLEMAN, DAERAH ISTIMEWA YOGYAKARTA",1,160,95,255
https://kawalpemilu.org#42284,"WEDOMARTANI, NGEMPLAK, SLEMAN, DAERAH ISTIMEWA YOGYAKARTA",2,99,81,180
https://kawalpemilu.org#42284,"WEDOMARTANI, NGEMPLAK, SLEMAN, DAERAH ISTIMEWA YOGYAKARTA",3,189,30,219
https://kawalpemilu.org#42284,"WEDOMARTANI, NGEMPLAK, SLEMAN, DAERAH ISTIMEWA YOGYAKARTA",4,121,88,209
https://kawalpemilu.org#42284,"WEDOMARTANI, NGEMPLAK, SLEMAN, DAERAH ISTIMEWA YOGYAKARTA",5,149,48,197
https://kawalpemilu.org#42284,"WEDOMARTANI, NGEMPLAK, SLEMAN, DAERAH ISTIMEWA YOGYAKARTA",6,201,16,217
https://kawalpemilu.org#42284,"WEDOMARTANI, NGEMPLAK, SLEMAN, DAERAH ISTIMEWA YOGYAKARTA",7,145,103,248
https://kawalpemilu.org#42284,"WEDOMARTANI, NGEMPLAK, SLEMAN, DAERAH ISTIMEWA YOGYAKARTA",8,167,89,256
https://kawalpemilu.org#42284,"WEDOMARTANI, NGEMPLAK, SLEMAN, DAERAH ISTIMEWA YOGYAKARTA",9,185,45,230
https://kawalpemilu.org#42284,"WEDOMARTANI, NGEMPLAK, SLEMAN, DAERAH ISTIMEWA YOGYAKARTA",10,190,39,229
https://kawalpemilu.org#42284,"WEDOMARTANI, NGEMPLAK, SLEMAN, DAERAH ISTIMEWA YOGYAKARTA",11,167,86,253
https://kawalpemilu.org#42284,"WEDOMARTANI, NGEMPLAK, SLEMAN, DAERAH ISTIMEWA YOGYAKARTA",12,141,53,194
https://kawalpemilu.org#42284,"WEDOMARTANI, NGEMPLAK, SLEMAN, DAERAH ISTIMEWA YOGYAKARTA",13,184,44,228
https://kawalpemilu.org#42284,"WEDOMARTANI, NGEMPLAK, SLEMAN, DAERAH ISTIMEWA YOGYAKARTA",14,110,70,180
https://kawalpemilu.org#42284,"WEDOMARTANI, NGEMPLAK, SLEMAN, DAERAH ISTIMEWA YOGYAKARTA",15,121,48,169
https://kawalpemilu.org#42284,"WEDOMARTANI, NGEMPLAK, SLEMAN, DAERAH ISTIMEWA YOGYAKARTA",16,135,70,205
https://kawalpemilu.org#42284,"WEDOMARTANI, NGEMPLAK, SLEMAN, DAERAH ISTIMEWA YOGYAKARTA",17,165,76,241
https://kawalpemilu.org#42284,"WEDOMARTANI, NGEMPLAK, SLEMAN, DAERAH ISTIMEWA YOGYAKARTA",18,160,98,258
https://kawalpemilu.org#42284,"WEDOMARTANI, NGEMPLAK, SLEMAN, DAERAH ISTIMEWA YOGYAKARTA",19,178,71,249
https://kawalpemilu.org#42284,"WEDOMARTANI, NGEMPLAK, SLEMAN, DAERAH ISTIMEWA YOGYAKARTA",20,126,65,191
https://kawalpemilu.org#42284,"WEDOMARTANI, NGEMPLAK, SLEMAN, DAERAH ISTIMEWA YOGYAKARTA",21,158,84,242
https://kawalpemilu.org#42284,"WEDOMARTANI, NGEMPLAK, SLEMAN, DAERAH ISTIMEWA YOGYAKARTA",22,146,72,218
https://kawalpemilu.org#42284,"WEDOMARTANI, NGEMPLAK, SLEMAN, DAERAH ISTIMEWA YOGYAKARTA",23,147,100,247
https://kawalpemilu.org#42284,"WEDOMARTANI, NGEMPLAK, SLEMAN, DAERAH ISTIMEWA YOGYAKARTA",24,153,77,230
https://kawalpemilu.org#42284,"WEDOMARTANI, NGEMPLAK, SLEMAN, DAERAH ISTIMEWA YOGYAKARTA",25,174,92,266
https://kawalpemilu.org#42284,"WEDOMARTANI, NGEMPLAK, SLEMAN, DAERAH ISTIMEWA YOGYAKARTA",26,181,64,245
https://kawalpemilu.org#42284,"WEDOMARTANI, NGEMPLAK, SLEMAN, DAERAH ISTIMEWA YOGYAKARTA",27,162,87,249
https://kawalpemilu.org#42284,"WEDOMARTANI, NGEMPLAK, SLEMAN, DAERAH ISTIMEWA YOGYAKARTA",28,183,48,231
https://kawalpemilu.org#42284,"WEDOMARTANI, NGEMPLAK, SLEMAN, DAERAH ISTIMEWA YOGYAKARTA",29,93,53,146
https://kawalpemilu.org#42284,"WEDOMARTANI, NGEMPLAK, SLEMAN, DAERAH ISTIMEWA YOGYAKARTA",30,200,39,239
https://kawalpemilu.org#42284,"WEDOMARTANI, NGEMPLAK, SLEMAN, DAERAH ISTIMEWA YOGYAKARTA",31,163,45,208
https://kawalpemilu.org#42284,"WEDOMARTANI, NGEMPLAK, SLEMAN, DAERAH ISTIMEWA YOGYAKARTA",32,108,66,174
https://kawalpemilu.org#42284,"WEDOMARTANI, NGEMPLAK, SLEMAN, DAERAH ISTIMEWA YOGYAKARTA",33,160,61,221
https://kawalpemilu.org#42284,"WEDOMARTANI, NGEMPLAK, SLEMAN, DAERAH ISTIMEWA YOGYAKARTA",34,167,66,233
https://kawalpemilu.org#42284,"WEDOMARTANI, NGEMPLAK, SLEMAN, DAERAH ISTIMEWA YOGYAKARTA",35,191,57,248
https://kawalpemilu.org#42284,"WEDOMARTANI, NGEMPLAK, SLEMAN, DAERAH ISTIMEWA YOGYAKARTA",36,134,109,243
https://kawalpemilu.org#42284,"WEDOMARTANI, NGEMPLAK, SLEMAN, DAERAH ISTIMEWA YOGYAKARTA",37,159,99,258
https://kawalpemilu.org#42284,"WEDOMARTANI, NGEMPLAK, SLEMAN, DAERAH ISTIMEWA YOGYAKARTA",38,203,76,279
https://kawalpemilu.org#42284,"WEDOMARTANI, NGEMPLAK, SLEMAN, DAERAH ISTIMEWA YOGYAKARTA",39,174,76,250
https://kawalpemilu.org#42284,"WEDOMARTANI, NGEMPLAK, SLEMAN, DAERAH ISTIMEWA YOGYAKARTA",40,81,37,118
https://kawalpemilu.org#42284,"WEDOMARTANI, NGEMPLAK, SLEMAN, DAERAH ISTIMEWA YOGYAKARTA",41,203,47,250
https://kawalpemilu.org#42284,"WEDOMARTANI, NGEMPLAK, SLEMAN, DAERAH ISTIMEWA YOGYAKARTA",42,85,85,170
https://kawalpemilu.org#42284,"WEDOMARTANI, NGEMPLAK, SLEMAN, DAERAH ISTIMEWA YOGYAKARTA",43,87,51,138
https://kawalpemilu.org#42284,"WEDOMARTANI, NGEMPLAK, SLEMAN, DAERAH ISTIMEWA YOGYAKARTA",44,159,65,224
https://kawalpemilu.org#42284,"WEDOMARTANI, NGEMPLAK, SLEMAN, DAERAH ISTIMEWA YOGYAKARTA",45,166,62,228
https://kawalpemilu.org#42284,"WEDOMARTANI, NGEMPLAK, SLEMAN, DAERAH ISTIMEWA YOGYAKARTA",46,101,35,136
https://kawalpemilu.org#42284,"WEDOMARTANI, NGEMPLAK, SLEMAN, DAERAH ISTIMEWA YOGYAKARTA",47,172,67,239
https://kawalpemilu.org#42284,"WEDOMARTANI, NGEMPLAK, SLEMAN, DAERAH ISTIMEWA YOGYAKARTA",48,178,60,238
https://kawalpemilu.org#42284,"WEDOMARTANI, NGEMPLAK, SLEMAN, DAERAH ISTIMEWA YOGYAKARTA",49,198,34,232
https://kawalpemilu.org#42284,"WEDOMARTANI, NGEMPLAK, SLEMAN, DAERAH ISTIMEWA YOGYAKARTA",50,154,120,274
https://kawalpemilu.org#42284,"WEDOMARTANI, NGEMPLAK, SLEMAN, DAERAH ISTIMEWA YOGYAKARTA",51,170,82,252
https://kawalpemilu.org#42284,"WEDOMARTANI, NGEMPLAK, SLEMAN, DAERAH ISTIMEWA YOGYAKARTA",52,159,61,220
https://kawalpemilu.org#42284,"WEDOMARTANI, NGEMPLAK, SLEMAN, DAERAH ISTIMEWA YOGYAKARTA",53,160,79,239
https://kawalpemilu.org#42284,"WEDOMARTANI, NGEMPLAK, SLEMAN, DAERAH ISTIMEWA YOGYAKARTA",54,92,138,230
https://kawalpemilu.org#42284,"WEDOMARTANI, NGEMPLAK, SLEMAN, DAERAH ISTIMEWA YOGYAKARTA",55,136,99,235
https://kawalpemilu.org#42284,"WEDOMARTANI, NGEMPLAK, SLEMAN, DAERAH ISTIMEWA YOGYAKARTA",56,158,73,231
https://kawalpemilu.org#42284,"WEDOMARTANI, NGEMPLAK, SLEMAN, DAERAH ISTIMEWA YOGYAKARTA",57,133,106,239
https://kawalpemilu.org#42284,"WEDOMARTANI, NGEMPLAK, SLEMAN, DAERAH ISTIMEWA YOGYAKARTA",58,148,60,208
https://kawalpemilu.org#42284,"WEDOMARTANI, NGEMPLAK, SLEMAN, DAERAH ISTIMEWA YOGYAKARTA",59,168,28,196
https://kawalpemilu.org#42284,"WEDOMARTANI, NGEMPLAK, SLEMAN, DAERAH ISTIMEWA YOGYAKARTA",60,101,81,182
https://kawalpemilu.org#42284,"WEDOMARTANI, NGEMPLAK, SLEMAN, DAERAH ISTIMEWA YOGYAKARTA",61,191,76,267
https://kawalpemilu.org#42284,"WEDOMARTANI, NGEMPLAK, SLEMAN, DAERAH ISTIMEWA YOGYAKARTA",62,167,92,259
https://kawalpemilu.org#42284,"WEDOMARTANI, NGEMPLAK, SLEMAN, DAERAH ISTIMEWA YOGYAKARTA",63,158,83,241
https://kawalpemilu.org#42284,"WEDOMARTANI, NGEMPLAK, SLEMAN, DAERAH ISTIMEWA YOGYAKARTA",64,114,67,181
https://kawalpemilu.org#42284,"WEDOMARTANI, NGEMPLAK, SLEMAN, DAERAH ISTIMEWA YOGYAKARTA",65,121,49,170
https://kawalpemilu.org#42284,"WEDOMARTANI, NGEMPLAK, SLEMAN, DAERAH ISTIMEWA YOGYAKARTA",66,129,65,194
https://kawalpemilu.org#42284,"WEDOMARTANI, NGEMPLAK, SLEMAN, DAERAH ISTIMEWA YOGYAKARTA",67,97,83,180
https://kawalpemilu.org#42284,"WEDOMARTANI, NGEMPLAK, SLEMAN, DAERAH ISTIMEWA YOGYAKARTA",68,98,66,164
https://kawalpemilu.org#42284,"WEDOMARTANI, NGEMPLAK, SLEMAN, DAERAH ISTIMEWA YOGYAKARTA",69,74,80,154
https://kawalpemilu.org#42284,"WEDOMARTANI, NGEMPLAK, SLEMAN, DAERAH ISTIMEWA YOGYAKARTA",70,125,96,221
https://kawalpemilu.org#42284,"WEDOMARTANI, NGEMPLAK, SLEMAN, DAERAH ISTIMEWA YOGYAKARTA",71,109,101,210
https://kawalpemilu.org#42284,"WEDOMARTANI, NGEMPLAK, SLEMAN, DAERAH ISTIMEWA YOGYAKARTA",72,166,88,254
https://kawalpemilu.org#42284,"WEDOMARTANI, NGEMPLAK, SLEMAN, DAERAH ISTIMEWA YOGYAKARTA",73,149,110,259
https://kawalpemilu.org#42284,"WEDOMARTANI, NGEMPLAK, SLEMAN, DAERAH ISTIMEWA YOGYAKARTA",74,143,132,275
https://kawalpemilu.org#42284,"WEDOMARTANI, NGEMPLAK, SLEMAN, DAERAH ISTIMEWA YOGYAKARTA",75,125,146,271
https://kawalpemilu.org#42284,"WEDOMARTANI, NGEMPLAK, SLEMAN, DAERAH ISTIMEWA YOGYAKARTA",76,155,92,247
https://kawalpemilu.org#42284,"WEDOMARTANI, NGEMPLAK, SLEMAN, DAERAH ISTIMEWA YOGYAKARTA",77,126,75,201
https://kawalpemilu.org#42284,"WEDOMARTANI, NGEMPLAK, SLEMAN, DAERAH ISTIMEWA YOGYAKARTA",78,113,53,166
https://kawalpemilu.org#42284,"WEDOMARTANI, NGEMPLAK, SLEMAN, DAERAH ISTIMEWA YOGYAKARTA",79,120,39,159
https://kawalpemilu.org#42284,"WEDOMARTANI, NGEMPLAK, SLEMAN, DAERAH ISTIMEWA YOGYAKARTA",80,0,0,0
https://kawalpemilu.org#42284,"WEDOMARTANI, NGEMPLAK, SLEMAN, DAERAH ISTIMEWA YOGYAKARTA",81,123,45,168
https://kawalpemilu.org#42284,"WEDOMARTANI, NGEMPLAK, SLEMAN, DAERAH ISTIMEWA YOGYAKARTA",82,97,48,145
https://kawalpemilu.org#42284,"WEDOMARTANI, NGEMPLAK, SLEMAN, DAERAH ISTIMEWA YOGYAKARTA",83,92,22,114
https://kawalpemilu.org#42284,"WEDOMARTANI, NGEMPLAK, SLEMAN, DAERAH ISTIMEWA YOGYAKARTA",84,108,61,169
https://kawalpemilu.org#42284,"WEDOMARTANI, NGEMPLAK, SLEMAN, DAERAH ISTIMEWA YOGYAKARTA",85,119,46,165
https://kawalpemilu.org#42285,"UMBULMARTANI, NGEMPLAK, SLEMAN, DAERAH ISTIMEWA YOGYAKARTA",1,210,60,270
https://kawalpemilu.org#42285,"UMBULMARTANI, NGEMPLAK, SLEMAN, DAERAH ISTIMEWA YOGYAKARTA",2,191,69,260
https://kawalpemilu.org#42285,"UMBULMARTANI, NGEMPLAK, SLEMAN, DAERAH ISTIMEWA YOGYAKARTA",3,156,83,239
https://kawalpemilu.org#42285,"UMBULMARTANI, NGEMPLAK, SLEMAN, DAERAH ISTIMEWA YOGYAKARTA",4,171,69,240
https://kawalpemilu.org#42285,"UMBULMARTANI, NGEMPLAK, SLEMAN, DAERAH ISTIMEWA YOGYAKARTA",5,160,104,264
https://kawalpemilu.org#42285,"UMBULMARTANI, NGEMPLAK, SLEMAN, DAERAH ISTIMEWA YOGYAKARTA",6,176,72,248
https://kawalpemilu.org#42285,"UMBULMARTANI, NGEMPLAK, SLEMAN, DAERAH ISTIMEWA YOGYAKARTA",7,157,76,233
https://kawalpemilu.org#42285,"UMBULMARTANI, NGEMPLAK, SLEMAN, DAERAH ISTIMEWA YOGYAKARTA",8,126,112,238
https://kawalpemilu.org#42285,"UMBULMARTANI, NGEMPLAK, SLEMAN, DAERAH ISTIMEWA YOGYAKARTA",9,185,69,254
https://kawalpemilu.org#42285,"UMBULMARTANI, NGEMPLAK, SLEMAN, DAERAH ISTIMEWA YOGYAKARTA",10,114,101,215
https://kawalpemilu.org#42285,"UMBULMARTANI, NGEMPLAK, SLEMAN, DAERAH ISTIMEWA YOGYAKARTA",11,173,58,231
https://kawalpemilu.org#42285,"UMBULMARTANI, NGEMPLAK, SLEMAN, DAERAH ISTIMEWA YOGYAKARTA",12,156,88,244
https://kawalpemilu.org#42285,"UMBULMARTANI, NGEMPLAK, SLEMAN, DAERAH ISTIMEWA YOGYAKARTA",13,121,119,240
https://kawalpemilu.org#42285,"UMBULMARTANI, NGEMPLAK, SLEMAN, DAERAH ISTIMEWA YOGYAKARTA",14,172,64,236
https://kawalpemilu.org#42285,"UMBULMARTANI, NGEMPLAK, SLEMAN, DAERAH ISTIMEWA YOGYAKARTA",15,173,83,256
https://kawalpemilu.org#42285,"UMBULMARTANI, NGEMPLAK, SLEMAN, DAERAH ISTIMEWA YOGYAKARTA",16,113,87,200
https://kawalpemilu.org#42285,"UMBULMARTANI, NGEMPLAK, SLEMAN, DAERAH ISTIMEWA YOGYAKARTA",17,125,56,181
https://kawalpemilu.org#42285,"UMBULMARTANI, NGEMPLAK, SLEMAN, DAERAH ISTIMEWA YOGYAKARTA",18,171,94,265
https://kawalpemilu.org#42285,"UMBULMARTANI, NGEMPLAK, SLEMAN, DAERAH ISTIMEWA YOGYAKARTA",19,157,92,249
https://kawalpemilu.org#42285,"UMBULMARTANI, NGEMPLAK, SLEMAN, DAERAH ISTIMEWA YOGYAKARTA",20,161,68,229
https://kawalpemilu.org#42285,"UMBULMARTANI, NGEMPLAK, SLEMAN, DAERAH ISTIMEWA YOGYAKARTA",21,127,79,206
https://kawalpemilu.org#42285,"UMBULMARTANI, NGEMPLAK, SLEMAN, DAERAH ISTIMEWA YOGYAKARTA",22,197,126,323
https://kawalpemilu.org#42285,"UMBULMARTANI, NGEMPLAK, SLEMAN, DAERAH ISTIMEWA YOGYAKARTA",23,145,89,234
https://kawalpemilu.org#42285,"UMBULMARTANI, NGEMPLAK, SLEMAN, DAERAH ISTIMEWA YOGYAKARTA",24,103,135,238
https://kawalpemilu.org#42285,"UMBULMARTANI, NGEMPLAK, SLEMAN, DAERAH ISTIMEWA YOGYAKARTA",25,172,89,261
https://kawalpemilu.org#42285,"UMBULMARTANI, NGEMPLAK, SLEMAN, DAERAH ISTIMEWA YOGYAKARTA",26,140,89,229
https://kawalpemilu.org#42285,"UMBULMARTANI, NGEMPLAK, SLEMAN, DAERAH ISTIMEWA YOGYAKARTA",27,167,98,265
https://kawalpemilu.org#42287,"SARIHARJO, NGAGLIK, SLEMAN, DAERAH ISTIMEWA YOGYAKARTA",1,55,141,196
https://kawalpemilu.org#42287,"SARIHARJO, NGAGLIK, SLEMAN, DAERAH ISTIMEWA YOGYAKARTA",2,56,78,134
https://kawalpemilu.org#42287,"SARIHARJO, NGAGLIK, SLEMAN, DAERAH ISTIMEWA YOGYAKARTA",3,70,66,136
https://kawalpemilu.org#42287,"SARIHARJO, NGAGLIK, SLEMAN, DAERAH ISTIMEWA YOGYAKARTA",4,95,75,168
https://kawalpemilu.org#42287,"SARIHARJO, NGAGLIK, SLEMAN, DAERAH ISTIMEWA YOGYAKARTA",5,113,82,193
https://kawalpemilu.org#42287,"SARIHARJO, NGAGLIK, SLEMAN, DAERAH ISTIMEWA YOGYAKARTA",6,129,66,195
https://kawalpemilu.org#42287,"SARIHARJO, NGAGLIK, SLEMAN, DAERAH ISTIMEWA YOGYAKARTA",7,98,48,146
https://kawalpemilu.org#42287,"SARIHARJO, NGAGLIK, SLEMAN, DAERAH ISTIMEWA YOGYAKARTA",8,86,51,137
https://kawalpemilu.org#42287,"SARIHARJO, NGAGLIK, SLEMAN, DAERAH ISTIMEWA YOGYAKARTA",9,168,83,251
https://kawalpemilu.org#42287,"SARIHARJO, NGAGLIK, SLEMAN, DAERAH ISTIMEWA YOGYAKARTA",10,125,100,225
https://kawalpemilu.org#42287,"SARIHARJO, NGAGLIK, SLEMAN, DAERAH ISTIMEWA YOGYAKARTA",11,159,71,230
https://kawalpemilu.org#42287,"SARIHARJO, NGAGLIK, SLEMAN, DAERAH ISTIMEWA YOGYAKARTA",12,163,63,226
https://kawalpemilu.org#42287,"SARIHARJO, NGAGLIK, SLEMAN, DAERAH ISTIMEWA YOGYAKARTA",13,192,85,277
https://kawalpemilu.org#42287,"SARIHARJO, NGAGLIK, SLEMAN, DAERAH ISTIMEWA YOGYAKARTA",15,95,35,130
https://kawalpemilu.org#42287,"SARIHARJO, NGAGLIK, SLEMAN, DAERAH ISTIMEWA YOGYAKARTA",16,122,6,128
https://kawalpemilu.org#42287,"SARIHARJO, NGAGLIK, SLEMAN, DAERAH ISTIMEWA YOGYAKARTA",17,114,16,130
https://kawalpemilu.org#42287,"SARIHARJO, NGAGLIK, SLEMAN, DAERAH ISTIMEWA YOGYAKARTA",19,140,74,214
https://kawalpemilu.org#42287,"SARIHARJO, NGAGLIK, SLEMAN, DAERAH ISTIMEWA YOGYAKARTA",20,130,97,227
https://kawalpemilu.org#42287,"SARIHARJO, NGAGLIK, SLEMAN, DAERAH ISTIMEWA YOGYAKARTA",22,114,79,193
https://kawalpemilu.org#42287,"SARIHARJO, NGAGLIK, SLEMAN, DAERAH ISTIMEWA YOGYAKARTA",24,138,60,198
https://kawalpemilu.org#42287,"SARIHARJO, NGAGLIK, SLEMAN, DAERAH ISTIMEWA YOGYAKARTA",25,150,61,211
https://kawalpemilu.org#42287,"SARIHARJO, NGAGLIK, SLEMAN, DAERAH ISTIMEWA YOGYAKARTA",26,147,56,203
https://kawalpemilu.org#42287,"SARIHARJO, NGAGLIK, SLEMAN, DAERAH ISTIMEWA YOGYAKARTA",27,130,62,192
https://kawalpemilu.org#42287,"SARIHARJO, NGAGLIK, SLEMAN, DAERAH ISTIMEWA YOGYAKARTA",28,81,50,131
https://kawalpemilu.org#42287,"SARIHARJO, NGAGLIK, SLEMAN, DAERAH ISTIMEWA YOGYAKARTA",29,97,57,154
https://kawalpemilu.org#42287,"SARIHARJO, NGAGLIK, SLEMAN, DAERAH ISTIMEWA YOGYAKARTA",30,137,73,210
https://kawalpemilu.org#42287,"SARIHARJO, NGAGLIK, SLEMAN, DAERAH ISTIMEWA YOGYAKARTA",31,157,76,233
https://kawalpemilu.org#42287,"SARIHARJO, NGAGLIK, SLEMAN, DAERAH ISTIMEWA YOGYAKARTA",32,168,86,254
https://kawalpemilu.org#42287,"SARIHARJO, NGAGLIK, SLEMAN, DAERAH ISTIMEWA YOGYAKARTA",34,149,84,233
https://kawalpemilu.org#42287,"SARIHARJO, NGAGLIK, SLEMAN, DAERAH ISTIMEWA YOGYAKARTA",35,138,74,212
https://kawalpemilu.org#42287,"SARIHARJO, NGAGLIK, SLEMAN, DAERAH ISTIMEWA YOGYAKARTA",36,119,65,184
https://kawalpemilu.org#42287,"SARIHARJO, NGAGLIK, SLEMAN, DAERAH ISTIMEWA YOGYAKARTA",37,151,55,206
https://kawalpemilu.org#42287,"SARIHARJO, NGAGLIK, SLEMAN, DAERAH ISTIMEWA YOGYAKARTA",38,109,86,195
https://kawalpemilu.org#42287,"SARIHARJO, NGAGLIK, SLEMAN, DAERAH ISTIMEWA YOGYAKARTA",39,151,98,249
https://kawalpemilu.org#42287,"SARIHARJO, NGAGLIK, SLEMAN, DAERAH ISTIMEWA YOGYAKARTA",40,146,116,262
https://kawalpemilu.org#42287,"SARIHARJO, NGAGLIK, SLEMAN, DAERAH ISTIMEWA YOGYAKARTA",41,128,54,182
https://kawalpemilu.org#42287,"SARIHARJO, NGAGLIK, SLEMAN, DAERAH ISTIMEWA YOGYAKARTA",42,104,42,146
https://kawalpemilu.org#42287,"SARIHARJO, NGAGLIK, SLEMAN, DAERAH ISTIMEWA YOGYAKARTA",43,153,35,188
https://kawalpemilu.org#42287,"SARIHARJO, NGAGLIK, SLEMAN, DAERAH ISTIMEWA YOGYAKARTA",44,150,56,206
https://kawalpemilu.org#42287,"SARIHARJO, NGAGLIK, SLEMAN, DAERAH ISTIMEWA YOGYAKARTA",45,130,95,225
https://kawalpemilu.org#42287,"SARIHARJO, NGAGLIK, SLEMAN, DAERAH ISTIMEWA YOGYAKARTA",46,161,60,221
https://kawalpemilu.org#42287,"SARIHARJO, NGAGLIK, SLEMAN, DAERAH ISTIMEWA YOGYAKARTA",47,114,37,151
https://kawalpemilu.org#42287,"SARIHARJO, NGAGLIK, SLEMAN, DAERAH ISTIMEWA YOGYAKARTA",48,145,68,213
https://kawalpemilu.org#42287,"SARIHARJO, NGAGLIK, SLEMAN, DAERAH ISTIMEWA YOGYAKARTA",49,101,43,144
https://kawalpemilu.org#42287,"SARIHARJO, NGAGLIK, SLEMAN, DAERAH ISTIMEWA YOGYAKARTA",50,112,15,127
https://kawalpemilu.org#42287,"SARIHARJO, NGAGLIK, SLEMAN, DAERAH ISTIMEWA YOGYAKARTA",51,99,49,148
https://kawalpemilu.org#42287,"SARIHARJO, NGAGLIK, SLEMAN, DAERAH ISTIMEWA YOGYAKARTA",52,128,91,219
https://kawalpemilu.org#42287,"SARIHARJO, NGAGLIK, SLEMAN, DAERAH ISTIMEWA YOGYAKARTA",53,154,78,232
https://kawalpemilu.org#42287,"SARIHARJO, NGAGLIK, SLEMAN, DAERAH ISTIMEWA YOGYAKARTA",54,108,92,200
https://kawalpemilu.org#42287,"SARIHARJO, NGAGLIK, SLEMAN, DAERAH ISTIMEWA YOGYAKARTA",55,119,85,204
https://kawalpemilu.org#42287,"SARIHARJO, NGAGLIK, SLEMAN, DAERAH ISTIMEWA YOGYAKARTA",56,150,86,236
https://kawalpemilu.org#42287,"SARIHARJO, NGAGLIK, SLEMAN, DAERAH ISTIMEWA YOGYAKARTA",57,166,68,234
https://kawalpemilu.org#42287,"SARIHARJO, NGAGLIK, SLEMAN, DAERAH ISTIMEWA YOGYAKARTA",58,97,126,223
https://kawalpemilu.org#42287,"SARIHARJO, NGAGLIK, SLEMAN, DAERAH ISTIMEWA YOGYAKARTA",59,148,81,229
https://kawalpemilu.org#42287,"SARIHARJO, NGAGLIK, SLEMAN, DAERAH ISTIMEWA YOGYAKARTA",60,127,89,216
https://kawalpemilu.org#42287,"SARIHARJO, NGAGLIK, SLEMAN, DAERAH ISTIMEWA YOGYAKARTA",61,126,66,192
https://kawalpemilu.org#42287,"SARIHARJO, NGAGLIK, SLEMAN, DAERAH ISTIMEWA YOGYAKARTA",62,116,51,167
https://kawalpemilu.org#42287,"SARIHARJO, NGAGLIK, SLEMAN, DAERAH ISTIMEWA YOGYAKARTA",63,58,121,179
https://kawalpemilu.org#42287,"SARIHARJO, NGAGLIK, SLEMAN, DAERAH ISTIMEWA YOGYAKARTA",65,119,66,185
https://kawalpemilu.org#42287,"SARIHARJO, NGAGLIK, SLEMAN, DAERAH ISTIMEWA YOGYAKARTA",67,126,57,183
https://kawalpemilu.org#42287,"SARIHARJO, NGAGLIK, SLEMAN, DAERAH ISTIMEWA YOGYAKARTA",68,118,45,163
https://kawalpemilu.org#42288,"MINOMARTANI, NGAGLIK, SLEMAN, DAERAH ISTIMEWA YOGYAKARTA",1,198,76,274
https://kawalpemilu.org#42288,"MINOMARTANI, NGAGLIK, SLEMAN, DAERAH ISTIMEWA YOGYAKARTA",2,141,115,256
https://kawalpemilu.org#42288,"MINOMARTANI, NGAGLIK, SLEMAN, DAERAH ISTIMEWA YOGYAKARTA",3,158,97,255
https://kawalpemilu.org#42288,"MINOMARTANI, NGAGLIK, SLEMAN, DAERAH ISTIMEWA YOGYAKARTA",4,169,71,240
https://kawalpemilu.org#42288,"MINOMARTANI, NGAGLIK, SLEMAN, DAERAH ISTIMEWA YOGYAKARTA",5,146,98,244
https://kawalpemilu.org#42288,"MINOMARTANI, NGAGLIK, SLEMAN, DAERAH ISTIMEWA YOGYAKARTA",6,156,77,233
https://kawalpemilu.org#42288,"MINOMARTANI, NGAGLIK, SLEMAN, DAERAH ISTIMEWA YOGYAKARTA",7,109,85,194
https://kawalpemilu.org#42288,"MINOMARTANI, NGAGLIK, SLEMAN, DAERAH ISTIMEWA YOGYAKARTA",8,65,94,159
https://kawalpemilu.org#42288,"MINOMARTANI, NGAGLIK, SLEMAN, DAERAH ISTIMEWA YOGYAKARTA",9,95,74,169
https://kawalpemilu.org#42288,"MINOMARTANI, NGAGLIK, SLEMAN, DAERAH ISTIMEWA YOGYAKARTA",10,155,68,223
https://kawalpemilu.org#42288,"MINOMARTANI, NGAGLIK, SLEMAN, DAERAH ISTIMEWA YOGYAKARTA",11,184,54,238
https://kawalpemilu.org#42288,"MINOMARTANI, NGAGLIK, SLEMAN, DAERAH ISTIMEWA YOGYAKARTA",12,133,57,190
https://kawalpemilu.org#42288,"MINOMARTANI, NGAGLIK, SLEMAN, DAERAH ISTIMEWA YOGYAKARTA",13,187,73,260
https://kawalpemilu.org#42288,"MINOMARTANI, NGAGLIK, SLEMAN, DAERAH ISTIMEWA YOGYAKARTA",14,134,47,181
https://kawalpemilu.org#42288,"MINOMARTANI, NGAGLIK, SLEMAN, DAERAH ISTIMEWA YOGYAKARTA",15,104,62,166
https://kawalpemilu.org#42288,"MINOMARTANI, NGAGLIK, SLEMAN, DAERAH ISTIMEWA YOGYAKARTA",16,138,45,183
https://kawalpemilu.org#42288,"MINOMARTANI, NGAGLIK, SLEMAN, DAERAH ISTIMEWA YOGYAKARTA",17,88,68,156
https://kawalpemilu.org#42288,"MINOMARTANI, NGAGLIK, SLEMAN, DAERAH ISTIMEWA YOGYAKARTA",18,106,53,159
https://kawalpemilu.org#42288,"MINOMARTANI, NGAGLIK, SLEMAN, DAERAH ISTIMEWA YOGYAKARTA",19,96,41,137
https://kawalpemilu.org#42288,"MINOMARTANI, NGAGLIK, SLEMAN, DAERAH ISTIMEWA YOGYAKARTA",20,115,41,156
https://kawalpemilu.org#42288,"MINOMARTANI, NGAGLIK, SLEMAN, DAERAH ISTIMEWA YOGYAKARTA",22,124,69,193
https://kawalpemilu.org#42288,"MINOMARTANI, NGAGLIK, SLEMAN, DAERAH ISTIMEWA YOGYAKARTA",23,109,72,181
https://kawalpemilu.org#42288,"MINOMARTANI, NGAGLIK, SLEMAN, DAERAH ISTIMEWA YOGYAKARTA",24,136,38,174
https://kawalpemilu.org#42288,"MINOMARTANI, NGAGLIK, SLEMAN, DAERAH ISTIMEWA YOGYAKARTA",25,123,69,192
https://kawalpemilu.org#42288,"MINOMARTANI, NGAGLIK, SLEMAN, DAERAH ISTIMEWA YOGYAKARTA",26,89,73,162
https://kawalpemilu.org#42288,"MINOMARTANI, NGAGLIK, SLEMAN, DAERAH ISTIMEWA YOGYAKARTA",27,115,56,171
https://kawalpemilu.org#42288,"MINOMARTANI, NGAGLIK, SLEMAN, DAERAH ISTIMEWA YOGYAKARTA",28,99,47,146
https://kawalpemilu.org#42288,"MINOMARTANI, NGAGLIK, SLEMAN, DAERAH ISTIMEWA YOGYAKARTA",29,154,80,234
https://kawalpemilu.org#42288,"MINOMARTANI, NGAGLIK, SLEMAN, DAERAH ISTIMEWA YOGYAKARTA",30,145,79,224
https://kawalpemilu.org#42288,"MINOMARTANI, NGAGLIK, SLEMAN, DAERAH ISTIMEWA YOGYAKARTA",31,140,68,208
https://kawalpemilu.org#42288,"MINOMARTANI, NGAGLIK, SLEMAN, DAERAH ISTIMEWA YOGYAKARTA",32,142,59,201
https://kawalpemilu.org#42288,"MINOMARTANI, NGAGLIK, SLEMAN, DAERAH ISTIMEWA YOGYAKARTA",33,128,55,183
https://kawalpemilu.org#42288,"MINOMARTANI, NGAGLIK, SLEMAN, DAERAH ISTIMEWA YOGYAKARTA",34,125,40,165
https://kawalpemilu.org#42288,"MINOMARTANI, NGAGLIK, SLEMAN, DAERAH ISTIMEWA YOGYAKARTA",35,110,59,169
https://kawalpemilu.org#42288,"MINOMARTANI, NGAGLIK, SLEMAN, DAERAH ISTIMEWA YOGYAKARTA",36,133,80,213
https://kawalpemilu.org#42288,"MINOMARTANI, NGAGLIK, SLEMAN, DAERAH ISTIMEWA YOGYAKARTA",37,154,58,212
https://kawalpemilu.org#42288,"MINOMARTANI, NGAGLIK, SLEMAN, DAERAH ISTIMEWA YOGYAKARTA",38,116,42,158
https://kawalpemilu.org#42288,"MINOMARTANI, NGAGLIK, SLEMAN, DAERAH ISTIMEWA YOGYAKARTA",39,125,56,181
https://kawalpemilu.org#42288,"MINOMARTANI, NGAGLIK, SLEMAN, DAERAH ISTIMEWA YOGYAKARTA",40,86,61,147
https://kawalpemilu.org#42288,"MINOMARTANI, NGAGLIK, SLEMAN, DAERAH ISTIMEWA YOGYAKARTA",41,104,72,176
https://kawalpemilu.org#42288,"MINOMARTANI, NGAGLIK, SLEMAN, DAERAH ISTIMEWA YOGYAKARTA",42,124,37,161
https://kawalpemilu.org#42288,"MINOMARTANI, NGAGLIK, SLEMAN, DAERAH ISTIMEWA YOGYAKARTA",43,152,79,231
https://kawalpemilu.org#42289,"SINDUHARJO, NGAGLIK, SLEMAN, DAERAH ISTIMEWA YOGYAKARTA",1,122,123,245
https://kawalpemilu.org#42289,"SINDUHARJO, NGAGLIK, SLEMAN, DAERAH ISTIMEWA YOGYAKARTA",2,126,62,188
https://kawalpemilu.org#42289,"SINDUHARJO, NGAGLIK, SLEMAN, DAERAH ISTIMEWA YOGYAKARTA",3,119,25,144
https://kawalpemilu.org#42289,"SINDUHARJO, NGAGLIK, SLEMAN, DAERAH ISTIMEWA YOGYAKARTA",4,119,49,168
https://kawalpemilu.org#42289,"SINDUHARJO, NGAGLIK, SLEMAN, DAERAH ISTIMEWA YOGYAKARTA",5,145,94,239
https://kawalpemilu.org#42289,"SINDUHARJO, NGAGLIK, SLEMAN, DAERAH ISTIMEWA YOGYAKARTA",6,148,78,226
https://kawalpemilu.org#42289,"SINDUHARJO, NGAGLIK, SLEMAN, DAERAH ISTIMEWA YOGYAKARTA",7,0,0,0
https://kawalpemilu.org#42289,"SINDUHARJO, NGAGLIK, SLEMAN, DAERAH ISTIMEWA YOGYAKARTA",8,195,34,229
https://kawalpemilu.org#42289,"SINDUHARJO, NGAGLIK, SLEMAN, DAERAH ISTIMEWA YOGYAKARTA",9,131,59,190
https://kawalpemilu.org#42289,"SINDUHARJO, NGAGLIK, SLEMAN, DAERAH ISTIMEWA YOGYAKARTA",10,120,51,171
https://kawalpemilu.org#42289,"SINDUHARJO, NGAGLIK, SLEMAN, DAERAH ISTIMEWA YOGYAKARTA",11,171,80,251
https://kawalpemilu.org#42289,"SINDUHARJO, NGAGLIK, SLEMAN, DAERAH ISTIMEWA YOGYAKARTA",12,164,80,244
https://kawalpemilu.org#42289,"SINDUHARJO, NGAGLIK, SLEMAN, DAERAH ISTIMEWA YOGYAKARTA",13,174,65,239
https://kawalpemilu.org#42289,"SINDUHARJO, NGAGLIK, SLEMAN, DAERAH ISTIMEWA YOGYAKARTA",14,180,70,250
https://kawalpemilu.org#42289,"SINDUHARJO, NGAGLIK, SLEMAN, DAERAH ISTIMEWA YOGYAKARTA",15,158,62,220
https://kawalpemilu.org#42289,"SINDUHARJO, NGAGLIK, SLEMAN, DAERAH ISTIMEWA YOGYAKARTA",16,204,29,233
https://kawalpemilu.org#42289,"SINDUHARJO, NGAGLIK, SLEMAN, DAERAH ISTIMEWA YOGYAKARTA",17,191,51,242
https://kawalpemilu.org#42289,"SINDUHARJO, NGAGLIK, SLEMAN, DAERAH ISTIMEWA YOGYAKARTA",18,123,99,222
https://kawalpemilu.org#42289,"SINDUHARJO, NGAGLIK, SLEMAN, DAERAH ISTIMEWA YOGYAKARTA",19,134,118,252
https://kawalpemilu.org#42289,"SINDUHARJO, NGAGLIK, SLEMAN, DAERAH ISTIMEWA YOGYAKARTA",20,119,102,221
https://kawalpemilu.org#42289,"SINDUHARJO, NGAGLIK, SLEMAN, DAERAH ISTIMEWA YOGYAKARTA",21,186,67,253
https://kawalpemilu.org#42289,"SINDUHARJO, NGAGLIK, SLEMAN, DAERAH ISTIMEWA YOGYAKARTA",22,164,93,257
https://kawalpemilu.org#42289,"SINDUHARJO, NGAGLIK, SLEMAN, DAERAH ISTIMEWA YOGYAKARTA",23,154,104,258
https://kawalpemilu.org#42289,"SINDUHARJO, NGAGLIK, SLEMAN, DAERAH ISTIMEWA YOGYAKARTA",24,179,79,258
https://kawalpemilu.org#42289,"SINDUHARJO, NGAGLIK, SLEMAN, DAERAH ISTIMEWA YOGYAKARTA",25,113,26,139
https://kawalpemilu.org#42289,"SINDUHARJO, NGAGLIK, SLEMAN, DAERAH ISTIMEWA YOGYAKARTA",26,81,29,110
https://kawalpemilu.org#42289,"SINDUHARJO, NGAGLIK, SLEMAN, DAERAH ISTIMEWA YOGYAKARTA",27,142,78,220
https://kawalpemilu.org#42289,"SINDUHARJO, NGAGLIK, SLEMAN, DAERAH ISTIMEWA YOGYAKARTA",28,118,76,194
https://kawalpemilu.org#42289,"SINDUHARJO, NGAGLIK, SLEMAN, DAERAH ISTIMEWA YOGYAKARTA",29,157,67,224
https://kawalpemilu.org#42289,"SINDUHARJO, NGAGLIK, SLEMAN, DAERAH ISTIMEWA YOGYAKARTA",30,178,29,207
https://kawalpemilu.org#42289,"SINDUHARJO, NGAGLIK, SLEMAN, DAERAH ISTIMEWA YOGYAKARTA",31,204,58,262
https://kawalpemilu.org#42289,"SINDUHARJO, NGAGLIK, SLEMAN, DAERAH ISTIMEWA YOGYAKARTA",32,93,63,156
https://kawalpemilu.org#42289,"SINDUHARJO, NGAGLIK, SLEMAN, DAERAH ISTIMEWA YOGYAKARTA",33,109,79,188
https://kawalpemilu.org#42289,"SINDUHARJO, NGAGLIK, SLEMAN, DAERAH ISTIMEWA YOGYAKARTA",34,156,78,234
https://kawalpemilu.org#42289,"SINDUHARJO, NGAGLIK, SLEMAN, DAERAH ISTIMEWA YOGYAKARTA",35,189,75,264
https://kawalpemilu.org#42289,"SINDUHARJO, NGAGLIK, SLEMAN, DAERAH ISTIMEWA YOGYAKARTA",36,117,43,160
https://kawalpemilu.org#42289,"SINDUHARJO, NGAGLIK, SLEMAN, DAERAH ISTIMEWA YOGYAKARTA",37,162,100,262
https://kawalpemilu.org#42289,"SINDUHARJO, NGAGLIK, SLEMAN, DAERAH ISTIMEWA YOGYAKARTA",38,172,53,225
https://kawalpemilu.org#42289,"SINDUHARJO, NGAGLIK, SLEMAN, DAERAH ISTIMEWA YOGYAKARTA",39,190,59,249
https://kawalpemilu.org#42289,"SINDUHARJO, NGAGLIK, SLEMAN, DAERAH ISTIMEWA YOGYAKARTA",40,195,53,248
https://kawalpemilu.org#42289,"SINDUHARJO, NGAGLIK, SLEMAN, DAERAH ISTIMEWA YOGYAKARTA",41,146,70,216
https://kawalpemilu.org#42289,"SINDUHARJO, NGAGLIK, SLEMAN, DAERAH ISTIMEWA YOGYAKARTA",42,152,49,201
https://kawalpemilu.org#42289,"SINDUHARJO, NGAGLIK, SLEMAN, DAERAH ISTIMEWA YOGYAKARTA",43,188,88,276
https://kawalpemilu.org#42289,"SINDUHARJO, NGAGLIK, SLEMAN, DAERAH ISTIMEWA YOGYAKARTA",44,207,79,286
https://kawalpemilu.org#42289,"SINDUHARJO, NGAGLIK, SLEMAN, DAERAH ISTIMEWA YOGYAKARTA",45,202,63,265
https://kawalpemilu.org#42289,"SINDUHARJO, NGAGLIK, SLEMAN, DAERAH ISTIMEWA YOGYAKARTA",46,191,44,235
https://kawalpemilu.org#42289,"SINDUHARJO, NGAGLIK, SLEMAN, DAERAH ISTIMEWA YOGYAKARTA",47,181,75,256
https://kawalpemilu.org#42289,"SINDUHARJO, NGAGLIK, SLEMAN, DAERAH ISTIMEWA YOGYAKARTA",48,202,71,273
https://kawalpemilu.org#42289,"SINDUHARJO, NGAGLIK, SLEMAN, DAERAH ISTIMEWA YOGYAKARTA",49,140,51,191
https://kawalpemilu.org#42289,"SINDUHARJO, NGAGLIK, SLEMAN, DAERAH ISTIMEWA YOGYAKARTA",50,176,81,257
https://kawalpemilu.org#42289,"SINDUHARJO, NGAGLIK, SLEMAN, DAERAH ISTIMEWA YOGYAKARTA",51,178,89,267
https://kawalpemilu.org#42289,"SINDUHARJO, NGAGLIK, SLEMAN, DAERAH ISTIMEWA YOGYAKARTA",52,212,66,278
https://kawalpemilu.org#42289,"SINDUHARJO, NGAGLIK, SLEMAN, DAERAH ISTIMEWA YOGYAKARTA",53,225,66,291
https://kawalpemilu.org#42290,"SUKOHARJO, NGAGLIK, SLEMAN, DAERAH ISTIMEWA YOGYAKARTA",1,159,44,203
https://kawalpemilu.org#42290,"SUKOHARJO, NGAGLIK, SLEMAN, DAERAH ISTIMEWA YOGYAKARTA",2,132,34,166
https://kawalpemilu.org#42290,"SUKOHARJO, NGAGLIK, SLEMAN, DAERAH ISTIMEWA YOGYAKARTA",3,160,91,251
https://kawalpemilu.org#42290,"SUKOHARJO, NGAGLIK, SLEMAN, DAERAH ISTIMEWA YOGYAKARTA",4,103,90,193
https://kawalpemilu.org#42290,"SUKOHARJO, NGAGLIK, SLEMAN, DAERAH ISTIMEWA YOGYAKARTA",5,197,52,249
https://kawalpemilu.org#42290,"SUKOHARJO, NGAGLIK, SLEMAN, DAERAH ISTIMEWA YOGYAKARTA",6,175,39,214
https://kawalpemilu.org#42290,"SUKOHARJO, NGAGLIK, SLEMAN, DAERAH ISTIMEWA YOGYAKARTA",7,100,37,137
https://kawalpemilu.org#42290,"SUKOHARJO, NGAGLIK, SLEMAN, DAERAH ISTIMEWA YOGYAKARTA",8,159,84,243
https://kawalpemilu.org#42290,"SUKOHARJO, NGAGLIK, SLEMAN, DAERAH ISTIMEWA YOGYAKARTA",9,118,54,172
https://kawalpemilu.org#42290,"SUKOHARJO, NGAGLIK, SLEMAN, DAERAH ISTIMEWA YOGYAKARTA",10,181,58,239
https://kawalpemilu.org#42290,"SUKOHARJO, NGAGLIK, SLEMAN, DAERAH ISTIMEWA YOGYAKARTA",11,147,37,184
https://kawalpemilu.org#42290,"SUKOHARJO, NGAGLIK, SLEMAN, DAERAH ISTIMEWA YOGYAKARTA",12,177,90,267
https://kawalpemilu.org#42290,"SUKOHARJO, NGAGLIK, SLEMAN, DAERAH ISTIMEWA YOGYAKARTA",13,189,51,240
https://kawalpemilu.org#42290,"SUKOHARJO, NGAGLIK, SLEMAN, DAERAH ISTIMEWA YOGYAKARTA",14,132,62,194
https://kawalpemilu.org#42290,"SUKOHARJO, NGAGLIK, SLEMAN, DAERAH ISTIMEWA YOGYAKARTA",15,165,56,221
https://kawalpemilu.org#42290,"SUKOHARJO, NGAGLIK, SLEMAN, DAERAH ISTIMEWA YOGYAKARTA",16,187,78,265
https://kawalpemilu.org#42290,"SUKOHARJO, NGAGLIK, SLEMAN, DAERAH ISTIMEWA YOGYAKARTA",17,132,78,210
https://kawalpemilu.org#42290,"SUKOHARJO, NGAGLIK, SLEMAN, DAERAH ISTIMEWA YOGYAKARTA",18,171,59,230
https://kawalpemilu.org#42290,"SUKOHARJO, NGAGLIK, SLEMAN, DAERAH ISTIMEWA YOGYAKARTA",19,132,64,196
https://kawalpemilu.org#42290,"SUKOHARJO, NGAGLIK, SLEMAN, DAERAH ISTIMEWA YOGYAKARTA",20,136,71,207
https://kawalpemilu.org#42290,"SUKOHARJO, NGAGLIK, SLEMAN, DAERAH ISTIMEWA YOGYAKARTA",21,191,54,245
https://kawalpemilu.org#42290,"SUKOHARJO, NGAGLIK, SLEMAN, DAERAH ISTIMEWA YOGYAKARTA",22,183,77,260
https://kawalpemilu.org#42290,"SUKOHARJO, NGAGLIK, SLEMAN, DAERAH ISTIMEWA YOGYAKARTA",23,128,105,233
https://kawalpemilu.org#42290,"SUKOHARJO, NGAGLIK, SLEMAN, DAERAH ISTIMEWA YOGYAKARTA",24,161,100,261
https://kawalpemilu.org#42290,"SUKOHARJO, NGAGLIK, SLEMAN, DAERAH ISTIMEWA YOGYAKARTA",25,170,87,257
https://kawalpemilu.org#42290,"SUKOHARJO, NGAGLIK, SLEMAN, DAERAH ISTIMEWA YOGYAKARTA",26,139,84,223
https://kawalpemilu.org#42290,"SUKOHARJO, NGAGLIK, SLEMAN, DAERAH ISTIMEWA YOGYAKARTA",27,195,66,261
https://kawalpemilu.org#42290,"SUKOHARJO, NGAGLIK, SLEMAN, DAERAH ISTIMEWA YOGYAKARTA",28,140,75,215
https://kawalpemilu.org#42290,"SUKOHARJO, NGAGLIK, SLEMAN, DAERAH ISTIMEWA YOGYAKARTA",29,163,59,222
https://kawalpemilu.org#42290,"SUKOHARJO, NGAGLIK, SLEMAN, DAERAH ISTIMEWA YOGYAKARTA",30,108,85,193
https://kawalpemilu.org#42290,"SUKOHARJO, NGAGLIK, SLEMAN, DAERAH ISTIMEWA YOGYAKARTA",31,108,51,159
https://kawalpemilu.org#42290,"SUKOHARJO, NGAGLIK, SLEMAN, DAERAH ISTIMEWA YOGYAKARTA",32,175,73,248
https://kawalpemilu.org#42290,"SUKOHARJO, NGAGLIK, SLEMAN, DAERAH ISTIMEWA YOGYAKARTA",33,134,122,256
https://kawalpemilu.org#42290,"SUKOHARJO, NGAGLIK, SLEMAN, DAERAH ISTIMEWA YOGYAKARTA",34,161,56,217
https://kawalpemilu.org#42290,"SUKOHARJO, NGAGLIK, SLEMAN, DAERAH ISTIMEWA YOGYAKARTA",35,181,70,251
https://kawalpemilu.org#42290,"SUKOHARJO, NGAGLIK, SLEMAN, DAERAH ISTIMEWA YOGYAKARTA",36,176,61,237
https://kawalpemilu.org#42290,"SUKOHARJO, NGAGLIK, SLEMAN, DAERAH ISTIMEWA YOGYAKARTA",38,180,65,245
https://kawalpemilu.org#42290,"SUKOHARJO, NGAGLIK, SLEMAN, DAERAH ISTIMEWA YOGYAKARTA",39,135,73,208
https://kawalpemilu.org#42290,"SUKOHARJO, NGAGLIK, SLEMAN, DAERAH ISTIMEWA YOGYAKARTA",40,103,61,164
https://kawalpemilu.org#42290,"SUKOHARJO, NGAGLIK, SLEMAN, DAERAH ISTIMEWA YOGYAKARTA",41,79,70,149
https://kawalpemilu.org#42290,"SUKOHARJO, NGAGLIK, SLEMAN, DAERAH ISTIMEWA YOGYAKARTA",42,135,71,206
https://kawalpemilu.org#42290,"SUKOHARJO, NGAGLIK, SLEMAN, DAERAH ISTIMEWA YOGYAKARTA",43,130,63,193
https://kawalpemilu.org#42291,"SARDONOHARJO, NGAGLIK, SLEMAN, DAERAH ISTIMEWA YOGYAKARTA",1,156,73,229
https://kawalpemilu.org#42291,"SARDONOHARJO, NGAGLIK, SLEMAN, DAERAH ISTIMEWA YOGYAKARTA",2,153,62,215
https://kawalpemilu.org#42291,"SARDONOHARJO, NGAGLIK, SLEMAN, DAERAH ISTIMEWA YOGYAKARTA",3,135,92,227
https://kawalpemilu.org#42291,"SARDONOHARJO, NGAGLIK, SLEMAN, DAERAH ISTIMEWA YOGYAKARTA",4,137,69,206
https://kawalpemilu.org#42291,"SARDONOHARJO, NGAGLIK, SLEMAN, DAERAH ISTIMEWA YOGYAKARTA",5,158,82,240
https://kawalpemilu.org#42291,"SARDONOHARJO, NGAGLIK, SLEMAN, DAERAH ISTIMEWA YOGYAKARTA",6,174,78,252
https://kawalpemilu.org#42291,"SARDONOHARJO, NGAGLIK, SLEMAN, DAERAH ISTIMEWA YOGYAKARTA",7,137,125,262
https://kawalpemilu.org#42291,"SARDONOHARJO, NGAGLIK, SLEMAN, DAERAH ISTIMEWA YOGYAKARTA",8,157,99,256
https://kawalpemilu.org#42291,"SARDONOHARJO, NGAGLIK, SLEMAN, DAERAH ISTIMEWA YOGYAKARTA",9,178,83,261
https://kawalpemilu.org#42291,"SARDONOHARJO, NGAGLIK, SLEMAN, DAERAH ISTIMEWA YOGYAKARTA",10,0,0,0
https://kawalpemilu.org#42291,"SARDONOHARJO, NGAGLIK, SLEMAN, DAERAH ISTIMEWA YOGYAKARTA",11,180,74,254
https://kawalpemilu.org#42291,"SARDONOHARJO, NGAGLIK, SLEMAN, DAERAH ISTIMEWA YOGYAKARTA",12,110,72,182
https://kawalpemilu.org#42291,"SARDONOHARJO, NGAGLIK, SLEMAN, DAERAH ISTIMEWA YOGYAKARTA",13,113,51,164
https://kawalpemilu.org#42291,"SARDONOHARJO, NGAGLIK, SLEMAN, DAERAH ISTIMEWA YOGYAKARTA",14,173,101,274
https://kawalpemilu.org#42291,"SARDONOHARJO, NGAGLIK, SLEMAN, DAERAH ISTIMEWA YOGYAKARTA",15,168,105,273
https://kawalpemilu.org#42291,"SARDONOHARJO, NGAGLIK, SLEMAN, DAERAH ISTIMEWA YOGYAKARTA",16,166,93,259
https://kawalpemilu.org#42291,"SARDONOHARJO, NGAGLIK, SLEMAN, DAERAH ISTIMEWA YOGYAKARTA",17,233,56,289
https://kawalpemilu.org#42291,"SARDONOHARJO, NGAGLIK, SLEMAN, DAERAH ISTIMEWA YOGYAKARTA",18,139,121,260
https://kawalpemilu.org#42291,"SARDONOHARJO, NGAGLIK, SLEMAN, DAERAH ISTIMEWA YOGYAKARTA",19,160,90,250
https://kawalpemilu.org#42291,"SARDONOHARJO, NGAGLIK, SLEMAN, DAERAH ISTIMEWA YOGYAKARTA",20,138,103,241
https://kawalpemilu.org#42291,"SARDONOHARJO, NGAGLIK, SLEMAN, DAERAH ISTIMEWA YOGYAKARTA",21,140,87,227
https://kawalpemilu.org#42291,"SARDONOHARJO, NGAGLIK, SLEMAN, DAERAH ISTIMEWA YOGYAKARTA",22,109,89,198
https://kawalpemilu.org#42291,"SARDONOHARJO, NGAGLIK, SLEMAN, DAERAH ISTIMEWA YOGYAKARTA",23,129,110,239
https://kawalpemilu.org#42291,"SARDONOHARJO, NGAGLIK, SLEMAN, DAERAH ISTIMEWA YOGYAKARTA",24,175,116,291
https://kawalpemilu.org#42291,"SARDONOHARJO, NGAGLIK, SLEMAN, DAERAH ISTIMEWA YOGYAKARTA",25,137,103,240
https://kawalpemilu.org#42291,"SARDONOHARJO, NGAGLIK, SLEMAN, DAERAH ISTIMEWA YOGYAKARTA",26,157,107,264
https://kawalpemilu.org#42291,"SARDONOHARJO, NGAGLIK, SLEMAN, DAERAH ISTIMEWA YOGYAKARTA",27,144,140,284
https://kawalpemilu.org#42291,"SARDONOHARJO, NGAGLIK, SLEMAN, DAERAH ISTIMEWA YOGYAKARTA",28,145,83,228
https://kawalpemilu.org#42291,"SARDONOHARJO, NGAGLIK, SLEMAN, DAERAH ISTIMEWA YOGYAKARTA",29,111,67,111
https://kawalpemilu.org#42291,"SARDONOHARJO, NGAGLIK, SLEMAN, DAERAH ISTIMEWA YOGYAKARTA",30,198,67,265
https://kawalpemilu.org#42291,"SARDONOHARJO, NGAGLIK, SLEMAN, DAERAH ISTIMEWA YOGYAKARTA",31,188,105,293
https://kawalpemilu.org#42291,"SARDONOHARJO, NGAGLIK, SLEMAN, DAERAH ISTIMEWA YOGYAKARTA",32,173,95,268
https://kawalpemilu.org#42291,"SARDONOHARJO, NGAGLIK, SLEMAN, DAERAH ISTIMEWA YOGYAKARTA",33,196,94,290
https://kawalpemilu.org#42291,"SARDONOHARJO, NGAGLIK, SLEMAN, DAERAH ISTIMEWA YOGYAKARTA",34,160,87,247
https://kawalpemilu.org#42291,"SARDONOHARJO, NGAGLIK, SLEMAN, DAERAH ISTIMEWA YOGYAKARTA",35,150,83,233
https://kawalpemilu.org#42291,"SARDONOHARJO, NGAGLIK, SLEMAN, DAERAH ISTIMEWA YOGYAKARTA",36,146,111,257
https://kawalpemilu.org#42291,"SARDONOHARJO, NGAGLIK, SLEMAN, DAERAH ISTIMEWA YOGYAKARTA",37,118,81,199
https://kawalpemilu.org#42291,"SARDONOHARJO, NGAGLIK, SLEMAN, DAERAH ISTIMEWA YOGYAKARTA",38,201,39,240
https://kawalpemilu.org#42291,"SARDONOHARJO, NGAGLIK, SLEMAN, DAERAH ISTIMEWA YOGYAKARTA",39,229,67,296
https://kawalpemilu.org#42291,"SARDONOHARJO, NGAGLIK, SLEMAN, DAERAH ISTIMEWA YOGYAKARTA",40,193,75,268
https://kawalpemilu.org#42291,"SARDONOHARJO, NGAGLIK, SLEMAN, DAERAH ISTIMEWA YOGYAKARTA",41,129,108,237
https://kawalpemilu.org#42291,"SARDONOHARJO, NGAGLIK, SLEMAN, DAERAH ISTIMEWA YOGYAKARTA",42,138,46,184
https://kawalpemilu.org#42291,"SARDONOHARJO, NGAGLIK, SLEMAN, DAERAH ISTIMEWA YOGYAKARTA",43,124,87,211
https://kawalpemilu.org#42291,"SARDONOHARJO, NGAGLIK, SLEMAN, DAERAH ISTIMEWA YOGYAKARTA",44,197,83,280
https://kawalpemilu.org#42291,"SARDONOHARJO, NGAGLIK, SLEMAN, DAERAH ISTIMEWA YOGYAKARTA",45,180,104,284
https://kawalpemilu.org#42291,"SARDONOHARJO, NGAGLIK, SLEMAN, DAERAH ISTIMEWA YOGYAKARTA",46,106,118,224
https://kawalpemilu.org#42291,"SARDONOHARJO, NGAGLIK, SLEMAN, DAERAH ISTIMEWA YOGYAKARTA",47,158,103,261
https://kawalpemilu.org#42291,"SARDONOHARJO, NGAGLIK, SLEMAN, DAERAH ISTIMEWA YOGYAKARTA",48,105,102,207
https://kawalpemilu.org#42291,"SARDONOHARJO, NGAGLIK, SLEMAN, DAERAH ISTIMEWA YOGYAKARTA",49,134,105,239
https://kawalpemilu.org#42291,"SARDONOHARJO, NGAGLIK, SLEMAN, DAERAH ISTIMEWA YOGYAKARTA",50,172,103,275
https://kawalpemilu.org#42291,"SARDONOHARJO, NGAGLIK, SLEMAN, DAERAH ISTIMEWA YOGYAKARTA",51,163,97,260
https://kawalpemilu.org#42291,"SARDONOHARJO, NGAGLIK, SLEMAN, DAERAH ISTIMEWA YOGYAKARTA",52,153,88,241
https://kawalpemilu.org#42291,"SARDONOHARJO, NGAGLIK, SLEMAN, DAERAH ISTIMEWA YOGYAKARTA",53,156,72,228
https://kawalpemilu.org#42292,"DONOHARJO, NGAGLIK, SLEMAN, DAERAH ISTIMEWA YOGYAKARTA",1,158,93,251
https://kawalpemilu.org#42292,"DONOHARJO, NGAGLIK, SLEMAN, DAERAH ISTIMEWA YOGYAKARTA",2,124,102,226
https://kawalpemilu.org#42292,"DONOHARJO, NGAGLIK, SLEMAN, DAERAH ISTIMEWA YOGYAKARTA",3,164,66,230
https://kawalpemilu.org#42292,"DONOHARJO, NGAGLIK, SLEMAN, DAERAH ISTIMEWA YOGYAKARTA",4,101,72,173
https://kawalpemilu.org#42292,"DONOHARJO, NGAGLIK, SLEMAN, DAERAH ISTIMEWA YOGYAKARTA",5,118,55,173
https://kawalpemilu.org#42292,"DONOHARJO, NGAGLIK, SLEMAN, DAERAH ISTIMEWA YOGYAKARTA",6,121,91,212
https://kawalpemilu.org#42292,"DONOHARJO, NGAGLIK, SLEMAN, DAERAH ISTIMEWA YOGYAKARTA",7,160,51,201
https://kawalpemilu.org#42292,"DONOHARJO, NGAGLIK, SLEMAN, DAERAH ISTIMEWA YOGYAKARTA",9,77,46,123
https://kawalpemilu.org#42292,"DONOHARJO, NGAGLIK, SLEMAN, DAERAH ISTIMEWA YOGYAKARTA",10,85,34,119
https://kawalpemilu.org#42292,"DONOHARJO, NGAGLIK, SLEMAN, DAERAH ISTIMEWA YOGYAKARTA",12,145,106,251
https://kawalpemilu.org#42292,"DONOHARJO, NGAGLIK, SLEMAN, DAERAH ISTIMEWA YOGYAKARTA",13,93,86,179
https://kawalpemilu.org#42292,"DONOHARJO, NGAGLIK, SLEMAN, DAERAH ISTIMEWA YOGYAKARTA",14,136,73,209
https://kawalpemilu.org#42292,"DONOHARJO, NGAGLIK, SLEMAN, DAERAH ISTIMEWA YOGYAKARTA",15,174,82,256
https://kawalpemilu.org#42292,"DONOHARJO, NGAGLIK, SLEMAN, DAERAH ISTIMEWA YOGYAKARTA",16,98,106,204
https://kawalpemilu.org#42292,"DONOHARJO, NGAGLIK, SLEMAN, DAERAH ISTIMEWA YOGYAKARTA",17,159,84,243
https://kawalpemilu.org#42292,"DONOHARJO, NGAGLIK, SLEMAN, DAERAH ISTIMEWA YOGYAKARTA",18,187,46,233
https://kawalpemilu.org#42292,"DONOHARJO, NGAGLIK, SLEMAN, DAERAH ISTIMEWA YOGYAKARTA",19,154,81,235
https://kawalpemilu.org#42292,"DONOHARJO, NGAGLIK, SLEMAN, DAERAH ISTIMEWA YOGYAKARTA",20,148,28,176
https://kawalpemilu.org#42292,"DONOHARJO, NGAGLIK, SLEMAN, DAERAH ISTIMEWA YOGYAKARTA",21,158,62,220
https://kawalpemilu.org#42292,"DONOHARJO, NGAGLIK, SLEMAN, DAERAH ISTIMEWA YOGYAKARTA",22,126,52,178
https://kawalpemilu.org#42292,"DONOHARJO, NGAGLIK, SLEMAN, DAERAH ISTIMEWA YOGYAKARTA",23,151,41,192
https://kawalpemilu.org#42292,"DONOHARJO, NGAGLIK, SLEMAN, DAERAH ISTIMEWA YOGYAKARTA",24,149,72,221
https://kawalpemilu.org#42292,"DONOHARJO, NGAGLIK, SLEMAN, DAERAH ISTIMEWA YOGYAKARTA",26,180,74,254
https://kawalpemilu.org#42292,"DONOHARJO, NGAGLIK, SLEMAN, DAERAH ISTIMEWA YOGYAKARTA",27,141,130,271
https://kawalpemilu.org#42292,"DONOHARJO, NGAGLIK, SLEMAN, DAERAH ISTIMEWA YOGYAKARTA",28,138,31,169
https://kawalpemilu.org#42292,"DONOHARJO, NGAGLIK, SLEMAN, DAERAH ISTIMEWA YOGYAKARTA",29,120,72,192
https://kawalpemilu.org#42292,"DONOHARJO, NGAGLIK, SLEMAN, DAERAH ISTIMEWA YOGYAKARTA",30,130,54,184
https://kawalpemilu.org#42292,"DONOHARJO, NGAGLIK, SLEMAN, DAERAH ISTIMEWA YOGYAKARTA",31,130,71,201
https://kawalpemilu.org#42292,"DONOHARJO, NGAGLIK, SLEMAN, DAERAH ISTIMEWA YOGYAKARTA",32,132,87,219
https://kawalpemilu.org#42294,"CATURHARJO, SLEMAN, SLEMAN, DAERAH ISTIMEWA YOGYAKARTA",1,90,41,131
https://kawalpemilu.org#42294,"CATURHARJO, SLEMAN, SLEMAN, DAERAH ISTIMEWA YOGYAKARTA",2,100,43,143
https://kawalpemilu.org#42294,"CATURHARJO, SLEMAN, SLEMAN, DAERAH ISTIMEWA YOGYAKARTA",3,109,50,159
https://kawalpemilu.org#42294,"CATURHARJO, SLEMAN, SLEMAN, DAERAH ISTIMEWA YOGYAKARTA",4,147,65,212
https://kawalpemilu.org#42294,"CATURHARJO, SLEMAN, SLEMAN, DAERAH ISTIMEWA YOGYAKARTA",5,111,35,146
https://kawalpemilu.org#42294,"CATURHARJO, SLEMAN, SLEMAN, DAERAH ISTIMEWA YOGYAKARTA",6,79,96,175
https://kawalpemilu.org#42294,"CATURHARJO, SLEMAN, SLEMAN, DAERAH ISTIMEWA YOGYAKARTA",7,136,77,213
https://kawalpemilu.org#42294,"CATURHARJO, SLEMAN, SLEMAN, DAERAH ISTIMEWA YOGYAKARTA",8,174,84,258
https://kawalpemilu.org#42294,"CATURHARJO, SLEMAN, SLEMAN, DAERAH ISTIMEWA YOGYAKARTA",9,57,47,104
https://kawalpemilu.org#42294,"CATURHARJO, SLEMAN, SLEMAN, DAERAH ISTIMEWA YOGYAKARTA",10,97,64,161
https://kawalpemilu.org#42294,"CATURHARJO, SLEMAN, SLEMAN, DAERAH ISTIMEWA YOGYAKARTA",11,130,89,219
https://kawalpemilu.org#42294,"CATURHARJO, SLEMAN, SLEMAN, DAERAH ISTIMEWA YOGYAKARTA",12,100,42,142
https://kawalpemilu.org#42294,"CATURHARJO, SLEMAN, SLEMAN, DAERAH ISTIMEWA YOGYAKARTA",13,114,64,178
https://kawalpemilu.org#42294,"CATURHARJO, SLEMAN, SLEMAN, DAERAH ISTIMEWA YOGYAKARTA",14,120,99,219
https://kawalpemilu.org#42294,"CATURHARJO, SLEMAN, SLEMAN, DAERAH ISTIMEWA YOGYAKARTA",15,181,62,243
https://kawalpemilu.org#42294,"CATURHARJO, SLEMAN, SLEMAN, DAERAH ISTIMEWA YOGYAKARTA",16,132,87,219
https://kawalpemilu.org#42294,"CATURHARJO, SLEMAN, SLEMAN, DAERAH ISTIMEWA YOGYAKARTA",17,122,72,194
https://kawalpemilu.org#42294,"CATURHARJO, SLEMAN, SLEMAN, DAERAH ISTIMEWA YOGYAKARTA",18,134,88,222
https://kawalpemilu.org#42294,"CATURHARJO, SLEMAN, SLEMAN, DAERAH ISTIMEWA YOGYAKARTA",19,127,83,210
https://kawalpemilu.org#42294,"CATURHARJO, SLEMAN, SLEMAN, DAERAH ISTIMEWA YOGYAKARTA",20,189,69,258
https://kawalpemilu.org#42294,"CATURHARJO, SLEMAN, SLEMAN, DAERAH ISTIMEWA YOGYAKARTA",21,189,31,220
https://kawalpemilu.org#42294,"CATURHARJO, SLEMAN, SLEMAN, DAERAH ISTIMEWA YOGYAKARTA",22,147,44,191
https://kawalpemilu.org#42294,"CATURHARJO, SLEMAN, SLEMAN, DAERAH ISTIMEWA YOGYAKARTA",23,182,45,227
https://kawalpemilu.org#42294,"CATURHARJO, SLEMAN, SLEMAN, DAERAH ISTIMEWA YOGYAKARTA",24,131,55,186
https://kawalpemilu.org#42294,"CATURHARJO, SLEMAN, SLEMAN, DAERAH ISTIMEWA YOGYAKARTA",25,153,80,233
https://kawalpemilu.org#42294,"CATURHARJO, SLEMAN, SLEMAN, DAERAH ISTIMEWA YOGYAKARTA",26,140,61,201
https://kawalpemilu.org#42294,"CATURHARJO, SLEMAN, SLEMAN, DAERAH ISTIMEWA YOGYAKARTA",27,164,73,237
https://kawalpemilu.org#42294,"CATURHARJO, SLEMAN, SLEMAN, DAERAH ISTIMEWA YOGYAKARTA",28,177,49,226
https://kawalpemilu.org#42294,"CATURHARJO, SLEMAN, SLEMAN, DAERAH ISTIMEWA YOGYAKARTA",29,187,76,263
https://kawalpemilu.org#42294,"CATURHARJO, SLEMAN, SLEMAN, DAERAH ISTIMEWA YOGYAKARTA",30,117,75,192
https://kawalpemilu.org#42294,"CATURHARJO, SLEMAN, SLEMAN, DAERAH ISTIMEWA YOGYAKARTA",31,163,88,251
https://kawalpemilu.org#42294,"CATURHARJO, SLEMAN, SLEMAN, DAERAH ISTIMEWA YOGYAKARTA",32,155,56,211
https://kawalpemilu.org#42294,"CATURHARJO, SLEMAN, SLEMAN, DAERAH ISTIMEWA YOGYAKARTA",33,179,78,257
https://kawalpemilu.org#42294,"CATURHARJO, SLEMAN, SLEMAN, DAERAH ISTIMEWA YOGYAKARTA",34,86,57,143
https://kawalpemilu.org#42294,"CATURHARJO, SLEMAN, SLEMAN, DAERAH ISTIMEWA YOGYAKARTA",35,84,68,152
https://kawalpemilu.org#42294,"CATURHARJO, SLEMAN, SLEMAN, DAERAH ISTIMEWA YOGYAKARTA",36,91,93,184
https://kawalpemilu.org#42294,"CATURHARJO, SLEMAN, SLEMAN, DAERAH ISTIMEWA YOGYAKARTA",37,105,114,219
https://kawalpemilu.org#42294,"CATURHARJO, SLEMAN, SLEMAN, DAERAH ISTIMEWA YOGYAKARTA",38,128,91,219
https://kawalpemilu.org#42294,"CATURHARJO, SLEMAN, SLEMAN, DAERAH ISTIMEWA YOGYAKARTA",39,134,27,161
https://kawalpemilu.org#42294,"CATURHARJO, SLEMAN, SLEMAN, DAERAH ISTIMEWA YOGYAKARTA",40,111,62,173
https://kawalpemilu.org#42294,"CATURHARJO, SLEMAN, SLEMAN, DAERAH ISTIMEWA YOGYAKARTA",41,130,57,187
https://kawalpemilu.org#42294,"CATURHARJO, SLEMAN, SLEMAN, DAERAH ISTIMEWA YOGYAKARTA",42,147,73,220
https://kawalpemilu.org#42294,"CATURHARJO, SLEMAN, SLEMAN, DAERAH ISTIMEWA YOGYAKARTA",43,121,113,234
https://kawalpemilu.org#42294,"CATURHARJO, SLEMAN, SLEMAN, DAERAH ISTIMEWA YOGYAKARTA",44,179,59,238
https://kawalpemilu.org#42294,"CATURHARJO, SLEMAN, SLEMAN, DAERAH ISTIMEWA YOGYAKARTA",45,179,41,220
https://kawalpemilu.org#42294,"CATURHARJO, SLEMAN, SLEMAN, DAERAH ISTIMEWA YOGYAKARTA",46,77,46,123
https://kawalpemilu.org#42294,"CATURHARJO, SLEMAN, SLEMAN, DAERAH ISTIMEWA YOGYAKARTA",48,206,38,244
https://kawalpemilu.org#42294,"CATURHARJO, SLEMAN, SLEMAN, DAERAH ISTIMEWA YOGYAKARTA",49,121,17,138
https://kawalpemilu.org#42295,"TRIHARJO, SLEMAN, SLEMAN, DAERAH ISTIMEWA YOGYAKARTA",1,69,56,125
https://kawalpemilu.org#42295,"TRIHARJO, SLEMAN, SLEMAN, DAERAH ISTIMEWA YOGYAKARTA",2,102,83,185
https://kawalpemilu.org#42295,"TRIHARJO, SLEMAN, SLEMAN, DAERAH ISTIMEWA YOGYAKARTA",3,92,136,228
https://kawalpemilu.org#42295,"TRIHARJO, SLEMAN, SLEMAN, DAERAH ISTIMEWA YOGYAKARTA",4,132,79,211
https://kawalpemilu.org#42295,"TRIHARJO, SLEMAN, SLEMAN, DAERAH ISTIMEWA YOGYAKARTA",5,132,63,195
https://kawalpemilu.org#42295,"TRIHARJO, SLEMAN, SLEMAN, DAERAH ISTIMEWA YOGYAKARTA",6,78,66,144
https://kawalpemilu.org#42295,"TRIHARJO, SLEMAN, SLEMAN, DAERAH ISTIMEWA YOGYAKARTA",7,127,136,163
https://kawalpemilu.org#42295,"TRIHARJO, SLEMAN, SLEMAN, DAERAH ISTIMEWA YOGYAKARTA",8,132,91,223
https://kawalpemilu.org#42295,"TRIHARJO, SLEMAN, SLEMAN, DAERAH ISTIMEWA YOGYAKARTA",9,105,142,247
https://kawalpemilu.org#42295,"TRIHARJO, SLEMAN, SLEMAN, DAERAH ISTIMEWA YOGYAKARTA",10,90,107,197
https://kawalpemilu.org#42295,"TRIHARJO, SLEMAN, SLEMAN, DAERAH ISTIMEWA YOGYAKARTA",11,113,74,187
https://kawalpemilu.org#42295,"TRIHARJO, SLEMAN, SLEMAN, DAERAH ISTIMEWA YOGYAKARTA",12,114,120,234
https://kawalpemilu.org#42295,"TRIHARJO, SLEMAN, SLEMAN, DAERAH ISTIMEWA YOGYAKARTA",13,117,65,182
https://kawalpemilu.org#42295,"TRIHARJO, SLEMAN, SLEMAN, DAERAH ISTIMEWA YOGYAKARTA",14,180,54,234
https://kawalpemilu.org#42295,"TRIHARJO, SLEMAN, SLEMAN, DAERAH ISTIMEWA YOGYAKARTA",15,160,49,209
https://kawalpemilu.org#42295,"TRIHARJO, SLEMAN, SLEMAN, DAERAH ISTIMEWA YOGYAKARTA",16,166,106,272
https://kawalpemilu.org#42295,"TRIHARJO, SLEMAN, SLEMAN, DAERAH ISTIMEWA YOGYAKARTA",17,108,102,210
https://kawalpemilu.org#42295,"TRIHARJO, SLEMAN, SLEMAN, DAERAH ISTIMEWA YOGYAKARTA",18,111,60,171
https://kawalpemilu.org#42295,"TRIHARJO, SLEMAN, SLEMAN, DAERAH ISTIMEWA YOGYAKARTA",19,127,34,161
https://kawalpemilu.org#42295,"TRIHARJO, SLEMAN, SLEMAN, DAERAH ISTIMEWA YOGYAKARTA",20,126,39,165
https://kawalpemilu.org#42295,"TRIHARJO, SLEMAN, SLEMAN, DAERAH ISTIMEWA YOGYAKARTA",21,102,52,154
https://kawalpemilu.org#42295,"TRIHARJO, SLEMAN, SLEMAN, DAERAH ISTIMEWA YOGYAKARTA",22,158,93,251
https://kawalpemilu.org#42295,"TRIHARJO, SLEMAN, SLEMAN, DAERAH ISTIMEWA YOGYAKARTA",23,63,35,98
https://kawalpemilu.org#42295,"TRIHARJO, SLEMAN, SLEMAN, DAERAH ISTIMEWA YOGYAKARTA",24,98,69,167
https://kawalpemilu.org#42295,"TRIHARJO, SLEMAN, SLEMAN, DAERAH ISTIMEWA YOGYAKARTA",25,111,47,158
https://kawalpemilu.org#42295,"TRIHARJO, SLEMAN, SLEMAN, DAERAH ISTIMEWA YOGYAKARTA",26,158,62,220
https://kawalpemilu.org#42295,"TRIHARJO, SLEMAN, SLEMAN, DAERAH ISTIMEWA YOGYAKARTA",27,112,83,195
https://kawalpemilu.org#42295,"TRIHARJO, SLEMAN, SLEMAN, DAERAH ISTIMEWA YOGYAKARTA",28,114,67,181
https://kawalpemilu.org#42295,"TRIHARJO, SLEMAN, SLEMAN, DAERAH ISTIMEWA YOGYAKARTA",29,123,94,217
https://kawalpemilu.org#42295,"TRIHARJO, SLEMAN, SLEMAN, DAERAH ISTIMEWA YOGYAKARTA",30,85,80,165
https://kawalpemilu.org#42295,"TRIHARJO, SLEMAN, SLEMAN, DAERAH ISTIMEWA YOGYAKARTA",31,140,89,229
https://kawalpemilu.org#42295,"TRIHARJO, SLEMAN, SLEMAN, DAERAH ISTIMEWA YOGYAKARTA",32,114,76,190
https://kawalpemilu.org#42295,"TRIHARJO, SLEMAN, SLEMAN, DAERAH ISTIMEWA YOGYAKARTA",33,95,96,191
https://kawalpemilu.org#42295,"TRIHARJO, SLEMAN, SLEMAN, DAERAH ISTIMEWA YOGYAKARTA",34,53,38,91
https://kawalpemilu.org#42295,"TRIHARJO, SLEMAN, SLEMAN, DAERAH ISTIMEWA YOGYAKARTA",35,178,67,245
https://kawalpemilu.org#42295,"TRIHARJO, SLEMAN, SLEMAN, DAERAH ISTIMEWA YOGYAKARTA",36,198,61,259
https://kawalpemilu.org#42295,"TRIHARJO, SLEMAN, SLEMAN, DAERAH ISTIMEWA YOGYAKARTA",37,159,54,213
https://kawalpemilu.org#42295,"TRIHARJO, SLEMAN, SLEMAN, DAERAH ISTIMEWA YOGYAKARTA",38,94,54,148
https://kawalpemilu.org#42295,"TRIHARJO, SLEMAN, SLEMAN, DAERAH ISTIMEWA YOGYAKARTA",39,146,119,265
https://kawalpemilu.org#42295,"TRIHARJO, SLEMAN, SLEMAN, DAERAH ISTIMEWA YOGYAKARTA",40,101,69,170
https://kawalpemilu.org#42295,"TRIHARJO, SLEMAN, SLEMAN, DAERAH ISTIMEWA YOGYAKARTA",41,160,49,209
https://kawalpemilu.org#42295,"TRIHARJO, SLEMAN, SLEMAN, DAERAH ISTIMEWA YOGYAKARTA",42,134,85,219
https://kawalpemilu.org#42295,"TRIHARJO, SLEMAN, SLEMAN, DAERAH ISTIMEWA YOGYAKARTA",43,116,49,165
https://kawalpemilu.org#42295,"TRIHARJO, SLEMAN, SLEMAN, DAERAH ISTIMEWA YOGYAKARTA",44,179,90,269
https://kawalpemilu.org#42295,"TRIHARJO, SLEMAN, SLEMAN, DAERAH ISTIMEWA YOGYAKARTA",45,97,54,151
https://kawalpemilu.org#42295,"TRIHARJO, SLEMAN, SLEMAN, DAERAH ISTIMEWA YOGYAKARTA",46,71,109,180
https://kawalpemilu.org#42295,"TRIHARJO, SLEMAN, SLEMAN, DAERAH ISTIMEWA YOGYAKARTA",47,114,134,248
https://kawalpemilu.org#42295,"TRIHARJO, SLEMAN, SLEMAN, DAERAH ISTIMEWA YOGYAKARTA",48,88,121,209
https://kawalpemilu.org#42295,"TRIHARJO, SLEMAN, SLEMAN, DAERAH ISTIMEWA YOGYAKARTA",49,119,50,169
https://kawalpemilu.org#42295,"TRIHARJO, SLEMAN, SLEMAN, DAERAH ISTIMEWA YOGYAKARTA",50,120,51,171
https://kawalpemilu.org#42295,"TRIHARJO, SLEMAN, SLEMAN, DAERAH ISTIMEWA YOGYAKARTA",51,79,101,180
https://kawalpemilu.org#42295,"TRIHARJO, SLEMAN, SLEMAN, DAERAH ISTIMEWA YOGYAKARTA",52,87,101,188
https://kawalpemilu.org#42295,"TRIHARJO, SLEMAN, SLEMAN, DAERAH ISTIMEWA YOGYAKARTA",53,85,61,146
https://kawalpemilu.org#42295,"TRIHARJO, SLEMAN, SLEMAN, DAERAH ISTIMEWA YOGYAKARTA",54,111,102,213
https://kawalpemilu.org#42295,"TRIHARJO, SLEMAN, SLEMAN, DAERAH ISTIMEWA YOGYAKARTA",55,120,122,242
https://kawalpemilu.org#42295,"TRIHARJO, SLEMAN, SLEMAN, DAERAH ISTIMEWA YOGYAKARTA",56,127,102,229
https://kawalpemilu.org#42295,"TRIHARJO, SLEMAN, SLEMAN, DAERAH ISTIMEWA YOGYAKARTA",57,89,139,228
https://kawalpemilu.org#42295,"TRIHARJO, SLEMAN, SLEMAN, DAERAH ISTIMEWA YOGYAKARTA",58,127,58,185
https://kawalpemilu.org#42295,"TRIHARJO, SLEMAN, SLEMAN, DAERAH ISTIMEWA YOGYAKARTA",59,69,72,141
https://kawalpemilu.org#42295,"TRIHARJO, SLEMAN, SLEMAN, DAERAH ISTIMEWA YOGYAKARTA",60,48,74,122
https://kawalpemilu.org#42296,"TRIDADI, SLEMAN, SLEMAN, DAERAH ISTIMEWA YOGYAKARTA",1,89,34,123
https://kawalpemilu.org#42296,"TRIDADI, SLEMAN, SLEMAN, DAERAH ISTIMEWA YOGYAKARTA",2,147,44,191
https://kawalpemilu.org#42296,"TRIDADI, SLEMAN, SLEMAN, DAERAH ISTIMEWA YOGYAKARTA",3,132,40,172
https://kawalpemilu.org#42296,"TRIDADI, SLEMAN, SLEMAN, DAERAH ISTIMEWA YOGYAKARTA",4,112,53,165
https://kawalpemilu.org#42296,"TRIDADI, SLEMAN, SLEMAN, DAERAH ISTIMEWA YOGYAKARTA",5,179,71,250
https://kawalpemilu.org#42296,"TRIDADI, SLEMAN, SLEMAN, DAERAH ISTIMEWA YOGYAKARTA",6,200,56,256
https://kawalpemilu.org#42296,"TRIDADI, SLEMAN, SLEMAN, DAERAH ISTIMEWA YOGYAKARTA",7,165,67,232
https://kawalpemilu.org#42296,"TRIDADI, SLEMAN, SLEMAN, DAERAH ISTIMEWA YOGYAKARTA",8,198,50,248
https://kawalpemilu.org#42296,"TRIDADI, SLEMAN, SLEMAN, DAERAH ISTIMEWA YOGYAKARTA",9,98,111,209
https://kawalpemilu.org#42296,"TRIDADI, SLEMAN, SLEMAN, DAERAH ISTIMEWA YOGYAKARTA",10,200,59,259
https://kawalpemilu.org#42296,"TRIDADI, SLEMAN, SLEMAN, DAERAH ISTIMEWA YOGYAKARTA",11,197,51,248
https://kawalpemilu.org#42296,"TRIDADI, SLEMAN, SLEMAN, DAERAH ISTIMEWA YOGYAKARTA",12,183,54,237
https://kawalpemilu.org#42296,"TRIDADI, SLEMAN, SLEMAN, DAERAH ISTIMEWA YOGYAKARTA",13,187,52,239
https://kawalpemilu.org#42296,"TRIDADI, SLEMAN, SLEMAN, DAERAH ISTIMEWA YOGYAKARTA",14,125,78,203
https://kawalpemilu.org#42296,"TRIDADI, SLEMAN, SLEMAN, DAERAH ISTIMEWA YOGYAKARTA",15,192,73,265
https://kawalpemilu.org#42296,"TRIDADI, SLEMAN, SLEMAN, DAERAH ISTIMEWA YOGYAKARTA",16,146,93,239
https://kawalpemilu.org#42296,"TRIDADI, SLEMAN, SLEMAN, DAERAH ISTIMEWA YOGYAKARTA",17,164,78,242
https://kawalpemilu.org#42296,"TRIDADI, SLEMAN, SLEMAN, DAERAH ISTIMEWA YOGYAKARTA",18,173,46,219
https://kawalpemilu.org#42296,"TRIDADI, SLEMAN, SLEMAN, DAERAH ISTIMEWA YOGYAKARTA",19,138,65,203
https://kawalpemilu.org#42296,"TRIDADI, SLEMAN, SLEMAN, DAERAH ISTIMEWA YOGYAKARTA",20,117,60,177
https://kawalpemilu.org#42296,"TRIDADI, SLEMAN, SLEMAN, DAERAH ISTIMEWA YOGYAKARTA",21,82,119,201
https://kawalpemilu.org#42296,"TRIDADI, SLEMAN, SLEMAN, DAERAH ISTIMEWA YOGYAKARTA",22,152,65,217
https://kawalpemilu.org#42296,"TRIDADI, SLEMAN, SLEMAN, DAERAH ISTIMEWA YOGYAKARTA",23,174,48,222
https://kawalpemilu.org#42296,"TRIDADI, SLEMAN, SLEMAN, DAERAH ISTIMEWA YOGYAKARTA",24,169,83,252
https://kawalpemilu.org#42296,"TRIDADI, SLEMAN, SLEMAN, DAERAH ISTIMEWA YOGYAKARTA",25,160,63,223
https://kawalpemilu.org#42296,"TRIDADI, SLEMAN, SLEMAN, DAERAH ISTIMEWA YOGYAKARTA",26,154,89,243
https://kawalpemilu.org#42296,"TRIDADI, SLEMAN, SLEMAN, DAERAH ISTIMEWA YOGYAKARTA",27,136,102,238
https://kawalpemilu.org#42296,"TRIDADI, SLEMAN, SLEMAN, DAERAH ISTIMEWA YOGYAKARTA",28,108,81,189
https://kawalpemilu.org#42296,"TRIDADI, SLEMAN, SLEMAN, DAERAH ISTIMEWA YOGYAKARTA",29,111,95,206
https://kawalpemilu.org#42296,"TRIDADI, SLEMAN, SLEMAN, DAERAH ISTIMEWA YOGYAKARTA",30,106,123,229
https://kawalpemilu.org#42296,"TRIDADI, SLEMAN, SLEMAN, DAERAH ISTIMEWA YOGYAKARTA",31,131,41,172
https://kawalpemilu.org#42296,"TRIDADI, SLEMAN, SLEMAN, DAERAH ISTIMEWA YOGYAKARTA",32,110,87,197
https://kawalpemilu.org#42296,"TRIDADI, SLEMAN, SLEMAN, DAERAH ISTIMEWA YOGYAKARTA",33,91,47,138
https://kawalpemilu.org#42296,"TRIDADI, SLEMAN, SLEMAN, DAERAH ISTIMEWA YOGYAKARTA",34,128,65,193
https://kawalpemilu.org#42296,"TRIDADI, SLEMAN, SLEMAN, DAERAH ISTIMEWA YOGYAKARTA",35,150,56,205
https://kawalpemilu.org#42296,"TRIDADI, SLEMAN, SLEMAN, DAERAH ISTIMEWA YOGYAKARTA",36,153,39,192
https://kawalpemilu.org#42296,"TRIDADI, SLEMAN, SLEMAN, DAERAH ISTIMEWA YOGYAKARTA",37,125,65,190
https://kawalpemilu.org#42296,"TRIDADI, SLEMAN, SLEMAN, DAERAH ISTIMEWA YOGYAKARTA",39,170,79,249
https://kawalpemilu.org#42296,"TRIDADI, SLEMAN, SLEMAN, DAERAH ISTIMEWA YOGYAKARTA",40,115,42,157
https://kawalpemilu.org#42296,"TRIDADI, SLEMAN, SLEMAN, DAERAH ISTIMEWA YOGYAKARTA",41,171,82,252
https://kawalpemilu.org#42296,"TRIDADI, SLEMAN, SLEMAN, DAERAH ISTIMEWA YOGYAKARTA",42,99,62,161
https://kawalpemilu.org#42296,"TRIDADI, SLEMAN, SLEMAN, DAERAH ISTIMEWA YOGYAKARTA",43,109,62,171
https://kawalpemilu.org#42296,"TRIDADI, SLEMAN, SLEMAN, DAERAH ISTIMEWA YOGYAKARTA",44,135,47,182
https://kawalpemilu.org#42296,"TRIDADI, SLEMAN, SLEMAN, DAERAH ISTIMEWA YOGYAKARTA",45,145,29,174
https://kawalpemilu.org#42296,"TRIDADI, SLEMAN, SLEMAN, DAERAH ISTIMEWA YOGYAKARTA",46,95,58,153
https://kawalpemilu.org#42296,"TRIDADI, SLEMAN, SLEMAN, DAERAH ISTIMEWA YOGYAKARTA",47,146,49,195
https://kawalpemilu.org#42297,"PANDOWOHARJO, SLEMAN, SLEMAN, DAERAH ISTIMEWA YOGYAKARTA",1,174,46,220
https://kawalpemilu.org#42297,"PANDOWOHARJO, SLEMAN, SLEMAN, DAERAH ISTIMEWA YOGYAKARTA",2,173,60,233
https://kawalpemilu.org#42297,"PANDOWOHARJO, SLEMAN, SLEMAN, DAERAH ISTIMEWA YOGYAKARTA",3,153,62,215
https://kawalpemilu.org#42297,"PANDOWOHARJO, SLEMAN, SLEMAN, DAERAH ISTIMEWA YOGYAKARTA",4,187,68,255
https://kawalpemilu.org#42297,"PANDOWOHARJO, SLEMAN, SLEMAN, DAERAH ISTIMEWA YOGYAKARTA",5,134,57,191
https://kawalpemilu.org#42297,"PANDOWOHARJO, SLEMAN, SLEMAN, DAERAH ISTIMEWA YOGYAKARTA",6,165,35,200
https://kawalpemilu.org#42297,"PANDOWOHARJO, SLEMAN, SLEMAN, DAERAH ISTIMEWA YOGYAKARTA",7,186,61,247
https://kawalpemilu.org#42297,"PANDOWOHARJO, SLEMAN, SLEMAN, DAERAH ISTIMEWA YOGYAKARTA",8,130,57,187
https://kawalpemilu.org#42297,"PANDOWOHARJO, SLEMAN, SLEMAN, DAERAH ISTIMEWA YOGYAKARTA",9,129,98,227
https://kawalpemilu.org#42297,"PANDOWOHARJO, SLEMAN, SLEMAN, DAERAH ISTIMEWA YOGYAKARTA",10,131,75,206
https://kawalpemilu.org#42297,"PANDOWOHARJO, SLEMAN, SLEMAN, DAERAH ISTIMEWA YOGYAKARTA",11,163,36,199
https://kawalpemilu.org#42297,"PANDOWOHARJO, SLEMAN, SLEMAN, DAERAH ISTIMEWA YOGYAKARTA",12,161,114,275
https://kawalpemilu.org#42297,"PANDOWOHARJO, SLEMAN, SLEMAN, DAERAH ISTIMEWA YOGYAKARTA",13,123,123,246
https://kawalpemilu.org#42297,"PANDOWOHARJO, SLEMAN, SLEMAN, DAERAH ISTIMEWA YOGYAKARTA",14,121,118,239
https://kawalpemilu.org#42297,"PANDOWOHARJO, SLEMAN, SLEMAN, DAERAH ISTIMEWA YOGYAKARTA",15,152,101,253
https://kawalpemilu.org#42297,"PANDOWOHARJO, SLEMAN, SLEMAN, DAERAH ISTIMEWA YOGYAKARTA",16,174,59,233
https://kawalpemilu.org#42297,"PANDOWOHARJO, SLEMAN, SLEMAN, DAERAH ISTIMEWA YOGYAKARTA",17,165,91,256
https://kawalpemilu.org#42297,"PANDOWOHARJO, SLEMAN, SLEMAN, DAERAH ISTIMEWA YOGYAKARTA",18,192,72,264
https://kawalpemilu.org#42297,"PANDOWOHARJO, SLEMAN, SLEMAN, DAERAH ISTIMEWA YOGYAKARTA",19,196,66,262
https://kawalpemilu.org#42297,"PANDOWOHARJO, SLEMAN, SLEMAN, DAERAH ISTIMEWA YOGYAKARTA",20,146,75,221
https://kawalpemilu.org#42297,"PANDOWOHARJO, SLEMAN, SLEMAN, DAERAH ISTIMEWA YOGYAKARTA",21,139,59,198
https://kawalpemilu.org#42297,"PANDOWOHARJO, SLEMAN, SLEMAN, DAERAH ISTIMEWA YOGYAKARTA",22,151,79,230
https://kawalpemilu.org#42297,"PANDOWOHARJO, SLEMAN, SLEMAN, DAERAH ISTIMEWA YOGYAKARTA",23,187,64,251
https://kawalpemilu.org#42297,"PANDOWOHARJO, SLEMAN, SLEMAN, DAERAH ISTIMEWA YOGYAKARTA",24,153,75,228
https://kawalpemilu.org#42297,"PANDOWOHARJO, SLEMAN, SLEMAN, DAERAH ISTIMEWA YOGYAKARTA",25,131,60,191
https://kawalpemilu.org#42297,"PANDOWOHARJO, SLEMAN, SLEMAN, DAERAH ISTIMEWA YOGYAKARTA",26,124,39,163
https://kawalpemilu.org#42297,"PANDOWOHARJO, SLEMAN, SLEMAN, DAERAH ISTIMEWA YOGYAKARTA",27,172,87,259
https://kawalpemilu.org#42297,"PANDOWOHARJO, SLEMAN, SLEMAN, DAERAH ISTIMEWA YOGYAKARTA",28,136,79,215
https://kawalpemilu.org#42297,"PANDOWOHARJO, SLEMAN, SLEMAN, DAERAH ISTIMEWA YOGYAKARTA",29,144,70,214
https://kawalpemilu.org#42297,"PANDOWOHARJO, SLEMAN, SLEMAN, DAERAH ISTIMEWA YOGYAKARTA",30,128,76,204
https://kawalpemilu.org#42297,"PANDOWOHARJO, SLEMAN, SLEMAN, DAERAH ISTIMEWA YOGYAKARTA",31,163,79,242
https://kawalpemilu.org#42297,"PANDOWOHARJO, SLEMAN, SLEMAN, DAERAH ISTIMEWA YOGYAKARTA",32,163,64,227
https://kawalpemilu.org#42297,"PANDOWOHARJO, SLEMAN, SLEMAN, DAERAH ISTIMEWA YOGYAKARTA",33,166,113,279
https://kawalpemilu.org#42297,"PANDOWOHARJO, SLEMAN, SLEMAN, DAERAH ISTIMEWA YOGYAKARTA",35,145,108,253
https://kawalpemilu.org#42298,"TRIMULYO, SLEMAN, SLEMAN, DAERAH ISTIMEWA YOGYAKARTA",1,200,36,236
https://kawalpemilu.org#42298,"TRIMULYO, SLEMAN, SLEMAN, DAERAH ISTIMEWA YOGYAKARTA",2,169,62,231
https://kawalpemilu.org#42298,"TRIMULYO, SLEMAN, SLEMAN, DAERAH ISTIMEWA YOGYAKARTA",3,104,41,145
https://kawalpemilu.org#42298,"TRIMULYO, SLEMAN, SLEMAN, DAERAH ISTIMEWA YOGYAKARTA",4,161,79,240
https://kawalpemilu.org#42298,"TRIMULYO, SLEMAN, SLEMAN, DAERAH ISTIMEWA YOGYAKARTA",5,145,101,246
https://kawalpemilu.org#42298,"TRIMULYO, SLEMAN, SLEMAN, DAERAH ISTIMEWA YOGYAKARTA",6,164,62,226
https://kawalpemilu.org#42298,"TRIMULYO, SLEMAN, SLEMAN, DAERAH ISTIMEWA YOGYAKARTA",7,151,21,172
https://kawalpemilu.org#42298,"TRIMULYO, SLEMAN, SLEMAN, DAERAH ISTIMEWA YOGYAKARTA",8,161,48,209
https://kawalpemilu.org#42298,"TRIMULYO, SLEMAN, SLEMAN, DAERAH ISTIMEWA YOGYAKARTA",9,114,137,251
https://kawalpemilu.org#42298,"TRIMULYO, SLEMAN, SLEMAN, DAERAH ISTIMEWA YOGYAKARTA",10,147,95,242
https://kawalpemilu.org#42298,"TRIMULYO, SLEMAN, SLEMAN, DAERAH ISTIMEWA YOGYAKARTA",11,180,96,276
https://kawalpemilu.org#42298,"TRIMULYO, SLEMAN, SLEMAN, DAERAH ISTIMEWA YOGYAKARTA",12,168,65,233
https://kawalpemilu.org#42298,"TRIMULYO, SLEMAN, SLEMAN, DAERAH ISTIMEWA YOGYAKARTA",13,170,88,258
https://kawalpemilu.org#42298,"TRIMULYO, SLEMAN, SLEMAN, DAERAH ISTIMEWA YOGYAKARTA",14,143,107,250
https://kawalpemilu.org#42298,"TRIMULYO, SLEMAN, SLEMAN, DAERAH ISTIMEWA YOGYAKARTA",15,131,88,219
https://kawalpemilu.org#42298,"TRIMULYO, SLEMAN, SLEMAN, DAERAH ISTIMEWA YOGYAKARTA",16,169,63,232
https://kawalpemilu.org#42298,"TRIMULYO, SLEMAN, SLEMAN, DAERAH ISTIMEWA YOGYAKARTA",17,90,46,136
https://kawalpemilu.org#42298,"TRIMULYO, SLEMAN, SLEMAN, DAERAH ISTIMEWA YOGYAKARTA",18,182,75,257
https://kawalpemilu.org#42298,"TRIMULYO, SLEMAN, SLEMAN, DAERAH ISTIMEWA YOGYAKARTA",19,140,112,252
https://kawalpemilu.org#42298,"TRIMULYO, SLEMAN, SLEMAN, DAERAH ISTIMEWA YOGYAKARTA",20,163,43,206
https://kawalpemilu.org#42298,"TRIMULYO, SLEMAN, SLEMAN, DAERAH ISTIMEWA YOGYAKARTA",21,159,85,244
https://kawalpemilu.org#42298,"TRIMULYO, SLEMAN, SLEMAN, DAERAH ISTIMEWA YOGYAKARTA",22,161,51,212
https://kawalpemilu.org#42298,"TRIMULYO, SLEMAN, SLEMAN, DAERAH ISTIMEWA YOGYAKARTA",23,130,55,185
https://kawalpemilu.org#42298,"TRIMULYO, SLEMAN, SLEMAN, DAERAH ISTIMEWA YOGYAKARTA",24,148,88,236
https://kawalpemilu.org#42298,"TRIMULYO, SLEMAN, SLEMAN, DAERAH ISTIMEWA YOGYAKARTA",25,140,81,221
https://kawalpemilu.org#42298,"TRIMULYO, SLEMAN, SLEMAN, DAERAH ISTIMEWA YOGYAKARTA",26,154,90,244
https://kawalpemilu.org#42298,"TRIMULYO, SLEMAN, SLEMAN, DAERAH ISTIMEWA YOGYAKARTA",27,139,74,213
https://kawalpemilu.org#42298,"TRIMULYO, SLEMAN, SLEMAN, DAERAH ISTIMEWA YOGYAKARTA",28,142,54,196
https://kawalpemilu.org#42300,"BANYUREJO, TEMPEL, SLEMAN, DAERAH ISTIMEWA YOGYAKARTA",1,104,134,238
https://kawalpemilu.org#42300,"BANYUREJO, TEMPEL, SLEMAN, DAERAH ISTIMEWA YOGYAKARTA",2,204,20,224
https://kawalpemilu.org#42300,"BANYUREJO, TEMPEL, SLEMAN, DAERAH ISTIMEWA YOGYAKARTA",3,99,67,166
https://kawalpemilu.org#42300,"BANYUREJO, TEMPEL, SLEMAN, DAERAH ISTIMEWA YOGYAKARTA",4,137,43,180
https://kawalpemilu.org#42300,"BANYUREJO, TEMPEL, SLEMAN, DAERAH ISTIMEWA YOGYAKARTA",5,114,51,165
https://kawalpemilu.org#42300,"BANYUREJO, TEMPEL, SLEMAN, DAERAH ISTIMEWA YOGYAKARTA",6,125,95,220
https://kawalpemilu.org#42300,"BANYUREJO, TEMPEL, SLEMAN, DAERAH ISTIMEWA YOGYAKARTA",7,170,56,226
https://kawalpemilu.org#42300,"BANYUREJO, TEMPEL, SLEMAN, DAERAH ISTIMEWA YOGYAKARTA",8,162,32,194
https://kawalpemilu.org#42300,"BANYUREJO, TEMPEL, SLEMAN, DAERAH ISTIMEWA YOGYAKARTA",9,154,66,220
https://kawalpemilu.org#42300,"BANYUREJO, TEMPEL, SLEMAN, DAERAH ISTIMEWA YOGYAKARTA",10,108,111,119
https://kawalpemilu.org#42300,"BANYUREJO, TEMPEL, SLEMAN, DAERAH ISTIMEWA YOGYAKARTA",12,127,54,181
https://kawalpemilu.org#42300,"BANYUREJO, TEMPEL, SLEMAN, DAERAH ISTIMEWA YOGYAKARTA",13,142,42,184
https://kawalpemilu.org#42300,"BANYUREJO, TEMPEL, SLEMAN, DAERAH ISTIMEWA YOGYAKARTA",14,172,64,236
https://kawalpemilu.org#42300,"BANYUREJO, TEMPEL, SLEMAN, DAERAH ISTIMEWA YOGYAKARTA",15,109,30,139
https://kawalpemilu.org#42300,"BANYUREJO, TEMPEL, SLEMAN, DAERAH ISTIMEWA YOGYAKARTA",16,159,60,219
https://kawalpemilu.org#42300,"BANYUREJO, TEMPEL, SLEMAN, DAERAH ISTIMEWA YOGYAKARTA",17,114,72,186
https://kawalpemilu.org#42300,"BANYUREJO, TEMPEL, SLEMAN, DAERAH ISTIMEWA YOGYAKARTA",18,107,112,119
https://kawalpemilu.org#42300,"BANYUREJO, TEMPEL, SLEMAN, DAERAH ISTIMEWA YOGYAKARTA",19,118,132,250
https://kawalpemilu.org#42300,"BANYUREJO, TEMPEL, SLEMAN, DAERAH ISTIMEWA YOGYAKARTA",20,72,68,140
https://kawalpemilu.org#42300,"BANYUREJO, TEMPEL, SLEMAN, DAERAH ISTIMEWA YOGYAKARTA",21,43,66,109
https://kawalpemilu.org#42300,"BANYUREJO, TEMPEL, SLEMAN, DAERAH ISTIMEWA YOGYAKARTA",22,91,118,209
https://kawalpemilu.org#42300,"BANYUREJO, TEMPEL, SLEMAN, DAERAH ISTIMEWA YOGYAKARTA",23,102,120,222
https://kawalpemilu.org#42300,"BANYUREJO, TEMPEL, SLEMAN, DAERAH ISTIMEWA YOGYAKARTA",24,144,27,171
https://kawalpemilu.org#42300,"BANYUREJO, TEMPEL, SLEMAN, DAERAH ISTIMEWA YOGYAKARTA",26,99,24,123
https://kawalpemilu.org#42301,"TAMBAKREJO, TEMPEL, SLEMAN, DAERAH ISTIMEWA YOGYAKARTA",1,130,91,221
https://kawalpemilu.org#42301,"TAMBAKREJO, TEMPEL, SLEMAN, DAERAH ISTIMEWA YOGYAKARTA",2,112,136,248
https://kawalpemilu.org#42301,"TAMBAKREJO, TEMPEL, SLEMAN, DAERAH ISTIMEWA YOGYAKARTA",3,120,124,244
https://kawalpemilu.org#42301,"TAMBAKREJO, TEMPEL, SLEMAN, DAERAH ISTIMEWA YOGYAKARTA",4,101,73,174
https://kawalpemilu.org#42301,"TAMBAKREJO, TEMPEL, SLEMAN, DAERAH ISTIMEWA YOGYAKARTA",5,97,69,166
https://kawalpemilu.org#42301,"TAMBAKREJO, TEMPEL, SLEMAN, DAERAH ISTIMEWA YOGYAKARTA",6,153,47,200
https://kawalpemilu.org#42301,"TAMBAKREJO, TEMPEL, SLEMAN, DAERAH ISTIMEWA YOGYAKARTA",7,168,71,239
https://kawalpemilu.org#42301,"TAMBAKREJO, TEMPEL, SLEMAN, DAERAH ISTIMEWA YOGYAKARTA",8,142,84,226
https://kawalpemilu.org#42301,"TAMBAKREJO, TEMPEL, SLEMAN, DAERAH ISTIMEWA YOGYAKARTA",9,145,95,240
https://kawalpemilu.org#42301,"TAMBAKREJO, TEMPEL, SLEMAN, DAERAH ISTIMEWA YOGYAKARTA",10,148,96,244
https://kawalpemilu.org#42301,"TAMBAKREJO, TEMPEL, SLEMAN, DAERAH ISTIMEWA YOGYAKARTA",11,202,44,246
https://kawalpemilu.org#42301,"TAMBAKREJO, TEMPEL, SLEMAN, DAERAH ISTIMEWA YOGYAKARTA",12,122,119,241
https://kawalpemilu.org#42301,"TAMBAKREJO, TEMPEL, SLEMAN, DAERAH ISTIMEWA YOGYAKARTA",13,149,78,227
https://kawalpemilu.org#42301,"TAMBAKREJO, TEMPEL, SLEMAN, DAERAH ISTIMEWA YOGYAKARTA",14,131,87,218
https://kawalpemilu.org#42301,"TAMBAKREJO, TEMPEL, SLEMAN, DAERAH ISTIMEWA YOGYAKARTA",15,166,62,228
https://kawalpemilu.org#42301,"TAMBAKREJO, TEMPEL, SLEMAN, DAERAH ISTIMEWA YOGYAKARTA",16,121,91,212
https://kawalpemilu.org#42302,"SUMBERREJO, TEMPEL, SLEMAN, DAERAH ISTIMEWA YOGYAKARTA",1,154,111,265
https://kawalpemilu.org#42302,"SUMBERREJO, TEMPEL, SLEMAN, DAERAH ISTIMEWA YOGYAKARTA",2,148,64,212
https://kawalpemilu.org#42302,"SUMBERREJO, TEMPEL, SLEMAN, DAERAH ISTIMEWA YOGYAKARTA",3,111,95,206
https://kawalpemilu.org#42302,"SUMBERREJO, TEMPEL, SLEMAN, DAERAH ISTIMEWA YOGYAKARTA",4,127,143,270
https://kawalpemilu.org#42302,"SUMBERREJO, TEMPEL, SLEMAN, DAERAH ISTIMEWA YOGYAKARTA",5,102,142,244
https://kawalpemilu.org#42302,"SUMBERREJO, TEMPEL, SLEMAN, DAERAH ISTIMEWA YOGYAKARTA",6,119,85,204
https://kawalpemilu.org#42302,"SUMBERREJO, TEMPEL, SLEMAN, DAERAH ISTIMEWA YOGYAKARTA",7,134,35,169
https://kawalpemilu.org#42302,"SUMBERREJO, TEMPEL, SLEMAN, DAERAH ISTIMEWA YOGYAKARTA",8,158,90,248
https://kawalpemilu.org#42302,"SUMBERREJO, TEMPEL, SLEMAN, DAERAH ISTIMEWA YOGYAKARTA",9,190,56,246
https://kawalpemilu.org#42302,"SUMBERREJO, TEMPEL, SLEMAN, DAERAH ISTIMEWA YOGYAKARTA",10,135,112,247
https://kawalpemilu.org#42302,"SUMBERREJO, TEMPEL, SLEMAN, DAERAH ISTIMEWA YOGYAKARTA",11,176,83,259
https://kawalpemilu.org#42302,"SUMBERREJO, TEMPEL, SLEMAN, DAERAH ISTIMEWA YOGYAKARTA",12,189,72,261
https://kawalpemilu.org#42302,"SUMBERREJO, TEMPEL, SLEMAN, DAERAH ISTIMEWA YOGYAKARTA",13,147,95,242
https://kawalpemilu.org#42302,"SUMBERREJO, TEMPEL, SLEMAN, DAERAH ISTIMEWA YOGYAKARTA",14,76,38,114
https://kawalpemilu.org#42303,"PONDOKREJO, TEMPEL, SLEMAN, DAERAH ISTIMEWA YOGYAKARTA",1,122,104,226
https://kawalpemilu.org#42303,"PONDOKREJO, TEMPEL, SLEMAN, DAERAH ISTIMEWA YOGYAKARTA",2,156,89,245
https://kawalpemilu.org#42303,"PONDOKREJO, TEMPEL, SLEMAN, DAERAH ISTIMEWA YOGYAKARTA",3,62,109,171
https://kawalpemilu.org#42303,"PONDOKREJO, TEMPEL, SLEMAN, DAERAH ISTIMEWA YOGYAKARTA",4,82,53,135
https://kawalpemilu.org#42303,"PONDOKREJO, TEMPEL, SLEMAN, DAERAH ISTIMEWA YOGYAKARTA",5,136,69,205
https://kawalpemilu.org#42303,"PONDOKREJO, TEMPEL, SLEMAN, DAERAH ISTIMEWA YOGYAKARTA",6,123,51,174
https://kawalpemilu.org#42303,"PONDOKREJO, TEMPEL, SLEMAN, DAERAH ISTIMEWA YOGYAKARTA",7,135,30,165
https://kawalpemilu.org#42303,"PONDOKREJO, TEMPEL, SLEMAN, DAERAH ISTIMEWA YOGYAKARTA",8,148,94,242
https://kawalpemilu.org#42303,"PONDOKREJO, TEMPEL, SLEMAN, DAERAH ISTIMEWA YOGYAKARTA",9,135,47,182
https://kawalpemilu.org#42303,"PONDOKREJO, TEMPEL, SLEMAN, DAERAH ISTIMEWA YOGYAKARTA",10,113,71,184
https://kawalpemilu.org#42303,"PONDOKREJO, TEMPEL, SLEMAN, DAERAH ISTIMEWA YOGYAKARTA",11,136,42,178
https://kawalpemilu.org#42303,"PONDOKREJO, TEMPEL, SLEMAN, DAERAH ISTIMEWA YOGYAKARTA",12,139,79,218
https://kawalpemilu.org#42303,"PONDOKREJO, TEMPEL, SLEMAN, DAERAH ISTIMEWA YOGYAKARTA",13,119,25,144
https://kawalpemilu.org#42303,"PONDOKREJO, TEMPEL, SLEMAN, DAERAH ISTIMEWA YOGYAKARTA",14,93,36,129
https://kawalpemilu.org#42303,"PONDOKREJO, TEMPEL, SLEMAN, DAERAH ISTIMEWA YOGYAKARTA",15,172,48,220
https://kawalpemilu.org#42303,"PONDOKREJO, TEMPEL, SLEMAN, DAERAH ISTIMEWA YOGYAKARTA",16,143,83,226
https://kawalpemilu.org#42303,"PONDOKREJO, TEMPEL, SLEMAN, DAERAH ISTIMEWA YOGYAKARTA",17,140,111,251
https://kawalpemilu.org#42303,"PONDOKREJO, TEMPEL, SLEMAN, DAERAH ISTIMEWA YOGYAKARTA",18,168,72,240
https://kawalpemilu.org#42303,"PONDOKREJO, TEMPEL, SLEMAN, DAERAH ISTIMEWA YOGYAKARTA",19,153,84,237
https://kawalpemilu.org#42303,"PONDOKREJO, TEMPEL, SLEMAN, DAERAH ISTIMEWA YOGYAKARTA",20,144,76,220
https://kawalpemilu.org#42303,"PONDOKREJO, TEMPEL, SLEMAN, DAERAH ISTIMEWA YOGYAKARTA",21,125,48,173
https://kawalpemilu.org#42304,"MOROREJO, TEMPEL, SLEMAN, DAERAH ISTIMEWA YOGYAKARTA",1,195,53,248
https://kawalpemilu.org#42304,"MOROREJO, TEMPEL, SLEMAN, DAERAH ISTIMEWA YOGYAKARTA",2,113,123,236
https://kawalpemilu.org#42304,"MOROREJO, TEMPEL, SLEMAN, DAERAH ISTIMEWA YOGYAKARTA",3,102,54,156
https://kawalpemilu.org#42304,"MOROREJO, TEMPEL, SLEMAN, DAERAH ISTIMEWA YOGYAKARTA",4,50,71,121
https://kawalpemilu.org#42304,"MOROREJO, TEMPEL, SLEMAN, DAERAH ISTIMEWA YOGYAKARTA",5,82,121,203
https://kawalpemilu.org#42304,"MOROREJO, TEMPEL, SLEMAN, DAERAH ISTIMEWA YOGYAKARTA",6,96,140,236
https://kawalpemilu.org#42304,"MOROREJO, TEMPEL, SLEMAN, DAERAH ISTIMEWA YOGYAKARTA",7,148,78,226
https://kawalpemilu.org#42304,"MOROREJO, TEMPEL, SLEMAN, DAERAH ISTIMEWA YOGYAKARTA",8,127,99,226
https://kawalpemilu.org#42304,"MOROREJO, TEMPEL, SLEMAN, DAERAH ISTIMEWA YOGYAKARTA",9,114,117,231
https://kawalpemilu.org#42304,"MOROREJO, TEMPEL, SLEMAN, DAERAH ISTIMEWA YOGYAKARTA",10,125,122,247
https://kawalpemilu.org#42304,"MOROREJO, TEMPEL, SLEMAN, DAERAH ISTIMEWA YOGYAKARTA",11,118,73,191
https://kawalpemilu.org#42304,"MOROREJO, TEMPEL, SLEMAN, DAERAH ISTIMEWA YOGYAKARTA",12,159,26,185
https://kawalpemilu.org#42304,"MOROREJO, TEMPEL, SLEMAN, DAERAH ISTIMEWA YOGYAKARTA",13,113,91,204
https://kawalpemilu.org#42304,"MOROREJO, TEMPEL, SLEMAN, DAERAH ISTIMEWA YOGYAKARTA",14,195,57,252
https://kawalpemilu.org#42304,"MOROREJO, TEMPEL, SLEMAN, DAERAH ISTIMEWA YOGYAKARTA",15,109,45,154
https://kawalpemilu.org#42304,"MOROREJO, TEMPEL, SLEMAN, DAERAH ISTIMEWA YOGYAKARTA",16,127,104,231
https://kawalpemilu.org#42304,"MOROREJO, TEMPEL, SLEMAN, DAERAH ISTIMEWA YOGYAKARTA",17,117,94,211
https://kawalpemilu.org#42305,"MARGOREJO, TEMPEL, SLEMAN, DAERAH ISTIMEWA YOGYAKARTA",1,115,45,160
https://kawalpemilu.org#42305,"MARGOREJO, TEMPEL, SLEMAN, DAERAH ISTIMEWA YOGYAKARTA",3,127,82,209
https://kawalpemilu.org#42305,"MARGOREJO, TEMPEL, SLEMAN, DAERAH ISTIMEWA YOGYAKARTA",4,87,67,154
https://kawalpemilu.org#42305,"MARGOREJO, TEMPEL, SLEMAN, DAERAH ISTIMEWA YOGYAKARTA",5,97,51,148
https://kawalpemilu.org#42305,"MARGOREJO, TEMPEL, SLEMAN, DAERAH ISTIMEWA YOGYAKARTA",6,120,50,170
https://kawalpemilu.org#42305,"MARGOREJO, TEMPEL, SLEMAN, DAERAH ISTIMEWA YOGYAKARTA",7,80,58,138
https://kawalpemilu.org#42305,"MARGOREJO, TEMPEL, SLEMAN, DAERAH ISTIMEWA YOGYAKARTA",8,154,36,190
https://kawalpemilu.org#42305,"MARGOREJO, TEMPEL, SLEMAN, DAERAH ISTIMEWA YOGYAKARTA",9,101,36,137
https://kawalpemilu.org#42305,"MARGOREJO, TEMPEL, SLEMAN, DAERAH ISTIMEWA YOGYAKARTA",10,150,41,191
https://kawalpemilu.org#42305,"MARGOREJO, TEMPEL, SLEMAN, DAERAH ISTIMEWA YOGYAKARTA",11,155,82,237
https://kawalpemilu.org#42305,"MARGOREJO, TEMPEL, SLEMAN, DAERAH ISTIMEWA YOGYAKARTA",12,147,74,221
https://kawalpemilu.org#42305,"MARGOREJO, TEMPEL, SLEMAN, DAERAH ISTIMEWA YOGYAKARTA",13,152,85,237
https://kawalpemilu.org#42305,"MARGOREJO, TEMPEL, SLEMAN, DAERAH ISTIMEWA YOGYAKARTA",14,105,72,177
https://kawalpemilu.org#42305,"MARGOREJO, TEMPEL, SLEMAN, DAERAH ISTIMEWA YOGYAKARTA",15,169,75,244
https://kawalpemilu.org#42305,"MARGOREJO, TEMPEL, SLEMAN, DAERAH ISTIMEWA YOGYAKARTA",16,146,92,238
https://kawalpemilu.org#42305,"MARGOREJO, TEMPEL, SLEMAN, DAERAH ISTIMEWA YOGYAKARTA",17,97,56,153
https://kawalpemilu.org#42305,"MARGOREJO, TEMPEL, SLEMAN, DAERAH ISTIMEWA YOGYAKARTA",18,121,45,166
https://kawalpemilu.org#42305,"MARGOREJO, TEMPEL, SLEMAN, DAERAH ISTIMEWA YOGYAKARTA",19,117,52,169
https://kawalpemilu.org#42305,"MARGOREJO, TEMPEL, SLEMAN, DAERAH ISTIMEWA YOGYAKARTA",20,160,47,207
https://kawalpemilu.org#42305,"MARGOREJO, TEMPEL, SLEMAN, DAERAH ISTIMEWA YOGYAKARTA",21,127,56,183
https://kawalpemilu.org#42305,"MARGOREJO, TEMPEL, SLEMAN, DAERAH ISTIMEWA YOGYAKARTA",22,138,63,201
https://kawalpemilu.org#42305,"MARGOREJO, TEMPEL, SLEMAN, DAERAH ISTIMEWA YOGYAKARTA",23,126,50,176
https://kawalpemilu.org#42305,"MARGOREJO, TEMPEL, SLEMAN, DAERAH ISTIMEWA YOGYAKARTA",24,99,70,169
https://kawalpemilu.org#42305,"MARGOREJO, TEMPEL, SLEMAN, DAERAH ISTIMEWA YOGYAKARTA",25,141,50,191
https://kawalpemilu.org#42305,"MARGOREJO, TEMPEL, SLEMAN, DAERAH ISTIMEWA YOGYAKARTA",26,86,44,130
https://kawalpemilu.org#42305,"MARGOREJO, TEMPEL, SLEMAN, DAERAH ISTIMEWA YOGYAKARTA",27,96,59,155
https://kawalpemilu.org#42305,"MARGOREJO, TEMPEL, SLEMAN, DAERAH ISTIMEWA YOGYAKARTA",28,158,68,226
https://kawalpemilu.org#42305,"MARGOREJO, TEMPEL, SLEMAN, DAERAH ISTIMEWA YOGYAKARTA",29,85,176,261
https://kawalpemilu.org#42305,"MARGOREJO, TEMPEL, SLEMAN, DAERAH ISTIMEWA YOGYAKARTA",30,72,193,265
https://kawalpemilu.org#42305,"MARGOREJO, TEMPEL, SLEMAN, DAERAH ISTIMEWA YOGYAKARTA",31,119,71,190
https://kawalpemilu.org#42305,"MARGOREJO, TEMPEL, SLEMAN, DAERAH ISTIMEWA YOGYAKARTA",32,120,102,222
https://kawalpemilu.org#42305,"MARGOREJO, TEMPEL, SLEMAN, DAERAH ISTIMEWA YOGYAKARTA",33,121,72,193
https://kawalpemilu.org#42305,"MARGOREJO, TEMPEL, SLEMAN, DAERAH ISTIMEWA YOGYAKARTA",34,152,86,238
https://kawalpemilu.org#42305,"MARGOREJO, TEMPEL, SLEMAN, DAERAH ISTIMEWA YOGYAKARTA",35,85,114,119
https://kawalpemilu.org#42305,"MARGOREJO, TEMPEL, SLEMAN, DAERAH ISTIMEWA YOGYAKARTA",36,84,88,172
https://kawalpemilu.org#42305,"MARGOREJO, TEMPEL, SLEMAN, DAERAH ISTIMEWA YOGYAKARTA",37,73,88,161
https://kawalpemilu.org#42306,"LUMBUNGREJO, TEMPEL, SLEMAN, DAERAH ISTIMEWA YOGYAKARTA",1,193,43,235
https://kawalpemilu.org#42306,"LUMBUNGREJO, TEMPEL, SLEMAN, DAERAH ISTIMEWA YOGYAKARTA",2,180,47,227
https://kawalpemilu.org#42306,"LUMBUNGREJO, TEMPEL, SLEMAN, DAERAH ISTIMEWA YOGYAKARTA",3,141,77,218
https://kawalpemilu.org#42306,"LUMBUNGREJO, TEMPEL, SLEMAN, DAERAH ISTIMEWA YOGYAKARTA",4,149,82,231
https://kawalpemilu.org#42306,"LUMBUNGREJO, TEMPEL, SLEMAN, DAERAH ISTIMEWA YOGYAKARTA",5,147,50,197
https://kawalpemilu.org#42306,"LUMBUNGREJO, TEMPEL, SLEMAN, DAERAH ISTIMEWA YOGYAKARTA",6,132,44,176
https://kawalpemilu.org#42306,"LUMBUNGREJO, TEMPEL, SLEMAN, DAERAH ISTIMEWA YOGYAKARTA",7,170,48,218
https://kawalpemilu.org#42306,"LUMBUNGREJO, TEMPEL, SLEMAN, DAERAH ISTIMEWA YOGYAKARTA",8,201,26,227
https://kawalpemilu.org#42306,"LUMBUNGREJO, TEMPEL, SLEMAN, DAERAH ISTIMEWA YOGYAKARTA",9,130,61,191
https://kawalpemilu.org#42306,"LUMBUNGREJO, TEMPEL, SLEMAN, DAERAH ISTIMEWA YOGYAKARTA",10,141,45,186
https://kawalpemilu.org#42306,"LUMBUNGREJO, TEMPEL, SLEMAN, DAERAH ISTIMEWA YOGYAKARTA",11,138,52,190
https://kawalpemilu.org#42306,"LUMBUNGREJO, TEMPEL, SLEMAN, DAERAH ISTIMEWA YOGYAKARTA",12,144,35,179
https://kawalpemilu.org#42306,"LUMBUNGREJO, TEMPEL, SLEMAN, DAERAH ISTIMEWA YOGYAKARTA",13,136,44,180
https://kawalpemilu.org#42306,"LUMBUNGREJO, TEMPEL, SLEMAN, DAERAH ISTIMEWA YOGYAKARTA",14,126,56,182
https://kawalpemilu.org#42306,"LUMBUNGREJO, TEMPEL, SLEMAN, DAERAH ISTIMEWA YOGYAKARTA",15,133,38,171
https://kawalpemilu.org#42306,"LUMBUNGREJO, TEMPEL, SLEMAN, DAERAH ISTIMEWA YOGYAKARTA",16,62,94,156
https://kawalpemilu.org#42306,"LUMBUNGREJO, TEMPEL, SLEMAN, DAERAH ISTIMEWA YOGYAKARTA",17,52,101,153
https://kawalpemilu.org#42306,"LUMBUNGREJO, TEMPEL, SLEMAN, DAERAH ISTIMEWA YOGYAKARTA",18,67,138,205
https://kawalpemilu.org#42306,"LUMBUNGREJO, TEMPEL, SLEMAN, DAERAH ISTIMEWA YOGYAKARTA",19,143,47,190
https://kawalpemilu.org#42306,"LUMBUNGREJO, TEMPEL, SLEMAN, DAERAH ISTIMEWA YOGYAKARTA",20,160,34,194
https://kawalpemilu.org#42306,"LUMBUNGREJO, TEMPEL, SLEMAN, DAERAH ISTIMEWA YOGYAKARTA",21,142,69,211
https://kawalpemilu.org#42306,"LUMBUNGREJO, TEMPEL, SLEMAN, DAERAH ISTIMEWA YOGYAKARTA",22,144,79,223
https://kawalpemilu.org#42306,"LUMBUNGREJO, TEMPEL, SLEMAN, DAERAH ISTIMEWA YOGYAKARTA",23,150,78,228
https://kawalpemilu.org#42306,"LUMBUNGREJO, TEMPEL, SLEMAN, DAERAH ISTIMEWA YOGYAKARTA",24,144,84,228
https://kawalpemilu.org#42306,"LUMBUNGREJO, TEMPEL, SLEMAN, DAERAH ISTIMEWA YOGYAKARTA",25,143,89,232
https://kawalpemilu.org#42307,"MERDIKOREJO, TEMPEL, SLEMAN, DAERAH ISTIMEWA YOGYAKARTA",1,142,82,224
https://kawalpemilu.org#42307,"MERDIKOREJO, TEMPEL, SLEMAN, DAERAH ISTIMEWA YOGYAKARTA",2,79,51,130
https://kawalpemilu.org#42307,"MERDIKOREJO, TEMPEL, SLEMAN, DAERAH ISTIMEWA YOGYAKARTA",3,122,51,173
https://kawalpemilu.org#42307,"MERDIKOREJO, TEMPEL, SLEMAN, DAERAH ISTIMEWA YOGYAKARTA",4,168,83,251
https://kawalpemilu.org#42307,"MERDIKOREJO, TEMPEL, SLEMAN, DAERAH ISTIMEWA YOGYAKARTA",5,84,123,207
https://kawalpemilu.org#42307,"MERDIKOREJO, TEMPEL, SLEMAN, DAERAH ISTIMEWA YOGYAKARTA",6,159,61,220
https://kawalpemilu.org#42307,"MERDIKOREJO, TEMPEL, SLEMAN, DAERAH ISTIMEWA YOGYAKARTA",7,184,60,244
https://kawalpemilu.org#42307,"MERDIKOREJO, TEMPEL, SLEMAN, DAERAH ISTIMEWA YOGYAKARTA",8,59,55,114
https://kawalpemilu.org#42307,"MERDIKOREJO, TEMPEL, SLEMAN, DAERAH ISTIMEWA YOGYAKARTA",9,139,106,245
https://kawalpemilu.org#42307,"MERDIKOREJO, TEMPEL, SLEMAN, DAERAH ISTIMEWA YOGYAKARTA",10,133,27,160
https://kawalpemilu.org#42307,"MERDIKOREJO, TEMPEL, SLEMAN, DAERAH ISTIMEWA YOGYAKARTA",11,99,64,163
https://kawalpemilu.org#42307,"MERDIKOREJO, TEMPEL, SLEMAN, DAERAH ISTIMEWA YOGYAKARTA",12,154,80,234
https://kawalpemilu.org#42307,"MERDIKOREJO, TEMPEL, SLEMAN, DAERAH ISTIMEWA YOGYAKARTA",13,135,72,207
https://kawalpemilu.org#42307,"MERDIKOREJO, TEMPEL, SLEMAN, DAERAH ISTIMEWA YOGYAKARTA",14,95,77,172
https://kawalpemilu.org#42307,"MERDIKOREJO, TEMPEL, SLEMAN, DAERAH ISTIMEWA YOGYAKARTA",15,110,21,131
https://kawalpemilu.org#42307,"MERDIKOREJO, TEMPEL, SLEMAN, DAERAH ISTIMEWA YOGYAKARTA",16,115,133,248
https://kawalpemilu.org#42307,"MERDIKOREJO, TEMPEL, SLEMAN, DAERAH ISTIMEWA YOGYAKARTA",17,138,67,205
https://kawalpemilu.org#42307,"MERDIKOREJO, TEMPEL, SLEMAN, DAERAH ISTIMEWA YOGYAKARTA",19,135,103,238
https://kawalpemilu.org#42307,"MERDIKOREJO, TEMPEL, SLEMAN, DAERAH ISTIMEWA YOGYAKARTA",20,124,60,184
https://kawalpemilu.org#42307,"MERDIKOREJO, TEMPEL, SLEMAN, DAERAH ISTIMEWA YOGYAKARTA",21,118,79,197
https://kawalpemilu.org#42307,"MERDIKOREJO, TEMPEL, SLEMAN, DAERAH ISTIMEWA YOGYAKARTA",22,149,54,203
https://kawalpemilu.org#42307,"MERDIKOREJO, TEMPEL, SLEMAN, DAERAH ISTIMEWA YOGYAKARTA",23,124,40,164
https://kawalpemilu.org#42309,"BANGUNKERTO, TURI, SLEMAN, DAERAH ISTIMEWA YOGYAKARTA",1,127,66,193
https://kawalpemilu.org#42309,"BANGUNKERTO, TURI, SLEMAN, DAERAH ISTIMEWA YOGYAKARTA",2,122,23,145
https://kawalpemilu.org#42309,"BANGUNKERTO, TURI, SLEMAN, DAERAH ISTIMEWA YOGYAKARTA",3,138,61,199
https://kawalpemilu.org#42309,"BANGUNKERTO, TURI, SLEMAN, DAERAH ISTIMEWA YOGYAKARTA",4,141,89,230
https://kawalpemilu.org#42309,"BANGUNKERTO, TURI, SLEMAN, DAERAH ISTIMEWA YOGYAKARTA",5,128,136,264
https://kawalpemilu.org#42309,"BANGUNKERTO, TURI, SLEMAN, DAERAH ISTIMEWA YOGYAKARTA",6,126,125,251
https://kawalpemilu.org#42309,"BANGUNKERTO, TURI, SLEMAN, DAERAH ISTIMEWA YOGYAKARTA",7,147,106,253
https://kawalpemilu.org#42309,"BANGUNKERTO, TURI, SLEMAN, DAERAH ISTIMEWA YOGYAKARTA",8,188,72,260
https://kawalpemilu.org#42309,"BANGUNKERTO, TURI, SLEMAN, DAERAH ISTIMEWA YOGYAKARTA",9,99,114,213
https://kawalpemilu.org#42309,"BANGUNKERTO, TURI, SLEMAN, DAERAH ISTIMEWA YOGYAKARTA",10,186,44,230
https://kawalpemilu.org#42309,"BANGUNKERTO, TURI, SLEMAN, DAERAH ISTIMEWA YOGYAKARTA",11,178,49,227
https://kawalpemilu.org#42309,"BANGUNKERTO, TURI, SLEMAN, DAERAH ISTIMEWA YOGYAKARTA",12,102,78,180
https://kawalpemilu.org#42309,"BANGUNKERTO, TURI, SLEMAN, DAERAH ISTIMEWA YOGYAKARTA",13,138,126,264
https://kawalpemilu.org#42309,"BANGUNKERTO, TURI, SLEMAN, DAERAH ISTIMEWA YOGYAKARTA",14,177,83,260
https://kawalpemilu.org#42309,"BANGUNKERTO, TURI, SLEMAN, DAERAH ISTIMEWA YOGYAKARTA",15,144,113,257
https://kawalpemilu.org#42309,"BANGUNKERTO, TURI, SLEMAN, DAERAH ISTIMEWA YOGYAKARTA",16,119,71,190
https://kawalpemilu.org#42309,"BANGUNKERTO, TURI, SLEMAN, DAERAH ISTIMEWA YOGYAKARTA",17,118,114,232
https://kawalpemilu.org#42309,"BANGUNKERTO, TURI, SLEMAN, DAERAH ISTIMEWA YOGYAKARTA",18,148,92,240
https://kawalpemilu.org#42309,"BANGUNKERTO, TURI, SLEMAN, DAERAH ISTIMEWA YOGYAKARTA",19,156,78,234
https://kawalpemilu.org#42309,"BANGUNKERTO, TURI, SLEMAN, DAERAH ISTIMEWA YOGYAKARTA",20,131,130,261
https://kawalpemilu.org#42309,"BANGUNKERTO, TURI, SLEMAN, DAERAH ISTIMEWA YOGYAKARTA",21,127,108,235
https://kawalpemilu.org#42309,"BANGUNKERTO, TURI, SLEMAN, DAERAH ISTIMEWA YOGYAKARTA",22,122,141,263
https://kawalpemilu.org#42309,"BANGUNKERTO, TURI, SLEMAN, DAERAH ISTIMEWA YOGYAKARTA",23,134,115,249
https://kawalpemilu.org#42309,"BANGUNKERTO, TURI, SLEMAN, DAERAH ISTIMEWA YOGYAKARTA",24,142,89,231
https://kawalpemilu.org#42309,"BANGUNKERTO, TURI, SLEMAN, DAERAH ISTIMEWA YOGYAKARTA",25,170,59,229
https://kawalpemilu.org#42309,"BANGUNKERTO, TURI, SLEMAN, DAERAH ISTIMEWA YOGYAKARTA",26,164,55,219
https://kawalpemilu.org#42309,"BANGUNKERTO, TURI, SLEMAN, DAERAH ISTIMEWA YOGYAKARTA",27,154,79,233
https://kawalpemilu.org#42310,"DONOKERTO, TURI, SLEMAN, DAERAH ISTIMEWA YOGYAKARTA",1,161,72,233
https://kawalpemilu.org#42310,"DONOKERTO, TURI, SLEMAN, DAERAH ISTIMEWA YOGYAKARTA",2,114,26,140
https://kawalpemilu.org#42310,"DONOKERTO, TURI, SLEMAN, DAERAH ISTIMEWA YOGYAKARTA",3,135,93,228
https://kawalpemilu.org#42310,"DONOKERTO, TURI, SLEMAN, DAERAH ISTIMEWA YOGYAKARTA",4,150,30,180
https://kawalpemilu.org#42310,"DONOKERTO, TURI, SLEMAN, DAERAH ISTIMEWA YOGYAKARTA",5,92,87,179
https://kawalpemilu.org#42310,"DONOKERTO, TURI, SLEMAN, DAERAH ISTIMEWA YOGYAKARTA",6,67,149,216
https://kawalpemilu.org#42310,"DONOKERTO, TURI, SLEMAN, DAERAH ISTIMEWA YOGYAKARTA",7,158,105,263
https://kawalpemilu.org#42310,"DONOKERTO, TURI, SLEMAN, DAERAH ISTIMEWA YOGYAKARTA",8,122,71,193
https://kawalpemilu.org#42310,"DONOKERTO, TURI, SLEMAN, DAERAH ISTIMEWA YOGYAKARTA",9,76,129,205
https://kawalpemilu.org#42310,"DONOKERTO, TURI, SLEMAN, DAERAH ISTIMEWA YOGYAKARTA",10,121,54,175
https://kawalpemilu.org#42310,"DONOKERTO, TURI, SLEMAN, DAERAH ISTIMEWA YOGYAKARTA",11,103,141,244
https://kawalpemilu.org#42310,"DONOKERTO, TURI, SLEMAN, DAERAH ISTIMEWA YOGYAKARTA",12,117,61,178
https://kawalpemilu.org#42310,"DONOKERTO, TURI, SLEMAN, DAERAH ISTIMEWA YOGYAKARTA",13,121,96,217
https://kawalpemilu.org#42310,"DONOKERTO, TURI, SLEMAN, DAERAH ISTIMEWA YOGYAKARTA",14,60,140,200
https://kawalpemilu.org#42310,"DONOKERTO, TURI, SLEMAN, DAERAH ISTIMEWA YOGYAKARTA",15,118,87,205
https://kawalpemilu.org#42310,"DONOKERTO, TURI, SLEMAN, DAERAH ISTIMEWA YOGYAKARTA",16,128,85,213
https://kawalpemilu.org#42310,"DONOKERTO, TURI, SLEMAN, DAERAH ISTIMEWA YOGYAKARTA",17,139,76,215
https://kawalpemilu.org#42310,"DONOKERTO, TURI, SLEMAN, DAERAH ISTIMEWA YOGYAKARTA",18,105,114,219
https://kawalpemilu.org#42310,"DONOKERTO, TURI, SLEMAN, DAERAH ISTIMEWA YOGYAKARTA",19,117,85,202
https://kawalpemilu.org#42310,"DONOKERTO, TURI, SLEMAN, DAERAH ISTIMEWA YOGYAKARTA",20,126,124,250
https://kawalpemilu.org#42310,"DONOKERTO, TURI, SLEMAN, DAERAH ISTIMEWA YOGYAKARTA",21,147,112,259
https://kawalpemilu.org#42310,"DONOKERTO, TURI, SLEMAN, DAERAH ISTIMEWA YOGYAKARTA",22,103,75,178
https://kawalpemilu.org#42310,"DONOKERTO, TURI, SLEMAN, DAERAH ISTIMEWA YOGYAKARTA",23,96,101,197
https://kawalpemilu.org#42310,"DONOKERTO, TURI, SLEMAN, DAERAH ISTIMEWA YOGYAKARTA",24,165,60,225
https://kawalpemilu.org#42310,"DONOKERTO, TURI, SLEMAN, DAERAH ISTIMEWA YOGYAKARTA",25,179,63,242
https://kawalpemilu.org#42310,"DONOKERTO, TURI, SLEMAN, DAERAH ISTIMEWA YOGYAKARTA",26,148,50,198
https://kawalpemilu.org#42310,"DONOKERTO, TURI, SLEMAN, DAERAH ISTIMEWA YOGYAKARTA",27,87,76,163
https://kawalpemilu.org#42310,"DONOKERTO, TURI, SLEMAN, DAERAH ISTIMEWA YOGYAKARTA",28,110,76,186
https://kawalpemilu.org#42310,"DONOKERTO, TURI, SLEMAN, DAERAH ISTIMEWA YOGYAKARTA",29,178,62,240
https://kawalpemilu.org#42310,"DONOKERTO, TURI, SLEMAN, DAERAH ISTIMEWA YOGYAKARTA",30,75,84,159
https://kawalpemilu.org#42311,"GIRIKERTO, TURI, SLEMAN, DAERAH ISTIMEWA YOGYAKARTA",1,150,26,176
https://kawalpemilu.org#42311,"GIRIKERTO, TURI, SLEMAN, DAERAH ISTIMEWA YOGYAKARTA",2,135,28,163
https://kawalpemilu.org#42311,"GIRIKERTO, TURI, SLEMAN, DAERAH ISTIMEWA YOGYAKARTA",3,156,47,203
https://kawalpemilu.org#42311,"GIRIKERTO, TURI, SLEMAN, DAERAH ISTIMEWA YOGYAKARTA",4,119,17,136
https://kawalpemilu.org#42311,"GIRIKERTO, TURI, SLEMAN, DAERAH ISTIMEWA YOGYAKARTA",5,145,82,227
https://kawalpemilu.org#42311,"GIRIKERTO, TURI, SLEMAN, DAERAH ISTIMEWA YOGYAKARTA",6,104,104,208
https://kawalpemilu.org#42311,"GIRIKERTO, TURI, SLEMAN, DAERAH ISTIMEWA YOGYAKARTA",7,119,50,169
https://kawalpemilu.org#42311,"GIRIKERTO, TURI, SLEMAN, DAERAH ISTIMEWA YOGYAKARTA",8,116,36,152
https://kawalpemilu.org#42311,"GIRIKERTO, TURI, SLEMAN, DAERAH ISTIMEWA YOGYAKARTA",9,112,97,209
https://kawalpemilu.org#42311,"GIRIKERTO, TURI, SLEMAN, DAERAH ISTIMEWA YOGYAKARTA",10,117,75,192
https://kawalpemilu.org#42311,"GIRIKERTO, TURI, SLEMAN, DAERAH ISTIMEWA YOGYAKARTA",11,135,87,222
https://kawalpemilu.org#42311,"GIRIKERTO, TURI, SLEMAN, DAERAH ISTIMEWA YOGYAKARTA",12,150,58,208
https://kawalpemilu.org#42311,"GIRIKERTO, TURI, SLEMAN, DAERAH ISTIMEWA YOGYAKARTA",13,120,95,215
https://kawalpemilu.org#42311,"GIRIKERTO, TURI, SLEMAN, DAERAH ISTIMEWA YOGYAKARTA",14,131,48,179
https://kawalpemilu.org#42311,"GIRIKERTO, TURI, SLEMAN, DAERAH ISTIMEWA YOGYAKARTA",15,127,49,176
https://kawalpemilu.org#42311,"GIRIKERTO, TURI, SLEMAN, DAERAH ISTIMEWA YOGYAKARTA",16,82,143,225
https://kawalpemilu.org#42311,"GIRIKERTO, TURI, SLEMAN, DAERAH ISTIMEWA YOGYAKARTA",18,84,56,140
https://kawalpemilu.org#42311,"GIRIKERTO, TURI, SLEMAN, DAERAH ISTIMEWA YOGYAKARTA",19,160,27,187
https://kawalpemilu.org#42311,"GIRIKERTO, TURI, SLEMAN, DAERAH ISTIMEWA YOGYAKARTA",20,156,37,193
https://kawalpemilu.org#42311,"GIRIKERTO, TURI, SLEMAN, DAERAH ISTIMEWA YOGYAKARTA",21,93,61,154
https://kawalpemilu.org#42311,"GIRIKERTO, TURI, SLEMAN, DAERAH ISTIMEWA YOGYAKARTA",22,144,118,262
https://kawalpemilu.org#42311,"GIRIKERTO, TURI, SLEMAN, DAERAH ISTIMEWA YOGYAKARTA",23,158,68,226
https://kawalpemilu.org#42311,"GIRIKERTO, TURI, SLEMAN, DAERAH ISTIMEWA YOGYAKARTA",24,101,100,201
https://kawalpemilu.org#42311,"GIRIKERTO, TURI, SLEMAN, DAERAH ISTIMEWA YOGYAKARTA",25,162,50,212
https://kawalpemilu.org#42311,"GIRIKERTO, TURI, SLEMAN, DAERAH ISTIMEWA YOGYAKARTA",26,152,23,175
https://kawalpemilu.org#42311,"GIRIKERTO, TURI, SLEMAN, DAERAH ISTIMEWA YOGYAKARTA",27,179,32,211
https://kawalpemilu.org#42311,"GIRIKERTO, TURI, SLEMAN, DAERAH ISTIMEWA YOGYAKARTA",28,124,73,197
https://kawalpemilu.org#42311,"GIRIKERTO, TURI, SLEMAN, DAERAH ISTIMEWA YOGYAKARTA",29,89,54,143
https://kawalpemilu.org#42312,"WONOKERTO, TURI, SLEMAN, DAERAH ISTIMEWA YOGYAKARTA",1,157,65,222
https://kawalpemilu.org#42312,"WONOKERTO, TURI, SLEMAN, DAERAH ISTIMEWA YOGYAKARTA",2,175,43,218
https://kawalpemilu.org#42312,"WONOKERTO, TURI, SLEMAN, DAERAH ISTIMEWA YOGYAKARTA",3,165,27,192
https://kawalpemilu.org#42312,"WONOKERTO, TURI, SLEMAN, DAERAH ISTIMEWA YOGYAKARTA",4,186,30,216
https://kawalpemilu.org#42312,"WONOKERTO, TURI, SLEMAN, DAERAH ISTIMEWA YOGYAKARTA",5,146,67,213
https://kawalpemilu.org#42312,"WONOKERTO, TURI, SLEMAN, DAERAH ISTIMEWA YOGYAKARTA",6,106,102,208
https://kawalpemilu.org#42312,"WONOKERTO, TURI, SLEMAN, DAERAH ISTIMEWA YOGYAKARTA",7,96,125,221
https://kawalpemilu.org#42312,"WONOKERTO, TURI, SLEMAN, DAERAH ISTIMEWA YOGYAKARTA",8,138,57,195
https://kawalpemilu.org#42312,"WONOKERTO, TURI, SLEMAN, DAERAH ISTIMEWA YOGYAKARTA",9,166,99,265
https://kawalpemilu.org#42312,"WONOKERTO, TURI, SLEMAN, DAERAH ISTIMEWA YOGYAKARTA",10,156,115,271
https://kawalpemilu.org#42312,"WONOKERTO, TURI, SLEMAN, DAERAH ISTIMEWA YOGYAKARTA",11,142,120,262
https://kawalpemilu.org#42312,"WONOKERTO, TURI, SLEMAN, DAERAH ISTIMEWA YOGYAKARTA",12,194,70,264
https://kawalpemilu.org#42312,"WONOKERTO, TURI, SLEMAN, DAERAH ISTIMEWA YOGYAKARTA",13,191,33,224
https://kawalpemilu.org#42312,"WONOKERTO, TURI, SLEMAN, DAERAH ISTIMEWA YOGYAKARTA",14,155,61,216
https://kawalpemilu.org#42312,"WONOKERTO, TURI, SLEMAN, DAERAH ISTIMEWA YOGYAKARTA",15,148,92,240
https://kawalpemilu.org#42312,"WONOKERTO, TURI, SLEMAN, DAERAH ISTIMEWA YOGYAKARTA",16,144,109,253
https://kawalpemilu.org#42312,"WONOKERTO, TURI, SLEMAN, DAERAH ISTIMEWA YOGYAKARTA",17,181,47,228
https://kawalpemilu.org#42312,"WONOKERTO, TURI, SLEMAN, DAERAH ISTIMEWA YOGYAKARTA",18,144,53,197
https://kawalpemilu.org#42312,"WONOKERTO, TURI, SLEMAN, DAERAH ISTIMEWA YOGYAKARTA",19,120,118,238
https://kawalpemilu.org#42312,"WONOKERTO, TURI, SLEMAN, DAERAH ISTIMEWA YOGYAKARTA",20,131,58,189
https://kawalpemilu.org#42312,"WONOKERTO, TURI, SLEMAN, DAERAH ISTIMEWA YOGYAKARTA",21,115,101,216
https://kawalpemilu.org#42312,"WONOKERTO, TURI, SLEMAN, DAERAH ISTIMEWA YOGYAKARTA",22,162,79,241
https://kawalpemilu.org#42312,"WONOKERTO, TURI, SLEMAN, DAERAH ISTIMEWA YOGYAKARTA",23,153,76,229
https://kawalpemilu.org#42312,"WONOKERTO, TURI, SLEMAN, DAERAH ISTIMEWA YOGYAKARTA",24,154,72,226
https://kawalpemilu.org#42312,"WONOKERTO, TURI, SLEMAN, DAERAH ISTIMEWA YOGYAKARTA",25,61,158,219
https://kawalpemilu.org#42312,"WONOKERTO, TURI, SLEMAN, DAERAH ISTIMEWA YOGYAKARTA",26,139,68,207
https://kawalpemilu.org#42312,"WONOKERTO, TURI, SLEMAN, DAERAH ISTIMEWA YOGYAKARTA",27,72,139,211
https://kawalpemilu.org#42312,"WONOKERTO, TURI, SLEMAN, DAERAH ISTIMEWA YOGYAKARTA",28,120,88,208
https://kawalpemilu.org#42312,"WONOKERTO, TURI, SLEMAN, DAERAH ISTIMEWA YOGYAKARTA",29,177,80,257
https://kawalpemilu.org#42312,"WONOKERTO, TURI, SLEMAN, DAERAH ISTIMEWA YOGYAKARTA",30,175,65,240
https://kawalpemilu.org#42312,"WONOKERTO, TURI, SLEMAN, DAERAH ISTIMEWA YOGYAKARTA",31,123,126,249
https://kawalpemilu.org#42314,"PURWOBINANGUN, PAKEM, SLEMAN, DAERAH ISTIMEWA YOGYAKARTA",1,137,36,173
https://kawalpemilu.org#42314,"PURWOBINANGUN, PAKEM, SLEMAN, DAERAH ISTIMEWA YOGYAKARTA",2,132,48,180
https://kawalpemilu.org#42314,"PURWOBINANGUN, PAKEM, SLEMAN, DAERAH ISTIMEWA YOGYAKARTA",3,160,73,233
https://kawalpemilu.org#42314,"PURWOBINANGUN, PAKEM, SLEMAN, DAERAH ISTIMEWA YOGYAKARTA",4,87,79,166
https://kawalpemilu.org#42314,"PURWOBINANGUN, PAKEM, SLEMAN, DAERAH ISTIMEWA YOGYAKARTA",5,141,106,247
https://kawalpemilu.org#42314,"PURWOBINANGUN, PAKEM, SLEMAN, DAERAH ISTIMEWA YOGYAKARTA",6,189,69,258
https://kawalpemilu.org#42314,"PURWOBINANGUN, PAKEM, SLEMAN, DAERAH ISTIMEWA YOGYAKARTA",7,107,91,198
https://kawalpemilu.org#42314,"PURWOBINANGUN, PAKEM, SLEMAN, DAERAH ISTIMEWA YOGYAKARTA",8,187,65,252
https://kawalpemilu.org#42314,"PURWOBINANGUN, PAKEM, SLEMAN, DAERAH ISTIMEWA YOGYAKARTA",9,224,30,254
https://kawalpemilu.org#42314,"PURWOBINANGUN, PAKEM, SLEMAN, DAERAH ISTIMEWA YOGYAKARTA",10,115,148,263
https://kawalpemilu.org#42314,"PURWOBINANGUN, PAKEM, SLEMAN, DAERAH ISTIMEWA YOGYAKARTA",11,209,52,261
https://kawalpemilu.org#42314,"PURWOBINANGUN, PAKEM, SLEMAN, DAERAH ISTIMEWA YOGYAKARTA",12,192,87,279
https://kawalpemilu.org#42314,"PURWOBINANGUN, PAKEM, SLEMAN, DAERAH ISTIMEWA YOGYAKARTA",13,146,123,269
https://kawalpemilu.org#42314,"PURWOBINANGUN, PAKEM, SLEMAN, DAERAH ISTIMEWA YOGYAKARTA",14,125,101,226
https://kawalpemilu.org#42314,"PURWOBINANGUN, PAKEM, SLEMAN, DAERAH ISTIMEWA YOGYAKARTA",15,90,98,188
https://kawalpemilu.org#42314,"PURWOBINANGUN, PAKEM, SLEMAN, DAERAH ISTIMEWA YOGYAKARTA",16,87,106,193
https://kawalpemilu.org#42314,"PURWOBINANGUN, PAKEM, SLEMAN, DAERAH ISTIMEWA YOGYAKARTA",17,101,77,178
https://kawalpemilu.org#42314,"PURWOBINANGUN, PAKEM, SLEMAN, DAERAH ISTIMEWA YOGYAKARTA",18,178,18,196
https://kawalpemilu.org#42314,"PURWOBINANGUN, PAKEM, SLEMAN, DAERAH ISTIMEWA YOGYAKARTA",20,217,39,256
https://kawalpemilu.org#42314,"PURWOBINANGUN, PAKEM, SLEMAN, DAERAH ISTIMEWA YOGYAKARTA",21,145,95,240
https://kawalpemilu.org#42314,"PURWOBINANGUN, PAKEM, SLEMAN, DAERAH ISTIMEWA YOGYAKARTA",22,167,39,206
https://kawalpemilu.org#42314,"PURWOBINANGUN, PAKEM, SLEMAN, DAERAH ISTIMEWA YOGYAKARTA",23,122,54,176
https://kawalpemilu.org#42314,"PURWOBINANGUN, PAKEM, SLEMAN, DAERAH ISTIMEWA YOGYAKARTA",24,80,79,159
https://kawalpemilu.org#42314,"PURWOBINANGUN, PAKEM, SLEMAN, DAERAH ISTIMEWA YOGYAKARTA",25,64,153,217
https://kawalpemilu.org#42314,"PURWOBINANGUN, PAKEM, SLEMAN, DAERAH ISTIMEWA YOGYAKARTA",26,158,46,204
https://kawalpemilu.org#42314,"PURWOBINANGUN, PAKEM, SLEMAN, DAERAH ISTIMEWA YOGYAKARTA",27,138,48,186
https://kawalpemilu.org#42314,"PURWOBINANGUN, PAKEM, SLEMAN, DAERAH ISTIMEWA YOGYAKARTA",28,130,53,183
https://kawalpemilu.org#42314,"PURWOBINANGUN, PAKEM, SLEMAN, DAERAH ISTIMEWA YOGYAKARTA",29,162,83,245
https://kawalpemilu.org#42314,"PURWOBINANGUN, PAKEM, SLEMAN, DAERAH ISTIMEWA YOGYAKARTA",30,114,62,176
https://kawalpemilu.org#42315,"CANDIBINANGUN, PAKEM, SLEMAN, DAERAH ISTIMEWA YOGYAKARTA",1,140,85,225
https://kawalpemilu.org#42315,"CANDIBINANGUN, PAKEM, SLEMAN, DAERAH ISTIMEWA YOGYAKARTA",2,173,85,258
https://kawalpemilu.org#42315,"CANDIBINANGUN, PAKEM, SLEMAN, DAERAH ISTIMEWA YOGYAKARTA",3,47,67,114
https://kawalpemilu.org#42315,"CANDIBINANGUN, PAKEM, SLEMAN, DAERAH ISTIMEWA YOGYAKARTA",4,110,75,185
https://kawalpemilu.org#42315,"CANDIBINANGUN, PAKEM, SLEMAN, DAERAH ISTIMEWA YOGYAKARTA",5,73,60,133
https://kawalpemilu.org#42315,"CANDIBINANGUN, PAKEM, SLEMAN, DAERAH ISTIMEWA YOGYAKARTA",6,139,59,198
https://kawalpemilu.org#42315,"CANDIBINANGUN, PAKEM, SLEMAN, DAERAH ISTIMEWA YOGYAKARTA",7,122,79,201
https://kawalpemilu.org#42315,"CANDIBINANGUN, PAKEM, SLEMAN, DAERAH ISTIMEWA YOGYAKARTA",8,143,74,217
https://kawalpemilu.org#42315,"CANDIBINANGUN, PAKEM, SLEMAN, DAERAH ISTIMEWA YOGYAKARTA",9,131,36,167
https://kawalpemilu.org#42315,"CANDIBINANGUN, PAKEM, SLEMAN, DAERAH ISTIMEWA YOGYAKARTA",10,189,64,253
https://kawalpemilu.org#42315,"CANDIBINANGUN, PAKEM, SLEMAN, DAERAH ISTIMEWA YOGYAKARTA",11,157,85,242
https://kawalpemilu.org#42315,"CANDIBINANGUN, PAKEM, SLEMAN, DAERAH ISTIMEWA YOGYAKARTA",12,171,54,225
https://kawalpemilu.org#42315,"CANDIBINANGUN, PAKEM, SLEMAN, DAERAH ISTIMEWA YOGYAKARTA",13,165,53,218
https://kawalpemilu.org#42315,"CANDIBINANGUN, PAKEM, SLEMAN, DAERAH ISTIMEWA YOGYAKARTA",14,94,22,116
https://kawalpemilu.org#42315,"CANDIBINANGUN, PAKEM, SLEMAN, DAERAH ISTIMEWA YOGYAKARTA",15,124,59,183
https://kawalpemilu.org#42315,"CANDIBINANGUN, PAKEM, SLEMAN, DAERAH ISTIMEWA YOGYAKARTA",16,172,61,233
https://kawalpemilu.org#42315,"CANDIBINANGUN, PAKEM, SLEMAN, DAERAH ISTIMEWA YOGYAKARTA",17,163,30,193
https://kawalpemilu.org#42315,"CANDIBINANGUN, PAKEM, SLEMAN, DAERAH ISTIMEWA YOGYAKARTA",18,116,70,186
https://kawalpemilu.org#42315,"CANDIBINANGUN, PAKEM, SLEMAN, DAERAH ISTIMEWA YOGYAKARTA",19,130,61,191
https://kawalpemilu.org#42315,"CANDIBINANGUN, PAKEM, SLEMAN, DAERAH ISTIMEWA YOGYAKARTA",20,211,60,271
https://kawalpemilu.org#42315,"CANDIBINANGUN, PAKEM, SLEMAN, DAERAH ISTIMEWA YOGYAKARTA",21,96,78,174
https://kawalpemilu.org#42315,"CANDIBINANGUN, PAKEM, SLEMAN, DAERAH ISTIMEWA YOGYAKARTA",22,196,71,267
https://kawalpemilu.org#42316,"HARJOBINANGUN, PAKEM, SLEMAN, DAERAH ISTIMEWA YOGYAKARTA",1,166,80,246
https://kawalpemilu.org#42316,"HARJOBINANGUN, PAKEM, SLEMAN, DAERAH ISTIMEWA YOGYAKARTA",2,126,56,182
https://kawalpemilu.org#42316,"HARJOBINANGUN, PAKEM, SLEMAN, DAERAH ISTIMEWA YOGYAKARTA",3,155,37,192
https://kawalpemilu.org#42316,"HARJOBINANGUN, PAKEM, SLEMAN, DAERAH ISTIMEWA YOGYAKARTA",4,152,39,191
https://kawalpemilu.org#42316,"HARJOBINANGUN, PAKEM, SLEMAN, DAERAH ISTIMEWA YOGYAKARTA",5,160,109,269
https://kawalpemilu.org#42316,"HARJOBINANGUN, PAKEM, SLEMAN, DAERAH ISTIMEWA YOGYAKARTA",6,116,137,253
https://kawalpemilu.org#42316,"HARJOBINANGUN, PAKEM, SLEMAN, DAERAH ISTIMEWA YOGYAKARTA",7,161,84,245
https://kawalpemilu.org#42316,"HARJOBINANGUN, PAKEM, SLEMAN, DAERAH ISTIMEWA YOGYAKARTA",8,226,31,257
https://kawalpemilu.org#42316,"HARJOBINANGUN, PAKEM, SLEMAN, DAERAH ISTIMEWA YOGYAKARTA",9,150,95,245
https://kawalpemilu.org#42316,"HARJOBINANGUN, PAKEM, SLEMAN, DAERAH ISTIMEWA YOGYAKARTA",10,107,36,143
https://kawalpemilu.org#42316,"HARJOBINANGUN, PAKEM, SLEMAN, DAERAH ISTIMEWA YOGYAKARTA",11,175,78,253
https://kawalpemilu.org#42316,"HARJOBINANGUN, PAKEM, SLEMAN, DAERAH ISTIMEWA YOGYAKARTA",12,185,57,242
https://kawalpemilu.org#42316,"HARJOBINANGUN, PAKEM, SLEMAN, DAERAH ISTIMEWA YOGYAKARTA",13,162,79,241
https://kawalpemilu.org#42316,"HARJOBINANGUN, PAKEM, SLEMAN, DAERAH ISTIMEWA YOGYAKARTA",14,180,70,250
https://kawalpemilu.org#42316,"HARJOBINANGUN, PAKEM, SLEMAN, DAERAH ISTIMEWA YOGYAKARTA",15,106,18,124
https://kawalpemilu.org#42316,"HARJOBINANGUN, PAKEM, SLEMAN, DAERAH ISTIMEWA YOGYAKARTA",16,156,65,221
https://kawalpemilu.org#42316,"HARJOBINANGUN, PAKEM, SLEMAN, DAERAH ISTIMEWA YOGYAKARTA",17,136,82,218
https://kawalpemilu.org#42316,"HARJOBINANGUN, PAKEM, SLEMAN, DAERAH ISTIMEWA YOGYAKARTA",18,155,98,253
https://kawalpemilu.org#42317,"PAKEMBINANGUN, PAKEM, SLEMAN, DAERAH ISTIMEWA YOGYAKARTA",1,165,48,213
https://kawalpemilu.org#42317,"PAKEMBINANGUN, PAKEM, SLEMAN, DAERAH ISTIMEWA YOGYAKARTA",2,114,62,176
https://kawalpemilu.org#42317,"PAKEMBINANGUN, PAKEM, SLEMAN, DAERAH ISTIMEWA YOGYAKARTA",3,98,71,169
https://kawalpemilu.org#42317,"PAKEMBINANGUN, PAKEM, SLEMAN, DAERAH ISTIMEWA YOGYAKARTA",4,112,25,137
https://kawalpemilu.org#42317,"PAKEMBINANGUN, PAKEM, SLEMAN, DAERAH ISTIMEWA YOGYAKARTA",5,184,60,244
https://kawalpemilu.org#42317,"PAKEMBINANGUN, PAKEM, SLEMAN, DAERAH ISTIMEWA YOGYAKARTA",6,122,41,163
https://kawalpemilu.org#42317,"PAKEMBINANGUN, PAKEM, SLEMAN, DAERAH ISTIMEWA YOGYAKARTA",7,155,65,220
https://kawalpemilu.org#42317,"PAKEMBINANGUN, PAKEM, SLEMAN, DAERAH ISTIMEWA YOGYAKARTA",8,148,77,225
https://kawalpemilu.org#42317,"PAKEMBINANGUN, PAKEM, SLEMAN, DAERAH ISTIMEWA YOGYAKARTA",9,137,77,214
https://kawalpemilu.org#42317,"PAKEMBINANGUN, PAKEM, SLEMAN, DAERAH ISTIMEWA YOGYAKARTA",10,110,81,191
https://kawalpemilu.org#42317,"PAKEMBINANGUN, PAKEM, SLEMAN, DAERAH ISTIMEWA YOGYAKARTA",11,96,70,166
https://kawalpemilu.org#42317,"PAKEMBINANGUN, PAKEM, SLEMAN, DAERAH ISTIMEWA YOGYAKARTA",12,124,85,209
https://kawalpemilu.org#42317,"PAKEMBINANGUN, PAKEM, SLEMAN, DAERAH ISTIMEWA YOGYAKARTA",13,127,44,171
https://kawalpemilu.org#42317,"PAKEMBINANGUN, PAKEM, SLEMAN, DAERAH ISTIMEWA YOGYAKARTA",14,138,114,252
https://kawalpemilu.org#42317,"PAKEMBINANGUN, PAKEM, SLEMAN, DAERAH ISTIMEWA YOGYAKARTA",15,104,56,160
https://kawalpemilu.org#42317,"PAKEMBINANGUN, PAKEM, SLEMAN, DAERAH ISTIMEWA YOGYAKARTA",16,143,68,211
https://kawalpemilu.org#42317,"PAKEMBINANGUN, PAKEM, SLEMAN, DAERAH ISTIMEWA YOGYAKARTA",17,122,56,178
https://kawalpemilu.org#42317,"PAKEMBINANGUN, PAKEM, SLEMAN, DAERAH ISTIMEWA YOGYAKARTA",18,147,55,202
https://kawalpemilu.org#42317,"PAKEMBINANGUN, PAKEM, SLEMAN, DAERAH ISTIMEWA YOGYAKARTA",19,143,43,186
https://kawalpemilu.org#42317,"PAKEMBINANGUN, PAKEM, SLEMAN, DAERAH ISTIMEWA YOGYAKARTA",20,123,48,171
https://kawalpemilu.org#42317,"PAKEMBINANGUN, PAKEM, SLEMAN, DAERAH ISTIMEWA YOGYAKARTA",21,191,46,237
https://kawalpemilu.org#42317,"PAKEMBINANGUN, PAKEM, SLEMAN, DAERAH ISTIMEWA YOGYAKARTA",22,113,74,187
https://kawalpemilu.org#42317,"PAKEMBINANGUN, PAKEM, SLEMAN, DAERAH ISTIMEWA YOGYAKARTA",23,45,15,60
https://kawalpemilu.org#42317,"PAKEMBINANGUN, PAKEM, SLEMAN, DAERAH ISTIMEWA YOGYAKARTA",24,113,77,190
https://kawalpemilu.org#42318,"HARGOBINANGUN, PAKEM, SLEMAN, DAERAH ISTIMEWA YOGYAKARTA",1,137,78,215
https://kawalpemilu.org#42318,"HARGOBINANGUN, PAKEM, SLEMAN, DAERAH ISTIMEWA YOGYAKARTA",2,182,55,237
https://kawalpemilu.org#42318,"HARGOBINANGUN, PAKEM, SLEMAN, DAERAH ISTIMEWA YOGYAKARTA",3,139,63,202
https://kawalpemilu.org#42318,"HARGOBINANGUN, PAKEM, SLEMAN, DAERAH ISTIMEWA YOGYAKARTA",4,130,57,187
https://kawalpemilu.org#42318,"HARGOBINANGUN, PAKEM, SLEMAN, DAERAH ISTIMEWA YOGYAKARTA",5,60,54,114
https://kawalpemilu.org#42318,"HARGOBINANGUN, PAKEM, SLEMAN, DAERAH ISTIMEWA YOGYAKARTA",6,186,40,226
https://kawalpemilu.org#42318,"HARGOBINANGUN, PAKEM, SLEMAN, DAERAH ISTIMEWA YOGYAKARTA",7,194,33,227
https://kawalpemilu.org#42318,"HARGOBINANGUN, PAKEM, SLEMAN, DAERAH ISTIMEWA YOGYAKARTA",8,156,59,215
https://kawalpemilu.org#42318,"HARGOBINANGUN, PAKEM, SLEMAN, DAERAH ISTIMEWA YOGYAKARTA",9,165,104,269
https://kawalpemilu.org#42318,"HARGOBINANGUN, PAKEM, SLEMAN, DAERAH ISTIMEWA YOGYAKARTA",10,181,68,249
https://kawalpemilu.org#42318,"HARGOBINANGUN, PAKEM, SLEMAN, DAERAH ISTIMEWA YOGYAKARTA",11,128,66,194
https://kawalpemilu.org#42318,"HARGOBINANGUN, PAKEM, SLEMAN, DAERAH ISTIMEWA YOGYAKARTA",12,149,64,213
https://kawalpemilu.org#42318,"HARGOBINANGUN, PAKEM, SLEMAN, DAERAH ISTIMEWA YOGYAKARTA",13,114,61,175
https://kawalpemilu.org#42318,"HARGOBINANGUN, PAKEM, SLEMAN, DAERAH ISTIMEWA YOGYAKARTA",14,139,37,176
https://kawalpemilu.org#42318,"HARGOBINANGUN, PAKEM, SLEMAN, DAERAH ISTIMEWA YOGYAKARTA",15,122,68,190
https://kawalpemilu.org#42318,"HARGOBINANGUN, PAKEM, SLEMAN, DAERAH ISTIMEWA YOGYAKARTA",16,95,56,151
https://kawalpemilu.org#42318,"HARGOBINANGUN, PAKEM, SLEMAN, DAERAH ISTIMEWA YOGYAKARTA",17,63,59,122
https://kawalpemilu.org#42318,"HARGOBINANGUN, PAKEM, SLEMAN, DAERAH ISTIMEWA YOGYAKARTA",18,93,57,150
https://kawalpemilu.org#42318,"HARGOBINANGUN, PAKEM, SLEMAN, DAERAH ISTIMEWA YOGYAKARTA",19,109,49,158
https://kawalpemilu.org#42318,"HARGOBINANGUN, PAKEM, SLEMAN, DAERAH ISTIMEWA YOGYAKARTA",20,107,36,143
https://kawalpemilu.org#42318,"HARGOBINANGUN, PAKEM, SLEMAN, DAERAH ISTIMEWA YOGYAKARTA",21,122,33,155
https://kawalpemilu.org#42318,"HARGOBINANGUN, PAKEM, SLEMAN, DAERAH ISTIMEWA YOGYAKARTA",22,161,61,222
https://kawalpemilu.org#42318,"HARGOBINANGUN, PAKEM, SLEMAN, DAERAH ISTIMEWA YOGYAKARTA",23,147,49,196
https://kawalpemilu.org#42318,"HARGOBINANGUN, PAKEM, SLEMAN, DAERAH ISTIMEWA YOGYAKARTA",24,169,57,226
https://kawalpemilu.org#42318,"HARGOBINANGUN, PAKEM, SLEMAN, DAERAH ISTIMEWA YOGYAKARTA",25,166,63,229
https://kawalpemilu.org#42318,"HARGOBINANGUN, PAKEM, SLEMAN, DAERAH ISTIMEWA YOGYAKARTA",26,165,78,243
https://kawalpemilu.org#42318,"HARGOBINANGUN, PAKEM, SLEMAN, DAERAH ISTIMEWA YOGYAKARTA",27,152,96,248
https://kawalpemilu.org#42318,"HARGOBINANGUN, PAKEM, SLEMAN, DAERAH ISTIMEWA YOGYAKARTA",28,235,21,256
https://kawalpemilu.org#42318,"HARGOBINANGUN, PAKEM, SLEMAN, DAERAH ISTIMEWA YOGYAKARTA",29,203,30,233
https://kawalpemilu.org#42318,"HARGOBINANGUN, PAKEM, SLEMAN, DAERAH ISTIMEWA YOGYAKARTA",30,207,55,262
https://kawalpemilu.org#42320,"ARGOMULYO, CANGKRINGAN, SLEMAN, DAERAH ISTIMEWA YOGYAKARTA",1,164,37,201
https://kawalpemilu.org#42320,"ARGOMULYO, CANGKRINGAN, SLEMAN, DAERAH ISTIMEWA YOGYAKARTA",2,175,74,249
https://kawalpemilu.org#42320,"ARGOMULYO, CANGKRINGAN, SLEMAN, DAERAH ISTIMEWA YOGYAKARTA",3,119,49,168
https://kawalpemilu.org#42320,"ARGOMULYO, CANGKRINGAN, SLEMAN, DAERAH ISTIMEWA YOGYAKARTA",4,114,75,189
https://kawalpemilu.org#42320,"ARGOMULYO, CANGKRINGAN, SLEMAN, DAERAH ISTIMEWA YOGYAKARTA",5,103,59,162
https://kawalpemilu.org#42320,"ARGOMULYO, CANGKRINGAN, SLEMAN, DAERAH ISTIMEWA YOGYAKARTA",6,76,75,151
https://kawalpemilu.org#42320,"ARGOMULYO, CANGKRINGAN, SLEMAN, DAERAH ISTIMEWA YOGYAKARTA",7,56,75,131
https://kawalpemilu.org#42320,"ARGOMULYO, CANGKRINGAN, SLEMAN, DAERAH ISTIMEWA YOGYAKARTA",8,87,84,171
https://kawalpemilu.org#42320,"ARGOMULYO, CANGKRINGAN, SLEMAN, DAERAH ISTIMEWA YOGYAKARTA",9,143,54,197
https://kawalpemilu.org#42320,"ARGOMULYO, CANGKRINGAN, SLEMAN, DAERAH ISTIMEWA YOGYAKARTA",10,140,75,215
https://kawalpemilu.org#42320,"ARGOMULYO, CANGKRINGAN, SLEMAN, DAERAH ISTIMEWA YOGYAKARTA",11,165,46,211
https://kawalpemilu.org#42320,"ARGOMULYO, CANGKRINGAN, SLEMAN, DAERAH ISTIMEWA YOGYAKARTA",12,87,81,168
https://kawalpemilu.org#42320,"ARGOMULYO, CANGKRINGAN, SLEMAN, DAERAH ISTIMEWA YOGYAKARTA",13,178,79,257
https://kawalpemilu.org#42320,"ARGOMULYO, CANGKRINGAN, SLEMAN, DAERAH ISTIMEWA YOGYAKARTA",14,205,52,257
https://kawalpemilu.org#42320,"ARGOMULYO, CANGKRINGAN, SLEMAN, DAERAH ISTIMEWA YOGYAKARTA",15,143,64,207
https://kawalpemilu.org#42320,"ARGOMULYO, CANGKRINGAN, SLEMAN, DAERAH ISTIMEWA YOGYAKARTA",16,100,54,154
https://kawalpemilu.org#42320,"ARGOMULYO, CANGKRINGAN, SLEMAN, DAERAH ISTIMEWA YOGYAKARTA",17,71,79,150
https://kawalpemilu.org#42320,"ARGOMULYO, CANGKRINGAN, SLEMAN, DAERAH ISTIMEWA YOGYAKARTA",18,72,95,167
https://kawalpemilu.org#42320,"ARGOMULYO, CANGKRINGAN, SLEMAN, DAERAH ISTIMEWA YOGYAKARTA",19,91,68,159
https://kawalpemilu.org#42320,"ARGOMULYO, CANGKRINGAN, SLEMAN, DAERAH ISTIMEWA YOGYAKARTA",20,184,56,240
https://kawalpemilu.org#42320,"ARGOMULYO, CANGKRINGAN, SLEMAN, DAERAH ISTIMEWA YOGYAKARTA",21,169,49,218
https://kawalpemilu.org#42320,"ARGOMULYO, CANGKRINGAN, SLEMAN, DAERAH ISTIMEWA YOGYAKARTA",23,121,94,215
https://kawalpemilu.org#42320,"ARGOMULYO, CANGKRINGAN, SLEMAN, DAERAH ISTIMEWA YOGYAKARTA",24,131,56,187
https://kawalpemilu.org#42320,"ARGOMULYO, CANGKRINGAN, SLEMAN, DAERAH ISTIMEWA YOGYAKARTA",25,157,42,199
https://kawalpemilu.org#42320,"ARGOMULYO, CANGKRINGAN, SLEMAN, DAERAH ISTIMEWA YOGYAKARTA",26,111,60,171
https://kawalpemilu.org#42320,"ARGOMULYO, CANGKRINGAN, SLEMAN, DAERAH ISTIMEWA YOGYAKARTA",27,101,74,175
https://kawalpemilu.org#42320,"ARGOMULYO, CANGKRINGAN, SLEMAN, DAERAH ISTIMEWA YOGYAKARTA",28,104,78,182
https://kawalpemilu.org#42321,"WUKIRSARI, CANGKRINGAN, SLEMAN, DAERAH ISTIMEWA YOGYAKARTA",1,176,36,212
https://kawalpemilu.org#42321,"WUKIRSARI, CANGKRINGAN, SLEMAN, DAERAH ISTIMEWA YOGYAKARTA",2,100,105,205
https://kawalpemilu.org#42321,"WUKIRSARI, CANGKRINGAN, SLEMAN, DAERAH ISTIMEWA YOGYAKARTA",3,212,34,246
https://kawalpemilu.org#42321,"WUKIRSARI, CANGKRINGAN, SLEMAN, DAERAH ISTIMEWA YOGYAKARTA",4,102,51,153
https://kawalpemilu.org#42321,"WUKIRSARI, CANGKRINGAN, SLEMAN, DAERAH ISTIMEWA YOGYAKARTA",5,129,39,168
https://kawalpemilu.org#42321,"WUKIRSARI, CANGKRINGAN, SLEMAN, DAERAH ISTIMEWA YOGYAKARTA",6,157,57,214
https://kawalpemilu.org#42321,"WUKIRSARI, CANGKRINGAN, SLEMAN, DAERAH ISTIMEWA YOGYAKARTA",7,116,133,249
https://kawalpemilu.org#42321,"WUKIRSARI, CANGKRINGAN, SLEMAN, DAERAH ISTIMEWA YOGYAKARTA",8,101,72,173
https://kawalpemilu.org#42321,"WUKIRSARI, CANGKRINGAN, SLEMAN, DAERAH ISTIMEWA YOGYAKARTA",9,103,66,169
https://kawalpemilu.org#42321,"WUKIRSARI, CANGKRINGAN, SLEMAN, DAERAH ISTIMEWA YOGYAKARTA",10,148,234,234
https://kawalpemilu.org#42321,"WUKIRSARI, CANGKRINGAN, SLEMAN, DAERAH ISTIMEWA YOGYAKARTA",11,116,116,232
https://kawalpemilu.org#42321,"WUKIRSARI, CANGKRINGAN, SLEMAN, DAERAH ISTIMEWA YOGYAKARTA",12,136,53,189
https://kawalpemilu.org#42321,"WUKIRSARI, CANGKRINGAN, SLEMAN, DAERAH ISTIMEWA YOGYAKARTA",13,182,84,266
https://kawalpemilu.org#42321,"WUKIRSARI, CANGKRINGAN, SLEMAN, DAERAH ISTIMEWA YOGYAKARTA",14,140,63,203
https://kawalpemilu.org#42321,"WUKIRSARI, CANGKRINGAN, SLEMAN, DAERAH ISTIMEWA YOGYAKARTA",15,174,35,209
https://kawalpemilu.org#42321,"WUKIRSARI, CANGKRINGAN, SLEMAN, DAERAH ISTIMEWA YOGYAKARTA",16,212,29,241
https://kawalpemilu.org#42321,"WUKIRSARI, CANGKRINGAN, SLEMAN, DAERAH ISTIMEWA YOGYAKARTA",17,112,68,180
https://kawalpemilu.org#42321,"WUKIRSARI, CANGKRINGAN, SLEMAN, DAERAH ISTIMEWA YOGYAKARTA",18,151,27,178
https://kawalpemilu.org#42321,"WUKIRSARI, CANGKRINGAN, SLEMAN, DAERAH ISTIMEWA YOGYAKARTA",19,153,66,219
https://kawalpemilu.org#42321,"WUKIRSARI, CANGKRINGAN, SLEMAN, DAERAH ISTIMEWA YOGYAKARTA",20,128,67,195
https://kawalpemilu.org#42321,"WUKIRSARI, CANGKRINGAN, SLEMAN, DAERAH ISTIMEWA YOGYAKARTA",21,77,73,150
https://kawalpemilu.org#42321,"WUKIRSARI, CANGKRINGAN, SLEMAN, DAERAH ISTIMEWA YOGYAKARTA",22,143,60,203
https://kawalpemilu.org#42321,"WUKIRSARI, CANGKRINGAN, SLEMAN, DAERAH ISTIMEWA YOGYAKARTA",23,180,63,243
https://kawalpemilu.org#42321,"WUKIRSARI, CANGKRINGAN, SLEMAN, DAERAH ISTIMEWA YOGYAKARTA",24,70,72,142
https://kawalpemilu.org#42321,"WUKIRSARI, CANGKRINGAN, SLEMAN, DAERAH ISTIMEWA YOGYAKARTA",25,140,69,209
https://kawalpemilu.org#42321,"WUKIRSARI, CANGKRINGAN, SLEMAN, DAERAH ISTIMEWA YOGYAKARTA",26,88,133,221
https://kawalpemilu.org#42321,"WUKIRSARI, CANGKRINGAN, SLEMAN, DAERAH ISTIMEWA YOGYAKARTA",27,92,56,148
https://kawalpemilu.org#42321,"WUKIRSARI, CANGKRINGAN, SLEMAN, DAERAH ISTIMEWA YOGYAKARTA",28,119,70,189
https://kawalpemilu.org#42321,"WUKIRSARI, CANGKRINGAN, SLEMAN, DAERAH ISTIMEWA YOGYAKARTA",29,159,85,244
https://kawalpemilu.org#42321,"WUKIRSARI, CANGKRINGAN, SLEMAN, DAERAH ISTIMEWA YOGYAKARTA",30,177,55,232
https://kawalpemilu.org#42321,"WUKIRSARI, CANGKRINGAN, SLEMAN, DAERAH ISTIMEWA YOGYAKARTA",31,214,39,253
https://kawalpemilu.org#42321,"WUKIRSARI, CANGKRINGAN, SLEMAN, DAERAH ISTIMEWA YOGYAKARTA",32,179,33,212
https://kawalpemilu.org#42321,"WUKIRSARI, CANGKRINGAN, SLEMAN, DAERAH ISTIMEWA YOGYAKARTA",33,152,75,227
https://kawalpemilu.org#42321,"WUKIRSARI, CANGKRINGAN, SLEMAN, DAERAH ISTIMEWA YOGYAKARTA",34,113,59,172
https://kawalpemilu.org#42321,"WUKIRSARI, CANGKRINGAN, SLEMAN, DAERAH ISTIMEWA YOGYAKARTA",35,132,88,220
https://kawalpemilu.org#42322,"GLAGAHARJO, CANGKRINGAN, SLEMAN, DAERAH ISTIMEWA YOGYAKARTA",1,198,38,236
https://kawalpemilu.org#42322,"GLAGAHARJO, CANGKRINGAN, SLEMAN, DAERAH ISTIMEWA YOGYAKARTA",2,122,55,177
https://kawalpemilu.org#42322,"GLAGAHARJO, CANGKRINGAN, SLEMAN, DAERAH ISTIMEWA YOGYAKARTA",3,89,59,148
https://kawalpemilu.org#42322,"GLAGAHARJO, CANGKRINGAN, SLEMAN, DAERAH ISTIMEWA YOGYAKARTA",4,178,37,215
https://kawalpemilu.org#42322,"GLAGAHARJO, CANGKRINGAN, SLEMAN, DAERAH ISTIMEWA YOGYAKARTA",5,190,20,210
https://kawalpemilu.org#42322,"GLAGAHARJO, CANGKRINGAN, SLEMAN, DAERAH ISTIMEWA YOGYAKARTA",6,163,36,199
https://kawalpemilu.org#42322,"GLAGAHARJO, CANGKRINGAN, SLEMAN, DAERAH ISTIMEWA YOGYAKARTA",7,156,27,183
https://kawalpemilu.org#42322,"GLAGAHARJO, CANGKRINGAN, SLEMAN, DAERAH ISTIMEWA YOGYAKARTA",8,158,40,198
https://kawalpemilu.org#42322,"GLAGAHARJO, CANGKRINGAN, SLEMAN, DAERAH ISTIMEWA YOGYAKARTA",9,242,40,282
https://kawalpemilu.org#42322,"GLAGAHARJO, CANGKRINGAN, SLEMAN, DAERAH ISTIMEWA YOGYAKARTA",10,146,28,174
https://kawalpemilu.org#42322,"GLAGAHARJO, CANGKRINGAN, SLEMAN, DAERAH ISTIMEWA YOGYAKARTA",11,119,28,147
https://kawalpemilu.org#42322,"GLAGAHARJO, CANGKRINGAN, SLEMAN, DAERAH ISTIMEWA YOGYAKARTA",12,76,44,120
https://kawalpemilu.org#42322,"GLAGAHARJO, CANGKRINGAN, SLEMAN, DAERAH ISTIMEWA YOGYAKARTA",13,95,38,133
https://kawalpemilu.org#42322,"GLAGAHARJO, CANGKRINGAN, SLEMAN, DAERAH ISTIMEWA YOGYAKARTA",14,148,33,181
https://kawalpemilu.org#42322,"GLAGAHARJO, CANGKRINGAN, SLEMAN, DAERAH ISTIMEWA YOGYAKARTA",15,196,13,209
https://kawalpemilu.org#42323,"KEPUHARJO, CANGKRINGAN, SLEMAN, DAERAH ISTIMEWA YOGYAKARTA",1,120,53,173
https://kawalpemilu.org#42323,"KEPUHARJO, CANGKRINGAN, SLEMAN, DAERAH ISTIMEWA YOGYAKARTA",2,131,53,184
https://kawalpemilu.org#42323,"KEPUHARJO, CANGKRINGAN, SLEMAN, DAERAH ISTIMEWA YOGYAKARTA",3,196,70,266
https://kawalpemilu.org#42323,"KEPUHARJO, CANGKRINGAN, SLEMAN, DAERAH ISTIMEWA YOGYAKARTA",4,212,63,275
https://kawalpemilu.org#42323,"KEPUHARJO, CANGKRINGAN, SLEMAN, DAERAH ISTIMEWA YOGYAKARTA",5,216,34,250
https://kawalpemilu.org#42323,"KEPUHARJO, CANGKRINGAN, SLEMAN, DAERAH ISTIMEWA YOGYAKARTA",6,226,23,249
https://kawalpemilu.org#42323,"KEPUHARJO, CANGKRINGAN, SLEMAN, DAERAH ISTIMEWA YOGYAKARTA",7,133,34,167
https://kawalpemilu.org#42323,"KEPUHARJO, CANGKRINGAN, SLEMAN, DAERAH ISTIMEWA YOGYAKARTA",8,114,47,161
https://kawalpemilu.org#42323,"KEPUHARJO, CANGKRINGAN, SLEMAN, DAERAH ISTIMEWA YOGYAKARTA",9,159,40,199
https://kawalpemilu.org#42323,"KEPUHARJO, CANGKRINGAN, SLEMAN, DAERAH ISTIMEWA YOGYAKARTA",10,183,86,269
https://kawalpemilu.org#42323,"KEPUHARJO, CANGKRINGAN, SLEMAN, DAERAH ISTIMEWA YOGYAKARTA",11,178,43,221
https://kawalpemilu.org#42324,"UMBULHARJO, CANGKRINGAN, SLEMAN, DAERAH ISTIMEWA YOGYAKARTA",1,126,29,155
https://kawalpemilu.org#42324,"UMBULHARJO, CANGKRINGAN, SLEMAN, DAERAH ISTIMEWA YOGYAKARTA",2,227,39,266
https://kawalpemilu.org#42324,"UMBULHARJO, CANGKRINGAN, SLEMAN, DAERAH ISTIMEWA YOGYAKARTA",3,207,54,261
https://kawalpemilu.org#42324,"UMBULHARJO, CANGKRINGAN, SLEMAN, DAERAH ISTIMEWA YOGYAKARTA",4,187,34,221
https://kawalpemilu.org#42324,"UMBULHARJO, CANGKRINGAN, SLEMAN, DAERAH ISTIMEWA YOGYAKARTA",5,193,71,264
https://kawalpemilu.org#42324,"UMBULHARJO, CANGKRINGAN, SLEMAN, DAERAH ISTIMEWA YOGYAKARTA",6,221,40,261
https://kawalpemilu.org#42324,"UMBULHARJO, CANGKRINGAN, SLEMAN, DAERAH ISTIMEWA YOGYAKARTA",7,152,47,199
https://kawalpemilu.org#42324,"UMBULHARJO, CANGKRINGAN, SLEMAN, DAERAH ISTIMEWA YOGYAKARTA",8,169,42,211
https://kawalpemilu.org#42324,"UMBULHARJO, CANGKRINGAN, SLEMAN, DAERAH ISTIMEWA YOGYAKARTA",9,156,75,231
https://kawalpemilu.org#42324,"UMBULHARJO, CANGKRINGAN, SLEMAN, DAERAH ISTIMEWA YOGYAKARTA",10,107,78,185
https://kawalpemilu.org#42324,"UMBULHARJO, CANGKRINGAN, SLEMAN, DAERAH ISTIMEWA YOGYAKARTA",11,92,57,149
https://kawalpemilu.org#42324,"UMBULHARJO, CANGKRINGAN, SLEMAN, DAERAH ISTIMEWA YOGYAKARTA",12,155,64,219
https://kawalpemilu.org#42324,"UMBULHARJO, CANGKRINGAN, SLEMAN, DAERAH ISTIMEWA YOGYAKARTA",13,165,25,190
https://kawalpemilu.org#42324,"UMBULHARJO, CANGKRINGAN, SLEMAN, DAERAH ISTIMEWA YOGYAKARTA",14,154,86,240
https://kawalpemilu.org#42324,"UMBULHARJO, CANGKRINGAN, SLEMAN, DAERAH ISTIMEWA YOGYAKARTA",15,123,61,184
https://kawalpemilu.org#42324,"UMBULHARJO, CANGKRINGAN, SLEMAN, DAERAH ISTIMEWA YOGYAKARTA",16,187,34,221
https://kawalpemilu.org#42324,"UMBULHARJO, CANGKRINGAN, SLEMAN, DAERAH ISTIMEWA YOGYAKARTA",17,113,31,144
https://kawalpemilu.org#42327,"KRICAK, TEGALREJO, KOTA YOGYAKARTA, DAERAH ISTIMEWA YOGYAKARTA",1,201,50,251
https://kawalpemilu.org#42327,"KRICAK, TEGALREJO, KOTA YOGYAKARTA, DAERAH ISTIMEWA YOGYAKARTA",2,157,37,194
https://kawalpemilu.org#42327,"KRICAK, TEGALREJO, KOTA YOGYAKARTA, DAERAH ISTIMEWA YOGYAKARTA",3,174,33,207
https://kawalpemilu.org#42327,"KRICAK, TEGALREJO, KOTA YOGYAKARTA, DAERAH ISTIMEWA YOGYAKARTA",4,182,40,222
https://kawalpemilu.org#42327,"KRICAK, TEGALREJO, KOTA YOGYAKARTA, DAERAH ISTIMEWA YOGYAKARTA",5,149,41,190
https://kawalpemilu.org#42327,"KRICAK, TEGALREJO, KOTA YOGYAKARTA, DAERAH ISTIMEWA YOGYAKARTA",6,148,56,204
https://kawalpemilu.org#42327,"KRICAK, TEGALREJO, KOTA YOGYAKARTA, DAERAH ISTIMEWA YOGYAKARTA",7,156,41,197
https://kawalpemilu.org#42327,"KRICAK, TEGALREJO, KOTA YOGYAKARTA, DAERAH ISTIMEWA YOGYAKARTA",8,169,34,203
https://kawalpemilu.org#42327,"KRICAK, TEGALREJO, KOTA YOGYAKARTA, DAERAH ISTIMEWA YOGYAKARTA",9,142,52,194
https://kawalpemilu.org#42327,"KRICAK, TEGALREJO, KOTA YOGYAKARTA, DAERAH ISTIMEWA YOGYAKARTA",10,191,49,240
https://kawalpemilu.org#42327,"KRICAK, TEGALREJO, KOTA YOGYAKARTA, DAERAH ISTIMEWA YOGYAKARTA",11,114,93,207
https://kawalpemilu.org#42327,"KRICAK, TEGALREJO, KOTA YOGYAKARTA, DAERAH ISTIMEWA YOGYAKARTA",12,165,64,229
https://kawalpemilu.org#42327,"KRICAK, TEGALREJO, KOTA YOGYAKARTA, DAERAH ISTIMEWA YOGYAKARTA",13,151,47,198
https://kawalpemilu.org#42327,"KRICAK, TEGALREJO, KOTA YOGYAKARTA, DAERAH ISTIMEWA YOGYAKARTA",14,184,52,236
https://kawalpemilu.org#42327,"KRICAK, TEGALREJO, KOTA YOGYAKARTA, DAERAH ISTIMEWA YOGYAKARTA",15,136,35,163
https://kawalpemilu.org#42327,"KRICAK, TEGALREJO, KOTA YOGYAKARTA, DAERAH ISTIMEWA YOGYAKARTA",16,165,36,201
https://kawalpemilu.org#42327,"KRICAK, TEGALREJO, KOTA YOGYAKARTA, DAERAH ISTIMEWA YOGYAKARTA",17,168,63,231
https://kawalpemilu.org#42327,"KRICAK, TEGALREJO, KOTA YOGYAKARTA, DAERAH ISTIMEWA YOGYAKARTA",18,188,24,212
https://kawalpemilu.org#42327,"KRICAK, TEGALREJO, KOTA YOGYAKARTA, DAERAH ISTIMEWA YOGYAKARTA",19,177,37,214
https://kawalpemilu.org#42327,"KRICAK, TEGALREJO, KOTA YOGYAKARTA, DAERAH ISTIMEWA YOGYAKARTA",20,109,71,180
https://kawalpemilu.org#42327,"KRICAK, TEGALREJO, KOTA YOGYAKARTA, DAERAH ISTIMEWA YOGYAKARTA",21,104,60,164
https://kawalpemilu.org#42327,"KRICAK, TEGALREJO, KOTA YOGYAKARTA, DAERAH ISTIMEWA YOGYAKARTA",22,143,40,183
https://kawalpemilu.org#42327,"KRICAK, TEGALREJO, KOTA YOGYAKARTA, DAERAH ISTIMEWA YOGYAKARTA",23,147,31,178
https://kawalpemilu.org#42327,"KRICAK, TEGALREJO, KOTA YOGYAKARTA, DAERAH ISTIMEWA YOGYAKARTA",24,134,21,155
https://kawalpemilu.org#42327,"KRICAK, TEGALREJO, KOTA YOGYAKARTA, DAERAH ISTIMEWA YOGYAKARTA",25,134,95,229
https://kawalpemilu.org#42327,"KRICAK, TEGALREJO, KOTA YOGYAKARTA, DAERAH ISTIMEWA YOGYAKARTA",26,135,52,187
https://kawalpemilu.org#42327,"KRICAK, TEGALREJO, KOTA YOGYAKARTA, DAERAH ISTIMEWA YOGYAKARTA",27,125,63,188
https://kawalpemilu.org#42327,"KRICAK, TEGALREJO, KOTA YOGYAKARTA, DAERAH ISTIMEWA YOGYAKARTA",28,153,43,196
https://kawalpemilu.org#42327,"KRICAK, TEGALREJO, KOTA YOGYAKARTA, DAERAH ISTIMEWA YOGYAKARTA",29,165,52,217
https://kawalpemilu.org#42327,"KRICAK, TEGALREJO, KOTA YOGYAKARTA, DAERAH ISTIMEWA YOGYAKARTA",30,185,41,226
https://kawalpemilu.org#42327,"KRICAK, TEGALREJO, KOTA YOGYAKARTA, DAERAH ISTIMEWA YOGYAKARTA",31,150,40,190
https://kawalpemilu.org#42327,"KRICAK, TEGALREJO, KOTA YOGYAKARTA, DAERAH ISTIMEWA YOGYAKARTA",32,144,61,205
https://kawalpemilu.org#42327,"KRICAK, TEGALREJO, KOTA YOGYAKARTA, DAERAH ISTIMEWA YOGYAKARTA",33,134,71,205
https://kawalpemilu.org#42327,"KRICAK, TEGALREJO, KOTA YOGYAKARTA, DAERAH ISTIMEWA YOGYAKARTA",34,97,82,179
https://kawalpemilu.org#42327,"KRICAK, TEGALREJO, KOTA YOGYAKARTA, DAERAH ISTIMEWA YOGYAKARTA",35,168,68,236
https://kawalpemilu.org#42327,"KRICAK, TEGALREJO, KOTA YOGYAKARTA, DAERAH ISTIMEWA YOGYAKARTA",36,160,51,211
https://kawalpemilu.org#42327,"KRICAK, TEGALREJO, KOTA YOGYAKARTA, DAERAH ISTIMEWA YOGYAKARTA",37,169,57,226
https://kawalpemilu.org#42327,"KRICAK, TEGALREJO, KOTA YOGYAKARTA, DAERAH ISTIMEWA YOGYAKARTA",38,151,75,226
https://kawalpemilu.org#42327,"KRICAK, TEGALREJO, KOTA YOGYAKARTA, DAERAH ISTIMEWA YOGYAKARTA",39,186,60,246
https://kawalpemilu.org#42327,"KRICAK, TEGALREJO, KOTA YOGYAKARTA, DAERAH ISTIMEWA YOGYAKARTA",40,213,51,264
https://kawalpemilu.org#42327,"KRICAK, TEGALREJO, KOTA YOGYAKARTA, DAERAH ISTIMEWA YOGYAKARTA",41,205,45,250
https://kawalpemilu.org#42328,"KARANGWARU, TEGALREJO, KOTA YOGYAKARTA, DAERAH ISTIMEWA YOGYAKARTA",1,171,70,241
https://kawalpemilu.org#42328,"KARANGWARU, TEGALREJO, KOTA YOGYAKARTA, DAERAH ISTIMEWA YOGYAKARTA",2,138,84,222
https://kawalpemilu.org#42328,"KARANGWARU, TEGALREJO, KOTA YOGYAKARTA, DAERAH ISTIMEWA YOGYAKARTA",3,161,73,234
https://kawalpemilu.org#42328,"KARANGWARU, TEGALREJO, KOTA YOGYAKARTA, DAERAH ISTIMEWA YOGYAKARTA",4,173,38,211
https://kawalpemilu.org#42328,"KARANGWARU, TEGALREJO, KOTA YOGYAKARTA, DAERAH ISTIMEWA YOGYAKARTA",5,148,71,219
https://kawalpemilu.org#42328,"KARANGWARU, TEGALREJO, KOTA YOGYAKARTA, DAERAH ISTIMEWA YOGYAKARTA",6,116,71,187
https://kawalpemilu.org#42328,"KARANGWARU, TEGALREJO, KOTA YOGYAKARTA, DAERAH ISTIMEWA YOGYAKARTA",7,139,68,207
https://kawalpemilu.org#42328,"KARANGWARU, TEGALREJO, KOTA YOGYAKARTA, DAERAH ISTIMEWA YOGYAKARTA",8,160,73,233
https://kawalpemilu.org#42328,"KARANGWARU, TEGALREJO, KOTA YOGYAKARTA, DAERAH ISTIMEWA YOGYAKARTA",9,137,51,188
https://kawalpemilu.org#42328,"KARANGWARU, TEGALREJO, KOTA YOGYAKARTA, DAERAH ISTIMEWA YOGYAKARTA",10,186,55,241
https://kawalpemilu.org#42328,"KARANGWARU, TEGALREJO, KOTA YOGYAKARTA, DAERAH ISTIMEWA YOGYAKARTA",11,134,80,214
https://kawalpemilu.org#42328,"KARANGWARU, TEGALREJO, KOTA YOGYAKARTA, DAERAH ISTIMEWA YOGYAKARTA",12,149,91,240
https://kawalpemilu.org#42328,"KARANGWARU, TEGALREJO, KOTA YOGYAKARTA, DAERAH ISTIMEWA YOGYAKARTA",13,138,73,211
https://kawalpemilu.org#42328,"KARANGWARU, TEGALREJO, KOTA YOGYAKARTA, DAERAH ISTIMEWA YOGYAKARTA",14,166,70,236
https://kawalpemilu.org#42328,"KARANGWARU, TEGALREJO, KOTA YOGYAKARTA, DAERAH ISTIMEWA YOGYAKARTA",15,152,64,216
https://kawalpemilu.org#42328,"KARANGWARU, TEGALREJO, KOTA YOGYAKARTA, DAERAH ISTIMEWA YOGYAKARTA",16,141,87,228
https://kawalpemilu.org#42328,"KARANGWARU, TEGALREJO, KOTA YOGYAKARTA, DAERAH ISTIMEWA YOGYAKARTA",17,144,66,210
https://kawalpemilu.org#42328,"KARANGWARU, TEGALREJO, KOTA YOGYAKARTA, DAERAH ISTIMEWA YOGYAKARTA",18,160,35,195
https://kawalpemilu.org#42328,"KARANGWARU, TEGALREJO, KOTA YOGYAKARTA, DAERAH ISTIMEWA YOGYAKARTA",19,117,61,178
https://kawalpemilu.org#42328,"KARANGWARU, TEGALREJO, KOTA YOGYAKARTA, DAERAH ISTIMEWA YOGYAKARTA",20,141,41,182
https://kawalpemilu.org#42328,"KARANGWARU, TEGALREJO, KOTA YOGYAKARTA, DAERAH ISTIMEWA YOGYAKARTA",21,147,63,210
https://kawalpemilu.org#42328,"KARANGWARU, TEGALREJO, KOTA YOGYAKARTA, DAERAH ISTIMEWA YOGYAKARTA",22,108,47,155
https://kawalpemilu.org#42328,"KARANGWARU, TEGALREJO, KOTA YOGYAKARTA, DAERAH ISTIMEWA YOGYAKARTA",23,119,78,197
https://kawalpemilu.org#42328,"KARANGWARU, TEGALREJO, KOTA YOGYAKARTA, DAERAH ISTIMEWA YOGYAKARTA",24,130,50,180
https://kawalpemilu.org#42328,"KARANGWARU, TEGALREJO, KOTA YOGYAKARTA, DAERAH ISTIMEWA YOGYAKARTA",25,111,44,155
https://kawalpemilu.org#42328,"KARANGWARU, TEGALREJO, KOTA YOGYAKARTA, DAERAH ISTIMEWA YOGYAKARTA",26,148,41,189
https://kawalpemilu.org#42328,"KARANGWARU, TEGALREJO, KOTA YOGYAKARTA, DAERAH ISTIMEWA YOGYAKARTA",27,139,51,190
https://kawalpemilu.org#42328,"KARANGWARU, TEGALREJO, KOTA YOGYAKARTA, DAERAH ISTIMEWA YOGYAKARTA",28,165,44,209
https://kawalpemilu.org#42328,"KARANGWARU, TEGALREJO, KOTA YOGYAKARTA, DAERAH ISTIMEWA YOGYAKARTA",29,167,44,211
https://kawalpemilu.org#42328,"KARANGWARU, TEGALREJO, KOTA YOGYAKARTA, DAERAH ISTIMEWA YOGYAKARTA",30,131,46,177
https://kawalpemilu.org#42328,"KARANGWARU, TEGALREJO, KOTA YOGYAKARTA, DAERAH ISTIMEWA YOGYAKARTA",31,70,68,138
https://kawalpemilu.org#42328,"KARANGWARU, TEGALREJO, KOTA YOGYAKARTA, DAERAH ISTIMEWA YOGYAKARTA",32,119,38,157
https://kawalpemilu.org#42329,"TEGALREJO, TEGALREJO, KOTA YOGYAKARTA, DAERAH ISTIMEWA YOGYAKARTA",1,194,34,227
https://kawalpemilu.org#42329,"TEGALREJO, TEGALREJO, KOTA YOGYAKARTA, DAERAH ISTIMEWA YOGYAKARTA",2,142,55,197
https://kawalpemilu.org#42329,"TEGALREJO, TEGALREJO, KOTA YOGYAKARTA, DAERAH ISTIMEWA YOGYAKARTA",3,125,46,171
https://kawalpemilu.org#42329,"TEGALREJO, TEGALREJO, KOTA YOGYAKARTA, DAERAH ISTIMEWA YOGYAKARTA",4,118,67,185
https://kawalpemilu.org#42329,"TEGALREJO, TEGALREJO, KOTA YOGYAKARTA, DAERAH ISTIMEWA YOGYAKARTA",5,153,67,220
https://kawalpemilu.org#42329,"TEGALREJO, TEGALREJO, KOTA YOGYAKARTA, DAERAH ISTIMEWA YOGYAKARTA",6,159,70,229
https://kawalpemilu.org#42329,"TEGALREJO, TEGALREJO, KOTA YOGYAKARTA, DAERAH ISTIMEWA YOGYAKARTA",7,97,54,151
https://kawalpemilu.org#42329,"TEGALREJO, TEGALREJO, KOTA YOGYAKARTA, DAERAH ISTIMEWA YOGYAKARTA",8,154,42,196
https://kawalpemilu.org#42329,"TEGALREJO, TEGALREJO, KOTA YOGYAKARTA, DAERAH ISTIMEWA YOGYAKARTA",9,97,63,160
https://kawalpemilu.org#42329,"TEGALREJO, TEGALREJO, KOTA YOGYAKARTA, DAERAH ISTIMEWA YOGYAKARTA",10,110,61,171
https://kawalpemilu.org#42329,"TEGALREJO, TEGALREJO, KOTA YOGYAKARTA, DAERAH ISTIMEWA YOGYAKARTA",11,125,42,167
https://kawalpemilu.org#42329,"TEGALREJO, TEGALREJO, KOTA YOGYAKARTA, DAERAH ISTIMEWA YOGYAKARTA",12,97,62,159
https://kawalpemilu.org#42329,"TEGALREJO, TEGALREJO, KOTA YOGYAKARTA, DAERAH ISTIMEWA YOGYAKARTA",13,135,89,224
https://kawalpemilu.org#42329,"TEGALREJO, TEGALREJO, KOTA YOGYAKARTA, DAERAH ISTIMEWA YOGYAKARTA",15,144,44,188
https://kawalpemilu.org#42329,"TEGALREJO, TEGALREJO, KOTA YOGYAKARTA, DAERAH ISTIMEWA YOGYAKARTA",16,114,20,134
https://kawalpemilu.org#42329,"TEGALREJO, TEGALREJO, KOTA YOGYAKARTA, DAERAH ISTIMEWA YOGYAKARTA",17,107,65,172
https://kawalpemilu.org#42329,"TEGALREJO, TEGALREJO, KOTA YOGYAKARTA, DAERAH ISTIMEWA YOGYAKARTA",18,125,71,196
https://kawalpemilu.org#42329,"TEGALREJO, TEGALREJO, KOTA YOGYAKARTA, DAERAH ISTIMEWA YOGYAKARTA",19,127,79,206
https://kawalpemilu.org#42329,"TEGALREJO, TEGALREJO, KOTA YOGYAKARTA, DAERAH ISTIMEWA YOGYAKARTA",20,81,64,145
https://kawalpemilu.org#42329,"TEGALREJO, TEGALREJO, KOTA YOGYAKARTA, DAERAH ISTIMEWA YOGYAKARTA",21,73,40,113
https://kawalpemilu.org#42329,"TEGALREJO, TEGALREJO, KOTA YOGYAKARTA, DAERAH ISTIMEWA YOGYAKARTA",22,157,43,200
https://kawalpemilu.org#42329,"TEGALREJO, TEGALREJO, KOTA YOGYAKARTA, DAERAH ISTIMEWA YOGYAKARTA",23,166,65,231
https://kawalpemilu.org#42329,"TEGALREJO, TEGALREJO, KOTA YOGYAKARTA, DAERAH ISTIMEWA YOGYAKARTA",24,139,74,213
https://kawalpemilu.org#42329,"TEGALREJO, TEGALREJO, KOTA YOGYAKARTA, DAERAH ISTIMEWA YOGYAKARTA",25,164,61,225
https://kawalpemilu.org#42329,"TEGALREJO, TEGALREJO, KOTA YOGYAKARTA, DAERAH ISTIMEWA YOGYAKARTA",26,148,58,206
https://kawalpemilu.org#42329,"TEGALREJO, TEGALREJO, KOTA YOGYAKARTA, DAERAH ISTIMEWA YOGYAKARTA",27,155,45,200
https://kawalpemilu.org#42329,"TEGALREJO, TEGALREJO, KOTA YOGYAKARTA, DAERAH ISTIMEWA YOGYAKARTA",28,153,56,209
https://kawalpemilu.org#42329,"TEGALREJO, TEGALREJO, KOTA YOGYAKARTA, DAERAH ISTIMEWA YOGYAKARTA",29,132,58,190
https://kawalpemilu.org#42329,"TEGALREJO, TEGALREJO, KOTA YOGYAKARTA, DAERAH ISTIMEWA YOGYAKARTA",30,138,89,227
https://kawalpemilu.org#42329,"TEGALREJO, TEGALREJO, KOTA YOGYAKARTA, DAERAH ISTIMEWA YOGYAKARTA",31,208,42,250
https://kawalpemilu.org#42330,"BENER, TEGALREJO, KOTA YOGYAKARTA, DAERAH ISTIMEWA YOGYAKARTA",1,102,53,155
https://kawalpemilu.org#42330,"BENER, TEGALREJO, KOTA YOGYAKARTA, DAERAH ISTIMEWA YOGYAKARTA",2,107,73,180
https://kawalpemilu.org#42330,"BENER, TEGALREJO, KOTA YOGYAKARTA, DAERAH ISTIMEWA YOGYAKARTA",3,91,97,188
https://kawalpemilu.org#42330,"BENER, TEGALREJO, KOTA YOGYAKARTA, DAERAH ISTIMEWA YOGYAKARTA",4,137,68,205
https://kawalpemilu.org#42330,"BENER, TEGALREJO, KOTA YOGYAKARTA, DAERAH ISTIMEWA YOGYAKARTA",5,162,65,227
https://kawalpemilu.org#42330,"BENER, TEGALREJO, KOTA YOGYAKARTA, DAERAH ISTIMEWA YOGYAKARTA",6,167,49,216
https://kawalpemilu.org#42330,"BENER, TEGALREJO, KOTA YOGYAKARTA, DAERAH ISTIMEWA YOGYAKARTA",8,143,50,193
https://kawalpemilu.org#42330,"BENER, TEGALREJO, KOTA YOGYAKARTA, DAERAH ISTIMEWA YOGYAKARTA",9,154,33,187
https://kawalpemilu.org#42330,"BENER, TEGALREJO, KOTA YOGYAKARTA, DAERAH ISTIMEWA YOGYAKARTA",10,151,36,187
https://kawalpemilu.org#42330,"BENER, TEGALREJO, KOTA YOGYAKARTA, DAERAH ISTIMEWA YOGYAKARTA",11,121,54,175
https://kawalpemilu.org#42330,"BENER, TEGALREJO, KOTA YOGYAKARTA, DAERAH ISTIMEWA YOGYAKARTA",13,116,47,163
https://kawalpemilu.org#42330,"BENER, TEGALREJO, KOTA YOGYAKARTA, DAERAH ISTIMEWA YOGYAKARTA",14,143,74,217
https://kawalpemilu.org#42330,"BENER, TEGALREJO, KOTA YOGYAKARTA, DAERAH ISTIMEWA YOGYAKARTA",15,166,50,216
https://kawalpemilu.org#42330,"BENER, TEGALREJO, KOTA YOGYAKARTA, DAERAH ISTIMEWA YOGYAKARTA",16,166,68,234
https://kawalpemilu.org#42332,"BUMIJO, JETIS, KOTA YOGYAKARTA, DAERAH ISTIMEWA YOGYAKARTA",1,188,31,219
https://kawalpemilu.org#42332,"BUMIJO, JETIS, KOTA YOGYAKARTA, DAERAH ISTIMEWA YOGYAKARTA",2,158,30,188
https://kawalpemilu.org#42332,"BUMIJO, JETIS, KOTA YOGYAKARTA, DAERAH ISTIMEWA YOGYAKARTA",3,149,45,194
https://kawalpemilu.org#42332,"BUMIJO, JETIS, KOTA YOGYAKARTA, DAERAH ISTIMEWA YOGYAKARTA",4,168,49,217
https://kawalpemilu.org#42332,"BUMIJO, JETIS, KOTA YOGYAKARTA, DAERAH ISTIMEWA YOGYAKARTA",5,227,22,249
https://kawalpemilu.org#42332,"BUMIJO, JETIS, KOTA YOGYAKARTA, DAERAH ISTIMEWA YOGYAKARTA",6,187,25,212
https://kawalpemilu.org#42332,"BUMIJO, JETIS, KOTA YOGYAKARTA, DAERAH ISTIMEWA YOGYAKARTA",7,188,37,225
https://kawalpemilu.org#42332,"BUMIJO, JETIS, KOTA YOGYAKARTA, DAERAH ISTIMEWA YOGYAKARTA",8,156,47,203
https://kawalpemilu.org#42332,"BUMIJO, JETIS, KOTA YOGYAKARTA, DAERAH ISTIMEWA YOGYAKARTA",9,194,38,232
https://kawalpemilu.org#42332,"BUMIJO, JETIS, KOTA YOGYAKARTA, DAERAH ISTIMEWA YOGYAKARTA",10,171,73,244
https://kawalpemilu.org#42332,"BUMIJO, JETIS, KOTA YOGYAKARTA, DAERAH ISTIMEWA YOGYAKARTA",11,141,64,205
https://kawalpemilu.org#42332,"BUMIJO, JETIS, KOTA YOGYAKARTA, DAERAH ISTIMEWA YOGYAKARTA",12,189,45,234
https://kawalpemilu.org#42332,"BUMIJO, JETIS, KOTA YOGYAKARTA, DAERAH ISTIMEWA YOGYAKARTA",13,182,61,243
https://kawalpemilu.org#42332,"BUMIJO, JETIS, KOTA YOGYAKARTA, DAERAH ISTIMEWA YOGYAKARTA",14,177,52,229
https://kawalpemilu.org#42332,"BUMIJO, JETIS, KOTA YOGYAKARTA, DAERAH ISTIMEWA YOGYAKARTA",15,165,67,232
https://kawalpemilu.org#42332,"BUMIJO, JETIS, KOTA YOGYAKARTA, DAERAH ISTIMEWA YOGYAKARTA",16,111,32,143
https://kawalpemilu.org#42332,"BUMIJO, JETIS, KOTA YOGYAKARTA, DAERAH ISTIMEWA YOGYAKARTA",17,108,74,182
https://kawalpemilu.org#42332,"BUMIJO, JETIS, KOTA YOGYAKARTA, DAERAH ISTIMEWA YOGYAKARTA",18,123,48,171
https://kawalpemilu.org#42332,"BUMIJO, JETIS, KOTA YOGYAKARTA, DAERAH ISTIMEWA YOGYAKARTA",19,152,39,191
https://kawalpemilu.org#42332,"BUMIJO, JETIS, KOTA YOGYAKARTA, DAERAH ISTIMEWA YOGYAKARTA",20,141,38,179
https://kawalpemilu.org#42332,"BUMIJO, JETIS, KOTA YOGYAKARTA, DAERAH ISTIMEWA YOGYAKARTA",21,103,58,161
https://kawalpemilu.org#42332,"BUMIJO, JETIS, KOTA YOGYAKARTA, DAERAH ISTIMEWA YOGYAKARTA",22,189,46,235
https://kawalpemilu.org#42332,"BUMIJO, JETIS, KOTA YOGYAKARTA, DAERAH ISTIMEWA YOGYAKARTA",23,183,38,221
https://kawalpemilu.org#42332,"BUMIJO, JETIS, KOTA YOGYAKARTA, DAERAH ISTIMEWA YOGYAKARTA",24,148,55,203
https://kawalpemilu.org#42332,"BUMIJO, JETIS, KOTA YOGYAKARTA, DAERAH ISTIMEWA YOGYAKARTA",25,146,43,189
https://kawalpemilu.org#42332,"BUMIJO, JETIS, KOTA YOGYAKARTA, DAERAH ISTIMEWA YOGYAKARTA",26,188,52,240
https://kawalpemilu.org#42332,"BUMIJO, JETIS, KOTA YOGYAKARTA, DAERAH ISTIMEWA YOGYAKARTA",27,133,35,168
https://kawalpemilu.org#42332,"BUMIJO, JETIS, KOTA YOGYAKARTA, DAERAH ISTIMEWA YOGYAKARTA",28,159,48,207
https://kawalpemilu.org#42332,"BUMIJO, JETIS, KOTA YOGYAKARTA, DAERAH ISTIMEWA YOGYAKARTA",29,163,70,233
https://kawalpemilu.org#42332,"BUMIJO, JETIS, KOTA YOGYAKARTA, DAERAH ISTIMEWA YOGYAKARTA",30,163,28,191
https://kawalpemilu.org#42332,"BUMIJO, JETIS, KOTA YOGYAKARTA, DAERAH ISTIMEWA YOGYAKARTA",31,212,29,241
https://kawalpemilu.org#42333,"COKRODININGRATAN, JETIS, KOTA YOGYAKARTA, DAERAH ISTIMEWA YOGYAKARTA",2,107,20,127
https://kawalpemilu.org#42333,"COKRODININGRATAN, JETIS, KOTA YOGYAKARTA, DAERAH ISTIMEWA YOGYAKARTA",3,189,13,202
https://kawalpemilu.org#42333,"COKRODININGRATAN, JETIS, KOTA YOGYAKARTA, DAERAH ISTIMEWA YOGYAKARTA",4,177,16,193
https://kawalpemilu.org#42333,"COKRODININGRATAN, JETIS, KOTA YOGYAKARTA, DAERAH ISTIMEWA YOGYAKARTA",5,153,50,203
https://kawalpemilu.org#42333,"COKRODININGRATAN, JETIS, KOTA YOGYAKARTA, DAERAH ISTIMEWA YOGYAKARTA",6,118,45,163
https://kawalpemilu.org#42333,"COKRODININGRATAN, JETIS, KOTA YOGYAKARTA, DAERAH ISTIMEWA YOGYAKARTA",7,152,44,196
https://kawalpemilu.org#42333,"COKRODININGRATAN, JETIS, KOTA YOGYAKARTA, DAERAH ISTIMEWA YOGYAKARTA",8,129,60,189
https://kawalpemilu.org#42333,"COKRODININGRATAN, JETIS, KOTA YOGYAKARTA, DAERAH ISTIMEWA YOGYAKARTA",9,169,25,194
https://kawalpemilu.org#42333,"COKRODININGRATAN, JETIS, KOTA YOGYAKARTA, DAERAH ISTIMEWA YOGYAKARTA",10,131,47,178
https://kawalpemilu.org#42333,"COKRODININGRATAN, JETIS, KOTA YOGYAKARTA, DAERAH ISTIMEWA YOGYAKARTA",11,86,81,167
https://kawalpemilu.org#42333,"COKRODININGRATAN, JETIS, KOTA YOGYAKARTA, DAERAH ISTIMEWA YOGYAKARTA",12,141,87,228
https://kawalpemilu.org#42333,"COKRODININGRATAN, JETIS, KOTA YOGYAKARTA, DAERAH ISTIMEWA YOGYAKARTA",13,124,32,156
https://kawalpemilu.org#42333,"COKRODININGRATAN, JETIS, KOTA YOGYAKARTA, DAERAH ISTIMEWA YOGYAKARTA",14,93,53,146
https://kawalpemilu.org#42333,"COKRODININGRATAN, JETIS, KOTA YOGYAKARTA, DAERAH ISTIMEWA YOGYAKARTA",15,175,52,227
https://kawalpemilu.org#42333,"COKRODININGRATAN, JETIS, KOTA YOGYAKARTA, DAERAH ISTIMEWA YOGYAKARTA",16,143,45,188
https://kawalpemilu.org#42333,"COKRODININGRATAN, JETIS, KOTA YOGYAKARTA, DAERAH ISTIMEWA YOGYAKARTA",17,119,70,189
https://kawalpemilu.org#42333,"COKRODININGRATAN, JETIS, KOTA YOGYAKARTA, DAERAH ISTIMEWA YOGYAKARTA",18,166,38,204
https://kawalpemilu.org#42333,"COKRODININGRATAN, JETIS, KOTA YOGYAKARTA, DAERAH ISTIMEWA YOGYAKARTA",19,135,52,187
https://kawalpemilu.org#42333,"COKRODININGRATAN, JETIS, KOTA YOGYAKARTA, DAERAH ISTIMEWA YOGYAKARTA",20,140,50,190
https://kawalpemilu.org#42333,"COKRODININGRATAN, JETIS, KOTA YOGYAKARTA, DAERAH ISTIMEWA YOGYAKARTA",21,143,60,203
https://kawalpemilu.org#42333,"COKRODININGRATAN, JETIS, KOTA YOGYAKARTA, DAERAH ISTIMEWA YOGYAKARTA",22,147,83,230
https://kawalpemilu.org#42333,"COKRODININGRATAN, JETIS, KOTA YOGYAKARTA, DAERAH ISTIMEWA YOGYAKARTA",23,184,65,249
https://kawalpemilu.org#42333,"COKRODININGRATAN, JETIS, KOTA YOGYAKARTA, DAERAH ISTIMEWA YOGYAKARTA",24,146,81,277
https://kawalpemilu.org#42333,"COKRODININGRATAN, JETIS, KOTA YOGYAKARTA, DAERAH ISTIMEWA YOGYAKARTA",25,132,45,177
https://kawalpemilu.org#42333,"COKRODININGRATAN, JETIS, KOTA YOGYAKARTA, DAERAH ISTIMEWA YOGYAKARTA",26,188,58,246
https://kawalpemilu.org#42333,"COKRODININGRATAN, JETIS, KOTA YOGYAKARTA, DAERAH ISTIMEWA YOGYAKARTA",27,175,44,219
https://kawalpemilu.org#42333,"COKRODININGRATAN, JETIS, KOTA YOGYAKARTA, DAERAH ISTIMEWA YOGYAKARTA",28,201,39,240
https://kawalpemilu.org#42333,"COKRODININGRATAN, JETIS, KOTA YOGYAKARTA, DAERAH ISTIMEWA YOGYAKARTA",29,174,69,243
https://kawalpemilu.org#42333,"COKRODININGRATAN, JETIS, KOTA YOGYAKARTA, DAERAH ISTIMEWA YOGYAKARTA",30,175,61,236
https://kawalpemilu.org#42334,"GOWONGAN, JETIS, KOTA YOGYAKARTA, DAERAH ISTIMEWA YOGYAKARTA",1,220,16,236
https://kawalpemilu.org#42334,"GOWONGAN, JETIS, KOTA YOGYAKARTA, DAERAH ISTIMEWA YOGYAKARTA",2,192,37,229
https://kawalpemilu.org#42334,"GOWONGAN, JETIS, KOTA YOGYAKARTA, DAERAH ISTIMEWA YOGYAKARTA",3,199,32,231
https://kawalpemilu.org#42334,"GOWONGAN, JETIS, KOTA YOGYAKARTA, DAERAH ISTIMEWA YOGYAKARTA",4,198,55,253
https://kawalpemilu.org#42334,"GOWONGAN, JETIS, KOTA YOGYAKARTA, DAERAH ISTIMEWA YOGYAKARTA",5,144,72,216
https://kawalpemilu.org#42334,"GOWONGAN, JETIS, KOTA YOGYAKARTA, DAERAH ISTIMEWA YOGYAKARTA",6,162,59,221
https://kawalpemilu.org#42334,"GOWONGAN, JETIS, KOTA YOGYAKARTA, DAERAH ISTIMEWA YOGYAKARTA",7,182,50,232
https://kawalpemilu.org#42334,"GOWONGAN, JETIS, KOTA YOGYAKARTA, DAERAH ISTIMEWA YOGYAKARTA",8,195,48,243
https://kawalpemilu.org#42334,"GOWONGAN, JETIS, KOTA YOGYAKARTA, DAERAH ISTIMEWA YOGYAKARTA",9,149,83,232
https://kawalpemilu.org#42334,"GOWONGAN, JETIS, KOTA YOGYAKARTA, DAERAH ISTIMEWA YOGYAKARTA",10,193,57,250
https://kawalpemilu.org#42334,"GOWONGAN, JETIS, KOTA YOGYAKARTA, DAERAH ISTIMEWA YOGYAKARTA",11,137,66,203
https://kawalpemilu.org#42334,"GOWONGAN, JETIS, KOTA YOGYAKARTA, DAERAH ISTIMEWA YOGYAKARTA",12,152,47,199
https://kawalpemilu.org#42334,"GOWONGAN, JETIS, KOTA YOGYAKARTA, DAERAH ISTIMEWA YOGYAKARTA",13,210,38,248
https://kawalpemilu.org#42334,"GOWONGAN, JETIS, KOTA YOGYAKARTA, DAERAH ISTIMEWA YOGYAKARTA",14,74,51,125
https://kawalpemilu.org#42334,"GOWONGAN, JETIS, KOTA YOGYAKARTA, DAERAH ISTIMEWA YOGYAKARTA",15,136,53,189
https://kawalpemilu.org#42334,"GOWONGAN, JETIS, KOTA YOGYAKARTA, DAERAH ISTIMEWA YOGYAKARTA",16,127,41,168
https://kawalpemilu.org#42334,"GOWONGAN, JETIS, KOTA YOGYAKARTA, DAERAH ISTIMEWA YOGYAKARTA",17,193,52,245
https://kawalpemilu.org#42334,"GOWONGAN, JETIS, KOTA YOGYAKARTA, DAERAH ISTIMEWA YOGYAKARTA",18,140,76,216
https://kawalpemilu.org#42334,"GOWONGAN, JETIS, KOTA YOGYAKARTA, DAERAH ISTIMEWA YOGYAKARTA",19,127,40,167
https://kawalpemilu.org#42334,"GOWONGAN, JETIS, KOTA YOGYAKARTA, DAERAH ISTIMEWA YOGYAKARTA",20,147,69,216
https://kawalpemilu.org#42334,"GOWONGAN, JETIS, KOTA YOGYAKARTA, DAERAH ISTIMEWA YOGYAKARTA",21,166,76,242
https://kawalpemilu.org#42334,"GOWONGAN, JETIS, KOTA YOGYAKARTA, DAERAH ISTIMEWA YOGYAKARTA",22,105,66,171
https://kawalpemilu.org#42334,"GOWONGAN, JETIS, KOTA YOGYAKARTA, DAERAH ISTIMEWA YOGYAKARTA",23,117,46,163
https://kawalpemilu.org#42334,"GOWONGAN, JETIS, KOTA YOGYAKARTA, DAERAH ISTIMEWA YOGYAKARTA",24,169,53,222
https://kawalpemilu.org#42336,"DEMANGAN, GONDOKUSUMAN, KOTA YOGYAKARTA, DAERAH ISTIMEWA YOGYAKARTA",1,199,71,270
https://kawalpemilu.org#42336,"DEMANGAN, GONDOKUSUMAN, KOTA YOGYAKARTA, DAERAH ISTIMEWA YOGYAKARTA",2,177,66,243
https://kawalpemilu.org#42336,"DEMANGAN, GONDOKUSUMAN, KOTA YOGYAKARTA, DAERAH ISTIMEWA YOGYAKARTA",3,132,45,177
https://kawalpemilu.org#42336,"DEMANGAN, GONDOKUSUMAN, KOTA YOGYAKARTA, DAERAH ISTIMEWA YOGYAKARTA",4,112,56,168
https://kawalpemilu.org#42336,"DEMANGAN, GONDOKUSUMAN, KOTA YOGYAKARTA, DAERAH ISTIMEWA YOGYAKARTA",5,124,23,147
https://kawalpemilu.org#42336,"DEMANGAN, GONDOKUSUMAN, KOTA YOGYAKARTA, DAERAH ISTIMEWA YOGYAKARTA",6,172,22,194
https://kawalpemilu.org#42336,"DEMANGAN, GONDOKUSUMAN, KOTA YOGYAKARTA, DAERAH ISTIMEWA YOGYAKARTA",7,186,45,231
https://kawalpemilu.org#42336,"DEMANGAN, GONDOKUSUMAN, KOTA YOGYAKARTA, DAERAH ISTIMEWA YOGYAKARTA",8,164,64,228
https://kawalpemilu.org#42336,"DEMANGAN, GONDOKUSUMAN, KOTA YOGYAKARTA, DAERAH ISTIMEWA YOGYAKARTA",9,133,85,218
https://kawalpemilu.org#42336,"DEMANGAN, GONDOKUSUMAN, KOTA YOGYAKARTA, DAERAH ISTIMEWA YOGYAKARTA",10,147,85,232
https://kawalpemilu.org#42336,"DEMANGAN, GONDOKUSUMAN, KOTA YOGYAKARTA, DAERAH ISTIMEWA YOGYAKARTA",11,90,66,156
https://kawalpemilu.org#42336,"DEMANGAN, GONDOKUSUMAN, KOTA YOGYAKARTA, DAERAH ISTIMEWA YOGYAKARTA",12,165,64,229
https://kawalpemilu.org#42336,"DEMANGAN, GONDOKUSUMAN, KOTA YOGYAKARTA, DAERAH ISTIMEWA YOGYAKARTA",13,139,51,190
https://kawalpemilu.org#42336,"DEMANGAN, GONDOKUSUMAN, KOTA YOGYAKARTA, DAERAH ISTIMEWA YOGYAKARTA",14,131,78,209
https://kawalpemilu.org#42336,"DEMANGAN, GONDOKUSUMAN, KOTA YOGYAKARTA, DAERAH ISTIMEWA YOGYAKARTA",15,74,76,150
https://kawalpemilu.org#42336,"DEMANGAN, GONDOKUSUMAN, KOTA YOGYAKARTA, DAERAH ISTIMEWA YOGYAKARTA",16,151,106,257
https://kawalpemilu.org#42336,"DEMANGAN, GONDOKUSUMAN, KOTA YOGYAKARTA, DAERAH ISTIMEWA YOGYAKARTA",17,154,103,257
https://kawalpemilu.org#42336,"DEMANGAN, GONDOKUSUMAN, KOTA YOGYAKARTA, DAERAH ISTIMEWA YOGYAKARTA",18,157,96,253
https://kawalpemilu.org#42336,"DEMANGAN, GONDOKUSUMAN, KOTA YOGYAKARTA, DAERAH ISTIMEWA YOGYAKARTA",19,151,57,208
https://kawalpemilu.org#42336,"DEMANGAN, GONDOKUSUMAN, KOTA YOGYAKARTA, DAERAH ISTIMEWA YOGYAKARTA",20,136,65,201
https://kawalpemilu.org#42336,"DEMANGAN, GONDOKUSUMAN, KOTA YOGYAKARTA, DAERAH ISTIMEWA YOGYAKARTA",21,114,82,196
https://kawalpemilu.org#42336,"DEMANGAN, GONDOKUSUMAN, KOTA YOGYAKARTA, DAERAH ISTIMEWA YOGYAKARTA",22,119,90,209
https://kawalpemilu.org#42336,"DEMANGAN, GONDOKUSUMAN, KOTA YOGYAKARTA, DAERAH ISTIMEWA YOGYAKARTA",23,118,70,188
https://kawalpemilu.org#42336,"DEMANGAN, GONDOKUSUMAN, KOTA YOGYAKARTA, DAERAH ISTIMEWA YOGYAKARTA",24,130,57,187
https://kawalpemilu.org#42336,"DEMANGAN, GONDOKUSUMAN, KOTA YOGYAKARTA, DAERAH ISTIMEWA YOGYAKARTA",25,106,93,199
https://kawalpemilu.org#42336,"DEMANGAN, GONDOKUSUMAN, KOTA YOGYAKARTA, DAERAH ISTIMEWA YOGYAKARTA",26,176,65,241
https://kawalpemilu.org#42336,"DEMANGAN, GONDOKUSUMAN, KOTA YOGYAKARTA, DAERAH ISTIMEWA YOGYAKARTA",28,182,68,250
https://kawalpemilu.org#42337,"KOTABARU, GONDOKUSUMAN, KOTA YOGYAKARTA, DAERAH ISTIMEWA YOGYAKARTA",1,176,40,216
https://kawalpemilu.org#42337,"KOTABARU, GONDOKUSUMAN, KOTA YOGYAKARTA, DAERAH ISTIMEWA YOGYAKARTA",2,139,36,175
https://kawalpemilu.org#42337,"KOTABARU, GONDOKUSUMAN, KOTA YOGYAKARTA, DAERAH ISTIMEWA YOGYAKARTA",3,167,44,211
https://kawalpemilu.org#42337,"KOTABARU, GONDOKUSUMAN, KOTA YOGYAKARTA, DAERAH ISTIMEWA YOGYAKARTA",4,66,163,229
https://kawalpemilu.org#42337,"KOTABARU, GONDOKUSUMAN, KOTA YOGYAKARTA, DAERAH ISTIMEWA YOGYAKARTA",5,96,137,233
https://kawalpemilu.org#42337,"KOTABARU, GONDOKUSUMAN, KOTA YOGYAKARTA, DAERAH ISTIMEWA YOGYAKARTA",6,191,59,250
https://kawalpemilu.org#42337,"KOTABARU, GONDOKUSUMAN, KOTA YOGYAKARTA, DAERAH ISTIMEWA YOGYAKARTA",7,193,33,226
https://kawalpemilu.org#42337,"KOTABARU, GONDOKUSUMAN, KOTA YOGYAKARTA, DAERAH ISTIMEWA YOGYAKARTA",8,150,81,231
https://kawalpemilu.org#42338,"KLITREN, GONDOKUSUMAN, KOTA YOGYAKARTA, DAERAH ISTIMEWA YOGYAKARTA",1,176,80,256
https://kawalpemilu.org#42338,"KLITREN, GONDOKUSUMAN, KOTA YOGYAKARTA, DAERAH ISTIMEWA YOGYAKARTA",2,183,65,248
https://kawalpemilu.org#42338,"KLITREN, GONDOKUSUMAN, KOTA YOGYAKARTA, DAERAH ISTIMEWA YOGYAKARTA",3,119,53,172
https://kawalpemilu.org#42338,"KLITREN, GONDOKUSUMAN, KOTA YOGYAKARTA, DAERAH ISTIMEWA YOGYAKARTA",4,128,47,175
https://kawalpemilu.org#42338,"KLITREN, GONDOKUSUMAN, KOTA YOGYAKARTA, DAERAH ISTIMEWA YOGYAKARTA",5,171,62,233
https://kawalpemilu.org#42338,"KLITREN, GONDOKUSUMAN, KOTA YOGYAKARTA, DAERAH ISTIMEWA YOGYAKARTA",6,192,78,3
https://kawalpemilu.org#42338,"KLITREN, GONDOKUSUMAN, KOTA YOGYAKARTA, DAERAH ISTIMEWA YOGYAKARTA",7,165,61,226
https://kawalpemilu.org#42338,"KLITREN, GONDOKUSUMAN, KOTA YOGYAKARTA, DAERAH ISTIMEWA YOGYAKARTA",8,148,46,194
https://kawalpemilu.org#42338,"KLITREN, GONDOKUSUMAN, KOTA YOGYAKARTA, DAERAH ISTIMEWA YOGYAKARTA",9,162,56,218
https://kawalpemilu.org#42338,"KLITREN, GONDOKUSUMAN, KOTA YOGYAKARTA, DAERAH ISTIMEWA YOGYAKARTA",10,188,42,230
https://kawalpemilu.org#42338,"KLITREN, GONDOKUSUMAN, KOTA YOGYAKARTA, DAERAH ISTIMEWA YOGYAKARTA",11,175,25,200
https://kawalpemilu.org#42338,"KLITREN, GONDOKUSUMAN, KOTA YOGYAKARTA, DAERAH ISTIMEWA YOGYAKARTA",12,164,19,183
https://kawalpemilu.org#42338,"KLITREN, GONDOKUSUMAN, KOTA YOGYAKARTA, DAERAH ISTIMEWA YOGYAKARTA",13,200,53,253
https://kawalpemilu.org#42338,"KLITREN, GONDOKUSUMAN, KOTA YOGYAKARTA, DAERAH ISTIMEWA YOGYAKARTA",14,143,15,158
https://kawalpemilu.org#42338,"KLITREN, GONDOKUSUMAN, KOTA YOGYAKARTA, DAERAH ISTIMEWA YOGYAKARTA",15,141,56,197
https://kawalpemilu.org#42338,"KLITREN, GONDOKUSUMAN, KOTA YOGYAKARTA, DAERAH ISTIMEWA YOGYAKARTA",16,135,23,158
https://kawalpemilu.org#42338,"KLITREN, GONDOKUSUMAN, KOTA YOGYAKARTA, DAERAH ISTIMEWA YOGYAKARTA",17,142,34,176
https://kawalpemilu.org#42338,"KLITREN, GONDOKUSUMAN, KOTA YOGYAKARTA, DAERAH ISTIMEWA YOGYAKARTA",18,102,46,148
https://kawalpemilu.org#42338,"KLITREN, GONDOKUSUMAN, KOTA YOGYAKARTA, DAERAH ISTIMEWA YOGYAKARTA",19,81,58,139
https://kawalpemilu.org#42338,"KLITREN, GONDOKUSUMAN, KOTA YOGYAKARTA, DAERAH ISTIMEWA YOGYAKARTA",20,92,23,115
https://kawalpemilu.org#42338,"KLITREN, GONDOKUSUMAN, KOTA YOGYAKARTA, DAERAH ISTIMEWA YOGYAKARTA",21,139,50,189
https://kawalpemilu.org#42338,"KLITREN, GONDOKUSUMAN, KOTA YOGYAKARTA, DAERAH ISTIMEWA YOGYAKARTA",22,183,23,206
https://kawalpemilu.org#42338,"KLITREN, GONDOKUSUMAN, KOTA YOGYAKARTA, DAERAH ISTIMEWA YOGYAKARTA",23,144,55,199
https://kawalpemilu.org#42338,"KLITREN, GONDOKUSUMAN, KOTA YOGYAKARTA, DAERAH ISTIMEWA YOGYAKARTA",24,129,32,161
https://kawalpemilu.org#42338,"KLITREN, GONDOKUSUMAN, KOTA YOGYAKARTA, DAERAH ISTIMEWA YOGYAKARTA",25,122,37,159
https://kawalpemilu.org#42338,"KLITREN, GONDOKUSUMAN, KOTA YOGYAKARTA, DAERAH ISTIMEWA YOGYAKARTA",26,194,35,229
https://kawalpemilu.org#42338,"KLITREN, GONDOKUSUMAN, KOTA YOGYAKARTA, DAERAH ISTIMEWA YOGYAKARTA",27,189,42,231
https://kawalpemilu.org#42338,"KLITREN, GONDOKUSUMAN, KOTA YOGYAKARTA, DAERAH ISTIMEWA YOGYAKARTA",28,124,82,206
https://kawalpemilu.org#42338,"KLITREN, GONDOKUSUMAN, KOTA YOGYAKARTA, DAERAH ISTIMEWA YOGYAKARTA",29,152,67,219
https://kawalpemilu.org#42338,"KLITREN, GONDOKUSUMAN, KOTA YOGYAKARTA, DAERAH ISTIMEWA YOGYAKARTA",30,99,56,155
https://kawalpemilu.org#42338,"KLITREN, GONDOKUSUMAN, KOTA YOGYAKARTA, DAERAH ISTIMEWA YOGYAKARTA",31,104,70,174
https://kawalpemilu.org#42338,"KLITREN, GONDOKUSUMAN, KOTA YOGYAKARTA, DAERAH ISTIMEWA YOGYAKARTA",32,85,62,147
https://kawalpemilu.org#42338,"KLITREN, GONDOKUSUMAN, KOTA YOGYAKARTA, DAERAH ISTIMEWA YOGYAKARTA",33,119,29,148
https://kawalpemilu.org#42339,"BACIRO, GONDOKUSUMAN, KOTA YOGYAKARTA, DAERAH ISTIMEWA YOGYAKARTA",1,113,48,161
https://kawalpemilu.org#42339,"BACIRO, GONDOKUSUMAN, KOTA YOGYAKARTA, DAERAH ISTIMEWA YOGYAKARTA",2,112,33,145
https://kawalpemilu.org#42339,"BACIRO, GONDOKUSUMAN, KOTA YOGYAKARTA, DAERAH ISTIMEWA YOGYAKARTA",3,179,60,239
https://kawalpemilu.org#42339,"BACIRO, GONDOKUSUMAN, KOTA YOGYAKARTA, DAERAH ISTIMEWA YOGYAKARTA",5,152,66,218
https://kawalpemilu.org#42339,"BACIRO, GONDOKUSUMAN, KOTA YOGYAKARTA, DAERAH ISTIMEWA YOGYAKARTA",6,120,57,177
https://kawalpemilu.org#42339,"BACIRO, GONDOKUSUMAN, KOTA YOGYAKARTA, DAERAH ISTIMEWA YOGYAKARTA",7,126,78,204
https://kawalpemilu.org#42339,"BACIRO, GONDOKUSUMAN, KOTA YOGYAKARTA, DAERAH ISTIMEWA YOGYAKARTA",8,165,33,198
https://kawalpemilu.org#42339,"BACIRO, GONDOKUSUMAN, KOTA YOGYAKARTA, DAERAH ISTIMEWA YOGYAKARTA",9,112,38,150
https://kawalpemilu.org#42339,"BACIRO, GONDOKUSUMAN, KOTA YOGYAKARTA, DAERAH ISTIMEWA YOGYAKARTA",10,152,61,213
https://kawalpemilu.org#42339,"BACIRO, GONDOKUSUMAN, KOTA YOGYAKARTA, DAERAH ISTIMEWA YOGYAKARTA",11,122,69,191
https://kawalpemilu.org#42339,"BACIRO, GONDOKUSUMAN, KOTA YOGYAKARTA, DAERAH ISTIMEWA YOGYAKARTA",12,132,65,197
https://kawalpemilu.org#42339,"BACIRO, GONDOKUSUMAN, KOTA YOGYAKARTA, DAERAH ISTIMEWA YOGYAKARTA",13,160,35,195
https://kawalpemilu.org#42339,"BACIRO, GONDOKUSUMAN, KOTA YOGYAKARTA, DAERAH ISTIMEWA YOGYAKARTA",14,150,92,242
https://kawalpemilu.org#42339,"BACIRO, GONDOKUSUMAN, KOTA YOGYAKARTA, DAERAH ISTIMEWA YOGYAKARTA",15,158,52,210
https://kawalpemilu.org#42339,"BACIRO, GONDOKUSUMAN, KOTA YOGYAKARTA, DAERAH ISTIMEWA YOGYAKARTA",16,155,72,227
https://kawalpemilu.org#42339,"BACIRO, GONDOKUSUMAN, KOTA YOGYAKARTA, DAERAH ISTIMEWA YOGYAKARTA",17,66,38,104
https://kawalpemilu.org#42339,"BACIRO, GONDOKUSUMAN, KOTA YOGYAKARTA, DAERAH ISTIMEWA YOGYAKARTA",18,87,68,155
https://kawalpemilu.org#42339,"BACIRO, GONDOKUSUMAN, KOTA YOGYAKARTA, DAERAH ISTIMEWA YOGYAKARTA",19,82,71,153
https://kawalpemilu.org#42339,"BACIRO, GONDOKUSUMAN, KOTA YOGYAKARTA, DAERAH ISTIMEWA YOGYAKARTA",20,103,48,151
https://kawalpemilu.org#42339,"BACIRO, GONDOKUSUMAN, KOTA YOGYAKARTA, DAERAH ISTIMEWA YOGYAKARTA",21,82,61,143
https://kawalpemilu.org#42339,"BACIRO, GONDOKUSUMAN, KOTA YOGYAKARTA, DAERAH ISTIMEWA YOGYAKARTA",22,124,37,161
https://kawalpemilu.org#42339,"BACIRO, GONDOKUSUMAN, KOTA YOGYAKARTA, DAERAH ISTIMEWA YOGYAKARTA",23,109,49,158
https://kawalpemilu.org#42339,"BACIRO, GONDOKUSUMAN, KOTA YOGYAKARTA, DAERAH ISTIMEWA YOGYAKARTA",24,126,46,172
https://kawalpemilu.org#42339,"BACIRO, GONDOKUSUMAN, KOTA YOGYAKARTA, DAERAH ISTIMEWA YOGYAKARTA",25,140,31,171
https://kawalpemilu.org#42339,"BACIRO, GONDOKUSUMAN, KOTA YOGYAKARTA, DAERAH ISTIMEWA YOGYAKARTA",26,199,49,248
https://kawalpemilu.org#42339,"BACIRO, GONDOKUSUMAN, KOTA YOGYAKARTA, DAERAH ISTIMEWA YOGYAKARTA",27,165,75,240
https://kawalpemilu.org#42339,"BACIRO, GONDOKUSUMAN, KOTA YOGYAKARTA, DAERAH ISTIMEWA YOGYAKARTA",28,157,55,212
https://kawalpemilu.org#42339,"BACIRO, GONDOKUSUMAN, KOTA YOGYAKARTA, DAERAH ISTIMEWA YOGYAKARTA",29,166,53,219
https://kawalpemilu.org#42339,"BACIRO, GONDOKUSUMAN, KOTA YOGYAKARTA, DAERAH ISTIMEWA YOGYAKARTA",30,192,51,243
https://kawalpemilu.org#42339,"BACIRO, GONDOKUSUMAN, KOTA YOGYAKARTA, DAERAH ISTIMEWA YOGYAKARTA",31,198,61,259
https://kawalpemilu.org#42339,"BACIRO, GONDOKUSUMAN, KOTA YOGYAKARTA, DAERAH ISTIMEWA YOGYAKARTA",32,157,92,249
https://kawalpemilu.org#42339,"BACIRO, GONDOKUSUMAN, KOTA YOGYAKARTA, DAERAH ISTIMEWA YOGYAKARTA",33,113,85,198
https://kawalpemilu.org#42339,"BACIRO, GONDOKUSUMAN, KOTA YOGYAKARTA, DAERAH ISTIMEWA YOGYAKARTA",34,176,65,241
https://kawalpemilu.org#42339,"BACIRO, GONDOKUSUMAN, KOTA YOGYAKARTA, DAERAH ISTIMEWA YOGYAKARTA",35,69,77,146
https://kawalpemilu.org#42339,"BACIRO, GONDOKUSUMAN, KOTA YOGYAKARTA, DAERAH ISTIMEWA YOGYAKARTA",36,136,54,190
https://kawalpemilu.org#42339,"BACIRO, GONDOKUSUMAN, KOTA YOGYAKARTA, DAERAH ISTIMEWA YOGYAKARTA",37,147,60,207
https://kawalpemilu.org#42339,"BACIRO, GONDOKUSUMAN, KOTA YOGYAKARTA, DAERAH ISTIMEWA YOGYAKARTA",38,160,40,200
https://kawalpemilu.org#42339,"BACIRO, GONDOKUSUMAN, KOTA YOGYAKARTA, DAERAH ISTIMEWA YOGYAKARTA",39,149,47,196
https://kawalpemilu.org#42339,"BACIRO, GONDOKUSUMAN, KOTA YOGYAKARTA, DAERAH ISTIMEWA YOGYAKARTA",40,124,60,184
https://kawalpemilu.org#42339,"BACIRO, GONDOKUSUMAN, KOTA YOGYAKARTA, DAERAH ISTIMEWA YOGYAKARTA",41,161,56,217
https://kawalpemilu.org#42340,"TERBAN, GONDOKUSUMAN, KOTA YOGYAKARTA, DAERAH ISTIMEWA YOGYAKARTA",1,104,73,177
https://kawalpemilu.org#42340,"TERBAN, GONDOKUSUMAN, KOTA YOGYAKARTA, DAERAH ISTIMEWA YOGYAKARTA",2,117,60,177
https://kawalpemilu.org#42340,"TERBAN, GONDOKUSUMAN, KOTA YOGYAKARTA, DAERAH ISTIMEWA YOGYAKARTA",3,132,76,208
https://kawalpemilu.org#42340,"TERBAN, GONDOKUSUMAN, KOTA YOGYAKARTA, DAERAH ISTIMEWA YOGYAKARTA",4,210,34,244
https://kawalpemilu.org#42340,"TERBAN, GONDOKUSUMAN, KOTA YOGYAKARTA, DAERAH ISTIMEWA YOGYAKARTA",5,159,55,214
https://kawalpemilu.org#42340,"TERBAN, GONDOKUSUMAN, KOTA YOGYAKARTA, DAERAH ISTIMEWA YOGYAKARTA",6,151,29,180
https://kawalpemilu.org#42340,"TERBAN, GONDOKUSUMAN, KOTA YOGYAKARTA, DAERAH ISTIMEWA YOGYAKARTA",7,130,81,211
https://kawalpemilu.org#42340,"TERBAN, GONDOKUSUMAN, KOTA YOGYAKARTA, DAERAH ISTIMEWA YOGYAKARTA",8,190,43,233
https://kawalpemilu.org#42340,"TERBAN, GONDOKUSUMAN, KOTA YOGYAKARTA, DAERAH ISTIMEWA YOGYAKARTA",9,119,46,165
https://kawalpemilu.org#42340,"TERBAN, GONDOKUSUMAN, KOTA YOGYAKARTA, DAERAH ISTIMEWA YOGYAKARTA",10,151,55,206
https://kawalpemilu.org#42340,"TERBAN, GONDOKUSUMAN, KOTA YOGYAKARTA, DAERAH ISTIMEWA YOGYAKARTA",11,175,61,236
https://kawalpemilu.org#42340,"TERBAN, GONDOKUSUMAN, KOTA YOGYAKARTA, DAERAH ISTIMEWA YOGYAKARTA",12,175,70,245
https://kawalpemilu.org#42340,"TERBAN, GONDOKUSUMAN, KOTA YOGYAKARTA, DAERAH ISTIMEWA YOGYAKARTA",13,208,60,268
https://kawalpemilu.org#42340,"TERBAN, GONDOKUSUMAN, KOTA YOGYAKARTA, DAERAH ISTIMEWA YOGYAKARTA",14,154,72,226
https://kawalpemilu.org#42340,"TERBAN, GONDOKUSUMAN, KOTA YOGYAKARTA, DAERAH ISTIMEWA YOGYAKARTA",15,116,50,166
https://kawalpemilu.org#42340,"TERBAN, GONDOKUSUMAN, KOTA YOGYAKARTA, DAERAH ISTIMEWA YOGYAKARTA",16,175,53,228
https://kawalpemilu.org#42340,"TERBAN, GONDOKUSUMAN, KOTA YOGYAKARTA, DAERAH ISTIMEWA YOGYAKARTA",17,237,16,253
https://kawalpemilu.org#42340,"TERBAN, GONDOKUSUMAN, KOTA YOGYAKARTA, DAERAH ISTIMEWA YOGYAKARTA",18,185,42,227
https://kawalpemilu.org#42340,"TERBAN, GONDOKUSUMAN, KOTA YOGYAKARTA, DAERAH ISTIMEWA YOGYAKARTA",19,217,30,247
https://kawalpemilu.org#42340,"TERBAN, GONDOKUSUMAN, KOTA YOGYAKARTA, DAERAH ISTIMEWA YOGYAKARTA",20,191,47,238
https://kawalpemilu.org#42340,"TERBAN, GONDOKUSUMAN, KOTA YOGYAKARTA, DAERAH ISTIMEWA YOGYAKARTA",21,166,51,217
https://kawalpemilu.org#42340,"TERBAN, GONDOKUSUMAN, KOTA YOGYAKARTA, DAERAH ISTIMEWA YOGYAKARTA",22,157,57,214
https://kawalpemilu.org#42340,"TERBAN, GONDOKUSUMAN, KOTA YOGYAKARTA, DAERAH ISTIMEWA YOGYAKARTA",23,162,41,203
https://kawalpemilu.org#42340,"TERBAN, GONDOKUSUMAN, KOTA YOGYAKARTA, DAERAH ISTIMEWA YOGYAKARTA",24,158,29,187
https://kawalpemilu.org#42340,"TERBAN, GONDOKUSUMAN, KOTA YOGYAKARTA, DAERAH ISTIMEWA YOGYAKARTA",25,188,20,208
https://kawalpemilu.org#42340,"TERBAN, GONDOKUSUMAN, KOTA YOGYAKARTA, DAERAH ISTIMEWA YOGYAKARTA",26,199,52,251
https://kawalpemilu.org#42340,"TERBAN, GONDOKUSUMAN, KOTA YOGYAKARTA, DAERAH ISTIMEWA YOGYAKARTA",27,158,58,216
https://kawalpemilu.org#42340,"TERBAN, GONDOKUSUMAN, KOTA YOGYAKARTA, DAERAH ISTIMEWA YOGYAKARTA",28,152,54,206
https://kawalpemilu.org#42342,"SURYATMAJAN, DANUREJAN, KOTA YOGYAKARTA, DAERAH ISTIMEWA YOGYAKARTA",1,184,34,218
https://kawalpemilu.org#42342,"SURYATMAJAN, DANUREJAN, KOTA YOGYAKARTA, DAERAH ISTIMEWA YOGYAKARTA",2,151,46,197
https://kawalpemilu.org#42342,"SURYATMAJAN, DANUREJAN, KOTA YOGYAKARTA, DAERAH ISTIMEWA YOGYAKARTA",3,130,50,180
https://kawalpemilu.org#42342,"SURYATMAJAN, DANUREJAN, KOTA YOGYAKARTA, DAERAH ISTIMEWA YOGYAKARTA",4,109,105,214
https://kawalpemilu.org#42342,"SURYATMAJAN, DANUREJAN, KOTA YOGYAKARTA, DAERAH ISTIMEWA YOGYAKARTA",5,122,56,178
https://kawalpemilu.org#42342,"SURYATMAJAN, DANUREJAN, KOTA YOGYAKARTA, DAERAH ISTIMEWA YOGYAKARTA",6,170,30,200
https://kawalpemilu.org#42342,"SURYATMAJAN, DANUREJAN, KOTA YOGYAKARTA, DAERAH ISTIMEWA YOGYAKARTA",7,98,20,118
https://kawalpemilu.org#42342,"SURYATMAJAN, DANUREJAN, KOTA YOGYAKARTA, DAERAH ISTIMEWA YOGYAKARTA",8,160,72,232
https://kawalpemilu.org#42342,"SURYATMAJAN, DANUREJAN, KOTA YOGYAKARTA, DAERAH ISTIMEWA YOGYAKARTA",9,180,63,243
https://kawalpemilu.org#42342,"SURYATMAJAN, DANUREJAN, KOTA YOGYAKARTA, DAERAH ISTIMEWA YOGYAKARTA",10,97,94,191
https://kawalpemilu.org#42342,"SURYATMAJAN, DANUREJAN, KOTA YOGYAKARTA, DAERAH ISTIMEWA YOGYAKARTA",11,114,58,172
https://kawalpemilu.org#42342,"SURYATMAJAN, DANUREJAN, KOTA YOGYAKARTA, DAERAH ISTIMEWA YOGYAKARTA",12,92,36,128
https://kawalpemilu.org#42342,"SURYATMAJAN, DANUREJAN, KOTA YOGYAKARTA, DAERAH ISTIMEWA YOGYAKARTA",13,180,39,219
https://kawalpemilu.org#42342,"SURYATMAJAN, DANUREJAN, KOTA YOGYAKARTA, DAERAH ISTIMEWA YOGYAKARTA",14,170,67,237
https://kawalpemilu.org#42342,"SURYATMAJAN, DANUREJAN, KOTA YOGYAKARTA, DAERAH ISTIMEWA YOGYAKARTA",15,176,31,207
https://kawalpemilu.org#42342,"SURYATMAJAN, DANUREJAN, KOTA YOGYAKARTA, DAERAH ISTIMEWA YOGYAKARTA",16,140,33,173
https://kawalpemilu.org#42343,"TEGALPANGGUNG, DANUREJAN, KOTA YOGYAKARTA, DAERAH ISTIMEWA YOGYAKARTA",1,110,62,172
https://kawalpemilu.org#42343,"TEGALPANGGUNG, DANUREJAN, KOTA YOGYAKARTA, DAERAH ISTIMEWA YOGYAKARTA",2,141,88,229
https://kawalpemilu.org#42343,"TEGALPANGGUNG, DANUREJAN, KOTA YOGYAKARTA, DAERAH ISTIMEWA YOGYAKARTA",3,138,102,240
https://kawalpemilu.org#42343,"TEGALPANGGUNG, DANUREJAN, KOTA YOGYAKARTA, DAERAH ISTIMEWA YOGYAKARTA",4,141,101,242
https://kawalpemilu.org#42343,"TEGALPANGGUNG, DANUREJAN, KOTA YOGYAKARTA, DAERAH ISTIMEWA YOGYAKARTA",5,172,52,224
https://kawalpemilu.org#42343,"TEGALPANGGUNG, DANUREJAN, KOTA YOGYAKARTA, DAERAH ISTIMEWA YOGYAKARTA",6,226,38,264
https://kawalpemilu.org#42343,"TEGALPANGGUNG, DANUREJAN, KOTA YOGYAKARTA, DAERAH ISTIMEWA YOGYAKARTA",7,173,60,233
https://kawalpemilu.org#42343,"TEGALPANGGUNG, DANUREJAN, KOTA YOGYAKARTA, DAERAH ISTIMEWA YOGYAKARTA",8,207,50,257
https://kawalpemilu.org#42343,"TEGALPANGGUNG, DANUREJAN, KOTA YOGYAKARTA, DAERAH ISTIMEWA YOGYAKARTA",9,130,38,168
https://kawalpemilu.org#42343,"TEGALPANGGUNG, DANUREJAN, KOTA YOGYAKARTA, DAERAH ISTIMEWA YOGYAKARTA",10,184,64,248
https://kawalpemilu.org#42343,"TEGALPANGGUNG, DANUREJAN, KOTA YOGYAKARTA, DAERAH ISTIMEWA YOGYAKARTA",11,156,78,234
https://kawalpemilu.org#42343,"TEGALPANGGUNG, DANUREJAN, KOTA YOGYAKARTA, DAERAH ISTIMEWA YOGYAKARTA",12,194,43,237
https://kawalpemilu.org#42343,"TEGALPANGGUNG, DANUREJAN, KOTA YOGYAKARTA, DAERAH ISTIMEWA YOGYAKARTA",13,211,54,265
https://kawalpemilu.org#42343,"TEGALPANGGUNG, DANUREJAN, KOTA YOGYAKARTA, DAERAH ISTIMEWA YOGYAKARTA",14,202,35,237
https://kawalpemilu.org#42343,"TEGALPANGGUNG, DANUREJAN, KOTA YOGYAKARTA, DAERAH ISTIMEWA YOGYAKARTA",15,187,62,249
https://kawalpemilu.org#42343,"TEGALPANGGUNG, DANUREJAN, KOTA YOGYAKARTA, DAERAH ISTIMEWA YOGYAKARTA",16,182,152,234
https://kawalpemilu.org#42343,"TEGALPANGGUNG, DANUREJAN, KOTA YOGYAKARTA, DAERAH ISTIMEWA YOGYAKARTA",17,193,67,260
https://kawalpemilu.org#42343,"TEGALPANGGUNG, DANUREJAN, KOTA YOGYAKARTA, DAERAH ISTIMEWA YOGYAKARTA",18,151,80,231
https://kawalpemilu.org#42343,"TEGALPANGGUNG, DANUREJAN, KOTA YOGYAKARTA, DAERAH ISTIMEWA YOGYAKARTA",19,152,91,243
https://kawalpemilu.org#42343,"TEGALPANGGUNG, DANUREJAN, KOTA YOGYAKARTA, DAERAH ISTIMEWA YOGYAKARTA",20,116,38,154
https://kawalpemilu.org#42343,"TEGALPANGGUNG, DANUREJAN, KOTA YOGYAKARTA, DAERAH ISTIMEWA YOGYAKARTA",21,139,48,187
https://kawalpemilu.org#42343,"TEGALPANGGUNG, DANUREJAN, KOTA YOGYAKARTA, DAERAH ISTIMEWA YOGYAKARTA",22,175,40,215
https://kawalpemilu.org#42343,"TEGALPANGGUNG, DANUREJAN, KOTA YOGYAKARTA, DAERAH ISTIMEWA YOGYAKARTA",23,130,56,186
https://kawalpemilu.org#42343,"TEGALPANGGUNG, DANUREJAN, KOTA YOGYAKARTA, DAERAH ISTIMEWA YOGYAKARTA",24,139,30,169
https://kawalpemilu.org#42343,"TEGALPANGGUNG, DANUREJAN, KOTA YOGYAKARTA, DAERAH ISTIMEWA YOGYAKARTA",25,190,32,222
https://kawalpemilu.org#42343,"TEGALPANGGUNG, DANUREJAN, KOTA YOGYAKARTA, DAERAH ISTIMEWA YOGYAKARTA",26,152,39,191
https://kawalpemilu.org#42343,"TEGALPANGGUNG, DANUREJAN, KOTA YOGYAKARTA, DAERAH ISTIMEWA YOGYAKARTA",27,147,49,196
https://kawalpemilu.org#42344,"BAUSASRAN, DANUREJAN, KOTA YOGYAKARTA, DAERAH ISTIMEWA YOGYAKARTA",1,150,59,209
https://kawalpemilu.org#42344,"BAUSASRAN, DANUREJAN, KOTA YOGYAKARTA, DAERAH ISTIMEWA YOGYAKARTA",2,151,51,202
https://kawalpemilu.org#42344,"BAUSASRAN, DANUREJAN, KOTA YOGYAKARTA, DAERAH ISTIMEWA YOGYAKARTA",3,119,68,187
https://kawalpemilu.org#42344,"BAUSASRAN, DANUREJAN, KOTA YOGYAKARTA, DAERAH ISTIMEWA YOGYAKARTA",4,0,0,0
https://kawalpemilu.org#42344,"BAUSASRAN, DANUREJAN, KOTA YOGYAKARTA, DAERAH ISTIMEWA YOGYAKARTA",5,145,81,226
https://kawalpemilu.org#42344,"BAUSASRAN, DANUREJAN, KOTA YOGYAKARTA, DAERAH ISTIMEWA YOGYAKARTA",6,112,112,224
https://kawalpemilu.org#42344,"BAUSASRAN, DANUREJAN, KOTA YOGYAKARTA, DAERAH ISTIMEWA YOGYAKARTA",7,82,70,152
https://kawalpemilu.org#42344,"BAUSASRAN, DANUREJAN, KOTA YOGYAKARTA, DAERAH ISTIMEWA YOGYAKARTA",8,105,86,191
https://kawalpemilu.org#42344,"BAUSASRAN, DANUREJAN, KOTA YOGYAKARTA, DAERAH ISTIMEWA YOGYAKARTA",9,88,150,238
https://kawalpemilu.org#42344,"BAUSASRAN, DANUREJAN, KOTA YOGYAKARTA, DAERAH ISTIMEWA YOGYAKARTA",10,102,139,241
https://kawalpemilu.org#42344,"BAUSASRAN, DANUREJAN, KOTA YOGYAKARTA, DAERAH ISTIMEWA YOGYAKARTA",11,85,81,166
https://kawalpemilu.org#42344,"BAUSASRAN, DANUREJAN, KOTA YOGYAKARTA, DAERAH ISTIMEWA YOGYAKARTA",12,91,95,186
https://kawalpemilu.org#42344,"BAUSASRAN, DANUREJAN, KOTA YOGYAKARTA, DAERAH ISTIMEWA YOGYAKARTA",13,104,85,189
https://kawalpemilu.org#42344,"BAUSASRAN, DANUREJAN, KOTA YOGYAKARTA, DAERAH ISTIMEWA YOGYAKARTA",14,136,55,191
https://kawalpemilu.org#42344,"BAUSASRAN, DANUREJAN, KOTA YOGYAKARTA, DAERAH ISTIMEWA YOGYAKARTA",15,176,50,226
https://kawalpemilu.org#42344,"BAUSASRAN, DANUREJAN, KOTA YOGYAKARTA, DAERAH ISTIMEWA YOGYAKARTA",16,117,67,184
https://kawalpemilu.org#42344,"BAUSASRAN, DANUREJAN, KOTA YOGYAKARTA, DAERAH ISTIMEWA YOGYAKARTA",17,184,71,255
https://kawalpemilu.org#42344,"BAUSASRAN, DANUREJAN, KOTA YOGYAKARTA, DAERAH ISTIMEWA YOGYAKARTA",18,170,49,219
https://kawalpemilu.org#42344,"BAUSASRAN, DANUREJAN, KOTA YOGYAKARTA, DAERAH ISTIMEWA YOGYAKARTA",19,165,70,235
https://kawalpemilu.org#42344,"BAUSASRAN, DANUREJAN, KOTA YOGYAKARTA, DAERAH ISTIMEWA YOGYAKARTA",20,165,40,205
https://kawalpemilu.org#42344,"BAUSASRAN, DANUREJAN, KOTA YOGYAKARTA, DAERAH ISTIMEWA YOGYAKARTA",21,177,56,233
https://kawalpemilu.org#42344,"BAUSASRAN, DANUREJAN, KOTA YOGYAKARTA, DAERAH ISTIMEWA YOGYAKARTA",22,140,47,187
https://kawalpemilu.org#42344,"BAUSASRAN, DANUREJAN, KOTA YOGYAKARTA, DAERAH ISTIMEWA YOGYAKARTA",23,149,34,183
https://kawalpemilu.org#42346,"SOSROMENDURAN, GEDONGTENGEN, KOTA YOGYAKARTA, DAERAH ISTIMEWA YOGYAKARTA",1,163,71,234
https://kawalpemilu.org#42346,"SOSROMENDURAN, GEDONGTENGEN, KOTA YOGYAKARTA, DAERAH ISTIMEWA YOGYAKARTA",2,67,14,81
https://kawalpemilu.org#42346,"SOSROMENDURAN, GEDONGTENGEN, KOTA YOGYAKARTA, DAERAH ISTIMEWA YOGYAKARTA",3,144,66,210
https://kawalpemilu.org#42346,"SOSROMENDURAN, GEDONGTENGEN, KOTA YOGYAKARTA, DAERAH ISTIMEWA YOGYAKARTA",4,144,37,181
https://kawalpemilu.org#42346,"SOSROMENDURAN, GEDONGTENGEN, KOTA YOGYAKARTA, DAERAH ISTIMEWA YOGYAKARTA",5,187,41,228
https://kawalpemilu.org#42346,"SOSROMENDURAN, GEDONGTENGEN, KOTA YOGYAKARTA, DAERAH ISTIMEWA YOGYAKARTA",6,174,56,230
https://kawalpemilu.org#42346,"SOSROMENDURAN, GEDONGTENGEN, KOTA YOGYAKARTA, DAERAH ISTIMEWA YOGYAKARTA",7,110,23,133
https://kawalpemilu.org#42346,"SOSROMENDURAN, GEDONGTENGEN, KOTA YOGYAKARTA, DAERAH ISTIMEWA YOGYAKARTA",8,119,18,137
https://kawalpemilu.org#42346,"SOSROMENDURAN, GEDONGTENGEN, KOTA YOGYAKARTA, DAERAH ISTIMEWA YOGYAKARTA",9,74,47,121
https://kawalpemilu.org#42346,"SOSROMENDURAN, GEDONGTENGEN, KOTA YOGYAKARTA, DAERAH ISTIMEWA YOGYAKARTA",10,73,64,137
https://kawalpemilu.org#42346,"SOSROMENDURAN, GEDONGTENGEN, KOTA YOGYAKARTA, DAERAH ISTIMEWA YOGYAKARTA",11,112,27,139
https://kawalpemilu.org#42346,"SOSROMENDURAN, GEDONGTENGEN, KOTA YOGYAKARTA, DAERAH ISTIMEWA YOGYAKARTA",12,61,49,110
https://kawalpemilu.org#42346,"SOSROMENDURAN, GEDONGTENGEN, KOTA YOGYAKARTA, DAERAH ISTIMEWA YOGYAKARTA",13,153,71,224
https://kawalpemilu.org#42346,"SOSROMENDURAN, GEDONGTENGEN, KOTA YOGYAKARTA, DAERAH ISTIMEWA YOGYAKARTA",14,113,30,143
https://kawalpemilu.org#42346,"SOSROMENDURAN, GEDONGTENGEN, KOTA YOGYAKARTA, DAERAH ISTIMEWA YOGYAKARTA",15,103,46,149
https://kawalpemilu.org#42346,"SOSROMENDURAN, GEDONGTENGEN, KOTA YOGYAKARTA, DAERAH ISTIMEWA YOGYAKARTA",16,161,70,231
https://kawalpemilu.org#42346,"SOSROMENDURAN, GEDONGTENGEN, KOTA YOGYAKARTA, DAERAH ISTIMEWA YOGYAKARTA",17,143,14,157
https://kawalpemilu.org#42346,"SOSROMENDURAN, GEDONGTENGEN, KOTA YOGYAKARTA, DAERAH ISTIMEWA YOGYAKARTA",18,139,10,149
https://kawalpemilu.org#42346,"SOSROMENDURAN, GEDONGTENGEN, KOTA YOGYAKARTA, DAERAH ISTIMEWA YOGYAKARTA",19,124,6,130
https://kawalpemilu.org#42346,"SOSROMENDURAN, GEDONGTENGEN, KOTA YOGYAKARTA, DAERAH ISTIMEWA YOGYAKARTA",20,121,26,147
https://kawalpemilu.org#42346,"SOSROMENDURAN, GEDONGTENGEN, KOTA YOGYAKARTA, DAERAH ISTIMEWA YOGYAKARTA",21,117,29,146
https://kawalpemilu.org#42346,"SOSROMENDURAN, GEDONGTENGEN, KOTA YOGYAKARTA, DAERAH ISTIMEWA YOGYAKARTA",22,141,45,186
https://kawalpemilu.org#42346,"SOSROMENDURAN, GEDONGTENGEN, KOTA YOGYAKARTA, DAERAH ISTIMEWA YOGYAKARTA",23,173,41,214
https://kawalpemilu.org#42346,"SOSROMENDURAN, GEDONGTENGEN, KOTA YOGYAKARTA, DAERAH ISTIMEWA YOGYAKARTA",24,155,51,206
https://kawalpemilu.org#42346,"SOSROMENDURAN, GEDONGTENGEN, KOTA YOGYAKARTA, DAERAH ISTIMEWA YOGYAKARTA",25,125,30,155
https://kawalpemilu.org#42346,"SOSROMENDURAN, GEDONGTENGEN, KOTA YOGYAKARTA, DAERAH ISTIMEWA YOGYAKARTA",26,116,35,151
https://kawalpemilu.org#42346,"SOSROMENDURAN, GEDONGTENGEN, KOTA YOGYAKARTA, DAERAH ISTIMEWA YOGYAKARTA",27,158,70,228
https://kawalpemilu.org#42346,"SOSROMENDURAN, GEDONGTENGEN, KOTA YOGYAKARTA, DAERAH ISTIMEWA YOGYAKARTA",28,172,47,219
https://kawalpemilu.org#42347,"PRINGGOKUSUMAN, GEDONGTENGEN, KOTA YOGYAKARTA, DAERAH ISTIMEWA YOGYAKARTA",1,101,26,127
https://kawalpemilu.org#42347,"PRINGGOKUSUMAN, GEDONGTENGEN, KOTA YOGYAKARTA, DAERAH ISTIMEWA YOGYAKARTA",2,168,39,207
https://kawalpemilu.org#42347,"PRINGGOKUSUMAN, GEDONGTENGEN, KOTA YOGYAKARTA, DAERAH ISTIMEWA YOGYAKARTA",3,183,58,241
https://kawalpemilu.org#42347,"PRINGGOKUSUMAN, GEDONGTENGEN, KOTA YOGYAKARTA, DAERAH ISTIMEWA YOGYAKARTA",4,110,45,155
https://kawalpemilu.org#42347,"PRINGGOKUSUMAN, GEDONGTENGEN, KOTA YOGYAKARTA, DAERAH ISTIMEWA YOGYAKARTA",5,105,58,163
https://kawalpemilu.org#42347,"PRINGGOKUSUMAN, GEDONGTENGEN, KOTA YOGYAKARTA, DAERAH ISTIMEWA YOGYAKARTA",6,87,34,121
https://kawalpemilu.org#42347,"PRINGGOKUSUMAN, GEDONGTENGEN, KOTA YOGYAKARTA, DAERAH ISTIMEWA YOGYAKARTA",7,181,51,232
https://kawalpemilu.org#42347,"PRINGGOKUSUMAN, GEDONGTENGEN, KOTA YOGYAKARTA, DAERAH ISTIMEWA YOGYAKARTA",8,181,60,241
https://kawalpemilu.org#42347,"PRINGGOKUSUMAN, GEDONGTENGEN, KOTA YOGYAKARTA, DAERAH ISTIMEWA YOGYAKARTA",9,124,38,162
https://kawalpemilu.org#42347,"PRINGGOKUSUMAN, GEDONGTENGEN, KOTA YOGYAKARTA, DAERAH ISTIMEWA YOGYAKARTA",10,88,51,139
https://kawalpemilu.org#42347,"PRINGGOKUSUMAN, GEDONGTENGEN, KOTA YOGYAKARTA, DAERAH ISTIMEWA YOGYAKARTA",11,95,60,155
https://kawalpemilu.org#42347,"PRINGGOKUSUMAN, GEDONGTENGEN, KOTA YOGYAKARTA, DAERAH ISTIMEWA YOGYAKARTA",12,126,37,163
https://kawalpemilu.org#42347,"PRINGGOKUSUMAN, GEDONGTENGEN, KOTA YOGYAKARTA, DAERAH ISTIMEWA YOGYAKARTA",13,146,20,166
https://kawalpemilu.org#42347,"PRINGGOKUSUMAN, GEDONGTENGEN, KOTA YOGYAKARTA, DAERAH ISTIMEWA YOGYAKARTA",14,169,49,218
https://kawalpemilu.org#42347,"PRINGGOKUSUMAN, GEDONGTENGEN, KOTA YOGYAKARTA, DAERAH ISTIMEWA YOGYAKARTA",15,99,18,117
https://kawalpemilu.org#42347,"PRINGGOKUSUMAN, GEDONGTENGEN, KOTA YOGYAKARTA, DAERAH ISTIMEWA YOGYAKARTA",16,150,15,165
https://kawalpemilu.org#42347,"PRINGGOKUSUMAN, GEDONGTENGEN, KOTA YOGYAKARTA, DAERAH ISTIMEWA YOGYAKARTA",17,160,49,209
https://kawalpemilu.org#42347,"PRINGGOKUSUMAN, GEDONGTENGEN, KOTA YOGYAKARTA, DAERAH ISTIMEWA YOGYAKARTA",18,130,25,155
https://kawalpemilu.org#42347,"PRINGGOKUSUMAN, GEDONGTENGEN, KOTA YOGYAKARTA, DAERAH ISTIMEWA YOGYAKARTA",19,138,17,155
https://kawalpemilu.org#42347,"PRINGGOKUSUMAN, GEDONGTENGEN, KOTA YOGYAKARTA, DAERAH ISTIMEWA YOGYAKARTA",20,100,51,151
https://kawalpemilu.org#42347,"PRINGGOKUSUMAN, GEDONGTENGEN, KOTA YOGYAKARTA, DAERAH ISTIMEWA YOGYAKARTA",21,105,29,134
https://kawalpemilu.org#42347,"PRINGGOKUSUMAN, GEDONGTENGEN, KOTA YOGYAKARTA, DAERAH ISTIMEWA YOGYAKARTA",22,122,17,139
https://kawalpemilu.org#42347,"PRINGGOKUSUMAN, GEDONGTENGEN, KOTA YOGYAKARTA, DAERAH ISTIMEWA YOGYAKARTA",23,87,26,113
https://kawalpemilu.org#42347,"PRINGGOKUSUMAN, GEDONGTENGEN, KOTA YOGYAKARTA, DAERAH ISTIMEWA YOGYAKARTA",24,161,29,190
https://kawalpemilu.org#42347,"PRINGGOKUSUMAN, GEDONGTENGEN, KOTA YOGYAKARTA, DAERAH ISTIMEWA YOGYAKARTA",25,186,56,242
https://kawalpemilu.org#42347,"PRINGGOKUSUMAN, GEDONGTENGEN, KOTA YOGYAKARTA, DAERAH ISTIMEWA YOGYAKARTA",26,179,56,235
https://kawalpemilu.org#42347,"PRINGGOKUSUMAN, GEDONGTENGEN, KOTA YOGYAKARTA, DAERAH ISTIMEWA YOGYAKARTA",27,102,38,140
https://kawalpemilu.org#42347,"PRINGGOKUSUMAN, GEDONGTENGEN, KOTA YOGYAKARTA, DAERAH ISTIMEWA YOGYAKARTA",28,137,14,151
https://kawalpemilu.org#42347,"PRINGGOKUSUMAN, GEDONGTENGEN, KOTA YOGYAKARTA, DAERAH ISTIMEWA YOGYAKARTA",29,177,32,209
https://kawalpemilu.org#42347,"PRINGGOKUSUMAN, GEDONGTENGEN, KOTA YOGYAKARTA, DAERAH ISTIMEWA YOGYAKARTA",30,204,30,234
https://kawalpemilu.org#42347,"PRINGGOKUSUMAN, GEDONGTENGEN, KOTA YOGYAKARTA, DAERAH ISTIMEWA YOGYAKARTA",31,135,19,154
https://kawalpemilu.org#42347,"PRINGGOKUSUMAN, GEDONGTENGEN, KOTA YOGYAKARTA, DAERAH ISTIMEWA YOGYAKARTA",33,164,66,230
https://kawalpemilu.org#42347,"PRINGGOKUSUMAN, GEDONGTENGEN, KOTA YOGYAKARTA, DAERAH ISTIMEWA YOGYAKARTA",34,204,28,232
https://kawalpemilu.org#42347,"PRINGGOKUSUMAN, GEDONGTENGEN, KOTA YOGYAKARTA, DAERAH ISTIMEWA YOGYAKARTA",35,128,38,166
https://kawalpemilu.org#42347,"PRINGGOKUSUMAN, GEDONGTENGEN, KOTA YOGYAKARTA, DAERAH ISTIMEWA YOGYAKARTA",36,126,48,174
https://kawalpemilu.org#42347,"PRINGGOKUSUMAN, GEDONGTENGEN, KOTA YOGYAKARTA, DAERAH ISTIMEWA YOGYAKARTA",37,142,42,184
https://kawalpemilu.org#42347,"PRINGGOKUSUMAN, GEDONGTENGEN, KOTA YOGYAKARTA, DAERAH ISTIMEWA YOGYAKARTA",38,123,34,157
https://kawalpemilu.org#42347,"PRINGGOKUSUMAN, GEDONGTENGEN, KOTA YOGYAKARTA, DAERAH ISTIMEWA YOGYAKARTA",39,220,34,254
https://kawalpemilu.org#42347,"PRINGGOKUSUMAN, GEDONGTENGEN, KOTA YOGYAKARTA, DAERAH ISTIMEWA YOGYAKARTA",40,140,59,199
https://kawalpemilu.org#42347,"PRINGGOKUSUMAN, GEDONGTENGEN, KOTA YOGYAKARTA, DAERAH ISTIMEWA YOGYAKARTA",41,192,50,242
https://kawalpemilu.org#42347,"PRINGGOKUSUMAN, GEDONGTENGEN, KOTA YOGYAKARTA, DAERAH ISTIMEWA YOGYAKARTA",42,86,26,112
https://kawalpemilu.org#42347,"PRINGGOKUSUMAN, GEDONGTENGEN, KOTA YOGYAKARTA, DAERAH ISTIMEWA YOGYAKARTA",43,100,51,151
https://kawalpemilu.org#42347,"PRINGGOKUSUMAN, GEDONGTENGEN, KOTA YOGYAKARTA, DAERAH ISTIMEWA YOGYAKARTA",44,143,19,162
https://kawalpemilu.org#42347,"PRINGGOKUSUMAN, GEDONGTENGEN, KOTA YOGYAKARTA, DAERAH ISTIMEWA YOGYAKARTA",45,173,55,228
https://kawalpemilu.org#42347,"PRINGGOKUSUMAN, GEDONGTENGEN, KOTA YOGYAKARTA, DAERAH ISTIMEWA YOGYAKARTA",46,130,32,162
https://kawalpemilu.org#42349,"NGAMPILAN, NGAMPILAN, KOTA YOGYAKARTA, DAERAH ISTIMEWA YOGYAKARTA",1,122,63,185
https://kawalpemilu.org#42349,"NGAMPILAN, NGAMPILAN, KOTA YOGYAKARTA, DAERAH ISTIMEWA YOGYAKARTA",2,151,50,201
https://kawalpemilu.org#42349,"NGAMPILAN, NGAMPILAN, KOTA YOGYAKARTA, DAERAH ISTIMEWA YOGYAKARTA",3,147,81,228
https://kawalpemilu.org#42349,"NGAMPILAN, NGAMPILAN, KOTA YOGYAKARTA, DAERAH ISTIMEWA YOGYAKARTA",4,133,36,169
https://kawalpemilu.org#42349,"NGAMPILAN, NGAMPILAN, KOTA YOGYAKARTA, DAERAH ISTIMEWA YOGYAKARTA",5,130,55,185
https://kawalpemilu.org#42349,"NGAMPILAN, NGAMPILAN, KOTA YOGYAKARTA, DAERAH ISTIMEWA YOGYAKARTA",6,131,47,178
https://kawalpemilu.org#42349,"NGAMPILAN, NGAMPILAN, KOTA YOGYAKARTA, DAERAH ISTIMEWA YOGYAKARTA",7,153,33,186
https://kawalpemilu.org#42349,"NGAMPILAN, NGAMPILAN, KOTA YOGYAKARTA, DAERAH ISTIMEWA YOGYAKARTA",8,127,49,176
https://kawalpemilu.org#42349,"NGAMPILAN, NGAMPILAN, KOTA YOGYAKARTA, DAERAH ISTIMEWA YOGYAKARTA",9,148,33,181
https://kawalpemilu.org#42349,"NGAMPILAN, NGAMPILAN, KOTA YOGYAKARTA, DAERAH ISTIMEWA YOGYAKARTA",10,148,34,182
https://kawalpemilu.org#42349,"NGAMPILAN, NGAMPILAN, KOTA YOGYAKARTA, DAERAH ISTIMEWA YOGYAKARTA",11,168,44,212
https://kawalpemilu.org#42349,"NGAMPILAN, NGAMPILAN, KOTA YOGYAKARTA, DAERAH ISTIMEWA YOGYAKARTA",12,149,36,185
https://kawalpemilu.org#42349,"NGAMPILAN, NGAMPILAN, KOTA YOGYAKARTA, DAERAH ISTIMEWA YOGYAKARTA",13,128,50,178
https://kawalpemilu.org#42349,"NGAMPILAN, NGAMPILAN, KOTA YOGYAKARTA, DAERAH ISTIMEWA YOGYAKARTA",14,69,91,160
https://kawalpemilu.org#42349,"NGAMPILAN, NGAMPILAN, KOTA YOGYAKARTA, DAERAH ISTIMEWA YOGYAKARTA",15,115,53,168
https://kawalpemilu.org#42349,"NGAMPILAN, NGAMPILAN, KOTA YOGYAKARTA, DAERAH ISTIMEWA YOGYAKARTA",16,130,64,194
https://kawalpemilu.org#42349,"NGAMPILAN, NGAMPILAN, KOTA YOGYAKARTA, DAERAH ISTIMEWA YOGYAKARTA",17,116,65,181
https://kawalpemilu.org#42349,"NGAMPILAN, NGAMPILAN, KOTA YOGYAKARTA, DAERAH ISTIMEWA YOGYAKARTA",18,197,57,254
https://kawalpemilu.org#42349,"NGAMPILAN, NGAMPILAN, KOTA YOGYAKARTA, DAERAH ISTIMEWA YOGYAKARTA",19,168,81,249
https://kawalpemilu.org#42349,"NGAMPILAN, NGAMPILAN, KOTA YOGYAKARTA, DAERAH ISTIMEWA YOGYAKARTA",20,167,50,217
https://kawalpemilu.org#42349,"NGAMPILAN, NGAMPILAN, KOTA YOGYAKARTA, DAERAH ISTIMEWA YOGYAKARTA",21,143,80,223
https://kawalpemilu.org#42349,"NGAMPILAN, NGAMPILAN, KOTA YOGYAKARTA, DAERAH ISTIMEWA YOGYAKARTA",22,121,109,230
https://kawalpemilu.org#42349,"NGAMPILAN, NGAMPILAN, KOTA YOGYAKARTA, DAERAH ISTIMEWA YOGYAKARTA",23,132,119,251
https://kawalpemilu.org#42349,"NGAMPILAN, NGAMPILAN, KOTA YOGYAKARTA, DAERAH ISTIMEWA YOGYAKARTA",24,121,108,229
https://kawalpemilu.org#42349,"NGAMPILAN, NGAMPILAN, KOTA YOGYAKARTA, DAERAH ISTIMEWA YOGYAKARTA",25,130,100,230
https://kawalpemilu.org#42349,"NGAMPILAN, NGAMPILAN, KOTA YOGYAKARTA, DAERAH ISTIMEWA YOGYAKARTA",26,183,45,228
https://kawalpemilu.org#42349,"NGAMPILAN, NGAMPILAN, KOTA YOGYAKARTA, DAERAH ISTIMEWA YOGYAKARTA",27,156,52,208
https://kawalpemilu.org#42349,"NGAMPILAN, NGAMPILAN, KOTA YOGYAKARTA, DAERAH ISTIMEWA YOGYAKARTA",28,163,71,234
https://kawalpemilu.org#42349,"NGAMPILAN, NGAMPILAN, KOTA YOGYAKARTA, DAERAH ISTIMEWA YOGYAKARTA",29,146,81,227
https://kawalpemilu.org#42349,"NGAMPILAN, NGAMPILAN, KOTA YOGYAKARTA, DAERAH ISTIMEWA YOGYAKARTA",30,86,128,214
https://kawalpemilu.org#42349,"NGAMPILAN, NGAMPILAN, KOTA YOGYAKARTA, DAERAH ISTIMEWA YOGYAKARTA",31,109,110,219
https://kawalpemilu.org#42349,"NGAMPILAN, NGAMPILAN, KOTA YOGYAKARTA, DAERAH ISTIMEWA YOGYAKARTA",32,143,67,210
https://kawalpemilu.org#42350,"NOTOPRAJAN, NGAMPILAN, KOTA YOGYAKARTA, DAERAH ISTIMEWA YOGYAKARTA",1,145,54,199
https://kawalpemilu.org#42350,"NOTOPRAJAN, NGAMPILAN, KOTA YOGYAKARTA, DAERAH ISTIMEWA YOGYAKARTA",2,121,56,177
https://kawalpemilu.org#42350,"NOTOPRAJAN, NGAMPILAN, KOTA YOGYAKARTA, DAERAH ISTIMEWA YOGYAKARTA",3,109,57,166
https://kawalpemilu.org#42350,"NOTOPRAJAN, NGAMPILAN, KOTA YOGYAKARTA, DAERAH ISTIMEWA YOGYAKARTA",4,134,76,210
https://kawalpemilu.org#42350,"NOTOPRAJAN, NGAMPILAN, KOTA YOGYAKARTA, DAERAH ISTIMEWA YOGYAKARTA",5,84,99,183
https://kawalpemilu.org#42350,"NOTOPRAJAN, NGAMPILAN, KOTA YOGYAKARTA, DAERAH ISTIMEWA YOGYAKARTA",6,118,51,169
https://kawalpemilu.org#42350,"NOTOPRAJAN, NGAMPILAN, KOTA YOGYAKARTA, DAERAH ISTIMEWA YOGYAKARTA",7,174,42,216
https://kawalpemilu.org#42350,"NOTOPRAJAN, NGAMPILAN, KOTA YOGYAKARTA, DAERAH ISTIMEWA YOGYAKARTA",8,111,101,212
https://kawalpemilu.org#42350,"NOTOPRAJAN, NGAMPILAN, KOTA YOGYAKARTA, DAERAH ISTIMEWA YOGYAKARTA",9,99,98,197
https://kawalpemilu.org#42350,"NOTOPRAJAN, NGAMPILAN, KOTA YOGYAKARTA, DAERAH ISTIMEWA YOGYAKARTA",10,115,89,204
https://kawalpemilu.org#42350,"NOTOPRAJAN, NGAMPILAN, KOTA YOGYAKARTA, DAERAH ISTIMEWA YOGYAKARTA",11,69,108,177
https://kawalpemilu.org#42350,"NOTOPRAJAN, NGAMPILAN, KOTA YOGYAKARTA, DAERAH ISTIMEWA YOGYAKARTA",12,98,111,209
https://kawalpemilu.org#42350,"NOTOPRAJAN, NGAMPILAN, KOTA YOGYAKARTA, DAERAH ISTIMEWA YOGYAKARTA",13,138,56,194
https://kawalpemilu.org#42350,"NOTOPRAJAN, NGAMPILAN, KOTA YOGYAKARTA, DAERAH ISTIMEWA YOGYAKARTA",14,172,37,209
https://kawalpemilu.org#42350,"NOTOPRAJAN, NGAMPILAN, KOTA YOGYAKARTA, DAERAH ISTIMEWA YOGYAKARTA",15,194,53,247
https://kawalpemilu.org#42350,"NOTOPRAJAN, NGAMPILAN, KOTA YOGYAKARTA, DAERAH ISTIMEWA YOGYAKARTA",16,63,77,140
https://kawalpemilu.org#42350,"NOTOPRAJAN, NGAMPILAN, KOTA YOGYAKARTA, DAERAH ISTIMEWA YOGYAKARTA",17,51,86,137
https://kawalpemilu.org#42350,"NOTOPRAJAN, NGAMPILAN, KOTA YOGYAKARTA, DAERAH ISTIMEWA YOGYAKARTA",18,57,64,121
https://kawalpemilu.org#42350,"NOTOPRAJAN, NGAMPILAN, KOTA YOGYAKARTA, DAERAH ISTIMEWA YOGYAKARTA",19,50,83,133
https://kawalpemilu.org#42350,"NOTOPRAJAN, NGAMPILAN, KOTA YOGYAKARTA, DAERAH ISTIMEWA YOGYAKARTA",20,56,159,215
https://kawalpemilu.org#42350,"NOTOPRAJAN, NGAMPILAN, KOTA YOGYAKARTA, DAERAH ISTIMEWA YOGYAKARTA",21,106,126,232
https://kawalpemilu.org#42350,"NOTOPRAJAN, NGAMPILAN, KOTA YOGYAKARTA, DAERAH ISTIMEWA YOGYAKARTA",22,98,116,214
https://kawalpemilu.org#42350,"NOTOPRAJAN, NGAMPILAN, KOTA YOGYAKARTA, DAERAH ISTIMEWA YOGYAKARTA",23,66,163,229
https://kawalpemilu.org#42350,"NOTOPRAJAN, NGAMPILAN, KOTA YOGYAKARTA, DAERAH ISTIMEWA YOGYAKARTA",24,59,179,238
https://kawalpemilu.org#42350,"NOTOPRAJAN, NGAMPILAN, KOTA YOGYAKARTA, DAERAH ISTIMEWA YOGYAKARTA",25,42,110,152
https://kawalpemilu.org#42350,"NOTOPRAJAN, NGAMPILAN, KOTA YOGYAKARTA, DAERAH ISTIMEWA YOGYAKARTA",26,35,149,184
https://kawalpemilu.org#42350,"NOTOPRAJAN, NGAMPILAN, KOTA YOGYAKARTA, DAERAH ISTIMEWA YOGYAKARTA",27,41,119,160
https://kawalpemilu.org#42350,"NOTOPRAJAN, NGAMPILAN, KOTA YOGYAKARTA, DAERAH ISTIMEWA YOGYAKARTA",28,22,146,168
https://kawalpemilu.org#42352,"PAKUNCEN, WIROBRAJAN, KOTA YOGYAKARTA, DAERAH ISTIMEWA YOGYAKARTA",1,124,73,197
https://kawalpemilu.org#42352,"PAKUNCEN, WIROBRAJAN, KOTA YOGYAKARTA, DAERAH ISTIMEWA YOGYAKARTA",2,85,65,150
https://kawalpemilu.org#42352,"PAKUNCEN, WIROBRAJAN, KOTA YOGYAKARTA, DAERAH ISTIMEWA YOGYAKARTA",3,103,42,145
https://kawalpemilu.org#42352,"PAKUNCEN, WIROBRAJAN, KOTA YOGYAKARTA, DAERAH ISTIMEWA YOGYAKARTA",4,108,55,163
https://kawalpemilu.org#42352,"PAKUNCEN, WIROBRAJAN, KOTA YOGYAKARTA, DAERAH ISTIMEWA YOGYAKARTA",5,134,38,172
https://kawalpemilu.org#42352,"PAKUNCEN, WIROBRAJAN, KOTA YOGYAKARTA, DAERAH ISTIMEWA YOGYAKARTA",6,206,60,266
https://kawalpemilu.org#42352,"PAKUNCEN, WIROBRAJAN, KOTA YOGYAKARTA, DAERAH ISTIMEWA YOGYAKARTA",7,159,67,226
https://kawalpemilu.org#42352,"PAKUNCEN, WIROBRAJAN, KOTA YOGYAKARTA, DAERAH ISTIMEWA YOGYAKARTA",8,143,95,238
https://kawalpemilu.org#42352,"PAKUNCEN, WIROBRAJAN, KOTA YOGYAKARTA, DAERAH ISTIMEWA YOGYAKARTA",9,60,24,84
https://kawalpemilu.org#42352,"PAKUNCEN, WIROBRAJAN, KOTA YOGYAKARTA, DAERAH ISTIMEWA YOGYAKARTA",10,161,35,196
https://kawalpemilu.org#42352,"PAKUNCEN, WIROBRAJAN, KOTA YOGYAKARTA, DAERAH ISTIMEWA YOGYAKARTA",11,115,60,175
https://kawalpemilu.org#42352,"PAKUNCEN, WIROBRAJAN, KOTA YOGYAKARTA, DAERAH ISTIMEWA YOGYAKARTA",12,74,122,196
https://kawalpemilu.org#42352,"PAKUNCEN, WIROBRAJAN, KOTA YOGYAKARTA, DAERAH ISTIMEWA YOGYAKARTA",13,83,58,141
https://kawalpemilu.org#42352,"PAKUNCEN, WIROBRAJAN, KOTA YOGYAKARTA, DAERAH ISTIMEWA YOGYAKARTA",14,94,148,242
https://kawalpemilu.org#42352,"PAKUNCEN, WIROBRAJAN, KOTA YOGYAKARTA, DAERAH ISTIMEWA YOGYAKARTA",15,49,85,134
https://kawalpemilu.org#42352,"PAKUNCEN, WIROBRAJAN, KOTA YOGYAKARTA, DAERAH ISTIMEWA YOGYAKARTA",16,214,37,251
https://kawalpemilu.org#42352,"PAKUNCEN, WIROBRAJAN, KOTA YOGYAKARTA, DAERAH ISTIMEWA YOGYAKARTA",17,155,42,197
https://kawalpemilu.org#42352,"PAKUNCEN, WIROBRAJAN, KOTA YOGYAKARTA, DAERAH ISTIMEWA YOGYAKARTA",18,177,49,226
https://kawalpemilu.org#42352,"PAKUNCEN, WIROBRAJAN, KOTA YOGYAKARTA, DAERAH ISTIMEWA YOGYAKARTA",19,113,72,185
https://kawalpemilu.org#42352,"PAKUNCEN, WIROBRAJAN, KOTA YOGYAKARTA, DAERAH ISTIMEWA YOGYAKARTA",20,87,24,111
https://kawalpemilu.org#42352,"PAKUNCEN, WIROBRAJAN, KOTA YOGYAKARTA, DAERAH ISTIMEWA YOGYAKARTA",21,88,59,147
https://kawalpemilu.org#42352,"PAKUNCEN, WIROBRAJAN, KOTA YOGYAKARTA, DAERAH ISTIMEWA YOGYAKARTA",22,150,75,225
https://kawalpemilu.org#42352,"PAKUNCEN, WIROBRAJAN, KOTA YOGYAKARTA, DAERAH ISTIMEWA YOGYAKARTA",23,110,56,166
https://kawalpemilu.org#42352,"PAKUNCEN, WIROBRAJAN, KOTA YOGYAKARTA, DAERAH ISTIMEWA YOGYAKARTA",24,111,87,198
https://kawalpemilu.org#42352,"PAKUNCEN, WIROBRAJAN, KOTA YOGYAKARTA, DAERAH ISTIMEWA YOGYAKARTA",25,160,72,232
https://kawalpemilu.org#42352,"PAKUNCEN, WIROBRAJAN, KOTA YOGYAKARTA, DAERAH ISTIMEWA YOGYAKARTA",26,187,70,257
https://kawalpemilu.org#42352,"PAKUNCEN, WIROBRAJAN, KOTA YOGYAKARTA, DAERAH ISTIMEWA YOGYAKARTA",27,90,76,166
https://kawalpemilu.org#42352,"PAKUNCEN, WIROBRAJAN, KOTA YOGYAKARTA, DAERAH ISTIMEWA YOGYAKARTA",28,109,39,148
https://kawalpemilu.org#42352,"PAKUNCEN, WIROBRAJAN, KOTA YOGYAKARTA, DAERAH ISTIMEWA YOGYAKARTA",29,160,54,214
https://kawalpemilu.org#42352,"PAKUNCEN, WIROBRAJAN, KOTA YOGYAKARTA, DAERAH ISTIMEWA YOGYAKARTA",30,142,39,181
https://kawalpemilu.org#42352,"PAKUNCEN, WIROBRAJAN, KOTA YOGYAKARTA, DAERAH ISTIMEWA YOGYAKARTA",31,156,82,238
https://kawalpemilu.org#42352,"PAKUNCEN, WIROBRAJAN, KOTA YOGYAKARTA, DAERAH ISTIMEWA YOGYAKARTA",32,158,40,198
https://kawalpemilu.org#42352,"PAKUNCEN, WIROBRAJAN, KOTA YOGYAKARTA, DAERAH ISTIMEWA YOGYAKARTA",33,129,53,182
https://kawalpemilu.org#42352,"PAKUNCEN, WIROBRAJAN, KOTA YOGYAKARTA, DAERAH ISTIMEWA YOGYAKARTA",34,116,45,161
https://kawalpemilu.org#42352,"PAKUNCEN, WIROBRAJAN, KOTA YOGYAKARTA, DAERAH ISTIMEWA YOGYAKARTA",35,99,24,123
https://kawalpemilu.org#42352,"PAKUNCEN, WIROBRAJAN, KOTA YOGYAKARTA, DAERAH ISTIMEWA YOGYAKARTA",36,213,49,262
https://kawalpemilu.org#42352,"PAKUNCEN, WIROBRAJAN, KOTA YOGYAKARTA, DAERAH ISTIMEWA YOGYAKARTA",37,81,28,109
https://kawalpemilu.org#42353,"WIROBRAJAN, WIROBRAJAN, KOTA YOGYAKARTA, DAERAH ISTIMEWA YOGYAKARTA",1,165,81,246
https://kawalpemilu.org#42353,"WIROBRAJAN, WIROBRAJAN, KOTA YOGYAKARTA, DAERAH ISTIMEWA YOGYAKARTA",2,157,40,197
https://kawalpemilu.org#42353,"WIROBRAJAN, WIROBRAJAN, KOTA YOGYAKARTA, DAERAH ISTIMEWA YOGYAKARTA",3,44,87,131
https://kawalpemilu.org#42353,"WIROBRAJAN, WIROBRAJAN, KOTA YOGYAKARTA, DAERAH ISTIMEWA YOGYAKARTA",4,143,54,197
https://kawalpemilu.org#42353,"WIROBRAJAN, WIROBRAJAN, KOTA YOGYAKARTA, DAERAH ISTIMEWA YOGYAKARTA",5,136,108,244
https://kawalpemilu.org#42353,"WIROBRAJAN, WIROBRAJAN, KOTA YOGYAKARTA, DAERAH ISTIMEWA YOGYAKARTA",6,142,65,1
https://kawalpemilu.org#42353,"WIROBRAJAN, WIROBRAJAN, KOTA YOGYAKARTA, DAERAH ISTIMEWA YOGYAKARTA",7,146,106,252
https://kawalpemilu.org#42353,"WIROBRAJAN, WIROBRAJAN, KOTA YOGYAKARTA, DAERAH ISTIMEWA YOGYAKARTA",8,156,77,233
https://kawalpemilu.org#42353,"WIROBRAJAN, WIROBRAJAN, KOTA YOGYAKARTA, DAERAH ISTIMEWA YOGYAKARTA",9,78,49,127
https://kawalpemilu.org#42353,"WIROBRAJAN, WIROBRAJAN, KOTA YOGYAKARTA, DAERAH ISTIMEWA YOGYAKARTA",10,94,56,150
https://kawalpemilu.org#42353,"WIROBRAJAN, WIROBRAJAN, KOTA YOGYAKARTA, DAERAH ISTIMEWA YOGYAKARTA",11,114,52,166
https://kawalpemilu.org#42353,"WIROBRAJAN, WIROBRAJAN, KOTA YOGYAKARTA, DAERAH ISTIMEWA YOGYAKARTA",12,121,68,189
https://kawalpemilu.org#42353,"WIROBRAJAN, WIROBRAJAN, KOTA YOGYAKARTA, DAERAH ISTIMEWA YOGYAKARTA",13,156,52,208
https://kawalpemilu.org#42353,"WIROBRAJAN, WIROBRAJAN, KOTA YOGYAKARTA, DAERAH ISTIMEWA YOGYAKARTA",14,138,69,207
https://kawalpemilu.org#42353,"WIROBRAJAN, WIROBRAJAN, KOTA YOGYAKARTA, DAERAH ISTIMEWA YOGYAKARTA",15,139,104,243
https://kawalpemilu.org#42353,"WIROBRAJAN, WIROBRAJAN, KOTA YOGYAKARTA, DAERAH ISTIMEWA YOGYAKARTA",16,137,38,175
https://kawalpemilu.org#42353,"WIROBRAJAN, WIROBRAJAN, KOTA YOGYAKARTA, DAERAH ISTIMEWA YOGYAKARTA",17,103,93,196
https://kawalpemilu.org#42353,"WIROBRAJAN, WIROBRAJAN, KOTA YOGYAKARTA, DAERAH ISTIMEWA YOGYAKARTA",18,83,60,143
https://kawalpemilu.org#42353,"WIROBRAJAN, WIROBRAJAN, KOTA YOGYAKARTA, DAERAH ISTIMEWA YOGYAKARTA",19,69,33,102
https://kawalpemilu.org#42353,"WIROBRAJAN, WIROBRAJAN, KOTA YOGYAKARTA, DAERAH ISTIMEWA YOGYAKARTA",20,106,77,183
https://kawalpemilu.org#42353,"WIROBRAJAN, WIROBRAJAN, KOTA YOGYAKARTA, DAERAH ISTIMEWA YOGYAKARTA",21,179,76,255
https://kawalpemilu.org#42353,"WIROBRAJAN, WIROBRAJAN, KOTA YOGYAKARTA, DAERAH ISTIMEWA YOGYAKARTA",22,124,115,239
https://kawalpemilu.org#42353,"WIROBRAJAN, WIROBRAJAN, KOTA YOGYAKARTA, DAERAH ISTIMEWA YOGYAKARTA",23,184,65,249
https://kawalpemilu.org#42353,"WIROBRAJAN, WIROBRAJAN, KOTA YOGYAKARTA, DAERAH ISTIMEWA YOGYAKARTA",24,137,43,180
https://kawalpemilu.org#42353,"WIROBRAJAN, WIROBRAJAN, KOTA YOGYAKARTA, DAERAH ISTIMEWA YOGYAKARTA",25,142,44,186
https://kawalpemilu.org#42353,"WIROBRAJAN, WIROBRAJAN, KOTA YOGYAKARTA, DAERAH ISTIMEWA YOGYAKARTA",26,132,89,221
https://kawalpemilu.org#42353,"WIROBRAJAN, WIROBRAJAN, KOTA YOGYAKARTA, DAERAH ISTIMEWA YOGYAKARTA",27,104,50,154
https://kawalpemilu.org#42353,"WIROBRAJAN, WIROBRAJAN, KOTA YOGYAKARTA, DAERAH ISTIMEWA YOGYAKARTA",28,116,80,196
https://kawalpemilu.org#42353,"WIROBRAJAN, WIROBRAJAN, KOTA YOGYAKARTA, DAERAH ISTIMEWA YOGYAKARTA",29,99,77,176
https://kawalpemilu.org#42353,"WIROBRAJAN, WIROBRAJAN, KOTA YOGYAKARTA, DAERAH ISTIMEWA YOGYAKARTA",30,152,56,208
https://kawalpemilu.org#42353,"WIROBRAJAN, WIROBRAJAN, KOTA YOGYAKARTA, DAERAH ISTIMEWA YOGYAKARTA",31,65,84,149
https://kawalpemilu.org#42353,"WIROBRAJAN, WIROBRAJAN, KOTA YOGYAKARTA, DAERAH ISTIMEWA YOGYAKARTA",32,99,82,181
https://kawalpemilu.org#42354,"PATANGPULUHAN, WIROBRAJAN, KOTA YOGYAKARTA, DAERAH ISTIMEWA YOGYAKARTA",1,121,83,204
https://kawalpemilu.org#42354,"PATANGPULUHAN, WIROBRAJAN, KOTA YOGYAKARTA, DAERAH ISTIMEWA YOGYAKARTA",2,99,76,175
https://kawalpemilu.org#42354,"PATANGPULUHAN, WIROBRAJAN, KOTA YOGYAKARTA, DAERAH ISTIMEWA YOGYAKARTA",3,121,95,216
https://kawalpemilu.org#42354,"PATANGPULUHAN, WIROBRAJAN, KOTA YOGYAKARTA, DAERAH ISTIMEWA YOGYAKARTA",4,95,54,149
https://kawalpemilu.org#42354,"PATANGPULUHAN, WIROBRAJAN, KOTA YOGYAKARTA, DAERAH ISTIMEWA YOGYAKARTA",5,96,61,157
https://kawalpemilu.org#42354,"PATANGPULUHAN, WIROBRAJAN, KOTA YOGYAKARTA, DAERAH ISTIMEWA YOGYAKARTA",6,98,36,134
https://kawalpemilu.org#42354,"PATANGPULUHAN, WIROBRAJAN, KOTA YOGYAKARTA, DAERAH ISTIMEWA YOGYAKARTA",7,95,71,166
https://kawalpemilu.org#42354,"PATANGPULUHAN, WIROBRAJAN, KOTA YOGYAKARTA, DAERAH ISTIMEWA YOGYAKARTA",8,158,68,226
https://kawalpemilu.org#42354,"PATANGPULUHAN, WIROBRAJAN, KOTA YOGYAKARTA, DAERAH ISTIMEWA YOGYAKARTA",9,134,70,204
https://kawalpemilu.org#42354,"PATANGPULUHAN, WIROBRAJAN, KOTA YOGYAKARTA, DAERAH ISTIMEWA YOGYAKARTA",10,59,83,142
https://kawalpemilu.org#42354,"PATANGPULUHAN, WIROBRAJAN, KOTA YOGYAKARTA, DAERAH ISTIMEWA YOGYAKARTA",11,101,38,139
https://kawalpemilu.org#42354,"PATANGPULUHAN, WIROBRAJAN, KOTA YOGYAKARTA, DAERAH ISTIMEWA YOGYAKARTA",12,117,108,225
https://kawalpemilu.org#42354,"PATANGPULUHAN, WIROBRAJAN, KOTA YOGYAKARTA, DAERAH ISTIMEWA YOGYAKARTA",13,112,57,169
https://kawalpemilu.org#42354,"PATANGPULUHAN, WIROBRAJAN, KOTA YOGYAKARTA, DAERAH ISTIMEWA YOGYAKARTA",14,104,37,141
https://kawalpemilu.org#42354,"PATANGPULUHAN, WIROBRAJAN, KOTA YOGYAKARTA, DAERAH ISTIMEWA YOGYAKARTA",15,133,98,231
https://kawalpemilu.org#42354,"PATANGPULUHAN, WIROBRAJAN, KOTA YOGYAKARTA, DAERAH ISTIMEWA YOGYAKARTA",16,105,68,173
https://kawalpemilu.org#42354,"PATANGPULUHAN, WIROBRAJAN, KOTA YOGYAKARTA, DAERAH ISTIMEWA YOGYAKARTA",17,147,87,234
https://kawalpemilu.org#42354,"PATANGPULUHAN, WIROBRAJAN, KOTA YOGYAKARTA, DAERAH ISTIMEWA YOGYAKARTA",18,141,60,201
https://kawalpemilu.org#42354,"PATANGPULUHAN, WIROBRAJAN, KOTA YOGYAKARTA, DAERAH ISTIMEWA YOGYAKARTA",19,148,65,213
https://kawalpemilu.org#42354,"PATANGPULUHAN, WIROBRAJAN, KOTA YOGYAKARTA, DAERAH ISTIMEWA YOGYAKARTA",20,155,50,205
https://kawalpemilu.org#42354,"PATANGPULUHAN, WIROBRAJAN, KOTA YOGYAKARTA, DAERAH ISTIMEWA YOGYAKARTA",21,79,61,140
https://kawalpemilu.org#42354,"PATANGPULUHAN, WIROBRAJAN, KOTA YOGYAKARTA, DAERAH ISTIMEWA YOGYAKARTA",22,65,82,147
https://kawalpemilu.org#42354,"PATANGPULUHAN, WIROBRAJAN, KOTA YOGYAKARTA, DAERAH ISTIMEWA YOGYAKARTA",23,115,47,162
https://kawalpemilu.org#42354,"PATANGPULUHAN, WIROBRAJAN, KOTA YOGYAKARTA, DAERAH ISTIMEWA YOGYAKARTA",24,80,68,148
https://kawalpemilu.org#42354,"PATANGPULUHAN, WIROBRAJAN, KOTA YOGYAKARTA, DAERAH ISTIMEWA YOGYAKARTA",25,75,79,154
https://kawalpemilu.org#42354,"PATANGPULUHAN, WIROBRAJAN, KOTA YOGYAKARTA, DAERAH ISTIMEWA YOGYAKARTA",26,151,102,253
https://kawalpemilu.org#42354,"PATANGPULUHAN, WIROBRAJAN, KOTA YOGYAKARTA, DAERAH ISTIMEWA YOGYAKARTA",27,177,72,249
https://kawalpemilu.org#42356,"GEDONGKIWO, MANTRIJERON, KOTA YOGYAKARTA, DAERAH ISTIMEWA YOGYAKARTA",1,143,66,209
https://kawalpemilu.org#42356,"GEDONGKIWO, MANTRIJERON, KOTA YOGYAKARTA, DAERAH ISTIMEWA YOGYAKARTA",2,133,90,223
https://kawalpemilu.org#42356,"GEDONGKIWO, MANTRIJERON, KOTA YOGYAKARTA, DAERAH ISTIMEWA YOGYAKARTA",3,102,74,176
https://kawalpemilu.org#42356,"GEDONGKIWO, MANTRIJERON, KOTA YOGYAKARTA, DAERAH ISTIMEWA YOGYAKARTA",4,177,67,244
https://kawalpemilu.org#42356,"GEDONGKIWO, MANTRIJERON, KOTA YOGYAKARTA, DAERAH ISTIMEWA YOGYAKARTA",5,131,91,222
https://kawalpemilu.org#42356,"GEDONGKIWO, MANTRIJERON, KOTA YOGYAKARTA, DAERAH ISTIMEWA YOGYAKARTA",6,163,64,227
https://kawalpemilu.org#42356,"GEDONGKIWO, MANTRIJERON, KOTA YOGYAKARTA, DAERAH ISTIMEWA YOGYAKARTA",7,141,64,205
https://kawalpemilu.org#42356,"GEDONGKIWO, MANTRIJERON, KOTA YOGYAKARTA, DAERAH ISTIMEWA YOGYAKARTA",8,101,114,215
https://kawalpemilu.org#42356,"GEDONGKIWO, MANTRIJERON, KOTA YOGYAKARTA, DAERAH ISTIMEWA YOGYAKARTA",9,162,58,220
https://kawalpemilu.org#42356,"GEDONGKIWO, MANTRIJERON, KOTA YOGYAKARTA, DAERAH ISTIMEWA YOGYAKARTA",10,65,182,247
https://kawalpemilu.org#42356,"GEDONGKIWO, MANTRIJERON, KOTA YOGYAKARTA, DAERAH ISTIMEWA YOGYAKARTA",11,127,63,190
https://kawalpemilu.org#42356,"GEDONGKIWO, MANTRIJERON, KOTA YOGYAKARTA, DAERAH ISTIMEWA YOGYAKARTA",12,118,80,198
https://kawalpemilu.org#42356,"GEDONGKIWO, MANTRIJERON, KOTA YOGYAKARTA, DAERAH ISTIMEWA YOGYAKARTA",13,132,69,201
https://kawalpemilu.org#42356,"GEDONGKIWO, MANTRIJERON, KOTA YOGYAKARTA, DAERAH ISTIMEWA YOGYAKARTA",14,110,78,188
https://kawalpemilu.org#42356,"GEDONGKIWO, MANTRIJERON, KOTA YOGYAKARTA, DAERAH ISTIMEWA YOGYAKARTA",15,130,75,205
https://kawalpemilu.org#42356,"GEDONGKIWO, MANTRIJERON, KOTA YOGYAKARTA, DAERAH ISTIMEWA YOGYAKARTA",16,135,39,174
https://kawalpemilu.org#42356,"GEDONGKIWO, MANTRIJERON, KOTA YOGYAKARTA, DAERAH ISTIMEWA YOGYAKARTA",17,132,66,198
https://kawalpemilu.org#42356,"GEDONGKIWO, MANTRIJERON, KOTA YOGYAKARTA, DAERAH ISTIMEWA YOGYAKARTA",18,135,84,219
https://kawalpemilu.org#42356,"GEDONGKIWO, MANTRIJERON, KOTA YOGYAKARTA, DAERAH ISTIMEWA YOGYAKARTA",19,172,67,239
https://kawalpemilu.org#42356,"GEDONGKIWO, MANTRIJERON, KOTA YOGYAKARTA, DAERAH ISTIMEWA YOGYAKARTA",20,185,62,247
https://kawalpemilu.org#42356,"GEDONGKIWO, MANTRIJERON, KOTA YOGYAKARTA, DAERAH ISTIMEWA YOGYAKARTA",21,115,73,188
https://kawalpemilu.org#42356,"GEDONGKIWO, MANTRIJERON, KOTA YOGYAKARTA, DAERAH ISTIMEWA YOGYAKARTA",22,140,65,205
https://kawalpemilu.org#42356,"GEDONGKIWO, MANTRIJERON, KOTA YOGYAKARTA, DAERAH ISTIMEWA YOGYAKARTA",23,87,64,151
https://kawalpemilu.org#42356,"GEDONGKIWO, MANTRIJERON, KOTA YOGYAKARTA, DAERAH ISTIMEWA YOGYAKARTA",24,116,79,195
https://kawalpemilu.org#42356,"GEDONGKIWO, MANTRIJERON, KOTA YOGYAKARTA, DAERAH ISTIMEWA YOGYAKARTA",25,120,52,172
https://kawalpemilu.org#42356,"GEDONGKIWO, MANTRIJERON, KOTA YOGYAKARTA, DAERAH ISTIMEWA YOGYAKARTA",26,197,48,245
https://kawalpemilu.org#42356,"GEDONGKIWO, MANTRIJERON, KOTA YOGYAKARTA, DAERAH ISTIMEWA YOGYAKARTA",27,146,86,232
https://kawalpemilu.org#42356,"GEDONGKIWO, MANTRIJERON, KOTA YOGYAKARTA, DAERAH ISTIMEWA YOGYAKARTA",28,174,78,252
https://kawalpemilu.org#42356,"GEDONGKIWO, MANTRIJERON, KOTA YOGYAKARTA, DAERAH ISTIMEWA YOGYAKARTA",29,151,61,212
https://kawalpemilu.org#42356,"GEDONGKIWO, MANTRIJERON, KOTA YOGYAKARTA, DAERAH ISTIMEWA YOGYAKARTA",30,98,103,201
https://kawalpemilu.org#42356,"GEDONGKIWO, MANTRIJERON, KOTA YOGYAKARTA, DAERAH ISTIMEWA YOGYAKARTA",31,114,84,198
https://kawalpemilu.org#42356,"GEDONGKIWO, MANTRIJERON, KOTA YOGYAKARTA, DAERAH ISTIMEWA YOGYAKARTA",32,192,42,234
https://kawalpemilu.org#42356,"GEDONGKIWO, MANTRIJERON, KOTA YOGYAKARTA, DAERAH ISTIMEWA YOGYAKARTA",33,115,56,171
https://kawalpemilu.org#42356,"GEDONGKIWO, MANTRIJERON, KOTA YOGYAKARTA, DAERAH ISTIMEWA YOGYAKARTA",34,190,71,261
https://kawalpemilu.org#42356,"GEDONGKIWO, MANTRIJERON, KOTA YOGYAKARTA, DAERAH ISTIMEWA YOGYAKARTA",35,107,47,154
https://kawalpemilu.org#42356,"GEDONGKIWO, MANTRIJERON, KOTA YOGYAKARTA, DAERAH ISTIMEWA YOGYAKARTA",36,128,103,231
https://kawalpemilu.org#42356,"GEDONGKIWO, MANTRIJERON, KOTA YOGYAKARTA, DAERAH ISTIMEWA YOGYAKARTA",37,162,71,233
https://kawalpemilu.org#42356,"GEDONGKIWO, MANTRIJERON, KOTA YOGYAKARTA, DAERAH ISTIMEWA YOGYAKARTA",38,97,55,152
https://kawalpemilu.org#42356,"GEDONGKIWO, MANTRIJERON, KOTA YOGYAKARTA, DAERAH ISTIMEWA YOGYAKARTA",39,142,113,255
https://kawalpemilu.org#42356,"GEDONGKIWO, MANTRIJERON, KOTA YOGYAKARTA, DAERAH ISTIMEWA YOGYAKARTA",40,149,92,241
https://kawalpemilu.org#42356,"GEDONGKIWO, MANTRIJERON, KOTA YOGYAKARTA, DAERAH ISTIMEWA YOGYAKARTA",41,188,66,254
https://kawalpemilu.org#42356,"GEDONGKIWO, MANTRIJERON, KOTA YOGYAKARTA, DAERAH ISTIMEWA YOGYAKARTA",42,153,79,232
https://kawalpemilu.org#42356,"GEDONGKIWO, MANTRIJERON, KOTA YOGYAKARTA, DAERAH ISTIMEWA YOGYAKARTA",43,123,60,183
https://kawalpemilu.org#42357,"SURYODININGRATAN, MANTRIJERON, KOTA YOGYAKARTA, DAERAH ISTIMEWA YOGYAKARTA",1,135,85,220
https://kawalpemilu.org#42357,"SURYODININGRATAN, MANTRIJERON, KOTA YOGYAKARTA, DAERAH ISTIMEWA YOGYAKARTA",2,150,60,210
https://kawalpemilu.org#42357,"SURYODININGRATAN, MANTRIJERON, KOTA YOGYAKARTA, DAERAH ISTIMEWA YOGYAKARTA",3,172,63,235
https://kawalpemilu.org#42357,"SURYODININGRATAN, MANTRIJERON, KOTA YOGYAKARTA, DAERAH ISTIMEWA YOGYAKARTA",4,158,53,211
https://kawalpemilu.org#42357,"SURYODININGRATAN, MANTRIJERON, KOTA YOGYAKARTA, DAERAH ISTIMEWA YOGYAKARTA",5,106,61,167
https://kawalpemilu.org#42357,"SURYODININGRATAN, MANTRIJERON, KOTA YOGYAKARTA, DAERAH ISTIMEWA YOGYAKARTA",6,148,54,202
https://kawalpemilu.org#42357,"SURYODININGRATAN, MANTRIJERON, KOTA YOGYAKARTA, DAERAH ISTIMEWA YOGYAKARTA",7,129,86,215
https://kawalpemilu.org#42357,"SURYODININGRATAN, MANTRIJERON, KOTA YOGYAKARTA, DAERAH ISTIMEWA YOGYAKARTA",8,145,81,226
https://kawalpemilu.org#42357,"SURYODININGRATAN, MANTRIJERON, KOTA YOGYAKARTA, DAERAH ISTIMEWA YOGYAKARTA",9,199,54,253
https://kawalpemilu.org#42357,"SURYODININGRATAN, MANTRIJERON, KOTA YOGYAKARTA, DAERAH ISTIMEWA YOGYAKARTA",10,169,75,244
https://kawalpemilu.org#42357,"SURYODININGRATAN, MANTRIJERON, KOTA YOGYAKARTA, DAERAH ISTIMEWA YOGYAKARTA",11,171,76,247
https://kawalpemilu.org#42357,"SURYODININGRATAN, MANTRIJERON, KOTA YOGYAKARTA, DAERAH ISTIMEWA YOGYAKARTA",12,146,87,233
https://kawalpemilu.org#42357,"SURYODININGRATAN, MANTRIJERON, KOTA YOGYAKARTA, DAERAH ISTIMEWA YOGYAKARTA",13,150,78,228
https://kawalpemilu.org#42357,"SURYODININGRATAN, MANTRIJERON, KOTA YOGYAKARTA, DAERAH ISTIMEWA YOGYAKARTA",14,123,98,221
https://kawalpemilu.org#42357,"SURYODININGRATAN, MANTRIJERON, KOTA YOGYAKARTA, DAERAH ISTIMEWA YOGYAKARTA",15,180,79,259
https://kawalpemilu.org#42357,"SURYODININGRATAN, MANTRIJERON, KOTA YOGYAKARTA, DAERAH ISTIMEWA YOGYAKARTA",16,118,120,238
https://kawalpemilu.org#42357,"SURYODININGRATAN, MANTRIJERON, KOTA YOGYAKARTA, DAERAH ISTIMEWA YOGYAKARTA",17,118,126,244
https://kawalpemilu.org#42357,"SURYODININGRATAN, MANTRIJERON, KOTA YOGYAKARTA, DAERAH ISTIMEWA YOGYAKARTA",18,148,48,196
https://kawalpemilu.org#42357,"SURYODININGRATAN, MANTRIJERON, KOTA YOGYAKARTA, DAERAH ISTIMEWA YOGYAKARTA",19,106,86,192
https://kawalpemilu.org#42357,"SURYODININGRATAN, MANTRIJERON, KOTA YOGYAKARTA, DAERAH ISTIMEWA YOGYAKARTA",20,83,67,150
https://kawalpemilu.org#42357,"SURYODININGRATAN, MANTRIJERON, KOTA YOGYAKARTA, DAERAH ISTIMEWA YOGYAKARTA",21,172,73,245
https://kawalpemilu.org#42357,"SURYODININGRATAN, MANTRIJERON, KOTA YOGYAKARTA, DAERAH ISTIMEWA YOGYAKARTA",22,122,72,194
https://kawalpemilu.org#42357,"SURYODININGRATAN, MANTRIJERON, KOTA YOGYAKARTA, DAERAH ISTIMEWA YOGYAKARTA",23,164,58,222
https://kawalpemilu.org#42357,"SURYODININGRATAN, MANTRIJERON, KOTA YOGYAKARTA, DAERAH ISTIMEWA YOGYAKARTA",24,184,78,262
https://kawalpemilu.org#42357,"SURYODININGRATAN, MANTRIJERON, KOTA YOGYAKARTA, DAERAH ISTIMEWA YOGYAKARTA",25,147,87,234
https://kawalpemilu.org#42357,"SURYODININGRATAN, MANTRIJERON, KOTA YOGYAKARTA, DAERAH ISTIMEWA YOGYAKARTA",26,210,67,277
https://kawalpemilu.org#42357,"SURYODININGRATAN, MANTRIJERON, KOTA YOGYAKARTA, DAERAH ISTIMEWA YOGYAKARTA",27,163,86,249
https://kawalpemilu.org#42357,"SURYODININGRATAN, MANTRIJERON, KOTA YOGYAKARTA, DAERAH ISTIMEWA YOGYAKARTA",28,129,99,228
https://kawalpemilu.org#42357,"SURYODININGRATAN, MANTRIJERON, KOTA YOGYAKARTA, DAERAH ISTIMEWA YOGYAKARTA",29,169,77,246
https://kawalpemilu.org#42357,"SURYODININGRATAN, MANTRIJERON, KOTA YOGYAKARTA, DAERAH ISTIMEWA YOGYAKARTA",30,141,107,248
https://kawalpemilu.org#42357,"SURYODININGRATAN, MANTRIJERON, KOTA YOGYAKARTA, DAERAH ISTIMEWA YOGYAKARTA",31,125,91,216
https://kawalpemilu.org#42357,"SURYODININGRATAN, MANTRIJERON, KOTA YOGYAKARTA, DAERAH ISTIMEWA YOGYAKARTA",32,166,83,249
https://kawalpemilu.org#42357,"SURYODININGRATAN, MANTRIJERON, KOTA YOGYAKARTA, DAERAH ISTIMEWA YOGYAKARTA",33,162,66,228
https://kawalpemilu.org#42358,"MANTRIJERON, MANTRIJERON, KOTA YOGYAKARTA, DAERAH ISTIMEWA YOGYAKARTA",1,153,89,242
https://kawalpemilu.org#42358,"MANTRIJERON, MANTRIJERON, KOTA YOGYAKARTA, DAERAH ISTIMEWA YOGYAKARTA",2,145,61,206
https://kawalpemilu.org#42358,"MANTRIJERON, MANTRIJERON, KOTA YOGYAKARTA, DAERAH ISTIMEWA YOGYAKARTA",3,125,107,232
https://kawalpemilu.org#42358,"MANTRIJERON, MANTRIJERON, KOTA YOGYAKARTA, DAERAH ISTIMEWA YOGYAKARTA",4,146,96,242
https://kawalpemilu.org#42358,"MANTRIJERON, MANTRIJERON, KOTA YOGYAKARTA, DAERAH ISTIMEWA YOGYAKARTA",5,164,50,214
https://kawalpemilu.org#42358,"MANTRIJERON, MANTRIJERON, KOTA YOGYAKARTA, DAERAH ISTIMEWA YOGYAKARTA",6,154,71,225
https://kawalpemilu.org#42358,"MANTRIJERON, MANTRIJERON, KOTA YOGYAKARTA, DAERAH ISTIMEWA YOGYAKARTA",7,137,86,223
https://kawalpemilu.org#42358,"MANTRIJERON, MANTRIJERON, KOTA YOGYAKARTA, DAERAH ISTIMEWA YOGYAKARTA",8,141,108,249
https://kawalpemilu.org#42358,"MANTRIJERON, MANTRIJERON, KOTA YOGYAKARTA, DAERAH ISTIMEWA YOGYAKARTA",9,154,92,246
https://kawalpemilu.org#42358,"MANTRIJERON, MANTRIJERON, KOTA YOGYAKARTA, DAERAH ISTIMEWA YOGYAKARTA",10,130,122,252
https://kawalpemilu.org#42358,"MANTRIJERON, MANTRIJERON, KOTA YOGYAKARTA, DAERAH ISTIMEWA YOGYAKARTA",11,159,81,240
https://kawalpemilu.org#42358,"MANTRIJERON, MANTRIJERON, KOTA YOGYAKARTA, DAERAH ISTIMEWA YOGYAKARTA",12,131,103,234
https://kawalpemilu.org#42358,"MANTRIJERON, MANTRIJERON, KOTA YOGYAKARTA, DAERAH ISTIMEWA YOGYAKARTA",13,172,72,244
https://kawalpemilu.org#42358,"MANTRIJERON, MANTRIJERON, KOTA YOGYAKARTA, DAERAH ISTIMEWA YOGYAKARTA",14,129,109,238
https://kawalpemilu.org#42358,"MANTRIJERON, MANTRIJERON, KOTA YOGYAKARTA, DAERAH ISTIMEWA YOGYAKARTA",15,121,119,240
https://kawalpemilu.org#42358,"MANTRIJERON, MANTRIJERON, KOTA YOGYAKARTA, DAERAH ISTIMEWA YOGYAKARTA",16,99,121,220
https://kawalpemilu.org#42358,"MANTRIJERON, MANTRIJERON, KOTA YOGYAKARTA, DAERAH ISTIMEWA YOGYAKARTA",17,74,131,205
https://kawalpemilu.org#42358,"MANTRIJERON, MANTRIJERON, KOTA YOGYAKARTA, DAERAH ISTIMEWA YOGYAKARTA",18,106,101,207
https://kawalpemilu.org#42358,"MANTRIJERON, MANTRIJERON, KOTA YOGYAKARTA, DAERAH ISTIMEWA YOGYAKARTA",19,100,104,204
https://kawalpemilu.org#42358,"MANTRIJERON, MANTRIJERON, KOTA YOGYAKARTA, DAERAH ISTIMEWA YOGYAKARTA",20,94,111,205
https://kawalpemilu.org#42358,"MANTRIJERON, MANTRIJERON, KOTA YOGYAKARTA, DAERAH ISTIMEWA YOGYAKARTA",21,144,73,217
https://kawalpemilu.org#42358,"MANTRIJERON, MANTRIJERON, KOTA YOGYAKARTA, DAERAH ISTIMEWA YOGYAKARTA",22,193,60,253
https://kawalpemilu.org#42358,"MANTRIJERON, MANTRIJERON, KOTA YOGYAKARTA, DAERAH ISTIMEWA YOGYAKARTA",23,163,41,204
https://kawalpemilu.org#42358,"MANTRIJERON, MANTRIJERON, KOTA YOGYAKARTA, DAERAH ISTIMEWA YOGYAKARTA",24,122,73,195
https://kawalpemilu.org#42358,"MANTRIJERON, MANTRIJERON, KOTA YOGYAKARTA, DAERAH ISTIMEWA YOGYAKARTA",25,97,72,169
https://kawalpemilu.org#42358,"MANTRIJERON, MANTRIJERON, KOTA YOGYAKARTA, DAERAH ISTIMEWA YOGYAKARTA",26,177,71,248
https://kawalpemilu.org#42358,"MANTRIJERON, MANTRIJERON, KOTA YOGYAKARTA, DAERAH ISTIMEWA YOGYAKARTA",27,171,71,242
https://kawalpemilu.org#42358,"MANTRIJERON, MANTRIJERON, KOTA YOGYAKARTA, DAERAH ISTIMEWA YOGYAKARTA",28,105,59,164
https://kawalpemilu.org#42358,"MANTRIJERON, MANTRIJERON, KOTA YOGYAKARTA, DAERAH ISTIMEWA YOGYAKARTA",29,152,63,215
https://kawalpemilu.org#42358,"MANTRIJERON, MANTRIJERON, KOTA YOGYAKARTA, DAERAH ISTIMEWA YOGYAKARTA",30,141,44,185
https://kawalpemilu.org#42360,"PATEHAN, KRATON, KOTA YOGYAKARTA, DAERAH ISTIMEWA YOGYAKARTA",1,147,60,207
https://kawalpemilu.org#42360,"PATEHAN, KRATON, KOTA YOGYAKARTA, DAERAH ISTIMEWA YOGYAKARTA",2,151,48,199
https://kawalpemilu.org#42360,"PATEHAN, KRATON, KOTA YOGYAKARTA, DAERAH ISTIMEWA YOGYAKARTA",3,112,70,182
https://kawalpemilu.org#42360,"PATEHAN, KRATON, KOTA YOGYAKARTA, DAERAH ISTIMEWA YOGYAKARTA",4,132,91,223
https://kawalpemilu.org#42360,"PATEHAN, KRATON, KOTA YOGYAKARTA, DAERAH ISTIMEWA YOGYAKARTA",5,69,40,109
https://kawalpemilu.org#42360,"PATEHAN, KRATON, KOTA YOGYAKARTA, DAERAH ISTIMEWA YOGYAKARTA",6,88,75,163
https://kawalpemilu.org#42360,"PATEHAN, KRATON, KOTA YOGYAKARTA, DAERAH ISTIMEWA YOGYAKARTA",7,115,74,189
https://kawalpemilu.org#42360,"PATEHAN, KRATON, KOTA YOGYAKARTA, DAERAH ISTIMEWA YOGYAKARTA",8,145,82,227
https://kawalpemilu.org#42360,"PATEHAN, KRATON, KOTA YOGYAKARTA, DAERAH ISTIMEWA YOGYAKARTA",9,130,98,228
https://kawalpemilu.org#42360,"PATEHAN, KRATON, KOTA YOGYAKARTA, DAERAH ISTIMEWA YOGYAKARTA",10,69,57,126
https://kawalpemilu.org#42360,"PATEHAN, KRATON, KOTA YOGYAKARTA, DAERAH ISTIMEWA YOGYAKARTA",11,94,60,154
https://kawalpemilu.org#42360,"PATEHAN, KRATON, KOTA YOGYAKARTA, DAERAH ISTIMEWA YOGYAKARTA",12,94,28,122
https://kawalpemilu.org#42360,"PATEHAN, KRATON, KOTA YOGYAKARTA, DAERAH ISTIMEWA YOGYAKARTA",13,91,93,184
https://kawalpemilu.org#42360,"PATEHAN, KRATON, KOTA YOGYAKARTA, DAERAH ISTIMEWA YOGYAKARTA",14,73,71,144
https://kawalpemilu.org#42360,"PATEHAN, KRATON, KOTA YOGYAKARTA, DAERAH ISTIMEWA YOGYAKARTA",15,155,93,248
https://kawalpemilu.org#42360,"PATEHAN, KRATON, KOTA YOGYAKARTA, DAERAH ISTIMEWA YOGYAKARTA",16,150,88,238
https://kawalpemilu.org#42360,"PATEHAN, KRATON, KOTA YOGYAKARTA, DAERAH ISTIMEWA YOGYAKARTA",17,169,45,214
https://kawalpemilu.org#42360,"PATEHAN, KRATON, KOTA YOGYAKARTA, DAERAH ISTIMEWA YOGYAKARTA",18,175,48,223
https://kawalpemilu.org#42360,"PATEHAN, KRATON, KOTA YOGYAKARTA, DAERAH ISTIMEWA YOGYAKARTA",19,131,58,189
https://kawalpemilu.org#42360,"PATEHAN, KRATON, KOTA YOGYAKARTA, DAERAH ISTIMEWA YOGYAKARTA",20,115,56,171
https://kawalpemilu.org#42360,"PATEHAN, KRATON, KOTA YOGYAKARTA, DAERAH ISTIMEWA YOGYAKARTA",21,189,61,250
https://kawalpemilu.org#42361,"PANEMBAHAN, KRATON, KOTA YOGYAKARTA, DAERAH ISTIMEWA YOGYAKARTA",1,126,63,189
https://kawalpemilu.org#42361,"PANEMBAHAN, KRATON, KOTA YOGYAKARTA, DAERAH ISTIMEWA YOGYAKARTA",2,110,40,150
https://kawalpemilu.org#42361,"PANEMBAHAN, KRATON, KOTA YOGYAKARTA, DAERAH ISTIMEWA YOGYAKARTA",3,66,42,108
https://kawalpemilu.org#42361,"PANEMBAHAN, KRATON, KOTA YOGYAKARTA, DAERAH ISTIMEWA YOGYAKARTA",4,112,68,180
https://kawalpemilu.org#42361,"PANEMBAHAN, KRATON, KOTA YOGYAKARTA, DAERAH ISTIMEWA YOGYAKARTA",5,141,59,200
https://kawalpemilu.org#42361,"PANEMBAHAN, KRATON, KOTA YOGYAKARTA, DAERAH ISTIMEWA YOGYAKARTA",6,140,81,221
https://kawalpemilu.org#42361,"PANEMBAHAN, KRATON, KOTA YOGYAKARTA, DAERAH ISTIMEWA YOGYAKARTA",7,113,66,179
https://kawalpemilu.org#42361,"PANEMBAHAN, KRATON, KOTA YOGYAKARTA, DAERAH ISTIMEWA YOGYAKARTA",8,145,67,212
https://kawalpemilu.org#42361,"PANEMBAHAN, KRATON, KOTA YOGYAKARTA, DAERAH ISTIMEWA YOGYAKARTA",9,103,39,142
https://kawalpemilu.org#42361,"PANEMBAHAN, KRATON, KOTA YOGYAKARTA, DAERAH ISTIMEWA YOGYAKARTA",10,111,60,171
https://kawalpemilu.org#42361,"PANEMBAHAN, KRATON, KOTA YOGYAKARTA, DAERAH ISTIMEWA YOGYAKARTA",11,139,66,205
https://kawalpemilu.org#42361,"PANEMBAHAN, KRATON, KOTA YOGYAKARTA, DAERAH ISTIMEWA YOGYAKARTA",12,82,41,123
https://kawalpemilu.org#42361,"PANEMBAHAN, KRATON, KOTA YOGYAKARTA, DAERAH ISTIMEWA YOGYAKARTA",13,112,80,192
https://kawalpemilu.org#42361,"PANEMBAHAN, KRATON, KOTA YOGYAKARTA, DAERAH ISTIMEWA YOGYAKARTA",14,172,65,237
https://kawalpemilu.org#42361,"PANEMBAHAN, KRATON, KOTA YOGYAKARTA, DAERAH ISTIMEWA YOGYAKARTA",15,172,55,227
https://kawalpemilu.org#42361,"PANEMBAHAN, KRATON, KOTA YOGYAKARTA, DAERAH ISTIMEWA YOGYAKARTA",16,137,79,216
https://kawalpemilu.org#42361,"PANEMBAHAN, KRATON, KOTA YOGYAKARTA, DAERAH ISTIMEWA YOGYAKARTA",17,198,45,243
https://kawalpemilu.org#42361,"PANEMBAHAN, KRATON, KOTA YOGYAKARTA, DAERAH ISTIMEWA YOGYAKARTA",18,130,65,195
https://kawalpemilu.org#42361,"PANEMBAHAN, KRATON, KOTA YOGYAKARTA, DAERAH ISTIMEWA YOGYAKARTA",19,76,29,105
https://kawalpemilu.org#42361,"PANEMBAHAN, KRATON, KOTA YOGYAKARTA, DAERAH ISTIMEWA YOGYAKARTA",20,128,23,151
https://kawalpemilu.org#42361,"PANEMBAHAN, KRATON, KOTA YOGYAKARTA, DAERAH ISTIMEWA YOGYAKARTA",21,118,33,151
https://kawalpemilu.org#42361,"PANEMBAHAN, KRATON, KOTA YOGYAKARTA, DAERAH ISTIMEWA YOGYAKARTA",22,117,39,156
https://kawalpemilu.org#42361,"PANEMBAHAN, KRATON, KOTA YOGYAKARTA, DAERAH ISTIMEWA YOGYAKARTA",23,87,28,115
https://kawalpemilu.org#42361,"PANEMBAHAN, KRATON, KOTA YOGYAKARTA, DAERAH ISTIMEWA YOGYAKARTA",24,109,70,179
https://kawalpemilu.org#42361,"PANEMBAHAN, KRATON, KOTA YOGYAKARTA, DAERAH ISTIMEWA YOGYAKARTA",25,99,61,160
https://kawalpemilu.org#42361,"PANEMBAHAN, KRATON, KOTA YOGYAKARTA, DAERAH ISTIMEWA YOGYAKARTA",27,105,39,144
https://kawalpemilu.org#42361,"PANEMBAHAN, KRATON, KOTA YOGYAKARTA, DAERAH ISTIMEWA YOGYAKARTA",28,156,32,188
https://kawalpemilu.org#42361,"PANEMBAHAN, KRATON, KOTA YOGYAKARTA, DAERAH ISTIMEWA YOGYAKARTA",29,109,56,165
https://kawalpemilu.org#42361,"PANEMBAHAN, KRATON, KOTA YOGYAKARTA, DAERAH ISTIMEWA YOGYAKARTA",30,132,63,195
https://kawalpemilu.org#42361,"PANEMBAHAN, KRATON, KOTA YOGYAKARTA, DAERAH ISTIMEWA YOGYAKARTA",31,193,58,251
https://kawalpemilu.org#42361,"PANEMBAHAN, KRATON, KOTA YOGYAKARTA, DAERAH ISTIMEWA YOGYAKARTA",32,135,39,174
https://kawalpemilu.org#42361,"PANEMBAHAN, KRATON, KOTA YOGYAKARTA, DAERAH ISTIMEWA YOGYAKARTA",33,104,61,165
https://kawalpemilu.org#42361,"PANEMBAHAN, KRATON, KOTA YOGYAKARTA, DAERAH ISTIMEWA YOGYAKARTA",34,161,62,223
https://kawalpemilu.org#42361,"PANEMBAHAN, KRATON, KOTA YOGYAKARTA, DAERAH ISTIMEWA YOGYAKARTA",35,66,34,100
https://kawalpemilu.org#42362,"KADIPATEN, KRATON, KOTA YOGYAKARTA, DAERAH ISTIMEWA YOGYAKARTA",1,65,76,141
https://kawalpemilu.org#42362,"KADIPATEN, KRATON, KOTA YOGYAKARTA, DAERAH ISTIMEWA YOGYAKARTA",2,102,65,167
https://kawalpemilu.org#42362,"KADIPATEN, KRATON, KOTA YOGYAKARTA, DAERAH ISTIMEWA YOGYAKARTA",3,108,39,147
https://kawalpemilu.org#42362,"KADIPATEN, KRATON, KOTA YOGYAKARTA, DAERAH ISTIMEWA YOGYAKARTA",4,94,42,136
https://kawalpemilu.org#42362,"KADIPATEN, KRATON, KOTA YOGYAKARTA, DAERAH ISTIMEWA YOGYAKARTA",5,139,59,198
https://kawalpemilu.org#42362,"KADIPATEN, KRATON, KOTA YOGYAKARTA, DAERAH ISTIMEWA YOGYAKARTA",6,148,71,219
https://kawalpemilu.org#42362,"KADIPATEN, KRATON, KOTA YOGYAKARTA, DAERAH ISTIMEWA YOGYAKARTA",7,80,126,206
https://kawalpemilu.org#42362,"KADIPATEN, KRATON, KOTA YOGYAKARTA, DAERAH ISTIMEWA YOGYAKARTA",8,74,133,207
https://kawalpemilu.org#42362,"KADIPATEN, KRATON, KOTA YOGYAKARTA, DAERAH ISTIMEWA YOGYAKARTA",9,91,67,158
https://kawalpemilu.org#42362,"KADIPATEN, KRATON, KOTA YOGYAKARTA, DAERAH ISTIMEWA YOGYAKARTA",10,93,48,141
https://kawalpemilu.org#42362,"KADIPATEN, KRATON, KOTA YOGYAKARTA, DAERAH ISTIMEWA YOGYAKARTA",11,50,129,179
https://kawalpemilu.org#42362,"KADIPATEN, KRATON, KOTA YOGYAKARTA, DAERAH ISTIMEWA YOGYAKARTA",12,77,88,165
https://kawalpemilu.org#42362,"KADIPATEN, KRATON, KOTA YOGYAKARTA, DAERAH ISTIMEWA YOGYAKARTA",13,114,40,154
https://kawalpemilu.org#42362,"KADIPATEN, KRATON, KOTA YOGYAKARTA, DAERAH ISTIMEWA YOGYAKARTA",14,99,59,158
https://kawalpemilu.org#42362,"KADIPATEN, KRATON, KOTA YOGYAKARTA, DAERAH ISTIMEWA YOGYAKARTA",15,94,65,159
https://kawalpemilu.org#42362,"KADIPATEN, KRATON, KOTA YOGYAKARTA, DAERAH ISTIMEWA YOGYAKARTA",16,96,78,174
https://kawalpemilu.org#42362,"KADIPATEN, KRATON, KOTA YOGYAKARTA, DAERAH ISTIMEWA YOGYAKARTA",17,91,31,122
https://kawalpemilu.org#42362,"KADIPATEN, KRATON, KOTA YOGYAKARTA, DAERAH ISTIMEWA YOGYAKARTA",18,101,58,159
https://kawalpemilu.org#42362,"KADIPATEN, KRATON, KOTA YOGYAKARTA, DAERAH ISTIMEWA YOGYAKARTA",19,129,108,237
https://kawalpemilu.org#42362,"KADIPATEN, KRATON, KOTA YOGYAKARTA, DAERAH ISTIMEWA YOGYAKARTA",20,156,80,236
https://kawalpemilu.org#42362,"KADIPATEN, KRATON, KOTA YOGYAKARTA, DAERAH ISTIMEWA YOGYAKARTA",21,99,55,154
https://kawalpemilu.org#42362,"KADIPATEN, KRATON, KOTA YOGYAKARTA, DAERAH ISTIMEWA YOGYAKARTA",22,90,47,137
https://kawalpemilu.org#42362,"KADIPATEN, KRATON, KOTA YOGYAKARTA, DAERAH ISTIMEWA YOGYAKARTA",23,118,53,171
https://kawalpemilu.org#42362,"KADIPATEN, KRATON, KOTA YOGYAKARTA, DAERAH ISTIMEWA YOGYAKARTA",24,118,62,180
https://kawalpemilu.org#42362,"KADIPATEN, KRATON, KOTA YOGYAKARTA, DAERAH ISTIMEWA YOGYAKARTA",25,138,53,191
https://kawalpemilu.org#42362,"KADIPATEN, KRATON, KOTA YOGYAKARTA, DAERAH ISTIMEWA YOGYAKARTA",26,77,71,148
https://kawalpemilu.org#42362,"KADIPATEN, KRATON, KOTA YOGYAKARTA, DAERAH ISTIMEWA YOGYAKARTA",27,84,37,121
https://kawalpemilu.org#42364,"NGUPASAN, GONDOMANAN, KOTA YOGYAKARTA, DAERAH ISTIMEWA YOGYAKARTA",1,212,16,228
https://kawalpemilu.org#42364,"NGUPASAN, GONDOMANAN, KOTA YOGYAKARTA, DAERAH ISTIMEWA YOGYAKARTA",2,166,16,182
https://kawalpemilu.org#42364,"NGUPASAN, GONDOMANAN, KOTA YOGYAKARTA, DAERAH ISTIMEWA YOGYAKARTA",3,169,4,173
https://kawalpemilu.org#42364,"NGUPASAN, GONDOMANAN, KOTA YOGYAKARTA, DAERAH ISTIMEWA YOGYAKARTA",4,107,65,172
https://kawalpemilu.org#42364,"NGUPASAN, GONDOMANAN, KOTA YOGYAKARTA, DAERAH ISTIMEWA YOGYAKARTA",5,155,26,181
https://kawalpemilu.org#42364,"NGUPASAN, GONDOMANAN, KOTA YOGYAKARTA, DAERAH ISTIMEWA YOGYAKARTA",6,192,26,218
https://kawalpemilu.org#42364,"NGUPASAN, GONDOMANAN, KOTA YOGYAKARTA, DAERAH ISTIMEWA YOGYAKARTA",7,199,8,207
https://kawalpemilu.org#42364,"NGUPASAN, GONDOMANAN, KOTA YOGYAKARTA, DAERAH ISTIMEWA YOGYAKARTA",8,135,30,165
https://kawalpemilu.org#42364,"NGUPASAN, GONDOMANAN, KOTA YOGYAKARTA, DAERAH ISTIMEWA YOGYAKARTA",9,180,52,232
https://kawalpemilu.org#42364,"NGUPASAN, GONDOMANAN, KOTA YOGYAKARTA, DAERAH ISTIMEWA YOGYAKARTA",10,173,69,242
https://kawalpemilu.org#42364,"NGUPASAN, GONDOMANAN, KOTA YOGYAKARTA, DAERAH ISTIMEWA YOGYAKARTA",11,203,21,224
https://kawalpemilu.org#42364,"NGUPASAN, GONDOMANAN, KOTA YOGYAKARTA, DAERAH ISTIMEWA YOGYAKARTA",12,37,182,219
https://kawalpemilu.org#42364,"NGUPASAN, GONDOMANAN, KOTA YOGYAKARTA, DAERAH ISTIMEWA YOGYAKARTA",13,74,171,245
https://kawalpemilu.org#42364,"NGUPASAN, GONDOMANAN, KOTA YOGYAKARTA, DAERAH ISTIMEWA YOGYAKARTA",14,28,178,206
https://kawalpemilu.org#42364,"NGUPASAN, GONDOMANAN, KOTA YOGYAKARTA, DAERAH ISTIMEWA YOGYAKARTA",15,61,184,245
https://kawalpemilu.org#42364,"NGUPASAN, GONDOMANAN, KOTA YOGYAKARTA, DAERAH ISTIMEWA YOGYAKARTA",16,40,204,244
https://kawalpemilu.org#42364,"NGUPASAN, GONDOMANAN, KOTA YOGYAKARTA, DAERAH ISTIMEWA YOGYAKARTA",17,25,172,197
https://kawalpemilu.org#42364,"NGUPASAN, GONDOMANAN, KOTA YOGYAKARTA, DAERAH ISTIMEWA YOGYAKARTA",18,50,180,230
https://kawalpemilu.org#42365,"PRAWIRODIRJAN, GONDOMANAN, KOTA YOGYAKARTA, DAERAH ISTIMEWA YOGYAKARTA",1,140,80,220
https://kawalpemilu.org#42365,"PRAWIRODIRJAN, GONDOMANAN, KOTA YOGYAKARTA, DAERAH ISTIMEWA YOGYAKARTA",2,144,78,222
https://kawalpemilu.org#42365,"PRAWIRODIRJAN, GONDOMANAN, KOTA YOGYAKARTA, DAERAH ISTIMEWA YOGYAKARTA",3,138,25,163
https://kawalpemilu.org#42365,"PRAWIRODIRJAN, GONDOMANAN, KOTA YOGYAKARTA, DAERAH ISTIMEWA YOGYAKARTA",4,128,43,171
https://kawalpemilu.org#42365,"PRAWIRODIRJAN, GONDOMANAN, KOTA YOGYAKARTA, DAERAH ISTIMEWA YOGYAKARTA",5,158,66,224
https://kawalpemilu.org#42365,"PRAWIRODIRJAN, GONDOMANAN, KOTA YOGYAKARTA, DAERAH ISTIMEWA YOGYAKARTA",6,119,79,198
https://kawalpemilu.org#42365,"PRAWIRODIRJAN, GONDOMANAN, KOTA YOGYAKARTA, DAERAH ISTIMEWA YOGYAKARTA",7,141,26,167
https://kawalpemilu.org#42365,"PRAWIRODIRJAN, GONDOMANAN, KOTA YOGYAKARTA, DAERAH ISTIMEWA YOGYAKARTA",8,97,24,121
https://kawalpemilu.org#42365,"PRAWIRODIRJAN, GONDOMANAN, KOTA YOGYAKARTA, DAERAH ISTIMEWA YOGYAKARTA",9,127,15,142
https://kawalpemilu.org#42365,"PRAWIRODIRJAN, GONDOMANAN, KOTA YOGYAKARTA, DAERAH ISTIMEWA YOGYAKARTA",10,117,35,152
https://kawalpemilu.org#42365,"PRAWIRODIRJAN, GONDOMANAN, KOTA YOGYAKARTA, DAERAH ISTIMEWA YOGYAKARTA",11,169,66,235
https://kawalpemilu.org#42365,"PRAWIRODIRJAN, GONDOMANAN, KOTA YOGYAKARTA, DAERAH ISTIMEWA YOGYAKARTA",12,175,70,245
https://kawalpemilu.org#42365,"PRAWIRODIRJAN, GONDOMANAN, KOTA YOGYAKARTA, DAERAH ISTIMEWA YOGYAKARTA",13,164,23,187
https://kawalpemilu.org#42365,"PRAWIRODIRJAN, GONDOMANAN, KOTA YOGYAKARTA, DAERAH ISTIMEWA YOGYAKARTA",14,120,49,169
https://kawalpemilu.org#42365,"PRAWIRODIRJAN, GONDOMANAN, KOTA YOGYAKARTA, DAERAH ISTIMEWA YOGYAKARTA",15,165,77,242
https://kawalpemilu.org#42365,"PRAWIRODIRJAN, GONDOMANAN, KOTA YOGYAKARTA, DAERAH ISTIMEWA YOGYAKARTA",16,176,67,243
https://kawalpemilu.org#42365,"PRAWIRODIRJAN, GONDOMANAN, KOTA YOGYAKARTA, DAERAH ISTIMEWA YOGYAKARTA",17,146,91,237
https://kawalpemilu.org#42365,"PRAWIRODIRJAN, GONDOMANAN, KOTA YOGYAKARTA, DAERAH ISTIMEWA YOGYAKARTA",18,183,49,232
https://kawalpemilu.org#42365,"PRAWIRODIRJAN, GONDOMANAN, KOTA YOGYAKARTA, DAERAH ISTIMEWA YOGYAKARTA",19,109,29,138
https://kawalpemilu.org#42365,"PRAWIRODIRJAN, GONDOMANAN, KOTA YOGYAKARTA, DAERAH ISTIMEWA YOGYAKARTA",20,180,44,224
https://kawalpemilu.org#42365,"PRAWIRODIRJAN, GONDOMANAN, KOTA YOGYAKARTA, DAERAH ISTIMEWA YOGYAKARTA",21,123,44,167
https://kawalpemilu.org#42365,"PRAWIRODIRJAN, GONDOMANAN, KOTA YOGYAKARTA, DAERAH ISTIMEWA YOGYAKARTA",22,225,26,251
https://kawalpemilu.org#42365,"PRAWIRODIRJAN, GONDOMANAN, KOTA YOGYAKARTA, DAERAH ISTIMEWA YOGYAKARTA",23,105,62,167
https://kawalpemilu.org#42365,"PRAWIRODIRJAN, GONDOMANAN, KOTA YOGYAKARTA, DAERAH ISTIMEWA YOGYAKARTA",24,138,43,181
https://kawalpemilu.org#42365,"PRAWIRODIRJAN, GONDOMANAN, KOTA YOGYAKARTA, DAERAH ISTIMEWA YOGYAKARTA",25,173,60,233
https://kawalpemilu.org#42365,"PRAWIRODIRJAN, GONDOMANAN, KOTA YOGYAKARTA, DAERAH ISTIMEWA YOGYAKARTA",26,176,56,232
https://kawalpemilu.org#42365,"PRAWIRODIRJAN, GONDOMANAN, KOTA YOGYAKARTA, DAERAH ISTIMEWA YOGYAKARTA",27,170,31,201
https://kawalpemilu.org#42365,"PRAWIRODIRJAN, GONDOMANAN, KOTA YOGYAKARTA, DAERAH ISTIMEWA YOGYAKARTA",28,152,38,190
https://kawalpemilu.org#42365,"PRAWIRODIRJAN, GONDOMANAN, KOTA YOGYAKARTA, DAERAH ISTIMEWA YOGYAKARTA",29,147,49,196
https://kawalpemilu.org#42365,"PRAWIRODIRJAN, GONDOMANAN, KOTA YOGYAKARTA, DAERAH ISTIMEWA YOGYAKARTA",30,129,54,183
https://kawalpemilu.org#42365,"PRAWIRODIRJAN, GONDOMANAN, KOTA YOGYAKARTA, DAERAH ISTIMEWA YOGYAKARTA",31,119,41,160
https://kawalpemilu.org#42367,"PURWOKINANTI, PAKUALAMAN, KOTA YOGYAKARTA, DAERAH ISTIMEWA YOGYAKARTA",1,184,22,206
https://kawalpemilu.org#42367,"PURWOKINANTI, PAKUALAMAN, KOTA YOGYAKARTA, DAERAH ISTIMEWA YOGYAKARTA",2,152,41,193
https://kawalpemilu.org#42367,"PURWOKINANTI, PAKUALAMAN, KOTA YOGYAKARTA, DAERAH ISTIMEWA YOGYAKARTA",3,138,15,153
https://kawalpemilu.org#42367,"PURWOKINANTI, PAKUALAMAN, KOTA YOGYAKARTA, DAERAH ISTIMEWA YOGYAKARTA",4,127,55,182
https://kawalpemilu.org#42367,"PURWOKINANTI, PAKUALAMAN, KOTA YOGYAKARTA, DAERAH ISTIMEWA YOGYAKARTA",5,105,33,138
https://kawalpemilu.org#42367,"PURWOKINANTI, PAKUALAMAN, KOTA YOGYAKARTA, DAERAH ISTIMEWA YOGYAKARTA",6,96,49,145
https://kawalpemilu.org#42367,"PURWOKINANTI, PAKUALAMAN, KOTA YOGYAKARTA, DAERAH ISTIMEWA YOGYAKARTA",7,129,63,192
https://kawalpemilu.org#42367,"PURWOKINANTI, PAKUALAMAN, KOTA YOGYAKARTA, DAERAH ISTIMEWA YOGYAKARTA",8,120,53,173
https://kawalpemilu.org#42367,"PURWOKINANTI, PAKUALAMAN, KOTA YOGYAKARTA, DAERAH ISTIMEWA YOGYAKARTA",9,135,24,159
https://kawalpemilu.org#42367,"PURWOKINANTI, PAKUALAMAN, KOTA YOGYAKARTA, DAERAH ISTIMEWA YOGYAKARTA",10,110,32,142
https://kawalpemilu.org#42367,"PURWOKINANTI, PAKUALAMAN, KOTA YOGYAKARTA, DAERAH ISTIMEWA YOGYAKARTA",11,132,75,207
https://kawalpemilu.org#42367,"PURWOKINANTI, PAKUALAMAN, KOTA YOGYAKARTA, DAERAH ISTIMEWA YOGYAKARTA",12,153,65,218
https://kawalpemilu.org#42367,"PURWOKINANTI, PAKUALAMAN, KOTA YOGYAKARTA, DAERAH ISTIMEWA YOGYAKARTA",13,161,26,187
https://kawalpemilu.org#42367,"PURWOKINANTI, PAKUALAMAN, KOTA YOGYAKARTA, DAERAH ISTIMEWA YOGYAKARTA",14,121,25,146
https://kawalpemilu.org#42367,"PURWOKINANTI, PAKUALAMAN, KOTA YOGYAKARTA, DAERAH ISTIMEWA YOGYAKARTA",15,147,19,166
https://kawalpemilu.org#42367,"PURWOKINANTI, PAKUALAMAN, KOTA YOGYAKARTA, DAERAH ISTIMEWA YOGYAKARTA",16,80,38,118
https://kawalpemilu.org#42367,"PURWOKINANTI, PAKUALAMAN, KOTA YOGYAKARTA, DAERAH ISTIMEWA YOGYAKARTA",17,127,56,183
https://kawalpemilu.org#42367,"PURWOKINANTI, PAKUALAMAN, KOTA YOGYAKARTA, DAERAH ISTIMEWA YOGYAKARTA",18,149,46,195
https://kawalpemilu.org#42367,"PURWOKINANTI, PAKUALAMAN, KOTA YOGYAKARTA, DAERAH ISTIMEWA YOGYAKARTA",19,81,30,111
https://kawalpemilu.org#42367,"PURWOKINANTI, PAKUALAMAN, KOTA YOGYAKARTA, DAERAH ISTIMEWA YOGYAKARTA",20,120,64,184
https://kawalpemilu.org#42367,"PURWOKINANTI, PAKUALAMAN, KOTA YOGYAKARTA, DAERAH ISTIMEWA YOGYAKARTA",21,152,71,223
https://kawalpemilu.org#42367,"PURWOKINANTI, PAKUALAMAN, KOTA YOGYAKARTA, DAERAH ISTIMEWA YOGYAKARTA",22,144,59,203
https://kawalpemilu.org#42367,"PURWOKINANTI, PAKUALAMAN, KOTA YOGYAKARTA, DAERAH ISTIMEWA YOGYAKARTA",23,146,83,229
https://kawalpemilu.org#42368,"GUNUNGKETUR, PAKUALAMAN, KOTA YOGYAKARTA, DAERAH ISTIMEWA YOGYAKARTA",1,159,27,186
https://kawalpemilu.org#42368,"GUNUNGKETUR, PAKUALAMAN, KOTA YOGYAKARTA, DAERAH ISTIMEWA YOGYAKARTA",2,138,56,194
https://kawalpemilu.org#42368,"GUNUNGKETUR, PAKUALAMAN, KOTA YOGYAKARTA, DAERAH ISTIMEWA YOGYAKARTA",3,141,38,179
https://kawalpemilu.org#42368,"GUNUNGKETUR, PAKUALAMAN, KOTA YOGYAKARTA, DAERAH ISTIMEWA YOGYAKARTA",4,143,44,187
https://kawalpemilu.org#42368,"GUNUNGKETUR, PAKUALAMAN, KOTA YOGYAKARTA, DAERAH ISTIMEWA YOGYAKARTA",5,138,52,190
https://kawalpemilu.org#42368,"GUNUNGKETUR, PAKUALAMAN, KOTA YOGYAKARTA, DAERAH ISTIMEWA YOGYAKARTA",6,166,56,222
https://kawalpemilu.org#42368,"GUNUNGKETUR, PAKUALAMAN, KOTA YOGYAKARTA, DAERAH ISTIMEWA YOGYAKARTA",7,120,50,170
https://kawalpemilu.org#42368,"GUNUNGKETUR, PAKUALAMAN, KOTA YOGYAKARTA, DAERAH ISTIMEWA YOGYAKARTA",8,119,47,166
https://kawalpemilu.org#42368,"GUNUNGKETUR, PAKUALAMAN, KOTA YOGYAKARTA, DAERAH ISTIMEWA YOGYAKARTA",9,125,62,187
https://kawalpemilu.org#42368,"GUNUNGKETUR, PAKUALAMAN, KOTA YOGYAKARTA, DAERAH ISTIMEWA YOGYAKARTA",10,124,25,149
https://kawalpemilu.org#42368,"GUNUNGKETUR, PAKUALAMAN, KOTA YOGYAKARTA, DAERAH ISTIMEWA YOGYAKARTA",11,90,50,140
https://kawalpemilu.org#42368,"GUNUNGKETUR, PAKUALAMAN, KOTA YOGYAKARTA, DAERAH ISTIMEWA YOGYAKARTA",12,146,41,187
https://kawalpemilu.org#42368,"GUNUNGKETUR, PAKUALAMAN, KOTA YOGYAKARTA, DAERAH ISTIMEWA YOGYAKARTA",13,163,51,214
https://kawalpemilu.org#42368,"GUNUNGKETUR, PAKUALAMAN, KOTA YOGYAKARTA, DAERAH ISTIMEWA YOGYAKARTA",14,135,73,208
https://kawalpemilu.org#42368,"GUNUNGKETUR, PAKUALAMAN, KOTA YOGYAKARTA, DAERAH ISTIMEWA YOGYAKARTA",15,42,130,172
https://kawalpemilu.org#42368,"GUNUNGKETUR, PAKUALAMAN, KOTA YOGYAKARTA, DAERAH ISTIMEWA YOGYAKARTA",16,50,143,193
https://kawalpemilu.org#42368,"GUNUNGKETUR, PAKUALAMAN, KOTA YOGYAKARTA, DAERAH ISTIMEWA YOGYAKARTA",17,82,50,132
https://kawalpemilu.org#42368,"GUNUNGKETUR, PAKUALAMAN, KOTA YOGYAKARTA, DAERAH ISTIMEWA YOGYAKARTA",18,129,98,227
https://kawalpemilu.org#42368,"GUNUNGKETUR, PAKUALAMAN, KOTA YOGYAKARTA, DAERAH ISTIMEWA YOGYAKARTA",19,81,31,112
https://kawalpemilu.org#42370,"KEPARAKAN, MERGANGSAN, KOTA YOGYAKARTA, DAERAH ISTIMEWA YOGYAKARTA",1,149,53,202
https://kawalpemilu.org#42370,"KEPARAKAN, MERGANGSAN, KOTA YOGYAKARTA, DAERAH ISTIMEWA YOGYAKARTA",2,147,75,222
https://kawalpemilu.org#42370,"KEPARAKAN, MERGANGSAN, KOTA YOGYAKARTA, DAERAH ISTIMEWA YOGYAKARTA",3,102,73,175
https://kawalpemilu.org#42370,"KEPARAKAN, MERGANGSAN, KOTA YOGYAKARTA, DAERAH ISTIMEWA YOGYAKARTA",4,136,36,172
https://kawalpemilu.org#42370,"KEPARAKAN, MERGANGSAN, KOTA YOGYAKARTA, DAERAH ISTIMEWA YOGYAKARTA",5,85,49,134
https://kawalpemilu.org#42370,"KEPARAKAN, MERGANGSAN, KOTA YOGYAKARTA, DAERAH ISTIMEWA YOGYAKARTA",6,178,56,234
https://kawalpemilu.org#42370,"KEPARAKAN, MERGANGSAN, KOTA YOGYAKARTA, DAERAH ISTIMEWA YOGYAKARTA",7,125,35,160
https://kawalpemilu.org#42370,"KEPARAKAN, MERGANGSAN, KOTA YOGYAKARTA, DAERAH ISTIMEWA YOGYAKARTA",8,101,21,122
https://kawalpemilu.org#42370,"KEPARAKAN, MERGANGSAN, KOTA YOGYAKARTA, DAERAH ISTIMEWA YOGYAKARTA",9,97,32,129
https://kawalpemilu.org#42370,"KEPARAKAN, MERGANGSAN, KOTA YOGYAKARTA, DAERAH ISTIMEWA YOGYAKARTA",10,104,67,171
https://kawalpemilu.org#42370,"KEPARAKAN, MERGANGSAN, KOTA YOGYAKARTA, DAERAH ISTIMEWA YOGYAKARTA",11,86,52,138
https://kawalpemilu.org#42370,"KEPARAKAN, MERGANGSAN, KOTA YOGYAKARTA, DAERAH ISTIMEWA YOGYAKARTA",12,109,50,159
https://kawalpemilu.org#42370,"KEPARAKAN, MERGANGSAN, KOTA YOGYAKARTA, DAERAH ISTIMEWA YOGYAKARTA",13,116,58,174
https://kawalpemilu.org#42370,"KEPARAKAN, MERGANGSAN, KOTA YOGYAKARTA, DAERAH ISTIMEWA YOGYAKARTA",14,119,33,152
https://kawalpemilu.org#42370,"KEPARAKAN, MERGANGSAN, KOTA YOGYAKARTA, DAERAH ISTIMEWA YOGYAKARTA",15,127,41,168
https://kawalpemilu.org#42370,"KEPARAKAN, MERGANGSAN, KOTA YOGYAKARTA, DAERAH ISTIMEWA YOGYAKARTA",16,140,34,174
https://kawalpemilu.org#42370,"KEPARAKAN, MERGANGSAN, KOTA YOGYAKARTA, DAERAH ISTIMEWA YOGYAKARTA",17,176,15,191
https://kawalpemilu.org#42370,"KEPARAKAN, MERGANGSAN, KOTA YOGYAKARTA, DAERAH ISTIMEWA YOGYAKARTA",18,86,36,122
https://kawalpemilu.org#42370,"KEPARAKAN, MERGANGSAN, KOTA YOGYAKARTA, DAERAH ISTIMEWA YOGYAKARTA",19,145,71,216
https://kawalpemilu.org#42370,"KEPARAKAN, MERGANGSAN, KOTA YOGYAKARTA, DAERAH ISTIMEWA YOGYAKARTA",20,194,38,232
https://kawalpemilu.org#42370,"KEPARAKAN, MERGANGSAN, KOTA YOGYAKARTA, DAERAH ISTIMEWA YOGYAKARTA",21,122,17,139
https://kawalpemilu.org#42370,"KEPARAKAN, MERGANGSAN, KOTA YOGYAKARTA, DAERAH ISTIMEWA YOGYAKARTA",22,192,47,239
https://kawalpemilu.org#42370,"KEPARAKAN, MERGANGSAN, KOTA YOGYAKARTA, DAERAH ISTIMEWA YOGYAKARTA",23,144,24,168
https://kawalpemilu.org#42370,"KEPARAKAN, MERGANGSAN, KOTA YOGYAKARTA, DAERAH ISTIMEWA YOGYAKARTA",24,149,41,190
https://kawalpemilu.org#42370,"KEPARAKAN, MERGANGSAN, KOTA YOGYAKARTA, DAERAH ISTIMEWA YOGYAKARTA",25,107,44,151
https://kawalpemilu.org#42370,"KEPARAKAN, MERGANGSAN, KOTA YOGYAKARTA, DAERAH ISTIMEWA YOGYAKARTA",26,140,26,166
https://kawalpemilu.org#42370,"KEPARAKAN, MERGANGSAN, KOTA YOGYAKARTA, DAERAH ISTIMEWA YOGYAKARTA",27,67,55,122
https://kawalpemilu.org#42370,"KEPARAKAN, MERGANGSAN, KOTA YOGYAKARTA, DAERAH ISTIMEWA YOGYAKARTA",28,100,23,123
https://kawalpemilu.org#42370,"KEPARAKAN, MERGANGSAN, KOTA YOGYAKARTA, DAERAH ISTIMEWA YOGYAKARTA",29,152,37,189
https://kawalpemilu.org#42370,"KEPARAKAN, MERGANGSAN, KOTA YOGYAKARTA, DAERAH ISTIMEWA YOGYAKARTA",30,113,46,159
https://kawalpemilu.org#42370,"KEPARAKAN, MERGANGSAN, KOTA YOGYAKARTA, DAERAH ISTIMEWA YOGYAKARTA",31,79,64,143
https://kawalpemilu.org#42370,"KEPARAKAN, MERGANGSAN, KOTA YOGYAKARTA, DAERAH ISTIMEWA YOGYAKARTA",32,118,34,152
https://kawalpemilu.org#42370,"KEPARAKAN, MERGANGSAN, KOTA YOGYAKARTA, DAERAH ISTIMEWA YOGYAKARTA",33,107,44,151
https://kawalpemilu.org#42370,"KEPARAKAN, MERGANGSAN, KOTA YOGYAKARTA, DAERAH ISTIMEWA YOGYAKARTA",34,92,62,154
https://kawalpemilu.org#42370,"KEPARAKAN, MERGANGSAN, KOTA YOGYAKARTA, DAERAH ISTIMEWA YOGYAKARTA",35,185,63,248
https://kawalpemilu.org#42370,"KEPARAKAN, MERGANGSAN, KOTA YOGYAKARTA, DAERAH ISTIMEWA YOGYAKARTA",36,148,61,209
https://kawalpemilu.org#42370,"KEPARAKAN, MERGANGSAN, KOTA YOGYAKARTA, DAERAH ISTIMEWA YOGYAKARTA",37,79,58,137
https://kawalpemilu.org#42370,"KEPARAKAN, MERGANGSAN, KOTA YOGYAKARTA, DAERAH ISTIMEWA YOGYAKARTA",38,176,75,251
https://kawalpemilu.org#42371,"WIROGUNAN, MERGANGSAN, KOTA YOGYAKARTA, DAERAH ISTIMEWA YOGYAKARTA",1,162,48,210
https://kawalpemilu.org#42371,"WIROGUNAN, MERGANGSAN, KOTA YOGYAKARTA, DAERAH ISTIMEWA YOGYAKARTA",2,77,71,148
https://kawalpemilu.org#42371,"WIROGUNAN, MERGANGSAN, KOTA YOGYAKARTA, DAERAH ISTIMEWA YOGYAKARTA",3,173,42,215
https://kawalpemilu.org#42371,"WIROGUNAN, MERGANGSAN, KOTA YOGYAKARTA, DAERAH ISTIMEWA YOGYAKARTA",4,129,61,190
https://kawalpemilu.org#42371,"WIROGUNAN, MERGANGSAN, KOTA YOGYAKARTA, DAERAH ISTIMEWA YOGYAKARTA",5,166,38,204
https://kawalpemilu.org#42371,"WIROGUNAN, MERGANGSAN, KOTA YOGYAKARTA, DAERAH ISTIMEWA YOGYAKARTA",6,126,63,189
https://kawalpemilu.org#42371,"WIROGUNAN, MERGANGSAN, KOTA YOGYAKARTA, DAERAH ISTIMEWA YOGYAKARTA",7,124,32,156
https://kawalpemilu.org#42371,"WIROGUNAN, MERGANGSAN, KOTA YOGYAKARTA, DAERAH ISTIMEWA YOGYAKARTA",8,92,24,116
https://kawalpemilu.org#42371,"WIROGUNAN, MERGANGSAN, KOTA YOGYAKARTA, DAERAH ISTIMEWA YOGYAKARTA",9,153,48,201
https://kawalpemilu.org#42371,"WIROGUNAN, MERGANGSAN, KOTA YOGYAKARTA, DAERAH ISTIMEWA YOGYAKARTA",10,135,42,177
https://kawalpemilu.org#42371,"WIROGUNAN, MERGANGSAN, KOTA YOGYAKARTA, DAERAH ISTIMEWA YOGYAKARTA",11,110,25,135
https://kawalpemilu.org#42371,"WIROGUNAN, MERGANGSAN, KOTA YOGYAKARTA, DAERAH ISTIMEWA YOGYAKARTA",12,86,61,147
https://kawalpemilu.org#42371,"WIROGUNAN, MERGANGSAN, KOTA YOGYAKARTA, DAERAH ISTIMEWA YOGYAKARTA",13,151,44,195
https://kawalpemilu.org#42371,"WIROGUNAN, MERGANGSAN, KOTA YOGYAKARTA, DAERAH ISTIMEWA YOGYAKARTA",14,117,53,170
https://kawalpemilu.org#42371,"WIROGUNAN, MERGANGSAN, KOTA YOGYAKARTA, DAERAH ISTIMEWA YOGYAKARTA",15,141,51,192
https://kawalpemilu.org#42371,"WIROGUNAN, MERGANGSAN, KOTA YOGYAKARTA, DAERAH ISTIMEWA YOGYAKARTA",16,107,98,205
https://kawalpemilu.org#42371,"WIROGUNAN, MERGANGSAN, KOTA YOGYAKARTA, DAERAH ISTIMEWA YOGYAKARTA",17,113,71,184
https://kawalpemilu.org#42371,"WIROGUNAN, MERGANGSAN, KOTA YOGYAKARTA, DAERAH ISTIMEWA YOGYAKARTA",18,109,48,157
https://kawalpemilu.org#42371,"WIROGUNAN, MERGANGSAN, KOTA YOGYAKARTA, DAERAH ISTIMEWA YOGYAKARTA",19,135,89,224
https://kawalpemilu.org#42371,"WIROGUNAN, MERGANGSAN, KOTA YOGYAKARTA, DAERAH ISTIMEWA YOGYAKARTA",20,94,23,117
https://kawalpemilu.org#42371,"WIROGUNAN, MERGANGSAN, KOTA YOGYAKARTA, DAERAH ISTIMEWA YOGYAKARTA",21,94,27,121
https://kawalpemilu.org#42371,"WIROGUNAN, MERGANGSAN, KOTA YOGYAKARTA, DAERAH ISTIMEWA YOGYAKARTA",22,120,72,192
https://kawalpemilu.org#42371,"WIROGUNAN, MERGANGSAN, KOTA YOGYAKARTA, DAERAH ISTIMEWA YOGYAKARTA",23,126,98,224
https://kawalpemilu.org#42371,"WIROGUNAN, MERGANGSAN, KOTA YOGYAKARTA, DAERAH ISTIMEWA YOGYAKARTA",24,156,68,224
https://kawalpemilu.org#42371,"WIROGUNAN, MERGANGSAN, KOTA YOGYAKARTA, DAERAH ISTIMEWA YOGYAKARTA",25,89,46,135
https://kawalpemilu.org#42371,"WIROGUNAN, MERGANGSAN, KOTA YOGYAKARTA, DAERAH ISTIMEWA YOGYAKARTA",26,134,24,158
https://kawalpemilu.org#42371,"WIROGUNAN, MERGANGSAN, KOTA YOGYAKARTA, DAERAH ISTIMEWA YOGYAKARTA",27,115,53,168
https://kawalpemilu.org#42371,"WIROGUNAN, MERGANGSAN, KOTA YOGYAKARTA, DAERAH ISTIMEWA YOGYAKARTA",28,92,34,126
https://kawalpemilu.org#42371,"WIROGUNAN, MERGANGSAN, KOTA YOGYAKARTA, DAERAH ISTIMEWA YOGYAKARTA",29,110,20,130
https://kawalpemilu.org#42371,"WIROGUNAN, MERGANGSAN, KOTA YOGYAKARTA, DAERAH ISTIMEWA YOGYAKARTA",30,91,15,106
https://kawalpemilu.org#42371,"WIROGUNAN, MERGANGSAN, KOTA YOGYAKARTA, DAERAH ISTIMEWA YOGYAKARTA",31,126,20,146
https://kawalpemilu.org#42371,"WIROGUNAN, MERGANGSAN, KOTA YOGYAKARTA, DAERAH ISTIMEWA YOGYAKARTA",32,111,33,144
https://kawalpemilu.org#42371,"WIROGUNAN, MERGANGSAN, KOTA YOGYAKARTA, DAERAH ISTIMEWA YOGYAKARTA",33,160,63,223
https://kawalpemilu.org#42371,"WIROGUNAN, MERGANGSAN, KOTA YOGYAKARTA, DAERAH ISTIMEWA YOGYAKARTA",34,113,44,157
https://kawalpemilu.org#42371,"WIROGUNAN, MERGANGSAN, KOTA YOGYAKARTA, DAERAH ISTIMEWA YOGYAKARTA",35,110,50,160
https://kawalpemilu.org#42371,"WIROGUNAN, MERGANGSAN, KOTA YOGYAKARTA, DAERAH ISTIMEWA YOGYAKARTA",36,73,66,139
https://kawalpemilu.org#42371,"WIROGUNAN, MERGANGSAN, KOTA YOGYAKARTA, DAERAH ISTIMEWA YOGYAKARTA",37,109,33,142
https://kawalpemilu.org#42371,"WIROGUNAN, MERGANGSAN, KOTA YOGYAKARTA, DAERAH ISTIMEWA YOGYAKARTA",38,150,45,195
https://kawalpemilu.org#42371,"WIROGUNAN, MERGANGSAN, KOTA YOGYAKARTA, DAERAH ISTIMEWA YOGYAKARTA",39,130,66,196
https://kawalpemilu.org#42371,"WIROGUNAN, MERGANGSAN, KOTA YOGYAKARTA, DAERAH ISTIMEWA YOGYAKARTA",40,118,73,191
https://kawalpemilu.org#42371,"WIROGUNAN, MERGANGSAN, KOTA YOGYAKARTA, DAERAH ISTIMEWA YOGYAKARTA",41,143,56,199
https://kawalpemilu.org#42371,"WIROGUNAN, MERGANGSAN, KOTA YOGYAKARTA, DAERAH ISTIMEWA YOGYAKARTA",42,76,62,138
https://kawalpemilu.org#42371,"WIROGUNAN, MERGANGSAN, KOTA YOGYAKARTA, DAERAH ISTIMEWA YOGYAKARTA",43,103,85,188
https://kawalpemilu.org#42371,"WIROGUNAN, MERGANGSAN, KOTA YOGYAKARTA, DAERAH ISTIMEWA YOGYAKARTA",44,143,72,215
https://kawalpemilu.org#42372,"BRONTOKUSUMAN, MERGANGSAN, KOTA YOGYAKARTA, DAERAH ISTIMEWA YOGYAKARTA",1,90,70,160
https://kawalpemilu.org#42372,"BRONTOKUSUMAN, MERGANGSAN, KOTA YOGYAKARTA, DAERAH ISTIMEWA YOGYAKARTA",2,141,56,197
https://kawalpemilu.org#42372,"BRONTOKUSUMAN, MERGANGSAN, KOTA YOGYAKARTA, DAERAH ISTIMEWA YOGYAKARTA",3,72,50,122
https://kawalpemilu.org#42372,"BRONTOKUSUMAN, MERGANGSAN, KOTA YOGYAKARTA, DAERAH ISTIMEWA YOGYAKARTA",4,107,72,179
https://kawalpemilu.org#42372,"BRONTOKUSUMAN, MERGANGSAN, KOTA YOGYAKARTA, DAERAH ISTIMEWA YOGYAKARTA",5,139,36,175
https://kawalpemilu.org#42372,"BRONTOKUSUMAN, MERGANGSAN, KOTA YOGYAKARTA, DAERAH ISTIMEWA YOGYAKARTA",6,114,56,170
https://kawalpemilu.org#42372,"BRONTOKUSUMAN, MERGANGSAN, KOTA YOGYAKARTA, DAERAH ISTIMEWA YOGYAKARTA",7,74,30,104
https://kawalpemilu.org#42372,"BRONTOKUSUMAN, MERGANGSAN, KOTA YOGYAKARTA, DAERAH ISTIMEWA YOGYAKARTA",8,107,41,148
https://kawalpemilu.org#42372,"BRONTOKUSUMAN, MERGANGSAN, KOTA YOGYAKARTA, DAERAH ISTIMEWA YOGYAKARTA",9,153,68,221
https://kawalpemilu.org#42372,"BRONTOKUSUMAN, MERGANGSAN, KOTA YOGYAKARTA, DAERAH ISTIMEWA YOGYAKARTA",10,129,32,161
https://kawalpemilu.org#42372,"BRONTOKUSUMAN, MERGANGSAN, KOTA YOGYAKARTA, DAERAH ISTIMEWA YOGYAKARTA",11,80,44,124
https://kawalpemilu.org#42372,"BRONTOKUSUMAN, MERGANGSAN, KOTA YOGYAKARTA, DAERAH ISTIMEWA YOGYAKARTA",12,138,41,179
https://kawalpemilu.org#42372,"BRONTOKUSUMAN, MERGANGSAN, KOTA YOGYAKARTA, DAERAH ISTIMEWA YOGYAKARTA",13,154,70,224
https://kawalpemilu.org#42372,"BRONTOKUSUMAN, MERGANGSAN, KOTA YOGYAKARTA, DAERAH ISTIMEWA YOGYAKARTA",14,121,82,203
https://kawalpemilu.org#42372,"BRONTOKUSUMAN, MERGANGSAN, KOTA YOGYAKARTA, DAERAH ISTIMEWA YOGYAKARTA",15,150,62,212
https://kawalpemilu.org#42372,"BRONTOKUSUMAN, MERGANGSAN, KOTA YOGYAKARTA, DAERAH ISTIMEWA YOGYAKARTA",16,144,85,229
https://kawalpemilu.org#42372,"BRONTOKUSUMAN, MERGANGSAN, KOTA YOGYAKARTA, DAERAH ISTIMEWA YOGYAKARTA",17,118,57,175
https://kawalpemilu.org#42372,"BRONTOKUSUMAN, MERGANGSAN, KOTA YOGYAKARTA, DAERAH ISTIMEWA YOGYAKARTA",18,93,63,156
https://kawalpemilu.org#42372,"BRONTOKUSUMAN, MERGANGSAN, KOTA YOGYAKARTA, DAERAH ISTIMEWA YOGYAKARTA",19,51,167,218
https://kawalpemilu.org#42372,"BRONTOKUSUMAN, MERGANGSAN, KOTA YOGYAKARTA, DAERAH ISTIMEWA YOGYAKARTA",20,30,155,185
https://kawalpemilu.org#42372,"BRONTOKUSUMAN, MERGANGSAN, KOTA YOGYAKARTA, DAERAH ISTIMEWA YOGYAKARTA",21,44,146,190
https://kawalpemilu.org#42372,"BRONTOKUSUMAN, MERGANGSAN, KOTA YOGYAKARTA, DAERAH ISTIMEWA YOGYAKARTA",22,87,130,217
https://kawalpemilu.org#42372,"BRONTOKUSUMAN, MERGANGSAN, KOTA YOGYAKARTA, DAERAH ISTIMEWA YOGYAKARTA",23,51,148,199
https://kawalpemilu.org#42372,"BRONTOKUSUMAN, MERGANGSAN, KOTA YOGYAKARTA, DAERAH ISTIMEWA YOGYAKARTA",24,51,141,192
https://kawalpemilu.org#42372,"BRONTOKUSUMAN, MERGANGSAN, KOTA YOGYAKARTA, DAERAH ISTIMEWA YOGYAKARTA",25,31,105,136
https://kawalpemilu.org#42372,"BRONTOKUSUMAN, MERGANGSAN, KOTA YOGYAKARTA, DAERAH ISTIMEWA YOGYAKARTA",26,40,111,151
https://kawalpemilu.org#42372,"BRONTOKUSUMAN, MERGANGSAN, KOTA YOGYAKARTA, DAERAH ISTIMEWA YOGYAKARTA",27,52,134,186
https://kawalpemilu.org#42372,"BRONTOKUSUMAN, MERGANGSAN, KOTA YOGYAKARTA, DAERAH ISTIMEWA YOGYAKARTA",28,58,156,214
https://kawalpemilu.org#42372,"BRONTOKUSUMAN, MERGANGSAN, KOTA YOGYAKARTA, DAERAH ISTIMEWA YOGYAKARTA",29,47,71,118
https://kawalpemilu.org#42372,"BRONTOKUSUMAN, MERGANGSAN, KOTA YOGYAKARTA, DAERAH ISTIMEWA YOGYAKARTA",30,52,129,181
https://kawalpemilu.org#42372,"BRONTOKUSUMAN, MERGANGSAN, KOTA YOGYAKARTA, DAERAH ISTIMEWA YOGYAKARTA",31,39,137,176
https://kawalpemilu.org#42372,"BRONTOKUSUMAN, MERGANGSAN, KOTA YOGYAKARTA, DAERAH ISTIMEWA YOGYAKARTA",32,45,64,109
https://kawalpemilu.org#42372,"BRONTOKUSUMAN, MERGANGSAN, KOTA YOGYAKARTA, DAERAH ISTIMEWA YOGYAKARTA",33,67,118,185
https://kawalpemilu.org#42372,"BRONTOKUSUMAN, MERGANGSAN, KOTA YOGYAKARTA, DAERAH ISTIMEWA YOGYAKARTA",34,123,90,213
https://kawalpemilu.org#42372,"BRONTOKUSUMAN, MERGANGSAN, KOTA YOGYAKARTA, DAERAH ISTIMEWA YOGYAKARTA",35,97,48,145
https://kawalpemilu.org#42372,"BRONTOKUSUMAN, MERGANGSAN, KOTA YOGYAKARTA, DAERAH ISTIMEWA YOGYAKARTA",36,95,56,151
https://kawalpemilu.org#42372,"BRONTOKUSUMAN, MERGANGSAN, KOTA YOGYAKARTA, DAERAH ISTIMEWA YOGYAKARTA",37,154,47,201
https://kawalpemilu.org#42372,"BRONTOKUSUMAN, MERGANGSAN, KOTA YOGYAKARTA, DAERAH ISTIMEWA YOGYAKARTA",38,76,79,155
https://kawalpemilu.org#42372,"BRONTOKUSUMAN, MERGANGSAN, KOTA YOGYAKARTA, DAERAH ISTIMEWA YOGYAKARTA",39,78,58,136
https://kawalpemilu.org#42372,"BRONTOKUSUMAN, MERGANGSAN, KOTA YOGYAKARTA, DAERAH ISTIMEWA YOGYAKARTA",40,69,72,141
https://kawalpemilu.org#42372,"BRONTOKUSUMAN, MERGANGSAN, KOTA YOGYAKARTA, DAERAH ISTIMEWA YOGYAKARTA",41,103,67,170
https://kawalpemilu.org#42374,"SEMAKI, UMBULHARJO, KOTA YOGYAKARTA, DAERAH ISTIMEWA YOGYAKARTA",1,145,58,203
https://kawalpemilu.org#42374,"SEMAKI, UMBULHARJO, KOTA YOGYAKARTA, DAERAH ISTIMEWA YOGYAKARTA",2,98,78,176
https://kawalpemilu.org#42374,"SEMAKI, UMBULHARJO, KOTA YOGYAKARTA, DAERAH ISTIMEWA YOGYAKARTA",3,145,77,222
https://kawalpemilu.org#42374,"SEMAKI, UMBULHARJO, KOTA YOGYAKARTA, DAERAH ISTIMEWA YOGYAKARTA",4,151,90,241
https://kawalpemilu.org#42374,"SEMAKI, UMBULHARJO, KOTA YOGYAKARTA, DAERAH ISTIMEWA YOGYAKARTA",5,186,48,234
https://kawalpemilu.org#42374,"SEMAKI, UMBULHARJO, KOTA YOGYAKARTA, DAERAH ISTIMEWA YOGYAKARTA",6,125,70,195
https://kawalpemilu.org#42374,"SEMAKI, UMBULHARJO, KOTA YOGYAKARTA, DAERAH ISTIMEWA YOGYAKARTA",7,91,59,150
https://kawalpemilu.org#42374,"SEMAKI, UMBULHARJO, KOTA YOGYAKARTA, DAERAH ISTIMEWA YOGYAKARTA",8,75,44,119
https://kawalpemilu.org#42374,"SEMAKI, UMBULHARJO, KOTA YOGYAKARTA, DAERAH ISTIMEWA YOGYAKARTA",9,59,73,132
https://kawalpemilu.org#42374,"SEMAKI, UMBULHARJO, KOTA YOGYAKARTA, DAERAH ISTIMEWA YOGYAKARTA",10,131,58,189
https://kawalpemilu.org#42374,"SEMAKI, UMBULHARJO, KOTA YOGYAKARTA, DAERAH ISTIMEWA YOGYAKARTA",11,88,56,144
https://kawalpemilu.org#42374,"SEMAKI, UMBULHARJO, KOTA YOGYAKARTA, DAERAH ISTIMEWA YOGYAKARTA",12,120,87,207
https://kawalpemilu.org#42374,"SEMAKI, UMBULHARJO, KOTA YOGYAKARTA, DAERAH ISTIMEWA YOGYAKARTA",13,161,53,214
https://kawalpemilu.org#42374,"SEMAKI, UMBULHARJO, KOTA YOGYAKARTA, DAERAH ISTIMEWA YOGYAKARTA",14,151,77,228
https://kawalpemilu.org#42374,"SEMAKI, UMBULHARJO, KOTA YOGYAKARTA, DAERAH ISTIMEWA YOGYAKARTA",15,100,82,182
https://kawalpemilu.org#42374,"SEMAKI, UMBULHARJO, KOTA YOGYAKARTA, DAERAH ISTIMEWA YOGYAKARTA",16,91,75,166
https://kawalpemilu.org#42374,"SEMAKI, UMBULHARJO, KOTA YOGYAKARTA, DAERAH ISTIMEWA YOGYAKARTA",17,127,56,183
https://kawalpemilu.org#42374,"SEMAKI, UMBULHARJO, KOTA YOGYAKARTA, DAERAH ISTIMEWA YOGYAKARTA",18,127,34,161
https://kawalpemilu.org#42375,"MUJAMUJU, UMBULHARJO, KOTA YOGYAKARTA, DAERAH ISTIMEWA YOGYAKARTA",1,163,58,221
https://kawalpemilu.org#42375,"MUJAMUJU, UMBULHARJO, KOTA YOGYAKARTA, DAERAH ISTIMEWA YOGYAKARTA",2,126,75,201
https://kawalpemilu.org#42375,"MUJAMUJU, UMBULHARJO, KOTA YOGYAKARTA, DAERAH ISTIMEWA YOGYAKARTA",3,120,90,210
https://kawalpemilu.org#42375,"MUJAMUJU, UMBULHARJO, KOTA YOGYAKARTA, DAERAH ISTIMEWA YOGYAKARTA",4,157,67,224
https://kawalpemilu.org#42375,"MUJAMUJU, UMBULHARJO, KOTA YOGYAKARTA, DAERAH ISTIMEWA YOGYAKARTA",5,180,33,213
https://kawalpemilu.org#42375,"MUJAMUJU, UMBULHARJO, KOTA YOGYAKARTA, DAERAH ISTIMEWA YOGYAKARTA",6,145,75,220
https://kawalpemilu.org#42375,"MUJAMUJU, UMBULHARJO, KOTA YOGYAKARTA, DAERAH ISTIMEWA YOGYAKARTA",7,184,56,240
https://kawalpemilu.org#42375,"MUJAMUJU, UMBULHARJO, KOTA YOGYAKARTA, DAERAH ISTIMEWA YOGYAKARTA",8,174,58,232
https://kawalpemilu.org#42375,"MUJAMUJU, UMBULHARJO, KOTA YOGYAKARTA, DAERAH ISTIMEWA YOGYAKARTA",9,139,75,214
https://kawalpemilu.org#42375,"MUJAMUJU, UMBULHARJO, KOTA YOGYAKARTA, DAERAH ISTIMEWA YOGYAKARTA",10,144,72,216
https://kawalpemilu.org#42375,"MUJAMUJU, UMBULHARJO, KOTA YOGYAKARTA, DAERAH ISTIMEWA YOGYAKARTA",11,152,85,237
https://kawalpemilu.org#42375,"MUJAMUJU, UMBULHARJO, KOTA YOGYAKARTA, DAERAH ISTIMEWA YOGYAKARTA",12,182,63,245
https://kawalpemilu.org#42375,"MUJAMUJU, UMBULHARJO, KOTA YOGYAKARTA, DAERAH ISTIMEWA YOGYAKARTA",13,170,92,262
https://kawalpemilu.org#42375,"MUJAMUJU, UMBULHARJO, KOTA YOGYAKARTA, DAERAH ISTIMEWA YOGYAKARTA",14,164,52,216
https://kawalpemilu.org#42375,"MUJAMUJU, UMBULHARJO, KOTA YOGYAKARTA, DAERAH ISTIMEWA YOGYAKARTA",15,159,78,3
https://kawalpemilu.org#42375,"MUJAMUJU, UMBULHARJO, KOTA YOGYAKARTA, DAERAH ISTIMEWA YOGYAKARTA",16,179,68,247
https://kawalpemilu.org#42375,"MUJAMUJU, UMBULHARJO, KOTA YOGYAKARTA, DAERAH ISTIMEWA YOGYAKARTA",17,130,82,212
https://kawalpemilu.org#42375,"MUJAMUJU, UMBULHARJO, KOTA YOGYAKARTA, DAERAH ISTIMEWA YOGYAKARTA",18,129,65,194
https://kawalpemilu.org#42375,"MUJAMUJU, UMBULHARJO, KOTA YOGYAKARTA, DAERAH ISTIMEWA YOGYAKARTA",19,98,67,165
https://kawalpemilu.org#42375,"MUJAMUJU, UMBULHARJO, KOTA YOGYAKARTA, DAERAH ISTIMEWA YOGYAKARTA",20,107,39,146
https://kawalpemilu.org#42375,"MUJAMUJU, UMBULHARJO, KOTA YOGYAKARTA, DAERAH ISTIMEWA YOGYAKARTA",21,78,51,129
https://kawalpemilu.org#42375,"MUJAMUJU, UMBULHARJO, KOTA YOGYAKARTA, DAERAH ISTIMEWA YOGYAKARTA",22,168,100,268
https://kawalpemilu.org#42375,"MUJAMUJU, UMBULHARJO, KOTA YOGYAKARTA, DAERAH ISTIMEWA YOGYAKARTA",23,119,69,188
https://kawalpemilu.org#42375,"MUJAMUJU, UMBULHARJO, KOTA YOGYAKARTA, DAERAH ISTIMEWA YOGYAKARTA",24,180,66,246
https://kawalpemilu.org#42375,"MUJAMUJU, UMBULHARJO, KOTA YOGYAKARTA, DAERAH ISTIMEWA YOGYAKARTA",25,138,125,263
https://kawalpemilu.org#42375,"MUJAMUJU, UMBULHARJO, KOTA YOGYAKARTA, DAERAH ISTIMEWA YOGYAKARTA",26,147,86,233
https://kawalpemilu.org#42375,"MUJAMUJU, UMBULHARJO, KOTA YOGYAKARTA, DAERAH ISTIMEWA YOGYAKARTA",27,124,127,251
https://kawalpemilu.org#42375,"MUJAMUJU, UMBULHARJO, KOTA YOGYAKARTA, DAERAH ISTIMEWA YOGYAKARTA",28,120,110,230
https://kawalpemilu.org#42375,"MUJAMUJU, UMBULHARJO, KOTA YOGYAKARTA, DAERAH ISTIMEWA YOGYAKARTA",29,139,120,259
https://kawalpemilu.org#42375,"MUJAMUJU, UMBULHARJO, KOTA YOGYAKARTA, DAERAH ISTIMEWA YOGYAKARTA",30,168,87,255
https://kawalpemilu.org#42375,"MUJAMUJU, UMBULHARJO, KOTA YOGYAKARTA, DAERAH ISTIMEWA YOGYAKARTA",31,147,114,261
https://kawalpemilu.org#42376,"TAHUNAN, UMBULHARJO, KOTA YOGYAKARTA, DAERAH ISTIMEWA YOGYAKARTA",1,139,50,189
https://kawalpemilu.org#42376,"TAHUNAN, UMBULHARJO, KOTA YOGYAKARTA, DAERAH ISTIMEWA YOGYAKARTA",2,107,73,180
https://kawalpemilu.org#42376,"TAHUNAN, UMBULHARJO, KOTA YOGYAKARTA, DAERAH ISTIMEWA YOGYAKARTA",3,159,60,219
https://kawalpemilu.org#42376,"TAHUNAN, UMBULHARJO, KOTA YOGYAKARTA, DAERAH ISTIMEWA YOGYAKARTA",4,189,60,249
https://kawalpemilu.org#42376,"TAHUNAN, UMBULHARJO, KOTA YOGYAKARTA, DAERAH ISTIMEWA YOGYAKARTA",5,182,68,250
https://kawalpemilu.org#42376,"TAHUNAN, UMBULHARJO, KOTA YOGYAKARTA, DAERAH ISTIMEWA YOGYAKARTA",6,148,100,248
https://kawalpemilu.org#42376,"TAHUNAN, UMBULHARJO, KOTA YOGYAKARTA, DAERAH ISTIMEWA YOGYAKARTA",7,158,102,260
https://kawalpemilu.org#42376,"TAHUNAN, UMBULHARJO, KOTA YOGYAKARTA, DAERAH ISTIMEWA YOGYAKARTA",8,186,63,249
https://kawalpemilu.org#42376,"TAHUNAN, UMBULHARJO, KOTA YOGYAKARTA, DAERAH ISTIMEWA YOGYAKARTA",9,156,92,248
https://kawalpemilu.org#42376,"TAHUNAN, UMBULHARJO, KOTA YOGYAKARTA, DAERAH ISTIMEWA YOGYAKARTA",10,124,112,236
https://kawalpemilu.org#42376,"TAHUNAN, UMBULHARJO, KOTA YOGYAKARTA, DAERAH ISTIMEWA YOGYAKARTA",11,114,93,207
https://kawalpemilu.org#42376,"TAHUNAN, UMBULHARJO, KOTA YOGYAKARTA, DAERAH ISTIMEWA YOGYAKARTA",12,156,79,235
https://kawalpemilu.org#42376,"TAHUNAN, UMBULHARJO, KOTA YOGYAKARTA, DAERAH ISTIMEWA YOGYAKARTA",13,160,80,240
https://kawalpemilu.org#42376,"TAHUNAN, UMBULHARJO, KOTA YOGYAKARTA, DAERAH ISTIMEWA YOGYAKARTA",14,111,40,151
https://kawalpemilu.org#42376,"TAHUNAN, UMBULHARJO, KOTA YOGYAKARTA, DAERAH ISTIMEWA YOGYAKARTA",15,131,60,191
https://kawalpemilu.org#42376,"TAHUNAN, UMBULHARJO, KOTA YOGYAKARTA, DAERAH ISTIMEWA YOGYAKARTA",16,159,87,246
https://kawalpemilu.org#42376,"TAHUNAN, UMBULHARJO, KOTA YOGYAKARTA, DAERAH ISTIMEWA YOGYAKARTA",17,118,112,230
https://kawalpemilu.org#42376,"TAHUNAN, UMBULHARJO, KOTA YOGYAKARTA, DAERAH ISTIMEWA YOGYAKARTA",18,184,75,259
https://kawalpemilu.org#42376,"TAHUNAN, UMBULHARJO, KOTA YOGYAKARTA, DAERAH ISTIMEWA YOGYAKARTA",19,137,55,192
https://kawalpemilu.org#42376,"TAHUNAN, UMBULHARJO, KOTA YOGYAKARTA, DAERAH ISTIMEWA YOGYAKARTA",20,153,76,229
https://kawalpemilu.org#42376,"TAHUNAN, UMBULHARJO, KOTA YOGYAKARTA, DAERAH ISTIMEWA YOGYAKARTA",21,166,73,239
https://kawalpemilu.org#42376,"TAHUNAN, UMBULHARJO, KOTA YOGYAKARTA, DAERAH ISTIMEWA YOGYAKARTA",22,163,70,233
https://kawalpemilu.org#42376,"TAHUNAN, UMBULHARJO, KOTA YOGYAKARTA, DAERAH ISTIMEWA YOGYAKARTA",23,112,85,197
https://kawalpemilu.org#42376,"TAHUNAN, UMBULHARJO, KOTA YOGYAKARTA, DAERAH ISTIMEWA YOGYAKARTA",24,160,67,227
https://kawalpemilu.org#42376,"TAHUNAN, UMBULHARJO, KOTA YOGYAKARTA, DAERAH ISTIMEWA YOGYAKARTA",25,165,76,241
https://kawalpemilu.org#42376,"TAHUNAN, UMBULHARJO, KOTA YOGYAKARTA, DAERAH ISTIMEWA YOGYAKARTA",26,121,92,213
https://kawalpemilu.org#42376,"TAHUNAN, UMBULHARJO, KOTA YOGYAKARTA, DAERAH ISTIMEWA YOGYAKARTA",27,88,51,139
https://kawalpemilu.org#42377,"WARUNGBOTO, UMBULHARJO, KOTA YOGYAKARTA, DAERAH ISTIMEWA YOGYAKARTA",1,170,61,231
https://kawalpemilu.org#42377,"WARUNGBOTO, UMBULHARJO, KOTA YOGYAKARTA, DAERAH ISTIMEWA YOGYAKARTA",2,87,66,153
https://kawalpemilu.org#42377,"WARUNGBOTO, UMBULHARJO, KOTA YOGYAKARTA, DAERAH ISTIMEWA YOGYAKARTA",3,77,40,117
https://kawalpemilu.org#42377,"WARUNGBOTO, UMBULHARJO, KOTA YOGYAKARTA, DAERAH ISTIMEWA YOGYAKARTA",4,77,61,138
https://kawalpemilu.org#42377,"WARUNGBOTO, UMBULHARJO, KOTA YOGYAKARTA, DAERAH ISTIMEWA YOGYAKARTA",5,101,87,188
https://kawalpemilu.org#42377,"WARUNGBOTO, UMBULHARJO, KOTA YOGYAKARTA, DAERAH ISTIMEWA YOGYAKARTA",6,63,96,159
https://kawalpemilu.org#42377,"WARUNGBOTO, UMBULHARJO, KOTA YOGYAKARTA, DAERAH ISTIMEWA YOGYAKARTA",7,56,89,145
https://kawalpemilu.org#42377,"WARUNGBOTO, UMBULHARJO, KOTA YOGYAKARTA, DAERAH ISTIMEWA YOGYAKARTA",8,71,70,141
https://kawalpemilu.org#42377,"WARUNGBOTO, UMBULHARJO, KOTA YOGYAKARTA, DAERAH ISTIMEWA YOGYAKARTA",9,112,77,189
https://kawalpemilu.org#42377,"WARUNGBOTO, UMBULHARJO, KOTA YOGYAKARTA, DAERAH ISTIMEWA YOGYAKARTA",10,154,79,233
https://kawalpemilu.org#42377,"WARUNGBOTO, UMBULHARJO, KOTA YOGYAKARTA, DAERAH ISTIMEWA YOGYAKARTA",11,136,117,253
https://kawalpemilu.org#42377,"WARUNGBOTO, UMBULHARJO, KOTA YOGYAKARTA, DAERAH ISTIMEWA YOGYAKARTA",12,100,73,173
https://kawalpemilu.org#42377,"WARUNGBOTO, UMBULHARJO, KOTA YOGYAKARTA, DAERAH ISTIMEWA YOGYAKARTA",13,82,55,137
https://kawalpemilu.org#42377,"WARUNGBOTO, UMBULHARJO, KOTA YOGYAKARTA, DAERAH ISTIMEWA YOGYAKARTA",14,89,93,182
https://kawalpemilu.org#42377,"WARUNGBOTO, UMBULHARJO, KOTA YOGYAKARTA, DAERAH ISTIMEWA YOGYAKARTA",15,137,82,219
https://kawalpemilu.org#42377,"WARUNGBOTO, UMBULHARJO, KOTA YOGYAKARTA, DAERAH ISTIMEWA YOGYAKARTA",16,139,74,213
https://kawalpemilu.org#42377,"WARUNGBOTO, UMBULHARJO, KOTA YOGYAKARTA, DAERAH ISTIMEWA YOGYAKARTA",17,145,53,198
https://kawalpemilu.org#42377,"WARUNGBOTO, UMBULHARJO, KOTA YOGYAKARTA, DAERAH ISTIMEWA YOGYAKARTA",18,77,87,164
https://kawalpemilu.org#42377,"WARUNGBOTO, UMBULHARJO, KOTA YOGYAKARTA, DAERAH ISTIMEWA YOGYAKARTA",19,81,118,199
https://kawalpemilu.org#42377,"WARUNGBOTO, UMBULHARJO, KOTA YOGYAKARTA, DAERAH ISTIMEWA YOGYAKARTA",20,104,121,225
https://kawalpemilu.org#42377,"WARUNGBOTO, UMBULHARJO, KOTA YOGYAKARTA, DAERAH ISTIMEWA YOGYAKARTA",21,47,83,130
https://kawalpemilu.org#42377,"WARUNGBOTO, UMBULHARJO, KOTA YOGYAKARTA, DAERAH ISTIMEWA YOGYAKARTA",22,100,152,252
https://kawalpemilu.org#42377,"WARUNGBOTO, UMBULHARJO, KOTA YOGYAKARTA, DAERAH ISTIMEWA YOGYAKARTA",23,79,166,245
https://kawalpemilu.org#42377,"WARUNGBOTO, UMBULHARJO, KOTA YOGYAKARTA, DAERAH ISTIMEWA YOGYAKARTA",24,57,116,173
https://kawalpemilu.org#42377,"WARUNGBOTO, UMBULHARJO, KOTA YOGYAKARTA, DAERAH ISTIMEWA YOGYAKARTA",25,80,131,211
https://kawalpemilu.org#42377,"WARUNGBOTO, UMBULHARJO, KOTA YOGYAKARTA, DAERAH ISTIMEWA YOGYAKARTA",26,72,115,187
https://kawalpemilu.org#42377,"WARUNGBOTO, UMBULHARJO, KOTA YOGYAKARTA, DAERAH ISTIMEWA YOGYAKARTA",27,113,124,237
https://kawalpemilu.org#42377,"WARUNGBOTO, UMBULHARJO, KOTA YOGYAKARTA, DAERAH ISTIMEWA YOGYAKARTA",28,85,146,231
https://kawalpemilu.org#42377,"WARUNGBOTO, UMBULHARJO, KOTA YOGYAKARTA, DAERAH ISTIMEWA YOGYAKARTA",29,87,96,183
https://kawalpemilu.org#42377,"WARUNGBOTO, UMBULHARJO, KOTA YOGYAKARTA, DAERAH ISTIMEWA YOGYAKARTA",30,64,55,119
https://kawalpemilu.org#42377,"WARUNGBOTO, UMBULHARJO, KOTA YOGYAKARTA, DAERAH ISTIMEWA YOGYAKARTA",31,102,132,234
https://kawalpemilu.org#42377,"WARUNGBOTO, UMBULHARJO, KOTA YOGYAKARTA, DAERAH ISTIMEWA YOGYAKARTA",32,87,120,207
https://kawalpemilu.org#42377,"WARUNGBOTO, UMBULHARJO, KOTA YOGYAKARTA, DAERAH ISTIMEWA YOGYAKARTA",33,149,76,225
https://kawalpemilu.org#42378,"PANDEYAN, UMBULHARJO, KOTA YOGYAKARTA, DAERAH ISTIMEWA YOGYAKARTA",1,138,83,221
https://kawalpemilu.org#42378,"PANDEYAN, UMBULHARJO, KOTA YOGYAKARTA, DAERAH ISTIMEWA YOGYAKARTA",2,141,92,233
https://kawalpemilu.org#42378,"PANDEYAN, UMBULHARJO, KOTA YOGYAKARTA, DAERAH ISTIMEWA YOGYAKARTA",3,100,48,148
https://kawalpemilu.org#42378,"PANDEYAN, UMBULHARJO, KOTA YOGYAKARTA, DAERAH ISTIMEWA YOGYAKARTA",4,159,57,216
https://kawalpemilu.org#42378,"PANDEYAN, UMBULHARJO, KOTA YOGYAKARTA, DAERAH ISTIMEWA YOGYAKARTA",5,129,97,226
https://kawalpemilu.org#42378,"PANDEYAN, UMBULHARJO, KOTA YOGYAKARTA, DAERAH ISTIMEWA YOGYAKARTA",6,150,80,230
https://kawalpemilu.org#42378,"PANDEYAN, UMBULHARJO, KOTA YOGYAKARTA, DAERAH ISTIMEWA YOGYAKARTA",7,134,35,169
https://kawalpemilu.org#42378,"PANDEYAN, UMBULHARJO, KOTA YOGYAKARTA, DAERAH ISTIMEWA YOGYAKARTA",8,138,58,196
https://kawalpemilu.org#42378,"PANDEYAN, UMBULHARJO, KOTA YOGYAKARTA, DAERAH ISTIMEWA YOGYAKARTA",9,121,65,186
https://kawalpemilu.org#42378,"PANDEYAN, UMBULHARJO, KOTA YOGYAKARTA, DAERAH ISTIMEWA YOGYAKARTA",10,99,113,212
https://kawalpemilu.org#42378,"PANDEYAN, UMBULHARJO, KOTA YOGYAKARTA, DAERAH ISTIMEWA YOGYAKARTA",11,142,84,226
https://kawalpemilu.org#42378,"PANDEYAN, UMBULHARJO, KOTA YOGYAKARTA, DAERAH ISTIMEWA YOGYAKARTA",12,121,84,205
https://kawalpemilu.org#42378,"PANDEYAN, UMBULHARJO, KOTA YOGYAKARTA, DAERAH ISTIMEWA YOGYAKARTA",13,88,43,131
https://kawalpemilu.org#42378,"PANDEYAN, UMBULHARJO, KOTA YOGYAKARTA, DAERAH ISTIMEWA YOGYAKARTA",14,75,98,173
https://kawalpemilu.org#42378,"PANDEYAN, UMBULHARJO, KOTA YOGYAKARTA, DAERAH ISTIMEWA YOGYAKARTA",15,166,99,265
https://kawalpemilu.org#42378,"PANDEYAN, UMBULHARJO, KOTA YOGYAKARTA, DAERAH ISTIMEWA YOGYAKARTA",16,137,111,248
https://kawalpemilu.org#42378,"PANDEYAN, UMBULHARJO, KOTA YOGYAKARTA, DAERAH ISTIMEWA YOGYAKARTA",17,98,74,172
https://kawalpemilu.org#42378,"PANDEYAN, UMBULHARJO, KOTA YOGYAKARTA, DAERAH ISTIMEWA YOGYAKARTA",18,125,55,180
https://kawalpemilu.org#42378,"PANDEYAN, UMBULHARJO, KOTA YOGYAKARTA, DAERAH ISTIMEWA YOGYAKARTA",19,151,75,226
https://kawalpemilu.org#42378,"PANDEYAN, UMBULHARJO, KOTA YOGYAKARTA, DAERAH ISTIMEWA YOGYAKARTA",20,109,82,191
https://kawalpemilu.org#42378,"PANDEYAN, UMBULHARJO, KOTA YOGYAKARTA, DAERAH ISTIMEWA YOGYAKARTA",21,73,73,146
https://kawalpemilu.org#42378,"PANDEYAN, UMBULHARJO, KOTA YOGYAKARTA, DAERAH ISTIMEWA YOGYAKARTA",22,151,97,248
https://kawalpemilu.org#42378,"PANDEYAN, UMBULHARJO, KOTA YOGYAKARTA, DAERAH ISTIMEWA YOGYAKARTA",23,73,124,197
https://kawalpemilu.org#42378,"PANDEYAN, UMBULHARJO, KOTA YOGYAKARTA, DAERAH ISTIMEWA YOGYAKARTA",24,111,58,169
https://kawalpemilu.org#42378,"PANDEYAN, UMBULHARJO, KOTA YOGYAKARTA, DAERAH ISTIMEWA YOGYAKARTA",25,88,28,116
https://kawalpemilu.org#42378,"PANDEYAN, UMBULHARJO, KOTA YOGYAKARTA, DAERAH ISTIMEWA YOGYAKARTA",26,99,84,183
https://kawalpemilu.org#42378,"PANDEYAN, UMBULHARJO, KOTA YOGYAKARTA, DAERAH ISTIMEWA YOGYAKARTA",27,105,85,190
https://kawalpemilu.org#42378,"PANDEYAN, UMBULHARJO, KOTA YOGYAKARTA, DAERAH ISTIMEWA YOGYAKARTA",28,141,64,205
https://kawalpemilu.org#42378,"PANDEYAN, UMBULHARJO, KOTA YOGYAKARTA, DAERAH ISTIMEWA YOGYAKARTA",29,148,66,214
https://kawalpemilu.org#42378,"PANDEYAN, UMBULHARJO, KOTA YOGYAKARTA, DAERAH ISTIMEWA YOGYAKARTA",30,147,67,214
https://kawalpemilu.org#42378,"PANDEYAN, UMBULHARJO, KOTA YOGYAKARTA, DAERAH ISTIMEWA YOGYAKARTA",31,113,101,214
https://kawalpemilu.org#42378,"PANDEYAN, UMBULHARJO, KOTA YOGYAKARTA, DAERAH ISTIMEWA YOGYAKARTA",32,133,93,226
https://kawalpemilu.org#42378,"PANDEYAN, UMBULHARJO, KOTA YOGYAKARTA, DAERAH ISTIMEWA YOGYAKARTA",33,94,76,170
https://kawalpemilu.org#42378,"PANDEYAN, UMBULHARJO, KOTA YOGYAKARTA, DAERAH ISTIMEWA YOGYAKARTA",34,113,87,200
https://kawalpemilu.org#42378,"PANDEYAN, UMBULHARJO, KOTA YOGYAKARTA, DAERAH ISTIMEWA YOGYAKARTA",35,97,89,186
https://kawalpemilu.org#42378,"PANDEYAN, UMBULHARJO, KOTA YOGYAKARTA, DAERAH ISTIMEWA YOGYAKARTA",36,124,59,183
https://kawalpemilu.org#42378,"PANDEYAN, UMBULHARJO, KOTA YOGYAKARTA, DAERAH ISTIMEWA YOGYAKARTA",37,90,77,167
https://kawalpemilu.org#42378,"PANDEYAN, UMBULHARJO, KOTA YOGYAKARTA, DAERAH ISTIMEWA YOGYAKARTA",38,43,68,111
https://kawalpemilu.org#42378,"PANDEYAN, UMBULHARJO, KOTA YOGYAKARTA, DAERAH ISTIMEWA YOGYAKARTA",39,113,100,213
https://kawalpemilu.org#42378,"PANDEYAN, UMBULHARJO, KOTA YOGYAKARTA, DAERAH ISTIMEWA YOGYAKARTA",40,139,71,210
https://kawalpemilu.org#42378,"PANDEYAN, UMBULHARJO, KOTA YOGYAKARTA, DAERAH ISTIMEWA YOGYAKARTA",41,83,66,149
https://kawalpemilu.org#42379,"SOROSUTAN, UMBULHARJO, KOTA YOGYAKARTA, DAERAH ISTIMEWA YOGYAKARTA",1,106,38,144
https://kawalpemilu.org#42379,"SOROSUTAN, UMBULHARJO, KOTA YOGYAKARTA, DAERAH ISTIMEWA YOGYAKARTA",2,106,67,173
https://kawalpemilu.org#42379,"SOROSUTAN, UMBULHARJO, KOTA YOGYAKARTA, DAERAH ISTIMEWA YOGYAKARTA",3,150,75,225
https://kawalpemilu.org#42379,"SOROSUTAN, UMBULHARJO, KOTA YOGYAKARTA, DAERAH ISTIMEWA YOGYAKARTA",4,130,50,180
https://kawalpemilu.org#42379,"SOROSUTAN, UMBULHARJO, KOTA YOGYAKARTA, DAERAH ISTIMEWA YOGYAKARTA",5,103,50,153
https://kawalpemilu.org#42379,"SOROSUTAN, UMBULHARJO, KOTA YOGYAKARTA, DAERAH ISTIMEWA YOGYAKARTA",6,119,32,151
https://kawalpemilu.org#42379,"SOROSUTAN, UMBULHARJO, KOTA YOGYAKARTA, DAERAH ISTIMEWA YOGYAKARTA",7,189,56,245
https://kawalpemilu.org#42379,"SOROSUTAN, UMBULHARJO, KOTA YOGYAKARTA, DAERAH ISTIMEWA YOGYAKARTA",8,185,71,256
https://kawalpemilu.org#42379,"SOROSUTAN, UMBULHARJO, KOTA YOGYAKARTA, DAERAH ISTIMEWA YOGYAKARTA",9,145,66,211
https://kawalpemilu.org#42379,"SOROSUTAN, UMBULHARJO, KOTA YOGYAKARTA, DAERAH ISTIMEWA YOGYAKARTA",10,162,89,251
https://kawalpemilu.org#42379,"SOROSUTAN, UMBULHARJO, KOTA YOGYAKARTA, DAERAH ISTIMEWA YOGYAKARTA",11,165,81,246
https://kawalpemilu.org#42379,"SOROSUTAN, UMBULHARJO, KOTA YOGYAKARTA, DAERAH ISTIMEWA YOGYAKARTA",12,117,74,191
https://kawalpemilu.org#42379,"SOROSUTAN, UMBULHARJO, KOTA YOGYAKARTA, DAERAH ISTIMEWA YOGYAKARTA",13,173,84,257
https://kawalpemilu.org#42379,"SOROSUTAN, UMBULHARJO, KOTA YOGYAKARTA, DAERAH ISTIMEWA YOGYAKARTA",14,165,90,255
https://kawalpemilu.org#42379,"SOROSUTAN, UMBULHARJO, KOTA YOGYAKARTA, DAERAH ISTIMEWA YOGYAKARTA",15,138,149,287
https://kawalpemilu.org#42379,"SOROSUTAN, UMBULHARJO, KOTA YOGYAKARTA, DAERAH ISTIMEWA YOGYAKARTA",16,56,91,147
https://kawalpemilu.org#42379,"SOROSUTAN, UMBULHARJO, KOTA YOGYAKARTA, DAERAH ISTIMEWA YOGYAKARTA",17,119,119,238
https://kawalpemilu.org#42379,"SOROSUTAN, UMBULHARJO, KOTA YOGYAKARTA, DAERAH ISTIMEWA YOGYAKARTA",18,93,50,143
https://kawalpemilu.org#42379,"SOROSUTAN, UMBULHARJO, KOTA YOGYAKARTA, DAERAH ISTIMEWA YOGYAKARTA",19,166,87,253
https://kawalpemilu.org#42379,"SOROSUTAN, UMBULHARJO, KOTA YOGYAKARTA, DAERAH ISTIMEWA YOGYAKARTA",20,126,116,242
https://kawalpemilu.org#42379,"SOROSUTAN, UMBULHARJO, KOTA YOGYAKARTA, DAERAH ISTIMEWA YOGYAKARTA",21,131,62,193
https://kawalpemilu.org#42379,"SOROSUTAN, UMBULHARJO, KOTA YOGYAKARTA, DAERAH ISTIMEWA YOGYAKARTA",22,101,79,180
https://kawalpemilu.org#42379,"SOROSUTAN, UMBULHARJO, KOTA YOGYAKARTA, DAERAH ISTIMEWA YOGYAKARTA",23,114,55,169
https://kawalpemilu.org#42379,"SOROSUTAN, UMBULHARJO, KOTA YOGYAKARTA, DAERAH ISTIMEWA YOGYAKARTA",24,127,85,212
https://kawalpemilu.org#42379,"SOROSUTAN, UMBULHARJO, KOTA YOGYAKARTA, DAERAH ISTIMEWA YOGYAKARTA",25,104,125,229
https://kawalpemilu.org#42379,"SOROSUTAN, UMBULHARJO, KOTA YOGYAKARTA, DAERAH ISTIMEWA YOGYAKARTA",26,113,109,222
https://kawalpemilu.org#42379,"SOROSUTAN, UMBULHARJO, KOTA YOGYAKARTA, DAERAH ISTIMEWA YOGYAKARTA",27,127,115,242
https://kawalpemilu.org#42379,"SOROSUTAN, UMBULHARJO, KOTA YOGYAKARTA, DAERAH ISTIMEWA YOGYAKARTA",28,110,111,221
https://kawalpemilu.org#42379,"SOROSUTAN, UMBULHARJO, KOTA YOGYAKARTA, DAERAH ISTIMEWA YOGYAKARTA",29,83,95,178
https://kawalpemilu.org#42379,"SOROSUTAN, UMBULHARJO, KOTA YOGYAKARTA, DAERAH ISTIMEWA YOGYAKARTA",30,82,129,211
https://kawalpemilu.org#42379,"SOROSUTAN, UMBULHARJO, KOTA YOGYAKARTA, DAERAH ISTIMEWA YOGYAKARTA",31,141,131,272
https://kawalpemilu.org#42379,"SOROSUTAN, UMBULHARJO, KOTA YOGYAKARTA, DAERAH ISTIMEWA YOGYAKARTA",32,76,184,260
https://kawalpemilu.org#42379,"SOROSUTAN, UMBULHARJO, KOTA YOGYAKARTA, DAERAH ISTIMEWA YOGYAKARTA",33,72,144,216
https://kawalpemilu.org#42379,"SOROSUTAN, UMBULHARJO, KOTA YOGYAKARTA, DAERAH ISTIMEWA YOGYAKARTA",34,65,112,177
https://kawalpemilu.org#42379,"SOROSUTAN, UMBULHARJO, KOTA YOGYAKARTA, DAERAH ISTIMEWA YOGYAKARTA",35,105,133,238
https://kawalpemilu.org#42379,"SOROSUTAN, UMBULHARJO, KOTA YOGYAKARTA, DAERAH ISTIMEWA YOGYAKARTA",36,89,117,206
https://kawalpemilu.org#42379,"SOROSUTAN, UMBULHARJO, KOTA YOGYAKARTA, DAERAH ISTIMEWA YOGYAKARTA",37,72,201,273
https://kawalpemilu.org#42379,"SOROSUTAN, UMBULHARJO, KOTA YOGYAKARTA, DAERAH ISTIMEWA YOGYAKARTA",38,67,196,263
https://kawalpemilu.org#42379,"SOROSUTAN, UMBULHARJO, KOTA YOGYAKARTA, DAERAH ISTIMEWA YOGYAKARTA",39,81,149,230
https://kawalpemilu.org#42379,"SOROSUTAN, UMBULHARJO, KOTA YOGYAKARTA, DAERAH ISTIMEWA YOGYAKARTA",40,77,116,193
https://kawalpemilu.org#42379,"SOROSUTAN, UMBULHARJO, KOTA YOGYAKARTA, DAERAH ISTIMEWA YOGYAKARTA",41,63,116,179
https://kawalpemilu.org#42379,"SOROSUTAN, UMBULHARJO, KOTA YOGYAKARTA, DAERAH ISTIMEWA YOGYAKARTA",42,69,112,181
https://kawalpemilu.org#42379,"SOROSUTAN, UMBULHARJO, KOTA YOGYAKARTA, DAERAH ISTIMEWA YOGYAKARTA",43,147,131,278
https://kawalpemilu.org#42379,"SOROSUTAN, UMBULHARJO, KOTA YOGYAKARTA, DAERAH ISTIMEWA YOGYAKARTA",44,144,106,250
https://kawalpemilu.org#42379,"SOROSUTAN, UMBULHARJO, KOTA YOGYAKARTA, DAERAH ISTIMEWA YOGYAKARTA",45,129,113,242
https://kawalpemilu.org#42379,"SOROSUTAN, UMBULHARJO, KOTA YOGYAKARTA, DAERAH ISTIMEWA YOGYAKARTA",46,122,97,219
https://kawalpemilu.org#42380,"GIWANGAN, UMBULHARJO, KOTA YOGYAKARTA, DAERAH ISTIMEWA YOGYAKARTA",1,70,89,159
https://kawalpemilu.org#42380,"GIWANGAN, UMBULHARJO, KOTA YOGYAKARTA, DAERAH ISTIMEWA YOGYAKARTA",2,72,105,177
https://kawalpemilu.org#42380,"GIWANGAN, UMBULHARJO, KOTA YOGYAKARTA, DAERAH ISTIMEWA YOGYAKARTA",3,114,110,224
https://kawalpemilu.org#42380,"GIWANGAN, UMBULHARJO, KOTA YOGYAKARTA, DAERAH ISTIMEWA YOGYAKARTA",4,140,99,239
https://kawalpemilu.org#42380,"GIWANGAN, UMBULHARJO, KOTA YOGYAKARTA, DAERAH ISTIMEWA YOGYAKARTA",5,139,96,235
https://kawalpemilu.org#42380,"GIWANGAN, UMBULHARJO, KOTA YOGYAKARTA, DAERAH ISTIMEWA YOGYAKARTA",6,76,68,144
https://kawalpemilu.org#42380,"GIWANGAN, UMBULHARJO, KOTA YOGYAKARTA, DAERAH ISTIMEWA YOGYAKARTA",7,129,61,190
https://kawalpemilu.org#42380,"GIWANGAN, UMBULHARJO, KOTA YOGYAKARTA, DAERAH ISTIMEWA YOGYAKARTA",8,124,106,230
https://kawalpemilu.org#42380,"GIWANGAN, UMBULHARJO, KOTA YOGYAKARTA, DAERAH ISTIMEWA YOGYAKARTA",9,119,110,229
https://kawalpemilu.org#42380,"GIWANGAN, UMBULHARJO, KOTA YOGYAKARTA, DAERAH ISTIMEWA YOGYAKARTA",10,126,89,215
https://kawalpemilu.org#42380,"GIWANGAN, UMBULHARJO, KOTA YOGYAKARTA, DAERAH ISTIMEWA YOGYAKARTA",11,121,108,229
https://kawalpemilu.org#42380,"GIWANGAN, UMBULHARJO, KOTA YOGYAKARTA, DAERAH ISTIMEWA YOGYAKARTA",12,128,115,243
https://kawalpemilu.org#42380,"GIWANGAN, UMBULHARJO, KOTA YOGYAKARTA, DAERAH ISTIMEWA YOGYAKARTA",13,119,126,245
https://kawalpemilu.org#42380,"GIWANGAN, UMBULHARJO, KOTA YOGYAKARTA, DAERAH ISTIMEWA YOGYAKARTA",14,113,71,184
https://kawalpemilu.org#42380,"GIWANGAN, UMBULHARJO, KOTA YOGYAKARTA, DAERAH ISTIMEWA YOGYAKARTA",15,150,64,214
https://kawalpemilu.org#42380,"GIWANGAN, UMBULHARJO, KOTA YOGYAKARTA, DAERAH ISTIMEWA YOGYAKARTA",16,142,63,205
https://kawalpemilu.org#42380,"GIWANGAN, UMBULHARJO, KOTA YOGYAKARTA, DAERAH ISTIMEWA YOGYAKARTA",17,141,47,188
https://kawalpemilu.org#42380,"GIWANGAN, UMBULHARJO, KOTA YOGYAKARTA, DAERAH ISTIMEWA YOGYAKARTA",18,133,76,209
https://kawalpemilu.org#42380,"GIWANGAN, UMBULHARJO, KOTA YOGYAKARTA, DAERAH ISTIMEWA YOGYAKARTA",19,111,107,218
https://kawalpemilu.org#42380,"GIWANGAN, UMBULHARJO, KOTA YOGYAKARTA, DAERAH ISTIMEWA YOGYAKARTA",20,67,69,136
https://kawalpemilu.org#42380,"GIWANGAN, UMBULHARJO, KOTA YOGYAKARTA, DAERAH ISTIMEWA YOGYAKARTA",21,87,49,136
https://kawalpemilu.org#42380,"GIWANGAN, UMBULHARJO, KOTA YOGYAKARTA, DAERAH ISTIMEWA YOGYAKARTA",22,62,78,140
https://kawalpemilu.org#42380,"GIWANGAN, UMBULHARJO, KOTA YOGYAKARTA, DAERAH ISTIMEWA YOGYAKARTA",23,138,85,223
https://kawalpemilu.org#42380,"GIWANGAN, UMBULHARJO, KOTA YOGYAKARTA, DAERAH ISTIMEWA YOGYAKARTA",24,96,95,191
https://kawalpemilu.org#42380,"GIWANGAN, UMBULHARJO, KOTA YOGYAKARTA, DAERAH ISTIMEWA YOGYAKARTA",25,90,82,172
https://kawalpemilu.org#42380,"GIWANGAN, UMBULHARJO, KOTA YOGYAKARTA, DAERAH ISTIMEWA YOGYAKARTA",26,103,68,171
https://kawalpemilu.org#42380,"GIWANGAN, UMBULHARJO, KOTA YOGYAKARTA, DAERAH ISTIMEWA YOGYAKARTA",27,59,94,153
https://kawalpemilu.org#42382,"REJOWINANGUN, KOTAGEDE, KOTA YOGYAKARTA, DAERAH ISTIMEWA YOGYAKARTA",1,164,82,246
https://kawalpemilu.org#42382,"REJOWINANGUN, KOTAGEDE, KOTA YOGYAKARTA, DAERAH ISTIMEWA YOGYAKARTA",2,135,108,243
https://kawalpemilu.org#42382,"REJOWINANGUN, KOTAGEDE, KOTA YOGYAKARTA, DAERAH ISTIMEWA YOGYAKARTA",3,144,72,216
https://kawalpemilu.org#42382,"REJOWINANGUN, KOTAGEDE, KOTA YOGYAKARTA, DAERAH ISTIMEWA YOGYAKARTA",4,128,84,212
https://kawalpemilu.org#42382,"REJOWINANGUN, KOTAGEDE, KOTA YOGYAKARTA, DAERAH ISTIMEWA YOGYAKARTA",6,108,49,157
https://kawalpemilu.org#42382,"REJOWINANGUN, KOTAGEDE, KOTA YOGYAKARTA, DAERAH ISTIMEWA YOGYAKARTA",7,116,77,193
https://kawalpemilu.org#42382,"REJOWINANGUN, KOTAGEDE, KOTA YOGYAKARTA, DAERAH ISTIMEWA YOGYAKARTA",8,126,60,186
https://kawalpemilu.org#42382,"REJOWINANGUN, KOTAGEDE, KOTA YOGYAKARTA, DAERAH ISTIMEWA YOGYAKARTA",9,152,86,238
https://kawalpemilu.org#42382,"REJOWINANGUN, KOTAGEDE, KOTA YOGYAKARTA, DAERAH ISTIMEWA YOGYAKARTA",10,144,102,246
https://kawalpemilu.org#42382,"REJOWINANGUN, KOTAGEDE, KOTA YOGYAKARTA, DAERAH ISTIMEWA YOGYAKARTA",11,137,97,234
https://kawalpemilu.org#42382,"REJOWINANGUN, KOTAGEDE, KOTA YOGYAKARTA, DAERAH ISTIMEWA YOGYAKARTA",12,146,103,249
https://kawalpemilu.org#42382,"REJOWINANGUN, KOTAGEDE, KOTA YOGYAKARTA, DAERAH ISTIMEWA YOGYAKARTA",13,147,86,233
https://kawalpemilu.org#42382,"REJOWINANGUN, KOTAGEDE, KOTA YOGYAKARTA, DAERAH ISTIMEWA YOGYAKARTA",14,123,113,236
https://kawalpemilu.org#42382,"REJOWINANGUN, KOTAGEDE, KOTA YOGYAKARTA, DAERAH ISTIMEWA YOGYAKARTA",15,148,91,239
https://kawalpemilu.org#42382,"REJOWINANGUN, KOTAGEDE, KOTA YOGYAKARTA, DAERAH ISTIMEWA YOGYAKARTA",16,131,117,248
https://kawalpemilu.org#42382,"REJOWINANGUN, KOTAGEDE, KOTA YOGYAKARTA, DAERAH ISTIMEWA YOGYAKARTA",17,139,121,260
https://kawalpemilu.org#42382,"REJOWINANGUN, KOTAGEDE, KOTA YOGYAKARTA, DAERAH ISTIMEWA YOGYAKARTA",18,153,88,241
https://kawalpemilu.org#42382,"REJOWINANGUN, KOTAGEDE, KOTA YOGYAKARTA, DAERAH ISTIMEWA YOGYAKARTA",19,127,120,247
https://kawalpemilu.org#42382,"REJOWINANGUN, KOTAGEDE, KOTA YOGYAKARTA, DAERAH ISTIMEWA YOGYAKARTA",20,130,115,245
https://kawalpemilu.org#42382,"REJOWINANGUN, KOTAGEDE, KOTA YOGYAKARTA, DAERAH ISTIMEWA YOGYAKARTA",21,99,53,152
https://kawalpemilu.org#42382,"REJOWINANGUN, KOTAGEDE, KOTA YOGYAKARTA, DAERAH ISTIMEWA YOGYAKARTA",22,103,134,237
https://kawalpemilu.org#42382,"REJOWINANGUN, KOTAGEDE, KOTA YOGYAKARTA, DAERAH ISTIMEWA YOGYAKARTA",23,142,88,230
https://kawalpemilu.org#42382,"REJOWINANGUN, KOTAGEDE, KOTA YOGYAKARTA, DAERAH ISTIMEWA YOGYAKARTA",24,124,109,233
https://kawalpemilu.org#42382,"REJOWINANGUN, KOTAGEDE, KOTA YOGYAKARTA, DAERAH ISTIMEWA YOGYAKARTA",25,112,83,195
https://kawalpemilu.org#42382,"REJOWINANGUN, KOTAGEDE, KOTA YOGYAKARTA, DAERAH ISTIMEWA YOGYAKARTA",26,92,84,176
https://kawalpemilu.org#42382,"REJOWINANGUN, KOTAGEDE, KOTA YOGYAKARTA, DAERAH ISTIMEWA YOGYAKARTA",27,113,118,231
https://kawalpemilu.org#42382,"REJOWINANGUN, KOTAGEDE, KOTA YOGYAKARTA, DAERAH ISTIMEWA YOGYAKARTA",28,129,116,245
https://kawalpemilu.org#42382,"REJOWINANGUN, KOTAGEDE, KOTA YOGYAKARTA, DAERAH ISTIMEWA YOGYAKARTA",29,115,122,237
https://kawalpemilu.org#42382,"REJOWINANGUN, KOTAGEDE, KOTA YOGYAKARTA, DAERAH ISTIMEWA YOGYAKARTA",30,119,114,233
https://kawalpemilu.org#42382,"REJOWINANGUN, KOTAGEDE, KOTA YOGYAKARTA, DAERAH ISTIMEWA YOGYAKARTA",31,104,75,179
https://kawalpemilu.org#42382,"REJOWINANGUN, KOTAGEDE, KOTA YOGYAKARTA, DAERAH ISTIMEWA YOGYAKARTA",33,83,119,202
https://kawalpemilu.org#42382,"REJOWINANGUN, KOTAGEDE, KOTA YOGYAKARTA, DAERAH ISTIMEWA YOGYAKARTA",34,144,83,227
https://kawalpemilu.org#42382,"REJOWINANGUN, KOTAGEDE, KOTA YOGYAKARTA, DAERAH ISTIMEWA YOGYAKARTA",35,115,66,181
https://kawalpemilu.org#42382,"REJOWINANGUN, KOTAGEDE, KOTA YOGYAKARTA, DAERAH ISTIMEWA YOGYAKARTA",36,120,52,172
https://kawalpemilu.org#42382,"REJOWINANGUN, KOTAGEDE, KOTA YOGYAKARTA, DAERAH ISTIMEWA YOGYAKARTA",37,106,44,150
https://kawalpemilu.org#42383,"PRENGGAN, KOTAGEDE, KOTA YOGYAKARTA, DAERAH ISTIMEWA YOGYAKARTA",1,140,87,227
https://kawalpemilu.org#42383,"PRENGGAN, KOTAGEDE, KOTA YOGYAKARTA, DAERAH ISTIMEWA YOGYAKARTA",2,136,96,232
https://kawalpemilu.org#42383,"PRENGGAN, KOTAGEDE, KOTA YOGYAKARTA, DAERAH ISTIMEWA YOGYAKARTA",3,155,87,242
https://kawalpemilu.org#42383,"PRENGGAN, KOTAGEDE, KOTA YOGYAKARTA, DAERAH ISTIMEWA YOGYAKARTA",4,106,50,156
https://kawalpemilu.org#42383,"PRENGGAN, KOTAGEDE, KOTA YOGYAKARTA, DAERAH ISTIMEWA YOGYAKARTA",5,118,56,174
https://kawalpemilu.org#42383,"PRENGGAN, KOTAGEDE, KOTA YOGYAKARTA, DAERAH ISTIMEWA YOGYAKARTA",6,143,95,238
https://kawalpemilu.org#42383,"PRENGGAN, KOTAGEDE, KOTA YOGYAKARTA, DAERAH ISTIMEWA YOGYAKARTA",7,152,70,222
https://kawalpemilu.org#42383,"PRENGGAN, KOTAGEDE, KOTA YOGYAKARTA, DAERAH ISTIMEWA YOGYAKARTA",8,123,61,184
https://kawalpemilu.org#42383,"PRENGGAN, KOTAGEDE, KOTA YOGYAKARTA, DAERAH ISTIMEWA YOGYAKARTA",9,105,75,180
https://kawalpemilu.org#42383,"PRENGGAN, KOTAGEDE, KOTA YOGYAKARTA, DAERAH ISTIMEWA YOGYAKARTA",10,70,43,113
https://kawalpemilu.org#42383,"PRENGGAN, KOTAGEDE, KOTA YOGYAKARTA, DAERAH ISTIMEWA YOGYAKARTA",11,130,132,262
https://kawalpemilu.org#42383,"PRENGGAN, KOTAGEDE, KOTA YOGYAKARTA, DAERAH ISTIMEWA YOGYAKARTA",12,136,71,207
https://kawalpemilu.org#42383,"PRENGGAN, KOTAGEDE, KOTA YOGYAKARTA, DAERAH ISTIMEWA YOGYAKARTA",13,114,64,178
https://kawalpemilu.org#42383,"PRENGGAN, KOTAGEDE, KOTA YOGYAKARTA, DAERAH ISTIMEWA YOGYAKARTA",14,119,102,221
https://kawalpemilu.org#42383,"PRENGGAN, KOTAGEDE, KOTA YOGYAKARTA, DAERAH ISTIMEWA YOGYAKARTA",15,143,73,216
https://kawalpemilu.org#42383,"PRENGGAN, KOTAGEDE, KOTA YOGYAKARTA, DAERAH ISTIMEWA YOGYAKARTA",16,158,105,263
https://kawalpemilu.org#42383,"PRENGGAN, KOTAGEDE, KOTA YOGYAKARTA, DAERAH ISTIMEWA YOGYAKARTA",17,127,131,258
https://kawalpemilu.org#42383,"PRENGGAN, KOTAGEDE, KOTA YOGYAKARTA, DAERAH ISTIMEWA YOGYAKARTA",18,177,97,274
https://kawalpemilu.org#42383,"PRENGGAN, KOTAGEDE, KOTA YOGYAKARTA, DAERAH ISTIMEWA YOGYAKARTA",19,91,63,154
https://kawalpemilu.org#42383,"PRENGGAN, KOTAGEDE, KOTA YOGYAKARTA, DAERAH ISTIMEWA YOGYAKARTA",20,97,96,193
https://kawalpemilu.org#42383,"PRENGGAN, KOTAGEDE, KOTA YOGYAKARTA, DAERAH ISTIMEWA YOGYAKARTA",21,160,107,267
https://kawalpemilu.org#42383,"PRENGGAN, KOTAGEDE, KOTA YOGYAKARTA, DAERAH ISTIMEWA YOGYAKARTA",22,122,113,235
https://kawalpemilu.org#42383,"PRENGGAN, KOTAGEDE, KOTA YOGYAKARTA, DAERAH ISTIMEWA YOGYAKARTA",23,113,124,237
https://kawalpemilu.org#42383,"PRENGGAN, KOTAGEDE, KOTA YOGYAKARTA, DAERAH ISTIMEWA YOGYAKARTA",24,136,123,259
https://kawalpemilu.org#42383,"PRENGGAN, KOTAGEDE, KOTA YOGYAKARTA, DAERAH ISTIMEWA YOGYAKARTA",25,118,104,222
https://kawalpemilu.org#42383,"PRENGGAN, KOTAGEDE, KOTA YOGYAKARTA, DAERAH ISTIMEWA YOGYAKARTA",26,93,151,244
https://kawalpemilu.org#42383,"PRENGGAN, KOTAGEDE, KOTA YOGYAKARTA, DAERAH ISTIMEWA YOGYAKARTA",27,102,110,212
https://kawalpemilu.org#42383,"PRENGGAN, KOTAGEDE, KOTA YOGYAKARTA, DAERAH ISTIMEWA YOGYAKARTA",28,88,130,218
https://kawalpemilu.org#42383,"PRENGGAN, KOTAGEDE, KOTA YOGYAKARTA, DAERAH ISTIMEWA YOGYAKARTA",29,108,111,219
https://kawalpemilu.org#42383,"PRENGGAN, KOTAGEDE, KOTA YOGYAKARTA, DAERAH ISTIMEWA YOGYAKARTA",30,115,117,232
https://kawalpemilu.org#42383,"PRENGGAN, KOTAGEDE, KOTA YOGYAKARTA, DAERAH ISTIMEWA YOGYAKARTA",31,160,58,218
https://kawalpemilu.org#42383,"PRENGGAN, KOTAGEDE, KOTA YOGYAKARTA, DAERAH ISTIMEWA YOGYAKARTA",32,106,52,158
https://kawalpemilu.org#42383,"PRENGGAN, KOTAGEDE, KOTA YOGYAKARTA, DAERAH ISTIMEWA YOGYAKARTA",33,79,61,140
https://kawalpemilu.org#42383,"PRENGGAN, KOTAGEDE, KOTA YOGYAKARTA, DAERAH ISTIMEWA YOGYAKARTA",34,181,54,235
https://kawalpemilu.org#42383,"PRENGGAN, KOTAGEDE, KOTA YOGYAKARTA, DAERAH ISTIMEWA YOGYAKARTA",35,31,72,103
https://kawalpemilu.org#42384,"PURBAYAN, KOTAGEDE, KOTA YOGYAKARTA, DAERAH ISTIMEWA YOGYAKARTA",1,135,69,204
https://kawalpemilu.org#42384,"PURBAYAN, KOTAGEDE, KOTA YOGYAKARTA, DAERAH ISTIMEWA YOGYAKARTA",2,137,76,213
https://kawalpemilu.org#42384,"PURBAYAN, KOTAGEDE, KOTA YOGYAKARTA, DAERAH ISTIMEWA YOGYAKARTA",3,119,50,169
https://kawalpemilu.org#42384,"PURBAYAN, KOTAGEDE, KOTA YOGYAKARTA, DAERAH ISTIMEWA YOGYAKARTA",4,106,48,154
https://kawalpemilu.org#42384,"PURBAYAN, KOTAGEDE, KOTA YOGYAKARTA, DAERAH ISTIMEWA YOGYAKARTA",5,110,60,170
https://kawalpemilu.org#42384,"PURBAYAN, KOTAGEDE, KOTA YOGYAKARTA, DAERAH ISTIMEWA YOGYAKARTA",6,80,78,158
https://kawalpemilu.org#42384,"PURBAYAN, KOTAGEDE, KOTA YOGYAKARTA, DAERAH ISTIMEWA YOGYAKARTA",7,139,107,246
https://kawalpemilu.org#42384,"PURBAYAN, KOTAGEDE, KOTA YOGYAKARTA, DAERAH ISTIMEWA YOGYAKARTA",8,115,120,235
https://kawalpemilu.org#42384,"PURBAYAN, KOTAGEDE, KOTA YOGYAKARTA, DAERAH ISTIMEWA YOGYAKARTA",9,112,123,235
https://kawalpemilu.org#42384,"PURBAYAN, KOTAGEDE, KOTA YOGYAKARTA, DAERAH ISTIMEWA YOGYAKARTA",10,102,124,226
https://kawalpemilu.org#42384,"PURBAYAN, KOTAGEDE, KOTA YOGYAKARTA, DAERAH ISTIMEWA YOGYAKARTA",11,103,113,216
https://kawalpemilu.org#42384,"PURBAYAN, KOTAGEDE, KOTA YOGYAKARTA, DAERAH ISTIMEWA YOGYAKARTA",12,99,79,178
https://kawalpemilu.org#42384,"PURBAYAN, KOTAGEDE, KOTA YOGYAKARTA, DAERAH ISTIMEWA YOGYAKARTA",13,119,85,204
https://kawalpemilu.org#42384,"PURBAYAN, KOTAGEDE, KOTA YOGYAKARTA, DAERAH ISTIMEWA YOGYAKARTA",14,62,95,157
https://kawalpemilu.org#42384,"PURBAYAN, KOTAGEDE, KOTA YOGYAKARTA, DAERAH ISTIMEWA YOGYAKARTA",15,98,99,197
https://kawalpemilu.org#42384,"PURBAYAN, KOTAGEDE, KOTA YOGYAKARTA, DAERAH ISTIMEWA YOGYAKARTA",16,135,81,216
https://kawalpemilu.org#42384,"PURBAYAN, KOTAGEDE, KOTA YOGYAKARTA, DAERAH ISTIMEWA YOGYAKARTA",17,118,101,219
https://kawalpemilu.org#42384,"PURBAYAN, KOTAGEDE, KOTA YOGYAKARTA, DAERAH ISTIMEWA YOGYAKARTA",18,177,97,274
https://kawalpemilu.org#42384,"PURBAYAN, KOTAGEDE, KOTA YOGYAKARTA, DAERAH ISTIMEWA YOGYAKARTA",19,36,88,124
https://kawalpemilu.org#42384,"PURBAYAN, KOTAGEDE, KOTA YOGYAKARTA, DAERAH ISTIMEWA YOGYAKARTA",20,57,116,173
https://kawalpemilu.org#42384,"PURBAYAN, KOTAGEDE, KOTA YOGYAKARTA, DAERAH ISTIMEWA YOGYAKARTA",21,34,124,158
https://kawalpemilu.org#42384,"PURBAYAN, KOTAGEDE, KOTA YOGYAKARTA, DAERAH ISTIMEWA YOGYAKARTA",22,68,153,221
https://kawalpemilu.org#42384,"PURBAYAN, KOTAGEDE, KOTA YOGYAKARTA, DAERAH ISTIMEWA YOGYAKARTA",23,70,105,175
https://kawalpemilu.org#42384,"PURBAYAN, KOTAGEDE, KOTA YOGYAKARTA, DAERAH ISTIMEWA YOGYAKARTA",24,66,136,202
https://kawalpemilu.org#42384,"PURBAYAN, KOTAGEDE, KOTA YOGYAKARTA, DAERAH ISTIMEWA YOGYAKARTA",25,65,147,212
https://kawalpemilu.org#42384,"PURBAYAN, KOTAGEDE, KOTA YOGYAKARTA, DAERAH ISTIMEWA YOGYAKARTA",26,64,140,204
https://kawalpemilu.org#42384,"PURBAYAN, KOTAGEDE, KOTA YOGYAKARTA, DAERAH ISTIMEWA YOGYAKARTA",27,124,120,244
https://kawalpemilu.org#42384,"PURBAYAN, KOTAGEDE, KOTA YOGYAKARTA, DAERAH ISTIMEWA YOGYAKARTA",28,60,163,223
https://kawalpemilu.org#42384,"PURBAYAN, KOTAGEDE, KOTA YOGYAKARTA, DAERAH ISTIMEWA YOGYAKARTA",29,49,177,226
https://kawalpemilu.org#42384,"PURBAYAN, KOTAGEDE, KOTA YOGYAKARTA, DAERAH ISTIMEWA YOGYAKARTA",30,67,96,163
https://kawalpemilu.org#42384,"PURBAYAN, KOTAGEDE, KOTA YOGYAKARTA, DAERAH ISTIMEWA YOGYAKARTA",31,61,98,159
https://kawalpemilu.org#42384,"PURBAYAN, KOTAGEDE, KOTA YOGYAKARTA, DAERAH ISTIMEWA YOGYAKARTA",32,80,89,169
https://kawalpemilu.org#42384,"PURBAYAN, KOTAGEDE, KOTA YOGYAKARTA, DAERAH ISTIMEWA YOGYAKARTA",33,89,84,173
https://kawalpemilu.org#42384,"PURBAYAN, KOTAGEDE, KOTA YOGYAKARTA, DAERAH ISTIMEWA YOGYAKARTA",34,84,112,196
https://kawalpemilu.org#42384,"PURBAYAN, KOTAGEDE, KOTA YOGYAKARTA, DAERAH ISTIMEWA YOGYAKARTA",35,91,106,197
