Link KawalPemilu,Nama Kelurahan,Nomor TPS,Suara 01,Suara 02,Suara Sah
https://kawalpemilu.org#25826,"PULAU PANGGANG, KEPULAUAN SERIBU UTARA, KEPULAUAN SERIBU, DKI JAKARTA",1,103,127,230
https://kawalpemilu.org#25826,"PULAU PANGGANG, KEPULAUAN SERIBU UTARA, KEPULAUAN SERIBU, DKI JAKARTA",2,117,98,215
https://kawalpemilu.org#25826,"PULAU PANGGANG, KEPULAUAN SERIBU UTARA, KEPULAUAN SERIBU, DKI JAKARTA",3,105,122,227
https://kawalpemilu.org#25826,"PULAU PANGGANG, KEPULAUAN SERIBU UTARA, KEPULAUAN SERIBU, DKI JAKARTA",4,128,90,218
https://kawalpemilu.org#25826,"PULAU PANGGANG, KEPULAUAN SERIBU UTARA, KEPULAUAN SERIBU, DKI JAKARTA",5,85,142,227
https://kawalpemilu.org#25826,"PULAU PANGGANG, KEPULAUAN SERIBU UTARA, KEPULAUAN SERIBU, DKI JAKARTA",6,110,82,192
https://kawalpemilu.org#25826,"PULAU PANGGANG, KEPULAUAN SERIBU UTARA, KEPULAUAN SERIBU, DKI JAKARTA",7,84,123,207
https://kawalpemilu.org#25826,"PULAU PANGGANG, KEPULAUAN SERIBU UTARA, KEPULAUAN SERIBU, DKI JAKARTA",8,95,107,202
https://kawalpemilu.org#25826,"PULAU PANGGANG, KEPULAUAN SERIBU UTARA, KEPULAUAN SERIBU, DKI JAKARTA",9,122,96,218
https://kawalpemilu.org#25826,"PULAU PANGGANG, KEPULAUAN SERIBU UTARA, KEPULAUAN SERIBU, DKI JAKARTA",10,126,83,209
https://kawalpemilu.org#25826,"PULAU PANGGANG, KEPULAUAN SERIBU UTARA, KEPULAUAN SERIBU, DKI JAKARTA",11,144,82,226
https://kawalpemilu.org#25826,"PULAU PANGGANG, KEPULAUAN SERIBU UTARA, KEPULAUAN SERIBU, DKI JAKARTA",12,136,89,225
https://kawalpemilu.org#25826,"PULAU PANGGANG, KEPULAUAN SERIBU UTARA, KEPULAUAN SERIBU, DKI JAKARTA",13,161,94,255
https://kawalpemilu.org#25826,"PULAU PANGGANG, KEPULAUAN SERIBU UTARA, KEPULAUAN SERIBU, DKI JAKARTA",14,123,114,237
https://kawalpemilu.org#25826,"PULAU PANGGANG, KEPULAUAN SERIBU UTARA, KEPULAUAN SERIBU, DKI JAKARTA",15,133,119,252
https://kawalpemilu.org#25826,"PULAU PANGGANG, KEPULAUAN SERIBU UTARA, KEPULAUAN SERIBU, DKI JAKARTA",16,140,97,237
https://kawalpemilu.org#25826,"PULAU PANGGANG, KEPULAUAN SERIBU UTARA, KEPULAUAN SERIBU, DKI JAKARTA",17,145,103,248
https://kawalpemilu.org#25827,"PULAU KELAPA, KEPULAUAN SERIBU UTARA, KEPULAUAN SERIBU, DKI JAKARTA",1,152,96,248
https://kawalpemilu.org#25827,"PULAU KELAPA, KEPULAUAN SERIBU UTARA, KEPULAUAN SERIBU, DKI JAKARTA",2,195,48,243
https://kawalpemilu.org#25827,"PULAU KELAPA, KEPULAUAN SERIBU UTARA, KEPULAUAN SERIBU, DKI JAKARTA",3,170,85,255
https://kawalpemilu.org#25827,"PULAU KELAPA, KEPULAUAN SERIBU UTARA, KEPULAUAN SERIBU, DKI JAKARTA",4,97,124,221
https://kawalpemilu.org#25827,"PULAU KELAPA, KEPULAUAN SERIBU UTARA, KEPULAUAN SERIBU, DKI JAKARTA",5,123,120,243
https://kawalpemilu.org#25827,"PULAU KELAPA, KEPULAUAN SERIBU UTARA, KEPULAUAN SERIBU, DKI JAKARTA",6,83,116,199
https://kawalpemilu.org#25827,"PULAU KELAPA, KEPULAUAN SERIBU UTARA, KEPULAUAN SERIBU, DKI JAKARTA",7,140,100,240
https://kawalpemilu.org#25827,"PULAU KELAPA, KEPULAUAN SERIBU UTARA, KEPULAUAN SERIBU, DKI JAKARTA",8,133,95,228
https://kawalpemilu.org#25827,"PULAU KELAPA, KEPULAUAN SERIBU UTARA, KEPULAUAN SERIBU, DKI JAKARTA",9,122,102,224
https://kawalpemilu.org#25827,"PULAU KELAPA, KEPULAUAN SERIBU UTARA, KEPULAUAN SERIBU, DKI JAKARTA",10,145,89,234
https://kawalpemilu.org#25827,"PULAU KELAPA, KEPULAUAN SERIBU UTARA, KEPULAUAN SERIBU, DKI JAKARTA",11,134,85,219
https://kawalpemilu.org#25827,"PULAU KELAPA, KEPULAUAN SERIBU UTARA, KEPULAUAN SERIBU, DKI JAKARTA",12,107,97,204
https://kawalpemilu.org#25827,"PULAU KELAPA, KEPULAUAN SERIBU UTARA, KEPULAUAN SERIBU, DKI JAKARTA",13,134,94,228
https://kawalpemilu.org#25827,"PULAU KELAPA, KEPULAUAN SERIBU UTARA, KEPULAUAN SERIBU, DKI JAKARTA",14,139,58,197
https://kawalpemilu.org#25827,"PULAU KELAPA, KEPULAUAN SERIBU UTARA, KEPULAUAN SERIBU, DKI JAKARTA",15,121,33,154
https://kawalpemilu.org#25827,"PULAU KELAPA, KEPULAUAN SERIBU UTARA, KEPULAUAN SERIBU, DKI JAKARTA",16,123,57,180
https://kawalpemilu.org#25827,"PULAU KELAPA, KEPULAUAN SERIBU UTARA, KEPULAUAN SERIBU, DKI JAKARTA",17,100,58,158
https://kawalpemilu.org#25827,"PULAU KELAPA, KEPULAUAN SERIBU UTARA, KEPULAUAN SERIBU, DKI JAKARTA",18,89,34,123
https://kawalpemilu.org#25827,"PULAU KELAPA, KEPULAUAN SERIBU UTARA, KEPULAUAN SERIBU, DKI JAKARTA",19,50,33,83
https://kawalpemilu.org#25827,"PULAU KELAPA, KEPULAUAN SERIBU UTARA, KEPULAUAN SERIBU, DKI JAKARTA",20,76,76,152
https://kawalpemilu.org#25827,"PULAU KELAPA, KEPULAUAN SERIBU UTARA, KEPULAUAN SERIBU, DKI JAKARTA",21,64,77,141
https://kawalpemilu.org#25827,"PULAU KELAPA, KEPULAUAN SERIBU UTARA, KEPULAUAN SERIBU, DKI JAKARTA",22,82,66,148
https://kawalpemilu.org#25827,"PULAU KELAPA, KEPULAUAN SERIBU UTARA, KEPULAUAN SERIBU, DKI JAKARTA",23,123,128,251
https://kawalpemilu.org#25827,"PULAU KELAPA, KEPULAUAN SERIBU UTARA, KEPULAUAN SERIBU, DKI JAKARTA",24,111,108,219
https://kawalpemilu.org#25827,"PULAU KELAPA, KEPULAUAN SERIBU UTARA, KEPULAUAN SERIBU, DKI JAKARTA",25,38,49,87
https://kawalpemilu.org#25827,"PULAU KELAPA, KEPULAUAN SERIBU UTARA, KEPULAUAN SERIBU, DKI JAKARTA",26,42,71,113
https://kawalpemilu.org#25827,"PULAU KELAPA, KEPULAUAN SERIBU UTARA, KEPULAUAN SERIBU, DKI JAKARTA",27,30,67,97
https://kawalpemilu.org#25827,"PULAU KELAPA, KEPULAUAN SERIBU UTARA, KEPULAUAN SERIBU, DKI JAKARTA",28,16,15,31
https://kawalpemilu.org#25828,"PULAU HARAPAN, KEPULAUAN SERIBU UTARA, KEPULAUAN SERIBU, DKI JAKARTA",1,93,131,224
https://kawalpemilu.org#25828,"PULAU HARAPAN, KEPULAUAN SERIBU UTARA, KEPULAUAN SERIBU, DKI JAKARTA",2,122,126,248
https://kawalpemilu.org#25828,"PULAU HARAPAN, KEPULAUAN SERIBU UTARA, KEPULAUAN SERIBU, DKI JAKARTA",3,116,114,230
https://kawalpemilu.org#25828,"PULAU HARAPAN, KEPULAUAN SERIBU UTARA, KEPULAUAN SERIBU, DKI JAKARTA",4,121,95,216
https://kawalpemilu.org#25828,"PULAU HARAPAN, KEPULAUAN SERIBU UTARA, KEPULAUAN SERIBU, DKI JAKARTA",5,99,118,217
https://kawalpemilu.org#25828,"PULAU HARAPAN, KEPULAUAN SERIBU UTARA, KEPULAUAN SERIBU, DKI JAKARTA",6,49,138,187
https://kawalpemilu.org#25828,"PULAU HARAPAN, KEPULAUAN SERIBU UTARA, KEPULAUAN SERIBU, DKI JAKARTA",7,52,116,168
https://kawalpemilu.org#25830,"PULAU TIDUNG, KEPULAUAN SERIBU SELATAN, KEPULAUAN SERIBU, DKI JAKARTA",1,129,118,247
https://kawalpemilu.org#25830,"PULAU TIDUNG, KEPULAUAN SERIBU SELATAN, KEPULAUAN SERIBU, DKI JAKARTA",2,115,132,247
https://kawalpemilu.org#25830,"PULAU TIDUNG, KEPULAUAN SERIBU SELATAN, KEPULAUAN SERIBU, DKI JAKARTA",3,85,165,250
https://kawalpemilu.org#25830,"PULAU TIDUNG, KEPULAUAN SERIBU SELATAN, KEPULAUAN SERIBU, DKI JAKARTA",4,79,110,189
https://kawalpemilu.org#25830,"PULAU TIDUNG, KEPULAUAN SERIBU SELATAN, KEPULAUAN SERIBU, DKI JAKARTA",5,104,152,256
https://kawalpemilu.org#25830,"PULAU TIDUNG, KEPULAUAN SERIBU SELATAN, KEPULAUAN SERIBU, DKI JAKARTA",6,109,135,244
https://kawalpemilu.org#25830,"PULAU TIDUNG, KEPULAUAN SERIBU SELATAN, KEPULAUAN SERIBU, DKI JAKARTA",7,139,125,264
https://kawalpemilu.org#25830,"PULAU TIDUNG, KEPULAUAN SERIBU SELATAN, KEPULAUAN SERIBU, DKI JAKARTA",8,107,134,241
https://kawalpemilu.org#25830,"PULAU TIDUNG, KEPULAUAN SERIBU SELATAN, KEPULAUAN SERIBU, DKI JAKARTA",9,97,117,214
https://kawalpemilu.org#25830,"PULAU TIDUNG, KEPULAUAN SERIBU SELATAN, KEPULAUAN SERIBU, DKI JAKARTA",10,131,100,231
https://kawalpemilu.org#25830,"PULAU TIDUNG, KEPULAUAN SERIBU SELATAN, KEPULAUAN SERIBU, DKI JAKARTA",11,125,99,224
https://kawalpemilu.org#25830,"PULAU TIDUNG, KEPULAUAN SERIBU SELATAN, KEPULAUAN SERIBU, DKI JAKARTA",12,129,123,252
https://kawalpemilu.org#25830,"PULAU TIDUNG, KEPULAUAN SERIBU SELATAN, KEPULAUAN SERIBU, DKI JAKARTA",13,152,90,242
https://kawalpemilu.org#25830,"PULAU TIDUNG, KEPULAUAN SERIBU SELATAN, KEPULAUAN SERIBU, DKI JAKARTA",14,26,103,129
https://kawalpemilu.org#25831,"PULAU PARI, KEPULAUAN SERIBU SELATAN, KEPULAUAN SERIBU, DKI JAKARTA",1,102,144,246
https://kawalpemilu.org#25831,"PULAU PARI, KEPULAUAN SERIBU SELATAN, KEPULAUAN SERIBU, DKI JAKARTA",2,141,107,248
https://kawalpemilu.org#25831,"PULAU PARI, KEPULAUAN SERIBU SELATAN, KEPULAUAN SERIBU, DKI JAKARTA",3,92,142,234
https://kawalpemilu.org#25831,"PULAU PARI, KEPULAUAN SERIBU SELATAN, KEPULAUAN SERIBU, DKI JAKARTA",4,122,117,239
https://kawalpemilu.org#25831,"PULAU PARI, KEPULAUAN SERIBU SELATAN, KEPULAUAN SERIBU, DKI JAKARTA",5,193,70,263
https://kawalpemilu.org#25831,"PULAU PARI, KEPULAUAN SERIBU SELATAN, KEPULAUAN SERIBU, DKI JAKARTA",6,118,149,267
https://kawalpemilu.org#25831,"PULAU PARI, KEPULAUAN SERIBU SELATAN, KEPULAUAN SERIBU, DKI JAKARTA",7,82,172,254
https://kawalpemilu.org#25831,"PULAU PARI, KEPULAUAN SERIBU SELATAN, KEPULAUAN SERIBU, DKI JAKARTA",8,139,119,258
https://kawalpemilu.org#25832,"PULAU UNTUNG JAWA, KEPULAUAN SERIBU SELATAN, KEPULAUAN SERIBU, DKI JAKARTA",1,127,103,230
https://kawalpemilu.org#25832,"PULAU UNTUNG JAWA, KEPULAUAN SERIBU SELATAN, KEPULAUAN SERIBU, DKI JAKARTA",2,136,94,230
https://kawalpemilu.org#25832,"PULAU UNTUNG JAWA, KEPULAUAN SERIBU SELATAN, KEPULAUAN SERIBU, DKI JAKARTA",3,116,121,237
https://kawalpemilu.org#25832,"PULAU UNTUNG JAWA, KEPULAUAN SERIBU SELATAN, KEPULAUAN SERIBU, DKI JAKARTA",4,83,156,239
https://kawalpemilu.org#25832,"PULAU UNTUNG JAWA, KEPULAUAN SERIBU SELATAN, KEPULAUAN SERIBU, DKI JAKARTA",5,56,136,192
https://kawalpemilu.org#25832,"PULAU UNTUNG JAWA, KEPULAUAN SERIBU SELATAN, KEPULAUAN SERIBU, DKI JAKARTA",6,86,111,197
https://kawalpemilu.org#25832,"PULAU UNTUNG JAWA, KEPULAUAN SERIBU SELATAN, KEPULAUAN SERIBU, DKI JAKARTA",7,58,50,108
https://kawalpemilu.org#25835,"GAMBIR, GAMBIR, JAKARTA PUSAT, DKI JAKARTA",1,157,92,249
https://kawalpemilu.org#25835,"GAMBIR, GAMBIR, JAKARTA PUSAT, DKI JAKARTA",2,193,46,239
https://kawalpemilu.org#25835,"GAMBIR, GAMBIR, JAKARTA PUSAT, DKI JAKARTA",3,199,54,253
https://kawalpemilu.org#25835,"GAMBIR, GAMBIR, JAKARTA PUSAT, DKI JAKARTA",4,149,82,231
https://kawalpemilu.org#25835,"GAMBIR, GAMBIR, JAKARTA PUSAT, DKI JAKARTA",5,93,144,237
https://kawalpemilu.org#25835,"GAMBIR, GAMBIR, JAKARTA PUSAT, DKI JAKARTA",6,79,154,233
https://kawalpemilu.org#25835,"GAMBIR, GAMBIR, JAKARTA PUSAT, DKI JAKARTA",7,74,114,188
https://kawalpemilu.org#25835,"GAMBIR, GAMBIR, JAKARTA PUSAT, DKI JAKARTA",8,109,46,155
https://kawalpemilu.org#25835,"GAMBIR, GAMBIR, JAKARTA PUSAT, DKI JAKARTA",9,98,70,168
https://kawalpemilu.org#25836,"CIDENG, GAMBIR, JAKARTA PUSAT, DKI JAKARTA",1,103,63,166
https://kawalpemilu.org#25836,"CIDENG, GAMBIR, JAKARTA PUSAT, DKI JAKARTA",2,152,56,208
https://kawalpemilu.org#25836,"CIDENG, GAMBIR, JAKARTA PUSAT, DKI JAKARTA",3,136,119,255
https://kawalpemilu.org#25836,"CIDENG, GAMBIR, JAKARTA PUSAT, DKI JAKARTA",4,149,63,212
https://kawalpemilu.org#25836,"CIDENG, GAMBIR, JAKARTA PUSAT, DKI JAKARTA",5,149,83,232
https://kawalpemilu.org#25836,"CIDENG, GAMBIR, JAKARTA PUSAT, DKI JAKARTA",6,104,76,180
https://kawalpemilu.org#25836,"CIDENG, GAMBIR, JAKARTA PUSAT, DKI JAKARTA",7,68,119,187
https://kawalpemilu.org#25836,"CIDENG, GAMBIR, JAKARTA PUSAT, DKI JAKARTA",8,75,115,190
https://kawalpemilu.org#25836,"CIDENG, GAMBIR, JAKARTA PUSAT, DKI JAKARTA",9,97,35,132
https://kawalpemilu.org#25836,"CIDENG, GAMBIR, JAKARTA PUSAT, DKI JAKARTA",10,95,64,159
https://kawalpemilu.org#25836,"CIDENG, GAMBIR, JAKARTA PUSAT, DKI JAKARTA",11,144,44,188
https://kawalpemilu.org#25836,"CIDENG, GAMBIR, JAKARTA PUSAT, DKI JAKARTA",12,182,24,206
https://kawalpemilu.org#25836,"CIDENG, GAMBIR, JAKARTA PUSAT, DKI JAKARTA",13,177,12,189
https://kawalpemilu.org#25836,"CIDENG, GAMBIR, JAKARTA PUSAT, DKI JAKARTA",14,232,15,247
https://kawalpemilu.org#25836,"CIDENG, GAMBIR, JAKARTA PUSAT, DKI JAKARTA",15,180,43,223
https://kawalpemilu.org#25836,"CIDENG, GAMBIR, JAKARTA PUSAT, DKI JAKARTA",16,165,37,202
https://kawalpemilu.org#25836,"CIDENG, GAMBIR, JAKARTA PUSAT, DKI JAKARTA",17,134,91,225
https://kawalpemilu.org#25836,"CIDENG, GAMBIR, JAKARTA PUSAT, DKI JAKARTA",18,164,48,212
https://kawalpemilu.org#25836,"CIDENG, GAMBIR, JAKARTA PUSAT, DKI JAKARTA",19,123,109,232
https://kawalpemilu.org#25836,"CIDENG, GAMBIR, JAKARTA PUSAT, DKI JAKARTA",20,187,46,233
https://kawalpemilu.org#25836,"CIDENG, GAMBIR, JAKARTA PUSAT, DKI JAKARTA",21,175,30,205
https://kawalpemilu.org#25836,"CIDENG, GAMBIR, JAKARTA PUSAT, DKI JAKARTA",22,89,54,143
https://kawalpemilu.org#25836,"CIDENG, GAMBIR, JAKARTA PUSAT, DKI JAKARTA",23,167,21,188
https://kawalpemilu.org#25836,"CIDENG, GAMBIR, JAKARTA PUSAT, DKI JAKARTA",24,153,19,172
https://kawalpemilu.org#25836,"CIDENG, GAMBIR, JAKARTA PUSAT, DKI JAKARTA",25,229,7,236
https://kawalpemilu.org#25836,"CIDENG, GAMBIR, JAKARTA PUSAT, DKI JAKARTA",26,189,49,238
https://kawalpemilu.org#25836,"CIDENG, GAMBIR, JAKARTA PUSAT, DKI JAKARTA",27,134,99,233
https://kawalpemilu.org#25836,"CIDENG, GAMBIR, JAKARTA PUSAT, DKI JAKARTA",28,117,97,214
https://kawalpemilu.org#25836,"CIDENG, GAMBIR, JAKARTA PUSAT, DKI JAKARTA",29,94,96,190
https://kawalpemilu.org#25836,"CIDENG, GAMBIR, JAKARTA PUSAT, DKI JAKARTA",30,128,80,208
https://kawalpemilu.org#25836,"CIDENG, GAMBIR, JAKARTA PUSAT, DKI JAKARTA",31,134,58,192
https://kawalpemilu.org#25836,"CIDENG, GAMBIR, JAKARTA PUSAT, DKI JAKARTA",32,135,76,211
https://kawalpemilu.org#25836,"CIDENG, GAMBIR, JAKARTA PUSAT, DKI JAKARTA",33,128,80,208
https://kawalpemilu.org#25836,"CIDENG, GAMBIR, JAKARTA PUSAT, DKI JAKARTA",34,156,28,184
https://kawalpemilu.org#25836,"CIDENG, GAMBIR, JAKARTA PUSAT, DKI JAKARTA",35,133,48,181
https://kawalpemilu.org#25836,"CIDENG, GAMBIR, JAKARTA PUSAT, DKI JAKARTA",36,186,29,215
https://kawalpemilu.org#25836,"CIDENG, GAMBIR, JAKARTA PUSAT, DKI JAKARTA",37,198,10,208
https://kawalpemilu.org#25836,"CIDENG, GAMBIR, JAKARTA PUSAT, DKI JAKARTA",38,143,27,170
https://kawalpemilu.org#25836,"CIDENG, GAMBIR, JAKARTA PUSAT, DKI JAKARTA",39,90,141,231
https://kawalpemilu.org#25836,"CIDENG, GAMBIR, JAKARTA PUSAT, DKI JAKARTA",40,103,61,164
https://kawalpemilu.org#25836,"CIDENG, GAMBIR, JAKARTA PUSAT, DKI JAKARTA",41,162,14,176
https://kawalpemilu.org#25836,"CIDENG, GAMBIR, JAKARTA PUSAT, DKI JAKARTA",42,112,104,216
https://kawalpemilu.org#25836,"CIDENG, GAMBIR, JAKARTA PUSAT, DKI JAKARTA",43,64,144,208
https://kawalpemilu.org#25836,"CIDENG, GAMBIR, JAKARTA PUSAT, DKI JAKARTA",44,91,127,218
https://kawalpemilu.org#25836,"CIDENG, GAMBIR, JAKARTA PUSAT, DKI JAKARTA",45,77,92,169
https://kawalpemilu.org#25836,"CIDENG, GAMBIR, JAKARTA PUSAT, DKI JAKARTA",46,132,103,235
https://kawalpemilu.org#25836,"CIDENG, GAMBIR, JAKARTA PUSAT, DKI JAKARTA",47,88,112,200
https://kawalpemilu.org#25836,"CIDENG, GAMBIR, JAKARTA PUSAT, DKI JAKARTA",48,85,113,198
https://kawalpemilu.org#25836,"CIDENG, GAMBIR, JAKARTA PUSAT, DKI JAKARTA",49,85,99,184
https://kawalpemilu.org#25836,"CIDENG, GAMBIR, JAKARTA PUSAT, DKI JAKARTA",50,140,93,233
https://kawalpemilu.org#25836,"CIDENG, GAMBIR, JAKARTA PUSAT, DKI JAKARTA",51,132,118,250
https://kawalpemilu.org#25836,"CIDENG, GAMBIR, JAKARTA PUSAT, DKI JAKARTA",52,157,77,234
https://kawalpemilu.org#25836,"CIDENG, GAMBIR, JAKARTA PUSAT, DKI JAKARTA",53,139,57,196
https://kawalpemilu.org#25836,"CIDENG, GAMBIR, JAKARTA PUSAT, DKI JAKARTA",54,118,73,191
https://kawalpemilu.org#25836,"CIDENG, GAMBIR, JAKARTA PUSAT, DKI JAKARTA",55,110,66,176
https://kawalpemilu.org#25836,"CIDENG, GAMBIR, JAKARTA PUSAT, DKI JAKARTA",56,142,35,177
https://kawalpemilu.org#25837,"PETOJO UTARA, GAMBIR, JAKARTA PUSAT, DKI JAKARTA",1,98,130,228
https://kawalpemilu.org#25837,"PETOJO UTARA, GAMBIR, JAKARTA PUSAT, DKI JAKARTA",2,190,47,237
https://kawalpemilu.org#25837,"PETOJO UTARA, GAMBIR, JAKARTA PUSAT, DKI JAKARTA",3,91,153,244
https://kawalpemilu.org#25837,"PETOJO UTARA, GAMBIR, JAKARTA PUSAT, DKI JAKARTA",4,111,106,217
https://kawalpemilu.org#25837,"PETOJO UTARA, GAMBIR, JAKARTA PUSAT, DKI JAKARTA",5,104,95,199
https://kawalpemilu.org#25837,"PETOJO UTARA, GAMBIR, JAKARTA PUSAT, DKI JAKARTA",6,120,120,240
https://kawalpemilu.org#25837,"PETOJO UTARA, GAMBIR, JAKARTA PUSAT, DKI JAKARTA",7,73,160,233
https://kawalpemilu.org#25837,"PETOJO UTARA, GAMBIR, JAKARTA PUSAT, DKI JAKARTA",8,110,115,225
https://kawalpemilu.org#25837,"PETOJO UTARA, GAMBIR, JAKARTA PUSAT, DKI JAKARTA",9,68,162,230
https://kawalpemilu.org#25837,"PETOJO UTARA, GAMBIR, JAKARTA PUSAT, DKI JAKARTA",10,139,93,232
https://kawalpemilu.org#25837,"PETOJO UTARA, GAMBIR, JAKARTA PUSAT, DKI JAKARTA",11,185,34,219
https://kawalpemilu.org#25837,"PETOJO UTARA, GAMBIR, JAKARTA PUSAT, DKI JAKARTA",12,158,28,186
https://kawalpemilu.org#25837,"PETOJO UTARA, GAMBIR, JAKARTA PUSAT, DKI JAKARTA",13,125,108,233
https://kawalpemilu.org#25837,"PETOJO UTARA, GAMBIR, JAKARTA PUSAT, DKI JAKARTA",14,105,127,232
https://kawalpemilu.org#25837,"PETOJO UTARA, GAMBIR, JAKARTA PUSAT, DKI JAKARTA",15,194,34,228
https://kawalpemilu.org#25837,"PETOJO UTARA, GAMBIR, JAKARTA PUSAT, DKI JAKARTA",16,114,120,234
https://kawalpemilu.org#25837,"PETOJO UTARA, GAMBIR, JAKARTA PUSAT, DKI JAKARTA",17,123,111,234
https://kawalpemilu.org#25837,"PETOJO UTARA, GAMBIR, JAKARTA PUSAT, DKI JAKARTA",18,86,144,230
https://kawalpemilu.org#25837,"PETOJO UTARA, GAMBIR, JAKARTA PUSAT, DKI JAKARTA",19,111,112,223
https://kawalpemilu.org#25837,"PETOJO UTARA, GAMBIR, JAKARTA PUSAT, DKI JAKARTA",20,80,164,244
https://kawalpemilu.org#25837,"PETOJO UTARA, GAMBIR, JAKARTA PUSAT, DKI JAKARTA",21,100,141,241
https://kawalpemilu.org#25837,"PETOJO UTARA, GAMBIR, JAKARTA PUSAT, DKI JAKARTA",22,116,121,237
https://kawalpemilu.org#25837,"PETOJO UTARA, GAMBIR, JAKARTA PUSAT, DKI JAKARTA",23,78,116,194
https://kawalpemilu.org#25837,"PETOJO UTARA, GAMBIR, JAKARTA PUSAT, DKI JAKARTA",24,138,80,218
https://kawalpemilu.org#25837,"PETOJO UTARA, GAMBIR, JAKARTA PUSAT, DKI JAKARTA",25,74,129,203
https://kawalpemilu.org#25837,"PETOJO UTARA, GAMBIR, JAKARTA PUSAT, DKI JAKARTA",26,100,92,192
https://kawalpemilu.org#25837,"PETOJO UTARA, GAMBIR, JAKARTA PUSAT, DKI JAKARTA",27,157,27,184
https://kawalpemilu.org#25837,"PETOJO UTARA, GAMBIR, JAKARTA PUSAT, DKI JAKARTA",28,206,9,215
https://kawalpemilu.org#25837,"PETOJO UTARA, GAMBIR, JAKARTA PUSAT, DKI JAKARTA",29,144,26,170
https://kawalpemilu.org#25837,"PETOJO UTARA, GAMBIR, JAKARTA PUSAT, DKI JAKARTA",30,164,8,172
https://kawalpemilu.org#25837,"PETOJO UTARA, GAMBIR, JAKARTA PUSAT, DKI JAKARTA",31,148,64,212
https://kawalpemilu.org#25837,"PETOJO UTARA, GAMBIR, JAKARTA PUSAT, DKI JAKARTA",32,143,66,209
https://kawalpemilu.org#25837,"PETOJO UTARA, GAMBIR, JAKARTA PUSAT, DKI JAKARTA",33,118,110,228
https://kawalpemilu.org#25837,"PETOJO UTARA, GAMBIR, JAKARTA PUSAT, DKI JAKARTA",34,141,67,208
https://kawalpemilu.org#25837,"PETOJO UTARA, GAMBIR, JAKARTA PUSAT, DKI JAKARTA",35,161,67,228
https://kawalpemilu.org#25837,"PETOJO UTARA, GAMBIR, JAKARTA PUSAT, DKI JAKARTA",36,143,96,239
https://kawalpemilu.org#25837,"PETOJO UTARA, GAMBIR, JAKARTA PUSAT, DKI JAKARTA",37,142,33,175
https://kawalpemilu.org#25837,"PETOJO UTARA, GAMBIR, JAKARTA PUSAT, DKI JAKARTA",38,101,92,193
https://kawalpemilu.org#25837,"PETOJO UTARA, GAMBIR, JAKARTA PUSAT, DKI JAKARTA",39,90,52,142
https://kawalpemilu.org#25837,"PETOJO UTARA, GAMBIR, JAKARTA PUSAT, DKI JAKARTA",40,126,52,178
https://kawalpemilu.org#25837,"PETOJO UTARA, GAMBIR, JAKARTA PUSAT, DKI JAKARTA",41,133,49,182
https://kawalpemilu.org#25837,"PETOJO UTARA, GAMBIR, JAKARTA PUSAT, DKI JAKARTA",42,127,80,207
https://kawalpemilu.org#25837,"PETOJO UTARA, GAMBIR, JAKARTA PUSAT, DKI JAKARTA",43,60,143,203
https://kawalpemilu.org#25837,"PETOJO UTARA, GAMBIR, JAKARTA PUSAT, DKI JAKARTA",44,139,57,196
https://kawalpemilu.org#25837,"PETOJO UTARA, GAMBIR, JAKARTA PUSAT, DKI JAKARTA",45,113,45,158
https://kawalpemilu.org#25837,"PETOJO UTARA, GAMBIR, JAKARTA PUSAT, DKI JAKARTA",46,191,40,231
https://kawalpemilu.org#25837,"PETOJO UTARA, GAMBIR, JAKARTA PUSAT, DKI JAKARTA",47,160,35,195
https://kawalpemilu.org#25837,"PETOJO UTARA, GAMBIR, JAKARTA PUSAT, DKI JAKARTA",48,156,14,170
https://kawalpemilu.org#25837,"PETOJO UTARA, GAMBIR, JAKARTA PUSAT, DKI JAKARTA",49,91,131,222
https://kawalpemilu.org#25837,"PETOJO UTARA, GAMBIR, JAKARTA PUSAT, DKI JAKARTA",50,72,151,223
https://kawalpemilu.org#25837,"PETOJO UTARA, GAMBIR, JAKARTA PUSAT, DKI JAKARTA",51,71,163,234
https://kawalpemilu.org#25837,"PETOJO UTARA, GAMBIR, JAKARTA PUSAT, DKI JAKARTA",52,143,48,191
https://kawalpemilu.org#25837,"PETOJO UTARA, GAMBIR, JAKARTA PUSAT, DKI JAKARTA",53,80,104,186
https://kawalpemilu.org#25837,"PETOJO UTARA, GAMBIR, JAKARTA PUSAT, DKI JAKARTA",54,67,139,206
https://kawalpemilu.org#25837,"PETOJO UTARA, GAMBIR, JAKARTA PUSAT, DKI JAKARTA",55,84,128,212
https://kawalpemilu.org#25837,"PETOJO UTARA, GAMBIR, JAKARTA PUSAT, DKI JAKARTA",56,90,106,196
https://kawalpemilu.org#25837,"PETOJO UTARA, GAMBIR, JAKARTA PUSAT, DKI JAKARTA",57,57,142,199
https://kawalpemilu.org#25837,"PETOJO UTARA, GAMBIR, JAKARTA PUSAT, DKI JAKARTA",58,81,137,218
https://kawalpemilu.org#25837,"PETOJO UTARA, GAMBIR, JAKARTA PUSAT, DKI JAKARTA",59,82,93,175
https://kawalpemilu.org#25837,"PETOJO UTARA, GAMBIR, JAKARTA PUSAT, DKI JAKARTA",60,101,91,192
https://kawalpemilu.org#25838,"PETOJO SELATAN, GAMBIR, JAKARTA PUSAT, DKI JAKARTA",1,139,47,186
https://kawalpemilu.org#25838,"PETOJO SELATAN, GAMBIR, JAKARTA PUSAT, DKI JAKARTA",2,161,82,243
https://kawalpemilu.org#25838,"PETOJO SELATAN, GAMBIR, JAKARTA PUSAT, DKI JAKARTA",3,120,89,209
https://kawalpemilu.org#25838,"PETOJO SELATAN, GAMBIR, JAKARTA PUSAT, DKI JAKARTA",4,170,72,242
https://kawalpemilu.org#25838,"PETOJO SELATAN, GAMBIR, JAKARTA PUSAT, DKI JAKARTA",5,68,181,249
https://kawalpemilu.org#25838,"PETOJO SELATAN, GAMBIR, JAKARTA PUSAT, DKI JAKARTA",6,87,133,220
https://kawalpemilu.org#25838,"PETOJO SELATAN, GAMBIR, JAKARTA PUSAT, DKI JAKARTA",7,87,124,211
https://kawalpemilu.org#25838,"PETOJO SELATAN, GAMBIR, JAKARTA PUSAT, DKI JAKARTA",8,114,123,237
https://kawalpemilu.org#25838,"PETOJO SELATAN, GAMBIR, JAKARTA PUSAT, DKI JAKARTA",9,82,158,240
https://kawalpemilu.org#25838,"PETOJO SELATAN, GAMBIR, JAKARTA PUSAT, DKI JAKARTA",10,51,133,184
https://kawalpemilu.org#25838,"PETOJO SELATAN, GAMBIR, JAKARTA PUSAT, DKI JAKARTA",11,102,79,181
https://kawalpemilu.org#25838,"PETOJO SELATAN, GAMBIR, JAKARTA PUSAT, DKI JAKARTA",12,188,68,256
https://kawalpemilu.org#25838,"PETOJO SELATAN, GAMBIR, JAKARTA PUSAT, DKI JAKARTA",13,119,139,258
https://kawalpemilu.org#25838,"PETOJO SELATAN, GAMBIR, JAKARTA PUSAT, DKI JAKARTA",14,141,55,196
https://kawalpemilu.org#25838,"PETOJO SELATAN, GAMBIR, JAKARTA PUSAT, DKI JAKARTA",15,151,44,195
https://kawalpemilu.org#25838,"PETOJO SELATAN, GAMBIR, JAKARTA PUSAT, DKI JAKARTA",16,106,98,204
https://kawalpemilu.org#25838,"PETOJO SELATAN, GAMBIR, JAKARTA PUSAT, DKI JAKARTA",17,81,120,201
https://kawalpemilu.org#25838,"PETOJO SELATAN, GAMBIR, JAKARTA PUSAT, DKI JAKARTA",18,140,66,206
https://kawalpemilu.org#25838,"PETOJO SELATAN, GAMBIR, JAKARTA PUSAT, DKI JAKARTA",19,113,102,215
https://kawalpemilu.org#25838,"PETOJO SELATAN, GAMBIR, JAKARTA PUSAT, DKI JAKARTA",20,60,124,184
https://kawalpemilu.org#25838,"PETOJO SELATAN, GAMBIR, JAKARTA PUSAT, DKI JAKARTA",21,70,107,177
https://kawalpemilu.org#25838,"PETOJO SELATAN, GAMBIR, JAKARTA PUSAT, DKI JAKARTA",22,90,95,185
https://kawalpemilu.org#25838,"PETOJO SELATAN, GAMBIR, JAKARTA PUSAT, DKI JAKARTA",23,159,53,212
https://kawalpemilu.org#25838,"PETOJO SELATAN, GAMBIR, JAKARTA PUSAT, DKI JAKARTA",24,105,94,199
https://kawalpemilu.org#25838,"PETOJO SELATAN, GAMBIR, JAKARTA PUSAT, DKI JAKARTA",25,99,118,217
https://kawalpemilu.org#25838,"PETOJO SELATAN, GAMBIR, JAKARTA PUSAT, DKI JAKARTA",26,99,96,195
https://kawalpemilu.org#25838,"PETOJO SELATAN, GAMBIR, JAKARTA PUSAT, DKI JAKARTA",27,101,79,180
https://kawalpemilu.org#25838,"PETOJO SELATAN, GAMBIR, JAKARTA PUSAT, DKI JAKARTA",28,175,31,206
https://kawalpemilu.org#25838,"PETOJO SELATAN, GAMBIR, JAKARTA PUSAT, DKI JAKARTA",29,150,22,172
https://kawalpemilu.org#25838,"PETOJO SELATAN, GAMBIR, JAKARTA PUSAT, DKI JAKARTA",30,143,19,162
https://kawalpemilu.org#25838,"PETOJO SELATAN, GAMBIR, JAKARTA PUSAT, DKI JAKARTA",31,130,67,197
https://kawalpemilu.org#25838,"PETOJO SELATAN, GAMBIR, JAKARTA PUSAT, DKI JAKARTA",32,90,102,192
https://kawalpemilu.org#25838,"PETOJO SELATAN, GAMBIR, JAKARTA PUSAT, DKI JAKARTA",33,120,112,232
https://kawalpemilu.org#25838,"PETOJO SELATAN, GAMBIR, JAKARTA PUSAT, DKI JAKARTA",34,129,72,201
https://kawalpemilu.org#25838,"PETOJO SELATAN, GAMBIR, JAKARTA PUSAT, DKI JAKARTA",35,85,110,195
https://kawalpemilu.org#25838,"PETOJO SELATAN, GAMBIR, JAKARTA PUSAT, DKI JAKARTA",36,85,138,223
https://kawalpemilu.org#25838,"PETOJO SELATAN, GAMBIR, JAKARTA PUSAT, DKI JAKARTA",37,115,119,234
https://kawalpemilu.org#25838,"PETOJO SELATAN, GAMBIR, JAKARTA PUSAT, DKI JAKARTA",38,82,163,245
https://kawalpemilu.org#25838,"PETOJO SELATAN, GAMBIR, JAKARTA PUSAT, DKI JAKARTA",39,102,120,222
https://kawalpemilu.org#25838,"PETOJO SELATAN, GAMBIR, JAKARTA PUSAT, DKI JAKARTA",40,157,97,254
https://kawalpemilu.org#25838,"PETOJO SELATAN, GAMBIR, JAKARTA PUSAT, DKI JAKARTA",41,80,155,235
https://kawalpemilu.org#25838,"PETOJO SELATAN, GAMBIR, JAKARTA PUSAT, DKI JAKARTA",42,82,132,217
https://kawalpemilu.org#25838,"PETOJO SELATAN, GAMBIR, JAKARTA PUSAT, DKI JAKARTA",43,98,121,219
https://kawalpemilu.org#25838,"PETOJO SELATAN, GAMBIR, JAKARTA PUSAT, DKI JAKARTA",44,75,151,226
https://kawalpemilu.org#25838,"PETOJO SELATAN, GAMBIR, JAKARTA PUSAT, DKI JAKARTA",45,67,109,176
https://kawalpemilu.org#25838,"PETOJO SELATAN, GAMBIR, JAKARTA PUSAT, DKI JAKARTA",46,76,92,168
https://kawalpemilu.org#25838,"PETOJO SELATAN, GAMBIR, JAKARTA PUSAT, DKI JAKARTA",47,53,81,134
https://kawalpemilu.org#25838,"PETOJO SELATAN, GAMBIR, JAKARTA PUSAT, DKI JAKARTA",48,64,108,172
https://kawalpemilu.org#25839,"KEBON KELAPA, GAMBIR, JAKARTA PUSAT, DKI JAKARTA",1,185,11,196
https://kawalpemilu.org#25839,"KEBON KELAPA, GAMBIR, JAKARTA PUSAT, DKI JAKARTA",2,141,54,195
https://kawalpemilu.org#25839,"KEBON KELAPA, GAMBIR, JAKARTA PUSAT, DKI JAKARTA",3,152,72,224
https://kawalpemilu.org#25839,"KEBON KELAPA, GAMBIR, JAKARTA PUSAT, DKI JAKARTA",4,162,83,245
https://kawalpemilu.org#25839,"KEBON KELAPA, GAMBIR, JAKARTA PUSAT, DKI JAKARTA",5,135,78,213
https://kawalpemilu.org#25839,"KEBON KELAPA, GAMBIR, JAKARTA PUSAT, DKI JAKARTA",6,124,114,238
https://kawalpemilu.org#25839,"KEBON KELAPA, GAMBIR, JAKARTA PUSAT, DKI JAKARTA",7,133,92,225
https://kawalpemilu.org#25839,"KEBON KELAPA, GAMBIR, JAKARTA PUSAT, DKI JAKARTA",8,104,79,183
https://kawalpemilu.org#25839,"KEBON KELAPA, GAMBIR, JAKARTA PUSAT, DKI JAKARTA",9,181,63,244
https://kawalpemilu.org#25839,"KEBON KELAPA, GAMBIR, JAKARTA PUSAT, DKI JAKARTA",10,167,32,199
https://kawalpemilu.org#25839,"KEBON KELAPA, GAMBIR, JAKARTA PUSAT, DKI JAKARTA",11,131,101,232
https://kawalpemilu.org#25839,"KEBON KELAPA, GAMBIR, JAKARTA PUSAT, DKI JAKARTA",12,171,19,190
https://kawalpemilu.org#25839,"KEBON KELAPA, GAMBIR, JAKARTA PUSAT, DKI JAKARTA",13,152,69,221
https://kawalpemilu.org#25839,"KEBON KELAPA, GAMBIR, JAKARTA PUSAT, DKI JAKARTA",14,116,126,242
https://kawalpemilu.org#25839,"KEBON KELAPA, GAMBIR, JAKARTA PUSAT, DKI JAKARTA",15,135,93,228
https://kawalpemilu.org#25839,"KEBON KELAPA, GAMBIR, JAKARTA PUSAT, DKI JAKARTA",16,84,105,189
https://kawalpemilu.org#25839,"KEBON KELAPA, GAMBIR, JAKARTA PUSAT, DKI JAKARTA",17,98,99,197
https://kawalpemilu.org#25839,"KEBON KELAPA, GAMBIR, JAKARTA PUSAT, DKI JAKARTA",18,146,36,182
https://kawalpemilu.org#25839,"KEBON KELAPA, GAMBIR, JAKARTA PUSAT, DKI JAKARTA",19,135,47,182
https://kawalpemilu.org#25839,"KEBON KELAPA, GAMBIR, JAKARTA PUSAT, DKI JAKARTA",20,152,37,189
https://kawalpemilu.org#25839,"KEBON KELAPA, GAMBIR, JAKARTA PUSAT, DKI JAKARTA",21,186,20,206
https://kawalpemilu.org#25839,"KEBON KELAPA, GAMBIR, JAKARTA PUSAT, DKI JAKARTA",22,155,82,237
https://kawalpemilu.org#25839,"KEBON KELAPA, GAMBIR, JAKARTA PUSAT, DKI JAKARTA",23,110,57,167
https://kawalpemilu.org#25839,"KEBON KELAPA, GAMBIR, JAKARTA PUSAT, DKI JAKARTA",24,128,48,176
https://kawalpemilu.org#25839,"KEBON KELAPA, GAMBIR, JAKARTA PUSAT, DKI JAKARTA",25,78,115,193
https://kawalpemilu.org#25839,"KEBON KELAPA, GAMBIR, JAKARTA PUSAT, DKI JAKARTA",26,154,84,238
https://kawalpemilu.org#25839,"KEBON KELAPA, GAMBIR, JAKARTA PUSAT, DKI JAKARTA",27,82,137,219
https://kawalpemilu.org#25839,"KEBON KELAPA, GAMBIR, JAKARTA PUSAT, DKI JAKARTA",28,71,159,230
https://kawalpemilu.org#25839,"KEBON KELAPA, GAMBIR, JAKARTA PUSAT, DKI JAKARTA",29,98,99,197
https://kawalpemilu.org#25839,"KEBON KELAPA, GAMBIR, JAKARTA PUSAT, DKI JAKARTA",30,95,129,224
https://kawalpemilu.org#25839,"KEBON KELAPA, GAMBIR, JAKARTA PUSAT, DKI JAKARTA",31,80,147,227
https://kawalpemilu.org#25839,"KEBON KELAPA, GAMBIR, JAKARTA PUSAT, DKI JAKARTA",32,102,130,232
https://kawalpemilu.org#25839,"KEBON KELAPA, GAMBIR, JAKARTA PUSAT, DKI JAKARTA",33,100,113,213
https://kawalpemilu.org#25839,"KEBON KELAPA, GAMBIR, JAKARTA PUSAT, DKI JAKARTA",34,126,112,238
https://kawalpemilu.org#25839,"KEBON KELAPA, GAMBIR, JAKARTA PUSAT, DKI JAKARTA",35,83,49,132
https://kawalpemilu.org#25840,"DURI PULO, GAMBIR, JAKARTA PUSAT, DKI JAKARTA",1,185,47,232
https://kawalpemilu.org#25840,"DURI PULO, GAMBIR, JAKARTA PUSAT, DKI JAKARTA",2,148,54,202
https://kawalpemilu.org#25840,"DURI PULO, GAMBIR, JAKARTA PUSAT, DKI JAKARTA",3,155,78,233
https://kawalpemilu.org#25840,"DURI PULO, GAMBIR, JAKARTA PUSAT, DKI JAKARTA",4,156,33,189
https://kawalpemilu.org#25840,"DURI PULO, GAMBIR, JAKARTA PUSAT, DKI JAKARTA",5,215,16,231
https://kawalpemilu.org#25840,"DURI PULO, GAMBIR, JAKARTA PUSAT, DKI JAKARTA",6,219,15,234
https://kawalpemilu.org#25840,"DURI PULO, GAMBIR, JAKARTA PUSAT, DKI JAKARTA",7,212,2,214
https://kawalpemilu.org#25840,"DURI PULO, GAMBIR, JAKARTA PUSAT, DKI JAKARTA",8,152,136,188
https://kawalpemilu.org#25840,"DURI PULO, GAMBIR, JAKARTA PUSAT, DKI JAKARTA",9,127,108,235
https://kawalpemilu.org#25840,"DURI PULO, GAMBIR, JAKARTA PUSAT, DKI JAKARTA",10,208,21,229
https://kawalpemilu.org#25840,"DURI PULO, GAMBIR, JAKARTA PUSAT, DKI JAKARTA",11,101,80,181
https://kawalpemilu.org#25840,"DURI PULO, GAMBIR, JAKARTA PUSAT, DKI JAKARTA",12,87,91,178
https://kawalpemilu.org#25840,"DURI PULO, GAMBIR, JAKARTA PUSAT, DKI JAKARTA",13,109,74,183
https://kawalpemilu.org#25840,"DURI PULO, GAMBIR, JAKARTA PUSAT, DKI JAKARTA",14,119,86,205
https://kawalpemilu.org#25840,"DURI PULO, GAMBIR, JAKARTA PUSAT, DKI JAKARTA",15,146,58,204
https://kawalpemilu.org#25840,"DURI PULO, GAMBIR, JAKARTA PUSAT, DKI JAKARTA",16,113,109,222
https://kawalpemilu.org#25840,"DURI PULO, GAMBIR, JAKARTA PUSAT, DKI JAKARTA",17,92,114,206
https://kawalpemilu.org#25840,"DURI PULO, GAMBIR, JAKARTA PUSAT, DKI JAKARTA",18,95,118,213
https://kawalpemilu.org#25840,"DURI PULO, GAMBIR, JAKARTA PUSAT, DKI JAKARTA",19,120,107,227
https://kawalpemilu.org#25840,"DURI PULO, GAMBIR, JAKARTA PUSAT, DKI JAKARTA",20,97,80,177
https://kawalpemilu.org#25840,"DURI PULO, GAMBIR, JAKARTA PUSAT, DKI JAKARTA",21,127,115,242
https://kawalpemilu.org#25840,"DURI PULO, GAMBIR, JAKARTA PUSAT, DKI JAKARTA",22,105,75,180
https://kawalpemilu.org#25840,"DURI PULO, GAMBIR, JAKARTA PUSAT, DKI JAKARTA",23,93,89,182
https://kawalpemilu.org#25840,"DURI PULO, GAMBIR, JAKARTA PUSAT, DKI JAKARTA",24,91,98,189
https://kawalpemilu.org#25840,"DURI PULO, GAMBIR, JAKARTA PUSAT, DKI JAKARTA",25,111,136,247
https://kawalpemilu.org#25840,"DURI PULO, GAMBIR, JAKARTA PUSAT, DKI JAKARTA",26,88,117,205
https://kawalpemilu.org#25840,"DURI PULO, GAMBIR, JAKARTA PUSAT, DKI JAKARTA",27,84,153,237
https://kawalpemilu.org#25840,"DURI PULO, GAMBIR, JAKARTA PUSAT, DKI JAKARTA",28,73,140,213
https://kawalpemilu.org#25840,"DURI PULO, GAMBIR, JAKARTA PUSAT, DKI JAKARTA",29,88,135,223
https://kawalpemilu.org#25840,"DURI PULO, GAMBIR, JAKARTA PUSAT, DKI JAKARTA",30,142,98,240
https://kawalpemilu.org#25840,"DURI PULO, GAMBIR, JAKARTA PUSAT, DKI JAKARTA",31,132,99,231
https://kawalpemilu.org#25840,"DURI PULO, GAMBIR, JAKARTA PUSAT, DKI JAKARTA",32,101,107,208
https://kawalpemilu.org#25840,"DURI PULO, GAMBIR, JAKARTA PUSAT, DKI JAKARTA",33,86,94,180
https://kawalpemilu.org#25840,"DURI PULO, GAMBIR, JAKARTA PUSAT, DKI JAKARTA",34,85,106,191
https://kawalpemilu.org#25840,"DURI PULO, GAMBIR, JAKARTA PUSAT, DKI JAKARTA",35,97,123,220
https://kawalpemilu.org#25840,"DURI PULO, GAMBIR, JAKARTA PUSAT, DKI JAKARTA",36,53,161,214
https://kawalpemilu.org#25840,"DURI PULO, GAMBIR, JAKARTA PUSAT, DKI JAKARTA",37,93,115,208
https://kawalpemilu.org#25840,"DURI PULO, GAMBIR, JAKARTA PUSAT, DKI JAKARTA",38,98,101,199
https://kawalpemilu.org#25840,"DURI PULO, GAMBIR, JAKARTA PUSAT, DKI JAKARTA",39,83,135,218
https://kawalpemilu.org#25840,"DURI PULO, GAMBIR, JAKARTA PUSAT, DKI JAKARTA",40,92,107,199
https://kawalpemilu.org#25840,"DURI PULO, GAMBIR, JAKARTA PUSAT, DKI JAKARTA",41,104,98,202
https://kawalpemilu.org#25840,"DURI PULO, GAMBIR, JAKARTA PUSAT, DKI JAKARTA",42,108,93,201
https://kawalpemilu.org#25840,"DURI PULO, GAMBIR, JAKARTA PUSAT, DKI JAKARTA",43,108,109,217
https://kawalpemilu.org#25840,"DURI PULO, GAMBIR, JAKARTA PUSAT, DKI JAKARTA",44,91,119,210
https://kawalpemilu.org#25840,"DURI PULO, GAMBIR, JAKARTA PUSAT, DKI JAKARTA",45,84,118,202
https://kawalpemilu.org#25840,"DURI PULO, GAMBIR, JAKARTA PUSAT, DKI JAKARTA",46,113,112,225
https://kawalpemilu.org#25840,"DURI PULO, GAMBIR, JAKARTA PUSAT, DKI JAKARTA",47,100,120,220
https://kawalpemilu.org#25840,"DURI PULO, GAMBIR, JAKARTA PUSAT, DKI JAKARTA",48,95,125,220
https://kawalpemilu.org#25840,"DURI PULO, GAMBIR, JAKARTA PUSAT, DKI JAKARTA",49,147,85,232
https://kawalpemilu.org#25840,"DURI PULO, GAMBIR, JAKARTA PUSAT, DKI JAKARTA",50,124,117,241
https://kawalpemilu.org#25840,"DURI PULO, GAMBIR, JAKARTA PUSAT, DKI JAKARTA",51,87,143,230
https://kawalpemilu.org#25840,"DURI PULO, GAMBIR, JAKARTA PUSAT, DKI JAKARTA",52,120,88,208
https://kawalpemilu.org#25840,"DURI PULO, GAMBIR, JAKARTA PUSAT, DKI JAKARTA",53,74,118,192
https://kawalpemilu.org#25840,"DURI PULO, GAMBIR, JAKARTA PUSAT, DKI JAKARTA",54,135,100,235
https://kawalpemilu.org#25840,"DURI PULO, GAMBIR, JAKARTA PUSAT, DKI JAKARTA",55,125,98,223
https://kawalpemilu.org#25840,"DURI PULO, GAMBIR, JAKARTA PUSAT, DKI JAKARTA",56,140,100,240
https://kawalpemilu.org#25840,"DURI PULO, GAMBIR, JAKARTA PUSAT, DKI JAKARTA",57,134,100,234
https://kawalpemilu.org#25840,"DURI PULO, GAMBIR, JAKARTA PUSAT, DKI JAKARTA",58,82,171,253
https://kawalpemilu.org#25840,"DURI PULO, GAMBIR, JAKARTA PUSAT, DKI JAKARTA",59,133,100,233
https://kawalpemilu.org#25840,"DURI PULO, GAMBIR, JAKARTA PUSAT, DKI JAKARTA",60,134,78,212
https://kawalpemilu.org#25840,"DURI PULO, GAMBIR, JAKARTA PUSAT, DKI JAKARTA",61,149,72,221
https://kawalpemilu.org#25840,"DURI PULO, GAMBIR, JAKARTA PUSAT, DKI JAKARTA",62,119,104,223
https://kawalpemilu.org#25840,"DURI PULO, GAMBIR, JAKARTA PUSAT, DKI JAKARTA",63,100,120,220
https://kawalpemilu.org#25840,"DURI PULO, GAMBIR, JAKARTA PUSAT, DKI JAKARTA",64,113,101,214
https://kawalpemilu.org#25840,"DURI PULO, GAMBIR, JAKARTA PUSAT, DKI JAKARTA",65,127,112,239
https://kawalpemilu.org#25840,"DURI PULO, GAMBIR, JAKARTA PUSAT, DKI JAKARTA",66,126,107,233
https://kawalpemilu.org#25842,"PASAR BARU, SAWAH BESAR, JAKARTA PUSAT, DKI JAKARTA",1,119,71,190
https://kawalpemilu.org#25842,"PASAR BARU, SAWAH BESAR, JAKARTA PUSAT, DKI JAKARTA",2,103,52,155
https://kawalpemilu.org#25842,"PASAR BARU, SAWAH BESAR, JAKARTA PUSAT, DKI JAKARTA",3,119,48,167
https://kawalpemilu.org#25842,"PASAR BARU, SAWAH BESAR, JAKARTA PUSAT, DKI JAKARTA",4,127,30,157
https://kawalpemilu.org#25842,"PASAR BARU, SAWAH BESAR, JAKARTA PUSAT, DKI JAKARTA",5,140,46,186
https://kawalpemilu.org#25842,"PASAR BARU, SAWAH BESAR, JAKARTA PUSAT, DKI JAKARTA",6,186,44,230
https://kawalpemilu.org#25842,"PASAR BARU, SAWAH BESAR, JAKARTA PUSAT, DKI JAKARTA",7,112,99,211
https://kawalpemilu.org#25842,"PASAR BARU, SAWAH BESAR, JAKARTA PUSAT, DKI JAKARTA",8,197,34,231
https://kawalpemilu.org#25842,"PASAR BARU, SAWAH BESAR, JAKARTA PUSAT, DKI JAKARTA",9,109,59,168
https://kawalpemilu.org#25842,"PASAR BARU, SAWAH BESAR, JAKARTA PUSAT, DKI JAKARTA",10,142,74,216
https://kawalpemilu.org#25842,"PASAR BARU, SAWAH BESAR, JAKARTA PUSAT, DKI JAKARTA",11,146,77,223
https://kawalpemilu.org#25842,"PASAR BARU, SAWAH BESAR, JAKARTA PUSAT, DKI JAKARTA",12,108,111,219
https://kawalpemilu.org#25842,"PASAR BARU, SAWAH BESAR, JAKARTA PUSAT, DKI JAKARTA",13,103,90,193
https://kawalpemilu.org#25842,"PASAR BARU, SAWAH BESAR, JAKARTA PUSAT, DKI JAKARTA",14,166,18,184
https://kawalpemilu.org#25842,"PASAR BARU, SAWAH BESAR, JAKARTA PUSAT, DKI JAKARTA",15,152,14,166
https://kawalpemilu.org#25842,"PASAR BARU, SAWAH BESAR, JAKARTA PUSAT, DKI JAKARTA",16,141,43,184
https://kawalpemilu.org#25842,"PASAR BARU, SAWAH BESAR, JAKARTA PUSAT, DKI JAKARTA",17,87,113,200
https://kawalpemilu.org#25842,"PASAR BARU, SAWAH BESAR, JAKARTA PUSAT, DKI JAKARTA",18,200,24,224
https://kawalpemilu.org#25842,"PASAR BARU, SAWAH BESAR, JAKARTA PUSAT, DKI JAKARTA",19,158,82,240
https://kawalpemilu.org#25842,"PASAR BARU, SAWAH BESAR, JAKARTA PUSAT, DKI JAKARTA",20,174,19,193
https://kawalpemilu.org#25842,"PASAR BARU, SAWAH BESAR, JAKARTA PUSAT, DKI JAKARTA",21,220,11,231
https://kawalpemilu.org#25842,"PASAR BARU, SAWAH BESAR, JAKARTA PUSAT, DKI JAKARTA",22,95,132,227
https://kawalpemilu.org#25842,"PASAR BARU, SAWAH BESAR, JAKARTA PUSAT, DKI JAKARTA",23,230,3,233
https://kawalpemilu.org#25842,"PASAR BARU, SAWAH BESAR, JAKARTA PUSAT, DKI JAKARTA",24,115,106,221
https://kawalpemilu.org#25842,"PASAR BARU, SAWAH BESAR, JAKARTA PUSAT, DKI JAKARTA",25,204,11,215
https://kawalpemilu.org#25842,"PASAR BARU, SAWAH BESAR, JAKARTA PUSAT, DKI JAKARTA",26,182,21,203
https://kawalpemilu.org#25842,"PASAR BARU, SAWAH BESAR, JAKARTA PUSAT, DKI JAKARTA",27,210,20,230
https://kawalpemilu.org#25842,"PASAR BARU, SAWAH BESAR, JAKARTA PUSAT, DKI JAKARTA",28,167,62,229
https://kawalpemilu.org#25842,"PASAR BARU, SAWAH BESAR, JAKARTA PUSAT, DKI JAKARTA",29,113,117,230
https://kawalpemilu.org#25842,"PASAR BARU, SAWAH BESAR, JAKARTA PUSAT, DKI JAKARTA",30,212,15,227
https://kawalpemilu.org#25842,"PASAR BARU, SAWAH BESAR, JAKARTA PUSAT, DKI JAKARTA",31,185,34,219
https://kawalpemilu.org#25842,"PASAR BARU, SAWAH BESAR, JAKARTA PUSAT, DKI JAKARTA",32,170,40,210
https://kawalpemilu.org#25842,"PASAR BARU, SAWAH BESAR, JAKARTA PUSAT, DKI JAKARTA",33,159,59,218
https://kawalpemilu.org#25842,"PASAR BARU, SAWAH BESAR, JAKARTA PUSAT, DKI JAKARTA",34,150,40,190
https://kawalpemilu.org#25842,"PASAR BARU, SAWAH BESAR, JAKARTA PUSAT, DKI JAKARTA",35,190,38,228
https://kawalpemilu.org#25842,"PASAR BARU, SAWAH BESAR, JAKARTA PUSAT, DKI JAKARTA",36,179,20,199
https://kawalpemilu.org#25842,"PASAR BARU, SAWAH BESAR, JAKARTA PUSAT, DKI JAKARTA",37,148,64,212
https://kawalpemilu.org#25842,"PASAR BARU, SAWAH BESAR, JAKARTA PUSAT, DKI JAKARTA",38,180,46,226
https://kawalpemilu.org#25842,"PASAR BARU, SAWAH BESAR, JAKARTA PUSAT, DKI JAKARTA",39,135,40,175
https://kawalpemilu.org#25842,"PASAR BARU, SAWAH BESAR, JAKARTA PUSAT, DKI JAKARTA",40,170,10,180
https://kawalpemilu.org#25842,"PASAR BARU, SAWAH BESAR, JAKARTA PUSAT, DKI JAKARTA",41,160,13,173
https://kawalpemilu.org#25842,"PASAR BARU, SAWAH BESAR, JAKARTA PUSAT, DKI JAKARTA",42,190,5,195
https://kawalpemilu.org#25842,"PASAR BARU, SAWAH BESAR, JAKARTA PUSAT, DKI JAKARTA",43,137,73,210
https://kawalpemilu.org#25842,"PASAR BARU, SAWAH BESAR, JAKARTA PUSAT, DKI JAKARTA",44,141,43,184
https://kawalpemilu.org#25842,"PASAR BARU, SAWAH BESAR, JAKARTA PUSAT, DKI JAKARTA",45,111,73,184
https://kawalpemilu.org#25843,"KARANG ANYAR, SAWAH BESAR, JAKARTA PUSAT, DKI JAKARTA",1,105,126,231
https://kawalpemilu.org#25843,"KARANG ANYAR, SAWAH BESAR, JAKARTA PUSAT, DKI JAKARTA",2,92,92,184
https://kawalpemilu.org#25843,"KARANG ANYAR, SAWAH BESAR, JAKARTA PUSAT, DKI JAKARTA",3,111,87,198
https://kawalpemilu.org#25843,"KARANG ANYAR, SAWAH BESAR, JAKARTA PUSAT, DKI JAKARTA",4,141,91,232
https://kawalpemilu.org#25843,"KARANG ANYAR, SAWAH BESAR, JAKARTA PUSAT, DKI JAKARTA",5,120,80,200
https://kawalpemilu.org#25843,"KARANG ANYAR, SAWAH BESAR, JAKARTA PUSAT, DKI JAKARTA",6,111,76,187
https://kawalpemilu.org#25843,"KARANG ANYAR, SAWAH BESAR, JAKARTA PUSAT, DKI JAKARTA",7,109,109,218
https://kawalpemilu.org#25843,"KARANG ANYAR, SAWAH BESAR, JAKARTA PUSAT, DKI JAKARTA",8,111,102,213
https://kawalpemilu.org#25843,"KARANG ANYAR, SAWAH BESAR, JAKARTA PUSAT, DKI JAKARTA",9,204,32,236
https://kawalpemilu.org#25843,"KARANG ANYAR, SAWAH BESAR, JAKARTA PUSAT, DKI JAKARTA",10,137,65,202
https://kawalpemilu.org#25843,"KARANG ANYAR, SAWAH BESAR, JAKARTA PUSAT, DKI JAKARTA",11,167,60,227
https://kawalpemilu.org#25843,"KARANG ANYAR, SAWAH BESAR, JAKARTA PUSAT, DKI JAKARTA",12,112,79,191
https://kawalpemilu.org#25843,"KARANG ANYAR, SAWAH BESAR, JAKARTA PUSAT, DKI JAKARTA",13,79,128,207
https://kawalpemilu.org#25843,"KARANG ANYAR, SAWAH BESAR, JAKARTA PUSAT, DKI JAKARTA",14,80,132,212
https://kawalpemilu.org#25843,"KARANG ANYAR, SAWAH BESAR, JAKARTA PUSAT, DKI JAKARTA",15,63,138,201
https://kawalpemilu.org#25843,"KARANG ANYAR, SAWAH BESAR, JAKARTA PUSAT, DKI JAKARTA",16,79,150,229
https://kawalpemilu.org#25843,"KARANG ANYAR, SAWAH BESAR, JAKARTA PUSAT, DKI JAKARTA",17,102,85,187
https://kawalpemilu.org#25843,"KARANG ANYAR, SAWAH BESAR, JAKARTA PUSAT, DKI JAKARTA",18,115,87,202
https://kawalpemilu.org#25843,"KARANG ANYAR, SAWAH BESAR, JAKARTA PUSAT, DKI JAKARTA",19,132,90,222
https://kawalpemilu.org#25843,"KARANG ANYAR, SAWAH BESAR, JAKARTA PUSAT, DKI JAKARTA",20,150,62,212
https://kawalpemilu.org#25843,"KARANG ANYAR, SAWAH BESAR, JAKARTA PUSAT, DKI JAKARTA",21,166,33,199
https://kawalpemilu.org#25843,"KARANG ANYAR, SAWAH BESAR, JAKARTA PUSAT, DKI JAKARTA",22,146,63,209
https://kawalpemilu.org#25843,"KARANG ANYAR, SAWAH BESAR, JAKARTA PUSAT, DKI JAKARTA",23,156,47,203
https://kawalpemilu.org#25843,"KARANG ANYAR, SAWAH BESAR, JAKARTA PUSAT, DKI JAKARTA",24,178,14,192
https://kawalpemilu.org#25843,"KARANG ANYAR, SAWAH BESAR, JAKARTA PUSAT, DKI JAKARTA",25,154,44,198
https://kawalpemilu.org#25843,"KARANG ANYAR, SAWAH BESAR, JAKARTA PUSAT, DKI JAKARTA",26,117,101,218
https://kawalpemilu.org#25843,"KARANG ANYAR, SAWAH BESAR, JAKARTA PUSAT, DKI JAKARTA",27,139,88,227
https://kawalpemilu.org#25843,"KARANG ANYAR, SAWAH BESAR, JAKARTA PUSAT, DKI JAKARTA",28,144,88,232
https://kawalpemilu.org#25843,"KARANG ANYAR, SAWAH BESAR, JAKARTA PUSAT, DKI JAKARTA",29,189,58,247
https://kawalpemilu.org#25843,"KARANG ANYAR, SAWAH BESAR, JAKARTA PUSAT, DKI JAKARTA",30,139,62,201
https://kawalpemilu.org#25843,"KARANG ANYAR, SAWAH BESAR, JAKARTA PUSAT, DKI JAKARTA",31,146,96,242
https://kawalpemilu.org#25843,"KARANG ANYAR, SAWAH BESAR, JAKARTA PUSAT, DKI JAKARTA",32,133,96,229
https://kawalpemilu.org#25843,"KARANG ANYAR, SAWAH BESAR, JAKARTA PUSAT, DKI JAKARTA",33,74,200,274
https://kawalpemilu.org#25843,"KARANG ANYAR, SAWAH BESAR, JAKARTA PUSAT, DKI JAKARTA",34,121,117,238
https://kawalpemilu.org#25843,"KARANG ANYAR, SAWAH BESAR, JAKARTA PUSAT, DKI JAKARTA",35,107,123,230
https://kawalpemilu.org#25843,"KARANG ANYAR, SAWAH BESAR, JAKARTA PUSAT, DKI JAKARTA",36,163,78,241
https://kawalpemilu.org#25843,"KARANG ANYAR, SAWAH BESAR, JAKARTA PUSAT, DKI JAKARTA",37,143,101,244
https://kawalpemilu.org#25843,"KARANG ANYAR, SAWAH BESAR, JAKARTA PUSAT, DKI JAKARTA",38,150,77,227
https://kawalpemilu.org#25843,"KARANG ANYAR, SAWAH BESAR, JAKARTA PUSAT, DKI JAKARTA",39,116,126,242
https://kawalpemilu.org#25843,"KARANG ANYAR, SAWAH BESAR, JAKARTA PUSAT, DKI JAKARTA",40,78,140,218
https://kawalpemilu.org#25843,"KARANG ANYAR, SAWAH BESAR, JAKARTA PUSAT, DKI JAKARTA",41,86,145,231
https://kawalpemilu.org#25843,"KARANG ANYAR, SAWAH BESAR, JAKARTA PUSAT, DKI JAKARTA",42,107,130,237
https://kawalpemilu.org#25843,"KARANG ANYAR, SAWAH BESAR, JAKARTA PUSAT, DKI JAKARTA",43,131,110,241
https://kawalpemilu.org#25843,"KARANG ANYAR, SAWAH BESAR, JAKARTA PUSAT, DKI JAKARTA",44,126,110,236
https://kawalpemilu.org#25843,"KARANG ANYAR, SAWAH BESAR, JAKARTA PUSAT, DKI JAKARTA",45,102,116,218
https://kawalpemilu.org#25843,"KARANG ANYAR, SAWAH BESAR, JAKARTA PUSAT, DKI JAKARTA",46,104,133,237
https://kawalpemilu.org#25843,"KARANG ANYAR, SAWAH BESAR, JAKARTA PUSAT, DKI JAKARTA",47,95,131,226
https://kawalpemilu.org#25843,"KARANG ANYAR, SAWAH BESAR, JAKARTA PUSAT, DKI JAKARTA",48,131,100,231
https://kawalpemilu.org#25843,"KARANG ANYAR, SAWAH BESAR, JAKARTA PUSAT, DKI JAKARTA",49,112,141,253
https://kawalpemilu.org#25843,"KARANG ANYAR, SAWAH BESAR, JAKARTA PUSAT, DKI JAKARTA",50,138,73,211
https://kawalpemilu.org#25843,"KARANG ANYAR, SAWAH BESAR, JAKARTA PUSAT, DKI JAKARTA",51,54,156,210
https://kawalpemilu.org#25843,"KARANG ANYAR, SAWAH BESAR, JAKARTA PUSAT, DKI JAKARTA",52,118,99,217
https://kawalpemilu.org#25843,"KARANG ANYAR, SAWAH BESAR, JAKARTA PUSAT, DKI JAKARTA",53,80,165,245
https://kawalpemilu.org#25843,"KARANG ANYAR, SAWAH BESAR, JAKARTA PUSAT, DKI JAKARTA",54,98,116,214
https://kawalpemilu.org#25843,"KARANG ANYAR, SAWAH BESAR, JAKARTA PUSAT, DKI JAKARTA",55,126,98,224
https://kawalpemilu.org#25843,"KARANG ANYAR, SAWAH BESAR, JAKARTA PUSAT, DKI JAKARTA",56,112,104,216
https://kawalpemilu.org#25843,"KARANG ANYAR, SAWAH BESAR, JAKARTA PUSAT, DKI JAKARTA",57,162,84,246
https://kawalpemilu.org#25843,"KARANG ANYAR, SAWAH BESAR, JAKARTA PUSAT, DKI JAKARTA",58,121,105,226
https://kawalpemilu.org#25843,"KARANG ANYAR, SAWAH BESAR, JAKARTA PUSAT, DKI JAKARTA",59,85,150,235
https://kawalpemilu.org#25843,"KARANG ANYAR, SAWAH BESAR, JAKARTA PUSAT, DKI JAKARTA",60,101,149,250
https://kawalpemilu.org#25843,"KARANG ANYAR, SAWAH BESAR, JAKARTA PUSAT, DKI JAKARTA",61,176,53,229
https://kawalpemilu.org#25843,"KARANG ANYAR, SAWAH BESAR, JAKARTA PUSAT, DKI JAKARTA",62,112,114,226
https://kawalpemilu.org#25843,"KARANG ANYAR, SAWAH BESAR, JAKARTA PUSAT, DKI JAKARTA",63,117,100,217
https://kawalpemilu.org#25843,"KARANG ANYAR, SAWAH BESAR, JAKARTA PUSAT, DKI JAKARTA",64,167,44,211
https://kawalpemilu.org#25843,"KARANG ANYAR, SAWAH BESAR, JAKARTA PUSAT, DKI JAKARTA",65,135,51,186
https://kawalpemilu.org#25843,"KARANG ANYAR, SAWAH BESAR, JAKARTA PUSAT, DKI JAKARTA",66,132,61,193
https://kawalpemilu.org#25843,"KARANG ANYAR, SAWAH BESAR, JAKARTA PUSAT, DKI JAKARTA",67,155,31,186
https://kawalpemilu.org#25843,"KARANG ANYAR, SAWAH BESAR, JAKARTA PUSAT, DKI JAKARTA",68,166,32,198
https://kawalpemilu.org#25843,"KARANG ANYAR, SAWAH BESAR, JAKARTA PUSAT, DKI JAKARTA",69,142,54,196
https://kawalpemilu.org#25843,"KARANG ANYAR, SAWAH BESAR, JAKARTA PUSAT, DKI JAKARTA",70,145,44,189
https://kawalpemilu.org#25843,"KARANG ANYAR, SAWAH BESAR, JAKARTA PUSAT, DKI JAKARTA",71,0,0,0
https://kawalpemilu.org#25843,"KARANG ANYAR, SAWAH BESAR, JAKARTA PUSAT, DKI JAKARTA",72,160,34,194
https://kawalpemilu.org#25843,"KARANG ANYAR, SAWAH BESAR, JAKARTA PUSAT, DKI JAKARTA",73,147,82,229
https://kawalpemilu.org#25843,"KARANG ANYAR, SAWAH BESAR, JAKARTA PUSAT, DKI JAKARTA",74,137,88,225
https://kawalpemilu.org#25843,"KARANG ANYAR, SAWAH BESAR, JAKARTA PUSAT, DKI JAKARTA",75,187,46,233
https://kawalpemilu.org#25843,"KARANG ANYAR, SAWAH BESAR, JAKARTA PUSAT, DKI JAKARTA",76,166,68,234
https://kawalpemilu.org#25843,"KARANG ANYAR, SAWAH BESAR, JAKARTA PUSAT, DKI JAKARTA",77,136,85,221
https://kawalpemilu.org#25843,"KARANG ANYAR, SAWAH BESAR, JAKARTA PUSAT, DKI JAKARTA",78,118,112,230
https://kawalpemilu.org#25843,"KARANG ANYAR, SAWAH BESAR, JAKARTA PUSAT, DKI JAKARTA",79,196,4,200
https://kawalpemilu.org#25843,"KARANG ANYAR, SAWAH BESAR, JAKARTA PUSAT, DKI JAKARTA",80,98,100,198
https://kawalpemilu.org#25843,"KARANG ANYAR, SAWAH BESAR, JAKARTA PUSAT, DKI JAKARTA",81,81,126,207
https://kawalpemilu.org#25843,"KARANG ANYAR, SAWAH BESAR, JAKARTA PUSAT, DKI JAKARTA",82,129,73,202
https://kawalpemilu.org#25843,"KARANG ANYAR, SAWAH BESAR, JAKARTA PUSAT, DKI JAKARTA",83,103,119,222
https://kawalpemilu.org#25843,"KARANG ANYAR, SAWAH BESAR, JAKARTA PUSAT, DKI JAKARTA",84,102,114,216
https://kawalpemilu.org#25843,"KARANG ANYAR, SAWAH BESAR, JAKARTA PUSAT, DKI JAKARTA",85,150,21,171
https://kawalpemilu.org#25844,"KARTINI, SAWAH BESAR, JAKARTA PUSAT, DKI JAKARTA",1,192,15,207
https://kawalpemilu.org#25844,"KARTINI, SAWAH BESAR, JAKARTA PUSAT, DKI JAKARTA",2,142,41,183
https://kawalpemilu.org#25844,"KARTINI, SAWAH BESAR, JAKARTA PUSAT, DKI JAKARTA",3,237,2,239
https://kawalpemilu.org#25844,"KARTINI, SAWAH BESAR, JAKARTA PUSAT, DKI JAKARTA",4,167,18,185
https://kawalpemilu.org#25844,"KARTINI, SAWAH BESAR, JAKARTA PUSAT, DKI JAKARTA",5,204,9,213
https://kawalpemilu.org#25844,"KARTINI, SAWAH BESAR, JAKARTA PUSAT, DKI JAKARTA",6,198,48,246
https://kawalpemilu.org#25844,"KARTINI, SAWAH BESAR, JAKARTA PUSAT, DKI JAKARTA",7,196,31,227
https://kawalpemilu.org#25844,"KARTINI, SAWAH BESAR, JAKARTA PUSAT, DKI JAKARTA",8,193,56,249
https://kawalpemilu.org#25844,"KARTINI, SAWAH BESAR, JAKARTA PUSAT, DKI JAKARTA",9,151,52,203
https://kawalpemilu.org#25844,"KARTINI, SAWAH BESAR, JAKARTA PUSAT, DKI JAKARTA",10,161,68,229
https://kawalpemilu.org#25844,"KARTINI, SAWAH BESAR, JAKARTA PUSAT, DKI JAKARTA",11,160,59,219
https://kawalpemilu.org#25844,"KARTINI, SAWAH BESAR, JAKARTA PUSAT, DKI JAKARTA",12,207,24,231
https://kawalpemilu.org#25844,"KARTINI, SAWAH BESAR, JAKARTA PUSAT, DKI JAKARTA",13,108,127,235
https://kawalpemilu.org#25844,"KARTINI, SAWAH BESAR, JAKARTA PUSAT, DKI JAKARTA",14,131,92,223
https://kawalpemilu.org#25844,"KARTINI, SAWAH BESAR, JAKARTA PUSAT, DKI JAKARTA",15,180,28,208
https://kawalpemilu.org#25844,"KARTINI, SAWAH BESAR, JAKARTA PUSAT, DKI JAKARTA",16,186,25,211
https://kawalpemilu.org#25844,"KARTINI, SAWAH BESAR, JAKARTA PUSAT, DKI JAKARTA",17,194,44,238
https://kawalpemilu.org#25844,"KARTINI, SAWAH BESAR, JAKARTA PUSAT, DKI JAKARTA",18,111,8,119
https://kawalpemilu.org#25844,"KARTINI, SAWAH BESAR, JAKARTA PUSAT, DKI JAKARTA",19,160,63,223
https://kawalpemilu.org#25844,"KARTINI, SAWAH BESAR, JAKARTA PUSAT, DKI JAKARTA",20,154,67,221
https://kawalpemilu.org#25844,"KARTINI, SAWAH BESAR, JAKARTA PUSAT, DKI JAKARTA",21,135,71,206
https://kawalpemilu.org#25844,"KARTINI, SAWAH BESAR, JAKARTA PUSAT, DKI JAKARTA",22,124,93,217
https://kawalpemilu.org#25844,"KARTINI, SAWAH BESAR, JAKARTA PUSAT, DKI JAKARTA",23,144,90,234
https://kawalpemilu.org#25844,"KARTINI, SAWAH BESAR, JAKARTA PUSAT, DKI JAKARTA",24,176,49,225
https://kawalpemilu.org#25844,"KARTINI, SAWAH BESAR, JAKARTA PUSAT, DKI JAKARTA",25,172,47,219
https://kawalpemilu.org#25844,"KARTINI, SAWAH BESAR, JAKARTA PUSAT, DKI JAKARTA",26,114,76,190
https://kawalpemilu.org#25844,"KARTINI, SAWAH BESAR, JAKARTA PUSAT, DKI JAKARTA",27,209,9,218
https://kawalpemilu.org#25844,"KARTINI, SAWAH BESAR, JAKARTA PUSAT, DKI JAKARTA",28,206,18,224
https://kawalpemilu.org#25844,"KARTINI, SAWAH BESAR, JAKARTA PUSAT, DKI JAKARTA",29,142,15,157
https://kawalpemilu.org#25844,"KARTINI, SAWAH BESAR, JAKARTA PUSAT, DKI JAKARTA",30,187,35,222
https://kawalpemilu.org#25844,"KARTINI, SAWAH BESAR, JAKARTA PUSAT, DKI JAKARTA",31,214,6,220
https://kawalpemilu.org#25844,"KARTINI, SAWAH BESAR, JAKARTA PUSAT, DKI JAKARTA",32,157,35,192
https://kawalpemilu.org#25844,"KARTINI, SAWAH BESAR, JAKARTA PUSAT, DKI JAKARTA",33,178,17,195
https://kawalpemilu.org#25844,"KARTINI, SAWAH BESAR, JAKARTA PUSAT, DKI JAKARTA",34,194,6,200
https://kawalpemilu.org#25844,"KARTINI, SAWAH BESAR, JAKARTA PUSAT, DKI JAKARTA",35,166,61,227
https://kawalpemilu.org#25844,"KARTINI, SAWAH BESAR, JAKARTA PUSAT, DKI JAKARTA",36,149,49,198
https://kawalpemilu.org#25844,"KARTINI, SAWAH BESAR, JAKARTA PUSAT, DKI JAKARTA",37,191,15,206
https://kawalpemilu.org#25844,"KARTINI, SAWAH BESAR, JAKARTA PUSAT, DKI JAKARTA",38,159,51,210
https://kawalpemilu.org#25844,"KARTINI, SAWAH BESAR, JAKARTA PUSAT, DKI JAKARTA",39,129,79,208
https://kawalpemilu.org#25844,"KARTINI, SAWAH BESAR, JAKARTA PUSAT, DKI JAKARTA",40,109,105,214
https://kawalpemilu.org#25844,"KARTINI, SAWAH BESAR, JAKARTA PUSAT, DKI JAKARTA",41,135,99,234
https://kawalpemilu.org#25844,"KARTINI, SAWAH BESAR, JAKARTA PUSAT, DKI JAKARTA",42,169,69,238
https://kawalpemilu.org#25844,"KARTINI, SAWAH BESAR, JAKARTA PUSAT, DKI JAKARTA",43,134,103,237
https://kawalpemilu.org#25844,"KARTINI, SAWAH BESAR, JAKARTA PUSAT, DKI JAKARTA",44,162,63,225
https://kawalpemilu.org#25844,"KARTINI, SAWAH BESAR, JAKARTA PUSAT, DKI JAKARTA",45,93,68,161
https://kawalpemilu.org#25844,"KARTINI, SAWAH BESAR, JAKARTA PUSAT, DKI JAKARTA",46,56,145,201
https://kawalpemilu.org#25844,"KARTINI, SAWAH BESAR, JAKARTA PUSAT, DKI JAKARTA",47,145,80,225
https://kawalpemilu.org#25844,"KARTINI, SAWAH BESAR, JAKARTA PUSAT, DKI JAKARTA",48,175,41,216
https://kawalpemilu.org#25844,"KARTINI, SAWAH BESAR, JAKARTA PUSAT, DKI JAKARTA",49,110,131,241
https://kawalpemilu.org#25844,"KARTINI, SAWAH BESAR, JAKARTA PUSAT, DKI JAKARTA",50,71,130,201
https://kawalpemilu.org#25844,"KARTINI, SAWAH BESAR, JAKARTA PUSAT, DKI JAKARTA",51,109,117,226
https://kawalpemilu.org#25844,"KARTINI, SAWAH BESAR, JAKARTA PUSAT, DKI JAKARTA",52,157,43,200
https://kawalpemilu.org#25844,"KARTINI, SAWAH BESAR, JAKARTA PUSAT, DKI JAKARTA",53,193,21,214
https://kawalpemilu.org#25844,"KARTINI, SAWAH BESAR, JAKARTA PUSAT, DKI JAKARTA",54,128,72,200
https://kawalpemilu.org#25844,"KARTINI, SAWAH BESAR, JAKARTA PUSAT, DKI JAKARTA",55,135,72,207
https://kawalpemilu.org#25844,"KARTINI, SAWAH BESAR, JAKARTA PUSAT, DKI JAKARTA",56,115,101,216
https://kawalpemilu.org#25844,"KARTINI, SAWAH BESAR, JAKARTA PUSAT, DKI JAKARTA",57,88,139,227
https://kawalpemilu.org#25844,"KARTINI, SAWAH BESAR, JAKARTA PUSAT, DKI JAKARTA",58,133,106,239
https://kawalpemilu.org#25844,"KARTINI, SAWAH BESAR, JAKARTA PUSAT, DKI JAKARTA",59,191,28,219
https://kawalpemilu.org#25844,"KARTINI, SAWAH BESAR, JAKARTA PUSAT, DKI JAKARTA",60,133,91,224
https://kawalpemilu.org#25844,"KARTINI, SAWAH BESAR, JAKARTA PUSAT, DKI JAKARTA",61,107,123,230
https://kawalpemilu.org#25844,"KARTINI, SAWAH BESAR, JAKARTA PUSAT, DKI JAKARTA",62,112,120,232
https://kawalpemilu.org#25844,"KARTINI, SAWAH BESAR, JAKARTA PUSAT, DKI JAKARTA",63,94,145,239
https://kawalpemilu.org#25844,"KARTINI, SAWAH BESAR, JAKARTA PUSAT, DKI JAKARTA",64,91,115,206
https://kawalpemilu.org#25844,"KARTINI, SAWAH BESAR, JAKARTA PUSAT, DKI JAKARTA",65,169,69,238
https://kawalpemilu.org#25844,"KARTINI, SAWAH BESAR, JAKARTA PUSAT, DKI JAKARTA",66,107,99,206
https://kawalpemilu.org#25844,"KARTINI, SAWAH BESAR, JAKARTA PUSAT, DKI JAKARTA",67,183,29,212
https://kawalpemilu.org#25844,"KARTINI, SAWAH BESAR, JAKARTA PUSAT, DKI JAKARTA",68,164,29,193
https://kawalpemilu.org#25844,"KARTINI, SAWAH BESAR, JAKARTA PUSAT, DKI JAKARTA",69,114,102,216
https://kawalpemilu.org#25844,"KARTINI, SAWAH BESAR, JAKARTA PUSAT, DKI JAKARTA",70,165,70,235
https://kawalpemilu.org#25844,"KARTINI, SAWAH BESAR, JAKARTA PUSAT, DKI JAKARTA",71,115,100,215
https://kawalpemilu.org#25844,"KARTINI, SAWAH BESAR, JAKARTA PUSAT, DKI JAKARTA",72,134,94,228
https://kawalpemilu.org#25844,"KARTINI, SAWAH BESAR, JAKARTA PUSAT, DKI JAKARTA",73,125,87,212
https://kawalpemilu.org#25844,"KARTINI, SAWAH BESAR, JAKARTA PUSAT, DKI JAKARTA",74,167,39,206
https://kawalpemilu.org#25845,"GUNUNG SAHARI UTARA, SAWAH BESAR, JAKARTA PUSAT, DKI JAKARTA",1,112,93,205
https://kawalpemilu.org#25845,"GUNUNG SAHARI UTARA, SAWAH BESAR, JAKARTA PUSAT, DKI JAKARTA",2,196,33,229
https://kawalpemilu.org#25845,"GUNUNG SAHARI UTARA, SAWAH BESAR, JAKARTA PUSAT, DKI JAKARTA",3,212,15,227
https://kawalpemilu.org#25845,"GUNUNG SAHARI UTARA, SAWAH BESAR, JAKARTA PUSAT, DKI JAKARTA",4,205,41,246
https://kawalpemilu.org#25845,"GUNUNG SAHARI UTARA, SAWAH BESAR, JAKARTA PUSAT, DKI JAKARTA",5,201,43,244
https://kawalpemilu.org#25845,"GUNUNG SAHARI UTARA, SAWAH BESAR, JAKARTA PUSAT, DKI JAKARTA",6,201,18,219
https://kawalpemilu.org#25845,"GUNUNG SAHARI UTARA, SAWAH BESAR, JAKARTA PUSAT, DKI JAKARTA",7,126,70,196
https://kawalpemilu.org#25845,"GUNUNG SAHARI UTARA, SAWAH BESAR, JAKARTA PUSAT, DKI JAKARTA",8,186,37,223
https://kawalpemilu.org#25845,"GUNUNG SAHARI UTARA, SAWAH BESAR, JAKARTA PUSAT, DKI JAKARTA",9,173,65,238
https://kawalpemilu.org#25845,"GUNUNG SAHARI UTARA, SAWAH BESAR, JAKARTA PUSAT, DKI JAKARTA",10,130,101,231
https://kawalpemilu.org#25845,"GUNUNG SAHARI UTARA, SAWAH BESAR, JAKARTA PUSAT, DKI JAKARTA",11,156,61,217
https://kawalpemilu.org#25845,"GUNUNG SAHARI UTARA, SAWAH BESAR, JAKARTA PUSAT, DKI JAKARTA",12,142,85,227
https://kawalpemilu.org#25845,"GUNUNG SAHARI UTARA, SAWAH BESAR, JAKARTA PUSAT, DKI JAKARTA",13,131,112,243
https://kawalpemilu.org#25845,"GUNUNG SAHARI UTARA, SAWAH BESAR, JAKARTA PUSAT, DKI JAKARTA",14,153,79,232
https://kawalpemilu.org#25845,"GUNUNG SAHARI UTARA, SAWAH BESAR, JAKARTA PUSAT, DKI JAKARTA",15,180,48,228
https://kawalpemilu.org#25845,"GUNUNG SAHARI UTARA, SAWAH BESAR, JAKARTA PUSAT, DKI JAKARTA",16,202,26,228
https://kawalpemilu.org#25845,"GUNUNG SAHARI UTARA, SAWAH BESAR, JAKARTA PUSAT, DKI JAKARTA",17,143,75,218
https://kawalpemilu.org#25845,"GUNUNG SAHARI UTARA, SAWAH BESAR, JAKARTA PUSAT, DKI JAKARTA",18,115,121,236
https://kawalpemilu.org#25845,"GUNUNG SAHARI UTARA, SAWAH BESAR, JAKARTA PUSAT, DKI JAKARTA",19,192,21,213
https://kawalpemilu.org#25845,"GUNUNG SAHARI UTARA, SAWAH BESAR, JAKARTA PUSAT, DKI JAKARTA",20,170,43,213
https://kawalpemilu.org#25845,"GUNUNG SAHARI UTARA, SAWAH BESAR, JAKARTA PUSAT, DKI JAKARTA",21,217,15,232
https://kawalpemilu.org#25845,"GUNUNG SAHARI UTARA, SAWAH BESAR, JAKARTA PUSAT, DKI JAKARTA",22,133,87,220
https://kawalpemilu.org#25845,"GUNUNG SAHARI UTARA, SAWAH BESAR, JAKARTA PUSAT, DKI JAKARTA",23,140,73,213
https://kawalpemilu.org#25845,"GUNUNG SAHARI UTARA, SAWAH BESAR, JAKARTA PUSAT, DKI JAKARTA",24,150,83,233
https://kawalpemilu.org#25845,"GUNUNG SAHARI UTARA, SAWAH BESAR, JAKARTA PUSAT, DKI JAKARTA",25,161,37,198
https://kawalpemilu.org#25845,"GUNUNG SAHARI UTARA, SAWAH BESAR, JAKARTA PUSAT, DKI JAKARTA",26,174,26,200
https://kawalpemilu.org#25845,"GUNUNG SAHARI UTARA, SAWAH BESAR, JAKARTA PUSAT, DKI JAKARTA",27,185,42,227
https://kawalpemilu.org#25845,"GUNUNG SAHARI UTARA, SAWAH BESAR, JAKARTA PUSAT, DKI JAKARTA",28,114,85,199
https://kawalpemilu.org#25845,"GUNUNG SAHARI UTARA, SAWAH BESAR, JAKARTA PUSAT, DKI JAKARTA",29,139,39,178
https://kawalpemilu.org#25845,"GUNUNG SAHARI UTARA, SAWAH BESAR, JAKARTA PUSAT, DKI JAKARTA",30,220,14,234
https://kawalpemilu.org#25845,"GUNUNG SAHARI UTARA, SAWAH BESAR, JAKARTA PUSAT, DKI JAKARTA",31,138,96,234
https://kawalpemilu.org#25845,"GUNUNG SAHARI UTARA, SAWAH BESAR, JAKARTA PUSAT, DKI JAKARTA",32,171,74,245
https://kawalpemilu.org#25845,"GUNUNG SAHARI UTARA, SAWAH BESAR, JAKARTA PUSAT, DKI JAKARTA",33,203,20,223
https://kawalpemilu.org#25845,"GUNUNG SAHARI UTARA, SAWAH BESAR, JAKARTA PUSAT, DKI JAKARTA",34,165,75,240
https://kawalpemilu.org#25845,"GUNUNG SAHARI UTARA, SAWAH BESAR, JAKARTA PUSAT, DKI JAKARTA",35,147,88,235
https://kawalpemilu.org#25845,"GUNUNG SAHARI UTARA, SAWAH BESAR, JAKARTA PUSAT, DKI JAKARTA",36,196,35,231
https://kawalpemilu.org#25845,"GUNUNG SAHARI UTARA, SAWAH BESAR, JAKARTA PUSAT, DKI JAKARTA",37,156,64,221
https://kawalpemilu.org#25845,"GUNUNG SAHARI UTARA, SAWAH BESAR, JAKARTA PUSAT, DKI JAKARTA",38,145,67,212
https://kawalpemilu.org#25845,"GUNUNG SAHARI UTARA, SAWAH BESAR, JAKARTA PUSAT, DKI JAKARTA",39,173,40,213
https://kawalpemilu.org#25845,"GUNUNG SAHARI UTARA, SAWAH BESAR, JAKARTA PUSAT, DKI JAKARTA",40,146,81,227
https://kawalpemilu.org#25845,"GUNUNG SAHARI UTARA, SAWAH BESAR, JAKARTA PUSAT, DKI JAKARTA",41,155,62,217
https://kawalpemilu.org#25845,"GUNUNG SAHARI UTARA, SAWAH BESAR, JAKARTA PUSAT, DKI JAKARTA",42,157,39,196
https://kawalpemilu.org#25845,"GUNUNG SAHARI UTARA, SAWAH BESAR, JAKARTA PUSAT, DKI JAKARTA",43,179,56,235
https://kawalpemilu.org#25845,"GUNUNG SAHARI UTARA, SAWAH BESAR, JAKARTA PUSAT, DKI JAKARTA",44,195,11,206
https://kawalpemilu.org#25845,"GUNUNG SAHARI UTARA, SAWAH BESAR, JAKARTA PUSAT, DKI JAKARTA",45,178,59,237
https://kawalpemilu.org#25845,"GUNUNG SAHARI UTARA, SAWAH BESAR, JAKARTA PUSAT, DKI JAKARTA",46,218,29,247
https://kawalpemilu.org#25845,"GUNUNG SAHARI UTARA, SAWAH BESAR, JAKARTA PUSAT, DKI JAKARTA",47,93,135,228
https://kawalpemilu.org#25845,"GUNUNG SAHARI UTARA, SAWAH BESAR, JAKARTA PUSAT, DKI JAKARTA",48,194,13,207
https://kawalpemilu.org#25845,"GUNUNG SAHARI UTARA, SAWAH BESAR, JAKARTA PUSAT, DKI JAKARTA",49,172,17,189
https://kawalpemilu.org#25845,"GUNUNG SAHARI UTARA, SAWAH BESAR, JAKARTA PUSAT, DKI JAKARTA",50,145,47,192
https://kawalpemilu.org#25845,"GUNUNG SAHARI UTARA, SAWAH BESAR, JAKARTA PUSAT, DKI JAKARTA",51,173,42,215
https://kawalpemilu.org#25845,"GUNUNG SAHARI UTARA, SAWAH BESAR, JAKARTA PUSAT, DKI JAKARTA",52,167,18,185
https://kawalpemilu.org#25845,"GUNUNG SAHARI UTARA, SAWAH BESAR, JAKARTA PUSAT, DKI JAKARTA",53,149,95,244
https://kawalpemilu.org#25845,"GUNUNG SAHARI UTARA, SAWAH BESAR, JAKARTA PUSAT, DKI JAKARTA",54,116,114,230
https://kawalpemilu.org#25845,"GUNUNG SAHARI UTARA, SAWAH BESAR, JAKARTA PUSAT, DKI JAKARTA",55,137,67,204
https://kawalpemilu.org#25845,"GUNUNG SAHARI UTARA, SAWAH BESAR, JAKARTA PUSAT, DKI JAKARTA",56,85,86,171
https://kawalpemilu.org#25845,"GUNUNG SAHARI UTARA, SAWAH BESAR, JAKARTA PUSAT, DKI JAKARTA",57,94,89,183
https://kawalpemilu.org#25846,"MANGGA DUA SELATAN, SAWAH BESAR, JAKARTA PUSAT, DKI JAKARTA",1,156,30,186
https://kawalpemilu.org#25846,"MANGGA DUA SELATAN, SAWAH BESAR, JAKARTA PUSAT, DKI JAKARTA",2,196,37,233
https://kawalpemilu.org#25846,"MANGGA DUA SELATAN, SAWAH BESAR, JAKARTA PUSAT, DKI JAKARTA",3,107,119,226
https://kawalpemilu.org#25846,"MANGGA DUA SELATAN, SAWAH BESAR, JAKARTA PUSAT, DKI JAKARTA",4,97,84,181
https://kawalpemilu.org#25846,"MANGGA DUA SELATAN, SAWAH BESAR, JAKARTA PUSAT, DKI JAKARTA",5,169,65,234
https://kawalpemilu.org#25846,"MANGGA DUA SELATAN, SAWAH BESAR, JAKARTA PUSAT, DKI JAKARTA",6,137,79,216
https://kawalpemilu.org#25846,"MANGGA DUA SELATAN, SAWAH BESAR, JAKARTA PUSAT, DKI JAKARTA",7,118,87,205
https://kawalpemilu.org#25846,"MANGGA DUA SELATAN, SAWAH BESAR, JAKARTA PUSAT, DKI JAKARTA",8,118,91,209
https://kawalpemilu.org#25846,"MANGGA DUA SELATAN, SAWAH BESAR, JAKARTA PUSAT, DKI JAKARTA",9,130,90,220
https://kawalpemilu.org#25846,"MANGGA DUA SELATAN, SAWAH BESAR, JAKARTA PUSAT, DKI JAKARTA",10,113,93,206
https://kawalpemilu.org#25846,"MANGGA DUA SELATAN, SAWAH BESAR, JAKARTA PUSAT, DKI JAKARTA",11,104,91,195
https://kawalpemilu.org#25846,"MANGGA DUA SELATAN, SAWAH BESAR, JAKARTA PUSAT, DKI JAKARTA",12,154,62,216
https://kawalpemilu.org#25846,"MANGGA DUA SELATAN, SAWAH BESAR, JAKARTA PUSAT, DKI JAKARTA",13,130,19,149
https://kawalpemilu.org#25846,"MANGGA DUA SELATAN, SAWAH BESAR, JAKARTA PUSAT, DKI JAKARTA",14,103,55,158
https://kawalpemilu.org#25846,"MANGGA DUA SELATAN, SAWAH BESAR, JAKARTA PUSAT, DKI JAKARTA",15,139,75,214
https://kawalpemilu.org#25846,"MANGGA DUA SELATAN, SAWAH BESAR, JAKARTA PUSAT, DKI JAKARTA",16,122,85,207
https://kawalpemilu.org#25846,"MANGGA DUA SELATAN, SAWAH BESAR, JAKARTA PUSAT, DKI JAKARTA",17,137,61,198
https://kawalpemilu.org#25846,"MANGGA DUA SELATAN, SAWAH BESAR, JAKARTA PUSAT, DKI JAKARTA",18,129,62,191
https://kawalpemilu.org#25846,"MANGGA DUA SELATAN, SAWAH BESAR, JAKARTA PUSAT, DKI JAKARTA",19,160,35,195
https://kawalpemilu.org#25846,"MANGGA DUA SELATAN, SAWAH BESAR, JAKARTA PUSAT, DKI JAKARTA",20,117,90,207
https://kawalpemilu.org#25846,"MANGGA DUA SELATAN, SAWAH BESAR, JAKARTA PUSAT, DKI JAKARTA",21,134,65,199
https://kawalpemilu.org#25846,"MANGGA DUA SELATAN, SAWAH BESAR, JAKARTA PUSAT, DKI JAKARTA",22,153,42,195
https://kawalpemilu.org#25846,"MANGGA DUA SELATAN, SAWAH BESAR, JAKARTA PUSAT, DKI JAKARTA",23,159,54,213
https://kawalpemilu.org#25846,"MANGGA DUA SELATAN, SAWAH BESAR, JAKARTA PUSAT, DKI JAKARTA",24,102,106,208
https://kawalpemilu.org#25846,"MANGGA DUA SELATAN, SAWAH BESAR, JAKARTA PUSAT, DKI JAKARTA",25,148,71,219
https://kawalpemilu.org#25846,"MANGGA DUA SELATAN, SAWAH BESAR, JAKARTA PUSAT, DKI JAKARTA",26,113,97,210
https://kawalpemilu.org#25846,"MANGGA DUA SELATAN, SAWAH BESAR, JAKARTA PUSAT, DKI JAKARTA",27,130,92,222
https://kawalpemilu.org#25846,"MANGGA DUA SELATAN, SAWAH BESAR, JAKARTA PUSAT, DKI JAKARTA",28,130,111,241
https://kawalpemilu.org#25846,"MANGGA DUA SELATAN, SAWAH BESAR, JAKARTA PUSAT, DKI JAKARTA",29,125,91,216
https://kawalpemilu.org#25846,"MANGGA DUA SELATAN, SAWAH BESAR, JAKARTA PUSAT, DKI JAKARTA",30,120,106,226
https://kawalpemilu.org#25846,"MANGGA DUA SELATAN, SAWAH BESAR, JAKARTA PUSAT, DKI JAKARTA",31,116,105,221
https://kawalpemilu.org#25846,"MANGGA DUA SELATAN, SAWAH BESAR, JAKARTA PUSAT, DKI JAKARTA",32,89,127,216
https://kawalpemilu.org#25846,"MANGGA DUA SELATAN, SAWAH BESAR, JAKARTA PUSAT, DKI JAKARTA",33,74,157,231
https://kawalpemilu.org#25846,"MANGGA DUA SELATAN, SAWAH BESAR, JAKARTA PUSAT, DKI JAKARTA",34,54,168,222
https://kawalpemilu.org#25846,"MANGGA DUA SELATAN, SAWAH BESAR, JAKARTA PUSAT, DKI JAKARTA",35,103,114,217
https://kawalpemilu.org#25846,"MANGGA DUA SELATAN, SAWAH BESAR, JAKARTA PUSAT, DKI JAKARTA",36,46,158,204
https://kawalpemilu.org#25846,"MANGGA DUA SELATAN, SAWAH BESAR, JAKARTA PUSAT, DKI JAKARTA",37,93,83,176
https://kawalpemilu.org#25846,"MANGGA DUA SELATAN, SAWAH BESAR, JAKARTA PUSAT, DKI JAKARTA",38,100,95,195
https://kawalpemilu.org#25846,"MANGGA DUA SELATAN, SAWAH BESAR, JAKARTA PUSAT, DKI JAKARTA",39,137,75,212
https://kawalpemilu.org#25846,"MANGGA DUA SELATAN, SAWAH BESAR, JAKARTA PUSAT, DKI JAKARTA",40,130,92,222
https://kawalpemilu.org#25846,"MANGGA DUA SELATAN, SAWAH BESAR, JAKARTA PUSAT, DKI JAKARTA",41,122,91,213
https://kawalpemilu.org#25846,"MANGGA DUA SELATAN, SAWAH BESAR, JAKARTA PUSAT, DKI JAKARTA",42,114,86,200
https://kawalpemilu.org#25846,"MANGGA DUA SELATAN, SAWAH BESAR, JAKARTA PUSAT, DKI JAKARTA",43,98,105,203
https://kawalpemilu.org#25846,"MANGGA DUA SELATAN, SAWAH BESAR, JAKARTA PUSAT, DKI JAKARTA",44,92,90,182
https://kawalpemilu.org#25846,"MANGGA DUA SELATAN, SAWAH BESAR, JAKARTA PUSAT, DKI JAKARTA",45,140,41,181
https://kawalpemilu.org#25846,"MANGGA DUA SELATAN, SAWAH BESAR, JAKARTA PUSAT, DKI JAKARTA",46,152,36,188
https://kawalpemilu.org#25846,"MANGGA DUA SELATAN, SAWAH BESAR, JAKARTA PUSAT, DKI JAKARTA",47,185,35,220
https://kawalpemilu.org#25846,"MANGGA DUA SELATAN, SAWAH BESAR, JAKARTA PUSAT, DKI JAKARTA",48,190,34,224
https://kawalpemilu.org#25846,"MANGGA DUA SELATAN, SAWAH BESAR, JAKARTA PUSAT, DKI JAKARTA",49,124,98,222
https://kawalpemilu.org#25846,"MANGGA DUA SELATAN, SAWAH BESAR, JAKARTA PUSAT, DKI JAKARTA",50,131,55,186
https://kawalpemilu.org#25846,"MANGGA DUA SELATAN, SAWAH BESAR, JAKARTA PUSAT, DKI JAKARTA",51,104,63,167
https://kawalpemilu.org#25846,"MANGGA DUA SELATAN, SAWAH BESAR, JAKARTA PUSAT, DKI JAKARTA",52,144,46,190
https://kawalpemilu.org#25846,"MANGGA DUA SELATAN, SAWAH BESAR, JAKARTA PUSAT, DKI JAKARTA",53,101,55,156
https://kawalpemilu.org#25846,"MANGGA DUA SELATAN, SAWAH BESAR, JAKARTA PUSAT, DKI JAKARTA",54,167,36,203
https://kawalpemilu.org#25846,"MANGGA DUA SELATAN, SAWAH BESAR, JAKARTA PUSAT, DKI JAKARTA",55,207,21,228
https://kawalpemilu.org#25846,"MANGGA DUA SELATAN, SAWAH BESAR, JAKARTA PUSAT, DKI JAKARTA",56,174,66,240
https://kawalpemilu.org#25846,"MANGGA DUA SELATAN, SAWAH BESAR, JAKARTA PUSAT, DKI JAKARTA",57,221,13,234
https://kawalpemilu.org#25846,"MANGGA DUA SELATAN, SAWAH BESAR, JAKARTA PUSAT, DKI JAKARTA",58,184,14,198
https://kawalpemilu.org#25846,"MANGGA DUA SELATAN, SAWAH BESAR, JAKARTA PUSAT, DKI JAKARTA",59,181,10,191
https://kawalpemilu.org#25846,"MANGGA DUA SELATAN, SAWAH BESAR, JAKARTA PUSAT, DKI JAKARTA",60,147,28,175
https://kawalpemilu.org#25846,"MANGGA DUA SELATAN, SAWAH BESAR, JAKARTA PUSAT, DKI JAKARTA",61,133,60,193
https://kawalpemilu.org#25846,"MANGGA DUA SELATAN, SAWAH BESAR, JAKARTA PUSAT, DKI JAKARTA",62,203,14,217
https://kawalpemilu.org#25846,"MANGGA DUA SELATAN, SAWAH BESAR, JAKARTA PUSAT, DKI JAKARTA",63,193,38,231
https://kawalpemilu.org#25846,"MANGGA DUA SELATAN, SAWAH BESAR, JAKARTA PUSAT, DKI JAKARTA",64,207,18,225
https://kawalpemilu.org#25846,"MANGGA DUA SELATAN, SAWAH BESAR, JAKARTA PUSAT, DKI JAKARTA",65,183,45,228
https://kawalpemilu.org#25846,"MANGGA DUA SELATAN, SAWAH BESAR, JAKARTA PUSAT, DKI JAKARTA",66,155,64,219
https://kawalpemilu.org#25846,"MANGGA DUA SELATAN, SAWAH BESAR, JAKARTA PUSAT, DKI JAKARTA",67,134,99,233
https://kawalpemilu.org#25846,"MANGGA DUA SELATAN, SAWAH BESAR, JAKARTA PUSAT, DKI JAKARTA",68,141,104,245
https://kawalpemilu.org#25846,"MANGGA DUA SELATAN, SAWAH BESAR, JAKARTA PUSAT, DKI JAKARTA",69,145,54,199
https://kawalpemilu.org#25846,"MANGGA DUA SELATAN, SAWAH BESAR, JAKARTA PUSAT, DKI JAKARTA",70,168,54,222
https://kawalpemilu.org#25846,"MANGGA DUA SELATAN, SAWAH BESAR, JAKARTA PUSAT, DKI JAKARTA",71,128,111,239
https://kawalpemilu.org#25846,"MANGGA DUA SELATAN, SAWAH BESAR, JAKARTA PUSAT, DKI JAKARTA",72,138,101,239
https://kawalpemilu.org#25846,"MANGGA DUA SELATAN, SAWAH BESAR, JAKARTA PUSAT, DKI JAKARTA",73,137,96,233
https://kawalpemilu.org#25846,"MANGGA DUA SELATAN, SAWAH BESAR, JAKARTA PUSAT, DKI JAKARTA",74,165,77,242
https://kawalpemilu.org#25846,"MANGGA DUA SELATAN, SAWAH BESAR, JAKARTA PUSAT, DKI JAKARTA",75,159,77,236
https://kawalpemilu.org#25846,"MANGGA DUA SELATAN, SAWAH BESAR, JAKARTA PUSAT, DKI JAKARTA",76,91,70,161
https://kawalpemilu.org#25846,"MANGGA DUA SELATAN, SAWAH BESAR, JAKARTA PUSAT, DKI JAKARTA",77,99,99,198
https://kawalpemilu.org#25846,"MANGGA DUA SELATAN, SAWAH BESAR, JAKARTA PUSAT, DKI JAKARTA",78,109,99,198
https://kawalpemilu.org#25846,"MANGGA DUA SELATAN, SAWAH BESAR, JAKARTA PUSAT, DKI JAKARTA",79,126,116,242
https://kawalpemilu.org#25846,"MANGGA DUA SELATAN, SAWAH BESAR, JAKARTA PUSAT, DKI JAKARTA",80,161,63,224
https://kawalpemilu.org#25846,"MANGGA DUA SELATAN, SAWAH BESAR, JAKARTA PUSAT, DKI JAKARTA",81,141,38,179
https://kawalpemilu.org#25846,"MANGGA DUA SELATAN, SAWAH BESAR, JAKARTA PUSAT, DKI JAKARTA",82,163,24,187
https://kawalpemilu.org#25846,"MANGGA DUA SELATAN, SAWAH BESAR, JAKARTA PUSAT, DKI JAKARTA",83,165,7,172
https://kawalpemilu.org#25846,"MANGGA DUA SELATAN, SAWAH BESAR, JAKARTA PUSAT, DKI JAKARTA",84,153,4,157
https://kawalpemilu.org#25846,"MANGGA DUA SELATAN, SAWAH BESAR, JAKARTA PUSAT, DKI JAKARTA",85,133,50,183
https://kawalpemilu.org#25846,"MANGGA DUA SELATAN, SAWAH BESAR, JAKARTA PUSAT, DKI JAKARTA",86,167,46,213
https://kawalpemilu.org#25846,"MANGGA DUA SELATAN, SAWAH BESAR, JAKARTA PUSAT, DKI JAKARTA",87,159,40,199
https://kawalpemilu.org#25846,"MANGGA DUA SELATAN, SAWAH BESAR, JAKARTA PUSAT, DKI JAKARTA",88,134,47,181
https://kawalpemilu.org#25846,"MANGGA DUA SELATAN, SAWAH BESAR, JAKARTA PUSAT, DKI JAKARTA",89,135,45,180
https://kawalpemilu.org#25846,"MANGGA DUA SELATAN, SAWAH BESAR, JAKARTA PUSAT, DKI JAKARTA",90,151,24,175
https://kawalpemilu.org#25846,"MANGGA DUA SELATAN, SAWAH BESAR, JAKARTA PUSAT, DKI JAKARTA",91,108,67,175
https://kawalpemilu.org#25846,"MANGGA DUA SELATAN, SAWAH BESAR, JAKARTA PUSAT, DKI JAKARTA",92,136,30,166
https://kawalpemilu.org#25848,"KEMAYORAN, KEMAYORAN, JAKARTA PUSAT, DKI JAKARTA",1,155,63,218
https://kawalpemilu.org#25848,"KEMAYORAN, KEMAYORAN, JAKARTA PUSAT, DKI JAKARTA",2,153,29,182
https://kawalpemilu.org#25848,"KEMAYORAN, KEMAYORAN, JAKARTA PUSAT, DKI JAKARTA",4,163,36,199
https://kawalpemilu.org#25848,"KEMAYORAN, KEMAYORAN, JAKARTA PUSAT, DKI JAKARTA",5,150,60,210
https://kawalpemilu.org#25848,"KEMAYORAN, KEMAYORAN, JAKARTA PUSAT, DKI JAKARTA",6,147,51,198
https://kawalpemilu.org#25848,"KEMAYORAN, KEMAYORAN, JAKARTA PUSAT, DKI JAKARTA",9,95,91,186
https://kawalpemilu.org#25848,"KEMAYORAN, KEMAYORAN, JAKARTA PUSAT, DKI JAKARTA",10,116,77,193
https://kawalpemilu.org#25848,"KEMAYORAN, KEMAYORAN, JAKARTA PUSAT, DKI JAKARTA",11,123,72,195
https://kawalpemilu.org#25848,"KEMAYORAN, KEMAYORAN, JAKARTA PUSAT, DKI JAKARTA",12,109,86,195
https://kawalpemilu.org#25848,"KEMAYORAN, KEMAYORAN, JAKARTA PUSAT, DKI JAKARTA",13,155,52,207
https://kawalpemilu.org#25848,"KEMAYORAN, KEMAYORAN, JAKARTA PUSAT, DKI JAKARTA",14,152,59,211
https://kawalpemilu.org#25848,"KEMAYORAN, KEMAYORAN, JAKARTA PUSAT, DKI JAKARTA",15,112,132,244
https://kawalpemilu.org#25848,"KEMAYORAN, KEMAYORAN, JAKARTA PUSAT, DKI JAKARTA",16,158,59,217
https://kawalpemilu.org#25848,"KEMAYORAN, KEMAYORAN, JAKARTA PUSAT, DKI JAKARTA",17,116,86,202
https://kawalpemilu.org#25848,"KEMAYORAN, KEMAYORAN, JAKARTA PUSAT, DKI JAKARTA",18,95,108,203
https://kawalpemilu.org#25848,"KEMAYORAN, KEMAYORAN, JAKARTA PUSAT, DKI JAKARTA",19,145,45,190
https://kawalpemilu.org#25848,"KEMAYORAN, KEMAYORAN, JAKARTA PUSAT, DKI JAKARTA",20,137,59,196
https://kawalpemilu.org#25848,"KEMAYORAN, KEMAYORAN, JAKARTA PUSAT, DKI JAKARTA",22,117,47,164
https://kawalpemilu.org#25848,"KEMAYORAN, KEMAYORAN, JAKARTA PUSAT, DKI JAKARTA",23,130,76,206
https://kawalpemilu.org#25848,"KEMAYORAN, KEMAYORAN, JAKARTA PUSAT, DKI JAKARTA",24,175,36,211
https://kawalpemilu.org#25848,"KEMAYORAN, KEMAYORAN, JAKARTA PUSAT, DKI JAKARTA",25,175,22,197
https://kawalpemilu.org#25848,"KEMAYORAN, KEMAYORAN, JAKARTA PUSAT, DKI JAKARTA",26,91,107,198
https://kawalpemilu.org#25848,"KEMAYORAN, KEMAYORAN, JAKARTA PUSAT, DKI JAKARTA",29,156,49,205
https://kawalpemilu.org#25848,"KEMAYORAN, KEMAYORAN, JAKARTA PUSAT, DKI JAKARTA",30,101,73,174
https://kawalpemilu.org#25848,"KEMAYORAN, KEMAYORAN, JAKARTA PUSAT, DKI JAKARTA",31,138,68,206
https://kawalpemilu.org#25848,"KEMAYORAN, KEMAYORAN, JAKARTA PUSAT, DKI JAKARTA",32,120,93,213
https://kawalpemilu.org#25848,"KEMAYORAN, KEMAYORAN, JAKARTA PUSAT, DKI JAKARTA",33,116,69,185
https://kawalpemilu.org#25848,"KEMAYORAN, KEMAYORAN, JAKARTA PUSAT, DKI JAKARTA",36,90,131,221
https://kawalpemilu.org#25848,"KEMAYORAN, KEMAYORAN, JAKARTA PUSAT, DKI JAKARTA",37,132,89,221
https://kawalpemilu.org#25848,"KEMAYORAN, KEMAYORAN, JAKARTA PUSAT, DKI JAKARTA",38,109,121,230
https://kawalpemilu.org#25848,"KEMAYORAN, KEMAYORAN, JAKARTA PUSAT, DKI JAKARTA",40,138,119,257
https://kawalpemilu.org#25848,"KEMAYORAN, KEMAYORAN, JAKARTA PUSAT, DKI JAKARTA",41,114,95,209
https://kawalpemilu.org#25848,"KEMAYORAN, KEMAYORAN, JAKARTA PUSAT, DKI JAKARTA",42,93,117,210
https://kawalpemilu.org#25848,"KEMAYORAN, KEMAYORAN, JAKARTA PUSAT, DKI JAKARTA",43,132,114,246
https://kawalpemilu.org#25848,"KEMAYORAN, KEMAYORAN, JAKARTA PUSAT, DKI JAKARTA",44,147,47,194
https://kawalpemilu.org#25848,"KEMAYORAN, KEMAYORAN, JAKARTA PUSAT, DKI JAKARTA",45,132,104,236
https://kawalpemilu.org#25848,"KEMAYORAN, KEMAYORAN, JAKARTA PUSAT, DKI JAKARTA",46,110,98,208
https://kawalpemilu.org#25848,"KEMAYORAN, KEMAYORAN, JAKARTA PUSAT, DKI JAKARTA",47,121,104,225
https://kawalpemilu.org#25848,"KEMAYORAN, KEMAYORAN, JAKARTA PUSAT, DKI JAKARTA",48,114,109,223
https://kawalpemilu.org#25848,"KEMAYORAN, KEMAYORAN, JAKARTA PUSAT, DKI JAKARTA",49,109,91,200
https://kawalpemilu.org#25848,"KEMAYORAN, KEMAYORAN, JAKARTA PUSAT, DKI JAKARTA",50,135,75,210
https://kawalpemilu.org#25848,"KEMAYORAN, KEMAYORAN, JAKARTA PUSAT, DKI JAKARTA",51,136,91,227
https://kawalpemilu.org#25848,"KEMAYORAN, KEMAYORAN, JAKARTA PUSAT, DKI JAKARTA",52,99,112,211
https://kawalpemilu.org#25848,"KEMAYORAN, KEMAYORAN, JAKARTA PUSAT, DKI JAKARTA",53,145,64,209
https://kawalpemilu.org#25848,"KEMAYORAN, KEMAYORAN, JAKARTA PUSAT, DKI JAKARTA",54,110,117,227
https://kawalpemilu.org#25848,"KEMAYORAN, KEMAYORAN, JAKARTA PUSAT, DKI JAKARTA",56,87,113,200
https://kawalpemilu.org#25848,"KEMAYORAN, KEMAYORAN, JAKARTA PUSAT, DKI JAKARTA",57,114,110,224
https://kawalpemilu.org#25848,"KEMAYORAN, KEMAYORAN, JAKARTA PUSAT, DKI JAKARTA",58,136,93,229
https://kawalpemilu.org#25848,"KEMAYORAN, KEMAYORAN, JAKARTA PUSAT, DKI JAKARTA",59,128,89,217
https://kawalpemilu.org#25848,"KEMAYORAN, KEMAYORAN, JAKARTA PUSAT, DKI JAKARTA",60,124,79,203
https://kawalpemilu.org#25848,"KEMAYORAN, KEMAYORAN, JAKARTA PUSAT, DKI JAKARTA",61,153,60,213
https://kawalpemilu.org#25848,"KEMAYORAN, KEMAYORAN, JAKARTA PUSAT, DKI JAKARTA",62,104,118,222
https://kawalpemilu.org#25848,"KEMAYORAN, KEMAYORAN, JAKARTA PUSAT, DKI JAKARTA",63,81,134,215
https://kawalpemilu.org#25848,"KEMAYORAN, KEMAYORAN, JAKARTA PUSAT, DKI JAKARTA",64,98,66,164
https://kawalpemilu.org#25848,"KEMAYORAN, KEMAYORAN, JAKARTA PUSAT, DKI JAKARTA",65,89,139,228
https://kawalpemilu.org#25848,"KEMAYORAN, KEMAYORAN, JAKARTA PUSAT, DKI JAKARTA",66,126,86,212
https://kawalpemilu.org#25848,"KEMAYORAN, KEMAYORAN, JAKARTA PUSAT, DKI JAKARTA",68,101,96,197
https://kawalpemilu.org#25848,"KEMAYORAN, KEMAYORAN, JAKARTA PUSAT, DKI JAKARTA",69,89,92,181
https://kawalpemilu.org#25848,"KEMAYORAN, KEMAYORAN, JAKARTA PUSAT, DKI JAKARTA",70,147,51,198
https://kawalpemilu.org#25849,"KEBON KOSONG, KEMAYORAN, JAKARTA PUSAT, DKI JAKARTA",1,159,72,231
https://kawalpemilu.org#25849,"KEBON KOSONG, KEMAYORAN, JAKARTA PUSAT, DKI JAKARTA",2,131,84,215
https://kawalpemilu.org#25849,"KEBON KOSONG, KEMAYORAN, JAKARTA PUSAT, DKI JAKARTA",3,164,64,228
https://kawalpemilu.org#25849,"KEBON KOSONG, KEMAYORAN, JAKARTA PUSAT, DKI JAKARTA",4,117,128,245
https://kawalpemilu.org#25849,"KEBON KOSONG, KEMAYORAN, JAKARTA PUSAT, DKI JAKARTA",5,119,116,235
https://kawalpemilu.org#25849,"KEBON KOSONG, KEMAYORAN, JAKARTA PUSAT, DKI JAKARTA",6,127,114,241
https://kawalpemilu.org#25849,"KEBON KOSONG, KEMAYORAN, JAKARTA PUSAT, DKI JAKARTA",8,113,98,211
https://kawalpemilu.org#25849,"KEBON KOSONG, KEMAYORAN, JAKARTA PUSAT, DKI JAKARTA",9,108,118,226
https://kawalpemilu.org#25849,"KEBON KOSONG, KEMAYORAN, JAKARTA PUSAT, DKI JAKARTA",10,76,146,222
https://kawalpemilu.org#25849,"KEBON KOSONG, KEMAYORAN, JAKARTA PUSAT, DKI JAKARTA",12,82,139,221
https://kawalpemilu.org#25849,"KEBON KOSONG, KEMAYORAN, JAKARTA PUSAT, DKI JAKARTA",13,115,109,224
https://kawalpemilu.org#25849,"KEBON KOSONG, KEMAYORAN, JAKARTA PUSAT, DKI JAKARTA",14,116,122,238
https://kawalpemilu.org#25849,"KEBON KOSONG, KEMAYORAN, JAKARTA PUSAT, DKI JAKARTA",15,136,107,243
https://kawalpemilu.org#25849,"KEBON KOSONG, KEMAYORAN, JAKARTA PUSAT, DKI JAKARTA",16,168,57,225
https://kawalpemilu.org#25849,"KEBON KOSONG, KEMAYORAN, JAKARTA PUSAT, DKI JAKARTA",18,101,135,236
https://kawalpemilu.org#25849,"KEBON KOSONG, KEMAYORAN, JAKARTA PUSAT, DKI JAKARTA",19,102,124,226
https://kawalpemilu.org#25849,"KEBON KOSONG, KEMAYORAN, JAKARTA PUSAT, DKI JAKARTA",20,106,124,230
https://kawalpemilu.org#25849,"KEBON KOSONG, KEMAYORAN, JAKARTA PUSAT, DKI JAKARTA",21,127,66,193
https://kawalpemilu.org#25849,"KEBON KOSONG, KEMAYORAN, JAKARTA PUSAT, DKI JAKARTA",22,120,114,234
https://kawalpemilu.org#25849,"KEBON KOSONG, KEMAYORAN, JAKARTA PUSAT, DKI JAKARTA",23,144,97,241
https://kawalpemilu.org#25849,"KEBON KOSONG, KEMAYORAN, JAKARTA PUSAT, DKI JAKARTA",24,136,87,223
https://kawalpemilu.org#25849,"KEBON KOSONG, KEMAYORAN, JAKARTA PUSAT, DKI JAKARTA",25,154,90,244
https://kawalpemilu.org#25849,"KEBON KOSONG, KEMAYORAN, JAKARTA PUSAT, DKI JAKARTA",26,171,75,246
https://kawalpemilu.org#25849,"KEBON KOSONG, KEMAYORAN, JAKARTA PUSAT, DKI JAKARTA",28,139,77,216
https://kawalpemilu.org#25849,"KEBON KOSONG, KEMAYORAN, JAKARTA PUSAT, DKI JAKARTA",29,128,75,203
https://kawalpemilu.org#25849,"KEBON KOSONG, KEMAYORAN, JAKARTA PUSAT, DKI JAKARTA",30,113,69,182
https://kawalpemilu.org#25849,"KEBON KOSONG, KEMAYORAN, JAKARTA PUSAT, DKI JAKARTA",31,106,88,194
https://kawalpemilu.org#25849,"KEBON KOSONG, KEMAYORAN, JAKARTA PUSAT, DKI JAKARTA",32,143,106,249
https://kawalpemilu.org#25849,"KEBON KOSONG, KEMAYORAN, JAKARTA PUSAT, DKI JAKARTA",33,139,92,231
https://kawalpemilu.org#25849,"KEBON KOSONG, KEMAYORAN, JAKARTA PUSAT, DKI JAKARTA",34,125,105,230
https://kawalpemilu.org#25849,"KEBON KOSONG, KEMAYORAN, JAKARTA PUSAT, DKI JAKARTA",35,125,100,225
https://kawalpemilu.org#25849,"KEBON KOSONG, KEMAYORAN, JAKARTA PUSAT, DKI JAKARTA",37,172,66,238
https://kawalpemilu.org#25849,"KEBON KOSONG, KEMAYORAN, JAKARTA PUSAT, DKI JAKARTA",38,159,78,237
https://kawalpemilu.org#25849,"KEBON KOSONG, KEMAYORAN, JAKARTA PUSAT, DKI JAKARTA",39,125,105,230
https://kawalpemilu.org#25849,"KEBON KOSONG, KEMAYORAN, JAKARTA PUSAT, DKI JAKARTA",40,78,129,207
https://kawalpemilu.org#25849,"KEBON KOSONG, KEMAYORAN, JAKARTA PUSAT, DKI JAKARTA",41,114,86,200
https://kawalpemilu.org#25849,"KEBON KOSONG, KEMAYORAN, JAKARTA PUSAT, DKI JAKARTA",42,111,110,221
https://kawalpemilu.org#25849,"KEBON KOSONG, KEMAYORAN, JAKARTA PUSAT, DKI JAKARTA",43,147,75,222
https://kawalpemilu.org#25849,"KEBON KOSONG, KEMAYORAN, JAKARTA PUSAT, DKI JAKARTA",44,129,109,238
https://kawalpemilu.org#25849,"KEBON KOSONG, KEMAYORAN, JAKARTA PUSAT, DKI JAKARTA",45,113,109,222
https://kawalpemilu.org#25849,"KEBON KOSONG, KEMAYORAN, JAKARTA PUSAT, DKI JAKARTA",46,109,93,202
https://kawalpemilu.org#25849,"KEBON KOSONG, KEMAYORAN, JAKARTA PUSAT, DKI JAKARTA",47,107,126,233
https://kawalpemilu.org#25849,"KEBON KOSONG, KEMAYORAN, JAKARTA PUSAT, DKI JAKARTA",48,100,122,222
https://kawalpemilu.org#25849,"KEBON KOSONG, KEMAYORAN, JAKARTA PUSAT, DKI JAKARTA",49,135,104,239
https://kawalpemilu.org#25849,"KEBON KOSONG, KEMAYORAN, JAKARTA PUSAT, DKI JAKARTA",50,111,142,253
https://kawalpemilu.org#25849,"KEBON KOSONG, KEMAYORAN, JAKARTA PUSAT, DKI JAKARTA",51,89,169,258
https://kawalpemilu.org#25849,"KEBON KOSONG, KEMAYORAN, JAKARTA PUSAT, DKI JAKARTA",52,76,155,231
https://kawalpemilu.org#25849,"KEBON KOSONG, KEMAYORAN, JAKARTA PUSAT, DKI JAKARTA",53,84,156,240
https://kawalpemilu.org#25849,"KEBON KOSONG, KEMAYORAN, JAKARTA PUSAT, DKI JAKARTA",54,77,165,242
https://kawalpemilu.org#25849,"KEBON KOSONG, KEMAYORAN, JAKARTA PUSAT, DKI JAKARTA",55,105,134,239
https://kawalpemilu.org#25849,"KEBON KOSONG, KEMAYORAN, JAKARTA PUSAT, DKI JAKARTA",56,125,110,235
https://kawalpemilu.org#25849,"KEBON KOSONG, KEMAYORAN, JAKARTA PUSAT, DKI JAKARTA",57,128,117,245
https://kawalpemilu.org#25849,"KEBON KOSONG, KEMAYORAN, JAKARTA PUSAT, DKI JAKARTA",58,114,165,279
https://kawalpemilu.org#25849,"KEBON KOSONG, KEMAYORAN, JAKARTA PUSAT, DKI JAKARTA",59,130,114,244
https://kawalpemilu.org#25849,"KEBON KOSONG, KEMAYORAN, JAKARTA PUSAT, DKI JAKARTA",60,124,103,228
https://kawalpemilu.org#25849,"KEBON KOSONG, KEMAYORAN, JAKARTA PUSAT, DKI JAKARTA",61,113,88,201
https://kawalpemilu.org#25849,"KEBON KOSONG, KEMAYORAN, JAKARTA PUSAT, DKI JAKARTA",62,143,55,198
https://kawalpemilu.org#25849,"KEBON KOSONG, KEMAYORAN, JAKARTA PUSAT, DKI JAKARTA",63,121,106,227
https://kawalpemilu.org#25849,"KEBON KOSONG, KEMAYORAN, JAKARTA PUSAT, DKI JAKARTA",64,106,93,199
https://kawalpemilu.org#25849,"KEBON KOSONG, KEMAYORAN, JAKARTA PUSAT, DKI JAKARTA",65,160,90,250
https://kawalpemilu.org#25849,"KEBON KOSONG, KEMAYORAN, JAKARTA PUSAT, DKI JAKARTA",66,141,59,200
https://kawalpemilu.org#25849,"KEBON KOSONG, KEMAYORAN, JAKARTA PUSAT, DKI JAKARTA",67,140,84,224
https://kawalpemilu.org#25849,"KEBON KOSONG, KEMAYORAN, JAKARTA PUSAT, DKI JAKARTA",68,189,67,256
https://kawalpemilu.org#25849,"KEBON KOSONG, KEMAYORAN, JAKARTA PUSAT, DKI JAKARTA",69,175,39,214
https://kawalpemilu.org#25849,"KEBON KOSONG, KEMAYORAN, JAKARTA PUSAT, DKI JAKARTA",70,130,102,232
https://kawalpemilu.org#25849,"KEBON KOSONG, KEMAYORAN, JAKARTA PUSAT, DKI JAKARTA",71,150,77,227
https://kawalpemilu.org#25849,"KEBON KOSONG, KEMAYORAN, JAKARTA PUSAT, DKI JAKARTA",72,107,128,235
https://kawalpemilu.org#25849,"KEBON KOSONG, KEMAYORAN, JAKARTA PUSAT, DKI JAKARTA",73,169,73,242
https://kawalpemilu.org#25849,"KEBON KOSONG, KEMAYORAN, JAKARTA PUSAT, DKI JAKARTA",74,146,91,237
https://kawalpemilu.org#25849,"KEBON KOSONG, KEMAYORAN, JAKARTA PUSAT, DKI JAKARTA",75,163,73,236
https://kawalpemilu.org#25849,"KEBON KOSONG, KEMAYORAN, JAKARTA PUSAT, DKI JAKARTA",76,167,74,241
https://kawalpemilu.org#25849,"KEBON KOSONG, KEMAYORAN, JAKARTA PUSAT, DKI JAKARTA",77,131,70,201
https://kawalpemilu.org#25849,"KEBON KOSONG, KEMAYORAN, JAKARTA PUSAT, DKI JAKARTA",78,117,79,196
https://kawalpemilu.org#25849,"KEBON KOSONG, KEMAYORAN, JAKARTA PUSAT, DKI JAKARTA",79,104,91,195
https://kawalpemilu.org#25849,"KEBON KOSONG, KEMAYORAN, JAKARTA PUSAT, DKI JAKARTA",80,147,36,183
https://kawalpemilu.org#25849,"KEBON KOSONG, KEMAYORAN, JAKARTA PUSAT, DKI JAKARTA",81,178,19,197
https://kawalpemilu.org#25849,"KEBON KOSONG, KEMAYORAN, JAKARTA PUSAT, DKI JAKARTA",82,143,94,237
https://kawalpemilu.org#25849,"KEBON KOSONG, KEMAYORAN, JAKARTA PUSAT, DKI JAKARTA",83,146,103,249
https://kawalpemilu.org#25849,"KEBON KOSONG, KEMAYORAN, JAKARTA PUSAT, DKI JAKARTA",84,175,63,238
https://kawalpemilu.org#25849,"KEBON KOSONG, KEMAYORAN, JAKARTA PUSAT, DKI JAKARTA",85,226,15,241
https://kawalpemilu.org#25849,"KEBON KOSONG, KEMAYORAN, JAKARTA PUSAT, DKI JAKARTA",86,211,32,243
https://kawalpemilu.org#25849,"KEBON KOSONG, KEMAYORAN, JAKARTA PUSAT, DKI JAKARTA",87,246,15,261
https://kawalpemilu.org#25850,"HARAPAN MULIA, KEMAYORAN, JAKARTA PUSAT, DKI JAKARTA",1,89,118,207
https://kawalpemilu.org#25850,"HARAPAN MULIA, KEMAYORAN, JAKARTA PUSAT, DKI JAKARTA",2,93,105,198
https://kawalpemilu.org#25850,"HARAPAN MULIA, KEMAYORAN, JAKARTA PUSAT, DKI JAKARTA",3,111,102,213
https://kawalpemilu.org#25850,"HARAPAN MULIA, KEMAYORAN, JAKARTA PUSAT, DKI JAKARTA",4,135,111,246
https://kawalpemilu.org#25850,"HARAPAN MULIA, KEMAYORAN, JAKARTA PUSAT, DKI JAKARTA",5,102,118,220
https://kawalpemilu.org#25850,"HARAPAN MULIA, KEMAYORAN, JAKARTA PUSAT, DKI JAKARTA",6,117,111,228
https://kawalpemilu.org#25850,"HARAPAN MULIA, KEMAYORAN, JAKARTA PUSAT, DKI JAKARTA",7,84,129,213
https://kawalpemilu.org#25850,"HARAPAN MULIA, KEMAYORAN, JAKARTA PUSAT, DKI JAKARTA",8,66,154,220
https://kawalpemilu.org#25850,"HARAPAN MULIA, KEMAYORAN, JAKARTA PUSAT, DKI JAKARTA",9,86,146,232
https://kawalpemilu.org#25850,"HARAPAN MULIA, KEMAYORAN, JAKARTA PUSAT, DKI JAKARTA",10,121,96,217
https://kawalpemilu.org#25850,"HARAPAN MULIA, KEMAYORAN, JAKARTA PUSAT, DKI JAKARTA",11,145,48,193
https://kawalpemilu.org#25850,"HARAPAN MULIA, KEMAYORAN, JAKARTA PUSAT, DKI JAKARTA",12,117,62,199
https://kawalpemilu.org#25850,"HARAPAN MULIA, KEMAYORAN, JAKARTA PUSAT, DKI JAKARTA",13,132,106,238
https://kawalpemilu.org#25850,"HARAPAN MULIA, KEMAYORAN, JAKARTA PUSAT, DKI JAKARTA",14,87,135,222
https://kawalpemilu.org#25850,"HARAPAN MULIA, KEMAYORAN, JAKARTA PUSAT, DKI JAKARTA",15,95,109,204
https://kawalpemilu.org#25850,"HARAPAN MULIA, KEMAYORAN, JAKARTA PUSAT, DKI JAKARTA",16,105,119,224
https://kawalpemilu.org#25850,"HARAPAN MULIA, KEMAYORAN, JAKARTA PUSAT, DKI JAKARTA",17,101,122,223
https://kawalpemilu.org#25850,"HARAPAN MULIA, KEMAYORAN, JAKARTA PUSAT, DKI JAKARTA",18,87,104,191
https://kawalpemilu.org#25850,"HARAPAN MULIA, KEMAYORAN, JAKARTA PUSAT, DKI JAKARTA",19,106,97,203
https://kawalpemilu.org#25850,"HARAPAN MULIA, KEMAYORAN, JAKARTA PUSAT, DKI JAKARTA",20,116,122,238
https://kawalpemilu.org#25850,"HARAPAN MULIA, KEMAYORAN, JAKARTA PUSAT, DKI JAKARTA",21,100,110,210
https://kawalpemilu.org#25850,"HARAPAN MULIA, KEMAYORAN, JAKARTA PUSAT, DKI JAKARTA",22,144,84,228
https://kawalpemilu.org#25850,"HARAPAN MULIA, KEMAYORAN, JAKARTA PUSAT, DKI JAKARTA",23,111,109,220
https://kawalpemilu.org#25850,"HARAPAN MULIA, KEMAYORAN, JAKARTA PUSAT, DKI JAKARTA",24,117,127,244
https://kawalpemilu.org#25850,"HARAPAN MULIA, KEMAYORAN, JAKARTA PUSAT, DKI JAKARTA",25,124,102,226
https://kawalpemilu.org#25850,"HARAPAN MULIA, KEMAYORAN, JAKARTA PUSAT, DKI JAKARTA",26,120,102,222
https://kawalpemilu.org#25850,"HARAPAN MULIA, KEMAYORAN, JAKARTA PUSAT, DKI JAKARTA",27,136,95,231
https://kawalpemilu.org#25850,"HARAPAN MULIA, KEMAYORAN, JAKARTA PUSAT, DKI JAKARTA",28,92,148,240
https://kawalpemilu.org#25850,"HARAPAN MULIA, KEMAYORAN, JAKARTA PUSAT, DKI JAKARTA",29,96,112,208
https://kawalpemilu.org#25850,"HARAPAN MULIA, KEMAYORAN, JAKARTA PUSAT, DKI JAKARTA",30,112,102,214
https://kawalpemilu.org#25850,"HARAPAN MULIA, KEMAYORAN, JAKARTA PUSAT, DKI JAKARTA",31,95,119,214
https://kawalpemilu.org#25850,"HARAPAN MULIA, KEMAYORAN, JAKARTA PUSAT, DKI JAKARTA",32,136,83,219
https://kawalpemilu.org#25850,"HARAPAN MULIA, KEMAYORAN, JAKARTA PUSAT, DKI JAKARTA",33,125,111,236
https://kawalpemilu.org#25850,"HARAPAN MULIA, KEMAYORAN, JAKARTA PUSAT, DKI JAKARTA",34,91,127,218
https://kawalpemilu.org#25850,"HARAPAN MULIA, KEMAYORAN, JAKARTA PUSAT, DKI JAKARTA",35,69,133,202
https://kawalpemilu.org#25850,"HARAPAN MULIA, KEMAYORAN, JAKARTA PUSAT, DKI JAKARTA",36,107,115,222
https://kawalpemilu.org#25850,"HARAPAN MULIA, KEMAYORAN, JAKARTA PUSAT, DKI JAKARTA",37,79,130,209
https://kawalpemilu.org#25850,"HARAPAN MULIA, KEMAYORAN, JAKARTA PUSAT, DKI JAKARTA",38,94,125,219
https://kawalpemilu.org#25850,"HARAPAN MULIA, KEMAYORAN, JAKARTA PUSAT, DKI JAKARTA",39,120,81,201
https://kawalpemilu.org#25850,"HARAPAN MULIA, KEMAYORAN, JAKARTA PUSAT, DKI JAKARTA",40,89,143,232
https://kawalpemilu.org#25850,"HARAPAN MULIA, KEMAYORAN, JAKARTA PUSAT, DKI JAKARTA",41,92,101,193
https://kawalpemilu.org#25850,"HARAPAN MULIA, KEMAYORAN, JAKARTA PUSAT, DKI JAKARTA",42,74,120,194
https://kawalpemilu.org#25850,"HARAPAN MULIA, KEMAYORAN, JAKARTA PUSAT, DKI JAKARTA",43,83,85,168
https://kawalpemilu.org#25850,"HARAPAN MULIA, KEMAYORAN, JAKARTA PUSAT, DKI JAKARTA",44,101,121,222
https://kawalpemilu.org#25850,"HARAPAN MULIA, KEMAYORAN, JAKARTA PUSAT, DKI JAKARTA",45,110,121,231
https://kawalpemilu.org#25850,"HARAPAN MULIA, KEMAYORAN, JAKARTA PUSAT, DKI JAKARTA",46,83,125,208
https://kawalpemilu.org#25850,"HARAPAN MULIA, KEMAYORAN, JAKARTA PUSAT, DKI JAKARTA",47,91,138,229
https://kawalpemilu.org#25850,"HARAPAN MULIA, KEMAYORAN, JAKARTA PUSAT, DKI JAKARTA",48,70,150,220
https://kawalpemilu.org#25850,"HARAPAN MULIA, KEMAYORAN, JAKARTA PUSAT, DKI JAKARTA",49,123,111,234
https://kawalpemilu.org#25850,"HARAPAN MULIA, KEMAYORAN, JAKARTA PUSAT, DKI JAKARTA",50,115,104,219
https://kawalpemilu.org#25850,"HARAPAN MULIA, KEMAYORAN, JAKARTA PUSAT, DKI JAKARTA",51,121,99,220
https://kawalpemilu.org#25850,"HARAPAN MULIA, KEMAYORAN, JAKARTA PUSAT, DKI JAKARTA",52,112,118,230
https://kawalpemilu.org#25850,"HARAPAN MULIA, KEMAYORAN, JAKARTA PUSAT, DKI JAKARTA",53,97,143,240
https://kawalpemilu.org#25850,"HARAPAN MULIA, KEMAYORAN, JAKARTA PUSAT, DKI JAKARTA",54,108,136,244
https://kawalpemilu.org#25850,"HARAPAN MULIA, KEMAYORAN, JAKARTA PUSAT, DKI JAKARTA",55,83,144,227
https://kawalpemilu.org#25850,"HARAPAN MULIA, KEMAYORAN, JAKARTA PUSAT, DKI JAKARTA",56,123,125,248
https://kawalpemilu.org#25850,"HARAPAN MULIA, KEMAYORAN, JAKARTA PUSAT, DKI JAKARTA",57,110,122,232
https://kawalpemilu.org#25850,"HARAPAN MULIA, KEMAYORAN, JAKARTA PUSAT, DKI JAKARTA",58,107,128,235
https://kawalpemilu.org#25850,"HARAPAN MULIA, KEMAYORAN, JAKARTA PUSAT, DKI JAKARTA",59,131,104,235
https://kawalpemilu.org#25850,"HARAPAN MULIA, KEMAYORAN, JAKARTA PUSAT, DKI JAKARTA",60,97,131,228
https://kawalpemilu.org#25850,"HARAPAN MULIA, KEMAYORAN, JAKARTA PUSAT, DKI JAKARTA",62,120,109,229
https://kawalpemilu.org#25850,"HARAPAN MULIA, KEMAYORAN, JAKARTA PUSAT, DKI JAKARTA",63,125,98,223
https://kawalpemilu.org#25850,"HARAPAN MULIA, KEMAYORAN, JAKARTA PUSAT, DKI JAKARTA",65,114,118,232
https://kawalpemilu.org#25850,"HARAPAN MULIA, KEMAYORAN, JAKARTA PUSAT, DKI JAKARTA",66,80,131,211
https://kawalpemilu.org#25850,"HARAPAN MULIA, KEMAYORAN, JAKARTA PUSAT, DKI JAKARTA",67,84,155,239
https://kawalpemilu.org#25850,"HARAPAN MULIA, KEMAYORAN, JAKARTA PUSAT, DKI JAKARTA",68,118,121,239
https://kawalpemilu.org#25850,"HARAPAN MULIA, KEMAYORAN, JAKARTA PUSAT, DKI JAKARTA",69,110,140,250
https://kawalpemilu.org#25850,"HARAPAN MULIA, KEMAYORAN, JAKARTA PUSAT, DKI JAKARTA",70,97,133,230
https://kawalpemilu.org#25850,"HARAPAN MULIA, KEMAYORAN, JAKARTA PUSAT, DKI JAKARTA",71,117,119,236
https://kawalpemilu.org#25850,"HARAPAN MULIA, KEMAYORAN, JAKARTA PUSAT, DKI JAKARTA",72,102,126,228
https://kawalpemilu.org#25850,"HARAPAN MULIA, KEMAYORAN, JAKARTA PUSAT, DKI JAKARTA",73,128,110,238
https://kawalpemilu.org#25850,"HARAPAN MULIA, KEMAYORAN, JAKARTA PUSAT, DKI JAKARTA",74,125,99,224
https://kawalpemilu.org#25851,"SERDANG, KEMAYORAN, JAKARTA PUSAT, DKI JAKARTA",1,100,137,237
https://kawalpemilu.org#25851,"SERDANG, KEMAYORAN, JAKARTA PUSAT, DKI JAKARTA",2,104,151,255
https://kawalpemilu.org#25851,"SERDANG, KEMAYORAN, JAKARTA PUSAT, DKI JAKARTA",3,74,180,254
https://kawalpemilu.org#25851,"SERDANG, KEMAYORAN, JAKARTA PUSAT, DKI JAKARTA",4,84,164,248
https://kawalpemilu.org#25851,"SERDANG, KEMAYORAN, JAKARTA PUSAT, DKI JAKARTA",5,120,107,227
https://kawalpemilu.org#25851,"SERDANG, KEMAYORAN, JAKARTA PUSAT, DKI JAKARTA",6,122,105,227
https://kawalpemilu.org#25851,"SERDANG, KEMAYORAN, JAKARTA PUSAT, DKI JAKARTA",7,139,102,241
https://kawalpemilu.org#25851,"SERDANG, KEMAYORAN, JAKARTA PUSAT, DKI JAKARTA",8,105,161,266
https://kawalpemilu.org#25851,"SERDANG, KEMAYORAN, JAKARTA PUSAT, DKI JAKARTA",9,113,141,254
https://kawalpemilu.org#25851,"SERDANG, KEMAYORAN, JAKARTA PUSAT, DKI JAKARTA",10,127,124,251
https://kawalpemilu.org#25851,"SERDANG, KEMAYORAN, JAKARTA PUSAT, DKI JAKARTA",11,133,110,243
https://kawalpemilu.org#25851,"SERDANG, KEMAYORAN, JAKARTA PUSAT, DKI JAKARTA",12,137,109,246
https://kawalpemilu.org#25851,"SERDANG, KEMAYORAN, JAKARTA PUSAT, DKI JAKARTA",13,110,143,253
https://kawalpemilu.org#25851,"SERDANG, KEMAYORAN, JAKARTA PUSAT, DKI JAKARTA",14,99,119,218
https://kawalpemilu.org#25851,"SERDANG, KEMAYORAN, JAKARTA PUSAT, DKI JAKARTA",15,91,140,231
https://kawalpemilu.org#25851,"SERDANG, KEMAYORAN, JAKARTA PUSAT, DKI JAKARTA",16,116,121,237
https://kawalpemilu.org#25851,"SERDANG, KEMAYORAN, JAKARTA PUSAT, DKI JAKARTA",17,123,120,243
https://kawalpemilu.org#25851,"SERDANG, KEMAYORAN, JAKARTA PUSAT, DKI JAKARTA",18,165,99,264
https://kawalpemilu.org#25851,"SERDANG, KEMAYORAN, JAKARTA PUSAT, DKI JAKARTA",19,134,128,262
https://kawalpemilu.org#25851,"SERDANG, KEMAYORAN, JAKARTA PUSAT, DKI JAKARTA",20,120,128,248
https://kawalpemilu.org#25851,"SERDANG, KEMAYORAN, JAKARTA PUSAT, DKI JAKARTA",21,141,113,254
https://kawalpemilu.org#25851,"SERDANG, KEMAYORAN, JAKARTA PUSAT, DKI JAKARTA",22,129,137,266
https://kawalpemilu.org#25851,"SERDANG, KEMAYORAN, JAKARTA PUSAT, DKI JAKARTA",23,132,106,238
https://kawalpemilu.org#25851,"SERDANG, KEMAYORAN, JAKARTA PUSAT, DKI JAKARTA",24,145,115,260
https://kawalpemilu.org#25851,"SERDANG, KEMAYORAN, JAKARTA PUSAT, DKI JAKARTA",25,124,105,229
https://kawalpemilu.org#25851,"SERDANG, KEMAYORAN, JAKARTA PUSAT, DKI JAKARTA",26,139,96,235
https://kawalpemilu.org#25851,"SERDANG, KEMAYORAN, JAKARTA PUSAT, DKI JAKARTA",27,117,100,217
https://kawalpemilu.org#25851,"SERDANG, KEMAYORAN, JAKARTA PUSAT, DKI JAKARTA",28,92,135,227
https://kawalpemilu.org#25851,"SERDANG, KEMAYORAN, JAKARTA PUSAT, DKI JAKARTA",29,101,116,217
https://kawalpemilu.org#25851,"SERDANG, KEMAYORAN, JAKARTA PUSAT, DKI JAKARTA",31,85,124,209
https://kawalpemilu.org#25851,"SERDANG, KEMAYORAN, JAKARTA PUSAT, DKI JAKARTA",32,85,129,214
https://kawalpemilu.org#25851,"SERDANG, KEMAYORAN, JAKARTA PUSAT, DKI JAKARTA",33,66,178,244
https://kawalpemilu.org#25851,"SERDANG, KEMAYORAN, JAKARTA PUSAT, DKI JAKARTA",35,97,113,210
https://kawalpemilu.org#25851,"SERDANG, KEMAYORAN, JAKARTA PUSAT, DKI JAKARTA",36,126,83,209
https://kawalpemilu.org#25851,"SERDANG, KEMAYORAN, JAKARTA PUSAT, DKI JAKARTA",37,87,130,217
https://kawalpemilu.org#25851,"SERDANG, KEMAYORAN, JAKARTA PUSAT, DKI JAKARTA",38,91,124,215
https://kawalpemilu.org#25851,"SERDANG, KEMAYORAN, JAKARTA PUSAT, DKI JAKARTA",39,117,95,212
https://kawalpemilu.org#25851,"SERDANG, KEMAYORAN, JAKARTA PUSAT, DKI JAKARTA",40,132,73,205
https://kawalpemilu.org#25851,"SERDANG, KEMAYORAN, JAKARTA PUSAT, DKI JAKARTA",41,103,121,224
https://kawalpemilu.org#25851,"SERDANG, KEMAYORAN, JAKARTA PUSAT, DKI JAKARTA",42,120,109,229
https://kawalpemilu.org#25851,"SERDANG, KEMAYORAN, JAKARTA PUSAT, DKI JAKARTA",43,122,104,226
https://kawalpemilu.org#25851,"SERDANG, KEMAYORAN, JAKARTA PUSAT, DKI JAKARTA",44,92,133,225
https://kawalpemilu.org#25851,"SERDANG, KEMAYORAN, JAKARTA PUSAT, DKI JAKARTA",45,113,105,218
https://kawalpemilu.org#25851,"SERDANG, KEMAYORAN, JAKARTA PUSAT, DKI JAKARTA",46,114,106,220
https://kawalpemilu.org#25851,"SERDANG, KEMAYORAN, JAKARTA PUSAT, DKI JAKARTA",47,113,112,225
https://kawalpemilu.org#25851,"SERDANG, KEMAYORAN, JAKARTA PUSAT, DKI JAKARTA",48,114,143,257
https://kawalpemilu.org#25851,"SERDANG, KEMAYORAN, JAKARTA PUSAT, DKI JAKARTA",49,110,123,233
https://kawalpemilu.org#25851,"SERDANG, KEMAYORAN, JAKARTA PUSAT, DKI JAKARTA",50,95,137,232
https://kawalpemilu.org#25851,"SERDANG, KEMAYORAN, JAKARTA PUSAT, DKI JAKARTA",51,104,131,235
https://kawalpemilu.org#25851,"SERDANG, KEMAYORAN, JAKARTA PUSAT, DKI JAKARTA",52,78,138,216
https://kawalpemilu.org#25851,"SERDANG, KEMAYORAN, JAKARTA PUSAT, DKI JAKARTA",53,116,117,233
https://kawalpemilu.org#25851,"SERDANG, KEMAYORAN, JAKARTA PUSAT, DKI JAKARTA",54,107,140,247
https://kawalpemilu.org#25851,"SERDANG, KEMAYORAN, JAKARTA PUSAT, DKI JAKARTA",55,100,134,234
https://kawalpemilu.org#25851,"SERDANG, KEMAYORAN, JAKARTA PUSAT, DKI JAKARTA",56,97,121,218
https://kawalpemilu.org#25851,"SERDANG, KEMAYORAN, JAKARTA PUSAT, DKI JAKARTA",57,105,135,240
https://kawalpemilu.org#25851,"SERDANG, KEMAYORAN, JAKARTA PUSAT, DKI JAKARTA",58,105,132,237
https://kawalpemilu.org#25851,"SERDANG, KEMAYORAN, JAKARTA PUSAT, DKI JAKARTA",59,107,141,248
https://kawalpemilu.org#25851,"SERDANG, KEMAYORAN, JAKARTA PUSAT, DKI JAKARTA",60,105,126,231
https://kawalpemilu.org#25851,"SERDANG, KEMAYORAN, JAKARTA PUSAT, DKI JAKARTA",61,95,146,241
https://kawalpemilu.org#25851,"SERDANG, KEMAYORAN, JAKARTA PUSAT, DKI JAKARTA",62,111,126,237
https://kawalpemilu.org#25851,"SERDANG, KEMAYORAN, JAKARTA PUSAT, DKI JAKARTA",63,134,110,244
https://kawalpemilu.org#25851,"SERDANG, KEMAYORAN, JAKARTA PUSAT, DKI JAKARTA",66,121,113,234
https://kawalpemilu.org#25851,"SERDANG, KEMAYORAN, JAKARTA PUSAT, DKI JAKARTA",67,126,94,220
https://kawalpemilu.org#25851,"SERDANG, KEMAYORAN, JAKARTA PUSAT, DKI JAKARTA",68,110,93,203
https://kawalpemilu.org#25851,"SERDANG, KEMAYORAN, JAKARTA PUSAT, DKI JAKARTA",69,134,103,237
https://kawalpemilu.org#25851,"SERDANG, KEMAYORAN, JAKARTA PUSAT, DKI JAKARTA",70,123,94,217
https://kawalpemilu.org#25851,"SERDANG, KEMAYORAN, JAKARTA PUSAT, DKI JAKARTA",71,77,139,216
https://kawalpemilu.org#25851,"SERDANG, KEMAYORAN, JAKARTA PUSAT, DKI JAKARTA",72,97,130,227
https://kawalpemilu.org#25851,"SERDANG, KEMAYORAN, JAKARTA PUSAT, DKI JAKARTA",73,133,97,230
https://kawalpemilu.org#25851,"SERDANG, KEMAYORAN, JAKARTA PUSAT, DKI JAKARTA",74,111,133,244
https://kawalpemilu.org#25851,"SERDANG, KEMAYORAN, JAKARTA PUSAT, DKI JAKARTA",75,112,138,250
https://kawalpemilu.org#25851,"SERDANG, KEMAYORAN, JAKARTA PUSAT, DKI JAKARTA",76,118,129,247
https://kawalpemilu.org#25851,"SERDANG, KEMAYORAN, JAKARTA PUSAT, DKI JAKARTA",77,120,112,232
https://kawalpemilu.org#25851,"SERDANG, KEMAYORAN, JAKARTA PUSAT, DKI JAKARTA",78,85,136,221
https://kawalpemilu.org#25851,"SERDANG, KEMAYORAN, JAKARTA PUSAT, DKI JAKARTA",80,109,152,261
https://kawalpemilu.org#25851,"SERDANG, KEMAYORAN, JAKARTA PUSAT, DKI JAKARTA",83,134,116,250
https://kawalpemilu.org#25851,"SERDANG, KEMAYORAN, JAKARTA PUSAT, DKI JAKARTA",84,135,102,237
https://kawalpemilu.org#25851,"SERDANG, KEMAYORAN, JAKARTA PUSAT, DKI JAKARTA",85,126,121,247
https://kawalpemilu.org#25851,"SERDANG, KEMAYORAN, JAKARTA PUSAT, DKI JAKARTA",86,115,118,233
https://kawalpemilu.org#25851,"SERDANG, KEMAYORAN, JAKARTA PUSAT, DKI JAKARTA",87,137,113,250
https://kawalpemilu.org#25851,"SERDANG, KEMAYORAN, JAKARTA PUSAT, DKI JAKARTA",88,89,107,196
https://kawalpemilu.org#25851,"SERDANG, KEMAYORAN, JAKARTA PUSAT, DKI JAKARTA",89,114,83,197
https://kawalpemilu.org#25851,"SERDANG, KEMAYORAN, JAKARTA PUSAT, DKI JAKARTA",91,125,89,214
https://kawalpemilu.org#25851,"SERDANG, KEMAYORAN, JAKARTA PUSAT, DKI JAKARTA",92,74,95,169
https://kawalpemilu.org#25851,"SERDANG, KEMAYORAN, JAKARTA PUSAT, DKI JAKARTA",93,74,101,175
https://kawalpemilu.org#25852,"GUNUNG SAHARI SELATAN, KEMAYORAN, JAKARTA PUSAT, DKI JAKARTA",1,182,35,217
https://kawalpemilu.org#25852,"GUNUNG SAHARI SELATAN, KEMAYORAN, JAKARTA PUSAT, DKI JAKARTA",2,188,35,223
https://kawalpemilu.org#25852,"GUNUNG SAHARI SELATAN, KEMAYORAN, JAKARTA PUSAT, DKI JAKARTA",3,128,93,221
https://kawalpemilu.org#25852,"GUNUNG SAHARI SELATAN, KEMAYORAN, JAKARTA PUSAT, DKI JAKARTA",4,177,57,234
https://kawalpemilu.org#25852,"GUNUNG SAHARI SELATAN, KEMAYORAN, JAKARTA PUSAT, DKI JAKARTA",5,183,73,256
https://kawalpemilu.org#25852,"GUNUNG SAHARI SELATAN, KEMAYORAN, JAKARTA PUSAT, DKI JAKARTA",7,122,93,215
https://kawalpemilu.org#25852,"GUNUNG SAHARI SELATAN, KEMAYORAN, JAKARTA PUSAT, DKI JAKARTA",9,151,76,227
https://kawalpemilu.org#25852,"GUNUNG SAHARI SELATAN, KEMAYORAN, JAKARTA PUSAT, DKI JAKARTA",10,122,91,213
https://kawalpemilu.org#25852,"GUNUNG SAHARI SELATAN, KEMAYORAN, JAKARTA PUSAT, DKI JAKARTA",12,117,109,226
https://kawalpemilu.org#25852,"GUNUNG SAHARI SELATAN, KEMAYORAN, JAKARTA PUSAT, DKI JAKARTA",13,118,77,195
https://kawalpemilu.org#25852,"GUNUNG SAHARI SELATAN, KEMAYORAN, JAKARTA PUSAT, DKI JAKARTA",14,143,89,232
https://kawalpemilu.org#25852,"GUNUNG SAHARI SELATAN, KEMAYORAN, JAKARTA PUSAT, DKI JAKARTA",15,148,77,225
https://kawalpemilu.org#25852,"GUNUNG SAHARI SELATAN, KEMAYORAN, JAKARTA PUSAT, DKI JAKARTA",16,167,59,226
https://kawalpemilu.org#25852,"GUNUNG SAHARI SELATAN, KEMAYORAN, JAKARTA PUSAT, DKI JAKARTA",17,105,144,249
https://kawalpemilu.org#25852,"GUNUNG SAHARI SELATAN, KEMAYORAN, JAKARTA PUSAT, DKI JAKARTA",18,103,118,221
https://kawalpemilu.org#25852,"GUNUNG SAHARI SELATAN, KEMAYORAN, JAKARTA PUSAT, DKI JAKARTA",19,142,65,207
https://kawalpemilu.org#25852,"GUNUNG SAHARI SELATAN, KEMAYORAN, JAKARTA PUSAT, DKI JAKARTA",20,153,55,208
https://kawalpemilu.org#25852,"GUNUNG SAHARI SELATAN, KEMAYORAN, JAKARTA PUSAT, DKI JAKARTA",21,118,116,234
https://kawalpemilu.org#25852,"GUNUNG SAHARI SELATAN, KEMAYORAN, JAKARTA PUSAT, DKI JAKARTA",22,127,105,232
https://kawalpemilu.org#25852,"GUNUNG SAHARI SELATAN, KEMAYORAN, JAKARTA PUSAT, DKI JAKARTA",23,104,119,223
https://kawalpemilu.org#25852,"GUNUNG SAHARI SELATAN, KEMAYORAN, JAKARTA PUSAT, DKI JAKARTA",24,108,113,221
https://kawalpemilu.org#25852,"GUNUNG SAHARI SELATAN, KEMAYORAN, JAKARTA PUSAT, DKI JAKARTA",25,47,141,188
https://kawalpemilu.org#25852,"GUNUNG SAHARI SELATAN, KEMAYORAN, JAKARTA PUSAT, DKI JAKARTA",26,101,98,199
https://kawalpemilu.org#25852,"GUNUNG SAHARI SELATAN, KEMAYORAN, JAKARTA PUSAT, DKI JAKARTA",27,126,76,202
https://kawalpemilu.org#25852,"GUNUNG SAHARI SELATAN, KEMAYORAN, JAKARTA PUSAT, DKI JAKARTA",28,101,63,164
https://kawalpemilu.org#25852,"GUNUNG SAHARI SELATAN, KEMAYORAN, JAKARTA PUSAT, DKI JAKARTA",29,83,89,172
https://kawalpemilu.org#25852,"GUNUNG SAHARI SELATAN, KEMAYORAN, JAKARTA PUSAT, DKI JAKARTA",30,103,73,176
https://kawalpemilu.org#25852,"GUNUNG SAHARI SELATAN, KEMAYORAN, JAKARTA PUSAT, DKI JAKARTA",31,91,83,174
https://kawalpemilu.org#25852,"GUNUNG SAHARI SELATAN, KEMAYORAN, JAKARTA PUSAT, DKI JAKARTA",32,160,37,197
https://kawalpemilu.org#25852,"GUNUNG SAHARI SELATAN, KEMAYORAN, JAKARTA PUSAT, DKI JAKARTA",33,180,51,231
https://kawalpemilu.org#25852,"GUNUNG SAHARI SELATAN, KEMAYORAN, JAKARTA PUSAT, DKI JAKARTA",34,117,92,209
https://kawalpemilu.org#25852,"GUNUNG SAHARI SELATAN, KEMAYORAN, JAKARTA PUSAT, DKI JAKARTA",36,119,108,227
https://kawalpemilu.org#25852,"GUNUNG SAHARI SELATAN, KEMAYORAN, JAKARTA PUSAT, DKI JAKARTA",37,117,53,170
https://kawalpemilu.org#25852,"GUNUNG SAHARI SELATAN, KEMAYORAN, JAKARTA PUSAT, DKI JAKARTA",38,112,57,169
https://kawalpemilu.org#25852,"GUNUNG SAHARI SELATAN, KEMAYORAN, JAKARTA PUSAT, DKI JAKARTA",39,143,91,234
https://kawalpemilu.org#25852,"GUNUNG SAHARI SELATAN, KEMAYORAN, JAKARTA PUSAT, DKI JAKARTA",41,135,79,214
https://kawalpemilu.org#25852,"GUNUNG SAHARI SELATAN, KEMAYORAN, JAKARTA PUSAT, DKI JAKARTA",42,134,87,221
https://kawalpemilu.org#25852,"GUNUNG SAHARI SELATAN, KEMAYORAN, JAKARTA PUSAT, DKI JAKARTA",44,172,53,225
https://kawalpemilu.org#25852,"GUNUNG SAHARI SELATAN, KEMAYORAN, JAKARTA PUSAT, DKI JAKARTA",45,125,92,217
https://kawalpemilu.org#25852,"GUNUNG SAHARI SELATAN, KEMAYORAN, JAKARTA PUSAT, DKI JAKARTA",46,90,94,184
https://kawalpemilu.org#25852,"GUNUNG SAHARI SELATAN, KEMAYORAN, JAKARTA PUSAT, DKI JAKARTA",47,162,73,235
https://kawalpemilu.org#25852,"GUNUNG SAHARI SELATAN, KEMAYORAN, JAKARTA PUSAT, DKI JAKARTA",48,113,104,217
https://kawalpemilu.org#25852,"GUNUNG SAHARI SELATAN, KEMAYORAN, JAKARTA PUSAT, DKI JAKARTA",49,172,21,193
https://kawalpemilu.org#25852,"GUNUNG SAHARI SELATAN, KEMAYORAN, JAKARTA PUSAT, DKI JAKARTA",50,180,23,203
https://kawalpemilu.org#25852,"GUNUNG SAHARI SELATAN, KEMAYORAN, JAKARTA PUSAT, DKI JAKARTA",51,129,25,204
https://kawalpemilu.org#25852,"GUNUNG SAHARI SELATAN, KEMAYORAN, JAKARTA PUSAT, DKI JAKARTA",52,108,107,215
https://kawalpemilu.org#25852,"GUNUNG SAHARI SELATAN, KEMAYORAN, JAKARTA PUSAT, DKI JAKARTA",53,157,57,214
https://kawalpemilu.org#25852,"GUNUNG SAHARI SELATAN, KEMAYORAN, JAKARTA PUSAT, DKI JAKARTA",54,176,45,221
https://kawalpemilu.org#25852,"GUNUNG SAHARI SELATAN, KEMAYORAN, JAKARTA PUSAT, DKI JAKARTA",55,145,40,185
https://kawalpemilu.org#25852,"GUNUNG SAHARI SELATAN, KEMAYORAN, JAKARTA PUSAT, DKI JAKARTA",56,156,10,166
https://kawalpemilu.org#25852,"GUNUNG SAHARI SELATAN, KEMAYORAN, JAKARTA PUSAT, DKI JAKARTA",57,138,76,214
https://kawalpemilu.org#25852,"GUNUNG SAHARI SELATAN, KEMAYORAN, JAKARTA PUSAT, DKI JAKARTA",58,145,89,234
https://kawalpemilu.org#25852,"GUNUNG SAHARI SELATAN, KEMAYORAN, JAKARTA PUSAT, DKI JAKARTA",59,116,122,238
https://kawalpemilu.org#25852,"GUNUNG SAHARI SELATAN, KEMAYORAN, JAKARTA PUSAT, DKI JAKARTA",60,78,131,209
https://kawalpemilu.org#25852,"GUNUNG SAHARI SELATAN, KEMAYORAN, JAKARTA PUSAT, DKI JAKARTA",61,145,101,246
https://kawalpemilu.org#25852,"GUNUNG SAHARI SELATAN, KEMAYORAN, JAKARTA PUSAT, DKI JAKARTA",62,106,107,213
https://kawalpemilu.org#25852,"GUNUNG SAHARI SELATAN, KEMAYORAN, JAKARTA PUSAT, DKI JAKARTA",63,111,140,251
https://kawalpemilu.org#25853,"CEMPAKA BARU, KEMAYORAN, JAKARTA PUSAT, DKI JAKARTA",1,115,125,240
https://kawalpemilu.org#25853,"CEMPAKA BARU, KEMAYORAN, JAKARTA PUSAT, DKI JAKARTA",2,113,123,236
https://kawalpemilu.org#25853,"CEMPAKA BARU, KEMAYORAN, JAKARTA PUSAT, DKI JAKARTA",3,139,105,244
https://kawalpemilu.org#25853,"CEMPAKA BARU, KEMAYORAN, JAKARTA PUSAT, DKI JAKARTA",4,104,120,224
https://kawalpemilu.org#25853,"CEMPAKA BARU, KEMAYORAN, JAKARTA PUSAT, DKI JAKARTA",5,139,90,229
https://kawalpemilu.org#25853,"CEMPAKA BARU, KEMAYORAN, JAKARTA PUSAT, DKI JAKARTA",6,118,113,231
https://kawalpemilu.org#25853,"CEMPAKA BARU, KEMAYORAN, JAKARTA PUSAT, DKI JAKARTA",8,74,141,215
https://kawalpemilu.org#25853,"CEMPAKA BARU, KEMAYORAN, JAKARTA PUSAT, DKI JAKARTA",9,83,121,204
https://kawalpemilu.org#25853,"CEMPAKA BARU, KEMAYORAN, JAKARTA PUSAT, DKI JAKARTA",10,126,97,223
https://kawalpemilu.org#25853,"CEMPAKA BARU, KEMAYORAN, JAKARTA PUSAT, DKI JAKARTA",11,88,138,226
https://kawalpemilu.org#25853,"CEMPAKA BARU, KEMAYORAN, JAKARTA PUSAT, DKI JAKARTA",12,112,97,209
https://kawalpemilu.org#25853,"CEMPAKA BARU, KEMAYORAN, JAKARTA PUSAT, DKI JAKARTA",13,96,152,248
https://kawalpemilu.org#25853,"CEMPAKA BARU, KEMAYORAN, JAKARTA PUSAT, DKI JAKARTA",14,103,110,213
https://kawalpemilu.org#25853,"CEMPAKA BARU, KEMAYORAN, JAKARTA PUSAT, DKI JAKARTA",15,81,110,191
https://kawalpemilu.org#25853,"CEMPAKA BARU, KEMAYORAN, JAKARTA PUSAT, DKI JAKARTA",16,106,117,223
https://kawalpemilu.org#25853,"CEMPAKA BARU, KEMAYORAN, JAKARTA PUSAT, DKI JAKARTA",17,76,102,178
https://kawalpemilu.org#25853,"CEMPAKA BARU, KEMAYORAN, JAKARTA PUSAT, DKI JAKARTA",18,94,123,217
https://kawalpemilu.org#25853,"CEMPAKA BARU, KEMAYORAN, JAKARTA PUSAT, DKI JAKARTA",19,110,102,212
https://kawalpemilu.org#25853,"CEMPAKA BARU, KEMAYORAN, JAKARTA PUSAT, DKI JAKARTA",20,113,136,249
https://kawalpemilu.org#25853,"CEMPAKA BARU, KEMAYORAN, JAKARTA PUSAT, DKI JAKARTA",21,106,127,233
https://kawalpemilu.org#25853,"CEMPAKA BARU, KEMAYORAN, JAKARTA PUSAT, DKI JAKARTA",22,98,139,237
https://kawalpemilu.org#25853,"CEMPAKA BARU, KEMAYORAN, JAKARTA PUSAT, DKI JAKARTA",23,135,122,257
https://kawalpemilu.org#25853,"CEMPAKA BARU, KEMAYORAN, JAKARTA PUSAT, DKI JAKARTA",24,106,95,201
https://kawalpemilu.org#25853,"CEMPAKA BARU, KEMAYORAN, JAKARTA PUSAT, DKI JAKARTA",25,90,137,227
https://kawalpemilu.org#25853,"CEMPAKA BARU, KEMAYORAN, JAKARTA PUSAT, DKI JAKARTA",26,94,95,189
https://kawalpemilu.org#25853,"CEMPAKA BARU, KEMAYORAN, JAKARTA PUSAT, DKI JAKARTA",27,125,104,229
https://kawalpemilu.org#25853,"CEMPAKA BARU, KEMAYORAN, JAKARTA PUSAT, DKI JAKARTA",28,103,140,243
https://kawalpemilu.org#25853,"CEMPAKA BARU, KEMAYORAN, JAKARTA PUSAT, DKI JAKARTA",29,113,124,237
https://kawalpemilu.org#25853,"CEMPAKA BARU, KEMAYORAN, JAKARTA PUSAT, DKI JAKARTA",30,132,101,233
https://kawalpemilu.org#25853,"CEMPAKA BARU, KEMAYORAN, JAKARTA PUSAT, DKI JAKARTA",31,116,94,210
https://kawalpemilu.org#25853,"CEMPAKA BARU, KEMAYORAN, JAKARTA PUSAT, DKI JAKARTA",32,107,109,216
https://kawalpemilu.org#25853,"CEMPAKA BARU, KEMAYORAN, JAKARTA PUSAT, DKI JAKARTA",33,98,119,217
https://kawalpemilu.org#25853,"CEMPAKA BARU, KEMAYORAN, JAKARTA PUSAT, DKI JAKARTA",34,78,137,215
https://kawalpemilu.org#25853,"CEMPAKA BARU, KEMAYORAN, JAKARTA PUSAT, DKI JAKARTA",35,180,45,225
https://kawalpemilu.org#25853,"CEMPAKA BARU, KEMAYORAN, JAKARTA PUSAT, DKI JAKARTA",36,126,98,224
https://kawalpemilu.org#25853,"CEMPAKA BARU, KEMAYORAN, JAKARTA PUSAT, DKI JAKARTA",37,172,68,240
https://kawalpemilu.org#25853,"CEMPAKA BARU, KEMAYORAN, JAKARTA PUSAT, DKI JAKARTA",38,81,152,233
https://kawalpemilu.org#25853,"CEMPAKA BARU, KEMAYORAN, JAKARTA PUSAT, DKI JAKARTA",39,117,132,249
https://kawalpemilu.org#25853,"CEMPAKA BARU, KEMAYORAN, JAKARTA PUSAT, DKI JAKARTA",40,105,125,230
https://kawalpemilu.org#25853,"CEMPAKA BARU, KEMAYORAN, JAKARTA PUSAT, DKI JAKARTA",41,107,122,229
https://kawalpemilu.org#25853,"CEMPAKA BARU, KEMAYORAN, JAKARTA PUSAT, DKI JAKARTA",42,107,123,230
https://kawalpemilu.org#25853,"CEMPAKA BARU, KEMAYORAN, JAKARTA PUSAT, DKI JAKARTA",43,75,167,242
https://kawalpemilu.org#25853,"CEMPAKA BARU, KEMAYORAN, JAKARTA PUSAT, DKI JAKARTA",44,116,131,247
https://kawalpemilu.org#25853,"CEMPAKA BARU, KEMAYORAN, JAKARTA PUSAT, DKI JAKARTA",45,119,100,219
https://kawalpemilu.org#25853,"CEMPAKA BARU, KEMAYORAN, JAKARTA PUSAT, DKI JAKARTA",46,129,124,253
https://kawalpemilu.org#25853,"CEMPAKA BARU, KEMAYORAN, JAKARTA PUSAT, DKI JAKARTA",47,116,115,231
https://kawalpemilu.org#25853,"CEMPAKA BARU, KEMAYORAN, JAKARTA PUSAT, DKI JAKARTA",48,128,102,230
https://kawalpemilu.org#25853,"CEMPAKA BARU, KEMAYORAN, JAKARTA PUSAT, DKI JAKARTA",49,169,45,214
https://kawalpemilu.org#25853,"CEMPAKA BARU, KEMAYORAN, JAKARTA PUSAT, DKI JAKARTA",50,196,30,226
https://kawalpemilu.org#25853,"CEMPAKA BARU, KEMAYORAN, JAKARTA PUSAT, DKI JAKARTA",51,109,115,224
https://kawalpemilu.org#25853,"CEMPAKA BARU, KEMAYORAN, JAKARTA PUSAT, DKI JAKARTA",52,112,133,245
https://kawalpemilu.org#25853,"CEMPAKA BARU, KEMAYORAN, JAKARTA PUSAT, DKI JAKARTA",53,146,89,235
https://kawalpemilu.org#25853,"CEMPAKA BARU, KEMAYORAN, JAKARTA PUSAT, DKI JAKARTA",54,131,95,226
https://kawalpemilu.org#25853,"CEMPAKA BARU, KEMAYORAN, JAKARTA PUSAT, DKI JAKARTA",55,130,100,230
https://kawalpemilu.org#25853,"CEMPAKA BARU, KEMAYORAN, JAKARTA PUSAT, DKI JAKARTA",56,98,144,242
https://kawalpemilu.org#25853,"CEMPAKA BARU, KEMAYORAN, JAKARTA PUSAT, DKI JAKARTA",57,126,124,250
https://kawalpemilu.org#25853,"CEMPAKA BARU, KEMAYORAN, JAKARTA PUSAT, DKI JAKARTA",58,107,118,225
https://kawalpemilu.org#25853,"CEMPAKA BARU, KEMAYORAN, JAKARTA PUSAT, DKI JAKARTA",59,118,128,246
https://kawalpemilu.org#25853,"CEMPAKA BARU, KEMAYORAN, JAKARTA PUSAT, DKI JAKARTA",60,146,109,255
https://kawalpemilu.org#25853,"CEMPAKA BARU, KEMAYORAN, JAKARTA PUSAT, DKI JAKARTA",61,124,104,228
https://kawalpemilu.org#25853,"CEMPAKA BARU, KEMAYORAN, JAKARTA PUSAT, DKI JAKARTA",62,85,150,235
https://kawalpemilu.org#25853,"CEMPAKA BARU, KEMAYORAN, JAKARTA PUSAT, DKI JAKARTA",63,129,123,252
https://kawalpemilu.org#25853,"CEMPAKA BARU, KEMAYORAN, JAKARTA PUSAT, DKI JAKARTA",64,97,124,220
https://kawalpemilu.org#25853,"CEMPAKA BARU, KEMAYORAN, JAKARTA PUSAT, DKI JAKARTA",65,136,132,268
https://kawalpemilu.org#25853,"CEMPAKA BARU, KEMAYORAN, JAKARTA PUSAT, DKI JAKARTA",66,130,83,213
https://kawalpemilu.org#25853,"CEMPAKA BARU, KEMAYORAN, JAKARTA PUSAT, DKI JAKARTA",67,143,65,208
https://kawalpemilu.org#25853,"CEMPAKA BARU, KEMAYORAN, JAKARTA PUSAT, DKI JAKARTA",68,119,92,211
https://kawalpemilu.org#25853,"CEMPAKA BARU, KEMAYORAN, JAKARTA PUSAT, DKI JAKARTA",69,113,104,217
https://kawalpemilu.org#25853,"CEMPAKA BARU, KEMAYORAN, JAKARTA PUSAT, DKI JAKARTA",70,129,91,220
https://kawalpemilu.org#25853,"CEMPAKA BARU, KEMAYORAN, JAKARTA PUSAT, DKI JAKARTA",71,125,117,242
https://kawalpemilu.org#25853,"CEMPAKA BARU, KEMAYORAN, JAKARTA PUSAT, DKI JAKARTA",72,111,124,235
https://kawalpemilu.org#25853,"CEMPAKA BARU, KEMAYORAN, JAKARTA PUSAT, DKI JAKARTA",74,105,132,237
https://kawalpemilu.org#25853,"CEMPAKA BARU, KEMAYORAN, JAKARTA PUSAT, DKI JAKARTA",76,95,138,233
https://kawalpemilu.org#25853,"CEMPAKA BARU, KEMAYORAN, JAKARTA PUSAT, DKI JAKARTA",78,108,156,264
https://kawalpemilu.org#25853,"CEMPAKA BARU, KEMAYORAN, JAKARTA PUSAT, DKI JAKARTA",79,126,153,279
https://kawalpemilu.org#25853,"CEMPAKA BARU, KEMAYORAN, JAKARTA PUSAT, DKI JAKARTA",80,99,140,239
https://kawalpemilu.org#25853,"CEMPAKA BARU, KEMAYORAN, JAKARTA PUSAT, DKI JAKARTA",81,89,152,241
https://kawalpemilu.org#25853,"CEMPAKA BARU, KEMAYORAN, JAKARTA PUSAT, DKI JAKARTA",82,125,99,224
https://kawalpemilu.org#25853,"CEMPAKA BARU, KEMAYORAN, JAKARTA PUSAT, DKI JAKARTA",83,121,106,227
https://kawalpemilu.org#25853,"CEMPAKA BARU, KEMAYORAN, JAKARTA PUSAT, DKI JAKARTA",84,126,93,219
https://kawalpemilu.org#25853,"CEMPAKA BARU, KEMAYORAN, JAKARTA PUSAT, DKI JAKARTA",86,81,125,206
https://kawalpemilu.org#25853,"CEMPAKA BARU, KEMAYORAN, JAKARTA PUSAT, DKI JAKARTA",87,104,130,234
https://kawalpemilu.org#25853,"CEMPAKA BARU, KEMAYORAN, JAKARTA PUSAT, DKI JAKARTA",88,82,143,225
https://kawalpemilu.org#25853,"CEMPAKA BARU, KEMAYORAN, JAKARTA PUSAT, DKI JAKARTA",89,90,146,236
https://kawalpemilu.org#25853,"CEMPAKA BARU, KEMAYORAN, JAKARTA PUSAT, DKI JAKARTA",90,97,100,197
https://kawalpemilu.org#25853,"CEMPAKA BARU, KEMAYORAN, JAKARTA PUSAT, DKI JAKARTA",91,113,122,235
https://kawalpemilu.org#25853,"CEMPAKA BARU, KEMAYORAN, JAKARTA PUSAT, DKI JAKARTA",92,90,138,228
https://kawalpemilu.org#25853,"CEMPAKA BARU, KEMAYORAN, JAKARTA PUSAT, DKI JAKARTA",93,94,140,234
https://kawalpemilu.org#25853,"CEMPAKA BARU, KEMAYORAN, JAKARTA PUSAT, DKI JAKARTA",95,117,109,226
https://kawalpemilu.org#25853,"CEMPAKA BARU, KEMAYORAN, JAKARTA PUSAT, DKI JAKARTA",96,122,105,227
https://kawalpemilu.org#25853,"CEMPAKA BARU, KEMAYORAN, JAKARTA PUSAT, DKI JAKARTA",97,95,131,226
https://kawalpemilu.org#25853,"CEMPAKA BARU, KEMAYORAN, JAKARTA PUSAT, DKI JAKARTA",98,121,111,232
https://kawalpemilu.org#25853,"CEMPAKA BARU, KEMAYORAN, JAKARTA PUSAT, DKI JAKARTA",99,94,105,199
https://kawalpemilu.org#25853,"CEMPAKA BARU, KEMAYORAN, JAKARTA PUSAT, DKI JAKARTA",100,101,98,199
https://kawalpemilu.org#25853,"CEMPAKA BARU, KEMAYORAN, JAKARTA PUSAT, DKI JAKARTA",101,107,133,240
https://kawalpemilu.org#25853,"CEMPAKA BARU, KEMAYORAN, JAKARTA PUSAT, DKI JAKARTA",103,82,131,213
https://kawalpemilu.org#25853,"CEMPAKA BARU, KEMAYORAN, JAKARTA PUSAT, DKI JAKARTA",104,102,112,214
https://kawalpemilu.org#25854,"SUMUR BATU, KEMAYORAN, JAKARTA PUSAT, DKI JAKARTA",1,132,77,209
https://kawalpemilu.org#25854,"SUMUR BATU, KEMAYORAN, JAKARTA PUSAT, DKI JAKARTA",3,108,131,239
https://kawalpemilu.org#25854,"SUMUR BATU, KEMAYORAN, JAKARTA PUSAT, DKI JAKARTA",4,88,117,205
https://kawalpemilu.org#25854,"SUMUR BATU, KEMAYORAN, JAKARTA PUSAT, DKI JAKARTA",6,136,96,232
https://kawalpemilu.org#25854,"SUMUR BATU, KEMAYORAN, JAKARTA PUSAT, DKI JAKARTA",7,140,95,235
https://kawalpemilu.org#25854,"SUMUR BATU, KEMAYORAN, JAKARTA PUSAT, DKI JAKARTA",8,96,112,208
https://kawalpemilu.org#25854,"SUMUR BATU, KEMAYORAN, JAKARTA PUSAT, DKI JAKARTA",9,106,121,227
https://kawalpemilu.org#25854,"SUMUR BATU, KEMAYORAN, JAKARTA PUSAT, DKI JAKARTA",10,121,128,249
https://kawalpemilu.org#25854,"SUMUR BATU, KEMAYORAN, JAKARTA PUSAT, DKI JAKARTA",11,95,118,213
https://kawalpemilu.org#25854,"SUMUR BATU, KEMAYORAN, JAKARTA PUSAT, DKI JAKARTA",12,119,122,241
https://kawalpemilu.org#25854,"SUMUR BATU, KEMAYORAN, JAKARTA PUSAT, DKI JAKARTA",13,131,104,235
https://kawalpemilu.org#25854,"SUMUR BATU, KEMAYORAN, JAKARTA PUSAT, DKI JAKARTA",14,123,122,245
https://kawalpemilu.org#25854,"SUMUR BATU, KEMAYORAN, JAKARTA PUSAT, DKI JAKARTA",15,103,103,206
https://kawalpemilu.org#25854,"SUMUR BATU, KEMAYORAN, JAKARTA PUSAT, DKI JAKARTA",17,112,110,222
https://kawalpemilu.org#25854,"SUMUR BATU, KEMAYORAN, JAKARTA PUSAT, DKI JAKARTA",18,154,68,222
https://kawalpemilu.org#25854,"SUMUR BATU, KEMAYORAN, JAKARTA PUSAT, DKI JAKARTA",19,128,96,224
https://kawalpemilu.org#25854,"SUMUR BATU, KEMAYORAN, JAKARTA PUSAT, DKI JAKARTA",20,105,107,212
https://kawalpemilu.org#25854,"SUMUR BATU, KEMAYORAN, JAKARTA PUSAT, DKI JAKARTA",21,129,74,203
https://kawalpemilu.org#25854,"SUMUR BATU, KEMAYORAN, JAKARTA PUSAT, DKI JAKARTA",22,113,82,195
https://kawalpemilu.org#25854,"SUMUR BATU, KEMAYORAN, JAKARTA PUSAT, DKI JAKARTA",23,147,85,232
https://kawalpemilu.org#25854,"SUMUR BATU, KEMAYORAN, JAKARTA PUSAT, DKI JAKARTA",24,106,121,227
https://kawalpemilu.org#25854,"SUMUR BATU, KEMAYORAN, JAKARTA PUSAT, DKI JAKARTA",25,117,104,221
https://kawalpemilu.org#25854,"SUMUR BATU, KEMAYORAN, JAKARTA PUSAT, DKI JAKARTA",26,114,111,225
https://kawalpemilu.org#25854,"SUMUR BATU, KEMAYORAN, JAKARTA PUSAT, DKI JAKARTA",27,126,76,202
https://kawalpemilu.org#25854,"SUMUR BATU, KEMAYORAN, JAKARTA PUSAT, DKI JAKARTA",28,124,104,228
https://kawalpemilu.org#25854,"SUMUR BATU, KEMAYORAN, JAKARTA PUSAT, DKI JAKARTA",29,116,121,237
https://kawalpemilu.org#25854,"SUMUR BATU, KEMAYORAN, JAKARTA PUSAT, DKI JAKARTA",30,77,150,227
https://kawalpemilu.org#25854,"SUMUR BATU, KEMAYORAN, JAKARTA PUSAT, DKI JAKARTA",31,114,102,216
https://kawalpemilu.org#25854,"SUMUR BATU, KEMAYORAN, JAKARTA PUSAT, DKI JAKARTA",32,123,116,239
https://kawalpemilu.org#25854,"SUMUR BATU, KEMAYORAN, JAKARTA PUSAT, DKI JAKARTA",33,123,115,238
https://kawalpemilu.org#25854,"SUMUR BATU, KEMAYORAN, JAKARTA PUSAT, DKI JAKARTA",34,100,139,239
https://kawalpemilu.org#25854,"SUMUR BATU, KEMAYORAN, JAKARTA PUSAT, DKI JAKARTA",35,113,129,242
https://kawalpemilu.org#25854,"SUMUR BATU, KEMAYORAN, JAKARTA PUSAT, DKI JAKARTA",36,110,107,217
https://kawalpemilu.org#25854,"SUMUR BATU, KEMAYORAN, JAKARTA PUSAT, DKI JAKARTA",37,117,115,232
https://kawalpemilu.org#25854,"SUMUR BATU, KEMAYORAN, JAKARTA PUSAT, DKI JAKARTA",39,86,133,219
https://kawalpemilu.org#25854,"SUMUR BATU, KEMAYORAN, JAKARTA PUSAT, DKI JAKARTA",40,109,113,222
https://kawalpemilu.org#25854,"SUMUR BATU, KEMAYORAN, JAKARTA PUSAT, DKI JAKARTA",41,148,95,243
https://kawalpemilu.org#25854,"SUMUR BATU, KEMAYORAN, JAKARTA PUSAT, DKI JAKARTA",42,136,100,236
https://kawalpemilu.org#25854,"SUMUR BATU, KEMAYORAN, JAKARTA PUSAT, DKI JAKARTA",44,144,84,228
https://kawalpemilu.org#25854,"SUMUR BATU, KEMAYORAN, JAKARTA PUSAT, DKI JAKARTA",45,126,87,213
https://kawalpemilu.org#25854,"SUMUR BATU, KEMAYORAN, JAKARTA PUSAT, DKI JAKARTA",46,47,161,208
https://kawalpemilu.org#25854,"SUMUR BATU, KEMAYORAN, JAKARTA PUSAT, DKI JAKARTA",47,77,77,154
https://kawalpemilu.org#25854,"SUMUR BATU, KEMAYORAN, JAKARTA PUSAT, DKI JAKARTA",48,68,89,157
https://kawalpemilu.org#25854,"SUMUR BATU, KEMAYORAN, JAKARTA PUSAT, DKI JAKARTA",49,100,84,184
https://kawalpemilu.org#25854,"SUMUR BATU, KEMAYORAN, JAKARTA PUSAT, DKI JAKARTA",51,139,63,202
https://kawalpemilu.org#25854,"SUMUR BATU, KEMAYORAN, JAKARTA PUSAT, DKI JAKARTA",52,104,87,191
https://kawalpemilu.org#25854,"SUMUR BATU, KEMAYORAN, JAKARTA PUSAT, DKI JAKARTA",53,113,133,246
https://kawalpemilu.org#25854,"SUMUR BATU, KEMAYORAN, JAKARTA PUSAT, DKI JAKARTA",54,101,140,241
https://kawalpemilu.org#25854,"SUMUR BATU, KEMAYORAN, JAKARTA PUSAT, DKI JAKARTA",56,87,107,194
https://kawalpemilu.org#25854,"SUMUR BATU, KEMAYORAN, JAKARTA PUSAT, DKI JAKARTA",57,113,72,185
https://kawalpemilu.org#25854,"SUMUR BATU, KEMAYORAN, JAKARTA PUSAT, DKI JAKARTA",58,95,98,193
https://kawalpemilu.org#25854,"SUMUR BATU, KEMAYORAN, JAKARTA PUSAT, DKI JAKARTA",59,102,128,230
https://kawalpemilu.org#25854,"SUMUR BATU, KEMAYORAN, JAKARTA PUSAT, DKI JAKARTA",60,139,98,237
https://kawalpemilu.org#25854,"SUMUR BATU, KEMAYORAN, JAKARTA PUSAT, DKI JAKARTA",62,107,143,250
https://kawalpemilu.org#25854,"SUMUR BATU, KEMAYORAN, JAKARTA PUSAT, DKI JAKARTA",63,101,98,199
https://kawalpemilu.org#25854,"SUMUR BATU, KEMAYORAN, JAKARTA PUSAT, DKI JAKARTA",64,103,136,239
https://kawalpemilu.org#25854,"SUMUR BATU, KEMAYORAN, JAKARTA PUSAT, DKI JAKARTA",65,152,86,238
https://kawalpemilu.org#25854,"SUMUR BATU, KEMAYORAN, JAKARTA PUSAT, DKI JAKARTA",67,104,97,201
https://kawalpemilu.org#25854,"SUMUR BATU, KEMAYORAN, JAKARTA PUSAT, DKI JAKARTA",68,121,134,255
https://kawalpemilu.org#25854,"SUMUR BATU, KEMAYORAN, JAKARTA PUSAT, DKI JAKARTA",69,127,92,219
https://kawalpemilu.org#25854,"SUMUR BATU, KEMAYORAN, JAKARTA PUSAT, DKI JAKARTA",70,121,98,219
https://kawalpemilu.org#25854,"SUMUR BATU, KEMAYORAN, JAKARTA PUSAT, DKI JAKARTA",71,84,111,195
https://kawalpemilu.org#25854,"SUMUR BATU, KEMAYORAN, JAKARTA PUSAT, DKI JAKARTA",72,87,134,221
https://kawalpemilu.org#25854,"SUMUR BATU, KEMAYORAN, JAKARTA PUSAT, DKI JAKARTA",73,155,42,197
https://kawalpemilu.org#25854,"SUMUR BATU, KEMAYORAN, JAKARTA PUSAT, DKI JAKARTA",74,211,41,252
https://kawalpemilu.org#25854,"SUMUR BATU, KEMAYORAN, JAKARTA PUSAT, DKI JAKARTA",75,192,35,227
https://kawalpemilu.org#25855,"UTAN PANJANG, KEMAYORAN, JAKARTA PUSAT, DKI JAKARTA",1,94,99,193
https://kawalpemilu.org#25855,"UTAN PANJANG, KEMAYORAN, JAKARTA PUSAT, DKI JAKARTA",2,123,103,226
https://kawalpemilu.org#25855,"UTAN PANJANG, KEMAYORAN, JAKARTA PUSAT, DKI JAKARTA",3,118,115,233
https://kawalpemilu.org#25855,"UTAN PANJANG, KEMAYORAN, JAKARTA PUSAT, DKI JAKARTA",4,137,106,243
https://kawalpemilu.org#25855,"UTAN PANJANG, KEMAYORAN, JAKARTA PUSAT, DKI JAKARTA",5,119,109,228
https://kawalpemilu.org#25855,"UTAN PANJANG, KEMAYORAN, JAKARTA PUSAT, DKI JAKARTA",6,125,120,245
https://kawalpemilu.org#25855,"UTAN PANJANG, KEMAYORAN, JAKARTA PUSAT, DKI JAKARTA",7,107,119,226
https://kawalpemilu.org#25855,"UTAN PANJANG, KEMAYORAN, JAKARTA PUSAT, DKI JAKARTA",8,107,120,227
https://kawalpemilu.org#25855,"UTAN PANJANG, KEMAYORAN, JAKARTA PUSAT, DKI JAKARTA",10,95,108,203
https://kawalpemilu.org#25855,"UTAN PANJANG, KEMAYORAN, JAKARTA PUSAT, DKI JAKARTA",11,95,141,236
https://kawalpemilu.org#25855,"UTAN PANJANG, KEMAYORAN, JAKARTA PUSAT, DKI JAKARTA",12,95,115,210
https://kawalpemilu.org#25855,"UTAN PANJANG, KEMAYORAN, JAKARTA PUSAT, DKI JAKARTA",13,127,89,216
https://kawalpemilu.org#25855,"UTAN PANJANG, KEMAYORAN, JAKARTA PUSAT, DKI JAKARTA",16,109,111,220
https://kawalpemilu.org#25855,"UTAN PANJANG, KEMAYORAN, JAKARTA PUSAT, DKI JAKARTA",18,105,88,193
https://kawalpemilu.org#25855,"UTAN PANJANG, KEMAYORAN, JAKARTA PUSAT, DKI JAKARTA",19,91,136,227
https://kawalpemilu.org#25855,"UTAN PANJANG, KEMAYORAN, JAKARTA PUSAT, DKI JAKARTA",20,71,130,201
https://kawalpemilu.org#25855,"UTAN PANJANG, KEMAYORAN, JAKARTA PUSAT, DKI JAKARTA",21,72,109,181
https://kawalpemilu.org#25855,"UTAN PANJANG, KEMAYORAN, JAKARTA PUSAT, DKI JAKARTA",22,89,95,184
https://kawalpemilu.org#25855,"UTAN PANJANG, KEMAYORAN, JAKARTA PUSAT, DKI JAKARTA",23,82,80,162
https://kawalpemilu.org#25855,"UTAN PANJANG, KEMAYORAN, JAKARTA PUSAT, DKI JAKARTA",24,80,114,194
https://kawalpemilu.org#25855,"UTAN PANJANG, KEMAYORAN, JAKARTA PUSAT, DKI JAKARTA",25,138,97,235
https://kawalpemilu.org#25855,"UTAN PANJANG, KEMAYORAN, JAKARTA PUSAT, DKI JAKARTA",26,89,147,236
https://kawalpemilu.org#25855,"UTAN PANJANG, KEMAYORAN, JAKARTA PUSAT, DKI JAKARTA",27,98,114,212
https://kawalpemilu.org#25855,"UTAN PANJANG, KEMAYORAN, JAKARTA PUSAT, DKI JAKARTA",29,76,117,193
https://kawalpemilu.org#25855,"UTAN PANJANG, KEMAYORAN, JAKARTA PUSAT, DKI JAKARTA",30,81,129,210
https://kawalpemilu.org#25855,"UTAN PANJANG, KEMAYORAN, JAKARTA PUSAT, DKI JAKARTA",31,102,106,208
https://kawalpemilu.org#25855,"UTAN PANJANG, KEMAYORAN, JAKARTA PUSAT, DKI JAKARTA",32,130,78,208
https://kawalpemilu.org#25855,"UTAN PANJANG, KEMAYORAN, JAKARTA PUSAT, DKI JAKARTA",33,102,119,221
https://kawalpemilu.org#25855,"UTAN PANJANG, KEMAYORAN, JAKARTA PUSAT, DKI JAKARTA",35,94,120,214
https://kawalpemilu.org#25855,"UTAN PANJANG, KEMAYORAN, JAKARTA PUSAT, DKI JAKARTA",36,72,160,232
https://kawalpemilu.org#25855,"UTAN PANJANG, KEMAYORAN, JAKARTA PUSAT, DKI JAKARTA",38,81,140,221
https://kawalpemilu.org#25855,"UTAN PANJANG, KEMAYORAN, JAKARTA PUSAT, DKI JAKARTA",39,97,129,226
https://kawalpemilu.org#25855,"UTAN PANJANG, KEMAYORAN, JAKARTA PUSAT, DKI JAKARTA",41,105,108,213
https://kawalpemilu.org#25855,"UTAN PANJANG, KEMAYORAN, JAKARTA PUSAT, DKI JAKARTA",42,125,113,238
https://kawalpemilu.org#25855,"UTAN PANJANG, KEMAYORAN, JAKARTA PUSAT, DKI JAKARTA",43,89,102,191
https://kawalpemilu.org#25855,"UTAN PANJANG, KEMAYORAN, JAKARTA PUSAT, DKI JAKARTA",44,101,81,182
https://kawalpemilu.org#25855,"UTAN PANJANG, KEMAYORAN, JAKARTA PUSAT, DKI JAKARTA",45,87,96,183
https://kawalpemilu.org#25855,"UTAN PANJANG, KEMAYORAN, JAKARTA PUSAT, DKI JAKARTA",46,97,130,227
https://kawalpemilu.org#25855,"UTAN PANJANG, KEMAYORAN, JAKARTA PUSAT, DKI JAKARTA",47,107,116,223
https://kawalpemilu.org#25855,"UTAN PANJANG, KEMAYORAN, JAKARTA PUSAT, DKI JAKARTA",48,79,131,210
https://kawalpemilu.org#25855,"UTAN PANJANG, KEMAYORAN, JAKARTA PUSAT, DKI JAKARTA",49,115,116,231
https://kawalpemilu.org#25855,"UTAN PANJANG, KEMAYORAN, JAKARTA PUSAT, DKI JAKARTA",50,125,97,222
https://kawalpemilu.org#25855,"UTAN PANJANG, KEMAYORAN, JAKARTA PUSAT, DKI JAKARTA",51,90,115,205
https://kawalpemilu.org#25855,"UTAN PANJANG, KEMAYORAN, JAKARTA PUSAT, DKI JAKARTA",52,84,140,224
https://kawalpemilu.org#25855,"UTAN PANJANG, KEMAYORAN, JAKARTA PUSAT, DKI JAKARTA",53,83,135,218
https://kawalpemilu.org#25855,"UTAN PANJANG, KEMAYORAN, JAKARTA PUSAT, DKI JAKARTA",54,81,124,205
https://kawalpemilu.org#25855,"UTAN PANJANG, KEMAYORAN, JAKARTA PUSAT, DKI JAKARTA",55,99,130,229
https://kawalpemilu.org#25855,"UTAN PANJANG, KEMAYORAN, JAKARTA PUSAT, DKI JAKARTA",56,108,110,218
https://kawalpemilu.org#25855,"UTAN PANJANG, KEMAYORAN, JAKARTA PUSAT, DKI JAKARTA",57,88,139,222
https://kawalpemilu.org#25855,"UTAN PANJANG, KEMAYORAN, JAKARTA PUSAT, DKI JAKARTA",58,63,167,230
https://kawalpemilu.org#25855,"UTAN PANJANG, KEMAYORAN, JAKARTA PUSAT, DKI JAKARTA",59,97,133,230
https://kawalpemilu.org#25855,"UTAN PANJANG, KEMAYORAN, JAKARTA PUSAT, DKI JAKARTA",60,92,139,231
https://kawalpemilu.org#25855,"UTAN PANJANG, KEMAYORAN, JAKARTA PUSAT, DKI JAKARTA",61,118,105,223
https://kawalpemilu.org#25855,"UTAN PANJANG, KEMAYORAN, JAKARTA PUSAT, DKI JAKARTA",62,106,112,218
https://kawalpemilu.org#25855,"UTAN PANJANG, KEMAYORAN, JAKARTA PUSAT, DKI JAKARTA",63,89,127,216
https://kawalpemilu.org#25855,"UTAN PANJANG, KEMAYORAN, JAKARTA PUSAT, DKI JAKARTA",64,94,122,216
https://kawalpemilu.org#25855,"UTAN PANJANG, KEMAYORAN, JAKARTA PUSAT, DKI JAKARTA",65,67,140,207
https://kawalpemilu.org#25855,"UTAN PANJANG, KEMAYORAN, JAKARTA PUSAT, DKI JAKARTA",66,78,151,229
https://kawalpemilu.org#25855,"UTAN PANJANG, KEMAYORAN, JAKARTA PUSAT, DKI JAKARTA",67,86,151,237
https://kawalpemilu.org#25855,"UTAN PANJANG, KEMAYORAN, JAKARTA PUSAT, DKI JAKARTA",68,89,128,217
https://kawalpemilu.org#25855,"UTAN PANJANG, KEMAYORAN, JAKARTA PUSAT, DKI JAKARTA",69,77,149,226
https://kawalpemilu.org#25855,"UTAN PANJANG, KEMAYORAN, JAKARTA PUSAT, DKI JAKARTA",70,77,121,198
https://kawalpemilu.org#25855,"UTAN PANJANG, KEMAYORAN, JAKARTA PUSAT, DKI JAKARTA",71,115,104,219
https://kawalpemilu.org#25855,"UTAN PANJANG, KEMAYORAN, JAKARTA PUSAT, DKI JAKARTA",72,96,88,184
https://kawalpemilu.org#25855,"UTAN PANJANG, KEMAYORAN, JAKARTA PUSAT, DKI JAKARTA",73,69,139,208
https://kawalpemilu.org#25855,"UTAN PANJANG, KEMAYORAN, JAKARTA PUSAT, DKI JAKARTA",74,84,104,188
https://kawalpemilu.org#25855,"UTAN PANJANG, KEMAYORAN, JAKARTA PUSAT, DKI JAKARTA",75,76,120,196
https://kawalpemilu.org#25855,"UTAN PANJANG, KEMAYORAN, JAKARTA PUSAT, DKI JAKARTA",76,132,84,216
https://kawalpemilu.org#25855,"UTAN PANJANG, KEMAYORAN, JAKARTA PUSAT, DKI JAKARTA",77,84,121,205
https://kawalpemilu.org#25855,"UTAN PANJANG, KEMAYORAN, JAKARTA PUSAT, DKI JAKARTA",78,100,121,221
https://kawalpemilu.org#25855,"UTAN PANJANG, KEMAYORAN, JAKARTA PUSAT, DKI JAKARTA",79,92,111,203
https://kawalpemilu.org#25855,"UTAN PANJANG, KEMAYORAN, JAKARTA PUSAT, DKI JAKARTA",80,110,122,232
https://kawalpemilu.org#25855,"UTAN PANJANG, KEMAYORAN, JAKARTA PUSAT, DKI JAKARTA",81,82,133,215
https://kawalpemilu.org#25855,"UTAN PANJANG, KEMAYORAN, JAKARTA PUSAT, DKI JAKARTA",82,86,104,190
https://kawalpemilu.org#25855,"UTAN PANJANG, KEMAYORAN, JAKARTA PUSAT, DKI JAKARTA",83,116,91,207
https://kawalpemilu.org#25855,"UTAN PANJANG, KEMAYORAN, JAKARTA PUSAT, DKI JAKARTA",84,90,122,212
https://kawalpemilu.org#25855,"UTAN PANJANG, KEMAYORAN, JAKARTA PUSAT, DKI JAKARTA",85,99,85,184
https://kawalpemilu.org#25855,"UTAN PANJANG, KEMAYORAN, JAKARTA PUSAT, DKI JAKARTA",86,81,120,201
https://kawalpemilu.org#25855,"UTAN PANJANG, KEMAYORAN, JAKARTA PUSAT, DKI JAKARTA",87,74,117,191
https://kawalpemilu.org#25855,"UTAN PANJANG, KEMAYORAN, JAKARTA PUSAT, DKI JAKARTA",88,59,118,177
https://kawalpemilu.org#25855,"UTAN PANJANG, KEMAYORAN, JAKARTA PUSAT, DKI JAKARTA",89,66,113,179
https://kawalpemilu.org#25855,"UTAN PANJANG, KEMAYORAN, JAKARTA PUSAT, DKI JAKARTA",90,42,163,205
https://kawalpemilu.org#25855,"UTAN PANJANG, KEMAYORAN, JAKARTA PUSAT, DKI JAKARTA",91,66,137,203
https://kawalpemilu.org#25855,"UTAN PANJANG, KEMAYORAN, JAKARTA PUSAT, DKI JAKARTA",92,66,158,224
https://kawalpemilu.org#25855,"UTAN PANJANG, KEMAYORAN, JAKARTA PUSAT, DKI JAKARTA",93,67,158,225
https://kawalpemilu.org#25855,"UTAN PANJANG, KEMAYORAN, JAKARTA PUSAT, DKI JAKARTA",94,84,145,229
https://kawalpemilu.org#25855,"UTAN PANJANG, KEMAYORAN, JAKARTA PUSAT, DKI JAKARTA",95,96,154,250
https://kawalpemilu.org#25855,"UTAN PANJANG, KEMAYORAN, JAKARTA PUSAT, DKI JAKARTA",96,79,159,238
https://kawalpemilu.org#25857,"SENEN, SENEN, JAKARTA PUSAT, DKI JAKARTA",1,109,91,200
https://kawalpemilu.org#25857,"SENEN, SENEN, JAKARTA PUSAT, DKI JAKARTA",2,162,25,187
https://kawalpemilu.org#25857,"SENEN, SENEN, JAKARTA PUSAT, DKI JAKARTA",3,156,63,219
https://kawalpemilu.org#25857,"SENEN, SENEN, JAKARTA PUSAT, DKI JAKARTA",4,205,29,234
https://kawalpemilu.org#25857,"SENEN, SENEN, JAKARTA PUSAT, DKI JAKARTA",5,164,71,235
https://kawalpemilu.org#25857,"SENEN, SENEN, JAKARTA PUSAT, DKI JAKARTA",6,162,33,195
https://kawalpemilu.org#25857,"SENEN, SENEN, JAKARTA PUSAT, DKI JAKARTA",8,134,97,231
https://kawalpemilu.org#25857,"SENEN, SENEN, JAKARTA PUSAT, DKI JAKARTA",9,160,35,195
https://kawalpemilu.org#25857,"SENEN, SENEN, JAKARTA PUSAT, DKI JAKARTA",10,75,153,228
https://kawalpemilu.org#25857,"SENEN, SENEN, JAKARTA PUSAT, DKI JAKARTA",11,142,71,213
https://kawalpemilu.org#25857,"SENEN, SENEN, JAKARTA PUSAT, DKI JAKARTA",13,96,107,203
https://kawalpemilu.org#25857,"SENEN, SENEN, JAKARTA PUSAT, DKI JAKARTA",15,116,20,136
https://kawalpemilu.org#25857,"SENEN, SENEN, JAKARTA PUSAT, DKI JAKARTA",16,31,164,195
https://kawalpemilu.org#25857,"SENEN, SENEN, JAKARTA PUSAT, DKI JAKARTA",17,14,172,186
https://kawalpemilu.org#25857,"SENEN, SENEN, JAKARTA PUSAT, DKI JAKARTA",18,165,34,199
https://kawalpemilu.org#25857,"SENEN, SENEN, JAKARTA PUSAT, DKI JAKARTA",19,137,37,174
https://kawalpemilu.org#25857,"SENEN, SENEN, JAKARTA PUSAT, DKI JAKARTA",20,146,51,197
https://kawalpemilu.org#25857,"SENEN, SENEN, JAKARTA PUSAT, DKI JAKARTA",21,137,51,188
https://kawalpemilu.org#25857,"SENEN, SENEN, JAKARTA PUSAT, DKI JAKARTA",22,141,39,180
https://kawalpemilu.org#25857,"SENEN, SENEN, JAKARTA PUSAT, DKI JAKARTA",23,91,93,184
https://kawalpemilu.org#25858,"KENARI, SENEN, JAKARTA PUSAT, DKI JAKARTA",1,137,82,219
https://kawalpemilu.org#25858,"KENARI, SENEN, JAKARTA PUSAT, DKI JAKARTA",2,213,16,229
https://kawalpemilu.org#25858,"KENARI, SENEN, JAKARTA PUSAT, DKI JAKARTA",3,184,14,198
https://kawalpemilu.org#25858,"KENARI, SENEN, JAKARTA PUSAT, DKI JAKARTA",4,85,68,153
https://kawalpemilu.org#25858,"KENARI, SENEN, JAKARTA PUSAT, DKI JAKARTA",5,132,45,177
https://kawalpemilu.org#25858,"KENARI, SENEN, JAKARTA PUSAT, DKI JAKARTA",6,156,45,201
https://kawalpemilu.org#25858,"KENARI, SENEN, JAKARTA PUSAT, DKI JAKARTA",7,82,149,231
https://kawalpemilu.org#25858,"KENARI, SENEN, JAKARTA PUSAT, DKI JAKARTA",8,129,108,237
https://kawalpemilu.org#25858,"KENARI, SENEN, JAKARTA PUSAT, DKI JAKARTA",9,110,135,245
https://kawalpemilu.org#25858,"KENARI, SENEN, JAKARTA PUSAT, DKI JAKARTA",11,69,144,213
https://kawalpemilu.org#25858,"KENARI, SENEN, JAKARTA PUSAT, DKI JAKARTA",13,53,134,187
https://kawalpemilu.org#25858,"KENARI, SENEN, JAKARTA PUSAT, DKI JAKARTA",14,73,141,214
https://kawalpemilu.org#25858,"KENARI, SENEN, JAKARTA PUSAT, DKI JAKARTA",15,55,174,229
https://kawalpemilu.org#25858,"KENARI, SENEN, JAKARTA PUSAT, DKI JAKARTA",16,66,176,242
https://kawalpemilu.org#25858,"KENARI, SENEN, JAKARTA PUSAT, DKI JAKARTA",17,104,146,250
https://kawalpemilu.org#25858,"KENARI, SENEN, JAKARTA PUSAT, DKI JAKARTA",18,74,166,240
https://kawalpemilu.org#25858,"KENARI, SENEN, JAKARTA PUSAT, DKI JAKARTA",19,55,138,193
https://kawalpemilu.org#25858,"KENARI, SENEN, JAKARTA PUSAT, DKI JAKARTA",20,41,162,203
https://kawalpemilu.org#25858,"KENARI, SENEN, JAKARTA PUSAT, DKI JAKARTA",21,36,159,195
https://kawalpemilu.org#25858,"KENARI, SENEN, JAKARTA PUSAT, DKI JAKARTA",22,130,98,228
https://kawalpemilu.org#25858,"KENARI, SENEN, JAKARTA PUSAT, DKI JAKARTA",23,114,105,219
https://kawalpemilu.org#25858,"KENARI, SENEN, JAKARTA PUSAT, DKI JAKARTA",24,209,66,3
https://kawalpemilu.org#25858,"KENARI, SENEN, JAKARTA PUSAT, DKI JAKARTA",25,194,72,266
https://kawalpemilu.org#25858,"KENARI, SENEN, JAKARTA PUSAT, DKI JAKARTA",26,143,52,195
https://kawalpemilu.org#25858,"KENARI, SENEN, JAKARTA PUSAT, DKI JAKARTA",27,126,57,183
https://kawalpemilu.org#25858,"KENARI, SENEN, JAKARTA PUSAT, DKI JAKARTA",29,200,25,225
https://kawalpemilu.org#25858,"KENARI, SENEN, JAKARTA PUSAT, DKI JAKARTA",30,180,44,224
https://kawalpemilu.org#25858,"KENARI, SENEN, JAKARTA PUSAT, DKI JAKARTA",31,201,32,233
https://kawalpemilu.org#25858,"KENARI, SENEN, JAKARTA PUSAT, DKI JAKARTA",32,219,11,230
https://kawalpemilu.org#25858,"KENARI, SENEN, JAKARTA PUSAT, DKI JAKARTA",33,180,23,203
https://kawalpemilu.org#25858,"KENARI, SENEN, JAKARTA PUSAT, DKI JAKARTA",34,127,93,220
https://kawalpemilu.org#25859,"PASEBAN, SENEN, JAKARTA PUSAT, DKI JAKARTA",1,122,91,213
https://kawalpemilu.org#25859,"PASEBAN, SENEN, JAKARTA PUSAT, DKI JAKARTA",2,83,142,225
https://kawalpemilu.org#25859,"PASEBAN, SENEN, JAKARTA PUSAT, DKI JAKARTA",3,98,146,244
https://kawalpemilu.org#25859,"PASEBAN, SENEN, JAKARTA PUSAT, DKI JAKARTA",4,93,118,211
https://kawalpemilu.org#25859,"PASEBAN, SENEN, JAKARTA PUSAT, DKI JAKARTA",5,75,127,202
https://kawalpemilu.org#25859,"PASEBAN, SENEN, JAKARTA PUSAT, DKI JAKARTA",6,94,122,216
https://kawalpemilu.org#25859,"PASEBAN, SENEN, JAKARTA PUSAT, DKI JAKARTA",7,61,97,158
https://kawalpemilu.org#25859,"PASEBAN, SENEN, JAKARTA PUSAT, DKI JAKARTA",8,90,73,163
https://kawalpemilu.org#25859,"PASEBAN, SENEN, JAKARTA PUSAT, DKI JAKARTA",9,85,85,170
https://kawalpemilu.org#25859,"PASEBAN, SENEN, JAKARTA PUSAT, DKI JAKARTA",10,103,113,216
https://kawalpemilu.org#25859,"PASEBAN, SENEN, JAKARTA PUSAT, DKI JAKARTA",11,94,147,241
https://kawalpemilu.org#25859,"PASEBAN, SENEN, JAKARTA PUSAT, DKI JAKARTA",13,96,107,203
https://kawalpemilu.org#25859,"PASEBAN, SENEN, JAKARTA PUSAT, DKI JAKARTA",14,108,122,230
https://kawalpemilu.org#25859,"PASEBAN, SENEN, JAKARTA PUSAT, DKI JAKARTA",15,66,140,206
https://kawalpemilu.org#25859,"PASEBAN, SENEN, JAKARTA PUSAT, DKI JAKARTA",16,86,110,196
https://kawalpemilu.org#25859,"PASEBAN, SENEN, JAKARTA PUSAT, DKI JAKARTA",17,92,122,214
https://kawalpemilu.org#25859,"PASEBAN, SENEN, JAKARTA PUSAT, DKI JAKARTA",18,57,146,203
https://kawalpemilu.org#25859,"PASEBAN, SENEN, JAKARTA PUSAT, DKI JAKARTA",19,63,135,198
https://kawalpemilu.org#25859,"PASEBAN, SENEN, JAKARTA PUSAT, DKI JAKARTA",20,107,110,217
https://kawalpemilu.org#25859,"PASEBAN, SENEN, JAKARTA PUSAT, DKI JAKARTA",21,52,146,198
https://kawalpemilu.org#25859,"PASEBAN, SENEN, JAKARTA PUSAT, DKI JAKARTA",22,62,134,196
https://kawalpemilu.org#25859,"PASEBAN, SENEN, JAKARTA PUSAT, DKI JAKARTA",24,64,135,199
https://kawalpemilu.org#25859,"PASEBAN, SENEN, JAKARTA PUSAT, DKI JAKARTA",25,102,105,207
https://kawalpemilu.org#25859,"PASEBAN, SENEN, JAKARTA PUSAT, DKI JAKARTA",26,89,142,231
https://kawalpemilu.org#25859,"PASEBAN, SENEN, JAKARTA PUSAT, DKI JAKARTA",27,79,151,230
https://kawalpemilu.org#25859,"PASEBAN, SENEN, JAKARTA PUSAT, DKI JAKARTA",28,86,146,232
https://kawalpemilu.org#25859,"PASEBAN, SENEN, JAKARTA PUSAT, DKI JAKARTA",29,113,109,222
https://kawalpemilu.org#25859,"PASEBAN, SENEN, JAKARTA PUSAT, DKI JAKARTA",30,64,151,215
https://kawalpemilu.org#25859,"PASEBAN, SENEN, JAKARTA PUSAT, DKI JAKARTA",31,48,183,231
https://kawalpemilu.org#25859,"PASEBAN, SENEN, JAKARTA PUSAT, DKI JAKARTA",32,111,138,249
https://kawalpemilu.org#25859,"PASEBAN, SENEN, JAKARTA PUSAT, DKI JAKARTA",33,113,113,226
https://kawalpemilu.org#25859,"PASEBAN, SENEN, JAKARTA PUSAT, DKI JAKARTA",34,95,148,243
https://kawalpemilu.org#25859,"PASEBAN, SENEN, JAKARTA PUSAT, DKI JAKARTA",35,105,148,253
https://kawalpemilu.org#25859,"PASEBAN, SENEN, JAKARTA PUSAT, DKI JAKARTA",36,130,109,239
https://kawalpemilu.org#25859,"PASEBAN, SENEN, JAKARTA PUSAT, DKI JAKARTA",37,114,90,204
https://kawalpemilu.org#25859,"PASEBAN, SENEN, JAKARTA PUSAT, DKI JAKARTA",38,125,128,253
https://kawalpemilu.org#25859,"PASEBAN, SENEN, JAKARTA PUSAT, DKI JAKARTA",39,101,113,214
https://kawalpemilu.org#25859,"PASEBAN, SENEN, JAKARTA PUSAT, DKI JAKARTA",40,105,118,223
https://kawalpemilu.org#25859,"PASEBAN, SENEN, JAKARTA PUSAT, DKI JAKARTA",41,81,129,210
https://kawalpemilu.org#25859,"PASEBAN, SENEN, JAKARTA PUSAT, DKI JAKARTA",42,85,152,237
https://kawalpemilu.org#25859,"PASEBAN, SENEN, JAKARTA PUSAT, DKI JAKARTA",43,120,107,227
https://kawalpemilu.org#25859,"PASEBAN, SENEN, JAKARTA PUSAT, DKI JAKARTA",44,116,126,242
https://kawalpemilu.org#25859,"PASEBAN, SENEN, JAKARTA PUSAT, DKI JAKARTA",45,127,126,253
https://kawalpemilu.org#25859,"PASEBAN, SENEN, JAKARTA PUSAT, DKI JAKARTA",46,154,34,188
https://kawalpemilu.org#25859,"PASEBAN, SENEN, JAKARTA PUSAT, DKI JAKARTA",47,170,85,255
https://kawalpemilu.org#25859,"PASEBAN, SENEN, JAKARTA PUSAT, DKI JAKARTA",48,74,143,217
https://kawalpemilu.org#25859,"PASEBAN, SENEN, JAKARTA PUSAT, DKI JAKARTA",49,64,179,243
https://kawalpemilu.org#25859,"PASEBAN, SENEN, JAKARTA PUSAT, DKI JAKARTA",50,88,122,210
https://kawalpemilu.org#25859,"PASEBAN, SENEN, JAKARTA PUSAT, DKI JAKARTA",51,75,115,190
https://kawalpemilu.org#25859,"PASEBAN, SENEN, JAKARTA PUSAT, DKI JAKARTA",52,100,122,222
https://kawalpemilu.org#25859,"PASEBAN, SENEN, JAKARTA PUSAT, DKI JAKARTA",53,87,156,243
https://kawalpemilu.org#25859,"PASEBAN, SENEN, JAKARTA PUSAT, DKI JAKARTA",55,74,130,204
https://kawalpemilu.org#25859,"PASEBAN, SENEN, JAKARTA PUSAT, DKI JAKARTA",56,100,142,242
https://kawalpemilu.org#25859,"PASEBAN, SENEN, JAKARTA PUSAT, DKI JAKARTA",57,70,151,221
https://kawalpemilu.org#25859,"PASEBAN, SENEN, JAKARTA PUSAT, DKI JAKARTA",58,109,98,207
https://kawalpemilu.org#25859,"PASEBAN, SENEN, JAKARTA PUSAT, DKI JAKARTA",59,91,136,227
https://kawalpemilu.org#25859,"PASEBAN, SENEN, JAKARTA PUSAT, DKI JAKARTA",60,83,139,222
https://kawalpemilu.org#25859,"PASEBAN, SENEN, JAKARTA PUSAT, DKI JAKARTA",61,101,150,251
https://kawalpemilu.org#25859,"PASEBAN, SENEN, JAKARTA PUSAT, DKI JAKARTA",62,94,126,220
https://kawalpemilu.org#25859,"PASEBAN, SENEN, JAKARTA PUSAT, DKI JAKARTA",63,97,90,194
https://kawalpemilu.org#25859,"PASEBAN, SENEN, JAKARTA PUSAT, DKI JAKARTA",64,83,109,192
https://kawalpemilu.org#25859,"PASEBAN, SENEN, JAKARTA PUSAT, DKI JAKARTA",65,75,139,214
https://kawalpemilu.org#25859,"PASEBAN, SENEN, JAKARTA PUSAT, DKI JAKARTA",66,69,111,180
https://kawalpemilu.org#25859,"PASEBAN, SENEN, JAKARTA PUSAT, DKI JAKARTA",67,91,131,222
https://kawalpemilu.org#25859,"PASEBAN, SENEN, JAKARTA PUSAT, DKI JAKARTA",68,97,132,229
https://kawalpemilu.org#25859,"PASEBAN, SENEN, JAKARTA PUSAT, DKI JAKARTA",69,86,126,212
https://kawalpemilu.org#25859,"PASEBAN, SENEN, JAKARTA PUSAT, DKI JAKARTA",70,87,106,193
https://kawalpemilu.org#25859,"PASEBAN, SENEN, JAKARTA PUSAT, DKI JAKARTA",71,77,148,225
https://kawalpemilu.org#25859,"PASEBAN, SENEN, JAKARTA PUSAT, DKI JAKARTA",72,94,133,227
https://kawalpemilu.org#25859,"PASEBAN, SENEN, JAKARTA PUSAT, DKI JAKARTA",73,75,133,208
https://kawalpemilu.org#25859,"PASEBAN, SENEN, JAKARTA PUSAT, DKI JAKARTA",74,97,123,220
https://kawalpemilu.org#25859,"PASEBAN, SENEN, JAKARTA PUSAT, DKI JAKARTA",75,153,80,233
https://kawalpemilu.org#25859,"PASEBAN, SENEN, JAKARTA PUSAT, DKI JAKARTA",76,141,90,231
https://kawalpemilu.org#25859,"PASEBAN, SENEN, JAKARTA PUSAT, DKI JAKARTA",77,100,128,228
https://kawalpemilu.org#25859,"PASEBAN, SENEN, JAKARTA PUSAT, DKI JAKARTA",78,89,135,224
https://kawalpemilu.org#25859,"PASEBAN, SENEN, JAKARTA PUSAT, DKI JAKARTA",79,118,97,215
https://kawalpemilu.org#25860,"KRAMAT, SENEN, JAKARTA PUSAT, DKI JAKARTA",1,103,105,208
https://kawalpemilu.org#25860,"KRAMAT, SENEN, JAKARTA PUSAT, DKI JAKARTA",2,67,136,203
https://kawalpemilu.org#25860,"KRAMAT, SENEN, JAKARTA PUSAT, DKI JAKARTA",3,60,136,196
https://kawalpemilu.org#25860,"KRAMAT, SENEN, JAKARTA PUSAT, DKI JAKARTA",4,109,80,189
https://kawalpemilu.org#25860,"KRAMAT, SENEN, JAKARTA PUSAT, DKI JAKARTA",5,131,62,193
https://kawalpemilu.org#25860,"KRAMAT, SENEN, JAKARTA PUSAT, DKI JAKARTA",6,153,45,198
https://kawalpemilu.org#25860,"KRAMAT, SENEN, JAKARTA PUSAT, DKI JAKARTA",7,132,47,179
https://kawalpemilu.org#25860,"KRAMAT, SENEN, JAKARTA PUSAT, DKI JAKARTA",8,97,121,218
https://kawalpemilu.org#25860,"KRAMAT, SENEN, JAKARTA PUSAT, DKI JAKARTA",9,178,11,189
https://kawalpemilu.org#25860,"KRAMAT, SENEN, JAKARTA PUSAT, DKI JAKARTA",10,157,44,201
https://kawalpemilu.org#25860,"KRAMAT, SENEN, JAKARTA PUSAT, DKI JAKARTA",11,123,73,196
https://kawalpemilu.org#25860,"KRAMAT, SENEN, JAKARTA PUSAT, DKI JAKARTA",12,136,79,215
https://kawalpemilu.org#25860,"KRAMAT, SENEN, JAKARTA PUSAT, DKI JAKARTA",13,60,125,185
https://kawalpemilu.org#25860,"KRAMAT, SENEN, JAKARTA PUSAT, DKI JAKARTA",14,62,75,137
https://kawalpemilu.org#25860,"KRAMAT, SENEN, JAKARTA PUSAT, DKI JAKARTA",15,58,105,163
https://kawalpemilu.org#25860,"KRAMAT, SENEN, JAKARTA PUSAT, DKI JAKARTA",16,107,67,174
https://kawalpemilu.org#25860,"KRAMAT, SENEN, JAKARTA PUSAT, DKI JAKARTA",17,147,57,204
https://kawalpemilu.org#25860,"KRAMAT, SENEN, JAKARTA PUSAT, DKI JAKARTA",18,183,28,211
https://kawalpemilu.org#25860,"KRAMAT, SENEN, JAKARTA PUSAT, DKI JAKARTA",20,155,28,183
https://kawalpemilu.org#25860,"KRAMAT, SENEN, JAKARTA PUSAT, DKI JAKARTA",21,199,51,250
https://kawalpemilu.org#25860,"KRAMAT, SENEN, JAKARTA PUSAT, DKI JAKARTA",22,95,98,193
https://kawalpemilu.org#25860,"KRAMAT, SENEN, JAKARTA PUSAT, DKI JAKARTA",23,65,48,113
https://kawalpemilu.org#25860,"KRAMAT, SENEN, JAKARTA PUSAT, DKI JAKARTA",24,52,69,121
https://kawalpemilu.org#25860,"KRAMAT, SENEN, JAKARTA PUSAT, DKI JAKARTA",25,85,90,175
https://kawalpemilu.org#25860,"KRAMAT, SENEN, JAKARTA PUSAT, DKI JAKARTA",26,78,115,193
https://kawalpemilu.org#25860,"KRAMAT, SENEN, JAKARTA PUSAT, DKI JAKARTA",27,84,103,187
https://kawalpemilu.org#25860,"KRAMAT, SENEN, JAKARTA PUSAT, DKI JAKARTA",28,66,141,207
https://kawalpemilu.org#25860,"KRAMAT, SENEN, JAKARTA PUSAT, DKI JAKARTA",29,138,62,200
https://kawalpemilu.org#25860,"KRAMAT, SENEN, JAKARTA PUSAT, DKI JAKARTA",30,122,95,217
https://kawalpemilu.org#25860,"KRAMAT, SENEN, JAKARTA PUSAT, DKI JAKARTA",31,80,113,193
https://kawalpemilu.org#25860,"KRAMAT, SENEN, JAKARTA PUSAT, DKI JAKARTA",32,103,89,192
https://kawalpemilu.org#25860,"KRAMAT, SENEN, JAKARTA PUSAT, DKI JAKARTA",33,107,96,203
https://kawalpemilu.org#25860,"KRAMAT, SENEN, JAKARTA PUSAT, DKI JAKARTA",34,100,91,191
https://kawalpemilu.org#25860,"KRAMAT, SENEN, JAKARTA PUSAT, DKI JAKARTA",35,133,115,248
https://kawalpemilu.org#25860,"KRAMAT, SENEN, JAKARTA PUSAT, DKI JAKARTA",36,146,83,229
https://kawalpemilu.org#25860,"KRAMAT, SENEN, JAKARTA PUSAT, DKI JAKARTA",37,121,89,210
https://kawalpemilu.org#25860,"KRAMAT, SENEN, JAKARTA PUSAT, DKI JAKARTA",38,72,137,209
https://kawalpemilu.org#25860,"KRAMAT, SENEN, JAKARTA PUSAT, DKI JAKARTA",39,84,114,198
https://kawalpemilu.org#25860,"KRAMAT, SENEN, JAKARTA PUSAT, DKI JAKARTA",40,92,123,215
https://kawalpemilu.org#25860,"KRAMAT, SENEN, JAKARTA PUSAT, DKI JAKARTA",41,107,74,181
https://kawalpemilu.org#25860,"KRAMAT, SENEN, JAKARTA PUSAT, DKI JAKARTA",42,119,93,212
https://kawalpemilu.org#25860,"KRAMAT, SENEN, JAKARTA PUSAT, DKI JAKARTA",43,84,132,216
https://kawalpemilu.org#25860,"KRAMAT, SENEN, JAKARTA PUSAT, DKI JAKARTA",44,116,129,245
https://kawalpemilu.org#25860,"KRAMAT, SENEN, JAKARTA PUSAT, DKI JAKARTA",45,88,112,200
https://kawalpemilu.org#25860,"KRAMAT, SENEN, JAKARTA PUSAT, DKI JAKARTA",46,59,126,185
https://kawalpemilu.org#25860,"KRAMAT, SENEN, JAKARTA PUSAT, DKI JAKARTA",47,173,26,199
https://kawalpemilu.org#25860,"KRAMAT, SENEN, JAKARTA PUSAT, DKI JAKARTA",48,133,94,227
https://kawalpemilu.org#25860,"KRAMAT, SENEN, JAKARTA PUSAT, DKI JAKARTA",49,132,69,201
https://kawalpemilu.org#25860,"KRAMAT, SENEN, JAKARTA PUSAT, DKI JAKARTA",50,123,58,181
https://kawalpemilu.org#25860,"KRAMAT, SENEN, JAKARTA PUSAT, DKI JAKARTA",51,65,84,149
https://kawalpemilu.org#25860,"KRAMAT, SENEN, JAKARTA PUSAT, DKI JAKARTA",52,48,155,203
https://kawalpemilu.org#25860,"KRAMAT, SENEN, JAKARTA PUSAT, DKI JAKARTA",53,56,166,222
https://kawalpemilu.org#25860,"KRAMAT, SENEN, JAKARTA PUSAT, DKI JAKARTA",54,50,156,206
https://kawalpemilu.org#25860,"KRAMAT, SENEN, JAKARTA PUSAT, DKI JAKARTA",55,48,155,203
https://kawalpemilu.org#25860,"KRAMAT, SENEN, JAKARTA PUSAT, DKI JAKARTA",56,65,143,208
https://kawalpemilu.org#25860,"KRAMAT, SENEN, JAKARTA PUSAT, DKI JAKARTA",57,53,131,184
https://kawalpemilu.org#25860,"KRAMAT, SENEN, JAKARTA PUSAT, DKI JAKARTA",58,52,159,211
https://kawalpemilu.org#25860,"KRAMAT, SENEN, JAKARTA PUSAT, DKI JAKARTA",59,64,157,221
https://kawalpemilu.org#25860,"KRAMAT, SENEN, JAKARTA PUSAT, DKI JAKARTA",60,88,149,237
https://kawalpemilu.org#25860,"KRAMAT, SENEN, JAKARTA PUSAT, DKI JAKARTA",61,62,142,204
https://kawalpemilu.org#25860,"KRAMAT, SENEN, JAKARTA PUSAT, DKI JAKARTA",62,53,122,175
https://kawalpemilu.org#25860,"KRAMAT, SENEN, JAKARTA PUSAT, DKI JAKARTA",63,83,110,193
https://kawalpemilu.org#25860,"KRAMAT, SENEN, JAKARTA PUSAT, DKI JAKARTA",64,60,119,179
https://kawalpemilu.org#25860,"KRAMAT, SENEN, JAKARTA PUSAT, DKI JAKARTA",65,80,111,191
https://kawalpemilu.org#25860,"KRAMAT, SENEN, JAKARTA PUSAT, DKI JAKARTA",66,87,101,188
https://kawalpemilu.org#25860,"KRAMAT, SENEN, JAKARTA PUSAT, DKI JAKARTA",67,80,123,203
https://kawalpemilu.org#25860,"KRAMAT, SENEN, JAKARTA PUSAT, DKI JAKARTA",68,84,141,225
https://kawalpemilu.org#25860,"KRAMAT, SENEN, JAKARTA PUSAT, DKI JAKARTA",70,87,110,197
https://kawalpemilu.org#25860,"KRAMAT, SENEN, JAKARTA PUSAT, DKI JAKARTA",71,85,126,211
https://kawalpemilu.org#25860,"KRAMAT, SENEN, JAKARTA PUSAT, DKI JAKARTA",72,106,122,228
https://kawalpemilu.org#25860,"KRAMAT, SENEN, JAKARTA PUSAT, DKI JAKARTA",73,95,126,221
https://kawalpemilu.org#25860,"KRAMAT, SENEN, JAKARTA PUSAT, DKI JAKARTA",74,105,82,187
https://kawalpemilu.org#25860,"KRAMAT, SENEN, JAKARTA PUSAT, DKI JAKARTA",75,84,107,191
https://kawalpemilu.org#25860,"KRAMAT, SENEN, JAKARTA PUSAT, DKI JAKARTA",76,135,77,212
https://kawalpemilu.org#25860,"KRAMAT, SENEN, JAKARTA PUSAT, DKI JAKARTA",77,83,127,210
https://kawalpemilu.org#25860,"KRAMAT, SENEN, JAKARTA PUSAT, DKI JAKARTA",78,91,107,198
https://kawalpemilu.org#25860,"KRAMAT, SENEN, JAKARTA PUSAT, DKI JAKARTA",79,72,128,200
https://kawalpemilu.org#25860,"KRAMAT, SENEN, JAKARTA PUSAT, DKI JAKARTA",80,91,106,197
https://kawalpemilu.org#25860,"KRAMAT, SENEN, JAKARTA PUSAT, DKI JAKARTA",81,118,83,201
https://kawalpemilu.org#25860,"KRAMAT, SENEN, JAKARTA PUSAT, DKI JAKARTA",82,92,152,244
https://kawalpemilu.org#25860,"KRAMAT, SENEN, JAKARTA PUSAT, DKI JAKARTA",83,95,78,173
https://kawalpemilu.org#25860,"KRAMAT, SENEN, JAKARTA PUSAT, DKI JAKARTA",84,108,104,212
https://kawalpemilu.org#25860,"KRAMAT, SENEN, JAKARTA PUSAT, DKI JAKARTA",85,93,112,205
https://kawalpemilu.org#25860,"KRAMAT, SENEN, JAKARTA PUSAT, DKI JAKARTA",86,81,87,168
https://kawalpemilu.org#25860,"KRAMAT, SENEN, JAKARTA PUSAT, DKI JAKARTA",87,60,142,202
https://kawalpemilu.org#25860,"KRAMAT, SENEN, JAKARTA PUSAT, DKI JAKARTA",88,101,128,229
https://kawalpemilu.org#25860,"KRAMAT, SENEN, JAKARTA PUSAT, DKI JAKARTA",89,53,155,208
https://kawalpemilu.org#25860,"KRAMAT, SENEN, JAKARTA PUSAT, DKI JAKARTA",90,104,86,190
https://kawalpemilu.org#25860,"KRAMAT, SENEN, JAKARTA PUSAT, DKI JAKARTA",91,62,194,256
https://kawalpemilu.org#25860,"KRAMAT, SENEN, JAKARTA PUSAT, DKI JAKARTA",92,90,106,196
https://kawalpemilu.org#25860,"KRAMAT, SENEN, JAKARTA PUSAT, DKI JAKARTA",93,65,146,211
https://kawalpemilu.org#25860,"KRAMAT, SENEN, JAKARTA PUSAT, DKI JAKARTA",94,86,110,196
https://kawalpemilu.org#25860,"KRAMAT, SENEN, JAKARTA PUSAT, DKI JAKARTA",95,92,112,204
https://kawalpemilu.org#25860,"KRAMAT, SENEN, JAKARTA PUSAT, DKI JAKARTA",96,102,119,221
https://kawalpemilu.org#25860,"KRAMAT, SENEN, JAKARTA PUSAT, DKI JAKARTA",97,73,137,210
https://kawalpemilu.org#25860,"KRAMAT, SENEN, JAKARTA PUSAT, DKI JAKARTA",98,57,185,242
https://kawalpemilu.org#25860,"KRAMAT, SENEN, JAKARTA PUSAT, DKI JAKARTA",99,104,118,222
https://kawalpemilu.org#25861,"KWITANG, SENEN, JAKARTA PUSAT, DKI JAKARTA",1,80,150,230
https://kawalpemilu.org#25861,"KWITANG, SENEN, JAKARTA PUSAT, DKI JAKARTA",2,83,131,214
https://kawalpemilu.org#25861,"KWITANG, SENEN, JAKARTA PUSAT, DKI JAKARTA",3,79,157,236
https://kawalpemilu.org#25861,"KWITANG, SENEN, JAKARTA PUSAT, DKI JAKARTA",4,67,164,231
https://kawalpemilu.org#25861,"KWITANG, SENEN, JAKARTA PUSAT, DKI JAKARTA",5,95,146,241
https://kawalpemilu.org#25861,"KWITANG, SENEN, JAKARTA PUSAT, DKI JAKARTA",6,136,74,210
https://kawalpemilu.org#25861,"KWITANG, SENEN, JAKARTA PUSAT, DKI JAKARTA",7,66,155,221
https://kawalpemilu.org#25861,"KWITANG, SENEN, JAKARTA PUSAT, DKI JAKARTA",8,74,141,215
https://kawalpemilu.org#25861,"KWITANG, SENEN, JAKARTA PUSAT, DKI JAKARTA",9,45,173,218
https://kawalpemilu.org#25861,"KWITANG, SENEN, JAKARTA PUSAT, DKI JAKARTA",10,53,174,227
https://kawalpemilu.org#25861,"KWITANG, SENEN, JAKARTA PUSAT, DKI JAKARTA",11,42,155,197
https://kawalpemilu.org#25861,"KWITANG, SENEN, JAKARTA PUSAT, DKI JAKARTA",12,62,142,204
https://kawalpemilu.org#25861,"KWITANG, SENEN, JAKARTA PUSAT, DKI JAKARTA",13,61,194,255
https://kawalpemilu.org#25861,"KWITANG, SENEN, JAKARTA PUSAT, DKI JAKARTA",14,39,216,255
https://kawalpemilu.org#25861,"KWITANG, SENEN, JAKARTA PUSAT, DKI JAKARTA",15,44,189,233
https://kawalpemilu.org#25861,"KWITANG, SENEN, JAKARTA PUSAT, DKI JAKARTA",16,56,185,241
https://kawalpemilu.org#25861,"KWITANG, SENEN, JAKARTA PUSAT, DKI JAKARTA",17,38,196,234
https://kawalpemilu.org#25861,"KWITANG, SENEN, JAKARTA PUSAT, DKI JAKARTA",18,46,194,240
https://kawalpemilu.org#25861,"KWITANG, SENEN, JAKARTA PUSAT, DKI JAKARTA",19,55,168,223
https://kawalpemilu.org#25861,"KWITANG, SENEN, JAKARTA PUSAT, DKI JAKARTA",20,166,22,188
https://kawalpemilu.org#25861,"KWITANG, SENEN, JAKARTA PUSAT, DKI JAKARTA",21,84,122,206
https://kawalpemilu.org#25861,"KWITANG, SENEN, JAKARTA PUSAT, DKI JAKARTA",22,86,148,234
https://kawalpemilu.org#25861,"KWITANG, SENEN, JAKARTA PUSAT, DKI JAKARTA",23,136,94,230
https://kawalpemilu.org#25861,"KWITANG, SENEN, JAKARTA PUSAT, DKI JAKARTA",24,136,67,203
https://kawalpemilu.org#25861,"KWITANG, SENEN, JAKARTA PUSAT, DKI JAKARTA",25,121,82,203
https://kawalpemilu.org#25861,"KWITANG, SENEN, JAKARTA PUSAT, DKI JAKARTA",26,112,91,203
https://kawalpemilu.org#25861,"KWITANG, SENEN, JAKARTA PUSAT, DKI JAKARTA",27,143,57,200
https://kawalpemilu.org#25861,"KWITANG, SENEN, JAKARTA PUSAT, DKI JAKARTA",28,91,150,241
https://kawalpemilu.org#25861,"KWITANG, SENEN, JAKARTA PUSAT, DKI JAKARTA",29,94,155,249
https://kawalpemilu.org#25861,"KWITANG, SENEN, JAKARTA PUSAT, DKI JAKARTA",30,85,154,239
https://kawalpemilu.org#25861,"KWITANG, SENEN, JAKARTA PUSAT, DKI JAKARTA",31,87,146,233
https://kawalpemilu.org#25861,"KWITANG, SENEN, JAKARTA PUSAT, DKI JAKARTA",32,143,95,238
https://kawalpemilu.org#25861,"KWITANG, SENEN, JAKARTA PUSAT, DKI JAKARTA",33,97,154,251
https://kawalpemilu.org#25861,"KWITANG, SENEN, JAKARTA PUSAT, DKI JAKARTA",34,139,75,214
https://kawalpemilu.org#25861,"KWITANG, SENEN, JAKARTA PUSAT, DKI JAKARTA",35,100,132,232
https://kawalpemilu.org#25861,"KWITANG, SENEN, JAKARTA PUSAT, DKI JAKARTA",36,40,184,224
https://kawalpemilu.org#25861,"KWITANG, SENEN, JAKARTA PUSAT, DKI JAKARTA",37,143,93,236
https://kawalpemilu.org#25861,"KWITANG, SENEN, JAKARTA PUSAT, DKI JAKARTA",38,189,49,238
https://kawalpemilu.org#25861,"KWITANG, SENEN, JAKARTA PUSAT, DKI JAKARTA",39,129,102,231
https://kawalpemilu.org#25861,"KWITANG, SENEN, JAKARTA PUSAT, DKI JAKARTA",40,179,44,223
https://kawalpemilu.org#25861,"KWITANG, SENEN, JAKARTA PUSAT, DKI JAKARTA",41,180,29,209
https://kawalpemilu.org#25861,"KWITANG, SENEN, JAKARTA PUSAT, DKI JAKARTA",43,92,167,259
https://kawalpemilu.org#25861,"KWITANG, SENEN, JAKARTA PUSAT, DKI JAKARTA",44,59,179,238
https://kawalpemilu.org#25861,"KWITANG, SENEN, JAKARTA PUSAT, DKI JAKARTA",45,98,137,235
https://kawalpemilu.org#25861,"KWITANG, SENEN, JAKARTA PUSAT, DKI JAKARTA",46,111,115,226
https://kawalpemilu.org#25861,"KWITANG, SENEN, JAKARTA PUSAT, DKI JAKARTA",47,150,35,185
https://kawalpemilu.org#25861,"KWITANG, SENEN, JAKARTA PUSAT, DKI JAKARTA",48,147,89,236
https://kawalpemilu.org#25861,"KWITANG, SENEN, JAKARTA PUSAT, DKI JAKARTA",49,140,95,235
https://kawalpemilu.org#25861,"KWITANG, SENEN, JAKARTA PUSAT, DKI JAKARTA",50,102,84,186
https://kawalpemilu.org#25862,"BUNGUR, SENEN, JAKARTA PUSAT, DKI JAKARTA",1,125,108,233
https://kawalpemilu.org#25862,"BUNGUR, SENEN, JAKARTA PUSAT, DKI JAKARTA",2,154,65,219
https://kawalpemilu.org#25862,"BUNGUR, SENEN, JAKARTA PUSAT, DKI JAKARTA",3,109,111,220
https://kawalpemilu.org#25862,"BUNGUR, SENEN, JAKARTA PUSAT, DKI JAKARTA",4,159,48,207
https://kawalpemilu.org#25862,"BUNGUR, SENEN, JAKARTA PUSAT, DKI JAKARTA",5,114,110,224
https://kawalpemilu.org#25862,"BUNGUR, SENEN, JAKARTA PUSAT, DKI JAKARTA",6,143,74,217
https://kawalpemilu.org#25862,"BUNGUR, SENEN, JAKARTA PUSAT, DKI JAKARTA",7,140,90,230
https://kawalpemilu.org#25862,"BUNGUR, SENEN, JAKARTA PUSAT, DKI JAKARTA",8,101,124,225
https://kawalpemilu.org#25862,"BUNGUR, SENEN, JAKARTA PUSAT, DKI JAKARTA",9,170,51,221
https://kawalpemilu.org#25862,"BUNGUR, SENEN, JAKARTA PUSAT, DKI JAKARTA",10,140,58,198
https://kawalpemilu.org#25862,"BUNGUR, SENEN, JAKARTA PUSAT, DKI JAKARTA",11,100,107,207
https://kawalpemilu.org#25862,"BUNGUR, SENEN, JAKARTA PUSAT, DKI JAKARTA",12,119,85,204
https://kawalpemilu.org#25862,"BUNGUR, SENEN, JAKARTA PUSAT, DKI JAKARTA",13,78,103,181
https://kawalpemilu.org#25862,"BUNGUR, SENEN, JAKARTA PUSAT, DKI JAKARTA",14,91,68,159
https://kawalpemilu.org#25862,"BUNGUR, SENEN, JAKARTA PUSAT, DKI JAKARTA",15,88,104,192
https://kawalpemilu.org#25862,"BUNGUR, SENEN, JAKARTA PUSAT, DKI JAKARTA",16,85,88,173
https://kawalpemilu.org#25862,"BUNGUR, SENEN, JAKARTA PUSAT, DKI JAKARTA",17,146,52,198
https://kawalpemilu.org#25862,"BUNGUR, SENEN, JAKARTA PUSAT, DKI JAKARTA",18,74,109,183
https://kawalpemilu.org#25862,"BUNGUR, SENEN, JAKARTA PUSAT, DKI JAKARTA",19,132,90,222
https://kawalpemilu.org#25862,"BUNGUR, SENEN, JAKARTA PUSAT, DKI JAKARTA",20,163,72,235
https://kawalpemilu.org#25862,"BUNGUR, SENEN, JAKARTA PUSAT, DKI JAKARTA",21,129,72,201
https://kawalpemilu.org#25862,"BUNGUR, SENEN, JAKARTA PUSAT, DKI JAKARTA",22,134,77,211
https://kawalpemilu.org#25862,"BUNGUR, SENEN, JAKARTA PUSAT, DKI JAKARTA",24,144,69,213
https://kawalpemilu.org#25862,"BUNGUR, SENEN, JAKARTA PUSAT, DKI JAKARTA",25,130,75,205
https://kawalpemilu.org#25862,"BUNGUR, SENEN, JAKARTA PUSAT, DKI JAKARTA",26,151,44,195
https://kawalpemilu.org#25862,"BUNGUR, SENEN, JAKARTA PUSAT, DKI JAKARTA",27,157,47,204
https://kawalpemilu.org#25862,"BUNGUR, SENEN, JAKARTA PUSAT, DKI JAKARTA",28,87,98,185
https://kawalpemilu.org#25862,"BUNGUR, SENEN, JAKARTA PUSAT, DKI JAKARTA",29,93,100,193
https://kawalpemilu.org#25862,"BUNGUR, SENEN, JAKARTA PUSAT, DKI JAKARTA",30,114,97,211
https://kawalpemilu.org#25862,"BUNGUR, SENEN, JAKARTA PUSAT, DKI JAKARTA",31,122,97,219
https://kawalpemilu.org#25862,"BUNGUR, SENEN, JAKARTA PUSAT, DKI JAKARTA",32,105,99,204
https://kawalpemilu.org#25862,"BUNGUR, SENEN, JAKARTA PUSAT, DKI JAKARTA",33,107,87,194
https://kawalpemilu.org#25862,"BUNGUR, SENEN, JAKARTA PUSAT, DKI JAKARTA",34,98,92,190
https://kawalpemilu.org#25862,"BUNGUR, SENEN, JAKARTA PUSAT, DKI JAKARTA",35,97,109,206
https://kawalpemilu.org#25862,"BUNGUR, SENEN, JAKARTA PUSAT, DKI JAKARTA",36,81,126,207
https://kawalpemilu.org#25862,"BUNGUR, SENEN, JAKARTA PUSAT, DKI JAKARTA",37,108,85,193
https://kawalpemilu.org#25862,"BUNGUR, SENEN, JAKARTA PUSAT, DKI JAKARTA",38,139,79,218
https://kawalpemilu.org#25862,"BUNGUR, SENEN, JAKARTA PUSAT, DKI JAKARTA",39,99,127,226
https://kawalpemilu.org#25862,"BUNGUR, SENEN, JAKARTA PUSAT, DKI JAKARTA",42,102,119,221
https://kawalpemilu.org#25862,"BUNGUR, SENEN, JAKARTA PUSAT, DKI JAKARTA",43,99,93,192
https://kawalpemilu.org#25862,"BUNGUR, SENEN, JAKARTA PUSAT, DKI JAKARTA",44,114,90,204
https://kawalpemilu.org#25862,"BUNGUR, SENEN, JAKARTA PUSAT, DKI JAKARTA",45,149,63,212
https://kawalpemilu.org#25862,"BUNGUR, SENEN, JAKARTA PUSAT, DKI JAKARTA",46,115,74,189
https://kawalpemilu.org#25862,"BUNGUR, SENEN, JAKARTA PUSAT, DKI JAKARTA",47,81,86,167
https://kawalpemilu.org#25862,"BUNGUR, SENEN, JAKARTA PUSAT, DKI JAKARTA",48,66,82,148
https://kawalpemilu.org#25862,"BUNGUR, SENEN, JAKARTA PUSAT, DKI JAKARTA",49,106,83,189
https://kawalpemilu.org#25862,"BUNGUR, SENEN, JAKARTA PUSAT, DKI JAKARTA",50,134,65,199
https://kawalpemilu.org#25862,"BUNGUR, SENEN, JAKARTA PUSAT, DKI JAKARTA",51,137,81,218
https://kawalpemilu.org#25862,"BUNGUR, SENEN, JAKARTA PUSAT, DKI JAKARTA",52,106,113,119
https://kawalpemilu.org#25862,"BUNGUR, SENEN, JAKARTA PUSAT, DKI JAKARTA",53,144,55,199
https://kawalpemilu.org#25862,"BUNGUR, SENEN, JAKARTA PUSAT, DKI JAKARTA",54,164,64,228
https://kawalpemilu.org#25862,"BUNGUR, SENEN, JAKARTA PUSAT, DKI JAKARTA",55,167,77,244
https://kawalpemilu.org#25862,"BUNGUR, SENEN, JAKARTA PUSAT, DKI JAKARTA",56,135,104,239
https://kawalpemilu.org#25862,"BUNGUR, SENEN, JAKARTA PUSAT, DKI JAKARTA",57,147,117,264
https://kawalpemilu.org#25862,"BUNGUR, SENEN, JAKARTA PUSAT, DKI JAKARTA",58,152,91,243
https://kawalpemilu.org#25862,"BUNGUR, SENEN, JAKARTA PUSAT, DKI JAKARTA",59,65,67,132
https://kawalpemilu.org#25862,"BUNGUR, SENEN, JAKARTA PUSAT, DKI JAKARTA",60,96,88,184
https://kawalpemilu.org#25862,"BUNGUR, SENEN, JAKARTA PUSAT, DKI JAKARTA",62,50,169,219
https://kawalpemilu.org#25864,"CEMPAKA PUTIH TIMUR, CEMPAKA PUTIH, JAKARTA PUSAT, DKI JAKARTA",1,95,131,226
https://kawalpemilu.org#25864,"CEMPAKA PUTIH TIMUR, CEMPAKA PUTIH, JAKARTA PUSAT, DKI JAKARTA",2,131,90,221
https://kawalpemilu.org#25864,"CEMPAKA PUTIH TIMUR, CEMPAKA PUTIH, JAKARTA PUSAT, DKI JAKARTA",3,93,98,191
https://kawalpemilu.org#25864,"CEMPAKA PUTIH TIMUR, CEMPAKA PUTIH, JAKARTA PUSAT, DKI JAKARTA",4,128,90,218
https://kawalpemilu.org#25864,"CEMPAKA PUTIH TIMUR, CEMPAKA PUTIH, JAKARTA PUSAT, DKI JAKARTA",5,69,111,207
https://kawalpemilu.org#25864,"CEMPAKA PUTIH TIMUR, CEMPAKA PUTIH, JAKARTA PUSAT, DKI JAKARTA",6,119,88,207
https://kawalpemilu.org#25864,"CEMPAKA PUTIH TIMUR, CEMPAKA PUTIH, JAKARTA PUSAT, DKI JAKARTA",7,129,115,244
https://kawalpemilu.org#25864,"CEMPAKA PUTIH TIMUR, CEMPAKA PUTIH, JAKARTA PUSAT, DKI JAKARTA",8,113,134,247
https://kawalpemilu.org#25864,"CEMPAKA PUTIH TIMUR, CEMPAKA PUTIH, JAKARTA PUSAT, DKI JAKARTA",9,122,124,246
https://kawalpemilu.org#25864,"CEMPAKA PUTIH TIMUR, CEMPAKA PUTIH, JAKARTA PUSAT, DKI JAKARTA",10,108,111,219
https://kawalpemilu.org#25864,"CEMPAKA PUTIH TIMUR, CEMPAKA PUTIH, JAKARTA PUSAT, DKI JAKARTA",11,118,137,255
https://kawalpemilu.org#25864,"CEMPAKA PUTIH TIMUR, CEMPAKA PUTIH, JAKARTA PUSAT, DKI JAKARTA",12,92,134,226
https://kawalpemilu.org#25864,"CEMPAKA PUTIH TIMUR, CEMPAKA PUTIH, JAKARTA PUSAT, DKI JAKARTA",13,98,127,225
https://kawalpemilu.org#25864,"CEMPAKA PUTIH TIMUR, CEMPAKA PUTIH, JAKARTA PUSAT, DKI JAKARTA",14,80,150,230
https://kawalpemilu.org#25864,"CEMPAKA PUTIH TIMUR, CEMPAKA PUTIH, JAKARTA PUSAT, DKI JAKARTA",15,54,186,240
https://kawalpemilu.org#25864,"CEMPAKA PUTIH TIMUR, CEMPAKA PUTIH, JAKARTA PUSAT, DKI JAKARTA",16,111,144,255
https://kawalpemilu.org#25864,"CEMPAKA PUTIH TIMUR, CEMPAKA PUTIH, JAKARTA PUSAT, DKI JAKARTA",17,99,150,249
https://kawalpemilu.org#25864,"CEMPAKA PUTIH TIMUR, CEMPAKA PUTIH, JAKARTA PUSAT, DKI JAKARTA",18,117,116,233
https://kawalpemilu.org#25864,"CEMPAKA PUTIH TIMUR, CEMPAKA PUTIH, JAKARTA PUSAT, DKI JAKARTA",19,155,90,245
https://kawalpemilu.org#25864,"CEMPAKA PUTIH TIMUR, CEMPAKA PUTIH, JAKARTA PUSAT, DKI JAKARTA",20,84,173,257
https://kawalpemilu.org#25864,"CEMPAKA PUTIH TIMUR, CEMPAKA PUTIH, JAKARTA PUSAT, DKI JAKARTA",21,89,137,226
https://kawalpemilu.org#25864,"CEMPAKA PUTIH TIMUR, CEMPAKA PUTIH, JAKARTA PUSAT, DKI JAKARTA",22,120,101,221
https://kawalpemilu.org#25864,"CEMPAKA PUTIH TIMUR, CEMPAKA PUTIH, JAKARTA PUSAT, DKI JAKARTA",23,97,126,223
https://kawalpemilu.org#25864,"CEMPAKA PUTIH TIMUR, CEMPAKA PUTIH, JAKARTA PUSAT, DKI JAKARTA",24,97,120,217
https://kawalpemilu.org#25864,"CEMPAKA PUTIH TIMUR, CEMPAKA PUTIH, JAKARTA PUSAT, DKI JAKARTA",25,120,110,230
https://kawalpemilu.org#25864,"CEMPAKA PUTIH TIMUR, CEMPAKA PUTIH, JAKARTA PUSAT, DKI JAKARTA",26,116,103,219
https://kawalpemilu.org#25864,"CEMPAKA PUTIH TIMUR, CEMPAKA PUTIH, JAKARTA PUSAT, DKI JAKARTA",27,96,122,218
https://kawalpemilu.org#25864,"CEMPAKA PUTIH TIMUR, CEMPAKA PUTIH, JAKARTA PUSAT, DKI JAKARTA",28,105,115,220
https://kawalpemilu.org#25864,"CEMPAKA PUTIH TIMUR, CEMPAKA PUTIH, JAKARTA PUSAT, DKI JAKARTA",29,104,98,202
https://kawalpemilu.org#25864,"CEMPAKA PUTIH TIMUR, CEMPAKA PUTIH, JAKARTA PUSAT, DKI JAKARTA",30,106,130,236
https://kawalpemilu.org#25864,"CEMPAKA PUTIH TIMUR, CEMPAKA PUTIH, JAKARTA PUSAT, DKI JAKARTA",31,103,117,220
https://kawalpemilu.org#25864,"CEMPAKA PUTIH TIMUR, CEMPAKA PUTIH, JAKARTA PUSAT, DKI JAKARTA",32,113,113,226
https://kawalpemilu.org#25864,"CEMPAKA PUTIH TIMUR, CEMPAKA PUTIH, JAKARTA PUSAT, DKI JAKARTA",33,97,141,238
https://kawalpemilu.org#25864,"CEMPAKA PUTIH TIMUR, CEMPAKA PUTIH, JAKARTA PUSAT, DKI JAKARTA",34,71,166,237
https://kawalpemilu.org#25864,"CEMPAKA PUTIH TIMUR, CEMPAKA PUTIH, JAKARTA PUSAT, DKI JAKARTA",35,111,102,213
https://kawalpemilu.org#25864,"CEMPAKA PUTIH TIMUR, CEMPAKA PUTIH, JAKARTA PUSAT, DKI JAKARTA",36,119,114,233
https://kawalpemilu.org#25864,"CEMPAKA PUTIH TIMUR, CEMPAKA PUTIH, JAKARTA PUSAT, DKI JAKARTA",37,109,94,203
https://kawalpemilu.org#25864,"CEMPAKA PUTIH TIMUR, CEMPAKA PUTIH, JAKARTA PUSAT, DKI JAKARTA",38,126,107,233
https://kawalpemilu.org#25864,"CEMPAKA PUTIH TIMUR, CEMPAKA PUTIH, JAKARTA PUSAT, DKI JAKARTA",39,112,89,201
https://kawalpemilu.org#25864,"CEMPAKA PUTIH TIMUR, CEMPAKA PUTIH, JAKARTA PUSAT, DKI JAKARTA",40,102,98,200
https://kawalpemilu.org#25864,"CEMPAKA PUTIH TIMUR, CEMPAKA PUTIH, JAKARTA PUSAT, DKI JAKARTA",41,112,100,212
https://kawalpemilu.org#25864,"CEMPAKA PUTIH TIMUR, CEMPAKA PUTIH, JAKARTA PUSAT, DKI JAKARTA",42,143,114,257
https://kawalpemilu.org#25864,"CEMPAKA PUTIH TIMUR, CEMPAKA PUTIH, JAKARTA PUSAT, DKI JAKARTA",43,137,118,255
https://kawalpemilu.org#25864,"CEMPAKA PUTIH TIMUR, CEMPAKA PUTIH, JAKARTA PUSAT, DKI JAKARTA",44,93,149,242
https://kawalpemilu.org#25864,"CEMPAKA PUTIH TIMUR, CEMPAKA PUTIH, JAKARTA PUSAT, DKI JAKARTA",45,121,111,232
https://kawalpemilu.org#25864,"CEMPAKA PUTIH TIMUR, CEMPAKA PUTIH, JAKARTA PUSAT, DKI JAKARTA",46,133,96,229
https://kawalpemilu.org#25864,"CEMPAKA PUTIH TIMUR, CEMPAKA PUTIH, JAKARTA PUSAT, DKI JAKARTA",47,178,74,252
https://kawalpemilu.org#25864,"CEMPAKA PUTIH TIMUR, CEMPAKA PUTIH, JAKARTA PUSAT, DKI JAKARTA",48,109,105,214
https://kawalpemilu.org#25864,"CEMPAKA PUTIH TIMUR, CEMPAKA PUTIH, JAKARTA PUSAT, DKI JAKARTA",49,111,94,205
https://kawalpemilu.org#25864,"CEMPAKA PUTIH TIMUR, CEMPAKA PUTIH, JAKARTA PUSAT, DKI JAKARTA",50,110,106,216
https://kawalpemilu.org#25864,"CEMPAKA PUTIH TIMUR, CEMPAKA PUTIH, JAKARTA PUSAT, DKI JAKARTA",51,102,104,206
https://kawalpemilu.org#25864,"CEMPAKA PUTIH TIMUR, CEMPAKA PUTIH, JAKARTA PUSAT, DKI JAKARTA",52,124,93,217
https://kawalpemilu.org#25864,"CEMPAKA PUTIH TIMUR, CEMPAKA PUTIH, JAKARTA PUSAT, DKI JAKARTA",53,136,80,216
https://kawalpemilu.org#25864,"CEMPAKA PUTIH TIMUR, CEMPAKA PUTIH, JAKARTA PUSAT, DKI JAKARTA",54,93,147,240
https://kawalpemilu.org#25864,"CEMPAKA PUTIH TIMUR, CEMPAKA PUTIH, JAKARTA PUSAT, DKI JAKARTA",55,83,128,211
https://kawalpemilu.org#25864,"CEMPAKA PUTIH TIMUR, CEMPAKA PUTIH, JAKARTA PUSAT, DKI JAKARTA",56,106,151,257
https://kawalpemilu.org#25864,"CEMPAKA PUTIH TIMUR, CEMPAKA PUTIH, JAKARTA PUSAT, DKI JAKARTA",57,104,122,226
https://kawalpemilu.org#25864,"CEMPAKA PUTIH TIMUR, CEMPAKA PUTIH, JAKARTA PUSAT, DKI JAKARTA",58,94,110,204
https://kawalpemilu.org#25864,"CEMPAKA PUTIH TIMUR, CEMPAKA PUTIH, JAKARTA PUSAT, DKI JAKARTA",59,123,82,205
https://kawalpemilu.org#25864,"CEMPAKA PUTIH TIMUR, CEMPAKA PUTIH, JAKARTA PUSAT, DKI JAKARTA",60,99,102,201
https://kawalpemilu.org#25864,"CEMPAKA PUTIH TIMUR, CEMPAKA PUTIH, JAKARTA PUSAT, DKI JAKARTA",61,104,111,215
https://kawalpemilu.org#25864,"CEMPAKA PUTIH TIMUR, CEMPAKA PUTIH, JAKARTA PUSAT, DKI JAKARTA",62,144,85,229
https://kawalpemilu.org#25864,"CEMPAKA PUTIH TIMUR, CEMPAKA PUTIH, JAKARTA PUSAT, DKI JAKARTA",63,98,94,192
https://kawalpemilu.org#25864,"CEMPAKA PUTIH TIMUR, CEMPAKA PUTIH, JAKARTA PUSAT, DKI JAKARTA",64,157,72,229
https://kawalpemilu.org#25864,"CEMPAKA PUTIH TIMUR, CEMPAKA PUTIH, JAKARTA PUSAT, DKI JAKARTA",65,145,64,209
https://kawalpemilu.org#25864,"CEMPAKA PUTIH TIMUR, CEMPAKA PUTIH, JAKARTA PUSAT, DKI JAKARTA",66,165,65,230
https://kawalpemilu.org#25864,"CEMPAKA PUTIH TIMUR, CEMPAKA PUTIH, JAKARTA PUSAT, DKI JAKARTA",67,146,54,200
https://kawalpemilu.org#25864,"CEMPAKA PUTIH TIMUR, CEMPAKA PUTIH, JAKARTA PUSAT, DKI JAKARTA",68,105,97,202
https://kawalpemilu.org#25864,"CEMPAKA PUTIH TIMUR, CEMPAKA PUTIH, JAKARTA PUSAT, DKI JAKARTA",69,129,56,185
https://kawalpemilu.org#25864,"CEMPAKA PUTIH TIMUR, CEMPAKA PUTIH, JAKARTA PUSAT, DKI JAKARTA",70,143,66,209
https://kawalpemilu.org#25864,"CEMPAKA PUTIH TIMUR, CEMPAKA PUTIH, JAKARTA PUSAT, DKI JAKARTA",71,148,53,201
https://kawalpemilu.org#25864,"CEMPAKA PUTIH TIMUR, CEMPAKA PUTIH, JAKARTA PUSAT, DKI JAKARTA",72,132,67,199
https://kawalpemilu.org#25864,"CEMPAKA PUTIH TIMUR, CEMPAKA PUTIH, JAKARTA PUSAT, DKI JAKARTA",73,152,68,220
https://kawalpemilu.org#25864,"CEMPAKA PUTIH TIMUR, CEMPAKA PUTIH, JAKARTA PUSAT, DKI JAKARTA",74,120,60,180
https://kawalpemilu.org#25864,"CEMPAKA PUTIH TIMUR, CEMPAKA PUTIH, JAKARTA PUSAT, DKI JAKARTA",75,162,84,246
https://kawalpemilu.org#25864,"CEMPAKA PUTIH TIMUR, CEMPAKA PUTIH, JAKARTA PUSAT, DKI JAKARTA",76,178,68,246
https://kawalpemilu.org#25864,"CEMPAKA PUTIH TIMUR, CEMPAKA PUTIH, JAKARTA PUSAT, DKI JAKARTA",77,189,56,245
https://kawalpemilu.org#25864,"CEMPAKA PUTIH TIMUR, CEMPAKA PUTIH, JAKARTA PUSAT, DKI JAKARTA",78,160,56,216
https://kawalpemilu.org#25865,"CEMPAKA PUTIH BARAT, CEMPAKA PUTIH, JAKARTA PUSAT, DKI JAKARTA",1,101,120,221
https://kawalpemilu.org#25865,"CEMPAKA PUTIH BARAT, CEMPAKA PUTIH, JAKARTA PUSAT, DKI JAKARTA",2,108,119,227
https://kawalpemilu.org#25865,"CEMPAKA PUTIH BARAT, CEMPAKA PUTIH, JAKARTA PUSAT, DKI JAKARTA",3,101,144,245
https://kawalpemilu.org#25865,"CEMPAKA PUTIH BARAT, CEMPAKA PUTIH, JAKARTA PUSAT, DKI JAKARTA",4,148,91,239
https://kawalpemilu.org#25865,"CEMPAKA PUTIH BARAT, CEMPAKA PUTIH, JAKARTA PUSAT, DKI JAKARTA",5,103,120,223
https://kawalpemilu.org#25865,"CEMPAKA PUTIH BARAT, CEMPAKA PUTIH, JAKARTA PUSAT, DKI JAKARTA",6,103,131,234
https://kawalpemilu.org#25865,"CEMPAKA PUTIH BARAT, CEMPAKA PUTIH, JAKARTA PUSAT, DKI JAKARTA",7,98,126,224
https://kawalpemilu.org#25865,"CEMPAKA PUTIH BARAT, CEMPAKA PUTIH, JAKARTA PUSAT, DKI JAKARTA",8,132,127,259
https://kawalpemilu.org#25865,"CEMPAKA PUTIH BARAT, CEMPAKA PUTIH, JAKARTA PUSAT, DKI JAKARTA",9,104,156,260
https://kawalpemilu.org#25865,"CEMPAKA PUTIH BARAT, CEMPAKA PUTIH, JAKARTA PUSAT, DKI JAKARTA",10,85,165,250
https://kawalpemilu.org#25865,"CEMPAKA PUTIH BARAT, CEMPAKA PUTIH, JAKARTA PUSAT, DKI JAKARTA",11,137,114,251
https://kawalpemilu.org#25865,"CEMPAKA PUTIH BARAT, CEMPAKA PUTIH, JAKARTA PUSAT, DKI JAKARTA",12,120,89,209
https://kawalpemilu.org#25865,"CEMPAKA PUTIH BARAT, CEMPAKA PUTIH, JAKARTA PUSAT, DKI JAKARTA",13,109,94,203
https://kawalpemilu.org#25865,"CEMPAKA PUTIH BARAT, CEMPAKA PUTIH, JAKARTA PUSAT, DKI JAKARTA",14,107,120,227
https://kawalpemilu.org#25865,"CEMPAKA PUTIH BARAT, CEMPAKA PUTIH, JAKARTA PUSAT, DKI JAKARTA",15,94,95,189
https://kawalpemilu.org#25865,"CEMPAKA PUTIH BARAT, CEMPAKA PUTIH, JAKARTA PUSAT, DKI JAKARTA",16,95,138,233
https://kawalpemilu.org#25865,"CEMPAKA PUTIH BARAT, CEMPAKA PUTIH, JAKARTA PUSAT, DKI JAKARTA",17,73,124,197
https://kawalpemilu.org#25865,"CEMPAKA PUTIH BARAT, CEMPAKA PUTIH, JAKARTA PUSAT, DKI JAKARTA",18,92,111,203
https://kawalpemilu.org#25865,"CEMPAKA PUTIH BARAT, CEMPAKA PUTIH, JAKARTA PUSAT, DKI JAKARTA",19,99,120,219
https://kawalpemilu.org#25865,"CEMPAKA PUTIH BARAT, CEMPAKA PUTIH, JAKARTA PUSAT, DKI JAKARTA",20,85,141,226
https://kawalpemilu.org#25865,"CEMPAKA PUTIH BARAT, CEMPAKA PUTIH, JAKARTA PUSAT, DKI JAKARTA",21,146,68,214
https://kawalpemilu.org#25865,"CEMPAKA PUTIH BARAT, CEMPAKA PUTIH, JAKARTA PUSAT, DKI JAKARTA",22,131,88,219
https://kawalpemilu.org#25865,"CEMPAKA PUTIH BARAT, CEMPAKA PUTIH, JAKARTA PUSAT, DKI JAKARTA",23,119,92,211
https://kawalpemilu.org#25865,"CEMPAKA PUTIH BARAT, CEMPAKA PUTIH, JAKARTA PUSAT, DKI JAKARTA",24,125,91,216
https://kawalpemilu.org#25865,"CEMPAKA PUTIH BARAT, CEMPAKA PUTIH, JAKARTA PUSAT, DKI JAKARTA",25,123,46,169
https://kawalpemilu.org#25865,"CEMPAKA PUTIH BARAT, CEMPAKA PUTIH, JAKARTA PUSAT, DKI JAKARTA",26,142,62,204
https://kawalpemilu.org#25865,"CEMPAKA PUTIH BARAT, CEMPAKA PUTIH, JAKARTA PUSAT, DKI JAKARTA",27,147,65,212
https://kawalpemilu.org#25865,"CEMPAKA PUTIH BARAT, CEMPAKA PUTIH, JAKARTA PUSAT, DKI JAKARTA",28,89,162,251
https://kawalpemilu.org#25865,"CEMPAKA PUTIH BARAT, CEMPAKA PUTIH, JAKARTA PUSAT, DKI JAKARTA",29,122,132,254
https://kawalpemilu.org#25865,"CEMPAKA PUTIH BARAT, CEMPAKA PUTIH, JAKARTA PUSAT, DKI JAKARTA",30,74,127,201
https://kawalpemilu.org#25865,"CEMPAKA PUTIH BARAT, CEMPAKA PUTIH, JAKARTA PUSAT, DKI JAKARTA",31,101,126,227
https://kawalpemilu.org#25865,"CEMPAKA PUTIH BARAT, CEMPAKA PUTIH, JAKARTA PUSAT, DKI JAKARTA",32,99,144,243
https://kawalpemilu.org#25865,"CEMPAKA PUTIH BARAT, CEMPAKA PUTIH, JAKARTA PUSAT, DKI JAKARTA",33,140,73,213
https://kawalpemilu.org#25865,"CEMPAKA PUTIH BARAT, CEMPAKA PUTIH, JAKARTA PUSAT, DKI JAKARTA",34,118,112,230
https://kawalpemilu.org#25865,"CEMPAKA PUTIH BARAT, CEMPAKA PUTIH, JAKARTA PUSAT, DKI JAKARTA",35,122,104,226
https://kawalpemilu.org#25865,"CEMPAKA PUTIH BARAT, CEMPAKA PUTIH, JAKARTA PUSAT, DKI JAKARTA",36,149,73,222
https://kawalpemilu.org#25865,"CEMPAKA PUTIH BARAT, CEMPAKA PUTIH, JAKARTA PUSAT, DKI JAKARTA",37,123,122,245
https://kawalpemilu.org#25865,"CEMPAKA PUTIH BARAT, CEMPAKA PUTIH, JAKARTA PUSAT, DKI JAKARTA",38,105,119,224
https://kawalpemilu.org#25865,"CEMPAKA PUTIH BARAT, CEMPAKA PUTIH, JAKARTA PUSAT, DKI JAKARTA",39,98,130,228
https://kawalpemilu.org#25865,"CEMPAKA PUTIH BARAT, CEMPAKA PUTIH, JAKARTA PUSAT, DKI JAKARTA",40,89,145,234
https://kawalpemilu.org#25865,"CEMPAKA PUTIH BARAT, CEMPAKA PUTIH, JAKARTA PUSAT, DKI JAKARTA",41,80,162,242
https://kawalpemilu.org#25865,"CEMPAKA PUTIH BARAT, CEMPAKA PUTIH, JAKARTA PUSAT, DKI JAKARTA",42,61,157,218
https://kawalpemilu.org#25865,"CEMPAKA PUTIH BARAT, CEMPAKA PUTIH, JAKARTA PUSAT, DKI JAKARTA",43,103,138,241
https://kawalpemilu.org#25865,"CEMPAKA PUTIH BARAT, CEMPAKA PUTIH, JAKARTA PUSAT, DKI JAKARTA",44,84,147,231
https://kawalpemilu.org#25865,"CEMPAKA PUTIH BARAT, CEMPAKA PUTIH, JAKARTA PUSAT, DKI JAKARTA",45,103,122,225
https://kawalpemilu.org#25865,"CEMPAKA PUTIH BARAT, CEMPAKA PUTIH, JAKARTA PUSAT, DKI JAKARTA",46,89,115,204
https://kawalpemilu.org#25865,"CEMPAKA PUTIH BARAT, CEMPAKA PUTIH, JAKARTA PUSAT, DKI JAKARTA",47,103,129,232
https://kawalpemilu.org#25865,"CEMPAKA PUTIH BARAT, CEMPAKA PUTIH, JAKARTA PUSAT, DKI JAKARTA",48,111,98,209
https://kawalpemilu.org#25865,"CEMPAKA PUTIH BARAT, CEMPAKA PUTIH, JAKARTA PUSAT, DKI JAKARTA",49,131,124,255
https://kawalpemilu.org#25865,"CEMPAKA PUTIH BARAT, CEMPAKA PUTIH, JAKARTA PUSAT, DKI JAKARTA",50,116,129,245
https://kawalpemilu.org#25865,"CEMPAKA PUTIH BARAT, CEMPAKA PUTIH, JAKARTA PUSAT, DKI JAKARTA",51,82,139,221
https://kawalpemilu.org#25865,"CEMPAKA PUTIH BARAT, CEMPAKA PUTIH, JAKARTA PUSAT, DKI JAKARTA",53,94,127,221
https://kawalpemilu.org#25865,"CEMPAKA PUTIH BARAT, CEMPAKA PUTIH, JAKARTA PUSAT, DKI JAKARTA",54,83,132,215
https://kawalpemilu.org#25865,"CEMPAKA PUTIH BARAT, CEMPAKA PUTIH, JAKARTA PUSAT, DKI JAKARTA",55,102,115,217
https://kawalpemilu.org#25865,"CEMPAKA PUTIH BARAT, CEMPAKA PUTIH, JAKARTA PUSAT, DKI JAKARTA",56,82,136,218
https://kawalpemilu.org#25865,"CEMPAKA PUTIH BARAT, CEMPAKA PUTIH, JAKARTA PUSAT, DKI JAKARTA",57,64,146,210
https://kawalpemilu.org#25865,"CEMPAKA PUTIH BARAT, CEMPAKA PUTIH, JAKARTA PUSAT, DKI JAKARTA",58,99,114,213
https://kawalpemilu.org#25865,"CEMPAKA PUTIH BARAT, CEMPAKA PUTIH, JAKARTA PUSAT, DKI JAKARTA",59,129,88,217
https://kawalpemilu.org#25865,"CEMPAKA PUTIH BARAT, CEMPAKA PUTIH, JAKARTA PUSAT, DKI JAKARTA",60,120,116,236
https://kawalpemilu.org#25865,"CEMPAKA PUTIH BARAT, CEMPAKA PUTIH, JAKARTA PUSAT, DKI JAKARTA",61,162,74,236
https://kawalpemilu.org#25865,"CEMPAKA PUTIH BARAT, CEMPAKA PUTIH, JAKARTA PUSAT, DKI JAKARTA",62,123,116,239
https://kawalpemilu.org#25865,"CEMPAKA PUTIH BARAT, CEMPAKA PUTIH, JAKARTA PUSAT, DKI JAKARTA",63,91,136,227
https://kawalpemilu.org#25865,"CEMPAKA PUTIH BARAT, CEMPAKA PUTIH, JAKARTA PUSAT, DKI JAKARTA",64,103,123,226
https://kawalpemilu.org#25865,"CEMPAKA PUTIH BARAT, CEMPAKA PUTIH, JAKARTA PUSAT, DKI JAKARTA",65,118,116,234
https://kawalpemilu.org#25865,"CEMPAKA PUTIH BARAT, CEMPAKA PUTIH, JAKARTA PUSAT, DKI JAKARTA",66,148,71,219
https://kawalpemilu.org#25865,"CEMPAKA PUTIH BARAT, CEMPAKA PUTIH, JAKARTA PUSAT, DKI JAKARTA",67,89,142,231
https://kawalpemilu.org#25865,"CEMPAKA PUTIH BARAT, CEMPAKA PUTIH, JAKARTA PUSAT, DKI JAKARTA",68,95,137,232
https://kawalpemilu.org#25865,"CEMPAKA PUTIH BARAT, CEMPAKA PUTIH, JAKARTA PUSAT, DKI JAKARTA",69,75,143,218
https://kawalpemilu.org#25865,"CEMPAKA PUTIH BARAT, CEMPAKA PUTIH, JAKARTA PUSAT, DKI JAKARTA",70,99,128,227
https://kawalpemilu.org#25865,"CEMPAKA PUTIH BARAT, CEMPAKA PUTIH, JAKARTA PUSAT, DKI JAKARTA",71,137,90,227
https://kawalpemilu.org#25865,"CEMPAKA PUTIH BARAT, CEMPAKA PUTIH, JAKARTA PUSAT, DKI JAKARTA",72,152,97,249
https://kawalpemilu.org#25865,"CEMPAKA PUTIH BARAT, CEMPAKA PUTIH, JAKARTA PUSAT, DKI JAKARTA",73,107,124,231
https://kawalpemilu.org#25865,"CEMPAKA PUTIH BARAT, CEMPAKA PUTIH, JAKARTA PUSAT, DKI JAKARTA",74,114,123,237
https://kawalpemilu.org#25865,"CEMPAKA PUTIH BARAT, CEMPAKA PUTIH, JAKARTA PUSAT, DKI JAKARTA",75,120,116,236
https://kawalpemilu.org#25865,"CEMPAKA PUTIH BARAT, CEMPAKA PUTIH, JAKARTA PUSAT, DKI JAKARTA",76,77,155,232
https://kawalpemilu.org#25865,"CEMPAKA PUTIH BARAT, CEMPAKA PUTIH, JAKARTA PUSAT, DKI JAKARTA",77,103,145,248
https://kawalpemilu.org#25865,"CEMPAKA PUTIH BARAT, CEMPAKA PUTIH, JAKARTA PUSAT, DKI JAKARTA",78,89,163,252
https://kawalpemilu.org#25865,"CEMPAKA PUTIH BARAT, CEMPAKA PUTIH, JAKARTA PUSAT, DKI JAKARTA",79,74,167,241
https://kawalpemilu.org#25865,"CEMPAKA PUTIH BARAT, CEMPAKA PUTIH, JAKARTA PUSAT, DKI JAKARTA",80,114,101,215
https://kawalpemilu.org#25865,"CEMPAKA PUTIH BARAT, CEMPAKA PUTIH, JAKARTA PUSAT, DKI JAKARTA",81,103,123,226
https://kawalpemilu.org#25865,"CEMPAKA PUTIH BARAT, CEMPAKA PUTIH, JAKARTA PUSAT, DKI JAKARTA",82,100,135,235
https://kawalpemilu.org#25865,"CEMPAKA PUTIH BARAT, CEMPAKA PUTIH, JAKARTA PUSAT, DKI JAKARTA",83,103,144,247
https://kawalpemilu.org#25865,"CEMPAKA PUTIH BARAT, CEMPAKA PUTIH, JAKARTA PUSAT, DKI JAKARTA",84,103,118,221
https://kawalpemilu.org#25865,"CEMPAKA PUTIH BARAT, CEMPAKA PUTIH, JAKARTA PUSAT, DKI JAKARTA",85,99,158,257
https://kawalpemilu.org#25865,"CEMPAKA PUTIH BARAT, CEMPAKA PUTIH, JAKARTA PUSAT, DKI JAKARTA",86,107,138,2
https://kawalpemilu.org#25865,"CEMPAKA PUTIH BARAT, CEMPAKA PUTIH, JAKARTA PUSAT, DKI JAKARTA",87,112,156,268
https://kawalpemilu.org#25865,"CEMPAKA PUTIH BARAT, CEMPAKA PUTIH, JAKARTA PUSAT, DKI JAKARTA",88,87,158,245
https://kawalpemilu.org#25865,"CEMPAKA PUTIH BARAT, CEMPAKA PUTIH, JAKARTA PUSAT, DKI JAKARTA",89,75,168,243
https://kawalpemilu.org#25865,"CEMPAKA PUTIH BARAT, CEMPAKA PUTIH, JAKARTA PUSAT, DKI JAKARTA",90,101,145,246
https://kawalpemilu.org#25865,"CEMPAKA PUTIH BARAT, CEMPAKA PUTIH, JAKARTA PUSAT, DKI JAKARTA",91,53,202,255
https://kawalpemilu.org#25865,"CEMPAKA PUTIH BARAT, CEMPAKA PUTIH, JAKARTA PUSAT, DKI JAKARTA",92,79,173,252
https://kawalpemilu.org#25865,"CEMPAKA PUTIH BARAT, CEMPAKA PUTIH, JAKARTA PUSAT, DKI JAKARTA",93,115,138,253
https://kawalpemilu.org#25865,"CEMPAKA PUTIH BARAT, CEMPAKA PUTIH, JAKARTA PUSAT, DKI JAKARTA",94,89,165,254
https://kawalpemilu.org#25865,"CEMPAKA PUTIH BARAT, CEMPAKA PUTIH, JAKARTA PUSAT, DKI JAKARTA",95,99,156,255
https://kawalpemilu.org#25865,"CEMPAKA PUTIH BARAT, CEMPAKA PUTIH, JAKARTA PUSAT, DKI JAKARTA",96,98,159,257
https://kawalpemilu.org#25865,"CEMPAKA PUTIH BARAT, CEMPAKA PUTIH, JAKARTA PUSAT, DKI JAKARTA",97,81,130,211
https://kawalpemilu.org#25865,"CEMPAKA PUTIH BARAT, CEMPAKA PUTIH, JAKARTA PUSAT, DKI JAKARTA",98,103,149,252
https://kawalpemilu.org#25865,"CEMPAKA PUTIH BARAT, CEMPAKA PUTIH, JAKARTA PUSAT, DKI JAKARTA",99,81,170,251
https://kawalpemilu.org#25865,"CEMPAKA PUTIH BARAT, CEMPAKA PUTIH, JAKARTA PUSAT, DKI JAKARTA",100,107,122,229
https://kawalpemilu.org#25865,"CEMPAKA PUTIH BARAT, CEMPAKA PUTIH, JAKARTA PUSAT, DKI JAKARTA",101,126,122,248
https://kawalpemilu.org#25865,"CEMPAKA PUTIH BARAT, CEMPAKA PUTIH, JAKARTA PUSAT, DKI JAKARTA",102,77,162,239
https://kawalpemilu.org#25865,"CEMPAKA PUTIH BARAT, CEMPAKA PUTIH, JAKARTA PUSAT, DKI JAKARTA",103,105,145,250
https://kawalpemilu.org#25865,"CEMPAKA PUTIH BARAT, CEMPAKA PUTIH, JAKARTA PUSAT, DKI JAKARTA",104,130,135,265
https://kawalpemilu.org#25865,"CEMPAKA PUTIH BARAT, CEMPAKA PUTIH, JAKARTA PUSAT, DKI JAKARTA",105,97,156,253
https://kawalpemilu.org#25865,"CEMPAKA PUTIH BARAT, CEMPAKA PUTIH, JAKARTA PUSAT, DKI JAKARTA",106,95,149,244
https://kawalpemilu.org#25865,"CEMPAKA PUTIH BARAT, CEMPAKA PUTIH, JAKARTA PUSAT, DKI JAKARTA",107,118,116,234
https://kawalpemilu.org#25865,"CEMPAKA PUTIH BARAT, CEMPAKA PUTIH, JAKARTA PUSAT, DKI JAKARTA",108,114,134,248
https://kawalpemilu.org#25865,"CEMPAKA PUTIH BARAT, CEMPAKA PUTIH, JAKARTA PUSAT, DKI JAKARTA",109,93,154,247
https://kawalpemilu.org#25865,"CEMPAKA PUTIH BARAT, CEMPAKA PUTIH, JAKARTA PUSAT, DKI JAKARTA",110,104,128,232
https://kawalpemilu.org#25865,"CEMPAKA PUTIH BARAT, CEMPAKA PUTIH, JAKARTA PUSAT, DKI JAKARTA",111,125,109,234
https://kawalpemilu.org#25866,"RAWASARI, CEMPAKA PUTIH, JAKARTA PUSAT, DKI JAKARTA",1,97,151,248
https://kawalpemilu.org#25866,"RAWASARI, CEMPAKA PUTIH, JAKARTA PUSAT, DKI JAKARTA",2,133,96,229
https://kawalpemilu.org#25866,"RAWASARI, CEMPAKA PUTIH, JAKARTA PUSAT, DKI JAKARTA",3,106,144,250
https://kawalpemilu.org#25866,"RAWASARI, CEMPAKA PUTIH, JAKARTA PUSAT, DKI JAKARTA",4,100,154,254
https://kawalpemilu.org#25866,"RAWASARI, CEMPAKA PUTIH, JAKARTA PUSAT, DKI JAKARTA",5,111,94,205
https://kawalpemilu.org#25866,"RAWASARI, CEMPAKA PUTIH, JAKARTA PUSAT, DKI JAKARTA",6,113,141,254
https://kawalpemilu.org#25866,"RAWASARI, CEMPAKA PUTIH, JAKARTA PUSAT, DKI JAKARTA",7,97,107,204
https://kawalpemilu.org#25866,"RAWASARI, CEMPAKA PUTIH, JAKARTA PUSAT, DKI JAKARTA",8,103,114,217
https://kawalpemilu.org#25866,"RAWASARI, CEMPAKA PUTIH, JAKARTA PUSAT, DKI JAKARTA",9,92,131,223
https://kawalpemilu.org#25866,"RAWASARI, CEMPAKA PUTIH, JAKARTA PUSAT, DKI JAKARTA",10,114,123,237
https://kawalpemilu.org#25866,"RAWASARI, CEMPAKA PUTIH, JAKARTA PUSAT, DKI JAKARTA",11,117,117,234
https://kawalpemilu.org#25866,"RAWASARI, CEMPAKA PUTIH, JAKARTA PUSAT, DKI JAKARTA",12,127,107,234
https://kawalpemilu.org#25866,"RAWASARI, CEMPAKA PUTIH, JAKARTA PUSAT, DKI JAKARTA",13,118,119,237
https://kawalpemilu.org#25866,"RAWASARI, CEMPAKA PUTIH, JAKARTA PUSAT, DKI JAKARTA",14,96,128,224
https://kawalpemilu.org#25866,"RAWASARI, CEMPAKA PUTIH, JAKARTA PUSAT, DKI JAKARTA",15,105,143,248
https://kawalpemilu.org#25866,"RAWASARI, CEMPAKA PUTIH, JAKARTA PUSAT, DKI JAKARTA",16,129,90,219
https://kawalpemilu.org#25866,"RAWASARI, CEMPAKA PUTIH, JAKARTA PUSAT, DKI JAKARTA",17,86,100,186
https://kawalpemilu.org#25866,"RAWASARI, CEMPAKA PUTIH, JAKARTA PUSAT, DKI JAKARTA",18,105,113,218
https://kawalpemilu.org#25866,"RAWASARI, CEMPAKA PUTIH, JAKARTA PUSAT, DKI JAKARTA",19,109,113,222
https://kawalpemilu.org#25866,"RAWASARI, CEMPAKA PUTIH, JAKARTA PUSAT, DKI JAKARTA",20,108,134,242
https://kawalpemilu.org#25866,"RAWASARI, CEMPAKA PUTIH, JAKARTA PUSAT, DKI JAKARTA",21,110,112,222
https://kawalpemilu.org#25866,"RAWASARI, CEMPAKA PUTIH, JAKARTA PUSAT, DKI JAKARTA",22,132,87,219
https://kawalpemilu.org#25866,"RAWASARI, CEMPAKA PUTIH, JAKARTA PUSAT, DKI JAKARTA",23,123,114,237
https://kawalpemilu.org#25866,"RAWASARI, CEMPAKA PUTIH, JAKARTA PUSAT, DKI JAKARTA",24,95,135,230
https://kawalpemilu.org#25866,"RAWASARI, CEMPAKA PUTIH, JAKARTA PUSAT, DKI JAKARTA",25,130,78,208
https://kawalpemilu.org#25866,"RAWASARI, CEMPAKA PUTIH, JAKARTA PUSAT, DKI JAKARTA",26,117,74,191
https://kawalpemilu.org#25866,"RAWASARI, CEMPAKA PUTIH, JAKARTA PUSAT, DKI JAKARTA",27,120,92,212
https://kawalpemilu.org#25866,"RAWASARI, CEMPAKA PUTIH, JAKARTA PUSAT, DKI JAKARTA",28,103,119,222
https://kawalpemilu.org#25866,"RAWASARI, CEMPAKA PUTIH, JAKARTA PUSAT, DKI JAKARTA",29,112,130,242
https://kawalpemilu.org#25866,"RAWASARI, CEMPAKA PUTIH, JAKARTA PUSAT, DKI JAKARTA",30,95,139,234
https://kawalpemilu.org#25866,"RAWASARI, CEMPAKA PUTIH, JAKARTA PUSAT, DKI JAKARTA",31,122,126,248
https://kawalpemilu.org#25866,"RAWASARI, CEMPAKA PUTIH, JAKARTA PUSAT, DKI JAKARTA",32,97,107,204
https://kawalpemilu.org#25866,"RAWASARI, CEMPAKA PUTIH, JAKARTA PUSAT, DKI JAKARTA",33,70,105,175
https://kawalpemilu.org#25866,"RAWASARI, CEMPAKA PUTIH, JAKARTA PUSAT, DKI JAKARTA",34,115,80,195
https://kawalpemilu.org#25866,"RAWASARI, CEMPAKA PUTIH, JAKARTA PUSAT, DKI JAKARTA",35,125,124,249
https://kawalpemilu.org#25866,"RAWASARI, CEMPAKA PUTIH, JAKARTA PUSAT, DKI JAKARTA",36,110,128,238
https://kawalpemilu.org#25866,"RAWASARI, CEMPAKA PUTIH, JAKARTA PUSAT, DKI JAKARTA",37,101,148,249
https://kawalpemilu.org#25866,"RAWASARI, CEMPAKA PUTIH, JAKARTA PUSAT, DKI JAKARTA",38,79,123,202
https://kawalpemilu.org#25866,"RAWASARI, CEMPAKA PUTIH, JAKARTA PUSAT, DKI JAKARTA",39,75,114,189
https://kawalpemilu.org#25866,"RAWASARI, CEMPAKA PUTIH, JAKARTA PUSAT, DKI JAKARTA",40,118,129,247
https://kawalpemilu.org#25866,"RAWASARI, CEMPAKA PUTIH, JAKARTA PUSAT, DKI JAKARTA",41,89,150,239
https://kawalpemilu.org#25866,"RAWASARI, CEMPAKA PUTIH, JAKARTA PUSAT, DKI JAKARTA",42,91,163,254
https://kawalpemilu.org#25866,"RAWASARI, CEMPAKA PUTIH, JAKARTA PUSAT, DKI JAKARTA",43,80,152,232
https://kawalpemilu.org#25866,"RAWASARI, CEMPAKA PUTIH, JAKARTA PUSAT, DKI JAKARTA",44,113,132,245
https://kawalpemilu.org#25866,"RAWASARI, CEMPAKA PUTIH, JAKARTA PUSAT, DKI JAKARTA",45,96,133,229
https://kawalpemilu.org#25866,"RAWASARI, CEMPAKA PUTIH, JAKARTA PUSAT, DKI JAKARTA",46,116,89,205
https://kawalpemilu.org#25866,"RAWASARI, CEMPAKA PUTIH, JAKARTA PUSAT, DKI JAKARTA",47,123,60,183
https://kawalpemilu.org#25866,"RAWASARI, CEMPAKA PUTIH, JAKARTA PUSAT, DKI JAKARTA",48,119,120,239
https://kawalpemilu.org#25866,"RAWASARI, CEMPAKA PUTIH, JAKARTA PUSAT, DKI JAKARTA",49,91,162,253
https://kawalpemilu.org#25866,"RAWASARI, CEMPAKA PUTIH, JAKARTA PUSAT, DKI JAKARTA",50,97,174,271
https://kawalpemilu.org#25866,"RAWASARI, CEMPAKA PUTIH, JAKARTA PUSAT, DKI JAKARTA",51,79,154,233
https://kawalpemilu.org#25866,"RAWASARI, CEMPAKA PUTIH, JAKARTA PUSAT, DKI JAKARTA",52,111,110,221
https://kawalpemilu.org#25866,"RAWASARI, CEMPAKA PUTIH, JAKARTA PUSAT, DKI JAKARTA",53,92,117,209
https://kawalpemilu.org#25866,"RAWASARI, CEMPAKA PUTIH, JAKARTA PUSAT, DKI JAKARTA",54,91,145,236
https://kawalpemilu.org#25866,"RAWASARI, CEMPAKA PUTIH, JAKARTA PUSAT, DKI JAKARTA",55,97,115,212
https://kawalpemilu.org#25866,"RAWASARI, CEMPAKA PUTIH, JAKARTA PUSAT, DKI JAKARTA",56,78,126,204
https://kawalpemilu.org#25866,"RAWASARI, CEMPAKA PUTIH, JAKARTA PUSAT, DKI JAKARTA",57,112,140,252
https://kawalpemilu.org#25866,"RAWASARI, CEMPAKA PUTIH, JAKARTA PUSAT, DKI JAKARTA",58,97,127,224
https://kawalpemilu.org#25866,"RAWASARI, CEMPAKA PUTIH, JAKARTA PUSAT, DKI JAKARTA",59,131,122,253
https://kawalpemilu.org#25866,"RAWASARI, CEMPAKA PUTIH, JAKARTA PUSAT, DKI JAKARTA",60,98,105,203
https://kawalpemilu.org#25866,"RAWASARI, CEMPAKA PUTIH, JAKARTA PUSAT, DKI JAKARTA",61,107,95,202
https://kawalpemilu.org#25866,"RAWASARI, CEMPAKA PUTIH, JAKARTA PUSAT, DKI JAKARTA",62,87,109,196
https://kawalpemilu.org#25866,"RAWASARI, CEMPAKA PUTIH, JAKARTA PUSAT, DKI JAKARTA",63,125,90,215
https://kawalpemilu.org#25866,"RAWASARI, CEMPAKA PUTIH, JAKARTA PUSAT, DKI JAKARTA",64,166,75,241
https://kawalpemilu.org#25866,"RAWASARI, CEMPAKA PUTIH, JAKARTA PUSAT, DKI JAKARTA",65,165,95,260
https://kawalpemilu.org#25866,"RAWASARI, CEMPAKA PUTIH, JAKARTA PUSAT, DKI JAKARTA",66,143,102,245
https://kawalpemilu.org#25866,"RAWASARI, CEMPAKA PUTIH, JAKARTA PUSAT, DKI JAKARTA",67,138,108,2
https://kawalpemilu.org#25866,"RAWASARI, CEMPAKA PUTIH, JAKARTA PUSAT, DKI JAKARTA",68,159,87,246
https://kawalpemilu.org#25866,"RAWASARI, CEMPAKA PUTIH, JAKARTA PUSAT, DKI JAKARTA",69,115,160,275
https://kawalpemilu.org#25866,"RAWASARI, CEMPAKA PUTIH, JAKARTA PUSAT, DKI JAKARTA",70,99,158,257
https://kawalpemilu.org#25866,"RAWASARI, CEMPAKA PUTIH, JAKARTA PUSAT, DKI JAKARTA",71,78,113,191
https://kawalpemilu.org#25866,"RAWASARI, CEMPAKA PUTIH, JAKARTA PUSAT, DKI JAKARTA",72,88,123,211
https://kawalpemilu.org#25866,"RAWASARI, CEMPAKA PUTIH, JAKARTA PUSAT, DKI JAKARTA",73,111,94,205
https://kawalpemilu.org#25866,"RAWASARI, CEMPAKA PUTIH, JAKARTA PUSAT, DKI JAKARTA",74,84,118,202
https://kawalpemilu.org#25866,"RAWASARI, CEMPAKA PUTIH, JAKARTA PUSAT, DKI JAKARTA",75,82,115,197
https://kawalpemilu.org#25866,"RAWASARI, CEMPAKA PUTIH, JAKARTA PUSAT, DKI JAKARTA",76,88,109,197
https://kawalpemilu.org#25866,"RAWASARI, CEMPAKA PUTIH, JAKARTA PUSAT, DKI JAKARTA",77,85,107,192
https://kawalpemilu.org#25868,"MENTENG, MENTENG, JAKARTA PUSAT, DKI JAKARTA",1,118,129,247
https://kawalpemilu.org#25868,"MENTENG, MENTENG, JAKARTA PUSAT, DKI JAKARTA",2,97,137,234
https://kawalpemilu.org#25868,"MENTENG, MENTENG, JAKARTA PUSAT, DKI JAKARTA",3,76,158,234
https://kawalpemilu.org#25868,"MENTENG, MENTENG, JAKARTA PUSAT, DKI JAKARTA",4,77,169,246
https://kawalpemilu.org#25868,"MENTENG, MENTENG, JAKARTA PUSAT, DKI JAKARTA",5,63,169,232
https://kawalpemilu.org#25868,"MENTENG, MENTENG, JAKARTA PUSAT, DKI JAKARTA",6,99,119,218
https://kawalpemilu.org#25868,"MENTENG, MENTENG, JAKARTA PUSAT, DKI JAKARTA",7,67,165,232
https://kawalpemilu.org#25868,"MENTENG, MENTENG, JAKARTA PUSAT, DKI JAKARTA",8,87,153,240
https://kawalpemilu.org#25868,"MENTENG, MENTENG, JAKARTA PUSAT, DKI JAKARTA",9,71,149,220
https://kawalpemilu.org#25868,"MENTENG, MENTENG, JAKARTA PUSAT, DKI JAKARTA",10,92,121,213
https://kawalpemilu.org#25868,"MENTENG, MENTENG, JAKARTA PUSAT, DKI JAKARTA",11,59,164,223
https://kawalpemilu.org#25868,"MENTENG, MENTENG, JAKARTA PUSAT, DKI JAKARTA",12,60,153,213
https://kawalpemilu.org#25868,"MENTENG, MENTENG, JAKARTA PUSAT, DKI JAKARTA",13,75,154,229
https://kawalpemilu.org#25868,"MENTENG, MENTENG, JAKARTA PUSAT, DKI JAKARTA",14,144,74,218
https://kawalpemilu.org#25868,"MENTENG, MENTENG, JAKARTA PUSAT, DKI JAKARTA",15,100,126,226
https://kawalpemilu.org#25868,"MENTENG, MENTENG, JAKARTA PUSAT, DKI JAKARTA",16,130,121,251
https://kawalpemilu.org#25868,"MENTENG, MENTENG, JAKARTA PUSAT, DKI JAKARTA",17,113,149,262
https://kawalpemilu.org#25868,"MENTENG, MENTENG, JAKARTA PUSAT, DKI JAKARTA",18,103,141,244
https://kawalpemilu.org#25868,"MENTENG, MENTENG, JAKARTA PUSAT, DKI JAKARTA",19,82,140,222
https://kawalpemilu.org#25868,"MENTENG, MENTENG, JAKARTA PUSAT, DKI JAKARTA",20,98,126,224
https://kawalpemilu.org#25868,"MENTENG, MENTENG, JAKARTA PUSAT, DKI JAKARTA",21,100,115,215
https://kawalpemilu.org#25868,"MENTENG, MENTENG, JAKARTA PUSAT, DKI JAKARTA",22,95,143,238
https://kawalpemilu.org#25868,"MENTENG, MENTENG, JAKARTA PUSAT, DKI JAKARTA",23,85,158,243
https://kawalpemilu.org#25868,"MENTENG, MENTENG, JAKARTA PUSAT, DKI JAKARTA",24,68,150,218
https://kawalpemilu.org#25868,"MENTENG, MENTENG, JAKARTA PUSAT, DKI JAKARTA",25,93,108,201
https://kawalpemilu.org#25868,"MENTENG, MENTENG, JAKARTA PUSAT, DKI JAKARTA",26,61,141,202
https://kawalpemilu.org#25868,"MENTENG, MENTENG, JAKARTA PUSAT, DKI JAKARTA",27,82,126,208
https://kawalpemilu.org#25868,"MENTENG, MENTENG, JAKARTA PUSAT, DKI JAKARTA",28,100,120,220
https://kawalpemilu.org#25868,"MENTENG, MENTENG, JAKARTA PUSAT, DKI JAKARTA",29,111,120,231
https://kawalpemilu.org#25868,"MENTENG, MENTENG, JAKARTA PUSAT, DKI JAKARTA",30,82,163,245
https://kawalpemilu.org#25868,"MENTENG, MENTENG, JAKARTA PUSAT, DKI JAKARTA",31,88,131,219
https://kawalpemilu.org#25868,"MENTENG, MENTENG, JAKARTA PUSAT, DKI JAKARTA",32,103,123,226
https://kawalpemilu.org#25868,"MENTENG, MENTENG, JAKARTA PUSAT, DKI JAKARTA",33,103,126,229
https://kawalpemilu.org#25868,"MENTENG, MENTENG, JAKARTA PUSAT, DKI JAKARTA",34,69,194,263
https://kawalpemilu.org#25868,"MENTENG, MENTENG, JAKARTA PUSAT, DKI JAKARTA",35,136,64,200
https://kawalpemilu.org#25868,"MENTENG, MENTENG, JAKARTA PUSAT, DKI JAKARTA",36,149,57,206
https://kawalpemilu.org#25868,"MENTENG, MENTENG, JAKARTA PUSAT, DKI JAKARTA",37,157,39,196
https://kawalpemilu.org#25868,"MENTENG, MENTENG, JAKARTA PUSAT, DKI JAKARTA",38,194,53,247
https://kawalpemilu.org#25868,"MENTENG, MENTENG, JAKARTA PUSAT, DKI JAKARTA",39,166,24,190
https://kawalpemilu.org#25868,"MENTENG, MENTENG, JAKARTA PUSAT, DKI JAKARTA",40,175,52,227
https://kawalpemilu.org#25868,"MENTENG, MENTENG, JAKARTA PUSAT, DKI JAKARTA",41,185,43,228
https://kawalpemilu.org#25868,"MENTENG, MENTENG, JAKARTA PUSAT, DKI JAKARTA",42,157,52,209
https://kawalpemilu.org#25868,"MENTENG, MENTENG, JAKARTA PUSAT, DKI JAKARTA",43,157,57,214
https://kawalpemilu.org#25868,"MENTENG, MENTENG, JAKARTA PUSAT, DKI JAKARTA",44,178,55,233
https://kawalpemilu.org#25868,"MENTENG, MENTENG, JAKARTA PUSAT, DKI JAKARTA",45,124,53,177
https://kawalpemilu.org#25868,"MENTENG, MENTENG, JAKARTA PUSAT, DKI JAKARTA",46,137,56,193
https://kawalpemilu.org#25868,"MENTENG, MENTENG, JAKARTA PUSAT, DKI JAKARTA",47,137,59,196
https://kawalpemilu.org#25868,"MENTENG, MENTENG, JAKARTA PUSAT, DKI JAKARTA",48,167,46,213
https://kawalpemilu.org#25868,"MENTENG, MENTENG, JAKARTA PUSAT, DKI JAKARTA",49,173,23,196
https://kawalpemilu.org#25868,"MENTENG, MENTENG, JAKARTA PUSAT, DKI JAKARTA",50,146,54,200
https://kawalpemilu.org#25868,"MENTENG, MENTENG, JAKARTA PUSAT, DKI JAKARTA",51,144,55,199
https://kawalpemilu.org#25868,"MENTENG, MENTENG, JAKARTA PUSAT, DKI JAKARTA",52,117,64,181
https://kawalpemilu.org#25868,"MENTENG, MENTENG, JAKARTA PUSAT, DKI JAKARTA",53,136,46,182
https://kawalpemilu.org#25868,"MENTENG, MENTENG, JAKARTA PUSAT, DKI JAKARTA",54,94,180,274
https://kawalpemilu.org#25868,"MENTENG, MENTENG, JAKARTA PUSAT, DKI JAKARTA",55,67,183,250
https://kawalpemilu.org#25868,"MENTENG, MENTENG, JAKARTA PUSAT, DKI JAKARTA",56,65,190,255
https://kawalpemilu.org#25868,"MENTENG, MENTENG, JAKARTA PUSAT, DKI JAKARTA",57,75,168,243
https://kawalpemilu.org#25868,"MENTENG, MENTENG, JAKARTA PUSAT, DKI JAKARTA",58,70,155,225
https://kawalpemilu.org#25868,"MENTENG, MENTENG, JAKARTA PUSAT, DKI JAKARTA",59,78,169,247
https://kawalpemilu.org#25868,"MENTENG, MENTENG, JAKARTA PUSAT, DKI JAKARTA",60,67,169,236
https://kawalpemilu.org#25868,"MENTENG, MENTENG, JAKARTA PUSAT, DKI JAKARTA",61,84,154,238
https://kawalpemilu.org#25868,"MENTENG, MENTENG, JAKARTA PUSAT, DKI JAKARTA",62,77,136,213
https://kawalpemilu.org#25868,"MENTENG, MENTENG, JAKARTA PUSAT, DKI JAKARTA",63,105,128,233
https://kawalpemilu.org#25868,"MENTENG, MENTENG, JAKARTA PUSAT, DKI JAKARTA",64,97,108,205
https://kawalpemilu.org#25868,"MENTENG, MENTENG, JAKARTA PUSAT, DKI JAKARTA",65,80,121,201
https://kawalpemilu.org#25868,"MENTENG, MENTENG, JAKARTA PUSAT, DKI JAKARTA",66,80,148,228
https://kawalpemilu.org#25868,"MENTENG, MENTENG, JAKARTA PUSAT, DKI JAKARTA",67,81,168,249
https://kawalpemilu.org#25868,"MENTENG, MENTENG, JAKARTA PUSAT, DKI JAKARTA",68,70,185,255
https://kawalpemilu.org#25868,"MENTENG, MENTENG, JAKARTA PUSAT, DKI JAKARTA",69,64,168,232
https://kawalpemilu.org#25868,"MENTENG, MENTENG, JAKARTA PUSAT, DKI JAKARTA",70,109,135,244
https://kawalpemilu.org#25868,"MENTENG, MENTENG, JAKARTA PUSAT, DKI JAKARTA",71,104,128,232
https://kawalpemilu.org#25868,"MENTENG, MENTENG, JAKARTA PUSAT, DKI JAKARTA",72,93,124,217
https://kawalpemilu.org#25868,"MENTENG, MENTENG, JAKARTA PUSAT, DKI JAKARTA",73,86,137,223
https://kawalpemilu.org#25868,"MENTENG, MENTENG, JAKARTA PUSAT, DKI JAKARTA",74,91,148,239
https://kawalpemilu.org#25868,"MENTENG, MENTENG, JAKARTA PUSAT, DKI JAKARTA",75,94,132,226
https://kawalpemilu.org#25868,"MENTENG, MENTENG, JAKARTA PUSAT, DKI JAKARTA",76,86,144,230
https://kawalpemilu.org#25868,"MENTENG, MENTENG, JAKARTA PUSAT, DKI JAKARTA",77,119,110,229
https://kawalpemilu.org#25868,"MENTENG, MENTENG, JAKARTA PUSAT, DKI JAKARTA",78,83,124,207
https://kawalpemilu.org#25868,"MENTENG, MENTENG, JAKARTA PUSAT, DKI JAKARTA",79,74,143,217
https://kawalpemilu.org#25868,"MENTENG, MENTENG, JAKARTA PUSAT, DKI JAKARTA",80,84,156,240
https://kawalpemilu.org#25868,"MENTENG, MENTENG, JAKARTA PUSAT, DKI JAKARTA",81,85,143,228
https://kawalpemilu.org#25868,"MENTENG, MENTENG, JAKARTA PUSAT, DKI JAKARTA",82,78,161,239
https://kawalpemilu.org#25868,"MENTENG, MENTENG, JAKARTA PUSAT, DKI JAKARTA",83,100,139,239
https://kawalpemilu.org#25869,"PEGANGSAAN, MENTENG, JAKARTA PUSAT, DKI JAKARTA",1,112,134,246
https://kawalpemilu.org#25869,"PEGANGSAAN, MENTENG, JAKARTA PUSAT, DKI JAKARTA",2,105,149,254
https://kawalpemilu.org#25869,"PEGANGSAAN, MENTENG, JAKARTA PUSAT, DKI JAKARTA",3,98,136,234
https://kawalpemilu.org#25869,"PEGANGSAAN, MENTENG, JAKARTA PUSAT, DKI JAKARTA",4,87,103,190
https://kawalpemilu.org#25869,"PEGANGSAAN, MENTENG, JAKARTA PUSAT, DKI JAKARTA",5,87,131,218
https://kawalpemilu.org#25869,"PEGANGSAAN, MENTENG, JAKARTA PUSAT, DKI JAKARTA",6,102,130,232
https://kawalpemilu.org#25869,"PEGANGSAAN, MENTENG, JAKARTA PUSAT, DKI JAKARTA",7,104,91,195
https://kawalpemilu.org#25869,"PEGANGSAAN, MENTENG, JAKARTA PUSAT, DKI JAKARTA",8,71,149,220
https://kawalpemilu.org#25869,"PEGANGSAAN, MENTENG, JAKARTA PUSAT, DKI JAKARTA",9,105,107,212
https://kawalpemilu.org#25869,"PEGANGSAAN, MENTENG, JAKARTA PUSAT, DKI JAKARTA",10,87,164,251
https://kawalpemilu.org#25869,"PEGANGSAAN, MENTENG, JAKARTA PUSAT, DKI JAKARTA",11,93,142,235
https://kawalpemilu.org#25869,"PEGANGSAAN, MENTENG, JAKARTA PUSAT, DKI JAKARTA",12,113,111,224
https://kawalpemilu.org#25869,"PEGANGSAAN, MENTENG, JAKARTA PUSAT, DKI JAKARTA",13,91,143,234
https://kawalpemilu.org#25869,"PEGANGSAAN, MENTENG, JAKARTA PUSAT, DKI JAKARTA",14,80,132,212
https://kawalpemilu.org#25869,"PEGANGSAAN, MENTENG, JAKARTA PUSAT, DKI JAKARTA",15,104,94,198
https://kawalpemilu.org#25869,"PEGANGSAAN, MENTENG, JAKARTA PUSAT, DKI JAKARTA",16,70,137,207
https://kawalpemilu.org#25869,"PEGANGSAAN, MENTENG, JAKARTA PUSAT, DKI JAKARTA",17,63,137,200
https://kawalpemilu.org#25869,"PEGANGSAAN, MENTENG, JAKARTA PUSAT, DKI JAKARTA",18,127,67,194
https://kawalpemilu.org#25869,"PEGANGSAAN, MENTENG, JAKARTA PUSAT, DKI JAKARTA",19,124,89,213
https://kawalpemilu.org#25869,"PEGANGSAAN, MENTENG, JAKARTA PUSAT, DKI JAKARTA",20,77,105,182
https://kawalpemilu.org#25869,"PEGANGSAAN, MENTENG, JAKARTA PUSAT, DKI JAKARTA",21,51,147,198
https://kawalpemilu.org#25869,"PEGANGSAAN, MENTENG, JAKARTA PUSAT, DKI JAKARTA",22,61,129,190
https://kawalpemilu.org#25869,"PEGANGSAAN, MENTENG, JAKARTA PUSAT, DKI JAKARTA",23,71,119,190
https://kawalpemilu.org#25869,"PEGANGSAAN, MENTENG, JAKARTA PUSAT, DKI JAKARTA",24,95,99,194
https://kawalpemilu.org#25869,"PEGANGSAAN, MENTENG, JAKARTA PUSAT, DKI JAKARTA",25,84,97,181
https://kawalpemilu.org#25869,"PEGANGSAAN, MENTENG, JAKARTA PUSAT, DKI JAKARTA",26,109,105,214
https://kawalpemilu.org#25869,"PEGANGSAAN, MENTENG, JAKARTA PUSAT, DKI JAKARTA",27,106,123,229
https://kawalpemilu.org#25869,"PEGANGSAAN, MENTENG, JAKARTA PUSAT, DKI JAKARTA",28,107,94,201
https://kawalpemilu.org#25869,"PEGANGSAAN, MENTENG, JAKARTA PUSAT, DKI JAKARTA",29,75,126,201
https://kawalpemilu.org#25869,"PEGANGSAAN, MENTENG, JAKARTA PUSAT, DKI JAKARTA",30,114,79,193
https://kawalpemilu.org#25869,"PEGANGSAAN, MENTENG, JAKARTA PUSAT, DKI JAKARTA",31,141,62,203
https://kawalpemilu.org#25869,"PEGANGSAAN, MENTENG, JAKARTA PUSAT, DKI JAKARTA",32,116,74,190
https://kawalpemilu.org#25869,"PEGANGSAAN, MENTENG, JAKARTA PUSAT, DKI JAKARTA",33,124,86,210
https://kawalpemilu.org#25869,"PEGANGSAAN, MENTENG, JAKARTA PUSAT, DKI JAKARTA",34,150,49,199
https://kawalpemilu.org#25869,"PEGANGSAAN, MENTENG, JAKARTA PUSAT, DKI JAKARTA",35,134,61,195
https://kawalpemilu.org#25869,"PEGANGSAAN, MENTENG, JAKARTA PUSAT, DKI JAKARTA",36,123,94,217
https://kawalpemilu.org#25869,"PEGANGSAAN, MENTENG, JAKARTA PUSAT, DKI JAKARTA",37,76,145,221
https://kawalpemilu.org#25869,"PEGANGSAAN, MENTENG, JAKARTA PUSAT, DKI JAKARTA",38,101,101,202
https://kawalpemilu.org#25869,"PEGANGSAAN, MENTENG, JAKARTA PUSAT, DKI JAKARTA",39,75,184,259
https://kawalpemilu.org#25869,"PEGANGSAAN, MENTENG, JAKARTA PUSAT, DKI JAKARTA",40,71,181,252
https://kawalpemilu.org#25869,"PEGANGSAAN, MENTENG, JAKARTA PUSAT, DKI JAKARTA",41,114,127,241
https://kawalpemilu.org#25869,"PEGANGSAAN, MENTENG, JAKARTA PUSAT, DKI JAKARTA",42,139,104,243
https://kawalpemilu.org#25869,"PEGANGSAAN, MENTENG, JAKARTA PUSAT, DKI JAKARTA",43,109,129,238
https://kawalpemilu.org#25869,"PEGANGSAAN, MENTENG, JAKARTA PUSAT, DKI JAKARTA",44,96,150,246
https://kawalpemilu.org#25869,"PEGANGSAAN, MENTENG, JAKARTA PUSAT, DKI JAKARTA",45,82,163,245
https://kawalpemilu.org#25869,"PEGANGSAAN, MENTENG, JAKARTA PUSAT, DKI JAKARTA",46,96,133,229
https://kawalpemilu.org#25869,"PEGANGSAAN, MENTENG, JAKARTA PUSAT, DKI JAKARTA",47,112,121,233
https://kawalpemilu.org#25869,"PEGANGSAAN, MENTENG, JAKARTA PUSAT, DKI JAKARTA",48,102,140,242
https://kawalpemilu.org#25869,"PEGANGSAAN, MENTENG, JAKARTA PUSAT, DKI JAKARTA",49,98,130,228
https://kawalpemilu.org#25869,"PEGANGSAAN, MENTENG, JAKARTA PUSAT, DKI JAKARTA",50,99,118,217
https://kawalpemilu.org#25869,"PEGANGSAAN, MENTENG, JAKARTA PUSAT, DKI JAKARTA",51,152,67,219
https://kawalpemilu.org#25869,"PEGANGSAAN, MENTENG, JAKARTA PUSAT, DKI JAKARTA",52,75,166,241
https://kawalpemilu.org#25869,"PEGANGSAAN, MENTENG, JAKARTA PUSAT, DKI JAKARTA",53,90,107,197
https://kawalpemilu.org#25869,"PEGANGSAAN, MENTENG, JAKARTA PUSAT, DKI JAKARTA",54,76,117,193
https://kawalpemilu.org#25869,"PEGANGSAAN, MENTENG, JAKARTA PUSAT, DKI JAKARTA",55,65,148,213
https://kawalpemilu.org#25869,"PEGANGSAAN, MENTENG, JAKARTA PUSAT, DKI JAKARTA",56,129,104,233
https://kawalpemilu.org#25869,"PEGANGSAAN, MENTENG, JAKARTA PUSAT, DKI JAKARTA",57,124,92,216
https://kawalpemilu.org#25869,"PEGANGSAAN, MENTENG, JAKARTA PUSAT, DKI JAKARTA",58,94,117,211
https://kawalpemilu.org#25869,"PEGANGSAAN, MENTENG, JAKARTA PUSAT, DKI JAKARTA",59,73,154,227
https://kawalpemilu.org#25869,"PEGANGSAAN, MENTENG, JAKARTA PUSAT, DKI JAKARTA",60,54,154,208
https://kawalpemilu.org#25869,"PEGANGSAAN, MENTENG, JAKARTA PUSAT, DKI JAKARTA",61,90,117,207
https://kawalpemilu.org#25869,"PEGANGSAAN, MENTENG, JAKARTA PUSAT, DKI JAKARTA",62,77,136,213
https://kawalpemilu.org#25869,"PEGANGSAAN, MENTENG, JAKARTA PUSAT, DKI JAKARTA",63,98,131,229
https://kawalpemilu.org#25869,"PEGANGSAAN, MENTENG, JAKARTA PUSAT, DKI JAKARTA",64,123,111,234
https://kawalpemilu.org#25869,"PEGANGSAAN, MENTENG, JAKARTA PUSAT, DKI JAKARTA",65,89,146,235
https://kawalpemilu.org#25869,"PEGANGSAAN, MENTENG, JAKARTA PUSAT, DKI JAKARTA",66,98,115,213
https://kawalpemilu.org#25869,"PEGANGSAAN, MENTENG, JAKARTA PUSAT, DKI JAKARTA",67,68,168,236
https://kawalpemilu.org#25869,"PEGANGSAAN, MENTENG, JAKARTA PUSAT, DKI JAKARTA",68,41,198,239
https://kawalpemilu.org#25869,"PEGANGSAAN, MENTENG, JAKARTA PUSAT, DKI JAKARTA",69,60,147,207
https://kawalpemilu.org#25869,"PEGANGSAAN, MENTENG, JAKARTA PUSAT, DKI JAKARTA",70,55,163,218
https://kawalpemilu.org#25869,"PEGANGSAAN, MENTENG, JAKARTA PUSAT, DKI JAKARTA",71,118,131,249
https://kawalpemilu.org#25869,"PEGANGSAAN, MENTENG, JAKARTA PUSAT, DKI JAKARTA",72,135,92,227
https://kawalpemilu.org#25869,"PEGANGSAAN, MENTENG, JAKARTA PUSAT, DKI JAKARTA",73,55,143,198
https://kawalpemilu.org#25869,"PEGANGSAAN, MENTENG, JAKARTA PUSAT, DKI JAKARTA",74,67,149,216
https://kawalpemilu.org#25869,"PEGANGSAAN, MENTENG, JAKARTA PUSAT, DKI JAKARTA",75,58,153,211
https://kawalpemilu.org#25869,"PEGANGSAAN, MENTENG, JAKARTA PUSAT, DKI JAKARTA",76,104,122,226
https://kawalpemilu.org#25869,"PEGANGSAAN, MENTENG, JAKARTA PUSAT, DKI JAKARTA",77,89,152,241
https://kawalpemilu.org#25869,"PEGANGSAAN, MENTENG, JAKARTA PUSAT, DKI JAKARTA",78,99,125,6
https://kawalpemilu.org#25869,"PEGANGSAAN, MENTENG, JAKARTA PUSAT, DKI JAKARTA",79,66,169,235
https://kawalpemilu.org#25870,"CIKINI, MENTENG, JAKARTA PUSAT, DKI JAKARTA",1,101,83,184
https://kawalpemilu.org#25870,"CIKINI, MENTENG, JAKARTA PUSAT, DKI JAKARTA",2,98,114,212
https://kawalpemilu.org#25870,"CIKINI, MENTENG, JAKARTA PUSAT, DKI JAKARTA",3,118,101,219
https://kawalpemilu.org#25870,"CIKINI, MENTENG, JAKARTA PUSAT, DKI JAKARTA",4,110,130,240
https://kawalpemilu.org#25870,"CIKINI, MENTENG, JAKARTA PUSAT, DKI JAKARTA",5,107,110,217
https://kawalpemilu.org#25870,"CIKINI, MENTENG, JAKARTA PUSAT, DKI JAKARTA",6,94,134,228
https://kawalpemilu.org#25870,"CIKINI, MENTENG, JAKARTA PUSAT, DKI JAKARTA",7,77,117,194
https://kawalpemilu.org#25870,"CIKINI, MENTENG, JAKARTA PUSAT, DKI JAKARTA",8,80,127,207
https://kawalpemilu.org#25870,"CIKINI, MENTENG, JAKARTA PUSAT, DKI JAKARTA",9,55,119,174
https://kawalpemilu.org#25870,"CIKINI, MENTENG, JAKARTA PUSAT, DKI JAKARTA",10,62,161,223
https://kawalpemilu.org#25870,"CIKINI, MENTENG, JAKARTA PUSAT, DKI JAKARTA",11,78,144,222
https://kawalpemilu.org#25870,"CIKINI, MENTENG, JAKARTA PUSAT, DKI JAKARTA",12,43,198,241
https://kawalpemilu.org#25870,"CIKINI, MENTENG, JAKARTA PUSAT, DKI JAKARTA",13,64,140,204
https://kawalpemilu.org#25870,"CIKINI, MENTENG, JAKARTA PUSAT, DKI JAKARTA",14,94,110,204
https://kawalpemilu.org#25870,"CIKINI, MENTENG, JAKARTA PUSAT, DKI JAKARTA",15,81,100,181
https://kawalpemilu.org#25870,"CIKINI, MENTENG, JAKARTA PUSAT, DKI JAKARTA",16,75,129,204
https://kawalpemilu.org#25870,"CIKINI, MENTENG, JAKARTA PUSAT, DKI JAKARTA",17,108,136,244
https://kawalpemilu.org#25870,"CIKINI, MENTENG, JAKARTA PUSAT, DKI JAKARTA",18,121,98,219
https://kawalpemilu.org#25870,"CIKINI, MENTENG, JAKARTA PUSAT, DKI JAKARTA",19,99,109,208
https://kawalpemilu.org#25870,"CIKINI, MENTENG, JAKARTA PUSAT, DKI JAKARTA",20,105,124,229
https://kawalpemilu.org#25870,"CIKINI, MENTENG, JAKARTA PUSAT, DKI JAKARTA",21,87,133,220
https://kawalpemilu.org#25870,"CIKINI, MENTENG, JAKARTA PUSAT, DKI JAKARTA",22,100,133,233
https://kawalpemilu.org#25870,"CIKINI, MENTENG, JAKARTA PUSAT, DKI JAKARTA",23,68,154,222
https://kawalpemilu.org#25870,"CIKINI, MENTENG, JAKARTA PUSAT, DKI JAKARTA",24,207,26,233
https://kawalpemilu.org#25870,"CIKINI, MENTENG, JAKARTA PUSAT, DKI JAKARTA",25,173,37,210
https://kawalpemilu.org#25870,"CIKINI, MENTENG, JAKARTA PUSAT, DKI JAKARTA",26,142,54,196
https://kawalpemilu.org#25870,"CIKINI, MENTENG, JAKARTA PUSAT, DKI JAKARTA",27,125,29,154
https://kawalpemilu.org#25870,"CIKINI, MENTENG, JAKARTA PUSAT, DKI JAKARTA",28,158,48,206
https://kawalpemilu.org#25870,"CIKINI, MENTENG, JAKARTA PUSAT, DKI JAKARTA",29,125,72,197
https://kawalpemilu.org#25870,"CIKINI, MENTENG, JAKARTA PUSAT, DKI JAKARTA",30,66,123,189
https://kawalpemilu.org#25871,"GONDANGDIA, MENTENG, JAKARTA PUSAT, DKI JAKARTA",1,187,38,225
https://kawalpemilu.org#25871,"GONDANGDIA, MENTENG, JAKARTA PUSAT, DKI JAKARTA",2,147,75,222
https://kawalpemilu.org#25871,"GONDANGDIA, MENTENG, JAKARTA PUSAT, DKI JAKARTA",3,163,70,233
https://kawalpemilu.org#25871,"GONDANGDIA, MENTENG, JAKARTA PUSAT, DKI JAKARTA",4,172,89,261
https://kawalpemilu.org#25871,"GONDANGDIA, MENTENG, JAKARTA PUSAT, DKI JAKARTA",5,141,97,238
https://kawalpemilu.org#25871,"GONDANGDIA, MENTENG, JAKARTA PUSAT, DKI JAKARTA",6,206,23,229
https://kawalpemilu.org#25871,"GONDANGDIA, MENTENG, JAKARTA PUSAT, DKI JAKARTA",7,183,46,229
https://kawalpemilu.org#25871,"GONDANGDIA, MENTENG, JAKARTA PUSAT, DKI JAKARTA",8,155,58,213
https://kawalpemilu.org#25871,"GONDANGDIA, MENTENG, JAKARTA PUSAT, DKI JAKARTA",9,173,27,200
https://kawalpemilu.org#25871,"GONDANGDIA, MENTENG, JAKARTA PUSAT, DKI JAKARTA",10,152,61,213
https://kawalpemilu.org#25871,"GONDANGDIA, MENTENG, JAKARTA PUSAT, DKI JAKARTA",11,163,48,211
https://kawalpemilu.org#25871,"GONDANGDIA, MENTENG, JAKARTA PUSAT, DKI JAKARTA",12,186,27,213
https://kawalpemilu.org#25871,"GONDANGDIA, MENTENG, JAKARTA PUSAT, DKI JAKARTA",13,169,44,213
https://kawalpemilu.org#25871,"GONDANGDIA, MENTENG, JAKARTA PUSAT, DKI JAKARTA",14,139,40,179
https://kawalpemilu.org#25872,"KEBON SIRIH, MENTENG, JAKARTA PUSAT, DKI JAKARTA",1,228,18,246
https://kawalpemilu.org#25872,"KEBON SIRIH, MENTENG, JAKARTA PUSAT, DKI JAKARTA",2,116,108,224
https://kawalpemilu.org#25872,"KEBON SIRIH, MENTENG, JAKARTA PUSAT, DKI JAKARTA",3,96,127,223
https://kawalpemilu.org#25872,"KEBON SIRIH, MENTENG, JAKARTA PUSAT, DKI JAKARTA",4,118,110,228
https://kawalpemilu.org#25872,"KEBON SIRIH, MENTENG, JAKARTA PUSAT, DKI JAKARTA",5,134,104,238
https://kawalpemilu.org#25872,"KEBON SIRIH, MENTENG, JAKARTA PUSAT, DKI JAKARTA",6,105,110,215
https://kawalpemilu.org#25872,"KEBON SIRIH, MENTENG, JAKARTA PUSAT, DKI JAKARTA",7,101,123,224
https://kawalpemilu.org#25872,"KEBON SIRIH, MENTENG, JAKARTA PUSAT, DKI JAKARTA",8,86,119,205
https://kawalpemilu.org#25872,"KEBON SIRIH, MENTENG, JAKARTA PUSAT, DKI JAKARTA",9,87,151,238
https://kawalpemilu.org#25872,"KEBON SIRIH, MENTENG, JAKARTA PUSAT, DKI JAKARTA",10,102,115,217
https://kawalpemilu.org#25872,"KEBON SIRIH, MENTENG, JAKARTA PUSAT, DKI JAKARTA",11,100,116,216
https://kawalpemilu.org#25872,"KEBON SIRIH, MENTENG, JAKARTA PUSAT, DKI JAKARTA",12,83,136,219
https://kawalpemilu.org#25872,"KEBON SIRIH, MENTENG, JAKARTA PUSAT, DKI JAKARTA",13,106,114,220
https://kawalpemilu.org#25872,"KEBON SIRIH, MENTENG, JAKARTA PUSAT, DKI JAKARTA",14,66,143,209
https://kawalpemilu.org#25872,"KEBON SIRIH, MENTENG, JAKARTA PUSAT, DKI JAKARTA",15,102,120,222
https://kawalpemilu.org#25872,"KEBON SIRIH, MENTENG, JAKARTA PUSAT, DKI JAKARTA",16,83,149,232
https://kawalpemilu.org#25872,"KEBON SIRIH, MENTENG, JAKARTA PUSAT, DKI JAKARTA",17,83,92,175
https://kawalpemilu.org#25872,"KEBON SIRIH, MENTENG, JAKARTA PUSAT, DKI JAKARTA",18,170,19,189
https://kawalpemilu.org#25872,"KEBON SIRIH, MENTENG, JAKARTA PUSAT, DKI JAKARTA",19,168,87,255
https://kawalpemilu.org#25872,"KEBON SIRIH, MENTENG, JAKARTA PUSAT, DKI JAKARTA",20,97,139,236
https://kawalpemilu.org#25872,"KEBON SIRIH, MENTENG, JAKARTA PUSAT, DKI JAKARTA",21,71,167,238
https://kawalpemilu.org#25872,"KEBON SIRIH, MENTENG, JAKARTA PUSAT, DKI JAKARTA",22,56,204,260
https://kawalpemilu.org#25872,"KEBON SIRIH, MENTENG, JAKARTA PUSAT, DKI JAKARTA",23,44,199,243
https://kawalpemilu.org#25872,"KEBON SIRIH, MENTENG, JAKARTA PUSAT, DKI JAKARTA",24,75,175,250
https://kawalpemilu.org#25872,"KEBON SIRIH, MENTENG, JAKARTA PUSAT, DKI JAKARTA",25,103,122,225
https://kawalpemilu.org#25872,"KEBON SIRIH, MENTENG, JAKARTA PUSAT, DKI JAKARTA",26,111,134,245
https://kawalpemilu.org#25872,"KEBON SIRIH, MENTENG, JAKARTA PUSAT, DKI JAKARTA",27,84,116,200
https://kawalpemilu.org#25872,"KEBON SIRIH, MENTENG, JAKARTA PUSAT, DKI JAKARTA",28,79,173,252
https://kawalpemilu.org#25872,"KEBON SIRIH, MENTENG, JAKARTA PUSAT, DKI JAKARTA",29,85,143,228
https://kawalpemilu.org#25872,"KEBON SIRIH, MENTENG, JAKARTA PUSAT, DKI JAKARTA",30,89,132,221
https://kawalpemilu.org#25872,"KEBON SIRIH, MENTENG, JAKARTA PUSAT, DKI JAKARTA",31,82,144,226
https://kawalpemilu.org#25872,"KEBON SIRIH, MENTENG, JAKARTA PUSAT, DKI JAKARTA",32,93,131,224
https://kawalpemilu.org#25872,"KEBON SIRIH, MENTENG, JAKARTA PUSAT, DKI JAKARTA",33,88,117,205
https://kawalpemilu.org#25872,"KEBON SIRIH, MENTENG, JAKARTA PUSAT, DKI JAKARTA",34,67,133,200
https://kawalpemilu.org#25872,"KEBON SIRIH, MENTENG, JAKARTA PUSAT, DKI JAKARTA",35,57,140,197
https://kawalpemilu.org#25872,"KEBON SIRIH, MENTENG, JAKARTA PUSAT, DKI JAKARTA",36,94,154,248
https://kawalpemilu.org#25872,"KEBON SIRIH, MENTENG, JAKARTA PUSAT, DKI JAKARTA",37,61,171,232
https://kawalpemilu.org#25872,"KEBON SIRIH, MENTENG, JAKARTA PUSAT, DKI JAKARTA",38,91,150,241
https://kawalpemilu.org#25872,"KEBON SIRIH, MENTENG, JAKARTA PUSAT, DKI JAKARTA",39,105,140,245
https://kawalpemilu.org#25872,"KEBON SIRIH, MENTENG, JAKARTA PUSAT, DKI JAKARTA",40,111,131,242
https://kawalpemilu.org#25874,"GELORA, TANAH ABANG, JAKARTA PUSAT, DKI JAKARTA",1,143,62,205
https://kawalpemilu.org#25874,"GELORA, TANAH ABANG, JAKARTA PUSAT, DKI JAKARTA",2,164,74,238
https://kawalpemilu.org#25874,"GELORA, TANAH ABANG, JAKARTA PUSAT, DKI JAKARTA",3,172,35,207
https://kawalpemilu.org#25874,"GELORA, TANAH ABANG, JAKARTA PUSAT, DKI JAKARTA",4,167,39,206
https://kawalpemilu.org#25874,"GELORA, TANAH ABANG, JAKARTA PUSAT, DKI JAKARTA",5,151,25,176
https://kawalpemilu.org#25874,"GELORA, TANAH ABANG, JAKARTA PUSAT, DKI JAKARTA",6,108,99,207
https://kawalpemilu.org#25874,"GELORA, TANAH ABANG, JAKARTA PUSAT, DKI JAKARTA",7,131,87,218
https://kawalpemilu.org#25874,"GELORA, TANAH ABANG, JAKARTA PUSAT, DKI JAKARTA",8,194,99,205
https://kawalpemilu.org#25874,"GELORA, TANAH ABANG, JAKARTA PUSAT, DKI JAKARTA",9,123,98,221
https://kawalpemilu.org#25874,"GELORA, TANAH ABANG, JAKARTA PUSAT, DKI JAKARTA",10,115,86,201
https://kawalpemilu.org#25874,"GELORA, TANAH ABANG, JAKARTA PUSAT, DKI JAKARTA",11,124,83,207
https://kawalpemilu.org#25875,"BENDUNGAN HILIR, TANAH ABANG, JAKARTA PUSAT, DKI JAKARTA",1,148,62,210
https://kawalpemilu.org#25875,"BENDUNGAN HILIR, TANAH ABANG, JAKARTA PUSAT, DKI JAKARTA",2,156,54,210
https://kawalpemilu.org#25875,"BENDUNGAN HILIR, TANAH ABANG, JAKARTA PUSAT, DKI JAKARTA",3,115,116,231
https://kawalpemilu.org#25875,"BENDUNGAN HILIR, TANAH ABANG, JAKARTA PUSAT, DKI JAKARTA",4,103,98,201
https://kawalpemilu.org#25875,"BENDUNGAN HILIR, TANAH ABANG, JAKARTA PUSAT, DKI JAKARTA",5,69,103,172
https://kawalpemilu.org#25875,"BENDUNGAN HILIR, TANAH ABANG, JAKARTA PUSAT, DKI JAKARTA",6,113,94,207
https://kawalpemilu.org#25875,"BENDUNGAN HILIR, TANAH ABANG, JAKARTA PUSAT, DKI JAKARTA",7,156,54,210
https://kawalpemilu.org#25875,"BENDUNGAN HILIR, TANAH ABANG, JAKARTA PUSAT, DKI JAKARTA",8,129,44,173
https://kawalpemilu.org#25875,"BENDUNGAN HILIR, TANAH ABANG, JAKARTA PUSAT, DKI JAKARTA",9,172,72,244
https://kawalpemilu.org#25875,"BENDUNGAN HILIR, TANAH ABANG, JAKARTA PUSAT, DKI JAKARTA",10,159,75,234
https://kawalpemilu.org#25875,"BENDUNGAN HILIR, TANAH ABANG, JAKARTA PUSAT, DKI JAKARTA",11,126,68,194
https://kawalpemilu.org#25875,"BENDUNGAN HILIR, TANAH ABANG, JAKARTA PUSAT, DKI JAKARTA",12,135,67,202
https://kawalpemilu.org#25875,"BENDUNGAN HILIR, TANAH ABANG, JAKARTA PUSAT, DKI JAKARTA",13,149,50,199
https://kawalpemilu.org#25875,"BENDUNGAN HILIR, TANAH ABANG, JAKARTA PUSAT, DKI JAKARTA",14,122,62,184
https://kawalpemilu.org#25875,"BENDUNGAN HILIR, TANAH ABANG, JAKARTA PUSAT, DKI JAKARTA",15,135,86,221
https://kawalpemilu.org#25875,"BENDUNGAN HILIR, TANAH ABANG, JAKARTA PUSAT, DKI JAKARTA",16,89,112,201
https://kawalpemilu.org#25875,"BENDUNGAN HILIR, TANAH ABANG, JAKARTA PUSAT, DKI JAKARTA",17,96,117,213
https://kawalpemilu.org#25875,"BENDUNGAN HILIR, TANAH ABANG, JAKARTA PUSAT, DKI JAKARTA",18,167,66,233
https://kawalpemilu.org#25875,"BENDUNGAN HILIR, TANAH ABANG, JAKARTA PUSAT, DKI JAKARTA",19,111,94,205
https://kawalpemilu.org#25875,"BENDUNGAN HILIR, TANAH ABANG, JAKARTA PUSAT, DKI JAKARTA",20,141,80,221
https://kawalpemilu.org#25875,"BENDUNGAN HILIR, TANAH ABANG, JAKARTA PUSAT, DKI JAKARTA",21,124,91,215
https://kawalpemilu.org#25875,"BENDUNGAN HILIR, TANAH ABANG, JAKARTA PUSAT, DKI JAKARTA",22,131,96,227
https://kawalpemilu.org#25875,"BENDUNGAN HILIR, TANAH ABANG, JAKARTA PUSAT, DKI JAKARTA",23,95,84,179
https://kawalpemilu.org#25875,"BENDUNGAN HILIR, TANAH ABANG, JAKARTA PUSAT, DKI JAKARTA",24,118,75,193
https://kawalpemilu.org#25875,"BENDUNGAN HILIR, TANAH ABANG, JAKARTA PUSAT, DKI JAKARTA",25,121,69,190
https://kawalpemilu.org#25875,"BENDUNGAN HILIR, TANAH ABANG, JAKARTA PUSAT, DKI JAKARTA",26,102,60,162
https://kawalpemilu.org#25875,"BENDUNGAN HILIR, TANAH ABANG, JAKARTA PUSAT, DKI JAKARTA",27,82,95,177
https://kawalpemilu.org#25875,"BENDUNGAN HILIR, TANAH ABANG, JAKARTA PUSAT, DKI JAKARTA",28,106,97,203
https://kawalpemilu.org#25875,"BENDUNGAN HILIR, TANAH ABANG, JAKARTA PUSAT, DKI JAKARTA",29,147,77,224
https://kawalpemilu.org#25875,"BENDUNGAN HILIR, TANAH ABANG, JAKARTA PUSAT, DKI JAKARTA",30,132,93,225
https://kawalpemilu.org#25875,"BENDUNGAN HILIR, TANAH ABANG, JAKARTA PUSAT, DKI JAKARTA",31,123,88,211
https://kawalpemilu.org#25875,"BENDUNGAN HILIR, TANAH ABANG, JAKARTA PUSAT, DKI JAKARTA",32,136,63,199
https://kawalpemilu.org#25875,"BENDUNGAN HILIR, TANAH ABANG, JAKARTA PUSAT, DKI JAKARTA",33,114,66,180
https://kawalpemilu.org#25875,"BENDUNGAN HILIR, TANAH ABANG, JAKARTA PUSAT, DKI JAKARTA",34,117,74,191
https://kawalpemilu.org#25875,"BENDUNGAN HILIR, TANAH ABANG, JAKARTA PUSAT, DKI JAKARTA",35,112,80,192
https://kawalpemilu.org#25875,"BENDUNGAN HILIR, TANAH ABANG, JAKARTA PUSAT, DKI JAKARTA",36,74,104,178
https://kawalpemilu.org#25875,"BENDUNGAN HILIR, TANAH ABANG, JAKARTA PUSAT, DKI JAKARTA",37,111,131,242
https://kawalpemilu.org#25875,"BENDUNGAN HILIR, TANAH ABANG, JAKARTA PUSAT, DKI JAKARTA",38,103,96,199
https://kawalpemilu.org#25875,"BENDUNGAN HILIR, TANAH ABANG, JAKARTA PUSAT, DKI JAKARTA",39,114,92,206
https://kawalpemilu.org#25875,"BENDUNGAN HILIR, TANAH ABANG, JAKARTA PUSAT, DKI JAKARTA",40,99,113,212
https://kawalpemilu.org#25875,"BENDUNGAN HILIR, TANAH ABANG, JAKARTA PUSAT, DKI JAKARTA",41,116,110,226
https://kawalpemilu.org#25875,"BENDUNGAN HILIR, TANAH ABANG, JAKARTA PUSAT, DKI JAKARTA",42,129,87,216
https://kawalpemilu.org#25875,"BENDUNGAN HILIR, TANAH ABANG, JAKARTA PUSAT, DKI JAKARTA",43,128,88,216
https://kawalpemilu.org#25875,"BENDUNGAN HILIR, TANAH ABANG, JAKARTA PUSAT, DKI JAKARTA",44,95,73,168
https://kawalpemilu.org#25875,"BENDUNGAN HILIR, TANAH ABANG, JAKARTA PUSAT, DKI JAKARTA",45,68,85,153
https://kawalpemilu.org#25875,"BENDUNGAN HILIR, TANAH ABANG, JAKARTA PUSAT, DKI JAKARTA",46,119,74,193
https://kawalpemilu.org#25875,"BENDUNGAN HILIR, TANAH ABANG, JAKARTA PUSAT, DKI JAKARTA",47,135,99,234
https://kawalpemilu.org#25875,"BENDUNGAN HILIR, TANAH ABANG, JAKARTA PUSAT, DKI JAKARTA",49,128,84,212
https://kawalpemilu.org#25875,"BENDUNGAN HILIR, TANAH ABANG, JAKARTA PUSAT, DKI JAKARTA",50,113,133,246
https://kawalpemilu.org#25875,"BENDUNGAN HILIR, TANAH ABANG, JAKARTA PUSAT, DKI JAKARTA",51,132,65,197
https://kawalpemilu.org#25875,"BENDUNGAN HILIR, TANAH ABANG, JAKARTA PUSAT, DKI JAKARTA",52,82,105,187
https://kawalpemilu.org#25875,"BENDUNGAN HILIR, TANAH ABANG, JAKARTA PUSAT, DKI JAKARTA",53,88,78,166
https://kawalpemilu.org#25875,"BENDUNGAN HILIR, TANAH ABANG, JAKARTA PUSAT, DKI JAKARTA",54,94,82,176
https://kawalpemilu.org#25875,"BENDUNGAN HILIR, TANAH ABANG, JAKARTA PUSAT, DKI JAKARTA",55,86,89,175
https://kawalpemilu.org#25875,"BENDUNGAN HILIR, TANAH ABANG, JAKARTA PUSAT, DKI JAKARTA",56,112,70,182
https://kawalpemilu.org#25875,"BENDUNGAN HILIR, TANAH ABANG, JAKARTA PUSAT, DKI JAKARTA",57,127,106,233
https://kawalpemilu.org#25875,"BENDUNGAN HILIR, TANAH ABANG, JAKARTA PUSAT, DKI JAKARTA",58,94,152,246
https://kawalpemilu.org#25875,"BENDUNGAN HILIR, TANAH ABANG, JAKARTA PUSAT, DKI JAKARTA",59,111,100,211
https://kawalpemilu.org#25875,"BENDUNGAN HILIR, TANAH ABANG, JAKARTA PUSAT, DKI JAKARTA",60,138,53,191
https://kawalpemilu.org#25875,"BENDUNGAN HILIR, TANAH ABANG, JAKARTA PUSAT, DKI JAKARTA",61,145,58,203
https://kawalpemilu.org#25875,"BENDUNGAN HILIR, TANAH ABANG, JAKARTA PUSAT, DKI JAKARTA",62,171,81,252
https://kawalpemilu.org#25875,"BENDUNGAN HILIR, TANAH ABANG, JAKARTA PUSAT, DKI JAKARTA",63,97,82,179
https://kawalpemilu.org#25875,"BENDUNGAN HILIR, TANAH ABANG, JAKARTA PUSAT, DKI JAKARTA",64,130,51,181
https://kawalpemilu.org#25875,"BENDUNGAN HILIR, TANAH ABANG, JAKARTA PUSAT, DKI JAKARTA",66,125,95,220
https://kawalpemilu.org#25875,"BENDUNGAN HILIR, TANAH ABANG, JAKARTA PUSAT, DKI JAKARTA",67,121,85,206
https://kawalpemilu.org#25875,"BENDUNGAN HILIR, TANAH ABANG, JAKARTA PUSAT, DKI JAKARTA",68,136,40,176
https://kawalpemilu.org#25875,"BENDUNGAN HILIR, TANAH ABANG, JAKARTA PUSAT, DKI JAKARTA",69,95,56,151
https://kawalpemilu.org#25875,"BENDUNGAN HILIR, TANAH ABANG, JAKARTA PUSAT, DKI JAKARTA",70,80,89,169
https://kawalpemilu.org#25875,"BENDUNGAN HILIR, TANAH ABANG, JAKARTA PUSAT, DKI JAKARTA",71,97,79,176
https://kawalpemilu.org#25875,"BENDUNGAN HILIR, TANAH ABANG, JAKARTA PUSAT, DKI JAKARTA",72,120,55,175
https://kawalpemilu.org#25875,"BENDUNGAN HILIR, TANAH ABANG, JAKARTA PUSAT, DKI JAKARTA",73,80,40,120
https://kawalpemilu.org#25875,"BENDUNGAN HILIR, TANAH ABANG, JAKARTA PUSAT, DKI JAKARTA",74,119,70,189
https://kawalpemilu.org#25875,"BENDUNGAN HILIR, TANAH ABANG, JAKARTA PUSAT, DKI JAKARTA",75,145,35,180
https://kawalpemilu.org#25875,"BENDUNGAN HILIR, TANAH ABANG, JAKARTA PUSAT, DKI JAKARTA",76,132,56,188
https://kawalpemilu.org#25875,"BENDUNGAN HILIR, TANAH ABANG, JAKARTA PUSAT, DKI JAKARTA",77,98,53,151
https://kawalpemilu.org#25876,"KARET TENGSIN, TANAH ABANG, JAKARTA PUSAT, DKI JAKARTA",1,183,65,248
https://kawalpemilu.org#25876,"KARET TENGSIN, TANAH ABANG, JAKARTA PUSAT, DKI JAKARTA",2,136,106,242
https://kawalpemilu.org#25876,"KARET TENGSIN, TANAH ABANG, JAKARTA PUSAT, DKI JAKARTA",3,85,95,180
https://kawalpemilu.org#25876,"KARET TENGSIN, TANAH ABANG, JAKARTA PUSAT, DKI JAKARTA",4,140,71,211
https://kawalpemilu.org#25876,"KARET TENGSIN, TANAH ABANG, JAKARTA PUSAT, DKI JAKARTA",5,106,102,208
https://kawalpemilu.org#25876,"KARET TENGSIN, TANAH ABANG, JAKARTA PUSAT, DKI JAKARTA",6,117,141,258
https://kawalpemilu.org#25876,"KARET TENGSIN, TANAH ABANG, JAKARTA PUSAT, DKI JAKARTA",7,108,130,238
https://kawalpemilu.org#25876,"KARET TENGSIN, TANAH ABANG, JAKARTA PUSAT, DKI JAKARTA",8,82,133,215
https://kawalpemilu.org#25876,"KARET TENGSIN, TANAH ABANG, JAKARTA PUSAT, DKI JAKARTA",9,119,119,238
https://kawalpemilu.org#25876,"KARET TENGSIN, TANAH ABANG, JAKARTA PUSAT, DKI JAKARTA",11,55,100,155
https://kawalpemilu.org#25876,"KARET TENGSIN, TANAH ABANG, JAKARTA PUSAT, DKI JAKARTA",12,68,85,153
https://kawalpemilu.org#25876,"KARET TENGSIN, TANAH ABANG, JAKARTA PUSAT, DKI JAKARTA",13,96,96,192
https://kawalpemilu.org#25876,"KARET TENGSIN, TANAH ABANG, JAKARTA PUSAT, DKI JAKARTA",14,83,157,240
https://kawalpemilu.org#25876,"KARET TENGSIN, TANAH ABANG, JAKARTA PUSAT, DKI JAKARTA",15,108,102,210
https://kawalpemilu.org#25876,"KARET TENGSIN, TANAH ABANG, JAKARTA PUSAT, DKI JAKARTA",16,77,112,189
https://kawalpemilu.org#25876,"KARET TENGSIN, TANAH ABANG, JAKARTA PUSAT, DKI JAKARTA",17,72,96,168
https://kawalpemilu.org#25876,"KARET TENGSIN, TANAH ABANG, JAKARTA PUSAT, DKI JAKARTA",18,120,146,266
https://kawalpemilu.org#25876,"KARET TENGSIN, TANAH ABANG, JAKARTA PUSAT, DKI JAKARTA",19,99,139,238
https://kawalpemilu.org#25876,"KARET TENGSIN, TANAH ABANG, JAKARTA PUSAT, DKI JAKARTA",20,89,114,203
https://kawalpemilu.org#25876,"KARET TENGSIN, TANAH ABANG, JAKARTA PUSAT, DKI JAKARTA",21,140,95,235
https://kawalpemilu.org#25876,"KARET TENGSIN, TANAH ABANG, JAKARTA PUSAT, DKI JAKARTA",22,119,114,233
https://kawalpemilu.org#25876,"KARET TENGSIN, TANAH ABANG, JAKARTA PUSAT, DKI JAKARTA",23,114,120,234
https://kawalpemilu.org#25876,"KARET TENGSIN, TANAH ABANG, JAKARTA PUSAT, DKI JAKARTA",24,163,71,234
https://kawalpemilu.org#25876,"KARET TENGSIN, TANAH ABANG, JAKARTA PUSAT, DKI JAKARTA",25,122,95,217
https://kawalpemilu.org#25876,"KARET TENGSIN, TANAH ABANG, JAKARTA PUSAT, DKI JAKARTA",26,91,102,193
https://kawalpemilu.org#25876,"KARET TENGSIN, TANAH ABANG, JAKARTA PUSAT, DKI JAKARTA",27,150,102,252
https://kawalpemilu.org#25876,"KARET TENGSIN, TANAH ABANG, JAKARTA PUSAT, DKI JAKARTA",28,80,167,247
https://kawalpemilu.org#25876,"KARET TENGSIN, TANAH ABANG, JAKARTA PUSAT, DKI JAKARTA",29,82,177,259
https://kawalpemilu.org#25876,"KARET TENGSIN, TANAH ABANG, JAKARTA PUSAT, DKI JAKARTA",30,123,137,260
https://kawalpemilu.org#25876,"KARET TENGSIN, TANAH ABANG, JAKARTA PUSAT, DKI JAKARTA",31,129,110,239
https://kawalpemilu.org#25876,"KARET TENGSIN, TANAH ABANG, JAKARTA PUSAT, DKI JAKARTA",32,100,134,234
https://kawalpemilu.org#25876,"KARET TENGSIN, TANAH ABANG, JAKARTA PUSAT, DKI JAKARTA",33,103,168,271
https://kawalpemilu.org#25876,"KARET TENGSIN, TANAH ABANG, JAKARTA PUSAT, DKI JAKARTA",34,138,102,240
https://kawalpemilu.org#25876,"KARET TENGSIN, TANAH ABANG, JAKARTA PUSAT, DKI JAKARTA",35,116,131,247
https://kawalpemilu.org#25876,"KARET TENGSIN, TANAH ABANG, JAKARTA PUSAT, DKI JAKARTA",36,120,110,230
https://kawalpemilu.org#25876,"KARET TENGSIN, TANAH ABANG, JAKARTA PUSAT, DKI JAKARTA",37,147,83,230
https://kawalpemilu.org#25876,"KARET TENGSIN, TANAH ABANG, JAKARTA PUSAT, DKI JAKARTA",38,116,115,231
https://kawalpemilu.org#25876,"KARET TENGSIN, TANAH ABANG, JAKARTA PUSAT, DKI JAKARTA",39,118,110,228
https://kawalpemilu.org#25876,"KARET TENGSIN, TANAH ABANG, JAKARTA PUSAT, DKI JAKARTA",41,155,95,250
https://kawalpemilu.org#25876,"KARET TENGSIN, TANAH ABANG, JAKARTA PUSAT, DKI JAKARTA",42,122,118,240
https://kawalpemilu.org#25876,"KARET TENGSIN, TANAH ABANG, JAKARTA PUSAT, DKI JAKARTA",47,125,73,198
https://kawalpemilu.org#25876,"KARET TENGSIN, TANAH ABANG, JAKARTA PUSAT, DKI JAKARTA",48,94,101,195
https://kawalpemilu.org#25876,"KARET TENGSIN, TANAH ABANG, JAKARTA PUSAT, DKI JAKARTA",49,103,71,174
https://kawalpemilu.org#25876,"KARET TENGSIN, TANAH ABANG, JAKARTA PUSAT, DKI JAKARTA",50,84,106,190
https://kawalpemilu.org#25876,"KARET TENGSIN, TANAH ABANG, JAKARTA PUSAT, DKI JAKARTA",51,108,108,216
https://kawalpemilu.org#25876,"KARET TENGSIN, TANAH ABANG, JAKARTA PUSAT, DKI JAKARTA",52,149,86,235
https://kawalpemilu.org#25876,"KARET TENGSIN, TANAH ABANG, JAKARTA PUSAT, DKI JAKARTA",53,126,54,180
https://kawalpemilu.org#25876,"KARET TENGSIN, TANAH ABANG, JAKARTA PUSAT, DKI JAKARTA",54,158,44,202
https://kawalpemilu.org#25876,"KARET TENGSIN, TANAH ABANG, JAKARTA PUSAT, DKI JAKARTA",55,129,101,230
https://kawalpemilu.org#25876,"KARET TENGSIN, TANAH ABANG, JAKARTA PUSAT, DKI JAKARTA",56,141,79,220
https://kawalpemilu.org#25876,"KARET TENGSIN, TANAH ABANG, JAKARTA PUSAT, DKI JAKARTA",57,132,57,189
https://kawalpemilu.org#25876,"KARET TENGSIN, TANAH ABANG, JAKARTA PUSAT, DKI JAKARTA",58,100,78,178
https://kawalpemilu.org#25876,"KARET TENGSIN, TANAH ABANG, JAKARTA PUSAT, DKI JAKARTA",59,94,101,195
https://kawalpemilu.org#25876,"KARET TENGSIN, TANAH ABANG, JAKARTA PUSAT, DKI JAKARTA",60,134,73,207
https://kawalpemilu.org#25876,"KARET TENGSIN, TANAH ABANG, JAKARTA PUSAT, DKI JAKARTA",61,109,57,166
https://kawalpemilu.org#25876,"KARET TENGSIN, TANAH ABANG, JAKARTA PUSAT, DKI JAKARTA",62,139,54,193
https://kawalpemilu.org#25876,"KARET TENGSIN, TANAH ABANG, JAKARTA PUSAT, DKI JAKARTA",63,157,25,182
https://kawalpemilu.org#25877,"PETAMBURAN, TANAH ABANG, JAKARTA PUSAT, DKI JAKARTA",1,96,123,219
https://kawalpemilu.org#25877,"PETAMBURAN, TANAH ABANG, JAKARTA PUSAT, DKI JAKARTA",2,66,115,181
https://kawalpemilu.org#25877,"PETAMBURAN, TANAH ABANG, JAKARTA PUSAT, DKI JAKARTA",3,81,91,172
https://kawalpemilu.org#25877,"PETAMBURAN, TANAH ABANG, JAKARTA PUSAT, DKI JAKARTA",4,57,171,228
https://kawalpemilu.org#25877,"PETAMBURAN, TANAH ABANG, JAKARTA PUSAT, DKI JAKARTA",5,63,169,232
https://kawalpemilu.org#25877,"PETAMBURAN, TANAH ABANG, JAKARTA PUSAT, DKI JAKARTA",6,66,148,214
https://kawalpemilu.org#25877,"PETAMBURAN, TANAH ABANG, JAKARTA PUSAT, DKI JAKARTA",7,62,141,203
https://kawalpemilu.org#25877,"PETAMBURAN, TANAH ABANG, JAKARTA PUSAT, DKI JAKARTA",8,69,167,236
https://kawalpemilu.org#25877,"PETAMBURAN, TANAH ABANG, JAKARTA PUSAT, DKI JAKARTA",9,60,185,245
https://kawalpemilu.org#25877,"PETAMBURAN, TANAH ABANG, JAKARTA PUSAT, DKI JAKARTA",10,40,154,194
https://kawalpemilu.org#25877,"PETAMBURAN, TANAH ABANG, JAKARTA PUSAT, DKI JAKARTA",11,43,145,188
https://kawalpemilu.org#25877,"PETAMBURAN, TANAH ABANG, JAKARTA PUSAT, DKI JAKARTA",12,47,139,186
https://kawalpemilu.org#25877,"PETAMBURAN, TANAH ABANG, JAKARTA PUSAT, DKI JAKARTA",13,56,160,216
https://kawalpemilu.org#25877,"PETAMBURAN, TANAH ABANG, JAKARTA PUSAT, DKI JAKARTA",14,49,127,176
https://kawalpemilu.org#25877,"PETAMBURAN, TANAH ABANG, JAKARTA PUSAT, DKI JAKARTA",15,100,117,217
https://kawalpemilu.org#25877,"PETAMBURAN, TANAH ABANG, JAKARTA PUSAT, DKI JAKARTA",16,87,123,210
https://kawalpemilu.org#25877,"PETAMBURAN, TANAH ABANG, JAKARTA PUSAT, DKI JAKARTA",17,65,176,241
https://kawalpemilu.org#25877,"PETAMBURAN, TANAH ABANG, JAKARTA PUSAT, DKI JAKARTA",18,56,130,186
https://kawalpemilu.org#25877,"PETAMBURAN, TANAH ABANG, JAKARTA PUSAT, DKI JAKARTA",19,64,149,213
https://kawalpemilu.org#25877,"PETAMBURAN, TANAH ABANG, JAKARTA PUSAT, DKI JAKARTA",20,82,151,233
https://kawalpemilu.org#25877,"PETAMBURAN, TANAH ABANG, JAKARTA PUSAT, DKI JAKARTA",21,45,186,231
https://kawalpemilu.org#25877,"PETAMBURAN, TANAH ABANG, JAKARTA PUSAT, DKI JAKARTA",22,39,185,224
https://kawalpemilu.org#25877,"PETAMBURAN, TANAH ABANG, JAKARTA PUSAT, DKI JAKARTA",23,37,205,242
https://kawalpemilu.org#25877,"PETAMBURAN, TANAH ABANG, JAKARTA PUSAT, DKI JAKARTA",24,64,120,184
https://kawalpemilu.org#25877,"PETAMBURAN, TANAH ABANG, JAKARTA PUSAT, DKI JAKARTA",25,45,177,222
https://kawalpemilu.org#25877,"PETAMBURAN, TANAH ABANG, JAKARTA PUSAT, DKI JAKARTA",26,50,170,220
https://kawalpemilu.org#25877,"PETAMBURAN, TANAH ABANG, JAKARTA PUSAT, DKI JAKARTA",27,69,162,231
https://kawalpemilu.org#25877,"PETAMBURAN, TANAH ABANG, JAKARTA PUSAT, DKI JAKARTA",28,31,196,227
https://kawalpemilu.org#25877,"PETAMBURAN, TANAH ABANG, JAKARTA PUSAT, DKI JAKARTA",29,45,167,212
https://kawalpemilu.org#25877,"PETAMBURAN, TANAH ABANG, JAKARTA PUSAT, DKI JAKARTA",31,46,190,236
https://kawalpemilu.org#25877,"PETAMBURAN, TANAH ABANG, JAKARTA PUSAT, DKI JAKARTA",32,50,185,235
https://kawalpemilu.org#25877,"PETAMBURAN, TANAH ABANG, JAKARTA PUSAT, DKI JAKARTA",34,52,118,170
https://kawalpemilu.org#25877,"PETAMBURAN, TANAH ABANG, JAKARTA PUSAT, DKI JAKARTA",35,71,150,221
https://kawalpemilu.org#25877,"PETAMBURAN, TANAH ABANG, JAKARTA PUSAT, DKI JAKARTA",36,68,202,270
https://kawalpemilu.org#25877,"PETAMBURAN, TANAH ABANG, JAKARTA PUSAT, DKI JAKARTA",37,41,190,231
https://kawalpemilu.org#25877,"PETAMBURAN, TANAH ABANG, JAKARTA PUSAT, DKI JAKARTA",38,51,185,236
https://kawalpemilu.org#25877,"PETAMBURAN, TANAH ABANG, JAKARTA PUSAT, DKI JAKARTA",40,43,169,212
https://kawalpemilu.org#25877,"PETAMBURAN, TANAH ABANG, JAKARTA PUSAT, DKI JAKARTA",41,47,165,212
https://kawalpemilu.org#25877,"PETAMBURAN, TANAH ABANG, JAKARTA PUSAT, DKI JAKARTA",42,40,195,235
https://kawalpemilu.org#25877,"PETAMBURAN, TANAH ABANG, JAKARTA PUSAT, DKI JAKARTA",44,159,41,200
https://kawalpemilu.org#25877,"PETAMBURAN, TANAH ABANG, JAKARTA PUSAT, DKI JAKARTA",45,98,79,177
https://kawalpemilu.org#25877,"PETAMBURAN, TANAH ABANG, JAKARTA PUSAT, DKI JAKARTA",46,66,150,216
https://kawalpemilu.org#25877,"PETAMBURAN, TANAH ABANG, JAKARTA PUSAT, DKI JAKARTA",47,40,159,199
https://kawalpemilu.org#25877,"PETAMBURAN, TANAH ABANG, JAKARTA PUSAT, DKI JAKARTA",48,62,134,196
https://kawalpemilu.org#25877,"PETAMBURAN, TANAH ABANG, JAKARTA PUSAT, DKI JAKARTA",49,55,191,246
https://kawalpemilu.org#25877,"PETAMBURAN, TANAH ABANG, JAKARTA PUSAT, DKI JAKARTA",50,50,142,192
https://kawalpemilu.org#25877,"PETAMBURAN, TANAH ABANG, JAKARTA PUSAT, DKI JAKARTA",51,28,219,247
https://kawalpemilu.org#25877,"PETAMBURAN, TANAH ABANG, JAKARTA PUSAT, DKI JAKARTA",52,37,150,187
https://kawalpemilu.org#25877,"PETAMBURAN, TANAH ABANG, JAKARTA PUSAT, DKI JAKARTA",53,54,140,194
https://kawalpemilu.org#25877,"PETAMBURAN, TANAH ABANG, JAKARTA PUSAT, DKI JAKARTA",54,55,174,229
https://kawalpemilu.org#25877,"PETAMBURAN, TANAH ABANG, JAKARTA PUSAT, DKI JAKARTA",55,57,146,203
https://kawalpemilu.org#25877,"PETAMBURAN, TANAH ABANG, JAKARTA PUSAT, DKI JAKARTA",56,56,185,241
https://kawalpemilu.org#25877,"PETAMBURAN, TANAH ABANG, JAKARTA PUSAT, DKI JAKARTA",57,53,161,214
https://kawalpemilu.org#25877,"PETAMBURAN, TANAH ABANG, JAKARTA PUSAT, DKI JAKARTA",58,67,127,194
https://kawalpemilu.org#25877,"PETAMBURAN, TANAH ABANG, JAKARTA PUSAT, DKI JAKARTA",59,65,149,214
https://kawalpemilu.org#25877,"PETAMBURAN, TANAH ABANG, JAKARTA PUSAT, DKI JAKARTA",60,57,99,156
https://kawalpemilu.org#25877,"PETAMBURAN, TANAH ABANG, JAKARTA PUSAT, DKI JAKARTA",61,85,139,224
https://kawalpemilu.org#25877,"PETAMBURAN, TANAH ABANG, JAKARTA PUSAT, DKI JAKARTA",62,60,147,207
https://kawalpemilu.org#25877,"PETAMBURAN, TANAH ABANG, JAKARTA PUSAT, DKI JAKARTA",63,74,166,240
https://kawalpemilu.org#25877,"PETAMBURAN, TANAH ABANG, JAKARTA PUSAT, DKI JAKARTA",65,59,153,212
https://kawalpemilu.org#25877,"PETAMBURAN, TANAH ABANG, JAKARTA PUSAT, DKI JAKARTA",66,77,164,241
https://kawalpemilu.org#25877,"PETAMBURAN, TANAH ABANG, JAKARTA PUSAT, DKI JAKARTA",67,94,130,224
https://kawalpemilu.org#25877,"PETAMBURAN, TANAH ABANG, JAKARTA PUSAT, DKI JAKARTA",68,71,126,197
https://kawalpemilu.org#25877,"PETAMBURAN, TANAH ABANG, JAKARTA PUSAT, DKI JAKARTA",69,83,139,222
https://kawalpemilu.org#25877,"PETAMBURAN, TANAH ABANG, JAKARTA PUSAT, DKI JAKARTA",70,98,114,212
https://kawalpemilu.org#25877,"PETAMBURAN, TANAH ABANG, JAKARTA PUSAT, DKI JAKARTA",71,74,131,205
https://kawalpemilu.org#25877,"PETAMBURAN, TANAH ABANG, JAKARTA PUSAT, DKI JAKARTA",73,63,181,244
https://kawalpemilu.org#25877,"PETAMBURAN, TANAH ABANG, JAKARTA PUSAT, DKI JAKARTA",74,96,142,238
https://kawalpemilu.org#25877,"PETAMBURAN, TANAH ABANG, JAKARTA PUSAT, DKI JAKARTA",75,69,149,218
https://kawalpemilu.org#25877,"PETAMBURAN, TANAH ABANG, JAKARTA PUSAT, DKI JAKARTA",76,67,111,178
https://kawalpemilu.org#25877,"PETAMBURAN, TANAH ABANG, JAKARTA PUSAT, DKI JAKARTA",77,99,122,221
https://kawalpemilu.org#25877,"PETAMBURAN, TANAH ABANG, JAKARTA PUSAT, DKI JAKARTA",78,114,80,194
https://kawalpemilu.org#25877,"PETAMBURAN, TANAH ABANG, JAKARTA PUSAT, DKI JAKARTA",79,114,76,190
https://kawalpemilu.org#25877,"PETAMBURAN, TANAH ABANG, JAKARTA PUSAT, DKI JAKARTA",80,100,113,213
https://kawalpemilu.org#25877,"PETAMBURAN, TANAH ABANG, JAKARTA PUSAT, DKI JAKARTA",81,71,130,201
https://kawalpemilu.org#25877,"PETAMBURAN, TANAH ABANG, JAKARTA PUSAT, DKI JAKARTA",82,76,108,184
https://kawalpemilu.org#25877,"PETAMBURAN, TANAH ABANG, JAKARTA PUSAT, DKI JAKARTA",83,87,134,221
https://kawalpemilu.org#25877,"PETAMBURAN, TANAH ABANG, JAKARTA PUSAT, DKI JAKARTA",84,79,138,217
https://kawalpemilu.org#25877,"PETAMBURAN, TANAH ABANG, JAKARTA PUSAT, DKI JAKARTA",85,75,168,243
https://kawalpemilu.org#25877,"PETAMBURAN, TANAH ABANG, JAKARTA PUSAT, DKI JAKARTA",86,95,143,238
https://kawalpemilu.org#25877,"PETAMBURAN, TANAH ABANG, JAKARTA PUSAT, DKI JAKARTA",87,130,91,221
https://kawalpemilu.org#25877,"PETAMBURAN, TANAH ABANG, JAKARTA PUSAT, DKI JAKARTA",88,89,107,196
https://kawalpemilu.org#25877,"PETAMBURAN, TANAH ABANG, JAKARTA PUSAT, DKI JAKARTA",89,65,124,189
https://kawalpemilu.org#25877,"PETAMBURAN, TANAH ABANG, JAKARTA PUSAT, DKI JAKARTA",90,80,153,233
https://kawalpemilu.org#25877,"PETAMBURAN, TANAH ABANG, JAKARTA PUSAT, DKI JAKARTA",91,93,144,237
https://kawalpemilu.org#25877,"PETAMBURAN, TANAH ABANG, JAKARTA PUSAT, DKI JAKARTA",92,88,118,206
https://kawalpemilu.org#25877,"PETAMBURAN, TANAH ABANG, JAKARTA PUSAT, DKI JAKARTA",93,66,208,274
https://kawalpemilu.org#25877,"PETAMBURAN, TANAH ABANG, JAKARTA PUSAT, DKI JAKARTA",94,82,138,220
https://kawalpemilu.org#25877,"PETAMBURAN, TANAH ABANG, JAKARTA PUSAT, DKI JAKARTA",95,58,159,217
https://kawalpemilu.org#25877,"PETAMBURAN, TANAH ABANG, JAKARTA PUSAT, DKI JAKARTA",96,70,132,202
https://kawalpemilu.org#25877,"PETAMBURAN, TANAH ABANG, JAKARTA PUSAT, DKI JAKARTA",97,95,131,226
https://kawalpemilu.org#25877,"PETAMBURAN, TANAH ABANG, JAKARTA PUSAT, DKI JAKARTA",98,147,57,204
https://kawalpemilu.org#25877,"PETAMBURAN, TANAH ABANG, JAKARTA PUSAT, DKI JAKARTA",99,112,62,174
https://kawalpemilu.org#25877,"PETAMBURAN, TANAH ABANG, JAKARTA PUSAT, DKI JAKARTA",100,71,142,213
https://kawalpemilu.org#25877,"PETAMBURAN, TANAH ABANG, JAKARTA PUSAT, DKI JAKARTA",101,107,71,178
https://kawalpemilu.org#25877,"PETAMBURAN, TANAH ABANG, JAKARTA PUSAT, DKI JAKARTA",102,132,66,198
https://kawalpemilu.org#25877,"PETAMBURAN, TANAH ABANG, JAKARTA PUSAT, DKI JAKARTA",103,122,42,164
https://kawalpemilu.org#25877,"PETAMBURAN, TANAH ABANG, JAKARTA PUSAT, DKI JAKARTA",104,124,105,229
https://kawalpemilu.org#25877,"PETAMBURAN, TANAH ABANG, JAKARTA PUSAT, DKI JAKARTA",105,122,25,147
https://kawalpemilu.org#25877,"PETAMBURAN, TANAH ABANG, JAKARTA PUSAT, DKI JAKARTA",106,127,22,149
https://kawalpemilu.org#25877,"PETAMBURAN, TANAH ABANG, JAKARTA PUSAT, DKI JAKARTA",107,136,71,207
https://kawalpemilu.org#25877,"PETAMBURAN, TANAH ABANG, JAKARTA PUSAT, DKI JAKARTA",108,111,114,225
https://kawalpemilu.org#25877,"PETAMBURAN, TANAH ABANG, JAKARTA PUSAT, DKI JAKARTA",109,110,85,195
https://kawalpemilu.org#25878,"KEBON MELATI, TANAH ABANG, JAKARTA PUSAT, DKI JAKARTA",1,73,112,185
https://kawalpemilu.org#25878,"KEBON MELATI, TANAH ABANG, JAKARTA PUSAT, DKI JAKARTA",2,80,101,181
https://kawalpemilu.org#25878,"KEBON MELATI, TANAH ABANG, JAKARTA PUSAT, DKI JAKARTA",3,102,65,167
https://kawalpemilu.org#25878,"KEBON MELATI, TANAH ABANG, JAKARTA PUSAT, DKI JAKARTA",4,102,73,175
https://kawalpemilu.org#25878,"KEBON MELATI, TANAH ABANG, JAKARTA PUSAT, DKI JAKARTA",5,133,99,232
https://kawalpemilu.org#25878,"KEBON MELATI, TANAH ABANG, JAKARTA PUSAT, DKI JAKARTA",6,128,76,204
https://kawalpemilu.org#25878,"KEBON MELATI, TANAH ABANG, JAKARTA PUSAT, DKI JAKARTA",7,51,73,124
https://kawalpemilu.org#25878,"KEBON MELATI, TANAH ABANG, JAKARTA PUSAT, DKI JAKARTA",8,75,62,137
https://kawalpemilu.org#25878,"KEBON MELATI, TANAH ABANG, JAKARTA PUSAT, DKI JAKARTA",10,64,107,171
https://kawalpemilu.org#25878,"KEBON MELATI, TANAH ABANG, JAKARTA PUSAT, DKI JAKARTA",11,106,72,178
https://kawalpemilu.org#25878,"KEBON MELATI, TANAH ABANG, JAKARTA PUSAT, DKI JAKARTA",12,67,130,197
https://kawalpemilu.org#25878,"KEBON MELATI, TANAH ABANG, JAKARTA PUSAT, DKI JAKARTA",13,60,159,219
https://kawalpemilu.org#25878,"KEBON MELATI, TANAH ABANG, JAKARTA PUSAT, DKI JAKARTA",14,51,135,186
https://kawalpemilu.org#25878,"KEBON MELATI, TANAH ABANG, JAKARTA PUSAT, DKI JAKARTA",15,94,127,221
https://kawalpemilu.org#25878,"KEBON MELATI, TANAH ABANG, JAKARTA PUSAT, DKI JAKARTA",16,50,177,227
https://kawalpemilu.org#25878,"KEBON MELATI, TANAH ABANG, JAKARTA PUSAT, DKI JAKARTA",17,77,157,234
https://kawalpemilu.org#25878,"KEBON MELATI, TANAH ABANG, JAKARTA PUSAT, DKI JAKARTA",18,75,154,229
https://kawalpemilu.org#25878,"KEBON MELATI, TANAH ABANG, JAKARTA PUSAT, DKI JAKARTA",19,51,151,202
https://kawalpemilu.org#25878,"KEBON MELATI, TANAH ABANG, JAKARTA PUSAT, DKI JAKARTA",20,80,111,191
https://kawalpemilu.org#25878,"KEBON MELATI, TANAH ABANG, JAKARTA PUSAT, DKI JAKARTA",21,59,114,173
https://kawalpemilu.org#25878,"KEBON MELATI, TANAH ABANG, JAKARTA PUSAT, DKI JAKARTA",22,92,123,215
https://kawalpemilu.org#25878,"KEBON MELATI, TANAH ABANG, JAKARTA PUSAT, DKI JAKARTA",23,78,136,214
https://kawalpemilu.org#25878,"KEBON MELATI, TANAH ABANG, JAKARTA PUSAT, DKI JAKARTA",24,59,158,217
https://kawalpemilu.org#25878,"KEBON MELATI, TANAH ABANG, JAKARTA PUSAT, DKI JAKARTA",25,93,122,215
https://kawalpemilu.org#25878,"KEBON MELATI, TANAH ABANG, JAKARTA PUSAT, DKI JAKARTA",26,104,85,189
https://kawalpemilu.org#25878,"KEBON MELATI, TANAH ABANG, JAKARTA PUSAT, DKI JAKARTA",27,94,103,197
https://kawalpemilu.org#25878,"KEBON MELATI, TANAH ABANG, JAKARTA PUSAT, DKI JAKARTA",28,70,102,172
https://kawalpemilu.org#25878,"KEBON MELATI, TANAH ABANG, JAKARTA PUSAT, DKI JAKARTA",30,155,35,190
https://kawalpemilu.org#25878,"KEBON MELATI, TANAH ABANG, JAKARTA PUSAT, DKI JAKARTA",31,192,19,211
https://kawalpemilu.org#25878,"KEBON MELATI, TANAH ABANG, JAKARTA PUSAT, DKI JAKARTA",33,142,17,159
https://kawalpemilu.org#25878,"KEBON MELATI, TANAH ABANG, JAKARTA PUSAT, DKI JAKARTA",34,147,20,167
https://kawalpemilu.org#25878,"KEBON MELATI, TANAH ABANG, JAKARTA PUSAT, DKI JAKARTA",35,47,162,209
https://kawalpemilu.org#25878,"KEBON MELATI, TANAH ABANG, JAKARTA PUSAT, DKI JAKARTA",36,31,181,212
https://kawalpemilu.org#25878,"KEBON MELATI, TANAH ABANG, JAKARTA PUSAT, DKI JAKARTA",37,35,197,232
https://kawalpemilu.org#25878,"KEBON MELATI, TANAH ABANG, JAKARTA PUSAT, DKI JAKARTA",38,45,178,223
https://kawalpemilu.org#25878,"KEBON MELATI, TANAH ABANG, JAKARTA PUSAT, DKI JAKARTA",39,68,160,228
https://kawalpemilu.org#25878,"KEBON MELATI, TANAH ABANG, JAKARTA PUSAT, DKI JAKARTA",40,62,137,199
https://kawalpemilu.org#25878,"KEBON MELATI, TANAH ABANG, JAKARTA PUSAT, DKI JAKARTA",41,68,165,233
https://kawalpemilu.org#25878,"KEBON MELATI, TANAH ABANG, JAKARTA PUSAT, DKI JAKARTA",42,62,171,233
https://kawalpemilu.org#25878,"KEBON MELATI, TANAH ABANG, JAKARTA PUSAT, DKI JAKARTA",43,36,167,203
https://kawalpemilu.org#25878,"KEBON MELATI, TANAH ABANG, JAKARTA PUSAT, DKI JAKARTA",44,57,167,224
https://kawalpemilu.org#25878,"KEBON MELATI, TANAH ABANG, JAKARTA PUSAT, DKI JAKARTA",45,88,144,2
https://kawalpemilu.org#25878,"KEBON MELATI, TANAH ABANG, JAKARTA PUSAT, DKI JAKARTA",46,78,149,227
https://kawalpemilu.org#25878,"KEBON MELATI, TANAH ABANG, JAKARTA PUSAT, DKI JAKARTA",47,52,122,174
https://kawalpemilu.org#25878,"KEBON MELATI, TANAH ABANG, JAKARTA PUSAT, DKI JAKARTA",48,56,132,188
https://kawalpemilu.org#25878,"KEBON MELATI, TANAH ABANG, JAKARTA PUSAT, DKI JAKARTA",49,39,201,240
https://kawalpemilu.org#25878,"KEBON MELATI, TANAH ABANG, JAKARTA PUSAT, DKI JAKARTA",50,41,185,226
https://kawalpemilu.org#25878,"KEBON MELATI, TANAH ABANG, JAKARTA PUSAT, DKI JAKARTA",51,39,182,221
https://kawalpemilu.org#25878,"KEBON MELATI, TANAH ABANG, JAKARTA PUSAT, DKI JAKARTA",52,41,189,230
https://kawalpemilu.org#25878,"KEBON MELATI, TANAH ABANG, JAKARTA PUSAT, DKI JAKARTA",54,49,175,224
https://kawalpemilu.org#25878,"KEBON MELATI, TANAH ABANG, JAKARTA PUSAT, DKI JAKARTA",55,78,151,229
https://kawalpemilu.org#25878,"KEBON MELATI, TANAH ABANG, JAKARTA PUSAT, DKI JAKARTA",56,49,144,193
https://kawalpemilu.org#25878,"KEBON MELATI, TANAH ABANG, JAKARTA PUSAT, DKI JAKARTA",57,60,132,192
https://kawalpemilu.org#25878,"KEBON MELATI, TANAH ABANG, JAKARTA PUSAT, DKI JAKARTA",58,81,124,205
https://kawalpemilu.org#25878,"KEBON MELATI, TANAH ABANG, JAKARTA PUSAT, DKI JAKARTA",59,97,117,214
https://kawalpemilu.org#25878,"KEBON MELATI, TANAH ABANG, JAKARTA PUSAT, DKI JAKARTA",60,79,112,191
https://kawalpemilu.org#25878,"KEBON MELATI, TANAH ABANG, JAKARTA PUSAT, DKI JAKARTA",61,62,130,192
https://kawalpemilu.org#25878,"KEBON MELATI, TANAH ABANG, JAKARTA PUSAT, DKI JAKARTA",62,66,95,161
https://kawalpemilu.org#25878,"KEBON MELATI, TANAH ABANG, JAKARTA PUSAT, DKI JAKARTA",63,56,173,229
https://kawalpemilu.org#25878,"KEBON MELATI, TANAH ABANG, JAKARTA PUSAT, DKI JAKARTA",64,93,83,176
https://kawalpemilu.org#25878,"KEBON MELATI, TANAH ABANG, JAKARTA PUSAT, DKI JAKARTA",65,68,111,179
https://kawalpemilu.org#25878,"KEBON MELATI, TANAH ABANG, JAKARTA PUSAT, DKI JAKARTA",66,72,93,165
https://kawalpemilu.org#25878,"KEBON MELATI, TANAH ABANG, JAKARTA PUSAT, DKI JAKARTA",67,75,108,183
https://kawalpemilu.org#25878,"KEBON MELATI, TANAH ABANG, JAKARTA PUSAT, DKI JAKARTA",68,77,121,198
https://kawalpemilu.org#25878,"KEBON MELATI, TANAH ABANG, JAKARTA PUSAT, DKI JAKARTA",69,98,128,226
https://kawalpemilu.org#25878,"KEBON MELATI, TANAH ABANG, JAKARTA PUSAT, DKI JAKARTA",70,115,144,259
https://kawalpemilu.org#25878,"KEBON MELATI, TANAH ABANG, JAKARTA PUSAT, DKI JAKARTA",71,46,177,223
https://kawalpemilu.org#25878,"KEBON MELATI, TANAH ABANG, JAKARTA PUSAT, DKI JAKARTA",72,74,101,175
https://kawalpemilu.org#25878,"KEBON MELATI, TANAH ABANG, JAKARTA PUSAT, DKI JAKARTA",73,54,74,128
https://kawalpemilu.org#25878,"KEBON MELATI, TANAH ABANG, JAKARTA PUSAT, DKI JAKARTA",74,54,107,161
https://kawalpemilu.org#25878,"KEBON MELATI, TANAH ABANG, JAKARTA PUSAT, DKI JAKARTA",75,47,104,151
https://kawalpemilu.org#25878,"KEBON MELATI, TANAH ABANG, JAKARTA PUSAT, DKI JAKARTA",76,73,162,235
https://kawalpemilu.org#25878,"KEBON MELATI, TANAH ABANG, JAKARTA PUSAT, DKI JAKARTA",77,54,107,161
https://kawalpemilu.org#25878,"KEBON MELATI, TANAH ABANG, JAKARTA PUSAT, DKI JAKARTA",78,40,175,215
https://kawalpemilu.org#25878,"KEBON MELATI, TANAH ABANG, JAKARTA PUSAT, DKI JAKARTA",79,44,170,214
https://kawalpemilu.org#25878,"KEBON MELATI, TANAH ABANG, JAKARTA PUSAT, DKI JAKARTA",80,47,166,213
https://kawalpemilu.org#25878,"KEBON MELATI, TANAH ABANG, JAKARTA PUSAT, DKI JAKARTA",81,44,156,200
https://kawalpemilu.org#25878,"KEBON MELATI, TANAH ABANG, JAKARTA PUSAT, DKI JAKARTA",82,55,148,203
https://kawalpemilu.org#25878,"KEBON MELATI, TANAH ABANG, JAKARTA PUSAT, DKI JAKARTA",83,62,175,237
https://kawalpemilu.org#25878,"KEBON MELATI, TANAH ABANG, JAKARTA PUSAT, DKI JAKARTA",84,77,141,218
https://kawalpemilu.org#25878,"KEBON MELATI, TANAH ABANG, JAKARTA PUSAT, DKI JAKARTA",85,78,148,226
https://kawalpemilu.org#25878,"KEBON MELATI, TANAH ABANG, JAKARTA PUSAT, DKI JAKARTA",86,107,101,208
https://kawalpemilu.org#25878,"KEBON MELATI, TANAH ABANG, JAKARTA PUSAT, DKI JAKARTA",87,113,108,221
https://kawalpemilu.org#25878,"KEBON MELATI, TANAH ABANG, JAKARTA PUSAT, DKI JAKARTA",88,81,162,243
https://kawalpemilu.org#25878,"KEBON MELATI, TANAH ABANG, JAKARTA PUSAT, DKI JAKARTA",89,75,167,242
https://kawalpemilu.org#25878,"KEBON MELATI, TANAH ABANG, JAKARTA PUSAT, DKI JAKARTA",90,97,125,222
https://kawalpemilu.org#25878,"KEBON MELATI, TANAH ABANG, JAKARTA PUSAT, DKI JAKARTA",91,42,180,222
https://kawalpemilu.org#25878,"KEBON MELATI, TANAH ABANG, JAKARTA PUSAT, DKI JAKARTA",92,31,153,184
https://kawalpemilu.org#25878,"KEBON MELATI, TANAH ABANG, JAKARTA PUSAT, DKI JAKARTA",93,51,151,202
https://kawalpemilu.org#25878,"KEBON MELATI, TANAH ABANG, JAKARTA PUSAT, DKI JAKARTA",94,46,175,221
https://kawalpemilu.org#25878,"KEBON MELATI, TANAH ABANG, JAKARTA PUSAT, DKI JAKARTA",95,41,183,224
https://kawalpemilu.org#25878,"KEBON MELATI, TANAH ABANG, JAKARTA PUSAT, DKI JAKARTA",96,64,181,245
https://kawalpemilu.org#25878,"KEBON MELATI, TANAH ABANG, JAKARTA PUSAT, DKI JAKARTA",97,58,186,244
https://kawalpemilu.org#25878,"KEBON MELATI, TANAH ABANG, JAKARTA PUSAT, DKI JAKARTA",98,46,219,265
https://kawalpemilu.org#25878,"KEBON MELATI, TANAH ABANG, JAKARTA PUSAT, DKI JAKARTA",99,42,240,282
https://kawalpemilu.org#25878,"KEBON MELATI, TANAH ABANG, JAKARTA PUSAT, DKI JAKARTA",100,27,218,245
https://kawalpemilu.org#25878,"KEBON MELATI, TANAH ABANG, JAKARTA PUSAT, DKI JAKARTA",101,46,182,228
https://kawalpemilu.org#25878,"KEBON MELATI, TANAH ABANG, JAKARTA PUSAT, DKI JAKARTA",102,34,169,203
https://kawalpemilu.org#25878,"KEBON MELATI, TANAH ABANG, JAKARTA PUSAT, DKI JAKARTA",103,107,46,153
https://kawalpemilu.org#25879,"KEBON KACANG, TANAH ABANG, JAKARTA PUSAT, DKI JAKARTA",1,148,93,241
https://kawalpemilu.org#25879,"KEBON KACANG, TANAH ABANG, JAKARTA PUSAT, DKI JAKARTA",2,137,99,236
https://kawalpemilu.org#25879,"KEBON KACANG, TANAH ABANG, JAKARTA PUSAT, DKI JAKARTA",3,157,107,264
https://kawalpemilu.org#25879,"KEBON KACANG, TANAH ABANG, JAKARTA PUSAT, DKI JAKARTA",4,130,74,204
https://kawalpemilu.org#25879,"KEBON KACANG, TANAH ABANG, JAKARTA PUSAT, DKI JAKARTA",5,90,104,194
https://kawalpemilu.org#25879,"KEBON KACANG, TANAH ABANG, JAKARTA PUSAT, DKI JAKARTA",7,105,85,190
https://kawalpemilu.org#25879,"KEBON KACANG, TANAH ABANG, JAKARTA PUSAT, DKI JAKARTA",8,131,88,219
https://kawalpemilu.org#25879,"KEBON KACANG, TANAH ABANG, JAKARTA PUSAT, DKI JAKARTA",9,99,106,205
https://kawalpemilu.org#25879,"KEBON KACANG, TANAH ABANG, JAKARTA PUSAT, DKI JAKARTA",10,104,86,190
https://kawalpemilu.org#25879,"KEBON KACANG, TANAH ABANG, JAKARTA PUSAT, DKI JAKARTA",11,90,116,206
https://kawalpemilu.org#25879,"KEBON KACANG, TANAH ABANG, JAKARTA PUSAT, DKI JAKARTA",12,148,87,235
https://kawalpemilu.org#25879,"KEBON KACANG, TANAH ABANG, JAKARTA PUSAT, DKI JAKARTA",13,100,134,234
https://kawalpemilu.org#25879,"KEBON KACANG, TANAH ABANG, JAKARTA PUSAT, DKI JAKARTA",14,61,147,208
https://kawalpemilu.org#25879,"KEBON KACANG, TANAH ABANG, JAKARTA PUSAT, DKI JAKARTA",15,97,147,244
https://kawalpemilu.org#25879,"KEBON KACANG, TANAH ABANG, JAKARTA PUSAT, DKI JAKARTA",16,49,142,191
https://kawalpemilu.org#25879,"KEBON KACANG, TANAH ABANG, JAKARTA PUSAT, DKI JAKARTA",17,98,61,159
https://kawalpemilu.org#25879,"KEBON KACANG, TANAH ABANG, JAKARTA PUSAT, DKI JAKARTA",18,110,119,229
https://kawalpemilu.org#25879,"KEBON KACANG, TANAH ABANG, JAKARTA PUSAT, DKI JAKARTA",19,112,105,217
https://kawalpemilu.org#25879,"KEBON KACANG, TANAH ABANG, JAKARTA PUSAT, DKI JAKARTA",20,127,94,221
https://kawalpemilu.org#25879,"KEBON KACANG, TANAH ABANG, JAKARTA PUSAT, DKI JAKARTA",21,142,72,214
https://kawalpemilu.org#25879,"KEBON KACANG, TANAH ABANG, JAKARTA PUSAT, DKI JAKARTA",22,96,145,241
https://kawalpemilu.org#25879,"KEBON KACANG, TANAH ABANG, JAKARTA PUSAT, DKI JAKARTA",23,126,138,264
https://kawalpemilu.org#25879,"KEBON KACANG, TANAH ABANG, JAKARTA PUSAT, DKI JAKARTA",24,157,62,219
https://kawalpemilu.org#25879,"KEBON KACANG, TANAH ABANG, JAKARTA PUSAT, DKI JAKARTA",25,152,61,213
https://kawalpemilu.org#25879,"KEBON KACANG, TANAH ABANG, JAKARTA PUSAT, DKI JAKARTA",26,93,135,228
https://kawalpemilu.org#25879,"KEBON KACANG, TANAH ABANG, JAKARTA PUSAT, DKI JAKARTA",27,127,124,251
https://kawalpemilu.org#25879,"KEBON KACANG, TANAH ABANG, JAKARTA PUSAT, DKI JAKARTA",28,124,114,238
https://kawalpemilu.org#25879,"KEBON KACANG, TANAH ABANG, JAKARTA PUSAT, DKI JAKARTA",29,28,207,235
https://kawalpemilu.org#25879,"KEBON KACANG, TANAH ABANG, JAKARTA PUSAT, DKI JAKARTA",30,53,181,234
https://kawalpemilu.org#25879,"KEBON KACANG, TANAH ABANG, JAKARTA PUSAT, DKI JAKARTA",31,64,160,224
https://kawalpemilu.org#25879,"KEBON KACANG, TANAH ABANG, JAKARTA PUSAT, DKI JAKARTA",32,61,154,215
https://kawalpemilu.org#25879,"KEBON KACANG, TANAH ABANG, JAKARTA PUSAT, DKI JAKARTA",33,75,157,232
https://kawalpemilu.org#25879,"KEBON KACANG, TANAH ABANG, JAKARTA PUSAT, DKI JAKARTA",34,145,87,232
https://kawalpemilu.org#25879,"KEBON KACANG, TANAH ABANG, JAKARTA PUSAT, DKI JAKARTA",35,49,107,156
https://kawalpemilu.org#25879,"KEBON KACANG, TANAH ABANG, JAKARTA PUSAT, DKI JAKARTA",36,44,172,216
https://kawalpemilu.org#25879,"KEBON KACANG, TANAH ABANG, JAKARTA PUSAT, DKI JAKARTA",37,26,189,215
https://kawalpemilu.org#25879,"KEBON KACANG, TANAH ABANG, JAKARTA PUSAT, DKI JAKARTA",38,45,179,224
https://kawalpemilu.org#25879,"KEBON KACANG, TANAH ABANG, JAKARTA PUSAT, DKI JAKARTA",39,43,152,195
https://kawalpemilu.org#25879,"KEBON KACANG, TANAH ABANG, JAKARTA PUSAT, DKI JAKARTA",40,44,152,196
https://kawalpemilu.org#25879,"KEBON KACANG, TANAH ABANG, JAKARTA PUSAT, DKI JAKARTA",41,27,136,163
https://kawalpemilu.org#25879,"KEBON KACANG, TANAH ABANG, JAKARTA PUSAT, DKI JAKARTA",42,42,201,243
https://kawalpemilu.org#25879,"KEBON KACANG, TANAH ABANG, JAKARTA PUSAT, DKI JAKARTA",43,30,163,193
https://kawalpemilu.org#25879,"KEBON KACANG, TANAH ABANG, JAKARTA PUSAT, DKI JAKARTA",44,91,66,157
https://kawalpemilu.org#25879,"KEBON KACANG, TANAH ABANG, JAKARTA PUSAT, DKI JAKARTA",45,62,141,203
https://kawalpemilu.org#25879,"KEBON KACANG, TANAH ABANG, JAKARTA PUSAT, DKI JAKARTA",46,66,152,218
https://kawalpemilu.org#25879,"KEBON KACANG, TANAH ABANG, JAKARTA PUSAT, DKI JAKARTA",47,74,143,217
https://kawalpemilu.org#25879,"KEBON KACANG, TANAH ABANG, JAKARTA PUSAT, DKI JAKARTA",48,70,115,185
https://kawalpemilu.org#25879,"KEBON KACANG, TANAH ABANG, JAKARTA PUSAT, DKI JAKARTA",49,90,117,207
https://kawalpemilu.org#25879,"KEBON KACANG, TANAH ABANG, JAKARTA PUSAT, DKI JAKARTA",50,68,119,187
https://kawalpemilu.org#25879,"KEBON KACANG, TANAH ABANG, JAKARTA PUSAT, DKI JAKARTA",51,60,115,175
https://kawalpemilu.org#25879,"KEBON KACANG, TANAH ABANG, JAKARTA PUSAT, DKI JAKARTA",52,63,132,195
https://kawalpemilu.org#25879,"KEBON KACANG, TANAH ABANG, JAKARTA PUSAT, DKI JAKARTA",54,103,68,171
https://kawalpemilu.org#25879,"KEBON KACANG, TANAH ABANG, JAKARTA PUSAT, DKI JAKARTA",55,88,124,212
https://kawalpemilu.org#25879,"KEBON KACANG, TANAH ABANG, JAKARTA PUSAT, DKI JAKARTA",56,102,118,220
https://kawalpemilu.org#25879,"KEBON KACANG, TANAH ABANG, JAKARTA PUSAT, DKI JAKARTA",57,83,152,235
https://kawalpemilu.org#25879,"KEBON KACANG, TANAH ABANG, JAKARTA PUSAT, DKI JAKARTA",58,47,176,223
https://kawalpemilu.org#25879,"KEBON KACANG, TANAH ABANG, JAKARTA PUSAT, DKI JAKARTA",59,90,150,240
https://kawalpemilu.org#25879,"KEBON KACANG, TANAH ABANG, JAKARTA PUSAT, DKI JAKARTA",60,43,186,229
https://kawalpemilu.org#25879,"KEBON KACANG, TANAH ABANG, JAKARTA PUSAT, DKI JAKARTA",61,89,134,223
https://kawalpemilu.org#25879,"KEBON KACANG, TANAH ABANG, JAKARTA PUSAT, DKI JAKARTA",62,63,144,207
https://kawalpemilu.org#25879,"KEBON KACANG, TANAH ABANG, JAKARTA PUSAT, DKI JAKARTA",63,37,148,185
https://kawalpemilu.org#25879,"KEBON KACANG, TANAH ABANG, JAKARTA PUSAT, DKI JAKARTA",64,41,133,174
https://kawalpemilu.org#25879,"KEBON KACANG, TANAH ABANG, JAKARTA PUSAT, DKI JAKARTA",65,114,106,220
https://kawalpemilu.org#25879,"KEBON KACANG, TANAH ABANG, JAKARTA PUSAT, DKI JAKARTA",67,76,100,176
https://kawalpemilu.org#25879,"KEBON KACANG, TANAH ABANG, JAKARTA PUSAT, DKI JAKARTA",68,91,90,181
https://kawalpemilu.org#25879,"KEBON KACANG, TANAH ABANG, JAKARTA PUSAT, DKI JAKARTA",69,89,103,192
https://kawalpemilu.org#25879,"KEBON KACANG, TANAH ABANG, JAKARTA PUSAT, DKI JAKARTA",70,95,92,187
https://kawalpemilu.org#25879,"KEBON KACANG, TANAH ABANG, JAKARTA PUSAT, DKI JAKARTA",71,114,85,199
https://kawalpemilu.org#25879,"KEBON KACANG, TANAH ABANG, JAKARTA PUSAT, DKI JAKARTA",72,108,120,228
https://kawalpemilu.org#25879,"KEBON KACANG, TANAH ABANG, JAKARTA PUSAT, DKI JAKARTA",73,93,113,206
https://kawalpemilu.org#25879,"KEBON KACANG, TANAH ABANG, JAKARTA PUSAT, DKI JAKARTA",74,121,97,218
https://kawalpemilu.org#25879,"KEBON KACANG, TANAH ABANG, JAKARTA PUSAT, DKI JAKARTA",75,79,113,192
https://kawalpemilu.org#25880,"KAMPUNG BALI, TANAH ABANG, JAKARTA PUSAT, DKI JAKARTA",1,113,64,177
https://kawalpemilu.org#25880,"KAMPUNG BALI, TANAH ABANG, JAKARTA PUSAT, DKI JAKARTA",2,82,66,148
https://kawalpemilu.org#25880,"KAMPUNG BALI, TANAH ABANG, JAKARTA PUSAT, DKI JAKARTA",3,61,117,178
https://kawalpemilu.org#25880,"KAMPUNG BALI, TANAH ABANG, JAKARTA PUSAT, DKI JAKARTA",4,110,75,185
https://kawalpemilu.org#25880,"KAMPUNG BALI, TANAH ABANG, JAKARTA PUSAT, DKI JAKARTA",5,70,105,175
https://kawalpemilu.org#25880,"KAMPUNG BALI, TANAH ABANG, JAKARTA PUSAT, DKI JAKARTA",6,70,92,162
https://kawalpemilu.org#25880,"KAMPUNG BALI, TANAH ABANG, JAKARTA PUSAT, DKI JAKARTA",7,62,142,204
https://kawalpemilu.org#25880,"KAMPUNG BALI, TANAH ABANG, JAKARTA PUSAT, DKI JAKARTA",8,45,153,198
https://kawalpemilu.org#25880,"KAMPUNG BALI, TANAH ABANG, JAKARTA PUSAT, DKI JAKARTA",9,47,156,203
https://kawalpemilu.org#25880,"KAMPUNG BALI, TANAH ABANG, JAKARTA PUSAT, DKI JAKARTA",10,85,158,243
https://kawalpemilu.org#25880,"KAMPUNG BALI, TANAH ABANG, JAKARTA PUSAT, DKI JAKARTA",11,128,125,253
https://kawalpemilu.org#25880,"KAMPUNG BALI, TANAH ABANG, JAKARTA PUSAT, DKI JAKARTA",12,63,143,206
https://kawalpemilu.org#25880,"KAMPUNG BALI, TANAH ABANG, JAKARTA PUSAT, DKI JAKARTA",13,66,148,214
https://kawalpemilu.org#25880,"KAMPUNG BALI, TANAH ABANG, JAKARTA PUSAT, DKI JAKARTA",14,37,144,181
https://kawalpemilu.org#25880,"KAMPUNG BALI, TANAH ABANG, JAKARTA PUSAT, DKI JAKARTA",15,21,159,180
https://kawalpemilu.org#25880,"KAMPUNG BALI, TANAH ABANG, JAKARTA PUSAT, DKI JAKARTA",16,45,139,184
https://kawalpemilu.org#25880,"KAMPUNG BALI, TANAH ABANG, JAKARTA PUSAT, DKI JAKARTA",17,40,137,177
https://kawalpemilu.org#25880,"KAMPUNG BALI, TANAH ABANG, JAKARTA PUSAT, DKI JAKARTA",18,93,96,189
https://kawalpemilu.org#25880,"KAMPUNG BALI, TANAH ABANG, JAKARTA PUSAT, DKI JAKARTA",19,73,86,159
https://kawalpemilu.org#25880,"KAMPUNG BALI, TANAH ABANG, JAKARTA PUSAT, DKI JAKARTA",20,58,153,211
https://kawalpemilu.org#25880,"KAMPUNG BALI, TANAH ABANG, JAKARTA PUSAT, DKI JAKARTA",21,63,137,200
https://kawalpemilu.org#25880,"KAMPUNG BALI, TANAH ABANG, JAKARTA PUSAT, DKI JAKARTA",22,60,134,194
https://kawalpemilu.org#25880,"KAMPUNG BALI, TANAH ABANG, JAKARTA PUSAT, DKI JAKARTA",23,81,154,235
https://kawalpemilu.org#25880,"KAMPUNG BALI, TANAH ABANG, JAKARTA PUSAT, DKI JAKARTA",24,65,153,218
https://kawalpemilu.org#25880,"KAMPUNG BALI, TANAH ABANG, JAKARTA PUSAT, DKI JAKARTA",25,43,193,236
https://kawalpemilu.org#25880,"KAMPUNG BALI, TANAH ABANG, JAKARTA PUSAT, DKI JAKARTA",26,93,135,228
https://kawalpemilu.org#25880,"KAMPUNG BALI, TANAH ABANG, JAKARTA PUSAT, DKI JAKARTA",27,128,74,202
https://kawalpemilu.org#25880,"KAMPUNG BALI, TANAH ABANG, JAKARTA PUSAT, DKI JAKARTA",28,85,88,173
https://kawalpemilu.org#25880,"KAMPUNG BALI, TANAH ABANG, JAKARTA PUSAT, DKI JAKARTA",29,100,78,178
https://kawalpemilu.org#25880,"KAMPUNG BALI, TANAH ABANG, JAKARTA PUSAT, DKI JAKARTA",30,141,34,175
https://kawalpemilu.org#25880,"KAMPUNG BALI, TANAH ABANG, JAKARTA PUSAT, DKI JAKARTA",31,189,73,262
https://kawalpemilu.org#25880,"KAMPUNG BALI, TANAH ABANG, JAKARTA PUSAT, DKI JAKARTA",32,156,81,237
https://kawalpemilu.org#25880,"KAMPUNG BALI, TANAH ABANG, JAKARTA PUSAT, DKI JAKARTA",33,67,131,198
https://kawalpemilu.org#25880,"KAMPUNG BALI, TANAH ABANG, JAKARTA PUSAT, DKI JAKARTA",34,94,125,219
https://kawalpemilu.org#25880,"KAMPUNG BALI, TANAH ABANG, JAKARTA PUSAT, DKI JAKARTA",35,144,97,241
https://kawalpemilu.org#25880,"KAMPUNG BALI, TANAH ABANG, JAKARTA PUSAT, DKI JAKARTA",36,89,133,222
https://kawalpemilu.org#25880,"KAMPUNG BALI, TANAH ABANG, JAKARTA PUSAT, DKI JAKARTA",37,117,96,213
https://kawalpemilu.org#25880,"KAMPUNG BALI, TANAH ABANG, JAKARTA PUSAT, DKI JAKARTA",38,131,100,231
https://kawalpemilu.org#25880,"KAMPUNG BALI, TANAH ABANG, JAKARTA PUSAT, DKI JAKARTA",39,128,86,214
https://kawalpemilu.org#25880,"KAMPUNG BALI, TANAH ABANG, JAKARTA PUSAT, DKI JAKARTA",40,78,88,166
https://kawalpemilu.org#25880,"KAMPUNG BALI, TANAH ABANG, JAKARTA PUSAT, DKI JAKARTA",42,96,104,200
https://kawalpemilu.org#25882,"JOHAR BARU, JOHAR BARU, JAKARTA PUSAT, DKI JAKARTA",1,63,179,242
https://kawalpemilu.org#25882,"JOHAR BARU, JOHAR BARU, JAKARTA PUSAT, DKI JAKARTA",2,71,167,238
https://kawalpemilu.org#25882,"JOHAR BARU, JOHAR BARU, JAKARTA PUSAT, DKI JAKARTA",3,81,161,242
https://kawalpemilu.org#25882,"JOHAR BARU, JOHAR BARU, JAKARTA PUSAT, DKI JAKARTA",4,82,153,235
https://kawalpemilu.org#25882,"JOHAR BARU, JOHAR BARU, JAKARTA PUSAT, DKI JAKARTA",5,116,75,191
https://kawalpemilu.org#25882,"JOHAR BARU, JOHAR BARU, JAKARTA PUSAT, DKI JAKARTA",6,85,138,223
https://kawalpemilu.org#25882,"JOHAR BARU, JOHAR BARU, JAKARTA PUSAT, DKI JAKARTA",7,82,113,195
https://kawalpemilu.org#25882,"JOHAR BARU, JOHAR BARU, JAKARTA PUSAT, DKI JAKARTA",8,116,116,232
https://kawalpemilu.org#25882,"JOHAR BARU, JOHAR BARU, JAKARTA PUSAT, DKI JAKARTA",9,112,126,238
https://kawalpemilu.org#25882,"JOHAR BARU, JOHAR BARU, JAKARTA PUSAT, DKI JAKARTA",10,116,100,216
https://kawalpemilu.org#25882,"JOHAR BARU, JOHAR BARU, JAKARTA PUSAT, DKI JAKARTA",11,113,82,195
https://kawalpemilu.org#25882,"JOHAR BARU, JOHAR BARU, JAKARTA PUSAT, DKI JAKARTA",12,181,58,239
https://kawalpemilu.org#25882,"JOHAR BARU, JOHAR BARU, JAKARTA PUSAT, DKI JAKARTA",13,127,106,233
https://kawalpemilu.org#25882,"JOHAR BARU, JOHAR BARU, JAKARTA PUSAT, DKI JAKARTA",14,82,153,235
https://kawalpemilu.org#25882,"JOHAR BARU, JOHAR BARU, JAKARTA PUSAT, DKI JAKARTA",15,128,105,233
https://kawalpemilu.org#25882,"JOHAR BARU, JOHAR BARU, JAKARTA PUSAT, DKI JAKARTA",16,90,165,255
https://kawalpemilu.org#25882,"JOHAR BARU, JOHAR BARU, JAKARTA PUSAT, DKI JAKARTA",17,107,130,237
https://kawalpemilu.org#25882,"JOHAR BARU, JOHAR BARU, JAKARTA PUSAT, DKI JAKARTA",18,93,167,260
https://kawalpemilu.org#25882,"JOHAR BARU, JOHAR BARU, JAKARTA PUSAT, DKI JAKARTA",19,106,124,230
https://kawalpemilu.org#25882,"JOHAR BARU, JOHAR BARU, JAKARTA PUSAT, DKI JAKARTA",20,84,146,230
https://kawalpemilu.org#25882,"JOHAR BARU, JOHAR BARU, JAKARTA PUSAT, DKI JAKARTA",21,89,167,256
https://kawalpemilu.org#25882,"JOHAR BARU, JOHAR BARU, JAKARTA PUSAT, DKI JAKARTA",22,98,132,230
https://kawalpemilu.org#25882,"JOHAR BARU, JOHAR BARU, JAKARTA PUSAT, DKI JAKARTA",23,97,133,230
https://kawalpemilu.org#25882,"JOHAR BARU, JOHAR BARU, JAKARTA PUSAT, DKI JAKARTA",24,121,136,257
https://kawalpemilu.org#25882,"JOHAR BARU, JOHAR BARU, JAKARTA PUSAT, DKI JAKARTA",25,114,123,237
https://kawalpemilu.org#25882,"JOHAR BARU, JOHAR BARU, JAKARTA PUSAT, DKI JAKARTA",26,93,105,198
https://kawalpemilu.org#25882,"JOHAR BARU, JOHAR BARU, JAKARTA PUSAT, DKI JAKARTA",27,91,153,244
https://kawalpemilu.org#25882,"JOHAR BARU, JOHAR BARU, JAKARTA PUSAT, DKI JAKARTA",28,91,196,287
https://kawalpemilu.org#25882,"JOHAR BARU, JOHAR BARU, JAKARTA PUSAT, DKI JAKARTA",29,95,125,220
https://kawalpemilu.org#25882,"JOHAR BARU, JOHAR BARU, JAKARTA PUSAT, DKI JAKARTA",30,91,150,241
https://kawalpemilu.org#25882,"JOHAR BARU, JOHAR BARU, JAKARTA PUSAT, DKI JAKARTA",31,83,140,223
https://kawalpemilu.org#25882,"JOHAR BARU, JOHAR BARU, JAKARTA PUSAT, DKI JAKARTA",32,66,172,238
https://kawalpemilu.org#25882,"JOHAR BARU, JOHAR BARU, JAKARTA PUSAT, DKI JAKARTA",33,51,104,155
https://kawalpemilu.org#25882,"JOHAR BARU, JOHAR BARU, JAKARTA PUSAT, DKI JAKARTA",34,74,145,219
https://kawalpemilu.org#25882,"JOHAR BARU, JOHAR BARU, JAKARTA PUSAT, DKI JAKARTA",35,82,174,256
https://kawalpemilu.org#25882,"JOHAR BARU, JOHAR BARU, JAKARTA PUSAT, DKI JAKARTA",36,110,103,213
https://kawalpemilu.org#25882,"JOHAR BARU, JOHAR BARU, JAKARTA PUSAT, DKI JAKARTA",37,103,95,198
https://kawalpemilu.org#25882,"JOHAR BARU, JOHAR BARU, JAKARTA PUSAT, DKI JAKARTA",38,87,160,247
https://kawalpemilu.org#25882,"JOHAR BARU, JOHAR BARU, JAKARTA PUSAT, DKI JAKARTA",39,95,156,251
https://kawalpemilu.org#25882,"JOHAR BARU, JOHAR BARU, JAKARTA PUSAT, DKI JAKARTA",40,107,116,223
https://kawalpemilu.org#25882,"JOHAR BARU, JOHAR BARU, JAKARTA PUSAT, DKI JAKARTA",41,95,142,237
https://kawalpemilu.org#25882,"JOHAR BARU, JOHAR BARU, JAKARTA PUSAT, DKI JAKARTA",42,108,123,231
https://kawalpemilu.org#25882,"JOHAR BARU, JOHAR BARU, JAKARTA PUSAT, DKI JAKARTA",43,105,143,248
https://kawalpemilu.org#25882,"JOHAR BARU, JOHAR BARU, JAKARTA PUSAT, DKI JAKARTA",44,102,145,247
https://kawalpemilu.org#25882,"JOHAR BARU, JOHAR BARU, JAKARTA PUSAT, DKI JAKARTA",45,121,126,247
https://kawalpemilu.org#25882,"JOHAR BARU, JOHAR BARU, JAKARTA PUSAT, DKI JAKARTA",46,87,155,242
https://kawalpemilu.org#25882,"JOHAR BARU, JOHAR BARU, JAKARTA PUSAT, DKI JAKARTA",47,110,141,251
https://kawalpemilu.org#25882,"JOHAR BARU, JOHAR BARU, JAKARTA PUSAT, DKI JAKARTA",48,58,168,226
https://kawalpemilu.org#25882,"JOHAR BARU, JOHAR BARU, JAKARTA PUSAT, DKI JAKARTA",49,68,119,187
https://kawalpemilu.org#25882,"JOHAR BARU, JOHAR BARU, JAKARTA PUSAT, DKI JAKARTA",50,96,118,214
https://kawalpemilu.org#25882,"JOHAR BARU, JOHAR BARU, JAKARTA PUSAT, DKI JAKARTA",51,113,129,242
https://kawalpemilu.org#25882,"JOHAR BARU, JOHAR BARU, JAKARTA PUSAT, DKI JAKARTA",52,100,119,219
https://kawalpemilu.org#25882,"JOHAR BARU, JOHAR BARU, JAKARTA PUSAT, DKI JAKARTA",53,110,124,234
https://kawalpemilu.org#25882,"JOHAR BARU, JOHAR BARU, JAKARTA PUSAT, DKI JAKARTA",54,109,132,241
https://kawalpemilu.org#25882,"JOHAR BARU, JOHAR BARU, JAKARTA PUSAT, DKI JAKARTA",55,64,144,208
https://kawalpemilu.org#25882,"JOHAR BARU, JOHAR BARU, JAKARTA PUSAT, DKI JAKARTA",56,104,133,237
https://kawalpemilu.org#25882,"JOHAR BARU, JOHAR BARU, JAKARTA PUSAT, DKI JAKARTA",57,125,95,220
https://kawalpemilu.org#25882,"JOHAR BARU, JOHAR BARU, JAKARTA PUSAT, DKI JAKARTA",58,113,134,247
https://kawalpemilu.org#25882,"JOHAR BARU, JOHAR BARU, JAKARTA PUSAT, DKI JAKARTA",59,102,102,204
https://kawalpemilu.org#25882,"JOHAR BARU, JOHAR BARU, JAKARTA PUSAT, DKI JAKARTA",60,80,125,205
https://kawalpemilu.org#25882,"JOHAR BARU, JOHAR BARU, JAKARTA PUSAT, DKI JAKARTA",61,66,155,221
https://kawalpemilu.org#25882,"JOHAR BARU, JOHAR BARU, JAKARTA PUSAT, DKI JAKARTA",62,84,147,231
https://kawalpemilu.org#25882,"JOHAR BARU, JOHAR BARU, JAKARTA PUSAT, DKI JAKARTA",63,107,96,203
https://kawalpemilu.org#25882,"JOHAR BARU, JOHAR BARU, JAKARTA PUSAT, DKI JAKARTA",64,82,121,203
https://kawalpemilu.org#25882,"JOHAR BARU, JOHAR BARU, JAKARTA PUSAT, DKI JAKARTA",65,86,114,200
https://kawalpemilu.org#25882,"JOHAR BARU, JOHAR BARU, JAKARTA PUSAT, DKI JAKARTA",66,82,78,160
https://kawalpemilu.org#25882,"JOHAR BARU, JOHAR BARU, JAKARTA PUSAT, DKI JAKARTA",67,118,94,212
https://kawalpemilu.org#25882,"JOHAR BARU, JOHAR BARU, JAKARTA PUSAT, DKI JAKARTA",68,76,124,200
https://kawalpemilu.org#25882,"JOHAR BARU, JOHAR BARU, JAKARTA PUSAT, DKI JAKARTA",69,78,127,205
https://kawalpemilu.org#25882,"JOHAR BARU, JOHAR BARU, JAKARTA PUSAT, DKI JAKARTA",70,72,134,206
https://kawalpemilu.org#25882,"JOHAR BARU, JOHAR BARU, JAKARTA PUSAT, DKI JAKARTA",71,80,154,234
https://kawalpemilu.org#25882,"JOHAR BARU, JOHAR BARU, JAKARTA PUSAT, DKI JAKARTA",72,73,110,183
https://kawalpemilu.org#25882,"JOHAR BARU, JOHAR BARU, JAKARTA PUSAT, DKI JAKARTA",73,83,137,220
https://kawalpemilu.org#25882,"JOHAR BARU, JOHAR BARU, JAKARTA PUSAT, DKI JAKARTA",74,86,155,241
https://kawalpemilu.org#25882,"JOHAR BARU, JOHAR BARU, JAKARTA PUSAT, DKI JAKARTA",75,104,126,230
https://kawalpemilu.org#25882,"JOHAR BARU, JOHAR BARU, JAKARTA PUSAT, DKI JAKARTA",76,102,120,222
https://kawalpemilu.org#25882,"JOHAR BARU, JOHAR BARU, JAKARTA PUSAT, DKI JAKARTA",77,102,127,229
https://kawalpemilu.org#25882,"JOHAR BARU, JOHAR BARU, JAKARTA PUSAT, DKI JAKARTA",78,130,111,241
https://kawalpemilu.org#25882,"JOHAR BARU, JOHAR BARU, JAKARTA PUSAT, DKI JAKARTA",79,149,82,231
https://kawalpemilu.org#25882,"JOHAR BARU, JOHAR BARU, JAKARTA PUSAT, DKI JAKARTA",80,89,92,181
https://kawalpemilu.org#25882,"JOHAR BARU, JOHAR BARU, JAKARTA PUSAT, DKI JAKARTA",81,109,79,188
https://kawalpemilu.org#25882,"JOHAR BARU, JOHAR BARU, JAKARTA PUSAT, DKI JAKARTA",82,91,105,196
https://kawalpemilu.org#25882,"JOHAR BARU, JOHAR BARU, JAKARTA PUSAT, DKI JAKARTA",83,107,118,225
https://kawalpemilu.org#25882,"JOHAR BARU, JOHAR BARU, JAKARTA PUSAT, DKI JAKARTA",84,89,117,206
https://kawalpemilu.org#25882,"JOHAR BARU, JOHAR BARU, JAKARTA PUSAT, DKI JAKARTA",85,71,100,171
https://kawalpemilu.org#25882,"JOHAR BARU, JOHAR BARU, JAKARTA PUSAT, DKI JAKARTA",86,123,97,220
https://kawalpemilu.org#25882,"JOHAR BARU, JOHAR BARU, JAKARTA PUSAT, DKI JAKARTA",87,81,99,180
https://kawalpemilu.org#25882,"JOHAR BARU, JOHAR BARU, JAKARTA PUSAT, DKI JAKARTA",88,97,115,212
https://kawalpemilu.org#25882,"JOHAR BARU, JOHAR BARU, JAKARTA PUSAT, DKI JAKARTA",89,111,73,184
https://kawalpemilu.org#25882,"JOHAR BARU, JOHAR BARU, JAKARTA PUSAT, DKI JAKARTA",90,96,87,183
https://kawalpemilu.org#25882,"JOHAR BARU, JOHAR BARU, JAKARTA PUSAT, DKI JAKARTA",91,120,114,234
https://kawalpemilu.org#25882,"JOHAR BARU, JOHAR BARU, JAKARTA PUSAT, DKI JAKARTA",92,86,123,209
https://kawalpemilu.org#25882,"JOHAR BARU, JOHAR BARU, JAKARTA PUSAT, DKI JAKARTA",93,96,108,204
https://kawalpemilu.org#25882,"JOHAR BARU, JOHAR BARU, JAKARTA PUSAT, DKI JAKARTA",94,85,137,222
https://kawalpemilu.org#25882,"JOHAR BARU, JOHAR BARU, JAKARTA PUSAT, DKI JAKARTA",95,69,94,163
https://kawalpemilu.org#25882,"JOHAR BARU, JOHAR BARU, JAKARTA PUSAT, DKI JAKARTA",96,87,93,180
https://kawalpemilu.org#25882,"JOHAR BARU, JOHAR BARU, JAKARTA PUSAT, DKI JAKARTA",97,93,108,201
https://kawalpemilu.org#25882,"JOHAR BARU, JOHAR BARU, JAKARTA PUSAT, DKI JAKARTA",98,124,64,188
https://kawalpemilu.org#25882,"JOHAR BARU, JOHAR BARU, JAKARTA PUSAT, DKI JAKARTA",99,114,99,213
https://kawalpemilu.org#25882,"JOHAR BARU, JOHAR BARU, JAKARTA PUSAT, DKI JAKARTA",100,121,79,200
https://kawalpemilu.org#25882,"JOHAR BARU, JOHAR BARU, JAKARTA PUSAT, DKI JAKARTA",101,108,95,203
https://kawalpemilu.org#25882,"JOHAR BARU, JOHAR BARU, JAKARTA PUSAT, DKI JAKARTA",102,129,120,249
https://kawalpemilu.org#25882,"JOHAR BARU, JOHAR BARU, JAKARTA PUSAT, DKI JAKARTA",103,146,96,242
https://kawalpemilu.org#25882,"JOHAR BARU, JOHAR BARU, JAKARTA PUSAT, DKI JAKARTA",104,94,69,163
https://kawalpemilu.org#25882,"JOHAR BARU, JOHAR BARU, JAKARTA PUSAT, DKI JAKARTA",105,226,23,249
https://kawalpemilu.org#25882,"JOHAR BARU, JOHAR BARU, JAKARTA PUSAT, DKI JAKARTA",106,225,6,231
https://kawalpemilu.org#25882,"JOHAR BARU, JOHAR BARU, JAKARTA PUSAT, DKI JAKARTA",107,237,9,246
https://kawalpemilu.org#25882,"JOHAR BARU, JOHAR BARU, JAKARTA PUSAT, DKI JAKARTA",108,172,1,173
https://kawalpemilu.org#25882,"JOHAR BARU, JOHAR BARU, JAKARTA PUSAT, DKI JAKARTA",109,175,21,196
https://kawalpemilu.org#25882,"JOHAR BARU, JOHAR BARU, JAKARTA PUSAT, DKI JAKARTA",110,162,41,203
https://kawalpemilu.org#25882,"JOHAR BARU, JOHAR BARU, JAKARTA PUSAT, DKI JAKARTA",111,190,53,243
https://kawalpemilu.org#25882,"JOHAR BARU, JOHAR BARU, JAKARTA PUSAT, DKI JAKARTA",112,223,8,231
https://kawalpemilu.org#25882,"JOHAR BARU, JOHAR BARU, JAKARTA PUSAT, DKI JAKARTA",113,82,155,237
https://kawalpemilu.org#25882,"JOHAR BARU, JOHAR BARU, JAKARTA PUSAT, DKI JAKARTA",114,91,139,230
https://kawalpemilu.org#25882,"JOHAR BARU, JOHAR BARU, JAKARTA PUSAT, DKI JAKARTA",115,103,128,231
https://kawalpemilu.org#25882,"JOHAR BARU, JOHAR BARU, JAKARTA PUSAT, DKI JAKARTA",116,116,119,235
https://kawalpemilu.org#25882,"JOHAR BARU, JOHAR BARU, JAKARTA PUSAT, DKI JAKARTA",117,90,127,217
https://kawalpemilu.org#25882,"JOHAR BARU, JOHAR BARU, JAKARTA PUSAT, DKI JAKARTA",118,67,137,204
https://kawalpemilu.org#25882,"JOHAR BARU, JOHAR BARU, JAKARTA PUSAT, DKI JAKARTA",119,103,126,229
https://kawalpemilu.org#25882,"JOHAR BARU, JOHAR BARU, JAKARTA PUSAT, DKI JAKARTA",120,92,93,185
https://kawalpemilu.org#25882,"JOHAR BARU, JOHAR BARU, JAKARTA PUSAT, DKI JAKARTA",121,87,136,223
https://kawalpemilu.org#25883,"KAMPUNG RAWA, JOHAR BARU, JAKARTA PUSAT, DKI JAKARTA",1,73,140,213
https://kawalpemilu.org#25883,"KAMPUNG RAWA, JOHAR BARU, JAKARTA PUSAT, DKI JAKARTA",2,95,140,235
https://kawalpemilu.org#25883,"KAMPUNG RAWA, JOHAR BARU, JAKARTA PUSAT, DKI JAKARTA",3,112,137,249
https://kawalpemilu.org#25883,"KAMPUNG RAWA, JOHAR BARU, JAKARTA PUSAT, DKI JAKARTA",5,78,155,233
https://kawalpemilu.org#25883,"KAMPUNG RAWA, JOHAR BARU, JAKARTA PUSAT, DKI JAKARTA",6,78,107,185
https://kawalpemilu.org#25883,"KAMPUNG RAWA, JOHAR BARU, JAKARTA PUSAT, DKI JAKARTA",7,116,108,224
https://kawalpemilu.org#25883,"KAMPUNG RAWA, JOHAR BARU, JAKARTA PUSAT, DKI JAKARTA",8,76,131,207
https://kawalpemilu.org#25883,"KAMPUNG RAWA, JOHAR BARU, JAKARTA PUSAT, DKI JAKARTA",9,142,112,254
https://kawalpemilu.org#25883,"KAMPUNG RAWA, JOHAR BARU, JAKARTA PUSAT, DKI JAKARTA",10,101,99,200
https://kawalpemilu.org#25883,"KAMPUNG RAWA, JOHAR BARU, JAKARTA PUSAT, DKI JAKARTA",11,95,143,238
https://kawalpemilu.org#25883,"KAMPUNG RAWA, JOHAR BARU, JAKARTA PUSAT, DKI JAKARTA",12,113,91,204
https://kawalpemilu.org#25883,"KAMPUNG RAWA, JOHAR BARU, JAKARTA PUSAT, DKI JAKARTA",13,122,91,213
https://kawalpemilu.org#25883,"KAMPUNG RAWA, JOHAR BARU, JAKARTA PUSAT, DKI JAKARTA",14,86,125,211
https://kawalpemilu.org#25883,"KAMPUNG RAWA, JOHAR BARU, JAKARTA PUSAT, DKI JAKARTA",15,77,146,223
https://kawalpemilu.org#25883,"KAMPUNG RAWA, JOHAR BARU, JAKARTA PUSAT, DKI JAKARTA",16,63,175,238
https://kawalpemilu.org#25883,"KAMPUNG RAWA, JOHAR BARU, JAKARTA PUSAT, DKI JAKARTA",17,69,151,220
https://kawalpemilu.org#25883,"KAMPUNG RAWA, JOHAR BARU, JAKARTA PUSAT, DKI JAKARTA",18,100,149,249
https://kawalpemilu.org#25883,"KAMPUNG RAWA, JOHAR BARU, JAKARTA PUSAT, DKI JAKARTA",19,46,157,203
https://kawalpemilu.org#25883,"KAMPUNG RAWA, JOHAR BARU, JAKARTA PUSAT, DKI JAKARTA",20,50,157,207
https://kawalpemilu.org#25883,"KAMPUNG RAWA, JOHAR BARU, JAKARTA PUSAT, DKI JAKARTA",21,86,117,203
https://kawalpemilu.org#25883,"KAMPUNG RAWA, JOHAR BARU, JAKARTA PUSAT, DKI JAKARTA",22,99,163,262
https://kawalpemilu.org#25883,"KAMPUNG RAWA, JOHAR BARU, JAKARTA PUSAT, DKI JAKARTA",24,84,150,234
https://kawalpemilu.org#25883,"KAMPUNG RAWA, JOHAR BARU, JAKARTA PUSAT, DKI JAKARTA",25,68,143,211
https://kawalpemilu.org#25883,"KAMPUNG RAWA, JOHAR BARU, JAKARTA PUSAT, DKI JAKARTA",26,113,99,212
https://kawalpemilu.org#25883,"KAMPUNG RAWA, JOHAR BARU, JAKARTA PUSAT, DKI JAKARTA",27,100,110,210
https://kawalpemilu.org#25883,"KAMPUNG RAWA, JOHAR BARU, JAKARTA PUSAT, DKI JAKARTA",28,112,110,222
https://kawalpemilu.org#25883,"KAMPUNG RAWA, JOHAR BARU, JAKARTA PUSAT, DKI JAKARTA",29,113,116,229
https://kawalpemilu.org#25883,"KAMPUNG RAWA, JOHAR BARU, JAKARTA PUSAT, DKI JAKARTA",30,116,103,219
https://kawalpemilu.org#25883,"KAMPUNG RAWA, JOHAR BARU, JAKARTA PUSAT, DKI JAKARTA",31,95,126,221
https://kawalpemilu.org#25883,"KAMPUNG RAWA, JOHAR BARU, JAKARTA PUSAT, DKI JAKARTA",33,66,154,220
https://kawalpemilu.org#25883,"KAMPUNG RAWA, JOHAR BARU, JAKARTA PUSAT, DKI JAKARTA",34,61,139,200
https://kawalpemilu.org#25883,"KAMPUNG RAWA, JOHAR BARU, JAKARTA PUSAT, DKI JAKARTA",35,85,162,247
https://kawalpemilu.org#25883,"KAMPUNG RAWA, JOHAR BARU, JAKARTA PUSAT, DKI JAKARTA",36,93,135,228
https://kawalpemilu.org#25883,"KAMPUNG RAWA, JOHAR BARU, JAKARTA PUSAT, DKI JAKARTA",37,123,122,245
https://kawalpemilu.org#25883,"KAMPUNG RAWA, JOHAR BARU, JAKARTA PUSAT, DKI JAKARTA",38,156,71,227
https://kawalpemilu.org#25883,"KAMPUNG RAWA, JOHAR BARU, JAKARTA PUSAT, DKI JAKARTA",40,75,155,230
https://kawalpemilu.org#25883,"KAMPUNG RAWA, JOHAR BARU, JAKARTA PUSAT, DKI JAKARTA",41,85,121,206
https://kawalpemilu.org#25883,"KAMPUNG RAWA, JOHAR BARU, JAKARTA PUSAT, DKI JAKARTA",42,94,129,223
https://kawalpemilu.org#25883,"KAMPUNG RAWA, JOHAR BARU, JAKARTA PUSAT, DKI JAKARTA",43,129,104,233
https://kawalpemilu.org#25883,"KAMPUNG RAWA, JOHAR BARU, JAKARTA PUSAT, DKI JAKARTA",45,94,135,229
https://kawalpemilu.org#25883,"KAMPUNG RAWA, JOHAR BARU, JAKARTA PUSAT, DKI JAKARTA",46,139,102,241
https://kawalpemilu.org#25883,"KAMPUNG RAWA, JOHAR BARU, JAKARTA PUSAT, DKI JAKARTA",47,79,162,241
https://kawalpemilu.org#25883,"KAMPUNG RAWA, JOHAR BARU, JAKARTA PUSAT, DKI JAKARTA",48,95,103,198
https://kawalpemilu.org#25883,"KAMPUNG RAWA, JOHAR BARU, JAKARTA PUSAT, DKI JAKARTA",49,71,133,204
https://kawalpemilu.org#25883,"KAMPUNG RAWA, JOHAR BARU, JAKARTA PUSAT, DKI JAKARTA",50,81,123,204
https://kawalpemilu.org#25883,"KAMPUNG RAWA, JOHAR BARU, JAKARTA PUSAT, DKI JAKARTA",51,88,135,223
https://kawalpemilu.org#25883,"KAMPUNG RAWA, JOHAR BARU, JAKARTA PUSAT, DKI JAKARTA",52,72,166,238
https://kawalpemilu.org#25883,"KAMPUNG RAWA, JOHAR BARU, JAKARTA PUSAT, DKI JAKARTA",53,95,134,229
https://kawalpemilu.org#25883,"KAMPUNG RAWA, JOHAR BARU, JAKARTA PUSAT, DKI JAKARTA",54,111,104,215
https://kawalpemilu.org#25883,"KAMPUNG RAWA, JOHAR BARU, JAKARTA PUSAT, DKI JAKARTA",55,78,138,216
https://kawalpemilu.org#25883,"KAMPUNG RAWA, JOHAR BARU, JAKARTA PUSAT, DKI JAKARTA",56,89,152,241
https://kawalpemilu.org#25883,"KAMPUNG RAWA, JOHAR BARU, JAKARTA PUSAT, DKI JAKARTA",57,102,128,230
https://kawalpemilu.org#25883,"KAMPUNG RAWA, JOHAR BARU, JAKARTA PUSAT, DKI JAKARTA",58,92,149,241
https://kawalpemilu.org#25883,"KAMPUNG RAWA, JOHAR BARU, JAKARTA PUSAT, DKI JAKARTA",59,95,140,235
https://kawalpemilu.org#25883,"KAMPUNG RAWA, JOHAR BARU, JAKARTA PUSAT, DKI JAKARTA",60,104,138,242
https://kawalpemilu.org#25883,"KAMPUNG RAWA, JOHAR BARU, JAKARTA PUSAT, DKI JAKARTA",61,102,168,270
https://kawalpemilu.org#25883,"KAMPUNG RAWA, JOHAR BARU, JAKARTA PUSAT, DKI JAKARTA",62,105,140,245
https://kawalpemilu.org#25883,"KAMPUNG RAWA, JOHAR BARU, JAKARTA PUSAT, DKI JAKARTA",63,67,138,205
https://kawalpemilu.org#25883,"KAMPUNG RAWA, JOHAR BARU, JAKARTA PUSAT, DKI JAKARTA",64,86,93,179
https://kawalpemilu.org#25883,"KAMPUNG RAWA, JOHAR BARU, JAKARTA PUSAT, DKI JAKARTA",65,77,123,200
https://kawalpemilu.org#25883,"KAMPUNG RAWA, JOHAR BARU, JAKARTA PUSAT, DKI JAKARTA",66,81,94,175
https://kawalpemilu.org#25883,"KAMPUNG RAWA, JOHAR BARU, JAKARTA PUSAT, DKI JAKARTA",67,109,100,209
https://kawalpemilu.org#25883,"KAMPUNG RAWA, JOHAR BARU, JAKARTA PUSAT, DKI JAKARTA",68,108,101,209
https://kawalpemilu.org#25883,"KAMPUNG RAWA, JOHAR BARU, JAKARTA PUSAT, DKI JAKARTA",69,85,51,136
https://kawalpemilu.org#25884,"GALUR, JOHAR BARU, JAKARTA PUSAT, DKI JAKARTA",1,120,117,237
https://kawalpemilu.org#25884,"GALUR, JOHAR BARU, JAKARTA PUSAT, DKI JAKARTA",2,104,116,220
https://kawalpemilu.org#25884,"GALUR, JOHAR BARU, JAKARTA PUSAT, DKI JAKARTA",3,66,161,227
https://kawalpemilu.org#25884,"GALUR, JOHAR BARU, JAKARTA PUSAT, DKI JAKARTA",4,77,152,229
https://kawalpemilu.org#25884,"GALUR, JOHAR BARU, JAKARTA PUSAT, DKI JAKARTA",5,122,107,229
https://kawalpemilu.org#25884,"GALUR, JOHAR BARU, JAKARTA PUSAT, DKI JAKARTA",6,112,124,2
https://kawalpemilu.org#25884,"GALUR, JOHAR BARU, JAKARTA PUSAT, DKI JAKARTA",7,95,127,222
https://kawalpemilu.org#25884,"GALUR, JOHAR BARU, JAKARTA PUSAT, DKI JAKARTA",8,135,68,203
https://kawalpemilu.org#25884,"GALUR, JOHAR BARU, JAKARTA PUSAT, DKI JAKARTA",9,101,97,198
https://kawalpemilu.org#25884,"GALUR, JOHAR BARU, JAKARTA PUSAT, DKI JAKARTA",10,90,125,215
https://kawalpemilu.org#25884,"GALUR, JOHAR BARU, JAKARTA PUSAT, DKI JAKARTA",11,73,141,214
https://kawalpemilu.org#25884,"GALUR, JOHAR BARU, JAKARTA PUSAT, DKI JAKARTA",12,61,141,202
https://kawalpemilu.org#25884,"GALUR, JOHAR BARU, JAKARTA PUSAT, DKI JAKARTA",13,101,124,225
https://kawalpemilu.org#25884,"GALUR, JOHAR BARU, JAKARTA PUSAT, DKI JAKARTA",14,102,123,225
https://kawalpemilu.org#25884,"GALUR, JOHAR BARU, JAKARTA PUSAT, DKI JAKARTA",15,98,136,234
https://kawalpemilu.org#25884,"GALUR, JOHAR BARU, JAKARTA PUSAT, DKI JAKARTA",16,116,84,200
https://kawalpemilu.org#25884,"GALUR, JOHAR BARU, JAKARTA PUSAT, DKI JAKARTA",17,124,91,215
https://kawalpemilu.org#25884,"GALUR, JOHAR BARU, JAKARTA PUSAT, DKI JAKARTA",18,107,104,211
https://kawalpemilu.org#25884,"GALUR, JOHAR BARU, JAKARTA PUSAT, DKI JAKARTA",19,114,90,204
https://kawalpemilu.org#25884,"GALUR, JOHAR BARU, JAKARTA PUSAT, DKI JAKARTA",20,80,129,209
https://kawalpemilu.org#25884,"GALUR, JOHAR BARU, JAKARTA PUSAT, DKI JAKARTA",21,81,131,212
https://kawalpemilu.org#25884,"GALUR, JOHAR BARU, JAKARTA PUSAT, DKI JAKARTA",22,87,123,210
https://kawalpemilu.org#25884,"GALUR, JOHAR BARU, JAKARTA PUSAT, DKI JAKARTA",23,106,80,186
https://kawalpemilu.org#25884,"GALUR, JOHAR BARU, JAKARTA PUSAT, DKI JAKARTA",24,64,138,202
https://kawalpemilu.org#25884,"GALUR, JOHAR BARU, JAKARTA PUSAT, DKI JAKARTA",25,74,93,167
https://kawalpemilu.org#25884,"GALUR, JOHAR BARU, JAKARTA PUSAT, DKI JAKARTA",26,94,101,195
https://kawalpemilu.org#25884,"GALUR, JOHAR BARU, JAKARTA PUSAT, DKI JAKARTA",27,82,143,225
https://kawalpemilu.org#25884,"GALUR, JOHAR BARU, JAKARTA PUSAT, DKI JAKARTA",28,69,165,234
https://kawalpemilu.org#25884,"GALUR, JOHAR BARU, JAKARTA PUSAT, DKI JAKARTA",29,68,144,212
https://kawalpemilu.org#25884,"GALUR, JOHAR BARU, JAKARTA PUSAT, DKI JAKARTA",30,63,166,229
https://kawalpemilu.org#25884,"GALUR, JOHAR BARU, JAKARTA PUSAT, DKI JAKARTA",31,100,108,208
https://kawalpemilu.org#25884,"GALUR, JOHAR BARU, JAKARTA PUSAT, DKI JAKARTA",32,123,93,216
https://kawalpemilu.org#25884,"GALUR, JOHAR BARU, JAKARTA PUSAT, DKI JAKARTA",33,105,127,232
https://kawalpemilu.org#25884,"GALUR, JOHAR BARU, JAKARTA PUSAT, DKI JAKARTA",34,143,69,212
https://kawalpemilu.org#25884,"GALUR, JOHAR BARU, JAKARTA PUSAT, DKI JAKARTA",35,119,90,209
https://kawalpemilu.org#25884,"GALUR, JOHAR BARU, JAKARTA PUSAT, DKI JAKARTA",36,92,92,186
https://kawalpemilu.org#25884,"GALUR, JOHAR BARU, JAKARTA PUSAT, DKI JAKARTA",37,89,149,238
https://kawalpemilu.org#25884,"GALUR, JOHAR BARU, JAKARTA PUSAT, DKI JAKARTA",38,74,150,224
https://kawalpemilu.org#25884,"GALUR, JOHAR BARU, JAKARTA PUSAT, DKI JAKARTA",39,81,106,187
https://kawalpemilu.org#25884,"GALUR, JOHAR BARU, JAKARTA PUSAT, DKI JAKARTA",40,107,93,200
https://kawalpemilu.org#25884,"GALUR, JOHAR BARU, JAKARTA PUSAT, DKI JAKARTA",41,91,94,185
https://kawalpemilu.org#25884,"GALUR, JOHAR BARU, JAKARTA PUSAT, DKI JAKARTA",42,93,103,196
https://kawalpemilu.org#25884,"GALUR, JOHAR BARU, JAKARTA PUSAT, DKI JAKARTA",43,66,100,166
https://kawalpemilu.org#25884,"GALUR, JOHAR BARU, JAKARTA PUSAT, DKI JAKARTA",44,86,111,197
https://kawalpemilu.org#25884,"GALUR, JOHAR BARU, JAKARTA PUSAT, DKI JAKARTA",45,103,106,209
https://kawalpemilu.org#25884,"GALUR, JOHAR BARU, JAKARTA PUSAT, DKI JAKARTA",46,85,125,210
https://kawalpemilu.org#25884,"GALUR, JOHAR BARU, JAKARTA PUSAT, DKI JAKARTA",47,86,121,207
https://kawalpemilu.org#25884,"GALUR, JOHAR BARU, JAKARTA PUSAT, DKI JAKARTA",48,64,150,214
https://kawalpemilu.org#25884,"GALUR, JOHAR BARU, JAKARTA PUSAT, DKI JAKARTA",49,85,109,194
https://kawalpemilu.org#25884,"GALUR, JOHAR BARU, JAKARTA PUSAT, DKI JAKARTA",50,105,111,216
https://kawalpemilu.org#25884,"GALUR, JOHAR BARU, JAKARTA PUSAT, DKI JAKARTA",51,78,112,190
https://kawalpemilu.org#25884,"GALUR, JOHAR BARU, JAKARTA PUSAT, DKI JAKARTA",52,92,105,197
https://kawalpemilu.org#25884,"GALUR, JOHAR BARU, JAKARTA PUSAT, DKI JAKARTA",53,99,112,211
https://kawalpemilu.org#25884,"GALUR, JOHAR BARU, JAKARTA PUSAT, DKI JAKARTA",54,84,147,231
https://kawalpemilu.org#25884,"GALUR, JOHAR BARU, JAKARTA PUSAT, DKI JAKARTA",55,65,119,184
https://kawalpemilu.org#25884,"GALUR, JOHAR BARU, JAKARTA PUSAT, DKI JAKARTA",56,87,119,206
https://kawalpemilu.org#25884,"GALUR, JOHAR BARU, JAKARTA PUSAT, DKI JAKARTA",57,130,124,254
https://kawalpemilu.org#25884,"GALUR, JOHAR BARU, JAKARTA PUSAT, DKI JAKARTA",58,87,113,200
https://kawalpemilu.org#25884,"GALUR, JOHAR BARU, JAKARTA PUSAT, DKI JAKARTA",59,132,96,228
https://kawalpemilu.org#25884,"GALUR, JOHAR BARU, JAKARTA PUSAT, DKI JAKARTA",60,94,124,218
https://kawalpemilu.org#25884,"GALUR, JOHAR BARU, JAKARTA PUSAT, DKI JAKARTA",61,109,108,217
https://kawalpemilu.org#25884,"GALUR, JOHAR BARU, JAKARTA PUSAT, DKI JAKARTA",62,136,66,202
https://kawalpemilu.org#25885,"TANAH TINGGI, JOHAR BARU, JAKARTA PUSAT, DKI JAKARTA",1,100,96,196
https://kawalpemilu.org#25885,"TANAH TINGGI, JOHAR BARU, JAKARTA PUSAT, DKI JAKARTA",2,172,38,210
https://kawalpemilu.org#25885,"TANAH TINGGI, JOHAR BARU, JAKARTA PUSAT, DKI JAKARTA",3,193,34,227
https://kawalpemilu.org#25885,"TANAH TINGGI, JOHAR BARU, JAKARTA PUSAT, DKI JAKARTA",4,163,45,208
https://kawalpemilu.org#25885,"TANAH TINGGI, JOHAR BARU, JAKARTA PUSAT, DKI JAKARTA",5,100,139,239
https://kawalpemilu.org#25885,"TANAH TINGGI, JOHAR BARU, JAKARTA PUSAT, DKI JAKARTA",6,167,67,234
https://kawalpemilu.org#25885,"TANAH TINGGI, JOHAR BARU, JAKARTA PUSAT, DKI JAKARTA",7,140,88,228
https://kawalpemilu.org#25885,"TANAH TINGGI, JOHAR BARU, JAKARTA PUSAT, DKI JAKARTA",8,137,109,246
https://kawalpemilu.org#25885,"TANAH TINGGI, JOHAR BARU, JAKARTA PUSAT, DKI JAKARTA",9,141,94,235
https://kawalpemilu.org#25885,"TANAH TINGGI, JOHAR BARU, JAKARTA PUSAT, DKI JAKARTA",10,153,80,233
https://kawalpemilu.org#25885,"TANAH TINGGI, JOHAR BARU, JAKARTA PUSAT, DKI JAKARTA",11,211,41,252
https://kawalpemilu.org#25885,"TANAH TINGGI, JOHAR BARU, JAKARTA PUSAT, DKI JAKARTA",12,187,62,249
https://kawalpemilu.org#25885,"TANAH TINGGI, JOHAR BARU, JAKARTA PUSAT, DKI JAKARTA",13,187,44,231
https://kawalpemilu.org#25885,"TANAH TINGGI, JOHAR BARU, JAKARTA PUSAT, DKI JAKARTA",14,233,6,239
https://kawalpemilu.org#25885,"TANAH TINGGI, JOHAR BARU, JAKARTA PUSAT, DKI JAKARTA",15,151,79,230
https://kawalpemilu.org#25885,"TANAH TINGGI, JOHAR BARU, JAKARTA PUSAT, DKI JAKARTA",16,125,92,217
https://kawalpemilu.org#25885,"TANAH TINGGI, JOHAR BARU, JAKARTA PUSAT, DKI JAKARTA",17,125,96,221
https://kawalpemilu.org#25885,"TANAH TINGGI, JOHAR BARU, JAKARTA PUSAT, DKI JAKARTA",18,100,124,224
https://kawalpemilu.org#25885,"TANAH TINGGI, JOHAR BARU, JAKARTA PUSAT, DKI JAKARTA",19,118,91,209
https://kawalpemilu.org#25885,"TANAH TINGGI, JOHAR BARU, JAKARTA PUSAT, DKI JAKARTA",20,133,87,220
https://kawalpemilu.org#25885,"TANAH TINGGI, JOHAR BARU, JAKARTA PUSAT, DKI JAKARTA",22,135,95,230
https://kawalpemilu.org#25885,"TANAH TINGGI, JOHAR BARU, JAKARTA PUSAT, DKI JAKARTA",23,134,80,214
https://kawalpemilu.org#25885,"TANAH TINGGI, JOHAR BARU, JAKARTA PUSAT, DKI JAKARTA",24,114,110,224
https://kawalpemilu.org#25885,"TANAH TINGGI, JOHAR BARU, JAKARTA PUSAT, DKI JAKARTA",25,114,100,214
https://kawalpemilu.org#25885,"TANAH TINGGI, JOHAR BARU, JAKARTA PUSAT, DKI JAKARTA",26,183,61,244
https://kawalpemilu.org#25885,"TANAH TINGGI, JOHAR BARU, JAKARTA PUSAT, DKI JAKARTA",27,187,58,245
https://kawalpemilu.org#25885,"TANAH TINGGI, JOHAR BARU, JAKARTA PUSAT, DKI JAKARTA",28,184,51,235
https://kawalpemilu.org#25885,"TANAH TINGGI, JOHAR BARU, JAKARTA PUSAT, DKI JAKARTA",29,113,97,210
https://kawalpemilu.org#25885,"TANAH TINGGI, JOHAR BARU, JAKARTA PUSAT, DKI JAKARTA",30,133,72,205
https://kawalpemilu.org#25885,"TANAH TINGGI, JOHAR BARU, JAKARTA PUSAT, DKI JAKARTA",31,93,84,177
https://kawalpemilu.org#25885,"TANAH TINGGI, JOHAR BARU, JAKARTA PUSAT, DKI JAKARTA",32,172,50,222
https://kawalpemilu.org#25885,"TANAH TINGGI, JOHAR BARU, JAKARTA PUSAT, DKI JAKARTA",33,184,57,241
https://kawalpemilu.org#25885,"TANAH TINGGI, JOHAR BARU, JAKARTA PUSAT, DKI JAKARTA",34,205,26,231
https://kawalpemilu.org#25885,"TANAH TINGGI, JOHAR BARU, JAKARTA PUSAT, DKI JAKARTA",35,158,46,204
https://kawalpemilu.org#25885,"TANAH TINGGI, JOHAR BARU, JAKARTA PUSAT, DKI JAKARTA",36,90,142,232
https://kawalpemilu.org#25885,"TANAH TINGGI, JOHAR BARU, JAKARTA PUSAT, DKI JAKARTA",38,124,104,228
https://kawalpemilu.org#25885,"TANAH TINGGI, JOHAR BARU, JAKARTA PUSAT, DKI JAKARTA",39,81,145,226
https://kawalpemilu.org#25885,"TANAH TINGGI, JOHAR BARU, JAKARTA PUSAT, DKI JAKARTA",40,99,112,211
https://kawalpemilu.org#25885,"TANAH TINGGI, JOHAR BARU, JAKARTA PUSAT, DKI JAKARTA",41,133,69,202
https://kawalpemilu.org#25885,"TANAH TINGGI, JOHAR BARU, JAKARTA PUSAT, DKI JAKARTA",42,149,49,198
https://kawalpemilu.org#25885,"TANAH TINGGI, JOHAR BARU, JAKARTA PUSAT, DKI JAKARTA",43,88,133,221
https://kawalpemilu.org#25885,"TANAH TINGGI, JOHAR BARU, JAKARTA PUSAT, DKI JAKARTA",44,113,97,210
https://kawalpemilu.org#25885,"TANAH TINGGI, JOHAR BARU, JAKARTA PUSAT, DKI JAKARTA",45,112,103,215
https://kawalpemilu.org#25885,"TANAH TINGGI, JOHAR BARU, JAKARTA PUSAT, DKI JAKARTA",46,93,96,189
https://kawalpemilu.org#25885,"TANAH TINGGI, JOHAR BARU, JAKARTA PUSAT, DKI JAKARTA",47,91,113,204
https://kawalpemilu.org#25885,"TANAH TINGGI, JOHAR BARU, JAKARTA PUSAT, DKI JAKARTA",49,128,74,202
https://kawalpemilu.org#25885,"TANAH TINGGI, JOHAR BARU, JAKARTA PUSAT, DKI JAKARTA",50,83,124,207
https://kawalpemilu.org#25885,"TANAH TINGGI, JOHAR BARU, JAKARTA PUSAT, DKI JAKARTA",51,110,88,202
https://kawalpemilu.org#25885,"TANAH TINGGI, JOHAR BARU, JAKARTA PUSAT, DKI JAKARTA",53,94,98,192
https://kawalpemilu.org#25885,"TANAH TINGGI, JOHAR BARU, JAKARTA PUSAT, DKI JAKARTA",54,104,104,208
https://kawalpemilu.org#25885,"TANAH TINGGI, JOHAR BARU, JAKARTA PUSAT, DKI JAKARTA",55,91,157,248
https://kawalpemilu.org#25885,"TANAH TINGGI, JOHAR BARU, JAKARTA PUSAT, DKI JAKARTA",56,100,111,211
https://kawalpemilu.org#25885,"TANAH TINGGI, JOHAR BARU, JAKARTA PUSAT, DKI JAKARTA",57,122,103,225
https://kawalpemilu.org#25885,"TANAH TINGGI, JOHAR BARU, JAKARTA PUSAT, DKI JAKARTA",58,73,99,172
https://kawalpemilu.org#25885,"TANAH TINGGI, JOHAR BARU, JAKARTA PUSAT, DKI JAKARTA",59,121,123,244
https://kawalpemilu.org#25885,"TANAH TINGGI, JOHAR BARU, JAKARTA PUSAT, DKI JAKARTA",60,137,80,217
https://kawalpemilu.org#25885,"TANAH TINGGI, JOHAR BARU, JAKARTA PUSAT, DKI JAKARTA",61,100,143,243
https://kawalpemilu.org#25885,"TANAH TINGGI, JOHAR BARU, JAKARTA PUSAT, DKI JAKARTA",62,86,134,220
https://kawalpemilu.org#25885,"TANAH TINGGI, JOHAR BARU, JAKARTA PUSAT, DKI JAKARTA",63,96,100,196
https://kawalpemilu.org#25885,"TANAH TINGGI, JOHAR BARU, JAKARTA PUSAT, DKI JAKARTA",64,82,112,194
https://kawalpemilu.org#25885,"TANAH TINGGI, JOHAR BARU, JAKARTA PUSAT, DKI JAKARTA",65,99,138,237
https://kawalpemilu.org#25885,"TANAH TINGGI, JOHAR BARU, JAKARTA PUSAT, DKI JAKARTA",66,130,83,213
https://kawalpemilu.org#25885,"TANAH TINGGI, JOHAR BARU, JAKARTA PUSAT, DKI JAKARTA",67,116,92,208
https://kawalpemilu.org#25885,"TANAH TINGGI, JOHAR BARU, JAKARTA PUSAT, DKI JAKARTA",68,102,107,209
https://kawalpemilu.org#25885,"TANAH TINGGI, JOHAR BARU, JAKARTA PUSAT, DKI JAKARTA",69,85,114,199
https://kawalpemilu.org#25885,"TANAH TINGGI, JOHAR BARU, JAKARTA PUSAT, DKI JAKARTA",70,114,109,223
https://kawalpemilu.org#25885,"TANAH TINGGI, JOHAR BARU, JAKARTA PUSAT, DKI JAKARTA",71,136,94,230
https://kawalpemilu.org#25885,"TANAH TINGGI, JOHAR BARU, JAKARTA PUSAT, DKI JAKARTA",72,92,117,209
https://kawalpemilu.org#25885,"TANAH TINGGI, JOHAR BARU, JAKARTA PUSAT, DKI JAKARTA",73,99,147,246
https://kawalpemilu.org#25885,"TANAH TINGGI, JOHAR BARU, JAKARTA PUSAT, DKI JAKARTA",74,83,153,236
https://kawalpemilu.org#25885,"TANAH TINGGI, JOHAR BARU, JAKARTA PUSAT, DKI JAKARTA",75,106,123,2
https://kawalpemilu.org#25885,"TANAH TINGGI, JOHAR BARU, JAKARTA PUSAT, DKI JAKARTA",76,81,105,186
https://kawalpemilu.org#25885,"TANAH TINGGI, JOHAR BARU, JAKARTA PUSAT, DKI JAKARTA",77,71,134,205
https://kawalpemilu.org#25885,"TANAH TINGGI, JOHAR BARU, JAKARTA PUSAT, DKI JAKARTA",78,131,105,236
https://kawalpemilu.org#25885,"TANAH TINGGI, JOHAR BARU, JAKARTA PUSAT, DKI JAKARTA",79,104,114,218
https://kawalpemilu.org#25885,"TANAH TINGGI, JOHAR BARU, JAKARTA PUSAT, DKI JAKARTA",80,121,114,235
https://kawalpemilu.org#25885,"TANAH TINGGI, JOHAR BARU, JAKARTA PUSAT, DKI JAKARTA",82,89,126,215
https://kawalpemilu.org#25885,"TANAH TINGGI, JOHAR BARU, JAKARTA PUSAT, DKI JAKARTA",83,76,159,235
https://kawalpemilu.org#25885,"TANAH TINGGI, JOHAR BARU, JAKARTA PUSAT, DKI JAKARTA",84,64,141,205
https://kawalpemilu.org#25885,"TANAH TINGGI, JOHAR BARU, JAKARTA PUSAT, DKI JAKARTA",85,65,163,228
https://kawalpemilu.org#25885,"TANAH TINGGI, JOHAR BARU, JAKARTA PUSAT, DKI JAKARTA",86,122,105,227
https://kawalpemilu.org#25885,"TANAH TINGGI, JOHAR BARU, JAKARTA PUSAT, DKI JAKARTA",87,76,125,201
https://kawalpemilu.org#25885,"TANAH TINGGI, JOHAR BARU, JAKARTA PUSAT, DKI JAKARTA",88,69,161,230
https://kawalpemilu.org#25885,"TANAH TINGGI, JOHAR BARU, JAKARTA PUSAT, DKI JAKARTA",90,106,96,202
https://kawalpemilu.org#25885,"TANAH TINGGI, JOHAR BARU, JAKARTA PUSAT, DKI JAKARTA",91,109,95,204
https://kawalpemilu.org#25885,"TANAH TINGGI, JOHAR BARU, JAKARTA PUSAT, DKI JAKARTA",93,141,106,247
https://kawalpemilu.org#25885,"TANAH TINGGI, JOHAR BARU, JAKARTA PUSAT, DKI JAKARTA",94,124,104,228
https://kawalpemilu.org#25885,"TANAH TINGGI, JOHAR BARU, JAKARTA PUSAT, DKI JAKARTA",95,132,74,2
https://kawalpemilu.org#25885,"TANAH TINGGI, JOHAR BARU, JAKARTA PUSAT, DKI JAKARTA",96,151,59,210
https://kawalpemilu.org#25885,"TANAH TINGGI, JOHAR BARU, JAKARTA PUSAT, DKI JAKARTA",97,134,76,210
https://kawalpemilu.org#25885,"TANAH TINGGI, JOHAR BARU, JAKARTA PUSAT, DKI JAKARTA",98,125,94,219
https://kawalpemilu.org#25885,"TANAH TINGGI, JOHAR BARU, JAKARTA PUSAT, DKI JAKARTA",99,143,96,2
https://kawalpemilu.org#25885,"TANAH TINGGI, JOHAR BARU, JAKARTA PUSAT, DKI JAKARTA",101,102,76,178
https://kawalpemilu.org#25885,"TANAH TINGGI, JOHAR BARU, JAKARTA PUSAT, DKI JAKARTA",102,133,72,205
https://kawalpemilu.org#25885,"TANAH TINGGI, JOHAR BARU, JAKARTA PUSAT, DKI JAKARTA",103,91,126,217
https://kawalpemilu.org#25885,"TANAH TINGGI, JOHAR BARU, JAKARTA PUSAT, DKI JAKARTA",104,87,149,236
https://kawalpemilu.org#25885,"TANAH TINGGI, JOHAR BARU, JAKARTA PUSAT, DKI JAKARTA",105,92,122,214
https://kawalpemilu.org#25885,"TANAH TINGGI, JOHAR BARU, JAKARTA PUSAT, DKI JAKARTA",106,101,111,212
https://kawalpemilu.org#25885,"TANAH TINGGI, JOHAR BARU, JAKARTA PUSAT, DKI JAKARTA",108,97,136,233
https://kawalpemilu.org#25885,"TANAH TINGGI, JOHAR BARU, JAKARTA PUSAT, DKI JAKARTA",109,123,120,243
https://kawalpemilu.org#25885,"TANAH TINGGI, JOHAR BARU, JAKARTA PUSAT, DKI JAKARTA",110,122,120,242
https://kawalpemilu.org#25885,"TANAH TINGGI, JOHAR BARU, JAKARTA PUSAT, DKI JAKARTA",111,91,145,236
https://kawalpemilu.org#25885,"TANAH TINGGI, JOHAR BARU, JAKARTA PUSAT, DKI JAKARTA",112,51,186,237
https://kawalpemilu.org#25885,"TANAH TINGGI, JOHAR BARU, JAKARTA PUSAT, DKI JAKARTA",113,85,148,233
https://kawalpemilu.org#25885,"TANAH TINGGI, JOHAR BARU, JAKARTA PUSAT, DKI JAKARTA",114,74,144,218
https://kawalpemilu.org#25885,"TANAH TINGGI, JOHAR BARU, JAKARTA PUSAT, DKI JAKARTA",115,97,124,221
https://kawalpemilu.org#25885,"TANAH TINGGI, JOHAR BARU, JAKARTA PUSAT, DKI JAKARTA",116,119,110,229
https://kawalpemilu.org#25885,"TANAH TINGGI, JOHAR BARU, JAKARTA PUSAT, DKI JAKARTA",117,100,87,187
https://kawalpemilu.org#25885,"TANAH TINGGI, JOHAR BARU, JAKARTA PUSAT, DKI JAKARTA",118,114,102,216
https://kawalpemilu.org#25885,"TANAH TINGGI, JOHAR BARU, JAKARTA PUSAT, DKI JAKARTA",119,110,77,187
https://kawalpemilu.org#25885,"TANAH TINGGI, JOHAR BARU, JAKARTA PUSAT, DKI JAKARTA",120,105,92,197
https://kawalpemilu.org#25888,"PENJARINGAN, PENJARINGAN, JAKARTA UTARA, DKI JAKARTA",1,34,146,180
https://kawalpemilu.org#25888,"PENJARINGAN, PENJARINGAN, JAKARTA UTARA, DKI JAKARTA",2,21,106,127
https://kawalpemilu.org#25888,"PENJARINGAN, PENJARINGAN, JAKARTA UTARA, DKI JAKARTA",3,18,172,190
https://kawalpemilu.org#25888,"PENJARINGAN, PENJARINGAN, JAKARTA UTARA, DKI JAKARTA",4,33,174,207
https://kawalpemilu.org#25888,"PENJARINGAN, PENJARINGAN, JAKARTA UTARA, DKI JAKARTA",5,24,147,171
https://kawalpemilu.org#25888,"PENJARINGAN, PENJARINGAN, JAKARTA UTARA, DKI JAKARTA",6,76,141,217
https://kawalpemilu.org#25888,"PENJARINGAN, PENJARINGAN, JAKARTA UTARA, DKI JAKARTA",7,33,125,158
https://kawalpemilu.org#25888,"PENJARINGAN, PENJARINGAN, JAKARTA UTARA, DKI JAKARTA",8,17,150,167
https://kawalpemilu.org#25888,"PENJARINGAN, PENJARINGAN, JAKARTA UTARA, DKI JAKARTA",9,126,68,194
https://kawalpemilu.org#25888,"PENJARINGAN, PENJARINGAN, JAKARTA UTARA, DKI JAKARTA",10,69,77,146
https://kawalpemilu.org#25888,"PENJARINGAN, PENJARINGAN, JAKARTA UTARA, DKI JAKARTA",11,36,209,245
https://kawalpemilu.org#25888,"PENJARINGAN, PENJARINGAN, JAKARTA UTARA, DKI JAKARTA",12,23,192,215
https://kawalpemilu.org#25888,"PENJARINGAN, PENJARINGAN, JAKARTA UTARA, DKI JAKARTA",13,65,141,206
https://kawalpemilu.org#25888,"PENJARINGAN, PENJARINGAN, JAKARTA UTARA, DKI JAKARTA",14,29,191,220
https://kawalpemilu.org#25888,"PENJARINGAN, PENJARINGAN, JAKARTA UTARA, DKI JAKARTA",15,37,141,178
https://kawalpemilu.org#25888,"PENJARINGAN, PENJARINGAN, JAKARTA UTARA, DKI JAKARTA",16,24,198,222
https://kawalpemilu.org#25888,"PENJARINGAN, PENJARINGAN, JAKARTA UTARA, DKI JAKARTA",17,50,158,208
https://kawalpemilu.org#25888,"PENJARINGAN, PENJARINGAN, JAKARTA UTARA, DKI JAKARTA",19,38,190,228
https://kawalpemilu.org#25888,"PENJARINGAN, PENJARINGAN, JAKARTA UTARA, DKI JAKARTA",20,71,149,220
https://kawalpemilu.org#25888,"PENJARINGAN, PENJARINGAN, JAKARTA UTARA, DKI JAKARTA",21,0,0,0
https://kawalpemilu.org#25888,"PENJARINGAN, PENJARINGAN, JAKARTA UTARA, DKI JAKARTA",22,29,165,194
https://kawalpemilu.org#25888,"PENJARINGAN, PENJARINGAN, JAKARTA UTARA, DKI JAKARTA",23,64,209,273
https://kawalpemilu.org#25888,"PENJARINGAN, PENJARINGAN, JAKARTA UTARA, DKI JAKARTA",24,34,247,281
https://kawalpemilu.org#25888,"PENJARINGAN, PENJARINGAN, JAKARTA UTARA, DKI JAKARTA",26,91,143,234
https://kawalpemilu.org#25888,"PENJARINGAN, PENJARINGAN, JAKARTA UTARA, DKI JAKARTA",27,67,168,235
https://kawalpemilu.org#25888,"PENJARINGAN, PENJARINGAN, JAKARTA UTARA, DKI JAKARTA",28,47,147,194
https://kawalpemilu.org#25888,"PENJARINGAN, PENJARINGAN, JAKARTA UTARA, DKI JAKARTA",29,38,171,209
https://kawalpemilu.org#25888,"PENJARINGAN, PENJARINGAN, JAKARTA UTARA, DKI JAKARTA",30,17,148,165
https://kawalpemilu.org#25888,"PENJARINGAN, PENJARINGAN, JAKARTA UTARA, DKI JAKARTA",31,101,71,172
https://kawalpemilu.org#25888,"PENJARINGAN, PENJARINGAN, JAKARTA UTARA, DKI JAKARTA",32,44,168,212
https://kawalpemilu.org#25888,"PENJARINGAN, PENJARINGAN, JAKARTA UTARA, DKI JAKARTA",34,118,79,197
https://kawalpemilu.org#25888,"PENJARINGAN, PENJARINGAN, JAKARTA UTARA, DKI JAKARTA",35,155,53,208
https://kawalpemilu.org#25888,"PENJARINGAN, PENJARINGAN, JAKARTA UTARA, DKI JAKARTA",36,0,0,0
https://kawalpemilu.org#25888,"PENJARINGAN, PENJARINGAN, JAKARTA UTARA, DKI JAKARTA",37,76,74,150
https://kawalpemilu.org#25888,"PENJARINGAN, PENJARINGAN, JAKARTA UTARA, DKI JAKARTA",38,126,50,176
https://kawalpemilu.org#25888,"PENJARINGAN, PENJARINGAN, JAKARTA UTARA, DKI JAKARTA",39,168,57,225
https://kawalpemilu.org#25888,"PENJARINGAN, PENJARINGAN, JAKARTA UTARA, DKI JAKARTA",40,32,163,195
https://kawalpemilu.org#25888,"PENJARINGAN, PENJARINGAN, JAKARTA UTARA, DKI JAKARTA",41,90,59,149
https://kawalpemilu.org#25888,"PENJARINGAN, PENJARINGAN, JAKARTA UTARA, DKI JAKARTA",42,128,64,192
https://kawalpemilu.org#25888,"PENJARINGAN, PENJARINGAN, JAKARTA UTARA, DKI JAKARTA",44,67,85,152
https://kawalpemilu.org#25888,"PENJARINGAN, PENJARINGAN, JAKARTA UTARA, DKI JAKARTA",45,81,81,162
https://kawalpemilu.org#25888,"PENJARINGAN, PENJARINGAN, JAKARTA UTARA, DKI JAKARTA",46,186,54,240
https://kawalpemilu.org#25888,"PENJARINGAN, PENJARINGAN, JAKARTA UTARA, DKI JAKARTA",47,166,80,246
https://kawalpemilu.org#25888,"PENJARINGAN, PENJARINGAN, JAKARTA UTARA, DKI JAKARTA",48,205,35,240
https://kawalpemilu.org#25888,"PENJARINGAN, PENJARINGAN, JAKARTA UTARA, DKI JAKARTA",50,115,127,242
https://kawalpemilu.org#25888,"PENJARINGAN, PENJARINGAN, JAKARTA UTARA, DKI JAKARTA",51,141,108,249
https://kawalpemilu.org#25888,"PENJARINGAN, PENJARINGAN, JAKARTA UTARA, DKI JAKARTA",52,141,103,244
https://kawalpemilu.org#25888,"PENJARINGAN, PENJARINGAN, JAKARTA UTARA, DKI JAKARTA",53,130,110,240
https://kawalpemilu.org#25888,"PENJARINGAN, PENJARINGAN, JAKARTA UTARA, DKI JAKARTA",54,113,100,213
https://kawalpemilu.org#25888,"PENJARINGAN, PENJARINGAN, JAKARTA UTARA, DKI JAKARTA",55,110,107,217
https://kawalpemilu.org#25888,"PENJARINGAN, PENJARINGAN, JAKARTA UTARA, DKI JAKARTA",57,131,86,217
https://kawalpemilu.org#25888,"PENJARINGAN, PENJARINGAN, JAKARTA UTARA, DKI JAKARTA",58,132,109,241
https://kawalpemilu.org#25888,"PENJARINGAN, PENJARINGAN, JAKARTA UTARA, DKI JAKARTA",59,196,42,238
https://kawalpemilu.org#25888,"PENJARINGAN, PENJARINGAN, JAKARTA UTARA, DKI JAKARTA",60,196,32,228
https://kawalpemilu.org#25888,"PENJARINGAN, PENJARINGAN, JAKARTA UTARA, DKI JAKARTA",61,183,67,250
https://kawalpemilu.org#25888,"PENJARINGAN, PENJARINGAN, JAKARTA UTARA, DKI JAKARTA",62,195,36,231
https://kawalpemilu.org#25888,"PENJARINGAN, PENJARINGAN, JAKARTA UTARA, DKI JAKARTA",63,180,27,207
https://kawalpemilu.org#25888,"PENJARINGAN, PENJARINGAN, JAKARTA UTARA, DKI JAKARTA",64,122,61,183
https://kawalpemilu.org#25888,"PENJARINGAN, PENJARINGAN, JAKARTA UTARA, DKI JAKARTA",66,153,94,247
https://kawalpemilu.org#25888,"PENJARINGAN, PENJARINGAN, JAKARTA UTARA, DKI JAKARTA",67,138,86,224
https://kawalpemilu.org#25888,"PENJARINGAN, PENJARINGAN, JAKARTA UTARA, DKI JAKARTA",68,92,88,180
https://kawalpemilu.org#25888,"PENJARINGAN, PENJARINGAN, JAKARTA UTARA, DKI JAKARTA",69,98,85,183
https://kawalpemilu.org#25888,"PENJARINGAN, PENJARINGAN, JAKARTA UTARA, DKI JAKARTA",70,87,92,179
https://kawalpemilu.org#25888,"PENJARINGAN, PENJARINGAN, JAKARTA UTARA, DKI JAKARTA",71,158,31,189
https://kawalpemilu.org#25888,"PENJARINGAN, PENJARINGAN, JAKARTA UTARA, DKI JAKARTA",72,155,73,228
https://kawalpemilu.org#25888,"PENJARINGAN, PENJARINGAN, JAKARTA UTARA, DKI JAKARTA",73,132,55,187
https://kawalpemilu.org#25888,"PENJARINGAN, PENJARINGAN, JAKARTA UTARA, DKI JAKARTA",74,144,102,246
https://kawalpemilu.org#25888,"PENJARINGAN, PENJARINGAN, JAKARTA UTARA, DKI JAKARTA",75,99,104,203
https://kawalpemilu.org#25888,"PENJARINGAN, PENJARINGAN, JAKARTA UTARA, DKI JAKARTA",76,214,42,256
https://kawalpemilu.org#25888,"PENJARINGAN, PENJARINGAN, JAKARTA UTARA, DKI JAKARTA",77,178,82,260
https://kawalpemilu.org#25888,"PENJARINGAN, PENJARINGAN, JAKARTA UTARA, DKI JAKARTA",78,110,76,186
https://kawalpemilu.org#25888,"PENJARINGAN, PENJARINGAN, JAKARTA UTARA, DKI JAKARTA",79,127,134,261
https://kawalpemilu.org#25888,"PENJARINGAN, PENJARINGAN, JAKARTA UTARA, DKI JAKARTA",80,99,70,169
https://kawalpemilu.org#25888,"PENJARINGAN, PENJARINGAN, JAKARTA UTARA, DKI JAKARTA",82,122,75,197
https://kawalpemilu.org#25888,"PENJARINGAN, PENJARINGAN, JAKARTA UTARA, DKI JAKARTA",83,144,77,221
https://kawalpemilu.org#25888,"PENJARINGAN, PENJARINGAN, JAKARTA UTARA, DKI JAKARTA",84,150,72,222
https://kawalpemilu.org#25888,"PENJARINGAN, PENJARINGAN, JAKARTA UTARA, DKI JAKARTA",85,151,94,245
https://kawalpemilu.org#25888,"PENJARINGAN, PENJARINGAN, JAKARTA UTARA, DKI JAKARTA",86,77,95,172
https://kawalpemilu.org#25888,"PENJARINGAN, PENJARINGAN, JAKARTA UTARA, DKI JAKARTA",87,69,106,175
https://kawalpemilu.org#25888,"PENJARINGAN, PENJARINGAN, JAKARTA UTARA, DKI JAKARTA",88,73,87,160
https://kawalpemilu.org#25888,"PENJARINGAN, PENJARINGAN, JAKARTA UTARA, DKI JAKARTA",89,106,75,181
https://kawalpemilu.org#25888,"PENJARINGAN, PENJARINGAN, JAKARTA UTARA, DKI JAKARTA",90,120,74,194
https://kawalpemilu.org#25888,"PENJARINGAN, PENJARINGAN, JAKARTA UTARA, DKI JAKARTA",91,116,62,178
https://kawalpemilu.org#25888,"PENJARINGAN, PENJARINGAN, JAKARTA UTARA, DKI JAKARTA",92,95,83,178
https://kawalpemilu.org#25888,"PENJARINGAN, PENJARINGAN, JAKARTA UTARA, DKI JAKARTA",93,89,63,152
https://kawalpemilu.org#25888,"PENJARINGAN, PENJARINGAN, JAKARTA UTARA, DKI JAKARTA",94,113,119,232
https://kawalpemilu.org#25888,"PENJARINGAN, PENJARINGAN, JAKARTA UTARA, DKI JAKARTA",95,82,66,148
https://kawalpemilu.org#25888,"PENJARINGAN, PENJARINGAN, JAKARTA UTARA, DKI JAKARTA",96,94,65,159
https://kawalpemilu.org#25888,"PENJARINGAN, PENJARINGAN, JAKARTA UTARA, DKI JAKARTA",97,88,142,230
https://kawalpemilu.org#25888,"PENJARINGAN, PENJARINGAN, JAKARTA UTARA, DKI JAKARTA",98,145,102,247
https://kawalpemilu.org#25888,"PENJARINGAN, PENJARINGAN, JAKARTA UTARA, DKI JAKARTA",99,103,80,183
https://kawalpemilu.org#25888,"PENJARINGAN, PENJARINGAN, JAKARTA UTARA, DKI JAKARTA",100,98,85,183
https://kawalpemilu.org#25888,"PENJARINGAN, PENJARINGAN, JAKARTA UTARA, DKI JAKARTA",101,71,68,139
https://kawalpemilu.org#25888,"PENJARINGAN, PENJARINGAN, JAKARTA UTARA, DKI JAKARTA",102,134,76,210
https://kawalpemilu.org#25888,"PENJARINGAN, PENJARINGAN, JAKARTA UTARA, DKI JAKARTA",103,77,75,152
https://kawalpemilu.org#25888,"PENJARINGAN, PENJARINGAN, JAKARTA UTARA, DKI JAKARTA",104,81,117,198
https://kawalpemilu.org#25888,"PENJARINGAN, PENJARINGAN, JAKARTA UTARA, DKI JAKARTA",105,117,85,202
https://kawalpemilu.org#25888,"PENJARINGAN, PENJARINGAN, JAKARTA UTARA, DKI JAKARTA",106,129,75,204
https://kawalpemilu.org#25888,"PENJARINGAN, PENJARINGAN, JAKARTA UTARA, DKI JAKARTA",107,227,19,246
https://kawalpemilu.org#25888,"PENJARINGAN, PENJARINGAN, JAKARTA UTARA, DKI JAKARTA",108,109,110,219
https://kawalpemilu.org#25888,"PENJARINGAN, PENJARINGAN, JAKARTA UTARA, DKI JAKARTA",109,117,127,244
https://kawalpemilu.org#25888,"PENJARINGAN, PENJARINGAN, JAKARTA UTARA, DKI JAKARTA",110,153,86,239
https://kawalpemilu.org#25888,"PENJARINGAN, PENJARINGAN, JAKARTA UTARA, DKI JAKARTA",111,155,89,244
https://kawalpemilu.org#25888,"PENJARINGAN, PENJARINGAN, JAKARTA UTARA, DKI JAKARTA",112,138,50,188
https://kawalpemilu.org#25888,"PENJARINGAN, PENJARINGAN, JAKARTA UTARA, DKI JAKARTA",113,163,45,208
https://kawalpemilu.org#25888,"PENJARINGAN, PENJARINGAN, JAKARTA UTARA, DKI JAKARTA",114,145,59,204
https://kawalpemilu.org#25888,"PENJARINGAN, PENJARINGAN, JAKARTA UTARA, DKI JAKARTA",115,215,7,222
https://kawalpemilu.org#25888,"PENJARINGAN, PENJARINGAN, JAKARTA UTARA, DKI JAKARTA",116,135,52,187
https://kawalpemilu.org#25888,"PENJARINGAN, PENJARINGAN, JAKARTA UTARA, DKI JAKARTA",117,127,82,209
https://kawalpemilu.org#25888,"PENJARINGAN, PENJARINGAN, JAKARTA UTARA, DKI JAKARTA",118,150,88,238
https://kawalpemilu.org#25888,"PENJARINGAN, PENJARINGAN, JAKARTA UTARA, DKI JAKARTA",119,129,46,175
https://kawalpemilu.org#25888,"PENJARINGAN, PENJARINGAN, JAKARTA UTARA, DKI JAKARTA",120,93,77,170
https://kawalpemilu.org#25888,"PENJARINGAN, PENJARINGAN, JAKARTA UTARA, DKI JAKARTA",121,101,59,160
https://kawalpemilu.org#25888,"PENJARINGAN, PENJARINGAN, JAKARTA UTARA, DKI JAKARTA",122,163,85,248
https://kawalpemilu.org#25888,"PENJARINGAN, PENJARINGAN, JAKARTA UTARA, DKI JAKARTA",123,150,47,197
https://kawalpemilu.org#25888,"PENJARINGAN, PENJARINGAN, JAKARTA UTARA, DKI JAKARTA",124,107,106,213
https://kawalpemilu.org#25888,"PENJARINGAN, PENJARINGAN, JAKARTA UTARA, DKI JAKARTA",125,142,59,201
https://kawalpemilu.org#25888,"PENJARINGAN, PENJARINGAN, JAKARTA UTARA, DKI JAKARTA",126,216,17,233
https://kawalpemilu.org#25888,"PENJARINGAN, PENJARINGAN, JAKARTA UTARA, DKI JAKARTA",127,131,80,211
https://kawalpemilu.org#25888,"PENJARINGAN, PENJARINGAN, JAKARTA UTARA, DKI JAKARTA",128,161,70,231
https://kawalpemilu.org#25888,"PENJARINGAN, PENJARINGAN, JAKARTA UTARA, DKI JAKARTA",129,135,87,222
https://kawalpemilu.org#25888,"PENJARINGAN, PENJARINGAN, JAKARTA UTARA, DKI JAKARTA",131,180,36,216
https://kawalpemilu.org#25888,"PENJARINGAN, PENJARINGAN, JAKARTA UTARA, DKI JAKARTA",132,160,64,224
https://kawalpemilu.org#25888,"PENJARINGAN, PENJARINGAN, JAKARTA UTARA, DKI JAKARTA",133,113,118,231
https://kawalpemilu.org#25888,"PENJARINGAN, PENJARINGAN, JAKARTA UTARA, DKI JAKARTA",134,102,137,239
https://kawalpemilu.org#25888,"PENJARINGAN, PENJARINGAN, JAKARTA UTARA, DKI JAKARTA",135,90,112,202
https://kawalpemilu.org#25888,"PENJARINGAN, PENJARINGAN, JAKARTA UTARA, DKI JAKARTA",136,156,71,227
https://kawalpemilu.org#25888,"PENJARINGAN, PENJARINGAN, JAKARTA UTARA, DKI JAKARTA",137,141,93,234
https://kawalpemilu.org#25888,"PENJARINGAN, PENJARINGAN, JAKARTA UTARA, DKI JAKARTA",139,114,95,209
https://kawalpemilu.org#25888,"PENJARINGAN, PENJARINGAN, JAKARTA UTARA, DKI JAKARTA",140,117,73,190
https://kawalpemilu.org#25888,"PENJARINGAN, PENJARINGAN, JAKARTA UTARA, DKI JAKARTA",141,120,103,223
https://kawalpemilu.org#25888,"PENJARINGAN, PENJARINGAN, JAKARTA UTARA, DKI JAKARTA",142,102,63,165
https://kawalpemilu.org#25888,"PENJARINGAN, PENJARINGAN, JAKARTA UTARA, DKI JAKARTA",143,120,83,203
https://kawalpemilu.org#25888,"PENJARINGAN, PENJARINGAN, JAKARTA UTARA, DKI JAKARTA",144,135,51,186
https://kawalpemilu.org#25888,"PENJARINGAN, PENJARINGAN, JAKARTA UTARA, DKI JAKARTA",146,114,80,194
https://kawalpemilu.org#25888,"PENJARINGAN, PENJARINGAN, JAKARTA UTARA, DKI JAKARTA",147,119,55,174
https://kawalpemilu.org#25888,"PENJARINGAN, PENJARINGAN, JAKARTA UTARA, DKI JAKARTA",148,130,65,195
https://kawalpemilu.org#25888,"PENJARINGAN, PENJARINGAN, JAKARTA UTARA, DKI JAKARTA",149,118,51,169
https://kawalpemilu.org#25888,"PENJARINGAN, PENJARINGAN, JAKARTA UTARA, DKI JAKARTA",150,153,64,217
https://kawalpemilu.org#25888,"PENJARINGAN, PENJARINGAN, JAKARTA UTARA, DKI JAKARTA",151,145,72,217
https://kawalpemilu.org#25888,"PENJARINGAN, PENJARINGAN, JAKARTA UTARA, DKI JAKARTA",152,140,53,193
https://kawalpemilu.org#25888,"PENJARINGAN, PENJARINGAN, JAKARTA UTARA, DKI JAKARTA",153,106,112,218
https://kawalpemilu.org#25888,"PENJARINGAN, PENJARINGAN, JAKARTA UTARA, DKI JAKARTA",155,158,51,209
https://kawalpemilu.org#25888,"PENJARINGAN, PENJARINGAN, JAKARTA UTARA, DKI JAKARTA",156,122,97,219
https://kawalpemilu.org#25888,"PENJARINGAN, PENJARINGAN, JAKARTA UTARA, DKI JAKARTA",157,111,80,191
https://kawalpemilu.org#25888,"PENJARINGAN, PENJARINGAN, JAKARTA UTARA, DKI JAKARTA",158,92,131,223
https://kawalpemilu.org#25888,"PENJARINGAN, PENJARINGAN, JAKARTA UTARA, DKI JAKARTA",159,82,98,180
https://kawalpemilu.org#25888,"PENJARINGAN, PENJARINGAN, JAKARTA UTARA, DKI JAKARTA",160,142,86,228
https://kawalpemilu.org#25888,"PENJARINGAN, PENJARINGAN, JAKARTA UTARA, DKI JAKARTA",161,133,86,219
https://kawalpemilu.org#25888,"PENJARINGAN, PENJARINGAN, JAKARTA UTARA, DKI JAKARTA",162,83,97,180
https://kawalpemilu.org#25888,"PENJARINGAN, PENJARINGAN, JAKARTA UTARA, DKI JAKARTA",163,80,92,172
https://kawalpemilu.org#25888,"PENJARINGAN, PENJARINGAN, JAKARTA UTARA, DKI JAKARTA",164,115,85,200
https://kawalpemilu.org#25888,"PENJARINGAN, PENJARINGAN, JAKARTA UTARA, DKI JAKARTA",165,150,68,218
https://kawalpemilu.org#25888,"PENJARINGAN, PENJARINGAN, JAKARTA UTARA, DKI JAKARTA",166,102,81,183
https://kawalpemilu.org#25888,"PENJARINGAN, PENJARINGAN, JAKARTA UTARA, DKI JAKARTA",167,67,51,118
https://kawalpemilu.org#25888,"PENJARINGAN, PENJARINGAN, JAKARTA UTARA, DKI JAKARTA",168,129,64,193
https://kawalpemilu.org#25888,"PENJARINGAN, PENJARINGAN, JAKARTA UTARA, DKI JAKARTA",169,137,83,220
https://kawalpemilu.org#25888,"PENJARINGAN, PENJARINGAN, JAKARTA UTARA, DKI JAKARTA",170,80,154,234
https://kawalpemilu.org#25888,"PENJARINGAN, PENJARINGAN, JAKARTA UTARA, DKI JAKARTA",171,124,125,249
https://kawalpemilu.org#25888,"PENJARINGAN, PENJARINGAN, JAKARTA UTARA, DKI JAKARTA",172,123,97,220
https://kawalpemilu.org#25888,"PENJARINGAN, PENJARINGAN, JAKARTA UTARA, DKI JAKARTA",173,145,90,235
https://kawalpemilu.org#25888,"PENJARINGAN, PENJARINGAN, JAKARTA UTARA, DKI JAKARTA",174,134,131,265
https://kawalpemilu.org#25888,"PENJARINGAN, PENJARINGAN, JAKARTA UTARA, DKI JAKARTA",175,143,97,240
https://kawalpemilu.org#25888,"PENJARINGAN, PENJARINGAN, JAKARTA UTARA, DKI JAKARTA",176,92,117,209
https://kawalpemilu.org#25888,"PENJARINGAN, PENJARINGAN, JAKARTA UTARA, DKI JAKARTA",177,114,103,217
https://kawalpemilu.org#25888,"PENJARINGAN, PENJARINGAN, JAKARTA UTARA, DKI JAKARTA",178,133,121,254
https://kawalpemilu.org#25888,"PENJARINGAN, PENJARINGAN, JAKARTA UTARA, DKI JAKARTA",179,113,136,249
https://kawalpemilu.org#25888,"PENJARINGAN, PENJARINGAN, JAKARTA UTARA, DKI JAKARTA",180,149,64,213
https://kawalpemilu.org#25888,"PENJARINGAN, PENJARINGAN, JAKARTA UTARA, DKI JAKARTA",181,107,105,212
https://kawalpemilu.org#25888,"PENJARINGAN, PENJARINGAN, JAKARTA UTARA, DKI JAKARTA",182,153,88,241
https://kawalpemilu.org#25888,"PENJARINGAN, PENJARINGAN, JAKARTA UTARA, DKI JAKARTA",183,121,84,205
https://kawalpemilu.org#25888,"PENJARINGAN, PENJARINGAN, JAKARTA UTARA, DKI JAKARTA",184,172,77,249
https://kawalpemilu.org#25888,"PENJARINGAN, PENJARINGAN, JAKARTA UTARA, DKI JAKARTA",185,121,99,220
https://kawalpemilu.org#25888,"PENJARINGAN, PENJARINGAN, JAKARTA UTARA, DKI JAKARTA",186,139,35,174
https://kawalpemilu.org#25888,"PENJARINGAN, PENJARINGAN, JAKARTA UTARA, DKI JAKARTA",187,114,101,215
https://kawalpemilu.org#25888,"PENJARINGAN, PENJARINGAN, JAKARTA UTARA, DKI JAKARTA",188,126,78,204
https://kawalpemilu.org#25888,"PENJARINGAN, PENJARINGAN, JAKARTA UTARA, DKI JAKARTA",189,158,28,186
https://kawalpemilu.org#25888,"PENJARINGAN, PENJARINGAN, JAKARTA UTARA, DKI JAKARTA",190,128,110,238
https://kawalpemilu.org#25888,"PENJARINGAN, PENJARINGAN, JAKARTA UTARA, DKI JAKARTA",191,113,58,171
https://kawalpemilu.org#25888,"PENJARINGAN, PENJARINGAN, JAKARTA UTARA, DKI JAKARTA",192,112,78,190
https://kawalpemilu.org#25888,"PENJARINGAN, PENJARINGAN, JAKARTA UTARA, DKI JAKARTA",193,108,121,229
https://kawalpemilu.org#25888,"PENJARINGAN, PENJARINGAN, JAKARTA UTARA, DKI JAKARTA",194,164,55,219
https://kawalpemilu.org#25888,"PENJARINGAN, PENJARINGAN, JAKARTA UTARA, DKI JAKARTA",195,175,51,226
https://kawalpemilu.org#25888,"PENJARINGAN, PENJARINGAN, JAKARTA UTARA, DKI JAKARTA",196,170,79,249
https://kawalpemilu.org#25888,"PENJARINGAN, PENJARINGAN, JAKARTA UTARA, DKI JAKARTA",197,153,102,255
https://kawalpemilu.org#25888,"PENJARINGAN, PENJARINGAN, JAKARTA UTARA, DKI JAKARTA",198,174,1,175
https://kawalpemilu.org#25888,"PENJARINGAN, PENJARINGAN, JAKARTA UTARA, DKI JAKARTA",199,170,14,184
https://kawalpemilu.org#25888,"PENJARINGAN, PENJARINGAN, JAKARTA UTARA, DKI JAKARTA",200,158,66,224
https://kawalpemilu.org#25888,"PENJARINGAN, PENJARINGAN, JAKARTA UTARA, DKI JAKARTA",201,132,63,195
https://kawalpemilu.org#25888,"PENJARINGAN, PENJARINGAN, JAKARTA UTARA, DKI JAKARTA",202,151,83,234
https://kawalpemilu.org#25888,"PENJARINGAN, PENJARINGAN, JAKARTA UTARA, DKI JAKARTA",203,123,79,202
https://kawalpemilu.org#25888,"PENJARINGAN, PENJARINGAN, JAKARTA UTARA, DKI JAKARTA",204,134,74,208
https://kawalpemilu.org#25888,"PENJARINGAN, PENJARINGAN, JAKARTA UTARA, DKI JAKARTA",205,116,54,170
https://kawalpemilu.org#25888,"PENJARINGAN, PENJARINGAN, JAKARTA UTARA, DKI JAKARTA",206,135,57,192
https://kawalpemilu.org#25888,"PENJARINGAN, PENJARINGAN, JAKARTA UTARA, DKI JAKARTA",207,122,79,201
https://kawalpemilu.org#25888,"PENJARINGAN, PENJARINGAN, JAKARTA UTARA, DKI JAKARTA",208,122,96,218
https://kawalpemilu.org#25888,"PENJARINGAN, PENJARINGAN, JAKARTA UTARA, DKI JAKARTA",209,97,105,202
https://kawalpemilu.org#25888,"PENJARINGAN, PENJARINGAN, JAKARTA UTARA, DKI JAKARTA",210,87,133,220
https://kawalpemilu.org#25888,"PENJARINGAN, PENJARINGAN, JAKARTA UTARA, DKI JAKARTA",211,69,87,156
https://kawalpemilu.org#25888,"PENJARINGAN, PENJARINGAN, JAKARTA UTARA, DKI JAKARTA",212,85,125,210
https://kawalpemilu.org#25888,"PENJARINGAN, PENJARINGAN, JAKARTA UTARA, DKI JAKARTA",213,91,105,196
https://kawalpemilu.org#25888,"PENJARINGAN, PENJARINGAN, JAKARTA UTARA, DKI JAKARTA",214,68,120,188
https://kawalpemilu.org#25888,"PENJARINGAN, PENJARINGAN, JAKARTA UTARA, DKI JAKARTA",215,80,85,165
https://kawalpemilu.org#25888,"PENJARINGAN, PENJARINGAN, JAKARTA UTARA, DKI JAKARTA",216,73,94,167
https://kawalpemilu.org#25888,"PENJARINGAN, PENJARINGAN, JAKARTA UTARA, DKI JAKARTA",217,62,82,144
https://kawalpemilu.org#25888,"PENJARINGAN, PENJARINGAN, JAKARTA UTARA, DKI JAKARTA",218,77,122,199
https://kawalpemilu.org#25888,"PENJARINGAN, PENJARINGAN, JAKARTA UTARA, DKI JAKARTA",219,95,126,223
https://kawalpemilu.org#25888,"PENJARINGAN, PENJARINGAN, JAKARTA UTARA, DKI JAKARTA",220,108,107,215
https://kawalpemilu.org#25888,"PENJARINGAN, PENJARINGAN, JAKARTA UTARA, DKI JAKARTA",221,61,155,216
https://kawalpemilu.org#25888,"PENJARINGAN, PENJARINGAN, JAKARTA UTARA, DKI JAKARTA",222,114,104,218
https://kawalpemilu.org#25888,"PENJARINGAN, PENJARINGAN, JAKARTA UTARA, DKI JAKARTA",223,57,175,232
https://kawalpemilu.org#25888,"PENJARINGAN, PENJARINGAN, JAKARTA UTARA, DKI JAKARTA",224,108,137,245
https://kawalpemilu.org#25888,"PENJARINGAN, PENJARINGAN, JAKARTA UTARA, DKI JAKARTA",225,109,128,237
https://kawalpemilu.org#25888,"PENJARINGAN, PENJARINGAN, JAKARTA UTARA, DKI JAKARTA",226,58,118,176
https://kawalpemilu.org#25888,"PENJARINGAN, PENJARINGAN, JAKARTA UTARA, DKI JAKARTA",227,73,142,215
https://kawalpemilu.org#25888,"PENJARINGAN, PENJARINGAN, JAKARTA UTARA, DKI JAKARTA",228,77,109,186
https://kawalpemilu.org#25888,"PENJARINGAN, PENJARINGAN, JAKARTA UTARA, DKI JAKARTA",229,108,153,261
https://kawalpemilu.org#25888,"PENJARINGAN, PENJARINGAN, JAKARTA UTARA, DKI JAKARTA",230,67,166,233
https://kawalpemilu.org#25888,"PENJARINGAN, PENJARINGAN, JAKARTA UTARA, DKI JAKARTA",231,113,99,212
https://kawalpemilu.org#25888,"PENJARINGAN, PENJARINGAN, JAKARTA UTARA, DKI JAKARTA",232,117,98,215
https://kawalpemilu.org#25888,"PENJARINGAN, PENJARINGAN, JAKARTA UTARA, DKI JAKARTA",233,96,90,186
https://kawalpemilu.org#25888,"PENJARINGAN, PENJARINGAN, JAKARTA UTARA, DKI JAKARTA",234,39,48,87
https://kawalpemilu.org#25888,"PENJARINGAN, PENJARINGAN, JAKARTA UTARA, DKI JAKARTA",235,77,114,191
https://kawalpemilu.org#25888,"PENJARINGAN, PENJARINGAN, JAKARTA UTARA, DKI JAKARTA",236,91,55,146
https://kawalpemilu.org#25888,"PENJARINGAN, PENJARINGAN, JAKARTA UTARA, DKI JAKARTA",237,75,123,198
https://kawalpemilu.org#25888,"PENJARINGAN, PENJARINGAN, JAKARTA UTARA, DKI JAKARTA",238,105,94,199
https://kawalpemilu.org#25888,"PENJARINGAN, PENJARINGAN, JAKARTA UTARA, DKI JAKARTA",239,89,135,224
https://kawalpemilu.org#25888,"PENJARINGAN, PENJARINGAN, JAKARTA UTARA, DKI JAKARTA",240,66,113,179
https://kawalpemilu.org#25888,"PENJARINGAN, PENJARINGAN, JAKARTA UTARA, DKI JAKARTA",241,98,133,231
https://kawalpemilu.org#25888,"PENJARINGAN, PENJARINGAN, JAKARTA UTARA, DKI JAKARTA",242,104,98,202
https://kawalpemilu.org#25888,"PENJARINGAN, PENJARINGAN, JAKARTA UTARA, DKI JAKARTA",243,85,101,186
https://kawalpemilu.org#25888,"PENJARINGAN, PENJARINGAN, JAKARTA UTARA, DKI JAKARTA",244,89,103,192
https://kawalpemilu.org#25888,"PENJARINGAN, PENJARINGAN, JAKARTA UTARA, DKI JAKARTA",245,57,73,130
https://kawalpemilu.org#25888,"PENJARINGAN, PENJARINGAN, JAKARTA UTARA, DKI JAKARTA",246,44,88,130
https://kawalpemilu.org#25888,"PENJARINGAN, PENJARINGAN, JAKARTA UTARA, DKI JAKARTA",247,10,13,23
https://kawalpemilu.org#25888,"PENJARINGAN, PENJARINGAN, JAKARTA UTARA, DKI JAKARTA",248,13,14,27
https://kawalpemilu.org#25888,"PENJARINGAN, PENJARINGAN, JAKARTA UTARA, DKI JAKARTA",249,44,77,121
https://kawalpemilu.org#25888,"PENJARINGAN, PENJARINGAN, JAKARTA UTARA, DKI JAKARTA",250,89,135,224
https://kawalpemilu.org#25888,"PENJARINGAN, PENJARINGAN, JAKARTA UTARA, DKI JAKARTA",251,72,90,162
https://kawalpemilu.org#25888,"PENJARINGAN, PENJARINGAN, JAKARTA UTARA, DKI JAKARTA",252,95,126,221
https://kawalpemilu.org#25888,"PENJARINGAN, PENJARINGAN, JAKARTA UTARA, DKI JAKARTA",253,92,95,187
https://kawalpemilu.org#25888,"PENJARINGAN, PENJARINGAN, JAKARTA UTARA, DKI JAKARTA",254,70,74,144
https://kawalpemilu.org#25888,"PENJARINGAN, PENJARINGAN, JAKARTA UTARA, DKI JAKARTA",255,75,93,168
https://kawalpemilu.org#25888,"PENJARINGAN, PENJARINGAN, JAKARTA UTARA, DKI JAKARTA",256,68,133,201
https://kawalpemilu.org#25888,"PENJARINGAN, PENJARINGAN, JAKARTA UTARA, DKI JAKARTA",257,72,91,163
https://kawalpemilu.org#25888,"PENJARINGAN, PENJARINGAN, JAKARTA UTARA, DKI JAKARTA",258,90,117,207
https://kawalpemilu.org#25888,"PENJARINGAN, PENJARINGAN, JAKARTA UTARA, DKI JAKARTA",260,65,45,110
https://kawalpemilu.org#25888,"PENJARINGAN, PENJARINGAN, JAKARTA UTARA, DKI JAKARTA",261,67,90,157
https://kawalpemilu.org#25888,"PENJARINGAN, PENJARINGAN, JAKARTA UTARA, DKI JAKARTA",262,98,105,203
https://kawalpemilu.org#25888,"PENJARINGAN, PENJARINGAN, JAKARTA UTARA, DKI JAKARTA",263,122,86,208
https://kawalpemilu.org#25888,"PENJARINGAN, PENJARINGAN, JAKARTA UTARA, DKI JAKARTA",264,103,100,203
https://kawalpemilu.org#25888,"PENJARINGAN, PENJARINGAN, JAKARTA UTARA, DKI JAKARTA",265,110,94,204
https://kawalpemilu.org#25888,"PENJARINGAN, PENJARINGAN, JAKARTA UTARA, DKI JAKARTA",266,94,132,226
https://kawalpemilu.org#25888,"PENJARINGAN, PENJARINGAN, JAKARTA UTARA, DKI JAKARTA",267,82,112,194
https://kawalpemilu.org#25888,"PENJARINGAN, PENJARINGAN, JAKARTA UTARA, DKI JAKARTA",268,94,128,222
https://kawalpemilu.org#25888,"PENJARINGAN, PENJARINGAN, JAKARTA UTARA, DKI JAKARTA",269,67,105,172
https://kawalpemilu.org#25888,"PENJARINGAN, PENJARINGAN, JAKARTA UTARA, DKI JAKARTA",270,72,90,162
https://kawalpemilu.org#25888,"PENJARINGAN, PENJARINGAN, JAKARTA UTARA, DKI JAKARTA",271,62,130,192
https://kawalpemilu.org#25888,"PENJARINGAN, PENJARINGAN, JAKARTA UTARA, DKI JAKARTA",272,19,41,60
https://kawalpemilu.org#25888,"PENJARINGAN, PENJARINGAN, JAKARTA UTARA, DKI JAKARTA",273,41,68,109
https://kawalpemilu.org#25888,"PENJARINGAN, PENJARINGAN, JAKARTA UTARA, DKI JAKARTA",274,67,105,172
https://kawalpemilu.org#25888,"PENJARINGAN, PENJARINGAN, JAKARTA UTARA, DKI JAKARTA",275,48,53,101
https://kawalpemilu.org#25888,"PENJARINGAN, PENJARINGAN, JAKARTA UTARA, DKI JAKARTA",276,87,113,200
https://kawalpemilu.org#25888,"PENJARINGAN, PENJARINGAN, JAKARTA UTARA, DKI JAKARTA",277,91,103,194
https://kawalpemilu.org#25888,"PENJARINGAN, PENJARINGAN, JAKARTA UTARA, DKI JAKARTA",278,84,98,182
https://kawalpemilu.org#25888,"PENJARINGAN, PENJARINGAN, JAKARTA UTARA, DKI JAKARTA",279,111,108,219
https://kawalpemilu.org#25888,"PENJARINGAN, PENJARINGAN, JAKARTA UTARA, DKI JAKARTA",280,84,136,220
https://kawalpemilu.org#25888,"PENJARINGAN, PENJARINGAN, JAKARTA UTARA, DKI JAKARTA",281,93,122,215
https://kawalpemilu.org#25888,"PENJARINGAN, PENJARINGAN, JAKARTA UTARA, DKI JAKARTA",282,38,70,108
https://kawalpemilu.org#25888,"PENJARINGAN, PENJARINGAN, JAKARTA UTARA, DKI JAKARTA",283,80,110,190
https://kawalpemilu.org#25888,"PENJARINGAN, PENJARINGAN, JAKARTA UTARA, DKI JAKARTA",284,75,97,172
https://kawalpemilu.org#25888,"PENJARINGAN, PENJARINGAN, JAKARTA UTARA, DKI JAKARTA",285,83,79,162
https://kawalpemilu.org#25888,"PENJARINGAN, PENJARINGAN, JAKARTA UTARA, DKI JAKARTA",286,91,116,207
https://kawalpemilu.org#25888,"PENJARINGAN, PENJARINGAN, JAKARTA UTARA, DKI JAKARTA",287,108,122,230
https://kawalpemilu.org#25888,"PENJARINGAN, PENJARINGAN, JAKARTA UTARA, DKI JAKARTA",288,83,74,157
https://kawalpemilu.org#25888,"PENJARINGAN, PENJARINGAN, JAKARTA UTARA, DKI JAKARTA",289,101,17,118
https://kawalpemilu.org#25888,"PENJARINGAN, PENJARINGAN, JAKARTA UTARA, DKI JAKARTA",290,111,74,185
https://kawalpemilu.org#25888,"PENJARINGAN, PENJARINGAN, JAKARTA UTARA, DKI JAKARTA",291,68,90,158
https://kawalpemilu.org#25888,"PENJARINGAN, PENJARINGAN, JAKARTA UTARA, DKI JAKARTA",292,42,67,109
https://kawalpemilu.org#25888,"PENJARINGAN, PENJARINGAN, JAKARTA UTARA, DKI JAKARTA",293,48,56,104
https://kawalpemilu.org#25888,"PENJARINGAN, PENJARINGAN, JAKARTA UTARA, DKI JAKARTA",294,97,45,142
https://kawalpemilu.org#25889,"KAMAL MUARA, PENJARINGAN, JAKARTA UTARA, DKI JAKARTA",1,53,181,234
https://kawalpemilu.org#25889,"KAMAL MUARA, PENJARINGAN, JAKARTA UTARA, DKI JAKARTA",2,59,146,205
https://kawalpemilu.org#25889,"KAMAL MUARA, PENJARINGAN, JAKARTA UTARA, DKI JAKARTA",3,77,147,224
https://kawalpemilu.org#25889,"KAMAL MUARA, PENJARINGAN, JAKARTA UTARA, DKI JAKARTA",4,62,125,187
https://kawalpemilu.org#25889,"KAMAL MUARA, PENJARINGAN, JAKARTA UTARA, DKI JAKARTA",5,84,175,259
https://kawalpemilu.org#25889,"KAMAL MUARA, PENJARINGAN, JAKARTA UTARA, DKI JAKARTA",6,55,160,215
https://kawalpemilu.org#25889,"KAMAL MUARA, PENJARINGAN, JAKARTA UTARA, DKI JAKARTA",7,56,133,189
https://kawalpemilu.org#25889,"KAMAL MUARA, PENJARINGAN, JAKARTA UTARA, DKI JAKARTA",8,51,114,165
https://kawalpemilu.org#25889,"KAMAL MUARA, PENJARINGAN, JAKARTA UTARA, DKI JAKARTA",9,67,116,183
https://kawalpemilu.org#25889,"KAMAL MUARA, PENJARINGAN, JAKARTA UTARA, DKI JAKARTA",10,75,118,193
https://kawalpemilu.org#25889,"KAMAL MUARA, PENJARINGAN, JAKARTA UTARA, DKI JAKARTA",11,96,183,279
https://kawalpemilu.org#25889,"KAMAL MUARA, PENJARINGAN, JAKARTA UTARA, DKI JAKARTA",12,103,152,255
https://kawalpemilu.org#25889,"KAMAL MUARA, PENJARINGAN, JAKARTA UTARA, DKI JAKARTA",13,113,145,258
https://kawalpemilu.org#25889,"KAMAL MUARA, PENJARINGAN, JAKARTA UTARA, DKI JAKARTA",14,90,112,202
https://kawalpemilu.org#25889,"KAMAL MUARA, PENJARINGAN, JAKARTA UTARA, DKI JAKARTA",15,71,153,224
https://kawalpemilu.org#25889,"KAMAL MUARA, PENJARINGAN, JAKARTA UTARA, DKI JAKARTA",16,91,96,187
https://kawalpemilu.org#25889,"KAMAL MUARA, PENJARINGAN, JAKARTA UTARA, DKI JAKARTA",17,105,145,250
https://kawalpemilu.org#25889,"KAMAL MUARA, PENJARINGAN, JAKARTA UTARA, DKI JAKARTA",18,118,106,224
https://kawalpemilu.org#25889,"KAMAL MUARA, PENJARINGAN, JAKARTA UTARA, DKI JAKARTA",19,134,88,222
https://kawalpemilu.org#25889,"KAMAL MUARA, PENJARINGAN, JAKARTA UTARA, DKI JAKARTA",20,159,72,231
https://kawalpemilu.org#25889,"KAMAL MUARA, PENJARINGAN, JAKARTA UTARA, DKI JAKARTA",21,171,57,228
https://kawalpemilu.org#25889,"KAMAL MUARA, PENJARINGAN, JAKARTA UTARA, DKI JAKARTA",22,78,78,156
https://kawalpemilu.org#25889,"KAMAL MUARA, PENJARINGAN, JAKARTA UTARA, DKI JAKARTA",23,103,104,207
https://kawalpemilu.org#25889,"KAMAL MUARA, PENJARINGAN, JAKARTA UTARA, DKI JAKARTA",24,117,86,203
https://kawalpemilu.org#25889,"KAMAL MUARA, PENJARINGAN, JAKARTA UTARA, DKI JAKARTA",25,76,86,162
https://kawalpemilu.org#25889,"KAMAL MUARA, PENJARINGAN, JAKARTA UTARA, DKI JAKARTA",26,137,33,170
https://kawalpemilu.org#25889,"KAMAL MUARA, PENJARINGAN, JAKARTA UTARA, DKI JAKARTA",27,109,38,147
https://kawalpemilu.org#25889,"KAMAL MUARA, PENJARINGAN, JAKARTA UTARA, DKI JAKARTA",28,116,62,178
https://kawalpemilu.org#25889,"KAMAL MUARA, PENJARINGAN, JAKARTA UTARA, DKI JAKARTA",29,175,8,183
https://kawalpemilu.org#25889,"KAMAL MUARA, PENJARINGAN, JAKARTA UTARA, DKI JAKARTA",30,163,3,166
https://kawalpemilu.org#25889,"KAMAL MUARA, PENJARINGAN, JAKARTA UTARA, DKI JAKARTA",31,206,3,209
https://kawalpemilu.org#25889,"KAMAL MUARA, PENJARINGAN, JAKARTA UTARA, DKI JAKARTA",32,224,4,228
https://kawalpemilu.org#25889,"KAMAL MUARA, PENJARINGAN, JAKARTA UTARA, DKI JAKARTA",33,193,6,199
https://kawalpemilu.org#25889,"KAMAL MUARA, PENJARINGAN, JAKARTA UTARA, DKI JAKARTA",34,173,10,183
https://kawalpemilu.org#25889,"KAMAL MUARA, PENJARINGAN, JAKARTA UTARA, DKI JAKARTA",35,181,7,188
https://kawalpemilu.org#25889,"KAMAL MUARA, PENJARINGAN, JAKARTA UTARA, DKI JAKARTA",36,196,3,199
https://kawalpemilu.org#25889,"KAMAL MUARA, PENJARINGAN, JAKARTA UTARA, DKI JAKARTA",37,239,8,247
https://kawalpemilu.org#25889,"KAMAL MUARA, PENJARINGAN, JAKARTA UTARA, DKI JAKARTA",38,253,7,260
https://kawalpemilu.org#25889,"KAMAL MUARA, PENJARINGAN, JAKARTA UTARA, DKI JAKARTA",39,207,6,213
https://kawalpemilu.org#25889,"KAMAL MUARA, PENJARINGAN, JAKARTA UTARA, DKI JAKARTA",40,231,9,240
https://kawalpemilu.org#25890,"KAPUK MUARA, PENJARINGAN, JAKARTA UTARA, DKI JAKARTA",1,65,137,202
https://kawalpemilu.org#25890,"KAPUK MUARA, PENJARINGAN, JAKARTA UTARA, DKI JAKARTA",2,77,110,187
https://kawalpemilu.org#25890,"KAPUK MUARA, PENJARINGAN, JAKARTA UTARA, DKI JAKARTA",3,70,116,186
https://kawalpemilu.org#25890,"KAPUK MUARA, PENJARINGAN, JAKARTA UTARA, DKI JAKARTA",4,58,150,208
https://kawalpemilu.org#25890,"KAPUK MUARA, PENJARINGAN, JAKARTA UTARA, DKI JAKARTA",5,72,120,192
https://kawalpemilu.org#25890,"KAPUK MUARA, PENJARINGAN, JAKARTA UTARA, DKI JAKARTA",6,88,117,205
https://kawalpemilu.org#25890,"KAPUK MUARA, PENJARINGAN, JAKARTA UTARA, DKI JAKARTA",8,96,130,226
https://kawalpemilu.org#25890,"KAPUK MUARA, PENJARINGAN, JAKARTA UTARA, DKI JAKARTA",9,119,109,228
https://kawalpemilu.org#25890,"KAPUK MUARA, PENJARINGAN, JAKARTA UTARA, DKI JAKARTA",10,108,102,210
https://kawalpemilu.org#25890,"KAPUK MUARA, PENJARINGAN, JAKARTA UTARA, DKI JAKARTA",11,98,103,201
https://kawalpemilu.org#25890,"KAPUK MUARA, PENJARINGAN, JAKARTA UTARA, DKI JAKARTA",12,81,81,162
https://kawalpemilu.org#25890,"KAPUK MUARA, PENJARINGAN, JAKARTA UTARA, DKI JAKARTA",13,81,72,153
https://kawalpemilu.org#25890,"KAPUK MUARA, PENJARINGAN, JAKARTA UTARA, DKI JAKARTA",14,120,23,143
https://kawalpemilu.org#25890,"KAPUK MUARA, PENJARINGAN, JAKARTA UTARA, DKI JAKARTA",15,158,34,192
https://kawalpemilu.org#25890,"KAPUK MUARA, PENJARINGAN, JAKARTA UTARA, DKI JAKARTA",16,139,35,174
https://kawalpemilu.org#25890,"KAPUK MUARA, PENJARINGAN, JAKARTA UTARA, DKI JAKARTA",17,163,60,223
https://kawalpemilu.org#25890,"KAPUK MUARA, PENJARINGAN, JAKARTA UTARA, DKI JAKARTA",18,120,86,206
https://kawalpemilu.org#25890,"KAPUK MUARA, PENJARINGAN, JAKARTA UTARA, DKI JAKARTA",19,214,30,244
https://kawalpemilu.org#25890,"KAPUK MUARA, PENJARINGAN, JAKARTA UTARA, DKI JAKARTA",20,212,21,233
https://kawalpemilu.org#25890,"KAPUK MUARA, PENJARINGAN, JAKARTA UTARA, DKI JAKARTA",21,164,18,182
https://kawalpemilu.org#25890,"KAPUK MUARA, PENJARINGAN, JAKARTA UTARA, DKI JAKARTA",22,201,7,208
https://kawalpemilu.org#25890,"KAPUK MUARA, PENJARINGAN, JAKARTA UTARA, DKI JAKARTA",23,205,10,215
https://kawalpemilu.org#25890,"KAPUK MUARA, PENJARINGAN, JAKARTA UTARA, DKI JAKARTA",24,199,9,208
https://kawalpemilu.org#25890,"KAPUK MUARA, PENJARINGAN, JAKARTA UTARA, DKI JAKARTA",25,152,9,161
https://kawalpemilu.org#25890,"KAPUK MUARA, PENJARINGAN, JAKARTA UTARA, DKI JAKARTA",26,157,6,163
https://kawalpemilu.org#25890,"KAPUK MUARA, PENJARINGAN, JAKARTA UTARA, DKI JAKARTA",27,131,69,200
https://kawalpemilu.org#25890,"KAPUK MUARA, PENJARINGAN, JAKARTA UTARA, DKI JAKARTA",28,125,50,175
https://kawalpemilu.org#25890,"KAPUK MUARA, PENJARINGAN, JAKARTA UTARA, DKI JAKARTA",29,112,43,155
https://kawalpemilu.org#25890,"KAPUK MUARA, PENJARINGAN, JAKARTA UTARA, DKI JAKARTA",30,106,48,154
https://kawalpemilu.org#25890,"KAPUK MUARA, PENJARINGAN, JAKARTA UTARA, DKI JAKARTA",31,140,50,190
https://kawalpemilu.org#25890,"KAPUK MUARA, PENJARINGAN, JAKARTA UTARA, DKI JAKARTA",32,145,60,205
https://kawalpemilu.org#25890,"KAPUK MUARA, PENJARINGAN, JAKARTA UTARA, DKI JAKARTA",33,132,54,186
https://kawalpemilu.org#25890,"KAPUK MUARA, PENJARINGAN, JAKARTA UTARA, DKI JAKARTA",34,219,9,228
https://kawalpemilu.org#25890,"KAPUK MUARA, PENJARINGAN, JAKARTA UTARA, DKI JAKARTA",35,178,4,182
https://kawalpemilu.org#25890,"KAPUK MUARA, PENJARINGAN, JAKARTA UTARA, DKI JAKARTA",36,202,9,211
https://kawalpemilu.org#25890,"KAPUK MUARA, PENJARINGAN, JAKARTA UTARA, DKI JAKARTA",37,224,7,231
https://kawalpemilu.org#25890,"KAPUK MUARA, PENJARINGAN, JAKARTA UTARA, DKI JAKARTA",38,215,5,220
https://kawalpemilu.org#25890,"KAPUK MUARA, PENJARINGAN, JAKARTA UTARA, DKI JAKARTA",39,199,15,214
https://kawalpemilu.org#25890,"KAPUK MUARA, PENJARINGAN, JAKARTA UTARA, DKI JAKARTA",40,235,12,247
https://kawalpemilu.org#25890,"KAPUK MUARA, PENJARINGAN, JAKARTA UTARA, DKI JAKARTA",41,100,116,216
https://kawalpemilu.org#25890,"KAPUK MUARA, PENJARINGAN, JAKARTA UTARA, DKI JAKARTA",42,86,97,183
https://kawalpemilu.org#25890,"KAPUK MUARA, PENJARINGAN, JAKARTA UTARA, DKI JAKARTA",43,146,94,240
https://kawalpemilu.org#25890,"KAPUK MUARA, PENJARINGAN, JAKARTA UTARA, DKI JAKARTA",44,144,73,217
https://kawalpemilu.org#25890,"KAPUK MUARA, PENJARINGAN, JAKARTA UTARA, DKI JAKARTA",45,169,54,223
https://kawalpemilu.org#25890,"KAPUK MUARA, PENJARINGAN, JAKARTA UTARA, DKI JAKARTA",46,115,95,210
https://kawalpemilu.org#25890,"KAPUK MUARA, PENJARINGAN, JAKARTA UTARA, DKI JAKARTA",47,78,133,211
https://kawalpemilu.org#25890,"KAPUK MUARA, PENJARINGAN, JAKARTA UTARA, DKI JAKARTA",48,86,101,187
https://kawalpemilu.org#25890,"KAPUK MUARA, PENJARINGAN, JAKARTA UTARA, DKI JAKARTA",49,151,27,178
https://kawalpemilu.org#25890,"KAPUK MUARA, PENJARINGAN, JAKARTA UTARA, DKI JAKARTA",50,102,90,192
https://kawalpemilu.org#25890,"KAPUK MUARA, PENJARINGAN, JAKARTA UTARA, DKI JAKARTA",51,117,87,204
https://kawalpemilu.org#25890,"KAPUK MUARA, PENJARINGAN, JAKARTA UTARA, DKI JAKARTA",52,113,45,158
https://kawalpemilu.org#25890,"KAPUK MUARA, PENJARINGAN, JAKARTA UTARA, DKI JAKARTA",53,125,76,201
https://kawalpemilu.org#25890,"KAPUK MUARA, PENJARINGAN, JAKARTA UTARA, DKI JAKARTA",54,97,55,152
https://kawalpemilu.org#25890,"KAPUK MUARA, PENJARINGAN, JAKARTA UTARA, DKI JAKARTA",55,136,71,207
https://kawalpemilu.org#25890,"KAPUK MUARA, PENJARINGAN, JAKARTA UTARA, DKI JAKARTA",56,113,121,234
https://kawalpemilu.org#25890,"KAPUK MUARA, PENJARINGAN, JAKARTA UTARA, DKI JAKARTA",57,104,63,167
https://kawalpemilu.org#25890,"KAPUK MUARA, PENJARINGAN, JAKARTA UTARA, DKI JAKARTA",58,151,72,223
https://kawalpemilu.org#25890,"KAPUK MUARA, PENJARINGAN, JAKARTA UTARA, DKI JAKARTA",59,97,105,202
https://kawalpemilu.org#25890,"KAPUK MUARA, PENJARINGAN, JAKARTA UTARA, DKI JAKARTA",60,137,100,237
https://kawalpemilu.org#25890,"KAPUK MUARA, PENJARINGAN, JAKARTA UTARA, DKI JAKARTA",61,119,86,205
https://kawalpemilu.org#25890,"KAPUK MUARA, PENJARINGAN, JAKARTA UTARA, DKI JAKARTA",63,130,82,212
https://kawalpemilu.org#25890,"KAPUK MUARA, PENJARINGAN, JAKARTA UTARA, DKI JAKARTA",64,149,102,251
https://kawalpemilu.org#25890,"KAPUK MUARA, PENJARINGAN, JAKARTA UTARA, DKI JAKARTA",65,59,128,187
https://kawalpemilu.org#25890,"KAPUK MUARA, PENJARINGAN, JAKARTA UTARA, DKI JAKARTA",66,201,8,209
https://kawalpemilu.org#25890,"KAPUK MUARA, PENJARINGAN, JAKARTA UTARA, DKI JAKARTA",67,207,3,210
https://kawalpemilu.org#25890,"KAPUK MUARA, PENJARINGAN, JAKARTA UTARA, DKI JAKARTA",68,225,5,230
https://kawalpemilu.org#25890,"KAPUK MUARA, PENJARINGAN, JAKARTA UTARA, DKI JAKARTA",69,174,2,176
https://kawalpemilu.org#25890,"KAPUK MUARA, PENJARINGAN, JAKARTA UTARA, DKI JAKARTA",70,169,3,172
https://kawalpemilu.org#25890,"KAPUK MUARA, PENJARINGAN, JAKARTA UTARA, DKI JAKARTA",71,212,5,217
https://kawalpemilu.org#25890,"KAPUK MUARA, PENJARINGAN, JAKARTA UTARA, DKI JAKARTA",72,180,17,197
https://kawalpemilu.org#25890,"KAPUK MUARA, PENJARINGAN, JAKARTA UTARA, DKI JAKARTA",73,168,7,175
https://kawalpemilu.org#25890,"KAPUK MUARA, PENJARINGAN, JAKARTA UTARA, DKI JAKARTA",74,212,7,219
https://kawalpemilu.org#25890,"KAPUK MUARA, PENJARINGAN, JAKARTA UTARA, DKI JAKARTA",75,198,6,204
https://kawalpemilu.org#25890,"KAPUK MUARA, PENJARINGAN, JAKARTA UTARA, DKI JAKARTA",76,198,3,201
https://kawalpemilu.org#25890,"KAPUK MUARA, PENJARINGAN, JAKARTA UTARA, DKI JAKARTA",77,217,7,224
https://kawalpemilu.org#25890,"KAPUK MUARA, PENJARINGAN, JAKARTA UTARA, DKI JAKARTA",78,204,3,207
https://kawalpemilu.org#25890,"KAPUK MUARA, PENJARINGAN, JAKARTA UTARA, DKI JAKARTA",79,222,6,228
https://kawalpemilu.org#25890,"KAPUK MUARA, PENJARINGAN, JAKARTA UTARA, DKI JAKARTA",80,224,6,230
https://kawalpemilu.org#25890,"KAPUK MUARA, PENJARINGAN, JAKARTA UTARA, DKI JAKARTA",81,242,7,249
https://kawalpemilu.org#25890,"KAPUK MUARA, PENJARINGAN, JAKARTA UTARA, DKI JAKARTA",82,180,6,185
https://kawalpemilu.org#25890,"KAPUK MUARA, PENJARINGAN, JAKARTA UTARA, DKI JAKARTA",83,225,5,230
https://kawalpemilu.org#25890,"KAPUK MUARA, PENJARINGAN, JAKARTA UTARA, DKI JAKARTA",84,207,7,214
https://kawalpemilu.org#25890,"KAPUK MUARA, PENJARINGAN, JAKARTA UTARA, DKI JAKARTA",85,223,8,231
https://kawalpemilu.org#25890,"KAPUK MUARA, PENJARINGAN, JAKARTA UTARA, DKI JAKARTA",86,206,17,223
https://kawalpemilu.org#25890,"KAPUK MUARA, PENJARINGAN, JAKARTA UTARA, DKI JAKARTA",87,211,13,224
https://kawalpemilu.org#25890,"KAPUK MUARA, PENJARINGAN, JAKARTA UTARA, DKI JAKARTA",88,222,16,238
https://kawalpemilu.org#25890,"KAPUK MUARA, PENJARINGAN, JAKARTA UTARA, DKI JAKARTA",89,190,7,197
https://kawalpemilu.org#25890,"KAPUK MUARA, PENJARINGAN, JAKARTA UTARA, DKI JAKARTA",90,179,18,197
https://kawalpemilu.org#25890,"KAPUK MUARA, PENJARINGAN, JAKARTA UTARA, DKI JAKARTA",91,199,12,211
https://kawalpemilu.org#25890,"KAPUK MUARA, PENJARINGAN, JAKARTA UTARA, DKI JAKARTA",92,173,8,181
https://kawalpemilu.org#25890,"KAPUK MUARA, PENJARINGAN, JAKARTA UTARA, DKI JAKARTA",93,212,7,219
https://kawalpemilu.org#25890,"KAPUK MUARA, PENJARINGAN, JAKARTA UTARA, DKI JAKARTA",94,211,4,215
https://kawalpemilu.org#25890,"KAPUK MUARA, PENJARINGAN, JAKARTA UTARA, DKI JAKARTA",95,226,6,232
https://kawalpemilu.org#25890,"KAPUK MUARA, PENJARINGAN, JAKARTA UTARA, DKI JAKARTA",96,216,12,228
https://kawalpemilu.org#25890,"KAPUK MUARA, PENJARINGAN, JAKARTA UTARA, DKI JAKARTA",97,185,12,197
https://kawalpemilu.org#25890,"KAPUK MUARA, PENJARINGAN, JAKARTA UTARA, DKI JAKARTA",98,207,15,222
https://kawalpemilu.org#25890,"KAPUK MUARA, PENJARINGAN, JAKARTA UTARA, DKI JAKARTA",99,207,15,222
https://kawalpemilu.org#25890,"KAPUK MUARA, PENJARINGAN, JAKARTA UTARA, DKI JAKARTA",100,149,47,196
https://kawalpemilu.org#25890,"KAPUK MUARA, PENJARINGAN, JAKARTA UTARA, DKI JAKARTA",101,145,68,213
https://kawalpemilu.org#25890,"KAPUK MUARA, PENJARINGAN, JAKARTA UTARA, DKI JAKARTA",102,171,60,231
https://kawalpemilu.org#25890,"KAPUK MUARA, PENJARINGAN, JAKARTA UTARA, DKI JAKARTA",103,174,58,232
https://kawalpemilu.org#25890,"KAPUK MUARA, PENJARINGAN, JAKARTA UTARA, DKI JAKARTA",104,152,60,212
https://kawalpemilu.org#25890,"KAPUK MUARA, PENJARINGAN, JAKARTA UTARA, DKI JAKARTA",105,162,47,209
https://kawalpemilu.org#25890,"KAPUK MUARA, PENJARINGAN, JAKARTA UTARA, DKI JAKARTA",106,174,33,207
https://kawalpemilu.org#25890,"KAPUK MUARA, PENJARINGAN, JAKARTA UTARA, DKI JAKARTA",107,230,1,231
https://kawalpemilu.org#25890,"KAPUK MUARA, PENJARINGAN, JAKARTA UTARA, DKI JAKARTA",108,238,4,242
https://kawalpemilu.org#25890,"KAPUK MUARA, PENJARINGAN, JAKARTA UTARA, DKI JAKARTA",109,166,5,171
https://kawalpemilu.org#25890,"KAPUK MUARA, PENJARINGAN, JAKARTA UTARA, DKI JAKARTA",110,179,3,182
https://kawalpemilu.org#25890,"KAPUK MUARA, PENJARINGAN, JAKARTA UTARA, DKI JAKARTA",111,182,0,182
https://kawalpemilu.org#25890,"KAPUK MUARA, PENJARINGAN, JAKARTA UTARA, DKI JAKARTA",112,199,2,201
https://kawalpemilu.org#25890,"KAPUK MUARA, PENJARINGAN, JAKARTA UTARA, DKI JAKARTA",113,97,68,165
https://kawalpemilu.org#25890,"KAPUK MUARA, PENJARINGAN, JAKARTA UTARA, DKI JAKARTA",114,93,116,209
https://kawalpemilu.org#25890,"KAPUK MUARA, PENJARINGAN, JAKARTA UTARA, DKI JAKARTA",115,126,81,207
https://kawalpemilu.org#25890,"KAPUK MUARA, PENJARINGAN, JAKARTA UTARA, DKI JAKARTA",116,183,6,189
https://kawalpemilu.org#25890,"KAPUK MUARA, PENJARINGAN, JAKARTA UTARA, DKI JAKARTA",117,191,8,199
https://kawalpemilu.org#25890,"KAPUK MUARA, PENJARINGAN, JAKARTA UTARA, DKI JAKARTA",118,151,9,160
https://kawalpemilu.org#25890,"KAPUK MUARA, PENJARINGAN, JAKARTA UTARA, DKI JAKARTA",119,146,24,170
https://kawalpemilu.org#25890,"KAPUK MUARA, PENJARINGAN, JAKARTA UTARA, DKI JAKARTA",120,100,61,161
https://kawalpemilu.org#25891,"PEJAGALAN, PENJARINGAN, JAKARTA UTARA, DKI JAKARTA",1,186,66,252
https://kawalpemilu.org#25891,"PEJAGALAN, PENJARINGAN, JAKARTA UTARA, DKI JAKARTA",2,170,52,222
https://kawalpemilu.org#25891,"PEJAGALAN, PENJARINGAN, JAKARTA UTARA, DKI JAKARTA",3,224,3,227
https://kawalpemilu.org#25891,"PEJAGALAN, PENJARINGAN, JAKARTA UTARA, DKI JAKARTA",4,136,94,230
https://kawalpemilu.org#25891,"PEJAGALAN, PENJARINGAN, JAKARTA UTARA, DKI JAKARTA",5,95,101,196
https://kawalpemilu.org#25891,"PEJAGALAN, PENJARINGAN, JAKARTA UTARA, DKI JAKARTA",6,141,82,223
https://kawalpemilu.org#25891,"PEJAGALAN, PENJARINGAN, JAKARTA UTARA, DKI JAKARTA",7,239,15,254
https://kawalpemilu.org#25891,"PEJAGALAN, PENJARINGAN, JAKARTA UTARA, DKI JAKARTA",8,185,49,234
https://kawalpemilu.org#25891,"PEJAGALAN, PENJARINGAN, JAKARTA UTARA, DKI JAKARTA",9,194,38,232
https://kawalpemilu.org#25891,"PEJAGALAN, PENJARINGAN, JAKARTA UTARA, DKI JAKARTA",10,213,3,216
https://kawalpemilu.org#25891,"PEJAGALAN, PENJARINGAN, JAKARTA UTARA, DKI JAKARTA",11,170,36,206
https://kawalpemilu.org#25891,"PEJAGALAN, PENJARINGAN, JAKARTA UTARA, DKI JAKARTA",12,222,4,226
https://kawalpemilu.org#25891,"PEJAGALAN, PENJARINGAN, JAKARTA UTARA, DKI JAKARTA",13,222,12,234
https://kawalpemilu.org#25891,"PEJAGALAN, PENJARINGAN, JAKARTA UTARA, DKI JAKARTA",14,221,11,232
https://kawalpemilu.org#25891,"PEJAGALAN, PENJARINGAN, JAKARTA UTARA, DKI JAKARTA",15,222,9,231
https://kawalpemilu.org#25891,"PEJAGALAN, PENJARINGAN, JAKARTA UTARA, DKI JAKARTA",16,243,14,257
https://kawalpemilu.org#25891,"PEJAGALAN, PENJARINGAN, JAKARTA UTARA, DKI JAKARTA",17,209,18,227
https://kawalpemilu.org#25891,"PEJAGALAN, PENJARINGAN, JAKARTA UTARA, DKI JAKARTA",18,228,9,237
https://kawalpemilu.org#25891,"PEJAGALAN, PENJARINGAN, JAKARTA UTARA, DKI JAKARTA",19,201,2,203
https://kawalpemilu.org#25891,"PEJAGALAN, PENJARINGAN, JAKARTA UTARA, DKI JAKARTA",20,239,4,243
https://kawalpemilu.org#25891,"PEJAGALAN, PENJARINGAN, JAKARTA UTARA, DKI JAKARTA",21,192,9,201
https://kawalpemilu.org#25891,"PEJAGALAN, PENJARINGAN, JAKARTA UTARA, DKI JAKARTA",22,211,14,225
https://kawalpemilu.org#25891,"PEJAGALAN, PENJARINGAN, JAKARTA UTARA, DKI JAKARTA",23,190,58,248
https://kawalpemilu.org#25891,"PEJAGALAN, PENJARINGAN, JAKARTA UTARA, DKI JAKARTA",24,168,63,231
https://kawalpemilu.org#25891,"PEJAGALAN, PENJARINGAN, JAKARTA UTARA, DKI JAKARTA",25,179,52,231
https://kawalpemilu.org#25891,"PEJAGALAN, PENJARINGAN, JAKARTA UTARA, DKI JAKARTA",27,179,42,221
https://kawalpemilu.org#25891,"PEJAGALAN, PENJARINGAN, JAKARTA UTARA, DKI JAKARTA",28,192,32,224
https://kawalpemilu.org#25891,"PEJAGALAN, PENJARINGAN, JAKARTA UTARA, DKI JAKARTA",29,149,57,206
https://kawalpemilu.org#25891,"PEJAGALAN, PENJARINGAN, JAKARTA UTARA, DKI JAKARTA",30,173,22,195
https://kawalpemilu.org#25891,"PEJAGALAN, PENJARINGAN, JAKARTA UTARA, DKI JAKARTA",31,167,47,214
https://kawalpemilu.org#25891,"PEJAGALAN, PENJARINGAN, JAKARTA UTARA, DKI JAKARTA",32,193,10,203
https://kawalpemilu.org#25891,"PEJAGALAN, PENJARINGAN, JAKARTA UTARA, DKI JAKARTA",33,225,11,236
https://kawalpemilu.org#25891,"PEJAGALAN, PENJARINGAN, JAKARTA UTARA, DKI JAKARTA",34,241,5,246
https://kawalpemilu.org#25891,"PEJAGALAN, PENJARINGAN, JAKARTA UTARA, DKI JAKARTA",35,252,4,256
https://kawalpemilu.org#25891,"PEJAGALAN, PENJARINGAN, JAKARTA UTARA, DKI JAKARTA",36,185,7,192
https://kawalpemilu.org#25891,"PEJAGALAN, PENJARINGAN, JAKARTA UTARA, DKI JAKARTA",37,237,18,255
https://kawalpemilu.org#25891,"PEJAGALAN, PENJARINGAN, JAKARTA UTARA, DKI JAKARTA",38,202,43,245
https://kawalpemilu.org#25891,"PEJAGALAN, PENJARINGAN, JAKARTA UTARA, DKI JAKARTA",39,217,36,253
https://kawalpemilu.org#25891,"PEJAGALAN, PENJARINGAN, JAKARTA UTARA, DKI JAKARTA",40,140,101,241
https://kawalpemilu.org#25891,"PEJAGALAN, PENJARINGAN, JAKARTA UTARA, DKI JAKARTA",41,57,16,73
https://kawalpemilu.org#25891,"PEJAGALAN, PENJARINGAN, JAKARTA UTARA, DKI JAKARTA",42,44,31,75
https://kawalpemilu.org#25891,"PEJAGALAN, PENJARINGAN, JAKARTA UTARA, DKI JAKARTA",43,92,45,137
https://kawalpemilu.org#25891,"PEJAGALAN, PENJARINGAN, JAKARTA UTARA, DKI JAKARTA",44,114,52,166
https://kawalpemilu.org#25891,"PEJAGALAN, PENJARINGAN, JAKARTA UTARA, DKI JAKARTA",45,229,4,233
https://kawalpemilu.org#25891,"PEJAGALAN, PENJARINGAN, JAKARTA UTARA, DKI JAKARTA",46,201,2,203
https://kawalpemilu.org#25891,"PEJAGALAN, PENJARINGAN, JAKARTA UTARA, DKI JAKARTA",47,236,11,247
https://kawalpemilu.org#25891,"PEJAGALAN, PENJARINGAN, JAKARTA UTARA, DKI JAKARTA",48,207,14,221
https://kawalpemilu.org#25891,"PEJAGALAN, PENJARINGAN, JAKARTA UTARA, DKI JAKARTA",49,223,6,229
https://kawalpemilu.org#25891,"PEJAGALAN, PENJARINGAN, JAKARTA UTARA, DKI JAKARTA",50,227,7,234
https://kawalpemilu.org#25891,"PEJAGALAN, PENJARINGAN, JAKARTA UTARA, DKI JAKARTA",51,263,5,268
https://kawalpemilu.org#25891,"PEJAGALAN, PENJARINGAN, JAKARTA UTARA, DKI JAKARTA",52,222,5,227
https://kawalpemilu.org#25891,"PEJAGALAN, PENJARINGAN, JAKARTA UTARA, DKI JAKARTA",53,211,18,229
https://kawalpemilu.org#25891,"PEJAGALAN, PENJARINGAN, JAKARTA UTARA, DKI JAKARTA",54,216,5,221
https://kawalpemilu.org#25891,"PEJAGALAN, PENJARINGAN, JAKARTA UTARA, DKI JAKARTA",55,236,6,242
https://kawalpemilu.org#25891,"PEJAGALAN, PENJARINGAN, JAKARTA UTARA, DKI JAKARTA",57,206,34,240
https://kawalpemilu.org#25891,"PEJAGALAN, PENJARINGAN, JAKARTA UTARA, DKI JAKARTA",58,197,35,232
https://kawalpemilu.org#25891,"PEJAGALAN, PENJARINGAN, JAKARTA UTARA, DKI JAKARTA",59,235,22,257
https://kawalpemilu.org#25891,"PEJAGALAN, PENJARINGAN, JAKARTA UTARA, DKI JAKARTA",60,217,6,223
https://kawalpemilu.org#25891,"PEJAGALAN, PENJARINGAN, JAKARTA UTARA, DKI JAKARTA",61,207,45,252
https://kawalpemilu.org#25891,"PEJAGALAN, PENJARINGAN, JAKARTA UTARA, DKI JAKARTA",62,189,14,203
https://kawalpemilu.org#25891,"PEJAGALAN, PENJARINGAN, JAKARTA UTARA, DKI JAKARTA",63,202,8,210
https://kawalpemilu.org#25891,"PEJAGALAN, PENJARINGAN, JAKARTA UTARA, DKI JAKARTA",64,216,9,225
https://kawalpemilu.org#25891,"PEJAGALAN, PENJARINGAN, JAKARTA UTARA, DKI JAKARTA",66,204,33,237
https://kawalpemilu.org#25891,"PEJAGALAN, PENJARINGAN, JAKARTA UTARA, DKI JAKARTA",67,223,37,260
https://kawalpemilu.org#25891,"PEJAGALAN, PENJARINGAN, JAKARTA UTARA, DKI JAKARTA",68,166,37,203
https://kawalpemilu.org#25891,"PEJAGALAN, PENJARINGAN, JAKARTA UTARA, DKI JAKARTA",69,110,47,157
https://kawalpemilu.org#25891,"PEJAGALAN, PENJARINGAN, JAKARTA UTARA, DKI JAKARTA",70,105,100,205
https://kawalpemilu.org#25891,"PEJAGALAN, PENJARINGAN, JAKARTA UTARA, DKI JAKARTA",71,129,84,213
https://kawalpemilu.org#25891,"PEJAGALAN, PENJARINGAN, JAKARTA UTARA, DKI JAKARTA",72,107,100,207
https://kawalpemilu.org#25891,"PEJAGALAN, PENJARINGAN, JAKARTA UTARA, DKI JAKARTA",73,153,58,211
https://kawalpemilu.org#25891,"PEJAGALAN, PENJARINGAN, JAKARTA UTARA, DKI JAKARTA",74,159,43,202
https://kawalpemilu.org#25891,"PEJAGALAN, PENJARINGAN, JAKARTA UTARA, DKI JAKARTA",75,142,68,210
https://kawalpemilu.org#25891,"PEJAGALAN, PENJARINGAN, JAKARTA UTARA, DKI JAKARTA",76,138,73,211
https://kawalpemilu.org#25891,"PEJAGALAN, PENJARINGAN, JAKARTA UTARA, DKI JAKARTA",77,178,10,188
https://kawalpemilu.org#25891,"PEJAGALAN, PENJARINGAN, JAKARTA UTARA, DKI JAKARTA",78,185,6,191
https://kawalpemilu.org#25891,"PEJAGALAN, PENJARINGAN, JAKARTA UTARA, DKI JAKARTA",79,93,116,209
https://kawalpemilu.org#25891,"PEJAGALAN, PENJARINGAN, JAKARTA UTARA, DKI JAKARTA",80,205,32,237
https://kawalpemilu.org#25891,"PEJAGALAN, PENJARINGAN, JAKARTA UTARA, DKI JAKARTA",81,181,24,205
https://kawalpemilu.org#25891,"PEJAGALAN, PENJARINGAN, JAKARTA UTARA, DKI JAKARTA",82,197,23,220
https://kawalpemilu.org#25891,"PEJAGALAN, PENJARINGAN, JAKARTA UTARA, DKI JAKARTA",83,154,56,210
https://kawalpemilu.org#25891,"PEJAGALAN, PENJARINGAN, JAKARTA UTARA, DKI JAKARTA",84,160,57,217
https://kawalpemilu.org#25891,"PEJAGALAN, PENJARINGAN, JAKARTA UTARA, DKI JAKARTA",85,161,86,247
https://kawalpemilu.org#25891,"PEJAGALAN, PENJARINGAN, JAKARTA UTARA, DKI JAKARTA",86,168,30,198
https://kawalpemilu.org#25891,"PEJAGALAN, PENJARINGAN, JAKARTA UTARA, DKI JAKARTA",87,191,23,214
https://kawalpemilu.org#25891,"PEJAGALAN, PENJARINGAN, JAKARTA UTARA, DKI JAKARTA",88,209,42,251
https://kawalpemilu.org#25891,"PEJAGALAN, PENJARINGAN, JAKARTA UTARA, DKI JAKARTA",89,191,51,242
https://kawalpemilu.org#25891,"PEJAGALAN, PENJARINGAN, JAKARTA UTARA, DKI JAKARTA",90,171,68,239
https://kawalpemilu.org#25891,"PEJAGALAN, PENJARINGAN, JAKARTA UTARA, DKI JAKARTA",91,166,32,198
https://kawalpemilu.org#25891,"PEJAGALAN, PENJARINGAN, JAKARTA UTARA, DKI JAKARTA",92,190,31,221
https://kawalpemilu.org#25891,"PEJAGALAN, PENJARINGAN, JAKARTA UTARA, DKI JAKARTA",93,178,17,195
https://kawalpemilu.org#25891,"PEJAGALAN, PENJARINGAN, JAKARTA UTARA, DKI JAKARTA",94,199,60,259
https://kawalpemilu.org#25891,"PEJAGALAN, PENJARINGAN, JAKARTA UTARA, DKI JAKARTA",95,150,53,203
https://kawalpemilu.org#25891,"PEJAGALAN, PENJARINGAN, JAKARTA UTARA, DKI JAKARTA",96,152,45,197
https://kawalpemilu.org#25891,"PEJAGALAN, PENJARINGAN, JAKARTA UTARA, DKI JAKARTA",97,128,101,229
https://kawalpemilu.org#25891,"PEJAGALAN, PENJARINGAN, JAKARTA UTARA, DKI JAKARTA",98,167,46,213
https://kawalpemilu.org#25891,"PEJAGALAN, PENJARINGAN, JAKARTA UTARA, DKI JAKARTA",100,214,51,265
https://kawalpemilu.org#25891,"PEJAGALAN, PENJARINGAN, JAKARTA UTARA, DKI JAKARTA",101,225,47,272
https://kawalpemilu.org#25891,"PEJAGALAN, PENJARINGAN, JAKARTA UTARA, DKI JAKARTA",102,187,27,214
https://kawalpemilu.org#25891,"PEJAGALAN, PENJARINGAN, JAKARTA UTARA, DKI JAKARTA",103,179,44,223
https://kawalpemilu.org#25891,"PEJAGALAN, PENJARINGAN, JAKARTA UTARA, DKI JAKARTA",104,147,45,192
https://kawalpemilu.org#25891,"PEJAGALAN, PENJARINGAN, JAKARTA UTARA, DKI JAKARTA",105,147,30,177
https://kawalpemilu.org#25891,"PEJAGALAN, PENJARINGAN, JAKARTA UTARA, DKI JAKARTA",106,118,36,154
https://kawalpemilu.org#25891,"PEJAGALAN, PENJARINGAN, JAKARTA UTARA, DKI JAKARTA",107,128,32,160
https://kawalpemilu.org#25891,"PEJAGALAN, PENJARINGAN, JAKARTA UTARA, DKI JAKARTA",108,135,49,184
https://kawalpemilu.org#25891,"PEJAGALAN, PENJARINGAN, JAKARTA UTARA, DKI JAKARTA",109,231,30,261
https://kawalpemilu.org#25891,"PEJAGALAN, PENJARINGAN, JAKARTA UTARA, DKI JAKARTA",110,198,30,228
https://kawalpemilu.org#25891,"PEJAGALAN, PENJARINGAN, JAKARTA UTARA, DKI JAKARTA",111,182,25,207
https://kawalpemilu.org#25891,"PEJAGALAN, PENJARINGAN, JAKARTA UTARA, DKI JAKARTA",112,193,23,216
https://kawalpemilu.org#25891,"PEJAGALAN, PENJARINGAN, JAKARTA UTARA, DKI JAKARTA",113,206,9,215
https://kawalpemilu.org#25891,"PEJAGALAN, PENJARINGAN, JAKARTA UTARA, DKI JAKARTA",114,229,8,237
https://kawalpemilu.org#25891,"PEJAGALAN, PENJARINGAN, JAKARTA UTARA, DKI JAKARTA",115,229,7,236
https://kawalpemilu.org#25891,"PEJAGALAN, PENJARINGAN, JAKARTA UTARA, DKI JAKARTA",116,237,19,256
https://kawalpemilu.org#25891,"PEJAGALAN, PENJARINGAN, JAKARTA UTARA, DKI JAKARTA",117,184,4,188
https://kawalpemilu.org#25891,"PEJAGALAN, PENJARINGAN, JAKARTA UTARA, DKI JAKARTA",118,222,26,248
https://kawalpemilu.org#25891,"PEJAGALAN, PENJARINGAN, JAKARTA UTARA, DKI JAKARTA",119,185,56,241
https://kawalpemilu.org#25891,"PEJAGALAN, PENJARINGAN, JAKARTA UTARA, DKI JAKARTA",120,225,21,246
https://kawalpemilu.org#25891,"PEJAGALAN, PENJARINGAN, JAKARTA UTARA, DKI JAKARTA",121,137,100,237
https://kawalpemilu.org#25891,"PEJAGALAN, PENJARINGAN, JAKARTA UTARA, DKI JAKARTA",122,235,6,241
https://kawalpemilu.org#25891,"PEJAGALAN, PENJARINGAN, JAKARTA UTARA, DKI JAKARTA",123,227,10,237
https://kawalpemilu.org#25891,"PEJAGALAN, PENJARINGAN, JAKARTA UTARA, DKI JAKARTA",124,196,29,225
https://kawalpemilu.org#25891,"PEJAGALAN, PENJARINGAN, JAKARTA UTARA, DKI JAKARTA",125,184,36,220
https://kawalpemilu.org#25891,"PEJAGALAN, PENJARINGAN, JAKARTA UTARA, DKI JAKARTA",126,194,15,209
https://kawalpemilu.org#25891,"PEJAGALAN, PENJARINGAN, JAKARTA UTARA, DKI JAKARTA",127,229,21,250
https://kawalpemilu.org#25891,"PEJAGALAN, PENJARINGAN, JAKARTA UTARA, DKI JAKARTA",128,225,2,227
https://kawalpemilu.org#25891,"PEJAGALAN, PENJARINGAN, JAKARTA UTARA, DKI JAKARTA",129,109,70,179
https://kawalpemilu.org#25891,"PEJAGALAN, PENJARINGAN, JAKARTA UTARA, DKI JAKARTA",130,162,24,186
https://kawalpemilu.org#25891,"PEJAGALAN, PENJARINGAN, JAKARTA UTARA, DKI JAKARTA",131,118,65,183
https://kawalpemilu.org#25891,"PEJAGALAN, PENJARINGAN, JAKARTA UTARA, DKI JAKARTA",132,152,70,222
https://kawalpemilu.org#25891,"PEJAGALAN, PENJARINGAN, JAKARTA UTARA, DKI JAKARTA",133,180,67,247
https://kawalpemilu.org#25891,"PEJAGALAN, PENJARINGAN, JAKARTA UTARA, DKI JAKARTA",135,201,36,237
https://kawalpemilu.org#25891,"PEJAGALAN, PENJARINGAN, JAKARTA UTARA, DKI JAKARTA",136,225,24,249
https://kawalpemilu.org#25891,"PEJAGALAN, PENJARINGAN, JAKARTA UTARA, DKI JAKARTA",137,184,34,218
https://kawalpemilu.org#25891,"PEJAGALAN, PENJARINGAN, JAKARTA UTARA, DKI JAKARTA",138,147,61,208
https://kawalpemilu.org#25891,"PEJAGALAN, PENJARINGAN, JAKARTA UTARA, DKI JAKARTA",139,151,34,185
https://kawalpemilu.org#25891,"PEJAGALAN, PENJARINGAN, JAKARTA UTARA, DKI JAKARTA",140,217,23,240
https://kawalpemilu.org#25891,"PEJAGALAN, PENJARINGAN, JAKARTA UTARA, DKI JAKARTA",141,195,48,243
https://kawalpemilu.org#25891,"PEJAGALAN, PENJARINGAN, JAKARTA UTARA, DKI JAKARTA",142,214,16,230
https://kawalpemilu.org#25891,"PEJAGALAN, PENJARINGAN, JAKARTA UTARA, DKI JAKARTA",143,237,17,254
https://kawalpemilu.org#25891,"PEJAGALAN, PENJARINGAN, JAKARTA UTARA, DKI JAKARTA",144,213,18,231
https://kawalpemilu.org#25891,"PEJAGALAN, PENJARINGAN, JAKARTA UTARA, DKI JAKARTA",145,194,32,226
https://kawalpemilu.org#25891,"PEJAGALAN, PENJARINGAN, JAKARTA UTARA, DKI JAKARTA",146,238,25,263
https://kawalpemilu.org#25891,"PEJAGALAN, PENJARINGAN, JAKARTA UTARA, DKI JAKARTA",148,205,36,241
https://kawalpemilu.org#25891,"PEJAGALAN, PENJARINGAN, JAKARTA UTARA, DKI JAKARTA",149,115,109,224
https://kawalpemilu.org#25891,"PEJAGALAN, PENJARINGAN, JAKARTA UTARA, DKI JAKARTA",150,100,111,211
https://kawalpemilu.org#25891,"PEJAGALAN, PENJARINGAN, JAKARTA UTARA, DKI JAKARTA",151,165,57,222
https://kawalpemilu.org#25891,"PEJAGALAN, PENJARINGAN, JAKARTA UTARA, DKI JAKARTA",152,186,57,243
https://kawalpemilu.org#25891,"PEJAGALAN, PENJARINGAN, JAKARTA UTARA, DKI JAKARTA",153,160,45,205
https://kawalpemilu.org#25891,"PEJAGALAN, PENJARINGAN, JAKARTA UTARA, DKI JAKARTA",154,205,65,270
https://kawalpemilu.org#25891,"PEJAGALAN, PENJARINGAN, JAKARTA UTARA, DKI JAKARTA",155,220,49,269
https://kawalpemilu.org#25891,"PEJAGALAN, PENJARINGAN, JAKARTA UTARA, DKI JAKARTA",156,169,40,209
https://kawalpemilu.org#25891,"PEJAGALAN, PENJARINGAN, JAKARTA UTARA, DKI JAKARTA",157,175,101,276
https://kawalpemilu.org#25891,"PEJAGALAN, PENJARINGAN, JAKARTA UTARA, DKI JAKARTA",159,174,79,236
https://kawalpemilu.org#25891,"PEJAGALAN, PENJARINGAN, JAKARTA UTARA, DKI JAKARTA",160,119,61,180
https://kawalpemilu.org#25891,"PEJAGALAN, PENJARINGAN, JAKARTA UTARA, DKI JAKARTA",161,108,98,206
https://kawalpemilu.org#25891,"PEJAGALAN, PENJARINGAN, JAKARTA UTARA, DKI JAKARTA",162,161,51,212
https://kawalpemilu.org#25891,"PEJAGALAN, PENJARINGAN, JAKARTA UTARA, DKI JAKARTA",163,102,101,203
https://kawalpemilu.org#25891,"PEJAGALAN, PENJARINGAN, JAKARTA UTARA, DKI JAKARTA",164,228,6,234
https://kawalpemilu.org#25891,"PEJAGALAN, PENJARINGAN, JAKARTA UTARA, DKI JAKARTA",165,174,1,175
https://kawalpemilu.org#25891,"PEJAGALAN, PENJARINGAN, JAKARTA UTARA, DKI JAKARTA",167,76,123,199
https://kawalpemilu.org#25891,"PEJAGALAN, PENJARINGAN, JAKARTA UTARA, DKI JAKARTA",168,106,138,244
https://kawalpemilu.org#25891,"PEJAGALAN, PENJARINGAN, JAKARTA UTARA, DKI JAKARTA",169,120,85,205
https://kawalpemilu.org#25891,"PEJAGALAN, PENJARINGAN, JAKARTA UTARA, DKI JAKARTA",170,131,96,227
https://kawalpemilu.org#25891,"PEJAGALAN, PENJARINGAN, JAKARTA UTARA, DKI JAKARTA",172,134,89,223
https://kawalpemilu.org#25891,"PEJAGALAN, PENJARINGAN, JAKARTA UTARA, DKI JAKARTA",173,135,93,228
https://kawalpemilu.org#25891,"PEJAGALAN, PENJARINGAN, JAKARTA UTARA, DKI JAKARTA",174,139,106,245
https://kawalpemilu.org#25891,"PEJAGALAN, PENJARINGAN, JAKARTA UTARA, DKI JAKARTA",175,111,120,231
https://kawalpemilu.org#25891,"PEJAGALAN, PENJARINGAN, JAKARTA UTARA, DKI JAKARTA",176,125,83,208
https://kawalpemilu.org#25891,"PEJAGALAN, PENJARINGAN, JAKARTA UTARA, DKI JAKARTA",177,226,2,228
https://kawalpemilu.org#25891,"PEJAGALAN, PENJARINGAN, JAKARTA UTARA, DKI JAKARTA",179,116,119,235
https://kawalpemilu.org#25891,"PEJAGALAN, PENJARINGAN, JAKARTA UTARA, DKI JAKARTA",180,116,113,229
https://kawalpemilu.org#25891,"PEJAGALAN, PENJARINGAN, JAKARTA UTARA, DKI JAKARTA",181,119,77,196
https://kawalpemilu.org#25891,"PEJAGALAN, PENJARINGAN, JAKARTA UTARA, DKI JAKARTA",182,90,180,270
https://kawalpemilu.org#25891,"PEJAGALAN, PENJARINGAN, JAKARTA UTARA, DKI JAKARTA",183,91,118,209
https://kawalpemilu.org#25891,"PEJAGALAN, PENJARINGAN, JAKARTA UTARA, DKI JAKARTA",184,94,128,222
https://kawalpemilu.org#25891,"PEJAGALAN, PENJARINGAN, JAKARTA UTARA, DKI JAKARTA",185,108,119,227
https://kawalpemilu.org#25891,"PEJAGALAN, PENJARINGAN, JAKARTA UTARA, DKI JAKARTA",186,104,97,201
https://kawalpemilu.org#25891,"PEJAGALAN, PENJARINGAN, JAKARTA UTARA, DKI JAKARTA",187,82,161,243
https://kawalpemilu.org#25891,"PEJAGALAN, PENJARINGAN, JAKARTA UTARA, DKI JAKARTA",188,118,115,233
https://kawalpemilu.org#25891,"PEJAGALAN, PENJARINGAN, JAKARTA UTARA, DKI JAKARTA",190,136,104,240
https://kawalpemilu.org#25891,"PEJAGALAN, PENJARINGAN, JAKARTA UTARA, DKI JAKARTA",191,146,85,231
https://kawalpemilu.org#25891,"PEJAGALAN, PENJARINGAN, JAKARTA UTARA, DKI JAKARTA",192,213,5,218
https://kawalpemilu.org#25891,"PEJAGALAN, PENJARINGAN, JAKARTA UTARA, DKI JAKARTA",193,242,5,247
https://kawalpemilu.org#25891,"PEJAGALAN, PENJARINGAN, JAKARTA UTARA, DKI JAKARTA",194,206,5,211
https://kawalpemilu.org#25891,"PEJAGALAN, PENJARINGAN, JAKARTA UTARA, DKI JAKARTA",195,219,10,229
https://kawalpemilu.org#25891,"PEJAGALAN, PENJARINGAN, JAKARTA UTARA, DKI JAKARTA",196,183,6,189
https://kawalpemilu.org#25891,"PEJAGALAN, PENJARINGAN, JAKARTA UTARA, DKI JAKARTA",197,136,80,216
https://kawalpemilu.org#25891,"PEJAGALAN, PENJARINGAN, JAKARTA UTARA, DKI JAKARTA",198,105,49,154
https://kawalpemilu.org#25891,"PEJAGALAN, PENJARINGAN, JAKARTA UTARA, DKI JAKARTA",199,105,84,189
https://kawalpemilu.org#25891,"PEJAGALAN, PENJARINGAN, JAKARTA UTARA, DKI JAKARTA",200,115,86,201
https://kawalpemilu.org#25891,"PEJAGALAN, PENJARINGAN, JAKARTA UTARA, DKI JAKARTA",201,112,75,187
https://kawalpemilu.org#25891,"PEJAGALAN, PENJARINGAN, JAKARTA UTARA, DKI JAKARTA",202,137,73,210
https://kawalpemilu.org#25891,"PEJAGALAN, PENJARINGAN, JAKARTA UTARA, DKI JAKARTA",203,241,4,245
https://kawalpemilu.org#25891,"PEJAGALAN, PENJARINGAN, JAKARTA UTARA, DKI JAKARTA",204,246,9,255
https://kawalpemilu.org#25891,"PEJAGALAN, PENJARINGAN, JAKARTA UTARA, DKI JAKARTA",205,225,8,233
https://kawalpemilu.org#25891,"PEJAGALAN, PENJARINGAN, JAKARTA UTARA, DKI JAKARTA",206,199,2,201
https://kawalpemilu.org#25891,"PEJAGALAN, PENJARINGAN, JAKARTA UTARA, DKI JAKARTA",207,212,3,215
https://kawalpemilu.org#25891,"PEJAGALAN, PENJARINGAN, JAKARTA UTARA, DKI JAKARTA",208,162,57,219
https://kawalpemilu.org#25891,"PEJAGALAN, PENJARINGAN, JAKARTA UTARA, DKI JAKARTA",209,177,58,235
https://kawalpemilu.org#25891,"PEJAGALAN, PENJARINGAN, JAKARTA UTARA, DKI JAKARTA",210,226,6,232
https://kawalpemilu.org#25891,"PEJAGALAN, PENJARINGAN, JAKARTA UTARA, DKI JAKARTA",211,237,10,247
https://kawalpemilu.org#25891,"PEJAGALAN, PENJARINGAN, JAKARTA UTARA, DKI JAKARTA",212,249,12,261
https://kawalpemilu.org#25891,"PEJAGALAN, PENJARINGAN, JAKARTA UTARA, DKI JAKARTA",213,209,6,215
https://kawalpemilu.org#25891,"PEJAGALAN, PENJARINGAN, JAKARTA UTARA, DKI JAKARTA",214,214,16,230
https://kawalpemilu.org#25891,"PEJAGALAN, PENJARINGAN, JAKARTA UTARA, DKI JAKARTA",215,217,5,222
https://kawalpemilu.org#25891,"PEJAGALAN, PENJARINGAN, JAKARTA UTARA, DKI JAKARTA",216,186,8,194
https://kawalpemilu.org#25891,"PEJAGALAN, PENJARINGAN, JAKARTA UTARA, DKI JAKARTA",217,180,4,184
https://kawalpemilu.org#25891,"PEJAGALAN, PENJARINGAN, JAKARTA UTARA, DKI JAKARTA",218,197,2,199
https://kawalpemilu.org#25891,"PEJAGALAN, PENJARINGAN, JAKARTA UTARA, DKI JAKARTA",219,226,7,233
https://kawalpemilu.org#25891,"PEJAGALAN, PENJARINGAN, JAKARTA UTARA, DKI JAKARTA",220,134,49,183
https://kawalpemilu.org#25891,"PEJAGALAN, PENJARINGAN, JAKARTA UTARA, DKI JAKARTA",221,128,64,192
https://kawalpemilu.org#25891,"PEJAGALAN, PENJARINGAN, JAKARTA UTARA, DKI JAKARTA",222,166,38,204
https://kawalpemilu.org#25891,"PEJAGALAN, PENJARINGAN, JAKARTA UTARA, DKI JAKARTA",223,126,61,187
https://kawalpemilu.org#25891,"PEJAGALAN, PENJARINGAN, JAKARTA UTARA, DKI JAKARTA",224,154,13,167
https://kawalpemilu.org#25891,"PEJAGALAN, PENJARINGAN, JAKARTA UTARA, DKI JAKARTA",225,137,36,173
https://kawalpemilu.org#25891,"PEJAGALAN, PENJARINGAN, JAKARTA UTARA, DKI JAKARTA",226,208,13,221
https://kawalpemilu.org#25891,"PEJAGALAN, PENJARINGAN, JAKARTA UTARA, DKI JAKARTA",227,138,56,194
https://kawalpemilu.org#25891,"PEJAGALAN, PENJARINGAN, JAKARTA UTARA, DKI JAKARTA",228,184,8,192
https://kawalpemilu.org#25891,"PEJAGALAN, PENJARINGAN, JAKARTA UTARA, DKI JAKARTA",229,117,89,206
https://kawalpemilu.org#25891,"PEJAGALAN, PENJARINGAN, JAKARTA UTARA, DKI JAKARTA",231,102,65,167
https://kawalpemilu.org#25891,"PEJAGALAN, PENJARINGAN, JAKARTA UTARA, DKI JAKARTA",232,157,11,168
https://kawalpemilu.org#25891,"PEJAGALAN, PENJARINGAN, JAKARTA UTARA, DKI JAKARTA",233,90,81,171
https://kawalpemilu.org#25892,"PLUIT, PENJARINGAN, JAKARTA UTARA, DKI JAKARTA",1,102,114,216
https://kawalpemilu.org#25892,"PLUIT, PENJARINGAN, JAKARTA UTARA, DKI JAKARTA",2,64,144,205
https://kawalpemilu.org#25892,"PLUIT, PENJARINGAN, JAKARTA UTARA, DKI JAKARTA",3,80,132,212
https://kawalpemilu.org#25892,"PLUIT, PENJARINGAN, JAKARTA UTARA, DKI JAKARTA",4,83,156,239
https://kawalpemilu.org#25892,"PLUIT, PENJARINGAN, JAKARTA UTARA, DKI JAKARTA",5,70,120,190
https://kawalpemilu.org#25892,"PLUIT, PENJARINGAN, JAKARTA UTARA, DKI JAKARTA",6,80,98,178
https://kawalpemilu.org#25892,"PLUIT, PENJARINGAN, JAKARTA UTARA, DKI JAKARTA",7,53,115,168
https://kawalpemilu.org#25892,"PLUIT, PENJARINGAN, JAKARTA UTARA, DKI JAKARTA",8,76,145,221
https://kawalpemilu.org#25892,"PLUIT, PENJARINGAN, JAKARTA UTARA, DKI JAKARTA",9,56,110,166
https://kawalpemilu.org#25892,"PLUIT, PENJARINGAN, JAKARTA UTARA, DKI JAKARTA",10,68,96,164
https://kawalpemilu.org#25892,"PLUIT, PENJARINGAN, JAKARTA UTARA, DKI JAKARTA",11,73,91,164
https://kawalpemilu.org#25892,"PLUIT, PENJARINGAN, JAKARTA UTARA, DKI JAKARTA",12,191,17,208
https://kawalpemilu.org#25892,"PLUIT, PENJARINGAN, JAKARTA UTARA, DKI JAKARTA",13,182,9,191
https://kawalpemilu.org#25892,"PLUIT, PENJARINGAN, JAKARTA UTARA, DKI JAKARTA",14,184,19,203
https://kawalpemilu.org#25892,"PLUIT, PENJARINGAN, JAKARTA UTARA, DKI JAKARTA",15,205,6,211
https://kawalpemilu.org#25892,"PLUIT, PENJARINGAN, JAKARTA UTARA, DKI JAKARTA",16,179,52,231
https://kawalpemilu.org#25892,"PLUIT, PENJARINGAN, JAKARTA UTARA, DKI JAKARTA",17,141,33,174
https://kawalpemilu.org#25892,"PLUIT, PENJARINGAN, JAKARTA UTARA, DKI JAKARTA",18,151,27,178
https://kawalpemilu.org#25892,"PLUIT, PENJARINGAN, JAKARTA UTARA, DKI JAKARTA",19,177,38,215
https://kawalpemilu.org#25892,"PLUIT, PENJARINGAN, JAKARTA UTARA, DKI JAKARTA",20,159,44,203
https://kawalpemilu.org#25892,"PLUIT, PENJARINGAN, JAKARTA UTARA, DKI JAKARTA",21,185,8,193
https://kawalpemilu.org#25892,"PLUIT, PENJARINGAN, JAKARTA UTARA, DKI JAKARTA",22,187,11,198
https://kawalpemilu.org#25892,"PLUIT, PENJARINGAN, JAKARTA UTARA, DKI JAKARTA",23,201,7,208
https://kawalpemilu.org#25892,"PLUIT, PENJARINGAN, JAKARTA UTARA, DKI JAKARTA",24,201,10,211
https://kawalpemilu.org#25892,"PLUIT, PENJARINGAN, JAKARTA UTARA, DKI JAKARTA",25,175,10,185
https://kawalpemilu.org#25892,"PLUIT, PENJARINGAN, JAKARTA UTARA, DKI JAKARTA",26,199,12,211
https://kawalpemilu.org#25892,"PLUIT, PENJARINGAN, JAKARTA UTARA, DKI JAKARTA",27,221,11,232
https://kawalpemilu.org#25892,"PLUIT, PENJARINGAN, JAKARTA UTARA, DKI JAKARTA",28,223,3,226
https://kawalpemilu.org#25892,"PLUIT, PENJARINGAN, JAKARTA UTARA, DKI JAKARTA",29,230,5,235
https://kawalpemilu.org#25892,"PLUIT, PENJARINGAN, JAKARTA UTARA, DKI JAKARTA",30,195,7,202
https://kawalpemilu.org#25892,"PLUIT, PENJARINGAN, JAKARTA UTARA, DKI JAKARTA",31,204,5,209
https://kawalpemilu.org#25892,"PLUIT, PENJARINGAN, JAKARTA UTARA, DKI JAKARTA",32,213,12,225
https://kawalpemilu.org#25892,"PLUIT, PENJARINGAN, JAKARTA UTARA, DKI JAKARTA",33,242,10,252
https://kawalpemilu.org#25892,"PLUIT, PENJARINGAN, JAKARTA UTARA, DKI JAKARTA",34,191,6,197
https://kawalpemilu.org#25892,"PLUIT, PENJARINGAN, JAKARTA UTARA, DKI JAKARTA",35,161,7,168
https://kawalpemilu.org#25892,"PLUIT, PENJARINGAN, JAKARTA UTARA, DKI JAKARTA",36,188,8,196
https://kawalpemilu.org#25892,"PLUIT, PENJARINGAN, JAKARTA UTARA, DKI JAKARTA",37,200,7,207
https://kawalpemilu.org#25892,"PLUIT, PENJARINGAN, JAKARTA UTARA, DKI JAKARTA",38,206,5,211
https://kawalpemilu.org#25892,"PLUIT, PENJARINGAN, JAKARTA UTARA, DKI JAKARTA",39,201,11,212
https://kawalpemilu.org#25892,"PLUIT, PENJARINGAN, JAKARTA UTARA, DKI JAKARTA",40,215,11,226
https://kawalpemilu.org#25892,"PLUIT, PENJARINGAN, JAKARTA UTARA, DKI JAKARTA",41,214,9,223
https://kawalpemilu.org#25892,"PLUIT, PENJARINGAN, JAKARTA UTARA, DKI JAKARTA",42,195,6,201
https://kawalpemilu.org#25892,"PLUIT, PENJARINGAN, JAKARTA UTARA, DKI JAKARTA",43,196,9,205
https://kawalpemilu.org#25892,"PLUIT, PENJARINGAN, JAKARTA UTARA, DKI JAKARTA",44,172,8,180
https://kawalpemilu.org#25892,"PLUIT, PENJARINGAN, JAKARTA UTARA, DKI JAKARTA",45,226,15,241
https://kawalpemilu.org#25892,"PLUIT, PENJARINGAN, JAKARTA UTARA, DKI JAKARTA",46,237,12,249
https://kawalpemilu.org#25892,"PLUIT, PENJARINGAN, JAKARTA UTARA, DKI JAKARTA",47,170,8,178
https://kawalpemilu.org#25892,"PLUIT, PENJARINGAN, JAKARTA UTARA, DKI JAKARTA",48,218,15,233
https://kawalpemilu.org#25892,"PLUIT, PENJARINGAN, JAKARTA UTARA, DKI JAKARTA",49,171,8,179
https://kawalpemilu.org#25892,"PLUIT, PENJARINGAN, JAKARTA UTARA, DKI JAKARTA",50,171,7,178
https://kawalpemilu.org#25892,"PLUIT, PENJARINGAN, JAKARTA UTARA, DKI JAKARTA",51,179,5,184
https://kawalpemilu.org#25892,"PLUIT, PENJARINGAN, JAKARTA UTARA, DKI JAKARTA",52,194,3,197
https://kawalpemilu.org#25892,"PLUIT, PENJARINGAN, JAKARTA UTARA, DKI JAKARTA",53,194,2,196
https://kawalpemilu.org#25892,"PLUIT, PENJARINGAN, JAKARTA UTARA, DKI JAKARTA",54,215,7,222
https://kawalpemilu.org#25892,"PLUIT, PENJARINGAN, JAKARTA UTARA, DKI JAKARTA",55,184,22,206
https://kawalpemilu.org#25892,"PLUIT, PENJARINGAN, JAKARTA UTARA, DKI JAKARTA",56,222,7,229
https://kawalpemilu.org#25892,"PLUIT, PENJARINGAN, JAKARTA UTARA, DKI JAKARTA",57,176,3,179
https://kawalpemilu.org#25892,"PLUIT, PENJARINGAN, JAKARTA UTARA, DKI JAKARTA",58,160,6,166
https://kawalpemilu.org#25892,"PLUIT, PENJARINGAN, JAKARTA UTARA, DKI JAKARTA",59,174,10,184
https://kawalpemilu.org#25892,"PLUIT, PENJARINGAN, JAKARTA UTARA, DKI JAKARTA",60,188,7,195
https://kawalpemilu.org#25892,"PLUIT, PENJARINGAN, JAKARTA UTARA, DKI JAKARTA",61,168,5,173
https://kawalpemilu.org#25892,"PLUIT, PENJARINGAN, JAKARTA UTARA, DKI JAKARTA",62,216,3,219
https://kawalpemilu.org#25892,"PLUIT, PENJARINGAN, JAKARTA UTARA, DKI JAKARTA",63,225,8,233
https://kawalpemilu.org#25892,"PLUIT, PENJARINGAN, JAKARTA UTARA, DKI JAKARTA",64,187,7,194
https://kawalpemilu.org#25892,"PLUIT, PENJARINGAN, JAKARTA UTARA, DKI JAKARTA",65,181,5,186
https://kawalpemilu.org#25892,"PLUIT, PENJARINGAN, JAKARTA UTARA, DKI JAKARTA",66,214,5,219
https://kawalpemilu.org#25892,"PLUIT, PENJARINGAN, JAKARTA UTARA, DKI JAKARTA",67,218,11,229
https://kawalpemilu.org#25892,"PLUIT, PENJARINGAN, JAKARTA UTARA, DKI JAKARTA",68,225,8,233
https://kawalpemilu.org#25892,"PLUIT, PENJARINGAN, JAKARTA UTARA, DKI JAKARTA",69,219,8,227
https://kawalpemilu.org#25892,"PLUIT, PENJARINGAN, JAKARTA UTARA, DKI JAKARTA",70,216,6,222
https://kawalpemilu.org#25892,"PLUIT, PENJARINGAN, JAKARTA UTARA, DKI JAKARTA",71,229,15,244
https://kawalpemilu.org#25892,"PLUIT, PENJARINGAN, JAKARTA UTARA, DKI JAKARTA",72,236,12,248
https://kawalpemilu.org#25892,"PLUIT, PENJARINGAN, JAKARTA UTARA, DKI JAKARTA",73,191,10,201
https://kawalpemilu.org#25892,"PLUIT, PENJARINGAN, JAKARTA UTARA, DKI JAKARTA",74,205,9,214
https://kawalpemilu.org#25892,"PLUIT, PENJARINGAN, JAKARTA UTARA, DKI JAKARTA",75,255,10,265
https://kawalpemilu.org#25892,"PLUIT, PENJARINGAN, JAKARTA UTARA, DKI JAKARTA",76,69,117,186
https://kawalpemilu.org#25892,"PLUIT, PENJARINGAN, JAKARTA UTARA, DKI JAKARTA",77,53,113,166
https://kawalpemilu.org#25892,"PLUIT, PENJARINGAN, JAKARTA UTARA, DKI JAKARTA",78,83,122,205
https://kawalpemilu.org#25892,"PLUIT, PENJARINGAN, JAKARTA UTARA, DKI JAKARTA",79,73,121,194
https://kawalpemilu.org#25892,"PLUIT, PENJARINGAN, JAKARTA UTARA, DKI JAKARTA",80,52,119,171
https://kawalpemilu.org#25892,"PLUIT, PENJARINGAN, JAKARTA UTARA, DKI JAKARTA",81,68,101,169
https://kawalpemilu.org#25892,"PLUIT, PENJARINGAN, JAKARTA UTARA, DKI JAKARTA",82,38,120,158
https://kawalpemilu.org#25892,"PLUIT, PENJARINGAN, JAKARTA UTARA, DKI JAKARTA",83,52,116,168
https://kawalpemilu.org#25892,"PLUIT, PENJARINGAN, JAKARTA UTARA, DKI JAKARTA",84,33,77,110
https://kawalpemilu.org#25892,"PLUIT, PENJARINGAN, JAKARTA UTARA, DKI JAKARTA",85,46,109,155
https://kawalpemilu.org#25892,"PLUIT, PENJARINGAN, JAKARTA UTARA, DKI JAKARTA",86,62,120,182
https://kawalpemilu.org#25892,"PLUIT, PENJARINGAN, JAKARTA UTARA, DKI JAKARTA",87,224,12,236
https://kawalpemilu.org#25892,"PLUIT, PENJARINGAN, JAKARTA UTARA, DKI JAKARTA",88,207,16,223
https://kawalpemilu.org#25892,"PLUIT, PENJARINGAN, JAKARTA UTARA, DKI JAKARTA",89,188,12,200
https://kawalpemilu.org#25892,"PLUIT, PENJARINGAN, JAKARTA UTARA, DKI JAKARTA",90,175,21,196
https://kawalpemilu.org#25892,"PLUIT, PENJARINGAN, JAKARTA UTARA, DKI JAKARTA",91,228,7,235
https://kawalpemilu.org#25892,"PLUIT, PENJARINGAN, JAKARTA UTARA, DKI JAKARTA",92,211,6,217
https://kawalpemilu.org#25892,"PLUIT, PENJARINGAN, JAKARTA UTARA, DKI JAKARTA",93,206,5,211
https://kawalpemilu.org#25892,"PLUIT, PENJARINGAN, JAKARTA UTARA, DKI JAKARTA",94,208,4,212
https://kawalpemilu.org#25892,"PLUIT, PENJARINGAN, JAKARTA UTARA, DKI JAKARTA",95,206,11,217
https://kawalpemilu.org#25892,"PLUIT, PENJARINGAN, JAKARTA UTARA, DKI JAKARTA",96,220,7,227
https://kawalpemilu.org#25892,"PLUIT, PENJARINGAN, JAKARTA UTARA, DKI JAKARTA",97,180,4,184
https://kawalpemilu.org#25892,"PLUIT, PENJARINGAN, JAKARTA UTARA, DKI JAKARTA",98,162,3,165
https://kawalpemilu.org#25892,"PLUIT, PENJARINGAN, JAKARTA UTARA, DKI JAKARTA",99,159,6,165
https://kawalpemilu.org#25892,"PLUIT, PENJARINGAN, JAKARTA UTARA, DKI JAKARTA",100,196,19,215
https://kawalpemilu.org#25892,"PLUIT, PENJARINGAN, JAKARTA UTARA, DKI JAKARTA",101,213,6,219
https://kawalpemilu.org#25892,"PLUIT, PENJARINGAN, JAKARTA UTARA, DKI JAKARTA",102,199,3,202
https://kawalpemilu.org#25892,"PLUIT, PENJARINGAN, JAKARTA UTARA, DKI JAKARTA",103,189,11,200
https://kawalpemilu.org#25892,"PLUIT, PENJARINGAN, JAKARTA UTARA, DKI JAKARTA",104,146,2,148
https://kawalpemilu.org#25892,"PLUIT, PENJARINGAN, JAKARTA UTARA, DKI JAKARTA",105,201,1,202
https://kawalpemilu.org#25892,"PLUIT, PENJARINGAN, JAKARTA UTARA, DKI JAKARTA",106,270,10,280
https://kawalpemilu.org#25892,"PLUIT, PENJARINGAN, JAKARTA UTARA, DKI JAKARTA",107,187,10,197
https://kawalpemilu.org#25892,"PLUIT, PENJARINGAN, JAKARTA UTARA, DKI JAKARTA",108,233,11,244
https://kawalpemilu.org#25892,"PLUIT, PENJARINGAN, JAKARTA UTARA, DKI JAKARTA",109,225,5,230
https://kawalpemilu.org#25892,"PLUIT, PENJARINGAN, JAKARTA UTARA, DKI JAKARTA",110,229,12,241
https://kawalpemilu.org#25892,"PLUIT, PENJARINGAN, JAKARTA UTARA, DKI JAKARTA",111,231,13,244
https://kawalpemilu.org#25892,"PLUIT, PENJARINGAN, JAKARTA UTARA, DKI JAKARTA",112,225,14,239
https://kawalpemilu.org#25892,"PLUIT, PENJARINGAN, JAKARTA UTARA, DKI JAKARTA",113,242,6,248
https://kawalpemilu.org#25892,"PLUIT, PENJARINGAN, JAKARTA UTARA, DKI JAKARTA",114,227,5,232
https://kawalpemilu.org#25892,"PLUIT, PENJARINGAN, JAKARTA UTARA, DKI JAKARTA",115,198,4,202
https://kawalpemilu.org#25892,"PLUIT, PENJARINGAN, JAKARTA UTARA, DKI JAKARTA",116,144,13,157
https://kawalpemilu.org#25892,"PLUIT, PENJARINGAN, JAKARTA UTARA, DKI JAKARTA",117,170,7,177
https://kawalpemilu.org#25892,"PLUIT, PENJARINGAN, JAKARTA UTARA, DKI JAKARTA",118,208,8,216
https://kawalpemilu.org#25892,"PLUIT, PENJARINGAN, JAKARTA UTARA, DKI JAKARTA",119,243,8,251
https://kawalpemilu.org#25892,"PLUIT, PENJARINGAN, JAKARTA UTARA, DKI JAKARTA",120,238,5,243
https://kawalpemilu.org#25892,"PLUIT, PENJARINGAN, JAKARTA UTARA, DKI JAKARTA",121,230,15,245
https://kawalpemilu.org#25892,"PLUIT, PENJARINGAN, JAKARTA UTARA, DKI JAKARTA",122,204,3,207
https://kawalpemilu.org#25892,"PLUIT, PENJARINGAN, JAKARTA UTARA, DKI JAKARTA",123,214,4,218
https://kawalpemilu.org#25892,"PLUIT, PENJARINGAN, JAKARTA UTARA, DKI JAKARTA",124,181,5,186
https://kawalpemilu.org#25892,"PLUIT, PENJARINGAN, JAKARTA UTARA, DKI JAKARTA",125,192,8,200
https://kawalpemilu.org#25892,"PLUIT, PENJARINGAN, JAKARTA UTARA, DKI JAKARTA",126,213,3,216
https://kawalpemilu.org#25892,"PLUIT, PENJARINGAN, JAKARTA UTARA, DKI JAKARTA",127,212,7,219
https://kawalpemilu.org#25892,"PLUIT, PENJARINGAN, JAKARTA UTARA, DKI JAKARTA",128,160,5,165
https://kawalpemilu.org#25892,"PLUIT, PENJARINGAN, JAKARTA UTARA, DKI JAKARTA",129,176,2,178
https://kawalpemilu.org#25892,"PLUIT, PENJARINGAN, JAKARTA UTARA, DKI JAKARTA",130,195,9,204
https://kawalpemilu.org#25892,"PLUIT, PENJARINGAN, JAKARTA UTARA, DKI JAKARTA",131,240,9,249
https://kawalpemilu.org#25892,"PLUIT, PENJARINGAN, JAKARTA UTARA, DKI JAKARTA",132,213,7,220
https://kawalpemilu.org#25892,"PLUIT, PENJARINGAN, JAKARTA UTARA, DKI JAKARTA",133,211,8,219
https://kawalpemilu.org#25892,"PLUIT, PENJARINGAN, JAKARTA UTARA, DKI JAKARTA",134,81,120,201
https://kawalpemilu.org#25892,"PLUIT, PENJARINGAN, JAKARTA UTARA, DKI JAKARTA",135,77,162,239
https://kawalpemilu.org#25892,"PLUIT, PENJARINGAN, JAKARTA UTARA, DKI JAKARTA",136,93,118,211
https://kawalpemilu.org#25892,"PLUIT, PENJARINGAN, JAKARTA UTARA, DKI JAKARTA",137,90,135,225
https://kawalpemilu.org#25892,"PLUIT, PENJARINGAN, JAKARTA UTARA, DKI JAKARTA",138,69,121,190
https://kawalpemilu.org#25892,"PLUIT, PENJARINGAN, JAKARTA UTARA, DKI JAKARTA",139,92,102,194
https://kawalpemilu.org#25892,"PLUIT, PENJARINGAN, JAKARTA UTARA, DKI JAKARTA",140,84,102,186
https://kawalpemilu.org#25892,"PLUIT, PENJARINGAN, JAKARTA UTARA, DKI JAKARTA",141,75,112,187
https://kawalpemilu.org#25892,"PLUIT, PENJARINGAN, JAKARTA UTARA, DKI JAKARTA",142,95,146,241
https://kawalpemilu.org#25892,"PLUIT, PENJARINGAN, JAKARTA UTARA, DKI JAKARTA",143,47,160,207
https://kawalpemilu.org#25892,"PLUIT, PENJARINGAN, JAKARTA UTARA, DKI JAKARTA",144,86,157,243
https://kawalpemilu.org#25892,"PLUIT, PENJARINGAN, JAKARTA UTARA, DKI JAKARTA",145,31,186,217
https://kawalpemilu.org#25892,"PLUIT, PENJARINGAN, JAKARTA UTARA, DKI JAKARTA",146,98,113,211
https://kawalpemilu.org#25892,"PLUIT, PENJARINGAN, JAKARTA UTARA, DKI JAKARTA",147,106,161,267
https://kawalpemilu.org#25892,"PLUIT, PENJARINGAN, JAKARTA UTARA, DKI JAKARTA",148,86,113,199
https://kawalpemilu.org#25892,"PLUIT, PENJARINGAN, JAKARTA UTARA, DKI JAKARTA",149,80,124,204
https://kawalpemilu.org#25892,"PLUIT, PENJARINGAN, JAKARTA UTARA, DKI JAKARTA",150,110,96,206
https://kawalpemilu.org#25892,"PLUIT, PENJARINGAN, JAKARTA UTARA, DKI JAKARTA",151,67,117,184
https://kawalpemilu.org#25892,"PLUIT, PENJARINGAN, JAKARTA UTARA, DKI JAKARTA",152,194,20,214
https://kawalpemilu.org#25892,"PLUIT, PENJARINGAN, JAKARTA UTARA, DKI JAKARTA",153,209,15,224
https://kawalpemilu.org#25892,"PLUIT, PENJARINGAN, JAKARTA UTARA, DKI JAKARTA",154,179,5,184
https://kawalpemilu.org#25892,"PLUIT, PENJARINGAN, JAKARTA UTARA, DKI JAKARTA",155,189,5,2
https://kawalpemilu.org#25892,"PLUIT, PENJARINGAN, JAKARTA UTARA, DKI JAKARTA",157,46,106,153
https://kawalpemilu.org#25892,"PLUIT, PENJARINGAN, JAKARTA UTARA, DKI JAKARTA",158,50,67,117
https://kawalpemilu.org#25892,"PLUIT, PENJARINGAN, JAKARTA UTARA, DKI JAKARTA",159,36,58,94
https://kawalpemilu.org#25892,"PLUIT, PENJARINGAN, JAKARTA UTARA, DKI JAKARTA",160,70,131,201
https://kawalpemilu.org#25892,"PLUIT, PENJARINGAN, JAKARTA UTARA, DKI JAKARTA",161,63,61,124
https://kawalpemilu.org#25892,"PLUIT, PENJARINGAN, JAKARTA UTARA, DKI JAKARTA",162,73,100,173
https://kawalpemilu.org#25892,"PLUIT, PENJARINGAN, JAKARTA UTARA, DKI JAKARTA",163,43,68,111
https://kawalpemilu.org#25894,"TANJUNG PRIOK, TANJUNG PRIOK, JAKARTA UTARA, DKI JAKARTA",1,127,90,217
https://kawalpemilu.org#25894,"TANJUNG PRIOK, TANJUNG PRIOK, JAKARTA UTARA, DKI JAKARTA",2,132,85,217
https://kawalpemilu.org#25894,"TANJUNG PRIOK, TANJUNG PRIOK, JAKARTA UTARA, DKI JAKARTA",3,127,101,228
https://kawalpemilu.org#25894,"TANJUNG PRIOK, TANJUNG PRIOK, JAKARTA UTARA, DKI JAKARTA",4,113,110,223
https://kawalpemilu.org#25894,"TANJUNG PRIOK, TANJUNG PRIOK, JAKARTA UTARA, DKI JAKARTA",5,105,126,231
https://kawalpemilu.org#25894,"TANJUNG PRIOK, TANJUNG PRIOK, JAKARTA UTARA, DKI JAKARTA",6,82,131,213
https://kawalpemilu.org#25894,"TANJUNG PRIOK, TANJUNG PRIOK, JAKARTA UTARA, DKI JAKARTA",7,74,128,202
https://kawalpemilu.org#25894,"TANJUNG PRIOK, TANJUNG PRIOK, JAKARTA UTARA, DKI JAKARTA",8,135,89,224
https://kawalpemilu.org#25894,"TANJUNG PRIOK, TANJUNG PRIOK, JAKARTA UTARA, DKI JAKARTA",9,101,103,204
https://kawalpemilu.org#25894,"TANJUNG PRIOK, TANJUNG PRIOK, JAKARTA UTARA, DKI JAKARTA",10,96,93,189
https://kawalpemilu.org#25894,"TANJUNG PRIOK, TANJUNG PRIOK, JAKARTA UTARA, DKI JAKARTA",11,96,96,192
https://kawalpemilu.org#25894,"TANJUNG PRIOK, TANJUNG PRIOK, JAKARTA UTARA, DKI JAKARTA",12,112,102,214
https://kawalpemilu.org#25894,"TANJUNG PRIOK, TANJUNG PRIOK, JAKARTA UTARA, DKI JAKARTA",13,128,95,223
https://kawalpemilu.org#25894,"TANJUNG PRIOK, TANJUNG PRIOK, JAKARTA UTARA, DKI JAKARTA",14,94,128,222
https://kawalpemilu.org#25894,"TANJUNG PRIOK, TANJUNG PRIOK, JAKARTA UTARA, DKI JAKARTA",15,129,99,228
https://kawalpemilu.org#25894,"TANJUNG PRIOK, TANJUNG PRIOK, JAKARTA UTARA, DKI JAKARTA",16,129,96,225
https://kawalpemilu.org#25894,"TANJUNG PRIOK, TANJUNG PRIOK, JAKARTA UTARA, DKI JAKARTA",17,105,126,231
https://kawalpemilu.org#25894,"TANJUNG PRIOK, TANJUNG PRIOK, JAKARTA UTARA, DKI JAKARTA",18,92,151,243
https://kawalpemilu.org#25894,"TANJUNG PRIOK, TANJUNG PRIOK, JAKARTA UTARA, DKI JAKARTA",19,126,101,227
https://kawalpemilu.org#25894,"TANJUNG PRIOK, TANJUNG PRIOK, JAKARTA UTARA, DKI JAKARTA",20,65,129,194
https://kawalpemilu.org#25894,"TANJUNG PRIOK, TANJUNG PRIOK, JAKARTA UTARA, DKI JAKARTA",21,140,72,212
https://kawalpemilu.org#25894,"TANJUNG PRIOK, TANJUNG PRIOK, JAKARTA UTARA, DKI JAKARTA",22,109,125,234
https://kawalpemilu.org#25894,"TANJUNG PRIOK, TANJUNG PRIOK, JAKARTA UTARA, DKI JAKARTA",23,146,85,231
https://kawalpemilu.org#25894,"TANJUNG PRIOK, TANJUNG PRIOK, JAKARTA UTARA, DKI JAKARTA",25,82,131,213
https://kawalpemilu.org#25894,"TANJUNG PRIOK, TANJUNG PRIOK, JAKARTA UTARA, DKI JAKARTA",26,102,117,219
https://kawalpemilu.org#25894,"TANJUNG PRIOK, TANJUNG PRIOK, JAKARTA UTARA, DKI JAKARTA",27,89,104,193
https://kawalpemilu.org#25894,"TANJUNG PRIOK, TANJUNG PRIOK, JAKARTA UTARA, DKI JAKARTA",28,82,138,220
https://kawalpemilu.org#25894,"TANJUNG PRIOK, TANJUNG PRIOK, JAKARTA UTARA, DKI JAKARTA",29,119,89,208
https://kawalpemilu.org#25894,"TANJUNG PRIOK, TANJUNG PRIOK, JAKARTA UTARA, DKI JAKARTA",30,99,125,224
https://kawalpemilu.org#25894,"TANJUNG PRIOK, TANJUNG PRIOK, JAKARTA UTARA, DKI JAKARTA",31,88,139,227
https://kawalpemilu.org#25894,"TANJUNG PRIOK, TANJUNG PRIOK, JAKARTA UTARA, DKI JAKARTA",32,139,103,242
https://kawalpemilu.org#25894,"TANJUNG PRIOK, TANJUNG PRIOK, JAKARTA UTARA, DKI JAKARTA",33,168,69,237
https://kawalpemilu.org#25894,"TANJUNG PRIOK, TANJUNG PRIOK, JAKARTA UTARA, DKI JAKARTA",34,123,94,217
https://kawalpemilu.org#25894,"TANJUNG PRIOK, TANJUNG PRIOK, JAKARTA UTARA, DKI JAKARTA",35,92,92,184
https://kawalpemilu.org#25894,"TANJUNG PRIOK, TANJUNG PRIOK, JAKARTA UTARA, DKI JAKARTA",36,110,104,214
https://kawalpemilu.org#25894,"TANJUNG PRIOK, TANJUNG PRIOK, JAKARTA UTARA, DKI JAKARTA",37,123,103,226
https://kawalpemilu.org#25894,"TANJUNG PRIOK, TANJUNG PRIOK, JAKARTA UTARA, DKI JAKARTA",38,93,126,219
https://kawalpemilu.org#25894,"TANJUNG PRIOK, TANJUNG PRIOK, JAKARTA UTARA, DKI JAKARTA",39,102,114,216
https://kawalpemilu.org#25894,"TANJUNG PRIOK, TANJUNG PRIOK, JAKARTA UTARA, DKI JAKARTA",41,100,115,215
https://kawalpemilu.org#25894,"TANJUNG PRIOK, TANJUNG PRIOK, JAKARTA UTARA, DKI JAKARTA",42,164,83,247
https://kawalpemilu.org#25894,"TANJUNG PRIOK, TANJUNG PRIOK, JAKARTA UTARA, DKI JAKARTA",43,152,84,236
https://kawalpemilu.org#25894,"TANJUNG PRIOK, TANJUNG PRIOK, JAKARTA UTARA, DKI JAKARTA",44,83,114,197
https://kawalpemilu.org#25894,"TANJUNG PRIOK, TANJUNG PRIOK, JAKARTA UTARA, DKI JAKARTA",45,84,85,169
https://kawalpemilu.org#25894,"TANJUNG PRIOK, TANJUNG PRIOK, JAKARTA UTARA, DKI JAKARTA",46,78,100,178
https://kawalpemilu.org#25894,"TANJUNG PRIOK, TANJUNG PRIOK, JAKARTA UTARA, DKI JAKARTA",47,95,105,200
https://kawalpemilu.org#25894,"TANJUNG PRIOK, TANJUNG PRIOK, JAKARTA UTARA, DKI JAKARTA",48,133,102,235
https://kawalpemilu.org#25894,"TANJUNG PRIOK, TANJUNG PRIOK, JAKARTA UTARA, DKI JAKARTA",49,116,85,201
https://kawalpemilu.org#25894,"TANJUNG PRIOK, TANJUNG PRIOK, JAKARTA UTARA, DKI JAKARTA",50,106,74,180
https://kawalpemilu.org#25894,"TANJUNG PRIOK, TANJUNG PRIOK, JAKARTA UTARA, DKI JAKARTA",52,91,121,212
https://kawalpemilu.org#25894,"TANJUNG PRIOK, TANJUNG PRIOK, JAKARTA UTARA, DKI JAKARTA",53,115,104,219
https://kawalpemilu.org#25894,"TANJUNG PRIOK, TANJUNG PRIOK, JAKARTA UTARA, DKI JAKARTA",54,125,108,233
https://kawalpemilu.org#25894,"TANJUNG PRIOK, TANJUNG PRIOK, JAKARTA UTARA, DKI JAKARTA",55,92,97,189
https://kawalpemilu.org#25894,"TANJUNG PRIOK, TANJUNG PRIOK, JAKARTA UTARA, DKI JAKARTA",56,99,98,197
https://kawalpemilu.org#25894,"TANJUNG PRIOK, TANJUNG PRIOK, JAKARTA UTARA, DKI JAKARTA",57,93,113,206
https://kawalpemilu.org#25894,"TANJUNG PRIOK, TANJUNG PRIOK, JAKARTA UTARA, DKI JAKARTA",58,79,145,224
https://kawalpemilu.org#25894,"TANJUNG PRIOK, TANJUNG PRIOK, JAKARTA UTARA, DKI JAKARTA",59,74,123,197
https://kawalpemilu.org#25894,"TANJUNG PRIOK, TANJUNG PRIOK, JAKARTA UTARA, DKI JAKARTA",60,107,116,223
https://kawalpemilu.org#25894,"TANJUNG PRIOK, TANJUNG PRIOK, JAKARTA UTARA, DKI JAKARTA",61,115,98,213
https://kawalpemilu.org#25894,"TANJUNG PRIOK, TANJUNG PRIOK, JAKARTA UTARA, DKI JAKARTA",62,91,137,228
https://kawalpemilu.org#25894,"TANJUNG PRIOK, TANJUNG PRIOK, JAKARTA UTARA, DKI JAKARTA",63,83,73,156
https://kawalpemilu.org#25894,"TANJUNG PRIOK, TANJUNG PRIOK, JAKARTA UTARA, DKI JAKARTA",64,101,80,181
https://kawalpemilu.org#25894,"TANJUNG PRIOK, TANJUNG PRIOK, JAKARTA UTARA, DKI JAKARTA",65,101,82,183
https://kawalpemilu.org#25894,"TANJUNG PRIOK, TANJUNG PRIOK, JAKARTA UTARA, DKI JAKARTA",66,72,115,187
https://kawalpemilu.org#25894,"TANJUNG PRIOK, TANJUNG PRIOK, JAKARTA UTARA, DKI JAKARTA",67,100,96,196
https://kawalpemilu.org#25894,"TANJUNG PRIOK, TANJUNG PRIOK, JAKARTA UTARA, DKI JAKARTA",68,52,113,165
https://kawalpemilu.org#25894,"TANJUNG PRIOK, TANJUNG PRIOK, JAKARTA UTARA, DKI JAKARTA",69,74,109,183
https://kawalpemilu.org#25894,"TANJUNG PRIOK, TANJUNG PRIOK, JAKARTA UTARA, DKI JAKARTA",70,106,113,219
https://kawalpemilu.org#25894,"TANJUNG PRIOK, TANJUNG PRIOK, JAKARTA UTARA, DKI JAKARTA",71,105,104,209
https://kawalpemilu.org#25894,"TANJUNG PRIOK, TANJUNG PRIOK, JAKARTA UTARA, DKI JAKARTA",72,80,105,185
https://kawalpemilu.org#25894,"TANJUNG PRIOK, TANJUNG PRIOK, JAKARTA UTARA, DKI JAKARTA",73,112,89,201
https://kawalpemilu.org#25894,"TANJUNG PRIOK, TANJUNG PRIOK, JAKARTA UTARA, DKI JAKARTA",74,111,88,199
https://kawalpemilu.org#25894,"TANJUNG PRIOK, TANJUNG PRIOK, JAKARTA UTARA, DKI JAKARTA",75,92,125,217
https://kawalpemilu.org#25894,"TANJUNG PRIOK, TANJUNG PRIOK, JAKARTA UTARA, DKI JAKARTA",76,80,111,191
https://kawalpemilu.org#25894,"TANJUNG PRIOK, TANJUNG PRIOK, JAKARTA UTARA, DKI JAKARTA",77,97,97,194
https://kawalpemilu.org#25894,"TANJUNG PRIOK, TANJUNG PRIOK, JAKARTA UTARA, DKI JAKARTA",78,95,118,213
https://kawalpemilu.org#25894,"TANJUNG PRIOK, TANJUNG PRIOK, JAKARTA UTARA, DKI JAKARTA",79,97,105,202
https://kawalpemilu.org#25894,"TANJUNG PRIOK, TANJUNG PRIOK, JAKARTA UTARA, DKI JAKARTA",80,105,106,211
https://kawalpemilu.org#25894,"TANJUNG PRIOK, TANJUNG PRIOK, JAKARTA UTARA, DKI JAKARTA",82,72,141,213
https://kawalpemilu.org#25894,"TANJUNG PRIOK, TANJUNG PRIOK, JAKARTA UTARA, DKI JAKARTA",83,135,86,29
https://kawalpemilu.org#25894,"TANJUNG PRIOK, TANJUNG PRIOK, JAKARTA UTARA, DKI JAKARTA",84,105,89,194
https://kawalpemilu.org#25894,"TANJUNG PRIOK, TANJUNG PRIOK, JAKARTA UTARA, DKI JAKARTA",85,92,102,194
https://kawalpemilu.org#25894,"TANJUNG PRIOK, TANJUNG PRIOK, JAKARTA UTARA, DKI JAKARTA",86,119,84,203
https://kawalpemilu.org#25894,"TANJUNG PRIOK, TANJUNG PRIOK, JAKARTA UTARA, DKI JAKARTA",87,163,69,232
https://kawalpemilu.org#25894,"TANJUNG PRIOK, TANJUNG PRIOK, JAKARTA UTARA, DKI JAKARTA",88,125,77,202
https://kawalpemilu.org#25894,"TANJUNG PRIOK, TANJUNG PRIOK, JAKARTA UTARA, DKI JAKARTA",89,120,82,202
https://kawalpemilu.org#25894,"TANJUNG PRIOK, TANJUNG PRIOK, JAKARTA UTARA, DKI JAKARTA",90,148,76,224
https://kawalpemilu.org#25894,"TANJUNG PRIOK, TANJUNG PRIOK, JAKARTA UTARA, DKI JAKARTA",92,159,62,221
https://kawalpemilu.org#25894,"TANJUNG PRIOK, TANJUNG PRIOK, JAKARTA UTARA, DKI JAKARTA",93,155,53,208
https://kawalpemilu.org#25894,"TANJUNG PRIOK, TANJUNG PRIOK, JAKARTA UTARA, DKI JAKARTA",94,133,78,211
https://kawalpemilu.org#25894,"TANJUNG PRIOK, TANJUNG PRIOK, JAKARTA UTARA, DKI JAKARTA",95,69,133,202
https://kawalpemilu.org#25894,"TANJUNG PRIOK, TANJUNG PRIOK, JAKARTA UTARA, DKI JAKARTA",96,112,109,221
https://kawalpemilu.org#25894,"TANJUNG PRIOK, TANJUNG PRIOK, JAKARTA UTARA, DKI JAKARTA",97,142,70,212
https://kawalpemilu.org#25894,"TANJUNG PRIOK, TANJUNG PRIOK, JAKARTA UTARA, DKI JAKARTA",99,125,68,193
https://kawalpemilu.org#25894,"TANJUNG PRIOK, TANJUNG PRIOK, JAKARTA UTARA, DKI JAKARTA",100,118,66,184
https://kawalpemilu.org#25894,"TANJUNG PRIOK, TANJUNG PRIOK, JAKARTA UTARA, DKI JAKARTA",101,107,96,203
https://kawalpemilu.org#25894,"TANJUNG PRIOK, TANJUNG PRIOK, JAKARTA UTARA, DKI JAKARTA",102,116,92,208
https://kawalpemilu.org#25894,"TANJUNG PRIOK, TANJUNG PRIOK, JAKARTA UTARA, DKI JAKARTA",105,76,83,159
https://kawalpemilu.org#25894,"TANJUNG PRIOK, TANJUNG PRIOK, JAKARTA UTARA, DKI JAKARTA",106,96,95,191
https://kawalpemilu.org#25894,"TANJUNG PRIOK, TANJUNG PRIOK, JAKARTA UTARA, DKI JAKARTA",107,90,66,156
https://kawalpemilu.org#25894,"TANJUNG PRIOK, TANJUNG PRIOK, JAKARTA UTARA, DKI JAKARTA",108,107,63,170
https://kawalpemilu.org#25894,"TANJUNG PRIOK, TANJUNG PRIOK, JAKARTA UTARA, DKI JAKARTA",109,114,101,215
https://kawalpemilu.org#25894,"TANJUNG PRIOK, TANJUNG PRIOK, JAKARTA UTARA, DKI JAKARTA",110,86,126,212
https://kawalpemilu.org#25895,"SUNTER JAYA, TANJUNG PRIOK, JAKARTA UTARA, DKI JAKARTA",2,104,89,193
https://kawalpemilu.org#25895,"SUNTER JAYA, TANJUNG PRIOK, JAKARTA UTARA, DKI JAKARTA",3,94,74,168
https://kawalpemilu.org#25895,"SUNTER JAYA, TANJUNG PRIOK, JAKARTA UTARA, DKI JAKARTA",4,132,72,204
https://kawalpemilu.org#25895,"SUNTER JAYA, TANJUNG PRIOK, JAKARTA UTARA, DKI JAKARTA",5,109,108,217
https://kawalpemilu.org#25895,"SUNTER JAYA, TANJUNG PRIOK, JAKARTA UTARA, DKI JAKARTA",6,120,70,190
https://kawalpemilu.org#25895,"SUNTER JAYA, TANJUNG PRIOK, JAKARTA UTARA, DKI JAKARTA",7,102,132,234
https://kawalpemilu.org#25895,"SUNTER JAYA, TANJUNG PRIOK, JAKARTA UTARA, DKI JAKARTA",8,107,69,176
https://kawalpemilu.org#25895,"SUNTER JAYA, TANJUNG PRIOK, JAKARTA UTARA, DKI JAKARTA",9,130,110,240
https://kawalpemilu.org#25895,"SUNTER JAYA, TANJUNG PRIOK, JAKARTA UTARA, DKI JAKARTA",10,133,100,233
https://kawalpemilu.org#25895,"SUNTER JAYA, TANJUNG PRIOK, JAKARTA UTARA, DKI JAKARTA",11,144,105,249
https://kawalpemilu.org#25895,"SUNTER JAYA, TANJUNG PRIOK, JAKARTA UTARA, DKI JAKARTA",12,122,77,199
https://kawalpemilu.org#25895,"SUNTER JAYA, TANJUNG PRIOK, JAKARTA UTARA, DKI JAKARTA",13,138,73,211
https://kawalpemilu.org#25895,"SUNTER JAYA, TANJUNG PRIOK, JAKARTA UTARA, DKI JAKARTA",15,95,89,184
https://kawalpemilu.org#25895,"SUNTER JAYA, TANJUNG PRIOK, JAKARTA UTARA, DKI JAKARTA",16,88,101,189
https://kawalpemilu.org#25895,"SUNTER JAYA, TANJUNG PRIOK, JAKARTA UTARA, DKI JAKARTA",17,93,111,204
https://kawalpemilu.org#25895,"SUNTER JAYA, TANJUNG PRIOK, JAKARTA UTARA, DKI JAKARTA",18,143,82,225
https://kawalpemilu.org#25895,"SUNTER JAYA, TANJUNG PRIOK, JAKARTA UTARA, DKI JAKARTA",20,127,98,225
https://kawalpemilu.org#25895,"SUNTER JAYA, TANJUNG PRIOK, JAKARTA UTARA, DKI JAKARTA",21,120,105,225
https://kawalpemilu.org#25895,"SUNTER JAYA, TANJUNG PRIOK, JAKARTA UTARA, DKI JAKARTA",22,143,95,238
https://kawalpemilu.org#25895,"SUNTER JAYA, TANJUNG PRIOK, JAKARTA UTARA, DKI JAKARTA",24,169,82,251
https://kawalpemilu.org#25895,"SUNTER JAYA, TANJUNG PRIOK, JAKARTA UTARA, DKI JAKARTA",27,143,99,242
https://kawalpemilu.org#25895,"SUNTER JAYA, TANJUNG PRIOK, JAKARTA UTARA, DKI JAKARTA",28,113,78,191
https://kawalpemilu.org#25895,"SUNTER JAYA, TANJUNG PRIOK, JAKARTA UTARA, DKI JAKARTA",29,112,61,173
https://kawalpemilu.org#25895,"SUNTER JAYA, TANJUNG PRIOK, JAKARTA UTARA, DKI JAKARTA",30,124,106,230
https://kawalpemilu.org#25895,"SUNTER JAYA, TANJUNG PRIOK, JAKARTA UTARA, DKI JAKARTA",31,130,106,236
https://kawalpemilu.org#25895,"SUNTER JAYA, TANJUNG PRIOK, JAKARTA UTARA, DKI JAKARTA",32,148,99,247
https://kawalpemilu.org#25895,"SUNTER JAYA, TANJUNG PRIOK, JAKARTA UTARA, DKI JAKARTA",34,108,102,210
https://kawalpemilu.org#25895,"SUNTER JAYA, TANJUNG PRIOK, JAKARTA UTARA, DKI JAKARTA",35,102,112,214
https://kawalpemilu.org#25895,"SUNTER JAYA, TANJUNG PRIOK, JAKARTA UTARA, DKI JAKARTA",36,84,105,189
https://kawalpemilu.org#25895,"SUNTER JAYA, TANJUNG PRIOK, JAKARTA UTARA, DKI JAKARTA",38,146,74,220
https://kawalpemilu.org#25895,"SUNTER JAYA, TANJUNG PRIOK, JAKARTA UTARA, DKI JAKARTA",39,137,90,227
https://kawalpemilu.org#25895,"SUNTER JAYA, TANJUNG PRIOK, JAKARTA UTARA, DKI JAKARTA",40,132,67,199
https://kawalpemilu.org#25895,"SUNTER JAYA, TANJUNG PRIOK, JAKARTA UTARA, DKI JAKARTA",42,161,78,239
https://kawalpemilu.org#25895,"SUNTER JAYA, TANJUNG PRIOK, JAKARTA UTARA, DKI JAKARTA",43,134,84,218
https://kawalpemilu.org#25895,"SUNTER JAYA, TANJUNG PRIOK, JAKARTA UTARA, DKI JAKARTA",44,170,76,246
https://kawalpemilu.org#25895,"SUNTER JAYA, TANJUNG PRIOK, JAKARTA UTARA, DKI JAKARTA",45,132,127,259
https://kawalpemilu.org#25895,"SUNTER JAYA, TANJUNG PRIOK, JAKARTA UTARA, DKI JAKARTA",46,76,145,221
https://kawalpemilu.org#25895,"SUNTER JAYA, TANJUNG PRIOK, JAKARTA UTARA, DKI JAKARTA",47,122,90,212
https://kawalpemilu.org#25895,"SUNTER JAYA, TANJUNG PRIOK, JAKARTA UTARA, DKI JAKARTA",48,118,109,227
https://kawalpemilu.org#25895,"SUNTER JAYA, TANJUNG PRIOK, JAKARTA UTARA, DKI JAKARTA",49,101,106,207
https://kawalpemilu.org#25895,"SUNTER JAYA, TANJUNG PRIOK, JAKARTA UTARA, DKI JAKARTA",50,136,59,195
https://kawalpemilu.org#25895,"SUNTER JAYA, TANJUNG PRIOK, JAKARTA UTARA, DKI JAKARTA",51,113,73,186
https://kawalpemilu.org#25895,"SUNTER JAYA, TANJUNG PRIOK, JAKARTA UTARA, DKI JAKARTA",52,118,89,207
https://kawalpemilu.org#25895,"SUNTER JAYA, TANJUNG PRIOK, JAKARTA UTARA, DKI JAKARTA",53,122,73,195
https://kawalpemilu.org#25895,"SUNTER JAYA, TANJUNG PRIOK, JAKARTA UTARA, DKI JAKARTA",54,118,95,213
https://kawalpemilu.org#25895,"SUNTER JAYA, TANJUNG PRIOK, JAKARTA UTARA, DKI JAKARTA",55,144,107,251
https://kawalpemilu.org#25895,"SUNTER JAYA, TANJUNG PRIOK, JAKARTA UTARA, DKI JAKARTA",57,151,90,241
https://kawalpemilu.org#25895,"SUNTER JAYA, TANJUNG PRIOK, JAKARTA UTARA, DKI JAKARTA",58,172,49,221
https://kawalpemilu.org#25895,"SUNTER JAYA, TANJUNG PRIOK, JAKARTA UTARA, DKI JAKARTA",59,116,73,189
https://kawalpemilu.org#25895,"SUNTER JAYA, TANJUNG PRIOK, JAKARTA UTARA, DKI JAKARTA",61,128,62,190
https://kawalpemilu.org#25895,"SUNTER JAYA, TANJUNG PRIOK, JAKARTA UTARA, DKI JAKARTA",63,125,87,212
https://kawalpemilu.org#25895,"SUNTER JAYA, TANJUNG PRIOK, JAKARTA UTARA, DKI JAKARTA",64,138,121,259
https://kawalpemilu.org#25895,"SUNTER JAYA, TANJUNG PRIOK, JAKARTA UTARA, DKI JAKARTA",65,100,89,189
https://kawalpemilu.org#25895,"SUNTER JAYA, TANJUNG PRIOK, JAKARTA UTARA, DKI JAKARTA",66,91,97,188
https://kawalpemilu.org#25895,"SUNTER JAYA, TANJUNG PRIOK, JAKARTA UTARA, DKI JAKARTA",67,143,71,214
https://kawalpemilu.org#25895,"SUNTER JAYA, TANJUNG PRIOK, JAKARTA UTARA, DKI JAKARTA",68,162,88,250
https://kawalpemilu.org#25895,"SUNTER JAYA, TANJUNG PRIOK, JAKARTA UTARA, DKI JAKARTA",70,149,103,252
https://kawalpemilu.org#25895,"SUNTER JAYA, TANJUNG PRIOK, JAKARTA UTARA, DKI JAKARTA",71,116,92,208
https://kawalpemilu.org#25895,"SUNTER JAYA, TANJUNG PRIOK, JAKARTA UTARA, DKI JAKARTA",74,96,133,229
https://kawalpemilu.org#25895,"SUNTER JAYA, TANJUNG PRIOK, JAKARTA UTARA, DKI JAKARTA",75,150,106,256
https://kawalpemilu.org#25895,"SUNTER JAYA, TANJUNG PRIOK, JAKARTA UTARA, DKI JAKARTA",76,144,114,258
https://kawalpemilu.org#25895,"SUNTER JAYA, TANJUNG PRIOK, JAKARTA UTARA, DKI JAKARTA",80,142,90,232
https://kawalpemilu.org#25895,"SUNTER JAYA, TANJUNG PRIOK, JAKARTA UTARA, DKI JAKARTA",81,142,95,237
https://kawalpemilu.org#25895,"SUNTER JAYA, TANJUNG PRIOK, JAKARTA UTARA, DKI JAKARTA",82,120,122,242
https://kawalpemilu.org#25895,"SUNTER JAYA, TANJUNG PRIOK, JAKARTA UTARA, DKI JAKARTA",84,113,112,225
https://kawalpemilu.org#25895,"SUNTER JAYA, TANJUNG PRIOK, JAKARTA UTARA, DKI JAKARTA",85,113,114,227
https://kawalpemilu.org#25895,"SUNTER JAYA, TANJUNG PRIOK, JAKARTA UTARA, DKI JAKARTA",86,110,118,228
https://kawalpemilu.org#25895,"SUNTER JAYA, TANJUNG PRIOK, JAKARTA UTARA, DKI JAKARTA",90,142,76,218
https://kawalpemilu.org#25895,"SUNTER JAYA, TANJUNG PRIOK, JAKARTA UTARA, DKI JAKARTA",91,156,87,243
https://kawalpemilu.org#25895,"SUNTER JAYA, TANJUNG PRIOK, JAKARTA UTARA, DKI JAKARTA",92,147,128,275
https://kawalpemilu.org#25895,"SUNTER JAYA, TANJUNG PRIOK, JAKARTA UTARA, DKI JAKARTA",93,138,71,209
https://kawalpemilu.org#25895,"SUNTER JAYA, TANJUNG PRIOK, JAKARTA UTARA, DKI JAKARTA",94,189,62,251
https://kawalpemilu.org#25895,"SUNTER JAYA, TANJUNG PRIOK, JAKARTA UTARA, DKI JAKARTA",95,198,46,244
https://kawalpemilu.org#25895,"SUNTER JAYA, TANJUNG PRIOK, JAKARTA UTARA, DKI JAKARTA",96,167,84,251
https://kawalpemilu.org#25895,"SUNTER JAYA, TANJUNG PRIOK, JAKARTA UTARA, DKI JAKARTA",97,157,65,222
https://kawalpemilu.org#25895,"SUNTER JAYA, TANJUNG PRIOK, JAKARTA UTARA, DKI JAKARTA",98,154,70,224
https://kawalpemilu.org#25895,"SUNTER JAYA, TANJUNG PRIOK, JAKARTA UTARA, DKI JAKARTA",99,150,83,233
https://kawalpemilu.org#25895,"SUNTER JAYA, TANJUNG PRIOK, JAKARTA UTARA, DKI JAKARTA",101,175,75,250
https://kawalpemilu.org#25895,"SUNTER JAYA, TANJUNG PRIOK, JAKARTA UTARA, DKI JAKARTA",103,148,75,223
https://kawalpemilu.org#25895,"SUNTER JAYA, TANJUNG PRIOK, JAKARTA UTARA, DKI JAKARTA",104,156,58,214
https://kawalpemilu.org#25895,"SUNTER JAYA, TANJUNG PRIOK, JAKARTA UTARA, DKI JAKARTA",105,193,49,242
https://kawalpemilu.org#25895,"SUNTER JAYA, TANJUNG PRIOK, JAKARTA UTARA, DKI JAKARTA",106,106,83,189
https://kawalpemilu.org#25895,"SUNTER JAYA, TANJUNG PRIOK, JAKARTA UTARA, DKI JAKARTA",107,128,91,219
https://kawalpemilu.org#25895,"SUNTER JAYA, TANJUNG PRIOK, JAKARTA UTARA, DKI JAKARTA",108,132,68,200
https://kawalpemilu.org#25895,"SUNTER JAYA, TANJUNG PRIOK, JAKARTA UTARA, DKI JAKARTA",109,163,61,224
https://kawalpemilu.org#25895,"SUNTER JAYA, TANJUNG PRIOK, JAKARTA UTARA, DKI JAKARTA",110,171,73,244
https://kawalpemilu.org#25895,"SUNTER JAYA, TANJUNG PRIOK, JAKARTA UTARA, DKI JAKARTA",111,113,142,255
https://kawalpemilu.org#25895,"SUNTER JAYA, TANJUNG PRIOK, JAKARTA UTARA, DKI JAKARTA",112,95,155,250
https://kawalpemilu.org#25895,"SUNTER JAYA, TANJUNG PRIOK, JAKARTA UTARA, DKI JAKARTA",113,91,153,244
https://kawalpemilu.org#25895,"SUNTER JAYA, TANJUNG PRIOK, JAKARTA UTARA, DKI JAKARTA",115,93,103,196
https://kawalpemilu.org#25895,"SUNTER JAYA, TANJUNG PRIOK, JAKARTA UTARA, DKI JAKARTA",116,121,70,191
https://kawalpemilu.org#25895,"SUNTER JAYA, TANJUNG PRIOK, JAKARTA UTARA, DKI JAKARTA",117,95,128,223
https://kawalpemilu.org#25895,"SUNTER JAYA, TANJUNG PRIOK, JAKARTA UTARA, DKI JAKARTA",118,131,137,268
https://kawalpemilu.org#25895,"SUNTER JAYA, TANJUNG PRIOK, JAKARTA UTARA, DKI JAKARTA",119,111,125,236
https://kawalpemilu.org#25895,"SUNTER JAYA, TANJUNG PRIOK, JAKARTA UTARA, DKI JAKARTA",120,134,107,241
https://kawalpemilu.org#25895,"SUNTER JAYA, TANJUNG PRIOK, JAKARTA UTARA, DKI JAKARTA",121,88,120,208
https://kawalpemilu.org#25895,"SUNTER JAYA, TANJUNG PRIOK, JAKARTA UTARA, DKI JAKARTA",122,109,78,187
https://kawalpemilu.org#25895,"SUNTER JAYA, TANJUNG PRIOK, JAKARTA UTARA, DKI JAKARTA",123,161,95,256
https://kawalpemilu.org#25895,"SUNTER JAYA, TANJUNG PRIOK, JAKARTA UTARA, DKI JAKARTA",124,101,156,257
https://kawalpemilu.org#25895,"SUNTER JAYA, TANJUNG PRIOK, JAKARTA UTARA, DKI JAKARTA",125,92,154,246
https://kawalpemilu.org#25895,"SUNTER JAYA, TANJUNG PRIOK, JAKARTA UTARA, DKI JAKARTA",126,106,152,258
https://kawalpemilu.org#25895,"SUNTER JAYA, TANJUNG PRIOK, JAKARTA UTARA, DKI JAKARTA",127,50,174,224
https://kawalpemilu.org#25895,"SUNTER JAYA, TANJUNG PRIOK, JAKARTA UTARA, DKI JAKARTA",128,80,159,239
https://kawalpemilu.org#25895,"SUNTER JAYA, TANJUNG PRIOK, JAKARTA UTARA, DKI JAKARTA",129,100,161,261
https://kawalpemilu.org#25895,"SUNTER JAYA, TANJUNG PRIOK, JAKARTA UTARA, DKI JAKARTA",130,179,15,194
https://kawalpemilu.org#25895,"SUNTER JAYA, TANJUNG PRIOK, JAKARTA UTARA, DKI JAKARTA",131,195,24,219
https://kawalpemilu.org#25895,"SUNTER JAYA, TANJUNG PRIOK, JAKARTA UTARA, DKI JAKARTA",132,206,15,221
https://kawalpemilu.org#25895,"SUNTER JAYA, TANJUNG PRIOK, JAKARTA UTARA, DKI JAKARTA",133,189,21,210
https://kawalpemilu.org#25895,"SUNTER JAYA, TANJUNG PRIOK, JAKARTA UTARA, DKI JAKARTA",134,232,14,246
https://kawalpemilu.org#25895,"SUNTER JAYA, TANJUNG PRIOK, JAKARTA UTARA, DKI JAKARTA",135,219,14,233
https://kawalpemilu.org#25895,"SUNTER JAYA, TANJUNG PRIOK, JAKARTA UTARA, DKI JAKARTA",136,240,7,247
https://kawalpemilu.org#25895,"SUNTER JAYA, TANJUNG PRIOK, JAKARTA UTARA, DKI JAKARTA",137,238,20,258
https://kawalpemilu.org#25895,"SUNTER JAYA, TANJUNG PRIOK, JAKARTA UTARA, DKI JAKARTA",138,219,5,224
https://kawalpemilu.org#25895,"SUNTER JAYA, TANJUNG PRIOK, JAKARTA UTARA, DKI JAKARTA",139,215,9,224
https://kawalpemilu.org#25895,"SUNTER JAYA, TANJUNG PRIOK, JAKARTA UTARA, DKI JAKARTA",140,236,5,239
https://kawalpemilu.org#25895,"SUNTER JAYA, TANJUNG PRIOK, JAKARTA UTARA, DKI JAKARTA",141,245,14,259
https://kawalpemilu.org#25895,"SUNTER JAYA, TANJUNG PRIOK, JAKARTA UTARA, DKI JAKARTA",142,116,136,252
https://kawalpemilu.org#25895,"SUNTER JAYA, TANJUNG PRIOK, JAKARTA UTARA, DKI JAKARTA",143,100,118,218
https://kawalpemilu.org#25895,"SUNTER JAYA, TANJUNG PRIOK, JAKARTA UTARA, DKI JAKARTA",145,74,171,245
https://kawalpemilu.org#25895,"SUNTER JAYA, TANJUNG PRIOK, JAKARTA UTARA, DKI JAKARTA",146,61,164,225
https://kawalpemilu.org#25895,"SUNTER JAYA, TANJUNG PRIOK, JAKARTA UTARA, DKI JAKARTA",147,118,96,214
https://kawalpemilu.org#25895,"SUNTER JAYA, TANJUNG PRIOK, JAKARTA UTARA, DKI JAKARTA",148,87,163,250
https://kawalpemilu.org#25895,"SUNTER JAYA, TANJUNG PRIOK, JAKARTA UTARA, DKI JAKARTA",149,67,164,231
https://kawalpemilu.org#25895,"SUNTER JAYA, TANJUNG PRIOK, JAKARTA UTARA, DKI JAKARTA",150,84,160,244
https://kawalpemilu.org#25895,"SUNTER JAYA, TANJUNG PRIOK, JAKARTA UTARA, DKI JAKARTA",151,121,139,260
https://kawalpemilu.org#25895,"SUNTER JAYA, TANJUNG PRIOK, JAKARTA UTARA, DKI JAKARTA",152,143,99,242
https://kawalpemilu.org#25895,"SUNTER JAYA, TANJUNG PRIOK, JAKARTA UTARA, DKI JAKARTA",153,107,137,244
https://kawalpemilu.org#25895,"SUNTER JAYA, TANJUNG PRIOK, JAKARTA UTARA, DKI JAKARTA",154,120,89,209
https://kawalpemilu.org#25895,"SUNTER JAYA, TANJUNG PRIOK, JAKARTA UTARA, DKI JAKARTA",155,207,23,230
https://kawalpemilu.org#25895,"SUNTER JAYA, TANJUNG PRIOK, JAKARTA UTARA, DKI JAKARTA",156,221,12,233
https://kawalpemilu.org#25895,"SUNTER JAYA, TANJUNG PRIOK, JAKARTA UTARA, DKI JAKARTA",157,191,24,215
https://kawalpemilu.org#25895,"SUNTER JAYA, TANJUNG PRIOK, JAKARTA UTARA, DKI JAKARTA",158,233,8,241
https://kawalpemilu.org#25895,"SUNTER JAYA, TANJUNG PRIOK, JAKARTA UTARA, DKI JAKARTA",159,214,3,217
https://kawalpemilu.org#25895,"SUNTER JAYA, TANJUNG PRIOK, JAKARTA UTARA, DKI JAKARTA",160,197,5,202
https://kawalpemilu.org#25895,"SUNTER JAYA, TANJUNG PRIOK, JAKARTA UTARA, DKI JAKARTA",161,202,6,208
https://kawalpemilu.org#25895,"SUNTER JAYA, TANJUNG PRIOK, JAKARTA UTARA, DKI JAKARTA",162,235,4,239
https://kawalpemilu.org#25895,"SUNTER JAYA, TANJUNG PRIOK, JAKARTA UTARA, DKI JAKARTA",163,239,8,247
https://kawalpemilu.org#25895,"SUNTER JAYA, TANJUNG PRIOK, JAKARTA UTARA, DKI JAKARTA",164,270,5,275
https://kawalpemilu.org#25895,"SUNTER JAYA, TANJUNG PRIOK, JAKARTA UTARA, DKI JAKARTA",165,219,4,223
https://kawalpemilu.org#25895,"SUNTER JAYA, TANJUNG PRIOK, JAKARTA UTARA, DKI JAKARTA",166,184,4,188
https://kawalpemilu.org#25895,"SUNTER JAYA, TANJUNG PRIOK, JAKARTA UTARA, DKI JAKARTA",167,176,6,182
https://kawalpemilu.org#25895,"SUNTER JAYA, TANJUNG PRIOK, JAKARTA UTARA, DKI JAKARTA",168,96,130,226
https://kawalpemilu.org#25895,"SUNTER JAYA, TANJUNG PRIOK, JAKARTA UTARA, DKI JAKARTA",169,77,160,237
https://kawalpemilu.org#25895,"SUNTER JAYA, TANJUNG PRIOK, JAKARTA UTARA, DKI JAKARTA",170,85,139,224
https://kawalpemilu.org#25895,"SUNTER JAYA, TANJUNG PRIOK, JAKARTA UTARA, DKI JAKARTA",171,82,132,214
https://kawalpemilu.org#25895,"SUNTER JAYA, TANJUNG PRIOK, JAKARTA UTARA, DKI JAKARTA",172,60,145,205
https://kawalpemilu.org#25895,"SUNTER JAYA, TANJUNG PRIOK, JAKARTA UTARA, DKI JAKARTA",174,65,157,222
https://kawalpemilu.org#25895,"SUNTER JAYA, TANJUNG PRIOK, JAKARTA UTARA, DKI JAKARTA",175,128,75,203
https://kawalpemilu.org#25895,"SUNTER JAYA, TANJUNG PRIOK, JAKARTA UTARA, DKI JAKARTA",177,244,6,250
https://kawalpemilu.org#25895,"SUNTER JAYA, TANJUNG PRIOK, JAKARTA UTARA, DKI JAKARTA",178,246,6,252
https://kawalpemilu.org#25895,"SUNTER JAYA, TANJUNG PRIOK, JAKARTA UTARA, DKI JAKARTA",179,226,16,242
https://kawalpemilu.org#25895,"SUNTER JAYA, TANJUNG PRIOK, JAKARTA UTARA, DKI JAKARTA",180,233,5,238
https://kawalpemilu.org#25895,"SUNTER JAYA, TANJUNG PRIOK, JAKARTA UTARA, DKI JAKARTA",181,225,19,244
https://kawalpemilu.org#25895,"SUNTER JAYA, TANJUNG PRIOK, JAKARTA UTARA, DKI JAKARTA",182,229,16,245
https://kawalpemilu.org#25895,"SUNTER JAYA, TANJUNG PRIOK, JAKARTA UTARA, DKI JAKARTA",183,211,9,220
https://kawalpemilu.org#25895,"SUNTER JAYA, TANJUNG PRIOK, JAKARTA UTARA, DKI JAKARTA",184,248,6,254
https://kawalpemilu.org#25895,"SUNTER JAYA, TANJUNG PRIOK, JAKARTA UTARA, DKI JAKARTA",186,239,7,246
https://kawalpemilu.org#25895,"SUNTER JAYA, TANJUNG PRIOK, JAKARTA UTARA, DKI JAKARTA",187,248,12,260
https://kawalpemilu.org#25895,"SUNTER JAYA, TANJUNG PRIOK, JAKARTA UTARA, DKI JAKARTA",188,264,5,269
https://kawalpemilu.org#25895,"SUNTER JAYA, TANJUNG PRIOK, JAKARTA UTARA, DKI JAKARTA",189,207,19,226
https://kawalpemilu.org#25895,"SUNTER JAYA, TANJUNG PRIOK, JAKARTA UTARA, DKI JAKARTA",190,215,10,225
https://kawalpemilu.org#25895,"SUNTER JAYA, TANJUNG PRIOK, JAKARTA UTARA, DKI JAKARTA",191,220,24,244
https://kawalpemilu.org#25895,"SUNTER JAYA, TANJUNG PRIOK, JAKARTA UTARA, DKI JAKARTA",192,171,16,187
https://kawalpemilu.org#25895,"SUNTER JAYA, TANJUNG PRIOK, JAKARTA UTARA, DKI JAKARTA",193,111,85,196
https://kawalpemilu.org#25895,"SUNTER JAYA, TANJUNG PRIOK, JAKARTA UTARA, DKI JAKARTA",194,80,66,146
https://kawalpemilu.org#25895,"SUNTER JAYA, TANJUNG PRIOK, JAKARTA UTARA, DKI JAKARTA",195,62,58,120
https://kawalpemilu.org#25895,"SUNTER JAYA, TANJUNG PRIOK, JAKARTA UTARA, DKI JAKARTA",196,104,110,214
https://kawalpemilu.org#25895,"SUNTER JAYA, TANJUNG PRIOK, JAKARTA UTARA, DKI JAKARTA",197,82,50,132
https://kawalpemilu.org#25896,"PAPANGGO, TANJUNG PRIOK, JAKARTA UTARA, DKI JAKARTA",1,132,82,214
https://kawalpemilu.org#25896,"PAPANGGO, TANJUNG PRIOK, JAKARTA UTARA, DKI JAKARTA",2,125,102,227
https://kawalpemilu.org#25896,"PAPANGGO, TANJUNG PRIOK, JAKARTA UTARA, DKI JAKARTA",3,72,141,213
https://kawalpemilu.org#25896,"PAPANGGO, TANJUNG PRIOK, JAKARTA UTARA, DKI JAKARTA",4,129,83,212
https://kawalpemilu.org#25896,"PAPANGGO, TANJUNG PRIOK, JAKARTA UTARA, DKI JAKARTA",5,110,146,256
https://kawalpemilu.org#25896,"PAPANGGO, TANJUNG PRIOK, JAKARTA UTARA, DKI JAKARTA",6,134,64,198
https://kawalpemilu.org#25896,"PAPANGGO, TANJUNG PRIOK, JAKARTA UTARA, DKI JAKARTA",7,99,102,201
https://kawalpemilu.org#25896,"PAPANGGO, TANJUNG PRIOK, JAKARTA UTARA, DKI JAKARTA",8,95,65,160
https://kawalpemilu.org#25896,"PAPANGGO, TANJUNG PRIOK, JAKARTA UTARA, DKI JAKARTA",9,117,93,210
https://kawalpemilu.org#25896,"PAPANGGO, TANJUNG PRIOK, JAKARTA UTARA, DKI JAKARTA",10,124,83,207
https://kawalpemilu.org#25896,"PAPANGGO, TANJUNG PRIOK, JAKARTA UTARA, DKI JAKARTA",11,112,104,216
https://kawalpemilu.org#25896,"PAPANGGO, TANJUNG PRIOK, JAKARTA UTARA, DKI JAKARTA",12,120,106,226
https://kawalpemilu.org#25896,"PAPANGGO, TANJUNG PRIOK, JAKARTA UTARA, DKI JAKARTA",13,116,104,220
https://kawalpemilu.org#25896,"PAPANGGO, TANJUNG PRIOK, JAKARTA UTARA, DKI JAKARTA",14,115,108,223
https://kawalpemilu.org#25896,"PAPANGGO, TANJUNG PRIOK, JAKARTA UTARA, DKI JAKARTA",15,112,116,228
https://kawalpemilu.org#25896,"PAPANGGO, TANJUNG PRIOK, JAKARTA UTARA, DKI JAKARTA",16,72,104,176
https://kawalpemilu.org#25896,"PAPANGGO, TANJUNG PRIOK, JAKARTA UTARA, DKI JAKARTA",17,101,119,220
https://kawalpemilu.org#25896,"PAPANGGO, TANJUNG PRIOK, JAKARTA UTARA, DKI JAKARTA",18,104,120,224
https://kawalpemilu.org#25896,"PAPANGGO, TANJUNG PRIOK, JAKARTA UTARA, DKI JAKARTA",19,99,150,249
https://kawalpemilu.org#25896,"PAPANGGO, TANJUNG PRIOK, JAKARTA UTARA, DKI JAKARTA",20,115,99,214
https://kawalpemilu.org#25896,"PAPANGGO, TANJUNG PRIOK, JAKARTA UTARA, DKI JAKARTA",21,107,148,255
https://kawalpemilu.org#25896,"PAPANGGO, TANJUNG PRIOK, JAKARTA UTARA, DKI JAKARTA",22,103,89,192
https://kawalpemilu.org#25896,"PAPANGGO, TANJUNG PRIOK, JAKARTA UTARA, DKI JAKARTA",23,98,130,228
https://kawalpemilu.org#25896,"PAPANGGO, TANJUNG PRIOK, JAKARTA UTARA, DKI JAKARTA",24,111,118,229
https://kawalpemilu.org#25896,"PAPANGGO, TANJUNG PRIOK, JAKARTA UTARA, DKI JAKARTA",25,103,132,235
https://kawalpemilu.org#25896,"PAPANGGO, TANJUNG PRIOK, JAKARTA UTARA, DKI JAKARTA",26,81,114,195
https://kawalpemilu.org#25896,"PAPANGGO, TANJUNG PRIOK, JAKARTA UTARA, DKI JAKARTA",27,105,148,253
https://kawalpemilu.org#25896,"PAPANGGO, TANJUNG PRIOK, JAKARTA UTARA, DKI JAKARTA",28,111,152,262
https://kawalpemilu.org#25896,"PAPANGGO, TANJUNG PRIOK, JAKARTA UTARA, DKI JAKARTA",29,139,107,246
https://kawalpemilu.org#25896,"PAPANGGO, TANJUNG PRIOK, JAKARTA UTARA, DKI JAKARTA",30,104,120,244
https://kawalpemilu.org#25896,"PAPANGGO, TANJUNG PRIOK, JAKARTA UTARA, DKI JAKARTA",31,98,140,238
https://kawalpemilu.org#25896,"PAPANGGO, TANJUNG PRIOK, JAKARTA UTARA, DKI JAKARTA",32,76,76,152
https://kawalpemilu.org#25896,"PAPANGGO, TANJUNG PRIOK, JAKARTA UTARA, DKI JAKARTA",33,124,128,252
https://kawalpemilu.org#25896,"PAPANGGO, TANJUNG PRIOK, JAKARTA UTARA, DKI JAKARTA",34,100,99,199
https://kawalpemilu.org#25896,"PAPANGGO, TANJUNG PRIOK, JAKARTA UTARA, DKI JAKARTA",35,109,126,235
https://kawalpemilu.org#25896,"PAPANGGO, TANJUNG PRIOK, JAKARTA UTARA, DKI JAKARTA",36,75,108,183
https://kawalpemilu.org#25896,"PAPANGGO, TANJUNG PRIOK, JAKARTA UTARA, DKI JAKARTA",37,99,133,232
https://kawalpemilu.org#25896,"PAPANGGO, TANJUNG PRIOK, JAKARTA UTARA, DKI JAKARTA",38,88,86,174
https://kawalpemilu.org#25896,"PAPANGGO, TANJUNG PRIOK, JAKARTA UTARA, DKI JAKARTA",39,99,131,230
https://kawalpemilu.org#25896,"PAPANGGO, TANJUNG PRIOK, JAKARTA UTARA, DKI JAKARTA",40,124,81,205
https://kawalpemilu.org#25896,"PAPANGGO, TANJUNG PRIOK, JAKARTA UTARA, DKI JAKARTA",41,147,92,239
https://kawalpemilu.org#25896,"PAPANGGO, TANJUNG PRIOK, JAKARTA UTARA, DKI JAKARTA",42,106,124,230
https://kawalpemilu.org#25896,"PAPANGGO, TANJUNG PRIOK, JAKARTA UTARA, DKI JAKARTA",43,100,103,203
https://kawalpemilu.org#25896,"PAPANGGO, TANJUNG PRIOK, JAKARTA UTARA, DKI JAKARTA",44,110,127,237
https://kawalpemilu.org#25896,"PAPANGGO, TANJUNG PRIOK, JAKARTA UTARA, DKI JAKARTA",45,102,80,182
https://kawalpemilu.org#25896,"PAPANGGO, TANJUNG PRIOK, JAKARTA UTARA, DKI JAKARTA",46,210,13,223
https://kawalpemilu.org#25896,"PAPANGGO, TANJUNG PRIOK, JAKARTA UTARA, DKI JAKARTA",47,155,7,162
https://kawalpemilu.org#25896,"PAPANGGO, TANJUNG PRIOK, JAKARTA UTARA, DKI JAKARTA",48,218,13,231
https://kawalpemilu.org#25896,"PAPANGGO, TANJUNG PRIOK, JAKARTA UTARA, DKI JAKARTA",49,230,8,238
https://kawalpemilu.org#25896,"PAPANGGO, TANJUNG PRIOK, JAKARTA UTARA, DKI JAKARTA",50,133,116,249
https://kawalpemilu.org#25896,"PAPANGGO, TANJUNG PRIOK, JAKARTA UTARA, DKI JAKARTA",51,71,71,142
https://kawalpemilu.org#25896,"PAPANGGO, TANJUNG PRIOK, JAKARTA UTARA, DKI JAKARTA",52,106,130,236
https://kawalpemilu.org#25896,"PAPANGGO, TANJUNG PRIOK, JAKARTA UTARA, DKI JAKARTA",53,101,78,179
https://kawalpemilu.org#25896,"PAPANGGO, TANJUNG PRIOK, JAKARTA UTARA, DKI JAKARTA",54,95,87,182
https://kawalpemilu.org#25896,"PAPANGGO, TANJUNG PRIOK, JAKARTA UTARA, DKI JAKARTA",55,136,116,252
https://kawalpemilu.org#25896,"PAPANGGO, TANJUNG PRIOK, JAKARTA UTARA, DKI JAKARTA",56,129,93,222
https://kawalpemilu.org#25896,"PAPANGGO, TANJUNG PRIOK, JAKARTA UTARA, DKI JAKARTA",57,106,67,173
https://kawalpemilu.org#25896,"PAPANGGO, TANJUNG PRIOK, JAKARTA UTARA, DKI JAKARTA",58,158,96,254
https://kawalpemilu.org#25896,"PAPANGGO, TANJUNG PRIOK, JAKARTA UTARA, DKI JAKARTA",59,134,85,219
https://kawalpemilu.org#25896,"PAPANGGO, TANJUNG PRIOK, JAKARTA UTARA, DKI JAKARTA",60,112,109,221
https://kawalpemilu.org#25896,"PAPANGGO, TANJUNG PRIOK, JAKARTA UTARA, DKI JAKARTA",61,122,72,194
https://kawalpemilu.org#25896,"PAPANGGO, TANJUNG PRIOK, JAKARTA UTARA, DKI JAKARTA",62,85,39,124
https://kawalpemilu.org#25896,"PAPANGGO, TANJUNG PRIOK, JAKARTA UTARA, DKI JAKARTA",63,89,64,153
https://kawalpemilu.org#25896,"PAPANGGO, TANJUNG PRIOK, JAKARTA UTARA, DKI JAKARTA",64,85,171,256
https://kawalpemilu.org#25896,"PAPANGGO, TANJUNG PRIOK, JAKARTA UTARA, DKI JAKARTA",65,140,111,251
https://kawalpemilu.org#25896,"PAPANGGO, TANJUNG PRIOK, JAKARTA UTARA, DKI JAKARTA",66,101,63,164
https://kawalpemilu.org#25896,"PAPANGGO, TANJUNG PRIOK, JAKARTA UTARA, DKI JAKARTA",67,113,143,256
https://kawalpemilu.org#25896,"PAPANGGO, TANJUNG PRIOK, JAKARTA UTARA, DKI JAKARTA",68,89,105,194
https://kawalpemilu.org#25896,"PAPANGGO, TANJUNG PRIOK, JAKARTA UTARA, DKI JAKARTA",69,70,77,147
https://kawalpemilu.org#25896,"PAPANGGO, TANJUNG PRIOK, JAKARTA UTARA, DKI JAKARTA",70,95,128,223
https://kawalpemilu.org#25896,"PAPANGGO, TANJUNG PRIOK, JAKARTA UTARA, DKI JAKARTA",71,105,131,236
https://kawalpemilu.org#25896,"PAPANGGO, TANJUNG PRIOK, JAKARTA UTARA, DKI JAKARTA",72,87,73,160
https://kawalpemilu.org#25896,"PAPANGGO, TANJUNG PRIOK, JAKARTA UTARA, DKI JAKARTA",73,102,95,197
https://kawalpemilu.org#25896,"PAPANGGO, TANJUNG PRIOK, JAKARTA UTARA, DKI JAKARTA",74,169,69,238
https://kawalpemilu.org#25896,"PAPANGGO, TANJUNG PRIOK, JAKARTA UTARA, DKI JAKARTA",75,92,68,160
https://kawalpemilu.org#25896,"PAPANGGO, TANJUNG PRIOK, JAKARTA UTARA, DKI JAKARTA",76,103,106,209
https://kawalpemilu.org#25896,"PAPANGGO, TANJUNG PRIOK, JAKARTA UTARA, DKI JAKARTA",77,87,86,173
https://kawalpemilu.org#25896,"PAPANGGO, TANJUNG PRIOK, JAKARTA UTARA, DKI JAKARTA",78,63,64,127
https://kawalpemilu.org#25896,"PAPANGGO, TANJUNG PRIOK, JAKARTA UTARA, DKI JAKARTA",79,98,103,201
https://kawalpemilu.org#25896,"PAPANGGO, TANJUNG PRIOK, JAKARTA UTARA, DKI JAKARTA",80,104,122,226
https://kawalpemilu.org#25896,"PAPANGGO, TANJUNG PRIOK, JAKARTA UTARA, DKI JAKARTA",81,137,4,141
https://kawalpemilu.org#25896,"PAPANGGO, TANJUNG PRIOK, JAKARTA UTARA, DKI JAKARTA",82,112,104,216
https://kawalpemilu.org#25896,"PAPANGGO, TANJUNG PRIOK, JAKARTA UTARA, DKI JAKARTA",83,102,97,199
https://kawalpemilu.org#25896,"PAPANGGO, TANJUNG PRIOK, JAKARTA UTARA, DKI JAKARTA",84,95,115,210
https://kawalpemilu.org#25896,"PAPANGGO, TANJUNG PRIOK, JAKARTA UTARA, DKI JAKARTA",85,105,114,219
https://kawalpemilu.org#25896,"PAPANGGO, TANJUNG PRIOK, JAKARTA UTARA, DKI JAKARTA",86,65,116,181
https://kawalpemilu.org#25896,"PAPANGGO, TANJUNG PRIOK, JAKARTA UTARA, DKI JAKARTA",87,98,106,204
https://kawalpemilu.org#25896,"PAPANGGO, TANJUNG PRIOK, JAKARTA UTARA, DKI JAKARTA",88,111,88,199
https://kawalpemilu.org#25896,"PAPANGGO, TANJUNG PRIOK, JAKARTA UTARA, DKI JAKARTA",89,89,84,173
https://kawalpemilu.org#25896,"PAPANGGO, TANJUNG PRIOK, JAKARTA UTARA, DKI JAKARTA",90,107,138,245
https://kawalpemilu.org#25896,"PAPANGGO, TANJUNG PRIOK, JAKARTA UTARA, DKI JAKARTA",91,66,75,141
https://kawalpemilu.org#25896,"PAPANGGO, TANJUNG PRIOK, JAKARTA UTARA, DKI JAKARTA",92,112,91,203
https://kawalpemilu.org#25896,"PAPANGGO, TANJUNG PRIOK, JAKARTA UTARA, DKI JAKARTA",93,116,75,191
https://kawalpemilu.org#25896,"PAPANGGO, TANJUNG PRIOK, JAKARTA UTARA, DKI JAKARTA",94,87,92,179
https://kawalpemilu.org#25896,"PAPANGGO, TANJUNG PRIOK, JAKARTA UTARA, DKI JAKARTA",95,73,122,195
https://kawalpemilu.org#25896,"PAPANGGO, TANJUNG PRIOK, JAKARTA UTARA, DKI JAKARTA",96,100,126,226
https://kawalpemilu.org#25896,"PAPANGGO, TANJUNG PRIOK, JAKARTA UTARA, DKI JAKARTA",97,112,90,202
https://kawalpemilu.org#25896,"PAPANGGO, TANJUNG PRIOK, JAKARTA UTARA, DKI JAKARTA",98,73,122,195
https://kawalpemilu.org#25896,"PAPANGGO, TANJUNG PRIOK, JAKARTA UTARA, DKI JAKARTA",99,117,135,252
https://kawalpemilu.org#25896,"PAPANGGO, TANJUNG PRIOK, JAKARTA UTARA, DKI JAKARTA",100,116,84,200
https://kawalpemilu.org#25896,"PAPANGGO, TANJUNG PRIOK, JAKARTA UTARA, DKI JAKARTA",101,120,122,242
https://kawalpemilu.org#25896,"PAPANGGO, TANJUNG PRIOK, JAKARTA UTARA, DKI JAKARTA",102,125,101,226
https://kawalpemilu.org#25896,"PAPANGGO, TANJUNG PRIOK, JAKARTA UTARA, DKI JAKARTA",103,95,102,197
https://kawalpemilu.org#25896,"PAPANGGO, TANJUNG PRIOK, JAKARTA UTARA, DKI JAKARTA",104,132,103,235
https://kawalpemilu.org#25896,"PAPANGGO, TANJUNG PRIOK, JAKARTA UTARA, DKI JAKARTA",105,132,82,214
https://kawalpemilu.org#25896,"PAPANGGO, TANJUNG PRIOK, JAKARTA UTARA, DKI JAKARTA",106,154,72,226
https://kawalpemilu.org#25896,"PAPANGGO, TANJUNG PRIOK, JAKARTA UTARA, DKI JAKARTA",107,91,46,137
https://kawalpemilu.org#25896,"PAPANGGO, TANJUNG PRIOK, JAKARTA UTARA, DKI JAKARTA",108,148,63,211
https://kawalpemilu.org#25896,"PAPANGGO, TANJUNG PRIOK, JAKARTA UTARA, DKI JAKARTA",109,139,62,201
https://kawalpemilu.org#25896,"PAPANGGO, TANJUNG PRIOK, JAKARTA UTARA, DKI JAKARTA",110,147,65,212
https://kawalpemilu.org#25896,"PAPANGGO, TANJUNG PRIOK, JAKARTA UTARA, DKI JAKARTA",111,139,59,198
https://kawalpemilu.org#25896,"PAPANGGO, TANJUNG PRIOK, JAKARTA UTARA, DKI JAKARTA",112,126,60,186
https://kawalpemilu.org#25896,"PAPANGGO, TANJUNG PRIOK, JAKARTA UTARA, DKI JAKARTA",113,100,39,139
https://kawalpemilu.org#25896,"PAPANGGO, TANJUNG PRIOK, JAKARTA UTARA, DKI JAKARTA",114,0,0,0
https://kawalpemilu.org#25896,"PAPANGGO, TANJUNG PRIOK, JAKARTA UTARA, DKI JAKARTA",115,108,50,158
https://kawalpemilu.org#25896,"PAPANGGO, TANJUNG PRIOK, JAKARTA UTARA, DKI JAKARTA",116,110,127,237
https://kawalpemilu.org#25896,"PAPANGGO, TANJUNG PRIOK, JAKARTA UTARA, DKI JAKARTA",117,230,6,236
https://kawalpemilu.org#25896,"PAPANGGO, TANJUNG PRIOK, JAKARTA UTARA, DKI JAKARTA",118,200,3,203
https://kawalpemilu.org#25896,"PAPANGGO, TANJUNG PRIOK, JAKARTA UTARA, DKI JAKARTA",119,196,12,208
https://kawalpemilu.org#25896,"PAPANGGO, TANJUNG PRIOK, JAKARTA UTARA, DKI JAKARTA",120,210,2,212
https://kawalpemilu.org#25896,"PAPANGGO, TANJUNG PRIOK, JAKARTA UTARA, DKI JAKARTA",121,203,6,209
https://kawalpemilu.org#25896,"PAPANGGO, TANJUNG PRIOK, JAKARTA UTARA, DKI JAKARTA",122,216,6,222
https://kawalpemilu.org#25896,"PAPANGGO, TANJUNG PRIOK, JAKARTA UTARA, DKI JAKARTA",123,181,6,187
https://kawalpemilu.org#25896,"PAPANGGO, TANJUNG PRIOK, JAKARTA UTARA, DKI JAKARTA",124,188,11,199
https://kawalpemilu.org#25896,"PAPANGGO, TANJUNG PRIOK, JAKARTA UTARA, DKI JAKARTA",125,184,10,194
https://kawalpemilu.org#25896,"PAPANGGO, TANJUNG PRIOK, JAKARTA UTARA, DKI JAKARTA",126,246,9,0
https://kawalpemilu.org#25896,"PAPANGGO, TANJUNG PRIOK, JAKARTA UTARA, DKI JAKARTA",127,155,29,184
https://kawalpemilu.org#25896,"PAPANGGO, TANJUNG PRIOK, JAKARTA UTARA, DKI JAKARTA",128,171,12,183
https://kawalpemilu.org#25897,"SUNGAI BAMBU, TANJUNG PRIOK, JAKARTA UTARA, DKI JAKARTA",1,110,91,201
https://kawalpemilu.org#25897,"SUNGAI BAMBU, TANJUNG PRIOK, JAKARTA UTARA, DKI JAKARTA",2,147,40,187
https://kawalpemilu.org#25897,"SUNGAI BAMBU, TANJUNG PRIOK, JAKARTA UTARA, DKI JAKARTA",3,110,112,222
https://kawalpemilu.org#25897,"SUNGAI BAMBU, TANJUNG PRIOK, JAKARTA UTARA, DKI JAKARTA",4,132,76,208
https://kawalpemilu.org#25897,"SUNGAI BAMBU, TANJUNG PRIOK, JAKARTA UTARA, DKI JAKARTA",5,100,95,195
https://kawalpemilu.org#25897,"SUNGAI BAMBU, TANJUNG PRIOK, JAKARTA UTARA, DKI JAKARTA",6,114,88,202
https://kawalpemilu.org#25897,"SUNGAI BAMBU, TANJUNG PRIOK, JAKARTA UTARA, DKI JAKARTA",7,148,27,175
https://kawalpemilu.org#25897,"SUNGAI BAMBU, TANJUNG PRIOK, JAKARTA UTARA, DKI JAKARTA",8,154,40,194
https://kawalpemilu.org#25897,"SUNGAI BAMBU, TANJUNG PRIOK, JAKARTA UTARA, DKI JAKARTA",9,130,90,220
https://kawalpemilu.org#25897,"SUNGAI BAMBU, TANJUNG PRIOK, JAKARTA UTARA, DKI JAKARTA",10,121,69,190
https://kawalpemilu.org#25897,"SUNGAI BAMBU, TANJUNG PRIOK, JAKARTA UTARA, DKI JAKARTA",11,134,66,200
https://kawalpemilu.org#25897,"SUNGAI BAMBU, TANJUNG PRIOK, JAKARTA UTARA, DKI JAKARTA",12,52,117,169
https://kawalpemilu.org#25897,"SUNGAI BAMBU, TANJUNG PRIOK, JAKARTA UTARA, DKI JAKARTA",13,76,87,163
https://kawalpemilu.org#25897,"SUNGAI BAMBU, TANJUNG PRIOK, JAKARTA UTARA, DKI JAKARTA",14,77,89,166
https://kawalpemilu.org#25897,"SUNGAI BAMBU, TANJUNG PRIOK, JAKARTA UTARA, DKI JAKARTA",15,101,102,203
https://kawalpemilu.org#25897,"SUNGAI BAMBU, TANJUNG PRIOK, JAKARTA UTARA, DKI JAKARTA",16,77,125,202
https://kawalpemilu.org#25897,"SUNGAI BAMBU, TANJUNG PRIOK, JAKARTA UTARA, DKI JAKARTA",17,156,51,207
https://kawalpemilu.org#25897,"SUNGAI BAMBU, TANJUNG PRIOK, JAKARTA UTARA, DKI JAKARTA",18,166,68,234
https://kawalpemilu.org#25897,"SUNGAI BAMBU, TANJUNG PRIOK, JAKARTA UTARA, DKI JAKARTA",19,81,92,173
https://kawalpemilu.org#25897,"SUNGAI BAMBU, TANJUNG PRIOK, JAKARTA UTARA, DKI JAKARTA",20,133,63,196
https://kawalpemilu.org#25897,"SUNGAI BAMBU, TANJUNG PRIOK, JAKARTA UTARA, DKI JAKARTA",21,136,37,173
https://kawalpemilu.org#25897,"SUNGAI BAMBU, TANJUNG PRIOK, JAKARTA UTARA, DKI JAKARTA",22,89,89,181
https://kawalpemilu.org#25897,"SUNGAI BAMBU, TANJUNG PRIOK, JAKARTA UTARA, DKI JAKARTA",23,142,69,211
https://kawalpemilu.org#25897,"SUNGAI BAMBU, TANJUNG PRIOK, JAKARTA UTARA, DKI JAKARTA",24,89,122,211
https://kawalpemilu.org#25897,"SUNGAI BAMBU, TANJUNG PRIOK, JAKARTA UTARA, DKI JAKARTA",25,145,71,216
https://kawalpemilu.org#25897,"SUNGAI BAMBU, TANJUNG PRIOK, JAKARTA UTARA, DKI JAKARTA",26,166,76,242
https://kawalpemilu.org#25897,"SUNGAI BAMBU, TANJUNG PRIOK, JAKARTA UTARA, DKI JAKARTA",27,84,112,196
https://kawalpemilu.org#25897,"SUNGAI BAMBU, TANJUNG PRIOK, JAKARTA UTARA, DKI JAKARTA",28,160,77,237
https://kawalpemilu.org#25897,"SUNGAI BAMBU, TANJUNG PRIOK, JAKARTA UTARA, DKI JAKARTA",29,78,118,196
https://kawalpemilu.org#25897,"SUNGAI BAMBU, TANJUNG PRIOK, JAKARTA UTARA, DKI JAKARTA",30,69,159,228
https://kawalpemilu.org#25897,"SUNGAI BAMBU, TANJUNG PRIOK, JAKARTA UTARA, DKI JAKARTA",31,106,120,226
https://kawalpemilu.org#25897,"SUNGAI BAMBU, TANJUNG PRIOK, JAKARTA UTARA, DKI JAKARTA",32,89,108,197
https://kawalpemilu.org#25897,"SUNGAI BAMBU, TANJUNG PRIOK, JAKARTA UTARA, DKI JAKARTA",33,160,63,223
https://kawalpemilu.org#25897,"SUNGAI BAMBU, TANJUNG PRIOK, JAKARTA UTARA, DKI JAKARTA",34,106,126,232
https://kawalpemilu.org#25897,"SUNGAI BAMBU, TANJUNG PRIOK, JAKARTA UTARA, DKI JAKARTA",35,144,88,232
https://kawalpemilu.org#25897,"SUNGAI BAMBU, TANJUNG PRIOK, JAKARTA UTARA, DKI JAKARTA",36,91,108,199
https://kawalpemilu.org#25897,"SUNGAI BAMBU, TANJUNG PRIOK, JAKARTA UTARA, DKI JAKARTA",37,126,82,208
https://kawalpemilu.org#25897,"SUNGAI BAMBU, TANJUNG PRIOK, JAKARTA UTARA, DKI JAKARTA",38,162,42,204
https://kawalpemilu.org#25897,"SUNGAI BAMBU, TANJUNG PRIOK, JAKARTA UTARA, DKI JAKARTA",39,150,69,219
https://kawalpemilu.org#25897,"SUNGAI BAMBU, TANJUNG PRIOK, JAKARTA UTARA, DKI JAKARTA",40,140,65,205
https://kawalpemilu.org#25897,"SUNGAI BAMBU, TANJUNG PRIOK, JAKARTA UTARA, DKI JAKARTA",41,143,45,188
https://kawalpemilu.org#25897,"SUNGAI BAMBU, TANJUNG PRIOK, JAKARTA UTARA, DKI JAKARTA",42,112,93,205
https://kawalpemilu.org#25897,"SUNGAI BAMBU, TANJUNG PRIOK, JAKARTA UTARA, DKI JAKARTA",43,127,66,193
https://kawalpemilu.org#25897,"SUNGAI BAMBU, TANJUNG PRIOK, JAKARTA UTARA, DKI JAKARTA",44,110,98,208
https://kawalpemilu.org#25897,"SUNGAI BAMBU, TANJUNG PRIOK, JAKARTA UTARA, DKI JAKARTA",45,80,118,198
https://kawalpemilu.org#25897,"SUNGAI BAMBU, TANJUNG PRIOK, JAKARTA UTARA, DKI JAKARTA",46,63,134,197
https://kawalpemilu.org#25897,"SUNGAI BAMBU, TANJUNG PRIOK, JAKARTA UTARA, DKI JAKARTA",47,83,91,174
https://kawalpemilu.org#25897,"SUNGAI BAMBU, TANJUNG PRIOK, JAKARTA UTARA, DKI JAKARTA",48,124,80,204
https://kawalpemilu.org#25897,"SUNGAI BAMBU, TANJUNG PRIOK, JAKARTA UTARA, DKI JAKARTA",49,91,89,180
https://kawalpemilu.org#25897,"SUNGAI BAMBU, TANJUNG PRIOK, JAKARTA UTARA, DKI JAKARTA",50,74,113,187
https://kawalpemilu.org#25897,"SUNGAI BAMBU, TANJUNG PRIOK, JAKARTA UTARA, DKI JAKARTA",51,100,96,196
https://kawalpemilu.org#25897,"SUNGAI BAMBU, TANJUNG PRIOK, JAKARTA UTARA, DKI JAKARTA",52,65,114,179
https://kawalpemilu.org#25897,"SUNGAI BAMBU, TANJUNG PRIOK, JAKARTA UTARA, DKI JAKARTA",53,97,83,180
https://kawalpemilu.org#25897,"SUNGAI BAMBU, TANJUNG PRIOK, JAKARTA UTARA, DKI JAKARTA",54,81,145,226
https://kawalpemilu.org#25897,"SUNGAI BAMBU, TANJUNG PRIOK, JAKARTA UTARA, DKI JAKARTA",55,117,96,213
https://kawalpemilu.org#25897,"SUNGAI BAMBU, TANJUNG PRIOK, JAKARTA UTARA, DKI JAKARTA",56,114,122,236
https://kawalpemilu.org#25897,"SUNGAI BAMBU, TANJUNG PRIOK, JAKARTA UTARA, DKI JAKARTA",57,129,121,250
https://kawalpemilu.org#25897,"SUNGAI BAMBU, TANJUNG PRIOK, JAKARTA UTARA, DKI JAKARTA",58,111,92,203
https://kawalpemilu.org#25897,"SUNGAI BAMBU, TANJUNG PRIOK, JAKARTA UTARA, DKI JAKARTA",59,110,94,204
https://kawalpemilu.org#25897,"SUNGAI BAMBU, TANJUNG PRIOK, JAKARTA UTARA, DKI JAKARTA",60,89,96,185
https://kawalpemilu.org#25897,"SUNGAI BAMBU, TANJUNG PRIOK, JAKARTA UTARA, DKI JAKARTA",61,97,136,233
https://kawalpemilu.org#25897,"SUNGAI BAMBU, TANJUNG PRIOK, JAKARTA UTARA, DKI JAKARTA",62,80,141,221
https://kawalpemilu.org#25897,"SUNGAI BAMBU, TANJUNG PRIOK, JAKARTA UTARA, DKI JAKARTA",63,109,137,246
https://kawalpemilu.org#25897,"SUNGAI BAMBU, TANJUNG PRIOK, JAKARTA UTARA, DKI JAKARTA",64,78,162,240
https://kawalpemilu.org#25897,"SUNGAI BAMBU, TANJUNG PRIOK, JAKARTA UTARA, DKI JAKARTA",65,61,133,194
https://kawalpemilu.org#25897,"SUNGAI BAMBU, TANJUNG PRIOK, JAKARTA UTARA, DKI JAKARTA",66,95,146,241
https://kawalpemilu.org#25897,"SUNGAI BAMBU, TANJUNG PRIOK, JAKARTA UTARA, DKI JAKARTA",67,100,163,263
https://kawalpemilu.org#25897,"SUNGAI BAMBU, TANJUNG PRIOK, JAKARTA UTARA, DKI JAKARTA",68,111,132,243
https://kawalpemilu.org#25897,"SUNGAI BAMBU, TANJUNG PRIOK, JAKARTA UTARA, DKI JAKARTA",69,83,167,250
https://kawalpemilu.org#25897,"SUNGAI BAMBU, TANJUNG PRIOK, JAKARTA UTARA, DKI JAKARTA",70,103,122,225
https://kawalpemilu.org#25897,"SUNGAI BAMBU, TANJUNG PRIOK, JAKARTA UTARA, DKI JAKARTA",71,113,117,230
https://kawalpemilu.org#25897,"SUNGAI BAMBU, TANJUNG PRIOK, JAKARTA UTARA, DKI JAKARTA",72,133,94,227
https://kawalpemilu.org#25897,"SUNGAI BAMBU, TANJUNG PRIOK, JAKARTA UTARA, DKI JAKARTA",73,93,106,199
https://kawalpemilu.org#25897,"SUNGAI BAMBU, TANJUNG PRIOK, JAKARTA UTARA, DKI JAKARTA",74,66,154,220
https://kawalpemilu.org#25897,"SUNGAI BAMBU, TANJUNG PRIOK, JAKARTA UTARA, DKI JAKARTA",75,96,128,224
https://kawalpemilu.org#25897,"SUNGAI BAMBU, TANJUNG PRIOK, JAKARTA UTARA, DKI JAKARTA",76,97,89,186
https://kawalpemilu.org#25897,"SUNGAI BAMBU, TANJUNG PRIOK, JAKARTA UTARA, DKI JAKARTA",77,86,139,225
https://kawalpemilu.org#25897,"SUNGAI BAMBU, TANJUNG PRIOK, JAKARTA UTARA, DKI JAKARTA",78,129,93,222
https://kawalpemilu.org#25897,"SUNGAI BAMBU, TANJUNG PRIOK, JAKARTA UTARA, DKI JAKARTA",79,135,72,207
https://kawalpemilu.org#25897,"SUNGAI BAMBU, TANJUNG PRIOK, JAKARTA UTARA, DKI JAKARTA",80,79,96,175
https://kawalpemilu.org#25897,"SUNGAI BAMBU, TANJUNG PRIOK, JAKARTA UTARA, DKI JAKARTA",81,130,86,216
https://kawalpemilu.org#25897,"SUNGAI BAMBU, TANJUNG PRIOK, JAKARTA UTARA, DKI JAKARTA",82,108,106,214
https://kawalpemilu.org#25897,"SUNGAI BAMBU, TANJUNG PRIOK, JAKARTA UTARA, DKI JAKARTA",83,110,77,187
https://kawalpemilu.org#25897,"SUNGAI BAMBU, TANJUNG PRIOK, JAKARTA UTARA, DKI JAKARTA",84,121,109,230
https://kawalpemilu.org#25897,"SUNGAI BAMBU, TANJUNG PRIOK, JAKARTA UTARA, DKI JAKARTA",85,88,57,145
https://kawalpemilu.org#25897,"SUNGAI BAMBU, TANJUNG PRIOK, JAKARTA UTARA, DKI JAKARTA",86,64,94,158
https://kawalpemilu.org#25897,"SUNGAI BAMBU, TANJUNG PRIOK, JAKARTA UTARA, DKI JAKARTA",87,97,112,209
https://kawalpemilu.org#25897,"SUNGAI BAMBU, TANJUNG PRIOK, JAKARTA UTARA, DKI JAKARTA",88,79,130,209
https://kawalpemilu.org#25897,"SUNGAI BAMBU, TANJUNG PRIOK, JAKARTA UTARA, DKI JAKARTA",89,97,100,197
https://kawalpemilu.org#25897,"SUNGAI BAMBU, TANJUNG PRIOK, JAKARTA UTARA, DKI JAKARTA",90,95,120,215
https://kawalpemilu.org#25897,"SUNGAI BAMBU, TANJUNG PRIOK, JAKARTA UTARA, DKI JAKARTA",91,107,96,203
https://kawalpemilu.org#25897,"SUNGAI BAMBU, TANJUNG PRIOK, JAKARTA UTARA, DKI JAKARTA",92,112,126,238
https://kawalpemilu.org#25897,"SUNGAI BAMBU, TANJUNG PRIOK, JAKARTA UTARA, DKI JAKARTA",93,117,134,251
https://kawalpemilu.org#25897,"SUNGAI BAMBU, TANJUNG PRIOK, JAKARTA UTARA, DKI JAKARTA",94,117,124,241
https://kawalpemilu.org#25897,"SUNGAI BAMBU, TANJUNG PRIOK, JAKARTA UTARA, DKI JAKARTA",95,98,81,179
https://kawalpemilu.org#25897,"SUNGAI BAMBU, TANJUNG PRIOK, JAKARTA UTARA, DKI JAKARTA",96,113,104,217
https://kawalpemilu.org#25897,"SUNGAI BAMBU, TANJUNG PRIOK, JAKARTA UTARA, DKI JAKARTA",97,102,117,219
https://kawalpemilu.org#25897,"SUNGAI BAMBU, TANJUNG PRIOK, JAKARTA UTARA, DKI JAKARTA",98,66,118,184
https://kawalpemilu.org#25898,"KEBON BAWANG, TANJUNG PRIOK, JAKARTA UTARA, DKI JAKARTA",1,122,118,240
https://kawalpemilu.org#25898,"KEBON BAWANG, TANJUNG PRIOK, JAKARTA UTARA, DKI JAKARTA",2,76,153,229
https://kawalpemilu.org#25898,"KEBON BAWANG, TANJUNG PRIOK, JAKARTA UTARA, DKI JAKARTA",3,13,199,212
https://kawalpemilu.org#25898,"KEBON BAWANG, TANJUNG PRIOK, JAKARTA UTARA, DKI JAKARTA",4,27,183,210
https://kawalpemilu.org#25898,"KEBON BAWANG, TANJUNG PRIOK, JAKARTA UTARA, DKI JAKARTA",5,104,115,219
https://kawalpemilu.org#25898,"KEBON BAWANG, TANJUNG PRIOK, JAKARTA UTARA, DKI JAKARTA",6,112,86,198
https://kawalpemilu.org#25898,"KEBON BAWANG, TANJUNG PRIOK, JAKARTA UTARA, DKI JAKARTA",7,130,101,231
https://kawalpemilu.org#25898,"KEBON BAWANG, TANJUNG PRIOK, JAKARTA UTARA, DKI JAKARTA",8,88,116,204
https://kawalpemilu.org#25898,"KEBON BAWANG, TANJUNG PRIOK, JAKARTA UTARA, DKI JAKARTA",9,96,124,220
https://kawalpemilu.org#25898,"KEBON BAWANG, TANJUNG PRIOK, JAKARTA UTARA, DKI JAKARTA",10,88,129,217
https://kawalpemilu.org#25898,"KEBON BAWANG, TANJUNG PRIOK, JAKARTA UTARA, DKI JAKARTA",11,98,120,218
https://kawalpemilu.org#25898,"KEBON BAWANG, TANJUNG PRIOK, JAKARTA UTARA, DKI JAKARTA",12,109,96,205
https://kawalpemilu.org#25898,"KEBON BAWANG, TANJUNG PRIOK, JAKARTA UTARA, DKI JAKARTA",13,147,67,214
https://kawalpemilu.org#25898,"KEBON BAWANG, TANJUNG PRIOK, JAKARTA UTARA, DKI JAKARTA",14,87,116,203
https://kawalpemilu.org#25898,"KEBON BAWANG, TANJUNG PRIOK, JAKARTA UTARA, DKI JAKARTA",15,100,107,207
https://kawalpemilu.org#25898,"KEBON BAWANG, TANJUNG PRIOK, JAKARTA UTARA, DKI JAKARTA",16,111,117,228
https://kawalpemilu.org#25898,"KEBON BAWANG, TANJUNG PRIOK, JAKARTA UTARA, DKI JAKARTA",17,84,107,191
https://kawalpemilu.org#25898,"KEBON BAWANG, TANJUNG PRIOK, JAKARTA UTARA, DKI JAKARTA",18,86,91,177
https://kawalpemilu.org#25898,"KEBON BAWANG, TANJUNG PRIOK, JAKARTA UTARA, DKI JAKARTA",19,54,111,165
https://kawalpemilu.org#25898,"KEBON BAWANG, TANJUNG PRIOK, JAKARTA UTARA, DKI JAKARTA",20,97,121,218
https://kawalpemilu.org#25898,"KEBON BAWANG, TANJUNG PRIOK, JAKARTA UTARA, DKI JAKARTA",21,115,100,215
https://kawalpemilu.org#25898,"KEBON BAWANG, TANJUNG PRIOK, JAKARTA UTARA, DKI JAKARTA",22,131,91,222
https://kawalpemilu.org#25898,"KEBON BAWANG, TANJUNG PRIOK, JAKARTA UTARA, DKI JAKARTA",23,107,118,225
https://kawalpemilu.org#25898,"KEBON BAWANG, TANJUNG PRIOK, JAKARTA UTARA, DKI JAKARTA",24,78,148,226
https://kawalpemilu.org#25898,"KEBON BAWANG, TANJUNG PRIOK, JAKARTA UTARA, DKI JAKARTA",25,68,100,168
https://kawalpemilu.org#25898,"KEBON BAWANG, TANJUNG PRIOK, JAKARTA UTARA, DKI JAKARTA",26,72,131,203
https://kawalpemilu.org#25898,"KEBON BAWANG, TANJUNG PRIOK, JAKARTA UTARA, DKI JAKARTA",27,107,110,217
https://kawalpemilu.org#25898,"KEBON BAWANG, TANJUNG PRIOK, JAKARTA UTARA, DKI JAKARTA",28,78,123,201
https://kawalpemilu.org#25898,"KEBON BAWANG, TANJUNG PRIOK, JAKARTA UTARA, DKI JAKARTA",29,113,113,226
https://kawalpemilu.org#25898,"KEBON BAWANG, TANJUNG PRIOK, JAKARTA UTARA, DKI JAKARTA",30,59,176,235
https://kawalpemilu.org#25898,"KEBON BAWANG, TANJUNG PRIOK, JAKARTA UTARA, DKI JAKARTA",31,108,102,210
https://kawalpemilu.org#25898,"KEBON BAWANG, TANJUNG PRIOK, JAKARTA UTARA, DKI JAKARTA",32,93,94,187
https://kawalpemilu.org#25898,"KEBON BAWANG, TANJUNG PRIOK, JAKARTA UTARA, DKI JAKARTA",33,93,119,212
https://kawalpemilu.org#25898,"KEBON BAWANG, TANJUNG PRIOK, JAKARTA UTARA, DKI JAKARTA",34,84,140,224
https://kawalpemilu.org#25898,"KEBON BAWANG, TANJUNG PRIOK, JAKARTA UTARA, DKI JAKARTA",35,86,81,167
https://kawalpemilu.org#25898,"KEBON BAWANG, TANJUNG PRIOK, JAKARTA UTARA, DKI JAKARTA",36,78,113,191
https://kawalpemilu.org#25898,"KEBON BAWANG, TANJUNG PRIOK, JAKARTA UTARA, DKI JAKARTA",37,134,71,205
https://kawalpemilu.org#25898,"KEBON BAWANG, TANJUNG PRIOK, JAKARTA UTARA, DKI JAKARTA",38,113,101,214
https://kawalpemilu.org#25898,"KEBON BAWANG, TANJUNG PRIOK, JAKARTA UTARA, DKI JAKARTA",39,151,64,215
https://kawalpemilu.org#25898,"KEBON BAWANG, TANJUNG PRIOK, JAKARTA UTARA, DKI JAKARTA",40,106,55,161
https://kawalpemilu.org#25898,"KEBON BAWANG, TANJUNG PRIOK, JAKARTA UTARA, DKI JAKARTA",41,92,120,212
https://kawalpemilu.org#25898,"KEBON BAWANG, TANJUNG PRIOK, JAKARTA UTARA, DKI JAKARTA",42,92,141,233
https://kawalpemilu.org#25898,"KEBON BAWANG, TANJUNG PRIOK, JAKARTA UTARA, DKI JAKARTA",43,117,99,216
https://kawalpemilu.org#25898,"KEBON BAWANG, TANJUNG PRIOK, JAKARTA UTARA, DKI JAKARTA",44,105,113,218
https://kawalpemilu.org#25898,"KEBON BAWANG, TANJUNG PRIOK, JAKARTA UTARA, DKI JAKARTA",45,126,108,234
https://kawalpemilu.org#25898,"KEBON BAWANG, TANJUNG PRIOK, JAKARTA UTARA, DKI JAKARTA",46,101,124,225
https://kawalpemilu.org#25898,"KEBON BAWANG, TANJUNG PRIOK, JAKARTA UTARA, DKI JAKARTA",47,113,127,240
https://kawalpemilu.org#25898,"KEBON BAWANG, TANJUNG PRIOK, JAKARTA UTARA, DKI JAKARTA",48,100,119,219
https://kawalpemilu.org#25898,"KEBON BAWANG, TANJUNG PRIOK, JAKARTA UTARA, DKI JAKARTA",49,112,125,237
https://kawalpemilu.org#25898,"KEBON BAWANG, TANJUNG PRIOK, JAKARTA UTARA, DKI JAKARTA",50,79,140,219
https://kawalpemilu.org#25898,"KEBON BAWANG, TANJUNG PRIOK, JAKARTA UTARA, DKI JAKARTA",51,109,114,223
https://kawalpemilu.org#25898,"KEBON BAWANG, TANJUNG PRIOK, JAKARTA UTARA, DKI JAKARTA",52,115,122,237
https://kawalpemilu.org#25898,"KEBON BAWANG, TANJUNG PRIOK, JAKARTA UTARA, DKI JAKARTA",53,101,98,199
https://kawalpemilu.org#25898,"KEBON BAWANG, TANJUNG PRIOK, JAKARTA UTARA, DKI JAKARTA",54,105,136,241
https://kawalpemilu.org#25898,"KEBON BAWANG, TANJUNG PRIOK, JAKARTA UTARA, DKI JAKARTA",55,100,129,229
https://kawalpemilu.org#25898,"KEBON BAWANG, TANJUNG PRIOK, JAKARTA UTARA, DKI JAKARTA",56,135,88,223
https://kawalpemilu.org#25898,"KEBON BAWANG, TANJUNG PRIOK, JAKARTA UTARA, DKI JAKARTA",57,129,84,213
https://kawalpemilu.org#25898,"KEBON BAWANG, TANJUNG PRIOK, JAKARTA UTARA, DKI JAKARTA",58,116,98,214
https://kawalpemilu.org#25898,"KEBON BAWANG, TANJUNG PRIOK, JAKARTA UTARA, DKI JAKARTA",59,112,122,234
https://kawalpemilu.org#25898,"KEBON BAWANG, TANJUNG PRIOK, JAKARTA UTARA, DKI JAKARTA",60,109,126,235
https://kawalpemilu.org#25898,"KEBON BAWANG, TANJUNG PRIOK, JAKARTA UTARA, DKI JAKARTA",61,132,85,217
https://kawalpemilu.org#25898,"KEBON BAWANG, TANJUNG PRIOK, JAKARTA UTARA, DKI JAKARTA",62,122,129,251
https://kawalpemilu.org#25898,"KEBON BAWANG, TANJUNG PRIOK, JAKARTA UTARA, DKI JAKARTA",63,98,149,247
https://kawalpemilu.org#25898,"KEBON BAWANG, TANJUNG PRIOK, JAKARTA UTARA, DKI JAKARTA",64,133,89,222
https://kawalpemilu.org#25898,"KEBON BAWANG, TANJUNG PRIOK, JAKARTA UTARA, DKI JAKARTA",65,115,88,203
https://kawalpemilu.org#25898,"KEBON BAWANG, TANJUNG PRIOK, JAKARTA UTARA, DKI JAKARTA",66,107,119,226
https://kawalpemilu.org#25898,"KEBON BAWANG, TANJUNG PRIOK, JAKARTA UTARA, DKI JAKARTA",67,104,131,235
https://kawalpemilu.org#25898,"KEBON BAWANG, TANJUNG PRIOK, JAKARTA UTARA, DKI JAKARTA",68,87,152,239
https://kawalpemilu.org#25898,"KEBON BAWANG, TANJUNG PRIOK, JAKARTA UTARA, DKI JAKARTA",69,78,127,205
https://kawalpemilu.org#25898,"KEBON BAWANG, TANJUNG PRIOK, JAKARTA UTARA, DKI JAKARTA",70,66,111,177
https://kawalpemilu.org#25898,"KEBON BAWANG, TANJUNG PRIOK, JAKARTA UTARA, DKI JAKARTA",71,127,99,226
https://kawalpemilu.org#25898,"KEBON BAWANG, TANJUNG PRIOK, JAKARTA UTARA, DKI JAKARTA",72,147,67,214
https://kawalpemilu.org#25898,"KEBON BAWANG, TANJUNG PRIOK, JAKARTA UTARA, DKI JAKARTA",73,104,122,226
https://kawalpemilu.org#25898,"KEBON BAWANG, TANJUNG PRIOK, JAKARTA UTARA, DKI JAKARTA",74,125,89,214
https://kawalpemilu.org#25898,"KEBON BAWANG, TANJUNG PRIOK, JAKARTA UTARA, DKI JAKARTA",75,92,125,217
https://kawalpemilu.org#25898,"KEBON BAWANG, TANJUNG PRIOK, JAKARTA UTARA, DKI JAKARTA",76,99,129,228
https://kawalpemilu.org#25898,"KEBON BAWANG, TANJUNG PRIOK, JAKARTA UTARA, DKI JAKARTA",77,109,146,255
https://kawalpemilu.org#25898,"KEBON BAWANG, TANJUNG PRIOK, JAKARTA UTARA, DKI JAKARTA",78,90,106,196
https://kawalpemilu.org#25898,"KEBON BAWANG, TANJUNG PRIOK, JAKARTA UTARA, DKI JAKARTA",79,139,92,231
https://kawalpemilu.org#25898,"KEBON BAWANG, TANJUNG PRIOK, JAKARTA UTARA, DKI JAKARTA",80,147,95,242
https://kawalpemilu.org#25898,"KEBON BAWANG, TANJUNG PRIOK, JAKARTA UTARA, DKI JAKARTA",81,88,119,207
https://kawalpemilu.org#25898,"KEBON BAWANG, TANJUNG PRIOK, JAKARTA UTARA, DKI JAKARTA",82,90,128,218
https://kawalpemilu.org#25898,"KEBON BAWANG, TANJUNG PRIOK, JAKARTA UTARA, DKI JAKARTA",83,116,101,217
https://kawalpemilu.org#25898,"KEBON BAWANG, TANJUNG PRIOK, JAKARTA UTARA, DKI JAKARTA",84,95,115,210
https://kawalpemilu.org#25898,"KEBON BAWANG, TANJUNG PRIOK, JAKARTA UTARA, DKI JAKARTA",85,88,153,241
https://kawalpemilu.org#25898,"KEBON BAWANG, TANJUNG PRIOK, JAKARTA UTARA, DKI JAKARTA",86,89,144,233
https://kawalpemilu.org#25898,"KEBON BAWANG, TANJUNG PRIOK, JAKARTA UTARA, DKI JAKARTA",87,70,144,214
https://kawalpemilu.org#25898,"KEBON BAWANG, TANJUNG PRIOK, JAKARTA UTARA, DKI JAKARTA",88,148,87,235
https://kawalpemilu.org#25898,"KEBON BAWANG, TANJUNG PRIOK, JAKARTA UTARA, DKI JAKARTA",89,58,106,164
https://kawalpemilu.org#25898,"KEBON BAWANG, TANJUNG PRIOK, JAKARTA UTARA, DKI JAKARTA",90,104,135,239
https://kawalpemilu.org#25898,"KEBON BAWANG, TANJUNG PRIOK, JAKARTA UTARA, DKI JAKARTA",91,97,131,228
https://kawalpemilu.org#25898,"KEBON BAWANG, TANJUNG PRIOK, JAKARTA UTARA, DKI JAKARTA",92,103,108,211
https://kawalpemilu.org#25898,"KEBON BAWANG, TANJUNG PRIOK, JAKARTA UTARA, DKI JAKARTA",93,77,113,190
https://kawalpemilu.org#25898,"KEBON BAWANG, TANJUNG PRIOK, JAKARTA UTARA, DKI JAKARTA",94,74,121,195
https://kawalpemilu.org#25898,"KEBON BAWANG, TANJUNG PRIOK, JAKARTA UTARA, DKI JAKARTA",95,105,103,208
https://kawalpemilu.org#25898,"KEBON BAWANG, TANJUNG PRIOK, JAKARTA UTARA, DKI JAKARTA",96,95,116,211
https://kawalpemilu.org#25898,"KEBON BAWANG, TANJUNG PRIOK, JAKARTA UTARA, DKI JAKARTA",97,125,85,210
https://kawalpemilu.org#25898,"KEBON BAWANG, TANJUNG PRIOK, JAKARTA UTARA, DKI JAKARTA",98,94,145,239
https://kawalpemilu.org#25898,"KEBON BAWANG, TANJUNG PRIOK, JAKARTA UTARA, DKI JAKARTA",99,82,105,187
https://kawalpemilu.org#25898,"KEBON BAWANG, TANJUNG PRIOK, JAKARTA UTARA, DKI JAKARTA",100,176,57,233
https://kawalpemilu.org#25898,"KEBON BAWANG, TANJUNG PRIOK, JAKARTA UTARA, DKI JAKARTA",101,123,95,218
https://kawalpemilu.org#25898,"KEBON BAWANG, TANJUNG PRIOK, JAKARTA UTARA, DKI JAKARTA",102,110,121,231
https://kawalpemilu.org#25898,"KEBON BAWANG, TANJUNG PRIOK, JAKARTA UTARA, DKI JAKARTA",103,115,132,247
https://kawalpemilu.org#25898,"KEBON BAWANG, TANJUNG PRIOK, JAKARTA UTARA, DKI JAKARTA",104,160,81,241
https://kawalpemilu.org#25898,"KEBON BAWANG, TANJUNG PRIOK, JAKARTA UTARA, DKI JAKARTA",105,118,124,242
https://kawalpemilu.org#25898,"KEBON BAWANG, TANJUNG PRIOK, JAKARTA UTARA, DKI JAKARTA",106,108,121,229
https://kawalpemilu.org#25898,"KEBON BAWANG, TANJUNG PRIOK, JAKARTA UTARA, DKI JAKARTA",107,150,60,210
https://kawalpemilu.org#25898,"KEBON BAWANG, TANJUNG PRIOK, JAKARTA UTARA, DKI JAKARTA",108,107,116,223
https://kawalpemilu.org#25898,"KEBON BAWANG, TANJUNG PRIOK, JAKARTA UTARA, DKI JAKARTA",109,92,143,240
https://kawalpemilu.org#25898,"KEBON BAWANG, TANJUNG PRIOK, JAKARTA UTARA, DKI JAKARTA",110,110,102,212
https://kawalpemilu.org#25898,"KEBON BAWANG, TANJUNG PRIOK, JAKARTA UTARA, DKI JAKARTA",111,126,92,218
https://kawalpemilu.org#25898,"KEBON BAWANG, TANJUNG PRIOK, JAKARTA UTARA, DKI JAKARTA",112,144,115,259
https://kawalpemilu.org#25898,"KEBON BAWANG, TANJUNG PRIOK, JAKARTA UTARA, DKI JAKARTA",113,158,84,242
https://kawalpemilu.org#25898,"KEBON BAWANG, TANJUNG PRIOK, JAKARTA UTARA, DKI JAKARTA",114,125,118,243
https://kawalpemilu.org#25898,"KEBON BAWANG, TANJUNG PRIOK, JAKARTA UTARA, DKI JAKARTA",115,108,111,219
https://kawalpemilu.org#25898,"KEBON BAWANG, TANJUNG PRIOK, JAKARTA UTARA, DKI JAKARTA",116,111,94,205
https://kawalpemilu.org#25898,"KEBON BAWANG, TANJUNG PRIOK, JAKARTA UTARA, DKI JAKARTA",117,136,106,242
https://kawalpemilu.org#25898,"KEBON BAWANG, TANJUNG PRIOK, JAKARTA UTARA, DKI JAKARTA",118,140,51,191
https://kawalpemilu.org#25898,"KEBON BAWANG, TANJUNG PRIOK, JAKARTA UTARA, DKI JAKARTA",119,138,91,229
https://kawalpemilu.org#25898,"KEBON BAWANG, TANJUNG PRIOK, JAKARTA UTARA, DKI JAKARTA",120,112,133,245
https://kawalpemilu.org#25898,"KEBON BAWANG, TANJUNG PRIOK, JAKARTA UTARA, DKI JAKARTA",121,162,72,234
https://kawalpemilu.org#25898,"KEBON BAWANG, TANJUNG PRIOK, JAKARTA UTARA, DKI JAKARTA",122,129,70,199
https://kawalpemilu.org#25898,"KEBON BAWANG, TANJUNG PRIOK, JAKARTA UTARA, DKI JAKARTA",123,155,73,228
https://kawalpemilu.org#25898,"KEBON BAWANG, TANJUNG PRIOK, JAKARTA UTARA, DKI JAKARTA",124,152,66,218
https://kawalpemilu.org#25898,"KEBON BAWANG, TANJUNG PRIOK, JAKARTA UTARA, DKI JAKARTA",125,145,84,229
https://kawalpemilu.org#25898,"KEBON BAWANG, TANJUNG PRIOK, JAKARTA UTARA, DKI JAKARTA",126,132,35,167
https://kawalpemilu.org#25898,"KEBON BAWANG, TANJUNG PRIOK, JAKARTA UTARA, DKI JAKARTA",127,104,150,254
https://kawalpemilu.org#25898,"KEBON BAWANG, TANJUNG PRIOK, JAKARTA UTARA, DKI JAKARTA",128,87,140,227
https://kawalpemilu.org#25898,"KEBON BAWANG, TANJUNG PRIOK, JAKARTA UTARA, DKI JAKARTA",129,83,165,248
https://kawalpemilu.org#25898,"KEBON BAWANG, TANJUNG PRIOK, JAKARTA UTARA, DKI JAKARTA",130,128,104,232
https://kawalpemilu.org#25898,"KEBON BAWANG, TANJUNG PRIOK, JAKARTA UTARA, DKI JAKARTA",131,110,101,211
https://kawalpemilu.org#25898,"KEBON BAWANG, TANJUNG PRIOK, JAKARTA UTARA, DKI JAKARTA",132,93,136,229
https://kawalpemilu.org#25898,"KEBON BAWANG, TANJUNG PRIOK, JAKARTA UTARA, DKI JAKARTA",133,136,87,223
https://kawalpemilu.org#25898,"KEBON BAWANG, TANJUNG PRIOK, JAKARTA UTARA, DKI JAKARTA",134,80,105,185
https://kawalpemilu.org#25898,"KEBON BAWANG, TANJUNG PRIOK, JAKARTA UTARA, DKI JAKARTA",135,90,146,236
https://kawalpemilu.org#25898,"KEBON BAWANG, TANJUNG PRIOK, JAKARTA UTARA, DKI JAKARTA",137,104,58,162
https://kawalpemilu.org#25898,"KEBON BAWANG, TANJUNG PRIOK, JAKARTA UTARA, DKI JAKARTA",138,119,139,258
https://kawalpemilu.org#25898,"KEBON BAWANG, TANJUNG PRIOK, JAKARTA UTARA, DKI JAKARTA",139,130,117,247
https://kawalpemilu.org#25898,"KEBON BAWANG, TANJUNG PRIOK, JAKARTA UTARA, DKI JAKARTA",141,127,114,241
https://kawalpemilu.org#25898,"KEBON BAWANG, TANJUNG PRIOK, JAKARTA UTARA, DKI JAKARTA",142,130,115,245
https://kawalpemilu.org#25898,"KEBON BAWANG, TANJUNG PRIOK, JAKARTA UTARA, DKI JAKARTA",143,84,140,224
https://kawalpemilu.org#25898,"KEBON BAWANG, TANJUNG PRIOK, JAKARTA UTARA, DKI JAKARTA",144,132,106,238
https://kawalpemilu.org#25898,"KEBON BAWANG, TANJUNG PRIOK, JAKARTA UTARA, DKI JAKARTA",145,66,142,208
https://kawalpemilu.org#25898,"KEBON BAWANG, TANJUNG PRIOK, JAKARTA UTARA, DKI JAKARTA",146,100,123,223
https://kawalpemilu.org#25898,"KEBON BAWANG, TANJUNG PRIOK, JAKARTA UTARA, DKI JAKARTA",147,116,71,187
https://kawalpemilu.org#25898,"KEBON BAWANG, TANJUNG PRIOK, JAKARTA UTARA, DKI JAKARTA",148,92,82,174
https://kawalpemilu.org#25898,"KEBON BAWANG, TANJUNG PRIOK, JAKARTA UTARA, DKI JAKARTA",150,79,97,176
https://kawalpemilu.org#25898,"KEBON BAWANG, TANJUNG PRIOK, JAKARTA UTARA, DKI JAKARTA",151,0,0,0
https://kawalpemilu.org#25898,"KEBON BAWANG, TANJUNG PRIOK, JAKARTA UTARA, DKI JAKARTA",153,93,66,159
https://kawalpemilu.org#25898,"KEBON BAWANG, TANJUNG PRIOK, JAKARTA UTARA, DKI JAKARTA",154,60,65,125
https://kawalpemilu.org#25898,"KEBON BAWANG, TANJUNG PRIOK, JAKARTA UTARA, DKI JAKARTA",156,63,53,116
https://kawalpemilu.org#25898,"KEBON BAWANG, TANJUNG PRIOK, JAKARTA UTARA, DKI JAKARTA",157,80,65,145
https://kawalpemilu.org#25898,"KEBON BAWANG, TANJUNG PRIOK, JAKARTA UTARA, DKI JAKARTA",158,85,84,169
https://kawalpemilu.org#25899,"SUNTER AGUNG, TANJUNG PRIOK, JAKARTA UTARA, DKI JAKARTA",1,128,94,222
https://kawalpemilu.org#25899,"SUNTER AGUNG, TANJUNG PRIOK, JAKARTA UTARA, DKI JAKARTA",2,114,103,217
https://kawalpemilu.org#25899,"SUNTER AGUNG, TANJUNG PRIOK, JAKARTA UTARA, DKI JAKARTA",3,138,84,222
https://kawalpemilu.org#25899,"SUNTER AGUNG, TANJUNG PRIOK, JAKARTA UTARA, DKI JAKARTA",4,134,74,208
https://kawalpemilu.org#25899,"SUNTER AGUNG, TANJUNG PRIOK, JAKARTA UTARA, DKI JAKARTA",5,144,74,218
https://kawalpemilu.org#25899,"SUNTER AGUNG, TANJUNG PRIOK, JAKARTA UTARA, DKI JAKARTA",6,108,78,186
https://kawalpemilu.org#25899,"SUNTER AGUNG, TANJUNG PRIOK, JAKARTA UTARA, DKI JAKARTA",7,108,81,189
https://kawalpemilu.org#25899,"SUNTER AGUNG, TANJUNG PRIOK, JAKARTA UTARA, DKI JAKARTA",8,131,81,227
https://kawalpemilu.org#25899,"SUNTER AGUNG, TANJUNG PRIOK, JAKARTA UTARA, DKI JAKARTA",9,140,69,209
https://kawalpemilu.org#25899,"SUNTER AGUNG, TANJUNG PRIOK, JAKARTA UTARA, DKI JAKARTA",10,164,112,276
https://kawalpemilu.org#25899,"SUNTER AGUNG, TANJUNG PRIOK, JAKARTA UTARA, DKI JAKARTA",11,186,66,252
https://kawalpemilu.org#25899,"SUNTER AGUNG, TANJUNG PRIOK, JAKARTA UTARA, DKI JAKARTA",12,158,83,241
https://kawalpemilu.org#25899,"SUNTER AGUNG, TANJUNG PRIOK, JAKARTA UTARA, DKI JAKARTA",13,169,76,245
https://kawalpemilu.org#25899,"SUNTER AGUNG, TANJUNG PRIOK, JAKARTA UTARA, DKI JAKARTA",14,188,83,271
https://kawalpemilu.org#25899,"SUNTER AGUNG, TANJUNG PRIOK, JAKARTA UTARA, DKI JAKARTA",15,143,108,251
https://kawalpemilu.org#25899,"SUNTER AGUNG, TANJUNG PRIOK, JAKARTA UTARA, DKI JAKARTA",16,125,92,217
https://kawalpemilu.org#25899,"SUNTER AGUNG, TANJUNG PRIOK, JAKARTA UTARA, DKI JAKARTA",17,129,72,201
https://kawalpemilu.org#25899,"SUNTER AGUNG, TANJUNG PRIOK, JAKARTA UTARA, DKI JAKARTA",18,178,57,235
https://kawalpemilu.org#25899,"SUNTER AGUNG, TANJUNG PRIOK, JAKARTA UTARA, DKI JAKARTA",19,150,95,245
https://kawalpemilu.org#25899,"SUNTER AGUNG, TANJUNG PRIOK, JAKARTA UTARA, DKI JAKARTA",20,191,60,251
https://kawalpemilu.org#25899,"SUNTER AGUNG, TANJUNG PRIOK, JAKARTA UTARA, DKI JAKARTA",21,90,169,259
https://kawalpemilu.org#25899,"SUNTER AGUNG, TANJUNG PRIOK, JAKARTA UTARA, DKI JAKARTA",22,167,73,240
https://kawalpemilu.org#25899,"SUNTER AGUNG, TANJUNG PRIOK, JAKARTA UTARA, DKI JAKARTA",23,136,65,201
https://kawalpemilu.org#25899,"SUNTER AGUNG, TANJUNG PRIOK, JAKARTA UTARA, DKI JAKARTA",24,127,43,170
https://kawalpemilu.org#25899,"SUNTER AGUNG, TANJUNG PRIOK, JAKARTA UTARA, DKI JAKARTA",25,99,109,208
https://kawalpemilu.org#25899,"SUNTER AGUNG, TANJUNG PRIOK, JAKARTA UTARA, DKI JAKARTA",26,152,75,227
https://kawalpemilu.org#25899,"SUNTER AGUNG, TANJUNG PRIOK, JAKARTA UTARA, DKI JAKARTA",27,125,68,193
https://kawalpemilu.org#25899,"SUNTER AGUNG, TANJUNG PRIOK, JAKARTA UTARA, DKI JAKARTA",28,181,67,248
https://kawalpemilu.org#25899,"SUNTER AGUNG, TANJUNG PRIOK, JAKARTA UTARA, DKI JAKARTA",29,152,62,214
https://kawalpemilu.org#25899,"SUNTER AGUNG, TANJUNG PRIOK, JAKARTA UTARA, DKI JAKARTA",30,148,90,238
https://kawalpemilu.org#25899,"SUNTER AGUNG, TANJUNG PRIOK, JAKARTA UTARA, DKI JAKARTA",31,152,75,227
https://kawalpemilu.org#25899,"SUNTER AGUNG, TANJUNG PRIOK, JAKARTA UTARA, DKI JAKARTA",32,163,88,251
https://kawalpemilu.org#25899,"SUNTER AGUNG, TANJUNG PRIOK, JAKARTA UTARA, DKI JAKARTA",33,109,76,185
https://kawalpemilu.org#25899,"SUNTER AGUNG, TANJUNG PRIOK, JAKARTA UTARA, DKI JAKARTA",34,147,114,261
https://kawalpemilu.org#25899,"SUNTER AGUNG, TANJUNG PRIOK, JAKARTA UTARA, DKI JAKARTA",35,107,93,200
https://kawalpemilu.org#25899,"SUNTER AGUNG, TANJUNG PRIOK, JAKARTA UTARA, DKI JAKARTA",36,139,97,236
https://kawalpemilu.org#25899,"SUNTER AGUNG, TANJUNG PRIOK, JAKARTA UTARA, DKI JAKARTA",37,142,97,239
https://kawalpemilu.org#25899,"SUNTER AGUNG, TANJUNG PRIOK, JAKARTA UTARA, DKI JAKARTA",38,151,89,240
https://kawalpemilu.org#25899,"SUNTER AGUNG, TANJUNG PRIOK, JAKARTA UTARA, DKI JAKARTA",39,120,138,258
https://kawalpemilu.org#25899,"SUNTER AGUNG, TANJUNG PRIOK, JAKARTA UTARA, DKI JAKARTA",40,152,106,258
https://kawalpemilu.org#25899,"SUNTER AGUNG, TANJUNG PRIOK, JAKARTA UTARA, DKI JAKARTA",41,199,40,239
https://kawalpemilu.org#25899,"SUNTER AGUNG, TANJUNG PRIOK, JAKARTA UTARA, DKI JAKARTA",42,238,9,247
https://kawalpemilu.org#25899,"SUNTER AGUNG, TANJUNG PRIOK, JAKARTA UTARA, DKI JAKARTA",43,207,17,224
https://kawalpemilu.org#25899,"SUNTER AGUNG, TANJUNG PRIOK, JAKARTA UTARA, DKI JAKARTA",44,157,12,169
https://kawalpemilu.org#25899,"SUNTER AGUNG, TANJUNG PRIOK, JAKARTA UTARA, DKI JAKARTA",45,230,4,234
https://kawalpemilu.org#25899,"SUNTER AGUNG, TANJUNG PRIOK, JAKARTA UTARA, DKI JAKARTA",46,149,67,216
https://kawalpemilu.org#25899,"SUNTER AGUNG, TANJUNG PRIOK, JAKARTA UTARA, DKI JAKARTA",47,144,69,213
https://kawalpemilu.org#25899,"SUNTER AGUNG, TANJUNG PRIOK, JAKARTA UTARA, DKI JAKARTA",48,122,90,212
https://kawalpemilu.org#25899,"SUNTER AGUNG, TANJUNG PRIOK, JAKARTA UTARA, DKI JAKARTA",49,133,110,243
https://kawalpemilu.org#25899,"SUNTER AGUNG, TANJUNG PRIOK, JAKARTA UTARA, DKI JAKARTA",50,121,109,230
https://kawalpemilu.org#25899,"SUNTER AGUNG, TANJUNG PRIOK, JAKARTA UTARA, DKI JAKARTA",51,148,88,236
https://kawalpemilu.org#25899,"SUNTER AGUNG, TANJUNG PRIOK, JAKARTA UTARA, DKI JAKARTA",52,152,80,232
https://kawalpemilu.org#25899,"SUNTER AGUNG, TANJUNG PRIOK, JAKARTA UTARA, DKI JAKARTA",53,155,104,259
https://kawalpemilu.org#25899,"SUNTER AGUNG, TANJUNG PRIOK, JAKARTA UTARA, DKI JAKARTA",54,153,80,233
https://kawalpemilu.org#25899,"SUNTER AGUNG, TANJUNG PRIOK, JAKARTA UTARA, DKI JAKARTA",55,178,63,241
https://kawalpemilu.org#25899,"SUNTER AGUNG, TANJUNG PRIOK, JAKARTA UTARA, DKI JAKARTA",56,153,72,225
https://kawalpemilu.org#25899,"SUNTER AGUNG, TANJUNG PRIOK, JAKARTA UTARA, DKI JAKARTA",57,122,104,226
https://kawalpemilu.org#25899,"SUNTER AGUNG, TANJUNG PRIOK, JAKARTA UTARA, DKI JAKARTA",58,120,87,207
https://kawalpemilu.org#25899,"SUNTER AGUNG, TANJUNG PRIOK, JAKARTA UTARA, DKI JAKARTA",59,138,83,221
https://kawalpemilu.org#25899,"SUNTER AGUNG, TANJUNG PRIOK, JAKARTA UTARA, DKI JAKARTA",60,167,64,231
https://kawalpemilu.org#25899,"SUNTER AGUNG, TANJUNG PRIOK, JAKARTA UTARA, DKI JAKARTA",61,162,70,232
https://kawalpemilu.org#25899,"SUNTER AGUNG, TANJUNG PRIOK, JAKARTA UTARA, DKI JAKARTA",62,141,102,243
https://kawalpemilu.org#25899,"SUNTER AGUNG, TANJUNG PRIOK, JAKARTA UTARA, DKI JAKARTA",63,148,85,233
https://kawalpemilu.org#25899,"SUNTER AGUNG, TANJUNG PRIOK, JAKARTA UTARA, DKI JAKARTA",64,146,95,141
https://kawalpemilu.org#25899,"SUNTER AGUNG, TANJUNG PRIOK, JAKARTA UTARA, DKI JAKARTA",65,134,111,245
https://kawalpemilu.org#25899,"SUNTER AGUNG, TANJUNG PRIOK, JAKARTA UTARA, DKI JAKARTA",66,160,89,249
https://kawalpemilu.org#25899,"SUNTER AGUNG, TANJUNG PRIOK, JAKARTA UTARA, DKI JAKARTA",67,146,77,223
https://kawalpemilu.org#25899,"SUNTER AGUNG, TANJUNG PRIOK, JAKARTA UTARA, DKI JAKARTA",68,149,77,226
https://kawalpemilu.org#25899,"SUNTER AGUNG, TANJUNG PRIOK, JAKARTA UTARA, DKI JAKARTA",69,150,89,239
https://kawalpemilu.org#25899,"SUNTER AGUNG, TANJUNG PRIOK, JAKARTA UTARA, DKI JAKARTA",70,128,107,235
https://kawalpemilu.org#25899,"SUNTER AGUNG, TANJUNG PRIOK, JAKARTA UTARA, DKI JAKARTA",71,106,80,186
https://kawalpemilu.org#25899,"SUNTER AGUNG, TANJUNG PRIOK, JAKARTA UTARA, DKI JAKARTA",72,131,63,194
https://kawalpemilu.org#25899,"SUNTER AGUNG, TANJUNG PRIOK, JAKARTA UTARA, DKI JAKARTA",73,146,90,236
https://kawalpemilu.org#25899,"SUNTER AGUNG, TANJUNG PRIOK, JAKARTA UTARA, DKI JAKARTA",74,117,138,255
https://kawalpemilu.org#25899,"SUNTER AGUNG, TANJUNG PRIOK, JAKARTA UTARA, DKI JAKARTA",75,107,104,211
https://kawalpemilu.org#25899,"SUNTER AGUNG, TANJUNG PRIOK, JAKARTA UTARA, DKI JAKARTA",76,87,95,182
https://kawalpemilu.org#25899,"SUNTER AGUNG, TANJUNG PRIOK, JAKARTA UTARA, DKI JAKARTA",77,107,76,183
https://kawalpemilu.org#25899,"SUNTER AGUNG, TANJUNG PRIOK, JAKARTA UTARA, DKI JAKARTA",78,151,95,246
https://kawalpemilu.org#25899,"SUNTER AGUNG, TANJUNG PRIOK, JAKARTA UTARA, DKI JAKARTA",79,119,123,242
https://kawalpemilu.org#25899,"SUNTER AGUNG, TANJUNG PRIOK, JAKARTA UTARA, DKI JAKARTA",80,109,131,240
https://kawalpemilu.org#25899,"SUNTER AGUNG, TANJUNG PRIOK, JAKARTA UTARA, DKI JAKARTA",81,93,154,247
https://kawalpemilu.org#25899,"SUNTER AGUNG, TANJUNG PRIOK, JAKARTA UTARA, DKI JAKARTA",82,98,118,216
https://kawalpemilu.org#25899,"SUNTER AGUNG, TANJUNG PRIOK, JAKARTA UTARA, DKI JAKARTA",83,103,128,231
https://kawalpemilu.org#25899,"SUNTER AGUNG, TANJUNG PRIOK, JAKARTA UTARA, DKI JAKARTA",84,138,115,253
https://kawalpemilu.org#25899,"SUNTER AGUNG, TANJUNG PRIOK, JAKARTA UTARA, DKI JAKARTA",85,128,114,242
https://kawalpemilu.org#25899,"SUNTER AGUNG, TANJUNG PRIOK, JAKARTA UTARA, DKI JAKARTA",86,110,126,236
https://kawalpemilu.org#25899,"SUNTER AGUNG, TANJUNG PRIOK, JAKARTA UTARA, DKI JAKARTA",87,112,108,220
https://kawalpemilu.org#25899,"SUNTER AGUNG, TANJUNG PRIOK, JAKARTA UTARA, DKI JAKARTA",88,123,58,181
https://kawalpemilu.org#25899,"SUNTER AGUNG, TANJUNG PRIOK, JAKARTA UTARA, DKI JAKARTA",89,121,68,189
https://kawalpemilu.org#25899,"SUNTER AGUNG, TANJUNG PRIOK, JAKARTA UTARA, DKI JAKARTA",90,76,166,242
https://kawalpemilu.org#25899,"SUNTER AGUNG, TANJUNG PRIOK, JAKARTA UTARA, DKI JAKARTA",91,122,170,292
https://kawalpemilu.org#25899,"SUNTER AGUNG, TANJUNG PRIOK, JAKARTA UTARA, DKI JAKARTA",92,132,104,236
https://kawalpemilu.org#25899,"SUNTER AGUNG, TANJUNG PRIOK, JAKARTA UTARA, DKI JAKARTA",93,146,107,253
https://kawalpemilu.org#25899,"SUNTER AGUNG, TANJUNG PRIOK, JAKARTA UTARA, DKI JAKARTA",94,134,99,233
https://kawalpemilu.org#25899,"SUNTER AGUNG, TANJUNG PRIOK, JAKARTA UTARA, DKI JAKARTA",95,230,33,263
https://kawalpemilu.org#25899,"SUNTER AGUNG, TANJUNG PRIOK, JAKARTA UTARA, DKI JAKARTA",96,159,60,219
https://kawalpemilu.org#25899,"SUNTER AGUNG, TANJUNG PRIOK, JAKARTA UTARA, DKI JAKARTA",97,173,49,222
https://kawalpemilu.org#25899,"SUNTER AGUNG, TANJUNG PRIOK, JAKARTA UTARA, DKI JAKARTA",98,202,34,236
https://kawalpemilu.org#25899,"SUNTER AGUNG, TANJUNG PRIOK, JAKARTA UTARA, DKI JAKARTA",99,181,58,239
https://kawalpemilu.org#25899,"SUNTER AGUNG, TANJUNG PRIOK, JAKARTA UTARA, DKI JAKARTA",100,159,27,186
https://kawalpemilu.org#25899,"SUNTER AGUNG, TANJUNG PRIOK, JAKARTA UTARA, DKI JAKARTA",101,169,87,256
https://kawalpemilu.org#25899,"SUNTER AGUNG, TANJUNG PRIOK, JAKARTA UTARA, DKI JAKARTA",102,185,53,238
https://kawalpemilu.org#25899,"SUNTER AGUNG, TANJUNG PRIOK, JAKARTA UTARA, DKI JAKARTA",103,122,91,213
https://kawalpemilu.org#25899,"SUNTER AGUNG, TANJUNG PRIOK, JAKARTA UTARA, DKI JAKARTA",104,184,100,284
https://kawalpemilu.org#25899,"SUNTER AGUNG, TANJUNG PRIOK, JAKARTA UTARA, DKI JAKARTA",105,127,61,188
https://kawalpemilu.org#25899,"SUNTER AGUNG, TANJUNG PRIOK, JAKARTA UTARA, DKI JAKARTA",106,169,45,214
https://kawalpemilu.org#25899,"SUNTER AGUNG, TANJUNG PRIOK, JAKARTA UTARA, DKI JAKARTA",107,172,46,218
https://kawalpemilu.org#25899,"SUNTER AGUNG, TANJUNG PRIOK, JAKARTA UTARA, DKI JAKARTA",108,170,83,253
https://kawalpemilu.org#25899,"SUNTER AGUNG, TANJUNG PRIOK, JAKARTA UTARA, DKI JAKARTA",109,157,73,230
https://kawalpemilu.org#25899,"SUNTER AGUNG, TANJUNG PRIOK, JAKARTA UTARA, DKI JAKARTA",110,178,70,248
https://kawalpemilu.org#25899,"SUNTER AGUNG, TANJUNG PRIOK, JAKARTA UTARA, DKI JAKARTA",111,176,49,225
https://kawalpemilu.org#25899,"SUNTER AGUNG, TANJUNG PRIOK, JAKARTA UTARA, DKI JAKARTA",112,172,66,238
https://kawalpemilu.org#25899,"SUNTER AGUNG, TANJUNG PRIOK, JAKARTA UTARA, DKI JAKARTA",113,132,79,211
https://kawalpemilu.org#25899,"SUNTER AGUNG, TANJUNG PRIOK, JAKARTA UTARA, DKI JAKARTA",114,156,76,232
https://kawalpemilu.org#25899,"SUNTER AGUNG, TANJUNG PRIOK, JAKARTA UTARA, DKI JAKARTA",115,127,56,183
https://kawalpemilu.org#25899,"SUNTER AGUNG, TANJUNG PRIOK, JAKARTA UTARA, DKI JAKARTA",116,97,60,157
https://kawalpemilu.org#25899,"SUNTER AGUNG, TANJUNG PRIOK, JAKARTA UTARA, DKI JAKARTA",117,121,81,202
https://kawalpemilu.org#25899,"SUNTER AGUNG, TANJUNG PRIOK, JAKARTA UTARA, DKI JAKARTA",118,149,66,215
https://kawalpemilu.org#25899,"SUNTER AGUNG, TANJUNG PRIOK, JAKARTA UTARA, DKI JAKARTA",119,150,95,245
https://kawalpemilu.org#25899,"SUNTER AGUNG, TANJUNG PRIOK, JAKARTA UTARA, DKI JAKARTA",120,144,93,237
https://kawalpemilu.org#25899,"SUNTER AGUNG, TANJUNG PRIOK, JAKARTA UTARA, DKI JAKARTA",121,151,72,223
https://kawalpemilu.org#25899,"SUNTER AGUNG, TANJUNG PRIOK, JAKARTA UTARA, DKI JAKARTA",122,162,79,241
https://kawalpemilu.org#25899,"SUNTER AGUNG, TANJUNG PRIOK, JAKARTA UTARA, DKI JAKARTA",123,150,96,246
https://kawalpemilu.org#25899,"SUNTER AGUNG, TANJUNG PRIOK, JAKARTA UTARA, DKI JAKARTA",124,166,63,229
https://kawalpemilu.org#25899,"SUNTER AGUNG, TANJUNG PRIOK, JAKARTA UTARA, DKI JAKARTA",125,148,84,232
https://kawalpemilu.org#25899,"SUNTER AGUNG, TANJUNG PRIOK, JAKARTA UTARA, DKI JAKARTA",126,131,65,196
https://kawalpemilu.org#25899,"SUNTER AGUNG, TANJUNG PRIOK, JAKARTA UTARA, DKI JAKARTA",127,169,78,247
https://kawalpemilu.org#25899,"SUNTER AGUNG, TANJUNG PRIOK, JAKARTA UTARA, DKI JAKARTA",128,136,54,190
https://kawalpemilu.org#25899,"SUNTER AGUNG, TANJUNG PRIOK, JAKARTA UTARA, DKI JAKARTA",129,175,11,186
https://kawalpemilu.org#25899,"SUNTER AGUNG, TANJUNG PRIOK, JAKARTA UTARA, DKI JAKARTA",130,154,85,239
https://kawalpemilu.org#25899,"SUNTER AGUNG, TANJUNG PRIOK, JAKARTA UTARA, DKI JAKARTA",131,212,55,267
https://kawalpemilu.org#25899,"SUNTER AGUNG, TANJUNG PRIOK, JAKARTA UTARA, DKI JAKARTA",132,177,68,245
https://kawalpemilu.org#25899,"SUNTER AGUNG, TANJUNG PRIOK, JAKARTA UTARA, DKI JAKARTA",133,119,90,209
https://kawalpemilu.org#25899,"SUNTER AGUNG, TANJUNG PRIOK, JAKARTA UTARA, DKI JAKARTA",134,177,96,273
https://kawalpemilu.org#25899,"SUNTER AGUNG, TANJUNG PRIOK, JAKARTA UTARA, DKI JAKARTA",135,184,57,241
https://kawalpemilu.org#25899,"SUNTER AGUNG, TANJUNG PRIOK, JAKARTA UTARA, DKI JAKARTA",136,230,25,255
https://kawalpemilu.org#25899,"SUNTER AGUNG, TANJUNG PRIOK, JAKARTA UTARA, DKI JAKARTA",137,154,84,238
https://kawalpemilu.org#25899,"SUNTER AGUNG, TANJUNG PRIOK, JAKARTA UTARA, DKI JAKARTA",138,131,94,225
https://kawalpemilu.org#25899,"SUNTER AGUNG, TANJUNG PRIOK, JAKARTA UTARA, DKI JAKARTA",139,196,45,234
https://kawalpemilu.org#25899,"SUNTER AGUNG, TANJUNG PRIOK, JAKARTA UTARA, DKI JAKARTA",140,191,56,247
https://kawalpemilu.org#25899,"SUNTER AGUNG, TANJUNG PRIOK, JAKARTA UTARA, DKI JAKARTA",141,158,12,170
https://kawalpemilu.org#25899,"SUNTER AGUNG, TANJUNG PRIOK, JAKARTA UTARA, DKI JAKARTA",142,158,7,165
https://kawalpemilu.org#25899,"SUNTER AGUNG, TANJUNG PRIOK, JAKARTA UTARA, DKI JAKARTA",143,187,0,187
https://kawalpemilu.org#25899,"SUNTER AGUNG, TANJUNG PRIOK, JAKARTA UTARA, DKI JAKARTA",144,215,15,230
https://kawalpemilu.org#25899,"SUNTER AGUNG, TANJUNG PRIOK, JAKARTA UTARA, DKI JAKARTA",145,152,104,256
https://kawalpemilu.org#25899,"SUNTER AGUNG, TANJUNG PRIOK, JAKARTA UTARA, DKI JAKARTA",146,150,102,252
https://kawalpemilu.org#25899,"SUNTER AGUNG, TANJUNG PRIOK, JAKARTA UTARA, DKI JAKARTA",147,179,83,262
https://kawalpemilu.org#25899,"SUNTER AGUNG, TANJUNG PRIOK, JAKARTA UTARA, DKI JAKARTA",148,175,13,188
https://kawalpemilu.org#25899,"SUNTER AGUNG, TANJUNG PRIOK, JAKARTA UTARA, DKI JAKARTA",149,126,52,178
https://kawalpemilu.org#25899,"SUNTER AGUNG, TANJUNG PRIOK, JAKARTA UTARA, DKI JAKARTA",150,156,32,188
https://kawalpemilu.org#25899,"SUNTER AGUNG, TANJUNG PRIOK, JAKARTA UTARA, DKI JAKARTA",151,198,50,248
https://kawalpemilu.org#25899,"SUNTER AGUNG, TANJUNG PRIOK, JAKARTA UTARA, DKI JAKARTA",152,170,69,239
https://kawalpemilu.org#25899,"SUNTER AGUNG, TANJUNG PRIOK, JAKARTA UTARA, DKI JAKARTA",153,163,37,200
https://kawalpemilu.org#25899,"SUNTER AGUNG, TANJUNG PRIOK, JAKARTA UTARA, DKI JAKARTA",154,185,54,239
https://kawalpemilu.org#25899,"SUNTER AGUNG, TANJUNG PRIOK, JAKARTA UTARA, DKI JAKARTA",155,138,50,188
https://kawalpemilu.org#25899,"SUNTER AGUNG, TANJUNG PRIOK, JAKARTA UTARA, DKI JAKARTA",156,186,9,195
https://kawalpemilu.org#25899,"SUNTER AGUNG, TANJUNG PRIOK, JAKARTA UTARA, DKI JAKARTA",157,165,46,211
https://kawalpemilu.org#25899,"SUNTER AGUNG, TANJUNG PRIOK, JAKARTA UTARA, DKI JAKARTA",158,223,5,228
https://kawalpemilu.org#25899,"SUNTER AGUNG, TANJUNG PRIOK, JAKARTA UTARA, DKI JAKARTA",159,212,5,217
https://kawalpemilu.org#25899,"SUNTER AGUNG, TANJUNG PRIOK, JAKARTA UTARA, DKI JAKARTA",160,221,8,229
https://kawalpemilu.org#25899,"SUNTER AGUNG, TANJUNG PRIOK, JAKARTA UTARA, DKI JAKARTA",161,191,11,202
https://kawalpemilu.org#25899,"SUNTER AGUNG, TANJUNG PRIOK, JAKARTA UTARA, DKI JAKARTA",162,201,11,212
https://kawalpemilu.org#25899,"SUNTER AGUNG, TANJUNG PRIOK, JAKARTA UTARA, DKI JAKARTA",163,214,15,229
https://kawalpemilu.org#25899,"SUNTER AGUNG, TANJUNG PRIOK, JAKARTA UTARA, DKI JAKARTA",164,219,14,233
https://kawalpemilu.org#25899,"SUNTER AGUNG, TANJUNG PRIOK, JAKARTA UTARA, DKI JAKARTA",165,234,9,243
https://kawalpemilu.org#25899,"SUNTER AGUNG, TANJUNG PRIOK, JAKARTA UTARA, DKI JAKARTA",166,234,8,242
https://kawalpemilu.org#25899,"SUNTER AGUNG, TANJUNG PRIOK, JAKARTA UTARA, DKI JAKARTA",168,233,8,241
https://kawalpemilu.org#25899,"SUNTER AGUNG, TANJUNG PRIOK, JAKARTA UTARA, DKI JAKARTA",169,198,64,262
https://kawalpemilu.org#25899,"SUNTER AGUNG, TANJUNG PRIOK, JAKARTA UTARA, DKI JAKARTA",170,145,112,257
https://kawalpemilu.org#25899,"SUNTER AGUNG, TANJUNG PRIOK, JAKARTA UTARA, DKI JAKARTA",171,169,101,270
https://kawalpemilu.org#25899,"SUNTER AGUNG, TANJUNG PRIOK, JAKARTA UTARA, DKI JAKARTA",172,144,90,234
https://kawalpemilu.org#25899,"SUNTER AGUNG, TANJUNG PRIOK, JAKARTA UTARA, DKI JAKARTA",173,124,107,231
https://kawalpemilu.org#25899,"SUNTER AGUNG, TANJUNG PRIOK, JAKARTA UTARA, DKI JAKARTA",174,119,122,241
https://kawalpemilu.org#25899,"SUNTER AGUNG, TANJUNG PRIOK, JAKARTA UTARA, DKI JAKARTA",175,133,123,256
https://kawalpemilu.org#25899,"SUNTER AGUNG, TANJUNG PRIOK, JAKARTA UTARA, DKI JAKARTA",176,209,28,237
https://kawalpemilu.org#25899,"SUNTER AGUNG, TANJUNG PRIOK, JAKARTA UTARA, DKI JAKARTA",177,189,52,241
https://kawalpemilu.org#25899,"SUNTER AGUNG, TANJUNG PRIOK, JAKARTA UTARA, DKI JAKARTA",178,161,39,200
https://kawalpemilu.org#25899,"SUNTER AGUNG, TANJUNG PRIOK, JAKARTA UTARA, DKI JAKARTA",179,199,32,231
https://kawalpemilu.org#25899,"SUNTER AGUNG, TANJUNG PRIOK, JAKARTA UTARA, DKI JAKARTA",180,233,8,241
https://kawalpemilu.org#25899,"SUNTER AGUNG, TANJUNG PRIOK, JAKARTA UTARA, DKI JAKARTA",181,231,11,242
https://kawalpemilu.org#25899,"SUNTER AGUNG, TANJUNG PRIOK, JAKARTA UTARA, DKI JAKARTA",182,187,8,195
https://kawalpemilu.org#25899,"SUNTER AGUNG, TANJUNG PRIOK, JAKARTA UTARA, DKI JAKARTA",183,243,10,253
https://kawalpemilu.org#25899,"SUNTER AGUNG, TANJUNG PRIOK, JAKARTA UTARA, DKI JAKARTA",184,208,58,266
https://kawalpemilu.org#25899,"SUNTER AGUNG, TANJUNG PRIOK, JAKARTA UTARA, DKI JAKARTA",185,179,51,230
https://kawalpemilu.org#25899,"SUNTER AGUNG, TANJUNG PRIOK, JAKARTA UTARA, DKI JAKARTA",186,214,47,261
https://kawalpemilu.org#25899,"SUNTER AGUNG, TANJUNG PRIOK, JAKARTA UTARA, DKI JAKARTA",187,188,21,209
https://kawalpemilu.org#25899,"SUNTER AGUNG, TANJUNG PRIOK, JAKARTA UTARA, DKI JAKARTA",188,212,14,226
https://kawalpemilu.org#25899,"SUNTER AGUNG, TANJUNG PRIOK, JAKARTA UTARA, DKI JAKARTA",189,156,8,164
https://kawalpemilu.org#25899,"SUNTER AGUNG, TANJUNG PRIOK, JAKARTA UTARA, DKI JAKARTA",190,168,7,175
https://kawalpemilu.org#25899,"SUNTER AGUNG, TANJUNG PRIOK, JAKARTA UTARA, DKI JAKARTA",191,192,46,238
https://kawalpemilu.org#25899,"SUNTER AGUNG, TANJUNG PRIOK, JAKARTA UTARA, DKI JAKARTA",192,214,20,234
https://kawalpemilu.org#25899,"SUNTER AGUNG, TANJUNG PRIOK, JAKARTA UTARA, DKI JAKARTA",193,265,18,283
https://kawalpemilu.org#25899,"SUNTER AGUNG, TANJUNG PRIOK, JAKARTA UTARA, DKI JAKARTA",194,247,4,251
https://kawalpemilu.org#25899,"SUNTER AGUNG, TANJUNG PRIOK, JAKARTA UTARA, DKI JAKARTA",195,248,4,252
https://kawalpemilu.org#25899,"SUNTER AGUNG, TANJUNG PRIOK, JAKARTA UTARA, DKI JAKARTA",196,210,4,214
https://kawalpemilu.org#25899,"SUNTER AGUNG, TANJUNG PRIOK, JAKARTA UTARA, DKI JAKARTA",197,247,4,251
https://kawalpemilu.org#25899,"SUNTER AGUNG, TANJUNG PRIOK, JAKARTA UTARA, DKI JAKARTA",198,233,7,240
https://kawalpemilu.org#25899,"SUNTER AGUNG, TANJUNG PRIOK, JAKARTA UTARA, DKI JAKARTA",199,250,4,254
https://kawalpemilu.org#25899,"SUNTER AGUNG, TANJUNG PRIOK, JAKARTA UTARA, DKI JAKARTA",200,225,16,241
https://kawalpemilu.org#25899,"SUNTER AGUNG, TANJUNG PRIOK, JAKARTA UTARA, DKI JAKARTA",201,238,7,245
https://kawalpemilu.org#25899,"SUNTER AGUNG, TANJUNG PRIOK, JAKARTA UTARA, DKI JAKARTA",202,232,10,242
https://kawalpemilu.org#25899,"SUNTER AGUNG, TANJUNG PRIOK, JAKARTA UTARA, DKI JAKARTA",203,230,12,242
https://kawalpemilu.org#25899,"SUNTER AGUNG, TANJUNG PRIOK, JAKARTA UTARA, DKI JAKARTA",204,215,8,223
https://kawalpemilu.org#25899,"SUNTER AGUNG, TANJUNG PRIOK, JAKARTA UTARA, DKI JAKARTA",205,231,8,239
https://kawalpemilu.org#25899,"SUNTER AGUNG, TANJUNG PRIOK, JAKARTA UTARA, DKI JAKARTA",206,233,8,241
https://kawalpemilu.org#25899,"SUNTER AGUNG, TANJUNG PRIOK, JAKARTA UTARA, DKI JAKARTA",207,198,2,200
https://kawalpemilu.org#25899,"SUNTER AGUNG, TANJUNG PRIOK, JAKARTA UTARA, DKI JAKARTA",208,235,8,243
https://kawalpemilu.org#25899,"SUNTER AGUNG, TANJUNG PRIOK, JAKARTA UTARA, DKI JAKARTA",209,204,10,214
https://kawalpemilu.org#25899,"SUNTER AGUNG, TANJUNG PRIOK, JAKARTA UTARA, DKI JAKARTA",210,210,10,220
https://kawalpemilu.org#25899,"SUNTER AGUNG, TANJUNG PRIOK, JAKARTA UTARA, DKI JAKARTA",211,202,5,207
https://kawalpemilu.org#25899,"SUNTER AGUNG, TANJUNG PRIOK, JAKARTA UTARA, DKI JAKARTA",212,218,16,234
https://kawalpemilu.org#25899,"SUNTER AGUNG, TANJUNG PRIOK, JAKARTA UTARA, DKI JAKARTA",213,209,11,220
https://kawalpemilu.org#25899,"SUNTER AGUNG, TANJUNG PRIOK, JAKARTA UTARA, DKI JAKARTA",214,205,5,210
https://kawalpemilu.org#25899,"SUNTER AGUNG, TANJUNG PRIOK, JAKARTA UTARA, DKI JAKARTA",215,205,2,207
https://kawalpemilu.org#25899,"SUNTER AGUNG, TANJUNG PRIOK, JAKARTA UTARA, DKI JAKARTA",216,179,13,192
https://kawalpemilu.org#25899,"SUNTER AGUNG, TANJUNG PRIOK, JAKARTA UTARA, DKI JAKARTA",217,92,64,156
https://kawalpemilu.org#25899,"SUNTER AGUNG, TANJUNG PRIOK, JAKARTA UTARA, DKI JAKARTA",218,117,74,191
https://kawalpemilu.org#25899,"SUNTER AGUNG, TANJUNG PRIOK, JAKARTA UTARA, DKI JAKARTA",219,97,39,136
https://kawalpemilu.org#25899,"SUNTER AGUNG, TANJUNG PRIOK, JAKARTA UTARA, DKI JAKARTA",220,112,66,178
https://kawalpemilu.org#25899,"SUNTER AGUNG, TANJUNG PRIOK, JAKARTA UTARA, DKI JAKARTA",221,103,50,153
https://kawalpemilu.org#25899,"SUNTER AGUNG, TANJUNG PRIOK, JAKARTA UTARA, DKI JAKARTA",222,107,60,167
https://kawalpemilu.org#25899,"SUNTER AGUNG, TANJUNG PRIOK, JAKARTA UTARA, DKI JAKARTA",223,150,67,217
https://kawalpemilu.org#25899,"SUNTER AGUNG, TANJUNG PRIOK, JAKARTA UTARA, DKI JAKARTA",224,109,82,191
https://kawalpemilu.org#25899,"SUNTER AGUNG, TANJUNG PRIOK, JAKARTA UTARA, DKI JAKARTA",225,121,65,186
https://kawalpemilu.org#25899,"SUNTER AGUNG, TANJUNG PRIOK, JAKARTA UTARA, DKI JAKARTA",226,119,78,197
https://kawalpemilu.org#25899,"SUNTER AGUNG, TANJUNG PRIOK, JAKARTA UTARA, DKI JAKARTA",227,108,31,139
https://kawalpemilu.org#25899,"SUNTER AGUNG, TANJUNG PRIOK, JAKARTA UTARA, DKI JAKARTA",228,135,79,214
https://kawalpemilu.org#25900,"WARAKAS, TANJUNG PRIOK, JAKARTA UTARA, DKI JAKARTA",1,116,84,200
https://kawalpemilu.org#25900,"WARAKAS, TANJUNG PRIOK, JAKARTA UTARA, DKI JAKARTA",2,126,83,209
https://kawalpemilu.org#25900,"WARAKAS, TANJUNG PRIOK, JAKARTA UTARA, DKI JAKARTA",3,127,87,214
https://kawalpemilu.org#25900,"WARAKAS, TANJUNG PRIOK, JAKARTA UTARA, DKI JAKARTA",4,122,84,206
https://kawalpemilu.org#25900,"WARAKAS, TANJUNG PRIOK, JAKARTA UTARA, DKI JAKARTA",5,116,103,219
https://kawalpemilu.org#25900,"WARAKAS, TANJUNG PRIOK, JAKARTA UTARA, DKI JAKARTA",6,122,89,211
https://kawalpemilu.org#25900,"WARAKAS, TANJUNG PRIOK, JAKARTA UTARA, DKI JAKARTA",7,92,139,231
https://kawalpemilu.org#25900,"WARAKAS, TANJUNG PRIOK, JAKARTA UTARA, DKI JAKARTA",8,106,135,241
https://kawalpemilu.org#25900,"WARAKAS, TANJUNG PRIOK, JAKARTA UTARA, DKI JAKARTA",9,90,135,225
https://kawalpemilu.org#25900,"WARAKAS, TANJUNG PRIOK, JAKARTA UTARA, DKI JAKARTA",10,111,109,220
https://kawalpemilu.org#25900,"WARAKAS, TANJUNG PRIOK, JAKARTA UTARA, DKI JAKARTA",11,107,137,244
https://kawalpemilu.org#25900,"WARAKAS, TANJUNG PRIOK, JAKARTA UTARA, DKI JAKARTA",12,88,120,208
https://kawalpemilu.org#25900,"WARAKAS, TANJUNG PRIOK, JAKARTA UTARA, DKI JAKARTA",13,55,124,179
https://kawalpemilu.org#25900,"WARAKAS, TANJUNG PRIOK, JAKARTA UTARA, DKI JAKARTA",14,95,126,221
https://kawalpemilu.org#25900,"WARAKAS, TANJUNG PRIOK, JAKARTA UTARA, DKI JAKARTA",15,125,97,222
https://kawalpemilu.org#25900,"WARAKAS, TANJUNG PRIOK, JAKARTA UTARA, DKI JAKARTA",16,111,118,229
https://kawalpemilu.org#25900,"WARAKAS, TANJUNG PRIOK, JAKARTA UTARA, DKI JAKARTA",17,95,96,191
https://kawalpemilu.org#25900,"WARAKAS, TANJUNG PRIOK, JAKARTA UTARA, DKI JAKARTA",18,84,135,219
https://kawalpemilu.org#25900,"WARAKAS, TANJUNG PRIOK, JAKARTA UTARA, DKI JAKARTA",19,104,123,227
https://kawalpemilu.org#25900,"WARAKAS, TANJUNG PRIOK, JAKARTA UTARA, DKI JAKARTA",20,67,161,228
https://kawalpemilu.org#25900,"WARAKAS, TANJUNG PRIOK, JAKARTA UTARA, DKI JAKARTA",21,93,113,206
https://kawalpemilu.org#25900,"WARAKAS, TANJUNG PRIOK, JAKARTA UTARA, DKI JAKARTA",22,65,158,223
https://kawalpemilu.org#25900,"WARAKAS, TANJUNG PRIOK, JAKARTA UTARA, DKI JAKARTA",23,60,116,176
https://kawalpemilu.org#25900,"WARAKAS, TANJUNG PRIOK, JAKARTA UTARA, DKI JAKARTA",24,97,92,189
https://kawalpemilu.org#25900,"WARAKAS, TANJUNG PRIOK, JAKARTA UTARA, DKI JAKARTA",25,96,106,202
https://kawalpemilu.org#25900,"WARAKAS, TANJUNG PRIOK, JAKARTA UTARA, DKI JAKARTA",26,144,71,215
https://kawalpemilu.org#25900,"WARAKAS, TANJUNG PRIOK, JAKARTA UTARA, DKI JAKARTA",27,68,129,197
https://kawalpemilu.org#25900,"WARAKAS, TANJUNG PRIOK, JAKARTA UTARA, DKI JAKARTA",28,78,127,205
https://kawalpemilu.org#25900,"WARAKAS, TANJUNG PRIOK, JAKARTA UTARA, DKI JAKARTA",29,94,145,239
https://kawalpemilu.org#25900,"WARAKAS, TANJUNG PRIOK, JAKARTA UTARA, DKI JAKARTA",30,90,124,214
https://kawalpemilu.org#25900,"WARAKAS, TANJUNG PRIOK, JAKARTA UTARA, DKI JAKARTA",31,87,128,215
https://kawalpemilu.org#25900,"WARAKAS, TANJUNG PRIOK, JAKARTA UTARA, DKI JAKARTA",32,81,114,195
https://kawalpemilu.org#25900,"WARAKAS, TANJUNG PRIOK, JAKARTA UTARA, DKI JAKARTA",33,137,78,215
https://kawalpemilu.org#25900,"WARAKAS, TANJUNG PRIOK, JAKARTA UTARA, DKI JAKARTA",34,105,88,193
https://kawalpemilu.org#25900,"WARAKAS, TANJUNG PRIOK, JAKARTA UTARA, DKI JAKARTA",35,101,115,216
https://kawalpemilu.org#25900,"WARAKAS, TANJUNG PRIOK, JAKARTA UTARA, DKI JAKARTA",36,105,100,205
https://kawalpemilu.org#25900,"WARAKAS, TANJUNG PRIOK, JAKARTA UTARA, DKI JAKARTA",37,114,103,217
https://kawalpemilu.org#25900,"WARAKAS, TANJUNG PRIOK, JAKARTA UTARA, DKI JAKARTA",38,137,95,232
https://kawalpemilu.org#25900,"WARAKAS, TANJUNG PRIOK, JAKARTA UTARA, DKI JAKARTA",39,91,101,192
https://kawalpemilu.org#25900,"WARAKAS, TANJUNG PRIOK, JAKARTA UTARA, DKI JAKARTA",40,63,134,197
https://kawalpemilu.org#25900,"WARAKAS, TANJUNG PRIOK, JAKARTA UTARA, DKI JAKARTA",41,86,127,213
https://kawalpemilu.org#25900,"WARAKAS, TANJUNG PRIOK, JAKARTA UTARA, DKI JAKARTA",42,120,106,226
https://kawalpemilu.org#25900,"WARAKAS, TANJUNG PRIOK, JAKARTA UTARA, DKI JAKARTA",43,117,78,195
https://kawalpemilu.org#25900,"WARAKAS, TANJUNG PRIOK, JAKARTA UTARA, DKI JAKARTA",44,100,80,180
https://kawalpemilu.org#25900,"WARAKAS, TANJUNG PRIOK, JAKARTA UTARA, DKI JAKARTA",45,127,110,237
https://kawalpemilu.org#25900,"WARAKAS, TANJUNG PRIOK, JAKARTA UTARA, DKI JAKARTA",46,103,152,255
https://kawalpemilu.org#25900,"WARAKAS, TANJUNG PRIOK, JAKARTA UTARA, DKI JAKARTA",47,108,99,207
https://kawalpemilu.org#25900,"WARAKAS, TANJUNG PRIOK, JAKARTA UTARA, DKI JAKARTA",48,91,104,195
https://kawalpemilu.org#25900,"WARAKAS, TANJUNG PRIOK, JAKARTA UTARA, DKI JAKARTA",49,109,84,193
https://kawalpemilu.org#25900,"WARAKAS, TANJUNG PRIOK, JAKARTA UTARA, DKI JAKARTA",50,136,121,257
https://kawalpemilu.org#25900,"WARAKAS, TANJUNG PRIOK, JAKARTA UTARA, DKI JAKARTA",51,117,110,227
https://kawalpemilu.org#25900,"WARAKAS, TANJUNG PRIOK, JAKARTA UTARA, DKI JAKARTA",52,107,107,214
https://kawalpemilu.org#25900,"WARAKAS, TANJUNG PRIOK, JAKARTA UTARA, DKI JAKARTA",53,102,154,256
https://kawalpemilu.org#25900,"WARAKAS, TANJUNG PRIOK, JAKARTA UTARA, DKI JAKARTA",54,73,170,243
https://kawalpemilu.org#25900,"WARAKAS, TANJUNG PRIOK, JAKARTA UTARA, DKI JAKARTA",55,91,151,242
https://kawalpemilu.org#25900,"WARAKAS, TANJUNG PRIOK, JAKARTA UTARA, DKI JAKARTA",56,90,138,228
https://kawalpemilu.org#25900,"WARAKAS, TANJUNG PRIOK, JAKARTA UTARA, DKI JAKARTA",57,123,92,215
https://kawalpemilu.org#25900,"WARAKAS, TANJUNG PRIOK, JAKARTA UTARA, DKI JAKARTA",58,96,124,220
https://kawalpemilu.org#25900,"WARAKAS, TANJUNG PRIOK, JAKARTA UTARA, DKI JAKARTA",59,77,132,209
https://kawalpemilu.org#25900,"WARAKAS, TANJUNG PRIOK, JAKARTA UTARA, DKI JAKARTA",60,75,131,206
https://kawalpemilu.org#25900,"WARAKAS, TANJUNG PRIOK, JAKARTA UTARA, DKI JAKARTA",61,127,109,236
https://kawalpemilu.org#25900,"WARAKAS, TANJUNG PRIOK, JAKARTA UTARA, DKI JAKARTA",62,113,131,244
https://kawalpemilu.org#25900,"WARAKAS, TANJUNG PRIOK, JAKARTA UTARA, DKI JAKARTA",63,90,106,196
https://kawalpemilu.org#25900,"WARAKAS, TANJUNG PRIOK, JAKARTA UTARA, DKI JAKARTA",64,112,87,199
https://kawalpemilu.org#25900,"WARAKAS, TANJUNG PRIOK, JAKARTA UTARA, DKI JAKARTA",65,109,108,217
https://kawalpemilu.org#25900,"WARAKAS, TANJUNG PRIOK, JAKARTA UTARA, DKI JAKARTA",66,102,145,247
https://kawalpemilu.org#25900,"WARAKAS, TANJUNG PRIOK, JAKARTA UTARA, DKI JAKARTA",67,88,116,204
https://kawalpemilu.org#25900,"WARAKAS, TANJUNG PRIOK, JAKARTA UTARA, DKI JAKARTA",68,79,134,213
https://kawalpemilu.org#25900,"WARAKAS, TANJUNG PRIOK, JAKARTA UTARA, DKI JAKARTA",69,78,140,218
https://kawalpemilu.org#25900,"WARAKAS, TANJUNG PRIOK, JAKARTA UTARA, DKI JAKARTA",70,86,124,210
https://kawalpemilu.org#25900,"WARAKAS, TANJUNG PRIOK, JAKARTA UTARA, DKI JAKARTA",71,86,174,260
https://kawalpemilu.org#25900,"WARAKAS, TANJUNG PRIOK, JAKARTA UTARA, DKI JAKARTA",72,84,139,223
https://kawalpemilu.org#25900,"WARAKAS, TANJUNG PRIOK, JAKARTA UTARA, DKI JAKARTA",73,101,130,231
https://kawalpemilu.org#25900,"WARAKAS, TANJUNG PRIOK, JAKARTA UTARA, DKI JAKARTA",74,58,145,203
https://kawalpemilu.org#25900,"WARAKAS, TANJUNG PRIOK, JAKARTA UTARA, DKI JAKARTA",75,108,79,187
https://kawalpemilu.org#25900,"WARAKAS, TANJUNG PRIOK, JAKARTA UTARA, DKI JAKARTA",76,106,105,211
https://kawalpemilu.org#25900,"WARAKAS, TANJUNG PRIOK, JAKARTA UTARA, DKI JAKARTA",77,156,99,255
https://kawalpemilu.org#25900,"WARAKAS, TANJUNG PRIOK, JAKARTA UTARA, DKI JAKARTA",78,108,100,208
https://kawalpemilu.org#25900,"WARAKAS, TANJUNG PRIOK, JAKARTA UTARA, DKI JAKARTA",79,98,102,200
https://kawalpemilu.org#25900,"WARAKAS, TANJUNG PRIOK, JAKARTA UTARA, DKI JAKARTA",80,90,110,200
https://kawalpemilu.org#25900,"WARAKAS, TANJUNG PRIOK, JAKARTA UTARA, DKI JAKARTA",81,107,110,217
https://kawalpemilu.org#25900,"WARAKAS, TANJUNG PRIOK, JAKARTA UTARA, DKI JAKARTA",82,91,117,208
https://kawalpemilu.org#25900,"WARAKAS, TANJUNG PRIOK, JAKARTA UTARA, DKI JAKARTA",83,124,84,208
https://kawalpemilu.org#25900,"WARAKAS, TANJUNG PRIOK, JAKARTA UTARA, DKI JAKARTA",84,175,62,237
https://kawalpemilu.org#25900,"WARAKAS, TANJUNG PRIOK, JAKARTA UTARA, DKI JAKARTA",85,113,115,228
https://kawalpemilu.org#25900,"WARAKAS, TANJUNG PRIOK, JAKARTA UTARA, DKI JAKARTA",86,144,74,218
https://kawalpemilu.org#25900,"WARAKAS, TANJUNG PRIOK, JAKARTA UTARA, DKI JAKARTA",87,98,99,197
https://kawalpemilu.org#25900,"WARAKAS, TANJUNG PRIOK, JAKARTA UTARA, DKI JAKARTA",88,142,68,210
https://kawalpemilu.org#25900,"WARAKAS, TANJUNG PRIOK, JAKARTA UTARA, DKI JAKARTA",89,114,100,214
https://kawalpemilu.org#25900,"WARAKAS, TANJUNG PRIOK, JAKARTA UTARA, DKI JAKARTA",90,92,137,229
https://kawalpemilu.org#25900,"WARAKAS, TANJUNG PRIOK, JAKARTA UTARA, DKI JAKARTA",91,88,92,180
https://kawalpemilu.org#25900,"WARAKAS, TANJUNG PRIOK, JAKARTA UTARA, DKI JAKARTA",92,89,116,205
https://kawalpemilu.org#25900,"WARAKAS, TANJUNG PRIOK, JAKARTA UTARA, DKI JAKARTA",93,101,108,209
https://kawalpemilu.org#25900,"WARAKAS, TANJUNG PRIOK, JAKARTA UTARA, DKI JAKARTA",94,117,105,222
https://kawalpemilu.org#25900,"WARAKAS, TANJUNG PRIOK, JAKARTA UTARA, DKI JAKARTA",95,109,101,210
https://kawalpemilu.org#25900,"WARAKAS, TANJUNG PRIOK, JAKARTA UTARA, DKI JAKARTA",96,121,88,209
https://kawalpemilu.org#25900,"WARAKAS, TANJUNG PRIOK, JAKARTA UTARA, DKI JAKARTA",97,118,88,206
https://kawalpemilu.org#25900,"WARAKAS, TANJUNG PRIOK, JAKARTA UTARA, DKI JAKARTA",98,108,113,221
https://kawalpemilu.org#25900,"WARAKAS, TANJUNG PRIOK, JAKARTA UTARA, DKI JAKARTA",99,103,130,233
https://kawalpemilu.org#25900,"WARAKAS, TANJUNG PRIOK, JAKARTA UTARA, DKI JAKARTA",100,95,119,214
https://kawalpemilu.org#25900,"WARAKAS, TANJUNG PRIOK, JAKARTA UTARA, DKI JAKARTA",101,82,108,190
https://kawalpemilu.org#25900,"WARAKAS, TANJUNG PRIOK, JAKARTA UTARA, DKI JAKARTA",103,112,113,225
https://kawalpemilu.org#25900,"WARAKAS, TANJUNG PRIOK, JAKARTA UTARA, DKI JAKARTA",104,116,132,248
https://kawalpemilu.org#25900,"WARAKAS, TANJUNG PRIOK, JAKARTA UTARA, DKI JAKARTA",105,82,158,240
https://kawalpemilu.org#25900,"WARAKAS, TANJUNG PRIOK, JAKARTA UTARA, DKI JAKARTA",106,92,149,241
https://kawalpemilu.org#25900,"WARAKAS, TANJUNG PRIOK, JAKARTA UTARA, DKI JAKARTA",107,122,122,244
https://kawalpemilu.org#25900,"WARAKAS, TANJUNG PRIOK, JAKARTA UTARA, DKI JAKARTA",108,116,103,219
https://kawalpemilu.org#25900,"WARAKAS, TANJUNG PRIOK, JAKARTA UTARA, DKI JAKARTA",109,117,89,206
https://kawalpemilu.org#25900,"WARAKAS, TANJUNG PRIOK, JAKARTA UTARA, DKI JAKARTA",110,175,71,246
https://kawalpemilu.org#25900,"WARAKAS, TANJUNG PRIOK, JAKARTA UTARA, DKI JAKARTA",111,158,58,216
https://kawalpemilu.org#25900,"WARAKAS, TANJUNG PRIOK, JAKARTA UTARA, DKI JAKARTA",112,144,83,227
https://kawalpemilu.org#25900,"WARAKAS, TANJUNG PRIOK, JAKARTA UTARA, DKI JAKARTA",113,112,118,230
https://kawalpemilu.org#25900,"WARAKAS, TANJUNG PRIOK, JAKARTA UTARA, DKI JAKARTA",114,117,119,236
https://kawalpemilu.org#25900,"WARAKAS, TANJUNG PRIOK, JAKARTA UTARA, DKI JAKARTA",115,103,88,191
https://kawalpemilu.org#25900,"WARAKAS, TANJUNG PRIOK, JAKARTA UTARA, DKI JAKARTA",116,122,80,202
https://kawalpemilu.org#25900,"WARAKAS, TANJUNG PRIOK, JAKARTA UTARA, DKI JAKARTA",117,99,131,230
https://kawalpemilu.org#25900,"WARAKAS, TANJUNG PRIOK, JAKARTA UTARA, DKI JAKARTA",118,102,114,216
https://kawalpemilu.org#25900,"WARAKAS, TANJUNG PRIOK, JAKARTA UTARA, DKI JAKARTA",119,111,100,211
https://kawalpemilu.org#25900,"WARAKAS, TANJUNG PRIOK, JAKARTA UTARA, DKI JAKARTA",120,102,81,183
https://kawalpemilu.org#25900,"WARAKAS, TANJUNG PRIOK, JAKARTA UTARA, DKI JAKARTA",121,107,114,221
https://kawalpemilu.org#25900,"WARAKAS, TANJUNG PRIOK, JAKARTA UTARA, DKI JAKARTA",122,122,111,233
https://kawalpemilu.org#25900,"WARAKAS, TANJUNG PRIOK, JAKARTA UTARA, DKI JAKARTA",123,76,142,218
https://kawalpemilu.org#25900,"WARAKAS, TANJUNG PRIOK, JAKARTA UTARA, DKI JAKARTA",124,107,113,220
https://kawalpemilu.org#25900,"WARAKAS, TANJUNG PRIOK, JAKARTA UTARA, DKI JAKARTA",125,139,92,231
https://kawalpemilu.org#25900,"WARAKAS, TANJUNG PRIOK, JAKARTA UTARA, DKI JAKARTA",126,98,104,202
https://kawalpemilu.org#25900,"WARAKAS, TANJUNG PRIOK, JAKARTA UTARA, DKI JAKARTA",127,108,103,211
https://kawalpemilu.org#25900,"WARAKAS, TANJUNG PRIOK, JAKARTA UTARA, DKI JAKARTA",128,155,79,234
https://kawalpemilu.org#25900,"WARAKAS, TANJUNG PRIOK, JAKARTA UTARA, DKI JAKARTA",129,113,107,220
https://kawalpemilu.org#25900,"WARAKAS, TANJUNG PRIOK, JAKARTA UTARA, DKI JAKARTA",130,92,92,184
https://kawalpemilu.org#25900,"WARAKAS, TANJUNG PRIOK, JAKARTA UTARA, DKI JAKARTA",131,77,115,192
https://kawalpemilu.org#25900,"WARAKAS, TANJUNG PRIOK, JAKARTA UTARA, DKI JAKARTA",132,78,92,170
https://kawalpemilu.org#25900,"WARAKAS, TANJUNG PRIOK, JAKARTA UTARA, DKI JAKARTA",133,103,86,189
https://kawalpemilu.org#25900,"WARAKAS, TANJUNG PRIOK, JAKARTA UTARA, DKI JAKARTA",135,100,89,189
https://kawalpemilu.org#25900,"WARAKAS, TANJUNG PRIOK, JAKARTA UTARA, DKI JAKARTA",136,92,120,212
https://kawalpemilu.org#25900,"WARAKAS, TANJUNG PRIOK, JAKARTA UTARA, DKI JAKARTA",137,121,111,232
https://kawalpemilu.org#25900,"WARAKAS, TANJUNG PRIOK, JAKARTA UTARA, DKI JAKARTA",138,108,97,205
https://kawalpemilu.org#25900,"WARAKAS, TANJUNG PRIOK, JAKARTA UTARA, DKI JAKARTA",139,106,110,216
https://kawalpemilu.org#25900,"WARAKAS, TANJUNG PRIOK, JAKARTA UTARA, DKI JAKARTA",140,107,99,206
https://kawalpemilu.org#25902,"KOJA, KOJA, JAKARTA UTARA, DKI JAKARTA",1,105,84,189
https://kawalpemilu.org#25902,"KOJA, KOJA, JAKARTA UTARA, DKI JAKARTA",2,93,117,210
https://kawalpemilu.org#25902,"KOJA, KOJA, JAKARTA UTARA, DKI JAKARTA",3,74,135,209
https://kawalpemilu.org#25902,"KOJA, KOJA, JAKARTA UTARA, DKI JAKARTA",4,100,99,199
https://kawalpemilu.org#25902,"KOJA, KOJA, JAKARTA UTARA, DKI JAKARTA",5,114,100,214
https://kawalpemilu.org#25902,"KOJA, KOJA, JAKARTA UTARA, DKI JAKARTA",6,116,119,235
https://kawalpemilu.org#25902,"KOJA, KOJA, JAKARTA UTARA, DKI JAKARTA",7,117,119,236
https://kawalpemilu.org#25902,"KOJA, KOJA, JAKARTA UTARA, DKI JAKARTA",8,91,110,201
https://kawalpemilu.org#25902,"KOJA, KOJA, JAKARTA UTARA, DKI JAKARTA",9,108,85,193
https://kawalpemilu.org#25902,"KOJA, KOJA, JAKARTA UTARA, DKI JAKARTA",10,84,128,212
https://kawalpemilu.org#25902,"KOJA, KOJA, JAKARTA UTARA, DKI JAKARTA",11,93,97,190
https://kawalpemilu.org#25902,"KOJA, KOJA, JAKARTA UTARA, DKI JAKARTA",12,59,104,163
https://kawalpemilu.org#25902,"KOJA, KOJA, JAKARTA UTARA, DKI JAKARTA",13,101,95,196
https://kawalpemilu.org#25902,"KOJA, KOJA, JAKARTA UTARA, DKI JAKARTA",14,119,113,232
https://kawalpemilu.org#25902,"KOJA, KOJA, JAKARTA UTARA, DKI JAKARTA",15,89,88,177
https://kawalpemilu.org#25902,"KOJA, KOJA, JAKARTA UTARA, DKI JAKARTA",16,88,134,222
https://kawalpemilu.org#25902,"KOJA, KOJA, JAKARTA UTARA, DKI JAKARTA",17,80,155,235
https://kawalpemilu.org#25902,"KOJA, KOJA, JAKARTA UTARA, DKI JAKARTA",18,123,67,190
https://kawalpemilu.org#25902,"KOJA, KOJA, JAKARTA UTARA, DKI JAKARTA",19,111,88,199
https://kawalpemilu.org#25902,"KOJA, KOJA, JAKARTA UTARA, DKI JAKARTA",20,78,116,194
https://kawalpemilu.org#25902,"KOJA, KOJA, JAKARTA UTARA, DKI JAKARTA",21,90,107,197
https://kawalpemilu.org#25902,"KOJA, KOJA, JAKARTA UTARA, DKI JAKARTA",22,88,67,155
https://kawalpemilu.org#25902,"KOJA, KOJA, JAKARTA UTARA, DKI JAKARTA",23,106,117,223
https://kawalpemilu.org#25902,"KOJA, KOJA, JAKARTA UTARA, DKI JAKARTA",24,91,103,194
https://kawalpemilu.org#25902,"KOJA, KOJA, JAKARTA UTARA, DKI JAKARTA",25,81,112,193
https://kawalpemilu.org#25902,"KOJA, KOJA, JAKARTA UTARA, DKI JAKARTA",26,66,86,152
https://kawalpemilu.org#25902,"KOJA, KOJA, JAKARTA UTARA, DKI JAKARTA",27,71,102,173
https://kawalpemilu.org#25902,"KOJA, KOJA, JAKARTA UTARA, DKI JAKARTA",28,79,112,191
https://kawalpemilu.org#25902,"KOJA, KOJA, JAKARTA UTARA, DKI JAKARTA",29,90,112,202
https://kawalpemilu.org#25902,"KOJA, KOJA, JAKARTA UTARA, DKI JAKARTA",30,68,160,228
https://kawalpemilu.org#25902,"KOJA, KOJA, JAKARTA UTARA, DKI JAKARTA",31,109,150,259
https://kawalpemilu.org#25902,"KOJA, KOJA, JAKARTA UTARA, DKI JAKARTA",32,151,71,222
https://kawalpemilu.org#25902,"KOJA, KOJA, JAKARTA UTARA, DKI JAKARTA",33,106,131,237
https://kawalpemilu.org#25902,"KOJA, KOJA, JAKARTA UTARA, DKI JAKARTA",34,112,120,232
https://kawalpemilu.org#25902,"KOJA, KOJA, JAKARTA UTARA, DKI JAKARTA",35,136,81,217
https://kawalpemilu.org#25902,"KOJA, KOJA, JAKARTA UTARA, DKI JAKARTA",36,98,77,175
https://kawalpemilu.org#25902,"KOJA, KOJA, JAKARTA UTARA, DKI JAKARTA",37,126,91,217
https://kawalpemilu.org#25902,"KOJA, KOJA, JAKARTA UTARA, DKI JAKARTA",38,85,115,200
https://kawalpemilu.org#25902,"KOJA, KOJA, JAKARTA UTARA, DKI JAKARTA",39,70,125,195
https://kawalpemilu.org#25902,"KOJA, KOJA, JAKARTA UTARA, DKI JAKARTA",40,97,124,221
https://kawalpemilu.org#25902,"KOJA, KOJA, JAKARTA UTARA, DKI JAKARTA",41,76,134,210
https://kawalpemilu.org#25902,"KOJA, KOJA, JAKARTA UTARA, DKI JAKARTA",42,103,111,214
https://kawalpemilu.org#25902,"KOJA, KOJA, JAKARTA UTARA, DKI JAKARTA",43,112,74,186
https://kawalpemilu.org#25902,"KOJA, KOJA, JAKARTA UTARA, DKI JAKARTA",44,101,99,200
https://kawalpemilu.org#25902,"KOJA, KOJA, JAKARTA UTARA, DKI JAKARTA",45,102,94,196
https://kawalpemilu.org#25902,"KOJA, KOJA, JAKARTA UTARA, DKI JAKARTA",46,120,98,218
https://kawalpemilu.org#25902,"KOJA, KOJA, JAKARTA UTARA, DKI JAKARTA",47,107,119,226
https://kawalpemilu.org#25902,"KOJA, KOJA, JAKARTA UTARA, DKI JAKARTA",48,121,94,215
https://kawalpemilu.org#25902,"KOJA, KOJA, JAKARTA UTARA, DKI JAKARTA",49,117,136,253
https://kawalpemilu.org#25902,"KOJA, KOJA, JAKARTA UTARA, DKI JAKARTA",50,117,123,240
https://kawalpemilu.org#25902,"KOJA, KOJA, JAKARTA UTARA, DKI JAKARTA",51,132,129,261
https://kawalpemilu.org#25902,"KOJA, KOJA, JAKARTA UTARA, DKI JAKARTA",52,83,146,229
https://kawalpemilu.org#25902,"KOJA, KOJA, JAKARTA UTARA, DKI JAKARTA",53,98,129,227
https://kawalpemilu.org#25902,"KOJA, KOJA, JAKARTA UTARA, DKI JAKARTA",54,143,84,227
https://kawalpemilu.org#25902,"KOJA, KOJA, JAKARTA UTARA, DKI JAKARTA",55,115,99,214
https://kawalpemilu.org#25902,"KOJA, KOJA, JAKARTA UTARA, DKI JAKARTA",56,138,108,246
https://kawalpemilu.org#25902,"KOJA, KOJA, JAKARTA UTARA, DKI JAKARTA",57,106,134,242
https://kawalpemilu.org#25902,"KOJA, KOJA, JAKARTA UTARA, DKI JAKARTA",58,109,97,203
https://kawalpemilu.org#25902,"KOJA, KOJA, JAKARTA UTARA, DKI JAKARTA",59,64,162,226
https://kawalpemilu.org#25902,"KOJA, KOJA, JAKARTA UTARA, DKI JAKARTA",60,78,156,234
https://kawalpemilu.org#25902,"KOJA, KOJA, JAKARTA UTARA, DKI JAKARTA",61,92,136,228
https://kawalpemilu.org#25902,"KOJA, KOJA, JAKARTA UTARA, DKI JAKARTA",63,73,128,201
https://kawalpemilu.org#25902,"KOJA, KOJA, JAKARTA UTARA, DKI JAKARTA",64,64,145,209
https://kawalpemilu.org#25902,"KOJA, KOJA, JAKARTA UTARA, DKI JAKARTA",65,95,121,216
https://kawalpemilu.org#25902,"KOJA, KOJA, JAKARTA UTARA, DKI JAKARTA",66,74,135,209
https://kawalpemilu.org#25902,"KOJA, KOJA, JAKARTA UTARA, DKI JAKARTA",67,91,116,207
https://kawalpemilu.org#25902,"KOJA, KOJA, JAKARTA UTARA, DKI JAKARTA",68,78,124,202
https://kawalpemilu.org#25902,"KOJA, KOJA, JAKARTA UTARA, DKI JAKARTA",69,79,124,203
https://kawalpemilu.org#25902,"KOJA, KOJA, JAKARTA UTARA, DKI JAKARTA",70,127,107,234
https://kawalpemilu.org#25902,"KOJA, KOJA, JAKARTA UTARA, DKI JAKARTA",71,78,104,182
https://kawalpemilu.org#25902,"KOJA, KOJA, JAKARTA UTARA, DKI JAKARTA",72,133,90,223
https://kawalpemilu.org#25902,"KOJA, KOJA, JAKARTA UTARA, DKI JAKARTA",73,143,123,266
https://kawalpemilu.org#25902,"KOJA, KOJA, JAKARTA UTARA, DKI JAKARTA",74,100,144,244
https://kawalpemilu.org#25902,"KOJA, KOJA, JAKARTA UTARA, DKI JAKARTA",75,116,123,239
https://kawalpemilu.org#25902,"KOJA, KOJA, JAKARTA UTARA, DKI JAKARTA",76,110,98,208
https://kawalpemilu.org#25902,"KOJA, KOJA, JAKARTA UTARA, DKI JAKARTA",77,90,117,207
https://kawalpemilu.org#25902,"KOJA, KOJA, JAKARTA UTARA, DKI JAKARTA",78,97,107,204
https://kawalpemilu.org#25902,"KOJA, KOJA, JAKARTA UTARA, DKI JAKARTA",79,124,118,242
https://kawalpemilu.org#25902,"KOJA, KOJA, JAKARTA UTARA, DKI JAKARTA",80,153,90,243
https://kawalpemilu.org#25902,"KOJA, KOJA, JAKARTA UTARA, DKI JAKARTA",81,125,124,249
https://kawalpemilu.org#25902,"KOJA, KOJA, JAKARTA UTARA, DKI JAKARTA",82,115,93,208
https://kawalpemilu.org#25902,"KOJA, KOJA, JAKARTA UTARA, DKI JAKARTA",83,64,165,229
https://kawalpemilu.org#25902,"KOJA, KOJA, JAKARTA UTARA, DKI JAKARTA",84,0,0,0
https://kawalpemilu.org#25902,"KOJA, KOJA, JAKARTA UTARA, DKI JAKARTA",85,85,91,176
https://kawalpemilu.org#25902,"KOJA, KOJA, JAKARTA UTARA, DKI JAKARTA",86,107,71,178
https://kawalpemilu.org#25902,"KOJA, KOJA, JAKARTA UTARA, DKI JAKARTA",87,75,138,213
https://kawalpemilu.org#25902,"KOJA, KOJA, JAKARTA UTARA, DKI JAKARTA",88,97,152,249
https://kawalpemilu.org#25902,"KOJA, KOJA, JAKARTA UTARA, DKI JAKARTA",89,84,142,226
https://kawalpemilu.org#25903,"TUGU UTARA, KOJA, JAKARTA UTARA, DKI JAKARTA",1,115,63,178
https://kawalpemilu.org#25903,"TUGU UTARA, KOJA, JAKARTA UTARA, DKI JAKARTA",2,93,114,207
https://kawalpemilu.org#25903,"TUGU UTARA, KOJA, JAKARTA UTARA, DKI JAKARTA",3,100,93,193
https://kawalpemilu.org#25903,"TUGU UTARA, KOJA, JAKARTA UTARA, DKI JAKARTA",4,79,117,196
https://kawalpemilu.org#25903,"TUGU UTARA, KOJA, JAKARTA UTARA, DKI JAKARTA",5,130,108,238
https://kawalpemilu.org#25903,"TUGU UTARA, KOJA, JAKARTA UTARA, DKI JAKARTA",6,110,117,227
https://kawalpemilu.org#25903,"TUGU UTARA, KOJA, JAKARTA UTARA, DKI JAKARTA",7,114,144,258
https://kawalpemilu.org#25903,"TUGU UTARA, KOJA, JAKARTA UTARA, DKI JAKARTA",8,107,128,235
https://kawalpemilu.org#25903,"TUGU UTARA, KOJA, JAKARTA UTARA, DKI JAKARTA",9,89,136,225
https://kawalpemilu.org#25903,"TUGU UTARA, KOJA, JAKARTA UTARA, DKI JAKARTA",10,112,131,243
https://kawalpemilu.org#25903,"TUGU UTARA, KOJA, JAKARTA UTARA, DKI JAKARTA",11,100,123,223
https://kawalpemilu.org#25903,"TUGU UTARA, KOJA, JAKARTA UTARA, DKI JAKARTA",12,71,133,204
https://kawalpemilu.org#25903,"TUGU UTARA, KOJA, JAKARTA UTARA, DKI JAKARTA",13,107,100,207
https://kawalpemilu.org#25903,"TUGU UTARA, KOJA, JAKARTA UTARA, DKI JAKARTA",14,134,138,272
https://kawalpemilu.org#25903,"TUGU UTARA, KOJA, JAKARTA UTARA, DKI JAKARTA",15,149,121,270
https://kawalpemilu.org#25903,"TUGU UTARA, KOJA, JAKARTA UTARA, DKI JAKARTA",16,168,87,255
https://kawalpemilu.org#25903,"TUGU UTARA, KOJA, JAKARTA UTARA, DKI JAKARTA",17,92,108,200
https://kawalpemilu.org#25903,"TUGU UTARA, KOJA, JAKARTA UTARA, DKI JAKARTA",18,99,163,262
https://kawalpemilu.org#25903,"TUGU UTARA, KOJA, JAKARTA UTARA, DKI JAKARTA",19,133,124,257
https://kawalpemilu.org#25903,"TUGU UTARA, KOJA, JAKARTA UTARA, DKI JAKARTA",20,127,114,241
https://kawalpemilu.org#25903,"TUGU UTARA, KOJA, JAKARTA UTARA, DKI JAKARTA",21,75,91,166
https://kawalpemilu.org#25903,"TUGU UTARA, KOJA, JAKARTA UTARA, DKI JAKARTA",22,72,105,177
https://kawalpemilu.org#25903,"TUGU UTARA, KOJA, JAKARTA UTARA, DKI JAKARTA",23,91,92,183
https://kawalpemilu.org#25903,"TUGU UTARA, KOJA, JAKARTA UTARA, DKI JAKARTA",24,138,107,245
https://kawalpemilu.org#25903,"TUGU UTARA, KOJA, JAKARTA UTARA, DKI JAKARTA",25,105,143,248
https://kawalpemilu.org#25903,"TUGU UTARA, KOJA, JAKARTA UTARA, DKI JAKARTA",26,96,142,238
https://kawalpemilu.org#25903,"TUGU UTARA, KOJA, JAKARTA UTARA, DKI JAKARTA",27,103,138,241
https://kawalpemilu.org#25903,"TUGU UTARA, KOJA, JAKARTA UTARA, DKI JAKARTA",28,105,120,225
https://kawalpemilu.org#25903,"TUGU UTARA, KOJA, JAKARTA UTARA, DKI JAKARTA",29,129,108,237
https://kawalpemilu.org#25903,"TUGU UTARA, KOJA, JAKARTA UTARA, DKI JAKARTA",30,149,132,281
https://kawalpemilu.org#25903,"TUGU UTARA, KOJA, JAKARTA UTARA, DKI JAKARTA",31,111,114,225
https://kawalpemilu.org#25903,"TUGU UTARA, KOJA, JAKARTA UTARA, DKI JAKARTA",32,113,121,234
https://kawalpemilu.org#25903,"TUGU UTARA, KOJA, JAKARTA UTARA, DKI JAKARTA",33,120,118,238
https://kawalpemilu.org#25903,"TUGU UTARA, KOJA, JAKARTA UTARA, DKI JAKARTA",34,110,106,216
https://kawalpemilu.org#25903,"TUGU UTARA, KOJA, JAKARTA UTARA, DKI JAKARTA",35,74,183,257
https://kawalpemilu.org#25903,"TUGU UTARA, KOJA, JAKARTA UTARA, DKI JAKARTA",36,83,156,239
https://kawalpemilu.org#25903,"TUGU UTARA, KOJA, JAKARTA UTARA, DKI JAKARTA",37,74,193,267
https://kawalpemilu.org#25903,"TUGU UTARA, KOJA, JAKARTA UTARA, DKI JAKARTA",38,75,152,227
https://kawalpemilu.org#25903,"TUGU UTARA, KOJA, JAKARTA UTARA, DKI JAKARTA",39,106,155,261
https://kawalpemilu.org#25903,"TUGU UTARA, KOJA, JAKARTA UTARA, DKI JAKARTA",40,105,133,238
https://kawalpemilu.org#25903,"TUGU UTARA, KOJA, JAKARTA UTARA, DKI JAKARTA",41,92,119,211
https://kawalpemilu.org#25903,"TUGU UTARA, KOJA, JAKARTA UTARA, DKI JAKARTA",42,84,129,213
https://kawalpemilu.org#25903,"TUGU UTARA, KOJA, JAKARTA UTARA, DKI JAKARTA",43,111,96,207
https://kawalpemilu.org#25903,"TUGU UTARA, KOJA, JAKARTA UTARA, DKI JAKARTA",44,101,119,220
https://kawalpemilu.org#25903,"TUGU UTARA, KOJA, JAKARTA UTARA, DKI JAKARTA",45,92,88,180
https://kawalpemilu.org#25903,"TUGU UTARA, KOJA, JAKARTA UTARA, DKI JAKARTA",46,102,85,187
https://kawalpemilu.org#25903,"TUGU UTARA, KOJA, JAKARTA UTARA, DKI JAKARTA",47,126,72,198
https://kawalpemilu.org#25903,"TUGU UTARA, KOJA, JAKARTA UTARA, DKI JAKARTA",48,91,136,227
https://kawalpemilu.org#25903,"TUGU UTARA, KOJA, JAKARTA UTARA, DKI JAKARTA",49,117,139,256
https://kawalpemilu.org#25903,"TUGU UTARA, KOJA, JAKARTA UTARA, DKI JAKARTA",50,91,126,217
https://kawalpemilu.org#25903,"TUGU UTARA, KOJA, JAKARTA UTARA, DKI JAKARTA",51,99,135,234
https://kawalpemilu.org#25903,"TUGU UTARA, KOJA, JAKARTA UTARA, DKI JAKARTA",52,121,113,234
https://kawalpemilu.org#25903,"TUGU UTARA, KOJA, JAKARTA UTARA, DKI JAKARTA",53,120,114,234
https://kawalpemilu.org#25903,"TUGU UTARA, KOJA, JAKARTA UTARA, DKI JAKARTA",54,105,134,239
https://kawalpemilu.org#25903,"TUGU UTARA, KOJA, JAKARTA UTARA, DKI JAKARTA",55,129,129,258
https://kawalpemilu.org#25903,"TUGU UTARA, KOJA, JAKARTA UTARA, DKI JAKARTA",56,73,147,220
https://kawalpemilu.org#25903,"TUGU UTARA, KOJA, JAKARTA UTARA, DKI JAKARTA",57,77,132,209
https://kawalpemilu.org#25903,"TUGU UTARA, KOJA, JAKARTA UTARA, DKI JAKARTA",58,92,114,206
https://kawalpemilu.org#25903,"TUGU UTARA, KOJA, JAKARTA UTARA, DKI JAKARTA",59,126,138,264
https://kawalpemilu.org#25903,"TUGU UTARA, KOJA, JAKARTA UTARA, DKI JAKARTA",60,108,159,267
https://kawalpemilu.org#25903,"TUGU UTARA, KOJA, JAKARTA UTARA, DKI JAKARTA",61,90,158,248
https://kawalpemilu.org#25903,"TUGU UTARA, KOJA, JAKARTA UTARA, DKI JAKARTA",62,79,185,264
https://kawalpemilu.org#25903,"TUGU UTARA, KOJA, JAKARTA UTARA, DKI JAKARTA",63,144,102,246
https://kawalpemilu.org#25903,"TUGU UTARA, KOJA, JAKARTA UTARA, DKI JAKARTA",64,140,96,236
https://kawalpemilu.org#25903,"TUGU UTARA, KOJA, JAKARTA UTARA, DKI JAKARTA",65,127,98,225
https://kawalpemilu.org#25903,"TUGU UTARA, KOJA, JAKARTA UTARA, DKI JAKARTA",66,155,102,257
https://kawalpemilu.org#25903,"TUGU UTARA, KOJA, JAKARTA UTARA, DKI JAKARTA",67,138,97,235
https://kawalpemilu.org#25903,"TUGU UTARA, KOJA, JAKARTA UTARA, DKI JAKARTA",68,80,147,227
https://kawalpemilu.org#25903,"TUGU UTARA, KOJA, JAKARTA UTARA, DKI JAKARTA",69,93,136,229
https://kawalpemilu.org#25903,"TUGU UTARA, KOJA, JAKARTA UTARA, DKI JAKARTA",70,103,74,177
https://kawalpemilu.org#25903,"TUGU UTARA, KOJA, JAKARTA UTARA, DKI JAKARTA",71,168,71,239
https://kawalpemilu.org#25903,"TUGU UTARA, KOJA, JAKARTA UTARA, DKI JAKARTA",72,120,51,171
https://kawalpemilu.org#25903,"TUGU UTARA, KOJA, JAKARTA UTARA, DKI JAKARTA",73,93,142,239
https://kawalpemilu.org#25903,"TUGU UTARA, KOJA, JAKARTA UTARA, DKI JAKARTA",74,93,152,245
https://kawalpemilu.org#25903,"TUGU UTARA, KOJA, JAKARTA UTARA, DKI JAKARTA",75,94,153,247
https://kawalpemilu.org#25903,"TUGU UTARA, KOJA, JAKARTA UTARA, DKI JAKARTA",76,115,120,235
https://kawalpemilu.org#25903,"TUGU UTARA, KOJA, JAKARTA UTARA, DKI JAKARTA",77,121,107,228
https://kawalpemilu.org#25903,"TUGU UTARA, KOJA, JAKARTA UTARA, DKI JAKARTA",78,97,146,243
https://kawalpemilu.org#25903,"TUGU UTARA, KOJA, JAKARTA UTARA, DKI JAKARTA",79,102,107,209
https://kawalpemilu.org#25903,"TUGU UTARA, KOJA, JAKARTA UTARA, DKI JAKARTA",80,95,152,247
https://kawalpemilu.org#25903,"TUGU UTARA, KOJA, JAKARTA UTARA, DKI JAKARTA",81,94,151,245
https://kawalpemilu.org#25903,"TUGU UTARA, KOJA, JAKARTA UTARA, DKI JAKARTA",82,105,124,229
https://kawalpemilu.org#25903,"TUGU UTARA, KOJA, JAKARTA UTARA, DKI JAKARTA",83,111,126,237
https://kawalpemilu.org#25903,"TUGU UTARA, KOJA, JAKARTA UTARA, DKI JAKARTA",84,104,146,250
https://kawalpemilu.org#25903,"TUGU UTARA, KOJA, JAKARTA UTARA, DKI JAKARTA",85,120,114,234
https://kawalpemilu.org#25903,"TUGU UTARA, KOJA, JAKARTA UTARA, DKI JAKARTA",86,116,114,230
https://kawalpemilu.org#25903,"TUGU UTARA, KOJA, JAKARTA UTARA, DKI JAKARTA",87,110,106,216
https://kawalpemilu.org#25903,"TUGU UTARA, KOJA, JAKARTA UTARA, DKI JAKARTA",88,120,136,256
https://kawalpemilu.org#25903,"TUGU UTARA, KOJA, JAKARTA UTARA, DKI JAKARTA",89,89,186,275
https://kawalpemilu.org#25903,"TUGU UTARA, KOJA, JAKARTA UTARA, DKI JAKARTA",90,113,146,259
https://kawalpemilu.org#25903,"TUGU UTARA, KOJA, JAKARTA UTARA, DKI JAKARTA",91,135,133,268
https://kawalpemilu.org#25903,"TUGU UTARA, KOJA, JAKARTA UTARA, DKI JAKARTA",92,145,106,251
https://kawalpemilu.org#25903,"TUGU UTARA, KOJA, JAKARTA UTARA, DKI JAKARTA",93,107,125,232
https://kawalpemilu.org#25903,"TUGU UTARA, KOJA, JAKARTA UTARA, DKI JAKARTA",94,157,115,272
https://kawalpemilu.org#25903,"TUGU UTARA, KOJA, JAKARTA UTARA, DKI JAKARTA",95,133,96,229
https://kawalpemilu.org#25903,"TUGU UTARA, KOJA, JAKARTA UTARA, DKI JAKARTA",96,147,120,267
https://kawalpemilu.org#25903,"TUGU UTARA, KOJA, JAKARTA UTARA, DKI JAKARTA",97,135,95,230
https://kawalpemilu.org#25903,"TUGU UTARA, KOJA, JAKARTA UTARA, DKI JAKARTA",98,147,127,274
https://kawalpemilu.org#25903,"TUGU UTARA, KOJA, JAKARTA UTARA, DKI JAKARTA",99,127,130,257
https://kawalpemilu.org#25903,"TUGU UTARA, KOJA, JAKARTA UTARA, DKI JAKARTA",100,131,156,287
https://kawalpemilu.org#25903,"TUGU UTARA, KOJA, JAKARTA UTARA, DKI JAKARTA",101,111,144,226
https://kawalpemilu.org#25903,"TUGU UTARA, KOJA, JAKARTA UTARA, DKI JAKARTA",102,116,109,225
https://kawalpemilu.org#25903,"TUGU UTARA, KOJA, JAKARTA UTARA, DKI JAKARTA",103,93,145,238
https://kawalpemilu.org#25903,"TUGU UTARA, KOJA, JAKARTA UTARA, DKI JAKARTA",104,106,143,249
https://kawalpemilu.org#25903,"TUGU UTARA, KOJA, JAKARTA UTARA, DKI JAKARTA",105,137,113,250
https://kawalpemilu.org#25903,"TUGU UTARA, KOJA, JAKARTA UTARA, DKI JAKARTA",106,103,132,235
https://kawalpemilu.org#25903,"TUGU UTARA, KOJA, JAKARTA UTARA, DKI JAKARTA",107,110,140,250
https://kawalpemilu.org#25903,"TUGU UTARA, KOJA, JAKARTA UTARA, DKI JAKARTA",108,103,145,248
https://kawalpemilu.org#25903,"TUGU UTARA, KOJA, JAKARTA UTARA, DKI JAKARTA",109,92,134,226
https://kawalpemilu.org#25903,"TUGU UTARA, KOJA, JAKARTA UTARA, DKI JAKARTA",111,119,137,256
https://kawalpemilu.org#25903,"TUGU UTARA, KOJA, JAKARTA UTARA, DKI JAKARTA",112,113,114,227
https://kawalpemilu.org#25903,"TUGU UTARA, KOJA, JAKARTA UTARA, DKI JAKARTA",113,103,123,226
https://kawalpemilu.org#25903,"TUGU UTARA, KOJA, JAKARTA UTARA, DKI JAKARTA",114,89,145,234
https://kawalpemilu.org#25903,"TUGU UTARA, KOJA, JAKARTA UTARA, DKI JAKARTA",115,98,145,243
https://kawalpemilu.org#25903,"TUGU UTARA, KOJA, JAKARTA UTARA, DKI JAKARTA",116,114,120,234
https://kawalpemilu.org#25903,"TUGU UTARA, KOJA, JAKARTA UTARA, DKI JAKARTA",119,101,111,212
https://kawalpemilu.org#25903,"TUGU UTARA, KOJA, JAKARTA UTARA, DKI JAKARTA",120,97,121,218
https://kawalpemilu.org#25903,"TUGU UTARA, KOJA, JAKARTA UTARA, DKI JAKARTA",121,119,121,240
https://kawalpemilu.org#25903,"TUGU UTARA, KOJA, JAKARTA UTARA, DKI JAKARTA",122,101,96,197
https://kawalpemilu.org#25903,"TUGU UTARA, KOJA, JAKARTA UTARA, DKI JAKARTA",123,118,121,239
https://kawalpemilu.org#25903,"TUGU UTARA, KOJA, JAKARTA UTARA, DKI JAKARTA",124,119,138,257
https://kawalpemilu.org#25903,"TUGU UTARA, KOJA, JAKARTA UTARA, DKI JAKARTA",125,112,126,238
https://kawalpemilu.org#25903,"TUGU UTARA, KOJA, JAKARTA UTARA, DKI JAKARTA",126,103,149,252
https://kawalpemilu.org#25903,"TUGU UTARA, KOJA, JAKARTA UTARA, DKI JAKARTA",127,79,151,230
https://kawalpemilu.org#25903,"TUGU UTARA, KOJA, JAKARTA UTARA, DKI JAKARTA",128,101,130,231
https://kawalpemilu.org#25903,"TUGU UTARA, KOJA, JAKARTA UTARA, DKI JAKARTA",129,104,135,239
https://kawalpemilu.org#25903,"TUGU UTARA, KOJA, JAKARTA UTARA, DKI JAKARTA",130,102,142,244
https://kawalpemilu.org#25903,"TUGU UTARA, KOJA, JAKARTA UTARA, DKI JAKARTA",131,89,140,229
https://kawalpemilu.org#25903,"TUGU UTARA, KOJA, JAKARTA UTARA, DKI JAKARTA",132,97,139,236
https://kawalpemilu.org#25903,"TUGU UTARA, KOJA, JAKARTA UTARA, DKI JAKARTA",133,105,181,286
https://kawalpemilu.org#25903,"TUGU UTARA, KOJA, JAKARTA UTARA, DKI JAKARTA",134,91,170,261
https://kawalpemilu.org#25903,"TUGU UTARA, KOJA, JAKARTA UTARA, DKI JAKARTA",135,102,138,240
https://kawalpemilu.org#25903,"TUGU UTARA, KOJA, JAKARTA UTARA, DKI JAKARTA",136,124,127,251
https://kawalpemilu.org#25903,"TUGU UTARA, KOJA, JAKARTA UTARA, DKI JAKARTA",137,125,148,273
https://kawalpemilu.org#25903,"TUGU UTARA, KOJA, JAKARTA UTARA, DKI JAKARTA",138,117,150,267
https://kawalpemilu.org#25903,"TUGU UTARA, KOJA, JAKARTA UTARA, DKI JAKARTA",139,129,101,230
https://kawalpemilu.org#25903,"TUGU UTARA, KOJA, JAKARTA UTARA, DKI JAKARTA",140,86,174,260
https://kawalpemilu.org#25903,"TUGU UTARA, KOJA, JAKARTA UTARA, DKI JAKARTA",141,93,125,218
https://kawalpemilu.org#25903,"TUGU UTARA, KOJA, JAKARTA UTARA, DKI JAKARTA",142,105,99,204
https://kawalpemilu.org#25903,"TUGU UTARA, KOJA, JAKARTA UTARA, DKI JAKARTA",143,91,96,187
https://kawalpemilu.org#25903,"TUGU UTARA, KOJA, JAKARTA UTARA, DKI JAKARTA",144,117,141,258
https://kawalpemilu.org#25903,"TUGU UTARA, KOJA, JAKARTA UTARA, DKI JAKARTA",145,69,121,190
https://kawalpemilu.org#25903,"TUGU UTARA, KOJA, JAKARTA UTARA, DKI JAKARTA",146,87,137,224
https://kawalpemilu.org#25903,"TUGU UTARA, KOJA, JAKARTA UTARA, DKI JAKARTA",147,136,104,240
https://kawalpemilu.org#25903,"TUGU UTARA, KOJA, JAKARTA UTARA, DKI JAKARTA",148,101,116,217
https://kawalpemilu.org#25903,"TUGU UTARA, KOJA, JAKARTA UTARA, DKI JAKARTA",149,111,97,208
https://kawalpemilu.org#25903,"TUGU UTARA, KOJA, JAKARTA UTARA, DKI JAKARTA",150,102,121,223
https://kawalpemilu.org#25903,"TUGU UTARA, KOJA, JAKARTA UTARA, DKI JAKARTA",151,88,171,259
https://kawalpemilu.org#25903,"TUGU UTARA, KOJA, JAKARTA UTARA, DKI JAKARTA",152,83,124,207
https://kawalpemilu.org#25903,"TUGU UTARA, KOJA, JAKARTA UTARA, DKI JAKARTA",153,104,113,217
https://kawalpemilu.org#25903,"TUGU UTARA, KOJA, JAKARTA UTARA, DKI JAKARTA",154,93,109,202
https://kawalpemilu.org#25903,"TUGU UTARA, KOJA, JAKARTA UTARA, DKI JAKARTA",155,123,103,226
https://kawalpemilu.org#25903,"TUGU UTARA, KOJA, JAKARTA UTARA, DKI JAKARTA",156,128,90,218
https://kawalpemilu.org#25903,"TUGU UTARA, KOJA, JAKARTA UTARA, DKI JAKARTA",157,133,85,218
https://kawalpemilu.org#25903,"TUGU UTARA, KOJA, JAKARTA UTARA, DKI JAKARTA",158,148,62,210
https://kawalpemilu.org#25903,"TUGU UTARA, KOJA, JAKARTA UTARA, DKI JAKARTA",159,115,91,206
https://kawalpemilu.org#25903,"TUGU UTARA, KOJA, JAKARTA UTARA, DKI JAKARTA",160,156,91,247
https://kawalpemilu.org#25903,"TUGU UTARA, KOJA, JAKARTA UTARA, DKI JAKARTA",161,122,145,267
https://kawalpemilu.org#25903,"TUGU UTARA, KOJA, JAKARTA UTARA, DKI JAKARTA",162,110,150,260
https://kawalpemilu.org#25903,"TUGU UTARA, KOJA, JAKARTA UTARA, DKI JAKARTA",163,147,84,231
https://kawalpemilu.org#25903,"TUGU UTARA, KOJA, JAKARTA UTARA, DKI JAKARTA",164,145,117,262
https://kawalpemilu.org#25903,"TUGU UTARA, KOJA, JAKARTA UTARA, DKI JAKARTA",165,151,90,241
https://kawalpemilu.org#25903,"TUGU UTARA, KOJA, JAKARTA UTARA, DKI JAKARTA",166,109,103,212
https://kawalpemilu.org#25903,"TUGU UTARA, KOJA, JAKARTA UTARA, DKI JAKARTA",167,159,74,233
https://kawalpemilu.org#25903,"TUGU UTARA, KOJA, JAKARTA UTARA, DKI JAKARTA",168,138,108,246
https://kawalpemilu.org#25903,"TUGU UTARA, KOJA, JAKARTA UTARA, DKI JAKARTA",169,131,101,232
https://kawalpemilu.org#25903,"TUGU UTARA, KOJA, JAKARTA UTARA, DKI JAKARTA",171,104,129,233
https://kawalpemilu.org#25903,"TUGU UTARA, KOJA, JAKARTA UTARA, DKI JAKARTA",172,151,107,258
https://kawalpemilu.org#25903,"TUGU UTARA, KOJA, JAKARTA UTARA, DKI JAKARTA",173,105,135,240
https://kawalpemilu.org#25903,"TUGU UTARA, KOJA, JAKARTA UTARA, DKI JAKARTA",174,110,122,232
https://kawalpemilu.org#25903,"TUGU UTARA, KOJA, JAKARTA UTARA, DKI JAKARTA",175,109,145,254
https://kawalpemilu.org#25903,"TUGU UTARA, KOJA, JAKARTA UTARA, DKI JAKARTA",176,113,149,262
https://kawalpemilu.org#25903,"TUGU UTARA, KOJA, JAKARTA UTARA, DKI JAKARTA",177,127,116,243
https://kawalpemilu.org#25903,"TUGU UTARA, KOJA, JAKARTA UTARA, DKI JAKARTA",178,127,129,256
https://kawalpemilu.org#25903,"TUGU UTARA, KOJA, JAKARTA UTARA, DKI JAKARTA",179,149,108,257
https://kawalpemilu.org#25903,"TUGU UTARA, KOJA, JAKARTA UTARA, DKI JAKARTA",180,124,120,244
https://kawalpemilu.org#25903,"TUGU UTARA, KOJA, JAKARTA UTARA, DKI JAKARTA",181,130,96,226
https://kawalpemilu.org#25903,"TUGU UTARA, KOJA, JAKARTA UTARA, DKI JAKARTA",183,123,100,223
https://kawalpemilu.org#25903,"TUGU UTARA, KOJA, JAKARTA UTARA, DKI JAKARTA",184,139,132,271
https://kawalpemilu.org#25903,"TUGU UTARA, KOJA, JAKARTA UTARA, DKI JAKARTA",185,105,129,3
https://kawalpemilu.org#25903,"TUGU UTARA, KOJA, JAKARTA UTARA, DKI JAKARTA",186,109,114,223
https://kawalpemilu.org#25903,"TUGU UTARA, KOJA, JAKARTA UTARA, DKI JAKARTA",187,137,104,241
https://kawalpemilu.org#25903,"TUGU UTARA, KOJA, JAKARTA UTARA, DKI JAKARTA",188,169,74,243
https://kawalpemilu.org#25903,"TUGU UTARA, KOJA, JAKARTA UTARA, DKI JAKARTA",189,167,80,247
https://kawalpemilu.org#25903,"TUGU UTARA, KOJA, JAKARTA UTARA, DKI JAKARTA",190,171,67,238
https://kawalpemilu.org#25903,"TUGU UTARA, KOJA, JAKARTA UTARA, DKI JAKARTA",191,147,96,243
https://kawalpemilu.org#25903,"TUGU UTARA, KOJA, JAKARTA UTARA, DKI JAKARTA",192,155,55,210
https://kawalpemilu.org#25903,"TUGU UTARA, KOJA, JAKARTA UTARA, DKI JAKARTA",193,152,69,221
https://kawalpemilu.org#25904,"LAGOA, KOJA, JAKARTA UTARA, DKI JAKARTA",1,116,95,211
https://kawalpemilu.org#25904,"LAGOA, KOJA, JAKARTA UTARA, DKI JAKARTA",2,102,120,222
https://kawalpemilu.org#25904,"LAGOA, KOJA, JAKARTA UTARA, DKI JAKARTA",3,122,108,230
https://kawalpemilu.org#25904,"LAGOA, KOJA, JAKARTA UTARA, DKI JAKARTA",4,150,90,240
https://kawalpemilu.org#25904,"LAGOA, KOJA, JAKARTA UTARA, DKI JAKARTA",5,157,91,248
https://kawalpemilu.org#25904,"LAGOA, KOJA, JAKARTA UTARA, DKI JAKARTA",6,119,108,227
https://kawalpemilu.org#25904,"LAGOA, KOJA, JAKARTA UTARA, DKI JAKARTA",7,100,100,200
https://kawalpemilu.org#25904,"LAGOA, KOJA, JAKARTA UTARA, DKI JAKARTA",8,92,141,233
https://kawalpemilu.org#25904,"LAGOA, KOJA, JAKARTA UTARA, DKI JAKARTA",9,118,163,281
https://kawalpemilu.org#25904,"LAGOA, KOJA, JAKARTA UTARA, DKI JAKARTA",10,83,139,222
https://kawalpemilu.org#25904,"LAGOA, KOJA, JAKARTA UTARA, DKI JAKARTA",11,80,162,242
https://kawalpemilu.org#25904,"LAGOA, KOJA, JAKARTA UTARA, DKI JAKARTA",12,78,112,0
https://kawalpemilu.org#25904,"LAGOA, KOJA, JAKARTA UTARA, DKI JAKARTA",13,128,101,229
https://kawalpemilu.org#25904,"LAGOA, KOJA, JAKARTA UTARA, DKI JAKARTA",14,107,99,206
https://kawalpemilu.org#25904,"LAGOA, KOJA, JAKARTA UTARA, DKI JAKARTA",15,90,127,217
https://kawalpemilu.org#25904,"LAGOA, KOJA, JAKARTA UTARA, DKI JAKARTA",16,107,104,211
https://kawalpemilu.org#25904,"LAGOA, KOJA, JAKARTA UTARA, DKI JAKARTA",17,116,115,231
https://kawalpemilu.org#25904,"LAGOA, KOJA, JAKARTA UTARA, DKI JAKARTA",18,129,114,243
https://kawalpemilu.org#25904,"LAGOA, KOJA, JAKARTA UTARA, DKI JAKARTA",19,161,103,264
https://kawalpemilu.org#25904,"LAGOA, KOJA, JAKARTA UTARA, DKI JAKARTA",20,120,116,236
https://kawalpemilu.org#25904,"LAGOA, KOJA, JAKARTA UTARA, DKI JAKARTA",21,143,134,277
https://kawalpemilu.org#25904,"LAGOA, KOJA, JAKARTA UTARA, DKI JAKARTA",22,176,77,253
https://kawalpemilu.org#25904,"LAGOA, KOJA, JAKARTA UTARA, DKI JAKARTA",23,126,78,204
https://kawalpemilu.org#25904,"LAGOA, KOJA, JAKARTA UTARA, DKI JAKARTA",24,104,103,207
https://kawalpemilu.org#25904,"LAGOA, KOJA, JAKARTA UTARA, DKI JAKARTA",25,149,66,215
https://kawalpemilu.org#25904,"LAGOA, KOJA, JAKARTA UTARA, DKI JAKARTA",26,134,75,209
https://kawalpemilu.org#25904,"LAGOA, KOJA, JAKARTA UTARA, DKI JAKARTA",27,123,83,206
https://kawalpemilu.org#25904,"LAGOA, KOJA, JAKARTA UTARA, DKI JAKARTA",28,122,103,225
https://kawalpemilu.org#25904,"LAGOA, KOJA, JAKARTA UTARA, DKI JAKARTA",29,79,134,213
https://kawalpemilu.org#25904,"LAGOA, KOJA, JAKARTA UTARA, DKI JAKARTA",30,84,115,199
https://kawalpemilu.org#25904,"LAGOA, KOJA, JAKARTA UTARA, DKI JAKARTA",31,108,103,211
https://kawalpemilu.org#25904,"LAGOA, KOJA, JAKARTA UTARA, DKI JAKARTA",32,126,103,229
https://kawalpemilu.org#25904,"LAGOA, KOJA, JAKARTA UTARA, DKI JAKARTA",33,103,144,247
https://kawalpemilu.org#25904,"LAGOA, KOJA, JAKARTA UTARA, DKI JAKARTA",34,120,133,253
https://kawalpemilu.org#25904,"LAGOA, KOJA, JAKARTA UTARA, DKI JAKARTA",35,94,100,194
https://kawalpemilu.org#25904,"LAGOA, KOJA, JAKARTA UTARA, DKI JAKARTA",36,128,103,231
https://kawalpemilu.org#25904,"LAGOA, KOJA, JAKARTA UTARA, DKI JAKARTA",37,114,76,190
https://kawalpemilu.org#25904,"LAGOA, KOJA, JAKARTA UTARA, DKI JAKARTA",38,144,112,156
https://kawalpemilu.org#25904,"LAGOA, KOJA, JAKARTA UTARA, DKI JAKARTA",39,134,94,228
https://kawalpemilu.org#25904,"LAGOA, KOJA, JAKARTA UTARA, DKI JAKARTA",40,109,85,194
https://kawalpemilu.org#25904,"LAGOA, KOJA, JAKARTA UTARA, DKI JAKARTA",41,130,150,280
https://kawalpemilu.org#25904,"LAGOA, KOJA, JAKARTA UTARA, DKI JAKARTA",42,133,115,248
https://kawalpemilu.org#25904,"LAGOA, KOJA, JAKARTA UTARA, DKI JAKARTA",43,91,125,216
https://kawalpemilu.org#25904,"LAGOA, KOJA, JAKARTA UTARA, DKI JAKARTA",44,100,130,230
https://kawalpemilu.org#25904,"LAGOA, KOJA, JAKARTA UTARA, DKI JAKARTA",45,120,127,247
https://kawalpemilu.org#25904,"LAGOA, KOJA, JAKARTA UTARA, DKI JAKARTA",46,70,131,201
https://kawalpemilu.org#25904,"LAGOA, KOJA, JAKARTA UTARA, DKI JAKARTA",47,116,113,229
https://kawalpemilu.org#25904,"LAGOA, KOJA, JAKARTA UTARA, DKI JAKARTA",48,94,148,242
https://kawalpemilu.org#25904,"LAGOA, KOJA, JAKARTA UTARA, DKI JAKARTA",49,109,110,219
https://kawalpemilu.org#25904,"LAGOA, KOJA, JAKARTA UTARA, DKI JAKARTA",50,114,91,205
https://kawalpemilu.org#25904,"LAGOA, KOJA, JAKARTA UTARA, DKI JAKARTA",51,112,85,197
https://kawalpemilu.org#25904,"LAGOA, KOJA, JAKARTA UTARA, DKI JAKARTA",52,96,131,227
https://kawalpemilu.org#25904,"LAGOA, KOJA, JAKARTA UTARA, DKI JAKARTA",53,73,136,209
https://kawalpemilu.org#25904,"LAGOA, KOJA, JAKARTA UTARA, DKI JAKARTA",54,89,116,205
https://kawalpemilu.org#25904,"LAGOA, KOJA, JAKARTA UTARA, DKI JAKARTA",55,64,153,217
https://kawalpemilu.org#25904,"LAGOA, KOJA, JAKARTA UTARA, DKI JAKARTA",56,104,120,224
https://kawalpemilu.org#25904,"LAGOA, KOJA, JAKARTA UTARA, DKI JAKARTA",57,127,120,247
https://kawalpemilu.org#25904,"LAGOA, KOJA, JAKARTA UTARA, DKI JAKARTA",58,118,92,210
https://kawalpemilu.org#25904,"LAGOA, KOJA, JAKARTA UTARA, DKI JAKARTA",59,82,139,221
https://kawalpemilu.org#25904,"LAGOA, KOJA, JAKARTA UTARA, DKI JAKARTA",60,98,150,248
https://kawalpemilu.org#25904,"LAGOA, KOJA, JAKARTA UTARA, DKI JAKARTA",61,98,103,201
https://kawalpemilu.org#25904,"LAGOA, KOJA, JAKARTA UTARA, DKI JAKARTA",62,156,99,255
https://kawalpemilu.org#25904,"LAGOA, KOJA, JAKARTA UTARA, DKI JAKARTA",63,110,133,243
https://kawalpemilu.org#25904,"LAGOA, KOJA, JAKARTA UTARA, DKI JAKARTA",64,62,117,179
https://kawalpemilu.org#25904,"LAGOA, KOJA, JAKARTA UTARA, DKI JAKARTA",65,129,74,203
https://kawalpemilu.org#25904,"LAGOA, KOJA, JAKARTA UTARA, DKI JAKARTA",66,68,126,194
https://kawalpemilu.org#25904,"LAGOA, KOJA, JAKARTA UTARA, DKI JAKARTA",67,117,82,199
https://kawalpemilu.org#25904,"LAGOA, KOJA, JAKARTA UTARA, DKI JAKARTA",68,136,112,248
https://kawalpemilu.org#25904,"LAGOA, KOJA, JAKARTA UTARA, DKI JAKARTA",69,71,110,181
https://kawalpemilu.org#25904,"LAGOA, KOJA, JAKARTA UTARA, DKI JAKARTA",70,83,69,152
https://kawalpemilu.org#25904,"LAGOA, KOJA, JAKARTA UTARA, DKI JAKARTA",71,100,117,217
https://kawalpemilu.org#25904,"LAGOA, KOJA, JAKARTA UTARA, DKI JAKARTA",72,172,60,232
https://kawalpemilu.org#25904,"LAGOA, KOJA, JAKARTA UTARA, DKI JAKARTA",73,83,144,227
https://kawalpemilu.org#25904,"LAGOA, KOJA, JAKARTA UTARA, DKI JAKARTA",74,145,91,236
https://kawalpemilu.org#25904,"LAGOA, KOJA, JAKARTA UTARA, DKI JAKARTA",75,168,88,256
https://kawalpemilu.org#25904,"LAGOA, KOJA, JAKARTA UTARA, DKI JAKARTA",76,99,119,218
https://kawalpemilu.org#25904,"LAGOA, KOJA, JAKARTA UTARA, DKI JAKARTA",77,84,123,207
https://kawalpemilu.org#25904,"LAGOA, KOJA, JAKARTA UTARA, DKI JAKARTA",78,84,127,211
https://kawalpemilu.org#25904,"LAGOA, KOJA, JAKARTA UTARA, DKI JAKARTA",79,81,92,173
https://kawalpemilu.org#25904,"LAGOA, KOJA, JAKARTA UTARA, DKI JAKARTA",80,126,135,261
https://kawalpemilu.org#25904,"LAGOA, KOJA, JAKARTA UTARA, DKI JAKARTA",81,120,123,243
https://kawalpemilu.org#25904,"LAGOA, KOJA, JAKARTA UTARA, DKI JAKARTA",82,111,128,239
https://kawalpemilu.org#25904,"LAGOA, KOJA, JAKARTA UTARA, DKI JAKARTA",83,112,121,233
https://kawalpemilu.org#25904,"LAGOA, KOJA, JAKARTA UTARA, DKI JAKARTA",84,109,121,230
https://kawalpemilu.org#25904,"LAGOA, KOJA, JAKARTA UTARA, DKI JAKARTA",85,103,143,246
https://kawalpemilu.org#25904,"LAGOA, KOJA, JAKARTA UTARA, DKI JAKARTA",86,66,184,250
https://kawalpemilu.org#25904,"LAGOA, KOJA, JAKARTA UTARA, DKI JAKARTA",87,158,100,258
https://kawalpemilu.org#25904,"LAGOA, KOJA, JAKARTA UTARA, DKI JAKARTA",88,136,118,254
https://kawalpemilu.org#25904,"LAGOA, KOJA, JAKARTA UTARA, DKI JAKARTA",89,84,161,245
https://kawalpemilu.org#25904,"LAGOA, KOJA, JAKARTA UTARA, DKI JAKARTA",90,125,128,253
https://kawalpemilu.org#25904,"LAGOA, KOJA, JAKARTA UTARA, DKI JAKARTA",91,97,155,252
https://kawalpemilu.org#25904,"LAGOA, KOJA, JAKARTA UTARA, DKI JAKARTA",92,109,101,210
https://kawalpemilu.org#25904,"LAGOA, KOJA, JAKARTA UTARA, DKI JAKARTA",93,115,84,199
https://kawalpemilu.org#25904,"LAGOA, KOJA, JAKARTA UTARA, DKI JAKARTA",94,124,125,249
https://kawalpemilu.org#25904,"LAGOA, KOJA, JAKARTA UTARA, DKI JAKARTA",95,167,92,259
https://kawalpemilu.org#25904,"LAGOA, KOJA, JAKARTA UTARA, DKI JAKARTA",96,126,98,224
https://kawalpemilu.org#25904,"LAGOA, KOJA, JAKARTA UTARA, DKI JAKARTA",97,123,102,225
https://kawalpemilu.org#25904,"LAGOA, KOJA, JAKARTA UTARA, DKI JAKARTA",98,126,107,233
https://kawalpemilu.org#25904,"LAGOA, KOJA, JAKARTA UTARA, DKI JAKARTA",100,92,110,202
https://kawalpemilu.org#25904,"LAGOA, KOJA, JAKARTA UTARA, DKI JAKARTA",101,90,93,183
https://kawalpemilu.org#25904,"LAGOA, KOJA, JAKARTA UTARA, DKI JAKARTA",102,75,108,183
https://kawalpemilu.org#25904,"LAGOA, KOJA, JAKARTA UTARA, DKI JAKARTA",103,71,120,191
https://kawalpemilu.org#25904,"LAGOA, KOJA, JAKARTA UTARA, DKI JAKARTA",104,77,107,184
https://kawalpemilu.org#25904,"LAGOA, KOJA, JAKARTA UTARA, DKI JAKARTA",105,71,115,186
https://kawalpemilu.org#25904,"LAGOA, KOJA, JAKARTA UTARA, DKI JAKARTA",106,65,101,166
https://kawalpemilu.org#25904,"LAGOA, KOJA, JAKARTA UTARA, DKI JAKARTA",107,114,71,185
https://kawalpemilu.org#25904,"LAGOA, KOJA, JAKARTA UTARA, DKI JAKARTA",108,111,72,183
https://kawalpemilu.org#25904,"LAGOA, KOJA, JAKARTA UTARA, DKI JAKARTA",109,117,97,214
https://kawalpemilu.org#25904,"LAGOA, KOJA, JAKARTA UTARA, DKI JAKARTA",110,121,115,236
https://kawalpemilu.org#25904,"LAGOA, KOJA, JAKARTA UTARA, DKI JAKARTA",111,103,102,205
https://kawalpemilu.org#25904,"LAGOA, KOJA, JAKARTA UTARA, DKI JAKARTA",112,110,78,188
https://kawalpemilu.org#25904,"LAGOA, KOJA, JAKARTA UTARA, DKI JAKARTA",113,67,130,197
https://kawalpemilu.org#25904,"LAGOA, KOJA, JAKARTA UTARA, DKI JAKARTA",114,68,136,204
https://kawalpemilu.org#25904,"LAGOA, KOJA, JAKARTA UTARA, DKI JAKARTA",115,95,60,155
https://kawalpemilu.org#25904,"LAGOA, KOJA, JAKARTA UTARA, DKI JAKARTA",116,119,101,220
https://kawalpemilu.org#25904,"LAGOA, KOJA, JAKARTA UTARA, DKI JAKARTA",117,133,70,203
https://kawalpemilu.org#25904,"LAGOA, KOJA, JAKARTA UTARA, DKI JAKARTA",118,113,107,220
https://kawalpemilu.org#25904,"LAGOA, KOJA, JAKARTA UTARA, DKI JAKARTA",119,133,131,264
https://kawalpemilu.org#25904,"LAGOA, KOJA, JAKARTA UTARA, DKI JAKARTA",120,139,73,212
https://kawalpemilu.org#25904,"LAGOA, KOJA, JAKARTA UTARA, DKI JAKARTA",121,82,93,175
https://kawalpemilu.org#25904,"LAGOA, KOJA, JAKARTA UTARA, DKI JAKARTA",122,107,67,174
https://kawalpemilu.org#25904,"LAGOA, KOJA, JAKARTA UTARA, DKI JAKARTA",123,91,154,245
https://kawalpemilu.org#25904,"LAGOA, KOJA, JAKARTA UTARA, DKI JAKARTA",124,120,84,204
https://kawalpemilu.org#25904,"LAGOA, KOJA, JAKARTA UTARA, DKI JAKARTA",125,100,88,188
https://kawalpemilu.org#25904,"LAGOA, KOJA, JAKARTA UTARA, DKI JAKARTA",126,112,168,280
https://kawalpemilu.org#25904,"LAGOA, KOJA, JAKARTA UTARA, DKI JAKARTA",127,74,140,214
https://kawalpemilu.org#25904,"LAGOA, KOJA, JAKARTA UTARA, DKI JAKARTA",128,68,143,211
https://kawalpemilu.org#25904,"LAGOA, KOJA, JAKARTA UTARA, DKI JAKARTA",129,95,152,247
https://kawalpemilu.org#25904,"LAGOA, KOJA, JAKARTA UTARA, DKI JAKARTA",130,88,141,229
https://kawalpemilu.org#25904,"LAGOA, KOJA, JAKARTA UTARA, DKI JAKARTA",131,159,113,272
https://kawalpemilu.org#25904,"LAGOA, KOJA, JAKARTA UTARA, DKI JAKARTA",132,99,126,225
https://kawalpemilu.org#25904,"LAGOA, KOJA, JAKARTA UTARA, DKI JAKARTA",133,82,106,188
https://kawalpemilu.org#25904,"LAGOA, KOJA, JAKARTA UTARA, DKI JAKARTA",134,91,123,214
https://kawalpemilu.org#25904,"LAGOA, KOJA, JAKARTA UTARA, DKI JAKARTA",135,111,140,251
https://kawalpemilu.org#25904,"LAGOA, KOJA, JAKARTA UTARA, DKI JAKARTA",136,92,129,221
https://kawalpemilu.org#25904,"LAGOA, KOJA, JAKARTA UTARA, DKI JAKARTA",137,127,105,232
https://kawalpemilu.org#25904,"LAGOA, KOJA, JAKARTA UTARA, DKI JAKARTA",138,94,144,238
https://kawalpemilu.org#25904,"LAGOA, KOJA, JAKARTA UTARA, DKI JAKARTA",139,79,132,211
https://kawalpemilu.org#25904,"LAGOA, KOJA, JAKARTA UTARA, DKI JAKARTA",140,159,82,241
https://kawalpemilu.org#25904,"LAGOA, KOJA, JAKARTA UTARA, DKI JAKARTA",141,88,127,215
https://kawalpemilu.org#25904,"LAGOA, KOJA, JAKARTA UTARA, DKI JAKARTA",142,88,114,202
https://kawalpemilu.org#25904,"LAGOA, KOJA, JAKARTA UTARA, DKI JAKARTA",143,120,126,246
https://kawalpemilu.org#25904,"LAGOA, KOJA, JAKARTA UTARA, DKI JAKARTA",144,152,104,256
https://kawalpemilu.org#25904,"LAGOA, KOJA, JAKARTA UTARA, DKI JAKARTA",145,91,132,223
https://kawalpemilu.org#25904,"LAGOA, KOJA, JAKARTA UTARA, DKI JAKARTA",146,83,133,216
https://kawalpemilu.org#25904,"LAGOA, KOJA, JAKARTA UTARA, DKI JAKARTA",147,99,140,239
https://kawalpemilu.org#25904,"LAGOA, KOJA, JAKARTA UTARA, DKI JAKARTA",148,75,122,197
https://kawalpemilu.org#25904,"LAGOA, KOJA, JAKARTA UTARA, DKI JAKARTA",149,65,90,155
https://kawalpemilu.org#25904,"LAGOA, KOJA, JAKARTA UTARA, DKI JAKARTA",150,122,76,198
https://kawalpemilu.org#25904,"LAGOA, KOJA, JAKARTA UTARA, DKI JAKARTA",151,115,104,219
https://kawalpemilu.org#25904,"LAGOA, KOJA, JAKARTA UTARA, DKI JAKARTA",152,98,81,179
https://kawalpemilu.org#25904,"LAGOA, KOJA, JAKARTA UTARA, DKI JAKARTA",153,140,81,221
https://kawalpemilu.org#25904,"LAGOA, KOJA, JAKARTA UTARA, DKI JAKARTA",154,106,80,186
https://kawalpemilu.org#25904,"LAGOA, KOJA, JAKARTA UTARA, DKI JAKARTA",155,76,74,150
https://kawalpemilu.org#25904,"LAGOA, KOJA, JAKARTA UTARA, DKI JAKARTA",156,68,107,175
https://kawalpemilu.org#25904,"LAGOA, KOJA, JAKARTA UTARA, DKI JAKARTA",157,83,119,202
https://kawalpemilu.org#25904,"LAGOA, KOJA, JAKARTA UTARA, DKI JAKARTA",158,77,89,166
https://kawalpemilu.org#25904,"LAGOA, KOJA, JAKARTA UTARA, DKI JAKARTA",159,94,77,171
https://kawalpemilu.org#25904,"LAGOA, KOJA, JAKARTA UTARA, DKI JAKARTA",160,97,95,192
https://kawalpemilu.org#25904,"LAGOA, KOJA, JAKARTA UTARA, DKI JAKARTA",161,130,81,211
https://kawalpemilu.org#25904,"LAGOA, KOJA, JAKARTA UTARA, DKI JAKARTA",162,143,43,186
https://kawalpemilu.org#25904,"LAGOA, KOJA, JAKARTA UTARA, DKI JAKARTA",163,147,90,237
https://kawalpemilu.org#25904,"LAGOA, KOJA, JAKARTA UTARA, DKI JAKARTA",164,98,130,228
https://kawalpemilu.org#25904,"LAGOA, KOJA, JAKARTA UTARA, DKI JAKARTA",165,115,130,245
https://kawalpemilu.org#25904,"LAGOA, KOJA, JAKARTA UTARA, DKI JAKARTA",166,129,70,199
https://kawalpemilu.org#25904,"LAGOA, KOJA, JAKARTA UTARA, DKI JAKARTA",167,139,119,258
https://kawalpemilu.org#25904,"LAGOA, KOJA, JAKARTA UTARA, DKI JAKARTA",168,109,88,197
https://kawalpemilu.org#25904,"LAGOA, KOJA, JAKARTA UTARA, DKI JAKARTA",169,166,67,233
https://kawalpemilu.org#25904,"LAGOA, KOJA, JAKARTA UTARA, DKI JAKARTA",170,102,115,217
https://kawalpemilu.org#25904,"LAGOA, KOJA, JAKARTA UTARA, DKI JAKARTA",171,139,112,251
https://kawalpemilu.org#25904,"LAGOA, KOJA, JAKARTA UTARA, DKI JAKARTA",172,116,121,237
https://kawalpemilu.org#25904,"LAGOA, KOJA, JAKARTA UTARA, DKI JAKARTA",173,142,103,245
https://kawalpemilu.org#25904,"LAGOA, KOJA, JAKARTA UTARA, DKI JAKARTA",174,104,85,189
https://kawalpemilu.org#25904,"LAGOA, KOJA, JAKARTA UTARA, DKI JAKARTA",175,139,60,199
https://kawalpemilu.org#25904,"LAGOA, KOJA, JAKARTA UTARA, DKI JAKARTA",176,138,78,216
https://kawalpemilu.org#25904,"LAGOA, KOJA, JAKARTA UTARA, DKI JAKARTA",177,77,103,180
https://kawalpemilu.org#25904,"LAGOA, KOJA, JAKARTA UTARA, DKI JAKARTA",178,80,99,179
https://kawalpemilu.org#25904,"LAGOA, KOJA, JAKARTA UTARA, DKI JAKARTA",179,96,75,171
https://kawalpemilu.org#25904,"LAGOA, KOJA, JAKARTA UTARA, DKI JAKARTA",180,170,56,226
https://kawalpemilu.org#25904,"LAGOA, KOJA, JAKARTA UTARA, DKI JAKARTA",181,107,122,229
https://kawalpemilu.org#25904,"LAGOA, KOJA, JAKARTA UTARA, DKI JAKARTA",182,114,113,227
https://kawalpemilu.org#25904,"LAGOA, KOJA, JAKARTA UTARA, DKI JAKARTA",183,153,113,266
https://kawalpemilu.org#25904,"LAGOA, KOJA, JAKARTA UTARA, DKI JAKARTA",184,119,125,244
https://kawalpemilu.org#25904,"LAGOA, KOJA, JAKARTA UTARA, DKI JAKARTA",185,120,120,240
https://kawalpemilu.org#25905,"RAWA BADAK UTARA, KOJA, JAKARTA UTARA, DKI JAKARTA",1,154,98,252
https://kawalpemilu.org#25905,"RAWA BADAK UTARA, KOJA, JAKARTA UTARA, DKI JAKARTA",2,135,116,251
https://kawalpemilu.org#25905,"RAWA BADAK UTARA, KOJA, JAKARTA UTARA, DKI JAKARTA",4,103,121,224
https://kawalpemilu.org#25905,"RAWA BADAK UTARA, KOJA, JAKARTA UTARA, DKI JAKARTA",5,60,162,222
https://kawalpemilu.org#25905,"RAWA BADAK UTARA, KOJA, JAKARTA UTARA, DKI JAKARTA",6,109,133,242
https://kawalpemilu.org#25905,"RAWA BADAK UTARA, KOJA, JAKARTA UTARA, DKI JAKARTA",7,100,147,247
https://kawalpemilu.org#25905,"RAWA BADAK UTARA, KOJA, JAKARTA UTARA, DKI JAKARTA",8,108,144,252
https://kawalpemilu.org#25905,"RAWA BADAK UTARA, KOJA, JAKARTA UTARA, DKI JAKARTA",9,136,108,244
https://kawalpemilu.org#25905,"RAWA BADAK UTARA, KOJA, JAKARTA UTARA, DKI JAKARTA",10,106,146,252
https://kawalpemilu.org#25905,"RAWA BADAK UTARA, KOJA, JAKARTA UTARA, DKI JAKARTA",11,151,114,265
https://kawalpemilu.org#25905,"RAWA BADAK UTARA, KOJA, JAKARTA UTARA, DKI JAKARTA",12,115,140,255
https://kawalpemilu.org#25905,"RAWA BADAK UTARA, KOJA, JAKARTA UTARA, DKI JAKARTA",13,108,143,251
https://kawalpemilu.org#25905,"RAWA BADAK UTARA, KOJA, JAKARTA UTARA, DKI JAKARTA",14,121,134,255
https://kawalpemilu.org#25905,"RAWA BADAK UTARA, KOJA, JAKARTA UTARA, DKI JAKARTA",15,92,131,223
https://kawalpemilu.org#25905,"RAWA BADAK UTARA, KOJA, JAKARTA UTARA, DKI JAKARTA",16,94,119,213
https://kawalpemilu.org#25905,"RAWA BADAK UTARA, KOJA, JAKARTA UTARA, DKI JAKARTA",17,71,161,232
https://kawalpemilu.org#25905,"RAWA BADAK UTARA, KOJA, JAKARTA UTARA, DKI JAKARTA",18,119,113,232
https://kawalpemilu.org#25905,"RAWA BADAK UTARA, KOJA, JAKARTA UTARA, DKI JAKARTA",19,95,97,192
https://kawalpemilu.org#25905,"RAWA BADAK UTARA, KOJA, JAKARTA UTARA, DKI JAKARTA",20,106,98,204
https://kawalpemilu.org#25905,"RAWA BADAK UTARA, KOJA, JAKARTA UTARA, DKI JAKARTA",21,101,125,226
https://kawalpemilu.org#25905,"RAWA BADAK UTARA, KOJA, JAKARTA UTARA, DKI JAKARTA",22,85,111,196
https://kawalpemilu.org#25905,"RAWA BADAK UTARA, KOJA, JAKARTA UTARA, DKI JAKARTA",23,106,74,180
https://kawalpemilu.org#25905,"RAWA BADAK UTARA, KOJA, JAKARTA UTARA, DKI JAKARTA",24,98,102,200
https://kawalpemilu.org#25905,"RAWA BADAK UTARA, KOJA, JAKARTA UTARA, DKI JAKARTA",25,126,96,222
https://kawalpemilu.org#25905,"RAWA BADAK UTARA, KOJA, JAKARTA UTARA, DKI JAKARTA",26,86,92,178
https://kawalpemilu.org#25905,"RAWA BADAK UTARA, KOJA, JAKARTA UTARA, DKI JAKARTA",27,76,119,195
https://kawalpemilu.org#25905,"RAWA BADAK UTARA, KOJA, JAKARTA UTARA, DKI JAKARTA",28,84,154,238
https://kawalpemilu.org#25905,"RAWA BADAK UTARA, KOJA, JAKARTA UTARA, DKI JAKARTA",29,101,96,197
https://kawalpemilu.org#25905,"RAWA BADAK UTARA, KOJA, JAKARTA UTARA, DKI JAKARTA",30,100,132,232
https://kawalpemilu.org#25905,"RAWA BADAK UTARA, KOJA, JAKARTA UTARA, DKI JAKARTA",31,73,116,189
https://kawalpemilu.org#25905,"RAWA BADAK UTARA, KOJA, JAKARTA UTARA, DKI JAKARTA",32,69,142,211
https://kawalpemilu.org#25905,"RAWA BADAK UTARA, KOJA, JAKARTA UTARA, DKI JAKARTA",33,99,143,242
https://kawalpemilu.org#25905,"RAWA BADAK UTARA, KOJA, JAKARTA UTARA, DKI JAKARTA",34,109,113,222
https://kawalpemilu.org#25905,"RAWA BADAK UTARA, KOJA, JAKARTA UTARA, DKI JAKARTA",35,96,131,227
https://kawalpemilu.org#25905,"RAWA BADAK UTARA, KOJA, JAKARTA UTARA, DKI JAKARTA",36,78,157,235
https://kawalpemilu.org#25905,"RAWA BADAK UTARA, KOJA, JAKARTA UTARA, DKI JAKARTA",37,74,133,207
https://kawalpemilu.org#25905,"RAWA BADAK UTARA, KOJA, JAKARTA UTARA, DKI JAKARTA",38,78,128,206
https://kawalpemilu.org#25905,"RAWA BADAK UTARA, KOJA, JAKARTA UTARA, DKI JAKARTA",39,82,129,211
https://kawalpemilu.org#25905,"RAWA BADAK UTARA, KOJA, JAKARTA UTARA, DKI JAKARTA",40,102,119,221
https://kawalpemilu.org#25905,"RAWA BADAK UTARA, KOJA, JAKARTA UTARA, DKI JAKARTA",41,99,90,189
https://kawalpemilu.org#25905,"RAWA BADAK UTARA, KOJA, JAKARTA UTARA, DKI JAKARTA",42,88,95,183
https://kawalpemilu.org#25905,"RAWA BADAK UTARA, KOJA, JAKARTA UTARA, DKI JAKARTA",43,125,111,236
https://kawalpemilu.org#25905,"RAWA BADAK UTARA, KOJA, JAKARTA UTARA, DKI JAKARTA",44,103,127,230
https://kawalpemilu.org#25905,"RAWA BADAK UTARA, KOJA, JAKARTA UTARA, DKI JAKARTA",45,144,92,236
https://kawalpemilu.org#25905,"RAWA BADAK UTARA, KOJA, JAKARTA UTARA, DKI JAKARTA",46,135,109,244
https://kawalpemilu.org#25905,"RAWA BADAK UTARA, KOJA, JAKARTA UTARA, DKI JAKARTA",47,94,87,181
https://kawalpemilu.org#25905,"RAWA BADAK UTARA, KOJA, JAKARTA UTARA, DKI JAKARTA",48,111,110,221
https://kawalpemilu.org#25905,"RAWA BADAK UTARA, KOJA, JAKARTA UTARA, DKI JAKARTA",49,102,113,215
https://kawalpemilu.org#25905,"RAWA BADAK UTARA, KOJA, JAKARTA UTARA, DKI JAKARTA",50,118,124,242
https://kawalpemilu.org#25905,"RAWA BADAK UTARA, KOJA, JAKARTA UTARA, DKI JAKARTA",51,95,138,233
https://kawalpemilu.org#25905,"RAWA BADAK UTARA, KOJA, JAKARTA UTARA, DKI JAKARTA",52,95,101,196
https://kawalpemilu.org#25905,"RAWA BADAK UTARA, KOJA, JAKARTA UTARA, DKI JAKARTA",53,79,118,197
https://kawalpemilu.org#25905,"RAWA BADAK UTARA, KOJA, JAKARTA UTARA, DKI JAKARTA",54,91,80,171
https://kawalpemilu.org#25905,"RAWA BADAK UTARA, KOJA, JAKARTA UTARA, DKI JAKARTA",55,67,123,190
https://kawalpemilu.org#25905,"RAWA BADAK UTARA, KOJA, JAKARTA UTARA, DKI JAKARTA",56,87,112,199
https://kawalpemilu.org#25905,"RAWA BADAK UTARA, KOJA, JAKARTA UTARA, DKI JAKARTA",57,127,126,253
https://kawalpemilu.org#25905,"RAWA BADAK UTARA, KOJA, JAKARTA UTARA, DKI JAKARTA",58,92,157,249
https://kawalpemilu.org#25905,"RAWA BADAK UTARA, KOJA, JAKARTA UTARA, DKI JAKARTA",59,127,106,233
https://kawalpemilu.org#25905,"RAWA BADAK UTARA, KOJA, JAKARTA UTARA, DKI JAKARTA",60,113,134,247
https://kawalpemilu.org#25905,"RAWA BADAK UTARA, KOJA, JAKARTA UTARA, DKI JAKARTA",61,121,118,239
https://kawalpemilu.org#25905,"RAWA BADAK UTARA, KOJA, JAKARTA UTARA, DKI JAKARTA",62,115,111,226
https://kawalpemilu.org#25905,"RAWA BADAK UTARA, KOJA, JAKARTA UTARA, DKI JAKARTA",63,105,131,236
https://kawalpemilu.org#25905,"RAWA BADAK UTARA, KOJA, JAKARTA UTARA, DKI JAKARTA",64,92,159,251
https://kawalpemilu.org#25905,"RAWA BADAK UTARA, KOJA, JAKARTA UTARA, DKI JAKARTA",65,101,113,214
https://kawalpemilu.org#25905,"RAWA BADAK UTARA, KOJA, JAKARTA UTARA, DKI JAKARTA",66,98,92,190
https://kawalpemilu.org#25905,"RAWA BADAK UTARA, KOJA, JAKARTA UTARA, DKI JAKARTA",67,109,119,228
https://kawalpemilu.org#25905,"RAWA BADAK UTARA, KOJA, JAKARTA UTARA, DKI JAKARTA",68,90,138,228
https://kawalpemilu.org#25905,"RAWA BADAK UTARA, KOJA, JAKARTA UTARA, DKI JAKARTA",69,111,141,252
https://kawalpemilu.org#25905,"RAWA BADAK UTARA, KOJA, JAKARTA UTARA, DKI JAKARTA",70,72,141,213
https://kawalpemilu.org#25905,"RAWA BADAK UTARA, KOJA, JAKARTA UTARA, DKI JAKARTA",71,100,149,249
https://kawalpemilu.org#25905,"RAWA BADAK UTARA, KOJA, JAKARTA UTARA, DKI JAKARTA",72,86,107,193
https://kawalpemilu.org#25905,"RAWA BADAK UTARA, KOJA, JAKARTA UTARA, DKI JAKARTA",73,102,129,231
https://kawalpemilu.org#25905,"RAWA BADAK UTARA, KOJA, JAKARTA UTARA, DKI JAKARTA",74,122,122,244
https://kawalpemilu.org#25905,"RAWA BADAK UTARA, KOJA, JAKARTA UTARA, DKI JAKARTA",75,76,171,247
https://kawalpemilu.org#25905,"RAWA BADAK UTARA, KOJA, JAKARTA UTARA, DKI JAKARTA",76,89,127,216
https://kawalpemilu.org#25905,"RAWA BADAK UTARA, KOJA, JAKARTA UTARA, DKI JAKARTA",77,125,108,233
https://kawalpemilu.org#25905,"RAWA BADAK UTARA, KOJA, JAKARTA UTARA, DKI JAKARTA",78,105,118,223
https://kawalpemilu.org#25905,"RAWA BADAK UTARA, KOJA, JAKARTA UTARA, DKI JAKARTA",79,121,108,229
https://kawalpemilu.org#25905,"RAWA BADAK UTARA, KOJA, JAKARTA UTARA, DKI JAKARTA",80,105,103,208
https://kawalpemilu.org#25905,"RAWA BADAK UTARA, KOJA, JAKARTA UTARA, DKI JAKARTA",81,76,110,186
https://kawalpemilu.org#25905,"RAWA BADAK UTARA, KOJA, JAKARTA UTARA, DKI JAKARTA",82,73,115,188
https://kawalpemilu.org#25905,"RAWA BADAK UTARA, KOJA, JAKARTA UTARA, DKI JAKARTA",83,91,95,186
https://kawalpemilu.org#25905,"RAWA BADAK UTARA, KOJA, JAKARTA UTARA, DKI JAKARTA",84,90,98,188
https://kawalpemilu.org#25905,"RAWA BADAK UTARA, KOJA, JAKARTA UTARA, DKI JAKARTA",85,122,121,243
https://kawalpemilu.org#25905,"RAWA BADAK UTARA, KOJA, JAKARTA UTARA, DKI JAKARTA",86,134,97,231
https://kawalpemilu.org#25905,"RAWA BADAK UTARA, KOJA, JAKARTA UTARA, DKI JAKARTA",87,109,132,241
https://kawalpemilu.org#25905,"RAWA BADAK UTARA, KOJA, JAKARTA UTARA, DKI JAKARTA",88,120,128,248
https://kawalpemilu.org#25905,"RAWA BADAK UTARA, KOJA, JAKARTA UTARA, DKI JAKARTA",89,118,140,258
https://kawalpemilu.org#25905,"RAWA BADAK UTARA, KOJA, JAKARTA UTARA, DKI JAKARTA",90,128,93,221
https://kawalpemilu.org#25905,"RAWA BADAK UTARA, KOJA, JAKARTA UTARA, DKI JAKARTA",91,103,131,234
https://kawalpemilu.org#25905,"RAWA BADAK UTARA, KOJA, JAKARTA UTARA, DKI JAKARTA",92,101,121,222
https://kawalpemilu.org#25905,"RAWA BADAK UTARA, KOJA, JAKARTA UTARA, DKI JAKARTA",93,113,125,238
https://kawalpemilu.org#25905,"RAWA BADAK UTARA, KOJA, JAKARTA UTARA, DKI JAKARTA",94,120,77,197
https://kawalpemilu.org#25905,"RAWA BADAK UTARA, KOJA, JAKARTA UTARA, DKI JAKARTA",95,93,67,160
https://kawalpemilu.org#25905,"RAWA BADAK UTARA, KOJA, JAKARTA UTARA, DKI JAKARTA",96,91,64,155
https://kawalpemilu.org#25905,"RAWA BADAK UTARA, KOJA, JAKARTA UTARA, DKI JAKARTA",97,64,93,157
https://kawalpemilu.org#25905,"RAWA BADAK UTARA, KOJA, JAKARTA UTARA, DKI JAKARTA",98,142,70,212
https://kawalpemilu.org#25905,"RAWA BADAK UTARA, KOJA, JAKARTA UTARA, DKI JAKARTA",99,77,113,190
https://kawalpemilu.org#25905,"RAWA BADAK UTARA, KOJA, JAKARTA UTARA, DKI JAKARTA",100,101,87,188
https://kawalpemilu.org#25905,"RAWA BADAK UTARA, KOJA, JAKARTA UTARA, DKI JAKARTA",101,110,86,196
https://kawalpemilu.org#25905,"RAWA BADAK UTARA, KOJA, JAKARTA UTARA, DKI JAKARTA",102,128,88,210
https://kawalpemilu.org#25905,"RAWA BADAK UTARA, KOJA, JAKARTA UTARA, DKI JAKARTA",103,131,108,239
https://kawalpemilu.org#25905,"RAWA BADAK UTARA, KOJA, JAKARTA UTARA, DKI JAKARTA",104,114,132,246
https://kawalpemilu.org#25905,"RAWA BADAK UTARA, KOJA, JAKARTA UTARA, DKI JAKARTA",105,156,100,256
https://kawalpemilu.org#25906,"TUGU SELATAN, KOJA, JAKARTA UTARA, DKI JAKARTA",1,140,155,295
https://kawalpemilu.org#25906,"TUGU SELATAN, KOJA, JAKARTA UTARA, DKI JAKARTA",2,144,133,277
https://kawalpemilu.org#25906,"TUGU SELATAN, KOJA, JAKARTA UTARA, DKI JAKARTA",3,118,127,245
https://kawalpemilu.org#25906,"TUGU SELATAN, KOJA, JAKARTA UTARA, DKI JAKARTA",4,96,169,265
https://kawalpemilu.org#25906,"TUGU SELATAN, KOJA, JAKARTA UTARA, DKI JAKARTA",5,80,177,257
https://kawalpemilu.org#25906,"TUGU SELATAN, KOJA, JAKARTA UTARA, DKI JAKARTA",6,102,138,240
https://kawalpemilu.org#25906,"TUGU SELATAN, KOJA, JAKARTA UTARA, DKI JAKARTA",7,106,150,256
https://kawalpemilu.org#25906,"TUGU SELATAN, KOJA, JAKARTA UTARA, DKI JAKARTA",8,103,144,247
https://kawalpemilu.org#25906,"TUGU SELATAN, KOJA, JAKARTA UTARA, DKI JAKARTA",9,130,172,302
https://kawalpemilu.org#25906,"TUGU SELATAN, KOJA, JAKARTA UTARA, DKI JAKARTA",10,99,122,221
https://kawalpemilu.org#25906,"TUGU SELATAN, KOJA, JAKARTA UTARA, DKI JAKARTA",11,80,174,254
https://kawalpemilu.org#25906,"TUGU SELATAN, KOJA, JAKARTA UTARA, DKI JAKARTA",12,79,167,246
https://kawalpemilu.org#25906,"TUGU SELATAN, KOJA, JAKARTA UTARA, DKI JAKARTA",13,105,100,205
https://kawalpemilu.org#25906,"TUGU SELATAN, KOJA, JAKARTA UTARA, DKI JAKARTA",14,98,105,203
https://kawalpemilu.org#25906,"TUGU SELATAN, KOJA, JAKARTA UTARA, DKI JAKARTA",15,70,164,234
https://kawalpemilu.org#25906,"TUGU SELATAN, KOJA, JAKARTA UTARA, DKI JAKARTA",16,149,84,233
https://kawalpemilu.org#25906,"TUGU SELATAN, KOJA, JAKARTA UTARA, DKI JAKARTA",17,93,175,268
https://kawalpemilu.org#25906,"TUGU SELATAN, KOJA, JAKARTA UTARA, DKI JAKARTA",18,118,118,236
https://kawalpemilu.org#25906,"TUGU SELATAN, KOJA, JAKARTA UTARA, DKI JAKARTA",19,119,150,269
https://kawalpemilu.org#25906,"TUGU SELATAN, KOJA, JAKARTA UTARA, DKI JAKARTA",20,71,181,252
https://kawalpemilu.org#25906,"TUGU SELATAN, KOJA, JAKARTA UTARA, DKI JAKARTA",21,94,61,155
https://kawalpemilu.org#25906,"TUGU SELATAN, KOJA, JAKARTA UTARA, DKI JAKARTA",22,94,136,230
https://kawalpemilu.org#25906,"TUGU SELATAN, KOJA, JAKARTA UTARA, DKI JAKARTA",23,94,89,183
https://kawalpemilu.org#25906,"TUGU SELATAN, KOJA, JAKARTA UTARA, DKI JAKARTA",24,93,90,183
https://kawalpemilu.org#25906,"TUGU SELATAN, KOJA, JAKARTA UTARA, DKI JAKARTA",25,106,151,257
https://kawalpemilu.org#25906,"TUGU SELATAN, KOJA, JAKARTA UTARA, DKI JAKARTA",26,107,106,213
https://kawalpemilu.org#25906,"TUGU SELATAN, KOJA, JAKARTA UTARA, DKI JAKARTA",27,117,155,272
https://kawalpemilu.org#25906,"TUGU SELATAN, KOJA, JAKARTA UTARA, DKI JAKARTA",28,95,150,245
https://kawalpemilu.org#25906,"TUGU SELATAN, KOJA, JAKARTA UTARA, DKI JAKARTA",29,90,165,255
https://kawalpemilu.org#25906,"TUGU SELATAN, KOJA, JAKARTA UTARA, DKI JAKARTA",30,93,157,250
https://kawalpemilu.org#25906,"TUGU SELATAN, KOJA, JAKARTA UTARA, DKI JAKARTA",31,88,113,201
https://kawalpemilu.org#25906,"TUGU SELATAN, KOJA, JAKARTA UTARA, DKI JAKARTA",32,94,145,239
https://kawalpemilu.org#25906,"TUGU SELATAN, KOJA, JAKARTA UTARA, DKI JAKARTA",33,56,158,214
https://kawalpemilu.org#25906,"TUGU SELATAN, KOJA, JAKARTA UTARA, DKI JAKARTA",34,111,147,258
https://kawalpemilu.org#25906,"TUGU SELATAN, KOJA, JAKARTA UTARA, DKI JAKARTA",35,89,187,276
https://kawalpemilu.org#25906,"TUGU SELATAN, KOJA, JAKARTA UTARA, DKI JAKARTA",36,92,167,259
https://kawalpemilu.org#25906,"TUGU SELATAN, KOJA, JAKARTA UTARA, DKI JAKARTA",37,130,148,278
https://kawalpemilu.org#25906,"TUGU SELATAN, KOJA, JAKARTA UTARA, DKI JAKARTA",38,85,182,267
https://kawalpemilu.org#25906,"TUGU SELATAN, KOJA, JAKARTA UTARA, DKI JAKARTA",39,110,150,260
https://kawalpemilu.org#25906,"TUGU SELATAN, KOJA, JAKARTA UTARA, DKI JAKARTA",40,111,112,223
https://kawalpemilu.org#25906,"TUGU SELATAN, KOJA, JAKARTA UTARA, DKI JAKARTA",41,68,158,226
https://kawalpemilu.org#25906,"TUGU SELATAN, KOJA, JAKARTA UTARA, DKI JAKARTA",42,87,133,220
https://kawalpemilu.org#25906,"TUGU SELATAN, KOJA, JAKARTA UTARA, DKI JAKARTA",43,150,131,281
https://kawalpemilu.org#25906,"TUGU SELATAN, KOJA, JAKARTA UTARA, DKI JAKARTA",44,97,138,235
https://kawalpemilu.org#25906,"TUGU SELATAN, KOJA, JAKARTA UTARA, DKI JAKARTA",45,119,104,223
https://kawalpemilu.org#25906,"TUGU SELATAN, KOJA, JAKARTA UTARA, DKI JAKARTA",46,172,96,268
https://kawalpemilu.org#25906,"TUGU SELATAN, KOJA, JAKARTA UTARA, DKI JAKARTA",47,79,149,228
https://kawalpemilu.org#25906,"TUGU SELATAN, KOJA, JAKARTA UTARA, DKI JAKARTA",48,89,157,246
https://kawalpemilu.org#25906,"TUGU SELATAN, KOJA, JAKARTA UTARA, DKI JAKARTA",49,113,146,259
https://kawalpemilu.org#25906,"TUGU SELATAN, KOJA, JAKARTA UTARA, DKI JAKARTA",50,136,133,269
https://kawalpemilu.org#25906,"TUGU SELATAN, KOJA, JAKARTA UTARA, DKI JAKARTA",51,147,108,255
https://kawalpemilu.org#25906,"TUGU SELATAN, KOJA, JAKARTA UTARA, DKI JAKARTA",52,123,165,288
https://kawalpemilu.org#25906,"TUGU SELATAN, KOJA, JAKARTA UTARA, DKI JAKARTA",53,131,126,257
https://kawalpemilu.org#25906,"TUGU SELATAN, KOJA, JAKARTA UTARA, DKI JAKARTA",54,118,130,248
https://kawalpemilu.org#25906,"TUGU SELATAN, KOJA, JAKARTA UTARA, DKI JAKARTA",55,160,98,258
https://kawalpemilu.org#25906,"TUGU SELATAN, KOJA, JAKARTA UTARA, DKI JAKARTA",56,96,109,205
https://kawalpemilu.org#25906,"TUGU SELATAN, KOJA, JAKARTA UTARA, DKI JAKARTA",57,107,99,206
https://kawalpemilu.org#25906,"TUGU SELATAN, KOJA, JAKARTA UTARA, DKI JAKARTA",58,101,153,254
https://kawalpemilu.org#25906,"TUGU SELATAN, KOJA, JAKARTA UTARA, DKI JAKARTA",59,123,145,268
https://kawalpemilu.org#25906,"TUGU SELATAN, KOJA, JAKARTA UTARA, DKI JAKARTA",60,86,135,221
https://kawalpemilu.org#25906,"TUGU SELATAN, KOJA, JAKARTA UTARA, DKI JAKARTA",61,106,143,249
https://kawalpemilu.org#25906,"TUGU SELATAN, KOJA, JAKARTA UTARA, DKI JAKARTA",62,92,195,287
https://kawalpemilu.org#25906,"TUGU SELATAN, KOJA, JAKARTA UTARA, DKI JAKARTA",63,66,183,6
https://kawalpemilu.org#25906,"TUGU SELATAN, KOJA, JAKARTA UTARA, DKI JAKARTA",64,83,165,248
https://kawalpemilu.org#25906,"TUGU SELATAN, KOJA, JAKARTA UTARA, DKI JAKARTA",65,75,182,257
https://kawalpemilu.org#25906,"TUGU SELATAN, KOJA, JAKARTA UTARA, DKI JAKARTA",66,105,123,228
https://kawalpemilu.org#25906,"TUGU SELATAN, KOJA, JAKARTA UTARA, DKI JAKARTA",67,81,157,238
https://kawalpemilu.org#25906,"TUGU SELATAN, KOJA, JAKARTA UTARA, DKI JAKARTA",68,123,130,253
https://kawalpemilu.org#25906,"TUGU SELATAN, KOJA, JAKARTA UTARA, DKI JAKARTA",69,98,130,228
https://kawalpemilu.org#25906,"TUGU SELATAN, KOJA, JAKARTA UTARA, DKI JAKARTA",70,68,88,156
https://kawalpemilu.org#25906,"TUGU SELATAN, KOJA, JAKARTA UTARA, DKI JAKARTA",71,118,149,267
https://kawalpemilu.org#25906,"TUGU SELATAN, KOJA, JAKARTA UTARA, DKI JAKARTA",72,89,154,243
https://kawalpemilu.org#25906,"TUGU SELATAN, KOJA, JAKARTA UTARA, DKI JAKARTA",73,119,154,273
https://kawalpemilu.org#25906,"TUGU SELATAN, KOJA, JAKARTA UTARA, DKI JAKARTA",74,96,116,212
https://kawalpemilu.org#25906,"TUGU SELATAN, KOJA, JAKARTA UTARA, DKI JAKARTA",75,74,177,251
https://kawalpemilu.org#25906,"TUGU SELATAN, KOJA, JAKARTA UTARA, DKI JAKARTA",76,112,138,250
https://kawalpemilu.org#25906,"TUGU SELATAN, KOJA, JAKARTA UTARA, DKI JAKARTA",77,83,182,265
https://kawalpemilu.org#25906,"TUGU SELATAN, KOJA, JAKARTA UTARA, DKI JAKARTA",78,80,132,212
https://kawalpemilu.org#25906,"TUGU SELATAN, KOJA, JAKARTA UTARA, DKI JAKARTA",79,86,138,224
https://kawalpemilu.org#25906,"TUGU SELATAN, KOJA, JAKARTA UTARA, DKI JAKARTA",80,69,130,199
https://kawalpemilu.org#25906,"TUGU SELATAN, KOJA, JAKARTA UTARA, DKI JAKARTA",81,70,170,240
https://kawalpemilu.org#25906,"TUGU SELATAN, KOJA, JAKARTA UTARA, DKI JAKARTA",82,99,175,274
https://kawalpemilu.org#25906,"TUGU SELATAN, KOJA, JAKARTA UTARA, DKI JAKARTA",83,83,165,248
https://kawalpemilu.org#25906,"TUGU SELATAN, KOJA, JAKARTA UTARA, DKI JAKARTA",84,77,142,219
https://kawalpemilu.org#25906,"TUGU SELATAN, KOJA, JAKARTA UTARA, DKI JAKARTA",85,68,133,201
https://kawalpemilu.org#25906,"TUGU SELATAN, KOJA, JAKARTA UTARA, DKI JAKARTA",86,46,178,224
https://kawalpemilu.org#25906,"TUGU SELATAN, KOJA, JAKARTA UTARA, DKI JAKARTA",87,237,9,246
https://kawalpemilu.org#25906,"TUGU SELATAN, KOJA, JAKARTA UTARA, DKI JAKARTA",88,240,11,251
https://kawalpemilu.org#25906,"TUGU SELATAN, KOJA, JAKARTA UTARA, DKI JAKARTA",89,256,7,263
https://kawalpemilu.org#25906,"TUGU SELATAN, KOJA, JAKARTA UTARA, DKI JAKARTA",90,171,72,243
https://kawalpemilu.org#25906,"TUGU SELATAN, KOJA, JAKARTA UTARA, DKI JAKARTA",91,233,57,290
https://kawalpemilu.org#25906,"TUGU SELATAN, KOJA, JAKARTA UTARA, DKI JAKARTA",92,181,102,283
https://kawalpemilu.org#25906,"TUGU SELATAN, KOJA, JAKARTA UTARA, DKI JAKARTA",93,195,77,272
https://kawalpemilu.org#25906,"TUGU SELATAN, KOJA, JAKARTA UTARA, DKI JAKARTA",94,216,34,250
https://kawalpemilu.org#25906,"TUGU SELATAN, KOJA, JAKARTA UTARA, DKI JAKARTA",95,215,76,291
https://kawalpemilu.org#25906,"TUGU SELATAN, KOJA, JAKARTA UTARA, DKI JAKARTA",96,128,82,210
https://kawalpemilu.org#25906,"TUGU SELATAN, KOJA, JAKARTA UTARA, DKI JAKARTA",97,136,81,217
https://kawalpemilu.org#25906,"TUGU SELATAN, KOJA, JAKARTA UTARA, DKI JAKARTA",98,216,58,274
https://kawalpemilu.org#25906,"TUGU SELATAN, KOJA, JAKARTA UTARA, DKI JAKARTA",99,199,69,268
https://kawalpemilu.org#25906,"TUGU SELATAN, KOJA, JAKARTA UTARA, DKI JAKARTA",100,234,56,290
https://kawalpemilu.org#25906,"TUGU SELATAN, KOJA, JAKARTA UTARA, DKI JAKARTA",101,158,104,262
https://kawalpemilu.org#25906,"TUGU SELATAN, KOJA, JAKARTA UTARA, DKI JAKARTA",102,196,53,249
https://kawalpemilu.org#25906,"TUGU SELATAN, KOJA, JAKARTA UTARA, DKI JAKARTA",103,142,120,262
https://kawalpemilu.org#25906,"TUGU SELATAN, KOJA, JAKARTA UTARA, DKI JAKARTA",104,225,32,257
https://kawalpemilu.org#25906,"TUGU SELATAN, KOJA, JAKARTA UTARA, DKI JAKARTA",105,88,115,203
https://kawalpemilu.org#25907,"RAWA BADAK SELATAN, KOJA, JAKARTA UTARA, DKI JAKARTA",1,130,159,289
https://kawalpemilu.org#25907,"RAWA BADAK SELATAN, KOJA, JAKARTA UTARA, DKI JAKARTA",2,83,158,241
https://kawalpemilu.org#25907,"RAWA BADAK SELATAN, KOJA, JAKARTA UTARA, DKI JAKARTA",3,91,125,216
https://kawalpemilu.org#25907,"RAWA BADAK SELATAN, KOJA, JAKARTA UTARA, DKI JAKARTA",4,107,134,241
https://kawalpemilu.org#25907,"RAWA BADAK SELATAN, KOJA, JAKARTA UTARA, DKI JAKARTA",5,90,170,260
https://kawalpemilu.org#25907,"RAWA BADAK SELATAN, KOJA, JAKARTA UTARA, DKI JAKARTA",6,125,144,269
https://kawalpemilu.org#25907,"RAWA BADAK SELATAN, KOJA, JAKARTA UTARA, DKI JAKARTA",7,97,132,229
https://kawalpemilu.org#25907,"RAWA BADAK SELATAN, KOJA, JAKARTA UTARA, DKI JAKARTA",8,82,160,242
https://kawalpemilu.org#25907,"RAWA BADAK SELATAN, KOJA, JAKARTA UTARA, DKI JAKARTA",9,78,174,252
https://kawalpemilu.org#25907,"RAWA BADAK SELATAN, KOJA, JAKARTA UTARA, DKI JAKARTA",10,111,115,226
https://kawalpemilu.org#25907,"RAWA BADAK SELATAN, KOJA, JAKARTA UTARA, DKI JAKARTA",11,96,161,257
https://kawalpemilu.org#25907,"RAWA BADAK SELATAN, KOJA, JAKARTA UTARA, DKI JAKARTA",12,78,161,239
https://kawalpemilu.org#25907,"RAWA BADAK SELATAN, KOJA, JAKARTA UTARA, DKI JAKARTA",13,74,145,219
https://kawalpemilu.org#25907,"RAWA BADAK SELATAN, KOJA, JAKARTA UTARA, DKI JAKARTA",14,95,143,238
https://kawalpemilu.org#25907,"RAWA BADAK SELATAN, KOJA, JAKARTA UTARA, DKI JAKARTA",15,80,169,250
https://kawalpemilu.org#25907,"RAWA BADAK SELATAN, KOJA, JAKARTA UTARA, DKI JAKARTA",16,87,160,247
https://kawalpemilu.org#25907,"RAWA BADAK SELATAN, KOJA, JAKARTA UTARA, DKI JAKARTA",17,99,129,228
https://kawalpemilu.org#25907,"RAWA BADAK SELATAN, KOJA, JAKARTA UTARA, DKI JAKARTA",18,106,164,270
https://kawalpemilu.org#25907,"RAWA BADAK SELATAN, KOJA, JAKARTA UTARA, DKI JAKARTA",19,137,85,222
https://kawalpemilu.org#25907,"RAWA BADAK SELATAN, KOJA, JAKARTA UTARA, DKI JAKARTA",20,97,168,265
https://kawalpemilu.org#25907,"RAWA BADAK SELATAN, KOJA, JAKARTA UTARA, DKI JAKARTA",21,104,142,246
https://kawalpemilu.org#25907,"RAWA BADAK SELATAN, KOJA, JAKARTA UTARA, DKI JAKARTA",22,59,153,212
https://kawalpemilu.org#25907,"RAWA BADAK SELATAN, KOJA, JAKARTA UTARA, DKI JAKARTA",23,109,120,229
https://kawalpemilu.org#25907,"RAWA BADAK SELATAN, KOJA, JAKARTA UTARA, DKI JAKARTA",24,148,87,235
https://kawalpemilu.org#25907,"RAWA BADAK SELATAN, KOJA, JAKARTA UTARA, DKI JAKARTA",25,122,96,218
https://kawalpemilu.org#25907,"RAWA BADAK SELATAN, KOJA, JAKARTA UTARA, DKI JAKARTA",26,99,131,230
https://kawalpemilu.org#25907,"RAWA BADAK SELATAN, KOJA, JAKARTA UTARA, DKI JAKARTA",27,101,138,239
https://kawalpemilu.org#25907,"RAWA BADAK SELATAN, KOJA, JAKARTA UTARA, DKI JAKARTA",28,111,102,213
https://kawalpemilu.org#25907,"RAWA BADAK SELATAN, KOJA, JAKARTA UTARA, DKI JAKARTA",29,139,73,212
https://kawalpemilu.org#25907,"RAWA BADAK SELATAN, KOJA, JAKARTA UTARA, DKI JAKARTA",30,132,117,249
https://kawalpemilu.org#25907,"RAWA BADAK SELATAN, KOJA, JAKARTA UTARA, DKI JAKARTA",31,111,115,226
https://kawalpemilu.org#25907,"RAWA BADAK SELATAN, KOJA, JAKARTA UTARA, DKI JAKARTA",32,87,153,240
https://kawalpemilu.org#25907,"RAWA BADAK SELATAN, KOJA, JAKARTA UTARA, DKI JAKARTA",33,89,121,210
https://kawalpemilu.org#25907,"RAWA BADAK SELATAN, KOJA, JAKARTA UTARA, DKI JAKARTA",34,82,163,245
https://kawalpemilu.org#25907,"RAWA BADAK SELATAN, KOJA, JAKARTA UTARA, DKI JAKARTA",35,112,139,0
https://kawalpemilu.org#25907,"RAWA BADAK SELATAN, KOJA, JAKARTA UTARA, DKI JAKARTA",36,112,124,236
https://kawalpemilu.org#25907,"RAWA BADAK SELATAN, KOJA, JAKARTA UTARA, DKI JAKARTA",37,93,139,232
https://kawalpemilu.org#25907,"RAWA BADAK SELATAN, KOJA, JAKARTA UTARA, DKI JAKARTA",38,118,131,249
https://kawalpemilu.org#25907,"RAWA BADAK SELATAN, KOJA, JAKARTA UTARA, DKI JAKARTA",39,51,156,207
https://kawalpemilu.org#25907,"RAWA BADAK SELATAN, KOJA, JAKARTA UTARA, DKI JAKARTA",40,54,177,231
https://kawalpemilu.org#25907,"RAWA BADAK SELATAN, KOJA, JAKARTA UTARA, DKI JAKARTA",41,105,137,242
https://kawalpemilu.org#25907,"RAWA BADAK SELATAN, KOJA, JAKARTA UTARA, DKI JAKARTA",42,100,122,222
https://kawalpemilu.org#25907,"RAWA BADAK SELATAN, KOJA, JAKARTA UTARA, DKI JAKARTA",43,88,156,244
https://kawalpemilu.org#25907,"RAWA BADAK SELATAN, KOJA, JAKARTA UTARA, DKI JAKARTA",44,88,164,252
https://kawalpemilu.org#25907,"RAWA BADAK SELATAN, KOJA, JAKARTA UTARA, DKI JAKARTA",45,100,127,227
https://kawalpemilu.org#25907,"RAWA BADAK SELATAN, KOJA, JAKARTA UTARA, DKI JAKARTA",46,131,130,261
https://kawalpemilu.org#25907,"RAWA BADAK SELATAN, KOJA, JAKARTA UTARA, DKI JAKARTA",47,129,120,249
https://kawalpemilu.org#25907,"RAWA BADAK SELATAN, KOJA, JAKARTA UTARA, DKI JAKARTA",48,101,151,252
https://kawalpemilu.org#25907,"RAWA BADAK SELATAN, KOJA, JAKARTA UTARA, DKI JAKARTA",49,100,147,247
https://kawalpemilu.org#25907,"RAWA BADAK SELATAN, KOJA, JAKARTA UTARA, DKI JAKARTA",50,94,150,244
https://kawalpemilu.org#25907,"RAWA BADAK SELATAN, KOJA, JAKARTA UTARA, DKI JAKARTA",51,117,133,250
https://kawalpemilu.org#25907,"RAWA BADAK SELATAN, KOJA, JAKARTA UTARA, DKI JAKARTA",52,68,169,237
https://kawalpemilu.org#25907,"RAWA BADAK SELATAN, KOJA, JAKARTA UTARA, DKI JAKARTA",53,66,166,232
https://kawalpemilu.org#25907,"RAWA BADAK SELATAN, KOJA, JAKARTA UTARA, DKI JAKARTA",54,126,121,247
https://kawalpemilu.org#25907,"RAWA BADAK SELATAN, KOJA, JAKARTA UTARA, DKI JAKARTA",56,114,162,276
https://kawalpemilu.org#25907,"RAWA BADAK SELATAN, KOJA, JAKARTA UTARA, DKI JAKARTA",57,100,89,189
https://kawalpemilu.org#25907,"RAWA BADAK SELATAN, KOJA, JAKARTA UTARA, DKI JAKARTA",58,84,126,210
https://kawalpemilu.org#25907,"RAWA BADAK SELATAN, KOJA, JAKARTA UTARA, DKI JAKARTA",59,96,115,211
https://kawalpemilu.org#25907,"RAWA BADAK SELATAN, KOJA, JAKARTA UTARA, DKI JAKARTA",60,159,59,218
https://kawalpemilu.org#25907,"RAWA BADAK SELATAN, KOJA, JAKARTA UTARA, DKI JAKARTA",61,143,61,205
https://kawalpemilu.org#25907,"RAWA BADAK SELATAN, KOJA, JAKARTA UTARA, DKI JAKARTA",62,101,100,201
https://kawalpemilu.org#25907,"RAWA BADAK SELATAN, KOJA, JAKARTA UTARA, DKI JAKARTA",63,130,124,254
https://kawalpemilu.org#25907,"RAWA BADAK SELATAN, KOJA, JAKARTA UTARA, DKI JAKARTA",64,97,124,221
https://kawalpemilu.org#25907,"RAWA BADAK SELATAN, KOJA, JAKARTA UTARA, DKI JAKARTA",65,148,138,286
https://kawalpemilu.org#25907,"RAWA BADAK SELATAN, KOJA, JAKARTA UTARA, DKI JAKARTA",66,89,135,224
https://kawalpemilu.org#25907,"RAWA BADAK SELATAN, KOJA, JAKARTA UTARA, DKI JAKARTA",67,180,75,255
https://kawalpemilu.org#25907,"RAWA BADAK SELATAN, KOJA, JAKARTA UTARA, DKI JAKARTA",68,125,166,291
https://kawalpemilu.org#25907,"RAWA BADAK SELATAN, KOJA, JAKARTA UTARA, DKI JAKARTA",69,123,115,238
https://kawalpemilu.org#25907,"RAWA BADAK SELATAN, KOJA, JAKARTA UTARA, DKI JAKARTA",70,183,56,239
https://kawalpemilu.org#25907,"RAWA BADAK SELATAN, KOJA, JAKARTA UTARA, DKI JAKARTA",71,84,141,225
https://kawalpemilu.org#25907,"RAWA BADAK SELATAN, KOJA, JAKARTA UTARA, DKI JAKARTA",72,96,171,267
https://kawalpemilu.org#25907,"RAWA BADAK SELATAN, KOJA, JAKARTA UTARA, DKI JAKARTA",73,129,148,277
https://kawalpemilu.org#25907,"RAWA BADAK SELATAN, KOJA, JAKARTA UTARA, DKI JAKARTA",74,137,121,258
https://kawalpemilu.org#25907,"RAWA BADAK SELATAN, KOJA, JAKARTA UTARA, DKI JAKARTA",75,116,114,230
https://kawalpemilu.org#25907,"RAWA BADAK SELATAN, KOJA, JAKARTA UTARA, DKI JAKARTA",76,111,154,265
https://kawalpemilu.org#25907,"RAWA BADAK SELATAN, KOJA, JAKARTA UTARA, DKI JAKARTA",77,85,156,241
https://kawalpemilu.org#25907,"RAWA BADAK SELATAN, KOJA, JAKARTA UTARA, DKI JAKARTA",78,145,113,258
https://kawalpemilu.org#25907,"RAWA BADAK SELATAN, KOJA, JAKARTA UTARA, DKI JAKARTA",79,90,171,261
https://kawalpemilu.org#25907,"RAWA BADAK SELATAN, KOJA, JAKARTA UTARA, DKI JAKARTA",80,124,131,255
https://kawalpemilu.org#25907,"RAWA BADAK SELATAN, KOJA, JAKARTA UTARA, DKI JAKARTA",81,192,60,252
https://kawalpemilu.org#25907,"RAWA BADAK SELATAN, KOJA, JAKARTA UTARA, DKI JAKARTA",82,233,66,299
https://kawalpemilu.org#25907,"RAWA BADAK SELATAN, KOJA, JAKARTA UTARA, DKI JAKARTA",83,167,64,232
https://kawalpemilu.org#25907,"RAWA BADAK SELATAN, KOJA, JAKARTA UTARA, DKI JAKARTA",84,155,97,252
https://kawalpemilu.org#25907,"RAWA BADAK SELATAN, KOJA, JAKARTA UTARA, DKI JAKARTA",85,102,162,264
https://kawalpemilu.org#25907,"RAWA BADAK SELATAN, KOJA, JAKARTA UTARA, DKI JAKARTA",86,105,149,254
https://kawalpemilu.org#25907,"RAWA BADAK SELATAN, KOJA, JAKARTA UTARA, DKI JAKARTA",87,90,146,236
https://kawalpemilu.org#25907,"RAWA BADAK SELATAN, KOJA, JAKARTA UTARA, DKI JAKARTA",88,91,162,253
https://kawalpemilu.org#25907,"RAWA BADAK SELATAN, KOJA, JAKARTA UTARA, DKI JAKARTA",89,113,120,233
https://kawalpemilu.org#25907,"RAWA BADAK SELATAN, KOJA, JAKARTA UTARA, DKI JAKARTA",90,140,96,236
https://kawalpemilu.org#25907,"RAWA BADAK SELATAN, KOJA, JAKARTA UTARA, DKI JAKARTA",91,150,103,253
https://kawalpemilu.org#25907,"RAWA BADAK SELATAN, KOJA, JAKARTA UTARA, DKI JAKARTA",92,129,102,231
https://kawalpemilu.org#25907,"RAWA BADAK SELATAN, KOJA, JAKARTA UTARA, DKI JAKARTA",93,147,94,241
https://kawalpemilu.org#25907,"RAWA BADAK SELATAN, KOJA, JAKARTA UTARA, DKI JAKARTA",94,128,105,233
https://kawalpemilu.org#25907,"RAWA BADAK SELATAN, KOJA, JAKARTA UTARA, DKI JAKARTA",95,133,102,235
https://kawalpemilu.org#25907,"RAWA BADAK SELATAN, KOJA, JAKARTA UTARA, DKI JAKARTA",96,140,128,268
https://kawalpemilu.org#25907,"RAWA BADAK SELATAN, KOJA, JAKARTA UTARA, DKI JAKARTA",97,139,57,196
https://kawalpemilu.org#25907,"RAWA BADAK SELATAN, KOJA, JAKARTA UTARA, DKI JAKARTA",98,153,79,232
https://kawalpemilu.org#25907,"RAWA BADAK SELATAN, KOJA, JAKARTA UTARA, DKI JAKARTA",99,135,93,228
https://kawalpemilu.org#25907,"RAWA BADAK SELATAN, KOJA, JAKARTA UTARA, DKI JAKARTA",100,150,57,207
https://kawalpemilu.org#25907,"RAWA BADAK SELATAN, KOJA, JAKARTA UTARA, DKI JAKARTA",101,113,66,179
https://kawalpemilu.org#25907,"RAWA BADAK SELATAN, KOJA, JAKARTA UTARA, DKI JAKARTA",102,150,25,175
https://kawalpemilu.org#25907,"RAWA BADAK SELATAN, KOJA, JAKARTA UTARA, DKI JAKARTA",103,217,45,262
https://kawalpemilu.org#25907,"RAWA BADAK SELATAN, KOJA, JAKARTA UTARA, DKI JAKARTA",104,232,36,268
https://kawalpemilu.org#25907,"RAWA BADAK SELATAN, KOJA, JAKARTA UTARA, DKI JAKARTA",105,161,104,265
https://kawalpemilu.org#25907,"RAWA BADAK SELATAN, KOJA, JAKARTA UTARA, DKI JAKARTA",106,130,91,221
https://kawalpemilu.org#25907,"RAWA BADAK SELATAN, KOJA, JAKARTA UTARA, DKI JAKARTA",107,194,52,246
https://kawalpemilu.org#25907,"RAWA BADAK SELATAN, KOJA, JAKARTA UTARA, DKI JAKARTA",108,174,97,271
https://kawalpemilu.org#25907,"RAWA BADAK SELATAN, KOJA, JAKARTA UTARA, DKI JAKARTA",109,144,76,220
https://kawalpemilu.org#25907,"RAWA BADAK SELATAN, KOJA, JAKARTA UTARA, DKI JAKARTA",110,191,73,264
https://kawalpemilu.org#25907,"RAWA BADAK SELATAN, KOJA, JAKARTA UTARA, DKI JAKARTA",111,147,102,249
https://kawalpemilu.org#25907,"RAWA BADAK SELATAN, KOJA, JAKARTA UTARA, DKI JAKARTA",112,167,100,267
https://kawalpemilu.org#25907,"RAWA BADAK SELATAN, KOJA, JAKARTA UTARA, DKI JAKARTA",113,254,70,324
https://kawalpemilu.org#25907,"RAWA BADAK SELATAN, KOJA, JAKARTA UTARA, DKI JAKARTA",114,136,114,250
https://kawalpemilu.org#25909,"CILINCING, CILINCING, JAKARTA UTARA, DKI JAKARTA",3,117,82,199
https://kawalpemilu.org#25909,"CILINCING, CILINCING, JAKARTA UTARA, DKI JAKARTA",4,80,107,187
https://kawalpemilu.org#25909,"CILINCING, CILINCING, JAKARTA UTARA, DKI JAKARTA",5,61,139,200
https://kawalpemilu.org#25909,"CILINCING, CILINCING, JAKARTA UTARA, DKI JAKARTA",6,100,94,194
https://kawalpemilu.org#25909,"CILINCING, CILINCING, JAKARTA UTARA, DKI JAKARTA",7,104,165,269
https://kawalpemilu.org#25909,"CILINCING, CILINCING, JAKARTA UTARA, DKI JAKARTA",8,105,116,221
https://kawalpemilu.org#25909,"CILINCING, CILINCING, JAKARTA UTARA, DKI JAKARTA",9,90,125,215
https://kawalpemilu.org#25909,"CILINCING, CILINCING, JAKARTA UTARA, DKI JAKARTA",10,69,90,159
https://kawalpemilu.org#25909,"CILINCING, CILINCING, JAKARTA UTARA, DKI JAKARTA",11,79,93,172
https://kawalpemilu.org#25909,"CILINCING, CILINCING, JAKARTA UTARA, DKI JAKARTA",12,98,128,226
https://kawalpemilu.org#25909,"CILINCING, CILINCING, JAKARTA UTARA, DKI JAKARTA",13,81,101,182
https://kawalpemilu.org#25909,"CILINCING, CILINCING, JAKARTA UTARA, DKI JAKARTA",14,72,130,202
https://kawalpemilu.org#25909,"CILINCING, CILINCING, JAKARTA UTARA, DKI JAKARTA",16,72,154,226
https://kawalpemilu.org#25909,"CILINCING, CILINCING, JAKARTA UTARA, DKI JAKARTA",17,92,112,204
https://kawalpemilu.org#25909,"CILINCING, CILINCING, JAKARTA UTARA, DKI JAKARTA",18,83,119,202
https://kawalpemilu.org#25909,"CILINCING, CILINCING, JAKARTA UTARA, DKI JAKARTA",19,109,110,219
https://kawalpemilu.org#25909,"CILINCING, CILINCING, JAKARTA UTARA, DKI JAKARTA",20,70,130,200
https://kawalpemilu.org#25909,"CILINCING, CILINCING, JAKARTA UTARA, DKI JAKARTA",21,112,90,202
https://kawalpemilu.org#25909,"CILINCING, CILINCING, JAKARTA UTARA, DKI JAKARTA",22,101,100,201
https://kawalpemilu.org#25909,"CILINCING, CILINCING, JAKARTA UTARA, DKI JAKARTA",23,88,103,191
https://kawalpemilu.org#25909,"CILINCING, CILINCING, JAKARTA UTARA, DKI JAKARTA",24,142,64,206
https://kawalpemilu.org#25909,"CILINCING, CILINCING, JAKARTA UTARA, DKI JAKARTA",25,71,115,186
https://kawalpemilu.org#25909,"CILINCING, CILINCING, JAKARTA UTARA, DKI JAKARTA",26,118,72,190
https://kawalpemilu.org#25909,"CILINCING, CILINCING, JAKARTA UTARA, DKI JAKARTA",27,120,125,245
https://kawalpemilu.org#25909,"CILINCING, CILINCING, JAKARTA UTARA, DKI JAKARTA",28,152,118,270
https://kawalpemilu.org#25909,"CILINCING, CILINCING, JAKARTA UTARA, DKI JAKARTA",29,152,72,224
https://kawalpemilu.org#25909,"CILINCING, CILINCING, JAKARTA UTARA, DKI JAKARTA",30,147,67,214
https://kawalpemilu.org#25909,"CILINCING, CILINCING, JAKARTA UTARA, DKI JAKARTA",31,131,97,228
https://kawalpemilu.org#25909,"CILINCING, CILINCING, JAKARTA UTARA, DKI JAKARTA",32,137,95,232
https://kawalpemilu.org#25909,"CILINCING, CILINCING, JAKARTA UTARA, DKI JAKARTA",33,130,90,220
https://kawalpemilu.org#25909,"CILINCING, CILINCING, JAKARTA UTARA, DKI JAKARTA",34,118,118,236
https://kawalpemilu.org#25909,"CILINCING, CILINCING, JAKARTA UTARA, DKI JAKARTA",35,156,116,272
https://kawalpemilu.org#25909,"CILINCING, CILINCING, JAKARTA UTARA, DKI JAKARTA",36,116,97,213
https://kawalpemilu.org#25909,"CILINCING, CILINCING, JAKARTA UTARA, DKI JAKARTA",37,108,88,196
https://kawalpemilu.org#25909,"CILINCING, CILINCING, JAKARTA UTARA, DKI JAKARTA",38,145,99,244
https://kawalpemilu.org#25909,"CILINCING, CILINCING, JAKARTA UTARA, DKI JAKARTA",39,118,117,235
https://kawalpemilu.org#25909,"CILINCING, CILINCING, JAKARTA UTARA, DKI JAKARTA",40,116,112,228
https://kawalpemilu.org#25909,"CILINCING, CILINCING, JAKARTA UTARA, DKI JAKARTA",41,142,116,258
https://kawalpemilu.org#25909,"CILINCING, CILINCING, JAKARTA UTARA, DKI JAKARTA",42,110,101,211
https://kawalpemilu.org#25909,"CILINCING, CILINCING, JAKARTA UTARA, DKI JAKARTA",43,150,95,245
https://kawalpemilu.org#25909,"CILINCING, CILINCING, JAKARTA UTARA, DKI JAKARTA",44,157,107,264
https://kawalpemilu.org#25909,"CILINCING, CILINCING, JAKARTA UTARA, DKI JAKARTA",45,150,128,278
https://kawalpemilu.org#25909,"CILINCING, CILINCING, JAKARTA UTARA, DKI JAKARTA",46,127,90,217
https://kawalpemilu.org#25909,"CILINCING, CILINCING, JAKARTA UTARA, DKI JAKARTA",47,120,103,223
https://kawalpemilu.org#25909,"CILINCING, CILINCING, JAKARTA UTARA, DKI JAKARTA",48,122,95,217
https://kawalpemilu.org#25909,"CILINCING, CILINCING, JAKARTA UTARA, DKI JAKARTA",49,135,126,261
https://kawalpemilu.org#25909,"CILINCING, CILINCING, JAKARTA UTARA, DKI JAKARTA",50,159,88,247
https://kawalpemilu.org#25909,"CILINCING, CILINCING, JAKARTA UTARA, DKI JAKARTA",51,135,117,252
https://kawalpemilu.org#25909,"CILINCING, CILINCING, JAKARTA UTARA, DKI JAKARTA",52,99,105,204
https://kawalpemilu.org#25909,"CILINCING, CILINCING, JAKARTA UTARA, DKI JAKARTA",53,105,69,174
https://kawalpemilu.org#25909,"CILINCING, CILINCING, JAKARTA UTARA, DKI JAKARTA",54,117,91,208
https://kawalpemilu.org#25909,"CILINCING, CILINCING, JAKARTA UTARA, DKI JAKARTA",55,122,82,204
https://kawalpemilu.org#25909,"CILINCING, CILINCING, JAKARTA UTARA, DKI JAKARTA",56,132,90,222
https://kawalpemilu.org#25909,"CILINCING, CILINCING, JAKARTA UTARA, DKI JAKARTA",57,132,102,234
https://kawalpemilu.org#25909,"CILINCING, CILINCING, JAKARTA UTARA, DKI JAKARTA",58,144,99,243
https://kawalpemilu.org#25909,"CILINCING, CILINCING, JAKARTA UTARA, DKI JAKARTA",59,118,97,215
https://kawalpemilu.org#25909,"CILINCING, CILINCING, JAKARTA UTARA, DKI JAKARTA",60,120,117,237
https://kawalpemilu.org#25909,"CILINCING, CILINCING, JAKARTA UTARA, DKI JAKARTA",61,90,117,207
https://kawalpemilu.org#25909,"CILINCING, CILINCING, JAKARTA UTARA, DKI JAKARTA",62,132,104,236
https://kawalpemilu.org#25909,"CILINCING, CILINCING, JAKARTA UTARA, DKI JAKARTA",63,138,98,236
https://kawalpemilu.org#25909,"CILINCING, CILINCING, JAKARTA UTARA, DKI JAKARTA",64,144,89,233
https://kawalpemilu.org#25909,"CILINCING, CILINCING, JAKARTA UTARA, DKI JAKARTA",65,103,130,233
https://kawalpemilu.org#25909,"CILINCING, CILINCING, JAKARTA UTARA, DKI JAKARTA",66,123,102,225
https://kawalpemilu.org#25909,"CILINCING, CILINCING, JAKARTA UTARA, DKI JAKARTA",67,124,74,198
https://kawalpemilu.org#25909,"CILINCING, CILINCING, JAKARTA UTARA, DKI JAKARTA",68,138,79,217
https://kawalpemilu.org#25909,"CILINCING, CILINCING, JAKARTA UTARA, DKI JAKARTA",69,119,133,252
https://kawalpemilu.org#25909,"CILINCING, CILINCING, JAKARTA UTARA, DKI JAKARTA",70,126,110,236
https://kawalpemilu.org#25909,"CILINCING, CILINCING, JAKARTA UTARA, DKI JAKARTA",71,110,85,195
https://kawalpemilu.org#25909,"CILINCING, CILINCING, JAKARTA UTARA, DKI JAKARTA",72,156,94,250
https://kawalpemilu.org#25909,"CILINCING, CILINCING, JAKARTA UTARA, DKI JAKARTA",73,133,112,245
https://kawalpemilu.org#25909,"CILINCING, CILINCING, JAKARTA UTARA, DKI JAKARTA",74,149,136,285
https://kawalpemilu.org#25909,"CILINCING, CILINCING, JAKARTA UTARA, DKI JAKARTA",75,153,110,263
https://kawalpemilu.org#25909,"CILINCING, CILINCING, JAKARTA UTARA, DKI JAKARTA",76,144,104,248
https://kawalpemilu.org#25909,"CILINCING, CILINCING, JAKARTA UTARA, DKI JAKARTA",77,135,98,233
https://kawalpemilu.org#25909,"CILINCING, CILINCING, JAKARTA UTARA, DKI JAKARTA",78,148,59,207
https://kawalpemilu.org#25909,"CILINCING, CILINCING, JAKARTA UTARA, DKI JAKARTA",79,76,113,189
https://kawalpemilu.org#25909,"CILINCING, CILINCING, JAKARTA UTARA, DKI JAKARTA",80,101,131,232
https://kawalpemilu.org#25909,"CILINCING, CILINCING, JAKARTA UTARA, DKI JAKARTA",81,89,27,116
https://kawalpemilu.org#25909,"CILINCING, CILINCING, JAKARTA UTARA, DKI JAKARTA",82,84,60,144
https://kawalpemilu.org#25909,"CILINCING, CILINCING, JAKARTA UTARA, DKI JAKARTA",83,120,96,216
https://kawalpemilu.org#25909,"CILINCING, CILINCING, JAKARTA UTARA, DKI JAKARTA",84,117,109,226
https://kawalpemilu.org#25909,"CILINCING, CILINCING, JAKARTA UTARA, DKI JAKARTA",85,150,97,247
https://kawalpemilu.org#25909,"CILINCING, CILINCING, JAKARTA UTARA, DKI JAKARTA",86,89,135,224
https://kawalpemilu.org#25909,"CILINCING, CILINCING, JAKARTA UTARA, DKI JAKARTA",87,100,157,257
https://kawalpemilu.org#25909,"CILINCING, CILINCING, JAKARTA UTARA, DKI JAKARTA",88,112,121,233
https://kawalpemilu.org#25909,"CILINCING, CILINCING, JAKARTA UTARA, DKI JAKARTA",89,84,138,222
https://kawalpemilu.org#25909,"CILINCING, CILINCING, JAKARTA UTARA, DKI JAKARTA",90,107,110,217
https://kawalpemilu.org#25909,"CILINCING, CILINCING, JAKARTA UTARA, DKI JAKARTA",91,112,143,255
https://kawalpemilu.org#25909,"CILINCING, CILINCING, JAKARTA UTARA, DKI JAKARTA",92,106,121,227
https://kawalpemilu.org#25909,"CILINCING, CILINCING, JAKARTA UTARA, DKI JAKARTA",93,95,114,209
https://kawalpemilu.org#25909,"CILINCING, CILINCING, JAKARTA UTARA, DKI JAKARTA",94,115,118,233
https://kawalpemilu.org#25909,"CILINCING, CILINCING, JAKARTA UTARA, DKI JAKARTA",95,128,97,225
https://kawalpemilu.org#25909,"CILINCING, CILINCING, JAKARTA UTARA, DKI JAKARTA",96,84,104,188
https://kawalpemilu.org#25909,"CILINCING, CILINCING, JAKARTA UTARA, DKI JAKARTA",97,117,90,207
https://kawalpemilu.org#25909,"CILINCING, CILINCING, JAKARTA UTARA, DKI JAKARTA",98,108,39,147
https://kawalpemilu.org#25909,"CILINCING, CILINCING, JAKARTA UTARA, DKI JAKARTA",99,111,57,168
https://kawalpemilu.org#25909,"CILINCING, CILINCING, JAKARTA UTARA, DKI JAKARTA",100,99,150,249
https://kawalpemilu.org#25909,"CILINCING, CILINCING, JAKARTA UTARA, DKI JAKARTA",101,160,51,211
https://kawalpemilu.org#25909,"CILINCING, CILINCING, JAKARTA UTARA, DKI JAKARTA",102,94,113,207
https://kawalpemilu.org#25909,"CILINCING, CILINCING, JAKARTA UTARA, DKI JAKARTA",103,125,88,213
https://kawalpemilu.org#25909,"CILINCING, CILINCING, JAKARTA UTARA, DKI JAKARTA",104,84,94,178
https://kawalpemilu.org#25909,"CILINCING, CILINCING, JAKARTA UTARA, DKI JAKARTA",105,105,82,187
https://kawalpemilu.org#25909,"CILINCING, CILINCING, JAKARTA UTARA, DKI JAKARTA",106,134,52,186
https://kawalpemilu.org#25909,"CILINCING, CILINCING, JAKARTA UTARA, DKI JAKARTA",107,129,55,184
https://kawalpemilu.org#25909,"CILINCING, CILINCING, JAKARTA UTARA, DKI JAKARTA",108,129,106,235
https://kawalpemilu.org#25909,"CILINCING, CILINCING, JAKARTA UTARA, DKI JAKARTA",109,146,65,211
https://kawalpemilu.org#25909,"CILINCING, CILINCING, JAKARTA UTARA, DKI JAKARTA",110,160,51,211
https://kawalpemilu.org#25909,"CILINCING, CILINCING, JAKARTA UTARA, DKI JAKARTA",111,165,90,255
https://kawalpemilu.org#25909,"CILINCING, CILINCING, JAKARTA UTARA, DKI JAKARTA",112,139,50,189
https://kawalpemilu.org#25909,"CILINCING, CILINCING, JAKARTA UTARA, DKI JAKARTA",113,188,65,253
https://kawalpemilu.org#25909,"CILINCING, CILINCING, JAKARTA UTARA, DKI JAKARTA",114,149,110,259
https://kawalpemilu.org#25909,"CILINCING, CILINCING, JAKARTA UTARA, DKI JAKARTA",115,149,99,248
https://kawalpemilu.org#25909,"CILINCING, CILINCING, JAKARTA UTARA, DKI JAKARTA",116,122,132,254
https://kawalpemilu.org#25909,"CILINCING, CILINCING, JAKARTA UTARA, DKI JAKARTA",117,119,140,259
https://kawalpemilu.org#25909,"CILINCING, CILINCING, JAKARTA UTARA, DKI JAKARTA",118,125,130,255
https://kawalpemilu.org#25909,"CILINCING, CILINCING, JAKARTA UTARA, DKI JAKARTA",119,136,130,266
https://kawalpemilu.org#25909,"CILINCING, CILINCING, JAKARTA UTARA, DKI JAKARTA",120,101,135,236
https://kawalpemilu.org#25909,"CILINCING, CILINCING, JAKARTA UTARA, DKI JAKARTA",121,127,126,253
https://kawalpemilu.org#25909,"CILINCING, CILINCING, JAKARTA UTARA, DKI JAKARTA",122,117,115,232
https://kawalpemilu.org#25909,"CILINCING, CILINCING, JAKARTA UTARA, DKI JAKARTA",123,140,98,238
https://kawalpemilu.org#25909,"CILINCING, CILINCING, JAKARTA UTARA, DKI JAKARTA",124,165,72,237
https://kawalpemilu.org#25909,"CILINCING, CILINCING, JAKARTA UTARA, DKI JAKARTA",125,100,102,202
https://kawalpemilu.org#25910,"SUKAPURA, CILINCING, JAKARTA UTARA, DKI JAKARTA",1,96,151,247
https://kawalpemilu.org#25910,"SUKAPURA, CILINCING, JAKARTA UTARA, DKI JAKARTA",2,91,137,228
https://kawalpemilu.org#25910,"SUKAPURA, CILINCING, JAKARTA UTARA, DKI JAKARTA",5,87,97,184
https://kawalpemilu.org#25910,"SUKAPURA, CILINCING, JAKARTA UTARA, DKI JAKARTA",6,61,117,178
https://kawalpemilu.org#25910,"SUKAPURA, CILINCING, JAKARTA UTARA, DKI JAKARTA",7,80,97,177
https://kawalpemilu.org#25910,"SUKAPURA, CILINCING, JAKARTA UTARA, DKI JAKARTA",8,77,118,195
https://kawalpemilu.org#25910,"SUKAPURA, CILINCING, JAKARTA UTARA, DKI JAKARTA",9,106,157,263
https://kawalpemilu.org#25910,"SUKAPURA, CILINCING, JAKARTA UTARA, DKI JAKARTA",10,96,150,246
https://kawalpemilu.org#25910,"SUKAPURA, CILINCING, JAKARTA UTARA, DKI JAKARTA",11,108,143,251
https://kawalpemilu.org#25910,"SUKAPURA, CILINCING, JAKARTA UTARA, DKI JAKARTA",12,102,127,229
https://kawalpemilu.org#25910,"SUKAPURA, CILINCING, JAKARTA UTARA, DKI JAKARTA",14,64,107,171
https://kawalpemilu.org#25910,"SUKAPURA, CILINCING, JAKARTA UTARA, DKI JAKARTA",15,55,119,174
https://kawalpemilu.org#25910,"SUKAPURA, CILINCING, JAKARTA UTARA, DKI JAKARTA",16,96,110,206
https://kawalpemilu.org#25910,"SUKAPURA, CILINCING, JAKARTA UTARA, DKI JAKARTA",17,61,54,115
https://kawalpemilu.org#25910,"SUKAPURA, CILINCING, JAKARTA UTARA, DKI JAKARTA",18,80,102,182
https://kawalpemilu.org#25910,"SUKAPURA, CILINCING, JAKARTA UTARA, DKI JAKARTA",20,74,74,148
https://kawalpemilu.org#25910,"SUKAPURA, CILINCING, JAKARTA UTARA, DKI JAKARTA",21,66,76,142
https://kawalpemilu.org#25910,"SUKAPURA, CILINCING, JAKARTA UTARA, DKI JAKARTA",23,70,92,162
https://kawalpemilu.org#25910,"SUKAPURA, CILINCING, JAKARTA UTARA, DKI JAKARTA",24,62,81,143
https://kawalpemilu.org#25910,"SUKAPURA, CILINCING, JAKARTA UTARA, DKI JAKARTA",25,83,85,168
https://kawalpemilu.org#25910,"SUKAPURA, CILINCING, JAKARTA UTARA, DKI JAKARTA",26,85,106,191
https://kawalpemilu.org#25910,"SUKAPURA, CILINCING, JAKARTA UTARA, DKI JAKARTA",27,103,107,210
https://kawalpemilu.org#25910,"SUKAPURA, CILINCING, JAKARTA UTARA, DKI JAKARTA",28,58,118,176
https://kawalpemilu.org#25910,"SUKAPURA, CILINCING, JAKARTA UTARA, DKI JAKARTA",30,65,106,171
https://kawalpemilu.org#25910,"SUKAPURA, CILINCING, JAKARTA UTARA, DKI JAKARTA",33,82,113,195
https://kawalpemilu.org#25910,"SUKAPURA, CILINCING, JAKARTA UTARA, DKI JAKARTA",35,84,94,178
https://kawalpemilu.org#25910,"SUKAPURA, CILINCING, JAKARTA UTARA, DKI JAKARTA",36,99,112,211
https://kawalpemilu.org#25910,"SUKAPURA, CILINCING, JAKARTA UTARA, DKI JAKARTA",37,117,94,211
https://kawalpemilu.org#25910,"SUKAPURA, CILINCING, JAKARTA UTARA, DKI JAKARTA",38,82,95,177
https://kawalpemilu.org#25910,"SUKAPURA, CILINCING, JAKARTA UTARA, DKI JAKARTA",39,78,113,191
https://kawalpemilu.org#25910,"SUKAPURA, CILINCING, JAKARTA UTARA, DKI JAKARTA",40,64,78,142
https://kawalpemilu.org#25910,"SUKAPURA, CILINCING, JAKARTA UTARA, DKI JAKARTA",41,69,110,178
https://kawalpemilu.org#25910,"SUKAPURA, CILINCING, JAKARTA UTARA, DKI JAKARTA",42,94,103,197
https://kawalpemilu.org#25910,"SUKAPURA, CILINCING, JAKARTA UTARA, DKI JAKARTA",43,40,90,130
https://kawalpemilu.org#25910,"SUKAPURA, CILINCING, JAKARTA UTARA, DKI JAKARTA",44,100,121,221
https://kawalpemilu.org#25910,"SUKAPURA, CILINCING, JAKARTA UTARA, DKI JAKARTA",45,83,98,181
https://kawalpemilu.org#25910,"SUKAPURA, CILINCING, JAKARTA UTARA, DKI JAKARTA",47,127,58,185
https://kawalpemilu.org#25910,"SUKAPURA, CILINCING, JAKARTA UTARA, DKI JAKARTA",48,105,62,167
https://kawalpemilu.org#25910,"SUKAPURA, CILINCING, JAKARTA UTARA, DKI JAKARTA",49,83,103,186
https://kawalpemilu.org#25910,"SUKAPURA, CILINCING, JAKARTA UTARA, DKI JAKARTA",50,65,127,192
https://kawalpemilu.org#25910,"SUKAPURA, CILINCING, JAKARTA UTARA, DKI JAKARTA",53,84,114,198
https://kawalpemilu.org#25910,"SUKAPURA, CILINCING, JAKARTA UTARA, DKI JAKARTA",54,77,114,191
https://kawalpemilu.org#25910,"SUKAPURA, CILINCING, JAKARTA UTARA, DKI JAKARTA",56,89,152,241
https://kawalpemilu.org#25910,"SUKAPURA, CILINCING, JAKARTA UTARA, DKI JAKARTA",57,82,87,169
https://kawalpemilu.org#25910,"SUKAPURA, CILINCING, JAKARTA UTARA, DKI JAKARTA",58,92,144,236
https://kawalpemilu.org#25910,"SUKAPURA, CILINCING, JAKARTA UTARA, DKI JAKARTA",59,76,137,213
https://kawalpemilu.org#25910,"SUKAPURA, CILINCING, JAKARTA UTARA, DKI JAKARTA",60,49,121,170
https://kawalpemilu.org#25910,"SUKAPURA, CILINCING, JAKARTA UTARA, DKI JAKARTA",61,43,128,171
https://kawalpemilu.org#25910,"SUKAPURA, CILINCING, JAKARTA UTARA, DKI JAKARTA",62,60,132,192
https://kawalpemilu.org#25910,"SUKAPURA, CILINCING, JAKARTA UTARA, DKI JAKARTA",63,50,120,170
https://kawalpemilu.org#25910,"SUKAPURA, CILINCING, JAKARTA UTARA, DKI JAKARTA",64,60,148,208
https://kawalpemilu.org#25910,"SUKAPURA, CILINCING, JAKARTA UTARA, DKI JAKARTA",66,71,151,222
https://kawalpemilu.org#25910,"SUKAPURA, CILINCING, JAKARTA UTARA, DKI JAKARTA",67,61,147,208
https://kawalpemilu.org#25910,"SUKAPURA, CILINCING, JAKARTA UTARA, DKI JAKARTA",68,55,149,204
https://kawalpemilu.org#25910,"SUKAPURA, CILINCING, JAKARTA UTARA, DKI JAKARTA",69,73,140,213
https://kawalpemilu.org#25910,"SUKAPURA, CILINCING, JAKARTA UTARA, DKI JAKARTA",70,60,153,213
https://kawalpemilu.org#25910,"SUKAPURA, CILINCING, JAKARTA UTARA, DKI JAKARTA",71,112,121,233
https://kawalpemilu.org#25910,"SUKAPURA, CILINCING, JAKARTA UTARA, DKI JAKARTA",72,86,94,180
https://kawalpemilu.org#25910,"SUKAPURA, CILINCING, JAKARTA UTARA, DKI JAKARTA",73,71,122,193
https://kawalpemilu.org#25910,"SUKAPURA, CILINCING, JAKARTA UTARA, DKI JAKARTA",75,64,77,141
https://kawalpemilu.org#25910,"SUKAPURA, CILINCING, JAKARTA UTARA, DKI JAKARTA",76,52,116,168
https://kawalpemilu.org#25910,"SUKAPURA, CILINCING, JAKARTA UTARA, DKI JAKARTA",77,71,153,224
https://kawalpemilu.org#25910,"SUKAPURA, CILINCING, JAKARTA UTARA, DKI JAKARTA",78,44,110,154
https://kawalpemilu.org#25910,"SUKAPURA, CILINCING, JAKARTA UTARA, DKI JAKARTA",79,71,136,207
https://kawalpemilu.org#25910,"SUKAPURA, CILINCING, JAKARTA UTARA, DKI JAKARTA",80,63,131,194
https://kawalpemilu.org#25910,"SUKAPURA, CILINCING, JAKARTA UTARA, DKI JAKARTA",81,77,127,204
https://kawalpemilu.org#25910,"SUKAPURA, CILINCING, JAKARTA UTARA, DKI JAKARTA",82,85,90,175
https://kawalpemilu.org#25910,"SUKAPURA, CILINCING, JAKARTA UTARA, DKI JAKARTA",83,81,76,157
https://kawalpemilu.org#25910,"SUKAPURA, CILINCING, JAKARTA UTARA, DKI JAKARTA",84,90,130,0
https://kawalpemilu.org#25910,"SUKAPURA, CILINCING, JAKARTA UTARA, DKI JAKARTA",85,97,95,192
https://kawalpemilu.org#25910,"SUKAPURA, CILINCING, JAKARTA UTARA, DKI JAKARTA",86,79,80,159
https://kawalpemilu.org#25910,"SUKAPURA, CILINCING, JAKARTA UTARA, DKI JAKARTA",87,67,114,181
https://kawalpemilu.org#25910,"SUKAPURA, CILINCING, JAKARTA UTARA, DKI JAKARTA",89,93,128,221
https://kawalpemilu.org#25910,"SUKAPURA, CILINCING, JAKARTA UTARA, DKI JAKARTA",90,58,142,200
https://kawalpemilu.org#25910,"SUKAPURA, CILINCING, JAKARTA UTARA, DKI JAKARTA",91,69,141,210
https://kawalpemilu.org#25910,"SUKAPURA, CILINCING, JAKARTA UTARA, DKI JAKARTA",92,53,153,206
https://kawalpemilu.org#25910,"SUKAPURA, CILINCING, JAKARTA UTARA, DKI JAKARTA",93,75,164,239
https://kawalpemilu.org#25910,"SUKAPURA, CILINCING, JAKARTA UTARA, DKI JAKARTA",96,62,121,183
https://kawalpemilu.org#25910,"SUKAPURA, CILINCING, JAKARTA UTARA, DKI JAKARTA",99,118,102,220
https://kawalpemilu.org#25910,"SUKAPURA, CILINCING, JAKARTA UTARA, DKI JAKARTA",100,102,124,226
https://kawalpemilu.org#25910,"SUKAPURA, CILINCING, JAKARTA UTARA, DKI JAKARTA",101,90,96,186
https://kawalpemilu.org#25910,"SUKAPURA, CILINCING, JAKARTA UTARA, DKI JAKARTA",103,87,116,203
https://kawalpemilu.org#25910,"SUKAPURA, CILINCING, JAKARTA UTARA, DKI JAKARTA",104,76,173,249
https://kawalpemilu.org#25910,"SUKAPURA, CILINCING, JAKARTA UTARA, DKI JAKARTA",105,59,131,190
https://kawalpemilu.org#25910,"SUKAPURA, CILINCING, JAKARTA UTARA, DKI JAKARTA",106,71,109,180
https://kawalpemilu.org#25910,"SUKAPURA, CILINCING, JAKARTA UTARA, DKI JAKARTA",107,94,114,208
https://kawalpemilu.org#25910,"SUKAPURA, CILINCING, JAKARTA UTARA, DKI JAKARTA",108,88,128,216
https://kawalpemilu.org#25910,"SUKAPURA, CILINCING, JAKARTA UTARA, DKI JAKARTA",109,75,95,170
https://kawalpemilu.org#25910,"SUKAPURA, CILINCING, JAKARTA UTARA, DKI JAKARTA",110,80,149,229
https://kawalpemilu.org#25910,"SUKAPURA, CILINCING, JAKARTA UTARA, DKI JAKARTA",111,108,128,236
https://kawalpemilu.org#25910,"SUKAPURA, CILINCING, JAKARTA UTARA, DKI JAKARTA",112,74,145,219
https://kawalpemilu.org#25910,"SUKAPURA, CILINCING, JAKARTA UTARA, DKI JAKARTA",113,98,116,214
https://kawalpemilu.org#25910,"SUKAPURA, CILINCING, JAKARTA UTARA, DKI JAKARTA",114,91,131,222
https://kawalpemilu.org#25910,"SUKAPURA, CILINCING, JAKARTA UTARA, DKI JAKARTA",115,90,138,228
https://kawalpemilu.org#25910,"SUKAPURA, CILINCING, JAKARTA UTARA, DKI JAKARTA",116,73,106,179
https://kawalpemilu.org#25910,"SUKAPURA, CILINCING, JAKARTA UTARA, DKI JAKARTA",118,124,118,242
https://kawalpemilu.org#25910,"SUKAPURA, CILINCING, JAKARTA UTARA, DKI JAKARTA",119,136,106,242
https://kawalpemilu.org#25910,"SUKAPURA, CILINCING, JAKARTA UTARA, DKI JAKARTA",120,65,132,197
https://kawalpemilu.org#25910,"SUKAPURA, CILINCING, JAKARTA UTARA, DKI JAKARTA",121,93,96,189
https://kawalpemilu.org#25910,"SUKAPURA, CILINCING, JAKARTA UTARA, DKI JAKARTA",122,66,80,146
https://kawalpemilu.org#25910,"SUKAPURA, CILINCING, JAKARTA UTARA, DKI JAKARTA",123,91,92,183
https://kawalpemilu.org#25910,"SUKAPURA, CILINCING, JAKARTA UTARA, DKI JAKARTA",124,112,113,225
https://kawalpemilu.org#25910,"SUKAPURA, CILINCING, JAKARTA UTARA, DKI JAKARTA",125,82,147,229
https://kawalpemilu.org#25910,"SUKAPURA, CILINCING, JAKARTA UTARA, DKI JAKARTA",126,109,105,214
https://kawalpemilu.org#25910,"SUKAPURA, CILINCING, JAKARTA UTARA, DKI JAKARTA",127,121,99,220
https://kawalpemilu.org#25910,"SUKAPURA, CILINCING, JAKARTA UTARA, DKI JAKARTA",128,108,112,220
https://kawalpemilu.org#25910,"SUKAPURA, CILINCING, JAKARTA UTARA, DKI JAKARTA",129,125,118,243
https://kawalpemilu.org#25910,"SUKAPURA, CILINCING, JAKARTA UTARA, DKI JAKARTA",130,119,100,219
https://kawalpemilu.org#25910,"SUKAPURA, CILINCING, JAKARTA UTARA, DKI JAKARTA",131,126,120,246
https://kawalpemilu.org#25910,"SUKAPURA, CILINCING, JAKARTA UTARA, DKI JAKARTA",132,129,122,251
https://kawalpemilu.org#25910,"SUKAPURA, CILINCING, JAKARTA UTARA, DKI JAKARTA",133,85,131,216
https://kawalpemilu.org#25910,"SUKAPURA, CILINCING, JAKARTA UTARA, DKI JAKARTA",134,120,104,224
https://kawalpemilu.org#25910,"SUKAPURA, CILINCING, JAKARTA UTARA, DKI JAKARTA",135,156,72,228
https://kawalpemilu.org#25910,"SUKAPURA, CILINCING, JAKARTA UTARA, DKI JAKARTA",136,97,75,172
https://kawalpemilu.org#25910,"SUKAPURA, CILINCING, JAKARTA UTARA, DKI JAKARTA",137,98,107,205
https://kawalpemilu.org#25910,"SUKAPURA, CILINCING, JAKARTA UTARA, DKI JAKARTA",138,84,110,194
https://kawalpemilu.org#25910,"SUKAPURA, CILINCING, JAKARTA UTARA, DKI JAKARTA",139,153,46,199
https://kawalpemilu.org#25910,"SUKAPURA, CILINCING, JAKARTA UTARA, DKI JAKARTA",140,152,37,189
https://kawalpemilu.org#25910,"SUKAPURA, CILINCING, JAKARTA UTARA, DKI JAKARTA",141,168,34,202
https://kawalpemilu.org#25910,"SUKAPURA, CILINCING, JAKARTA UTARA, DKI JAKARTA",142,154,63,217
https://kawalpemilu.org#25910,"SUKAPURA, CILINCING, JAKARTA UTARA, DKI JAKARTA",143,193,37,230
https://kawalpemilu.org#25910,"SUKAPURA, CILINCING, JAKARTA UTARA, DKI JAKARTA",144,199,31,230
https://kawalpemilu.org#25910,"SUKAPURA, CILINCING, JAKARTA UTARA, DKI JAKARTA",145,97,61,158
https://kawalpemilu.org#25910,"SUKAPURA, CILINCING, JAKARTA UTARA, DKI JAKARTA",147,87,122,209
https://kawalpemilu.org#25910,"SUKAPURA, CILINCING, JAKARTA UTARA, DKI JAKARTA",148,122,83,205
https://kawalpemilu.org#25910,"SUKAPURA, CILINCING, JAKARTA UTARA, DKI JAKARTA",150,92,71,163
https://kawalpemilu.org#25910,"SUKAPURA, CILINCING, JAKARTA UTARA, DKI JAKARTA",151,111,102,213
https://kawalpemilu.org#25910,"SUKAPURA, CILINCING, JAKARTA UTARA, DKI JAKARTA",152,91,95,186
https://kawalpemilu.org#25910,"SUKAPURA, CILINCING, JAKARTA UTARA, DKI JAKARTA",153,104,106,210
https://kawalpemilu.org#25910,"SUKAPURA, CILINCING, JAKARTA UTARA, DKI JAKARTA",154,97,106,203
https://kawalpemilu.org#25910,"SUKAPURA, CILINCING, JAKARTA UTARA, DKI JAKARTA",155,92,124,216
https://kawalpemilu.org#25910,"SUKAPURA, CILINCING, JAKARTA UTARA, DKI JAKARTA",156,135,112,247
https://kawalpemilu.org#25910,"SUKAPURA, CILINCING, JAKARTA UTARA, DKI JAKARTA",157,113,86,199
https://kawalpemilu.org#25910,"SUKAPURA, CILINCING, JAKARTA UTARA, DKI JAKARTA",158,129,126,255
https://kawalpemilu.org#25910,"SUKAPURA, CILINCING, JAKARTA UTARA, DKI JAKARTA",159,80,121,201
https://kawalpemilu.org#25910,"SUKAPURA, CILINCING, JAKARTA UTARA, DKI JAKARTA",160,89,95,184
https://kawalpemilu.org#25910,"SUKAPURA, CILINCING, JAKARTA UTARA, DKI JAKARTA",161,228,22,250
https://kawalpemilu.org#25910,"SUKAPURA, CILINCING, JAKARTA UTARA, DKI JAKARTA",162,196,10,206
https://kawalpemilu.org#25910,"SUKAPURA, CILINCING, JAKARTA UTARA, DKI JAKARTA",163,202,9,211
https://kawalpemilu.org#25910,"SUKAPURA, CILINCING, JAKARTA UTARA, DKI JAKARTA",164,210,27,237
https://kawalpemilu.org#25910,"SUKAPURA, CILINCING, JAKARTA UTARA, DKI JAKARTA",165,229,36,265
https://kawalpemilu.org#25910,"SUKAPURA, CILINCING, JAKARTA UTARA, DKI JAKARTA",166,226,22,248
https://kawalpemilu.org#25910,"SUKAPURA, CILINCING, JAKARTA UTARA, DKI JAKARTA",167,232,19,1
https://kawalpemilu.org#25911,"MARUNDA, CILINCING, JAKARTA UTARA, DKI JAKARTA",1,76,127,203
https://kawalpemilu.org#25911,"MARUNDA, CILINCING, JAKARTA UTARA, DKI JAKARTA",2,97,133,230
https://kawalpemilu.org#25911,"MARUNDA, CILINCING, JAKARTA UTARA, DKI JAKARTA",3,109,127,236
https://kawalpemilu.org#25911,"MARUNDA, CILINCING, JAKARTA UTARA, DKI JAKARTA",4,104,139,243
https://kawalpemilu.org#25911,"MARUNDA, CILINCING, JAKARTA UTARA, DKI JAKARTA",5,110,117,217
https://kawalpemilu.org#25911,"MARUNDA, CILINCING, JAKARTA UTARA, DKI JAKARTA",6,122,113,235
https://kawalpemilu.org#25911,"MARUNDA, CILINCING, JAKARTA UTARA, DKI JAKARTA",7,81,167,248
https://kawalpemilu.org#25911,"MARUNDA, CILINCING, JAKARTA UTARA, DKI JAKARTA",8,85,190,275
https://kawalpemilu.org#25911,"MARUNDA, CILINCING, JAKARTA UTARA, DKI JAKARTA",9,87,191,278
https://kawalpemilu.org#25911,"MARUNDA, CILINCING, JAKARTA UTARA, DKI JAKARTA",10,108,126,234
https://kawalpemilu.org#25911,"MARUNDA, CILINCING, JAKARTA UTARA, DKI JAKARTA",11,86,148,234
https://kawalpemilu.org#25911,"MARUNDA, CILINCING, JAKARTA UTARA, DKI JAKARTA",12,108,138,246
https://kawalpemilu.org#25911,"MARUNDA, CILINCING, JAKARTA UTARA, DKI JAKARTA",13,96,139,235
https://kawalpemilu.org#25911,"MARUNDA, CILINCING, JAKARTA UTARA, DKI JAKARTA",14,77,174,251
https://kawalpemilu.org#25911,"MARUNDA, CILINCING, JAKARTA UTARA, DKI JAKARTA",15,76,156,232
https://kawalpemilu.org#25911,"MARUNDA, CILINCING, JAKARTA UTARA, DKI JAKARTA",16,80,167,247
https://kawalpemilu.org#25911,"MARUNDA, CILINCING, JAKARTA UTARA, DKI JAKARTA",17,117,130,247
https://kawalpemilu.org#25911,"MARUNDA, CILINCING, JAKARTA UTARA, DKI JAKARTA",18,109,152,261
https://kawalpemilu.org#25911,"MARUNDA, CILINCING, JAKARTA UTARA, DKI JAKARTA",19,97,154,251
https://kawalpemilu.org#25911,"MARUNDA, CILINCING, JAKARTA UTARA, DKI JAKARTA",20,86,184,270
https://kawalpemilu.org#25911,"MARUNDA, CILINCING, JAKARTA UTARA, DKI JAKARTA",21,116,134,250
https://kawalpemilu.org#25911,"MARUNDA, CILINCING, JAKARTA UTARA, DKI JAKARTA",22,79,189,268
https://kawalpemilu.org#25911,"MARUNDA, CILINCING, JAKARTA UTARA, DKI JAKARTA",23,106,170,276
https://kawalpemilu.org#25911,"MARUNDA, CILINCING, JAKARTA UTARA, DKI JAKARTA",24,119,136,255
https://kawalpemilu.org#25911,"MARUNDA, CILINCING, JAKARTA UTARA, DKI JAKARTA",25,99,153,252
https://kawalpemilu.org#25911,"MARUNDA, CILINCING, JAKARTA UTARA, DKI JAKARTA",26,86,147,233
https://kawalpemilu.org#25911,"MARUNDA, CILINCING, JAKARTA UTARA, DKI JAKARTA",27,104,116,220
https://kawalpemilu.org#25911,"MARUNDA, CILINCING, JAKARTA UTARA, DKI JAKARTA",28,120,100,220
https://kawalpemilu.org#25911,"MARUNDA, CILINCING, JAKARTA UTARA, DKI JAKARTA",29,87,129,216
https://kawalpemilu.org#25911,"MARUNDA, CILINCING, JAKARTA UTARA, DKI JAKARTA",30,74,176,250
https://kawalpemilu.org#25911,"MARUNDA, CILINCING, JAKARTA UTARA, DKI JAKARTA",31,119,140,259
https://kawalpemilu.org#25911,"MARUNDA, CILINCING, JAKARTA UTARA, DKI JAKARTA",32,99,165,265
https://kawalpemilu.org#25911,"MARUNDA, CILINCING, JAKARTA UTARA, DKI JAKARTA",33,74,140,214
https://kawalpemilu.org#25911,"MARUNDA, CILINCING, JAKARTA UTARA, DKI JAKARTA",34,98,103,201
https://kawalpemilu.org#25911,"MARUNDA, CILINCING, JAKARTA UTARA, DKI JAKARTA",35,81,132,213
https://kawalpemilu.org#25911,"MARUNDA, CILINCING, JAKARTA UTARA, DKI JAKARTA",36,75,183,258
https://kawalpemilu.org#25911,"MARUNDA, CILINCING, JAKARTA UTARA, DKI JAKARTA",37,58,187,245
https://kawalpemilu.org#25911,"MARUNDA, CILINCING, JAKARTA UTARA, DKI JAKARTA",38,88,154,242
https://kawalpemilu.org#25911,"MARUNDA, CILINCING, JAKARTA UTARA, DKI JAKARTA",39,60,159,219
https://kawalpemilu.org#25911,"MARUNDA, CILINCING, JAKARTA UTARA, DKI JAKARTA",40,82,141,223
https://kawalpemilu.org#25911,"MARUNDA, CILINCING, JAKARTA UTARA, DKI JAKARTA",41,78,154,232
https://kawalpemilu.org#25911,"MARUNDA, CILINCING, JAKARTA UTARA, DKI JAKARTA",42,63,187,250
https://kawalpemilu.org#25911,"MARUNDA, CILINCING, JAKARTA UTARA, DKI JAKARTA",43,78,185,263
https://kawalpemilu.org#25911,"MARUNDA, CILINCING, JAKARTA UTARA, DKI JAKARTA",44,65,168,233
https://kawalpemilu.org#25911,"MARUNDA, CILINCING, JAKARTA UTARA, DKI JAKARTA",45,122,109,231
https://kawalpemilu.org#25911,"MARUNDA, CILINCING, JAKARTA UTARA, DKI JAKARTA",46,78,154,232
https://kawalpemilu.org#25911,"MARUNDA, CILINCING, JAKARTA UTARA, DKI JAKARTA",47,114,136,250
https://kawalpemilu.org#25911,"MARUNDA, CILINCING, JAKARTA UTARA, DKI JAKARTA",48,107,141,248
https://kawalpemilu.org#25911,"MARUNDA, CILINCING, JAKARTA UTARA, DKI JAKARTA",49,55,201,256
https://kawalpemilu.org#25911,"MARUNDA, CILINCING, JAKARTA UTARA, DKI JAKARTA",50,72,157,229
https://kawalpemilu.org#25911,"MARUNDA, CILINCING, JAKARTA UTARA, DKI JAKARTA",51,122,121,243
https://kawalpemilu.org#25911,"MARUNDA, CILINCING, JAKARTA UTARA, DKI JAKARTA",52,96,158,254
https://kawalpemilu.org#25911,"MARUNDA, CILINCING, JAKARTA UTARA, DKI JAKARTA",53,90,119,209
https://kawalpemilu.org#25911,"MARUNDA, CILINCING, JAKARTA UTARA, DKI JAKARTA",54,150,86,236
https://kawalpemilu.org#25911,"MARUNDA, CILINCING, JAKARTA UTARA, DKI JAKARTA",55,127,95,222
https://kawalpemilu.org#25911,"MARUNDA, CILINCING, JAKARTA UTARA, DKI JAKARTA",56,181,76,257
https://kawalpemilu.org#25911,"MARUNDA, CILINCING, JAKARTA UTARA, DKI JAKARTA",57,140,104,244
https://kawalpemilu.org#25911,"MARUNDA, CILINCING, JAKARTA UTARA, DKI JAKARTA",58,142,116,258
https://kawalpemilu.org#25911,"MARUNDA, CILINCING, JAKARTA UTARA, DKI JAKARTA",59,36,62,98
https://kawalpemilu.org#25911,"MARUNDA, CILINCING, JAKARTA UTARA, DKI JAKARTA",60,90,93,183
https://kawalpemilu.org#25911,"MARUNDA, CILINCING, JAKARTA UTARA, DKI JAKARTA",61,92,111,203
https://kawalpemilu.org#25911,"MARUNDA, CILINCING, JAKARTA UTARA, DKI JAKARTA",62,126,72,198
https://kawalpemilu.org#25911,"MARUNDA, CILINCING, JAKARTA UTARA, DKI JAKARTA",63,120,103,223
https://kawalpemilu.org#25911,"MARUNDA, CILINCING, JAKARTA UTARA, DKI JAKARTA",64,135,73,208
https://kawalpemilu.org#25911,"MARUNDA, CILINCING, JAKARTA UTARA, DKI JAKARTA",65,116,93,209
https://kawalpemilu.org#25911,"MARUNDA, CILINCING, JAKARTA UTARA, DKI JAKARTA",66,123,95,218
https://kawalpemilu.org#25911,"MARUNDA, CILINCING, JAKARTA UTARA, DKI JAKARTA",67,107,114,221
https://kawalpemilu.org#25911,"MARUNDA, CILINCING, JAKARTA UTARA, DKI JAKARTA",68,136,107,243
https://kawalpemilu.org#25911,"MARUNDA, CILINCING, JAKARTA UTARA, DKI JAKARTA",69,152,92,244
https://kawalpemilu.org#25911,"MARUNDA, CILINCING, JAKARTA UTARA, DKI JAKARTA",70,160,85,245
https://kawalpemilu.org#25911,"MARUNDA, CILINCING, JAKARTA UTARA, DKI JAKARTA",71,142,94,236
https://kawalpemilu.org#25911,"MARUNDA, CILINCING, JAKARTA UTARA, DKI JAKARTA",72,165,92,257
https://kawalpemilu.org#25911,"MARUNDA, CILINCING, JAKARTA UTARA, DKI JAKARTA",73,177,66,243
https://kawalpemilu.org#25911,"MARUNDA, CILINCING, JAKARTA UTARA, DKI JAKARTA",74,154,77,231
https://kawalpemilu.org#25911,"MARUNDA, CILINCING, JAKARTA UTARA, DKI JAKARTA",75,144,101,245
https://kawalpemilu.org#25911,"MARUNDA, CILINCING, JAKARTA UTARA, DKI JAKARTA",76,146,87,233
https://kawalpemilu.org#25911,"MARUNDA, CILINCING, JAKARTA UTARA, DKI JAKARTA",77,124,88,212
https://kawalpemilu.org#25911,"MARUNDA, CILINCING, JAKARTA UTARA, DKI JAKARTA",78,130,70,200
https://kawalpemilu.org#25911,"MARUNDA, CILINCING, JAKARTA UTARA, DKI JAKARTA",79,128,82,210
https://kawalpemilu.org#25911,"MARUNDA, CILINCING, JAKARTA UTARA, DKI JAKARTA",80,145,80,225
https://kawalpemilu.org#25911,"MARUNDA, CILINCING, JAKARTA UTARA, DKI JAKARTA",81,88,124,212
https://kawalpemilu.org#25911,"MARUNDA, CILINCING, JAKARTA UTARA, DKI JAKARTA",82,116,127,243
https://kawalpemilu.org#25912,"KALIBARU, CILINCING, JAKARTA UTARA, DKI JAKARTA",1,92,105,197
https://kawalpemilu.org#25912,"KALIBARU, CILINCING, JAKARTA UTARA, DKI JAKARTA",2,128,70,198
https://kawalpemilu.org#25912,"KALIBARU, CILINCING, JAKARTA UTARA, DKI JAKARTA",3,115,96,211
https://kawalpemilu.org#25912,"KALIBARU, CILINCING, JAKARTA UTARA, DKI JAKARTA",4,95,109,204
https://kawalpemilu.org#25912,"KALIBARU, CILINCING, JAKARTA UTARA, DKI JAKARTA",5,95,150,245
https://kawalpemilu.org#25912,"KALIBARU, CILINCING, JAKARTA UTARA, DKI JAKARTA",6,92,143,235
https://kawalpemilu.org#25912,"KALIBARU, CILINCING, JAKARTA UTARA, DKI JAKARTA",7,80,72,152
https://kawalpemilu.org#25912,"KALIBARU, CILINCING, JAKARTA UTARA, DKI JAKARTA",8,102,115,217
https://kawalpemilu.org#25912,"KALIBARU, CILINCING, JAKARTA UTARA, DKI JAKARTA",9,140,103,243
https://kawalpemilu.org#25912,"KALIBARU, CILINCING, JAKARTA UTARA, DKI JAKARTA",10,111,103,214
https://kawalpemilu.org#25912,"KALIBARU, CILINCING, JAKARTA UTARA, DKI JAKARTA",12,111,84,195
https://kawalpemilu.org#25912,"KALIBARU, CILINCING, JAKARTA UTARA, DKI JAKARTA",13,107,98,205
https://kawalpemilu.org#25912,"KALIBARU, CILINCING, JAKARTA UTARA, DKI JAKARTA",14,91,103,194
https://kawalpemilu.org#25912,"KALIBARU, CILINCING, JAKARTA UTARA, DKI JAKARTA",15,95,123,218
https://kawalpemilu.org#25912,"KALIBARU, CILINCING, JAKARTA UTARA, DKI JAKARTA",16,91,96,187
https://kawalpemilu.org#25912,"KALIBARU, CILINCING, JAKARTA UTARA, DKI JAKARTA",17,90,95,185
https://kawalpemilu.org#25912,"KALIBARU, CILINCING, JAKARTA UTARA, DKI JAKARTA",18,121,80,201
https://kawalpemilu.org#25912,"KALIBARU, CILINCING, JAKARTA UTARA, DKI JAKARTA",19,103,79,182
https://kawalpemilu.org#25912,"KALIBARU, CILINCING, JAKARTA UTARA, DKI JAKARTA",20,114,76,190
https://kawalpemilu.org#25912,"KALIBARU, CILINCING, JAKARTA UTARA, DKI JAKARTA",21,117,121,238
https://kawalpemilu.org#25912,"KALIBARU, CILINCING, JAKARTA UTARA, DKI JAKARTA",22,107,97,204
https://kawalpemilu.org#25912,"KALIBARU, CILINCING, JAKARTA UTARA, DKI JAKARTA",23,91,126,217
https://kawalpemilu.org#25912,"KALIBARU, CILINCING, JAKARTA UTARA, DKI JAKARTA",24,102,128,230
https://kawalpemilu.org#25912,"KALIBARU, CILINCING, JAKARTA UTARA, DKI JAKARTA",25,90,129,219
https://kawalpemilu.org#25912,"KALIBARU, CILINCING, JAKARTA UTARA, DKI JAKARTA",26,96,141,237
https://kawalpemilu.org#25912,"KALIBARU, CILINCING, JAKARTA UTARA, DKI JAKARTA",27,95,157,252
https://kawalpemilu.org#25912,"KALIBARU, CILINCING, JAKARTA UTARA, DKI JAKARTA",28,55,131,186
https://kawalpemilu.org#25912,"KALIBARU, CILINCING, JAKARTA UTARA, DKI JAKARTA",29,83,102,185
https://kawalpemilu.org#25912,"KALIBARU, CILINCING, JAKARTA UTARA, DKI JAKARTA",30,106,103,209
https://kawalpemilu.org#25912,"KALIBARU, CILINCING, JAKARTA UTARA, DKI JAKARTA",31,114,101,215
https://kawalpemilu.org#25912,"KALIBARU, CILINCING, JAKARTA UTARA, DKI JAKARTA",32,102,92,194
https://kawalpemilu.org#25912,"KALIBARU, CILINCING, JAKARTA UTARA, DKI JAKARTA",33,100,78,178
https://kawalpemilu.org#25912,"KALIBARU, CILINCING, JAKARTA UTARA, DKI JAKARTA",34,126,96,222
https://kawalpemilu.org#25912,"KALIBARU, CILINCING, JAKARTA UTARA, DKI JAKARTA",35,130,107,237
https://kawalpemilu.org#25912,"KALIBARU, CILINCING, JAKARTA UTARA, DKI JAKARTA",36,113,140,253
https://kawalpemilu.org#25912,"KALIBARU, CILINCING, JAKARTA UTARA, DKI JAKARTA",38,88,127,215
https://kawalpemilu.org#25912,"KALIBARU, CILINCING, JAKARTA UTARA, DKI JAKARTA",39,83,124,207
https://kawalpemilu.org#25912,"KALIBARU, CILINCING, JAKARTA UTARA, DKI JAKARTA",40,101,116,217
https://kawalpemilu.org#25912,"KALIBARU, CILINCING, JAKARTA UTARA, DKI JAKARTA",42,104,118,222
https://kawalpemilu.org#25912,"KALIBARU, CILINCING, JAKARTA UTARA, DKI JAKARTA",43,106,76,182
https://kawalpemilu.org#25912,"KALIBARU, CILINCING, JAKARTA UTARA, DKI JAKARTA",45,90,125,215
https://kawalpemilu.org#25912,"KALIBARU, CILINCING, JAKARTA UTARA, DKI JAKARTA",46,113,85,198
https://kawalpemilu.org#25912,"KALIBARU, CILINCING, JAKARTA UTARA, DKI JAKARTA",47,86,133,219
https://kawalpemilu.org#25912,"KALIBARU, CILINCING, JAKARTA UTARA, DKI JAKARTA",48,87,147,234
https://kawalpemilu.org#25912,"KALIBARU, CILINCING, JAKARTA UTARA, DKI JAKARTA",49,107,110,217
https://kawalpemilu.org#25912,"KALIBARU, CILINCING, JAKARTA UTARA, DKI JAKARTA",50,141,70,211
https://kawalpemilu.org#25912,"KALIBARU, CILINCING, JAKARTA UTARA, DKI JAKARTA",51,118,110,228
https://kawalpemilu.org#25912,"KALIBARU, CILINCING, JAKARTA UTARA, DKI JAKARTA",52,86,128,214
https://kawalpemilu.org#25912,"KALIBARU, CILINCING, JAKARTA UTARA, DKI JAKARTA",53,116,126,242
https://kawalpemilu.org#25912,"KALIBARU, CILINCING, JAKARTA UTARA, DKI JAKARTA",55,126,111,237
https://kawalpemilu.org#25912,"KALIBARU, CILINCING, JAKARTA UTARA, DKI JAKARTA",56,155,67,222
https://kawalpemilu.org#25912,"KALIBARU, CILINCING, JAKARTA UTARA, DKI JAKARTA",57,61,159,220
https://kawalpemilu.org#25912,"KALIBARU, CILINCING, JAKARTA UTARA, DKI JAKARTA",58,70,158,228
https://kawalpemilu.org#25912,"KALIBARU, CILINCING, JAKARTA UTARA, DKI JAKARTA",59,74,146,220
https://kawalpemilu.org#25912,"KALIBARU, CILINCING, JAKARTA UTARA, DKI JAKARTA",60,90,113,203
https://kawalpemilu.org#25912,"KALIBARU, CILINCING, JAKARTA UTARA, DKI JAKARTA",61,108,96,204
https://kawalpemilu.org#25912,"KALIBARU, CILINCING, JAKARTA UTARA, DKI JAKARTA",62,77,114,191
https://kawalpemilu.org#25912,"KALIBARU, CILINCING, JAKARTA UTARA, DKI JAKARTA",63,89,121,210
https://kawalpemilu.org#25912,"KALIBARU, CILINCING, JAKARTA UTARA, DKI JAKARTA",64,62,183,245
https://kawalpemilu.org#25912,"KALIBARU, CILINCING, JAKARTA UTARA, DKI JAKARTA",65,81,134,215
https://kawalpemilu.org#25912,"KALIBARU, CILINCING, JAKARTA UTARA, DKI JAKARTA",68,81,145,226
https://kawalpemilu.org#25912,"KALIBARU, CILINCING, JAKARTA UTARA, DKI JAKARTA",70,148,102,250
https://kawalpemilu.org#25912,"KALIBARU, CILINCING, JAKARTA UTARA, DKI JAKARTA",71,87,155,241
https://kawalpemilu.org#25912,"KALIBARU, CILINCING, JAKARTA UTARA, DKI JAKARTA",72,56,170,226
https://kawalpemilu.org#25912,"KALIBARU, CILINCING, JAKARTA UTARA, DKI JAKARTA",73,55,146,205
https://kawalpemilu.org#25912,"KALIBARU, CILINCING, JAKARTA UTARA, DKI JAKARTA",74,110,150,260
https://kawalpemilu.org#25912,"KALIBARU, CILINCING, JAKARTA UTARA, DKI JAKARTA",76,78,99,177
https://kawalpemilu.org#25912,"KALIBARU, CILINCING, JAKARTA UTARA, DKI JAKARTA",77,117,106,223
https://kawalpemilu.org#25912,"KALIBARU, CILINCING, JAKARTA UTARA, DKI JAKARTA",78,79,109,188
https://kawalpemilu.org#25912,"KALIBARU, CILINCING, JAKARTA UTARA, DKI JAKARTA",79,93,116,209
https://kawalpemilu.org#25912,"KALIBARU, CILINCING, JAKARTA UTARA, DKI JAKARTA",80,115,147,262
https://kawalpemilu.org#25912,"KALIBARU, CILINCING, JAKARTA UTARA, DKI JAKARTA",81,107,74,181
https://kawalpemilu.org#25912,"KALIBARU, CILINCING, JAKARTA UTARA, DKI JAKARTA",82,83,119,202
https://kawalpemilu.org#25912,"KALIBARU, CILINCING, JAKARTA UTARA, DKI JAKARTA",83,95,125,220
https://kawalpemilu.org#25912,"KALIBARU, CILINCING, JAKARTA UTARA, DKI JAKARTA",84,154,104,258
https://kawalpemilu.org#25912,"KALIBARU, CILINCING, JAKARTA UTARA, DKI JAKARTA",85,121,139,260
https://kawalpemilu.org#25912,"KALIBARU, CILINCING, JAKARTA UTARA, DKI JAKARTA",87,118,122,240
https://kawalpemilu.org#25912,"KALIBARU, CILINCING, JAKARTA UTARA, DKI JAKARTA",88,102,117,219
https://kawalpemilu.org#25912,"KALIBARU, CILINCING, JAKARTA UTARA, DKI JAKARTA",90,83,94,177
https://kawalpemilu.org#25912,"KALIBARU, CILINCING, JAKARTA UTARA, DKI JAKARTA",91,89,77,166
https://kawalpemilu.org#25912,"KALIBARU, CILINCING, JAKARTA UTARA, DKI JAKARTA",92,128,99,227
https://kawalpemilu.org#25912,"KALIBARU, CILINCING, JAKARTA UTARA, DKI JAKARTA",93,84,71,155
https://kawalpemilu.org#25912,"KALIBARU, CILINCING, JAKARTA UTARA, DKI JAKARTA",94,98,70,168
https://kawalpemilu.org#25912,"KALIBARU, CILINCING, JAKARTA UTARA, DKI JAKARTA",95,108,116,224
https://kawalpemilu.org#25912,"KALIBARU, CILINCING, JAKARTA UTARA, DKI JAKARTA",96,107,75,182
https://kawalpemilu.org#25912,"KALIBARU, CILINCING, JAKARTA UTARA, DKI JAKARTA",97,87,58,145
https://kawalpemilu.org#25912,"KALIBARU, CILINCING, JAKARTA UTARA, DKI JAKARTA",98,126,70,196
https://kawalpemilu.org#25912,"KALIBARU, CILINCING, JAKARTA UTARA, DKI JAKARTA",99,112,120,232
https://kawalpemilu.org#25912,"KALIBARU, CILINCING, JAKARTA UTARA, DKI JAKARTA",100,96,76,172
https://kawalpemilu.org#25912,"KALIBARU, CILINCING, JAKARTA UTARA, DKI JAKARTA",101,101,60,161
https://kawalpemilu.org#25912,"KALIBARU, CILINCING, JAKARTA UTARA, DKI JAKARTA",102,70,113,183
https://kawalpemilu.org#25912,"KALIBARU, CILINCING, JAKARTA UTARA, DKI JAKARTA",103,108,130,238
https://kawalpemilu.org#25912,"KALIBARU, CILINCING, JAKARTA UTARA, DKI JAKARTA",104,138,80,218
https://kawalpemilu.org#25912,"KALIBARU, CILINCING, JAKARTA UTARA, DKI JAKARTA",105,0,0,0
https://kawalpemilu.org#25912,"KALIBARU, CILINCING, JAKARTA UTARA, DKI JAKARTA",106,113,88,201
https://kawalpemilu.org#25912,"KALIBARU, CILINCING, JAKARTA UTARA, DKI JAKARTA",107,93,58,151
https://kawalpemilu.org#25912,"KALIBARU, CILINCING, JAKARTA UTARA, DKI JAKARTA",108,92,125,217
https://kawalpemilu.org#25912,"KALIBARU, CILINCING, JAKARTA UTARA, DKI JAKARTA",109,77,84,161
https://kawalpemilu.org#25912,"KALIBARU, CILINCING, JAKARTA UTARA, DKI JAKARTA",110,66,89,155
https://kawalpemilu.org#25912,"KALIBARU, CILINCING, JAKARTA UTARA, DKI JAKARTA",111,87,83,170
https://kawalpemilu.org#25912,"KALIBARU, CILINCING, JAKARTA UTARA, DKI JAKARTA",112,106,77,183
https://kawalpemilu.org#25912,"KALIBARU, CILINCING, JAKARTA UTARA, DKI JAKARTA",113,107,75,182
https://kawalpemilu.org#25912,"KALIBARU, CILINCING, JAKARTA UTARA, DKI JAKARTA",114,102,89,191
https://kawalpemilu.org#25912,"KALIBARU, CILINCING, JAKARTA UTARA, DKI JAKARTA",115,84,99,183
https://kawalpemilu.org#25912,"KALIBARU, CILINCING, JAKARTA UTARA, DKI JAKARTA",116,85,89,174
https://kawalpemilu.org#25912,"KALIBARU, CILINCING, JAKARTA UTARA, DKI JAKARTA",117,61,154,215
https://kawalpemilu.org#25912,"KALIBARU, CILINCING, JAKARTA UTARA, DKI JAKARTA",118,74,141,215
https://kawalpemilu.org#25912,"KALIBARU, CILINCING, JAKARTA UTARA, DKI JAKARTA",119,93,137,230
https://kawalpemilu.org#25912,"KALIBARU, CILINCING, JAKARTA UTARA, DKI JAKARTA",120,75,98,173
https://kawalpemilu.org#25912,"KALIBARU, CILINCING, JAKARTA UTARA, DKI JAKARTA",121,74,148,222
https://kawalpemilu.org#25912,"KALIBARU, CILINCING, JAKARTA UTARA, DKI JAKARTA",122,64,114,178
https://kawalpemilu.org#25912,"KALIBARU, CILINCING, JAKARTA UTARA, DKI JAKARTA",123,99,107,206
https://kawalpemilu.org#25912,"KALIBARU, CILINCING, JAKARTA UTARA, DKI JAKARTA",124,73,87,160
https://kawalpemilu.org#25912,"KALIBARU, CILINCING, JAKARTA UTARA, DKI JAKARTA",125,90,134,224
https://kawalpemilu.org#25912,"KALIBARU, CILINCING, JAKARTA UTARA, DKI JAKARTA",126,115,114,229
https://kawalpemilu.org#25912,"KALIBARU, CILINCING, JAKARTA UTARA, DKI JAKARTA",127,111,97,208
https://kawalpemilu.org#25912,"KALIBARU, CILINCING, JAKARTA UTARA, DKI JAKARTA",128,73,91,164
https://kawalpemilu.org#25912,"KALIBARU, CILINCING, JAKARTA UTARA, DKI JAKARTA",129,90,74,164
https://kawalpemilu.org#25912,"KALIBARU, CILINCING, JAKARTA UTARA, DKI JAKARTA",130,92,84,176
https://kawalpemilu.org#25912,"KALIBARU, CILINCING, JAKARTA UTARA, DKI JAKARTA",131,88,101,189
https://kawalpemilu.org#25912,"KALIBARU, CILINCING, JAKARTA UTARA, DKI JAKARTA",132,140,88,228
https://kawalpemilu.org#25912,"KALIBARU, CILINCING, JAKARTA UTARA, DKI JAKARTA",133,110,99,209
https://kawalpemilu.org#25912,"KALIBARU, CILINCING, JAKARTA UTARA, DKI JAKARTA",134,160,103,263
https://kawalpemilu.org#25912,"KALIBARU, CILINCING, JAKARTA UTARA, DKI JAKARTA",135,118,114,232
https://kawalpemilu.org#25912,"KALIBARU, CILINCING, JAKARTA UTARA, DKI JAKARTA",136,104,102,206
https://kawalpemilu.org#25912,"KALIBARU, CILINCING, JAKARTA UTARA, DKI JAKARTA",137,81,113,194
https://kawalpemilu.org#25912,"KALIBARU, CILINCING, JAKARTA UTARA, DKI JAKARTA",138,93,128,221
https://kawalpemilu.org#25912,"KALIBARU, CILINCING, JAKARTA UTARA, DKI JAKARTA",139,111,97,208
https://kawalpemilu.org#25912,"KALIBARU, CILINCING, JAKARTA UTARA, DKI JAKARTA",140,111,82,193
https://kawalpemilu.org#25912,"KALIBARU, CILINCING, JAKARTA UTARA, DKI JAKARTA",141,113,90,203
https://kawalpemilu.org#25912,"KALIBARU, CILINCING, JAKARTA UTARA, DKI JAKARTA",142,91,80,171
https://kawalpemilu.org#25912,"KALIBARU, CILINCING, JAKARTA UTARA, DKI JAKARTA",143,84,98,182
https://kawalpemilu.org#25912,"KALIBARU, CILINCING, JAKARTA UTARA, DKI JAKARTA",144,136,111,247
https://kawalpemilu.org#25912,"KALIBARU, CILINCING, JAKARTA UTARA, DKI JAKARTA",145,113,118,231
https://kawalpemilu.org#25912,"KALIBARU, CILINCING, JAKARTA UTARA, DKI JAKARTA",146,101,129,230
https://kawalpemilu.org#25912,"KALIBARU, CILINCING, JAKARTA UTARA, DKI JAKARTA",147,141,94,235
https://kawalpemilu.org#25912,"KALIBARU, CILINCING, JAKARTA UTARA, DKI JAKARTA",148,40,62,102
https://kawalpemilu.org#25912,"KALIBARU, CILINCING, JAKARTA UTARA, DKI JAKARTA",149,142,106,248
https://kawalpemilu.org#25912,"KALIBARU, CILINCING, JAKARTA UTARA, DKI JAKARTA",150,109,115,224
https://kawalpemilu.org#25912,"KALIBARU, CILINCING, JAKARTA UTARA, DKI JAKARTA",151,80,119,199
https://kawalpemilu.org#25912,"KALIBARU, CILINCING, JAKARTA UTARA, DKI JAKARTA",152,110,49,159
https://kawalpemilu.org#25912,"KALIBARU, CILINCING, JAKARTA UTARA, DKI JAKARTA",153,98,59,157
https://kawalpemilu.org#25912,"KALIBARU, CILINCING, JAKARTA UTARA, DKI JAKARTA",154,81,115,196
https://kawalpemilu.org#25912,"KALIBARU, CILINCING, JAKARTA UTARA, DKI JAKARTA",155,71,103,174
https://kawalpemilu.org#25912,"KALIBARU, CILINCING, JAKARTA UTARA, DKI JAKARTA",156,77,133,210
https://kawalpemilu.org#25912,"KALIBARU, CILINCING, JAKARTA UTARA, DKI JAKARTA",157,99,95,194
https://kawalpemilu.org#25912,"KALIBARU, CILINCING, JAKARTA UTARA, DKI JAKARTA",158,90,98,188
https://kawalpemilu.org#25912,"KALIBARU, CILINCING, JAKARTA UTARA, DKI JAKARTA",159,54,44,98
https://kawalpemilu.org#25912,"KALIBARU, CILINCING, JAKARTA UTARA, DKI JAKARTA",160,56,179,235
https://kawalpemilu.org#25912,"KALIBARU, CILINCING, JAKARTA UTARA, DKI JAKARTA",161,96,122,218
https://kawalpemilu.org#25912,"KALIBARU, CILINCING, JAKARTA UTARA, DKI JAKARTA",162,84,127,211
https://kawalpemilu.org#25912,"KALIBARU, CILINCING, JAKARTA UTARA, DKI JAKARTA",163,85,142,227
https://kawalpemilu.org#25912,"KALIBARU, CILINCING, JAKARTA UTARA, DKI JAKARTA",164,96,112,208
https://kawalpemilu.org#25912,"KALIBARU, CILINCING, JAKARTA UTARA, DKI JAKARTA",165,91,144,235
https://kawalpemilu.org#25912,"KALIBARU, CILINCING, JAKARTA UTARA, DKI JAKARTA",166,86,124,210
https://kawalpemilu.org#25912,"KALIBARU, CILINCING, JAKARTA UTARA, DKI JAKARTA",167,85,140,225
https://kawalpemilu.org#25912,"KALIBARU, CILINCING, JAKARTA UTARA, DKI JAKARTA",168,110,120,230
https://kawalpemilu.org#25912,"KALIBARU, CILINCING, JAKARTA UTARA, DKI JAKARTA",169,82,153,235
https://kawalpemilu.org#25912,"KALIBARU, CILINCING, JAKARTA UTARA, DKI JAKARTA",170,103,112,215
https://kawalpemilu.org#25912,"KALIBARU, CILINCING, JAKARTA UTARA, DKI JAKARTA",171,82,83,165
https://kawalpemilu.org#25912,"KALIBARU, CILINCING, JAKARTA UTARA, DKI JAKARTA",172,77,87,164
https://kawalpemilu.org#25912,"KALIBARU, CILINCING, JAKARTA UTARA, DKI JAKARTA",173,111,95,206
https://kawalpemilu.org#25912,"KALIBARU, CILINCING, JAKARTA UTARA, DKI JAKARTA",174,93,101,194
https://kawalpemilu.org#25912,"KALIBARU, CILINCING, JAKARTA UTARA, DKI JAKARTA",175,115,120,235
https://kawalpemilu.org#25912,"KALIBARU, CILINCING, JAKARTA UTARA, DKI JAKARTA",176,104,119,223
https://kawalpemilu.org#25912,"KALIBARU, CILINCING, JAKARTA UTARA, DKI JAKARTA",177,104,118,222
https://kawalpemilu.org#25912,"KALIBARU, CILINCING, JAKARTA UTARA, DKI JAKARTA",178,99,116,215
https://kawalpemilu.org#25912,"KALIBARU, CILINCING, JAKARTA UTARA, DKI JAKARTA",179,117,83,200
https://kawalpemilu.org#25912,"KALIBARU, CILINCING, JAKARTA UTARA, DKI JAKARTA",180,96,90,186
https://kawalpemilu.org#25912,"KALIBARU, CILINCING, JAKARTA UTARA, DKI JAKARTA",181,90,125,215
https://kawalpemilu.org#25912,"KALIBARU, CILINCING, JAKARTA UTARA, DKI JAKARTA",182,87,131,218
https://kawalpemilu.org#25912,"KALIBARU, CILINCING, JAKARTA UTARA, DKI JAKARTA",183,99,134,233
https://kawalpemilu.org#25912,"KALIBARU, CILINCING, JAKARTA UTARA, DKI JAKARTA",184,93,128,221
https://kawalpemilu.org#25912,"KALIBARU, CILINCING, JAKARTA UTARA, DKI JAKARTA",185,81,96,177
https://kawalpemilu.org#25912,"KALIBARU, CILINCING, JAKARTA UTARA, DKI JAKARTA",186,65,120,185
https://kawalpemilu.org#25912,"KALIBARU, CILINCING, JAKARTA UTARA, DKI JAKARTA",187,112,147,259
https://kawalpemilu.org#25912,"KALIBARU, CILINCING, JAKARTA UTARA, DKI JAKARTA",188,78,145,223
https://kawalpemilu.org#25912,"KALIBARU, CILINCING, JAKARTA UTARA, DKI JAKARTA",189,72,155,227
https://kawalpemilu.org#25912,"KALIBARU, CILINCING, JAKARTA UTARA, DKI JAKARTA",190,112,124,236
https://kawalpemilu.org#25912,"KALIBARU, CILINCING, JAKARTA UTARA, DKI JAKARTA",191,98,146,244
https://kawalpemilu.org#25912,"KALIBARU, CILINCING, JAKARTA UTARA, DKI JAKARTA",192,84,115,199
https://kawalpemilu.org#25912,"KALIBARU, CILINCING, JAKARTA UTARA, DKI JAKARTA",193,111,104,215
https://kawalpemilu.org#25912,"KALIBARU, CILINCING, JAKARTA UTARA, DKI JAKARTA",194,79,137,216
https://kawalpemilu.org#25912,"KALIBARU, CILINCING, JAKARTA UTARA, DKI JAKARTA",195,43,158,201
https://kawalpemilu.org#25912,"KALIBARU, CILINCING, JAKARTA UTARA, DKI JAKARTA",196,69,141,210
https://kawalpemilu.org#25912,"KALIBARU, CILINCING, JAKARTA UTARA, DKI JAKARTA",197,80,120,200
https://kawalpemilu.org#25912,"KALIBARU, CILINCING, JAKARTA UTARA, DKI JAKARTA",198,66,168,234
https://kawalpemilu.org#25912,"KALIBARU, CILINCING, JAKARTA UTARA, DKI JAKARTA",199,67,132,199
https://kawalpemilu.org#25912,"KALIBARU, CILINCING, JAKARTA UTARA, DKI JAKARTA",200,95,94,189
https://kawalpemilu.org#25912,"KALIBARU, CILINCING, JAKARTA UTARA, DKI JAKARTA",201,105,102,207
https://kawalpemilu.org#25912,"KALIBARU, CILINCING, JAKARTA UTARA, DKI JAKARTA",202,57,76,133
https://kawalpemilu.org#25912,"KALIBARU, CILINCING, JAKARTA UTARA, DKI JAKARTA",203,69,69,138
https://kawalpemilu.org#25912,"KALIBARU, CILINCING, JAKARTA UTARA, DKI JAKARTA",204,71,78,149
https://kawalpemilu.org#25912,"KALIBARU, CILINCING, JAKARTA UTARA, DKI JAKARTA",205,72,92,164
https://kawalpemilu.org#25912,"KALIBARU, CILINCING, JAKARTA UTARA, DKI JAKARTA",206,84,73,157
https://kawalpemilu.org#25912,"KALIBARU, CILINCING, JAKARTA UTARA, DKI JAKARTA",207,134,81,215
https://kawalpemilu.org#25912,"KALIBARU, CILINCING, JAKARTA UTARA, DKI JAKARTA",208,68,50,118
https://kawalpemilu.org#25912,"KALIBARU, CILINCING, JAKARTA UTARA, DKI JAKARTA",209,96,70,166
https://kawalpemilu.org#25912,"KALIBARU, CILINCING, JAKARTA UTARA, DKI JAKARTA",210,80,58,138
https://kawalpemilu.org#25912,"KALIBARU, CILINCING, JAKARTA UTARA, DKI JAKARTA",211,90,65,155
https://kawalpemilu.org#25912,"KALIBARU, CILINCING, JAKARTA UTARA, DKI JAKARTA",212,40,43,83
https://kawalpemilu.org#25912,"KALIBARU, CILINCING, JAKARTA UTARA, DKI JAKARTA",213,70,43,113
https://kawalpemilu.org#25912,"KALIBARU, CILINCING, JAKARTA UTARA, DKI JAKARTA",214,54,70,124
https://kawalpemilu.org#25912,"KALIBARU, CILINCING, JAKARTA UTARA, DKI JAKARTA",215,47,32,79
https://kawalpemilu.org#25912,"KALIBARU, CILINCING, JAKARTA UTARA, DKI JAKARTA",216,72,56,128
https://kawalpemilu.org#25912,"KALIBARU, CILINCING, JAKARTA UTARA, DKI JAKARTA",217,54,85,139
https://kawalpemilu.org#25913,"SEMPER TIMUR, CILINCING, JAKARTA UTARA, DKI JAKARTA",1,152,87,239
https://kawalpemilu.org#25913,"SEMPER TIMUR, CILINCING, JAKARTA UTARA, DKI JAKARTA",2,146,100,246
https://kawalpemilu.org#25913,"SEMPER TIMUR, CILINCING, JAKARTA UTARA, DKI JAKARTA",3,131,113,244
https://kawalpemilu.org#25913,"SEMPER TIMUR, CILINCING, JAKARTA UTARA, DKI JAKARTA",4,130,113,243
https://kawalpemilu.org#25913,"SEMPER TIMUR, CILINCING, JAKARTA UTARA, DKI JAKARTA",5,140,88,228
https://kawalpemilu.org#25913,"SEMPER TIMUR, CILINCING, JAKARTA UTARA, DKI JAKARTA",6,100,125,225
https://kawalpemilu.org#25913,"SEMPER TIMUR, CILINCING, JAKARTA UTARA, DKI JAKARTA",7,125,101,226
https://kawalpemilu.org#25913,"SEMPER TIMUR, CILINCING, JAKARTA UTARA, DKI JAKARTA",8,146,70,216
https://kawalpemilu.org#25913,"SEMPER TIMUR, CILINCING, JAKARTA UTARA, DKI JAKARTA",9,132,90,222
https://kawalpemilu.org#25913,"SEMPER TIMUR, CILINCING, JAKARTA UTARA, DKI JAKARTA",10,131,106,237
https://kawalpemilu.org#25913,"SEMPER TIMUR, CILINCING, JAKARTA UTARA, DKI JAKARTA",11,117,141,258
https://kawalpemilu.org#25913,"SEMPER TIMUR, CILINCING, JAKARTA UTARA, DKI JAKARTA",12,99,100,199
https://kawalpemilu.org#25913,"SEMPER TIMUR, CILINCING, JAKARTA UTARA, DKI JAKARTA",13,100,130,230
https://kawalpemilu.org#25913,"SEMPER TIMUR, CILINCING, JAKARTA UTARA, DKI JAKARTA",14,100,148,248
https://kawalpemilu.org#25913,"SEMPER TIMUR, CILINCING, JAKARTA UTARA, DKI JAKARTA",15,100,104,204
https://kawalpemilu.org#25913,"SEMPER TIMUR, CILINCING, JAKARTA UTARA, DKI JAKARTA",16,110,95,205
https://kawalpemilu.org#25913,"SEMPER TIMUR, CILINCING, JAKARTA UTARA, DKI JAKARTA",17,99,135,234
https://kawalpemilu.org#25913,"SEMPER TIMUR, CILINCING, JAKARTA UTARA, DKI JAKARTA",18,99,134,233
https://kawalpemilu.org#25913,"SEMPER TIMUR, CILINCING, JAKARTA UTARA, DKI JAKARTA",19,107,55,162
https://kawalpemilu.org#25913,"SEMPER TIMUR, CILINCING, JAKARTA UTARA, DKI JAKARTA",20,74,38,112
https://kawalpemilu.org#25913,"SEMPER TIMUR, CILINCING, JAKARTA UTARA, DKI JAKARTA",21,145,101,246
https://kawalpemilu.org#25913,"SEMPER TIMUR, CILINCING, JAKARTA UTARA, DKI JAKARTA",22,129,71,200
https://kawalpemilu.org#25913,"SEMPER TIMUR, CILINCING, JAKARTA UTARA, DKI JAKARTA",23,126,138,264
https://kawalpemilu.org#25913,"SEMPER TIMUR, CILINCING, JAKARTA UTARA, DKI JAKARTA",24,100,139,239
https://kawalpemilu.org#25913,"SEMPER TIMUR, CILINCING, JAKARTA UTARA, DKI JAKARTA",25,142,91,233
https://kawalpemilu.org#25913,"SEMPER TIMUR, CILINCING, JAKARTA UTARA, DKI JAKARTA",26,92,135,227
https://kawalpemilu.org#25913,"SEMPER TIMUR, CILINCING, JAKARTA UTARA, DKI JAKARTA",27,88,121,209
https://kawalpemilu.org#25913,"SEMPER TIMUR, CILINCING, JAKARTA UTARA, DKI JAKARTA",28,85,168,253
https://kawalpemilu.org#25913,"SEMPER TIMUR, CILINCING, JAKARTA UTARA, DKI JAKARTA",29,86,153,239
https://kawalpemilu.org#25913,"SEMPER TIMUR, CILINCING, JAKARTA UTARA, DKI JAKARTA",30,93,147,240
https://kawalpemilu.org#25913,"SEMPER TIMUR, CILINCING, JAKARTA UTARA, DKI JAKARTA",31,103,136,239
https://kawalpemilu.org#25913,"SEMPER TIMUR, CILINCING, JAKARTA UTARA, DKI JAKARTA",32,107,128,235
https://kawalpemilu.org#25913,"SEMPER TIMUR, CILINCING, JAKARTA UTARA, DKI JAKARTA",33,84,144,228
https://kawalpemilu.org#25913,"SEMPER TIMUR, CILINCING, JAKARTA UTARA, DKI JAKARTA",34,116,138,254
https://kawalpemilu.org#25913,"SEMPER TIMUR, CILINCING, JAKARTA UTARA, DKI JAKARTA",35,99,125,224
https://kawalpemilu.org#25913,"SEMPER TIMUR, CILINCING, JAKARTA UTARA, DKI JAKARTA",36,90,128,218
https://kawalpemilu.org#25913,"SEMPER TIMUR, CILINCING, JAKARTA UTARA, DKI JAKARTA",37,122,76,198
https://kawalpemilu.org#25913,"SEMPER TIMUR, CILINCING, JAKARTA UTARA, DKI JAKARTA",38,85,119,204
https://kawalpemilu.org#25913,"SEMPER TIMUR, CILINCING, JAKARTA UTARA, DKI JAKARTA",39,117,128,245
https://kawalpemilu.org#25913,"SEMPER TIMUR, CILINCING, JAKARTA UTARA, DKI JAKARTA",40,69,104,173
https://kawalpemilu.org#25913,"SEMPER TIMUR, CILINCING, JAKARTA UTARA, DKI JAKARTA",41,89,93,182
https://kawalpemilu.org#25913,"SEMPER TIMUR, CILINCING, JAKARTA UTARA, DKI JAKARTA",42,126,110,236
https://kawalpemilu.org#25913,"SEMPER TIMUR, CILINCING, JAKARTA UTARA, DKI JAKARTA",43,98,152,250
https://kawalpemilu.org#25913,"SEMPER TIMUR, CILINCING, JAKARTA UTARA, DKI JAKARTA",44,82,150,232
https://kawalpemilu.org#25913,"SEMPER TIMUR, CILINCING, JAKARTA UTARA, DKI JAKARTA",45,99,117,216
https://kawalpemilu.org#25913,"SEMPER TIMUR, CILINCING, JAKARTA UTARA, DKI JAKARTA",46,101,148,249
https://kawalpemilu.org#25913,"SEMPER TIMUR, CILINCING, JAKARTA UTARA, DKI JAKARTA",47,96,141,237
https://kawalpemilu.org#25913,"SEMPER TIMUR, CILINCING, JAKARTA UTARA, DKI JAKARTA",48,75,93,168
https://kawalpemilu.org#25913,"SEMPER TIMUR, CILINCING, JAKARTA UTARA, DKI JAKARTA",49,92,123,215
https://kawalpemilu.org#25913,"SEMPER TIMUR, CILINCING, JAKARTA UTARA, DKI JAKARTA",50,106,109,215
https://kawalpemilu.org#25913,"SEMPER TIMUR, CILINCING, JAKARTA UTARA, DKI JAKARTA",51,143,84,227
https://kawalpemilu.org#25913,"SEMPER TIMUR, CILINCING, JAKARTA UTARA, DKI JAKARTA",52,136,104,240
https://kawalpemilu.org#25913,"SEMPER TIMUR, CILINCING, JAKARTA UTARA, DKI JAKARTA",53,101,103,204
https://kawalpemilu.org#25913,"SEMPER TIMUR, CILINCING, JAKARTA UTARA, DKI JAKARTA",54,97,112,209
https://kawalpemilu.org#25913,"SEMPER TIMUR, CILINCING, JAKARTA UTARA, DKI JAKARTA",55,114,129,243
https://kawalpemilu.org#25913,"SEMPER TIMUR, CILINCING, JAKARTA UTARA, DKI JAKARTA",56,102,145,247
https://kawalpemilu.org#25913,"SEMPER TIMUR, CILINCING, JAKARTA UTARA, DKI JAKARTA",57,124,95,219
https://kawalpemilu.org#25913,"SEMPER TIMUR, CILINCING, JAKARTA UTARA, DKI JAKARTA",58,106,76,182
https://kawalpemilu.org#25913,"SEMPER TIMUR, CILINCING, JAKARTA UTARA, DKI JAKARTA",59,107,131,238
https://kawalpemilu.org#25913,"SEMPER TIMUR, CILINCING, JAKARTA UTARA, DKI JAKARTA",60,132,130,262
https://kawalpemilu.org#25913,"SEMPER TIMUR, CILINCING, JAKARTA UTARA, DKI JAKARTA",61,127,111,238
https://kawalpemilu.org#25913,"SEMPER TIMUR, CILINCING, JAKARTA UTARA, DKI JAKARTA",62,142,109,251
https://kawalpemilu.org#25913,"SEMPER TIMUR, CILINCING, JAKARTA UTARA, DKI JAKARTA",63,136,120,256
https://kawalpemilu.org#25913,"SEMPER TIMUR, CILINCING, JAKARTA UTARA, DKI JAKARTA",64,113,126,239
https://kawalpemilu.org#25913,"SEMPER TIMUR, CILINCING, JAKARTA UTARA, DKI JAKARTA",65,97,154,251
https://kawalpemilu.org#25913,"SEMPER TIMUR, CILINCING, JAKARTA UTARA, DKI JAKARTA",66,102,135,237
https://kawalpemilu.org#25913,"SEMPER TIMUR, CILINCING, JAKARTA UTARA, DKI JAKARTA",67,104,98,202
https://kawalpemilu.org#25913,"SEMPER TIMUR, CILINCING, JAKARTA UTARA, DKI JAKARTA",68,113,100,213
https://kawalpemilu.org#25913,"SEMPER TIMUR, CILINCING, JAKARTA UTARA, DKI JAKARTA",69,84,114,198
https://kawalpemilu.org#25913,"SEMPER TIMUR, CILINCING, JAKARTA UTARA, DKI JAKARTA",70,76,84,160
https://kawalpemilu.org#25913,"SEMPER TIMUR, CILINCING, JAKARTA UTARA, DKI JAKARTA",71,90,84,174
https://kawalpemilu.org#25913,"SEMPER TIMUR, CILINCING, JAKARTA UTARA, DKI JAKARTA",72,120,74,194
https://kawalpemilu.org#25913,"SEMPER TIMUR, CILINCING, JAKARTA UTARA, DKI JAKARTA",73,97,71,168
https://kawalpemilu.org#25913,"SEMPER TIMUR, CILINCING, JAKARTA UTARA, DKI JAKARTA",74,115,89,204
https://kawalpemilu.org#25913,"SEMPER TIMUR, CILINCING, JAKARTA UTARA, DKI JAKARTA",75,115,77,192
https://kawalpemilu.org#25913,"SEMPER TIMUR, CILINCING, JAKARTA UTARA, DKI JAKARTA",76,113,67,180
https://kawalpemilu.org#25913,"SEMPER TIMUR, CILINCING, JAKARTA UTARA, DKI JAKARTA",77,142,58,200
https://kawalpemilu.org#25913,"SEMPER TIMUR, CILINCING, JAKARTA UTARA, DKI JAKARTA",78,122,71,193
https://kawalpemilu.org#25913,"SEMPER TIMUR, CILINCING, JAKARTA UTARA, DKI JAKARTA",79,117,59,176
https://kawalpemilu.org#25913,"SEMPER TIMUR, CILINCING, JAKARTA UTARA, DKI JAKARTA",80,139,82,221
https://kawalpemilu.org#25913,"SEMPER TIMUR, CILINCING, JAKARTA UTARA, DKI JAKARTA",81,128,126,254
https://kawalpemilu.org#25913,"SEMPER TIMUR, CILINCING, JAKARTA UTARA, DKI JAKARTA",82,121,123,244
https://kawalpemilu.org#25913,"SEMPER TIMUR, CILINCING, JAKARTA UTARA, DKI JAKARTA",83,98,141,239
https://kawalpemilu.org#25913,"SEMPER TIMUR, CILINCING, JAKARTA UTARA, DKI JAKARTA",84,128,39,167
https://kawalpemilu.org#25913,"SEMPER TIMUR, CILINCING, JAKARTA UTARA, DKI JAKARTA",85,128,45,173
https://kawalpemilu.org#25913,"SEMPER TIMUR, CILINCING, JAKARTA UTARA, DKI JAKARTA",86,90,97,187
https://kawalpemilu.org#25913,"SEMPER TIMUR, CILINCING, JAKARTA UTARA, DKI JAKARTA",87,71,152,223
https://kawalpemilu.org#25913,"SEMPER TIMUR, CILINCING, JAKARTA UTARA, DKI JAKARTA",88,70,144,214
https://kawalpemilu.org#25913,"SEMPER TIMUR, CILINCING, JAKARTA UTARA, DKI JAKARTA",89,62,212,274
https://kawalpemilu.org#25913,"SEMPER TIMUR, CILINCING, JAKARTA UTARA, DKI JAKARTA",90,118,125,243
https://kawalpemilu.org#25913,"SEMPER TIMUR, CILINCING, JAKARTA UTARA, DKI JAKARTA",91,113,114,227
https://kawalpemilu.org#25913,"SEMPER TIMUR, CILINCING, JAKARTA UTARA, DKI JAKARTA",92,125,119,244
https://kawalpemilu.org#25913,"SEMPER TIMUR, CILINCING, JAKARTA UTARA, DKI JAKARTA",93,151,79,230
https://kawalpemilu.org#25913,"SEMPER TIMUR, CILINCING, JAKARTA UTARA, DKI JAKARTA",94,114,58,172
https://kawalpemilu.org#25913,"SEMPER TIMUR, CILINCING, JAKARTA UTARA, DKI JAKARTA",95,100,55,155
https://kawalpemilu.org#25913,"SEMPER TIMUR, CILINCING, JAKARTA UTARA, DKI JAKARTA",96,132,102,234
https://kawalpemilu.org#25913,"SEMPER TIMUR, CILINCING, JAKARTA UTARA, DKI JAKARTA",97,157,87,244
https://kawalpemilu.org#25913,"SEMPER TIMUR, CILINCING, JAKARTA UTARA, DKI JAKARTA",98,166,72,238
https://kawalpemilu.org#25913,"SEMPER TIMUR, CILINCING, JAKARTA UTARA, DKI JAKARTA",99,134,58,192
https://kawalpemilu.org#25913,"SEMPER TIMUR, CILINCING, JAKARTA UTARA, DKI JAKARTA",100,148,57,205
https://kawalpemilu.org#25913,"SEMPER TIMUR, CILINCING, JAKARTA UTARA, DKI JAKARTA",101,149,64,213
https://kawalpemilu.org#25913,"SEMPER TIMUR, CILINCING, JAKARTA UTARA, DKI JAKARTA",102,134,42,176
https://kawalpemilu.org#25913,"SEMPER TIMUR, CILINCING, JAKARTA UTARA, DKI JAKARTA",103,173,94,267
https://kawalpemilu.org#25913,"SEMPER TIMUR, CILINCING, JAKARTA UTARA, DKI JAKARTA",104,0,0,0
https://kawalpemilu.org#25913,"SEMPER TIMUR, CILINCING, JAKARTA UTARA, DKI JAKARTA",105,196,47,243
https://kawalpemilu.org#25913,"SEMPER TIMUR, CILINCING, JAKARTA UTARA, DKI JAKARTA",106,134,84,218
https://kawalpemilu.org#25913,"SEMPER TIMUR, CILINCING, JAKARTA UTARA, DKI JAKARTA",107,166,106,272
https://kawalpemilu.org#25913,"SEMPER TIMUR, CILINCING, JAKARTA UTARA, DKI JAKARTA",108,149,57,206
https://kawalpemilu.org#25913,"SEMPER TIMUR, CILINCING, JAKARTA UTARA, DKI JAKARTA",109,141,60,201
https://kawalpemilu.org#25913,"SEMPER TIMUR, CILINCING, JAKARTA UTARA, DKI JAKARTA",110,158,53,211
https://kawalpemilu.org#25914,"ROROTAN, CILINCING, JAKARTA UTARA, DKI JAKARTA",1,118,117,235
https://kawalpemilu.org#25914,"ROROTAN, CILINCING, JAKARTA UTARA, DKI JAKARTA",2,109,128,237
https://kawalpemilu.org#25914,"ROROTAN, CILINCING, JAKARTA UTARA, DKI JAKARTA",3,123,128,251
https://kawalpemilu.org#25914,"ROROTAN, CILINCING, JAKARTA UTARA, DKI JAKARTA",4,109,122,231
https://kawalpemilu.org#25914,"ROROTAN, CILINCING, JAKARTA UTARA, DKI JAKARTA",5,141,108,249
https://kawalpemilu.org#25914,"ROROTAN, CILINCING, JAKARTA UTARA, DKI JAKARTA",6,124,122,246
https://kawalpemilu.org#25914,"ROROTAN, CILINCING, JAKARTA UTARA, DKI JAKARTA",7,137,111,248
https://kawalpemilu.org#25914,"ROROTAN, CILINCING, JAKARTA UTARA, DKI JAKARTA",8,109,139,248
https://kawalpemilu.org#25914,"ROROTAN, CILINCING, JAKARTA UTARA, DKI JAKARTA",9,129,89,218
https://kawalpemilu.org#25914,"ROROTAN, CILINCING, JAKARTA UTARA, DKI JAKARTA",10,153,90,243
https://kawalpemilu.org#25914,"ROROTAN, CILINCING, JAKARTA UTARA, DKI JAKARTA",11,114,106,220
https://kawalpemilu.org#25914,"ROROTAN, CILINCING, JAKARTA UTARA, DKI JAKARTA",12,55,197,252
https://kawalpemilu.org#25914,"ROROTAN, CILINCING, JAKARTA UTARA, DKI JAKARTA",13,55,212,267
https://kawalpemilu.org#25914,"ROROTAN, CILINCING, JAKARTA UTARA, DKI JAKARTA",14,72,156,228
https://kawalpemilu.org#25914,"ROROTAN, CILINCING, JAKARTA UTARA, DKI JAKARTA",15,92,180,272
https://kawalpemilu.org#25914,"ROROTAN, CILINCING, JAKARTA UTARA, DKI JAKARTA",16,94,164,258
https://kawalpemilu.org#25914,"ROROTAN, CILINCING, JAKARTA UTARA, DKI JAKARTA",17,72,186,258
https://kawalpemilu.org#25914,"ROROTAN, CILINCING, JAKARTA UTARA, DKI JAKARTA",18,79,172,251
https://kawalpemilu.org#25914,"ROROTAN, CILINCING, JAKARTA UTARA, DKI JAKARTA",19,97,183,280
https://kawalpemilu.org#25914,"ROROTAN, CILINCING, JAKARTA UTARA, DKI JAKARTA",20,28,226,254
https://kawalpemilu.org#25914,"ROROTAN, CILINCING, JAKARTA UTARA, DKI JAKARTA",21,69,154,223
https://kawalpemilu.org#25914,"ROROTAN, CILINCING, JAKARTA UTARA, DKI JAKARTA",22,76,149,225
https://kawalpemilu.org#25914,"ROROTAN, CILINCING, JAKARTA UTARA, DKI JAKARTA",23,73,123,196
https://kawalpemilu.org#25914,"ROROTAN, CILINCING, JAKARTA UTARA, DKI JAKARTA",24,99,122,221
https://kawalpemilu.org#25914,"ROROTAN, CILINCING, JAKARTA UTARA, DKI JAKARTA",25,89,114,203
https://kawalpemilu.org#25914,"ROROTAN, CILINCING, JAKARTA UTARA, DKI JAKARTA",26,87,149,236
https://kawalpemilu.org#25914,"ROROTAN, CILINCING, JAKARTA UTARA, DKI JAKARTA",27,69,159,228
https://kawalpemilu.org#25914,"ROROTAN, CILINCING, JAKARTA UTARA, DKI JAKARTA",28,99,102,201
https://kawalpemilu.org#25914,"ROROTAN, CILINCING, JAKARTA UTARA, DKI JAKARTA",29,163,84,247
https://kawalpemilu.org#25914,"ROROTAN, CILINCING, JAKARTA UTARA, DKI JAKARTA",30,106,169,275
https://kawalpemilu.org#25914,"ROROTAN, CILINCING, JAKARTA UTARA, DKI JAKARTA",31,68,153,221
https://kawalpemilu.org#25914,"ROROTAN, CILINCING, JAKARTA UTARA, DKI JAKARTA",32,127,117,244
https://kawalpemilu.org#25914,"ROROTAN, CILINCING, JAKARTA UTARA, DKI JAKARTA",33,84,153,237
https://kawalpemilu.org#25914,"ROROTAN, CILINCING, JAKARTA UTARA, DKI JAKARTA",34,96,173,269
https://kawalpemilu.org#25914,"ROROTAN, CILINCING, JAKARTA UTARA, DKI JAKARTA",35,79,177,256
https://kawalpemilu.org#25914,"ROROTAN, CILINCING, JAKARTA UTARA, DKI JAKARTA",36,84,186,270
https://kawalpemilu.org#25914,"ROROTAN, CILINCING, JAKARTA UTARA, DKI JAKARTA",37,44,194,238
https://kawalpemilu.org#25914,"ROROTAN, CILINCING, JAKARTA UTARA, DKI JAKARTA",38,44,159,203
https://kawalpemilu.org#25914,"ROROTAN, CILINCING, JAKARTA UTARA, DKI JAKARTA",39,82,156,238
https://kawalpemilu.org#25914,"ROROTAN, CILINCING, JAKARTA UTARA, DKI JAKARTA",40,46,167,213
https://kawalpemilu.org#25914,"ROROTAN, CILINCING, JAKARTA UTARA, DKI JAKARTA",41,56,216,272
https://kawalpemilu.org#25914,"ROROTAN, CILINCING, JAKARTA UTARA, DKI JAKARTA",42,93,152,245
https://kawalpemilu.org#25914,"ROROTAN, CILINCING, JAKARTA UTARA, DKI JAKARTA",43,48,191,239
https://kawalpemilu.org#25914,"ROROTAN, CILINCING, JAKARTA UTARA, DKI JAKARTA",44,73,176,249
https://kawalpemilu.org#25914,"ROROTAN, CILINCING, JAKARTA UTARA, DKI JAKARTA",45,52,161,213
https://kawalpemilu.org#25914,"ROROTAN, CILINCING, JAKARTA UTARA, DKI JAKARTA",46,63,192,255
https://kawalpemilu.org#25914,"ROROTAN, CILINCING, JAKARTA UTARA, DKI JAKARTA",47,69,183,252
https://kawalpemilu.org#25914,"ROROTAN, CILINCING, JAKARTA UTARA, DKI JAKARTA",48,106,166,272
https://kawalpemilu.org#25914,"ROROTAN, CILINCING, JAKARTA UTARA, DKI JAKARTA",49,72,140,212
https://kawalpemilu.org#25914,"ROROTAN, CILINCING, JAKARTA UTARA, DKI JAKARTA",50,77,168,245
https://kawalpemilu.org#25914,"ROROTAN, CILINCING, JAKARTA UTARA, DKI JAKARTA",51,62,152,214
https://kawalpemilu.org#25914,"ROROTAN, CILINCING, JAKARTA UTARA, DKI JAKARTA",52,62,196,258
https://kawalpemilu.org#25914,"ROROTAN, CILINCING, JAKARTA UTARA, DKI JAKARTA",53,60,171,231
https://kawalpemilu.org#25914,"ROROTAN, CILINCING, JAKARTA UTARA, DKI JAKARTA",54,58,163,221
https://kawalpemilu.org#25914,"ROROTAN, CILINCING, JAKARTA UTARA, DKI JAKARTA",55,68,207,275
https://kawalpemilu.org#25914,"ROROTAN, CILINCING, JAKARTA UTARA, DKI JAKARTA",56,46,217,263
https://kawalpemilu.org#25914,"ROROTAN, CILINCING, JAKARTA UTARA, DKI JAKARTA",57,57,185,242
https://kawalpemilu.org#25914,"ROROTAN, CILINCING, JAKARTA UTARA, DKI JAKARTA",58,67,188,255
https://kawalpemilu.org#25914,"ROROTAN, CILINCING, JAKARTA UTARA, DKI JAKARTA",59,52,123,175
https://kawalpemilu.org#25914,"ROROTAN, CILINCING, JAKARTA UTARA, DKI JAKARTA",60,99,135,234
https://kawalpemilu.org#25914,"ROROTAN, CILINCING, JAKARTA UTARA, DKI JAKARTA",61,95,158,253
https://kawalpemilu.org#25914,"ROROTAN, CILINCING, JAKARTA UTARA, DKI JAKARTA",62,75,154,229
https://kawalpemilu.org#25914,"ROROTAN, CILINCING, JAKARTA UTARA, DKI JAKARTA",63,122,160,282
https://kawalpemilu.org#25914,"ROROTAN, CILINCING, JAKARTA UTARA, DKI JAKARTA",64,47,203,250
https://kawalpemilu.org#25914,"ROROTAN, CILINCING, JAKARTA UTARA, DKI JAKARTA",66,58,187,245
https://kawalpemilu.org#25914,"ROROTAN, CILINCING, JAKARTA UTARA, DKI JAKARTA",67,70,186,256
https://kawalpemilu.org#25914,"ROROTAN, CILINCING, JAKARTA UTARA, DKI JAKARTA",68,57,152,209
https://kawalpemilu.org#25914,"ROROTAN, CILINCING, JAKARTA UTARA, DKI JAKARTA",69,57,188,245
https://kawalpemilu.org#25914,"ROROTAN, CILINCING, JAKARTA UTARA, DKI JAKARTA",70,56,190,246
https://kawalpemilu.org#25914,"ROROTAN, CILINCING, JAKARTA UTARA, DKI JAKARTA",71,85,187,272
https://kawalpemilu.org#25914,"ROROTAN, CILINCING, JAKARTA UTARA, DKI JAKARTA",72,103,132,235
https://kawalpemilu.org#25914,"ROROTAN, CILINCING, JAKARTA UTARA, DKI JAKARTA",73,151,73,224
https://kawalpemilu.org#25914,"ROROTAN, CILINCING, JAKARTA UTARA, DKI JAKARTA",74,61,143,204
https://kawalpemilu.org#25914,"ROROTAN, CILINCING, JAKARTA UTARA, DKI JAKARTA",75,32,169,201
https://kawalpemilu.org#25914,"ROROTAN, CILINCING, JAKARTA UTARA, DKI JAKARTA",76,45,213,258
https://kawalpemilu.org#25914,"ROROTAN, CILINCING, JAKARTA UTARA, DKI JAKARTA",77,46,203,249
https://kawalpemilu.org#25914,"ROROTAN, CILINCING, JAKARTA UTARA, DKI JAKARTA",78,61,185,246
https://kawalpemilu.org#25914,"ROROTAN, CILINCING, JAKARTA UTARA, DKI JAKARTA",79,24,215,239
https://kawalpemilu.org#25914,"ROROTAN, CILINCING, JAKARTA UTARA, DKI JAKARTA",80,30,216,246
https://kawalpemilu.org#25914,"ROROTAN, CILINCING, JAKARTA UTARA, DKI JAKARTA",81,26,229,255
https://kawalpemilu.org#25914,"ROROTAN, CILINCING, JAKARTA UTARA, DKI JAKARTA",82,39,198,237
https://kawalpemilu.org#25914,"ROROTAN, CILINCING, JAKARTA UTARA, DKI JAKARTA",83,82,135,217
https://kawalpemilu.org#25914,"ROROTAN, CILINCING, JAKARTA UTARA, DKI JAKARTA",84,100,138,238
https://kawalpemilu.org#25914,"ROROTAN, CILINCING, JAKARTA UTARA, DKI JAKARTA",85,82,177,259
https://kawalpemilu.org#25914,"ROROTAN, CILINCING, JAKARTA UTARA, DKI JAKARTA",86,88,149,237
https://kawalpemilu.org#25914,"ROROTAN, CILINCING, JAKARTA UTARA, DKI JAKARTA",87,91,169,260
https://kawalpemilu.org#25914,"ROROTAN, CILINCING, JAKARTA UTARA, DKI JAKARTA",88,82,168,250
https://kawalpemilu.org#25914,"ROROTAN, CILINCING, JAKARTA UTARA, DKI JAKARTA",89,62,153,215
https://kawalpemilu.org#25914,"ROROTAN, CILINCING, JAKARTA UTARA, DKI JAKARTA",90,102,139,1
https://kawalpemilu.org#25914,"ROROTAN, CILINCING, JAKARTA UTARA, DKI JAKARTA",91,110,127,237
https://kawalpemilu.org#25914,"ROROTAN, CILINCING, JAKARTA UTARA, DKI JAKARTA",92,115,125,240
https://kawalpemilu.org#25914,"ROROTAN, CILINCING, JAKARTA UTARA, DKI JAKARTA",93,132,89,221
https://kawalpemilu.org#25914,"ROROTAN, CILINCING, JAKARTA UTARA, DKI JAKARTA",94,102,147,249
https://kawalpemilu.org#25914,"ROROTAN, CILINCING, JAKARTA UTARA, DKI JAKARTA",95,87,151,238
https://kawalpemilu.org#25914,"ROROTAN, CILINCING, JAKARTA UTARA, DKI JAKARTA",96,86,164,250
https://kawalpemilu.org#25914,"ROROTAN, CILINCING, JAKARTA UTARA, DKI JAKARTA",97,106,128,234
https://kawalpemilu.org#25914,"ROROTAN, CILINCING, JAKARTA UTARA, DKI JAKARTA",98,96,142,238
https://kawalpemilu.org#25914,"ROROTAN, CILINCING, JAKARTA UTARA, DKI JAKARTA",99,58,164,222
https://kawalpemilu.org#25914,"ROROTAN, CILINCING, JAKARTA UTARA, DKI JAKARTA",100,102,144,246
https://kawalpemilu.org#25914,"ROROTAN, CILINCING, JAKARTA UTARA, DKI JAKARTA",101,73,173,246
https://kawalpemilu.org#25914,"ROROTAN, CILINCING, JAKARTA UTARA, DKI JAKARTA",102,70,170,240
https://kawalpemilu.org#25914,"ROROTAN, CILINCING, JAKARTA UTARA, DKI JAKARTA",103,79,165,244
https://kawalpemilu.org#25914,"ROROTAN, CILINCING, JAKARTA UTARA, DKI JAKARTA",104,73,183,256
https://kawalpemilu.org#25914,"ROROTAN, CILINCING, JAKARTA UTARA, DKI JAKARTA",105,64,163,227
https://kawalpemilu.org#25914,"ROROTAN, CILINCING, JAKARTA UTARA, DKI JAKARTA",106,94,128,222
https://kawalpemilu.org#25914,"ROROTAN, CILINCING, JAKARTA UTARA, DKI JAKARTA",107,80,156,236
https://kawalpemilu.org#25914,"ROROTAN, CILINCING, JAKARTA UTARA, DKI JAKARTA",108,64,142,206
https://kawalpemilu.org#25914,"ROROTAN, CILINCING, JAKARTA UTARA, DKI JAKARTA",109,91,120,211
https://kawalpemilu.org#25914,"ROROTAN, CILINCING, JAKARTA UTARA, DKI JAKARTA",110,66,94,160
https://kawalpemilu.org#25914,"ROROTAN, CILINCING, JAKARTA UTARA, DKI JAKARTA",111,49,186,235
https://kawalpemilu.org#25914,"ROROTAN, CILINCING, JAKARTA UTARA, DKI JAKARTA",112,65,172,237
https://kawalpemilu.org#25914,"ROROTAN, CILINCING, JAKARTA UTARA, DKI JAKARTA",113,86,141,227
https://kawalpemilu.org#25914,"ROROTAN, CILINCING, JAKARTA UTARA, DKI JAKARTA",114,103,84,187
https://kawalpemilu.org#25914,"ROROTAN, CILINCING, JAKARTA UTARA, DKI JAKARTA",115,74,88,162
https://kawalpemilu.org#25914,"ROROTAN, CILINCING, JAKARTA UTARA, DKI JAKARTA",116,119,92,211
https://kawalpemilu.org#25914,"ROROTAN, CILINCING, JAKARTA UTARA, DKI JAKARTA",117,86,115,201
https://kawalpemilu.org#25915,"SEMPER BARAT, CILINCING, JAKARTA UTARA, DKI JAKARTA",1,89,148,237
https://kawalpemilu.org#25915,"SEMPER BARAT, CILINCING, JAKARTA UTARA, DKI JAKARTA",2,167,77,244
https://kawalpemilu.org#25915,"SEMPER BARAT, CILINCING, JAKARTA UTARA, DKI JAKARTA",3,113,109,222
https://kawalpemilu.org#25915,"SEMPER BARAT, CILINCING, JAKARTA UTARA, DKI JAKARTA",4,113,124,237
https://kawalpemilu.org#25915,"SEMPER BARAT, CILINCING, JAKARTA UTARA, DKI JAKARTA",5,137,123,260
https://kawalpemilu.org#25915,"SEMPER BARAT, CILINCING, JAKARTA UTARA, DKI JAKARTA",6,144,110,254
https://kawalpemilu.org#25915,"SEMPER BARAT, CILINCING, JAKARTA UTARA, DKI JAKARTA",7,136,113,249
https://kawalpemilu.org#25915,"SEMPER BARAT, CILINCING, JAKARTA UTARA, DKI JAKARTA",8,116,131,247
https://kawalpemilu.org#25915,"SEMPER BARAT, CILINCING, JAKARTA UTARA, DKI JAKARTA",9,131,122,253
https://kawalpemilu.org#25915,"SEMPER BARAT, CILINCING, JAKARTA UTARA, DKI JAKARTA",10,145,90,235
https://kawalpemilu.org#25915,"SEMPER BARAT, CILINCING, JAKARTA UTARA, DKI JAKARTA",11,175,96,271
https://kawalpemilu.org#25915,"SEMPER BARAT, CILINCING, JAKARTA UTARA, DKI JAKARTA",12,118,130,248
https://kawalpemilu.org#25915,"SEMPER BARAT, CILINCING, JAKARTA UTARA, DKI JAKARTA",13,137,116,253
https://kawalpemilu.org#25915,"SEMPER BARAT, CILINCING, JAKARTA UTARA, DKI JAKARTA",15,154,58,212
https://kawalpemilu.org#25915,"SEMPER BARAT, CILINCING, JAKARTA UTARA, DKI JAKARTA",16,140,74,214
https://kawalpemilu.org#25915,"SEMPER BARAT, CILINCING, JAKARTA UTARA, DKI JAKARTA",17,139,101,240
https://kawalpemilu.org#25915,"SEMPER BARAT, CILINCING, JAKARTA UTARA, DKI JAKARTA",18,146,100,246
https://kawalpemilu.org#25915,"SEMPER BARAT, CILINCING, JAKARTA UTARA, DKI JAKARTA",19,115,112,227
https://kawalpemilu.org#25915,"SEMPER BARAT, CILINCING, JAKARTA UTARA, DKI JAKARTA",20,125,120,245
https://kawalpemilu.org#25915,"SEMPER BARAT, CILINCING, JAKARTA UTARA, DKI JAKARTA",21,125,141,266
https://kawalpemilu.org#25915,"SEMPER BARAT, CILINCING, JAKARTA UTARA, DKI JAKARTA",22,113,139,252
https://kawalpemilu.org#25915,"SEMPER BARAT, CILINCING, JAKARTA UTARA, DKI JAKARTA",23,182,83,265
https://kawalpemilu.org#25915,"SEMPER BARAT, CILINCING, JAKARTA UTARA, DKI JAKARTA",24,122,112,234
https://kawalpemilu.org#25915,"SEMPER BARAT, CILINCING, JAKARTA UTARA, DKI JAKARTA",25,159,84,243
https://kawalpemilu.org#25915,"SEMPER BARAT, CILINCING, JAKARTA UTARA, DKI JAKARTA",26,70,113,183
https://kawalpemilu.org#25915,"SEMPER BARAT, CILINCING, JAKARTA UTARA, DKI JAKARTA",27,85,162,247
https://kawalpemilu.org#25915,"SEMPER BARAT, CILINCING, JAKARTA UTARA, DKI JAKARTA",28,129,107,236
https://kawalpemilu.org#25915,"SEMPER BARAT, CILINCING, JAKARTA UTARA, DKI JAKARTA",29,72,119,191
https://kawalpemilu.org#25915,"SEMPER BARAT, CILINCING, JAKARTA UTARA, DKI JAKARTA",30,87,118,205
https://kawalpemilu.org#25915,"SEMPER BARAT, CILINCING, JAKARTA UTARA, DKI JAKARTA",31,100,121,221
https://kawalpemilu.org#25915,"SEMPER BARAT, CILINCING, JAKARTA UTARA, DKI JAKARTA",32,51,190,241
https://kawalpemilu.org#25915,"SEMPER BARAT, CILINCING, JAKARTA UTARA, DKI JAKARTA",33,97,142,239
https://kawalpemilu.org#25915,"SEMPER BARAT, CILINCING, JAKARTA UTARA, DKI JAKARTA",34,85,153,238
https://kawalpemilu.org#25915,"SEMPER BARAT, CILINCING, JAKARTA UTARA, DKI JAKARTA",35,84,151,235
https://kawalpemilu.org#25915,"SEMPER BARAT, CILINCING, JAKARTA UTARA, DKI JAKARTA",36,80,169,249
https://kawalpemilu.org#25915,"SEMPER BARAT, CILINCING, JAKARTA UTARA, DKI JAKARTA",37,94,159,253
https://kawalpemilu.org#25915,"SEMPER BARAT, CILINCING, JAKARTA UTARA, DKI JAKARTA",38,100,135,235
https://kawalpemilu.org#25915,"SEMPER BARAT, CILINCING, JAKARTA UTARA, DKI JAKARTA",39,99,126,225
https://kawalpemilu.org#25915,"SEMPER BARAT, CILINCING, JAKARTA UTARA, DKI JAKARTA",40,61,143,204
https://kawalpemilu.org#25915,"SEMPER BARAT, CILINCING, JAKARTA UTARA, DKI JAKARTA",41,67,163,230
https://kawalpemilu.org#25915,"SEMPER BARAT, CILINCING, JAKARTA UTARA, DKI JAKARTA",42,73,125,198
https://kawalpemilu.org#25915,"SEMPER BARAT, CILINCING, JAKARTA UTARA, DKI JAKARTA",43,75,182,257
https://kawalpemilu.org#25915,"SEMPER BARAT, CILINCING, JAKARTA UTARA, DKI JAKARTA",44,94,138,232
https://kawalpemilu.org#25915,"SEMPER BARAT, CILINCING, JAKARTA UTARA, DKI JAKARTA",45,52,188,240
https://kawalpemilu.org#25915,"SEMPER BARAT, CILINCING, JAKARTA UTARA, DKI JAKARTA",46,85,75,160
https://kawalpemilu.org#25915,"SEMPER BARAT, CILINCING, JAKARTA UTARA, DKI JAKARTA",47,100,76,176
https://kawalpemilu.org#25915,"SEMPER BARAT, CILINCING, JAKARTA UTARA, DKI JAKARTA",48,99,74,173
https://kawalpemilu.org#25915,"SEMPER BARAT, CILINCING, JAKARTA UTARA, DKI JAKARTA",49,83,60,143
https://kawalpemilu.org#25915,"SEMPER BARAT, CILINCING, JAKARTA UTARA, DKI JAKARTA",50,101,123,224
https://kawalpemilu.org#25915,"SEMPER BARAT, CILINCING, JAKARTA UTARA, DKI JAKARTA",51,77,139,216
https://kawalpemilu.org#25915,"SEMPER BARAT, CILINCING, JAKARTA UTARA, DKI JAKARTA",52,106,127,233
https://kawalpemilu.org#25915,"SEMPER BARAT, CILINCING, JAKARTA UTARA, DKI JAKARTA",53,92,154,246
https://kawalpemilu.org#25915,"SEMPER BARAT, CILINCING, JAKARTA UTARA, DKI JAKARTA",54,72,169,241
https://kawalpemilu.org#25915,"SEMPER BARAT, CILINCING, JAKARTA UTARA, DKI JAKARTA",55,113,141,254
https://kawalpemilu.org#25915,"SEMPER BARAT, CILINCING, JAKARTA UTARA, DKI JAKARTA",56,86,156,242
https://kawalpemilu.org#25915,"SEMPER BARAT, CILINCING, JAKARTA UTARA, DKI JAKARTA",57,73,104,177
https://kawalpemilu.org#25915,"SEMPER BARAT, CILINCING, JAKARTA UTARA, DKI JAKARTA",58,92,92,184
https://kawalpemilu.org#25915,"SEMPER BARAT, CILINCING, JAKARTA UTARA, DKI JAKARTA",59,84,109,193
https://kawalpemilu.org#25915,"SEMPER BARAT, CILINCING, JAKARTA UTARA, DKI JAKARTA",60,95,116,211
https://kawalpemilu.org#25915,"SEMPER BARAT, CILINCING, JAKARTA UTARA, DKI JAKARTA",61,86,130,216
https://kawalpemilu.org#25915,"SEMPER BARAT, CILINCING, JAKARTA UTARA, DKI JAKARTA",62,104,88,192
https://kawalpemilu.org#25915,"SEMPER BARAT, CILINCING, JAKARTA UTARA, DKI JAKARTA",63,58,141,199
https://kawalpemilu.org#25915,"SEMPER BARAT, CILINCING, JAKARTA UTARA, DKI JAKARTA",64,92,148,240
https://kawalpemilu.org#25915,"SEMPER BARAT, CILINCING, JAKARTA UTARA, DKI JAKARTA",65,86,130,216
https://kawalpemilu.org#25915,"SEMPER BARAT, CILINCING, JAKARTA UTARA, DKI JAKARTA",66,93,115,208
https://kawalpemilu.org#25915,"SEMPER BARAT, CILINCING, JAKARTA UTARA, DKI JAKARTA",67,50,97,147
https://kawalpemilu.org#25915,"SEMPER BARAT, CILINCING, JAKARTA UTARA, DKI JAKARTA",68,71,98,169
https://kawalpemilu.org#25915,"SEMPER BARAT, CILINCING, JAKARTA UTARA, DKI JAKARTA",69,77,93,170
https://kawalpemilu.org#25915,"SEMPER BARAT, CILINCING, JAKARTA UTARA, DKI JAKARTA",70,91,160,251
https://kawalpemilu.org#25915,"SEMPER BARAT, CILINCING, JAKARTA UTARA, DKI JAKARTA",71,83,147,230
https://kawalpemilu.org#25915,"SEMPER BARAT, CILINCING, JAKARTA UTARA, DKI JAKARTA",72,138,111,249
https://kawalpemilu.org#25915,"SEMPER BARAT, CILINCING, JAKARTA UTARA, DKI JAKARTA",73,121,115,236
https://kawalpemilu.org#25915,"SEMPER BARAT, CILINCING, JAKARTA UTARA, DKI JAKARTA",74,121,134,255
https://kawalpemilu.org#25915,"SEMPER BARAT, CILINCING, JAKARTA UTARA, DKI JAKARTA",75,87,124,211
https://kawalpemilu.org#25915,"SEMPER BARAT, CILINCING, JAKARTA UTARA, DKI JAKARTA",76,68,157,225
https://kawalpemilu.org#25915,"SEMPER BARAT, CILINCING, JAKARTA UTARA, DKI JAKARTA",77,110,134,244
https://kawalpemilu.org#25915,"SEMPER BARAT, CILINCING, JAKARTA UTARA, DKI JAKARTA",78,68,135,203
https://kawalpemilu.org#25915,"SEMPER BARAT, CILINCING, JAKARTA UTARA, DKI JAKARTA",79,103,116,219
https://kawalpemilu.org#25915,"SEMPER BARAT, CILINCING, JAKARTA UTARA, DKI JAKARTA",80,190,54,244
https://kawalpemilu.org#25915,"SEMPER BARAT, CILINCING, JAKARTA UTARA, DKI JAKARTA",81,130,111,241
https://kawalpemilu.org#25915,"SEMPER BARAT, CILINCING, JAKARTA UTARA, DKI JAKARTA",82,85,167,252
https://kawalpemilu.org#25915,"SEMPER BARAT, CILINCING, JAKARTA UTARA, DKI JAKARTA",83,70,128,198
https://kawalpemilu.org#25915,"SEMPER BARAT, CILINCING, JAKARTA UTARA, DKI JAKARTA",84,91,91,182
https://kawalpemilu.org#25915,"SEMPER BARAT, CILINCING, JAKARTA UTARA, DKI JAKARTA",85,86,96,182
https://kawalpemilu.org#25915,"SEMPER BARAT, CILINCING, JAKARTA UTARA, DKI JAKARTA",86,105,100,205
https://kawalpemilu.org#25915,"SEMPER BARAT, CILINCING, JAKARTA UTARA, DKI JAKARTA",87,76,121,197
https://kawalpemilu.org#25915,"SEMPER BARAT, CILINCING, JAKARTA UTARA, DKI JAKARTA",88,71,97,168
https://kawalpemilu.org#25915,"SEMPER BARAT, CILINCING, JAKARTA UTARA, DKI JAKARTA",89,64,112,176
https://kawalpemilu.org#25915,"SEMPER BARAT, CILINCING, JAKARTA UTARA, DKI JAKARTA",90,122,110,132
https://kawalpemilu.org#25915,"SEMPER BARAT, CILINCING, JAKARTA UTARA, DKI JAKARTA",91,135,56,191
https://kawalpemilu.org#25915,"SEMPER BARAT, CILINCING, JAKARTA UTARA, DKI JAKARTA",92,94,94,188
https://kawalpemilu.org#25915,"SEMPER BARAT, CILINCING, JAKARTA UTARA, DKI JAKARTA",93,134,52,186
https://kawalpemilu.org#25915,"SEMPER BARAT, CILINCING, JAKARTA UTARA, DKI JAKARTA",94,175,77,252
https://kawalpemilu.org#25915,"SEMPER BARAT, CILINCING, JAKARTA UTARA, DKI JAKARTA",95,105,113,218
https://kawalpemilu.org#25915,"SEMPER BARAT, CILINCING, JAKARTA UTARA, DKI JAKARTA",96,184,51,235
https://kawalpemilu.org#25915,"SEMPER BARAT, CILINCING, JAKARTA UTARA, DKI JAKARTA",97,98,174,272
https://kawalpemilu.org#25915,"SEMPER BARAT, CILINCING, JAKARTA UTARA, DKI JAKARTA",98,95,148,243
https://kawalpemilu.org#25915,"SEMPER BARAT, CILINCING, JAKARTA UTARA, DKI JAKARTA",99,91,121,212
https://kawalpemilu.org#25915,"SEMPER BARAT, CILINCING, JAKARTA UTARA, DKI JAKARTA",100,101,93,194
https://kawalpemilu.org#25915,"SEMPER BARAT, CILINCING, JAKARTA UTARA, DKI JAKARTA",101,133,126,259
https://kawalpemilu.org#25915,"SEMPER BARAT, CILINCING, JAKARTA UTARA, DKI JAKARTA",102,74,100,174
https://kawalpemilu.org#25915,"SEMPER BARAT, CILINCING, JAKARTA UTARA, DKI JAKARTA",103,129,65,194
https://kawalpemilu.org#25915,"SEMPER BARAT, CILINCING, JAKARTA UTARA, DKI JAKARTA",104,110,74,184
https://kawalpemilu.org#25915,"SEMPER BARAT, CILINCING, JAKARTA UTARA, DKI JAKARTA",105,80,84,164
https://kawalpemilu.org#25915,"SEMPER BARAT, CILINCING, JAKARTA UTARA, DKI JAKARTA",106,110,59,169
https://kawalpemilu.org#25915,"SEMPER BARAT, CILINCING, JAKARTA UTARA, DKI JAKARTA",107,94,50,144
https://kawalpemilu.org#25915,"SEMPER BARAT, CILINCING, JAKARTA UTARA, DKI JAKARTA",108,138,24,162
https://kawalpemilu.org#25915,"SEMPER BARAT, CILINCING, JAKARTA UTARA, DKI JAKARTA",109,211,10,221
https://kawalpemilu.org#25915,"SEMPER BARAT, CILINCING, JAKARTA UTARA, DKI JAKARTA",110,176,24,200
https://kawalpemilu.org#25915,"SEMPER BARAT, CILINCING, JAKARTA UTARA, DKI JAKARTA",111,150,91,241
https://kawalpemilu.org#25915,"SEMPER BARAT, CILINCING, JAKARTA UTARA, DKI JAKARTA",112,104,130,234
https://kawalpemilu.org#25915,"SEMPER BARAT, CILINCING, JAKARTA UTARA, DKI JAKARTA",113,131,109,240
https://kawalpemilu.org#25915,"SEMPER BARAT, CILINCING, JAKARTA UTARA, DKI JAKARTA",114,137,113,250
https://kawalpemilu.org#25915,"SEMPER BARAT, CILINCING, JAKARTA UTARA, DKI JAKARTA",115,120,147,267
https://kawalpemilu.org#25915,"SEMPER BARAT, CILINCING, JAKARTA UTARA, DKI JAKARTA",116,108,103,211
https://kawalpemilu.org#25915,"SEMPER BARAT, CILINCING, JAKARTA UTARA, DKI JAKARTA",117,134,97,231
https://kawalpemilu.org#25915,"SEMPER BARAT, CILINCING, JAKARTA UTARA, DKI JAKARTA",118,120,101,221
https://kawalpemilu.org#25915,"SEMPER BARAT, CILINCING, JAKARTA UTARA, DKI JAKARTA",119,86,105,191
https://kawalpemilu.org#25915,"SEMPER BARAT, CILINCING, JAKARTA UTARA, DKI JAKARTA",120,134,111,245
https://kawalpemilu.org#25915,"SEMPER BARAT, CILINCING, JAKARTA UTARA, DKI JAKARTA",121,103,129,232
https://kawalpemilu.org#25915,"SEMPER BARAT, CILINCING, JAKARTA UTARA, DKI JAKARTA",122,127,137,264
https://kawalpemilu.org#25915,"SEMPER BARAT, CILINCING, JAKARTA UTARA, DKI JAKARTA",123,121,127,248
https://kawalpemilu.org#25915,"SEMPER BARAT, CILINCING, JAKARTA UTARA, DKI JAKARTA",124,112,120,232
https://kawalpemilu.org#25915,"SEMPER BARAT, CILINCING, JAKARTA UTARA, DKI JAKARTA",125,118,127,245
https://kawalpemilu.org#25915,"SEMPER BARAT, CILINCING, JAKARTA UTARA, DKI JAKARTA",126,159,94,253
https://kawalpemilu.org#25915,"SEMPER BARAT, CILINCING, JAKARTA UTARA, DKI JAKARTA",127,109,143,252
https://kawalpemilu.org#25915,"SEMPER BARAT, CILINCING, JAKARTA UTARA, DKI JAKARTA",128,124,100,224
https://kawalpemilu.org#25915,"SEMPER BARAT, CILINCING, JAKARTA UTARA, DKI JAKARTA",129,104,133,237
https://kawalpemilu.org#25915,"SEMPER BARAT, CILINCING, JAKARTA UTARA, DKI JAKARTA",130,83,124,207
https://kawalpemilu.org#25915,"SEMPER BARAT, CILINCING, JAKARTA UTARA, DKI JAKARTA",131,0,0,114
https://kawalpemilu.org#25915,"SEMPER BARAT, CILINCING, JAKARTA UTARA, DKI JAKARTA",132,112,62,174
https://kawalpemilu.org#25915,"SEMPER BARAT, CILINCING, JAKARTA UTARA, DKI JAKARTA",133,120,73,193
https://kawalpemilu.org#25915,"SEMPER BARAT, CILINCING, JAKARTA UTARA, DKI JAKARTA",134,103,64,167
https://kawalpemilu.org#25915,"SEMPER BARAT, CILINCING, JAKARTA UTARA, DKI JAKARTA",135,155,103,258
https://kawalpemilu.org#25915,"SEMPER BARAT, CILINCING, JAKARTA UTARA, DKI JAKARTA",136,110,133,243
https://kawalpemilu.org#25915,"SEMPER BARAT, CILINCING, JAKARTA UTARA, DKI JAKARTA",137,100,149,249
https://kawalpemilu.org#25915,"SEMPER BARAT, CILINCING, JAKARTA UTARA, DKI JAKARTA",138,125,125,250
https://kawalpemilu.org#25915,"SEMPER BARAT, CILINCING, JAKARTA UTARA, DKI JAKARTA",139,79,103,182
https://kawalpemilu.org#25915,"SEMPER BARAT, CILINCING, JAKARTA UTARA, DKI JAKARTA",140,104,90,194
https://kawalpemilu.org#25915,"SEMPER BARAT, CILINCING, JAKARTA UTARA, DKI JAKARTA",141,97,88,185
https://kawalpemilu.org#25915,"SEMPER BARAT, CILINCING, JAKARTA UTARA, DKI JAKARTA",142,130,130,260
https://kawalpemilu.org#25915,"SEMPER BARAT, CILINCING, JAKARTA UTARA, DKI JAKARTA",143,123,103,226
https://kawalpemilu.org#25915,"SEMPER BARAT, CILINCING, JAKARTA UTARA, DKI JAKARTA",144,137,100,237
https://kawalpemilu.org#25915,"SEMPER BARAT, CILINCING, JAKARTA UTARA, DKI JAKARTA",145,119,100,219
https://kawalpemilu.org#25915,"SEMPER BARAT, CILINCING, JAKARTA UTARA, DKI JAKARTA",146,114,84,198
https://kawalpemilu.org#25915,"SEMPER BARAT, CILINCING, JAKARTA UTARA, DKI JAKARTA",147,93,97,190
https://kawalpemilu.org#25915,"SEMPER BARAT, CILINCING, JAKARTA UTARA, DKI JAKARTA",148,165,60,225
https://kawalpemilu.org#25915,"SEMPER BARAT, CILINCING, JAKARTA UTARA, DKI JAKARTA",149,124,63,187
https://kawalpemilu.org#25915,"SEMPER BARAT, CILINCING, JAKARTA UTARA, DKI JAKARTA",150,104,113,217
https://kawalpemilu.org#25915,"SEMPER BARAT, CILINCING, JAKARTA UTARA, DKI JAKARTA",151,141,82,223
https://kawalpemilu.org#25915,"SEMPER BARAT, CILINCING, JAKARTA UTARA, DKI JAKARTA",152,125,108,233
https://kawalpemilu.org#25915,"SEMPER BARAT, CILINCING, JAKARTA UTARA, DKI JAKARTA",153,125,125,250
https://kawalpemilu.org#25915,"SEMPER BARAT, CILINCING, JAKARTA UTARA, DKI JAKARTA",154,134,89,223
https://kawalpemilu.org#25915,"SEMPER BARAT, CILINCING, JAKARTA UTARA, DKI JAKARTA",155,168,54,222
https://kawalpemilu.org#25915,"SEMPER BARAT, CILINCING, JAKARTA UTARA, DKI JAKARTA",156,139,119,258
https://kawalpemilu.org#25915,"SEMPER BARAT, CILINCING, JAKARTA UTARA, DKI JAKARTA",157,109,111,220
https://kawalpemilu.org#25915,"SEMPER BARAT, CILINCING, JAKARTA UTARA, DKI JAKARTA",158,149,104,253
https://kawalpemilu.org#25915,"SEMPER BARAT, CILINCING, JAKARTA UTARA, DKI JAKARTA",159,119,127,246
https://kawalpemilu.org#25915,"SEMPER BARAT, CILINCING, JAKARTA UTARA, DKI JAKARTA",160,163,117,280
https://kawalpemilu.org#25915,"SEMPER BARAT, CILINCING, JAKARTA UTARA, DKI JAKARTA",161,132,109,241
https://kawalpemilu.org#25915,"SEMPER BARAT, CILINCING, JAKARTA UTARA, DKI JAKARTA",162,106,136,242
https://kawalpemilu.org#25915,"SEMPER BARAT, CILINCING, JAKARTA UTARA, DKI JAKARTA",163,154,120,274
https://kawalpemilu.org#25915,"SEMPER BARAT, CILINCING, JAKARTA UTARA, DKI JAKARTA",164,116,81,197
https://kawalpemilu.org#25915,"SEMPER BARAT, CILINCING, JAKARTA UTARA, DKI JAKARTA",165,80,98,178
https://kawalpemilu.org#25915,"SEMPER BARAT, CILINCING, JAKARTA UTARA, DKI JAKARTA",166,73,103,176
https://kawalpemilu.org#25915,"SEMPER BARAT, CILINCING, JAKARTA UTARA, DKI JAKARTA",167,110,99,209
https://kawalpemilu.org#25915,"SEMPER BARAT, CILINCING, JAKARTA UTARA, DKI JAKARTA",168,165,83,248
https://kawalpemilu.org#25915,"SEMPER BARAT, CILINCING, JAKARTA UTARA, DKI JAKARTA",169,169,90,259
https://kawalpemilu.org#25915,"SEMPER BARAT, CILINCING, JAKARTA UTARA, DKI JAKARTA",170,132,121,253
https://kawalpemilu.org#25915,"SEMPER BARAT, CILINCING, JAKARTA UTARA, DKI JAKARTA",171,100,143,243
https://kawalpemilu.org#25915,"SEMPER BARAT, CILINCING, JAKARTA UTARA, DKI JAKARTA",172,83,145,228
https://kawalpemilu.org#25915,"SEMPER BARAT, CILINCING, JAKARTA UTARA, DKI JAKARTA",173,53,145,198
https://kawalpemilu.org#25915,"SEMPER BARAT, CILINCING, JAKARTA UTARA, DKI JAKARTA",174,102,126,228
https://kawalpemilu.org#25915,"SEMPER BARAT, CILINCING, JAKARTA UTARA, DKI JAKARTA",175,126,107,233
https://kawalpemilu.org#25915,"SEMPER BARAT, CILINCING, JAKARTA UTARA, DKI JAKARTA",176,133,108,241
https://kawalpemilu.org#25915,"SEMPER BARAT, CILINCING, JAKARTA UTARA, DKI JAKARTA",177,123,129,252
https://kawalpemilu.org#25915,"SEMPER BARAT, CILINCING, JAKARTA UTARA, DKI JAKARTA",178,107,140,247
https://kawalpemilu.org#25915,"SEMPER BARAT, CILINCING, JAKARTA UTARA, DKI JAKARTA",179,116,83,199
https://kawalpemilu.org#25915,"SEMPER BARAT, CILINCING, JAKARTA UTARA, DKI JAKARTA",180,129,78,207
https://kawalpemilu.org#25915,"SEMPER BARAT, CILINCING, JAKARTA UTARA, DKI JAKARTA",181,159,60,219
https://kawalpemilu.org#25915,"SEMPER BARAT, CILINCING, JAKARTA UTARA, DKI JAKARTA",182,142,117,259
https://kawalpemilu.org#25915,"SEMPER BARAT, CILINCING, JAKARTA UTARA, DKI JAKARTA",183,119,125,244
https://kawalpemilu.org#25915,"SEMPER BARAT, CILINCING, JAKARTA UTARA, DKI JAKARTA",184,85,179,264
https://kawalpemilu.org#25915,"SEMPER BARAT, CILINCING, JAKARTA UTARA, DKI JAKARTA",185,121,134,255
https://kawalpemilu.org#25915,"SEMPER BARAT, CILINCING, JAKARTA UTARA, DKI JAKARTA",186,109,125,234
https://kawalpemilu.org#25915,"SEMPER BARAT, CILINCING, JAKARTA UTARA, DKI JAKARTA",187,95,134,229
https://kawalpemilu.org#25915,"SEMPER BARAT, CILINCING, JAKARTA UTARA, DKI JAKARTA",188,131,105,236
https://kawalpemilu.org#25915,"SEMPER BARAT, CILINCING, JAKARTA UTARA, DKI JAKARTA",189,106,128,234
https://kawalpemilu.org#25915,"SEMPER BARAT, CILINCING, JAKARTA UTARA, DKI JAKARTA",190,96,92,188
https://kawalpemilu.org#25915,"SEMPER BARAT, CILINCING, JAKARTA UTARA, DKI JAKARTA",191,103,110,213
https://kawalpemilu.org#25915,"SEMPER BARAT, CILINCING, JAKARTA UTARA, DKI JAKARTA",192,106,150,256
https://kawalpemilu.org#25915,"SEMPER BARAT, CILINCING, JAKARTA UTARA, DKI JAKARTA",193,97,79,176
https://kawalpemilu.org#25915,"SEMPER BARAT, CILINCING, JAKARTA UTARA, DKI JAKARTA",194,83,103,186
https://kawalpemilu.org#25915,"SEMPER BARAT, CILINCING, JAKARTA UTARA, DKI JAKARTA",195,96,141,237
https://kawalpemilu.org#25915,"SEMPER BARAT, CILINCING, JAKARTA UTARA, DKI JAKARTA",196,120,135,255
https://kawalpemilu.org#25915,"SEMPER BARAT, CILINCING, JAKARTA UTARA, DKI JAKARTA",197,92,140,232
https://kawalpemilu.org#25915,"SEMPER BARAT, CILINCING, JAKARTA UTARA, DKI JAKARTA",198,130,98,228
https://kawalpemilu.org#25915,"SEMPER BARAT, CILINCING, JAKARTA UTARA, DKI JAKARTA",199,112,132,244
https://kawalpemilu.org#25915,"SEMPER BARAT, CILINCING, JAKARTA UTARA, DKI JAKARTA",200,128,107,235
https://kawalpemilu.org#25915,"SEMPER BARAT, CILINCING, JAKARTA UTARA, DKI JAKARTA",201,135,93,228
https://kawalpemilu.org#25915,"SEMPER BARAT, CILINCING, JAKARTA UTARA, DKI JAKARTA",202,87,87,174
https://kawalpemilu.org#25915,"SEMPER BARAT, CILINCING, JAKARTA UTARA, DKI JAKARTA",203,125,50,175
https://kawalpemilu.org#25915,"SEMPER BARAT, CILINCING, JAKARTA UTARA, DKI JAKARTA",204,101,60,160
https://kawalpemilu.org#25915,"SEMPER BARAT, CILINCING, JAKARTA UTARA, DKI JAKARTA",205,171,93,264
https://kawalpemilu.org#25915,"SEMPER BARAT, CILINCING, JAKARTA UTARA, DKI JAKARTA",206,111,151,262
https://kawalpemilu.org#25915,"SEMPER BARAT, CILINCING, JAKARTA UTARA, DKI JAKARTA",207,148,95,243
https://kawalpemilu.org#25915,"SEMPER BARAT, CILINCING, JAKARTA UTARA, DKI JAKARTA",208,140,108,248
https://kawalpemilu.org#25915,"SEMPER BARAT, CILINCING, JAKARTA UTARA, DKI JAKARTA",209,59,188,247
https://kawalpemilu.org#25915,"SEMPER BARAT, CILINCING, JAKARTA UTARA, DKI JAKARTA",210,49,155,204
https://kawalpemilu.org#25915,"SEMPER BARAT, CILINCING, JAKARTA UTARA, DKI JAKARTA",211,47,139,186
https://kawalpemilu.org#25917,"PADEMANGAN TIMUR, PADEMANGAN, JAKARTA UTARA, DKI JAKARTA",1,166,29,195
https://kawalpemilu.org#25917,"PADEMANGAN TIMUR, PADEMANGAN, JAKARTA UTARA, DKI JAKARTA",2,200,24,224
https://kawalpemilu.org#25917,"PADEMANGAN TIMUR, PADEMANGAN, JAKARTA UTARA, DKI JAKARTA",3,195,43,238
https://kawalpemilu.org#25917,"PADEMANGAN TIMUR, PADEMANGAN, JAKARTA UTARA, DKI JAKARTA",4,163,38,201
https://kawalpemilu.org#25917,"PADEMANGAN TIMUR, PADEMANGAN, JAKARTA UTARA, DKI JAKARTA",5,120,56,176
https://kawalpemilu.org#25917,"PADEMANGAN TIMUR, PADEMANGAN, JAKARTA UTARA, DKI JAKARTA",6,131,64,195
https://kawalpemilu.org#25917,"PADEMANGAN TIMUR, PADEMANGAN, JAKARTA UTARA, DKI JAKARTA",7,129,77,206
https://kawalpemilu.org#25917,"PADEMANGAN TIMUR, PADEMANGAN, JAKARTA UTARA, DKI JAKARTA",8,159,43,202
https://kawalpemilu.org#25917,"PADEMANGAN TIMUR, PADEMANGAN, JAKARTA UTARA, DKI JAKARTA",9,173,53,226
https://kawalpemilu.org#25917,"PADEMANGAN TIMUR, PADEMANGAN, JAKARTA UTARA, DKI JAKARTA",10,147,66,213
https://kawalpemilu.org#25917,"PADEMANGAN TIMUR, PADEMANGAN, JAKARTA UTARA, DKI JAKARTA",11,159,26,185
https://kawalpemilu.org#25917,"PADEMANGAN TIMUR, PADEMANGAN, JAKARTA UTARA, DKI JAKARTA",12,147,36,183
https://kawalpemilu.org#25917,"PADEMANGAN TIMUR, PADEMANGAN, JAKARTA UTARA, DKI JAKARTA",13,140,77,217
https://kawalpemilu.org#25917,"PADEMANGAN TIMUR, PADEMANGAN, JAKARTA UTARA, DKI JAKARTA",14,189,45,234
https://kawalpemilu.org#25917,"PADEMANGAN TIMUR, PADEMANGAN, JAKARTA UTARA, DKI JAKARTA",15,189,69,258
https://kawalpemilu.org#25917,"PADEMANGAN TIMUR, PADEMANGAN, JAKARTA UTARA, DKI JAKARTA",16,177,63,240
https://kawalpemilu.org#25917,"PADEMANGAN TIMUR, PADEMANGAN, JAKARTA UTARA, DKI JAKARTA",17,169,85,254
https://kawalpemilu.org#25917,"PADEMANGAN TIMUR, PADEMANGAN, JAKARTA UTARA, DKI JAKARTA",18,179,91,270
https://kawalpemilu.org#25917,"PADEMANGAN TIMUR, PADEMANGAN, JAKARTA UTARA, DKI JAKARTA",19,154,99,253
https://kawalpemilu.org#25917,"PADEMANGAN TIMUR, PADEMANGAN, JAKARTA UTARA, DKI JAKARTA",20,105,86,191
https://kawalpemilu.org#25917,"PADEMANGAN TIMUR, PADEMANGAN, JAKARTA UTARA, DKI JAKARTA",21,106,70,176
https://kawalpemilu.org#25917,"PADEMANGAN TIMUR, PADEMANGAN, JAKARTA UTARA, DKI JAKARTA",22,118,52,170
https://kawalpemilu.org#25917,"PADEMANGAN TIMUR, PADEMANGAN, JAKARTA UTARA, DKI JAKARTA",23,93,29,122
https://kawalpemilu.org#25917,"PADEMANGAN TIMUR, PADEMANGAN, JAKARTA UTARA, DKI JAKARTA",24,158,8,166
https://kawalpemilu.org#25917,"PADEMANGAN TIMUR, PADEMANGAN, JAKARTA UTARA, DKI JAKARTA",25,204,64,268
https://kawalpemilu.org#25917,"PADEMANGAN TIMUR, PADEMANGAN, JAKARTA UTARA, DKI JAKARTA",26,163,38,201
https://kawalpemilu.org#25917,"PADEMANGAN TIMUR, PADEMANGAN, JAKARTA UTARA, DKI JAKARTA",27,148,31,179
https://kawalpemilu.org#25917,"PADEMANGAN TIMUR, PADEMANGAN, JAKARTA UTARA, DKI JAKARTA",28,137,26,163
https://kawalpemilu.org#25917,"PADEMANGAN TIMUR, PADEMANGAN, JAKARTA UTARA, DKI JAKARTA",29,173,30,203
https://kawalpemilu.org#25917,"PADEMANGAN TIMUR, PADEMANGAN, JAKARTA UTARA, DKI JAKARTA",30,165,52,217
https://kawalpemilu.org#25917,"PADEMANGAN TIMUR, PADEMANGAN, JAKARTA UTARA, DKI JAKARTA",31,223,39,262
https://kawalpemilu.org#25917,"PADEMANGAN TIMUR, PADEMANGAN, JAKARTA UTARA, DKI JAKARTA",32,169,85,254
https://kawalpemilu.org#25917,"PADEMANGAN TIMUR, PADEMANGAN, JAKARTA UTARA, DKI JAKARTA",33,111,47,162
https://kawalpemilu.org#25917,"PADEMANGAN TIMUR, PADEMANGAN, JAKARTA UTARA, DKI JAKARTA",34,112,72,184
https://kawalpemilu.org#25917,"PADEMANGAN TIMUR, PADEMANGAN, JAKARTA UTARA, DKI JAKARTA",35,220,15,235
https://kawalpemilu.org#25917,"PADEMANGAN TIMUR, PADEMANGAN, JAKARTA UTARA, DKI JAKARTA",36,199,12,211
https://kawalpemilu.org#25917,"PADEMANGAN TIMUR, PADEMANGAN, JAKARTA UTARA, DKI JAKARTA",37,184,32,216
https://kawalpemilu.org#25917,"PADEMANGAN TIMUR, PADEMANGAN, JAKARTA UTARA, DKI JAKARTA",38,191,31,222
https://kawalpemilu.org#25917,"PADEMANGAN TIMUR, PADEMANGAN, JAKARTA UTARA, DKI JAKARTA",39,160,26,186
https://kawalpemilu.org#25917,"PADEMANGAN TIMUR, PADEMANGAN, JAKARTA UTARA, DKI JAKARTA",40,185,42,227
https://kawalpemilu.org#25917,"PADEMANGAN TIMUR, PADEMANGAN, JAKARTA UTARA, DKI JAKARTA",41,168,41,209
https://kawalpemilu.org#25917,"PADEMANGAN TIMUR, PADEMANGAN, JAKARTA UTARA, DKI JAKARTA",42,202,55,257
https://kawalpemilu.org#25917,"PADEMANGAN TIMUR, PADEMANGAN, JAKARTA UTARA, DKI JAKARTA",43,119,105,224
https://kawalpemilu.org#25917,"PADEMANGAN TIMUR, PADEMANGAN, JAKARTA UTARA, DKI JAKARTA",44,168,75,243
https://kawalpemilu.org#25917,"PADEMANGAN TIMUR, PADEMANGAN, JAKARTA UTARA, DKI JAKARTA",45,191,29,220
https://kawalpemilu.org#25917,"PADEMANGAN TIMUR, PADEMANGAN, JAKARTA UTARA, DKI JAKARTA",46,190,35,225
https://kawalpemilu.org#25917,"PADEMANGAN TIMUR, PADEMANGAN, JAKARTA UTARA, DKI JAKARTA",47,202,24,226
https://kawalpemilu.org#25917,"PADEMANGAN TIMUR, PADEMANGAN, JAKARTA UTARA, DKI JAKARTA",48,204,36,240
https://kawalpemilu.org#25917,"PADEMANGAN TIMUR, PADEMANGAN, JAKARTA UTARA, DKI JAKARTA",49,179,57,236
https://kawalpemilu.org#25917,"PADEMANGAN TIMUR, PADEMANGAN, JAKARTA UTARA, DKI JAKARTA",50,219,22,241
https://kawalpemilu.org#25917,"PADEMANGAN TIMUR, PADEMANGAN, JAKARTA UTARA, DKI JAKARTA",51,199,26,225
https://kawalpemilu.org#25917,"PADEMANGAN TIMUR, PADEMANGAN, JAKARTA UTARA, DKI JAKARTA",52,193,25,218
https://kawalpemilu.org#25917,"PADEMANGAN TIMUR, PADEMANGAN, JAKARTA UTARA, DKI JAKARTA",53,146,13,159
https://kawalpemilu.org#25917,"PADEMANGAN TIMUR, PADEMANGAN, JAKARTA UTARA, DKI JAKARTA",54,210,35,245
https://kawalpemilu.org#25917,"PADEMANGAN TIMUR, PADEMANGAN, JAKARTA UTARA, DKI JAKARTA",55,211,17,228
https://kawalpemilu.org#25917,"PADEMANGAN TIMUR, PADEMANGAN, JAKARTA UTARA, DKI JAKARTA",56,207,25,232
https://kawalpemilu.org#25917,"PADEMANGAN TIMUR, PADEMANGAN, JAKARTA UTARA, DKI JAKARTA",57,184,24,208
https://kawalpemilu.org#25917,"PADEMANGAN TIMUR, PADEMANGAN, JAKARTA UTARA, DKI JAKARTA",58,182,29,211
https://kawalpemilu.org#25917,"PADEMANGAN TIMUR, PADEMANGAN, JAKARTA UTARA, DKI JAKARTA",59,214,38,252
https://kawalpemilu.org#25917,"PADEMANGAN TIMUR, PADEMANGAN, JAKARTA UTARA, DKI JAKARTA",60,167,36,203
https://kawalpemilu.org#25917,"PADEMANGAN TIMUR, PADEMANGAN, JAKARTA UTARA, DKI JAKARTA",61,186,37,223
https://kawalpemilu.org#25917,"PADEMANGAN TIMUR, PADEMANGAN, JAKARTA UTARA, DKI JAKARTA",62,211,21,232
https://kawalpemilu.org#25917,"PADEMANGAN TIMUR, PADEMANGAN, JAKARTA UTARA, DKI JAKARTA",63,221,22,243
https://kawalpemilu.org#25917,"PADEMANGAN TIMUR, PADEMANGAN, JAKARTA UTARA, DKI JAKARTA",64,185,34,219
https://kawalpemilu.org#25917,"PADEMANGAN TIMUR, PADEMANGAN, JAKARTA UTARA, DKI JAKARTA",65,221,11,232
https://kawalpemilu.org#25917,"PADEMANGAN TIMUR, PADEMANGAN, JAKARTA UTARA, DKI JAKARTA",66,187,26,213
https://kawalpemilu.org#25917,"PADEMANGAN TIMUR, PADEMANGAN, JAKARTA UTARA, DKI JAKARTA",67,192,38,230
https://kawalpemilu.org#25917,"PADEMANGAN TIMUR, PADEMANGAN, JAKARTA UTARA, DKI JAKARTA",68,196,33,229
https://kawalpemilu.org#25917,"PADEMANGAN TIMUR, PADEMANGAN, JAKARTA UTARA, DKI JAKARTA",69,180,30,210
https://kawalpemilu.org#25917,"PADEMANGAN TIMUR, PADEMANGAN, JAKARTA UTARA, DKI JAKARTA",70,179,19,198
https://kawalpemilu.org#25917,"PADEMANGAN TIMUR, PADEMANGAN, JAKARTA UTARA, DKI JAKARTA",71,174,25,199
https://kawalpemilu.org#25917,"PADEMANGAN TIMUR, PADEMANGAN, JAKARTA UTARA, DKI JAKARTA",72,200,9,209
https://kawalpemilu.org#25917,"PADEMANGAN TIMUR, PADEMANGAN, JAKARTA UTARA, DKI JAKARTA",73,196,21,217
https://kawalpemilu.org#25917,"PADEMANGAN TIMUR, PADEMANGAN, JAKARTA UTARA, DKI JAKARTA",74,163,13,176
https://kawalpemilu.org#25917,"PADEMANGAN TIMUR, PADEMANGAN, JAKARTA UTARA, DKI JAKARTA",75,196,14,210
https://kawalpemilu.org#25917,"PADEMANGAN TIMUR, PADEMANGAN, JAKARTA UTARA, DKI JAKARTA",76,183,35,218
https://kawalpemilu.org#25917,"PADEMANGAN TIMUR, PADEMANGAN, JAKARTA UTARA, DKI JAKARTA",77,203,40,243
https://kawalpemilu.org#25917,"PADEMANGAN TIMUR, PADEMANGAN, JAKARTA UTARA, DKI JAKARTA",78,157,54,211
https://kawalpemilu.org#25917,"PADEMANGAN TIMUR, PADEMANGAN, JAKARTA UTARA, DKI JAKARTA",79,205,38,243
https://kawalpemilu.org#25917,"PADEMANGAN TIMUR, PADEMANGAN, JAKARTA UTARA, DKI JAKARTA",80,173,65,238
https://kawalpemilu.org#25917,"PADEMANGAN TIMUR, PADEMANGAN, JAKARTA UTARA, DKI JAKARTA",81,203,28,231
https://kawalpemilu.org#25917,"PADEMANGAN TIMUR, PADEMANGAN, JAKARTA UTARA, DKI JAKARTA",82,194,23,217
https://kawalpemilu.org#25917,"PADEMANGAN TIMUR, PADEMANGAN, JAKARTA UTARA, DKI JAKARTA",83,187,20,207
https://kawalpemilu.org#25917,"PADEMANGAN TIMUR, PADEMANGAN, JAKARTA UTARA, DKI JAKARTA",84,176,27,203
https://kawalpemilu.org#25917,"PADEMANGAN TIMUR, PADEMANGAN, JAKARTA UTARA, DKI JAKARTA",85,142,42,184
https://kawalpemilu.org#25917,"PADEMANGAN TIMUR, PADEMANGAN, JAKARTA UTARA, DKI JAKARTA",86,199,12,211
https://kawalpemilu.org#25917,"PADEMANGAN TIMUR, PADEMANGAN, JAKARTA UTARA, DKI JAKARTA",87,153,84,237
https://kawalpemilu.org#25917,"PADEMANGAN TIMUR, PADEMANGAN, JAKARTA UTARA, DKI JAKARTA",88,176,38,214
https://kawalpemilu.org#25917,"PADEMANGAN TIMUR, PADEMANGAN, JAKARTA UTARA, DKI JAKARTA",89,131,58,189
https://kawalpemilu.org#25917,"PADEMANGAN TIMUR, PADEMANGAN, JAKARTA UTARA, DKI JAKARTA",90,177,49,226
https://kawalpemilu.org#25917,"PADEMANGAN TIMUR, PADEMANGAN, JAKARTA UTARA, DKI JAKARTA",91,174,10,184
https://kawalpemilu.org#25917,"PADEMANGAN TIMUR, PADEMANGAN, JAKARTA UTARA, DKI JAKARTA",92,163,59,222
https://kawalpemilu.org#25917,"PADEMANGAN TIMUR, PADEMANGAN, JAKARTA UTARA, DKI JAKARTA",93,178,14,192
https://kawalpemilu.org#25917,"PADEMANGAN TIMUR, PADEMANGAN, JAKARTA UTARA, DKI JAKARTA",94,158,18,176
https://kawalpemilu.org#25917,"PADEMANGAN TIMUR, PADEMANGAN, JAKARTA UTARA, DKI JAKARTA",95,170,31,201
https://kawalpemilu.org#25917,"PADEMANGAN TIMUR, PADEMANGAN, JAKARTA UTARA, DKI JAKARTA",96,111,87,198
https://kawalpemilu.org#25917,"PADEMANGAN TIMUR, PADEMANGAN, JAKARTA UTARA, DKI JAKARTA",97,159,68,227
https://kawalpemilu.org#25917,"PADEMANGAN TIMUR, PADEMANGAN, JAKARTA UTARA, DKI JAKARTA",98,177,61,238
https://kawalpemilu.org#25917,"PADEMANGAN TIMUR, PADEMANGAN, JAKARTA UTARA, DKI JAKARTA",99,186,50,236
https://kawalpemilu.org#25917,"PADEMANGAN TIMUR, PADEMANGAN, JAKARTA UTARA, DKI JAKARTA",100,122,61,183
https://kawalpemilu.org#25917,"PADEMANGAN TIMUR, PADEMANGAN, JAKARTA UTARA, DKI JAKARTA",101,116,67,183
https://kawalpemilu.org#25917,"PADEMANGAN TIMUR, PADEMANGAN, JAKARTA UTARA, DKI JAKARTA",102,113,108,221
https://kawalpemilu.org#25917,"PADEMANGAN TIMUR, PADEMANGAN, JAKARTA UTARA, DKI JAKARTA",103,152,61,213
https://kawalpemilu.org#25917,"PADEMANGAN TIMUR, PADEMANGAN, JAKARTA UTARA, DKI JAKARTA",104,111,66,177
https://kawalpemilu.org#25917,"PADEMANGAN TIMUR, PADEMANGAN, JAKARTA UTARA, DKI JAKARTA",105,140,93,233
https://kawalpemilu.org#25917,"PADEMANGAN TIMUR, PADEMANGAN, JAKARTA UTARA, DKI JAKARTA",106,156,85,241
https://kawalpemilu.org#25917,"PADEMANGAN TIMUR, PADEMANGAN, JAKARTA UTARA, DKI JAKARTA",107,128,104,232
https://kawalpemilu.org#25917,"PADEMANGAN TIMUR, PADEMANGAN, JAKARTA UTARA, DKI JAKARTA",108,100,111,211
https://kawalpemilu.org#25917,"PADEMANGAN TIMUR, PADEMANGAN, JAKARTA UTARA, DKI JAKARTA",109,141,65,206
https://kawalpemilu.org#25917,"PADEMANGAN TIMUR, PADEMANGAN, JAKARTA UTARA, DKI JAKARTA",110,151,100,251
https://kawalpemilu.org#25917,"PADEMANGAN TIMUR, PADEMANGAN, JAKARTA UTARA, DKI JAKARTA",111,73,179,252
https://kawalpemilu.org#25917,"PADEMANGAN TIMUR, PADEMANGAN, JAKARTA UTARA, DKI JAKARTA",112,153,101,254
https://kawalpemilu.org#25917,"PADEMANGAN TIMUR, PADEMANGAN, JAKARTA UTARA, DKI JAKARTA",113,129,105,234
https://kawalpemilu.org#25917,"PADEMANGAN TIMUR, PADEMANGAN, JAKARTA UTARA, DKI JAKARTA",114,94,123,217
https://kawalpemilu.org#25917,"PADEMANGAN TIMUR, PADEMANGAN, JAKARTA UTARA, DKI JAKARTA",115,224,13,237
https://kawalpemilu.org#25917,"PADEMANGAN TIMUR, PADEMANGAN, JAKARTA UTARA, DKI JAKARTA",116,220,12,232
https://kawalpemilu.org#25917,"PADEMANGAN TIMUR, PADEMANGAN, JAKARTA UTARA, DKI JAKARTA",117,174,45,219
https://kawalpemilu.org#25917,"PADEMANGAN TIMUR, PADEMANGAN, JAKARTA UTARA, DKI JAKARTA",118,119,101,220
https://kawalpemilu.org#25917,"PADEMANGAN TIMUR, PADEMANGAN, JAKARTA UTARA, DKI JAKARTA",119,161,26,187
https://kawalpemilu.org#25917,"PADEMANGAN TIMUR, PADEMANGAN, JAKARTA UTARA, DKI JAKARTA",120,95,59,154
https://kawalpemilu.org#25917,"PADEMANGAN TIMUR, PADEMANGAN, JAKARTA UTARA, DKI JAKARTA",121,113,94,207
https://kawalpemilu.org#25917,"PADEMANGAN TIMUR, PADEMANGAN, JAKARTA UTARA, DKI JAKARTA",122,112,46,158
https://kawalpemilu.org#25918,"PADEMANGAN BARAT, PADEMANGAN, JAKARTA UTARA, DKI JAKARTA",1,152,72,224
https://kawalpemilu.org#25918,"PADEMANGAN BARAT, PADEMANGAN, JAKARTA UTARA, DKI JAKARTA",2,132,49,181
https://kawalpemilu.org#25918,"PADEMANGAN BARAT, PADEMANGAN, JAKARTA UTARA, DKI JAKARTA",3,183,42,225
https://kawalpemilu.org#25918,"PADEMANGAN BARAT, PADEMANGAN, JAKARTA UTARA, DKI JAKARTA",4,139,104,243
https://kawalpemilu.org#25918,"PADEMANGAN BARAT, PADEMANGAN, JAKARTA UTARA, DKI JAKARTA",5,150,59,209
https://kawalpemilu.org#25918,"PADEMANGAN BARAT, PADEMANGAN, JAKARTA UTARA, DKI JAKARTA",6,128,104,232
https://kawalpemilu.org#25918,"PADEMANGAN BARAT, PADEMANGAN, JAKARTA UTARA, DKI JAKARTA",7,156,85,241
https://kawalpemilu.org#25918,"PADEMANGAN BARAT, PADEMANGAN, JAKARTA UTARA, DKI JAKARTA",8,183,31,214
https://kawalpemilu.org#25918,"PADEMANGAN BARAT, PADEMANGAN, JAKARTA UTARA, DKI JAKARTA",9,126,71,197
https://kawalpemilu.org#25918,"PADEMANGAN BARAT, PADEMANGAN, JAKARTA UTARA, DKI JAKARTA",10,94,161,255
https://kawalpemilu.org#25918,"PADEMANGAN BARAT, PADEMANGAN, JAKARTA UTARA, DKI JAKARTA",11,117,113,230
https://kawalpemilu.org#25918,"PADEMANGAN BARAT, PADEMANGAN, JAKARTA UTARA, DKI JAKARTA",12,129,69,198
https://kawalpemilu.org#25918,"PADEMANGAN BARAT, PADEMANGAN, JAKARTA UTARA, DKI JAKARTA",13,81,52,133
https://kawalpemilu.org#25918,"PADEMANGAN BARAT, PADEMANGAN, JAKARTA UTARA, DKI JAKARTA",14,74,50,124
https://kawalpemilu.org#25918,"PADEMANGAN BARAT, PADEMANGAN, JAKARTA UTARA, DKI JAKARTA",15,123,49,172
https://kawalpemilu.org#25918,"PADEMANGAN BARAT, PADEMANGAN, JAKARTA UTARA, DKI JAKARTA",16,99,105,204
https://kawalpemilu.org#25918,"PADEMANGAN BARAT, PADEMANGAN, JAKARTA UTARA, DKI JAKARTA",17,129,84,213
https://kawalpemilu.org#25918,"PADEMANGAN BARAT, PADEMANGAN, JAKARTA UTARA, DKI JAKARTA",18,134,88,222
https://kawalpemilu.org#25918,"PADEMANGAN BARAT, PADEMANGAN, JAKARTA UTARA, DKI JAKARTA",19,96,126,222
https://kawalpemilu.org#25918,"PADEMANGAN BARAT, PADEMANGAN, JAKARTA UTARA, DKI JAKARTA",20,220,30,250
https://kawalpemilu.org#25918,"PADEMANGAN BARAT, PADEMANGAN, JAKARTA UTARA, DKI JAKARTA",21,229,2,231
https://kawalpemilu.org#25918,"PADEMANGAN BARAT, PADEMANGAN, JAKARTA UTARA, DKI JAKARTA",22,191,38,230
https://kawalpemilu.org#25918,"PADEMANGAN BARAT, PADEMANGAN, JAKARTA UTARA, DKI JAKARTA",23,169,44,213
https://kawalpemilu.org#25918,"PADEMANGAN BARAT, PADEMANGAN, JAKARTA UTARA, DKI JAKARTA",24,124,43,167
https://kawalpemilu.org#25918,"PADEMANGAN BARAT, PADEMANGAN, JAKARTA UTARA, DKI JAKARTA",25,143,100,243
https://kawalpemilu.org#25918,"PADEMANGAN BARAT, PADEMANGAN, JAKARTA UTARA, DKI JAKARTA",26,163,63,226
https://kawalpemilu.org#25918,"PADEMANGAN BARAT, PADEMANGAN, JAKARTA UTARA, DKI JAKARTA",27,153,90,243
https://kawalpemilu.org#25918,"PADEMANGAN BARAT, PADEMANGAN, JAKARTA UTARA, DKI JAKARTA",28,126,108,234
https://kawalpemilu.org#25918,"PADEMANGAN BARAT, PADEMANGAN, JAKARTA UTARA, DKI JAKARTA",29,163,67,230
https://kawalpemilu.org#25918,"PADEMANGAN BARAT, PADEMANGAN, JAKARTA UTARA, DKI JAKARTA",30,210,46,256
https://kawalpemilu.org#25918,"PADEMANGAN BARAT, PADEMANGAN, JAKARTA UTARA, DKI JAKARTA",31,186,39,225
https://kawalpemilu.org#25918,"PADEMANGAN BARAT, PADEMANGAN, JAKARTA UTARA, DKI JAKARTA",32,157,89,246
https://kawalpemilu.org#25918,"PADEMANGAN BARAT, PADEMANGAN, JAKARTA UTARA, DKI JAKARTA",33,156,75,231
https://kawalpemilu.org#25918,"PADEMANGAN BARAT, PADEMANGAN, JAKARTA UTARA, DKI JAKARTA",34,145,90,235
https://kawalpemilu.org#25918,"PADEMANGAN BARAT, PADEMANGAN, JAKARTA UTARA, DKI JAKARTA",35,107,65,172
https://kawalpemilu.org#25918,"PADEMANGAN BARAT, PADEMANGAN, JAKARTA UTARA, DKI JAKARTA",36,180,22,202
https://kawalpemilu.org#25918,"PADEMANGAN BARAT, PADEMANGAN, JAKARTA UTARA, DKI JAKARTA",37,167,50,217
https://kawalpemilu.org#25918,"PADEMANGAN BARAT, PADEMANGAN, JAKARTA UTARA, DKI JAKARTA",38,137,72,209
https://kawalpemilu.org#25918,"PADEMANGAN BARAT, PADEMANGAN, JAKARTA UTARA, DKI JAKARTA",39,142,64,206
https://kawalpemilu.org#25918,"PADEMANGAN BARAT, PADEMANGAN, JAKARTA UTARA, DKI JAKARTA",40,144,86,230
https://kawalpemilu.org#25918,"PADEMANGAN BARAT, PADEMANGAN, JAKARTA UTARA, DKI JAKARTA",41,117,82,199
https://kawalpemilu.org#25918,"PADEMANGAN BARAT, PADEMANGAN, JAKARTA UTARA, DKI JAKARTA",42,112,89,201
https://kawalpemilu.org#25918,"PADEMANGAN BARAT, PADEMANGAN, JAKARTA UTARA, DKI JAKARTA",43,162,67,229
https://kawalpemilu.org#25918,"PADEMANGAN BARAT, PADEMANGAN, JAKARTA UTARA, DKI JAKARTA",44,141,107,248
https://kawalpemilu.org#25918,"PADEMANGAN BARAT, PADEMANGAN, JAKARTA UTARA, DKI JAKARTA",45,105,121,226
https://kawalpemilu.org#25918,"PADEMANGAN BARAT, PADEMANGAN, JAKARTA UTARA, DKI JAKARTA",46,153,68,221
https://kawalpemilu.org#25918,"PADEMANGAN BARAT, PADEMANGAN, JAKARTA UTARA, DKI JAKARTA",47,161,64,225
https://kawalpemilu.org#25918,"PADEMANGAN BARAT, PADEMANGAN, JAKARTA UTARA, DKI JAKARTA",48,173,62,235
https://kawalpemilu.org#25918,"PADEMANGAN BARAT, PADEMANGAN, JAKARTA UTARA, DKI JAKARTA",49,145,70,215
https://kawalpemilu.org#25918,"PADEMANGAN BARAT, PADEMANGAN, JAKARTA UTARA, DKI JAKARTA",50,153,35,188
https://kawalpemilu.org#25918,"PADEMANGAN BARAT, PADEMANGAN, JAKARTA UTARA, DKI JAKARTA",51,108,88,196
https://kawalpemilu.org#25918,"PADEMANGAN BARAT, PADEMANGAN, JAKARTA UTARA, DKI JAKARTA",52,118,109,227
https://kawalpemilu.org#25918,"PADEMANGAN BARAT, PADEMANGAN, JAKARTA UTARA, DKI JAKARTA",53,138,86,224
https://kawalpemilu.org#25918,"PADEMANGAN BARAT, PADEMANGAN, JAKARTA UTARA, DKI JAKARTA",54,140,77,217
https://kawalpemilu.org#25918,"PADEMANGAN BARAT, PADEMANGAN, JAKARTA UTARA, DKI JAKARTA",55,125,72,197
https://kawalpemilu.org#25918,"PADEMANGAN BARAT, PADEMANGAN, JAKARTA UTARA, DKI JAKARTA",56,179,71,250
https://kawalpemilu.org#25918,"PADEMANGAN BARAT, PADEMANGAN, JAKARTA UTARA, DKI JAKARTA",57,174,76,250
https://kawalpemilu.org#25918,"PADEMANGAN BARAT, PADEMANGAN, JAKARTA UTARA, DKI JAKARTA",58,144,61,205
https://kawalpemilu.org#25918,"PADEMANGAN BARAT, PADEMANGAN, JAKARTA UTARA, DKI JAKARTA",59,173,76,249
https://kawalpemilu.org#25918,"PADEMANGAN BARAT, PADEMANGAN, JAKARTA UTARA, DKI JAKARTA",60,165,63,228
https://kawalpemilu.org#25918,"PADEMANGAN BARAT, PADEMANGAN, JAKARTA UTARA, DKI JAKARTA",61,279,61,240
https://kawalpemilu.org#25918,"PADEMANGAN BARAT, PADEMANGAN, JAKARTA UTARA, DKI JAKARTA",62,177,79,256
https://kawalpemilu.org#25918,"PADEMANGAN BARAT, PADEMANGAN, JAKARTA UTARA, DKI JAKARTA",63,135,85,220
https://kawalpemilu.org#25918,"PADEMANGAN BARAT, PADEMANGAN, JAKARTA UTARA, DKI JAKARTA",64,109,57,166
https://kawalpemilu.org#25918,"PADEMANGAN BARAT, PADEMANGAN, JAKARTA UTARA, DKI JAKARTA",65,164,31,195
https://kawalpemilu.org#25918,"PADEMANGAN BARAT, PADEMANGAN, JAKARTA UTARA, DKI JAKARTA",66,179,65,244
https://kawalpemilu.org#25918,"PADEMANGAN BARAT, PADEMANGAN, JAKARTA UTARA, DKI JAKARTA",67,184,45,229
https://kawalpemilu.org#25918,"PADEMANGAN BARAT, PADEMANGAN, JAKARTA UTARA, DKI JAKARTA",68,146,64,210
https://kawalpemilu.org#25918,"PADEMANGAN BARAT, PADEMANGAN, JAKARTA UTARA, DKI JAKARTA",69,152,86,238
https://kawalpemilu.org#25918,"PADEMANGAN BARAT, PADEMANGAN, JAKARTA UTARA, DKI JAKARTA",70,141,94,235
https://kawalpemilu.org#25918,"PADEMANGAN BARAT, PADEMANGAN, JAKARTA UTARA, DKI JAKARTA",71,136,113,249
https://kawalpemilu.org#25918,"PADEMANGAN BARAT, PADEMANGAN, JAKARTA UTARA, DKI JAKARTA",72,130,90,220
https://kawalpemilu.org#25918,"PADEMANGAN BARAT, PADEMANGAN, JAKARTA UTARA, DKI JAKARTA",73,136,126,262
https://kawalpemilu.org#25918,"PADEMANGAN BARAT, PADEMANGAN, JAKARTA UTARA, DKI JAKARTA",74,130,67,197
https://kawalpemilu.org#25918,"PADEMANGAN BARAT, PADEMANGAN, JAKARTA UTARA, DKI JAKARTA",75,160,79,239
https://kawalpemilu.org#25918,"PADEMANGAN BARAT, PADEMANGAN, JAKARTA UTARA, DKI JAKARTA",76,158,61,219
https://kawalpemilu.org#25918,"PADEMANGAN BARAT, PADEMANGAN, JAKARTA UTARA, DKI JAKARTA",77,125,79,204
https://kawalpemilu.org#25918,"PADEMANGAN BARAT, PADEMANGAN, JAKARTA UTARA, DKI JAKARTA",78,109,128,237
https://kawalpemilu.org#25918,"PADEMANGAN BARAT, PADEMANGAN, JAKARTA UTARA, DKI JAKARTA",79,119,109,228
https://kawalpemilu.org#25918,"PADEMANGAN BARAT, PADEMANGAN, JAKARTA UTARA, DKI JAKARTA",80,138,51,189
https://kawalpemilu.org#25918,"PADEMANGAN BARAT, PADEMANGAN, JAKARTA UTARA, DKI JAKARTA",81,100,83,183
https://kawalpemilu.org#25918,"PADEMANGAN BARAT, PADEMANGAN, JAKARTA UTARA, DKI JAKARTA",82,71,159,230
https://kawalpemilu.org#25918,"PADEMANGAN BARAT, PADEMANGAN, JAKARTA UTARA, DKI JAKARTA",83,82,97,179
https://kawalpemilu.org#25918,"PADEMANGAN BARAT, PADEMANGAN, JAKARTA UTARA, DKI JAKARTA",84,121,101,222
https://kawalpemilu.org#25918,"PADEMANGAN BARAT, PADEMANGAN, JAKARTA UTARA, DKI JAKARTA",85,108,143,251
https://kawalpemilu.org#25918,"PADEMANGAN BARAT, PADEMANGAN, JAKARTA UTARA, DKI JAKARTA",86,137,86,223
https://kawalpemilu.org#25918,"PADEMANGAN BARAT, PADEMANGAN, JAKARTA UTARA, DKI JAKARTA",87,140,77,217
https://kawalpemilu.org#25918,"PADEMANGAN BARAT, PADEMANGAN, JAKARTA UTARA, DKI JAKARTA",88,157,68,225
https://kawalpemilu.org#25918,"PADEMANGAN BARAT, PADEMANGAN, JAKARTA UTARA, DKI JAKARTA",89,129,91,220
https://kawalpemilu.org#25918,"PADEMANGAN BARAT, PADEMANGAN, JAKARTA UTARA, DKI JAKARTA",90,204,42,246
https://kawalpemilu.org#25918,"PADEMANGAN BARAT, PADEMANGAN, JAKARTA UTARA, DKI JAKARTA",91,158,51,209
https://kawalpemilu.org#25918,"PADEMANGAN BARAT, PADEMANGAN, JAKARTA UTARA, DKI JAKARTA",92,148,59,207
https://kawalpemilu.org#25918,"PADEMANGAN BARAT, PADEMANGAN, JAKARTA UTARA, DKI JAKARTA",93,147,90,237
https://kawalpemilu.org#25918,"PADEMANGAN BARAT, PADEMANGAN, JAKARTA UTARA, DKI JAKARTA",94,148,75,223
https://kawalpemilu.org#25918,"PADEMANGAN BARAT, PADEMANGAN, JAKARTA UTARA, DKI JAKARTA",95,118,114,232
https://kawalpemilu.org#25918,"PADEMANGAN BARAT, PADEMANGAN, JAKARTA UTARA, DKI JAKARTA",96,114,93,207
https://kawalpemilu.org#25918,"PADEMANGAN BARAT, PADEMANGAN, JAKARTA UTARA, DKI JAKARTA",97,94,137,231
https://kawalpemilu.org#25918,"PADEMANGAN BARAT, PADEMANGAN, JAKARTA UTARA, DKI JAKARTA",98,177,61,238
https://kawalpemilu.org#25918,"PADEMANGAN BARAT, PADEMANGAN, JAKARTA UTARA, DKI JAKARTA",99,203,39,242
https://kawalpemilu.org#25918,"PADEMANGAN BARAT, PADEMANGAN, JAKARTA UTARA, DKI JAKARTA",100,208,34,242
https://kawalpemilu.org#25918,"PADEMANGAN BARAT, PADEMANGAN, JAKARTA UTARA, DKI JAKARTA",101,155,40,195
https://kawalpemilu.org#25918,"PADEMANGAN BARAT, PADEMANGAN, JAKARTA UTARA, DKI JAKARTA",102,184,90,274
https://kawalpemilu.org#25918,"PADEMANGAN BARAT, PADEMANGAN, JAKARTA UTARA, DKI JAKARTA",103,156,63,219
https://kawalpemilu.org#25918,"PADEMANGAN BARAT, PADEMANGAN, JAKARTA UTARA, DKI JAKARTA",104,134,99,233
https://kawalpemilu.org#25918,"PADEMANGAN BARAT, PADEMANGAN, JAKARTA UTARA, DKI JAKARTA",105,167,77,244
https://kawalpemilu.org#25918,"PADEMANGAN BARAT, PADEMANGAN, JAKARTA UTARA, DKI JAKARTA",106,138,94,232
https://kawalpemilu.org#25918,"PADEMANGAN BARAT, PADEMANGAN, JAKARTA UTARA, DKI JAKARTA",107,135,83,218
https://kawalpemilu.org#25918,"PADEMANGAN BARAT, PADEMANGAN, JAKARTA UTARA, DKI JAKARTA",108,149,59,205
https://kawalpemilu.org#25918,"PADEMANGAN BARAT, PADEMANGAN, JAKARTA UTARA, DKI JAKARTA",109,144,88,232
https://kawalpemilu.org#25918,"PADEMANGAN BARAT, PADEMANGAN, JAKARTA UTARA, DKI JAKARTA",110,132,89,221
https://kawalpemilu.org#25918,"PADEMANGAN BARAT, PADEMANGAN, JAKARTA UTARA, DKI JAKARTA",111,154,76,230
https://kawalpemilu.org#25918,"PADEMANGAN BARAT, PADEMANGAN, JAKARTA UTARA, DKI JAKARTA",112,118,59,177
https://kawalpemilu.org#25918,"PADEMANGAN BARAT, PADEMANGAN, JAKARTA UTARA, DKI JAKARTA",113,121,99,220
https://kawalpemilu.org#25918,"PADEMANGAN BARAT, PADEMANGAN, JAKARTA UTARA, DKI JAKARTA",114,131,83,214
https://kawalpemilu.org#25918,"PADEMANGAN BARAT, PADEMANGAN, JAKARTA UTARA, DKI JAKARTA",115,127,77,204
https://kawalpemilu.org#25918,"PADEMANGAN BARAT, PADEMANGAN, JAKARTA UTARA, DKI JAKARTA",116,111,116,227
https://kawalpemilu.org#25918,"PADEMANGAN BARAT, PADEMANGAN, JAKARTA UTARA, DKI JAKARTA",117,132,107,239
https://kawalpemilu.org#25918,"PADEMANGAN BARAT, PADEMANGAN, JAKARTA UTARA, DKI JAKARTA",118,130,92,222
https://kawalpemilu.org#25918,"PADEMANGAN BARAT, PADEMANGAN, JAKARTA UTARA, DKI JAKARTA",119,123,91,214
https://kawalpemilu.org#25918,"PADEMANGAN BARAT, PADEMANGAN, JAKARTA UTARA, DKI JAKARTA",120,108,123,231
https://kawalpemilu.org#25918,"PADEMANGAN BARAT, PADEMANGAN, JAKARTA UTARA, DKI JAKARTA",121,133,83,216
https://kawalpemilu.org#25918,"PADEMANGAN BARAT, PADEMANGAN, JAKARTA UTARA, DKI JAKARTA",122,142,97,239
https://kawalpemilu.org#25918,"PADEMANGAN BARAT, PADEMANGAN, JAKARTA UTARA, DKI JAKARTA",123,164,90,254
https://kawalpemilu.org#25918,"PADEMANGAN BARAT, PADEMANGAN, JAKARTA UTARA, DKI JAKARTA",124,139,87,226
https://kawalpemilu.org#25918,"PADEMANGAN BARAT, PADEMANGAN, JAKARTA UTARA, DKI JAKARTA",125,97,113,210
https://kawalpemilu.org#25918,"PADEMANGAN BARAT, PADEMANGAN, JAKARTA UTARA, DKI JAKARTA",126,138,93,231
https://kawalpemilu.org#25918,"PADEMANGAN BARAT, PADEMANGAN, JAKARTA UTARA, DKI JAKARTA",127,124,101,225
https://kawalpemilu.org#25918,"PADEMANGAN BARAT, PADEMANGAN, JAKARTA UTARA, DKI JAKARTA",128,134,85,219
https://kawalpemilu.org#25918,"PADEMANGAN BARAT, PADEMANGAN, JAKARTA UTARA, DKI JAKARTA",129,150,90,240
https://kawalpemilu.org#25918,"PADEMANGAN BARAT, PADEMANGAN, JAKARTA UTARA, DKI JAKARTA",130,130,118,248
https://kawalpemilu.org#25918,"PADEMANGAN BARAT, PADEMANGAN, JAKARTA UTARA, DKI JAKARTA",131,98,141,239
https://kawalpemilu.org#25918,"PADEMANGAN BARAT, PADEMANGAN, JAKARTA UTARA, DKI JAKARTA",132,119,114,233
https://kawalpemilu.org#25918,"PADEMANGAN BARAT, PADEMANGAN, JAKARTA UTARA, DKI JAKARTA",133,140,105,245
https://kawalpemilu.org#25918,"PADEMANGAN BARAT, PADEMANGAN, JAKARTA UTARA, DKI JAKARTA",134,109,87,196
https://kawalpemilu.org#25918,"PADEMANGAN BARAT, PADEMANGAN, JAKARTA UTARA, DKI JAKARTA",135,163,90,253
https://kawalpemilu.org#25918,"PADEMANGAN BARAT, PADEMANGAN, JAKARTA UTARA, DKI JAKARTA",136,167,72,239
https://kawalpemilu.org#25918,"PADEMANGAN BARAT, PADEMANGAN, JAKARTA UTARA, DKI JAKARTA",137,149,71,220
https://kawalpemilu.org#25918,"PADEMANGAN BARAT, PADEMANGAN, JAKARTA UTARA, DKI JAKARTA",139,111,92,203
https://kawalpemilu.org#25918,"PADEMANGAN BARAT, PADEMANGAN, JAKARTA UTARA, DKI JAKARTA",140,107,73,180
https://kawalpemilu.org#25918,"PADEMANGAN BARAT, PADEMANGAN, JAKARTA UTARA, DKI JAKARTA",141,129,113,242
https://kawalpemilu.org#25918,"PADEMANGAN BARAT, PADEMANGAN, JAKARTA UTARA, DKI JAKARTA",142,94,88,182
https://kawalpemilu.org#25918,"PADEMANGAN BARAT, PADEMANGAN, JAKARTA UTARA, DKI JAKARTA",143,110,107,217
https://kawalpemilu.org#25918,"PADEMANGAN BARAT, PADEMANGAN, JAKARTA UTARA, DKI JAKARTA",144,108,88,196
https://kawalpemilu.org#25918,"PADEMANGAN BARAT, PADEMANGAN, JAKARTA UTARA, DKI JAKARTA",145,100,85,185
https://kawalpemilu.org#25918,"PADEMANGAN BARAT, PADEMANGAN, JAKARTA UTARA, DKI JAKARTA",146,133,123,256
https://kawalpemilu.org#25918,"PADEMANGAN BARAT, PADEMANGAN, JAKARTA UTARA, DKI JAKARTA",147,113,114,227
https://kawalpemilu.org#25918,"PADEMANGAN BARAT, PADEMANGAN, JAKARTA UTARA, DKI JAKARTA",148,131,109,240
https://kawalpemilu.org#25918,"PADEMANGAN BARAT, PADEMANGAN, JAKARTA UTARA, DKI JAKARTA",149,106,112,218
https://kawalpemilu.org#25918,"PADEMANGAN BARAT, PADEMANGAN, JAKARTA UTARA, DKI JAKARTA",150,123,122,0
https://kawalpemilu.org#25918,"PADEMANGAN BARAT, PADEMANGAN, JAKARTA UTARA, DKI JAKARTA",151,133,86,219
https://kawalpemilu.org#25918,"PADEMANGAN BARAT, PADEMANGAN, JAKARTA UTARA, DKI JAKARTA",152,108,123,231
https://kawalpemilu.org#25918,"PADEMANGAN BARAT, PADEMANGAN, JAKARTA UTARA, DKI JAKARTA",153,75,118,193
https://kawalpemilu.org#25918,"PADEMANGAN BARAT, PADEMANGAN, JAKARTA UTARA, DKI JAKARTA",154,124,84,208
https://kawalpemilu.org#25918,"PADEMANGAN BARAT, PADEMANGAN, JAKARTA UTARA, DKI JAKARTA",155,128,90,218
https://kawalpemilu.org#25918,"PADEMANGAN BARAT, PADEMANGAN, JAKARTA UTARA, DKI JAKARTA",156,121,84,205
https://kawalpemilu.org#25918,"PADEMANGAN BARAT, PADEMANGAN, JAKARTA UTARA, DKI JAKARTA",157,132,47,179
https://kawalpemilu.org#25918,"PADEMANGAN BARAT, PADEMANGAN, JAKARTA UTARA, DKI JAKARTA",158,0,0,0
https://kawalpemilu.org#25918,"PADEMANGAN BARAT, PADEMANGAN, JAKARTA UTARA, DKI JAKARTA",159,122,79,212
https://kawalpemilu.org#25918,"PADEMANGAN BARAT, PADEMANGAN, JAKARTA UTARA, DKI JAKARTA",160,104,78,182
https://kawalpemilu.org#25918,"PADEMANGAN BARAT, PADEMANGAN, JAKARTA UTARA, DKI JAKARTA",161,92,150,242
https://kawalpemilu.org#25918,"PADEMANGAN BARAT, PADEMANGAN, JAKARTA UTARA, DKI JAKARTA",162,95,139,234
https://kawalpemilu.org#25918,"PADEMANGAN BARAT, PADEMANGAN, JAKARTA UTARA, DKI JAKARTA",163,122,127,249
https://kawalpemilu.org#25918,"PADEMANGAN BARAT, PADEMANGAN, JAKARTA UTARA, DKI JAKARTA",164,120,117,237
https://kawalpemilu.org#25918,"PADEMANGAN BARAT, PADEMANGAN, JAKARTA UTARA, DKI JAKARTA",165,113,131,244
https://kawalpemilu.org#25918,"PADEMANGAN BARAT, PADEMANGAN, JAKARTA UTARA, DKI JAKARTA",166,125,118,243
https://kawalpemilu.org#25918,"PADEMANGAN BARAT, PADEMANGAN, JAKARTA UTARA, DKI JAKARTA",167,138,106,244
https://kawalpemilu.org#25918,"PADEMANGAN BARAT, PADEMANGAN, JAKARTA UTARA, DKI JAKARTA",168,141,120,261
https://kawalpemilu.org#25918,"PADEMANGAN BARAT, PADEMANGAN, JAKARTA UTARA, DKI JAKARTA",169,122,104,226
https://kawalpemilu.org#25918,"PADEMANGAN BARAT, PADEMANGAN, JAKARTA UTARA, DKI JAKARTA",170,133,107,240
https://kawalpemilu.org#25918,"PADEMANGAN BARAT, PADEMANGAN, JAKARTA UTARA, DKI JAKARTA",171,121,98,219
https://kawalpemilu.org#25918,"PADEMANGAN BARAT, PADEMANGAN, JAKARTA UTARA, DKI JAKARTA",172,125,127,252
https://kawalpemilu.org#25918,"PADEMANGAN BARAT, PADEMANGAN, JAKARTA UTARA, DKI JAKARTA",173,105,87,192
https://kawalpemilu.org#25918,"PADEMANGAN BARAT, PADEMANGAN, JAKARTA UTARA, DKI JAKARTA",174,111,120,231
https://kawalpemilu.org#25918,"PADEMANGAN BARAT, PADEMANGAN, JAKARTA UTARA, DKI JAKARTA",175,151,96,247
https://kawalpemilu.org#25918,"PADEMANGAN BARAT, PADEMANGAN, JAKARTA UTARA, DKI JAKARTA",176,149,87,236
https://kawalpemilu.org#25918,"PADEMANGAN BARAT, PADEMANGAN, JAKARTA UTARA, DKI JAKARTA",177,169,55,224
https://kawalpemilu.org#25918,"PADEMANGAN BARAT, PADEMANGAN, JAKARTA UTARA, DKI JAKARTA",178,142,54,196
https://kawalpemilu.org#25918,"PADEMANGAN BARAT, PADEMANGAN, JAKARTA UTARA, DKI JAKARTA",179,128,70,198
https://kawalpemilu.org#25918,"PADEMANGAN BARAT, PADEMANGAN, JAKARTA UTARA, DKI JAKARTA",180,109,109,218
https://kawalpemilu.org#25918,"PADEMANGAN BARAT, PADEMANGAN, JAKARTA UTARA, DKI JAKARTA",181,107,108,215
https://kawalpemilu.org#25918,"PADEMANGAN BARAT, PADEMANGAN, JAKARTA UTARA, DKI JAKARTA",182,91,101,192
https://kawalpemilu.org#25918,"PADEMANGAN BARAT, PADEMANGAN, JAKARTA UTARA, DKI JAKARTA",183,116,121,237
https://kawalpemilu.org#25918,"PADEMANGAN BARAT, PADEMANGAN, JAKARTA UTARA, DKI JAKARTA",184,156,99,255
https://kawalpemilu.org#25918,"PADEMANGAN BARAT, PADEMANGAN, JAKARTA UTARA, DKI JAKARTA",185,156,94,250
https://kawalpemilu.org#25918,"PADEMANGAN BARAT, PADEMANGAN, JAKARTA UTARA, DKI JAKARTA",186,126,97,223
https://kawalpemilu.org#25918,"PADEMANGAN BARAT, PADEMANGAN, JAKARTA UTARA, DKI JAKARTA",187,113,157,270
https://kawalpemilu.org#25918,"PADEMANGAN BARAT, PADEMANGAN, JAKARTA UTARA, DKI JAKARTA",188,89,168,257
https://kawalpemilu.org#25918,"PADEMANGAN BARAT, PADEMANGAN, JAKARTA UTARA, DKI JAKARTA",189,124,139,263
https://kawalpemilu.org#25918,"PADEMANGAN BARAT, PADEMANGAN, JAKARTA UTARA, DKI JAKARTA",190,94,136,230
https://kawalpemilu.org#25918,"PADEMANGAN BARAT, PADEMANGAN, JAKARTA UTARA, DKI JAKARTA",191,110,132,242
https://kawalpemilu.org#25918,"PADEMANGAN BARAT, PADEMANGAN, JAKARTA UTARA, DKI JAKARTA",192,108,108,216
https://kawalpemilu.org#25918,"PADEMANGAN BARAT, PADEMANGAN, JAKARTA UTARA, DKI JAKARTA",193,115,124,239
https://kawalpemilu.org#25918,"PADEMANGAN BARAT, PADEMANGAN, JAKARTA UTARA, DKI JAKARTA",194,91,160,251
https://kawalpemilu.org#25918,"PADEMANGAN BARAT, PADEMANGAN, JAKARTA UTARA, DKI JAKARTA",195,116,133,249
https://kawalpemilu.org#25918,"PADEMANGAN BARAT, PADEMANGAN, JAKARTA UTARA, DKI JAKARTA",196,97,149,246
https://kawalpemilu.org#25918,"PADEMANGAN BARAT, PADEMANGAN, JAKARTA UTARA, DKI JAKARTA",197,128,106,234
https://kawalpemilu.org#25918,"PADEMANGAN BARAT, PADEMANGAN, JAKARTA UTARA, DKI JAKARTA",198,88,151,239
https://kawalpemilu.org#25918,"PADEMANGAN BARAT, PADEMANGAN, JAKARTA UTARA, DKI JAKARTA",199,133,100,233
https://kawalpemilu.org#25918,"PADEMANGAN BARAT, PADEMANGAN, JAKARTA UTARA, DKI JAKARTA",200,133,101,234
https://kawalpemilu.org#25918,"PADEMANGAN BARAT, PADEMANGAN, JAKARTA UTARA, DKI JAKARTA",201,118,121,239
https://kawalpemilu.org#25918,"PADEMANGAN BARAT, PADEMANGAN, JAKARTA UTARA, DKI JAKARTA",202,102,151,253
https://kawalpemilu.org#25918,"PADEMANGAN BARAT, PADEMANGAN, JAKARTA UTARA, DKI JAKARTA",203,120,98,218
https://kawalpemilu.org#25918,"PADEMANGAN BARAT, PADEMANGAN, JAKARTA UTARA, DKI JAKARTA",204,90,131,221
https://kawalpemilu.org#25918,"PADEMANGAN BARAT, PADEMANGAN, JAKARTA UTARA, DKI JAKARTA",205,128,147,275
https://kawalpemilu.org#25918,"PADEMANGAN BARAT, PADEMANGAN, JAKARTA UTARA, DKI JAKARTA",206,138,118,256
https://kawalpemilu.org#25918,"PADEMANGAN BARAT, PADEMANGAN, JAKARTA UTARA, DKI JAKARTA",207,125,128,253
https://kawalpemilu.org#25918,"PADEMANGAN BARAT, PADEMANGAN, JAKARTA UTARA, DKI JAKARTA",208,110,153,263
https://kawalpemilu.org#25918,"PADEMANGAN BARAT, PADEMANGAN, JAKARTA UTARA, DKI JAKARTA",209,123,142,265
https://kawalpemilu.org#25918,"PADEMANGAN BARAT, PADEMANGAN, JAKARTA UTARA, DKI JAKARTA",210,137,81,218
https://kawalpemilu.org#25918,"PADEMANGAN BARAT, PADEMANGAN, JAKARTA UTARA, DKI JAKARTA",211,165,115,280
https://kawalpemilu.org#25918,"PADEMANGAN BARAT, PADEMANGAN, JAKARTA UTARA, DKI JAKARTA",212,134,90,224
https://kawalpemilu.org#25918,"PADEMANGAN BARAT, PADEMANGAN, JAKARTA UTARA, DKI JAKARTA",213,110,80,190
https://kawalpemilu.org#25918,"PADEMANGAN BARAT, PADEMANGAN, JAKARTA UTARA, DKI JAKARTA",214,130,83,213
https://kawalpemilu.org#25918,"PADEMANGAN BARAT, PADEMANGAN, JAKARTA UTARA, DKI JAKARTA",215,125,129,254
https://kawalpemilu.org#25918,"PADEMANGAN BARAT, PADEMANGAN, JAKARTA UTARA, DKI JAKARTA",216,171,111,282
https://kawalpemilu.org#25918,"PADEMANGAN BARAT, PADEMANGAN, JAKARTA UTARA, DKI JAKARTA",217,142,11,153
https://kawalpemilu.org#25918,"PADEMANGAN BARAT, PADEMANGAN, JAKARTA UTARA, DKI JAKARTA",218,149,75,224
https://kawalpemilu.org#25918,"PADEMANGAN BARAT, PADEMANGAN, JAKARTA UTARA, DKI JAKARTA",219,73,54,127
https://kawalpemilu.org#25918,"PADEMANGAN BARAT, PADEMANGAN, JAKARTA UTARA, DKI JAKARTA",220,144,81,225
https://kawalpemilu.org#25918,"PADEMANGAN BARAT, PADEMANGAN, JAKARTA UTARA, DKI JAKARTA",221,127,94,221
https://kawalpemilu.org#25918,"PADEMANGAN BARAT, PADEMANGAN, JAKARTA UTARA, DKI JAKARTA",222,141,92,233
https://kawalpemilu.org#25918,"PADEMANGAN BARAT, PADEMANGAN, JAKARTA UTARA, DKI JAKARTA",223,109,68,177
https://kawalpemilu.org#25918,"PADEMANGAN BARAT, PADEMANGAN, JAKARTA UTARA, DKI JAKARTA",224,123,110,233
https://kawalpemilu.org#25918,"PADEMANGAN BARAT, PADEMANGAN, JAKARTA UTARA, DKI JAKARTA",225,101,85,186
https://kawalpemilu.org#25918,"PADEMANGAN BARAT, PADEMANGAN, JAKARTA UTARA, DKI JAKARTA",226,98,95,193
https://kawalpemilu.org#25919,"ANCOL, PADEMANGAN, JAKARTA UTARA, DKI JAKARTA",1,86,158,244
https://kawalpemilu.org#25919,"ANCOL, PADEMANGAN, JAKARTA UTARA, DKI JAKARTA",2,104,113,217
https://kawalpemilu.org#25919,"ANCOL, PADEMANGAN, JAKARTA UTARA, DKI JAKARTA",3,104,126,230
https://kawalpemilu.org#25919,"ANCOL, PADEMANGAN, JAKARTA UTARA, DKI JAKARTA",4,115,136,251
https://kawalpemilu.org#25919,"ANCOL, PADEMANGAN, JAKARTA UTARA, DKI JAKARTA",5,80,81,161
https://kawalpemilu.org#25919,"ANCOL, PADEMANGAN, JAKARTA UTARA, DKI JAKARTA",6,79,106,185
https://kawalpemilu.org#25919,"ANCOL, PADEMANGAN, JAKARTA UTARA, DKI JAKARTA",7,67,104,171
https://kawalpemilu.org#25919,"ANCOL, PADEMANGAN, JAKARTA UTARA, DKI JAKARTA",8,71,60,131
https://kawalpemilu.org#25919,"ANCOL, PADEMANGAN, JAKARTA UTARA, DKI JAKARTA",9,120,127,247
https://kawalpemilu.org#25919,"ANCOL, PADEMANGAN, JAKARTA UTARA, DKI JAKARTA",10,73,125,198
https://kawalpemilu.org#25919,"ANCOL, PADEMANGAN, JAKARTA UTARA, DKI JAKARTA",11,84,103,187
https://kawalpemilu.org#25919,"ANCOL, PADEMANGAN, JAKARTA UTARA, DKI JAKARTA",12,97,123,220
https://kawalpemilu.org#25919,"ANCOL, PADEMANGAN, JAKARTA UTARA, DKI JAKARTA",13,204,34,238
https://kawalpemilu.org#25919,"ANCOL, PADEMANGAN, JAKARTA UTARA, DKI JAKARTA",14,97,83,180
https://kawalpemilu.org#25919,"ANCOL, PADEMANGAN, JAKARTA UTARA, DKI JAKARTA",15,107,34,141
https://kawalpemilu.org#25919,"ANCOL, PADEMANGAN, JAKARTA UTARA, DKI JAKARTA",16,119,135,254
https://kawalpemilu.org#25919,"ANCOL, PADEMANGAN, JAKARTA UTARA, DKI JAKARTA",17,93,155,248
https://kawalpemilu.org#25919,"ANCOL, PADEMANGAN, JAKARTA UTARA, DKI JAKARTA",18,112,128,240
https://kawalpemilu.org#25919,"ANCOL, PADEMANGAN, JAKARTA UTARA, DKI JAKARTA",19,98,117,215
https://kawalpemilu.org#25919,"ANCOL, PADEMANGAN, JAKARTA UTARA, DKI JAKARTA",20,112,101,213
https://kawalpemilu.org#25919,"ANCOL, PADEMANGAN, JAKARTA UTARA, DKI JAKARTA",21,79,149,228
https://kawalpemilu.org#25919,"ANCOL, PADEMANGAN, JAKARTA UTARA, DKI JAKARTA",22,90,99,189
https://kawalpemilu.org#25919,"ANCOL, PADEMANGAN, JAKARTA UTARA, DKI JAKARTA",23,121,129,250
https://kawalpemilu.org#25919,"ANCOL, PADEMANGAN, JAKARTA UTARA, DKI JAKARTA",24,113,111,224
https://kawalpemilu.org#25919,"ANCOL, PADEMANGAN, JAKARTA UTARA, DKI JAKARTA",25,116,115,231
https://kawalpemilu.org#25919,"ANCOL, PADEMANGAN, JAKARTA UTARA, DKI JAKARTA",26,112,123,235
https://kawalpemilu.org#25919,"ANCOL, PADEMANGAN, JAKARTA UTARA, DKI JAKARTA",27,105,98,203
https://kawalpemilu.org#25919,"ANCOL, PADEMANGAN, JAKARTA UTARA, DKI JAKARTA",28,84,111,195
https://kawalpemilu.org#25919,"ANCOL, PADEMANGAN, JAKARTA UTARA, DKI JAKARTA",29,90,107,197
https://kawalpemilu.org#25919,"ANCOL, PADEMANGAN, JAKARTA UTARA, DKI JAKARTA",30,96,126,222
https://kawalpemilu.org#25919,"ANCOL, PADEMANGAN, JAKARTA UTARA, DKI JAKARTA",31,99,126,225
https://kawalpemilu.org#25919,"ANCOL, PADEMANGAN, JAKARTA UTARA, DKI JAKARTA",32,84,97,181
https://kawalpemilu.org#25919,"ANCOL, PADEMANGAN, JAKARTA UTARA, DKI JAKARTA",33,77,118,195
https://kawalpemilu.org#25919,"ANCOL, PADEMANGAN, JAKARTA UTARA, DKI JAKARTA",34,89,99,188
https://kawalpemilu.org#25919,"ANCOL, PADEMANGAN, JAKARTA UTARA, DKI JAKARTA",35,98,95,193
https://kawalpemilu.org#25919,"ANCOL, PADEMANGAN, JAKARTA UTARA, DKI JAKARTA",36,119,78,197
https://kawalpemilu.org#25919,"ANCOL, PADEMANGAN, JAKARTA UTARA, DKI JAKARTA",37,58,146,204
https://kawalpemilu.org#25919,"ANCOL, PADEMANGAN, JAKARTA UTARA, DKI JAKARTA",38,83,87,170
https://kawalpemilu.org#25919,"ANCOL, PADEMANGAN, JAKARTA UTARA, DKI JAKARTA",39,67,90,157
https://kawalpemilu.org#25919,"ANCOL, PADEMANGAN, JAKARTA UTARA, DKI JAKARTA",40,74,107,181
https://kawalpemilu.org#25919,"ANCOL, PADEMANGAN, JAKARTA UTARA, DKI JAKARTA",41,117,83,200
https://kawalpemilu.org#25919,"ANCOL, PADEMANGAN, JAKARTA UTARA, DKI JAKARTA",43,93,78,171
https://kawalpemilu.org#25919,"ANCOL, PADEMANGAN, JAKARTA UTARA, DKI JAKARTA",45,74,52,126
https://kawalpemilu.org#25919,"ANCOL, PADEMANGAN, JAKARTA UTARA, DKI JAKARTA",46,65,68,133
https://kawalpemilu.org#25919,"ANCOL, PADEMANGAN, JAKARTA UTARA, DKI JAKARTA",47,51,47,98
https://kawalpemilu.org#25919,"ANCOL, PADEMANGAN, JAKARTA UTARA, DKI JAKARTA",48,88,107,195
https://kawalpemilu.org#25919,"ANCOL, PADEMANGAN, JAKARTA UTARA, DKI JAKARTA",49,100,126,226
https://kawalpemilu.org#25919,"ANCOL, PADEMANGAN, JAKARTA UTARA, DKI JAKARTA",50,82,156,238
https://kawalpemilu.org#25919,"ANCOL, PADEMANGAN, JAKARTA UTARA, DKI JAKARTA",51,34,168,202
https://kawalpemilu.org#25919,"ANCOL, PADEMANGAN, JAKARTA UTARA, DKI JAKARTA",52,52,185,237
https://kawalpemilu.org#25919,"ANCOL, PADEMANGAN, JAKARTA UTARA, DKI JAKARTA",53,52,179,231
https://kawalpemilu.org#25919,"ANCOL, PADEMANGAN, JAKARTA UTARA, DKI JAKARTA",54,64,182,246
https://kawalpemilu.org#25919,"ANCOL, PADEMANGAN, JAKARTA UTARA, DKI JAKARTA",55,80,131,211
https://kawalpemilu.org#25919,"ANCOL, PADEMANGAN, JAKARTA UTARA, DKI JAKARTA",56,72,151,223
https://kawalpemilu.org#25919,"ANCOL, PADEMANGAN, JAKARTA UTARA, DKI JAKARTA",57,75,148,223
https://kawalpemilu.org#25919,"ANCOL, PADEMANGAN, JAKARTA UTARA, DKI JAKARTA",58,60,91,151
https://kawalpemilu.org#25919,"ANCOL, PADEMANGAN, JAKARTA UTARA, DKI JAKARTA",59,60,65,125
https://kawalpemilu.org#25919,"ANCOL, PADEMANGAN, JAKARTA UTARA, DKI JAKARTA",60,209,14,2
https://kawalpemilu.org#25919,"ANCOL, PADEMANGAN, JAKARTA UTARA, DKI JAKARTA",61,206,5,211
https://kawalpemilu.org#25919,"ANCOL, PADEMANGAN, JAKARTA UTARA, DKI JAKARTA",62,224,11,235
https://kawalpemilu.org#25919,"ANCOL, PADEMANGAN, JAKARTA UTARA, DKI JAKARTA",63,234,13,247
https://kawalpemilu.org#25919,"ANCOL, PADEMANGAN, JAKARTA UTARA, DKI JAKARTA",64,223,21,244
https://kawalpemilu.org#25919,"ANCOL, PADEMANGAN, JAKARTA UTARA, DKI JAKARTA",65,189,8,197
https://kawalpemilu.org#25919,"ANCOL, PADEMANGAN, JAKARTA UTARA, DKI JAKARTA",66,204,14,218
https://kawalpemilu.org#25919,"ANCOL, PADEMANGAN, JAKARTA UTARA, DKI JAKARTA",67,158,20,178
https://kawalpemilu.org#25919,"ANCOL, PADEMANGAN, JAKARTA UTARA, DKI JAKARTA",68,160,3,163
https://kawalpemilu.org#25919,"ANCOL, PADEMANGAN, JAKARTA UTARA, DKI JAKARTA",69,175,10,185
https://kawalpemilu.org#25919,"ANCOL, PADEMANGAN, JAKARTA UTARA, DKI JAKARTA",70,186,14,200
https://kawalpemilu.org#25919,"ANCOL, PADEMANGAN, JAKARTA UTARA, DKI JAKARTA",71,228,12,240
https://kawalpemilu.org#25919,"ANCOL, PADEMANGAN, JAKARTA UTARA, DKI JAKARTA",72,99,120,219
https://kawalpemilu.org#25919,"ANCOL, PADEMANGAN, JAKARTA UTARA, DKI JAKARTA",73,70,74,144
https://kawalpemilu.org#25919,"ANCOL, PADEMANGAN, JAKARTA UTARA, DKI JAKARTA",74,115,91,207
https://kawalpemilu.org#25919,"ANCOL, PADEMANGAN, JAKARTA UTARA, DKI JAKARTA",75,93,89,182
https://kawalpemilu.org#25919,"ANCOL, PADEMANGAN, JAKARTA UTARA, DKI JAKARTA",76,55,98,153
https://kawalpemilu.org#25919,"ANCOL, PADEMANGAN, JAKARTA UTARA, DKI JAKARTA",77,67,69,136
https://kawalpemilu.org#25919,"ANCOL, PADEMANGAN, JAKARTA UTARA, DKI JAKARTA",78,61,110,171
https://kawalpemilu.org#25921,"KELAPA GADING TIMUR, KELAPA GADING, JAKARTA UTARA, DKI JAKARTA",1,209,7,216
https://kawalpemilu.org#25921,"KELAPA GADING TIMUR, KELAPA GADING, JAKARTA UTARA, DKI JAKARTA",2,224,13,237
https://kawalpemilu.org#25921,"KELAPA GADING TIMUR, KELAPA GADING, JAKARTA UTARA, DKI JAKARTA",3,196,17,213
https://kawalpemilu.org#25921,"KELAPA GADING TIMUR, KELAPA GADING, JAKARTA UTARA, DKI JAKARTA",4,182,12,194
https://kawalpemilu.org#25921,"KELAPA GADING TIMUR, KELAPA GADING, JAKARTA UTARA, DKI JAKARTA",5,201,7,208
https://kawalpemilu.org#25921,"KELAPA GADING TIMUR, KELAPA GADING, JAKARTA UTARA, DKI JAKARTA",6,203,12,215
https://kawalpemilu.org#25921,"KELAPA GADING TIMUR, KELAPA GADING, JAKARTA UTARA, DKI JAKARTA",7,207,9,216
https://kawalpemilu.org#25921,"KELAPA GADING TIMUR, KELAPA GADING, JAKARTA UTARA, DKI JAKARTA",8,208,20,228
https://kawalpemilu.org#25921,"KELAPA GADING TIMUR, KELAPA GADING, JAKARTA UTARA, DKI JAKARTA",9,200,20,220
https://kawalpemilu.org#25921,"KELAPA GADING TIMUR, KELAPA GADING, JAKARTA UTARA, DKI JAKARTA",10,179,20,199
https://kawalpemilu.org#25921,"KELAPA GADING TIMUR, KELAPA GADING, JAKARTA UTARA, DKI JAKARTA",11,202,12,214
https://kawalpemilu.org#25921,"KELAPA GADING TIMUR, KELAPA GADING, JAKARTA UTARA, DKI JAKARTA",12,60,146,206
https://kawalpemilu.org#25921,"KELAPA GADING TIMUR, KELAPA GADING, JAKARTA UTARA, DKI JAKARTA",13,89,117,206
https://kawalpemilu.org#25921,"KELAPA GADING TIMUR, KELAPA GADING, JAKARTA UTARA, DKI JAKARTA",14,57,141,198
https://kawalpemilu.org#25921,"KELAPA GADING TIMUR, KELAPA GADING, JAKARTA UTARA, DKI JAKARTA",15,61,151,212
https://kawalpemilu.org#25921,"KELAPA GADING TIMUR, KELAPA GADING, JAKARTA UTARA, DKI JAKARTA",16,100,103,203
https://kawalpemilu.org#25921,"KELAPA GADING TIMUR, KELAPA GADING, JAKARTA UTARA, DKI JAKARTA",17,82,109,191
https://kawalpemilu.org#25921,"KELAPA GADING TIMUR, KELAPA GADING, JAKARTA UTARA, DKI JAKARTA",18,90,131,221
https://kawalpemilu.org#25921,"KELAPA GADING TIMUR, KELAPA GADING, JAKARTA UTARA, DKI JAKARTA",19,99,126,225
https://kawalpemilu.org#25921,"KELAPA GADING TIMUR, KELAPA GADING, JAKARTA UTARA, DKI JAKARTA",20,82,122,204
https://kawalpemilu.org#25921,"KELAPA GADING TIMUR, KELAPA GADING, JAKARTA UTARA, DKI JAKARTA",21,99,132,231
https://kawalpemilu.org#25921,"KELAPA GADING TIMUR, KELAPA GADING, JAKARTA UTARA, DKI JAKARTA",22,94,97,191
https://kawalpemilu.org#25921,"KELAPA GADING TIMUR, KELAPA GADING, JAKARTA UTARA, DKI JAKARTA",23,99,109,208
https://kawalpemilu.org#25921,"KELAPA GADING TIMUR, KELAPA GADING, JAKARTA UTARA, DKI JAKARTA",24,86,114,200
https://kawalpemilu.org#25921,"KELAPA GADING TIMUR, KELAPA GADING, JAKARTA UTARA, DKI JAKARTA",25,69,108,177
https://kawalpemilu.org#25921,"KELAPA GADING TIMUR, KELAPA GADING, JAKARTA UTARA, DKI JAKARTA",26,104,94,198
https://kawalpemilu.org#25921,"KELAPA GADING TIMUR, KELAPA GADING, JAKARTA UTARA, DKI JAKARTA",27,87,92,179
https://kawalpemilu.org#25921,"KELAPA GADING TIMUR, KELAPA GADING, JAKARTA UTARA, DKI JAKARTA",28,107,72,179
https://kawalpemilu.org#25921,"KELAPA GADING TIMUR, KELAPA GADING, JAKARTA UTARA, DKI JAKARTA",29,85,157,242
https://kawalpemilu.org#25921,"KELAPA GADING TIMUR, KELAPA GADING, JAKARTA UTARA, DKI JAKARTA",30,107,159,266
https://kawalpemilu.org#25921,"KELAPA GADING TIMUR, KELAPA GADING, JAKARTA UTARA, DKI JAKARTA",31,91,147,238
https://kawalpemilu.org#25921,"KELAPA GADING TIMUR, KELAPA GADING, JAKARTA UTARA, DKI JAKARTA",32,94,158,252
https://kawalpemilu.org#25921,"KELAPA GADING TIMUR, KELAPA GADING, JAKARTA UTARA, DKI JAKARTA",33,112,120,233
https://kawalpemilu.org#25921,"KELAPA GADING TIMUR, KELAPA GADING, JAKARTA UTARA, DKI JAKARTA",34,116,119,235
https://kawalpemilu.org#25921,"KELAPA GADING TIMUR, KELAPA GADING, JAKARTA UTARA, DKI JAKARTA",35,133,117,250
https://kawalpemilu.org#25921,"KELAPA GADING TIMUR, KELAPA GADING, JAKARTA UTARA, DKI JAKARTA",36,126,110,236
https://kawalpemilu.org#25921,"KELAPA GADING TIMUR, KELAPA GADING, JAKARTA UTARA, DKI JAKARTA",37,186,52,238
https://kawalpemilu.org#25921,"KELAPA GADING TIMUR, KELAPA GADING, JAKARTA UTARA, DKI JAKARTA",38,177,48,225
https://kawalpemilu.org#25921,"KELAPA GADING TIMUR, KELAPA GADING, JAKARTA UTARA, DKI JAKARTA",39,213,14,227
https://kawalpemilu.org#25921,"KELAPA GADING TIMUR, KELAPA GADING, JAKARTA UTARA, DKI JAKARTA",40,164,41,205
https://kawalpemilu.org#25921,"KELAPA GADING TIMUR, KELAPA GADING, JAKARTA UTARA, DKI JAKARTA",41,156,54,210
https://kawalpemilu.org#25921,"KELAPA GADING TIMUR, KELAPA GADING, JAKARTA UTARA, DKI JAKARTA",42,199,39,238
https://kawalpemilu.org#25921,"KELAPA GADING TIMUR, KELAPA GADING, JAKARTA UTARA, DKI JAKARTA",43,191,50,241
https://kawalpemilu.org#25921,"KELAPA GADING TIMUR, KELAPA GADING, JAKARTA UTARA, DKI JAKARTA",44,172,61,233
https://kawalpemilu.org#25921,"KELAPA GADING TIMUR, KELAPA GADING, JAKARTA UTARA, DKI JAKARTA",45,161,69,230
https://kawalpemilu.org#25921,"KELAPA GADING TIMUR, KELAPA GADING, JAKARTA UTARA, DKI JAKARTA",46,177,54,231
https://kawalpemilu.org#25921,"KELAPA GADING TIMUR, KELAPA GADING, JAKARTA UTARA, DKI JAKARTA",47,179,55,234
https://kawalpemilu.org#25921,"KELAPA GADING TIMUR, KELAPA GADING, JAKARTA UTARA, DKI JAKARTA",48,220,14,234
https://kawalpemilu.org#25921,"KELAPA GADING TIMUR, KELAPA GADING, JAKARTA UTARA, DKI JAKARTA",49,262,7,269
https://kawalpemilu.org#25921,"KELAPA GADING TIMUR, KELAPA GADING, JAKARTA UTARA, DKI JAKARTA",50,227,15,242
https://kawalpemilu.org#25921,"KELAPA GADING TIMUR, KELAPA GADING, JAKARTA UTARA, DKI JAKARTA",51,224,10,234
https://kawalpemilu.org#25921,"KELAPA GADING TIMUR, KELAPA GADING, JAKARTA UTARA, DKI JAKARTA",52,244,12,256
https://kawalpemilu.org#25921,"KELAPA GADING TIMUR, KELAPA GADING, JAKARTA UTARA, DKI JAKARTA",53,217,10,227
https://kawalpemilu.org#25921,"KELAPA GADING TIMUR, KELAPA GADING, JAKARTA UTARA, DKI JAKARTA",54,223,16,239
https://kawalpemilu.org#25921,"KELAPA GADING TIMUR, KELAPA GADING, JAKARTA UTARA, DKI JAKARTA",55,209,12,221
https://kawalpemilu.org#25921,"KELAPA GADING TIMUR, KELAPA GADING, JAKARTA UTARA, DKI JAKARTA",56,112,96,208
https://kawalpemilu.org#25921,"KELAPA GADING TIMUR, KELAPA GADING, JAKARTA UTARA, DKI JAKARTA",57,117,93,210
https://kawalpemilu.org#25921,"KELAPA GADING TIMUR, KELAPA GADING, JAKARTA UTARA, DKI JAKARTA",58,103,117,220
https://kawalpemilu.org#25921,"KELAPA GADING TIMUR, KELAPA GADING, JAKARTA UTARA, DKI JAKARTA",59,114,111,225
https://kawalpemilu.org#25921,"KELAPA GADING TIMUR, KELAPA GADING, JAKARTA UTARA, DKI JAKARTA",60,139,98,237
https://kawalpemilu.org#25921,"KELAPA GADING TIMUR, KELAPA GADING, JAKARTA UTARA, DKI JAKARTA",61,114,90,204
https://kawalpemilu.org#25921,"KELAPA GADING TIMUR, KELAPA GADING, JAKARTA UTARA, DKI JAKARTA",62,160,82,242
https://kawalpemilu.org#25921,"KELAPA GADING TIMUR, KELAPA GADING, JAKARTA UTARA, DKI JAKARTA",63,90,137,227
https://kawalpemilu.org#25921,"KELAPA GADING TIMUR, KELAPA GADING, JAKARTA UTARA, DKI JAKARTA",64,142,83,225
https://kawalpemilu.org#25921,"KELAPA GADING TIMUR, KELAPA GADING, JAKARTA UTARA, DKI JAKARTA",65,230,13,243
https://kawalpemilu.org#25921,"KELAPA GADING TIMUR, KELAPA GADING, JAKARTA UTARA, DKI JAKARTA",66,231,11,242
https://kawalpemilu.org#25921,"KELAPA GADING TIMUR, KELAPA GADING, JAKARTA UTARA, DKI JAKARTA",67,252,8,260
https://kawalpemilu.org#25921,"KELAPA GADING TIMUR, KELAPA GADING, JAKARTA UTARA, DKI JAKARTA",68,216,11,227
https://kawalpemilu.org#25921,"KELAPA GADING TIMUR, KELAPA GADING, JAKARTA UTARA, DKI JAKARTA",69,210,15,225
https://kawalpemilu.org#25921,"KELAPA GADING TIMUR, KELAPA GADING, JAKARTA UTARA, DKI JAKARTA",70,212,13,225
https://kawalpemilu.org#25921,"KELAPA GADING TIMUR, KELAPA GADING, JAKARTA UTARA, DKI JAKARTA",71,217,4,221
https://kawalpemilu.org#25921,"KELAPA GADING TIMUR, KELAPA GADING, JAKARTA UTARA, DKI JAKARTA",72,206,10,216
https://kawalpemilu.org#25921,"KELAPA GADING TIMUR, KELAPA GADING, JAKARTA UTARA, DKI JAKARTA",73,216,22,238
https://kawalpemilu.org#25921,"KELAPA GADING TIMUR, KELAPA GADING, JAKARTA UTARA, DKI JAKARTA",74,203,18,221
https://kawalpemilu.org#25921,"KELAPA GADING TIMUR, KELAPA GADING, JAKARTA UTARA, DKI JAKARTA",75,228,11,239
https://kawalpemilu.org#25921,"KELAPA GADING TIMUR, KELAPA GADING, JAKARTA UTARA, DKI JAKARTA",76,214,10,224
https://kawalpemilu.org#25921,"KELAPA GADING TIMUR, KELAPA GADING, JAKARTA UTARA, DKI JAKARTA",77,213,13,226
https://kawalpemilu.org#25921,"KELAPA GADING TIMUR, KELAPA GADING, JAKARTA UTARA, DKI JAKARTA",78,145,45,190
https://kawalpemilu.org#25921,"KELAPA GADING TIMUR, KELAPA GADING, JAKARTA UTARA, DKI JAKARTA",79,101,111,212
https://kawalpemilu.org#25921,"KELAPA GADING TIMUR, KELAPA GADING, JAKARTA UTARA, DKI JAKARTA",80,115,98,213
https://kawalpemilu.org#25921,"KELAPA GADING TIMUR, KELAPA GADING, JAKARTA UTARA, DKI JAKARTA",81,195,15,210
https://kawalpemilu.org#25921,"KELAPA GADING TIMUR, KELAPA GADING, JAKARTA UTARA, DKI JAKARTA",82,190,17,207
https://kawalpemilu.org#25921,"KELAPA GADING TIMUR, KELAPA GADING, JAKARTA UTARA, DKI JAKARTA",83,200,15,215
https://kawalpemilu.org#25921,"KELAPA GADING TIMUR, KELAPA GADING, JAKARTA UTARA, DKI JAKARTA",84,198,4,202
https://kawalpemilu.org#25921,"KELAPA GADING TIMUR, KELAPA GADING, JAKARTA UTARA, DKI JAKARTA",85,220,4,224
https://kawalpemilu.org#25921,"KELAPA GADING TIMUR, KELAPA GADING, JAKARTA UTARA, DKI JAKARTA",86,208,8,216
https://kawalpemilu.org#25921,"KELAPA GADING TIMUR, KELAPA GADING, JAKARTA UTARA, DKI JAKARTA",87,202,10,212
https://kawalpemilu.org#25921,"KELAPA GADING TIMUR, KELAPA GADING, JAKARTA UTARA, DKI JAKARTA",88,203,8,211
https://kawalpemilu.org#25921,"KELAPA GADING TIMUR, KELAPA GADING, JAKARTA UTARA, DKI JAKARTA",89,207,6,213
https://kawalpemilu.org#25921,"KELAPA GADING TIMUR, KELAPA GADING, JAKARTA UTARA, DKI JAKARTA",90,224,10,234
https://kawalpemilu.org#25921,"KELAPA GADING TIMUR, KELAPA GADING, JAKARTA UTARA, DKI JAKARTA",91,174,34,208
https://kawalpemilu.org#25921,"KELAPA GADING TIMUR, KELAPA GADING, JAKARTA UTARA, DKI JAKARTA",92,203,29,232
https://kawalpemilu.org#25921,"KELAPA GADING TIMUR, KELAPA GADING, JAKARTA UTARA, DKI JAKARTA",93,194,35,229
https://kawalpemilu.org#25921,"KELAPA GADING TIMUR, KELAPA GADING, JAKARTA UTARA, DKI JAKARTA",94,197,19,216
https://kawalpemilu.org#25921,"KELAPA GADING TIMUR, KELAPA GADING, JAKARTA UTARA, DKI JAKARTA",95,219,14,233
https://kawalpemilu.org#25921,"KELAPA GADING TIMUR, KELAPA GADING, JAKARTA UTARA, DKI JAKARTA",96,217,6,223
https://kawalpemilu.org#25921,"KELAPA GADING TIMUR, KELAPA GADING, JAKARTA UTARA, DKI JAKARTA",97,190,9,199
https://kawalpemilu.org#25921,"KELAPA GADING TIMUR, KELAPA GADING, JAKARTA UTARA, DKI JAKARTA",98,185,23,208
https://kawalpemilu.org#25921,"KELAPA GADING TIMUR, KELAPA GADING, JAKARTA UTARA, DKI JAKARTA",99,207,16,223
https://kawalpemilu.org#25921,"KELAPA GADING TIMUR, KELAPA GADING, JAKARTA UTARA, DKI JAKARTA",100,222,13,235
https://kawalpemilu.org#25921,"KELAPA GADING TIMUR, KELAPA GADING, JAKARTA UTARA, DKI JAKARTA",101,199,4,203
https://kawalpemilu.org#25921,"KELAPA GADING TIMUR, KELAPA GADING, JAKARTA UTARA, DKI JAKARTA",102,200,34,234
https://kawalpemilu.org#25921,"KELAPA GADING TIMUR, KELAPA GADING, JAKARTA UTARA, DKI JAKARTA",103,167,19,186
https://kawalpemilu.org#25921,"KELAPA GADING TIMUR, KELAPA GADING, JAKARTA UTARA, DKI JAKARTA",104,203,22,225
https://kawalpemilu.org#25921,"KELAPA GADING TIMUR, KELAPA GADING, JAKARTA UTARA, DKI JAKARTA",105,214,8,222
https://kawalpemilu.org#25921,"KELAPA GADING TIMUR, KELAPA GADING, JAKARTA UTARA, DKI JAKARTA",106,223,20,243
https://kawalpemilu.org#25921,"KELAPA GADING TIMUR, KELAPA GADING, JAKARTA UTARA, DKI JAKARTA",107,199,18,217
https://kawalpemilu.org#25921,"KELAPA GADING TIMUR, KELAPA GADING, JAKARTA UTARA, DKI JAKARTA",108,227,9,236
https://kawalpemilu.org#25921,"KELAPA GADING TIMUR, KELAPA GADING, JAKARTA UTARA, DKI JAKARTA",109,211,11,222
https://kawalpemilu.org#25921,"KELAPA GADING TIMUR, KELAPA GADING, JAKARTA UTARA, DKI JAKARTA",110,219,16,235
https://kawalpemilu.org#25921,"KELAPA GADING TIMUR, KELAPA GADING, JAKARTA UTARA, DKI JAKARTA",111,197,11,208
https://kawalpemilu.org#25921,"KELAPA GADING TIMUR, KELAPA GADING, JAKARTA UTARA, DKI JAKARTA",112,234,8,242
https://kawalpemilu.org#25921,"KELAPA GADING TIMUR, KELAPA GADING, JAKARTA UTARA, DKI JAKARTA",113,190,15,205
https://kawalpemilu.org#25921,"KELAPA GADING TIMUR, KELAPA GADING, JAKARTA UTARA, DKI JAKARTA",114,219,16,235
https://kawalpemilu.org#25921,"KELAPA GADING TIMUR, KELAPA GADING, JAKARTA UTARA, DKI JAKARTA",115,100,87,187
https://kawalpemilu.org#25921,"KELAPA GADING TIMUR, KELAPA GADING, JAKARTA UTARA, DKI JAKARTA",116,81,123,204
https://kawalpemilu.org#25921,"KELAPA GADING TIMUR, KELAPA GADING, JAKARTA UTARA, DKI JAKARTA",117,186,35,221
https://kawalpemilu.org#25921,"KELAPA GADING TIMUR, KELAPA GADING, JAKARTA UTARA, DKI JAKARTA",118,132,89,221
https://kawalpemilu.org#25922,"PEGANGSAAN DUA, KELAPA GADING, JAKARTA UTARA, DKI JAKARTA",1,99,128,227
https://kawalpemilu.org#25922,"PEGANGSAAN DUA, KELAPA GADING, JAKARTA UTARA, DKI JAKARTA",2,67,152,219
https://kawalpemilu.org#25922,"PEGANGSAAN DUA, KELAPA GADING, JAKARTA UTARA, DKI JAKARTA",3,80,124,204
https://kawalpemilu.org#25922,"PEGANGSAAN DUA, KELAPA GADING, JAKARTA UTARA, DKI JAKARTA",4,98,115,213
https://kawalpemilu.org#25922,"PEGANGSAAN DUA, KELAPA GADING, JAKARTA UTARA, DKI JAKARTA",5,82,121,203
https://kawalpemilu.org#25922,"PEGANGSAAN DUA, KELAPA GADING, JAKARTA UTARA, DKI JAKARTA",6,89,116,205
https://kawalpemilu.org#25922,"PEGANGSAAN DUA, KELAPA GADING, JAKARTA UTARA, DKI JAKARTA",7,56,137,193
https://kawalpemilu.org#25922,"PEGANGSAAN DUA, KELAPA GADING, JAKARTA UTARA, DKI JAKARTA",8,68,141,209
https://kawalpemilu.org#25922,"PEGANGSAAN DUA, KELAPA GADING, JAKARTA UTARA, DKI JAKARTA",9,51,167,218
https://kawalpemilu.org#25922,"PEGANGSAAN DUA, KELAPA GADING, JAKARTA UTARA, DKI JAKARTA",10,65,122,187
https://kawalpemilu.org#25922,"PEGANGSAAN DUA, KELAPA GADING, JAKARTA UTARA, DKI JAKARTA",11,55,166,221
https://kawalpemilu.org#25922,"PEGANGSAAN DUA, KELAPA GADING, JAKARTA UTARA, DKI JAKARTA",12,84,145,229
https://kawalpemilu.org#25922,"PEGANGSAAN DUA, KELAPA GADING, JAKARTA UTARA, DKI JAKARTA",13,77,93,170
https://kawalpemilu.org#25922,"PEGANGSAAN DUA, KELAPA GADING, JAKARTA UTARA, DKI JAKARTA",14,82,105,187
https://kawalpemilu.org#25922,"PEGANGSAAN DUA, KELAPA GADING, JAKARTA UTARA, DKI JAKARTA",15,99,106,205
https://kawalpemilu.org#25922,"PEGANGSAAN DUA, KELAPA GADING, JAKARTA UTARA, DKI JAKARTA",16,99,72,171
https://kawalpemilu.org#25922,"PEGANGSAAN DUA, KELAPA GADING, JAKARTA UTARA, DKI JAKARTA",17,85,80,165
https://kawalpemilu.org#25922,"PEGANGSAAN DUA, KELAPA GADING, JAKARTA UTARA, DKI JAKARTA",18,104,54,158
https://kawalpemilu.org#25922,"PEGANGSAAN DUA, KELAPA GADING, JAKARTA UTARA, DKI JAKARTA",19,95,83,178
https://kawalpemilu.org#25922,"PEGANGSAAN DUA, KELAPA GADING, JAKARTA UTARA, DKI JAKARTA",20,85,129,214
https://kawalpemilu.org#25922,"PEGANGSAAN DUA, KELAPA GADING, JAKARTA UTARA, DKI JAKARTA",21,85,105,190
https://kawalpemilu.org#25922,"PEGANGSAAN DUA, KELAPA GADING, JAKARTA UTARA, DKI JAKARTA",22,255,15,270
https://kawalpemilu.org#25922,"PEGANGSAAN DUA, KELAPA GADING, JAKARTA UTARA, DKI JAKARTA",23,245,28,273
https://kawalpemilu.org#25922,"PEGANGSAAN DUA, KELAPA GADING, JAKARTA UTARA, DKI JAKARTA",24,266,16,282
https://kawalpemilu.org#25922,"PEGANGSAAN DUA, KELAPA GADING, JAKARTA UTARA, DKI JAKARTA",25,231,14,245
https://kawalpemilu.org#25922,"PEGANGSAAN DUA, KELAPA GADING, JAKARTA UTARA, DKI JAKARTA",26,240,29,269
https://kawalpemilu.org#25922,"PEGANGSAAN DUA, KELAPA GADING, JAKARTA UTARA, DKI JAKARTA",27,228,24,252
https://kawalpemilu.org#25922,"PEGANGSAAN DUA, KELAPA GADING, JAKARTA UTARA, DKI JAKARTA",28,235,28,263
https://kawalpemilu.org#25922,"PEGANGSAAN DUA, KELAPA GADING, JAKARTA UTARA, DKI JAKARTA",29,76,105,181
https://kawalpemilu.org#25922,"PEGANGSAAN DUA, KELAPA GADING, JAKARTA UTARA, DKI JAKARTA",30,84,103,187
https://kawalpemilu.org#25922,"PEGANGSAAN DUA, KELAPA GADING, JAKARTA UTARA, DKI JAKARTA",31,79,106,185
https://kawalpemilu.org#25922,"PEGANGSAAN DUA, KELAPA GADING, JAKARTA UTARA, DKI JAKARTA",32,79,121,200
https://kawalpemilu.org#25922,"PEGANGSAAN DUA, KELAPA GADING, JAKARTA UTARA, DKI JAKARTA",33,82,83,165
https://kawalpemilu.org#25922,"PEGANGSAAN DUA, KELAPA GADING, JAKARTA UTARA, DKI JAKARTA",34,141,72,213
https://kawalpemilu.org#25922,"PEGANGSAAN DUA, KELAPA GADING, JAKARTA UTARA, DKI JAKARTA",35,70,127,197
https://kawalpemilu.org#25922,"PEGANGSAAN DUA, KELAPA GADING, JAKARTA UTARA, DKI JAKARTA",36,94,86,180
https://kawalpemilu.org#25922,"PEGANGSAAN DUA, KELAPA GADING, JAKARTA UTARA, DKI JAKARTA",37,69,131,200
https://kawalpemilu.org#25922,"PEGANGSAAN DUA, KELAPA GADING, JAKARTA UTARA, DKI JAKARTA",38,88,132,220
https://kawalpemilu.org#25922,"PEGANGSAAN DUA, KELAPA GADING, JAKARTA UTARA, DKI JAKARTA",39,65,123,188
https://kawalpemilu.org#25922,"PEGANGSAAN DUA, KELAPA GADING, JAKARTA UTARA, DKI JAKARTA",40,49,149,198
https://kawalpemilu.org#25922,"PEGANGSAAN DUA, KELAPA GADING, JAKARTA UTARA, DKI JAKARTA",41,42,123,165
https://kawalpemilu.org#25922,"PEGANGSAAN DUA, KELAPA GADING, JAKARTA UTARA, DKI JAKARTA",42,89,91,180
https://kawalpemilu.org#25922,"PEGANGSAAN DUA, KELAPA GADING, JAKARTA UTARA, DKI JAKARTA",43,74,122,196
https://kawalpemilu.org#25922,"PEGANGSAAN DUA, KELAPA GADING, JAKARTA UTARA, DKI JAKARTA",44,75,127,202
https://kawalpemilu.org#25922,"PEGANGSAAN DUA, KELAPA GADING, JAKARTA UTARA, DKI JAKARTA",45,77,167,244
https://kawalpemilu.org#25922,"PEGANGSAAN DUA, KELAPA GADING, JAKARTA UTARA, DKI JAKARTA",46,90,136,226
https://kawalpemilu.org#25922,"PEGANGSAAN DUA, KELAPA GADING, JAKARTA UTARA, DKI JAKARTA",47,112,149,261
https://kawalpemilu.org#25922,"PEGANGSAAN DUA, KELAPA GADING, JAKARTA UTARA, DKI JAKARTA",48,116,109,225
https://kawalpemilu.org#25922,"PEGANGSAAN DUA, KELAPA GADING, JAKARTA UTARA, DKI JAKARTA",49,115,96,211
https://kawalpemilu.org#25922,"PEGANGSAAN DUA, KELAPA GADING, JAKARTA UTARA, DKI JAKARTA",50,118,108,226
https://kawalpemilu.org#25922,"PEGANGSAAN DUA, KELAPA GADING, JAKARTA UTARA, DKI JAKARTA",51,129,97,226
https://kawalpemilu.org#25922,"PEGANGSAAN DUA, KELAPA GADING, JAKARTA UTARA, DKI JAKARTA",52,107,66,173
https://kawalpemilu.org#25922,"PEGANGSAAN DUA, KELAPA GADING, JAKARTA UTARA, DKI JAKARTA",53,101,120,221
https://kawalpemilu.org#25922,"PEGANGSAAN DUA, KELAPA GADING, JAKARTA UTARA, DKI JAKARTA",54,96,134,230
https://kawalpemilu.org#25922,"PEGANGSAAN DUA, KELAPA GADING, JAKARTA UTARA, DKI JAKARTA",55,108,90,198
https://kawalpemilu.org#25922,"PEGANGSAAN DUA, KELAPA GADING, JAKARTA UTARA, DKI JAKARTA",56,75,106,181
https://kawalpemilu.org#25922,"PEGANGSAAN DUA, KELAPA GADING, JAKARTA UTARA, DKI JAKARTA",57,98,109,207
https://kawalpemilu.org#25922,"PEGANGSAAN DUA, KELAPA GADING, JAKARTA UTARA, DKI JAKARTA",58,135,48,183
https://kawalpemilu.org#25922,"PEGANGSAAN DUA, KELAPA GADING, JAKARTA UTARA, DKI JAKARTA",59,147,41,188
https://kawalpemilu.org#25922,"PEGANGSAAN DUA, KELAPA GADING, JAKARTA UTARA, DKI JAKARTA",60,125,50,175
https://kawalpemilu.org#25922,"PEGANGSAAN DUA, KELAPA GADING, JAKARTA UTARA, DKI JAKARTA",61,163,34,197
https://kawalpemilu.org#25922,"PEGANGSAAN DUA, KELAPA GADING, JAKARTA UTARA, DKI JAKARTA",62,184,33,217
https://kawalpemilu.org#25922,"PEGANGSAAN DUA, KELAPA GADING, JAKARTA UTARA, DKI JAKARTA",63,183,39,222
https://kawalpemilu.org#25922,"PEGANGSAAN DUA, KELAPA GADING, JAKARTA UTARA, DKI JAKARTA",64,184,35,219
https://kawalpemilu.org#25922,"PEGANGSAAN DUA, KELAPA GADING, JAKARTA UTARA, DKI JAKARTA",65,193,24,217
https://kawalpemilu.org#25922,"PEGANGSAAN DUA, KELAPA GADING, JAKARTA UTARA, DKI JAKARTA",66,200,23,223
https://kawalpemilu.org#25922,"PEGANGSAAN DUA, KELAPA GADING, JAKARTA UTARA, DKI JAKARTA",67,185,29,214
https://kawalpemilu.org#25922,"PEGANGSAAN DUA, KELAPA GADING, JAKARTA UTARA, DKI JAKARTA",68,179,41,220
https://kawalpemilu.org#25922,"PEGANGSAAN DUA, KELAPA GADING, JAKARTA UTARA, DKI JAKARTA",69,172,37,209
https://kawalpemilu.org#25922,"PEGANGSAAN DUA, KELAPA GADING, JAKARTA UTARA, DKI JAKARTA",70,158,64,222
https://kawalpemilu.org#25922,"PEGANGSAAN DUA, KELAPA GADING, JAKARTA UTARA, DKI JAKARTA",71,225,30,255
https://kawalpemilu.org#25922,"PEGANGSAAN DUA, KELAPA GADING, JAKARTA UTARA, DKI JAKARTA",72,200,28,228
https://kawalpemilu.org#25922,"PEGANGSAAN DUA, KELAPA GADING, JAKARTA UTARA, DKI JAKARTA",73,152,76,228
https://kawalpemilu.org#25922,"PEGANGSAAN DUA, KELAPA GADING, JAKARTA UTARA, DKI JAKARTA",74,124,111,235
https://kawalpemilu.org#25922,"PEGANGSAAN DUA, KELAPA GADING, JAKARTA UTARA, DKI JAKARTA",75,190,35,225
https://kawalpemilu.org#25922,"PEGANGSAAN DUA, KELAPA GADING, JAKARTA UTARA, DKI JAKARTA",76,135,108,243
https://kawalpemilu.org#25922,"PEGANGSAAN DUA, KELAPA GADING, JAKARTA UTARA, DKI JAKARTA",77,162,79,241
https://kawalpemilu.org#25922,"PEGANGSAAN DUA, KELAPA GADING, JAKARTA UTARA, DKI JAKARTA",78,153,33,186
https://kawalpemilu.org#25922,"PEGANGSAAN DUA, KELAPA GADING, JAKARTA UTARA, DKI JAKARTA",79,169,36,205
https://kawalpemilu.org#25922,"PEGANGSAAN DUA, KELAPA GADING, JAKARTA UTARA, DKI JAKARTA",80,164,36,200
https://kawalpemilu.org#25922,"PEGANGSAAN DUA, KELAPA GADING, JAKARTA UTARA, DKI JAKARTA",81,182,35,217
https://kawalpemilu.org#25922,"PEGANGSAAN DUA, KELAPA GADING, JAKARTA UTARA, DKI JAKARTA",82,180,36,216
https://kawalpemilu.org#25922,"PEGANGSAAN DUA, KELAPA GADING, JAKARTA UTARA, DKI JAKARTA",83,185,29,214
https://kawalpemilu.org#25922,"PEGANGSAAN DUA, KELAPA GADING, JAKARTA UTARA, DKI JAKARTA",84,237,2,239
https://kawalpemilu.org#25922,"PEGANGSAAN DUA, KELAPA GADING, JAKARTA UTARA, DKI JAKARTA",85,230,6,236
https://kawalpemilu.org#25922,"PEGANGSAAN DUA, KELAPA GADING, JAKARTA UTARA, DKI JAKARTA",86,223,5,228
https://kawalpemilu.org#25922,"PEGANGSAAN DUA, KELAPA GADING, JAKARTA UTARA, DKI JAKARTA",87,216,19,235
https://kawalpemilu.org#25922,"PEGANGSAAN DUA, KELAPA GADING, JAKARTA UTARA, DKI JAKARTA",88,225,12,237
https://kawalpemilu.org#25922,"PEGANGSAAN DUA, KELAPA GADING, JAKARTA UTARA, DKI JAKARTA",89,216,14,230
https://kawalpemilu.org#25922,"PEGANGSAAN DUA, KELAPA GADING, JAKARTA UTARA, DKI JAKARTA",90,242,3,245
https://kawalpemilu.org#25922,"PEGANGSAAN DUA, KELAPA GADING, JAKARTA UTARA, DKI JAKARTA",91,241,8,249
https://kawalpemilu.org#25922,"PEGANGSAAN DUA, KELAPA GADING, JAKARTA UTARA, DKI JAKARTA",92,226,7,233
https://kawalpemilu.org#25922,"PEGANGSAAN DUA, KELAPA GADING, JAKARTA UTARA, DKI JAKARTA",93,213,8,221
https://kawalpemilu.org#25922,"PEGANGSAAN DUA, KELAPA GADING, JAKARTA UTARA, DKI JAKARTA",94,228,11,239
https://kawalpemilu.org#25922,"PEGANGSAAN DUA, KELAPA GADING, JAKARTA UTARA, DKI JAKARTA",95,242,14,256
https://kawalpemilu.org#25922,"PEGANGSAAN DUA, KELAPA GADING, JAKARTA UTARA, DKI JAKARTA",96,209,16,225
https://kawalpemilu.org#25922,"PEGANGSAAN DUA, KELAPA GADING, JAKARTA UTARA, DKI JAKARTA",97,247,7,254
https://kawalpemilu.org#25922,"PEGANGSAAN DUA, KELAPA GADING, JAKARTA UTARA, DKI JAKARTA",98,223,13,236
https://kawalpemilu.org#25922,"PEGANGSAAN DUA, KELAPA GADING, JAKARTA UTARA, DKI JAKARTA",99,245,7,252
https://kawalpemilu.org#25922,"PEGANGSAAN DUA, KELAPA GADING, JAKARTA UTARA, DKI JAKARTA",100,230,16,246
https://kawalpemilu.org#25922,"PEGANGSAAN DUA, KELAPA GADING, JAKARTA UTARA, DKI JAKARTA",101,213,8,221
https://kawalpemilu.org#25922,"PEGANGSAAN DUA, KELAPA GADING, JAKARTA UTARA, DKI JAKARTA",102,222,12,234
https://kawalpemilu.org#25922,"PEGANGSAAN DUA, KELAPA GADING, JAKARTA UTARA, DKI JAKARTA",103,97,111,208
https://kawalpemilu.org#25922,"PEGANGSAAN DUA, KELAPA GADING, JAKARTA UTARA, DKI JAKARTA",104,60,169,229
https://kawalpemilu.org#25922,"PEGANGSAAN DUA, KELAPA GADING, JAKARTA UTARA, DKI JAKARTA",105,79,132,211
https://kawalpemilu.org#25922,"PEGANGSAAN DUA, KELAPA GADING, JAKARTA UTARA, DKI JAKARTA",106,113,115,228
https://kawalpemilu.org#25922,"PEGANGSAAN DUA, KELAPA GADING, JAKARTA UTARA, DKI JAKARTA",107,227,8,235
https://kawalpemilu.org#25922,"PEGANGSAAN DUA, KELAPA GADING, JAKARTA UTARA, DKI JAKARTA",108,222,5,227
https://kawalpemilu.org#25922,"PEGANGSAAN DUA, KELAPA GADING, JAKARTA UTARA, DKI JAKARTA",109,232,6,238
https://kawalpemilu.org#25922,"PEGANGSAAN DUA, KELAPA GADING, JAKARTA UTARA, DKI JAKARTA",110,191,12,203
https://kawalpemilu.org#25922,"PEGANGSAAN DUA, KELAPA GADING, JAKARTA UTARA, DKI JAKARTA",111,192,6,198
https://kawalpemilu.org#25922,"PEGANGSAAN DUA, KELAPA GADING, JAKARTA UTARA, DKI JAKARTA",112,217,4,221
https://kawalpemilu.org#25922,"PEGANGSAAN DUA, KELAPA GADING, JAKARTA UTARA, DKI JAKARTA",113,203,4,207
https://kawalpemilu.org#25922,"PEGANGSAAN DUA, KELAPA GADING, JAKARTA UTARA, DKI JAKARTA",114,213,13,226
https://kawalpemilu.org#25922,"PEGANGSAAN DUA, KELAPA GADING, JAKARTA UTARA, DKI JAKARTA",115,204,8,212
https://kawalpemilu.org#25922,"PEGANGSAAN DUA, KELAPA GADING, JAKARTA UTARA, DKI JAKARTA",116,212,21,233
https://kawalpemilu.org#25922,"PEGANGSAAN DUA, KELAPA GADING, JAKARTA UTARA, DKI JAKARTA",117,232,19,251
https://kawalpemilu.org#25922,"PEGANGSAAN DUA, KELAPA GADING, JAKARTA UTARA, DKI JAKARTA",118,223,22,245
https://kawalpemilu.org#25922,"PEGANGSAAN DUA, KELAPA GADING, JAKARTA UTARA, DKI JAKARTA",119,211,9,220
https://kawalpemilu.org#25922,"PEGANGSAAN DUA, KELAPA GADING, JAKARTA UTARA, DKI JAKARTA",120,189,8,197
https://kawalpemilu.org#25922,"PEGANGSAAN DUA, KELAPA GADING, JAKARTA UTARA, DKI JAKARTA",121,196,4,200
https://kawalpemilu.org#25922,"PEGANGSAAN DUA, KELAPA GADING, JAKARTA UTARA, DKI JAKARTA",122,192,9,201
https://kawalpemilu.org#25922,"PEGANGSAAN DUA, KELAPA GADING, JAKARTA UTARA, DKI JAKARTA",123,209,2,211
https://kawalpemilu.org#25922,"PEGANGSAAN DUA, KELAPA GADING, JAKARTA UTARA, DKI JAKARTA",124,212,3,215
https://kawalpemilu.org#25922,"PEGANGSAAN DUA, KELAPA GADING, JAKARTA UTARA, DKI JAKARTA",125,208,9,217
https://kawalpemilu.org#25922,"PEGANGSAAN DUA, KELAPA GADING, JAKARTA UTARA, DKI JAKARTA",126,203,6,209
https://kawalpemilu.org#25922,"PEGANGSAAN DUA, KELAPA GADING, JAKARTA UTARA, DKI JAKARTA",127,194,22,216
https://kawalpemilu.org#25922,"PEGANGSAAN DUA, KELAPA GADING, JAKARTA UTARA, DKI JAKARTA",128,223,8,231
https://kawalpemilu.org#25922,"PEGANGSAAN DUA, KELAPA GADING, JAKARTA UTARA, DKI JAKARTA",129,214,15,229
https://kawalpemilu.org#25922,"PEGANGSAAN DUA, KELAPA GADING, JAKARTA UTARA, DKI JAKARTA",130,225,8,233
https://kawalpemilu.org#25922,"PEGANGSAAN DUA, KELAPA GADING, JAKARTA UTARA, DKI JAKARTA",131,213,16,229
https://kawalpemilu.org#25922,"PEGANGSAAN DUA, KELAPA GADING, JAKARTA UTARA, DKI JAKARTA",132,247,10,257
https://kawalpemilu.org#25922,"PEGANGSAAN DUA, KELAPA GADING, JAKARTA UTARA, DKI JAKARTA",133,0,0,0
https://kawalpemilu.org#25922,"PEGANGSAAN DUA, KELAPA GADING, JAKARTA UTARA, DKI JAKARTA",134,163,20,183
https://kawalpemilu.org#25922,"PEGANGSAAN DUA, KELAPA GADING, JAKARTA UTARA, DKI JAKARTA",135,143,40,183
https://kawalpemilu.org#25922,"PEGANGSAAN DUA, KELAPA GADING, JAKARTA UTARA, DKI JAKARTA",136,192,17,209
https://kawalpemilu.org#25922,"PEGANGSAAN DUA, KELAPA GADING, JAKARTA UTARA, DKI JAKARTA",137,250,15,265
https://kawalpemilu.org#25922,"PEGANGSAAN DUA, KELAPA GADING, JAKARTA UTARA, DKI JAKARTA",138,258,15,273
https://kawalpemilu.org#25922,"PEGANGSAAN DUA, KELAPA GADING, JAKARTA UTARA, DKI JAKARTA",139,247,4,251
https://kawalpemilu.org#25922,"PEGANGSAAN DUA, KELAPA GADING, JAKARTA UTARA, DKI JAKARTA",140,240,5,245
https://kawalpemilu.org#25922,"PEGANGSAAN DUA, KELAPA GADING, JAKARTA UTARA, DKI JAKARTA",141,203,14,217
https://kawalpemilu.org#25922,"PEGANGSAAN DUA, KELAPA GADING, JAKARTA UTARA, DKI JAKARTA",142,210,8,218
https://kawalpemilu.org#25922,"PEGANGSAAN DUA, KELAPA GADING, JAKARTA UTARA, DKI JAKARTA",143,118,8,126
https://kawalpemilu.org#25922,"PEGANGSAAN DUA, KELAPA GADING, JAKARTA UTARA, DKI JAKARTA",144,247,12,259
https://kawalpemilu.org#25922,"PEGANGSAAN DUA, KELAPA GADING, JAKARTA UTARA, DKI JAKARTA",145,183,22,205
https://kawalpemilu.org#25922,"PEGANGSAAN DUA, KELAPA GADING, JAKARTA UTARA, DKI JAKARTA",146,223,8,231
https://kawalpemilu.org#25922,"PEGANGSAAN DUA, KELAPA GADING, JAKARTA UTARA, DKI JAKARTA",147,188,12,200
https://kawalpemilu.org#25922,"PEGANGSAAN DUA, KELAPA GADING, JAKARTA UTARA, DKI JAKARTA",148,201,1,202
https://kawalpemilu.org#25922,"PEGANGSAAN DUA, KELAPA GADING, JAKARTA UTARA, DKI JAKARTA",149,229,10,239
https://kawalpemilu.org#25922,"PEGANGSAAN DUA, KELAPA GADING, JAKARTA UTARA, DKI JAKARTA",150,83,109,192
https://kawalpemilu.org#25922,"PEGANGSAAN DUA, KELAPA GADING, JAKARTA UTARA, DKI JAKARTA",151,66,131,197
https://kawalpemilu.org#25922,"PEGANGSAAN DUA, KELAPA GADING, JAKARTA UTARA, DKI JAKARTA",152,108,75,183
https://kawalpemilu.org#25922,"PEGANGSAAN DUA, KELAPA GADING, JAKARTA UTARA, DKI JAKARTA",153,129,53,182
https://kawalpemilu.org#25922,"PEGANGSAAN DUA, KELAPA GADING, JAKARTA UTARA, DKI JAKARTA",154,109,49,158
https://kawalpemilu.org#25922,"PEGANGSAAN DUA, KELAPA GADING, JAKARTA UTARA, DKI JAKARTA",155,65,136,201
https://kawalpemilu.org#25922,"PEGANGSAAN DUA, KELAPA GADING, JAKARTA UTARA, DKI JAKARTA",156,0,0,191
https://kawalpemilu.org#25922,"PEGANGSAAN DUA, KELAPA GADING, JAKARTA UTARA, DKI JAKARTA",157,70,131,201
https://kawalpemilu.org#25922,"PEGANGSAAN DUA, KELAPA GADING, JAKARTA UTARA, DKI JAKARTA",158,86,128,214
https://kawalpemilu.org#25922,"PEGANGSAAN DUA, KELAPA GADING, JAKARTA UTARA, DKI JAKARTA",159,102,104,206
https://kawalpemilu.org#25922,"PEGANGSAAN DUA, KELAPA GADING, JAKARTA UTARA, DKI JAKARTA",160,87,126,213
https://kawalpemilu.org#25922,"PEGANGSAAN DUA, KELAPA GADING, JAKARTA UTARA, DKI JAKARTA",161,64,134,198
https://kawalpemilu.org#25922,"PEGANGSAAN DUA, KELAPA GADING, JAKARTA UTARA, DKI JAKARTA",162,108,134,242
https://kawalpemilu.org#25922,"PEGANGSAAN DUA, KELAPA GADING, JAKARTA UTARA, DKI JAKARTA",163,122,88,210
https://kawalpemilu.org#25922,"PEGANGSAAN DUA, KELAPA GADING, JAKARTA UTARA, DKI JAKARTA",164,105,92,197
https://kawalpemilu.org#25922,"PEGANGSAAN DUA, KELAPA GADING, JAKARTA UTARA, DKI JAKARTA",165,162,46,208
https://kawalpemilu.org#25922,"PEGANGSAAN DUA, KELAPA GADING, JAKARTA UTARA, DKI JAKARTA",166,155,65,220
https://kawalpemilu.org#25922,"PEGANGSAAN DUA, KELAPA GADING, JAKARTA UTARA, DKI JAKARTA",167,175,8,183
https://kawalpemilu.org#25922,"PEGANGSAAN DUA, KELAPA GADING, JAKARTA UTARA, DKI JAKARTA",168,60,169,229
https://kawalpemilu.org#25923,"KELAPA GADING BARAT, KELAPA GADING, JAKARTA UTARA, DKI JAKARTA",1,100,154,254
https://kawalpemilu.org#25923,"KELAPA GADING BARAT, KELAPA GADING, JAKARTA UTARA, DKI JAKARTA",2,103,100,203
https://kawalpemilu.org#25923,"KELAPA GADING BARAT, KELAPA GADING, JAKARTA UTARA, DKI JAKARTA",3,118,125,243
https://kawalpemilu.org#25923,"KELAPA GADING BARAT, KELAPA GADING, JAKARTA UTARA, DKI JAKARTA",4,85,125,210
https://kawalpemilu.org#25923,"KELAPA GADING BARAT, KELAPA GADING, JAKARTA UTARA, DKI JAKARTA",5,114,119,233
https://kawalpemilu.org#25923,"KELAPA GADING BARAT, KELAPA GADING, JAKARTA UTARA, DKI JAKARTA",6,94,118,212
https://kawalpemilu.org#25923,"KELAPA GADING BARAT, KELAPA GADING, JAKARTA UTARA, DKI JAKARTA",7,72,113,185
https://kawalpemilu.org#25923,"KELAPA GADING BARAT, KELAPA GADING, JAKARTA UTARA, DKI JAKARTA",8,119,84,203
https://kawalpemilu.org#25923,"KELAPA GADING BARAT, KELAPA GADING, JAKARTA UTARA, DKI JAKARTA",9,110,94,204
https://kawalpemilu.org#25923,"KELAPA GADING BARAT, KELAPA GADING, JAKARTA UTARA, DKI JAKARTA",10,146,60,206
https://kawalpemilu.org#25923,"KELAPA GADING BARAT, KELAPA GADING, JAKARTA UTARA, DKI JAKARTA",11,134,66,200
https://kawalpemilu.org#25923,"KELAPA GADING BARAT, KELAPA GADING, JAKARTA UTARA, DKI JAKARTA",12,121,93,214
https://kawalpemilu.org#25923,"KELAPA GADING BARAT, KELAPA GADING, JAKARTA UTARA, DKI JAKARTA",13,90,131,221
https://kawalpemilu.org#25923,"KELAPA GADING BARAT, KELAPA GADING, JAKARTA UTARA, DKI JAKARTA",14,112,89,201
https://kawalpemilu.org#25923,"KELAPA GADING BARAT, KELAPA GADING, JAKARTA UTARA, DKI JAKARTA",15,101,126,227
https://kawalpemilu.org#25923,"KELAPA GADING BARAT, KELAPA GADING, JAKARTA UTARA, DKI JAKARTA",16,100,104,204
https://kawalpemilu.org#25923,"KELAPA GADING BARAT, KELAPA GADING, JAKARTA UTARA, DKI JAKARTA",17,97,116,213
https://kawalpemilu.org#25923,"KELAPA GADING BARAT, KELAPA GADING, JAKARTA UTARA, DKI JAKARTA",18,98,100,198
https://kawalpemilu.org#25923,"KELAPA GADING BARAT, KELAPA GADING, JAKARTA UTARA, DKI JAKARTA",19,116,97,213
https://kawalpemilu.org#25923,"KELAPA GADING BARAT, KELAPA GADING, JAKARTA UTARA, DKI JAKARTA",20,115,83,198
https://kawalpemilu.org#25923,"KELAPA GADING BARAT, KELAPA GADING, JAKARTA UTARA, DKI JAKARTA",21,98,117,215
https://kawalpemilu.org#25923,"KELAPA GADING BARAT, KELAPA GADING, JAKARTA UTARA, DKI JAKARTA",22,123,79,1
https://kawalpemilu.org#25923,"KELAPA GADING BARAT, KELAPA GADING, JAKARTA UTARA, DKI JAKARTA",23,111,118,229
https://kawalpemilu.org#25923,"KELAPA GADING BARAT, KELAPA GADING, JAKARTA UTARA, DKI JAKARTA",24,77,116,193
https://kawalpemilu.org#25923,"KELAPA GADING BARAT, KELAPA GADING, JAKARTA UTARA, DKI JAKARTA",25,79,103,182
https://kawalpemilu.org#25923,"KELAPA GADING BARAT, KELAPA GADING, JAKARTA UTARA, DKI JAKARTA",26,94,84,178
https://kawalpemilu.org#25923,"KELAPA GADING BARAT, KELAPA GADING, JAKARTA UTARA, DKI JAKARTA",27,100,85,185
https://kawalpemilu.org#25923,"KELAPA GADING BARAT, KELAPA GADING, JAKARTA UTARA, DKI JAKARTA",28,93,131,224
https://kawalpemilu.org#25923,"KELAPA GADING BARAT, KELAPA GADING, JAKARTA UTARA, DKI JAKARTA",29,109,84,193
https://kawalpemilu.org#25923,"KELAPA GADING BARAT, KELAPA GADING, JAKARTA UTARA, DKI JAKARTA",30,117,89,206
https://kawalpemilu.org#25923,"KELAPA GADING BARAT, KELAPA GADING, JAKARTA UTARA, DKI JAKARTA",31,93,91,184
https://kawalpemilu.org#25923,"KELAPA GADING BARAT, KELAPA GADING, JAKARTA UTARA, DKI JAKARTA",33,83,142,225
https://kawalpemilu.org#25923,"KELAPA GADING BARAT, KELAPA GADING, JAKARTA UTARA, DKI JAKARTA",34,117,101,218
https://kawalpemilu.org#25923,"KELAPA GADING BARAT, KELAPA GADING, JAKARTA UTARA, DKI JAKARTA",35,101,121,222
https://kawalpemilu.org#25923,"KELAPA GADING BARAT, KELAPA GADING, JAKARTA UTARA, DKI JAKARTA",36,97,119,216
https://kawalpemilu.org#25923,"KELAPA GADING BARAT, KELAPA GADING, JAKARTA UTARA, DKI JAKARTA",37,102,118,220
https://kawalpemilu.org#25923,"KELAPA GADING BARAT, KELAPA GADING, JAKARTA UTARA, DKI JAKARTA",38,213,4,217
https://kawalpemilu.org#25923,"KELAPA GADING BARAT, KELAPA GADING, JAKARTA UTARA, DKI JAKARTA",39,211,10,221
https://kawalpemilu.org#25923,"KELAPA GADING BARAT, KELAPA GADING, JAKARTA UTARA, DKI JAKARTA",40,210,8,218
https://kawalpemilu.org#25923,"KELAPA GADING BARAT, KELAPA GADING, JAKARTA UTARA, DKI JAKARTA",41,189,10,199
https://kawalpemilu.org#25923,"KELAPA GADING BARAT, KELAPA GADING, JAKARTA UTARA, DKI JAKARTA",42,188,11,199
https://kawalpemilu.org#25923,"KELAPA GADING BARAT, KELAPA GADING, JAKARTA UTARA, DKI JAKARTA",43,198,6,204
https://kawalpemilu.org#25923,"KELAPA GADING BARAT, KELAPA GADING, JAKARTA UTARA, DKI JAKARTA",44,192,9,201
https://kawalpemilu.org#25923,"KELAPA GADING BARAT, KELAPA GADING, JAKARTA UTARA, DKI JAKARTA",45,208,10,218
https://kawalpemilu.org#25923,"KELAPA GADING BARAT, KELAPA GADING, JAKARTA UTARA, DKI JAKARTA",46,192,8,200
https://kawalpemilu.org#25923,"KELAPA GADING BARAT, KELAPA GADING, JAKARTA UTARA, DKI JAKARTA",47,215,17,232
https://kawalpemilu.org#25923,"KELAPA GADING BARAT, KELAPA GADING, JAKARTA UTARA, DKI JAKARTA",48,217,5,222
https://kawalpemilu.org#25923,"KELAPA GADING BARAT, KELAPA GADING, JAKARTA UTARA, DKI JAKARTA",49,207,10,217
https://kawalpemilu.org#25923,"KELAPA GADING BARAT, KELAPA GADING, JAKARTA UTARA, DKI JAKARTA",50,192,15,207
https://kawalpemilu.org#25923,"KELAPA GADING BARAT, KELAPA GADING, JAKARTA UTARA, DKI JAKARTA",51,197,13,210
https://kawalpemilu.org#25923,"KELAPA GADING BARAT, KELAPA GADING, JAKARTA UTARA, DKI JAKARTA",52,196,6,202
https://kawalpemilu.org#25923,"KELAPA GADING BARAT, KELAPA GADING, JAKARTA UTARA, DKI JAKARTA",53,219,19,238
https://kawalpemilu.org#25923,"KELAPA GADING BARAT, KELAPA GADING, JAKARTA UTARA, DKI JAKARTA",54,204,5,209
https://kawalpemilu.org#25923,"KELAPA GADING BARAT, KELAPA GADING, JAKARTA UTARA, DKI JAKARTA",55,202,9,0
https://kawalpemilu.org#25923,"KELAPA GADING BARAT, KELAPA GADING, JAKARTA UTARA, DKI JAKARTA",56,93,106,199
https://kawalpemilu.org#25923,"KELAPA GADING BARAT, KELAPA GADING, JAKARTA UTARA, DKI JAKARTA",57,121,92,213
https://kawalpemilu.org#25923,"KELAPA GADING BARAT, KELAPA GADING, JAKARTA UTARA, DKI JAKARTA",58,98,103,201
https://kawalpemilu.org#25923,"KELAPA GADING BARAT, KELAPA GADING, JAKARTA UTARA, DKI JAKARTA",59,99,116,215
https://kawalpemilu.org#25923,"KELAPA GADING BARAT, KELAPA GADING, JAKARTA UTARA, DKI JAKARTA",60,116,91,207
https://kawalpemilu.org#25923,"KELAPA GADING BARAT, KELAPA GADING, JAKARTA UTARA, DKI JAKARTA",61,86,133,219
https://kawalpemilu.org#25923,"KELAPA GADING BARAT, KELAPA GADING, JAKARTA UTARA, DKI JAKARTA",62,99,131,230
https://kawalpemilu.org#25923,"KELAPA GADING BARAT, KELAPA GADING, JAKARTA UTARA, DKI JAKARTA",63,128,88,216
https://kawalpemilu.org#25923,"KELAPA GADING BARAT, KELAPA GADING, JAKARTA UTARA, DKI JAKARTA",64,118,89,207
https://kawalpemilu.org#25923,"KELAPA GADING BARAT, KELAPA GADING, JAKARTA UTARA, DKI JAKARTA",65,105,110,215
https://kawalpemilu.org#25923,"KELAPA GADING BARAT, KELAPA GADING, JAKARTA UTARA, DKI JAKARTA",66,98,123,221
https://kawalpemilu.org#25923,"KELAPA GADING BARAT, KELAPA GADING, JAKARTA UTARA, DKI JAKARTA",67,183,3,186
https://kawalpemilu.org#25923,"KELAPA GADING BARAT, KELAPA GADING, JAKARTA UTARA, DKI JAKARTA",68,194,7,201
https://kawalpemilu.org#25923,"KELAPA GADING BARAT, KELAPA GADING, JAKARTA UTARA, DKI JAKARTA",69,172,13,185
https://kawalpemilu.org#25923,"KELAPA GADING BARAT, KELAPA GADING, JAKARTA UTARA, DKI JAKARTA",70,189,16,205
https://kawalpemilu.org#25923,"KELAPA GADING BARAT, KELAPA GADING, JAKARTA UTARA, DKI JAKARTA",71,200,5,205
https://kawalpemilu.org#25923,"KELAPA GADING BARAT, KELAPA GADING, JAKARTA UTARA, DKI JAKARTA",72,227,8,235
https://kawalpemilu.org#25923,"KELAPA GADING BARAT, KELAPA GADING, JAKARTA UTARA, DKI JAKARTA",73,206,10,216
https://kawalpemilu.org#25923,"KELAPA GADING BARAT, KELAPA GADING, JAKARTA UTARA, DKI JAKARTA",74,216,8,224
https://kawalpemilu.org#25923,"KELAPA GADING BARAT, KELAPA GADING, JAKARTA UTARA, DKI JAKARTA",75,250,6,256
https://kawalpemilu.org#25923,"KELAPA GADING BARAT, KELAPA GADING, JAKARTA UTARA, DKI JAKARTA",76,208,5,213
https://kawalpemilu.org#25923,"KELAPA GADING BARAT, KELAPA GADING, JAKARTA UTARA, DKI JAKARTA",77,235,4,239
https://kawalpemilu.org#25923,"KELAPA GADING BARAT, KELAPA GADING, JAKARTA UTARA, DKI JAKARTA",78,95,59,154
https://kawalpemilu.org#25923,"KELAPA GADING BARAT, KELAPA GADING, JAKARTA UTARA, DKI JAKARTA",79,179,13,192
https://kawalpemilu.org#25923,"KELAPA GADING BARAT, KELAPA GADING, JAKARTA UTARA, DKI JAKARTA",80,186,18,204
https://kawalpemilu.org#25923,"KELAPA GADING BARAT, KELAPA GADING, JAKARTA UTARA, DKI JAKARTA",81,191,23,214
https://kawalpemilu.org#25923,"KELAPA GADING BARAT, KELAPA GADING, JAKARTA UTARA, DKI JAKARTA",82,180,6,186
https://kawalpemilu.org#25923,"KELAPA GADING BARAT, KELAPA GADING, JAKARTA UTARA, DKI JAKARTA",83,188,11,199
https://kawalpemilu.org#25923,"KELAPA GADING BARAT, KELAPA GADING, JAKARTA UTARA, DKI JAKARTA",84,198,5,203
https://kawalpemilu.org#25923,"KELAPA GADING BARAT, KELAPA GADING, JAKARTA UTARA, DKI JAKARTA",85,180,8,188
https://kawalpemilu.org#25923,"KELAPA GADING BARAT, KELAPA GADING, JAKARTA UTARA, DKI JAKARTA",86,208,8,216
https://kawalpemilu.org#25923,"KELAPA GADING BARAT, KELAPA GADING, JAKARTA UTARA, DKI JAKARTA",87,196,12,208
https://kawalpemilu.org#25923,"KELAPA GADING BARAT, KELAPA GADING, JAKARTA UTARA, DKI JAKARTA",88,181,9,190
https://kawalpemilu.org#25923,"KELAPA GADING BARAT, KELAPA GADING, JAKARTA UTARA, DKI JAKARTA",89,157,13,170
https://kawalpemilu.org#25923,"KELAPA GADING BARAT, KELAPA GADING, JAKARTA UTARA, DKI JAKARTA",90,249,8,257
https://kawalpemilu.org#25923,"KELAPA GADING BARAT, KELAPA GADING, JAKARTA UTARA, DKI JAKARTA",91,228,27,255
https://kawalpemilu.org#25923,"KELAPA GADING BARAT, KELAPA GADING, JAKARTA UTARA, DKI JAKARTA",92,240,22,262
https://kawalpemilu.org#25923,"KELAPA GADING BARAT, KELAPA GADING, JAKARTA UTARA, DKI JAKARTA",93,191,29,220
https://kawalpemilu.org#25923,"KELAPA GADING BARAT, KELAPA GADING, JAKARTA UTARA, DKI JAKARTA",94,263,7,270
https://kawalpemilu.org#25923,"KELAPA GADING BARAT, KELAPA GADING, JAKARTA UTARA, DKI JAKARTA",95,242,31,273
https://kawalpemilu.org#25923,"KELAPA GADING BARAT, KELAPA GADING, JAKARTA UTARA, DKI JAKARTA",96,162,10,172
https://kawalpemilu.org#25923,"KELAPA GADING BARAT, KELAPA GADING, JAKARTA UTARA, DKI JAKARTA",97,155,9,164
https://kawalpemilu.org#25923,"KELAPA GADING BARAT, KELAPA GADING, JAKARTA UTARA, DKI JAKARTA",98,162,15,177
https://kawalpemilu.org#25923,"KELAPA GADING BARAT, KELAPA GADING, JAKARTA UTARA, DKI JAKARTA",99,190,68,258
https://kawalpemilu.org#25923,"KELAPA GADING BARAT, KELAPA GADING, JAKARTA UTARA, DKI JAKARTA",100,171,72,243
https://kawalpemilu.org#25923,"KELAPA GADING BARAT, KELAPA GADING, JAKARTA UTARA, DKI JAKARTA",101,129,75,204
https://kawalpemilu.org#25923,"KELAPA GADING BARAT, KELAPA GADING, JAKARTA UTARA, DKI JAKARTA",102,153,84,237
https://kawalpemilu.org#25923,"KELAPA GADING BARAT, KELAPA GADING, JAKARTA UTARA, DKI JAKARTA",103,204,62,266
https://kawalpemilu.org#25923,"KELAPA GADING BARAT, KELAPA GADING, JAKARTA UTARA, DKI JAKARTA",104,173,66,239
https://kawalpemilu.org#25923,"KELAPA GADING BARAT, KELAPA GADING, JAKARTA UTARA, DKI JAKARTA",105,112,112,224
https://kawalpemilu.org#25923,"KELAPA GADING BARAT, KELAPA GADING, JAKARTA UTARA, DKI JAKARTA",106,70,124,194
https://kawalpemilu.org#25923,"KELAPA GADING BARAT, KELAPA GADING, JAKARTA UTARA, DKI JAKARTA",107,129,89,218
https://kawalpemilu.org#25923,"KELAPA GADING BARAT, KELAPA GADING, JAKARTA UTARA, DKI JAKARTA",108,104,75,179
https://kawalpemilu.org#25923,"KELAPA GADING BARAT, KELAPA GADING, JAKARTA UTARA, DKI JAKARTA",109,70,157,227
https://kawalpemilu.org#25923,"KELAPA GADING BARAT, KELAPA GADING, JAKARTA UTARA, DKI JAKARTA",110,199,9,208
https://kawalpemilu.org#25923,"KELAPA GADING BARAT, KELAPA GADING, JAKARTA UTARA, DKI JAKARTA",111,224,17,241
https://kawalpemilu.org#25923,"KELAPA GADING BARAT, KELAPA GADING, JAKARTA UTARA, DKI JAKARTA",112,195,12,207
https://kawalpemilu.org#25923,"KELAPA GADING BARAT, KELAPA GADING, JAKARTA UTARA, DKI JAKARTA",113,194,11,205
https://kawalpemilu.org#25923,"KELAPA GADING BARAT, KELAPA GADING, JAKARTA UTARA, DKI JAKARTA",114,155,16,171
https://kawalpemilu.org#25923,"KELAPA GADING BARAT, KELAPA GADING, JAKARTA UTARA, DKI JAKARTA",115,67,152,219
https://kawalpemilu.org#25923,"KELAPA GADING BARAT, KELAPA GADING, JAKARTA UTARA, DKI JAKARTA",116,184,67,251
https://kawalpemilu.org#25926,"CENGKARENG BARAT, CENGKARENG, JAKARTA BARAT, DKI JAKARTA",1,129,66,195
https://kawalpemilu.org#25926,"CENGKARENG BARAT, CENGKARENG, JAKARTA BARAT, DKI JAKARTA",2,131,82,213
https://kawalpemilu.org#25926,"CENGKARENG BARAT, CENGKARENG, JAKARTA BARAT, DKI JAKARTA",3,85,122,207
https://kawalpemilu.org#25926,"CENGKARENG BARAT, CENGKARENG, JAKARTA BARAT, DKI JAKARTA",4,121,121,242
https://kawalpemilu.org#25926,"CENGKARENG BARAT, CENGKARENG, JAKARTA BARAT, DKI JAKARTA",5,99,95,194
https://kawalpemilu.org#25926,"CENGKARENG BARAT, CENGKARENG, JAKARTA BARAT, DKI JAKARTA",6,107,135,242
https://kawalpemilu.org#25926,"CENGKARENG BARAT, CENGKARENG, JAKARTA BARAT, DKI JAKARTA",7,137,99,236
https://kawalpemilu.org#25926,"CENGKARENG BARAT, CENGKARENG, JAKARTA BARAT, DKI JAKARTA",8,100,182,282
https://kawalpemilu.org#25926,"CENGKARENG BARAT, CENGKARENG, JAKARTA BARAT, DKI JAKARTA",9,83,60,143
https://kawalpemilu.org#25926,"CENGKARENG BARAT, CENGKARENG, JAKARTA BARAT, DKI JAKARTA",10,94,63,157
https://kawalpemilu.org#25926,"CENGKARENG BARAT, CENGKARENG, JAKARTA BARAT, DKI JAKARTA",11,64,49,113
https://kawalpemilu.org#25926,"CENGKARENG BARAT, CENGKARENG, JAKARTA BARAT, DKI JAKARTA",12,68,69,137
https://kawalpemilu.org#25926,"CENGKARENG BARAT, CENGKARENG, JAKARTA BARAT, DKI JAKARTA",13,201,7,208
https://kawalpemilu.org#25926,"CENGKARENG BARAT, CENGKARENG, JAKARTA BARAT, DKI JAKARTA",14,183,6,189
https://kawalpemilu.org#25926,"CENGKARENG BARAT, CENGKARENG, JAKARTA BARAT, DKI JAKARTA",15,107,98,205
https://kawalpemilu.org#25926,"CENGKARENG BARAT, CENGKARENG, JAKARTA BARAT, DKI JAKARTA",16,115,37,152
https://kawalpemilu.org#25926,"CENGKARENG BARAT, CENGKARENG, JAKARTA BARAT, DKI JAKARTA",17,133,77,210
https://kawalpemilu.org#25926,"CENGKARENG BARAT, CENGKARENG, JAKARTA BARAT, DKI JAKARTA",18,116,104,220
https://kawalpemilu.org#25926,"CENGKARENG BARAT, CENGKARENG, JAKARTA BARAT, DKI JAKARTA",19,131,82,213
https://kawalpemilu.org#25926,"CENGKARENG BARAT, CENGKARENG, JAKARTA BARAT, DKI JAKARTA",20,98,75,173
https://kawalpemilu.org#25926,"CENGKARENG BARAT, CENGKARENG, JAKARTA BARAT, DKI JAKARTA",21,153,118,271
https://kawalpemilu.org#25926,"CENGKARENG BARAT, CENGKARENG, JAKARTA BARAT, DKI JAKARTA",22,94,64,158
https://kawalpemilu.org#25926,"CENGKARENG BARAT, CENGKARENG, JAKARTA BARAT, DKI JAKARTA",23,121,126,247
https://kawalpemilu.org#25926,"CENGKARENG BARAT, CENGKARENG, JAKARTA BARAT, DKI JAKARTA",24,82,153,235
https://kawalpemilu.org#25926,"CENGKARENG BARAT, CENGKARENG, JAKARTA BARAT, DKI JAKARTA",25,160,83,243
https://kawalpemilu.org#25926,"CENGKARENG BARAT, CENGKARENG, JAKARTA BARAT, DKI JAKARTA",26,116,93,209
https://kawalpemilu.org#25926,"CENGKARENG BARAT, CENGKARENG, JAKARTA BARAT, DKI JAKARTA",27,132,71,203
https://kawalpemilu.org#25926,"CENGKARENG BARAT, CENGKARENG, JAKARTA BARAT, DKI JAKARTA",28,123,72,195
https://kawalpemilu.org#25926,"CENGKARENG BARAT, CENGKARENG, JAKARTA BARAT, DKI JAKARTA",29,155,80,235
https://kawalpemilu.org#25926,"CENGKARENG BARAT, CENGKARENG, JAKARTA BARAT, DKI JAKARTA",30,82,68,150
https://kawalpemilu.org#25926,"CENGKARENG BARAT, CENGKARENG, JAKARTA BARAT, DKI JAKARTA",31,93,81,174
https://kawalpemilu.org#25926,"CENGKARENG BARAT, CENGKARENG, JAKARTA BARAT, DKI JAKARTA",32,97,123,220
https://kawalpemilu.org#25926,"CENGKARENG BARAT, CENGKARENG, JAKARTA BARAT, DKI JAKARTA",33,124,113,237
https://kawalpemilu.org#25926,"CENGKARENG BARAT, CENGKARENG, JAKARTA BARAT, DKI JAKARTA",34,115,113,228
https://kawalpemilu.org#25926,"CENGKARENG BARAT, CENGKARENG, JAKARTA BARAT, DKI JAKARTA",35,130,96,226
https://kawalpemilu.org#25926,"CENGKARENG BARAT, CENGKARENG, JAKARTA BARAT, DKI JAKARTA",36,106,100,206
https://kawalpemilu.org#25926,"CENGKARENG BARAT, CENGKARENG, JAKARTA BARAT, DKI JAKARTA",37,107,154,261
https://kawalpemilu.org#25926,"CENGKARENG BARAT, CENGKARENG, JAKARTA BARAT, DKI JAKARTA",38,115,95,210
https://kawalpemilu.org#25926,"CENGKARENG BARAT, CENGKARENG, JAKARTA BARAT, DKI JAKARTA",39,102,127,229
https://kawalpemilu.org#25926,"CENGKARENG BARAT, CENGKARENG, JAKARTA BARAT, DKI JAKARTA",40,151,50,201
https://kawalpemilu.org#25926,"CENGKARENG BARAT, CENGKARENG, JAKARTA BARAT, DKI JAKARTA",41,113,102,215
https://kawalpemilu.org#25926,"CENGKARENG BARAT, CENGKARENG, JAKARTA BARAT, DKI JAKARTA",42,83,96,179
https://kawalpemilu.org#25926,"CENGKARENG BARAT, CENGKARENG, JAKARTA BARAT, DKI JAKARTA",43,84,122,206
https://kawalpemilu.org#25926,"CENGKARENG BARAT, CENGKARENG, JAKARTA BARAT, DKI JAKARTA",44,125,125,250
https://kawalpemilu.org#25926,"CENGKARENG BARAT, CENGKARENG, JAKARTA BARAT, DKI JAKARTA",45,89,116,205
https://kawalpemilu.org#25926,"CENGKARENG BARAT, CENGKARENG, JAKARTA BARAT, DKI JAKARTA",46,94,100,194
https://kawalpemilu.org#25926,"CENGKARENG BARAT, CENGKARENG, JAKARTA BARAT, DKI JAKARTA",47,90,107,197
https://kawalpemilu.org#25926,"CENGKARENG BARAT, CENGKARENG, JAKARTA BARAT, DKI JAKARTA",48,73,143,216
https://kawalpemilu.org#25926,"CENGKARENG BARAT, CENGKARENG, JAKARTA BARAT, DKI JAKARTA",49,72,106,178
https://kawalpemilu.org#25926,"CENGKARENG BARAT, CENGKARENG, JAKARTA BARAT, DKI JAKARTA",50,53,57,110
https://kawalpemilu.org#25926,"CENGKARENG BARAT, CENGKARENG, JAKARTA BARAT, DKI JAKARTA",51,71,172,243
https://kawalpemilu.org#25926,"CENGKARENG BARAT, CENGKARENG, JAKARTA BARAT, DKI JAKARTA",52,94,81,175
https://kawalpemilu.org#25926,"CENGKARENG BARAT, CENGKARENG, JAKARTA BARAT, DKI JAKARTA",53,88,71,159
https://kawalpemilu.org#25926,"CENGKARENG BARAT, CENGKARENG, JAKARTA BARAT, DKI JAKARTA",54,98,117,215
https://kawalpemilu.org#25926,"CENGKARENG BARAT, CENGKARENG, JAKARTA BARAT, DKI JAKARTA",55,70,213,283
https://kawalpemilu.org#25926,"CENGKARENG BARAT, CENGKARENG, JAKARTA BARAT, DKI JAKARTA",56,113,124,237
https://kawalpemilu.org#25926,"CENGKARENG BARAT, CENGKARENG, JAKARTA BARAT, DKI JAKARTA",57,110,129,239
https://kawalpemilu.org#25926,"CENGKARENG BARAT, CENGKARENG, JAKARTA BARAT, DKI JAKARTA",58,107,120,227
https://kawalpemilu.org#25926,"CENGKARENG BARAT, CENGKARENG, JAKARTA BARAT, DKI JAKARTA",59,116,117,233
https://kawalpemilu.org#25926,"CENGKARENG BARAT, CENGKARENG, JAKARTA BARAT, DKI JAKARTA",60,124,117,241
https://kawalpemilu.org#25926,"CENGKARENG BARAT, CENGKARENG, JAKARTA BARAT, DKI JAKARTA",61,121,122,243
https://kawalpemilu.org#25926,"CENGKARENG BARAT, CENGKARENG, JAKARTA BARAT, DKI JAKARTA",62,83,72,155
https://kawalpemilu.org#25926,"CENGKARENG BARAT, CENGKARENG, JAKARTA BARAT, DKI JAKARTA",63,110,115,225
https://kawalpemilu.org#25926,"CENGKARENG BARAT, CENGKARENG, JAKARTA BARAT, DKI JAKARTA",64,114,93,207
https://kawalpemilu.org#25926,"CENGKARENG BARAT, CENGKARENG, JAKARTA BARAT, DKI JAKARTA",65,94,132,226
https://kawalpemilu.org#25926,"CENGKARENG BARAT, CENGKARENG, JAKARTA BARAT, DKI JAKARTA",66,84,124,208
https://kawalpemilu.org#25926,"CENGKARENG BARAT, CENGKARENG, JAKARTA BARAT, DKI JAKARTA",67,116,103,219
https://kawalpemilu.org#25926,"CENGKARENG BARAT, CENGKARENG, JAKARTA BARAT, DKI JAKARTA",68,217,10,227
https://kawalpemilu.org#25926,"CENGKARENG BARAT, CENGKARENG, JAKARTA BARAT, DKI JAKARTA",69,174,6,180
https://kawalpemilu.org#25926,"CENGKARENG BARAT, CENGKARENG, JAKARTA BARAT, DKI JAKARTA",70,226,1,227
https://kawalpemilu.org#25926,"CENGKARENG BARAT, CENGKARENG, JAKARTA BARAT, DKI JAKARTA",71,191,12,203
https://kawalpemilu.org#25926,"CENGKARENG BARAT, CENGKARENG, JAKARTA BARAT, DKI JAKARTA",72,197,4,201
https://kawalpemilu.org#25926,"CENGKARENG BARAT, CENGKARENG, JAKARTA BARAT, DKI JAKARTA",73,43,200,243
https://kawalpemilu.org#25926,"CENGKARENG BARAT, CENGKARENG, JAKARTA BARAT, DKI JAKARTA",74,48,218,266
https://kawalpemilu.org#25926,"CENGKARENG BARAT, CENGKARENG, JAKARTA BARAT, DKI JAKARTA",75,168,131,299
https://kawalpemilu.org#25926,"CENGKARENG BARAT, CENGKARENG, JAKARTA BARAT, DKI JAKARTA",76,70,54,124
https://kawalpemilu.org#25926,"CENGKARENG BARAT, CENGKARENG, JAKARTA BARAT, DKI JAKARTA",77,60,84,144
https://kawalpemilu.org#25926,"CENGKARENG BARAT, CENGKARENG, JAKARTA BARAT, DKI JAKARTA",78,110,118,228
https://kawalpemilu.org#25926,"CENGKARENG BARAT, CENGKARENG, JAKARTA BARAT, DKI JAKARTA",79,120,101,221
https://kawalpemilu.org#25926,"CENGKARENG BARAT, CENGKARENG, JAKARTA BARAT, DKI JAKARTA",80,150,95,245
https://kawalpemilu.org#25926,"CENGKARENG BARAT, CENGKARENG, JAKARTA BARAT, DKI JAKARTA",81,162,84,246
https://kawalpemilu.org#25926,"CENGKARENG BARAT, CENGKARENG, JAKARTA BARAT, DKI JAKARTA",82,142,101,243
https://kawalpemilu.org#25926,"CENGKARENG BARAT, CENGKARENG, JAKARTA BARAT, DKI JAKARTA",83,129,108,237
https://kawalpemilu.org#25926,"CENGKARENG BARAT, CENGKARENG, JAKARTA BARAT, DKI JAKARTA",84,65,97,162
https://kawalpemilu.org#25926,"CENGKARENG BARAT, CENGKARENG, JAKARTA BARAT, DKI JAKARTA",85,92,64,156
https://kawalpemilu.org#25926,"CENGKARENG BARAT, CENGKARENG, JAKARTA BARAT, DKI JAKARTA",86,172,67,239
https://kawalpemilu.org#25926,"CENGKARENG BARAT, CENGKARENG, JAKARTA BARAT, DKI JAKARTA",87,111,96,207
https://kawalpemilu.org#25926,"CENGKARENG BARAT, CENGKARENG, JAKARTA BARAT, DKI JAKARTA",88,94,108,202
https://kawalpemilu.org#25926,"CENGKARENG BARAT, CENGKARENG, JAKARTA BARAT, DKI JAKARTA",89,61,117,178
https://kawalpemilu.org#25926,"CENGKARENG BARAT, CENGKARENG, JAKARTA BARAT, DKI JAKARTA",90,130,130,260
https://kawalpemilu.org#25926,"CENGKARENG BARAT, CENGKARENG, JAKARTA BARAT, DKI JAKARTA",91,105,131,236
https://kawalpemilu.org#25926,"CENGKARENG BARAT, CENGKARENG, JAKARTA BARAT, DKI JAKARTA",92,0,0,0
https://kawalpemilu.org#25926,"CENGKARENG BARAT, CENGKARENG, JAKARTA BARAT, DKI JAKARTA",93,93,148,241
https://kawalpemilu.org#25926,"CENGKARENG BARAT, CENGKARENG, JAKARTA BARAT, DKI JAKARTA",94,103,103,206
https://kawalpemilu.org#25926,"CENGKARENG BARAT, CENGKARENG, JAKARTA BARAT, DKI JAKARTA",95,109,128,237
https://kawalpemilu.org#25926,"CENGKARENG BARAT, CENGKARENG, JAKARTA BARAT, DKI JAKARTA",96,86,98,184
https://kawalpemilu.org#25926,"CENGKARENG BARAT, CENGKARENG, JAKARTA BARAT, DKI JAKARTA",97,108,65,173
https://kawalpemilu.org#25926,"CENGKARENG BARAT, CENGKARENG, JAKARTA BARAT, DKI JAKARTA",98,133,95,228
https://kawalpemilu.org#25926,"CENGKARENG BARAT, CENGKARENG, JAKARTA BARAT, DKI JAKARTA",99,119,97,216
https://kawalpemilu.org#25926,"CENGKARENG BARAT, CENGKARENG, JAKARTA BARAT, DKI JAKARTA",100,113,62,175
https://kawalpemilu.org#25926,"CENGKARENG BARAT, CENGKARENG, JAKARTA BARAT, DKI JAKARTA",101,147,55,202
https://kawalpemilu.org#25926,"CENGKARENG BARAT, CENGKARENG, JAKARTA BARAT, DKI JAKARTA",102,148,52,200
https://kawalpemilu.org#25926,"CENGKARENG BARAT, CENGKARENG, JAKARTA BARAT, DKI JAKARTA",103,138,64,202
https://kawalpemilu.org#25926,"CENGKARENG BARAT, CENGKARENG, JAKARTA BARAT, DKI JAKARTA",104,121,88,209
https://kawalpemilu.org#25926,"CENGKARENG BARAT, CENGKARENG, JAKARTA BARAT, DKI JAKARTA",105,80,76,156
https://kawalpemilu.org#25926,"CENGKARENG BARAT, CENGKARENG, JAKARTA BARAT, DKI JAKARTA",106,75,73,148
https://kawalpemilu.org#25926,"CENGKARENG BARAT, CENGKARENG, JAKARTA BARAT, DKI JAKARTA",107,74,136,210
https://kawalpemilu.org#25926,"CENGKARENG BARAT, CENGKARENG, JAKARTA BARAT, DKI JAKARTA",108,119,80,199
https://kawalpemilu.org#25926,"CENGKARENG BARAT, CENGKARENG, JAKARTA BARAT, DKI JAKARTA",109,93,64,157
https://kawalpemilu.org#25926,"CENGKARENG BARAT, CENGKARENG, JAKARTA BARAT, DKI JAKARTA",110,95,54,149
https://kawalpemilu.org#25926,"CENGKARENG BARAT, CENGKARENG, JAKARTA BARAT, DKI JAKARTA",111,147,89,236
https://kawalpemilu.org#25926,"CENGKARENG BARAT, CENGKARENG, JAKARTA BARAT, DKI JAKARTA",112,131,85,216
https://kawalpemilu.org#25926,"CENGKARENG BARAT, CENGKARENG, JAKARTA BARAT, DKI JAKARTA",113,146,73,219
https://kawalpemilu.org#25926,"CENGKARENG BARAT, CENGKARENG, JAKARTA BARAT, DKI JAKARTA",114,121,90,211
https://kawalpemilu.org#25926,"CENGKARENG BARAT, CENGKARENG, JAKARTA BARAT, DKI JAKARTA",115,145,72,217
https://kawalpemilu.org#25926,"CENGKARENG BARAT, CENGKARENG, JAKARTA BARAT, DKI JAKARTA",116,108,92,200
https://kawalpemilu.org#25926,"CENGKARENG BARAT, CENGKARENG, JAKARTA BARAT, DKI JAKARTA",117,70,80,150
https://kawalpemilu.org#25926,"CENGKARENG BARAT, CENGKARENG, JAKARTA BARAT, DKI JAKARTA",118,100,54,154
https://kawalpemilu.org#25926,"CENGKARENG BARAT, CENGKARENG, JAKARTA BARAT, DKI JAKARTA",119,133,24,157
https://kawalpemilu.org#25926,"CENGKARENG BARAT, CENGKARENG, JAKARTA BARAT, DKI JAKARTA",120,108,45,153
https://kawalpemilu.org#25926,"CENGKARENG BARAT, CENGKARENG, JAKARTA BARAT, DKI JAKARTA",121,76,49,125
https://kawalpemilu.org#25926,"CENGKARENG BARAT, CENGKARENG, JAKARTA BARAT, DKI JAKARTA",122,96,103,199
https://kawalpemilu.org#25926,"CENGKARENG BARAT, CENGKARENG, JAKARTA BARAT, DKI JAKARTA",123,151,10,161
https://kawalpemilu.org#25926,"CENGKARENG BARAT, CENGKARENG, JAKARTA BARAT, DKI JAKARTA",124,152,3,155
https://kawalpemilu.org#25926,"CENGKARENG BARAT, CENGKARENG, JAKARTA BARAT, DKI JAKARTA",125,128,96,224
https://kawalpemilu.org#25926,"CENGKARENG BARAT, CENGKARENG, JAKARTA BARAT, DKI JAKARTA",126,61,61,122
https://kawalpemilu.org#25926,"CENGKARENG BARAT, CENGKARENG, JAKARTA BARAT, DKI JAKARTA",127,122,124,246
https://kawalpemilu.org#25926,"CENGKARENG BARAT, CENGKARENG, JAKARTA BARAT, DKI JAKARTA",128,111,104,215
https://kawalpemilu.org#25926,"CENGKARENG BARAT, CENGKARENG, JAKARTA BARAT, DKI JAKARTA",129,165,79,244
https://kawalpemilu.org#25926,"CENGKARENG BARAT, CENGKARENG, JAKARTA BARAT, DKI JAKARTA",130,137,98,235
https://kawalpemilu.org#25926,"CENGKARENG BARAT, CENGKARENG, JAKARTA BARAT, DKI JAKARTA",131,134,103,237
https://kawalpemilu.org#25926,"CENGKARENG BARAT, CENGKARENG, JAKARTA BARAT, DKI JAKARTA",132,119,79,198
https://kawalpemilu.org#25926,"CENGKARENG BARAT, CENGKARENG, JAKARTA BARAT, DKI JAKARTA",133,110,82,192
https://kawalpemilu.org#25926,"CENGKARENG BARAT, CENGKARENG, JAKARTA BARAT, DKI JAKARTA",134,139,113,252
https://kawalpemilu.org#25926,"CENGKARENG BARAT, CENGKARENG, JAKARTA BARAT, DKI JAKARTA",135,102,93,195
https://kawalpemilu.org#25926,"CENGKARENG BARAT, CENGKARENG, JAKARTA BARAT, DKI JAKARTA",136,100,108,208
https://kawalpemilu.org#25926,"CENGKARENG BARAT, CENGKARENG, JAKARTA BARAT, DKI JAKARTA",137,109,115,224
https://kawalpemilu.org#25926,"CENGKARENG BARAT, CENGKARENG, JAKARTA BARAT, DKI JAKARTA",138,125,124,249
https://kawalpemilu.org#25926,"CENGKARENG BARAT, CENGKARENG, JAKARTA BARAT, DKI JAKARTA",139,126,97,223
https://kawalpemilu.org#25926,"CENGKARENG BARAT, CENGKARENG, JAKARTA BARAT, DKI JAKARTA",140,108,120,228
https://kawalpemilu.org#25926,"CENGKARENG BARAT, CENGKARENG, JAKARTA BARAT, DKI JAKARTA",141,89,103,192
https://kawalpemilu.org#25926,"CENGKARENG BARAT, CENGKARENG, JAKARTA BARAT, DKI JAKARTA",142,122,71,193
https://kawalpemilu.org#25926,"CENGKARENG BARAT, CENGKARENG, JAKARTA BARAT, DKI JAKARTA",143,110,87,197
https://kawalpemilu.org#25926,"CENGKARENG BARAT, CENGKARENG, JAKARTA BARAT, DKI JAKARTA",144,134,95,229
https://kawalpemilu.org#25926,"CENGKARENG BARAT, CENGKARENG, JAKARTA BARAT, DKI JAKARTA",145,79,60,139
https://kawalpemilu.org#25926,"CENGKARENG BARAT, CENGKARENG, JAKARTA BARAT, DKI JAKARTA",146,127,77,204
https://kawalpemilu.org#25926,"CENGKARENG BARAT, CENGKARENG, JAKARTA BARAT, DKI JAKARTA",147,115,124,239
https://kawalpemilu.org#25926,"CENGKARENG BARAT, CENGKARENG, JAKARTA BARAT, DKI JAKARTA",148,88,66,154
https://kawalpemilu.org#25926,"CENGKARENG BARAT, CENGKARENG, JAKARTA BARAT, DKI JAKARTA",149,150,86,236
https://kawalpemilu.org#25926,"CENGKARENG BARAT, CENGKARENG, JAKARTA BARAT, DKI JAKARTA",150,95,54,149
https://kawalpemilu.org#25926,"CENGKARENG BARAT, CENGKARENG, JAKARTA BARAT, DKI JAKARTA",151,126,55,181
https://kawalpemilu.org#25926,"CENGKARENG BARAT, CENGKARENG, JAKARTA BARAT, DKI JAKARTA",152,123,87,210
https://kawalpemilu.org#25926,"CENGKARENG BARAT, CENGKARENG, JAKARTA BARAT, DKI JAKARTA",153,130,107,237
https://kawalpemilu.org#25926,"CENGKARENG BARAT, CENGKARENG, JAKARTA BARAT, DKI JAKARTA",154,114,93,207
https://kawalpemilu.org#25926,"CENGKARENG BARAT, CENGKARENG, JAKARTA BARAT, DKI JAKARTA",155,109,164,273
https://kawalpemilu.org#25926,"CENGKARENG BARAT, CENGKARENG, JAKARTA BARAT, DKI JAKARTA",156,99,135,234
https://kawalpemilu.org#25926,"CENGKARENG BARAT, CENGKARENG, JAKARTA BARAT, DKI JAKARTA",157,113,151,264
https://kawalpemilu.org#25926,"CENGKARENG BARAT, CENGKARENG, JAKARTA BARAT, DKI JAKARTA",158,137,149,286
https://kawalpemilu.org#25926,"CENGKARENG BARAT, CENGKARENG, JAKARTA BARAT, DKI JAKARTA",159,118,128,246
https://kawalpemilu.org#25926,"CENGKARENG BARAT, CENGKARENG, JAKARTA BARAT, DKI JAKARTA",160,123,117,240
https://kawalpemilu.org#25926,"CENGKARENG BARAT, CENGKARENG, JAKARTA BARAT, DKI JAKARTA",161,100,89,189
https://kawalpemilu.org#25926,"CENGKARENG BARAT, CENGKARENG, JAKARTA BARAT, DKI JAKARTA",162,77,97,174
https://kawalpemilu.org#25926,"CENGKARENG BARAT, CENGKARENG, JAKARTA BARAT, DKI JAKARTA",163,121,92,213
https://kawalpemilu.org#25926,"CENGKARENG BARAT, CENGKARENG, JAKARTA BARAT, DKI JAKARTA",164,98,95,193
https://kawalpemilu.org#25926,"CENGKARENG BARAT, CENGKARENG, JAKARTA BARAT, DKI JAKARTA",165,94,104,198
https://kawalpemilu.org#25926,"CENGKARENG BARAT, CENGKARENG, JAKARTA BARAT, DKI JAKARTA",166,91,104,195
https://kawalpemilu.org#25926,"CENGKARENG BARAT, CENGKARENG, JAKARTA BARAT, DKI JAKARTA",167,110,93,203
https://kawalpemilu.org#25926,"CENGKARENG BARAT, CENGKARENG, JAKARTA BARAT, DKI JAKARTA",168,103,80,183
https://kawalpemilu.org#25926,"CENGKARENG BARAT, CENGKARENG, JAKARTA BARAT, DKI JAKARTA",169,117,56,173
https://kawalpemilu.org#25926,"CENGKARENG BARAT, CENGKARENG, JAKARTA BARAT, DKI JAKARTA",170,120,104,224
https://kawalpemilu.org#25926,"CENGKARENG BARAT, CENGKARENG, JAKARTA BARAT, DKI JAKARTA",171,144,100,244
https://kawalpemilu.org#25926,"CENGKARENG BARAT, CENGKARENG, JAKARTA BARAT, DKI JAKARTA",172,181,57,238
https://kawalpemilu.org#25926,"CENGKARENG BARAT, CENGKARENG, JAKARTA BARAT, DKI JAKARTA",173,179,64,243
https://kawalpemilu.org#25926,"CENGKARENG BARAT, CENGKARENG, JAKARTA BARAT, DKI JAKARTA",174,191,63,254
https://kawalpemilu.org#25926,"CENGKARENG BARAT, CENGKARENG, JAKARTA BARAT, DKI JAKARTA",175,105,101,206
https://kawalpemilu.org#25926,"CENGKARENG BARAT, CENGKARENG, JAKARTA BARAT, DKI JAKARTA",176,215,23,238
https://kawalpemilu.org#25926,"CENGKARENG BARAT, CENGKARENG, JAKARTA BARAT, DKI JAKARTA",177,164,93,257
https://kawalpemilu.org#25926,"CENGKARENG BARAT, CENGKARENG, JAKARTA BARAT, DKI JAKARTA",178,210,7,217
https://kawalpemilu.org#25926,"CENGKARENG BARAT, CENGKARENG, JAKARTA BARAT, DKI JAKARTA",179,138,96,234
https://kawalpemilu.org#25926,"CENGKARENG BARAT, CENGKARENG, JAKARTA BARAT, DKI JAKARTA",180,155,96,251
https://kawalpemilu.org#25926,"CENGKARENG BARAT, CENGKARENG, JAKARTA BARAT, DKI JAKARTA",181,173,80,253
https://kawalpemilu.org#25926,"CENGKARENG BARAT, CENGKARENG, JAKARTA BARAT, DKI JAKARTA",182,146,57,203
https://kawalpemilu.org#25926,"CENGKARENG BARAT, CENGKARENG, JAKARTA BARAT, DKI JAKARTA",183,122,5,127
https://kawalpemilu.org#25926,"CENGKARENG BARAT, CENGKARENG, JAKARTA BARAT, DKI JAKARTA",184,213,19,232
https://kawalpemilu.org#25926,"CENGKARENG BARAT, CENGKARENG, JAKARTA BARAT, DKI JAKARTA",185,189,32,221
https://kawalpemilu.org#25926,"CENGKARENG BARAT, CENGKARENG, JAKARTA BARAT, DKI JAKARTA",186,185,16,201
https://kawalpemilu.org#25926,"CENGKARENG BARAT, CENGKARENG, JAKARTA BARAT, DKI JAKARTA",187,210,7,217
https://kawalpemilu.org#25926,"CENGKARENG BARAT, CENGKARENG, JAKARTA BARAT, DKI JAKARTA",188,120,4,124
https://kawalpemilu.org#25926,"CENGKARENG BARAT, CENGKARENG, JAKARTA BARAT, DKI JAKARTA",189,162,2,164
https://kawalpemilu.org#25926,"CENGKARENG BARAT, CENGKARENG, JAKARTA BARAT, DKI JAKARTA",190,178,6,184
https://kawalpemilu.org#25926,"CENGKARENG BARAT, CENGKARENG, JAKARTA BARAT, DKI JAKARTA",191,183,3,186
https://kawalpemilu.org#25926,"CENGKARENG BARAT, CENGKARENG, JAKARTA BARAT, DKI JAKARTA",192,155,1,156
https://kawalpemilu.org#25926,"CENGKARENG BARAT, CENGKARENG, JAKARTA BARAT, DKI JAKARTA",193,238,11,249
https://kawalpemilu.org#25926,"CENGKARENG BARAT, CENGKARENG, JAKARTA BARAT, DKI JAKARTA",194,145,1,146
https://kawalpemilu.org#25926,"CENGKARENG BARAT, CENGKARENG, JAKARTA BARAT, DKI JAKARTA",195,174,10,184
https://kawalpemilu.org#25926,"CENGKARENG BARAT, CENGKARENG, JAKARTA BARAT, DKI JAKARTA",196,97,98,195
https://kawalpemilu.org#25926,"CENGKARENG BARAT, CENGKARENG, JAKARTA BARAT, DKI JAKARTA",197,73,99,172
https://kawalpemilu.org#25926,"CENGKARENG BARAT, CENGKARENG, JAKARTA BARAT, DKI JAKARTA",198,115,126,241
https://kawalpemilu.org#25926,"CENGKARENG BARAT, CENGKARENG, JAKARTA BARAT, DKI JAKARTA",199,134,101,235
https://kawalpemilu.org#25926,"CENGKARENG BARAT, CENGKARENG, JAKARTA BARAT, DKI JAKARTA",200,171,82,253
https://kawalpemilu.org#25926,"CENGKARENG BARAT, CENGKARENG, JAKARTA BARAT, DKI JAKARTA",201,137,132,269
https://kawalpemilu.org#25926,"CENGKARENG BARAT, CENGKARENG, JAKARTA BARAT, DKI JAKARTA",202,135,97,232
https://kawalpemilu.org#25926,"CENGKARENG BARAT, CENGKARENG, JAKARTA BARAT, DKI JAKARTA",203,217,17,234
https://kawalpemilu.org#25926,"CENGKARENG BARAT, CENGKARENG, JAKARTA BARAT, DKI JAKARTA",204,232,4,236
https://kawalpemilu.org#25926,"CENGKARENG BARAT, CENGKARENG, JAKARTA BARAT, DKI JAKARTA",205,184,6,190
https://kawalpemilu.org#25926,"CENGKARENG BARAT, CENGKARENG, JAKARTA BARAT, DKI JAKARTA",206,175,2,177
https://kawalpemilu.org#25926,"CENGKARENG BARAT, CENGKARENG, JAKARTA BARAT, DKI JAKARTA",207,236,5,241
https://kawalpemilu.org#25926,"CENGKARENG BARAT, CENGKARENG, JAKARTA BARAT, DKI JAKARTA",208,111,1,112
https://kawalpemilu.org#25926,"CENGKARENG BARAT, CENGKARENG, JAKARTA BARAT, DKI JAKARTA",209,254,11,265
https://kawalpemilu.org#25926,"CENGKARENG BARAT, CENGKARENG, JAKARTA BARAT, DKI JAKARTA",210,220,5,225
https://kawalpemilu.org#25926,"CENGKARENG BARAT, CENGKARENG, JAKARTA BARAT, DKI JAKARTA",211,246,9,255
https://kawalpemilu.org#25926,"CENGKARENG BARAT, CENGKARENG, JAKARTA BARAT, DKI JAKARTA",212,136,0,136
https://kawalpemilu.org#25926,"CENGKARENG BARAT, CENGKARENG, JAKARTA BARAT, DKI JAKARTA",213,226,3,229
https://kawalpemilu.org#25926,"CENGKARENG BARAT, CENGKARENG, JAKARTA BARAT, DKI JAKARTA",214,218,2,220
https://kawalpemilu.org#25926,"CENGKARENG BARAT, CENGKARENG, JAKARTA BARAT, DKI JAKARTA",215,171,11,182
https://kawalpemilu.org#25926,"CENGKARENG BARAT, CENGKARENG, JAKARTA BARAT, DKI JAKARTA",216,199,1,200
https://kawalpemilu.org#25926,"CENGKARENG BARAT, CENGKARENG, JAKARTA BARAT, DKI JAKARTA",217,147,2,149
https://kawalpemilu.org#25926,"CENGKARENG BARAT, CENGKARENG, JAKARTA BARAT, DKI JAKARTA",218,228,3,231
https://kawalpemilu.org#25926,"CENGKARENG BARAT, CENGKARENG, JAKARTA BARAT, DKI JAKARTA",219,184,6,190
https://kawalpemilu.org#25926,"CENGKARENG BARAT, CENGKARENG, JAKARTA BARAT, DKI JAKARTA",220,161,2,163
https://kawalpemilu.org#25926,"CENGKARENG BARAT, CENGKARENG, JAKARTA BARAT, DKI JAKARTA",221,84,78,162
https://kawalpemilu.org#25926,"CENGKARENG BARAT, CENGKARENG, JAKARTA BARAT, DKI JAKARTA",222,80,48,128
https://kawalpemilu.org#25926,"CENGKARENG BARAT, CENGKARENG, JAKARTA BARAT, DKI JAKARTA",223,44,75,119
https://kawalpemilu.org#25926,"CENGKARENG BARAT, CENGKARENG, JAKARTA BARAT, DKI JAKARTA",224,25,76,101
https://kawalpemilu.org#25926,"CENGKARENG BARAT, CENGKARENG, JAKARTA BARAT, DKI JAKARTA",225,29,156,185
https://kawalpemilu.org#25926,"CENGKARENG BARAT, CENGKARENG, JAKARTA BARAT, DKI JAKARTA",226,58,40,98
https://kawalpemilu.org#25927,"DURI KOSAMBI, CENGKARENG, JAKARTA BARAT, DKI JAKARTA",1,82,133,215
https://kawalpemilu.org#25927,"DURI KOSAMBI, CENGKARENG, JAKARTA BARAT, DKI JAKARTA",2,74,164,238
https://kawalpemilu.org#25927,"DURI KOSAMBI, CENGKARENG, JAKARTA BARAT, DKI JAKARTA",3,50,147,197
https://kawalpemilu.org#25927,"DURI KOSAMBI, CENGKARENG, JAKARTA BARAT, DKI JAKARTA",4,49,180,229
https://kawalpemilu.org#25927,"DURI KOSAMBI, CENGKARENG, JAKARTA BARAT, DKI JAKARTA",5,77,155,232
https://kawalpemilu.org#25927,"DURI KOSAMBI, CENGKARENG, JAKARTA BARAT, DKI JAKARTA",6,93,138,231
https://kawalpemilu.org#25927,"DURI KOSAMBI, CENGKARENG, JAKARTA BARAT, DKI JAKARTA",7,103,110,213
https://kawalpemilu.org#25927,"DURI KOSAMBI, CENGKARENG, JAKARTA BARAT, DKI JAKARTA",8,49,158,207
https://kawalpemilu.org#25927,"DURI KOSAMBI, CENGKARENG, JAKARTA BARAT, DKI JAKARTA",9,67,142,209
https://kawalpemilu.org#25927,"DURI KOSAMBI, CENGKARENG, JAKARTA BARAT, DKI JAKARTA",10,48,197,245
https://kawalpemilu.org#25927,"DURI KOSAMBI, CENGKARENG, JAKARTA BARAT, DKI JAKARTA",11,80,152,232
https://kawalpemilu.org#25927,"DURI KOSAMBI, CENGKARENG, JAKARTA BARAT, DKI JAKARTA",12,118,173,291
https://kawalpemilu.org#25927,"DURI KOSAMBI, CENGKARENG, JAKARTA BARAT, DKI JAKARTA",13,110,155,265
https://kawalpemilu.org#25927,"DURI KOSAMBI, CENGKARENG, JAKARTA BARAT, DKI JAKARTA",14,85,123,208
https://kawalpemilu.org#25927,"DURI KOSAMBI, CENGKARENG, JAKARTA BARAT, DKI JAKARTA",15,95,142,237
https://kawalpemilu.org#25927,"DURI KOSAMBI, CENGKARENG, JAKARTA BARAT, DKI JAKARTA",16,93,147,240
https://kawalpemilu.org#25927,"DURI KOSAMBI, CENGKARENG, JAKARTA BARAT, DKI JAKARTA",17,63,127,190
https://kawalpemilu.org#25927,"DURI KOSAMBI, CENGKARENG, JAKARTA BARAT, DKI JAKARTA",18,75,98,173
https://kawalpemilu.org#25927,"DURI KOSAMBI, CENGKARENG, JAKARTA BARAT, DKI JAKARTA",19,62,112,174
https://kawalpemilu.org#25927,"DURI KOSAMBI, CENGKARENG, JAKARTA BARAT, DKI JAKARTA",20,79,117,196
https://kawalpemilu.org#25927,"DURI KOSAMBI, CENGKARENG, JAKARTA BARAT, DKI JAKARTA",21,102,128,230
https://kawalpemilu.org#25927,"DURI KOSAMBI, CENGKARENG, JAKARTA BARAT, DKI JAKARTA",22,88,69,157
https://kawalpemilu.org#25927,"DURI KOSAMBI, CENGKARENG, JAKARTA BARAT, DKI JAKARTA",23,99,160,259
https://kawalpemilu.org#25927,"DURI KOSAMBI, CENGKARENG, JAKARTA BARAT, DKI JAKARTA",24,107,148,255
https://kawalpemilu.org#25927,"DURI KOSAMBI, CENGKARENG, JAKARTA BARAT, DKI JAKARTA",25,104,156,260
https://kawalpemilu.org#25927,"DURI KOSAMBI, CENGKARENG, JAKARTA BARAT, DKI JAKARTA",26,107,162,269
https://kawalpemilu.org#25927,"DURI KOSAMBI, CENGKARENG, JAKARTA BARAT, DKI JAKARTA",27,110,119,229
https://kawalpemilu.org#25927,"DURI KOSAMBI, CENGKARENG, JAKARTA BARAT, DKI JAKARTA",28,111,155,266
https://kawalpemilu.org#25927,"DURI KOSAMBI, CENGKARENG, JAKARTA BARAT, DKI JAKARTA",29,106,141,247
https://kawalpemilu.org#25927,"DURI KOSAMBI, CENGKARENG, JAKARTA BARAT, DKI JAKARTA",30,138,129,267
https://kawalpemilu.org#25927,"DURI KOSAMBI, CENGKARENG, JAKARTA BARAT, DKI JAKARTA",31,103,131,234
https://kawalpemilu.org#25927,"DURI KOSAMBI, CENGKARENG, JAKARTA BARAT, DKI JAKARTA",32,76,157,233
https://kawalpemilu.org#25927,"DURI KOSAMBI, CENGKARENG, JAKARTA BARAT, DKI JAKARTA",33,120,103,223
https://kawalpemilu.org#25927,"DURI KOSAMBI, CENGKARENG, JAKARTA BARAT, DKI JAKARTA",34,103,79,182
https://kawalpemilu.org#25927,"DURI KOSAMBI, CENGKARENG, JAKARTA BARAT, DKI JAKARTA",35,127,64,191
https://kawalpemilu.org#25927,"DURI KOSAMBI, CENGKARENG, JAKARTA BARAT, DKI JAKARTA",36,105,73,178
https://kawalpemilu.org#25927,"DURI KOSAMBI, CENGKARENG, JAKARTA BARAT, DKI JAKARTA",37,86,99,185
https://kawalpemilu.org#25927,"DURI KOSAMBI, CENGKARENG, JAKARTA BARAT, DKI JAKARTA",38,57,122,179
https://kawalpemilu.org#25927,"DURI KOSAMBI, CENGKARENG, JAKARTA BARAT, DKI JAKARTA",39,47,183,230
https://kawalpemilu.org#25927,"DURI KOSAMBI, CENGKARENG, JAKARTA BARAT, DKI JAKARTA",40,57,140,197
https://kawalpemilu.org#25927,"DURI KOSAMBI, CENGKARENG, JAKARTA BARAT, DKI JAKARTA",41,61,162,223
https://kawalpemilu.org#25927,"DURI KOSAMBI, CENGKARENG, JAKARTA BARAT, DKI JAKARTA",42,52,158,210
https://kawalpemilu.org#25927,"DURI KOSAMBI, CENGKARENG, JAKARTA BARAT, DKI JAKARTA",43,54,182,236
https://kawalpemilu.org#25927,"DURI KOSAMBI, CENGKARENG, JAKARTA BARAT, DKI JAKARTA",44,46,181,227
https://kawalpemilu.org#25927,"DURI KOSAMBI, CENGKARENG, JAKARTA BARAT, DKI JAKARTA",45,93,162,255
https://kawalpemilu.org#25927,"DURI KOSAMBI, CENGKARENG, JAKARTA BARAT, DKI JAKARTA",46,87,141,228
https://kawalpemilu.org#25927,"DURI KOSAMBI, CENGKARENG, JAKARTA BARAT, DKI JAKARTA",47,78,171,249
https://kawalpemilu.org#25927,"DURI KOSAMBI, CENGKARENG, JAKARTA BARAT, DKI JAKARTA",48,70,149,219
https://kawalpemilu.org#25927,"DURI KOSAMBI, CENGKARENG, JAKARTA BARAT, DKI JAKARTA",49,46,132,178
https://kawalpemilu.org#25927,"DURI KOSAMBI, CENGKARENG, JAKARTA BARAT, DKI JAKARTA",50,70,154,224
https://kawalpemilu.org#25927,"DURI KOSAMBI, CENGKARENG, JAKARTA BARAT, DKI JAKARTA",51,59,126,185
https://kawalpemilu.org#25927,"DURI KOSAMBI, CENGKARENG, JAKARTA BARAT, DKI JAKARTA",52,80,147,227
https://kawalpemilu.org#25927,"DURI KOSAMBI, CENGKARENG, JAKARTA BARAT, DKI JAKARTA",53,83,185,268
https://kawalpemilu.org#25927,"DURI KOSAMBI, CENGKARENG, JAKARTA BARAT, DKI JAKARTA",54,68,141,209
https://kawalpemilu.org#25927,"DURI KOSAMBI, CENGKARENG, JAKARTA BARAT, DKI JAKARTA",55,67,125,192
https://kawalpemilu.org#25927,"DURI KOSAMBI, CENGKARENG, JAKARTA BARAT, DKI JAKARTA",56,86,109,195
https://kawalpemilu.org#25927,"DURI KOSAMBI, CENGKARENG, JAKARTA BARAT, DKI JAKARTA",57,79,106,185
https://kawalpemilu.org#25927,"DURI KOSAMBI, CENGKARENG, JAKARTA BARAT, DKI JAKARTA",58,86,132,218
https://kawalpemilu.org#25927,"DURI KOSAMBI, CENGKARENG, JAKARTA BARAT, DKI JAKARTA",59,107,114,221
https://kawalpemilu.org#25927,"DURI KOSAMBI, CENGKARENG, JAKARTA BARAT, DKI JAKARTA",60,79,115,194
https://kawalpemilu.org#25927,"DURI KOSAMBI, CENGKARENG, JAKARTA BARAT, DKI JAKARTA",61,76,126,202
https://kawalpemilu.org#25927,"DURI KOSAMBI, CENGKARENG, JAKARTA BARAT, DKI JAKARTA",62,65,136,201
https://kawalpemilu.org#25927,"DURI KOSAMBI, CENGKARENG, JAKARTA BARAT, DKI JAKARTA",63,69,154,223
https://kawalpemilu.org#25927,"DURI KOSAMBI, CENGKARENG, JAKARTA BARAT, DKI JAKARTA",64,91,89,180
https://kawalpemilu.org#25927,"DURI KOSAMBI, CENGKARENG, JAKARTA BARAT, DKI JAKARTA",65,106,101,207
https://kawalpemilu.org#25927,"DURI KOSAMBI, CENGKARENG, JAKARTA BARAT, DKI JAKARTA",66,95,105,200
https://kawalpemilu.org#25927,"DURI KOSAMBI, CENGKARENG, JAKARTA BARAT, DKI JAKARTA",67,95,135,230
https://kawalpemilu.org#25927,"DURI KOSAMBI, CENGKARENG, JAKARTA BARAT, DKI JAKARTA",68,83,122,205
https://kawalpemilu.org#25927,"DURI KOSAMBI, CENGKARENG, JAKARTA BARAT, DKI JAKARTA",69,60,102,162
https://kawalpemilu.org#25927,"DURI KOSAMBI, CENGKARENG, JAKARTA BARAT, DKI JAKARTA",70,78,135,213
https://kawalpemilu.org#25927,"DURI KOSAMBI, CENGKARENG, JAKARTA BARAT, DKI JAKARTA",71,81,114,195
https://kawalpemilu.org#25927,"DURI KOSAMBI, CENGKARENG, JAKARTA BARAT, DKI JAKARTA",72,80,174,254
https://kawalpemilu.org#25927,"DURI KOSAMBI, CENGKARENG, JAKARTA BARAT, DKI JAKARTA",73,87,174,261
https://kawalpemilu.org#25927,"DURI KOSAMBI, CENGKARENG, JAKARTA BARAT, DKI JAKARTA",74,56,159,215
https://kawalpemilu.org#25927,"DURI KOSAMBI, CENGKARENG, JAKARTA BARAT, DKI JAKARTA",75,60,171,231
https://kawalpemilu.org#25927,"DURI KOSAMBI, CENGKARENG, JAKARTA BARAT, DKI JAKARTA",76,48,198,246
https://kawalpemilu.org#25927,"DURI KOSAMBI, CENGKARENG, JAKARTA BARAT, DKI JAKARTA",77,71,180,251
https://kawalpemilu.org#25927,"DURI KOSAMBI, CENGKARENG, JAKARTA BARAT, DKI JAKARTA",78,45,166,211
https://kawalpemilu.org#25927,"DURI KOSAMBI, CENGKARENG, JAKARTA BARAT, DKI JAKARTA",79,57,135,192
https://kawalpemilu.org#25927,"DURI KOSAMBI, CENGKARENG, JAKARTA BARAT, DKI JAKARTA",80,106,126,232
https://kawalpemilu.org#25927,"DURI KOSAMBI, CENGKARENG, JAKARTA BARAT, DKI JAKARTA",81,83,127,210
https://kawalpemilu.org#25927,"DURI KOSAMBI, CENGKARENG, JAKARTA BARAT, DKI JAKARTA",82,56,127,183
https://kawalpemilu.org#25927,"DURI KOSAMBI, CENGKARENG, JAKARTA BARAT, DKI JAKARTA",83,51,94,145
https://kawalpemilu.org#25927,"DURI KOSAMBI, CENGKARENG, JAKARTA BARAT, DKI JAKARTA",84,99,149,248
https://kawalpemilu.org#25927,"DURI KOSAMBI, CENGKARENG, JAKARTA BARAT, DKI JAKARTA",85,108,132,240
https://kawalpemilu.org#25927,"DURI KOSAMBI, CENGKARENG, JAKARTA BARAT, DKI JAKARTA",86,98,134,232
https://kawalpemilu.org#25927,"DURI KOSAMBI, CENGKARENG, JAKARTA BARAT, DKI JAKARTA",87,99,142,241
https://kawalpemilu.org#25927,"DURI KOSAMBI, CENGKARENG, JAKARTA BARAT, DKI JAKARTA",88,82,111,193
https://kawalpemilu.org#25927,"DURI KOSAMBI, CENGKARENG, JAKARTA BARAT, DKI JAKARTA",89,77,95,172
https://kawalpemilu.org#25927,"DURI KOSAMBI, CENGKARENG, JAKARTA BARAT, DKI JAKARTA",90,84,164,248
https://kawalpemilu.org#25927,"DURI KOSAMBI, CENGKARENG, JAKARTA BARAT, DKI JAKARTA",91,95,161,256
https://kawalpemilu.org#25927,"DURI KOSAMBI, CENGKARENG, JAKARTA BARAT, DKI JAKARTA",92,101,120,221
https://kawalpemilu.org#25927,"DURI KOSAMBI, CENGKARENG, JAKARTA BARAT, DKI JAKARTA",93,68,89,157
https://kawalpemilu.org#25927,"DURI KOSAMBI, CENGKARENG, JAKARTA BARAT, DKI JAKARTA",94,91,138,229
https://kawalpemilu.org#25927,"DURI KOSAMBI, CENGKARENG, JAKARTA BARAT, DKI JAKARTA",95,51,80,131
https://kawalpemilu.org#25927,"DURI KOSAMBI, CENGKARENG, JAKARTA BARAT, DKI JAKARTA",96,121,104,225
https://kawalpemilu.org#25927,"DURI KOSAMBI, CENGKARENG, JAKARTA BARAT, DKI JAKARTA",97,108,133,241
https://kawalpemilu.org#25927,"DURI KOSAMBI, CENGKARENG, JAKARTA BARAT, DKI JAKARTA",98,124,88,212
https://kawalpemilu.org#25927,"DURI KOSAMBI, CENGKARENG, JAKARTA BARAT, DKI JAKARTA",99,131,104,235
https://kawalpemilu.org#25927,"DURI KOSAMBI, CENGKARENG, JAKARTA BARAT, DKI JAKARTA",100,177,116,293
https://kawalpemilu.org#25927,"DURI KOSAMBI, CENGKARENG, JAKARTA BARAT, DKI JAKARTA",101,144,102,246
https://kawalpemilu.org#25927,"DURI KOSAMBI, CENGKARENG, JAKARTA BARAT, DKI JAKARTA",102,183,64,247
https://kawalpemilu.org#25927,"DURI KOSAMBI, CENGKARENG, JAKARTA BARAT, DKI JAKARTA",103,195,78,273
https://kawalpemilu.org#25927,"DURI KOSAMBI, CENGKARENG, JAKARTA BARAT, DKI JAKARTA",104,162,97,259
https://kawalpemilu.org#25927,"DURI KOSAMBI, CENGKARENG, JAKARTA BARAT, DKI JAKARTA",105,161,61,222
https://kawalpemilu.org#25927,"DURI KOSAMBI, CENGKARENG, JAKARTA BARAT, DKI JAKARTA",106,131,107,238
https://kawalpemilu.org#25927,"DURI KOSAMBI, CENGKARENG, JAKARTA BARAT, DKI JAKARTA",107,113,138,251
https://kawalpemilu.org#25927,"DURI KOSAMBI, CENGKARENG, JAKARTA BARAT, DKI JAKARTA",108,150,145,295
https://kawalpemilu.org#25927,"DURI KOSAMBI, CENGKARENG, JAKARTA BARAT, DKI JAKARTA",109,119,116,235
https://kawalpemilu.org#25927,"DURI KOSAMBI, CENGKARENG, JAKARTA BARAT, DKI JAKARTA",110,117,104,221
https://kawalpemilu.org#25927,"DURI KOSAMBI, CENGKARENG, JAKARTA BARAT, DKI JAKARTA",111,87,123,210
https://kawalpemilu.org#25927,"DURI KOSAMBI, CENGKARENG, JAKARTA BARAT, DKI JAKARTA",112,93,138,231
https://kawalpemilu.org#25927,"DURI KOSAMBI, CENGKARENG, JAKARTA BARAT, DKI JAKARTA",113,99,132,231
https://kawalpemilu.org#25927,"DURI KOSAMBI, CENGKARENG, JAKARTA BARAT, DKI JAKARTA",114,105,82,187
https://kawalpemilu.org#25927,"DURI KOSAMBI, CENGKARENG, JAKARTA BARAT, DKI JAKARTA",115,93,77,170
https://kawalpemilu.org#25927,"DURI KOSAMBI, CENGKARENG, JAKARTA BARAT, DKI JAKARTA",116,132,114,246
https://kawalpemilu.org#25927,"DURI KOSAMBI, CENGKARENG, JAKARTA BARAT, DKI JAKARTA",117,128,104,232
https://kawalpemilu.org#25927,"DURI KOSAMBI, CENGKARENG, JAKARTA BARAT, DKI JAKARTA",118,93,85,178
https://kawalpemilu.org#25927,"DURI KOSAMBI, CENGKARENG, JAKARTA BARAT, DKI JAKARTA",119,72,66,138
https://kawalpemilu.org#25927,"DURI KOSAMBI, CENGKARENG, JAKARTA BARAT, DKI JAKARTA",120,83,71,154
https://kawalpemilu.org#25927,"DURI KOSAMBI, CENGKARENG, JAKARTA BARAT, DKI JAKARTA",121,94,109,203
https://kawalpemilu.org#25927,"DURI KOSAMBI, CENGKARENG, JAKARTA BARAT, DKI JAKARTA",122,80,78,158
https://kawalpemilu.org#25927,"DURI KOSAMBI, CENGKARENG, JAKARTA BARAT, DKI JAKARTA",123,107,95,202
https://kawalpemilu.org#25927,"DURI KOSAMBI, CENGKARENG, JAKARTA BARAT, DKI JAKARTA",124,105,108,213
https://kawalpemilu.org#25927,"DURI KOSAMBI, CENGKARENG, JAKARTA BARAT, DKI JAKARTA",125,118,72,190
https://kawalpemilu.org#25927,"DURI KOSAMBI, CENGKARENG, JAKARTA BARAT, DKI JAKARTA",126,127,121,248
https://kawalpemilu.org#25927,"DURI KOSAMBI, CENGKARENG, JAKARTA BARAT, DKI JAKARTA",127,105,121,226
https://kawalpemilu.org#25927,"DURI KOSAMBI, CENGKARENG, JAKARTA BARAT, DKI JAKARTA",128,83,89,172
https://kawalpemilu.org#25927,"DURI KOSAMBI, CENGKARENG, JAKARTA BARAT, DKI JAKARTA",129,97,97,194
https://kawalpemilu.org#25927,"DURI KOSAMBI, CENGKARENG, JAKARTA BARAT, DKI JAKARTA",130,82,94,176
https://kawalpemilu.org#25927,"DURI KOSAMBI, CENGKARENG, JAKARTA BARAT, DKI JAKARTA",131,63,53,116
https://kawalpemilu.org#25927,"DURI KOSAMBI, CENGKARENG, JAKARTA BARAT, DKI JAKARTA",132,58,63,121
https://kawalpemilu.org#25927,"DURI KOSAMBI, CENGKARENG, JAKARTA BARAT, DKI JAKARTA",133,109,149,258
https://kawalpemilu.org#25927,"DURI KOSAMBI, CENGKARENG, JAKARTA BARAT, DKI JAKARTA",134,143,82,225
https://kawalpemilu.org#25927,"DURI KOSAMBI, CENGKARENG, JAKARTA BARAT, DKI JAKARTA",135,0,0,0
https://kawalpemilu.org#25927,"DURI KOSAMBI, CENGKARENG, JAKARTA BARAT, DKI JAKARTA",136,91,145,236
https://kawalpemilu.org#25927,"DURI KOSAMBI, CENGKARENG, JAKARTA BARAT, DKI JAKARTA",137,88,150,238
https://kawalpemilu.org#25927,"DURI KOSAMBI, CENGKARENG, JAKARTA BARAT, DKI JAKARTA",138,98,120,218
https://kawalpemilu.org#25927,"DURI KOSAMBI, CENGKARENG, JAKARTA BARAT, DKI JAKARTA",139,95,94,189
https://kawalpemilu.org#25927,"DURI KOSAMBI, CENGKARENG, JAKARTA BARAT, DKI JAKARTA",140,74,96,170
https://kawalpemilu.org#25927,"DURI KOSAMBI, CENGKARENG, JAKARTA BARAT, DKI JAKARTA",141,123,146,269
https://kawalpemilu.org#25927,"DURI KOSAMBI, CENGKARENG, JAKARTA BARAT, DKI JAKARTA",142,127,45,172
https://kawalpemilu.org#25927,"DURI KOSAMBI, CENGKARENG, JAKARTA BARAT, DKI JAKARTA",143,99,60,159
https://kawalpemilu.org#25927,"DURI KOSAMBI, CENGKARENG, JAKARTA BARAT, DKI JAKARTA",144,207,18,225
https://kawalpemilu.org#25927,"DURI KOSAMBI, CENGKARENG, JAKARTA BARAT, DKI JAKARTA",145,102,128,230
https://kawalpemilu.org#25927,"DURI KOSAMBI, CENGKARENG, JAKARTA BARAT, DKI JAKARTA",146,85,177,262
https://kawalpemilu.org#25927,"DURI KOSAMBI, CENGKARENG, JAKARTA BARAT, DKI JAKARTA",147,172,76,248
https://kawalpemilu.org#25927,"DURI KOSAMBI, CENGKARENG, JAKARTA BARAT, DKI JAKARTA",148,94,126,220
https://kawalpemilu.org#25927,"DURI KOSAMBI, CENGKARENG, JAKARTA BARAT, DKI JAKARTA",149,106,149,255
https://kawalpemilu.org#25927,"DURI KOSAMBI, CENGKARENG, JAKARTA BARAT, DKI JAKARTA",150,91,154,245
https://kawalpemilu.org#25927,"DURI KOSAMBI, CENGKARENG, JAKARTA BARAT, DKI JAKARTA",151,117,93,210
https://kawalpemilu.org#25927,"DURI KOSAMBI, CENGKARENG, JAKARTA BARAT, DKI JAKARTA",152,114,95,209
https://kawalpemilu.org#25927,"DURI KOSAMBI, CENGKARENG, JAKARTA BARAT, DKI JAKARTA",153,79,167,246
https://kawalpemilu.org#25927,"DURI KOSAMBI, CENGKARENG, JAKARTA BARAT, DKI JAKARTA",154,46,220,266
https://kawalpemilu.org#25927,"DURI KOSAMBI, CENGKARENG, JAKARTA BARAT, DKI JAKARTA",155,104,105,209
https://kawalpemilu.org#25927,"DURI KOSAMBI, CENGKARENG, JAKARTA BARAT, DKI JAKARTA",156,91,163,254
https://kawalpemilu.org#25927,"DURI KOSAMBI, CENGKARENG, JAKARTA BARAT, DKI JAKARTA",157,91,107,198
https://kawalpemilu.org#25927,"DURI KOSAMBI, CENGKARENG, JAKARTA BARAT, DKI JAKARTA",158,90,127,217
https://kawalpemilu.org#25927,"DURI KOSAMBI, CENGKARENG, JAKARTA BARAT, DKI JAKARTA",159,91,115,206
https://kawalpemilu.org#25927,"DURI KOSAMBI, CENGKARENG, JAKARTA BARAT, DKI JAKARTA",160,72,139,211
https://kawalpemilu.org#25927,"DURI KOSAMBI, CENGKARENG, JAKARTA BARAT, DKI JAKARTA",161,97,122,219
https://kawalpemilu.org#25927,"DURI KOSAMBI, CENGKARENG, JAKARTA BARAT, DKI JAKARTA",162,79,144,223
https://kawalpemilu.org#25927,"DURI KOSAMBI, CENGKARENG, JAKARTA BARAT, DKI JAKARTA",163,95,158,253
https://kawalpemilu.org#25927,"DURI KOSAMBI, CENGKARENG, JAKARTA BARAT, DKI JAKARTA",164,73,179,252
https://kawalpemilu.org#25927,"DURI KOSAMBI, CENGKARENG, JAKARTA BARAT, DKI JAKARTA",165,120,135,255
https://kawalpemilu.org#25927,"DURI KOSAMBI, CENGKARENG, JAKARTA BARAT, DKI JAKARTA",166,85,170,255
https://kawalpemilu.org#25927,"DURI KOSAMBI, CENGKARENG, JAKARTA BARAT, DKI JAKARTA",167,88,133,221
https://kawalpemilu.org#25927,"DURI KOSAMBI, CENGKARENG, JAKARTA BARAT, DKI JAKARTA",168,124,113,237
https://kawalpemilu.org#25927,"DURI KOSAMBI, CENGKARENG, JAKARTA BARAT, DKI JAKARTA",169,89,95,184
https://kawalpemilu.org#25927,"DURI KOSAMBI, CENGKARENG, JAKARTA BARAT, DKI JAKARTA",170,115,90,205
https://kawalpemilu.org#25927,"DURI KOSAMBI, CENGKARENG, JAKARTA BARAT, DKI JAKARTA",171,103,142,245
https://kawalpemilu.org#25927,"DURI KOSAMBI, CENGKARENG, JAKARTA BARAT, DKI JAKARTA",172,103,120,223
https://kawalpemilu.org#25927,"DURI KOSAMBI, CENGKARENG, JAKARTA BARAT, DKI JAKARTA",173,226,10,236
https://kawalpemilu.org#25927,"DURI KOSAMBI, CENGKARENG, JAKARTA BARAT, DKI JAKARTA",174,231,4,235
https://kawalpemilu.org#25927,"DURI KOSAMBI, CENGKARENG, JAKARTA BARAT, DKI JAKARTA",175,181,6,187
https://kawalpemilu.org#25927,"DURI KOSAMBI, CENGKARENG, JAKARTA BARAT, DKI JAKARTA",176,174,3,177
https://kawalpemilu.org#25927,"DURI KOSAMBI, CENGKARENG, JAKARTA BARAT, DKI JAKARTA",177,212,6,218
https://kawalpemilu.org#25927,"DURI KOSAMBI, CENGKARENG, JAKARTA BARAT, DKI JAKARTA",178,191,6,197
https://kawalpemilu.org#25927,"DURI KOSAMBI, CENGKARENG, JAKARTA BARAT, DKI JAKARTA",179,218,8,226
https://kawalpemilu.org#25927,"DURI KOSAMBI, CENGKARENG, JAKARTA BARAT, DKI JAKARTA",180,202,4,206
https://kawalpemilu.org#25927,"DURI KOSAMBI, CENGKARENG, JAKARTA BARAT, DKI JAKARTA",181,177,2,179
https://kawalpemilu.org#25927,"DURI KOSAMBI, CENGKARENG, JAKARTA BARAT, DKI JAKARTA",182,199,4,203
https://kawalpemilu.org#25927,"DURI KOSAMBI, CENGKARENG, JAKARTA BARAT, DKI JAKARTA",183,204,6,210
https://kawalpemilu.org#25927,"DURI KOSAMBI, CENGKARENG, JAKARTA BARAT, DKI JAKARTA",184,259,5,264
https://kawalpemilu.org#25927,"DURI KOSAMBI, CENGKARENG, JAKARTA BARAT, DKI JAKARTA",185,229,1,230
https://kawalpemilu.org#25927,"DURI KOSAMBI, CENGKARENG, JAKARTA BARAT, DKI JAKARTA",186,227,6,233
https://kawalpemilu.org#25927,"DURI KOSAMBI, CENGKARENG, JAKARTA BARAT, DKI JAKARTA",187,223,4,227
https://kawalpemilu.org#25927,"DURI KOSAMBI, CENGKARENG, JAKARTA BARAT, DKI JAKARTA",188,188,2,190
https://kawalpemilu.org#25927,"DURI KOSAMBI, CENGKARENG, JAKARTA BARAT, DKI JAKARTA",189,198,7,205
https://kawalpemilu.org#25927,"DURI KOSAMBI, CENGKARENG, JAKARTA BARAT, DKI JAKARTA",190,213,9,222
https://kawalpemilu.org#25927,"DURI KOSAMBI, CENGKARENG, JAKARTA BARAT, DKI JAKARTA",191,233,1,234
https://kawalpemilu.org#25927,"DURI KOSAMBI, CENGKARENG, JAKARTA BARAT, DKI JAKARTA",192,219,0,219
https://kawalpemilu.org#25927,"DURI KOSAMBI, CENGKARENG, JAKARTA BARAT, DKI JAKARTA",193,192,5,197
https://kawalpemilu.org#25927,"DURI KOSAMBI, CENGKARENG, JAKARTA BARAT, DKI JAKARTA",194,158,40,198
https://kawalpemilu.org#25927,"DURI KOSAMBI, CENGKARENG, JAKARTA BARAT, DKI JAKARTA",195,236,14,250
https://kawalpemilu.org#25927,"DURI KOSAMBI, CENGKARENG, JAKARTA BARAT, DKI JAKARTA",196,201,28,229
https://kawalpemilu.org#25927,"DURI KOSAMBI, CENGKARENG, JAKARTA BARAT, DKI JAKARTA",197,175,5,180
https://kawalpemilu.org#25927,"DURI KOSAMBI, CENGKARENG, JAKARTA BARAT, DKI JAKARTA",198,218,4,222
https://kawalpemilu.org#25927,"DURI KOSAMBI, CENGKARENG, JAKARTA BARAT, DKI JAKARTA",199,176,5,181
https://kawalpemilu.org#25927,"DURI KOSAMBI, CENGKARENG, JAKARTA BARAT, DKI JAKARTA",200,137,55,192
https://kawalpemilu.org#25927,"DURI KOSAMBI, CENGKARENG, JAKARTA BARAT, DKI JAKARTA",201,132,49,181
https://kawalpemilu.org#25927,"DURI KOSAMBI, CENGKARENG, JAKARTA BARAT, DKI JAKARTA",202,70,161,231
https://kawalpemilu.org#25927,"DURI KOSAMBI, CENGKARENG, JAKARTA BARAT, DKI JAKARTA",203,90,151,241
https://kawalpemilu.org#25927,"DURI KOSAMBI, CENGKARENG, JAKARTA BARAT, DKI JAKARTA",204,198,16,214
https://kawalpemilu.org#25927,"DURI KOSAMBI, CENGKARENG, JAKARTA BARAT, DKI JAKARTA",205,180,26,206
https://kawalpemilu.org#25927,"DURI KOSAMBI, CENGKARENG, JAKARTA BARAT, DKI JAKARTA",206,122,127,249
https://kawalpemilu.org#25927,"DURI KOSAMBI, CENGKARENG, JAKARTA BARAT, DKI JAKARTA",207,119,112,231
https://kawalpemilu.org#25927,"DURI KOSAMBI, CENGKARENG, JAKARTA BARAT, DKI JAKARTA",208,166,35,201
https://kawalpemilu.org#25927,"DURI KOSAMBI, CENGKARENG, JAKARTA BARAT, DKI JAKARTA",209,112,120,232
https://kawalpemilu.org#25927,"DURI KOSAMBI, CENGKARENG, JAKARTA BARAT, DKI JAKARTA",210,100,144,244
https://kawalpemilu.org#25927,"DURI KOSAMBI, CENGKARENG, JAKARTA BARAT, DKI JAKARTA",211,48,171,219
https://kawalpemilu.org#25927,"DURI KOSAMBI, CENGKARENG, JAKARTA BARAT, DKI JAKARTA",212,112,164,276
https://kawalpemilu.org#25927,"DURI KOSAMBI, CENGKARENG, JAKARTA BARAT, DKI JAKARTA",213,68,176,244
https://kawalpemilu.org#25927,"DURI KOSAMBI, CENGKARENG, JAKARTA BARAT, DKI JAKARTA",214,136,35,171
https://kawalpemilu.org#25927,"DURI KOSAMBI, CENGKARENG, JAKARTA BARAT, DKI JAKARTA",215,89,152,241
https://kawalpemilu.org#25927,"DURI KOSAMBI, CENGKARENG, JAKARTA BARAT, DKI JAKARTA",216,83,169,252
https://kawalpemilu.org#25927,"DURI KOSAMBI, CENGKARENG, JAKARTA BARAT, DKI JAKARTA",217,87,143,230
https://kawalpemilu.org#25927,"DURI KOSAMBI, CENGKARENG, JAKARTA BARAT, DKI JAKARTA",218,101,113,214
https://kawalpemilu.org#25927,"DURI KOSAMBI, CENGKARENG, JAKARTA BARAT, DKI JAKARTA",219,76,113,189
https://kawalpemilu.org#25927,"DURI KOSAMBI, CENGKARENG, JAKARTA BARAT, DKI JAKARTA",220,83,114,197
https://kawalpemilu.org#25927,"DURI KOSAMBI, CENGKARENG, JAKARTA BARAT, DKI JAKARTA",221,90,78,168
https://kawalpemilu.org#25927,"DURI KOSAMBI, CENGKARENG, JAKARTA BARAT, DKI JAKARTA",222,101,113,214
https://kawalpemilu.org#25927,"DURI KOSAMBI, CENGKARENG, JAKARTA BARAT, DKI JAKARTA",223,83,124,207
https://kawalpemilu.org#25927,"DURI KOSAMBI, CENGKARENG, JAKARTA BARAT, DKI JAKARTA",224,45,211,256
https://kawalpemilu.org#25927,"DURI KOSAMBI, CENGKARENG, JAKARTA BARAT, DKI JAKARTA",225,108,101,209
https://kawalpemilu.org#25927,"DURI KOSAMBI, CENGKARENG, JAKARTA BARAT, DKI JAKARTA",226,115,99,214
https://kawalpemilu.org#25927,"DURI KOSAMBI, CENGKARENG, JAKARTA BARAT, DKI JAKARTA",227,108,130,238
https://kawalpemilu.org#25927,"DURI KOSAMBI, CENGKARENG, JAKARTA BARAT, DKI JAKARTA",228,123,142,265
https://kawalpemilu.org#25927,"DURI KOSAMBI, CENGKARENG, JAKARTA BARAT, DKI JAKARTA",229,120,129,249
https://kawalpemilu.org#25927,"DURI KOSAMBI, CENGKARENG, JAKARTA BARAT, DKI JAKARTA",230,162,83,245
https://kawalpemilu.org#25927,"DURI KOSAMBI, CENGKARENG, JAKARTA BARAT, DKI JAKARTA",231,133,139,272
https://kawalpemilu.org#25927,"DURI KOSAMBI, CENGKARENG, JAKARTA BARAT, DKI JAKARTA",232,147,120,267
https://kawalpemilu.org#25927,"DURI KOSAMBI, CENGKARENG, JAKARTA BARAT, DKI JAKARTA",233,133,127,260
https://kawalpemilu.org#25927,"DURI KOSAMBI, CENGKARENG, JAKARTA BARAT, DKI JAKARTA",234,145,89,234
https://kawalpemilu.org#25927,"DURI KOSAMBI, CENGKARENG, JAKARTA BARAT, DKI JAKARTA",235,117,61,178
https://kawalpemilu.org#25927,"DURI KOSAMBI, CENGKARENG, JAKARTA BARAT, DKI JAKARTA",236,180,34,214
https://kawalpemilu.org#25927,"DURI KOSAMBI, CENGKARENG, JAKARTA BARAT, DKI JAKARTA",237,121,61,182
https://kawalpemilu.org#25927,"DURI KOSAMBI, CENGKARENG, JAKARTA BARAT, DKI JAKARTA",238,96,91,187
https://kawalpemilu.org#25927,"DURI KOSAMBI, CENGKARENG, JAKARTA BARAT, DKI JAKARTA",239,129,88,217
https://kawalpemilu.org#25927,"DURI KOSAMBI, CENGKARENG, JAKARTA BARAT, DKI JAKARTA",240,124,74,198
https://kawalpemilu.org#25927,"DURI KOSAMBI, CENGKARENG, JAKARTA BARAT, DKI JAKARTA",241,146,48,194
https://kawalpemilu.org#25927,"DURI KOSAMBI, CENGKARENG, JAKARTA BARAT, DKI JAKARTA",242,138,86,224
https://kawalpemilu.org#25927,"DURI KOSAMBI, CENGKARENG, JAKARTA BARAT, DKI JAKARTA",243,126,87,213
https://kawalpemilu.org#25927,"DURI KOSAMBI, CENGKARENG, JAKARTA BARAT, DKI JAKARTA",244,182,2,184
https://kawalpemilu.org#25927,"DURI KOSAMBI, CENGKARENG, JAKARTA BARAT, DKI JAKARTA",245,217,2,219
https://kawalpemilu.org#25927,"DURI KOSAMBI, CENGKARENG, JAKARTA BARAT, DKI JAKARTA",246,199,2,201
https://kawalpemilu.org#25927,"DURI KOSAMBI, CENGKARENG, JAKARTA BARAT, DKI JAKARTA",247,219,8,227
https://kawalpemilu.org#25927,"DURI KOSAMBI, CENGKARENG, JAKARTA BARAT, DKI JAKARTA",248,184,3,187
https://kawalpemilu.org#25927,"DURI KOSAMBI, CENGKARENG, JAKARTA BARAT, DKI JAKARTA",249,158,9,167
https://kawalpemilu.org#25927,"DURI KOSAMBI, CENGKARENG, JAKARTA BARAT, DKI JAKARTA",250,267,12,279
https://kawalpemilu.org#25927,"DURI KOSAMBI, CENGKARENG, JAKARTA BARAT, DKI JAKARTA",251,72,145,217
https://kawalpemilu.org#25927,"DURI KOSAMBI, CENGKARENG, JAKARTA BARAT, DKI JAKARTA",252,83,114,197
https://kawalpemilu.org#25928,"RAWA BUAYA, CENGKARENG, JAKARTA BARAT, DKI JAKARTA",1,104,91,195
https://kawalpemilu.org#25928,"RAWA BUAYA, CENGKARENG, JAKARTA BARAT, DKI JAKARTA",2,86,78,164
https://kawalpemilu.org#25928,"RAWA BUAYA, CENGKARENG, JAKARTA BARAT, DKI JAKARTA",3,122,159,281
https://kawalpemilu.org#25928,"RAWA BUAYA, CENGKARENG, JAKARTA BARAT, DKI JAKARTA",4,135,104,239
https://kawalpemilu.org#25928,"RAWA BUAYA, CENGKARENG, JAKARTA BARAT, DKI JAKARTA",5,131,94,225
https://kawalpemilu.org#25928,"RAWA BUAYA, CENGKARENG, JAKARTA BARAT, DKI JAKARTA",6,99,137,236
https://kawalpemilu.org#25928,"RAWA BUAYA, CENGKARENG, JAKARTA BARAT, DKI JAKARTA",7,87,96,183
https://kawalpemilu.org#25928,"RAWA BUAYA, CENGKARENG, JAKARTA BARAT, DKI JAKARTA",8,84,78,162
https://kawalpemilu.org#25928,"RAWA BUAYA, CENGKARENG, JAKARTA BARAT, DKI JAKARTA",9,107,76,183
https://kawalpemilu.org#25928,"RAWA BUAYA, CENGKARENG, JAKARTA BARAT, DKI JAKARTA",10,113,87,200
https://kawalpemilu.org#25928,"RAWA BUAYA, CENGKARENG, JAKARTA BARAT, DKI JAKARTA",11,106,73,179
https://kawalpemilu.org#25928,"RAWA BUAYA, CENGKARENG, JAKARTA BARAT, DKI JAKARTA",12,131,76,207
https://kawalpemilu.org#25928,"RAWA BUAYA, CENGKARENG, JAKARTA BARAT, DKI JAKARTA",13,97,102,199
https://kawalpemilu.org#25928,"RAWA BUAYA, CENGKARENG, JAKARTA BARAT, DKI JAKARTA",14,100,92,192
https://kawalpemilu.org#25928,"RAWA BUAYA, CENGKARENG, JAKARTA BARAT, DKI JAKARTA",16,93,81,174
https://kawalpemilu.org#25928,"RAWA BUAYA, CENGKARENG, JAKARTA BARAT, DKI JAKARTA",17,97,160,257
https://kawalpemilu.org#25928,"RAWA BUAYA, CENGKARENG, JAKARTA BARAT, DKI JAKARTA",18,121,98,219
https://kawalpemilu.org#25928,"RAWA BUAYA, CENGKARENG, JAKARTA BARAT, DKI JAKARTA",19,128,136,264
https://kawalpemilu.org#25928,"RAWA BUAYA, CENGKARENG, JAKARTA BARAT, DKI JAKARTA",20,112,94,206
https://kawalpemilu.org#25928,"RAWA BUAYA, CENGKARENG, JAKARTA BARAT, DKI JAKARTA",21,112,127,239
https://kawalpemilu.org#25928,"RAWA BUAYA, CENGKARENG, JAKARTA BARAT, DKI JAKARTA",22,128,88,216
https://kawalpemilu.org#25928,"RAWA BUAYA, CENGKARENG, JAKARTA BARAT, DKI JAKARTA",23,151,97,248
https://kawalpemilu.org#25928,"RAWA BUAYA, CENGKARENG, JAKARTA BARAT, DKI JAKARTA",24,122,57,179
https://kawalpemilu.org#25928,"RAWA BUAYA, CENGKARENG, JAKARTA BARAT, DKI JAKARTA",25,102,91,193
https://kawalpemilu.org#25928,"RAWA BUAYA, CENGKARENG, JAKARTA BARAT, DKI JAKARTA",26,87,97,184
https://kawalpemilu.org#25928,"RAWA BUAYA, CENGKARENG, JAKARTA BARAT, DKI JAKARTA",27,121,114,235
https://kawalpemilu.org#25928,"RAWA BUAYA, CENGKARENG, JAKARTA BARAT, DKI JAKARTA",28,113,108,221
https://kawalpemilu.org#25928,"RAWA BUAYA, CENGKARENG, JAKARTA BARAT, DKI JAKARTA",29,132,91,223
https://kawalpemilu.org#25928,"RAWA BUAYA, CENGKARENG, JAKARTA BARAT, DKI JAKARTA",30,135,97,232
https://kawalpemilu.org#25928,"RAWA BUAYA, CENGKARENG, JAKARTA BARAT, DKI JAKARTA",31,122,112,234
https://kawalpemilu.org#25928,"RAWA BUAYA, CENGKARENG, JAKARTA BARAT, DKI JAKARTA",32,162,93,255
https://kawalpemilu.org#25928,"RAWA BUAYA, CENGKARENG, JAKARTA BARAT, DKI JAKARTA",33,141,100,241
https://kawalpemilu.org#25928,"RAWA BUAYA, CENGKARENG, JAKARTA BARAT, DKI JAKARTA",34,161,77,238
https://kawalpemilu.org#25928,"RAWA BUAYA, CENGKARENG, JAKARTA BARAT, DKI JAKARTA",35,120,115,235
https://kawalpemilu.org#25928,"RAWA BUAYA, CENGKARENG, JAKARTA BARAT, DKI JAKARTA",36,108,106,214
https://kawalpemilu.org#25928,"RAWA BUAYA, CENGKARENG, JAKARTA BARAT, DKI JAKARTA",37,114,64,178
https://kawalpemilu.org#25928,"RAWA BUAYA, CENGKARENG, JAKARTA BARAT, DKI JAKARTA",38,142,74,216
https://kawalpemilu.org#25928,"RAWA BUAYA, CENGKARENG, JAKARTA BARAT, DKI JAKARTA",39,139,90,4
https://kawalpemilu.org#25928,"RAWA BUAYA, CENGKARENG, JAKARTA BARAT, DKI JAKARTA",40,154,121,275
https://kawalpemilu.org#25928,"RAWA BUAYA, CENGKARENG, JAKARTA BARAT, DKI JAKARTA",41,138,117,255
https://kawalpemilu.org#25928,"RAWA BUAYA, CENGKARENG, JAKARTA BARAT, DKI JAKARTA",42,132,91,223
https://kawalpemilu.org#25928,"RAWA BUAYA, CENGKARENG, JAKARTA BARAT, DKI JAKARTA",43,123,101,224
https://kawalpemilu.org#25928,"RAWA BUAYA, CENGKARENG, JAKARTA BARAT, DKI JAKARTA",44,121,100,221
https://kawalpemilu.org#25928,"RAWA BUAYA, CENGKARENG, JAKARTA BARAT, DKI JAKARTA",45,121,88,209
https://kawalpemilu.org#25928,"RAWA BUAYA, CENGKARENG, JAKARTA BARAT, DKI JAKARTA",46,152,80,232
https://kawalpemilu.org#25928,"RAWA BUAYA, CENGKARENG, JAKARTA BARAT, DKI JAKARTA",47,127,98,225
https://kawalpemilu.org#25928,"RAWA BUAYA, CENGKARENG, JAKARTA BARAT, DKI JAKARTA",48,124,120,244
https://kawalpemilu.org#25928,"RAWA BUAYA, CENGKARENG, JAKARTA BARAT, DKI JAKARTA",49,127,107,234
https://kawalpemilu.org#25928,"RAWA BUAYA, CENGKARENG, JAKARTA BARAT, DKI JAKARTA",50,180,75,255
https://kawalpemilu.org#25928,"RAWA BUAYA, CENGKARENG, JAKARTA BARAT, DKI JAKARTA",51,194,60,254
https://kawalpemilu.org#25928,"RAWA BUAYA, CENGKARENG, JAKARTA BARAT, DKI JAKARTA",52,186,68,254
https://kawalpemilu.org#25928,"RAWA BUAYA, CENGKARENG, JAKARTA BARAT, DKI JAKARTA",53,155,112,267
https://kawalpemilu.org#25928,"RAWA BUAYA, CENGKARENG, JAKARTA BARAT, DKI JAKARTA",54,162,91,253
https://kawalpemilu.org#25928,"RAWA BUAYA, CENGKARENG, JAKARTA BARAT, DKI JAKARTA",55,96,129,225
https://kawalpemilu.org#25928,"RAWA BUAYA, CENGKARENG, JAKARTA BARAT, DKI JAKARTA",56,113,102,215
https://kawalpemilu.org#25928,"RAWA BUAYA, CENGKARENG, JAKARTA BARAT, DKI JAKARTA",57,113,131,244
https://kawalpemilu.org#25928,"RAWA BUAYA, CENGKARENG, JAKARTA BARAT, DKI JAKARTA",58,122,126,248
https://kawalpemilu.org#25928,"RAWA BUAYA, CENGKARENG, JAKARTA BARAT, DKI JAKARTA",59,109,103,212
https://kawalpemilu.org#25928,"RAWA BUAYA, CENGKARENG, JAKARTA BARAT, DKI JAKARTA",60,112,125,237
https://kawalpemilu.org#25928,"RAWA BUAYA, CENGKARENG, JAKARTA BARAT, DKI JAKARTA",61,82,168,250
https://kawalpemilu.org#25928,"RAWA BUAYA, CENGKARENG, JAKARTA BARAT, DKI JAKARTA",62,92,145,237
https://kawalpemilu.org#25928,"RAWA BUAYA, CENGKARENG, JAKARTA BARAT, DKI JAKARTA",63,114,160,274
https://kawalpemilu.org#25928,"RAWA BUAYA, CENGKARENG, JAKARTA BARAT, DKI JAKARTA",64,87,134,221
https://kawalpemilu.org#25928,"RAWA BUAYA, CENGKARENG, JAKARTA BARAT, DKI JAKARTA",65,104,147,251
https://kawalpemilu.org#25928,"RAWA BUAYA, CENGKARENG, JAKARTA BARAT, DKI JAKARTA",66,115,147,262
https://kawalpemilu.org#25928,"RAWA BUAYA, CENGKARENG, JAKARTA BARAT, DKI JAKARTA",67,101,144,245
https://kawalpemilu.org#25928,"RAWA BUAYA, CENGKARENG, JAKARTA BARAT, DKI JAKARTA",68,138,65,203
https://kawalpemilu.org#25928,"RAWA BUAYA, CENGKARENG, JAKARTA BARAT, DKI JAKARTA",69,171,75,246
https://kawalpemilu.org#25928,"RAWA BUAYA, CENGKARENG, JAKARTA BARAT, DKI JAKARTA",70,69,189,258
https://kawalpemilu.org#25928,"RAWA BUAYA, CENGKARENG, JAKARTA BARAT, DKI JAKARTA",71,107,95,202
https://kawalpemilu.org#25928,"RAWA BUAYA, CENGKARENG, JAKARTA BARAT, DKI JAKARTA",72,121,134,255
https://kawalpemilu.org#25928,"RAWA BUAYA, CENGKARENG, JAKARTA BARAT, DKI JAKARTA",73,111,137,248
https://kawalpemilu.org#25928,"RAWA BUAYA, CENGKARENG, JAKARTA BARAT, DKI JAKARTA",74,133,127,260
https://kawalpemilu.org#25928,"RAWA BUAYA, CENGKARENG, JAKARTA BARAT, DKI JAKARTA",75,156,101,257
https://kawalpemilu.org#25928,"RAWA BUAYA, CENGKARENG, JAKARTA BARAT, DKI JAKARTA",76,122,98,220
https://kawalpemilu.org#25928,"RAWA BUAYA, CENGKARENG, JAKARTA BARAT, DKI JAKARTA",77,110,143,253
https://kawalpemilu.org#25928,"RAWA BUAYA, CENGKARENG, JAKARTA BARAT, DKI JAKARTA",78,129,95,224
https://kawalpemilu.org#25928,"RAWA BUAYA, CENGKARENG, JAKARTA BARAT, DKI JAKARTA",79,115,135,250
https://kawalpemilu.org#25928,"RAWA BUAYA, CENGKARENG, JAKARTA BARAT, DKI JAKARTA",80,135,123,258
https://kawalpemilu.org#25928,"RAWA BUAYA, CENGKARENG, JAKARTA BARAT, DKI JAKARTA",81,128,91,219
https://kawalpemilu.org#25928,"RAWA BUAYA, CENGKARENG, JAKARTA BARAT, DKI JAKARTA",82,84,80,164
https://kawalpemilu.org#25928,"RAWA BUAYA, CENGKARENG, JAKARTA BARAT, DKI JAKARTA",83,110,88,198
https://kawalpemilu.org#25928,"RAWA BUAYA, CENGKARENG, JAKARTA BARAT, DKI JAKARTA",84,125,107,232
https://kawalpemilu.org#25928,"RAWA BUAYA, CENGKARENG, JAKARTA BARAT, DKI JAKARTA",85,98,71,169
https://kawalpemilu.org#25928,"RAWA BUAYA, CENGKARENG, JAKARTA BARAT, DKI JAKARTA",86,154,58,212
https://kawalpemilu.org#25928,"RAWA BUAYA, CENGKARENG, JAKARTA BARAT, DKI JAKARTA",87,138,86,224
https://kawalpemilu.org#25928,"RAWA BUAYA, CENGKARENG, JAKARTA BARAT, DKI JAKARTA",88,159,75,234
https://kawalpemilu.org#25928,"RAWA BUAYA, CENGKARENG, JAKARTA BARAT, DKI JAKARTA",89,126,92,218
https://kawalpemilu.org#25928,"RAWA BUAYA, CENGKARENG, JAKARTA BARAT, DKI JAKARTA",90,162,71,233
https://kawalpemilu.org#25928,"RAWA BUAYA, CENGKARENG, JAKARTA BARAT, DKI JAKARTA",91,96,87,183
https://kawalpemilu.org#25928,"RAWA BUAYA, CENGKARENG, JAKARTA BARAT, DKI JAKARTA",92,101,89,190
https://kawalpemilu.org#25928,"RAWA BUAYA, CENGKARENG, JAKARTA BARAT, DKI JAKARTA",93,105,94,199
https://kawalpemilu.org#25928,"RAWA BUAYA, CENGKARENG, JAKARTA BARAT, DKI JAKARTA",94,93,147,240
https://kawalpemilu.org#25928,"RAWA BUAYA, CENGKARENG, JAKARTA BARAT, DKI JAKARTA",95,89,145,234
https://kawalpemilu.org#25928,"RAWA BUAYA, CENGKARENG, JAKARTA BARAT, DKI JAKARTA",96,102,138,240
https://kawalpemilu.org#25928,"RAWA BUAYA, CENGKARENG, JAKARTA BARAT, DKI JAKARTA",97,113,77,190
https://kawalpemilu.org#25928,"RAWA BUAYA, CENGKARENG, JAKARTA BARAT, DKI JAKARTA",98,168,58,226
https://kawalpemilu.org#25928,"RAWA BUAYA, CENGKARENG, JAKARTA BARAT, DKI JAKARTA",99,141,114,255
https://kawalpemilu.org#25928,"RAWA BUAYA, CENGKARENG, JAKARTA BARAT, DKI JAKARTA",100,132,133,265
https://kawalpemilu.org#25928,"RAWA BUAYA, CENGKARENG, JAKARTA BARAT, DKI JAKARTA",101,156,115,271
https://kawalpemilu.org#25928,"RAWA BUAYA, CENGKARENG, JAKARTA BARAT, DKI JAKARTA",102,122,123,245
https://kawalpemilu.org#25928,"RAWA BUAYA, CENGKARENG, JAKARTA BARAT, DKI JAKARTA",103,124,103,227
https://kawalpemilu.org#25928,"RAWA BUAYA, CENGKARENG, JAKARTA BARAT, DKI JAKARTA",104,134,102,236
https://kawalpemilu.org#25928,"RAWA BUAYA, CENGKARENG, JAKARTA BARAT, DKI JAKARTA",105,123,125,248
https://kawalpemilu.org#25928,"RAWA BUAYA, CENGKARENG, JAKARTA BARAT, DKI JAKARTA",106,127,122,249
https://kawalpemilu.org#25928,"RAWA BUAYA, CENGKARENG, JAKARTA BARAT, DKI JAKARTA",107,118,113,231
https://kawalpemilu.org#25928,"RAWA BUAYA, CENGKARENG, JAKARTA BARAT, DKI JAKARTA",108,86,151,237
https://kawalpemilu.org#25928,"RAWA BUAYA, CENGKARENG, JAKARTA BARAT, DKI JAKARTA",109,121,149,270
https://kawalpemilu.org#25928,"RAWA BUAYA, CENGKARENG, JAKARTA BARAT, DKI JAKARTA",110,96,137,233
https://kawalpemilu.org#25928,"RAWA BUAYA, CENGKARENG, JAKARTA BARAT, DKI JAKARTA",111,95,186,281
https://kawalpemilu.org#25928,"RAWA BUAYA, CENGKARENG, JAKARTA BARAT, DKI JAKARTA",112,104,169,273
https://kawalpemilu.org#25928,"RAWA BUAYA, CENGKARENG, JAKARTA BARAT, DKI JAKARTA",113,149,53,202
https://kawalpemilu.org#25928,"RAWA BUAYA, CENGKARENG, JAKARTA BARAT, DKI JAKARTA",114,85,133,218
https://kawalpemilu.org#25928,"RAWA BUAYA, CENGKARENG, JAKARTA BARAT, DKI JAKARTA",115,124,42,166
https://kawalpemilu.org#25928,"RAWA BUAYA, CENGKARENG, JAKARTA BARAT, DKI JAKARTA",116,138,46,176
https://kawalpemilu.org#25928,"RAWA BUAYA, CENGKARENG, JAKARTA BARAT, DKI JAKARTA",117,138,69,207
https://kawalpemilu.org#25928,"RAWA BUAYA, CENGKARENG, JAKARTA BARAT, DKI JAKARTA",118,149,53,202
https://kawalpemilu.org#25928,"RAWA BUAYA, CENGKARENG, JAKARTA BARAT, DKI JAKARTA",119,131,28,159
https://kawalpemilu.org#25928,"RAWA BUAYA, CENGKARENG, JAKARTA BARAT, DKI JAKARTA",120,205,23,228
https://kawalpemilu.org#25928,"RAWA BUAYA, CENGKARENG, JAKARTA BARAT, DKI JAKARTA",121,153,11,164
https://kawalpemilu.org#25928,"RAWA BUAYA, CENGKARENG, JAKARTA BARAT, DKI JAKARTA",122,172,10,182
https://kawalpemilu.org#25928,"RAWA BUAYA, CENGKARENG, JAKARTA BARAT, DKI JAKARTA",123,222,13,235
https://kawalpemilu.org#25928,"RAWA BUAYA, CENGKARENG, JAKARTA BARAT, DKI JAKARTA",124,184,14,198
https://kawalpemilu.org#25928,"RAWA BUAYA, CENGKARENG, JAKARTA BARAT, DKI JAKARTA",125,229,8,237
https://kawalpemilu.org#25928,"RAWA BUAYA, CENGKARENG, JAKARTA BARAT, DKI JAKARTA",126,190,18,208
https://kawalpemilu.org#25928,"RAWA BUAYA, CENGKARENG, JAKARTA BARAT, DKI JAKARTA",127,200,6,206
https://kawalpemilu.org#25928,"RAWA BUAYA, CENGKARENG, JAKARTA BARAT, DKI JAKARTA",128,213,7,220
https://kawalpemilu.org#25928,"RAWA BUAYA, CENGKARENG, JAKARTA BARAT, DKI JAKARTA",129,155,12,167
https://kawalpemilu.org#25928,"RAWA BUAYA, CENGKARENG, JAKARTA BARAT, DKI JAKARTA",130,236,9,245
https://kawalpemilu.org#25928,"RAWA BUAYA, CENGKARENG, JAKARTA BARAT, DKI JAKARTA",131,229,4,233
https://kawalpemilu.org#25928,"RAWA BUAYA, CENGKARENG, JAKARTA BARAT, DKI JAKARTA",132,243,3,246
https://kawalpemilu.org#25928,"RAWA BUAYA, CENGKARENG, JAKARTA BARAT, DKI JAKARTA",133,210,1,211
https://kawalpemilu.org#25928,"RAWA BUAYA, CENGKARENG, JAKARTA BARAT, DKI JAKARTA",134,235,5,240
https://kawalpemilu.org#25928,"RAWA BUAYA, CENGKARENG, JAKARTA BARAT, DKI JAKARTA",135,224,10,234
https://kawalpemilu.org#25928,"RAWA BUAYA, CENGKARENG, JAKARTA BARAT, DKI JAKARTA",136,246,20,266
https://kawalpemilu.org#25928,"RAWA BUAYA, CENGKARENG, JAKARTA BARAT, DKI JAKARTA",137,186,17,203
https://kawalpemilu.org#25928,"RAWA BUAYA, CENGKARENG, JAKARTA BARAT, DKI JAKARTA",138,234,5,239
https://kawalpemilu.org#25928,"RAWA BUAYA, CENGKARENG, JAKARTA BARAT, DKI JAKARTA",139,216,3,219
https://kawalpemilu.org#25928,"RAWA BUAYA, CENGKARENG, JAKARTA BARAT, DKI JAKARTA",140,242,10,252
https://kawalpemilu.org#25928,"RAWA BUAYA, CENGKARENG, JAKARTA BARAT, DKI JAKARTA",141,229,6,235
https://kawalpemilu.org#25928,"RAWA BUAYA, CENGKARENG, JAKARTA BARAT, DKI JAKARTA",142,234,9,243
https://kawalpemilu.org#25928,"RAWA BUAYA, CENGKARENG, JAKARTA BARAT, DKI JAKARTA",143,257,3,260
https://kawalpemilu.org#25928,"RAWA BUAYA, CENGKARENG, JAKARTA BARAT, DKI JAKARTA",144,263,3,266
https://kawalpemilu.org#25928,"RAWA BUAYA, CENGKARENG, JAKARTA BARAT, DKI JAKARTA",145,223,23,246
https://kawalpemilu.org#25928,"RAWA BUAYA, CENGKARENG, JAKARTA BARAT, DKI JAKARTA",146,211,49,260
https://kawalpemilu.org#25928,"RAWA BUAYA, CENGKARENG, JAKARTA BARAT, DKI JAKARTA",147,256,8,264
https://kawalpemilu.org#25928,"RAWA BUAYA, CENGKARENG, JAKARTA BARAT, DKI JAKARTA",148,116,115,231
https://kawalpemilu.org#25928,"RAWA BUAYA, CENGKARENG, JAKARTA BARAT, DKI JAKARTA",149,98,97,195
https://kawalpemilu.org#25928,"RAWA BUAYA, CENGKARENG, JAKARTA BARAT, DKI JAKARTA",150,143,110,253
https://kawalpemilu.org#25928,"RAWA BUAYA, CENGKARENG, JAKARTA BARAT, DKI JAKARTA",151,120,109,229
https://kawalpemilu.org#25928,"RAWA BUAYA, CENGKARENG, JAKARTA BARAT, DKI JAKARTA",152,118,121,239
https://kawalpemilu.org#25928,"RAWA BUAYA, CENGKARENG, JAKARTA BARAT, DKI JAKARTA",153,149,134,283
https://kawalpemilu.org#25928,"RAWA BUAYA, CENGKARENG, JAKARTA BARAT, DKI JAKARTA",154,142,112,254
https://kawalpemilu.org#25928,"RAWA BUAYA, CENGKARENG, JAKARTA BARAT, DKI JAKARTA",155,126,108,234
https://kawalpemilu.org#25928,"RAWA BUAYA, CENGKARENG, JAKARTA BARAT, DKI JAKARTA",156,124,98,222
https://kawalpemilu.org#25928,"RAWA BUAYA, CENGKARENG, JAKARTA BARAT, DKI JAKARTA",157,88,91,179
https://kawalpemilu.org#25928,"RAWA BUAYA, CENGKARENG, JAKARTA BARAT, DKI JAKARTA",158,158,92,250
https://kawalpemilu.org#25928,"RAWA BUAYA, CENGKARENG, JAKARTA BARAT, DKI JAKARTA",159,141,75,216
https://kawalpemilu.org#25928,"RAWA BUAYA, CENGKARENG, JAKARTA BARAT, DKI JAKARTA",160,143,96,239
https://kawalpemilu.org#25928,"RAWA BUAYA, CENGKARENG, JAKARTA BARAT, DKI JAKARTA",161,154,88,242
https://kawalpemilu.org#25928,"RAWA BUAYA, CENGKARENG, JAKARTA BARAT, DKI JAKARTA",162,101,140,241
https://kawalpemilu.org#25928,"RAWA BUAYA, CENGKARENG, JAKARTA BARAT, DKI JAKARTA",163,170,60,231
https://kawalpemilu.org#25928,"RAWA BUAYA, CENGKARENG, JAKARTA BARAT, DKI JAKARTA",164,147,125,272
https://kawalpemilu.org#25928,"RAWA BUAYA, CENGKARENG, JAKARTA BARAT, DKI JAKARTA",165,124,143,267
https://kawalpemilu.org#25928,"RAWA BUAYA, CENGKARENG, JAKARTA BARAT, DKI JAKARTA",166,112,142,254
https://kawalpemilu.org#25928,"RAWA BUAYA, CENGKARENG, JAKARTA BARAT, DKI JAKARTA",167,140,130,270
https://kawalpemilu.org#25928,"RAWA BUAYA, CENGKARENG, JAKARTA BARAT, DKI JAKARTA",168,86,151,237
https://kawalpemilu.org#25928,"RAWA BUAYA, CENGKARENG, JAKARTA BARAT, DKI JAKARTA",169,140,102,242
https://kawalpemilu.org#25928,"RAWA BUAYA, CENGKARENG, JAKARTA BARAT, DKI JAKARTA",170,144,131,275
https://kawalpemilu.org#25928,"RAWA BUAYA, CENGKARENG, JAKARTA BARAT, DKI JAKARTA",171,144,118,262
https://kawalpemilu.org#25928,"RAWA BUAYA, CENGKARENG, JAKARTA BARAT, DKI JAKARTA",172,144,89,233
https://kawalpemilu.org#25928,"RAWA BUAYA, CENGKARENG, JAKARTA BARAT, DKI JAKARTA",173,105,89,194
https://kawalpemilu.org#25928,"RAWA BUAYA, CENGKARENG, JAKARTA BARAT, DKI JAKARTA",174,193,69,262
https://kawalpemilu.org#25928,"RAWA BUAYA, CENGKARENG, JAKARTA BARAT, DKI JAKARTA",175,97,109,206
https://kawalpemilu.org#25928,"RAWA BUAYA, CENGKARENG, JAKARTA BARAT, DKI JAKARTA",176,112,106,218
https://kawalpemilu.org#25928,"RAWA BUAYA, CENGKARENG, JAKARTA BARAT, DKI JAKARTA",177,93,103,196
https://kawalpemilu.org#25928,"RAWA BUAYA, CENGKARENG, JAKARTA BARAT, DKI JAKARTA",178,157,71,228
https://kawalpemilu.org#25928,"RAWA BUAYA, CENGKARENG, JAKARTA BARAT, DKI JAKARTA",179,124,69,193
https://kawalpemilu.org#25928,"RAWA BUAYA, CENGKARENG, JAKARTA BARAT, DKI JAKARTA",180,144,69,213
https://kawalpemilu.org#25928,"RAWA BUAYA, CENGKARENG, JAKARTA BARAT, DKI JAKARTA",181,135,56,191
https://kawalpemilu.org#25928,"RAWA BUAYA, CENGKARENG, JAKARTA BARAT, DKI JAKARTA",182,95,39,134
https://kawalpemilu.org#25928,"RAWA BUAYA, CENGKARENG, JAKARTA BARAT, DKI JAKARTA",183,125,116,241
https://kawalpemilu.org#25928,"RAWA BUAYA, CENGKARENG, JAKARTA BARAT, DKI JAKARTA",184,137,90,227
https://kawalpemilu.org#25928,"RAWA BUAYA, CENGKARENG, JAKARTA BARAT, DKI JAKARTA",185,130,168,298
https://kawalpemilu.org#25928,"RAWA BUAYA, CENGKARENG, JAKARTA BARAT, DKI JAKARTA",186,159,85,244
https://kawalpemilu.org#25928,"RAWA BUAYA, CENGKARENG, JAKARTA BARAT, DKI JAKARTA",187,126,95,221
https://kawalpemilu.org#25928,"RAWA BUAYA, CENGKARENG, JAKARTA BARAT, DKI JAKARTA",188,184,91,275
https://kawalpemilu.org#25928,"RAWA BUAYA, CENGKARENG, JAKARTA BARAT, DKI JAKARTA",189,155,103,258
https://kawalpemilu.org#25928,"RAWA BUAYA, CENGKARENG, JAKARTA BARAT, DKI JAKARTA",190,91,149,240
https://kawalpemilu.org#25928,"RAWA BUAYA, CENGKARENG, JAKARTA BARAT, DKI JAKARTA",191,118,161,279
https://kawalpemilu.org#25928,"RAWA BUAYA, CENGKARENG, JAKARTA BARAT, DKI JAKARTA",192,0,0,0
https://kawalpemilu.org#25928,"RAWA BUAYA, CENGKARENG, JAKARTA BARAT, DKI JAKARTA",193,136,105,241
https://kawalpemilu.org#25929,"KEDAUNG KALI ANGKE, CENGKARENG, JAKARTA BARAT, DKI JAKARTA",1,115,75,190
https://kawalpemilu.org#25929,"KEDAUNG KALI ANGKE, CENGKARENG, JAKARTA BARAT, DKI JAKARTA",2,141,97,238
https://kawalpemilu.org#25929,"KEDAUNG KALI ANGKE, CENGKARENG, JAKARTA BARAT, DKI JAKARTA",3,112,68,180
https://kawalpemilu.org#25929,"KEDAUNG KALI ANGKE, CENGKARENG, JAKARTA BARAT, DKI JAKARTA",4,125,67,192
https://kawalpemilu.org#25929,"KEDAUNG KALI ANGKE, CENGKARENG, JAKARTA BARAT, DKI JAKARTA",5,135,59,194
https://kawalpemilu.org#25929,"KEDAUNG KALI ANGKE, CENGKARENG, JAKARTA BARAT, DKI JAKARTA",6,159,94,253
https://kawalpemilu.org#25929,"KEDAUNG KALI ANGKE, CENGKARENG, JAKARTA BARAT, DKI JAKARTA",7,130,127,257
https://kawalpemilu.org#25929,"KEDAUNG KALI ANGKE, CENGKARENG, JAKARTA BARAT, DKI JAKARTA",8,107,130,237
https://kawalpemilu.org#25929,"KEDAUNG KALI ANGKE, CENGKARENG, JAKARTA BARAT, DKI JAKARTA",9,138,118,256
https://kawalpemilu.org#25929,"KEDAUNG KALI ANGKE, CENGKARENG, JAKARTA BARAT, DKI JAKARTA",10,120,88,208
https://kawalpemilu.org#25929,"KEDAUNG KALI ANGKE, CENGKARENG, JAKARTA BARAT, DKI JAKARTA",11,100,84,184
https://kawalpemilu.org#25929,"KEDAUNG KALI ANGKE, CENGKARENG, JAKARTA BARAT, DKI JAKARTA",12,157,69,226
https://kawalpemilu.org#25929,"KEDAUNG KALI ANGKE, CENGKARENG, JAKARTA BARAT, DKI JAKARTA",13,127,101,228
https://kawalpemilu.org#25929,"KEDAUNG KALI ANGKE, CENGKARENG, JAKARTA BARAT, DKI JAKARTA",14,78,115,193
https://kawalpemilu.org#25929,"KEDAUNG KALI ANGKE, CENGKARENG, JAKARTA BARAT, DKI JAKARTA",15,153,78,231
https://kawalpemilu.org#25929,"KEDAUNG KALI ANGKE, CENGKARENG, JAKARTA BARAT, DKI JAKARTA",16,140,121,261
https://kawalpemilu.org#25929,"KEDAUNG KALI ANGKE, CENGKARENG, JAKARTA BARAT, DKI JAKARTA",17,105,115,220
https://kawalpemilu.org#25929,"KEDAUNG KALI ANGKE, CENGKARENG, JAKARTA BARAT, DKI JAKARTA",18,82,89,172
https://kawalpemilu.org#25929,"KEDAUNG KALI ANGKE, CENGKARENG, JAKARTA BARAT, DKI JAKARTA",19,125,138,263
https://kawalpemilu.org#25929,"KEDAUNG KALI ANGKE, CENGKARENG, JAKARTA BARAT, DKI JAKARTA",20,97,142,239
https://kawalpemilu.org#25929,"KEDAUNG KALI ANGKE, CENGKARENG, JAKARTA BARAT, DKI JAKARTA",21,157,107,264
https://kawalpemilu.org#25929,"KEDAUNG KALI ANGKE, CENGKARENG, JAKARTA BARAT, DKI JAKARTA",22,100,140,240
https://kawalpemilu.org#25929,"KEDAUNG KALI ANGKE, CENGKARENG, JAKARTA BARAT, DKI JAKARTA",23,125,118,243
https://kawalpemilu.org#25929,"KEDAUNG KALI ANGKE, CENGKARENG, JAKARTA BARAT, DKI JAKARTA",24,164,91,255
https://kawalpemilu.org#25929,"KEDAUNG KALI ANGKE, CENGKARENG, JAKARTA BARAT, DKI JAKARTA",25,111,146,257
https://kawalpemilu.org#25929,"KEDAUNG KALI ANGKE, CENGKARENG, JAKARTA BARAT, DKI JAKARTA",26,102,128,230
https://kawalpemilu.org#25929,"KEDAUNG KALI ANGKE, CENGKARENG, JAKARTA BARAT, DKI JAKARTA",27,107,113,220
https://kawalpemilu.org#25929,"KEDAUNG KALI ANGKE, CENGKARENG, JAKARTA BARAT, DKI JAKARTA",28,164,99,263
https://kawalpemilu.org#25929,"KEDAUNG KALI ANGKE, CENGKARENG, JAKARTA BARAT, DKI JAKARTA",29,155,104,259
https://kawalpemilu.org#25929,"KEDAUNG KALI ANGKE, CENGKARENG, JAKARTA BARAT, DKI JAKARTA",30,133,117,250
https://kawalpemilu.org#25929,"KEDAUNG KALI ANGKE, CENGKARENG, JAKARTA BARAT, DKI JAKARTA",31,109,118,227
https://kawalpemilu.org#25929,"KEDAUNG KALI ANGKE, CENGKARENG, JAKARTA BARAT, DKI JAKARTA",32,125,111,236
https://kawalpemilu.org#25929,"KEDAUNG KALI ANGKE, CENGKARENG, JAKARTA BARAT, DKI JAKARTA",33,151,94,245
https://kawalpemilu.org#25929,"KEDAUNG KALI ANGKE, CENGKARENG, JAKARTA BARAT, DKI JAKARTA",34,144,88,232
https://kawalpemilu.org#25929,"KEDAUNG KALI ANGKE, CENGKARENG, JAKARTA BARAT, DKI JAKARTA",35,183,81,264
https://kawalpemilu.org#25929,"KEDAUNG KALI ANGKE, CENGKARENG, JAKARTA BARAT, DKI JAKARTA",36,95,133,228
https://kawalpemilu.org#25929,"KEDAUNG KALI ANGKE, CENGKARENG, JAKARTA BARAT, DKI JAKARTA",37,118,79,197
https://kawalpemilu.org#25929,"KEDAUNG KALI ANGKE, CENGKARENG, JAKARTA BARAT, DKI JAKARTA",38,168,64,232
https://kawalpemilu.org#25929,"KEDAUNG KALI ANGKE, CENGKARENG, JAKARTA BARAT, DKI JAKARTA",39,163,108,271
https://kawalpemilu.org#25929,"KEDAUNG KALI ANGKE, CENGKARENG, JAKARTA BARAT, DKI JAKARTA",40,142,114,256
https://kawalpemilu.org#25929,"KEDAUNG KALI ANGKE, CENGKARENG, JAKARTA BARAT, DKI JAKARTA",41,160,111,271
https://kawalpemilu.org#25929,"KEDAUNG KALI ANGKE, CENGKARENG, JAKARTA BARAT, DKI JAKARTA",42,95,126,221
https://kawalpemilu.org#25929,"KEDAUNG KALI ANGKE, CENGKARENG, JAKARTA BARAT, DKI JAKARTA",43,142,78,220
https://kawalpemilu.org#25929,"KEDAUNG KALI ANGKE, CENGKARENG, JAKARTA BARAT, DKI JAKARTA",44,137,131,268
https://kawalpemilu.org#25929,"KEDAUNG KALI ANGKE, CENGKARENG, JAKARTA BARAT, DKI JAKARTA",46,126,108,234
https://kawalpemilu.org#25929,"KEDAUNG KALI ANGKE, CENGKARENG, JAKARTA BARAT, DKI JAKARTA",47,98,144,242
https://kawalpemilu.org#25929,"KEDAUNG KALI ANGKE, CENGKARENG, JAKARTA BARAT, DKI JAKARTA",48,126,126,252
https://kawalpemilu.org#25929,"KEDAUNG KALI ANGKE, CENGKARENG, JAKARTA BARAT, DKI JAKARTA",49,104,132,236
https://kawalpemilu.org#25929,"KEDAUNG KALI ANGKE, CENGKARENG, JAKARTA BARAT, DKI JAKARTA",50,119,104,223
https://kawalpemilu.org#25929,"KEDAUNG KALI ANGKE, CENGKARENG, JAKARTA BARAT, DKI JAKARTA",51,79,145,224
https://kawalpemilu.org#25929,"KEDAUNG KALI ANGKE, CENGKARENG, JAKARTA BARAT, DKI JAKARTA",52,87,128,215
https://kawalpemilu.org#25929,"KEDAUNG KALI ANGKE, CENGKARENG, JAKARTA BARAT, DKI JAKARTA",53,143,123,266
https://kawalpemilu.org#25929,"KEDAUNG KALI ANGKE, CENGKARENG, JAKARTA BARAT, DKI JAKARTA",54,125,87,212
https://kawalpemilu.org#25929,"KEDAUNG KALI ANGKE, CENGKARENG, JAKARTA BARAT, DKI JAKARTA",55,119,75,194
https://kawalpemilu.org#25929,"KEDAUNG KALI ANGKE, CENGKARENG, JAKARTA BARAT, DKI JAKARTA",56,128,143,271
https://kawalpemilu.org#25929,"KEDAUNG KALI ANGKE, CENGKARENG, JAKARTA BARAT, DKI JAKARTA",57,99,122,221
https://kawalpemilu.org#25929,"KEDAUNG KALI ANGKE, CENGKARENG, JAKARTA BARAT, DKI JAKARTA",58,132,97,229
https://kawalpemilu.org#25929,"KEDAUNG KALI ANGKE, CENGKARENG, JAKARTA BARAT, DKI JAKARTA",59,176,79,255
https://kawalpemilu.org#25929,"KEDAUNG KALI ANGKE, CENGKARENG, JAKARTA BARAT, DKI JAKARTA",60,158,84,242
https://kawalpemilu.org#25929,"KEDAUNG KALI ANGKE, CENGKARENG, JAKARTA BARAT, DKI JAKARTA",61,152,71,223
https://kawalpemilu.org#25929,"KEDAUNG KALI ANGKE, CENGKARENG, JAKARTA BARAT, DKI JAKARTA",62,129,90,219
https://kawalpemilu.org#25929,"KEDAUNG KALI ANGKE, CENGKARENG, JAKARTA BARAT, DKI JAKARTA",63,172,78,250
https://kawalpemilu.org#25929,"KEDAUNG KALI ANGKE, CENGKARENG, JAKARTA BARAT, DKI JAKARTA",64,120,92,212
https://kawalpemilu.org#25929,"KEDAUNG KALI ANGKE, CENGKARENG, JAKARTA BARAT, DKI JAKARTA",65,155,121,276
https://kawalpemilu.org#25929,"KEDAUNG KALI ANGKE, CENGKARENG, JAKARTA BARAT, DKI JAKARTA",66,234,7,241
https://kawalpemilu.org#25929,"KEDAUNG KALI ANGKE, CENGKARENG, JAKARTA BARAT, DKI JAKARTA",67,200,3,203
https://kawalpemilu.org#25929,"KEDAUNG KALI ANGKE, CENGKARENG, JAKARTA BARAT, DKI JAKARTA",68,214,2,216
https://kawalpemilu.org#25929,"KEDAUNG KALI ANGKE, CENGKARENG, JAKARTA BARAT, DKI JAKARTA",69,195,14,209
https://kawalpemilu.org#25929,"KEDAUNG KALI ANGKE, CENGKARENG, JAKARTA BARAT, DKI JAKARTA",70,176,57,233
https://kawalpemilu.org#25929,"KEDAUNG KALI ANGKE, CENGKARENG, JAKARTA BARAT, DKI JAKARTA",71,170,65,235
https://kawalpemilu.org#25929,"KEDAUNG KALI ANGKE, CENGKARENG, JAKARTA BARAT, DKI JAKARTA",72,160,103,263
https://kawalpemilu.org#25929,"KEDAUNG KALI ANGKE, CENGKARENG, JAKARTA BARAT, DKI JAKARTA",73,118,55,173
https://kawalpemilu.org#25929,"KEDAUNG KALI ANGKE, CENGKARENG, JAKARTA BARAT, DKI JAKARTA",74,179,80,259
https://kawalpemilu.org#25929,"KEDAUNG KALI ANGKE, CENGKARENG, JAKARTA BARAT, DKI JAKARTA",75,117,105,222
https://kawalpemilu.org#25929,"KEDAUNG KALI ANGKE, CENGKARENG, JAKARTA BARAT, DKI JAKARTA",76,107,82,189
https://kawalpemilu.org#25929,"KEDAUNG KALI ANGKE, CENGKARENG, JAKARTA BARAT, DKI JAKARTA",77,183,19,202
https://kawalpemilu.org#25929,"KEDAUNG KALI ANGKE, CENGKARENG, JAKARTA BARAT, DKI JAKARTA",78,104,137,241
https://kawalpemilu.org#25929,"KEDAUNG KALI ANGKE, CENGKARENG, JAKARTA BARAT, DKI JAKARTA",79,136,125,261
https://kawalpemilu.org#25929,"KEDAUNG KALI ANGKE, CENGKARENG, JAKARTA BARAT, DKI JAKARTA",80,118,121,239
https://kawalpemilu.org#25929,"KEDAUNG KALI ANGKE, CENGKARENG, JAKARTA BARAT, DKI JAKARTA",81,122,138,260
https://kawalpemilu.org#25929,"KEDAUNG KALI ANGKE, CENGKARENG, JAKARTA BARAT, DKI JAKARTA",82,95,103,198
https://kawalpemilu.org#25929,"KEDAUNG KALI ANGKE, CENGKARENG, JAKARTA BARAT, DKI JAKARTA",83,94,72,166
https://kawalpemilu.org#25929,"KEDAUNG KALI ANGKE, CENGKARENG, JAKARTA BARAT, DKI JAKARTA",84,115,103,218
https://kawalpemilu.org#25929,"KEDAUNG KALI ANGKE, CENGKARENG, JAKARTA BARAT, DKI JAKARTA",85,116,84,0
https://kawalpemilu.org#25929,"KEDAUNG KALI ANGKE, CENGKARENG, JAKARTA BARAT, DKI JAKARTA",86,104,79,183
https://kawalpemilu.org#25929,"KEDAUNG KALI ANGKE, CENGKARENG, JAKARTA BARAT, DKI JAKARTA",87,111,82,193
https://kawalpemilu.org#25929,"KEDAUNG KALI ANGKE, CENGKARENG, JAKARTA BARAT, DKI JAKARTA",88,100,139,239
https://kawalpemilu.org#25929,"KEDAUNG KALI ANGKE, CENGKARENG, JAKARTA BARAT, DKI JAKARTA",89,125,79,204
https://kawalpemilu.org#25929,"KEDAUNG KALI ANGKE, CENGKARENG, JAKARTA BARAT, DKI JAKARTA",90,102,62,164
https://kawalpemilu.org#25929,"KEDAUNG KALI ANGKE, CENGKARENG, JAKARTA BARAT, DKI JAKARTA",91,143,126,269
https://kawalpemilu.org#25929,"KEDAUNG KALI ANGKE, CENGKARENG, JAKARTA BARAT, DKI JAKARTA",92,92,69,161
https://kawalpemilu.org#25929,"KEDAUNG KALI ANGKE, CENGKARENG, JAKARTA BARAT, DKI JAKARTA",93,59,129,188
https://kawalpemilu.org#25929,"KEDAUNG KALI ANGKE, CENGKARENG, JAKARTA BARAT, DKI JAKARTA",94,130,89,219
https://kawalpemilu.org#25929,"KEDAUNG KALI ANGKE, CENGKARENG, JAKARTA BARAT, DKI JAKARTA",95,259,4,263
https://kawalpemilu.org#25929,"KEDAUNG KALI ANGKE, CENGKARENG, JAKARTA BARAT, DKI JAKARTA",96,291,6,297
https://kawalpemilu.org#25929,"KEDAUNG KALI ANGKE, CENGKARENG, JAKARTA BARAT, DKI JAKARTA",97,279,5,284
https://kawalpemilu.org#25929,"KEDAUNG KALI ANGKE, CENGKARENG, JAKARTA BARAT, DKI JAKARTA",98,234,12,246
https://kawalpemilu.org#25929,"KEDAUNG KALI ANGKE, CENGKARENG, JAKARTA BARAT, DKI JAKARTA",99,244,6,250
https://kawalpemilu.org#25930,"KAPUK, CENGKARENG, JAKARTA BARAT, DKI JAKARTA",1,170,17,187
https://kawalpemilu.org#25930,"KAPUK, CENGKARENG, JAKARTA BARAT, DKI JAKARTA",2,149,52,201
https://kawalpemilu.org#25930,"KAPUK, CENGKARENG, JAKARTA BARAT, DKI JAKARTA",3,155,54,209
https://kawalpemilu.org#25930,"KAPUK, CENGKARENG, JAKARTA BARAT, DKI JAKARTA",4,128,76,204
https://kawalpemilu.org#25930,"KAPUK, CENGKARENG, JAKARTA BARAT, DKI JAKARTA",5,173,60,233
https://kawalpemilu.org#25930,"KAPUK, CENGKARENG, JAKARTA BARAT, DKI JAKARTA",6,183,46,229
https://kawalpemilu.org#25930,"KAPUK, CENGKARENG, JAKARTA BARAT, DKI JAKARTA",7,214,27,241
https://kawalpemilu.org#25930,"KAPUK, CENGKARENG, JAKARTA BARAT, DKI JAKARTA",8,209,34,243
https://kawalpemilu.org#25930,"KAPUK, CENGKARENG, JAKARTA BARAT, DKI JAKARTA",9,138,88,226
https://kawalpemilu.org#25930,"KAPUK, CENGKARENG, JAKARTA BARAT, DKI JAKARTA",10,142,90,232
https://kawalpemilu.org#25930,"KAPUK, CENGKARENG, JAKARTA BARAT, DKI JAKARTA",11,122,80,202
https://kawalpemilu.org#25930,"KAPUK, CENGKARENG, JAKARTA BARAT, DKI JAKARTA",12,114,87,201
https://kawalpemilu.org#25930,"KAPUK, CENGKARENG, JAKARTA BARAT, DKI JAKARTA",13,123,76,199
https://kawalpemilu.org#25930,"KAPUK, CENGKARENG, JAKARTA BARAT, DKI JAKARTA",14,128,65,193
https://kawalpemilu.org#25930,"KAPUK, CENGKARENG, JAKARTA BARAT, DKI JAKARTA",15,108,79,187
https://kawalpemilu.org#25930,"KAPUK, CENGKARENG, JAKARTA BARAT, DKI JAKARTA",16,178,41,219
https://kawalpemilu.org#25930,"KAPUK, CENGKARENG, JAKARTA BARAT, DKI JAKARTA",17,165,38,203
https://kawalpemilu.org#25930,"KAPUK, CENGKARENG, JAKARTA BARAT, DKI JAKARTA",18,158,25,183
https://kawalpemilu.org#25930,"KAPUK, CENGKARENG, JAKARTA BARAT, DKI JAKARTA",19,142,55,197
https://kawalpemilu.org#25930,"KAPUK, CENGKARENG, JAKARTA BARAT, DKI JAKARTA",20,170,36,206
https://kawalpemilu.org#25930,"KAPUK, CENGKARENG, JAKARTA BARAT, DKI JAKARTA",21,219,20,239
https://kawalpemilu.org#25930,"KAPUK, CENGKARENG, JAKARTA BARAT, DKI JAKARTA",22,165,25,190
https://kawalpemilu.org#25930,"KAPUK, CENGKARENG, JAKARTA BARAT, DKI JAKARTA",23,162,27,195
https://kawalpemilu.org#25930,"KAPUK, CENGKARENG, JAKARTA BARAT, DKI JAKARTA",24,178,47,225
https://kawalpemilu.org#25930,"KAPUK, CENGKARENG, JAKARTA BARAT, DKI JAKARTA",25,180,29,209
https://kawalpemilu.org#25930,"KAPUK, CENGKARENG, JAKARTA BARAT, DKI JAKARTA",26,157,34,191
https://kawalpemilu.org#25930,"KAPUK, CENGKARENG, JAKARTA BARAT, DKI JAKARTA",27,170,10,180
https://kawalpemilu.org#25930,"KAPUK, CENGKARENG, JAKARTA BARAT, DKI JAKARTA",28,157,38,195
https://kawalpemilu.org#25930,"KAPUK, CENGKARENG, JAKARTA BARAT, DKI JAKARTA",29,162,68,230
https://kawalpemilu.org#25930,"KAPUK, CENGKARENG, JAKARTA BARAT, DKI JAKARTA",30,182,58,240
https://kawalpemilu.org#25930,"KAPUK, CENGKARENG, JAKARTA BARAT, DKI JAKARTA",31,122,90,212
https://kawalpemilu.org#25930,"KAPUK, CENGKARENG, JAKARTA BARAT, DKI JAKARTA",32,140,58,198
https://kawalpemilu.org#25930,"KAPUK, CENGKARENG, JAKARTA BARAT, DKI JAKARTA",33,173,48,221
https://kawalpemilu.org#25930,"KAPUK, CENGKARENG, JAKARTA BARAT, DKI JAKARTA",34,159,59,218
https://kawalpemilu.org#25930,"KAPUK, CENGKARENG, JAKARTA BARAT, DKI JAKARTA",35,148,93,241
https://kawalpemilu.org#25930,"KAPUK, CENGKARENG, JAKARTA BARAT, DKI JAKARTA",36,165,75,240
https://kawalpemilu.org#25930,"KAPUK, CENGKARENG, JAKARTA BARAT, DKI JAKARTA",37,159,75,234
https://kawalpemilu.org#25930,"KAPUK, CENGKARENG, JAKARTA BARAT, DKI JAKARTA",38,129,73,202
https://kawalpemilu.org#25930,"KAPUK, CENGKARENG, JAKARTA BARAT, DKI JAKARTA",39,143,89,232
https://kawalpemilu.org#25930,"KAPUK, CENGKARENG, JAKARTA BARAT, DKI JAKARTA",40,134,88,222
https://kawalpemilu.org#25930,"KAPUK, CENGKARENG, JAKARTA BARAT, DKI JAKARTA",41,113,74,187
https://kawalpemilu.org#25930,"KAPUK, CENGKARENG, JAKARTA BARAT, DKI JAKARTA",42,136,79,215
https://kawalpemilu.org#25930,"KAPUK, CENGKARENG, JAKARTA BARAT, DKI JAKARTA",43,163,87,250
https://kawalpemilu.org#25930,"KAPUK, CENGKARENG, JAKARTA BARAT, DKI JAKARTA",44,137,88,225
https://kawalpemilu.org#25930,"KAPUK, CENGKARENG, JAKARTA BARAT, DKI JAKARTA",45,166,72,238
https://kawalpemilu.org#25930,"KAPUK, CENGKARENG, JAKARTA BARAT, DKI JAKARTA",46,141,81,222
https://kawalpemilu.org#25930,"KAPUK, CENGKARENG, JAKARTA BARAT, DKI JAKARTA",47,132,93,225
https://kawalpemilu.org#25930,"KAPUK, CENGKARENG, JAKARTA BARAT, DKI JAKARTA",48,114,71,185
https://kawalpemilu.org#25930,"KAPUK, CENGKARENG, JAKARTA BARAT, DKI JAKARTA",49,122,109,231
https://kawalpemilu.org#25930,"KAPUK, CENGKARENG, JAKARTA BARAT, DKI JAKARTA",50,130,74,204
https://kawalpemilu.org#25930,"KAPUK, CENGKARENG, JAKARTA BARAT, DKI JAKARTA",51,106,88,194
https://kawalpemilu.org#25930,"KAPUK, CENGKARENG, JAKARTA BARAT, DKI JAKARTA",52,155,48,203
https://kawalpemilu.org#25930,"KAPUK, CENGKARENG, JAKARTA BARAT, DKI JAKARTA",53,146,63,209
https://kawalpemilu.org#25930,"KAPUK, CENGKARENG, JAKARTA BARAT, DKI JAKARTA",54,141,75,216
https://kawalpemilu.org#25930,"KAPUK, CENGKARENG, JAKARTA BARAT, DKI JAKARTA",55,114,72,186
https://kawalpemilu.org#25930,"KAPUK, CENGKARENG, JAKARTA BARAT, DKI JAKARTA",56,122,81,203
https://kawalpemilu.org#25930,"KAPUK, CENGKARENG, JAKARTA BARAT, DKI JAKARTA",57,134,85,219
https://kawalpemilu.org#25930,"KAPUK, CENGKARENG, JAKARTA BARAT, DKI JAKARTA",58,123,98,221
https://kawalpemilu.org#25930,"KAPUK, CENGKARENG, JAKARTA BARAT, DKI JAKARTA",59,134,99,233
https://kawalpemilu.org#25930,"KAPUK, CENGKARENG, JAKARTA BARAT, DKI JAKARTA",60,135,70,205
https://kawalpemilu.org#25930,"KAPUK, CENGKARENG, JAKARTA BARAT, DKI JAKARTA",61,148,66,214
https://kawalpemilu.org#25930,"KAPUK, CENGKARENG, JAKARTA BARAT, DKI JAKARTA",62,148,75,223
https://kawalpemilu.org#25930,"KAPUK, CENGKARENG, JAKARTA BARAT, DKI JAKARTA",63,130,87,217
https://kawalpemilu.org#25930,"KAPUK, CENGKARENG, JAKARTA BARAT, DKI JAKARTA",64,151,65,216
https://kawalpemilu.org#25930,"KAPUK, CENGKARENG, JAKARTA BARAT, DKI JAKARTA",65,120,47,167
https://kawalpemilu.org#25930,"KAPUK, CENGKARENG, JAKARTA BARAT, DKI JAKARTA",66,169,74,243
https://kawalpemilu.org#25930,"KAPUK, CENGKARENG, JAKARTA BARAT, DKI JAKARTA",67,121,79,203
https://kawalpemilu.org#25930,"KAPUK, CENGKARENG, JAKARTA BARAT, DKI JAKARTA",68,123,77,200
https://kawalpemilu.org#25930,"KAPUK, CENGKARENG, JAKARTA BARAT, DKI JAKARTA",69,122,116,234
https://kawalpemilu.org#25930,"KAPUK, CENGKARENG, JAKARTA BARAT, DKI JAKARTA",70,130,102,232
https://kawalpemilu.org#25930,"KAPUK, CENGKARENG, JAKARTA BARAT, DKI JAKARTA",71,132,128,260
https://kawalpemilu.org#25930,"KAPUK, CENGKARENG, JAKARTA BARAT, DKI JAKARTA",72,112,100,212
https://kawalpemilu.org#25930,"KAPUK, CENGKARENG, JAKARTA BARAT, DKI JAKARTA",73,153,79,232
https://kawalpemilu.org#25930,"KAPUK, CENGKARENG, JAKARTA BARAT, DKI JAKARTA",75,150,110,260
https://kawalpemilu.org#25930,"KAPUK, CENGKARENG, JAKARTA BARAT, DKI JAKARTA",76,122,87,209
https://kawalpemilu.org#25930,"KAPUK, CENGKARENG, JAKARTA BARAT, DKI JAKARTA",77,143,63,206
https://kawalpemilu.org#25930,"KAPUK, CENGKARENG, JAKARTA BARAT, DKI JAKARTA",78,137,67,204
https://kawalpemilu.org#25930,"KAPUK, CENGKARENG, JAKARTA BARAT, DKI JAKARTA",79,164,49,213
https://kawalpemilu.org#25930,"KAPUK, CENGKARENG, JAKARTA BARAT, DKI JAKARTA",80,150,38,188
https://kawalpemilu.org#25930,"KAPUK, CENGKARENG, JAKARTA BARAT, DKI JAKARTA",81,143,114,257
https://kawalpemilu.org#25930,"KAPUK, CENGKARENG, JAKARTA BARAT, DKI JAKARTA",82,144,105,249
https://kawalpemilu.org#25930,"KAPUK, CENGKARENG, JAKARTA BARAT, DKI JAKARTA",83,152,66,218
https://kawalpemilu.org#25930,"KAPUK, CENGKARENG, JAKARTA BARAT, DKI JAKARTA",84,138,89,227
https://kawalpemilu.org#25930,"KAPUK, CENGKARENG, JAKARTA BARAT, DKI JAKARTA",85,129,108,237
https://kawalpemilu.org#25930,"KAPUK, CENGKARENG, JAKARTA BARAT, DKI JAKARTA",86,164,83,247
https://kawalpemilu.org#25930,"KAPUK, CENGKARENG, JAKARTA BARAT, DKI JAKARTA",87,135,88,223
https://kawalpemilu.org#25930,"KAPUK, CENGKARENG, JAKARTA BARAT, DKI JAKARTA",88,112,75,187
https://kawalpemilu.org#25930,"KAPUK, CENGKARENG, JAKARTA BARAT, DKI JAKARTA",89,156,62,218
https://kawalpemilu.org#25930,"KAPUK, CENGKARENG, JAKARTA BARAT, DKI JAKARTA",90,191,36,227
https://kawalpemilu.org#25930,"KAPUK, CENGKARENG, JAKARTA BARAT, DKI JAKARTA",91,180,68,248
https://kawalpemilu.org#25930,"KAPUK, CENGKARENG, JAKARTA BARAT, DKI JAKARTA",92,166,58,224
https://kawalpemilu.org#25930,"KAPUK, CENGKARENG, JAKARTA BARAT, DKI JAKARTA",93,149,79,228
https://kawalpemilu.org#25930,"KAPUK, CENGKARENG, JAKARTA BARAT, DKI JAKARTA",94,167,61,228
https://kawalpemilu.org#25930,"KAPUK, CENGKARENG, JAKARTA BARAT, DKI JAKARTA",95,148,87,235
https://kawalpemilu.org#25930,"KAPUK, CENGKARENG, JAKARTA BARAT, DKI JAKARTA",97,197,37,234
https://kawalpemilu.org#25930,"KAPUK, CENGKARENG, JAKARTA BARAT, DKI JAKARTA",98,178,38,216
https://kawalpemilu.org#25930,"KAPUK, CENGKARENG, JAKARTA BARAT, DKI JAKARTA",99,162,58,220
https://kawalpemilu.org#25930,"KAPUK, CENGKARENG, JAKARTA BARAT, DKI JAKARTA",100,176,53,229
https://kawalpemilu.org#25930,"KAPUK, CENGKARENG, JAKARTA BARAT, DKI JAKARTA",101,170,42,212
https://kawalpemilu.org#25930,"KAPUK, CENGKARENG, JAKARTA BARAT, DKI JAKARTA",102,176,39,215
https://kawalpemilu.org#25930,"KAPUK, CENGKARENG, JAKARTA BARAT, DKI JAKARTA",103,159,58,217
https://kawalpemilu.org#25930,"KAPUK, CENGKARENG, JAKARTA BARAT, DKI JAKARTA",104,125,72,197
https://kawalpemilu.org#25930,"KAPUK, CENGKARENG, JAKARTA BARAT, DKI JAKARTA",105,147,62,209
https://kawalpemilu.org#25930,"KAPUK, CENGKARENG, JAKARTA BARAT, DKI JAKARTA",106,148,46,194
https://kawalpemilu.org#25930,"KAPUK, CENGKARENG, JAKARTA BARAT, DKI JAKARTA",107,102,97,199
https://kawalpemilu.org#25930,"KAPUK, CENGKARENG, JAKARTA BARAT, DKI JAKARTA",108,128,99,227
https://kawalpemilu.org#25930,"KAPUK, CENGKARENG, JAKARTA BARAT, DKI JAKARTA",109,118,96,214
https://kawalpemilu.org#25930,"KAPUK, CENGKARENG, JAKARTA BARAT, DKI JAKARTA",110,130,110,240
https://kawalpemilu.org#25930,"KAPUK, CENGKARENG, JAKARTA BARAT, DKI JAKARTA",111,141,113,254
https://kawalpemilu.org#25930,"KAPUK, CENGKARENG, JAKARTA BARAT, DKI JAKARTA",112,157,86,243
https://kawalpemilu.org#25930,"KAPUK, CENGKARENG, JAKARTA BARAT, DKI JAKARTA",113,109,85,194
https://kawalpemilu.org#25930,"KAPUK, CENGKARENG, JAKARTA BARAT, DKI JAKARTA",114,92,89,181
https://kawalpemilu.org#25930,"KAPUK, CENGKARENG, JAKARTA BARAT, DKI JAKARTA",115,74,151,225
https://kawalpemilu.org#25930,"KAPUK, CENGKARENG, JAKARTA BARAT, DKI JAKARTA",116,84,95,179
https://kawalpemilu.org#25930,"KAPUK, CENGKARENG, JAKARTA BARAT, DKI JAKARTA",117,96,77,173
https://kawalpemilu.org#25930,"KAPUK, CENGKARENG, JAKARTA BARAT, DKI JAKARTA",118,215,9,224
https://kawalpemilu.org#25930,"KAPUK, CENGKARENG, JAKARTA BARAT, DKI JAKARTA",119,212,46,258
https://kawalpemilu.org#25930,"KAPUK, CENGKARENG, JAKARTA BARAT, DKI JAKARTA",121,174,63,237
https://kawalpemilu.org#25930,"KAPUK, CENGKARENG, JAKARTA BARAT, DKI JAKARTA",122,181,43,224
https://kawalpemilu.org#25930,"KAPUK, CENGKARENG, JAKARTA BARAT, DKI JAKARTA",123,164,58,222
https://kawalpemilu.org#25930,"KAPUK, CENGKARENG, JAKARTA BARAT, DKI JAKARTA",124,169,44,213
https://kawalpemilu.org#25930,"KAPUK, CENGKARENG, JAKARTA BARAT, DKI JAKARTA",125,181,41,222
https://kawalpemilu.org#25930,"KAPUK, CENGKARENG, JAKARTA BARAT, DKI JAKARTA",126,169,67,236
https://kawalpemilu.org#25930,"KAPUK, CENGKARENG, JAKARTA BARAT, DKI JAKARTA",127,188,37,225
https://kawalpemilu.org#25930,"KAPUK, CENGKARENG, JAKARTA BARAT, DKI JAKARTA",128,201,41,242
https://kawalpemilu.org#25930,"KAPUK, CENGKARENG, JAKARTA BARAT, DKI JAKARTA",129,168,44,212
https://kawalpemilu.org#25930,"KAPUK, CENGKARENG, JAKARTA BARAT, DKI JAKARTA",130,119,45,244
https://kawalpemilu.org#25930,"KAPUK, CENGKARENG, JAKARTA BARAT, DKI JAKARTA",131,183,36,219
https://kawalpemilu.org#25930,"KAPUK, CENGKARENG, JAKARTA BARAT, DKI JAKARTA",132,170,49,219
https://kawalpemilu.org#25930,"KAPUK, CENGKARENG, JAKARTA BARAT, DKI JAKARTA",133,176,44,220
https://kawalpemilu.org#25930,"KAPUK, CENGKARENG, JAKARTA BARAT, DKI JAKARTA",134,176,67,243
https://kawalpemilu.org#25930,"KAPUK, CENGKARENG, JAKARTA BARAT, DKI JAKARTA",135,170,84,254
https://kawalpemilu.org#25930,"KAPUK, CENGKARENG, JAKARTA BARAT, DKI JAKARTA",136,157,115,272
https://kawalpemilu.org#25930,"KAPUK, CENGKARENG, JAKARTA BARAT, DKI JAKARTA",137,147,94,241
https://kawalpemilu.org#25930,"KAPUK, CENGKARENG, JAKARTA BARAT, DKI JAKARTA",138,153,73,226
https://kawalpemilu.org#25930,"KAPUK, CENGKARENG, JAKARTA BARAT, DKI JAKARTA",139,143,105,248
https://kawalpemilu.org#25930,"KAPUK, CENGKARENG, JAKARTA BARAT, DKI JAKARTA",140,156,85,241
https://kawalpemilu.org#25930,"KAPUK, CENGKARENG, JAKARTA BARAT, DKI JAKARTA",141,171,78,249
https://kawalpemilu.org#25930,"KAPUK, CENGKARENG, JAKARTA BARAT, DKI JAKARTA",142,136,88,224
https://kawalpemilu.org#25930,"KAPUK, CENGKARENG, JAKARTA BARAT, DKI JAKARTA",143,122,138,260
https://kawalpemilu.org#25930,"KAPUK, CENGKARENG, JAKARTA BARAT, DKI JAKARTA",144,138,87,225
https://kawalpemilu.org#25930,"KAPUK, CENGKARENG, JAKARTA BARAT, DKI JAKARTA",145,181,70,251
https://kawalpemilu.org#25930,"KAPUK, CENGKARENG, JAKARTA BARAT, DKI JAKARTA",146,159,80,239
https://kawalpemilu.org#25930,"KAPUK, CENGKARENG, JAKARTA BARAT, DKI JAKARTA",147,155,68,223
https://kawalpemilu.org#25930,"KAPUK, CENGKARENG, JAKARTA BARAT, DKI JAKARTA",148,186,60,246
https://kawalpemilu.org#25930,"KAPUK, CENGKARENG, JAKARTA BARAT, DKI JAKARTA",149,105,69,174
https://kawalpemilu.org#25930,"KAPUK, CENGKARENG, JAKARTA BARAT, DKI JAKARTA",150,165,58,223
https://kawalpemilu.org#25930,"KAPUK, CENGKARENG, JAKARTA BARAT, DKI JAKARTA",151,194,55,249
https://kawalpemilu.org#25930,"KAPUK, CENGKARENG, JAKARTA BARAT, DKI JAKARTA",152,182,43,225
https://kawalpemilu.org#25930,"KAPUK, CENGKARENG, JAKARTA BARAT, DKI JAKARTA",153,200,65,265
https://kawalpemilu.org#25930,"KAPUK, CENGKARENG, JAKARTA BARAT, DKI JAKARTA",154,197,33,230
https://kawalpemilu.org#25930,"KAPUK, CENGKARENG, JAKARTA BARAT, DKI JAKARTA",155,193,35,228
https://kawalpemilu.org#25930,"KAPUK, CENGKARENG, JAKARTA BARAT, DKI JAKARTA",156,169,57,226
https://kawalpemilu.org#25930,"KAPUK, CENGKARENG, JAKARTA BARAT, DKI JAKARTA",157,161,94,255
https://kawalpemilu.org#25930,"KAPUK, CENGKARENG, JAKARTA BARAT, DKI JAKARTA",158,139,94,233
https://kawalpemilu.org#25930,"KAPUK, CENGKARENG, JAKARTA BARAT, DKI JAKARTA",159,95,150,245
https://kawalpemilu.org#25930,"KAPUK, CENGKARENG, JAKARTA BARAT, DKI JAKARTA",160,196,30,226
https://kawalpemilu.org#25930,"KAPUK, CENGKARENG, JAKARTA BARAT, DKI JAKARTA",161,180,33,213
https://kawalpemilu.org#25930,"KAPUK, CENGKARENG, JAKARTA BARAT, DKI JAKARTA",162,166,39,205
https://kawalpemilu.org#25930,"KAPUK, CENGKARENG, JAKARTA BARAT, DKI JAKARTA",163,148,32,180
https://kawalpemilu.org#25930,"KAPUK, CENGKARENG, JAKARTA BARAT, DKI JAKARTA",164,178,65,243
https://kawalpemilu.org#25930,"KAPUK, CENGKARENG, JAKARTA BARAT, DKI JAKARTA",165,175,64,239
https://kawalpemilu.org#25930,"KAPUK, CENGKARENG, JAKARTA BARAT, DKI JAKARTA",166,190,37,227
https://kawalpemilu.org#25930,"KAPUK, CENGKARENG, JAKARTA BARAT, DKI JAKARTA",167,164,61,225
https://kawalpemilu.org#25930,"KAPUK, CENGKARENG, JAKARTA BARAT, DKI JAKARTA",168,177,57,234
https://kawalpemilu.org#25930,"KAPUK, CENGKARENG, JAKARTA BARAT, DKI JAKARTA",169,150,64,214
https://kawalpemilu.org#25930,"KAPUK, CENGKARENG, JAKARTA BARAT, DKI JAKARTA",170,151,78,229
https://kawalpemilu.org#25930,"KAPUK, CENGKARENG, JAKARTA BARAT, DKI JAKARTA",171,150,51,201
https://kawalpemilu.org#25930,"KAPUK, CENGKARENG, JAKARTA BARAT, DKI JAKARTA",172,137,79,216
https://kawalpemilu.org#25930,"KAPUK, CENGKARENG, JAKARTA BARAT, DKI JAKARTA",173,128,65,193
https://kawalpemilu.org#25930,"KAPUK, CENGKARENG, JAKARTA BARAT, DKI JAKARTA",174,168,54,222
https://kawalpemilu.org#25930,"KAPUK, CENGKARENG, JAKARTA BARAT, DKI JAKARTA",175,159,46,205
https://kawalpemilu.org#25930,"KAPUK, CENGKARENG, JAKARTA BARAT, DKI JAKARTA",176,123,97,220
https://kawalpemilu.org#25930,"KAPUK, CENGKARENG, JAKARTA BARAT, DKI JAKARTA",177,159,77,236
https://kawalpemilu.org#25930,"KAPUK, CENGKARENG, JAKARTA BARAT, DKI JAKARTA",178,140,91,231
https://kawalpemilu.org#25930,"KAPUK, CENGKARENG, JAKARTA BARAT, DKI JAKARTA",179,164,72,236
https://kawalpemilu.org#25930,"KAPUK, CENGKARENG, JAKARTA BARAT, DKI JAKARTA",180,190,41,231
https://kawalpemilu.org#25930,"KAPUK, CENGKARENG, JAKARTA BARAT, DKI JAKARTA",181,196,62,258
https://kawalpemilu.org#25930,"KAPUK, CENGKARENG, JAKARTA BARAT, DKI JAKARTA",182,166,46,212
https://kawalpemilu.org#25930,"KAPUK, CENGKARENG, JAKARTA BARAT, DKI JAKARTA",183,171,57,228
https://kawalpemilu.org#25930,"KAPUK, CENGKARENG, JAKARTA BARAT, DKI JAKARTA",184,181,74,255
https://kawalpemilu.org#25930,"KAPUK, CENGKARENG, JAKARTA BARAT, DKI JAKARTA",185,148,79,227
https://kawalpemilu.org#25930,"KAPUK, CENGKARENG, JAKARTA BARAT, DKI JAKARTA",186,145,76,221
https://kawalpemilu.org#25930,"KAPUK, CENGKARENG, JAKARTA BARAT, DKI JAKARTA",187,157,79,236
https://kawalpemilu.org#25930,"KAPUK, CENGKARENG, JAKARTA BARAT, DKI JAKARTA",188,167,84,251
https://kawalpemilu.org#25930,"KAPUK, CENGKARENG, JAKARTA BARAT, DKI JAKARTA",189,169,85,254
https://kawalpemilu.org#25930,"KAPUK, CENGKARENG, JAKARTA BARAT, DKI JAKARTA",190,120,122,242
https://kawalpemilu.org#25930,"KAPUK, CENGKARENG, JAKARTA BARAT, DKI JAKARTA",191,127,116,243
https://kawalpemilu.org#25930,"KAPUK, CENGKARENG, JAKARTA BARAT, DKI JAKARTA",192,133,113,246
https://kawalpemilu.org#25930,"KAPUK, CENGKARENG, JAKARTA BARAT, DKI JAKARTA",193,129,122,251
https://kawalpemilu.org#25930,"KAPUK, CENGKARENG, JAKARTA BARAT, DKI JAKARTA",194,128,114,242
https://kawalpemilu.org#25930,"KAPUK, CENGKARENG, JAKARTA BARAT, DKI JAKARTA",195,129,89,218
https://kawalpemilu.org#25930,"KAPUK, CENGKARENG, JAKARTA BARAT, DKI JAKARTA",196,133,116,249
https://kawalpemilu.org#25930,"KAPUK, CENGKARENG, JAKARTA BARAT, DKI JAKARTA",197,137,106,243
https://kawalpemilu.org#25930,"KAPUK, CENGKARENG, JAKARTA BARAT, DKI JAKARTA",198,110,134,244
https://kawalpemilu.org#25930,"KAPUK, CENGKARENG, JAKARTA BARAT, DKI JAKARTA",199,140,108,248
https://kawalpemilu.org#25930,"KAPUK, CENGKARENG, JAKARTA BARAT, DKI JAKARTA",200,144,123,267
https://kawalpemilu.org#25930,"KAPUK, CENGKARENG, JAKARTA BARAT, DKI JAKARTA",201,120,82,202
https://kawalpemilu.org#25930,"KAPUK, CENGKARENG, JAKARTA BARAT, DKI JAKARTA",202,120,81,201
https://kawalpemilu.org#25930,"KAPUK, CENGKARENG, JAKARTA BARAT, DKI JAKARTA",203,130,67,197
https://kawalpemilu.org#25930,"KAPUK, CENGKARENG, JAKARTA BARAT, DKI JAKARTA",204,149,124,273
https://kawalpemilu.org#25930,"KAPUK, CENGKARENG, JAKARTA BARAT, DKI JAKARTA",205,150,90,240
https://kawalpemilu.org#25930,"KAPUK, CENGKARENG, JAKARTA BARAT, DKI JAKARTA",206,173,78,251
https://kawalpemilu.org#25930,"KAPUK, CENGKARENG, JAKARTA BARAT, DKI JAKARTA",207,164,76,240
https://kawalpemilu.org#25930,"KAPUK, CENGKARENG, JAKARTA BARAT, DKI JAKARTA",208,97,136,233
https://kawalpemilu.org#25930,"KAPUK, CENGKARENG, JAKARTA BARAT, DKI JAKARTA",209,114,123,237
https://kawalpemilu.org#25930,"KAPUK, CENGKARENG, JAKARTA BARAT, DKI JAKARTA",210,94,144,238
https://kawalpemilu.org#25930,"KAPUK, CENGKARENG, JAKARTA BARAT, DKI JAKARTA",211,93,123,216
https://kawalpemilu.org#25930,"KAPUK, CENGKARENG, JAKARTA BARAT, DKI JAKARTA",212,109,115,224
https://kawalpemilu.org#25930,"KAPUK, CENGKARENG, JAKARTA BARAT, DKI JAKARTA",213,125,92,217
https://kawalpemilu.org#25930,"KAPUK, CENGKARENG, JAKARTA BARAT, DKI JAKARTA",214,101,97,198
https://kawalpemilu.org#25930,"KAPUK, CENGKARENG, JAKARTA BARAT, DKI JAKARTA",215,126,83,209
https://kawalpemilu.org#25930,"KAPUK, CENGKARENG, JAKARTA BARAT, DKI JAKARTA",216,122,112,234
https://kawalpemilu.org#25930,"KAPUK, CENGKARENG, JAKARTA BARAT, DKI JAKARTA",217,148,85,233
https://kawalpemilu.org#25930,"KAPUK, CENGKARENG, JAKARTA BARAT, DKI JAKARTA",218,144,98,242
https://kawalpemilu.org#25930,"KAPUK, CENGKARENG, JAKARTA BARAT, DKI JAKARTA",219,145,128,273
https://kawalpemilu.org#25930,"KAPUK, CENGKARENG, JAKARTA BARAT, DKI JAKARTA",220,121,132,253
https://kawalpemilu.org#25930,"KAPUK, CENGKARENG, JAKARTA BARAT, DKI JAKARTA",221,141,120,261
https://kawalpemilu.org#25930,"KAPUK, CENGKARENG, JAKARTA BARAT, DKI JAKARTA",222,173,65,238
https://kawalpemilu.org#25930,"KAPUK, CENGKARENG, JAKARTA BARAT, DKI JAKARTA",223,131,87,218
https://kawalpemilu.org#25930,"KAPUK, CENGKARENG, JAKARTA BARAT, DKI JAKARTA",224,138,62,200
https://kawalpemilu.org#25930,"KAPUK, CENGKARENG, JAKARTA BARAT, DKI JAKARTA",225,133,72,205
https://kawalpemilu.org#25930,"KAPUK, CENGKARENG, JAKARTA BARAT, DKI JAKARTA",226,140,72,212
https://kawalpemilu.org#25930,"KAPUK, CENGKARENG, JAKARTA BARAT, DKI JAKARTA",227,165,83,248
https://kawalpemilu.org#25930,"KAPUK, CENGKARENG, JAKARTA BARAT, DKI JAKARTA",228,148,82,230
https://kawalpemilu.org#25930,"KAPUK, CENGKARENG, JAKARTA BARAT, DKI JAKARTA",229,111,84,195
https://kawalpemilu.org#25930,"KAPUK, CENGKARENG, JAKARTA BARAT, DKI JAKARTA",230,153,67,220
https://kawalpemilu.org#25930,"KAPUK, CENGKARENG, JAKARTA BARAT, DKI JAKARTA",231,177,60,237
https://kawalpemilu.org#25930,"KAPUK, CENGKARENG, JAKARTA BARAT, DKI JAKARTA",232,153,82,235
https://kawalpemilu.org#25930,"KAPUK, CENGKARENG, JAKARTA BARAT, DKI JAKARTA",233,181,61,242
https://kawalpemilu.org#25930,"KAPUK, CENGKARENG, JAKARTA BARAT, DKI JAKARTA",234,201,55,256
https://kawalpemilu.org#25930,"KAPUK, CENGKARENG, JAKARTA BARAT, DKI JAKARTA",235,194,65,259
https://kawalpemilu.org#25930,"KAPUK, CENGKARENG, JAKARTA BARAT, DKI JAKARTA",236,129,64,193
https://kawalpemilu.org#25930,"KAPUK, CENGKARENG, JAKARTA BARAT, DKI JAKARTA",237,136,75,211
https://kawalpemilu.org#25930,"KAPUK, CENGKARENG, JAKARTA BARAT, DKI JAKARTA",238,126,81,207
https://kawalpemilu.org#25930,"KAPUK, CENGKARENG, JAKARTA BARAT, DKI JAKARTA",239,128,118,246
https://kawalpemilu.org#25930,"KAPUK, CENGKARENG, JAKARTA BARAT, DKI JAKARTA",240,123,72,195
https://kawalpemilu.org#25930,"KAPUK, CENGKARENG, JAKARTA BARAT, DKI JAKARTA",241,114,95,209
https://kawalpemilu.org#25930,"KAPUK, CENGKARENG, JAKARTA BARAT, DKI JAKARTA",242,154,91,245
https://kawalpemilu.org#25930,"KAPUK, CENGKARENG, JAKARTA BARAT, DKI JAKARTA",243,156,88,244
https://kawalpemilu.org#25930,"KAPUK, CENGKARENG, JAKARTA BARAT, DKI JAKARTA",244,145,109,254
https://kawalpemilu.org#25930,"KAPUK, CENGKARENG, JAKARTA BARAT, DKI JAKARTA",245,130,85,215
https://kawalpemilu.org#25930,"KAPUK, CENGKARENG, JAKARTA BARAT, DKI JAKARTA",246,135,89,224
https://kawalpemilu.org#25930,"KAPUK, CENGKARENG, JAKARTA BARAT, DKI JAKARTA",247,125,92,217
https://kawalpemilu.org#25930,"KAPUK, CENGKARENG, JAKARTA BARAT, DKI JAKARTA",248,157,80,237
https://kawalpemilu.org#25930,"KAPUK, CENGKARENG, JAKARTA BARAT, DKI JAKARTA",249,162,78,240
https://kawalpemilu.org#25930,"KAPUK, CENGKARENG, JAKARTA BARAT, DKI JAKARTA",250,126,95,221
https://kawalpemilu.org#25930,"KAPUK, CENGKARENG, JAKARTA BARAT, DKI JAKARTA",251,130,80,210
https://kawalpemilu.org#25930,"KAPUK, CENGKARENG, JAKARTA BARAT, DKI JAKARTA",252,137,71,208
https://kawalpemilu.org#25930,"KAPUK, CENGKARENG, JAKARTA BARAT, DKI JAKARTA",253,128,83,211
https://kawalpemilu.org#25930,"KAPUK, CENGKARENG, JAKARTA BARAT, DKI JAKARTA",254,155,85,240
https://kawalpemilu.org#25930,"KAPUK, CENGKARENG, JAKARTA BARAT, DKI JAKARTA",255,152,77,229
https://kawalpemilu.org#25930,"KAPUK, CENGKARENG, JAKARTA BARAT, DKI JAKARTA",256,146,78,224
https://kawalpemilu.org#25930,"KAPUK, CENGKARENG, JAKARTA BARAT, DKI JAKARTA",257,153,66,219
https://kawalpemilu.org#25930,"KAPUK, CENGKARENG, JAKARTA BARAT, DKI JAKARTA",258,132,89,221
https://kawalpemilu.org#25930,"KAPUK, CENGKARENG, JAKARTA BARAT, DKI JAKARTA",259,131,81,212
https://kawalpemilu.org#25930,"KAPUK, CENGKARENG, JAKARTA BARAT, DKI JAKARTA",260,129,99,228
https://kawalpemilu.org#25930,"KAPUK, CENGKARENG, JAKARTA BARAT, DKI JAKARTA",261,132,101,233
https://kawalpemilu.org#25930,"KAPUK, CENGKARENG, JAKARTA BARAT, DKI JAKARTA",262,132,56,188
https://kawalpemilu.org#25930,"KAPUK, CENGKARENG, JAKARTA BARAT, DKI JAKARTA",263,166,79,245
https://kawalpemilu.org#25930,"KAPUK, CENGKARENG, JAKARTA BARAT, DKI JAKARTA",264,189,72,261
https://kawalpemilu.org#25930,"KAPUK, CENGKARENG, JAKARTA BARAT, DKI JAKARTA",265,124,59,183
https://kawalpemilu.org#25930,"KAPUK, CENGKARENG, JAKARTA BARAT, DKI JAKARTA",266,143,60,203
https://kawalpemilu.org#25930,"KAPUK, CENGKARENG, JAKARTA BARAT, DKI JAKARTA",267,129,61,190
https://kawalpemilu.org#25930,"KAPUK, CENGKARENG, JAKARTA BARAT, DKI JAKARTA",268,148,92,240
https://kawalpemilu.org#25930,"KAPUK, CENGKARENG, JAKARTA BARAT, DKI JAKARTA",269,140,75,215
https://kawalpemilu.org#25930,"KAPUK, CENGKARENG, JAKARTA BARAT, DKI JAKARTA",270,126,94,220
https://kawalpemilu.org#25930,"KAPUK, CENGKARENG, JAKARTA BARAT, DKI JAKARTA",271,146,85,231
https://kawalpemilu.org#25930,"KAPUK, CENGKARENG, JAKARTA BARAT, DKI JAKARTA",272,135,78,213
https://kawalpemilu.org#25930,"KAPUK, CENGKARENG, JAKARTA BARAT, DKI JAKARTA",273,129,94,223
https://kawalpemilu.org#25930,"KAPUK, CENGKARENG, JAKARTA BARAT, DKI JAKARTA",274,120,107,227
https://kawalpemilu.org#25930,"KAPUK, CENGKARENG, JAKARTA BARAT, DKI JAKARTA",275,130,126,256
https://kawalpemilu.org#25930,"KAPUK, CENGKARENG, JAKARTA BARAT, DKI JAKARTA",276,137,106,243
https://kawalpemilu.org#25930,"KAPUK, CENGKARENG, JAKARTA BARAT, DKI JAKARTA",277,147,90,237
https://kawalpemilu.org#25930,"KAPUK, CENGKARENG, JAKARTA BARAT, DKI JAKARTA",278,113,110,223
https://kawalpemilu.org#25930,"KAPUK, CENGKARENG, JAKARTA BARAT, DKI JAKARTA",279,140,77,217
https://kawalpemilu.org#25930,"KAPUK, CENGKARENG, JAKARTA BARAT, DKI JAKARTA",280,165,57,222
https://kawalpemilu.org#25930,"KAPUK, CENGKARENG, JAKARTA BARAT, DKI JAKARTA",281,140,76,216
https://kawalpemilu.org#25930,"KAPUK, CENGKARENG, JAKARTA BARAT, DKI JAKARTA",282,151,96,247
https://kawalpemilu.org#25930,"KAPUK, CENGKARENG, JAKARTA BARAT, DKI JAKARTA",283,132,104,236
https://kawalpemilu.org#25930,"KAPUK, CENGKARENG, JAKARTA BARAT, DKI JAKARTA",284,135,93,228
https://kawalpemilu.org#25930,"KAPUK, CENGKARENG, JAKARTA BARAT, DKI JAKARTA",285,88,165,253
https://kawalpemilu.org#25930,"KAPUK, CENGKARENG, JAKARTA BARAT, DKI JAKARTA",286,108,129,237
https://kawalpemilu.org#25930,"KAPUK, CENGKARENG, JAKARTA BARAT, DKI JAKARTA",287,110,126,236
https://kawalpemilu.org#25930,"KAPUK, CENGKARENG, JAKARTA BARAT, DKI JAKARTA",288,111,119,230
https://kawalpemilu.org#25930,"KAPUK, CENGKARENG, JAKARTA BARAT, DKI JAKARTA",289,146,87,233
https://kawalpemilu.org#25930,"KAPUK, CENGKARENG, JAKARTA BARAT, DKI JAKARTA",290,143,86,229
https://kawalpemilu.org#25930,"KAPUK, CENGKARENG, JAKARTA BARAT, DKI JAKARTA",291,146,65,211
https://kawalpemilu.org#25930,"KAPUK, CENGKARENG, JAKARTA BARAT, DKI JAKARTA",292,151,80,231
https://kawalpemilu.org#25930,"KAPUK, CENGKARENG, JAKARTA BARAT, DKI JAKARTA",293,142,90,232
https://kawalpemilu.org#25930,"KAPUK, CENGKARENG, JAKARTA BARAT, DKI JAKARTA",294,92,121,213
https://kawalpemilu.org#25930,"KAPUK, CENGKARENG, JAKARTA BARAT, DKI JAKARTA",295,118,107,225
https://kawalpemilu.org#25930,"KAPUK, CENGKARENG, JAKARTA BARAT, DKI JAKARTA",296,133,124,257
https://kawalpemilu.org#25930,"KAPUK, CENGKARENG, JAKARTA BARAT, DKI JAKARTA",297,138,96,234
https://kawalpemilu.org#25930,"KAPUK, CENGKARENG, JAKARTA BARAT, DKI JAKARTA",298,121,101,222
https://kawalpemilu.org#25930,"KAPUK, CENGKARENG, JAKARTA BARAT, DKI JAKARTA",299,152,107,259
https://kawalpemilu.org#25930,"KAPUK, CENGKARENG, JAKARTA BARAT, DKI JAKARTA",300,123,94,225
https://kawalpemilu.org#25930,"KAPUK, CENGKARENG, JAKARTA BARAT, DKI JAKARTA",301,101,100,201
https://kawalpemilu.org#25930,"KAPUK, CENGKARENG, JAKARTA BARAT, DKI JAKARTA",302,181,80,261
https://kawalpemilu.org#25930,"KAPUK, CENGKARENG, JAKARTA BARAT, DKI JAKARTA",303,115,126,241
https://kawalpemilu.org#25930,"KAPUK, CENGKARENG, JAKARTA BARAT, DKI JAKARTA",304,110,115,225
https://kawalpemilu.org#25930,"KAPUK, CENGKARENG, JAKARTA BARAT, DKI JAKARTA",305,130,103,233
https://kawalpemilu.org#25930,"KAPUK, CENGKARENG, JAKARTA BARAT, DKI JAKARTA",307,137,93,230
https://kawalpemilu.org#25930,"KAPUK, CENGKARENG, JAKARTA BARAT, DKI JAKARTA",308,147,108,255
https://kawalpemilu.org#25930,"KAPUK, CENGKARENG, JAKARTA BARAT, DKI JAKARTA",309,140,90,230
https://kawalpemilu.org#25930,"KAPUK, CENGKARENG, JAKARTA BARAT, DKI JAKARTA",310,153,87,240
https://kawalpemilu.org#25930,"KAPUK, CENGKARENG, JAKARTA BARAT, DKI JAKARTA",311,128,53,181
https://kawalpemilu.org#25930,"KAPUK, CENGKARENG, JAKARTA BARAT, DKI JAKARTA",312,111,88,199
https://kawalpemilu.org#25930,"KAPUK, CENGKARENG, JAKARTA BARAT, DKI JAKARTA",313,105,90,195
https://kawalpemilu.org#25930,"KAPUK, CENGKARENG, JAKARTA BARAT, DKI JAKARTA",314,128,73,201
https://kawalpemilu.org#25930,"KAPUK, CENGKARENG, JAKARTA BARAT, DKI JAKARTA",315,165,26,191
https://kawalpemilu.org#25930,"KAPUK, CENGKARENG, JAKARTA BARAT, DKI JAKARTA",316,207,24,231
https://kawalpemilu.org#25930,"KAPUK, CENGKARENG, JAKARTA BARAT, DKI JAKARTA",317,147,55,202
https://kawalpemilu.org#25930,"KAPUK, CENGKARENG, JAKARTA BARAT, DKI JAKARTA",318,179,29,208
https://kawalpemilu.org#25930,"KAPUK, CENGKARENG, JAKARTA BARAT, DKI JAKARTA",319,207,9,216
https://kawalpemilu.org#25930,"KAPUK, CENGKARENG, JAKARTA BARAT, DKI JAKARTA",320,223,14,237
https://kawalpemilu.org#25930,"KAPUK, CENGKARENG, JAKARTA BARAT, DKI JAKARTA",321,208,13,221
https://kawalpemilu.org#25930,"KAPUK, CENGKARENG, JAKARTA BARAT, DKI JAKARTA",322,203,17,0
https://kawalpemilu.org#25930,"KAPUK, CENGKARENG, JAKARTA BARAT, DKI JAKARTA",323,172,23,195
https://kawalpemilu.org#25930,"KAPUK, CENGKARENG, JAKARTA BARAT, DKI JAKARTA",324,181,8,189
https://kawalpemilu.org#25930,"KAPUK, CENGKARENG, JAKARTA BARAT, DKI JAKARTA",325,183,63,246
https://kawalpemilu.org#25930,"KAPUK, CENGKARENG, JAKARTA BARAT, DKI JAKARTA",326,142,115,257
https://kawalpemilu.org#25930,"KAPUK, CENGKARENG, JAKARTA BARAT, DKI JAKARTA",327,95,121,216
https://kawalpemilu.org#25930,"KAPUK, CENGKARENG, JAKARTA BARAT, DKI JAKARTA",328,159,66,225
https://kawalpemilu.org#25930,"KAPUK, CENGKARENG, JAKARTA BARAT, DKI JAKARTA",329,171,73,244
https://kawalpemilu.org#25930,"KAPUK, CENGKARENG, JAKARTA BARAT, DKI JAKARTA",330,155,74,229
https://kawalpemilu.org#25930,"KAPUK, CENGKARENG, JAKARTA BARAT, DKI JAKARTA",331,173,39,212
https://kawalpemilu.org#25930,"KAPUK, CENGKARENG, JAKARTA BARAT, DKI JAKARTA",332,190,17,207
https://kawalpemilu.org#25930,"KAPUK, CENGKARENG, JAKARTA BARAT, DKI JAKARTA",333,153,12,165
https://kawalpemilu.org#25930,"KAPUK, CENGKARENG, JAKARTA BARAT, DKI JAKARTA",334,154,7,161
https://kawalpemilu.org#25930,"KAPUK, CENGKARENG, JAKARTA BARAT, DKI JAKARTA",335,208,53,261
https://kawalpemilu.org#25930,"KAPUK, CENGKARENG, JAKARTA BARAT, DKI JAKARTA",336,176,52,228
https://kawalpemilu.org#25930,"KAPUK, CENGKARENG, JAKARTA BARAT, DKI JAKARTA",337,186,81,267
https://kawalpemilu.org#25930,"KAPUK, CENGKARENG, JAKARTA BARAT, DKI JAKARTA",338,174,106,280
https://kawalpemilu.org#25930,"KAPUK, CENGKARENG, JAKARTA BARAT, DKI JAKARTA",339,165,68,233
https://kawalpemilu.org#25930,"KAPUK, CENGKARENG, JAKARTA BARAT, DKI JAKARTA",340,170,76,246
https://kawalpemilu.org#25930,"KAPUK, CENGKARENG, JAKARTA BARAT, DKI JAKARTA",341,168,78,246
https://kawalpemilu.org#25930,"KAPUK, CENGKARENG, JAKARTA BARAT, DKI JAKARTA",343,158,28,186
https://kawalpemilu.org#25930,"KAPUK, CENGKARENG, JAKARTA BARAT, DKI JAKARTA",344,208,26,234
https://kawalpemilu.org#25930,"KAPUK, CENGKARENG, JAKARTA BARAT, DKI JAKARTA",345,155,78,233
https://kawalpemilu.org#25930,"KAPUK, CENGKARENG, JAKARTA BARAT, DKI JAKARTA",346,170,76,246
https://kawalpemilu.org#25930,"KAPUK, CENGKARENG, JAKARTA BARAT, DKI JAKARTA",347,171,67,238
https://kawalpemilu.org#25930,"KAPUK, CENGKARENG, JAKARTA BARAT, DKI JAKARTA",348,144,74,218
https://kawalpemilu.org#25930,"KAPUK, CENGKARENG, JAKARTA BARAT, DKI JAKARTA",349,129,103,232
https://kawalpemilu.org#25930,"KAPUK, CENGKARENG, JAKARTA BARAT, DKI JAKARTA",350,143,87,230
https://kawalpemilu.org#25930,"KAPUK, CENGKARENG, JAKARTA BARAT, DKI JAKARTA",351,126,94,220
https://kawalpemilu.org#25930,"KAPUK, CENGKARENG, JAKARTA BARAT, DKI JAKARTA",352,149,83,232
https://kawalpemilu.org#25930,"KAPUK, CENGKARENG, JAKARTA BARAT, DKI JAKARTA",353,127,89,216
https://kawalpemilu.org#25930,"KAPUK, CENGKARENG, JAKARTA BARAT, DKI JAKARTA",354,136,68,204
https://kawalpemilu.org#25930,"KAPUK, CENGKARENG, JAKARTA BARAT, DKI JAKARTA",355,141,97,238
https://kawalpemilu.org#25930,"KAPUK, CENGKARENG, JAKARTA BARAT, DKI JAKARTA",356,123,104,227
https://kawalpemilu.org#25930,"KAPUK, CENGKARENG, JAKARTA BARAT, DKI JAKARTA",357,149,101,250
https://kawalpemilu.org#25930,"KAPUK, CENGKARENG, JAKARTA BARAT, DKI JAKARTA",358,146,97,243
https://kawalpemilu.org#25930,"KAPUK, CENGKARENG, JAKARTA BARAT, DKI JAKARTA",359,162,85,247
https://kawalpemilu.org#25930,"KAPUK, CENGKARENG, JAKARTA BARAT, DKI JAKARTA",360,140,104,244
https://kawalpemilu.org#25930,"KAPUK, CENGKARENG, JAKARTA BARAT, DKI JAKARTA",362,140,90,233
https://kawalpemilu.org#25930,"KAPUK, CENGKARENG, JAKARTA BARAT, DKI JAKARTA",363,152,93,245
https://kawalpemilu.org#25930,"KAPUK, CENGKARENG, JAKARTA BARAT, DKI JAKARTA",364,146,102,248
https://kawalpemilu.org#25930,"KAPUK, CENGKARENG, JAKARTA BARAT, DKI JAKARTA",365,140,88,228
https://kawalpemilu.org#25930,"KAPUK, CENGKARENG, JAKARTA BARAT, DKI JAKARTA",366,161,78,239
https://kawalpemilu.org#25930,"KAPUK, CENGKARENG, JAKARTA BARAT, DKI JAKARTA",367,136,83,219
https://kawalpemilu.org#25930,"KAPUK, CENGKARENG, JAKARTA BARAT, DKI JAKARTA",368,147,99,246
https://kawalpemilu.org#25930,"KAPUK, CENGKARENG, JAKARTA BARAT, DKI JAKARTA",369,159,103,262
https://kawalpemilu.org#25930,"KAPUK, CENGKARENG, JAKARTA BARAT, DKI JAKARTA",371,159,89,248
https://kawalpemilu.org#25930,"KAPUK, CENGKARENG, JAKARTA BARAT, DKI JAKARTA",372,182,76,258
https://kawalpemilu.org#25930,"KAPUK, CENGKARENG, JAKARTA BARAT, DKI JAKARTA",373,149,91,240
https://kawalpemilu.org#25930,"KAPUK, CENGKARENG, JAKARTA BARAT, DKI JAKARTA",374,108,111,219
https://kawalpemilu.org#25930,"KAPUK, CENGKARENG, JAKARTA BARAT, DKI JAKARTA",375,141,81,222
https://kawalpemilu.org#25930,"KAPUK, CENGKARENG, JAKARTA BARAT, DKI JAKARTA",376,109,63,172
https://kawalpemilu.org#25930,"KAPUK, CENGKARENG, JAKARTA BARAT, DKI JAKARTA",377,97,102,199
https://kawalpemilu.org#25930,"KAPUK, CENGKARENG, JAKARTA BARAT, DKI JAKARTA",378,138,110,248
https://kawalpemilu.org#25930,"KAPUK, CENGKARENG, JAKARTA BARAT, DKI JAKARTA",379,119,120,239
https://kawalpemilu.org#25930,"KAPUK, CENGKARENG, JAKARTA BARAT, DKI JAKARTA",380,155,92,247
https://kawalpemilu.org#25930,"KAPUK, CENGKARENG, JAKARTA BARAT, DKI JAKARTA",381,152,89,241
https://kawalpemilu.org#25930,"KAPUK, CENGKARENG, JAKARTA BARAT, DKI JAKARTA",382,158,91,249
https://kawalpemilu.org#25930,"KAPUK, CENGKARENG, JAKARTA BARAT, DKI JAKARTA",383,144,96,240
https://kawalpemilu.org#25930,"KAPUK, CENGKARENG, JAKARTA BARAT, DKI JAKARTA",384,153,81,234
https://kawalpemilu.org#25930,"KAPUK, CENGKARENG, JAKARTA BARAT, DKI JAKARTA",385,172,99,271
https://kawalpemilu.org#25930,"KAPUK, CENGKARENG, JAKARTA BARAT, DKI JAKARTA",386,158,77,235
https://kawalpemilu.org#25930,"KAPUK, CENGKARENG, JAKARTA BARAT, DKI JAKARTA",387,187,78,265
https://kawalpemilu.org#25930,"KAPUK, CENGKARENG, JAKARTA BARAT, DKI JAKARTA",388,173,62,235
https://kawalpemilu.org#25930,"KAPUK, CENGKARENG, JAKARTA BARAT, DKI JAKARTA",389,173,64,237
https://kawalpemilu.org#25930,"KAPUK, CENGKARENG, JAKARTA BARAT, DKI JAKARTA",390,168,71,239
https://kawalpemilu.org#25930,"KAPUK, CENGKARENG, JAKARTA BARAT, DKI JAKARTA",391,157,96,253
https://kawalpemilu.org#25930,"KAPUK, CENGKARENG, JAKARTA BARAT, DKI JAKARTA",392,143,87,230
https://kawalpemilu.org#25930,"KAPUK, CENGKARENG, JAKARTA BARAT, DKI JAKARTA",393,103,126,229
https://kawalpemilu.org#25930,"KAPUK, CENGKARENG, JAKARTA BARAT, DKI JAKARTA",394,120,139,259
https://kawalpemilu.org#25930,"KAPUK, CENGKARENG, JAKARTA BARAT, DKI JAKARTA",395,125,82,207
https://kawalpemilu.org#25930,"KAPUK, CENGKARENG, JAKARTA BARAT, DKI JAKARTA",396,163,67,230
https://kawalpemilu.org#25930,"KAPUK, CENGKARENG, JAKARTA BARAT, DKI JAKARTA",397,153,75,228
https://kawalpemilu.org#25930,"KAPUK, CENGKARENG, JAKARTA BARAT, DKI JAKARTA",398,148,71,219
https://kawalpemilu.org#25930,"KAPUK, CENGKARENG, JAKARTA BARAT, DKI JAKARTA",399,165,96,261
https://kawalpemilu.org#25930,"KAPUK, CENGKARENG, JAKARTA BARAT, DKI JAKARTA",400,176,74,250
https://kawalpemilu.org#25931,"CENGKARENG TIMUR, CENGKARENG, JAKARTA BARAT, DKI JAKARTA",1,130,138,268
https://kawalpemilu.org#25931,"CENGKARENG TIMUR, CENGKARENG, JAKARTA BARAT, DKI JAKARTA",2,91,89,180
https://kawalpemilu.org#25931,"CENGKARENG TIMUR, CENGKARENG, JAKARTA BARAT, DKI JAKARTA",3,107,126,233
https://kawalpemilu.org#25931,"CENGKARENG TIMUR, CENGKARENG, JAKARTA BARAT, DKI JAKARTA",4,104,143,247
https://kawalpemilu.org#25931,"CENGKARENG TIMUR, CENGKARENG, JAKARTA BARAT, DKI JAKARTA",5,96,145,241
https://kawalpemilu.org#25931,"CENGKARENG TIMUR, CENGKARENG, JAKARTA BARAT, DKI JAKARTA",6,113,130,243
https://kawalpemilu.org#25931,"CENGKARENG TIMUR, CENGKARENG, JAKARTA BARAT, DKI JAKARTA",7,113,103,216
https://kawalpemilu.org#25931,"CENGKARENG TIMUR, CENGKARENG, JAKARTA BARAT, DKI JAKARTA",8,106,115,221
https://kawalpemilu.org#25931,"CENGKARENG TIMUR, CENGKARENG, JAKARTA BARAT, DKI JAKARTA",9,25,170,245
https://kawalpemilu.org#25931,"CENGKARENG TIMUR, CENGKARENG, JAKARTA BARAT, DKI JAKARTA",10,178,31,209
https://kawalpemilu.org#25931,"CENGKARENG TIMUR, CENGKARENG, JAKARTA BARAT, DKI JAKARTA",11,98,134,232
https://kawalpemilu.org#25931,"CENGKARENG TIMUR, CENGKARENG, JAKARTA BARAT, DKI JAKARTA",12,91,93,184
https://kawalpemilu.org#25931,"CENGKARENG TIMUR, CENGKARENG, JAKARTA BARAT, DKI JAKARTA",13,107,91,198
https://kawalpemilu.org#25931,"CENGKARENG TIMUR, CENGKARENG, JAKARTA BARAT, DKI JAKARTA",14,111,94,205
https://kawalpemilu.org#25931,"CENGKARENG TIMUR, CENGKARENG, JAKARTA BARAT, DKI JAKARTA",15,112,120,232
https://kawalpemilu.org#25931,"CENGKARENG TIMUR, CENGKARENG, JAKARTA BARAT, DKI JAKARTA",16,123,94,217
https://kawalpemilu.org#25931,"CENGKARENG TIMUR, CENGKARENG, JAKARTA BARAT, DKI JAKARTA",17,140,80,220
https://kawalpemilu.org#25931,"CENGKARENG TIMUR, CENGKARENG, JAKARTA BARAT, DKI JAKARTA",18,157,82,239
https://kawalpemilu.org#25931,"CENGKARENG TIMUR, CENGKARENG, JAKARTA BARAT, DKI JAKARTA",19,117,86,203
https://kawalpemilu.org#25931,"CENGKARENG TIMUR, CENGKARENG, JAKARTA BARAT, DKI JAKARTA",20,169,28,197
https://kawalpemilu.org#25931,"CENGKARENG TIMUR, CENGKARENG, JAKARTA BARAT, DKI JAKARTA",21,136,110,246
https://kawalpemilu.org#25931,"CENGKARENG TIMUR, CENGKARENG, JAKARTA BARAT, DKI JAKARTA",22,136,93,229
https://kawalpemilu.org#25931,"CENGKARENG TIMUR, CENGKARENG, JAKARTA BARAT, DKI JAKARTA",23,132,94,226
https://kawalpemilu.org#25931,"CENGKARENG TIMUR, CENGKARENG, JAKARTA BARAT, DKI JAKARTA",24,164,92,256
https://kawalpemilu.org#25931,"CENGKARENG TIMUR, CENGKARENG, JAKARTA BARAT, DKI JAKARTA",25,135,103,238
https://kawalpemilu.org#25931,"CENGKARENG TIMUR, CENGKARENG, JAKARTA BARAT, DKI JAKARTA",26,164,87,251
https://kawalpemilu.org#25931,"CENGKARENG TIMUR, CENGKARENG, JAKARTA BARAT, DKI JAKARTA",27,159,93,252
https://kawalpemilu.org#25931,"CENGKARENG TIMUR, CENGKARENG, JAKARTA BARAT, DKI JAKARTA",28,118,114,232
https://kawalpemilu.org#25931,"CENGKARENG TIMUR, CENGKARENG, JAKARTA BARAT, DKI JAKARTA",29,136,66,202
https://kawalpemilu.org#25931,"CENGKARENG TIMUR, CENGKARENG, JAKARTA BARAT, DKI JAKARTA",30,128,93,221
https://kawalpemilu.org#25931,"CENGKARENG TIMUR, CENGKARENG, JAKARTA BARAT, DKI JAKARTA",31,118,122,240
https://kawalpemilu.org#25931,"CENGKARENG TIMUR, CENGKARENG, JAKARTA BARAT, DKI JAKARTA",32,137,78,215
https://kawalpemilu.org#25931,"CENGKARENG TIMUR, CENGKARENG, JAKARTA BARAT, DKI JAKARTA",33,162,67,229
https://kawalpemilu.org#25931,"CENGKARENG TIMUR, CENGKARENG, JAKARTA BARAT, DKI JAKARTA",34,151,88,239
https://kawalpemilu.org#25931,"CENGKARENG TIMUR, CENGKARENG, JAKARTA BARAT, DKI JAKARTA",35,115,108,223
https://kawalpemilu.org#25931,"CENGKARENG TIMUR, CENGKARENG, JAKARTA BARAT, DKI JAKARTA",36,131,114,245
https://kawalpemilu.org#25931,"CENGKARENG TIMUR, CENGKARENG, JAKARTA BARAT, DKI JAKARTA",37,134,116,250
https://kawalpemilu.org#25931,"CENGKARENG TIMUR, CENGKARENG, JAKARTA BARAT, DKI JAKARTA",38,147,92,239
https://kawalpemilu.org#25931,"CENGKARENG TIMUR, CENGKARENG, JAKARTA BARAT, DKI JAKARTA",39,172,94,266
https://kawalpemilu.org#25931,"CENGKARENG TIMUR, CENGKARENG, JAKARTA BARAT, DKI JAKARTA",40,147,95,242
https://kawalpemilu.org#25931,"CENGKARENG TIMUR, CENGKARENG, JAKARTA BARAT, DKI JAKARTA",41,131,122,253
https://kawalpemilu.org#25931,"CENGKARENG TIMUR, CENGKARENG, JAKARTA BARAT, DKI JAKARTA",42,119,122,241
https://kawalpemilu.org#25931,"CENGKARENG TIMUR, CENGKARENG, JAKARTA BARAT, DKI JAKARTA",43,140,102,242
https://kawalpemilu.org#25931,"CENGKARENG TIMUR, CENGKARENG, JAKARTA BARAT, DKI JAKARTA",44,125,122,247
https://kawalpemilu.org#25931,"CENGKARENG TIMUR, CENGKARENG, JAKARTA BARAT, DKI JAKARTA",45,153,109,262
https://kawalpemilu.org#25931,"CENGKARENG TIMUR, CENGKARENG, JAKARTA BARAT, DKI JAKARTA",46,178,82,260
https://kawalpemilu.org#25931,"CENGKARENG TIMUR, CENGKARENG, JAKARTA BARAT, DKI JAKARTA",47,170,69,239
https://kawalpemilu.org#25931,"CENGKARENG TIMUR, CENGKARENG, JAKARTA BARAT, DKI JAKARTA",48,167,69,236
https://kawalpemilu.org#25931,"CENGKARENG TIMUR, CENGKARENG, JAKARTA BARAT, DKI JAKARTA",49,143,101,244
https://kawalpemilu.org#25931,"CENGKARENG TIMUR, CENGKARENG, JAKARTA BARAT, DKI JAKARTA",50,170,88,258
https://kawalpemilu.org#25931,"CENGKARENG TIMUR, CENGKARENG, JAKARTA BARAT, DKI JAKARTA",51,134,84,218
https://kawalpemilu.org#25931,"CENGKARENG TIMUR, CENGKARENG, JAKARTA BARAT, DKI JAKARTA",52,154,89,243
https://kawalpemilu.org#25931,"CENGKARENG TIMUR, CENGKARENG, JAKARTA BARAT, DKI JAKARTA",53,141,110,251
https://kawalpemilu.org#25931,"CENGKARENG TIMUR, CENGKARENG, JAKARTA BARAT, DKI JAKARTA",54,133,119,252
https://kawalpemilu.org#25931,"CENGKARENG TIMUR, CENGKARENG, JAKARTA BARAT, DKI JAKARTA",55,156,110,266
https://kawalpemilu.org#25931,"CENGKARENG TIMUR, CENGKARENG, JAKARTA BARAT, DKI JAKARTA",56,150,103,253
https://kawalpemilu.org#25931,"CENGKARENG TIMUR, CENGKARENG, JAKARTA BARAT, DKI JAKARTA",57,144,92,236
https://kawalpemilu.org#25931,"CENGKARENG TIMUR, CENGKARENG, JAKARTA BARAT, DKI JAKARTA",58,124,117,241
https://kawalpemilu.org#25931,"CENGKARENG TIMUR, CENGKARENG, JAKARTA BARAT, DKI JAKARTA",59,116,67,183
https://kawalpemilu.org#25931,"CENGKARENG TIMUR, CENGKARENG, JAKARTA BARAT, DKI JAKARTA",60,123,112,235
https://kawalpemilu.org#25931,"CENGKARENG TIMUR, CENGKARENG, JAKARTA BARAT, DKI JAKARTA",61,131,109,240
https://kawalpemilu.org#25931,"CENGKARENG TIMUR, CENGKARENG, JAKARTA BARAT, DKI JAKARTA",62,149,107,256
https://kawalpemilu.org#25931,"CENGKARENG TIMUR, CENGKARENG, JAKARTA BARAT, DKI JAKARTA",63,133,117,250
https://kawalpemilu.org#25931,"CENGKARENG TIMUR, CENGKARENG, JAKARTA BARAT, DKI JAKARTA",64,137,108,245
https://kawalpemilu.org#25931,"CENGKARENG TIMUR, CENGKARENG, JAKARTA BARAT, DKI JAKARTA",65,137,100,237
https://kawalpemilu.org#25931,"CENGKARENG TIMUR, CENGKARENG, JAKARTA BARAT, DKI JAKARTA",66,123,99,222
https://kawalpemilu.org#25931,"CENGKARENG TIMUR, CENGKARENG, JAKARTA BARAT, DKI JAKARTA",67,146,110,256
https://kawalpemilu.org#25931,"CENGKARENG TIMUR, CENGKARENG, JAKARTA BARAT, DKI JAKARTA",68,134,116,250
https://kawalpemilu.org#25931,"CENGKARENG TIMUR, CENGKARENG, JAKARTA BARAT, DKI JAKARTA",69,151,86,237
https://kawalpemilu.org#25931,"CENGKARENG TIMUR, CENGKARENG, JAKARTA BARAT, DKI JAKARTA",70,121,74,195
https://kawalpemilu.org#25931,"CENGKARENG TIMUR, CENGKARENG, JAKARTA BARAT, DKI JAKARTA",71,131,67,198
https://kawalpemilu.org#25931,"CENGKARENG TIMUR, CENGKARENG, JAKARTA BARAT, DKI JAKARTA",72,136,81,217
https://kawalpemilu.org#25931,"CENGKARENG TIMUR, CENGKARENG, JAKARTA BARAT, DKI JAKARTA",73,135,53,188
https://kawalpemilu.org#25931,"CENGKARENG TIMUR, CENGKARENG, JAKARTA BARAT, DKI JAKARTA",74,158,131,289
https://kawalpemilu.org#25931,"CENGKARENG TIMUR, CENGKARENG, JAKARTA BARAT, DKI JAKARTA",75,135,128,263
https://kawalpemilu.org#25931,"CENGKARENG TIMUR, CENGKARENG, JAKARTA BARAT, DKI JAKARTA",76,112,128,240
https://kawalpemilu.org#25931,"CENGKARENG TIMUR, CENGKARENG, JAKARTA BARAT, DKI JAKARTA",77,126,100,226
https://kawalpemilu.org#25931,"CENGKARENG TIMUR, CENGKARENG, JAKARTA BARAT, DKI JAKARTA",78,155,61,216
https://kawalpemilu.org#25931,"CENGKARENG TIMUR, CENGKARENG, JAKARTA BARAT, DKI JAKARTA",79,106,111,217
https://kawalpemilu.org#25931,"CENGKARENG TIMUR, CENGKARENG, JAKARTA BARAT, DKI JAKARTA",80,113,110,223
https://kawalpemilu.org#25931,"CENGKARENG TIMUR, CENGKARENG, JAKARTA BARAT, DKI JAKARTA",81,98,149,247
https://kawalpemilu.org#25931,"CENGKARENG TIMUR, CENGKARENG, JAKARTA BARAT, DKI JAKARTA",82,151,92,243
https://kawalpemilu.org#25931,"CENGKARENG TIMUR, CENGKARENG, JAKARTA BARAT, DKI JAKARTA",83,147,81,228
https://kawalpemilu.org#25931,"CENGKARENG TIMUR, CENGKARENG, JAKARTA BARAT, DKI JAKARTA",84,155,73,228
https://kawalpemilu.org#25931,"CENGKARENG TIMUR, CENGKARENG, JAKARTA BARAT, DKI JAKARTA",85,158,91,249
https://kawalpemilu.org#25931,"CENGKARENG TIMUR, CENGKARENG, JAKARTA BARAT, DKI JAKARTA",86,146,74,220
https://kawalpemilu.org#25931,"CENGKARENG TIMUR, CENGKARENG, JAKARTA BARAT, DKI JAKARTA",87,167,89,256
https://kawalpemilu.org#25931,"CENGKARENG TIMUR, CENGKARENG, JAKARTA BARAT, DKI JAKARTA",88,113,98,211
https://kawalpemilu.org#25931,"CENGKARENG TIMUR, CENGKARENG, JAKARTA BARAT, DKI JAKARTA",89,147,70,217
https://kawalpemilu.org#25931,"CENGKARENG TIMUR, CENGKARENG, JAKARTA BARAT, DKI JAKARTA",90,140,104,244
https://kawalpemilu.org#25931,"CENGKARENG TIMUR, CENGKARENG, JAKARTA BARAT, DKI JAKARTA",91,133,114,247
https://kawalpemilu.org#25931,"CENGKARENG TIMUR, CENGKARENG, JAKARTA BARAT, DKI JAKARTA",92,122,87,209
https://kawalpemilu.org#25931,"CENGKARENG TIMUR, CENGKARENG, JAKARTA BARAT, DKI JAKARTA",93,109,73,182
https://kawalpemilu.org#25931,"CENGKARENG TIMUR, CENGKARENG, JAKARTA BARAT, DKI JAKARTA",94,112,86,198
https://kawalpemilu.org#25931,"CENGKARENG TIMUR, CENGKARENG, JAKARTA BARAT, DKI JAKARTA",95,114,85,199
https://kawalpemilu.org#25931,"CENGKARENG TIMUR, CENGKARENG, JAKARTA BARAT, DKI JAKARTA",96,175,91,266
https://kawalpemilu.org#25931,"CENGKARENG TIMUR, CENGKARENG, JAKARTA BARAT, DKI JAKARTA",97,174,115,289
https://kawalpemilu.org#25931,"CENGKARENG TIMUR, CENGKARENG, JAKARTA BARAT, DKI JAKARTA",98,79,68,147
https://kawalpemilu.org#25931,"CENGKARENG TIMUR, CENGKARENG, JAKARTA BARAT, DKI JAKARTA",99,136,89,225
https://kawalpemilu.org#25931,"CENGKARENG TIMUR, CENGKARENG, JAKARTA BARAT, DKI JAKARTA",100,165,106,271
https://kawalpemilu.org#25931,"CENGKARENG TIMUR, CENGKARENG, JAKARTA BARAT, DKI JAKARTA",101,173,81,254
https://kawalpemilu.org#25931,"CENGKARENG TIMUR, CENGKARENG, JAKARTA BARAT, DKI JAKARTA",102,136,114,250
https://kawalpemilu.org#25931,"CENGKARENG TIMUR, CENGKARENG, JAKARTA BARAT, DKI JAKARTA",103,136,113,249
https://kawalpemilu.org#25931,"CENGKARENG TIMUR, CENGKARENG, JAKARTA BARAT, DKI JAKARTA",104,181,82,263
https://kawalpemilu.org#25931,"CENGKARENG TIMUR, CENGKARENG, JAKARTA BARAT, DKI JAKARTA",105,118,118,236
https://kawalpemilu.org#25931,"CENGKARENG TIMUR, CENGKARENG, JAKARTA BARAT, DKI JAKARTA",106,156,99,255
https://kawalpemilu.org#25931,"CENGKARENG TIMUR, CENGKARENG, JAKARTA BARAT, DKI JAKARTA",107,145,98,243
https://kawalpemilu.org#25931,"CENGKARENG TIMUR, CENGKARENG, JAKARTA BARAT, DKI JAKARTA",108,134,111,245
https://kawalpemilu.org#25931,"CENGKARENG TIMUR, CENGKARENG, JAKARTA BARAT, DKI JAKARTA",109,125,93,218
https://kawalpemilu.org#25931,"CENGKARENG TIMUR, CENGKARENG, JAKARTA BARAT, DKI JAKARTA",110,175,77,252
https://kawalpemilu.org#25931,"CENGKARENG TIMUR, CENGKARENG, JAKARTA BARAT, DKI JAKARTA",111,122,115,237
https://kawalpemilu.org#25931,"CENGKARENG TIMUR, CENGKARENG, JAKARTA BARAT, DKI JAKARTA",112,87,55,142
https://kawalpemilu.org#25931,"CENGKARENG TIMUR, CENGKARENG, JAKARTA BARAT, DKI JAKARTA",113,129,91,220
https://kawalpemilu.org#25931,"CENGKARENG TIMUR, CENGKARENG, JAKARTA BARAT, DKI JAKARTA",114,137,112,249
https://kawalpemilu.org#25931,"CENGKARENG TIMUR, CENGKARENG, JAKARTA BARAT, DKI JAKARTA",115,126,120,246
https://kawalpemilu.org#25931,"CENGKARENG TIMUR, CENGKARENG, JAKARTA BARAT, DKI JAKARTA",116,101,105,206
https://kawalpemilu.org#25931,"CENGKARENG TIMUR, CENGKARENG, JAKARTA BARAT, DKI JAKARTA",117,89,124,213
https://kawalpemilu.org#25931,"CENGKARENG TIMUR, CENGKARENG, JAKARTA BARAT, DKI JAKARTA",118,91,67,158
https://kawalpemilu.org#25931,"CENGKARENG TIMUR, CENGKARENG, JAKARTA BARAT, DKI JAKARTA",119,108,93,201
https://kawalpemilu.org#25931,"CENGKARENG TIMUR, CENGKARENG, JAKARTA BARAT, DKI JAKARTA",120,92,111,203
https://kawalpemilu.org#25931,"CENGKARENG TIMUR, CENGKARENG, JAKARTA BARAT, DKI JAKARTA",121,123,159,282
https://kawalpemilu.org#25931,"CENGKARENG TIMUR, CENGKARENG, JAKARTA BARAT, DKI JAKARTA",122,112,140,252
https://kawalpemilu.org#25931,"CENGKARENG TIMUR, CENGKARENG, JAKARTA BARAT, DKI JAKARTA",123,120,118,238
https://kawalpemilu.org#25931,"CENGKARENG TIMUR, CENGKARENG, JAKARTA BARAT, DKI JAKARTA",124,103,126,229
https://kawalpemilu.org#25931,"CENGKARENG TIMUR, CENGKARENG, JAKARTA BARAT, DKI JAKARTA",125,150,113,263
https://kawalpemilu.org#25931,"CENGKARENG TIMUR, CENGKARENG, JAKARTA BARAT, DKI JAKARTA",126,133,97,230
https://kawalpemilu.org#25931,"CENGKARENG TIMUR, CENGKARENG, JAKARTA BARAT, DKI JAKARTA",127,129,111,240
https://kawalpemilu.org#25931,"CENGKARENG TIMUR, CENGKARENG, JAKARTA BARAT, DKI JAKARTA",128,108,108,216
https://kawalpemilu.org#25931,"CENGKARENG TIMUR, CENGKARENG, JAKARTA BARAT, DKI JAKARTA",129,84,171,255
https://kawalpemilu.org#25931,"CENGKARENG TIMUR, CENGKARENG, JAKARTA BARAT, DKI JAKARTA",130,108,120,228
https://kawalpemilu.org#25931,"CENGKARENG TIMUR, CENGKARENG, JAKARTA BARAT, DKI JAKARTA",131,125,123,248
https://kawalpemilu.org#25931,"CENGKARENG TIMUR, CENGKARENG, JAKARTA BARAT, DKI JAKARTA",132,136,107,243
https://kawalpemilu.org#25931,"CENGKARENG TIMUR, CENGKARENG, JAKARTA BARAT, DKI JAKARTA",133,91,126,217
https://kawalpemilu.org#25931,"CENGKARENG TIMUR, CENGKARENG, JAKARTA BARAT, DKI JAKARTA",134,82,120,202
https://kawalpemilu.org#25931,"CENGKARENG TIMUR, CENGKARENG, JAKARTA BARAT, DKI JAKARTA",135,79,120,199
https://kawalpemilu.org#25931,"CENGKARENG TIMUR, CENGKARENG, JAKARTA BARAT, DKI JAKARTA",136,106,118,224
https://kawalpemilu.org#25931,"CENGKARENG TIMUR, CENGKARENG, JAKARTA BARAT, DKI JAKARTA",137,91,108,199
https://kawalpemilu.org#25931,"CENGKARENG TIMUR, CENGKARENG, JAKARTA BARAT, DKI JAKARTA",138,105,136,241
https://kawalpemilu.org#25931,"CENGKARENG TIMUR, CENGKARENG, JAKARTA BARAT, DKI JAKARTA",139,107,121,228
https://kawalpemilu.org#25931,"CENGKARENG TIMUR, CENGKARENG, JAKARTA BARAT, DKI JAKARTA",140,96,113,209
https://kawalpemilu.org#25931,"CENGKARENG TIMUR, CENGKARENG, JAKARTA BARAT, DKI JAKARTA",141,202,13,215
https://kawalpemilu.org#25931,"CENGKARENG TIMUR, CENGKARENG, JAKARTA BARAT, DKI JAKARTA",142,98,82,180
https://kawalpemilu.org#25931,"CENGKARENG TIMUR, CENGKARENG, JAKARTA BARAT, DKI JAKARTA",143,156,75,231
https://kawalpemilu.org#25931,"CENGKARENG TIMUR, CENGKARENG, JAKARTA BARAT, DKI JAKARTA",144,191,52,243
https://kawalpemilu.org#25931,"CENGKARENG TIMUR, CENGKARENG, JAKARTA BARAT, DKI JAKARTA",145,188,58,246
https://kawalpemilu.org#25931,"CENGKARENG TIMUR, CENGKARENG, JAKARTA BARAT, DKI JAKARTA",146,148,76,224
https://kawalpemilu.org#25931,"CENGKARENG TIMUR, CENGKARENG, JAKARTA BARAT, DKI JAKARTA",147,98,81,179
https://kawalpemilu.org#25931,"CENGKARENG TIMUR, CENGKARENG, JAKARTA BARAT, DKI JAKARTA",148,131,75,206
https://kawalpemilu.org#25931,"CENGKARENG TIMUR, CENGKARENG, JAKARTA BARAT, DKI JAKARTA",149,148,92,240
https://kawalpemilu.org#25931,"CENGKARENG TIMUR, CENGKARENG, JAKARTA BARAT, DKI JAKARTA",150,132,113,245
https://kawalpemilu.org#25931,"CENGKARENG TIMUR, CENGKARENG, JAKARTA BARAT, DKI JAKARTA",151,123,114,237
https://kawalpemilu.org#25931,"CENGKARENG TIMUR, CENGKARENG, JAKARTA BARAT, DKI JAKARTA",152,131,97,228
https://kawalpemilu.org#25931,"CENGKARENG TIMUR, CENGKARENG, JAKARTA BARAT, DKI JAKARTA",153,123,83,206
https://kawalpemilu.org#25931,"CENGKARENG TIMUR, CENGKARENG, JAKARTA BARAT, DKI JAKARTA",154,146,103,249
https://kawalpemilu.org#25931,"CENGKARENG TIMUR, CENGKARENG, JAKARTA BARAT, DKI JAKARTA",155,0,0,0
https://kawalpemilu.org#25931,"CENGKARENG TIMUR, CENGKARENG, JAKARTA BARAT, DKI JAKARTA",156,151,62,213
https://kawalpemilu.org#25931,"CENGKARENG TIMUR, CENGKARENG, JAKARTA BARAT, DKI JAKARTA",157,124,81,205
https://kawalpemilu.org#25931,"CENGKARENG TIMUR, CENGKARENG, JAKARTA BARAT, DKI JAKARTA",158,168,56,224
https://kawalpemilu.org#25931,"CENGKARENG TIMUR, CENGKARENG, JAKARTA BARAT, DKI JAKARTA",159,184,52,236
https://kawalpemilu.org#25931,"CENGKARENG TIMUR, CENGKARENG, JAKARTA BARAT, DKI JAKARTA",160,191,39,230
https://kawalpemilu.org#25931,"CENGKARENG TIMUR, CENGKARENG, JAKARTA BARAT, DKI JAKARTA",161,213,39,252
https://kawalpemilu.org#25931,"CENGKARENG TIMUR, CENGKARENG, JAKARTA BARAT, DKI JAKARTA",162,146,110,159
https://kawalpemilu.org#25931,"CENGKARENG TIMUR, CENGKARENG, JAKARTA BARAT, DKI JAKARTA",163,149,123,272
https://kawalpemilu.org#25931,"CENGKARENG TIMUR, CENGKARENG, JAKARTA BARAT, DKI JAKARTA",164,126,79,205
https://kawalpemilu.org#25931,"CENGKARENG TIMUR, CENGKARENG, JAKARTA BARAT, DKI JAKARTA",165,168,46,214
https://kawalpemilu.org#25931,"CENGKARENG TIMUR, CENGKARENG, JAKARTA BARAT, DKI JAKARTA",166,125,83,208
https://kawalpemilu.org#25931,"CENGKARENG TIMUR, CENGKARENG, JAKARTA BARAT, DKI JAKARTA",167,110,95,205
https://kawalpemilu.org#25931,"CENGKARENG TIMUR, CENGKARENG, JAKARTA BARAT, DKI JAKARTA",168,110,91,201
https://kawalpemilu.org#25931,"CENGKARENG TIMUR, CENGKARENG, JAKARTA BARAT, DKI JAKARTA",169,158,91,249
https://kawalpemilu.org#25931,"CENGKARENG TIMUR, CENGKARENG, JAKARTA BARAT, DKI JAKARTA",170,139,83,222
https://kawalpemilu.org#25931,"CENGKARENG TIMUR, CENGKARENG, JAKARTA BARAT, DKI JAKARTA",171,110,95,205
https://kawalpemilu.org#25931,"CENGKARENG TIMUR, CENGKARENG, JAKARTA BARAT, DKI JAKARTA",172,90,127,217
https://kawalpemilu.org#25931,"CENGKARENG TIMUR, CENGKARENG, JAKARTA BARAT, DKI JAKARTA",173,113,102,215
https://kawalpemilu.org#25931,"CENGKARENG TIMUR, CENGKARENG, JAKARTA BARAT, DKI JAKARTA",175,89,117,206
https://kawalpemilu.org#25931,"CENGKARENG TIMUR, CENGKARENG, JAKARTA BARAT, DKI JAKARTA",176,87,115,202
https://kawalpemilu.org#25931,"CENGKARENG TIMUR, CENGKARENG, JAKARTA BARAT, DKI JAKARTA",177,102,114,216
https://kawalpemilu.org#25931,"CENGKARENG TIMUR, CENGKARENG, JAKARTA BARAT, DKI JAKARTA",178,88,112,200
https://kawalpemilu.org#25931,"CENGKARENG TIMUR, CENGKARENG, JAKARTA BARAT, DKI JAKARTA",179,129,114,243
https://kawalpemilu.org#25931,"CENGKARENG TIMUR, CENGKARENG, JAKARTA BARAT, DKI JAKARTA",180,121,96,217
https://kawalpemilu.org#25931,"CENGKARENG TIMUR, CENGKARENG, JAKARTA BARAT, DKI JAKARTA",181,88,102,190
https://kawalpemilu.org#25931,"CENGKARENG TIMUR, CENGKARENG, JAKARTA BARAT, DKI JAKARTA",182,45,170,215
https://kawalpemilu.org#25931,"CENGKARENG TIMUR, CENGKARENG, JAKARTA BARAT, DKI JAKARTA",183,163,104,267
https://kawalpemilu.org#25931,"CENGKARENG TIMUR, CENGKARENG, JAKARTA BARAT, DKI JAKARTA",184,136,112,248
https://kawalpemilu.org#25931,"CENGKARENG TIMUR, CENGKARENG, JAKARTA BARAT, DKI JAKARTA",185,131,108,239
https://kawalpemilu.org#25931,"CENGKARENG TIMUR, CENGKARENG, JAKARTA BARAT, DKI JAKARTA",186,129,123,252
https://kawalpemilu.org#25931,"CENGKARENG TIMUR, CENGKARENG, JAKARTA BARAT, DKI JAKARTA",187,97,133,230
https://kawalpemilu.org#25931,"CENGKARENG TIMUR, CENGKARENG, JAKARTA BARAT, DKI JAKARTA",188,122,105,227
https://kawalpemilu.org#25931,"CENGKARENG TIMUR, CENGKARENG, JAKARTA BARAT, DKI JAKARTA",189,228,6,234
https://kawalpemilu.org#25931,"CENGKARENG TIMUR, CENGKARENG, JAKARTA BARAT, DKI JAKARTA",190,184,9,193
https://kawalpemilu.org#25931,"CENGKARENG TIMUR, CENGKARENG, JAKARTA BARAT, DKI JAKARTA",191,228,7,235
https://kawalpemilu.org#25931,"CENGKARENG TIMUR, CENGKARENG, JAKARTA BARAT, DKI JAKARTA",192,142,102,244
https://kawalpemilu.org#25931,"CENGKARENG TIMUR, CENGKARENG, JAKARTA BARAT, DKI JAKARTA",193,283,10,293
https://kawalpemilu.org#25931,"CENGKARENG TIMUR, CENGKARENG, JAKARTA BARAT, DKI JAKARTA",194,204,90,294
https://kawalpemilu.org#25931,"CENGKARENG TIMUR, CENGKARENG, JAKARTA BARAT, DKI JAKARTA",195,176,41,217
https://kawalpemilu.org#25931,"CENGKARENG TIMUR, CENGKARENG, JAKARTA BARAT, DKI JAKARTA",196,234,3,237
https://kawalpemilu.org#25931,"CENGKARENG TIMUR, CENGKARENG, JAKARTA BARAT, DKI JAKARTA",197,228,6,234
https://kawalpemilu.org#25931,"CENGKARENG TIMUR, CENGKARENG, JAKARTA BARAT, DKI JAKARTA",198,199,5,204
https://kawalpemilu.org#25931,"CENGKARENG TIMUR, CENGKARENG, JAKARTA BARAT, DKI JAKARTA",199,182,8,190
https://kawalpemilu.org#25931,"CENGKARENG TIMUR, CENGKARENG, JAKARTA BARAT, DKI JAKARTA",200,250,12,262
https://kawalpemilu.org#25931,"CENGKARENG TIMUR, CENGKARENG, JAKARTA BARAT, DKI JAKARTA",201,205,5,210
https://kawalpemilu.org#25931,"CENGKARENG TIMUR, CENGKARENG, JAKARTA BARAT, DKI JAKARTA",202,189,8,197
https://kawalpemilu.org#25931,"CENGKARENG TIMUR, CENGKARENG, JAKARTA BARAT, DKI JAKARTA",203,204,6,210
https://kawalpemilu.org#25931,"CENGKARENG TIMUR, CENGKARENG, JAKARTA BARAT, DKI JAKARTA",204,177,3,180
https://kawalpemilu.org#25931,"CENGKARENG TIMUR, CENGKARENG, JAKARTA BARAT, DKI JAKARTA",205,235,12,247
https://kawalpemilu.org#25931,"CENGKARENG TIMUR, CENGKARENG, JAKARTA BARAT, DKI JAKARTA",206,204,6,210
https://kawalpemilu.org#25931,"CENGKARENG TIMUR, CENGKARENG, JAKARTA BARAT, DKI JAKARTA",207,262,16,278
https://kawalpemilu.org#25931,"CENGKARENG TIMUR, CENGKARENG, JAKARTA BARAT, DKI JAKARTA",208,152,101,253
https://kawalpemilu.org#25931,"CENGKARENG TIMUR, CENGKARENG, JAKARTA BARAT, DKI JAKARTA",209,139,82,221
https://kawalpemilu.org#25931,"CENGKARENG TIMUR, CENGKARENG, JAKARTA BARAT, DKI JAKARTA",210,164,77,241
https://kawalpemilu.org#25931,"CENGKARENG TIMUR, CENGKARENG, JAKARTA BARAT, DKI JAKARTA",211,146,94,240
https://kawalpemilu.org#25931,"CENGKARENG TIMUR, CENGKARENG, JAKARTA BARAT, DKI JAKARTA",212,157,90,247
https://kawalpemilu.org#25931,"CENGKARENG TIMUR, CENGKARENG, JAKARTA BARAT, DKI JAKARTA",213,133,93,226
https://kawalpemilu.org#25931,"CENGKARENG TIMUR, CENGKARENG, JAKARTA BARAT, DKI JAKARTA",214,126,91,217
https://kawalpemilu.org#25931,"CENGKARENG TIMUR, CENGKARENG, JAKARTA BARAT, DKI JAKARTA",215,201,50,251
https://kawalpemilu.org#25931,"CENGKARENG TIMUR, CENGKARENG, JAKARTA BARAT, DKI JAKARTA",216,188,102,290
https://kawalpemilu.org#25931,"CENGKARENG TIMUR, CENGKARENG, JAKARTA BARAT, DKI JAKARTA",217,189,72,261
https://kawalpemilu.org#25931,"CENGKARENG TIMUR, CENGKARENG, JAKARTA BARAT, DKI JAKARTA",218,170,63,233
https://kawalpemilu.org#25931,"CENGKARENG TIMUR, CENGKARENG, JAKARTA BARAT, DKI JAKARTA",219,204,58,262
https://kawalpemilu.org#25931,"CENGKARENG TIMUR, CENGKARENG, JAKARTA BARAT, DKI JAKARTA",220,156,70,226
https://kawalpemilu.org#25931,"CENGKARENG TIMUR, CENGKARENG, JAKARTA BARAT, DKI JAKARTA",221,143,79,222
https://kawalpemilu.org#25931,"CENGKARENG TIMUR, CENGKARENG, JAKARTA BARAT, DKI JAKARTA",222,249,15,264
https://kawalpemilu.org#25931,"CENGKARENG TIMUR, CENGKARENG, JAKARTA BARAT, DKI JAKARTA",223,201,60,261
https://kawalpemilu.org#25931,"CENGKARENG TIMUR, CENGKARENG, JAKARTA BARAT, DKI JAKARTA",224,97,153,250
https://kawalpemilu.org#25931,"CENGKARENG TIMUR, CENGKARENG, JAKARTA BARAT, DKI JAKARTA",225,139,102,241
https://kawalpemilu.org#25931,"CENGKARENG TIMUR, CENGKARENG, JAKARTA BARAT, DKI JAKARTA",226,144,93,237
https://kawalpemilu.org#25931,"CENGKARENG TIMUR, CENGKARENG, JAKARTA BARAT, DKI JAKARTA",227,155,113,268
https://kawalpemilu.org#25931,"CENGKARENG TIMUR, CENGKARENG, JAKARTA BARAT, DKI JAKARTA",228,176,76,252
https://kawalpemilu.org#25931,"CENGKARENG TIMUR, CENGKARENG, JAKARTA BARAT, DKI JAKARTA",229,133,98,231
https://kawalpemilu.org#25931,"CENGKARENG TIMUR, CENGKARENG, JAKARTA BARAT, DKI JAKARTA",230,122,99,221
https://kawalpemilu.org#25931,"CENGKARENG TIMUR, CENGKARENG, JAKARTA BARAT, DKI JAKARTA",231,131,111,242
https://kawalpemilu.org#25931,"CENGKARENG TIMUR, CENGKARENG, JAKARTA BARAT, DKI JAKARTA",232,168,84,252
https://kawalpemilu.org#25931,"CENGKARENG TIMUR, CENGKARENG, JAKARTA BARAT, DKI JAKARTA",233,145,94,239
https://kawalpemilu.org#25931,"CENGKARENG TIMUR, CENGKARENG, JAKARTA BARAT, DKI JAKARTA",234,208,4,7
https://kawalpemilu.org#25931,"CENGKARENG TIMUR, CENGKARENG, JAKARTA BARAT, DKI JAKARTA",235,203,5,208
https://kawalpemilu.org#25931,"CENGKARENG TIMUR, CENGKARENG, JAKARTA BARAT, DKI JAKARTA",236,233,10,243
https://kawalpemilu.org#25933,"GROGOL, GROGOL PETAMBURAN, JAKARTA BARAT, DKI JAKARTA",1,100,129,229
https://kawalpemilu.org#25933,"GROGOL, GROGOL PETAMBURAN, JAKARTA BARAT, DKI JAKARTA",2,128,94,222
https://kawalpemilu.org#25933,"GROGOL, GROGOL PETAMBURAN, JAKARTA BARAT, DKI JAKARTA",3,114,109,223
https://kawalpemilu.org#25933,"GROGOL, GROGOL PETAMBURAN, JAKARTA BARAT, DKI JAKARTA",4,102,135,237
https://kawalpemilu.org#25933,"GROGOL, GROGOL PETAMBURAN, JAKARTA BARAT, DKI JAKARTA",5,100,142,242
https://kawalpemilu.org#25933,"GROGOL, GROGOL PETAMBURAN, JAKARTA BARAT, DKI JAKARTA",6,98,142,240
https://kawalpemilu.org#25933,"GROGOL, GROGOL PETAMBURAN, JAKARTA BARAT, DKI JAKARTA",7,0,0,0
https://kawalpemilu.org#25933,"GROGOL, GROGOL PETAMBURAN, JAKARTA BARAT, DKI JAKARTA",8,118,116,234
https://kawalpemilu.org#25933,"GROGOL, GROGOL PETAMBURAN, JAKARTA BARAT, DKI JAKARTA",9,89,138,227
https://kawalpemilu.org#25933,"GROGOL, GROGOL PETAMBURAN, JAKARTA BARAT, DKI JAKARTA",10,111,122,233
https://kawalpemilu.org#25933,"GROGOL, GROGOL PETAMBURAN, JAKARTA BARAT, DKI JAKARTA",11,91,135,226
https://kawalpemilu.org#25933,"GROGOL, GROGOL PETAMBURAN, JAKARTA BARAT, DKI JAKARTA",12,178,40,218
https://kawalpemilu.org#25933,"GROGOL, GROGOL PETAMBURAN, JAKARTA BARAT, DKI JAKARTA",13,117,87,204
https://kawalpemilu.org#25933,"GROGOL, GROGOL PETAMBURAN, JAKARTA BARAT, DKI JAKARTA",14,174,46,220
https://kawalpemilu.org#25933,"GROGOL, GROGOL PETAMBURAN, JAKARTA BARAT, DKI JAKARTA",15,100,109,209
https://kawalpemilu.org#25933,"GROGOL, GROGOL PETAMBURAN, JAKARTA BARAT, DKI JAKARTA",16,99,127,226
https://kawalpemilu.org#25933,"GROGOL, GROGOL PETAMBURAN, JAKARTA BARAT, DKI JAKARTA",17,135,114,249
https://kawalpemilu.org#25933,"GROGOL, GROGOL PETAMBURAN, JAKARTA BARAT, DKI JAKARTA",18,179,47,226
https://kawalpemilu.org#25933,"GROGOL, GROGOL PETAMBURAN, JAKARTA BARAT, DKI JAKARTA",19,212,34,246
https://kawalpemilu.org#25933,"GROGOL, GROGOL PETAMBURAN, JAKARTA BARAT, DKI JAKARTA",20,174,63,237
https://kawalpemilu.org#25933,"GROGOL, GROGOL PETAMBURAN, JAKARTA BARAT, DKI JAKARTA",21,183,48,231
https://kawalpemilu.org#25933,"GROGOL, GROGOL PETAMBURAN, JAKARTA BARAT, DKI JAKARTA",22,154,90,244
https://kawalpemilu.org#25933,"GROGOL, GROGOL PETAMBURAN, JAKARTA BARAT, DKI JAKARTA",23,172,69,241
https://kawalpemilu.org#25933,"GROGOL, GROGOL PETAMBURAN, JAKARTA BARAT, DKI JAKARTA",24,166,56,222
https://kawalpemilu.org#25933,"GROGOL, GROGOL PETAMBURAN, JAKARTA BARAT, DKI JAKARTA",25,208,53,261
https://kawalpemilu.org#25933,"GROGOL, GROGOL PETAMBURAN, JAKARTA BARAT, DKI JAKARTA",26,182,63,245
https://kawalpemilu.org#25933,"GROGOL, GROGOL PETAMBURAN, JAKARTA BARAT, DKI JAKARTA",27,218,38,256
https://kawalpemilu.org#25933,"GROGOL, GROGOL PETAMBURAN, JAKARTA BARAT, DKI JAKARTA",28,211,29,240
https://kawalpemilu.org#25933,"GROGOL, GROGOL PETAMBURAN, JAKARTA BARAT, DKI JAKARTA",29,154,77,231
https://kawalpemilu.org#25933,"GROGOL, GROGOL PETAMBURAN, JAKARTA BARAT, DKI JAKARTA",30,109,107,216
https://kawalpemilu.org#25933,"GROGOL, GROGOL PETAMBURAN, JAKARTA BARAT, DKI JAKARTA",31,185,71,256
https://kawalpemilu.org#25933,"GROGOL, GROGOL PETAMBURAN, JAKARTA BARAT, DKI JAKARTA",32,173,51,224
https://kawalpemilu.org#25933,"GROGOL, GROGOL PETAMBURAN, JAKARTA BARAT, DKI JAKARTA",33,196,27,223
https://kawalpemilu.org#25933,"GROGOL, GROGOL PETAMBURAN, JAKARTA BARAT, DKI JAKARTA",34,212,30,242
https://kawalpemilu.org#25933,"GROGOL, GROGOL PETAMBURAN, JAKARTA BARAT, DKI JAKARTA",35,170,59,229
https://kawalpemilu.org#25933,"GROGOL, GROGOL PETAMBURAN, JAKARTA BARAT, DKI JAKARTA",36,184,42,226
https://kawalpemilu.org#25933,"GROGOL, GROGOL PETAMBURAN, JAKARTA BARAT, DKI JAKARTA",37,186,31,217
https://kawalpemilu.org#25933,"GROGOL, GROGOL PETAMBURAN, JAKARTA BARAT, DKI JAKARTA",38,155,43,198
https://kawalpemilu.org#25933,"GROGOL, GROGOL PETAMBURAN, JAKARTA BARAT, DKI JAKARTA",39,200,25,225
https://kawalpemilu.org#25933,"GROGOL, GROGOL PETAMBURAN, JAKARTA BARAT, DKI JAKARTA",40,174,40,214
https://kawalpemilu.org#25933,"GROGOL, GROGOL PETAMBURAN, JAKARTA BARAT, DKI JAKARTA",41,156,31,187
https://kawalpemilu.org#25933,"GROGOL, GROGOL PETAMBURAN, JAKARTA BARAT, DKI JAKARTA",42,176,24,200
https://kawalpemilu.org#25933,"GROGOL, GROGOL PETAMBURAN, JAKARTA BARAT, DKI JAKARTA",43,122,61,183
https://kawalpemilu.org#25933,"GROGOL, GROGOL PETAMBURAN, JAKARTA BARAT, DKI JAKARTA",44,180,64,244
https://kawalpemilu.org#25933,"GROGOL, GROGOL PETAMBURAN, JAKARTA BARAT, DKI JAKARTA",45,122,123,245
https://kawalpemilu.org#25933,"GROGOL, GROGOL PETAMBURAN, JAKARTA BARAT, DKI JAKARTA",46,119,105,224
https://kawalpemilu.org#25933,"GROGOL, GROGOL PETAMBURAN, JAKARTA BARAT, DKI JAKARTA",47,111,133,244
https://kawalpemilu.org#25933,"GROGOL, GROGOL PETAMBURAN, JAKARTA BARAT, DKI JAKARTA",48,90,157,247
https://kawalpemilu.org#25933,"GROGOL, GROGOL PETAMBURAN, JAKARTA BARAT, DKI JAKARTA",49,119,94,213
https://kawalpemilu.org#25933,"GROGOL, GROGOL PETAMBURAN, JAKARTA BARAT, DKI JAKARTA",50,116,89,205
https://kawalpemilu.org#25933,"GROGOL, GROGOL PETAMBURAN, JAKARTA BARAT, DKI JAKARTA",51,125,96,221
https://kawalpemilu.org#25933,"GROGOL, GROGOL PETAMBURAN, JAKARTA BARAT, DKI JAKARTA",52,138,63,201
https://kawalpemilu.org#25933,"GROGOL, GROGOL PETAMBURAN, JAKARTA BARAT, DKI JAKARTA",53,129,99,228
https://kawalpemilu.org#25933,"GROGOL, GROGOL PETAMBURAN, JAKARTA BARAT, DKI JAKARTA",54,85,133,4
https://kawalpemilu.org#25933,"GROGOL, GROGOL PETAMBURAN, JAKARTA BARAT, DKI JAKARTA",55,71,185,256
https://kawalpemilu.org#25933,"GROGOL, GROGOL PETAMBURAN, JAKARTA BARAT, DKI JAKARTA",56,120,101,221
https://kawalpemilu.org#25933,"GROGOL, GROGOL PETAMBURAN, JAKARTA BARAT, DKI JAKARTA",57,119,100,219
https://kawalpemilu.org#25934,"TANJUNG DUREN UTARA, GROGOL PETAMBURAN, JAKARTA BARAT, DKI JAKARTA",1,206,11,217
https://kawalpemilu.org#25934,"TANJUNG DUREN UTARA, GROGOL PETAMBURAN, JAKARTA BARAT, DKI JAKARTA",2,180,37,217
https://kawalpemilu.org#25934,"TANJUNG DUREN UTARA, GROGOL PETAMBURAN, JAKARTA BARAT, DKI JAKARTA",3,152,76,228
https://kawalpemilu.org#25934,"TANJUNG DUREN UTARA, GROGOL PETAMBURAN, JAKARTA BARAT, DKI JAKARTA",4,140,93,233
https://kawalpemilu.org#25934,"TANJUNG DUREN UTARA, GROGOL PETAMBURAN, JAKARTA BARAT, DKI JAKARTA",5,145,65,210
https://kawalpemilu.org#25934,"TANJUNG DUREN UTARA, GROGOL PETAMBURAN, JAKARTA BARAT, DKI JAKARTA",6,165,65,230
https://kawalpemilu.org#25934,"TANJUNG DUREN UTARA, GROGOL PETAMBURAN, JAKARTA BARAT, DKI JAKARTA",7,141,31,172
https://kawalpemilu.org#25934,"TANJUNG DUREN UTARA, GROGOL PETAMBURAN, JAKARTA BARAT, DKI JAKARTA",8,127,90,217
https://kawalpemilu.org#25934,"TANJUNG DUREN UTARA, GROGOL PETAMBURAN, JAKARTA BARAT, DKI JAKARTA",9,131,92,223
https://kawalpemilu.org#25934,"TANJUNG DUREN UTARA, GROGOL PETAMBURAN, JAKARTA BARAT, DKI JAKARTA",10,155,69,224
https://kawalpemilu.org#25934,"TANJUNG DUREN UTARA, GROGOL PETAMBURAN, JAKARTA BARAT, DKI JAKARTA",11,135,88,223
https://kawalpemilu.org#25934,"TANJUNG DUREN UTARA, GROGOL PETAMBURAN, JAKARTA BARAT, DKI JAKARTA",12,158,105,263
https://kawalpemilu.org#25934,"TANJUNG DUREN UTARA, GROGOL PETAMBURAN, JAKARTA BARAT, DKI JAKARTA",13,181,71,252
https://kawalpemilu.org#25934,"TANJUNG DUREN UTARA, GROGOL PETAMBURAN, JAKARTA BARAT, DKI JAKARTA",14,234,2,236
https://kawalpemilu.org#25934,"TANJUNG DUREN UTARA, GROGOL PETAMBURAN, JAKARTA BARAT, DKI JAKARTA",15,236,8,244
https://kawalpemilu.org#25934,"TANJUNG DUREN UTARA, GROGOL PETAMBURAN, JAKARTA BARAT, DKI JAKARTA",16,212,49,261
https://kawalpemilu.org#25934,"TANJUNG DUREN UTARA, GROGOL PETAMBURAN, JAKARTA BARAT, DKI JAKARTA",17,193,58,251
https://kawalpemilu.org#25934,"TANJUNG DUREN UTARA, GROGOL PETAMBURAN, JAKARTA BARAT, DKI JAKARTA",18,178,50,228
https://kawalpemilu.org#25934,"TANJUNG DUREN UTARA, GROGOL PETAMBURAN, JAKARTA BARAT, DKI JAKARTA",19,252,8,260
https://kawalpemilu.org#25934,"TANJUNG DUREN UTARA, GROGOL PETAMBURAN, JAKARTA BARAT, DKI JAKARTA",20,252,7,259
https://kawalpemilu.org#25934,"TANJUNG DUREN UTARA, GROGOL PETAMBURAN, JAKARTA BARAT, DKI JAKARTA",21,240,6,246
https://kawalpemilu.org#25934,"TANJUNG DUREN UTARA, GROGOL PETAMBURAN, JAKARTA BARAT, DKI JAKARTA",22,241,38,279
https://kawalpemilu.org#25934,"TANJUNG DUREN UTARA, GROGOL PETAMBURAN, JAKARTA BARAT, DKI JAKARTA",23,209,25,234
https://kawalpemilu.org#25934,"TANJUNG DUREN UTARA, GROGOL PETAMBURAN, JAKARTA BARAT, DKI JAKARTA",24,189,43,232
https://kawalpemilu.org#25934,"TANJUNG DUREN UTARA, GROGOL PETAMBURAN, JAKARTA BARAT, DKI JAKARTA",25,199,54,253
https://kawalpemilu.org#25934,"TANJUNG DUREN UTARA, GROGOL PETAMBURAN, JAKARTA BARAT, DKI JAKARTA",26,177,39,216
https://kawalpemilu.org#25934,"TANJUNG DUREN UTARA, GROGOL PETAMBURAN, JAKARTA BARAT, DKI JAKARTA",27,163,52,216
https://kawalpemilu.org#25934,"TANJUNG DUREN UTARA, GROGOL PETAMBURAN, JAKARTA BARAT, DKI JAKARTA",28,151,75,226
https://kawalpemilu.org#25934,"TANJUNG DUREN UTARA, GROGOL PETAMBURAN, JAKARTA BARAT, DKI JAKARTA",29,143,80,223
https://kawalpemilu.org#25934,"TANJUNG DUREN UTARA, GROGOL PETAMBURAN, JAKARTA BARAT, DKI JAKARTA",30,149,70,219
https://kawalpemilu.org#25934,"TANJUNG DUREN UTARA, GROGOL PETAMBURAN, JAKARTA BARAT, DKI JAKARTA",31,168,80,248
https://kawalpemilu.org#25934,"TANJUNG DUREN UTARA, GROGOL PETAMBURAN, JAKARTA BARAT, DKI JAKARTA",32,190,57,247
https://kawalpemilu.org#25934,"TANJUNG DUREN UTARA, GROGOL PETAMBURAN, JAKARTA BARAT, DKI JAKARTA",33,167,76,243
https://kawalpemilu.org#25934,"TANJUNG DUREN UTARA, GROGOL PETAMBURAN, JAKARTA BARAT, DKI JAKARTA",34,168,71,239
https://kawalpemilu.org#25934,"TANJUNG DUREN UTARA, GROGOL PETAMBURAN, JAKARTA BARAT, DKI JAKARTA",35,150,87,237
https://kawalpemilu.org#25934,"TANJUNG DUREN UTARA, GROGOL PETAMBURAN, JAKARTA BARAT, DKI JAKARTA",36,172,85,257
https://kawalpemilu.org#25934,"TANJUNG DUREN UTARA, GROGOL PETAMBURAN, JAKARTA BARAT, DKI JAKARTA",37,177,50,227
https://kawalpemilu.org#25934,"TANJUNG DUREN UTARA, GROGOL PETAMBURAN, JAKARTA BARAT, DKI JAKARTA",38,190,47,237
https://kawalpemilu.org#25934,"TANJUNG DUREN UTARA, GROGOL PETAMBURAN, JAKARTA BARAT, DKI JAKARTA",39,195,49,244
https://kawalpemilu.org#25934,"TANJUNG DUREN UTARA, GROGOL PETAMBURAN, JAKARTA BARAT, DKI JAKARTA",40,221,35,256
https://kawalpemilu.org#25934,"TANJUNG DUREN UTARA, GROGOL PETAMBURAN, JAKARTA BARAT, DKI JAKARTA",41,150,97,247
https://kawalpemilu.org#25934,"TANJUNG DUREN UTARA, GROGOL PETAMBURAN, JAKARTA BARAT, DKI JAKARTA",42,161,93,254
https://kawalpemilu.org#25934,"TANJUNG DUREN UTARA, GROGOL PETAMBURAN, JAKARTA BARAT, DKI JAKARTA",43,218,55,273
https://kawalpemilu.org#25934,"TANJUNG DUREN UTARA, GROGOL PETAMBURAN, JAKARTA BARAT, DKI JAKARTA",44,220,11,231
https://kawalpemilu.org#25934,"TANJUNG DUREN UTARA, GROGOL PETAMBURAN, JAKARTA BARAT, DKI JAKARTA",45,190,23,213
https://kawalpemilu.org#25934,"TANJUNG DUREN UTARA, GROGOL PETAMBURAN, JAKARTA BARAT, DKI JAKARTA",46,153,83,236
https://kawalpemilu.org#25934,"TANJUNG DUREN UTARA, GROGOL PETAMBURAN, JAKARTA BARAT, DKI JAKARTA",47,181,74,255
https://kawalpemilu.org#25934,"TANJUNG DUREN UTARA, GROGOL PETAMBURAN, JAKARTA BARAT, DKI JAKARTA",48,187,64,251
https://kawalpemilu.org#25934,"TANJUNG DUREN UTARA, GROGOL PETAMBURAN, JAKARTA BARAT, DKI JAKARTA",49,216,46,262
https://kawalpemilu.org#25934,"TANJUNG DUREN UTARA, GROGOL PETAMBURAN, JAKARTA BARAT, DKI JAKARTA",50,162,73,235
https://kawalpemilu.org#25934,"TANJUNG DUREN UTARA, GROGOL PETAMBURAN, JAKARTA BARAT, DKI JAKARTA",51,194,32,226
https://kawalpemilu.org#25934,"TANJUNG DUREN UTARA, GROGOL PETAMBURAN, JAKARTA BARAT, DKI JAKARTA",52,207,32,239
https://kawalpemilu.org#25934,"TANJUNG DUREN UTARA, GROGOL PETAMBURAN, JAKARTA BARAT, DKI JAKARTA",53,225,29,254
https://kawalpemilu.org#25934,"TANJUNG DUREN UTARA, GROGOL PETAMBURAN, JAKARTA BARAT, DKI JAKARTA",54,171,56,227
https://kawalpemilu.org#25934,"TANJUNG DUREN UTARA, GROGOL PETAMBURAN, JAKARTA BARAT, DKI JAKARTA",55,126,141,267
https://kawalpemilu.org#25934,"TANJUNG DUREN UTARA, GROGOL PETAMBURAN, JAKARTA BARAT, DKI JAKARTA",56,120,99,219
https://kawalpemilu.org#25935,"TOMANG, GROGOL PETAMBURAN, JAKARTA BARAT, DKI JAKARTA",1,155,39,194
https://kawalpemilu.org#25935,"TOMANG, GROGOL PETAMBURAN, JAKARTA BARAT, DKI JAKARTA",2,166,57,223
https://kawalpemilu.org#25935,"TOMANG, GROGOL PETAMBURAN, JAKARTA BARAT, DKI JAKARTA",3,99,80,179
https://kawalpemilu.org#25935,"TOMANG, GROGOL PETAMBURAN, JAKARTA BARAT, DKI JAKARTA",4,153,58,211
https://kawalpemilu.org#25935,"TOMANG, GROGOL PETAMBURAN, JAKARTA BARAT, DKI JAKARTA",5,171,46,217
https://kawalpemilu.org#25935,"TOMANG, GROGOL PETAMBURAN, JAKARTA BARAT, DKI JAKARTA",6,203,46,249
https://kawalpemilu.org#25935,"TOMANG, GROGOL PETAMBURAN, JAKARTA BARAT, DKI JAKARTA",7,183,48,231
https://kawalpemilu.org#25935,"TOMANG, GROGOL PETAMBURAN, JAKARTA BARAT, DKI JAKARTA",8,162,41,203
https://kawalpemilu.org#25935,"TOMANG, GROGOL PETAMBURAN, JAKARTA BARAT, DKI JAKARTA",9,204,32,236
https://kawalpemilu.org#25935,"TOMANG, GROGOL PETAMBURAN, JAKARTA BARAT, DKI JAKARTA",10,176,26,202
https://kawalpemilu.org#25935,"TOMANG, GROGOL PETAMBURAN, JAKARTA BARAT, DKI JAKARTA",11,179,26,205
https://kawalpemilu.org#25935,"TOMANG, GROGOL PETAMBURAN, JAKARTA BARAT, DKI JAKARTA",12,171,29,200
https://kawalpemilu.org#25935,"TOMANG, GROGOL PETAMBURAN, JAKARTA BARAT, DKI JAKARTA",13,204,21,225
https://kawalpemilu.org#25935,"TOMANG, GROGOL PETAMBURAN, JAKARTA BARAT, DKI JAKARTA",14,148,34,182
https://kawalpemilu.org#25935,"TOMANG, GROGOL PETAMBURAN, JAKARTA BARAT, DKI JAKARTA",15,169,69,238
https://kawalpemilu.org#25935,"TOMANG, GROGOL PETAMBURAN, JAKARTA BARAT, DKI JAKARTA",16,153,44,197
https://kawalpemilu.org#25935,"TOMANG, GROGOL PETAMBURAN, JAKARTA BARAT, DKI JAKARTA",17,152,67,219
https://kawalpemilu.org#25935,"TOMANG, GROGOL PETAMBURAN, JAKARTA BARAT, DKI JAKARTA",18,140,72,212
https://kawalpemilu.org#25935,"TOMANG, GROGOL PETAMBURAN, JAKARTA BARAT, DKI JAKARTA",19,188,76,264
https://kawalpemilu.org#25935,"TOMANG, GROGOL PETAMBURAN, JAKARTA BARAT, DKI JAKARTA",20,190,46,236
https://kawalpemilu.org#25935,"TOMANG, GROGOL PETAMBURAN, JAKARTA BARAT, DKI JAKARTA",21,188,44,232
https://kawalpemilu.org#25935,"TOMANG, GROGOL PETAMBURAN, JAKARTA BARAT, DKI JAKARTA",22,195,53,248
https://kawalpemilu.org#25935,"TOMANG, GROGOL PETAMBURAN, JAKARTA BARAT, DKI JAKARTA",23,196,49,245
https://kawalpemilu.org#25935,"TOMANG, GROGOL PETAMBURAN, JAKARTA BARAT, DKI JAKARTA",24,167,69,236
https://kawalpemilu.org#25935,"TOMANG, GROGOL PETAMBURAN, JAKARTA BARAT, DKI JAKARTA",25,143,53,196
https://kawalpemilu.org#25935,"TOMANG, GROGOL PETAMBURAN, JAKARTA BARAT, DKI JAKARTA",26,124,73,197
https://kawalpemilu.org#25935,"TOMANG, GROGOL PETAMBURAN, JAKARTA BARAT, DKI JAKARTA",27,179,54,233
https://kawalpemilu.org#25935,"TOMANG, GROGOL PETAMBURAN, JAKARTA BARAT, DKI JAKARTA",28,105,110,215
https://kawalpemilu.org#25935,"TOMANG, GROGOL PETAMBURAN, JAKARTA BARAT, DKI JAKARTA",29,119,96,215
https://kawalpemilu.org#25935,"TOMANG, GROGOL PETAMBURAN, JAKARTA BARAT, DKI JAKARTA",30,128,102,230
https://kawalpemilu.org#25935,"TOMANG, GROGOL PETAMBURAN, JAKARTA BARAT, DKI JAKARTA",31,148,69,217
https://kawalpemilu.org#25935,"TOMANG, GROGOL PETAMBURAN, JAKARTA BARAT, DKI JAKARTA",32,137,86,223
https://kawalpemilu.org#25935,"TOMANG, GROGOL PETAMBURAN, JAKARTA BARAT, DKI JAKARTA",33,154,89,243
https://kawalpemilu.org#25935,"TOMANG, GROGOL PETAMBURAN, JAKARTA BARAT, DKI JAKARTA",34,113,132,245
https://kawalpemilu.org#25935,"TOMANG, GROGOL PETAMBURAN, JAKARTA BARAT, DKI JAKARTA",35,148,59,207
https://kawalpemilu.org#25935,"TOMANG, GROGOL PETAMBURAN, JAKARTA BARAT, DKI JAKARTA",36,124,109,233
https://kawalpemilu.org#25935,"TOMANG, GROGOL PETAMBURAN, JAKARTA BARAT, DKI JAKARTA",37,120,115,235
https://kawalpemilu.org#25935,"TOMANG, GROGOL PETAMBURAN, JAKARTA BARAT, DKI JAKARTA",38,88,156,244
https://kawalpemilu.org#25935,"TOMANG, GROGOL PETAMBURAN, JAKARTA BARAT, DKI JAKARTA",39,92,134,226
https://kawalpemilu.org#25935,"TOMANG, GROGOL PETAMBURAN, JAKARTA BARAT, DKI JAKARTA",40,145,100,245
https://kawalpemilu.org#25935,"TOMANG, GROGOL PETAMBURAN, JAKARTA BARAT, DKI JAKARTA",41,130,109,239
https://kawalpemilu.org#25935,"TOMANG, GROGOL PETAMBURAN, JAKARTA BARAT, DKI JAKARTA",42,136,109,245
https://kawalpemilu.org#25935,"TOMANG, GROGOL PETAMBURAN, JAKARTA BARAT, DKI JAKARTA",43,148,110,258
https://kawalpemilu.org#25935,"TOMANG, GROGOL PETAMBURAN, JAKARTA BARAT, DKI JAKARTA",44,131,78,209
https://kawalpemilu.org#25935,"TOMANG, GROGOL PETAMBURAN, JAKARTA BARAT, DKI JAKARTA",45,124,107,231
https://kawalpemilu.org#25935,"TOMANG, GROGOL PETAMBURAN, JAKARTA BARAT, DKI JAKARTA",46,0,0,0
https://kawalpemilu.org#25935,"TOMANG, GROGOL PETAMBURAN, JAKARTA BARAT, DKI JAKARTA",47,124,77,201
https://kawalpemilu.org#25935,"TOMANG, GROGOL PETAMBURAN, JAKARTA BARAT, DKI JAKARTA",48,179,62,241
https://kawalpemilu.org#25935,"TOMANG, GROGOL PETAMBURAN, JAKARTA BARAT, DKI JAKARTA",49,120,102,222
https://kawalpemilu.org#25935,"TOMANG, GROGOL PETAMBURAN, JAKARTA BARAT, DKI JAKARTA",50,144,68,212
https://kawalpemilu.org#25935,"TOMANG, GROGOL PETAMBURAN, JAKARTA BARAT, DKI JAKARTA",51,133,116,249
https://kawalpemilu.org#25935,"TOMANG, GROGOL PETAMBURAN, JAKARTA BARAT, DKI JAKARTA",52,172,23,195
https://kawalpemilu.org#25935,"TOMANG, GROGOL PETAMBURAN, JAKARTA BARAT, DKI JAKARTA",53,135,69,204
https://kawalpemilu.org#25935,"TOMANG, GROGOL PETAMBURAN, JAKARTA BARAT, DKI JAKARTA",54,129,66,195
https://kawalpemilu.org#25935,"TOMANG, GROGOL PETAMBURAN, JAKARTA BARAT, DKI JAKARTA",55,129,55,184
https://kawalpemilu.org#25935,"TOMANG, GROGOL PETAMBURAN, JAKARTA BARAT, DKI JAKARTA",56,117,95,212
https://kawalpemilu.org#25935,"TOMANG, GROGOL PETAMBURAN, JAKARTA BARAT, DKI JAKARTA",57,152,34,186
https://kawalpemilu.org#25935,"TOMANG, GROGOL PETAMBURAN, JAKARTA BARAT, DKI JAKARTA",58,172,32,204
https://kawalpemilu.org#25935,"TOMANG, GROGOL PETAMBURAN, JAKARTA BARAT, DKI JAKARTA",59,205,32,237
https://kawalpemilu.org#25935,"TOMANG, GROGOL PETAMBURAN, JAKARTA BARAT, DKI JAKARTA",60,196,42,238
https://kawalpemilu.org#25935,"TOMANG, GROGOL PETAMBURAN, JAKARTA BARAT, DKI JAKARTA",61,193,20,213
https://kawalpemilu.org#25935,"TOMANG, GROGOL PETAMBURAN, JAKARTA BARAT, DKI JAKARTA",62,139,91,230
https://kawalpemilu.org#25935,"TOMANG, GROGOL PETAMBURAN, JAKARTA BARAT, DKI JAKARTA",63,63,172,235
https://kawalpemilu.org#25935,"TOMANG, GROGOL PETAMBURAN, JAKARTA BARAT, DKI JAKARTA",64,88,115,203
https://kawalpemilu.org#25935,"TOMANG, GROGOL PETAMBURAN, JAKARTA BARAT, DKI JAKARTA",65,78,136,214
https://kawalpemilu.org#25935,"TOMANG, GROGOL PETAMBURAN, JAKARTA BARAT, DKI JAKARTA",66,79,146,225
https://kawalpemilu.org#25935,"TOMANG, GROGOL PETAMBURAN, JAKARTA BARAT, DKI JAKARTA",67,81,146,227
https://kawalpemilu.org#25935,"TOMANG, GROGOL PETAMBURAN, JAKARTA BARAT, DKI JAKARTA",68,64,188,252
https://kawalpemilu.org#25935,"TOMANG, GROGOL PETAMBURAN, JAKARTA BARAT, DKI JAKARTA",69,68,134,202
https://kawalpemilu.org#25935,"TOMANG, GROGOL PETAMBURAN, JAKARTA BARAT, DKI JAKARTA",70,109,119,228
https://kawalpemilu.org#25935,"TOMANG, GROGOL PETAMBURAN, JAKARTA BARAT, DKI JAKARTA",71,86,147,233
https://kawalpemilu.org#25935,"TOMANG, GROGOL PETAMBURAN, JAKARTA BARAT, DKI JAKARTA",72,81,153,234
https://kawalpemilu.org#25935,"TOMANG, GROGOL PETAMBURAN, JAKARTA BARAT, DKI JAKARTA",73,74,148,222
https://kawalpemilu.org#25935,"TOMANG, GROGOL PETAMBURAN, JAKARTA BARAT, DKI JAKARTA",74,133,72,205
https://kawalpemilu.org#25935,"TOMANG, GROGOL PETAMBURAN, JAKARTA BARAT, DKI JAKARTA",75,186,65,251
https://kawalpemilu.org#25935,"TOMANG, GROGOL PETAMBURAN, JAKARTA BARAT, DKI JAKARTA",76,131,117,248
https://kawalpemilu.org#25935,"TOMANG, GROGOL PETAMBURAN, JAKARTA BARAT, DKI JAKARTA",77,96,138,234
https://kawalpemilu.org#25935,"TOMANG, GROGOL PETAMBURAN, JAKARTA BARAT, DKI JAKARTA",78,73,166,239
https://kawalpemilu.org#25935,"TOMANG, GROGOL PETAMBURAN, JAKARTA BARAT, DKI JAKARTA",79,104,126,230
https://kawalpemilu.org#25935,"TOMANG, GROGOL PETAMBURAN, JAKARTA BARAT, DKI JAKARTA",80,87,128,215
https://kawalpemilu.org#25935,"TOMANG, GROGOL PETAMBURAN, JAKARTA BARAT, DKI JAKARTA",81,60,133,193
https://kawalpemilu.org#25935,"TOMANG, GROGOL PETAMBURAN, JAKARTA BARAT, DKI JAKARTA",82,48,138,186
https://kawalpemilu.org#25935,"TOMANG, GROGOL PETAMBURAN, JAKARTA BARAT, DKI JAKARTA",83,68,110,178
https://kawalpemilu.org#25935,"TOMANG, GROGOL PETAMBURAN, JAKARTA BARAT, DKI JAKARTA",84,44,131,175
https://kawalpemilu.org#25935,"TOMANG, GROGOL PETAMBURAN, JAKARTA BARAT, DKI JAKARTA",85,34,172,206
https://kawalpemilu.org#25935,"TOMANG, GROGOL PETAMBURAN, JAKARTA BARAT, DKI JAKARTA",86,61,144,205
https://kawalpemilu.org#25935,"TOMANG, GROGOL PETAMBURAN, JAKARTA BARAT, DKI JAKARTA",87,82,109,1
https://kawalpemilu.org#25935,"TOMANG, GROGOL PETAMBURAN, JAKARTA BARAT, DKI JAKARTA",89,96,94,190
https://kawalpemilu.org#25935,"TOMANG, GROGOL PETAMBURAN, JAKARTA BARAT, DKI JAKARTA",90,176,32,208
https://kawalpemilu.org#25935,"TOMANG, GROGOL PETAMBURAN, JAKARTA BARAT, DKI JAKARTA",91,199,26,225
https://kawalpemilu.org#25935,"TOMANG, GROGOL PETAMBURAN, JAKARTA BARAT, DKI JAKARTA",92,163,51,214
https://kawalpemilu.org#25935,"TOMANG, GROGOL PETAMBURAN, JAKARTA BARAT, DKI JAKARTA",93,109,100,209
https://kawalpemilu.org#25935,"TOMANG, GROGOL PETAMBURAN, JAKARTA BARAT, DKI JAKARTA",94,165,87,252
https://kawalpemilu.org#25935,"TOMANG, GROGOL PETAMBURAN, JAKARTA BARAT, DKI JAKARTA",95,110,87,197
https://kawalpemilu.org#25935,"TOMANG, GROGOL PETAMBURAN, JAKARTA BARAT, DKI JAKARTA",96,144,70,214
https://kawalpemilu.org#25935,"TOMANG, GROGOL PETAMBURAN, JAKARTA BARAT, DKI JAKARTA",97,119,57,176
https://kawalpemilu.org#25935,"TOMANG, GROGOL PETAMBURAN, JAKARTA BARAT, DKI JAKARTA",98,124,108,232
https://kawalpemilu.org#25935,"TOMANG, GROGOL PETAMBURAN, JAKARTA BARAT, DKI JAKARTA",99,144,81,225
https://kawalpemilu.org#25935,"TOMANG, GROGOL PETAMBURAN, JAKARTA BARAT, DKI JAKARTA",100,108,119,227
https://kawalpemilu.org#25936,"JELAMBAR, GROGOL PETAMBURAN, JAKARTA BARAT, DKI JAKARTA",1,198,12,210
https://kawalpemilu.org#25936,"JELAMBAR, GROGOL PETAMBURAN, JAKARTA BARAT, DKI JAKARTA",2,213,15,228
https://kawalpemilu.org#25936,"JELAMBAR, GROGOL PETAMBURAN, JAKARTA BARAT, DKI JAKARTA",3,193,17,210
https://kawalpemilu.org#25936,"JELAMBAR, GROGOL PETAMBURAN, JAKARTA BARAT, DKI JAKARTA",4,203,13,216
https://kawalpemilu.org#25936,"JELAMBAR, GROGOL PETAMBURAN, JAKARTA BARAT, DKI JAKARTA",5,232,12,244
https://kawalpemilu.org#25936,"JELAMBAR, GROGOL PETAMBURAN, JAKARTA BARAT, DKI JAKARTA",6,223,5,228
https://kawalpemilu.org#25936,"JELAMBAR, GROGOL PETAMBURAN, JAKARTA BARAT, DKI JAKARTA",7,208,21,229
https://kawalpemilu.org#25936,"JELAMBAR, GROGOL PETAMBURAN, JAKARTA BARAT, DKI JAKARTA",8,207,5,212
https://kawalpemilu.org#25936,"JELAMBAR, GROGOL PETAMBURAN, JAKARTA BARAT, DKI JAKARTA",9,172,12,184
https://kawalpemilu.org#25936,"JELAMBAR, GROGOL PETAMBURAN, JAKARTA BARAT, DKI JAKARTA",10,190,12,202
https://kawalpemilu.org#25936,"JELAMBAR, GROGOL PETAMBURAN, JAKARTA BARAT, DKI JAKARTA",11,192,13,205
https://kawalpemilu.org#25936,"JELAMBAR, GROGOL PETAMBURAN, JAKARTA BARAT, DKI JAKARTA",12,122,83,205
https://kawalpemilu.org#25936,"JELAMBAR, GROGOL PETAMBURAN, JAKARTA BARAT, DKI JAKARTA",13,125,73,198
https://kawalpemilu.org#25936,"JELAMBAR, GROGOL PETAMBURAN, JAKARTA BARAT, DKI JAKARTA",14,104,87,191
https://kawalpemilu.org#25936,"JELAMBAR, GROGOL PETAMBURAN, JAKARTA BARAT, DKI JAKARTA",15,102,89,191
https://kawalpemilu.org#25936,"JELAMBAR, GROGOL PETAMBURAN, JAKARTA BARAT, DKI JAKARTA",16,116,70,186
https://kawalpemilu.org#25936,"JELAMBAR, GROGOL PETAMBURAN, JAKARTA BARAT, DKI JAKARTA",17,159,80,239
https://kawalpemilu.org#25936,"JELAMBAR, GROGOL PETAMBURAN, JAKARTA BARAT, DKI JAKARTA",18,180,44,244
https://kawalpemilu.org#25936,"JELAMBAR, GROGOL PETAMBURAN, JAKARTA BARAT, DKI JAKARTA",19,141,77,218
https://kawalpemilu.org#25936,"JELAMBAR, GROGOL PETAMBURAN, JAKARTA BARAT, DKI JAKARTA",20,186,32,218
https://kawalpemilu.org#25936,"JELAMBAR, GROGOL PETAMBURAN, JAKARTA BARAT, DKI JAKARTA",21,163,66,229
https://kawalpemilu.org#25936,"JELAMBAR, GROGOL PETAMBURAN, JAKARTA BARAT, DKI JAKARTA",22,158,59,217
https://kawalpemilu.org#25936,"JELAMBAR, GROGOL PETAMBURAN, JAKARTA BARAT, DKI JAKARTA",23,174,48,222
https://kawalpemilu.org#25936,"JELAMBAR, GROGOL PETAMBURAN, JAKARTA BARAT, DKI JAKARTA",24,179,64,243
https://kawalpemilu.org#25936,"JELAMBAR, GROGOL PETAMBURAN, JAKARTA BARAT, DKI JAKARTA",25,130,125,255
https://kawalpemilu.org#25936,"JELAMBAR, GROGOL PETAMBURAN, JAKARTA BARAT, DKI JAKARTA",26,80,165,245
https://kawalpemilu.org#25936,"JELAMBAR, GROGOL PETAMBURAN, JAKARTA BARAT, DKI JAKARTA",27,226,22,248
https://kawalpemilu.org#25936,"JELAMBAR, GROGOL PETAMBURAN, JAKARTA BARAT, DKI JAKARTA",28,195,29,0
https://kawalpemilu.org#25936,"JELAMBAR, GROGOL PETAMBURAN, JAKARTA BARAT, DKI JAKARTA",29,178,45,225
https://kawalpemilu.org#25936,"JELAMBAR, GROGOL PETAMBURAN, JAKARTA BARAT, DKI JAKARTA",30,108,129,237
https://kawalpemilu.org#25936,"JELAMBAR, GROGOL PETAMBURAN, JAKARTA BARAT, DKI JAKARTA",31,120,90,210
https://kawalpemilu.org#25936,"JELAMBAR, GROGOL PETAMBURAN, JAKARTA BARAT, DKI JAKARTA",32,161,76,237
https://kawalpemilu.org#25936,"JELAMBAR, GROGOL PETAMBURAN, JAKARTA BARAT, DKI JAKARTA",33,182,80,262
https://kawalpemilu.org#25936,"JELAMBAR, GROGOL PETAMBURAN, JAKARTA BARAT, DKI JAKARTA",34,183,69,252
https://kawalpemilu.org#25936,"JELAMBAR, GROGOL PETAMBURAN, JAKARTA BARAT, DKI JAKARTA",35,168,89,257
https://kawalpemilu.org#25936,"JELAMBAR, GROGOL PETAMBURAN, JAKARTA BARAT, DKI JAKARTA",36,170,68,238
https://kawalpemilu.org#25936,"JELAMBAR, GROGOL PETAMBURAN, JAKARTA BARAT, DKI JAKARTA",37,185,65,250
https://kawalpemilu.org#25936,"JELAMBAR, GROGOL PETAMBURAN, JAKARTA BARAT, DKI JAKARTA",38,125,125,250
https://kawalpemilu.org#25936,"JELAMBAR, GROGOL PETAMBURAN, JAKARTA BARAT, DKI JAKARTA",40,147,63,210
https://kawalpemilu.org#25936,"JELAMBAR, GROGOL PETAMBURAN, JAKARTA BARAT, DKI JAKARTA",41,166,68,234
https://kawalpemilu.org#25936,"JELAMBAR, GROGOL PETAMBURAN, JAKARTA BARAT, DKI JAKARTA",42,145,87,232
https://kawalpemilu.org#25936,"JELAMBAR, GROGOL PETAMBURAN, JAKARTA BARAT, DKI JAKARTA",43,138,72,210
https://kawalpemilu.org#25936,"JELAMBAR, GROGOL PETAMBURAN, JAKARTA BARAT, DKI JAKARTA",44,139,78,217
https://kawalpemilu.org#25936,"JELAMBAR, GROGOL PETAMBURAN, JAKARTA BARAT, DKI JAKARTA",45,150,77,227
https://kawalpemilu.org#25936,"JELAMBAR, GROGOL PETAMBURAN, JAKARTA BARAT, DKI JAKARTA",46,157,70,227
https://kawalpemilu.org#25936,"JELAMBAR, GROGOL PETAMBURAN, JAKARTA BARAT, DKI JAKARTA",47,154,79,233
https://kawalpemilu.org#25936,"JELAMBAR, GROGOL PETAMBURAN, JAKARTA BARAT, DKI JAKARTA",48,198,60,258
https://kawalpemilu.org#25936,"JELAMBAR, GROGOL PETAMBURAN, JAKARTA BARAT, DKI JAKARTA",49,175,71,246
https://kawalpemilu.org#25936,"JELAMBAR, GROGOL PETAMBURAN, JAKARTA BARAT, DKI JAKARTA",50,189,64,253
https://kawalpemilu.org#25936,"JELAMBAR, GROGOL PETAMBURAN, JAKARTA BARAT, DKI JAKARTA",51,160,107,267
https://kawalpemilu.org#25936,"JELAMBAR, GROGOL PETAMBURAN, JAKARTA BARAT, DKI JAKARTA",52,207,29,236
https://kawalpemilu.org#25936,"JELAMBAR, GROGOL PETAMBURAN, JAKARTA BARAT, DKI JAKARTA",53,212,17,229
https://kawalpemilu.org#25936,"JELAMBAR, GROGOL PETAMBURAN, JAKARTA BARAT, DKI JAKARTA",54,218,19,237
https://kawalpemilu.org#25936,"JELAMBAR, GROGOL PETAMBURAN, JAKARTA BARAT, DKI JAKARTA",55,237,19,256
https://kawalpemilu.org#25936,"JELAMBAR, GROGOL PETAMBURAN, JAKARTA BARAT, DKI JAKARTA",56,189,19,208
https://kawalpemilu.org#25936,"JELAMBAR, GROGOL PETAMBURAN, JAKARTA BARAT, DKI JAKARTA",57,151,33,184
https://kawalpemilu.org#25936,"JELAMBAR, GROGOL PETAMBURAN, JAKARTA BARAT, DKI JAKARTA",58,174,9,183
https://kawalpemilu.org#25936,"JELAMBAR, GROGOL PETAMBURAN, JAKARTA BARAT, DKI JAKARTA",59,171,79,250
https://kawalpemilu.org#25936,"JELAMBAR, GROGOL PETAMBURAN, JAKARTA BARAT, DKI JAKARTA",60,170,36,206
https://kawalpemilu.org#25936,"JELAMBAR, GROGOL PETAMBURAN, JAKARTA BARAT, DKI JAKARTA",61,169,35,204
https://kawalpemilu.org#25936,"JELAMBAR, GROGOL PETAMBURAN, JAKARTA BARAT, DKI JAKARTA",62,157,74,231
https://kawalpemilu.org#25936,"JELAMBAR, GROGOL PETAMBURAN, JAKARTA BARAT, DKI JAKARTA",63,112,88,200
https://kawalpemilu.org#25936,"JELAMBAR, GROGOL PETAMBURAN, JAKARTA BARAT, DKI JAKARTA",64,95,116,211
https://kawalpemilu.org#25936,"JELAMBAR, GROGOL PETAMBURAN, JAKARTA BARAT, DKI JAKARTA",65,136,93,229
https://kawalpemilu.org#25936,"JELAMBAR, GROGOL PETAMBURAN, JAKARTA BARAT, DKI JAKARTA",66,140,90,230
https://kawalpemilu.org#25936,"JELAMBAR, GROGOL PETAMBURAN, JAKARTA BARAT, DKI JAKARTA",67,116,109,225
https://kawalpemilu.org#25936,"JELAMBAR, GROGOL PETAMBURAN, JAKARTA BARAT, DKI JAKARTA",68,114,118,232
https://kawalpemilu.org#25936,"JELAMBAR, GROGOL PETAMBURAN, JAKARTA BARAT, DKI JAKARTA",69,155,64,219
https://kawalpemilu.org#25936,"JELAMBAR, GROGOL PETAMBURAN, JAKARTA BARAT, DKI JAKARTA",70,160,74,234
https://kawalpemilu.org#25936,"JELAMBAR, GROGOL PETAMBURAN, JAKARTA BARAT, DKI JAKARTA",71,136,129,265
https://kawalpemilu.org#25936,"JELAMBAR, GROGOL PETAMBURAN, JAKARTA BARAT, DKI JAKARTA",72,120,108,228
https://kawalpemilu.org#25936,"JELAMBAR, GROGOL PETAMBURAN, JAKARTA BARAT, DKI JAKARTA",73,99,126,225
https://kawalpemilu.org#25936,"JELAMBAR, GROGOL PETAMBURAN, JAKARTA BARAT, DKI JAKARTA",74,97,99,196
https://kawalpemilu.org#25936,"JELAMBAR, GROGOL PETAMBURAN, JAKARTA BARAT, DKI JAKARTA",75,114,98,212
https://kawalpemilu.org#25936,"JELAMBAR, GROGOL PETAMBURAN, JAKARTA BARAT, DKI JAKARTA",76,238,4,242
https://kawalpemilu.org#25936,"JELAMBAR, GROGOL PETAMBURAN, JAKARTA BARAT, DKI JAKARTA",77,247,5,252
https://kawalpemilu.org#25936,"JELAMBAR, GROGOL PETAMBURAN, JAKARTA BARAT, DKI JAKARTA",78,227,15,1
https://kawalpemilu.org#25936,"JELAMBAR, GROGOL PETAMBURAN, JAKARTA BARAT, DKI JAKARTA",79,195,26,221
https://kawalpemilu.org#25936,"JELAMBAR, GROGOL PETAMBURAN, JAKARTA BARAT, DKI JAKARTA",80,240,5,245
https://kawalpemilu.org#25936,"JELAMBAR, GROGOL PETAMBURAN, JAKARTA BARAT, DKI JAKARTA",81,245,10,255
https://kawalpemilu.org#25936,"JELAMBAR, GROGOL PETAMBURAN, JAKARTA BARAT, DKI JAKARTA",82,219,9,228
https://kawalpemilu.org#25936,"JELAMBAR, GROGOL PETAMBURAN, JAKARTA BARAT, DKI JAKARTA",84,143,52,195
https://kawalpemilu.org#25936,"JELAMBAR, GROGOL PETAMBURAN, JAKARTA BARAT, DKI JAKARTA",85,223,34,257
https://kawalpemilu.org#25936,"JELAMBAR, GROGOL PETAMBURAN, JAKARTA BARAT, DKI JAKARTA",86,188,28,216
https://kawalpemilu.org#25936,"JELAMBAR, GROGOL PETAMBURAN, JAKARTA BARAT, DKI JAKARTA",87,214,18,232
https://kawalpemilu.org#25936,"JELAMBAR, GROGOL PETAMBURAN, JAKARTA BARAT, DKI JAKARTA",88,175,7,182
https://kawalpemilu.org#25936,"JELAMBAR, GROGOL PETAMBURAN, JAKARTA BARAT, DKI JAKARTA",89,204,44,248
https://kawalpemilu.org#25936,"JELAMBAR, GROGOL PETAMBURAN, JAKARTA BARAT, DKI JAKARTA",90,198,48,246
https://kawalpemilu.org#25936,"JELAMBAR, GROGOL PETAMBURAN, JAKARTA BARAT, DKI JAKARTA",91,178,60,238
https://kawalpemilu.org#25936,"JELAMBAR, GROGOL PETAMBURAN, JAKARTA BARAT, DKI JAKARTA",92,160,73,233
https://kawalpemilu.org#25936,"JELAMBAR, GROGOL PETAMBURAN, JAKARTA BARAT, DKI JAKARTA",93,185,59,244
https://kawalpemilu.org#25936,"JELAMBAR, GROGOL PETAMBURAN, JAKARTA BARAT, DKI JAKARTA",94,144,63,207
https://kawalpemilu.org#25936,"JELAMBAR, GROGOL PETAMBURAN, JAKARTA BARAT, DKI JAKARTA",95,154,67,221
https://kawalpemilu.org#25936,"JELAMBAR, GROGOL PETAMBURAN, JAKARTA BARAT, DKI JAKARTA",96,144,61,205
https://kawalpemilu.org#25937,"TANJUNG DUREN SELATAN, GROGOL PETAMBURAN, JAKARTA BARAT, DKI JAKARTA",1,149,91,240
https://kawalpemilu.org#25937,"TANJUNG DUREN SELATAN, GROGOL PETAMBURAN, JAKARTA BARAT, DKI JAKARTA",2,84,155,239
https://kawalpemilu.org#25937,"TANJUNG DUREN SELATAN, GROGOL PETAMBURAN, JAKARTA BARAT, DKI JAKARTA",3,141,70,211
https://kawalpemilu.org#25937,"TANJUNG DUREN SELATAN, GROGOL PETAMBURAN, JAKARTA BARAT, DKI JAKARTA",4,131,112,243
https://kawalpemilu.org#25937,"TANJUNG DUREN SELATAN, GROGOL PETAMBURAN, JAKARTA BARAT, DKI JAKARTA",5,139,116,255
https://kawalpemilu.org#25937,"TANJUNG DUREN SELATAN, GROGOL PETAMBURAN, JAKARTA BARAT, DKI JAKARTA",6,98,123,221
https://kawalpemilu.org#25937,"TANJUNG DUREN SELATAN, GROGOL PETAMBURAN, JAKARTA BARAT, DKI JAKARTA",7,103,144,247
https://kawalpemilu.org#25937,"TANJUNG DUREN SELATAN, GROGOL PETAMBURAN, JAKARTA BARAT, DKI JAKARTA",8,124,108,232
https://kawalpemilu.org#25937,"TANJUNG DUREN SELATAN, GROGOL PETAMBURAN, JAKARTA BARAT, DKI JAKARTA",9,111,134,245
https://kawalpemilu.org#25937,"TANJUNG DUREN SELATAN, GROGOL PETAMBURAN, JAKARTA BARAT, DKI JAKARTA",10,133,93,226
https://kawalpemilu.org#25937,"TANJUNG DUREN SELATAN, GROGOL PETAMBURAN, JAKARTA BARAT, DKI JAKARTA",11,126,111,237
https://kawalpemilu.org#25937,"TANJUNG DUREN SELATAN, GROGOL PETAMBURAN, JAKARTA BARAT, DKI JAKARTA",12,74,132,206
https://kawalpemilu.org#25937,"TANJUNG DUREN SELATAN, GROGOL PETAMBURAN, JAKARTA BARAT, DKI JAKARTA",13,126,133,259
https://kawalpemilu.org#25937,"TANJUNG DUREN SELATAN, GROGOL PETAMBURAN, JAKARTA BARAT, DKI JAKARTA",14,99,123,222
https://kawalpemilu.org#25937,"TANJUNG DUREN SELATAN, GROGOL PETAMBURAN, JAKARTA BARAT, DKI JAKARTA",15,103,146,249
https://kawalpemilu.org#25937,"TANJUNG DUREN SELATAN, GROGOL PETAMBURAN, JAKARTA BARAT, DKI JAKARTA",16,188,30,218
https://kawalpemilu.org#25937,"TANJUNG DUREN SELATAN, GROGOL PETAMBURAN, JAKARTA BARAT, DKI JAKARTA",17,160,61,221
https://kawalpemilu.org#25937,"TANJUNG DUREN SELATAN, GROGOL PETAMBURAN, JAKARTA BARAT, DKI JAKARTA",18,177,68,245
https://kawalpemilu.org#25937,"TANJUNG DUREN SELATAN, GROGOL PETAMBURAN, JAKARTA BARAT, DKI JAKARTA",19,150,50,200
https://kawalpemilu.org#25937,"TANJUNG DUREN SELATAN, GROGOL PETAMBURAN, JAKARTA BARAT, DKI JAKARTA",20,193,36,229
https://kawalpemilu.org#25937,"TANJUNG DUREN SELATAN, GROGOL PETAMBURAN, JAKARTA BARAT, DKI JAKARTA",21,170,41,211
https://kawalpemilu.org#25937,"TANJUNG DUREN SELATAN, GROGOL PETAMBURAN, JAKARTA BARAT, DKI JAKARTA",22,151,45,196
https://kawalpemilu.org#25937,"TANJUNG DUREN SELATAN, GROGOL PETAMBURAN, JAKARTA BARAT, DKI JAKARTA",23,172,38,210
https://kawalpemilu.org#25937,"TANJUNG DUREN SELATAN, GROGOL PETAMBURAN, JAKARTA BARAT, DKI JAKARTA",24,181,54,235
https://kawalpemilu.org#25937,"TANJUNG DUREN SELATAN, GROGOL PETAMBURAN, JAKARTA BARAT, DKI JAKARTA",25,170,58,228
https://kawalpemilu.org#25937,"TANJUNG DUREN SELATAN, GROGOL PETAMBURAN, JAKARTA BARAT, DKI JAKARTA",26,162,29,191
https://kawalpemilu.org#25937,"TANJUNG DUREN SELATAN, GROGOL PETAMBURAN, JAKARTA BARAT, DKI JAKARTA",27,186,32,218
https://kawalpemilu.org#25937,"TANJUNG DUREN SELATAN, GROGOL PETAMBURAN, JAKARTA BARAT, DKI JAKARTA",28,171,48,219
https://kawalpemilu.org#25937,"TANJUNG DUREN SELATAN, GROGOL PETAMBURAN, JAKARTA BARAT, DKI JAKARTA",29,161,34,195
https://kawalpemilu.org#25937,"TANJUNG DUREN SELATAN, GROGOL PETAMBURAN, JAKARTA BARAT, DKI JAKARTA",30,165,47,212
https://kawalpemilu.org#25937,"TANJUNG DUREN SELATAN, GROGOL PETAMBURAN, JAKARTA BARAT, DKI JAKARTA",31,149,107,256
https://kawalpemilu.org#25937,"TANJUNG DUREN SELATAN, GROGOL PETAMBURAN, JAKARTA BARAT, DKI JAKARTA",32,184,58,242
https://kawalpemilu.org#25937,"TANJUNG DUREN SELATAN, GROGOL PETAMBURAN, JAKARTA BARAT, DKI JAKARTA",33,132,110,242
https://kawalpemilu.org#25937,"TANJUNG DUREN SELATAN, GROGOL PETAMBURAN, JAKARTA BARAT, DKI JAKARTA",34,152,76,228
https://kawalpemilu.org#25937,"TANJUNG DUREN SELATAN, GROGOL PETAMBURAN, JAKARTA BARAT, DKI JAKARTA",35,165,46,211
https://kawalpemilu.org#25937,"TANJUNG DUREN SELATAN, GROGOL PETAMBURAN, JAKARTA BARAT, DKI JAKARTA",36,172,61,233
https://kawalpemilu.org#25937,"TANJUNG DUREN SELATAN, GROGOL PETAMBURAN, JAKARTA BARAT, DKI JAKARTA",37,174,38,212
https://kawalpemilu.org#25937,"TANJUNG DUREN SELATAN, GROGOL PETAMBURAN, JAKARTA BARAT, DKI JAKARTA",38,148,53,201
https://kawalpemilu.org#25937,"TANJUNG DUREN SELATAN, GROGOL PETAMBURAN, JAKARTA BARAT, DKI JAKARTA",39,132,86,218
https://kawalpemilu.org#25937,"TANJUNG DUREN SELATAN, GROGOL PETAMBURAN, JAKARTA BARAT, DKI JAKARTA",40,168,63,231
https://kawalpemilu.org#25937,"TANJUNG DUREN SELATAN, GROGOL PETAMBURAN, JAKARTA BARAT, DKI JAKARTA",41,172,52,224
https://kawalpemilu.org#25937,"TANJUNG DUREN SELATAN, GROGOL PETAMBURAN, JAKARTA BARAT, DKI JAKARTA",42,129,102,231
https://kawalpemilu.org#25937,"TANJUNG DUREN SELATAN, GROGOL PETAMBURAN, JAKARTA BARAT, DKI JAKARTA",43,182,33,215
https://kawalpemilu.org#25937,"TANJUNG DUREN SELATAN, GROGOL PETAMBURAN, JAKARTA BARAT, DKI JAKARTA",44,160,41,201
https://kawalpemilu.org#25937,"TANJUNG DUREN SELATAN, GROGOL PETAMBURAN, JAKARTA BARAT, DKI JAKARTA",45,116,135,251
https://kawalpemilu.org#25937,"TANJUNG DUREN SELATAN, GROGOL PETAMBURAN, JAKARTA BARAT, DKI JAKARTA",46,122,89,211
https://kawalpemilu.org#25937,"TANJUNG DUREN SELATAN, GROGOL PETAMBURAN, JAKARTA BARAT, DKI JAKARTA",47,217,14,231
https://kawalpemilu.org#25937,"TANJUNG DUREN SELATAN, GROGOL PETAMBURAN, JAKARTA BARAT, DKI JAKARTA",48,166,66,232
https://kawalpemilu.org#25937,"TANJUNG DUREN SELATAN, GROGOL PETAMBURAN, JAKARTA BARAT, DKI JAKARTA",49,208,19,227
https://kawalpemilu.org#25937,"TANJUNG DUREN SELATAN, GROGOL PETAMBURAN, JAKARTA BARAT, DKI JAKARTA",50,136,103,239
https://kawalpemilu.org#25937,"TANJUNG DUREN SELATAN, GROGOL PETAMBURAN, JAKARTA BARAT, DKI JAKARTA",51,102,127,229
https://kawalpemilu.org#25937,"TANJUNG DUREN SELATAN, GROGOL PETAMBURAN, JAKARTA BARAT, DKI JAKARTA",52,70,178,248
https://kawalpemilu.org#25937,"TANJUNG DUREN SELATAN, GROGOL PETAMBURAN, JAKARTA BARAT, DKI JAKARTA",53,95,122,217
https://kawalpemilu.org#25937,"TANJUNG DUREN SELATAN, GROGOL PETAMBURAN, JAKARTA BARAT, DKI JAKARTA",54,73,118,191
https://kawalpemilu.org#25937,"TANJUNG DUREN SELATAN, GROGOL PETAMBURAN, JAKARTA BARAT, DKI JAKARTA",55,57,181,238
https://kawalpemilu.org#25937,"TANJUNG DUREN SELATAN, GROGOL PETAMBURAN, JAKARTA BARAT, DKI JAKARTA",56,79,156,235
https://kawalpemilu.org#25937,"TANJUNG DUREN SELATAN, GROGOL PETAMBURAN, JAKARTA BARAT, DKI JAKARTA",57,86,155,241
https://kawalpemilu.org#25937,"TANJUNG DUREN SELATAN, GROGOL PETAMBURAN, JAKARTA BARAT, DKI JAKARTA",58,85,104,189
https://kawalpemilu.org#25937,"TANJUNG DUREN SELATAN, GROGOL PETAMBURAN, JAKARTA BARAT, DKI JAKARTA",59,110,83,193
https://kawalpemilu.org#25937,"TANJUNG DUREN SELATAN, GROGOL PETAMBURAN, JAKARTA BARAT, DKI JAKARTA",60,117,98,215
https://kawalpemilu.org#25937,"TANJUNG DUREN SELATAN, GROGOL PETAMBURAN, JAKARTA BARAT, DKI JAKARTA",61,144,75,219
https://kawalpemilu.org#25937,"TANJUNG DUREN SELATAN, GROGOL PETAMBURAN, JAKARTA BARAT, DKI JAKARTA",62,69,137,233
https://kawalpemilu.org#25937,"TANJUNG DUREN SELATAN, GROGOL PETAMBURAN, JAKARTA BARAT, DKI JAKARTA",63,101,97,198
https://kawalpemilu.org#25937,"TANJUNG DUREN SELATAN, GROGOL PETAMBURAN, JAKARTA BARAT, DKI JAKARTA",64,129,77,206
https://kawalpemilu.org#25937,"TANJUNG DUREN SELATAN, GROGOL PETAMBURAN, JAKARTA BARAT, DKI JAKARTA",65,75,136,211
https://kawalpemilu.org#25937,"TANJUNG DUREN SELATAN, GROGOL PETAMBURAN, JAKARTA BARAT, DKI JAKARTA",66,90,91,181
https://kawalpemilu.org#25937,"TANJUNG DUREN SELATAN, GROGOL PETAMBURAN, JAKARTA BARAT, DKI JAKARTA",67,108,116,224
https://kawalpemilu.org#25937,"TANJUNG DUREN SELATAN, GROGOL PETAMBURAN, JAKARTA BARAT, DKI JAKARTA",68,125,124,249
https://kawalpemilu.org#25937,"TANJUNG DUREN SELATAN, GROGOL PETAMBURAN, JAKARTA BARAT, DKI JAKARTA",69,169,9,178
https://kawalpemilu.org#25937,"TANJUNG DUREN SELATAN, GROGOL PETAMBURAN, JAKARTA BARAT, DKI JAKARTA",70,190,12,202
https://kawalpemilu.org#25937,"TANJUNG DUREN SELATAN, GROGOL PETAMBURAN, JAKARTA BARAT, DKI JAKARTA",71,190,10,200
https://kawalpemilu.org#25937,"TANJUNG DUREN SELATAN, GROGOL PETAMBURAN, JAKARTA BARAT, DKI JAKARTA",72,178,7,185
https://kawalpemilu.org#25937,"TANJUNG DUREN SELATAN, GROGOL PETAMBURAN, JAKARTA BARAT, DKI JAKARTA",73,207,11,218
https://kawalpemilu.org#25937,"TANJUNG DUREN SELATAN, GROGOL PETAMBURAN, JAKARTA BARAT, DKI JAKARTA",74,199,10,209
https://kawalpemilu.org#25937,"TANJUNG DUREN SELATAN, GROGOL PETAMBURAN, JAKARTA BARAT, DKI JAKARTA",75,228,16,244
https://kawalpemilu.org#25937,"TANJUNG DUREN SELATAN, GROGOL PETAMBURAN, JAKARTA BARAT, DKI JAKARTA",76,229,8,237
https://kawalpemilu.org#25937,"TANJUNG DUREN SELATAN, GROGOL PETAMBURAN, JAKARTA BARAT, DKI JAKARTA",77,225,8,233
https://kawalpemilu.org#25937,"TANJUNG DUREN SELATAN, GROGOL PETAMBURAN, JAKARTA BARAT, DKI JAKARTA",78,193,13,206
https://kawalpemilu.org#25937,"TANJUNG DUREN SELATAN, GROGOL PETAMBURAN, JAKARTA BARAT, DKI JAKARTA",79,200,3,203
https://kawalpemilu.org#25937,"TANJUNG DUREN SELATAN, GROGOL PETAMBURAN, JAKARTA BARAT, DKI JAKARTA",80,219,19,238
https://kawalpemilu.org#25937,"TANJUNG DUREN SELATAN, GROGOL PETAMBURAN, JAKARTA BARAT, DKI JAKARTA",81,214,10,224
https://kawalpemilu.org#25937,"TANJUNG DUREN SELATAN, GROGOL PETAMBURAN, JAKARTA BARAT, DKI JAKARTA",82,219,3,222
https://kawalpemilu.org#25937,"TANJUNG DUREN SELATAN, GROGOL PETAMBURAN, JAKARTA BARAT, DKI JAKARTA",83,200,13,213
https://kawalpemilu.org#25937,"TANJUNG DUREN SELATAN, GROGOL PETAMBURAN, JAKARTA BARAT, DKI JAKARTA",84,197,7,204
https://kawalpemilu.org#25938,"JELAMBAR BARU, GROGOL PETAMBURAN, JAKARTA BARAT, DKI JAKARTA",1,139,98,237
https://kawalpemilu.org#25938,"JELAMBAR BARU, GROGOL PETAMBURAN, JAKARTA BARAT, DKI JAKARTA",2,227,22,249
https://kawalpemilu.org#25938,"JELAMBAR BARU, GROGOL PETAMBURAN, JAKARTA BARAT, DKI JAKARTA",3,149,72,221
https://kawalpemilu.org#25938,"JELAMBAR BARU, GROGOL PETAMBURAN, JAKARTA BARAT, DKI JAKARTA",4,173,57,230
https://kawalpemilu.org#25938,"JELAMBAR BARU, GROGOL PETAMBURAN, JAKARTA BARAT, DKI JAKARTA",5,162,81,243
https://kawalpemilu.org#25938,"JELAMBAR BARU, GROGOL PETAMBURAN, JAKARTA BARAT, DKI JAKARTA",6,133,96,229
https://kawalpemilu.org#25938,"JELAMBAR BARU, GROGOL PETAMBURAN, JAKARTA BARAT, DKI JAKARTA",7,189,50,239
https://kawalpemilu.org#25938,"JELAMBAR BARU, GROGOL PETAMBURAN, JAKARTA BARAT, DKI JAKARTA",8,216,35,251
https://kawalpemilu.org#25938,"JELAMBAR BARU, GROGOL PETAMBURAN, JAKARTA BARAT, DKI JAKARTA",9,196,41,237
https://kawalpemilu.org#25938,"JELAMBAR BARU, GROGOL PETAMBURAN, JAKARTA BARAT, DKI JAKARTA",10,179,80,259
https://kawalpemilu.org#25938,"JELAMBAR BARU, GROGOL PETAMBURAN, JAKARTA BARAT, DKI JAKARTA",11,188,83,271
https://kawalpemilu.org#25938,"JELAMBAR BARU, GROGOL PETAMBURAN, JAKARTA BARAT, DKI JAKARTA",12,193,32,225
https://kawalpemilu.org#25938,"JELAMBAR BARU, GROGOL PETAMBURAN, JAKARTA BARAT, DKI JAKARTA",13,128,97,225
https://kawalpemilu.org#25938,"JELAMBAR BARU, GROGOL PETAMBURAN, JAKARTA BARAT, DKI JAKARTA",14,141,22,163
https://kawalpemilu.org#25938,"JELAMBAR BARU, GROGOL PETAMBURAN, JAKARTA BARAT, DKI JAKARTA",15,163,35,198
https://kawalpemilu.org#25938,"JELAMBAR BARU, GROGOL PETAMBURAN, JAKARTA BARAT, DKI JAKARTA",16,139,23,162
https://kawalpemilu.org#25938,"JELAMBAR BARU, GROGOL PETAMBURAN, JAKARTA BARAT, DKI JAKARTA",17,181,54,235
https://kawalpemilu.org#25938,"JELAMBAR BARU, GROGOL PETAMBURAN, JAKARTA BARAT, DKI JAKARTA",18,167,80,247
https://kawalpemilu.org#25938,"JELAMBAR BARU, GROGOL PETAMBURAN, JAKARTA BARAT, DKI JAKARTA",19,213,25,238
https://kawalpemilu.org#25938,"JELAMBAR BARU, GROGOL PETAMBURAN, JAKARTA BARAT, DKI JAKARTA",20,223,14,237
https://kawalpemilu.org#25938,"JELAMBAR BARU, GROGOL PETAMBURAN, JAKARTA BARAT, DKI JAKARTA",21,207,16,223
https://kawalpemilu.org#25938,"JELAMBAR BARU, GROGOL PETAMBURAN, JAKARTA BARAT, DKI JAKARTA",22,241,13,254
https://kawalpemilu.org#25938,"JELAMBAR BARU, GROGOL PETAMBURAN, JAKARTA BARAT, DKI JAKARTA",23,211,27,238
https://kawalpemilu.org#25938,"JELAMBAR BARU, GROGOL PETAMBURAN, JAKARTA BARAT, DKI JAKARTA",24,192,44,236
https://kawalpemilu.org#25938,"JELAMBAR BARU, GROGOL PETAMBURAN, JAKARTA BARAT, DKI JAKARTA",25,194,36,230
https://kawalpemilu.org#25938,"JELAMBAR BARU, GROGOL PETAMBURAN, JAKARTA BARAT, DKI JAKARTA",26,217,34,251
https://kawalpemilu.org#25938,"JELAMBAR BARU, GROGOL PETAMBURAN, JAKARTA BARAT, DKI JAKARTA",27,218,15,233
https://kawalpemilu.org#25938,"JELAMBAR BARU, GROGOL PETAMBURAN, JAKARTA BARAT, DKI JAKARTA",28,192,32,224
https://kawalpemilu.org#25938,"JELAMBAR BARU, GROGOL PETAMBURAN, JAKARTA BARAT, DKI JAKARTA",29,188,18,206
https://kawalpemilu.org#25938,"JELAMBAR BARU, GROGOL PETAMBURAN, JAKARTA BARAT, DKI JAKARTA",30,186,25,211
https://kawalpemilu.org#25938,"JELAMBAR BARU, GROGOL PETAMBURAN, JAKARTA BARAT, DKI JAKARTA",31,215,28,243
https://kawalpemilu.org#25938,"JELAMBAR BARU, GROGOL PETAMBURAN, JAKARTA BARAT, DKI JAKARTA",32,226,27,253
https://kawalpemilu.org#25938,"JELAMBAR BARU, GROGOL PETAMBURAN, JAKARTA BARAT, DKI JAKARTA",33,215,24,239
https://kawalpemilu.org#25938,"JELAMBAR BARU, GROGOL PETAMBURAN, JAKARTA BARAT, DKI JAKARTA",34,172,57,229
https://kawalpemilu.org#25938,"JELAMBAR BARU, GROGOL PETAMBURAN, JAKARTA BARAT, DKI JAKARTA",35,220,19,239
https://kawalpemilu.org#25938,"JELAMBAR BARU, GROGOL PETAMBURAN, JAKARTA BARAT, DKI JAKARTA",36,236,18,254
https://kawalpemilu.org#25938,"JELAMBAR BARU, GROGOL PETAMBURAN, JAKARTA BARAT, DKI JAKARTA",37,154,59,213
https://kawalpemilu.org#25938,"JELAMBAR BARU, GROGOL PETAMBURAN, JAKARTA BARAT, DKI JAKARTA",38,178,30,208
https://kawalpemilu.org#25938,"JELAMBAR BARU, GROGOL PETAMBURAN, JAKARTA BARAT, DKI JAKARTA",39,158,34,192
https://kawalpemilu.org#25938,"JELAMBAR BARU, GROGOL PETAMBURAN, JAKARTA BARAT, DKI JAKARTA",40,145,50,195
https://kawalpemilu.org#25938,"JELAMBAR BARU, GROGOL PETAMBURAN, JAKARTA BARAT, DKI JAKARTA",41,152,55,207
https://kawalpemilu.org#25938,"JELAMBAR BARU, GROGOL PETAMBURAN, JAKARTA BARAT, DKI JAKARTA",42,161,82,243
https://kawalpemilu.org#25938,"JELAMBAR BARU, GROGOL PETAMBURAN, JAKARTA BARAT, DKI JAKARTA",43,176,83,259
https://kawalpemilu.org#25938,"JELAMBAR BARU, GROGOL PETAMBURAN, JAKARTA BARAT, DKI JAKARTA",44,125,127,252
https://kawalpemilu.org#25938,"JELAMBAR BARU, GROGOL PETAMBURAN, JAKARTA BARAT, DKI JAKARTA",45,126,114,240
https://kawalpemilu.org#25938,"JELAMBAR BARU, GROGOL PETAMBURAN, JAKARTA BARAT, DKI JAKARTA",46,150,94,244
https://kawalpemilu.org#25938,"JELAMBAR BARU, GROGOL PETAMBURAN, JAKARTA BARAT, DKI JAKARTA",47,177,52,229
https://kawalpemilu.org#25938,"JELAMBAR BARU, GROGOL PETAMBURAN, JAKARTA BARAT, DKI JAKARTA",48,105,101,206
https://kawalpemilu.org#25938,"JELAMBAR BARU, GROGOL PETAMBURAN, JAKARTA BARAT, DKI JAKARTA",49,218,7,225
https://kawalpemilu.org#25938,"JELAMBAR BARU, GROGOL PETAMBURAN, JAKARTA BARAT, DKI JAKARTA",50,227,7,234
https://kawalpemilu.org#25938,"JELAMBAR BARU, GROGOL PETAMBURAN, JAKARTA BARAT, DKI JAKARTA",51,236,2,238
https://kawalpemilu.org#25938,"JELAMBAR BARU, GROGOL PETAMBURAN, JAKARTA BARAT, DKI JAKARTA",52,230,0,230
https://kawalpemilu.org#25938,"JELAMBAR BARU, GROGOL PETAMBURAN, JAKARTA BARAT, DKI JAKARTA",53,226,2,228
https://kawalpemilu.org#25938,"JELAMBAR BARU, GROGOL PETAMBURAN, JAKARTA BARAT, DKI JAKARTA",54,225,5,230
https://kawalpemilu.org#25938,"JELAMBAR BARU, GROGOL PETAMBURAN, JAKARTA BARAT, DKI JAKARTA",55,225,33,258
https://kawalpemilu.org#25938,"JELAMBAR BARU, GROGOL PETAMBURAN, JAKARTA BARAT, DKI JAKARTA",56,171,35,206
https://kawalpemilu.org#25938,"JELAMBAR BARU, GROGOL PETAMBURAN, JAKARTA BARAT, DKI JAKARTA",57,208,35,243
https://kawalpemilu.org#25938,"JELAMBAR BARU, GROGOL PETAMBURAN, JAKARTA BARAT, DKI JAKARTA",58,190,49,239
https://kawalpemilu.org#25938,"JELAMBAR BARU, GROGOL PETAMBURAN, JAKARTA BARAT, DKI JAKARTA",59,180,61,241
https://kawalpemilu.org#25938,"JELAMBAR BARU, GROGOL PETAMBURAN, JAKARTA BARAT, DKI JAKARTA",60,200,62,262
https://kawalpemilu.org#25938,"JELAMBAR BARU, GROGOL PETAMBURAN, JAKARTA BARAT, DKI JAKARTA",61,168,38,206
https://kawalpemilu.org#25938,"JELAMBAR BARU, GROGOL PETAMBURAN, JAKARTA BARAT, DKI JAKARTA",62,197,41,238
https://kawalpemilu.org#25938,"JELAMBAR BARU, GROGOL PETAMBURAN, JAKARTA BARAT, DKI JAKARTA",63,186,35,221
https://kawalpemilu.org#25938,"JELAMBAR BARU, GROGOL PETAMBURAN, JAKARTA BARAT, DKI JAKARTA",64,105,152,257
https://kawalpemilu.org#25938,"JELAMBAR BARU, GROGOL PETAMBURAN, JAKARTA BARAT, DKI JAKARTA",65,127,101,228
https://kawalpemilu.org#25938,"JELAMBAR BARU, GROGOL PETAMBURAN, JAKARTA BARAT, DKI JAKARTA",66,137,93,230
https://kawalpemilu.org#25938,"JELAMBAR BARU, GROGOL PETAMBURAN, JAKARTA BARAT, DKI JAKARTA",67,142,102,244
https://kawalpemilu.org#25938,"JELAMBAR BARU, GROGOL PETAMBURAN, JAKARTA BARAT, DKI JAKARTA",68,193,28,221
https://kawalpemilu.org#25938,"JELAMBAR BARU, GROGOL PETAMBURAN, JAKARTA BARAT, DKI JAKARTA",69,224,1,225
https://kawalpemilu.org#25938,"JELAMBAR BARU, GROGOL PETAMBURAN, JAKARTA BARAT, DKI JAKARTA",70,220,5,225
https://kawalpemilu.org#25938,"JELAMBAR BARU, GROGOL PETAMBURAN, JAKARTA BARAT, DKI JAKARTA",71,155,76,231
https://kawalpemilu.org#25938,"JELAMBAR BARU, GROGOL PETAMBURAN, JAKARTA BARAT, DKI JAKARTA",72,138,76,214
https://kawalpemilu.org#25938,"JELAMBAR BARU, GROGOL PETAMBURAN, JAKARTA BARAT, DKI JAKARTA",73,124,137,261
https://kawalpemilu.org#25938,"JELAMBAR BARU, GROGOL PETAMBURAN, JAKARTA BARAT, DKI JAKARTA",74,109,137,246
https://kawalpemilu.org#25938,"JELAMBAR BARU, GROGOL PETAMBURAN, JAKARTA BARAT, DKI JAKARTA",75,128,132,260
https://kawalpemilu.org#25938,"JELAMBAR BARU, GROGOL PETAMBURAN, JAKARTA BARAT, DKI JAKARTA",76,154,102,256
https://kawalpemilu.org#25938,"JELAMBAR BARU, GROGOL PETAMBURAN, JAKARTA BARAT, DKI JAKARTA",77,162,89,251
https://kawalpemilu.org#25938,"JELAMBAR BARU, GROGOL PETAMBURAN, JAKARTA BARAT, DKI JAKARTA",78,141,50,191
https://kawalpemilu.org#25938,"JELAMBAR BARU, GROGOL PETAMBURAN, JAKARTA BARAT, DKI JAKARTA",79,194,0,194
https://kawalpemilu.org#25938,"JELAMBAR BARU, GROGOL PETAMBURAN, JAKARTA BARAT, DKI JAKARTA",80,207,9,216
https://kawalpemilu.org#25938,"JELAMBAR BARU, GROGOL PETAMBURAN, JAKARTA BARAT, DKI JAKARTA",81,206,18,224
https://kawalpemilu.org#25938,"JELAMBAR BARU, GROGOL PETAMBURAN, JAKARTA BARAT, DKI JAKARTA",82,173,44,217
https://kawalpemilu.org#25938,"JELAMBAR BARU, GROGOL PETAMBURAN, JAKARTA BARAT, DKI JAKARTA",83,174,20,194
https://kawalpemilu.org#25938,"JELAMBAR BARU, GROGOL PETAMBURAN, JAKARTA BARAT, DKI JAKARTA",84,153,50,203
https://kawalpemilu.org#25938,"JELAMBAR BARU, GROGOL PETAMBURAN, JAKARTA BARAT, DKI JAKARTA",85,162,41,203
https://kawalpemilu.org#25938,"JELAMBAR BARU, GROGOL PETAMBURAN, JAKARTA BARAT, DKI JAKARTA",86,148,64,212
https://kawalpemilu.org#25938,"JELAMBAR BARU, GROGOL PETAMBURAN, JAKARTA BARAT, DKI JAKARTA",87,167,61,228
https://kawalpemilu.org#25938,"JELAMBAR BARU, GROGOL PETAMBURAN, JAKARTA BARAT, DKI JAKARTA",88,132,120,252
https://kawalpemilu.org#25938,"JELAMBAR BARU, GROGOL PETAMBURAN, JAKARTA BARAT, DKI JAKARTA",89,115,125,240
https://kawalpemilu.org#25938,"JELAMBAR BARU, GROGOL PETAMBURAN, JAKARTA BARAT, DKI JAKARTA",90,148,92,240
https://kawalpemilu.org#25938,"JELAMBAR BARU, GROGOL PETAMBURAN, JAKARTA BARAT, DKI JAKARTA",91,228,18,246
https://kawalpemilu.org#25938,"JELAMBAR BARU, GROGOL PETAMBURAN, JAKARTA BARAT, DKI JAKARTA",92,210,6,216
https://kawalpemilu.org#25938,"JELAMBAR BARU, GROGOL PETAMBURAN, JAKARTA BARAT, DKI JAKARTA",93,159,77,236
https://kawalpemilu.org#25938,"JELAMBAR BARU, GROGOL PETAMBURAN, JAKARTA BARAT, DKI JAKARTA",94,159,82,241
https://kawalpemilu.org#25938,"JELAMBAR BARU, GROGOL PETAMBURAN, JAKARTA BARAT, DKI JAKARTA",95,187,50,237
https://kawalpemilu.org#25938,"JELAMBAR BARU, GROGOL PETAMBURAN, JAKARTA BARAT, DKI JAKARTA",96,208,47,255
https://kawalpemilu.org#25938,"JELAMBAR BARU, GROGOL PETAMBURAN, JAKARTA BARAT, DKI JAKARTA",97,183,46,229
https://kawalpemilu.org#25938,"JELAMBAR BARU, GROGOL PETAMBURAN, JAKARTA BARAT, DKI JAKARTA",98,186,61,247
https://kawalpemilu.org#25938,"JELAMBAR BARU, GROGOL PETAMBURAN, JAKARTA BARAT, DKI JAKARTA",99,211,42,253
https://kawalpemilu.org#25938,"JELAMBAR BARU, GROGOL PETAMBURAN, JAKARTA BARAT, DKI JAKARTA",100,167,60,227
https://kawalpemilu.org#25938,"JELAMBAR BARU, GROGOL PETAMBURAN, JAKARTA BARAT, DKI JAKARTA",101,203,47,250
https://kawalpemilu.org#25938,"JELAMBAR BARU, GROGOL PETAMBURAN, JAKARTA BARAT, DKI JAKARTA",102,177,52,229
https://kawalpemilu.org#25938,"JELAMBAR BARU, GROGOL PETAMBURAN, JAKARTA BARAT, DKI JAKARTA",103,179,24,203
https://kawalpemilu.org#25938,"JELAMBAR BARU, GROGOL PETAMBURAN, JAKARTA BARAT, DKI JAKARTA",104,212,21,233
https://kawalpemilu.org#25938,"JELAMBAR BARU, GROGOL PETAMBURAN, JAKARTA BARAT, DKI JAKARTA",105,186,20,206
https://kawalpemilu.org#25938,"JELAMBAR BARU, GROGOL PETAMBURAN, JAKARTA BARAT, DKI JAKARTA",106,181,40,221
https://kawalpemilu.org#25938,"JELAMBAR BARU, GROGOL PETAMBURAN, JAKARTA BARAT, DKI JAKARTA",107,169,42,211
https://kawalpemilu.org#25938,"JELAMBAR BARU, GROGOL PETAMBURAN, JAKARTA BARAT, DKI JAKARTA",108,157,62,219
https://kawalpemilu.org#25938,"JELAMBAR BARU, GROGOL PETAMBURAN, JAKARTA BARAT, DKI JAKARTA",109,120,78,198
https://kawalpemilu.org#25938,"JELAMBAR BARU, GROGOL PETAMBURAN, JAKARTA BARAT, DKI JAKARTA",110,173,44,217
https://kawalpemilu.org#25938,"JELAMBAR BARU, GROGOL PETAMBURAN, JAKARTA BARAT, DKI JAKARTA",111,114,70,184
https://kawalpemilu.org#25938,"JELAMBAR BARU, GROGOL PETAMBURAN, JAKARTA BARAT, DKI JAKARTA",112,185,29,219
https://kawalpemilu.org#25938,"JELAMBAR BARU, GROGOL PETAMBURAN, JAKARTA BARAT, DKI JAKARTA",113,171,2,173
https://kawalpemilu.org#25938,"JELAMBAR BARU, GROGOL PETAMBURAN, JAKARTA BARAT, DKI JAKARTA",114,157,6,163
https://kawalpemilu.org#25938,"JELAMBAR BARU, GROGOL PETAMBURAN, JAKARTA BARAT, DKI JAKARTA",115,159,7,166
https://kawalpemilu.org#25938,"JELAMBAR BARU, GROGOL PETAMBURAN, JAKARTA BARAT, DKI JAKARTA",116,216,5,221
https://kawalpemilu.org#25938,"JELAMBAR BARU, GROGOL PETAMBURAN, JAKARTA BARAT, DKI JAKARTA",117,212,9,221
https://kawalpemilu.org#25939,"WIJAYA KUSUMA, GROGOL PETAMBURAN, JAKARTA BARAT, DKI JAKARTA",1,145,98,243
https://kawalpemilu.org#25939,"WIJAYA KUSUMA, GROGOL PETAMBURAN, JAKARTA BARAT, DKI JAKARTA",2,202,12,214
https://kawalpemilu.org#25939,"WIJAYA KUSUMA, GROGOL PETAMBURAN, JAKARTA BARAT, DKI JAKARTA",3,205,10,215
https://kawalpemilu.org#25939,"WIJAYA KUSUMA, GROGOL PETAMBURAN, JAKARTA BARAT, DKI JAKARTA",4,194,4,198
https://kawalpemilu.org#25939,"WIJAYA KUSUMA, GROGOL PETAMBURAN, JAKARTA BARAT, DKI JAKARTA",5,147,95,242
https://kawalpemilu.org#25939,"WIJAYA KUSUMA, GROGOL PETAMBURAN, JAKARTA BARAT, DKI JAKARTA",6,111,87,198
https://kawalpemilu.org#25939,"WIJAYA KUSUMA, GROGOL PETAMBURAN, JAKARTA BARAT, DKI JAKARTA",7,129,70,199
https://kawalpemilu.org#25939,"WIJAYA KUSUMA, GROGOL PETAMBURAN, JAKARTA BARAT, DKI JAKARTA",8,152,112,264
https://kawalpemilu.org#25939,"WIJAYA KUSUMA, GROGOL PETAMBURAN, JAKARTA BARAT, DKI JAKARTA",9,127,98,225
https://kawalpemilu.org#25939,"WIJAYA KUSUMA, GROGOL PETAMBURAN, JAKARTA BARAT, DKI JAKARTA",10,188,6,194
https://kawalpemilu.org#25939,"WIJAYA KUSUMA, GROGOL PETAMBURAN, JAKARTA BARAT, DKI JAKARTA",11,130,81,211
https://kawalpemilu.org#25939,"WIJAYA KUSUMA, GROGOL PETAMBURAN, JAKARTA BARAT, DKI JAKARTA",12,160,57,217
https://kawalpemilu.org#25939,"WIJAYA KUSUMA, GROGOL PETAMBURAN, JAKARTA BARAT, DKI JAKARTA",13,148,85,233
https://kawalpemilu.org#25939,"WIJAYA KUSUMA, GROGOL PETAMBURAN, JAKARTA BARAT, DKI JAKARTA",14,127,119,247
https://kawalpemilu.org#25939,"WIJAYA KUSUMA, GROGOL PETAMBURAN, JAKARTA BARAT, DKI JAKARTA",15,120,108,228
https://kawalpemilu.org#25939,"WIJAYA KUSUMA, GROGOL PETAMBURAN, JAKARTA BARAT, DKI JAKARTA",16,113,111,224
https://kawalpemilu.org#25939,"WIJAYA KUSUMA, GROGOL PETAMBURAN, JAKARTA BARAT, DKI JAKARTA",17,111,87,198
https://kawalpemilu.org#25939,"WIJAYA KUSUMA, GROGOL PETAMBURAN, JAKARTA BARAT, DKI JAKARTA",18,120,96,216
https://kawalpemilu.org#25939,"WIJAYA KUSUMA, GROGOL PETAMBURAN, JAKARTA BARAT, DKI JAKARTA",19,89,116,205
https://kawalpemilu.org#25939,"WIJAYA KUSUMA, GROGOL PETAMBURAN, JAKARTA BARAT, DKI JAKARTA",20,129,97,226
https://kawalpemilu.org#25939,"WIJAYA KUSUMA, GROGOL PETAMBURAN, JAKARTA BARAT, DKI JAKARTA",21,151,105,256
https://kawalpemilu.org#25939,"WIJAYA KUSUMA, GROGOL PETAMBURAN, JAKARTA BARAT, DKI JAKARTA",22,65,32,97
https://kawalpemilu.org#25939,"WIJAYA KUSUMA, GROGOL PETAMBURAN, JAKARTA BARAT, DKI JAKARTA",23,108,61,169
https://kawalpemilu.org#25939,"WIJAYA KUSUMA, GROGOL PETAMBURAN, JAKARTA BARAT, DKI JAKARTA",24,168,66,234
https://kawalpemilu.org#25939,"WIJAYA KUSUMA, GROGOL PETAMBURAN, JAKARTA BARAT, DKI JAKARTA",25,160,75,235
https://kawalpemilu.org#25939,"WIJAYA KUSUMA, GROGOL PETAMBURAN, JAKARTA BARAT, DKI JAKARTA",26,118,113,231
https://kawalpemilu.org#25939,"WIJAYA KUSUMA, GROGOL PETAMBURAN, JAKARTA BARAT, DKI JAKARTA",27,118,103,224
https://kawalpemilu.org#25939,"WIJAYA KUSUMA, GROGOL PETAMBURAN, JAKARTA BARAT, DKI JAKARTA",28,173,59,232
https://kawalpemilu.org#25939,"WIJAYA KUSUMA, GROGOL PETAMBURAN, JAKARTA BARAT, DKI JAKARTA",29,90,136,226
https://kawalpemilu.org#25939,"WIJAYA KUSUMA, GROGOL PETAMBURAN, JAKARTA BARAT, DKI JAKARTA",30,136,60,196
https://kawalpemilu.org#25939,"WIJAYA KUSUMA, GROGOL PETAMBURAN, JAKARTA BARAT, DKI JAKARTA",31,162,59,221
https://kawalpemilu.org#25939,"WIJAYA KUSUMA, GROGOL PETAMBURAN, JAKARTA BARAT, DKI JAKARTA",32,168,77,245
https://kawalpemilu.org#25939,"WIJAYA KUSUMA, GROGOL PETAMBURAN, JAKARTA BARAT, DKI JAKARTA",33,235,7,242
https://kawalpemilu.org#25939,"WIJAYA KUSUMA, GROGOL PETAMBURAN, JAKARTA BARAT, DKI JAKARTA",34,205,3,208
https://kawalpemilu.org#25939,"WIJAYA KUSUMA, GROGOL PETAMBURAN, JAKARTA BARAT, DKI JAKARTA",35,171,47,218
https://kawalpemilu.org#25939,"WIJAYA KUSUMA, GROGOL PETAMBURAN, JAKARTA BARAT, DKI JAKARTA",36,144,55,199
https://kawalpemilu.org#25939,"WIJAYA KUSUMA, GROGOL PETAMBURAN, JAKARTA BARAT, DKI JAKARTA",37,141,121,262
https://kawalpemilu.org#25939,"WIJAYA KUSUMA, GROGOL PETAMBURAN, JAKARTA BARAT, DKI JAKARTA",38,140,111,251
https://kawalpemilu.org#25939,"WIJAYA KUSUMA, GROGOL PETAMBURAN, JAKARTA BARAT, DKI JAKARTA",39,113,66,179
https://kawalpemilu.org#25939,"WIJAYA KUSUMA, GROGOL PETAMBURAN, JAKARTA BARAT, DKI JAKARTA",40,159,53,212
https://kawalpemilu.org#25939,"WIJAYA KUSUMA, GROGOL PETAMBURAN, JAKARTA BARAT, DKI JAKARTA",41,140,37,177
https://kawalpemilu.org#25939,"WIJAYA KUSUMA, GROGOL PETAMBURAN, JAKARTA BARAT, DKI JAKARTA",42,178,4,182
https://kawalpemilu.org#25939,"WIJAYA KUSUMA, GROGOL PETAMBURAN, JAKARTA BARAT, DKI JAKARTA",43,184,25,209
https://kawalpemilu.org#25939,"WIJAYA KUSUMA, GROGOL PETAMBURAN, JAKARTA BARAT, DKI JAKARTA",44,166,51,217
https://kawalpemilu.org#25939,"WIJAYA KUSUMA, GROGOL PETAMBURAN, JAKARTA BARAT, DKI JAKARTA",45,196,16,212
https://kawalpemilu.org#25939,"WIJAYA KUSUMA, GROGOL PETAMBURAN, JAKARTA BARAT, DKI JAKARTA",46,138,110,248
https://kawalpemilu.org#25939,"WIJAYA KUSUMA, GROGOL PETAMBURAN, JAKARTA BARAT, DKI JAKARTA",47,105,82,187
https://kawalpemilu.org#25939,"WIJAYA KUSUMA, GROGOL PETAMBURAN, JAKARTA BARAT, DKI JAKARTA",48,148,80,228
https://kawalpemilu.org#25939,"WIJAYA KUSUMA, GROGOL PETAMBURAN, JAKARTA BARAT, DKI JAKARTA",50,170,82,252
https://kawalpemilu.org#25939,"WIJAYA KUSUMA, GROGOL PETAMBURAN, JAKARTA BARAT, DKI JAKARTA",51,152,79,231
https://kawalpemilu.org#25939,"WIJAYA KUSUMA, GROGOL PETAMBURAN, JAKARTA BARAT, DKI JAKARTA",52,108,88,196
https://kawalpemilu.org#25939,"WIJAYA KUSUMA, GROGOL PETAMBURAN, JAKARTA BARAT, DKI JAKARTA",53,129,95,224
https://kawalpemilu.org#25939,"WIJAYA KUSUMA, GROGOL PETAMBURAN, JAKARTA BARAT, DKI JAKARTA",54,207,5,212
https://kawalpemilu.org#25939,"WIJAYA KUSUMA, GROGOL PETAMBURAN, JAKARTA BARAT, DKI JAKARTA",55,136,64,200
https://kawalpemilu.org#25939,"WIJAYA KUSUMA, GROGOL PETAMBURAN, JAKARTA BARAT, DKI JAKARTA",56,155,70,225
https://kawalpemilu.org#25939,"WIJAYA KUSUMA, GROGOL PETAMBURAN, JAKARTA BARAT, DKI JAKARTA",57,186,61,247
https://kawalpemilu.org#25939,"WIJAYA KUSUMA, GROGOL PETAMBURAN, JAKARTA BARAT, DKI JAKARTA",58,163,70,233
https://kawalpemilu.org#25939,"WIJAYA KUSUMA, GROGOL PETAMBURAN, JAKARTA BARAT, DKI JAKARTA",59,216,44,260
https://kawalpemilu.org#25939,"WIJAYA KUSUMA, GROGOL PETAMBURAN, JAKARTA BARAT, DKI JAKARTA",60,165,26,191
https://kawalpemilu.org#25939,"WIJAYA KUSUMA, GROGOL PETAMBURAN, JAKARTA BARAT, DKI JAKARTA",61,194,40,234
https://kawalpemilu.org#25939,"WIJAYA KUSUMA, GROGOL PETAMBURAN, JAKARTA BARAT, DKI JAKARTA",62,161,61,222
https://kawalpemilu.org#25939,"WIJAYA KUSUMA, GROGOL PETAMBURAN, JAKARTA BARAT, DKI JAKARTA",63,93,117,210
https://kawalpemilu.org#25939,"WIJAYA KUSUMA, GROGOL PETAMBURAN, JAKARTA BARAT, DKI JAKARTA",64,94,135,229
https://kawalpemilu.org#25939,"WIJAYA KUSUMA, GROGOL PETAMBURAN, JAKARTA BARAT, DKI JAKARTA",65,157,87,244
https://kawalpemilu.org#25939,"WIJAYA KUSUMA, GROGOL PETAMBURAN, JAKARTA BARAT, DKI JAKARTA",66,186,37,223
https://kawalpemilu.org#25939,"WIJAYA KUSUMA, GROGOL PETAMBURAN, JAKARTA BARAT, DKI JAKARTA",67,153,45,198
https://kawalpemilu.org#25939,"WIJAYA KUSUMA, GROGOL PETAMBURAN, JAKARTA BARAT, DKI JAKARTA",68,140,52,192
https://kawalpemilu.org#25939,"WIJAYA KUSUMA, GROGOL PETAMBURAN, JAKARTA BARAT, DKI JAKARTA",69,122,48,170
https://kawalpemilu.org#25939,"WIJAYA KUSUMA, GROGOL PETAMBURAN, JAKARTA BARAT, DKI JAKARTA",70,137,58,195
https://kawalpemilu.org#25939,"WIJAYA KUSUMA, GROGOL PETAMBURAN, JAKARTA BARAT, DKI JAKARTA",71,112,73,185
https://kawalpemilu.org#25939,"WIJAYA KUSUMA, GROGOL PETAMBURAN, JAKARTA BARAT, DKI JAKARTA",72,171,48,219
https://kawalpemilu.org#25939,"WIJAYA KUSUMA, GROGOL PETAMBURAN, JAKARTA BARAT, DKI JAKARTA",73,157,56,213
https://kawalpemilu.org#25939,"WIJAYA KUSUMA, GROGOL PETAMBURAN, JAKARTA BARAT, DKI JAKARTA",74,195,35,230
https://kawalpemilu.org#25939,"WIJAYA KUSUMA, GROGOL PETAMBURAN, JAKARTA BARAT, DKI JAKARTA",75,179,25,204
https://kawalpemilu.org#25939,"WIJAYA KUSUMA, GROGOL PETAMBURAN, JAKARTA BARAT, DKI JAKARTA",76,182,46,228
https://kawalpemilu.org#25939,"WIJAYA KUSUMA, GROGOL PETAMBURAN, JAKARTA BARAT, DKI JAKARTA",77,110,82,192
https://kawalpemilu.org#25939,"WIJAYA KUSUMA, GROGOL PETAMBURAN, JAKARTA BARAT, DKI JAKARTA",78,128,106,234
https://kawalpemilu.org#25939,"WIJAYA KUSUMA, GROGOL PETAMBURAN, JAKARTA BARAT, DKI JAKARTA",79,118,116,234
https://kawalpemilu.org#25939,"WIJAYA KUSUMA, GROGOL PETAMBURAN, JAKARTA BARAT, DKI JAKARTA",80,129,93,222
https://kawalpemilu.org#25939,"WIJAYA KUSUMA, GROGOL PETAMBURAN, JAKARTA BARAT, DKI JAKARTA",81,107,80,187
https://kawalpemilu.org#25939,"WIJAYA KUSUMA, GROGOL PETAMBURAN, JAKARTA BARAT, DKI JAKARTA",82,126,53,179
https://kawalpemilu.org#25939,"WIJAYA KUSUMA, GROGOL PETAMBURAN, JAKARTA BARAT, DKI JAKARTA",83,108,68,176
https://kawalpemilu.org#25939,"WIJAYA KUSUMA, GROGOL PETAMBURAN, JAKARTA BARAT, DKI JAKARTA",84,112,77,189
https://kawalpemilu.org#25939,"WIJAYA KUSUMA, GROGOL PETAMBURAN, JAKARTA BARAT, DKI JAKARTA",85,118,91,209
https://kawalpemilu.org#25939,"WIJAYA KUSUMA, GROGOL PETAMBURAN, JAKARTA BARAT, DKI JAKARTA",86,134,113,247
https://kawalpemilu.org#25939,"WIJAYA KUSUMA, GROGOL PETAMBURAN, JAKARTA BARAT, DKI JAKARTA",87,118,95,213
https://kawalpemilu.org#25939,"WIJAYA KUSUMA, GROGOL PETAMBURAN, JAKARTA BARAT, DKI JAKARTA",88,150,78,228
https://kawalpemilu.org#25939,"WIJAYA KUSUMA, GROGOL PETAMBURAN, JAKARTA BARAT, DKI JAKARTA",89,117,63,180
https://kawalpemilu.org#25939,"WIJAYA KUSUMA, GROGOL PETAMBURAN, JAKARTA BARAT, DKI JAKARTA",90,100,119,219
https://kawalpemilu.org#25939,"WIJAYA KUSUMA, GROGOL PETAMBURAN, JAKARTA BARAT, DKI JAKARTA",91,123,90,213
https://kawalpemilu.org#25939,"WIJAYA KUSUMA, GROGOL PETAMBURAN, JAKARTA BARAT, DKI JAKARTA",92,158,90,248
https://kawalpemilu.org#25939,"WIJAYA KUSUMA, GROGOL PETAMBURAN, JAKARTA BARAT, DKI JAKARTA",93,116,89,205
https://kawalpemilu.org#25939,"WIJAYA KUSUMA, GROGOL PETAMBURAN, JAKARTA BARAT, DKI JAKARTA",94,134,64,198
https://kawalpemilu.org#25939,"WIJAYA KUSUMA, GROGOL PETAMBURAN, JAKARTA BARAT, DKI JAKARTA",95,113,81,194
https://kawalpemilu.org#25939,"WIJAYA KUSUMA, GROGOL PETAMBURAN, JAKARTA BARAT, DKI JAKARTA",96,195,2,197
https://kawalpemilu.org#25939,"WIJAYA KUSUMA, GROGOL PETAMBURAN, JAKARTA BARAT, DKI JAKARTA",97,193,16,209
https://kawalpemilu.org#25939,"WIJAYA KUSUMA, GROGOL PETAMBURAN, JAKARTA BARAT, DKI JAKARTA",98,183,10,193
https://kawalpemilu.org#25939,"WIJAYA KUSUMA, GROGOL PETAMBURAN, JAKARTA BARAT, DKI JAKARTA",99,203,6,209
https://kawalpemilu.org#25939,"WIJAYA KUSUMA, GROGOL PETAMBURAN, JAKARTA BARAT, DKI JAKARTA",100,228,4,232
https://kawalpemilu.org#25939,"WIJAYA KUSUMA, GROGOL PETAMBURAN, JAKARTA BARAT, DKI JAKARTA",101,191,6,197
https://kawalpemilu.org#25939,"WIJAYA KUSUMA, GROGOL PETAMBURAN, JAKARTA BARAT, DKI JAKARTA",102,207,2,209
https://kawalpemilu.org#25939,"WIJAYA KUSUMA, GROGOL PETAMBURAN, JAKARTA BARAT, DKI JAKARTA",103,222,1,223
https://kawalpemilu.org#25939,"WIJAYA KUSUMA, GROGOL PETAMBURAN, JAKARTA BARAT, DKI JAKARTA",104,204,3,207
https://kawalpemilu.org#25939,"WIJAYA KUSUMA, GROGOL PETAMBURAN, JAKARTA BARAT, DKI JAKARTA",105,198,2,200
https://kawalpemilu.org#25939,"WIJAYA KUSUMA, GROGOL PETAMBURAN, JAKARTA BARAT, DKI JAKARTA",106,244,3,247
https://kawalpemilu.org#25939,"WIJAYA KUSUMA, GROGOL PETAMBURAN, JAKARTA BARAT, DKI JAKARTA",107,182,4,186
https://kawalpemilu.org#25939,"WIJAYA KUSUMA, GROGOL PETAMBURAN, JAKARTA BARAT, DKI JAKARTA",108,203,73,276
https://kawalpemilu.org#25939,"WIJAYA KUSUMA, GROGOL PETAMBURAN, JAKARTA BARAT, DKI JAKARTA",109,130,127,257
https://kawalpemilu.org#25939,"WIJAYA KUSUMA, GROGOL PETAMBURAN, JAKARTA BARAT, DKI JAKARTA",110,150,74,224
https://kawalpemilu.org#25939,"WIJAYA KUSUMA, GROGOL PETAMBURAN, JAKARTA BARAT, DKI JAKARTA",111,187,76,263
https://kawalpemilu.org#25939,"WIJAYA KUSUMA, GROGOL PETAMBURAN, JAKARTA BARAT, DKI JAKARTA",112,161,89,250
https://kawalpemilu.org#25939,"WIJAYA KUSUMA, GROGOL PETAMBURAN, JAKARTA BARAT, DKI JAKARTA",113,126,71,197
https://kawalpemilu.org#25939,"WIJAYA KUSUMA, GROGOL PETAMBURAN, JAKARTA BARAT, DKI JAKARTA",114,114,88,202
https://kawalpemilu.org#25939,"WIJAYA KUSUMA, GROGOL PETAMBURAN, JAKARTA BARAT, DKI JAKARTA",115,131,89,220
https://kawalpemilu.org#25939,"WIJAYA KUSUMA, GROGOL PETAMBURAN, JAKARTA BARAT, DKI JAKARTA",116,139,78,217
https://kawalpemilu.org#25939,"WIJAYA KUSUMA, GROGOL PETAMBURAN, JAKARTA BARAT, DKI JAKARTA",117,131,78,209
https://kawalpemilu.org#25939,"WIJAYA KUSUMA, GROGOL PETAMBURAN, JAKARTA BARAT, DKI JAKARTA",118,125,105,230
https://kawalpemilu.org#25939,"WIJAYA KUSUMA, GROGOL PETAMBURAN, JAKARTA BARAT, DKI JAKARTA",119,140,94,234
https://kawalpemilu.org#25939,"WIJAYA KUSUMA, GROGOL PETAMBURAN, JAKARTA BARAT, DKI JAKARTA",120,73,108,181
https://kawalpemilu.org#25939,"WIJAYA KUSUMA, GROGOL PETAMBURAN, JAKARTA BARAT, DKI JAKARTA",121,88,115,203
https://kawalpemilu.org#25939,"WIJAYA KUSUMA, GROGOL PETAMBURAN, JAKARTA BARAT, DKI JAKARTA",122,161,86,247
https://kawalpemilu.org#25939,"WIJAYA KUSUMA, GROGOL PETAMBURAN, JAKARTA BARAT, DKI JAKARTA",123,103,80,183
https://kawalpemilu.org#25939,"WIJAYA KUSUMA, GROGOL PETAMBURAN, JAKARTA BARAT, DKI JAKARTA",124,74,74,148
https://kawalpemilu.org#25939,"WIJAYA KUSUMA, GROGOL PETAMBURAN, JAKARTA BARAT, DKI JAKARTA",125,98,51,149
https://kawalpemilu.org#25939,"WIJAYA KUSUMA, GROGOL PETAMBURAN, JAKARTA BARAT, DKI JAKARTA",126,58,28,86
https://kawalpemilu.org#25939,"WIJAYA KUSUMA, GROGOL PETAMBURAN, JAKARTA BARAT, DKI JAKARTA",127,68,24,92
https://kawalpemilu.org#25939,"WIJAYA KUSUMA, GROGOL PETAMBURAN, JAKARTA BARAT, DKI JAKARTA",128,62,30,92
https://kawalpemilu.org#25941,"TAMAN SARI, TAMAN SARI, JAKARTA BARAT, DKI JAKARTA",1,182,15,197
https://kawalpemilu.org#25941,"TAMAN SARI, TAMAN SARI, JAKARTA BARAT, DKI JAKARTA",2,173,3,176
https://kawalpemilu.org#25941,"TAMAN SARI, TAMAN SARI, JAKARTA BARAT, DKI JAKARTA",3,185,12,197
https://kawalpemilu.org#25941,"TAMAN SARI, TAMAN SARI, JAKARTA BARAT, DKI JAKARTA",4,181,9,190
https://kawalpemilu.org#25941,"TAMAN SARI, TAMAN SARI, JAKARTA BARAT, DKI JAKARTA",5,173,1,174
https://kawalpemilu.org#25941,"TAMAN SARI, TAMAN SARI, JAKARTA BARAT, DKI JAKARTA",6,118,115,233
https://kawalpemilu.org#25941,"TAMAN SARI, TAMAN SARI, JAKARTA BARAT, DKI JAKARTA",7,132,104,236
https://kawalpemilu.org#25941,"TAMAN SARI, TAMAN SARI, JAKARTA BARAT, DKI JAKARTA",8,117,121,238
https://kawalpemilu.org#25941,"TAMAN SARI, TAMAN SARI, JAKARTA BARAT, DKI JAKARTA",9,127,63,190
https://kawalpemilu.org#25941,"TAMAN SARI, TAMAN SARI, JAKARTA BARAT, DKI JAKARTA",10,62,131,193
https://kawalpemilu.org#25941,"TAMAN SARI, TAMAN SARI, JAKARTA BARAT, DKI JAKARTA",11,72,164,236
https://kawalpemilu.org#25941,"TAMAN SARI, TAMAN SARI, JAKARTA BARAT, DKI JAKARTA",12,219,46,265
https://kawalpemilu.org#25941,"TAMAN SARI, TAMAN SARI, JAKARTA BARAT, DKI JAKARTA",13,137,93,230
https://kawalpemilu.org#25941,"TAMAN SARI, TAMAN SARI, JAKARTA BARAT, DKI JAKARTA",14,194,19,213
https://kawalpemilu.org#25941,"TAMAN SARI, TAMAN SARI, JAKARTA BARAT, DKI JAKARTA",15,135,68,203
https://kawalpemilu.org#25941,"TAMAN SARI, TAMAN SARI, JAKARTA BARAT, DKI JAKARTA",16,178,6,184
https://kawalpemilu.org#25941,"TAMAN SARI, TAMAN SARI, JAKARTA BARAT, DKI JAKARTA",17,199,28,227
https://kawalpemilu.org#25941,"TAMAN SARI, TAMAN SARI, JAKARTA BARAT, DKI JAKARTA",18,205,31,236
https://kawalpemilu.org#25941,"TAMAN SARI, TAMAN SARI, JAKARTA BARAT, DKI JAKARTA",19,172,45,217
https://kawalpemilu.org#25941,"TAMAN SARI, TAMAN SARI, JAKARTA BARAT, DKI JAKARTA",20,157,46,203
https://kawalpemilu.org#25941,"TAMAN SARI, TAMAN SARI, JAKARTA BARAT, DKI JAKARTA",21,154,46,200
https://kawalpemilu.org#25941,"TAMAN SARI, TAMAN SARI, JAKARTA BARAT, DKI JAKARTA",22,144,91,235
https://kawalpemilu.org#25941,"TAMAN SARI, TAMAN SARI, JAKARTA BARAT, DKI JAKARTA",23,130,80,210
https://kawalpemilu.org#25941,"TAMAN SARI, TAMAN SARI, JAKARTA BARAT, DKI JAKARTA",24,151,59,210
https://kawalpemilu.org#25941,"TAMAN SARI, TAMAN SARI, JAKARTA BARAT, DKI JAKARTA",25,115,124,239
https://kawalpemilu.org#25941,"TAMAN SARI, TAMAN SARI, JAKARTA BARAT, DKI JAKARTA",26,145,96,241
https://kawalpemilu.org#25941,"TAMAN SARI, TAMAN SARI, JAKARTA BARAT, DKI JAKARTA",27,173,73,246
https://kawalpemilu.org#25941,"TAMAN SARI, TAMAN SARI, JAKARTA BARAT, DKI JAKARTA",28,152,49,201
https://kawalpemilu.org#25941,"TAMAN SARI, TAMAN SARI, JAKARTA BARAT, DKI JAKARTA",29,150,68,218
https://kawalpemilu.org#25941,"TAMAN SARI, TAMAN SARI, JAKARTA BARAT, DKI JAKARTA",30,161,43,204
https://kawalpemilu.org#25941,"TAMAN SARI, TAMAN SARI, JAKARTA BARAT, DKI JAKARTA",31,146,37,183
https://kawalpemilu.org#25941,"TAMAN SARI, TAMAN SARI, JAKARTA BARAT, DKI JAKARTA",32,136,66,202
https://kawalpemilu.org#25941,"TAMAN SARI, TAMAN SARI, JAKARTA BARAT, DKI JAKARTA",33,166,47,213
https://kawalpemilu.org#25941,"TAMAN SARI, TAMAN SARI, JAKARTA BARAT, DKI JAKARTA",34,122,88,210
https://kawalpemilu.org#25941,"TAMAN SARI, TAMAN SARI, JAKARTA BARAT, DKI JAKARTA",35,102,48,150
https://kawalpemilu.org#25941,"TAMAN SARI, TAMAN SARI, JAKARTA BARAT, DKI JAKARTA",36,97,154,251
https://kawalpemilu.org#25941,"TAMAN SARI, TAMAN SARI, JAKARTA BARAT, DKI JAKARTA",37,146,105,251
https://kawalpemilu.org#25941,"TAMAN SARI, TAMAN SARI, JAKARTA BARAT, DKI JAKARTA",38,67,186,253
https://kawalpemilu.org#25941,"TAMAN SARI, TAMAN SARI, JAKARTA BARAT, DKI JAKARTA",39,105,101,206
https://kawalpemilu.org#25941,"TAMAN SARI, TAMAN SARI, JAKARTA BARAT, DKI JAKARTA",40,141,61,202
https://kawalpemilu.org#25941,"TAMAN SARI, TAMAN SARI, JAKARTA BARAT, DKI JAKARTA",41,130,73,203
https://kawalpemilu.org#25941,"TAMAN SARI, TAMAN SARI, JAKARTA BARAT, DKI JAKARTA",42,92,121,213
https://kawalpemilu.org#25941,"TAMAN SARI, TAMAN SARI, JAKARTA BARAT, DKI JAKARTA",43,161,62,223
https://kawalpemilu.org#25941,"TAMAN SARI, TAMAN SARI, JAKARTA BARAT, DKI JAKARTA",44,154,90,244
https://kawalpemilu.org#25941,"TAMAN SARI, TAMAN SARI, JAKARTA BARAT, DKI JAKARTA",45,130,89,219
https://kawalpemilu.org#25941,"TAMAN SARI, TAMAN SARI, JAKARTA BARAT, DKI JAKARTA",46,165,71,236
https://kawalpemilu.org#25941,"TAMAN SARI, TAMAN SARI, JAKARTA BARAT, DKI JAKARTA",47,98,133,231
https://kawalpemilu.org#25941,"TAMAN SARI, TAMAN SARI, JAKARTA BARAT, DKI JAKARTA",48,114,74,188
https://kawalpemilu.org#25942,"KRUKUT, TAMAN SARI, JAKARTA BARAT, DKI JAKARTA",1,169,67,236
https://kawalpemilu.org#25942,"KRUKUT, TAMAN SARI, JAKARTA BARAT, DKI JAKARTA",2,98,138,236
https://kawalpemilu.org#25942,"KRUKUT, TAMAN SARI, JAKARTA BARAT, DKI JAKARTA",3,94,116,210
https://kawalpemilu.org#25942,"KRUKUT, TAMAN SARI, JAKARTA BARAT, DKI JAKARTA",4,101,87,188
https://kawalpemilu.org#25942,"KRUKUT, TAMAN SARI, JAKARTA BARAT, DKI JAKARTA",5,114,97,211
https://kawalpemilu.org#25942,"KRUKUT, TAMAN SARI, JAKARTA BARAT, DKI JAKARTA",6,167,56,223
https://kawalpemilu.org#25942,"KRUKUT, TAMAN SARI, JAKARTA BARAT, DKI JAKARTA",7,108,97,205
https://kawalpemilu.org#25942,"KRUKUT, TAMAN SARI, JAKARTA BARAT, DKI JAKARTA",8,78,154,232
https://kawalpemilu.org#25942,"KRUKUT, TAMAN SARI, JAKARTA BARAT, DKI JAKARTA",9,102,163,265
https://kawalpemilu.org#25942,"KRUKUT, TAMAN SARI, JAKARTA BARAT, DKI JAKARTA",10,112,134,246
https://kawalpemilu.org#25942,"KRUKUT, TAMAN SARI, JAKARTA BARAT, DKI JAKARTA",11,105,123,228
https://kawalpemilu.org#25942,"KRUKUT, TAMAN SARI, JAKARTA BARAT, DKI JAKARTA",12,97,101,198
https://kawalpemilu.org#25942,"KRUKUT, TAMAN SARI, JAKARTA BARAT, DKI JAKARTA",13,132,107,239
https://kawalpemilu.org#25942,"KRUKUT, TAMAN SARI, JAKARTA BARAT, DKI JAKARTA",14,135,110,245
https://kawalpemilu.org#25942,"KRUKUT, TAMAN SARI, JAKARTA BARAT, DKI JAKARTA",15,113,126,239
https://kawalpemilu.org#25942,"KRUKUT, TAMAN SARI, JAKARTA BARAT, DKI JAKARTA",16,90,138,228
https://kawalpemilu.org#25942,"KRUKUT, TAMAN SARI, JAKARTA BARAT, DKI JAKARTA",17,88,179,267
https://kawalpemilu.org#25942,"KRUKUT, TAMAN SARI, JAKARTA BARAT, DKI JAKARTA",18,72,186,258
https://kawalpemilu.org#25942,"KRUKUT, TAMAN SARI, JAKARTA BARAT, DKI JAKARTA",19,84,153,237
https://kawalpemilu.org#25942,"KRUKUT, TAMAN SARI, JAKARTA BARAT, DKI JAKARTA",20,120,135,255
https://kawalpemilu.org#25942,"KRUKUT, TAMAN SARI, JAKARTA BARAT, DKI JAKARTA",21,88,149,237
https://kawalpemilu.org#25942,"KRUKUT, TAMAN SARI, JAKARTA BARAT, DKI JAKARTA",22,128,101,229
https://kawalpemilu.org#25942,"KRUKUT, TAMAN SARI, JAKARTA BARAT, DKI JAKARTA",23,65,152,217
https://kawalpemilu.org#25942,"KRUKUT, TAMAN SARI, JAKARTA BARAT, DKI JAKARTA",24,146,68,214
https://kawalpemilu.org#25942,"KRUKUT, TAMAN SARI, JAKARTA BARAT, DKI JAKARTA",25,103,132,235
https://kawalpemilu.org#25942,"KRUKUT, TAMAN SARI, JAKARTA BARAT, DKI JAKARTA",26,104,120,224
https://kawalpemilu.org#25942,"KRUKUT, TAMAN SARI, JAKARTA BARAT, DKI JAKARTA",27,68,173,241
https://kawalpemilu.org#25942,"KRUKUT, TAMAN SARI, JAKARTA BARAT, DKI JAKARTA",28,71,167,238
https://kawalpemilu.org#25942,"KRUKUT, TAMAN SARI, JAKARTA BARAT, DKI JAKARTA",29,47,155,202
https://kawalpemilu.org#25942,"KRUKUT, TAMAN SARI, JAKARTA BARAT, DKI JAKARTA",30,62,145,207
https://kawalpemilu.org#25942,"KRUKUT, TAMAN SARI, JAKARTA BARAT, DKI JAKARTA",31,84,147,231
https://kawalpemilu.org#25942,"KRUKUT, TAMAN SARI, JAKARTA BARAT, DKI JAKARTA",32,85,128,213
https://kawalpemilu.org#25942,"KRUKUT, TAMAN SARI, JAKARTA BARAT, DKI JAKARTA",33,61,168,229
https://kawalpemilu.org#25942,"KRUKUT, TAMAN SARI, JAKARTA BARAT, DKI JAKARTA",34,81,159,240
https://kawalpemilu.org#25942,"KRUKUT, TAMAN SARI, JAKARTA BARAT, DKI JAKARTA",35,119,109,228
https://kawalpemilu.org#25942,"KRUKUT, TAMAN SARI, JAKARTA BARAT, DKI JAKARTA",36,119,126,245
https://kawalpemilu.org#25942,"KRUKUT, TAMAN SARI, JAKARTA BARAT, DKI JAKARTA",37,58,176,234
https://kawalpemilu.org#25942,"KRUKUT, TAMAN SARI, JAKARTA BARAT, DKI JAKARTA",38,105,123,228
https://kawalpemilu.org#25942,"KRUKUT, TAMAN SARI, JAKARTA BARAT, DKI JAKARTA",39,197,71,268
https://kawalpemilu.org#25942,"KRUKUT, TAMAN SARI, JAKARTA BARAT, DKI JAKARTA",40,111,132,243
https://kawalpemilu.org#25942,"KRUKUT, TAMAN SARI, JAKARTA BARAT, DKI JAKARTA",41,108,126,234
https://kawalpemilu.org#25942,"KRUKUT, TAMAN SARI, JAKARTA BARAT, DKI JAKARTA",42,149,79,228
https://kawalpemilu.org#25942,"KRUKUT, TAMAN SARI, JAKARTA BARAT, DKI JAKARTA",43,127,105,232
https://kawalpemilu.org#25942,"KRUKUT, TAMAN SARI, JAKARTA BARAT, DKI JAKARTA",44,143,48,191
https://kawalpemilu.org#25942,"KRUKUT, TAMAN SARI, JAKARTA BARAT, DKI JAKARTA",45,73,169,242
https://kawalpemilu.org#25942,"KRUKUT, TAMAN SARI, JAKARTA BARAT, DKI JAKARTA",46,48,175,223
https://kawalpemilu.org#25942,"KRUKUT, TAMAN SARI, JAKARTA BARAT, DKI JAKARTA",47,82,124,206
https://kawalpemilu.org#25942,"KRUKUT, TAMAN SARI, JAKARTA BARAT, DKI JAKARTA",48,87,98,185
https://kawalpemilu.org#25942,"KRUKUT, TAMAN SARI, JAKARTA BARAT, DKI JAKARTA",49,151,67,218
https://kawalpemilu.org#25942,"KRUKUT, TAMAN SARI, JAKARTA BARAT, DKI JAKARTA",50,60,184,244
https://kawalpemilu.org#25942,"KRUKUT, TAMAN SARI, JAKARTA BARAT, DKI JAKARTA",51,125,118,243
https://kawalpemilu.org#25942,"KRUKUT, TAMAN SARI, JAKARTA BARAT, DKI JAKARTA",52,117,127,244
https://kawalpemilu.org#25942,"KRUKUT, TAMAN SARI, JAKARTA BARAT, DKI JAKARTA",53,139,112,251
https://kawalpemilu.org#25942,"KRUKUT, TAMAN SARI, JAKARTA BARAT, DKI JAKARTA",54,168,66,234
https://kawalpemilu.org#25942,"KRUKUT, TAMAN SARI, JAKARTA BARAT, DKI JAKARTA",55,176,81,257
https://kawalpemilu.org#25942,"KRUKUT, TAMAN SARI, JAKARTA BARAT, DKI JAKARTA",56,191,22,213
https://kawalpemilu.org#25942,"KRUKUT, TAMAN SARI, JAKARTA BARAT, DKI JAKARTA",57,150,92,242
https://kawalpemilu.org#25942,"KRUKUT, TAMAN SARI, JAKARTA BARAT, DKI JAKARTA",58,139,64,203
https://kawalpemilu.org#25942,"KRUKUT, TAMAN SARI, JAKARTA BARAT, DKI JAKARTA",59,147,44,191
https://kawalpemilu.org#25942,"KRUKUT, TAMAN SARI, JAKARTA BARAT, DKI JAKARTA",60,148,48,196
https://kawalpemilu.org#25943,"MAPHAR, TAMAN SARI, JAKARTA BARAT, DKI JAKARTA",1,149,71,220
https://kawalpemilu.org#25943,"MAPHAR, TAMAN SARI, JAKARTA BARAT, DKI JAKARTA",2,167,61,228
https://kawalpemilu.org#25943,"MAPHAR, TAMAN SARI, JAKARTA BARAT, DKI JAKARTA",3,176,32,208
https://kawalpemilu.org#25943,"MAPHAR, TAMAN SARI, JAKARTA BARAT, DKI JAKARTA",4,130,91,221
https://kawalpemilu.org#25943,"MAPHAR, TAMAN SARI, JAKARTA BARAT, DKI JAKARTA",5,94,117,211
https://kawalpemilu.org#25943,"MAPHAR, TAMAN SARI, JAKARTA BARAT, DKI JAKARTA",6,221,20,241
https://kawalpemilu.org#25943,"MAPHAR, TAMAN SARI, JAKARTA BARAT, DKI JAKARTA",7,200,40,240
https://kawalpemilu.org#25943,"MAPHAR, TAMAN SARI, JAKARTA BARAT, DKI JAKARTA",8,143,66,209
https://kawalpemilu.org#25943,"MAPHAR, TAMAN SARI, JAKARTA BARAT, DKI JAKARTA",9,117,84,201
https://kawalpemilu.org#25943,"MAPHAR, TAMAN SARI, JAKARTA BARAT, DKI JAKARTA",10,142,26,168
https://kawalpemilu.org#25943,"MAPHAR, TAMAN SARI, JAKARTA BARAT, DKI JAKARTA",11,82,115,197
https://kawalpemilu.org#25943,"MAPHAR, TAMAN SARI, JAKARTA BARAT, DKI JAKARTA",12,129,74,203
https://kawalpemilu.org#25943,"MAPHAR, TAMAN SARI, JAKARTA BARAT, DKI JAKARTA",13,142,13,155
https://kawalpemilu.org#25943,"MAPHAR, TAMAN SARI, JAKARTA BARAT, DKI JAKARTA",14,200,3,203
https://kawalpemilu.org#25943,"MAPHAR, TAMAN SARI, JAKARTA BARAT, DKI JAKARTA",15,118,56,175
https://kawalpemilu.org#25943,"MAPHAR, TAMAN SARI, JAKARTA BARAT, DKI JAKARTA",16,165,25,190
https://kawalpemilu.org#25943,"MAPHAR, TAMAN SARI, JAKARTA BARAT, DKI JAKARTA",17,142,50,192
https://kawalpemilu.org#25943,"MAPHAR, TAMAN SARI, JAKARTA BARAT, DKI JAKARTA",18,110,80,190
https://kawalpemilu.org#25943,"MAPHAR, TAMAN SARI, JAKARTA BARAT, DKI JAKARTA",19,173,36,209
https://kawalpemilu.org#25943,"MAPHAR, TAMAN SARI, JAKARTA BARAT, DKI JAKARTA",20,106,82,188
https://kawalpemilu.org#25943,"MAPHAR, TAMAN SARI, JAKARTA BARAT, DKI JAKARTA",21,125,75,200
https://kawalpemilu.org#25943,"MAPHAR, TAMAN SARI, JAKARTA BARAT, DKI JAKARTA",22,147,59,206
https://kawalpemilu.org#25943,"MAPHAR, TAMAN SARI, JAKARTA BARAT, DKI JAKARTA",23,108,47,155
https://kawalpemilu.org#25943,"MAPHAR, TAMAN SARI, JAKARTA BARAT, DKI JAKARTA",24,105,84,189
https://kawalpemilu.org#25943,"MAPHAR, TAMAN SARI, JAKARTA BARAT, DKI JAKARTA",25,108,86,194
https://kawalpemilu.org#25943,"MAPHAR, TAMAN SARI, JAKARTA BARAT, DKI JAKARTA",26,117,95,212
https://kawalpemilu.org#25943,"MAPHAR, TAMAN SARI, JAKARTA BARAT, DKI JAKARTA",27,110,96,206
https://kawalpemilu.org#25943,"MAPHAR, TAMAN SARI, JAKARTA BARAT, DKI JAKARTA",28,177,41,218
https://kawalpemilu.org#25943,"MAPHAR, TAMAN SARI, JAKARTA BARAT, DKI JAKARTA",29,116,108,224
https://kawalpemilu.org#25943,"MAPHAR, TAMAN SARI, JAKARTA BARAT, DKI JAKARTA",30,107,85,192
https://kawalpemilu.org#25943,"MAPHAR, TAMAN SARI, JAKARTA BARAT, DKI JAKARTA",31,139,80,219
https://kawalpemilu.org#25943,"MAPHAR, TAMAN SARI, JAKARTA BARAT, DKI JAKARTA",32,191,17,208
https://kawalpemilu.org#25943,"MAPHAR, TAMAN SARI, JAKARTA BARAT, DKI JAKARTA",33,189,15,204
https://kawalpemilu.org#25943,"MAPHAR, TAMAN SARI, JAKARTA BARAT, DKI JAKARTA",34,130,85,215
https://kawalpemilu.org#25943,"MAPHAR, TAMAN SARI, JAKARTA BARAT, DKI JAKARTA",35,146,77,223
https://kawalpemilu.org#25943,"MAPHAR, TAMAN SARI, JAKARTA BARAT, DKI JAKARTA",36,100,119,219
https://kawalpemilu.org#25943,"MAPHAR, TAMAN SARI, JAKARTA BARAT, DKI JAKARTA",37,92,129,221
https://kawalpemilu.org#25943,"MAPHAR, TAMAN SARI, JAKARTA BARAT, DKI JAKARTA",38,161,19,180
https://kawalpemilu.org#25943,"MAPHAR, TAMAN SARI, JAKARTA BARAT, DKI JAKARTA",39,122,35,157
https://kawalpemilu.org#25943,"MAPHAR, TAMAN SARI, JAKARTA BARAT, DKI JAKARTA",40,89,53,142
https://kawalpemilu.org#25943,"MAPHAR, TAMAN SARI, JAKARTA BARAT, DKI JAKARTA",41,54,84,138
https://kawalpemilu.org#25943,"MAPHAR, TAMAN SARI, JAKARTA BARAT, DKI JAKARTA",42,57,144,201
https://kawalpemilu.org#25943,"MAPHAR, TAMAN SARI, JAKARTA BARAT, DKI JAKARTA",43,62,130,192
https://kawalpemilu.org#25943,"MAPHAR, TAMAN SARI, JAKARTA BARAT, DKI JAKARTA",44,112,70,182
https://kawalpemilu.org#25943,"MAPHAR, TAMAN SARI, JAKARTA BARAT, DKI JAKARTA",45,186,32,218
https://kawalpemilu.org#25943,"MAPHAR, TAMAN SARI, JAKARTA BARAT, DKI JAKARTA",46,142,26,168
https://kawalpemilu.org#25943,"MAPHAR, TAMAN SARI, JAKARTA BARAT, DKI JAKARTA",47,150,41,191
https://kawalpemilu.org#25943,"MAPHAR, TAMAN SARI, JAKARTA BARAT, DKI JAKARTA",48,143,31,174
https://kawalpemilu.org#25943,"MAPHAR, TAMAN SARI, JAKARTA BARAT, DKI JAKARTA",49,110,85,195
https://kawalpemilu.org#25943,"MAPHAR, TAMAN SARI, JAKARTA BARAT, DKI JAKARTA",50,87,117,204
https://kawalpemilu.org#25943,"MAPHAR, TAMAN SARI, JAKARTA BARAT, DKI JAKARTA",51,62,126,188
https://kawalpemilu.org#25943,"MAPHAR, TAMAN SARI, JAKARTA BARAT, DKI JAKARTA",52,74,111,185
https://kawalpemilu.org#25943,"MAPHAR, TAMAN SARI, JAKARTA BARAT, DKI JAKARTA",53,69,113,182
https://kawalpemilu.org#25943,"MAPHAR, TAMAN SARI, JAKARTA BARAT, DKI JAKARTA",54,126,69,195
https://kawalpemilu.org#25943,"MAPHAR, TAMAN SARI, JAKARTA BARAT, DKI JAKARTA",55,112,91,203
https://kawalpemilu.org#25943,"MAPHAR, TAMAN SARI, JAKARTA BARAT, DKI JAKARTA",56,98,77,175
https://kawalpemilu.org#25943,"MAPHAR, TAMAN SARI, JAKARTA BARAT, DKI JAKARTA",57,105,32,137
https://kawalpemilu.org#25943,"MAPHAR, TAMAN SARI, JAKARTA BARAT, DKI JAKARTA",58,65,111,176
https://kawalpemilu.org#25944,"TANGKI, TAMAN SARI, JAKARTA BARAT, DKI JAKARTA",1,207,27,234
https://kawalpemilu.org#25944,"TANGKI, TAMAN SARI, JAKARTA BARAT, DKI JAKARTA",2,177,56,233
https://kawalpemilu.org#25944,"TANGKI, TAMAN SARI, JAKARTA BARAT, DKI JAKARTA",3,149,88,237
https://kawalpemilu.org#25944,"TANGKI, TAMAN SARI, JAKARTA BARAT, DKI JAKARTA",4,154,50,204
https://kawalpemilu.org#25944,"TANGKI, TAMAN SARI, JAKARTA BARAT, DKI JAKARTA",5,200,7,207
https://kawalpemilu.org#25944,"TANGKI, TAMAN SARI, JAKARTA BARAT, DKI JAKARTA",6,191,11,202
https://kawalpemilu.org#25944,"TANGKI, TAMAN SARI, JAKARTA BARAT, DKI JAKARTA",7,162,12,174
https://kawalpemilu.org#25944,"TANGKI, TAMAN SARI, JAKARTA BARAT, DKI JAKARTA",8,203,20,223
https://kawalpemilu.org#25944,"TANGKI, TAMAN SARI, JAKARTA BARAT, DKI JAKARTA",9,219,5,224
https://kawalpemilu.org#25944,"TANGKI, TAMAN SARI, JAKARTA BARAT, DKI JAKARTA",10,186,56,242
https://kawalpemilu.org#25944,"TANGKI, TAMAN SARI, JAKARTA BARAT, DKI JAKARTA",11,187,43,230
https://kawalpemilu.org#25944,"TANGKI, TAMAN SARI, JAKARTA BARAT, DKI JAKARTA",12,191,52,243
https://kawalpemilu.org#25944,"TANGKI, TAMAN SARI, JAKARTA BARAT, DKI JAKARTA",13,141,16,157
https://kawalpemilu.org#25944,"TANGKI, TAMAN SARI, JAKARTA BARAT, DKI JAKARTA",14,124,64,188
https://kawalpemilu.org#25944,"TANGKI, TAMAN SARI, JAKARTA BARAT, DKI JAKARTA",15,155,107,262
https://kawalpemilu.org#25944,"TANGKI, TAMAN SARI, JAKARTA BARAT, DKI JAKARTA",16,95,149,244
https://kawalpemilu.org#25944,"TANGKI, TAMAN SARI, JAKARTA BARAT, DKI JAKARTA",17,140,62,202
https://kawalpemilu.org#25944,"TANGKI, TAMAN SARI, JAKARTA BARAT, DKI JAKARTA",18,216,22,238
https://kawalpemilu.org#25944,"TANGKI, TAMAN SARI, JAKARTA BARAT, DKI JAKARTA",19,153,59,212
https://kawalpemilu.org#25944,"TANGKI, TAMAN SARI, JAKARTA BARAT, DKI JAKARTA",20,119,109,228
https://kawalpemilu.org#25944,"TANGKI, TAMAN SARI, JAKARTA BARAT, DKI JAKARTA",21,125,115,240
https://kawalpemilu.org#25944,"TANGKI, TAMAN SARI, JAKARTA BARAT, DKI JAKARTA",22,193,42,235
https://kawalpemilu.org#25944,"TANGKI, TAMAN SARI, JAKARTA BARAT, DKI JAKARTA",23,213,42,255
https://kawalpemilu.org#25944,"TANGKI, TAMAN SARI, JAKARTA BARAT, DKI JAKARTA",24,219,29,248
https://kawalpemilu.org#25944,"TANGKI, TAMAN SARI, JAKARTA BARAT, DKI JAKARTA",25,170,73,243
https://kawalpemilu.org#25944,"TANGKI, TAMAN SARI, JAKARTA BARAT, DKI JAKARTA",26,152,44,196
https://kawalpemilu.org#25944,"TANGKI, TAMAN SARI, JAKARTA BARAT, DKI JAKARTA",27,187,32,219
https://kawalpemilu.org#25944,"TANGKI, TAMAN SARI, JAKARTA BARAT, DKI JAKARTA",28,227,33,260
https://kawalpemilu.org#25944,"TANGKI, TAMAN SARI, JAKARTA BARAT, DKI JAKARTA",29,200,62,262
https://kawalpemilu.org#25944,"TANGKI, TAMAN SARI, JAKARTA BARAT, DKI JAKARTA",30,200,47,247
https://kawalpemilu.org#25944,"TANGKI, TAMAN SARI, JAKARTA BARAT, DKI JAKARTA",31,154,103,257
https://kawalpemilu.org#25944,"TANGKI, TAMAN SARI, JAKARTA BARAT, DKI JAKARTA",32,185,50,235
https://kawalpemilu.org#25944,"TANGKI, TAMAN SARI, JAKARTA BARAT, DKI JAKARTA",33,160,42,202
https://kawalpemilu.org#25944,"TANGKI, TAMAN SARI, JAKARTA BARAT, DKI JAKARTA",34,173,39,212
https://kawalpemilu.org#25944,"TANGKI, TAMAN SARI, JAKARTA BARAT, DKI JAKARTA",35,165,93,258
https://kawalpemilu.org#25944,"TANGKI, TAMAN SARI, JAKARTA BARAT, DKI JAKARTA",36,179,59,238
https://kawalpemilu.org#25944,"TANGKI, TAMAN SARI, JAKARTA BARAT, DKI JAKARTA",37,158,43,201
https://kawalpemilu.org#25944,"TANGKI, TAMAN SARI, JAKARTA BARAT, DKI JAKARTA",38,179,64,243
https://kawalpemilu.org#25944,"TANGKI, TAMAN SARI, JAKARTA BARAT, DKI JAKARTA",39,178,51,229
https://kawalpemilu.org#25944,"TANGKI, TAMAN SARI, JAKARTA BARAT, DKI JAKARTA",40,160,63,223
https://kawalpemilu.org#25944,"TANGKI, TAMAN SARI, JAKARTA BARAT, DKI JAKARTA",41,165,63,228
https://kawalpemilu.org#25944,"TANGKI, TAMAN SARI, JAKARTA BARAT, DKI JAKARTA",42,202,32,234
https://kawalpemilu.org#25945,"MANGGA BESAR, TAMAN SARI, JAKARTA BARAT, DKI JAKARTA",1,208,7,215
https://kawalpemilu.org#25945,"MANGGA BESAR, TAMAN SARI, JAKARTA BARAT, DKI JAKARTA",2,181,27,208
https://kawalpemilu.org#25945,"MANGGA BESAR, TAMAN SARI, JAKARTA BARAT, DKI JAKARTA",3,176,33,209
https://kawalpemilu.org#25945,"MANGGA BESAR, TAMAN SARI, JAKARTA BARAT, DKI JAKARTA",4,145,96,241
https://kawalpemilu.org#25945,"MANGGA BESAR, TAMAN SARI, JAKARTA BARAT, DKI JAKARTA",5,208,22,230
https://kawalpemilu.org#25945,"MANGGA BESAR, TAMAN SARI, JAKARTA BARAT, DKI JAKARTA",6,153,61,214
https://kawalpemilu.org#25945,"MANGGA BESAR, TAMAN SARI, JAKARTA BARAT, DKI JAKARTA",7,172,20,192
https://kawalpemilu.org#25945,"MANGGA BESAR, TAMAN SARI, JAKARTA BARAT, DKI JAKARTA",8,181,7,188
https://kawalpemilu.org#25945,"MANGGA BESAR, TAMAN SARI, JAKARTA BARAT, DKI JAKARTA",9,211,9,220
https://kawalpemilu.org#25945,"MANGGA BESAR, TAMAN SARI, JAKARTA BARAT, DKI JAKARTA",10,211,17,228
https://kawalpemilu.org#25945,"MANGGA BESAR, TAMAN SARI, JAKARTA BARAT, DKI JAKARTA",11,174,41,215
https://kawalpemilu.org#25945,"MANGGA BESAR, TAMAN SARI, JAKARTA BARAT, DKI JAKARTA",12,139,69,208
https://kawalpemilu.org#25945,"MANGGA BESAR, TAMAN SARI, JAKARTA BARAT, DKI JAKARTA",13,172,55,227
https://kawalpemilu.org#25945,"MANGGA BESAR, TAMAN SARI, JAKARTA BARAT, DKI JAKARTA",14,205,6,211
https://kawalpemilu.org#25945,"MANGGA BESAR, TAMAN SARI, JAKARTA BARAT, DKI JAKARTA",15,158,92,250
https://kawalpemilu.org#25945,"MANGGA BESAR, TAMAN SARI, JAKARTA BARAT, DKI JAKARTA",16,146,80,226
https://kawalpemilu.org#25945,"MANGGA BESAR, TAMAN SARI, JAKARTA BARAT, DKI JAKARTA",17,115,94,209
https://kawalpemilu.org#25945,"MANGGA BESAR, TAMAN SARI, JAKARTA BARAT, DKI JAKARTA",18,167,82,249
https://kawalpemilu.org#25945,"MANGGA BESAR, TAMAN SARI, JAKARTA BARAT, DKI JAKARTA",19,85,144,229
https://kawalpemilu.org#25945,"MANGGA BESAR, TAMAN SARI, JAKARTA BARAT, DKI JAKARTA",20,211,52,263
https://kawalpemilu.org#25945,"MANGGA BESAR, TAMAN SARI, JAKARTA BARAT, DKI JAKARTA",21,224,58,282
https://kawalpemilu.org#25945,"MANGGA BESAR, TAMAN SARI, JAKARTA BARAT, DKI JAKARTA",22,217,34,251
https://kawalpemilu.org#25945,"MANGGA BESAR, TAMAN SARI, JAKARTA BARAT, DKI JAKARTA",23,194,91,285
https://kawalpemilu.org#25945,"MANGGA BESAR, TAMAN SARI, JAKARTA BARAT, DKI JAKARTA",24,243,51,294
https://kawalpemilu.org#25946,"KEAGUNGAN, TAMAN SARI, JAKARTA BARAT, DKI JAKARTA",1,118,78,196
https://kawalpemilu.org#25946,"KEAGUNGAN, TAMAN SARI, JAKARTA BARAT, DKI JAKARTA",2,128,76,204
https://kawalpemilu.org#25946,"KEAGUNGAN, TAMAN SARI, JAKARTA BARAT, DKI JAKARTA",3,121,86,207
https://kawalpemilu.org#25946,"KEAGUNGAN, TAMAN SARI, JAKARTA BARAT, DKI JAKARTA",4,168,46,214
https://kawalpemilu.org#25946,"KEAGUNGAN, TAMAN SARI, JAKARTA BARAT, DKI JAKARTA",5,207,31,238
https://kawalpemilu.org#25946,"KEAGUNGAN, TAMAN SARI, JAKARTA BARAT, DKI JAKARTA",6,104,83,187
https://kawalpemilu.org#25946,"KEAGUNGAN, TAMAN SARI, JAKARTA BARAT, DKI JAKARTA",7,134,74,208
https://kawalpemilu.org#25946,"KEAGUNGAN, TAMAN SARI, JAKARTA BARAT, DKI JAKARTA",8,70,127,197
https://kawalpemilu.org#25946,"KEAGUNGAN, TAMAN SARI, JAKARTA BARAT, DKI JAKARTA",9,97,112,209
https://kawalpemilu.org#25946,"KEAGUNGAN, TAMAN SARI, JAKARTA BARAT, DKI JAKARTA",10,113,74,187
https://kawalpemilu.org#25946,"KEAGUNGAN, TAMAN SARI, JAKARTA BARAT, DKI JAKARTA",11,54,159,213
https://kawalpemilu.org#25946,"KEAGUNGAN, TAMAN SARI, JAKARTA BARAT, DKI JAKARTA",12,69,148,217
https://kawalpemilu.org#25946,"KEAGUNGAN, TAMAN SARI, JAKARTA BARAT, DKI JAKARTA",13,64,169,233
https://kawalpemilu.org#25946,"KEAGUNGAN, TAMAN SARI, JAKARTA BARAT, DKI JAKARTA",14,73,146,219
https://kawalpemilu.org#25946,"KEAGUNGAN, TAMAN SARI, JAKARTA BARAT, DKI JAKARTA",15,98,144,242
https://kawalpemilu.org#25946,"KEAGUNGAN, TAMAN SARI, JAKARTA BARAT, DKI JAKARTA",16,130,120,250
https://kawalpemilu.org#25946,"KEAGUNGAN, TAMAN SARI, JAKARTA BARAT, DKI JAKARTA",17,199,9,208
https://kawalpemilu.org#25946,"KEAGUNGAN, TAMAN SARI, JAKARTA BARAT, DKI JAKARTA",18,133,91,224
https://kawalpemilu.org#25946,"KEAGUNGAN, TAMAN SARI, JAKARTA BARAT, DKI JAKARTA",19,82,108,190
https://kawalpemilu.org#25946,"KEAGUNGAN, TAMAN SARI, JAKARTA BARAT, DKI JAKARTA",20,57,152,209
https://kawalpemilu.org#25946,"KEAGUNGAN, TAMAN SARI, JAKARTA BARAT, DKI JAKARTA",21,83,111,194
https://kawalpemilu.org#25946,"KEAGUNGAN, TAMAN SARI, JAKARTA BARAT, DKI JAKARTA",22,187,12,199
https://kawalpemilu.org#25946,"KEAGUNGAN, TAMAN SARI, JAKARTA BARAT, DKI JAKARTA",23,94,91,185
https://kawalpemilu.org#25946,"KEAGUNGAN, TAMAN SARI, JAKARTA BARAT, DKI JAKARTA",24,68,174,215
https://kawalpemilu.org#25946,"KEAGUNGAN, TAMAN SARI, JAKARTA BARAT, DKI JAKARTA",25,76,137,213
https://kawalpemilu.org#25946,"KEAGUNGAN, TAMAN SARI, JAKARTA BARAT, DKI JAKARTA",26,130,112,242
https://kawalpemilu.org#25946,"KEAGUNGAN, TAMAN SARI, JAKARTA BARAT, DKI JAKARTA",27,88,115,203
https://kawalpemilu.org#25946,"KEAGUNGAN, TAMAN SARI, JAKARTA BARAT, DKI JAKARTA",28,116,106,222
https://kawalpemilu.org#25946,"KEAGUNGAN, TAMAN SARI, JAKARTA BARAT, DKI JAKARTA",29,107,113,220
https://kawalpemilu.org#25946,"KEAGUNGAN, TAMAN SARI, JAKARTA BARAT, DKI JAKARTA",30,128,83,211
https://kawalpemilu.org#25946,"KEAGUNGAN, TAMAN SARI, JAKARTA BARAT, DKI JAKARTA",31,110,55,165
https://kawalpemilu.org#25946,"KEAGUNGAN, TAMAN SARI, JAKARTA BARAT, DKI JAKARTA",32,171,68,239
https://kawalpemilu.org#25946,"KEAGUNGAN, TAMAN SARI, JAKARTA BARAT, DKI JAKARTA",33,126,101,227
https://kawalpemilu.org#25946,"KEAGUNGAN, TAMAN SARI, JAKARTA BARAT, DKI JAKARTA",34,82,123,205
https://kawalpemilu.org#25946,"KEAGUNGAN, TAMAN SARI, JAKARTA BARAT, DKI JAKARTA",35,105,110,215
https://kawalpemilu.org#25946,"KEAGUNGAN, TAMAN SARI, JAKARTA BARAT, DKI JAKARTA",36,133,53,186
https://kawalpemilu.org#25946,"KEAGUNGAN, TAMAN SARI, JAKARTA BARAT, DKI JAKARTA",37,102,130,232
https://kawalpemilu.org#25946,"KEAGUNGAN, TAMAN SARI, JAKARTA BARAT, DKI JAKARTA",38,96,107,203
https://kawalpemilu.org#25946,"KEAGUNGAN, TAMAN SARI, JAKARTA BARAT, DKI JAKARTA",39,107,72,179
https://kawalpemilu.org#25946,"KEAGUNGAN, TAMAN SARI, JAKARTA BARAT, DKI JAKARTA",40,198,40,238
https://kawalpemilu.org#25946,"KEAGUNGAN, TAMAN SARI, JAKARTA BARAT, DKI JAKARTA",41,120,114,234
https://kawalpemilu.org#25946,"KEAGUNGAN, TAMAN SARI, JAKARTA BARAT, DKI JAKARTA",42,0,0,0
https://kawalpemilu.org#25946,"KEAGUNGAN, TAMAN SARI, JAKARTA BARAT, DKI JAKARTA",43,147,96,243
https://kawalpemilu.org#25946,"KEAGUNGAN, TAMAN SARI, JAKARTA BARAT, DKI JAKARTA",44,104,123,227
https://kawalpemilu.org#25946,"KEAGUNGAN, TAMAN SARI, JAKARTA BARAT, DKI JAKARTA",45,117,111,228
https://kawalpemilu.org#25946,"KEAGUNGAN, TAMAN SARI, JAKARTA BARAT, DKI JAKARTA",46,149,58,207
https://kawalpemilu.org#25946,"KEAGUNGAN, TAMAN SARI, JAKARTA BARAT, DKI JAKARTA",47,138,84,222
https://kawalpemilu.org#25946,"KEAGUNGAN, TAMAN SARI, JAKARTA BARAT, DKI JAKARTA",48,129,106,235
https://kawalpemilu.org#25946,"KEAGUNGAN, TAMAN SARI, JAKARTA BARAT, DKI JAKARTA",49,54,138,192
https://kawalpemilu.org#25946,"KEAGUNGAN, TAMAN SARI, JAKARTA BARAT, DKI JAKARTA",50,134,92,226
https://kawalpemilu.org#25946,"KEAGUNGAN, TAMAN SARI, JAKARTA BARAT, DKI JAKARTA",51,86,160,246
https://kawalpemilu.org#25946,"KEAGUNGAN, TAMAN SARI, JAKARTA BARAT, DKI JAKARTA",52,93,176,269
https://kawalpemilu.org#25946,"KEAGUNGAN, TAMAN SARI, JAKARTA BARAT, DKI JAKARTA",53,132,105,237
https://kawalpemilu.org#25946,"KEAGUNGAN, TAMAN SARI, JAKARTA BARAT, DKI JAKARTA",54,90,164,254
https://kawalpemilu.org#25946,"KEAGUNGAN, TAMAN SARI, JAKARTA BARAT, DKI JAKARTA",55,85,145,230
https://kawalpemilu.org#25946,"KEAGUNGAN, TAMAN SARI, JAKARTA BARAT, DKI JAKARTA",56,122,108,230
https://kawalpemilu.org#25947,"GLODOK, TAMAN SARI, JAKARTA BARAT, DKI JAKARTA",1,196,10,206
https://kawalpemilu.org#25947,"GLODOK, TAMAN SARI, JAKARTA BARAT, DKI JAKARTA",3,191,8,199
https://kawalpemilu.org#25947,"GLODOK, TAMAN SARI, JAKARTA BARAT, DKI JAKARTA",4,229,4,233
https://kawalpemilu.org#25947,"GLODOK, TAMAN SARI, JAKARTA BARAT, DKI JAKARTA",5,198,4,202
https://kawalpemilu.org#25947,"GLODOK, TAMAN SARI, JAKARTA BARAT, DKI JAKARTA",6,133,37,170
https://kawalpemilu.org#25947,"GLODOK, TAMAN SARI, JAKARTA BARAT, DKI JAKARTA",7,116,83,199
https://kawalpemilu.org#25947,"GLODOK, TAMAN SARI, JAKARTA BARAT, DKI JAKARTA",8,195,19,214
https://kawalpemilu.org#25947,"GLODOK, TAMAN SARI, JAKARTA BARAT, DKI JAKARTA",9,205,10,215
https://kawalpemilu.org#25947,"GLODOK, TAMAN SARI, JAKARTA BARAT, DKI JAKARTA",10,218,12,230
https://kawalpemilu.org#25947,"GLODOK, TAMAN SARI, JAKARTA BARAT, DKI JAKARTA",11,194,6,200
https://kawalpemilu.org#25947,"GLODOK, TAMAN SARI, JAKARTA BARAT, DKI JAKARTA",12,164,61,225
https://kawalpemilu.org#25947,"GLODOK, TAMAN SARI, JAKARTA BARAT, DKI JAKARTA",13,152,69,221
https://kawalpemilu.org#25947,"GLODOK, TAMAN SARI, JAKARTA BARAT, DKI JAKARTA",14,203,11,214
https://kawalpemilu.org#25947,"GLODOK, TAMAN SARI, JAKARTA BARAT, DKI JAKARTA",15,210,5,215
https://kawalpemilu.org#25947,"GLODOK, TAMAN SARI, JAKARTA BARAT, DKI JAKARTA",16,174,17,191
https://kawalpemilu.org#25947,"GLODOK, TAMAN SARI, JAKARTA BARAT, DKI JAKARTA",17,190,5,195
https://kawalpemilu.org#25947,"GLODOK, TAMAN SARI, JAKARTA BARAT, DKI JAKARTA",18,0,0,0
https://kawalpemilu.org#25947,"GLODOK, TAMAN SARI, JAKARTA BARAT, DKI JAKARTA",19,201,6,207
https://kawalpemilu.org#25947,"GLODOK, TAMAN SARI, JAKARTA BARAT, DKI JAKARTA",20,144,33,177
https://kawalpemilu.org#25947,"GLODOK, TAMAN SARI, JAKARTA BARAT, DKI JAKARTA",21,176,4,180
https://kawalpemilu.org#25947,"GLODOK, TAMAN SARI, JAKARTA BARAT, DKI JAKARTA",22,201,8,209
https://kawalpemilu.org#25947,"GLODOK, TAMAN SARI, JAKARTA BARAT, DKI JAKARTA",23,195,2,197
https://kawalpemilu.org#25947,"GLODOK, TAMAN SARI, JAKARTA BARAT, DKI JAKARTA",25,200,31,231
https://kawalpemilu.org#25947,"GLODOK, TAMAN SARI, JAKARTA BARAT, DKI JAKARTA",26,211,12,223
https://kawalpemilu.org#25947,"GLODOK, TAMAN SARI, JAKARTA BARAT, DKI JAKARTA",27,199,3,202
https://kawalpemilu.org#25947,"GLODOK, TAMAN SARI, JAKARTA BARAT, DKI JAKARTA",28,126,64,190
https://kawalpemilu.org#25948,"PINANGSIA, TAMAN SARI, JAKARTA BARAT, DKI JAKARTA",1,175,46,221
https://kawalpemilu.org#25948,"PINANGSIA, TAMAN SARI, JAKARTA BARAT, DKI JAKARTA",2,206,15,221
https://kawalpemilu.org#25948,"PINANGSIA, TAMAN SARI, JAKARTA BARAT, DKI JAKARTA",3,198,18,216
https://kawalpemilu.org#25948,"PINANGSIA, TAMAN SARI, JAKARTA BARAT, DKI JAKARTA",4,184,21,205
https://kawalpemilu.org#25948,"PINANGSIA, TAMAN SARI, JAKARTA BARAT, DKI JAKARTA",5,183,17,200
https://kawalpemilu.org#25948,"PINANGSIA, TAMAN SARI, JAKARTA BARAT, DKI JAKARTA",6,160,42,202
https://kawalpemilu.org#25948,"PINANGSIA, TAMAN SARI, JAKARTA BARAT, DKI JAKARTA",7,231,8,239
https://kawalpemilu.org#25948,"PINANGSIA, TAMAN SARI, JAKARTA BARAT, DKI JAKARTA",8,197,40,237
https://kawalpemilu.org#25948,"PINANGSIA, TAMAN SARI, JAKARTA BARAT, DKI JAKARTA",9,109,111,220
https://kawalpemilu.org#25948,"PINANGSIA, TAMAN SARI, JAKARTA BARAT, DKI JAKARTA",10,80,141,221
https://kawalpemilu.org#25948,"PINANGSIA, TAMAN SARI, JAKARTA BARAT, DKI JAKARTA",11,153,60,213
https://kawalpemilu.org#25948,"PINANGSIA, TAMAN SARI, JAKARTA BARAT, DKI JAKARTA",12,138,51,189
https://kawalpemilu.org#25948,"PINANGSIA, TAMAN SARI, JAKARTA BARAT, DKI JAKARTA",13,142,64,206
https://kawalpemilu.org#25948,"PINANGSIA, TAMAN SARI, JAKARTA BARAT, DKI JAKARTA",14,138,55,193
https://kawalpemilu.org#25948,"PINANGSIA, TAMAN SARI, JAKARTA BARAT, DKI JAKARTA",15,143,55,198
https://kawalpemilu.org#25948,"PINANGSIA, TAMAN SARI, JAKARTA BARAT, DKI JAKARTA",16,140,77,217
https://kawalpemilu.org#25948,"PINANGSIA, TAMAN SARI, JAKARTA BARAT, DKI JAKARTA",17,111,93,204
https://kawalpemilu.org#25948,"PINANGSIA, TAMAN SARI, JAKARTA BARAT, DKI JAKARTA",18,104,84,188
https://kawalpemilu.org#25948,"PINANGSIA, TAMAN SARI, JAKARTA BARAT, DKI JAKARTA",19,167,30,197
https://kawalpemilu.org#25948,"PINANGSIA, TAMAN SARI, JAKARTA BARAT, DKI JAKARTA",20,127,65,192
https://kawalpemilu.org#25948,"PINANGSIA, TAMAN SARI, JAKARTA BARAT, DKI JAKARTA",21,160,26,186
https://kawalpemilu.org#25948,"PINANGSIA, TAMAN SARI, JAKARTA BARAT, DKI JAKARTA",22,194,6,200
https://kawalpemilu.org#25948,"PINANGSIA, TAMAN SARI, JAKARTA BARAT, DKI JAKARTA",23,190,12,202
https://kawalpemilu.org#25948,"PINANGSIA, TAMAN SARI, JAKARTA BARAT, DKI JAKARTA",24,200,7,207
https://kawalpemilu.org#25948,"PINANGSIA, TAMAN SARI, JAKARTA BARAT, DKI JAKARTA",25,193,31,224
https://kawalpemilu.org#25948,"PINANGSIA, TAMAN SARI, JAKARTA BARAT, DKI JAKARTA",26,100,95,195
https://kawalpemilu.org#25948,"PINANGSIA, TAMAN SARI, JAKARTA BARAT, DKI JAKARTA",27,74,180,254
https://kawalpemilu.org#25948,"PINANGSIA, TAMAN SARI, JAKARTA BARAT, DKI JAKARTA",28,88,163,251
https://kawalpemilu.org#25948,"PINANGSIA, TAMAN SARI, JAKARTA BARAT, DKI JAKARTA",29,141,108,249
https://kawalpemilu.org#25948,"PINANGSIA, TAMAN SARI, JAKARTA BARAT, DKI JAKARTA",30,137,116,253
https://kawalpemilu.org#25948,"PINANGSIA, TAMAN SARI, JAKARTA BARAT, DKI JAKARTA",31,128,122,250
https://kawalpemilu.org#25948,"PINANGSIA, TAMAN SARI, JAKARTA BARAT, DKI JAKARTA",32,117,119,236
https://kawalpemilu.org#25948,"PINANGSIA, TAMAN SARI, JAKARTA BARAT, DKI JAKARTA",33,117,120,237
https://kawalpemilu.org#25948,"PINANGSIA, TAMAN SARI, JAKARTA BARAT, DKI JAKARTA",34,125,109,234
https://kawalpemilu.org#25948,"PINANGSIA, TAMAN SARI, JAKARTA BARAT, DKI JAKARTA",35,124,111,235
https://kawalpemilu.org#25950,"TAMBORA, TAMBORA, JAKARTA BARAT, DKI JAKARTA",1,174,3,177
https://kawalpemilu.org#25950,"TAMBORA, TAMBORA, JAKARTA BARAT, DKI JAKARTA",2,186,6,193
https://kawalpemilu.org#25950,"TAMBORA, TAMBORA, JAKARTA BARAT, DKI JAKARTA",3,126,59,185
https://kawalpemilu.org#25950,"TAMBORA, TAMBORA, JAKARTA BARAT, DKI JAKARTA",4,190,2,192
https://kawalpemilu.org#25950,"TAMBORA, TAMBORA, JAKARTA BARAT, DKI JAKARTA",5,106,97,203
https://kawalpemilu.org#25950,"TAMBORA, TAMBORA, JAKARTA BARAT, DKI JAKARTA",6,141,20,161
https://kawalpemilu.org#25950,"TAMBORA, TAMBORA, JAKARTA BARAT, DKI JAKARTA",7,165,23,188
https://kawalpemilu.org#25950,"TAMBORA, TAMBORA, JAKARTA BARAT, DKI JAKARTA",8,175,18,193
https://kawalpemilu.org#25950,"TAMBORA, TAMBORA, JAKARTA BARAT, DKI JAKARTA",9,171,45,216
https://kawalpemilu.org#25950,"TAMBORA, TAMBORA, JAKARTA BARAT, DKI JAKARTA",10,179,17,196
https://kawalpemilu.org#25950,"TAMBORA, TAMBORA, JAKARTA BARAT, DKI JAKARTA",11,161,42,203
https://kawalpemilu.org#25950,"TAMBORA, TAMBORA, JAKARTA BARAT, DKI JAKARTA",12,123,1,124
https://kawalpemilu.org#25950,"TAMBORA, TAMBORA, JAKARTA BARAT, DKI JAKARTA",13,117,12,129
https://kawalpemilu.org#25950,"TAMBORA, TAMBORA, JAKARTA BARAT, DKI JAKARTA",14,53,92,145
https://kawalpemilu.org#25950,"TAMBORA, TAMBORA, JAKARTA BARAT, DKI JAKARTA",15,63,104,167
https://kawalpemilu.org#25950,"TAMBORA, TAMBORA, JAKARTA BARAT, DKI JAKARTA",16,94,60,154
https://kawalpemilu.org#25950,"TAMBORA, TAMBORA, JAKARTA BARAT, DKI JAKARTA",17,85,47,132
https://kawalpemilu.org#25950,"TAMBORA, TAMBORA, JAKARTA BARAT, DKI JAKARTA",18,111,92,203
https://kawalpemilu.org#25950,"TAMBORA, TAMBORA, JAKARTA BARAT, DKI JAKARTA",19,111,76,187
https://kawalpemilu.org#25950,"TAMBORA, TAMBORA, JAKARTA BARAT, DKI JAKARTA",20,88,118,206
https://kawalpemilu.org#25950,"TAMBORA, TAMBORA, JAKARTA BARAT, DKI JAKARTA",21,147,71,218
https://kawalpemilu.org#25950,"TAMBORA, TAMBORA, JAKARTA BARAT, DKI JAKARTA",22,85,84,169
https://kawalpemilu.org#25950,"TAMBORA, TAMBORA, JAKARTA BARAT, DKI JAKARTA",23,97,91,188
https://kawalpemilu.org#25950,"TAMBORA, TAMBORA, JAKARTA BARAT, DKI JAKARTA",24,86,76,162
https://kawalpemilu.org#25950,"TAMBORA, TAMBORA, JAKARTA BARAT, DKI JAKARTA",25,81,109,190
https://kawalpemilu.org#25950,"TAMBORA, TAMBORA, JAKARTA BARAT, DKI JAKARTA",26,79,109,188
https://kawalpemilu.org#25950,"TAMBORA, TAMBORA, JAKARTA BARAT, DKI JAKARTA",27,60,145,205
https://kawalpemilu.org#25950,"TAMBORA, TAMBORA, JAKARTA BARAT, DKI JAKARTA",28,58,150,208
https://kawalpemilu.org#25950,"TAMBORA, TAMBORA, JAKARTA BARAT, DKI JAKARTA",29,81,114,195
https://kawalpemilu.org#25950,"TAMBORA, TAMBORA, JAKARTA BARAT, DKI JAKARTA",30,65,121,186
https://kawalpemilu.org#25950,"TAMBORA, TAMBORA, JAKARTA BARAT, DKI JAKARTA",31,103,96,199
https://kawalpemilu.org#25950,"TAMBORA, TAMBORA, JAKARTA BARAT, DKI JAKARTA",32,75,108,183
https://kawalpemilu.org#25950,"TAMBORA, TAMBORA, JAKARTA BARAT, DKI JAKARTA",33,70,111,181
https://kawalpemilu.org#25950,"TAMBORA, TAMBORA, JAKARTA BARAT, DKI JAKARTA",34,85,84,169
https://kawalpemilu.org#25950,"TAMBORA, TAMBORA, JAKARTA BARAT, DKI JAKARTA",35,88,114,202
https://kawalpemilu.org#25950,"TAMBORA, TAMBORA, JAKARTA BARAT, DKI JAKARTA",36,67,138,205
https://kawalpemilu.org#25950,"TAMBORA, TAMBORA, JAKARTA BARAT, DKI JAKARTA",37,91,85,176
https://kawalpemilu.org#25950,"TAMBORA, TAMBORA, JAKARTA BARAT, DKI JAKARTA",38,73,90,163
https://kawalpemilu.org#25950,"TAMBORA, TAMBORA, JAKARTA BARAT, DKI JAKARTA",39,76,111,187
https://kawalpemilu.org#25950,"TAMBORA, TAMBORA, JAKARTA BARAT, DKI JAKARTA",40,88,95,183
https://kawalpemilu.org#25951,"KALI ANYAR, TAMBORA, JAKARTA BARAT, DKI JAKARTA",1,122,114,236
https://kawalpemilu.org#25951,"KALI ANYAR, TAMBORA, JAKARTA BARAT, DKI JAKARTA",2,110,93,203
https://kawalpemilu.org#25951,"KALI ANYAR, TAMBORA, JAKARTA BARAT, DKI JAKARTA",3,82,82,164
https://kawalpemilu.org#25951,"KALI ANYAR, TAMBORA, JAKARTA BARAT, DKI JAKARTA",4,68,91,159
https://kawalpemilu.org#25951,"KALI ANYAR, TAMBORA, JAKARTA BARAT, DKI JAKARTA",5,62,124,186
https://kawalpemilu.org#25951,"KALI ANYAR, TAMBORA, JAKARTA BARAT, DKI JAKARTA",6,121,98,219
https://kawalpemilu.org#25951,"KALI ANYAR, TAMBORA, JAKARTA BARAT, DKI JAKARTA",7,72,138,210
https://kawalpemilu.org#25951,"KALI ANYAR, TAMBORA, JAKARTA BARAT, DKI JAKARTA",8,83,115,198
https://kawalpemilu.org#25951,"KALI ANYAR, TAMBORA, JAKARTA BARAT, DKI JAKARTA",9,83,108,191
https://kawalpemilu.org#25951,"KALI ANYAR, TAMBORA, JAKARTA BARAT, DKI JAKARTA",10,97,99,196
https://kawalpemilu.org#25951,"KALI ANYAR, TAMBORA, JAKARTA BARAT, DKI JAKARTA",11,105,130,235
https://kawalpemilu.org#25951,"KALI ANYAR, TAMBORA, JAKARTA BARAT, DKI JAKARTA",12,79,120,199
https://kawalpemilu.org#25951,"KALI ANYAR, TAMBORA, JAKARTA BARAT, DKI JAKARTA",13,92,118,210
https://kawalpemilu.org#25951,"KALI ANYAR, TAMBORA, JAKARTA BARAT, DKI JAKARTA",15,115,72,187
https://kawalpemilu.org#25951,"KALI ANYAR, TAMBORA, JAKARTA BARAT, DKI JAKARTA",16,87,111,198
https://kawalpemilu.org#25951,"KALI ANYAR, TAMBORA, JAKARTA BARAT, DKI JAKARTA",17,134,68,202
https://kawalpemilu.org#25951,"KALI ANYAR, TAMBORA, JAKARTA BARAT, DKI JAKARTA",18,121,59,180
https://kawalpemilu.org#25951,"KALI ANYAR, TAMBORA, JAKARTA BARAT, DKI JAKARTA",19,88,52,140
https://kawalpemilu.org#25951,"KALI ANYAR, TAMBORA, JAKARTA BARAT, DKI JAKARTA",20,89,38,127
https://kawalpemilu.org#25951,"KALI ANYAR, TAMBORA, JAKARTA BARAT, DKI JAKARTA",21,135,47,182
https://kawalpemilu.org#25951,"KALI ANYAR, TAMBORA, JAKARTA BARAT, DKI JAKARTA",22,134,32,166
https://kawalpemilu.org#25951,"KALI ANYAR, TAMBORA, JAKARTA BARAT, DKI JAKARTA",23,115,71,186
https://kawalpemilu.org#25951,"KALI ANYAR, TAMBORA, JAKARTA BARAT, DKI JAKARTA",24,83,104,187
https://kawalpemilu.org#25951,"KALI ANYAR, TAMBORA, JAKARTA BARAT, DKI JAKARTA",25,97,93,190
https://kawalpemilu.org#25951,"KALI ANYAR, TAMBORA, JAKARTA BARAT, DKI JAKARTA",26,63,69,132
https://kawalpemilu.org#25951,"KALI ANYAR, TAMBORA, JAKARTA BARAT, DKI JAKARTA",27,108,92,200
https://kawalpemilu.org#25951,"KALI ANYAR, TAMBORA, JAKARTA BARAT, DKI JAKARTA",28,152,23,175
https://kawalpemilu.org#25951,"KALI ANYAR, TAMBORA, JAKARTA BARAT, DKI JAKARTA",29,126,55,181
https://kawalpemilu.org#25951,"KALI ANYAR, TAMBORA, JAKARTA BARAT, DKI JAKARTA",30,117,92,209
https://kawalpemilu.org#25951,"KALI ANYAR, TAMBORA, JAKARTA BARAT, DKI JAKARTA",31,129,76,205
https://kawalpemilu.org#25951,"KALI ANYAR, TAMBORA, JAKARTA BARAT, DKI JAKARTA",32,82,78,160
https://kawalpemilu.org#25951,"KALI ANYAR, TAMBORA, JAKARTA BARAT, DKI JAKARTA",33,67,101,168
https://kawalpemilu.org#25951,"KALI ANYAR, TAMBORA, JAKARTA BARAT, DKI JAKARTA",35,94,84,178
https://kawalpemilu.org#25951,"KALI ANYAR, TAMBORA, JAKARTA BARAT, DKI JAKARTA",36,127,94,221
https://kawalpemilu.org#25951,"KALI ANYAR, TAMBORA, JAKARTA BARAT, DKI JAKARTA",38,97,43,140
https://kawalpemilu.org#25951,"KALI ANYAR, TAMBORA, JAKARTA BARAT, DKI JAKARTA",39,98,20,118
https://kawalpemilu.org#25951,"KALI ANYAR, TAMBORA, JAKARTA BARAT, DKI JAKARTA",41,102,24,126
https://kawalpemilu.org#25951,"KALI ANYAR, TAMBORA, JAKARTA BARAT, DKI JAKARTA",42,115,59,174
https://kawalpemilu.org#25951,"KALI ANYAR, TAMBORA, JAKARTA BARAT, DKI JAKARTA",43,81,86,167
https://kawalpemilu.org#25951,"KALI ANYAR, TAMBORA, JAKARTA BARAT, DKI JAKARTA",44,121,55,176
https://kawalpemilu.org#25951,"KALI ANYAR, TAMBORA, JAKARTA BARAT, DKI JAKARTA",45,122,52,174
https://kawalpemilu.org#25951,"KALI ANYAR, TAMBORA, JAKARTA BARAT, DKI JAKARTA",46,81,88,169
https://kawalpemilu.org#25951,"KALI ANYAR, TAMBORA, JAKARTA BARAT, DKI JAKARTA",47,142,75,217
https://kawalpemilu.org#25951,"KALI ANYAR, TAMBORA, JAKARTA BARAT, DKI JAKARTA",48,140,90,230
https://kawalpemilu.org#25951,"KALI ANYAR, TAMBORA, JAKARTA BARAT, DKI JAKARTA",49,131,81,212
https://kawalpemilu.org#25951,"KALI ANYAR, TAMBORA, JAKARTA BARAT, DKI JAKARTA",50,86,126,212
https://kawalpemilu.org#25951,"KALI ANYAR, TAMBORA, JAKARTA BARAT, DKI JAKARTA",51,54,117,171
https://kawalpemilu.org#25951,"KALI ANYAR, TAMBORA, JAKARTA BARAT, DKI JAKARTA",52,77,128,205
https://kawalpemilu.org#25951,"KALI ANYAR, TAMBORA, JAKARTA BARAT, DKI JAKARTA",53,84,128,212
https://kawalpemilu.org#25951,"KALI ANYAR, TAMBORA, JAKARTA BARAT, DKI JAKARTA",54,72,103,175
https://kawalpemilu.org#25951,"KALI ANYAR, TAMBORA, JAKARTA BARAT, DKI JAKARTA",55,85,116,198
https://kawalpemilu.org#25951,"KALI ANYAR, TAMBORA, JAKARTA BARAT, DKI JAKARTA",56,102,52,154
https://kawalpemilu.org#25951,"KALI ANYAR, TAMBORA, JAKARTA BARAT, DKI JAKARTA",57,96,67,163
https://kawalpemilu.org#25951,"KALI ANYAR, TAMBORA, JAKARTA BARAT, DKI JAKARTA",58,100,60,160
https://kawalpemilu.org#25951,"KALI ANYAR, TAMBORA, JAKARTA BARAT, DKI JAKARTA",59,100,80,180
https://kawalpemilu.org#25951,"KALI ANYAR, TAMBORA, JAKARTA BARAT, DKI JAKARTA",60,105,85,190
https://kawalpemilu.org#25951,"KALI ANYAR, TAMBORA, JAKARTA BARAT, DKI JAKARTA",61,142,94,236
https://kawalpemilu.org#25951,"KALI ANYAR, TAMBORA, JAKARTA BARAT, DKI JAKARTA",62,149,106,255
https://kawalpemilu.org#25951,"KALI ANYAR, TAMBORA, JAKARTA BARAT, DKI JAKARTA",63,93,103,196
https://kawalpemilu.org#25951,"KALI ANYAR, TAMBORA, JAKARTA BARAT, DKI JAKARTA",64,78,83,161
https://kawalpemilu.org#25951,"KALI ANYAR, TAMBORA, JAKARTA BARAT, DKI JAKARTA",65,123,107,230
https://kawalpemilu.org#25951,"KALI ANYAR, TAMBORA, JAKARTA BARAT, DKI JAKARTA",66,157,69,226
https://kawalpemilu.org#25951,"KALI ANYAR, TAMBORA, JAKARTA BARAT, DKI JAKARTA",67,138,93,231
https://kawalpemilu.org#25951,"KALI ANYAR, TAMBORA, JAKARTA BARAT, DKI JAKARTA",68,123,98,221
https://kawalpemilu.org#25951,"KALI ANYAR, TAMBORA, JAKARTA BARAT, DKI JAKARTA",69,93,93,186
https://kawalpemilu.org#25951,"KALI ANYAR, TAMBORA, JAKARTA BARAT, DKI JAKARTA",70,133,75,188
https://kawalpemilu.org#25951,"KALI ANYAR, TAMBORA, JAKARTA BARAT, DKI JAKARTA",71,144,58,202
https://kawalpemilu.org#25951,"KALI ANYAR, TAMBORA, JAKARTA BARAT, DKI JAKARTA",72,123,84,207
https://kawalpemilu.org#25951,"KALI ANYAR, TAMBORA, JAKARTA BARAT, DKI JAKARTA",73,140,67,207
https://kawalpemilu.org#25951,"KALI ANYAR, TAMBORA, JAKARTA BARAT, DKI JAKARTA",74,108,99,207
https://kawalpemilu.org#25951,"KALI ANYAR, TAMBORA, JAKARTA BARAT, DKI JAKARTA",75,106,61,167
https://kawalpemilu.org#25951,"KALI ANYAR, TAMBORA, JAKARTA BARAT, DKI JAKARTA",76,104,62,166
https://kawalpemilu.org#25951,"KALI ANYAR, TAMBORA, JAKARTA BARAT, DKI JAKARTA",77,88,92,180
https://kawalpemilu.org#25951,"KALI ANYAR, TAMBORA, JAKARTA BARAT, DKI JAKARTA",78,93,106,199
https://kawalpemilu.org#25951,"KALI ANYAR, TAMBORA, JAKARTA BARAT, DKI JAKARTA",79,139,76,215
https://kawalpemilu.org#25951,"KALI ANYAR, TAMBORA, JAKARTA BARAT, DKI JAKARTA",80,122,80,202
https://kawalpemilu.org#25951,"KALI ANYAR, TAMBORA, JAKARTA BARAT, DKI JAKARTA",81,105,88,193
https://kawalpemilu.org#25951,"KALI ANYAR, TAMBORA, JAKARTA BARAT, DKI JAKARTA",82,161,48,209
https://kawalpemilu.org#25951,"KALI ANYAR, TAMBORA, JAKARTA BARAT, DKI JAKARTA",83,98,118,216
https://kawalpemilu.org#25951,"KALI ANYAR, TAMBORA, JAKARTA BARAT, DKI JAKARTA",84,134,88,222
https://kawalpemilu.org#25951,"KALI ANYAR, TAMBORA, JAKARTA BARAT, DKI JAKARTA",85,81,85,166
https://kawalpemilu.org#25951,"KALI ANYAR, TAMBORA, JAKARTA BARAT, DKI JAKARTA",86,92,82,174
https://kawalpemilu.org#25952,"DURI UTARA, TAMBORA, JAKARTA BARAT, DKI JAKARTA",1,159,51,210
https://kawalpemilu.org#25952,"DURI UTARA, TAMBORA, JAKARTA BARAT, DKI JAKARTA",2,158,77,235
https://kawalpemilu.org#25952,"DURI UTARA, TAMBORA, JAKARTA BARAT, DKI JAKARTA",3,141,36,177
https://kawalpemilu.org#25952,"DURI UTARA, TAMBORA, JAKARTA BARAT, DKI JAKARTA",4,138,75,213
https://kawalpemilu.org#25952,"DURI UTARA, TAMBORA, JAKARTA BARAT, DKI JAKARTA",5,81,178,259
https://kawalpemilu.org#25952,"DURI UTARA, TAMBORA, JAKARTA BARAT, DKI JAKARTA",6,127,103,230
https://kawalpemilu.org#25952,"DURI UTARA, TAMBORA, JAKARTA BARAT, DKI JAKARTA",7,141,114,255
https://kawalpemilu.org#25952,"DURI UTARA, TAMBORA, JAKARTA BARAT, DKI JAKARTA",8,174,23,197
https://kawalpemilu.org#25952,"DURI UTARA, TAMBORA, JAKARTA BARAT, DKI JAKARTA",9,225,21,246
https://kawalpemilu.org#25952,"DURI UTARA, TAMBORA, JAKARTA BARAT, DKI JAKARTA",10,165,46,211
https://kawalpemilu.org#25952,"DURI UTARA, TAMBORA, JAKARTA BARAT, DKI JAKARTA",11,136,93,229
https://kawalpemilu.org#25952,"DURI UTARA, TAMBORA, JAKARTA BARAT, DKI JAKARTA",12,134,88,222
https://kawalpemilu.org#25952,"DURI UTARA, TAMBORA, JAKARTA BARAT, DKI JAKARTA",13,79,58,137
https://kawalpemilu.org#25952,"DURI UTARA, TAMBORA, JAKARTA BARAT, DKI JAKARTA",14,105,67,172
https://kawalpemilu.org#25952,"DURI UTARA, TAMBORA, JAKARTA BARAT, DKI JAKARTA",15,122,61,183
https://kawalpemilu.org#25952,"DURI UTARA, TAMBORA, JAKARTA BARAT, DKI JAKARTA",16,107,107,214
https://kawalpemilu.org#25952,"DURI UTARA, TAMBORA, JAKARTA BARAT, DKI JAKARTA",17,137,91,228
https://kawalpemilu.org#25952,"DURI UTARA, TAMBORA, JAKARTA BARAT, DKI JAKARTA",18,143,54,197
https://kawalpemilu.org#25952,"DURI UTARA, TAMBORA, JAKARTA BARAT, DKI JAKARTA",19,148,66,214
https://kawalpemilu.org#25952,"DURI UTARA, TAMBORA, JAKARTA BARAT, DKI JAKARTA",20,148,85,233
https://kawalpemilu.org#25952,"DURI UTARA, TAMBORA, JAKARTA BARAT, DKI JAKARTA",21,167,71,238
https://kawalpemilu.org#25952,"DURI UTARA, TAMBORA, JAKARTA BARAT, DKI JAKARTA",22,106,77,183
https://kawalpemilu.org#25952,"DURI UTARA, TAMBORA, JAKARTA BARAT, DKI JAKARTA",23,93,140,233
https://kawalpemilu.org#25952,"DURI UTARA, TAMBORA, JAKARTA BARAT, DKI JAKARTA",24,135,61,196
https://kawalpemilu.org#25952,"DURI UTARA, TAMBORA, JAKARTA BARAT, DKI JAKARTA",25,126,55,181
https://kawalpemilu.org#25952,"DURI UTARA, TAMBORA, JAKARTA BARAT, DKI JAKARTA",26,130,29,159
https://kawalpemilu.org#25952,"DURI UTARA, TAMBORA, JAKARTA BARAT, DKI JAKARTA",27,152,25,177
https://kawalpemilu.org#25952,"DURI UTARA, TAMBORA, JAKARTA BARAT, DKI JAKARTA",28,179,17,196
https://kawalpemilu.org#25952,"DURI UTARA, TAMBORA, JAKARTA BARAT, DKI JAKARTA",29,160,35,195
https://kawalpemilu.org#25952,"DURI UTARA, TAMBORA, JAKARTA BARAT, DKI JAKARTA",30,129,88,217
https://kawalpemilu.org#25952,"DURI UTARA, TAMBORA, JAKARTA BARAT, DKI JAKARTA",31,115,83,198
https://kawalpemilu.org#25952,"DURI UTARA, TAMBORA, JAKARTA BARAT, DKI JAKARTA",32,155,96,251
https://kawalpemilu.org#25952,"DURI UTARA, TAMBORA, JAKARTA BARAT, DKI JAKARTA",33,152,52,204
https://kawalpemilu.org#25952,"DURI UTARA, TAMBORA, JAKARTA BARAT, DKI JAKARTA",34,156,33,189
https://kawalpemilu.org#25952,"DURI UTARA, TAMBORA, JAKARTA BARAT, DKI JAKARTA",35,124,78,202
https://kawalpemilu.org#25952,"DURI UTARA, TAMBORA, JAKARTA BARAT, DKI JAKARTA",36,117,122,239
https://kawalpemilu.org#25952,"DURI UTARA, TAMBORA, JAKARTA BARAT, DKI JAKARTA",37,172,9,181
https://kawalpemilu.org#25952,"DURI UTARA, TAMBORA, JAKARTA BARAT, DKI JAKARTA",38,161,77,238
https://kawalpemilu.org#25952,"DURI UTARA, TAMBORA, JAKARTA BARAT, DKI JAKARTA",39,118,86,204
https://kawalpemilu.org#25952,"DURI UTARA, TAMBORA, JAKARTA BARAT, DKI JAKARTA",40,167,40,207
https://kawalpemilu.org#25952,"DURI UTARA, TAMBORA, JAKARTA BARAT, DKI JAKARTA",41,116,84,200
https://kawalpemilu.org#25952,"DURI UTARA, TAMBORA, JAKARTA BARAT, DKI JAKARTA",42,156,77,233
https://kawalpemilu.org#25952,"DURI UTARA, TAMBORA, JAKARTA BARAT, DKI JAKARTA",43,134,74,208
https://kawalpemilu.org#25952,"DURI UTARA, TAMBORA, JAKARTA BARAT, DKI JAKARTA",44,165,31,196
https://kawalpemilu.org#25952,"DURI UTARA, TAMBORA, JAKARTA BARAT, DKI JAKARTA",45,132,52,184
https://kawalpemilu.org#25952,"DURI UTARA, TAMBORA, JAKARTA BARAT, DKI JAKARTA",46,119,64,183
https://kawalpemilu.org#25952,"DURI UTARA, TAMBORA, JAKARTA BARAT, DKI JAKARTA",47,176,58,234
https://kawalpemilu.org#25952,"DURI UTARA, TAMBORA, JAKARTA BARAT, DKI JAKARTA",48,154,38,192
https://kawalpemilu.org#25952,"DURI UTARA, TAMBORA, JAKARTA BARAT, DKI JAKARTA",49,127,81,208
https://kawalpemilu.org#25952,"DURI UTARA, TAMBORA, JAKARTA BARAT, DKI JAKARTA",50,74,82,156
https://kawalpemilu.org#25952,"DURI UTARA, TAMBORA, JAKARTA BARAT, DKI JAKARTA",51,163,59,222
https://kawalpemilu.org#25952,"DURI UTARA, TAMBORA, JAKARTA BARAT, DKI JAKARTA",52,199,5,204
https://kawalpemilu.org#25952,"DURI UTARA, TAMBORA, JAKARTA BARAT, DKI JAKARTA",53,157,61,218
https://kawalpemilu.org#25952,"DURI UTARA, TAMBORA, JAKARTA BARAT, DKI JAKARTA",54,170,72,242
https://kawalpemilu.org#25952,"DURI UTARA, TAMBORA, JAKARTA BARAT, DKI JAKARTA",55,128,139,267
https://kawalpemilu.org#25952,"DURI UTARA, TAMBORA, JAKARTA BARAT, DKI JAKARTA",56,120,129,249
https://kawalpemilu.org#25952,"DURI UTARA, TAMBORA, JAKARTA BARAT, DKI JAKARTA",57,114,97,211
https://kawalpemilu.org#25952,"DURI UTARA, TAMBORA, JAKARTA BARAT, DKI JAKARTA",58,128,73,201
https://kawalpemilu.org#25952,"DURI UTARA, TAMBORA, JAKARTA BARAT, DKI JAKARTA",59,203,20,223
https://kawalpemilu.org#25952,"DURI UTARA, TAMBORA, JAKARTA BARAT, DKI JAKARTA",60,193,26,219
https://kawalpemilu.org#25952,"DURI UTARA, TAMBORA, JAKARTA BARAT, DKI JAKARTA",61,123,52,175
https://kawalpemilu.org#25952,"DURI UTARA, TAMBORA, JAKARTA BARAT, DKI JAKARTA",62,189,1,190
https://kawalpemilu.org#25952,"DURI UTARA, TAMBORA, JAKARTA BARAT, DKI JAKARTA",63,233,6,239
https://kawalpemilu.org#25952,"DURI UTARA, TAMBORA, JAKARTA BARAT, DKI JAKARTA",64,210,9,219
https://kawalpemilu.org#25952,"DURI UTARA, TAMBORA, JAKARTA BARAT, DKI JAKARTA",65,167,55,222
https://kawalpemilu.org#25953,"TANAH SEREAL, TAMBORA, JAKARTA BARAT, DKI JAKARTA",1,210,28,238
https://kawalpemilu.org#25953,"TANAH SEREAL, TAMBORA, JAKARTA BARAT, DKI JAKARTA",2,114,102,216
https://kawalpemilu.org#25953,"TANAH SEREAL, TAMBORA, JAKARTA BARAT, DKI JAKARTA",3,43,103,146
https://kawalpemilu.org#25953,"TANAH SEREAL, TAMBORA, JAKARTA BARAT, DKI JAKARTA",4,60,93,153
https://kawalpemilu.org#25953,"TANAH SEREAL, TAMBORA, JAKARTA BARAT, DKI JAKARTA",5,125,113,238
https://kawalpemilu.org#25953,"TANAH SEREAL, TAMBORA, JAKARTA BARAT, DKI JAKARTA",6,187,47,234
https://kawalpemilu.org#25953,"TANAH SEREAL, TAMBORA, JAKARTA BARAT, DKI JAKARTA",7,91,127,218
https://kawalpemilu.org#25953,"TANAH SEREAL, TAMBORA, JAKARTA BARAT, DKI JAKARTA",8,138,88,226
https://kawalpemilu.org#25953,"TANAH SEREAL, TAMBORA, JAKARTA BARAT, DKI JAKARTA",9,164,55,219
https://kawalpemilu.org#25953,"TANAH SEREAL, TAMBORA, JAKARTA BARAT, DKI JAKARTA",10,126,41,167
https://kawalpemilu.org#25953,"TANAH SEREAL, TAMBORA, JAKARTA BARAT, DKI JAKARTA",11,110,88,198
https://kawalpemilu.org#25953,"TANAH SEREAL, TAMBORA, JAKARTA BARAT, DKI JAKARTA",12,103,37,140
https://kawalpemilu.org#25953,"TANAH SEREAL, TAMBORA, JAKARTA BARAT, DKI JAKARTA",13,153,63,216
https://kawalpemilu.org#25953,"TANAH SEREAL, TAMBORA, JAKARTA BARAT, DKI JAKARTA",14,157,71,228
https://kawalpemilu.org#25953,"TANAH SEREAL, TAMBORA, JAKARTA BARAT, DKI JAKARTA",15,104,133,237
https://kawalpemilu.org#25953,"TANAH SEREAL, TAMBORA, JAKARTA BARAT, DKI JAKARTA",16,124,105,229
https://kawalpemilu.org#25953,"TANAH SEREAL, TAMBORA, JAKARTA BARAT, DKI JAKARTA",17,32,155,187
https://kawalpemilu.org#25953,"TANAH SEREAL, TAMBORA, JAKARTA BARAT, DKI JAKARTA",18,113,102,215
https://kawalpemilu.org#25953,"TANAH SEREAL, TAMBORA, JAKARTA BARAT, DKI JAKARTA",19,87,117,204
https://kawalpemilu.org#25953,"TANAH SEREAL, TAMBORA, JAKARTA BARAT, DKI JAKARTA",20,149,108,257
https://kawalpemilu.org#25953,"TANAH SEREAL, TAMBORA, JAKARTA BARAT, DKI JAKARTA",21,157,98,255
https://kawalpemilu.org#25953,"TANAH SEREAL, TAMBORA, JAKARTA BARAT, DKI JAKARTA",22,116,138,254
https://kawalpemilu.org#25953,"TANAH SEREAL, TAMBORA, JAKARTA BARAT, DKI JAKARTA",23,161,63,224
https://kawalpemilu.org#25953,"TANAH SEREAL, TAMBORA, JAKARTA BARAT, DKI JAKARTA",24,214,19,233
https://kawalpemilu.org#25953,"TANAH SEREAL, TAMBORA, JAKARTA BARAT, DKI JAKARTA",25,153,59,212
https://kawalpemilu.org#25953,"TANAH SEREAL, TAMBORA, JAKARTA BARAT, DKI JAKARTA",26,189,65,254
https://kawalpemilu.org#25953,"TANAH SEREAL, TAMBORA, JAKARTA BARAT, DKI JAKARTA",27,108,70,178
https://kawalpemilu.org#25953,"TANAH SEREAL, TAMBORA, JAKARTA BARAT, DKI JAKARTA",28,151,85,236
https://kawalpemilu.org#25953,"TANAH SEREAL, TAMBORA, JAKARTA BARAT, DKI JAKARTA",29,145,95,240
https://kawalpemilu.org#25953,"TANAH SEREAL, TAMBORA, JAKARTA BARAT, DKI JAKARTA",30,125,80,205
https://kawalpemilu.org#25953,"TANAH SEREAL, TAMBORA, JAKARTA BARAT, DKI JAKARTA",31,141,77,218
https://kawalpemilu.org#25953,"TANAH SEREAL, TAMBORA, JAKARTA BARAT, DKI JAKARTA",32,207,15,222
https://kawalpemilu.org#25953,"TANAH SEREAL, TAMBORA, JAKARTA BARAT, DKI JAKARTA",33,193,19,212
https://kawalpemilu.org#25953,"TANAH SEREAL, TAMBORA, JAKARTA BARAT, DKI JAKARTA",34,213,19,232
https://kawalpemilu.org#25953,"TANAH SEREAL, TAMBORA, JAKARTA BARAT, DKI JAKARTA",35,204,30,234
https://kawalpemilu.org#25953,"TANAH SEREAL, TAMBORA, JAKARTA BARAT, DKI JAKARTA",36,135,84,219
https://kawalpemilu.org#25953,"TANAH SEREAL, TAMBORA, JAKARTA BARAT, DKI JAKARTA",37,106,94,200
https://kawalpemilu.org#25953,"TANAH SEREAL, TAMBORA, JAKARTA BARAT, DKI JAKARTA",38,89,148,237
https://kawalpemilu.org#25953,"TANAH SEREAL, TAMBORA, JAKARTA BARAT, DKI JAKARTA",39,113,104,217
https://kawalpemilu.org#25953,"TANAH SEREAL, TAMBORA, JAKARTA BARAT, DKI JAKARTA",40,85,160,245
https://kawalpemilu.org#25953,"TANAH SEREAL, TAMBORA, JAKARTA BARAT, DKI JAKARTA",41,165,59,224
https://kawalpemilu.org#25953,"TANAH SEREAL, TAMBORA, JAKARTA BARAT, DKI JAKARTA",42,120,139,259
https://kawalpemilu.org#25953,"TANAH SEREAL, TAMBORA, JAKARTA BARAT, DKI JAKARTA",43,112,131,243
https://kawalpemilu.org#25953,"TANAH SEREAL, TAMBORA, JAKARTA BARAT, DKI JAKARTA",44,141,84,225
https://kawalpemilu.org#25953,"TANAH SEREAL, TAMBORA, JAKARTA BARAT, DKI JAKARTA",45,144,84,228
https://kawalpemilu.org#25953,"TANAH SEREAL, TAMBORA, JAKARTA BARAT, DKI JAKARTA",46,132,116,248
https://kawalpemilu.org#25953,"TANAH SEREAL, TAMBORA, JAKARTA BARAT, DKI JAKARTA",47,174,59,233
https://kawalpemilu.org#25953,"TANAH SEREAL, TAMBORA, JAKARTA BARAT, DKI JAKARTA",48,198,59,257
https://kawalpemilu.org#25953,"TANAH SEREAL, TAMBORA, JAKARTA BARAT, DKI JAKARTA",49,166,74,240
https://kawalpemilu.org#25953,"TANAH SEREAL, TAMBORA, JAKARTA BARAT, DKI JAKARTA",50,159,58,217
https://kawalpemilu.org#25953,"TANAH SEREAL, TAMBORA, JAKARTA BARAT, DKI JAKARTA",51,135,90,225
https://kawalpemilu.org#25953,"TANAH SEREAL, TAMBORA, JAKARTA BARAT, DKI JAKARTA",52,205,45,250
https://kawalpemilu.org#25953,"TANAH SEREAL, TAMBORA, JAKARTA BARAT, DKI JAKARTA",53,168,37,205
https://kawalpemilu.org#25953,"TANAH SEREAL, TAMBORA, JAKARTA BARAT, DKI JAKARTA",54,136,126,262
https://kawalpemilu.org#25953,"TANAH SEREAL, TAMBORA, JAKARTA BARAT, DKI JAKARTA",55,140,126,266
https://kawalpemilu.org#25953,"TANAH SEREAL, TAMBORA, JAKARTA BARAT, DKI JAKARTA",56,116,95,211
https://kawalpemilu.org#25953,"TANAH SEREAL, TAMBORA, JAKARTA BARAT, DKI JAKARTA",57,125,113,238
https://kawalpemilu.org#25953,"TANAH SEREAL, TAMBORA, JAKARTA BARAT, DKI JAKARTA",58,129,99,228
https://kawalpemilu.org#25953,"TANAH SEREAL, TAMBORA, JAKARTA BARAT, DKI JAKARTA",59,191,25,216
https://kawalpemilu.org#25953,"TANAH SEREAL, TAMBORA, JAKARTA BARAT, DKI JAKARTA",60,153,56,209
https://kawalpemilu.org#25953,"TANAH SEREAL, TAMBORA, JAKARTA BARAT, DKI JAKARTA",61,142,78,220
https://kawalpemilu.org#25953,"TANAH SEREAL, TAMBORA, JAKARTA BARAT, DKI JAKARTA",62,91,91,182
https://kawalpemilu.org#25953,"TANAH SEREAL, TAMBORA, JAKARTA BARAT, DKI JAKARTA",63,145,73,218
https://kawalpemilu.org#25953,"TANAH SEREAL, TAMBORA, JAKARTA BARAT, DKI JAKARTA",64,79,99,178
https://kawalpemilu.org#25953,"TANAH SEREAL, TAMBORA, JAKARTA BARAT, DKI JAKARTA",65,136,44,180
https://kawalpemilu.org#25953,"TANAH SEREAL, TAMBORA, JAKARTA BARAT, DKI JAKARTA",66,147,72,219
https://kawalpemilu.org#25953,"TANAH SEREAL, TAMBORA, JAKARTA BARAT, DKI JAKARTA",67,73,113,186
https://kawalpemilu.org#25953,"TANAH SEREAL, TAMBORA, JAKARTA BARAT, DKI JAKARTA",68,160,34,194
https://kawalpemilu.org#25953,"TANAH SEREAL, TAMBORA, JAKARTA BARAT, DKI JAKARTA",69,188,54,242
https://kawalpemilu.org#25953,"TANAH SEREAL, TAMBORA, JAKARTA BARAT, DKI JAKARTA",70,170,67,237
https://kawalpemilu.org#25953,"TANAH SEREAL, TAMBORA, JAKARTA BARAT, DKI JAKARTA",71,131,74,205
https://kawalpemilu.org#25953,"TANAH SEREAL, TAMBORA, JAKARTA BARAT, DKI JAKARTA",72,198,38,236
https://kawalpemilu.org#25953,"TANAH SEREAL, TAMBORA, JAKARTA BARAT, DKI JAKARTA",73,114,143,257
https://kawalpemilu.org#25953,"TANAH SEREAL, TAMBORA, JAKARTA BARAT, DKI JAKARTA",74,85,60,145
https://kawalpemilu.org#25953,"TANAH SEREAL, TAMBORA, JAKARTA BARAT, DKI JAKARTA",75,182,31,213
https://kawalpemilu.org#25953,"TANAH SEREAL, TAMBORA, JAKARTA BARAT, DKI JAKARTA",76,167,57,224
https://kawalpemilu.org#25953,"TANAH SEREAL, TAMBORA, JAKARTA BARAT, DKI JAKARTA",77,187,46,233
https://kawalpemilu.org#25953,"TANAH SEREAL, TAMBORA, JAKARTA BARAT, DKI JAKARTA",78,125,74,199
https://kawalpemilu.org#25953,"TANAH SEREAL, TAMBORA, JAKARTA BARAT, DKI JAKARTA",79,118,89,207
https://kawalpemilu.org#25953,"TANAH SEREAL, TAMBORA, JAKARTA BARAT, DKI JAKARTA",80,169,51,220
https://kawalpemilu.org#25953,"TANAH SEREAL, TAMBORA, JAKARTA BARAT, DKI JAKARTA",81,170,33,203
https://kawalpemilu.org#25953,"TANAH SEREAL, TAMBORA, JAKARTA BARAT, DKI JAKARTA",82,183,41,224
https://kawalpemilu.org#25953,"TANAH SEREAL, TAMBORA, JAKARTA BARAT, DKI JAKARTA",83,136,31,167
https://kawalpemilu.org#25953,"TANAH SEREAL, TAMBORA, JAKARTA BARAT, DKI JAKARTA",84,142,51,193
https://kawalpemilu.org#25953,"TANAH SEREAL, TAMBORA, JAKARTA BARAT, DKI JAKARTA",85,188,47,235
https://kawalpemilu.org#25953,"TANAH SEREAL, TAMBORA, JAKARTA BARAT, DKI JAKARTA",86,125,52,177
https://kawalpemilu.org#25954,"KRENDANG, TAMBORA, JAKARTA BARAT, DKI JAKARTA",1,187,31,218
https://kawalpemilu.org#25954,"KRENDANG, TAMBORA, JAKARTA BARAT, DKI JAKARTA",2,186,11,197
https://kawalpemilu.org#25954,"KRENDANG, TAMBORA, JAKARTA BARAT, DKI JAKARTA",3,178,41,219
https://kawalpemilu.org#25954,"KRENDANG, TAMBORA, JAKARTA BARAT, DKI JAKARTA",4,151,80,231
https://kawalpemilu.org#25954,"KRENDANG, TAMBORA, JAKARTA BARAT, DKI JAKARTA",5,174,44,218
https://kawalpemilu.org#25954,"KRENDANG, TAMBORA, JAKARTA BARAT, DKI JAKARTA",6,178,49,227
https://kawalpemilu.org#25954,"KRENDANG, TAMBORA, JAKARTA BARAT, DKI JAKARTA",7,125,57,182
https://kawalpemilu.org#25954,"KRENDANG, TAMBORA, JAKARTA BARAT, DKI JAKARTA",8,123,116,239
https://kawalpemilu.org#25954,"KRENDANG, TAMBORA, JAKARTA BARAT, DKI JAKARTA",9,153,41,194
https://kawalpemilu.org#25954,"KRENDANG, TAMBORA, JAKARTA BARAT, DKI JAKARTA",10,167,39,206
https://kawalpemilu.org#25954,"KRENDANG, TAMBORA, JAKARTA BARAT, DKI JAKARTA",11,128,101,229
https://kawalpemilu.org#25954,"KRENDANG, TAMBORA, JAKARTA BARAT, DKI JAKARTA",12,124,83,207
https://kawalpemilu.org#25954,"KRENDANG, TAMBORA, JAKARTA BARAT, DKI JAKARTA",13,116,89,205
https://kawalpemilu.org#25954,"KRENDANG, TAMBORA, JAKARTA BARAT, DKI JAKARTA",14,90,127,217
https://kawalpemilu.org#25954,"KRENDANG, TAMBORA, JAKARTA BARAT, DKI JAKARTA",15,125,110,235
https://kawalpemilu.org#25954,"KRENDANG, TAMBORA, JAKARTA BARAT, DKI JAKARTA",16,125,81,206
https://kawalpemilu.org#25954,"KRENDANG, TAMBORA, JAKARTA BARAT, DKI JAKARTA",17,58,137,195
https://kawalpemilu.org#25954,"KRENDANG, TAMBORA, JAKARTA BARAT, DKI JAKARTA",18,117,72,189
https://kawalpemilu.org#25954,"KRENDANG, TAMBORA, JAKARTA BARAT, DKI JAKARTA",19,116,73,189
https://kawalpemilu.org#25954,"KRENDANG, TAMBORA, JAKARTA BARAT, DKI JAKARTA",20,99,102,201
https://kawalpemilu.org#25954,"KRENDANG, TAMBORA, JAKARTA BARAT, DKI JAKARTA",21,101,125,226
https://kawalpemilu.org#25954,"KRENDANG, TAMBORA, JAKARTA BARAT, DKI JAKARTA",22,76,137,213
https://kawalpemilu.org#25954,"KRENDANG, TAMBORA, JAKARTA BARAT, DKI JAKARTA",23,85,108,193
https://kawalpemilu.org#25954,"KRENDANG, TAMBORA, JAKARTA BARAT, DKI JAKARTA",24,125,106,231
https://kawalpemilu.org#25954,"KRENDANG, TAMBORA, JAKARTA BARAT, DKI JAKARTA",25,83,102,185
https://kawalpemilu.org#25954,"KRENDANG, TAMBORA, JAKARTA BARAT, DKI JAKARTA",26,101,124,225
https://kawalpemilu.org#25954,"KRENDANG, TAMBORA, JAKARTA BARAT, DKI JAKARTA",27,114,102,116
https://kawalpemilu.org#25954,"KRENDANG, TAMBORA, JAKARTA BARAT, DKI JAKARTA",28,109,64,173
https://kawalpemilu.org#25954,"KRENDANG, TAMBORA, JAKARTA BARAT, DKI JAKARTA",29,94,111,205
https://kawalpemilu.org#25954,"KRENDANG, TAMBORA, JAKARTA BARAT, DKI JAKARTA",31,101,48,149
https://kawalpemilu.org#25954,"KRENDANG, TAMBORA, JAKARTA BARAT, DKI JAKARTA",33,71,102,173
https://kawalpemilu.org#25954,"KRENDANG, TAMBORA, JAKARTA BARAT, DKI JAKARTA",34,110,148,258
https://kawalpemilu.org#25954,"KRENDANG, TAMBORA, JAKARTA BARAT, DKI JAKARTA",35,111,115,226
https://kawalpemilu.org#25954,"KRENDANG, TAMBORA, JAKARTA BARAT, DKI JAKARTA",36,106,90,196
https://kawalpemilu.org#25954,"KRENDANG, TAMBORA, JAKARTA BARAT, DKI JAKARTA",37,99,110,209
https://kawalpemilu.org#25954,"KRENDANG, TAMBORA, JAKARTA BARAT, DKI JAKARTA",38,76,116,192
https://kawalpemilu.org#25954,"KRENDANG, TAMBORA, JAKARTA BARAT, DKI JAKARTA",39,122,86,202
https://kawalpemilu.org#25954,"KRENDANG, TAMBORA, JAKARTA BARAT, DKI JAKARTA",41,111,83,194
https://kawalpemilu.org#25954,"KRENDANG, TAMBORA, JAKARTA BARAT, DKI JAKARTA",42,76,67,143
https://kawalpemilu.org#25954,"KRENDANG, TAMBORA, JAKARTA BARAT, DKI JAKARTA",43,90,82,172
https://kawalpemilu.org#25954,"KRENDANG, TAMBORA, JAKARTA BARAT, DKI JAKARTA",44,129,58,187
https://kawalpemilu.org#25954,"KRENDANG, TAMBORA, JAKARTA BARAT, DKI JAKARTA",45,124,78,202
https://kawalpemilu.org#25954,"KRENDANG, TAMBORA, JAKARTA BARAT, DKI JAKARTA",46,120,86,206
https://kawalpemilu.org#25954,"KRENDANG, TAMBORA, JAKARTA BARAT, DKI JAKARTA",47,103,96,199
https://kawalpemilu.org#25954,"KRENDANG, TAMBORA, JAKARTA BARAT, DKI JAKARTA",48,56,144,200
https://kawalpemilu.org#25954,"KRENDANG, TAMBORA, JAKARTA BARAT, DKI JAKARTA",49,183,40,223
https://kawalpemilu.org#25954,"KRENDANG, TAMBORA, JAKARTA BARAT, DKI JAKARTA",50,112,76,188
https://kawalpemilu.org#25954,"KRENDANG, TAMBORA, JAKARTA BARAT, DKI JAKARTA",51,78,72,150
https://kawalpemilu.org#25954,"KRENDANG, TAMBORA, JAKARTA BARAT, DKI JAKARTA",52,124,43,167
https://kawalpemilu.org#25954,"KRENDANG, TAMBORA, JAKARTA BARAT, DKI JAKARTA",53,89,55,144
https://kawalpemilu.org#25954,"KRENDANG, TAMBORA, JAKARTA BARAT, DKI JAKARTA",54,149,59,208
https://kawalpemilu.org#25954,"KRENDANG, TAMBORA, JAKARTA BARAT, DKI JAKARTA",55,138,54,192
https://kawalpemilu.org#25954,"KRENDANG, TAMBORA, JAKARTA BARAT, DKI JAKARTA",56,126,45,171
https://kawalpemilu.org#25954,"KRENDANG, TAMBORA, JAKARTA BARAT, DKI JAKARTA",57,106,122,228
https://kawalpemilu.org#25954,"KRENDANG, TAMBORA, JAKARTA BARAT, DKI JAKARTA",58,86,104,190
https://kawalpemilu.org#25954,"KRENDANG, TAMBORA, JAKARTA BARAT, DKI JAKARTA",59,104,50,154
https://kawalpemilu.org#25954,"KRENDANG, TAMBORA, JAKARTA BARAT, DKI JAKARTA",60,171,60,231
https://kawalpemilu.org#25954,"KRENDANG, TAMBORA, JAKARTA BARAT, DKI JAKARTA",61,101,92,193
https://kawalpemilu.org#25954,"KRENDANG, TAMBORA, JAKARTA BARAT, DKI JAKARTA",62,156,35,191
https://kawalpemilu.org#25954,"KRENDANG, TAMBORA, JAKARTA BARAT, DKI JAKARTA",63,117,60,177
https://kawalpemilu.org#25954,"KRENDANG, TAMBORA, JAKARTA BARAT, DKI JAKARTA",64,128,38,166
https://kawalpemilu.org#25954,"KRENDANG, TAMBORA, JAKARTA BARAT, DKI JAKARTA",65,161,27,188
https://kawalpemilu.org#25954,"KRENDANG, TAMBORA, JAKARTA BARAT, DKI JAKARTA",66,139,56,195
https://kawalpemilu.org#25954,"KRENDANG, TAMBORA, JAKARTA BARAT, DKI JAKARTA",67,166,31,197
https://kawalpemilu.org#25954,"KRENDANG, TAMBORA, JAKARTA BARAT, DKI JAKARTA",68,124,16,140
https://kawalpemilu.org#25954,"KRENDANG, TAMBORA, JAKARTA BARAT, DKI JAKARTA",69,167,27,194
https://kawalpemilu.org#25955,"JEMBATAN BESI, TAMBORA, JAKARTA BARAT, DKI JAKARTA",1,139,87,226
https://kawalpemilu.org#25955,"JEMBATAN BESI, TAMBORA, JAKARTA BARAT, DKI JAKARTA",2,116,95,211
https://kawalpemilu.org#25955,"JEMBATAN BESI, TAMBORA, JAKARTA BARAT, DKI JAKARTA",3,88,138,226
https://kawalpemilu.org#25955,"JEMBATAN BESI, TAMBORA, JAKARTA BARAT, DKI JAKARTA",4,83,149,232
https://kawalpemilu.org#25955,"JEMBATAN BESI, TAMBORA, JAKARTA BARAT, DKI JAKARTA",5,91,160,251
https://kawalpemilu.org#25955,"JEMBATAN BESI, TAMBORA, JAKARTA BARAT, DKI JAKARTA",6,141,69,210
https://kawalpemilu.org#25955,"JEMBATAN BESI, TAMBORA, JAKARTA BARAT, DKI JAKARTA",7,165,45,210
https://kawalpemilu.org#25955,"JEMBATAN BESI, TAMBORA, JAKARTA BARAT, DKI JAKARTA",8,74,173,247
https://kawalpemilu.org#25955,"JEMBATAN BESI, TAMBORA, JAKARTA BARAT, DKI JAKARTA",9,91,154,245
https://kawalpemilu.org#25955,"JEMBATAN BESI, TAMBORA, JAKARTA BARAT, DKI JAKARTA",10,86,131,217
https://kawalpemilu.org#25955,"JEMBATAN BESI, TAMBORA, JAKARTA BARAT, DKI JAKARTA",11,91,150,241
https://kawalpemilu.org#25955,"JEMBATAN BESI, TAMBORA, JAKARTA BARAT, DKI JAKARTA",12,132,91,223
https://kawalpemilu.org#25955,"JEMBATAN BESI, TAMBORA, JAKARTA BARAT, DKI JAKARTA",13,117,126,243
https://kawalpemilu.org#25955,"JEMBATAN BESI, TAMBORA, JAKARTA BARAT, DKI JAKARTA",14,136,104,240
https://kawalpemilu.org#25955,"JEMBATAN BESI, TAMBORA, JAKARTA BARAT, DKI JAKARTA",15,105,114,219
https://kawalpemilu.org#25955,"JEMBATAN BESI, TAMBORA, JAKARTA BARAT, DKI JAKARTA",16,99,159,258
https://kawalpemilu.org#25955,"JEMBATAN BESI, TAMBORA, JAKARTA BARAT, DKI JAKARTA",17,93,146,239
https://kawalpemilu.org#25955,"JEMBATAN BESI, TAMBORA, JAKARTA BARAT, DKI JAKARTA",18,99,138,237
https://kawalpemilu.org#25955,"JEMBATAN BESI, TAMBORA, JAKARTA BARAT, DKI JAKARTA",19,85,137,222
https://kawalpemilu.org#25955,"JEMBATAN BESI, TAMBORA, JAKARTA BARAT, DKI JAKARTA",20,151,69,220
https://kawalpemilu.org#25955,"JEMBATAN BESI, TAMBORA, JAKARTA BARAT, DKI JAKARTA",21,73,159,232
https://kawalpemilu.org#25955,"JEMBATAN BESI, TAMBORA, JAKARTA BARAT, DKI JAKARTA",22,126,82,208
https://kawalpemilu.org#25955,"JEMBATAN BESI, TAMBORA, JAKARTA BARAT, DKI JAKARTA",23,78,118,196
https://kawalpemilu.org#25955,"JEMBATAN BESI, TAMBORA, JAKARTA BARAT, DKI JAKARTA",24,88,54,142
https://kawalpemilu.org#25955,"JEMBATAN BESI, TAMBORA, JAKARTA BARAT, DKI JAKARTA",25,92,116,208
https://kawalpemilu.org#25955,"JEMBATAN BESI, TAMBORA, JAKARTA BARAT, DKI JAKARTA",26,97,136,233
https://kawalpemilu.org#25955,"JEMBATAN BESI, TAMBORA, JAKARTA BARAT, DKI JAKARTA",27,95,27,122
https://kawalpemilu.org#25955,"JEMBATAN BESI, TAMBORA, JAKARTA BARAT, DKI JAKARTA",28,98,51,149
https://kawalpemilu.org#25955,"JEMBATAN BESI, TAMBORA, JAKARTA BARAT, DKI JAKARTA",29,128,56,184
https://kawalpemilu.org#25955,"JEMBATAN BESI, TAMBORA, JAKARTA BARAT, DKI JAKARTA",30,142,77,219
https://kawalpemilu.org#25955,"JEMBATAN BESI, TAMBORA, JAKARTA BARAT, DKI JAKARTA",31,64,145,209
https://kawalpemilu.org#25955,"JEMBATAN BESI, TAMBORA, JAKARTA BARAT, DKI JAKARTA",32,106,83,189
https://kawalpemilu.org#25955,"JEMBATAN BESI, TAMBORA, JAKARTA BARAT, DKI JAKARTA",33,135,82,217
https://kawalpemilu.org#25955,"JEMBATAN BESI, TAMBORA, JAKARTA BARAT, DKI JAKARTA",34,92,117,209
https://kawalpemilu.org#25955,"JEMBATAN BESI, TAMBORA, JAKARTA BARAT, DKI JAKARTA",35,107,99,206
https://kawalpemilu.org#25955,"JEMBATAN BESI, TAMBORA, JAKARTA BARAT, DKI JAKARTA",36,140,94,234
https://kawalpemilu.org#25955,"JEMBATAN BESI, TAMBORA, JAKARTA BARAT, DKI JAKARTA",37,169,85,254
https://kawalpemilu.org#25955,"JEMBATAN BESI, TAMBORA, JAKARTA BARAT, DKI JAKARTA",38,137,130,267
https://kawalpemilu.org#25955,"JEMBATAN BESI, TAMBORA, JAKARTA BARAT, DKI JAKARTA",39,95,145,240
https://kawalpemilu.org#25955,"JEMBATAN BESI, TAMBORA, JAKARTA BARAT, DKI JAKARTA",40,76,115,191
https://kawalpemilu.org#25955,"JEMBATAN BESI, TAMBORA, JAKARTA BARAT, DKI JAKARTA",41,73,131,204
https://kawalpemilu.org#25955,"JEMBATAN BESI, TAMBORA, JAKARTA BARAT, DKI JAKARTA",42,112,101,213
https://kawalpemilu.org#25955,"JEMBATAN BESI, TAMBORA, JAKARTA BARAT, DKI JAKARTA",43,38,151,189
https://kawalpemilu.org#25955,"JEMBATAN BESI, TAMBORA, JAKARTA BARAT, DKI JAKARTA",44,74,101,175
https://kawalpemilu.org#25955,"JEMBATAN BESI, TAMBORA, JAKARTA BARAT, DKI JAKARTA",45,100,81,181
https://kawalpemilu.org#25955,"JEMBATAN BESI, TAMBORA, JAKARTA BARAT, DKI JAKARTA",46,140,63,203
https://kawalpemilu.org#25955,"JEMBATAN BESI, TAMBORA, JAKARTA BARAT, DKI JAKARTA",47,183,40,223
https://kawalpemilu.org#25955,"JEMBATAN BESI, TAMBORA, JAKARTA BARAT, DKI JAKARTA",48,196,55,251
https://kawalpemilu.org#25955,"JEMBATAN BESI, TAMBORA, JAKARTA BARAT, DKI JAKARTA",49,152,74,226
https://kawalpemilu.org#25955,"JEMBATAN BESI, TAMBORA, JAKARTA BARAT, DKI JAKARTA",50,179,73,252
https://kawalpemilu.org#25955,"JEMBATAN BESI, TAMBORA, JAKARTA BARAT, DKI JAKARTA",51,97,136,233
https://kawalpemilu.org#25955,"JEMBATAN BESI, TAMBORA, JAKARTA BARAT, DKI JAKARTA",52,152,70,222
https://kawalpemilu.org#25955,"JEMBATAN BESI, TAMBORA, JAKARTA BARAT, DKI JAKARTA",53,112,136,248
https://kawalpemilu.org#25955,"JEMBATAN BESI, TAMBORA, JAKARTA BARAT, DKI JAKARTA",54,130,49,179
https://kawalpemilu.org#25955,"JEMBATAN BESI, TAMBORA, JAKARTA BARAT, DKI JAKARTA",55,117,53,230
https://kawalpemilu.org#25955,"JEMBATAN BESI, TAMBORA, JAKARTA BARAT, DKI JAKARTA",56,118,92,210
https://kawalpemilu.org#25955,"JEMBATAN BESI, TAMBORA, JAKARTA BARAT, DKI JAKARTA",57,144,49,193
https://kawalpemilu.org#25955,"JEMBATAN BESI, TAMBORA, JAKARTA BARAT, DKI JAKARTA",58,119,79,198
https://kawalpemilu.org#25955,"JEMBATAN BESI, TAMBORA, JAKARTA BARAT, DKI JAKARTA",60,172,64,236
https://kawalpemilu.org#25955,"JEMBATAN BESI, TAMBORA, JAKARTA BARAT, DKI JAKARTA",61,97,110,207
https://kawalpemilu.org#25955,"JEMBATAN BESI, TAMBORA, JAKARTA BARAT, DKI JAKARTA",62,97,102,199
https://kawalpemilu.org#25955,"JEMBATAN BESI, TAMBORA, JAKARTA BARAT, DKI JAKARTA",63,88,117,205
https://kawalpemilu.org#25955,"JEMBATAN BESI, TAMBORA, JAKARTA BARAT, DKI JAKARTA",64,107,114,221
https://kawalpemilu.org#25955,"JEMBATAN BESI, TAMBORA, JAKARTA BARAT, DKI JAKARTA",65,117,110,227
https://kawalpemilu.org#25955,"JEMBATAN BESI, TAMBORA, JAKARTA BARAT, DKI JAKARTA",66,112,78,190
https://kawalpemilu.org#25955,"JEMBATAN BESI, TAMBORA, JAKARTA BARAT, DKI JAKARTA",67,146,82,228
https://kawalpemilu.org#25955,"JEMBATAN BESI, TAMBORA, JAKARTA BARAT, DKI JAKARTA",68,123,101,224
https://kawalpemilu.org#25955,"JEMBATAN BESI, TAMBORA, JAKARTA BARAT, DKI JAKARTA",69,94,132,226
https://kawalpemilu.org#25955,"JEMBATAN BESI, TAMBORA, JAKARTA BARAT, DKI JAKARTA",70,141,75,216
https://kawalpemilu.org#25955,"JEMBATAN BESI, TAMBORA, JAKARTA BARAT, DKI JAKARTA",71,119,49,168
https://kawalpemilu.org#25955,"JEMBATAN BESI, TAMBORA, JAKARTA BARAT, DKI JAKARTA",72,113,60,173
https://kawalpemilu.org#25955,"JEMBATAN BESI, TAMBORA, JAKARTA BARAT, DKI JAKARTA",73,96,66,162
https://kawalpemilu.org#25955,"JEMBATAN BESI, TAMBORA, JAKARTA BARAT, DKI JAKARTA",75,118,90,208
https://kawalpemilu.org#25955,"JEMBATAN BESI, TAMBORA, JAKARTA BARAT, DKI JAKARTA",76,103,109,212
https://kawalpemilu.org#25955,"JEMBATAN BESI, TAMBORA, JAKARTA BARAT, DKI JAKARTA",77,125,110,235
https://kawalpemilu.org#25955,"JEMBATAN BESI, TAMBORA, JAKARTA BARAT, DKI JAKARTA",78,110,101,211
https://kawalpemilu.org#25955,"JEMBATAN BESI, TAMBORA, JAKARTA BARAT, DKI JAKARTA",79,73,148,221
https://kawalpemilu.org#25955,"JEMBATAN BESI, TAMBORA, JAKARTA BARAT, DKI JAKARTA",80,103,86,189
https://kawalpemilu.org#25955,"JEMBATAN BESI, TAMBORA, JAKARTA BARAT, DKI JAKARTA",81,130,98,228
https://kawalpemilu.org#25955,"JEMBATAN BESI, TAMBORA, JAKARTA BARAT, DKI JAKARTA",82,87,132,219
https://kawalpemilu.org#25955,"JEMBATAN BESI, TAMBORA, JAKARTA BARAT, DKI JAKARTA",83,109,125,234
https://kawalpemilu.org#25955,"JEMBATAN BESI, TAMBORA, JAKARTA BARAT, DKI JAKARTA",84,68,132,200
https://kawalpemilu.org#25955,"JEMBATAN BESI, TAMBORA, JAKARTA BARAT, DKI JAKARTA",85,95,127,222
https://kawalpemilu.org#25955,"JEMBATAN BESI, TAMBORA, JAKARTA BARAT, DKI JAKARTA",86,95,128,223
https://kawalpemilu.org#25955,"JEMBATAN BESI, TAMBORA, JAKARTA BARAT, DKI JAKARTA",87,97,61,158
https://kawalpemilu.org#25955,"JEMBATAN BESI, TAMBORA, JAKARTA BARAT, DKI JAKARTA",88,102,92,194
https://kawalpemilu.org#25955,"JEMBATAN BESI, TAMBORA, JAKARTA BARAT, DKI JAKARTA",89,67,161,228
https://kawalpemilu.org#25955,"JEMBATAN BESI, TAMBORA, JAKARTA BARAT, DKI JAKARTA",90,102,136,238
https://kawalpemilu.org#25955,"JEMBATAN BESI, TAMBORA, JAKARTA BARAT, DKI JAKARTA",91,109,115,224
https://kawalpemilu.org#25955,"JEMBATAN BESI, TAMBORA, JAKARTA BARAT, DKI JAKARTA",92,92,117,209
https://kawalpemilu.org#25955,"JEMBATAN BESI, TAMBORA, JAKARTA BARAT, DKI JAKARTA",93,143,60,203
https://kawalpemilu.org#25955,"JEMBATAN BESI, TAMBORA, JAKARTA BARAT, DKI JAKARTA",94,98,85,183
https://kawalpemilu.org#25956,"ANGKE, TAMBORA, JAKARTA BARAT, DKI JAKARTA",1,130,100,230
https://kawalpemilu.org#25956,"ANGKE, TAMBORA, JAKARTA BARAT, DKI JAKARTA",2,73,134,207
https://kawalpemilu.org#25956,"ANGKE, TAMBORA, JAKARTA BARAT, DKI JAKARTA",3,38,161,199
https://kawalpemilu.org#25956,"ANGKE, TAMBORA, JAKARTA BARAT, DKI JAKARTA",4,50,167,217
https://kawalpemilu.org#25956,"ANGKE, TAMBORA, JAKARTA BARAT, DKI JAKARTA",5,48,179,227
https://kawalpemilu.org#25956,"ANGKE, TAMBORA, JAKARTA BARAT, DKI JAKARTA",6,90,142,232
https://kawalpemilu.org#25956,"ANGKE, TAMBORA, JAKARTA BARAT, DKI JAKARTA",7,77,132,209
https://kawalpemilu.org#25956,"ANGKE, TAMBORA, JAKARTA BARAT, DKI JAKARTA",8,84,130,214
https://kawalpemilu.org#25956,"ANGKE, TAMBORA, JAKARTA BARAT, DKI JAKARTA",9,82,106,188
https://kawalpemilu.org#25956,"ANGKE, TAMBORA, JAKARTA BARAT, DKI JAKARTA",10,108,56,164
https://kawalpemilu.org#25956,"ANGKE, TAMBORA, JAKARTA BARAT, DKI JAKARTA",11,40,135,175
https://kawalpemilu.org#25956,"ANGKE, TAMBORA, JAKARTA BARAT, DKI JAKARTA",12,71,128,199
https://kawalpemilu.org#25956,"ANGKE, TAMBORA, JAKARTA BARAT, DKI JAKARTA",13,89,131,220
https://kawalpemilu.org#25956,"ANGKE, TAMBORA, JAKARTA BARAT, DKI JAKARTA",14,114,129,243
https://kawalpemilu.org#25956,"ANGKE, TAMBORA, JAKARTA BARAT, DKI JAKARTA",15,81,137,218
https://kawalpemilu.org#25956,"ANGKE, TAMBORA, JAKARTA BARAT, DKI JAKARTA",16,81,156,237
https://kawalpemilu.org#25956,"ANGKE, TAMBORA, JAKARTA BARAT, DKI JAKARTA",17,77,160,237
https://kawalpemilu.org#25956,"ANGKE, TAMBORA, JAKARTA BARAT, DKI JAKARTA",18,151,28,179
https://kawalpemilu.org#25956,"ANGKE, TAMBORA, JAKARTA BARAT, DKI JAKARTA",19,176,11,187
https://kawalpemilu.org#25956,"ANGKE, TAMBORA, JAKARTA BARAT, DKI JAKARTA",20,150,13,163
https://kawalpemilu.org#25956,"ANGKE, TAMBORA, JAKARTA BARAT, DKI JAKARTA",21,187,49,236
https://kawalpemilu.org#25956,"ANGKE, TAMBORA, JAKARTA BARAT, DKI JAKARTA",22,65,134,199
https://kawalpemilu.org#25956,"ANGKE, TAMBORA, JAKARTA BARAT, DKI JAKARTA",23,59,141,200
https://kawalpemilu.org#25956,"ANGKE, TAMBORA, JAKARTA BARAT, DKI JAKARTA",24,51,143,0
https://kawalpemilu.org#25956,"ANGKE, TAMBORA, JAKARTA BARAT, DKI JAKARTA",25,66,131,197
https://kawalpemilu.org#25956,"ANGKE, TAMBORA, JAKARTA BARAT, DKI JAKARTA",26,81,143,224
https://kawalpemilu.org#25956,"ANGKE, TAMBORA, JAKARTA BARAT, DKI JAKARTA",27,67,165,232
https://kawalpemilu.org#25956,"ANGKE, TAMBORA, JAKARTA BARAT, DKI JAKARTA",28,62,116,178
https://kawalpemilu.org#25956,"ANGKE, TAMBORA, JAKARTA BARAT, DKI JAKARTA",29,54,115,169
https://kawalpemilu.org#25956,"ANGKE, TAMBORA, JAKARTA BARAT, DKI JAKARTA",30,186,33,219
https://kawalpemilu.org#25956,"ANGKE, TAMBORA, JAKARTA BARAT, DKI JAKARTA",31,204,4,208
https://kawalpemilu.org#25956,"ANGKE, TAMBORA, JAKARTA BARAT, DKI JAKARTA",32,199,9,208
https://kawalpemilu.org#25956,"ANGKE, TAMBORA, JAKARTA BARAT, DKI JAKARTA",33,229,17,246
https://kawalpemilu.org#25956,"ANGKE, TAMBORA, JAKARTA BARAT, DKI JAKARTA",34,235,9,244
https://kawalpemilu.org#25956,"ANGKE, TAMBORA, JAKARTA BARAT, DKI JAKARTA",35,207,7,214
https://kawalpemilu.org#25956,"ANGKE, TAMBORA, JAKARTA BARAT, DKI JAKARTA",36,206,2,208
https://kawalpemilu.org#25956,"ANGKE, TAMBORA, JAKARTA BARAT, DKI JAKARTA",37,198,22,220
https://kawalpemilu.org#25956,"ANGKE, TAMBORA, JAKARTA BARAT, DKI JAKARTA",39,153,64,217
https://kawalpemilu.org#25956,"ANGKE, TAMBORA, JAKARTA BARAT, DKI JAKARTA",40,159,50,209
https://kawalpemilu.org#25956,"ANGKE, TAMBORA, JAKARTA BARAT, DKI JAKARTA",41,149,66,215
https://kawalpemilu.org#25956,"ANGKE, TAMBORA, JAKARTA BARAT, DKI JAKARTA",42,205,27,232
https://kawalpemilu.org#25956,"ANGKE, TAMBORA, JAKARTA BARAT, DKI JAKARTA",43,187,45,232
https://kawalpemilu.org#25956,"ANGKE, TAMBORA, JAKARTA BARAT, DKI JAKARTA",44,226,3,229
https://kawalpemilu.org#25956,"ANGKE, TAMBORA, JAKARTA BARAT, DKI JAKARTA",45,197,10,207
https://kawalpemilu.org#25956,"ANGKE, TAMBORA, JAKARTA BARAT, DKI JAKARTA",46,180,15,195
https://kawalpemilu.org#25956,"ANGKE, TAMBORA, JAKARTA BARAT, DKI JAKARTA",47,205,30,235
https://kawalpemilu.org#25956,"ANGKE, TAMBORA, JAKARTA BARAT, DKI JAKARTA",48,204,27,231
https://kawalpemilu.org#25956,"ANGKE, TAMBORA, JAKARTA BARAT, DKI JAKARTA",49,161,70,231
https://kawalpemilu.org#25956,"ANGKE, TAMBORA, JAKARTA BARAT, DKI JAKARTA",50,126,49,175
https://kawalpemilu.org#25956,"ANGKE, TAMBORA, JAKARTA BARAT, DKI JAKARTA",51,141,31,172
https://kawalpemilu.org#25956,"ANGKE, TAMBORA, JAKARTA BARAT, DKI JAKARTA",52,221,7,228
https://kawalpemilu.org#25956,"ANGKE, TAMBORA, JAKARTA BARAT, DKI JAKARTA",53,182,30,212
https://kawalpemilu.org#25956,"ANGKE, TAMBORA, JAKARTA BARAT, DKI JAKARTA",54,71,144,215
https://kawalpemilu.org#25956,"ANGKE, TAMBORA, JAKARTA BARAT, DKI JAKARTA",55,52,174,226
https://kawalpemilu.org#25956,"ANGKE, TAMBORA, JAKARTA BARAT, DKI JAKARTA",56,83,153,236
https://kawalpemilu.org#25956,"ANGKE, TAMBORA, JAKARTA BARAT, DKI JAKARTA",57,197,25,222
https://kawalpemilu.org#25956,"ANGKE, TAMBORA, JAKARTA BARAT, DKI JAKARTA",58,129,69,198
https://kawalpemilu.org#25956,"ANGKE, TAMBORA, JAKARTA BARAT, DKI JAKARTA",59,189,6,195
https://kawalpemilu.org#25956,"ANGKE, TAMBORA, JAKARTA BARAT, DKI JAKARTA",60,192,1,193
https://kawalpemilu.org#25956,"ANGKE, TAMBORA, JAKARTA BARAT, DKI JAKARTA",61,146,72,218
https://kawalpemilu.org#25956,"ANGKE, TAMBORA, JAKARTA BARAT, DKI JAKARTA",62,142,86,228
https://kawalpemilu.org#25956,"ANGKE, TAMBORA, JAKARTA BARAT, DKI JAKARTA",63,80,116,196
https://kawalpemilu.org#25956,"ANGKE, TAMBORA, JAKARTA BARAT, DKI JAKARTA",64,173,72,245
https://kawalpemilu.org#25956,"ANGKE, TAMBORA, JAKARTA BARAT, DKI JAKARTA",65,117,121,238
https://kawalpemilu.org#25956,"ANGKE, TAMBORA, JAKARTA BARAT, DKI JAKARTA",66,157,78,235
https://kawalpemilu.org#25956,"ANGKE, TAMBORA, JAKARTA BARAT, DKI JAKARTA",67,194,39,233
https://kawalpemilu.org#25956,"ANGKE, TAMBORA, JAKARTA BARAT, DKI JAKARTA",68,188,30,218
https://kawalpemilu.org#25956,"ANGKE, TAMBORA, JAKARTA BARAT, DKI JAKARTA",69,92,105,197
https://kawalpemilu.org#25956,"ANGKE, TAMBORA, JAKARTA BARAT, DKI JAKARTA",70,102,69,171
https://kawalpemilu.org#25956,"ANGKE, TAMBORA, JAKARTA BARAT, DKI JAKARTA",71,120,70,190
https://kawalpemilu.org#25956,"ANGKE, TAMBORA, JAKARTA BARAT, DKI JAKARTA",72,147,28,175
https://kawalpemilu.org#25956,"ANGKE, TAMBORA, JAKARTA BARAT, DKI JAKARTA",73,189,3,192
https://kawalpemilu.org#25956,"ANGKE, TAMBORA, JAKARTA BARAT, DKI JAKARTA",74,250,8,258
https://kawalpemilu.org#25956,"ANGKE, TAMBORA, JAKARTA BARAT, DKI JAKARTA",75,176,13,189
https://kawalpemilu.org#25956,"ANGKE, TAMBORA, JAKARTA BARAT, DKI JAKARTA",76,190,10,200
https://kawalpemilu.org#25956,"ANGKE, TAMBORA, JAKARTA BARAT, DKI JAKARTA",77,164,64,228
https://kawalpemilu.org#25956,"ANGKE, TAMBORA, JAKARTA BARAT, DKI JAKARTA",78,146,92,238
https://kawalpemilu.org#25956,"ANGKE, TAMBORA, JAKARTA BARAT, DKI JAKARTA",79,152,87,239
https://kawalpemilu.org#25956,"ANGKE, TAMBORA, JAKARTA BARAT, DKI JAKARTA",80,155,79,234
https://kawalpemilu.org#25956,"ANGKE, TAMBORA, JAKARTA BARAT, DKI JAKARTA",81,85,102,187
https://kawalpemilu.org#25956,"ANGKE, TAMBORA, JAKARTA BARAT, DKI JAKARTA",82,86,63,149
https://kawalpemilu.org#25956,"ANGKE, TAMBORA, JAKARTA BARAT, DKI JAKARTA",83,88,106,194
https://kawalpemilu.org#25956,"ANGKE, TAMBORA, JAKARTA BARAT, DKI JAKARTA",84,122,65,187
https://kawalpemilu.org#25956,"ANGKE, TAMBORA, JAKARTA BARAT, DKI JAKARTA",85,97,112,209
https://kawalpemilu.org#25956,"ANGKE, TAMBORA, JAKARTA BARAT, DKI JAKARTA",86,124,75,199
https://kawalpemilu.org#25956,"ANGKE, TAMBORA, JAKARTA BARAT, DKI JAKARTA",87,176,63,239
https://kawalpemilu.org#25956,"ANGKE, TAMBORA, JAKARTA BARAT, DKI JAKARTA",88,134,118,252
https://kawalpemilu.org#25956,"ANGKE, TAMBORA, JAKARTA BARAT, DKI JAKARTA",89,120,88,208
https://kawalpemilu.org#25956,"ANGKE, TAMBORA, JAKARTA BARAT, DKI JAKARTA",90,133,122,255
https://kawalpemilu.org#25956,"ANGKE, TAMBORA, JAKARTA BARAT, DKI JAKARTA",91,72,121,193
https://kawalpemilu.org#25956,"ANGKE, TAMBORA, JAKARTA BARAT, DKI JAKARTA",92,81,127,208
https://kawalpemilu.org#25956,"ANGKE, TAMBORA, JAKARTA BARAT, DKI JAKARTA",93,102,136,238
https://kawalpemilu.org#25956,"ANGKE, TAMBORA, JAKARTA BARAT, DKI JAKARTA",94,102,71,173
https://kawalpemilu.org#25956,"ANGKE, TAMBORA, JAKARTA BARAT, DKI JAKARTA",95,96,127,223
https://kawalpemilu.org#25956,"ANGKE, TAMBORA, JAKARTA BARAT, DKI JAKARTA",96,84,120,204
https://kawalpemilu.org#25956,"ANGKE, TAMBORA, JAKARTA BARAT, DKI JAKARTA",97,99,81,180
https://kawalpemilu.org#25956,"ANGKE, TAMBORA, JAKARTA BARAT, DKI JAKARTA",98,133,37,170
https://kawalpemilu.org#25956,"ANGKE, TAMBORA, JAKARTA BARAT, DKI JAKARTA",99,167,58,225
https://kawalpemilu.org#25957,"JEMBATAN LIMA, TAMBORA, JAKARTA BARAT, DKI JAKARTA",1,181,33,214
https://kawalpemilu.org#25957,"JEMBATAN LIMA, TAMBORA, JAKARTA BARAT, DKI JAKARTA",2,88,110,198
https://kawalpemilu.org#25957,"JEMBATAN LIMA, TAMBORA, JAKARTA BARAT, DKI JAKARTA",3,120,72,192
https://kawalpemilu.org#25957,"JEMBATAN LIMA, TAMBORA, JAKARTA BARAT, DKI JAKARTA",4,89,132,222
https://kawalpemilu.org#25957,"JEMBATAN LIMA, TAMBORA, JAKARTA BARAT, DKI JAKARTA",5,102,97,199
https://kawalpemilu.org#25957,"JEMBATAN LIMA, TAMBORA, JAKARTA BARAT, DKI JAKARTA",6,71,59,130
https://kawalpemilu.org#25957,"JEMBATAN LIMA, TAMBORA, JAKARTA BARAT, DKI JAKARTA",7,80,119,199
https://kawalpemilu.org#25957,"JEMBATAN LIMA, TAMBORA, JAKARTA BARAT, DKI JAKARTA",8,164,17,181
https://kawalpemilu.org#25957,"JEMBATAN LIMA, TAMBORA, JAKARTA BARAT, DKI JAKARTA",9,188,22,210
https://kawalpemilu.org#25957,"JEMBATAN LIMA, TAMBORA, JAKARTA BARAT, DKI JAKARTA",10,149,61,210
https://kawalpemilu.org#25957,"JEMBATAN LIMA, TAMBORA, JAKARTA BARAT, DKI JAKARTA",11,144,39,183
https://kawalpemilu.org#25957,"JEMBATAN LIMA, TAMBORA, JAKARTA BARAT, DKI JAKARTA",12,189,13,202
https://kawalpemilu.org#25957,"JEMBATAN LIMA, TAMBORA, JAKARTA BARAT, DKI JAKARTA",13,164,35,199
https://kawalpemilu.org#25957,"JEMBATAN LIMA, TAMBORA, JAKARTA BARAT, DKI JAKARTA",14,176,44,220
https://kawalpemilu.org#25957,"JEMBATAN LIMA, TAMBORA, JAKARTA BARAT, DKI JAKARTA",15,207,29,236
https://kawalpemilu.org#25957,"JEMBATAN LIMA, TAMBORA, JAKARTA BARAT, DKI JAKARTA",16,148,64,212
https://kawalpemilu.org#25957,"JEMBATAN LIMA, TAMBORA, JAKARTA BARAT, DKI JAKARTA",17,251,126,377
https://kawalpemilu.org#25957,"JEMBATAN LIMA, TAMBORA, JAKARTA BARAT, DKI JAKARTA",18,142,85,227
https://kawalpemilu.org#25957,"JEMBATAN LIMA, TAMBORA, JAKARTA BARAT, DKI JAKARTA",19,157,75,232
https://kawalpemilu.org#25957,"JEMBATAN LIMA, TAMBORA, JAKARTA BARAT, DKI JAKARTA",20,220,27,247
https://kawalpemilu.org#25957,"JEMBATAN LIMA, TAMBORA, JAKARTA BARAT, DKI JAKARTA",21,174,32,206
https://kawalpemilu.org#25957,"JEMBATAN LIMA, TAMBORA, JAKARTA BARAT, DKI JAKARTA",22,142,103,245
https://kawalpemilu.org#25957,"JEMBATAN LIMA, TAMBORA, JAKARTA BARAT, DKI JAKARTA",23,110,112,222
https://kawalpemilu.org#25957,"JEMBATAN LIMA, TAMBORA, JAKARTA BARAT, DKI JAKARTA",24,62,167,229
https://kawalpemilu.org#25957,"JEMBATAN LIMA, TAMBORA, JAKARTA BARAT, DKI JAKARTA",25,104,84,188
https://kawalpemilu.org#25957,"JEMBATAN LIMA, TAMBORA, JAKARTA BARAT, DKI JAKARTA",26,116,93,209
https://kawalpemilu.org#25957,"JEMBATAN LIMA, TAMBORA, JAKARTA BARAT, DKI JAKARTA",27,150,68,218
https://kawalpemilu.org#25957,"JEMBATAN LIMA, TAMBORA, JAKARTA BARAT, DKI JAKARTA",28,181,33,214
https://kawalpemilu.org#25957,"JEMBATAN LIMA, TAMBORA, JAKARTA BARAT, DKI JAKARTA",29,179,10,189
https://kawalpemilu.org#25957,"JEMBATAN LIMA, TAMBORA, JAKARTA BARAT, DKI JAKARTA",30,122,57,179
https://kawalpemilu.org#25957,"JEMBATAN LIMA, TAMBORA, JAKARTA BARAT, DKI JAKARTA",31,150,14,164
https://kawalpemilu.org#25957,"JEMBATAN LIMA, TAMBORA, JAKARTA BARAT, DKI JAKARTA",32,94,102,196
https://kawalpemilu.org#25957,"JEMBATAN LIMA, TAMBORA, JAKARTA BARAT, DKI JAKARTA",33,133,59,192
https://kawalpemilu.org#25957,"JEMBATAN LIMA, TAMBORA, JAKARTA BARAT, DKI JAKARTA",34,165,64,229
https://kawalpemilu.org#25957,"JEMBATAN LIMA, TAMBORA, JAKARTA BARAT, DKI JAKARTA",35,158,70,228
https://kawalpemilu.org#25957,"JEMBATAN LIMA, TAMBORA, JAKARTA BARAT, DKI JAKARTA",36,121,44,165
https://kawalpemilu.org#25957,"JEMBATAN LIMA, TAMBORA, JAKARTA BARAT, DKI JAKARTA",37,164,83,247
https://kawalpemilu.org#25957,"JEMBATAN LIMA, TAMBORA, JAKARTA BARAT, DKI JAKARTA",38,92,148,240
https://kawalpemilu.org#25957,"JEMBATAN LIMA, TAMBORA, JAKARTA BARAT, DKI JAKARTA",39,76,166,242
https://kawalpemilu.org#25957,"JEMBATAN LIMA, TAMBORA, JAKARTA BARAT, DKI JAKARTA",40,156,99,255
https://kawalpemilu.org#25957,"JEMBATAN LIMA, TAMBORA, JAKARTA BARAT, DKI JAKARTA",41,99,145,244
https://kawalpemilu.org#25957,"JEMBATAN LIMA, TAMBORA, JAKARTA BARAT, DKI JAKARTA",42,83,144,227
https://kawalpemilu.org#25957,"JEMBATAN LIMA, TAMBORA, JAKARTA BARAT, DKI JAKARTA",43,86,75,161
https://kawalpemilu.org#25957,"JEMBATAN LIMA, TAMBORA, JAKARTA BARAT, DKI JAKARTA",44,132,62,194
https://kawalpemilu.org#25957,"JEMBATAN LIMA, TAMBORA, JAKARTA BARAT, DKI JAKARTA",45,133,102,235
https://kawalpemilu.org#25957,"JEMBATAN LIMA, TAMBORA, JAKARTA BARAT, DKI JAKARTA",46,116,87,203
https://kawalpemilu.org#25957,"JEMBATAN LIMA, TAMBORA, JAKARTA BARAT, DKI JAKARTA",47,111,93,204
https://kawalpemilu.org#25957,"JEMBATAN LIMA, TAMBORA, JAKARTA BARAT, DKI JAKARTA",48,79,153,232
https://kawalpemilu.org#25957,"JEMBATAN LIMA, TAMBORA, JAKARTA BARAT, DKI JAKARTA",49,122,90,212
https://kawalpemilu.org#25957,"JEMBATAN LIMA, TAMBORA, JAKARTA BARAT, DKI JAKARTA",50,128,102,230
https://kawalpemilu.org#25957,"JEMBATAN LIMA, TAMBORA, JAKARTA BARAT, DKI JAKARTA",51,137,97,234
https://kawalpemilu.org#25957,"JEMBATAN LIMA, TAMBORA, JAKARTA BARAT, DKI JAKARTA",52,44,113,157
https://kawalpemilu.org#25957,"JEMBATAN LIMA, TAMBORA, JAKARTA BARAT, DKI JAKARTA",53,90,98,188
https://kawalpemilu.org#25957,"JEMBATAN LIMA, TAMBORA, JAKARTA BARAT, DKI JAKARTA",54,85,96,181
https://kawalpemilu.org#25957,"JEMBATAN LIMA, TAMBORA, JAKARTA BARAT, DKI JAKARTA",55,131,78,209
https://kawalpemilu.org#25957,"JEMBATAN LIMA, TAMBORA, JAKARTA BARAT, DKI JAKARTA",56,72,130,202
https://kawalpemilu.org#25957,"JEMBATAN LIMA, TAMBORA, JAKARTA BARAT, DKI JAKARTA",57,91,95,186
https://kawalpemilu.org#25957,"JEMBATAN LIMA, TAMBORA, JAKARTA BARAT, DKI JAKARTA",58,129,101,230
https://kawalpemilu.org#25957,"JEMBATAN LIMA, TAMBORA, JAKARTA BARAT, DKI JAKARTA",59,125,77,202
https://kawalpemilu.org#25957,"JEMBATAN LIMA, TAMBORA, JAKARTA BARAT, DKI JAKARTA",60,129,72,201
https://kawalpemilu.org#25957,"JEMBATAN LIMA, TAMBORA, JAKARTA BARAT, DKI JAKARTA",61,142,47,189
https://kawalpemilu.org#25957,"JEMBATAN LIMA, TAMBORA, JAKARTA BARAT, DKI JAKARTA",62,117,76,193
https://kawalpemilu.org#25957,"JEMBATAN LIMA, TAMBORA, JAKARTA BARAT, DKI JAKARTA",63,105,98,203
https://kawalpemilu.org#25957,"JEMBATAN LIMA, TAMBORA, JAKARTA BARAT, DKI JAKARTA",64,121,130,251
https://kawalpemilu.org#25957,"JEMBATAN LIMA, TAMBORA, JAKARTA BARAT, DKI JAKARTA",65,108,124,232
https://kawalpemilu.org#25957,"JEMBATAN LIMA, TAMBORA, JAKARTA BARAT, DKI JAKARTA",66,98,128,226
https://kawalpemilu.org#25957,"JEMBATAN LIMA, TAMBORA, JAKARTA BARAT, DKI JAKARTA",67,63,180,243
https://kawalpemilu.org#25957,"JEMBATAN LIMA, TAMBORA, JAKARTA BARAT, DKI JAKARTA",68,109,76,185
https://kawalpemilu.org#25957,"JEMBATAN LIMA, TAMBORA, JAKARTA BARAT, DKI JAKARTA",69,145,45,190
https://kawalpemilu.org#25957,"JEMBATAN LIMA, TAMBORA, JAKARTA BARAT, DKI JAKARTA",70,97,33,130
https://kawalpemilu.org#25958,"PEKOJAN, TAMBORA, JAKARTA BARAT, DKI JAKARTA",1,100,66,166
https://kawalpemilu.org#25958,"PEKOJAN, TAMBORA, JAKARTA BARAT, DKI JAKARTA",2,116,81,197
https://kawalpemilu.org#25958,"PEKOJAN, TAMBORA, JAKARTA BARAT, DKI JAKARTA",3,130,78,208
https://kawalpemilu.org#25958,"PEKOJAN, TAMBORA, JAKARTA BARAT, DKI JAKARTA",4,150,25,175
https://kawalpemilu.org#25958,"PEKOJAN, TAMBORA, JAKARTA BARAT, DKI JAKARTA",5,140,89,229
https://kawalpemilu.org#25958,"PEKOJAN, TAMBORA, JAKARTA BARAT, DKI JAKARTA",6,180,54,234
https://kawalpemilu.org#25958,"PEKOJAN, TAMBORA, JAKARTA BARAT, DKI JAKARTA",7,128,122,250
https://kawalpemilu.org#25958,"PEKOJAN, TAMBORA, JAKARTA BARAT, DKI JAKARTA",8,131,49,180
https://kawalpemilu.org#25958,"PEKOJAN, TAMBORA, JAKARTA BARAT, DKI JAKARTA",9,112,41,153
https://kawalpemilu.org#25958,"PEKOJAN, TAMBORA, JAKARTA BARAT, DKI JAKARTA",10,135,57,192
https://kawalpemilu.org#25958,"PEKOJAN, TAMBORA, JAKARTA BARAT, DKI JAKARTA",11,145,43,188
https://kawalpemilu.org#25958,"PEKOJAN, TAMBORA, JAKARTA BARAT, DKI JAKARTA",12,113,96,209
https://kawalpemilu.org#25958,"PEKOJAN, TAMBORA, JAKARTA BARAT, DKI JAKARTA",13,192,30,223
https://kawalpemilu.org#25958,"PEKOJAN, TAMBORA, JAKARTA BARAT, DKI JAKARTA",14,155,29,184
https://kawalpemilu.org#25958,"PEKOJAN, TAMBORA, JAKARTA BARAT, DKI JAKARTA",15,180,23,203
https://kawalpemilu.org#25958,"PEKOJAN, TAMBORA, JAKARTA BARAT, DKI JAKARTA",16,170,81,251
https://kawalpemilu.org#25958,"PEKOJAN, TAMBORA, JAKARTA BARAT, DKI JAKARTA",17,58,180,238
https://kawalpemilu.org#25958,"PEKOJAN, TAMBORA, JAKARTA BARAT, DKI JAKARTA",18,151,70,221
https://kawalpemilu.org#25958,"PEKOJAN, TAMBORA, JAKARTA BARAT, DKI JAKARTA",19,145,51,196
https://kawalpemilu.org#25958,"PEKOJAN, TAMBORA, JAKARTA BARAT, DKI JAKARTA",20,207,19,226
https://kawalpemilu.org#25958,"PEKOJAN, TAMBORA, JAKARTA BARAT, DKI JAKARTA",21,169,12,181
https://kawalpemilu.org#25958,"PEKOJAN, TAMBORA, JAKARTA BARAT, DKI JAKARTA",22,181,23,204
https://kawalpemilu.org#25958,"PEKOJAN, TAMBORA, JAKARTA BARAT, DKI JAKARTA",23,159,50,209
https://kawalpemilu.org#25958,"PEKOJAN, TAMBORA, JAKARTA BARAT, DKI JAKARTA",24,153,69,222
https://kawalpemilu.org#25958,"PEKOJAN, TAMBORA, JAKARTA BARAT, DKI JAKARTA",25,170,67,237
https://kawalpemilu.org#25958,"PEKOJAN, TAMBORA, JAKARTA BARAT, DKI JAKARTA",26,194,57,251
https://kawalpemilu.org#25958,"PEKOJAN, TAMBORA, JAKARTA BARAT, DKI JAKARTA",27,217,7,224
https://kawalpemilu.org#25958,"PEKOJAN, TAMBORA, JAKARTA BARAT, DKI JAKARTA",28,169,48,217
https://kawalpemilu.org#25958,"PEKOJAN, TAMBORA, JAKARTA BARAT, DKI JAKARTA",29,186,54,240
https://kawalpemilu.org#25958,"PEKOJAN, TAMBORA, JAKARTA BARAT, DKI JAKARTA",30,145,97,242
https://kawalpemilu.org#25958,"PEKOJAN, TAMBORA, JAKARTA BARAT, DKI JAKARTA",31,166,52,218
https://kawalpemilu.org#25958,"PEKOJAN, TAMBORA, JAKARTA BARAT, DKI JAKARTA",32,127,58,185
https://kawalpemilu.org#25958,"PEKOJAN, TAMBORA, JAKARTA BARAT, DKI JAKARTA",33,214,4,218
https://kawalpemilu.org#25958,"PEKOJAN, TAMBORA, JAKARTA BARAT, DKI JAKARTA",34,230,4,234
https://kawalpemilu.org#25958,"PEKOJAN, TAMBORA, JAKARTA BARAT, DKI JAKARTA",35,162,32,194
https://kawalpemilu.org#25958,"PEKOJAN, TAMBORA, JAKARTA BARAT, DKI JAKARTA",36,70,102,172
https://kawalpemilu.org#25958,"PEKOJAN, TAMBORA, JAKARTA BARAT, DKI JAKARTA",37,64,132,196
https://kawalpemilu.org#25958,"PEKOJAN, TAMBORA, JAKARTA BARAT, DKI JAKARTA",38,60,158,218
https://kawalpemilu.org#25958,"PEKOJAN, TAMBORA, JAKARTA BARAT, DKI JAKARTA",39,56,133,189
https://kawalpemilu.org#25958,"PEKOJAN, TAMBORA, JAKARTA BARAT, DKI JAKARTA",40,81,111,192
https://kawalpemilu.org#25958,"PEKOJAN, TAMBORA, JAKARTA BARAT, DKI JAKARTA",41,63,161,224
https://kawalpemilu.org#25958,"PEKOJAN, TAMBORA, JAKARTA BARAT, DKI JAKARTA",42,43,174,217
https://kawalpemilu.org#25958,"PEKOJAN, TAMBORA, JAKARTA BARAT, DKI JAKARTA",43,83,143,226
https://kawalpemilu.org#25958,"PEKOJAN, TAMBORA, JAKARTA BARAT, DKI JAKARTA",44,114,59,173
https://kawalpemilu.org#25958,"PEKOJAN, TAMBORA, JAKARTA BARAT, DKI JAKARTA",45,95,121,216
https://kawalpemilu.org#25958,"PEKOJAN, TAMBORA, JAKARTA BARAT, DKI JAKARTA",46,77,100,177
https://kawalpemilu.org#25958,"PEKOJAN, TAMBORA, JAKARTA BARAT, DKI JAKARTA",47,127,42,169
https://kawalpemilu.org#25958,"PEKOJAN, TAMBORA, JAKARTA BARAT, DKI JAKARTA",48,88,85,173
https://kawalpemilu.org#25958,"PEKOJAN, TAMBORA, JAKARTA BARAT, DKI JAKARTA",49,115,60,175
https://kawalpemilu.org#25958,"PEKOJAN, TAMBORA, JAKARTA BARAT, DKI JAKARTA",50,201,23,224
https://kawalpemilu.org#25958,"PEKOJAN, TAMBORA, JAKARTA BARAT, DKI JAKARTA",51,164,96,260
https://kawalpemilu.org#25958,"PEKOJAN, TAMBORA, JAKARTA BARAT, DKI JAKARTA",52,122,89,211
https://kawalpemilu.org#25958,"PEKOJAN, TAMBORA, JAKARTA BARAT, DKI JAKARTA",53,99,131,230
https://kawalpemilu.org#25958,"PEKOJAN, TAMBORA, JAKARTA BARAT, DKI JAKARTA",54,77,157,234
https://kawalpemilu.org#25958,"PEKOJAN, TAMBORA, JAKARTA BARAT, DKI JAKARTA",55,134,95,229
https://kawalpemilu.org#25958,"PEKOJAN, TAMBORA, JAKARTA BARAT, DKI JAKARTA",56,177,77,254
https://kawalpemilu.org#25958,"PEKOJAN, TAMBORA, JAKARTA BARAT, DKI JAKARTA",57,99,163,262
https://kawalpemilu.org#25958,"PEKOJAN, TAMBORA, JAKARTA BARAT, DKI JAKARTA",58,141,50,191
https://kawalpemilu.org#25958,"PEKOJAN, TAMBORA, JAKARTA BARAT, DKI JAKARTA",59,174,60,234
https://kawalpemilu.org#25958,"PEKOJAN, TAMBORA, JAKARTA BARAT, DKI JAKARTA",60,175,57,232
https://kawalpemilu.org#25958,"PEKOJAN, TAMBORA, JAKARTA BARAT, DKI JAKARTA",61,182,24,206
https://kawalpemilu.org#25958,"PEKOJAN, TAMBORA, JAKARTA BARAT, DKI JAKARTA",62,203,26,229
https://kawalpemilu.org#25958,"PEKOJAN, TAMBORA, JAKARTA BARAT, DKI JAKARTA",63,199,23,222
https://kawalpemilu.org#25958,"PEKOJAN, TAMBORA, JAKARTA BARAT, DKI JAKARTA",64,194,46,240
https://kawalpemilu.org#25958,"PEKOJAN, TAMBORA, JAKARTA BARAT, DKI JAKARTA",65,192,43,235
https://kawalpemilu.org#25958,"PEKOJAN, TAMBORA, JAKARTA BARAT, DKI JAKARTA",66,156,24,180
https://kawalpemilu.org#25958,"PEKOJAN, TAMBORA, JAKARTA BARAT, DKI JAKARTA",67,160,28,188
https://kawalpemilu.org#25958,"PEKOJAN, TAMBORA, JAKARTA BARAT, DKI JAKARTA",68,187,7,194
https://kawalpemilu.org#25958,"PEKOJAN, TAMBORA, JAKARTA BARAT, DKI JAKARTA",69,173,34,207
https://kawalpemilu.org#25958,"PEKOJAN, TAMBORA, JAKARTA BARAT, DKI JAKARTA",70,96,90,186
https://kawalpemilu.org#25958,"PEKOJAN, TAMBORA, JAKARTA BARAT, DKI JAKARTA",71,148,61,209
https://kawalpemilu.org#25958,"PEKOJAN, TAMBORA, JAKARTA BARAT, DKI JAKARTA",72,133,53,186
https://kawalpemilu.org#25958,"PEKOJAN, TAMBORA, JAKARTA BARAT, DKI JAKARTA",73,154,54,208
https://kawalpemilu.org#25958,"PEKOJAN, TAMBORA, JAKARTA BARAT, DKI JAKARTA",74,135,53,188
https://kawalpemilu.org#25958,"PEKOJAN, TAMBORA, JAKARTA BARAT, DKI JAKARTA",75,97,70,167
https://kawalpemilu.org#25958,"PEKOJAN, TAMBORA, JAKARTA BARAT, DKI JAKARTA",76,133,110,243
https://kawalpemilu.org#25958,"PEKOJAN, TAMBORA, JAKARTA BARAT, DKI JAKARTA",77,115,94,209
https://kawalpemilu.org#25958,"PEKOJAN, TAMBORA, JAKARTA BARAT, DKI JAKARTA",78,163,51,214
https://kawalpemilu.org#25958,"PEKOJAN, TAMBORA, JAKARTA BARAT, DKI JAKARTA",79,169,40,209
https://kawalpemilu.org#25958,"PEKOJAN, TAMBORA, JAKARTA BARAT, DKI JAKARTA",80,152,68,220
https://kawalpemilu.org#25958,"PEKOJAN, TAMBORA, JAKARTA BARAT, DKI JAKARTA",81,134,88,222
https://kawalpemilu.org#25958,"PEKOJAN, TAMBORA, JAKARTA BARAT, DKI JAKARTA",82,150,80,230
https://kawalpemilu.org#25958,"PEKOJAN, TAMBORA, JAKARTA BARAT, DKI JAKARTA",83,198,16,214
https://kawalpemilu.org#25959,"ROA MALAKA, TAMBORA, JAKARTA BARAT, DKI JAKARTA",1,170,4,174
https://kawalpemilu.org#25959,"ROA MALAKA, TAMBORA, JAKARTA BARAT, DKI JAKARTA",2,169,3,172
https://kawalpemilu.org#25959,"ROA MALAKA, TAMBORA, JAKARTA BARAT, DKI JAKARTA",3,174,3,177
https://kawalpemilu.org#25959,"ROA MALAKA, TAMBORA, JAKARTA BARAT, DKI JAKARTA",4,182,5,187
https://kawalpemilu.org#25959,"ROA MALAKA, TAMBORA, JAKARTA BARAT, DKI JAKARTA",5,110,10,120
https://kawalpemilu.org#25959,"ROA MALAKA, TAMBORA, JAKARTA BARAT, DKI JAKARTA",6,160,7,167
https://kawalpemilu.org#25959,"ROA MALAKA, TAMBORA, JAKARTA BARAT, DKI JAKARTA",7,160,9,169
https://kawalpemilu.org#25959,"ROA MALAKA, TAMBORA, JAKARTA BARAT, DKI JAKARTA",8,131,49,180
https://kawalpemilu.org#25959,"ROA MALAKA, TAMBORA, JAKARTA BARAT, DKI JAKARTA",9,173,11,184
https://kawalpemilu.org#25959,"ROA MALAKA, TAMBORA, JAKARTA BARAT, DKI JAKARTA",10,119,89,208
https://kawalpemilu.org#25959,"ROA MALAKA, TAMBORA, JAKARTA BARAT, DKI JAKARTA",11,85,119,204
https://kawalpemilu.org#25959,"ROA MALAKA, TAMBORA, JAKARTA BARAT, DKI JAKARTA",12,116,78,194
https://kawalpemilu.org#25959,"ROA MALAKA, TAMBORA, JAKARTA BARAT, DKI JAKARTA",13,138,39,177
https://kawalpemilu.org#25959,"ROA MALAKA, TAMBORA, JAKARTA BARAT, DKI JAKARTA",14,131,43,174
https://kawalpemilu.org#25960,"DURI SELATAN, TAMBORA, JAKARTA BARAT, DKI JAKARTA",1,221,3,224
https://kawalpemilu.org#25960,"DURI SELATAN, TAMBORA, JAKARTA BARAT, DKI JAKARTA",2,124,60,184
https://kawalpemilu.org#25960,"DURI SELATAN, TAMBORA, JAKARTA BARAT, DKI JAKARTA",3,135,29,164
https://kawalpemilu.org#25960,"DURI SELATAN, TAMBORA, JAKARTA BARAT, DKI JAKARTA",4,183,64,247
https://kawalpemilu.org#25960,"DURI SELATAN, TAMBORA, JAKARTA BARAT, DKI JAKARTA",5,168,29,197
https://kawalpemilu.org#25960,"DURI SELATAN, TAMBORA, JAKARTA BARAT, DKI JAKARTA",6,191,11,202
https://kawalpemilu.org#25960,"DURI SELATAN, TAMBORA, JAKARTA BARAT, DKI JAKARTA",7,182,6,188
https://kawalpemilu.org#25960,"DURI SELATAN, TAMBORA, JAKARTA BARAT, DKI JAKARTA",8,180,33,213
https://kawalpemilu.org#25960,"DURI SELATAN, TAMBORA, JAKARTA BARAT, DKI JAKARTA",9,205,12,217
https://kawalpemilu.org#25960,"DURI SELATAN, TAMBORA, JAKARTA BARAT, DKI JAKARTA",10,202,15,217
https://kawalpemilu.org#25960,"DURI SELATAN, TAMBORA, JAKARTA BARAT, DKI JAKARTA",11,177,12,189
https://kawalpemilu.org#25960,"DURI SELATAN, TAMBORA, JAKARTA BARAT, DKI JAKARTA",12,143,46,189
https://kawalpemilu.org#25960,"DURI SELATAN, TAMBORA, JAKARTA BARAT, DKI JAKARTA",13,114,97,211
https://kawalpemilu.org#25960,"DURI SELATAN, TAMBORA, JAKARTA BARAT, DKI JAKARTA",14,176,50,226
https://kawalpemilu.org#25960,"DURI SELATAN, TAMBORA, JAKARTA BARAT, DKI JAKARTA",15,158,44,202
https://kawalpemilu.org#25960,"DURI SELATAN, TAMBORA, JAKARTA BARAT, DKI JAKARTA",16,126,83,209
https://kawalpemilu.org#25960,"DURI SELATAN, TAMBORA, JAKARTA BARAT, DKI JAKARTA",17,0,0,194
https://kawalpemilu.org#25960,"DURI SELATAN, TAMBORA, JAKARTA BARAT, DKI JAKARTA",18,140,37,177
https://kawalpemilu.org#25960,"DURI SELATAN, TAMBORA, JAKARTA BARAT, DKI JAKARTA",19,141,84,225
https://kawalpemilu.org#25960,"DURI SELATAN, TAMBORA, JAKARTA BARAT, DKI JAKARTA",20,117,84,201
https://kawalpemilu.org#25960,"DURI SELATAN, TAMBORA, JAKARTA BARAT, DKI JAKARTA",21,150,55,205
https://kawalpemilu.org#25960,"DURI SELATAN, TAMBORA, JAKARTA BARAT, DKI JAKARTA",23,107,135,242
https://kawalpemilu.org#25960,"DURI SELATAN, TAMBORA, JAKARTA BARAT, DKI JAKARTA",24,148,80,228
https://kawalpemilu.org#25960,"DURI SELATAN, TAMBORA, JAKARTA BARAT, DKI JAKARTA",25,158,90,248
https://kawalpemilu.org#25960,"DURI SELATAN, TAMBORA, JAKARTA BARAT, DKI JAKARTA",27,98,121,219
https://kawalpemilu.org#25960,"DURI SELATAN, TAMBORA, JAKARTA BARAT, DKI JAKARTA",28,83,123,206
https://kawalpemilu.org#25960,"DURI SELATAN, TAMBORA, JAKARTA BARAT, DKI JAKARTA",29,139,81,220
https://kawalpemilu.org#25960,"DURI SELATAN, TAMBORA, JAKARTA BARAT, DKI JAKARTA",30,152,76,228
https://kawalpemilu.org#25960,"DURI SELATAN, TAMBORA, JAKARTA BARAT, DKI JAKARTA",31,134,81,215
https://kawalpemilu.org#25960,"DURI SELATAN, TAMBORA, JAKARTA BARAT, DKI JAKARTA",32,111,74,185
https://kawalpemilu.org#25960,"DURI SELATAN, TAMBORA, JAKARTA BARAT, DKI JAKARTA",33,74,82,156
https://kawalpemilu.org#25960,"DURI SELATAN, TAMBORA, JAKARTA BARAT, DKI JAKARTA",34,152,74,226
https://kawalpemilu.org#25960,"DURI SELATAN, TAMBORA, JAKARTA BARAT, DKI JAKARTA",36,74,163,237
https://kawalpemilu.org#25960,"DURI SELATAN, TAMBORA, JAKARTA BARAT, DKI JAKARTA",37,80,94,174
https://kawalpemilu.org#25960,"DURI SELATAN, TAMBORA, JAKARTA BARAT, DKI JAKARTA",38,109,100,209
https://kawalpemilu.org#25960,"DURI SELATAN, TAMBORA, JAKARTA BARAT, DKI JAKARTA",39,117,101,218
https://kawalpemilu.org#25960,"DURI SELATAN, TAMBORA, JAKARTA BARAT, DKI JAKARTA",40,106,100,209
https://kawalpemilu.org#25960,"DURI SELATAN, TAMBORA, JAKARTA BARAT, DKI JAKARTA",41,67,131,198
https://kawalpemilu.org#25960,"DURI SELATAN, TAMBORA, JAKARTA BARAT, DKI JAKARTA",42,104,70,174
https://kawalpemilu.org#25960,"DURI SELATAN, TAMBORA, JAKARTA BARAT, DKI JAKARTA",43,83,118,201
https://kawalpemilu.org#25960,"DURI SELATAN, TAMBORA, JAKARTA BARAT, DKI JAKARTA",44,78,127,205
https://kawalpemilu.org#25960,"DURI SELATAN, TAMBORA, JAKARTA BARAT, DKI JAKARTA",45,187,40,227
https://kawalpemilu.org#25960,"DURI SELATAN, TAMBORA, JAKARTA BARAT, DKI JAKARTA",46,220,23,243
https://kawalpemilu.org#25960,"DURI SELATAN, TAMBORA, JAKARTA BARAT, DKI JAKARTA",47,208,12,220
https://kawalpemilu.org#25960,"DURI SELATAN, TAMBORA, JAKARTA BARAT, DKI JAKARTA",48,83,100,183
https://kawalpemilu.org#25960,"DURI SELATAN, TAMBORA, JAKARTA BARAT, DKI JAKARTA",49,143,46,189
https://kawalpemilu.org#25960,"DURI SELATAN, TAMBORA, JAKARTA BARAT, DKI JAKARTA",50,181,10,191
https://kawalpemilu.org#25962,"KEBON JERUK, KEBON JERUK, JAKARTA BARAT, DKI JAKARTA",1,114,145,259
https://kawalpemilu.org#25962,"KEBON JERUK, KEBON JERUK, JAKARTA BARAT, DKI JAKARTA",2,72,133,205
https://kawalpemilu.org#25962,"KEBON JERUK, KEBON JERUK, JAKARTA BARAT, DKI JAKARTA",3,61,133,194
https://kawalpemilu.org#25962,"KEBON JERUK, KEBON JERUK, JAKARTA BARAT, DKI JAKARTA",4,70,131,201
https://kawalpemilu.org#25962,"KEBON JERUK, KEBON JERUK, JAKARTA BARAT, DKI JAKARTA",5,80,86,166
https://kawalpemilu.org#25962,"KEBON JERUK, KEBON JERUK, JAKARTA BARAT, DKI JAKARTA",6,95,152,247
https://kawalpemilu.org#25962,"KEBON JERUK, KEBON JERUK, JAKARTA BARAT, DKI JAKARTA",7,98,86,184
https://kawalpemilu.org#25962,"KEBON JERUK, KEBON JERUK, JAKARTA BARAT, DKI JAKARTA",8,63,153,216
https://kawalpemilu.org#25962,"KEBON JERUK, KEBON JERUK, JAKARTA BARAT, DKI JAKARTA",9,73,128,0
https://kawalpemilu.org#25962,"KEBON JERUK, KEBON JERUK, JAKARTA BARAT, DKI JAKARTA",10,104,188,292
https://kawalpemilu.org#25962,"KEBON JERUK, KEBON JERUK, JAKARTA BARAT, DKI JAKARTA",11,106,128,234
https://kawalpemilu.org#25962,"KEBON JERUK, KEBON JERUK, JAKARTA BARAT, DKI JAKARTA",12,77,157,234
https://kawalpemilu.org#25962,"KEBON JERUK, KEBON JERUK, JAKARTA BARAT, DKI JAKARTA",13,65,158,223
https://kawalpemilu.org#25962,"KEBON JERUK, KEBON JERUK, JAKARTA BARAT, DKI JAKARTA",14,119,149,268
https://kawalpemilu.org#25962,"KEBON JERUK, KEBON JERUK, JAKARTA BARAT, DKI JAKARTA",15,115,132,247
https://kawalpemilu.org#25962,"KEBON JERUK, KEBON JERUK, JAKARTA BARAT, DKI JAKARTA",16,110,139,249
https://kawalpemilu.org#25962,"KEBON JERUK, KEBON JERUK, JAKARTA BARAT, DKI JAKARTA",17,60,123,183
https://kawalpemilu.org#25962,"KEBON JERUK, KEBON JERUK, JAKARTA BARAT, DKI JAKARTA",18,113,138,251
https://kawalpemilu.org#25962,"KEBON JERUK, KEBON JERUK, JAKARTA BARAT, DKI JAKARTA",19,77,97,174
https://kawalpemilu.org#25962,"KEBON JERUK, KEBON JERUK, JAKARTA BARAT, DKI JAKARTA",20,101,86,187
https://kawalpemilu.org#25962,"KEBON JERUK, KEBON JERUK, JAKARTA BARAT, DKI JAKARTA",21,73,151,224
https://kawalpemilu.org#25962,"KEBON JERUK, KEBON JERUK, JAKARTA BARAT, DKI JAKARTA",22,85,124,209
https://kawalpemilu.org#25962,"KEBON JERUK, KEBON JERUK, JAKARTA BARAT, DKI JAKARTA",23,102,133,235
https://kawalpemilu.org#25962,"KEBON JERUK, KEBON JERUK, JAKARTA BARAT, DKI JAKARTA",24,96,144,240
https://kawalpemilu.org#25962,"KEBON JERUK, KEBON JERUK, JAKARTA BARAT, DKI JAKARTA",25,89,104,193
https://kawalpemilu.org#25962,"KEBON JERUK, KEBON JERUK, JAKARTA BARAT, DKI JAKARTA",26,112,104,216
https://kawalpemilu.org#25962,"KEBON JERUK, KEBON JERUK, JAKARTA BARAT, DKI JAKARTA",27,96,132,228
https://kawalpemilu.org#25962,"KEBON JERUK, KEBON JERUK, JAKARTA BARAT, DKI JAKARTA",28,92,153,245
https://kawalpemilu.org#25962,"KEBON JERUK, KEBON JERUK, JAKARTA BARAT, DKI JAKARTA",29,78,179,257
https://kawalpemilu.org#25962,"KEBON JERUK, KEBON JERUK, JAKARTA BARAT, DKI JAKARTA",30,85,119,204
https://kawalpemilu.org#25962,"KEBON JERUK, KEBON JERUK, JAKARTA BARAT, DKI JAKARTA",31,80,96,176
https://kawalpemilu.org#25962,"KEBON JERUK, KEBON JERUK, JAKARTA BARAT, DKI JAKARTA",32,71,164,235
https://kawalpemilu.org#25962,"KEBON JERUK, KEBON JERUK, JAKARTA BARAT, DKI JAKARTA",33,61,139,200
https://kawalpemilu.org#25962,"KEBON JERUK, KEBON JERUK, JAKARTA BARAT, DKI JAKARTA",34,67,150,217
https://kawalpemilu.org#25962,"KEBON JERUK, KEBON JERUK, JAKARTA BARAT, DKI JAKARTA",35,66,122,188
https://kawalpemilu.org#25962,"KEBON JERUK, KEBON JERUK, JAKARTA BARAT, DKI JAKARTA",36,70,187,257
https://kawalpemilu.org#25962,"KEBON JERUK, KEBON JERUK, JAKARTA BARAT, DKI JAKARTA",37,78,154,232
https://kawalpemilu.org#25962,"KEBON JERUK, KEBON JERUK, JAKARTA BARAT, DKI JAKARTA",38,68,112,180
https://kawalpemilu.org#25962,"KEBON JERUK, KEBON JERUK, JAKARTA BARAT, DKI JAKARTA",39,85,157,242
https://kawalpemilu.org#25962,"KEBON JERUK, KEBON JERUK, JAKARTA BARAT, DKI JAKARTA",40,88,192,280
https://kawalpemilu.org#25962,"KEBON JERUK, KEBON JERUK, JAKARTA BARAT, DKI JAKARTA",41,108,169,277
https://kawalpemilu.org#25962,"KEBON JERUK, KEBON JERUK, JAKARTA BARAT, DKI JAKARTA",42,90,164,254
https://kawalpemilu.org#25962,"KEBON JERUK, KEBON JERUK, JAKARTA BARAT, DKI JAKARTA",43,104,147,251
https://kawalpemilu.org#25962,"KEBON JERUK, KEBON JERUK, JAKARTA BARAT, DKI JAKARTA",44,90,164,254
https://kawalpemilu.org#25962,"KEBON JERUK, KEBON JERUK, JAKARTA BARAT, DKI JAKARTA",45,87,172,259
https://kawalpemilu.org#25962,"KEBON JERUK, KEBON JERUK, JAKARTA BARAT, DKI JAKARTA",46,98,148,246
https://kawalpemilu.org#25962,"KEBON JERUK, KEBON JERUK, JAKARTA BARAT, DKI JAKARTA",47,89,152,241
https://kawalpemilu.org#25962,"KEBON JERUK, KEBON JERUK, JAKARTA BARAT, DKI JAKARTA",48,92,158,250
https://kawalpemilu.org#25962,"KEBON JERUK, KEBON JERUK, JAKARTA BARAT, DKI JAKARTA",49,136,80,116
https://kawalpemilu.org#25962,"KEBON JERUK, KEBON JERUK, JAKARTA BARAT, DKI JAKARTA",50,77,154,231
https://kawalpemilu.org#25962,"KEBON JERUK, KEBON JERUK, JAKARTA BARAT, DKI JAKARTA",51,87,187,274
https://kawalpemilu.org#25962,"KEBON JERUK, KEBON JERUK, JAKARTA BARAT, DKI JAKARTA",52,145,90,235
https://kawalpemilu.org#25962,"KEBON JERUK, KEBON JERUK, JAKARTA BARAT, DKI JAKARTA",53,97,160,257
https://kawalpemilu.org#25962,"KEBON JERUK, KEBON JERUK, JAKARTA BARAT, DKI JAKARTA",54,108,133,241
https://kawalpemilu.org#25962,"KEBON JERUK, KEBON JERUK, JAKARTA BARAT, DKI JAKARTA",55,106,159,265
https://kawalpemilu.org#25962,"KEBON JERUK, KEBON JERUK, JAKARTA BARAT, DKI JAKARTA",56,155,97,252
https://kawalpemilu.org#25962,"KEBON JERUK, KEBON JERUK, JAKARTA BARAT, DKI JAKARTA",57,51,192,243
https://kawalpemilu.org#25962,"KEBON JERUK, KEBON JERUK, JAKARTA BARAT, DKI JAKARTA",58,82,119,201
https://kawalpemilu.org#25962,"KEBON JERUK, KEBON JERUK, JAKARTA BARAT, DKI JAKARTA",59,124,140,264
https://kawalpemilu.org#25962,"KEBON JERUK, KEBON JERUK, JAKARTA BARAT, DKI JAKARTA",60,112,155,264
https://kawalpemilu.org#25962,"KEBON JERUK, KEBON JERUK, JAKARTA BARAT, DKI JAKARTA",61,125,125,250
https://kawalpemilu.org#25962,"KEBON JERUK, KEBON JERUK, JAKARTA BARAT, DKI JAKARTA",62,165,86,251
https://kawalpemilu.org#25962,"KEBON JERUK, KEBON JERUK, JAKARTA BARAT, DKI JAKARTA",63,142,92,234
https://kawalpemilu.org#25962,"KEBON JERUK, KEBON JERUK, JAKARTA BARAT, DKI JAKARTA",64,115,68,183
https://kawalpemilu.org#25962,"KEBON JERUK, KEBON JERUK, JAKARTA BARAT, DKI JAKARTA",65,63,150,213
https://kawalpemilu.org#25962,"KEBON JERUK, KEBON JERUK, JAKARTA BARAT, DKI JAKARTA",66,58,141,199
https://kawalpemilu.org#25962,"KEBON JERUK, KEBON JERUK, JAKARTA BARAT, DKI JAKARTA",67,73,180,253
https://kawalpemilu.org#25962,"KEBON JERUK, KEBON JERUK, JAKARTA BARAT, DKI JAKARTA",68,83,159,242
https://kawalpemilu.org#25962,"KEBON JERUK, KEBON JERUK, JAKARTA BARAT, DKI JAKARTA",69,56,133,189
https://kawalpemilu.org#25962,"KEBON JERUK, KEBON JERUK, JAKARTA BARAT, DKI JAKARTA",70,156,12,168
https://kawalpemilu.org#25962,"KEBON JERUK, KEBON JERUK, JAKARTA BARAT, DKI JAKARTA",71,203,14,217
https://kawalpemilu.org#25962,"KEBON JERUK, KEBON JERUK, JAKARTA BARAT, DKI JAKARTA",72,123,11,134
https://kawalpemilu.org#25962,"KEBON JERUK, KEBON JERUK, JAKARTA BARAT, DKI JAKARTA",73,192,5,197
https://kawalpemilu.org#25962,"KEBON JERUK, KEBON JERUK, JAKARTA BARAT, DKI JAKARTA",74,105,195,300
https://kawalpemilu.org#25962,"KEBON JERUK, KEBON JERUK, JAKARTA BARAT, DKI JAKARTA",75,83,106,189
https://kawalpemilu.org#25962,"KEBON JERUK, KEBON JERUK, JAKARTA BARAT, DKI JAKARTA",76,112,73,185
https://kawalpemilu.org#25962,"KEBON JERUK, KEBON JERUK, JAKARTA BARAT, DKI JAKARTA",77,108,76,184
https://kawalpemilu.org#25962,"KEBON JERUK, KEBON JERUK, JAKARTA BARAT, DKI JAKARTA",78,112,77,189
https://kawalpemilu.org#25962,"KEBON JERUK, KEBON JERUK, JAKARTA BARAT, DKI JAKARTA",79,81,110,191
https://kawalpemilu.org#25962,"KEBON JERUK, KEBON JERUK, JAKARTA BARAT, DKI JAKARTA",80,85,107,192
https://kawalpemilu.org#25962,"KEBON JERUK, KEBON JERUK, JAKARTA BARAT, DKI JAKARTA",81,73,128,201
https://kawalpemilu.org#25962,"KEBON JERUK, KEBON JERUK, JAKARTA BARAT, DKI JAKARTA",82,72,127,199
https://kawalpemilu.org#25962,"KEBON JERUK, KEBON JERUK, JAKARTA BARAT, DKI JAKARTA",83,68,122,190
https://kawalpemilu.org#25962,"KEBON JERUK, KEBON JERUK, JAKARTA BARAT, DKI JAKARTA",84,62,168,230
https://kawalpemilu.org#25962,"KEBON JERUK, KEBON JERUK, JAKARTA BARAT, DKI JAKARTA",85,99,126,225
https://kawalpemilu.org#25962,"KEBON JERUK, KEBON JERUK, JAKARTA BARAT, DKI JAKARTA",86,85,183,268
https://kawalpemilu.org#25962,"KEBON JERUK, KEBON JERUK, JAKARTA BARAT, DKI JAKARTA",87,86,128,214
https://kawalpemilu.org#25962,"KEBON JERUK, KEBON JERUK, JAKARTA BARAT, DKI JAKARTA",88,63,121,184
https://kawalpemilu.org#25962,"KEBON JERUK, KEBON JERUK, JAKARTA BARAT, DKI JAKARTA",89,82,73,155
https://kawalpemilu.org#25962,"KEBON JERUK, KEBON JERUK, JAKARTA BARAT, DKI JAKARTA",90,97,138,235
https://kawalpemilu.org#25962,"KEBON JERUK, KEBON JERUK, JAKARTA BARAT, DKI JAKARTA",91,66,161,227
https://kawalpemilu.org#25962,"KEBON JERUK, KEBON JERUK, JAKARTA BARAT, DKI JAKARTA",92,80,116,196
https://kawalpemilu.org#25962,"KEBON JERUK, KEBON JERUK, JAKARTA BARAT, DKI JAKARTA",93,84,77,161
https://kawalpemilu.org#25962,"KEBON JERUK, KEBON JERUK, JAKARTA BARAT, DKI JAKARTA",94,66,96,162
https://kawalpemilu.org#25962,"KEBON JERUK, KEBON JERUK, JAKARTA BARAT, DKI JAKARTA",95,105,119,224
https://kawalpemilu.org#25962,"KEBON JERUK, KEBON JERUK, JAKARTA BARAT, DKI JAKARTA",96,101,168,269
https://kawalpemilu.org#25962,"KEBON JERUK, KEBON JERUK, JAKARTA BARAT, DKI JAKARTA",97,130,51,181
https://kawalpemilu.org#25962,"KEBON JERUK, KEBON JERUK, JAKARTA BARAT, DKI JAKARTA",98,106,113,219
https://kawalpemilu.org#25962,"KEBON JERUK, KEBON JERUK, JAKARTA BARAT, DKI JAKARTA",99,115,89,204
https://kawalpemilu.org#25962,"KEBON JERUK, KEBON JERUK, JAKARTA BARAT, DKI JAKARTA",100,89,114,203
https://kawalpemilu.org#25962,"KEBON JERUK, KEBON JERUK, JAKARTA BARAT, DKI JAKARTA",101,90,70,160
https://kawalpemilu.org#25962,"KEBON JERUK, KEBON JERUK, JAKARTA BARAT, DKI JAKARTA",102,120,104,224
https://kawalpemilu.org#25962,"KEBON JERUK, KEBON JERUK, JAKARTA BARAT, DKI JAKARTA",103,77,218,295
https://kawalpemilu.org#25962,"KEBON JERUK, KEBON JERUK, JAKARTA BARAT, DKI JAKARTA",104,77,174,251
https://kawalpemilu.org#25962,"KEBON JERUK, KEBON JERUK, JAKARTA BARAT, DKI JAKARTA",105,61,196,257
https://kawalpemilu.org#25962,"KEBON JERUK, KEBON JERUK, JAKARTA BARAT, DKI JAKARTA",106,189,7,196
https://kawalpemilu.org#25962,"KEBON JERUK, KEBON JERUK, JAKARTA BARAT, DKI JAKARTA",107,186,10,196
https://kawalpemilu.org#25962,"KEBON JERUK, KEBON JERUK, JAKARTA BARAT, DKI JAKARTA",108,152,18,170
https://kawalpemilu.org#25962,"KEBON JERUK, KEBON JERUK, JAKARTA BARAT, DKI JAKARTA",109,202,14,216
https://kawalpemilu.org#25962,"KEBON JERUK, KEBON JERUK, JAKARTA BARAT, DKI JAKARTA",110,124,131,255
https://kawalpemilu.org#25962,"KEBON JERUK, KEBON JERUK, JAKARTA BARAT, DKI JAKARTA",111,104,156,260
https://kawalpemilu.org#25962,"KEBON JERUK, KEBON JERUK, JAKARTA BARAT, DKI JAKARTA",112,226,22,248
https://kawalpemilu.org#25962,"KEBON JERUK, KEBON JERUK, JAKARTA BARAT, DKI JAKARTA",113,121,132,253
https://kawalpemilu.org#25962,"KEBON JERUK, KEBON JERUK, JAKARTA BARAT, DKI JAKARTA",114,241,8,249
https://kawalpemilu.org#25962,"KEBON JERUK, KEBON JERUK, JAKARTA BARAT, DKI JAKARTA",115,222,16,238
https://kawalpemilu.org#25962,"KEBON JERUK, KEBON JERUK, JAKARTA BARAT, DKI JAKARTA",116,174,24,198
https://kawalpemilu.org#25962,"KEBON JERUK, KEBON JERUK, JAKARTA BARAT, DKI JAKARTA",117,95,119,214
https://kawalpemilu.org#25962,"KEBON JERUK, KEBON JERUK, JAKARTA BARAT, DKI JAKARTA",118,167,118,285
https://kawalpemilu.org#25962,"KEBON JERUK, KEBON JERUK, JAKARTA BARAT, DKI JAKARTA",119,125,133,258
https://kawalpemilu.org#25962,"KEBON JERUK, KEBON JERUK, JAKARTA BARAT, DKI JAKARTA",120,128,144,272
https://kawalpemilu.org#25962,"KEBON JERUK, KEBON JERUK, JAKARTA BARAT, DKI JAKARTA",121,117,111,228
https://kawalpemilu.org#25962,"KEBON JERUK, KEBON JERUK, JAKARTA BARAT, DKI JAKARTA",122,118,83,201
https://kawalpemilu.org#25962,"KEBON JERUK, KEBON JERUK, JAKARTA BARAT, DKI JAKARTA",123,46,180,226
https://kawalpemilu.org#25962,"KEBON JERUK, KEBON JERUK, JAKARTA BARAT, DKI JAKARTA",124,66,165,231
https://kawalpemilu.org#25962,"KEBON JERUK, KEBON JERUK, JAKARTA BARAT, DKI JAKARTA",125,108,170,278
https://kawalpemilu.org#25962,"KEBON JERUK, KEBON JERUK, JAKARTA BARAT, DKI JAKARTA",126,104,82,186
https://kawalpemilu.org#25962,"KEBON JERUK, KEBON JERUK, JAKARTA BARAT, DKI JAKARTA",127,81,89,170
https://kawalpemilu.org#25962,"KEBON JERUK, KEBON JERUK, JAKARTA BARAT, DKI JAKARTA",128,105,128,233
https://kawalpemilu.org#25962,"KEBON JERUK, KEBON JERUK, JAKARTA BARAT, DKI JAKARTA",129,79,105,184
https://kawalpemilu.org#25962,"KEBON JERUK, KEBON JERUK, JAKARTA BARAT, DKI JAKARTA",130,71,106,177
https://kawalpemilu.org#25962,"KEBON JERUK, KEBON JERUK, JAKARTA BARAT, DKI JAKARTA",131,69,127,196
https://kawalpemilu.org#25962,"KEBON JERUK, KEBON JERUK, JAKARTA BARAT, DKI JAKARTA",132,77,121,198
https://kawalpemilu.org#25962,"KEBON JERUK, KEBON JERUK, JAKARTA BARAT, DKI JAKARTA",133,84,160,244
https://kawalpemilu.org#25962,"KEBON JERUK, KEBON JERUK, JAKARTA BARAT, DKI JAKARTA",134,113,155,268
https://kawalpemilu.org#25962,"KEBON JERUK, KEBON JERUK, JAKARTA BARAT, DKI JAKARTA",135,79,160,239
https://kawalpemilu.org#25962,"KEBON JERUK, KEBON JERUK, JAKARTA BARAT, DKI JAKARTA",136,85,181,266
https://kawalpemilu.org#25962,"KEBON JERUK, KEBON JERUK, JAKARTA BARAT, DKI JAKARTA",137,107,166,273
https://kawalpemilu.org#25962,"KEBON JERUK, KEBON JERUK, JAKARTA BARAT, DKI JAKARTA",138,80,194,274
https://kawalpemilu.org#25962,"KEBON JERUK, KEBON JERUK, JAKARTA BARAT, DKI JAKARTA",139,100,175,275
https://kawalpemilu.org#25962,"KEBON JERUK, KEBON JERUK, JAKARTA BARAT, DKI JAKARTA",140,76,136,212
https://kawalpemilu.org#25962,"KEBON JERUK, KEBON JERUK, JAKARTA BARAT, DKI JAKARTA",141,64,109,173
https://kawalpemilu.org#25962,"KEBON JERUK, KEBON JERUK, JAKARTA BARAT, DKI JAKARTA",142,84,92,176
https://kawalpemilu.org#25962,"KEBON JERUK, KEBON JERUK, JAKARTA BARAT, DKI JAKARTA",143,60,163,223
https://kawalpemilu.org#25962,"KEBON JERUK, KEBON JERUK, JAKARTA BARAT, DKI JAKARTA",144,54,106,160
https://kawalpemilu.org#25962,"KEBON JERUK, KEBON JERUK, JAKARTA BARAT, DKI JAKARTA",145,95,177,272
https://kawalpemilu.org#25962,"KEBON JERUK, KEBON JERUK, JAKARTA BARAT, DKI JAKARTA",146,41,72,113
https://kawalpemilu.org#25962,"KEBON JERUK, KEBON JERUK, JAKARTA BARAT, DKI JAKARTA",147,66,173,239
https://kawalpemilu.org#25962,"KEBON JERUK, KEBON JERUK, JAKARTA BARAT, DKI JAKARTA",148,90,112,202
https://kawalpemilu.org#25962,"KEBON JERUK, KEBON JERUK, JAKARTA BARAT, DKI JAKARTA",149,75,82,157
https://kawalpemilu.org#25962,"KEBON JERUK, KEBON JERUK, JAKARTA BARAT, DKI JAKARTA",150,100,104,204
https://kawalpemilu.org#25962,"KEBON JERUK, KEBON JERUK, JAKARTA BARAT, DKI JAKARTA",151,77,118,195
https://kawalpemilu.org#25962,"KEBON JERUK, KEBON JERUK, JAKARTA BARAT, DKI JAKARTA",152,73,115,188
https://kawalpemilu.org#25962,"KEBON JERUK, KEBON JERUK, JAKARTA BARAT, DKI JAKARTA",153,121,63,184
https://kawalpemilu.org#25962,"KEBON JERUK, KEBON JERUK, JAKARTA BARAT, DKI JAKARTA",154,132,44,176
https://kawalpemilu.org#25962,"KEBON JERUK, KEBON JERUK, JAKARTA BARAT, DKI JAKARTA",155,62,152,214
https://kawalpemilu.org#25962,"KEBON JERUK, KEBON JERUK, JAKARTA BARAT, DKI JAKARTA",156,65,151,216
https://kawalpemilu.org#25962,"KEBON JERUK, KEBON JERUK, JAKARTA BARAT, DKI JAKARTA",157,77,140,217
https://kawalpemilu.org#25962,"KEBON JERUK, KEBON JERUK, JAKARTA BARAT, DKI JAKARTA",158,75,126,201
https://kawalpemilu.org#25962,"KEBON JERUK, KEBON JERUK, JAKARTA BARAT, DKI JAKARTA",159,124,96,220
https://kawalpemilu.org#25962,"KEBON JERUK, KEBON JERUK, JAKARTA BARAT, DKI JAKARTA",160,89,168,257
https://kawalpemilu.org#25962,"KEBON JERUK, KEBON JERUK, JAKARTA BARAT, DKI JAKARTA",161,110,128,238
https://kawalpemilu.org#25962,"KEBON JERUK, KEBON JERUK, JAKARTA BARAT, DKI JAKARTA",162,59,131,190
https://kawalpemilu.org#25962,"KEBON JERUK, KEBON JERUK, JAKARTA BARAT, DKI JAKARTA",163,64,122,186
https://kawalpemilu.org#25962,"KEBON JERUK, KEBON JERUK, JAKARTA BARAT, DKI JAKARTA",164,68,111,179
https://kawalpemilu.org#25962,"KEBON JERUK, KEBON JERUK, JAKARTA BARAT, DKI JAKARTA",165,98,92,190
https://kawalpemilu.org#25962,"KEBON JERUK, KEBON JERUK, JAKARTA BARAT, DKI JAKARTA",166,131,106,237
https://kawalpemilu.org#25962,"KEBON JERUK, KEBON JERUK, JAKARTA BARAT, DKI JAKARTA",167,112,84,196
https://kawalpemilu.org#25962,"KEBON JERUK, KEBON JERUK, JAKARTA BARAT, DKI JAKARTA",168,110,137,247
https://kawalpemilu.org#25962,"KEBON JERUK, KEBON JERUK, JAKARTA BARAT, DKI JAKARTA",169,86,109,195
https://kawalpemilu.org#25962,"KEBON JERUK, KEBON JERUK, JAKARTA BARAT, DKI JAKARTA",170,95,149,244
https://kawalpemilu.org#25962,"KEBON JERUK, KEBON JERUK, JAKARTA BARAT, DKI JAKARTA",171,90,128,218
https://kawalpemilu.org#25962,"KEBON JERUK, KEBON JERUK, JAKARTA BARAT, DKI JAKARTA",172,83,161,244
https://kawalpemilu.org#25962,"KEBON JERUK, KEBON JERUK, JAKARTA BARAT, DKI JAKARTA",173,80,192,272
https://kawalpemilu.org#25962,"KEBON JERUK, KEBON JERUK, JAKARTA BARAT, DKI JAKARTA",174,86,173,259
https://kawalpemilu.org#25962,"KEBON JERUK, KEBON JERUK, JAKARTA BARAT, DKI JAKARTA",175,49,174,223
https://kawalpemilu.org#25962,"KEBON JERUK, KEBON JERUK, JAKARTA BARAT, DKI JAKARTA",176,62,158,220
https://kawalpemilu.org#25962,"KEBON JERUK, KEBON JERUK, JAKARTA BARAT, DKI JAKARTA",177,94,155,249
https://kawalpemilu.org#25963,"SUKABUMI UTARA, KEBON JERUK, JAKARTA BARAT, DKI JAKARTA",1,97,154,251
https://kawalpemilu.org#25963,"SUKABUMI UTARA, KEBON JERUK, JAKARTA BARAT, DKI JAKARTA",2,76,178,254
https://kawalpemilu.org#25963,"SUKABUMI UTARA, KEBON JERUK, JAKARTA BARAT, DKI JAKARTA",3,51,189,240
https://kawalpemilu.org#25963,"SUKABUMI UTARA, KEBON JERUK, JAKARTA BARAT, DKI JAKARTA",4,60,223,283
https://kawalpemilu.org#25963,"SUKABUMI UTARA, KEBON JERUK, JAKARTA BARAT, DKI JAKARTA",5,64,196,260
https://kawalpemilu.org#25963,"SUKABUMI UTARA, KEBON JERUK, JAKARTA BARAT, DKI JAKARTA",6,88,177,265
https://kawalpemilu.org#25963,"SUKABUMI UTARA, KEBON JERUK, JAKARTA BARAT, DKI JAKARTA",7,46,187,233
https://kawalpemilu.org#25963,"SUKABUMI UTARA, KEBON JERUK, JAKARTA BARAT, DKI JAKARTA",8,69,172,241
https://kawalpemilu.org#25963,"SUKABUMI UTARA, KEBON JERUK, JAKARTA BARAT, DKI JAKARTA",9,70,153,223
https://kawalpemilu.org#25963,"SUKABUMI UTARA, KEBON JERUK, JAKARTA BARAT, DKI JAKARTA",10,90,173,263
https://kawalpemilu.org#25963,"SUKABUMI UTARA, KEBON JERUK, JAKARTA BARAT, DKI JAKARTA",11,64,135,199
https://kawalpemilu.org#25963,"SUKABUMI UTARA, KEBON JERUK, JAKARTA BARAT, DKI JAKARTA",12,58,193,251
https://kawalpemilu.org#25963,"SUKABUMI UTARA, KEBON JERUK, JAKARTA BARAT, DKI JAKARTA",13,63,157,220
https://kawalpemilu.org#25963,"SUKABUMI UTARA, KEBON JERUK, JAKARTA BARAT, DKI JAKARTA",14,64,191,255
https://kawalpemilu.org#25963,"SUKABUMI UTARA, KEBON JERUK, JAKARTA BARAT, DKI JAKARTA",15,68,143,211
https://kawalpemilu.org#25963,"SUKABUMI UTARA, KEBON JERUK, JAKARTA BARAT, DKI JAKARTA",16,58,175,233
https://kawalpemilu.org#25963,"SUKABUMI UTARA, KEBON JERUK, JAKARTA BARAT, DKI JAKARTA",17,40,203,243
https://kawalpemilu.org#25963,"SUKABUMI UTARA, KEBON JERUK, JAKARTA BARAT, DKI JAKARTA",18,66,189,255
https://kawalpemilu.org#25963,"SUKABUMI UTARA, KEBON JERUK, JAKARTA BARAT, DKI JAKARTA",19,79,183,262
https://kawalpemilu.org#25963,"SUKABUMI UTARA, KEBON JERUK, JAKARTA BARAT, DKI JAKARTA",20,65,112,177
https://kawalpemilu.org#25963,"SUKABUMI UTARA, KEBON JERUK, JAKARTA BARAT, DKI JAKARTA",21,89,122,211
https://kawalpemilu.org#25963,"SUKABUMI UTARA, KEBON JERUK, JAKARTA BARAT, DKI JAKARTA",22,86,117,203
https://kawalpemilu.org#25963,"SUKABUMI UTARA, KEBON JERUK, JAKARTA BARAT, DKI JAKARTA",23,90,119,209
https://kawalpemilu.org#25963,"SUKABUMI UTARA, KEBON JERUK, JAKARTA BARAT, DKI JAKARTA",24,53,144,197
https://kawalpemilu.org#25963,"SUKABUMI UTARA, KEBON JERUK, JAKARTA BARAT, DKI JAKARTA",25,67,167,234
https://kawalpemilu.org#25963,"SUKABUMI UTARA, KEBON JERUK, JAKARTA BARAT, DKI JAKARTA",26,58,174,232
https://kawalpemilu.org#25963,"SUKABUMI UTARA, KEBON JERUK, JAKARTA BARAT, DKI JAKARTA",27,56,181,237
https://kawalpemilu.org#25963,"SUKABUMI UTARA, KEBON JERUK, JAKARTA BARAT, DKI JAKARTA",28,49,216,267
https://kawalpemilu.org#25963,"SUKABUMI UTARA, KEBON JERUK, JAKARTA BARAT, DKI JAKARTA",29,89,153,242
https://kawalpemilu.org#25963,"SUKABUMI UTARA, KEBON JERUK, JAKARTA BARAT, DKI JAKARTA",31,81,161,242
https://kawalpemilu.org#25963,"SUKABUMI UTARA, KEBON JERUK, JAKARTA BARAT, DKI JAKARTA",32,83,145,228
https://kawalpemilu.org#25963,"SUKABUMI UTARA, KEBON JERUK, JAKARTA BARAT, DKI JAKARTA",33,67,161,228
https://kawalpemilu.org#25963,"SUKABUMI UTARA, KEBON JERUK, JAKARTA BARAT, DKI JAKARTA",34,58,137,195
https://kawalpemilu.org#25963,"SUKABUMI UTARA, KEBON JERUK, JAKARTA BARAT, DKI JAKARTA",35,78,137,215
https://kawalpemilu.org#25963,"SUKABUMI UTARA, KEBON JERUK, JAKARTA BARAT, DKI JAKARTA",36,79,80,159
https://kawalpemilu.org#25963,"SUKABUMI UTARA, KEBON JERUK, JAKARTA BARAT, DKI JAKARTA",37,79,95,174
https://kawalpemilu.org#25963,"SUKABUMI UTARA, KEBON JERUK, JAKARTA BARAT, DKI JAKARTA",38,81,91,172
https://kawalpemilu.org#25963,"SUKABUMI UTARA, KEBON JERUK, JAKARTA BARAT, DKI JAKARTA",39,91,118,209
https://kawalpemilu.org#25963,"SUKABUMI UTARA, KEBON JERUK, JAKARTA BARAT, DKI JAKARTA",40,100,167,267
https://kawalpemilu.org#25963,"SUKABUMI UTARA, KEBON JERUK, JAKARTA BARAT, DKI JAKARTA",41,71,184,255
https://kawalpemilu.org#25963,"SUKABUMI UTARA, KEBON JERUK, JAKARTA BARAT, DKI JAKARTA",42,76,163,239
https://kawalpemilu.org#25963,"SUKABUMI UTARA, KEBON JERUK, JAKARTA BARAT, DKI JAKARTA",43,51,187,238
https://kawalpemilu.org#25963,"SUKABUMI UTARA, KEBON JERUK, JAKARTA BARAT, DKI JAKARTA",44,40,196,236
https://kawalpemilu.org#25963,"SUKABUMI UTARA, KEBON JERUK, JAKARTA BARAT, DKI JAKARTA",45,44,170,214
https://kawalpemilu.org#25963,"SUKABUMI UTARA, KEBON JERUK, JAKARTA BARAT, DKI JAKARTA",46,99,155,254
https://kawalpemilu.org#25963,"SUKABUMI UTARA, KEBON JERUK, JAKARTA BARAT, DKI JAKARTA",47,64,158,222
https://kawalpemilu.org#25963,"SUKABUMI UTARA, KEBON JERUK, JAKARTA BARAT, DKI JAKARTA",48,43,163,206
https://kawalpemilu.org#25963,"SUKABUMI UTARA, KEBON JERUK, JAKARTA BARAT, DKI JAKARTA",49,71,183,254
https://kawalpemilu.org#25963,"SUKABUMI UTARA, KEBON JERUK, JAKARTA BARAT, DKI JAKARTA",50,72,135,207
https://kawalpemilu.org#25963,"SUKABUMI UTARA, KEBON JERUK, JAKARTA BARAT, DKI JAKARTA",51,69,145,214
https://kawalpemilu.org#25963,"SUKABUMI UTARA, KEBON JERUK, JAKARTA BARAT, DKI JAKARTA",52,60,116,176
https://kawalpemilu.org#25963,"SUKABUMI UTARA, KEBON JERUK, JAKARTA BARAT, DKI JAKARTA",53,53,150,203
https://kawalpemilu.org#25963,"SUKABUMI UTARA, KEBON JERUK, JAKARTA BARAT, DKI JAKARTA",54,60,150,210
https://kawalpemilu.org#25963,"SUKABUMI UTARA, KEBON JERUK, JAKARTA BARAT, DKI JAKARTA",55,67,187,254
https://kawalpemilu.org#25963,"SUKABUMI UTARA, KEBON JERUK, JAKARTA BARAT, DKI JAKARTA",56,76,136,212
https://kawalpemilu.org#25963,"SUKABUMI UTARA, KEBON JERUK, JAKARTA BARAT, DKI JAKARTA",57,52,134,186
https://kawalpemilu.org#25963,"SUKABUMI UTARA, KEBON JERUK, JAKARTA BARAT, DKI JAKARTA",58,64,197,261
https://kawalpemilu.org#25963,"SUKABUMI UTARA, KEBON JERUK, JAKARTA BARAT, DKI JAKARTA",59,80,126,206
https://kawalpemilu.org#25963,"SUKABUMI UTARA, KEBON JERUK, JAKARTA BARAT, DKI JAKARTA",60,85,101,186
https://kawalpemilu.org#25963,"SUKABUMI UTARA, KEBON JERUK, JAKARTA BARAT, DKI JAKARTA",61,101,87,188
https://kawalpemilu.org#25963,"SUKABUMI UTARA, KEBON JERUK, JAKARTA BARAT, DKI JAKARTA",62,60,192,252
https://kawalpemilu.org#25963,"SUKABUMI UTARA, KEBON JERUK, JAKARTA BARAT, DKI JAKARTA",63,116,125,241
https://kawalpemilu.org#25963,"SUKABUMI UTARA, KEBON JERUK, JAKARTA BARAT, DKI JAKARTA",64,125,144,269
https://kawalpemilu.org#25963,"SUKABUMI UTARA, KEBON JERUK, JAKARTA BARAT, DKI JAKARTA",65,72,88,160
https://kawalpemilu.org#25963,"SUKABUMI UTARA, KEBON JERUK, JAKARTA BARAT, DKI JAKARTA",67,120,119,239
https://kawalpemilu.org#25963,"SUKABUMI UTARA, KEBON JERUK, JAKARTA BARAT, DKI JAKARTA",68,69,139,208
https://kawalpemilu.org#25963,"SUKABUMI UTARA, KEBON JERUK, JAKARTA BARAT, DKI JAKARTA",69,74,148,222
https://kawalpemilu.org#25963,"SUKABUMI UTARA, KEBON JERUK, JAKARTA BARAT, DKI JAKARTA",70,79,167,246
https://kawalpemilu.org#25963,"SUKABUMI UTARA, KEBON JERUK, JAKARTA BARAT, DKI JAKARTA",71,91,163,254
https://kawalpemilu.org#25963,"SUKABUMI UTARA, KEBON JERUK, JAKARTA BARAT, DKI JAKARTA",72,49,161,210
https://kawalpemilu.org#25963,"SUKABUMI UTARA, KEBON JERUK, JAKARTA BARAT, DKI JAKARTA",73,56,140,196
https://kawalpemilu.org#25963,"SUKABUMI UTARA, KEBON JERUK, JAKARTA BARAT, DKI JAKARTA",74,88,163,251
https://kawalpemilu.org#25963,"SUKABUMI UTARA, KEBON JERUK, JAKARTA BARAT, DKI JAKARTA",75,102,104,206
https://kawalpemilu.org#25963,"SUKABUMI UTARA, KEBON JERUK, JAKARTA BARAT, DKI JAKARTA",76,155,108,263
https://kawalpemilu.org#25963,"SUKABUMI UTARA, KEBON JERUK, JAKARTA BARAT, DKI JAKARTA",77,88,101,189
https://kawalpemilu.org#25963,"SUKABUMI UTARA, KEBON JERUK, JAKARTA BARAT, DKI JAKARTA",78,128,115,243
https://kawalpemilu.org#25963,"SUKABUMI UTARA, KEBON JERUK, JAKARTA BARAT, DKI JAKARTA",79,71,171,242
https://kawalpemilu.org#25963,"SUKABUMI UTARA, KEBON JERUK, JAKARTA BARAT, DKI JAKARTA",80,80,163,243
https://kawalpemilu.org#25963,"SUKABUMI UTARA, KEBON JERUK, JAKARTA BARAT, DKI JAKARTA",81,92,147,239
https://kawalpemilu.org#25963,"SUKABUMI UTARA, KEBON JERUK, JAKARTA BARAT, DKI JAKARTA",82,72,120,192
https://kawalpemilu.org#25963,"SUKABUMI UTARA, KEBON JERUK, JAKARTA BARAT, DKI JAKARTA",83,60,121,181
https://kawalpemilu.org#25963,"SUKABUMI UTARA, KEBON JERUK, JAKARTA BARAT, DKI JAKARTA",84,56,170,226
https://kawalpemilu.org#25963,"SUKABUMI UTARA, KEBON JERUK, JAKARTA BARAT, DKI JAKARTA",85,64,108,172
https://kawalpemilu.org#25963,"SUKABUMI UTARA, KEBON JERUK, JAKARTA BARAT, DKI JAKARTA",86,41,183,224
https://kawalpemilu.org#25963,"SUKABUMI UTARA, KEBON JERUK, JAKARTA BARAT, DKI JAKARTA",87,68,118,186
https://kawalpemilu.org#25963,"SUKABUMI UTARA, KEBON JERUK, JAKARTA BARAT, DKI JAKARTA",88,47,144,191
https://kawalpemilu.org#25963,"SUKABUMI UTARA, KEBON JERUK, JAKARTA BARAT, DKI JAKARTA",89,63,135,198
https://kawalpemilu.org#25963,"SUKABUMI UTARA, KEBON JERUK, JAKARTA BARAT, DKI JAKARTA",90,72,165,237
https://kawalpemilu.org#25963,"SUKABUMI UTARA, KEBON JERUK, JAKARTA BARAT, DKI JAKARTA",91,59,157,216
https://kawalpemilu.org#25963,"SUKABUMI UTARA, KEBON JERUK, JAKARTA BARAT, DKI JAKARTA",92,45,182,227
https://kawalpemilu.org#25963,"SUKABUMI UTARA, KEBON JERUK, JAKARTA BARAT, DKI JAKARTA",93,65,212,277
https://kawalpemilu.org#25963,"SUKABUMI UTARA, KEBON JERUK, JAKARTA BARAT, DKI JAKARTA",94,63,183,246
https://kawalpemilu.org#25963,"SUKABUMI UTARA, KEBON JERUK, JAKARTA BARAT, DKI JAKARTA",95,80,120,200
https://kawalpemilu.org#25963,"SUKABUMI UTARA, KEBON JERUK, JAKARTA BARAT, DKI JAKARTA",96,64,121,185
https://kawalpemilu.org#25963,"SUKABUMI UTARA, KEBON JERUK, JAKARTA BARAT, DKI JAKARTA",97,59,147,206
https://kawalpemilu.org#25963,"SUKABUMI UTARA, KEBON JERUK, JAKARTA BARAT, DKI JAKARTA",98,53,182,235
https://kawalpemilu.org#25963,"SUKABUMI UTARA, KEBON JERUK, JAKARTA BARAT, DKI JAKARTA",99,55,188,243
https://kawalpemilu.org#25963,"SUKABUMI UTARA, KEBON JERUK, JAKARTA BARAT, DKI JAKARTA",100,64,179,243
https://kawalpemilu.org#25963,"SUKABUMI UTARA, KEBON JERUK, JAKARTA BARAT, DKI JAKARTA",101,62,199,261
https://kawalpemilu.org#25963,"SUKABUMI UTARA, KEBON JERUK, JAKARTA BARAT, DKI JAKARTA",102,76,175,251
https://kawalpemilu.org#25963,"SUKABUMI UTARA, KEBON JERUK, JAKARTA BARAT, DKI JAKARTA",103,74,187,261
https://kawalpemilu.org#25963,"SUKABUMI UTARA, KEBON JERUK, JAKARTA BARAT, DKI JAKARTA",104,32,152,184
https://kawalpemilu.org#25963,"SUKABUMI UTARA, KEBON JERUK, JAKARTA BARAT, DKI JAKARTA",105,24,133,157
https://kawalpemilu.org#25963,"SUKABUMI UTARA, KEBON JERUK, JAKARTA BARAT, DKI JAKARTA",106,61,194,255
https://kawalpemilu.org#25963,"SUKABUMI UTARA, KEBON JERUK, JAKARTA BARAT, DKI JAKARTA",107,30,208,238
https://kawalpemilu.org#25963,"SUKABUMI UTARA, KEBON JERUK, JAKARTA BARAT, DKI JAKARTA",108,56,163,219
https://kawalpemilu.org#25963,"SUKABUMI UTARA, KEBON JERUK, JAKARTA BARAT, DKI JAKARTA",109,42,136,178
https://kawalpemilu.org#25963,"SUKABUMI UTARA, KEBON JERUK, JAKARTA BARAT, DKI JAKARTA",110,33,174,207
https://kawalpemilu.org#25963,"SUKABUMI UTARA, KEBON JERUK, JAKARTA BARAT, DKI JAKARTA",111,48,196,244
https://kawalpemilu.org#25963,"SUKABUMI UTARA, KEBON JERUK, JAKARTA BARAT, DKI JAKARTA",112,37,172,209
https://kawalpemilu.org#25963,"SUKABUMI UTARA, KEBON JERUK, JAKARTA BARAT, DKI JAKARTA",113,36,188,224
https://kawalpemilu.org#25963,"SUKABUMI UTARA, KEBON JERUK, JAKARTA BARAT, DKI JAKARTA",114,38,147,185
https://kawalpemilu.org#25963,"SUKABUMI UTARA, KEBON JERUK, JAKARTA BARAT, DKI JAKARTA",115,42,161,203
https://kawalpemilu.org#25963,"SUKABUMI UTARA, KEBON JERUK, JAKARTA BARAT, DKI JAKARTA",116,58,146,204
https://kawalpemilu.org#25963,"SUKABUMI UTARA, KEBON JERUK, JAKARTA BARAT, DKI JAKARTA",117,53,175,228
https://kawalpemilu.org#25963,"SUKABUMI UTARA, KEBON JERUK, JAKARTA BARAT, DKI JAKARTA",118,70,125,195
https://kawalpemilu.org#25963,"SUKABUMI UTARA, KEBON JERUK, JAKARTA BARAT, DKI JAKARTA",119,69,189,258
https://kawalpemilu.org#25963,"SUKABUMI UTARA, KEBON JERUK, JAKARTA BARAT, DKI JAKARTA",120,56,128,184
https://kawalpemilu.org#25963,"SUKABUMI UTARA, KEBON JERUK, JAKARTA BARAT, DKI JAKARTA",121,49,145,194
https://kawalpemilu.org#25963,"SUKABUMI UTARA, KEBON JERUK, JAKARTA BARAT, DKI JAKARTA",122,56,169,225
https://kawalpemilu.org#25963,"SUKABUMI UTARA, KEBON JERUK, JAKARTA BARAT, DKI JAKARTA",123,43,171,214
https://kawalpemilu.org#25963,"SUKABUMI UTARA, KEBON JERUK, JAKARTA BARAT, DKI JAKARTA",124,42,166,208
https://kawalpemilu.org#25963,"SUKABUMI UTARA, KEBON JERUK, JAKARTA BARAT, DKI JAKARTA",125,48,133,181
https://kawalpemilu.org#25963,"SUKABUMI UTARA, KEBON JERUK, JAKARTA BARAT, DKI JAKARTA",126,29,160,189
https://kawalpemilu.org#25964,"SUKABUMI SELATAN, KEBON JERUK, JAKARTA BARAT, DKI JAKARTA",1,82,138,220
https://kawalpemilu.org#25964,"SUKABUMI SELATAN, KEBON JERUK, JAKARTA BARAT, DKI JAKARTA",2,78,180,258
https://kawalpemilu.org#25964,"SUKABUMI SELATAN, KEBON JERUK, JAKARTA BARAT, DKI JAKARTA",3,89,127,216
https://kawalpemilu.org#25964,"SUKABUMI SELATAN, KEBON JERUK, JAKARTA BARAT, DKI JAKARTA",4,56,129,185
https://kawalpemilu.org#25964,"SUKABUMI SELATAN, KEBON JERUK, JAKARTA BARAT, DKI JAKARTA",5,29,133,162
https://kawalpemilu.org#25964,"SUKABUMI SELATAN, KEBON JERUK, JAKARTA BARAT, DKI JAKARTA",6,144,116,260
https://kawalpemilu.org#25964,"SUKABUMI SELATAN, KEBON JERUK, JAKARTA BARAT, DKI JAKARTA",7,108,127,235
https://kawalpemilu.org#25964,"SUKABUMI SELATAN, KEBON JERUK, JAKARTA BARAT, DKI JAKARTA",8,77,164,241
https://kawalpemilu.org#25964,"SUKABUMI SELATAN, KEBON JERUK, JAKARTA BARAT, DKI JAKARTA",9,56,175,231
https://kawalpemilu.org#25964,"SUKABUMI SELATAN, KEBON JERUK, JAKARTA BARAT, DKI JAKARTA",10,49,196,245
https://kawalpemilu.org#25964,"SUKABUMI SELATAN, KEBON JERUK, JAKARTA BARAT, DKI JAKARTA",11,59,121,180
https://kawalpemilu.org#25964,"SUKABUMI SELATAN, KEBON JERUK, JAKARTA BARAT, DKI JAKARTA",12,76,191,267
https://kawalpemilu.org#25964,"SUKABUMI SELATAN, KEBON JERUK, JAKARTA BARAT, DKI JAKARTA",13,98,148,246
https://kawalpemilu.org#25964,"SUKABUMI SELATAN, KEBON JERUK, JAKARTA BARAT, DKI JAKARTA",14,58,173,231
https://kawalpemilu.org#25964,"SUKABUMI SELATAN, KEBON JERUK, JAKARTA BARAT, DKI JAKARTA",15,69,160,229
https://kawalpemilu.org#25964,"SUKABUMI SELATAN, KEBON JERUK, JAKARTA BARAT, DKI JAKARTA",16,86,127,213
https://kawalpemilu.org#25964,"SUKABUMI SELATAN, KEBON JERUK, JAKARTA BARAT, DKI JAKARTA",17,75,162,237
https://kawalpemilu.org#25964,"SUKABUMI SELATAN, KEBON JERUK, JAKARTA BARAT, DKI JAKARTA",18,0,0,0
https://kawalpemilu.org#25964,"SUKABUMI SELATAN, KEBON JERUK, JAKARTA BARAT, DKI JAKARTA",19,60,140,200
https://kawalpemilu.org#25964,"SUKABUMI SELATAN, KEBON JERUK, JAKARTA BARAT, DKI JAKARTA",20,73,161,234
https://kawalpemilu.org#25964,"SUKABUMI SELATAN, KEBON JERUK, JAKARTA BARAT, DKI JAKARTA",21,82,164,246
https://kawalpemilu.org#25964,"SUKABUMI SELATAN, KEBON JERUK, JAKARTA BARAT, DKI JAKARTA",22,67,162,229
https://kawalpemilu.org#25964,"SUKABUMI SELATAN, KEBON JERUK, JAKARTA BARAT, DKI JAKARTA",23,79,154,233
https://kawalpemilu.org#25964,"SUKABUMI SELATAN, KEBON JERUK, JAKARTA BARAT, DKI JAKARTA",24,70,160,230
https://kawalpemilu.org#25964,"SUKABUMI SELATAN, KEBON JERUK, JAKARTA BARAT, DKI JAKARTA",25,77,177,254
https://kawalpemilu.org#25964,"SUKABUMI SELATAN, KEBON JERUK, JAKARTA BARAT, DKI JAKARTA",26,27,131,158
https://kawalpemilu.org#25964,"SUKABUMI SELATAN, KEBON JERUK, JAKARTA BARAT, DKI JAKARTA",27,91,160,251
https://kawalpemilu.org#25964,"SUKABUMI SELATAN, KEBON JERUK, JAKARTA BARAT, DKI JAKARTA",28,87,174,261
https://kawalpemilu.org#25964,"SUKABUMI SELATAN, KEBON JERUK, JAKARTA BARAT, DKI JAKARTA",29,0,0,0
https://kawalpemilu.org#25964,"SUKABUMI SELATAN, KEBON JERUK, JAKARTA BARAT, DKI JAKARTA",30,59,185,244
https://kawalpemilu.org#25964,"SUKABUMI SELATAN, KEBON JERUK, JAKARTA BARAT, DKI JAKARTA",31,83,173,256
https://kawalpemilu.org#25964,"SUKABUMI SELATAN, KEBON JERUK, JAKARTA BARAT, DKI JAKARTA",32,74,217,291
https://kawalpemilu.org#25964,"SUKABUMI SELATAN, KEBON JERUK, JAKARTA BARAT, DKI JAKARTA",33,88,170,258
https://kawalpemilu.org#25964,"SUKABUMI SELATAN, KEBON JERUK, JAKARTA BARAT, DKI JAKARTA",34,75,154,229
https://kawalpemilu.org#25964,"SUKABUMI SELATAN, KEBON JERUK, JAKARTA BARAT, DKI JAKARTA",35,60,153,213
https://kawalpemilu.org#25964,"SUKABUMI SELATAN, KEBON JERUK, JAKARTA BARAT, DKI JAKARTA",36,55,138,193
https://kawalpemilu.org#25964,"SUKABUMI SELATAN, KEBON JERUK, JAKARTA BARAT, DKI JAKARTA",37,76,169,245
https://kawalpemilu.org#25964,"SUKABUMI SELATAN, KEBON JERUK, JAKARTA BARAT, DKI JAKARTA",38,86,158,244
https://kawalpemilu.org#25964,"SUKABUMI SELATAN, KEBON JERUK, JAKARTA BARAT, DKI JAKARTA",39,74,161,235
https://kawalpemilu.org#25964,"SUKABUMI SELATAN, KEBON JERUK, JAKARTA BARAT, DKI JAKARTA",40,74,161,235
https://kawalpemilu.org#25964,"SUKABUMI SELATAN, KEBON JERUK, JAKARTA BARAT, DKI JAKARTA",41,87,184,271
https://kawalpemilu.org#25964,"SUKABUMI SELATAN, KEBON JERUK, JAKARTA BARAT, DKI JAKARTA",42,89,199,288
https://kawalpemilu.org#25964,"SUKABUMI SELATAN, KEBON JERUK, JAKARTA BARAT, DKI JAKARTA",43,82,180,262
https://kawalpemilu.org#25964,"SUKABUMI SELATAN, KEBON JERUK, JAKARTA BARAT, DKI JAKARTA",44,60,189,249
https://kawalpemilu.org#25964,"SUKABUMI SELATAN, KEBON JERUK, JAKARTA BARAT, DKI JAKARTA",45,62,200,262
https://kawalpemilu.org#25964,"SUKABUMI SELATAN, KEBON JERUK, JAKARTA BARAT, DKI JAKARTA",46,57,165,222
https://kawalpemilu.org#25964,"SUKABUMI SELATAN, KEBON JERUK, JAKARTA BARAT, DKI JAKARTA",47,68,172,240
https://kawalpemilu.org#25964,"SUKABUMI SELATAN, KEBON JERUK, JAKARTA BARAT, DKI JAKARTA",48,49,198,247
https://kawalpemilu.org#25964,"SUKABUMI SELATAN, KEBON JERUK, JAKARTA BARAT, DKI JAKARTA",49,54,136,190
https://kawalpemilu.org#25964,"SUKABUMI SELATAN, KEBON JERUK, JAKARTA BARAT, DKI JAKARTA",50,62,123,185
https://kawalpemilu.org#25964,"SUKABUMI SELATAN, KEBON JERUK, JAKARTA BARAT, DKI JAKARTA",51,62,196,258
https://kawalpemilu.org#25964,"SUKABUMI SELATAN, KEBON JERUK, JAKARTA BARAT, DKI JAKARTA",52,65,177,242
https://kawalpemilu.org#25964,"SUKABUMI SELATAN, KEBON JERUK, JAKARTA BARAT, DKI JAKARTA",53,59,192,251
https://kawalpemilu.org#25964,"SUKABUMI SELATAN, KEBON JERUK, JAKARTA BARAT, DKI JAKARTA",54,40,193,233
https://kawalpemilu.org#25964,"SUKABUMI SELATAN, KEBON JERUK, JAKARTA BARAT, DKI JAKARTA",55,61,163,224
https://kawalpemilu.org#25964,"SUKABUMI SELATAN, KEBON JERUK, JAKARTA BARAT, DKI JAKARTA",56,111,121,232
https://kawalpemilu.org#25964,"SUKABUMI SELATAN, KEBON JERUK, JAKARTA BARAT, DKI JAKARTA",57,81,196,277
https://kawalpemilu.org#25964,"SUKABUMI SELATAN, KEBON JERUK, JAKARTA BARAT, DKI JAKARTA",58,73,170,243
https://kawalpemilu.org#25964,"SUKABUMI SELATAN, KEBON JERUK, JAKARTA BARAT, DKI JAKARTA",59,80,177,257
https://kawalpemilu.org#25964,"SUKABUMI SELATAN, KEBON JERUK, JAKARTA BARAT, DKI JAKARTA",60,69,164,233
https://kawalpemilu.org#25964,"SUKABUMI SELATAN, KEBON JERUK, JAKARTA BARAT, DKI JAKARTA",61,73,180,253
https://kawalpemilu.org#25964,"SUKABUMI SELATAN, KEBON JERUK, JAKARTA BARAT, DKI JAKARTA",62,67,188,255
https://kawalpemilu.org#25964,"SUKABUMI SELATAN, KEBON JERUK, JAKARTA BARAT, DKI JAKARTA",63,49,92,141
https://kawalpemilu.org#25964,"SUKABUMI SELATAN, KEBON JERUK, JAKARTA BARAT, DKI JAKARTA",64,101,156,257
https://kawalpemilu.org#25964,"SUKABUMI SELATAN, KEBON JERUK, JAKARTA BARAT, DKI JAKARTA",65,73,171,244
https://kawalpemilu.org#25964,"SUKABUMI SELATAN, KEBON JERUK, JAKARTA BARAT, DKI JAKARTA",66,45,169,214
https://kawalpemilu.org#25964,"SUKABUMI SELATAN, KEBON JERUK, JAKARTA BARAT, DKI JAKARTA",67,72,201,273
https://kawalpemilu.org#25964,"SUKABUMI SELATAN, KEBON JERUK, JAKARTA BARAT, DKI JAKARTA",68,67,166,233
https://kawalpemilu.org#25964,"SUKABUMI SELATAN, KEBON JERUK, JAKARTA BARAT, DKI JAKARTA",69,94,143,237
https://kawalpemilu.org#25964,"SUKABUMI SELATAN, KEBON JERUK, JAKARTA BARAT, DKI JAKARTA",70,81,182,263
https://kawalpemilu.org#25964,"SUKABUMI SELATAN, KEBON JERUK, JAKARTA BARAT, DKI JAKARTA",71,57,170,227
https://kawalpemilu.org#25964,"SUKABUMI SELATAN, KEBON JERUK, JAKARTA BARAT, DKI JAKARTA",72,51,176,227
https://kawalpemilu.org#25964,"SUKABUMI SELATAN, KEBON JERUK, JAKARTA BARAT, DKI JAKARTA",73,68,118,186
https://kawalpemilu.org#25964,"SUKABUMI SELATAN, KEBON JERUK, JAKARTA BARAT, DKI JAKARTA",74,58,143,201
https://kawalpemilu.org#25964,"SUKABUMI SELATAN, KEBON JERUK, JAKARTA BARAT, DKI JAKARTA",75,78,143,221
https://kawalpemilu.org#25964,"SUKABUMI SELATAN, KEBON JERUK, JAKARTA BARAT, DKI JAKARTA",76,102,150,252
https://kawalpemilu.org#25964,"SUKABUMI SELATAN, KEBON JERUK, JAKARTA BARAT, DKI JAKARTA",77,107,131,238
https://kawalpemilu.org#25964,"SUKABUMI SELATAN, KEBON JERUK, JAKARTA BARAT, DKI JAKARTA",78,65,87,152
https://kawalpemilu.org#25964,"SUKABUMI SELATAN, KEBON JERUK, JAKARTA BARAT, DKI JAKARTA",79,71,177,248
https://kawalpemilu.org#25964,"SUKABUMI SELATAN, KEBON JERUK, JAKARTA BARAT, DKI JAKARTA",80,84,163,247
https://kawalpemilu.org#25964,"SUKABUMI SELATAN, KEBON JERUK, JAKARTA BARAT, DKI JAKARTA",81,92,136,228
https://kawalpemilu.org#25964,"SUKABUMI SELATAN, KEBON JERUK, JAKARTA BARAT, DKI JAKARTA",82,66,169,235
https://kawalpemilu.org#25964,"SUKABUMI SELATAN, KEBON JERUK, JAKARTA BARAT, DKI JAKARTA",83,72,174,246
https://kawalpemilu.org#25964,"SUKABUMI SELATAN, KEBON JERUK, JAKARTA BARAT, DKI JAKARTA",84,85,146,231
https://kawalpemilu.org#25964,"SUKABUMI SELATAN, KEBON JERUK, JAKARTA BARAT, DKI JAKARTA",85,72,171,243
https://kawalpemilu.org#25964,"SUKABUMI SELATAN, KEBON JERUK, JAKARTA BARAT, DKI JAKARTA",86,96,162,258
https://kawalpemilu.org#25964,"SUKABUMI SELATAN, KEBON JERUK, JAKARTA BARAT, DKI JAKARTA",87,95,145,240
https://kawalpemilu.org#25964,"SUKABUMI SELATAN, KEBON JERUK, JAKARTA BARAT, DKI JAKARTA",88,95,118,213
https://kawalpemilu.org#25964,"SUKABUMI SELATAN, KEBON JERUK, JAKARTA BARAT, DKI JAKARTA",89,72,109,181
https://kawalpemilu.org#25964,"SUKABUMI SELATAN, KEBON JERUK, JAKARTA BARAT, DKI JAKARTA",90,78,167,245
https://kawalpemilu.org#25964,"SUKABUMI SELATAN, KEBON JERUK, JAKARTA BARAT, DKI JAKARTA",91,64,162,226
https://kawalpemilu.org#25964,"SUKABUMI SELATAN, KEBON JERUK, JAKARTA BARAT, DKI JAKARTA",92,101,139,240
https://kawalpemilu.org#25964,"SUKABUMI SELATAN, KEBON JERUK, JAKARTA BARAT, DKI JAKARTA",93,108,97,205
https://kawalpemilu.org#25964,"SUKABUMI SELATAN, KEBON JERUK, JAKARTA BARAT, DKI JAKARTA",94,74,148,222
https://kawalpemilu.org#25964,"SUKABUMI SELATAN, KEBON JERUK, JAKARTA BARAT, DKI JAKARTA",95,71,155,226
https://kawalpemilu.org#25964,"SUKABUMI SELATAN, KEBON JERUK, JAKARTA BARAT, DKI JAKARTA",96,64,140,204
https://kawalpemilu.org#25964,"SUKABUMI SELATAN, KEBON JERUK, JAKARTA BARAT, DKI JAKARTA",97,58,175,233
https://kawalpemilu.org#25964,"SUKABUMI SELATAN, KEBON JERUK, JAKARTA BARAT, DKI JAKARTA",98,84,168,252
https://kawalpemilu.org#25964,"SUKABUMI SELATAN, KEBON JERUK, JAKARTA BARAT, DKI JAKARTA",99,55,148,203
https://kawalpemilu.org#25964,"SUKABUMI SELATAN, KEBON JERUK, JAKARTA BARAT, DKI JAKARTA",100,77,172,249
https://kawalpemilu.org#25964,"SUKABUMI SELATAN, KEBON JERUK, JAKARTA BARAT, DKI JAKARTA",101,67,165,232
https://kawalpemilu.org#25964,"SUKABUMI SELATAN, KEBON JERUK, JAKARTA BARAT, DKI JAKARTA",102,88,165,253
https://kawalpemilu.org#25964,"SUKABUMI SELATAN, KEBON JERUK, JAKARTA BARAT, DKI JAKARTA",103,72,151,223
https://kawalpemilu.org#25964,"SUKABUMI SELATAN, KEBON JERUK, JAKARTA BARAT, DKI JAKARTA",104,70,192,262
https://kawalpemilu.org#25964,"SUKABUMI SELATAN, KEBON JERUK, JAKARTA BARAT, DKI JAKARTA",105,83,142,225
https://kawalpemilu.org#25964,"SUKABUMI SELATAN, KEBON JERUK, JAKARTA BARAT, DKI JAKARTA",106,65,82,147
https://kawalpemilu.org#25964,"SUKABUMI SELATAN, KEBON JERUK, JAKARTA BARAT, DKI JAKARTA",107,94,115,209
https://kawalpemilu.org#25964,"SUKABUMI SELATAN, KEBON JERUK, JAKARTA BARAT, DKI JAKARTA",108,97,111,208
https://kawalpemilu.org#25964,"SUKABUMI SELATAN, KEBON JERUK, JAKARTA BARAT, DKI JAKARTA",109,76,133,209
https://kawalpemilu.org#25964,"SUKABUMI SELATAN, KEBON JERUK, JAKARTA BARAT, DKI JAKARTA",110,94,119,213
https://kawalpemilu.org#25964,"SUKABUMI SELATAN, KEBON JERUK, JAKARTA BARAT, DKI JAKARTA",111,75,171,246
https://kawalpemilu.org#25964,"SUKABUMI SELATAN, KEBON JERUK, JAKARTA BARAT, DKI JAKARTA",112,75,129,204
https://kawalpemilu.org#25964,"SUKABUMI SELATAN, KEBON JERUK, JAKARTA BARAT, DKI JAKARTA",113,64,84,148
https://kawalpemilu.org#25964,"SUKABUMI SELATAN, KEBON JERUK, JAKARTA BARAT, DKI JAKARTA",114,58,93,151
https://kawalpemilu.org#25964,"SUKABUMI SELATAN, KEBON JERUK, JAKARTA BARAT, DKI JAKARTA",115,64,99,163
https://kawalpemilu.org#25964,"SUKABUMI SELATAN, KEBON JERUK, JAKARTA BARAT, DKI JAKARTA",116,48,131,179
https://kawalpemilu.org#25964,"SUKABUMI SELATAN, KEBON JERUK, JAKARTA BARAT, DKI JAKARTA",117,68,87,155
https://kawalpemilu.org#25964,"SUKABUMI SELATAN, KEBON JERUK, JAKARTA BARAT, DKI JAKARTA",118,73,110,183
https://kawalpemilu.org#25964,"SUKABUMI SELATAN, KEBON JERUK, JAKARTA BARAT, DKI JAKARTA",119,59,96,155
https://kawalpemilu.org#25965,"KELAPA DUA, KEBON JERUK, JAKARTA BARAT, DKI JAKARTA",1,82,181,263
https://kawalpemilu.org#25965,"KELAPA DUA, KEBON JERUK, JAKARTA BARAT, DKI JAKARTA",2,88,173,261
https://kawalpemilu.org#25965,"KELAPA DUA, KEBON JERUK, JAKARTA BARAT, DKI JAKARTA",3,72,175,247
https://kawalpemilu.org#25965,"KELAPA DUA, KEBON JERUK, JAKARTA BARAT, DKI JAKARTA",4,66,181,247
https://kawalpemilu.org#25965,"KELAPA DUA, KEBON JERUK, JAKARTA BARAT, DKI JAKARTA",5,110,129,239
https://kawalpemilu.org#25965,"KELAPA DUA, KEBON JERUK, JAKARTA BARAT, DKI JAKARTA",6,77,165,242
https://kawalpemilu.org#25965,"KELAPA DUA, KEBON JERUK, JAKARTA BARAT, DKI JAKARTA",7,73,160,223
https://kawalpemilu.org#25965,"KELAPA DUA, KEBON JERUK, JAKARTA BARAT, DKI JAKARTA",8,58,192,250
https://kawalpemilu.org#25965,"KELAPA DUA, KEBON JERUK, JAKARTA BARAT, DKI JAKARTA",9,80,147,227
https://kawalpemilu.org#25965,"KELAPA DUA, KEBON JERUK, JAKARTA BARAT, DKI JAKARTA",10,51,175,226
https://kawalpemilu.org#25965,"KELAPA DUA, KEBON JERUK, JAKARTA BARAT, DKI JAKARTA",11,104,145,249
https://kawalpemilu.org#25965,"KELAPA DUA, KEBON JERUK, JAKARTA BARAT, DKI JAKARTA",12,125,153,278
https://kawalpemilu.org#25965,"KELAPA DUA, KEBON JERUK, JAKARTA BARAT, DKI JAKARTA",13,84,133,217
https://kawalpemilu.org#25965,"KELAPA DUA, KEBON JERUK, JAKARTA BARAT, DKI JAKARTA",14,82,163,245
https://kawalpemilu.org#25965,"KELAPA DUA, KEBON JERUK, JAKARTA BARAT, DKI JAKARTA",15,88,157,245
https://kawalpemilu.org#25965,"KELAPA DUA, KEBON JERUK, JAKARTA BARAT, DKI JAKARTA",16,84,186,270
https://kawalpemilu.org#25965,"KELAPA DUA, KEBON JERUK, JAKARTA BARAT, DKI JAKARTA",17,85,179,264
https://kawalpemilu.org#25965,"KELAPA DUA, KEBON JERUK, JAKARTA BARAT, DKI JAKARTA",18,0,0,0
https://kawalpemilu.org#25965,"KELAPA DUA, KEBON JERUK, JAKARTA BARAT, DKI JAKARTA",19,59,149,208
https://kawalpemilu.org#25965,"KELAPA DUA, KEBON JERUK, JAKARTA BARAT, DKI JAKARTA",20,119,150,269
https://kawalpemilu.org#25965,"KELAPA DUA, KEBON JERUK, JAKARTA BARAT, DKI JAKARTA",21,99,178,277
https://kawalpemilu.org#25965,"KELAPA DUA, KEBON JERUK, JAKARTA BARAT, DKI JAKARTA",22,88,179,267
https://kawalpemilu.org#25965,"KELAPA DUA, KEBON JERUK, JAKARTA BARAT, DKI JAKARTA",23,97,154,251
https://kawalpemilu.org#25965,"KELAPA DUA, KEBON JERUK, JAKARTA BARAT, DKI JAKARTA",24,74,147,221
https://kawalpemilu.org#25965,"KELAPA DUA, KEBON JERUK, JAKARTA BARAT, DKI JAKARTA",25,92,158,250
https://kawalpemilu.org#25965,"KELAPA DUA, KEBON JERUK, JAKARTA BARAT, DKI JAKARTA",26,78,151,229
https://kawalpemilu.org#25965,"KELAPA DUA, KEBON JERUK, JAKARTA BARAT, DKI JAKARTA",27,70,164,234
https://kawalpemilu.org#25965,"KELAPA DUA, KEBON JERUK, JAKARTA BARAT, DKI JAKARTA",28,87,186,273
https://kawalpemilu.org#25965,"KELAPA DUA, KEBON JERUK, JAKARTA BARAT, DKI JAKARTA",29,72,170,242
https://kawalpemilu.org#25965,"KELAPA DUA, KEBON JERUK, JAKARTA BARAT, DKI JAKARTA",30,91,142,232
https://kawalpemilu.org#25965,"KELAPA DUA, KEBON JERUK, JAKARTA BARAT, DKI JAKARTA",31,63,121,184
https://kawalpemilu.org#25965,"KELAPA DUA, KEBON JERUK, JAKARTA BARAT, DKI JAKARTA",32,116,103,219
https://kawalpemilu.org#25965,"KELAPA DUA, KEBON JERUK, JAKARTA BARAT, DKI JAKARTA",33,85,141,226
https://kawalpemilu.org#25965,"KELAPA DUA, KEBON JERUK, JAKARTA BARAT, DKI JAKARTA",34,56,161,217
https://kawalpemilu.org#25965,"KELAPA DUA, KEBON JERUK, JAKARTA BARAT, DKI JAKARTA",35,71,178,249
https://kawalpemilu.org#25965,"KELAPA DUA, KEBON JERUK, JAKARTA BARAT, DKI JAKARTA",36,57,176,233
https://kawalpemilu.org#25965,"KELAPA DUA, KEBON JERUK, JAKARTA BARAT, DKI JAKARTA",37,76,185,261
https://kawalpemilu.org#25965,"KELAPA DUA, KEBON JERUK, JAKARTA BARAT, DKI JAKARTA",38,88,128,216
https://kawalpemilu.org#25965,"KELAPA DUA, KEBON JERUK, JAKARTA BARAT, DKI JAKARTA",39,80,145,225
https://kawalpemilu.org#25965,"KELAPA DUA, KEBON JERUK, JAKARTA BARAT, DKI JAKARTA",40,112,141,253
https://kawalpemilu.org#25965,"KELAPA DUA, KEBON JERUK, JAKARTA BARAT, DKI JAKARTA",41,84,182,266
https://kawalpemilu.org#25965,"KELAPA DUA, KEBON JERUK, JAKARTA BARAT, DKI JAKARTA",42,70,182,252
https://kawalpemilu.org#25965,"KELAPA DUA, KEBON JERUK, JAKARTA BARAT, DKI JAKARTA",43,112,140,252
https://kawalpemilu.org#25965,"KELAPA DUA, KEBON JERUK, JAKARTA BARAT, DKI JAKARTA",44,80,129,209
https://kawalpemilu.org#25965,"KELAPA DUA, KEBON JERUK, JAKARTA BARAT, DKI JAKARTA",45,127,149,276
https://kawalpemilu.org#25965,"KELAPA DUA, KEBON JERUK, JAKARTA BARAT, DKI JAKARTA",46,66,199,265
https://kawalpemilu.org#25965,"KELAPA DUA, KEBON JERUK, JAKARTA BARAT, DKI JAKARTA",47,90,185,275
https://kawalpemilu.org#25965,"KELAPA DUA, KEBON JERUK, JAKARTA BARAT, DKI JAKARTA",48,69,204,273
https://kawalpemilu.org#25965,"KELAPA DUA, KEBON JERUK, JAKARTA BARAT, DKI JAKARTA",49,74,203,277
https://kawalpemilu.org#25965,"KELAPA DUA, KEBON JERUK, JAKARTA BARAT, DKI JAKARTA",50,102,176,278
https://kawalpemilu.org#25965,"KELAPA DUA, KEBON JERUK, JAKARTA BARAT, DKI JAKARTA",51,131,67,198
https://kawalpemilu.org#25965,"KELAPA DUA, KEBON JERUK, JAKARTA BARAT, DKI JAKARTA",52,122,92,214
https://kawalpemilu.org#25965,"KELAPA DUA, KEBON JERUK, JAKARTA BARAT, DKI JAKARTA",53,61,166,227
https://kawalpemilu.org#25965,"KELAPA DUA, KEBON JERUK, JAKARTA BARAT, DKI JAKARTA",54,66,206,272
https://kawalpemilu.org#25965,"KELAPA DUA, KEBON JERUK, JAKARTA BARAT, DKI JAKARTA",55,89,178,267
https://kawalpemilu.org#25965,"KELAPA DUA, KEBON JERUK, JAKARTA BARAT, DKI JAKARTA",56,72,193,265
https://kawalpemilu.org#25965,"KELAPA DUA, KEBON JERUK, JAKARTA BARAT, DKI JAKARTA",57,34,168,202
https://kawalpemilu.org#25965,"KELAPA DUA, KEBON JERUK, JAKARTA BARAT, DKI JAKARTA",58,71,195,266
https://kawalpemilu.org#25965,"KELAPA DUA, KEBON JERUK, JAKARTA BARAT, DKI JAKARTA",59,156,77,233
https://kawalpemilu.org#25965,"KELAPA DUA, KEBON JERUK, JAKARTA BARAT, DKI JAKARTA",60,149,61,210
https://kawalpemilu.org#25965,"KELAPA DUA, KEBON JERUK, JAKARTA BARAT, DKI JAKARTA",61,155,89,244
https://kawalpemilu.org#25965,"KELAPA DUA, KEBON JERUK, JAKARTA BARAT, DKI JAKARTA",62,72,120,192
https://kawalpemilu.org#25965,"KELAPA DUA, KEBON JERUK, JAKARTA BARAT, DKI JAKARTA",63,125,142,267
https://kawalpemilu.org#25965,"KELAPA DUA, KEBON JERUK, JAKARTA BARAT, DKI JAKARTA",64,75,188,263
https://kawalpemilu.org#25965,"KELAPA DUA, KEBON JERUK, JAKARTA BARAT, DKI JAKARTA",65,84,168,252
https://kawalpemilu.org#25965,"KELAPA DUA, KEBON JERUK, JAKARTA BARAT, DKI JAKARTA",66,72,196,268
https://kawalpemilu.org#25965,"KELAPA DUA, KEBON JERUK, JAKARTA BARAT, DKI JAKARTA",67,74,197,271
https://kawalpemilu.org#25965,"KELAPA DUA, KEBON JERUK, JAKARTA BARAT, DKI JAKARTA",68,63,130,193
https://kawalpemilu.org#25965,"KELAPA DUA, KEBON JERUK, JAKARTA BARAT, DKI JAKARTA",69,105,120,225
https://kawalpemilu.org#25965,"KELAPA DUA, KEBON JERUK, JAKARTA BARAT, DKI JAKARTA",70,73,176,249
https://kawalpemilu.org#25965,"KELAPA DUA, KEBON JERUK, JAKARTA BARAT, DKI JAKARTA",71,120,126,246
https://kawalpemilu.org#25966,"DURI KEPA, KEBON JERUK, JAKARTA BARAT, DKI JAKARTA",1,181,40,221
https://kawalpemilu.org#25966,"DURI KEPA, KEBON JERUK, JAKARTA BARAT, DKI JAKARTA",2,105,77,182
https://kawalpemilu.org#25966,"DURI KEPA, KEBON JERUK, JAKARTA BARAT, DKI JAKARTA",3,152,52,204
https://kawalpemilu.org#25966,"DURI KEPA, KEBON JERUK, JAKARTA BARAT, DKI JAKARTA",4,151,132,283
https://kawalpemilu.org#25966,"DURI KEPA, KEBON JERUK, JAKARTA BARAT, DKI JAKARTA",5,81,106,187
https://kawalpemilu.org#25966,"DURI KEPA, KEBON JERUK, JAKARTA BARAT, DKI JAKARTA",6,80,88,168
https://kawalpemilu.org#25966,"DURI KEPA, KEBON JERUK, JAKARTA BARAT, DKI JAKARTA",7,105,155,260
https://kawalpemilu.org#25966,"DURI KEPA, KEBON JERUK, JAKARTA BARAT, DKI JAKARTA",8,75,131,206
https://kawalpemilu.org#25966,"DURI KEPA, KEBON JERUK, JAKARTA BARAT, DKI JAKARTA",9,76,163,239
https://kawalpemilu.org#25966,"DURI KEPA, KEBON JERUK, JAKARTA BARAT, DKI JAKARTA",10,63,162,227
https://kawalpemilu.org#25966,"DURI KEPA, KEBON JERUK, JAKARTA BARAT, DKI JAKARTA",11,85,116,201
https://kawalpemilu.org#25966,"DURI KEPA, KEBON JERUK, JAKARTA BARAT, DKI JAKARTA",12,112,140,252
https://kawalpemilu.org#25966,"DURI KEPA, KEBON JERUK, JAKARTA BARAT, DKI JAKARTA",13,96,96,192
https://kawalpemilu.org#25966,"DURI KEPA, KEBON JERUK, JAKARTA BARAT, DKI JAKARTA",14,134,113,247
https://kawalpemilu.org#25966,"DURI KEPA, KEBON JERUK, JAKARTA BARAT, DKI JAKARTA",15,115,100,215
https://kawalpemilu.org#25966,"DURI KEPA, KEBON JERUK, JAKARTA BARAT, DKI JAKARTA",16,131,132,263
https://kawalpemilu.org#25966,"DURI KEPA, KEBON JERUK, JAKARTA BARAT, DKI JAKARTA",17,121,136,257
https://kawalpemilu.org#25966,"DURI KEPA, KEBON JERUK, JAKARTA BARAT, DKI JAKARTA",18,86,178,264
https://kawalpemilu.org#25966,"DURI KEPA, KEBON JERUK, JAKARTA BARAT, DKI JAKARTA",19,77,164,241
https://kawalpemilu.org#25966,"DURI KEPA, KEBON JERUK, JAKARTA BARAT, DKI JAKARTA",20,139,162,301
https://kawalpemilu.org#25966,"DURI KEPA, KEBON JERUK, JAKARTA BARAT, DKI JAKARTA",21,92,131,223
https://kawalpemilu.org#25966,"DURI KEPA, KEBON JERUK, JAKARTA BARAT, DKI JAKARTA",22,114,168,282
https://kawalpemilu.org#25966,"DURI KEPA, KEBON JERUK, JAKARTA BARAT, DKI JAKARTA",23,121,31,152
https://kawalpemilu.org#25966,"DURI KEPA, KEBON JERUK, JAKARTA BARAT, DKI JAKARTA",24,195,27,222
https://kawalpemilu.org#25966,"DURI KEPA, KEBON JERUK, JAKARTA BARAT, DKI JAKARTA",25,204,34,238
https://kawalpemilu.org#25966,"DURI KEPA, KEBON JERUK, JAKARTA BARAT, DKI JAKARTA",26,174,50,224
https://kawalpemilu.org#25966,"DURI KEPA, KEBON JERUK, JAKARTA BARAT, DKI JAKARTA",27,147,50,197
https://kawalpemilu.org#25966,"DURI KEPA, KEBON JERUK, JAKARTA BARAT, DKI JAKARTA",28,151,46,197
https://kawalpemilu.org#25966,"DURI KEPA, KEBON JERUK, JAKARTA BARAT, DKI JAKARTA",29,141,51,192
https://kawalpemilu.org#25966,"DURI KEPA, KEBON JERUK, JAKARTA BARAT, DKI JAKARTA",30,109,52,161
https://kawalpemilu.org#25966,"DURI KEPA, KEBON JERUK, JAKARTA BARAT, DKI JAKARTA",31,147,100,247
https://kawalpemilu.org#25966,"DURI KEPA, KEBON JERUK, JAKARTA BARAT, DKI JAKARTA",32,142,93,235
https://kawalpemilu.org#25966,"DURI KEPA, KEBON JERUK, JAKARTA BARAT, DKI JAKARTA",33,0,0,0
https://kawalpemilu.org#25966,"DURI KEPA, KEBON JERUK, JAKARTA BARAT, DKI JAKARTA",34,130,74,204
https://kawalpemilu.org#25966,"DURI KEPA, KEBON JERUK, JAKARTA BARAT, DKI JAKARTA",35,175,99,224
https://kawalpemilu.org#25966,"DURI KEPA, KEBON JERUK, JAKARTA BARAT, DKI JAKARTA",36,128,25,153
https://kawalpemilu.org#25966,"DURI KEPA, KEBON JERUK, JAKARTA BARAT, DKI JAKARTA",37,87,31,118
https://kawalpemilu.org#25966,"DURI KEPA, KEBON JERUK, JAKARTA BARAT, DKI JAKARTA",38,149,99,248
https://kawalpemilu.org#25966,"DURI KEPA, KEBON JERUK, JAKARTA BARAT, DKI JAKARTA",39,169,34,203
https://kawalpemilu.org#25966,"DURI KEPA, KEBON JERUK, JAKARTA BARAT, DKI JAKARTA",40,194,57,251
https://kawalpemilu.org#25966,"DURI KEPA, KEBON JERUK, JAKARTA BARAT, DKI JAKARTA",41,204,34,238
https://kawalpemilu.org#25966,"DURI KEPA, KEBON JERUK, JAKARTA BARAT, DKI JAKARTA",42,173,43,216
https://kawalpemilu.org#25966,"DURI KEPA, KEBON JERUK, JAKARTA BARAT, DKI JAKARTA",43,135,27,162
https://kawalpemilu.org#25966,"DURI KEPA, KEBON JERUK, JAKARTA BARAT, DKI JAKARTA",44,221,28,249
https://kawalpemilu.org#25966,"DURI KEPA, KEBON JERUK, JAKARTA BARAT, DKI JAKARTA",45,156,40,196
https://kawalpemilu.org#25966,"DURI KEPA, KEBON JERUK, JAKARTA BARAT, DKI JAKARTA",46,156,20,176
https://kawalpemilu.org#25966,"DURI KEPA, KEBON JERUK, JAKARTA BARAT, DKI JAKARTA",47,161,49,210
https://kawalpemilu.org#25966,"DURI KEPA, KEBON JERUK, JAKARTA BARAT, DKI JAKARTA",48,148,39,187
https://kawalpemilu.org#25966,"DURI KEPA, KEBON JERUK, JAKARTA BARAT, DKI JAKARTA",49,133,34,167
https://kawalpemilu.org#25966,"DURI KEPA, KEBON JERUK, JAKARTA BARAT, DKI JAKARTA",50,181,47,228
https://kawalpemilu.org#25966,"DURI KEPA, KEBON JERUK, JAKARTA BARAT, DKI JAKARTA",51,184,64,248
https://kawalpemilu.org#25966,"DURI KEPA, KEBON JERUK, JAKARTA BARAT, DKI JAKARTA",52,173,68,241
https://kawalpemilu.org#25966,"DURI KEPA, KEBON JERUK, JAKARTA BARAT, DKI JAKARTA",53,157,70,227
https://kawalpemilu.org#25966,"DURI KEPA, KEBON JERUK, JAKARTA BARAT, DKI JAKARTA",54,155,68,223
https://kawalpemilu.org#25966,"DURI KEPA, KEBON JERUK, JAKARTA BARAT, DKI JAKARTA",55,140,114,254
https://kawalpemilu.org#25966,"DURI KEPA, KEBON JERUK, JAKARTA BARAT, DKI JAKARTA",56,157,95,252
https://kawalpemilu.org#25966,"DURI KEPA, KEBON JERUK, JAKARTA BARAT, DKI JAKARTA",57,134,87,221
https://kawalpemilu.org#25966,"DURI KEPA, KEBON JERUK, JAKARTA BARAT, DKI JAKARTA",58,146,76,222
https://kawalpemilu.org#25966,"DURI KEPA, KEBON JERUK, JAKARTA BARAT, DKI JAKARTA",59,140,96,236
https://kawalpemilu.org#25966,"DURI KEPA, KEBON JERUK, JAKARTA BARAT, DKI JAKARTA",60,153,104,257
https://kawalpemilu.org#25966,"DURI KEPA, KEBON JERUK, JAKARTA BARAT, DKI JAKARTA",61,105,99,204
https://kawalpemilu.org#25966,"DURI KEPA, KEBON JERUK, JAKARTA BARAT, DKI JAKARTA",62,119,86,205
https://kawalpemilu.org#25966,"DURI KEPA, KEBON JERUK, JAKARTA BARAT, DKI JAKARTA",63,126,79,205
https://kawalpemilu.org#25966,"DURI KEPA, KEBON JERUK, JAKARTA BARAT, DKI JAKARTA",64,160,92,252
https://kawalpemilu.org#25966,"DURI KEPA, KEBON JERUK, JAKARTA BARAT, DKI JAKARTA",65,150,99,249
https://kawalpemilu.org#25966,"DURI KEPA, KEBON JERUK, JAKARTA BARAT, DKI JAKARTA",66,114,51,165
https://kawalpemilu.org#25966,"DURI KEPA, KEBON JERUK, JAKARTA BARAT, DKI JAKARTA",67,105,93,198
https://kawalpemilu.org#25966,"DURI KEPA, KEBON JERUK, JAKARTA BARAT, DKI JAKARTA",68,119,63,182
https://kawalpemilu.org#25966,"DURI KEPA, KEBON JERUK, JAKARTA BARAT, DKI JAKARTA",69,131,91,222
https://kawalpemilu.org#25966,"DURI KEPA, KEBON JERUK, JAKARTA BARAT, DKI JAKARTA",70,140,114,254
https://kawalpemilu.org#25966,"DURI KEPA, KEBON JERUK, JAKARTA BARAT, DKI JAKARTA",71,144,104,248
https://kawalpemilu.org#25966,"DURI KEPA, KEBON JERUK, JAKARTA BARAT, DKI JAKARTA",72,137,94,231
https://kawalpemilu.org#25966,"DURI KEPA, KEBON JERUK, JAKARTA BARAT, DKI JAKARTA",73,163,55,218
https://kawalpemilu.org#25966,"DURI KEPA, KEBON JERUK, JAKARTA BARAT, DKI JAKARTA",74,178,41,219
https://kawalpemilu.org#25966,"DURI KEPA, KEBON JERUK, JAKARTA BARAT, DKI JAKARTA",75,161,47,208
https://kawalpemilu.org#25966,"DURI KEPA, KEBON JERUK, JAKARTA BARAT, DKI JAKARTA",76,195,68,263
https://kawalpemilu.org#25966,"DURI KEPA, KEBON JERUK, JAKARTA BARAT, DKI JAKARTA",77,149,57,206
https://kawalpemilu.org#25966,"DURI KEPA, KEBON JERUK, JAKARTA BARAT, DKI JAKARTA",78,175,39,214
https://kawalpemilu.org#25966,"DURI KEPA, KEBON JERUK, JAKARTA BARAT, DKI JAKARTA",79,104,79,183
https://kawalpemilu.org#25966,"DURI KEPA, KEBON JERUK, JAKARTA BARAT, DKI JAKARTA",80,116,82,198
https://kawalpemilu.org#25966,"DURI KEPA, KEBON JERUK, JAKARTA BARAT, DKI JAKARTA",81,70,63,135
https://kawalpemilu.org#25966,"DURI KEPA, KEBON JERUK, JAKARTA BARAT, DKI JAKARTA",82,95,51,146
https://kawalpemilu.org#25966,"DURI KEPA, KEBON JERUK, JAKARTA BARAT, DKI JAKARTA",83,127,53,180
https://kawalpemilu.org#25966,"DURI KEPA, KEBON JERUK, JAKARTA BARAT, DKI JAKARTA",84,120,60,180
https://kawalpemilu.org#25966,"DURI KEPA, KEBON JERUK, JAKARTA BARAT, DKI JAKARTA",85,97,84,181
https://kawalpemilu.org#25966,"DURI KEPA, KEBON JERUK, JAKARTA BARAT, DKI JAKARTA",86,147,83,230
https://kawalpemilu.org#25966,"DURI KEPA, KEBON JERUK, JAKARTA BARAT, DKI JAKARTA",87,104,135,239
https://kawalpemilu.org#25966,"DURI KEPA, KEBON JERUK, JAKARTA BARAT, DKI JAKARTA",88,154,92,246
https://kawalpemilu.org#25966,"DURI KEPA, KEBON JERUK, JAKARTA BARAT, DKI JAKARTA",89,181,8,189
https://kawalpemilu.org#25966,"DURI KEPA, KEBON JERUK, JAKARTA BARAT, DKI JAKARTA",90,230,8,238
https://kawalpemilu.org#25966,"DURI KEPA, KEBON JERUK, JAKARTA BARAT, DKI JAKARTA",91,210,22,232
https://kawalpemilu.org#25966,"DURI KEPA, KEBON JERUK, JAKARTA BARAT, DKI JAKARTA",92,244,16,260
https://kawalpemilu.org#25966,"DURI KEPA, KEBON JERUK, JAKARTA BARAT, DKI JAKARTA",93,142,110,252
https://kawalpemilu.org#25966,"DURI KEPA, KEBON JERUK, JAKARTA BARAT, DKI JAKARTA",94,61,80,141
https://kawalpemilu.org#25966,"DURI KEPA, KEBON JERUK, JAKARTA BARAT, DKI JAKARTA",95,133,74,207
https://kawalpemilu.org#25966,"DURI KEPA, KEBON JERUK, JAKARTA BARAT, DKI JAKARTA",96,158,76,234
https://kawalpemilu.org#25966,"DURI KEPA, KEBON JERUK, JAKARTA BARAT, DKI JAKARTA",97,146,124,270
https://kawalpemilu.org#25966,"DURI KEPA, KEBON JERUK, JAKARTA BARAT, DKI JAKARTA",98,134,70,204
https://kawalpemilu.org#25966,"DURI KEPA, KEBON JERUK, JAKARTA BARAT, DKI JAKARTA",99,126,86,212
https://kawalpemilu.org#25966,"DURI KEPA, KEBON JERUK, JAKARTA BARAT, DKI JAKARTA",100,200,37,237
https://kawalpemilu.org#25966,"DURI KEPA, KEBON JERUK, JAKARTA BARAT, DKI JAKARTA",101,191,39,230
https://kawalpemilu.org#25966,"DURI KEPA, KEBON JERUK, JAKARTA BARAT, DKI JAKARTA",102,147,48,195
https://kawalpemilu.org#25966,"DURI KEPA, KEBON JERUK, JAKARTA BARAT, DKI JAKARTA",103,199,35,234
https://kawalpemilu.org#25966,"DURI KEPA, KEBON JERUK, JAKARTA BARAT, DKI JAKARTA",104,185,70,255
https://kawalpemilu.org#25966,"DURI KEPA, KEBON JERUK, JAKARTA BARAT, DKI JAKARTA",105,206,22,228
https://kawalpemilu.org#25966,"DURI KEPA, KEBON JERUK, JAKARTA BARAT, DKI JAKARTA",106,177,50,227
https://kawalpemilu.org#25966,"DURI KEPA, KEBON JERUK, JAKARTA BARAT, DKI JAKARTA",107,199,31,230
https://kawalpemilu.org#25966,"DURI KEPA, KEBON JERUK, JAKARTA BARAT, DKI JAKARTA",108,136,135,271
https://kawalpemilu.org#25966,"DURI KEPA, KEBON JERUK, JAKARTA BARAT, DKI JAKARTA",109,114,111,225
https://kawalpemilu.org#25966,"DURI KEPA, KEBON JERUK, JAKARTA BARAT, DKI JAKARTA",110,138,95,233
https://kawalpemilu.org#25966,"DURI KEPA, KEBON JERUK, JAKARTA BARAT, DKI JAKARTA",111,231,21,252
https://kawalpemilu.org#25966,"DURI KEPA, KEBON JERUK, JAKARTA BARAT, DKI JAKARTA",112,183,89,272
https://kawalpemilu.org#25966,"DURI KEPA, KEBON JERUK, JAKARTA BARAT, DKI JAKARTA",113,215,61,276
https://kawalpemilu.org#25966,"DURI KEPA, KEBON JERUK, JAKARTA BARAT, DKI JAKARTA",114,197,49,246
https://kawalpemilu.org#25966,"DURI KEPA, KEBON JERUK, JAKARTA BARAT, DKI JAKARTA",115,93,56,149
https://kawalpemilu.org#25966,"DURI KEPA, KEBON JERUK, JAKARTA BARAT, DKI JAKARTA",116,98,51,149
https://kawalpemilu.org#25966,"DURI KEPA, KEBON JERUK, JAKARTA BARAT, DKI JAKARTA",118,120,120,240
https://kawalpemilu.org#25966,"DURI KEPA, KEBON JERUK, JAKARTA BARAT, DKI JAKARTA",119,116,168,284
https://kawalpemilu.org#25966,"DURI KEPA, KEBON JERUK, JAKARTA BARAT, DKI JAKARTA",120,139,72,211
https://kawalpemilu.org#25966,"DURI KEPA, KEBON JERUK, JAKARTA BARAT, DKI JAKARTA",121,132,89,221
https://kawalpemilu.org#25966,"DURI KEPA, KEBON JERUK, JAKARTA BARAT, DKI JAKARTA",122,133,87,220
https://kawalpemilu.org#25966,"DURI KEPA, KEBON JERUK, JAKARTA BARAT, DKI JAKARTA",123,130,102,232
https://kawalpemilu.org#25966,"DURI KEPA, KEBON JERUK, JAKARTA BARAT, DKI JAKARTA",124,111,145,256
https://kawalpemilu.org#25966,"DURI KEPA, KEBON JERUK, JAKARTA BARAT, DKI JAKARTA",125,85,138,223
https://kawalpemilu.org#25966,"DURI KEPA, KEBON JERUK, JAKARTA BARAT, DKI JAKARTA",126,118,97,215
https://kawalpemilu.org#25966,"DURI KEPA, KEBON JERUK, JAKARTA BARAT, DKI JAKARTA",127,115,90,205
https://kawalpemilu.org#25966,"DURI KEPA, KEBON JERUK, JAKARTA BARAT, DKI JAKARTA",128,94,99,193
https://kawalpemilu.org#25966,"DURI KEPA, KEBON JERUK, JAKARTA BARAT, DKI JAKARTA",129,86,109,195
https://kawalpemilu.org#25966,"DURI KEPA, KEBON JERUK, JAKARTA BARAT, DKI JAKARTA",130,87,119,206
https://kawalpemilu.org#25966,"DURI KEPA, KEBON JERUK, JAKARTA BARAT, DKI JAKARTA",131,78,115,193
https://kawalpemilu.org#25966,"DURI KEPA, KEBON JERUK, JAKARTA BARAT, DKI JAKARTA",132,110,98,208
https://kawalpemilu.org#25966,"DURI KEPA, KEBON JERUK, JAKARTA BARAT, DKI JAKARTA",133,74,99,173
https://kawalpemilu.org#25966,"DURI KEPA, KEBON JERUK, JAKARTA BARAT, DKI JAKARTA",134,78,113,191
https://kawalpemilu.org#25966,"DURI KEPA, KEBON JERUK, JAKARTA BARAT, DKI JAKARTA",135,76,98,174
https://kawalpemilu.org#25966,"DURI KEPA, KEBON JERUK, JAKARTA BARAT, DKI JAKARTA",136,142,42,184
https://kawalpemilu.org#25966,"DURI KEPA, KEBON JERUK, JAKARTA BARAT, DKI JAKARTA",137,162,42,204
https://kawalpemilu.org#25966,"DURI KEPA, KEBON JERUK, JAKARTA BARAT, DKI JAKARTA",138,115,54,169
https://kawalpemilu.org#25966,"DURI KEPA, KEBON JERUK, JAKARTA BARAT, DKI JAKARTA",139,154,169,223
https://kawalpemilu.org#25966,"DURI KEPA, KEBON JERUK, JAKARTA BARAT, DKI JAKARTA",140,170,68,238
https://kawalpemilu.org#25966,"DURI KEPA, KEBON JERUK, JAKARTA BARAT, DKI JAKARTA",141,194,23,217
https://kawalpemilu.org#25966,"DURI KEPA, KEBON JERUK, JAKARTA BARAT, DKI JAKARTA",142,196,12,208
https://kawalpemilu.org#25966,"DURI KEPA, KEBON JERUK, JAKARTA BARAT, DKI JAKARTA",143,203,11,214
https://kawalpemilu.org#25966,"DURI KEPA, KEBON JERUK, JAKARTA BARAT, DKI JAKARTA",144,223,9,232
https://kawalpemilu.org#25966,"DURI KEPA, KEBON JERUK, JAKARTA BARAT, DKI JAKARTA",145,171,3,174
https://kawalpemilu.org#25966,"DURI KEPA, KEBON JERUK, JAKARTA BARAT, DKI JAKARTA",146,144,0,144
https://kawalpemilu.org#25966,"DURI KEPA, KEBON JERUK, JAKARTA BARAT, DKI JAKARTA",147,169,1,170
https://kawalpemilu.org#25966,"DURI KEPA, KEBON JERUK, JAKARTA BARAT, DKI JAKARTA",148,152,56,208
https://kawalpemilu.org#25966,"DURI KEPA, KEBON JERUK, JAKARTA BARAT, DKI JAKARTA",149,151,44,195
https://kawalpemilu.org#25966,"DURI KEPA, KEBON JERUK, JAKARTA BARAT, DKI JAKARTA",150,151,29,180
https://kawalpemilu.org#25966,"DURI KEPA, KEBON JERUK, JAKARTA BARAT, DKI JAKARTA",151,213,10,223
https://kawalpemilu.org#25966,"DURI KEPA, KEBON JERUK, JAKARTA BARAT, DKI JAKARTA",152,201,20,221
https://kawalpemilu.org#25966,"DURI KEPA, KEBON JERUK, JAKARTA BARAT, DKI JAKARTA",153,114,118,232
https://kawalpemilu.org#25966,"DURI KEPA, KEBON JERUK, JAKARTA BARAT, DKI JAKARTA",154,132,75,207
https://kawalpemilu.org#25966,"DURI KEPA, KEBON JERUK, JAKARTA BARAT, DKI JAKARTA",155,126,76,202
https://kawalpemilu.org#25966,"DURI KEPA, KEBON JERUK, JAKARTA BARAT, DKI JAKARTA",156,149,73,222
https://kawalpemilu.org#25966,"DURI KEPA, KEBON JERUK, JAKARTA BARAT, DKI JAKARTA",157,182,68,250
https://kawalpemilu.org#25966,"DURI KEPA, KEBON JERUK, JAKARTA BARAT, DKI JAKARTA",158,168,82,250
https://kawalpemilu.org#25966,"DURI KEPA, KEBON JERUK, JAKARTA BARAT, DKI JAKARTA",159,187,58,245
https://kawalpemilu.org#25966,"DURI KEPA, KEBON JERUK, JAKARTA BARAT, DKI JAKARTA",160,129,79,208
https://kawalpemilu.org#25966,"DURI KEPA, KEBON JERUK, JAKARTA BARAT, DKI JAKARTA",161,147,122,269
https://kawalpemilu.org#25966,"DURI KEPA, KEBON JERUK, JAKARTA BARAT, DKI JAKARTA",162,141,114,255
https://kawalpemilu.org#25966,"DURI KEPA, KEBON JERUK, JAKARTA BARAT, DKI JAKARTA",163,214,5,219
https://kawalpemilu.org#25966,"DURI KEPA, KEBON JERUK, JAKARTA BARAT, DKI JAKARTA",164,207,11,218
https://kawalpemilu.org#25966,"DURI KEPA, KEBON JERUK, JAKARTA BARAT, DKI JAKARTA",165,176,42,218
https://kawalpemilu.org#25966,"DURI KEPA, KEBON JERUK, JAKARTA BARAT, DKI JAKARTA",166,157,27,182
https://kawalpemilu.org#25966,"DURI KEPA, KEBON JERUK, JAKARTA BARAT, DKI JAKARTA",167,128,106,234
https://kawalpemilu.org#25966,"DURI KEPA, KEBON JERUK, JAKARTA BARAT, DKI JAKARTA",168,122,93,215
https://kawalpemilu.org#25966,"DURI KEPA, KEBON JERUK, JAKARTA BARAT, DKI JAKARTA",169,147,92,239
https://kawalpemilu.org#25966,"DURI KEPA, KEBON JERUK, JAKARTA BARAT, DKI JAKARTA",170,127,85,212
https://kawalpemilu.org#25966,"DURI KEPA, KEBON JERUK, JAKARTA BARAT, DKI JAKARTA",171,248,19,264
https://kawalpemilu.org#25966,"DURI KEPA, KEBON JERUK, JAKARTA BARAT, DKI JAKARTA",172,199,35,234
https://kawalpemilu.org#25966,"DURI KEPA, KEBON JERUK, JAKARTA BARAT, DKI JAKARTA",173,176,26,202
https://kawalpemilu.org#25966,"DURI KEPA, KEBON JERUK, JAKARTA BARAT, DKI JAKARTA",174,209,4,213
https://kawalpemilu.org#25966,"DURI KEPA, KEBON JERUK, JAKARTA BARAT, DKI JAKARTA",175,243,3,246
https://kawalpemilu.org#25966,"DURI KEPA, KEBON JERUK, JAKARTA BARAT, DKI JAKARTA",176,254,1,255
https://kawalpemilu.org#25966,"DURI KEPA, KEBON JERUK, JAKARTA BARAT, DKI JAKARTA",177,222,6,228
https://kawalpemilu.org#25966,"DURI KEPA, KEBON JERUK, JAKARTA BARAT, DKI JAKARTA",178,216,3,219
https://kawalpemilu.org#25966,"DURI KEPA, KEBON JERUK, JAKARTA BARAT, DKI JAKARTA",179,237,5,242
https://kawalpemilu.org#25966,"DURI KEPA, KEBON JERUK, JAKARTA BARAT, DKI JAKARTA",180,232,1,233
https://kawalpemilu.org#25966,"DURI KEPA, KEBON JERUK, JAKARTA BARAT, DKI JAKARTA",181,227,3,230
https://kawalpemilu.org#25966,"DURI KEPA, KEBON JERUK, JAKARTA BARAT, DKI JAKARTA",182,231,2,233
https://kawalpemilu.org#25966,"DURI KEPA, KEBON JERUK, JAKARTA BARAT, DKI JAKARTA",183,229,10,239
https://kawalpemilu.org#25966,"DURI KEPA, KEBON JERUK, JAKARTA BARAT, DKI JAKARTA",184,202,35,237
https://kawalpemilu.org#25966,"DURI KEPA, KEBON JERUK, JAKARTA BARAT, DKI JAKARTA",185,223,3,226
https://kawalpemilu.org#25966,"DURI KEPA, KEBON JERUK, JAKARTA BARAT, DKI JAKARTA",186,224,13,237
https://kawalpemilu.org#25966,"DURI KEPA, KEBON JERUK, JAKARTA BARAT, DKI JAKARTA",187,205,2,207
https://kawalpemilu.org#25966,"DURI KEPA, KEBON JERUK, JAKARTA BARAT, DKI JAKARTA",188,235,2,237
https://kawalpemilu.org#25966,"DURI KEPA, KEBON JERUK, JAKARTA BARAT, DKI JAKARTA",189,235,12,247
https://kawalpemilu.org#25966,"DURI KEPA, KEBON JERUK, JAKARTA BARAT, DKI JAKARTA",190,222,9,231
https://kawalpemilu.org#25966,"DURI KEPA, KEBON JERUK, JAKARTA BARAT, DKI JAKARTA",191,189,4,193
https://kawalpemilu.org#25966,"DURI KEPA, KEBON JERUK, JAKARTA BARAT, DKI JAKARTA",192,214,3,217
https://kawalpemilu.org#25966,"DURI KEPA, KEBON JERUK, JAKARTA BARAT, DKI JAKARTA",193,211,1,212
https://kawalpemilu.org#25966,"DURI KEPA, KEBON JERUK, JAKARTA BARAT, DKI JAKARTA",194,225,1,226
https://kawalpemilu.org#25966,"DURI KEPA, KEBON JERUK, JAKARTA BARAT, DKI JAKARTA",195,206,9,215
https://kawalpemilu.org#25967,"KEDOYA UTARA, KEBON JERUK, JAKARTA BARAT, DKI JAKARTA",1,169,89,258
https://kawalpemilu.org#25967,"KEDOYA UTARA, KEBON JERUK, JAKARTA BARAT, DKI JAKARTA",2,166,89,255
https://kawalpemilu.org#25967,"KEDOYA UTARA, KEBON JERUK, JAKARTA BARAT, DKI JAKARTA",3,174,100,274
https://kawalpemilu.org#25967,"KEDOYA UTARA, KEBON JERUK, JAKARTA BARAT, DKI JAKARTA",4,154,86,240
https://kawalpemilu.org#25967,"KEDOYA UTARA, KEBON JERUK, JAKARTA BARAT, DKI JAKARTA",5,110,101,211
https://kawalpemilu.org#25967,"KEDOYA UTARA, KEBON JERUK, JAKARTA BARAT, DKI JAKARTA",6,112,135,247
https://kawalpemilu.org#25967,"KEDOYA UTARA, KEBON JERUK, JAKARTA BARAT, DKI JAKARTA",7,106,121,227
https://kawalpemilu.org#25967,"KEDOYA UTARA, KEBON JERUK, JAKARTA BARAT, DKI JAKARTA",8,130,81,211
https://kawalpemilu.org#25967,"KEDOYA UTARA, KEBON JERUK, JAKARTA BARAT, DKI JAKARTA",9,104,98,202
https://kawalpemilu.org#25967,"KEDOYA UTARA, KEBON JERUK, JAKARTA BARAT, DKI JAKARTA",10,99,158,257
https://kawalpemilu.org#25967,"KEDOYA UTARA, KEBON JERUK, JAKARTA BARAT, DKI JAKARTA",11,99,133,232
https://kawalpemilu.org#25967,"KEDOYA UTARA, KEBON JERUK, JAKARTA BARAT, DKI JAKARTA",12,101,123,224
https://kawalpemilu.org#25967,"KEDOYA UTARA, KEBON JERUK, JAKARTA BARAT, DKI JAKARTA",13,93,78,171
https://kawalpemilu.org#25967,"KEDOYA UTARA, KEBON JERUK, JAKARTA BARAT, DKI JAKARTA",14,143,27,170
https://kawalpemilu.org#25967,"KEDOYA UTARA, KEBON JERUK, JAKARTA BARAT, DKI JAKARTA",15,98,157,255
https://kawalpemilu.org#25967,"KEDOYA UTARA, KEBON JERUK, JAKARTA BARAT, DKI JAKARTA",16,106,97,203
https://kawalpemilu.org#25967,"KEDOYA UTARA, KEBON JERUK, JAKARTA BARAT, DKI JAKARTA",17,169,62,231
https://kawalpemilu.org#25967,"KEDOYA UTARA, KEBON JERUK, JAKARTA BARAT, DKI JAKARTA",18,106,110,216
https://kawalpemilu.org#25967,"KEDOYA UTARA, KEBON JERUK, JAKARTA BARAT, DKI JAKARTA",19,145,85,230
https://kawalpemilu.org#25967,"KEDOYA UTARA, KEBON JERUK, JAKARTA BARAT, DKI JAKARTA",20,138,93,231
https://kawalpemilu.org#25967,"KEDOYA UTARA, KEBON JERUK, JAKARTA BARAT, DKI JAKARTA",21,115,138,253
https://kawalpemilu.org#25967,"KEDOYA UTARA, KEBON JERUK, JAKARTA BARAT, DKI JAKARTA",22,150,128,278
https://kawalpemilu.org#25967,"KEDOYA UTARA, KEBON JERUK, JAKARTA BARAT, DKI JAKARTA",23,142,109,251
https://kawalpemilu.org#25967,"KEDOYA UTARA, KEBON JERUK, JAKARTA BARAT, DKI JAKARTA",24,117,143,260
https://kawalpemilu.org#25967,"KEDOYA UTARA, KEBON JERUK, JAKARTA BARAT, DKI JAKARTA",25,135,105,240
https://kawalpemilu.org#25967,"KEDOYA UTARA, KEBON JERUK, JAKARTA BARAT, DKI JAKARTA",26,142,123,265
https://kawalpemilu.org#25967,"KEDOYA UTARA, KEBON JERUK, JAKARTA BARAT, DKI JAKARTA",27,124,127,251
https://kawalpemilu.org#25967,"KEDOYA UTARA, KEBON JERUK, JAKARTA BARAT, DKI JAKARTA",28,125,139,264
https://kawalpemilu.org#25967,"KEDOYA UTARA, KEBON JERUK, JAKARTA BARAT, DKI JAKARTA",29,111,148,259
https://kawalpemilu.org#25967,"KEDOYA UTARA, KEBON JERUK, JAKARTA BARAT, DKI JAKARTA",30,145,132,277
https://kawalpemilu.org#25967,"KEDOYA UTARA, KEBON JERUK, JAKARTA BARAT, DKI JAKARTA",31,147,62,209
https://kawalpemilu.org#25967,"KEDOYA UTARA, KEBON JERUK, JAKARTA BARAT, DKI JAKARTA",32,145,53,198
https://kawalpemilu.org#25967,"KEDOYA UTARA, KEBON JERUK, JAKARTA BARAT, DKI JAKARTA",33,159,74,233
https://kawalpemilu.org#25967,"KEDOYA UTARA, KEBON JERUK, JAKARTA BARAT, DKI JAKARTA",34,222,1,223
https://kawalpemilu.org#25967,"KEDOYA UTARA, KEBON JERUK, JAKARTA BARAT, DKI JAKARTA",35,201,8,209
https://kawalpemilu.org#25967,"KEDOYA UTARA, KEBON JERUK, JAKARTA BARAT, DKI JAKARTA",36,197,4,201
https://kawalpemilu.org#25967,"KEDOYA UTARA, KEBON JERUK, JAKARTA BARAT, DKI JAKARTA",37,225,9,234
https://kawalpemilu.org#25967,"KEDOYA UTARA, KEBON JERUK, JAKARTA BARAT, DKI JAKARTA",38,223,1,224
https://kawalpemilu.org#25967,"KEDOYA UTARA, KEBON JERUK, JAKARTA BARAT, DKI JAKARTA",39,220,5,225
https://kawalpemilu.org#25967,"KEDOYA UTARA, KEBON JERUK, JAKARTA BARAT, DKI JAKARTA",40,204,5,209
https://kawalpemilu.org#25967,"KEDOYA UTARA, KEBON JERUK, JAKARTA BARAT, DKI JAKARTA",41,148,3,151
https://kawalpemilu.org#25967,"KEDOYA UTARA, KEBON JERUK, JAKARTA BARAT, DKI JAKARTA",42,165,2,167
https://kawalpemilu.org#25967,"KEDOYA UTARA, KEBON JERUK, JAKARTA BARAT, DKI JAKARTA",43,157,19,176
https://kawalpemilu.org#25967,"KEDOYA UTARA, KEBON JERUK, JAKARTA BARAT, DKI JAKARTA",44,175,29,204
https://kawalpemilu.org#25967,"KEDOYA UTARA, KEBON JERUK, JAKARTA BARAT, DKI JAKARTA",45,159,83,242
https://kawalpemilu.org#25967,"KEDOYA UTARA, KEBON JERUK, JAKARTA BARAT, DKI JAKARTA",46,131,107,232
https://kawalpemilu.org#25967,"KEDOYA UTARA, KEBON JERUK, JAKARTA BARAT, DKI JAKARTA",47,146,98,244
https://kawalpemilu.org#25967,"KEDOYA UTARA, KEBON JERUK, JAKARTA BARAT, DKI JAKARTA",48,103,124,227
https://kawalpemilu.org#25967,"KEDOYA UTARA, KEBON JERUK, JAKARTA BARAT, DKI JAKARTA",49,97,119,216
https://kawalpemilu.org#25967,"KEDOYA UTARA, KEBON JERUK, JAKARTA BARAT, DKI JAKARTA",50,95,134,229
https://kawalpemilu.org#25967,"KEDOYA UTARA, KEBON JERUK, JAKARTA BARAT, DKI JAKARTA",51,128,111,239
https://kawalpemilu.org#25967,"KEDOYA UTARA, KEBON JERUK, JAKARTA BARAT, DKI JAKARTA",52,96,137,233
https://kawalpemilu.org#25967,"KEDOYA UTARA, KEBON JERUK, JAKARTA BARAT, DKI JAKARTA",53,244,3,247
https://kawalpemilu.org#25967,"KEDOYA UTARA, KEBON JERUK, JAKARTA BARAT, DKI JAKARTA",54,205,74,279
https://kawalpemilu.org#25967,"KEDOYA UTARA, KEBON JERUK, JAKARTA BARAT, DKI JAKARTA",55,213,8,221
https://kawalpemilu.org#25967,"KEDOYA UTARA, KEBON JERUK, JAKARTA BARAT, DKI JAKARTA",56,199,7,206
https://kawalpemilu.org#25967,"KEDOYA UTARA, KEBON JERUK, JAKARTA BARAT, DKI JAKARTA",57,160,4,164
https://kawalpemilu.org#25967,"KEDOYA UTARA, KEBON JERUK, JAKARTA BARAT, DKI JAKARTA",58,207,5,212
https://kawalpemilu.org#25967,"KEDOYA UTARA, KEBON JERUK, JAKARTA BARAT, DKI JAKARTA",59,230,6,236
https://kawalpemilu.org#25967,"KEDOYA UTARA, KEBON JERUK, JAKARTA BARAT, DKI JAKARTA",60,209,8,217
https://kawalpemilu.org#25967,"KEDOYA UTARA, KEBON JERUK, JAKARTA BARAT, DKI JAKARTA",61,238,3,241
https://kawalpemilu.org#25967,"KEDOYA UTARA, KEBON JERUK, JAKARTA BARAT, DKI JAKARTA",62,182,41,223
https://kawalpemilu.org#25967,"KEDOYA UTARA, KEBON JERUK, JAKARTA BARAT, DKI JAKARTA",63,98,66,164
https://kawalpemilu.org#25967,"KEDOYA UTARA, KEBON JERUK, JAKARTA BARAT, DKI JAKARTA",64,146,42,188
https://kawalpemilu.org#25967,"KEDOYA UTARA, KEBON JERUK, JAKARTA BARAT, DKI JAKARTA",65,174,2,176
https://kawalpemilu.org#25967,"KEDOYA UTARA, KEBON JERUK, JAKARTA BARAT, DKI JAKARTA",66,88,148,236
https://kawalpemilu.org#25967,"KEDOYA UTARA, KEBON JERUK, JAKARTA BARAT, DKI JAKARTA",67,113,109,222
https://kawalpemilu.org#25967,"KEDOYA UTARA, KEBON JERUK, JAKARTA BARAT, DKI JAKARTA",68,112,121,233
https://kawalpemilu.org#25967,"KEDOYA UTARA, KEBON JERUK, JAKARTA BARAT, DKI JAKARTA",69,100,139,239
https://kawalpemilu.org#25967,"KEDOYA UTARA, KEBON JERUK, JAKARTA BARAT, DKI JAKARTA",70,119,125,244
https://kawalpemilu.org#25967,"KEDOYA UTARA, KEBON JERUK, JAKARTA BARAT, DKI JAKARTA",71,117,142,259
https://kawalpemilu.org#25967,"KEDOYA UTARA, KEBON JERUK, JAKARTA BARAT, DKI JAKARTA",72,110,128,240
https://kawalpemilu.org#25967,"KEDOYA UTARA, KEBON JERUK, JAKARTA BARAT, DKI JAKARTA",73,146,89,235
https://kawalpemilu.org#25967,"KEDOYA UTARA, KEBON JERUK, JAKARTA BARAT, DKI JAKARTA",74,89,124,213
https://kawalpemilu.org#25967,"KEDOYA UTARA, KEBON JERUK, JAKARTA BARAT, DKI JAKARTA",75,140,120,260
https://kawalpemilu.org#25967,"KEDOYA UTARA, KEBON JERUK, JAKARTA BARAT, DKI JAKARTA",76,123,111,234
https://kawalpemilu.org#25967,"KEDOYA UTARA, KEBON JERUK, JAKARTA BARAT, DKI JAKARTA",77,125,143,268
https://kawalpemilu.org#25967,"KEDOYA UTARA, KEBON JERUK, JAKARTA BARAT, DKI JAKARTA",78,130,117,247
https://kawalpemilu.org#25967,"KEDOYA UTARA, KEBON JERUK, JAKARTA BARAT, DKI JAKARTA",79,144,129,273
https://kawalpemilu.org#25967,"KEDOYA UTARA, KEBON JERUK, JAKARTA BARAT, DKI JAKARTA",80,107,168,275
https://kawalpemilu.org#25967,"KEDOYA UTARA, KEBON JERUK, JAKARTA BARAT, DKI JAKARTA",81,89,148,237
https://kawalpemilu.org#25967,"KEDOYA UTARA, KEBON JERUK, JAKARTA BARAT, DKI JAKARTA",82,55,116,171
https://kawalpemilu.org#25967,"KEDOYA UTARA, KEBON JERUK, JAKARTA BARAT, DKI JAKARTA",83,114,151,265
https://kawalpemilu.org#25967,"KEDOYA UTARA, KEBON JERUK, JAKARTA BARAT, DKI JAKARTA",84,111,131,242
https://kawalpemilu.org#25967,"KEDOYA UTARA, KEBON JERUK, JAKARTA BARAT, DKI JAKARTA",85,171,51,222
https://kawalpemilu.org#25967,"KEDOYA UTARA, KEBON JERUK, JAKARTA BARAT, DKI JAKARTA",86,155,71,226
https://kawalpemilu.org#25967,"KEDOYA UTARA, KEBON JERUK, JAKARTA BARAT, DKI JAKARTA",87,154,96,250
https://kawalpemilu.org#25967,"KEDOYA UTARA, KEBON JERUK, JAKARTA BARAT, DKI JAKARTA",88,135,119,254
https://kawalpemilu.org#25967,"KEDOYA UTARA, KEBON JERUK, JAKARTA BARAT, DKI JAKARTA",89,7,100,193
https://kawalpemilu.org#25967,"KEDOYA UTARA, KEBON JERUK, JAKARTA BARAT, DKI JAKARTA",90,249,8,257
https://kawalpemilu.org#25967,"KEDOYA UTARA, KEBON JERUK, JAKARTA BARAT, DKI JAKARTA",91,162,108,270
https://kawalpemilu.org#25967,"KEDOYA UTARA, KEBON JERUK, JAKARTA BARAT, DKI JAKARTA",92,184,65,249
https://kawalpemilu.org#25967,"KEDOYA UTARA, KEBON JERUK, JAKARTA BARAT, DKI JAKARTA",93,132,81,213
https://kawalpemilu.org#25967,"KEDOYA UTARA, KEBON JERUK, JAKARTA BARAT, DKI JAKARTA",94,106,163,269
https://kawalpemilu.org#25967,"KEDOYA UTARA, KEBON JERUK, JAKARTA BARAT, DKI JAKARTA",95,138,117,255
https://kawalpemilu.org#25967,"KEDOYA UTARA, KEBON JERUK, JAKARTA BARAT, DKI JAKARTA",96,137,144,281
https://kawalpemilu.org#25967,"KEDOYA UTARA, KEBON JERUK, JAKARTA BARAT, DKI JAKARTA",97,110,147,257
https://kawalpemilu.org#25967,"KEDOYA UTARA, KEBON JERUK, JAKARTA BARAT, DKI JAKARTA",98,221,1,222
https://kawalpemilu.org#25967,"KEDOYA UTARA, KEBON JERUK, JAKARTA BARAT, DKI JAKARTA",99,236,1,237
https://kawalpemilu.org#25967,"KEDOYA UTARA, KEBON JERUK, JAKARTA BARAT, DKI JAKARTA",100,147,70,217
https://kawalpemilu.org#25967,"KEDOYA UTARA, KEBON JERUK, JAKARTA BARAT, DKI JAKARTA",101,163,61,224
https://kawalpemilu.org#25967,"KEDOYA UTARA, KEBON JERUK, JAKARTA BARAT, DKI JAKARTA",102,167,69,236
https://kawalpemilu.org#25967,"KEDOYA UTARA, KEBON JERUK, JAKARTA BARAT, DKI JAKARTA",103,153,87,240
https://kawalpemilu.org#25967,"KEDOYA UTARA, KEBON JERUK, JAKARTA BARAT, DKI JAKARTA",104,155,103,258
https://kawalpemilu.org#25967,"KEDOYA UTARA, KEBON JERUK, JAKARTA BARAT, DKI JAKARTA",105,88,111,199
https://kawalpemilu.org#25967,"KEDOYA UTARA, KEBON JERUK, JAKARTA BARAT, DKI JAKARTA",106,102,95,197
https://kawalpemilu.org#25967,"KEDOYA UTARA, KEBON JERUK, JAKARTA BARAT, DKI JAKARTA",107,90,116,206
https://kawalpemilu.org#25967,"KEDOYA UTARA, KEBON JERUK, JAKARTA BARAT, DKI JAKARTA",108,111,95,206
https://kawalpemilu.org#25967,"KEDOYA UTARA, KEBON JERUK, JAKARTA BARAT, DKI JAKARTA",109,116,118,234
https://kawalpemilu.org#25967,"KEDOYA UTARA, KEBON JERUK, JAKARTA BARAT, DKI JAKARTA",110,129,136,265
https://kawalpemilu.org#25967,"KEDOYA UTARA, KEBON JERUK, JAKARTA BARAT, DKI JAKARTA",111,108,117,225
https://kawalpemilu.org#25967,"KEDOYA UTARA, KEBON JERUK, JAKARTA BARAT, DKI JAKARTA",112,72,147,219
https://kawalpemilu.org#25967,"KEDOYA UTARA, KEBON JERUK, JAKARTA BARAT, DKI JAKARTA",113,62,97,159
https://kawalpemilu.org#25967,"KEDOYA UTARA, KEBON JERUK, JAKARTA BARAT, DKI JAKARTA",114,77,128,205
https://kawalpemilu.org#25967,"KEDOYA UTARA, KEBON JERUK, JAKARTA BARAT, DKI JAKARTA",115,128,96,224
https://kawalpemilu.org#25967,"KEDOYA UTARA, KEBON JERUK, JAKARTA BARAT, DKI JAKARTA",116,111,123,234
https://kawalpemilu.org#25967,"KEDOYA UTARA, KEBON JERUK, JAKARTA BARAT, DKI JAKARTA",117,115,140,255
https://kawalpemilu.org#25967,"KEDOYA UTARA, KEBON JERUK, JAKARTA BARAT, DKI JAKARTA",118,88,163,251
https://kawalpemilu.org#25967,"KEDOYA UTARA, KEBON JERUK, JAKARTA BARAT, DKI JAKARTA",119,129,81,210
https://kawalpemilu.org#25967,"KEDOYA UTARA, KEBON JERUK, JAKARTA BARAT, DKI JAKARTA",120,126,106,232
https://kawalpemilu.org#25967,"KEDOYA UTARA, KEBON JERUK, JAKARTA BARAT, DKI JAKARTA",121,104,128,232
https://kawalpemilu.org#25967,"KEDOYA UTARA, KEBON JERUK, JAKARTA BARAT, DKI JAKARTA",122,126,147,273
https://kawalpemilu.org#25967,"KEDOYA UTARA, KEBON JERUK, JAKARTA BARAT, DKI JAKARTA",123,132,80,212
https://kawalpemilu.org#25967,"KEDOYA UTARA, KEBON JERUK, JAKARTA BARAT, DKI JAKARTA",124,90,64,154
https://kawalpemilu.org#25967,"KEDOYA UTARA, KEBON JERUK, JAKARTA BARAT, DKI JAKARTA",125,109,80,189
https://kawalpemilu.org#25967,"KEDOYA UTARA, KEBON JERUK, JAKARTA BARAT, DKI JAKARTA",126,147,26,173
https://kawalpemilu.org#25967,"KEDOYA UTARA, KEBON JERUK, JAKARTA BARAT, DKI JAKARTA",127,207,6,213
https://kawalpemilu.org#25967,"KEDOYA UTARA, KEBON JERUK, JAKARTA BARAT, DKI JAKARTA",128,170,11,181
https://kawalpemilu.org#25967,"KEDOYA UTARA, KEBON JERUK, JAKARTA BARAT, DKI JAKARTA",129,181,3,184
https://kawalpemilu.org#25967,"KEDOYA UTARA, KEBON JERUK, JAKARTA BARAT, DKI JAKARTA",130,185,2,187
https://kawalpemilu.org#25967,"KEDOYA UTARA, KEBON JERUK, JAKARTA BARAT, DKI JAKARTA",131,178,3,181
https://kawalpemilu.org#25967,"KEDOYA UTARA, KEBON JERUK, JAKARTA BARAT, DKI JAKARTA",132,202,1,203
https://kawalpemilu.org#25967,"KEDOYA UTARA, KEBON JERUK, JAKARTA BARAT, DKI JAKARTA",133,211,3,214
https://kawalpemilu.org#25967,"KEDOYA UTARA, KEBON JERUK, JAKARTA BARAT, DKI JAKARTA",134,179,6,185
https://kawalpemilu.org#25967,"KEDOYA UTARA, KEBON JERUK, JAKARTA BARAT, DKI JAKARTA",135,206,0,206
https://kawalpemilu.org#25967,"KEDOYA UTARA, KEBON JERUK, JAKARTA BARAT, DKI JAKARTA",136,205,4,209
https://kawalpemilu.org#25967,"KEDOYA UTARA, KEBON JERUK, JAKARTA BARAT, DKI JAKARTA",137,183,2,185
https://kawalpemilu.org#25967,"KEDOYA UTARA, KEBON JERUK, JAKARTA BARAT, DKI JAKARTA",138,172,5,177
https://kawalpemilu.org#25967,"KEDOYA UTARA, KEBON JERUK, JAKARTA BARAT, DKI JAKARTA",139,153,4,157
https://kawalpemilu.org#25967,"KEDOYA UTARA, KEBON JERUK, JAKARTA BARAT, DKI JAKARTA",140,190,2,192
https://kawalpemilu.org#25967,"KEDOYA UTARA, KEBON JERUK, JAKARTA BARAT, DKI JAKARTA",141,219,1,220
https://kawalpemilu.org#25967,"KEDOYA UTARA, KEBON JERUK, JAKARTA BARAT, DKI JAKARTA",142,164,4,168
https://kawalpemilu.org#25967,"KEDOYA UTARA, KEBON JERUK, JAKARTA BARAT, DKI JAKARTA",143,164,49,213
https://kawalpemilu.org#25967,"KEDOYA UTARA, KEBON JERUK, JAKARTA BARAT, DKI JAKARTA",144,177,65,242
https://kawalpemilu.org#25967,"KEDOYA UTARA, KEBON JERUK, JAKARTA BARAT, DKI JAKARTA",145,221,3,224
https://kawalpemilu.org#25968,"KEDOYA SELATAN, KEBON JERUK, JAKARTA BARAT, DKI JAKARTA",1,136,128,264
https://kawalpemilu.org#25968,"KEDOYA SELATAN, KEBON JERUK, JAKARTA BARAT, DKI JAKARTA",2,134,102,236
https://kawalpemilu.org#25968,"KEDOYA SELATAN, KEBON JERUK, JAKARTA BARAT, DKI JAKARTA",3,112,134,246
https://kawalpemilu.org#25968,"KEDOYA SELATAN, KEBON JERUK, JAKARTA BARAT, DKI JAKARTA",4,92,106,198
https://kawalpemilu.org#25968,"KEDOYA SELATAN, KEBON JERUK, JAKARTA BARAT, DKI JAKARTA",5,109,105,214
https://kawalpemilu.org#25968,"KEDOYA SELATAN, KEBON JERUK, JAKARTA BARAT, DKI JAKARTA",6,117,140,257
https://kawalpemilu.org#25968,"KEDOYA SELATAN, KEBON JERUK, JAKARTA BARAT, DKI JAKARTA",7,137,125,262
https://kawalpemilu.org#25968,"KEDOYA SELATAN, KEBON JERUK, JAKARTA BARAT, DKI JAKARTA",8,121,109,230
https://kawalpemilu.org#25968,"KEDOYA SELATAN, KEBON JERUK, JAKARTA BARAT, DKI JAKARTA",9,80,117,197
https://kawalpemilu.org#25968,"KEDOYA SELATAN, KEBON JERUK, JAKARTA BARAT, DKI JAKARTA",10,54,89,143
https://kawalpemilu.org#25968,"KEDOYA SELATAN, KEBON JERUK, JAKARTA BARAT, DKI JAKARTA",11,102,106,208
https://kawalpemilu.org#25968,"KEDOYA SELATAN, KEBON JERUK, JAKARTA BARAT, DKI JAKARTA",12,96,150,246
https://kawalpemilu.org#25968,"KEDOYA SELATAN, KEBON JERUK, JAKARTA BARAT, DKI JAKARTA",13,117,83,200
https://kawalpemilu.org#25968,"KEDOYA SELATAN, KEBON JERUK, JAKARTA BARAT, DKI JAKARTA",14,210,13,223
https://kawalpemilu.org#25968,"KEDOYA SELATAN, KEBON JERUK, JAKARTA BARAT, DKI JAKARTA",15,254,5,259
https://kawalpemilu.org#25968,"KEDOYA SELATAN, KEBON JERUK, JAKARTA BARAT, DKI JAKARTA",16,86,161,247
https://kawalpemilu.org#25968,"KEDOYA SELATAN, KEBON JERUK, JAKARTA BARAT, DKI JAKARTA",17,122,152,274
https://kawalpemilu.org#25968,"KEDOYA SELATAN, KEBON JERUK, JAKARTA BARAT, DKI JAKARTA",18,89,174,263
https://kawalpemilu.org#25968,"KEDOYA SELATAN, KEBON JERUK, JAKARTA BARAT, DKI JAKARTA",19,139,109,248
https://kawalpemilu.org#25968,"KEDOYA SELATAN, KEBON JERUK, JAKARTA BARAT, DKI JAKARTA",20,90,181,271
https://kawalpemilu.org#25968,"KEDOYA SELATAN, KEBON JERUK, JAKARTA BARAT, DKI JAKARTA",21,109,127,236
https://kawalpemilu.org#25968,"KEDOYA SELATAN, KEBON JERUK, JAKARTA BARAT, DKI JAKARTA",22,243,9,252
https://kawalpemilu.org#25968,"KEDOYA SELATAN, KEBON JERUK, JAKARTA BARAT, DKI JAKARTA",23,229,3,232
https://kawalpemilu.org#25968,"KEDOYA SELATAN, KEBON JERUK, JAKARTA BARAT, DKI JAKARTA",24,109,145,254
https://kawalpemilu.org#25968,"KEDOYA SELATAN, KEBON JERUK, JAKARTA BARAT, DKI JAKARTA",25,104,68,172
https://kawalpemilu.org#25968,"KEDOYA SELATAN, KEBON JERUK, JAKARTA BARAT, DKI JAKARTA",26,103,150,253
https://kawalpemilu.org#25968,"KEDOYA SELATAN, KEBON JERUK, JAKARTA BARAT, DKI JAKARTA",27,99,118,217
https://kawalpemilu.org#25968,"KEDOYA SELATAN, KEBON JERUK, JAKARTA BARAT, DKI JAKARTA",28,87,185,272
https://kawalpemilu.org#25968,"KEDOYA SELATAN, KEBON JERUK, JAKARTA BARAT, DKI JAKARTA",29,114,126,240
https://kawalpemilu.org#25968,"KEDOYA SELATAN, KEBON JERUK, JAKARTA BARAT, DKI JAKARTA",30,123,145,268
https://kawalpemilu.org#25968,"KEDOYA SELATAN, KEBON JERUK, JAKARTA BARAT, DKI JAKARTA",31,119,160,279
https://kawalpemilu.org#25968,"KEDOYA SELATAN, KEBON JERUK, JAKARTA BARAT, DKI JAKARTA",32,137,47,184
https://kawalpemilu.org#25968,"KEDOYA SELATAN, KEBON JERUK, JAKARTA BARAT, DKI JAKARTA",33,134,135,269
https://kawalpemilu.org#25968,"KEDOYA SELATAN, KEBON JERUK, JAKARTA BARAT, DKI JAKARTA",34,106,135,241
https://kawalpemilu.org#25968,"KEDOYA SELATAN, KEBON JERUK, JAKARTA BARAT, DKI JAKARTA",35,123,109,232
https://kawalpemilu.org#25968,"KEDOYA SELATAN, KEBON JERUK, JAKARTA BARAT, DKI JAKARTA",36,132,101,233
https://kawalpemilu.org#25968,"KEDOYA SELATAN, KEBON JERUK, JAKARTA BARAT, DKI JAKARTA",37,124,94,218
https://kawalpemilu.org#25968,"KEDOYA SELATAN, KEBON JERUK, JAKARTA BARAT, DKI JAKARTA",38,103,107,210
https://kawalpemilu.org#25968,"KEDOYA SELATAN, KEBON JERUK, JAKARTA BARAT, DKI JAKARTA",39,113,92,205
https://kawalpemilu.org#25968,"KEDOYA SELATAN, KEBON JERUK, JAKARTA BARAT, DKI JAKARTA",40,124,121,245
https://kawalpemilu.org#25968,"KEDOYA SELATAN, KEBON JERUK, JAKARTA BARAT, DKI JAKARTA",41,118,140,258
https://kawalpemilu.org#25968,"KEDOYA SELATAN, KEBON JERUK, JAKARTA BARAT, DKI JAKARTA",42,87,82,169
https://kawalpemilu.org#25968,"KEDOYA SELATAN, KEBON JERUK, JAKARTA BARAT, DKI JAKARTA",43,130,124,254
https://kawalpemilu.org#25968,"KEDOYA SELATAN, KEBON JERUK, JAKARTA BARAT, DKI JAKARTA",44,119,124,243
https://kawalpemilu.org#25968,"KEDOYA SELATAN, KEBON JERUK, JAKARTA BARAT, DKI JAKARTA",45,88,180,268
https://kawalpemilu.org#25968,"KEDOYA SELATAN, KEBON JERUK, JAKARTA BARAT, DKI JAKARTA",46,133,107,240
https://kawalpemilu.org#25968,"KEDOYA SELATAN, KEBON JERUK, JAKARTA BARAT, DKI JAKARTA",47,118,129,247
https://kawalpemilu.org#25968,"KEDOYA SELATAN, KEBON JERUK, JAKARTA BARAT, DKI JAKARTA",48,0,0,0
https://kawalpemilu.org#25968,"KEDOYA SELATAN, KEBON JERUK, JAKARTA BARAT, DKI JAKARTA",49,117,110,227
https://kawalpemilu.org#25968,"KEDOYA SELATAN, KEBON JERUK, JAKARTA BARAT, DKI JAKARTA",50,192,85,277
https://kawalpemilu.org#25968,"KEDOYA SELATAN, KEBON JERUK, JAKARTA BARAT, DKI JAKARTA",51,173,96,269
https://kawalpemilu.org#25968,"KEDOYA SELATAN, KEBON JERUK, JAKARTA BARAT, DKI JAKARTA",52,133,147,280
https://kawalpemilu.org#25968,"KEDOYA SELATAN, KEBON JERUK, JAKARTA BARAT, DKI JAKARTA",53,124,161,285
https://kawalpemilu.org#25968,"KEDOYA SELATAN, KEBON JERUK, JAKARTA BARAT, DKI JAKARTA",54,81,95,176
https://kawalpemilu.org#25968,"KEDOYA SELATAN, KEBON JERUK, JAKARTA BARAT, DKI JAKARTA",55,101,95,196
https://kawalpemilu.org#25968,"KEDOYA SELATAN, KEBON JERUK, JAKARTA BARAT, DKI JAKARTA",56,130,116,246
https://kawalpemilu.org#25968,"KEDOYA SELATAN, KEBON JERUK, JAKARTA BARAT, DKI JAKARTA",57,140,34,174
https://kawalpemilu.org#25968,"KEDOYA SELATAN, KEBON JERUK, JAKARTA BARAT, DKI JAKARTA",58,107,22,129
https://kawalpemilu.org#25968,"KEDOYA SELATAN, KEBON JERUK, JAKARTA BARAT, DKI JAKARTA",59,222,0,222
https://kawalpemilu.org#25968,"KEDOYA SELATAN, KEBON JERUK, JAKARTA BARAT, DKI JAKARTA",60,209,10,219
https://kawalpemilu.org#25968,"KEDOYA SELATAN, KEBON JERUK, JAKARTA BARAT, DKI JAKARTA",61,195,6,201
https://kawalpemilu.org#25968,"KEDOYA SELATAN, KEBON JERUK, JAKARTA BARAT, DKI JAKARTA",62,0,0,0
https://kawalpemilu.org#25968,"KEDOYA SELATAN, KEBON JERUK, JAKARTA BARAT, DKI JAKARTA",63,229,3,232
https://kawalpemilu.org#25968,"KEDOYA SELATAN, KEBON JERUK, JAKARTA BARAT, DKI JAKARTA",64,244,3,247
https://kawalpemilu.org#25968,"KEDOYA SELATAN, KEBON JERUK, JAKARTA BARAT, DKI JAKARTA",65,156,4,160
https://kawalpemilu.org#25968,"KEDOYA SELATAN, KEBON JERUK, JAKARTA BARAT, DKI JAKARTA",66,141,6,147
https://kawalpemilu.org#25968,"KEDOYA SELATAN, KEBON JERUK, JAKARTA BARAT, DKI JAKARTA",67,242,8,250
https://kawalpemilu.org#25968,"KEDOYA SELATAN, KEBON JERUK, JAKARTA BARAT, DKI JAKARTA",68,215,6,221
https://kawalpemilu.org#25968,"KEDOYA SELATAN, KEBON JERUK, JAKARTA BARAT, DKI JAKARTA",69,126,2,128
https://kawalpemilu.org#25968,"KEDOYA SELATAN, KEBON JERUK, JAKARTA BARAT, DKI JAKARTA",70,180,5,185
https://kawalpemilu.org#25968,"KEDOYA SELATAN, KEBON JERUK, JAKARTA BARAT, DKI JAKARTA",71,124,144,268
https://kawalpemilu.org#25968,"KEDOYA SELATAN, KEBON JERUK, JAKARTA BARAT, DKI JAKARTA",72,101,153,254
https://kawalpemilu.org#25968,"KEDOYA SELATAN, KEBON JERUK, JAKARTA BARAT, DKI JAKARTA",73,105,153,258
https://kawalpemilu.org#25968,"KEDOYA SELATAN, KEBON JERUK, JAKARTA BARAT, DKI JAKARTA",74,137,95,232
https://kawalpemilu.org#25968,"KEDOYA SELATAN, KEBON JERUK, JAKARTA BARAT, DKI JAKARTA",75,133,88,221
https://kawalpemilu.org#25968,"KEDOYA SELATAN, KEBON JERUK, JAKARTA BARAT, DKI JAKARTA",76,155,108,263
https://kawalpemilu.org#25968,"KEDOYA SELATAN, KEBON JERUK, JAKARTA BARAT, DKI JAKARTA",77,157,119,276
https://kawalpemilu.org#25968,"KEDOYA SELATAN, KEBON JERUK, JAKARTA BARAT, DKI JAKARTA",78,136,106,242
https://kawalpemilu.org#25968,"KEDOYA SELATAN, KEBON JERUK, JAKARTA BARAT, DKI JAKARTA",79,153,128,281
https://kawalpemilu.org#25968,"KEDOYA SELATAN, KEBON JERUK, JAKARTA BARAT, DKI JAKARTA",80,133,136,269
https://kawalpemilu.org#25968,"KEDOYA SELATAN, KEBON JERUK, JAKARTA BARAT, DKI JAKARTA",81,161,111,272
https://kawalpemilu.org#25968,"KEDOYA SELATAN, KEBON JERUK, JAKARTA BARAT, DKI JAKARTA",82,129,108,237
https://kawalpemilu.org#25968,"KEDOYA SELATAN, KEBON JERUK, JAKARTA BARAT, DKI JAKARTA",83,156,118,274
https://kawalpemilu.org#25968,"KEDOYA SELATAN, KEBON JERUK, JAKARTA BARAT, DKI JAKARTA",84,156,118,274
https://kawalpemilu.org#25968,"KEDOYA SELATAN, KEBON JERUK, JAKARTA BARAT, DKI JAKARTA",85,138,115,253
https://kawalpemilu.org#25968,"KEDOYA SELATAN, KEBON JERUK, JAKARTA BARAT, DKI JAKARTA",86,198,105,303
https://kawalpemilu.org#25968,"KEDOYA SELATAN, KEBON JERUK, JAKARTA BARAT, DKI JAKARTA",87,153,116,269
https://kawalpemilu.org#25968,"KEDOYA SELATAN, KEBON JERUK, JAKARTA BARAT, DKI JAKARTA",88,118,133,251
https://kawalpemilu.org#25968,"KEDOYA SELATAN, KEBON JERUK, JAKARTA BARAT, DKI JAKARTA",89,142,116,258
https://kawalpemilu.org#25968,"KEDOYA SELATAN, KEBON JERUK, JAKARTA BARAT, DKI JAKARTA",90,165,92,257
https://kawalpemilu.org#25968,"KEDOYA SELATAN, KEBON JERUK, JAKARTA BARAT, DKI JAKARTA",91,230,60,290
https://kawalpemilu.org#25968,"KEDOYA SELATAN, KEBON JERUK, JAKARTA BARAT, DKI JAKARTA",92,166,46,212
https://kawalpemilu.org#25968,"KEDOYA SELATAN, KEBON JERUK, JAKARTA BARAT, DKI JAKARTA",93,168,72,240
https://kawalpemilu.org#25968,"KEDOYA SELATAN, KEBON JERUK, JAKARTA BARAT, DKI JAKARTA",94,174,20,194
https://kawalpemilu.org#25968,"KEDOYA SELATAN, KEBON JERUK, JAKARTA BARAT, DKI JAKARTA",95,124,112,236
https://kawalpemilu.org#25968,"KEDOYA SELATAN, KEBON JERUK, JAKARTA BARAT, DKI JAKARTA",96,108,129,237
https://kawalpemilu.org#25968,"KEDOYA SELATAN, KEBON JERUK, JAKARTA BARAT, DKI JAKARTA",97,148,99,247
https://kawalpemilu.org#25968,"KEDOYA SELATAN, KEBON JERUK, JAKARTA BARAT, DKI JAKARTA",98,190,64,254
https://kawalpemilu.org#25968,"KEDOYA SELATAN, KEBON JERUK, JAKARTA BARAT, DKI JAKARTA",99,113,81,194
https://kawalpemilu.org#25968,"KEDOYA SELATAN, KEBON JERUK, JAKARTA BARAT, DKI JAKARTA",100,142,58,200
https://kawalpemilu.org#25970,"KALIDERES, KALIDERES, JAKARTA BARAT, DKI JAKARTA",1,120,136,256
https://kawalpemilu.org#25970,"KALIDERES, KALIDERES, JAKARTA BARAT, DKI JAKARTA",2,97,146,243
https://kawalpemilu.org#25970,"KALIDERES, KALIDERES, JAKARTA BARAT, DKI JAKARTA",3,110,150,260
https://kawalpemilu.org#25970,"KALIDERES, KALIDERES, JAKARTA BARAT, DKI JAKARTA",4,164,70,234
https://kawalpemilu.org#25970,"KALIDERES, KALIDERES, JAKARTA BARAT, DKI JAKARTA",5,117,106,223
https://kawalpemilu.org#25970,"KALIDERES, KALIDERES, JAKARTA BARAT, DKI JAKARTA",6,124,108,232
https://kawalpemilu.org#25970,"KALIDERES, KALIDERES, JAKARTA BARAT, DKI JAKARTA",7,95,114,209
https://kawalpemilu.org#25970,"KALIDERES, KALIDERES, JAKARTA BARAT, DKI JAKARTA",8,106,169,275
https://kawalpemilu.org#25970,"KALIDERES, KALIDERES, JAKARTA BARAT, DKI JAKARTA",9,117,166,283
https://kawalpemilu.org#25970,"KALIDERES, KALIDERES, JAKARTA BARAT, DKI JAKARTA",10,79,98,177
https://kawalpemilu.org#25970,"KALIDERES, KALIDERES, JAKARTA BARAT, DKI JAKARTA",11,99,150,249
https://kawalpemilu.org#25970,"KALIDERES, KALIDERES, JAKARTA BARAT, DKI JAKARTA",12,85,135,220
https://kawalpemilu.org#25970,"KALIDERES, KALIDERES, JAKARTA BARAT, DKI JAKARTA",13,86,151,237
https://kawalpemilu.org#25970,"KALIDERES, KALIDERES, JAKARTA BARAT, DKI JAKARTA",14,110,105,215
https://kawalpemilu.org#25970,"KALIDERES, KALIDERES, JAKARTA BARAT, DKI JAKARTA",15,92,159,251
https://kawalpemilu.org#25970,"KALIDERES, KALIDERES, JAKARTA BARAT, DKI JAKARTA",16,82,182,264
https://kawalpemilu.org#25970,"KALIDERES, KALIDERES, JAKARTA BARAT, DKI JAKARTA",17,100,143,243
https://kawalpemilu.org#25970,"KALIDERES, KALIDERES, JAKARTA BARAT, DKI JAKARTA",18,98,80,178
https://kawalpemilu.org#25970,"KALIDERES, KALIDERES, JAKARTA BARAT, DKI JAKARTA",19,110,67,177
https://kawalpemilu.org#25970,"KALIDERES, KALIDERES, JAKARTA BARAT, DKI JAKARTA",20,89,90,179
https://kawalpemilu.org#25970,"KALIDERES, KALIDERES, JAKARTA BARAT, DKI JAKARTA",21,78,109,187
https://kawalpemilu.org#25970,"KALIDERES, KALIDERES, JAKARTA BARAT, DKI JAKARTA",22,75,115,190
https://kawalpemilu.org#25970,"KALIDERES, KALIDERES, JAKARTA BARAT, DKI JAKARTA",23,92,77,169
https://kawalpemilu.org#25970,"KALIDERES, KALIDERES, JAKARTA BARAT, DKI JAKARTA",24,73,86,159
https://kawalpemilu.org#25970,"KALIDERES, KALIDERES, JAKARTA BARAT, DKI JAKARTA",25,171,50,221
https://kawalpemilu.org#25970,"KALIDERES, KALIDERES, JAKARTA BARAT, DKI JAKARTA",26,149,36,185
https://kawalpemilu.org#25970,"KALIDERES, KALIDERES, JAKARTA BARAT, DKI JAKARTA",27,115,60,175
https://kawalpemilu.org#25970,"KALIDERES, KALIDERES, JAKARTA BARAT, DKI JAKARTA",28,122,129,251
https://kawalpemilu.org#25970,"KALIDERES, KALIDERES, JAKARTA BARAT, DKI JAKARTA",29,75,116,191
https://kawalpemilu.org#25970,"KALIDERES, KALIDERES, JAKARTA BARAT, DKI JAKARTA",30,55,142,197
https://kawalpemilu.org#25970,"KALIDERES, KALIDERES, JAKARTA BARAT, DKI JAKARTA",31,94,120,214
https://kawalpemilu.org#25970,"KALIDERES, KALIDERES, JAKARTA BARAT, DKI JAKARTA",32,123,137,260
https://kawalpemilu.org#25970,"KALIDERES, KALIDERES, JAKARTA BARAT, DKI JAKARTA",33,146,142,288
https://kawalpemilu.org#25970,"KALIDERES, KALIDERES, JAKARTA BARAT, DKI JAKARTA",35,101,134,235
https://kawalpemilu.org#25970,"KALIDERES, KALIDERES, JAKARTA BARAT, DKI JAKARTA",36,116,66,182
https://kawalpemilu.org#25970,"KALIDERES, KALIDERES, JAKARTA BARAT, DKI JAKARTA",37,121,70,191
https://kawalpemilu.org#25970,"KALIDERES, KALIDERES, JAKARTA BARAT, DKI JAKARTA",38,62,108,170
https://kawalpemilu.org#25970,"KALIDERES, KALIDERES, JAKARTA BARAT, DKI JAKARTA",39,75,87,162
https://kawalpemilu.org#25970,"KALIDERES, KALIDERES, JAKARTA BARAT, DKI JAKARTA",40,145,120,265
https://kawalpemilu.org#25970,"KALIDERES, KALIDERES, JAKARTA BARAT, DKI JAKARTA",41,108,120,228
https://kawalpemilu.org#25970,"KALIDERES, KALIDERES, JAKARTA BARAT, DKI JAKARTA",42,91,110,201
https://kawalpemilu.org#25970,"KALIDERES, KALIDERES, JAKARTA BARAT, DKI JAKARTA",43,113,111,224
https://kawalpemilu.org#25970,"KALIDERES, KALIDERES, JAKARTA BARAT, DKI JAKARTA",44,81,117,198
https://kawalpemilu.org#25970,"KALIDERES, KALIDERES, JAKARTA BARAT, DKI JAKARTA",45,68,120,188
https://kawalpemilu.org#25970,"KALIDERES, KALIDERES, JAKARTA BARAT, DKI JAKARTA",46,73,95,168
https://kawalpemilu.org#25970,"KALIDERES, KALIDERES, JAKARTA BARAT, DKI JAKARTA",47,126,129,255
https://kawalpemilu.org#25970,"KALIDERES, KALIDERES, JAKARTA BARAT, DKI JAKARTA",48,139,112,251
https://kawalpemilu.org#25970,"KALIDERES, KALIDERES, JAKARTA BARAT, DKI JAKARTA",49,133,134,267
https://kawalpemilu.org#25970,"KALIDERES, KALIDERES, JAKARTA BARAT, DKI JAKARTA",50,106,144,250
https://kawalpemilu.org#25970,"KALIDERES, KALIDERES, JAKARTA BARAT, DKI JAKARTA",51,84,123,207
https://kawalpemilu.org#25970,"KALIDERES, KALIDERES, JAKARTA BARAT, DKI JAKARTA",52,67,115,182
https://kawalpemilu.org#25970,"KALIDERES, KALIDERES, JAKARTA BARAT, DKI JAKARTA",53,155,83,238
https://kawalpemilu.org#25970,"KALIDERES, KALIDERES, JAKARTA BARAT, DKI JAKARTA",54,73,97,170
https://kawalpemilu.org#25970,"KALIDERES, KALIDERES, JAKARTA BARAT, DKI JAKARTA",55,84,84,168
https://kawalpemilu.org#25970,"KALIDERES, KALIDERES, JAKARTA BARAT, DKI JAKARTA",56,96,103,199
https://kawalpemilu.org#25970,"KALIDERES, KALIDERES, JAKARTA BARAT, DKI JAKARTA",57,52,155,207
https://kawalpemilu.org#25970,"KALIDERES, KALIDERES, JAKARTA BARAT, DKI JAKARTA",58,98,84,182
https://kawalpemilu.org#25970,"KALIDERES, KALIDERES, JAKARTA BARAT, DKI JAKARTA",59,81,150,231
https://kawalpemilu.org#25970,"KALIDERES, KALIDERES, JAKARTA BARAT, DKI JAKARTA",60,66,143,209
https://kawalpemilu.org#25970,"KALIDERES, KALIDERES, JAKARTA BARAT, DKI JAKARTA",61,86,167,253
https://kawalpemilu.org#25970,"KALIDERES, KALIDERES, JAKARTA BARAT, DKI JAKARTA",62,110,116,226
https://kawalpemilu.org#25970,"KALIDERES, KALIDERES, JAKARTA BARAT, DKI JAKARTA",63,143,127,270
https://kawalpemilu.org#25970,"KALIDERES, KALIDERES, JAKARTA BARAT, DKI JAKARTA",64,101,108,209
https://kawalpemilu.org#25970,"KALIDERES, KALIDERES, JAKARTA BARAT, DKI JAKARTA",65,115,109,224
https://kawalpemilu.org#25970,"KALIDERES, KALIDERES, JAKARTA BARAT, DKI JAKARTA",66,121,139,260
https://kawalpemilu.org#25970,"KALIDERES, KALIDERES, JAKARTA BARAT, DKI JAKARTA",67,121,104,225
https://kawalpemilu.org#25970,"KALIDERES, KALIDERES, JAKARTA BARAT, DKI JAKARTA",68,127,126,253
https://kawalpemilu.org#25970,"KALIDERES, KALIDERES, JAKARTA BARAT, DKI JAKARTA",69,138,121,259
https://kawalpemilu.org#25970,"KALIDERES, KALIDERES, JAKARTA BARAT, DKI JAKARTA",70,80,113,193
https://kawalpemilu.org#25970,"KALIDERES, KALIDERES, JAKARTA BARAT, DKI JAKARTA",71,95,95,190
https://kawalpemilu.org#25970,"KALIDERES, KALIDERES, JAKARTA BARAT, DKI JAKARTA",72,95,150,245
https://kawalpemilu.org#25970,"KALIDERES, KALIDERES, JAKARTA BARAT, DKI JAKARTA",73,106,117,223
https://kawalpemilu.org#25970,"KALIDERES, KALIDERES, JAKARTA BARAT, DKI JAKARTA",74,102,150,252
https://kawalpemilu.org#25970,"KALIDERES, KALIDERES, JAKARTA BARAT, DKI JAKARTA",75,108,147,255
https://kawalpemilu.org#25970,"KALIDERES, KALIDERES, JAKARTA BARAT, DKI JAKARTA",76,91,123,214
https://kawalpemilu.org#25970,"KALIDERES, KALIDERES, JAKARTA BARAT, DKI JAKARTA",77,72,92,164
https://kawalpemilu.org#25970,"KALIDERES, KALIDERES, JAKARTA BARAT, DKI JAKARTA",78,112,105,217
https://kawalpemilu.org#25970,"KALIDERES, KALIDERES, JAKARTA BARAT, DKI JAKARTA",79,85,103,188
https://kawalpemilu.org#25970,"KALIDERES, KALIDERES, JAKARTA BARAT, DKI JAKARTA",80,77,81,158
https://kawalpemilu.org#25970,"KALIDERES, KALIDERES, JAKARTA BARAT, DKI JAKARTA",81,72,178,250
https://kawalpemilu.org#25970,"KALIDERES, KALIDERES, JAKARTA BARAT, DKI JAKARTA",82,129,95,224
https://kawalpemilu.org#25970,"KALIDERES, KALIDERES, JAKARTA BARAT, DKI JAKARTA",83,85,108,193
https://kawalpemilu.org#25970,"KALIDERES, KALIDERES, JAKARTA BARAT, DKI JAKARTA",84,119,96,215
https://kawalpemilu.org#25970,"KALIDERES, KALIDERES, JAKARTA BARAT, DKI JAKARTA",85,101,130,231
https://kawalpemilu.org#25970,"KALIDERES, KALIDERES, JAKARTA BARAT, DKI JAKARTA",86,108,94,202
https://kawalpemilu.org#25970,"KALIDERES, KALIDERES, JAKARTA BARAT, DKI JAKARTA",87,114,104,218
https://kawalpemilu.org#25970,"KALIDERES, KALIDERES, JAKARTA BARAT, DKI JAKARTA",88,92,102,194
https://kawalpemilu.org#25970,"KALIDERES, KALIDERES, JAKARTA BARAT, DKI JAKARTA",89,77,116,193
https://kawalpemilu.org#25970,"KALIDERES, KALIDERES, JAKARTA BARAT, DKI JAKARTA",90,104,92,196
https://kawalpemilu.org#25970,"KALIDERES, KALIDERES, JAKARTA BARAT, DKI JAKARTA",91,105,140,245
https://kawalpemilu.org#25970,"KALIDERES, KALIDERES, JAKARTA BARAT, DKI JAKARTA",92,131,160,291
https://kawalpemilu.org#25970,"KALIDERES, KALIDERES, JAKARTA BARAT, DKI JAKARTA",93,89,108,197
https://kawalpemilu.org#25970,"KALIDERES, KALIDERES, JAKARTA BARAT, DKI JAKARTA",94,96,122,218
https://kawalpemilu.org#25970,"KALIDERES, KALIDERES, JAKARTA BARAT, DKI JAKARTA",95,88,151,239
https://kawalpemilu.org#25970,"KALIDERES, KALIDERES, JAKARTA BARAT, DKI JAKARTA",96,79,178,257
https://kawalpemilu.org#25970,"KALIDERES, KALIDERES, JAKARTA BARAT, DKI JAKARTA",97,88,120,208
https://kawalpemilu.org#25970,"KALIDERES, KALIDERES, JAKARTA BARAT, DKI JAKARTA",98,105,113,218
https://kawalpemilu.org#25970,"KALIDERES, KALIDERES, JAKARTA BARAT, DKI JAKARTA",99,138,91,229
https://kawalpemilu.org#25970,"KALIDERES, KALIDERES, JAKARTA BARAT, DKI JAKARTA",100,124,88,212
https://kawalpemilu.org#25970,"KALIDERES, KALIDERES, JAKARTA BARAT, DKI JAKARTA",101,93,123,216
https://kawalpemilu.org#25970,"KALIDERES, KALIDERES, JAKARTA BARAT, DKI JAKARTA",102,120,78,198
https://kawalpemilu.org#25970,"KALIDERES, KALIDERES, JAKARTA BARAT, DKI JAKARTA",103,112,90,202
https://kawalpemilu.org#25970,"KALIDERES, KALIDERES, JAKARTA BARAT, DKI JAKARTA",104,94,85,179
https://kawalpemilu.org#25970,"KALIDERES, KALIDERES, JAKARTA BARAT, DKI JAKARTA",105,142,76,218
https://kawalpemilu.org#25970,"KALIDERES, KALIDERES, JAKARTA BARAT, DKI JAKARTA",106,158,61,219
https://kawalpemilu.org#25970,"KALIDERES, KALIDERES, JAKARTA BARAT, DKI JAKARTA",107,147,93,240
https://kawalpemilu.org#25970,"KALIDERES, KALIDERES, JAKARTA BARAT, DKI JAKARTA",108,242,9,251
https://kawalpemilu.org#25970,"KALIDERES, KALIDERES, JAKARTA BARAT, DKI JAKARTA",109,217,20,237
https://kawalpemilu.org#25970,"KALIDERES, KALIDERES, JAKARTA BARAT, DKI JAKARTA",110,170,16,186
https://kawalpemilu.org#25970,"KALIDERES, KALIDERES, JAKARTA BARAT, DKI JAKARTA",111,193,14,207
https://kawalpemilu.org#25970,"KALIDERES, KALIDERES, JAKARTA BARAT, DKI JAKARTA",112,185,9,194
https://kawalpemilu.org#25970,"KALIDERES, KALIDERES, JAKARTA BARAT, DKI JAKARTA",113,207,7,214
https://kawalpemilu.org#25970,"KALIDERES, KALIDERES, JAKARTA BARAT, DKI JAKARTA",114,213,3,216
https://kawalpemilu.org#25970,"KALIDERES, KALIDERES, JAKARTA BARAT, DKI JAKARTA",115,195,2,197
https://kawalpemilu.org#25970,"KALIDERES, KALIDERES, JAKARTA BARAT, DKI JAKARTA",116,239,13,252
https://kawalpemilu.org#25970,"KALIDERES, KALIDERES, JAKARTA BARAT, DKI JAKARTA",117,233,20,253
https://kawalpemilu.org#25970,"KALIDERES, KALIDERES, JAKARTA BARAT, DKI JAKARTA",118,106,117,223
https://kawalpemilu.org#25970,"KALIDERES, KALIDERES, JAKARTA BARAT, DKI JAKARTA",119,128,116,244
https://kawalpemilu.org#25970,"KALIDERES, KALIDERES, JAKARTA BARAT, DKI JAKARTA",120,102,145,247
https://kawalpemilu.org#25970,"KALIDERES, KALIDERES, JAKARTA BARAT, DKI JAKARTA",121,146,112,258
https://kawalpemilu.org#25970,"KALIDERES, KALIDERES, JAKARTA BARAT, DKI JAKARTA",122,107,113,220
https://kawalpemilu.org#25970,"KALIDERES, KALIDERES, JAKARTA BARAT, DKI JAKARTA",123,122,119,241
https://kawalpemilu.org#25970,"KALIDERES, KALIDERES, JAKARTA BARAT, DKI JAKARTA",124,133,127,260
https://kawalpemilu.org#25970,"KALIDERES, KALIDERES, JAKARTA BARAT, DKI JAKARTA",125,133,93,226
https://kawalpemilu.org#25970,"KALIDERES, KALIDERES, JAKARTA BARAT, DKI JAKARTA",126,113,65,178
https://kawalpemilu.org#25970,"KALIDERES, KALIDERES, JAKARTA BARAT, DKI JAKARTA",127,125,72,197
https://kawalpemilu.org#25970,"KALIDERES, KALIDERES, JAKARTA BARAT, DKI JAKARTA",128,134,93,227
https://kawalpemilu.org#25970,"KALIDERES, KALIDERES, JAKARTA BARAT, DKI JAKARTA",129,153,92,245
https://kawalpemilu.org#25970,"KALIDERES, KALIDERES, JAKARTA BARAT, DKI JAKARTA",130,99,112,211
https://kawalpemilu.org#25970,"KALIDERES, KALIDERES, JAKARTA BARAT, DKI JAKARTA",131,120,94,214
https://kawalpemilu.org#25970,"KALIDERES, KALIDERES, JAKARTA BARAT, DKI JAKARTA",132,117,145,262
https://kawalpemilu.org#25970,"KALIDERES, KALIDERES, JAKARTA BARAT, DKI JAKARTA",133,127,100,227
https://kawalpemilu.org#25970,"KALIDERES, KALIDERES, JAKARTA BARAT, DKI JAKARTA",134,110,103,213
https://kawalpemilu.org#25970,"KALIDERES, KALIDERES, JAKARTA BARAT, DKI JAKARTA",135,107,91,198
https://kawalpemilu.org#25970,"KALIDERES, KALIDERES, JAKARTA BARAT, DKI JAKARTA",136,97,112,209
https://kawalpemilu.org#25970,"KALIDERES, KALIDERES, JAKARTA BARAT, DKI JAKARTA",137,85,116,201
https://kawalpemilu.org#25970,"KALIDERES, KALIDERES, JAKARTA BARAT, DKI JAKARTA",138,112,128,240
https://kawalpemilu.org#25970,"KALIDERES, KALIDERES, JAKARTA BARAT, DKI JAKARTA",139,93,112,205
https://kawalpemilu.org#25970,"KALIDERES, KALIDERES, JAKARTA BARAT, DKI JAKARTA",140,128,99,227
https://kawalpemilu.org#25970,"KALIDERES, KALIDERES, JAKARTA BARAT, DKI JAKARTA",141,104,116,220
https://kawalpemilu.org#25970,"KALIDERES, KALIDERES, JAKARTA BARAT, DKI JAKARTA",142,118,89,207
https://kawalpemilu.org#25970,"KALIDERES, KALIDERES, JAKARTA BARAT, DKI JAKARTA",143,153,130,283
https://kawalpemilu.org#25970,"KALIDERES, KALIDERES, JAKARTA BARAT, DKI JAKARTA",144,116,78,194
https://kawalpemilu.org#25970,"KALIDERES, KALIDERES, JAKARTA BARAT, DKI JAKARTA",145,136,80,216
https://kawalpemilu.org#25970,"KALIDERES, KALIDERES, JAKARTA BARAT, DKI JAKARTA",146,118,89,207
https://kawalpemilu.org#25970,"KALIDERES, KALIDERES, JAKARTA BARAT, DKI JAKARTA",147,122,59,181
https://kawalpemilu.org#25970,"KALIDERES, KALIDERES, JAKARTA BARAT, DKI JAKARTA",148,136,71,207
https://kawalpemilu.org#25970,"KALIDERES, KALIDERES, JAKARTA BARAT, DKI JAKARTA",149,114,73,187
https://kawalpemilu.org#25970,"KALIDERES, KALIDERES, JAKARTA BARAT, DKI JAKARTA",150,99,65,164
https://kawalpemilu.org#25970,"KALIDERES, KALIDERES, JAKARTA BARAT, DKI JAKARTA",151,98,140,238
https://kawalpemilu.org#25970,"KALIDERES, KALIDERES, JAKARTA BARAT, DKI JAKARTA",152,144,77,221
https://kawalpemilu.org#25970,"KALIDERES, KALIDERES, JAKARTA BARAT, DKI JAKARTA",153,70,90,160
https://kawalpemilu.org#25970,"KALIDERES, KALIDERES, JAKARTA BARAT, DKI JAKARTA",154,93,119,212
https://kawalpemilu.org#25970,"KALIDERES, KALIDERES, JAKARTA BARAT, DKI JAKARTA",155,209,23,232
https://kawalpemilu.org#25970,"KALIDERES, KALIDERES, JAKARTA BARAT, DKI JAKARTA",156,120,76,196
https://kawalpemilu.org#25970,"KALIDERES, KALIDERES, JAKARTA BARAT, DKI JAKARTA",157,120,67,187
https://kawalpemilu.org#25970,"KALIDERES, KALIDERES, JAKARTA BARAT, DKI JAKARTA",158,123,55,178
https://kawalpemilu.org#25970,"KALIDERES, KALIDERES, JAKARTA BARAT, DKI JAKARTA",159,122,63,185
https://kawalpemilu.org#25970,"KALIDERES, KALIDERES, JAKARTA BARAT, DKI JAKARTA",160,116,78,194
https://kawalpemilu.org#25970,"KALIDERES, KALIDERES, JAKARTA BARAT, DKI JAKARTA",161,102,88,190
https://kawalpemilu.org#25970,"KALIDERES, KALIDERES, JAKARTA BARAT, DKI JAKARTA",162,87,75,162
https://kawalpemilu.org#25970,"KALIDERES, KALIDERES, JAKARTA BARAT, DKI JAKARTA",163,106,91,197
https://kawalpemilu.org#25970,"KALIDERES, KALIDERES, JAKARTA BARAT, DKI JAKARTA",164,152,80,252
https://kawalpemilu.org#25970,"KALIDERES, KALIDERES, JAKARTA BARAT, DKI JAKARTA",165,162,129,291
https://kawalpemilu.org#25970,"KALIDERES, KALIDERES, JAKARTA BARAT, DKI JAKARTA",166,68,121,189
https://kawalpemilu.org#25970,"KALIDERES, KALIDERES, JAKARTA BARAT, DKI JAKARTA",167,93,108,201
https://kawalpemilu.org#25970,"KALIDERES, KALIDERES, JAKARTA BARAT, DKI JAKARTA",168,88,83,171
https://kawalpemilu.org#25970,"KALIDERES, KALIDERES, JAKARTA BARAT, DKI JAKARTA",169,78,72,150
https://kawalpemilu.org#25970,"KALIDERES, KALIDERES, JAKARTA BARAT, DKI JAKARTA",170,63,92,155
https://kawalpemilu.org#25970,"KALIDERES, KALIDERES, JAKARTA BARAT, DKI JAKARTA",171,54,79,133
https://kawalpemilu.org#25970,"KALIDERES, KALIDERES, JAKARTA BARAT, DKI JAKARTA",172,114,82,196
https://kawalpemilu.org#25970,"KALIDERES, KALIDERES, JAKARTA BARAT, DKI JAKARTA",173,99,84,183
https://kawalpemilu.org#25970,"KALIDERES, KALIDERES, JAKARTA BARAT, DKI JAKARTA",174,87,108,195
https://kawalpemilu.org#25970,"KALIDERES, KALIDERES, JAKARTA BARAT, DKI JAKARTA",175,140,63,203
https://kawalpemilu.org#25970,"KALIDERES, KALIDERES, JAKARTA BARAT, DKI JAKARTA",176,150,105,255
https://kawalpemilu.org#25970,"KALIDERES, KALIDERES, JAKARTA BARAT, DKI JAKARTA",177,108,139,247
https://kawalpemilu.org#25970,"KALIDERES, KALIDERES, JAKARTA BARAT, DKI JAKARTA",178,110,82,192
https://kawalpemilu.org#25970,"KALIDERES, KALIDERES, JAKARTA BARAT, DKI JAKARTA",179,108,105,213
https://kawalpemilu.org#25970,"KALIDERES, KALIDERES, JAKARTA BARAT, DKI JAKARTA",180,111,97,208
https://kawalpemilu.org#25970,"KALIDERES, KALIDERES, JAKARTA BARAT, DKI JAKARTA",181,74,101,175
https://kawalpemilu.org#25970,"KALIDERES, KALIDERES, JAKARTA BARAT, DKI JAKARTA",182,98,106,204
https://kawalpemilu.org#25970,"KALIDERES, KALIDERES, JAKARTA BARAT, DKI JAKARTA",183,94,79,173
https://kawalpemilu.org#25970,"KALIDERES, KALIDERES, JAKARTA BARAT, DKI JAKARTA",184,86,117,203
https://kawalpemilu.org#25970,"KALIDERES, KALIDERES, JAKARTA BARAT, DKI JAKARTA",185,72,135,207
https://kawalpemilu.org#25970,"KALIDERES, KALIDERES, JAKARTA BARAT, DKI JAKARTA",186,82,119,201
https://kawalpemilu.org#25970,"KALIDERES, KALIDERES, JAKARTA BARAT, DKI JAKARTA",187,102,107,209
https://kawalpemilu.org#25970,"KALIDERES, KALIDERES, JAKARTA BARAT, DKI JAKARTA",188,96,77,173
https://kawalpemilu.org#25970,"KALIDERES, KALIDERES, JAKARTA BARAT, DKI JAKARTA",189,80,118,198
https://kawalpemilu.org#25970,"KALIDERES, KALIDERES, JAKARTA BARAT, DKI JAKARTA",190,114,101,215
https://kawalpemilu.org#25970,"KALIDERES, KALIDERES, JAKARTA BARAT, DKI JAKARTA",191,112,119,231
https://kawalpemilu.org#25970,"KALIDERES, KALIDERES, JAKARTA BARAT, DKI JAKARTA",192,103,118,221
https://kawalpemilu.org#25970,"KALIDERES, KALIDERES, JAKARTA BARAT, DKI JAKARTA",193,117,98,215
https://kawalpemilu.org#25970,"KALIDERES, KALIDERES, JAKARTA BARAT, DKI JAKARTA",194,125,99,224
https://kawalpemilu.org#25970,"KALIDERES, KALIDERES, JAKARTA BARAT, DKI JAKARTA",195,104,120,224
https://kawalpemilu.org#25970,"KALIDERES, KALIDERES, JAKARTA BARAT, DKI JAKARTA",196,100,71,171
https://kawalpemilu.org#25970,"KALIDERES, KALIDERES, JAKARTA BARAT, DKI JAKARTA",197,84,102,186
https://kawalpemilu.org#25970,"KALIDERES, KALIDERES, JAKARTA BARAT, DKI JAKARTA",198,100,77,177
https://kawalpemilu.org#25970,"KALIDERES, KALIDERES, JAKARTA BARAT, DKI JAKARTA",199,122,115,237
https://kawalpemilu.org#25970,"KALIDERES, KALIDERES, JAKARTA BARAT, DKI JAKARTA",200,91,110,201
https://kawalpemilu.org#25970,"KALIDERES, KALIDERES, JAKARTA BARAT, DKI JAKARTA",201,97,102,199
https://kawalpemilu.org#25970,"KALIDERES, KALIDERES, JAKARTA BARAT, DKI JAKARTA",202,88,82,170
https://kawalpemilu.org#25970,"KALIDERES, KALIDERES, JAKARTA BARAT, DKI JAKARTA",203,170,73,243
https://kawalpemilu.org#25970,"KALIDERES, KALIDERES, JAKARTA BARAT, DKI JAKARTA",204,222,19,241
https://kawalpemilu.org#25970,"KALIDERES, KALIDERES, JAKARTA BARAT, DKI JAKARTA",205,199,11,210
https://kawalpemilu.org#25970,"KALIDERES, KALIDERES, JAKARTA BARAT, DKI JAKARTA",206,217,12,229
https://kawalpemilu.org#25970,"KALIDERES, KALIDERES, JAKARTA BARAT, DKI JAKARTA",207,224,15,239
https://kawalpemilu.org#25970,"KALIDERES, KALIDERES, JAKARTA BARAT, DKI JAKARTA",208,242,15,257
https://kawalpemilu.org#25970,"KALIDERES, KALIDERES, JAKARTA BARAT, DKI JAKARTA",209,170,6,176
https://kawalpemilu.org#25970,"KALIDERES, KALIDERES, JAKARTA BARAT, DKI JAKARTA",210,233,2,235
https://kawalpemilu.org#25970,"KALIDERES, KALIDERES, JAKARTA BARAT, DKI JAKARTA",211,240,6,246
https://kawalpemilu.org#25970,"KALIDERES, KALIDERES, JAKARTA BARAT, DKI JAKARTA",212,195,6,201
https://kawalpemilu.org#25970,"KALIDERES, KALIDERES, JAKARTA BARAT, DKI JAKARTA",213,210,4,214
https://kawalpemilu.org#25970,"KALIDERES, KALIDERES, JAKARTA BARAT, DKI JAKARTA",214,244,10,254
https://kawalpemilu.org#25970,"KALIDERES, KALIDERES, JAKARTA BARAT, DKI JAKARTA",215,256,3,259
https://kawalpemilu.org#25970,"KALIDERES, KALIDERES, JAKARTA BARAT, DKI JAKARTA",216,222,8,230
https://kawalpemilu.org#25970,"KALIDERES, KALIDERES, JAKARTA BARAT, DKI JAKARTA",217,228,18,246
https://kawalpemilu.org#25970,"KALIDERES, KALIDERES, JAKARTA BARAT, DKI JAKARTA",218,144,3,147
https://kawalpemilu.org#25970,"KALIDERES, KALIDERES, JAKARTA BARAT, DKI JAKARTA",219,155,0,155
https://kawalpemilu.org#25970,"KALIDERES, KALIDERES, JAKARTA BARAT, DKI JAKARTA",220,170,6,176
https://kawalpemilu.org#25970,"KALIDERES, KALIDERES, JAKARTA BARAT, DKI JAKARTA",221,206,11,217
https://kawalpemilu.org#25970,"KALIDERES, KALIDERES, JAKARTA BARAT, DKI JAKARTA",222,211,19,230
https://kawalpemilu.org#25970,"KALIDERES, KALIDERES, JAKARTA BARAT, DKI JAKARTA",223,229,4,233
https://kawalpemilu.org#25970,"KALIDERES, KALIDERES, JAKARTA BARAT, DKI JAKARTA",224,216,12,228
https://kawalpemilu.org#25970,"KALIDERES, KALIDERES, JAKARTA BARAT, DKI JAKARTA",225,270,4,274
https://kawalpemilu.org#25970,"KALIDERES, KALIDERES, JAKARTA BARAT, DKI JAKARTA",226,233,5,238
https://kawalpemilu.org#25970,"KALIDERES, KALIDERES, JAKARTA BARAT, DKI JAKARTA",227,255,5,260
https://kawalpemilu.org#25970,"KALIDERES, KALIDERES, JAKARTA BARAT, DKI JAKARTA",228,260,9,269
https://kawalpemilu.org#25970,"KALIDERES, KALIDERES, JAKARTA BARAT, DKI JAKARTA",229,202,0,202
https://kawalpemilu.org#25970,"KALIDERES, KALIDERES, JAKARTA BARAT, DKI JAKARTA",230,216,3,219
https://kawalpemilu.org#25970,"KALIDERES, KALIDERES, JAKARTA BARAT, DKI JAKARTA",231,254,12,266
https://kawalpemilu.org#25971,"SEMANAN, KALIDERES, JAKARTA BARAT, DKI JAKARTA",1,83,131,214
https://kawalpemilu.org#25971,"SEMANAN, KALIDERES, JAKARTA BARAT, DKI JAKARTA",2,91,103,194
https://kawalpemilu.org#25971,"SEMANAN, KALIDERES, JAKARTA BARAT, DKI JAKARTA",3,107,127,234
https://kawalpemilu.org#25971,"SEMANAN, KALIDERES, JAKARTA BARAT, DKI JAKARTA",4,98,138,236
https://kawalpemilu.org#25971,"SEMANAN, KALIDERES, JAKARTA BARAT, DKI JAKARTA",5,114,104,218
https://kawalpemilu.org#25971,"SEMANAN, KALIDERES, JAKARTA BARAT, DKI JAKARTA",6,94,121,215
https://kawalpemilu.org#25971,"SEMANAN, KALIDERES, JAKARTA BARAT, DKI JAKARTA",7,103,110,213
https://kawalpemilu.org#25971,"SEMANAN, KALIDERES, JAKARTA BARAT, DKI JAKARTA",8,99,162,261
https://kawalpemilu.org#25971,"SEMANAN, KALIDERES, JAKARTA BARAT, DKI JAKARTA",9,91,96,187
https://kawalpemilu.org#25971,"SEMANAN, KALIDERES, JAKARTA BARAT, DKI JAKARTA",10,76,146,222
https://kawalpemilu.org#25971,"SEMANAN, KALIDERES, JAKARTA BARAT, DKI JAKARTA",11,123,110,233
https://kawalpemilu.org#25971,"SEMANAN, KALIDERES, JAKARTA BARAT, DKI JAKARTA",12,95,79,174
https://kawalpemilu.org#25971,"SEMANAN, KALIDERES, JAKARTA BARAT, DKI JAKARTA",13,108,147,255
https://kawalpemilu.org#25971,"SEMANAN, KALIDERES, JAKARTA BARAT, DKI JAKARTA",14,88,136,224
https://kawalpemilu.org#25971,"SEMANAN, KALIDERES, JAKARTA BARAT, DKI JAKARTA",15,82,104,186
https://kawalpemilu.org#25971,"SEMANAN, KALIDERES, JAKARTA BARAT, DKI JAKARTA",16,112,93,205
https://kawalpemilu.org#25971,"SEMANAN, KALIDERES, JAKARTA BARAT, DKI JAKARTA",17,0,0,0
https://kawalpemilu.org#25971,"SEMANAN, KALIDERES, JAKARTA BARAT, DKI JAKARTA",18,78,74,152
https://kawalpemilu.org#25971,"SEMANAN, KALIDERES, JAKARTA BARAT, DKI JAKARTA",19,101,89,190
https://kawalpemilu.org#25971,"SEMANAN, KALIDERES, JAKARTA BARAT, DKI JAKARTA",20,132,80,212
https://kawalpemilu.org#25971,"SEMANAN, KALIDERES, JAKARTA BARAT, DKI JAKARTA",21,120,74,194
https://kawalpemilu.org#25971,"SEMANAN, KALIDERES, JAKARTA BARAT, DKI JAKARTA",22,67,95,162
https://kawalpemilu.org#25971,"SEMANAN, KALIDERES, JAKARTA BARAT, DKI JAKARTA",23,71,92,163
https://kawalpemilu.org#25971,"SEMANAN, KALIDERES, JAKARTA BARAT, DKI JAKARTA",24,59,104,163
https://kawalpemilu.org#25971,"SEMANAN, KALIDERES, JAKARTA BARAT, DKI JAKARTA",25,94,85,179
https://kawalpemilu.org#25971,"SEMANAN, KALIDERES, JAKARTA BARAT, DKI JAKARTA",26,63,109,172
https://kawalpemilu.org#25971,"SEMANAN, KALIDERES, JAKARTA BARAT, DKI JAKARTA",27,89,123,212
https://kawalpemilu.org#25971,"SEMANAN, KALIDERES, JAKARTA BARAT, DKI JAKARTA",28,81,119,200
https://kawalpemilu.org#25971,"SEMANAN, KALIDERES, JAKARTA BARAT, DKI JAKARTA",29,85,131,216
https://kawalpemilu.org#25971,"SEMANAN, KALIDERES, JAKARTA BARAT, DKI JAKARTA",30,74,118,192
https://kawalpemilu.org#25971,"SEMANAN, KALIDERES, JAKARTA BARAT, DKI JAKARTA",31,83,145,228
https://kawalpemilu.org#25971,"SEMANAN, KALIDERES, JAKARTA BARAT, DKI JAKARTA",32,125,91,216
https://kawalpemilu.org#25971,"SEMANAN, KALIDERES, JAKARTA BARAT, DKI JAKARTA",33,110,82,192
https://kawalpemilu.org#25971,"SEMANAN, KALIDERES, JAKARTA BARAT, DKI JAKARTA",34,86,111,197
https://kawalpemilu.org#25971,"SEMANAN, KALIDERES, JAKARTA BARAT, DKI JAKARTA",35,68,102,170
https://kawalpemilu.org#25971,"SEMANAN, KALIDERES, JAKARTA BARAT, DKI JAKARTA",36,101,94,195
https://kawalpemilu.org#25971,"SEMANAN, KALIDERES, JAKARTA BARAT, DKI JAKARTA",37,87,95,182
https://kawalpemilu.org#25971,"SEMANAN, KALIDERES, JAKARTA BARAT, DKI JAKARTA",38,119,129,248
https://kawalpemilu.org#25971,"SEMANAN, KALIDERES, JAKARTA BARAT, DKI JAKARTA",39,101,131,232
https://kawalpemilu.org#25971,"SEMANAN, KALIDERES, JAKARTA BARAT, DKI JAKARTA",40,74,98,172
https://kawalpemilu.org#25971,"SEMANAN, KALIDERES, JAKARTA BARAT, DKI JAKARTA",41,78,93,171
https://kawalpemilu.org#25971,"SEMANAN, KALIDERES, JAKARTA BARAT, DKI JAKARTA",42,71,186,257
https://kawalpemilu.org#25971,"SEMANAN, KALIDERES, JAKARTA BARAT, DKI JAKARTA",43,70,149,219
https://kawalpemilu.org#25971,"SEMANAN, KALIDERES, JAKARTA BARAT, DKI JAKARTA",45,104,137,241
https://kawalpemilu.org#25971,"SEMANAN, KALIDERES, JAKARTA BARAT, DKI JAKARTA",46,105,119,224
https://kawalpemilu.org#25971,"SEMANAN, KALIDERES, JAKARTA BARAT, DKI JAKARTA",47,58,117,175
https://kawalpemilu.org#25971,"SEMANAN, KALIDERES, JAKARTA BARAT, DKI JAKARTA",48,82,90,172
https://kawalpemilu.org#25971,"SEMANAN, KALIDERES, JAKARTA BARAT, DKI JAKARTA",49,63,109,172
https://kawalpemilu.org#25971,"SEMANAN, KALIDERES, JAKARTA BARAT, DKI JAKARTA",50,107,120,227
https://kawalpemilu.org#25971,"SEMANAN, KALIDERES, JAKARTA BARAT, DKI JAKARTA",51,101,129,230
https://kawalpemilu.org#25971,"SEMANAN, KALIDERES, JAKARTA BARAT, DKI JAKARTA",52,79,134,213
https://kawalpemilu.org#25971,"SEMANAN, KALIDERES, JAKARTA BARAT, DKI JAKARTA",53,84,133,217
https://kawalpemilu.org#25971,"SEMANAN, KALIDERES, JAKARTA BARAT, DKI JAKARTA",54,104,129,233
https://kawalpemilu.org#25971,"SEMANAN, KALIDERES, JAKARTA BARAT, DKI JAKARTA",55,111,119,230
https://kawalpemilu.org#25971,"SEMANAN, KALIDERES, JAKARTA BARAT, DKI JAKARTA",56,99,190,289
https://kawalpemilu.org#25971,"SEMANAN, KALIDERES, JAKARTA BARAT, DKI JAKARTA",57,114,132,246
https://kawalpemilu.org#25971,"SEMANAN, KALIDERES, JAKARTA BARAT, DKI JAKARTA",58,88,130,218
https://kawalpemilu.org#25971,"SEMANAN, KALIDERES, JAKARTA BARAT, DKI JAKARTA",59,73,133,206
https://kawalpemilu.org#25971,"SEMANAN, KALIDERES, JAKARTA BARAT, DKI JAKARTA",60,80,110,190
https://kawalpemilu.org#25971,"SEMANAN, KALIDERES, JAKARTA BARAT, DKI JAKARTA",61,75,100,175
https://kawalpemilu.org#25971,"SEMANAN, KALIDERES, JAKARTA BARAT, DKI JAKARTA",62,66,144,210
https://kawalpemilu.org#25971,"SEMANAN, KALIDERES, JAKARTA BARAT, DKI JAKARTA",63,104,100,204
https://kawalpemilu.org#25971,"SEMANAN, KALIDERES, JAKARTA BARAT, DKI JAKARTA",64,86,109,195
https://kawalpemilu.org#25971,"SEMANAN, KALIDERES, JAKARTA BARAT, DKI JAKARTA",65,96,137,233
https://kawalpemilu.org#25971,"SEMANAN, KALIDERES, JAKARTA BARAT, DKI JAKARTA",66,101,116,217
https://kawalpemilu.org#25971,"SEMANAN, KALIDERES, JAKARTA BARAT, DKI JAKARTA",67,58,164,222
https://kawalpemilu.org#25971,"SEMANAN, KALIDERES, JAKARTA BARAT, DKI JAKARTA",68,57,165,222
https://kawalpemilu.org#25971,"SEMANAN, KALIDERES, JAKARTA BARAT, DKI JAKARTA",69,57,165,222
https://kawalpemilu.org#25971,"SEMANAN, KALIDERES, JAKARTA BARAT, DKI JAKARTA",70,102,132,234
https://kawalpemilu.org#25971,"SEMANAN, KALIDERES, JAKARTA BARAT, DKI JAKARTA",71,124,147,271
https://kawalpemilu.org#25971,"SEMANAN, KALIDERES, JAKARTA BARAT, DKI JAKARTA",72,101,128,229
https://kawalpemilu.org#25971,"SEMANAN, KALIDERES, JAKARTA BARAT, DKI JAKARTA",73,88,159,247
https://kawalpemilu.org#25971,"SEMANAN, KALIDERES, JAKARTA BARAT, DKI JAKARTA",74,98,143,241
https://kawalpemilu.org#25971,"SEMANAN, KALIDERES, JAKARTA BARAT, DKI JAKARTA",75,102,163,265
https://kawalpemilu.org#25971,"SEMANAN, KALIDERES, JAKARTA BARAT, DKI JAKARTA",76,89,145,234
https://kawalpemilu.org#25971,"SEMANAN, KALIDERES, JAKARTA BARAT, DKI JAKARTA",77,92,144,236
https://kawalpemilu.org#25971,"SEMANAN, KALIDERES, JAKARTA BARAT, DKI JAKARTA",78,59,196,255
https://kawalpemilu.org#25971,"SEMANAN, KALIDERES, JAKARTA BARAT, DKI JAKARTA",79,62,184,246
https://kawalpemilu.org#25971,"SEMANAN, KALIDERES, JAKARTA BARAT, DKI JAKARTA",80,60,164,224
https://kawalpemilu.org#25971,"SEMANAN, KALIDERES, JAKARTA BARAT, DKI JAKARTA",81,69,206,275
https://kawalpemilu.org#25971,"SEMANAN, KALIDERES, JAKARTA BARAT, DKI JAKARTA",82,61,177,238
https://kawalpemilu.org#25971,"SEMANAN, KALIDERES, JAKARTA BARAT, DKI JAKARTA",83,60,138,198
https://kawalpemilu.org#25971,"SEMANAN, KALIDERES, JAKARTA BARAT, DKI JAKARTA",84,104,108,212
https://kawalpemilu.org#25971,"SEMANAN, KALIDERES, JAKARTA BARAT, DKI JAKARTA",85,98,111,209
https://kawalpemilu.org#25971,"SEMANAN, KALIDERES, JAKARTA BARAT, DKI JAKARTA",86,108,97,205
https://kawalpemilu.org#25971,"SEMANAN, KALIDERES, JAKARTA BARAT, DKI JAKARTA",87,62,153,215
https://kawalpemilu.org#25971,"SEMANAN, KALIDERES, JAKARTA BARAT, DKI JAKARTA",88,62,155,217
https://kawalpemilu.org#25971,"SEMANAN, KALIDERES, JAKARTA BARAT, DKI JAKARTA",89,57,142,199
https://kawalpemilu.org#25971,"SEMANAN, KALIDERES, JAKARTA BARAT, DKI JAKARTA",90,46,150,196
https://kawalpemilu.org#25971,"SEMANAN, KALIDERES, JAKARTA BARAT, DKI JAKARTA",91,82,113,195
https://kawalpemilu.org#25971,"SEMANAN, KALIDERES, JAKARTA BARAT, DKI JAKARTA",92,63,133,196
https://kawalpemilu.org#25971,"SEMANAN, KALIDERES, JAKARTA BARAT, DKI JAKARTA",93,60,116,176
https://kawalpemilu.org#25971,"SEMANAN, KALIDERES, JAKARTA BARAT, DKI JAKARTA",94,96,134,230
https://kawalpemilu.org#25971,"SEMANAN, KALIDERES, JAKARTA BARAT, DKI JAKARTA",95,114,102,216
https://kawalpemilu.org#25971,"SEMANAN, KALIDERES, JAKARTA BARAT, DKI JAKARTA",96,94,131,225
https://kawalpemilu.org#25971,"SEMANAN, KALIDERES, JAKARTA BARAT, DKI JAKARTA",97,93,109,202
https://kawalpemilu.org#25971,"SEMANAN, KALIDERES, JAKARTA BARAT, DKI JAKARTA",98,92,117,209
https://kawalpemilu.org#25971,"SEMANAN, KALIDERES, JAKARTA BARAT, DKI JAKARTA",99,110,73,183
https://kawalpemilu.org#25971,"SEMANAN, KALIDERES, JAKARTA BARAT, DKI JAKARTA",100,83,100,183
https://kawalpemilu.org#25971,"SEMANAN, KALIDERES, JAKARTA BARAT, DKI JAKARTA",101,75,97,172
https://kawalpemilu.org#25971,"SEMANAN, KALIDERES, JAKARTA BARAT, DKI JAKARTA",102,79,98,177
https://kawalpemilu.org#25971,"SEMANAN, KALIDERES, JAKARTA BARAT, DKI JAKARTA",103,106,76,182
https://kawalpemilu.org#25971,"SEMANAN, KALIDERES, JAKARTA BARAT, DKI JAKARTA",104,75,58,133
https://kawalpemilu.org#25971,"SEMANAN, KALIDERES, JAKARTA BARAT, DKI JAKARTA",105,79,133,212
https://kawalpemilu.org#25971,"SEMANAN, KALIDERES, JAKARTA BARAT, DKI JAKARTA",106,67,102,169
https://kawalpemilu.org#25971,"SEMANAN, KALIDERES, JAKARTA BARAT, DKI JAKARTA",107,44,143,187
https://kawalpemilu.org#25971,"SEMANAN, KALIDERES, JAKARTA BARAT, DKI JAKARTA",108,54,141,195
https://kawalpemilu.org#25971,"SEMANAN, KALIDERES, JAKARTA BARAT, DKI JAKARTA",109,56,141,197
https://kawalpemilu.org#25971,"SEMANAN, KALIDERES, JAKARTA BARAT, DKI JAKARTA",110,52,102,154
https://kawalpemilu.org#25971,"SEMANAN, KALIDERES, JAKARTA BARAT, DKI JAKARTA",111,82,85,167
https://kawalpemilu.org#25971,"SEMANAN, KALIDERES, JAKARTA BARAT, DKI JAKARTA",112,68,85,153
https://kawalpemilu.org#25971,"SEMANAN, KALIDERES, JAKARTA BARAT, DKI JAKARTA",113,73,95,168
https://kawalpemilu.org#25971,"SEMANAN, KALIDERES, JAKARTA BARAT, DKI JAKARTA",114,72,70,142
https://kawalpemilu.org#25971,"SEMANAN, KALIDERES, JAKARTA BARAT, DKI JAKARTA",115,73,117,190
https://kawalpemilu.org#25971,"SEMANAN, KALIDERES, JAKARTA BARAT, DKI JAKARTA",116,63,122,185
https://kawalpemilu.org#25971,"SEMANAN, KALIDERES, JAKARTA BARAT, DKI JAKARTA",117,96,125,221
https://kawalpemilu.org#25971,"SEMANAN, KALIDERES, JAKARTA BARAT, DKI JAKARTA",118,82,208,290
https://kawalpemilu.org#25971,"SEMANAN, KALIDERES, JAKARTA BARAT, DKI JAKARTA",119,81,220,301
https://kawalpemilu.org#25971,"SEMANAN, KALIDERES, JAKARTA BARAT, DKI JAKARTA",120,70,218,288
https://kawalpemilu.org#25971,"SEMANAN, KALIDERES, JAKARTA BARAT, DKI JAKARTA",121,69,106,175
https://kawalpemilu.org#25971,"SEMANAN, KALIDERES, JAKARTA BARAT, DKI JAKARTA",122,85,98,183
https://kawalpemilu.org#25971,"SEMANAN, KALIDERES, JAKARTA BARAT, DKI JAKARTA",123,47,84,131
https://kawalpemilu.org#25971,"SEMANAN, KALIDERES, JAKARTA BARAT, DKI JAKARTA",124,63,80,143
https://kawalpemilu.org#25971,"SEMANAN, KALIDERES, JAKARTA BARAT, DKI JAKARTA",125,89,71,160
https://kawalpemilu.org#25971,"SEMANAN, KALIDERES, JAKARTA BARAT, DKI JAKARTA",126,109,109,218
https://kawalpemilu.org#25971,"SEMANAN, KALIDERES, JAKARTA BARAT, DKI JAKARTA",127,75,51,126
https://kawalpemilu.org#25971,"SEMANAN, KALIDERES, JAKARTA BARAT, DKI JAKARTA",128,87,51,138
https://kawalpemilu.org#25971,"SEMANAN, KALIDERES, JAKARTA BARAT, DKI JAKARTA",129,165,74,239
https://kawalpemilu.org#25971,"SEMANAN, KALIDERES, JAKARTA BARAT, DKI JAKARTA",130,104,119,223
https://kawalpemilu.org#25971,"SEMANAN, KALIDERES, JAKARTA BARAT, DKI JAKARTA",131,95,102,197
https://kawalpemilu.org#25971,"SEMANAN, KALIDERES, JAKARTA BARAT, DKI JAKARTA",132,112,74,186
https://kawalpemilu.org#25971,"SEMANAN, KALIDERES, JAKARTA BARAT, DKI JAKARTA",133,90,102,192
https://kawalpemilu.org#25971,"SEMANAN, KALIDERES, JAKARTA BARAT, DKI JAKARTA",134,113,95,208
https://kawalpemilu.org#25971,"SEMANAN, KALIDERES, JAKARTA BARAT, DKI JAKARTA",135,81,90,171
https://kawalpemilu.org#25971,"SEMANAN, KALIDERES, JAKARTA BARAT, DKI JAKARTA",136,71,71,142
https://kawalpemilu.org#25971,"SEMANAN, KALIDERES, JAKARTA BARAT, DKI JAKARTA",137,70,132,202
https://kawalpemilu.org#25971,"SEMANAN, KALIDERES, JAKARTA BARAT, DKI JAKARTA",138,75,126,201
https://kawalpemilu.org#25971,"SEMANAN, KALIDERES, JAKARTA BARAT, DKI JAKARTA",139,84,100,187
https://kawalpemilu.org#25971,"SEMANAN, KALIDERES, JAKARTA BARAT, DKI JAKARTA",140,116,80,196
https://kawalpemilu.org#25971,"SEMANAN, KALIDERES, JAKARTA BARAT, DKI JAKARTA",142,74,106,180
https://kawalpemilu.org#25971,"SEMANAN, KALIDERES, JAKARTA BARAT, DKI JAKARTA",143,59,105,164
https://kawalpemilu.org#25971,"SEMANAN, KALIDERES, JAKARTA BARAT, DKI JAKARTA",144,68,99,167
https://kawalpemilu.org#25971,"SEMANAN, KALIDERES, JAKARTA BARAT, DKI JAKARTA",145,75,80,155
https://kawalpemilu.org#25971,"SEMANAN, KALIDERES, JAKARTA BARAT, DKI JAKARTA",146,69,46,115
https://kawalpemilu.org#25971,"SEMANAN, KALIDERES, JAKARTA BARAT, DKI JAKARTA",147,61,106,167
https://kawalpemilu.org#25971,"SEMANAN, KALIDERES, JAKARTA BARAT, DKI JAKARTA",148,65,119,184
https://kawalpemilu.org#25971,"SEMANAN, KALIDERES, JAKARTA BARAT, DKI JAKARTA",149,61,103,164
https://kawalpemilu.org#25971,"SEMANAN, KALIDERES, JAKARTA BARAT, DKI JAKARTA",150,76,82,161
https://kawalpemilu.org#25971,"SEMANAN, KALIDERES, JAKARTA BARAT, DKI JAKARTA",151,63,125,188
https://kawalpemilu.org#25971,"SEMANAN, KALIDERES, JAKARTA BARAT, DKI JAKARTA",152,82,145,227
https://kawalpemilu.org#25971,"SEMANAN, KALIDERES, JAKARTA BARAT, DKI JAKARTA",153,86,127,213
https://kawalpemilu.org#25971,"SEMANAN, KALIDERES, JAKARTA BARAT, DKI JAKARTA",154,93,90,183
https://kawalpemilu.org#25971,"SEMANAN, KALIDERES, JAKARTA BARAT, DKI JAKARTA",155,114,111,225
https://kawalpemilu.org#25971,"SEMANAN, KALIDERES, JAKARTA BARAT, DKI JAKARTA",156,75,131,206
https://kawalpemilu.org#25971,"SEMANAN, KALIDERES, JAKARTA BARAT, DKI JAKARTA",157,99,107,206
https://kawalpemilu.org#25971,"SEMANAN, KALIDERES, JAKARTA BARAT, DKI JAKARTA",158,92,89,181
https://kawalpemilu.org#25971,"SEMANAN, KALIDERES, JAKARTA BARAT, DKI JAKARTA",159,69,127,196
https://kawalpemilu.org#25971,"SEMANAN, KALIDERES, JAKARTA BARAT, DKI JAKARTA",160,91,95,186
https://kawalpemilu.org#25971,"SEMANAN, KALIDERES, JAKARTA BARAT, DKI JAKARTA",161,100,64,164
https://kawalpemilu.org#25971,"SEMANAN, KALIDERES, JAKARTA BARAT, DKI JAKARTA",162,84,136,220
https://kawalpemilu.org#25971,"SEMANAN, KALIDERES, JAKARTA BARAT, DKI JAKARTA",163,81,115,196
https://kawalpemilu.org#25971,"SEMANAN, KALIDERES, JAKARTA BARAT, DKI JAKARTA",164,82,123,205
https://kawalpemilu.org#25971,"SEMANAN, KALIDERES, JAKARTA BARAT, DKI JAKARTA",165,94,139,233
https://kawalpemilu.org#25971,"SEMANAN, KALIDERES, JAKARTA BARAT, DKI JAKARTA",166,88,116,204
https://kawalpemilu.org#25971,"SEMANAN, KALIDERES, JAKARTA BARAT, DKI JAKARTA",167,77,132,209
https://kawalpemilu.org#25971,"SEMANAN, KALIDERES, JAKARTA BARAT, DKI JAKARTA",168,102,103,205
https://kawalpemilu.org#25971,"SEMANAN, KALIDERES, JAKARTA BARAT, DKI JAKARTA",169,107,102,209
https://kawalpemilu.org#25971,"SEMANAN, KALIDERES, JAKARTA BARAT, DKI JAKARTA",170,80,167,247
https://kawalpemilu.org#25971,"SEMANAN, KALIDERES, JAKARTA BARAT, DKI JAKARTA",171,94,143,237
https://kawalpemilu.org#25971,"SEMANAN, KALIDERES, JAKARTA BARAT, DKI JAKARTA",172,70,163,233
https://kawalpemilu.org#25971,"SEMANAN, KALIDERES, JAKARTA BARAT, DKI JAKARTA",174,77,145,222
https://kawalpemilu.org#25971,"SEMANAN, KALIDERES, JAKARTA BARAT, DKI JAKARTA",175,71,120,191
https://kawalpemilu.org#25971,"SEMANAN, KALIDERES, JAKARTA BARAT, DKI JAKARTA",176,79,121,200
https://kawalpemilu.org#25971,"SEMANAN, KALIDERES, JAKARTA BARAT, DKI JAKARTA",177,86,109,195
https://kawalpemilu.org#25971,"SEMANAN, KALIDERES, JAKARTA BARAT, DKI JAKARTA",178,70,149,219
https://kawalpemilu.org#25971,"SEMANAN, KALIDERES, JAKARTA BARAT, DKI JAKARTA",179,68,135,203
https://kawalpemilu.org#25971,"SEMANAN, KALIDERES, JAKARTA BARAT, DKI JAKARTA",180,79,113,192
https://kawalpemilu.org#25971,"SEMANAN, KALIDERES, JAKARTA BARAT, DKI JAKARTA",181,72,126,198
https://kawalpemilu.org#25971,"SEMANAN, KALIDERES, JAKARTA BARAT, DKI JAKARTA",182,73,116,189
https://kawalpemilu.org#25971,"SEMANAN, KALIDERES, JAKARTA BARAT, DKI JAKARTA",183,76,112,188
https://kawalpemilu.org#25971,"SEMANAN, KALIDERES, JAKARTA BARAT, DKI JAKARTA",184,82,122,204
https://kawalpemilu.org#25971,"SEMANAN, KALIDERES, JAKARTA BARAT, DKI JAKARTA",185,97,94,191
https://kawalpemilu.org#25971,"SEMANAN, KALIDERES, JAKARTA BARAT, DKI JAKARTA",186,73,75,148
https://kawalpemilu.org#25971,"SEMANAN, KALIDERES, JAKARTA BARAT, DKI JAKARTA",187,89,113,202
https://kawalpemilu.org#25971,"SEMANAN, KALIDERES, JAKARTA BARAT, DKI JAKARTA",188,110,105,215
https://kawalpemilu.org#25971,"SEMANAN, KALIDERES, JAKARTA BARAT, DKI JAKARTA",189,108,97,205
https://kawalpemilu.org#25971,"SEMANAN, KALIDERES, JAKARTA BARAT, DKI JAKARTA",190,90,126,216
https://kawalpemilu.org#25971,"SEMANAN, KALIDERES, JAKARTA BARAT, DKI JAKARTA",191,72,138,208
https://kawalpemilu.org#25971,"SEMANAN, KALIDERES, JAKARTA BARAT, DKI JAKARTA",192,89,135,224
https://kawalpemilu.org#25971,"SEMANAN, KALIDERES, JAKARTA BARAT, DKI JAKARTA",193,0,0,0
https://kawalpemilu.org#25971,"SEMANAN, KALIDERES, JAKARTA BARAT, DKI JAKARTA",194,54,131,185
https://kawalpemilu.org#25971,"SEMANAN, KALIDERES, JAKARTA BARAT, DKI JAKARTA",195,70,142,212
https://kawalpemilu.org#25971,"SEMANAN, KALIDERES, JAKARTA BARAT, DKI JAKARTA",196,82,123,205
https://kawalpemilu.org#25971,"SEMANAN, KALIDERES, JAKARTA BARAT, DKI JAKARTA",197,75,137,212
https://kawalpemilu.org#25971,"SEMANAN, KALIDERES, JAKARTA BARAT, DKI JAKARTA",198,106,144,250
https://kawalpemilu.org#25971,"SEMANAN, KALIDERES, JAKARTA BARAT, DKI JAKARTA",199,107,134,241
https://kawalpemilu.org#25971,"SEMANAN, KALIDERES, JAKARTA BARAT, DKI JAKARTA",200,96,119,215
https://kawalpemilu.org#25971,"SEMANAN, KALIDERES, JAKARTA BARAT, DKI JAKARTA",201,112,98,210
https://kawalpemilu.org#25971,"SEMANAN, KALIDERES, JAKARTA BARAT, DKI JAKARTA",202,74,120,194
https://kawalpemilu.org#25971,"SEMANAN, KALIDERES, JAKARTA BARAT, DKI JAKARTA",203,82,88,170
https://kawalpemilu.org#25971,"SEMANAN, KALIDERES, JAKARTA BARAT, DKI JAKARTA",204,63,94,157
https://kawalpemilu.org#25971,"SEMANAN, KALIDERES, JAKARTA BARAT, DKI JAKARTA",205,76,97,173
https://kawalpemilu.org#25971,"SEMANAN, KALIDERES, JAKARTA BARAT, DKI JAKARTA",206,79,90,169
https://kawalpemilu.org#25971,"SEMANAN, KALIDERES, JAKARTA BARAT, DKI JAKARTA",207,123,92,215
https://kawalpemilu.org#25971,"SEMANAN, KALIDERES, JAKARTA BARAT, DKI JAKARTA",208,106,93,199
https://kawalpemilu.org#25971,"SEMANAN, KALIDERES, JAKARTA BARAT, DKI JAKARTA",209,0,0,0
https://kawalpemilu.org#25971,"SEMANAN, KALIDERES, JAKARTA BARAT, DKI JAKARTA",210,162,54,216
https://kawalpemilu.org#25971,"SEMANAN, KALIDERES, JAKARTA BARAT, DKI JAKARTA",211,164,47,211
https://kawalpemilu.org#25971,"SEMANAN, KALIDERES, JAKARTA BARAT, DKI JAKARTA",212,156,54,210
https://kawalpemilu.org#25971,"SEMANAN, KALIDERES, JAKARTA BARAT, DKI JAKARTA",214,124,50,174
https://kawalpemilu.org#25971,"SEMANAN, KALIDERES, JAKARTA BARAT, DKI JAKARTA",215,103,39,142
https://kawalpemilu.org#25971,"SEMANAN, KALIDERES, JAKARTA BARAT, DKI JAKARTA",216,187,29,216
https://kawalpemilu.org#25971,"SEMANAN, KALIDERES, JAKARTA BARAT, DKI JAKARTA",218,173,55,228
https://kawalpemilu.org#25971,"SEMANAN, KALIDERES, JAKARTA BARAT, DKI JAKARTA",219,167,45,212
https://kawalpemilu.org#25971,"SEMANAN, KALIDERES, JAKARTA BARAT, DKI JAKARTA",220,123,62,185
https://kawalpemilu.org#25971,"SEMANAN, KALIDERES, JAKARTA BARAT, DKI JAKARTA",221,114,46,160
https://kawalpemilu.org#25971,"SEMANAN, KALIDERES, JAKARTA BARAT, DKI JAKARTA",222,205,7,212
https://kawalpemilu.org#25971,"SEMANAN, KALIDERES, JAKARTA BARAT, DKI JAKARTA",223,211,12,223
https://kawalpemilu.org#25971,"SEMANAN, KALIDERES, JAKARTA BARAT, DKI JAKARTA",224,212,8,220
https://kawalpemilu.org#25971,"SEMANAN, KALIDERES, JAKARTA BARAT, DKI JAKARTA",225,207,8,215
https://kawalpemilu.org#25971,"SEMANAN, KALIDERES, JAKARTA BARAT, DKI JAKARTA",226,204,7,211
https://kawalpemilu.org#25971,"SEMANAN, KALIDERES, JAKARTA BARAT, DKI JAKARTA",227,229,1,230
https://kawalpemilu.org#25971,"SEMANAN, KALIDERES, JAKARTA BARAT, DKI JAKARTA",228,189,14,203
https://kawalpemilu.org#25971,"SEMANAN, KALIDERES, JAKARTA BARAT, DKI JAKARTA",229,199,7,206
https://kawalpemilu.org#25971,"SEMANAN, KALIDERES, JAKARTA BARAT, DKI JAKARTA",230,234,0,234
https://kawalpemilu.org#25971,"SEMANAN, KALIDERES, JAKARTA BARAT, DKI JAKARTA",231,251,23,274
https://kawalpemilu.org#25971,"SEMANAN, KALIDERES, JAKARTA BARAT, DKI JAKARTA",232,228,4,232
https://kawalpemilu.org#25971,"SEMANAN, KALIDERES, JAKARTA BARAT, DKI JAKARTA",233,225,3,228
https://kawalpemilu.org#25971,"SEMANAN, KALIDERES, JAKARTA BARAT, DKI JAKARTA",234,262,6,268
https://kawalpemilu.org#25971,"SEMANAN, KALIDERES, JAKARTA BARAT, DKI JAKARTA",235,258,5,263
https://kawalpemilu.org#25972,"TEGAL ALUR, KALIDERES, JAKARTA BARAT, DKI JAKARTA",1,104,112,216
https://kawalpemilu.org#25972,"TEGAL ALUR, KALIDERES, JAKARTA BARAT, DKI JAKARTA",2,113,121,234
https://kawalpemilu.org#25972,"TEGAL ALUR, KALIDERES, JAKARTA BARAT, DKI JAKARTA",3,94,121,215
https://kawalpemilu.org#25972,"TEGAL ALUR, KALIDERES, JAKARTA BARAT, DKI JAKARTA",4,137,131,268
https://kawalpemilu.org#25972,"TEGAL ALUR, KALIDERES, JAKARTA BARAT, DKI JAKARTA",5,92,109,211
https://kawalpemilu.org#25972,"TEGAL ALUR, KALIDERES, JAKARTA BARAT, DKI JAKARTA",6,89,106,195
https://kawalpemilu.org#25972,"TEGAL ALUR, KALIDERES, JAKARTA BARAT, DKI JAKARTA",7,108,91,199
https://kawalpemilu.org#25972,"TEGAL ALUR, KALIDERES, JAKARTA BARAT, DKI JAKARTA",8,0,0,0
https://kawalpemilu.org#25972,"TEGAL ALUR, KALIDERES, JAKARTA BARAT, DKI JAKARTA",9,82,126,208
https://kawalpemilu.org#25972,"TEGAL ALUR, KALIDERES, JAKARTA BARAT, DKI JAKARTA",10,103,130,233
https://kawalpemilu.org#25972,"TEGAL ALUR, KALIDERES, JAKARTA BARAT, DKI JAKARTA",11,71,98,169
https://kawalpemilu.org#25972,"TEGAL ALUR, KALIDERES, JAKARTA BARAT, DKI JAKARTA",12,95,96,191
https://kawalpemilu.org#25972,"TEGAL ALUR, KALIDERES, JAKARTA BARAT, DKI JAKARTA",13,123,108,231
https://kawalpemilu.org#25972,"TEGAL ALUR, KALIDERES, JAKARTA BARAT, DKI JAKARTA",14,92,89,181
https://kawalpemilu.org#25972,"TEGAL ALUR, KALIDERES, JAKARTA BARAT, DKI JAKARTA",15,96,147,243
https://kawalpemilu.org#25972,"TEGAL ALUR, KALIDERES, JAKARTA BARAT, DKI JAKARTA",16,159,100,259
https://kawalpemilu.org#25972,"TEGAL ALUR, KALIDERES, JAKARTA BARAT, DKI JAKARTA",17,163,104,267
https://kawalpemilu.org#25972,"TEGAL ALUR, KALIDERES, JAKARTA BARAT, DKI JAKARTA",18,0,0,0
https://kawalpemilu.org#25972,"TEGAL ALUR, KALIDERES, JAKARTA BARAT, DKI JAKARTA",19,106,83,189
https://kawalpemilu.org#25972,"TEGAL ALUR, KALIDERES, JAKARTA BARAT, DKI JAKARTA",20,114,72,186
https://kawalpemilu.org#25972,"TEGAL ALUR, KALIDERES, JAKARTA BARAT, DKI JAKARTA",21,115,108,223
https://kawalpemilu.org#25972,"TEGAL ALUR, KALIDERES, JAKARTA BARAT, DKI JAKARTA",22,119,99,218
https://kawalpemilu.org#25972,"TEGAL ALUR, KALIDERES, JAKARTA BARAT, DKI JAKARTA",23,89,116,205
https://kawalpemilu.org#25972,"TEGAL ALUR, KALIDERES, JAKARTA BARAT, DKI JAKARTA",24,90,88,178
https://kawalpemilu.org#25972,"TEGAL ALUR, KALIDERES, JAKARTA BARAT, DKI JAKARTA",25,110,66,176
https://kawalpemilu.org#25972,"TEGAL ALUR, KALIDERES, JAKARTA BARAT, DKI JAKARTA",26,98,62,160
https://kawalpemilu.org#25972,"TEGAL ALUR, KALIDERES, JAKARTA BARAT, DKI JAKARTA",27,108,86,194
https://kawalpemilu.org#25972,"TEGAL ALUR, KALIDERES, JAKARTA BARAT, DKI JAKARTA",28,141,67,208
https://kawalpemilu.org#25972,"TEGAL ALUR, KALIDERES, JAKARTA BARAT, DKI JAKARTA",29,97,74,171
https://kawalpemilu.org#25972,"TEGAL ALUR, KALIDERES, JAKARTA BARAT, DKI JAKARTA",30,118,91,209
https://kawalpemilu.org#25972,"TEGAL ALUR, KALIDERES, JAKARTA BARAT, DKI JAKARTA",31,125,92,217
https://kawalpemilu.org#25972,"TEGAL ALUR, KALIDERES, JAKARTA BARAT, DKI JAKARTA",32,142,61,203
https://kawalpemilu.org#25972,"TEGAL ALUR, KALIDERES, JAKARTA BARAT, DKI JAKARTA",33,153,47,200
https://kawalpemilu.org#25972,"TEGAL ALUR, KALIDERES, JAKARTA BARAT, DKI JAKARTA",34,126,78,204
https://kawalpemilu.org#25972,"TEGAL ALUR, KALIDERES, JAKARTA BARAT, DKI JAKARTA",35,132,83,215
https://kawalpemilu.org#25972,"TEGAL ALUR, KALIDERES, JAKARTA BARAT, DKI JAKARTA",36,109,96,205
https://kawalpemilu.org#25972,"TEGAL ALUR, KALIDERES, JAKARTA BARAT, DKI JAKARTA",37,122,92,214
https://kawalpemilu.org#25972,"TEGAL ALUR, KALIDERES, JAKARTA BARAT, DKI JAKARTA",38,112,71,183
https://kawalpemilu.org#25972,"TEGAL ALUR, KALIDERES, JAKARTA BARAT, DKI JAKARTA",39,107,54,161
https://kawalpemilu.org#25972,"TEGAL ALUR, KALIDERES, JAKARTA BARAT, DKI JAKARTA",40,125,71,196
https://kawalpemilu.org#25972,"TEGAL ALUR, KALIDERES, JAKARTA BARAT, DKI JAKARTA",41,114,71,185
https://kawalpemilu.org#25972,"TEGAL ALUR, KALIDERES, JAKARTA BARAT, DKI JAKARTA",42,110,63,173
https://kawalpemilu.org#25972,"TEGAL ALUR, KALIDERES, JAKARTA BARAT, DKI JAKARTA",43,123,135,258
https://kawalpemilu.org#25972,"TEGAL ALUR, KALIDERES, JAKARTA BARAT, DKI JAKARTA",44,119,132,251
https://kawalpemilu.org#25972,"TEGAL ALUR, KALIDERES, JAKARTA BARAT, DKI JAKARTA",45,128,81,209
https://kawalpemilu.org#25972,"TEGAL ALUR, KALIDERES, JAKARTA BARAT, DKI JAKARTA",46,113,55,168
https://kawalpemilu.org#25972,"TEGAL ALUR, KALIDERES, JAKARTA BARAT, DKI JAKARTA",47,106,35,141
https://kawalpemilu.org#25972,"TEGAL ALUR, KALIDERES, JAKARTA BARAT, DKI JAKARTA",48,96,80,176
https://kawalpemilu.org#25972,"TEGAL ALUR, KALIDERES, JAKARTA BARAT, DKI JAKARTA",49,88,74,162
https://kawalpemilu.org#25972,"TEGAL ALUR, KALIDERES, JAKARTA BARAT, DKI JAKARTA",50,138,104,242
https://kawalpemilu.org#25972,"TEGAL ALUR, KALIDERES, JAKARTA BARAT, DKI JAKARTA",51,148,107,255
https://kawalpemilu.org#25972,"TEGAL ALUR, KALIDERES, JAKARTA BARAT, DKI JAKARTA",52,81,48,129
https://kawalpemilu.org#25972,"TEGAL ALUR, KALIDERES, JAKARTA BARAT, DKI JAKARTA",53,116,65,181
https://kawalpemilu.org#25972,"TEGAL ALUR, KALIDERES, JAKARTA BARAT, DKI JAKARTA",54,99,47,146
https://kawalpemilu.org#25972,"TEGAL ALUR, KALIDERES, JAKARTA BARAT, DKI JAKARTA",55,68,93,161
https://kawalpemilu.org#25972,"TEGAL ALUR, KALIDERES, JAKARTA BARAT, DKI JAKARTA",56,67,110,177
https://kawalpemilu.org#25972,"TEGAL ALUR, KALIDERES, JAKARTA BARAT, DKI JAKARTA",57,98,80,178
https://kawalpemilu.org#25972,"TEGAL ALUR, KALIDERES, JAKARTA BARAT, DKI JAKARTA",58,70,106,176
https://kawalpemilu.org#25972,"TEGAL ALUR, KALIDERES, JAKARTA BARAT, DKI JAKARTA",59,91,100,191
https://kawalpemilu.org#25972,"TEGAL ALUR, KALIDERES, JAKARTA BARAT, DKI JAKARTA",60,99,113,212
https://kawalpemilu.org#25972,"TEGAL ALUR, KALIDERES, JAKARTA BARAT, DKI JAKARTA",61,81,126,207
https://kawalpemilu.org#25972,"TEGAL ALUR, KALIDERES, JAKARTA BARAT, DKI JAKARTA",62,73,89,162
https://kawalpemilu.org#25972,"TEGAL ALUR, KALIDERES, JAKARTA BARAT, DKI JAKARTA",63,126,103,229
https://kawalpemilu.org#25972,"TEGAL ALUR, KALIDERES, JAKARTA BARAT, DKI JAKARTA",64,120,59,179
https://kawalpemilu.org#25972,"TEGAL ALUR, KALIDERES, JAKARTA BARAT, DKI JAKARTA",65,100,112,212
https://kawalpemilu.org#25972,"TEGAL ALUR, KALIDERES, JAKARTA BARAT, DKI JAKARTA",66,70,88,158
https://kawalpemilu.org#25972,"TEGAL ALUR, KALIDERES, JAKARTA BARAT, DKI JAKARTA",67,84,145,229
https://kawalpemilu.org#25972,"TEGAL ALUR, KALIDERES, JAKARTA BARAT, DKI JAKARTA",68,91,83,174
https://kawalpemilu.org#25972,"TEGAL ALUR, KALIDERES, JAKARTA BARAT, DKI JAKARTA",69,76,90,166
https://kawalpemilu.org#25972,"TEGAL ALUR, KALIDERES, JAKARTA BARAT, DKI JAKARTA",70,64,119,183
https://kawalpemilu.org#25972,"TEGAL ALUR, KALIDERES, JAKARTA BARAT, DKI JAKARTA",71,70,107,177
https://kawalpemilu.org#25972,"TEGAL ALUR, KALIDERES, JAKARTA BARAT, DKI JAKARTA",72,96,153,249
https://kawalpemilu.org#25972,"TEGAL ALUR, KALIDERES, JAKARTA BARAT, DKI JAKARTA",73,135,106,241
https://kawalpemilu.org#25972,"TEGAL ALUR, KALIDERES, JAKARTA BARAT, DKI JAKARTA",75,100,128,228
https://kawalpemilu.org#25972,"TEGAL ALUR, KALIDERES, JAKARTA BARAT, DKI JAKARTA",76,59,130,189
https://kawalpemilu.org#25972,"TEGAL ALUR, KALIDERES, JAKARTA BARAT, DKI JAKARTA",77,55,100,155
https://kawalpemilu.org#25972,"TEGAL ALUR, KALIDERES, JAKARTA BARAT, DKI JAKARTA",78,78,115,193
https://kawalpemilu.org#25972,"TEGAL ALUR, KALIDERES, JAKARTA BARAT, DKI JAKARTA",79,95,112,207
https://kawalpemilu.org#25972,"TEGAL ALUR, KALIDERES, JAKARTA BARAT, DKI JAKARTA",80,83,126,209
https://kawalpemilu.org#25972,"TEGAL ALUR, KALIDERES, JAKARTA BARAT, DKI JAKARTA",81,126,54,180
https://kawalpemilu.org#25972,"TEGAL ALUR, KALIDERES, JAKARTA BARAT, DKI JAKARTA",82,150,45,195
https://kawalpemilu.org#25972,"TEGAL ALUR, KALIDERES, JAKARTA BARAT, DKI JAKARTA",83,141,18,159
https://kawalpemilu.org#25972,"TEGAL ALUR, KALIDERES, JAKARTA BARAT, DKI JAKARTA",84,164,27,191
https://kawalpemilu.org#25972,"TEGAL ALUR, KALIDERES, JAKARTA BARAT, DKI JAKARTA",85,180,33,213
https://kawalpemilu.org#25972,"TEGAL ALUR, KALIDERES, JAKARTA BARAT, DKI JAKARTA",86,173,66,239
https://kawalpemilu.org#25972,"TEGAL ALUR, KALIDERES, JAKARTA BARAT, DKI JAKARTA",87,150,59,209
https://kawalpemilu.org#25972,"TEGAL ALUR, KALIDERES, JAKARTA BARAT, DKI JAKARTA",89,162,44,206
https://kawalpemilu.org#25972,"TEGAL ALUR, KALIDERES, JAKARTA BARAT, DKI JAKARTA",90,158,85,243
https://kawalpemilu.org#25972,"TEGAL ALUR, KALIDERES, JAKARTA BARAT, DKI JAKARTA",91,145,67,212
https://kawalpemilu.org#25972,"TEGAL ALUR, KALIDERES, JAKARTA BARAT, DKI JAKARTA",92,158,52,210
https://kawalpemilu.org#25972,"TEGAL ALUR, KALIDERES, JAKARTA BARAT, DKI JAKARTA",93,134,80,214
https://kawalpemilu.org#25972,"TEGAL ALUR, KALIDERES, JAKARTA BARAT, DKI JAKARTA",94,135,84,219
https://kawalpemilu.org#25972,"TEGAL ALUR, KALIDERES, JAKARTA BARAT, DKI JAKARTA",95,142,51,193
https://kawalpemilu.org#25972,"TEGAL ALUR, KALIDERES, JAKARTA BARAT, DKI JAKARTA",96,156,75,231
https://kawalpemilu.org#25972,"TEGAL ALUR, KALIDERES, JAKARTA BARAT, DKI JAKARTA",97,124,88,212
https://kawalpemilu.org#25972,"TEGAL ALUR, KALIDERES, JAKARTA BARAT, DKI JAKARTA",98,118,125,243
https://kawalpemilu.org#25972,"TEGAL ALUR, KALIDERES, JAKARTA BARAT, DKI JAKARTA",99,126,91,217
https://kawalpemilu.org#25972,"TEGAL ALUR, KALIDERES, JAKARTA BARAT, DKI JAKARTA",100,117,85,202
https://kawalpemilu.org#25972,"TEGAL ALUR, KALIDERES, JAKARTA BARAT, DKI JAKARTA",101,151,107,258
https://kawalpemilu.org#25972,"TEGAL ALUR, KALIDERES, JAKARTA BARAT, DKI JAKARTA",102,107,85,192
https://kawalpemilu.org#25972,"TEGAL ALUR, KALIDERES, JAKARTA BARAT, DKI JAKARTA",103,192,1,193
https://kawalpemilu.org#25972,"TEGAL ALUR, KALIDERES, JAKARTA BARAT, DKI JAKARTA",104,198,4,202
https://kawalpemilu.org#25972,"TEGAL ALUR, KALIDERES, JAKARTA BARAT, DKI JAKARTA",106,194,23,217
https://kawalpemilu.org#25972,"TEGAL ALUR, KALIDERES, JAKARTA BARAT, DKI JAKARTA",107,156,55,211
https://kawalpemilu.org#25972,"TEGAL ALUR, KALIDERES, JAKARTA BARAT, DKI JAKARTA",108,143,90,233
https://kawalpemilu.org#25972,"TEGAL ALUR, KALIDERES, JAKARTA BARAT, DKI JAKARTA",109,95,71,169
https://kawalpemilu.org#25972,"TEGAL ALUR, KALIDERES, JAKARTA BARAT, DKI JAKARTA",110,128,47,175
https://kawalpemilu.org#25972,"TEGAL ALUR, KALIDERES, JAKARTA BARAT, DKI JAKARTA",111,135,89,224
https://kawalpemilu.org#25972,"TEGAL ALUR, KALIDERES, JAKARTA BARAT, DKI JAKARTA",112,129,42,171
https://kawalpemilu.org#25972,"TEGAL ALUR, KALIDERES, JAKARTA BARAT, DKI JAKARTA",113,151,34,185
https://kawalpemilu.org#25972,"TEGAL ALUR, KALIDERES, JAKARTA BARAT, DKI JAKARTA",114,162,35,197
https://kawalpemilu.org#25972,"TEGAL ALUR, KALIDERES, JAKARTA BARAT, DKI JAKARTA",115,162,27,189
https://kawalpemilu.org#25972,"TEGAL ALUR, KALIDERES, JAKARTA BARAT, DKI JAKARTA",116,183,34,217
https://kawalpemilu.org#25972,"TEGAL ALUR, KALIDERES, JAKARTA BARAT, DKI JAKARTA",117,192,40,232
https://kawalpemilu.org#25972,"TEGAL ALUR, KALIDERES, JAKARTA BARAT, DKI JAKARTA",118,194,60,254
https://kawalpemilu.org#25972,"TEGAL ALUR, KALIDERES, JAKARTA BARAT, DKI JAKARTA",119,192,67,259
https://kawalpemilu.org#25972,"TEGAL ALUR, KALIDERES, JAKARTA BARAT, DKI JAKARTA",120,135,53,188
https://kawalpemilu.org#25972,"TEGAL ALUR, KALIDERES, JAKARTA BARAT, DKI JAKARTA",121,154,43,197
https://kawalpemilu.org#25972,"TEGAL ALUR, KALIDERES, JAKARTA BARAT, DKI JAKARTA",122,159,52,211
https://kawalpemilu.org#25972,"TEGAL ALUR, KALIDERES, JAKARTA BARAT, DKI JAKARTA",123,177,23,200
https://kawalpemilu.org#25972,"TEGAL ALUR, KALIDERES, JAKARTA BARAT, DKI JAKARTA",124,156,47,203
https://kawalpemilu.org#25972,"TEGAL ALUR, KALIDERES, JAKARTA BARAT, DKI JAKARTA",125,177,37,214
https://kawalpemilu.org#25972,"TEGAL ALUR, KALIDERES, JAKARTA BARAT, DKI JAKARTA",126,165,51,216
https://kawalpemilu.org#25972,"TEGAL ALUR, KALIDERES, JAKARTA BARAT, DKI JAKARTA",127,187,38,225
https://kawalpemilu.org#25972,"TEGAL ALUR, KALIDERES, JAKARTA BARAT, DKI JAKARTA",128,180,42,222
https://kawalpemilu.org#25972,"TEGAL ALUR, KALIDERES, JAKARTA BARAT, DKI JAKARTA",129,184,26,210
https://kawalpemilu.org#25972,"TEGAL ALUR, KALIDERES, JAKARTA BARAT, DKI JAKARTA",130,185,61,246
https://kawalpemilu.org#25972,"TEGAL ALUR, KALIDERES, JAKARTA BARAT, DKI JAKARTA",131,203,44,247
https://kawalpemilu.org#25972,"TEGAL ALUR, KALIDERES, JAKARTA BARAT, DKI JAKARTA",132,179,14,193
https://kawalpemilu.org#25972,"TEGAL ALUR, KALIDERES, JAKARTA BARAT, DKI JAKARTA",133,186,12,198
https://kawalpemilu.org#25972,"TEGAL ALUR, KALIDERES, JAKARTA BARAT, DKI JAKARTA",134,176,65,241
https://kawalpemilu.org#25972,"TEGAL ALUR, KALIDERES, JAKARTA BARAT, DKI JAKARTA",135,181,44,225
https://kawalpemilu.org#25972,"TEGAL ALUR, KALIDERES, JAKARTA BARAT, DKI JAKARTA",136,176,27,203
https://kawalpemilu.org#25972,"TEGAL ALUR, KALIDERES, JAKARTA BARAT, DKI JAKARTA",137,122,27,149
https://kawalpemilu.org#25972,"TEGAL ALUR, KALIDERES, JAKARTA BARAT, DKI JAKARTA",138,126,47,173
https://kawalpemilu.org#25972,"TEGAL ALUR, KALIDERES, JAKARTA BARAT, DKI JAKARTA",139,184,63,247
https://kawalpemilu.org#25972,"TEGAL ALUR, KALIDERES, JAKARTA BARAT, DKI JAKARTA",140,107,98,205
https://kawalpemilu.org#25972,"TEGAL ALUR, KALIDERES, JAKARTA BARAT, DKI JAKARTA",141,116,90,206
https://kawalpemilu.org#25972,"TEGAL ALUR, KALIDERES, JAKARTA BARAT, DKI JAKARTA",142,104,91,195
https://kawalpemilu.org#25972,"TEGAL ALUR, KALIDERES, JAKARTA BARAT, DKI JAKARTA",143,94,102,196
https://kawalpemilu.org#25972,"TEGAL ALUR, KALIDERES, JAKARTA BARAT, DKI JAKARTA",144,103,83,186
https://kawalpemilu.org#25972,"TEGAL ALUR, KALIDERES, JAKARTA BARAT, DKI JAKARTA",145,108,73,181
https://kawalpemilu.org#25972,"TEGAL ALUR, KALIDERES, JAKARTA BARAT, DKI JAKARTA",146,86,81,167
https://kawalpemilu.org#25972,"TEGAL ALUR, KALIDERES, JAKARTA BARAT, DKI JAKARTA",147,112,84,196
https://kawalpemilu.org#25972,"TEGAL ALUR, KALIDERES, JAKARTA BARAT, DKI JAKARTA",148,91,101,192
https://kawalpemilu.org#25972,"TEGAL ALUR, KALIDERES, JAKARTA BARAT, DKI JAKARTA",149,76,112,188
https://kawalpemilu.org#25972,"TEGAL ALUR, KALIDERES, JAKARTA BARAT, DKI JAKARTA",150,78,102,180
https://kawalpemilu.org#25972,"TEGAL ALUR, KALIDERES, JAKARTA BARAT, DKI JAKARTA",151,125,85,210
https://kawalpemilu.org#25972,"TEGAL ALUR, KALIDERES, JAKARTA BARAT, DKI JAKARTA",152,104,79,183
https://kawalpemilu.org#25972,"TEGAL ALUR, KALIDERES, JAKARTA BARAT, DKI JAKARTA",153,84,104,188
https://kawalpemilu.org#25972,"TEGAL ALUR, KALIDERES, JAKARTA BARAT, DKI JAKARTA",154,99,112,211
https://kawalpemilu.org#25972,"TEGAL ALUR, KALIDERES, JAKARTA BARAT, DKI JAKARTA",155,94,79,173
https://kawalpemilu.org#25972,"TEGAL ALUR, KALIDERES, JAKARTA BARAT, DKI JAKARTA",156,66,98,164
https://kawalpemilu.org#25972,"TEGAL ALUR, KALIDERES, JAKARTA BARAT, DKI JAKARTA",157,96,87,183
https://kawalpemilu.org#25972,"TEGAL ALUR, KALIDERES, JAKARTA BARAT, DKI JAKARTA",158,87,77,164
https://kawalpemilu.org#25972,"TEGAL ALUR, KALIDERES, JAKARTA BARAT, DKI JAKARTA",159,138,107,245
https://kawalpemilu.org#25972,"TEGAL ALUR, KALIDERES, JAKARTA BARAT, DKI JAKARTA",160,113,100,213
https://kawalpemilu.org#25972,"TEGAL ALUR, KALIDERES, JAKARTA BARAT, DKI JAKARTA",161,164,67,231
https://kawalpemilu.org#25972,"TEGAL ALUR, KALIDERES, JAKARTA BARAT, DKI JAKARTA",162,85,119,204
https://kawalpemilu.org#25972,"TEGAL ALUR, KALIDERES, JAKARTA BARAT, DKI JAKARTA",163,83,104,187
https://kawalpemilu.org#25972,"TEGAL ALUR, KALIDERES, JAKARTA BARAT, DKI JAKARTA",164,142,58,200
https://kawalpemilu.org#25972,"TEGAL ALUR, KALIDERES, JAKARTA BARAT, DKI JAKARTA",165,169,51,220
https://kawalpemilu.org#25972,"TEGAL ALUR, KALIDERES, JAKARTA BARAT, DKI JAKARTA",166,158,56,214
https://kawalpemilu.org#25972,"TEGAL ALUR, KALIDERES, JAKARTA BARAT, DKI JAKARTA",167,175,58,233
https://kawalpemilu.org#25972,"TEGAL ALUR, KALIDERES, JAKARTA BARAT, DKI JAKARTA",168,141,73,214
https://kawalpemilu.org#25972,"TEGAL ALUR, KALIDERES, JAKARTA BARAT, DKI JAKARTA",169,147,75,222
https://kawalpemilu.org#25972,"TEGAL ALUR, KALIDERES, JAKARTA BARAT, DKI JAKARTA",170,178,51,229
https://kawalpemilu.org#25972,"TEGAL ALUR, KALIDERES, JAKARTA BARAT, DKI JAKARTA",171,175,72,247
https://kawalpemilu.org#25972,"TEGAL ALUR, KALIDERES, JAKARTA BARAT, DKI JAKARTA",172,182,58,240
https://kawalpemilu.org#25972,"TEGAL ALUR, KALIDERES, JAKARTA BARAT, DKI JAKARTA",173,188,39,227
https://kawalpemilu.org#25972,"TEGAL ALUR, KALIDERES, JAKARTA BARAT, DKI JAKARTA",174,213,24,237
https://kawalpemilu.org#25972,"TEGAL ALUR, KALIDERES, JAKARTA BARAT, DKI JAKARTA",175,180,26,206
https://kawalpemilu.org#25972,"TEGAL ALUR, KALIDERES, JAKARTA BARAT, DKI JAKARTA",176,153,60,213
https://kawalpemilu.org#25972,"TEGAL ALUR, KALIDERES, JAKARTA BARAT, DKI JAKARTA",177,126,56,181
https://kawalpemilu.org#25972,"TEGAL ALUR, KALIDERES, JAKARTA BARAT, DKI JAKARTA",178,166,64,230
https://kawalpemilu.org#25972,"TEGAL ALUR, KALIDERES, JAKARTA BARAT, DKI JAKARTA",179,121,109,230
https://kawalpemilu.org#25972,"TEGAL ALUR, KALIDERES, JAKARTA BARAT, DKI JAKARTA",180,131,109,240
https://kawalpemilu.org#25972,"TEGAL ALUR, KALIDERES, JAKARTA BARAT, DKI JAKARTA",181,168,89,257
https://kawalpemilu.org#25972,"TEGAL ALUR, KALIDERES, JAKARTA BARAT, DKI JAKARTA",182,177,59,236
https://kawalpemilu.org#25972,"TEGAL ALUR, KALIDERES, JAKARTA BARAT, DKI JAKARTA",183,172,70,242
https://kawalpemilu.org#25972,"TEGAL ALUR, KALIDERES, JAKARTA BARAT, DKI JAKARTA",184,136,51,187
https://kawalpemilu.org#25972,"TEGAL ALUR, KALIDERES, JAKARTA BARAT, DKI JAKARTA",185,115,62,177
https://kawalpemilu.org#25972,"TEGAL ALUR, KALIDERES, JAKARTA BARAT, DKI JAKARTA",186,123,57,180
https://kawalpemilu.org#25972,"TEGAL ALUR, KALIDERES, JAKARTA BARAT, DKI JAKARTA",187,123,88,211
https://kawalpemilu.org#25972,"TEGAL ALUR, KALIDERES, JAKARTA BARAT, DKI JAKARTA",188,104,91,195
https://kawalpemilu.org#25972,"TEGAL ALUR, KALIDERES, JAKARTA BARAT, DKI JAKARTA",189,98,111,209
https://kawalpemilu.org#25972,"TEGAL ALUR, KALIDERES, JAKARTA BARAT, DKI JAKARTA",190,113,63,176
https://kawalpemilu.org#25972,"TEGAL ALUR, KALIDERES, JAKARTA BARAT, DKI JAKARTA",191,140,75,215
https://kawalpemilu.org#25972,"TEGAL ALUR, KALIDERES, JAKARTA BARAT, DKI JAKARTA",192,111,73,184
https://kawalpemilu.org#25972,"TEGAL ALUR, KALIDERES, JAKARTA BARAT, DKI JAKARTA",193,97,74,171
https://kawalpemilu.org#25972,"TEGAL ALUR, KALIDERES, JAKARTA BARAT, DKI JAKARTA",194,110,71,181
https://kawalpemilu.org#25972,"TEGAL ALUR, KALIDERES, JAKARTA BARAT, DKI JAKARTA",195,212,98,219
https://kawalpemilu.org#25972,"TEGAL ALUR, KALIDERES, JAKARTA BARAT, DKI JAKARTA",196,117,99,216
https://kawalpemilu.org#25972,"TEGAL ALUR, KALIDERES, JAKARTA BARAT, DKI JAKARTA",197,116,92,208
https://kawalpemilu.org#25972,"TEGAL ALUR, KALIDERES, JAKARTA BARAT, DKI JAKARTA",198,137,87,224
https://kawalpemilu.org#25972,"TEGAL ALUR, KALIDERES, JAKARTA BARAT, DKI JAKARTA",199,127,81,208
https://kawalpemilu.org#25972,"TEGAL ALUR, KALIDERES, JAKARTA BARAT, DKI JAKARTA",200,137,76,213
https://kawalpemilu.org#25972,"TEGAL ALUR, KALIDERES, JAKARTA BARAT, DKI JAKARTA",201,101,69,170
https://kawalpemilu.org#25972,"TEGAL ALUR, KALIDERES, JAKARTA BARAT, DKI JAKARTA",202,141,80,221
https://kawalpemilu.org#25972,"TEGAL ALUR, KALIDERES, JAKARTA BARAT, DKI JAKARTA",203,164,44,208
https://kawalpemilu.org#25972,"TEGAL ALUR, KALIDERES, JAKARTA BARAT, DKI JAKARTA",204,116,51,167
https://kawalpemilu.org#25972,"TEGAL ALUR, KALIDERES, JAKARTA BARAT, DKI JAKARTA",205,122,49,171
https://kawalpemilu.org#25972,"TEGAL ALUR, KALIDERES, JAKARTA BARAT, DKI JAKARTA",206,126,37,163
https://kawalpemilu.org#25972,"TEGAL ALUR, KALIDERES, JAKARTA BARAT, DKI JAKARTA",207,141,42,183
https://kawalpemilu.org#25972,"TEGAL ALUR, KALIDERES, JAKARTA BARAT, DKI JAKARTA",208,114,45,159
https://kawalpemilu.org#25972,"TEGAL ALUR, KALIDERES, JAKARTA BARAT, DKI JAKARTA",209,160,52,212
https://kawalpemilu.org#25972,"TEGAL ALUR, KALIDERES, JAKARTA BARAT, DKI JAKARTA",210,103,41,144
https://kawalpemilu.org#25972,"TEGAL ALUR, KALIDERES, JAKARTA BARAT, DKI JAKARTA",211,168,50,218
https://kawalpemilu.org#25972,"TEGAL ALUR, KALIDERES, JAKARTA BARAT, DKI JAKARTA",212,200,48,248
https://kawalpemilu.org#25972,"TEGAL ALUR, KALIDERES, JAKARTA BARAT, DKI JAKARTA",213,127,91,218
https://kawalpemilu.org#25972,"TEGAL ALUR, KALIDERES, JAKARTA BARAT, DKI JAKARTA",214,128,55,183
https://kawalpemilu.org#25972,"TEGAL ALUR, KALIDERES, JAKARTA BARAT, DKI JAKARTA",215,116,56,172
https://kawalpemilu.org#25972,"TEGAL ALUR, KALIDERES, JAKARTA BARAT, DKI JAKARTA",216,122,77,199
https://kawalpemilu.org#25972,"TEGAL ALUR, KALIDERES, JAKARTA BARAT, DKI JAKARTA",217,123,72,195
https://kawalpemilu.org#25972,"TEGAL ALUR, KALIDERES, JAKARTA BARAT, DKI JAKARTA",218,176,38,214
https://kawalpemilu.org#25972,"TEGAL ALUR, KALIDERES, JAKARTA BARAT, DKI JAKARTA",219,166,57,223
https://kawalpemilu.org#25972,"TEGAL ALUR, KALIDERES, JAKARTA BARAT, DKI JAKARTA",220,186,49,235
https://kawalpemilu.org#25972,"TEGAL ALUR, KALIDERES, JAKARTA BARAT, DKI JAKARTA",221,178,90,268
https://kawalpemilu.org#25972,"TEGAL ALUR, KALIDERES, JAKARTA BARAT, DKI JAKARTA",222,96,89,185
https://kawalpemilu.org#25972,"TEGAL ALUR, KALIDERES, JAKARTA BARAT, DKI JAKARTA",223,110,84,194
https://kawalpemilu.org#25972,"TEGAL ALUR, KALIDERES, JAKARTA BARAT, DKI JAKARTA",224,93,77,170
https://kawalpemilu.org#25972,"TEGAL ALUR, KALIDERES, JAKARTA BARAT, DKI JAKARTA",225,86,123,209
https://kawalpemilu.org#25972,"TEGAL ALUR, KALIDERES, JAKARTA BARAT, DKI JAKARTA",226,88,107,195
https://kawalpemilu.org#25972,"TEGAL ALUR, KALIDERES, JAKARTA BARAT, DKI JAKARTA",227,53,118,171
https://kawalpemilu.org#25972,"TEGAL ALUR, KALIDERES, JAKARTA BARAT, DKI JAKARTA",228,69,119,188
https://kawalpemilu.org#25972,"TEGAL ALUR, KALIDERES, JAKARTA BARAT, DKI JAKARTA",229,93,120,213
https://kawalpemilu.org#25972,"TEGAL ALUR, KALIDERES, JAKARTA BARAT, DKI JAKARTA",230,86,127,213
https://kawalpemilu.org#25972,"TEGAL ALUR, KALIDERES, JAKARTA BARAT, DKI JAKARTA",231,104,118,222
https://kawalpemilu.org#25972,"TEGAL ALUR, KALIDERES, JAKARTA BARAT, DKI JAKARTA",232,72,116,188
https://kawalpemilu.org#25972,"TEGAL ALUR, KALIDERES, JAKARTA BARAT, DKI JAKARTA",233,81,81,162
https://kawalpemilu.org#25972,"TEGAL ALUR, KALIDERES, JAKARTA BARAT, DKI JAKARTA",234,84,81,165
https://kawalpemilu.org#25972,"TEGAL ALUR, KALIDERES, JAKARTA BARAT, DKI JAKARTA",235,102,110,212
https://kawalpemilu.org#25972,"TEGAL ALUR, KALIDERES, JAKARTA BARAT, DKI JAKARTA",236,121,87,208
https://kawalpemilu.org#25972,"TEGAL ALUR, KALIDERES, JAKARTA BARAT, DKI JAKARTA",237,124,65,189
https://kawalpemilu.org#25972,"TEGAL ALUR, KALIDERES, JAKARTA BARAT, DKI JAKARTA",238,104,117,221
https://kawalpemilu.org#25972,"TEGAL ALUR, KALIDERES, JAKARTA BARAT, DKI JAKARTA",239,102,141,243
https://kawalpemilu.org#25972,"TEGAL ALUR, KALIDERES, JAKARTA BARAT, DKI JAKARTA",240,109,179,288
https://kawalpemilu.org#25972,"TEGAL ALUR, KALIDERES, JAKARTA BARAT, DKI JAKARTA",241,102,92,194
https://kawalpemilu.org#25972,"TEGAL ALUR, KALIDERES, JAKARTA BARAT, DKI JAKARTA",242,120,88,208
https://kawalpemilu.org#25972,"TEGAL ALUR, KALIDERES, JAKARTA BARAT, DKI JAKARTA",243,141,81,222
https://kawalpemilu.org#25972,"TEGAL ALUR, KALIDERES, JAKARTA BARAT, DKI JAKARTA",244,135,82,217
https://kawalpemilu.org#25972,"TEGAL ALUR, KALIDERES, JAKARTA BARAT, DKI JAKARTA",245,90,135,225
https://kawalpemilu.org#25972,"TEGAL ALUR, KALIDERES, JAKARTA BARAT, DKI JAKARTA",246,111,100,211
https://kawalpemilu.org#25972,"TEGAL ALUR, KALIDERES, JAKARTA BARAT, DKI JAKARTA",247,137,72,209
https://kawalpemilu.org#25972,"TEGAL ALUR, KALIDERES, JAKARTA BARAT, DKI JAKARTA",248,121,97,218
https://kawalpemilu.org#25972,"TEGAL ALUR, KALIDERES, JAKARTA BARAT, DKI JAKARTA",249,118,105,223
https://kawalpemilu.org#25972,"TEGAL ALUR, KALIDERES, JAKARTA BARAT, DKI JAKARTA",250,138,63,201
https://kawalpemilu.org#25972,"TEGAL ALUR, KALIDERES, JAKARTA BARAT, DKI JAKARTA",251,120,114,234
https://kawalpemilu.org#25972,"TEGAL ALUR, KALIDERES, JAKARTA BARAT, DKI JAKARTA",252,121,90,211
https://kawalpemilu.org#25972,"TEGAL ALUR, KALIDERES, JAKARTA BARAT, DKI JAKARTA",253,134,93,227
https://kawalpemilu.org#25972,"TEGAL ALUR, KALIDERES, JAKARTA BARAT, DKI JAKARTA",254,96,67,163
https://kawalpemilu.org#25972,"TEGAL ALUR, KALIDERES, JAKARTA BARAT, DKI JAKARTA",255,106,58,164
https://kawalpemilu.org#25972,"TEGAL ALUR, KALIDERES, JAKARTA BARAT, DKI JAKARTA",256,87,103,190
https://kawalpemilu.org#25972,"TEGAL ALUR, KALIDERES, JAKARTA BARAT, DKI JAKARTA",257,197,0,197
https://kawalpemilu.org#25972,"TEGAL ALUR, KALIDERES, JAKARTA BARAT, DKI JAKARTA",258,217,3,220
https://kawalpemilu.org#25972,"TEGAL ALUR, KALIDERES, JAKARTA BARAT, DKI JAKARTA",259,175,6,181
https://kawalpemilu.org#25972,"TEGAL ALUR, KALIDERES, JAKARTA BARAT, DKI JAKARTA",260,227,4,231
https://kawalpemilu.org#25972,"TEGAL ALUR, KALIDERES, JAKARTA BARAT, DKI JAKARTA",261,121,85,206
https://kawalpemilu.org#25972,"TEGAL ALUR, KALIDERES, JAKARTA BARAT, DKI JAKARTA",262,112,102,214
https://kawalpemilu.org#25972,"TEGAL ALUR, KALIDERES, JAKARTA BARAT, DKI JAKARTA",263,89,120,209
https://kawalpemilu.org#25972,"TEGAL ALUR, KALIDERES, JAKARTA BARAT, DKI JAKARTA",264,116,106,222
https://kawalpemilu.org#25972,"TEGAL ALUR, KALIDERES, JAKARTA BARAT, DKI JAKARTA",265,95,58,153
https://kawalpemilu.org#25972,"TEGAL ALUR, KALIDERES, JAKARTA BARAT, DKI JAKARTA",266,115,85,200
https://kawalpemilu.org#25972,"TEGAL ALUR, KALIDERES, JAKARTA BARAT, DKI JAKARTA",267,126,72,198
https://kawalpemilu.org#25972,"TEGAL ALUR, KALIDERES, JAKARTA BARAT, DKI JAKARTA",268,142,53,195
https://kawalpemilu.org#25972,"TEGAL ALUR, KALIDERES, JAKARTA BARAT, DKI JAKARTA",269,121,56,177
https://kawalpemilu.org#25972,"TEGAL ALUR, KALIDERES, JAKARTA BARAT, DKI JAKARTA",270,122,57,179
https://kawalpemilu.org#25972,"TEGAL ALUR, KALIDERES, JAKARTA BARAT, DKI JAKARTA",271,154,78,232
https://kawalpemilu.org#25972,"TEGAL ALUR, KALIDERES, JAKARTA BARAT, DKI JAKARTA",272,119,51,170
https://kawalpemilu.org#25972,"TEGAL ALUR, KALIDERES, JAKARTA BARAT, DKI JAKARTA",273,124,53,177
https://kawalpemilu.org#25972,"TEGAL ALUR, KALIDERES, JAKARTA BARAT, DKI JAKARTA",274,140,40,180
https://kawalpemilu.org#25972,"TEGAL ALUR, KALIDERES, JAKARTA BARAT, DKI JAKARTA",275,106,80,186
https://kawalpemilu.org#25972,"TEGAL ALUR, KALIDERES, JAKARTA BARAT, DKI JAKARTA",276,98,82,180
https://kawalpemilu.org#25972,"TEGAL ALUR, KALIDERES, JAKARTA BARAT, DKI JAKARTA",277,115,66,181
https://kawalpemilu.org#25972,"TEGAL ALUR, KALIDERES, JAKARTA BARAT, DKI JAKARTA",278,126,56,182
https://kawalpemilu.org#25972,"TEGAL ALUR, KALIDERES, JAKARTA BARAT, DKI JAKARTA",279,124,61,185
https://kawalpemilu.org#25972,"TEGAL ALUR, KALIDERES, JAKARTA BARAT, DKI JAKARTA",280,125,59,184
https://kawalpemilu.org#25972,"TEGAL ALUR, KALIDERES, JAKARTA BARAT, DKI JAKARTA",281,200,2,202
https://kawalpemilu.org#25972,"TEGAL ALUR, KALIDERES, JAKARTA BARAT, DKI JAKARTA",282,189,1,190
https://kawalpemilu.org#25972,"TEGAL ALUR, KALIDERES, JAKARTA BARAT, DKI JAKARTA",283,188,12,200
https://kawalpemilu.org#25973,"KAMAL, KALIDERES, JAKARTA BARAT, DKI JAKARTA",1,97,57,154
https://kawalpemilu.org#25973,"KAMAL, KALIDERES, JAKARTA BARAT, DKI JAKARTA",2,58,107,165
https://kawalpemilu.org#25973,"KAMAL, KALIDERES, JAKARTA BARAT, DKI JAKARTA",3,81,89,170
https://kawalpemilu.org#25973,"KAMAL, KALIDERES, JAKARTA BARAT, DKI JAKARTA",4,96,121,217
https://kawalpemilu.org#25973,"KAMAL, KALIDERES, JAKARTA BARAT, DKI JAKARTA",5,84,95,179
https://kawalpemilu.org#25973,"KAMAL, KALIDERES, JAKARTA BARAT, DKI JAKARTA",6,80,118,198
https://kawalpemilu.org#25973,"KAMAL, KALIDERES, JAKARTA BARAT, DKI JAKARTA",7,99,142,241
https://kawalpemilu.org#25973,"KAMAL, KALIDERES, JAKARTA BARAT, DKI JAKARTA",8,92,117,209
https://kawalpemilu.org#25973,"KAMAL, KALIDERES, JAKARTA BARAT, DKI JAKARTA",9,73,155,228
https://kawalpemilu.org#25973,"KAMAL, KALIDERES, JAKARTA BARAT, DKI JAKARTA",10,78,111,189
https://kawalpemilu.org#25973,"KAMAL, KALIDERES, JAKARTA BARAT, DKI JAKARTA",11,78,118,196
https://kawalpemilu.org#25973,"KAMAL, KALIDERES, JAKARTA BARAT, DKI JAKARTA",12,76,95,171
https://kawalpemilu.org#25973,"KAMAL, KALIDERES, JAKARTA BARAT, DKI JAKARTA",13,61,75,136
https://kawalpemilu.org#25973,"KAMAL, KALIDERES, JAKARTA BARAT, DKI JAKARTA",14,130,138,268
https://kawalpemilu.org#25973,"KAMAL, KALIDERES, JAKARTA BARAT, DKI JAKARTA",15,90,124,214
https://kawalpemilu.org#25973,"KAMAL, KALIDERES, JAKARTA BARAT, DKI JAKARTA",16,105,124,229
https://kawalpemilu.org#25973,"KAMAL, KALIDERES, JAKARTA BARAT, DKI JAKARTA",17,140,101,241
https://kawalpemilu.org#25973,"KAMAL, KALIDERES, JAKARTA BARAT, DKI JAKARTA",18,124,110,234
https://kawalpemilu.org#25973,"KAMAL, KALIDERES, JAKARTA BARAT, DKI JAKARTA",19,121,149,270
https://kawalpemilu.org#25973,"KAMAL, KALIDERES, JAKARTA BARAT, DKI JAKARTA",20,102,119,221
https://kawalpemilu.org#25973,"KAMAL, KALIDERES, JAKARTA BARAT, DKI JAKARTA",21,99,81,180
https://kawalpemilu.org#25973,"KAMAL, KALIDERES, JAKARTA BARAT, DKI JAKARTA",22,85,103,188
https://kawalpemilu.org#25973,"KAMAL, KALIDERES, JAKARTA BARAT, DKI JAKARTA",23,68,72,140
https://kawalpemilu.org#25973,"KAMAL, KALIDERES, JAKARTA BARAT, DKI JAKARTA",24,76,106,182
https://kawalpemilu.org#25973,"KAMAL, KALIDERES, JAKARTA BARAT, DKI JAKARTA",25,88,84,172
https://kawalpemilu.org#25973,"KAMAL, KALIDERES, JAKARTA BARAT, DKI JAKARTA",26,89,79,168
https://kawalpemilu.org#25973,"KAMAL, KALIDERES, JAKARTA BARAT, DKI JAKARTA",27,65,102,167
https://kawalpemilu.org#25973,"KAMAL, KALIDERES, JAKARTA BARAT, DKI JAKARTA",28,71,84,155
https://kawalpemilu.org#25973,"KAMAL, KALIDERES, JAKARTA BARAT, DKI JAKARTA",29,64,93,157
https://kawalpemilu.org#25973,"KAMAL, KALIDERES, JAKARTA BARAT, DKI JAKARTA",30,98,114,212
https://kawalpemilu.org#25973,"KAMAL, KALIDERES, JAKARTA BARAT, DKI JAKARTA",31,76,90,166
https://kawalpemilu.org#25973,"KAMAL, KALIDERES, JAKARTA BARAT, DKI JAKARTA",32,85,85,170
https://kawalpemilu.org#25973,"KAMAL, KALIDERES, JAKARTA BARAT, DKI JAKARTA",33,57,54,111
https://kawalpemilu.org#25973,"KAMAL, KALIDERES, JAKARTA BARAT, DKI JAKARTA",34,46,56,102
https://kawalpemilu.org#25973,"KAMAL, KALIDERES, JAKARTA BARAT, DKI JAKARTA",35,88,86,174
https://kawalpemilu.org#25973,"KAMAL, KALIDERES, JAKARTA BARAT, DKI JAKARTA",36,68,88,156
https://kawalpemilu.org#25973,"KAMAL, KALIDERES, JAKARTA BARAT, DKI JAKARTA",37,83,121,204
https://kawalpemilu.org#25973,"KAMAL, KALIDERES, JAKARTA BARAT, DKI JAKARTA",38,72,92,164
https://kawalpemilu.org#25973,"KAMAL, KALIDERES, JAKARTA BARAT, DKI JAKARTA",39,53,84,137
https://kawalpemilu.org#25973,"KAMAL, KALIDERES, JAKARTA BARAT, DKI JAKARTA",40,69,130,199
https://kawalpemilu.org#25973,"KAMAL, KALIDERES, JAKARTA BARAT, DKI JAKARTA",41,64,81,145
https://kawalpemilu.org#25973,"KAMAL, KALIDERES, JAKARTA BARAT, DKI JAKARTA",42,76,89,165
https://kawalpemilu.org#25973,"KAMAL, KALIDERES, JAKARTA BARAT, DKI JAKARTA",44,77,102,179
https://kawalpemilu.org#25973,"KAMAL, KALIDERES, JAKARTA BARAT, DKI JAKARTA",45,85,91,176
https://kawalpemilu.org#25973,"KAMAL, KALIDERES, JAKARTA BARAT, DKI JAKARTA",46,110,69,179
https://kawalpemilu.org#25973,"KAMAL, KALIDERES, JAKARTA BARAT, DKI JAKARTA",47,120,70,190
https://kawalpemilu.org#25973,"KAMAL, KALIDERES, JAKARTA BARAT, DKI JAKARTA",48,100,74,174
https://kawalpemilu.org#25973,"KAMAL, KALIDERES, JAKARTA BARAT, DKI JAKARTA",49,160,106,266
https://kawalpemilu.org#25973,"KAMAL, KALIDERES, JAKARTA BARAT, DKI JAKARTA",50,161,74,235
https://kawalpemilu.org#25973,"KAMAL, KALIDERES, JAKARTA BARAT, DKI JAKARTA",51,159,57,216
https://kawalpemilu.org#25973,"KAMAL, KALIDERES, JAKARTA BARAT, DKI JAKARTA",52,177,48,225
https://kawalpemilu.org#25973,"KAMAL, KALIDERES, JAKARTA BARAT, DKI JAKARTA",53,145,62,207
https://kawalpemilu.org#25973,"KAMAL, KALIDERES, JAKARTA BARAT, DKI JAKARTA",54,151,44,195
https://kawalpemilu.org#25973,"KAMAL, KALIDERES, JAKARTA BARAT, DKI JAKARTA",55,169,35,204
https://kawalpemilu.org#25973,"KAMAL, KALIDERES, JAKARTA BARAT, DKI JAKARTA",56,174,13,187
https://kawalpemilu.org#25973,"KAMAL, KALIDERES, JAKARTA BARAT, DKI JAKARTA",57,151,36,17
https://kawalpemilu.org#25973,"KAMAL, KALIDERES, JAKARTA BARAT, DKI JAKARTA",58,177,36,213
https://kawalpemilu.org#25973,"KAMAL, KALIDERES, JAKARTA BARAT, DKI JAKARTA",59,177,90,267
https://kawalpemilu.org#25973,"KAMAL, KALIDERES, JAKARTA BARAT, DKI JAKARTA",60,170,66,236
https://kawalpemilu.org#25973,"KAMAL, KALIDERES, JAKARTA BARAT, DKI JAKARTA",61,71,89,160
https://kawalpemilu.org#25973,"KAMAL, KALIDERES, JAKARTA BARAT, DKI JAKARTA",62,76,89,165
https://kawalpemilu.org#25973,"KAMAL, KALIDERES, JAKARTA BARAT, DKI JAKARTA",63,70,94,164
https://kawalpemilu.org#25973,"KAMAL, KALIDERES, JAKARTA BARAT, DKI JAKARTA",64,100,88,188
https://kawalpemilu.org#25973,"KAMAL, KALIDERES, JAKARTA BARAT, DKI JAKARTA",65,86,80,166
https://kawalpemilu.org#25973,"KAMAL, KALIDERES, JAKARTA BARAT, DKI JAKARTA",66,108,95,203
https://kawalpemilu.org#25973,"KAMAL, KALIDERES, JAKARTA BARAT, DKI JAKARTA",67,130,100,230
https://kawalpemilu.org#25973,"KAMAL, KALIDERES, JAKARTA BARAT, DKI JAKARTA",68,165,95,260
https://kawalpemilu.org#25973,"KAMAL, KALIDERES, JAKARTA BARAT, DKI JAKARTA",69,120,98,218
https://kawalpemilu.org#25973,"KAMAL, KALIDERES, JAKARTA BARAT, DKI JAKARTA",70,133,101,234
https://kawalpemilu.org#25973,"KAMAL, KALIDERES, JAKARTA BARAT, DKI JAKARTA",71,133,76,209
https://kawalpemilu.org#25973,"KAMAL, KALIDERES, JAKARTA BARAT, DKI JAKARTA",72,103,116,219
https://kawalpemilu.org#25973,"KAMAL, KALIDERES, JAKARTA BARAT, DKI JAKARTA",73,107,160,267
https://kawalpemilu.org#25973,"KAMAL, KALIDERES, JAKARTA BARAT, DKI JAKARTA",74,123,156,279
https://kawalpemilu.org#25973,"KAMAL, KALIDERES, JAKARTA BARAT, DKI JAKARTA",75,106,151,257
https://kawalpemilu.org#25973,"KAMAL, KALIDERES, JAKARTA BARAT, DKI JAKARTA",76,115,161,276
https://kawalpemilu.org#25973,"KAMAL, KALIDERES, JAKARTA BARAT, DKI JAKARTA",77,98,117,215
https://kawalpemilu.org#25973,"KAMAL, KALIDERES, JAKARTA BARAT, DKI JAKARTA",78,89,124,213
https://kawalpemilu.org#25973,"KAMAL, KALIDERES, JAKARTA BARAT, DKI JAKARTA",79,91,97,188
https://kawalpemilu.org#25973,"KAMAL, KALIDERES, JAKARTA BARAT, DKI JAKARTA",80,105,75,180
https://kawalpemilu.org#25973,"KAMAL, KALIDERES, JAKARTA BARAT, DKI JAKARTA",81,118,53,171
https://kawalpemilu.org#25973,"KAMAL, KALIDERES, JAKARTA BARAT, DKI JAKARTA",82,109,73,182
https://kawalpemilu.org#25973,"KAMAL, KALIDERES, JAKARTA BARAT, DKI JAKARTA",83,109,89,198
https://kawalpemilu.org#25973,"KAMAL, KALIDERES, JAKARTA BARAT, DKI JAKARTA",84,118,142,260
https://kawalpemilu.org#25973,"KAMAL, KALIDERES, JAKARTA BARAT, DKI JAKARTA",85,98,76,174
https://kawalpemilu.org#25973,"KAMAL, KALIDERES, JAKARTA BARAT, DKI JAKARTA",86,116,138,254
https://kawalpemilu.org#25973,"KAMAL, KALIDERES, JAKARTA BARAT, DKI JAKARTA",87,111,76,187
https://kawalpemilu.org#25973,"KAMAL, KALIDERES, JAKARTA BARAT, DKI JAKARTA",88,185,61,246
https://kawalpemilu.org#25973,"KAMAL, KALIDERES, JAKARTA BARAT, DKI JAKARTA",89,113,105,218
https://kawalpemilu.org#25973,"KAMAL, KALIDERES, JAKARTA BARAT, DKI JAKARTA",90,98,97,195
https://kawalpemilu.org#25973,"KAMAL, KALIDERES, JAKARTA BARAT, DKI JAKARTA",91,159,107,266
https://kawalpemilu.org#25973,"KAMAL, KALIDERES, JAKARTA BARAT, DKI JAKARTA",92,75,99,174
https://kawalpemilu.org#25973,"KAMAL, KALIDERES, JAKARTA BARAT, DKI JAKARTA",93,93,166,259
https://kawalpemilu.org#25973,"KAMAL, KALIDERES, JAKARTA BARAT, DKI JAKARTA",94,134,129,263
https://kawalpemilu.org#25973,"KAMAL, KALIDERES, JAKARTA BARAT, DKI JAKARTA",95,115,108,223
https://kawalpemilu.org#25973,"KAMAL, KALIDERES, JAKARTA BARAT, DKI JAKARTA",96,101,117,218
https://kawalpemilu.org#25973,"KAMAL, KALIDERES, JAKARTA BARAT, DKI JAKARTA",97,95,161,256
https://kawalpemilu.org#25973,"KAMAL, KALIDERES, JAKARTA BARAT, DKI JAKARTA",98,106,89,195
https://kawalpemilu.org#25973,"KAMAL, KALIDERES, JAKARTA BARAT, DKI JAKARTA",99,114,98,212
https://kawalpemilu.org#25973,"KAMAL, KALIDERES, JAKARTA BARAT, DKI JAKARTA",100,127,73,200
https://kawalpemilu.org#25973,"KAMAL, KALIDERES, JAKARTA BARAT, DKI JAKARTA",101,109,125,234
https://kawalpemilu.org#25973,"KAMAL, KALIDERES, JAKARTA BARAT, DKI JAKARTA",102,114,92,206
https://kawalpemilu.org#25973,"KAMAL, KALIDERES, JAKARTA BARAT, DKI JAKARTA",104,141,109,250
https://kawalpemilu.org#25973,"KAMAL, KALIDERES, JAKARTA BARAT, DKI JAKARTA",105,94,89,183
https://kawalpemilu.org#25973,"KAMAL, KALIDERES, JAKARTA BARAT, DKI JAKARTA",106,125,65,190
https://kawalpemilu.org#25973,"KAMAL, KALIDERES, JAKARTA BARAT, DKI JAKARTA",107,109,88,197
https://kawalpemilu.org#25973,"KAMAL, KALIDERES, JAKARTA BARAT, DKI JAKARTA",108,111,84,195
https://kawalpemilu.org#25973,"KAMAL, KALIDERES, JAKARTA BARAT, DKI JAKARTA",109,109,86,195
https://kawalpemilu.org#25973,"KAMAL, KALIDERES, JAKARTA BARAT, DKI JAKARTA",110,94,64,158
https://kawalpemilu.org#25973,"KAMAL, KALIDERES, JAKARTA BARAT, DKI JAKARTA",111,75,73,148
https://kawalpemilu.org#25973,"KAMAL, KALIDERES, JAKARTA BARAT, DKI JAKARTA",112,118,70,188
https://kawalpemilu.org#25973,"KAMAL, KALIDERES, JAKARTA BARAT, DKI JAKARTA",113,106,94,200
https://kawalpemilu.org#25973,"KAMAL, KALIDERES, JAKARTA BARAT, DKI JAKARTA",114,81,138,219
https://kawalpemilu.org#25973,"KAMAL, KALIDERES, JAKARTA BARAT, DKI JAKARTA",115,141,92,233
https://kawalpemilu.org#25973,"KAMAL, KALIDERES, JAKARTA BARAT, DKI JAKARTA",116,135,93,228
https://kawalpemilu.org#25973,"KAMAL, KALIDERES, JAKARTA BARAT, DKI JAKARTA",117,151,67,218
https://kawalpemilu.org#25973,"KAMAL, KALIDERES, JAKARTA BARAT, DKI JAKARTA",118,90,58,148
https://kawalpemilu.org#25973,"KAMAL, KALIDERES, JAKARTA BARAT, DKI JAKARTA",119,142,73,215
https://kawalpemilu.org#25973,"KAMAL, KALIDERES, JAKARTA BARAT, DKI JAKARTA",120,103,64,167
https://kawalpemilu.org#25973,"KAMAL, KALIDERES, JAKARTA BARAT, DKI JAKARTA",121,157,60,217
https://kawalpemilu.org#25973,"KAMAL, KALIDERES, JAKARTA BARAT, DKI JAKARTA",122,115,40,155
https://kawalpemilu.org#25973,"KAMAL, KALIDERES, JAKARTA BARAT, DKI JAKARTA",123,117,69,186
https://kawalpemilu.org#25973,"KAMAL, KALIDERES, JAKARTA BARAT, DKI JAKARTA",124,134,60,194
https://kawalpemilu.org#25973,"KAMAL, KALIDERES, JAKARTA BARAT, DKI JAKARTA",125,158,59,217
https://kawalpemilu.org#25973,"KAMAL, KALIDERES, JAKARTA BARAT, DKI JAKARTA",126,113,71,184
https://kawalpemilu.org#25973,"KAMAL, KALIDERES, JAKARTA BARAT, DKI JAKARTA",127,129,65,194
https://kawalpemilu.org#25973,"KAMAL, KALIDERES, JAKARTA BARAT, DKI JAKARTA",128,124,60,184
https://kawalpemilu.org#25973,"KAMAL, KALIDERES, JAKARTA BARAT, DKI JAKARTA",129,125,69,194
https://kawalpemilu.org#25973,"KAMAL, KALIDERES, JAKARTA BARAT, DKI JAKARTA",130,111,58,169
https://kawalpemilu.org#25973,"KAMAL, KALIDERES, JAKARTA BARAT, DKI JAKARTA",131,160,71,231
https://kawalpemilu.org#25973,"KAMAL, KALIDERES, JAKARTA BARAT, DKI JAKARTA",132,163,79,242
https://kawalpemilu.org#25973,"KAMAL, KALIDERES, JAKARTA BARAT, DKI JAKARTA",133,144,63,207
https://kawalpemilu.org#25973,"KAMAL, KALIDERES, JAKARTA BARAT, DKI JAKARTA",134,124,76,200
https://kawalpemilu.org#25973,"KAMAL, KALIDERES, JAKARTA BARAT, DKI JAKARTA",135,116,92,208
https://kawalpemilu.org#25973,"KAMAL, KALIDERES, JAKARTA BARAT, DKI JAKARTA",136,110,70,180
https://kawalpemilu.org#25973,"KAMAL, KALIDERES, JAKARTA BARAT, DKI JAKARTA",137,125,66,191
https://kawalpemilu.org#25973,"KAMAL, KALIDERES, JAKARTA BARAT, DKI JAKARTA",138,108,58,166
https://kawalpemilu.org#25973,"KAMAL, KALIDERES, JAKARTA BARAT, DKI JAKARTA",139,97,65,162
https://kawalpemilu.org#25973,"KAMAL, KALIDERES, JAKARTA BARAT, DKI JAKARTA",140,93,151,244
https://kawalpemilu.org#25973,"KAMAL, KALIDERES, JAKARTA BARAT, DKI JAKARTA",141,92,156,248
https://kawalpemilu.org#25973,"KAMAL, KALIDERES, JAKARTA BARAT, DKI JAKARTA",142,82,162,244
https://kawalpemilu.org#25973,"KAMAL, KALIDERES, JAKARTA BARAT, DKI JAKARTA",143,84,159,243
https://kawalpemilu.org#25973,"KAMAL, KALIDERES, JAKARTA BARAT, DKI JAKARTA",144,69,100,169
https://kawalpemilu.org#25973,"KAMAL, KALIDERES, JAKARTA BARAT, DKI JAKARTA",145,71,102,173
https://kawalpemilu.org#25973,"KAMAL, KALIDERES, JAKARTA BARAT, DKI JAKARTA",146,78,105,183
https://kawalpemilu.org#25973,"KAMAL, KALIDERES, JAKARTA BARAT, DKI JAKARTA",147,83,155,238
https://kawalpemilu.org#25973,"KAMAL, KALIDERES, JAKARTA BARAT, DKI JAKARTA",148,75,177,252
https://kawalpemilu.org#25973,"KAMAL, KALIDERES, JAKARTA BARAT, DKI JAKARTA",149,74,166,240
https://kawalpemilu.org#25973,"KAMAL, KALIDERES, JAKARTA BARAT, DKI JAKARTA",150,103,133,236
https://kawalpemilu.org#25973,"KAMAL, KALIDERES, JAKARTA BARAT, DKI JAKARTA",151,108,122,230
https://kawalpemilu.org#25973,"KAMAL, KALIDERES, JAKARTA BARAT, DKI JAKARTA",152,101,108,209
https://kawalpemilu.org#25973,"KAMAL, KALIDERES, JAKARTA BARAT, DKI JAKARTA",153,86,112,198
https://kawalpemilu.org#25973,"KAMAL, KALIDERES, JAKARTA BARAT, DKI JAKARTA",154,63,107,170
https://kawalpemilu.org#25973,"KAMAL, KALIDERES, JAKARTA BARAT, DKI JAKARTA",155,96,80,176
https://kawalpemilu.org#25973,"KAMAL, KALIDERES, JAKARTA BARAT, DKI JAKARTA",156,99,49,148
https://kawalpemilu.org#25973,"KAMAL, KALIDERES, JAKARTA BARAT, DKI JAKARTA",157,109,71,180
https://kawalpemilu.org#25973,"KAMAL, KALIDERES, JAKARTA BARAT, DKI JAKARTA",158,102,81,183
https://kawalpemilu.org#25973,"KAMAL, KALIDERES, JAKARTA BARAT, DKI JAKARTA",160,97,73,170
https://kawalpemilu.org#25973,"KAMAL, KALIDERES, JAKARTA BARAT, DKI JAKARTA",161,121,59,180
https://kawalpemilu.org#25973,"KAMAL, KALIDERES, JAKARTA BARAT, DKI JAKARTA",162,99,117,216
https://kawalpemilu.org#25973,"KAMAL, KALIDERES, JAKARTA BARAT, DKI JAKARTA",163,115,96,211
https://kawalpemilu.org#25973,"KAMAL, KALIDERES, JAKARTA BARAT, DKI JAKARTA",164,116,99,215
https://kawalpemilu.org#25973,"KAMAL, KALIDERES, JAKARTA BARAT, DKI JAKARTA",165,141,102,243
https://kawalpemilu.org#25973,"KAMAL, KALIDERES, JAKARTA BARAT, DKI JAKARTA",166,119,125,244
https://kawalpemilu.org#25973,"KAMAL, KALIDERES, JAKARTA BARAT, DKI JAKARTA",167,105,114,219
https://kawalpemilu.org#25973,"KAMAL, KALIDERES, JAKARTA BARAT, DKI JAKARTA",168,93,103,196
https://kawalpemilu.org#25973,"KAMAL, KALIDERES, JAKARTA BARAT, DKI JAKARTA",169,120,67,187
https://kawalpemilu.org#25973,"KAMAL, KALIDERES, JAKARTA BARAT, DKI JAKARTA",170,116,84,200
https://kawalpemilu.org#25973,"KAMAL, KALIDERES, JAKARTA BARAT, DKI JAKARTA",171,79,195,274
https://kawalpemilu.org#25973,"KAMAL, KALIDERES, JAKARTA BARAT, DKI JAKARTA",172,218,5,223
https://kawalpemilu.org#25973,"KAMAL, KALIDERES, JAKARTA BARAT, DKI JAKARTA",173,205,6,211
https://kawalpemilu.org#25973,"KAMAL, KALIDERES, JAKARTA BARAT, DKI JAKARTA",174,183,3,186
https://kawalpemilu.org#25973,"KAMAL, KALIDERES, JAKARTA BARAT, DKI JAKARTA",175,173,6,179
https://kawalpemilu.org#25973,"KAMAL, KALIDERES, JAKARTA BARAT, DKI JAKARTA",176,148,10,158
https://kawalpemilu.org#25973,"KAMAL, KALIDERES, JAKARTA BARAT, DKI JAKARTA",177,155,3,158
https://kawalpemilu.org#25973,"KAMAL, KALIDERES, JAKARTA BARAT, DKI JAKARTA",178,159,7,166
https://kawalpemilu.org#25973,"KAMAL, KALIDERES, JAKARTA BARAT, DKI JAKARTA",179,166,1,167
https://kawalpemilu.org#25973,"KAMAL, KALIDERES, JAKARTA BARAT, DKI JAKARTA",180,171,10,181
https://kawalpemilu.org#25974,"PEGADUNGAN, KALIDERES, JAKARTA BARAT, DKI JAKARTA",1,69,94,163
https://kawalpemilu.org#25974,"PEGADUNGAN, KALIDERES, JAKARTA BARAT, DKI JAKARTA",2,88,110,198
https://kawalpemilu.org#25974,"PEGADUNGAN, KALIDERES, JAKARTA BARAT, DKI JAKARTA",3,92,138,230
https://kawalpemilu.org#25974,"PEGADUNGAN, KALIDERES, JAKARTA BARAT, DKI JAKARTA",4,94,108,202
https://kawalpemilu.org#25974,"PEGADUNGAN, KALIDERES, JAKARTA BARAT, DKI JAKARTA",5,88,135,223
https://kawalpemilu.org#25974,"PEGADUNGAN, KALIDERES, JAKARTA BARAT, DKI JAKARTA",6,0,0,0
https://kawalpemilu.org#25974,"PEGADUNGAN, KALIDERES, JAKARTA BARAT, DKI JAKARTA",7,114,113,227
https://kawalpemilu.org#25974,"PEGADUNGAN, KALIDERES, JAKARTA BARAT, DKI JAKARTA",8,83,116,199
https://kawalpemilu.org#25974,"PEGADUNGAN, KALIDERES, JAKARTA BARAT, DKI JAKARTA",9,62,162,224
https://kawalpemilu.org#25974,"PEGADUNGAN, KALIDERES, JAKARTA BARAT, DKI JAKARTA",10,67,131,198
https://kawalpemilu.org#25974,"PEGADUNGAN, KALIDERES, JAKARTA BARAT, DKI JAKARTA",11,85,107,192
https://kawalpemilu.org#25974,"PEGADUNGAN, KALIDERES, JAKARTA BARAT, DKI JAKARTA",12,135,119,254
https://kawalpemilu.org#25974,"PEGADUNGAN, KALIDERES, JAKARTA BARAT, DKI JAKARTA",13,106,127,233
https://kawalpemilu.org#25974,"PEGADUNGAN, KALIDERES, JAKARTA BARAT, DKI JAKARTA",14,81,149,230
https://kawalpemilu.org#25974,"PEGADUNGAN, KALIDERES, JAKARTA BARAT, DKI JAKARTA",15,71,146,217
https://kawalpemilu.org#25974,"PEGADUNGAN, KALIDERES, JAKARTA BARAT, DKI JAKARTA",16,68,118,186
https://kawalpemilu.org#25974,"PEGADUNGAN, KALIDERES, JAKARTA BARAT, DKI JAKARTA",17,78,141,219
https://kawalpemilu.org#25974,"PEGADUNGAN, KALIDERES, JAKARTA BARAT, DKI JAKARTA",18,106,119,225
https://kawalpemilu.org#25974,"PEGADUNGAN, KALIDERES, JAKARTA BARAT, DKI JAKARTA",19,92,123,215
https://kawalpemilu.org#25974,"PEGADUNGAN, KALIDERES, JAKARTA BARAT, DKI JAKARTA",20,92,123,215
https://kawalpemilu.org#25974,"PEGADUNGAN, KALIDERES, JAKARTA BARAT, DKI JAKARTA",21,92,92,184
https://kawalpemilu.org#25974,"PEGADUNGAN, KALIDERES, JAKARTA BARAT, DKI JAKARTA",22,69,100,169
https://kawalpemilu.org#25974,"PEGADUNGAN, KALIDERES, JAKARTA BARAT, DKI JAKARTA",23,110,71,181
https://kawalpemilu.org#25974,"PEGADUNGAN, KALIDERES, JAKARTA BARAT, DKI JAKARTA",24,73,83,156
https://kawalpemilu.org#25974,"PEGADUNGAN, KALIDERES, JAKARTA BARAT, DKI JAKARTA",25,90,118,208
https://kawalpemilu.org#25974,"PEGADUNGAN, KALIDERES, JAKARTA BARAT, DKI JAKARTA",26,85,105,190
https://kawalpemilu.org#25974,"PEGADUNGAN, KALIDERES, JAKARTA BARAT, DKI JAKARTA",27,93,88,181
https://kawalpemilu.org#25974,"PEGADUNGAN, KALIDERES, JAKARTA BARAT, DKI JAKARTA",28,69,100,169
https://kawalpemilu.org#25974,"PEGADUNGAN, KALIDERES, JAKARTA BARAT, DKI JAKARTA",29,60,112,172
https://kawalpemilu.org#25974,"PEGADUNGAN, KALIDERES, JAKARTA BARAT, DKI JAKARTA",30,101,65,166
https://kawalpemilu.org#25974,"PEGADUNGAN, KALIDERES, JAKARTA BARAT, DKI JAKARTA",31,103,83,186
https://kawalpemilu.org#25974,"PEGADUNGAN, KALIDERES, JAKARTA BARAT, DKI JAKARTA",32,95,125,220
https://kawalpemilu.org#25974,"PEGADUNGAN, KALIDERES, JAKARTA BARAT, DKI JAKARTA",33,88,102,190
https://kawalpemilu.org#25974,"PEGADUNGAN, KALIDERES, JAKARTA BARAT, DKI JAKARTA",34,108,109,217
https://kawalpemilu.org#25974,"PEGADUNGAN, KALIDERES, JAKARTA BARAT, DKI JAKARTA",35,114,95,209
https://kawalpemilu.org#25974,"PEGADUNGAN, KALIDERES, JAKARTA BARAT, DKI JAKARTA",36,87,103,190
https://kawalpemilu.org#25974,"PEGADUNGAN, KALIDERES, JAKARTA BARAT, DKI JAKARTA",37,101,97,198
https://kawalpemilu.org#25974,"PEGADUNGAN, KALIDERES, JAKARTA BARAT, DKI JAKARTA",38,94,108,202
https://kawalpemilu.org#25974,"PEGADUNGAN, KALIDERES, JAKARTA BARAT, DKI JAKARTA",39,212,11,223
https://kawalpemilu.org#25974,"PEGADUNGAN, KALIDERES, JAKARTA BARAT, DKI JAKARTA",40,210,4,214
https://kawalpemilu.org#25974,"PEGADUNGAN, KALIDERES, JAKARTA BARAT, DKI JAKARTA",41,228,5,233
https://kawalpemilu.org#25974,"PEGADUNGAN, KALIDERES, JAKARTA BARAT, DKI JAKARTA",42,122,107,229
https://kawalpemilu.org#25974,"PEGADUNGAN, KALIDERES, JAKARTA BARAT, DKI JAKARTA",43,123,107,230
https://kawalpemilu.org#25974,"PEGADUNGAN, KALIDERES, JAKARTA BARAT, DKI JAKARTA",44,164,74,238
https://kawalpemilu.org#25974,"PEGADUNGAN, KALIDERES, JAKARTA BARAT, DKI JAKARTA",45,0,0,0
https://kawalpemilu.org#25974,"PEGADUNGAN, KALIDERES, JAKARTA BARAT, DKI JAKARTA",46,145,95,240
https://kawalpemilu.org#25974,"PEGADUNGAN, KALIDERES, JAKARTA BARAT, DKI JAKARTA",47,120,143,263
https://kawalpemilu.org#25974,"PEGADUNGAN, KALIDERES, JAKARTA BARAT, DKI JAKARTA",48,152,117,269
https://kawalpemilu.org#25974,"PEGADUNGAN, KALIDERES, JAKARTA BARAT, DKI JAKARTA",49,139,128,267
https://kawalpemilu.org#25974,"PEGADUNGAN, KALIDERES, JAKARTA BARAT, DKI JAKARTA",50,170,78,248
https://kawalpemilu.org#25974,"PEGADUNGAN, KALIDERES, JAKARTA BARAT, DKI JAKARTA",51,198,69,267
https://kawalpemilu.org#25974,"PEGADUNGAN, KALIDERES, JAKARTA BARAT, DKI JAKARTA",52,126,72,198
https://kawalpemilu.org#25974,"PEGADUNGAN, KALIDERES, JAKARTA BARAT, DKI JAKARTA",53,102,98,200
https://kawalpemilu.org#25974,"PEGADUNGAN, KALIDERES, JAKARTA BARAT, DKI JAKARTA",54,144,89,233
https://kawalpemilu.org#25974,"PEGADUNGAN, KALIDERES, JAKARTA BARAT, DKI JAKARTA",55,136,106,242
https://kawalpemilu.org#25974,"PEGADUNGAN, KALIDERES, JAKARTA BARAT, DKI JAKARTA",56,117,94,211
https://kawalpemilu.org#25974,"PEGADUNGAN, KALIDERES, JAKARTA BARAT, DKI JAKARTA",57,134,72,206
https://kawalpemilu.org#25974,"PEGADUNGAN, KALIDERES, JAKARTA BARAT, DKI JAKARTA",58,203,63,266
https://kawalpemilu.org#25974,"PEGADUNGAN, KALIDERES, JAKARTA BARAT, DKI JAKARTA",59,74,134,208
https://kawalpemilu.org#25974,"PEGADUNGAN, KALIDERES, JAKARTA BARAT, DKI JAKARTA",60,126,128,254
https://kawalpemilu.org#25974,"PEGADUNGAN, KALIDERES, JAKARTA BARAT, DKI JAKARTA",61,105,169,274
https://kawalpemilu.org#25974,"PEGADUNGAN, KALIDERES, JAKARTA BARAT, DKI JAKARTA",62,76,171,247
https://kawalpemilu.org#25974,"PEGADUNGAN, KALIDERES, JAKARTA BARAT, DKI JAKARTA",63,144,153,297
https://kawalpemilu.org#25974,"PEGADUNGAN, KALIDERES, JAKARTA BARAT, DKI JAKARTA",64,114,130,244
https://kawalpemilu.org#25974,"PEGADUNGAN, KALIDERES, JAKARTA BARAT, DKI JAKARTA",66,127,137,264
https://kawalpemilu.org#25974,"PEGADUNGAN, KALIDERES, JAKARTA BARAT, DKI JAKARTA",67,127,107,234
https://kawalpemilu.org#25974,"PEGADUNGAN, KALIDERES, JAKARTA BARAT, DKI JAKARTA",68,119,157,276
https://kawalpemilu.org#25974,"PEGADUNGAN, KALIDERES, JAKARTA BARAT, DKI JAKARTA",69,96,138,234
https://kawalpemilu.org#25974,"PEGADUNGAN, KALIDERES, JAKARTA BARAT, DKI JAKARTA",70,88,138,226
https://kawalpemilu.org#25974,"PEGADUNGAN, KALIDERES, JAKARTA BARAT, DKI JAKARTA",71,121,114,235
https://kawalpemilu.org#25974,"PEGADUNGAN, KALIDERES, JAKARTA BARAT, DKI JAKARTA",72,91,129,220
https://kawalpemilu.org#25974,"PEGADUNGAN, KALIDERES, JAKARTA BARAT, DKI JAKARTA",73,123,107,230
https://kawalpemilu.org#25974,"PEGADUNGAN, KALIDERES, JAKARTA BARAT, DKI JAKARTA",74,134,118,252
https://kawalpemilu.org#25974,"PEGADUNGAN, KALIDERES, JAKARTA BARAT, DKI JAKARTA",75,108,114,222
https://kawalpemilu.org#25974,"PEGADUNGAN, KALIDERES, JAKARTA BARAT, DKI JAKARTA",76,58,178,236
https://kawalpemilu.org#25974,"PEGADUNGAN, KALIDERES, JAKARTA BARAT, DKI JAKARTA",77,40,138,178
https://kawalpemilu.org#25974,"PEGADUNGAN, KALIDERES, JAKARTA BARAT, DKI JAKARTA",78,78,111,189
https://kawalpemilu.org#25974,"PEGADUNGAN, KALIDERES, JAKARTA BARAT, DKI JAKARTA",79,81,106,187
https://kawalpemilu.org#25974,"PEGADUNGAN, KALIDERES, JAKARTA BARAT, DKI JAKARTA",80,72,96,168
https://kawalpemilu.org#25974,"PEGADUNGAN, KALIDERES, JAKARTA BARAT, DKI JAKARTA",81,100,152,252
https://kawalpemilu.org#25974,"PEGADUNGAN, KALIDERES, JAKARTA BARAT, DKI JAKARTA",82,92,115,207
https://kawalpemilu.org#25974,"PEGADUNGAN, KALIDERES, JAKARTA BARAT, DKI JAKARTA",83,111,134,245
https://kawalpemilu.org#25974,"PEGADUNGAN, KALIDERES, JAKARTA BARAT, DKI JAKARTA",84,84,102,186
https://kawalpemilu.org#25974,"PEGADUNGAN, KALIDERES, JAKARTA BARAT, DKI JAKARTA",85,81,93,174
https://kawalpemilu.org#25974,"PEGADUNGAN, KALIDERES, JAKARTA BARAT, DKI JAKARTA",86,74,138,212
https://kawalpemilu.org#25974,"PEGADUNGAN, KALIDERES, JAKARTA BARAT, DKI JAKARTA",87,60,128,188
https://kawalpemilu.org#25974,"PEGADUNGAN, KALIDERES, JAKARTA BARAT, DKI JAKARTA",88,94,106,200
https://kawalpemilu.org#25974,"PEGADUNGAN, KALIDERES, JAKARTA BARAT, DKI JAKARTA",89,98,117,215
https://kawalpemilu.org#25974,"PEGADUNGAN, KALIDERES, JAKARTA BARAT, DKI JAKARTA",90,111,127,238
https://kawalpemilu.org#25974,"PEGADUNGAN, KALIDERES, JAKARTA BARAT, DKI JAKARTA",91,99,83,182
https://kawalpemilu.org#25974,"PEGADUNGAN, KALIDERES, JAKARTA BARAT, DKI JAKARTA",92,86,90,176
https://kawalpemilu.org#25974,"PEGADUNGAN, KALIDERES, JAKARTA BARAT, DKI JAKARTA",93,100,115,215
https://kawalpemilu.org#25974,"PEGADUNGAN, KALIDERES, JAKARTA BARAT, DKI JAKARTA",94,101,119,220
https://kawalpemilu.org#25974,"PEGADUNGAN, KALIDERES, JAKARTA BARAT, DKI JAKARTA",95,91,90,181
https://kawalpemilu.org#25974,"PEGADUNGAN, KALIDERES, JAKARTA BARAT, DKI JAKARTA",96,84,93,177
https://kawalpemilu.org#25974,"PEGADUNGAN, KALIDERES, JAKARTA BARAT, DKI JAKARTA",97,83,110,193
https://kawalpemilu.org#25974,"PEGADUNGAN, KALIDERES, JAKARTA BARAT, DKI JAKARTA",98,94,94,188
https://kawalpemilu.org#25974,"PEGADUNGAN, KALIDERES, JAKARTA BARAT, DKI JAKARTA",99,121,60,181
https://kawalpemilu.org#25974,"PEGADUNGAN, KALIDERES, JAKARTA BARAT, DKI JAKARTA",100,191,3,194
https://kawalpemilu.org#25974,"PEGADUNGAN, KALIDERES, JAKARTA BARAT, DKI JAKARTA",101,204,6,210
https://kawalpemilu.org#25974,"PEGADUNGAN, KALIDERES, JAKARTA BARAT, DKI JAKARTA",102,193,2,195
https://kawalpemilu.org#25974,"PEGADUNGAN, KALIDERES, JAKARTA BARAT, DKI JAKARTA",103,191,5,196
https://kawalpemilu.org#25974,"PEGADUNGAN, KALIDERES, JAKARTA BARAT, DKI JAKARTA",104,83,58,141
https://kawalpemilu.org#25974,"PEGADUNGAN, KALIDERES, JAKARTA BARAT, DKI JAKARTA",105,95,75,170
https://kawalpemilu.org#25974,"PEGADUNGAN, KALIDERES, JAKARTA BARAT, DKI JAKARTA",106,98,64,162
https://kawalpemilu.org#25974,"PEGADUNGAN, KALIDERES, JAKARTA BARAT, DKI JAKARTA",107,76,87,164
https://kawalpemilu.org#25974,"PEGADUNGAN, KALIDERES, JAKARTA BARAT, DKI JAKARTA",108,97,178,275
https://kawalpemilu.org#25974,"PEGADUNGAN, KALIDERES, JAKARTA BARAT, DKI JAKARTA",109,110,131,241
https://kawalpemilu.org#25974,"PEGADUNGAN, KALIDERES, JAKARTA BARAT, DKI JAKARTA",110,117,101,3
https://kawalpemilu.org#25974,"PEGADUNGAN, KALIDERES, JAKARTA BARAT, DKI JAKARTA",111,107,79,186
https://kawalpemilu.org#25974,"PEGADUNGAN, KALIDERES, JAKARTA BARAT, DKI JAKARTA",112,108,99,207
https://kawalpemilu.org#25974,"PEGADUNGAN, KALIDERES, JAKARTA BARAT, DKI JAKARTA",113,104,110,214
https://kawalpemilu.org#25974,"PEGADUNGAN, KALIDERES, JAKARTA BARAT, DKI JAKARTA",114,147,81,228
https://kawalpemilu.org#25974,"PEGADUNGAN, KALIDERES, JAKARTA BARAT, DKI JAKARTA",115,166,83,249
https://kawalpemilu.org#25974,"PEGADUNGAN, KALIDERES, JAKARTA BARAT, DKI JAKARTA",116,0,0,0
https://kawalpemilu.org#25974,"PEGADUNGAN, KALIDERES, JAKARTA BARAT, DKI JAKARTA",117,116,100,216
https://kawalpemilu.org#25974,"PEGADUNGAN, KALIDERES, JAKARTA BARAT, DKI JAKARTA",118,98,89,187
https://kawalpemilu.org#25974,"PEGADUNGAN, KALIDERES, JAKARTA BARAT, DKI JAKARTA",119,85,131,216
https://kawalpemilu.org#25974,"PEGADUNGAN, KALIDERES, JAKARTA BARAT, DKI JAKARTA",120,110,98,208
https://kawalpemilu.org#25974,"PEGADUNGAN, KALIDERES, JAKARTA BARAT, DKI JAKARTA",121,74,132,206
https://kawalpemilu.org#25974,"PEGADUNGAN, KALIDERES, JAKARTA BARAT, DKI JAKARTA",122,87,107,194
https://kawalpemilu.org#25974,"PEGADUNGAN, KALIDERES, JAKARTA BARAT, DKI JAKARTA",123,92,124,216
https://kawalpemilu.org#25974,"PEGADUNGAN, KALIDERES, JAKARTA BARAT, DKI JAKARTA",124,132,72,204
https://kawalpemilu.org#25974,"PEGADUNGAN, KALIDERES, JAKARTA BARAT, DKI JAKARTA",125,135,127,262
https://kawalpemilu.org#25974,"PEGADUNGAN, KALIDERES, JAKARTA BARAT, DKI JAKARTA",126,113,111,224
https://kawalpemilu.org#25974,"PEGADUNGAN, KALIDERES, JAKARTA BARAT, DKI JAKARTA",127,107,119,226
https://kawalpemilu.org#25974,"PEGADUNGAN, KALIDERES, JAKARTA BARAT, DKI JAKARTA",128,124,128,252
https://kawalpemilu.org#25974,"PEGADUNGAN, KALIDERES, JAKARTA BARAT, DKI JAKARTA",129,103,81,184
https://kawalpemilu.org#25974,"PEGADUNGAN, KALIDERES, JAKARTA BARAT, DKI JAKARTA",130,165,75,240
https://kawalpemilu.org#25974,"PEGADUNGAN, KALIDERES, JAKARTA BARAT, DKI JAKARTA",131,147,81,228
https://kawalpemilu.org#25974,"PEGADUNGAN, KALIDERES, JAKARTA BARAT, DKI JAKARTA",132,86,114,200
https://kawalpemilu.org#25974,"PEGADUNGAN, KALIDERES, JAKARTA BARAT, DKI JAKARTA",133,88,165,253
https://kawalpemilu.org#25974,"PEGADUNGAN, KALIDERES, JAKARTA BARAT, DKI JAKARTA",134,114,146,260
https://kawalpemilu.org#25974,"PEGADUNGAN, KALIDERES, JAKARTA BARAT, DKI JAKARTA",135,81,166,247
https://kawalpemilu.org#25974,"PEGADUNGAN, KALIDERES, JAKARTA BARAT, DKI JAKARTA",136,110,139,249
https://kawalpemilu.org#25974,"PEGADUNGAN, KALIDERES, JAKARTA BARAT, DKI JAKARTA",137,178,4,182
https://kawalpemilu.org#25974,"PEGADUNGAN, KALIDERES, JAKARTA BARAT, DKI JAKARTA",138,217,7,224
https://kawalpemilu.org#25974,"PEGADUNGAN, KALIDERES, JAKARTA BARAT, DKI JAKARTA",139,249,7,256
https://kawalpemilu.org#25974,"PEGADUNGAN, KALIDERES, JAKARTA BARAT, DKI JAKARTA",140,97,110,209
https://kawalpemilu.org#25974,"PEGADUNGAN, KALIDERES, JAKARTA BARAT, DKI JAKARTA",141,54,127,181
https://kawalpemilu.org#25974,"PEGADUNGAN, KALIDERES, JAKARTA BARAT, DKI JAKARTA",142,75,95,170
https://kawalpemilu.org#25974,"PEGADUNGAN, KALIDERES, JAKARTA BARAT, DKI JAKARTA",143,82,68,150
https://kawalpemilu.org#25974,"PEGADUNGAN, KALIDERES, JAKARTA BARAT, DKI JAKARTA",144,104,70,174
https://kawalpemilu.org#25974,"PEGADUNGAN, KALIDERES, JAKARTA BARAT, DKI JAKARTA",145,91,135,226
https://kawalpemilu.org#25974,"PEGADUNGAN, KALIDERES, JAKARTA BARAT, DKI JAKARTA",146,93,103,196
https://kawalpemilu.org#25974,"PEGADUNGAN, KALIDERES, JAKARTA BARAT, DKI JAKARTA",147,130,92,222
https://kawalpemilu.org#25974,"PEGADUNGAN, KALIDERES, JAKARTA BARAT, DKI JAKARTA",148,122,100,222
https://kawalpemilu.org#25974,"PEGADUNGAN, KALIDERES, JAKARTA BARAT, DKI JAKARTA",149,78,125,203
https://kawalpemilu.org#25974,"PEGADUNGAN, KALIDERES, JAKARTA BARAT, DKI JAKARTA",150,86,110,196
https://kawalpemilu.org#25974,"PEGADUNGAN, KALIDERES, JAKARTA BARAT, DKI JAKARTA",151,122,87,209
https://kawalpemilu.org#25974,"PEGADUNGAN, KALIDERES, JAKARTA BARAT, DKI JAKARTA",152,122,116,238
https://kawalpemilu.org#25974,"PEGADUNGAN, KALIDERES, JAKARTA BARAT, DKI JAKARTA",153,107,88,195
https://kawalpemilu.org#25974,"PEGADUNGAN, KALIDERES, JAKARTA BARAT, DKI JAKARTA",154,0,0,0
https://kawalpemilu.org#25974,"PEGADUNGAN, KALIDERES, JAKARTA BARAT, DKI JAKARTA",155,62,100,162
https://kawalpemilu.org#25974,"PEGADUNGAN, KALIDERES, JAKARTA BARAT, DKI JAKARTA",156,120,74,194
https://kawalpemilu.org#25974,"PEGADUNGAN, KALIDERES, JAKARTA BARAT, DKI JAKARTA",157,87,91,178
https://kawalpemilu.org#25974,"PEGADUNGAN, KALIDERES, JAKARTA BARAT, DKI JAKARTA",158,113,54,167
https://kawalpemilu.org#25974,"PEGADUNGAN, KALIDERES, JAKARTA BARAT, DKI JAKARTA",159,107,95,202
https://kawalpemilu.org#25974,"PEGADUNGAN, KALIDERES, JAKARTA BARAT, DKI JAKARTA",160,96,112,208
https://kawalpemilu.org#25974,"PEGADUNGAN, KALIDERES, JAKARTA BARAT, DKI JAKARTA",161,73,107,180
https://kawalpemilu.org#25974,"PEGADUNGAN, KALIDERES, JAKARTA BARAT, DKI JAKARTA",162,79,93,172
https://kawalpemilu.org#25974,"PEGADUNGAN, KALIDERES, JAKARTA BARAT, DKI JAKARTA",163,105,75,180
https://kawalpemilu.org#25974,"PEGADUNGAN, KALIDERES, JAKARTA BARAT, DKI JAKARTA",164,120,120,240
https://kawalpemilu.org#25974,"PEGADUNGAN, KALIDERES, JAKARTA BARAT, DKI JAKARTA",165,83,130,213
https://kawalpemilu.org#25974,"PEGADUNGAN, KALIDERES, JAKARTA BARAT, DKI JAKARTA",166,79,110,189
https://kawalpemilu.org#25974,"PEGADUNGAN, KALIDERES, JAKARTA BARAT, DKI JAKARTA",167,0,0,0
https://kawalpemilu.org#25974,"PEGADUNGAN, KALIDERES, JAKARTA BARAT, DKI JAKARTA",169,115,98,213
https://kawalpemilu.org#25974,"PEGADUNGAN, KALIDERES, JAKARTA BARAT, DKI JAKARTA",170,88,96,184
https://kawalpemilu.org#25974,"PEGADUNGAN, KALIDERES, JAKARTA BARAT, DKI JAKARTA",171,83,107,190
https://kawalpemilu.org#25974,"PEGADUNGAN, KALIDERES, JAKARTA BARAT, DKI JAKARTA",172,99,109,208
https://kawalpemilu.org#25974,"PEGADUNGAN, KALIDERES, JAKARTA BARAT, DKI JAKARTA",173,135,91,226
https://kawalpemilu.org#25974,"PEGADUNGAN, KALIDERES, JAKARTA BARAT, DKI JAKARTA",174,117,99,216
https://kawalpemilu.org#25974,"PEGADUNGAN, KALIDERES, JAKARTA BARAT, DKI JAKARTA",175,97,75,172
https://kawalpemilu.org#25974,"PEGADUNGAN, KALIDERES, JAKARTA BARAT, DKI JAKARTA",176,92,72,164
https://kawalpemilu.org#25974,"PEGADUNGAN, KALIDERES, JAKARTA BARAT, DKI JAKARTA",177,93,118,211
https://kawalpemilu.org#25974,"PEGADUNGAN, KALIDERES, JAKARTA BARAT, DKI JAKARTA",178,109,101,210
https://kawalpemilu.org#25974,"PEGADUNGAN, KALIDERES, JAKARTA BARAT, DKI JAKARTA",179,165,65,230
https://kawalpemilu.org#25974,"PEGADUNGAN, KALIDERES, JAKARTA BARAT, DKI JAKARTA",180,151,63,216
https://kawalpemilu.org#25974,"PEGADUNGAN, KALIDERES, JAKARTA BARAT, DKI JAKARTA",181,167,5,172
https://kawalpemilu.org#25974,"PEGADUNGAN, KALIDERES, JAKARTA BARAT, DKI JAKARTA",182,205,5,210
https://kawalpemilu.org#25974,"PEGADUNGAN, KALIDERES, JAKARTA BARAT, DKI JAKARTA",183,220,2,222
https://kawalpemilu.org#25974,"PEGADUNGAN, KALIDERES, JAKARTA BARAT, DKI JAKARTA",184,204,10,214
https://kawalpemilu.org#25974,"PEGADUNGAN, KALIDERES, JAKARTA BARAT, DKI JAKARTA",185,193,8,201
https://kawalpemilu.org#25974,"PEGADUNGAN, KALIDERES, JAKARTA BARAT, DKI JAKARTA",186,244,6,250
https://kawalpemilu.org#25974,"PEGADUNGAN, KALIDERES, JAKARTA BARAT, DKI JAKARTA",187,204,3,207
https://kawalpemilu.org#25974,"PEGADUNGAN, KALIDERES, JAKARTA BARAT, DKI JAKARTA",188,216,5,221
https://kawalpemilu.org#25974,"PEGADUNGAN, KALIDERES, JAKARTA BARAT, DKI JAKARTA",189,256,4,260
https://kawalpemilu.org#25974,"PEGADUNGAN, KALIDERES, JAKARTA BARAT, DKI JAKARTA",190,158,2,160
https://kawalpemilu.org#25974,"PEGADUNGAN, KALIDERES, JAKARTA BARAT, DKI JAKARTA",191,210,5,215
https://kawalpemilu.org#25974,"PEGADUNGAN, KALIDERES, JAKARTA BARAT, DKI JAKARTA",192,213,2,215
https://kawalpemilu.org#25974,"PEGADUNGAN, KALIDERES, JAKARTA BARAT, DKI JAKARTA",193,212,3,215
https://kawalpemilu.org#25974,"PEGADUNGAN, KALIDERES, JAKARTA BARAT, DKI JAKARTA",194,215,4,219
https://kawalpemilu.org#25974,"PEGADUNGAN, KALIDERES, JAKARTA BARAT, DKI JAKARTA",195,176,0,176
https://kawalpemilu.org#25974,"PEGADUNGAN, KALIDERES, JAKARTA BARAT, DKI JAKARTA",196,216,2,218
https://kawalpemilu.org#25974,"PEGADUNGAN, KALIDERES, JAKARTA BARAT, DKI JAKARTA",197,225,5,230
https://kawalpemilu.org#25974,"PEGADUNGAN, KALIDERES, JAKARTA BARAT, DKI JAKARTA",198,194,5,199
https://kawalpemilu.org#25974,"PEGADUNGAN, KALIDERES, JAKARTA BARAT, DKI JAKARTA",199,201,4,205
https://kawalpemilu.org#25974,"PEGADUNGAN, KALIDERES, JAKARTA BARAT, DKI JAKARTA",200,209,13,222
https://kawalpemilu.org#25974,"PEGADUNGAN, KALIDERES, JAKARTA BARAT, DKI JAKARTA",201,194,2,196
https://kawalpemilu.org#25974,"PEGADUNGAN, KALIDERES, JAKARTA BARAT, DKI JAKARTA",202,208,13,221
https://kawalpemilu.org#25974,"PEGADUNGAN, KALIDERES, JAKARTA BARAT, DKI JAKARTA",203,239,13,252
https://kawalpemilu.org#25974,"PEGADUNGAN, KALIDERES, JAKARTA BARAT, DKI JAKARTA",204,213,5,218
https://kawalpemilu.org#25974,"PEGADUNGAN, KALIDERES, JAKARTA BARAT, DKI JAKARTA",205,255,4,259
https://kawalpemilu.org#25974,"PEGADUNGAN, KALIDERES, JAKARTA BARAT, DKI JAKARTA",206,184,0,184
https://kawalpemilu.org#25974,"PEGADUNGAN, KALIDERES, JAKARTA BARAT, DKI JAKARTA",207,221,14,235
https://kawalpemilu.org#25974,"PEGADUNGAN, KALIDERES, JAKARTA BARAT, DKI JAKARTA",208,224,2,226
https://kawalpemilu.org#25974,"PEGADUNGAN, KALIDERES, JAKARTA BARAT, DKI JAKARTA",209,199,7,206
https://kawalpemilu.org#25974,"PEGADUNGAN, KALIDERES, JAKARTA BARAT, DKI JAKARTA",210,195,7,202
https://kawalpemilu.org#25974,"PEGADUNGAN, KALIDERES, JAKARTA BARAT, DKI JAKARTA",211,219,0,219
https://kawalpemilu.org#25974,"PEGADUNGAN, KALIDERES, JAKARTA BARAT, DKI JAKARTA",212,230,1,231
https://kawalpemilu.org#25974,"PEGADUNGAN, KALIDERES, JAKARTA BARAT, DKI JAKARTA",213,199,2,201
https://kawalpemilu.org#25974,"PEGADUNGAN, KALIDERES, JAKARTA BARAT, DKI JAKARTA",214,250,4,254
https://kawalpemilu.org#25974,"PEGADUNGAN, KALIDERES, JAKARTA BARAT, DKI JAKARTA",215,166,3,169
https://kawalpemilu.org#25974,"PEGADUNGAN, KALIDERES, JAKARTA BARAT, DKI JAKARTA",216,210,2,212
https://kawalpemilu.org#25974,"PEGADUNGAN, KALIDERES, JAKARTA BARAT, DKI JAKARTA",217,184,2,186
https://kawalpemilu.org#25974,"PEGADUNGAN, KALIDERES, JAKARTA BARAT, DKI JAKARTA",218,207,1,208
https://kawalpemilu.org#25974,"PEGADUNGAN, KALIDERES, JAKARTA BARAT, DKI JAKARTA",219,190,4,194
https://kawalpemilu.org#25974,"PEGADUNGAN, KALIDERES, JAKARTA BARAT, DKI JAKARTA",220,195,4,199
https://kawalpemilu.org#25974,"PEGADUNGAN, KALIDERES, JAKARTA BARAT, DKI JAKARTA",221,250,1,251
https://kawalpemilu.org#25974,"PEGADUNGAN, KALIDERES, JAKARTA BARAT, DKI JAKARTA",222,214,2,216
https://kawalpemilu.org#25974,"PEGADUNGAN, KALIDERES, JAKARTA BARAT, DKI JAKARTA",223,217,2,219
https://kawalpemilu.org#25974,"PEGADUNGAN, KALIDERES, JAKARTA BARAT, DKI JAKARTA",224,204,8,212
https://kawalpemilu.org#25974,"PEGADUNGAN, KALIDERES, JAKARTA BARAT, DKI JAKARTA",225,209,3,212
https://kawalpemilu.org#25974,"PEGADUNGAN, KALIDERES, JAKARTA BARAT, DKI JAKARTA",226,154,6,160
https://kawalpemilu.org#25974,"PEGADUNGAN, KALIDERES, JAKARTA BARAT, DKI JAKARTA",227,197,7,204
https://kawalpemilu.org#25974,"PEGADUNGAN, KALIDERES, JAKARTA BARAT, DKI JAKARTA",228,180,9,189
https://kawalpemilu.org#25974,"PEGADUNGAN, KALIDERES, JAKARTA BARAT, DKI JAKARTA",229,194,8,202
https://kawalpemilu.org#25974,"PEGADUNGAN, KALIDERES, JAKARTA BARAT, DKI JAKARTA",230,209,7,216
https://kawalpemilu.org#25974,"PEGADUNGAN, KALIDERES, JAKARTA BARAT, DKI JAKARTA",231,205,4,209
https://kawalpemilu.org#25974,"PEGADUNGAN, KALIDERES, JAKARTA BARAT, DKI JAKARTA",232,176,0,176
https://kawalpemilu.org#25974,"PEGADUNGAN, KALIDERES, JAKARTA BARAT, DKI JAKARTA",233,181,6,187
https://kawalpemilu.org#25974,"PEGADUNGAN, KALIDERES, JAKARTA BARAT, DKI JAKARTA",234,223,5,228
https://kawalpemilu.org#25974,"PEGADUNGAN, KALIDERES, JAKARTA BARAT, DKI JAKARTA",235,217,6,223
https://kawalpemilu.org#25974,"PEGADUNGAN, KALIDERES, JAKARTA BARAT, DKI JAKARTA",236,218,7,225
https://kawalpemilu.org#25974,"PEGADUNGAN, KALIDERES, JAKARTA BARAT, DKI JAKARTA",237,203,8,211
https://kawalpemilu.org#25974,"PEGADUNGAN, KALIDERES, JAKARTA BARAT, DKI JAKARTA",238,240,4,244
https://kawalpemilu.org#25974,"PEGADUNGAN, KALIDERES, JAKARTA BARAT, DKI JAKARTA",239,163,4,167
https://kawalpemilu.org#25974,"PEGADUNGAN, KALIDERES, JAKARTA BARAT, DKI JAKARTA",240,194,11,205
https://kawalpemilu.org#25974,"PEGADUNGAN, KALIDERES, JAKARTA BARAT, DKI JAKARTA",241,175,6,181
https://kawalpemilu.org#25974,"PEGADUNGAN, KALIDERES, JAKARTA BARAT, DKI JAKARTA",242,200,7,207
https://kawalpemilu.org#25974,"PEGADUNGAN, KALIDERES, JAKARTA BARAT, DKI JAKARTA",243,221,2,223
https://kawalpemilu.org#25974,"PEGADUNGAN, KALIDERES, JAKARTA BARAT, DKI JAKARTA",244,219,3,222
https://kawalpemilu.org#25976,"PALMERAH, PALMERAH, JAKARTA BARAT, DKI JAKARTA",1,103,156,259
https://kawalpemilu.org#25976,"PALMERAH, PALMERAH, JAKARTA BARAT, DKI JAKARTA",2,103,143,246
https://kawalpemilu.org#25976,"PALMERAH, PALMERAH, JAKARTA BARAT, DKI JAKARTA",3,96,163,259
https://kawalpemilu.org#25976,"PALMERAH, PALMERAH, JAKARTA BARAT, DKI JAKARTA",4,113,142,255
https://kawalpemilu.org#25976,"PALMERAH, PALMERAH, JAKARTA BARAT, DKI JAKARTA",5,108,142,250
https://kawalpemilu.org#25976,"PALMERAH, PALMERAH, JAKARTA BARAT, DKI JAKARTA",6,102,153,255
https://kawalpemilu.org#25976,"PALMERAH, PALMERAH, JAKARTA BARAT, DKI JAKARTA",7,122,117,239
https://kawalpemilu.org#25976,"PALMERAH, PALMERAH, JAKARTA BARAT, DKI JAKARTA",8,94,135,229
https://kawalpemilu.org#25976,"PALMERAH, PALMERAH, JAKARTA BARAT, DKI JAKARTA",9,123,138,261
https://kawalpemilu.org#25976,"PALMERAH, PALMERAH, JAKARTA BARAT, DKI JAKARTA",10,103,130,233
https://kawalpemilu.org#25976,"PALMERAH, PALMERAH, JAKARTA BARAT, DKI JAKARTA",11,119,115,234
https://kawalpemilu.org#25976,"PALMERAH, PALMERAH, JAKARTA BARAT, DKI JAKARTA",12,105,109,214
https://kawalpemilu.org#25976,"PALMERAH, PALMERAH, JAKARTA BARAT, DKI JAKARTA",13,92,106,198
https://kawalpemilu.org#25976,"PALMERAH, PALMERAH, JAKARTA BARAT, DKI JAKARTA",14,127,107,234
https://kawalpemilu.org#25976,"PALMERAH, PALMERAH, JAKARTA BARAT, DKI JAKARTA",15,118,87,205
https://kawalpemilu.org#25976,"PALMERAH, PALMERAH, JAKARTA BARAT, DKI JAKARTA",16,83,129,212
https://kawalpemilu.org#25976,"PALMERAH, PALMERAH, JAKARTA BARAT, DKI JAKARTA",17,103,127,230
https://kawalpemilu.org#25976,"PALMERAH, PALMERAH, JAKARTA BARAT, DKI JAKARTA",18,126,100,226
https://kawalpemilu.org#25976,"PALMERAH, PALMERAH, JAKARTA BARAT, DKI JAKARTA",19,130,120,250
https://kawalpemilu.org#25976,"PALMERAH, PALMERAH, JAKARTA BARAT, DKI JAKARTA",20,138,83,221
https://kawalpemilu.org#25976,"PALMERAH, PALMERAH, JAKARTA BARAT, DKI JAKARTA",21,123,116,239
https://kawalpemilu.org#25976,"PALMERAH, PALMERAH, JAKARTA BARAT, DKI JAKARTA",22,111,114,225
https://kawalpemilu.org#25976,"PALMERAH, PALMERAH, JAKARTA BARAT, DKI JAKARTA",23,105,79,184
https://kawalpemilu.org#25976,"PALMERAH, PALMERAH, JAKARTA BARAT, DKI JAKARTA",24,130,101,231
https://kawalpemilu.org#25976,"PALMERAH, PALMERAH, JAKARTA BARAT, DKI JAKARTA",25,109,123,232
https://kawalpemilu.org#25976,"PALMERAH, PALMERAH, JAKARTA BARAT, DKI JAKARTA",26,112,111,223
https://kawalpemilu.org#25976,"PALMERAH, PALMERAH, JAKARTA BARAT, DKI JAKARTA",27,127,101,228
https://kawalpemilu.org#25976,"PALMERAH, PALMERAH, JAKARTA BARAT, DKI JAKARTA",28,104,103,2
https://kawalpemilu.org#25976,"PALMERAH, PALMERAH, JAKARTA BARAT, DKI JAKARTA",29,136,78,214
https://kawalpemilu.org#25976,"PALMERAH, PALMERAH, JAKARTA BARAT, DKI JAKARTA",30,111,92,203
https://kawalpemilu.org#25976,"PALMERAH, PALMERAH, JAKARTA BARAT, DKI JAKARTA",31,103,124,227
https://kawalpemilu.org#25976,"PALMERAH, PALMERAH, JAKARTA BARAT, DKI JAKARTA",32,105,118,223
https://kawalpemilu.org#25976,"PALMERAH, PALMERAH, JAKARTA BARAT, DKI JAKARTA",33,91,127,218
https://kawalpemilu.org#25976,"PALMERAH, PALMERAH, JAKARTA BARAT, DKI JAKARTA",34,97,129,226
https://kawalpemilu.org#25976,"PALMERAH, PALMERAH, JAKARTA BARAT, DKI JAKARTA",35,174,57,231
https://kawalpemilu.org#25976,"PALMERAH, PALMERAH, JAKARTA BARAT, DKI JAKARTA",36,57,160,217
https://kawalpemilu.org#25976,"PALMERAH, PALMERAH, JAKARTA BARAT, DKI JAKARTA",37,87,110,197
https://kawalpemilu.org#25976,"PALMERAH, PALMERAH, JAKARTA BARAT, DKI JAKARTA",38,0,0,0
https://kawalpemilu.org#25976,"PALMERAH, PALMERAH, JAKARTA BARAT, DKI JAKARTA",39,93,91,184
https://kawalpemilu.org#25976,"PALMERAH, PALMERAH, JAKARTA BARAT, DKI JAKARTA",40,72,135,207
https://kawalpemilu.org#25976,"PALMERAH, PALMERAH, JAKARTA BARAT, DKI JAKARTA",41,79,143,222
https://kawalpemilu.org#25976,"PALMERAH, PALMERAH, JAKARTA BARAT, DKI JAKARTA",42,108,134,242
https://kawalpemilu.org#25976,"PALMERAH, PALMERAH, JAKARTA BARAT, DKI JAKARTA",43,73,125,198
https://kawalpemilu.org#25976,"PALMERAH, PALMERAH, JAKARTA BARAT, DKI JAKARTA",44,66,119,185
https://kawalpemilu.org#25976,"PALMERAH, PALMERAH, JAKARTA BARAT, DKI JAKARTA",45,63,130,193
https://kawalpemilu.org#25976,"PALMERAH, PALMERAH, JAKARTA BARAT, DKI JAKARTA",46,168,62,230
https://kawalpemilu.org#25976,"PALMERAH, PALMERAH, JAKARTA BARAT, DKI JAKARTA",47,122,105,227
https://kawalpemilu.org#25976,"PALMERAH, PALMERAH, JAKARTA BARAT, DKI JAKARTA",48,140,86,226
https://kawalpemilu.org#25976,"PALMERAH, PALMERAH, JAKARTA BARAT, DKI JAKARTA",49,124,110,234
https://kawalpemilu.org#25976,"PALMERAH, PALMERAH, JAKARTA BARAT, DKI JAKARTA",50,120,136,256
https://kawalpemilu.org#25976,"PALMERAH, PALMERAH, JAKARTA BARAT, DKI JAKARTA",51,71,141,212
https://kawalpemilu.org#25976,"PALMERAH, PALMERAH, JAKARTA BARAT, DKI JAKARTA",52,113,110,223
https://kawalpemilu.org#25976,"PALMERAH, PALMERAH, JAKARTA BARAT, DKI JAKARTA",53,193,21,214
https://kawalpemilu.org#25976,"PALMERAH, PALMERAH, JAKARTA BARAT, DKI JAKARTA",54,169,52,221
https://kawalpemilu.org#25976,"PALMERAH, PALMERAH, JAKARTA BARAT, DKI JAKARTA",55,126,104,230
https://kawalpemilu.org#25976,"PALMERAH, PALMERAH, JAKARTA BARAT, DKI JAKARTA",56,112,78,190
https://kawalpemilu.org#25976,"PALMERAH, PALMERAH, JAKARTA BARAT, DKI JAKARTA",57,90,117,207
https://kawalpemilu.org#25976,"PALMERAH, PALMERAH, JAKARTA BARAT, DKI JAKARTA",58,106,113,219
https://kawalpemilu.org#25976,"PALMERAH, PALMERAH, JAKARTA BARAT, DKI JAKARTA",59,138,72,210
https://kawalpemilu.org#25976,"PALMERAH, PALMERAH, JAKARTA BARAT, DKI JAKARTA",60,93,98,191
https://kawalpemilu.org#25976,"PALMERAH, PALMERAH, JAKARTA BARAT, DKI JAKARTA",61,105,93,198
https://kawalpemilu.org#25976,"PALMERAH, PALMERAH, JAKARTA BARAT, DKI JAKARTA",62,71,145,216
https://kawalpemilu.org#25976,"PALMERAH, PALMERAH, JAKARTA BARAT, DKI JAKARTA",63,194,17,211
https://kawalpemilu.org#25976,"PALMERAH, PALMERAH, JAKARTA BARAT, DKI JAKARTA",64,139,117,256
https://kawalpemilu.org#25976,"PALMERAH, PALMERAH, JAKARTA BARAT, DKI JAKARTA",65,134,117,251
https://kawalpemilu.org#25976,"PALMERAH, PALMERAH, JAKARTA BARAT, DKI JAKARTA",66,118,128,247
https://kawalpemilu.org#25976,"PALMERAH, PALMERAH, JAKARTA BARAT, DKI JAKARTA",67,94,150,244
https://kawalpemilu.org#25976,"PALMERAH, PALMERAH, JAKARTA BARAT, DKI JAKARTA",68,121,121,242
https://kawalpemilu.org#25976,"PALMERAH, PALMERAH, JAKARTA BARAT, DKI JAKARTA",69,93,159,252
https://kawalpemilu.org#25976,"PALMERAH, PALMERAH, JAKARTA BARAT, DKI JAKARTA",70,115,140,255
https://kawalpemilu.org#25976,"PALMERAH, PALMERAH, JAKARTA BARAT, DKI JAKARTA",71,110,135,245
https://kawalpemilu.org#25976,"PALMERAH, PALMERAH, JAKARTA BARAT, DKI JAKARTA",72,114,104,218
https://kawalpemilu.org#25976,"PALMERAH, PALMERAH, JAKARTA BARAT, DKI JAKARTA",73,136,127,263
https://kawalpemilu.org#25976,"PALMERAH, PALMERAH, JAKARTA BARAT, DKI JAKARTA",74,91,145,236
https://kawalpemilu.org#25976,"PALMERAH, PALMERAH, JAKARTA BARAT, DKI JAKARTA",75,87,149,236
https://kawalpemilu.org#25976,"PALMERAH, PALMERAH, JAKARTA BARAT, DKI JAKARTA",76,68,109,177
https://kawalpemilu.org#25976,"PALMERAH, PALMERAH, JAKARTA BARAT, DKI JAKARTA",77,97,107,197
https://kawalpemilu.org#25976,"PALMERAH, PALMERAH, JAKARTA BARAT, DKI JAKARTA",78,96,115,211
https://kawalpemilu.org#25976,"PALMERAH, PALMERAH, JAKARTA BARAT, DKI JAKARTA",79,99,129,228
https://kawalpemilu.org#25976,"PALMERAH, PALMERAH, JAKARTA BARAT, DKI JAKARTA",80,91,125,216
https://kawalpemilu.org#25976,"PALMERAH, PALMERAH, JAKARTA BARAT, DKI JAKARTA",81,98,100,198
https://kawalpemilu.org#25976,"PALMERAH, PALMERAH, JAKARTA BARAT, DKI JAKARTA",82,128,76,204
https://kawalpemilu.org#25976,"PALMERAH, PALMERAH, JAKARTA BARAT, DKI JAKARTA",83,92,117,209
https://kawalpemilu.org#25976,"PALMERAH, PALMERAH, JAKARTA BARAT, DKI JAKARTA",84,102,115,117
https://kawalpemilu.org#25976,"PALMERAH, PALMERAH, JAKARTA BARAT, DKI JAKARTA",85,70,115,185
https://kawalpemilu.org#25976,"PALMERAH, PALMERAH, JAKARTA BARAT, DKI JAKARTA",86,96,94,190
https://kawalpemilu.org#25976,"PALMERAH, PALMERAH, JAKARTA BARAT, DKI JAKARTA",87,66,90,156
https://kawalpemilu.org#25976,"PALMERAH, PALMERAH, JAKARTA BARAT, DKI JAKARTA",88,99,97,196
https://kawalpemilu.org#25976,"PALMERAH, PALMERAH, JAKARTA BARAT, DKI JAKARTA",89,96,127,223
https://kawalpemilu.org#25976,"PALMERAH, PALMERAH, JAKARTA BARAT, DKI JAKARTA",90,103,121,224
https://kawalpemilu.org#25976,"PALMERAH, PALMERAH, JAKARTA BARAT, DKI JAKARTA",91,65,147,212
https://kawalpemilu.org#25976,"PALMERAH, PALMERAH, JAKARTA BARAT, DKI JAKARTA",92,94,131,225
https://kawalpemilu.org#25976,"PALMERAH, PALMERAH, JAKARTA BARAT, DKI JAKARTA",93,83,149,232
https://kawalpemilu.org#25976,"PALMERAH, PALMERAH, JAKARTA BARAT, DKI JAKARTA",94,95,116,211
https://kawalpemilu.org#25976,"PALMERAH, PALMERAH, JAKARTA BARAT, DKI JAKARTA",95,87,148,235
https://kawalpemilu.org#25976,"PALMERAH, PALMERAH, JAKARTA BARAT, DKI JAKARTA",96,65,174,239
https://kawalpemilu.org#25976,"PALMERAH, PALMERAH, JAKARTA BARAT, DKI JAKARTA",97,85,102,187
https://kawalpemilu.org#25976,"PALMERAH, PALMERAH, JAKARTA BARAT, DKI JAKARTA",98,83,118,201
https://kawalpemilu.org#25976,"PALMERAH, PALMERAH, JAKARTA BARAT, DKI JAKARTA",99,107,112,219
https://kawalpemilu.org#25976,"PALMERAH, PALMERAH, JAKARTA BARAT, DKI JAKARTA",100,98,131,229
https://kawalpemilu.org#25976,"PALMERAH, PALMERAH, JAKARTA BARAT, DKI JAKARTA",101,116,139,255
https://kawalpemilu.org#25976,"PALMERAH, PALMERAH, JAKARTA BARAT, DKI JAKARTA",102,119,112,231
https://kawalpemilu.org#25976,"PALMERAH, PALMERAH, JAKARTA BARAT, DKI JAKARTA",103,121,99,220
https://kawalpemilu.org#25976,"PALMERAH, PALMERAH, JAKARTA BARAT, DKI JAKARTA",104,140,85,225
https://kawalpemilu.org#25976,"PALMERAH, PALMERAH, JAKARTA BARAT, DKI JAKARTA",105,140,101,241
https://kawalpemilu.org#25976,"PALMERAH, PALMERAH, JAKARTA BARAT, DKI JAKARTA",106,121,122,243
https://kawalpemilu.org#25976,"PALMERAH, PALMERAH, JAKARTA BARAT, DKI JAKARTA",107,81,151,232
https://kawalpemilu.org#25976,"PALMERAH, PALMERAH, JAKARTA BARAT, DKI JAKARTA",108,105,85,190
https://kawalpemilu.org#25976,"PALMERAH, PALMERAH, JAKARTA BARAT, DKI JAKARTA",109,75,145,220
https://kawalpemilu.org#25976,"PALMERAH, PALMERAH, JAKARTA BARAT, DKI JAKARTA",110,63,132,195
https://kawalpemilu.org#25976,"PALMERAH, PALMERAH, JAKARTA BARAT, DKI JAKARTA",111,105,94,199
https://kawalpemilu.org#25976,"PALMERAH, PALMERAH, JAKARTA BARAT, DKI JAKARTA",112,128,77,205
https://kawalpemilu.org#25976,"PALMERAH, PALMERAH, JAKARTA BARAT, DKI JAKARTA",113,105,87,192
https://kawalpemilu.org#25976,"PALMERAH, PALMERAH, JAKARTA BARAT, DKI JAKARTA",114,84,95,179
https://kawalpemilu.org#25976,"PALMERAH, PALMERAH, JAKARTA BARAT, DKI JAKARTA",115,95,90,185
https://kawalpemilu.org#25976,"PALMERAH, PALMERAH, JAKARTA BARAT, DKI JAKARTA",116,99,131,230
https://kawalpemilu.org#25976,"PALMERAH, PALMERAH, JAKARTA BARAT, DKI JAKARTA",117,94,127,221
https://kawalpemilu.org#25976,"PALMERAH, PALMERAH, JAKARTA BARAT, DKI JAKARTA",118,122,102,224
https://kawalpemilu.org#25976,"PALMERAH, PALMERAH, JAKARTA BARAT, DKI JAKARTA",119,113,101,214
https://kawalpemilu.org#25976,"PALMERAH, PALMERAH, JAKARTA BARAT, DKI JAKARTA",120,132,92,224
https://kawalpemilu.org#25976,"PALMERAH, PALMERAH, JAKARTA BARAT, DKI JAKARTA",121,121,118,239
https://kawalpemilu.org#25976,"PALMERAH, PALMERAH, JAKARTA BARAT, DKI JAKARTA",122,73,89,162
https://kawalpemilu.org#25976,"PALMERAH, PALMERAH, JAKARTA BARAT, DKI JAKARTA",123,88,104,192
https://kawalpemilu.org#25976,"PALMERAH, PALMERAH, JAKARTA BARAT, DKI JAKARTA",124,124,115,239
https://kawalpemilu.org#25976,"PALMERAH, PALMERAH, JAKARTA BARAT, DKI JAKARTA",125,106,153,259
https://kawalpemilu.org#25976,"PALMERAH, PALMERAH, JAKARTA BARAT, DKI JAKARTA",126,94,139,233
https://kawalpemilu.org#25976,"PALMERAH, PALMERAH, JAKARTA BARAT, DKI JAKARTA",127,62,164,226
https://kawalpemilu.org#25976,"PALMERAH, PALMERAH, JAKARTA BARAT, DKI JAKARTA",128,75,108,183
https://kawalpemilu.org#25976,"PALMERAH, PALMERAH, JAKARTA BARAT, DKI JAKARTA",129,55,144,199
https://kawalpemilu.org#25976,"PALMERAH, PALMERAH, JAKARTA BARAT, DKI JAKARTA",130,67,116,183
https://kawalpemilu.org#25976,"PALMERAH, PALMERAH, JAKARTA BARAT, DKI JAKARTA",131,73,154,227
https://kawalpemilu.org#25976,"PALMERAH, PALMERAH, JAKARTA BARAT, DKI JAKARTA",132,107,144,251
https://kawalpemilu.org#25976,"PALMERAH, PALMERAH, JAKARTA BARAT, DKI JAKARTA",133,98,145,243
https://kawalpemilu.org#25976,"PALMERAH, PALMERAH, JAKARTA BARAT, DKI JAKARTA",134,84,167,251
https://kawalpemilu.org#25976,"PALMERAH, PALMERAH, JAKARTA BARAT, DKI JAKARTA",135,96,172,268
https://kawalpemilu.org#25976,"PALMERAH, PALMERAH, JAKARTA BARAT, DKI JAKARTA",136,70,161,231
https://kawalpemilu.org#25976,"PALMERAH, PALMERAH, JAKARTA BARAT, DKI JAKARTA",137,83,145,228
https://kawalpemilu.org#25976,"PALMERAH, PALMERAH, JAKARTA BARAT, DKI JAKARTA",138,78,158,236
https://kawalpemilu.org#25976,"PALMERAH, PALMERAH, JAKARTA BARAT, DKI JAKARTA",139,99,160,259
https://kawalpemilu.org#25976,"PALMERAH, PALMERAH, JAKARTA BARAT, DKI JAKARTA",140,76,182,258
https://kawalpemilu.org#25976,"PALMERAH, PALMERAH, JAKARTA BARAT, DKI JAKARTA",141,77,200,277
https://kawalpemilu.org#25976,"PALMERAH, PALMERAH, JAKARTA BARAT, DKI JAKARTA",142,77,173,250
https://kawalpemilu.org#25976,"PALMERAH, PALMERAH, JAKARTA BARAT, DKI JAKARTA",143,73,134,207
https://kawalpemilu.org#25976,"PALMERAH, PALMERAH, JAKARTA BARAT, DKI JAKARTA",144,85,121,206
https://kawalpemilu.org#25976,"PALMERAH, PALMERAH, JAKARTA BARAT, DKI JAKARTA",145,67,129,196
https://kawalpemilu.org#25976,"PALMERAH, PALMERAH, JAKARTA BARAT, DKI JAKARTA",146,77,118,195
https://kawalpemilu.org#25976,"PALMERAH, PALMERAH, JAKARTA BARAT, DKI JAKARTA",147,108,108,216
https://kawalpemilu.org#25976,"PALMERAH, PALMERAH, JAKARTA BARAT, DKI JAKARTA",148,96,176,272
https://kawalpemilu.org#25976,"PALMERAH, PALMERAH, JAKARTA BARAT, DKI JAKARTA",149,99,131,230
https://kawalpemilu.org#25976,"PALMERAH, PALMERAH, JAKARTA BARAT, DKI JAKARTA",150,94,147,241
https://kawalpemilu.org#25976,"PALMERAH, PALMERAH, JAKARTA BARAT, DKI JAKARTA",151,121,159,280
https://kawalpemilu.org#25976,"PALMERAH, PALMERAH, JAKARTA BARAT, DKI JAKARTA",152,119,185,304
https://kawalpemilu.org#25976,"PALMERAH, PALMERAH, JAKARTA BARAT, DKI JAKARTA",153,75,194,269
https://kawalpemilu.org#25976,"PALMERAH, PALMERAH, JAKARTA BARAT, DKI JAKARTA",154,106,143,249
https://kawalpemilu.org#25976,"PALMERAH, PALMERAH, JAKARTA BARAT, DKI JAKARTA",155,126,95,221
https://kawalpemilu.org#25976,"PALMERAH, PALMERAH, JAKARTA BARAT, DKI JAKARTA",156,102,105,207
https://kawalpemilu.org#25976,"PALMERAH, PALMERAH, JAKARTA BARAT, DKI JAKARTA",157,72,126,198
https://kawalpemilu.org#25976,"PALMERAH, PALMERAH, JAKARTA BARAT, DKI JAKARTA",158,89,124,213
https://kawalpemilu.org#25976,"PALMERAH, PALMERAH, JAKARTA BARAT, DKI JAKARTA",159,131,113,244
https://kawalpemilu.org#25976,"PALMERAH, PALMERAH, JAKARTA BARAT, DKI JAKARTA",160,81,155,236
https://kawalpemilu.org#25976,"PALMERAH, PALMERAH, JAKARTA BARAT, DKI JAKARTA",161,84,132,216
https://kawalpemilu.org#25976,"PALMERAH, PALMERAH, JAKARTA BARAT, DKI JAKARTA",162,73,99,172
https://kawalpemilu.org#25976,"PALMERAH, PALMERAH, JAKARTA BARAT, DKI JAKARTA",163,105,130,235
https://kawalpemilu.org#25976,"PALMERAH, PALMERAH, JAKARTA BARAT, DKI JAKARTA",164,115,126,241
https://kawalpemilu.org#25976,"PALMERAH, PALMERAH, JAKARTA BARAT, DKI JAKARTA",165,112,125,237
https://kawalpemilu.org#25976,"PALMERAH, PALMERAH, JAKARTA BARAT, DKI JAKARTA",166,119,138,257
https://kawalpemilu.org#25976,"PALMERAH, PALMERAH, JAKARTA BARAT, DKI JAKARTA",167,74,139,213
https://kawalpemilu.org#25976,"PALMERAH, PALMERAH, JAKARTA BARAT, DKI JAKARTA",168,82,122,204
https://kawalpemilu.org#25976,"PALMERAH, PALMERAH, JAKARTA BARAT, DKI JAKARTA",169,84,118,202
https://kawalpemilu.org#25976,"PALMERAH, PALMERAH, JAKARTA BARAT, DKI JAKARTA",170,115,102,217
https://kawalpemilu.org#25976,"PALMERAH, PALMERAH, JAKARTA BARAT, DKI JAKARTA",171,91,103,194
https://kawalpemilu.org#25976,"PALMERAH, PALMERAH, JAKARTA BARAT, DKI JAKARTA",172,118,82,200
https://kawalpemilu.org#25976,"PALMERAH, PALMERAH, JAKARTA BARAT, DKI JAKARTA",173,155,58,213
https://kawalpemilu.org#25976,"PALMERAH, PALMERAH, JAKARTA BARAT, DKI JAKARTA",174,151,46,197
https://kawalpemilu.org#25976,"PALMERAH, PALMERAH, JAKARTA BARAT, DKI JAKARTA",175,132,68,200
https://kawalpemilu.org#25976,"PALMERAH, PALMERAH, JAKARTA BARAT, DKI JAKARTA",176,104,107,211
https://kawalpemilu.org#25976,"PALMERAH, PALMERAH, JAKARTA BARAT, DKI JAKARTA",177,29,198,227
https://kawalpemilu.org#25976,"PALMERAH, PALMERAH, JAKARTA BARAT, DKI JAKARTA",178,69,133,202
https://kawalpemilu.org#25976,"PALMERAH, PALMERAH, JAKARTA BARAT, DKI JAKARTA",179,74,170,244
https://kawalpemilu.org#25976,"PALMERAH, PALMERAH, JAKARTA BARAT, DKI JAKARTA",180,81,161,242
https://kawalpemilu.org#25976,"PALMERAH, PALMERAH, JAKARTA BARAT, DKI JAKARTA",181,83,156,239
https://kawalpemilu.org#25976,"PALMERAH, PALMERAH, JAKARTA BARAT, DKI JAKARTA",182,113,106,219
https://kawalpemilu.org#25976,"PALMERAH, PALMERAH, JAKARTA BARAT, DKI JAKARTA",183,99,140,239
https://kawalpemilu.org#25976,"PALMERAH, PALMERAH, JAKARTA BARAT, DKI JAKARTA",184,113,108,221
https://kawalpemilu.org#25976,"PALMERAH, PALMERAH, JAKARTA BARAT, DKI JAKARTA",185,163,59,222
https://kawalpemilu.org#25976,"PALMERAH, PALMERAH, JAKARTA BARAT, DKI JAKARTA",186,134,71,205
https://kawalpemilu.org#25976,"PALMERAH, PALMERAH, JAKARTA BARAT, DKI JAKARTA",187,152,66,218
https://kawalpemilu.org#25976,"PALMERAH, PALMERAH, JAKARTA BARAT, DKI JAKARTA",188,168,63,231
https://kawalpemilu.org#25976,"PALMERAH, PALMERAH, JAKARTA BARAT, DKI JAKARTA",189,109,100,209
https://kawalpemilu.org#25976,"PALMERAH, PALMERAH, JAKARTA BARAT, DKI JAKARTA",190,173,43,216
https://kawalpemilu.org#25976,"PALMERAH, PALMERAH, JAKARTA BARAT, DKI JAKARTA",191,131,65,196
https://kawalpemilu.org#25976,"PALMERAH, PALMERAH, JAKARTA BARAT, DKI JAKARTA",192,85,113,198
https://kawalpemilu.org#25976,"PALMERAH, PALMERAH, JAKARTA BARAT, DKI JAKARTA",193,96,114,210
https://kawalpemilu.org#25976,"PALMERAH, PALMERAH, JAKARTA BARAT, DKI JAKARTA",194,93,145,238
https://kawalpemilu.org#25976,"PALMERAH, PALMERAH, JAKARTA BARAT, DKI JAKARTA",195,102,151,253
https://kawalpemilu.org#25976,"PALMERAH, PALMERAH, JAKARTA BARAT, DKI JAKARTA",196,82,139,221
https://kawalpemilu.org#25976,"PALMERAH, PALMERAH, JAKARTA BARAT, DKI JAKARTA",197,80,163,243
https://kawalpemilu.org#25976,"PALMERAH, PALMERAH, JAKARTA BARAT, DKI JAKARTA",198,64,156,220
https://kawalpemilu.org#25976,"PALMERAH, PALMERAH, JAKARTA BARAT, DKI JAKARTA",199,88,166,254
https://kawalpemilu.org#25976,"PALMERAH, PALMERAH, JAKARTA BARAT, DKI JAKARTA",200,84,181,266
https://kawalpemilu.org#25976,"PALMERAH, PALMERAH, JAKARTA BARAT, DKI JAKARTA",201,70,159,229
https://kawalpemilu.org#25976,"PALMERAH, PALMERAH, JAKARTA BARAT, DKI JAKARTA",202,82,140,222
https://kawalpemilu.org#25976,"PALMERAH, PALMERAH, JAKARTA BARAT, DKI JAKARTA",203,94,128,205
https://kawalpemilu.org#25976,"PALMERAH, PALMERAH, JAKARTA BARAT, DKI JAKARTA",204,101,126,227
https://kawalpemilu.org#25976,"PALMERAH, PALMERAH, JAKARTA BARAT, DKI JAKARTA",205,127,105,232
https://kawalpemilu.org#25976,"PALMERAH, PALMERAH, JAKARTA BARAT, DKI JAKARTA",206,91,113,204
https://kawalpemilu.org#25976,"PALMERAH, PALMERAH, JAKARTA BARAT, DKI JAKARTA",207,102,115,217
https://kawalpemilu.org#25976,"PALMERAH, PALMERAH, JAKARTA BARAT, DKI JAKARTA",208,89,124,213
https://kawalpemilu.org#25977,"SLIPI, PALMERAH, JAKARTA BARAT, DKI JAKARTA",1,93,46,139
https://kawalpemilu.org#25977,"SLIPI, PALMERAH, JAKARTA BARAT, DKI JAKARTA",2,161,18,179
https://kawalpemilu.org#25977,"SLIPI, PALMERAH, JAKARTA BARAT, DKI JAKARTA",3,162,17,179
https://kawalpemilu.org#25977,"SLIPI, PALMERAH, JAKARTA BARAT, DKI JAKARTA",4,142,71,213
https://kawalpemilu.org#25977,"SLIPI, PALMERAH, JAKARTA BARAT, DKI JAKARTA",5,138,58,196
https://kawalpemilu.org#25977,"SLIPI, PALMERAH, JAKARTA BARAT, DKI JAKARTA",6,86,128,214
https://kawalpemilu.org#25977,"SLIPI, PALMERAH, JAKARTA BARAT, DKI JAKARTA",7,99,103,202
https://kawalpemilu.org#25977,"SLIPI, PALMERAH, JAKARTA BARAT, DKI JAKARTA",8,73,103,176
https://kawalpemilu.org#25977,"SLIPI, PALMERAH, JAKARTA BARAT, DKI JAKARTA",9,72,166,238
https://kawalpemilu.org#25977,"SLIPI, PALMERAH, JAKARTA BARAT, DKI JAKARTA",10,115,114,229
https://kawalpemilu.org#25977,"SLIPI, PALMERAH, JAKARTA BARAT, DKI JAKARTA",11,106,100,206
https://kawalpemilu.org#25977,"SLIPI, PALMERAH, JAKARTA BARAT, DKI JAKARTA",12,81,130,211
https://kawalpemilu.org#25977,"SLIPI, PALMERAH, JAKARTA BARAT, DKI JAKARTA",13,67,121,188
https://kawalpemilu.org#25977,"SLIPI, PALMERAH, JAKARTA BARAT, DKI JAKARTA",14,95,134,229
https://kawalpemilu.org#25977,"SLIPI, PALMERAH, JAKARTA BARAT, DKI JAKARTA",15,63,155,218
https://kawalpemilu.org#25977,"SLIPI, PALMERAH, JAKARTA BARAT, DKI JAKARTA",16,89,125,214
https://kawalpemilu.org#25977,"SLIPI, PALMERAH, JAKARTA BARAT, DKI JAKARTA",17,113,108,221
https://kawalpemilu.org#25977,"SLIPI, PALMERAH, JAKARTA BARAT, DKI JAKARTA",18,0,0,0
https://kawalpemilu.org#25977,"SLIPI, PALMERAH, JAKARTA BARAT, DKI JAKARTA",19,80,119,199
https://kawalpemilu.org#25977,"SLIPI, PALMERAH, JAKARTA BARAT, DKI JAKARTA",20,60,123,183
https://kawalpemilu.org#25977,"SLIPI, PALMERAH, JAKARTA BARAT, DKI JAKARTA",21,66,112,178
https://kawalpemilu.org#25977,"SLIPI, PALMERAH, JAKARTA BARAT, DKI JAKARTA",22,84,102,186
https://kawalpemilu.org#25977,"SLIPI, PALMERAH, JAKARTA BARAT, DKI JAKARTA",23,58,161,219
https://kawalpemilu.org#25977,"SLIPI, PALMERAH, JAKARTA BARAT, DKI JAKARTA",24,69,149,218
https://kawalpemilu.org#25977,"SLIPI, PALMERAH, JAKARTA BARAT, DKI JAKARTA",25,67,123,190
https://kawalpemilu.org#25977,"SLIPI, PALMERAH, JAKARTA BARAT, DKI JAKARTA",26,68,122,190
https://kawalpemilu.org#25977,"SLIPI, PALMERAH, JAKARTA BARAT, DKI JAKARTA",27,50,99,149
https://kawalpemilu.org#25977,"SLIPI, PALMERAH, JAKARTA BARAT, DKI JAKARTA",28,101,108,209
https://kawalpemilu.org#25977,"SLIPI, PALMERAH, JAKARTA BARAT, DKI JAKARTA",29,75,130,205
https://kawalpemilu.org#25977,"SLIPI, PALMERAH, JAKARTA BARAT, DKI JAKARTA",30,87,93,180
https://kawalpemilu.org#25977,"SLIPI, PALMERAH, JAKARTA BARAT, DKI JAKARTA",31,83,124,207
https://kawalpemilu.org#25977,"SLIPI, PALMERAH, JAKARTA BARAT, DKI JAKARTA",32,63,129,192
https://kawalpemilu.org#25977,"SLIPI, PALMERAH, JAKARTA BARAT, DKI JAKARTA",33,87,132,219
https://kawalpemilu.org#25977,"SLIPI, PALMERAH, JAKARTA BARAT, DKI JAKARTA",34,89,123,212
https://kawalpemilu.org#25977,"SLIPI, PALMERAH, JAKARTA BARAT, DKI JAKARTA",35,98,122,220
https://kawalpemilu.org#25977,"SLIPI, PALMERAH, JAKARTA BARAT, DKI JAKARTA",36,69,167,236
https://kawalpemilu.org#25977,"SLIPI, PALMERAH, JAKARTA BARAT, DKI JAKARTA",37,60,158,218
https://kawalpemilu.org#25977,"SLIPI, PALMERAH, JAKARTA BARAT, DKI JAKARTA",38,92,146,238
https://kawalpemilu.org#25977,"SLIPI, PALMERAH, JAKARTA BARAT, DKI JAKARTA",39,155,51,206
https://kawalpemilu.org#25977,"SLIPI, PALMERAH, JAKARTA BARAT, DKI JAKARTA",40,170,34,204
https://kawalpemilu.org#25977,"SLIPI, PALMERAH, JAKARTA BARAT, DKI JAKARTA",41,83,111,194
https://kawalpemilu.org#25977,"SLIPI, PALMERAH, JAKARTA BARAT, DKI JAKARTA",42,119,85,204
https://kawalpemilu.org#25977,"SLIPI, PALMERAH, JAKARTA BARAT, DKI JAKARTA",43,107,88,195
https://kawalpemilu.org#25977,"SLIPI, PALMERAH, JAKARTA BARAT, DKI JAKARTA",44,104,88,192
https://kawalpemilu.org#25977,"SLIPI, PALMERAH, JAKARTA BARAT, DKI JAKARTA",45,56,152,208
https://kawalpemilu.org#25977,"SLIPI, PALMERAH, JAKARTA BARAT, DKI JAKARTA",46,91,96,187
https://kawalpemilu.org#25977,"SLIPI, PALMERAH, JAKARTA BARAT, DKI JAKARTA",47,165,57,222
https://kawalpemilu.org#25977,"SLIPI, PALMERAH, JAKARTA BARAT, DKI JAKARTA",48,171,76,247
https://kawalpemilu.org#25977,"SLIPI, PALMERAH, JAKARTA BARAT, DKI JAKARTA",49,140,36,176
https://kawalpemilu.org#25977,"SLIPI, PALMERAH, JAKARTA BARAT, DKI JAKARTA",50,157,78,235
https://kawalpemilu.org#25977,"SLIPI, PALMERAH, JAKARTA BARAT, DKI JAKARTA",51,144,74,218
https://kawalpemilu.org#25977,"SLIPI, PALMERAH, JAKARTA BARAT, DKI JAKARTA",52,153,54,207
https://kawalpemilu.org#25977,"SLIPI, PALMERAH, JAKARTA BARAT, DKI JAKARTA",53,105,94,199
https://kawalpemilu.org#25977,"SLIPI, PALMERAH, JAKARTA BARAT, DKI JAKARTA",54,116,63,179
https://kawalpemilu.org#25977,"SLIPI, PALMERAH, JAKARTA BARAT, DKI JAKARTA",55,111,103,214
https://kawalpemilu.org#25977,"SLIPI, PALMERAH, JAKARTA BARAT, DKI JAKARTA",56,112,123,235
https://kawalpemilu.org#25977,"SLIPI, PALMERAH, JAKARTA BARAT, DKI JAKARTA",57,87,115,202
https://kawalpemilu.org#25977,"SLIPI, PALMERAH, JAKARTA BARAT, DKI JAKARTA",58,61,152,213
https://kawalpemilu.org#25977,"SLIPI, PALMERAH, JAKARTA BARAT, DKI JAKARTA",59,86,103,189
https://kawalpemilu.org#25977,"SLIPI, PALMERAH, JAKARTA BARAT, DKI JAKARTA",60,96,95,191
https://kawalpemilu.org#25978,"KOTA BAMBU UTARA, PALMERAH, JAKARTA BARAT, DKI JAKARTA",1,85,110,195
https://kawalpemilu.org#25978,"KOTA BAMBU UTARA, PALMERAH, JAKARTA BARAT, DKI JAKARTA",2,82,118,200
https://kawalpemilu.org#25978,"KOTA BAMBU UTARA, PALMERAH, JAKARTA BARAT, DKI JAKARTA",3,99,101,200
https://kawalpemilu.org#25978,"KOTA BAMBU UTARA, PALMERAH, JAKARTA BARAT, DKI JAKARTA",4,74,143,217
https://kawalpemilu.org#25978,"KOTA BAMBU UTARA, PALMERAH, JAKARTA BARAT, DKI JAKARTA",5,73,130,203
https://kawalpemilu.org#25978,"KOTA BAMBU UTARA, PALMERAH, JAKARTA BARAT, DKI JAKARTA",6,72,141,213
https://kawalpemilu.org#25978,"KOTA BAMBU UTARA, PALMERAH, JAKARTA BARAT, DKI JAKARTA",7,80,115,195
https://kawalpemilu.org#25978,"KOTA BAMBU UTARA, PALMERAH, JAKARTA BARAT, DKI JAKARTA",8,69,119,188
https://kawalpemilu.org#25978,"KOTA BAMBU UTARA, PALMERAH, JAKARTA BARAT, DKI JAKARTA",9,75,127,202
https://kawalpemilu.org#25978,"KOTA BAMBU UTARA, PALMERAH, JAKARTA BARAT, DKI JAKARTA",10,69,116,185
https://kawalpemilu.org#25978,"KOTA BAMBU UTARA, PALMERAH, JAKARTA BARAT, DKI JAKARTA",11,47,133,180
https://kawalpemilu.org#25978,"KOTA BAMBU UTARA, PALMERAH, JAKARTA BARAT, DKI JAKARTA",12,57,113,170
https://kawalpemilu.org#25978,"KOTA BAMBU UTARA, PALMERAH, JAKARTA BARAT, DKI JAKARTA",13,82,151,233
https://kawalpemilu.org#25978,"KOTA BAMBU UTARA, PALMERAH, JAKARTA BARAT, DKI JAKARTA",14,52,148,200
https://kawalpemilu.org#25978,"KOTA BAMBU UTARA, PALMERAH, JAKARTA BARAT, DKI JAKARTA",15,64,131,195
https://kawalpemilu.org#25978,"KOTA BAMBU UTARA, PALMERAH, JAKARTA BARAT, DKI JAKARTA",16,60,137,197
https://kawalpemilu.org#25978,"KOTA BAMBU UTARA, PALMERAH, JAKARTA BARAT, DKI JAKARTA",17,56,134,190
https://kawalpemilu.org#25978,"KOTA BAMBU UTARA, PALMERAH, JAKARTA BARAT, DKI JAKARTA",18,66,122,188
https://kawalpemilu.org#25978,"KOTA BAMBU UTARA, PALMERAH, JAKARTA BARAT, DKI JAKARTA",19,82,119,201
https://kawalpemilu.org#25978,"KOTA BAMBU UTARA, PALMERAH, JAKARTA BARAT, DKI JAKARTA",20,41,168,209
https://kawalpemilu.org#25978,"KOTA BAMBU UTARA, PALMERAH, JAKARTA BARAT, DKI JAKARTA",21,95,123,218
https://kawalpemilu.org#25978,"KOTA BAMBU UTARA, PALMERAH, JAKARTA BARAT, DKI JAKARTA",22,68,130,198
https://kawalpemilu.org#25978,"KOTA BAMBU UTARA, PALMERAH, JAKARTA BARAT, DKI JAKARTA",23,49,158,207
https://kawalpemilu.org#25978,"KOTA BAMBU UTARA, PALMERAH, JAKARTA BARAT, DKI JAKARTA",24,59,125,184
https://kawalpemilu.org#25978,"KOTA BAMBU UTARA, PALMERAH, JAKARTA BARAT, DKI JAKARTA",25,54,110,164
https://kawalpemilu.org#25978,"KOTA BAMBU UTARA, PALMERAH, JAKARTA BARAT, DKI JAKARTA",26,46,140,186
https://kawalpemilu.org#25978,"KOTA BAMBU UTARA, PALMERAH, JAKARTA BARAT, DKI JAKARTA",27,77,133,210
https://kawalpemilu.org#25978,"KOTA BAMBU UTARA, PALMERAH, JAKARTA BARAT, DKI JAKARTA",28,96,107,203
https://kawalpemilu.org#25978,"KOTA BAMBU UTARA, PALMERAH, JAKARTA BARAT, DKI JAKARTA",29,75,142,217
https://kawalpemilu.org#25978,"KOTA BAMBU UTARA, PALMERAH, JAKARTA BARAT, DKI JAKARTA",30,45,157,202
https://kawalpemilu.org#25978,"KOTA BAMBU UTARA, PALMERAH, JAKARTA BARAT, DKI JAKARTA",31,75,126,201
https://kawalpemilu.org#25978,"KOTA BAMBU UTARA, PALMERAH, JAKARTA BARAT, DKI JAKARTA",32,80,138,218
https://kawalpemilu.org#25978,"KOTA BAMBU UTARA, PALMERAH, JAKARTA BARAT, DKI JAKARTA",33,93,135,228
https://kawalpemilu.org#25978,"KOTA BAMBU UTARA, PALMERAH, JAKARTA BARAT, DKI JAKARTA",34,55,137,192
https://kawalpemilu.org#25978,"KOTA BAMBU UTARA, PALMERAH, JAKARTA BARAT, DKI JAKARTA",35,65,170,235
https://kawalpemilu.org#25978,"KOTA BAMBU UTARA, PALMERAH, JAKARTA BARAT, DKI JAKARTA",36,83,107,190
https://kawalpemilu.org#25978,"KOTA BAMBU UTARA, PALMERAH, JAKARTA BARAT, DKI JAKARTA",37,88,116,204
https://kawalpemilu.org#25978,"KOTA BAMBU UTARA, PALMERAH, JAKARTA BARAT, DKI JAKARTA",38,68,131,199
https://kawalpemilu.org#25978,"KOTA BAMBU UTARA, PALMERAH, JAKARTA BARAT, DKI JAKARTA",39,85,131,216
https://kawalpemilu.org#25978,"KOTA BAMBU UTARA, PALMERAH, JAKARTA BARAT, DKI JAKARTA",40,81,119,200
https://kawalpemilu.org#25978,"KOTA BAMBU UTARA, PALMERAH, JAKARTA BARAT, DKI JAKARTA",41,62,103,165
https://kawalpemilu.org#25978,"KOTA BAMBU UTARA, PALMERAH, JAKARTA BARAT, DKI JAKARTA",42,56,121,177
https://kawalpemilu.org#25978,"KOTA BAMBU UTARA, PALMERAH, JAKARTA BARAT, DKI JAKARTA",43,37,153,190
https://kawalpemilu.org#25978,"KOTA BAMBU UTARA, PALMERAH, JAKARTA BARAT, DKI JAKARTA",44,75,147,222
https://kawalpemilu.org#25978,"KOTA BAMBU UTARA, PALMERAH, JAKARTA BARAT, DKI JAKARTA",45,73,173,246
https://kawalpemilu.org#25978,"KOTA BAMBU UTARA, PALMERAH, JAKARTA BARAT, DKI JAKARTA",46,78,152,230
https://kawalpemilu.org#25978,"KOTA BAMBU UTARA, PALMERAH, JAKARTA BARAT, DKI JAKARTA",47,81,142,223
https://kawalpemilu.org#25978,"KOTA BAMBU UTARA, PALMERAH, JAKARTA BARAT, DKI JAKARTA",48,80,110,190
https://kawalpemilu.org#25978,"KOTA BAMBU UTARA, PALMERAH, JAKARTA BARAT, DKI JAKARTA",49,60,167,227
https://kawalpemilu.org#25978,"KOTA BAMBU UTARA, PALMERAH, JAKARTA BARAT, DKI JAKARTA",50,83,110,193
https://kawalpemilu.org#25978,"KOTA BAMBU UTARA, PALMERAH, JAKARTA BARAT, DKI JAKARTA",51,66,113,179
https://kawalpemilu.org#25978,"KOTA BAMBU UTARA, PALMERAH, JAKARTA BARAT, DKI JAKARTA",52,78,84,162
https://kawalpemilu.org#25978,"KOTA BAMBU UTARA, PALMERAH, JAKARTA BARAT, DKI JAKARTA",53,84,149,233
https://kawalpemilu.org#25978,"KOTA BAMBU UTARA, PALMERAH, JAKARTA BARAT, DKI JAKARTA",54,70,105,175
https://kawalpemilu.org#25978,"KOTA BAMBU UTARA, PALMERAH, JAKARTA BARAT, DKI JAKARTA",55,95,92,187
https://kawalpemilu.org#25978,"KOTA BAMBU UTARA, PALMERAH, JAKARTA BARAT, DKI JAKARTA",56,60,109,169
https://kawalpemilu.org#25978,"KOTA BAMBU UTARA, PALMERAH, JAKARTA BARAT, DKI JAKARTA",57,80,110,190
https://kawalpemilu.org#25978,"KOTA BAMBU UTARA, PALMERAH, JAKARTA BARAT, DKI JAKARTA",58,71,130,201
https://kawalpemilu.org#25978,"KOTA BAMBU UTARA, PALMERAH, JAKARTA BARAT, DKI JAKARTA",59,77,121,198
https://kawalpemilu.org#25978,"KOTA BAMBU UTARA, PALMERAH, JAKARTA BARAT, DKI JAKARTA",60,172,12,184
https://kawalpemilu.org#25978,"KOTA BAMBU UTARA, PALMERAH, JAKARTA BARAT, DKI JAKARTA",61,56,148,204
https://kawalpemilu.org#25978,"KOTA BAMBU UTARA, PALMERAH, JAKARTA BARAT, DKI JAKARTA",62,77,124,201
https://kawalpemilu.org#25978,"KOTA BAMBU UTARA, PALMERAH, JAKARTA BARAT, DKI JAKARTA",63,60,148,208
https://kawalpemilu.org#25978,"KOTA BAMBU UTARA, PALMERAH, JAKARTA BARAT, DKI JAKARTA",64,68,147,215
https://kawalpemilu.org#25978,"KOTA BAMBU UTARA, PALMERAH, JAKARTA BARAT, DKI JAKARTA",65,108,96,204
https://kawalpemilu.org#25978,"KOTA BAMBU UTARA, PALMERAH, JAKARTA BARAT, DKI JAKARTA",66,73,109,182
https://kawalpemilu.org#25978,"KOTA BAMBU UTARA, PALMERAH, JAKARTA BARAT, DKI JAKARTA",67,92,121,213
https://kawalpemilu.org#25978,"KOTA BAMBU UTARA, PALMERAH, JAKARTA BARAT, DKI JAKARTA",68,104,85,189
https://kawalpemilu.org#25978,"KOTA BAMBU UTARA, PALMERAH, JAKARTA BARAT, DKI JAKARTA",69,131,70,201
https://kawalpemilu.org#25978,"KOTA BAMBU UTARA, PALMERAH, JAKARTA BARAT, DKI JAKARTA",70,80,90,170
https://kawalpemilu.org#25978,"KOTA BAMBU UTARA, PALMERAH, JAKARTA BARAT, DKI JAKARTA",71,84,113,197
https://kawalpemilu.org#25978,"KOTA BAMBU UTARA, PALMERAH, JAKARTA BARAT, DKI JAKARTA",72,96,125,221
https://kawalpemilu.org#25978,"KOTA BAMBU UTARA, PALMERAH, JAKARTA BARAT, DKI JAKARTA",73,112,83,195
https://kawalpemilu.org#25978,"KOTA BAMBU UTARA, PALMERAH, JAKARTA BARAT, DKI JAKARTA",74,108,76,184
https://kawalpemilu.org#25978,"KOTA BAMBU UTARA, PALMERAH, JAKARTA BARAT, DKI JAKARTA",75,100,82,182
https://kawalpemilu.org#25978,"KOTA BAMBU UTARA, PALMERAH, JAKARTA BARAT, DKI JAKARTA",76,89,92,181
https://kawalpemilu.org#25978,"KOTA BAMBU UTARA, PALMERAH, JAKARTA BARAT, DKI JAKARTA",77,78,118,196
https://kawalpemilu.org#25978,"KOTA BAMBU UTARA, PALMERAH, JAKARTA BARAT, DKI JAKARTA",78,70,114,184
https://kawalpemilu.org#25978,"KOTA BAMBU UTARA, PALMERAH, JAKARTA BARAT, DKI JAKARTA",79,184,20,204
https://kawalpemilu.org#25978,"KOTA BAMBU UTARA, PALMERAH, JAKARTA BARAT, DKI JAKARTA",80,174,30,204
https://kawalpemilu.org#25978,"KOTA BAMBU UTARA, PALMERAH, JAKARTA BARAT, DKI JAKARTA",81,96,94,190
https://kawalpemilu.org#25978,"KOTA BAMBU UTARA, PALMERAH, JAKARTA BARAT, DKI JAKARTA",82,98,99,197
https://kawalpemilu.org#25978,"KOTA BAMBU UTARA, PALMERAH, JAKARTA BARAT, DKI JAKARTA",83,84,112,196
https://kawalpemilu.org#25978,"KOTA BAMBU UTARA, PALMERAH, JAKARTA BARAT, DKI JAKARTA",84,74,145,219
https://kawalpemilu.org#25978,"KOTA BAMBU UTARA, PALMERAH, JAKARTA BARAT, DKI JAKARTA",85,54,155,209
https://kawalpemilu.org#25978,"KOTA BAMBU UTARA, PALMERAH, JAKARTA BARAT, DKI JAKARTA",86,68,138,206
https://kawalpemilu.org#25978,"KOTA BAMBU UTARA, PALMERAH, JAKARTA BARAT, DKI JAKARTA",87,57,132,189
https://kawalpemilu.org#25978,"KOTA BAMBU UTARA, PALMERAH, JAKARTA BARAT, DKI JAKARTA",88,65,154,219
https://kawalpemilu.org#25978,"KOTA BAMBU UTARA, PALMERAH, JAKARTA BARAT, DKI JAKARTA",89,66,150,2
https://kawalpemilu.org#25979,"JATIPULO, PALMERAH, JAKARTA BARAT, DKI JAKARTA",1,115,37,152
https://kawalpemilu.org#25979,"JATIPULO, PALMERAH, JAKARTA BARAT, DKI JAKARTA",2,143,33,176
https://kawalpemilu.org#25979,"JATIPULO, PALMERAH, JAKARTA BARAT, DKI JAKARTA",3,146,55,201
https://kawalpemilu.org#25979,"JATIPULO, PALMERAH, JAKARTA BARAT, DKI JAKARTA",4,113,31,144
https://kawalpemilu.org#25979,"JATIPULO, PALMERAH, JAKARTA BARAT, DKI JAKARTA",5,116,47,163
https://kawalpemilu.org#25979,"JATIPULO, PALMERAH, JAKARTA BARAT, DKI JAKARTA",6,98,40,138
https://kawalpemilu.org#25979,"JATIPULO, PALMERAH, JAKARTA BARAT, DKI JAKARTA",7,149,14,163
https://kawalpemilu.org#25979,"JATIPULO, PALMERAH, JAKARTA BARAT, DKI JAKARTA",8,153,8,161
https://kawalpemilu.org#25979,"JATIPULO, PALMERAH, JAKARTA BARAT, DKI JAKARTA",9,151,12,163
https://kawalpemilu.org#25979,"JATIPULO, PALMERAH, JAKARTA BARAT, DKI JAKARTA",10,155,22,177
https://kawalpemilu.org#25979,"JATIPULO, PALMERAH, JAKARTA BARAT, DKI JAKARTA",11,117,60,177
https://kawalpemilu.org#25979,"JATIPULO, PALMERAH, JAKARTA BARAT, DKI JAKARTA",12,105,89,194
https://kawalpemilu.org#25979,"JATIPULO, PALMERAH, JAKARTA BARAT, DKI JAKARTA",13,108,57,165
https://kawalpemilu.org#25979,"JATIPULO, PALMERAH, JAKARTA BARAT, DKI JAKARTA",14,113,69,182
https://kawalpemilu.org#25979,"JATIPULO, PALMERAH, JAKARTA BARAT, DKI JAKARTA",15,126,68,194
https://kawalpemilu.org#25979,"JATIPULO, PALMERAH, JAKARTA BARAT, DKI JAKARTA",16,127,39,166
https://kawalpemilu.org#25979,"JATIPULO, PALMERAH, JAKARTA BARAT, DKI JAKARTA",17,113,36,149
https://kawalpemilu.org#25979,"JATIPULO, PALMERAH, JAKARTA BARAT, DKI JAKARTA",18,102,77,179
https://kawalpemilu.org#25979,"JATIPULO, PALMERAH, JAKARTA BARAT, DKI JAKARTA",19,82,71,153
https://kawalpemilu.org#25979,"JATIPULO, PALMERAH, JAKARTA BARAT, DKI JAKARTA",20,111,60,171
https://kawalpemilu.org#25979,"JATIPULO, PALMERAH, JAKARTA BARAT, DKI JAKARTA",21,149,19,168
https://kawalpemilu.org#25979,"JATIPULO, PALMERAH, JAKARTA BARAT, DKI JAKARTA",22,114,73,187
https://kawalpemilu.org#25979,"JATIPULO, PALMERAH, JAKARTA BARAT, DKI JAKARTA",23,114,51,165
https://kawalpemilu.org#25979,"JATIPULO, PALMERAH, JAKARTA BARAT, DKI JAKARTA",24,115,56,171
https://kawalpemilu.org#25979,"JATIPULO, PALMERAH, JAKARTA BARAT, DKI JAKARTA",25,125,30,155
https://kawalpemilu.org#25979,"JATIPULO, PALMERAH, JAKARTA BARAT, DKI JAKARTA",26,129,54,183
https://kawalpemilu.org#25979,"JATIPULO, PALMERAH, JAKARTA BARAT, DKI JAKARTA",27,150,35,185
https://kawalpemilu.org#25979,"JATIPULO, PALMERAH, JAKARTA BARAT, DKI JAKARTA",28,56,126,182
https://kawalpemilu.org#25979,"JATIPULO, PALMERAH, JAKARTA BARAT, DKI JAKARTA",29,91,96,187
https://kawalpemilu.org#25979,"JATIPULO, PALMERAH, JAKARTA BARAT, DKI JAKARTA",30,77,128,205
https://kawalpemilu.org#25979,"JATIPULO, PALMERAH, JAKARTA BARAT, DKI JAKARTA",31,94,113,207
https://kawalpemilu.org#25979,"JATIPULO, PALMERAH, JAKARTA BARAT, DKI JAKARTA",32,96,94,190
https://kawalpemilu.org#25979,"JATIPULO, PALMERAH, JAKARTA BARAT, DKI JAKARTA",33,98,86,184
https://kawalpemilu.org#25979,"JATIPULO, PALMERAH, JAKARTA BARAT, DKI JAKARTA",34,100,86,186
https://kawalpemilu.org#25979,"JATIPULO, PALMERAH, JAKARTA BARAT, DKI JAKARTA",35,94,56,150
https://kawalpemilu.org#25979,"JATIPULO, PALMERAH, JAKARTA BARAT, DKI JAKARTA",36,98,89,187
https://kawalpemilu.org#25979,"JATIPULO, PALMERAH, JAKARTA BARAT, DKI JAKARTA",37,96,98,194
https://kawalpemilu.org#25979,"JATIPULO, PALMERAH, JAKARTA BARAT, DKI JAKARTA",38,101,95,196
https://kawalpemilu.org#25979,"JATIPULO, PALMERAH, JAKARTA BARAT, DKI JAKARTA",39,98,98,196
https://kawalpemilu.org#25979,"JATIPULO, PALMERAH, JAKARTA BARAT, DKI JAKARTA",40,83,109,192
https://kawalpemilu.org#25979,"JATIPULO, PALMERAH, JAKARTA BARAT, DKI JAKARTA",41,60,144,204
https://kawalpemilu.org#25979,"JATIPULO, PALMERAH, JAKARTA BARAT, DKI JAKARTA",42,62,144,206
https://kawalpemilu.org#25979,"JATIPULO, PALMERAH, JAKARTA BARAT, DKI JAKARTA",43,86,119,205
https://kawalpemilu.org#25979,"JATIPULO, PALMERAH, JAKARTA BARAT, DKI JAKARTA",44,88,131,219
https://kawalpemilu.org#25979,"JATIPULO, PALMERAH, JAKARTA BARAT, DKI JAKARTA",45,91,113,204
https://kawalpemilu.org#25979,"JATIPULO, PALMERAH, JAKARTA BARAT, DKI JAKARTA",46,110,100,210
https://kawalpemilu.org#25979,"JATIPULO, PALMERAH, JAKARTA BARAT, DKI JAKARTA",47,57,143,200
https://kawalpemilu.org#25979,"JATIPULO, PALMERAH, JAKARTA BARAT, DKI JAKARTA",48,61,158,219
https://kawalpemilu.org#25979,"JATIPULO, PALMERAH, JAKARTA BARAT, DKI JAKARTA",49,1,0,1
https://kawalpemilu.org#25979,"JATIPULO, PALMERAH, JAKARTA BARAT, DKI JAKARTA",50,101,118,219
https://kawalpemilu.org#25979,"JATIPULO, PALMERAH, JAKARTA BARAT, DKI JAKARTA",51,78,158,236
https://kawalpemilu.org#25979,"JATIPULO, PALMERAH, JAKARTA BARAT, DKI JAKARTA",52,99,105,204
https://kawalpemilu.org#25979,"JATIPULO, PALMERAH, JAKARTA BARAT, DKI JAKARTA",53,84,100,184
https://kawalpemilu.org#25979,"JATIPULO, PALMERAH, JAKARTA BARAT, DKI JAKARTA",54,87,130,217
https://kawalpemilu.org#25979,"JATIPULO, PALMERAH, JAKARTA BARAT, DKI JAKARTA",55,96,128,224
https://kawalpemilu.org#25979,"JATIPULO, PALMERAH, JAKARTA BARAT, DKI JAKARTA",56,111,75,186
https://kawalpemilu.org#25979,"JATIPULO, PALMERAH, JAKARTA BARAT, DKI JAKARTA",57,100,116,216
https://kawalpemilu.org#25979,"JATIPULO, PALMERAH, JAKARTA BARAT, DKI JAKARTA",58,85,111,196
https://kawalpemilu.org#25979,"JATIPULO, PALMERAH, JAKARTA BARAT, DKI JAKARTA",59,82,109,191
https://kawalpemilu.org#25979,"JATIPULO, PALMERAH, JAKARTA BARAT, DKI JAKARTA",60,94,103,197
https://kawalpemilu.org#25979,"JATIPULO, PALMERAH, JAKARTA BARAT, DKI JAKARTA",61,88,119,207
https://kawalpemilu.org#25979,"JATIPULO, PALMERAH, JAKARTA BARAT, DKI JAKARTA",62,105,119,224
https://kawalpemilu.org#25979,"JATIPULO, PALMERAH, JAKARTA BARAT, DKI JAKARTA",63,85,128,213
https://kawalpemilu.org#25979,"JATIPULO, PALMERAH, JAKARTA BARAT, DKI JAKARTA",64,77,99,176
https://kawalpemilu.org#25979,"JATIPULO, PALMERAH, JAKARTA BARAT, DKI JAKARTA",65,78,125,203
https://kawalpemilu.org#25979,"JATIPULO, PALMERAH, JAKARTA BARAT, DKI JAKARTA",66,123,112,235
https://kawalpemilu.org#25979,"JATIPULO, PALMERAH, JAKARTA BARAT, DKI JAKARTA",67,119,80,199
https://kawalpemilu.org#25979,"JATIPULO, PALMERAH, JAKARTA BARAT, DKI JAKARTA",68,113,92,205
https://kawalpemilu.org#25979,"JATIPULO, PALMERAH, JAKARTA BARAT, DKI JAKARTA",69,97,86,183
https://kawalpemilu.org#25979,"JATIPULO, PALMERAH, JAKARTA BARAT, DKI JAKARTA",70,96,110,206
https://kawalpemilu.org#25979,"JATIPULO, PALMERAH, JAKARTA BARAT, DKI JAKARTA",71,100,101,201
https://kawalpemilu.org#25979,"JATIPULO, PALMERAH, JAKARTA BARAT, DKI JAKARTA",72,117,94,211
https://kawalpemilu.org#25979,"JATIPULO, PALMERAH, JAKARTA BARAT, DKI JAKARTA",73,80,118,198
https://kawalpemilu.org#25979,"JATIPULO, PALMERAH, JAKARTA BARAT, DKI JAKARTA",74,73,116,189
https://kawalpemilu.org#25979,"JATIPULO, PALMERAH, JAKARTA BARAT, DKI JAKARTA",75,69,155,224
https://kawalpemilu.org#25979,"JATIPULO, PALMERAH, JAKARTA BARAT, DKI JAKARTA",76,85,110,195
https://kawalpemilu.org#25979,"JATIPULO, PALMERAH, JAKARTA BARAT, DKI JAKARTA",77,64,134,198
https://kawalpemilu.org#25979,"JATIPULO, PALMERAH, JAKARTA BARAT, DKI JAKARTA",78,60,135,195
https://kawalpemilu.org#25979,"JATIPULO, PALMERAH, JAKARTA BARAT, DKI JAKARTA",79,52,143,195
https://kawalpemilu.org#25979,"JATIPULO, PALMERAH, JAKARTA BARAT, DKI JAKARTA",80,57,143,200
https://kawalpemilu.org#25979,"JATIPULO, PALMERAH, JAKARTA BARAT, DKI JAKARTA",81,0,0,180
https://kawalpemilu.org#25979,"JATIPULO, PALMERAH, JAKARTA BARAT, DKI JAKARTA",82,60,141,201
https://kawalpemilu.org#25979,"JATIPULO, PALMERAH, JAKARTA BARAT, DKI JAKARTA",83,82,110,195
https://kawalpemilu.org#25979,"JATIPULO, PALMERAH, JAKARTA BARAT, DKI JAKARTA",84,80,133,213
https://kawalpemilu.org#25979,"JATIPULO, PALMERAH, JAKARTA BARAT, DKI JAKARTA",85,68,123,191
https://kawalpemilu.org#25979,"JATIPULO, PALMERAH, JAKARTA BARAT, DKI JAKARTA",86,87,108,195
https://kawalpemilu.org#25979,"JATIPULO, PALMERAH, JAKARTA BARAT, DKI JAKARTA",87,102,98,200
https://kawalpemilu.org#25979,"JATIPULO, PALMERAH, JAKARTA BARAT, DKI JAKARTA",88,58,142,200
https://kawalpemilu.org#25979,"JATIPULO, PALMERAH, JAKARTA BARAT, DKI JAKARTA",89,48,131,179
https://kawalpemilu.org#25979,"JATIPULO, PALMERAH, JAKARTA BARAT, DKI JAKARTA",90,61,130,191
https://kawalpemilu.org#25979,"JATIPULO, PALMERAH, JAKARTA BARAT, DKI JAKARTA",91,62,107,169
https://kawalpemilu.org#25979,"JATIPULO, PALMERAH, JAKARTA BARAT, DKI JAKARTA",92,73,130,203
https://kawalpemilu.org#25979,"JATIPULO, PALMERAH, JAKARTA BARAT, DKI JAKARTA",93,81,130,211
https://kawalpemilu.org#25979,"JATIPULO, PALMERAH, JAKARTA BARAT, DKI JAKARTA",94,103,82,185
https://kawalpemilu.org#25979,"JATIPULO, PALMERAH, JAKARTA BARAT, DKI JAKARTA",95,124,79,203
https://kawalpemilu.org#25979,"JATIPULO, PALMERAH, JAKARTA BARAT, DKI JAKARTA",96,97,105,202
https://kawalpemilu.org#25979,"JATIPULO, PALMERAH, JAKARTA BARAT, DKI JAKARTA",97,95,89,184
https://kawalpemilu.org#25979,"JATIPULO, PALMERAH, JAKARTA BARAT, DKI JAKARTA",98,107,94,201
https://kawalpemilu.org#25979,"JATIPULO, PALMERAH, JAKARTA BARAT, DKI JAKARTA",99,118,90,208
https://kawalpemilu.org#25979,"JATIPULO, PALMERAH, JAKARTA BARAT, DKI JAKARTA",100,94,81,175
https://kawalpemilu.org#25979,"JATIPULO, PALMERAH, JAKARTA BARAT, DKI JAKARTA",101,78,91,169
https://kawalpemilu.org#25979,"JATIPULO, PALMERAH, JAKARTA BARAT, DKI JAKARTA",102,75,86,161
https://kawalpemilu.org#25979,"JATIPULO, PALMERAH, JAKARTA BARAT, DKI JAKARTA",103,82,86,168
https://kawalpemilu.org#25979,"JATIPULO, PALMERAH, JAKARTA BARAT, DKI JAKARTA",104,74,75,149
https://kawalpemilu.org#25979,"JATIPULO, PALMERAH, JAKARTA BARAT, DKI JAKARTA",105,51,101,152
https://kawalpemilu.org#25979,"JATIPULO, PALMERAH, JAKARTA BARAT, DKI JAKARTA",106,53,120,173
https://kawalpemilu.org#25979,"JATIPULO, PALMERAH, JAKARTA BARAT, DKI JAKARTA",107,56,119,175
https://kawalpemilu.org#25979,"JATIPULO, PALMERAH, JAKARTA BARAT, DKI JAKARTA",108,65,125,190
https://kawalpemilu.org#25980,"KEMANGGISAN, PALMERAH, JAKARTA BARAT, DKI JAKARTA",1,93,90,183
https://kawalpemilu.org#25980,"KEMANGGISAN, PALMERAH, JAKARTA BARAT, DKI JAKARTA",2,149,55,204
https://kawalpemilu.org#25980,"KEMANGGISAN, PALMERAH, JAKARTA BARAT, DKI JAKARTA",3,98,78,176
https://kawalpemilu.org#25980,"KEMANGGISAN, PALMERAH, JAKARTA BARAT, DKI JAKARTA",4,117,84,201
https://kawalpemilu.org#25980,"KEMANGGISAN, PALMERAH, JAKARTA BARAT, DKI JAKARTA",5,132,85,217
https://kawalpemilu.org#25980,"KEMANGGISAN, PALMERAH, JAKARTA BARAT, DKI JAKARTA",6,137,82,219
https://kawalpemilu.org#25980,"KEMANGGISAN, PALMERAH, JAKARTA BARAT, DKI JAKARTA",7,110,64,174
https://kawalpemilu.org#25980,"KEMANGGISAN, PALMERAH, JAKARTA BARAT, DKI JAKARTA",8,97,142,239
https://kawalpemilu.org#25980,"KEMANGGISAN, PALMERAH, JAKARTA BARAT, DKI JAKARTA",9,117,84,201
https://kawalpemilu.org#25980,"KEMANGGISAN, PALMERAH, JAKARTA BARAT, DKI JAKARTA",10,106,80,186
https://kawalpemilu.org#25980,"KEMANGGISAN, PALMERAH, JAKARTA BARAT, DKI JAKARTA",11,138,74,212
https://kawalpemilu.org#25980,"KEMANGGISAN, PALMERAH, JAKARTA BARAT, DKI JAKARTA",12,113,84,197
https://kawalpemilu.org#25980,"KEMANGGISAN, PALMERAH, JAKARTA BARAT, DKI JAKARTA",13,147,80,227
https://kawalpemilu.org#25980,"KEMANGGISAN, PALMERAH, JAKARTA BARAT, DKI JAKARTA",14,137,74,211
https://kawalpemilu.org#25980,"KEMANGGISAN, PALMERAH, JAKARTA BARAT, DKI JAKARTA",15,132,78,210
https://kawalpemilu.org#25980,"KEMANGGISAN, PALMERAH, JAKARTA BARAT, DKI JAKARTA",16,85,81,165
https://kawalpemilu.org#25980,"KEMANGGISAN, PALMERAH, JAKARTA BARAT, DKI JAKARTA",17,147,52,199
https://kawalpemilu.org#25980,"KEMANGGISAN, PALMERAH, JAKARTA BARAT, DKI JAKARTA",18,113,74,187
https://kawalpemilu.org#25980,"KEMANGGISAN, PALMERAH, JAKARTA BARAT, DKI JAKARTA",19,116,106,222
https://kawalpemilu.org#25980,"KEMANGGISAN, PALMERAH, JAKARTA BARAT, DKI JAKARTA",20,120,95,215
https://kawalpemilu.org#25980,"KEMANGGISAN, PALMERAH, JAKARTA BARAT, DKI JAKARTA",21,136,80,216
https://kawalpemilu.org#25980,"KEMANGGISAN, PALMERAH, JAKARTA BARAT, DKI JAKARTA",22,109,82,191
https://kawalpemilu.org#25980,"KEMANGGISAN, PALMERAH, JAKARTA BARAT, DKI JAKARTA",23,66,116,182
https://kawalpemilu.org#25980,"KEMANGGISAN, PALMERAH, JAKARTA BARAT, DKI JAKARTA",24,89,106,195
https://kawalpemilu.org#25980,"KEMANGGISAN, PALMERAH, JAKARTA BARAT, DKI JAKARTA",25,94,112,206
https://kawalpemilu.org#25980,"KEMANGGISAN, PALMERAH, JAKARTA BARAT, DKI JAKARTA",26,88,94,182
https://kawalpemilu.org#25980,"KEMANGGISAN, PALMERAH, JAKARTA BARAT, DKI JAKARTA",27,116,78,194
https://kawalpemilu.org#25980,"KEMANGGISAN, PALMERAH, JAKARTA BARAT, DKI JAKARTA",28,97,87,184
https://kawalpemilu.org#25980,"KEMANGGISAN, PALMERAH, JAKARTA BARAT, DKI JAKARTA",29,87,92,179
https://kawalpemilu.org#25980,"KEMANGGISAN, PALMERAH, JAKARTA BARAT, DKI JAKARTA",30,91,53,144
https://kawalpemilu.org#25980,"KEMANGGISAN, PALMERAH, JAKARTA BARAT, DKI JAKARTA",31,109,96,205
https://kawalpemilu.org#25980,"KEMANGGISAN, PALMERAH, JAKARTA BARAT, DKI JAKARTA",32,74,106,180
https://kawalpemilu.org#25980,"KEMANGGISAN, PALMERAH, JAKARTA BARAT, DKI JAKARTA",33,99,88,187
https://kawalpemilu.org#25980,"KEMANGGISAN, PALMERAH, JAKARTA BARAT, DKI JAKARTA",34,85,136,221
https://kawalpemilu.org#25980,"KEMANGGISAN, PALMERAH, JAKARTA BARAT, DKI JAKARTA",35,77,121,198
https://kawalpemilu.org#25980,"KEMANGGISAN, PALMERAH, JAKARTA BARAT, DKI JAKARTA",36,96,89,185
https://kawalpemilu.org#25980,"KEMANGGISAN, PALMERAH, JAKARTA BARAT, DKI JAKARTA",37,121,137,258
https://kawalpemilu.org#25980,"KEMANGGISAN, PALMERAH, JAKARTA BARAT, DKI JAKARTA",38,101,132,233
https://kawalpemilu.org#25980,"KEMANGGISAN, PALMERAH, JAKARTA BARAT, DKI JAKARTA",39,118,114,232
https://kawalpemilu.org#25980,"KEMANGGISAN, PALMERAH, JAKARTA BARAT, DKI JAKARTA",40,113,111,224
https://kawalpemilu.org#25980,"KEMANGGISAN, PALMERAH, JAKARTA BARAT, DKI JAKARTA",41,116,128,244
https://kawalpemilu.org#25980,"KEMANGGISAN, PALMERAH, JAKARTA BARAT, DKI JAKARTA",42,99,151,250
https://kawalpemilu.org#25980,"KEMANGGISAN, PALMERAH, JAKARTA BARAT, DKI JAKARTA",43,111,132,243
https://kawalpemilu.org#25980,"KEMANGGISAN, PALMERAH, JAKARTA BARAT, DKI JAKARTA",44,129,94,223
https://kawalpemilu.org#25980,"KEMANGGISAN, PALMERAH, JAKARTA BARAT, DKI JAKARTA",45,111,110,221
https://kawalpemilu.org#25980,"KEMANGGISAN, PALMERAH, JAKARTA BARAT, DKI JAKARTA",46,109,122,231
https://kawalpemilu.org#25980,"KEMANGGISAN, PALMERAH, JAKARTA BARAT, DKI JAKARTA",47,92,127,219
https://kawalpemilu.org#25980,"KEMANGGISAN, PALMERAH, JAKARTA BARAT, DKI JAKARTA",48,91,125,216
https://kawalpemilu.org#25980,"KEMANGGISAN, PALMERAH, JAKARTA BARAT, DKI JAKARTA",49,83,137,220
https://kawalpemilu.org#25980,"KEMANGGISAN, PALMERAH, JAKARTA BARAT, DKI JAKARTA",50,67,147,214
https://kawalpemilu.org#25980,"KEMANGGISAN, PALMERAH, JAKARTA BARAT, DKI JAKARTA",51,99,128,227
https://kawalpemilu.org#25980,"KEMANGGISAN, PALMERAH, JAKARTA BARAT, DKI JAKARTA",52,106,134,240
https://kawalpemilu.org#25980,"KEMANGGISAN, PALMERAH, JAKARTA BARAT, DKI JAKARTA",53,73,120,193
https://kawalpemilu.org#25980,"KEMANGGISAN, PALMERAH, JAKARTA BARAT, DKI JAKARTA",54,76,129,205
https://kawalpemilu.org#25980,"KEMANGGISAN, PALMERAH, JAKARTA BARAT, DKI JAKARTA",55,83,153,236
https://kawalpemilu.org#25980,"KEMANGGISAN, PALMERAH, JAKARTA BARAT, DKI JAKARTA",56,109,122,231
https://kawalpemilu.org#25980,"KEMANGGISAN, PALMERAH, JAKARTA BARAT, DKI JAKARTA",57,107,141,248
https://kawalpemilu.org#25980,"KEMANGGISAN, PALMERAH, JAKARTA BARAT, DKI JAKARTA",58,91,157,248
https://kawalpemilu.org#25980,"KEMANGGISAN, PALMERAH, JAKARTA BARAT, DKI JAKARTA",59,118,112,230
https://kawalpemilu.org#25980,"KEMANGGISAN, PALMERAH, JAKARTA BARAT, DKI JAKARTA",60,93,135,228
https://kawalpemilu.org#25980,"KEMANGGISAN, PALMERAH, JAKARTA BARAT, DKI JAKARTA",61,87,161,248
https://kawalpemilu.org#25980,"KEMANGGISAN, PALMERAH, JAKARTA BARAT, DKI JAKARTA",62,102,158,260
https://kawalpemilu.org#25980,"KEMANGGISAN, PALMERAH, JAKARTA BARAT, DKI JAKARTA",63,118,113,0
https://kawalpemilu.org#25980,"KEMANGGISAN, PALMERAH, JAKARTA BARAT, DKI JAKARTA",64,155,79,234
https://kawalpemilu.org#25980,"KEMANGGISAN, PALMERAH, JAKARTA BARAT, DKI JAKARTA",65,88,141,229
https://kawalpemilu.org#25980,"KEMANGGISAN, PALMERAH, JAKARTA BARAT, DKI JAKARTA",66,180,62,242
https://kawalpemilu.org#25980,"KEMANGGISAN, PALMERAH, JAKARTA BARAT, DKI JAKARTA",67,123,115,238
https://kawalpemilu.org#25980,"KEMANGGISAN, PALMERAH, JAKARTA BARAT, DKI JAKARTA",68,132,122,254
https://kawalpemilu.org#25980,"KEMANGGISAN, PALMERAH, JAKARTA BARAT, DKI JAKARTA",69,132,101,233
https://kawalpemilu.org#25980,"KEMANGGISAN, PALMERAH, JAKARTA BARAT, DKI JAKARTA",70,138,74,212
https://kawalpemilu.org#25980,"KEMANGGISAN, PALMERAH, JAKARTA BARAT, DKI JAKARTA",71,112,77,189
https://kawalpemilu.org#25980,"KEMANGGISAN, PALMERAH, JAKARTA BARAT, DKI JAKARTA",72,180,43,223
https://kawalpemilu.org#25980,"KEMANGGISAN, PALMERAH, JAKARTA BARAT, DKI JAKARTA",73,101,116,217
https://kawalpemilu.org#25980,"KEMANGGISAN, PALMERAH, JAKARTA BARAT, DKI JAKARTA",74,102,123,225
https://kawalpemilu.org#25980,"KEMANGGISAN, PALMERAH, JAKARTA BARAT, DKI JAKARTA",75,90,142,232
https://kawalpemilu.org#25980,"KEMANGGISAN, PALMERAH, JAKARTA BARAT, DKI JAKARTA",76,94,112,206
https://kawalpemilu.org#25980,"KEMANGGISAN, PALMERAH, JAKARTA BARAT, DKI JAKARTA",77,78,105,183
https://kawalpemilu.org#25980,"KEMANGGISAN, PALMERAH, JAKARTA BARAT, DKI JAKARTA",78,110,116,226
https://kawalpemilu.org#25980,"KEMANGGISAN, PALMERAH, JAKARTA BARAT, DKI JAKARTA",79,107,94,201
https://kawalpemilu.org#25980,"KEMANGGISAN, PALMERAH, JAKARTA BARAT, DKI JAKARTA",80,90,154,244
https://kawalpemilu.org#25980,"KEMANGGISAN, PALMERAH, JAKARTA BARAT, DKI JAKARTA",81,100,155,255
https://kawalpemilu.org#25980,"KEMANGGISAN, PALMERAH, JAKARTA BARAT, DKI JAKARTA",82,82,146,228
https://kawalpemilu.org#25980,"KEMANGGISAN, PALMERAH, JAKARTA BARAT, DKI JAKARTA",83,85,125,210
https://kawalpemilu.org#25980,"KEMANGGISAN, PALMERAH, JAKARTA BARAT, DKI JAKARTA",84,106,140,246
https://kawalpemilu.org#25980,"KEMANGGISAN, PALMERAH, JAKARTA BARAT, DKI JAKARTA",85,155,72,227
https://kawalpemilu.org#25980,"KEMANGGISAN, PALMERAH, JAKARTA BARAT, DKI JAKARTA",86,114,92,206
https://kawalpemilu.org#25980,"KEMANGGISAN, PALMERAH, JAKARTA BARAT, DKI JAKARTA",87,127,74,201
https://kawalpemilu.org#25980,"KEMANGGISAN, PALMERAH, JAKARTA BARAT, DKI JAKARTA",88,133,85,218
https://kawalpemilu.org#25980,"KEMANGGISAN, PALMERAH, JAKARTA BARAT, DKI JAKARTA",89,94,126,220
https://kawalpemilu.org#25980,"KEMANGGISAN, PALMERAH, JAKARTA BARAT, DKI JAKARTA",90,76,171,247
https://kawalpemilu.org#25980,"KEMANGGISAN, PALMERAH, JAKARTA BARAT, DKI JAKARTA",91,97,132,229
https://kawalpemilu.org#25980,"KEMANGGISAN, PALMERAH, JAKARTA BARAT, DKI JAKARTA",92,118,101,219
https://kawalpemilu.org#25980,"KEMANGGISAN, PALMERAH, JAKARTA BARAT, DKI JAKARTA",93,83,109,192
https://kawalpemilu.org#25980,"KEMANGGISAN, PALMERAH, JAKARTA BARAT, DKI JAKARTA",94,108,77,185
https://kawalpemilu.org#25980,"KEMANGGISAN, PALMERAH, JAKARTA BARAT, DKI JAKARTA",95,87,125,212
https://kawalpemilu.org#25980,"KEMANGGISAN, PALMERAH, JAKARTA BARAT, DKI JAKARTA",96,127,121,248
https://kawalpemilu.org#25980,"KEMANGGISAN, PALMERAH, JAKARTA BARAT, DKI JAKARTA",97,129,122,251
https://kawalpemilu.org#25980,"KEMANGGISAN, PALMERAH, JAKARTA BARAT, DKI JAKARTA",98,91,104,195
https://kawalpemilu.org#25980,"KEMANGGISAN, PALMERAH, JAKARTA BARAT, DKI JAKARTA",99,87,133,220
https://kawalpemilu.org#25980,"KEMANGGISAN, PALMERAH, JAKARTA BARAT, DKI JAKARTA",100,162,64,226
https://kawalpemilu.org#25980,"KEMANGGISAN, PALMERAH, JAKARTA BARAT, DKI JAKARTA",101,87,143,230
https://kawalpemilu.org#25980,"KEMANGGISAN, PALMERAH, JAKARTA BARAT, DKI JAKARTA",102,74,123,197
https://kawalpemilu.org#25980,"KEMANGGISAN, PALMERAH, JAKARTA BARAT, DKI JAKARTA",103,56,136,192
https://kawalpemilu.org#25980,"KEMANGGISAN, PALMERAH, JAKARTA BARAT, DKI JAKARTA",104,75,152,227
https://kawalpemilu.org#25980,"KEMANGGISAN, PALMERAH, JAKARTA BARAT, DKI JAKARTA",105,86,145,231
https://kawalpemilu.org#25980,"KEMANGGISAN, PALMERAH, JAKARTA BARAT, DKI JAKARTA",106,83,150,233
https://kawalpemilu.org#25980,"KEMANGGISAN, PALMERAH, JAKARTA BARAT, DKI JAKARTA",107,140,101,241
https://kawalpemilu.org#25980,"KEMANGGISAN, PALMERAH, JAKARTA BARAT, DKI JAKARTA",108,125,122,247
https://kawalpemilu.org#25980,"KEMANGGISAN, PALMERAH, JAKARTA BARAT, DKI JAKARTA",109,183,56,239
https://kawalpemilu.org#25980,"KEMANGGISAN, PALMERAH, JAKARTA BARAT, DKI JAKARTA",110,88,100,188
https://kawalpemilu.org#25981,"KOTA BAMBU SELATAN, PALMERAH, JAKARTA BARAT, DKI JAKARTA",1,84,120,204
https://kawalpemilu.org#25981,"KOTA BAMBU SELATAN, PALMERAH, JAKARTA BARAT, DKI JAKARTA",2,54,85,139
https://kawalpemilu.org#25981,"KOTA BAMBU SELATAN, PALMERAH, JAKARTA BARAT, DKI JAKARTA",3,49,151,200
https://kawalpemilu.org#25981,"KOTA BAMBU SELATAN, PALMERAH, JAKARTA BARAT, DKI JAKARTA",4,99,70,169
https://kawalpemilu.org#25981,"KOTA BAMBU SELATAN, PALMERAH, JAKARTA BARAT, DKI JAKARTA",5,75,111,186
https://kawalpemilu.org#25981,"KOTA BAMBU SELATAN, PALMERAH, JAKARTA BARAT, DKI JAKARTA",6,156,61,217
https://kawalpemilu.org#25981,"KOTA BAMBU SELATAN, PALMERAH, JAKARTA BARAT, DKI JAKARTA",7,104,53,157
https://kawalpemilu.org#25981,"KOTA BAMBU SELATAN, PALMERAH, JAKARTA BARAT, DKI JAKARTA",8,77,105,182
https://kawalpemilu.org#25981,"KOTA BAMBU SELATAN, PALMERAH, JAKARTA BARAT, DKI JAKARTA",9,64,135,199
https://kawalpemilu.org#25981,"KOTA BAMBU SELATAN, PALMERAH, JAKARTA BARAT, DKI JAKARTA",10,60,178,238
https://kawalpemilu.org#25981,"KOTA BAMBU SELATAN, PALMERAH, JAKARTA BARAT, DKI JAKARTA",11,103,74,177
https://kawalpemilu.org#25981,"KOTA BAMBU SELATAN, PALMERAH, JAKARTA BARAT, DKI JAKARTA",12,65,76,141
https://kawalpemilu.org#25981,"KOTA BAMBU SELATAN, PALMERAH, JAKARTA BARAT, DKI JAKARTA",13,72,82,154
https://kawalpemilu.org#25981,"KOTA BAMBU SELATAN, PALMERAH, JAKARTA BARAT, DKI JAKARTA",14,59,156,215
https://kawalpemilu.org#25981,"KOTA BAMBU SELATAN, PALMERAH, JAKARTA BARAT, DKI JAKARTA",15,72,90,162
https://kawalpemilu.org#25981,"KOTA BAMBU SELATAN, PALMERAH, JAKARTA BARAT, DKI JAKARTA",16,75,111,186
https://kawalpemilu.org#25981,"KOTA BAMBU SELATAN, PALMERAH, JAKARTA BARAT, DKI JAKARTA",17,50,141,191
https://kawalpemilu.org#25981,"KOTA BAMBU SELATAN, PALMERAH, JAKARTA BARAT, DKI JAKARTA",18,55,104,159
https://kawalpemilu.org#25981,"KOTA BAMBU SELATAN, PALMERAH, JAKARTA BARAT, DKI JAKARTA",19,49,96,145
https://kawalpemilu.org#25981,"KOTA BAMBU SELATAN, PALMERAH, JAKARTA BARAT, DKI JAKARTA",20,172,59,231
https://kawalpemilu.org#25981,"KOTA BAMBU SELATAN, PALMERAH, JAKARTA BARAT, DKI JAKARTA",21,93,116,209
https://kawalpemilu.org#25981,"KOTA BAMBU SELATAN, PALMERAH, JAKARTA BARAT, DKI JAKARTA",22,59,164,223
https://kawalpemilu.org#25981,"KOTA BAMBU SELATAN, PALMERAH, JAKARTA BARAT, DKI JAKARTA",23,71,176,247
https://kawalpemilu.org#25981,"KOTA BAMBU SELATAN, PALMERAH, JAKARTA BARAT, DKI JAKARTA",24,79,172,251
https://kawalpemilu.org#25981,"KOTA BAMBU SELATAN, PALMERAH, JAKARTA BARAT, DKI JAKARTA",25,35,181,216
https://kawalpemilu.org#25981,"KOTA BAMBU SELATAN, PALMERAH, JAKARTA BARAT, DKI JAKARTA",26,81,119,200
https://kawalpemilu.org#25981,"KOTA BAMBU SELATAN, PALMERAH, JAKARTA BARAT, DKI JAKARTA",27,53,148,201
https://kawalpemilu.org#25981,"KOTA BAMBU SELATAN, PALMERAH, JAKARTA BARAT, DKI JAKARTA",28,67,140,207
https://kawalpemilu.org#25981,"KOTA BAMBU SELATAN, PALMERAH, JAKARTA BARAT, DKI JAKARTA",29,73,138,211
https://kawalpemilu.org#25981,"KOTA BAMBU SELATAN, PALMERAH, JAKARTA BARAT, DKI JAKARTA",30,88,95,183
https://kawalpemilu.org#25981,"KOTA BAMBU SELATAN, PALMERAH, JAKARTA BARAT, DKI JAKARTA",31,88,110,198
https://kawalpemilu.org#25981,"KOTA BAMBU SELATAN, PALMERAH, JAKARTA BARAT, DKI JAKARTA",32,96,84,180
https://kawalpemilu.org#25981,"KOTA BAMBU SELATAN, PALMERAH, JAKARTA BARAT, DKI JAKARTA",33,49,136,185
https://kawalpemilu.org#25981,"KOTA BAMBU SELATAN, PALMERAH, JAKARTA BARAT, DKI JAKARTA",34,101,128,229
https://kawalpemilu.org#25981,"KOTA BAMBU SELATAN, PALMERAH, JAKARTA BARAT, DKI JAKARTA",35,107,89,196
https://kawalpemilu.org#25981,"KOTA BAMBU SELATAN, PALMERAH, JAKARTA BARAT, DKI JAKARTA",36,68,134,202
https://kawalpemilu.org#25981,"KOTA BAMBU SELATAN, PALMERAH, JAKARTA BARAT, DKI JAKARTA",37,77,109,186
https://kawalpemilu.org#25981,"KOTA BAMBU SELATAN, PALMERAH, JAKARTA BARAT, DKI JAKARTA",38,42,146,188
https://kawalpemilu.org#25981,"KOTA BAMBU SELATAN, PALMERAH, JAKARTA BARAT, DKI JAKARTA",39,43,169,212
https://kawalpemilu.org#25981,"KOTA BAMBU SELATAN, PALMERAH, JAKARTA BARAT, DKI JAKARTA",40,66,159,225
https://kawalpemilu.org#25981,"KOTA BAMBU SELATAN, PALMERAH, JAKARTA BARAT, DKI JAKARTA",41,64,179,243
https://kawalpemilu.org#25981,"KOTA BAMBU SELATAN, PALMERAH, JAKARTA BARAT, DKI JAKARTA",42,76,169,245
https://kawalpemilu.org#25981,"KOTA BAMBU SELATAN, PALMERAH, JAKARTA BARAT, DKI JAKARTA",43,78,162,240
https://kawalpemilu.org#25981,"KOTA BAMBU SELATAN, PALMERAH, JAKARTA BARAT, DKI JAKARTA",44,76,136,212
https://kawalpemilu.org#25981,"KOTA BAMBU SELATAN, PALMERAH, JAKARTA BARAT, DKI JAKARTA",45,102,146,248
https://kawalpemilu.org#25981,"KOTA BAMBU SELATAN, PALMERAH, JAKARTA BARAT, DKI JAKARTA",46,93,124,217
https://kawalpemilu.org#25981,"KOTA BAMBU SELATAN, PALMERAH, JAKARTA BARAT, DKI JAKARTA",47,0,0,0
https://kawalpemilu.org#25981,"KOTA BAMBU SELATAN, PALMERAH, JAKARTA BARAT, DKI JAKARTA",48,86,155,241
https://kawalpemilu.org#25981,"KOTA BAMBU SELATAN, PALMERAH, JAKARTA BARAT, DKI JAKARTA",49,99,122,221
https://kawalpemilu.org#25981,"KOTA BAMBU SELATAN, PALMERAH, JAKARTA BARAT, DKI JAKARTA",50,76,144,220
https://kawalpemilu.org#25981,"KOTA BAMBU SELATAN, PALMERAH, JAKARTA BARAT, DKI JAKARTA",51,66,145,211
https://kawalpemilu.org#25981,"KOTA BAMBU SELATAN, PALMERAH, JAKARTA BARAT, DKI JAKARTA",52,31,160,191
https://kawalpemilu.org#25981,"KOTA BAMBU SELATAN, PALMERAH, JAKARTA BARAT, DKI JAKARTA",53,75,153,228
https://kawalpemilu.org#25981,"KOTA BAMBU SELATAN, PALMERAH, JAKARTA BARAT, DKI JAKARTA",54,88,129,217
https://kawalpemilu.org#25981,"KOTA BAMBU SELATAN, PALMERAH, JAKARTA BARAT, DKI JAKARTA",55,58,136,194
https://kawalpemilu.org#25981,"KOTA BAMBU SELATAN, PALMERAH, JAKARTA BARAT, DKI JAKARTA",56,73,1,223
https://kawalpemilu.org#25981,"KOTA BAMBU SELATAN, PALMERAH, JAKARTA BARAT, DKI JAKARTA",57,62,144,206
https://kawalpemilu.org#25981,"KOTA BAMBU SELATAN, PALMERAH, JAKARTA BARAT, DKI JAKARTA",58,76,147,223
https://kawalpemilu.org#25981,"KOTA BAMBU SELATAN, PALMERAH, JAKARTA BARAT, DKI JAKARTA",59,50,180,230
https://kawalpemilu.org#25981,"KOTA BAMBU SELATAN, PALMERAH, JAKARTA BARAT, DKI JAKARTA",60,78,85,163
https://kawalpemilu.org#25981,"KOTA BAMBU SELATAN, PALMERAH, JAKARTA BARAT, DKI JAKARTA",61,68,129,196
https://kawalpemilu.org#25981,"KOTA BAMBU SELATAN, PALMERAH, JAKARTA BARAT, DKI JAKARTA",62,62,151,213
https://kawalpemilu.org#25981,"KOTA BAMBU SELATAN, PALMERAH, JAKARTA BARAT, DKI JAKARTA",63,109,107,216
https://kawalpemilu.org#25981,"KOTA BAMBU SELATAN, PALMERAH, JAKARTA BARAT, DKI JAKARTA",64,68,118,186
https://kawalpemilu.org#25981,"KOTA BAMBU SELATAN, PALMERAH, JAKARTA BARAT, DKI JAKARTA",65,73,104,177
https://kawalpemilu.org#25981,"KOTA BAMBU SELATAN, PALMERAH, JAKARTA BARAT, DKI JAKARTA",66,53,192,245
https://kawalpemilu.org#25981,"KOTA BAMBU SELATAN, PALMERAH, JAKARTA BARAT, DKI JAKARTA",67,53,128,181
https://kawalpemilu.org#25981,"KOTA BAMBU SELATAN, PALMERAH, JAKARTA BARAT, DKI JAKARTA",68,55,133,188
https://kawalpemilu.org#25981,"KOTA BAMBU SELATAN, PALMERAH, JAKARTA BARAT, DKI JAKARTA",69,80,136,216
https://kawalpemilu.org#25981,"KOTA BAMBU SELATAN, PALMERAH, JAKARTA BARAT, DKI JAKARTA",70,74,177,251
https://kawalpemilu.org#25981,"KOTA BAMBU SELATAN, PALMERAH, JAKARTA BARAT, DKI JAKARTA",71,84,159,243
https://kawalpemilu.org#25981,"KOTA BAMBU SELATAN, PALMERAH, JAKARTA BARAT, DKI JAKARTA",72,75,168,243
https://kawalpemilu.org#25981,"KOTA BAMBU SELATAN, PALMERAH, JAKARTA BARAT, DKI JAKARTA",73,87,169,256
https://kawalpemilu.org#25981,"KOTA BAMBU SELATAN, PALMERAH, JAKARTA BARAT, DKI JAKARTA",74,96,161,257
https://kawalpemilu.org#25983,"KEMBANGAN UTARA, KEMBANGAN, JAKARTA BARAT, DKI JAKARTA",1,100,88,188
https://kawalpemilu.org#25983,"KEMBANGAN UTARA, KEMBANGAN, JAKARTA BARAT, DKI JAKARTA",2,88,115,203
https://kawalpemilu.org#25983,"KEMBANGAN UTARA, KEMBANGAN, JAKARTA BARAT, DKI JAKARTA",3,0,0,0
https://kawalpemilu.org#25983,"KEMBANGAN UTARA, KEMBANGAN, JAKARTA BARAT, DKI JAKARTA",4,100,85,185
https://kawalpemilu.org#25983,"KEMBANGAN UTARA, KEMBANGAN, JAKARTA BARAT, DKI JAKARTA",5,130,113,243
https://kawalpemilu.org#25983,"KEMBANGAN UTARA, KEMBANGAN, JAKARTA BARAT, DKI JAKARTA",6,78,133,211
https://kawalpemilu.org#25983,"KEMBANGAN UTARA, KEMBANGAN, JAKARTA BARAT, DKI JAKARTA",7,84,128,212
https://kawalpemilu.org#25983,"KEMBANGAN UTARA, KEMBANGAN, JAKARTA BARAT, DKI JAKARTA",8,111,97,208
https://kawalpemilu.org#25983,"KEMBANGAN UTARA, KEMBANGAN, JAKARTA BARAT, DKI JAKARTA",9,75,97,172
https://kawalpemilu.org#25983,"KEMBANGAN UTARA, KEMBANGAN, JAKARTA BARAT, DKI JAKARTA",10,83,99,182
https://kawalpemilu.org#25983,"KEMBANGAN UTARA, KEMBANGAN, JAKARTA BARAT, DKI JAKARTA",11,89,102,191
https://kawalpemilu.org#25983,"KEMBANGAN UTARA, KEMBANGAN, JAKARTA BARAT, DKI JAKARTA",12,91,128,219
https://kawalpemilu.org#25983,"KEMBANGAN UTARA, KEMBANGAN, JAKARTA BARAT, DKI JAKARTA",13,156,81,237
https://kawalpemilu.org#25983,"KEMBANGAN UTARA, KEMBANGAN, JAKARTA BARAT, DKI JAKARTA",14,75,130,205
https://kawalpemilu.org#25983,"KEMBANGAN UTARA, KEMBANGAN, JAKARTA BARAT, DKI JAKARTA",15,75,116,191
https://kawalpemilu.org#25983,"KEMBANGAN UTARA, KEMBANGAN, JAKARTA BARAT, DKI JAKARTA",16,73,100,173
https://kawalpemilu.org#25983,"KEMBANGAN UTARA, KEMBANGAN, JAKARTA BARAT, DKI JAKARTA",17,65,173,238
https://kawalpemilu.org#25983,"KEMBANGAN UTARA, KEMBANGAN, JAKARTA BARAT, DKI JAKARTA",18,105,115,220
https://kawalpemilu.org#25983,"KEMBANGAN UTARA, KEMBANGAN, JAKARTA BARAT, DKI JAKARTA",19,83,85,168
https://kawalpemilu.org#25983,"KEMBANGAN UTARA, KEMBANGAN, JAKARTA BARAT, DKI JAKARTA",20,81,58,139
https://kawalpemilu.org#25983,"KEMBANGAN UTARA, KEMBANGAN, JAKARTA BARAT, DKI JAKARTA",21,86,101,187
https://kawalpemilu.org#25983,"KEMBANGAN UTARA, KEMBANGAN, JAKARTA BARAT, DKI JAKARTA",22,52,137,189
https://kawalpemilu.org#25983,"KEMBANGAN UTARA, KEMBANGAN, JAKARTA BARAT, DKI JAKARTA",23,75,172,247
https://kawalpemilu.org#25983,"KEMBANGAN UTARA, KEMBANGAN, JAKARTA BARAT, DKI JAKARTA",24,75,184,259
https://kawalpemilu.org#25983,"KEMBANGAN UTARA, KEMBANGAN, JAKARTA BARAT, DKI JAKARTA",25,89,135,224
https://kawalpemilu.org#25983,"KEMBANGAN UTARA, KEMBANGAN, JAKARTA BARAT, DKI JAKARTA",26,42,174,216
https://kawalpemilu.org#25983,"KEMBANGAN UTARA, KEMBANGAN, JAKARTA BARAT, DKI JAKARTA",27,46,165,211
https://kawalpemilu.org#25983,"KEMBANGAN UTARA, KEMBANGAN, JAKARTA BARAT, DKI JAKARTA",28,75,139,214
https://kawalpemilu.org#25983,"KEMBANGAN UTARA, KEMBANGAN, JAKARTA BARAT, DKI JAKARTA",29,61,88,149
https://kawalpemilu.org#25983,"KEMBANGAN UTARA, KEMBANGAN, JAKARTA BARAT, DKI JAKARTA",30,84,95,179
https://kawalpemilu.org#25983,"KEMBANGAN UTARA, KEMBANGAN, JAKARTA BARAT, DKI JAKARTA",31,76,130,206
https://kawalpemilu.org#25983,"KEMBANGAN UTARA, KEMBANGAN, JAKARTA BARAT, DKI JAKARTA",32,84,130,214
https://kawalpemilu.org#25983,"KEMBANGAN UTARA, KEMBANGAN, JAKARTA BARAT, DKI JAKARTA",33,70,114,184
https://kawalpemilu.org#25983,"KEMBANGAN UTARA, KEMBANGAN, JAKARTA BARAT, DKI JAKARTA",34,71,95,166
https://kawalpemilu.org#25983,"KEMBANGAN UTARA, KEMBANGAN, JAKARTA BARAT, DKI JAKARTA",35,82,171,253
https://kawalpemilu.org#25983,"KEMBANGAN UTARA, KEMBANGAN, JAKARTA BARAT, DKI JAKARTA",36,65,171,236
https://kawalpemilu.org#25983,"KEMBANGAN UTARA, KEMBANGAN, JAKARTA BARAT, DKI JAKARTA",37,72,134,206
https://kawalpemilu.org#25983,"KEMBANGAN UTARA, KEMBANGAN, JAKARTA BARAT, DKI JAKARTA",38,76,117,193
https://kawalpemilu.org#25983,"KEMBANGAN UTARA, KEMBANGAN, JAKARTA BARAT, DKI JAKARTA",39,63,145,208
https://kawalpemilu.org#25983,"KEMBANGAN UTARA, KEMBANGAN, JAKARTA BARAT, DKI JAKARTA",40,96,134,250
https://kawalpemilu.org#25983,"KEMBANGAN UTARA, KEMBANGAN, JAKARTA BARAT, DKI JAKARTA",41,59,142,201
https://kawalpemilu.org#25983,"KEMBANGAN UTARA, KEMBANGAN, JAKARTA BARAT, DKI JAKARTA",42,98,143,241
https://kawalpemilu.org#25983,"KEMBANGAN UTARA, KEMBANGAN, JAKARTA BARAT, DKI JAKARTA",43,63,101,164
https://kawalpemilu.org#25983,"KEMBANGAN UTARA, KEMBANGAN, JAKARTA BARAT, DKI JAKARTA",44,55,114,169
https://kawalpemilu.org#25983,"KEMBANGAN UTARA, KEMBANGAN, JAKARTA BARAT, DKI JAKARTA",45,70,146,216
https://kawalpemilu.org#25983,"KEMBANGAN UTARA, KEMBANGAN, JAKARTA BARAT, DKI JAKARTA",46,57,128,188
https://kawalpemilu.org#25983,"KEMBANGAN UTARA, KEMBANGAN, JAKARTA BARAT, DKI JAKARTA",47,82,125,207
https://kawalpemilu.org#25983,"KEMBANGAN UTARA, KEMBANGAN, JAKARTA BARAT, DKI JAKARTA",48,69,117,186
https://kawalpemilu.org#25983,"KEMBANGAN UTARA, KEMBANGAN, JAKARTA BARAT, DKI JAKARTA",49,132,83,215
https://kawalpemilu.org#25983,"KEMBANGAN UTARA, KEMBANGAN, JAKARTA BARAT, DKI JAKARTA",50,112,85,197
https://kawalpemilu.org#25983,"KEMBANGAN UTARA, KEMBANGAN, JAKARTA BARAT, DKI JAKARTA",51,118,66,184
https://kawalpemilu.org#25983,"KEMBANGAN UTARA, KEMBANGAN, JAKARTA BARAT, DKI JAKARTA",52,128,74,202
https://kawalpemilu.org#25983,"KEMBANGAN UTARA, KEMBANGAN, JAKARTA BARAT, DKI JAKARTA",53,106,120,226
https://kawalpemilu.org#25983,"KEMBANGAN UTARA, KEMBANGAN, JAKARTA BARAT, DKI JAKARTA",54,106,69,175
https://kawalpemilu.org#25983,"KEMBANGAN UTARA, KEMBANGAN, JAKARTA BARAT, DKI JAKARTA",55,104,48,104
https://kawalpemilu.org#25983,"KEMBANGAN UTARA, KEMBANGAN, JAKARTA BARAT, DKI JAKARTA",56,96,122,218
https://kawalpemilu.org#25983,"KEMBANGAN UTARA, KEMBANGAN, JAKARTA BARAT, DKI JAKARTA",57,97,111,208
https://kawalpemilu.org#25983,"KEMBANGAN UTARA, KEMBANGAN, JAKARTA BARAT, DKI JAKARTA",58,86,84,170
https://kawalpemilu.org#25983,"KEMBANGAN UTARA, KEMBANGAN, JAKARTA BARAT, DKI JAKARTA",59,105,78,183
https://kawalpemilu.org#25983,"KEMBANGAN UTARA, KEMBANGAN, JAKARTA BARAT, DKI JAKARTA",60,70,83,153
https://kawalpemilu.org#25983,"KEMBANGAN UTARA, KEMBANGAN, JAKARTA BARAT, DKI JAKARTA",61,70,77,147
https://kawalpemilu.org#25983,"KEMBANGAN UTARA, KEMBANGAN, JAKARTA BARAT, DKI JAKARTA",62,77,59,136
https://kawalpemilu.org#25983,"KEMBANGAN UTARA, KEMBANGAN, JAKARTA BARAT, DKI JAKARTA",63,103,101,204
https://kawalpemilu.org#25983,"KEMBANGAN UTARA, KEMBANGAN, JAKARTA BARAT, DKI JAKARTA",64,127,97,224
https://kawalpemilu.org#25983,"KEMBANGAN UTARA, KEMBANGAN, JAKARTA BARAT, DKI JAKARTA",65,134,120,254
https://kawalpemilu.org#25983,"KEMBANGAN UTARA, KEMBANGAN, JAKARTA BARAT, DKI JAKARTA",66,105,102,207
https://kawalpemilu.org#25983,"KEMBANGAN UTARA, KEMBANGAN, JAKARTA BARAT, DKI JAKARTA",67,167,94,261
https://kawalpemilu.org#25983,"KEMBANGAN UTARA, KEMBANGAN, JAKARTA BARAT, DKI JAKARTA",68,117,86,203
https://kawalpemilu.org#25983,"KEMBANGAN UTARA, KEMBANGAN, JAKARTA BARAT, DKI JAKARTA",69,138,56,194
https://kawalpemilu.org#25983,"KEMBANGAN UTARA, KEMBANGAN, JAKARTA BARAT, DKI JAKARTA",70,88,66,154
https://kawalpemilu.org#25983,"KEMBANGAN UTARA, KEMBANGAN, JAKARTA BARAT, DKI JAKARTA",71,107,110,217
https://kawalpemilu.org#25983,"KEMBANGAN UTARA, KEMBANGAN, JAKARTA BARAT, DKI JAKARTA",72,100,94,194
https://kawalpemilu.org#25983,"KEMBANGAN UTARA, KEMBANGAN, JAKARTA BARAT, DKI JAKARTA",73,116,103,219
https://kawalpemilu.org#25983,"KEMBANGAN UTARA, KEMBANGAN, JAKARTA BARAT, DKI JAKARTA",74,143,85,228
https://kawalpemilu.org#25983,"KEMBANGAN UTARA, KEMBANGAN, JAKARTA BARAT, DKI JAKARTA",75,138,103,241
https://kawalpemilu.org#25983,"KEMBANGAN UTARA, KEMBANGAN, JAKARTA BARAT, DKI JAKARTA",76,118,97,215
https://kawalpemilu.org#25983,"KEMBANGAN UTARA, KEMBANGAN, JAKARTA BARAT, DKI JAKARTA",77,76,114,190
https://kawalpemilu.org#25983,"KEMBANGAN UTARA, KEMBANGAN, JAKARTA BARAT, DKI JAKARTA",78,120,61,181
https://kawalpemilu.org#25983,"KEMBANGAN UTARA, KEMBANGAN, JAKARTA BARAT, DKI JAKARTA",79,131,10,141
https://kawalpemilu.org#25983,"KEMBANGAN UTARA, KEMBANGAN, JAKARTA BARAT, DKI JAKARTA",80,195,5,200
https://kawalpemilu.org#25983,"KEMBANGAN UTARA, KEMBANGAN, JAKARTA BARAT, DKI JAKARTA",81,150,14,164
https://kawalpemilu.org#25983,"KEMBANGAN UTARA, KEMBANGAN, JAKARTA BARAT, DKI JAKARTA",82,231,9,240
https://kawalpemilu.org#25983,"KEMBANGAN UTARA, KEMBANGAN, JAKARTA BARAT, DKI JAKARTA",83,173,0,173
https://kawalpemilu.org#25983,"KEMBANGAN UTARA, KEMBANGAN, JAKARTA BARAT, DKI JAKARTA",84,210,5,215
https://kawalpemilu.org#25983,"KEMBANGAN UTARA, KEMBANGAN, JAKARTA BARAT, DKI JAKARTA",85,171,18,189
https://kawalpemilu.org#25983,"KEMBANGAN UTARA, KEMBANGAN, JAKARTA BARAT, DKI JAKARTA",86,190,49,239
https://kawalpemilu.org#25983,"KEMBANGAN UTARA, KEMBANGAN, JAKARTA BARAT, DKI JAKARTA",87,182,60,242
https://kawalpemilu.org#25983,"KEMBANGAN UTARA, KEMBANGAN, JAKARTA BARAT, DKI JAKARTA",88,99,45,144
https://kawalpemilu.org#25983,"KEMBANGAN UTARA, KEMBANGAN, JAKARTA BARAT, DKI JAKARTA",89,109,76,185
https://kawalpemilu.org#25983,"KEMBANGAN UTARA, KEMBANGAN, JAKARTA BARAT, DKI JAKARTA",90,118,103,221
https://kawalpemilu.org#25983,"KEMBANGAN UTARA, KEMBANGAN, JAKARTA BARAT, DKI JAKARTA",91,113,71,184
https://kawalpemilu.org#25983,"KEMBANGAN UTARA, KEMBANGAN, JAKARTA BARAT, DKI JAKARTA",92,107,66,173
https://kawalpemilu.org#25983,"KEMBANGAN UTARA, KEMBANGAN, JAKARTA BARAT, DKI JAKARTA",93,123,101,224
https://kawalpemilu.org#25983,"KEMBANGAN UTARA, KEMBANGAN, JAKARTA BARAT, DKI JAKARTA",94,96,108,204
https://kawalpemilu.org#25983,"KEMBANGAN UTARA, KEMBANGAN, JAKARTA BARAT, DKI JAKARTA",95,78,70,148
https://kawalpemilu.org#25983,"KEMBANGAN UTARA, KEMBANGAN, JAKARTA BARAT, DKI JAKARTA",96,109,128,237
https://kawalpemilu.org#25983,"KEMBANGAN UTARA, KEMBANGAN, JAKARTA BARAT, DKI JAKARTA",97,125,113,238
https://kawalpemilu.org#25983,"KEMBANGAN UTARA, KEMBANGAN, JAKARTA BARAT, DKI JAKARTA",98,120,136,256
https://kawalpemilu.org#25983,"KEMBANGAN UTARA, KEMBANGAN, JAKARTA BARAT, DKI JAKARTA",99,92,104,196
https://kawalpemilu.org#25983,"KEMBANGAN UTARA, KEMBANGAN, JAKARTA BARAT, DKI JAKARTA",100,85,116,201
https://kawalpemilu.org#25983,"KEMBANGAN UTARA, KEMBANGAN, JAKARTA BARAT, DKI JAKARTA",101,102,109,211
https://kawalpemilu.org#25983,"KEMBANGAN UTARA, KEMBANGAN, JAKARTA BARAT, DKI JAKARTA",102,68,71,139
https://kawalpemilu.org#25983,"KEMBANGAN UTARA, KEMBANGAN, JAKARTA BARAT, DKI JAKARTA",103,89,138,227
https://kawalpemilu.org#25983,"KEMBANGAN UTARA, KEMBANGAN, JAKARTA BARAT, DKI JAKARTA",104,86,90,176
https://kawalpemilu.org#25983,"KEMBANGAN UTARA, KEMBANGAN, JAKARTA BARAT, DKI JAKARTA",105,98,75,173
https://kawalpemilu.org#25983,"KEMBANGAN UTARA, KEMBANGAN, JAKARTA BARAT, DKI JAKARTA",106,96,82,178
https://kawalpemilu.org#25983,"KEMBANGAN UTARA, KEMBANGAN, JAKARTA BARAT, DKI JAKARTA",107,125,98,223
https://kawalpemilu.org#25983,"KEMBANGAN UTARA, KEMBANGAN, JAKARTA BARAT, DKI JAKARTA",109,79,100,179
https://kawalpemilu.org#25983,"KEMBANGAN UTARA, KEMBANGAN, JAKARTA BARAT, DKI JAKARTA",110,84,85,169
https://kawalpemilu.org#25983,"KEMBANGAN UTARA, KEMBANGAN, JAKARTA BARAT, DKI JAKARTA",111,117,80,197
https://kawalpemilu.org#25983,"KEMBANGAN UTARA, KEMBANGAN, JAKARTA BARAT, DKI JAKARTA",112,90,101,191
https://kawalpemilu.org#25983,"KEMBANGAN UTARA, KEMBANGAN, JAKARTA BARAT, DKI JAKARTA",113,77,59,136
https://kawalpemilu.org#25983,"KEMBANGAN UTARA, KEMBANGAN, JAKARTA BARAT, DKI JAKARTA",114,125,103,228
https://kawalpemilu.org#25983,"KEMBANGAN UTARA, KEMBANGAN, JAKARTA BARAT, DKI JAKARTA",115,74,141,215
https://kawalpemilu.org#25983,"KEMBANGAN UTARA, KEMBANGAN, JAKARTA BARAT, DKI JAKARTA",117,50,98,148
https://kawalpemilu.org#25983,"KEMBANGAN UTARA, KEMBANGAN, JAKARTA BARAT, DKI JAKARTA",118,31,94,125
https://kawalpemilu.org#25983,"KEMBANGAN UTARA, KEMBANGAN, JAKARTA BARAT, DKI JAKARTA",119,133,56,189
https://kawalpemilu.org#25983,"KEMBANGAN UTARA, KEMBANGAN, JAKARTA BARAT, DKI JAKARTA",120,134,60,194
https://kawalpemilu.org#25983,"KEMBANGAN UTARA, KEMBANGAN, JAKARTA BARAT, DKI JAKARTA",121,162,80,242
https://kawalpemilu.org#25983,"KEMBANGAN UTARA, KEMBANGAN, JAKARTA BARAT, DKI JAKARTA",122,147,66,213
https://kawalpemilu.org#25983,"KEMBANGAN UTARA, KEMBANGAN, JAKARTA BARAT, DKI JAKARTA",123,121,56,177
https://kawalpemilu.org#25983,"KEMBANGAN UTARA, KEMBANGAN, JAKARTA BARAT, DKI JAKARTA",124,120,69,189
https://kawalpemilu.org#25983,"KEMBANGAN UTARA, KEMBANGAN, JAKARTA BARAT, DKI JAKARTA",125,88,45,133
https://kawalpemilu.org#25983,"KEMBANGAN UTARA, KEMBANGAN, JAKARTA BARAT, DKI JAKARTA",126,90,58,148
https://kawalpemilu.org#25983,"KEMBANGAN UTARA, KEMBANGAN, JAKARTA BARAT, DKI JAKARTA",127,112,58,170
https://kawalpemilu.org#25983,"KEMBANGAN UTARA, KEMBANGAN, JAKARTA BARAT, DKI JAKARTA",128,130,90,220
https://kawalpemilu.org#25983,"KEMBANGAN UTARA, KEMBANGAN, JAKARTA BARAT, DKI JAKARTA",129,138,84,222
https://kawalpemilu.org#25983,"KEMBANGAN UTARA, KEMBANGAN, JAKARTA BARAT, DKI JAKARTA",130,76,61,137
https://kawalpemilu.org#25983,"KEMBANGAN UTARA, KEMBANGAN, JAKARTA BARAT, DKI JAKARTA",131,72,110,182
https://kawalpemilu.org#25983,"KEMBANGAN UTARA, KEMBANGAN, JAKARTA BARAT, DKI JAKARTA",132,73,110,183
https://kawalpemilu.org#25983,"KEMBANGAN UTARA, KEMBANGAN, JAKARTA BARAT, DKI JAKARTA",133,69,106,175
https://kawalpemilu.org#25983,"KEMBANGAN UTARA, KEMBANGAN, JAKARTA BARAT, DKI JAKARTA",134,51,125,176
https://kawalpemilu.org#25983,"KEMBANGAN UTARA, KEMBANGAN, JAKARTA BARAT, DKI JAKARTA",135,94,86,180
https://kawalpemilu.org#25983,"KEMBANGAN UTARA, KEMBANGAN, JAKARTA BARAT, DKI JAKARTA",136,48,130,178
https://kawalpemilu.org#25983,"KEMBANGAN UTARA, KEMBANGAN, JAKARTA BARAT, DKI JAKARTA",137,49,137,186
https://kawalpemilu.org#25983,"KEMBANGAN UTARA, KEMBANGAN, JAKARTA BARAT, DKI JAKARTA",138,55,160,215
https://kawalpemilu.org#25983,"KEMBANGAN UTARA, KEMBANGAN, JAKARTA BARAT, DKI JAKARTA",139,44,169,213
https://kawalpemilu.org#25983,"KEMBANGAN UTARA, KEMBANGAN, JAKARTA BARAT, DKI JAKARTA",140,52,135,187
https://kawalpemilu.org#25983,"KEMBANGAN UTARA, KEMBANGAN, JAKARTA BARAT, DKI JAKARTA",141,42,125,167
https://kawalpemilu.org#25983,"KEMBANGAN UTARA, KEMBANGAN, JAKARTA BARAT, DKI JAKARTA",142,76,166,242
https://kawalpemilu.org#25983,"KEMBANGAN UTARA, KEMBANGAN, JAKARTA BARAT, DKI JAKARTA",143,76,132,208
https://kawalpemilu.org#25983,"KEMBANGAN UTARA, KEMBANGAN, JAKARTA BARAT, DKI JAKARTA",144,69,116,185
https://kawalpemilu.org#25983,"KEMBANGAN UTARA, KEMBANGAN, JAKARTA BARAT, DKI JAKARTA",145,76,104,180
https://kawalpemilu.org#25983,"KEMBANGAN UTARA, KEMBANGAN, JAKARTA BARAT, DKI JAKARTA",146,153,6,159
https://kawalpemilu.org#25983,"KEMBANGAN UTARA, KEMBANGAN, JAKARTA BARAT, DKI JAKARTA",147,158,5,163
https://kawalpemilu.org#25983,"KEMBANGAN UTARA, KEMBANGAN, JAKARTA BARAT, DKI JAKARTA",148,127,8,135
https://kawalpemilu.org#25983,"KEMBANGAN UTARA, KEMBANGAN, JAKARTA BARAT, DKI JAKARTA",149,199,7,206
https://kawalpemilu.org#25983,"KEMBANGAN UTARA, KEMBANGAN, JAKARTA BARAT, DKI JAKARTA",150,216,4,220
https://kawalpemilu.org#25983,"KEMBANGAN UTARA, KEMBANGAN, JAKARTA BARAT, DKI JAKARTA",151,168,4,172
https://kawalpemilu.org#25983,"KEMBANGAN UTARA, KEMBANGAN, JAKARTA BARAT, DKI JAKARTA",152,228,7,235
https://kawalpemilu.org#25983,"KEMBANGAN UTARA, KEMBANGAN, JAKARTA BARAT, DKI JAKARTA",153,155,0,155
https://kawalpemilu.org#25983,"KEMBANGAN UTARA, KEMBANGAN, JAKARTA BARAT, DKI JAKARTA",154,220,2,222
https://kawalpemilu.org#25983,"KEMBANGAN UTARA, KEMBANGAN, JAKARTA BARAT, DKI JAKARTA",155,193,2,195
https://kawalpemilu.org#25983,"KEMBANGAN UTARA, KEMBANGAN, JAKARTA BARAT, DKI JAKARTA",156,178,3,181
https://kawalpemilu.org#25983,"KEMBANGAN UTARA, KEMBANGAN, JAKARTA BARAT, DKI JAKARTA",157,178,8,186
https://kawalpemilu.org#25983,"KEMBANGAN UTARA, KEMBANGAN, JAKARTA BARAT, DKI JAKARTA",158,236,5,241
https://kawalpemilu.org#25983,"KEMBANGAN UTARA, KEMBANGAN, JAKARTA BARAT, DKI JAKARTA",159,234,4,238
https://kawalpemilu.org#25983,"KEMBANGAN UTARA, KEMBANGAN, JAKARTA BARAT, DKI JAKARTA",160,221,5,226
https://kawalpemilu.org#25983,"KEMBANGAN UTARA, KEMBANGAN, JAKARTA BARAT, DKI JAKARTA",161,210,4,214
https://kawalpemilu.org#25983,"KEMBANGAN UTARA, KEMBANGAN, JAKARTA BARAT, DKI JAKARTA",162,204,9,213
https://kawalpemilu.org#25983,"KEMBANGAN UTARA, KEMBANGAN, JAKARTA BARAT, DKI JAKARTA",163,174,5,179
https://kawalpemilu.org#25983,"KEMBANGAN UTARA, KEMBANGAN, JAKARTA BARAT, DKI JAKARTA",164,173,8,181
https://kawalpemilu.org#25983,"KEMBANGAN UTARA, KEMBANGAN, JAKARTA BARAT, DKI JAKARTA",165,151,10,161
https://kawalpemilu.org#25983,"KEMBANGAN UTARA, KEMBANGAN, JAKARTA BARAT, DKI JAKARTA",166,150,1,151
https://kawalpemilu.org#25983,"KEMBANGAN UTARA, KEMBANGAN, JAKARTA BARAT, DKI JAKARTA",167,236,4,240
https://kawalpemilu.org#25983,"KEMBANGAN UTARA, KEMBANGAN, JAKARTA BARAT, DKI JAKARTA",168,146,103,249
https://kawalpemilu.org#25983,"KEMBANGAN UTARA, KEMBANGAN, JAKARTA BARAT, DKI JAKARTA",169,145,85,230
https://kawalpemilu.org#25983,"KEMBANGAN UTARA, KEMBANGAN, JAKARTA BARAT, DKI JAKARTA",170,119,117,236
https://kawalpemilu.org#25983,"KEMBANGAN UTARA, KEMBANGAN, JAKARTA BARAT, DKI JAKARTA",171,106,76,182
https://kawalpemilu.org#25983,"KEMBANGAN UTARA, KEMBANGAN, JAKARTA BARAT, DKI JAKARTA",172,74,57,131
https://kawalpemilu.org#25983,"KEMBANGAN UTARA, KEMBANGAN, JAKARTA BARAT, DKI JAKARTA",173,83,128,211
https://kawalpemilu.org#25983,"KEMBANGAN UTARA, KEMBANGAN, JAKARTA BARAT, DKI JAKARTA",174,104,112,216
https://kawalpemilu.org#25983,"KEMBANGAN UTARA, KEMBANGAN, JAKARTA BARAT, DKI JAKARTA",175,64,59,123
https://kawalpemilu.org#25983,"KEMBANGAN UTARA, KEMBANGAN, JAKARTA BARAT, DKI JAKARTA",176,84,104,188
https://kawalpemilu.org#25983,"KEMBANGAN UTARA, KEMBANGAN, JAKARTA BARAT, DKI JAKARTA",177,63,119,182
https://kawalpemilu.org#25983,"KEMBANGAN UTARA, KEMBANGAN, JAKARTA BARAT, DKI JAKARTA",178,135,92,227
https://kawalpemilu.org#25983,"KEMBANGAN UTARA, KEMBANGAN, JAKARTA BARAT, DKI JAKARTA",179,127,94,221
https://kawalpemilu.org#25983,"KEMBANGAN UTARA, KEMBANGAN, JAKARTA BARAT, DKI JAKARTA",180,78,122,200
https://kawalpemilu.org#25983,"KEMBANGAN UTARA, KEMBANGAN, JAKARTA BARAT, DKI JAKARTA",181,64,118,182
https://kawalpemilu.org#25983,"KEMBANGAN UTARA, KEMBANGAN, JAKARTA BARAT, DKI JAKARTA",182,110,95,205
https://kawalpemilu.org#25983,"KEMBANGAN UTARA, KEMBANGAN, JAKARTA BARAT, DKI JAKARTA",183,94,91,185
https://kawalpemilu.org#25983,"KEMBANGAN UTARA, KEMBANGAN, JAKARTA BARAT, DKI JAKARTA",184,84,98,182
https://kawalpemilu.org#25983,"KEMBANGAN UTARA, KEMBANGAN, JAKARTA BARAT, DKI JAKARTA",185,106,130,236
https://kawalpemilu.org#25983,"KEMBANGAN UTARA, KEMBANGAN, JAKARTA BARAT, DKI JAKARTA",186,92,110,202
https://kawalpemilu.org#25983,"KEMBANGAN UTARA, KEMBANGAN, JAKARTA BARAT, DKI JAKARTA",187,95,89,184
https://kawalpemilu.org#25983,"KEMBANGAN UTARA, KEMBANGAN, JAKARTA BARAT, DKI JAKARTA",188,93,101,194
https://kawalpemilu.org#25983,"KEMBANGAN UTARA, KEMBANGAN, JAKARTA BARAT, DKI JAKARTA",189,68,141,209
https://kawalpemilu.org#25983,"KEMBANGAN UTARA, KEMBANGAN, JAKARTA BARAT, DKI JAKARTA",190,184,4,188
https://kawalpemilu.org#25983,"KEMBANGAN UTARA, KEMBANGAN, JAKARTA BARAT, DKI JAKARTA",191,166,2,168
https://kawalpemilu.org#25983,"KEMBANGAN UTARA, KEMBANGAN, JAKARTA BARAT, DKI JAKARTA",192,187,0,187
https://kawalpemilu.org#25984,"MERUYA UTARA, KEMBANGAN, JAKARTA BARAT, DKI JAKARTA",1,121,110,231
https://kawalpemilu.org#25984,"MERUYA UTARA, KEMBANGAN, JAKARTA BARAT, DKI JAKARTA",2,100,121,221
https://kawalpemilu.org#25984,"MERUYA UTARA, KEMBANGAN, JAKARTA BARAT, DKI JAKARTA",3,80,84,164
https://kawalpemilu.org#25984,"MERUYA UTARA, KEMBANGAN, JAKARTA BARAT, DKI JAKARTA",4,124,123,247
https://kawalpemilu.org#25984,"MERUYA UTARA, KEMBANGAN, JAKARTA BARAT, DKI JAKARTA",5,150,98,248
https://kawalpemilu.org#25984,"MERUYA UTARA, KEMBANGAN, JAKARTA BARAT, DKI JAKARTA",6,133,113,246
https://kawalpemilu.org#25984,"MERUYA UTARA, KEMBANGAN, JAKARTA BARAT, DKI JAKARTA",7,164,93,257
https://kawalpemilu.org#25984,"MERUYA UTARA, KEMBANGAN, JAKARTA BARAT, DKI JAKARTA",8,156,88,244
https://kawalpemilu.org#25984,"MERUYA UTARA, KEMBANGAN, JAKARTA BARAT, DKI JAKARTA",9,96,114,210
https://kawalpemilu.org#25984,"MERUYA UTARA, KEMBANGAN, JAKARTA BARAT, DKI JAKARTA",10,215,32,247
https://kawalpemilu.org#25984,"MERUYA UTARA, KEMBANGAN, JAKARTA BARAT, DKI JAKARTA",11,126,140,266
https://kawalpemilu.org#25984,"MERUYA UTARA, KEMBANGAN, JAKARTA BARAT, DKI JAKARTA",12,62,92,154
https://kawalpemilu.org#25984,"MERUYA UTARA, KEMBANGAN, JAKARTA BARAT, DKI JAKARTA",13,104,107,211
https://kawalpemilu.org#25984,"MERUYA UTARA, KEMBANGAN, JAKARTA BARAT, DKI JAKARTA",14,92,131,223
https://kawalpemilu.org#25984,"MERUYA UTARA, KEMBANGAN, JAKARTA BARAT, DKI JAKARTA",15,94,113,207
https://kawalpemilu.org#25984,"MERUYA UTARA, KEMBANGAN, JAKARTA BARAT, DKI JAKARTA",16,94,75,169
https://kawalpemilu.org#25984,"MERUYA UTARA, KEMBANGAN, JAKARTA BARAT, DKI JAKARTA",17,79,82,161
https://kawalpemilu.org#25984,"MERUYA UTARA, KEMBANGAN, JAKARTA BARAT, DKI JAKARTA",18,83,97,214
https://kawalpemilu.org#25984,"MERUYA UTARA, KEMBANGAN, JAKARTA BARAT, DKI JAKARTA",19,92,97,189
https://kawalpemilu.org#25984,"MERUYA UTARA, KEMBANGAN, JAKARTA BARAT, DKI JAKARTA",20,76,154,230
https://kawalpemilu.org#25984,"MERUYA UTARA, KEMBANGAN, JAKARTA BARAT, DKI JAKARTA",21,94,89,183
https://kawalpemilu.org#25984,"MERUYA UTARA, KEMBANGAN, JAKARTA BARAT, DKI JAKARTA",22,93,93,186
https://kawalpemilu.org#25984,"MERUYA UTARA, KEMBANGAN, JAKARTA BARAT, DKI JAKARTA",23,55,101,156
https://kawalpemilu.org#25984,"MERUYA UTARA, KEMBANGAN, JAKARTA BARAT, DKI JAKARTA",24,99,116,215
https://kawalpemilu.org#25984,"MERUYA UTARA, KEMBANGAN, JAKARTA BARAT, DKI JAKARTA",25,209,28,237
https://kawalpemilu.org#25984,"MERUYA UTARA, KEMBANGAN, JAKARTA BARAT, DKI JAKARTA",26,79,91,170
https://kawalpemilu.org#25984,"MERUYA UTARA, KEMBANGAN, JAKARTA BARAT, DKI JAKARTA",27,116,88,204
https://kawalpemilu.org#25984,"MERUYA UTARA, KEMBANGAN, JAKARTA BARAT, DKI JAKARTA",28,99,129,228
https://kawalpemilu.org#25984,"MERUYA UTARA, KEMBANGAN, JAKARTA BARAT, DKI JAKARTA",29,108,128,236
https://kawalpemilu.org#25984,"MERUYA UTARA, KEMBANGAN, JAKARTA BARAT, DKI JAKARTA",30,67,64,131
https://kawalpemilu.org#25984,"MERUYA UTARA, KEMBANGAN, JAKARTA BARAT, DKI JAKARTA",31,79,102,181
https://kawalpemilu.org#25984,"MERUYA UTARA, KEMBANGAN, JAKARTA BARAT, DKI JAKARTA",32,88,113,201
https://kawalpemilu.org#25984,"MERUYA UTARA, KEMBANGAN, JAKARTA BARAT, DKI JAKARTA",33,83,108,191
https://kawalpemilu.org#25984,"MERUYA UTARA, KEMBANGAN, JAKARTA BARAT, DKI JAKARTA",34,101,47,148
https://kawalpemilu.org#25984,"MERUYA UTARA, KEMBANGAN, JAKARTA BARAT, DKI JAKARTA",35,122,104,226
https://kawalpemilu.org#25984,"MERUYA UTARA, KEMBANGAN, JAKARTA BARAT, DKI JAKARTA",36,103,100,203
https://kawalpemilu.org#25984,"MERUYA UTARA, KEMBANGAN, JAKARTA BARAT, DKI JAKARTA",37,109,69,178
https://kawalpemilu.org#25984,"MERUYA UTARA, KEMBANGAN, JAKARTA BARAT, DKI JAKARTA",38,93,118,211
https://kawalpemilu.org#25984,"MERUYA UTARA, KEMBANGAN, JAKARTA BARAT, DKI JAKARTA",39,81,52,133
https://kawalpemilu.org#25984,"MERUYA UTARA, KEMBANGAN, JAKARTA BARAT, DKI JAKARTA",40,161,53,214
https://kawalpemilu.org#25984,"MERUYA UTARA, KEMBANGAN, JAKARTA BARAT, DKI JAKARTA",41,161,93,254
https://kawalpemilu.org#25984,"MERUYA UTARA, KEMBANGAN, JAKARTA BARAT, DKI JAKARTA",42,124,90,214
https://kawalpemilu.org#25984,"MERUYA UTARA, KEMBANGAN, JAKARTA BARAT, DKI JAKARTA",43,97,172,269
https://kawalpemilu.org#25984,"MERUYA UTARA, KEMBANGAN, JAKARTA BARAT, DKI JAKARTA",44,114,155,269
https://kawalpemilu.org#25984,"MERUYA UTARA, KEMBANGAN, JAKARTA BARAT, DKI JAKARTA",45,180,24,204
https://kawalpemilu.org#25984,"MERUYA UTARA, KEMBANGAN, JAKARTA BARAT, DKI JAKARTA",46,163,9,172
https://kawalpemilu.org#25984,"MERUYA UTARA, KEMBANGAN, JAKARTA BARAT, DKI JAKARTA",47,111,127,238
https://kawalpemilu.org#25984,"MERUYA UTARA, KEMBANGAN, JAKARTA BARAT, DKI JAKARTA",48,108,142,250
https://kawalpemilu.org#25984,"MERUYA UTARA, KEMBANGAN, JAKARTA BARAT, DKI JAKARTA",49,136,100,236
https://kawalpemilu.org#25984,"MERUYA UTARA, KEMBANGAN, JAKARTA BARAT, DKI JAKARTA",50,97,105,202
https://kawalpemilu.org#25984,"MERUYA UTARA, KEMBANGAN, JAKARTA BARAT, DKI JAKARTA",51,98,84,182
https://kawalpemilu.org#25984,"MERUYA UTARA, KEMBANGAN, JAKARTA BARAT, DKI JAKARTA",52,72,147,219
https://kawalpemilu.org#25984,"MERUYA UTARA, KEMBANGAN, JAKARTA BARAT, DKI JAKARTA",53,59,143,202
https://kawalpemilu.org#25984,"MERUYA UTARA, KEMBANGAN, JAKARTA BARAT, DKI JAKARTA",54,73,93,166
https://kawalpemilu.org#25984,"MERUYA UTARA, KEMBANGAN, JAKARTA BARAT, DKI JAKARTA",55,86,111,194
https://kawalpemilu.org#25984,"MERUYA UTARA, KEMBANGAN, JAKARTA BARAT, DKI JAKARTA",56,138,88,226
https://kawalpemilu.org#25984,"MERUYA UTARA, KEMBANGAN, JAKARTA BARAT, DKI JAKARTA",57,98,82,180
https://kawalpemilu.org#25984,"MERUYA UTARA, KEMBANGAN, JAKARTA BARAT, DKI JAKARTA",58,123,112,235
https://kawalpemilu.org#25984,"MERUYA UTARA, KEMBANGAN, JAKARTA BARAT, DKI JAKARTA",59,140,129,269
https://kawalpemilu.org#25984,"MERUYA UTARA, KEMBANGAN, JAKARTA BARAT, DKI JAKARTA",60,80,109,189
https://kawalpemilu.org#25984,"MERUYA UTARA, KEMBANGAN, JAKARTA BARAT, DKI JAKARTA",61,135,109,244
https://kawalpemilu.org#25984,"MERUYA UTARA, KEMBANGAN, JAKARTA BARAT, DKI JAKARTA",62,136,71,207
https://kawalpemilu.org#25984,"MERUYA UTARA, KEMBANGAN, JAKARTA BARAT, DKI JAKARTA",63,69,97,166
https://kawalpemilu.org#25984,"MERUYA UTARA, KEMBANGAN, JAKARTA BARAT, DKI JAKARTA",64,111,128,239
https://kawalpemilu.org#25984,"MERUYA UTARA, KEMBANGAN, JAKARTA BARAT, DKI JAKARTA",65,127,123,250
https://kawalpemilu.org#25984,"MERUYA UTARA, KEMBANGAN, JAKARTA BARAT, DKI JAKARTA",66,99,129,228
https://kawalpemilu.org#25984,"MERUYA UTARA, KEMBANGAN, JAKARTA BARAT, DKI JAKARTA",67,89,107,196
https://kawalpemilu.org#25984,"MERUYA UTARA, KEMBANGAN, JAKARTA BARAT, DKI JAKARTA",68,98,117,215
https://kawalpemilu.org#25984,"MERUYA UTARA, KEMBANGAN, JAKARTA BARAT, DKI JAKARTA",69,193,30,223
https://kawalpemilu.org#25984,"MERUYA UTARA, KEMBANGAN, JAKARTA BARAT, DKI JAKARTA",70,188,56,244
https://kawalpemilu.org#25984,"MERUYA UTARA, KEMBANGAN, JAKARTA BARAT, DKI JAKARTA",71,189,74,263
https://kawalpemilu.org#25984,"MERUYA UTARA, KEMBANGAN, JAKARTA BARAT, DKI JAKARTA",72,84,88,172
https://kawalpemilu.org#25984,"MERUYA UTARA, KEMBANGAN, JAKARTA BARAT, DKI JAKARTA",73,63,75,138
https://kawalpemilu.org#25984,"MERUYA UTARA, KEMBANGAN, JAKARTA BARAT, DKI JAKARTA",74,69,102,0
https://kawalpemilu.org#25984,"MERUYA UTARA, KEMBANGAN, JAKARTA BARAT, DKI JAKARTA",75,88,79,167
https://kawalpemilu.org#25984,"MERUYA UTARA, KEMBANGAN, JAKARTA BARAT, DKI JAKARTA",76,86,66,152
https://kawalpemilu.org#25984,"MERUYA UTARA, KEMBANGAN, JAKARTA BARAT, DKI JAKARTA",77,95,154,249
https://kawalpemilu.org#25984,"MERUYA UTARA, KEMBANGAN, JAKARTA BARAT, DKI JAKARTA",78,117,138,255
https://kawalpemilu.org#25984,"MERUYA UTARA, KEMBANGAN, JAKARTA BARAT, DKI JAKARTA",80,81,84,165
https://kawalpemilu.org#25984,"MERUYA UTARA, KEMBANGAN, JAKARTA BARAT, DKI JAKARTA",81,75,80,155
https://kawalpemilu.org#25984,"MERUYA UTARA, KEMBANGAN, JAKARTA BARAT, DKI JAKARTA",82,64,148,212
https://kawalpemilu.org#25984,"MERUYA UTARA, KEMBANGAN, JAKARTA BARAT, DKI JAKARTA",83,92,118,210
https://kawalpemilu.org#25984,"MERUYA UTARA, KEMBANGAN, JAKARTA BARAT, DKI JAKARTA",84,155,95,250
https://kawalpemilu.org#25984,"MERUYA UTARA, KEMBANGAN, JAKARTA BARAT, DKI JAKARTA",85,180,11,191
https://kawalpemilu.org#25984,"MERUYA UTARA, KEMBANGAN, JAKARTA BARAT, DKI JAKARTA",86,214,14,228
https://kawalpemilu.org#25984,"MERUYA UTARA, KEMBANGAN, JAKARTA BARAT, DKI JAKARTA",87,111,40,151
https://kawalpemilu.org#25984,"MERUYA UTARA, KEMBANGAN, JAKARTA BARAT, DKI JAKARTA",88,114,99,213
https://kawalpemilu.org#25984,"MERUYA UTARA, KEMBANGAN, JAKARTA BARAT, DKI JAKARTA",89,118,69,187
https://kawalpemilu.org#25984,"MERUYA UTARA, KEMBANGAN, JAKARTA BARAT, DKI JAKARTA",90,125,62,187
https://kawalpemilu.org#25984,"MERUYA UTARA, KEMBANGAN, JAKARTA BARAT, DKI JAKARTA",91,100,102,202
https://kawalpemilu.org#25984,"MERUYA UTARA, KEMBANGAN, JAKARTA BARAT, DKI JAKARTA",92,221,20,241
https://kawalpemilu.org#25984,"MERUYA UTARA, KEMBANGAN, JAKARTA BARAT, DKI JAKARTA",93,235,16,251
https://kawalpemilu.org#25984,"MERUYA UTARA, KEMBANGAN, JAKARTA BARAT, DKI JAKARTA",94,216,9,225
https://kawalpemilu.org#25984,"MERUYA UTARA, KEMBANGAN, JAKARTA BARAT, DKI JAKARTA",95,176,36,212
https://kawalpemilu.org#25984,"MERUYA UTARA, KEMBANGAN, JAKARTA BARAT, DKI JAKARTA",96,163,22,185
https://kawalpemilu.org#25984,"MERUYA UTARA, KEMBANGAN, JAKARTA BARAT, DKI JAKARTA",97,146,106,252
https://kawalpemilu.org#25984,"MERUYA UTARA, KEMBANGAN, JAKARTA BARAT, DKI JAKARTA",98,142,90,232
https://kawalpemilu.org#25984,"MERUYA UTARA, KEMBANGAN, JAKARTA BARAT, DKI JAKARTA",99,102,114,216
https://kawalpemilu.org#25984,"MERUYA UTARA, KEMBANGAN, JAKARTA BARAT, DKI JAKARTA",100,115,85,200
https://kawalpemilu.org#25984,"MERUYA UTARA, KEMBANGAN, JAKARTA BARAT, DKI JAKARTA",101,132,47,179
https://kawalpemilu.org#25984,"MERUYA UTARA, KEMBANGAN, JAKARTA BARAT, DKI JAKARTA",102,96,48,144
https://kawalpemilu.org#25984,"MERUYA UTARA, KEMBANGAN, JAKARTA BARAT, DKI JAKARTA",103,147,78,225
https://kawalpemilu.org#25984,"MERUYA UTARA, KEMBANGAN, JAKARTA BARAT, DKI JAKARTA",104,111,77,188
https://kawalpemilu.org#25984,"MERUYA UTARA, KEMBANGAN, JAKARTA BARAT, DKI JAKARTA",105,134,99,233
https://kawalpemilu.org#25984,"MERUYA UTARA, KEMBANGAN, JAKARTA BARAT, DKI JAKARTA",106,139,41,180
https://kawalpemilu.org#25984,"MERUYA UTARA, KEMBANGAN, JAKARTA BARAT, DKI JAKARTA",107,143,37,180
https://kawalpemilu.org#25984,"MERUYA UTARA, KEMBANGAN, JAKARTA BARAT, DKI JAKARTA",108,106,22,128
https://kawalpemilu.org#25984,"MERUYA UTARA, KEMBANGAN, JAKARTA BARAT, DKI JAKARTA",109,193,40,233
https://kawalpemilu.org#25984,"MERUYA UTARA, KEMBANGAN, JAKARTA BARAT, DKI JAKARTA",110,174,40,214
https://kawalpemilu.org#25984,"MERUYA UTARA, KEMBANGAN, JAKARTA BARAT, DKI JAKARTA",111,205,13,218
https://kawalpemilu.org#25984,"MERUYA UTARA, KEMBANGAN, JAKARTA BARAT, DKI JAKARTA",112,230,18,248
https://kawalpemilu.org#25984,"MERUYA UTARA, KEMBANGAN, JAKARTA BARAT, DKI JAKARTA",113,223,12,235
https://kawalpemilu.org#25984,"MERUYA UTARA, KEMBANGAN, JAKARTA BARAT, DKI JAKARTA",114,236,13,249
https://kawalpemilu.org#25984,"MERUYA UTARA, KEMBANGAN, JAKARTA BARAT, DKI JAKARTA",115,186,10,196
https://kawalpemilu.org#25984,"MERUYA UTARA, KEMBANGAN, JAKARTA BARAT, DKI JAKARTA",116,215,15,230
https://kawalpemilu.org#25984,"MERUYA UTARA, KEMBANGAN, JAKARTA BARAT, DKI JAKARTA",117,213,16,229
https://kawalpemilu.org#25984,"MERUYA UTARA, KEMBANGAN, JAKARTA BARAT, DKI JAKARTA",118,140,8,148
https://kawalpemilu.org#25984,"MERUYA UTARA, KEMBANGAN, JAKARTA BARAT, DKI JAKARTA",119,136,16,152
https://kawalpemilu.org#25984,"MERUYA UTARA, KEMBANGAN, JAKARTA BARAT, DKI JAKARTA",120,113,48,161
https://kawalpemilu.org#25984,"MERUYA UTARA, KEMBANGAN, JAKARTA BARAT, DKI JAKARTA",121,126,112,238
https://kawalpemilu.org#25984,"MERUYA UTARA, KEMBANGAN, JAKARTA BARAT, DKI JAKARTA",122,124,107,231
https://kawalpemilu.org#25984,"MERUYA UTARA, KEMBANGAN, JAKARTA BARAT, DKI JAKARTA",123,101,104,205
https://kawalpemilu.org#25984,"MERUYA UTARA, KEMBANGAN, JAKARTA BARAT, DKI JAKARTA",124,134,73,207
https://kawalpemilu.org#25984,"MERUYA UTARA, KEMBANGAN, JAKARTA BARAT, DKI JAKARTA",125,166,36,202
https://kawalpemilu.org#25984,"MERUYA UTARA, KEMBANGAN, JAKARTA BARAT, DKI JAKARTA",126,144,47,191
https://kawalpemilu.org#25984,"MERUYA UTARA, KEMBANGAN, JAKARTA BARAT, DKI JAKARTA",127,103,148,251
https://kawalpemilu.org#25984,"MERUYA UTARA, KEMBANGAN, JAKARTA BARAT, DKI JAKARTA",128,105,148,253
https://kawalpemilu.org#25984,"MERUYA UTARA, KEMBANGAN, JAKARTA BARAT, DKI JAKARTA",129,88,150,238
https://kawalpemilu.org#25984,"MERUYA UTARA, KEMBANGAN, JAKARTA BARAT, DKI JAKARTA",130,106,172,278
https://kawalpemilu.org#25984,"MERUYA UTARA, KEMBANGAN, JAKARTA BARAT, DKI JAKARTA",131,98,181,279
https://kawalpemilu.org#25984,"MERUYA UTARA, KEMBANGAN, JAKARTA BARAT, DKI JAKARTA",132,172,85,257
https://kawalpemilu.org#25984,"MERUYA UTARA, KEMBANGAN, JAKARTA BARAT, DKI JAKARTA",133,213,39,252
https://kawalpemilu.org#25984,"MERUYA UTARA, KEMBANGAN, JAKARTA BARAT, DKI JAKARTA",134,201,59,260
https://kawalpemilu.org#25984,"MERUYA UTARA, KEMBANGAN, JAKARTA BARAT, DKI JAKARTA",135,78,118,196
https://kawalpemilu.org#25984,"MERUYA UTARA, KEMBANGAN, JAKARTA BARAT, DKI JAKARTA",136,88,152,240
https://kawalpemilu.org#25984,"MERUYA UTARA, KEMBANGAN, JAKARTA BARAT, DKI JAKARTA",137,87,97,184
https://kawalpemilu.org#25984,"MERUYA UTARA, KEMBANGAN, JAKARTA BARAT, DKI JAKARTA",138,62,121,183
https://kawalpemilu.org#25984,"MERUYA UTARA, KEMBANGAN, JAKARTA BARAT, DKI JAKARTA",139,88,125,213
https://kawalpemilu.org#25984,"MERUYA UTARA, KEMBANGAN, JAKARTA BARAT, DKI JAKARTA",140,93,153,246
https://kawalpemilu.org#25984,"MERUYA UTARA, KEMBANGAN, JAKARTA BARAT, DKI JAKARTA",141,104,104,208
https://kawalpemilu.org#25984,"MERUYA UTARA, KEMBANGAN, JAKARTA BARAT, DKI JAKARTA",142,104,115,219
https://kawalpemilu.org#25984,"MERUYA UTARA, KEMBANGAN, JAKARTA BARAT, DKI JAKARTA",143,108,85,193
https://kawalpemilu.org#25984,"MERUYA UTARA, KEMBANGAN, JAKARTA BARAT, DKI JAKARTA",144,78,60,138
https://kawalpemilu.org#25984,"MERUYA UTARA, KEMBANGAN, JAKARTA BARAT, DKI JAKARTA",145,110,143,253
https://kawalpemilu.org#25984,"MERUYA UTARA, KEMBANGAN, JAKARTA BARAT, DKI JAKARTA",146,132,116,248
https://kawalpemilu.org#25984,"MERUYA UTARA, KEMBANGAN, JAKARTA BARAT, DKI JAKARTA",148,111,158,269
https://kawalpemilu.org#25984,"MERUYA UTARA, KEMBANGAN, JAKARTA BARAT, DKI JAKARTA",149,209,40,249
https://kawalpemilu.org#25985,"MERUYA SELATAN, KEMBANGAN, JAKARTA BARAT, DKI JAKARTA",1,67,111,178
https://kawalpemilu.org#25985,"MERUYA SELATAN, KEMBANGAN, JAKARTA BARAT, DKI JAKARTA",2,59,84,143
https://kawalpemilu.org#25985,"MERUYA SELATAN, KEMBANGAN, JAKARTA BARAT, DKI JAKARTA",3,152,105,257
https://kawalpemilu.org#25985,"MERUYA SELATAN, KEMBANGAN, JAKARTA BARAT, DKI JAKARTA",4,141,108,249
https://kawalpemilu.org#25985,"MERUYA SELATAN, KEMBANGAN, JAKARTA BARAT, DKI JAKARTA",5,113,132,245
https://kawalpemilu.org#25985,"MERUYA SELATAN, KEMBANGAN, JAKARTA BARAT, DKI JAKARTA",6,128,124,252
https://kawalpemilu.org#25985,"MERUYA SELATAN, KEMBANGAN, JAKARTA BARAT, DKI JAKARTA",7,93,84,177
https://kawalpemilu.org#25985,"MERUYA SELATAN, KEMBANGAN, JAKARTA BARAT, DKI JAKARTA",8,70,93,163
https://kawalpemilu.org#25985,"MERUYA SELATAN, KEMBANGAN, JAKARTA BARAT, DKI JAKARTA",9,119,112,231
https://kawalpemilu.org#25985,"MERUYA SELATAN, KEMBANGAN, JAKARTA BARAT, DKI JAKARTA",10,116,69,185
https://kawalpemilu.org#25985,"MERUYA SELATAN, KEMBANGAN, JAKARTA BARAT, DKI JAKARTA",11,65,138,203
https://kawalpemilu.org#25985,"MERUYA SELATAN, KEMBANGAN, JAKARTA BARAT, DKI JAKARTA",12,87,128,215
https://kawalpemilu.org#25985,"MERUYA SELATAN, KEMBANGAN, JAKARTA BARAT, DKI JAKARTA",13,94,113,207
https://kawalpemilu.org#25985,"MERUYA SELATAN, KEMBANGAN, JAKARTA BARAT, DKI JAKARTA",14,92,100,192
https://kawalpemilu.org#25985,"MERUYA SELATAN, KEMBANGAN, JAKARTA BARAT, DKI JAKARTA",15,85,99,184
https://kawalpemilu.org#25985,"MERUYA SELATAN, KEMBANGAN, JAKARTA BARAT, DKI JAKARTA",16,78,102,180
https://kawalpemilu.org#25985,"MERUYA SELATAN, KEMBANGAN, JAKARTA BARAT, DKI JAKARTA",17,169,134,303
https://kawalpemilu.org#25985,"MERUYA SELATAN, KEMBANGAN, JAKARTA BARAT, DKI JAKARTA",18,119,121,240
https://kawalpemilu.org#25985,"MERUYA SELATAN, KEMBANGAN, JAKARTA BARAT, DKI JAKARTA",19,108,117,225
https://kawalpemilu.org#25985,"MERUYA SELATAN, KEMBANGAN, JAKARTA BARAT, DKI JAKARTA",20,38,111,149
https://kawalpemilu.org#25985,"MERUYA SELATAN, KEMBANGAN, JAKARTA BARAT, DKI JAKARTA",21,66,85,151
https://kawalpemilu.org#25985,"MERUYA SELATAN, KEMBANGAN, JAKARTA BARAT, DKI JAKARTA",22,151,77,228
https://kawalpemilu.org#25985,"MERUYA SELATAN, KEMBANGAN, JAKARTA BARAT, DKI JAKARTA",23,74,65,139
https://kawalpemilu.org#25985,"MERUYA SELATAN, KEMBANGAN, JAKARTA BARAT, DKI JAKARTA",24,70,75,145
https://kawalpemilu.org#25985,"MERUYA SELATAN, KEMBANGAN, JAKARTA BARAT, DKI JAKARTA",25,121,120,241
https://kawalpemilu.org#25985,"MERUYA SELATAN, KEMBANGAN, JAKARTA BARAT, DKI JAKARTA",26,117,95,212
https://kawalpemilu.org#25985,"MERUYA SELATAN, KEMBANGAN, JAKARTA BARAT, DKI JAKARTA",27,141,100,241
https://kawalpemilu.org#25985,"MERUYA SELATAN, KEMBANGAN, JAKARTA BARAT, DKI JAKARTA",28,86,81,167
https://kawalpemilu.org#25985,"MERUYA SELATAN, KEMBANGAN, JAKARTA BARAT, DKI JAKARTA",29,78,86,164
https://kawalpemilu.org#25985,"MERUYA SELATAN, KEMBANGAN, JAKARTA BARAT, DKI JAKARTA",30,110,98,208
https://kawalpemilu.org#25985,"MERUYA SELATAN, KEMBANGAN, JAKARTA BARAT, DKI JAKARTA",31,110,114,224
https://kawalpemilu.org#25985,"MERUYA SELATAN, KEMBANGAN, JAKARTA BARAT, DKI JAKARTA",32,89,132,221
https://kawalpemilu.org#25985,"MERUYA SELATAN, KEMBANGAN, JAKARTA BARAT, DKI JAKARTA",33,79,104,183
https://kawalpemilu.org#25985,"MERUYA SELATAN, KEMBANGAN, JAKARTA BARAT, DKI JAKARTA",34,47,117,164
https://kawalpemilu.org#25985,"MERUYA SELATAN, KEMBANGAN, JAKARTA BARAT, DKI JAKARTA",35,68,81,149
https://kawalpemilu.org#25985,"MERUYA SELATAN, KEMBANGAN, JAKARTA BARAT, DKI JAKARTA",36,45,77,122
https://kawalpemilu.org#25985,"MERUYA SELATAN, KEMBANGAN, JAKARTA BARAT, DKI JAKARTA",37,85,150,235
https://kawalpemilu.org#25985,"MERUYA SELATAN, KEMBANGAN, JAKARTA BARAT, DKI JAKARTA",38,48,106,154
https://kawalpemilu.org#25985,"MERUYA SELATAN, KEMBANGAN, JAKARTA BARAT, DKI JAKARTA",39,37,140,177
https://kawalpemilu.org#25985,"MERUYA SELATAN, KEMBANGAN, JAKARTA BARAT, DKI JAKARTA",40,86,189,275
https://kawalpemilu.org#25985,"MERUYA SELATAN, KEMBANGAN, JAKARTA BARAT, DKI JAKARTA",41,127,126,253
https://kawalpemilu.org#25985,"MERUYA SELATAN, KEMBANGAN, JAKARTA BARAT, DKI JAKARTA",42,113,125,238
https://kawalpemilu.org#25985,"MERUYA SELATAN, KEMBANGAN, JAKARTA BARAT, DKI JAKARTA",43,87,113,200
https://kawalpemilu.org#25985,"MERUYA SELATAN, KEMBANGAN, JAKARTA BARAT, DKI JAKARTA",44,96,100,196
https://kawalpemilu.org#25985,"MERUYA SELATAN, KEMBANGAN, JAKARTA BARAT, DKI JAKARTA",45,81,105,186
https://kawalpemilu.org#25985,"MERUYA SELATAN, KEMBANGAN, JAKARTA BARAT, DKI JAKARTA",46,97,110,207
https://kawalpemilu.org#25985,"MERUYA SELATAN, KEMBANGAN, JAKARTA BARAT, DKI JAKARTA",47,101,86,187
https://kawalpemilu.org#25985,"MERUYA SELATAN, KEMBANGAN, JAKARTA BARAT, DKI JAKARTA",48,97,105,202
https://kawalpemilu.org#25985,"MERUYA SELATAN, KEMBANGAN, JAKARTA BARAT, DKI JAKARTA",49,69,108,177
https://kawalpemilu.org#25985,"MERUYA SELATAN, KEMBANGAN, JAKARTA BARAT, DKI JAKARTA",50,80,124,204
https://kawalpemilu.org#25985,"MERUYA SELATAN, KEMBANGAN, JAKARTA BARAT, DKI JAKARTA",51,115,142,257
https://kawalpemilu.org#25985,"MERUYA SELATAN, KEMBANGAN, JAKARTA BARAT, DKI JAKARTA",52,111,136,247
https://kawalpemilu.org#25985,"MERUYA SELATAN, KEMBANGAN, JAKARTA BARAT, DKI JAKARTA",53,106,101,207
https://kawalpemilu.org#25985,"MERUYA SELATAN, KEMBANGAN, JAKARTA BARAT, DKI JAKARTA",54,88,69,157
https://kawalpemilu.org#25985,"MERUYA SELATAN, KEMBANGAN, JAKARTA BARAT, DKI JAKARTA",55,67,85,152
https://kawalpemilu.org#25985,"MERUYA SELATAN, KEMBANGAN, JAKARTA BARAT, DKI JAKARTA",56,106,131,237
https://kawalpemilu.org#25985,"MERUYA SELATAN, KEMBANGAN, JAKARTA BARAT, DKI JAKARTA",57,122,106,228
https://kawalpemilu.org#25985,"MERUYA SELATAN, KEMBANGAN, JAKARTA BARAT, DKI JAKARTA",58,92,76,168
https://kawalpemilu.org#25985,"MERUYA SELATAN, KEMBANGAN, JAKARTA BARAT, DKI JAKARTA",59,86,96,182
https://kawalpemilu.org#25985,"MERUYA SELATAN, KEMBANGAN, JAKARTA BARAT, DKI JAKARTA",60,99,173,272
https://kawalpemilu.org#25985,"MERUYA SELATAN, KEMBANGAN, JAKARTA BARAT, DKI JAKARTA",61,91,150,241
https://kawalpemilu.org#25985,"MERUYA SELATAN, KEMBANGAN, JAKARTA BARAT, DKI JAKARTA",62,162,135,297
https://kawalpemilu.org#25985,"MERUYA SELATAN, KEMBANGAN, JAKARTA BARAT, DKI JAKARTA",63,102,73,175
https://kawalpemilu.org#25985,"MERUYA SELATAN, KEMBANGAN, JAKARTA BARAT, DKI JAKARTA",64,77,78,155
https://kawalpemilu.org#25985,"MERUYA SELATAN, KEMBANGAN, JAKARTA BARAT, DKI JAKARTA",65,38,92,130
https://kawalpemilu.org#25985,"MERUYA SELATAN, KEMBANGAN, JAKARTA BARAT, DKI JAKARTA",66,27,78,105
https://kawalpemilu.org#25985,"MERUYA SELATAN, KEMBANGAN, JAKARTA BARAT, DKI JAKARTA",67,81,136,217
https://kawalpemilu.org#25985,"MERUYA SELATAN, KEMBANGAN, JAKARTA BARAT, DKI JAKARTA",68,88,117,205
https://kawalpemilu.org#25985,"MERUYA SELATAN, KEMBANGAN, JAKARTA BARAT, DKI JAKARTA",69,112,141,253
https://kawalpemilu.org#25985,"MERUYA SELATAN, KEMBANGAN, JAKARTA BARAT, DKI JAKARTA",70,101,133,234
https://kawalpemilu.org#25985,"MERUYA SELATAN, KEMBANGAN, JAKARTA BARAT, DKI JAKARTA",71,76,144,220
https://kawalpemilu.org#25985,"MERUYA SELATAN, KEMBANGAN, JAKARTA BARAT, DKI JAKARTA",72,81,135,216
https://kawalpemilu.org#25985,"MERUYA SELATAN, KEMBANGAN, JAKARTA BARAT, DKI JAKARTA",73,52,104,156
https://kawalpemilu.org#25985,"MERUYA SELATAN, KEMBANGAN, JAKARTA BARAT, DKI JAKARTA",74,52,87,139
https://kawalpemilu.org#25985,"MERUYA SELATAN, KEMBANGAN, JAKARTA BARAT, DKI JAKARTA",75,80,210,290
https://kawalpemilu.org#25985,"MERUYA SELATAN, KEMBANGAN, JAKARTA BARAT, DKI JAKARTA",76,95,92,187
https://kawalpemilu.org#25985,"MERUYA SELATAN, KEMBANGAN, JAKARTA BARAT, DKI JAKARTA",77,102,131,233
https://kawalpemilu.org#25985,"MERUYA SELATAN, KEMBANGAN, JAKARTA BARAT, DKI JAKARTA",78,88,129,217
https://kawalpemilu.org#25985,"MERUYA SELATAN, KEMBANGAN, JAKARTA BARAT, DKI JAKARTA",79,136,25,161
https://kawalpemilu.org#25985,"MERUYA SELATAN, KEMBANGAN, JAKARTA BARAT, DKI JAKARTA",80,136,20,156
https://kawalpemilu.org#25985,"MERUYA SELATAN, KEMBANGAN, JAKARTA BARAT, DKI JAKARTA",81,108,52,160
https://kawalpemilu.org#25985,"MERUYA SELATAN, KEMBANGAN, JAKARTA BARAT, DKI JAKARTA",82,104,40,144
https://kawalpemilu.org#25985,"MERUYA SELATAN, KEMBANGAN, JAKARTA BARAT, DKI JAKARTA",83,131,96,267
https://kawalpemilu.org#25985,"MERUYA SELATAN, KEMBANGAN, JAKARTA BARAT, DKI JAKARTA",84,165,77,242
https://kawalpemilu.org#25985,"MERUYA SELATAN, KEMBANGAN, JAKARTA BARAT, DKI JAKARTA",85,91,90,181
https://kawalpemilu.org#25985,"MERUYA SELATAN, KEMBANGAN, JAKARTA BARAT, DKI JAKARTA",86,101,78,179
https://kawalpemilu.org#25985,"MERUYA SELATAN, KEMBANGAN, JAKARTA BARAT, DKI JAKARTA",87,111,132,243
https://kawalpemilu.org#25985,"MERUYA SELATAN, KEMBANGAN, JAKARTA BARAT, DKI JAKARTA",88,84,144,228
https://kawalpemilu.org#25985,"MERUYA SELATAN, KEMBANGAN, JAKARTA BARAT, DKI JAKARTA",89,144,82,226
https://kawalpemilu.org#25985,"MERUYA SELATAN, KEMBANGAN, JAKARTA BARAT, DKI JAKARTA",90,106,127,233
https://kawalpemilu.org#25985,"MERUYA SELATAN, KEMBANGAN, JAKARTA BARAT, DKI JAKARTA",91,91,106,197
https://kawalpemilu.org#25985,"MERUYA SELATAN, KEMBANGAN, JAKARTA BARAT, DKI JAKARTA",92,94,126,220
https://kawalpemilu.org#25985,"MERUYA SELATAN, KEMBANGAN, JAKARTA BARAT, DKI JAKARTA",93,78,90,168
https://kawalpemilu.org#25985,"MERUYA SELATAN, KEMBANGAN, JAKARTA BARAT, DKI JAKARTA",94,105,109,214
https://kawalpemilu.org#25985,"MERUYA SELATAN, KEMBANGAN, JAKARTA BARAT, DKI JAKARTA",95,88,116,204
https://kawalpemilu.org#25985,"MERUYA SELATAN, KEMBANGAN, JAKARTA BARAT, DKI JAKARTA",96,119,110,229
https://kawalpemilu.org#25985,"MERUYA SELATAN, KEMBANGAN, JAKARTA BARAT, DKI JAKARTA",97,122,147,269
https://kawalpemilu.org#25985,"MERUYA SELATAN, KEMBANGAN, JAKARTA BARAT, DKI JAKARTA",98,93,157,250
https://kawalpemilu.org#25985,"MERUYA SELATAN, KEMBANGAN, JAKARTA BARAT, DKI JAKARTA",99,125,108,233
https://kawalpemilu.org#25985,"MERUYA SELATAN, KEMBANGAN, JAKARTA BARAT, DKI JAKARTA",100,101,83,184
https://kawalpemilu.org#25985,"MERUYA SELATAN, KEMBANGAN, JAKARTA BARAT, DKI JAKARTA",101,135,165,300
https://kawalpemilu.org#25985,"MERUYA SELATAN, KEMBANGAN, JAKARTA BARAT, DKI JAKARTA",102,110,117,227
https://kawalpemilu.org#25985,"MERUYA SELATAN, KEMBANGAN, JAKARTA BARAT, DKI JAKARTA",103,108,118,226
https://kawalpemilu.org#25985,"MERUYA SELATAN, KEMBANGAN, JAKARTA BARAT, DKI JAKARTA",104,138,62,200
https://kawalpemilu.org#25985,"MERUYA SELATAN, KEMBANGAN, JAKARTA BARAT, DKI JAKARTA",105,83,50,133
https://kawalpemilu.org#25985,"MERUYA SELATAN, KEMBANGAN, JAKARTA BARAT, DKI JAKARTA",106,69,77,146
https://kawalpemilu.org#25985,"MERUYA SELATAN, KEMBANGAN, JAKARTA BARAT, DKI JAKARTA",107,103,68,171
https://kawalpemilu.org#25985,"MERUYA SELATAN, KEMBANGAN, JAKARTA BARAT, DKI JAKARTA",108,127,93,220
https://kawalpemilu.org#25985,"MERUYA SELATAN, KEMBANGAN, JAKARTA BARAT, DKI JAKARTA",109,98,138,236
https://kawalpemilu.org#25985,"MERUYA SELATAN, KEMBANGAN, JAKARTA BARAT, DKI JAKARTA",110,102,109,211
https://kawalpemilu.org#25985,"MERUYA SELATAN, KEMBANGAN, JAKARTA BARAT, DKI JAKARTA",111,191,29,220
https://kawalpemilu.org#25985,"MERUYA SELATAN, KEMBANGAN, JAKARTA BARAT, DKI JAKARTA",112,214,30,244
https://kawalpemilu.org#25985,"MERUYA SELATAN, KEMBANGAN, JAKARTA BARAT, DKI JAKARTA",113,164,23,187
https://kawalpemilu.org#25986,"SRENGSENG, KEMBANGAN, JAKARTA BARAT, DKI JAKARTA",1,81,125,206
https://kawalpemilu.org#25986,"SRENGSENG, KEMBANGAN, JAKARTA BARAT, DKI JAKARTA",2,83,143,226
https://kawalpemilu.org#25986,"SRENGSENG, KEMBANGAN, JAKARTA BARAT, DKI JAKARTA",3,64,151,215
https://kawalpemilu.org#25986,"SRENGSENG, KEMBANGAN, JAKARTA BARAT, DKI JAKARTA",4,70,137,207
https://kawalpemilu.org#25986,"SRENGSENG, KEMBANGAN, JAKARTA BARAT, DKI JAKARTA",5,110,104,214
https://kawalpemilu.org#25986,"SRENGSENG, KEMBANGAN, JAKARTA BARAT, DKI JAKARTA",6,110,148,258
https://kawalpemilu.org#25986,"SRENGSENG, KEMBANGAN, JAKARTA BARAT, DKI JAKARTA",7,120,75,195
https://kawalpemilu.org#25986,"SRENGSENG, KEMBANGAN, JAKARTA BARAT, DKI JAKARTA",8,96,81,177
https://kawalpemilu.org#25986,"SRENGSENG, KEMBANGAN, JAKARTA BARAT, DKI JAKARTA",9,90,96,186
https://kawalpemilu.org#25986,"SRENGSENG, KEMBANGAN, JAKARTA BARAT, DKI JAKARTA",10,79,108,187
https://kawalpemilu.org#25986,"SRENGSENG, KEMBANGAN, JAKARTA BARAT, DKI JAKARTA",11,95,113,208
https://kawalpemilu.org#25986,"SRENGSENG, KEMBANGAN, JAKARTA BARAT, DKI JAKARTA",12,93,126,219
https://kawalpemilu.org#25986,"SRENGSENG, KEMBANGAN, JAKARTA BARAT, DKI JAKARTA",13,82,123,205
https://kawalpemilu.org#25986,"SRENGSENG, KEMBANGAN, JAKARTA BARAT, DKI JAKARTA",14,73,148,221
https://kawalpemilu.org#25986,"SRENGSENG, KEMBANGAN, JAKARTA BARAT, DKI JAKARTA",15,59,141,200
https://kawalpemilu.org#25986,"SRENGSENG, KEMBANGAN, JAKARTA BARAT, DKI JAKARTA",16,61,100,161
https://kawalpemilu.org#25986,"SRENGSENG, KEMBANGAN, JAKARTA BARAT, DKI JAKARTA",17,61,110,171
https://kawalpemilu.org#25986,"SRENGSENG, KEMBANGAN, JAKARTA BARAT, DKI JAKARTA",19,62,166,228
https://kawalpemilu.org#25986,"SRENGSENG, KEMBANGAN, JAKARTA BARAT, DKI JAKARTA",20,79,123,202
https://kawalpemilu.org#25986,"SRENGSENG, KEMBANGAN, JAKARTA BARAT, DKI JAKARTA",21,89,140,229
https://kawalpemilu.org#25986,"SRENGSENG, KEMBANGAN, JAKARTA BARAT, DKI JAKARTA",22,123,148,271
https://kawalpemilu.org#25986,"SRENGSENG, KEMBANGAN, JAKARTA BARAT, DKI JAKARTA",23,82,116,0
https://kawalpemilu.org#25986,"SRENGSENG, KEMBANGAN, JAKARTA BARAT, DKI JAKARTA",24,101,119,220
https://kawalpemilu.org#25986,"SRENGSENG, KEMBANGAN, JAKARTA BARAT, DKI JAKARTA",25,108,125,233
https://kawalpemilu.org#25986,"SRENGSENG, KEMBANGAN, JAKARTA BARAT, DKI JAKARTA",26,91,139,230
https://kawalpemilu.org#25986,"SRENGSENG, KEMBANGAN, JAKARTA BARAT, DKI JAKARTA",27,65,158,223
https://kawalpemilu.org#25986,"SRENGSENG, KEMBANGAN, JAKARTA BARAT, DKI JAKARTA",28,64,117,181
https://kawalpemilu.org#25986,"SRENGSENG, KEMBANGAN, JAKARTA BARAT, DKI JAKARTA",29,90,118,208
https://kawalpemilu.org#25986,"SRENGSENG, KEMBANGAN, JAKARTA BARAT, DKI JAKARTA",30,117,119,236
https://kawalpemilu.org#25986,"SRENGSENG, KEMBANGAN, JAKARTA BARAT, DKI JAKARTA",31,124,103,227
https://kawalpemilu.org#25986,"SRENGSENG, KEMBANGAN, JAKARTA BARAT, DKI JAKARTA",32,74,121,195
https://kawalpemilu.org#25986,"SRENGSENG, KEMBANGAN, JAKARTA BARAT, DKI JAKARTA",33,68,142,210
https://kawalpemilu.org#25986,"SRENGSENG, KEMBANGAN, JAKARTA BARAT, DKI JAKARTA",34,91,112,203
https://kawalpemilu.org#25986,"SRENGSENG, KEMBANGAN, JAKARTA BARAT, DKI JAKARTA",35,134,152,286
https://kawalpemilu.org#25986,"SRENGSENG, KEMBANGAN, JAKARTA BARAT, DKI JAKARTA",36,97,141,238
https://kawalpemilu.org#25986,"SRENGSENG, KEMBANGAN, JAKARTA BARAT, DKI JAKARTA",37,86,168,254
https://kawalpemilu.org#25986,"SRENGSENG, KEMBANGAN, JAKARTA BARAT, DKI JAKARTA",38,94,131,225
https://kawalpemilu.org#25986,"SRENGSENG, KEMBANGAN, JAKARTA BARAT, DKI JAKARTA",39,148,107,255
https://kawalpemilu.org#25986,"SRENGSENG, KEMBANGAN, JAKARTA BARAT, DKI JAKARTA",40,79,165,244
https://kawalpemilu.org#25986,"SRENGSENG, KEMBANGAN, JAKARTA BARAT, DKI JAKARTA",41,94,142,236
https://kawalpemilu.org#25986,"SRENGSENG, KEMBANGAN, JAKARTA BARAT, DKI JAKARTA",42,59,138,197
https://kawalpemilu.org#25986,"SRENGSENG, KEMBANGAN, JAKARTA BARAT, DKI JAKARTA",43,157,74,231
https://kawalpemilu.org#25986,"SRENGSENG, KEMBANGAN, JAKARTA BARAT, DKI JAKARTA",44,128,87,215
https://kawalpemilu.org#25986,"SRENGSENG, KEMBANGAN, JAKARTA BARAT, DKI JAKARTA",45,145,88,233
https://kawalpemilu.org#25986,"SRENGSENG, KEMBANGAN, JAKARTA BARAT, DKI JAKARTA",46,133,100,233
https://kawalpemilu.org#25986,"SRENGSENG, KEMBANGAN, JAKARTA BARAT, DKI JAKARTA",47,125,118,243
https://kawalpemilu.org#25986,"SRENGSENG, KEMBANGAN, JAKARTA BARAT, DKI JAKARTA",48,114,112,226
https://kawalpemilu.org#25986,"SRENGSENG, KEMBANGAN, JAKARTA BARAT, DKI JAKARTA",49,77,160,237
https://kawalpemilu.org#25986,"SRENGSENG, KEMBANGAN, JAKARTA BARAT, DKI JAKARTA",50,70,166,236
https://kawalpemilu.org#25986,"SRENGSENG, KEMBANGAN, JAKARTA BARAT, DKI JAKARTA",51,88,114,202
https://kawalpemilu.org#25986,"SRENGSENG, KEMBANGAN, JAKARTA BARAT, DKI JAKARTA",52,97,112,209
https://kawalpemilu.org#25986,"SRENGSENG, KEMBANGAN, JAKARTA BARAT, DKI JAKARTA",53,96,136,232
https://kawalpemilu.org#25986,"SRENGSENG, KEMBANGAN, JAKARTA BARAT, DKI JAKARTA",54,87,151,238
https://kawalpemilu.org#25986,"SRENGSENG, KEMBANGAN, JAKARTA BARAT, DKI JAKARTA",55,136,48,184
https://kawalpemilu.org#25986,"SRENGSENG, KEMBANGAN, JAKARTA BARAT, DKI JAKARTA",56,142,40,182
https://kawalpemilu.org#25986,"SRENGSENG, KEMBANGAN, JAKARTA BARAT, DKI JAKARTA",57,111,92,203
https://kawalpemilu.org#25986,"SRENGSENG, KEMBANGAN, JAKARTA BARAT, DKI JAKARTA",58,84,74,158
https://kawalpemilu.org#25986,"SRENGSENG, KEMBANGAN, JAKARTA BARAT, DKI JAKARTA",59,86,98,184
https://kawalpemilu.org#25986,"SRENGSENG, KEMBANGAN, JAKARTA BARAT, DKI JAKARTA",60,102,81,183
https://kawalpemilu.org#25986,"SRENGSENG, KEMBANGAN, JAKARTA BARAT, DKI JAKARTA",61,83,70,153
https://kawalpemilu.org#25986,"SRENGSENG, KEMBANGAN, JAKARTA BARAT, DKI JAKARTA",62,77,101,178
https://kawalpemilu.org#25986,"SRENGSENG, KEMBANGAN, JAKARTA BARAT, DKI JAKARTA",63,95,103,198
https://kawalpemilu.org#25986,"SRENGSENG, KEMBANGAN, JAKARTA BARAT, DKI JAKARTA",64,112,95,207
https://kawalpemilu.org#25986,"SRENGSENG, KEMBANGAN, JAKARTA BARAT, DKI JAKARTA",65,105,100,205
https://kawalpemilu.org#25986,"SRENGSENG, KEMBANGAN, JAKARTA BARAT, DKI JAKARTA",66,211,11,222
https://kawalpemilu.org#25986,"SRENGSENG, KEMBANGAN, JAKARTA BARAT, DKI JAKARTA",67,134,130,264
https://kawalpemilu.org#25986,"SRENGSENG, KEMBANGAN, JAKARTA BARAT, DKI JAKARTA",68,96,130,226
https://kawalpemilu.org#25986,"SRENGSENG, KEMBANGAN, JAKARTA BARAT, DKI JAKARTA",69,77,115,192
https://kawalpemilu.org#25986,"SRENGSENG, KEMBANGAN, JAKARTA BARAT, DKI JAKARTA",70,83,141,224
https://kawalpemilu.org#25986,"SRENGSENG, KEMBANGAN, JAKARTA BARAT, DKI JAKARTA",71,86,120,206
https://kawalpemilu.org#25986,"SRENGSENG, KEMBANGAN, JAKARTA BARAT, DKI JAKARTA",72,82,127,209
https://kawalpemilu.org#25986,"SRENGSENG, KEMBANGAN, JAKARTA BARAT, DKI JAKARTA",73,85,114,199
https://kawalpemilu.org#25986,"SRENGSENG, KEMBANGAN, JAKARTA BARAT, DKI JAKARTA",74,96,166,262
https://kawalpemilu.org#25986,"SRENGSENG, KEMBANGAN, JAKARTA BARAT, DKI JAKARTA",75,66,135,201
https://kawalpemilu.org#25986,"SRENGSENG, KEMBANGAN, JAKARTA BARAT, DKI JAKARTA",76,123,136,259
https://kawalpemilu.org#25986,"SRENGSENG, KEMBANGAN, JAKARTA BARAT, DKI JAKARTA",77,104,151,255
https://kawalpemilu.org#25986,"SRENGSENG, KEMBANGAN, JAKARTA BARAT, DKI JAKARTA",78,101,113,214
https://kawalpemilu.org#25986,"SRENGSENG, KEMBANGAN, JAKARTA BARAT, DKI JAKARTA",79,105,121,226
https://kawalpemilu.org#25986,"SRENGSENG, KEMBANGAN, JAKARTA BARAT, DKI JAKARTA",80,95,135,230
https://kawalpemilu.org#25986,"SRENGSENG, KEMBANGAN, JAKARTA BARAT, DKI JAKARTA",81,82,143,225
https://kawalpemilu.org#25986,"SRENGSENG, KEMBANGAN, JAKARTA BARAT, DKI JAKARTA",82,87,146,233
https://kawalpemilu.org#25986,"SRENGSENG, KEMBANGAN, JAKARTA BARAT, DKI JAKARTA",83,83,113,196
https://kawalpemilu.org#25986,"SRENGSENG, KEMBANGAN, JAKARTA BARAT, DKI JAKARTA",84,103,110,213
https://kawalpemilu.org#25986,"SRENGSENG, KEMBANGAN, JAKARTA BARAT, DKI JAKARTA",85,100,125,225
https://kawalpemilu.org#25986,"SRENGSENG, KEMBANGAN, JAKARTA BARAT, DKI JAKARTA",86,124,115,239
https://kawalpemilu.org#25986,"SRENGSENG, KEMBANGAN, JAKARTA BARAT, DKI JAKARTA",87,130,133,263
https://kawalpemilu.org#25986,"SRENGSENG, KEMBANGAN, JAKARTA BARAT, DKI JAKARTA",88,110,95,205
https://kawalpemilu.org#25986,"SRENGSENG, KEMBANGAN, JAKARTA BARAT, DKI JAKARTA",89,105,166,271
https://kawalpemilu.org#25986,"SRENGSENG, KEMBANGAN, JAKARTA BARAT, DKI JAKARTA",90,104,125,229
https://kawalpemilu.org#25986,"SRENGSENG, KEMBANGAN, JAKARTA BARAT, DKI JAKARTA",91,87,146,233
https://kawalpemilu.org#25986,"SRENGSENG, KEMBANGAN, JAKARTA BARAT, DKI JAKARTA",92,113,113,226
https://kawalpemilu.org#25986,"SRENGSENG, KEMBANGAN, JAKARTA BARAT, DKI JAKARTA",93,114,123,237
https://kawalpemilu.org#25986,"SRENGSENG, KEMBANGAN, JAKARTA BARAT, DKI JAKARTA",94,130,94,224
https://kawalpemilu.org#25986,"SRENGSENG, KEMBANGAN, JAKARTA BARAT, DKI JAKARTA",95,112,100,212
https://kawalpemilu.org#25986,"SRENGSENG, KEMBANGAN, JAKARTA BARAT, DKI JAKARTA",96,76,145,221
https://kawalpemilu.org#25986,"SRENGSENG, KEMBANGAN, JAKARTA BARAT, DKI JAKARTA",97,66,141,207
https://kawalpemilu.org#25986,"SRENGSENG, KEMBANGAN, JAKARTA BARAT, DKI JAKARTA",98,99,118,217
https://kawalpemilu.org#25986,"SRENGSENG, KEMBANGAN, JAKARTA BARAT, DKI JAKARTA",99,71,145,216
https://kawalpemilu.org#25986,"SRENGSENG, KEMBANGAN, JAKARTA BARAT, DKI JAKARTA",100,99,134,233
https://kawalpemilu.org#25986,"SRENGSENG, KEMBANGAN, JAKARTA BARAT, DKI JAKARTA",101,139,96,235
https://kawalpemilu.org#25986,"SRENGSENG, KEMBANGAN, JAKARTA BARAT, DKI JAKARTA",102,166,110,276
https://kawalpemilu.org#25986,"SRENGSENG, KEMBANGAN, JAKARTA BARAT, DKI JAKARTA",103,133,97,230
https://kawalpemilu.org#25986,"SRENGSENG, KEMBANGAN, JAKARTA BARAT, DKI JAKARTA",104,87,108,195
https://kawalpemilu.org#25986,"SRENGSENG, KEMBANGAN, JAKARTA BARAT, DKI JAKARTA",105,79,99,178
https://kawalpemilu.org#25986,"SRENGSENG, KEMBANGAN, JAKARTA BARAT, DKI JAKARTA",106,92,120,212
https://kawalpemilu.org#25986,"SRENGSENG, KEMBANGAN, JAKARTA BARAT, DKI JAKARTA",107,120,105,225
https://kawalpemilu.org#25986,"SRENGSENG, KEMBANGAN, JAKARTA BARAT, DKI JAKARTA",108,101,128,229
https://kawalpemilu.org#25986,"SRENGSENG, KEMBANGAN, JAKARTA BARAT, DKI JAKARTA",109,92,163,255
https://kawalpemilu.org#25986,"SRENGSENG, KEMBANGAN, JAKARTA BARAT, DKI JAKARTA",110,96,171,267
https://kawalpemilu.org#25986,"SRENGSENG, KEMBANGAN, JAKARTA BARAT, DKI JAKARTA",111,104,140,244
https://kawalpemilu.org#25986,"SRENGSENG, KEMBANGAN, JAKARTA BARAT, DKI JAKARTA",112,86,163,249
https://kawalpemilu.org#25986,"SRENGSENG, KEMBANGAN, JAKARTA BARAT, DKI JAKARTA",113,87,104,191
https://kawalpemilu.org#25986,"SRENGSENG, KEMBANGAN, JAKARTA BARAT, DKI JAKARTA",114,82,78,160
https://kawalpemilu.org#25986,"SRENGSENG, KEMBANGAN, JAKARTA BARAT, DKI JAKARTA",115,99,126,225
https://kawalpemilu.org#25986,"SRENGSENG, KEMBANGAN, JAKARTA BARAT, DKI JAKARTA",116,108,147,255
https://kawalpemilu.org#25986,"SRENGSENG, KEMBANGAN, JAKARTA BARAT, DKI JAKARTA",117,101,161,262
https://kawalpemilu.org#25986,"SRENGSENG, KEMBANGAN, JAKARTA BARAT, DKI JAKARTA",118,176,59,235
https://kawalpemilu.org#25986,"SRENGSENG, KEMBANGAN, JAKARTA BARAT, DKI JAKARTA",119,69,112,181
https://kawalpemilu.org#25986,"SRENGSENG, KEMBANGAN, JAKARTA BARAT, DKI JAKARTA",120,90,131,221
https://kawalpemilu.org#25986,"SRENGSENG, KEMBANGAN, JAKARTA BARAT, DKI JAKARTA",121,85,142,227
https://kawalpemilu.org#25986,"SRENGSENG, KEMBANGAN, JAKARTA BARAT, DKI JAKARTA",122,199,32,231
https://kawalpemilu.org#25986,"SRENGSENG, KEMBANGAN, JAKARTA BARAT, DKI JAKARTA",123,124,120,244
https://kawalpemilu.org#25986,"SRENGSENG, KEMBANGAN, JAKARTA BARAT, DKI JAKARTA",124,93,111,204
https://kawalpemilu.org#25986,"SRENGSENG, KEMBANGAN, JAKARTA BARAT, DKI JAKARTA",125,85,96,181
https://kawalpemilu.org#25986,"SRENGSENG, KEMBANGAN, JAKARTA BARAT, DKI JAKARTA",126,88,89,177
https://kawalpemilu.org#25986,"SRENGSENG, KEMBANGAN, JAKARTA BARAT, DKI JAKARTA",127,74,166,240
https://kawalpemilu.org#25986,"SRENGSENG, KEMBANGAN, JAKARTA BARAT, DKI JAKARTA",128,82,131,213
https://kawalpemilu.org#25986,"SRENGSENG, KEMBANGAN, JAKARTA BARAT, DKI JAKARTA",129,64,150,214
https://kawalpemilu.org#25986,"SRENGSENG, KEMBANGAN, JAKARTA BARAT, DKI JAKARTA",130,125,130,255
https://kawalpemilu.org#25986,"SRENGSENG, KEMBANGAN, JAKARTA BARAT, DKI JAKARTA",131,95,110,205
https://kawalpemilu.org#25986,"SRENGSENG, KEMBANGAN, JAKARTA BARAT, DKI JAKARTA",132,0,0,0
https://kawalpemilu.org#25986,"SRENGSENG, KEMBANGAN, JAKARTA BARAT, DKI JAKARTA",133,125,133,258
https://kawalpemilu.org#25986,"SRENGSENG, KEMBANGAN, JAKARTA BARAT, DKI JAKARTA",134,120,116,236
https://kawalpemilu.org#25986,"SRENGSENG, KEMBANGAN, JAKARTA BARAT, DKI JAKARTA",135,158,10,168
https://kawalpemilu.org#25986,"SRENGSENG, KEMBANGAN, JAKARTA BARAT, DKI JAKARTA",136,179,5,184
https://kawalpemilu.org#25986,"SRENGSENG, KEMBANGAN, JAKARTA BARAT, DKI JAKARTA",137,164,7,171
https://kawalpemilu.org#25986,"SRENGSENG, KEMBANGAN, JAKARTA BARAT, DKI JAKARTA",139,143,7,150
https://kawalpemilu.org#25986,"SRENGSENG, KEMBANGAN, JAKARTA BARAT, DKI JAKARTA",140,172,7,179
https://kawalpemilu.org#25986,"SRENGSENG, KEMBANGAN, JAKARTA BARAT, DKI JAKARTA",141,185,7,192
https://kawalpemilu.org#25986,"SRENGSENG, KEMBANGAN, JAKARTA BARAT, DKI JAKARTA",142,144,11,155
https://kawalpemilu.org#25986,"SRENGSENG, KEMBANGAN, JAKARTA BARAT, DKI JAKARTA",143,170,4,174
https://kawalpemilu.org#25986,"SRENGSENG, KEMBANGAN, JAKARTA BARAT, DKI JAKARTA",144,185,1,186
https://kawalpemilu.org#25986,"SRENGSENG, KEMBANGAN, JAKARTA BARAT, DKI JAKARTA",145,199,3,202
https://kawalpemilu.org#25986,"SRENGSENG, KEMBANGAN, JAKARTA BARAT, DKI JAKARTA",146,204,9,213
https://kawalpemilu.org#25986,"SRENGSENG, KEMBANGAN, JAKARTA BARAT, DKI JAKARTA",147,220,11,231
https://kawalpemilu.org#25987,"JOGLO, KEMBANGAN, JAKARTA BARAT, DKI JAKARTA",1,126,118,244
https://kawalpemilu.org#25987,"JOGLO, KEMBANGAN, JAKARTA BARAT, DKI JAKARTA",2,120,82,202
https://kawalpemilu.org#25987,"JOGLO, KEMBANGAN, JAKARTA BARAT, DKI JAKARTA",3,79,149,228
https://kawalpemilu.org#25987,"JOGLO, KEMBANGAN, JAKARTA BARAT, DKI JAKARTA",4,74,141,215
https://kawalpemilu.org#25987,"JOGLO, KEMBANGAN, JAKARTA BARAT, DKI JAKARTA",5,92,112,290
https://kawalpemilu.org#25987,"JOGLO, KEMBANGAN, JAKARTA BARAT, DKI JAKARTA",6,109,118,227
https://kawalpemilu.org#25987,"JOGLO, KEMBANGAN, JAKARTA BARAT, DKI JAKARTA",7,128,88,216
https://kawalpemilu.org#25987,"JOGLO, KEMBANGAN, JAKARTA BARAT, DKI JAKARTA",8,111,100,211
https://kawalpemilu.org#25987,"JOGLO, KEMBANGAN, JAKARTA BARAT, DKI JAKARTA",9,127,84,211
https://kawalpemilu.org#25987,"JOGLO, KEMBANGAN, JAKARTA BARAT, DKI JAKARTA",10,101,80,181
https://kawalpemilu.org#25987,"JOGLO, KEMBANGAN, JAKARTA BARAT, DKI JAKARTA",11,97,117,214
https://kawalpemilu.org#25987,"JOGLO, KEMBANGAN, JAKARTA BARAT, DKI JAKARTA",12,115,75,190
https://kawalpemilu.org#25987,"JOGLO, KEMBANGAN, JAKARTA BARAT, DKI JAKARTA",13,143,43,186
https://kawalpemilu.org#25987,"JOGLO, KEMBANGAN, JAKARTA BARAT, DKI JAKARTA",14,115,132,247
https://kawalpemilu.org#25987,"JOGLO, KEMBANGAN, JAKARTA BARAT, DKI JAKARTA",15,128,112,240
https://kawalpemilu.org#25987,"JOGLO, KEMBANGAN, JAKARTA BARAT, DKI JAKARTA",16,113,98,211
https://kawalpemilu.org#25987,"JOGLO, KEMBANGAN, JAKARTA BARAT, DKI JAKARTA",17,79,56,135
https://kawalpemilu.org#25987,"JOGLO, KEMBANGAN, JAKARTA BARAT, DKI JAKARTA",18,132,49,181
https://kawalpemilu.org#25987,"JOGLO, KEMBANGAN, JAKARTA BARAT, DKI JAKARTA",19,119,105,224
https://kawalpemilu.org#25987,"JOGLO, KEMBANGAN, JAKARTA BARAT, DKI JAKARTA",20,113,89,202
https://kawalpemilu.org#25987,"JOGLO, KEMBANGAN, JAKARTA BARAT, DKI JAKARTA",21,90,96,186
https://kawalpemilu.org#25987,"JOGLO, KEMBANGAN, JAKARTA BARAT, DKI JAKARTA",22,112,44,156
https://kawalpemilu.org#25987,"JOGLO, KEMBANGAN, JAKARTA BARAT, DKI JAKARTA",23,96,132,228
https://kawalpemilu.org#25987,"JOGLO, KEMBANGAN, JAKARTA BARAT, DKI JAKARTA",24,98,146,244
https://kawalpemilu.org#25987,"JOGLO, KEMBANGAN, JAKARTA BARAT, DKI JAKARTA",25,137,127,264
https://kawalpemilu.org#25987,"JOGLO, KEMBANGAN, JAKARTA BARAT, DKI JAKARTA",26,109,156,265
https://kawalpemilu.org#25987,"JOGLO, KEMBANGAN, JAKARTA BARAT, DKI JAKARTA",27,90,145,235
https://kawalpemilu.org#25987,"JOGLO, KEMBANGAN, JAKARTA BARAT, DKI JAKARTA",28,111,103,214
https://kawalpemilu.org#25987,"JOGLO, KEMBANGAN, JAKARTA BARAT, DKI JAKARTA",29,93,117,210
https://kawalpemilu.org#25987,"JOGLO, KEMBANGAN, JAKARTA BARAT, DKI JAKARTA",30,79,148,227
https://kawalpemilu.org#25987,"JOGLO, KEMBANGAN, JAKARTA BARAT, DKI JAKARTA",31,95,135,230
https://kawalpemilu.org#25987,"JOGLO, KEMBANGAN, JAKARTA BARAT, DKI JAKARTA",32,94,143,237
https://kawalpemilu.org#25987,"JOGLO, KEMBANGAN, JAKARTA BARAT, DKI JAKARTA",33,79,131,210
https://kawalpemilu.org#25987,"JOGLO, KEMBANGAN, JAKARTA BARAT, DKI JAKARTA",34,115,138,253
https://kawalpemilu.org#25987,"JOGLO, KEMBANGAN, JAKARTA BARAT, DKI JAKARTA",35,93,125,218
https://kawalpemilu.org#25987,"JOGLO, KEMBANGAN, JAKARTA BARAT, DKI JAKARTA",36,121,110,231
https://kawalpemilu.org#25987,"JOGLO, KEMBANGAN, JAKARTA BARAT, DKI JAKARTA",37,100,142,242
https://kawalpemilu.org#25987,"JOGLO, KEMBANGAN, JAKARTA BARAT, DKI JAKARTA",38,104,155,259
https://kawalpemilu.org#25987,"JOGLO, KEMBANGAN, JAKARTA BARAT, DKI JAKARTA",39,113,117,230
https://kawalpemilu.org#25987,"JOGLO, KEMBANGAN, JAKARTA BARAT, DKI JAKARTA",40,121,106,227
https://kawalpemilu.org#25987,"JOGLO, KEMBANGAN, JAKARTA BARAT, DKI JAKARTA",41,102,136,238
https://kawalpemilu.org#25987,"JOGLO, KEMBANGAN, JAKARTA BARAT, DKI JAKARTA",42,123,126,249
https://kawalpemilu.org#25987,"JOGLO, KEMBANGAN, JAKARTA BARAT, DKI JAKARTA",43,81,136,217
https://kawalpemilu.org#25987,"JOGLO, KEMBANGAN, JAKARTA BARAT, DKI JAKARTA",44,85,162,247
https://kawalpemilu.org#25987,"JOGLO, KEMBANGAN, JAKARTA BARAT, DKI JAKARTA",45,86,148,234
https://kawalpemilu.org#25987,"JOGLO, KEMBANGAN, JAKARTA BARAT, DKI JAKARTA",46,80,179,259
https://kawalpemilu.org#25987,"JOGLO, KEMBANGAN, JAKARTA BARAT, DKI JAKARTA",47,127,135,262
https://kawalpemilu.org#25987,"JOGLO, KEMBANGAN, JAKARTA BARAT, DKI JAKARTA",48,136,110,246
https://kawalpemilu.org#25987,"JOGLO, KEMBANGAN, JAKARTA BARAT, DKI JAKARTA",49,82,129,211
https://kawalpemilu.org#25987,"JOGLO, KEMBANGAN, JAKARTA BARAT, DKI JAKARTA",50,117,137,254
https://kawalpemilu.org#25987,"JOGLO, KEMBANGAN, JAKARTA BARAT, DKI JAKARTA",51,92,163,255
https://kawalpemilu.org#25987,"JOGLO, KEMBANGAN, JAKARTA BARAT, DKI JAKARTA",52,93,140,233
https://kawalpemilu.org#25987,"JOGLO, KEMBANGAN, JAKARTA BARAT, DKI JAKARTA",53,124,146,270
https://kawalpemilu.org#25987,"JOGLO, KEMBANGAN, JAKARTA BARAT, DKI JAKARTA",54,135,122,260
https://kawalpemilu.org#25987,"JOGLO, KEMBANGAN, JAKARTA BARAT, DKI JAKARTA",55,98,159,257
https://kawalpemilu.org#25987,"JOGLO, KEMBANGAN, JAKARTA BARAT, DKI JAKARTA",56,83,108,191
https://kawalpemilu.org#25987,"JOGLO, KEMBANGAN, JAKARTA BARAT, DKI JAKARTA",57,103,109,212
https://kawalpemilu.org#25987,"JOGLO, KEMBANGAN, JAKARTA BARAT, DKI JAKARTA",58,140,103,243
https://kawalpemilu.org#25987,"JOGLO, KEMBANGAN, JAKARTA BARAT, DKI JAKARTA",59,116,88,204
https://kawalpemilu.org#25987,"JOGLO, KEMBANGAN, JAKARTA BARAT, DKI JAKARTA",60,84,93,177
https://kawalpemilu.org#25987,"JOGLO, KEMBANGAN, JAKARTA BARAT, DKI JAKARTA",61,107,131,238
https://kawalpemilu.org#25987,"JOGLO, KEMBANGAN, JAKARTA BARAT, DKI JAKARTA",62,100,129,229
https://kawalpemilu.org#25987,"JOGLO, KEMBANGAN, JAKARTA BARAT, DKI JAKARTA",63,95,96,191
https://kawalpemilu.org#25987,"JOGLO, KEMBANGAN, JAKARTA BARAT, DKI JAKARTA",64,111,129,240
https://kawalpemilu.org#25987,"JOGLO, KEMBANGAN, JAKARTA BARAT, DKI JAKARTA",65,116,119,235
https://kawalpemilu.org#25987,"JOGLO, KEMBANGAN, JAKARTA BARAT, DKI JAKARTA",66,119,132,251
https://kawalpemilu.org#25987,"JOGLO, KEMBANGAN, JAKARTA BARAT, DKI JAKARTA",67,135,116,251
https://kawalpemilu.org#25987,"JOGLO, KEMBANGAN, JAKARTA BARAT, DKI JAKARTA",68,97,121,218
https://kawalpemilu.org#25987,"JOGLO, KEMBANGAN, JAKARTA BARAT, DKI JAKARTA",69,78,168,246
https://kawalpemilu.org#25987,"JOGLO, KEMBANGAN, JAKARTA BARAT, DKI JAKARTA",70,124,78,202
https://kawalpemilu.org#25987,"JOGLO, KEMBANGAN, JAKARTA BARAT, DKI JAKARTA",71,108,96,204
https://kawalpemilu.org#25987,"JOGLO, KEMBANGAN, JAKARTA BARAT, DKI JAKARTA",72,101,106,207
https://kawalpemilu.org#25987,"JOGLO, KEMBANGAN, JAKARTA BARAT, DKI JAKARTA",73,135,117,252
https://kawalpemilu.org#25987,"JOGLO, KEMBANGAN, JAKARTA BARAT, DKI JAKARTA",74,113,122,235
https://kawalpemilu.org#25987,"JOGLO, KEMBANGAN, JAKARTA BARAT, DKI JAKARTA",75,107,125,232
https://kawalpemilu.org#25987,"JOGLO, KEMBANGAN, JAKARTA BARAT, DKI JAKARTA",76,106,137,243
https://kawalpemilu.org#25987,"JOGLO, KEMBANGAN, JAKARTA BARAT, DKI JAKARTA",77,68,127,195
https://kawalpemilu.org#25987,"JOGLO, KEMBANGAN, JAKARTA BARAT, DKI JAKARTA",78,117,100,217
https://kawalpemilu.org#25987,"JOGLO, KEMBANGAN, JAKARTA BARAT, DKI JAKARTA",79,107,124,231
https://kawalpemilu.org#25987,"JOGLO, KEMBANGAN, JAKARTA BARAT, DKI JAKARTA",80,88,125,213
https://kawalpemilu.org#25987,"JOGLO, KEMBANGAN, JAKARTA BARAT, DKI JAKARTA",81,199,33,232
https://kawalpemilu.org#25987,"JOGLO, KEMBANGAN, JAKARTA BARAT, DKI JAKARTA",83,187,50,237
https://kawalpemilu.org#25987,"JOGLO, KEMBANGAN, JAKARTA BARAT, DKI JAKARTA",84,146,58,204
https://kawalpemilu.org#25987,"JOGLO, KEMBANGAN, JAKARTA BARAT, DKI JAKARTA",85,164,38,202
https://kawalpemilu.org#25987,"JOGLO, KEMBANGAN, JAKARTA BARAT, DKI JAKARTA",86,172,36,208
https://kawalpemilu.org#25987,"JOGLO, KEMBANGAN, JAKARTA BARAT, DKI JAKARTA",88,76,124,200
https://kawalpemilu.org#25987,"JOGLO, KEMBANGAN, JAKARTA BARAT, DKI JAKARTA",89,86,134,220
https://kawalpemilu.org#25987,"JOGLO, KEMBANGAN, JAKARTA BARAT, DKI JAKARTA",90,88,126,214
https://kawalpemilu.org#25987,"JOGLO, KEMBANGAN, JAKARTA BARAT, DKI JAKARTA",91,92,111,203
https://kawalpemilu.org#25987,"JOGLO, KEMBANGAN, JAKARTA BARAT, DKI JAKARTA",92,72,152,224
https://kawalpemilu.org#25987,"JOGLO, KEMBANGAN, JAKARTA BARAT, DKI JAKARTA",93,74,97,171
https://kawalpemilu.org#25987,"JOGLO, KEMBANGAN, JAKARTA BARAT, DKI JAKARTA",94,118,112,230
https://kawalpemilu.org#25987,"JOGLO, KEMBANGAN, JAKARTA BARAT, DKI JAKARTA",95,91,143,234
https://kawalpemilu.org#25987,"JOGLO, KEMBANGAN, JAKARTA BARAT, DKI JAKARTA",96,64,148,212
https://kawalpemilu.org#25987,"JOGLO, KEMBANGAN, JAKARTA BARAT, DKI JAKARTA",97,91,104,195
https://kawalpemilu.org#25987,"JOGLO, KEMBANGAN, JAKARTA BARAT, DKI JAKARTA",98,123,95,218
https://kawalpemilu.org#25987,"JOGLO, KEMBANGAN, JAKARTA BARAT, DKI JAKARTA",99,113,136,249
https://kawalpemilu.org#25987,"JOGLO, KEMBANGAN, JAKARTA BARAT, DKI JAKARTA",100,105,102,207
https://kawalpemilu.org#25987,"JOGLO, KEMBANGAN, JAKARTA BARAT, DKI JAKARTA",101,129,81,210
https://kawalpemilu.org#25987,"JOGLO, KEMBANGAN, JAKARTA BARAT, DKI JAKARTA",102,82,105,187
https://kawalpemilu.org#25987,"JOGLO, KEMBANGAN, JAKARTA BARAT, DKI JAKARTA",103,77,165,242
https://kawalpemilu.org#25987,"JOGLO, KEMBANGAN, JAKARTA BARAT, DKI JAKARTA",104,113,135,248
https://kawalpemilu.org#25987,"JOGLO, KEMBANGAN, JAKARTA BARAT, DKI JAKARTA",105,92,149,241
https://kawalpemilu.org#25987,"JOGLO, KEMBANGAN, JAKARTA BARAT, DKI JAKARTA",106,104,117,221
https://kawalpemilu.org#25987,"JOGLO, KEMBANGAN, JAKARTA BARAT, DKI JAKARTA",107,89,113,202
https://kawalpemilu.org#25987,"JOGLO, KEMBANGAN, JAKARTA BARAT, DKI JAKARTA",108,211,35,246
https://kawalpemilu.org#25987,"JOGLO, KEMBANGAN, JAKARTA BARAT, DKI JAKARTA",109,213,21,234
https://kawalpemilu.org#25987,"JOGLO, KEMBANGAN, JAKARTA BARAT, DKI JAKARTA",110,222,16,238
https://kawalpemilu.org#25987,"JOGLO, KEMBANGAN, JAKARTA BARAT, DKI JAKARTA",111,204,17,221
https://kawalpemilu.org#25987,"JOGLO, KEMBANGAN, JAKARTA BARAT, DKI JAKARTA",112,233,17,250
https://kawalpemilu.org#25987,"JOGLO, KEMBANGAN, JAKARTA BARAT, DKI JAKARTA",113,105,116,221
https://kawalpemilu.org#25987,"JOGLO, KEMBANGAN, JAKARTA BARAT, DKI JAKARTA",114,108,85,193
https://kawalpemilu.org#25987,"JOGLO, KEMBANGAN, JAKARTA BARAT, DKI JAKARTA",115,96,93,189
https://kawalpemilu.org#25987,"JOGLO, KEMBANGAN, JAKARTA BARAT, DKI JAKARTA",116,97,86,183
https://kawalpemilu.org#25987,"JOGLO, KEMBANGAN, JAKARTA BARAT, DKI JAKARTA",117,129,106,235
https://kawalpemilu.org#25987,"JOGLO, KEMBANGAN, JAKARTA BARAT, DKI JAKARTA",118,105,108,213
https://kawalpemilu.org#25987,"JOGLO, KEMBANGAN, JAKARTA BARAT, DKI JAKARTA",119,90,147,237
https://kawalpemilu.org#25987,"JOGLO, KEMBANGAN, JAKARTA BARAT, DKI JAKARTA",120,97,113,210
https://kawalpemilu.org#25987,"JOGLO, KEMBANGAN, JAKARTA BARAT, DKI JAKARTA",121,120,132,252
https://kawalpemilu.org#25987,"JOGLO, KEMBANGAN, JAKARTA BARAT, DKI JAKARTA",122,100,126,226
https://kawalpemilu.org#25987,"JOGLO, KEMBANGAN, JAKARTA BARAT, DKI JAKARTA",123,105,119,224
https://kawalpemilu.org#25987,"JOGLO, KEMBANGAN, JAKARTA BARAT, DKI JAKARTA",124,119,129,248
https://kawalpemilu.org#25987,"JOGLO, KEMBANGAN, JAKARTA BARAT, DKI JAKARTA",125,86,176,262
https://kawalpemilu.org#25987,"JOGLO, KEMBANGAN, JAKARTA BARAT, DKI JAKARTA",126,119,161,280
https://kawalpemilu.org#25987,"JOGLO, KEMBANGAN, JAKARTA BARAT, DKI JAKARTA",127,137,104,241
https://kawalpemilu.org#25987,"JOGLO, KEMBANGAN, JAKARTA BARAT, DKI JAKARTA",128,92,147,239
https://kawalpemilu.org#25987,"JOGLO, KEMBANGAN, JAKARTA BARAT, DKI JAKARTA",129,91,115,206
https://kawalpemilu.org#25987,"JOGLO, KEMBANGAN, JAKARTA BARAT, DKI JAKARTA",130,181,24,205
https://kawalpemilu.org#25987,"JOGLO, KEMBANGAN, JAKARTA BARAT, DKI JAKARTA",131,147,13,160
https://kawalpemilu.org#25988,"KEMBANGAN SELATAN, KEMBANGAN, JAKARTA BARAT, DKI JAKARTA",1,54,166,220
https://kawalpemilu.org#25988,"KEMBANGAN SELATAN, KEMBANGAN, JAKARTA BARAT, DKI JAKARTA",2,52,150,202
https://kawalpemilu.org#25988,"KEMBANGAN SELATAN, KEMBANGAN, JAKARTA BARAT, DKI JAKARTA",3,82,119,201
https://kawalpemilu.org#25988,"KEMBANGAN SELATAN, KEMBANGAN, JAKARTA BARAT, DKI JAKARTA",4,52,150,202
https://kawalpemilu.org#25988,"KEMBANGAN SELATAN, KEMBANGAN, JAKARTA BARAT, DKI JAKARTA",5,47,145,192
https://kawalpemilu.org#25988,"KEMBANGAN SELATAN, KEMBANGAN, JAKARTA BARAT, DKI JAKARTA",6,61,151,212
https://kawalpemilu.org#25988,"KEMBANGAN SELATAN, KEMBANGAN, JAKARTA BARAT, DKI JAKARTA",7,52,173,225
https://kawalpemilu.org#25988,"KEMBANGAN SELATAN, KEMBANGAN, JAKARTA BARAT, DKI JAKARTA",8,50,177,227
https://kawalpemilu.org#25988,"KEMBANGAN SELATAN, KEMBANGAN, JAKARTA BARAT, DKI JAKARTA",9,46,196,242
https://kawalpemilu.org#25988,"KEMBANGAN SELATAN, KEMBANGAN, JAKARTA BARAT, DKI JAKARTA",10,59,184,243
https://kawalpemilu.org#25988,"KEMBANGAN SELATAN, KEMBANGAN, JAKARTA BARAT, DKI JAKARTA",11,112,130,242
https://kawalpemilu.org#25988,"KEMBANGAN SELATAN, KEMBANGAN, JAKARTA BARAT, DKI JAKARTA",12,82,126,208
https://kawalpemilu.org#25988,"KEMBANGAN SELATAN, KEMBANGAN, JAKARTA BARAT, DKI JAKARTA",13,73,151,224
https://kawalpemilu.org#25988,"KEMBANGAN SELATAN, KEMBANGAN, JAKARTA BARAT, DKI JAKARTA",14,88,142,230
https://kawalpemilu.org#25988,"KEMBANGAN SELATAN, KEMBANGAN, JAKARTA BARAT, DKI JAKARTA",15,107,149,256
https://kawalpemilu.org#25988,"KEMBANGAN SELATAN, KEMBANGAN, JAKARTA BARAT, DKI JAKARTA",16,106,138,244
https://kawalpemilu.org#25988,"KEMBANGAN SELATAN, KEMBANGAN, JAKARTA BARAT, DKI JAKARTA",17,104,125,229
https://kawalpemilu.org#25988,"KEMBANGAN SELATAN, KEMBANGAN, JAKARTA BARAT, DKI JAKARTA",18,79,161,240
https://kawalpemilu.org#25988,"KEMBANGAN SELATAN, KEMBANGAN, JAKARTA BARAT, DKI JAKARTA",19,41,187,228
https://kawalpemilu.org#25988,"KEMBANGAN SELATAN, KEMBANGAN, JAKARTA BARAT, DKI JAKARTA",20,76,163,239
https://kawalpemilu.org#25988,"KEMBANGAN SELATAN, KEMBANGAN, JAKARTA BARAT, DKI JAKARTA",21,47,166,213
https://kawalpemilu.org#25988,"KEMBANGAN SELATAN, KEMBANGAN, JAKARTA BARAT, DKI JAKARTA",22,62,120,182
https://kawalpemilu.org#25988,"KEMBANGAN SELATAN, KEMBANGAN, JAKARTA BARAT, DKI JAKARTA",23,152,6,158
https://kawalpemilu.org#25988,"KEMBANGAN SELATAN, KEMBANGAN, JAKARTA BARAT, DKI JAKARTA",24,173,9,182
https://kawalpemilu.org#25988,"KEMBANGAN SELATAN, KEMBANGAN, JAKARTA BARAT, DKI JAKARTA",25,106,119,225
https://kawalpemilu.org#25988,"KEMBANGAN SELATAN, KEMBANGAN, JAKARTA BARAT, DKI JAKARTA",26,107,111,218
https://kawalpemilu.org#25988,"KEMBANGAN SELATAN, KEMBANGAN, JAKARTA BARAT, DKI JAKARTA",27,151,75,226
https://kawalpemilu.org#25988,"KEMBANGAN SELATAN, KEMBANGAN, JAKARTA BARAT, DKI JAKARTA",28,108,114,222
https://kawalpemilu.org#25988,"KEMBANGAN SELATAN, KEMBANGAN, JAKARTA BARAT, DKI JAKARTA",29,114,93,207
https://kawalpemilu.org#25988,"KEMBANGAN SELATAN, KEMBANGAN, JAKARTA BARAT, DKI JAKARTA",30,127,113,240
https://kawalpemilu.org#25988,"KEMBANGAN SELATAN, KEMBANGAN, JAKARTA BARAT, DKI JAKARTA",31,143,132,275
https://kawalpemilu.org#25988,"KEMBANGAN SELATAN, KEMBANGAN, JAKARTA BARAT, DKI JAKARTA",32,113,105,218
https://kawalpemilu.org#25988,"KEMBANGAN SELATAN, KEMBANGAN, JAKARTA BARAT, DKI JAKARTA",33,176,6,182
https://kawalpemilu.org#25988,"KEMBANGAN SELATAN, KEMBANGAN, JAKARTA BARAT, DKI JAKARTA",34,243,7,250
https://kawalpemilu.org#25988,"KEMBANGAN SELATAN, KEMBANGAN, JAKARTA BARAT, DKI JAKARTA",35,250,2,252
https://kawalpemilu.org#25988,"KEMBANGAN SELATAN, KEMBANGAN, JAKARTA BARAT, DKI JAKARTA",36,105,62,167
https://kawalpemilu.org#25988,"KEMBANGAN SELATAN, KEMBANGAN, JAKARTA BARAT, DKI JAKARTA",37,122,138,260
https://kawalpemilu.org#25988,"KEMBANGAN SELATAN, KEMBANGAN, JAKARTA BARAT, DKI JAKARTA",38,103,156,259
https://kawalpemilu.org#25988,"KEMBANGAN SELATAN, KEMBANGAN, JAKARTA BARAT, DKI JAKARTA",39,116,99,215
https://kawalpemilu.org#25988,"KEMBANGAN SELATAN, KEMBANGAN, JAKARTA BARAT, DKI JAKARTA",40,102,122,224
https://kawalpemilu.org#25988,"KEMBANGAN SELATAN, KEMBANGAN, JAKARTA BARAT, DKI JAKARTA",41,109,106,215
https://kawalpemilu.org#25988,"KEMBANGAN SELATAN, KEMBANGAN, JAKARTA BARAT, DKI JAKARTA",42,102,145,247
https://kawalpemilu.org#25988,"KEMBANGAN SELATAN, KEMBANGAN, JAKARTA BARAT, DKI JAKARTA",43,117,83,200
https://kawalpemilu.org#25988,"KEMBANGAN SELATAN, KEMBANGAN, JAKARTA BARAT, DKI JAKARTA",44,106,102,208
https://kawalpemilu.org#25988,"KEMBANGAN SELATAN, KEMBANGAN, JAKARTA BARAT, DKI JAKARTA",45,92,79,171
https://kawalpemilu.org#25988,"KEMBANGAN SELATAN, KEMBANGAN, JAKARTA BARAT, DKI JAKARTA",46,178,10,188
https://kawalpemilu.org#25988,"KEMBANGAN SELATAN, KEMBANGAN, JAKARTA BARAT, DKI JAKARTA",47,175,23,198
https://kawalpemilu.org#25988,"KEMBANGAN SELATAN, KEMBANGAN, JAKARTA BARAT, DKI JAKARTA",48,122,100,222
https://kawalpemilu.org#25988,"KEMBANGAN SELATAN, KEMBANGAN, JAKARTA BARAT, DKI JAKARTA",49,86,69,155
https://kawalpemilu.org#25988,"KEMBANGAN SELATAN, KEMBANGAN, JAKARTA BARAT, DKI JAKARTA",50,172,1,173
https://kawalpemilu.org#25988,"KEMBANGAN SELATAN, KEMBANGAN, JAKARTA BARAT, DKI JAKARTA",51,200,1,201
https://kawalpemilu.org#25988,"KEMBANGAN SELATAN, KEMBANGAN, JAKARTA BARAT, DKI JAKARTA",52,142,112,254
https://kawalpemilu.org#25988,"KEMBANGAN SELATAN, KEMBANGAN, JAKARTA BARAT, DKI JAKARTA",53,86,101,187
https://kawalpemilu.org#25988,"KEMBANGAN SELATAN, KEMBANGAN, JAKARTA BARAT, DKI JAKARTA",54,84,92,176
https://kawalpemilu.org#25988,"KEMBANGAN SELATAN, KEMBANGAN, JAKARTA BARAT, DKI JAKARTA",55,106,159,265
https://kawalpemilu.org#25988,"KEMBANGAN SELATAN, KEMBANGAN, JAKARTA BARAT, DKI JAKARTA",56,133,53,186
https://kawalpemilu.org#25988,"KEMBANGAN SELATAN, KEMBANGAN, JAKARTA BARAT, DKI JAKARTA",57,129,29,158
https://kawalpemilu.org#25988,"KEMBANGAN SELATAN, KEMBANGAN, JAKARTA BARAT, DKI JAKARTA",58,203,1,204
https://kawalpemilu.org#25988,"KEMBANGAN SELATAN, KEMBANGAN, JAKARTA BARAT, DKI JAKARTA",59,224,9,233
https://kawalpemilu.org#25988,"KEMBANGAN SELATAN, KEMBANGAN, JAKARTA BARAT, DKI JAKARTA",60,171,15,186
https://kawalpemilu.org#25988,"KEMBANGAN SELATAN, KEMBANGAN, JAKARTA BARAT, DKI JAKARTA",61,203,8,211
https://kawalpemilu.org#25988,"KEMBANGAN SELATAN, KEMBANGAN, JAKARTA BARAT, DKI JAKARTA",62,210,4,214
https://kawalpemilu.org#25988,"KEMBANGAN SELATAN, KEMBANGAN, JAKARTA BARAT, DKI JAKARTA",63,178,6,184
https://kawalpemilu.org#25988,"KEMBANGAN SELATAN, KEMBANGAN, JAKARTA BARAT, DKI JAKARTA",64,172,1,173
https://kawalpemilu.org#25988,"KEMBANGAN SELATAN, KEMBANGAN, JAKARTA BARAT, DKI JAKARTA",65,178,1,179
https://kawalpemilu.org#25988,"KEMBANGAN SELATAN, KEMBANGAN, JAKARTA BARAT, DKI JAKARTA",66,192,4,196
https://kawalpemilu.org#25988,"KEMBANGAN SELATAN, KEMBANGAN, JAKARTA BARAT, DKI JAKARTA",67,113,92,205
https://kawalpemilu.org#25988,"KEMBANGAN SELATAN, KEMBANGAN, JAKARTA BARAT, DKI JAKARTA",68,154,3,157
https://kawalpemilu.org#25988,"KEMBANGAN SELATAN, KEMBANGAN, JAKARTA BARAT, DKI JAKARTA",69,129,166,295
https://kawalpemilu.org#25988,"KEMBANGAN SELATAN, KEMBANGAN, JAKARTA BARAT, DKI JAKARTA",70,158,1,159
https://kawalpemilu.org#25988,"KEMBANGAN SELATAN, KEMBANGAN, JAKARTA BARAT, DKI JAKARTA",71,165,6,171
https://kawalpemilu.org#25988,"KEMBANGAN SELATAN, KEMBANGAN, JAKARTA BARAT, DKI JAKARTA",72,248,12,260
https://kawalpemilu.org#25988,"KEMBANGAN SELATAN, KEMBANGAN, JAKARTA BARAT, DKI JAKARTA",73,224,9,233
https://kawalpemilu.org#25988,"KEMBANGAN SELATAN, KEMBANGAN, JAKARTA BARAT, DKI JAKARTA",74,242,15,257
https://kawalpemilu.org#25988,"KEMBANGAN SELATAN, KEMBANGAN, JAKARTA BARAT, DKI JAKARTA",75,231,3,234
https://kawalpemilu.org#25988,"KEMBANGAN SELATAN, KEMBANGAN, JAKARTA BARAT, DKI JAKARTA",76,124,116,240
https://kawalpemilu.org#25988,"KEMBANGAN SELATAN, KEMBANGAN, JAKARTA BARAT, DKI JAKARTA",77,222,3,225
https://kawalpemilu.org#25988,"KEMBANGAN SELATAN, KEMBANGAN, JAKARTA BARAT, DKI JAKARTA",78,223,9,232
https://kawalpemilu.org#25988,"KEMBANGAN SELATAN, KEMBANGAN, JAKARTA BARAT, DKI JAKARTA",79,208,9,217
https://kawalpemilu.org#25988,"KEMBANGAN SELATAN, KEMBANGAN, JAKARTA BARAT, DKI JAKARTA",80,100,97,197
https://kawalpemilu.org#25988,"KEMBANGAN SELATAN, KEMBANGAN, JAKARTA BARAT, DKI JAKARTA",81,109,77,186
https://kawalpemilu.org#25988,"KEMBANGAN SELATAN, KEMBANGAN, JAKARTA BARAT, DKI JAKARTA",82,97,76,173
https://kawalpemilu.org#25988,"KEMBANGAN SELATAN, KEMBANGAN, JAKARTA BARAT, DKI JAKARTA",83,189,32,221
https://kawalpemilu.org#25988,"KEMBANGAN SELATAN, KEMBANGAN, JAKARTA BARAT, DKI JAKARTA",84,202,32,234
https://kawalpemilu.org#25988,"KEMBANGAN SELATAN, KEMBANGAN, JAKARTA BARAT, DKI JAKARTA",85,192,20,212
https://kawalpemilu.org#25988,"KEMBANGAN SELATAN, KEMBANGAN, JAKARTA BARAT, DKI JAKARTA",86,205,3,208
https://kawalpemilu.org#25988,"KEMBANGAN SELATAN, KEMBANGAN, JAKARTA BARAT, DKI JAKARTA",87,116,110,226
https://kawalpemilu.org#25988,"KEMBANGAN SELATAN, KEMBANGAN, JAKARTA BARAT, DKI JAKARTA",88,100,102,202
https://kawalpemilu.org#25988,"KEMBANGAN SELATAN, KEMBANGAN, JAKARTA BARAT, DKI JAKARTA",89,129,116,245
https://kawalpemilu.org#25988,"KEMBANGAN SELATAN, KEMBANGAN, JAKARTA BARAT, DKI JAKARTA",90,112,157,269
https://kawalpemilu.org#25988,"KEMBANGAN SELATAN, KEMBANGAN, JAKARTA BARAT, DKI JAKARTA",91,96,154,250
https://kawalpemilu.org#25988,"KEMBANGAN SELATAN, KEMBANGAN, JAKARTA BARAT, DKI JAKARTA",92,123,110,233
https://kawalpemilu.org#25991,"TEBET TIMUR, TEBET, JAKARTA SELATAN, DKI JAKARTA",1,133,107,240
https://kawalpemilu.org#25991,"TEBET TIMUR, TEBET, JAKARTA SELATAN, DKI JAKARTA",2,108,124,232
https://kawalpemilu.org#25991,"TEBET TIMUR, TEBET, JAKARTA SELATAN, DKI JAKARTA",3,88,113,201
https://kawalpemilu.org#25991,"TEBET TIMUR, TEBET, JAKARTA SELATAN, DKI JAKARTA",4,93,82,175
https://kawalpemilu.org#25991,"TEBET TIMUR, TEBET, JAKARTA SELATAN, DKI JAKARTA",5,98,151,249
https://kawalpemilu.org#25991,"TEBET TIMUR, TEBET, JAKARTA SELATAN, DKI JAKARTA",6,96,126,222
https://kawalpemilu.org#25991,"TEBET TIMUR, TEBET, JAKARTA SELATAN, DKI JAKARTA",7,94,131,225
https://kawalpemilu.org#25991,"TEBET TIMUR, TEBET, JAKARTA SELATAN, DKI JAKARTA",8,94,119,213
https://kawalpemilu.org#25991,"TEBET TIMUR, TEBET, JAKARTA SELATAN, DKI JAKARTA",9,98,121,219
https://kawalpemilu.org#25991,"TEBET TIMUR, TEBET, JAKARTA SELATAN, DKI JAKARTA",10,129,107,236
https://kawalpemilu.org#25991,"TEBET TIMUR, TEBET, JAKARTA SELATAN, DKI JAKARTA",11,120,88,208
https://kawalpemilu.org#25991,"TEBET TIMUR, TEBET, JAKARTA SELATAN, DKI JAKARTA",12,148,88,236
https://kawalpemilu.org#25991,"TEBET TIMUR, TEBET, JAKARTA SELATAN, DKI JAKARTA",13,119,77,196
https://kawalpemilu.org#25991,"TEBET TIMUR, TEBET, JAKARTA SELATAN, DKI JAKARTA",14,124,79,203
https://kawalpemilu.org#25991,"TEBET TIMUR, TEBET, JAKARTA SELATAN, DKI JAKARTA",15,99,109,208
https://kawalpemilu.org#25991,"TEBET TIMUR, TEBET, JAKARTA SELATAN, DKI JAKARTA",16,81,126,207
https://kawalpemilu.org#25991,"TEBET TIMUR, TEBET, JAKARTA SELATAN, DKI JAKARTA",17,78,165,243
https://kawalpemilu.org#25991,"TEBET TIMUR, TEBET, JAKARTA SELATAN, DKI JAKARTA",18,111,116,227
https://kawalpemilu.org#25991,"TEBET TIMUR, TEBET, JAKARTA SELATAN, DKI JAKARTA",19,83,145,228
https://kawalpemilu.org#25991,"TEBET TIMUR, TEBET, JAKARTA SELATAN, DKI JAKARTA",20,100,120,220
https://kawalpemilu.org#25991,"TEBET TIMUR, TEBET, JAKARTA SELATAN, DKI JAKARTA",21,89,108,197
https://kawalpemilu.org#25991,"TEBET TIMUR, TEBET, JAKARTA SELATAN, DKI JAKARTA",22,70,112,182
https://kawalpemilu.org#25991,"TEBET TIMUR, TEBET, JAKARTA SELATAN, DKI JAKARTA",23,64,120,184
https://kawalpemilu.org#25991,"TEBET TIMUR, TEBET, JAKARTA SELATAN, DKI JAKARTA",24,89,71,160
https://kawalpemilu.org#25991,"TEBET TIMUR, TEBET, JAKARTA SELATAN, DKI JAKARTA",25,121,146,267
https://kawalpemilu.org#25991,"TEBET TIMUR, TEBET, JAKARTA SELATAN, DKI JAKARTA",26,94,148,242
https://kawalpemilu.org#25991,"TEBET TIMUR, TEBET, JAKARTA SELATAN, DKI JAKARTA",27,102,104,206
https://kawalpemilu.org#25991,"TEBET TIMUR, TEBET, JAKARTA SELATAN, DKI JAKARTA",28,138,60,198
https://kawalpemilu.org#25991,"TEBET TIMUR, TEBET, JAKARTA SELATAN, DKI JAKARTA",29,147,81,228
https://kawalpemilu.org#25991,"TEBET TIMUR, TEBET, JAKARTA SELATAN, DKI JAKARTA",30,97,82,179
https://kawalpemilu.org#25991,"TEBET TIMUR, TEBET, JAKARTA SELATAN, DKI JAKARTA",31,122,112,234
https://kawalpemilu.org#25991,"TEBET TIMUR, TEBET, JAKARTA SELATAN, DKI JAKARTA",32,128,107,235
https://kawalpemilu.org#25991,"TEBET TIMUR, TEBET, JAKARTA SELATAN, DKI JAKARTA",33,110,129,239
https://kawalpemilu.org#25991,"TEBET TIMUR, TEBET, JAKARTA SELATAN, DKI JAKARTA",34,136,90,226
https://kawalpemilu.org#25991,"TEBET TIMUR, TEBET, JAKARTA SELATAN, DKI JAKARTA",35,163,96,259
https://kawalpemilu.org#25991,"TEBET TIMUR, TEBET, JAKARTA SELATAN, DKI JAKARTA",36,132,94,226
https://kawalpemilu.org#25991,"TEBET TIMUR, TEBET, JAKARTA SELATAN, DKI JAKARTA",37,127,107,234
https://kawalpemilu.org#25991,"TEBET TIMUR, TEBET, JAKARTA SELATAN, DKI JAKARTA",38,135,97,232
https://kawalpemilu.org#25991,"TEBET TIMUR, TEBET, JAKARTA SELATAN, DKI JAKARTA",39,137,73,210
https://kawalpemilu.org#25991,"TEBET TIMUR, TEBET, JAKARTA SELATAN, DKI JAKARTA",40,124,92,216
https://kawalpemilu.org#25991,"TEBET TIMUR, TEBET, JAKARTA SELATAN, DKI JAKARTA",41,94,130,224
https://kawalpemilu.org#25991,"TEBET TIMUR, TEBET, JAKARTA SELATAN, DKI JAKARTA",42,121,66,187
https://kawalpemilu.org#25991,"TEBET TIMUR, TEBET, JAKARTA SELATAN, DKI JAKARTA",43,106,118,224
https://kawalpemilu.org#25991,"TEBET TIMUR, TEBET, JAKARTA SELATAN, DKI JAKARTA",44,143,100,243
https://kawalpemilu.org#25991,"TEBET TIMUR, TEBET, JAKARTA SELATAN, DKI JAKARTA",45,132,81,213
https://kawalpemilu.org#25991,"TEBET TIMUR, TEBET, JAKARTA SELATAN, DKI JAKARTA",46,122,107,229
https://kawalpemilu.org#25991,"TEBET TIMUR, TEBET, JAKARTA SELATAN, DKI JAKARTA",47,87,99,186
https://kawalpemilu.org#25991,"TEBET TIMUR, TEBET, JAKARTA SELATAN, DKI JAKARTA",48,106,101,207
https://kawalpemilu.org#25991,"TEBET TIMUR, TEBET, JAKARTA SELATAN, DKI JAKARTA",49,131,104,235
https://kawalpemilu.org#25991,"TEBET TIMUR, TEBET, JAKARTA SELATAN, DKI JAKARTA",50,121,66,187
https://kawalpemilu.org#25991,"TEBET TIMUR, TEBET, JAKARTA SELATAN, DKI JAKARTA",51,91,135,226
https://kawalpemilu.org#25991,"TEBET TIMUR, TEBET, JAKARTA SELATAN, DKI JAKARTA",52,87,153,240
https://kawalpemilu.org#25991,"TEBET TIMUR, TEBET, JAKARTA SELATAN, DKI JAKARTA",53,103,116,219
https://kawalpemilu.org#25991,"TEBET TIMUR, TEBET, JAKARTA SELATAN, DKI JAKARTA",54,90,135,225
https://kawalpemilu.org#25991,"TEBET TIMUR, TEBET, JAKARTA SELATAN, DKI JAKARTA",55,106,134,240
https://kawalpemilu.org#25991,"TEBET TIMUR, TEBET, JAKARTA SELATAN, DKI JAKARTA",56,101,142,243
https://kawalpemilu.org#25991,"TEBET TIMUR, TEBET, JAKARTA SELATAN, DKI JAKARTA",57,96,121,217
https://kawalpemilu.org#25991,"TEBET TIMUR, TEBET, JAKARTA SELATAN, DKI JAKARTA",58,123,119,242
https://kawalpemilu.org#25991,"TEBET TIMUR, TEBET, JAKARTA SELATAN, DKI JAKARTA",59,120,105,225
https://kawalpemilu.org#25991,"TEBET TIMUR, TEBET, JAKARTA SELATAN, DKI JAKARTA",60,117,107,224
https://kawalpemilu.org#25991,"TEBET TIMUR, TEBET, JAKARTA SELATAN, DKI JAKARTA",61,108,73,181
https://kawalpemilu.org#25991,"TEBET TIMUR, TEBET, JAKARTA SELATAN, DKI JAKARTA",62,139,109,248
https://kawalpemilu.org#25991,"TEBET TIMUR, TEBET, JAKARTA SELATAN, DKI JAKARTA",63,119,115,234
https://kawalpemilu.org#25992,"TEBET BARAT, TEBET, JAKARTA SELATAN, DKI JAKARTA",1,138,93,231
https://kawalpemilu.org#25992,"TEBET BARAT, TEBET, JAKARTA SELATAN, DKI JAKARTA",2,122,123,245
https://kawalpemilu.org#25992,"TEBET BARAT, TEBET, JAKARTA SELATAN, DKI JAKARTA",3,124,46,170
https://kawalpemilu.org#25992,"TEBET BARAT, TEBET, JAKARTA SELATAN, DKI JAKARTA",4,121,50,171
https://kawalpemilu.org#25992,"TEBET BARAT, TEBET, JAKARTA SELATAN, DKI JAKARTA",5,109,65,174
https://kawalpemilu.org#25992,"TEBET BARAT, TEBET, JAKARTA SELATAN, DKI JAKARTA",6,79,46,125
https://kawalpemilu.org#25992,"TEBET BARAT, TEBET, JAKARTA SELATAN, DKI JAKARTA",8,96,87,183
https://kawalpemilu.org#25992,"TEBET BARAT, TEBET, JAKARTA SELATAN, DKI JAKARTA",9,81,48,129
https://kawalpemilu.org#25992,"TEBET BARAT, TEBET, JAKARTA SELATAN, DKI JAKARTA",10,117,93,210
https://kawalpemilu.org#25992,"TEBET BARAT, TEBET, JAKARTA SELATAN, DKI JAKARTA",12,108,133,241
https://kawalpemilu.org#25992,"TEBET BARAT, TEBET, JAKARTA SELATAN, DKI JAKARTA",13,110,113,223
https://kawalpemilu.org#25992,"TEBET BARAT, TEBET, JAKARTA SELATAN, DKI JAKARTA",14,106,126,232
https://kawalpemilu.org#25992,"TEBET BARAT, TEBET, JAKARTA SELATAN, DKI JAKARTA",16,120,102,222
https://kawalpemilu.org#25992,"TEBET BARAT, TEBET, JAKARTA SELATAN, DKI JAKARTA",17,116,87,203
https://kawalpemilu.org#25992,"TEBET BARAT, TEBET, JAKARTA SELATAN, DKI JAKARTA",19,107,153,260
https://kawalpemilu.org#25992,"TEBET BARAT, TEBET, JAKARTA SELATAN, DKI JAKARTA",20,136,124,260
https://kawalpemilu.org#25992,"TEBET BARAT, TEBET, JAKARTA SELATAN, DKI JAKARTA",21,121,82,203
https://kawalpemilu.org#25992,"TEBET BARAT, TEBET, JAKARTA SELATAN, DKI JAKARTA",22,180,50,230
https://kawalpemilu.org#25992,"TEBET BARAT, TEBET, JAKARTA SELATAN, DKI JAKARTA",23,120,95,215
https://kawalpemilu.org#25992,"TEBET BARAT, TEBET, JAKARTA SELATAN, DKI JAKARTA",25,139,82,221
https://kawalpemilu.org#25992,"TEBET BARAT, TEBET, JAKARTA SELATAN, DKI JAKARTA",26,82,100,182
https://kawalpemilu.org#25992,"TEBET BARAT, TEBET, JAKARTA SELATAN, DKI JAKARTA",27,63,95,158
https://kawalpemilu.org#25992,"TEBET BARAT, TEBET, JAKARTA SELATAN, DKI JAKARTA",28,91,70,161
https://kawalpemilu.org#25992,"TEBET BARAT, TEBET, JAKARTA SELATAN, DKI JAKARTA",29,127,73,200
https://kawalpemilu.org#25992,"TEBET BARAT, TEBET, JAKARTA SELATAN, DKI JAKARTA",30,152,87,239
https://kawalpemilu.org#25992,"TEBET BARAT, TEBET, JAKARTA SELATAN, DKI JAKARTA",31,139,70,209
https://kawalpemilu.org#25992,"TEBET BARAT, TEBET, JAKARTA SELATAN, DKI JAKARTA",32,118,86,204
https://kawalpemilu.org#25992,"TEBET BARAT, TEBET, JAKARTA SELATAN, DKI JAKARTA",33,93,97,190
https://kawalpemilu.org#25992,"TEBET BARAT, TEBET, JAKARTA SELATAN, DKI JAKARTA",34,87,102,189
https://kawalpemilu.org#25992,"TEBET BARAT, TEBET, JAKARTA SELATAN, DKI JAKARTA",35,84,100,184
https://kawalpemilu.org#25992,"TEBET BARAT, TEBET, JAKARTA SELATAN, DKI JAKARTA",36,85,108,193
https://kawalpemilu.org#25992,"TEBET BARAT, TEBET, JAKARTA SELATAN, DKI JAKARTA",37,100,80,180
https://kawalpemilu.org#25992,"TEBET BARAT, TEBET, JAKARTA SELATAN, DKI JAKARTA",38,102,60,162
https://kawalpemilu.org#25992,"TEBET BARAT, TEBET, JAKARTA SELATAN, DKI JAKARTA",39,111,110,221
https://kawalpemilu.org#25992,"TEBET BARAT, TEBET, JAKARTA SELATAN, DKI JAKARTA",40,86,128,214
https://kawalpemilu.org#25992,"TEBET BARAT, TEBET, JAKARTA SELATAN, DKI JAKARTA",41,86,113,199
https://kawalpemilu.org#25992,"TEBET BARAT, TEBET, JAKARTA SELATAN, DKI JAKARTA",42,100,63,163
https://kawalpemilu.org#25992,"TEBET BARAT, TEBET, JAKARTA SELATAN, DKI JAKARTA",43,103,64,167
https://kawalpemilu.org#25992,"TEBET BARAT, TEBET, JAKARTA SELATAN, DKI JAKARTA",45,120,115,235
https://kawalpemilu.org#25992,"TEBET BARAT, TEBET, JAKARTA SELATAN, DKI JAKARTA",46,139,107,246
https://kawalpemilu.org#25992,"TEBET BARAT, TEBET, JAKARTA SELATAN, DKI JAKARTA",47,106,100,206
https://kawalpemilu.org#25992,"TEBET BARAT, TEBET, JAKARTA SELATAN, DKI JAKARTA",48,123,112,235
https://kawalpemilu.org#25992,"TEBET BARAT, TEBET, JAKARTA SELATAN, DKI JAKARTA",49,124,83,207
https://kawalpemilu.org#25992,"TEBET BARAT, TEBET, JAKARTA SELATAN, DKI JAKARTA",50,85,93,178
https://kawalpemilu.org#25992,"TEBET BARAT, TEBET, JAKARTA SELATAN, DKI JAKARTA",52,133,97,230
https://kawalpemilu.org#25992,"TEBET BARAT, TEBET, JAKARTA SELATAN, DKI JAKARTA",54,98,140,238
https://kawalpemilu.org#25992,"TEBET BARAT, TEBET, JAKARTA SELATAN, DKI JAKARTA",55,71,89,160
https://kawalpemilu.org#25992,"TEBET BARAT, TEBET, JAKARTA SELATAN, DKI JAKARTA",56,159,63,222
https://kawalpemilu.org#25992,"TEBET BARAT, TEBET, JAKARTA SELATAN, DKI JAKARTA",58,113,66,179
https://kawalpemilu.org#25992,"TEBET BARAT, TEBET, JAKARTA SELATAN, DKI JAKARTA",60,108,128,236
https://kawalpemilu.org#25992,"TEBET BARAT, TEBET, JAKARTA SELATAN, DKI JAKARTA",61,137,70,207
https://kawalpemilu.org#25992,"TEBET BARAT, TEBET, JAKARTA SELATAN, DKI JAKARTA",62,128,70,198
https://kawalpemilu.org#25992,"TEBET BARAT, TEBET, JAKARTA SELATAN, DKI JAKARTA",63,137,123,260
https://kawalpemilu.org#25992,"TEBET BARAT, TEBET, JAKARTA SELATAN, DKI JAKARTA",64,123,109,232
https://kawalpemilu.org#25992,"TEBET BARAT, TEBET, JAKARTA SELATAN, DKI JAKARTA",65,103,130,233
https://kawalpemilu.org#25992,"TEBET BARAT, TEBET, JAKARTA SELATAN, DKI JAKARTA",68,106,68,174
https://kawalpemilu.org#25992,"TEBET BARAT, TEBET, JAKARTA SELATAN, DKI JAKARTA",69,145,69,214
https://kawalpemilu.org#25992,"TEBET BARAT, TEBET, JAKARTA SELATAN, DKI JAKARTA",70,64,87,151
https://kawalpemilu.org#25992,"TEBET BARAT, TEBET, JAKARTA SELATAN, DKI JAKARTA",74,119,67,186
https://kawalpemilu.org#25992,"TEBET BARAT, TEBET, JAKARTA SELATAN, DKI JAKARTA",75,118,128,246
https://kawalpemilu.org#25992,"TEBET BARAT, TEBET, JAKARTA SELATAN, DKI JAKARTA",77,112,109,221
https://kawalpemilu.org#25992,"TEBET BARAT, TEBET, JAKARTA SELATAN, DKI JAKARTA",78,91,138,229
https://kawalpemilu.org#25992,"TEBET BARAT, TEBET, JAKARTA SELATAN, DKI JAKARTA",79,86,140,226
https://kawalpemilu.org#25992,"TEBET BARAT, TEBET, JAKARTA SELATAN, DKI JAKARTA",80,86,131,217
https://kawalpemilu.org#25992,"TEBET BARAT, TEBET, JAKARTA SELATAN, DKI JAKARTA",81,148,76,224
https://kawalpemilu.org#25993,"MENTENG DALAM, TEBET, JAKARTA SELATAN, DKI JAKARTA",1,97,137,234
https://kawalpemilu.org#25993,"MENTENG DALAM, TEBET, JAKARTA SELATAN, DKI JAKARTA",2,120,89,209
https://kawalpemilu.org#25993,"MENTENG DALAM, TEBET, JAKARTA SELATAN, DKI JAKARTA",3,91,138,229
https://kawalpemilu.org#25993,"MENTENG DALAM, TEBET, JAKARTA SELATAN, DKI JAKARTA",4,142,92,234
https://kawalpemilu.org#25993,"MENTENG DALAM, TEBET, JAKARTA SELATAN, DKI JAKARTA",5,106,84,190
https://kawalpemilu.org#25993,"MENTENG DALAM, TEBET, JAKARTA SELATAN, DKI JAKARTA",6,95,99,194
https://kawalpemilu.org#25993,"MENTENG DALAM, TEBET, JAKARTA SELATAN, DKI JAKARTA",7,98,102,202
https://kawalpemilu.org#25993,"MENTENG DALAM, TEBET, JAKARTA SELATAN, DKI JAKARTA",8,116,107,223
https://kawalpemilu.org#25993,"MENTENG DALAM, TEBET, JAKARTA SELATAN, DKI JAKARTA",9,72,150,222
https://kawalpemilu.org#25993,"MENTENG DALAM, TEBET, JAKARTA SELATAN, DKI JAKARTA",10,153,66,219
https://kawalpemilu.org#25993,"MENTENG DALAM, TEBET, JAKARTA SELATAN, DKI JAKARTA",11,93,156,249
https://kawalpemilu.org#25993,"MENTENG DALAM, TEBET, JAKARTA SELATAN, DKI JAKARTA",12,90,129,219
https://kawalpemilu.org#25993,"MENTENG DALAM, TEBET, JAKARTA SELATAN, DKI JAKARTA",13,86,135,221
https://kawalpemilu.org#25993,"MENTENG DALAM, TEBET, JAKARTA SELATAN, DKI JAKARTA",16,49,193,242
https://kawalpemilu.org#25993,"MENTENG DALAM, TEBET, JAKARTA SELATAN, DKI JAKARTA",17,46,180,226
https://kawalpemilu.org#25993,"MENTENG DALAM, TEBET, JAKARTA SELATAN, DKI JAKARTA",18,77,120,197
https://kawalpemilu.org#25993,"MENTENG DALAM, TEBET, JAKARTA SELATAN, DKI JAKARTA",19,63,139,202
https://kawalpemilu.org#25993,"MENTENG DALAM, TEBET, JAKARTA SELATAN, DKI JAKARTA",20,51,170,221
https://kawalpemilu.org#25993,"MENTENG DALAM, TEBET, JAKARTA SELATAN, DKI JAKARTA",21,49,183,232
https://kawalpemilu.org#25993,"MENTENG DALAM, TEBET, JAKARTA SELATAN, DKI JAKARTA",22,119,82,201
https://kawalpemilu.org#25993,"MENTENG DALAM, TEBET, JAKARTA SELATAN, DKI JAKARTA",23,89,74,163
https://kawalpemilu.org#25993,"MENTENG DALAM, TEBET, JAKARTA SELATAN, DKI JAKARTA",24,67,113,180
https://kawalpemilu.org#25993,"MENTENG DALAM, TEBET, JAKARTA SELATAN, DKI JAKARTA",25,56,120,176
https://kawalpemilu.org#25993,"MENTENG DALAM, TEBET, JAKARTA SELATAN, DKI JAKARTA",26,58,144,202
https://kawalpemilu.org#25993,"MENTENG DALAM, TEBET, JAKARTA SELATAN, DKI JAKARTA",28,108,97,205
https://kawalpemilu.org#25993,"MENTENG DALAM, TEBET, JAKARTA SELATAN, DKI JAKARTA",29,140,50,190
https://kawalpemilu.org#25993,"MENTENG DALAM, TEBET, JAKARTA SELATAN, DKI JAKARTA",30,103,111,214
https://kawalpemilu.org#25993,"MENTENG DALAM, TEBET, JAKARTA SELATAN, DKI JAKARTA",32,119,81,200
https://kawalpemilu.org#25993,"MENTENG DALAM, TEBET, JAKARTA SELATAN, DKI JAKARTA",33,78,118,196
https://kawalpemilu.org#25993,"MENTENG DALAM, TEBET, JAKARTA SELATAN, DKI JAKARTA",34,80,126,207
https://kawalpemilu.org#25993,"MENTENG DALAM, TEBET, JAKARTA SELATAN, DKI JAKARTA",35,84,100,184
https://kawalpemilu.org#25993,"MENTENG DALAM, TEBET, JAKARTA SELATAN, DKI JAKARTA",36,91,124,215
https://kawalpemilu.org#25993,"MENTENG DALAM, TEBET, JAKARTA SELATAN, DKI JAKARTA",37,85,166,251
https://kawalpemilu.org#25993,"MENTENG DALAM, TEBET, JAKARTA SELATAN, DKI JAKARTA",38,59,166,225
https://kawalpemilu.org#25993,"MENTENG DALAM, TEBET, JAKARTA SELATAN, DKI JAKARTA",40,97,138,235
https://kawalpemilu.org#25993,"MENTENG DALAM, TEBET, JAKARTA SELATAN, DKI JAKARTA",41,161,105,266
https://kawalpemilu.org#25993,"MENTENG DALAM, TEBET, JAKARTA SELATAN, DKI JAKARTA",42,132,102,234
https://kawalpemilu.org#25993,"MENTENG DALAM, TEBET, JAKARTA SELATAN, DKI JAKARTA",43,88,137,225
https://kawalpemilu.org#25993,"MENTENG DALAM, TEBET, JAKARTA SELATAN, DKI JAKARTA",45,67,142,209
https://kawalpemilu.org#25993,"MENTENG DALAM, TEBET, JAKARTA SELATAN, DKI JAKARTA",46,98,122,220
https://kawalpemilu.org#25993,"MENTENG DALAM, TEBET, JAKARTA SELATAN, DKI JAKARTA",47,100,78,178
https://kawalpemilu.org#25993,"MENTENG DALAM, TEBET, JAKARTA SELATAN, DKI JAKARTA",49,51,117,168
https://kawalpemilu.org#25993,"MENTENG DALAM, TEBET, JAKARTA SELATAN, DKI JAKARTA",50,94,93,187
https://kawalpemilu.org#25993,"MENTENG DALAM, TEBET, JAKARTA SELATAN, DKI JAKARTA",51,108,89,197
https://kawalpemilu.org#25993,"MENTENG DALAM, TEBET, JAKARTA SELATAN, DKI JAKARTA",52,118,44,162
https://kawalpemilu.org#25993,"MENTENG DALAM, TEBET, JAKARTA SELATAN, DKI JAKARTA",53,122,54,176
https://kawalpemilu.org#25993,"MENTENG DALAM, TEBET, JAKARTA SELATAN, DKI JAKARTA",54,131,49,180
https://kawalpemilu.org#25993,"MENTENG DALAM, TEBET, JAKARTA SELATAN, DKI JAKARTA",55,113,156,269
https://kawalpemilu.org#25993,"MENTENG DALAM, TEBET, JAKARTA SELATAN, DKI JAKARTA",56,92,76,168
https://kawalpemilu.org#25993,"MENTENG DALAM, TEBET, JAKARTA SELATAN, DKI JAKARTA",57,81,66,147
https://kawalpemilu.org#25993,"MENTENG DALAM, TEBET, JAKARTA SELATAN, DKI JAKARTA",59,95,117,212
https://kawalpemilu.org#25993,"MENTENG DALAM, TEBET, JAKARTA SELATAN, DKI JAKARTA",62,80,152,232
https://kawalpemilu.org#25993,"MENTENG DALAM, TEBET, JAKARTA SELATAN, DKI JAKARTA",64,72,113,185
https://kawalpemilu.org#25993,"MENTENG DALAM, TEBET, JAKARTA SELATAN, DKI JAKARTA",65,117,60,177
https://kawalpemilu.org#25993,"MENTENG DALAM, TEBET, JAKARTA SELATAN, DKI JAKARTA",66,111,71,182
https://kawalpemilu.org#25993,"MENTENG DALAM, TEBET, JAKARTA SELATAN, DKI JAKARTA",67,105,61,166
https://kawalpemilu.org#25993,"MENTENG DALAM, TEBET, JAKARTA SELATAN, DKI JAKARTA",68,113,123,236
https://kawalpemilu.org#25993,"MENTENG DALAM, TEBET, JAKARTA SELATAN, DKI JAKARTA",70,75,179,254
https://kawalpemilu.org#25993,"MENTENG DALAM, TEBET, JAKARTA SELATAN, DKI JAKARTA",71,63,169,232
https://kawalpemilu.org#25993,"MENTENG DALAM, TEBET, JAKARTA SELATAN, DKI JAKARTA",72,98,129,227
https://kawalpemilu.org#25993,"MENTENG DALAM, TEBET, JAKARTA SELATAN, DKI JAKARTA",73,82,163,245
https://kawalpemilu.org#25993,"MENTENG DALAM, TEBET, JAKARTA SELATAN, DKI JAKARTA",74,89,159,248
https://kawalpemilu.org#25993,"MENTENG DALAM, TEBET, JAKARTA SELATAN, DKI JAKARTA",75,71,162,233
https://kawalpemilu.org#25993,"MENTENG DALAM, TEBET, JAKARTA SELATAN, DKI JAKARTA",77,68,171,239
https://kawalpemilu.org#25993,"MENTENG DALAM, TEBET, JAKARTA SELATAN, DKI JAKARTA",78,77,154,231
https://kawalpemilu.org#25993,"MENTENG DALAM, TEBET, JAKARTA SELATAN, DKI JAKARTA",80,76,155,231
https://kawalpemilu.org#25993,"MENTENG DALAM, TEBET, JAKARTA SELATAN, DKI JAKARTA",81,61,125,186
https://kawalpemilu.org#25993,"MENTENG DALAM, TEBET, JAKARTA SELATAN, DKI JAKARTA",82,60,123,183
https://kawalpemilu.org#25993,"MENTENG DALAM, TEBET, JAKARTA SELATAN, DKI JAKARTA",83,82,130,212
https://kawalpemilu.org#25993,"MENTENG DALAM, TEBET, JAKARTA SELATAN, DKI JAKARTA",85,66,159,225
https://kawalpemilu.org#25993,"MENTENG DALAM, TEBET, JAKARTA SELATAN, DKI JAKARTA",86,123,138,261
https://kawalpemilu.org#25993,"MENTENG DALAM, TEBET, JAKARTA SELATAN, DKI JAKARTA",87,96,136,232
https://kawalpemilu.org#25993,"MENTENG DALAM, TEBET, JAKARTA SELATAN, DKI JAKARTA",88,47,203,250
https://kawalpemilu.org#25993,"MENTENG DALAM, TEBET, JAKARTA SELATAN, DKI JAKARTA",90,61,143,204
https://kawalpemilu.org#25993,"MENTENG DALAM, TEBET, JAKARTA SELATAN, DKI JAKARTA",91,64,145,209
https://kawalpemilu.org#25993,"MENTENG DALAM, TEBET, JAKARTA SELATAN, DKI JAKARTA",92,93,147,240
https://kawalpemilu.org#25993,"MENTENG DALAM, TEBET, JAKARTA SELATAN, DKI JAKARTA",93,51,150,201
https://kawalpemilu.org#25993,"MENTENG DALAM, TEBET, JAKARTA SELATAN, DKI JAKARTA",94,101,86,187
https://kawalpemilu.org#25993,"MENTENG DALAM, TEBET, JAKARTA SELATAN, DKI JAKARTA",95,82,98,180
https://kawalpemilu.org#25993,"MENTENG DALAM, TEBET, JAKARTA SELATAN, DKI JAKARTA",96,123,114,237
https://kawalpemilu.org#25993,"MENTENG DALAM, TEBET, JAKARTA SELATAN, DKI JAKARTA",97,140,97,237
https://kawalpemilu.org#25993,"MENTENG DALAM, TEBET, JAKARTA SELATAN, DKI JAKARTA",98,124,113,237
https://kawalpemilu.org#25993,"MENTENG DALAM, TEBET, JAKARTA SELATAN, DKI JAKARTA",99,153,73,226
https://kawalpemilu.org#25993,"MENTENG DALAM, TEBET, JAKARTA SELATAN, DKI JAKARTA",100,96,141,237
https://kawalpemilu.org#25993,"MENTENG DALAM, TEBET, JAKARTA SELATAN, DKI JAKARTA",101,74,128,202
https://kawalpemilu.org#25993,"MENTENG DALAM, TEBET, JAKARTA SELATAN, DKI JAKARTA",102,80,131,211
https://kawalpemilu.org#25993,"MENTENG DALAM, TEBET, JAKARTA SELATAN, DKI JAKARTA",103,74,140,214
https://kawalpemilu.org#25993,"MENTENG DALAM, TEBET, JAKARTA SELATAN, DKI JAKARTA",104,53,142,195
https://kawalpemilu.org#25993,"MENTENG DALAM, TEBET, JAKARTA SELATAN, DKI JAKARTA",105,61,162,223
https://kawalpemilu.org#25993,"MENTENG DALAM, TEBET, JAKARTA SELATAN, DKI JAKARTA",106,103,133,236
https://kawalpemilu.org#25993,"MENTENG DALAM, TEBET, JAKARTA SELATAN, DKI JAKARTA",108,63,155,218
https://kawalpemilu.org#25993,"MENTENG DALAM, TEBET, JAKARTA SELATAN, DKI JAKARTA",109,56,152,208
https://kawalpemilu.org#25993,"MENTENG DALAM, TEBET, JAKARTA SELATAN, DKI JAKARTA",112,53,148,201
https://kawalpemilu.org#25993,"MENTENG DALAM, TEBET, JAKARTA SELATAN, DKI JAKARTA",113,51,140,191
https://kawalpemilu.org#25993,"MENTENG DALAM, TEBET, JAKARTA SELATAN, DKI JAKARTA",114,49,197,246
https://kawalpemilu.org#25993,"MENTENG DALAM, TEBET, JAKARTA SELATAN, DKI JAKARTA",115,84,130,214
https://kawalpemilu.org#25993,"MENTENG DALAM, TEBET, JAKARTA SELATAN, DKI JAKARTA",117,76,158,234
https://kawalpemilu.org#25993,"MENTENG DALAM, TEBET, JAKARTA SELATAN, DKI JAKARTA",118,64,159,223
https://kawalpemilu.org#25993,"MENTENG DALAM, TEBET, JAKARTA SELATAN, DKI JAKARTA",120,145,131,276
https://kawalpemilu.org#25993,"MENTENG DALAM, TEBET, JAKARTA SELATAN, DKI JAKARTA",121,148,85,233
https://kawalpemilu.org#25993,"MENTENG DALAM, TEBET, JAKARTA SELATAN, DKI JAKARTA",122,99,136,235
https://kawalpemilu.org#25993,"MENTENG DALAM, TEBET, JAKARTA SELATAN, DKI JAKARTA",125,77,172,249
https://kawalpemilu.org#25993,"MENTENG DALAM, TEBET, JAKARTA SELATAN, DKI JAKARTA",127,89,168,257
https://kawalpemilu.org#25994,"KEBON BARU, TEBET, JAKARTA SELATAN, DKI JAKARTA",1,98,102,200
https://kawalpemilu.org#25994,"KEBON BARU, TEBET, JAKARTA SELATAN, DKI JAKARTA",2,100,107,207
https://kawalpemilu.org#25994,"KEBON BARU, TEBET, JAKARTA SELATAN, DKI JAKARTA",3,25,138,163
https://kawalpemilu.org#25994,"KEBON BARU, TEBET, JAKARTA SELATAN, DKI JAKARTA",5,76,126,202
https://kawalpemilu.org#25994,"KEBON BARU, TEBET, JAKARTA SELATAN, DKI JAKARTA",6,79,130,209
https://kawalpemilu.org#25994,"KEBON BARU, TEBET, JAKARTA SELATAN, DKI JAKARTA",7,83,111,194
https://kawalpemilu.org#25994,"KEBON BARU, TEBET, JAKARTA SELATAN, DKI JAKARTA",8,95,138,233
https://kawalpemilu.org#25994,"KEBON BARU, TEBET, JAKARTA SELATAN, DKI JAKARTA",9,52,158,210
https://kawalpemilu.org#25994,"KEBON BARU, TEBET, JAKARTA SELATAN, DKI JAKARTA",11,45,181,226
https://kawalpemilu.org#25994,"KEBON BARU, TEBET, JAKARTA SELATAN, DKI JAKARTA",12,67,183,250
https://kawalpemilu.org#25994,"KEBON BARU, TEBET, JAKARTA SELATAN, DKI JAKARTA",14,89,95,184
https://kawalpemilu.org#25994,"KEBON BARU, TEBET, JAKARTA SELATAN, DKI JAKARTA",15,103,93,196
https://kawalpemilu.org#25994,"KEBON BARU, TEBET, JAKARTA SELATAN, DKI JAKARTA",16,76,139,215
https://kawalpemilu.org#25994,"KEBON BARU, TEBET, JAKARTA SELATAN, DKI JAKARTA",17,163,69,232
https://kawalpemilu.org#25994,"KEBON BARU, TEBET, JAKARTA SELATAN, DKI JAKARTA",18,134,72,206
https://kawalpemilu.org#25994,"KEBON BARU, TEBET, JAKARTA SELATAN, DKI JAKARTA",19,146,68,214
https://kawalpemilu.org#25994,"KEBON BARU, TEBET, JAKARTA SELATAN, DKI JAKARTA",20,127,72,199
https://kawalpemilu.org#25994,"KEBON BARU, TEBET, JAKARTA SELATAN, DKI JAKARTA",21,176,62,238
https://kawalpemilu.org#25994,"KEBON BARU, TEBET, JAKARTA SELATAN, DKI JAKARTA",22,134,61,195
https://kawalpemilu.org#25994,"KEBON BARU, TEBET, JAKARTA SELATAN, DKI JAKARTA",23,116,99,215
https://kawalpemilu.org#25994,"KEBON BARU, TEBET, JAKARTA SELATAN, DKI JAKARTA",24,94,140,234
https://kawalpemilu.org#25994,"KEBON BARU, TEBET, JAKARTA SELATAN, DKI JAKARTA",25,79,164,243
https://kawalpemilu.org#25994,"KEBON BARU, TEBET, JAKARTA SELATAN, DKI JAKARTA",26,58,157,215
https://kawalpemilu.org#25994,"KEBON BARU, TEBET, JAKARTA SELATAN, DKI JAKARTA",27,91,160,251
https://kawalpemilu.org#25994,"KEBON BARU, TEBET, JAKARTA SELATAN, DKI JAKARTA",28,105,131,236
https://kawalpemilu.org#25994,"KEBON BARU, TEBET, JAKARTA SELATAN, DKI JAKARTA",29,83,155,238
https://kawalpemilu.org#25994,"KEBON BARU, TEBET, JAKARTA SELATAN, DKI JAKARTA",30,115,123,238
https://kawalpemilu.org#25994,"KEBON BARU, TEBET, JAKARTA SELATAN, DKI JAKARTA",31,36,173,209
https://kawalpemilu.org#25994,"KEBON BARU, TEBET, JAKARTA SELATAN, DKI JAKARTA",33,70,172,242
https://kawalpemilu.org#25994,"KEBON BARU, TEBET, JAKARTA SELATAN, DKI JAKARTA",34,51,131,182
https://kawalpemilu.org#25994,"KEBON BARU, TEBET, JAKARTA SELATAN, DKI JAKARTA",35,41,202,243
https://kawalpemilu.org#25994,"KEBON BARU, TEBET, JAKARTA SELATAN, DKI JAKARTA",36,54,169,223
https://kawalpemilu.org#25994,"KEBON BARU, TEBET, JAKARTA SELATAN, DKI JAKARTA",37,78,157,235
https://kawalpemilu.org#25994,"KEBON BARU, TEBET, JAKARTA SELATAN, DKI JAKARTA",38,110,104,214
https://kawalpemilu.org#25994,"KEBON BARU, TEBET, JAKARTA SELATAN, DKI JAKARTA",39,87,143,230
https://kawalpemilu.org#25994,"KEBON BARU, TEBET, JAKARTA SELATAN, DKI JAKARTA",41,78,152,230
https://kawalpemilu.org#25994,"KEBON BARU, TEBET, JAKARTA SELATAN, DKI JAKARTA",43,63,182,245
https://kawalpemilu.org#25994,"KEBON BARU, TEBET, JAKARTA SELATAN, DKI JAKARTA",44,104,154,258
https://kawalpemilu.org#25994,"KEBON BARU, TEBET, JAKARTA SELATAN, DKI JAKARTA",46,89,169,258
https://kawalpemilu.org#25994,"KEBON BARU, TEBET, JAKARTA SELATAN, DKI JAKARTA",47,84,129,213
https://kawalpemilu.org#25994,"KEBON BARU, TEBET, JAKARTA SELATAN, DKI JAKARTA",48,83,149,232
https://kawalpemilu.org#25994,"KEBON BARU, TEBET, JAKARTA SELATAN, DKI JAKARTA",49,96,136,232
https://kawalpemilu.org#25994,"KEBON BARU, TEBET, JAKARTA SELATAN, DKI JAKARTA",50,79,139,218
https://kawalpemilu.org#25994,"KEBON BARU, TEBET, JAKARTA SELATAN, DKI JAKARTA",51,101,120,221
https://kawalpemilu.org#25994,"KEBON BARU, TEBET, JAKARTA SELATAN, DKI JAKARTA",52,68,115,183
https://kawalpemilu.org#25994,"KEBON BARU, TEBET, JAKARTA SELATAN, DKI JAKARTA",53,49,152,201
https://kawalpemilu.org#25994,"KEBON BARU, TEBET, JAKARTA SELATAN, DKI JAKARTA",54,51,131,182
https://kawalpemilu.org#25994,"KEBON BARU, TEBET, JAKARTA SELATAN, DKI JAKARTA",55,52,113,165
https://kawalpemilu.org#25994,"KEBON BARU, TEBET, JAKARTA SELATAN, DKI JAKARTA",56,73,131,204
https://kawalpemilu.org#25994,"KEBON BARU, TEBET, JAKARTA SELATAN, DKI JAKARTA",57,74,148,222
https://kawalpemilu.org#25994,"KEBON BARU, TEBET, JAKARTA SELATAN, DKI JAKARTA",58,73,149,222
https://kawalpemilu.org#25994,"KEBON BARU, TEBET, JAKARTA SELATAN, DKI JAKARTA",59,59,164,223
https://kawalpemilu.org#25994,"KEBON BARU, TEBET, JAKARTA SELATAN, DKI JAKARTA",60,75,107,182
https://kawalpemilu.org#25994,"KEBON BARU, TEBET, JAKARTA SELATAN, DKI JAKARTA",61,62,129,191
https://kawalpemilu.org#25994,"KEBON BARU, TEBET, JAKARTA SELATAN, DKI JAKARTA",62,50,173,223
https://kawalpemilu.org#25994,"KEBON BARU, TEBET, JAKARTA SELATAN, DKI JAKARTA",63,61,183,244
https://kawalpemilu.org#25994,"KEBON BARU, TEBET, JAKARTA SELATAN, DKI JAKARTA",64,95,146,241
https://kawalpemilu.org#25994,"KEBON BARU, TEBET, JAKARTA SELATAN, DKI JAKARTA",65,88,121,209
https://kawalpemilu.org#25994,"KEBON BARU, TEBET, JAKARTA SELATAN, DKI JAKARTA",66,63,189,252
https://kawalpemilu.org#25994,"KEBON BARU, TEBET, JAKARTA SELATAN, DKI JAKARTA",67,93,115,208
https://kawalpemilu.org#25994,"KEBON BARU, TEBET, JAKARTA SELATAN, DKI JAKARTA",68,70,139,209
https://kawalpemilu.org#25994,"KEBON BARU, TEBET, JAKARTA SELATAN, DKI JAKARTA",69,36,179,215
https://kawalpemilu.org#25994,"KEBON BARU, TEBET, JAKARTA SELATAN, DKI JAKARTA",71,109,120,229
https://kawalpemilu.org#25994,"KEBON BARU, TEBET, JAKARTA SELATAN, DKI JAKARTA",72,89,163,252
https://kawalpemilu.org#25994,"KEBON BARU, TEBET, JAKARTA SELATAN, DKI JAKARTA",73,70,176,246
https://kawalpemilu.org#25994,"KEBON BARU, TEBET, JAKARTA SELATAN, DKI JAKARTA",74,127,135,262
https://kawalpemilu.org#25994,"KEBON BARU, TEBET, JAKARTA SELATAN, DKI JAKARTA",75,73,167,240
https://kawalpemilu.org#25994,"KEBON BARU, TEBET, JAKARTA SELATAN, DKI JAKARTA",76,63,186,249
https://kawalpemilu.org#25994,"KEBON BARU, TEBET, JAKARTA SELATAN, DKI JAKARTA",77,71,182,253
https://kawalpemilu.org#25994,"KEBON BARU, TEBET, JAKARTA SELATAN, DKI JAKARTA",78,84,175,259
https://kawalpemilu.org#25994,"KEBON BARU, TEBET, JAKARTA SELATAN, DKI JAKARTA",79,51,179,230
https://kawalpemilu.org#25994,"KEBON BARU, TEBET, JAKARTA SELATAN, DKI JAKARTA",80,90,121,211
https://kawalpemilu.org#25994,"KEBON BARU, TEBET, JAKARTA SELATAN, DKI JAKARTA",81,81,139,220
https://kawalpemilu.org#25994,"KEBON BARU, TEBET, JAKARTA SELATAN, DKI JAKARTA",83,87,164,251
https://kawalpemilu.org#25994,"KEBON BARU, TEBET, JAKARTA SELATAN, DKI JAKARTA",84,86,155,241
https://kawalpemilu.org#25994,"KEBON BARU, TEBET, JAKARTA SELATAN, DKI JAKARTA",85,80,172,252
https://kawalpemilu.org#25994,"KEBON BARU, TEBET, JAKARTA SELATAN, DKI JAKARTA",86,71,163,234
https://kawalpemilu.org#25994,"KEBON BARU, TEBET, JAKARTA SELATAN, DKI JAKARTA",87,69,151,220
https://kawalpemilu.org#25994,"KEBON BARU, TEBET, JAKARTA SELATAN, DKI JAKARTA",89,92,139,231
https://kawalpemilu.org#25994,"KEBON BARU, TEBET, JAKARTA SELATAN, DKI JAKARTA",90,62,163,225
https://kawalpemilu.org#25994,"KEBON BARU, TEBET, JAKARTA SELATAN, DKI JAKARTA",91,96,135,231
https://kawalpemilu.org#25994,"KEBON BARU, TEBET, JAKARTA SELATAN, DKI JAKARTA",92,78,184,262
https://kawalpemilu.org#25994,"KEBON BARU, TEBET, JAKARTA SELATAN, DKI JAKARTA",93,94,121,215
https://kawalpemilu.org#25994,"KEBON BARU, TEBET, JAKARTA SELATAN, DKI JAKARTA",94,77,143,220
https://kawalpemilu.org#25994,"KEBON BARU, TEBET, JAKARTA SELATAN, DKI JAKARTA",96,35,160,195
https://kawalpemilu.org#25994,"KEBON BARU, TEBET, JAKARTA SELATAN, DKI JAKARTA",97,82,109,191
https://kawalpemilu.org#25994,"KEBON BARU, TEBET, JAKARTA SELATAN, DKI JAKARTA",98,54,175,229
https://kawalpemilu.org#25994,"KEBON BARU, TEBET, JAKARTA SELATAN, DKI JAKARTA",101,61,168,229
https://kawalpemilu.org#25994,"KEBON BARU, TEBET, JAKARTA SELATAN, DKI JAKARTA",102,36,190,226
https://kawalpemilu.org#25994,"KEBON BARU, TEBET, JAKARTA SELATAN, DKI JAKARTA",103,47,182,229
https://kawalpemilu.org#25994,"KEBON BARU, TEBET, JAKARTA SELATAN, DKI JAKARTA",106,44,219,263
https://kawalpemilu.org#25994,"KEBON BARU, TEBET, JAKARTA SELATAN, DKI JAKARTA",107,41,206,247
https://kawalpemilu.org#25994,"KEBON BARU, TEBET, JAKARTA SELATAN, DKI JAKARTA",109,54,181,235
https://kawalpemilu.org#25994,"KEBON BARU, TEBET, JAKARTA SELATAN, DKI JAKARTA",111,56,202,258
https://kawalpemilu.org#25994,"KEBON BARU, TEBET, JAKARTA SELATAN, DKI JAKARTA",112,43,187,230
https://kawalpemilu.org#25994,"KEBON BARU, TEBET, JAKARTA SELATAN, DKI JAKARTA",113,71,173,244
https://kawalpemilu.org#25994,"KEBON BARU, TEBET, JAKARTA SELATAN, DKI JAKARTA",114,91,150,241
https://kawalpemilu.org#25994,"KEBON BARU, TEBET, JAKARTA SELATAN, DKI JAKARTA",115,89,140,229
https://kawalpemilu.org#25994,"KEBON BARU, TEBET, JAKARTA SELATAN, DKI JAKARTA",116,74,165,239
https://kawalpemilu.org#25994,"KEBON BARU, TEBET, JAKARTA SELATAN, DKI JAKARTA",117,88,116,204
https://kawalpemilu.org#25994,"KEBON BARU, TEBET, JAKARTA SELATAN, DKI JAKARTA",118,96,131,227
https://kawalpemilu.org#25994,"KEBON BARU, TEBET, JAKARTA SELATAN, DKI JAKARTA",119,91,138,229
https://kawalpemilu.org#25995,"BUKIT DURI, TEBET, JAKARTA SELATAN, DKI JAKARTA",1,70,154,224
https://kawalpemilu.org#25995,"BUKIT DURI, TEBET, JAKARTA SELATAN, DKI JAKARTA",2,72,148,220
https://kawalpemilu.org#25995,"BUKIT DURI, TEBET, JAKARTA SELATAN, DKI JAKARTA",3,80,145,225
https://kawalpemilu.org#25995,"BUKIT DURI, TEBET, JAKARTA SELATAN, DKI JAKARTA",4,44,176,220
https://kawalpemilu.org#25995,"BUKIT DURI, TEBET, JAKARTA SELATAN, DKI JAKARTA",5,83,149,232
https://kawalpemilu.org#25995,"BUKIT DURI, TEBET, JAKARTA SELATAN, DKI JAKARTA",6,88,129,217
https://kawalpemilu.org#25995,"BUKIT DURI, TEBET, JAKARTA SELATAN, DKI JAKARTA",7,174,68,242
https://kawalpemilu.org#25995,"BUKIT DURI, TEBET, JAKARTA SELATAN, DKI JAKARTA",8,198,49,247
https://kawalpemilu.org#25995,"BUKIT DURI, TEBET, JAKARTA SELATAN, DKI JAKARTA",9,61,131,192
https://kawalpemilu.org#25995,"BUKIT DURI, TEBET, JAKARTA SELATAN, DKI JAKARTA",10,78,139,217
https://kawalpemilu.org#25995,"BUKIT DURI, TEBET, JAKARTA SELATAN, DKI JAKARTA",11,91,149,240
https://kawalpemilu.org#25995,"BUKIT DURI, TEBET, JAKARTA SELATAN, DKI JAKARTA",12,94,135,229
https://kawalpemilu.org#25995,"BUKIT DURI, TEBET, JAKARTA SELATAN, DKI JAKARTA",13,68,123,191
https://kawalpemilu.org#25995,"BUKIT DURI, TEBET, JAKARTA SELATAN, DKI JAKARTA",14,71,194,265
https://kawalpemilu.org#25995,"BUKIT DURI, TEBET, JAKARTA SELATAN, DKI JAKARTA",15,71,169,240
https://kawalpemilu.org#25995,"BUKIT DURI, TEBET, JAKARTA SELATAN, DKI JAKARTA",16,54,142,196
https://kawalpemilu.org#25995,"BUKIT DURI, TEBET, JAKARTA SELATAN, DKI JAKARTA",17,65,119,184
https://kawalpemilu.org#25995,"BUKIT DURI, TEBET, JAKARTA SELATAN, DKI JAKARTA",18,56,190,246
https://kawalpemilu.org#25995,"BUKIT DURI, TEBET, JAKARTA SELATAN, DKI JAKARTA",19,117,78,195
https://kawalpemilu.org#25995,"BUKIT DURI, TEBET, JAKARTA SELATAN, DKI JAKARTA",20,78,130,208
https://kawalpemilu.org#25995,"BUKIT DURI, TEBET, JAKARTA SELATAN, DKI JAKARTA",21,87,130,217
https://kawalpemilu.org#25995,"BUKIT DURI, TEBET, JAKARTA SELATAN, DKI JAKARTA",22,67,150,217
https://kawalpemilu.org#25995,"BUKIT DURI, TEBET, JAKARTA SELATAN, DKI JAKARTA",23,98,102,200
https://kawalpemilu.org#25995,"BUKIT DURI, TEBET, JAKARTA SELATAN, DKI JAKARTA",24,104,104,208
https://kawalpemilu.org#25995,"BUKIT DURI, TEBET, JAKARTA SELATAN, DKI JAKARTA",25,72,60,132
https://kawalpemilu.org#25995,"BUKIT DURI, TEBET, JAKARTA SELATAN, DKI JAKARTA",26,83,101,184
https://kawalpemilu.org#25995,"BUKIT DURI, TEBET, JAKARTA SELATAN, DKI JAKARTA",27,54,159,213
https://kawalpemilu.org#25995,"BUKIT DURI, TEBET, JAKARTA SELATAN, DKI JAKARTA",28,64,159,223
https://kawalpemilu.org#25995,"BUKIT DURI, TEBET, JAKARTA SELATAN, DKI JAKARTA",29,82,128,210
https://kawalpemilu.org#25995,"BUKIT DURI, TEBET, JAKARTA SELATAN, DKI JAKARTA",30,48,169,217
https://kawalpemilu.org#25995,"BUKIT DURI, TEBET, JAKARTA SELATAN, DKI JAKARTA",31,60,202,262
https://kawalpemilu.org#25995,"BUKIT DURI, TEBET, JAKARTA SELATAN, DKI JAKARTA",32,42,178,220
https://kawalpemilu.org#25995,"BUKIT DURI, TEBET, JAKARTA SELATAN, DKI JAKARTA",33,110,144,254
https://kawalpemilu.org#25995,"BUKIT DURI, TEBET, JAKARTA SELATAN, DKI JAKARTA",34,93,142,235
https://kawalpemilu.org#25995,"BUKIT DURI, TEBET, JAKARTA SELATAN, DKI JAKARTA",35,86,161,247
https://kawalpemilu.org#25995,"BUKIT DURI, TEBET, JAKARTA SELATAN, DKI JAKARTA",36,86,139,225
https://kawalpemilu.org#25995,"BUKIT DURI, TEBET, JAKARTA SELATAN, DKI JAKARTA",37,101,112,213
https://kawalpemilu.org#25995,"BUKIT DURI, TEBET, JAKARTA SELATAN, DKI JAKARTA",38,83,151,234
https://kawalpemilu.org#25995,"BUKIT DURI, TEBET, JAKARTA SELATAN, DKI JAKARTA",39,74,166,240
https://kawalpemilu.org#25995,"BUKIT DURI, TEBET, JAKARTA SELATAN, DKI JAKARTA",40,44,145,189
https://kawalpemilu.org#25995,"BUKIT DURI, TEBET, JAKARTA SELATAN, DKI JAKARTA",41,48,161,209
https://kawalpemilu.org#25995,"BUKIT DURI, TEBET, JAKARTA SELATAN, DKI JAKARTA",42,122,109,231
https://kawalpemilu.org#25995,"BUKIT DURI, TEBET, JAKARTA SELATAN, DKI JAKARTA",43,84,145,229
https://kawalpemilu.org#25995,"BUKIT DURI, TEBET, JAKARTA SELATAN, DKI JAKARTA",44,72,107,179
https://kawalpemilu.org#25995,"BUKIT DURI, TEBET, JAKARTA SELATAN, DKI JAKARTA",45,45,155,200
https://kawalpemilu.org#25995,"BUKIT DURI, TEBET, JAKARTA SELATAN, DKI JAKARTA",46,70,148,218
https://kawalpemilu.org#25995,"BUKIT DURI, TEBET, JAKARTA SELATAN, DKI JAKARTA",47,55,165,220
https://kawalpemilu.org#25995,"BUKIT DURI, TEBET, JAKARTA SELATAN, DKI JAKARTA",48,69,149,218
https://kawalpemilu.org#25995,"BUKIT DURI, TEBET, JAKARTA SELATAN, DKI JAKARTA",49,98,118,216
https://kawalpemilu.org#25995,"BUKIT DURI, TEBET, JAKARTA SELATAN, DKI JAKARTA",50,98,154,252
https://kawalpemilu.org#25995,"BUKIT DURI, TEBET, JAKARTA SELATAN, DKI JAKARTA",51,91,147,238
https://kawalpemilu.org#25995,"BUKIT DURI, TEBET, JAKARTA SELATAN, DKI JAKARTA",52,72,138,210
https://kawalpemilu.org#25995,"BUKIT DURI, TEBET, JAKARTA SELATAN, DKI JAKARTA",53,92,117,209
https://kawalpemilu.org#25995,"BUKIT DURI, TEBET, JAKARTA SELATAN, DKI JAKARTA",54,59,182,241
https://kawalpemilu.org#25995,"BUKIT DURI, TEBET, JAKARTA SELATAN, DKI JAKARTA",55,100,123,223
https://kawalpemilu.org#25995,"BUKIT DURI, TEBET, JAKARTA SELATAN, DKI JAKARTA",56,65,154,219
https://kawalpemilu.org#25995,"BUKIT DURI, TEBET, JAKARTA SELATAN, DKI JAKARTA",57,87,116,203
https://kawalpemilu.org#25995,"BUKIT DURI, TEBET, JAKARTA SELATAN, DKI JAKARTA",58,72,148,220
https://kawalpemilu.org#25995,"BUKIT DURI, TEBET, JAKARTA SELATAN, DKI JAKARTA",59,93,123,216
https://kawalpemilu.org#25995,"BUKIT DURI, TEBET, JAKARTA SELATAN, DKI JAKARTA",60,60,158,218
https://kawalpemilu.org#25995,"BUKIT DURI, TEBET, JAKARTA SELATAN, DKI JAKARTA",61,111,72,183
https://kawalpemilu.org#25995,"BUKIT DURI, TEBET, JAKARTA SELATAN, DKI JAKARTA",62,70,110,180
https://kawalpemilu.org#25995,"BUKIT DURI, TEBET, JAKARTA SELATAN, DKI JAKARTA",63,53,117,170
https://kawalpemilu.org#25995,"BUKIT DURI, TEBET, JAKARTA SELATAN, DKI JAKARTA",64,108,120,228
https://kawalpemilu.org#25995,"BUKIT DURI, TEBET, JAKARTA SELATAN, DKI JAKARTA",65,107,131,238
https://kawalpemilu.org#25995,"BUKIT DURI, TEBET, JAKARTA SELATAN, DKI JAKARTA",66,67,132,199
https://kawalpemilu.org#25995,"BUKIT DURI, TEBET, JAKARTA SELATAN, DKI JAKARTA",67,105,128,233
https://kawalpemilu.org#25995,"BUKIT DURI, TEBET, JAKARTA SELATAN, DKI JAKARTA",68,93,121,214
https://kawalpemilu.org#25995,"BUKIT DURI, TEBET, JAKARTA SELATAN, DKI JAKARTA",69,73,142,215
https://kawalpemilu.org#25995,"BUKIT DURI, TEBET, JAKARTA SELATAN, DKI JAKARTA",70,96,147,243
https://kawalpemilu.org#25995,"BUKIT DURI, TEBET, JAKARTA SELATAN, DKI JAKARTA",71,64,114,178
https://kawalpemilu.org#25995,"BUKIT DURI, TEBET, JAKARTA SELATAN, DKI JAKARTA",72,65,100,165
https://kawalpemilu.org#25995,"BUKIT DURI, TEBET, JAKARTA SELATAN, DKI JAKARTA",73,116,115,231
https://kawalpemilu.org#25995,"BUKIT DURI, TEBET, JAKARTA SELATAN, DKI JAKARTA",74,62,116,176
https://kawalpemilu.org#25995,"BUKIT DURI, TEBET, JAKARTA SELATAN, DKI JAKARTA",75,109,88,197
https://kawalpemilu.org#25995,"BUKIT DURI, TEBET, JAKARTA SELATAN, DKI JAKARTA",76,59,153,212
https://kawalpemilu.org#25995,"BUKIT DURI, TEBET, JAKARTA SELATAN, DKI JAKARTA",77,80,132,212
https://kawalpemilu.org#25995,"BUKIT DURI, TEBET, JAKARTA SELATAN, DKI JAKARTA",78,70,160,230
https://kawalpemilu.org#25995,"BUKIT DURI, TEBET, JAKARTA SELATAN, DKI JAKARTA",79,57,182,239
https://kawalpemilu.org#25995,"BUKIT DURI, TEBET, JAKARTA SELATAN, DKI JAKARTA",80,52,167,219
https://kawalpemilu.org#25995,"BUKIT DURI, TEBET, JAKARTA SELATAN, DKI JAKARTA",81,67,121,188
https://kawalpemilu.org#25995,"BUKIT DURI, TEBET, JAKARTA SELATAN, DKI JAKARTA",82,81,165,246
https://kawalpemilu.org#25995,"BUKIT DURI, TEBET, JAKARTA SELATAN, DKI JAKARTA",83,58,150,208
https://kawalpemilu.org#25995,"BUKIT DURI, TEBET, JAKARTA SELATAN, DKI JAKARTA",84,35,201,236
https://kawalpemilu.org#25995,"BUKIT DURI, TEBET, JAKARTA SELATAN, DKI JAKARTA",85,63,180,243
https://kawalpemilu.org#25995,"BUKIT DURI, TEBET, JAKARTA SELATAN, DKI JAKARTA",86,56,166,222
https://kawalpemilu.org#25995,"BUKIT DURI, TEBET, JAKARTA SELATAN, DKI JAKARTA",87,74,173,247
https://kawalpemilu.org#25995,"BUKIT DURI, TEBET, JAKARTA SELATAN, DKI JAKARTA",88,69,181,250
https://kawalpemilu.org#25995,"BUKIT DURI, TEBET, JAKARTA SELATAN, DKI JAKARTA",89,56,187,243
https://kawalpemilu.org#25995,"BUKIT DURI, TEBET, JAKARTA SELATAN, DKI JAKARTA",90,102,140,242
https://kawalpemilu.org#25995,"BUKIT DURI, TEBET, JAKARTA SELATAN, DKI JAKARTA",91,75,140,215
https://kawalpemilu.org#25995,"BUKIT DURI, TEBET, JAKARTA SELATAN, DKI JAKARTA",92,46,130,176
https://kawalpemilu.org#25995,"BUKIT DURI, TEBET, JAKARTA SELATAN, DKI JAKARTA",93,57,197,254
https://kawalpemilu.org#25995,"BUKIT DURI, TEBET, JAKARTA SELATAN, DKI JAKARTA",94,39,192,231
https://kawalpemilu.org#25995,"BUKIT DURI, TEBET, JAKARTA SELATAN, DKI JAKARTA",95,73,152,225
https://kawalpemilu.org#25995,"BUKIT DURI, TEBET, JAKARTA SELATAN, DKI JAKARTA",96,43,147,190
https://kawalpemilu.org#25995,"BUKIT DURI, TEBET, JAKARTA SELATAN, DKI JAKARTA",97,84,129,213
https://kawalpemilu.org#25995,"BUKIT DURI, TEBET, JAKARTA SELATAN, DKI JAKARTA",98,98,129,227
https://kawalpemilu.org#25995,"BUKIT DURI, TEBET, JAKARTA SELATAN, DKI JAKARTA",99,85,143,228
https://kawalpemilu.org#25995,"BUKIT DURI, TEBET, JAKARTA SELATAN, DKI JAKARTA",100,55,174,229
https://kawalpemilu.org#25995,"BUKIT DURI, TEBET, JAKARTA SELATAN, DKI JAKARTA",101,71,174,245
https://kawalpemilu.org#25995,"BUKIT DURI, TEBET, JAKARTA SELATAN, DKI JAKARTA",102,69,158,227
https://kawalpemilu.org#25995,"BUKIT DURI, TEBET, JAKARTA SELATAN, DKI JAKARTA",103,80,168,248
https://kawalpemilu.org#25995,"BUKIT DURI, TEBET, JAKARTA SELATAN, DKI JAKARTA",104,77,156,223
https://kawalpemilu.org#25995,"BUKIT DURI, TEBET, JAKARTA SELATAN, DKI JAKARTA",105,79,148,227
https://kawalpemilu.org#25995,"BUKIT DURI, TEBET, JAKARTA SELATAN, DKI JAKARTA",106,68,125,193
https://kawalpemilu.org#25995,"BUKIT DURI, TEBET, JAKARTA SELATAN, DKI JAKARTA",107,69,121,190
https://kawalpemilu.org#25995,"BUKIT DURI, TEBET, JAKARTA SELATAN, DKI JAKARTA",108,89,122,211
https://kawalpemilu.org#25995,"BUKIT DURI, TEBET, JAKARTA SELATAN, DKI JAKARTA",109,76,103,179
https://kawalpemilu.org#25995,"BUKIT DURI, TEBET, JAKARTA SELATAN, DKI JAKARTA",110,93,115,208
https://kawalpemilu.org#25995,"BUKIT DURI, TEBET, JAKARTA SELATAN, DKI JAKARTA",111,28,162,190
https://kawalpemilu.org#25995,"BUKIT DURI, TEBET, JAKARTA SELATAN, DKI JAKARTA",112,48,142,190
https://kawalpemilu.org#25995,"BUKIT DURI, TEBET, JAKARTA SELATAN, DKI JAKARTA",113,82,130,212
https://kawalpemilu.org#25995,"BUKIT DURI, TEBET, JAKARTA SELATAN, DKI JAKARTA",114,87,109,196
https://kawalpemilu.org#25995,"BUKIT DURI, TEBET, JAKARTA SELATAN, DKI JAKARTA",115,102,124,226
https://kawalpemilu.org#25995,"BUKIT DURI, TEBET, JAKARTA SELATAN, DKI JAKARTA",116,76,141,217
https://kawalpemilu.org#25995,"BUKIT DURI, TEBET, JAKARTA SELATAN, DKI JAKARTA",117,59,134,193
https://kawalpemilu.org#25995,"BUKIT DURI, TEBET, JAKARTA SELATAN, DKI JAKARTA",118,83,124,207
https://kawalpemilu.org#25995,"BUKIT DURI, TEBET, JAKARTA SELATAN, DKI JAKARTA",119,66,173,239
https://kawalpemilu.org#25996,"MANGGARAI SELATAN, TEBET, JAKARTA SELATAN, DKI JAKARTA",1,55,118,173
https://kawalpemilu.org#25996,"MANGGARAI SELATAN, TEBET, JAKARTA SELATAN, DKI JAKARTA",2,76,133,209
https://kawalpemilu.org#25996,"MANGGARAI SELATAN, TEBET, JAKARTA SELATAN, DKI JAKARTA",3,95,112,207
https://kawalpemilu.org#25996,"MANGGARAI SELATAN, TEBET, JAKARTA SELATAN, DKI JAKARTA",4,74,144,218
https://kawalpemilu.org#25996,"MANGGARAI SELATAN, TEBET, JAKARTA SELATAN, DKI JAKARTA",5,84,119,203
https://kawalpemilu.org#25996,"MANGGARAI SELATAN, TEBET, JAKARTA SELATAN, DKI JAKARTA",6,57,119,176
https://kawalpemilu.org#25996,"MANGGARAI SELATAN, TEBET, JAKARTA SELATAN, DKI JAKARTA",7,54,124,178
https://kawalpemilu.org#25996,"MANGGARAI SELATAN, TEBET, JAKARTA SELATAN, DKI JAKARTA",8,79,143,222
https://kawalpemilu.org#25996,"MANGGARAI SELATAN, TEBET, JAKARTA SELATAN, DKI JAKARTA",10,77,155,232
https://kawalpemilu.org#25996,"MANGGARAI SELATAN, TEBET, JAKARTA SELATAN, DKI JAKARTA",11,79,145,224
https://kawalpemilu.org#25996,"MANGGARAI SELATAN, TEBET, JAKARTA SELATAN, DKI JAKARTA",12,73,157,230
https://kawalpemilu.org#25996,"MANGGARAI SELATAN, TEBET, JAKARTA SELATAN, DKI JAKARTA",13,81,130,211
https://kawalpemilu.org#25996,"MANGGARAI SELATAN, TEBET, JAKARTA SELATAN, DKI JAKARTA",14,113,135,248
https://kawalpemilu.org#25996,"MANGGARAI SELATAN, TEBET, JAKARTA SELATAN, DKI JAKARTA",15,129,113,242
https://kawalpemilu.org#25996,"MANGGARAI SELATAN, TEBET, JAKARTA SELATAN, DKI JAKARTA",16,108,139,247
https://kawalpemilu.org#25996,"MANGGARAI SELATAN, TEBET, JAKARTA SELATAN, DKI JAKARTA",17,89,95,184
https://kawalpemilu.org#25996,"MANGGARAI SELATAN, TEBET, JAKARTA SELATAN, DKI JAKARTA",18,102,140,242
https://kawalpemilu.org#25996,"MANGGARAI SELATAN, TEBET, JAKARTA SELATAN, DKI JAKARTA",19,77,126,203
https://kawalpemilu.org#25996,"MANGGARAI SELATAN, TEBET, JAKARTA SELATAN, DKI JAKARTA",20,113,124,237
https://kawalpemilu.org#25996,"MANGGARAI SELATAN, TEBET, JAKARTA SELATAN, DKI JAKARTA",21,82,159,241
https://kawalpemilu.org#25996,"MANGGARAI SELATAN, TEBET, JAKARTA SELATAN, DKI JAKARTA",22,106,115,221
https://kawalpemilu.org#25996,"MANGGARAI SELATAN, TEBET, JAKARTA SELATAN, DKI JAKARTA",23,111,121,232
https://kawalpemilu.org#25996,"MANGGARAI SELATAN, TEBET, JAKARTA SELATAN, DKI JAKARTA",24,85,128,213
https://kawalpemilu.org#25996,"MANGGARAI SELATAN, TEBET, JAKARTA SELATAN, DKI JAKARTA",25,85,133,218
https://kawalpemilu.org#25996,"MANGGARAI SELATAN, TEBET, JAKARTA SELATAN, DKI JAKARTA",26,122,85,207
https://kawalpemilu.org#25996,"MANGGARAI SELATAN, TEBET, JAKARTA SELATAN, DKI JAKARTA",27,101,104,205
https://kawalpemilu.org#25996,"MANGGARAI SELATAN, TEBET, JAKARTA SELATAN, DKI JAKARTA",28,99,144,243
https://kawalpemilu.org#25996,"MANGGARAI SELATAN, TEBET, JAKARTA SELATAN, DKI JAKARTA",29,92,142,234
https://kawalpemilu.org#25996,"MANGGARAI SELATAN, TEBET, JAKARTA SELATAN, DKI JAKARTA",30,93,144,237
https://kawalpemilu.org#25996,"MANGGARAI SELATAN, TEBET, JAKARTA SELATAN, DKI JAKARTA",31,67,122,189
https://kawalpemilu.org#25996,"MANGGARAI SELATAN, TEBET, JAKARTA SELATAN, DKI JAKARTA",32,61,160,221
https://kawalpemilu.org#25996,"MANGGARAI SELATAN, TEBET, JAKARTA SELATAN, DKI JAKARTA",33,88,137,225
https://kawalpemilu.org#25996,"MANGGARAI SELATAN, TEBET, JAKARTA SELATAN, DKI JAKARTA",34,111,141,252
https://kawalpemilu.org#25996,"MANGGARAI SELATAN, TEBET, JAKARTA SELATAN, DKI JAKARTA",35,82,150,232
https://kawalpemilu.org#25996,"MANGGARAI SELATAN, TEBET, JAKARTA SELATAN, DKI JAKARTA",36,74,183,257
https://kawalpemilu.org#25996,"MANGGARAI SELATAN, TEBET, JAKARTA SELATAN, DKI JAKARTA",37,102,119,221
https://kawalpemilu.org#25996,"MANGGARAI SELATAN, TEBET, JAKARTA SELATAN, DKI JAKARTA",38,73,153,226
https://kawalpemilu.org#25996,"MANGGARAI SELATAN, TEBET, JAKARTA SELATAN, DKI JAKARTA",39,81,165,246
https://kawalpemilu.org#25996,"MANGGARAI SELATAN, TEBET, JAKARTA SELATAN, DKI JAKARTA",41,79,130,209
https://kawalpemilu.org#25996,"MANGGARAI SELATAN, TEBET, JAKARTA SELATAN, DKI JAKARTA",42,46,123,169
https://kawalpemilu.org#25996,"MANGGARAI SELATAN, TEBET, JAKARTA SELATAN, DKI JAKARTA",43,61,101,162
https://kawalpemilu.org#25996,"MANGGARAI SELATAN, TEBET, JAKARTA SELATAN, DKI JAKARTA",44,62,169,231
https://kawalpemilu.org#25996,"MANGGARAI SELATAN, TEBET, JAKARTA SELATAN, DKI JAKARTA",45,96,102,198
https://kawalpemilu.org#25996,"MANGGARAI SELATAN, TEBET, JAKARTA SELATAN, DKI JAKARTA",46,47,134,181
https://kawalpemilu.org#25996,"MANGGARAI SELATAN, TEBET, JAKARTA SELATAN, DKI JAKARTA",47,75,64,139
https://kawalpemilu.org#25996,"MANGGARAI SELATAN, TEBET, JAKARTA SELATAN, DKI JAKARTA",48,64,173,237
https://kawalpemilu.org#25996,"MANGGARAI SELATAN, TEBET, JAKARTA SELATAN, DKI JAKARTA",49,82,143,225
https://kawalpemilu.org#25996,"MANGGARAI SELATAN, TEBET, JAKARTA SELATAN, DKI JAKARTA",50,82,148,230
https://kawalpemilu.org#25996,"MANGGARAI SELATAN, TEBET, JAKARTA SELATAN, DKI JAKARTA",51,99,94,193
https://kawalpemilu.org#25996,"MANGGARAI SELATAN, TEBET, JAKARTA SELATAN, DKI JAKARTA",52,108,146,254
https://kawalpemilu.org#25996,"MANGGARAI SELATAN, TEBET, JAKARTA SELATAN, DKI JAKARTA",53,120,102,222
https://kawalpemilu.org#25996,"MANGGARAI SELATAN, TEBET, JAKARTA SELATAN, DKI JAKARTA",54,80,155,235
https://kawalpemilu.org#25996,"MANGGARAI SELATAN, TEBET, JAKARTA SELATAN, DKI JAKARTA",55,107,118,225
https://kawalpemilu.org#25996,"MANGGARAI SELATAN, TEBET, JAKARTA SELATAN, DKI JAKARTA",56,96,108,204
https://kawalpemilu.org#25996,"MANGGARAI SELATAN, TEBET, JAKARTA SELATAN, DKI JAKARTA",57,97,124,221
https://kawalpemilu.org#25996,"MANGGARAI SELATAN, TEBET, JAKARTA SELATAN, DKI JAKARTA",58,74,129,203
https://kawalpemilu.org#25996,"MANGGARAI SELATAN, TEBET, JAKARTA SELATAN, DKI JAKARTA",59,67,122,189
https://kawalpemilu.org#25996,"MANGGARAI SELATAN, TEBET, JAKARTA SELATAN, DKI JAKARTA",60,93,132,225
https://kawalpemilu.org#25996,"MANGGARAI SELATAN, TEBET, JAKARTA SELATAN, DKI JAKARTA",61,100,153,253
https://kawalpemilu.org#25996,"MANGGARAI SELATAN, TEBET, JAKARTA SELATAN, DKI JAKARTA",62,111,124,235
https://kawalpemilu.org#25996,"MANGGARAI SELATAN, TEBET, JAKARTA SELATAN, DKI JAKARTA",63,78,95,173
https://kawalpemilu.org#25996,"MANGGARAI SELATAN, TEBET, JAKARTA SELATAN, DKI JAKARTA",64,59,112,171
https://kawalpemilu.org#25996,"MANGGARAI SELATAN, TEBET, JAKARTA SELATAN, DKI JAKARTA",65,58,111,169
https://kawalpemilu.org#25996,"MANGGARAI SELATAN, TEBET, JAKARTA SELATAN, DKI JAKARTA",66,88,113,201
https://kawalpemilu.org#25996,"MANGGARAI SELATAN, TEBET, JAKARTA SELATAN, DKI JAKARTA",67,59,114,173
https://kawalpemilu.org#25996,"MANGGARAI SELATAN, TEBET, JAKARTA SELATAN, DKI JAKARTA",68,115,103,218
https://kawalpemilu.org#25996,"MANGGARAI SELATAN, TEBET, JAKARTA SELATAN, DKI JAKARTA",69,102,107,209
https://kawalpemilu.org#25996,"MANGGARAI SELATAN, TEBET, JAKARTA SELATAN, DKI JAKARTA",70,117,100,217
https://kawalpemilu.org#25996,"MANGGARAI SELATAN, TEBET, JAKARTA SELATAN, DKI JAKARTA",71,74,117,191
https://kawalpemilu.org#25996,"MANGGARAI SELATAN, TEBET, JAKARTA SELATAN, DKI JAKARTA",72,68,63,131
https://kawalpemilu.org#25996,"MANGGARAI SELATAN, TEBET, JAKARTA SELATAN, DKI JAKARTA",73,57,134,191
https://kawalpemilu.org#25996,"MANGGARAI SELATAN, TEBET, JAKARTA SELATAN, DKI JAKARTA",74,96,100,196
https://kawalpemilu.org#25996,"MANGGARAI SELATAN, TEBET, JAKARTA SELATAN, DKI JAKARTA",75,73,143,217
https://kawalpemilu.org#25996,"MANGGARAI SELATAN, TEBET, JAKARTA SELATAN, DKI JAKARTA",76,111,106,217
https://kawalpemilu.org#25996,"MANGGARAI SELATAN, TEBET, JAKARTA SELATAN, DKI JAKARTA",77,122,89,211
https://kawalpemilu.org#25996,"MANGGARAI SELATAN, TEBET, JAKARTA SELATAN, DKI JAKARTA",78,136,108,244
https://kawalpemilu.org#25996,"MANGGARAI SELATAN, TEBET, JAKARTA SELATAN, DKI JAKARTA",79,91,145,236
https://kawalpemilu.org#25996,"MANGGARAI SELATAN, TEBET, JAKARTA SELATAN, DKI JAKARTA",80,118,56,174
https://kawalpemilu.org#25996,"MANGGARAI SELATAN, TEBET, JAKARTA SELATAN, DKI JAKARTA",81,75,67,142
https://kawalpemilu.org#25997,"MANGGARAI, TEBET, JAKARTA SELATAN, DKI JAKARTA",1,138,100,238
https://kawalpemilu.org#25997,"MANGGARAI, TEBET, JAKARTA SELATAN, DKI JAKARTA",2,95,73,168
https://kawalpemilu.org#25997,"MANGGARAI, TEBET, JAKARTA SELATAN, DKI JAKARTA",3,98,72,170
https://kawalpemilu.org#25997,"MANGGARAI, TEBET, JAKARTA SELATAN, DKI JAKARTA",4,136,106,242
https://kawalpemilu.org#25997,"MANGGARAI, TEBET, JAKARTA SELATAN, DKI JAKARTA",5,142,100,242
https://kawalpemilu.org#25997,"MANGGARAI, TEBET, JAKARTA SELATAN, DKI JAKARTA",6,68,156,224
https://kawalpemilu.org#25997,"MANGGARAI, TEBET, JAKARTA SELATAN, DKI JAKARTA",7,94,118,212
https://kawalpemilu.org#25997,"MANGGARAI, TEBET, JAKARTA SELATAN, DKI JAKARTA",8,84,96,180
https://kawalpemilu.org#25997,"MANGGARAI, TEBET, JAKARTA SELATAN, DKI JAKARTA",9,83,117,200
https://kawalpemilu.org#25997,"MANGGARAI, TEBET, JAKARTA SELATAN, DKI JAKARTA",10,100,114,214
https://kawalpemilu.org#25997,"MANGGARAI, TEBET, JAKARTA SELATAN, DKI JAKARTA",11,102,111,213
https://kawalpemilu.org#25997,"MANGGARAI, TEBET, JAKARTA SELATAN, DKI JAKARTA",12,85,132,217
https://kawalpemilu.org#25997,"MANGGARAI, TEBET, JAKARTA SELATAN, DKI JAKARTA",13,99,130,229
https://kawalpemilu.org#25997,"MANGGARAI, TEBET, JAKARTA SELATAN, DKI JAKARTA",14,111,102,213
https://kawalpemilu.org#25997,"MANGGARAI, TEBET, JAKARTA SELATAN, DKI JAKARTA",15,87,106,193
https://kawalpemilu.org#25997,"MANGGARAI, TEBET, JAKARTA SELATAN, DKI JAKARTA",16,56,106,162
https://kawalpemilu.org#25997,"MANGGARAI, TEBET, JAKARTA SELATAN, DKI JAKARTA",17,110,119,229
https://kawalpemilu.org#25997,"MANGGARAI, TEBET, JAKARTA SELATAN, DKI JAKARTA",18,136,76,212
https://kawalpemilu.org#25997,"MANGGARAI, TEBET, JAKARTA SELATAN, DKI JAKARTA",19,96,107,203
https://kawalpemilu.org#25997,"MANGGARAI, TEBET, JAKARTA SELATAN, DKI JAKARTA",20,50,124,174
https://kawalpemilu.org#25997,"MANGGARAI, TEBET, JAKARTA SELATAN, DKI JAKARTA",21,96,119,215
https://kawalpemilu.org#25997,"MANGGARAI, TEBET, JAKARTA SELATAN, DKI JAKARTA",22,113,141,254
https://kawalpemilu.org#25997,"MANGGARAI, TEBET, JAKARTA SELATAN, DKI JAKARTA",23,101,104,205
https://kawalpemilu.org#25997,"MANGGARAI, TEBET, JAKARTA SELATAN, DKI JAKARTA",24,107,86,193
https://kawalpemilu.org#25997,"MANGGARAI, TEBET, JAKARTA SELATAN, DKI JAKARTA",25,84,106,190
https://kawalpemilu.org#25997,"MANGGARAI, TEBET, JAKARTA SELATAN, DKI JAKARTA",26,83,96,179
https://kawalpemilu.org#25997,"MANGGARAI, TEBET, JAKARTA SELATAN, DKI JAKARTA",27,141,95,236
https://kawalpemilu.org#25997,"MANGGARAI, TEBET, JAKARTA SELATAN, DKI JAKARTA",28,79,115,194
https://kawalpemilu.org#25997,"MANGGARAI, TEBET, JAKARTA SELATAN, DKI JAKARTA",29,99,88,187
https://kawalpemilu.org#25997,"MANGGARAI, TEBET, JAKARTA SELATAN, DKI JAKARTA",30,27,169,196
https://kawalpemilu.org#25997,"MANGGARAI, TEBET, JAKARTA SELATAN, DKI JAKARTA",32,56,168,224
https://kawalpemilu.org#25997,"MANGGARAI, TEBET, JAKARTA SELATAN, DKI JAKARTA",33,62,155,217
https://kawalpemilu.org#25997,"MANGGARAI, TEBET, JAKARTA SELATAN, DKI JAKARTA",34,41,130,171
https://kawalpemilu.org#25997,"MANGGARAI, TEBET, JAKARTA SELATAN, DKI JAKARTA",35,75,140,215
https://kawalpemilu.org#25997,"MANGGARAI, TEBET, JAKARTA SELATAN, DKI JAKARTA",36,44,109,153
https://kawalpemilu.org#25997,"MANGGARAI, TEBET, JAKARTA SELATAN, DKI JAKARTA",37,83,148,231
https://kawalpemilu.org#25997,"MANGGARAI, TEBET, JAKARTA SELATAN, DKI JAKARTA",38,86,134,220
https://kawalpemilu.org#25997,"MANGGARAI, TEBET, JAKARTA SELATAN, DKI JAKARTA",39,88,142,230
https://kawalpemilu.org#25997,"MANGGARAI, TEBET, JAKARTA SELATAN, DKI JAKARTA",40,100,122,222
https://kawalpemilu.org#25997,"MANGGARAI, TEBET, JAKARTA SELATAN, DKI JAKARTA",41,105,118,223
https://kawalpemilu.org#25997,"MANGGARAI, TEBET, JAKARTA SELATAN, DKI JAKARTA",42,85,89,174
https://kawalpemilu.org#25997,"MANGGARAI, TEBET, JAKARTA SELATAN, DKI JAKARTA",43,53,132,185
https://kawalpemilu.org#25997,"MANGGARAI, TEBET, JAKARTA SELATAN, DKI JAKARTA",44,123,79,202
https://kawalpemilu.org#25997,"MANGGARAI, TEBET, JAKARTA SELATAN, DKI JAKARTA",45,79,109,188
https://kawalpemilu.org#25997,"MANGGARAI, TEBET, JAKARTA SELATAN, DKI JAKARTA",46,100,79,179
https://kawalpemilu.org#25997,"MANGGARAI, TEBET, JAKARTA SELATAN, DKI JAKARTA",47,118,116,234
https://kawalpemilu.org#25997,"MANGGARAI, TEBET, JAKARTA SELATAN, DKI JAKARTA",48,99,117,216
https://kawalpemilu.org#25997,"MANGGARAI, TEBET, JAKARTA SELATAN, DKI JAKARTA",49,89,106,195
https://kawalpemilu.org#25997,"MANGGARAI, TEBET, JAKARTA SELATAN, DKI JAKARTA",50,74,144,218
https://kawalpemilu.org#25997,"MANGGARAI, TEBET, JAKARTA SELATAN, DKI JAKARTA",56,100,96,196
https://kawalpemilu.org#25997,"MANGGARAI, TEBET, JAKARTA SELATAN, DKI JAKARTA",60,91,93,184
https://kawalpemilu.org#25997,"MANGGARAI, TEBET, JAKARTA SELATAN, DKI JAKARTA",66,91,89,180
https://kawalpemilu.org#25997,"MANGGARAI, TEBET, JAKARTA SELATAN, DKI JAKARTA",67,77,126,213
https://kawalpemilu.org#25997,"MANGGARAI, TEBET, JAKARTA SELATAN, DKI JAKARTA",68,72,164,236
https://kawalpemilu.org#25997,"MANGGARAI, TEBET, JAKARTA SELATAN, DKI JAKARTA",69,59,112,171
https://kawalpemilu.org#25997,"MANGGARAI, TEBET, JAKARTA SELATAN, DKI JAKARTA",70,103,109,212
https://kawalpemilu.org#25997,"MANGGARAI, TEBET, JAKARTA SELATAN, DKI JAKARTA",71,101,99,200
https://kawalpemilu.org#25997,"MANGGARAI, TEBET, JAKARTA SELATAN, DKI JAKARTA",72,112,119,231
https://kawalpemilu.org#25997,"MANGGARAI, TEBET, JAKARTA SELATAN, DKI JAKARTA",73,76,125,201
https://kawalpemilu.org#25997,"MANGGARAI, TEBET, JAKARTA SELATAN, DKI JAKARTA",74,74,173,247
https://kawalpemilu.org#25997,"MANGGARAI, TEBET, JAKARTA SELATAN, DKI JAKARTA",77,59,116,175
https://kawalpemilu.org#25997,"MANGGARAI, TEBET, JAKARTA SELATAN, DKI JAKARTA",78,72,136,208
https://kawalpemilu.org#25997,"MANGGARAI, TEBET, JAKARTA SELATAN, DKI JAKARTA",79,80,146,226
https://kawalpemilu.org#25997,"MANGGARAI, TEBET, JAKARTA SELATAN, DKI JAKARTA",80,115,89,204
https://kawalpemilu.org#25997,"MANGGARAI, TEBET, JAKARTA SELATAN, DKI JAKARTA",83,75,81,156
https://kawalpemilu.org#25997,"MANGGARAI, TEBET, JAKARTA SELATAN, DKI JAKARTA",84,58,87,145
https://kawalpemilu.org#25997,"MANGGARAI, TEBET, JAKARTA SELATAN, DKI JAKARTA",86,85,144,229
https://kawalpemilu.org#25997,"MANGGARAI, TEBET, JAKARTA SELATAN, DKI JAKARTA",87,76,169,245
https://kawalpemilu.org#25997,"MANGGARAI, TEBET, JAKARTA SELATAN, DKI JAKARTA",89,65,139,204
https://kawalpemilu.org#25997,"MANGGARAI, TEBET, JAKARTA SELATAN, DKI JAKARTA",90,107,122,229
https://kawalpemilu.org#25997,"MANGGARAI, TEBET, JAKARTA SELATAN, DKI JAKARTA",93,133,100,233
https://kawalpemilu.org#25997,"MANGGARAI, TEBET, JAKARTA SELATAN, DKI JAKARTA",96,131,102,233
https://kawalpemilu.org#25997,"MANGGARAI, TEBET, JAKARTA SELATAN, DKI JAKARTA",99,64,120,184
https://kawalpemilu.org#25997,"MANGGARAI, TEBET, JAKARTA SELATAN, DKI JAKARTA",100,74,131,205
https://kawalpemilu.org#25999,"SETIA BUDI, SETIABUDI, JAKARTA SELATAN, DKI JAKARTA",1,118,67,185
https://kawalpemilu.org#25999,"SETIA BUDI, SETIABUDI, JAKARTA SELATAN, DKI JAKARTA",2,188,79,267
https://kawalpemilu.org#25999,"SETIA BUDI, SETIABUDI, JAKARTA SELATAN, DKI JAKARTA",3,162,89,251
https://kawalpemilu.org#25999,"SETIA BUDI, SETIABUDI, JAKARTA SELATAN, DKI JAKARTA",4,136,63,199
https://kawalpemilu.org#25999,"SETIA BUDI, SETIABUDI, JAKARTA SELATAN, DKI JAKARTA",6,93,121,214
https://kawalpemilu.org#25999,"SETIA BUDI, SETIABUDI, JAKARTA SELATAN, DKI JAKARTA",7,61,111,172
https://kawalpemilu.org#25999,"SETIA BUDI, SETIABUDI, JAKARTA SELATAN, DKI JAKARTA",8,142,77,219
https://kawalpemilu.org#25999,"SETIA BUDI, SETIABUDI, JAKARTA SELATAN, DKI JAKARTA",9,104,73,177
https://kawalpemilu.org#25999,"SETIA BUDI, SETIABUDI, JAKARTA SELATAN, DKI JAKARTA",10,128,102,230
https://kawalpemilu.org#25999,"SETIA BUDI, SETIABUDI, JAKARTA SELATAN, DKI JAKARTA",11,158,84,242
https://kawalpemilu.org#25999,"SETIA BUDI, SETIABUDI, JAKARTA SELATAN, DKI JAKARTA",12,143,33,176
https://kawalpemilu.org#26000,"KARET SEMANGGI, SETIABUDI, JAKARTA SELATAN, DKI JAKARTA",1,89,109,198
https://kawalpemilu.org#26000,"KARET SEMANGGI, SETIABUDI, JAKARTA SELATAN, DKI JAKARTA",2,143,89,232
https://kawalpemilu.org#26000,"KARET SEMANGGI, SETIABUDI, JAKARTA SELATAN, DKI JAKARTA",3,205,41,246
https://kawalpemilu.org#26000,"KARET SEMANGGI, SETIABUDI, JAKARTA SELATAN, DKI JAKARTA",4,138,64,202
https://kawalpemilu.org#26000,"KARET SEMANGGI, SETIABUDI, JAKARTA SELATAN, DKI JAKARTA",5,186,41,227
https://kawalpemilu.org#26000,"KARET SEMANGGI, SETIABUDI, JAKARTA SELATAN, DKI JAKARTA",6,218,6,224
https://kawalpemilu.org#26000,"KARET SEMANGGI, SETIABUDI, JAKARTA SELATAN, DKI JAKARTA",7,220,21,241
https://kawalpemilu.org#26000,"KARET SEMANGGI, SETIABUDI, JAKARTA SELATAN, DKI JAKARTA",8,168,58,226
https://kawalpemilu.org#26000,"KARET SEMANGGI, SETIABUDI, JAKARTA SELATAN, DKI JAKARTA",9,130,93,223
https://kawalpemilu.org#26000,"KARET SEMANGGI, SETIABUDI, JAKARTA SELATAN, DKI JAKARTA",10,115,55,170
https://kawalpemilu.org#26001,"KARET KUNINGAN, SETIABUDI, JAKARTA SELATAN, DKI JAKARTA",1,153,81,234
https://kawalpemilu.org#26001,"KARET KUNINGAN, SETIABUDI, JAKARTA SELATAN, DKI JAKARTA",2,189,43,232
https://kawalpemilu.org#26001,"KARET KUNINGAN, SETIABUDI, JAKARTA SELATAN, DKI JAKARTA",3,201,46,247
https://kawalpemilu.org#26001,"KARET KUNINGAN, SETIABUDI, JAKARTA SELATAN, DKI JAKARTA",4,176,57,233
https://kawalpemilu.org#26001,"KARET KUNINGAN, SETIABUDI, JAKARTA SELATAN, DKI JAKARTA",5,167,75,242
https://kawalpemilu.org#26001,"KARET KUNINGAN, SETIABUDI, JAKARTA SELATAN, DKI JAKARTA",7,153,86,239
https://kawalpemilu.org#26001,"KARET KUNINGAN, SETIABUDI, JAKARTA SELATAN, DKI JAKARTA",8,158,52,210
https://kawalpemilu.org#26001,"KARET KUNINGAN, SETIABUDI, JAKARTA SELATAN, DKI JAKARTA",11,103,132,235
https://kawalpemilu.org#26001,"KARET KUNINGAN, SETIABUDI, JAKARTA SELATAN, DKI JAKARTA",13,107,138,245
https://kawalpemilu.org#26001,"KARET KUNINGAN, SETIABUDI, JAKARTA SELATAN, DKI JAKARTA",14,126,97,223
https://kawalpemilu.org#26001,"KARET KUNINGAN, SETIABUDI, JAKARTA SELATAN, DKI JAKARTA",15,88,125,213
https://kawalpemilu.org#26001,"KARET KUNINGAN, SETIABUDI, JAKARTA SELATAN, DKI JAKARTA",16,139,85,224
https://kawalpemilu.org#26001,"KARET KUNINGAN, SETIABUDI, JAKARTA SELATAN, DKI JAKARTA",18,134,132,266
https://kawalpemilu.org#26001,"KARET KUNINGAN, SETIABUDI, JAKARTA SELATAN, DKI JAKARTA",19,111,132,243
https://kawalpemilu.org#26001,"KARET KUNINGAN, SETIABUDI, JAKARTA SELATAN, DKI JAKARTA",20,157,98,255
https://kawalpemilu.org#26001,"KARET KUNINGAN, SETIABUDI, JAKARTA SELATAN, DKI JAKARTA",21,80,158,238
https://kawalpemilu.org#26001,"KARET KUNINGAN, SETIABUDI, JAKARTA SELATAN, DKI JAKARTA",22,80,164,244
https://kawalpemilu.org#26001,"KARET KUNINGAN, SETIABUDI, JAKARTA SELATAN, DKI JAKARTA",23,75,143,218
https://kawalpemilu.org#26001,"KARET KUNINGAN, SETIABUDI, JAKARTA SELATAN, DKI JAKARTA",24,90,182,272
https://kawalpemilu.org#26001,"KARET KUNINGAN, SETIABUDI, JAKARTA SELATAN, DKI JAKARTA",25,39,172,211
https://kawalpemilu.org#26001,"KARET KUNINGAN, SETIABUDI, JAKARTA SELATAN, DKI JAKARTA",26,79,132,211
https://kawalpemilu.org#26001,"KARET KUNINGAN, SETIABUDI, JAKARTA SELATAN, DKI JAKARTA",27,103,134,237
https://kawalpemilu.org#26001,"KARET KUNINGAN, SETIABUDI, JAKARTA SELATAN, DKI JAKARTA",28,79,132,211
https://kawalpemilu.org#26001,"KARET KUNINGAN, SETIABUDI, JAKARTA SELATAN, DKI JAKARTA",29,73,184,257
https://kawalpemilu.org#26001,"KARET KUNINGAN, SETIABUDI, JAKARTA SELATAN, DKI JAKARTA",30,56,192,248
https://kawalpemilu.org#26001,"KARET KUNINGAN, SETIABUDI, JAKARTA SELATAN, DKI JAKARTA",31,81,136,217
https://kawalpemilu.org#26001,"KARET KUNINGAN, SETIABUDI, JAKARTA SELATAN, DKI JAKARTA",32,126,122,248
https://kawalpemilu.org#26001,"KARET KUNINGAN, SETIABUDI, JAKARTA SELATAN, DKI JAKARTA",33,121,101,222
https://kawalpemilu.org#26001,"KARET KUNINGAN, SETIABUDI, JAKARTA SELATAN, DKI JAKARTA",34,139,93,232
https://kawalpemilu.org#26001,"KARET KUNINGAN, SETIABUDI, JAKARTA SELATAN, DKI JAKARTA",35,96,132,228
https://kawalpemilu.org#26001,"KARET KUNINGAN, SETIABUDI, JAKARTA SELATAN, DKI JAKARTA",37,86,151,237
https://kawalpemilu.org#26001,"KARET KUNINGAN, SETIABUDI, JAKARTA SELATAN, DKI JAKARTA",38,161,66,227
https://kawalpemilu.org#26001,"KARET KUNINGAN, SETIABUDI, JAKARTA SELATAN, DKI JAKARTA",40,165,114,279
https://kawalpemilu.org#26001,"KARET KUNINGAN, SETIABUDI, JAKARTA SELATAN, DKI JAKARTA",41,153,92,245
https://kawalpemilu.org#26001,"KARET KUNINGAN, SETIABUDI, JAKARTA SELATAN, DKI JAKARTA",42,171,47,218
https://kawalpemilu.org#26001,"KARET KUNINGAN, SETIABUDI, JAKARTA SELATAN, DKI JAKARTA",44,169,52,221
https://kawalpemilu.org#26001,"KARET KUNINGAN, SETIABUDI, JAKARTA SELATAN, DKI JAKARTA",45,129,106,235
https://kawalpemilu.org#26001,"KARET KUNINGAN, SETIABUDI, JAKARTA SELATAN, DKI JAKARTA",47,95,147,242
https://kawalpemilu.org#26001,"KARET KUNINGAN, SETIABUDI, JAKARTA SELATAN, DKI JAKARTA",48,143,89,232
https://kawalpemilu.org#26001,"KARET KUNINGAN, SETIABUDI, JAKARTA SELATAN, DKI JAKARTA",49,157,80,237
https://kawalpemilu.org#26001,"KARET KUNINGAN, SETIABUDI, JAKARTA SELATAN, DKI JAKARTA",50,134,99,233
https://kawalpemilu.org#26001,"KARET KUNINGAN, SETIABUDI, JAKARTA SELATAN, DKI JAKARTA",51,121,108,229
https://kawalpemilu.org#26001,"KARET KUNINGAN, SETIABUDI, JAKARTA SELATAN, DKI JAKARTA",52,102,143,245
https://kawalpemilu.org#26001,"KARET KUNINGAN, SETIABUDI, JAKARTA SELATAN, DKI JAKARTA",53,113,128,241
https://kawalpemilu.org#26001,"KARET KUNINGAN, SETIABUDI, JAKARTA SELATAN, DKI JAKARTA",54,101,136,237
https://kawalpemilu.org#26002,"KARET, SETIABUDI, JAKARTA SELATAN, DKI JAKARTA",1,140,83,223
https://kawalpemilu.org#26002,"KARET, SETIABUDI, JAKARTA SELATAN, DKI JAKARTA",2,105,127,232
https://kawalpemilu.org#26002,"KARET, SETIABUDI, JAKARTA SELATAN, DKI JAKARTA",3,113,116,229
https://kawalpemilu.org#26002,"KARET, SETIABUDI, JAKARTA SELATAN, DKI JAKARTA",4,119,109,228
https://kawalpemilu.org#26002,"KARET, SETIABUDI, JAKARTA SELATAN, DKI JAKARTA",5,112,105,217
https://kawalpemilu.org#26002,"KARET, SETIABUDI, JAKARTA SELATAN, DKI JAKARTA",6,130,113,243
https://kawalpemilu.org#26002,"KARET, SETIABUDI, JAKARTA SELATAN, DKI JAKARTA",7,70,160,230
https://kawalpemilu.org#26002,"KARET, SETIABUDI, JAKARTA SELATAN, DKI JAKARTA",8,158,52,210
https://kawalpemilu.org#26002,"KARET, SETIABUDI, JAKARTA SELATAN, DKI JAKARTA",9,146,92,238
https://kawalpemilu.org#26002,"KARET, SETIABUDI, JAKARTA SELATAN, DKI JAKARTA",10,120,105,225
https://kawalpemilu.org#26002,"KARET, SETIABUDI, JAKARTA SELATAN, DKI JAKARTA",11,149,87,236
https://kawalpemilu.org#26002,"KARET, SETIABUDI, JAKARTA SELATAN, DKI JAKARTA",12,118,115,233
https://kawalpemilu.org#26002,"KARET, SETIABUDI, JAKARTA SELATAN, DKI JAKARTA",13,99,121,220
https://kawalpemilu.org#26002,"KARET, SETIABUDI, JAKARTA SELATAN, DKI JAKARTA",14,176,63,239
https://kawalpemilu.org#26002,"KARET, SETIABUDI, JAKARTA SELATAN, DKI JAKARTA",15,165,72,237
https://kawalpemilu.org#26002,"KARET, SETIABUDI, JAKARTA SELATAN, DKI JAKARTA",16,116,120,236
https://kawalpemilu.org#26002,"KARET, SETIABUDI, JAKARTA SELATAN, DKI JAKARTA",17,118,110,228
https://kawalpemilu.org#26002,"KARET, SETIABUDI, JAKARTA SELATAN, DKI JAKARTA",18,97,109,206
https://kawalpemilu.org#26002,"KARET, SETIABUDI, JAKARTA SELATAN, DKI JAKARTA",19,134,84,218
https://kawalpemilu.org#26002,"KARET, SETIABUDI, JAKARTA SELATAN, DKI JAKARTA",20,113,99,212
https://kawalpemilu.org#26002,"KARET, SETIABUDI, JAKARTA SELATAN, DKI JAKARTA",21,113,62,175
https://kawalpemilu.org#26002,"KARET, SETIABUDI, JAKARTA SELATAN, DKI JAKARTA",22,89,110,199
https://kawalpemilu.org#26002,"KARET, SETIABUDI, JAKARTA SELATAN, DKI JAKARTA",23,127,91,218
https://kawalpemilu.org#26002,"KARET, SETIABUDI, JAKARTA SELATAN, DKI JAKARTA",24,109,97,206
https://kawalpemilu.org#26002,"KARET, SETIABUDI, JAKARTA SELATAN, DKI JAKARTA",25,132,87,219
https://kawalpemilu.org#26002,"KARET, SETIABUDI, JAKARTA SELATAN, DKI JAKARTA",26,89,135,224
https://kawalpemilu.org#26002,"KARET, SETIABUDI, JAKARTA SELATAN, DKI JAKARTA",27,65,166,231
https://kawalpemilu.org#26002,"KARET, SETIABUDI, JAKARTA SELATAN, DKI JAKARTA",28,108,107,215
https://kawalpemilu.org#26002,"KARET, SETIABUDI, JAKARTA SELATAN, DKI JAKARTA",29,124,91,215
https://kawalpemilu.org#26002,"KARET, SETIABUDI, JAKARTA SELATAN, DKI JAKARTA",30,138,84,222
https://kawalpemilu.org#26002,"KARET, SETIABUDI, JAKARTA SELATAN, DKI JAKARTA",31,94,113,207
https://kawalpemilu.org#26002,"KARET, SETIABUDI, JAKARTA SELATAN, DKI JAKARTA",32,144,77,221
https://kawalpemilu.org#26002,"KARET, SETIABUDI, JAKARTA SELATAN, DKI JAKARTA",33,116,91,207
https://kawalpemilu.org#26002,"KARET, SETIABUDI, JAKARTA SELATAN, DKI JAKARTA",34,81,24,105
https://kawalpemilu.org#26003,"MENTENG ATAS, SETIABUDI, JAKARTA SELATAN, DKI JAKARTA",1,89,95,184
https://kawalpemilu.org#26003,"MENTENG ATAS, SETIABUDI, JAKARTA SELATAN, DKI JAKARTA",2,83,102,185
https://kawalpemilu.org#26003,"MENTENG ATAS, SETIABUDI, JAKARTA SELATAN, DKI JAKARTA",3,137,52,189
https://kawalpemilu.org#26003,"MENTENG ATAS, SETIABUDI, JAKARTA SELATAN, DKI JAKARTA",4,103,81,184
https://kawalpemilu.org#26003,"MENTENG ATAS, SETIABUDI, JAKARTA SELATAN, DKI JAKARTA",5,73,142,215
https://kawalpemilu.org#26003,"MENTENG ATAS, SETIABUDI, JAKARTA SELATAN, DKI JAKARTA",6,64,126,190
https://kawalpemilu.org#26003,"MENTENG ATAS, SETIABUDI, JAKARTA SELATAN, DKI JAKARTA",7,86,129,215
https://kawalpemilu.org#26003,"MENTENG ATAS, SETIABUDI, JAKARTA SELATAN, DKI JAKARTA",8,77,119,196
https://kawalpemilu.org#26003,"MENTENG ATAS, SETIABUDI, JAKARTA SELATAN, DKI JAKARTA",9,57,85,142
https://kawalpemilu.org#26003,"MENTENG ATAS, SETIABUDI, JAKARTA SELATAN, DKI JAKARTA",10,76,160,236
https://kawalpemilu.org#26003,"MENTENG ATAS, SETIABUDI, JAKARTA SELATAN, DKI JAKARTA",11,77,114,191
https://kawalpemilu.org#26003,"MENTENG ATAS, SETIABUDI, JAKARTA SELATAN, DKI JAKARTA",12,69,113,182
https://kawalpemilu.org#26003,"MENTENG ATAS, SETIABUDI, JAKARTA SELATAN, DKI JAKARTA",13,89,88,177
https://kawalpemilu.org#26003,"MENTENG ATAS, SETIABUDI, JAKARTA SELATAN, DKI JAKARTA",14,135,89,224
https://kawalpemilu.org#26003,"MENTENG ATAS, SETIABUDI, JAKARTA SELATAN, DKI JAKARTA",15,110,110,220
https://kawalpemilu.org#26003,"MENTENG ATAS, SETIABUDI, JAKARTA SELATAN, DKI JAKARTA",16,72,185,257
https://kawalpemilu.org#26003,"MENTENG ATAS, SETIABUDI, JAKARTA SELATAN, DKI JAKARTA",17,70,151,221
https://kawalpemilu.org#26003,"MENTENG ATAS, SETIABUDI, JAKARTA SELATAN, DKI JAKARTA",18,84,142,226
https://kawalpemilu.org#26003,"MENTENG ATAS, SETIABUDI, JAKARTA SELATAN, DKI JAKARTA",19,82,158,240
https://kawalpemilu.org#26003,"MENTENG ATAS, SETIABUDI, JAKARTA SELATAN, DKI JAKARTA",20,75,157,232
https://kawalpemilu.org#26003,"MENTENG ATAS, SETIABUDI, JAKARTA SELATAN, DKI JAKARTA",21,88,147,231
https://kawalpemilu.org#26003,"MENTENG ATAS, SETIABUDI, JAKARTA SELATAN, DKI JAKARTA",22,83,174,257
https://kawalpemilu.org#26003,"MENTENG ATAS, SETIABUDI, JAKARTA SELATAN, DKI JAKARTA",23,105,154,259
https://kawalpemilu.org#26003,"MENTENG ATAS, SETIABUDI, JAKARTA SELATAN, DKI JAKARTA",24,117,146,263
https://kawalpemilu.org#26003,"MENTENG ATAS, SETIABUDI, JAKARTA SELATAN, DKI JAKARTA",25,131,109,240
https://kawalpemilu.org#26003,"MENTENG ATAS, SETIABUDI, JAKARTA SELATAN, DKI JAKARTA",26,87,133,220
https://kawalpemilu.org#26003,"MENTENG ATAS, SETIABUDI, JAKARTA SELATAN, DKI JAKARTA",27,94,109,203
https://kawalpemilu.org#26003,"MENTENG ATAS, SETIABUDI, JAKARTA SELATAN, DKI JAKARTA",28,95,119,214
https://kawalpemilu.org#26003,"MENTENG ATAS, SETIABUDI, JAKARTA SELATAN, DKI JAKARTA",29,73,164,237
https://kawalpemilu.org#26003,"MENTENG ATAS, SETIABUDI, JAKARTA SELATAN, DKI JAKARTA",30,71,143,214
https://kawalpemilu.org#26003,"MENTENG ATAS, SETIABUDI, JAKARTA SELATAN, DKI JAKARTA",31,104,134,238
https://kawalpemilu.org#26003,"MENTENG ATAS, SETIABUDI, JAKARTA SELATAN, DKI JAKARTA",32,90,147,237
https://kawalpemilu.org#26003,"MENTENG ATAS, SETIABUDI, JAKARTA SELATAN, DKI JAKARTA",33,70,174,244
https://kawalpemilu.org#26003,"MENTENG ATAS, SETIABUDI, JAKARTA SELATAN, DKI JAKARTA",34,77,95,172
https://kawalpemilu.org#26003,"MENTENG ATAS, SETIABUDI, JAKARTA SELATAN, DKI JAKARTA",36,112,84,196
https://kawalpemilu.org#26003,"MENTENG ATAS, SETIABUDI, JAKARTA SELATAN, DKI JAKARTA",37,75,101,176
https://kawalpemilu.org#26003,"MENTENG ATAS, SETIABUDI, JAKARTA SELATAN, DKI JAKARTA",38,99,121,220
https://kawalpemilu.org#26003,"MENTENG ATAS, SETIABUDI, JAKARTA SELATAN, DKI JAKARTA",39,100,135,235
https://kawalpemilu.org#26003,"MENTENG ATAS, SETIABUDI, JAKARTA SELATAN, DKI JAKARTA",40,90,120,210
https://kawalpemilu.org#26003,"MENTENG ATAS, SETIABUDI, JAKARTA SELATAN, DKI JAKARTA",41,103,105,208
https://kawalpemilu.org#26003,"MENTENG ATAS, SETIABUDI, JAKARTA SELATAN, DKI JAKARTA",42,112,98,210
https://kawalpemilu.org#26003,"MENTENG ATAS, SETIABUDI, JAKARTA SELATAN, DKI JAKARTA",43,108,117,225
https://kawalpemilu.org#26003,"MENTENG ATAS, SETIABUDI, JAKARTA SELATAN, DKI JAKARTA",44,136,93,229
https://kawalpemilu.org#26003,"MENTENG ATAS, SETIABUDI, JAKARTA SELATAN, DKI JAKARTA",45,115,82,197
https://kawalpemilu.org#26003,"MENTENG ATAS, SETIABUDI, JAKARTA SELATAN, DKI JAKARTA",46,126,86,212
https://kawalpemilu.org#26003,"MENTENG ATAS, SETIABUDI, JAKARTA SELATAN, DKI JAKARTA",47,108,107,215
https://kawalpemilu.org#26003,"MENTENG ATAS, SETIABUDI, JAKARTA SELATAN, DKI JAKARTA",48,114,107,221
https://kawalpemilu.org#26003,"MENTENG ATAS, SETIABUDI, JAKARTA SELATAN, DKI JAKARTA",49,129,106,235
https://kawalpemilu.org#26003,"MENTENG ATAS, SETIABUDI, JAKARTA SELATAN, DKI JAKARTA",51,112,94,206
https://kawalpemilu.org#26003,"MENTENG ATAS, SETIABUDI, JAKARTA SELATAN, DKI JAKARTA",52,100,153,253
https://kawalpemilu.org#26003,"MENTENG ATAS, SETIABUDI, JAKARTA SELATAN, DKI JAKARTA",53,109,115,224
https://kawalpemilu.org#26003,"MENTENG ATAS, SETIABUDI, JAKARTA SELATAN, DKI JAKARTA",54,100,103,203
https://kawalpemilu.org#26003,"MENTENG ATAS, SETIABUDI, JAKARTA SELATAN, DKI JAKARTA",55,109,104,213
https://kawalpemilu.org#26003,"MENTENG ATAS, SETIABUDI, JAKARTA SELATAN, DKI JAKARTA",56,114,133,247
https://kawalpemilu.org#26003,"MENTENG ATAS, SETIABUDI, JAKARTA SELATAN, DKI JAKARTA",58,118,94,212
https://kawalpemilu.org#26003,"MENTENG ATAS, SETIABUDI, JAKARTA SELATAN, DKI JAKARTA",59,103,102,205
https://kawalpemilu.org#26003,"MENTENG ATAS, SETIABUDI, JAKARTA SELATAN, DKI JAKARTA",60,157,39,196
https://kawalpemilu.org#26003,"MENTENG ATAS, SETIABUDI, JAKARTA SELATAN, DKI JAKARTA",61,146,49,195
https://kawalpemilu.org#26003,"MENTENG ATAS, SETIABUDI, JAKARTA SELATAN, DKI JAKARTA",62,135,70,205
https://kawalpemilu.org#26003,"MENTENG ATAS, SETIABUDI, JAKARTA SELATAN, DKI JAKARTA",63,173,46,219
https://kawalpemilu.org#26003,"MENTENG ATAS, SETIABUDI, JAKARTA SELATAN, DKI JAKARTA",64,153,50,203
https://kawalpemilu.org#26003,"MENTENG ATAS, SETIABUDI, JAKARTA SELATAN, DKI JAKARTA",65,170,48,218
https://kawalpemilu.org#26003,"MENTENG ATAS, SETIABUDI, JAKARTA SELATAN, DKI JAKARTA",66,159,33,192
https://kawalpemilu.org#26003,"MENTENG ATAS, SETIABUDI, JAKARTA SELATAN, DKI JAKARTA",67,184,56,240
https://kawalpemilu.org#26003,"MENTENG ATAS, SETIABUDI, JAKARTA SELATAN, DKI JAKARTA",69,118,117,235
https://kawalpemilu.org#26003,"MENTENG ATAS, SETIABUDI, JAKARTA SELATAN, DKI JAKARTA",70,85,122,207
https://kawalpemilu.org#26003,"MENTENG ATAS, SETIABUDI, JAKARTA SELATAN, DKI JAKARTA",71,151,81,232
https://kawalpemilu.org#26003,"MENTENG ATAS, SETIABUDI, JAKARTA SELATAN, DKI JAKARTA",72,135,111,246
https://kawalpemilu.org#26003,"MENTENG ATAS, SETIABUDI, JAKARTA SELATAN, DKI JAKARTA",73,101,121,222
https://kawalpemilu.org#26003,"MENTENG ATAS, SETIABUDI, JAKARTA SELATAN, DKI JAKARTA",74,96,116,212
https://kawalpemilu.org#26003,"MENTENG ATAS, SETIABUDI, JAKARTA SELATAN, DKI JAKARTA",75,77,141,218
https://kawalpemilu.org#26003,"MENTENG ATAS, SETIABUDI, JAKARTA SELATAN, DKI JAKARTA",76,84,113,197
https://kawalpemilu.org#26003,"MENTENG ATAS, SETIABUDI, JAKARTA SELATAN, DKI JAKARTA",77,79,126,205
https://kawalpemilu.org#26003,"MENTENG ATAS, SETIABUDI, JAKARTA SELATAN, DKI JAKARTA",78,103,150,253
https://kawalpemilu.org#26003,"MENTENG ATAS, SETIABUDI, JAKARTA SELATAN, DKI JAKARTA",79,85,147,232
https://kawalpemilu.org#26003,"MENTENG ATAS, SETIABUDI, JAKARTA SELATAN, DKI JAKARTA",81,100,157,257
https://kawalpemilu.org#26003,"MENTENG ATAS, SETIABUDI, JAKARTA SELATAN, DKI JAKARTA",82,90,147,237
https://kawalpemilu.org#26003,"MENTENG ATAS, SETIABUDI, JAKARTA SELATAN, DKI JAKARTA",83,83,145,228
https://kawalpemilu.org#26003,"MENTENG ATAS, SETIABUDI, JAKARTA SELATAN, DKI JAKARTA",84,85,151,236
https://kawalpemilu.org#26003,"MENTENG ATAS, SETIABUDI, JAKARTA SELATAN, DKI JAKARTA",85,78,125,203
https://kawalpemilu.org#26003,"MENTENG ATAS, SETIABUDI, JAKARTA SELATAN, DKI JAKARTA",86,115,95,210
https://kawalpemilu.org#26003,"MENTENG ATAS, SETIABUDI, JAKARTA SELATAN, DKI JAKARTA",87,122,113,235
https://kawalpemilu.org#26003,"MENTENG ATAS, SETIABUDI, JAKARTA SELATAN, DKI JAKARTA",89,144,52,196
https://kawalpemilu.org#26003,"MENTENG ATAS, SETIABUDI, JAKARTA SELATAN, DKI JAKARTA",90,106,109,215
https://kawalpemilu.org#26003,"MENTENG ATAS, SETIABUDI, JAKARTA SELATAN, DKI JAKARTA",91,132,86,218
https://kawalpemilu.org#26003,"MENTENG ATAS, SETIABUDI, JAKARTA SELATAN, DKI JAKARTA",92,111,126,237
https://kawalpemilu.org#26003,"MENTENG ATAS, SETIABUDI, JAKARTA SELATAN, DKI JAKARTA",93,95,119,214
https://kawalpemilu.org#26003,"MENTENG ATAS, SETIABUDI, JAKARTA SELATAN, DKI JAKARTA",94,66,91,157
https://kawalpemilu.org#26004,"PASAR MANGGIS, SETIABUDI, JAKARTA SELATAN, DKI JAKARTA",1,112,70,182
https://kawalpemilu.org#26004,"PASAR MANGGIS, SETIABUDI, JAKARTA SELATAN, DKI JAKARTA",2,134,88,222
https://kawalpemilu.org#26004,"PASAR MANGGIS, SETIABUDI, JAKARTA SELATAN, DKI JAKARTA",3,129,76,205
https://kawalpemilu.org#26004,"PASAR MANGGIS, SETIABUDI, JAKARTA SELATAN, DKI JAKARTA",4,81,117,198
https://kawalpemilu.org#26004,"PASAR MANGGIS, SETIABUDI, JAKARTA SELATAN, DKI JAKARTA",5,58,156,214
https://kawalpemilu.org#26004,"PASAR MANGGIS, SETIABUDI, JAKARTA SELATAN, DKI JAKARTA",6,87,91,178
https://kawalpemilu.org#26004,"PASAR MANGGIS, SETIABUDI, JAKARTA SELATAN, DKI JAKARTA",7,81,129,210
https://kawalpemilu.org#26004,"PASAR MANGGIS, SETIABUDI, JAKARTA SELATAN, DKI JAKARTA",8,43,139,182
https://kawalpemilu.org#26004,"PASAR MANGGIS, SETIABUDI, JAKARTA SELATAN, DKI JAKARTA",9,69,112,180
https://kawalpemilu.org#26004,"PASAR MANGGIS, SETIABUDI, JAKARTA SELATAN, DKI JAKARTA",10,96,134,230
https://kawalpemilu.org#26004,"PASAR MANGGIS, SETIABUDI, JAKARTA SELATAN, DKI JAKARTA",11,94,128,222
https://kawalpemilu.org#26004,"PASAR MANGGIS, SETIABUDI, JAKARTA SELATAN, DKI JAKARTA",12,56,151,207
https://kawalpemilu.org#26004,"PASAR MANGGIS, SETIABUDI, JAKARTA SELATAN, DKI JAKARTA",13,56,147,203
https://kawalpemilu.org#26004,"PASAR MANGGIS, SETIABUDI, JAKARTA SELATAN, DKI JAKARTA",14,87,114,201
https://kawalpemilu.org#26004,"PASAR MANGGIS, SETIABUDI, JAKARTA SELATAN, DKI JAKARTA",15,55,138,193
https://kawalpemilu.org#26004,"PASAR MANGGIS, SETIABUDI, JAKARTA SELATAN, DKI JAKARTA",16,68,135,203
https://kawalpemilu.org#26004,"PASAR MANGGIS, SETIABUDI, JAKARTA SELATAN, DKI JAKARTA",17,59,147,206
https://kawalpemilu.org#26004,"PASAR MANGGIS, SETIABUDI, JAKARTA SELATAN, DKI JAKARTA",18,59,143,202
https://kawalpemilu.org#26004,"PASAR MANGGIS, SETIABUDI, JAKARTA SELATAN, DKI JAKARTA",19,70,130,200
https://kawalpemilu.org#26004,"PASAR MANGGIS, SETIABUDI, JAKARTA SELATAN, DKI JAKARTA",20,76,137,213
https://kawalpemilu.org#26004,"PASAR MANGGIS, SETIABUDI, JAKARTA SELATAN, DKI JAKARTA",21,69,124,193
https://kawalpemilu.org#26004,"PASAR MANGGIS, SETIABUDI, JAKARTA SELATAN, DKI JAKARTA",22,55,83,138
https://kawalpemilu.org#26004,"PASAR MANGGIS, SETIABUDI, JAKARTA SELATAN, DKI JAKARTA",23,71,135,206
https://kawalpemilu.org#26004,"PASAR MANGGIS, SETIABUDI, JAKARTA SELATAN, DKI JAKARTA",24,59,105,164
https://kawalpemilu.org#26004,"PASAR MANGGIS, SETIABUDI, JAKARTA SELATAN, DKI JAKARTA",25,63,136,199
https://kawalpemilu.org#26004,"PASAR MANGGIS, SETIABUDI, JAKARTA SELATAN, DKI JAKARTA",26,76,112,188
https://kawalpemilu.org#26004,"PASAR MANGGIS, SETIABUDI, JAKARTA SELATAN, DKI JAKARTA",27,63,83,146
https://kawalpemilu.org#26004,"PASAR MANGGIS, SETIABUDI, JAKARTA SELATAN, DKI JAKARTA",28,72,124,196
https://kawalpemilu.org#26004,"PASAR MANGGIS, SETIABUDI, JAKARTA SELATAN, DKI JAKARTA",29,94,95,189
https://kawalpemilu.org#26004,"PASAR MANGGIS, SETIABUDI, JAKARTA SELATAN, DKI JAKARTA",30,67,146,213
https://kawalpemilu.org#26004,"PASAR MANGGIS, SETIABUDI, JAKARTA SELATAN, DKI JAKARTA",31,57,141,198
https://kawalpemilu.org#26004,"PASAR MANGGIS, SETIABUDI, JAKARTA SELATAN, DKI JAKARTA",32,58,88,146
https://kawalpemilu.org#26004,"PASAR MANGGIS, SETIABUDI, JAKARTA SELATAN, DKI JAKARTA",33,59,134,193
https://kawalpemilu.org#26004,"PASAR MANGGIS, SETIABUDI, JAKARTA SELATAN, DKI JAKARTA",34,74,116,190
https://kawalpemilu.org#26004,"PASAR MANGGIS, SETIABUDI, JAKARTA SELATAN, DKI JAKARTA",35,57,157,214
https://kawalpemilu.org#26004,"PASAR MANGGIS, SETIABUDI, JAKARTA SELATAN, DKI JAKARTA",36,33,137,169
https://kawalpemilu.org#26004,"PASAR MANGGIS, SETIABUDI, JAKARTA SELATAN, DKI JAKARTA",37,96,119,215
https://kawalpemilu.org#26004,"PASAR MANGGIS, SETIABUDI, JAKARTA SELATAN, DKI JAKARTA",38,95,96,191
https://kawalpemilu.org#26004,"PASAR MANGGIS, SETIABUDI, JAKARTA SELATAN, DKI JAKARTA",39,187,27,214
https://kawalpemilu.org#26004,"PASAR MANGGIS, SETIABUDI, JAKARTA SELATAN, DKI JAKARTA",40,206,22,228
https://kawalpemilu.org#26004,"PASAR MANGGIS, SETIABUDI, JAKARTA SELATAN, DKI JAKARTA",41,103,108,211
https://kawalpemilu.org#26004,"PASAR MANGGIS, SETIABUDI, JAKARTA SELATAN, DKI JAKARTA",42,184,115,199
https://kawalpemilu.org#26004,"PASAR MANGGIS, SETIABUDI, JAKARTA SELATAN, DKI JAKARTA",43,85,138,223
https://kawalpemilu.org#26004,"PASAR MANGGIS, SETIABUDI, JAKARTA SELATAN, DKI JAKARTA",44,85,137,222
https://kawalpemilu.org#26004,"PASAR MANGGIS, SETIABUDI, JAKARTA SELATAN, DKI JAKARTA",45,158,32,190
https://kawalpemilu.org#26004,"PASAR MANGGIS, SETIABUDI, JAKARTA SELATAN, DKI JAKARTA",46,120,107,227
https://kawalpemilu.org#26004,"PASAR MANGGIS, SETIABUDI, JAKARTA SELATAN, DKI JAKARTA",47,120,92,212
https://kawalpemilu.org#26004,"PASAR MANGGIS, SETIABUDI, JAKARTA SELATAN, DKI JAKARTA",48,112,105,217
https://kawalpemilu.org#26004,"PASAR MANGGIS, SETIABUDI, JAKARTA SELATAN, DKI JAKARTA",49,109,120,229
https://kawalpemilu.org#26004,"PASAR MANGGIS, SETIABUDI, JAKARTA SELATAN, DKI JAKARTA",50,88,125,213
https://kawalpemilu.org#26004,"PASAR MANGGIS, SETIABUDI, JAKARTA SELATAN, DKI JAKARTA",51,102,106,208
https://kawalpemilu.org#26004,"PASAR MANGGIS, SETIABUDI, JAKARTA SELATAN, DKI JAKARTA",52,69,108,177
https://kawalpemilu.org#26004,"PASAR MANGGIS, SETIABUDI, JAKARTA SELATAN, DKI JAKARTA",53,103,127,230
https://kawalpemilu.org#26004,"PASAR MANGGIS, SETIABUDI, JAKARTA SELATAN, DKI JAKARTA",54,94,110,204
https://kawalpemilu.org#26004,"PASAR MANGGIS, SETIABUDI, JAKARTA SELATAN, DKI JAKARTA",55,64,141,205
https://kawalpemilu.org#26004,"PASAR MANGGIS, SETIABUDI, JAKARTA SELATAN, DKI JAKARTA",56,85,121,206
https://kawalpemilu.org#26004,"PASAR MANGGIS, SETIABUDI, JAKARTA SELATAN, DKI JAKARTA",57,92,96,188
https://kawalpemilu.org#26004,"PASAR MANGGIS, SETIABUDI, JAKARTA SELATAN, DKI JAKARTA",58,82,121,203
https://kawalpemilu.org#26004,"PASAR MANGGIS, SETIABUDI, JAKARTA SELATAN, DKI JAKARTA",59,100,126,226
https://kawalpemilu.org#26004,"PASAR MANGGIS, SETIABUDI, JAKARTA SELATAN, DKI JAKARTA",60,133,99,232
https://kawalpemilu.org#26004,"PASAR MANGGIS, SETIABUDI, JAKARTA SELATAN, DKI JAKARTA",61,80,113,193
https://kawalpemilu.org#26004,"PASAR MANGGIS, SETIABUDI, JAKARTA SELATAN, DKI JAKARTA",62,127,54,181
https://kawalpemilu.org#26004,"PASAR MANGGIS, SETIABUDI, JAKARTA SELATAN, DKI JAKARTA",63,117,80,197
https://kawalpemilu.org#26004,"PASAR MANGGIS, SETIABUDI, JAKARTA SELATAN, DKI JAKARTA",64,95,125,220
https://kawalpemilu.org#26004,"PASAR MANGGIS, SETIABUDI, JAKARTA SELATAN, DKI JAKARTA",65,102,105,207
https://kawalpemilu.org#26004,"PASAR MANGGIS, SETIABUDI, JAKARTA SELATAN, DKI JAKARTA",66,76,176,243
https://kawalpemilu.org#26004,"PASAR MANGGIS, SETIABUDI, JAKARTA SELATAN, DKI JAKARTA",67,0,0,0
https://kawalpemilu.org#26004,"PASAR MANGGIS, SETIABUDI, JAKARTA SELATAN, DKI JAKARTA",68,89,144,233
https://kawalpemilu.org#26004,"PASAR MANGGIS, SETIABUDI, JAKARTA SELATAN, DKI JAKARTA",69,106,76,182
https://kawalpemilu.org#26004,"PASAR MANGGIS, SETIABUDI, JAKARTA SELATAN, DKI JAKARTA",70,78,135,213
https://kawalpemilu.org#26004,"PASAR MANGGIS, SETIABUDI, JAKARTA SELATAN, DKI JAKARTA",71,115,88,203
https://kawalpemilu.org#26004,"PASAR MANGGIS, SETIABUDI, JAKARTA SELATAN, DKI JAKARTA",72,83,130,213
https://kawalpemilu.org#26004,"PASAR MANGGIS, SETIABUDI, JAKARTA SELATAN, DKI JAKARTA",73,140,66,206
https://kawalpemilu.org#26004,"PASAR MANGGIS, SETIABUDI, JAKARTA SELATAN, DKI JAKARTA",74,89,140,229
https://kawalpemilu.org#26004,"PASAR MANGGIS, SETIABUDI, JAKARTA SELATAN, DKI JAKARTA",75,101,110,211
https://kawalpemilu.org#26004,"PASAR MANGGIS, SETIABUDI, JAKARTA SELATAN, DKI JAKARTA",76,67,146,219
https://kawalpemilu.org#26004,"PASAR MANGGIS, SETIABUDI, JAKARTA SELATAN, DKI JAKARTA",77,73,145,218
https://kawalpemilu.org#26004,"PASAR MANGGIS, SETIABUDI, JAKARTA SELATAN, DKI JAKARTA",78,90,118,208
https://kawalpemilu.org#26004,"PASAR MANGGIS, SETIABUDI, JAKARTA SELATAN, DKI JAKARTA",79,74,120,194
https://kawalpemilu.org#26004,"PASAR MANGGIS, SETIABUDI, JAKARTA SELATAN, DKI JAKARTA",80,81,123,204
https://kawalpemilu.org#26004,"PASAR MANGGIS, SETIABUDI, JAKARTA SELATAN, DKI JAKARTA",81,62,134,196
https://kawalpemilu.org#26004,"PASAR MANGGIS, SETIABUDI, JAKARTA SELATAN, DKI JAKARTA",82,69,127,196
https://kawalpemilu.org#26004,"PASAR MANGGIS, SETIABUDI, JAKARTA SELATAN, DKI JAKARTA",83,72,136,208
https://kawalpemilu.org#26004,"PASAR MANGGIS, SETIABUDI, JAKARTA SELATAN, DKI JAKARTA",84,43,152,195
https://kawalpemilu.org#26004,"PASAR MANGGIS, SETIABUDI, JAKARTA SELATAN, DKI JAKARTA",85,66,130,196
https://kawalpemilu.org#26004,"PASAR MANGGIS, SETIABUDI, JAKARTA SELATAN, DKI JAKARTA",86,73,132,205
https://kawalpemilu.org#26004,"PASAR MANGGIS, SETIABUDI, JAKARTA SELATAN, DKI JAKARTA",87,99,108,207
https://kawalpemilu.org#26004,"PASAR MANGGIS, SETIABUDI, JAKARTA SELATAN, DKI JAKARTA",88,118,120,238
https://kawalpemilu.org#26004,"PASAR MANGGIS, SETIABUDI, JAKARTA SELATAN, DKI JAKARTA",89,106,116,222
https://kawalpemilu.org#26004,"PASAR MANGGIS, SETIABUDI, JAKARTA SELATAN, DKI JAKARTA",90,78,101,179
https://kawalpemilu.org#26004,"PASAR MANGGIS, SETIABUDI, JAKARTA SELATAN, DKI JAKARTA",91,127,60,187
https://kawalpemilu.org#26004,"PASAR MANGGIS, SETIABUDI, JAKARTA SELATAN, DKI JAKARTA",92,89,114,203
https://kawalpemilu.org#26004,"PASAR MANGGIS, SETIABUDI, JAKARTA SELATAN, DKI JAKARTA",93,72,140,212
https://kawalpemilu.org#26004,"PASAR MANGGIS, SETIABUDI, JAKARTA SELATAN, DKI JAKARTA",94,94,100,194
https://kawalpemilu.org#26004,"PASAR MANGGIS, SETIABUDI, JAKARTA SELATAN, DKI JAKARTA",95,80,81,161
https://kawalpemilu.org#26005,"GUNTUR, SETIABUDI, JAKARTA SELATAN, DKI JAKARTA",1,159,17,176
https://kawalpemilu.org#26005,"GUNTUR, SETIABUDI, JAKARTA SELATAN, DKI JAKARTA",2,164,37,201
https://kawalpemilu.org#26005,"GUNTUR, SETIABUDI, JAKARTA SELATAN, DKI JAKARTA",3,152,32,184
https://kawalpemilu.org#26005,"GUNTUR, SETIABUDI, JAKARTA SELATAN, DKI JAKARTA",4,136,22,158
https://kawalpemilu.org#26005,"GUNTUR, SETIABUDI, JAKARTA SELATAN, DKI JAKARTA",5,155,69,224
https://kawalpemilu.org#26005,"GUNTUR, SETIABUDI, JAKARTA SELATAN, DKI JAKARTA",6,161,41,202
https://kawalpemilu.org#26005,"GUNTUR, SETIABUDI, JAKARTA SELATAN, DKI JAKARTA",7,179,48,227
https://kawalpemilu.org#26005,"GUNTUR, SETIABUDI, JAKARTA SELATAN, DKI JAKARTA",8,189,27,216
https://kawalpemilu.org#26005,"GUNTUR, SETIABUDI, JAKARTA SELATAN, DKI JAKARTA",9,149,68,217
https://kawalpemilu.org#26005,"GUNTUR, SETIABUDI, JAKARTA SELATAN, DKI JAKARTA",10,127,112,239
https://kawalpemilu.org#26005,"GUNTUR, SETIABUDI, JAKARTA SELATAN, DKI JAKARTA",11,126,106,232
https://kawalpemilu.org#26005,"GUNTUR, SETIABUDI, JAKARTA SELATAN, DKI JAKARTA",12,127,85,212
https://kawalpemilu.org#26005,"GUNTUR, SETIABUDI, JAKARTA SELATAN, DKI JAKARTA",13,112,102,214
https://kawalpemilu.org#26005,"GUNTUR, SETIABUDI, JAKARTA SELATAN, DKI JAKARTA",14,119,119,238
https://kawalpemilu.org#26005,"GUNTUR, SETIABUDI, JAKARTA SELATAN, DKI JAKARTA",15,109,104,213
https://kawalpemilu.org#26006,"KUNINGAN TIMUR, SETIABUDI, JAKARTA SELATAN, DKI JAKARTA",1,114,113,227
https://kawalpemilu.org#26006,"KUNINGAN TIMUR, SETIABUDI, JAKARTA SELATAN, DKI JAKARTA",2,141,102,243
https://kawalpemilu.org#26006,"KUNINGAN TIMUR, SETIABUDI, JAKARTA SELATAN, DKI JAKARTA",3,142,89,231
https://kawalpemilu.org#26006,"KUNINGAN TIMUR, SETIABUDI, JAKARTA SELATAN, DKI JAKARTA",4,100,145,245
https://kawalpemilu.org#26006,"KUNINGAN TIMUR, SETIABUDI, JAKARTA SELATAN, DKI JAKARTA",5,183,53,236
https://kawalpemilu.org#26006,"KUNINGAN TIMUR, SETIABUDI, JAKARTA SELATAN, DKI JAKARTA",6,184,30,214
https://kawalpemilu.org#26006,"KUNINGAN TIMUR, SETIABUDI, JAKARTA SELATAN, DKI JAKARTA",7,116,131,247
https://kawalpemilu.org#26006,"KUNINGAN TIMUR, SETIABUDI, JAKARTA SELATAN, DKI JAKARTA",8,143,108,251
https://kawalpemilu.org#26006,"KUNINGAN TIMUR, SETIABUDI, JAKARTA SELATAN, DKI JAKARTA",9,103,156,259
https://kawalpemilu.org#26006,"KUNINGAN TIMUR, SETIABUDI, JAKARTA SELATAN, DKI JAKARTA",10,177,49,222
https://kawalpemilu.org#26006,"KUNINGAN TIMUR, SETIABUDI, JAKARTA SELATAN, DKI JAKARTA",11,148,88,236
https://kawalpemilu.org#26006,"KUNINGAN TIMUR, SETIABUDI, JAKARTA SELATAN, DKI JAKARTA",12,60,191,251
https://kawalpemilu.org#26006,"KUNINGAN TIMUR, SETIABUDI, JAKARTA SELATAN, DKI JAKARTA",13,78,156,234
https://kawalpemilu.org#26006,"KUNINGAN TIMUR, SETIABUDI, JAKARTA SELATAN, DKI JAKARTA",14,87,170,257
https://kawalpemilu.org#26006,"KUNINGAN TIMUR, SETIABUDI, JAKARTA SELATAN, DKI JAKARTA",15,70,196,266
https://kawalpemilu.org#26006,"KUNINGAN TIMUR, SETIABUDI, JAKARTA SELATAN, DKI JAKARTA",16,68,163,231
https://kawalpemilu.org#26006,"KUNINGAN TIMUR, SETIABUDI, JAKARTA SELATAN, DKI JAKARTA",17,81,150,231
https://kawalpemilu.org#26006,"KUNINGAN TIMUR, SETIABUDI, JAKARTA SELATAN, DKI JAKARTA",18,79,185,264
https://kawalpemilu.org#26006,"KUNINGAN TIMUR, SETIABUDI, JAKARTA SELATAN, DKI JAKARTA",19,122,135,257
https://kawalpemilu.org#26008,"MAMPANG PRAPATAN, MAMPANG PRAPATAN, JAKARTA SELATAN, DKI JAKARTA",1,77,106,183
https://kawalpemilu.org#26008,"MAMPANG PRAPATAN, MAMPANG PRAPATAN, JAKARTA SELATAN, DKI JAKARTA",2,100,109,209
https://kawalpemilu.org#26008,"MAMPANG PRAPATAN, MAMPANG PRAPATAN, JAKARTA SELATAN, DKI JAKARTA",3,100,85,185
https://kawalpemilu.org#26008,"MAMPANG PRAPATAN, MAMPANG PRAPATAN, JAKARTA SELATAN, DKI JAKARTA",4,97,89,186
https://kawalpemilu.org#26008,"MAMPANG PRAPATAN, MAMPANG PRAPATAN, JAKARTA SELATAN, DKI JAKARTA",5,107,101,208
https://kawalpemilu.org#26008,"MAMPANG PRAPATAN, MAMPANG PRAPATAN, JAKARTA SELATAN, DKI JAKARTA",6,89,103,192
https://kawalpemilu.org#26008,"MAMPANG PRAPATAN, MAMPANG PRAPATAN, JAKARTA SELATAN, DKI JAKARTA",7,93,109,202
https://kawalpemilu.org#26008,"MAMPANG PRAPATAN, MAMPANG PRAPATAN, JAKARTA SELATAN, DKI JAKARTA",8,90,93,183
https://kawalpemilu.org#26008,"MAMPANG PRAPATAN, MAMPANG PRAPATAN, JAKARTA SELATAN, DKI JAKARTA",9,65,143,208
https://kawalpemilu.org#26008,"MAMPANG PRAPATAN, MAMPANG PRAPATAN, JAKARTA SELATAN, DKI JAKARTA",10,104,135,239
https://kawalpemilu.org#26008,"MAMPANG PRAPATAN, MAMPANG PRAPATAN, JAKARTA SELATAN, DKI JAKARTA",11,113,128,241
https://kawalpemilu.org#26008,"MAMPANG PRAPATAN, MAMPANG PRAPATAN, JAKARTA SELATAN, DKI JAKARTA",12,103,102,205
https://kawalpemilu.org#26008,"MAMPANG PRAPATAN, MAMPANG PRAPATAN, JAKARTA SELATAN, DKI JAKARTA",13,73,119,192
https://kawalpemilu.org#26008,"MAMPANG PRAPATAN, MAMPANG PRAPATAN, JAKARTA SELATAN, DKI JAKARTA",14,109,95,204
https://kawalpemilu.org#26008,"MAMPANG PRAPATAN, MAMPANG PRAPATAN, JAKARTA SELATAN, DKI JAKARTA",15,76,123,199
https://kawalpemilu.org#26008,"MAMPANG PRAPATAN, MAMPANG PRAPATAN, JAKARTA SELATAN, DKI JAKARTA",16,52,151,203
https://kawalpemilu.org#26008,"MAMPANG PRAPATAN, MAMPANG PRAPATAN, JAKARTA SELATAN, DKI JAKARTA",17,60,136,196
https://kawalpemilu.org#26008,"MAMPANG PRAPATAN, MAMPANG PRAPATAN, JAKARTA SELATAN, DKI JAKARTA",18,84,155,239
https://kawalpemilu.org#26008,"MAMPANG PRAPATAN, MAMPANG PRAPATAN, JAKARTA SELATAN, DKI JAKARTA",19,27,197,224
https://kawalpemilu.org#26008,"MAMPANG PRAPATAN, MAMPANG PRAPATAN, JAKARTA SELATAN, DKI JAKARTA",20,70,106,176
https://kawalpemilu.org#26008,"MAMPANG PRAPATAN, MAMPANG PRAPATAN, JAKARTA SELATAN, DKI JAKARTA",21,97,78,175
https://kawalpemilu.org#26008,"MAMPANG PRAPATAN, MAMPANG PRAPATAN, JAKARTA SELATAN, DKI JAKARTA",22,101,130,231
https://kawalpemilu.org#26008,"MAMPANG PRAPATAN, MAMPANG PRAPATAN, JAKARTA SELATAN, DKI JAKARTA",23,58,201,259
https://kawalpemilu.org#26008,"MAMPANG PRAPATAN, MAMPANG PRAPATAN, JAKARTA SELATAN, DKI JAKARTA",24,90,155,245
https://kawalpemilu.org#26008,"MAMPANG PRAPATAN, MAMPANG PRAPATAN, JAKARTA SELATAN, DKI JAKARTA",25,65,163,228
https://kawalpemilu.org#26008,"MAMPANG PRAPATAN, MAMPANG PRAPATAN, JAKARTA SELATAN, DKI JAKARTA",26,113,129,242
https://kawalpemilu.org#26008,"MAMPANG PRAPATAN, MAMPANG PRAPATAN, JAKARTA SELATAN, DKI JAKARTA",27,82,150,232
https://kawalpemilu.org#26008,"MAMPANG PRAPATAN, MAMPANG PRAPATAN, JAKARTA SELATAN, DKI JAKARTA",28,77,118,195
https://kawalpemilu.org#26008,"MAMPANG PRAPATAN, MAMPANG PRAPATAN, JAKARTA SELATAN, DKI JAKARTA",29,93,117,210
https://kawalpemilu.org#26008,"MAMPANG PRAPATAN, MAMPANG PRAPATAN, JAKARTA SELATAN, DKI JAKARTA",30,94,152,246
https://kawalpemilu.org#26008,"MAMPANG PRAPATAN, MAMPANG PRAPATAN, JAKARTA SELATAN, DKI JAKARTA",31,97,90,187
https://kawalpemilu.org#26008,"MAMPANG PRAPATAN, MAMPANG PRAPATAN, JAKARTA SELATAN, DKI JAKARTA",32,117,84,201
https://kawalpemilu.org#26008,"MAMPANG PRAPATAN, MAMPANG PRAPATAN, JAKARTA SELATAN, DKI JAKARTA",33,92,165,257
https://kawalpemilu.org#26008,"MAMPANG PRAPATAN, MAMPANG PRAPATAN, JAKARTA SELATAN, DKI JAKARTA",34,70,121,191
https://kawalpemilu.org#26008,"MAMPANG PRAPATAN, MAMPANG PRAPATAN, JAKARTA SELATAN, DKI JAKARTA",35,73,154,227
https://kawalpemilu.org#26008,"MAMPANG PRAPATAN, MAMPANG PRAPATAN, JAKARTA SELATAN, DKI JAKARTA",36,40,170,210
https://kawalpemilu.org#26008,"MAMPANG PRAPATAN, MAMPANG PRAPATAN, JAKARTA SELATAN, DKI JAKARTA",37,53,162,215
https://kawalpemilu.org#26008,"MAMPANG PRAPATAN, MAMPANG PRAPATAN, JAKARTA SELATAN, DKI JAKARTA",38,76,156,232
https://kawalpemilu.org#26008,"MAMPANG PRAPATAN, MAMPANG PRAPATAN, JAKARTA SELATAN, DKI JAKARTA",39,55,135,190
https://kawalpemilu.org#26008,"MAMPANG PRAPATAN, MAMPANG PRAPATAN, JAKARTA SELATAN, DKI JAKARTA",40,61,196,257
https://kawalpemilu.org#26008,"MAMPANG PRAPATAN, MAMPANG PRAPATAN, JAKARTA SELATAN, DKI JAKARTA",41,66,128,194
https://kawalpemilu.org#26008,"MAMPANG PRAPATAN, MAMPANG PRAPATAN, JAKARTA SELATAN, DKI JAKARTA",42,85,108,193
https://kawalpemilu.org#26008,"MAMPANG PRAPATAN, MAMPANG PRAPATAN, JAKARTA SELATAN, DKI JAKARTA",43,26,200,226
https://kawalpemilu.org#26008,"MAMPANG PRAPATAN, MAMPANG PRAPATAN, JAKARTA SELATAN, DKI JAKARTA",44,50,151,201
https://kawalpemilu.org#26008,"MAMPANG PRAPATAN, MAMPANG PRAPATAN, JAKARTA SELATAN, DKI JAKARTA",45,68,114,182
https://kawalpemilu.org#26008,"MAMPANG PRAPATAN, MAMPANG PRAPATAN, JAKARTA SELATAN, DKI JAKARTA",46,43,149,192
https://kawalpemilu.org#26008,"MAMPANG PRAPATAN, MAMPANG PRAPATAN, JAKARTA SELATAN, DKI JAKARTA",47,72,124,196
https://kawalpemilu.org#26008,"MAMPANG PRAPATAN, MAMPANG PRAPATAN, JAKARTA SELATAN, DKI JAKARTA",48,45,131,176
https://kawalpemilu.org#26008,"MAMPANG PRAPATAN, MAMPANG PRAPATAN, JAKARTA SELATAN, DKI JAKARTA",49,32,190,222
https://kawalpemilu.org#26008,"MAMPANG PRAPATAN, MAMPANG PRAPATAN, JAKARTA SELATAN, DKI JAKARTA",50,66,119,185
https://kawalpemilu.org#26008,"MAMPANG PRAPATAN, MAMPANG PRAPATAN, JAKARTA SELATAN, DKI JAKARTA",51,79,120,199
https://kawalpemilu.org#26008,"MAMPANG PRAPATAN, MAMPANG PRAPATAN, JAKARTA SELATAN, DKI JAKARTA",52,101,148,249
https://kawalpemilu.org#26008,"MAMPANG PRAPATAN, MAMPANG PRAPATAN, JAKARTA SELATAN, DKI JAKARTA",53,72,129,201
https://kawalpemilu.org#26008,"MAMPANG PRAPATAN, MAMPANG PRAPATAN, JAKARTA SELATAN, DKI JAKARTA",54,88,92,180
https://kawalpemilu.org#26008,"MAMPANG PRAPATAN, MAMPANG PRAPATAN, JAKARTA SELATAN, DKI JAKARTA",55,97,129,226
https://kawalpemilu.org#26008,"MAMPANG PRAPATAN, MAMPANG PRAPATAN, JAKARTA SELATAN, DKI JAKARTA",56,93,91,184
https://kawalpemilu.org#26008,"MAMPANG PRAPATAN, MAMPANG PRAPATAN, JAKARTA SELATAN, DKI JAKARTA",57,75,174,249
https://kawalpemilu.org#26008,"MAMPANG PRAPATAN, MAMPANG PRAPATAN, JAKARTA SELATAN, DKI JAKARTA",58,95,152,247
https://kawalpemilu.org#26008,"MAMPANG PRAPATAN, MAMPANG PRAPATAN, JAKARTA SELATAN, DKI JAKARTA",59,80,120,200
https://kawalpemilu.org#26008,"MAMPANG PRAPATAN, MAMPANG PRAPATAN, JAKARTA SELATAN, DKI JAKARTA",60,84,118,202
https://kawalpemilu.org#26008,"MAMPANG PRAPATAN, MAMPANG PRAPATAN, JAKARTA SELATAN, DKI JAKARTA",61,63,156,219
https://kawalpemilu.org#26008,"MAMPANG PRAPATAN, MAMPANG PRAPATAN, JAKARTA SELATAN, DKI JAKARTA",62,70,138,208
https://kawalpemilu.org#26008,"MAMPANG PRAPATAN, MAMPANG PRAPATAN, JAKARTA SELATAN, DKI JAKARTA",63,75,132,207
https://kawalpemilu.org#26008,"MAMPANG PRAPATAN, MAMPANG PRAPATAN, JAKARTA SELATAN, DKI JAKARTA",64,56,157,213
https://kawalpemilu.org#26008,"MAMPANG PRAPATAN, MAMPANG PRAPATAN, JAKARTA SELATAN, DKI JAKARTA",65,60,129,189
https://kawalpemilu.org#26008,"MAMPANG PRAPATAN, MAMPANG PRAPATAN, JAKARTA SELATAN, DKI JAKARTA",66,46,188,234
https://kawalpemilu.org#26009,"BANGKA, MAMPANG PRAPATAN, JAKARTA SELATAN, DKI JAKARTA",1,98,140,238
https://kawalpemilu.org#26009,"BANGKA, MAMPANG PRAPATAN, JAKARTA SELATAN, DKI JAKARTA",3,91,172,263
https://kawalpemilu.org#26009,"BANGKA, MAMPANG PRAPATAN, JAKARTA SELATAN, DKI JAKARTA",4,105,153,258
https://kawalpemilu.org#26009,"BANGKA, MAMPANG PRAPATAN, JAKARTA SELATAN, DKI JAKARTA",5,84,109,193
https://kawalpemilu.org#26009,"BANGKA, MAMPANG PRAPATAN, JAKARTA SELATAN, DKI JAKARTA",6,108,109,217
https://kawalpemilu.org#26009,"BANGKA, MAMPANG PRAPATAN, JAKARTA SELATAN, DKI JAKARTA",7,60,144,204
https://kawalpemilu.org#26009,"BANGKA, MAMPANG PRAPATAN, JAKARTA SELATAN, DKI JAKARTA",8,130,105,235
https://kawalpemilu.org#26009,"BANGKA, MAMPANG PRAPATAN, JAKARTA SELATAN, DKI JAKARTA",10,112,102,214
https://kawalpemilu.org#26009,"BANGKA, MAMPANG PRAPATAN, JAKARTA SELATAN, DKI JAKARTA",11,126,119,245
https://kawalpemilu.org#26009,"BANGKA, MAMPANG PRAPATAN, JAKARTA SELATAN, DKI JAKARTA",12,69,120,189
https://kawalpemilu.org#26009,"BANGKA, MAMPANG PRAPATAN, JAKARTA SELATAN, DKI JAKARTA",13,71,104,175
https://kawalpemilu.org#26009,"BANGKA, MAMPANG PRAPATAN, JAKARTA SELATAN, DKI JAKARTA",14,87,125,212
https://kawalpemilu.org#26009,"BANGKA, MAMPANG PRAPATAN, JAKARTA SELATAN, DKI JAKARTA",15,96,122,218
https://kawalpemilu.org#26009,"BANGKA, MAMPANG PRAPATAN, JAKARTA SELATAN, DKI JAKARTA",16,114,104,218
https://kawalpemilu.org#26009,"BANGKA, MAMPANG PRAPATAN, JAKARTA SELATAN, DKI JAKARTA",17,54,153,207
https://kawalpemilu.org#26009,"BANGKA, MAMPANG PRAPATAN, JAKARTA SELATAN, DKI JAKARTA",18,80,100,180
https://kawalpemilu.org#26009,"BANGKA, MAMPANG PRAPATAN, JAKARTA SELATAN, DKI JAKARTA",19,102,92,198
https://kawalpemilu.org#26009,"BANGKA, MAMPANG PRAPATAN, JAKARTA SELATAN, DKI JAKARTA",20,124,92,216
https://kawalpemilu.org#26009,"BANGKA, MAMPANG PRAPATAN, JAKARTA SELATAN, DKI JAKARTA",21,114,100,214
https://kawalpemilu.org#26009,"BANGKA, MAMPANG PRAPATAN, JAKARTA SELATAN, DKI JAKARTA",22,132,76,208
https://kawalpemilu.org#26009,"BANGKA, MAMPANG PRAPATAN, JAKARTA SELATAN, DKI JAKARTA",23,73,111,184
https://kawalpemilu.org#26009,"BANGKA, MAMPANG PRAPATAN, JAKARTA SELATAN, DKI JAKARTA",24,91,91,182
https://kawalpemilu.org#26009,"BANGKA, MAMPANG PRAPATAN, JAKARTA SELATAN, DKI JAKARTA",25,92,98,190
https://kawalpemilu.org#26009,"BANGKA, MAMPANG PRAPATAN, JAKARTA SELATAN, DKI JAKARTA",26,158,80,238
https://kawalpemilu.org#26009,"BANGKA, MAMPANG PRAPATAN, JAKARTA SELATAN, DKI JAKARTA",27,79,82,161
https://kawalpemilu.org#26009,"BANGKA, MAMPANG PRAPATAN, JAKARTA SELATAN, DKI JAKARTA",28,80,86,166
https://kawalpemilu.org#26009,"BANGKA, MAMPANG PRAPATAN, JAKARTA SELATAN, DKI JAKARTA",29,154,77,231
https://kawalpemilu.org#26009,"BANGKA, MAMPANG PRAPATAN, JAKARTA SELATAN, DKI JAKARTA",30,96,155,251
https://kawalpemilu.org#26009,"BANGKA, MAMPANG PRAPATAN, JAKARTA SELATAN, DKI JAKARTA",31,94,93,187
https://kawalpemilu.org#26009,"BANGKA, MAMPANG PRAPATAN, JAKARTA SELATAN, DKI JAKARTA",32,61,157,218
https://kawalpemilu.org#26009,"BANGKA, MAMPANG PRAPATAN, JAKARTA SELATAN, DKI JAKARTA",33,102,145,247
https://kawalpemilu.org#26009,"BANGKA, MAMPANG PRAPATAN, JAKARTA SELATAN, DKI JAKARTA",34,55,169,224
https://kawalpemilu.org#26009,"BANGKA, MAMPANG PRAPATAN, JAKARTA SELATAN, DKI JAKARTA",35,67,139,206
https://kawalpemilu.org#26009,"BANGKA, MAMPANG PRAPATAN, JAKARTA SELATAN, DKI JAKARTA",36,80,94,174
https://kawalpemilu.org#26009,"BANGKA, MAMPANG PRAPATAN, JAKARTA SELATAN, DKI JAKARTA",37,75,120,195
https://kawalpemilu.org#26009,"BANGKA, MAMPANG PRAPATAN, JAKARTA SELATAN, DKI JAKARTA",38,75,95,170
https://kawalpemilu.org#26009,"BANGKA, MAMPANG PRAPATAN, JAKARTA SELATAN, DKI JAKARTA",39,84,163,247
https://kawalpemilu.org#26009,"BANGKA, MAMPANG PRAPATAN, JAKARTA SELATAN, DKI JAKARTA",40,121,111,232
https://kawalpemilu.org#26009,"BANGKA, MAMPANG PRAPATAN, JAKARTA SELATAN, DKI JAKARTA",41,95,112,207
https://kawalpemilu.org#26009,"BANGKA, MAMPANG PRAPATAN, JAKARTA SELATAN, DKI JAKARTA",42,89,155,244
https://kawalpemilu.org#26009,"BANGKA, MAMPANG PRAPATAN, JAKARTA SELATAN, DKI JAKARTA",43,95,126,221
https://kawalpemilu.org#26009,"BANGKA, MAMPANG PRAPATAN, JAKARTA SELATAN, DKI JAKARTA",44,70,114,184
https://kawalpemilu.org#26009,"BANGKA, MAMPANG PRAPATAN, JAKARTA SELATAN, DKI JAKARTA",45,75,116,191
https://kawalpemilu.org#26009,"BANGKA, MAMPANG PRAPATAN, JAKARTA SELATAN, DKI JAKARTA",46,92,130,222
https://kawalpemilu.org#26009,"BANGKA, MAMPANG PRAPATAN, JAKARTA SELATAN, DKI JAKARTA",47,76,119,195
https://kawalpemilu.org#26009,"BANGKA, MAMPANG PRAPATAN, JAKARTA SELATAN, DKI JAKARTA",48,98,107,205
https://kawalpemilu.org#26009,"BANGKA, MAMPANG PRAPATAN, JAKARTA SELATAN, DKI JAKARTA",49,102,100,202
https://kawalpemilu.org#26009,"BANGKA, MAMPANG PRAPATAN, JAKARTA SELATAN, DKI JAKARTA",50,151,59,210
https://kawalpemilu.org#26009,"BANGKA, MAMPANG PRAPATAN, JAKARTA SELATAN, DKI JAKARTA",51,134,69,203
https://kawalpemilu.org#26009,"BANGKA, MAMPANG PRAPATAN, JAKARTA SELATAN, DKI JAKARTA",52,115,85,200
https://kawalpemilu.org#26009,"BANGKA, MAMPANG PRAPATAN, JAKARTA SELATAN, DKI JAKARTA",53,104,94,198
https://kawalpemilu.org#26009,"BANGKA, MAMPANG PRAPATAN, JAKARTA SELATAN, DKI JAKARTA",54,110,93,203
https://kawalpemilu.org#26009,"BANGKA, MAMPANG PRAPATAN, JAKARTA SELATAN, DKI JAKARTA",55,123,114,237
https://kawalpemilu.org#26009,"BANGKA, MAMPANG PRAPATAN, JAKARTA SELATAN, DKI JAKARTA",56,126,105,231
https://kawalpemilu.org#26009,"BANGKA, MAMPANG PRAPATAN, JAKARTA SELATAN, DKI JAKARTA",57,90,157,247
https://kawalpemilu.org#26009,"BANGKA, MAMPANG PRAPATAN, JAKARTA SELATAN, DKI JAKARTA",58,106,114,220
https://kawalpemilu.org#26009,"BANGKA, MAMPANG PRAPATAN, JAKARTA SELATAN, DKI JAKARTA",59,130,81,211
https://kawalpemilu.org#26009,"BANGKA, MAMPANG PRAPATAN, JAKARTA SELATAN, DKI JAKARTA",60,103,95,198
https://kawalpemilu.org#26009,"BANGKA, MAMPANG PRAPATAN, JAKARTA SELATAN, DKI JAKARTA",61,128,132,260
https://kawalpemilu.org#26009,"BANGKA, MAMPANG PRAPATAN, JAKARTA SELATAN, DKI JAKARTA",62,100,168,268
https://kawalpemilu.org#26009,"BANGKA, MAMPANG PRAPATAN, JAKARTA SELATAN, DKI JAKARTA",63,104,97,201
https://kawalpemilu.org#26009,"BANGKA, MAMPANG PRAPATAN, JAKARTA SELATAN, DKI JAKARTA",64,98,80,178
https://kawalpemilu.org#26009,"BANGKA, MAMPANG PRAPATAN, JAKARTA SELATAN, DKI JAKARTA",65,149,69,218
https://kawalpemilu.org#26009,"BANGKA, MAMPANG PRAPATAN, JAKARTA SELATAN, DKI JAKARTA",66,112,123,235
https://kawalpemilu.org#26009,"BANGKA, MAMPANG PRAPATAN, JAKARTA SELATAN, DKI JAKARTA",67,127,95,222
https://kawalpemilu.org#26009,"BANGKA, MAMPANG PRAPATAN, JAKARTA SELATAN, DKI JAKARTA",68,125,101,226
https://kawalpemilu.org#26009,"BANGKA, MAMPANG PRAPATAN, JAKARTA SELATAN, DKI JAKARTA",69,124,95,219
https://kawalpemilu.org#26009,"BANGKA, MAMPANG PRAPATAN, JAKARTA SELATAN, DKI JAKARTA",70,110,113,223
https://kawalpemilu.org#26009,"BANGKA, MAMPANG PRAPATAN, JAKARTA SELATAN, DKI JAKARTA",71,115,85,200
https://kawalpemilu.org#26009,"BANGKA, MAMPANG PRAPATAN, JAKARTA SELATAN, DKI JAKARTA",72,134,54,188
https://kawalpemilu.org#26009,"BANGKA, MAMPANG PRAPATAN, JAKARTA SELATAN, DKI JAKARTA",73,64,117,181
https://kawalpemilu.org#26009,"BANGKA, MAMPANG PRAPATAN, JAKARTA SELATAN, DKI JAKARTA",74,113,63,176
https://kawalpemilu.org#26010,"PELA MAMPANG, MAMPANG PRAPATAN, JAKARTA SELATAN, DKI JAKARTA",1,140,79,219
https://kawalpemilu.org#26010,"PELA MAMPANG, MAMPANG PRAPATAN, JAKARTA SELATAN, DKI JAKARTA",2,114,126,240
https://kawalpemilu.org#26010,"PELA MAMPANG, MAMPANG PRAPATAN, JAKARTA SELATAN, DKI JAKARTA",3,107,111,218
https://kawalpemilu.org#26010,"PELA MAMPANG, MAMPANG PRAPATAN, JAKARTA SELATAN, DKI JAKARTA",4,96,143,239
https://kawalpemilu.org#26010,"PELA MAMPANG, MAMPANG PRAPATAN, JAKARTA SELATAN, DKI JAKARTA",5,104,129,233
https://kawalpemilu.org#26010,"PELA MAMPANG, MAMPANG PRAPATAN, JAKARTA SELATAN, DKI JAKARTA",6,87,138,225
https://kawalpemilu.org#26010,"PELA MAMPANG, MAMPANG PRAPATAN, JAKARTA SELATAN, DKI JAKARTA",7,71,102,173
https://kawalpemilu.org#26010,"PELA MAMPANG, MAMPANG PRAPATAN, JAKARTA SELATAN, DKI JAKARTA",8,82,110,192
https://kawalpemilu.org#26010,"PELA MAMPANG, MAMPANG PRAPATAN, JAKARTA SELATAN, DKI JAKARTA",9,79,151,230
https://kawalpemilu.org#26010,"PELA MAMPANG, MAMPANG PRAPATAN, JAKARTA SELATAN, DKI JAKARTA",10,117,135,252
https://kawalpemilu.org#26010,"PELA MAMPANG, MAMPANG PRAPATAN, JAKARTA SELATAN, DKI JAKARTA",11,118,137,255
https://kawalpemilu.org#26010,"PELA MAMPANG, MAMPANG PRAPATAN, JAKARTA SELATAN, DKI JAKARTA",12,84,147,231
https://kawalpemilu.org#26010,"PELA MAMPANG, MAMPANG PRAPATAN, JAKARTA SELATAN, DKI JAKARTA",13,167,89,256
https://kawalpemilu.org#26010,"PELA MAMPANG, MAMPANG PRAPATAN, JAKARTA SELATAN, DKI JAKARTA",14,78,166,244
https://kawalpemilu.org#26010,"PELA MAMPANG, MAMPANG PRAPATAN, JAKARTA SELATAN, DKI JAKARTA",15,115,125,240
https://kawalpemilu.org#26010,"PELA MAMPANG, MAMPANG PRAPATAN, JAKARTA SELATAN, DKI JAKARTA",16,141,100,241
https://kawalpemilu.org#26010,"PELA MAMPANG, MAMPANG PRAPATAN, JAKARTA SELATAN, DKI JAKARTA",17,138,88,224
https://kawalpemilu.org#26010,"PELA MAMPANG, MAMPANG PRAPATAN, JAKARTA SELATAN, DKI JAKARTA",18,121,104,225
https://kawalpemilu.org#26010,"PELA MAMPANG, MAMPANG PRAPATAN, JAKARTA SELATAN, DKI JAKARTA",19,127,143,270
https://kawalpemilu.org#26010,"PELA MAMPANG, MAMPANG PRAPATAN, JAKARTA SELATAN, DKI JAKARTA",20,94,178,272
https://kawalpemilu.org#26010,"PELA MAMPANG, MAMPANG PRAPATAN, JAKARTA SELATAN, DKI JAKARTA",21,107,132,239
https://kawalpemilu.org#26010,"PELA MAMPANG, MAMPANG PRAPATAN, JAKARTA SELATAN, DKI JAKARTA",22,104,111,215
https://kawalpemilu.org#26010,"PELA MAMPANG, MAMPANG PRAPATAN, JAKARTA SELATAN, DKI JAKARTA",23,94,116,210
https://kawalpemilu.org#26010,"PELA MAMPANG, MAMPANG PRAPATAN, JAKARTA SELATAN, DKI JAKARTA",24,75,121,196
https://kawalpemilu.org#26010,"PELA MAMPANG, MAMPANG PRAPATAN, JAKARTA SELATAN, DKI JAKARTA",25,53,182,235
https://kawalpemilu.org#26010,"PELA MAMPANG, MAMPANG PRAPATAN, JAKARTA SELATAN, DKI JAKARTA",26,65,177,242
https://kawalpemilu.org#26010,"PELA MAMPANG, MAMPANG PRAPATAN, JAKARTA SELATAN, DKI JAKARTA",27,44,209,253
https://kawalpemilu.org#26010,"PELA MAMPANG, MAMPANG PRAPATAN, JAKARTA SELATAN, DKI JAKARTA",28,93,140,233
https://kawalpemilu.org#26010,"PELA MAMPANG, MAMPANG PRAPATAN, JAKARTA SELATAN, DKI JAKARTA",29,145,104,249
https://kawalpemilu.org#26010,"PELA MAMPANG, MAMPANG PRAPATAN, JAKARTA SELATAN, DKI JAKARTA",30,113,107,220
https://kawalpemilu.org#26010,"PELA MAMPANG, MAMPANG PRAPATAN, JAKARTA SELATAN, DKI JAKARTA",31,69,212,281
https://kawalpemilu.org#26010,"PELA MAMPANG, MAMPANG PRAPATAN, JAKARTA SELATAN, DKI JAKARTA",32,81,160,241
https://kawalpemilu.org#26010,"PELA MAMPANG, MAMPANG PRAPATAN, JAKARTA SELATAN, DKI JAKARTA",33,85,118,203
https://kawalpemilu.org#26010,"PELA MAMPANG, MAMPANG PRAPATAN, JAKARTA SELATAN, DKI JAKARTA",34,94,131,225
https://kawalpemilu.org#26010,"PELA MAMPANG, MAMPANG PRAPATAN, JAKARTA SELATAN, DKI JAKARTA",35,109,106,215
https://kawalpemilu.org#26010,"PELA MAMPANG, MAMPANG PRAPATAN, JAKARTA SELATAN, DKI JAKARTA",36,89,143,232
https://kawalpemilu.org#26010,"PELA MAMPANG, MAMPANG PRAPATAN, JAKARTA SELATAN, DKI JAKARTA",37,80,115,195
https://kawalpemilu.org#26010,"PELA MAMPANG, MAMPANG PRAPATAN, JAKARTA SELATAN, DKI JAKARTA",38,96,160,256
https://kawalpemilu.org#26010,"PELA MAMPANG, MAMPANG PRAPATAN, JAKARTA SELATAN, DKI JAKARTA",39,103,108,211
https://kawalpemilu.org#26010,"PELA MAMPANG, MAMPANG PRAPATAN, JAKARTA SELATAN, DKI JAKARTA",40,117,129,246
https://kawalpemilu.org#26010,"PELA MAMPANG, MAMPANG PRAPATAN, JAKARTA SELATAN, DKI JAKARTA",41,67,181,248
https://kawalpemilu.org#26010,"PELA MAMPANG, MAMPANG PRAPATAN, JAKARTA SELATAN, DKI JAKARTA",42,103,164,267
https://kawalpemilu.org#26010,"PELA MAMPANG, MAMPANG PRAPATAN, JAKARTA SELATAN, DKI JAKARTA",43,77,166,243
https://kawalpemilu.org#26010,"PELA MAMPANG, MAMPANG PRAPATAN, JAKARTA SELATAN, DKI JAKARTA",44,50,183,233
https://kawalpemilu.org#26010,"PELA MAMPANG, MAMPANG PRAPATAN, JAKARTA SELATAN, DKI JAKARTA",45,140,81,221
https://kawalpemilu.org#26010,"PELA MAMPANG, MAMPANG PRAPATAN, JAKARTA SELATAN, DKI JAKARTA",46,135,75,210
https://kawalpemilu.org#26010,"PELA MAMPANG, MAMPANG PRAPATAN, JAKARTA SELATAN, DKI JAKARTA",47,148,89,237
https://kawalpemilu.org#26010,"PELA MAMPANG, MAMPANG PRAPATAN, JAKARTA SELATAN, DKI JAKARTA",48,125,87,212
https://kawalpemilu.org#26010,"PELA MAMPANG, MAMPANG PRAPATAN, JAKARTA SELATAN, DKI JAKARTA",49,105,68,173
https://kawalpemilu.org#26010,"PELA MAMPANG, MAMPANG PRAPATAN, JAKARTA SELATAN, DKI JAKARTA",50,141,81,222
https://kawalpemilu.org#26010,"PELA MAMPANG, MAMPANG PRAPATAN, JAKARTA SELATAN, DKI JAKARTA",51,115,110,225
https://kawalpemilu.org#26010,"PELA MAMPANG, MAMPANG PRAPATAN, JAKARTA SELATAN, DKI JAKARTA",53,125,77,202
https://kawalpemilu.org#26010,"PELA MAMPANG, MAMPANG PRAPATAN, JAKARTA SELATAN, DKI JAKARTA",54,119,69,188
https://kawalpemilu.org#26010,"PELA MAMPANG, MAMPANG PRAPATAN, JAKARTA SELATAN, DKI JAKARTA",55,105,100,205
https://kawalpemilu.org#26010,"PELA MAMPANG, MAMPANG PRAPATAN, JAKARTA SELATAN, DKI JAKARTA",56,172,67,239
https://kawalpemilu.org#26010,"PELA MAMPANG, MAMPANG PRAPATAN, JAKARTA SELATAN, DKI JAKARTA",57,107,105,212
https://kawalpemilu.org#26010,"PELA MAMPANG, MAMPANG PRAPATAN, JAKARTA SELATAN, DKI JAKARTA",58,120,83,203
https://kawalpemilu.org#26010,"PELA MAMPANG, MAMPANG PRAPATAN, JAKARTA SELATAN, DKI JAKARTA",62,106,111,217
https://kawalpemilu.org#26010,"PELA MAMPANG, MAMPANG PRAPATAN, JAKARTA SELATAN, DKI JAKARTA",63,149,54,203
https://kawalpemilu.org#26010,"PELA MAMPANG, MAMPANG PRAPATAN, JAKARTA SELATAN, DKI JAKARTA",64,144,76,220
https://kawalpemilu.org#26010,"PELA MAMPANG, MAMPANG PRAPATAN, JAKARTA SELATAN, DKI JAKARTA",65,118,111,229
https://kawalpemilu.org#26010,"PELA MAMPANG, MAMPANG PRAPATAN, JAKARTA SELATAN, DKI JAKARTA",66,115,92,207
https://kawalpemilu.org#26010,"PELA MAMPANG, MAMPANG PRAPATAN, JAKARTA SELATAN, DKI JAKARTA",67,124,64,188
https://kawalpemilu.org#26010,"PELA MAMPANG, MAMPANG PRAPATAN, JAKARTA SELATAN, DKI JAKARTA",68,167,70,237
https://kawalpemilu.org#26010,"PELA MAMPANG, MAMPANG PRAPATAN, JAKARTA SELATAN, DKI JAKARTA",69,121,107,228
https://kawalpemilu.org#26010,"PELA MAMPANG, MAMPANG PRAPATAN, JAKARTA SELATAN, DKI JAKARTA",70,107,112,219
https://kawalpemilu.org#26010,"PELA MAMPANG, MAMPANG PRAPATAN, JAKARTA SELATAN, DKI JAKARTA",71,119,105,224
https://kawalpemilu.org#26010,"PELA MAMPANG, MAMPANG PRAPATAN, JAKARTA SELATAN, DKI JAKARTA",72,88,152,240
https://kawalpemilu.org#26010,"PELA MAMPANG, MAMPANG PRAPATAN, JAKARTA SELATAN, DKI JAKARTA",73,135,115,250
https://kawalpemilu.org#26010,"PELA MAMPANG, MAMPANG PRAPATAN, JAKARTA SELATAN, DKI JAKARTA",75,130,60,190
https://kawalpemilu.org#26010,"PELA MAMPANG, MAMPANG PRAPATAN, JAKARTA SELATAN, DKI JAKARTA",76,135,79,214
https://kawalpemilu.org#26010,"PELA MAMPANG, MAMPANG PRAPATAN, JAKARTA SELATAN, DKI JAKARTA",78,97,122,219
https://kawalpemilu.org#26010,"PELA MAMPANG, MAMPANG PRAPATAN, JAKARTA SELATAN, DKI JAKARTA",80,140,91,231
https://kawalpemilu.org#26010,"PELA MAMPANG, MAMPANG PRAPATAN, JAKARTA SELATAN, DKI JAKARTA",81,124,57,181
https://kawalpemilu.org#26010,"PELA MAMPANG, MAMPANG PRAPATAN, JAKARTA SELATAN, DKI JAKARTA",82,109,57,166
https://kawalpemilu.org#26010,"PELA MAMPANG, MAMPANG PRAPATAN, JAKARTA SELATAN, DKI JAKARTA",83,119,100,219
https://kawalpemilu.org#26010,"PELA MAMPANG, MAMPANG PRAPATAN, JAKARTA SELATAN, DKI JAKARTA",84,150,34,184
https://kawalpemilu.org#26010,"PELA MAMPANG, MAMPANG PRAPATAN, JAKARTA SELATAN, DKI JAKARTA",85,127,91,218
https://kawalpemilu.org#26010,"PELA MAMPANG, MAMPANG PRAPATAN, JAKARTA SELATAN, DKI JAKARTA",86,117,98,215
https://kawalpemilu.org#26010,"PELA MAMPANG, MAMPANG PRAPATAN, JAKARTA SELATAN, DKI JAKARTA",87,139,96,235
https://kawalpemilu.org#26010,"PELA MAMPANG, MAMPANG PRAPATAN, JAKARTA SELATAN, DKI JAKARTA",88,114,108,222
https://kawalpemilu.org#26010,"PELA MAMPANG, MAMPANG PRAPATAN, JAKARTA SELATAN, DKI JAKARTA",89,103,107,210
https://kawalpemilu.org#26010,"PELA MAMPANG, MAMPANG PRAPATAN, JAKARTA SELATAN, DKI JAKARTA",90,139,50,189
https://kawalpemilu.org#26010,"PELA MAMPANG, MAMPANG PRAPATAN, JAKARTA SELATAN, DKI JAKARTA",91,102,136,238
https://kawalpemilu.org#26010,"PELA MAMPANG, MAMPANG PRAPATAN, JAKARTA SELATAN, DKI JAKARTA",92,112,111,223
https://kawalpemilu.org#26010,"PELA MAMPANG, MAMPANG PRAPATAN, JAKARTA SELATAN, DKI JAKARTA",93,89,141,230
https://kawalpemilu.org#26010,"PELA MAMPANG, MAMPANG PRAPATAN, JAKARTA SELATAN, DKI JAKARTA",94,86,146,232
https://kawalpemilu.org#26010,"PELA MAMPANG, MAMPANG PRAPATAN, JAKARTA SELATAN, DKI JAKARTA",95,54,170,224
https://kawalpemilu.org#26010,"PELA MAMPANG, MAMPANG PRAPATAN, JAKARTA SELATAN, DKI JAKARTA",96,64,198,262
https://kawalpemilu.org#26010,"PELA MAMPANG, MAMPANG PRAPATAN, JAKARTA SELATAN, DKI JAKARTA",97,93,132,225
https://kawalpemilu.org#26010,"PELA MAMPANG, MAMPANG PRAPATAN, JAKARTA SELATAN, DKI JAKARTA",98,92,148,240
https://kawalpemilu.org#26010,"PELA MAMPANG, MAMPANG PRAPATAN, JAKARTA SELATAN, DKI JAKARTA",100,74,81,155
https://kawalpemilu.org#26010,"PELA MAMPANG, MAMPANG PRAPATAN, JAKARTA SELATAN, DKI JAKARTA",101,79,96,175
https://kawalpemilu.org#26010,"PELA MAMPANG, MAMPANG PRAPATAN, JAKARTA SELATAN, DKI JAKARTA",102,156,81,237
https://kawalpemilu.org#26010,"PELA MAMPANG, MAMPANG PRAPATAN, JAKARTA SELATAN, DKI JAKARTA",103,105,133,238
https://kawalpemilu.org#26010,"PELA MAMPANG, MAMPANG PRAPATAN, JAKARTA SELATAN, DKI JAKARTA",105,83,142,225
https://kawalpemilu.org#26010,"PELA MAMPANG, MAMPANG PRAPATAN, JAKARTA SELATAN, DKI JAKARTA",107,96,88,184
https://kawalpemilu.org#26010,"PELA MAMPANG, MAMPANG PRAPATAN, JAKARTA SELATAN, DKI JAKARTA",108,86,89,175
https://kawalpemilu.org#26010,"PELA MAMPANG, MAMPANG PRAPATAN, JAKARTA SELATAN, DKI JAKARTA",109,134,107,241
https://kawalpemilu.org#26010,"PELA MAMPANG, MAMPANG PRAPATAN, JAKARTA SELATAN, DKI JAKARTA",111,143,84,227
https://kawalpemilu.org#26010,"PELA MAMPANG, MAMPANG PRAPATAN, JAKARTA SELATAN, DKI JAKARTA",112,120,90,210
https://kawalpemilu.org#26010,"PELA MAMPANG, MAMPANG PRAPATAN, JAKARTA SELATAN, DKI JAKARTA",113,93,129,222
https://kawalpemilu.org#26010,"PELA MAMPANG, MAMPANG PRAPATAN, JAKARTA SELATAN, DKI JAKARTA",114,96,74,170
https://kawalpemilu.org#26010,"PELA MAMPANG, MAMPANG PRAPATAN, JAKARTA SELATAN, DKI JAKARTA",115,118,78,196
https://kawalpemilu.org#26010,"PELA MAMPANG, MAMPANG PRAPATAN, JAKARTA SELATAN, DKI JAKARTA",116,88,98,186
https://kawalpemilu.org#26010,"PELA MAMPANG, MAMPANG PRAPATAN, JAKARTA SELATAN, DKI JAKARTA",117,91,104,195
https://kawalpemilu.org#26010,"PELA MAMPANG, MAMPANG PRAPATAN, JAKARTA SELATAN, DKI JAKARTA",118,111,62,175
https://kawalpemilu.org#26010,"PELA MAMPANG, MAMPANG PRAPATAN, JAKARTA SELATAN, DKI JAKARTA",120,64,124,188
https://kawalpemilu.org#26010,"PELA MAMPANG, MAMPANG PRAPATAN, JAKARTA SELATAN, DKI JAKARTA",121,67,142,209
https://kawalpemilu.org#26010,"PELA MAMPANG, MAMPANG PRAPATAN, JAKARTA SELATAN, DKI JAKARTA",123,69,115,184
https://kawalpemilu.org#26010,"PELA MAMPANG, MAMPANG PRAPATAN, JAKARTA SELATAN, DKI JAKARTA",125,85,103,188
https://kawalpemilu.org#26010,"PELA MAMPANG, MAMPANG PRAPATAN, JAKARTA SELATAN, DKI JAKARTA",126,111,130,241
https://kawalpemilu.org#26010,"PELA MAMPANG, MAMPANG PRAPATAN, JAKARTA SELATAN, DKI JAKARTA",127,81,141,222
https://kawalpemilu.org#26010,"PELA MAMPANG, MAMPANG PRAPATAN, JAKARTA SELATAN, DKI JAKARTA",128,90,145,235
https://kawalpemilu.org#26010,"PELA MAMPANG, MAMPANG PRAPATAN, JAKARTA SELATAN, DKI JAKARTA",129,79,154,233
https://kawalpemilu.org#26010,"PELA MAMPANG, MAMPANG PRAPATAN, JAKARTA SELATAN, DKI JAKARTA",130,97,158,255
https://kawalpemilu.org#26010,"PELA MAMPANG, MAMPANG PRAPATAN, JAKARTA SELATAN, DKI JAKARTA",131,95,170,265
https://kawalpemilu.org#26010,"PELA MAMPANG, MAMPANG PRAPATAN, JAKARTA SELATAN, DKI JAKARTA",132,125,143,268
https://kawalpemilu.org#26010,"PELA MAMPANG, MAMPANG PRAPATAN, JAKARTA SELATAN, DKI JAKARTA",134,112,71,183
https://kawalpemilu.org#26010,"PELA MAMPANG, MAMPANG PRAPATAN, JAKARTA SELATAN, DKI JAKARTA",135,112,92,204
https://kawalpemilu.org#26010,"PELA MAMPANG, MAMPANG PRAPATAN, JAKARTA SELATAN, DKI JAKARTA",136,145,98,243
https://kawalpemilu.org#26010,"PELA MAMPANG, MAMPANG PRAPATAN, JAKARTA SELATAN, DKI JAKARTA",137,88,78,166
https://kawalpemilu.org#26010,"PELA MAMPANG, MAMPANG PRAPATAN, JAKARTA SELATAN, DKI JAKARTA",138,76,91,167
https://kawalpemilu.org#26010,"PELA MAMPANG, MAMPANG PRAPATAN, JAKARTA SELATAN, DKI JAKARTA",139,80,94,174
https://kawalpemilu.org#26010,"PELA MAMPANG, MAMPANG PRAPATAN, JAKARTA SELATAN, DKI JAKARTA",140,91,153,244
https://kawalpemilu.org#26010,"PELA MAMPANG, MAMPANG PRAPATAN, JAKARTA SELATAN, DKI JAKARTA",141,108,97,205
https://kawalpemilu.org#26010,"PELA MAMPANG, MAMPANG PRAPATAN, JAKARTA SELATAN, DKI JAKARTA",142,131,120,251
https://kawalpemilu.org#26010,"PELA MAMPANG, MAMPANG PRAPATAN, JAKARTA SELATAN, DKI JAKARTA",144,117,67,184
https://kawalpemilu.org#26010,"PELA MAMPANG, MAMPANG PRAPATAN, JAKARTA SELATAN, DKI JAKARTA",146,125,90,215
https://kawalpemilu.org#26010,"PELA MAMPANG, MAMPANG PRAPATAN, JAKARTA SELATAN, DKI JAKARTA",148,151,104,255
https://kawalpemilu.org#26010,"PELA MAMPANG, MAMPANG PRAPATAN, JAKARTA SELATAN, DKI JAKARTA",149,88,99,187
https://kawalpemilu.org#26011,"TEGAL PARANG, MAMPANG PRAPATAN, JAKARTA SELATAN, DKI JAKARTA",1,73,126,199
https://kawalpemilu.org#26011,"TEGAL PARANG, MAMPANG PRAPATAN, JAKARTA SELATAN, DKI JAKARTA",2,78,102,180
https://kawalpemilu.org#26011,"TEGAL PARANG, MAMPANG PRAPATAN, JAKARTA SELATAN, DKI JAKARTA",3,75,147,222
https://kawalpemilu.org#26011,"TEGAL PARANG, MAMPANG PRAPATAN, JAKARTA SELATAN, DKI JAKARTA",4,92,144,236
https://kawalpemilu.org#26011,"TEGAL PARANG, MAMPANG PRAPATAN, JAKARTA SELATAN, DKI JAKARTA",5,57,197,254
https://kawalpemilu.org#26011,"TEGAL PARANG, MAMPANG PRAPATAN, JAKARTA SELATAN, DKI JAKARTA",6,69,176,245
https://kawalpemilu.org#26011,"TEGAL PARANG, MAMPANG PRAPATAN, JAKARTA SELATAN, DKI JAKARTA",7,80,131,211
https://kawalpemilu.org#26011,"TEGAL PARANG, MAMPANG PRAPATAN, JAKARTA SELATAN, DKI JAKARTA",8,64,146,210
https://kawalpemilu.org#26011,"TEGAL PARANG, MAMPANG PRAPATAN, JAKARTA SELATAN, DKI JAKARTA",9,72,181,253
https://kawalpemilu.org#26011,"TEGAL PARANG, MAMPANG PRAPATAN, JAKARTA SELATAN, DKI JAKARTA",10,79,172,251
https://kawalpemilu.org#26011,"TEGAL PARANG, MAMPANG PRAPATAN, JAKARTA SELATAN, DKI JAKARTA",11,74,169,243
https://kawalpemilu.org#26011,"TEGAL PARANG, MAMPANG PRAPATAN, JAKARTA SELATAN, DKI JAKARTA",12,51,213,264
https://kawalpemilu.org#26011,"TEGAL PARANG, MAMPANG PRAPATAN, JAKARTA SELATAN, DKI JAKARTA",13,47,211,258
https://kawalpemilu.org#26011,"TEGAL PARANG, MAMPANG PRAPATAN, JAKARTA SELATAN, DKI JAKARTA",14,96,156,252
https://kawalpemilu.org#26011,"TEGAL PARANG, MAMPANG PRAPATAN, JAKARTA SELATAN, DKI JAKARTA",15,70,174,244
https://kawalpemilu.org#26011,"TEGAL PARANG, MAMPANG PRAPATAN, JAKARTA SELATAN, DKI JAKARTA",17,62,199,261
https://kawalpemilu.org#26011,"TEGAL PARANG, MAMPANG PRAPATAN, JAKARTA SELATAN, DKI JAKARTA",19,54,194,248
https://kawalpemilu.org#26011,"TEGAL PARANG, MAMPANG PRAPATAN, JAKARTA SELATAN, DKI JAKARTA",20,74,166,240
https://kawalpemilu.org#26011,"TEGAL PARANG, MAMPANG PRAPATAN, JAKARTA SELATAN, DKI JAKARTA",21,61,215,276
https://kawalpemilu.org#26011,"TEGAL PARANG, MAMPANG PRAPATAN, JAKARTA SELATAN, DKI JAKARTA",22,66,190,256
https://kawalpemilu.org#26011,"TEGAL PARANG, MAMPANG PRAPATAN, JAKARTA SELATAN, DKI JAKARTA",23,72,171,243
https://kawalpemilu.org#26011,"TEGAL PARANG, MAMPANG PRAPATAN, JAKARTA SELATAN, DKI JAKARTA",24,38,164,202
https://kawalpemilu.org#26011,"TEGAL PARANG, MAMPANG PRAPATAN, JAKARTA SELATAN, DKI JAKARTA",25,113,135,248
https://kawalpemilu.org#26011,"TEGAL PARANG, MAMPANG PRAPATAN, JAKARTA SELATAN, DKI JAKARTA",26,58,141,199
https://kawalpemilu.org#26011,"TEGAL PARANG, MAMPANG PRAPATAN, JAKARTA SELATAN, DKI JAKARTA",27,103,119,222
https://kawalpemilu.org#26011,"TEGAL PARANG, MAMPANG PRAPATAN, JAKARTA SELATAN, DKI JAKARTA",28,83,120,203
https://kawalpemilu.org#26011,"TEGAL PARANG, MAMPANG PRAPATAN, JAKARTA SELATAN, DKI JAKARTA",29,97,107,204
https://kawalpemilu.org#26011,"TEGAL PARANG, MAMPANG PRAPATAN, JAKARTA SELATAN, DKI JAKARTA",30,74,201,275
https://kawalpemilu.org#26011,"TEGAL PARANG, MAMPANG PRAPATAN, JAKARTA SELATAN, DKI JAKARTA",31,86,146,232
https://kawalpemilu.org#26011,"TEGAL PARANG, MAMPANG PRAPATAN, JAKARTA SELATAN, DKI JAKARTA",32,79,126,205
https://kawalpemilu.org#26011,"TEGAL PARANG, MAMPANG PRAPATAN, JAKARTA SELATAN, DKI JAKARTA",33,107,106,213
https://kawalpemilu.org#26011,"TEGAL PARANG, MAMPANG PRAPATAN, JAKARTA SELATAN, DKI JAKARTA",34,109,109,218
https://kawalpemilu.org#26011,"TEGAL PARANG, MAMPANG PRAPATAN, JAKARTA SELATAN, DKI JAKARTA",35,87,152,239
https://kawalpemilu.org#26011,"TEGAL PARANG, MAMPANG PRAPATAN, JAKARTA SELATAN, DKI JAKARTA",36,81,128,209
https://kawalpemilu.org#26011,"TEGAL PARANG, MAMPANG PRAPATAN, JAKARTA SELATAN, DKI JAKARTA",37,102,139,241
https://kawalpemilu.org#26011,"TEGAL PARANG, MAMPANG PRAPATAN, JAKARTA SELATAN, DKI JAKARTA",38,87,143,230
https://kawalpemilu.org#26011,"TEGAL PARANG, MAMPANG PRAPATAN, JAKARTA SELATAN, DKI JAKARTA",39,63,120,183
https://kawalpemilu.org#26011,"TEGAL PARANG, MAMPANG PRAPATAN, JAKARTA SELATAN, DKI JAKARTA",40,92,146,238
https://kawalpemilu.org#26011,"TEGAL PARANG, MAMPANG PRAPATAN, JAKARTA SELATAN, DKI JAKARTA",41,81,149,230
https://kawalpemilu.org#26011,"TEGAL PARANG, MAMPANG PRAPATAN, JAKARTA SELATAN, DKI JAKARTA",42,65,162,227
https://kawalpemilu.org#26011,"TEGAL PARANG, MAMPANG PRAPATAN, JAKARTA SELATAN, DKI JAKARTA",43,64,161,225
https://kawalpemilu.org#26011,"TEGAL PARANG, MAMPANG PRAPATAN, JAKARTA SELATAN, DKI JAKARTA",44,77,169,246
https://kawalpemilu.org#26011,"TEGAL PARANG, MAMPANG PRAPATAN, JAKARTA SELATAN, DKI JAKARTA",45,95,143,238
https://kawalpemilu.org#26011,"TEGAL PARANG, MAMPANG PRAPATAN, JAKARTA SELATAN, DKI JAKARTA",46,118,144,262
https://kawalpemilu.org#26011,"TEGAL PARANG, MAMPANG PRAPATAN, JAKARTA SELATAN, DKI JAKARTA",47,73,161,234
https://kawalpemilu.org#26011,"TEGAL PARANG, MAMPANG PRAPATAN, JAKARTA SELATAN, DKI JAKARTA",48,45,174,219
https://kawalpemilu.org#26011,"TEGAL PARANG, MAMPANG PRAPATAN, JAKARTA SELATAN, DKI JAKARTA",49,72,150,222
https://kawalpemilu.org#26011,"TEGAL PARANG, MAMPANG PRAPATAN, JAKARTA SELATAN, DKI JAKARTA",50,84,194,278
https://kawalpemilu.org#26011,"TEGAL PARANG, MAMPANG PRAPATAN, JAKARTA SELATAN, DKI JAKARTA",51,51,186,237
https://kawalpemilu.org#26011,"TEGAL PARANG, MAMPANG PRAPATAN, JAKARTA SELATAN, DKI JAKARTA",52,40,179,219
https://kawalpemilu.org#26011,"TEGAL PARANG, MAMPANG PRAPATAN, JAKARTA SELATAN, DKI JAKARTA",53,75,139,214
https://kawalpemilu.org#26011,"TEGAL PARANG, MAMPANG PRAPATAN, JAKARTA SELATAN, DKI JAKARTA",54,91,122,213
https://kawalpemilu.org#26011,"TEGAL PARANG, MAMPANG PRAPATAN, JAKARTA SELATAN, DKI JAKARTA",55,57,170,227
https://kawalpemilu.org#26011,"TEGAL PARANG, MAMPANG PRAPATAN, JAKARTA SELATAN, DKI JAKARTA",56,71,158,229
https://kawalpemilu.org#26011,"TEGAL PARANG, MAMPANG PRAPATAN, JAKARTA SELATAN, DKI JAKARTA",58,47,177,224
https://kawalpemilu.org#26011,"TEGAL PARANG, MAMPANG PRAPATAN, JAKARTA SELATAN, DKI JAKARTA",59,51,144,195
https://kawalpemilu.org#26011,"TEGAL PARANG, MAMPANG PRAPATAN, JAKARTA SELATAN, DKI JAKARTA",60,48,147,195
https://kawalpemilu.org#26011,"TEGAL PARANG, MAMPANG PRAPATAN, JAKARTA SELATAN, DKI JAKARTA",61,49,187,236
https://kawalpemilu.org#26011,"TEGAL PARANG, MAMPANG PRAPATAN, JAKARTA SELATAN, DKI JAKARTA",62,36,205,241
https://kawalpemilu.org#26011,"TEGAL PARANG, MAMPANG PRAPATAN, JAKARTA SELATAN, DKI JAKARTA",63,63,165,228
https://kawalpemilu.org#26011,"TEGAL PARANG, MAMPANG PRAPATAN, JAKARTA SELATAN, DKI JAKARTA",64,52,172,224
https://kawalpemilu.org#26011,"TEGAL PARANG, MAMPANG PRAPATAN, JAKARTA SELATAN, DKI JAKARTA",65,56,145,201
https://kawalpemilu.org#26011,"TEGAL PARANG, MAMPANG PRAPATAN, JAKARTA SELATAN, DKI JAKARTA",66,63,174,237
https://kawalpemilu.org#26011,"TEGAL PARANG, MAMPANG PRAPATAN, JAKARTA SELATAN, DKI JAKARTA",67,69,161,230
https://kawalpemilu.org#26011,"TEGAL PARANG, MAMPANG PRAPATAN, JAKARTA SELATAN, DKI JAKARTA",68,76,175,251
https://kawalpemilu.org#26011,"TEGAL PARANG, MAMPANG PRAPATAN, JAKARTA SELATAN, DKI JAKARTA",69,58,199,257
https://kawalpemilu.org#26011,"TEGAL PARANG, MAMPANG PRAPATAN, JAKARTA SELATAN, DKI JAKARTA",70,56,140,196
https://kawalpemilu.org#26011,"TEGAL PARANG, MAMPANG PRAPATAN, JAKARTA SELATAN, DKI JAKARTA",71,68,123,191
https://kawalpemilu.org#26011,"TEGAL PARANG, MAMPANG PRAPATAN, JAKARTA SELATAN, DKI JAKARTA",72,83,98,181
https://kawalpemilu.org#26011,"TEGAL PARANG, MAMPANG PRAPATAN, JAKARTA SELATAN, DKI JAKARTA",73,52,194,246
https://kawalpemilu.org#26011,"TEGAL PARANG, MAMPANG PRAPATAN, JAKARTA SELATAN, DKI JAKARTA",74,64,186,250
https://kawalpemilu.org#26011,"TEGAL PARANG, MAMPANG PRAPATAN, JAKARTA SELATAN, DKI JAKARTA",75,74,157,231
https://kawalpemilu.org#26011,"TEGAL PARANG, MAMPANG PRAPATAN, JAKARTA SELATAN, DKI JAKARTA",76,75,134,209
https://kawalpemilu.org#26011,"TEGAL PARANG, MAMPANG PRAPATAN, JAKARTA SELATAN, DKI JAKARTA",77,79,138,217
https://kawalpemilu.org#26011,"TEGAL PARANG, MAMPANG PRAPATAN, JAKARTA SELATAN, DKI JAKARTA",78,68,140,208
https://kawalpemilu.org#26011,"TEGAL PARANG, MAMPANG PRAPATAN, JAKARTA SELATAN, DKI JAKARTA",79,33,179,212
https://kawalpemilu.org#26011,"TEGAL PARANG, MAMPANG PRAPATAN, JAKARTA SELATAN, DKI JAKARTA",80,35,192,227
https://kawalpemilu.org#26011,"TEGAL PARANG, MAMPANG PRAPATAN, JAKARTA SELATAN, DKI JAKARTA",81,65,158,223
https://kawalpemilu.org#26011,"TEGAL PARANG, MAMPANG PRAPATAN, JAKARTA SELATAN, DKI JAKARTA",82,67,154,221
https://kawalpemilu.org#26011,"TEGAL PARANG, MAMPANG PRAPATAN, JAKARTA SELATAN, DKI JAKARTA",83,95,128,223
https://kawalpemilu.org#26011,"TEGAL PARANG, MAMPANG PRAPATAN, JAKARTA SELATAN, DKI JAKARTA",84,121,107,228
https://kawalpemilu.org#26011,"TEGAL PARANG, MAMPANG PRAPATAN, JAKARTA SELATAN, DKI JAKARTA",85,118,135,253
https://kawalpemilu.org#26011,"TEGAL PARANG, MAMPANG PRAPATAN, JAKARTA SELATAN, DKI JAKARTA",86,120,125,245
https://kawalpemilu.org#26011,"TEGAL PARANG, MAMPANG PRAPATAN, JAKARTA SELATAN, DKI JAKARTA",87,107,120,227
https://kawalpemilu.org#26011,"TEGAL PARANG, MAMPANG PRAPATAN, JAKARTA SELATAN, DKI JAKARTA",88,173,102,275
https://kawalpemilu.org#26011,"TEGAL PARANG, MAMPANG PRAPATAN, JAKARTA SELATAN, DKI JAKARTA",89,131,112,243
https://kawalpemilu.org#26011,"TEGAL PARANG, MAMPANG PRAPATAN, JAKARTA SELATAN, DKI JAKARTA",90,75,172,247
https://kawalpemilu.org#26011,"TEGAL PARANG, MAMPANG PRAPATAN, JAKARTA SELATAN, DKI JAKARTA",91,112,109,221
https://kawalpemilu.org#26011,"TEGAL PARANG, MAMPANG PRAPATAN, JAKARTA SELATAN, DKI JAKARTA",92,108,130,238
https://kawalpemilu.org#26011,"TEGAL PARANG, MAMPANG PRAPATAN, JAKARTA SELATAN, DKI JAKARTA",93,58,170,228
https://kawalpemilu.org#26011,"TEGAL PARANG, MAMPANG PRAPATAN, JAKARTA SELATAN, DKI JAKARTA",94,79,193,272
https://kawalpemilu.org#26011,"TEGAL PARANG, MAMPANG PRAPATAN, JAKARTA SELATAN, DKI JAKARTA",96,88,183,271
https://kawalpemilu.org#26011,"TEGAL PARANG, MAMPANG PRAPATAN, JAKARTA SELATAN, DKI JAKARTA",97,90,148,238
https://kawalpemilu.org#26011,"TEGAL PARANG, MAMPANG PRAPATAN, JAKARTA SELATAN, DKI JAKARTA",98,37,149,186
https://kawalpemilu.org#26011,"TEGAL PARANG, MAMPANG PRAPATAN, JAKARTA SELATAN, DKI JAKARTA",99,48,156,204
https://kawalpemilu.org#26011,"TEGAL PARANG, MAMPANG PRAPATAN, JAKARTA SELATAN, DKI JAKARTA",100,59,173,232
https://kawalpemilu.org#26012,"KUNINGAN BARAT, MAMPANG PRAPATAN, JAKARTA SELATAN, DKI JAKARTA",1,141,106,247
https://kawalpemilu.org#26012,"KUNINGAN BARAT, MAMPANG PRAPATAN, JAKARTA SELATAN, DKI JAKARTA",2,60,159,219
https://kawalpemilu.org#26012,"KUNINGAN BARAT, MAMPANG PRAPATAN, JAKARTA SELATAN, DKI JAKARTA",3,113,112,225
https://kawalpemilu.org#26012,"KUNINGAN BARAT, MAMPANG PRAPATAN, JAKARTA SELATAN, DKI JAKARTA",4,135,86,221
https://kawalpemilu.org#26012,"KUNINGAN BARAT, MAMPANG PRAPATAN, JAKARTA SELATAN, DKI JAKARTA",5,127,126,253
https://kawalpemilu.org#26012,"KUNINGAN BARAT, MAMPANG PRAPATAN, JAKARTA SELATAN, DKI JAKARTA",6,125,120,245
https://kawalpemilu.org#26012,"KUNINGAN BARAT, MAMPANG PRAPATAN, JAKARTA SELATAN, DKI JAKARTA",7,92,135,227
https://kawalpemilu.org#26012,"KUNINGAN BARAT, MAMPANG PRAPATAN, JAKARTA SELATAN, DKI JAKARTA",8,101,144,245
https://kawalpemilu.org#26012,"KUNINGAN BARAT, MAMPANG PRAPATAN, JAKARTA SELATAN, DKI JAKARTA",9,144,72,216
https://kawalpemilu.org#26012,"KUNINGAN BARAT, MAMPANG PRAPATAN, JAKARTA SELATAN, DKI JAKARTA",10,145,68,213
https://kawalpemilu.org#26012,"KUNINGAN BARAT, MAMPANG PRAPATAN, JAKARTA SELATAN, DKI JAKARTA",11,138,90,228
https://kawalpemilu.org#26012,"KUNINGAN BARAT, MAMPANG PRAPATAN, JAKARTA SELATAN, DKI JAKARTA",12,122,67,189
https://kawalpemilu.org#26012,"KUNINGAN BARAT, MAMPANG PRAPATAN, JAKARTA SELATAN, DKI JAKARTA",13,143,37,180
https://kawalpemilu.org#26012,"KUNINGAN BARAT, MAMPANG PRAPATAN, JAKARTA SELATAN, DKI JAKARTA",14,129,92,221
https://kawalpemilu.org#26012,"KUNINGAN BARAT, MAMPANG PRAPATAN, JAKARTA SELATAN, DKI JAKARTA",15,91,100,191
https://kawalpemilu.org#26012,"KUNINGAN BARAT, MAMPANG PRAPATAN, JAKARTA SELATAN, DKI JAKARTA",16,77,116,193
https://kawalpemilu.org#26012,"KUNINGAN BARAT, MAMPANG PRAPATAN, JAKARTA SELATAN, DKI JAKARTA",17,118,83,201
https://kawalpemilu.org#26012,"KUNINGAN BARAT, MAMPANG PRAPATAN, JAKARTA SELATAN, DKI JAKARTA",18,124,89,213
https://kawalpemilu.org#26012,"KUNINGAN BARAT, MAMPANG PRAPATAN, JAKARTA SELATAN, DKI JAKARTA",19,79,105,184
https://kawalpemilu.org#26012,"KUNINGAN BARAT, MAMPANG PRAPATAN, JAKARTA SELATAN, DKI JAKARTA",20,95,128,223
https://kawalpemilu.org#26012,"KUNINGAN BARAT, MAMPANG PRAPATAN, JAKARTA SELATAN, DKI JAKARTA",21,99,144,243
https://kawalpemilu.org#26012,"KUNINGAN BARAT, MAMPANG PRAPATAN, JAKARTA SELATAN, DKI JAKARTA",22,95,120,215
https://kawalpemilu.org#26012,"KUNINGAN BARAT, MAMPANG PRAPATAN, JAKARTA SELATAN, DKI JAKARTA",23,81,143,224
https://kawalpemilu.org#26012,"KUNINGAN BARAT, MAMPANG PRAPATAN, JAKARTA SELATAN, DKI JAKARTA",24,135,116,251
https://kawalpemilu.org#26012,"KUNINGAN BARAT, MAMPANG PRAPATAN, JAKARTA SELATAN, DKI JAKARTA",25,124,106,230
https://kawalpemilu.org#26012,"KUNINGAN BARAT, MAMPANG PRAPATAN, JAKARTA SELATAN, DKI JAKARTA",26,73,136,209
https://kawalpemilu.org#26012,"KUNINGAN BARAT, MAMPANG PRAPATAN, JAKARTA SELATAN, DKI JAKARTA",27,82,98,180
https://kawalpemilu.org#26012,"KUNINGAN BARAT, MAMPANG PRAPATAN, JAKARTA SELATAN, DKI JAKARTA",28,82,136,218
https://kawalpemilu.org#26012,"KUNINGAN BARAT, MAMPANG PRAPATAN, JAKARTA SELATAN, DKI JAKARTA",29,74,167,241
https://kawalpemilu.org#26012,"KUNINGAN BARAT, MAMPANG PRAPATAN, JAKARTA SELATAN, DKI JAKARTA",30,68,142,210
https://kawalpemilu.org#26012,"KUNINGAN BARAT, MAMPANG PRAPATAN, JAKARTA SELATAN, DKI JAKARTA",31,153,98,251
https://kawalpemilu.org#26012,"KUNINGAN BARAT, MAMPANG PRAPATAN, JAKARTA SELATAN, DKI JAKARTA",32,98,78,176
https://kawalpemilu.org#26012,"KUNINGAN BARAT, MAMPANG PRAPATAN, JAKARTA SELATAN, DKI JAKARTA",33,119,100,219
https://kawalpemilu.org#26012,"KUNINGAN BARAT, MAMPANG PRAPATAN, JAKARTA SELATAN, DKI JAKARTA",34,142,87,229
https://kawalpemilu.org#26012,"KUNINGAN BARAT, MAMPANG PRAPATAN, JAKARTA SELATAN, DKI JAKARTA",35,146,82,228
https://kawalpemilu.org#26012,"KUNINGAN BARAT, MAMPANG PRAPATAN, JAKARTA SELATAN, DKI JAKARTA",36,141,86,227
https://kawalpemilu.org#26012,"KUNINGAN BARAT, MAMPANG PRAPATAN, JAKARTA SELATAN, DKI JAKARTA",37,154,70,224
https://kawalpemilu.org#26012,"KUNINGAN BARAT, MAMPANG PRAPATAN, JAKARTA SELATAN, DKI JAKARTA",38,144,71,215
https://kawalpemilu.org#26012,"KUNINGAN BARAT, MAMPANG PRAPATAN, JAKARTA SELATAN, DKI JAKARTA",39,109,121,230
https://kawalpemilu.org#26012,"KUNINGAN BARAT, MAMPANG PRAPATAN, JAKARTA SELATAN, DKI JAKARTA",40,93,111,204
https://kawalpemilu.org#26012,"KUNINGAN BARAT, MAMPANG PRAPATAN, JAKARTA SELATAN, DKI JAKARTA",41,83,149,232
https://kawalpemilu.org#26012,"KUNINGAN BARAT, MAMPANG PRAPATAN, JAKARTA SELATAN, DKI JAKARTA",42,100,72,172
https://kawalpemilu.org#26012,"KUNINGAN BARAT, MAMPANG PRAPATAN, JAKARTA SELATAN, DKI JAKARTA",43,104,107,211
https://kawalpemilu.org#26012,"KUNINGAN BARAT, MAMPANG PRAPATAN, JAKARTA SELATAN, DKI JAKARTA",44,113,79,192
https://kawalpemilu.org#26012,"KUNINGAN BARAT, MAMPANG PRAPATAN, JAKARTA SELATAN, DKI JAKARTA",45,82,71,153
https://kawalpemilu.org#26014,"PASAR MINGGU, PASAR MINGGU, JAKARTA SELATAN, DKI JAKARTA",1,180,61,241
https://kawalpemilu.org#26014,"PASAR MINGGU, PASAR MINGGU, JAKARTA SELATAN, DKI JAKARTA",2,133,87,220
https://kawalpemilu.org#26014,"PASAR MINGGU, PASAR MINGGU, JAKARTA SELATAN, DKI JAKARTA",3,127,120,247
https://kawalpemilu.org#26014,"PASAR MINGGU, PASAR MINGGU, JAKARTA SELATAN, DKI JAKARTA",4,134,99,233
https://kawalpemilu.org#26014,"PASAR MINGGU, PASAR MINGGU, JAKARTA SELATAN, DKI JAKARTA",5,109,106,215
https://kawalpemilu.org#26014,"PASAR MINGGU, PASAR MINGGU, JAKARTA SELATAN, DKI JAKARTA",7,89,125,214
https://kawalpemilu.org#26014,"PASAR MINGGU, PASAR MINGGU, JAKARTA SELATAN, DKI JAKARTA",8,111,146,257
https://kawalpemilu.org#26014,"PASAR MINGGU, PASAR MINGGU, JAKARTA SELATAN, DKI JAKARTA",9,116,114,230
https://kawalpemilu.org#26014,"PASAR MINGGU, PASAR MINGGU, JAKARTA SELATAN, DKI JAKARTA",10,95,74,169
https://kawalpemilu.org#26014,"PASAR MINGGU, PASAR MINGGU, JAKARTA SELATAN, DKI JAKARTA",11,165,66,231
https://kawalpemilu.org#26014,"PASAR MINGGU, PASAR MINGGU, JAKARTA SELATAN, DKI JAKARTA",12,153,98,251
https://kawalpemilu.org#26014,"PASAR MINGGU, PASAR MINGGU, JAKARTA SELATAN, DKI JAKARTA",13,103,99,202
https://kawalpemilu.org#26014,"PASAR MINGGU, PASAR MINGGU, JAKARTA SELATAN, DKI JAKARTA",14,118,111,229
https://kawalpemilu.org#26014,"PASAR MINGGU, PASAR MINGGU, JAKARTA SELATAN, DKI JAKARTA",15,94,127,221
https://kawalpemilu.org#26014,"PASAR MINGGU, PASAR MINGGU, JAKARTA SELATAN, DKI JAKARTA",17,80,71,151
https://kawalpemilu.org#26014,"PASAR MINGGU, PASAR MINGGU, JAKARTA SELATAN, DKI JAKARTA",18,129,106,235
https://kawalpemilu.org#26014,"PASAR MINGGU, PASAR MINGGU, JAKARTA SELATAN, DKI JAKARTA",19,95,92,187
https://kawalpemilu.org#26014,"PASAR MINGGU, PASAR MINGGU, JAKARTA SELATAN, DKI JAKARTA",20,79,73,152
https://kawalpemilu.org#26014,"PASAR MINGGU, PASAR MINGGU, JAKARTA SELATAN, DKI JAKARTA",21,117,54,171
https://kawalpemilu.org#26014,"PASAR MINGGU, PASAR MINGGU, JAKARTA SELATAN, DKI JAKARTA",22,0,0,0
https://kawalpemilu.org#26014,"PASAR MINGGU, PASAR MINGGU, JAKARTA SELATAN, DKI JAKARTA",23,116,96,212
https://kawalpemilu.org#26014,"PASAR MINGGU, PASAR MINGGU, JAKARTA SELATAN, DKI JAKARTA",24,146,90,236
https://kawalpemilu.org#26014,"PASAR MINGGU, PASAR MINGGU, JAKARTA SELATAN, DKI JAKARTA",25,95,105,200
https://kawalpemilu.org#26014,"PASAR MINGGU, PASAR MINGGU, JAKARTA SELATAN, DKI JAKARTA",26,107,144,251
https://kawalpemilu.org#26014,"PASAR MINGGU, PASAR MINGGU, JAKARTA SELATAN, DKI JAKARTA",27,150,96,246
https://kawalpemilu.org#26014,"PASAR MINGGU, PASAR MINGGU, JAKARTA SELATAN, DKI JAKARTA",28,77,71,148
https://kawalpemilu.org#26014,"PASAR MINGGU, PASAR MINGGU, JAKARTA SELATAN, DKI JAKARTA",29,111,82,193
https://kawalpemilu.org#26014,"PASAR MINGGU, PASAR MINGGU, JAKARTA SELATAN, DKI JAKARTA",30,82,84,166
https://kawalpemilu.org#26014,"PASAR MINGGU, PASAR MINGGU, JAKARTA SELATAN, DKI JAKARTA",31,112,97,209
https://kawalpemilu.org#26014,"PASAR MINGGU, PASAR MINGGU, JAKARTA SELATAN, DKI JAKARTA",32,119,98,217
https://kawalpemilu.org#26014,"PASAR MINGGU, PASAR MINGGU, JAKARTA SELATAN, DKI JAKARTA",33,106,53,159
https://kawalpemilu.org#26014,"PASAR MINGGU, PASAR MINGGU, JAKARTA SELATAN, DKI JAKARTA",34,141,94,235
https://kawalpemilu.org#26014,"PASAR MINGGU, PASAR MINGGU, JAKARTA SELATAN, DKI JAKARTA",35,144,80,224
https://kawalpemilu.org#26014,"PASAR MINGGU, PASAR MINGGU, JAKARTA SELATAN, DKI JAKARTA",36,154,84,238
https://kawalpemilu.org#26014,"PASAR MINGGU, PASAR MINGGU, JAKARTA SELATAN, DKI JAKARTA",37,123,39,162
https://kawalpemilu.org#26014,"PASAR MINGGU, PASAR MINGGU, JAKARTA SELATAN, DKI JAKARTA",38,123,69,192
https://kawalpemilu.org#26014,"PASAR MINGGU, PASAR MINGGU, JAKARTA SELATAN, DKI JAKARTA",39,147,70,217
https://kawalpemilu.org#26014,"PASAR MINGGU, PASAR MINGGU, JAKARTA SELATAN, DKI JAKARTA",40,115,103,218
https://kawalpemilu.org#26014,"PASAR MINGGU, PASAR MINGGU, JAKARTA SELATAN, DKI JAKARTA",41,145,74,219
https://kawalpemilu.org#26014,"PASAR MINGGU, PASAR MINGGU, JAKARTA SELATAN, DKI JAKARTA",42,133,120,253
https://kawalpemilu.org#26014,"PASAR MINGGU, PASAR MINGGU, JAKARTA SELATAN, DKI JAKARTA",43,146,99,245
https://kawalpemilu.org#26014,"PASAR MINGGU, PASAR MINGGU, JAKARTA SELATAN, DKI JAKARTA",44,135,62,197
https://kawalpemilu.org#26014,"PASAR MINGGU, PASAR MINGGU, JAKARTA SELATAN, DKI JAKARTA",45,112,73,185
https://kawalpemilu.org#26014,"PASAR MINGGU, PASAR MINGGU, JAKARTA SELATAN, DKI JAKARTA",46,112,110,222
https://kawalpemilu.org#26014,"PASAR MINGGU, PASAR MINGGU, JAKARTA SELATAN, DKI JAKARTA",47,117,94,211
https://kawalpemilu.org#26014,"PASAR MINGGU, PASAR MINGGU, JAKARTA SELATAN, DKI JAKARTA",48,163,78,241
https://kawalpemilu.org#26014,"PASAR MINGGU, PASAR MINGGU, JAKARTA SELATAN, DKI JAKARTA",49,134,102,236
https://kawalpemilu.org#26014,"PASAR MINGGU, PASAR MINGGU, JAKARTA SELATAN, DKI JAKARTA",50,100,112,212
https://kawalpemilu.org#26014,"PASAR MINGGU, PASAR MINGGU, JAKARTA SELATAN, DKI JAKARTA",51,114,105,219
https://kawalpemilu.org#26014,"PASAR MINGGU, PASAR MINGGU, JAKARTA SELATAN, DKI JAKARTA",52,105,120,225
https://kawalpemilu.org#26014,"PASAR MINGGU, PASAR MINGGU, JAKARTA SELATAN, DKI JAKARTA",53,127,99,226
https://kawalpemilu.org#26014,"PASAR MINGGU, PASAR MINGGU, JAKARTA SELATAN, DKI JAKARTA",54,134,107,241
https://kawalpemilu.org#26014,"PASAR MINGGU, PASAR MINGGU, JAKARTA SELATAN, DKI JAKARTA",55,83,194,277
https://kawalpemilu.org#26014,"PASAR MINGGU, PASAR MINGGU, JAKARTA SELATAN, DKI JAKARTA",56,136,121,257
https://kawalpemilu.org#26014,"PASAR MINGGU, PASAR MINGGU, JAKARTA SELATAN, DKI JAKARTA",57,119,125,244
https://kawalpemilu.org#26014,"PASAR MINGGU, PASAR MINGGU, JAKARTA SELATAN, DKI JAKARTA",58,124,77,201
https://kawalpemilu.org#26014,"PASAR MINGGU, PASAR MINGGU, JAKARTA SELATAN, DKI JAKARTA",59,108,122,230
https://kawalpemilu.org#26014,"PASAR MINGGU, PASAR MINGGU, JAKARTA SELATAN, DKI JAKARTA",60,78,100,178
https://kawalpemilu.org#26014,"PASAR MINGGU, PASAR MINGGU, JAKARTA SELATAN, DKI JAKARTA",61,102,21,123
https://kawalpemilu.org#26014,"PASAR MINGGU, PASAR MINGGU, JAKARTA SELATAN, DKI JAKARTA",62,123,111,234
https://kawalpemilu.org#26014,"PASAR MINGGU, PASAR MINGGU, JAKARTA SELATAN, DKI JAKARTA",63,115,50,165
https://kawalpemilu.org#26014,"PASAR MINGGU, PASAR MINGGU, JAKARTA SELATAN, DKI JAKARTA",64,86,65,151
https://kawalpemilu.org#26014,"PASAR MINGGU, PASAR MINGGU, JAKARTA SELATAN, DKI JAKARTA",65,119,100,219
https://kawalpemilu.org#26014,"PASAR MINGGU, PASAR MINGGU, JAKARTA SELATAN, DKI JAKARTA",66,121,91,212
https://kawalpemilu.org#26014,"PASAR MINGGU, PASAR MINGGU, JAKARTA SELATAN, DKI JAKARTA",67,179,77,256
https://kawalpemilu.org#26014,"PASAR MINGGU, PASAR MINGGU, JAKARTA SELATAN, DKI JAKARTA",68,153,89,242
https://kawalpemilu.org#26014,"PASAR MINGGU, PASAR MINGGU, JAKARTA SELATAN, DKI JAKARTA",69,47,60,107
https://kawalpemilu.org#26014,"PASAR MINGGU, PASAR MINGGU, JAKARTA SELATAN, DKI JAKARTA",70,31,61,92
https://kawalpemilu.org#26014,"PASAR MINGGU, PASAR MINGGU, JAKARTA SELATAN, DKI JAKARTA",71,98,84,182
https://kawalpemilu.org#26014,"PASAR MINGGU, PASAR MINGGU, JAKARTA SELATAN, DKI JAKARTA",72,116,148,264
https://kawalpemilu.org#26014,"PASAR MINGGU, PASAR MINGGU, JAKARTA SELATAN, DKI JAKARTA",74,111,138,249
https://kawalpemilu.org#26014,"PASAR MINGGU, PASAR MINGGU, JAKARTA SELATAN, DKI JAKARTA",75,125,98,223
https://kawalpemilu.org#26014,"PASAR MINGGU, PASAR MINGGU, JAKARTA SELATAN, DKI JAKARTA",76,94,181,275
https://kawalpemilu.org#26014,"PASAR MINGGU, PASAR MINGGU, JAKARTA SELATAN, DKI JAKARTA",77,110,123,233
https://kawalpemilu.org#26014,"PASAR MINGGU, PASAR MINGGU, JAKARTA SELATAN, DKI JAKARTA",78,118,130,248
https://kawalpemilu.org#26014,"PASAR MINGGU, PASAR MINGGU, JAKARTA SELATAN, DKI JAKARTA",79,136,101,237
https://kawalpemilu.org#26014,"PASAR MINGGU, PASAR MINGGU, JAKARTA SELATAN, DKI JAKARTA",80,139,116,255
https://kawalpemilu.org#26014,"PASAR MINGGU, PASAR MINGGU, JAKARTA SELATAN, DKI JAKARTA",81,113,129,242
https://kawalpemilu.org#26014,"PASAR MINGGU, PASAR MINGGU, JAKARTA SELATAN, DKI JAKARTA",82,92,159,251
https://kawalpemilu.org#26014,"PASAR MINGGU, PASAR MINGGU, JAKARTA SELATAN, DKI JAKARTA",83,63,106,169
https://kawalpemilu.org#26014,"PASAR MINGGU, PASAR MINGGU, JAKARTA SELATAN, DKI JAKARTA",85,133,119,252
https://kawalpemilu.org#26015,"JATI PADANG, PASAR MINGGU, JAKARTA SELATAN, DKI JAKARTA",1,134,86,220
https://kawalpemilu.org#26015,"JATI PADANG, PASAR MINGGU, JAKARTA SELATAN, DKI JAKARTA",2,114,146,260
https://kawalpemilu.org#26015,"JATI PADANG, PASAR MINGGU, JAKARTA SELATAN, DKI JAKARTA",3,102,147,249
https://kawalpemilu.org#26015,"JATI PADANG, PASAR MINGGU, JAKARTA SELATAN, DKI JAKARTA",4,101,110,211
https://kawalpemilu.org#26015,"JATI PADANG, PASAR MINGGU, JAKARTA SELATAN, DKI JAKARTA",6,86,121,207
https://kawalpemilu.org#26015,"JATI PADANG, PASAR MINGGU, JAKARTA SELATAN, DKI JAKARTA",7,83,115,198
https://kawalpemilu.org#26015,"JATI PADANG, PASAR MINGGU, JAKARTA SELATAN, DKI JAKARTA",9,136,102,238
https://kawalpemilu.org#26015,"JATI PADANG, PASAR MINGGU, JAKARTA SELATAN, DKI JAKARTA",10,155,116,271
https://kawalpemilu.org#26015,"JATI PADANG, PASAR MINGGU, JAKARTA SELATAN, DKI JAKARTA",11,151,86,237
https://kawalpemilu.org#26015,"JATI PADANG, PASAR MINGGU, JAKARTA SELATAN, DKI JAKARTA",12,100,139,239
https://kawalpemilu.org#26015,"JATI PADANG, PASAR MINGGU, JAKARTA SELATAN, DKI JAKARTA",13,66,139,205
https://kawalpemilu.org#26015,"JATI PADANG, PASAR MINGGU, JAKARTA SELATAN, DKI JAKARTA",14,100,105,205
https://kawalpemilu.org#26015,"JATI PADANG, PASAR MINGGU, JAKARTA SELATAN, DKI JAKARTA",15,89,159,248
https://kawalpemilu.org#26015,"JATI PADANG, PASAR MINGGU, JAKARTA SELATAN, DKI JAKARTA",16,116,103,219
https://kawalpemilu.org#26015,"JATI PADANG, PASAR MINGGU, JAKARTA SELATAN, DKI JAKARTA",17,54,150,204
https://kawalpemilu.org#26015,"JATI PADANG, PASAR MINGGU, JAKARTA SELATAN, DKI JAKARTA",18,84,130,214
https://kawalpemilu.org#26015,"JATI PADANG, PASAR MINGGU, JAKARTA SELATAN, DKI JAKARTA",19,88,130,218
https://kawalpemilu.org#26015,"JATI PADANG, PASAR MINGGU, JAKARTA SELATAN, DKI JAKARTA",20,86,138,224
https://kawalpemilu.org#26015,"JATI PADANG, PASAR MINGGU, JAKARTA SELATAN, DKI JAKARTA",21,100,142,242
https://kawalpemilu.org#26015,"JATI PADANG, PASAR MINGGU, JAKARTA SELATAN, DKI JAKARTA",22,105,139,244
https://kawalpemilu.org#26015,"JATI PADANG, PASAR MINGGU, JAKARTA SELATAN, DKI JAKARTA",23,95,156,251
https://kawalpemilu.org#26015,"JATI PADANG, PASAR MINGGU, JAKARTA SELATAN, DKI JAKARTA",24,98,163,261
https://kawalpemilu.org#26015,"JATI PADANG, PASAR MINGGU, JAKARTA SELATAN, DKI JAKARTA",25,55,144,199
https://kawalpemilu.org#26015,"JATI PADANG, PASAR MINGGU, JAKARTA SELATAN, DKI JAKARTA",26,50,145,195
https://kawalpemilu.org#26015,"JATI PADANG, PASAR MINGGU, JAKARTA SELATAN, DKI JAKARTA",27,123,110,233
https://kawalpemilu.org#26015,"JATI PADANG, PASAR MINGGU, JAKARTA SELATAN, DKI JAKARTA",28,135,99,234
https://kawalpemilu.org#26015,"JATI PADANG, PASAR MINGGU, JAKARTA SELATAN, DKI JAKARTA",29,171,86,257
https://kawalpemilu.org#26015,"JATI PADANG, PASAR MINGGU, JAKARTA SELATAN, DKI JAKARTA",30,142,112,254
https://kawalpemilu.org#26015,"JATI PADANG, PASAR MINGGU, JAKARTA SELATAN, DKI JAKARTA",31,122,126,248
https://kawalpemilu.org#26015,"JATI PADANG, PASAR MINGGU, JAKARTA SELATAN, DKI JAKARTA",32,133,123,256
https://kawalpemilu.org#26015,"JATI PADANG, PASAR MINGGU, JAKARTA SELATAN, DKI JAKARTA",33,104,108,212
https://kawalpemilu.org#26015,"JATI PADANG, PASAR MINGGU, JAKARTA SELATAN, DKI JAKARTA",34,99,154,253
https://kawalpemilu.org#26015,"JATI PADANG, PASAR MINGGU, JAKARTA SELATAN, DKI JAKARTA",35,93,126,219
https://kawalpemilu.org#26015,"JATI PADANG, PASAR MINGGU, JAKARTA SELATAN, DKI JAKARTA",36,149,80,229
https://kawalpemilu.org#26015,"JATI PADANG, PASAR MINGGU, JAKARTA SELATAN, DKI JAKARTA",37,123,111,234
https://kawalpemilu.org#26015,"JATI PADANG, PASAR MINGGU, JAKARTA SELATAN, DKI JAKARTA",38,117,104,221
https://kawalpemilu.org#26015,"JATI PADANG, PASAR MINGGU, JAKARTA SELATAN, DKI JAKARTA",39,137,79,216
https://kawalpemilu.org#26015,"JATI PADANG, PASAR MINGGU, JAKARTA SELATAN, DKI JAKARTA",40,126,89,215
https://kawalpemilu.org#26015,"JATI PADANG, PASAR MINGGU, JAKARTA SELATAN, DKI JAKARTA",41,109,130,239
https://kawalpemilu.org#26015,"JATI PADANG, PASAR MINGGU, JAKARTA SELATAN, DKI JAKARTA",42,79,173,252
https://kawalpemilu.org#26015,"JATI PADANG, PASAR MINGGU, JAKARTA SELATAN, DKI JAKARTA",43,55,166,221
https://kawalpemilu.org#26015,"JATI PADANG, PASAR MINGGU, JAKARTA SELATAN, DKI JAKARTA",44,71,132,203
https://kawalpemilu.org#26015,"JATI PADANG, PASAR MINGGU, JAKARTA SELATAN, DKI JAKARTA",45,63,144,207
https://kawalpemilu.org#26015,"JATI PADANG, PASAR MINGGU, JAKARTA SELATAN, DKI JAKARTA",46,64,126,190
https://kawalpemilu.org#26015,"JATI PADANG, PASAR MINGGU, JAKARTA SELATAN, DKI JAKARTA",47,107,113,220
https://kawalpemilu.org#26015,"JATI PADANG, PASAR MINGGU, JAKARTA SELATAN, DKI JAKARTA",48,98,94,192
https://kawalpemilu.org#26015,"JATI PADANG, PASAR MINGGU, JAKARTA SELATAN, DKI JAKARTA",49,92,119,211
https://kawalpemilu.org#26015,"JATI PADANG, PASAR MINGGU, JAKARTA SELATAN, DKI JAKARTA",50,121,145,266
https://kawalpemilu.org#26015,"JATI PADANG, PASAR MINGGU, JAKARTA SELATAN, DKI JAKARTA",51,123,133,256
https://kawalpemilu.org#26015,"JATI PADANG, PASAR MINGGU, JAKARTA SELATAN, DKI JAKARTA",52,95,113,208
https://kawalpemilu.org#26015,"JATI PADANG, PASAR MINGGU, JAKARTA SELATAN, DKI JAKARTA",53,124,121,245
https://kawalpemilu.org#26015,"JATI PADANG, PASAR MINGGU, JAKARTA SELATAN, DKI JAKARTA",54,132,96,228
https://kawalpemilu.org#26015,"JATI PADANG, PASAR MINGGU, JAKARTA SELATAN, DKI JAKARTA",56,119,105,224
https://kawalpemilu.org#26015,"JATI PADANG, PASAR MINGGU, JAKARTA SELATAN, DKI JAKARTA",57,144,106,250
https://kawalpemilu.org#26015,"JATI PADANG, PASAR MINGGU, JAKARTA SELATAN, DKI JAKARTA",58,120,133,253
https://kawalpemilu.org#26015,"JATI PADANG, PASAR MINGGU, JAKARTA SELATAN, DKI JAKARTA",59,120,117,237
https://kawalpemilu.org#26015,"JATI PADANG, PASAR MINGGU, JAKARTA SELATAN, DKI JAKARTA",60,144,89,233
https://kawalpemilu.org#26015,"JATI PADANG, PASAR MINGGU, JAKARTA SELATAN, DKI JAKARTA",61,119,89,208
https://kawalpemilu.org#26015,"JATI PADANG, PASAR MINGGU, JAKARTA SELATAN, DKI JAKARTA",62,114,132,246
https://kawalpemilu.org#26015,"JATI PADANG, PASAR MINGGU, JAKARTA SELATAN, DKI JAKARTA",63,107,130,237
https://kawalpemilu.org#26015,"JATI PADANG, PASAR MINGGU, JAKARTA SELATAN, DKI JAKARTA",64,111,150,262
https://kawalpemilu.org#26015,"JATI PADANG, PASAR MINGGU, JAKARTA SELATAN, DKI JAKARTA",65,118,148,266
https://kawalpemilu.org#26015,"JATI PADANG, PASAR MINGGU, JAKARTA SELATAN, DKI JAKARTA",66,95,152,247
https://kawalpemilu.org#26015,"JATI PADANG, PASAR MINGGU, JAKARTA SELATAN, DKI JAKARTA",67,83,172,255
https://kawalpemilu.org#26015,"JATI PADANG, PASAR MINGGU, JAKARTA SELATAN, DKI JAKARTA",68,108,171,279
https://kawalpemilu.org#26015,"JATI PADANG, PASAR MINGGU, JAKARTA SELATAN, DKI JAKARTA",69,95,136,231
https://kawalpemilu.org#26015,"JATI PADANG, PASAR MINGGU, JAKARTA SELATAN, DKI JAKARTA",70,89,163,252
https://kawalpemilu.org#26015,"JATI PADANG, PASAR MINGGU, JAKARTA SELATAN, DKI JAKARTA",71,90,159,249
https://kawalpemilu.org#26015,"JATI PADANG, PASAR MINGGU, JAKARTA SELATAN, DKI JAKARTA",72,77,170,247
https://kawalpemilu.org#26015,"JATI PADANG, PASAR MINGGU, JAKARTA SELATAN, DKI JAKARTA",73,71,154,225
https://kawalpemilu.org#26015,"JATI PADANG, PASAR MINGGU, JAKARTA SELATAN, DKI JAKARTA",74,82,165,247
https://kawalpemilu.org#26015,"JATI PADANG, PASAR MINGGU, JAKARTA SELATAN, DKI JAKARTA",75,126,139,265
https://kawalpemilu.org#26015,"JATI PADANG, PASAR MINGGU, JAKARTA SELATAN, DKI JAKARTA",76,94,181,275
https://kawalpemilu.org#26015,"JATI PADANG, PASAR MINGGU, JAKARTA SELATAN, DKI JAKARTA",77,97,141,238
https://kawalpemilu.org#26015,"JATI PADANG, PASAR MINGGU, JAKARTA SELATAN, DKI JAKARTA",78,94,143,237
https://kawalpemilu.org#26015,"JATI PADANG, PASAR MINGGU, JAKARTA SELATAN, DKI JAKARTA",79,87,137,224
https://kawalpemilu.org#26015,"JATI PADANG, PASAR MINGGU, JAKARTA SELATAN, DKI JAKARTA",80,115,154,269
https://kawalpemilu.org#26015,"JATI PADANG, PASAR MINGGU, JAKARTA SELATAN, DKI JAKARTA",81,105,148,253
https://kawalpemilu.org#26015,"JATI PADANG, PASAR MINGGU, JAKARTA SELATAN, DKI JAKARTA",82,84,141,225
https://kawalpemilu.org#26015,"JATI PADANG, PASAR MINGGU, JAKARTA SELATAN, DKI JAKARTA",83,116,104,220
https://kawalpemilu.org#26015,"JATI PADANG, PASAR MINGGU, JAKARTA SELATAN, DKI JAKARTA",84,103,95,198
https://kawalpemilu.org#26015,"JATI PADANG, PASAR MINGGU, JAKARTA SELATAN, DKI JAKARTA",85,106,130,236
https://kawalpemilu.org#26015,"JATI PADANG, PASAR MINGGU, JAKARTA SELATAN, DKI JAKARTA",86,89,122,211
https://kawalpemilu.org#26015,"JATI PADANG, PASAR MINGGU, JAKARTA SELATAN, DKI JAKARTA",87,108,130,238
https://kawalpemilu.org#26015,"JATI PADANG, PASAR MINGGU, JAKARTA SELATAN, DKI JAKARTA",88,156,95,251
https://kawalpemilu.org#26015,"JATI PADANG, PASAR MINGGU, JAKARTA SELATAN, DKI JAKARTA",89,116,92,208
https://kawalpemilu.org#26015,"JATI PADANG, PASAR MINGGU, JAKARTA SELATAN, DKI JAKARTA",90,174,79,253
https://kawalpemilu.org#26015,"JATI PADANG, PASAR MINGGU, JAKARTA SELATAN, DKI JAKARTA",91,161,104,265
https://kawalpemilu.org#26015,"JATI PADANG, PASAR MINGGU, JAKARTA SELATAN, DKI JAKARTA",92,79,152,231
https://kawalpemilu.org#26015,"JATI PADANG, PASAR MINGGU, JAKARTA SELATAN, DKI JAKARTA",93,93,112,205
https://kawalpemilu.org#26015,"JATI PADANG, PASAR MINGGU, JAKARTA SELATAN, DKI JAKARTA",94,116,118,234
https://kawalpemilu.org#26015,"JATI PADANG, PASAR MINGGU, JAKARTA SELATAN, DKI JAKARTA",95,96,147,243
https://kawalpemilu.org#26015,"JATI PADANG, PASAR MINGGU, JAKARTA SELATAN, DKI JAKARTA",96,102,123,225
https://kawalpemilu.org#26015,"JATI PADANG, PASAR MINGGU, JAKARTA SELATAN, DKI JAKARTA",97,77,168,245
https://kawalpemilu.org#26015,"JATI PADANG, PASAR MINGGU, JAKARTA SELATAN, DKI JAKARTA",98,104,137,241
https://kawalpemilu.org#26015,"JATI PADANG, PASAR MINGGU, JAKARTA SELATAN, DKI JAKARTA",99,82,140,222
https://kawalpemilu.org#26015,"JATI PADANG, PASAR MINGGU, JAKARTA SELATAN, DKI JAKARTA",100,123,126,249
https://kawalpemilu.org#26015,"JATI PADANG, PASAR MINGGU, JAKARTA SELATAN, DKI JAKARTA",101,117,93,210
https://kawalpemilu.org#26015,"JATI PADANG, PASAR MINGGU, JAKARTA SELATAN, DKI JAKARTA",102,98,143,241
https://kawalpemilu.org#26015,"JATI PADANG, PASAR MINGGU, JAKARTA SELATAN, DKI JAKARTA",103,93,132,225
https://kawalpemilu.org#26015,"JATI PADANG, PASAR MINGGU, JAKARTA SELATAN, DKI JAKARTA",104,95,127,222
https://kawalpemilu.org#26015,"JATI PADANG, PASAR MINGGU, JAKARTA SELATAN, DKI JAKARTA",105,100,141,241
https://kawalpemilu.org#26015,"JATI PADANG, PASAR MINGGU, JAKARTA SELATAN, DKI JAKARTA",106,148,92,240
https://kawalpemilu.org#26015,"JATI PADANG, PASAR MINGGU, JAKARTA SELATAN, DKI JAKARTA",107,102,121,223
https://kawalpemilu.org#26015,"JATI PADANG, PASAR MINGGU, JAKARTA SELATAN, DKI JAKARTA",108,96,151,247
https://kawalpemilu.org#26015,"JATI PADANG, PASAR MINGGU, JAKARTA SELATAN, DKI JAKARTA",109,76,133,209
https://kawalpemilu.org#26015,"JATI PADANG, PASAR MINGGU, JAKARTA SELATAN, DKI JAKARTA",110,78,153,231
https://kawalpemilu.org#26015,"JATI PADANG, PASAR MINGGU, JAKARTA SELATAN, DKI JAKARTA",111,93,111,204
https://kawalpemilu.org#26015,"JATI PADANG, PASAR MINGGU, JAKARTA SELATAN, DKI JAKARTA",112,105,117,222
https://kawalpemilu.org#26015,"JATI PADANG, PASAR MINGGU, JAKARTA SELATAN, DKI JAKARTA",113,80,138,218
https://kawalpemilu.org#26015,"JATI PADANG, PASAR MINGGU, JAKARTA SELATAN, DKI JAKARTA",114,124,118,242
https://kawalpemilu.org#26015,"JATI PADANG, PASAR MINGGU, JAKARTA SELATAN, DKI JAKARTA",115,100,109,209
https://kawalpemilu.org#26015,"JATI PADANG, PASAR MINGGU, JAKARTA SELATAN, DKI JAKARTA",116,106,152,258
https://kawalpemilu.org#26015,"JATI PADANG, PASAR MINGGU, JAKARTA SELATAN, DKI JAKARTA",117,73,144,217
https://kawalpemilu.org#26015,"JATI PADANG, PASAR MINGGU, JAKARTA SELATAN, DKI JAKARTA",118,115,93,208
https://kawalpemilu.org#26015,"JATI PADANG, PASAR MINGGU, JAKARTA SELATAN, DKI JAKARTA",119,122,107,229
https://kawalpemilu.org#26015,"JATI PADANG, PASAR MINGGU, JAKARTA SELATAN, DKI JAKARTA",120,111,137,248
https://kawalpemilu.org#26015,"JATI PADANG, PASAR MINGGU, JAKARTA SELATAN, DKI JAKARTA",121,112,119,231
https://kawalpemilu.org#26015,"JATI PADANG, PASAR MINGGU, JAKARTA SELATAN, DKI JAKARTA",122,79,169,248
https://kawalpemilu.org#26015,"JATI PADANG, PASAR MINGGU, JAKARTA SELATAN, DKI JAKARTA",123,57,110,167
https://kawalpemilu.org#26016,"CILANDAK TIMUR, PASAR MINGGU, JAKARTA SELATAN, DKI JAKARTA",1,109,94,203
https://kawalpemilu.org#26016,"CILANDAK TIMUR, PASAR MINGGU, JAKARTA SELATAN, DKI JAKARTA",3,137,108,245
https://kawalpemilu.org#26016,"CILANDAK TIMUR, PASAR MINGGU, JAKARTA SELATAN, DKI JAKARTA",4,103,69,172
https://kawalpemilu.org#26016,"CILANDAK TIMUR, PASAR MINGGU, JAKARTA SELATAN, DKI JAKARTA",5,79,94,173
https://kawalpemilu.org#26016,"CILANDAK TIMUR, PASAR MINGGU, JAKARTA SELATAN, DKI JAKARTA",6,128,132,260
https://kawalpemilu.org#26016,"CILANDAK TIMUR, PASAR MINGGU, JAKARTA SELATAN, DKI JAKARTA",7,109,94,203
https://kawalpemilu.org#26016,"CILANDAK TIMUR, PASAR MINGGU, JAKARTA SELATAN, DKI JAKARTA",8,160,62,222
https://kawalpemilu.org#26016,"CILANDAK TIMUR, PASAR MINGGU, JAKARTA SELATAN, DKI JAKARTA",9,128,86,214
https://kawalpemilu.org#26016,"CILANDAK TIMUR, PASAR MINGGU, JAKARTA SELATAN, DKI JAKARTA",10,129,120,249
https://kawalpemilu.org#26016,"CILANDAK TIMUR, PASAR MINGGU, JAKARTA SELATAN, DKI JAKARTA",11,121,131,252
https://kawalpemilu.org#26016,"CILANDAK TIMUR, PASAR MINGGU, JAKARTA SELATAN, DKI JAKARTA",12,127,85,212
https://kawalpemilu.org#26016,"CILANDAK TIMUR, PASAR MINGGU, JAKARTA SELATAN, DKI JAKARTA",14,112,90,202
https://kawalpemilu.org#26016,"CILANDAK TIMUR, PASAR MINGGU, JAKARTA SELATAN, DKI JAKARTA",18,84,91,175
https://kawalpemilu.org#26016,"CILANDAK TIMUR, PASAR MINGGU, JAKARTA SELATAN, DKI JAKARTA",21,89,86,175
https://kawalpemilu.org#26016,"CILANDAK TIMUR, PASAR MINGGU, JAKARTA SELATAN, DKI JAKARTA",22,103,132,235
https://kawalpemilu.org#26016,"CILANDAK TIMUR, PASAR MINGGU, JAKARTA SELATAN, DKI JAKARTA",23,121,102,223
https://kawalpemilu.org#26016,"CILANDAK TIMUR, PASAR MINGGU, JAKARTA SELATAN, DKI JAKARTA",24,136,91,227
https://kawalpemilu.org#26016,"CILANDAK TIMUR, PASAR MINGGU, JAKARTA SELATAN, DKI JAKARTA",25,100,84,184
https://kawalpemilu.org#26016,"CILANDAK TIMUR, PASAR MINGGU, JAKARTA SELATAN, DKI JAKARTA",26,108,102,210
https://kawalpemilu.org#26016,"CILANDAK TIMUR, PASAR MINGGU, JAKARTA SELATAN, DKI JAKARTA",28,95,107,202
https://kawalpemilu.org#26016,"CILANDAK TIMUR, PASAR MINGGU, JAKARTA SELATAN, DKI JAKARTA",29,96,84,180
https://kawalpemilu.org#26016,"CILANDAK TIMUR, PASAR MINGGU, JAKARTA SELATAN, DKI JAKARTA",30,102,60,162
https://kawalpemilu.org#26016,"CILANDAK TIMUR, PASAR MINGGU, JAKARTA SELATAN, DKI JAKARTA",31,114,45,159
https://kawalpemilu.org#26016,"CILANDAK TIMUR, PASAR MINGGU, JAKARTA SELATAN, DKI JAKARTA",32,128,100,228
https://kawalpemilu.org#26016,"CILANDAK TIMUR, PASAR MINGGU, JAKARTA SELATAN, DKI JAKARTA",34,113,87,200
https://kawalpemilu.org#26016,"CILANDAK TIMUR, PASAR MINGGU, JAKARTA SELATAN, DKI JAKARTA",35,81,101,182
https://kawalpemilu.org#26016,"CILANDAK TIMUR, PASAR MINGGU, JAKARTA SELATAN, DKI JAKARTA",38,102,134,236
https://kawalpemilu.org#26016,"CILANDAK TIMUR, PASAR MINGGU, JAKARTA SELATAN, DKI JAKARTA",39,117,122,239
https://kawalpemilu.org#26016,"CILANDAK TIMUR, PASAR MINGGU, JAKARTA SELATAN, DKI JAKARTA",42,115,100,215
https://kawalpemilu.org#26016,"CILANDAK TIMUR, PASAR MINGGU, JAKARTA SELATAN, DKI JAKARTA",44,111,136,247
https://kawalpemilu.org#26016,"CILANDAK TIMUR, PASAR MINGGU, JAKARTA SELATAN, DKI JAKARTA",45,86,157,243
https://kawalpemilu.org#26016,"CILANDAK TIMUR, PASAR MINGGU, JAKARTA SELATAN, DKI JAKARTA",47,63,156,219
https://kawalpemilu.org#26016,"CILANDAK TIMUR, PASAR MINGGU, JAKARTA SELATAN, DKI JAKARTA",48,86,93,179
https://kawalpemilu.org#26016,"CILANDAK TIMUR, PASAR MINGGU, JAKARTA SELATAN, DKI JAKARTA",49,79,119,198
https://kawalpemilu.org#26016,"CILANDAK TIMUR, PASAR MINGGU, JAKARTA SELATAN, DKI JAKARTA",50,117,85,202
https://kawalpemilu.org#26016,"CILANDAK TIMUR, PASAR MINGGU, JAKARTA SELATAN, DKI JAKARTA",51,110,110,220
https://kawalpemilu.org#26016,"CILANDAK TIMUR, PASAR MINGGU, JAKARTA SELATAN, DKI JAKARTA",52,90,158,248
https://kawalpemilu.org#26016,"CILANDAK TIMUR, PASAR MINGGU, JAKARTA SELATAN, DKI JAKARTA",53,109,135,244
https://kawalpemilu.org#26016,"CILANDAK TIMUR, PASAR MINGGU, JAKARTA SELATAN, DKI JAKARTA",54,102,105,207
https://kawalpemilu.org#26016,"CILANDAK TIMUR, PASAR MINGGU, JAKARTA SELATAN, DKI JAKARTA",55,107,134,241
https://kawalpemilu.org#26016,"CILANDAK TIMUR, PASAR MINGGU, JAKARTA SELATAN, DKI JAKARTA",56,74,148,222
https://kawalpemilu.org#26016,"CILANDAK TIMUR, PASAR MINGGU, JAKARTA SELATAN, DKI JAKARTA",57,83,137,220
https://kawalpemilu.org#26016,"CILANDAK TIMUR, PASAR MINGGU, JAKARTA SELATAN, DKI JAKARTA",60,106,96,202
https://kawalpemilu.org#26016,"CILANDAK TIMUR, PASAR MINGGU, JAKARTA SELATAN, DKI JAKARTA",62,108,84,192
https://kawalpemilu.org#26016,"CILANDAK TIMUR, PASAR MINGGU, JAKARTA SELATAN, DKI JAKARTA",64,93,110,203
https://kawalpemilu.org#26016,"CILANDAK TIMUR, PASAR MINGGU, JAKARTA SELATAN, DKI JAKARTA",66,104,88,192
https://kawalpemilu.org#26016,"CILANDAK TIMUR, PASAR MINGGU, JAKARTA SELATAN, DKI JAKARTA",67,100,89,189
https://kawalpemilu.org#26016,"CILANDAK TIMUR, PASAR MINGGU, JAKARTA SELATAN, DKI JAKARTA",68,36,60,96
https://kawalpemilu.org#26016,"CILANDAK TIMUR, PASAR MINGGU, JAKARTA SELATAN, DKI JAKARTA",69,129,83,212
https://kawalpemilu.org#26016,"CILANDAK TIMUR, PASAR MINGGU, JAKARTA SELATAN, DKI JAKARTA",70,117,75,192
https://kawalpemilu.org#26016,"CILANDAK TIMUR, PASAR MINGGU, JAKARTA SELATAN, DKI JAKARTA",71,117,110,227
https://kawalpemilu.org#26016,"CILANDAK TIMUR, PASAR MINGGU, JAKARTA SELATAN, DKI JAKARTA",72,73,134,207
https://kawalpemilu.org#26016,"CILANDAK TIMUR, PASAR MINGGU, JAKARTA SELATAN, DKI JAKARTA",73,138,121,259
https://kawalpemilu.org#26016,"CILANDAK TIMUR, PASAR MINGGU, JAKARTA SELATAN, DKI JAKARTA",74,106,67,173
https://kawalpemilu.org#26016,"CILANDAK TIMUR, PASAR MINGGU, JAKARTA SELATAN, DKI JAKARTA",75,41,79,120
https://kawalpemilu.org#26016,"CILANDAK TIMUR, PASAR MINGGU, JAKARTA SELATAN, DKI JAKARTA",77,55,30,85
https://kawalpemilu.org#26016,"CILANDAK TIMUR, PASAR MINGGU, JAKARTA SELATAN, DKI JAKARTA",78,54,62,116
https://kawalpemilu.org#26016,"CILANDAK TIMUR, PASAR MINGGU, JAKARTA SELATAN, DKI JAKARTA",80,50,72,122
https://kawalpemilu.org#26016,"CILANDAK TIMUR, PASAR MINGGU, JAKARTA SELATAN, DKI JAKARTA",81,77,47,124
https://kawalpemilu.org#26016,"CILANDAK TIMUR, PASAR MINGGU, JAKARTA SELATAN, DKI JAKARTA",83,21,38,59
https://kawalpemilu.org#26017,"RAGUNAN, PASAR MINGGU, JAKARTA SELATAN, DKI JAKARTA",1,111,70,181
https://kawalpemilu.org#26017,"RAGUNAN, PASAR MINGGU, JAKARTA SELATAN, DKI JAKARTA",2,117,107,224
https://kawalpemilu.org#26017,"RAGUNAN, PASAR MINGGU, JAKARTA SELATAN, DKI JAKARTA",3,133,88,221
https://kawalpemilu.org#26017,"RAGUNAN, PASAR MINGGU, JAKARTA SELATAN, DKI JAKARTA",4,129,120,249
https://kawalpemilu.org#26017,"RAGUNAN, PASAR MINGGU, JAKARTA SELATAN, DKI JAKARTA",6,144,81,225
https://kawalpemilu.org#26017,"RAGUNAN, PASAR MINGGU, JAKARTA SELATAN, DKI JAKARTA",8,112,129,241
https://kawalpemilu.org#26017,"RAGUNAN, PASAR MINGGU, JAKARTA SELATAN, DKI JAKARTA",9,105,105,210
https://kawalpemilu.org#26017,"RAGUNAN, PASAR MINGGU, JAKARTA SELATAN, DKI JAKARTA",10,93,141,234
https://kawalpemilu.org#26017,"RAGUNAN, PASAR MINGGU, JAKARTA SELATAN, DKI JAKARTA",11,113,118,231
https://kawalpemilu.org#26017,"RAGUNAN, PASAR MINGGU, JAKARTA SELATAN, DKI JAKARTA",12,59,59,118
https://kawalpemilu.org#26017,"RAGUNAN, PASAR MINGGU, JAKARTA SELATAN, DKI JAKARTA",13,93,117,6
https://kawalpemilu.org#26017,"RAGUNAN, PASAR MINGGU, JAKARTA SELATAN, DKI JAKARTA",14,120,121,241
https://kawalpemilu.org#26017,"RAGUNAN, PASAR MINGGU, JAKARTA SELATAN, DKI JAKARTA",15,99,125,224
https://kawalpemilu.org#26017,"RAGUNAN, PASAR MINGGU, JAKARTA SELATAN, DKI JAKARTA",16,100,99,199
https://kawalpemilu.org#26017,"RAGUNAN, PASAR MINGGU, JAKARTA SELATAN, DKI JAKARTA",17,134,97,231
https://kawalpemilu.org#26017,"RAGUNAN, PASAR MINGGU, JAKARTA SELATAN, DKI JAKARTA",18,110,121,231
https://kawalpemilu.org#26017,"RAGUNAN, PASAR MINGGU, JAKARTA SELATAN, DKI JAKARTA",19,79,66,145
https://kawalpemilu.org#26017,"RAGUNAN, PASAR MINGGU, JAKARTA SELATAN, DKI JAKARTA",20,113,113,226
https://kawalpemilu.org#26017,"RAGUNAN, PASAR MINGGU, JAKARTA SELATAN, DKI JAKARTA",21,172,45,217
https://kawalpemilu.org#26017,"RAGUNAN, PASAR MINGGU, JAKARTA SELATAN, DKI JAKARTA",22,182,61,243
https://kawalpemilu.org#26017,"RAGUNAN, PASAR MINGGU, JAKARTA SELATAN, DKI JAKARTA",23,150,114,264
https://kawalpemilu.org#26017,"RAGUNAN, PASAR MINGGU, JAKARTA SELATAN, DKI JAKARTA",24,122,122,244
https://kawalpemilu.org#26017,"RAGUNAN, PASAR MINGGU, JAKARTA SELATAN, DKI JAKARTA",25,121,115,236
https://kawalpemilu.org#26017,"RAGUNAN, PASAR MINGGU, JAKARTA SELATAN, DKI JAKARTA",26,85,96,181
https://kawalpemilu.org#26017,"RAGUNAN, PASAR MINGGU, JAKARTA SELATAN, DKI JAKARTA",27,109,122,231
https://kawalpemilu.org#26017,"RAGUNAN, PASAR MINGGU, JAKARTA SELATAN, DKI JAKARTA",28,98,127,225
https://kawalpemilu.org#26017,"RAGUNAN, PASAR MINGGU, JAKARTA SELATAN, DKI JAKARTA",30,110,56,166
https://kawalpemilu.org#26017,"RAGUNAN, PASAR MINGGU, JAKARTA SELATAN, DKI JAKARTA",31,109,62,171
https://kawalpemilu.org#26017,"RAGUNAN, PASAR MINGGU, JAKARTA SELATAN, DKI JAKARTA",33,101,114,215
https://kawalpemilu.org#26017,"RAGUNAN, PASAR MINGGU, JAKARTA SELATAN, DKI JAKARTA",34,95,123,220
https://kawalpemilu.org#26017,"RAGUNAN, PASAR MINGGU, JAKARTA SELATAN, DKI JAKARTA",35,92,117,209
https://kawalpemilu.org#26017,"RAGUNAN, PASAR MINGGU, JAKARTA SELATAN, DKI JAKARTA",36,102,128,230
https://kawalpemilu.org#26017,"RAGUNAN, PASAR MINGGU, JAKARTA SELATAN, DKI JAKARTA",37,103,113,216
https://kawalpemilu.org#26017,"RAGUNAN, PASAR MINGGU, JAKARTA SELATAN, DKI JAKARTA",38,114,127,241
https://kawalpemilu.org#26017,"RAGUNAN, PASAR MINGGU, JAKARTA SELATAN, DKI JAKARTA",39,124,85,209
https://kawalpemilu.org#26017,"RAGUNAN, PASAR MINGGU, JAKARTA SELATAN, DKI JAKARTA",40,139,90,229
https://kawalpemilu.org#26017,"RAGUNAN, PASAR MINGGU, JAKARTA SELATAN, DKI JAKARTA",42,137,114,251
https://kawalpemilu.org#26017,"RAGUNAN, PASAR MINGGU, JAKARTA SELATAN, DKI JAKARTA",43,93,113,206
https://kawalpemilu.org#26017,"RAGUNAN, PASAR MINGGU, JAKARTA SELATAN, DKI JAKARTA",44,113,144,257
https://kawalpemilu.org#26017,"RAGUNAN, PASAR MINGGU, JAKARTA SELATAN, DKI JAKARTA",45,97,119,216
https://kawalpemilu.org#26017,"RAGUNAN, PASAR MINGGU, JAKARTA SELATAN, DKI JAKARTA",46,56,75,131
https://kawalpemilu.org#26017,"RAGUNAN, PASAR MINGGU, JAKARTA SELATAN, DKI JAKARTA",47,79,75,154
https://kawalpemilu.org#26017,"RAGUNAN, PASAR MINGGU, JAKARTA SELATAN, DKI JAKARTA",49,120,76,196
https://kawalpemilu.org#26017,"RAGUNAN, PASAR MINGGU, JAKARTA SELATAN, DKI JAKARTA",50,65,55,120
https://kawalpemilu.org#26017,"RAGUNAN, PASAR MINGGU, JAKARTA SELATAN, DKI JAKARTA",52,99,115,214
https://kawalpemilu.org#26017,"RAGUNAN, PASAR MINGGU, JAKARTA SELATAN, DKI JAKARTA",53,117,93,210
https://kawalpemilu.org#26017,"RAGUNAN, PASAR MINGGU, JAKARTA SELATAN, DKI JAKARTA",54,125,117,242
https://kawalpemilu.org#26017,"RAGUNAN, PASAR MINGGU, JAKARTA SELATAN, DKI JAKARTA",55,111,109,220
https://kawalpemilu.org#26017,"RAGUNAN, PASAR MINGGU, JAKARTA SELATAN, DKI JAKARTA",56,147,78,225
https://kawalpemilu.org#26017,"RAGUNAN, PASAR MINGGU, JAKARTA SELATAN, DKI JAKARTA",57,113,78,191
https://kawalpemilu.org#26017,"RAGUNAN, PASAR MINGGU, JAKARTA SELATAN, DKI JAKARTA",59,146,61,207
https://kawalpemilu.org#26017,"RAGUNAN, PASAR MINGGU, JAKARTA SELATAN, DKI JAKARTA",60,139,86,225
https://kawalpemilu.org#26017,"RAGUNAN, PASAR MINGGU, JAKARTA SELATAN, DKI JAKARTA",63,149,91,240
https://kawalpemilu.org#26017,"RAGUNAN, PASAR MINGGU, JAKARTA SELATAN, DKI JAKARTA",70,169,55,224
https://kawalpemilu.org#26017,"RAGUNAN, PASAR MINGGU, JAKARTA SELATAN, DKI JAKARTA",72,121,107,228
https://kawalpemilu.org#26017,"RAGUNAN, PASAR MINGGU, JAKARTA SELATAN, DKI JAKARTA",73,56,62,118
https://kawalpemilu.org#26017,"RAGUNAN, PASAR MINGGU, JAKARTA SELATAN, DKI JAKARTA",74,125,56,181
https://kawalpemilu.org#26017,"RAGUNAN, PASAR MINGGU, JAKARTA SELATAN, DKI JAKARTA",75,105,76,181
https://kawalpemilu.org#26017,"RAGUNAN, PASAR MINGGU, JAKARTA SELATAN, DKI JAKARTA",76,130,84,214
https://kawalpemilu.org#26017,"RAGUNAN, PASAR MINGGU, JAKARTA SELATAN, DKI JAKARTA",77,119,64,183
https://kawalpemilu.org#26017,"RAGUNAN, PASAR MINGGU, JAKARTA SELATAN, DKI JAKARTA",78,127,59,186
https://kawalpemilu.org#26017,"RAGUNAN, PASAR MINGGU, JAKARTA SELATAN, DKI JAKARTA",79,112,91,203
https://kawalpemilu.org#26017,"RAGUNAN, PASAR MINGGU, JAKARTA SELATAN, DKI JAKARTA",80,91,63,154
https://kawalpemilu.org#26017,"RAGUNAN, PASAR MINGGU, JAKARTA SELATAN, DKI JAKARTA",81,111,150,261
https://kawalpemilu.org#26017,"RAGUNAN, PASAR MINGGU, JAKARTA SELATAN, DKI JAKARTA",82,88,156,244
https://kawalpemilu.org#26017,"RAGUNAN, PASAR MINGGU, JAKARTA SELATAN, DKI JAKARTA",83,105,140,245
https://kawalpemilu.org#26017,"RAGUNAN, PASAR MINGGU, JAKARTA SELATAN, DKI JAKARTA",84,102,133,235
https://kawalpemilu.org#26017,"RAGUNAN, PASAR MINGGU, JAKARTA SELATAN, DKI JAKARTA",85,90,108,198
https://kawalpemilu.org#26017,"RAGUNAN, PASAR MINGGU, JAKARTA SELATAN, DKI JAKARTA",86,122,113,235
https://kawalpemilu.org#26017,"RAGUNAN, PASAR MINGGU, JAKARTA SELATAN, DKI JAKARTA",87,136,107,243
https://kawalpemilu.org#26017,"RAGUNAN, PASAR MINGGU, JAKARTA SELATAN, DKI JAKARTA",88,121,126,247
https://kawalpemilu.org#26017,"RAGUNAN, PASAR MINGGU, JAKARTA SELATAN, DKI JAKARTA",89,141,113,254
https://kawalpemilu.org#26017,"RAGUNAN, PASAR MINGGU, JAKARTA SELATAN, DKI JAKARTA",90,102,89,191
https://kawalpemilu.org#26017,"RAGUNAN, PASAR MINGGU, JAKARTA SELATAN, DKI JAKARTA",91,60,68,128
https://kawalpemilu.org#26017,"RAGUNAN, PASAR MINGGU, JAKARTA SELATAN, DKI JAKARTA",92,95,69,164
https://kawalpemilu.org#26017,"RAGUNAN, PASAR MINGGU, JAKARTA SELATAN, DKI JAKARTA",93,138,42,180
https://kawalpemilu.org#26017,"RAGUNAN, PASAR MINGGU, JAKARTA SELATAN, DKI JAKARTA",94,152,86,238
https://kawalpemilu.org#26017,"RAGUNAN, PASAR MINGGU, JAKARTA SELATAN, DKI JAKARTA",95,123,107,230
https://kawalpemilu.org#26017,"RAGUNAN, PASAR MINGGU, JAKARTA SELATAN, DKI JAKARTA",96,140,123,263
https://kawalpemilu.org#26017,"RAGUNAN, PASAR MINGGU, JAKARTA SELATAN, DKI JAKARTA",97,171,89,260
https://kawalpemilu.org#26017,"RAGUNAN, PASAR MINGGU, JAKARTA SELATAN, DKI JAKARTA",98,130,112,242
https://kawalpemilu.org#26017,"RAGUNAN, PASAR MINGGU, JAKARTA SELATAN, DKI JAKARTA",99,111,126,237
https://kawalpemilu.org#26017,"RAGUNAN, PASAR MINGGU, JAKARTA SELATAN, DKI JAKARTA",100,98,127,225
https://kawalpemilu.org#26017,"RAGUNAN, PASAR MINGGU, JAKARTA SELATAN, DKI JAKARTA",101,120,113,233
https://kawalpemilu.org#26017,"RAGUNAN, PASAR MINGGU, JAKARTA SELATAN, DKI JAKARTA",102,109,146,255
https://kawalpemilu.org#26017,"RAGUNAN, PASAR MINGGU, JAKARTA SELATAN, DKI JAKARTA",103,128,97,225
https://kawalpemilu.org#26017,"RAGUNAN, PASAR MINGGU, JAKARTA SELATAN, DKI JAKARTA",104,136,97,233
https://kawalpemilu.org#26017,"RAGUNAN, PASAR MINGGU, JAKARTA SELATAN, DKI JAKARTA",105,132,104,236
https://kawalpemilu.org#26017,"RAGUNAN, PASAR MINGGU, JAKARTA SELATAN, DKI JAKARTA",106,103,128,231
https://kawalpemilu.org#26017,"RAGUNAN, PASAR MINGGU, JAKARTA SELATAN, DKI JAKARTA",107,110,112,222
https://kawalpemilu.org#26017,"RAGUNAN, PASAR MINGGU, JAKARTA SELATAN, DKI JAKARTA",108,116,117,233
https://kawalpemilu.org#26017,"RAGUNAN, PASAR MINGGU, JAKARTA SELATAN, DKI JAKARTA",109,122,113,235
https://kawalpemilu.org#26017,"RAGUNAN, PASAR MINGGU, JAKARTA SELATAN, DKI JAKARTA",110,131,129,260
https://kawalpemilu.org#26017,"RAGUNAN, PASAR MINGGU, JAKARTA SELATAN, DKI JAKARTA",111,127,123,250
https://kawalpemilu.org#26017,"RAGUNAN, PASAR MINGGU, JAKARTA SELATAN, DKI JAKARTA",112,129,107,236
https://kawalpemilu.org#26017,"RAGUNAN, PASAR MINGGU, JAKARTA SELATAN, DKI JAKARTA",113,135,81,216
https://kawalpemilu.org#26017,"RAGUNAN, PASAR MINGGU, JAKARTA SELATAN, DKI JAKARTA",114,132,96,229
https://kawalpemilu.org#26017,"RAGUNAN, PASAR MINGGU, JAKARTA SELATAN, DKI JAKARTA",115,167,90,257
https://kawalpemilu.org#26017,"RAGUNAN, PASAR MINGGU, JAKARTA SELATAN, DKI JAKARTA",116,152,95,247
https://kawalpemilu.org#26017,"RAGUNAN, PASAR MINGGU, JAKARTA SELATAN, DKI JAKARTA",117,100,126,226
https://kawalpemilu.org#26017,"RAGUNAN, PASAR MINGGU, JAKARTA SELATAN, DKI JAKARTA",118,135,125,260
https://kawalpemilu.org#26017,"RAGUNAN, PASAR MINGGU, JAKARTA SELATAN, DKI JAKARTA",119,102,118,220
https://kawalpemilu.org#26017,"RAGUNAN, PASAR MINGGU, JAKARTA SELATAN, DKI JAKARTA",120,122,125,247
https://kawalpemilu.org#26017,"RAGUNAN, PASAR MINGGU, JAKARTA SELATAN, DKI JAKARTA",121,92,114,206
https://kawalpemilu.org#26017,"RAGUNAN, PASAR MINGGU, JAKARTA SELATAN, DKI JAKARTA",122,125,106,231
https://kawalpemilu.org#26017,"RAGUNAN, PASAR MINGGU, JAKARTA SELATAN, DKI JAKARTA",123,134,93,227
https://kawalpemilu.org#26017,"RAGUNAN, PASAR MINGGU, JAKARTA SELATAN, DKI JAKARTA",124,144,88,232
https://kawalpemilu.org#26017,"RAGUNAN, PASAR MINGGU, JAKARTA SELATAN, DKI JAKARTA",125,148,102,250
https://kawalpemilu.org#26017,"RAGUNAN, PASAR MINGGU, JAKARTA SELATAN, DKI JAKARTA",126,101,150,251
https://kawalpemilu.org#26017,"RAGUNAN, PASAR MINGGU, JAKARTA SELATAN, DKI JAKARTA",127,115,115,230
https://kawalpemilu.org#26017,"RAGUNAN, PASAR MINGGU, JAKARTA SELATAN, DKI JAKARTA",128,127,98,225
https://kawalpemilu.org#26017,"RAGUNAN, PASAR MINGGU, JAKARTA SELATAN, DKI JAKARTA",129,71,162,233
https://kawalpemilu.org#26017,"RAGUNAN, PASAR MINGGU, JAKARTA SELATAN, DKI JAKARTA",130,107,106,213
https://kawalpemilu.org#26017,"RAGUNAN, PASAR MINGGU, JAKARTA SELATAN, DKI JAKARTA",131,92,114,206
https://kawalpemilu.org#26017,"RAGUNAN, PASAR MINGGU, JAKARTA SELATAN, DKI JAKARTA",132,101,132,233
https://kawalpemilu.org#26018,"PEJATEN TIMUR, PASAR MINGGU, JAKARTA SELATAN, DKI JAKARTA",2,143,103,246
https://kawalpemilu.org#26018,"PEJATEN TIMUR, PASAR MINGGU, JAKARTA SELATAN, DKI JAKARTA",3,96,113,209
https://kawalpemilu.org#26018,"PEJATEN TIMUR, PASAR MINGGU, JAKARTA SELATAN, DKI JAKARTA",4,104,115,219
https://kawalpemilu.org#26018,"PEJATEN TIMUR, PASAR MINGGU, JAKARTA SELATAN, DKI JAKARTA",8,101,96,197
https://kawalpemilu.org#26018,"PEJATEN TIMUR, PASAR MINGGU, JAKARTA SELATAN, DKI JAKARTA",9,96,120,216
https://kawalpemilu.org#26018,"PEJATEN TIMUR, PASAR MINGGU, JAKARTA SELATAN, DKI JAKARTA",10,104,98,202
https://kawalpemilu.org#26018,"PEJATEN TIMUR, PASAR MINGGU, JAKARTA SELATAN, DKI JAKARTA",12,77,103,180
https://kawalpemilu.org#26018,"PEJATEN TIMUR, PASAR MINGGU, JAKARTA SELATAN, DKI JAKARTA",13,131,100,231
https://kawalpemilu.org#26018,"PEJATEN TIMUR, PASAR MINGGU, JAKARTA SELATAN, DKI JAKARTA",14,91,161,252
https://kawalpemilu.org#26018,"PEJATEN TIMUR, PASAR MINGGU, JAKARTA SELATAN, DKI JAKARTA",15,120,92,212
https://kawalpemilu.org#26018,"PEJATEN TIMUR, PASAR MINGGU, JAKARTA SELATAN, DKI JAKARTA",16,88,140,228
https://kawalpemilu.org#26018,"PEJATEN TIMUR, PASAR MINGGU, JAKARTA SELATAN, DKI JAKARTA",17,73,145,218
https://kawalpemilu.org#26018,"PEJATEN TIMUR, PASAR MINGGU, JAKARTA SELATAN, DKI JAKARTA",18,92,144,236
https://kawalpemilu.org#26018,"PEJATEN TIMUR, PASAR MINGGU, JAKARTA SELATAN, DKI JAKARTA",19,92,102,194
https://kawalpemilu.org#26018,"PEJATEN TIMUR, PASAR MINGGU, JAKARTA SELATAN, DKI JAKARTA",20,111,90,201
https://kawalpemilu.org#26018,"PEJATEN TIMUR, PASAR MINGGU, JAKARTA SELATAN, DKI JAKARTA",21,132,89,221
https://kawalpemilu.org#26018,"PEJATEN TIMUR, PASAR MINGGU, JAKARTA SELATAN, DKI JAKARTA",25,117,103,220
https://kawalpemilu.org#26018,"PEJATEN TIMUR, PASAR MINGGU, JAKARTA SELATAN, DKI JAKARTA",26,102,120,222
https://kawalpemilu.org#26018,"PEJATEN TIMUR, PASAR MINGGU, JAKARTA SELATAN, DKI JAKARTA",27,98,130,228
https://kawalpemilu.org#26018,"PEJATEN TIMUR, PASAR MINGGU, JAKARTA SELATAN, DKI JAKARTA",28,105,122,227
https://kawalpemilu.org#26018,"PEJATEN TIMUR, PASAR MINGGU, JAKARTA SELATAN, DKI JAKARTA",29,73,118,191
https://kawalpemilu.org#26018,"PEJATEN TIMUR, PASAR MINGGU, JAKARTA SELATAN, DKI JAKARTA",32,129,135,264
https://kawalpemilu.org#26018,"PEJATEN TIMUR, PASAR MINGGU, JAKARTA SELATAN, DKI JAKARTA",34,77,153,230
https://kawalpemilu.org#26018,"PEJATEN TIMUR, PASAR MINGGU, JAKARTA SELATAN, DKI JAKARTA",35,94,159,253
https://kawalpemilu.org#26018,"PEJATEN TIMUR, PASAR MINGGU, JAKARTA SELATAN, DKI JAKARTA",36,142,56,198
https://kawalpemilu.org#26018,"PEJATEN TIMUR, PASAR MINGGU, JAKARTA SELATAN, DKI JAKARTA",37,163,37,200
https://kawalpemilu.org#26018,"PEJATEN TIMUR, PASAR MINGGU, JAKARTA SELATAN, DKI JAKARTA",38,175,41,216
https://kawalpemilu.org#26018,"PEJATEN TIMUR, PASAR MINGGU, JAKARTA SELATAN, DKI JAKARTA",39,169,43,212
https://kawalpemilu.org#26018,"PEJATEN TIMUR, PASAR MINGGU, JAKARTA SELATAN, DKI JAKARTA",40,178,42,220
https://kawalpemilu.org#26018,"PEJATEN TIMUR, PASAR MINGGU, JAKARTA SELATAN, DKI JAKARTA",41,204,57,261
https://kawalpemilu.org#26018,"PEJATEN TIMUR, PASAR MINGGU, JAKARTA SELATAN, DKI JAKARTA",42,126,123,249
https://kawalpemilu.org#26018,"PEJATEN TIMUR, PASAR MINGGU, JAKARTA SELATAN, DKI JAKARTA",43,64,152,216
https://kawalpemilu.org#26018,"PEJATEN TIMUR, PASAR MINGGU, JAKARTA SELATAN, DKI JAKARTA",44,40,190,230
https://kawalpemilu.org#26018,"PEJATEN TIMUR, PASAR MINGGU, JAKARTA SELATAN, DKI JAKARTA",45,67,181,248
https://kawalpemilu.org#26018,"PEJATEN TIMUR, PASAR MINGGU, JAKARTA SELATAN, DKI JAKARTA",46,53,198,251
https://kawalpemilu.org#26018,"PEJATEN TIMUR, PASAR MINGGU, JAKARTA SELATAN, DKI JAKARTA",47,51,175,226
https://kawalpemilu.org#26018,"PEJATEN TIMUR, PASAR MINGGU, JAKARTA SELATAN, DKI JAKARTA",48,49,199,248
https://kawalpemilu.org#26018,"PEJATEN TIMUR, PASAR MINGGU, JAKARTA SELATAN, DKI JAKARTA",51,84,174,258
https://kawalpemilu.org#26018,"PEJATEN TIMUR, PASAR MINGGU, JAKARTA SELATAN, DKI JAKARTA",52,66,195,261
https://kawalpemilu.org#26018,"PEJATEN TIMUR, PASAR MINGGU, JAKARTA SELATAN, DKI JAKARTA",53,44,170,214
https://kawalpemilu.org#26018,"PEJATEN TIMUR, PASAR MINGGU, JAKARTA SELATAN, DKI JAKARTA",56,84,119,203
https://kawalpemilu.org#26018,"PEJATEN TIMUR, PASAR MINGGU, JAKARTA SELATAN, DKI JAKARTA",58,63,141,204
https://kawalpemilu.org#26018,"PEJATEN TIMUR, PASAR MINGGU, JAKARTA SELATAN, DKI JAKARTA",59,49,192,241
https://kawalpemilu.org#26018,"PEJATEN TIMUR, PASAR MINGGU, JAKARTA SELATAN, DKI JAKARTA",60,63,172,235
https://kawalpemilu.org#26018,"PEJATEN TIMUR, PASAR MINGGU, JAKARTA SELATAN, DKI JAKARTA",61,55,163,218
https://kawalpemilu.org#26018,"PEJATEN TIMUR, PASAR MINGGU, JAKARTA SELATAN, DKI JAKARTA",62,59,167,226
https://kawalpemilu.org#26018,"PEJATEN TIMUR, PASAR MINGGU, JAKARTA SELATAN, DKI JAKARTA",63,68,169,237
https://kawalpemilu.org#26018,"PEJATEN TIMUR, PASAR MINGGU, JAKARTA SELATAN, DKI JAKARTA",65,77,172,249
https://kawalpemilu.org#26018,"PEJATEN TIMUR, PASAR MINGGU, JAKARTA SELATAN, DKI JAKARTA",67,110,134,244
https://kawalpemilu.org#26018,"PEJATEN TIMUR, PASAR MINGGU, JAKARTA SELATAN, DKI JAKARTA",68,91,161,252
https://kawalpemilu.org#26018,"PEJATEN TIMUR, PASAR MINGGU, JAKARTA SELATAN, DKI JAKARTA",69,99,109,208
https://kawalpemilu.org#26018,"PEJATEN TIMUR, PASAR MINGGU, JAKARTA SELATAN, DKI JAKARTA",70,97,110,207
https://kawalpemilu.org#26018,"PEJATEN TIMUR, PASAR MINGGU, JAKARTA SELATAN, DKI JAKARTA",71,135,124,259
https://kawalpemilu.org#26018,"PEJATEN TIMUR, PASAR MINGGU, JAKARTA SELATAN, DKI JAKARTA",72,82,125,207
https://kawalpemilu.org#26018,"PEJATEN TIMUR, PASAR MINGGU, JAKARTA SELATAN, DKI JAKARTA",73,110,149,259
https://kawalpemilu.org#26018,"PEJATEN TIMUR, PASAR MINGGU, JAKARTA SELATAN, DKI JAKARTA",74,73,172,245
https://kawalpemilu.org#26018,"PEJATEN TIMUR, PASAR MINGGU, JAKARTA SELATAN, DKI JAKARTA",75,69,129,198
https://kawalpemilu.org#26018,"PEJATEN TIMUR, PASAR MINGGU, JAKARTA SELATAN, DKI JAKARTA",76,81,129,210
https://kawalpemilu.org#26018,"PEJATEN TIMUR, PASAR MINGGU, JAKARTA SELATAN, DKI JAKARTA",77,68,168,236
https://kawalpemilu.org#26018,"PEJATEN TIMUR, PASAR MINGGU, JAKARTA SELATAN, DKI JAKARTA",78,118,146,264
https://kawalpemilu.org#26018,"PEJATEN TIMUR, PASAR MINGGU, JAKARTA SELATAN, DKI JAKARTA",79,82,147,229
https://kawalpemilu.org#26018,"PEJATEN TIMUR, PASAR MINGGU, JAKARTA SELATAN, DKI JAKARTA",80,92,131,223
https://kawalpemilu.org#26018,"PEJATEN TIMUR, PASAR MINGGU, JAKARTA SELATAN, DKI JAKARTA",81,106,117,223
https://kawalpemilu.org#26018,"PEJATEN TIMUR, PASAR MINGGU, JAKARTA SELATAN, DKI JAKARTA",82,122,120,242
https://kawalpemilu.org#26018,"PEJATEN TIMUR, PASAR MINGGU, JAKARTA SELATAN, DKI JAKARTA",84,94,103,197
https://kawalpemilu.org#26018,"PEJATEN TIMUR, PASAR MINGGU, JAKARTA SELATAN, DKI JAKARTA",86,94,141,235
https://kawalpemilu.org#26018,"PEJATEN TIMUR, PASAR MINGGU, JAKARTA SELATAN, DKI JAKARTA",88,117,137,254
https://kawalpemilu.org#26018,"PEJATEN TIMUR, PASAR MINGGU, JAKARTA SELATAN, DKI JAKARTA",90,76,161,237
https://kawalpemilu.org#26018,"PEJATEN TIMUR, PASAR MINGGU, JAKARTA SELATAN, DKI JAKARTA",91,84,126,210
https://kawalpemilu.org#26018,"PEJATEN TIMUR, PASAR MINGGU, JAKARTA SELATAN, DKI JAKARTA",92,78,98,176
https://kawalpemilu.org#26018,"PEJATEN TIMUR, PASAR MINGGU, JAKARTA SELATAN, DKI JAKARTA",94,84,124,208
https://kawalpemilu.org#26018,"PEJATEN TIMUR, PASAR MINGGU, JAKARTA SELATAN, DKI JAKARTA",95,93,110,203
https://kawalpemilu.org#26018,"PEJATEN TIMUR, PASAR MINGGU, JAKARTA SELATAN, DKI JAKARTA",96,103,120,223
https://kawalpemilu.org#26018,"PEJATEN TIMUR, PASAR MINGGU, JAKARTA SELATAN, DKI JAKARTA",97,120,104,224
https://kawalpemilu.org#26018,"PEJATEN TIMUR, PASAR MINGGU, JAKARTA SELATAN, DKI JAKARTA",98,107,113,220
https://kawalpemilu.org#26018,"PEJATEN TIMUR, PASAR MINGGU, JAKARTA SELATAN, DKI JAKARTA",101,78,128,206
https://kawalpemilu.org#26018,"PEJATEN TIMUR, PASAR MINGGU, JAKARTA SELATAN, DKI JAKARTA",103,119,114,233
https://kawalpemilu.org#26018,"PEJATEN TIMUR, PASAR MINGGU, JAKARTA SELATAN, DKI JAKARTA",106,110,90,200
https://kawalpemilu.org#26018,"PEJATEN TIMUR, PASAR MINGGU, JAKARTA SELATAN, DKI JAKARTA",107,72,130,202
https://kawalpemilu.org#26018,"PEJATEN TIMUR, PASAR MINGGU, JAKARTA SELATAN, DKI JAKARTA",108,86,75,161
https://kawalpemilu.org#26018,"PEJATEN TIMUR, PASAR MINGGU, JAKARTA SELATAN, DKI JAKARTA",109,101,70,171
https://kawalpemilu.org#26018,"PEJATEN TIMUR, PASAR MINGGU, JAKARTA SELATAN, DKI JAKARTA",110,83,97,180
https://kawalpemilu.org#26018,"PEJATEN TIMUR, PASAR MINGGU, JAKARTA SELATAN, DKI JAKARTA",111,69,140,209
https://kawalpemilu.org#26018,"PEJATEN TIMUR, PASAR MINGGU, JAKARTA SELATAN, DKI JAKARTA",112,59,133,192
https://kawalpemilu.org#26018,"PEJATEN TIMUR, PASAR MINGGU, JAKARTA SELATAN, DKI JAKARTA",115,99,106,205
https://kawalpemilu.org#26018,"PEJATEN TIMUR, PASAR MINGGU, JAKARTA SELATAN, DKI JAKARTA",116,123,95,218
https://kawalpemilu.org#26018,"PEJATEN TIMUR, PASAR MINGGU, JAKARTA SELATAN, DKI JAKARTA",118,96,84,180
https://kawalpemilu.org#26018,"PEJATEN TIMUR, PASAR MINGGU, JAKARTA SELATAN, DKI JAKARTA",119,90,68,158
https://kawalpemilu.org#26018,"PEJATEN TIMUR, PASAR MINGGU, JAKARTA SELATAN, DKI JAKARTA",120,107,107,214
https://kawalpemilu.org#26018,"PEJATEN TIMUR, PASAR MINGGU, JAKARTA SELATAN, DKI JAKARTA",122,155,88,243
https://kawalpemilu.org#26018,"PEJATEN TIMUR, PASAR MINGGU, JAKARTA SELATAN, DKI JAKARTA",123,170,58,228
https://kawalpemilu.org#26018,"PEJATEN TIMUR, PASAR MINGGU, JAKARTA SELATAN, DKI JAKARTA",124,115,118,233
https://kawalpemilu.org#26018,"PEJATEN TIMUR, PASAR MINGGU, JAKARTA SELATAN, DKI JAKARTA",125,155,74,229
https://kawalpemilu.org#26018,"PEJATEN TIMUR, PASAR MINGGU, JAKARTA SELATAN, DKI JAKARTA",126,119,118,237
https://kawalpemilu.org#26018,"PEJATEN TIMUR, PASAR MINGGU, JAKARTA SELATAN, DKI JAKARTA",127,87,119,206
https://kawalpemilu.org#26018,"PEJATEN TIMUR, PASAR MINGGU, JAKARTA SELATAN, DKI JAKARTA",128,112,127,239
https://kawalpemilu.org#26018,"PEJATEN TIMUR, PASAR MINGGU, JAKARTA SELATAN, DKI JAKARTA",129,97,131,228
https://kawalpemilu.org#26018,"PEJATEN TIMUR, PASAR MINGGU, JAKARTA SELATAN, DKI JAKARTA",130,127,130,257
https://kawalpemilu.org#26018,"PEJATEN TIMUR, PASAR MINGGU, JAKARTA SELATAN, DKI JAKARTA",131,78,114,192
https://kawalpemilu.org#26018,"PEJATEN TIMUR, PASAR MINGGU, JAKARTA SELATAN, DKI JAKARTA",132,86,34,220
https://kawalpemilu.org#26018,"PEJATEN TIMUR, PASAR MINGGU, JAKARTA SELATAN, DKI JAKARTA",133,122,131,253
https://kawalpemilu.org#26018,"PEJATEN TIMUR, PASAR MINGGU, JAKARTA SELATAN, DKI JAKARTA",134,94,156,250
https://kawalpemilu.org#26018,"PEJATEN TIMUR, PASAR MINGGU, JAKARTA SELATAN, DKI JAKARTA",135,90,146,236
https://kawalpemilu.org#26018,"PEJATEN TIMUR, PASAR MINGGU, JAKARTA SELATAN, DKI JAKARTA",136,105,142,247
https://kawalpemilu.org#26018,"PEJATEN TIMUR, PASAR MINGGU, JAKARTA SELATAN, DKI JAKARTA",137,94,148,242
https://kawalpemilu.org#26018,"PEJATEN TIMUR, PASAR MINGGU, JAKARTA SELATAN, DKI JAKARTA",138,66,151,217
https://kawalpemilu.org#26018,"PEJATEN TIMUR, PASAR MINGGU, JAKARTA SELATAN, DKI JAKARTA",139,85,145,230
https://kawalpemilu.org#26018,"PEJATEN TIMUR, PASAR MINGGU, JAKARTA SELATAN, DKI JAKARTA",141,79,160,239
https://kawalpemilu.org#26018,"PEJATEN TIMUR, PASAR MINGGU, JAKARTA SELATAN, DKI JAKARTA",142,69,160,229
https://kawalpemilu.org#26018,"PEJATEN TIMUR, PASAR MINGGU, JAKARTA SELATAN, DKI JAKARTA",143,57,158,215
https://kawalpemilu.org#26018,"PEJATEN TIMUR, PASAR MINGGU, JAKARTA SELATAN, DKI JAKARTA",145,88,128,216
https://kawalpemilu.org#26018,"PEJATEN TIMUR, PASAR MINGGU, JAKARTA SELATAN, DKI JAKARTA",146,59,114,173
https://kawalpemilu.org#26018,"PEJATEN TIMUR, PASAR MINGGU, JAKARTA SELATAN, DKI JAKARTA",147,74,104,178
https://kawalpemilu.org#26018,"PEJATEN TIMUR, PASAR MINGGU, JAKARTA SELATAN, DKI JAKARTA",150,90,139,229
https://kawalpemilu.org#26018,"PEJATEN TIMUR, PASAR MINGGU, JAKARTA SELATAN, DKI JAKARTA",151,69,127,196
https://kawalpemilu.org#26018,"PEJATEN TIMUR, PASAR MINGGU, JAKARTA SELATAN, DKI JAKARTA",152,120,116,236
https://kawalpemilu.org#26018,"PEJATEN TIMUR, PASAR MINGGU, JAKARTA SELATAN, DKI JAKARTA",153,123,114,237
https://kawalpemilu.org#26018,"PEJATEN TIMUR, PASAR MINGGU, JAKARTA SELATAN, DKI JAKARTA",155,83,138,221
https://kawalpemilu.org#26018,"PEJATEN TIMUR, PASAR MINGGU, JAKARTA SELATAN, DKI JAKARTA",156,102,108,210
https://kawalpemilu.org#26018,"PEJATEN TIMUR, PASAR MINGGU, JAKARTA SELATAN, DKI JAKARTA",157,102,98,200
https://kawalpemilu.org#26018,"PEJATEN TIMUR, PASAR MINGGU, JAKARTA SELATAN, DKI JAKARTA",161,89,131,220
https://kawalpemilu.org#26018,"PEJATEN TIMUR, PASAR MINGGU, JAKARTA SELATAN, DKI JAKARTA",162,97,122,219
https://kawalpemilu.org#26018,"PEJATEN TIMUR, PASAR MINGGU, JAKARTA SELATAN, DKI JAKARTA",163,109,158,267
https://kawalpemilu.org#26018,"PEJATEN TIMUR, PASAR MINGGU, JAKARTA SELATAN, DKI JAKARTA",164,93,127,220
https://kawalpemilu.org#26018,"PEJATEN TIMUR, PASAR MINGGU, JAKARTA SELATAN, DKI JAKARTA",166,120,102,222
https://kawalpemilu.org#26018,"PEJATEN TIMUR, PASAR MINGGU, JAKARTA SELATAN, DKI JAKARTA",167,90,133,223
https://kawalpemilu.org#26018,"PEJATEN TIMUR, PASAR MINGGU, JAKARTA SELATAN, DKI JAKARTA",168,117,105,222
https://kawalpemilu.org#26018,"PEJATEN TIMUR, PASAR MINGGU, JAKARTA SELATAN, DKI JAKARTA",171,76,150,226
https://kawalpemilu.org#26018,"PEJATEN TIMUR, PASAR MINGGU, JAKARTA SELATAN, DKI JAKARTA",172,68,176,244
https://kawalpemilu.org#26018,"PEJATEN TIMUR, PASAR MINGGU, JAKARTA SELATAN, DKI JAKARTA",173,47,167,214
https://kawalpemilu.org#26018,"PEJATEN TIMUR, PASAR MINGGU, JAKARTA SELATAN, DKI JAKARTA",174,130,77,207
https://kawalpemilu.org#26018,"PEJATEN TIMUR, PASAR MINGGU, JAKARTA SELATAN, DKI JAKARTA",175,111,91,202
https://kawalpemilu.org#26018,"PEJATEN TIMUR, PASAR MINGGU, JAKARTA SELATAN, DKI JAKARTA",176,113,89,202
https://kawalpemilu.org#26018,"PEJATEN TIMUR, PASAR MINGGU, JAKARTA SELATAN, DKI JAKARTA",177,85,154,239
https://kawalpemilu.org#26018,"PEJATEN TIMUR, PASAR MINGGU, JAKARTA SELATAN, DKI JAKARTA",180,54,151,205
https://kawalpemilu.org#26018,"PEJATEN TIMUR, PASAR MINGGU, JAKARTA SELATAN, DKI JAKARTA",181,101,153,254
https://kawalpemilu.org#26018,"PEJATEN TIMUR, PASAR MINGGU, JAKARTA SELATAN, DKI JAKARTA",182,103,106,209
https://kawalpemilu.org#26018,"PEJATEN TIMUR, PASAR MINGGU, JAKARTA SELATAN, DKI JAKARTA",183,91,143,234
https://kawalpemilu.org#26018,"PEJATEN TIMUR, PASAR MINGGU, JAKARTA SELATAN, DKI JAKARTA",184,84,118,202
https://kawalpemilu.org#26018,"PEJATEN TIMUR, PASAR MINGGU, JAKARTA SELATAN, DKI JAKARTA",185,75,151,226
https://kawalpemilu.org#26019,"PEJATEN BARAT, PASAR MINGGU, JAKARTA SELATAN, DKI JAKARTA",3,72,109,181
https://kawalpemilu.org#26019,"PEJATEN BARAT, PASAR MINGGU, JAKARTA SELATAN, DKI JAKARTA",4,106,142,248
https://kawalpemilu.org#26019,"PEJATEN BARAT, PASAR MINGGU, JAKARTA SELATAN, DKI JAKARTA",5,56,105,161
https://kawalpemilu.org#26019,"PEJATEN BARAT, PASAR MINGGU, JAKARTA SELATAN, DKI JAKARTA",6,81,92,173
https://kawalpemilu.org#26019,"PEJATEN BARAT, PASAR MINGGU, JAKARTA SELATAN, DKI JAKARTA",7,147,86,233
https://kawalpemilu.org#26019,"PEJATEN BARAT, PASAR MINGGU, JAKARTA SELATAN, DKI JAKARTA",8,134,113,247
https://kawalpemilu.org#26019,"PEJATEN BARAT, PASAR MINGGU, JAKARTA SELATAN, DKI JAKARTA",9,93,138,231
https://kawalpemilu.org#26019,"PEJATEN BARAT, PASAR MINGGU, JAKARTA SELATAN, DKI JAKARTA",10,107,111,218
https://kawalpemilu.org#26019,"PEJATEN BARAT, PASAR MINGGU, JAKARTA SELATAN, DKI JAKARTA",11,91,106,197
https://kawalpemilu.org#26019,"PEJATEN BARAT, PASAR MINGGU, JAKARTA SELATAN, DKI JAKARTA",12,96,140,236
https://kawalpemilu.org#26019,"PEJATEN BARAT, PASAR MINGGU, JAKARTA SELATAN, DKI JAKARTA",13,136,97,233
https://kawalpemilu.org#26019,"PEJATEN BARAT, PASAR MINGGU, JAKARTA SELATAN, DKI JAKARTA",14,97,105,202
https://kawalpemilu.org#26019,"PEJATEN BARAT, PASAR MINGGU, JAKARTA SELATAN, DKI JAKARTA",15,80,163,243
https://kawalpemilu.org#26019,"PEJATEN BARAT, PASAR MINGGU, JAKARTA SELATAN, DKI JAKARTA",16,107,139,246
https://kawalpemilu.org#26019,"PEJATEN BARAT, PASAR MINGGU, JAKARTA SELATAN, DKI JAKARTA",17,93,88,181
https://kawalpemilu.org#26019,"PEJATEN BARAT, PASAR MINGGU, JAKARTA SELATAN, DKI JAKARTA",18,78,69,147
https://kawalpemilu.org#26019,"PEJATEN BARAT, PASAR MINGGU, JAKARTA SELATAN, DKI JAKARTA",19,79,130,209
https://kawalpemilu.org#26019,"PEJATEN BARAT, PASAR MINGGU, JAKARTA SELATAN, DKI JAKARTA",20,79,82,161
https://kawalpemilu.org#26019,"PEJATEN BARAT, PASAR MINGGU, JAKARTA SELATAN, DKI JAKARTA",21,125,81,206
https://kawalpemilu.org#26019,"PEJATEN BARAT, PASAR MINGGU, JAKARTA SELATAN, DKI JAKARTA",22,139,66,205
https://kawalpemilu.org#26019,"PEJATEN BARAT, PASAR MINGGU, JAKARTA SELATAN, DKI JAKARTA",25,83,143,226
https://kawalpemilu.org#26019,"PEJATEN BARAT, PASAR MINGGU, JAKARTA SELATAN, DKI JAKARTA",27,188,77,265
https://kawalpemilu.org#26019,"PEJATEN BARAT, PASAR MINGGU, JAKARTA SELATAN, DKI JAKARTA",28,135,79,214
https://kawalpemilu.org#26019,"PEJATEN BARAT, PASAR MINGGU, JAKARTA SELATAN, DKI JAKARTA",29,79,178,257
https://kawalpemilu.org#26019,"PEJATEN BARAT, PASAR MINGGU, JAKARTA SELATAN, DKI JAKARTA",30,154,80,234
https://kawalpemilu.org#26019,"PEJATEN BARAT, PASAR MINGGU, JAKARTA SELATAN, DKI JAKARTA",32,109,107,216
https://kawalpemilu.org#26019,"PEJATEN BARAT, PASAR MINGGU, JAKARTA SELATAN, DKI JAKARTA",33,122,112,234
https://kawalpemilu.org#26019,"PEJATEN BARAT, PASAR MINGGU, JAKARTA SELATAN, DKI JAKARTA",34,113,128,241
https://kawalpemilu.org#26019,"PEJATEN BARAT, PASAR MINGGU, JAKARTA SELATAN, DKI JAKARTA",35,130,115,245
https://kawalpemilu.org#26019,"PEJATEN BARAT, PASAR MINGGU, JAKARTA SELATAN, DKI JAKARTA",36,113,106,219
https://kawalpemilu.org#26019,"PEJATEN BARAT, PASAR MINGGU, JAKARTA SELATAN, DKI JAKARTA",37,124,114,238
https://kawalpemilu.org#26019,"PEJATEN BARAT, PASAR MINGGU, JAKARTA SELATAN, DKI JAKARTA",38,75,153,228
https://kawalpemilu.org#26019,"PEJATEN BARAT, PASAR MINGGU, JAKARTA SELATAN, DKI JAKARTA",39,86,124,210
https://kawalpemilu.org#26019,"PEJATEN BARAT, PASAR MINGGU, JAKARTA SELATAN, DKI JAKARTA",40,121,113,234
https://kawalpemilu.org#26019,"PEJATEN BARAT, PASAR MINGGU, JAKARTA SELATAN, DKI JAKARTA",41,61,166,227
https://kawalpemilu.org#26019,"PEJATEN BARAT, PASAR MINGGU, JAKARTA SELATAN, DKI JAKARTA",42,112,142,254
https://kawalpemilu.org#26019,"PEJATEN BARAT, PASAR MINGGU, JAKARTA SELATAN, DKI JAKARTA",43,144,92,236
https://kawalpemilu.org#26019,"PEJATEN BARAT, PASAR MINGGU, JAKARTA SELATAN, DKI JAKARTA",44,102,140,242
https://kawalpemilu.org#26019,"PEJATEN BARAT, PASAR MINGGU, JAKARTA SELATAN, DKI JAKARTA",45,90,166,256
https://kawalpemilu.org#26019,"PEJATEN BARAT, PASAR MINGGU, JAKARTA SELATAN, DKI JAKARTA",46,85,112,197
https://kawalpemilu.org#26019,"PEJATEN BARAT, PASAR MINGGU, JAKARTA SELATAN, DKI JAKARTA",47,125,130,255
https://kawalpemilu.org#26019,"PEJATEN BARAT, PASAR MINGGU, JAKARTA SELATAN, DKI JAKARTA",48,139,97,236
https://kawalpemilu.org#26019,"PEJATEN BARAT, PASAR MINGGU, JAKARTA SELATAN, DKI JAKARTA",49,96,156,252
https://kawalpemilu.org#26019,"PEJATEN BARAT, PASAR MINGGU, JAKARTA SELATAN, DKI JAKARTA",50,94,134,228
https://kawalpemilu.org#26019,"PEJATEN BARAT, PASAR MINGGU, JAKARTA SELATAN, DKI JAKARTA",51,68,111,179
https://kawalpemilu.org#26019,"PEJATEN BARAT, PASAR MINGGU, JAKARTA SELATAN, DKI JAKARTA",52,60,170,230
https://kawalpemilu.org#26019,"PEJATEN BARAT, PASAR MINGGU, JAKARTA SELATAN, DKI JAKARTA",53,102,126,228
https://kawalpemilu.org#26019,"PEJATEN BARAT, PASAR MINGGU, JAKARTA SELATAN, DKI JAKARTA",55,69,72,141
https://kawalpemilu.org#26019,"PEJATEN BARAT, PASAR MINGGU, JAKARTA SELATAN, DKI JAKARTA",56,88,170,258
https://kawalpemilu.org#26019,"PEJATEN BARAT, PASAR MINGGU, JAKARTA SELATAN, DKI JAKARTA",57,115,121,236
https://kawalpemilu.org#26019,"PEJATEN BARAT, PASAR MINGGU, JAKARTA SELATAN, DKI JAKARTA",58,71,122,193
https://kawalpemilu.org#26019,"PEJATEN BARAT, PASAR MINGGU, JAKARTA SELATAN, DKI JAKARTA",59,83,130,213
https://kawalpemilu.org#26019,"PEJATEN BARAT, PASAR MINGGU, JAKARTA SELATAN, DKI JAKARTA",60,89,115,204
https://kawalpemilu.org#26019,"PEJATEN BARAT, PASAR MINGGU, JAKARTA SELATAN, DKI JAKARTA",61,116,119,235
https://kawalpemilu.org#26019,"PEJATEN BARAT, PASAR MINGGU, JAKARTA SELATAN, DKI JAKARTA",62,97,101,198
https://kawalpemilu.org#26019,"PEJATEN BARAT, PASAR MINGGU, JAKARTA SELATAN, DKI JAKARTA",63,94,110,204
https://kawalpemilu.org#26019,"PEJATEN BARAT, PASAR MINGGU, JAKARTA SELATAN, DKI JAKARTA",64,99,112,211
https://kawalpemilu.org#26019,"PEJATEN BARAT, PASAR MINGGU, JAKARTA SELATAN, DKI JAKARTA",65,97,90,187
https://kawalpemilu.org#26019,"PEJATEN BARAT, PASAR MINGGU, JAKARTA SELATAN, DKI JAKARTA",66,81,143,224
https://kawalpemilu.org#26019,"PEJATEN BARAT, PASAR MINGGU, JAKARTA SELATAN, DKI JAKARTA",67,74,107,181
https://kawalpemilu.org#26019,"PEJATEN BARAT, PASAR MINGGU, JAKARTA SELATAN, DKI JAKARTA",68,83,101,184
https://kawalpemilu.org#26019,"PEJATEN BARAT, PASAR MINGGU, JAKARTA SELATAN, DKI JAKARTA",69,91,108,199
https://kawalpemilu.org#26019,"PEJATEN BARAT, PASAR MINGGU, JAKARTA SELATAN, DKI JAKARTA",70,126,93,219
https://kawalpemilu.org#26019,"PEJATEN BARAT, PASAR MINGGU, JAKARTA SELATAN, DKI JAKARTA",71,89,131,220
https://kawalpemilu.org#26019,"PEJATEN BARAT, PASAR MINGGU, JAKARTA SELATAN, DKI JAKARTA",72,88,114,202
https://kawalpemilu.org#26019,"PEJATEN BARAT, PASAR MINGGU, JAKARTA SELATAN, DKI JAKARTA",73,96,92,188
https://kawalpemilu.org#26019,"PEJATEN BARAT, PASAR MINGGU, JAKARTA SELATAN, DKI JAKARTA",74,76,124,200
https://kawalpemilu.org#26019,"PEJATEN BARAT, PASAR MINGGU, JAKARTA SELATAN, DKI JAKARTA",75,69,119,188
https://kawalpemilu.org#26019,"PEJATEN BARAT, PASAR MINGGU, JAKARTA SELATAN, DKI JAKARTA",76,117,83,200
https://kawalpemilu.org#26019,"PEJATEN BARAT, PASAR MINGGU, JAKARTA SELATAN, DKI JAKARTA",77,107,106,213
https://kawalpemilu.org#26019,"PEJATEN BARAT, PASAR MINGGU, JAKARTA SELATAN, DKI JAKARTA",78,116,131,247
https://kawalpemilu.org#26019,"PEJATEN BARAT, PASAR MINGGU, JAKARTA SELATAN, DKI JAKARTA",79,116,115,231
https://kawalpemilu.org#26019,"PEJATEN BARAT, PASAR MINGGU, JAKARTA SELATAN, DKI JAKARTA",80,101,124,225
https://kawalpemilu.org#26019,"PEJATEN BARAT, PASAR MINGGU, JAKARTA SELATAN, DKI JAKARTA",81,98,96,194
https://kawalpemilu.org#26019,"PEJATEN BARAT, PASAR MINGGU, JAKARTA SELATAN, DKI JAKARTA",82,130,45,175
https://kawalpemilu.org#26019,"PEJATEN BARAT, PASAR MINGGU, JAKARTA SELATAN, DKI JAKARTA",83,143,71,214
https://kawalpemilu.org#26019,"PEJATEN BARAT, PASAR MINGGU, JAKARTA SELATAN, DKI JAKARTA",84,116,98,214
https://kawalpemilu.org#26019,"PEJATEN BARAT, PASAR MINGGU, JAKARTA SELATAN, DKI JAKARTA",85,97,112,209
https://kawalpemilu.org#26019,"PEJATEN BARAT, PASAR MINGGU, JAKARTA SELATAN, DKI JAKARTA",86,131,89,220
https://kawalpemilu.org#26019,"PEJATEN BARAT, PASAR MINGGU, JAKARTA SELATAN, DKI JAKARTA",87,157,78,235
https://kawalpemilu.org#26019,"PEJATEN BARAT, PASAR MINGGU, JAKARTA SELATAN, DKI JAKARTA",88,136,104,240
https://kawalpemilu.org#26019,"PEJATEN BARAT, PASAR MINGGU, JAKARTA SELATAN, DKI JAKARTA",89,98,143,241
https://kawalpemilu.org#26019,"PEJATEN BARAT, PASAR MINGGU, JAKARTA SELATAN, DKI JAKARTA",90,118,118,236
https://kawalpemilu.org#26019,"PEJATEN BARAT, PASAR MINGGU, JAKARTA SELATAN, DKI JAKARTA",91,84,136,220
https://kawalpemilu.org#26019,"PEJATEN BARAT, PASAR MINGGU, JAKARTA SELATAN, DKI JAKARTA",92,95,112,207
https://kawalpemilu.org#26019,"PEJATEN BARAT, PASAR MINGGU, JAKARTA SELATAN, DKI JAKARTA",93,110,99,209
https://kawalpemilu.org#26019,"PEJATEN BARAT, PASAR MINGGU, JAKARTA SELATAN, DKI JAKARTA",94,141,86,227
https://kawalpemilu.org#26019,"PEJATEN BARAT, PASAR MINGGU, JAKARTA SELATAN, DKI JAKARTA",95,84,150,234
https://kawalpemilu.org#26019,"PEJATEN BARAT, PASAR MINGGU, JAKARTA SELATAN, DKI JAKARTA",96,79,108,187
https://kawalpemilu.org#26019,"PEJATEN BARAT, PASAR MINGGU, JAKARTA SELATAN, DKI JAKARTA",97,81,100,181
https://kawalpemilu.org#26019,"PEJATEN BARAT, PASAR MINGGU, JAKARTA SELATAN, DKI JAKARTA",98,67,176,243
https://kawalpemilu.org#26019,"PEJATEN BARAT, PASAR MINGGU, JAKARTA SELATAN, DKI JAKARTA",100,97,128,225
https://kawalpemilu.org#26019,"PEJATEN BARAT, PASAR MINGGU, JAKARTA SELATAN, DKI JAKARTA",101,146,68,214
https://kawalpemilu.org#26019,"PEJATEN BARAT, PASAR MINGGU, JAKARTA SELATAN, DKI JAKARTA",102,92,134,226
https://kawalpemilu.org#26019,"PEJATEN BARAT, PASAR MINGGU, JAKARTA SELATAN, DKI JAKARTA",103,73,100,173
https://kawalpemilu.org#26019,"PEJATEN BARAT, PASAR MINGGU, JAKARTA SELATAN, DKI JAKARTA",104,73,149,222
https://kawalpemilu.org#26019,"PEJATEN BARAT, PASAR MINGGU, JAKARTA SELATAN, DKI JAKARTA",105,151,51,202
https://kawalpemilu.org#26019,"PEJATEN BARAT, PASAR MINGGU, JAKARTA SELATAN, DKI JAKARTA",106,70,132,202
https://kawalpemilu.org#26019,"PEJATEN BARAT, PASAR MINGGU, JAKARTA SELATAN, DKI JAKARTA",107,62,139,201
https://kawalpemilu.org#26019,"PEJATEN BARAT, PASAR MINGGU, JAKARTA SELATAN, DKI JAKARTA",108,75,122,197
https://kawalpemilu.org#26019,"PEJATEN BARAT, PASAR MINGGU, JAKARTA SELATAN, DKI JAKARTA",109,95,109,204
https://kawalpemilu.org#26019,"PEJATEN BARAT, PASAR MINGGU, JAKARTA SELATAN, DKI JAKARTA",110,104,98,202
https://kawalpemilu.org#26019,"PEJATEN BARAT, PASAR MINGGU, JAKARTA SELATAN, DKI JAKARTA",111,108,98,206
https://kawalpemilu.org#26019,"PEJATEN BARAT, PASAR MINGGU, JAKARTA SELATAN, DKI JAKARTA",112,93,108,201
https://kawalpemilu.org#26019,"PEJATEN BARAT, PASAR MINGGU, JAKARTA SELATAN, DKI JAKARTA",113,95,93,188
https://kawalpemilu.org#26019,"PEJATEN BARAT, PASAR MINGGU, JAKARTA SELATAN, DKI JAKARTA",114,78,104,182
https://kawalpemilu.org#26019,"PEJATEN BARAT, PASAR MINGGU, JAKARTA SELATAN, DKI JAKARTA",115,69,96,165
https://kawalpemilu.org#26019,"PEJATEN BARAT, PASAR MINGGU, JAKARTA SELATAN, DKI JAKARTA",116,86,113,199
https://kawalpemilu.org#26019,"PEJATEN BARAT, PASAR MINGGU, JAKARTA SELATAN, DKI JAKARTA",117,73,141,214
https://kawalpemilu.org#26019,"PEJATEN BARAT, PASAR MINGGU, JAKARTA SELATAN, DKI JAKARTA",118,71,110,181
https://kawalpemilu.org#26019,"PEJATEN BARAT, PASAR MINGGU, JAKARTA SELATAN, DKI JAKARTA",119,56,111,167
https://kawalpemilu.org#26019,"PEJATEN BARAT, PASAR MINGGU, JAKARTA SELATAN, DKI JAKARTA",120,98,127,225
https://kawalpemilu.org#26019,"PEJATEN BARAT, PASAR MINGGU, JAKARTA SELATAN, DKI JAKARTA",121,66,135,201
https://kawalpemilu.org#26019,"PEJATEN BARAT, PASAR MINGGU, JAKARTA SELATAN, DKI JAKARTA",122,52,168,220
https://kawalpemilu.org#26019,"PEJATEN BARAT, PASAR MINGGU, JAKARTA SELATAN, DKI JAKARTA",123,58,152,210
https://kawalpemilu.org#26019,"PEJATEN BARAT, PASAR MINGGU, JAKARTA SELATAN, DKI JAKARTA",124,95,129,224
https://kawalpemilu.org#26019,"PEJATEN BARAT, PASAR MINGGU, JAKARTA SELATAN, DKI JAKARTA",125,79,120,199
https://kawalpemilu.org#26019,"PEJATEN BARAT, PASAR MINGGU, JAKARTA SELATAN, DKI JAKARTA",126,46,168,214
https://kawalpemilu.org#26019,"PEJATEN BARAT, PASAR MINGGU, JAKARTA SELATAN, DKI JAKARTA",127,61,186,247
https://kawalpemilu.org#26019,"PEJATEN BARAT, PASAR MINGGU, JAKARTA SELATAN, DKI JAKARTA",128,108,137,245
https://kawalpemilu.org#26019,"PEJATEN BARAT, PASAR MINGGU, JAKARTA SELATAN, DKI JAKARTA",129,72,84,156
https://kawalpemilu.org#26020,"KEBAGUSAN, PASAR MINGGU, JAKARTA SELATAN, DKI JAKARTA",1,65,119,184
https://kawalpemilu.org#26020,"KEBAGUSAN, PASAR MINGGU, JAKARTA SELATAN, DKI JAKARTA",2,71,83,154
https://kawalpemilu.org#26020,"KEBAGUSAN, PASAR MINGGU, JAKARTA SELATAN, DKI JAKARTA",3,104,116,220
https://kawalpemilu.org#26020,"KEBAGUSAN, PASAR MINGGU, JAKARTA SELATAN, DKI JAKARTA",4,91,131,222
https://kawalpemilu.org#26020,"KEBAGUSAN, PASAR MINGGU, JAKARTA SELATAN, DKI JAKARTA",5,118,140,258
https://kawalpemilu.org#26020,"KEBAGUSAN, PASAR MINGGU, JAKARTA SELATAN, DKI JAKARTA",6,95,159,254
https://kawalpemilu.org#26020,"KEBAGUSAN, PASAR MINGGU, JAKARTA SELATAN, DKI JAKARTA",7,90,134,224
https://kawalpemilu.org#26020,"KEBAGUSAN, PASAR MINGGU, JAKARTA SELATAN, DKI JAKARTA",9,89,103,192
https://kawalpemilu.org#26020,"KEBAGUSAN, PASAR MINGGU, JAKARTA SELATAN, DKI JAKARTA",10,105,147,252
https://kawalpemilu.org#26020,"KEBAGUSAN, PASAR MINGGU, JAKARTA SELATAN, DKI JAKARTA",11,86,81,167
https://kawalpemilu.org#26020,"KEBAGUSAN, PASAR MINGGU, JAKARTA SELATAN, DKI JAKARTA",13,95,149,244
https://kawalpemilu.org#26020,"KEBAGUSAN, PASAR MINGGU, JAKARTA SELATAN, DKI JAKARTA",15,93,134,227
https://kawalpemilu.org#26020,"KEBAGUSAN, PASAR MINGGU, JAKARTA SELATAN, DKI JAKARTA",16,74,126,200
https://kawalpemilu.org#26020,"KEBAGUSAN, PASAR MINGGU, JAKARTA SELATAN, DKI JAKARTA",17,131,101,232
https://kawalpemilu.org#26020,"KEBAGUSAN, PASAR MINGGU, JAKARTA SELATAN, DKI JAKARTA",18,99,147,246
https://kawalpemilu.org#26020,"KEBAGUSAN, PASAR MINGGU, JAKARTA SELATAN, DKI JAKARTA",19,97,104,201
https://kawalpemilu.org#26020,"KEBAGUSAN, PASAR MINGGU, JAKARTA SELATAN, DKI JAKARTA",20,99,96,195
https://kawalpemilu.org#26020,"KEBAGUSAN, PASAR MINGGU, JAKARTA SELATAN, DKI JAKARTA",21,88,133,221
https://kawalpemilu.org#26020,"KEBAGUSAN, PASAR MINGGU, JAKARTA SELATAN, DKI JAKARTA",22,123,141,264
https://kawalpemilu.org#26020,"KEBAGUSAN, PASAR MINGGU, JAKARTA SELATAN, DKI JAKARTA",23,147,99,246
https://kawalpemilu.org#26020,"KEBAGUSAN, PASAR MINGGU, JAKARTA SELATAN, DKI JAKARTA",24,125,74,199
https://kawalpemilu.org#26020,"KEBAGUSAN, PASAR MINGGU, JAKARTA SELATAN, DKI JAKARTA",25,113,123,236
https://kawalpemilu.org#26020,"KEBAGUSAN, PASAR MINGGU, JAKARTA SELATAN, DKI JAKARTA",26,130,96,226
https://kawalpemilu.org#26020,"KEBAGUSAN, PASAR MINGGU, JAKARTA SELATAN, DKI JAKARTA",28,101,158,259
https://kawalpemilu.org#26020,"KEBAGUSAN, PASAR MINGGU, JAKARTA SELATAN, DKI JAKARTA",29,119,89,208
https://kawalpemilu.org#26020,"KEBAGUSAN, PASAR MINGGU, JAKARTA SELATAN, DKI JAKARTA",30,92,147,239
https://kawalpemilu.org#26020,"KEBAGUSAN, PASAR MINGGU, JAKARTA SELATAN, DKI JAKARTA",31,92,135,227
https://kawalpemilu.org#26020,"KEBAGUSAN, PASAR MINGGU, JAKARTA SELATAN, DKI JAKARTA",32,100,114,214
https://kawalpemilu.org#26020,"KEBAGUSAN, PASAR MINGGU, JAKARTA SELATAN, DKI JAKARTA",33,143,101,244
https://kawalpemilu.org#26020,"KEBAGUSAN, PASAR MINGGU, JAKARTA SELATAN, DKI JAKARTA",34,92,115,207
https://kawalpemilu.org#26020,"KEBAGUSAN, PASAR MINGGU, JAKARTA SELATAN, DKI JAKARTA",35,149,99,248
https://kawalpemilu.org#26020,"KEBAGUSAN, PASAR MINGGU, JAKARTA SELATAN, DKI JAKARTA",36,127,108,235
https://kawalpemilu.org#26020,"KEBAGUSAN, PASAR MINGGU, JAKARTA SELATAN, DKI JAKARTA",37,129,105,234
https://kawalpemilu.org#26020,"KEBAGUSAN, PASAR MINGGU, JAKARTA SELATAN, DKI JAKARTA",38,133,114,247
https://kawalpemilu.org#26020,"KEBAGUSAN, PASAR MINGGU, JAKARTA SELATAN, DKI JAKARTA",39,105,135,240
https://kawalpemilu.org#26020,"KEBAGUSAN, PASAR MINGGU, JAKARTA SELATAN, DKI JAKARTA",40,123,76,199
https://kawalpemilu.org#26020,"KEBAGUSAN, PASAR MINGGU, JAKARTA SELATAN, DKI JAKARTA",41,102,129,231
https://kawalpemilu.org#26020,"KEBAGUSAN, PASAR MINGGU, JAKARTA SELATAN, DKI JAKARTA",42,124,111,235
https://kawalpemilu.org#26020,"KEBAGUSAN, PASAR MINGGU, JAKARTA SELATAN, DKI JAKARTA",43,112,118,230
https://kawalpemilu.org#26020,"KEBAGUSAN, PASAR MINGGU, JAKARTA SELATAN, DKI JAKARTA",44,115,97,212
https://kawalpemilu.org#26020,"KEBAGUSAN, PASAR MINGGU, JAKARTA SELATAN, DKI JAKARTA",45,94,94,188
https://kawalpemilu.org#26020,"KEBAGUSAN, PASAR MINGGU, JAKARTA SELATAN, DKI JAKARTA",46,116,155,271
https://kawalpemilu.org#26020,"KEBAGUSAN, PASAR MINGGU, JAKARTA SELATAN, DKI JAKARTA",47,98,128,226
https://kawalpemilu.org#26020,"KEBAGUSAN, PASAR MINGGU, JAKARTA SELATAN, DKI JAKARTA",48,125,59,184
https://kawalpemilu.org#26020,"KEBAGUSAN, PASAR MINGGU, JAKARTA SELATAN, DKI JAKARTA",49,96,140,236
https://kawalpemilu.org#26020,"KEBAGUSAN, PASAR MINGGU, JAKARTA SELATAN, DKI JAKARTA",50,72,141,213
https://kawalpemilu.org#26020,"KEBAGUSAN, PASAR MINGGU, JAKARTA SELATAN, DKI JAKARTA",51,81,117,198
https://kawalpemilu.org#26020,"KEBAGUSAN, PASAR MINGGU, JAKARTA SELATAN, DKI JAKARTA",52,107,115,222
https://kawalpemilu.org#26020,"KEBAGUSAN, PASAR MINGGU, JAKARTA SELATAN, DKI JAKARTA",53,99,151,250
https://kawalpemilu.org#26020,"KEBAGUSAN, PASAR MINGGU, JAKARTA SELATAN, DKI JAKARTA",54,101,133,234
https://kawalpemilu.org#26020,"KEBAGUSAN, PASAR MINGGU, JAKARTA SELATAN, DKI JAKARTA",55,105,107,212
https://kawalpemilu.org#26020,"KEBAGUSAN, PASAR MINGGU, JAKARTA SELATAN, DKI JAKARTA",56,110,103,213
https://kawalpemilu.org#26020,"KEBAGUSAN, PASAR MINGGU, JAKARTA SELATAN, DKI JAKARTA",57,125,118,243
https://kawalpemilu.org#26020,"KEBAGUSAN, PASAR MINGGU, JAKARTA SELATAN, DKI JAKARTA",58,118,95,213
https://kawalpemilu.org#26020,"KEBAGUSAN, PASAR MINGGU, JAKARTA SELATAN, DKI JAKARTA",59,78,157,235
https://kawalpemilu.org#26020,"KEBAGUSAN, PASAR MINGGU, JAKARTA SELATAN, DKI JAKARTA",60,76,148,224
https://kawalpemilu.org#26020,"KEBAGUSAN, PASAR MINGGU, JAKARTA SELATAN, DKI JAKARTA",61,81,126,207
https://kawalpemilu.org#26020,"KEBAGUSAN, PASAR MINGGU, JAKARTA SELATAN, DKI JAKARTA",62,129,118,247
https://kawalpemilu.org#26020,"KEBAGUSAN, PASAR MINGGU, JAKARTA SELATAN, DKI JAKARTA",63,89,102,191
https://kawalpemilu.org#26020,"KEBAGUSAN, PASAR MINGGU, JAKARTA SELATAN, DKI JAKARTA",64,117,94,211
https://kawalpemilu.org#26020,"KEBAGUSAN, PASAR MINGGU, JAKARTA SELATAN, DKI JAKARTA",65,138,111,249
https://kawalpemilu.org#26020,"KEBAGUSAN, PASAR MINGGU, JAKARTA SELATAN, DKI JAKARTA",66,126,85,211
https://kawalpemilu.org#26020,"KEBAGUSAN, PASAR MINGGU, JAKARTA SELATAN, DKI JAKARTA",67,89,91,180
https://kawalpemilu.org#26020,"KEBAGUSAN, PASAR MINGGU, JAKARTA SELATAN, DKI JAKARTA",68,115,77,192
https://kawalpemilu.org#26020,"KEBAGUSAN, PASAR MINGGU, JAKARTA SELATAN, DKI JAKARTA",69,86,71,157
https://kawalpemilu.org#26020,"KEBAGUSAN, PASAR MINGGU, JAKARTA SELATAN, DKI JAKARTA",70,149,100,249
https://kawalpemilu.org#26020,"KEBAGUSAN, PASAR MINGGU, JAKARTA SELATAN, DKI JAKARTA",71,93,67,160
https://kawalpemilu.org#26020,"KEBAGUSAN, PASAR MINGGU, JAKARTA SELATAN, DKI JAKARTA",72,90,103,193
https://kawalpemilu.org#26020,"KEBAGUSAN, PASAR MINGGU, JAKARTA SELATAN, DKI JAKARTA",73,101,105,206
https://kawalpemilu.org#26020,"KEBAGUSAN, PASAR MINGGU, JAKARTA SELATAN, DKI JAKARTA",74,105,81,186
https://kawalpemilu.org#26020,"KEBAGUSAN, PASAR MINGGU, JAKARTA SELATAN, DKI JAKARTA",75,112,121,233
https://kawalpemilu.org#26020,"KEBAGUSAN, PASAR MINGGU, JAKARTA SELATAN, DKI JAKARTA",76,148,97,245
https://kawalpemilu.org#26020,"KEBAGUSAN, PASAR MINGGU, JAKARTA SELATAN, DKI JAKARTA",77,124,103,227
https://kawalpemilu.org#26020,"KEBAGUSAN, PASAR MINGGU, JAKARTA SELATAN, DKI JAKARTA",78,130,114,244
https://kawalpemilu.org#26020,"KEBAGUSAN, PASAR MINGGU, JAKARTA SELATAN, DKI JAKARTA",79,98,117,215
https://kawalpemilu.org#26020,"KEBAGUSAN, PASAR MINGGU, JAKARTA SELATAN, DKI JAKARTA",80,129,95,224
https://kawalpemilu.org#26020,"KEBAGUSAN, PASAR MINGGU, JAKARTA SELATAN, DKI JAKARTA",81,118,109,227
https://kawalpemilu.org#26020,"KEBAGUSAN, PASAR MINGGU, JAKARTA SELATAN, DKI JAKARTA",82,121,84,205
https://kawalpemilu.org#26020,"KEBAGUSAN, PASAR MINGGU, JAKARTA SELATAN, DKI JAKARTA",83,128,91,219
https://kawalpemilu.org#26020,"KEBAGUSAN, PASAR MINGGU, JAKARTA SELATAN, DKI JAKARTA",84,118,118,236
https://kawalpemilu.org#26020,"KEBAGUSAN, PASAR MINGGU, JAKARTA SELATAN, DKI JAKARTA",85,92,121,213
https://kawalpemilu.org#26020,"KEBAGUSAN, PASAR MINGGU, JAKARTA SELATAN, DKI JAKARTA",87,122,116,238
https://kawalpemilu.org#26020,"KEBAGUSAN, PASAR MINGGU, JAKARTA SELATAN, DKI JAKARTA",88,89,121,210
https://kawalpemilu.org#26020,"KEBAGUSAN, PASAR MINGGU, JAKARTA SELATAN, DKI JAKARTA",89,129,106,235
https://kawalpemilu.org#26020,"KEBAGUSAN, PASAR MINGGU, JAKARTA SELATAN, DKI JAKARTA",90,104,115,219
https://kawalpemilu.org#26020,"KEBAGUSAN, PASAR MINGGU, JAKARTA SELATAN, DKI JAKARTA",91,106,105,211
https://kawalpemilu.org#26020,"KEBAGUSAN, PASAR MINGGU, JAKARTA SELATAN, DKI JAKARTA",92,130,89,219
https://kawalpemilu.org#26020,"KEBAGUSAN, PASAR MINGGU, JAKARTA SELATAN, DKI JAKARTA",93,113,127,240
https://kawalpemilu.org#26020,"KEBAGUSAN, PASAR MINGGU, JAKARTA SELATAN, DKI JAKARTA",94,77,104,181
https://kawalpemilu.org#26020,"KEBAGUSAN, PASAR MINGGU, JAKARTA SELATAN, DKI JAKARTA",95,131,136,267
https://kawalpemilu.org#26020,"KEBAGUSAN, PASAR MINGGU, JAKARTA SELATAN, DKI JAKARTA",96,102,124,226
https://kawalpemilu.org#26020,"KEBAGUSAN, PASAR MINGGU, JAKARTA SELATAN, DKI JAKARTA",97,126,125,251
https://kawalpemilu.org#26020,"KEBAGUSAN, PASAR MINGGU, JAKARTA SELATAN, DKI JAKARTA",98,132,101,233
https://kawalpemilu.org#26020,"KEBAGUSAN, PASAR MINGGU, JAKARTA SELATAN, DKI JAKARTA",99,118,97,215
https://kawalpemilu.org#26020,"KEBAGUSAN, PASAR MINGGU, JAKARTA SELATAN, DKI JAKARTA",100,125,125,250
https://kawalpemilu.org#26020,"KEBAGUSAN, PASAR MINGGU, JAKARTA SELATAN, DKI JAKARTA",101,108,116,224
https://kawalpemilu.org#26020,"KEBAGUSAN, PASAR MINGGU, JAKARTA SELATAN, DKI JAKARTA",102,108,121,229
https://kawalpemilu.org#26020,"KEBAGUSAN, PASAR MINGGU, JAKARTA SELATAN, DKI JAKARTA",103,71,115,186
https://kawalpemilu.org#26020,"KEBAGUSAN, PASAR MINGGU, JAKARTA SELATAN, DKI JAKARTA",104,120,112,232
https://kawalpemilu.org#26020,"KEBAGUSAN, PASAR MINGGU, JAKARTA SELATAN, DKI JAKARTA",105,128,118,246
https://kawalpemilu.org#26020,"KEBAGUSAN, PASAR MINGGU, JAKARTA SELATAN, DKI JAKARTA",106,105,113,218
https://kawalpemilu.org#26020,"KEBAGUSAN, PASAR MINGGU, JAKARTA SELATAN, DKI JAKARTA",107,61,117,178
https://kawalpemilu.org#26020,"KEBAGUSAN, PASAR MINGGU, JAKARTA SELATAN, DKI JAKARTA",108,77,98,175
https://kawalpemilu.org#26020,"KEBAGUSAN, PASAR MINGGU, JAKARTA SELATAN, DKI JAKARTA",109,125,118,243
https://kawalpemilu.org#26020,"KEBAGUSAN, PASAR MINGGU, JAKARTA SELATAN, DKI JAKARTA",110,121,86,207
https://kawalpemilu.org#26020,"KEBAGUSAN, PASAR MINGGU, JAKARTA SELATAN, DKI JAKARTA",111,139,105,244
https://kawalpemilu.org#26020,"KEBAGUSAN, PASAR MINGGU, JAKARTA SELATAN, DKI JAKARTA",112,119,76,195
https://kawalpemilu.org#26020,"KEBAGUSAN, PASAR MINGGU, JAKARTA SELATAN, DKI JAKARTA",113,120,126,246
https://kawalpemilu.org#26020,"KEBAGUSAN, PASAR MINGGU, JAKARTA SELATAN, DKI JAKARTA",114,113,99,212
https://kawalpemilu.org#26020,"KEBAGUSAN, PASAR MINGGU, JAKARTA SELATAN, DKI JAKARTA",115,102,116,218
https://kawalpemilu.org#26020,"KEBAGUSAN, PASAR MINGGU, JAKARTA SELATAN, DKI JAKARTA",116,86,139,225
https://kawalpemilu.org#26020,"KEBAGUSAN, PASAR MINGGU, JAKARTA SELATAN, DKI JAKARTA",117,144,113,257
https://kawalpemilu.org#26020,"KEBAGUSAN, PASAR MINGGU, JAKARTA SELATAN, DKI JAKARTA",118,127,120,247
https://kawalpemilu.org#26020,"KEBAGUSAN, PASAR MINGGU, JAKARTA SELATAN, DKI JAKARTA",119,72,139,211
https://kawalpemilu.org#26020,"KEBAGUSAN, PASAR MINGGU, JAKARTA SELATAN, DKI JAKARTA",120,86,126,212
https://kawalpemilu.org#26020,"KEBAGUSAN, PASAR MINGGU, JAKARTA SELATAN, DKI JAKARTA",121,108,107,215
https://kawalpemilu.org#26020,"KEBAGUSAN, PASAR MINGGU, JAKARTA SELATAN, DKI JAKARTA",122,105,99,204
https://kawalpemilu.org#26020,"KEBAGUSAN, PASAR MINGGU, JAKARTA SELATAN, DKI JAKARTA",123,114,129,243
https://kawalpemilu.org#26020,"KEBAGUSAN, PASAR MINGGU, JAKARTA SELATAN, DKI JAKARTA",124,103,129,232
https://kawalpemilu.org#26020,"KEBAGUSAN, PASAR MINGGU, JAKARTA SELATAN, DKI JAKARTA",125,129,122,251
https://kawalpemilu.org#26020,"KEBAGUSAN, PASAR MINGGU, JAKARTA SELATAN, DKI JAKARTA",126,124,157,281
https://kawalpemilu.org#26020,"KEBAGUSAN, PASAR MINGGU, JAKARTA SELATAN, DKI JAKARTA",127,83,127,210
https://kawalpemilu.org#26020,"KEBAGUSAN, PASAR MINGGU, JAKARTA SELATAN, DKI JAKARTA",128,85,136,221
https://kawalpemilu.org#26020,"KEBAGUSAN, PASAR MINGGU, JAKARTA SELATAN, DKI JAKARTA",129,79,116,195
https://kawalpemilu.org#26020,"KEBAGUSAN, PASAR MINGGU, JAKARTA SELATAN, DKI JAKARTA",130,144,129,273
https://kawalpemilu.org#26020,"KEBAGUSAN, PASAR MINGGU, JAKARTA SELATAN, DKI JAKARTA",131,117,108,225
https://kawalpemilu.org#26020,"KEBAGUSAN, PASAR MINGGU, JAKARTA SELATAN, DKI JAKARTA",132,102,134,236
https://kawalpemilu.org#26020,"KEBAGUSAN, PASAR MINGGU, JAKARTA SELATAN, DKI JAKARTA",133,99,136,235
https://kawalpemilu.org#26020,"KEBAGUSAN, PASAR MINGGU, JAKARTA SELATAN, DKI JAKARTA",134,100,144,244
https://kawalpemilu.org#26020,"KEBAGUSAN, PASAR MINGGU, JAKARTA SELATAN, DKI JAKARTA",135,81,93,174
https://kawalpemilu.org#26020,"KEBAGUSAN, PASAR MINGGU, JAKARTA SELATAN, DKI JAKARTA",136,118,143,261
https://kawalpemilu.org#26020,"KEBAGUSAN, PASAR MINGGU, JAKARTA SELATAN, DKI JAKARTA",137,111,120,231
https://kawalpemilu.org#26020,"KEBAGUSAN, PASAR MINGGU, JAKARTA SELATAN, DKI JAKARTA",138,112,129,241
https://kawalpemilu.org#26020,"KEBAGUSAN, PASAR MINGGU, JAKARTA SELATAN, DKI JAKARTA",139,98,129,227
https://kawalpemilu.org#26020,"KEBAGUSAN, PASAR MINGGU, JAKARTA SELATAN, DKI JAKARTA",140,105,133,238
https://kawalpemilu.org#26020,"KEBAGUSAN, PASAR MINGGU, JAKARTA SELATAN, DKI JAKARTA",141,128,119,247
https://kawalpemilu.org#26022,"KEBAYORAN LAMA UTARA, KEBAYORAN LAMA, JAKARTA SELATAN, DKI JAKARTA",2,109,70,179
https://kawalpemilu.org#26022,"KEBAYORAN LAMA UTARA, KEBAYORAN LAMA, JAKARTA SELATAN, DKI JAKARTA",5,125,77,202
https://kawalpemilu.org#26022,"KEBAYORAN LAMA UTARA, KEBAYORAN LAMA, JAKARTA SELATAN, DKI JAKARTA",16,88,84,172
https://kawalpemilu.org#26022,"KEBAYORAN LAMA UTARA, KEBAYORAN LAMA, JAKARTA SELATAN, DKI JAKARTA",18,86,65,151
https://kawalpemilu.org#26022,"KEBAYORAN LAMA UTARA, KEBAYORAN LAMA, JAKARTA SELATAN, DKI JAKARTA",19,73,60,133
https://kawalpemilu.org#26022,"KEBAYORAN LAMA UTARA, KEBAYORAN LAMA, JAKARTA SELATAN, DKI JAKARTA",24,146,76,222
https://kawalpemilu.org#26022,"KEBAYORAN LAMA UTARA, KEBAYORAN LAMA, JAKARTA SELATAN, DKI JAKARTA",25,97,64,161
https://kawalpemilu.org#26022,"KEBAYORAN LAMA UTARA, KEBAYORAN LAMA, JAKARTA SELATAN, DKI JAKARTA",30,87,60,147
https://kawalpemilu.org#26022,"KEBAYORAN LAMA UTARA, KEBAYORAN LAMA, JAKARTA SELATAN, DKI JAKARTA",31,102,86,188
https://kawalpemilu.org#26022,"KEBAYORAN LAMA UTARA, KEBAYORAN LAMA, JAKARTA SELATAN, DKI JAKARTA",33,145,61,206
https://kawalpemilu.org#26022,"KEBAYORAN LAMA UTARA, KEBAYORAN LAMA, JAKARTA SELATAN, DKI JAKARTA",37,130,71,201
https://kawalpemilu.org#26022,"KEBAYORAN LAMA UTARA, KEBAYORAN LAMA, JAKARTA SELATAN, DKI JAKARTA",38,154,91,245
https://kawalpemilu.org#26022,"KEBAYORAN LAMA UTARA, KEBAYORAN LAMA, JAKARTA SELATAN, DKI JAKARTA",39,139,90,229
https://kawalpemilu.org#26022,"KEBAYORAN LAMA UTARA, KEBAYORAN LAMA, JAKARTA SELATAN, DKI JAKARTA",40,125,80,205
https://kawalpemilu.org#26022,"KEBAYORAN LAMA UTARA, KEBAYORAN LAMA, JAKARTA SELATAN, DKI JAKARTA",41,131,85,216
https://kawalpemilu.org#26022,"KEBAYORAN LAMA UTARA, KEBAYORAN LAMA, JAKARTA SELATAN, DKI JAKARTA",43,118,68,186
https://kawalpemilu.org#26022,"KEBAYORAN LAMA UTARA, KEBAYORAN LAMA, JAKARTA SELATAN, DKI JAKARTA",44,91,119,210
https://kawalpemilu.org#26022,"KEBAYORAN LAMA UTARA, KEBAYORAN LAMA, JAKARTA SELATAN, DKI JAKARTA",48,102,72,174
https://kawalpemilu.org#26022,"KEBAYORAN LAMA UTARA, KEBAYORAN LAMA, JAKARTA SELATAN, DKI JAKARTA",49,146,89,235
https://kawalpemilu.org#26022,"KEBAYORAN LAMA UTARA, KEBAYORAN LAMA, JAKARTA SELATAN, DKI JAKARTA",50,118,93,211
https://kawalpemilu.org#26022,"KEBAYORAN LAMA UTARA, KEBAYORAN LAMA, JAKARTA SELATAN, DKI JAKARTA",51,85,90,175
https://kawalpemilu.org#26022,"KEBAYORAN LAMA UTARA, KEBAYORAN LAMA, JAKARTA SELATAN, DKI JAKARTA",54,102,121,223
https://kawalpemilu.org#26022,"KEBAYORAN LAMA UTARA, KEBAYORAN LAMA, JAKARTA SELATAN, DKI JAKARTA",55,106,125,231
https://kawalpemilu.org#26022,"KEBAYORAN LAMA UTARA, KEBAYORAN LAMA, JAKARTA SELATAN, DKI JAKARTA",57,103,89,192
https://kawalpemilu.org#26022,"KEBAYORAN LAMA UTARA, KEBAYORAN LAMA, JAKARTA SELATAN, DKI JAKARTA",58,98,75,173
https://kawalpemilu.org#26022,"KEBAYORAN LAMA UTARA, KEBAYORAN LAMA, JAKARTA SELATAN, DKI JAKARTA",59,133,91,224
https://kawalpemilu.org#26022,"KEBAYORAN LAMA UTARA, KEBAYORAN LAMA, JAKARTA SELATAN, DKI JAKARTA",63,142,97,239
https://kawalpemilu.org#26022,"KEBAYORAN LAMA UTARA, KEBAYORAN LAMA, JAKARTA SELATAN, DKI JAKARTA",64,147,84,231
https://kawalpemilu.org#26022,"KEBAYORAN LAMA UTARA, KEBAYORAN LAMA, JAKARTA SELATAN, DKI JAKARTA",72,107,117,224
https://kawalpemilu.org#26022,"KEBAYORAN LAMA UTARA, KEBAYORAN LAMA, JAKARTA SELATAN, DKI JAKARTA",73,116,99,215
https://kawalpemilu.org#26022,"KEBAYORAN LAMA UTARA, KEBAYORAN LAMA, JAKARTA SELATAN, DKI JAKARTA",74,124,80,204
https://kawalpemilu.org#26022,"KEBAYORAN LAMA UTARA, KEBAYORAN LAMA, JAKARTA SELATAN, DKI JAKARTA",75,118,94,212
https://kawalpemilu.org#26022,"KEBAYORAN LAMA UTARA, KEBAYORAN LAMA, JAKARTA SELATAN, DKI JAKARTA",76,106,94,200
https://kawalpemilu.org#26022,"KEBAYORAN LAMA UTARA, KEBAYORAN LAMA, JAKARTA SELATAN, DKI JAKARTA",77,107,73,180
https://kawalpemilu.org#26022,"KEBAYORAN LAMA UTARA, KEBAYORAN LAMA, JAKARTA SELATAN, DKI JAKARTA",79,80,103,183
https://kawalpemilu.org#26022,"KEBAYORAN LAMA UTARA, KEBAYORAN LAMA, JAKARTA SELATAN, DKI JAKARTA",81,90,131,221
https://kawalpemilu.org#26022,"KEBAYORAN LAMA UTARA, KEBAYORAN LAMA, JAKARTA SELATAN, DKI JAKARTA",83,92,101,193
https://kawalpemilu.org#26022,"KEBAYORAN LAMA UTARA, KEBAYORAN LAMA, JAKARTA SELATAN, DKI JAKARTA",85,89,107,196
https://kawalpemilu.org#26022,"KEBAYORAN LAMA UTARA, KEBAYORAN LAMA, JAKARTA SELATAN, DKI JAKARTA",86,89,101,190
https://kawalpemilu.org#26022,"KEBAYORAN LAMA UTARA, KEBAYORAN LAMA, JAKARTA SELATAN, DKI JAKARTA",87,87,114,201
https://kawalpemilu.org#26022,"KEBAYORAN LAMA UTARA, KEBAYORAN LAMA, JAKARTA SELATAN, DKI JAKARTA",89,123,89,212
https://kawalpemilu.org#26022,"KEBAYORAN LAMA UTARA, KEBAYORAN LAMA, JAKARTA SELATAN, DKI JAKARTA",90,71,108,179
https://kawalpemilu.org#26022,"KEBAYORAN LAMA UTARA, KEBAYORAN LAMA, JAKARTA SELATAN, DKI JAKARTA",92,130,94,224
https://kawalpemilu.org#26022,"KEBAYORAN LAMA UTARA, KEBAYORAN LAMA, JAKARTA SELATAN, DKI JAKARTA",94,163,24,187
https://kawalpemilu.org#26022,"KEBAYORAN LAMA UTARA, KEBAYORAN LAMA, JAKARTA SELATAN, DKI JAKARTA",97,138,56,194
https://kawalpemilu.org#26022,"KEBAYORAN LAMA UTARA, KEBAYORAN LAMA, JAKARTA SELATAN, DKI JAKARTA",102,157,50,207
https://kawalpemilu.org#26022,"KEBAYORAN LAMA UTARA, KEBAYORAN LAMA, JAKARTA SELATAN, DKI JAKARTA",105,128,95,223
https://kawalpemilu.org#26022,"KEBAYORAN LAMA UTARA, KEBAYORAN LAMA, JAKARTA SELATAN, DKI JAKARTA",106,149,70,219
https://kawalpemilu.org#26022,"KEBAYORAN LAMA UTARA, KEBAYORAN LAMA, JAKARTA SELATAN, DKI JAKARTA",107,130,66,196
https://kawalpemilu.org#26022,"KEBAYORAN LAMA UTARA, KEBAYORAN LAMA, JAKARTA SELATAN, DKI JAKARTA",108,185,44,229
https://kawalpemilu.org#26022,"KEBAYORAN LAMA UTARA, KEBAYORAN LAMA, JAKARTA SELATAN, DKI JAKARTA",109,163,70,233
https://kawalpemilu.org#26022,"KEBAYORAN LAMA UTARA, KEBAYORAN LAMA, JAKARTA SELATAN, DKI JAKARTA",110,169,73,242
https://kawalpemilu.org#26022,"KEBAYORAN LAMA UTARA, KEBAYORAN LAMA, JAKARTA SELATAN, DKI JAKARTA",117,156,75,231
https://kawalpemilu.org#26022,"KEBAYORAN LAMA UTARA, KEBAYORAN LAMA, JAKARTA SELATAN, DKI JAKARTA",118,143,105,248
https://kawalpemilu.org#26022,"KEBAYORAN LAMA UTARA, KEBAYORAN LAMA, JAKARTA SELATAN, DKI JAKARTA",119,134,79,213
https://kawalpemilu.org#26022,"KEBAYORAN LAMA UTARA, KEBAYORAN LAMA, JAKARTA SELATAN, DKI JAKARTA",120,126,76,202
https://kawalpemilu.org#26022,"KEBAYORAN LAMA UTARA, KEBAYORAN LAMA, JAKARTA SELATAN, DKI JAKARTA",122,147,68,215
https://kawalpemilu.org#26022,"KEBAYORAN LAMA UTARA, KEBAYORAN LAMA, JAKARTA SELATAN, DKI JAKARTA",123,152,72,224
https://kawalpemilu.org#26022,"KEBAYORAN LAMA UTARA, KEBAYORAN LAMA, JAKARTA SELATAN, DKI JAKARTA",124,145,94,239
https://kawalpemilu.org#26022,"KEBAYORAN LAMA UTARA, KEBAYORAN LAMA, JAKARTA SELATAN, DKI JAKARTA",125,136,88,224
https://kawalpemilu.org#26022,"KEBAYORAN LAMA UTARA, KEBAYORAN LAMA, JAKARTA SELATAN, DKI JAKARTA",126,138,113,251
https://kawalpemilu.org#26022,"KEBAYORAN LAMA UTARA, KEBAYORAN LAMA, JAKARTA SELATAN, DKI JAKARTA",128,143,106,249
https://kawalpemilu.org#26022,"KEBAYORAN LAMA UTARA, KEBAYORAN LAMA, JAKARTA SELATAN, DKI JAKARTA",131,104,136,240
https://kawalpemilu.org#26022,"KEBAYORAN LAMA UTARA, KEBAYORAN LAMA, JAKARTA SELATAN, DKI JAKARTA",132,87,123,210
https://kawalpemilu.org#26022,"KEBAYORAN LAMA UTARA, KEBAYORAN LAMA, JAKARTA SELATAN, DKI JAKARTA",136,73,156,229
https://kawalpemilu.org#26022,"KEBAYORAN LAMA UTARA, KEBAYORAN LAMA, JAKARTA SELATAN, DKI JAKARTA",137,98,102,200
https://kawalpemilu.org#26022,"KEBAYORAN LAMA UTARA, KEBAYORAN LAMA, JAKARTA SELATAN, DKI JAKARTA",138,129,104,233
https://kawalpemilu.org#26022,"KEBAYORAN LAMA UTARA, KEBAYORAN LAMA, JAKARTA SELATAN, DKI JAKARTA",139,107,109,216
https://kawalpemilu.org#26022,"KEBAYORAN LAMA UTARA, KEBAYORAN LAMA, JAKARTA SELATAN, DKI JAKARTA",140,109,140,249
https://kawalpemilu.org#26022,"KEBAYORAN LAMA UTARA, KEBAYORAN LAMA, JAKARTA SELATAN, DKI JAKARTA",143,124,104,228
https://kawalpemilu.org#26022,"KEBAYORAN LAMA UTARA, KEBAYORAN LAMA, JAKARTA SELATAN, DKI JAKARTA",144,49,60,109
https://kawalpemilu.org#26023,"PONDOK PINANG, KEBAYORAN LAMA, JAKARTA SELATAN, DKI JAKARTA",2,102,118,220
https://kawalpemilu.org#26023,"PONDOK PINANG, KEBAYORAN LAMA, JAKARTA SELATAN, DKI JAKARTA",5,69,144,213
https://kawalpemilu.org#26023,"PONDOK PINANG, KEBAYORAN LAMA, JAKARTA SELATAN, DKI JAKARTA",7,79,140,219
https://kawalpemilu.org#26023,"PONDOK PINANG, KEBAYORAN LAMA, JAKARTA SELATAN, DKI JAKARTA",8,93,119,212
https://kawalpemilu.org#26023,"PONDOK PINANG, KEBAYORAN LAMA, JAKARTA SELATAN, DKI JAKARTA",9,105,151,256
https://kawalpemilu.org#26023,"PONDOK PINANG, KEBAYORAN LAMA, JAKARTA SELATAN, DKI JAKARTA",13,89,160,249
https://kawalpemilu.org#26023,"PONDOK PINANG, KEBAYORAN LAMA, JAKARTA SELATAN, DKI JAKARTA",14,97,156,253
https://kawalpemilu.org#26023,"PONDOK PINANG, KEBAYORAN LAMA, JAKARTA SELATAN, DKI JAKARTA",15,101,139,240
https://kawalpemilu.org#26023,"PONDOK PINANG, KEBAYORAN LAMA, JAKARTA SELATAN, DKI JAKARTA",16,90,144,234
https://kawalpemilu.org#26023,"PONDOK PINANG, KEBAYORAN LAMA, JAKARTA SELATAN, DKI JAKARTA",17,125,115,240
https://kawalpemilu.org#26023,"PONDOK PINANG, KEBAYORAN LAMA, JAKARTA SELATAN, DKI JAKARTA",18,107,124,231
https://kawalpemilu.org#26023,"PONDOK PINANG, KEBAYORAN LAMA, JAKARTA SELATAN, DKI JAKARTA",19,77,177,254
https://kawalpemilu.org#26023,"PONDOK PINANG, KEBAYORAN LAMA, JAKARTA SELATAN, DKI JAKARTA",22,128,107,235
https://kawalpemilu.org#26023,"PONDOK PINANG, KEBAYORAN LAMA, JAKARTA SELATAN, DKI JAKARTA",23,114,108,222
https://kawalpemilu.org#26023,"PONDOK PINANG, KEBAYORAN LAMA, JAKARTA SELATAN, DKI JAKARTA",24,98,164,262
https://kawalpemilu.org#26023,"PONDOK PINANG, KEBAYORAN LAMA, JAKARTA SELATAN, DKI JAKARTA",26,102,108,210
https://kawalpemilu.org#26023,"PONDOK PINANG, KEBAYORAN LAMA, JAKARTA SELATAN, DKI JAKARTA",27,90,126,216
https://kawalpemilu.org#26023,"PONDOK PINANG, KEBAYORAN LAMA, JAKARTA SELATAN, DKI JAKARTA",28,88,151,239
https://kawalpemilu.org#26023,"PONDOK PINANG, KEBAYORAN LAMA, JAKARTA SELATAN, DKI JAKARTA",32,103,143,246
https://kawalpemilu.org#26023,"PONDOK PINANG, KEBAYORAN LAMA, JAKARTA SELATAN, DKI JAKARTA",34,91,137,228
https://kawalpemilu.org#26023,"PONDOK PINANG, KEBAYORAN LAMA, JAKARTA SELATAN, DKI JAKARTA",35,96,146,242
https://kawalpemilu.org#26023,"PONDOK PINANG, KEBAYORAN LAMA, JAKARTA SELATAN, DKI JAKARTA",36,69,193,262
https://kawalpemilu.org#26023,"PONDOK PINANG, KEBAYORAN LAMA, JAKARTA SELATAN, DKI JAKARTA",39,81,139,220
https://kawalpemilu.org#26023,"PONDOK PINANG, KEBAYORAN LAMA, JAKARTA SELATAN, DKI JAKARTA",40,85,132,217
https://kawalpemilu.org#26023,"PONDOK PINANG, KEBAYORAN LAMA, JAKARTA SELATAN, DKI JAKARTA",41,101,122,223
https://kawalpemilu.org#26023,"PONDOK PINANG, KEBAYORAN LAMA, JAKARTA SELATAN, DKI JAKARTA",42,87,137,224
https://kawalpemilu.org#26023,"PONDOK PINANG, KEBAYORAN LAMA, JAKARTA SELATAN, DKI JAKARTA",43,119,142,261
https://kawalpemilu.org#26023,"PONDOK PINANG, KEBAYORAN LAMA, JAKARTA SELATAN, DKI JAKARTA",44,115,120,235
https://kawalpemilu.org#26023,"PONDOK PINANG, KEBAYORAN LAMA, JAKARTA SELATAN, DKI JAKARTA",45,88,125,213
https://kawalpemilu.org#26023,"PONDOK PINANG, KEBAYORAN LAMA, JAKARTA SELATAN, DKI JAKARTA",46,95,115,210
https://kawalpemilu.org#26023,"PONDOK PINANG, KEBAYORAN LAMA, JAKARTA SELATAN, DKI JAKARTA",47,71,117,188
https://kawalpemilu.org#26023,"PONDOK PINANG, KEBAYORAN LAMA, JAKARTA SELATAN, DKI JAKARTA",48,118,113,231
https://kawalpemilu.org#26023,"PONDOK PINANG, KEBAYORAN LAMA, JAKARTA SELATAN, DKI JAKARTA",49,160,77,237
https://kawalpemilu.org#26023,"PONDOK PINANG, KEBAYORAN LAMA, JAKARTA SELATAN, DKI JAKARTA",50,194,55,249
https://kawalpemilu.org#26023,"PONDOK PINANG, KEBAYORAN LAMA, JAKARTA SELATAN, DKI JAKARTA",51,183,57,240
https://kawalpemilu.org#26023,"PONDOK PINANG, KEBAYORAN LAMA, JAKARTA SELATAN, DKI JAKARTA",52,171,45,216
https://kawalpemilu.org#26023,"PONDOK PINANG, KEBAYORAN LAMA, JAKARTA SELATAN, DKI JAKARTA",53,60,200,260
https://kawalpemilu.org#26023,"PONDOK PINANG, KEBAYORAN LAMA, JAKARTA SELATAN, DKI JAKARTA",55,127,110,237
https://kawalpemilu.org#26023,"PONDOK PINANG, KEBAYORAN LAMA, JAKARTA SELATAN, DKI JAKARTA",56,137,122,259
https://kawalpemilu.org#26023,"PONDOK PINANG, KEBAYORAN LAMA, JAKARTA SELATAN, DKI JAKARTA",57,117,163,280
https://kawalpemilu.org#26023,"PONDOK PINANG, KEBAYORAN LAMA, JAKARTA SELATAN, DKI JAKARTA",58,94,142,236
https://kawalpemilu.org#26023,"PONDOK PINANG, KEBAYORAN LAMA, JAKARTA SELATAN, DKI JAKARTA",59,114,151,265
https://kawalpemilu.org#26023,"PONDOK PINANG, KEBAYORAN LAMA, JAKARTA SELATAN, DKI JAKARTA",60,69,183,252
https://kawalpemilu.org#26023,"PONDOK PINANG, KEBAYORAN LAMA, JAKARTA SELATAN, DKI JAKARTA",61,68,192,260
https://kawalpemilu.org#26023,"PONDOK PINANG, KEBAYORAN LAMA, JAKARTA SELATAN, DKI JAKARTA",62,143,86,229
https://kawalpemilu.org#26023,"PONDOK PINANG, KEBAYORAN LAMA, JAKARTA SELATAN, DKI JAKARTA",63,142,106,248
https://kawalpemilu.org#26023,"PONDOK PINANG, KEBAYORAN LAMA, JAKARTA SELATAN, DKI JAKARTA",64,116,115,231
https://kawalpemilu.org#26023,"PONDOK PINANG, KEBAYORAN LAMA, JAKARTA SELATAN, DKI JAKARTA",65,108,122,230
https://kawalpemilu.org#26023,"PONDOK PINANG, KEBAYORAN LAMA, JAKARTA SELATAN, DKI JAKARTA",66,121,123,244
https://kawalpemilu.org#26023,"PONDOK PINANG, KEBAYORAN LAMA, JAKARTA SELATAN, DKI JAKARTA",67,120,141,261
https://kawalpemilu.org#26023,"PONDOK PINANG, KEBAYORAN LAMA, JAKARTA SELATAN, DKI JAKARTA",68,130,122,252
https://kawalpemilu.org#26023,"PONDOK PINANG, KEBAYORAN LAMA, JAKARTA SELATAN, DKI JAKARTA",69,120,137,257
https://kawalpemilu.org#26023,"PONDOK PINANG, KEBAYORAN LAMA, JAKARTA SELATAN, DKI JAKARTA",70,152,98,250
https://kawalpemilu.org#26023,"PONDOK PINANG, KEBAYORAN LAMA, JAKARTA SELATAN, DKI JAKARTA",71,146,94,240
https://kawalpemilu.org#26023,"PONDOK PINANG, KEBAYORAN LAMA, JAKARTA SELATAN, DKI JAKARTA",72,157,81,238
https://kawalpemilu.org#26023,"PONDOK PINANG, KEBAYORAN LAMA, JAKARTA SELATAN, DKI JAKARTA",73,178,94,272
https://kawalpemilu.org#26023,"PONDOK PINANG, KEBAYORAN LAMA, JAKARTA SELATAN, DKI JAKARTA",75,82,124,206
https://kawalpemilu.org#26023,"PONDOK PINANG, KEBAYORAN LAMA, JAKARTA SELATAN, DKI JAKARTA",76,51,131,182
https://kawalpemilu.org#26023,"PONDOK PINANG, KEBAYORAN LAMA, JAKARTA SELATAN, DKI JAKARTA",77,78,129,207
https://kawalpemilu.org#26023,"PONDOK PINANG, KEBAYORAN LAMA, JAKARTA SELATAN, DKI JAKARTA",78,66,162,228
https://kawalpemilu.org#26023,"PONDOK PINANG, KEBAYORAN LAMA, JAKARTA SELATAN, DKI JAKARTA",79,106,147,253
https://kawalpemilu.org#26023,"PONDOK PINANG, KEBAYORAN LAMA, JAKARTA SELATAN, DKI JAKARTA",80,106,159,265
https://kawalpemilu.org#26023,"PONDOK PINANG, KEBAYORAN LAMA, JAKARTA SELATAN, DKI JAKARTA",81,121,115,236
https://kawalpemilu.org#26023,"PONDOK PINANG, KEBAYORAN LAMA, JAKARTA SELATAN, DKI JAKARTA",82,85,172,257
https://kawalpemilu.org#26023,"PONDOK PINANG, KEBAYORAN LAMA, JAKARTA SELATAN, DKI JAKARTA",83,100,111,211
https://kawalpemilu.org#26023,"PONDOK PINANG, KEBAYORAN LAMA, JAKARTA SELATAN, DKI JAKARTA",84,117,119,236
https://kawalpemilu.org#26023,"PONDOK PINANG, KEBAYORAN LAMA, JAKARTA SELATAN, DKI JAKARTA",85,100,148,248
https://kawalpemilu.org#26023,"PONDOK PINANG, KEBAYORAN LAMA, JAKARTA SELATAN, DKI JAKARTA",86,111,130,241
https://kawalpemilu.org#26023,"PONDOK PINANG, KEBAYORAN LAMA, JAKARTA SELATAN, DKI JAKARTA",88,159,106,265
https://kawalpemilu.org#26023,"PONDOK PINANG, KEBAYORAN LAMA, JAKARTA SELATAN, DKI JAKARTA",89,140,90,230
https://kawalpemilu.org#26023,"PONDOK PINANG, KEBAYORAN LAMA, JAKARTA SELATAN, DKI JAKARTA",90,134,113,247
https://kawalpemilu.org#26023,"PONDOK PINANG, KEBAYORAN LAMA, JAKARTA SELATAN, DKI JAKARTA",91,162,85,247
https://kawalpemilu.org#26023,"PONDOK PINANG, KEBAYORAN LAMA, JAKARTA SELATAN, DKI JAKARTA",94,134,112,246
https://kawalpemilu.org#26023,"PONDOK PINANG, KEBAYORAN LAMA, JAKARTA SELATAN, DKI JAKARTA",95,88,131,219
https://kawalpemilu.org#26023,"PONDOK PINANG, KEBAYORAN LAMA, JAKARTA SELATAN, DKI JAKARTA",96,121,128,249
https://kawalpemilu.org#26023,"PONDOK PINANG, KEBAYORAN LAMA, JAKARTA SELATAN, DKI JAKARTA",97,88,239,239
https://kawalpemilu.org#26023,"PONDOK PINANG, KEBAYORAN LAMA, JAKARTA SELATAN, DKI JAKARTA",98,84,155,239
https://kawalpemilu.org#26023,"PONDOK PINANG, KEBAYORAN LAMA, JAKARTA SELATAN, DKI JAKARTA",99,108,136,244
https://kawalpemilu.org#26023,"PONDOK PINANG, KEBAYORAN LAMA, JAKARTA SELATAN, DKI JAKARTA",100,81,158,239
https://kawalpemilu.org#26023,"PONDOK PINANG, KEBAYORAN LAMA, JAKARTA SELATAN, DKI JAKARTA",101,88,170,258
https://kawalpemilu.org#26023,"PONDOK PINANG, KEBAYORAN LAMA, JAKARTA SELATAN, DKI JAKARTA",102,82,176,258
https://kawalpemilu.org#26023,"PONDOK PINANG, KEBAYORAN LAMA, JAKARTA SELATAN, DKI JAKARTA",103,67,144,211
https://kawalpemilu.org#26023,"PONDOK PINANG, KEBAYORAN LAMA, JAKARTA SELATAN, DKI JAKARTA",104,62,156,218
https://kawalpemilu.org#26023,"PONDOK PINANG, KEBAYORAN LAMA, JAKARTA SELATAN, DKI JAKARTA",106,127,133,260
https://kawalpemilu.org#26023,"PONDOK PINANG, KEBAYORAN LAMA, JAKARTA SELATAN, DKI JAKARTA",107,103,128,231
https://kawalpemilu.org#26023,"PONDOK PINANG, KEBAYORAN LAMA, JAKARTA SELATAN, DKI JAKARTA",108,101,144,245
https://kawalpemilu.org#26023,"PONDOK PINANG, KEBAYORAN LAMA, JAKARTA SELATAN, DKI JAKARTA",109,92,173,265
https://kawalpemilu.org#26023,"PONDOK PINANG, KEBAYORAN LAMA, JAKARTA SELATAN, DKI JAKARTA",110,159,70,229
https://kawalpemilu.org#26023,"PONDOK PINANG, KEBAYORAN LAMA, JAKARTA SELATAN, DKI JAKARTA",111,171,69,240
https://kawalpemilu.org#26023,"PONDOK PINANG, KEBAYORAN LAMA, JAKARTA SELATAN, DKI JAKARTA",112,152,93,245
https://kawalpemilu.org#26023,"PONDOK PINANG, KEBAYORAN LAMA, JAKARTA SELATAN, DKI JAKARTA",113,162,107,269
https://kawalpemilu.org#26023,"PONDOK PINANG, KEBAYORAN LAMA, JAKARTA SELATAN, DKI JAKARTA",114,179,63,242
https://kawalpemilu.org#26023,"PONDOK PINANG, KEBAYORAN LAMA, JAKARTA SELATAN, DKI JAKARTA",115,157,83,240
https://kawalpemilu.org#26023,"PONDOK PINANG, KEBAYORAN LAMA, JAKARTA SELATAN, DKI JAKARTA",116,134,89,223
https://kawalpemilu.org#26023,"PONDOK PINANG, KEBAYORAN LAMA, JAKARTA SELATAN, DKI JAKARTA",117,146,88,234
https://kawalpemilu.org#26023,"PONDOK PINANG, KEBAYORAN LAMA, JAKARTA SELATAN, DKI JAKARTA",118,111,113,224
https://kawalpemilu.org#26023,"PONDOK PINANG, KEBAYORAN LAMA, JAKARTA SELATAN, DKI JAKARTA",119,131,84,215
https://kawalpemilu.org#26023,"PONDOK PINANG, KEBAYORAN LAMA, JAKARTA SELATAN, DKI JAKARTA",120,116,84,200
https://kawalpemilu.org#26023,"PONDOK PINANG, KEBAYORAN LAMA, JAKARTA SELATAN, DKI JAKARTA",121,118,106,224
https://kawalpemilu.org#26023,"PONDOK PINANG, KEBAYORAN LAMA, JAKARTA SELATAN, DKI JAKARTA",122,110,116,226
https://kawalpemilu.org#26023,"PONDOK PINANG, KEBAYORAN LAMA, JAKARTA SELATAN, DKI JAKARTA",123,130,87,217
https://kawalpemilu.org#26023,"PONDOK PINANG, KEBAYORAN LAMA, JAKARTA SELATAN, DKI JAKARTA",124,138,101,239
https://kawalpemilu.org#26023,"PONDOK PINANG, KEBAYORAN LAMA, JAKARTA SELATAN, DKI JAKARTA",125,74,162,236
https://kawalpemilu.org#26023,"PONDOK PINANG, KEBAYORAN LAMA, JAKARTA SELATAN, DKI JAKARTA",126,70,173,243
https://kawalpemilu.org#26023,"PONDOK PINANG, KEBAYORAN LAMA, JAKARTA SELATAN, DKI JAKARTA",127,110,117,227
https://kawalpemilu.org#26023,"PONDOK PINANG, KEBAYORAN LAMA, JAKARTA SELATAN, DKI JAKARTA",128,103,133,236
https://kawalpemilu.org#26023,"PONDOK PINANG, KEBAYORAN LAMA, JAKARTA SELATAN, DKI JAKARTA",129,85,162,247
https://kawalpemilu.org#26023,"PONDOK PINANG, KEBAYORAN LAMA, JAKARTA SELATAN, DKI JAKARTA",130,104,145,249
https://kawalpemilu.org#26023,"PONDOK PINANG, KEBAYORAN LAMA, JAKARTA SELATAN, DKI JAKARTA",131,121,129,250
https://kawalpemilu.org#26023,"PONDOK PINANG, KEBAYORAN LAMA, JAKARTA SELATAN, DKI JAKARTA",132,77,173,250
https://kawalpemilu.org#26023,"PONDOK PINANG, KEBAYORAN LAMA, JAKARTA SELATAN, DKI JAKARTA",133,122,101,223
https://kawalpemilu.org#26023,"PONDOK PINANG, KEBAYORAN LAMA, JAKARTA SELATAN, DKI JAKARTA",134,134,109,243
https://kawalpemilu.org#26023,"PONDOK PINANG, KEBAYORAN LAMA, JAKARTA SELATAN, DKI JAKARTA",135,101,129,230
https://kawalpemilu.org#26023,"PONDOK PINANG, KEBAYORAN LAMA, JAKARTA SELATAN, DKI JAKARTA",139,58,170,228
https://kawalpemilu.org#26023,"PONDOK PINANG, KEBAYORAN LAMA, JAKARTA SELATAN, DKI JAKARTA",141,0,0,0
https://kawalpemilu.org#26023,"PONDOK PINANG, KEBAYORAN LAMA, JAKARTA SELATAN, DKI JAKARTA",143,100,108,208
https://kawalpemilu.org#26023,"PONDOK PINANG, KEBAYORAN LAMA, JAKARTA SELATAN, DKI JAKARTA",145,200,35,235
https://kawalpemilu.org#26023,"PONDOK PINANG, KEBAYORAN LAMA, JAKARTA SELATAN, DKI JAKARTA",146,202,54,256
https://kawalpemilu.org#26023,"PONDOK PINANG, KEBAYORAN LAMA, JAKARTA SELATAN, DKI JAKARTA",147,195,44,239
https://kawalpemilu.org#26023,"PONDOK PINANG, KEBAYORAN LAMA, JAKARTA SELATAN, DKI JAKARTA",148,203,26,229
https://kawalpemilu.org#26023,"PONDOK PINANG, KEBAYORAN LAMA, JAKARTA SELATAN, DKI JAKARTA",149,208,46,254
https://kawalpemilu.org#26023,"PONDOK PINANG, KEBAYORAN LAMA, JAKARTA SELATAN, DKI JAKARTA",150,192,42,234
https://kawalpemilu.org#26023,"PONDOK PINANG, KEBAYORAN LAMA, JAKARTA SELATAN, DKI JAKARTA",151,204,29,233
https://kawalpemilu.org#26023,"PONDOK PINANG, KEBAYORAN LAMA, JAKARTA SELATAN, DKI JAKARTA",152,193,33,226
https://kawalpemilu.org#26023,"PONDOK PINANG, KEBAYORAN LAMA, JAKARTA SELATAN, DKI JAKARTA",153,161,59,220
https://kawalpemilu.org#26023,"PONDOK PINANG, KEBAYORAN LAMA, JAKARTA SELATAN, DKI JAKARTA",154,197,36,233
https://kawalpemilu.org#26023,"PONDOK PINANG, KEBAYORAN LAMA, JAKARTA SELATAN, DKI JAKARTA",155,212,40,252
https://kawalpemilu.org#26023,"PONDOK PINANG, KEBAYORAN LAMA, JAKARTA SELATAN, DKI JAKARTA",156,198,32,230
https://kawalpemilu.org#26023,"PONDOK PINANG, KEBAYORAN LAMA, JAKARTA SELATAN, DKI JAKARTA",157,208,39,247
https://kawalpemilu.org#26023,"PONDOK PINANG, KEBAYORAN LAMA, JAKARTA SELATAN, DKI JAKARTA",158,182,32,214
https://kawalpemilu.org#26023,"PONDOK PINANG, KEBAYORAN LAMA, JAKARTA SELATAN, DKI JAKARTA",159,197,40,237
https://kawalpemilu.org#26023,"PONDOK PINANG, KEBAYORAN LAMA, JAKARTA SELATAN, DKI JAKARTA",160,251,44,295
https://kawalpemilu.org#26023,"PONDOK PINANG, KEBAYORAN LAMA, JAKARTA SELATAN, DKI JAKARTA",161,218,42,260
https://kawalpemilu.org#26023,"PONDOK PINANG, KEBAYORAN LAMA, JAKARTA SELATAN, DKI JAKARTA",162,196,42,238
https://kawalpemilu.org#26023,"PONDOK PINANG, KEBAYORAN LAMA, JAKARTA SELATAN, DKI JAKARTA",163,192,37,232
https://kawalpemilu.org#26023,"PONDOK PINANG, KEBAYORAN LAMA, JAKARTA SELATAN, DKI JAKARTA",164,187,46,233
https://kawalpemilu.org#26023,"PONDOK PINANG, KEBAYORAN LAMA, JAKARTA SELATAN, DKI JAKARTA",166,224,31,255
https://kawalpemilu.org#26023,"PONDOK PINANG, KEBAYORAN LAMA, JAKARTA SELATAN, DKI JAKARTA",167,207,41,248
https://kawalpemilu.org#26023,"PONDOK PINANG, KEBAYORAN LAMA, JAKARTA SELATAN, DKI JAKARTA",168,178,62,240
https://kawalpemilu.org#26023,"PONDOK PINANG, KEBAYORAN LAMA, JAKARTA SELATAN, DKI JAKARTA",169,174,36,210
https://kawalpemilu.org#26023,"PONDOK PINANG, KEBAYORAN LAMA, JAKARTA SELATAN, DKI JAKARTA",170,183,51,234
https://kawalpemilu.org#26023,"PONDOK PINANG, KEBAYORAN LAMA, JAKARTA SELATAN, DKI JAKARTA",171,202,55,257
https://kawalpemilu.org#26023,"PONDOK PINANG, KEBAYORAN LAMA, JAKARTA SELATAN, DKI JAKARTA",172,198,52,250
https://kawalpemilu.org#26023,"PONDOK PINANG, KEBAYORAN LAMA, JAKARTA SELATAN, DKI JAKARTA",174,206,53,259
https://kawalpemilu.org#26023,"PONDOK PINANG, KEBAYORAN LAMA, JAKARTA SELATAN, DKI JAKARTA",175,147,45,192
https://kawalpemilu.org#26023,"PONDOK PINANG, KEBAYORAN LAMA, JAKARTA SELATAN, DKI JAKARTA",176,196,37,233
https://kawalpemilu.org#26023,"PONDOK PINANG, KEBAYORAN LAMA, JAKARTA SELATAN, DKI JAKARTA",177,207,40,247
https://kawalpemilu.org#26024,"CIPULIR, KEBAYORAN LAMA, JAKARTA SELATAN, DKI JAKARTA",1,108,106,214
https://kawalpemilu.org#26024,"CIPULIR, KEBAYORAN LAMA, JAKARTA SELATAN, DKI JAKARTA",2,106,100,206
https://kawalpemilu.org#26024,"CIPULIR, KEBAYORAN LAMA, JAKARTA SELATAN, DKI JAKARTA",3,77,159,236
https://kawalpemilu.org#26024,"CIPULIR, KEBAYORAN LAMA, JAKARTA SELATAN, DKI JAKARTA",4,112,109,221
https://kawalpemilu.org#26024,"CIPULIR, KEBAYORAN LAMA, JAKARTA SELATAN, DKI JAKARTA",5,125,108,233
https://kawalpemilu.org#26024,"CIPULIR, KEBAYORAN LAMA, JAKARTA SELATAN, DKI JAKARTA",6,72,138,210
https://kawalpemilu.org#26024,"CIPULIR, KEBAYORAN LAMA, JAKARTA SELATAN, DKI JAKARTA",8,77,135,212
https://kawalpemilu.org#26024,"CIPULIR, KEBAYORAN LAMA, JAKARTA SELATAN, DKI JAKARTA",9,113,119,232
https://kawalpemilu.org#26024,"CIPULIR, KEBAYORAN LAMA, JAKARTA SELATAN, DKI JAKARTA",10,155,82,237
https://kawalpemilu.org#26024,"CIPULIR, KEBAYORAN LAMA, JAKARTA SELATAN, DKI JAKARTA",11,102,110,212
https://kawalpemilu.org#26024,"CIPULIR, KEBAYORAN LAMA, JAKARTA SELATAN, DKI JAKARTA",12,173,64,237
https://kawalpemilu.org#26024,"CIPULIR, KEBAYORAN LAMA, JAKARTA SELATAN, DKI JAKARTA",13,138,76,214
https://kawalpemilu.org#26024,"CIPULIR, KEBAYORAN LAMA, JAKARTA SELATAN, DKI JAKARTA",14,120,100,220
https://kawalpemilu.org#26024,"CIPULIR, KEBAYORAN LAMA, JAKARTA SELATAN, DKI JAKARTA",15,100,109,209
https://kawalpemilu.org#26024,"CIPULIR, KEBAYORAN LAMA, JAKARTA SELATAN, DKI JAKARTA",16,100,109,209
https://kawalpemilu.org#26024,"CIPULIR, KEBAYORAN LAMA, JAKARTA SELATAN, DKI JAKARTA",17,119,73,192
https://kawalpemilu.org#26024,"CIPULIR, KEBAYORAN LAMA, JAKARTA SELATAN, DKI JAKARTA",19,101,96,197
https://kawalpemilu.org#26024,"CIPULIR, KEBAYORAN LAMA, JAKARTA SELATAN, DKI JAKARTA",21,116,126,242
https://kawalpemilu.org#26024,"CIPULIR, KEBAYORAN LAMA, JAKARTA SELATAN, DKI JAKARTA",22,96,119,215
https://kawalpemilu.org#26024,"CIPULIR, KEBAYORAN LAMA, JAKARTA SELATAN, DKI JAKARTA",23,141,54,195
https://kawalpemilu.org#26024,"CIPULIR, KEBAYORAN LAMA, JAKARTA SELATAN, DKI JAKARTA",24,100,104,204
https://kawalpemilu.org#26024,"CIPULIR, KEBAYORAN LAMA, JAKARTA SELATAN, DKI JAKARTA",26,134,105,239
https://kawalpemilu.org#26024,"CIPULIR, KEBAYORAN LAMA, JAKARTA SELATAN, DKI JAKARTA",27,110,129,239
https://kawalpemilu.org#26024,"CIPULIR, KEBAYORAN LAMA, JAKARTA SELATAN, DKI JAKARTA",28,97,151,248
https://kawalpemilu.org#26024,"CIPULIR, KEBAYORAN LAMA, JAKARTA SELATAN, DKI JAKARTA",29,116,116,232
https://kawalpemilu.org#26024,"CIPULIR, KEBAYORAN LAMA, JAKARTA SELATAN, DKI JAKARTA",30,107,117,224
https://kawalpemilu.org#26024,"CIPULIR, KEBAYORAN LAMA, JAKARTA SELATAN, DKI JAKARTA",31,95,136,231
https://kawalpemilu.org#26024,"CIPULIR, KEBAYORAN LAMA, JAKARTA SELATAN, DKI JAKARTA",32,100,105,205
https://kawalpemilu.org#26024,"CIPULIR, KEBAYORAN LAMA, JAKARTA SELATAN, DKI JAKARTA",33,77,151,228
https://kawalpemilu.org#26024,"CIPULIR, KEBAYORAN LAMA, JAKARTA SELATAN, DKI JAKARTA",34,99,109,208
https://kawalpemilu.org#26024,"CIPULIR, KEBAYORAN LAMA, JAKARTA SELATAN, DKI JAKARTA",35,87,76,163
https://kawalpemilu.org#26024,"CIPULIR, KEBAYORAN LAMA, JAKARTA SELATAN, DKI JAKARTA",36,93,109,202
https://kawalpemilu.org#26024,"CIPULIR, KEBAYORAN LAMA, JAKARTA SELATAN, DKI JAKARTA",37,120,105,225
https://kawalpemilu.org#26024,"CIPULIR, KEBAYORAN LAMA, JAKARTA SELATAN, DKI JAKARTA",38,74,131,205
https://kawalpemilu.org#26024,"CIPULIR, KEBAYORAN LAMA, JAKARTA SELATAN, DKI JAKARTA",39,89,127,216
https://kawalpemilu.org#26024,"CIPULIR, KEBAYORAN LAMA, JAKARTA SELATAN, DKI JAKARTA",40,101,134,235
https://kawalpemilu.org#26024,"CIPULIR, KEBAYORAN LAMA, JAKARTA SELATAN, DKI JAKARTA",41,117,122,239
https://kawalpemilu.org#26024,"CIPULIR, KEBAYORAN LAMA, JAKARTA SELATAN, DKI JAKARTA",42,100,98,198
https://kawalpemilu.org#26024,"CIPULIR, KEBAYORAN LAMA, JAKARTA SELATAN, DKI JAKARTA",44,84,114,198
https://kawalpemilu.org#26024,"CIPULIR, KEBAYORAN LAMA, JAKARTA SELATAN, DKI JAKARTA",45,95,153,248
https://kawalpemilu.org#26024,"CIPULIR, KEBAYORAN LAMA, JAKARTA SELATAN, DKI JAKARTA",46,106,116,222
https://kawalpemilu.org#26024,"CIPULIR, KEBAYORAN LAMA, JAKARTA SELATAN, DKI JAKARTA",47,100,132,232
https://kawalpemilu.org#26024,"CIPULIR, KEBAYORAN LAMA, JAKARTA SELATAN, DKI JAKARTA",48,73,127,200
https://kawalpemilu.org#26024,"CIPULIR, KEBAYORAN LAMA, JAKARTA SELATAN, DKI JAKARTA",49,113,99,212
https://kawalpemilu.org#26024,"CIPULIR, KEBAYORAN LAMA, JAKARTA SELATAN, DKI JAKARTA",50,133,97,230
https://kawalpemilu.org#26024,"CIPULIR, KEBAYORAN LAMA, JAKARTA SELATAN, DKI JAKARTA",51,76,98,174
https://kawalpemilu.org#26024,"CIPULIR, KEBAYORAN LAMA, JAKARTA SELATAN, DKI JAKARTA",52,132,101,233
https://kawalpemilu.org#26024,"CIPULIR, KEBAYORAN LAMA, JAKARTA SELATAN, DKI JAKARTA",53,87,115,202
https://kawalpemilu.org#26024,"CIPULIR, KEBAYORAN LAMA, JAKARTA SELATAN, DKI JAKARTA",54,99,152,251
https://kawalpemilu.org#26024,"CIPULIR, KEBAYORAN LAMA, JAKARTA SELATAN, DKI JAKARTA",55,101,148,249
https://kawalpemilu.org#26024,"CIPULIR, KEBAYORAN LAMA, JAKARTA SELATAN, DKI JAKARTA",56,127,143,270
https://kawalpemilu.org#26024,"CIPULIR, KEBAYORAN LAMA, JAKARTA SELATAN, DKI JAKARTA",57,73,130,203
https://kawalpemilu.org#26024,"CIPULIR, KEBAYORAN LAMA, JAKARTA SELATAN, DKI JAKARTA",58,139,106,245
https://kawalpemilu.org#26024,"CIPULIR, KEBAYORAN LAMA, JAKARTA SELATAN, DKI JAKARTA",59,152,91,243
https://kawalpemilu.org#26024,"CIPULIR, KEBAYORAN LAMA, JAKARTA SELATAN, DKI JAKARTA",60,104,109,213
https://kawalpemilu.org#26024,"CIPULIR, KEBAYORAN LAMA, JAKARTA SELATAN, DKI JAKARTA",61,108,107,215
https://kawalpemilu.org#26024,"CIPULIR, KEBAYORAN LAMA, JAKARTA SELATAN, DKI JAKARTA",62,124,124,248
https://kawalpemilu.org#26024,"CIPULIR, KEBAYORAN LAMA, JAKARTA SELATAN, DKI JAKARTA",64,121,117,238
https://kawalpemilu.org#26024,"CIPULIR, KEBAYORAN LAMA, JAKARTA SELATAN, DKI JAKARTA",65,124,117,241
https://kawalpemilu.org#26024,"CIPULIR, KEBAYORAN LAMA, JAKARTA SELATAN, DKI JAKARTA",66,114,98,212
https://kawalpemilu.org#26024,"CIPULIR, KEBAYORAN LAMA, JAKARTA SELATAN, DKI JAKARTA",67,93,111,204
https://kawalpemilu.org#26024,"CIPULIR, KEBAYORAN LAMA, JAKARTA SELATAN, DKI JAKARTA",68,102,92,194
https://kawalpemilu.org#26024,"CIPULIR, KEBAYORAN LAMA, JAKARTA SELATAN, DKI JAKARTA",69,97,130,227
https://kawalpemilu.org#26024,"CIPULIR, KEBAYORAN LAMA, JAKARTA SELATAN, DKI JAKARTA",70,110,105,215
https://kawalpemilu.org#26024,"CIPULIR, KEBAYORAN LAMA, JAKARTA SELATAN, DKI JAKARTA",71,80,122,202
https://kawalpemilu.org#26024,"CIPULIR, KEBAYORAN LAMA, JAKARTA SELATAN, DKI JAKARTA",72,54,153,207
https://kawalpemilu.org#26024,"CIPULIR, KEBAYORAN LAMA, JAKARTA SELATAN, DKI JAKARTA",73,70,151,221
https://kawalpemilu.org#26024,"CIPULIR, KEBAYORAN LAMA, JAKARTA SELATAN, DKI JAKARTA",74,81,122,203
https://kawalpemilu.org#26024,"CIPULIR, KEBAYORAN LAMA, JAKARTA SELATAN, DKI JAKARTA",75,61,114,175
https://kawalpemilu.org#26024,"CIPULIR, KEBAYORAN LAMA, JAKARTA SELATAN, DKI JAKARTA",76,75,145,220
https://kawalpemilu.org#26024,"CIPULIR, KEBAYORAN LAMA, JAKARTA SELATAN, DKI JAKARTA",77,94,130,224
https://kawalpemilu.org#26024,"CIPULIR, KEBAYORAN LAMA, JAKARTA SELATAN, DKI JAKARTA",78,131,88,219
https://kawalpemilu.org#26024,"CIPULIR, KEBAYORAN LAMA, JAKARTA SELATAN, DKI JAKARTA",79,132,96,228
https://kawalpemilu.org#26024,"CIPULIR, KEBAYORAN LAMA, JAKARTA SELATAN, DKI JAKARTA",81,93,104,197
https://kawalpemilu.org#26024,"CIPULIR, KEBAYORAN LAMA, JAKARTA SELATAN, DKI JAKARTA",82,110,112,222
https://kawalpemilu.org#26024,"CIPULIR, KEBAYORAN LAMA, JAKARTA SELATAN, DKI JAKARTA",83,86,130,216
https://kawalpemilu.org#26024,"CIPULIR, KEBAYORAN LAMA, JAKARTA SELATAN, DKI JAKARTA",84,117,122,239
https://kawalpemilu.org#26024,"CIPULIR, KEBAYORAN LAMA, JAKARTA SELATAN, DKI JAKARTA",85,129,115,244
https://kawalpemilu.org#26024,"CIPULIR, KEBAYORAN LAMA, JAKARTA SELATAN, DKI JAKARTA",86,136,109,245
https://kawalpemilu.org#26024,"CIPULIR, KEBAYORAN LAMA, JAKARTA SELATAN, DKI JAKARTA",87,146,87,233
https://kawalpemilu.org#26024,"CIPULIR, KEBAYORAN LAMA, JAKARTA SELATAN, DKI JAKARTA",88,122,127,249
https://kawalpemilu.org#26024,"CIPULIR, KEBAYORAN LAMA, JAKARTA SELATAN, DKI JAKARTA",89,113,137,250
https://kawalpemilu.org#26024,"CIPULIR, KEBAYORAN LAMA, JAKARTA SELATAN, DKI JAKARTA",90,113,151,264
https://kawalpemilu.org#26024,"CIPULIR, KEBAYORAN LAMA, JAKARTA SELATAN, DKI JAKARTA",91,94,109,203
https://kawalpemilu.org#26024,"CIPULIR, KEBAYORAN LAMA, JAKARTA SELATAN, DKI JAKARTA",92,87,116,203
https://kawalpemilu.org#26024,"CIPULIR, KEBAYORAN LAMA, JAKARTA SELATAN, DKI JAKARTA",93,107,122,229
https://kawalpemilu.org#26024,"CIPULIR, KEBAYORAN LAMA, JAKARTA SELATAN, DKI JAKARTA",94,136,108,244
https://kawalpemilu.org#26024,"CIPULIR, KEBAYORAN LAMA, JAKARTA SELATAN, DKI JAKARTA",95,103,134,237
https://kawalpemilu.org#26024,"CIPULIR, KEBAYORAN LAMA, JAKARTA SELATAN, DKI JAKARTA",96,112,112,224
https://kawalpemilu.org#26024,"CIPULIR, KEBAYORAN LAMA, JAKARTA SELATAN, DKI JAKARTA",97,90,146,236
https://kawalpemilu.org#26024,"CIPULIR, KEBAYORAN LAMA, JAKARTA SELATAN, DKI JAKARTA",98,134,105,239
https://kawalpemilu.org#26024,"CIPULIR, KEBAYORAN LAMA, JAKARTA SELATAN, DKI JAKARTA",99,136,110,246
https://kawalpemilu.org#26024,"CIPULIR, KEBAYORAN LAMA, JAKARTA SELATAN, DKI JAKARTA",100,161,97,258
https://kawalpemilu.org#26024,"CIPULIR, KEBAYORAN LAMA, JAKARTA SELATAN, DKI JAKARTA",101,128,122,250
https://kawalpemilu.org#26024,"CIPULIR, KEBAYORAN LAMA, JAKARTA SELATAN, DKI JAKARTA",102,134,115,249
https://kawalpemilu.org#26024,"CIPULIR, KEBAYORAN LAMA, JAKARTA SELATAN, DKI JAKARTA",103,120,111,231
https://kawalpemilu.org#26024,"CIPULIR, KEBAYORAN LAMA, JAKARTA SELATAN, DKI JAKARTA",104,111,158,269
https://kawalpemilu.org#26024,"CIPULIR, KEBAYORAN LAMA, JAKARTA SELATAN, DKI JAKARTA",105,144,114,258
https://kawalpemilu.org#26024,"CIPULIR, KEBAYORAN LAMA, JAKARTA SELATAN, DKI JAKARTA",106,63,86,149
https://kawalpemilu.org#26024,"CIPULIR, KEBAYORAN LAMA, JAKARTA SELATAN, DKI JAKARTA",107,193,68,261
https://kawalpemilu.org#26024,"CIPULIR, KEBAYORAN LAMA, JAKARTA SELATAN, DKI JAKARTA",108,89,141,230
https://kawalpemilu.org#26024,"CIPULIR, KEBAYORAN LAMA, JAKARTA SELATAN, DKI JAKARTA",109,139,113,252
https://kawalpemilu.org#26024,"CIPULIR, KEBAYORAN LAMA, JAKARTA SELATAN, DKI JAKARTA",110,86,169,255
https://kawalpemilu.org#26024,"CIPULIR, KEBAYORAN LAMA, JAKARTA SELATAN, DKI JAKARTA",111,65,192,257
https://kawalpemilu.org#26024,"CIPULIR, KEBAYORAN LAMA, JAKARTA SELATAN, DKI JAKARTA",112,60,189,249
https://kawalpemilu.org#26024,"CIPULIR, KEBAYORAN LAMA, JAKARTA SELATAN, DKI JAKARTA",113,109,133,242
https://kawalpemilu.org#26024,"CIPULIR, KEBAYORAN LAMA, JAKARTA SELATAN, DKI JAKARTA",114,63,158,221
https://kawalpemilu.org#26024,"CIPULIR, KEBAYORAN LAMA, JAKARTA SELATAN, DKI JAKARTA",115,74,170,244
https://kawalpemilu.org#26024,"CIPULIR, KEBAYORAN LAMA, JAKARTA SELATAN, DKI JAKARTA",116,86,123,209
https://kawalpemilu.org#26024,"CIPULIR, KEBAYORAN LAMA, JAKARTA SELATAN, DKI JAKARTA",117,139,97,236
https://kawalpemilu.org#26024,"CIPULIR, KEBAYORAN LAMA, JAKARTA SELATAN, DKI JAKARTA",118,95,141,236
https://kawalpemilu.org#26024,"CIPULIR, KEBAYORAN LAMA, JAKARTA SELATAN, DKI JAKARTA",119,107,129,236
https://kawalpemilu.org#26024,"CIPULIR, KEBAYORAN LAMA, JAKARTA SELATAN, DKI JAKARTA",120,71,133,204
https://kawalpemilu.org#26024,"CIPULIR, KEBAYORAN LAMA, JAKARTA SELATAN, DKI JAKARTA",121,96,175,271
https://kawalpemilu.org#26024,"CIPULIR, KEBAYORAN LAMA, JAKARTA SELATAN, DKI JAKARTA",123,106,129,235
https://kawalpemilu.org#26024,"CIPULIR, KEBAYORAN LAMA, JAKARTA SELATAN, DKI JAKARTA",124,148,115,263
https://kawalpemilu.org#26024,"CIPULIR, KEBAYORAN LAMA, JAKARTA SELATAN, DKI JAKARTA",125,79,96,175
https://kawalpemilu.org#26024,"CIPULIR, KEBAYORAN LAMA, JAKARTA SELATAN, DKI JAKARTA",126,51,69,120
https://kawalpemilu.org#26025,"GROGOL UTARA, KEBAYORAN LAMA, JAKARTA SELATAN, DKI JAKARTA",1,120,92,212
https://kawalpemilu.org#26025,"GROGOL UTARA, KEBAYORAN LAMA, JAKARTA SELATAN, DKI JAKARTA",2,116,93,209
https://kawalpemilu.org#26025,"GROGOL UTARA, KEBAYORAN LAMA, JAKARTA SELATAN, DKI JAKARTA",3,154,58,212
https://kawalpemilu.org#26025,"GROGOL UTARA, KEBAYORAN LAMA, JAKARTA SELATAN, DKI JAKARTA",4,152,68,220
https://kawalpemilu.org#26025,"GROGOL UTARA, KEBAYORAN LAMA, JAKARTA SELATAN, DKI JAKARTA",5,160,47,207
https://kawalpemilu.org#26025,"GROGOL UTARA, KEBAYORAN LAMA, JAKARTA SELATAN, DKI JAKARTA",6,127,133,260
https://kawalpemilu.org#26025,"GROGOL UTARA, KEBAYORAN LAMA, JAKARTA SELATAN, DKI JAKARTA",7,83,136,219
https://kawalpemilu.org#26025,"GROGOL UTARA, KEBAYORAN LAMA, JAKARTA SELATAN, DKI JAKARTA",8,64,178,242
https://kawalpemilu.org#26025,"GROGOL UTARA, KEBAYORAN LAMA, JAKARTA SELATAN, DKI JAKARTA",10,80,155,235
https://kawalpemilu.org#26025,"GROGOL UTARA, KEBAYORAN LAMA, JAKARTA SELATAN, DKI JAKARTA",11,94,141,241
https://kawalpemilu.org#26025,"GROGOL UTARA, KEBAYORAN LAMA, JAKARTA SELATAN, DKI JAKARTA",12,106,128,234
https://kawalpemilu.org#26025,"GROGOL UTARA, KEBAYORAN LAMA, JAKARTA SELATAN, DKI JAKARTA",13,62,175,237
https://kawalpemilu.org#26025,"GROGOL UTARA, KEBAYORAN LAMA, JAKARTA SELATAN, DKI JAKARTA",14,90,130,220
https://kawalpemilu.org#26025,"GROGOL UTARA, KEBAYORAN LAMA, JAKARTA SELATAN, DKI JAKARTA",16,116,77,0
https://kawalpemilu.org#26025,"GROGOL UTARA, KEBAYORAN LAMA, JAKARTA SELATAN, DKI JAKARTA",17,114,83,197
https://kawalpemilu.org#26025,"GROGOL UTARA, KEBAYORAN LAMA, JAKARTA SELATAN, DKI JAKARTA",18,56,180,236
https://kawalpemilu.org#26025,"GROGOL UTARA, KEBAYORAN LAMA, JAKARTA SELATAN, DKI JAKARTA",20,100,120,220
https://kawalpemilu.org#26025,"GROGOL UTARA, KEBAYORAN LAMA, JAKARTA SELATAN, DKI JAKARTA",21,72,127,199
https://kawalpemilu.org#26025,"GROGOL UTARA, KEBAYORAN LAMA, JAKARTA SELATAN, DKI JAKARTA",22,74,114,188
https://kawalpemilu.org#26025,"GROGOL UTARA, KEBAYORAN LAMA, JAKARTA SELATAN, DKI JAKARTA",23,166,40,206
https://kawalpemilu.org#26025,"GROGOL UTARA, KEBAYORAN LAMA, JAKARTA SELATAN, DKI JAKARTA",24,96,119,215
https://kawalpemilu.org#26025,"GROGOL UTARA, KEBAYORAN LAMA, JAKARTA SELATAN, DKI JAKARTA",25,142,54,196
https://kawalpemilu.org#26025,"GROGOL UTARA, KEBAYORAN LAMA, JAKARTA SELATAN, DKI JAKARTA",26,112,65,177
https://kawalpemilu.org#26025,"GROGOL UTARA, KEBAYORAN LAMA, JAKARTA SELATAN, DKI JAKARTA",27,115,59,174
https://kawalpemilu.org#26025,"GROGOL UTARA, KEBAYORAN LAMA, JAKARTA SELATAN, DKI JAKARTA",28,107,115,222
https://kawalpemilu.org#26025,"GROGOL UTARA, KEBAYORAN LAMA, JAKARTA SELATAN, DKI JAKARTA",29,85,111,196
https://kawalpemilu.org#26025,"GROGOL UTARA, KEBAYORAN LAMA, JAKARTA SELATAN, DKI JAKARTA",30,69,158,227
https://kawalpemilu.org#26025,"GROGOL UTARA, KEBAYORAN LAMA, JAKARTA SELATAN, DKI JAKARTA",31,120,135,255
https://kawalpemilu.org#26025,"GROGOL UTARA, KEBAYORAN LAMA, JAKARTA SELATAN, DKI JAKARTA",32,170,94,264
https://kawalpemilu.org#26025,"GROGOL UTARA, KEBAYORAN LAMA, JAKARTA SELATAN, DKI JAKARTA",33,193,44,237
https://kawalpemilu.org#26025,"GROGOL UTARA, KEBAYORAN LAMA, JAKARTA SELATAN, DKI JAKARTA",35,116,122,238
https://kawalpemilu.org#26025,"GROGOL UTARA, KEBAYORAN LAMA, JAKARTA SELATAN, DKI JAKARTA",36,119,98,217
https://kawalpemilu.org#26025,"GROGOL UTARA, KEBAYORAN LAMA, JAKARTA SELATAN, DKI JAKARTA",38,154,91,245
https://kawalpemilu.org#26025,"GROGOL UTARA, KEBAYORAN LAMA, JAKARTA SELATAN, DKI JAKARTA",39,123,119,242
https://kawalpemilu.org#26025,"GROGOL UTARA, KEBAYORAN LAMA, JAKARTA SELATAN, DKI JAKARTA",45,84,148,232
https://kawalpemilu.org#26025,"GROGOL UTARA, KEBAYORAN LAMA, JAKARTA SELATAN, DKI JAKARTA",47,147,80,227
https://kawalpemilu.org#26025,"GROGOL UTARA, KEBAYORAN LAMA, JAKARTA SELATAN, DKI JAKARTA",49,122,101,223
https://kawalpemilu.org#26025,"GROGOL UTARA, KEBAYORAN LAMA, JAKARTA SELATAN, DKI JAKARTA",50,112,133,245
https://kawalpemilu.org#26025,"GROGOL UTARA, KEBAYORAN LAMA, JAKARTA SELATAN, DKI JAKARTA",53,131,128,259
https://kawalpemilu.org#26025,"GROGOL UTARA, KEBAYORAN LAMA, JAKARTA SELATAN, DKI JAKARTA",54,67,173,240
https://kawalpemilu.org#26025,"GROGOL UTARA, KEBAYORAN LAMA, JAKARTA SELATAN, DKI JAKARTA",55,111,87,198
https://kawalpemilu.org#26025,"GROGOL UTARA, KEBAYORAN LAMA, JAKARTA SELATAN, DKI JAKARTA",56,70,191,261
https://kawalpemilu.org#26025,"GROGOL UTARA, KEBAYORAN LAMA, JAKARTA SELATAN, DKI JAKARTA",57,95,141,236
https://kawalpemilu.org#26025,"GROGOL UTARA, KEBAYORAN LAMA, JAKARTA SELATAN, DKI JAKARTA",59,88,142,230
https://kawalpemilu.org#26025,"GROGOL UTARA, KEBAYORAN LAMA, JAKARTA SELATAN, DKI JAKARTA",60,95,135,230
https://kawalpemilu.org#26025,"GROGOL UTARA, KEBAYORAN LAMA, JAKARTA SELATAN, DKI JAKARTA",61,0,0,0
https://kawalpemilu.org#26025,"GROGOL UTARA, KEBAYORAN LAMA, JAKARTA SELATAN, DKI JAKARTA",62,115,115,230
https://kawalpemilu.org#26025,"GROGOL UTARA, KEBAYORAN LAMA, JAKARTA SELATAN, DKI JAKARTA",63,121,122,243
https://kawalpemilu.org#26025,"GROGOL UTARA, KEBAYORAN LAMA, JAKARTA SELATAN, DKI JAKARTA",65,104,139,243
https://kawalpemilu.org#26025,"GROGOL UTARA, KEBAYORAN LAMA, JAKARTA SELATAN, DKI JAKARTA",66,108,129,237
https://kawalpemilu.org#26025,"GROGOL UTARA, KEBAYORAN LAMA, JAKARTA SELATAN, DKI JAKARTA",67,150,74,224
https://kawalpemilu.org#26025,"GROGOL UTARA, KEBAYORAN LAMA, JAKARTA SELATAN, DKI JAKARTA",69,101,100,201
https://kawalpemilu.org#26025,"GROGOL UTARA, KEBAYORAN LAMA, JAKARTA SELATAN, DKI JAKARTA",70,181,50,231
https://kawalpemilu.org#26025,"GROGOL UTARA, KEBAYORAN LAMA, JAKARTA SELATAN, DKI JAKARTA",71,133,104,237
https://kawalpemilu.org#26025,"GROGOL UTARA, KEBAYORAN LAMA, JAKARTA SELATAN, DKI JAKARTA",72,108,99,207
https://kawalpemilu.org#26025,"GROGOL UTARA, KEBAYORAN LAMA, JAKARTA SELATAN, DKI JAKARTA",73,129,97,226
https://kawalpemilu.org#26025,"GROGOL UTARA, KEBAYORAN LAMA, JAKARTA SELATAN, DKI JAKARTA",75,129,118,247
https://kawalpemilu.org#26025,"GROGOL UTARA, KEBAYORAN LAMA, JAKARTA SELATAN, DKI JAKARTA",76,134,144,278
https://kawalpemilu.org#26025,"GROGOL UTARA, KEBAYORAN LAMA, JAKARTA SELATAN, DKI JAKARTA",77,94,158,252
https://kawalpemilu.org#26025,"GROGOL UTARA, KEBAYORAN LAMA, JAKARTA SELATAN, DKI JAKARTA",78,85,141,226
https://kawalpemilu.org#26025,"GROGOL UTARA, KEBAYORAN LAMA, JAKARTA SELATAN, DKI JAKARTA",80,88,114,202
https://kawalpemilu.org#26025,"GROGOL UTARA, KEBAYORAN LAMA, JAKARTA SELATAN, DKI JAKARTA",85,132,98,230
https://kawalpemilu.org#26025,"GROGOL UTARA, KEBAYORAN LAMA, JAKARTA SELATAN, DKI JAKARTA",86,138,85,224
https://kawalpemilu.org#26025,"GROGOL UTARA, KEBAYORAN LAMA, JAKARTA SELATAN, DKI JAKARTA",87,146,75,221
https://kawalpemilu.org#26025,"GROGOL UTARA, KEBAYORAN LAMA, JAKARTA SELATAN, DKI JAKARTA",88,129,80,209
https://kawalpemilu.org#26025,"GROGOL UTARA, KEBAYORAN LAMA, JAKARTA SELATAN, DKI JAKARTA",89,153,80,233
https://kawalpemilu.org#26025,"GROGOL UTARA, KEBAYORAN LAMA, JAKARTA SELATAN, DKI JAKARTA",90,114,111,225
https://kawalpemilu.org#26025,"GROGOL UTARA, KEBAYORAN LAMA, JAKARTA SELATAN, DKI JAKARTA",92,108,138,246
https://kawalpemilu.org#26025,"GROGOL UTARA, KEBAYORAN LAMA, JAKARTA SELATAN, DKI JAKARTA",93,99,127,226
https://kawalpemilu.org#26025,"GROGOL UTARA, KEBAYORAN LAMA, JAKARTA SELATAN, DKI JAKARTA",94,155,93,248
https://kawalpemilu.org#26025,"GROGOL UTARA, KEBAYORAN LAMA, JAKARTA SELATAN, DKI JAKARTA",95,133,98,231
https://kawalpemilu.org#26025,"GROGOL UTARA, KEBAYORAN LAMA, JAKARTA SELATAN, DKI JAKARTA",97,118,104,222
https://kawalpemilu.org#26025,"GROGOL UTARA, KEBAYORAN LAMA, JAKARTA SELATAN, DKI JAKARTA",98,117,143,260
https://kawalpemilu.org#26025,"GROGOL UTARA, KEBAYORAN LAMA, JAKARTA SELATAN, DKI JAKARTA",100,85,130,215
https://kawalpemilu.org#26025,"GROGOL UTARA, KEBAYORAN LAMA, JAKARTA SELATAN, DKI JAKARTA",101,160,40,200
https://kawalpemilu.org#26025,"GROGOL UTARA, KEBAYORAN LAMA, JAKARTA SELATAN, DKI JAKARTA",102,131,88,219
https://kawalpemilu.org#26025,"GROGOL UTARA, KEBAYORAN LAMA, JAKARTA SELATAN, DKI JAKARTA",103,148,57,205
https://kawalpemilu.org#26025,"GROGOL UTARA, KEBAYORAN LAMA, JAKARTA SELATAN, DKI JAKARTA",105,158,83,241
https://kawalpemilu.org#26025,"GROGOL UTARA, KEBAYORAN LAMA, JAKARTA SELATAN, DKI JAKARTA",106,135,126,261
https://kawalpemilu.org#26025,"GROGOL UTARA, KEBAYORAN LAMA, JAKARTA SELATAN, DKI JAKARTA",107,146,103,249
https://kawalpemilu.org#26025,"GROGOL UTARA, KEBAYORAN LAMA, JAKARTA SELATAN, DKI JAKARTA",108,143,105,248
https://kawalpemilu.org#26025,"GROGOL UTARA, KEBAYORAN LAMA, JAKARTA SELATAN, DKI JAKARTA",109,149,99,248
https://kawalpemilu.org#26025,"GROGOL UTARA, KEBAYORAN LAMA, JAKARTA SELATAN, DKI JAKARTA",110,161,104,265
https://kawalpemilu.org#26025,"GROGOL UTARA, KEBAYORAN LAMA, JAKARTA SELATAN, DKI JAKARTA",111,113,129,242
https://kawalpemilu.org#26025,"GROGOL UTARA, KEBAYORAN LAMA, JAKARTA SELATAN, DKI JAKARTA",113,141,102,243
https://kawalpemilu.org#26025,"GROGOL UTARA, KEBAYORAN LAMA, JAKARTA SELATAN, DKI JAKARTA",114,95,92,187
https://kawalpemilu.org#26025,"GROGOL UTARA, KEBAYORAN LAMA, JAKARTA SELATAN, DKI JAKARTA",115,106,73,179
https://kawalpemilu.org#26025,"GROGOL UTARA, KEBAYORAN LAMA, JAKARTA SELATAN, DKI JAKARTA",116,84,113,197
https://kawalpemilu.org#26025,"GROGOL UTARA, KEBAYORAN LAMA, JAKARTA SELATAN, DKI JAKARTA",117,145,86,231
https://kawalpemilu.org#26025,"GROGOL UTARA, KEBAYORAN LAMA, JAKARTA SELATAN, DKI JAKARTA",118,92,129,221
https://kawalpemilu.org#26025,"GROGOL UTARA, KEBAYORAN LAMA, JAKARTA SELATAN, DKI JAKARTA",119,153,82,235
https://kawalpemilu.org#26025,"GROGOL UTARA, KEBAYORAN LAMA, JAKARTA SELATAN, DKI JAKARTA",121,162,91,253
https://kawalpemilu.org#26025,"GROGOL UTARA, KEBAYORAN LAMA, JAKARTA SELATAN, DKI JAKARTA",122,155,85,240
https://kawalpemilu.org#26025,"GROGOL UTARA, KEBAYORAN LAMA, JAKARTA SELATAN, DKI JAKARTA",123,121,116,237
https://kawalpemilu.org#26025,"GROGOL UTARA, KEBAYORAN LAMA, JAKARTA SELATAN, DKI JAKARTA",124,118,123,241
https://kawalpemilu.org#26025,"GROGOL UTARA, KEBAYORAN LAMA, JAKARTA SELATAN, DKI JAKARTA",125,139,77,216
https://kawalpemilu.org#26025,"GROGOL UTARA, KEBAYORAN LAMA, JAKARTA SELATAN, DKI JAKARTA",126,101,109,210
https://kawalpemilu.org#26025,"GROGOL UTARA, KEBAYORAN LAMA, JAKARTA SELATAN, DKI JAKARTA",127,170,61,231
https://kawalpemilu.org#26025,"GROGOL UTARA, KEBAYORAN LAMA, JAKARTA SELATAN, DKI JAKARTA",128,166,46,212
https://kawalpemilu.org#26025,"GROGOL UTARA, KEBAYORAN LAMA, JAKARTA SELATAN, DKI JAKARTA",129,119,59,178
https://kawalpemilu.org#26025,"GROGOL UTARA, KEBAYORAN LAMA, JAKARTA SELATAN, DKI JAKARTA",131,151,81,232
https://kawalpemilu.org#26025,"GROGOL UTARA, KEBAYORAN LAMA, JAKARTA SELATAN, DKI JAKARTA",132,208,11,219
https://kawalpemilu.org#26025,"GROGOL UTARA, KEBAYORAN LAMA, JAKARTA SELATAN, DKI JAKARTA",133,150,92,242
https://kawalpemilu.org#26025,"GROGOL UTARA, KEBAYORAN LAMA, JAKARTA SELATAN, DKI JAKARTA",135,115,105,220
https://kawalpemilu.org#26025,"GROGOL UTARA, KEBAYORAN LAMA, JAKARTA SELATAN, DKI JAKARTA",136,103,119,222
https://kawalpemilu.org#26025,"GROGOL UTARA, KEBAYORAN LAMA, JAKARTA SELATAN, DKI JAKARTA",137,115,133,248
https://kawalpemilu.org#26025,"GROGOL UTARA, KEBAYORAN LAMA, JAKARTA SELATAN, DKI JAKARTA",138,142,79,221
https://kawalpemilu.org#26025,"GROGOL UTARA, KEBAYORAN LAMA, JAKARTA SELATAN, DKI JAKARTA",139,71,63,134
https://kawalpemilu.org#26026,"GROGOL SELATAN, KEBAYORAN LAMA, JAKARTA SELATAN, DKI JAKARTA",1,126,89,215
https://kawalpemilu.org#26026,"GROGOL SELATAN, KEBAYORAN LAMA, JAKARTA SELATAN, DKI JAKARTA",3,130,122,252
https://kawalpemilu.org#26026,"GROGOL SELATAN, KEBAYORAN LAMA, JAKARTA SELATAN, DKI JAKARTA",4,102,150,252
https://kawalpemilu.org#26026,"GROGOL SELATAN, KEBAYORAN LAMA, JAKARTA SELATAN, DKI JAKARTA",5,108,122,230
https://kawalpemilu.org#26026,"GROGOL SELATAN, KEBAYORAN LAMA, JAKARTA SELATAN, DKI JAKARTA",7,104,111,215
https://kawalpemilu.org#26026,"GROGOL SELATAN, KEBAYORAN LAMA, JAKARTA SELATAN, DKI JAKARTA",9,101,142,243
https://kawalpemilu.org#26026,"GROGOL SELATAN, KEBAYORAN LAMA, JAKARTA SELATAN, DKI JAKARTA",10,99,116,215
https://kawalpemilu.org#26026,"GROGOL SELATAN, KEBAYORAN LAMA, JAKARTA SELATAN, DKI JAKARTA",11,107,101,208
https://kawalpemilu.org#26026,"GROGOL SELATAN, KEBAYORAN LAMA, JAKARTA SELATAN, DKI JAKARTA",13,152,66,218
https://kawalpemilu.org#26026,"GROGOL SELATAN, KEBAYORAN LAMA, JAKARTA SELATAN, DKI JAKARTA",14,110,111,221
https://kawalpemilu.org#26026,"GROGOL SELATAN, KEBAYORAN LAMA, JAKARTA SELATAN, DKI JAKARTA",15,110,101,211
https://kawalpemilu.org#26026,"GROGOL SELATAN, KEBAYORAN LAMA, JAKARTA SELATAN, DKI JAKARTA",16,135,95,230
https://kawalpemilu.org#26026,"GROGOL SELATAN, KEBAYORAN LAMA, JAKARTA SELATAN, DKI JAKARTA",17,106,93,199
https://kawalpemilu.org#26026,"GROGOL SELATAN, KEBAYORAN LAMA, JAKARTA SELATAN, DKI JAKARTA",18,119,123,242
https://kawalpemilu.org#26026,"GROGOL SELATAN, KEBAYORAN LAMA, JAKARTA SELATAN, DKI JAKARTA",19,151,85,236
https://kawalpemilu.org#26026,"GROGOL SELATAN, KEBAYORAN LAMA, JAKARTA SELATAN, DKI JAKARTA",20,117,104,221
https://kawalpemilu.org#26026,"GROGOL SELATAN, KEBAYORAN LAMA, JAKARTA SELATAN, DKI JAKARTA",21,115,63,178
https://kawalpemilu.org#26026,"GROGOL SELATAN, KEBAYORAN LAMA, JAKARTA SELATAN, DKI JAKARTA",22,84,103,187
https://kawalpemilu.org#26026,"GROGOL SELATAN, KEBAYORAN LAMA, JAKARTA SELATAN, DKI JAKARTA",23,132,102,234
https://kawalpemilu.org#26026,"GROGOL SELATAN, KEBAYORAN LAMA, JAKARTA SELATAN, DKI JAKARTA",24,88,67,155
https://kawalpemilu.org#26026,"GROGOL SELATAN, KEBAYORAN LAMA, JAKARTA SELATAN, DKI JAKARTA",25,100,84,184
https://kawalpemilu.org#26026,"GROGOL SELATAN, KEBAYORAN LAMA, JAKARTA SELATAN, DKI JAKARTA",26,168,24,192
https://kawalpemilu.org#26026,"GROGOL SELATAN, KEBAYORAN LAMA, JAKARTA SELATAN, DKI JAKARTA",27,150,80,230
https://kawalpemilu.org#26026,"GROGOL SELATAN, KEBAYORAN LAMA, JAKARTA SELATAN, DKI JAKARTA",29,82,138,220
https://kawalpemilu.org#26026,"GROGOL SELATAN, KEBAYORAN LAMA, JAKARTA SELATAN, DKI JAKARTA",30,87,127,214
https://kawalpemilu.org#26026,"GROGOL SELATAN, KEBAYORAN LAMA, JAKARTA SELATAN, DKI JAKARTA",31,96,129,225
https://kawalpemilu.org#26026,"GROGOL SELATAN, KEBAYORAN LAMA, JAKARTA SELATAN, DKI JAKARTA",32,107,112,219
https://kawalpemilu.org#26026,"GROGOL SELATAN, KEBAYORAN LAMA, JAKARTA SELATAN, DKI JAKARTA",33,61,161,222
https://kawalpemilu.org#26026,"GROGOL SELATAN, KEBAYORAN LAMA, JAKARTA SELATAN, DKI JAKARTA",34,101,109,210
https://kawalpemilu.org#26026,"GROGOL SELATAN, KEBAYORAN LAMA, JAKARTA SELATAN, DKI JAKARTA",35,109,132,241
https://kawalpemilu.org#26026,"GROGOL SELATAN, KEBAYORAN LAMA, JAKARTA SELATAN, DKI JAKARTA",36,94,126,220
https://kawalpemilu.org#26026,"GROGOL SELATAN, KEBAYORAN LAMA, JAKARTA SELATAN, DKI JAKARTA",37,94,121,215
https://kawalpemilu.org#26026,"GROGOL SELATAN, KEBAYORAN LAMA, JAKARTA SELATAN, DKI JAKARTA",38,83,146,229
https://kawalpemilu.org#26026,"GROGOL SELATAN, KEBAYORAN LAMA, JAKARTA SELATAN, DKI JAKARTA",39,90,164,254
https://kawalpemilu.org#26026,"GROGOL SELATAN, KEBAYORAN LAMA, JAKARTA SELATAN, DKI JAKARTA",40,114,99,213
https://kawalpemilu.org#26026,"GROGOL SELATAN, KEBAYORAN LAMA, JAKARTA SELATAN, DKI JAKARTA",41,109,98,207
https://kawalpemilu.org#26026,"GROGOL SELATAN, KEBAYORAN LAMA, JAKARTA SELATAN, DKI JAKARTA",42,155,67,222
https://kawalpemilu.org#26026,"GROGOL SELATAN, KEBAYORAN LAMA, JAKARTA SELATAN, DKI JAKARTA",43,102,121,223
https://kawalpemilu.org#26026,"GROGOL SELATAN, KEBAYORAN LAMA, JAKARTA SELATAN, DKI JAKARTA",44,120,102,222
https://kawalpemilu.org#26026,"GROGOL SELATAN, KEBAYORAN LAMA, JAKARTA SELATAN, DKI JAKARTA",45,85,160,245
https://kawalpemilu.org#26026,"GROGOL SELATAN, KEBAYORAN LAMA, JAKARTA SELATAN, DKI JAKARTA",46,90,127,217
https://kawalpemilu.org#26026,"GROGOL SELATAN, KEBAYORAN LAMA, JAKARTA SELATAN, DKI JAKARTA",47,96,135,231
https://kawalpemilu.org#26026,"GROGOL SELATAN, KEBAYORAN LAMA, JAKARTA SELATAN, DKI JAKARTA",48,87,136,223
https://kawalpemilu.org#26026,"GROGOL SELATAN, KEBAYORAN LAMA, JAKARTA SELATAN, DKI JAKARTA",49,72,167,239
https://kawalpemilu.org#26026,"GROGOL SELATAN, KEBAYORAN LAMA, JAKARTA SELATAN, DKI JAKARTA",50,85,146,231
https://kawalpemilu.org#26026,"GROGOL SELATAN, KEBAYORAN LAMA, JAKARTA SELATAN, DKI JAKARTA",51,77,142,219
https://kawalpemilu.org#26026,"GROGOL SELATAN, KEBAYORAN LAMA, JAKARTA SELATAN, DKI JAKARTA",52,84,129,213
https://kawalpemilu.org#26026,"GROGOL SELATAN, KEBAYORAN LAMA, JAKARTA SELATAN, DKI JAKARTA",53,91,134,225
https://kawalpemilu.org#26026,"GROGOL SELATAN, KEBAYORAN LAMA, JAKARTA SELATAN, DKI JAKARTA",54,104,139,243
https://kawalpemilu.org#26026,"GROGOL SELATAN, KEBAYORAN LAMA, JAKARTA SELATAN, DKI JAKARTA",55,102,146,248
https://kawalpemilu.org#26026,"GROGOL SELATAN, KEBAYORAN LAMA, JAKARTA SELATAN, DKI JAKARTA",56,102,165,267
https://kawalpemilu.org#26026,"GROGOL SELATAN, KEBAYORAN LAMA, JAKARTA SELATAN, DKI JAKARTA",58,127,49,176
https://kawalpemilu.org#26026,"GROGOL SELATAN, KEBAYORAN LAMA, JAKARTA SELATAN, DKI JAKARTA",59,161,32,193
https://kawalpemilu.org#26026,"GROGOL SELATAN, KEBAYORAN LAMA, JAKARTA SELATAN, DKI JAKARTA",60,145,22,167
https://kawalpemilu.org#26026,"GROGOL SELATAN, KEBAYORAN LAMA, JAKARTA SELATAN, DKI JAKARTA",61,139,87,226
https://kawalpemilu.org#26026,"GROGOL SELATAN, KEBAYORAN LAMA, JAKARTA SELATAN, DKI JAKARTA",62,133,76,209
https://kawalpemilu.org#26026,"GROGOL SELATAN, KEBAYORAN LAMA, JAKARTA SELATAN, DKI JAKARTA",63,120,125,245
https://kawalpemilu.org#26026,"GROGOL SELATAN, KEBAYORAN LAMA, JAKARTA SELATAN, DKI JAKARTA",65,96,109,205
https://kawalpemilu.org#26026,"GROGOL SELATAN, KEBAYORAN LAMA, JAKARTA SELATAN, DKI JAKARTA",66,141,60,201
https://kawalpemilu.org#26026,"GROGOL SELATAN, KEBAYORAN LAMA, JAKARTA SELATAN, DKI JAKARTA",67,128,45,173
https://kawalpemilu.org#26026,"GROGOL SELATAN, KEBAYORAN LAMA, JAKARTA SELATAN, DKI JAKARTA",68,85,155,240
https://kawalpemilu.org#26026,"GROGOL SELATAN, KEBAYORAN LAMA, JAKARTA SELATAN, DKI JAKARTA",69,112,139,251
https://kawalpemilu.org#26026,"GROGOL SELATAN, KEBAYORAN LAMA, JAKARTA SELATAN, DKI JAKARTA",70,99,133,232
https://kawalpemilu.org#26026,"GROGOL SELATAN, KEBAYORAN LAMA, JAKARTA SELATAN, DKI JAKARTA",71,134,111,245
https://kawalpemilu.org#26026,"GROGOL SELATAN, KEBAYORAN LAMA, JAKARTA SELATAN, DKI JAKARTA",72,96,138,234
https://kawalpemilu.org#26026,"GROGOL SELATAN, KEBAYORAN LAMA, JAKARTA SELATAN, DKI JAKARTA",73,153,98,251
https://kawalpemilu.org#26026,"GROGOL SELATAN, KEBAYORAN LAMA, JAKARTA SELATAN, DKI JAKARTA",74,76,160,236
https://kawalpemilu.org#26026,"GROGOL SELATAN, KEBAYORAN LAMA, JAKARTA SELATAN, DKI JAKARTA",75,94,113,207
https://kawalpemilu.org#26026,"GROGOL SELATAN, KEBAYORAN LAMA, JAKARTA SELATAN, DKI JAKARTA",76,96,143,239
https://kawalpemilu.org#26026,"GROGOL SELATAN, KEBAYORAN LAMA, JAKARTA SELATAN, DKI JAKARTA",77,82,142,224
https://kawalpemilu.org#26026,"GROGOL SELATAN, KEBAYORAN LAMA, JAKARTA SELATAN, DKI JAKARTA",78,104,156,260
https://kawalpemilu.org#26026,"GROGOL SELATAN, KEBAYORAN LAMA, JAKARTA SELATAN, DKI JAKARTA",79,148,117,265
https://kawalpemilu.org#26026,"GROGOL SELATAN, KEBAYORAN LAMA, JAKARTA SELATAN, DKI JAKARTA",81,113,103,216
https://kawalpemilu.org#26026,"GROGOL SELATAN, KEBAYORAN LAMA, JAKARTA SELATAN, DKI JAKARTA",82,113,117,230
https://kawalpemilu.org#26026,"GROGOL SELATAN, KEBAYORAN LAMA, JAKARTA SELATAN, DKI JAKARTA",83,74,139,213
https://kawalpemilu.org#26026,"GROGOL SELATAN, KEBAYORAN LAMA, JAKARTA SELATAN, DKI JAKARTA",84,106,123,229
https://kawalpemilu.org#26026,"GROGOL SELATAN, KEBAYORAN LAMA, JAKARTA SELATAN, DKI JAKARTA",86,88,119,207
https://kawalpemilu.org#26026,"GROGOL SELATAN, KEBAYORAN LAMA, JAKARTA SELATAN, DKI JAKARTA",87,79,155,234
https://kawalpemilu.org#26026,"GROGOL SELATAN, KEBAYORAN LAMA, JAKARTA SELATAN, DKI JAKARTA",89,59,123,182
https://kawalpemilu.org#26026,"GROGOL SELATAN, KEBAYORAN LAMA, JAKARTA SELATAN, DKI JAKARTA",90,108,164,272
https://kawalpemilu.org#26026,"GROGOL SELATAN, KEBAYORAN LAMA, JAKARTA SELATAN, DKI JAKARTA",91,105,129,234
https://kawalpemilu.org#26026,"GROGOL SELATAN, KEBAYORAN LAMA, JAKARTA SELATAN, DKI JAKARTA",92,100,119,219
https://kawalpemilu.org#26026,"GROGOL SELATAN, KEBAYORAN LAMA, JAKARTA SELATAN, DKI JAKARTA",93,176,52,228
https://kawalpemilu.org#26026,"GROGOL SELATAN, KEBAYORAN LAMA, JAKARTA SELATAN, DKI JAKARTA",94,131,74,205
https://kawalpemilu.org#26026,"GROGOL SELATAN, KEBAYORAN LAMA, JAKARTA SELATAN, DKI JAKARTA",95,122,97,219
https://kawalpemilu.org#26026,"GROGOL SELATAN, KEBAYORAN LAMA, JAKARTA SELATAN, DKI JAKARTA",96,116,90,206
https://kawalpemilu.org#26026,"GROGOL SELATAN, KEBAYORAN LAMA, JAKARTA SELATAN, DKI JAKARTA",97,187,25,212
https://kawalpemilu.org#26026,"GROGOL SELATAN, KEBAYORAN LAMA, JAKARTA SELATAN, DKI JAKARTA",99,200,35,235
https://kawalpemilu.org#26026,"GROGOL SELATAN, KEBAYORAN LAMA, JAKARTA SELATAN, DKI JAKARTA",100,124,85,209
https://kawalpemilu.org#26026,"GROGOL SELATAN, KEBAYORAN LAMA, JAKARTA SELATAN, DKI JAKARTA",101,172,66,238
https://kawalpemilu.org#26026,"GROGOL SELATAN, KEBAYORAN LAMA, JAKARTA SELATAN, DKI JAKARTA",102,116,125,241
https://kawalpemilu.org#26026,"GROGOL SELATAN, KEBAYORAN LAMA, JAKARTA SELATAN, DKI JAKARTA",103,136,108,244
https://kawalpemilu.org#26026,"GROGOL SELATAN, KEBAYORAN LAMA, JAKARTA SELATAN, DKI JAKARTA",104,87,110,197
https://kawalpemilu.org#26026,"GROGOL SELATAN, KEBAYORAN LAMA, JAKARTA SELATAN, DKI JAKARTA",105,119,94,213
https://kawalpemilu.org#26026,"GROGOL SELATAN, KEBAYORAN LAMA, JAKARTA SELATAN, DKI JAKARTA",106,129,93,222
https://kawalpemilu.org#26026,"GROGOL SELATAN, KEBAYORAN LAMA, JAKARTA SELATAN, DKI JAKARTA",107,110,87,197
https://kawalpemilu.org#26026,"GROGOL SELATAN, KEBAYORAN LAMA, JAKARTA SELATAN, DKI JAKARTA",108,116,114,230
https://kawalpemilu.org#26026,"GROGOL SELATAN, KEBAYORAN LAMA, JAKARTA SELATAN, DKI JAKARTA",109,71,183,254
https://kawalpemilu.org#26026,"GROGOL SELATAN, KEBAYORAN LAMA, JAKARTA SELATAN, DKI JAKARTA",111,63,141,204
https://kawalpemilu.org#26026,"GROGOL SELATAN, KEBAYORAN LAMA, JAKARTA SELATAN, DKI JAKARTA",112,135,90,225
https://kawalpemilu.org#26026,"GROGOL SELATAN, KEBAYORAN LAMA, JAKARTA SELATAN, DKI JAKARTA",114,141,112,253
https://kawalpemilu.org#26026,"GROGOL SELATAN, KEBAYORAN LAMA, JAKARTA SELATAN, DKI JAKARTA",115,133,81,214
https://kawalpemilu.org#26026,"GROGOL SELATAN, KEBAYORAN LAMA, JAKARTA SELATAN, DKI JAKARTA",116,167,45,212
https://kawalpemilu.org#26026,"GROGOL SELATAN, KEBAYORAN LAMA, JAKARTA SELATAN, DKI JAKARTA",117,95,121,216
https://kawalpemilu.org#26026,"GROGOL SELATAN, KEBAYORAN LAMA, JAKARTA SELATAN, DKI JAKARTA",118,99,124,223
https://kawalpemilu.org#26026,"GROGOL SELATAN, KEBAYORAN LAMA, JAKARTA SELATAN, DKI JAKARTA",119,131,139,270
https://kawalpemilu.org#26026,"GROGOL SELATAN, KEBAYORAN LAMA, JAKARTA SELATAN, DKI JAKARTA",120,150,97,247
https://kawalpemilu.org#26026,"GROGOL SELATAN, KEBAYORAN LAMA, JAKARTA SELATAN, DKI JAKARTA",121,114,109,223
https://kawalpemilu.org#26026,"GROGOL SELATAN, KEBAYORAN LAMA, JAKARTA SELATAN, DKI JAKARTA",122,119,114,233
https://kawalpemilu.org#26026,"GROGOL SELATAN, KEBAYORAN LAMA, JAKARTA SELATAN, DKI JAKARTA",123,127,90,217
https://kawalpemilu.org#26026,"GROGOL SELATAN, KEBAYORAN LAMA, JAKARTA SELATAN, DKI JAKARTA",124,134,117,251
https://kawalpemilu.org#26026,"GROGOL SELATAN, KEBAYORAN LAMA, JAKARTA SELATAN, DKI JAKARTA",125,109,115,224
https://kawalpemilu.org#26026,"GROGOL SELATAN, KEBAYORAN LAMA, JAKARTA SELATAN, DKI JAKARTA",126,103,123,226
https://kawalpemilu.org#26026,"GROGOL SELATAN, KEBAYORAN LAMA, JAKARTA SELATAN, DKI JAKARTA",127,90,175,265
https://kawalpemilu.org#26026,"GROGOL SELATAN, KEBAYORAN LAMA, JAKARTA SELATAN, DKI JAKARTA",128,97,164,261
https://kawalpemilu.org#26026,"GROGOL SELATAN, KEBAYORAN LAMA, JAKARTA SELATAN, DKI JAKARTA",129,101,129,230
https://kawalpemilu.org#26026,"GROGOL SELATAN, KEBAYORAN LAMA, JAKARTA SELATAN, DKI JAKARTA",130,110,141,251
https://kawalpemilu.org#26026,"GROGOL SELATAN, KEBAYORAN LAMA, JAKARTA SELATAN, DKI JAKARTA",131,91,141,232
https://kawalpemilu.org#26026,"GROGOL SELATAN, KEBAYORAN LAMA, JAKARTA SELATAN, DKI JAKARTA",132,139,117,256
https://kawalpemilu.org#26026,"GROGOL SELATAN, KEBAYORAN LAMA, JAKARTA SELATAN, DKI JAKARTA",133,142,128,270
https://kawalpemilu.org#26026,"GROGOL SELATAN, KEBAYORAN LAMA, JAKARTA SELATAN, DKI JAKARTA",134,118,123,241
https://kawalpemilu.org#26026,"GROGOL SELATAN, KEBAYORAN LAMA, JAKARTA SELATAN, DKI JAKARTA",135,169,77,246
https://kawalpemilu.org#26026,"GROGOL SELATAN, KEBAYORAN LAMA, JAKARTA SELATAN, DKI JAKARTA",136,157,65,222
https://kawalpemilu.org#26026,"GROGOL SELATAN, KEBAYORAN LAMA, JAKARTA SELATAN, DKI JAKARTA",137,134,100,234
https://kawalpemilu.org#26026,"GROGOL SELATAN, KEBAYORAN LAMA, JAKARTA SELATAN, DKI JAKARTA",138,84,151,235
https://kawalpemilu.org#26026,"GROGOL SELATAN, KEBAYORAN LAMA, JAKARTA SELATAN, DKI JAKARTA",139,123,103,226
https://kawalpemilu.org#26026,"GROGOL SELATAN, KEBAYORAN LAMA, JAKARTA SELATAN, DKI JAKARTA",140,148,72,220
https://kawalpemilu.org#26026,"GROGOL SELATAN, KEBAYORAN LAMA, JAKARTA SELATAN, DKI JAKARTA",141,137,85,222
https://kawalpemilu.org#26026,"GROGOL SELATAN, KEBAYORAN LAMA, JAKARTA SELATAN, DKI JAKARTA",142,113,107,220
https://kawalpemilu.org#26026,"GROGOL SELATAN, KEBAYORAN LAMA, JAKARTA SELATAN, DKI JAKARTA",143,90,114,204
https://kawalpemilu.org#26026,"GROGOL SELATAN, KEBAYORAN LAMA, JAKARTA SELATAN, DKI JAKARTA",144,110,130,240
https://kawalpemilu.org#26026,"GROGOL SELATAN, KEBAYORAN LAMA, JAKARTA SELATAN, DKI JAKARTA",145,66,133,199
https://kawalpemilu.org#26026,"GROGOL SELATAN, KEBAYORAN LAMA, JAKARTA SELATAN, DKI JAKARTA",146,72,183,255
https://kawalpemilu.org#26026,"GROGOL SELATAN, KEBAYORAN LAMA, JAKARTA SELATAN, DKI JAKARTA",147,98,96,194
https://kawalpemilu.org#26027,"KEBAYORAN LAMA SELATAN, KEBAYORAN LAMA, JAKARTA SELATAN, DKI JAKARTA",1,0,0,0
https://kawalpemilu.org#26027,"KEBAYORAN LAMA SELATAN, KEBAYORAN LAMA, JAKARTA SELATAN, DKI JAKARTA",2,0,0,0
https://kawalpemilu.org#26027,"KEBAYORAN LAMA SELATAN, KEBAYORAN LAMA, JAKARTA SELATAN, DKI JAKARTA",3,113,108,221
https://kawalpemilu.org#26027,"KEBAYORAN LAMA SELATAN, KEBAYORAN LAMA, JAKARTA SELATAN, DKI JAKARTA",4,162,73,235
https://kawalpemilu.org#26027,"KEBAYORAN LAMA SELATAN, KEBAYORAN LAMA, JAKARTA SELATAN, DKI JAKARTA",5,136,79,215
https://kawalpemilu.org#26027,"KEBAYORAN LAMA SELATAN, KEBAYORAN LAMA, JAKARTA SELATAN, DKI JAKARTA",6,164,36,200
https://kawalpemilu.org#26027,"KEBAYORAN LAMA SELATAN, KEBAYORAN LAMA, JAKARTA SELATAN, DKI JAKARTA",7,166,54,220
https://kawalpemilu.org#26027,"KEBAYORAN LAMA SELATAN, KEBAYORAN LAMA, JAKARTA SELATAN, DKI JAKARTA",8,113,111,224
https://kawalpemilu.org#26027,"KEBAYORAN LAMA SELATAN, KEBAYORAN LAMA, JAKARTA SELATAN, DKI JAKARTA",9,123,103,226
https://kawalpemilu.org#26027,"KEBAYORAN LAMA SELATAN, KEBAYORAN LAMA, JAKARTA SELATAN, DKI JAKARTA",11,113,98,211
https://kawalpemilu.org#26027,"KEBAYORAN LAMA SELATAN, KEBAYORAN LAMA, JAKARTA SELATAN, DKI JAKARTA",12,152,88,240
https://kawalpemilu.org#26027,"KEBAYORAN LAMA SELATAN, KEBAYORAN LAMA, JAKARTA SELATAN, DKI JAKARTA",13,106,134,240
https://kawalpemilu.org#26027,"KEBAYORAN LAMA SELATAN, KEBAYORAN LAMA, JAKARTA SELATAN, DKI JAKARTA",14,142,115,257
https://kawalpemilu.org#26027,"KEBAYORAN LAMA SELATAN, KEBAYORAN LAMA, JAKARTA SELATAN, DKI JAKARTA",15,141,104,245
https://kawalpemilu.org#26027,"KEBAYORAN LAMA SELATAN, KEBAYORAN LAMA, JAKARTA SELATAN, DKI JAKARTA",16,103,101,204
https://kawalpemilu.org#26027,"KEBAYORAN LAMA SELATAN, KEBAYORAN LAMA, JAKARTA SELATAN, DKI JAKARTA",17,130,108,238
https://kawalpemilu.org#26027,"KEBAYORAN LAMA SELATAN, KEBAYORAN LAMA, JAKARTA SELATAN, DKI JAKARTA",18,131,106,237
https://kawalpemilu.org#26027,"KEBAYORAN LAMA SELATAN, KEBAYORAN LAMA, JAKARTA SELATAN, DKI JAKARTA",19,121,111,232
https://kawalpemilu.org#26027,"KEBAYORAN LAMA SELATAN, KEBAYORAN LAMA, JAKARTA SELATAN, DKI JAKARTA",20,141,95,236
https://kawalpemilu.org#26027,"KEBAYORAN LAMA SELATAN, KEBAYORAN LAMA, JAKARTA SELATAN, DKI JAKARTA",22,91,140,231
https://kawalpemilu.org#26027,"KEBAYORAN LAMA SELATAN, KEBAYORAN LAMA, JAKARTA SELATAN, DKI JAKARTA",23,119,114,233
https://kawalpemilu.org#26027,"KEBAYORAN LAMA SELATAN, KEBAYORAN LAMA, JAKARTA SELATAN, DKI JAKARTA",25,136,103,239
https://kawalpemilu.org#26027,"KEBAYORAN LAMA SELATAN, KEBAYORAN LAMA, JAKARTA SELATAN, DKI JAKARTA",26,121,101,222
https://kawalpemilu.org#26027,"KEBAYORAN LAMA SELATAN, KEBAYORAN LAMA, JAKARTA SELATAN, DKI JAKARTA",29,132,69,201
https://kawalpemilu.org#26027,"KEBAYORAN LAMA SELATAN, KEBAYORAN LAMA, JAKARTA SELATAN, DKI JAKARTA",30,122,94,216
https://kawalpemilu.org#26027,"KEBAYORAN LAMA SELATAN, KEBAYORAN LAMA, JAKARTA SELATAN, DKI JAKARTA",31,110,114,224
https://kawalpemilu.org#26027,"KEBAYORAN LAMA SELATAN, KEBAYORAN LAMA, JAKARTA SELATAN, DKI JAKARTA",32,119,101,220
https://kawalpemilu.org#26027,"KEBAYORAN LAMA SELATAN, KEBAYORAN LAMA, JAKARTA SELATAN, DKI JAKARTA",33,123,91,214
https://kawalpemilu.org#26027,"KEBAYORAN LAMA SELATAN, KEBAYORAN LAMA, JAKARTA SELATAN, DKI JAKARTA",34,114,85,199
https://kawalpemilu.org#26027,"KEBAYORAN LAMA SELATAN, KEBAYORAN LAMA, JAKARTA SELATAN, DKI JAKARTA",36,95,113,208
https://kawalpemilu.org#26027,"KEBAYORAN LAMA SELATAN, KEBAYORAN LAMA, JAKARTA SELATAN, DKI JAKARTA",39,147,99,246
https://kawalpemilu.org#26027,"KEBAYORAN LAMA SELATAN, KEBAYORAN LAMA, JAKARTA SELATAN, DKI JAKARTA",40,145,92,237
https://kawalpemilu.org#26027,"KEBAYORAN LAMA SELATAN, KEBAYORAN LAMA, JAKARTA SELATAN, DKI JAKARTA",41,104,91,195
https://kawalpemilu.org#26027,"KEBAYORAN LAMA SELATAN, KEBAYORAN LAMA, JAKARTA SELATAN, DKI JAKARTA",42,101,160,261
https://kawalpemilu.org#26027,"KEBAYORAN LAMA SELATAN, KEBAYORAN LAMA, JAKARTA SELATAN, DKI JAKARTA",44,106,116,222
https://kawalpemilu.org#26027,"KEBAYORAN LAMA SELATAN, KEBAYORAN LAMA, JAKARTA SELATAN, DKI JAKARTA",45,140,92,232
https://kawalpemilu.org#26027,"KEBAYORAN LAMA SELATAN, KEBAYORAN LAMA, JAKARTA SELATAN, DKI JAKARTA",46,135,90,225
https://kawalpemilu.org#26027,"KEBAYORAN LAMA SELATAN, KEBAYORAN LAMA, JAKARTA SELATAN, DKI JAKARTA",47,121,85,206
https://kawalpemilu.org#26027,"KEBAYORAN LAMA SELATAN, KEBAYORAN LAMA, JAKARTA SELATAN, DKI JAKARTA",48,174,72,246
https://kawalpemilu.org#26027,"KEBAYORAN LAMA SELATAN, KEBAYORAN LAMA, JAKARTA SELATAN, DKI JAKARTA",49,162,83,245
https://kawalpemilu.org#26027,"KEBAYORAN LAMA SELATAN, KEBAYORAN LAMA, JAKARTA SELATAN, DKI JAKARTA",50,125,75,200
https://kawalpemilu.org#26027,"KEBAYORAN LAMA SELATAN, KEBAYORAN LAMA, JAKARTA SELATAN, DKI JAKARTA",51,161,69,230
https://kawalpemilu.org#26027,"KEBAYORAN LAMA SELATAN, KEBAYORAN LAMA, JAKARTA SELATAN, DKI JAKARTA",52,125,80,205
https://kawalpemilu.org#26027,"KEBAYORAN LAMA SELATAN, KEBAYORAN LAMA, JAKARTA SELATAN, DKI JAKARTA",53,120,94,214
https://kawalpemilu.org#26027,"KEBAYORAN LAMA SELATAN, KEBAYORAN LAMA, JAKARTA SELATAN, DKI JAKARTA",54,145,93,238
https://kawalpemilu.org#26027,"KEBAYORAN LAMA SELATAN, KEBAYORAN LAMA, JAKARTA SELATAN, DKI JAKARTA",55,119,94,213
https://kawalpemilu.org#26027,"KEBAYORAN LAMA SELATAN, KEBAYORAN LAMA, JAKARTA SELATAN, DKI JAKARTA",56,162,78,240
https://kawalpemilu.org#26027,"KEBAYORAN LAMA SELATAN, KEBAYORAN LAMA, JAKARTA SELATAN, DKI JAKARTA",57,93,132,225
https://kawalpemilu.org#26027,"KEBAYORAN LAMA SELATAN, KEBAYORAN LAMA, JAKARTA SELATAN, DKI JAKARTA",58,97,120,217
https://kawalpemilu.org#26027,"KEBAYORAN LAMA SELATAN, KEBAYORAN LAMA, JAKARTA SELATAN, DKI JAKARTA",59,54,159,213
https://kawalpemilu.org#26027,"KEBAYORAN LAMA SELATAN, KEBAYORAN LAMA, JAKARTA SELATAN, DKI JAKARTA",60,63,145,208
https://kawalpemilu.org#26027,"KEBAYORAN LAMA SELATAN, KEBAYORAN LAMA, JAKARTA SELATAN, DKI JAKARTA",61,75,145,220
https://kawalpemilu.org#26027,"KEBAYORAN LAMA SELATAN, KEBAYORAN LAMA, JAKARTA SELATAN, DKI JAKARTA",66,96,156,252
https://kawalpemilu.org#26027,"KEBAYORAN LAMA SELATAN, KEBAYORAN LAMA, JAKARTA SELATAN, DKI JAKARTA",69,115,100,215
https://kawalpemilu.org#26027,"KEBAYORAN LAMA SELATAN, KEBAYORAN LAMA, JAKARTA SELATAN, DKI JAKARTA",70,95,128,223
https://kawalpemilu.org#26027,"KEBAYORAN LAMA SELATAN, KEBAYORAN LAMA, JAKARTA SELATAN, DKI JAKARTA",71,120,90,210
https://kawalpemilu.org#26027,"KEBAYORAN LAMA SELATAN, KEBAYORAN LAMA, JAKARTA SELATAN, DKI JAKARTA",73,99,118,217
https://kawalpemilu.org#26027,"KEBAYORAN LAMA SELATAN, KEBAYORAN LAMA, JAKARTA SELATAN, DKI JAKARTA",74,80,140,220
https://kawalpemilu.org#26027,"KEBAYORAN LAMA SELATAN, KEBAYORAN LAMA, JAKARTA SELATAN, DKI JAKARTA",75,82,133,215
https://kawalpemilu.org#26027,"KEBAYORAN LAMA SELATAN, KEBAYORAN LAMA, JAKARTA SELATAN, DKI JAKARTA",77,142,61,203
https://kawalpemilu.org#26027,"KEBAYORAN LAMA SELATAN, KEBAYORAN LAMA, JAKARTA SELATAN, DKI JAKARTA",78,107,120,227
https://kawalpemilu.org#26027,"KEBAYORAN LAMA SELATAN, KEBAYORAN LAMA, JAKARTA SELATAN, DKI JAKARTA",79,123,94,217
https://kawalpemilu.org#26027,"KEBAYORAN LAMA SELATAN, KEBAYORAN LAMA, JAKARTA SELATAN, DKI JAKARTA",80,102,114,216
https://kawalpemilu.org#26027,"KEBAYORAN LAMA SELATAN, KEBAYORAN LAMA, JAKARTA SELATAN, DKI JAKARTA",81,83,139,222
https://kawalpemilu.org#26027,"KEBAYORAN LAMA SELATAN, KEBAYORAN LAMA, JAKARTA SELATAN, DKI JAKARTA",82,87,114,201
https://kawalpemilu.org#26027,"KEBAYORAN LAMA SELATAN, KEBAYORAN LAMA, JAKARTA SELATAN, DKI JAKARTA",83,134,78,212
https://kawalpemilu.org#26027,"KEBAYORAN LAMA SELATAN, KEBAYORAN LAMA, JAKARTA SELATAN, DKI JAKARTA",84,114,85,199
https://kawalpemilu.org#26027,"KEBAYORAN LAMA SELATAN, KEBAYORAN LAMA, JAKARTA SELATAN, DKI JAKARTA",85,119,72,191
https://kawalpemilu.org#26027,"KEBAYORAN LAMA SELATAN, KEBAYORAN LAMA, JAKARTA SELATAN, DKI JAKARTA",86,89,107,196
https://kawalpemilu.org#26027,"KEBAYORAN LAMA SELATAN, KEBAYORAN LAMA, JAKARTA SELATAN, DKI JAKARTA",87,123,92,215
https://kawalpemilu.org#26027,"KEBAYORAN LAMA SELATAN, KEBAYORAN LAMA, JAKARTA SELATAN, DKI JAKARTA",88,136,83,219
https://kawalpemilu.org#26027,"KEBAYORAN LAMA SELATAN, KEBAYORAN LAMA, JAKARTA SELATAN, DKI JAKARTA",89,115,76,191
https://kawalpemilu.org#26027,"KEBAYORAN LAMA SELATAN, KEBAYORAN LAMA, JAKARTA SELATAN, DKI JAKARTA",92,133,100,233
https://kawalpemilu.org#26027,"KEBAYORAN LAMA SELATAN, KEBAYORAN LAMA, JAKARTA SELATAN, DKI JAKARTA",93,119,104,223
https://kawalpemilu.org#26027,"KEBAYORAN LAMA SELATAN, KEBAYORAN LAMA, JAKARTA SELATAN, DKI JAKARTA",94,138,93,231
https://kawalpemilu.org#26027,"KEBAYORAN LAMA SELATAN, KEBAYORAN LAMA, JAKARTA SELATAN, DKI JAKARTA",95,128,113,241
https://kawalpemilu.org#26027,"KEBAYORAN LAMA SELATAN, KEBAYORAN LAMA, JAKARTA SELATAN, DKI JAKARTA",96,126,117,243
https://kawalpemilu.org#26027,"KEBAYORAN LAMA SELATAN, KEBAYORAN LAMA, JAKARTA SELATAN, DKI JAKARTA",97,123,109,232
https://kawalpemilu.org#26027,"KEBAYORAN LAMA SELATAN, KEBAYORAN LAMA, JAKARTA SELATAN, DKI JAKARTA",98,127,102,229
https://kawalpemilu.org#26027,"KEBAYORAN LAMA SELATAN, KEBAYORAN LAMA, JAKARTA SELATAN, DKI JAKARTA",100,152,88,240
https://kawalpemilu.org#26027,"KEBAYORAN LAMA SELATAN, KEBAYORAN LAMA, JAKARTA SELATAN, DKI JAKARTA",101,99,99,198
https://kawalpemilu.org#26027,"KEBAYORAN LAMA SELATAN, KEBAYORAN LAMA, JAKARTA SELATAN, DKI JAKARTA",102,135,102,237
https://kawalpemilu.org#26027,"KEBAYORAN LAMA SELATAN, KEBAYORAN LAMA, JAKARTA SELATAN, DKI JAKARTA",103,115,114,229
https://kawalpemilu.org#26027,"KEBAYORAN LAMA SELATAN, KEBAYORAN LAMA, JAKARTA SELATAN, DKI JAKARTA",104,129,89,218
https://kawalpemilu.org#26027,"KEBAYORAN LAMA SELATAN, KEBAYORAN LAMA, JAKARTA SELATAN, DKI JAKARTA",105,155,92,247
https://kawalpemilu.org#26027,"KEBAYORAN LAMA SELATAN, KEBAYORAN LAMA, JAKARTA SELATAN, DKI JAKARTA",106,94,119,213
https://kawalpemilu.org#26027,"KEBAYORAN LAMA SELATAN, KEBAYORAN LAMA, JAKARTA SELATAN, DKI JAKARTA",107,114,102,216
https://kawalpemilu.org#26027,"KEBAYORAN LAMA SELATAN, KEBAYORAN LAMA, JAKARTA SELATAN, DKI JAKARTA",108,120,117,237
https://kawalpemilu.org#26027,"KEBAYORAN LAMA SELATAN, KEBAYORAN LAMA, JAKARTA SELATAN, DKI JAKARTA",109,110,121,231
https://kawalpemilu.org#26027,"KEBAYORAN LAMA SELATAN, KEBAYORAN LAMA, JAKARTA SELATAN, DKI JAKARTA",110,120,117,237
https://kawalpemilu.org#26027,"KEBAYORAN LAMA SELATAN, KEBAYORAN LAMA, JAKARTA SELATAN, DKI JAKARTA",111,121,125,246
https://kawalpemilu.org#26027,"KEBAYORAN LAMA SELATAN, KEBAYORAN LAMA, JAKARTA SELATAN, DKI JAKARTA",112,118,120,238
https://kawalpemilu.org#26027,"KEBAYORAN LAMA SELATAN, KEBAYORAN LAMA, JAKARTA SELATAN, DKI JAKARTA",113,126,107,233
https://kawalpemilu.org#26027,"KEBAYORAN LAMA SELATAN, KEBAYORAN LAMA, JAKARTA SELATAN, DKI JAKARTA",114,166,78,244
https://kawalpemilu.org#26027,"KEBAYORAN LAMA SELATAN, KEBAYORAN LAMA, JAKARTA SELATAN, DKI JAKARTA",115,128,85,213
https://kawalpemilu.org#26027,"KEBAYORAN LAMA SELATAN, KEBAYORAN LAMA, JAKARTA SELATAN, DKI JAKARTA",116,140,75,215
https://kawalpemilu.org#26027,"KEBAYORAN LAMA SELATAN, KEBAYORAN LAMA, JAKARTA SELATAN, DKI JAKARTA",117,136,71,207
https://kawalpemilu.org#26027,"KEBAYORAN LAMA SELATAN, KEBAYORAN LAMA, JAKARTA SELATAN, DKI JAKARTA",118,98,102,200
https://kawalpemilu.org#26027,"KEBAYORAN LAMA SELATAN, KEBAYORAN LAMA, JAKARTA SELATAN, DKI JAKARTA",119,107,111,218
https://kawalpemilu.org#26027,"KEBAYORAN LAMA SELATAN, KEBAYORAN LAMA, JAKARTA SELATAN, DKI JAKARTA",120,97,129,224
https://kawalpemilu.org#26027,"KEBAYORAN LAMA SELATAN, KEBAYORAN LAMA, JAKARTA SELATAN, DKI JAKARTA",122,103,94,197
https://kawalpemilu.org#26027,"KEBAYORAN LAMA SELATAN, KEBAYORAN LAMA, JAKARTA SELATAN, DKI JAKARTA",124,123,103,226
https://kawalpemilu.org#26027,"KEBAYORAN LAMA SELATAN, KEBAYORAN LAMA, JAKARTA SELATAN, DKI JAKARTA",125,157,88,245
https://kawalpemilu.org#26027,"KEBAYORAN LAMA SELATAN, KEBAYORAN LAMA, JAKARTA SELATAN, DKI JAKARTA",126,109,117,226
https://kawalpemilu.org#26027,"KEBAYORAN LAMA SELATAN, KEBAYORAN LAMA, JAKARTA SELATAN, DKI JAKARTA",127,121,104,225
https://kawalpemilu.org#26027,"KEBAYORAN LAMA SELATAN, KEBAYORAN LAMA, JAKARTA SELATAN, DKI JAKARTA",128,172,78,250
https://kawalpemilu.org#26027,"KEBAYORAN LAMA SELATAN, KEBAYORAN LAMA, JAKARTA SELATAN, DKI JAKARTA",131,91,141,232
https://kawalpemilu.org#26027,"KEBAYORAN LAMA SELATAN, KEBAYORAN LAMA, JAKARTA SELATAN, DKI JAKARTA",132,89,97,186
https://kawalpemilu.org#26027,"KEBAYORAN LAMA SELATAN, KEBAYORAN LAMA, JAKARTA SELATAN, DKI JAKARTA",133,144,119,263
https://kawalpemilu.org#26027,"KEBAYORAN LAMA SELATAN, KEBAYORAN LAMA, JAKARTA SELATAN, DKI JAKARTA",134,112,107,219
https://kawalpemilu.org#26029,"CILANDAK BARAT, CILANDAK, JAKARTA SELATAN, DKI JAKARTA",1,85,136,221
https://kawalpemilu.org#26029,"CILANDAK BARAT, CILANDAK, JAKARTA SELATAN, DKI JAKARTA",2,77,147,0
https://kawalpemilu.org#26029,"CILANDAK BARAT, CILANDAK, JAKARTA SELATAN, DKI JAKARTA",3,81,121,202
https://kawalpemilu.org#26029,"CILANDAK BARAT, CILANDAK, JAKARTA SELATAN, DKI JAKARTA",4,81,70,151
https://kawalpemilu.org#26029,"CILANDAK BARAT, CILANDAK, JAKARTA SELATAN, DKI JAKARTA",5,97,57,154
https://kawalpemilu.org#26029,"CILANDAK BARAT, CILANDAK, JAKARTA SELATAN, DKI JAKARTA",6,104,107,211
https://kawalpemilu.org#26029,"CILANDAK BARAT, CILANDAK, JAKARTA SELATAN, DKI JAKARTA",7,130,117,247
https://kawalpemilu.org#26029,"CILANDAK BARAT, CILANDAK, JAKARTA SELATAN, DKI JAKARTA",8,140,66,206
https://kawalpemilu.org#26029,"CILANDAK BARAT, CILANDAK, JAKARTA SELATAN, DKI JAKARTA",9,94,52,146
https://kawalpemilu.org#26029,"CILANDAK BARAT, CILANDAK, JAKARTA SELATAN, DKI JAKARTA",10,129,111,240
https://kawalpemilu.org#26029,"CILANDAK BARAT, CILANDAK, JAKARTA SELATAN, DKI JAKARTA",11,106,55,161
https://kawalpemilu.org#26029,"CILANDAK BARAT, CILANDAK, JAKARTA SELATAN, DKI JAKARTA",13,52,54,106
https://kawalpemilu.org#26029,"CILANDAK BARAT, CILANDAK, JAKARTA SELATAN, DKI JAKARTA",14,159,45,204
https://kawalpemilu.org#26029,"CILANDAK BARAT, CILANDAK, JAKARTA SELATAN, DKI JAKARTA",15,92,65,157
https://kawalpemilu.org#26029,"CILANDAK BARAT, CILANDAK, JAKARTA SELATAN, DKI JAKARTA",16,65,29,94
https://kawalpemilu.org#26029,"CILANDAK BARAT, CILANDAK, JAKARTA SELATAN, DKI JAKARTA",17,122,110,232
https://kawalpemilu.org#26029,"CILANDAK BARAT, CILANDAK, JAKARTA SELATAN, DKI JAKARTA",18,117,92,209
https://kawalpemilu.org#26029,"CILANDAK BARAT, CILANDAK, JAKARTA SELATAN, DKI JAKARTA",19,103,95,198
https://kawalpemilu.org#26029,"CILANDAK BARAT, CILANDAK, JAKARTA SELATAN, DKI JAKARTA",20,100,99,199
https://kawalpemilu.org#26029,"CILANDAK BARAT, CILANDAK, JAKARTA SELATAN, DKI JAKARTA",21,114,107,221
https://kawalpemilu.org#26029,"CILANDAK BARAT, CILANDAK, JAKARTA SELATAN, DKI JAKARTA",24,137,82,219
https://kawalpemilu.org#26029,"CILANDAK BARAT, CILANDAK, JAKARTA SELATAN, DKI JAKARTA",26,130,85,215
https://kawalpemilu.org#26029,"CILANDAK BARAT, CILANDAK, JAKARTA SELATAN, DKI JAKARTA",27,114,81,195
https://kawalpemilu.org#26029,"CILANDAK BARAT, CILANDAK, JAKARTA SELATAN, DKI JAKARTA",28,127,89,216
https://kawalpemilu.org#26029,"CILANDAK BARAT, CILANDAK, JAKARTA SELATAN, DKI JAKARTA",29,102,111,213
https://kawalpemilu.org#26029,"CILANDAK BARAT, CILANDAK, JAKARTA SELATAN, DKI JAKARTA",31,97,108,205
https://kawalpemilu.org#26029,"CILANDAK BARAT, CILANDAK, JAKARTA SELATAN, DKI JAKARTA",32,116,95,211
https://kawalpemilu.org#26029,"CILANDAK BARAT, CILANDAK, JAKARTA SELATAN, DKI JAKARTA",33,105,60,165
https://kawalpemilu.org#26029,"CILANDAK BARAT, CILANDAK, JAKARTA SELATAN, DKI JAKARTA",34,133,49,182
https://kawalpemilu.org#26029,"CILANDAK BARAT, CILANDAK, JAKARTA SELATAN, DKI JAKARTA",36,158,70,228
https://kawalpemilu.org#26029,"CILANDAK BARAT, CILANDAK, JAKARTA SELATAN, DKI JAKARTA",37,110,73,183
https://kawalpemilu.org#26029,"CILANDAK BARAT, CILANDAK, JAKARTA SELATAN, DKI JAKARTA",38,149,108,257
https://kawalpemilu.org#26029,"CILANDAK BARAT, CILANDAK, JAKARTA SELATAN, DKI JAKARTA",39,146,62,208
https://kawalpemilu.org#26029,"CILANDAK BARAT, CILANDAK, JAKARTA SELATAN, DKI JAKARTA",40,126,85,211
https://kawalpemilu.org#26029,"CILANDAK BARAT, CILANDAK, JAKARTA SELATAN, DKI JAKARTA",41,210,74,284
https://kawalpemilu.org#26029,"CILANDAK BARAT, CILANDAK, JAKARTA SELATAN, DKI JAKARTA",42,105,136,241
https://kawalpemilu.org#26029,"CILANDAK BARAT, CILANDAK, JAKARTA SELATAN, DKI JAKARTA",43,127,89,216
https://kawalpemilu.org#26029,"CILANDAK BARAT, CILANDAK, JAKARTA SELATAN, DKI JAKARTA",45,91,73,164
https://kawalpemilu.org#26029,"CILANDAK BARAT, CILANDAK, JAKARTA SELATAN, DKI JAKARTA",46,155,70,225
https://kawalpemilu.org#26029,"CILANDAK BARAT, CILANDAK, JAKARTA SELATAN, DKI JAKARTA",47,155,69,224
https://kawalpemilu.org#26029,"CILANDAK BARAT, CILANDAK, JAKARTA SELATAN, DKI JAKARTA",48,129,79,205
https://kawalpemilu.org#26029,"CILANDAK BARAT, CILANDAK, JAKARTA SELATAN, DKI JAKARTA",50,110,57,167
https://kawalpemilu.org#26029,"CILANDAK BARAT, CILANDAK, JAKARTA SELATAN, DKI JAKARTA",51,150,39,189
https://kawalpemilu.org#26029,"CILANDAK BARAT, CILANDAK, JAKARTA SELATAN, DKI JAKARTA",52,95,154,249
https://kawalpemilu.org#26029,"CILANDAK BARAT, CILANDAK, JAKARTA SELATAN, DKI JAKARTA",53,116,126,242
https://kawalpemilu.org#26029,"CILANDAK BARAT, CILANDAK, JAKARTA SELATAN, DKI JAKARTA",54,130,115,245
https://kawalpemilu.org#26029,"CILANDAK BARAT, CILANDAK, JAKARTA SELATAN, DKI JAKARTA",55,115,106,221
https://kawalpemilu.org#26029,"CILANDAK BARAT, CILANDAK, JAKARTA SELATAN, DKI JAKARTA",56,99,40,139
https://kawalpemilu.org#26029,"CILANDAK BARAT, CILANDAK, JAKARTA SELATAN, DKI JAKARTA",57,102,128,230
https://kawalpemilu.org#26029,"CILANDAK BARAT, CILANDAK, JAKARTA SELATAN, DKI JAKARTA",58,109,134,243
https://kawalpemilu.org#26029,"CILANDAK BARAT, CILANDAK, JAKARTA SELATAN, DKI JAKARTA",59,109,132,241
https://kawalpemilu.org#26029,"CILANDAK BARAT, CILANDAK, JAKARTA SELATAN, DKI JAKARTA",60,117,120,237
https://kawalpemilu.org#26029,"CILANDAK BARAT, CILANDAK, JAKARTA SELATAN, DKI JAKARTA",61,108,128,236
https://kawalpemilu.org#26029,"CILANDAK BARAT, CILANDAK, JAKARTA SELATAN, DKI JAKARTA",62,135,109,244
https://kawalpemilu.org#26029,"CILANDAK BARAT, CILANDAK, JAKARTA SELATAN, DKI JAKARTA",63,123,128,251
https://kawalpemilu.org#26029,"CILANDAK BARAT, CILANDAK, JAKARTA SELATAN, DKI JAKARTA",64,140,103,243
https://kawalpemilu.org#26029,"CILANDAK BARAT, CILANDAK, JAKARTA SELATAN, DKI JAKARTA",65,118,137,255
https://kawalpemilu.org#26029,"CILANDAK BARAT, CILANDAK, JAKARTA SELATAN, DKI JAKARTA",66,77,95,172
https://kawalpemilu.org#26029,"CILANDAK BARAT, CILANDAK, JAKARTA SELATAN, DKI JAKARTA",67,83,80,163
https://kawalpemilu.org#26029,"CILANDAK BARAT, CILANDAK, JAKARTA SELATAN, DKI JAKARTA",68,174,55,229
https://kawalpemilu.org#26029,"CILANDAK BARAT, CILANDAK, JAKARTA SELATAN, DKI JAKARTA",69,111,139,250
https://kawalpemilu.org#26029,"CILANDAK BARAT, CILANDAK, JAKARTA SELATAN, DKI JAKARTA",70,127,120,247
https://kawalpemilu.org#26029,"CILANDAK BARAT, CILANDAK, JAKARTA SELATAN, DKI JAKARTA",72,125,149,274
https://kawalpemilu.org#26029,"CILANDAK BARAT, CILANDAK, JAKARTA SELATAN, DKI JAKARTA",73,101,139,240
https://kawalpemilu.org#26029,"CILANDAK BARAT, CILANDAK, JAKARTA SELATAN, DKI JAKARTA",74,128,102,230
https://kawalpemilu.org#26029,"CILANDAK BARAT, CILANDAK, JAKARTA SELATAN, DKI JAKARTA",75,125,52,177
https://kawalpemilu.org#26029,"CILANDAK BARAT, CILANDAK, JAKARTA SELATAN, DKI JAKARTA",76,156,58,214
https://kawalpemilu.org#26029,"CILANDAK BARAT, CILANDAK, JAKARTA SELATAN, DKI JAKARTA",77,85,78,163
https://kawalpemilu.org#26029,"CILANDAK BARAT, CILANDAK, JAKARTA SELATAN, DKI JAKARTA",78,113,68,181
https://kawalpemilu.org#26029,"CILANDAK BARAT, CILANDAK, JAKARTA SELATAN, DKI JAKARTA",79,138,75,213
https://kawalpemilu.org#26029,"CILANDAK BARAT, CILANDAK, JAKARTA SELATAN, DKI JAKARTA",80,119,127,246
https://kawalpemilu.org#26029,"CILANDAK BARAT, CILANDAK, JAKARTA SELATAN, DKI JAKARTA",81,115,101,216
https://kawalpemilu.org#26029,"CILANDAK BARAT, CILANDAK, JAKARTA SELATAN, DKI JAKARTA",82,101,109,110
https://kawalpemilu.org#26029,"CILANDAK BARAT, CILANDAK, JAKARTA SELATAN, DKI JAKARTA",83,93,90,183
https://kawalpemilu.org#26029,"CILANDAK BARAT, CILANDAK, JAKARTA SELATAN, DKI JAKARTA",85,126,103,229
https://kawalpemilu.org#26029,"CILANDAK BARAT, CILANDAK, JAKARTA SELATAN, DKI JAKARTA",86,128,112,240
https://kawalpemilu.org#26029,"CILANDAK BARAT, CILANDAK, JAKARTA SELATAN, DKI JAKARTA",87,146,102,248
https://kawalpemilu.org#26029,"CILANDAK BARAT, CILANDAK, JAKARTA SELATAN, DKI JAKARTA",88,85,164,249
https://kawalpemilu.org#26029,"CILANDAK BARAT, CILANDAK, JAKARTA SELATAN, DKI JAKARTA",89,102,142,244
https://kawalpemilu.org#26029,"CILANDAK BARAT, CILANDAK, JAKARTA SELATAN, DKI JAKARTA",90,104,128,232
https://kawalpemilu.org#26029,"CILANDAK BARAT, CILANDAK, JAKARTA SELATAN, DKI JAKARTA",91,129,122,251
https://kawalpemilu.org#26029,"CILANDAK BARAT, CILANDAK, JAKARTA SELATAN, DKI JAKARTA",92,109,132,241
https://kawalpemilu.org#26029,"CILANDAK BARAT, CILANDAK, JAKARTA SELATAN, DKI JAKARTA",93,75,152,227
https://kawalpemilu.org#26029,"CILANDAK BARAT, CILANDAK, JAKARTA SELATAN, DKI JAKARTA",94,98,119,217
https://kawalpemilu.org#26029,"CILANDAK BARAT, CILANDAK, JAKARTA SELATAN, DKI JAKARTA",95,122,123,245
https://kawalpemilu.org#26029,"CILANDAK BARAT, CILANDAK, JAKARTA SELATAN, DKI JAKARTA",96,57,92,149
https://kawalpemilu.org#26029,"CILANDAK BARAT, CILANDAK, JAKARTA SELATAN, DKI JAKARTA",97,72,75,147
https://kawalpemilu.org#26029,"CILANDAK BARAT, CILANDAK, JAKARTA SELATAN, DKI JAKARTA",98,136,84,220
https://kawalpemilu.org#26029,"CILANDAK BARAT, CILANDAK, JAKARTA SELATAN, DKI JAKARTA",99,87,51,138
https://kawalpemilu.org#26029,"CILANDAK BARAT, CILANDAK, JAKARTA SELATAN, DKI JAKARTA",100,149,93,242
https://kawalpemilu.org#26029,"CILANDAK BARAT, CILANDAK, JAKARTA SELATAN, DKI JAKARTA",101,127,78,205
https://kawalpemilu.org#26029,"CILANDAK BARAT, CILANDAK, JAKARTA SELATAN, DKI JAKARTA",102,176,83,259
https://kawalpemilu.org#26029,"CILANDAK BARAT, CILANDAK, JAKARTA SELATAN, DKI JAKARTA",104,147,44,191
https://kawalpemilu.org#26029,"CILANDAK BARAT, CILANDAK, JAKARTA SELATAN, DKI JAKARTA",105,143,80,223
https://kawalpemilu.org#26029,"CILANDAK BARAT, CILANDAK, JAKARTA SELATAN, DKI JAKARTA",106,159,71,230
https://kawalpemilu.org#26029,"CILANDAK BARAT, CILANDAK, JAKARTA SELATAN, DKI JAKARTA",107,137,82,219
https://kawalpemilu.org#26029,"CILANDAK BARAT, CILANDAK, JAKARTA SELATAN, DKI JAKARTA",108,126,88,214
https://kawalpemilu.org#26029,"CILANDAK BARAT, CILANDAK, JAKARTA SELATAN, DKI JAKARTA",109,104,83,187
https://kawalpemilu.org#26029,"CILANDAK BARAT, CILANDAK, JAKARTA SELATAN, DKI JAKARTA",110,123,67,190
https://kawalpemilu.org#26029,"CILANDAK BARAT, CILANDAK, JAKARTA SELATAN, DKI JAKARTA",111,90,78,168
https://kawalpemilu.org#26029,"CILANDAK BARAT, CILANDAK, JAKARTA SELATAN, DKI JAKARTA",112,126,43,169
https://kawalpemilu.org#26029,"CILANDAK BARAT, CILANDAK, JAKARTA SELATAN, DKI JAKARTA",114,134,32,168
https://kawalpemilu.org#26029,"CILANDAK BARAT, CILANDAK, JAKARTA SELATAN, DKI JAKARTA",115,140,106,246
https://kawalpemilu.org#26029,"CILANDAK BARAT, CILANDAK, JAKARTA SELATAN, DKI JAKARTA",116,108,41,149
https://kawalpemilu.org#26029,"CILANDAK BARAT, CILANDAK, JAKARTA SELATAN, DKI JAKARTA",117,135,98,233
https://kawalpemilu.org#26029,"CILANDAK BARAT, CILANDAK, JAKARTA SELATAN, DKI JAKARTA",118,114,107,221
https://kawalpemilu.org#26029,"CILANDAK BARAT, CILANDAK, JAKARTA SELATAN, DKI JAKARTA",119,98,58,156
https://kawalpemilu.org#26029,"CILANDAK BARAT, CILANDAK, JAKARTA SELATAN, DKI JAKARTA",121,130,115,245
https://kawalpemilu.org#26029,"CILANDAK BARAT, CILANDAK, JAKARTA SELATAN, DKI JAKARTA",123,123,86,209
https://kawalpemilu.org#26029,"CILANDAK BARAT, CILANDAK, JAKARTA SELATAN, DKI JAKARTA",124,120,101,221
https://kawalpemilu.org#26029,"CILANDAK BARAT, CILANDAK, JAKARTA SELATAN, DKI JAKARTA",127,116,137,253
https://kawalpemilu.org#26029,"CILANDAK BARAT, CILANDAK, JAKARTA SELATAN, DKI JAKARTA",128,101,71,172
https://kawalpemilu.org#26029,"CILANDAK BARAT, CILANDAK, JAKARTA SELATAN, DKI JAKARTA",129,105,63,168
https://kawalpemilu.org#26029,"CILANDAK BARAT, CILANDAK, JAKARTA SELATAN, DKI JAKARTA",131,104,68,172
https://kawalpemilu.org#26029,"CILANDAK BARAT, CILANDAK, JAKARTA SELATAN, DKI JAKARTA",132,71,99,170
https://kawalpemilu.org#26029,"CILANDAK BARAT, CILANDAK, JAKARTA SELATAN, DKI JAKARTA",133,85,69,154
https://kawalpemilu.org#26029,"CILANDAK BARAT, CILANDAK, JAKARTA SELATAN, DKI JAKARTA",134,130,48,178
https://kawalpemilu.org#26029,"CILANDAK BARAT, CILANDAK, JAKARTA SELATAN, DKI JAKARTA",135,157,64,221
https://kawalpemilu.org#26029,"CILANDAK BARAT, CILANDAK, JAKARTA SELATAN, DKI JAKARTA",136,150,82,232
https://kawalpemilu.org#26029,"CILANDAK BARAT, CILANDAK, JAKARTA SELATAN, DKI JAKARTA",137,191,82,273
https://kawalpemilu.org#26029,"CILANDAK BARAT, CILANDAK, JAKARTA SELATAN, DKI JAKARTA",138,136,57,193
https://kawalpemilu.org#26029,"CILANDAK BARAT, CILANDAK, JAKARTA SELATAN, DKI JAKARTA",139,145,85,230
https://kawalpemilu.org#26029,"CILANDAK BARAT, CILANDAK, JAKARTA SELATAN, DKI JAKARTA",140,69,78,147
https://kawalpemilu.org#26029,"CILANDAK BARAT, CILANDAK, JAKARTA SELATAN, DKI JAKARTA",141,164,63,227
https://kawalpemilu.org#26029,"CILANDAK BARAT, CILANDAK, JAKARTA SELATAN, DKI JAKARTA",142,85,118,203
https://kawalpemilu.org#26029,"CILANDAK BARAT, CILANDAK, JAKARTA SELATAN, DKI JAKARTA",143,130,64,194
https://kawalpemilu.org#26029,"CILANDAK BARAT, CILANDAK, JAKARTA SELATAN, DKI JAKARTA",145,103,52,155
https://kawalpemilu.org#26029,"CILANDAK BARAT, CILANDAK, JAKARTA SELATAN, DKI JAKARTA",146,107,46,153
https://kawalpemilu.org#26029,"CILANDAK BARAT, CILANDAK, JAKARTA SELATAN, DKI JAKARTA",147,158,62,220
https://kawalpemilu.org#26029,"CILANDAK BARAT, CILANDAK, JAKARTA SELATAN, DKI JAKARTA",148,93,132,225
https://kawalpemilu.org#26029,"CILANDAK BARAT, CILANDAK, JAKARTA SELATAN, DKI JAKARTA",149,159,95,254
https://kawalpemilu.org#26029,"CILANDAK BARAT, CILANDAK, JAKARTA SELATAN, DKI JAKARTA",150,83,98,181
https://kawalpemilu.org#26029,"CILANDAK BARAT, CILANDAK, JAKARTA SELATAN, DKI JAKARTA",151,124,125,249
https://kawalpemilu.org#26029,"CILANDAK BARAT, CILANDAK, JAKARTA SELATAN, DKI JAKARTA",152,103,128,231
https://kawalpemilu.org#26029,"CILANDAK BARAT, CILANDAK, JAKARTA SELATAN, DKI JAKARTA",153,141,56,197
https://kawalpemilu.org#26029,"CILANDAK BARAT, CILANDAK, JAKARTA SELATAN, DKI JAKARTA",156,152,115,267
https://kawalpemilu.org#26029,"CILANDAK BARAT, CILANDAK, JAKARTA SELATAN, DKI JAKARTA",158,190,59,249
https://kawalpemilu.org#26029,"CILANDAK BARAT, CILANDAK, JAKARTA SELATAN, DKI JAKARTA",159,152,89,241
https://kawalpemilu.org#26029,"CILANDAK BARAT, CILANDAK, JAKARTA SELATAN, DKI JAKARTA",160,142,69,211
https://kawalpemilu.org#26029,"CILANDAK BARAT, CILANDAK, JAKARTA SELATAN, DKI JAKARTA",161,117,40,157
https://kawalpemilu.org#26029,"CILANDAK BARAT, CILANDAK, JAKARTA SELATAN, DKI JAKARTA",163,108,99,207
https://kawalpemilu.org#26029,"CILANDAK BARAT, CILANDAK, JAKARTA SELATAN, DKI JAKARTA",164,125,109,234
https://kawalpemilu.org#26029,"CILANDAK BARAT, CILANDAK, JAKARTA SELATAN, DKI JAKARTA",165,136,119,255
https://kawalpemilu.org#26029,"CILANDAK BARAT, CILANDAK, JAKARTA SELATAN, DKI JAKARTA",166,108,137,245
https://kawalpemilu.org#26029,"CILANDAK BARAT, CILANDAK, JAKARTA SELATAN, DKI JAKARTA",167,116,112,228
https://kawalpemilu.org#26029,"CILANDAK BARAT, CILANDAK, JAKARTA SELATAN, DKI JAKARTA",168,130,131,261
https://kawalpemilu.org#26029,"CILANDAK BARAT, CILANDAK, JAKARTA SELATAN, DKI JAKARTA",169,122,119,242
https://kawalpemilu.org#26029,"CILANDAK BARAT, CILANDAK, JAKARTA SELATAN, DKI JAKARTA",170,93,87,180
https://kawalpemilu.org#26029,"CILANDAK BARAT, CILANDAK, JAKARTA SELATAN, DKI JAKARTA",173,142,78,220
https://kawalpemilu.org#26029,"CILANDAK BARAT, CILANDAK, JAKARTA SELATAN, DKI JAKARTA",174,122,80,202
https://kawalpemilu.org#26029,"CILANDAK BARAT, CILANDAK, JAKARTA SELATAN, DKI JAKARTA",175,129,52,181
https://kawalpemilu.org#26029,"CILANDAK BARAT, CILANDAK, JAKARTA SELATAN, DKI JAKARTA",176,126,59,185
https://kawalpemilu.org#26029,"CILANDAK BARAT, CILANDAK, JAKARTA SELATAN, DKI JAKARTA",177,134,63,197
https://kawalpemilu.org#26029,"CILANDAK BARAT, CILANDAK, JAKARTA SELATAN, DKI JAKARTA",178,130,95,225
https://kawalpemilu.org#26029,"CILANDAK BARAT, CILANDAK, JAKARTA SELATAN, DKI JAKARTA",179,137,55,192
https://kawalpemilu.org#26029,"CILANDAK BARAT, CILANDAK, JAKARTA SELATAN, DKI JAKARTA",181,114,77,191
https://kawalpemilu.org#26029,"CILANDAK BARAT, CILANDAK, JAKARTA SELATAN, DKI JAKARTA",182,153,54,207
https://kawalpemilu.org#26030,"LEBAK BULUS, CILANDAK, JAKARTA SELATAN, DKI JAKARTA",1,85,124,209
https://kawalpemilu.org#26030,"LEBAK BULUS, CILANDAK, JAKARTA SELATAN, DKI JAKARTA",3,88,83,171
https://kawalpemilu.org#26030,"LEBAK BULUS, CILANDAK, JAKARTA SELATAN, DKI JAKARTA",4,60,143,203
https://kawalpemilu.org#26030,"LEBAK BULUS, CILANDAK, JAKARTA SELATAN, DKI JAKARTA",6,92,143,235
https://kawalpemilu.org#26030,"LEBAK BULUS, CILANDAK, JAKARTA SELATAN, DKI JAKARTA",7,115,92,207
https://kawalpemilu.org#26030,"LEBAK BULUS, CILANDAK, JAKARTA SELATAN, DKI JAKARTA",10,124,67,191
https://kawalpemilu.org#26030,"LEBAK BULUS, CILANDAK, JAKARTA SELATAN, DKI JAKARTA",11,78,108,186
https://kawalpemilu.org#26030,"LEBAK BULUS, CILANDAK, JAKARTA SELATAN, DKI JAKARTA",12,71,158,229
https://kawalpemilu.org#26030,"LEBAK BULUS, CILANDAK, JAKARTA SELATAN, DKI JAKARTA",13,86,62,148
https://kawalpemilu.org#26030,"LEBAK BULUS, CILANDAK, JAKARTA SELATAN, DKI JAKARTA",15,90,139,229
https://kawalpemilu.org#26030,"LEBAK BULUS, CILANDAK, JAKARTA SELATAN, DKI JAKARTA",17,95,110,205
https://kawalpemilu.org#26030,"LEBAK BULUS, CILANDAK, JAKARTA SELATAN, DKI JAKARTA",18,101,123,224
https://kawalpemilu.org#26030,"LEBAK BULUS, CILANDAK, JAKARTA SELATAN, DKI JAKARTA",19,85,107,192
https://kawalpemilu.org#26030,"LEBAK BULUS, CILANDAK, JAKARTA SELATAN, DKI JAKARTA",21,96,89,185
https://kawalpemilu.org#26030,"LEBAK BULUS, CILANDAK, JAKARTA SELATAN, DKI JAKARTA",22,70,57,127
https://kawalpemilu.org#26030,"LEBAK BULUS, CILANDAK, JAKARTA SELATAN, DKI JAKARTA",23,114,98,212
https://kawalpemilu.org#26030,"LEBAK BULUS, CILANDAK, JAKARTA SELATAN, DKI JAKARTA",25,107,113,220
https://kawalpemilu.org#26030,"LEBAK BULUS, CILANDAK, JAKARTA SELATAN, DKI JAKARTA",26,78,86,164
https://kawalpemilu.org#26030,"LEBAK BULUS, CILANDAK, JAKARTA SELATAN, DKI JAKARTA",27,120,81,201
https://kawalpemilu.org#26030,"LEBAK BULUS, CILANDAK, JAKARTA SELATAN, DKI JAKARTA",28,138,129,267
https://kawalpemilu.org#26030,"LEBAK BULUS, CILANDAK, JAKARTA SELATAN, DKI JAKARTA",29,124,136,260
https://kawalpemilu.org#26030,"LEBAK BULUS, CILANDAK, JAKARTA SELATAN, DKI JAKARTA",31,99,143,242
https://kawalpemilu.org#26030,"LEBAK BULUS, CILANDAK, JAKARTA SELATAN, DKI JAKARTA",32,72,154,226
https://kawalpemilu.org#26030,"LEBAK BULUS, CILANDAK, JAKARTA SELATAN, DKI JAKARTA",33,102,111,213
https://kawalpemilu.org#26030,"LEBAK BULUS, CILANDAK, JAKARTA SELATAN, DKI JAKARTA",36,123,119,242
https://kawalpemilu.org#26030,"LEBAK BULUS, CILANDAK, JAKARTA SELATAN, DKI JAKARTA",40,134,125,259
https://kawalpemilu.org#26030,"LEBAK BULUS, CILANDAK, JAKARTA SELATAN, DKI JAKARTA",41,107,75,182
https://kawalpemilu.org#26030,"LEBAK BULUS, CILANDAK, JAKARTA SELATAN, DKI JAKARTA",42,135,99,234
https://kawalpemilu.org#26030,"LEBAK BULUS, CILANDAK, JAKARTA SELATAN, DKI JAKARTA",44,177,43,220
https://kawalpemilu.org#26030,"LEBAK BULUS, CILANDAK, JAKARTA SELATAN, DKI JAKARTA",45,161,60,221
https://kawalpemilu.org#26030,"LEBAK BULUS, CILANDAK, JAKARTA SELATAN, DKI JAKARTA",46,120,63,183
https://kawalpemilu.org#26030,"LEBAK BULUS, CILANDAK, JAKARTA SELATAN, DKI JAKARTA",47,129,78,207
https://kawalpemilu.org#26030,"LEBAK BULUS, CILANDAK, JAKARTA SELATAN, DKI JAKARTA",48,128,100,228
https://kawalpemilu.org#26030,"LEBAK BULUS, CILANDAK, JAKARTA SELATAN, DKI JAKARTA",49,70,77,147
https://kawalpemilu.org#26030,"LEBAK BULUS, CILANDAK, JAKARTA SELATAN, DKI JAKARTA",50,102,141,243
https://kawalpemilu.org#26030,"LEBAK BULUS, CILANDAK, JAKARTA SELATAN, DKI JAKARTA",52,132,102,234
https://kawalpemilu.org#26030,"LEBAK BULUS, CILANDAK, JAKARTA SELATAN, DKI JAKARTA",53,124,136,260
https://kawalpemilu.org#26030,"LEBAK BULUS, CILANDAK, JAKARTA SELATAN, DKI JAKARTA",54,104,109,213
https://kawalpemilu.org#26030,"LEBAK BULUS, CILANDAK, JAKARTA SELATAN, DKI JAKARTA",56,124,76,200
https://kawalpemilu.org#26030,"LEBAK BULUS, CILANDAK, JAKARTA SELATAN, DKI JAKARTA",58,119,94,213
https://kawalpemilu.org#26030,"LEBAK BULUS, CILANDAK, JAKARTA SELATAN, DKI JAKARTA",59,109,132,241
https://kawalpemilu.org#26030,"LEBAK BULUS, CILANDAK, JAKARTA SELATAN, DKI JAKARTA",60,109,141,250
https://kawalpemilu.org#26030,"LEBAK BULUS, CILANDAK, JAKARTA SELATAN, DKI JAKARTA",61,107,143,250
https://kawalpemilu.org#26030,"LEBAK BULUS, CILANDAK, JAKARTA SELATAN, DKI JAKARTA",64,113,145,258
https://kawalpemilu.org#26030,"LEBAK BULUS, CILANDAK, JAKARTA SELATAN, DKI JAKARTA",65,106,140,246
https://kawalpemilu.org#26030,"LEBAK BULUS, CILANDAK, JAKARTA SELATAN, DKI JAKARTA",66,112,159,271
https://kawalpemilu.org#26030,"LEBAK BULUS, CILANDAK, JAKARTA SELATAN, DKI JAKARTA",68,77,79,156
https://kawalpemilu.org#26030,"LEBAK BULUS, CILANDAK, JAKARTA SELATAN, DKI JAKARTA",71,97,121,218
https://kawalpemilu.org#26030,"LEBAK BULUS, CILANDAK, JAKARTA SELATAN, DKI JAKARTA",75,191,55,246
https://kawalpemilu.org#26030,"LEBAK BULUS, CILANDAK, JAKARTA SELATAN, DKI JAKARTA",76,146,79,225
https://kawalpemilu.org#26030,"LEBAK BULUS, CILANDAK, JAKARTA SELATAN, DKI JAKARTA",77,150,68,218
https://kawalpemilu.org#26030,"LEBAK BULUS, CILANDAK, JAKARTA SELATAN, DKI JAKARTA",78,147,68,215
https://kawalpemilu.org#26030,"LEBAK BULUS, CILANDAK, JAKARTA SELATAN, DKI JAKARTA",79,91,48,139
https://kawalpemilu.org#26030,"LEBAK BULUS, CILANDAK, JAKARTA SELATAN, DKI JAKARTA",80,170,59,229
https://kawalpemilu.org#26030,"LEBAK BULUS, CILANDAK, JAKARTA SELATAN, DKI JAKARTA",81,111,99,210
https://kawalpemilu.org#26030,"LEBAK BULUS, CILANDAK, JAKARTA SELATAN, DKI JAKARTA",82,107,51,158
https://kawalpemilu.org#26030,"LEBAK BULUS, CILANDAK, JAKARTA SELATAN, DKI JAKARTA",83,146,93,239
https://kawalpemilu.org#26030,"LEBAK BULUS, CILANDAK, JAKARTA SELATAN, DKI JAKARTA",84,63,73,136
https://kawalpemilu.org#26030,"LEBAK BULUS, CILANDAK, JAKARTA SELATAN, DKI JAKARTA",85,130,42,172
https://kawalpemilu.org#26030,"LEBAK BULUS, CILANDAK, JAKARTA SELATAN, DKI JAKARTA",86,122,28,150
https://kawalpemilu.org#26030,"LEBAK BULUS, CILANDAK, JAKARTA SELATAN, DKI JAKARTA",87,113,28,141
https://kawalpemilu.org#26030,"LEBAK BULUS, CILANDAK, JAKARTA SELATAN, DKI JAKARTA",88,99,31,130
https://kawalpemilu.org#26030,"LEBAK BULUS, CILANDAK, JAKARTA SELATAN, DKI JAKARTA",89,98,48,146
https://kawalpemilu.org#26030,"LEBAK BULUS, CILANDAK, JAKARTA SELATAN, DKI JAKARTA",90,102,42,144
https://kawalpemilu.org#26030,"LEBAK BULUS, CILANDAK, JAKARTA SELATAN, DKI JAKARTA",92,162,49,211
https://kawalpemilu.org#26030,"LEBAK BULUS, CILANDAK, JAKARTA SELATAN, DKI JAKARTA",93,144,51,195
https://kawalpemilu.org#26030,"LEBAK BULUS, CILANDAK, JAKARTA SELATAN, DKI JAKARTA",95,188,36,224
https://kawalpemilu.org#26030,"LEBAK BULUS, CILANDAK, JAKARTA SELATAN, DKI JAKARTA",96,152,55,207
https://kawalpemilu.org#26030,"LEBAK BULUS, CILANDAK, JAKARTA SELATAN, DKI JAKARTA",97,162,49,211
https://kawalpemilu.org#26030,"LEBAK BULUS, CILANDAK, JAKARTA SELATAN, DKI JAKARTA",98,120,84,204
https://kawalpemilu.org#26030,"LEBAK BULUS, CILANDAK, JAKARTA SELATAN, DKI JAKARTA",99,167,84,251
https://kawalpemilu.org#26030,"LEBAK BULUS, CILANDAK, JAKARTA SELATAN, DKI JAKARTA",100,71,150,3
https://kawalpemilu.org#26030,"LEBAK BULUS, CILANDAK, JAKARTA SELATAN, DKI JAKARTA",102,115,88,0
https://kawalpemilu.org#26030,"LEBAK BULUS, CILANDAK, JAKARTA SELATAN, DKI JAKARTA",103,114,88,202
https://kawalpemilu.org#26030,"LEBAK BULUS, CILANDAK, JAKARTA SELATAN, DKI JAKARTA",105,95,118,213
https://kawalpemilu.org#26030,"LEBAK BULUS, CILANDAK, JAKARTA SELATAN, DKI JAKARTA",107,104,128,232
https://kawalpemilu.org#26030,"LEBAK BULUS, CILANDAK, JAKARTA SELATAN, DKI JAKARTA",108,82,56,138
https://kawalpemilu.org#26030,"LEBAK BULUS, CILANDAK, JAKARTA SELATAN, DKI JAKARTA",109,93,52,145
https://kawalpemilu.org#26030,"LEBAK BULUS, CILANDAK, JAKARTA SELATAN, DKI JAKARTA",112,100,78,178
https://kawalpemilu.org#26030,"LEBAK BULUS, CILANDAK, JAKARTA SELATAN, DKI JAKARTA",114,158,83,241
https://kawalpemilu.org#26030,"LEBAK BULUS, CILANDAK, JAKARTA SELATAN, DKI JAKARTA",115,123,74,197
https://kawalpemilu.org#26030,"LEBAK BULUS, CILANDAK, JAKARTA SELATAN, DKI JAKARTA",116,130,130,260
https://kawalpemilu.org#26030,"LEBAK BULUS, CILANDAK, JAKARTA SELATAN, DKI JAKARTA",117,133,105,238
https://kawalpemilu.org#26030,"LEBAK BULUS, CILANDAK, JAKARTA SELATAN, DKI JAKARTA",118,142,79,221
https://kawalpemilu.org#26030,"LEBAK BULUS, CILANDAK, JAKARTA SELATAN, DKI JAKARTA",119,125,75,200
https://kawalpemilu.org#26030,"LEBAK BULUS, CILANDAK, JAKARTA SELATAN, DKI JAKARTA",122,132,120,252
https://kawalpemilu.org#26030,"LEBAK BULUS, CILANDAK, JAKARTA SELATAN, DKI JAKARTA",123,137,129,266
https://kawalpemilu.org#26030,"LEBAK BULUS, CILANDAK, JAKARTA SELATAN, DKI JAKARTA",125,103,148,251
https://kawalpemilu.org#26030,"LEBAK BULUS, CILANDAK, JAKARTA SELATAN, DKI JAKARTA",126,103,99,202
https://kawalpemilu.org#26030,"LEBAK BULUS, CILANDAK, JAKARTA SELATAN, DKI JAKARTA",127,142,85,227
https://kawalpemilu.org#26030,"LEBAK BULUS, CILANDAK, JAKARTA SELATAN, DKI JAKARTA",128,106,45,151
https://kawalpemilu.org#26030,"LEBAK BULUS, CILANDAK, JAKARTA SELATAN, DKI JAKARTA",129,104,20,124
https://kawalpemilu.org#26030,"LEBAK BULUS, CILANDAK, JAKARTA SELATAN, DKI JAKARTA",130,161,69,230
https://kawalpemilu.org#26030,"LEBAK BULUS, CILANDAK, JAKARTA SELATAN, DKI JAKARTA",131,140,50,190
https://kawalpemilu.org#26031,"PONDOK LABU, CILANDAK, JAKARTA SELATAN, DKI JAKARTA",1,182,87,269
https://kawalpemilu.org#26031,"PONDOK LABU, CILANDAK, JAKARTA SELATAN, DKI JAKARTA",2,0,0,0
https://kawalpemilu.org#26031,"PONDOK LABU, CILANDAK, JAKARTA SELATAN, DKI JAKARTA",3,70,90,160
https://kawalpemilu.org#26031,"PONDOK LABU, CILANDAK, JAKARTA SELATAN, DKI JAKARTA",5,127,69,196
https://kawalpemilu.org#26031,"PONDOK LABU, CILANDAK, JAKARTA SELATAN, DKI JAKARTA",6,99,77,176
https://kawalpemilu.org#26031,"PONDOK LABU, CILANDAK, JAKARTA SELATAN, DKI JAKARTA",7,87,105,192
https://kawalpemilu.org#26031,"PONDOK LABU, CILANDAK, JAKARTA SELATAN, DKI JAKARTA",8,94,101,195
https://kawalpemilu.org#26031,"PONDOK LABU, CILANDAK, JAKARTA SELATAN, DKI JAKARTA",9,105,119,224
https://kawalpemilu.org#26031,"PONDOK LABU, CILANDAK, JAKARTA SELATAN, DKI JAKARTA",10,90,93,183
https://kawalpemilu.org#26031,"PONDOK LABU, CILANDAK, JAKARTA SELATAN, DKI JAKARTA",11,111,99,210
https://kawalpemilu.org#26031,"PONDOK LABU, CILANDAK, JAKARTA SELATAN, DKI JAKARTA",12,160,106,266
https://kawalpemilu.org#26031,"PONDOK LABU, CILANDAK, JAKARTA SELATAN, DKI JAKARTA",13,89,113,202
https://kawalpemilu.org#26031,"PONDOK LABU, CILANDAK, JAKARTA SELATAN, DKI JAKARTA",16,133,78,211
https://kawalpemilu.org#26031,"PONDOK LABU, CILANDAK, JAKARTA SELATAN, DKI JAKARTA",17,98,81,179
https://kawalpemilu.org#26031,"PONDOK LABU, CILANDAK, JAKARTA SELATAN, DKI JAKARTA",20,82,62,144
https://kawalpemilu.org#26031,"PONDOK LABU, CILANDAK, JAKARTA SELATAN, DKI JAKARTA",21,126,71,197
https://kawalpemilu.org#26031,"PONDOK LABU, CILANDAK, JAKARTA SELATAN, DKI JAKARTA",23,137,73,210
https://kawalpemilu.org#26031,"PONDOK LABU, CILANDAK, JAKARTA SELATAN, DKI JAKARTA",24,173,72,245
https://kawalpemilu.org#26031,"PONDOK LABU, CILANDAK, JAKARTA SELATAN, DKI JAKARTA",25,163,93,256
https://kawalpemilu.org#26031,"PONDOK LABU, CILANDAK, JAKARTA SELATAN, DKI JAKARTA",27,134,77,211
https://kawalpemilu.org#26031,"PONDOK LABU, CILANDAK, JAKARTA SELATAN, DKI JAKARTA",30,162,82,244
https://kawalpemilu.org#26031,"PONDOK LABU, CILANDAK, JAKARTA SELATAN, DKI JAKARTA",31,96,104,200
https://kawalpemilu.org#26031,"PONDOK LABU, CILANDAK, JAKARTA SELATAN, DKI JAKARTA",35,118,66,184
https://kawalpemilu.org#26031,"PONDOK LABU, CILANDAK, JAKARTA SELATAN, DKI JAKARTA",37,114,74,188
https://kawalpemilu.org#26031,"PONDOK LABU, CILANDAK, JAKARTA SELATAN, DKI JAKARTA",38,72,105,177
https://kawalpemilu.org#26031,"PONDOK LABU, CILANDAK, JAKARTA SELATAN, DKI JAKARTA",39,85,107,192
https://kawalpemilu.org#26031,"PONDOK LABU, CILANDAK, JAKARTA SELATAN, DKI JAKARTA",40,69,118,187
https://kawalpemilu.org#26031,"PONDOK LABU, CILANDAK, JAKARTA SELATAN, DKI JAKARTA",41,142,73,215
https://kawalpemilu.org#26031,"PONDOK LABU, CILANDAK, JAKARTA SELATAN, DKI JAKARTA",42,115,112,227
https://kawalpemilu.org#26031,"PONDOK LABU, CILANDAK, JAKARTA SELATAN, DKI JAKARTA",43,127,100,227
https://kawalpemilu.org#26031,"PONDOK LABU, CILANDAK, JAKARTA SELATAN, DKI JAKARTA",44,128,83,211
https://kawalpemilu.org#26031,"PONDOK LABU, CILANDAK, JAKARTA SELATAN, DKI JAKARTA",45,143,66,209
https://kawalpemilu.org#26031,"PONDOK LABU, CILANDAK, JAKARTA SELATAN, DKI JAKARTA",46,136,103,239
https://kawalpemilu.org#26031,"PONDOK LABU, CILANDAK, JAKARTA SELATAN, DKI JAKARTA",47,145,108,253
https://kawalpemilu.org#26031,"PONDOK LABU, CILANDAK, JAKARTA SELATAN, DKI JAKARTA",48,147,100,247
https://kawalpemilu.org#26031,"PONDOK LABU, CILANDAK, JAKARTA SELATAN, DKI JAKARTA",49,149,54,203
https://kawalpemilu.org#26031,"PONDOK LABU, CILANDAK, JAKARTA SELATAN, DKI JAKARTA",51,117,93,210
https://kawalpemilu.org#26031,"PONDOK LABU, CILANDAK, JAKARTA SELATAN, DKI JAKARTA",53,119,67,186
https://kawalpemilu.org#26031,"PONDOK LABU, CILANDAK, JAKARTA SELATAN, DKI JAKARTA",54,114,94,208
https://kawalpemilu.org#26031,"PONDOK LABU, CILANDAK, JAKARTA SELATAN, DKI JAKARTA",55,107,100,207
https://kawalpemilu.org#26031,"PONDOK LABU, CILANDAK, JAKARTA SELATAN, DKI JAKARTA",56,118,93,211
https://kawalpemilu.org#26031,"PONDOK LABU, CILANDAK, JAKARTA SELATAN, DKI JAKARTA",58,98,130,228
https://kawalpemilu.org#26031,"PONDOK LABU, CILANDAK, JAKARTA SELATAN, DKI JAKARTA",59,143,34,177
https://kawalpemilu.org#26031,"PONDOK LABU, CILANDAK, JAKARTA SELATAN, DKI JAKARTA",61,134,106,240
https://kawalpemilu.org#26031,"PONDOK LABU, CILANDAK, JAKARTA SELATAN, DKI JAKARTA",63,139,110,249
https://kawalpemilu.org#26031,"PONDOK LABU, CILANDAK, JAKARTA SELATAN, DKI JAKARTA",64,147,92,239
https://kawalpemilu.org#26031,"PONDOK LABU, CILANDAK, JAKARTA SELATAN, DKI JAKARTA",65,93,94,187
https://kawalpemilu.org#26031,"PONDOK LABU, CILANDAK, JAKARTA SELATAN, DKI JAKARTA",66,98,119,217
https://kawalpemilu.org#26031,"PONDOK LABU, CILANDAK, JAKARTA SELATAN, DKI JAKARTA",67,85,130,215
https://kawalpemilu.org#26031,"PONDOK LABU, CILANDAK, JAKARTA SELATAN, DKI JAKARTA",69,145,79,224
https://kawalpemilu.org#26031,"PONDOK LABU, CILANDAK, JAKARTA SELATAN, DKI JAKARTA",71,92,66,158
https://kawalpemilu.org#26031,"PONDOK LABU, CILANDAK, JAKARTA SELATAN, DKI JAKARTA",72,101,86,187
https://kawalpemilu.org#26031,"PONDOK LABU, CILANDAK, JAKARTA SELATAN, DKI JAKARTA",74,122,75,197
https://kawalpemilu.org#26031,"PONDOK LABU, CILANDAK, JAKARTA SELATAN, DKI JAKARTA",75,122,65,187
https://kawalpemilu.org#26031,"PONDOK LABU, CILANDAK, JAKARTA SELATAN, DKI JAKARTA",77,98,63,161
https://kawalpemilu.org#26031,"PONDOK LABU, CILANDAK, JAKARTA SELATAN, DKI JAKARTA",78,105,81,186
https://kawalpemilu.org#26031,"PONDOK LABU, CILANDAK, JAKARTA SELATAN, DKI JAKARTA",79,101,75,176
https://kawalpemilu.org#26031,"PONDOK LABU, CILANDAK, JAKARTA SELATAN, DKI JAKARTA",80,136,104,240
https://kawalpemilu.org#26031,"PONDOK LABU, CILANDAK, JAKARTA SELATAN, DKI JAKARTA",81,145,71,216
https://kawalpemilu.org#26031,"PONDOK LABU, CILANDAK, JAKARTA SELATAN, DKI JAKARTA",82,66,80,146
https://kawalpemilu.org#26031,"PONDOK LABU, CILANDAK, JAKARTA SELATAN, DKI JAKARTA",83,129,53,182
https://kawalpemilu.org#26031,"PONDOK LABU, CILANDAK, JAKARTA SELATAN, DKI JAKARTA",84,59,111,170
https://kawalpemilu.org#26031,"PONDOK LABU, CILANDAK, JAKARTA SELATAN, DKI JAKARTA",85,75,76,151
https://kawalpemilu.org#26031,"PONDOK LABU, CILANDAK, JAKARTA SELATAN, DKI JAKARTA",87,98,122,220
https://kawalpemilu.org#26031,"PONDOK LABU, CILANDAK, JAKARTA SELATAN, DKI JAKARTA",88,77,111,188
https://kawalpemilu.org#26031,"PONDOK LABU, CILANDAK, JAKARTA SELATAN, DKI JAKARTA",89,67,75,142
https://kawalpemilu.org#26031,"PONDOK LABU, CILANDAK, JAKARTA SELATAN, DKI JAKARTA",91,74,53,127
https://kawalpemilu.org#26031,"PONDOK LABU, CILANDAK, JAKARTA SELATAN, DKI JAKARTA",92,63,58,121
https://kawalpemilu.org#26031,"PONDOK LABU, CILANDAK, JAKARTA SELATAN, DKI JAKARTA",93,125,53,178
https://kawalpemilu.org#26031,"PONDOK LABU, CILANDAK, JAKARTA SELATAN, DKI JAKARTA",94,113,68,181
https://kawalpemilu.org#26031,"PONDOK LABU, CILANDAK, JAKARTA SELATAN, DKI JAKARTA",95,154,75,229
https://kawalpemilu.org#26031,"PONDOK LABU, CILANDAK, JAKARTA SELATAN, DKI JAKARTA",96,180,80,260
https://kawalpemilu.org#26031,"PONDOK LABU, CILANDAK, JAKARTA SELATAN, DKI JAKARTA",97,143,86,229
https://kawalpemilu.org#26031,"PONDOK LABU, CILANDAK, JAKARTA SELATAN, DKI JAKARTA",98,150,53,203
https://kawalpemilu.org#26031,"PONDOK LABU, CILANDAK, JAKARTA SELATAN, DKI JAKARTA",99,149,54,203
https://kawalpemilu.org#26031,"PONDOK LABU, CILANDAK, JAKARTA SELATAN, DKI JAKARTA",101,147,76,223
https://kawalpemilu.org#26031,"PONDOK LABU, CILANDAK, JAKARTA SELATAN, DKI JAKARTA",102,143,78,221
https://kawalpemilu.org#26031,"PONDOK LABU, CILANDAK, JAKARTA SELATAN, DKI JAKARTA",103,119,97,216
https://kawalpemilu.org#26031,"PONDOK LABU, CILANDAK, JAKARTA SELATAN, DKI JAKARTA",105,133,90,223
https://kawalpemilu.org#26031,"PONDOK LABU, CILANDAK, JAKARTA SELATAN, DKI JAKARTA",106,141,109,250
https://kawalpemilu.org#26031,"PONDOK LABU, CILANDAK, JAKARTA SELATAN, DKI JAKARTA",107,138,70,208
https://kawalpemilu.org#26031,"PONDOK LABU, CILANDAK, JAKARTA SELATAN, DKI JAKARTA",108,109,118,227
https://kawalpemilu.org#26031,"PONDOK LABU, CILANDAK, JAKARTA SELATAN, DKI JAKARTA",110,75,105,180
https://kawalpemilu.org#26031,"PONDOK LABU, CILANDAK, JAKARTA SELATAN, DKI JAKARTA",111,137,99,236
https://kawalpemilu.org#26031,"PONDOK LABU, CILANDAK, JAKARTA SELATAN, DKI JAKARTA",112,135,111,246
https://kawalpemilu.org#26031,"PONDOK LABU, CILANDAK, JAKARTA SELATAN, DKI JAKARTA",114,112,134,246
https://kawalpemilu.org#26031,"PONDOK LABU, CILANDAK, JAKARTA SELATAN, DKI JAKARTA",116,115,149,264
https://kawalpemilu.org#26031,"PONDOK LABU, CILANDAK, JAKARTA SELATAN, DKI JAKARTA",117,112,105,217
https://kawalpemilu.org#26031,"PONDOK LABU, CILANDAK, JAKARTA SELATAN, DKI JAKARTA",119,148,42,190
https://kawalpemilu.org#26031,"PONDOK LABU, CILANDAK, JAKARTA SELATAN, DKI JAKARTA",121,143,47,190
https://kawalpemilu.org#26031,"PONDOK LABU, CILANDAK, JAKARTA SELATAN, DKI JAKARTA",122,154,30,184
https://kawalpemilu.org#26031,"PONDOK LABU, CILANDAK, JAKARTA SELATAN, DKI JAKARTA",123,152,60,212
https://kawalpemilu.org#26031,"PONDOK LABU, CILANDAK, JAKARTA SELATAN, DKI JAKARTA",125,142,86,228
https://kawalpemilu.org#26031,"PONDOK LABU, CILANDAK, JAKARTA SELATAN, DKI JAKARTA",126,92,78,170
https://kawalpemilu.org#26031,"PONDOK LABU, CILANDAK, JAKARTA SELATAN, DKI JAKARTA",127,138,80,218
https://kawalpemilu.org#26031,"PONDOK LABU, CILANDAK, JAKARTA SELATAN, DKI JAKARTA",128,91,100,191
https://kawalpemilu.org#26031,"PONDOK LABU, CILANDAK, JAKARTA SELATAN, DKI JAKARTA",129,119,70,189
https://kawalpemilu.org#26031,"PONDOK LABU, CILANDAK, JAKARTA SELATAN, DKI JAKARTA",130,112,120,232
https://kawalpemilu.org#26031,"PONDOK LABU, CILANDAK, JAKARTA SELATAN, DKI JAKARTA",131,73,125,198
https://kawalpemilu.org#26031,"PONDOK LABU, CILANDAK, JAKARTA SELATAN, DKI JAKARTA",133,114,78,192
https://kawalpemilu.org#26031,"PONDOK LABU, CILANDAK, JAKARTA SELATAN, DKI JAKARTA",134,94,102,196
https://kawalpemilu.org#26031,"PONDOK LABU, CILANDAK, JAKARTA SELATAN, DKI JAKARTA",135,108,81,189
https://kawalpemilu.org#26031,"PONDOK LABU, CILANDAK, JAKARTA SELATAN, DKI JAKARTA",136,139,110,249
https://kawalpemilu.org#26031,"PONDOK LABU, CILANDAK, JAKARTA SELATAN, DKI JAKARTA",137,127,116,243
https://kawalpemilu.org#26031,"PONDOK LABU, CILANDAK, JAKARTA SELATAN, DKI JAKARTA",138,148,118,266
https://kawalpemilu.org#26031,"PONDOK LABU, CILANDAK, JAKARTA SELATAN, DKI JAKARTA",139,138,134,272
https://kawalpemilu.org#26031,"PONDOK LABU, CILANDAK, JAKARTA SELATAN, DKI JAKARTA",141,95,85,180
https://kawalpemilu.org#26031,"PONDOK LABU, CILANDAK, JAKARTA SELATAN, DKI JAKARTA",142,170,73,243
https://kawalpemilu.org#26031,"PONDOK LABU, CILANDAK, JAKARTA SELATAN, DKI JAKARTA",143,160,83,243
https://kawalpemilu.org#26031,"PONDOK LABU, CILANDAK, JAKARTA SELATAN, DKI JAKARTA",144,186,75,261
https://kawalpemilu.org#26031,"PONDOK LABU, CILANDAK, JAKARTA SELATAN, DKI JAKARTA",147,92,87,189
https://kawalpemilu.org#26031,"PONDOK LABU, CILANDAK, JAKARTA SELATAN, DKI JAKARTA",148,59,108,167
https://kawalpemilu.org#26031,"PONDOK LABU, CILANDAK, JAKARTA SELATAN, DKI JAKARTA",149,57,94,152
https://kawalpemilu.org#26031,"PONDOK LABU, CILANDAK, JAKARTA SELATAN, DKI JAKARTA",152,107,123,230
https://kawalpemilu.org#26031,"PONDOK LABU, CILANDAK, JAKARTA SELATAN, DKI JAKARTA",153,101,119,220
https://kawalpemilu.org#26031,"PONDOK LABU, CILANDAK, JAKARTA SELATAN, DKI JAKARTA",154,83,138,221
https://kawalpemilu.org#26031,"PONDOK LABU, CILANDAK, JAKARTA SELATAN, DKI JAKARTA",155,103,118,221
https://kawalpemilu.org#26031,"PONDOK LABU, CILANDAK, JAKARTA SELATAN, DKI JAKARTA",156,113,128,241
https://kawalpemilu.org#26031,"PONDOK LABU, CILANDAK, JAKARTA SELATAN, DKI JAKARTA",157,91,149,240
https://kawalpemilu.org#26031,"PONDOK LABU, CILANDAK, JAKARTA SELATAN, DKI JAKARTA",158,129,40,169
https://kawalpemilu.org#26031,"PONDOK LABU, CILANDAK, JAKARTA SELATAN, DKI JAKARTA",159,63,81,144
https://kawalpemilu.org#26032,"GANDARIA SELATAN, CILANDAK, JAKARTA SELATAN, DKI JAKARTA",1,88,157,245
https://kawalpemilu.org#26032,"GANDARIA SELATAN, CILANDAK, JAKARTA SELATAN, DKI JAKARTA",2,90,96,186
https://kawalpemilu.org#26032,"GANDARIA SELATAN, CILANDAK, JAKARTA SELATAN, DKI JAKARTA",3,113,80,193
https://kawalpemilu.org#26032,"GANDARIA SELATAN, CILANDAK, JAKARTA SELATAN, DKI JAKARTA",4,141,90,231
https://kawalpemilu.org#26032,"GANDARIA SELATAN, CILANDAK, JAKARTA SELATAN, DKI JAKARTA",6,146,95,241
https://kawalpemilu.org#26032,"GANDARIA SELATAN, CILANDAK, JAKARTA SELATAN, DKI JAKARTA",7,139,94,233
https://kawalpemilu.org#26032,"GANDARIA SELATAN, CILANDAK, JAKARTA SELATAN, DKI JAKARTA",8,118,121,239
https://kawalpemilu.org#26032,"GANDARIA SELATAN, CILANDAK, JAKARTA SELATAN, DKI JAKARTA",9,114,71,185
https://kawalpemilu.org#26032,"GANDARIA SELATAN, CILANDAK, JAKARTA SELATAN, DKI JAKARTA",10,132,97,229
https://kawalpemilu.org#26032,"GANDARIA SELATAN, CILANDAK, JAKARTA SELATAN, DKI JAKARTA",12,80,74,154
https://kawalpemilu.org#26032,"GANDARIA SELATAN, CILANDAK, JAKARTA SELATAN, DKI JAKARTA",13,70,87,157
https://kawalpemilu.org#26032,"GANDARIA SELATAN, CILANDAK, JAKARTA SELATAN, DKI JAKARTA",14,98,75,173
https://kawalpemilu.org#26032,"GANDARIA SELATAN, CILANDAK, JAKARTA SELATAN, DKI JAKARTA",15,127,95,223
https://kawalpemilu.org#26032,"GANDARIA SELATAN, CILANDAK, JAKARTA SELATAN, DKI JAKARTA",16,125,93,218
https://kawalpemilu.org#26032,"GANDARIA SELATAN, CILANDAK, JAKARTA SELATAN, DKI JAKARTA",17,129,78,207
https://kawalpemilu.org#26032,"GANDARIA SELATAN, CILANDAK, JAKARTA SELATAN, DKI JAKARTA",18,84,88,172
https://kawalpemilu.org#26032,"GANDARIA SELATAN, CILANDAK, JAKARTA SELATAN, DKI JAKARTA",19,0,0,171
https://kawalpemilu.org#26032,"GANDARIA SELATAN, CILANDAK, JAKARTA SELATAN, DKI JAKARTA",20,116,110,226
https://kawalpemilu.org#26032,"GANDARIA SELATAN, CILANDAK, JAKARTA SELATAN, DKI JAKARTA",21,112,109,221
https://kawalpemilu.org#26032,"GANDARIA SELATAN, CILANDAK, JAKARTA SELATAN, DKI JAKARTA",22,99,140,239
https://kawalpemilu.org#26032,"GANDARIA SELATAN, CILANDAK, JAKARTA SELATAN, DKI JAKARTA",23,102,71,173
https://kawalpemilu.org#26032,"GANDARIA SELATAN, CILANDAK, JAKARTA SELATAN, DKI JAKARTA",25,113,79,192
https://kawalpemilu.org#26032,"GANDARIA SELATAN, CILANDAK, JAKARTA SELATAN, DKI JAKARTA",26,0,0,0
https://kawalpemilu.org#26032,"GANDARIA SELATAN, CILANDAK, JAKARTA SELATAN, DKI JAKARTA",27,58,132,190
https://kawalpemilu.org#26032,"GANDARIA SELATAN, CILANDAK, JAKARTA SELATAN, DKI JAKARTA",29,66,79,145
https://kawalpemilu.org#26032,"GANDARIA SELATAN, CILANDAK, JAKARTA SELATAN, DKI JAKARTA",30,147,83,230
https://kawalpemilu.org#26032,"GANDARIA SELATAN, CILANDAK, JAKARTA SELATAN, DKI JAKARTA",31,149,95,244
https://kawalpemilu.org#26032,"GANDARIA SELATAN, CILANDAK, JAKARTA SELATAN, DKI JAKARTA",32,95,99,194
https://kawalpemilu.org#26032,"GANDARIA SELATAN, CILANDAK, JAKARTA SELATAN, DKI JAKARTA",33,89,65,154
https://kawalpemilu.org#26032,"GANDARIA SELATAN, CILANDAK, JAKARTA SELATAN, DKI JAKARTA",35,134,53,187
https://kawalpemilu.org#26032,"GANDARIA SELATAN, CILANDAK, JAKARTA SELATAN, DKI JAKARTA",36,84,105,189
https://kawalpemilu.org#26032,"GANDARIA SELATAN, CILANDAK, JAKARTA SELATAN, DKI JAKARTA",37,131,84,215
https://kawalpemilu.org#26032,"GANDARIA SELATAN, CILANDAK, JAKARTA SELATAN, DKI JAKARTA",39,124,111,235
https://kawalpemilu.org#26032,"GANDARIA SELATAN, CILANDAK, JAKARTA SELATAN, DKI JAKARTA",40,121,106,227
https://kawalpemilu.org#26032,"GANDARIA SELATAN, CILANDAK, JAKARTA SELATAN, DKI JAKARTA",41,125,103,228
https://kawalpemilu.org#26032,"GANDARIA SELATAN, CILANDAK, JAKARTA SELATAN, DKI JAKARTA",42,110,79,189
https://kawalpemilu.org#26032,"GANDARIA SELATAN, CILANDAK, JAKARTA SELATAN, DKI JAKARTA",44,89,84,173
https://kawalpemilu.org#26032,"GANDARIA SELATAN, CILANDAK, JAKARTA SELATAN, DKI JAKARTA",45,74,109,183
https://kawalpemilu.org#26032,"GANDARIA SELATAN, CILANDAK, JAKARTA SELATAN, DKI JAKARTA",46,104,112,216
https://kawalpemilu.org#26032,"GANDARIA SELATAN, CILANDAK, JAKARTA SELATAN, DKI JAKARTA",47,149,65,214
https://kawalpemilu.org#26032,"GANDARIA SELATAN, CILANDAK, JAKARTA SELATAN, DKI JAKARTA",48,101,106,207
https://kawalpemilu.org#26032,"GANDARIA SELATAN, CILANDAK, JAKARTA SELATAN, DKI JAKARTA",49,134,118,252
https://kawalpemilu.org#26032,"GANDARIA SELATAN, CILANDAK, JAKARTA SELATAN, DKI JAKARTA",50,131,88,219
https://kawalpemilu.org#26032,"GANDARIA SELATAN, CILANDAK, JAKARTA SELATAN, DKI JAKARTA",51,160,90,250
https://kawalpemilu.org#26032,"GANDARIA SELATAN, CILANDAK, JAKARTA SELATAN, DKI JAKARTA",52,108,98,206
https://kawalpemilu.org#26032,"GANDARIA SELATAN, CILANDAK, JAKARTA SELATAN, DKI JAKARTA",53,94,141,235
https://kawalpemilu.org#26032,"GANDARIA SELATAN, CILANDAK, JAKARTA SELATAN, DKI JAKARTA",54,112,103,215
https://kawalpemilu.org#26032,"GANDARIA SELATAN, CILANDAK, JAKARTA SELATAN, DKI JAKARTA",55,111,94,205
https://kawalpemilu.org#26032,"GANDARIA SELATAN, CILANDAK, JAKARTA SELATAN, DKI JAKARTA",56,141,118,259
https://kawalpemilu.org#26032,"GANDARIA SELATAN, CILANDAK, JAKARTA SELATAN, DKI JAKARTA",57,107,119,226
https://kawalpemilu.org#26032,"GANDARIA SELATAN, CILANDAK, JAKARTA SELATAN, DKI JAKARTA",58,127,61,188
https://kawalpemilu.org#26032,"GANDARIA SELATAN, CILANDAK, JAKARTA SELATAN, DKI JAKARTA",59,124,115,239
https://kawalpemilu.org#26032,"GANDARIA SELATAN, CILANDAK, JAKARTA SELATAN, DKI JAKARTA",60,110,125,235
https://kawalpemilu.org#26032,"GANDARIA SELATAN, CILANDAK, JAKARTA SELATAN, DKI JAKARTA",61,144,82,226
https://kawalpemilu.org#26032,"GANDARIA SELATAN, CILANDAK, JAKARTA SELATAN, DKI JAKARTA",62,118,132,250
https://kawalpemilu.org#26032,"GANDARIA SELATAN, CILANDAK, JAKARTA SELATAN, DKI JAKARTA",63,137,119,256
https://kawalpemilu.org#26032,"GANDARIA SELATAN, CILANDAK, JAKARTA SELATAN, DKI JAKARTA",65,120,148,268
https://kawalpemilu.org#26032,"GANDARIA SELATAN, CILANDAK, JAKARTA SELATAN, DKI JAKARTA",66,96,122,218
https://kawalpemilu.org#26032,"GANDARIA SELATAN, CILANDAK, JAKARTA SELATAN, DKI JAKARTA",67,120,103,223
https://kawalpemilu.org#26032,"GANDARIA SELATAN, CILANDAK, JAKARTA SELATAN, DKI JAKARTA",68,124,136,260
https://kawalpemilu.org#26032,"GANDARIA SELATAN, CILANDAK, JAKARTA SELATAN, DKI JAKARTA",70,132,96,228
https://kawalpemilu.org#26032,"GANDARIA SELATAN, CILANDAK, JAKARTA SELATAN, DKI JAKARTA",71,144,60,204
https://kawalpemilu.org#26032,"GANDARIA SELATAN, CILANDAK, JAKARTA SELATAN, DKI JAKARTA",72,192,61,253
https://kawalpemilu.org#26032,"GANDARIA SELATAN, CILANDAK, JAKARTA SELATAN, DKI JAKARTA",73,109,141,250
https://kawalpemilu.org#26032,"GANDARIA SELATAN, CILANDAK, JAKARTA SELATAN, DKI JAKARTA",74,63,122,185
https://kawalpemilu.org#26032,"GANDARIA SELATAN, CILANDAK, JAKARTA SELATAN, DKI JAKARTA",75,84,93,177
https://kawalpemilu.org#26032,"GANDARIA SELATAN, CILANDAK, JAKARTA SELATAN, DKI JAKARTA",76,171,40,211
https://kawalpemilu.org#26032,"GANDARIA SELATAN, CILANDAK, JAKARTA SELATAN, DKI JAKARTA",77,184,29,213
https://kawalpemilu.org#26033,"CIPETE SELATAN, CILANDAK, JAKARTA SELATAN, DKI JAKARTA",1,161,51,212
https://kawalpemilu.org#26033,"CIPETE SELATAN, CILANDAK, JAKARTA SELATAN, DKI JAKARTA",2,123,77,200
https://kawalpemilu.org#26033,"CIPETE SELATAN, CILANDAK, JAKARTA SELATAN, DKI JAKARTA",3,89,124,213
https://kawalpemilu.org#26033,"CIPETE SELATAN, CILANDAK, JAKARTA SELATAN, DKI JAKARTA",4,115,120,235
https://kawalpemilu.org#26033,"CIPETE SELATAN, CILANDAK, JAKARTA SELATAN, DKI JAKARTA",5,145,84,229
https://kawalpemilu.org#26033,"CIPETE SELATAN, CILANDAK, JAKARTA SELATAN, DKI JAKARTA",6,90,121,211
https://kawalpemilu.org#26033,"CIPETE SELATAN, CILANDAK, JAKARTA SELATAN, DKI JAKARTA",7,99,88,187
https://kawalpemilu.org#26033,"CIPETE SELATAN, CILANDAK, JAKARTA SELATAN, DKI JAKARTA",8,76,133,209
https://kawalpemilu.org#26033,"CIPETE SELATAN, CILANDAK, JAKARTA SELATAN, DKI JAKARTA",9,107,112,219
https://kawalpemilu.org#26033,"CIPETE SELATAN, CILANDAK, JAKARTA SELATAN, DKI JAKARTA",10,96,101,197
https://kawalpemilu.org#26033,"CIPETE SELATAN, CILANDAK, JAKARTA SELATAN, DKI JAKARTA",11,127,64,177
https://kawalpemilu.org#26033,"CIPETE SELATAN, CILANDAK, JAKARTA SELATAN, DKI JAKARTA",12,99,67,166
https://kawalpemilu.org#26033,"CIPETE SELATAN, CILANDAK, JAKARTA SELATAN, DKI JAKARTA",13,140,87,227
https://kawalpemilu.org#26033,"CIPETE SELATAN, CILANDAK, JAKARTA SELATAN, DKI JAKARTA",14,110,139,249
https://kawalpemilu.org#26033,"CIPETE SELATAN, CILANDAK, JAKARTA SELATAN, DKI JAKARTA",16,95,151,246
https://kawalpemilu.org#26033,"CIPETE SELATAN, CILANDAK, JAKARTA SELATAN, DKI JAKARTA",17,77,133,210
https://kawalpemilu.org#26033,"CIPETE SELATAN, CILANDAK, JAKARTA SELATAN, DKI JAKARTA",19,110,111,221
https://kawalpemilu.org#26033,"CIPETE SELATAN, CILANDAK, JAKARTA SELATAN, DKI JAKARTA",20,96,116,212
https://kawalpemilu.org#26033,"CIPETE SELATAN, CILANDAK, JAKARTA SELATAN, DKI JAKARTA",21,74,152,226
https://kawalpemilu.org#26033,"CIPETE SELATAN, CILANDAK, JAKARTA SELATAN, DKI JAKARTA",22,105,97,202
https://kawalpemilu.org#26033,"CIPETE SELATAN, CILANDAK, JAKARTA SELATAN, DKI JAKARTA",23,74,64,138
https://kawalpemilu.org#26033,"CIPETE SELATAN, CILANDAK, JAKARTA SELATAN, DKI JAKARTA",24,130,116,246
https://kawalpemilu.org#26033,"CIPETE SELATAN, CILANDAK, JAKARTA SELATAN, DKI JAKARTA",25,166,60,226
https://kawalpemilu.org#26033,"CIPETE SELATAN, CILANDAK, JAKARTA SELATAN, DKI JAKARTA",26,57,87,144
https://kawalpemilu.org#26033,"CIPETE SELATAN, CILANDAK, JAKARTA SELATAN, DKI JAKARTA",27,111,85,196
https://kawalpemilu.org#26033,"CIPETE SELATAN, CILANDAK, JAKARTA SELATAN, DKI JAKARTA",28,113,97,210
https://kawalpemilu.org#26033,"CIPETE SELATAN, CILANDAK, JAKARTA SELATAN, DKI JAKARTA",29,99,92,191
https://kawalpemilu.org#26033,"CIPETE SELATAN, CILANDAK, JAKARTA SELATAN, DKI JAKARTA",30,102,110,212
https://kawalpemilu.org#26033,"CIPETE SELATAN, CILANDAK, JAKARTA SELATAN, DKI JAKARTA",31,122,121,243
https://kawalpemilu.org#26033,"CIPETE SELATAN, CILANDAK, JAKARTA SELATAN, DKI JAKARTA",32,163,77,240
https://kawalpemilu.org#26033,"CIPETE SELATAN, CILANDAK, JAKARTA SELATAN, DKI JAKARTA",33,137,70,207
https://kawalpemilu.org#26033,"CIPETE SELATAN, CILANDAK, JAKARTA SELATAN, DKI JAKARTA",34,129,63,192
https://kawalpemilu.org#26033,"CIPETE SELATAN, CILANDAK, JAKARTA SELATAN, DKI JAKARTA",36,92,98,190
https://kawalpemilu.org#26033,"CIPETE SELATAN, CILANDAK, JAKARTA SELATAN, DKI JAKARTA",37,104,74,178
https://kawalpemilu.org#26033,"CIPETE SELATAN, CILANDAK, JAKARTA SELATAN, DKI JAKARTA",38,90,71,161
https://kawalpemilu.org#26033,"CIPETE SELATAN, CILANDAK, JAKARTA SELATAN, DKI JAKARTA",39,122,63,185
https://kawalpemilu.org#26033,"CIPETE SELATAN, CILANDAK, JAKARTA SELATAN, DKI JAKARTA",41,81,59,140
https://kawalpemilu.org#26033,"CIPETE SELATAN, CILANDAK, JAKARTA SELATAN, DKI JAKARTA",42,109,96,205
https://kawalpemilu.org#26033,"CIPETE SELATAN, CILANDAK, JAKARTA SELATAN, DKI JAKARTA",43,105,116,221
https://kawalpemilu.org#26033,"CIPETE SELATAN, CILANDAK, JAKARTA SELATAN, DKI JAKARTA",44,110,117,227
https://kawalpemilu.org#26033,"CIPETE SELATAN, CILANDAK, JAKARTA SELATAN, DKI JAKARTA",45,113,120,233
https://kawalpemilu.org#26033,"CIPETE SELATAN, CILANDAK, JAKARTA SELATAN, DKI JAKARTA",47,127,107,234
https://kawalpemilu.org#26033,"CIPETE SELATAN, CILANDAK, JAKARTA SELATAN, DKI JAKARTA",48,104,65,169
https://kawalpemilu.org#26033,"CIPETE SELATAN, CILANDAK, JAKARTA SELATAN, DKI JAKARTA",49,103,115,218
https://kawalpemilu.org#26033,"CIPETE SELATAN, CILANDAK, JAKARTA SELATAN, DKI JAKARTA",51,87,87,174
https://kawalpemilu.org#26033,"CIPETE SELATAN, CILANDAK, JAKARTA SELATAN, DKI JAKARTA",52,108,75,183
https://kawalpemilu.org#26033,"CIPETE SELATAN, CILANDAK, JAKARTA SELATAN, DKI JAKARTA",53,97,70,167
https://kawalpemilu.org#26033,"CIPETE SELATAN, CILANDAK, JAKARTA SELATAN, DKI JAKARTA",54,71,90,161
https://kawalpemilu.org#26033,"CIPETE SELATAN, CILANDAK, JAKARTA SELATAN, DKI JAKARTA",56,70,113,183
https://kawalpemilu.org#26033,"CIPETE SELATAN, CILANDAK, JAKARTA SELATAN, DKI JAKARTA",57,95,60,155
https://kawalpemilu.org#26033,"CIPETE SELATAN, CILANDAK, JAKARTA SELATAN, DKI JAKARTA",58,112,71,183
https://kawalpemilu.org#26033,"CIPETE SELATAN, CILANDAK, JAKARTA SELATAN, DKI JAKARTA",59,105,67,172
https://kawalpemilu.org#26033,"CIPETE SELATAN, CILANDAK, JAKARTA SELATAN, DKI JAKARTA",60,110,59,169
https://kawalpemilu.org#26033,"CIPETE SELATAN, CILANDAK, JAKARTA SELATAN, DKI JAKARTA",61,144,82,226
https://kawalpemilu.org#26033,"CIPETE SELATAN, CILANDAK, JAKARTA SELATAN, DKI JAKARTA",62,137,99,236
https://kawalpemilu.org#26033,"CIPETE SELATAN, CILANDAK, JAKARTA SELATAN, DKI JAKARTA",63,118,84,202
https://kawalpemilu.org#26033,"CIPETE SELATAN, CILANDAK, JAKARTA SELATAN, DKI JAKARTA",64,93,69,162
https://kawalpemilu.org#26033,"CIPETE SELATAN, CILANDAK, JAKARTA SELATAN, DKI JAKARTA",65,95,68,163
https://kawalpemilu.org#26033,"CIPETE SELATAN, CILANDAK, JAKARTA SELATAN, DKI JAKARTA",66,113,105,218
https://kawalpemilu.org#26033,"CIPETE SELATAN, CILANDAK, JAKARTA SELATAN, DKI JAKARTA",67,131,85,216
https://kawalpemilu.org#26033,"CIPETE SELATAN, CILANDAK, JAKARTA SELATAN, DKI JAKARTA",68,102,125,227
https://kawalpemilu.org#26033,"CIPETE SELATAN, CILANDAK, JAKARTA SELATAN, DKI JAKARTA",69,121,118,239
https://kawalpemilu.org#26033,"CIPETE SELATAN, CILANDAK, JAKARTA SELATAN, DKI JAKARTA",70,94,129,223
https://kawalpemilu.org#26033,"CIPETE SELATAN, CILANDAK, JAKARTA SELATAN, DKI JAKARTA",71,70,105,175
https://kawalpemilu.org#26033,"CIPETE SELATAN, CILANDAK, JAKARTA SELATAN, DKI JAKARTA",72,103,94,197
https://kawalpemilu.org#26033,"CIPETE SELATAN, CILANDAK, JAKARTA SELATAN, DKI JAKARTA",73,94,90,184
https://kawalpemilu.org#26033,"CIPETE SELATAN, CILANDAK, JAKARTA SELATAN, DKI JAKARTA",75,96,74,170
https://kawalpemilu.org#26033,"CIPETE SELATAN, CILANDAK, JAKARTA SELATAN, DKI JAKARTA",76,84,74,158
https://kawalpemilu.org#26033,"CIPETE SELATAN, CILANDAK, JAKARTA SELATAN, DKI JAKARTA",79,93,116,209
https://kawalpemilu.org#26033,"CIPETE SELATAN, CILANDAK, JAKARTA SELATAN, DKI JAKARTA",80,0,0,0
https://kawalpemilu.org#26033,"CIPETE SELATAN, CILANDAK, JAKARTA SELATAN, DKI JAKARTA",82,87,119,206
https://kawalpemilu.org#26033,"CIPETE SELATAN, CILANDAK, JAKARTA SELATAN, DKI JAKARTA",83,121,84,205
https://kawalpemilu.org#26033,"CIPETE SELATAN, CILANDAK, JAKARTA SELATAN, DKI JAKARTA",84,89,82,171
https://kawalpemilu.org#26033,"CIPETE SELATAN, CILANDAK, JAKARTA SELATAN, DKI JAKARTA",85,131,92,223
https://kawalpemilu.org#26033,"CIPETE SELATAN, CILANDAK, JAKARTA SELATAN, DKI JAKARTA",86,78,112,190
https://kawalpemilu.org#26033,"CIPETE SELATAN, CILANDAK, JAKARTA SELATAN, DKI JAKARTA",87,166,104,270
https://kawalpemilu.org#26033,"CIPETE SELATAN, CILANDAK, JAKARTA SELATAN, DKI JAKARTA",88,128,89,217
https://kawalpemilu.org#26033,"CIPETE SELATAN, CILANDAK, JAKARTA SELATAN, DKI JAKARTA",89,108,133,241
https://kawalpemilu.org#26033,"CIPETE SELATAN, CILANDAK, JAKARTA SELATAN, DKI JAKARTA",90,104,80,184
https://kawalpemilu.org#26033,"CIPETE SELATAN, CILANDAK, JAKARTA SELATAN, DKI JAKARTA",92,95,95,190
https://kawalpemilu.org#26033,"CIPETE SELATAN, CILANDAK, JAKARTA SELATAN, DKI JAKARTA",93,130,122,252
https://kawalpemilu.org#26033,"CIPETE SELATAN, CILANDAK, JAKARTA SELATAN, DKI JAKARTA",94,74,121,195
https://kawalpemilu.org#26033,"CIPETE SELATAN, CILANDAK, JAKARTA SELATAN, DKI JAKARTA",95,73,72,145
https://kawalpemilu.org#26033,"CIPETE SELATAN, CILANDAK, JAKARTA SELATAN, DKI JAKARTA",96,82,148,230
https://kawalpemilu.org#26033,"CIPETE SELATAN, CILANDAK, JAKARTA SELATAN, DKI JAKARTA",98,74,113,187
https://kawalpemilu.org#26033,"CIPETE SELATAN, CILANDAK, JAKARTA SELATAN, DKI JAKARTA",99,74,134,208
https://kawalpemilu.org#26033,"CIPETE SELATAN, CILANDAK, JAKARTA SELATAN, DKI JAKARTA",100,76,118,194
https://kawalpemilu.org#26035,"MELAWAI, KEBAYORAN BARU, JAKARTA SELATAN, DKI JAKARTA",1,101,45,146
https://kawalpemilu.org#26035,"MELAWAI, KEBAYORAN BARU, JAKARTA SELATAN, DKI JAKARTA",2,148,51,199
https://kawalpemilu.org#26035,"MELAWAI, KEBAYORAN BARU, JAKARTA SELATAN, DKI JAKARTA",3,92,78,170
https://kawalpemilu.org#26035,"MELAWAI, KEBAYORAN BARU, JAKARTA SELATAN, DKI JAKARTA",4,137,43,180
https://kawalpemilu.org#26035,"MELAWAI, KEBAYORAN BARU, JAKARTA SELATAN, DKI JAKARTA",5,144,40,184
https://kawalpemilu.org#26035,"MELAWAI, KEBAYORAN BARU, JAKARTA SELATAN, DKI JAKARTA",6,105,44,149
https://kawalpemilu.org#26035,"MELAWAI, KEBAYORAN BARU, JAKARTA SELATAN, DKI JAKARTA",7,115,40,155
https://kawalpemilu.org#26035,"MELAWAI, KEBAYORAN BARU, JAKARTA SELATAN, DKI JAKARTA",8,183,39,222
https://kawalpemilu.org#26035,"MELAWAI, KEBAYORAN BARU, JAKARTA SELATAN, DKI JAKARTA",9,138,47,185
https://kawalpemilu.org#26035,"MELAWAI, KEBAYORAN BARU, JAKARTA SELATAN, DKI JAKARTA",10,87,44,131
https://kawalpemilu.org#26035,"MELAWAI, KEBAYORAN BARU, JAKARTA SELATAN, DKI JAKARTA",11,124,48,172
https://kawalpemilu.org#26035,"MELAWAI, KEBAYORAN BARU, JAKARTA SELATAN, DKI JAKARTA",12,137,49,186
https://kawalpemilu.org#26036,"GUNUNG, KEBAYORAN BARU, JAKARTA SELATAN, DKI JAKARTA",1,206,15,221
https://kawalpemilu.org#26036,"GUNUNG, KEBAYORAN BARU, JAKARTA SELATAN, DKI JAKARTA",2,100,73,173
https://kawalpemilu.org#26036,"GUNUNG, KEBAYORAN BARU, JAKARTA SELATAN, DKI JAKARTA",7,83,137,220
https://kawalpemilu.org#26036,"GUNUNG, KEBAYORAN BARU, JAKARTA SELATAN, DKI JAKARTA",8,96,142,238
https://kawalpemilu.org#26036,"GUNUNG, KEBAYORAN BARU, JAKARTA SELATAN, DKI JAKARTA",10,163,64,227
https://kawalpemilu.org#26036,"GUNUNG, KEBAYORAN BARU, JAKARTA SELATAN, DKI JAKARTA",11,157,90,247
https://kawalpemilu.org#26036,"GUNUNG, KEBAYORAN BARU, JAKARTA SELATAN, DKI JAKARTA",12,169,64,233
https://kawalpemilu.org#26036,"GUNUNG, KEBAYORAN BARU, JAKARTA SELATAN, DKI JAKARTA",13,149,67,216
https://kawalpemilu.org#26036,"GUNUNG, KEBAYORAN BARU, JAKARTA SELATAN, DKI JAKARTA",14,151,55,206
https://kawalpemilu.org#26036,"GUNUNG, KEBAYORAN BARU, JAKARTA SELATAN, DKI JAKARTA",15,177,28,205
https://kawalpemilu.org#26036,"GUNUNG, KEBAYORAN BARU, JAKARTA SELATAN, DKI JAKARTA",16,155,52,207
https://kawalpemilu.org#26036,"GUNUNG, KEBAYORAN BARU, JAKARTA SELATAN, DKI JAKARTA",17,163,46,209
https://kawalpemilu.org#26036,"GUNUNG, KEBAYORAN BARU, JAKARTA SELATAN, DKI JAKARTA",18,158,59,217
https://kawalpemilu.org#26036,"GUNUNG, KEBAYORAN BARU, JAKARTA SELATAN, DKI JAKARTA",20,135,84,219
https://kawalpemilu.org#26036,"GUNUNG, KEBAYORAN BARU, JAKARTA SELATAN, DKI JAKARTA",22,143,62,205
https://kawalpemilu.org#26036,"GUNUNG, KEBAYORAN BARU, JAKARTA SELATAN, DKI JAKARTA",23,144,64,208
https://kawalpemilu.org#26036,"GUNUNG, KEBAYORAN BARU, JAKARTA SELATAN, DKI JAKARTA",24,167,70,237
https://kawalpemilu.org#26036,"GUNUNG, KEBAYORAN BARU, JAKARTA SELATAN, DKI JAKARTA",25,142,74,216
https://kawalpemilu.org#26036,"GUNUNG, KEBAYORAN BARU, JAKARTA SELATAN, DKI JAKARTA",26,139,100,239
https://kawalpemilu.org#26036,"GUNUNG, KEBAYORAN BARU, JAKARTA SELATAN, DKI JAKARTA",27,133,78,211
https://kawalpemilu.org#26036,"GUNUNG, KEBAYORAN BARU, JAKARTA SELATAN, DKI JAKARTA",28,141,80,221
https://kawalpemilu.org#26036,"GUNUNG, KEBAYORAN BARU, JAKARTA SELATAN, DKI JAKARTA",29,119,95,214
https://kawalpemilu.org#26036,"GUNUNG, KEBAYORAN BARU, JAKARTA SELATAN, DKI JAKARTA",30,102,118,220
https://kawalpemilu.org#26036,"GUNUNG, KEBAYORAN BARU, JAKARTA SELATAN, DKI JAKARTA",31,105,139,244
https://kawalpemilu.org#26036,"GUNUNG, KEBAYORAN BARU, JAKARTA SELATAN, DKI JAKARTA",32,122,113,235
https://kawalpemilu.org#26037,"KRAMAT PELA, KEBAYORAN BARU, JAKARTA SELATAN, DKI JAKARTA",1,134,47,181
https://kawalpemilu.org#26037,"KRAMAT PELA, KEBAYORAN BARU, JAKARTA SELATAN, DKI JAKARTA",2,130,74,204
https://kawalpemilu.org#26037,"KRAMAT PELA, KEBAYORAN BARU, JAKARTA SELATAN, DKI JAKARTA",3,158,80,238
https://kawalpemilu.org#26037,"KRAMAT PELA, KEBAYORAN BARU, JAKARTA SELATAN, DKI JAKARTA",4,129,82,211
https://kawalpemilu.org#26037,"KRAMAT PELA, KEBAYORAN BARU, JAKARTA SELATAN, DKI JAKARTA",5,167,58,225
https://kawalpemilu.org#26037,"KRAMAT PELA, KEBAYORAN BARU, JAKARTA SELATAN, DKI JAKARTA",7,118,131,249
https://kawalpemilu.org#26037,"KRAMAT PELA, KEBAYORAN BARU, JAKARTA SELATAN, DKI JAKARTA",8,134,55,189
https://kawalpemilu.org#26037,"KRAMAT PELA, KEBAYORAN BARU, JAKARTA SELATAN, DKI JAKARTA",9,165,65,230
https://kawalpemilu.org#26037,"KRAMAT PELA, KEBAYORAN BARU, JAKARTA SELATAN, DKI JAKARTA",10,140,90,230
https://kawalpemilu.org#26037,"KRAMAT PELA, KEBAYORAN BARU, JAKARTA SELATAN, DKI JAKARTA",11,122,74,196
https://kawalpemilu.org#26037,"KRAMAT PELA, KEBAYORAN BARU, JAKARTA SELATAN, DKI JAKARTA",13,159,59,218
https://kawalpemilu.org#26037,"KRAMAT PELA, KEBAYORAN BARU, JAKARTA SELATAN, DKI JAKARTA",14,146,89,235
https://kawalpemilu.org#26037,"KRAMAT PELA, KEBAYORAN BARU, JAKARTA SELATAN, DKI JAKARTA",15,104,118,222
https://kawalpemilu.org#26037,"KRAMAT PELA, KEBAYORAN BARU, JAKARTA SELATAN, DKI JAKARTA",16,161,42,203
https://kawalpemilu.org#26037,"KRAMAT PELA, KEBAYORAN BARU, JAKARTA SELATAN, DKI JAKARTA",17,174,37,211
https://kawalpemilu.org#26037,"KRAMAT PELA, KEBAYORAN BARU, JAKARTA SELATAN, DKI JAKARTA",18,144,61,205
https://kawalpemilu.org#26037,"KRAMAT PELA, KEBAYORAN BARU, JAKARTA SELATAN, DKI JAKARTA",19,112,29,141
https://kawalpemilu.org#26037,"KRAMAT PELA, KEBAYORAN BARU, JAKARTA SELATAN, DKI JAKARTA",20,173,66,239
https://kawalpemilu.org#26037,"KRAMAT PELA, KEBAYORAN BARU, JAKARTA SELATAN, DKI JAKARTA",21,172,49,221
https://kawalpemilu.org#26037,"KRAMAT PELA, KEBAYORAN BARU, JAKARTA SELATAN, DKI JAKARTA",22,165,50,215
https://kawalpemilu.org#26037,"KRAMAT PELA, KEBAYORAN BARU, JAKARTA SELATAN, DKI JAKARTA",23,133,124,257
https://kawalpemilu.org#26037,"KRAMAT PELA, KEBAYORAN BARU, JAKARTA SELATAN, DKI JAKARTA",24,90,128,218
https://kawalpemilu.org#26037,"KRAMAT PELA, KEBAYORAN BARU, JAKARTA SELATAN, DKI JAKARTA",25,82,97,179
https://kawalpemilu.org#26037,"KRAMAT PELA, KEBAYORAN BARU, JAKARTA SELATAN, DKI JAKARTA",27,116,100,216
https://kawalpemilu.org#26037,"KRAMAT PELA, KEBAYORAN BARU, JAKARTA SELATAN, DKI JAKARTA",28,104,110,214
https://kawalpemilu.org#26037,"KRAMAT PELA, KEBAYORAN BARU, JAKARTA SELATAN, DKI JAKARTA",29,132,122,254
https://kawalpemilu.org#26037,"KRAMAT PELA, KEBAYORAN BARU, JAKARTA SELATAN, DKI JAKARTA",30,107,65,172
https://kawalpemilu.org#26037,"KRAMAT PELA, KEBAYORAN BARU, JAKARTA SELATAN, DKI JAKARTA",31,143,76,219
https://kawalpemilu.org#26037,"KRAMAT PELA, KEBAYORAN BARU, JAKARTA SELATAN, DKI JAKARTA",32,101,80,181
https://kawalpemilu.org#26037,"KRAMAT PELA, KEBAYORAN BARU, JAKARTA SELATAN, DKI JAKARTA",34,89,77,166
https://kawalpemilu.org#26037,"KRAMAT PELA, KEBAYORAN BARU, JAKARTA SELATAN, DKI JAKARTA",35,77,48,125
https://kawalpemilu.org#26037,"KRAMAT PELA, KEBAYORAN BARU, JAKARTA SELATAN, DKI JAKARTA",36,3,129,212
https://kawalpemilu.org#26037,"KRAMAT PELA, KEBAYORAN BARU, JAKARTA SELATAN, DKI JAKARTA",37,84,118,202
https://kawalpemilu.org#26037,"KRAMAT PELA, KEBAYORAN BARU, JAKARTA SELATAN, DKI JAKARTA",38,93,125,218
https://kawalpemilu.org#26037,"KRAMAT PELA, KEBAYORAN BARU, JAKARTA SELATAN, DKI JAKARTA",39,107,129,236
https://kawalpemilu.org#26037,"KRAMAT PELA, KEBAYORAN BARU, JAKARTA SELATAN, DKI JAKARTA",40,111,136,247
https://kawalpemilu.org#26037,"KRAMAT PELA, KEBAYORAN BARU, JAKARTA SELATAN, DKI JAKARTA",41,66,130,196
https://kawalpemilu.org#26037,"KRAMAT PELA, KEBAYORAN BARU, JAKARTA SELATAN, DKI JAKARTA",42,58,139,197
https://kawalpemilu.org#26037,"KRAMAT PELA, KEBAYORAN BARU, JAKARTA SELATAN, DKI JAKARTA",43,61,137,198
https://kawalpemilu.org#26037,"KRAMAT PELA, KEBAYORAN BARU, JAKARTA SELATAN, DKI JAKARTA",44,87,138,225
https://kawalpemilu.org#26037,"KRAMAT PELA, KEBAYORAN BARU, JAKARTA SELATAN, DKI JAKARTA",45,67,129,196
https://kawalpemilu.org#26037,"KRAMAT PELA, KEBAYORAN BARU, JAKARTA SELATAN, DKI JAKARTA",46,86,126,212
https://kawalpemilu.org#26037,"KRAMAT PELA, KEBAYORAN BARU, JAKARTA SELATAN, DKI JAKARTA",47,98,75,173
https://kawalpemilu.org#26037,"KRAMAT PELA, KEBAYORAN BARU, JAKARTA SELATAN, DKI JAKARTA",48,128,80,208
https://kawalpemilu.org#26037,"KRAMAT PELA, KEBAYORAN BARU, JAKARTA SELATAN, DKI JAKARTA",49,115,64,179
https://kawalpemilu.org#26037,"KRAMAT PELA, KEBAYORAN BARU, JAKARTA SELATAN, DKI JAKARTA",50,98,51,149
https://kawalpemilu.org#26038,"SELONG, KEBAYORAN BARU, JAKARTA SELATAN, DKI JAKARTA",1,123,74,197
https://kawalpemilu.org#26038,"SELONG, KEBAYORAN BARU, JAKARTA SELATAN, DKI JAKARTA",2,133,76,209
https://kawalpemilu.org#26038,"SELONG, KEBAYORAN BARU, JAKARTA SELATAN, DKI JAKARTA",3,124,62,186
https://kawalpemilu.org#26038,"SELONG, KEBAYORAN BARU, JAKARTA SELATAN, DKI JAKARTA",4,142,48,190
https://kawalpemilu.org#26038,"SELONG, KEBAYORAN BARU, JAKARTA SELATAN, DKI JAKARTA",5,146,55,201
https://kawalpemilu.org#26038,"SELONG, KEBAYORAN BARU, JAKARTA SELATAN, DKI JAKARTA",6,135,47,182
https://kawalpemilu.org#26038,"SELONG, KEBAYORAN BARU, JAKARTA SELATAN, DKI JAKARTA",7,95,64,159
https://kawalpemilu.org#26038,"SELONG, KEBAYORAN BARU, JAKARTA SELATAN, DKI JAKARTA",8,177,41,218
https://kawalpemilu.org#26038,"SELONG, KEBAYORAN BARU, JAKARTA SELATAN, DKI JAKARTA",9,152,50,202
https://kawalpemilu.org#26038,"SELONG, KEBAYORAN BARU, JAKARTA SELATAN, DKI JAKARTA",10,126,40,166
https://kawalpemilu.org#26038,"SELONG, KEBAYORAN BARU, JAKARTA SELATAN, DKI JAKARTA",11,86,143,229
https://kawalpemilu.org#26038,"SELONG, KEBAYORAN BARU, JAKARTA SELATAN, DKI JAKARTA",12,136,96,232
https://kawalpemilu.org#26039,"RAWA BARAT, KEBAYORAN BARU, JAKARTA SELATAN, DKI JAKARTA",1,123,56,179
https://kawalpemilu.org#26039,"RAWA BARAT, KEBAYORAN BARU, JAKARTA SELATAN, DKI JAKARTA",2,89,72,161
https://kawalpemilu.org#26039,"RAWA BARAT, KEBAYORAN BARU, JAKARTA SELATAN, DKI JAKARTA",3,128,65,193
https://kawalpemilu.org#26039,"RAWA BARAT, KEBAYORAN BARU, JAKARTA SELATAN, DKI JAKARTA",4,89,140,229
https://kawalpemilu.org#26039,"RAWA BARAT, KEBAYORAN BARU, JAKARTA SELATAN, DKI JAKARTA",5,79,145,224
https://kawalpemilu.org#26039,"RAWA BARAT, KEBAYORAN BARU, JAKARTA SELATAN, DKI JAKARTA",6,85,151,236
https://kawalpemilu.org#26039,"RAWA BARAT, KEBAYORAN BARU, JAKARTA SELATAN, DKI JAKARTA",7,87,132,219
https://kawalpemilu.org#26039,"RAWA BARAT, KEBAYORAN BARU, JAKARTA SELATAN, DKI JAKARTA",8,91,134,225
https://kawalpemilu.org#26039,"RAWA BARAT, KEBAYORAN BARU, JAKARTA SELATAN, DKI JAKARTA",9,70,140,210
https://kawalpemilu.org#26039,"RAWA BARAT, KEBAYORAN BARU, JAKARTA SELATAN, DKI JAKARTA",10,156,48,204
https://kawalpemilu.org#26039,"RAWA BARAT, KEBAYORAN BARU, JAKARTA SELATAN, DKI JAKARTA",11,175,52,227
https://kawalpemilu.org#26039,"RAWA BARAT, KEBAYORAN BARU, JAKARTA SELATAN, DKI JAKARTA",12,134,70,204
https://kawalpemilu.org#26039,"RAWA BARAT, KEBAYORAN BARU, JAKARTA SELATAN, DKI JAKARTA",13,121,108,229
https://kawalpemilu.org#26039,"RAWA BARAT, KEBAYORAN BARU, JAKARTA SELATAN, DKI JAKARTA",14,117,97,214
https://kawalpemilu.org#26039,"RAWA BARAT, KEBAYORAN BARU, JAKARTA SELATAN, DKI JAKARTA",15,104,123,227
https://kawalpemilu.org#26039,"RAWA BARAT, KEBAYORAN BARU, JAKARTA SELATAN, DKI JAKARTA",16,123,106,229
https://kawalpemilu.org#26039,"RAWA BARAT, KEBAYORAN BARU, JAKARTA SELATAN, DKI JAKARTA",17,122,111,233
https://kawalpemilu.org#26039,"RAWA BARAT, KEBAYORAN BARU, JAKARTA SELATAN, DKI JAKARTA",18,139,48,187
https://kawalpemilu.org#26039,"RAWA BARAT, KEBAYORAN BARU, JAKARTA SELATAN, DKI JAKARTA",19,150,60,210
https://kawalpemilu.org#26039,"RAWA BARAT, KEBAYORAN BARU, JAKARTA SELATAN, DKI JAKARTA",20,181,46,227
https://kawalpemilu.org#26039,"RAWA BARAT, KEBAYORAN BARU, JAKARTA SELATAN, DKI JAKARTA",21,127,40,167
https://kawalpemilu.org#26040,"SENAYAN, KEBAYORAN BARU, JAKARTA SELATAN, DKI JAKARTA",1,127,56,183
https://kawalpemilu.org#26040,"SENAYAN, KEBAYORAN BARU, JAKARTA SELATAN, DKI JAKARTA",2,174,51,225
https://kawalpemilu.org#26040,"SENAYAN, KEBAYORAN BARU, JAKARTA SELATAN, DKI JAKARTA",3,161,25,186
https://kawalpemilu.org#26040,"SENAYAN, KEBAYORAN BARU, JAKARTA SELATAN, DKI JAKARTA",4,151,35,186
https://kawalpemilu.org#26040,"SENAYAN, KEBAYORAN BARU, JAKARTA SELATAN, DKI JAKARTA",5,148,45,193
https://kawalpemilu.org#26040,"SENAYAN, KEBAYORAN BARU, JAKARTA SELATAN, DKI JAKARTA",6,104,106,210
https://kawalpemilu.org#26040,"SENAYAN, KEBAYORAN BARU, JAKARTA SELATAN, DKI JAKARTA",7,70,111,181
https://kawalpemilu.org#26040,"SENAYAN, KEBAYORAN BARU, JAKARTA SELATAN, DKI JAKARTA",9,71,89,160
https://kawalpemilu.org#26040,"SENAYAN, KEBAYORAN BARU, JAKARTA SELATAN, DKI JAKARTA",11,51,77,128
https://kawalpemilu.org#26040,"SENAYAN, KEBAYORAN BARU, JAKARTA SELATAN, DKI JAKARTA",12,54,90,144
https://kawalpemilu.org#26040,"SENAYAN, KEBAYORAN BARU, JAKARTA SELATAN, DKI JAKARTA",13,76,48,124
https://kawalpemilu.org#26040,"SENAYAN, KEBAYORAN BARU, JAKARTA SELATAN, DKI JAKARTA",14,107,121,228
https://kawalpemilu.org#26040,"SENAYAN, KEBAYORAN BARU, JAKARTA SELATAN, DKI JAKARTA",15,129,114,243
https://kawalpemilu.org#26040,"SENAYAN, KEBAYORAN BARU, JAKARTA SELATAN, DKI JAKARTA",16,104,106,210
https://kawalpemilu.org#26041,"PULO, KEBAYORAN BARU, JAKARTA SELATAN, DKI JAKARTA",1,137,62,199
https://kawalpemilu.org#26041,"PULO, KEBAYORAN BARU, JAKARTA SELATAN, DKI JAKARTA",2,87,116,203
https://kawalpemilu.org#26041,"PULO, KEBAYORAN BARU, JAKARTA SELATAN, DKI JAKARTA",3,85,24,109
https://kawalpemilu.org#26041,"PULO, KEBAYORAN BARU, JAKARTA SELATAN, DKI JAKARTA",4,133,58,191
https://kawalpemilu.org#26041,"PULO, KEBAYORAN BARU, JAKARTA SELATAN, DKI JAKARTA",5,104,40,144
https://kawalpemilu.org#26041,"PULO, KEBAYORAN BARU, JAKARTA SELATAN, DKI JAKARTA",6,130,47,177
https://kawalpemilu.org#26041,"PULO, KEBAYORAN BARU, JAKARTA SELATAN, DKI JAKARTA",7,120,47,167
https://kawalpemilu.org#26041,"PULO, KEBAYORAN BARU, JAKARTA SELATAN, DKI JAKARTA",8,104,34,138
https://kawalpemilu.org#26041,"PULO, KEBAYORAN BARU, JAKARTA SELATAN, DKI JAKARTA",9,160,86,246
https://kawalpemilu.org#26041,"PULO, KEBAYORAN BARU, JAKARTA SELATAN, DKI JAKARTA",10,116,106,222
https://kawalpemilu.org#26041,"PULO, KEBAYORAN BARU, JAKARTA SELATAN, DKI JAKARTA",11,137,77,214
https://kawalpemilu.org#26041,"PULO, KEBAYORAN BARU, JAKARTA SELATAN, DKI JAKARTA",12,190,70,260
https://kawalpemilu.org#26041,"PULO, KEBAYORAN BARU, JAKARTA SELATAN, DKI JAKARTA",13,181,90,271
https://kawalpemilu.org#26041,"PULO, KEBAYORAN BARU, JAKARTA SELATAN, DKI JAKARTA",14,159,74,233
https://kawalpemilu.org#26041,"PULO, KEBAYORAN BARU, JAKARTA SELATAN, DKI JAKARTA",15,101,139,240
https://kawalpemilu.org#26041,"PULO, KEBAYORAN BARU, JAKARTA SELATAN, DKI JAKARTA",16,119,108,227
https://kawalpemilu.org#26041,"PULO, KEBAYORAN BARU, JAKARTA SELATAN, DKI JAKARTA",17,65,111,176
https://kawalpemilu.org#26041,"PULO, KEBAYORAN BARU, JAKARTA SELATAN, DKI JAKARTA",18,132,116,248
https://kawalpemilu.org#26041,"PULO, KEBAYORAN BARU, JAKARTA SELATAN, DKI JAKARTA",19,114,107,221
https://kawalpemilu.org#26041,"PULO, KEBAYORAN BARU, JAKARTA SELATAN, DKI JAKARTA",20,115,69,184
https://kawalpemilu.org#26041,"PULO, KEBAYORAN BARU, JAKARTA SELATAN, DKI JAKARTA",21,113,107,220
https://kawalpemilu.org#26041,"PULO, KEBAYORAN BARU, JAKARTA SELATAN, DKI JAKARTA",22,107,54,161
https://kawalpemilu.org#26042,"PETOGOGAN, KEBAYORAN BARU, JAKARTA SELATAN, DKI JAKARTA",1,157,73,230
https://kawalpemilu.org#26042,"PETOGOGAN, KEBAYORAN BARU, JAKARTA SELATAN, DKI JAKARTA",2,148,79,227
https://kawalpemilu.org#26042,"PETOGOGAN, KEBAYORAN BARU, JAKARTA SELATAN, DKI JAKARTA",3,152,53,205
https://kawalpemilu.org#26042,"PETOGOGAN, KEBAYORAN BARU, JAKARTA SELATAN, DKI JAKARTA",4,78,166,244
https://kawalpemilu.org#26042,"PETOGOGAN, KEBAYORAN BARU, JAKARTA SELATAN, DKI JAKARTA",5,190,48,238
https://kawalpemilu.org#26042,"PETOGOGAN, KEBAYORAN BARU, JAKARTA SELATAN, DKI JAKARTA",6,115,88,203
https://kawalpemilu.org#26042,"PETOGOGAN, KEBAYORAN BARU, JAKARTA SELATAN, DKI JAKARTA",7,75,125,200
https://kawalpemilu.org#26042,"PETOGOGAN, KEBAYORAN BARU, JAKARTA SELATAN, DKI JAKARTA",8,85,135,220
https://kawalpemilu.org#26042,"PETOGOGAN, KEBAYORAN BARU, JAKARTA SELATAN, DKI JAKARTA",9,78,95,173
https://kawalpemilu.org#26042,"PETOGOGAN, KEBAYORAN BARU, JAKARTA SELATAN, DKI JAKARTA",10,34,148,182
https://kawalpemilu.org#26042,"PETOGOGAN, KEBAYORAN BARU, JAKARTA SELATAN, DKI JAKARTA",11,79,141,220
https://kawalpemilu.org#26042,"PETOGOGAN, KEBAYORAN BARU, JAKARTA SELATAN, DKI JAKARTA",14,80,118,198
https://kawalpemilu.org#26042,"PETOGOGAN, KEBAYORAN BARU, JAKARTA SELATAN, DKI JAKARTA",15,67,142,209
https://kawalpemilu.org#26042,"PETOGOGAN, KEBAYORAN BARU, JAKARTA SELATAN, DKI JAKARTA",16,162,57,219
https://kawalpemilu.org#26042,"PETOGOGAN, KEBAYORAN BARU, JAKARTA SELATAN, DKI JAKARTA",17,86,81,167
https://kawalpemilu.org#26042,"PETOGOGAN, KEBAYORAN BARU, JAKARTA SELATAN, DKI JAKARTA",18,44,142,186
https://kawalpemilu.org#26042,"PETOGOGAN, KEBAYORAN BARU, JAKARTA SELATAN, DKI JAKARTA",19,122,110,232
https://kawalpemilu.org#26042,"PETOGOGAN, KEBAYORAN BARU, JAKARTA SELATAN, DKI JAKARTA",20,93,103,196
https://kawalpemilu.org#26042,"PETOGOGAN, KEBAYORAN BARU, JAKARTA SELATAN, DKI JAKARTA",22,163,74,237
https://kawalpemilu.org#26042,"PETOGOGAN, KEBAYORAN BARU, JAKARTA SELATAN, DKI JAKARTA",26,53,146,199
https://kawalpemilu.org#26042,"PETOGOGAN, KEBAYORAN BARU, JAKARTA SELATAN, DKI JAKARTA",27,64,132,196
https://kawalpemilu.org#26042,"PETOGOGAN, KEBAYORAN BARU, JAKARTA SELATAN, DKI JAKARTA",28,79,114,193
https://kawalpemilu.org#26042,"PETOGOGAN, KEBAYORAN BARU, JAKARTA SELATAN, DKI JAKARTA",29,73,126,199
https://kawalpemilu.org#26042,"PETOGOGAN, KEBAYORAN BARU, JAKARTA SELATAN, DKI JAKARTA",30,152,81,233
https://kawalpemilu.org#26042,"PETOGOGAN, KEBAYORAN BARU, JAKARTA SELATAN, DKI JAKARTA",31,157,77,234
https://kawalpemilu.org#26042,"PETOGOGAN, KEBAYORAN BARU, JAKARTA SELATAN, DKI JAKARTA",32,157,61,218
https://kawalpemilu.org#26042,"PETOGOGAN, KEBAYORAN BARU, JAKARTA SELATAN, DKI JAKARTA",33,172,62,234
https://kawalpemilu.org#26042,"PETOGOGAN, KEBAYORAN BARU, JAKARTA SELATAN, DKI JAKARTA",34,80,57,137
https://kawalpemilu.org#26042,"PETOGOGAN, KEBAYORAN BARU, JAKARTA SELATAN, DKI JAKARTA",35,109,72,181
https://kawalpemilu.org#26042,"PETOGOGAN, KEBAYORAN BARU, JAKARTA SELATAN, DKI JAKARTA",36,103,91,194
https://kawalpemilu.org#26042,"PETOGOGAN, KEBAYORAN BARU, JAKARTA SELATAN, DKI JAKARTA",37,126,46,172
https://kawalpemilu.org#26042,"PETOGOGAN, KEBAYORAN BARU, JAKARTA SELATAN, DKI JAKARTA",38,99,24,173
https://kawalpemilu.org#26042,"PETOGOGAN, KEBAYORAN BARU, JAKARTA SELATAN, DKI JAKARTA",39,158,75,233
https://kawalpemilu.org#26042,"PETOGOGAN, KEBAYORAN BARU, JAKARTA SELATAN, DKI JAKARTA",40,128,93,221
https://kawalpemilu.org#26042,"PETOGOGAN, KEBAYORAN BARU, JAKARTA SELATAN, DKI JAKARTA",41,146,87,233
https://kawalpemilu.org#26042,"PETOGOGAN, KEBAYORAN BARU, JAKARTA SELATAN, DKI JAKARTA",42,132,92,224
https://kawalpemilu.org#26043,"GANDARIA UTARA, KEBAYORAN BARU, JAKARTA SELATAN, DKI JAKARTA",1,129,76,205
https://kawalpemilu.org#26043,"GANDARIA UTARA, KEBAYORAN BARU, JAKARTA SELATAN, DKI JAKARTA",3,112,92,204
https://kawalpemilu.org#26043,"GANDARIA UTARA, KEBAYORAN BARU, JAKARTA SELATAN, DKI JAKARTA",4,94,126,220
https://kawalpemilu.org#26043,"GANDARIA UTARA, KEBAYORAN BARU, JAKARTA SELATAN, DKI JAKARTA",6,107,121,228
https://kawalpemilu.org#26043,"GANDARIA UTARA, KEBAYORAN BARU, JAKARTA SELATAN, DKI JAKARTA",7,92,104,196
https://kawalpemilu.org#26043,"GANDARIA UTARA, KEBAYORAN BARU, JAKARTA SELATAN, DKI JAKARTA",8,78,112,190
https://kawalpemilu.org#26043,"GANDARIA UTARA, KEBAYORAN BARU, JAKARTA SELATAN, DKI JAKARTA",11,86,154,240
https://kawalpemilu.org#26043,"GANDARIA UTARA, KEBAYORAN BARU, JAKARTA SELATAN, DKI JAKARTA",12,120,82,202
https://kawalpemilu.org#26043,"GANDARIA UTARA, KEBAYORAN BARU, JAKARTA SELATAN, DKI JAKARTA",13,131,74,205
https://kawalpemilu.org#26043,"GANDARIA UTARA, KEBAYORAN BARU, JAKARTA SELATAN, DKI JAKARTA",14,94,91,185
https://kawalpemilu.org#26043,"GANDARIA UTARA, KEBAYORAN BARU, JAKARTA SELATAN, DKI JAKARTA",15,81,105,186
https://kawalpemilu.org#26043,"GANDARIA UTARA, KEBAYORAN BARU, JAKARTA SELATAN, DKI JAKARTA",16,120,90,210
https://kawalpemilu.org#26043,"GANDARIA UTARA, KEBAYORAN BARU, JAKARTA SELATAN, DKI JAKARTA",17,121,80,201
https://kawalpemilu.org#26043,"GANDARIA UTARA, KEBAYORAN BARU, JAKARTA SELATAN, DKI JAKARTA",18,93,43,136
https://kawalpemilu.org#26043,"GANDARIA UTARA, KEBAYORAN BARU, JAKARTA SELATAN, DKI JAKARTA",19,0,0,0
https://kawalpemilu.org#26043,"GANDARIA UTARA, KEBAYORAN BARU, JAKARTA SELATAN, DKI JAKARTA",20,118,87,205
https://kawalpemilu.org#26043,"GANDARIA UTARA, KEBAYORAN BARU, JAKARTA SELATAN, DKI JAKARTA",21,105,69,174
https://kawalpemilu.org#26043,"GANDARIA UTARA, KEBAYORAN BARU, JAKARTA SELATAN, DKI JAKARTA",24,154,101,255
https://kawalpemilu.org#26043,"GANDARIA UTARA, KEBAYORAN BARU, JAKARTA SELATAN, DKI JAKARTA",25,104,67,171
https://kawalpemilu.org#26043,"GANDARIA UTARA, KEBAYORAN BARU, JAKARTA SELATAN, DKI JAKARTA",26,97,85,182
https://kawalpemilu.org#26043,"GANDARIA UTARA, KEBAYORAN BARU, JAKARTA SELATAN, DKI JAKARTA",27,85,90,175
https://kawalpemilu.org#26043,"GANDARIA UTARA, KEBAYORAN BARU, JAKARTA SELATAN, DKI JAKARTA",29,136,106,242
https://kawalpemilu.org#26043,"GANDARIA UTARA, KEBAYORAN BARU, JAKARTA SELATAN, DKI JAKARTA",33,144,84,228
https://kawalpemilu.org#26043,"GANDARIA UTARA, KEBAYORAN BARU, JAKARTA SELATAN, DKI JAKARTA",34,56,79,135
https://kawalpemilu.org#26043,"GANDARIA UTARA, KEBAYORAN BARU, JAKARTA SELATAN, DKI JAKARTA",35,84,83,167
https://kawalpemilu.org#26043,"GANDARIA UTARA, KEBAYORAN BARU, JAKARTA SELATAN, DKI JAKARTA",38,120,95,215
https://kawalpemilu.org#26043,"GANDARIA UTARA, KEBAYORAN BARU, JAKARTA SELATAN, DKI JAKARTA",39,88,141,229
https://kawalpemilu.org#26043,"GANDARIA UTARA, KEBAYORAN BARU, JAKARTA SELATAN, DKI JAKARTA",40,94,152,246
https://kawalpemilu.org#26043,"GANDARIA UTARA, KEBAYORAN BARU, JAKARTA SELATAN, DKI JAKARTA",41,111,119,230
https://kawalpemilu.org#26043,"GANDARIA UTARA, KEBAYORAN BARU, JAKARTA SELATAN, DKI JAKARTA",42,97,143,240
https://kawalpemilu.org#26043,"GANDARIA UTARA, KEBAYORAN BARU, JAKARTA SELATAN, DKI JAKARTA",46,146,109,255
https://kawalpemilu.org#26043,"GANDARIA UTARA, KEBAYORAN BARU, JAKARTA SELATAN, DKI JAKARTA",47,122,107,229
https://kawalpemilu.org#26043,"GANDARIA UTARA, KEBAYORAN BARU, JAKARTA SELATAN, DKI JAKARTA",53,107,152,259
https://kawalpemilu.org#26043,"GANDARIA UTARA, KEBAYORAN BARU, JAKARTA SELATAN, DKI JAKARTA",56,123,126,249
https://kawalpemilu.org#26043,"GANDARIA UTARA, KEBAYORAN BARU, JAKARTA SELATAN, DKI JAKARTA",58,90,152,242
https://kawalpemilu.org#26043,"GANDARIA UTARA, KEBAYORAN BARU, JAKARTA SELATAN, DKI JAKARTA",59,81,136,217
https://kawalpemilu.org#26043,"GANDARIA UTARA, KEBAYORAN BARU, JAKARTA SELATAN, DKI JAKARTA",60,112,125,237
https://kawalpemilu.org#26043,"GANDARIA UTARA, KEBAYORAN BARU, JAKARTA SELATAN, DKI JAKARTA",61,127,61,188
https://kawalpemilu.org#26043,"GANDARIA UTARA, KEBAYORAN BARU, JAKARTA SELATAN, DKI JAKARTA",63,121,88,209
https://kawalpemilu.org#26043,"GANDARIA UTARA, KEBAYORAN BARU, JAKARTA SELATAN, DKI JAKARTA",64,157,86,243
https://kawalpemilu.org#26043,"GANDARIA UTARA, KEBAYORAN BARU, JAKARTA SELATAN, DKI JAKARTA",65,153,73,226
https://kawalpemilu.org#26043,"GANDARIA UTARA, KEBAYORAN BARU, JAKARTA SELATAN, DKI JAKARTA",66,127,65,192
https://kawalpemilu.org#26043,"GANDARIA UTARA, KEBAYORAN BARU, JAKARTA SELATAN, DKI JAKARTA",67,122,69,191
https://kawalpemilu.org#26043,"GANDARIA UTARA, KEBAYORAN BARU, JAKARTA SELATAN, DKI JAKARTA",68,172,72,244
https://kawalpemilu.org#26043,"GANDARIA UTARA, KEBAYORAN BARU, JAKARTA SELATAN, DKI JAKARTA",71,132,88,220
https://kawalpemilu.org#26043,"GANDARIA UTARA, KEBAYORAN BARU, JAKARTA SELATAN, DKI JAKARTA",72,118,107,225
https://kawalpemilu.org#26043,"GANDARIA UTARA, KEBAYORAN BARU, JAKARTA SELATAN, DKI JAKARTA",73,95,128,223
https://kawalpemilu.org#26043,"GANDARIA UTARA, KEBAYORAN BARU, JAKARTA SELATAN, DKI JAKARTA",74,101,129,230
https://kawalpemilu.org#26043,"GANDARIA UTARA, KEBAYORAN BARU, JAKARTA SELATAN, DKI JAKARTA",75,148,92,240
https://kawalpemilu.org#26043,"GANDARIA UTARA, KEBAYORAN BARU, JAKARTA SELATAN, DKI JAKARTA",77,120,65,185
https://kawalpemilu.org#26043,"GANDARIA UTARA, KEBAYORAN BARU, JAKARTA SELATAN, DKI JAKARTA",78,120,123,243
https://kawalpemilu.org#26043,"GANDARIA UTARA, KEBAYORAN BARU, JAKARTA SELATAN, DKI JAKARTA",79,125,119,244
https://kawalpemilu.org#26043,"GANDARIA UTARA, KEBAYORAN BARU, JAKARTA SELATAN, DKI JAKARTA",80,113,112,225
https://kawalpemilu.org#26043,"GANDARIA UTARA, KEBAYORAN BARU, JAKARTA SELATAN, DKI JAKARTA",81,88,121,209
https://kawalpemilu.org#26043,"GANDARIA UTARA, KEBAYORAN BARU, JAKARTA SELATAN, DKI JAKARTA",83,122,78,200
https://kawalpemilu.org#26043,"GANDARIA UTARA, KEBAYORAN BARU, JAKARTA SELATAN, DKI JAKARTA",84,115,109,224
https://kawalpemilu.org#26043,"GANDARIA UTARA, KEBAYORAN BARU, JAKARTA SELATAN, DKI JAKARTA",86,61,137,198
https://kawalpemilu.org#26043,"GANDARIA UTARA, KEBAYORAN BARU, JAKARTA SELATAN, DKI JAKARTA",89,109,114,223
https://kawalpemilu.org#26043,"GANDARIA UTARA, KEBAYORAN BARU, JAKARTA SELATAN, DKI JAKARTA",90,123,77,200
https://kawalpemilu.org#26043,"GANDARIA UTARA, KEBAYORAN BARU, JAKARTA SELATAN, DKI JAKARTA",91,125,66,191
https://kawalpemilu.org#26043,"GANDARIA UTARA, KEBAYORAN BARU, JAKARTA SELATAN, DKI JAKARTA",92,102,76,178
https://kawalpemilu.org#26043,"GANDARIA UTARA, KEBAYORAN BARU, JAKARTA SELATAN, DKI JAKARTA",98,101,64,165
https://kawalpemilu.org#26043,"GANDARIA UTARA, KEBAYORAN BARU, JAKARTA SELATAN, DKI JAKARTA",99,88,79,167
https://kawalpemilu.org#26043,"GANDARIA UTARA, KEBAYORAN BARU, JAKARTA SELATAN, DKI JAKARTA",100,71,84,155
https://kawalpemilu.org#26043,"GANDARIA UTARA, KEBAYORAN BARU, JAKARTA SELATAN, DKI JAKARTA",101,94,130,224
https://kawalpemilu.org#26043,"GANDARIA UTARA, KEBAYORAN BARU, JAKARTA SELATAN, DKI JAKARTA",102,98,108,206
https://kawalpemilu.org#26043,"GANDARIA UTARA, KEBAYORAN BARU, JAKARTA SELATAN, DKI JAKARTA",107,97,133,230
https://kawalpemilu.org#26043,"GANDARIA UTARA, KEBAYORAN BARU, JAKARTA SELATAN, DKI JAKARTA",109,99,79,178
https://kawalpemilu.org#26043,"GANDARIA UTARA, KEBAYORAN BARU, JAKARTA SELATAN, DKI JAKARTA",111,115,121,236
https://kawalpemilu.org#26043,"GANDARIA UTARA, KEBAYORAN BARU, JAKARTA SELATAN, DKI JAKARTA",112,116,95,211
https://kawalpemilu.org#26043,"GANDARIA UTARA, KEBAYORAN BARU, JAKARTA SELATAN, DKI JAKARTA",113,148,96,244
https://kawalpemilu.org#26043,"GANDARIA UTARA, KEBAYORAN BARU, JAKARTA SELATAN, DKI JAKARTA",115,103,126,229
https://kawalpemilu.org#26043,"GANDARIA UTARA, KEBAYORAN BARU, JAKARTA SELATAN, DKI JAKARTA",117,128,103,231
https://kawalpemilu.org#26043,"GANDARIA UTARA, KEBAYORAN BARU, JAKARTA SELATAN, DKI JAKARTA",119,97,95,192
https://kawalpemilu.org#26043,"GANDARIA UTARA, KEBAYORAN BARU, JAKARTA SELATAN, DKI JAKARTA",120,108,70,178
https://kawalpemilu.org#26043,"GANDARIA UTARA, KEBAYORAN BARU, JAKARTA SELATAN, DKI JAKARTA",121,59,102,161
https://kawalpemilu.org#26043,"GANDARIA UTARA, KEBAYORAN BARU, JAKARTA SELATAN, DKI JAKARTA",123,83,115,198
https://kawalpemilu.org#26043,"GANDARIA UTARA, KEBAYORAN BARU, JAKARTA SELATAN, DKI JAKARTA",124,118,137,255
https://kawalpemilu.org#26043,"GANDARIA UTARA, KEBAYORAN BARU, JAKARTA SELATAN, DKI JAKARTA",126,134,90,224
https://kawalpemilu.org#26043,"GANDARIA UTARA, KEBAYORAN BARU, JAKARTA SELATAN, DKI JAKARTA",127,136,90,226
https://kawalpemilu.org#26043,"GANDARIA UTARA, KEBAYORAN BARU, JAKARTA SELATAN, DKI JAKARTA",128,97,70,167
https://kawalpemilu.org#26043,"GANDARIA UTARA, KEBAYORAN BARU, JAKARTA SELATAN, DKI JAKARTA",129,140,29,169
https://kawalpemilu.org#26043,"GANDARIA UTARA, KEBAYORAN BARU, JAKARTA SELATAN, DKI JAKARTA",130,99,152,251
https://kawalpemilu.org#26043,"GANDARIA UTARA, KEBAYORAN BARU, JAKARTA SELATAN, DKI JAKARTA",131,105,133,238
https://kawalpemilu.org#26043,"GANDARIA UTARA, KEBAYORAN BARU, JAKARTA SELATAN, DKI JAKARTA",132,114,118,232
https://kawalpemilu.org#26043,"GANDARIA UTARA, KEBAYORAN BARU, JAKARTA SELATAN, DKI JAKARTA",133,105,116,221
https://kawalpemilu.org#26043,"GANDARIA UTARA, KEBAYORAN BARU, JAKARTA SELATAN, DKI JAKARTA",134,147,112,259
https://kawalpemilu.org#26043,"GANDARIA UTARA, KEBAYORAN BARU, JAKARTA SELATAN, DKI JAKARTA",135,109,131,240
https://kawalpemilu.org#26043,"GANDARIA UTARA, KEBAYORAN BARU, JAKARTA SELATAN, DKI JAKARTA",136,117,71,188
https://kawalpemilu.org#26043,"GANDARIA UTARA, KEBAYORAN BARU, JAKARTA SELATAN, DKI JAKARTA",137,95,126,221
https://kawalpemilu.org#26044,"CIPETE UTARA, KEBAYORAN BARU, JAKARTA SELATAN, DKI JAKARTA",1,114,106,220
https://kawalpemilu.org#26044,"CIPETE UTARA, KEBAYORAN BARU, JAKARTA SELATAN, DKI JAKARTA",3,103,100,203
https://kawalpemilu.org#26044,"CIPETE UTARA, KEBAYORAN BARU, JAKARTA SELATAN, DKI JAKARTA",4,133,80,213
https://kawalpemilu.org#26044,"CIPETE UTARA, KEBAYORAN BARU, JAKARTA SELATAN, DKI JAKARTA",5,99,104,203
https://kawalpemilu.org#26044,"CIPETE UTARA, KEBAYORAN BARU, JAKARTA SELATAN, DKI JAKARTA",6,62,155,217
https://kawalpemilu.org#26044,"CIPETE UTARA, KEBAYORAN BARU, JAKARTA SELATAN, DKI JAKARTA",7,122,90,212
https://kawalpemilu.org#26044,"CIPETE UTARA, KEBAYORAN BARU, JAKARTA SELATAN, DKI JAKARTA",8,124,91,215
https://kawalpemilu.org#26044,"CIPETE UTARA, KEBAYORAN BARU, JAKARTA SELATAN, DKI JAKARTA",9,103,124,227
https://kawalpemilu.org#26044,"CIPETE UTARA, KEBAYORAN BARU, JAKARTA SELATAN, DKI JAKARTA",10,54,105,159
https://kawalpemilu.org#26044,"CIPETE UTARA, KEBAYORAN BARU, JAKARTA SELATAN, DKI JAKARTA",11,92,109,201
https://kawalpemilu.org#26044,"CIPETE UTARA, KEBAYORAN BARU, JAKARTA SELATAN, DKI JAKARTA",12,118,57,175
https://kawalpemilu.org#26044,"CIPETE UTARA, KEBAYORAN BARU, JAKARTA SELATAN, DKI JAKARTA",13,114,93,207
https://kawalpemilu.org#26044,"CIPETE UTARA, KEBAYORAN BARU, JAKARTA SELATAN, DKI JAKARTA",14,150,65,215
https://kawalpemilu.org#26044,"CIPETE UTARA, KEBAYORAN BARU, JAKARTA SELATAN, DKI JAKARTA",15,122,60,182
https://kawalpemilu.org#26044,"CIPETE UTARA, KEBAYORAN BARU, JAKARTA SELATAN, DKI JAKARTA",16,122,65,187
https://kawalpemilu.org#26044,"CIPETE UTARA, KEBAYORAN BARU, JAKARTA SELATAN, DKI JAKARTA",17,117,97,214
https://kawalpemilu.org#26044,"CIPETE UTARA, KEBAYORAN BARU, JAKARTA SELATAN, DKI JAKARTA",18,114,86,200
https://kawalpemilu.org#26044,"CIPETE UTARA, KEBAYORAN BARU, JAKARTA SELATAN, DKI JAKARTA",19,128,106,234
https://kawalpemilu.org#26044,"CIPETE UTARA, KEBAYORAN BARU, JAKARTA SELATAN, DKI JAKARTA",20,118,116,234
https://kawalpemilu.org#26044,"CIPETE UTARA, KEBAYORAN BARU, JAKARTA SELATAN, DKI JAKARTA",21,141,55,196
https://kawalpemilu.org#26044,"CIPETE UTARA, KEBAYORAN BARU, JAKARTA SELATAN, DKI JAKARTA",23,108,81,189
https://kawalpemilu.org#26044,"CIPETE UTARA, KEBAYORAN BARU, JAKARTA SELATAN, DKI JAKARTA",24,108,122,230
https://kawalpemilu.org#26044,"CIPETE UTARA, KEBAYORAN BARU, JAKARTA SELATAN, DKI JAKARTA",25,119,90,209
https://kawalpemilu.org#26044,"CIPETE UTARA, KEBAYORAN BARU, JAKARTA SELATAN, DKI JAKARTA",26,148,121,269
https://kawalpemilu.org#26044,"CIPETE UTARA, KEBAYORAN BARU, JAKARTA SELATAN, DKI JAKARTA",27,118,107,225
https://kawalpemilu.org#26044,"CIPETE UTARA, KEBAYORAN BARU, JAKARTA SELATAN, DKI JAKARTA",28,132,129,261
https://kawalpemilu.org#26044,"CIPETE UTARA, KEBAYORAN BARU, JAKARTA SELATAN, DKI JAKARTA",29,157,102,259
https://kawalpemilu.org#26044,"CIPETE UTARA, KEBAYORAN BARU, JAKARTA SELATAN, DKI JAKARTA",30,124,103,227
https://kawalpemilu.org#26044,"CIPETE UTARA, KEBAYORAN BARU, JAKARTA SELATAN, DKI JAKARTA",31,138,101,239
https://kawalpemilu.org#26044,"CIPETE UTARA, KEBAYORAN BARU, JAKARTA SELATAN, DKI JAKARTA",32,136,103,239
https://kawalpemilu.org#26044,"CIPETE UTARA, KEBAYORAN BARU, JAKARTA SELATAN, DKI JAKARTA",33,157,47,204
https://kawalpemilu.org#26044,"CIPETE UTARA, KEBAYORAN BARU, JAKARTA SELATAN, DKI JAKARTA",34,124,53,177
https://kawalpemilu.org#26044,"CIPETE UTARA, KEBAYORAN BARU, JAKARTA SELATAN, DKI JAKARTA",35,141,38,179
https://kawalpemilu.org#26044,"CIPETE UTARA, KEBAYORAN BARU, JAKARTA SELATAN, DKI JAKARTA",37,127,65,192
https://kawalpemilu.org#26044,"CIPETE UTARA, KEBAYORAN BARU, JAKARTA SELATAN, DKI JAKARTA",38,114,81,195
https://kawalpemilu.org#26044,"CIPETE UTARA, KEBAYORAN BARU, JAKARTA SELATAN, DKI JAKARTA",39,87,60,147
https://kawalpemilu.org#26044,"CIPETE UTARA, KEBAYORAN BARU, JAKARTA SELATAN, DKI JAKARTA",40,116,78,194
https://kawalpemilu.org#26044,"CIPETE UTARA, KEBAYORAN BARU, JAKARTA SELATAN, DKI JAKARTA",41,130,97,227
https://kawalpemilu.org#26044,"CIPETE UTARA, KEBAYORAN BARU, JAKARTA SELATAN, DKI JAKARTA",42,143,78,221
https://kawalpemilu.org#26044,"CIPETE UTARA, KEBAYORAN BARU, JAKARTA SELATAN, DKI JAKARTA",43,156,87,243
https://kawalpemilu.org#26044,"CIPETE UTARA, KEBAYORAN BARU, JAKARTA SELATAN, DKI JAKARTA",44,160,90,250
https://kawalpemilu.org#26044,"CIPETE UTARA, KEBAYORAN BARU, JAKARTA SELATAN, DKI JAKARTA",45,139,29,168
https://kawalpemilu.org#26044,"CIPETE UTARA, KEBAYORAN BARU, JAKARTA SELATAN, DKI JAKARTA",46,147,63,210
https://kawalpemilu.org#26044,"CIPETE UTARA, KEBAYORAN BARU, JAKARTA SELATAN, DKI JAKARTA",49,133,68,201
https://kawalpemilu.org#26044,"CIPETE UTARA, KEBAYORAN BARU, JAKARTA SELATAN, DKI JAKARTA",50,102,118,220
https://kawalpemilu.org#26044,"CIPETE UTARA, KEBAYORAN BARU, JAKARTA SELATAN, DKI JAKARTA",51,106,81,187
https://kawalpemilu.org#26044,"CIPETE UTARA, KEBAYORAN BARU, JAKARTA SELATAN, DKI JAKARTA",54,141,98,239
https://kawalpemilu.org#26044,"CIPETE UTARA, KEBAYORAN BARU, JAKARTA SELATAN, DKI JAKARTA",55,119,119,238
https://kawalpemilu.org#26044,"CIPETE UTARA, KEBAYORAN BARU, JAKARTA SELATAN, DKI JAKARTA",56,138,100,238
https://kawalpemilu.org#26044,"CIPETE UTARA, KEBAYORAN BARU, JAKARTA SELATAN, DKI JAKARTA",57,106,128,234
https://kawalpemilu.org#26044,"CIPETE UTARA, KEBAYORAN BARU, JAKARTA SELATAN, DKI JAKARTA",58,131,72,203
https://kawalpemilu.org#26044,"CIPETE UTARA, KEBAYORAN BARU, JAKARTA SELATAN, DKI JAKARTA",59,105,84,189
https://kawalpemilu.org#26044,"CIPETE UTARA, KEBAYORAN BARU, JAKARTA SELATAN, DKI JAKARTA",60,95,131,226
https://kawalpemilu.org#26044,"CIPETE UTARA, KEBAYORAN BARU, JAKARTA SELATAN, DKI JAKARTA",62,136,88,224
https://kawalpemilu.org#26044,"CIPETE UTARA, KEBAYORAN BARU, JAKARTA SELATAN, DKI JAKARTA",63,98,85,183
https://kawalpemilu.org#26044,"CIPETE UTARA, KEBAYORAN BARU, JAKARTA SELATAN, DKI JAKARTA",64,187,62,249
https://kawalpemilu.org#26044,"CIPETE UTARA, KEBAYORAN BARU, JAKARTA SELATAN, DKI JAKARTA",65,189,51,240
https://kawalpemilu.org#26044,"CIPETE UTARA, KEBAYORAN BARU, JAKARTA SELATAN, DKI JAKARTA",66,167,46,213
https://kawalpemilu.org#26044,"CIPETE UTARA, KEBAYORAN BARU, JAKARTA SELATAN, DKI JAKARTA",67,133,98,231
https://kawalpemilu.org#26044,"CIPETE UTARA, KEBAYORAN BARU, JAKARTA SELATAN, DKI JAKARTA",68,118,96,214
https://kawalpemilu.org#26044,"CIPETE UTARA, KEBAYORAN BARU, JAKARTA SELATAN, DKI JAKARTA",69,85,105,190
https://kawalpemilu.org#26044,"CIPETE UTARA, KEBAYORAN BARU, JAKARTA SELATAN, DKI JAKARTA",70,126,101,227
https://kawalpemilu.org#26044,"CIPETE UTARA, KEBAYORAN BARU, JAKARTA SELATAN, DKI JAKARTA",72,162,82,244
https://kawalpemilu.org#26044,"CIPETE UTARA, KEBAYORAN BARU, JAKARTA SELATAN, DKI JAKARTA",73,123,64,187
https://kawalpemilu.org#26044,"CIPETE UTARA, KEBAYORAN BARU, JAKARTA SELATAN, DKI JAKARTA",74,122,90,212
https://kawalpemilu.org#26044,"CIPETE UTARA, KEBAYORAN BARU, JAKARTA SELATAN, DKI JAKARTA",75,109,75,184
https://kawalpemilu.org#26044,"CIPETE UTARA, KEBAYORAN BARU, JAKARTA SELATAN, DKI JAKARTA",76,110,85,195
https://kawalpemilu.org#26044,"CIPETE UTARA, KEBAYORAN BARU, JAKARTA SELATAN, DKI JAKARTA",77,113,62,175
https://kawalpemilu.org#26044,"CIPETE UTARA, KEBAYORAN BARU, JAKARTA SELATAN, DKI JAKARTA",78,146,60,206
https://kawalpemilu.org#26044,"CIPETE UTARA, KEBAYORAN BARU, JAKARTA SELATAN, DKI JAKARTA",79,123,57,180
https://kawalpemilu.org#26044,"CIPETE UTARA, KEBAYORAN BARU, JAKARTA SELATAN, DKI JAKARTA",80,95,78,173
https://kawalpemilu.org#26044,"CIPETE UTARA, KEBAYORAN BARU, JAKARTA SELATAN, DKI JAKARTA",81,84,82,166
https://kawalpemilu.org#26044,"CIPETE UTARA, KEBAYORAN BARU, JAKARTA SELATAN, DKI JAKARTA",82,114,65,179
https://kawalpemilu.org#26044,"CIPETE UTARA, KEBAYORAN BARU, JAKARTA SELATAN, DKI JAKARTA",83,75,81,156
https://kawalpemilu.org#26044,"CIPETE UTARA, KEBAYORAN BARU, JAKARTA SELATAN, DKI JAKARTA",84,178,79,257
https://kawalpemilu.org#26044,"CIPETE UTARA, KEBAYORAN BARU, JAKARTA SELATAN, DKI JAKARTA",85,158,83,241
https://kawalpemilu.org#26044,"CIPETE UTARA, KEBAYORAN BARU, JAKARTA SELATAN, DKI JAKARTA",86,137,77,214
https://kawalpemilu.org#26044,"CIPETE UTARA, KEBAYORAN BARU, JAKARTA SELATAN, DKI JAKARTA",87,130,106,236
https://kawalpemilu.org#26044,"CIPETE UTARA, KEBAYORAN BARU, JAKARTA SELATAN, DKI JAKARTA",88,115,101,216
https://kawalpemilu.org#26044,"CIPETE UTARA, KEBAYORAN BARU, JAKARTA SELATAN, DKI JAKARTA",89,148,102,250
https://kawalpemilu.org#26044,"CIPETE UTARA, KEBAYORAN BARU, JAKARTA SELATAN, DKI JAKARTA",90,115,91,206
https://kawalpemilu.org#26044,"CIPETE UTARA, KEBAYORAN BARU, JAKARTA SELATAN, DKI JAKARTA",91,116,89,205
https://kawalpemilu.org#26044,"CIPETE UTARA, KEBAYORAN BARU, JAKARTA SELATAN, DKI JAKARTA",92,99,111,210
https://kawalpemilu.org#26044,"CIPETE UTARA, KEBAYORAN BARU, JAKARTA SELATAN, DKI JAKARTA",93,94,78,172
https://kawalpemilu.org#26044,"CIPETE UTARA, KEBAYORAN BARU, JAKARTA SELATAN, DKI JAKARTA",94,76,70,146
https://kawalpemilu.org#26044,"CIPETE UTARA, KEBAYORAN BARU, JAKARTA SELATAN, DKI JAKARTA",95,87,126,213
https://kawalpemilu.org#26044,"CIPETE UTARA, KEBAYORAN BARU, JAKARTA SELATAN, DKI JAKARTA",96,97,118,215
https://kawalpemilu.org#26044,"CIPETE UTARA, KEBAYORAN BARU, JAKARTA SELATAN, DKI JAKARTA",97,135,83,218
https://kawalpemilu.org#26044,"CIPETE UTARA, KEBAYORAN BARU, JAKARTA SELATAN, DKI JAKARTA",98,114,114,228
https://kawalpemilu.org#26044,"CIPETE UTARA, KEBAYORAN BARU, JAKARTA SELATAN, DKI JAKARTA",99,169,64,233
https://kawalpemilu.org#26044,"CIPETE UTARA, KEBAYORAN BARU, JAKARTA SELATAN, DKI JAKARTA",100,154,92,246
https://kawalpemilu.org#26044,"CIPETE UTARA, KEBAYORAN BARU, JAKARTA SELATAN, DKI JAKARTA",101,155,90,245
https://kawalpemilu.org#26044,"CIPETE UTARA, KEBAYORAN BARU, JAKARTA SELATAN, DKI JAKARTA",102,79,116,195
https://kawalpemilu.org#26044,"CIPETE UTARA, KEBAYORAN BARU, JAKARTA SELATAN, DKI JAKARTA",103,91,108,199
https://kawalpemilu.org#26044,"CIPETE UTARA, KEBAYORAN BARU, JAKARTA SELATAN, DKI JAKARTA",104,117,100,217
https://kawalpemilu.org#26044,"CIPETE UTARA, KEBAYORAN BARU, JAKARTA SELATAN, DKI JAKARTA",105,142,101,243
https://kawalpemilu.org#26044,"CIPETE UTARA, KEBAYORAN BARU, JAKARTA SELATAN, DKI JAKARTA",106,126,53,179
https://kawalpemilu.org#26044,"CIPETE UTARA, KEBAYORAN BARU, JAKARTA SELATAN, DKI JAKARTA",107,91,93,184
https://kawalpemilu.org#26044,"CIPETE UTARA, KEBAYORAN BARU, JAKARTA SELATAN, DKI JAKARTA",108,113,87,200
https://kawalpemilu.org#26044,"CIPETE UTARA, KEBAYORAN BARU, JAKARTA SELATAN, DKI JAKARTA",109,94,131,225
https://kawalpemilu.org#26044,"CIPETE UTARA, KEBAYORAN BARU, JAKARTA SELATAN, DKI JAKARTA",110,75,139,214
https://kawalpemilu.org#26044,"CIPETE UTARA, KEBAYORAN BARU, JAKARTA SELATAN, DKI JAKARTA",111,100,108,208
https://kawalpemilu.org#26044,"CIPETE UTARA, KEBAYORAN BARU, JAKARTA SELATAN, DKI JAKARTA",112,101,124,225
https://kawalpemilu.org#26044,"CIPETE UTARA, KEBAYORAN BARU, JAKARTA SELATAN, DKI JAKARTA",113,128,95,223
https://kawalpemilu.org#26044,"CIPETE UTARA, KEBAYORAN BARU, JAKARTA SELATAN, DKI JAKARTA",114,107,116,223
https://kawalpemilu.org#26044,"CIPETE UTARA, KEBAYORAN BARU, JAKARTA SELATAN, DKI JAKARTA",115,125,100,225
https://kawalpemilu.org#26044,"CIPETE UTARA, KEBAYORAN BARU, JAKARTA SELATAN, DKI JAKARTA",116,90,80,170
https://kawalpemilu.org#26044,"CIPETE UTARA, KEBAYORAN BARU, JAKARTA SELATAN, DKI JAKARTA",117,68,109,177
https://kawalpemilu.org#26044,"CIPETE UTARA, KEBAYORAN BARU, JAKARTA SELATAN, DKI JAKARTA",118,70,118,188
https://kawalpemilu.org#26044,"CIPETE UTARA, KEBAYORAN BARU, JAKARTA SELATAN, DKI JAKARTA",119,87,133,220
https://kawalpemilu.org#26046,"PANCORAN, PANCORAN, JAKARTA SELATAN, DKI JAKARTA",1,104,78,182
https://kawalpemilu.org#26046,"PANCORAN, PANCORAN, JAKARTA SELATAN, DKI JAKARTA",2,59,182,241
https://kawalpemilu.org#26046,"PANCORAN, PANCORAN, JAKARTA SELATAN, DKI JAKARTA",3,78,185,263
https://kawalpemilu.org#26046,"PANCORAN, PANCORAN, JAKARTA SELATAN, DKI JAKARTA",4,70,192,262
https://kawalpemilu.org#26046,"PANCORAN, PANCORAN, JAKARTA SELATAN, DKI JAKARTA",5,83,167,250
https://kawalpemilu.org#26046,"PANCORAN, PANCORAN, JAKARTA SELATAN, DKI JAKARTA",6,90,173,263
https://kawalpemilu.org#26046,"PANCORAN, PANCORAN, JAKARTA SELATAN, DKI JAKARTA",7,62,205,267
https://kawalpemilu.org#26046,"PANCORAN, PANCORAN, JAKARTA SELATAN, DKI JAKARTA",8,69,123,192
https://kawalpemilu.org#26046,"PANCORAN, PANCORAN, JAKARTA SELATAN, DKI JAKARTA",9,39,156,195
https://kawalpemilu.org#26046,"PANCORAN, PANCORAN, JAKARTA SELATAN, DKI JAKARTA",10,65,151,216
https://kawalpemilu.org#26046,"PANCORAN, PANCORAN, JAKARTA SELATAN, DKI JAKARTA",11,76,160,236
https://kawalpemilu.org#26046,"PANCORAN, PANCORAN, JAKARTA SELATAN, DKI JAKARTA",12,68,156,224
https://kawalpemilu.org#26046,"PANCORAN, PANCORAN, JAKARTA SELATAN, DKI JAKARTA",13,97,140,237
https://kawalpemilu.org#26046,"PANCORAN, PANCORAN, JAKARTA SELATAN, DKI JAKARTA",14,63,162,225
https://kawalpemilu.org#26046,"PANCORAN, PANCORAN, JAKARTA SELATAN, DKI JAKARTA",15,126,130,256
https://kawalpemilu.org#26046,"PANCORAN, PANCORAN, JAKARTA SELATAN, DKI JAKARTA",16,196,72,268
https://kawalpemilu.org#26046,"PANCORAN, PANCORAN, JAKARTA SELATAN, DKI JAKARTA",17,132,92,224
https://kawalpemilu.org#26046,"PANCORAN, PANCORAN, JAKARTA SELATAN, DKI JAKARTA",18,66,101,167
https://kawalpemilu.org#26046,"PANCORAN, PANCORAN, JAKARTA SELATAN, DKI JAKARTA",19,100,100,200
https://kawalpemilu.org#26046,"PANCORAN, PANCORAN, JAKARTA SELATAN, DKI JAKARTA",20,203,69,272
https://kawalpemilu.org#26046,"PANCORAN, PANCORAN, JAKARTA SELATAN, DKI JAKARTA",21,92,143,235
https://kawalpemilu.org#26046,"PANCORAN, PANCORAN, JAKARTA SELATAN, DKI JAKARTA",22,67,142,209
https://kawalpemilu.org#26046,"PANCORAN, PANCORAN, JAKARTA SELATAN, DKI JAKARTA",23,84,177,261
https://kawalpemilu.org#26046,"PANCORAN, PANCORAN, JAKARTA SELATAN, DKI JAKARTA",24,36,175,211
https://kawalpemilu.org#26046,"PANCORAN, PANCORAN, JAKARTA SELATAN, DKI JAKARTA",25,45,166,211
https://kawalpemilu.org#26046,"PANCORAN, PANCORAN, JAKARTA SELATAN, DKI JAKARTA",26,57,145,202
https://kawalpemilu.org#26046,"PANCORAN, PANCORAN, JAKARTA SELATAN, DKI JAKARTA",27,89,159,248
https://kawalpemilu.org#26046,"PANCORAN, PANCORAN, JAKARTA SELATAN, DKI JAKARTA",28,94,138,232
https://kawalpemilu.org#26046,"PANCORAN, PANCORAN, JAKARTA SELATAN, DKI JAKARTA",29,74,156,230
https://kawalpemilu.org#26046,"PANCORAN, PANCORAN, JAKARTA SELATAN, DKI JAKARTA",30,73,141,214
https://kawalpemilu.org#26046,"PANCORAN, PANCORAN, JAKARTA SELATAN, DKI JAKARTA",31,86,129,215
https://kawalpemilu.org#26046,"PANCORAN, PANCORAN, JAKARTA SELATAN, DKI JAKARTA",32,70,193,263
https://kawalpemilu.org#26046,"PANCORAN, PANCORAN, JAKARTA SELATAN, DKI JAKARTA",33,79,199,278
https://kawalpemilu.org#26046,"PANCORAN, PANCORAN, JAKARTA SELATAN, DKI JAKARTA",34,85,161,246
https://kawalpemilu.org#26046,"PANCORAN, PANCORAN, JAKARTA SELATAN, DKI JAKARTA",35,70,164,234
https://kawalpemilu.org#26046,"PANCORAN, PANCORAN, JAKARTA SELATAN, DKI JAKARTA",36,77,153,230
https://kawalpemilu.org#26046,"PANCORAN, PANCORAN, JAKARTA SELATAN, DKI JAKARTA",37,43,174,217
https://kawalpemilu.org#26046,"PANCORAN, PANCORAN, JAKARTA SELATAN, DKI JAKARTA",38,78,176,254
https://kawalpemilu.org#26046,"PANCORAN, PANCORAN, JAKARTA SELATAN, DKI JAKARTA",39,158,93,251
https://kawalpemilu.org#26046,"PANCORAN, PANCORAN, JAKARTA SELATAN, DKI JAKARTA",40,121,135,256
https://kawalpemilu.org#26046,"PANCORAN, PANCORAN, JAKARTA SELATAN, DKI JAKARTA",41,71,143,214
https://kawalpemilu.org#26046,"PANCORAN, PANCORAN, JAKARTA SELATAN, DKI JAKARTA",42,89,155,244
https://kawalpemilu.org#26046,"PANCORAN, PANCORAN, JAKARTA SELATAN, DKI JAKARTA",43,92,91,183
https://kawalpemilu.org#26046,"PANCORAN, PANCORAN, JAKARTA SELATAN, DKI JAKARTA",44,92,145,237
https://kawalpemilu.org#26046,"PANCORAN, PANCORAN, JAKARTA SELATAN, DKI JAKARTA",45,80,146,226
https://kawalpemilu.org#26046,"PANCORAN, PANCORAN, JAKARTA SELATAN, DKI JAKARTA",46,82,159,241
https://kawalpemilu.org#26046,"PANCORAN, PANCORAN, JAKARTA SELATAN, DKI JAKARTA",47,71,141,212
https://kawalpemilu.org#26046,"PANCORAN, PANCORAN, JAKARTA SELATAN, DKI JAKARTA",48,63,198,261
https://kawalpemilu.org#26046,"PANCORAN, PANCORAN, JAKARTA SELATAN, DKI JAKARTA",49,46,159,205
https://kawalpemilu.org#26046,"PANCORAN, PANCORAN, JAKARTA SELATAN, DKI JAKARTA",50,51,133,184
https://kawalpemilu.org#26046,"PANCORAN, PANCORAN, JAKARTA SELATAN, DKI JAKARTA",51,100,170,270
https://kawalpemilu.org#26046,"PANCORAN, PANCORAN, JAKARTA SELATAN, DKI JAKARTA",52,58,191,249
https://kawalpemilu.org#26046,"PANCORAN, PANCORAN, JAKARTA SELATAN, DKI JAKARTA",54,71,144,215
https://kawalpemilu.org#26046,"PANCORAN, PANCORAN, JAKARTA SELATAN, DKI JAKARTA",55,49,166,215
https://kawalpemilu.org#26046,"PANCORAN, PANCORAN, JAKARTA SELATAN, DKI JAKARTA",56,61,155,216
https://kawalpemilu.org#26046,"PANCORAN, PANCORAN, JAKARTA SELATAN, DKI JAKARTA",57,69,137,206
https://kawalpemilu.org#26046,"PANCORAN, PANCORAN, JAKARTA SELATAN, DKI JAKARTA",58,101,147,248
https://kawalpemilu.org#26046,"PANCORAN, PANCORAN, JAKARTA SELATAN, DKI JAKARTA",59,53,152,205
https://kawalpemilu.org#26046,"PANCORAN, PANCORAN, JAKARTA SELATAN, DKI JAKARTA",60,62,159,221
https://kawalpemilu.org#26046,"PANCORAN, PANCORAN, JAKARTA SELATAN, DKI JAKARTA",61,77,187,264
https://kawalpemilu.org#26046,"PANCORAN, PANCORAN, JAKARTA SELATAN, DKI JAKARTA",62,109,125,234
https://kawalpemilu.org#26046,"PANCORAN, PANCORAN, JAKARTA SELATAN, DKI JAKARTA",63,59,120,179
https://kawalpemilu.org#26046,"PANCORAN, PANCORAN, JAKARTA SELATAN, DKI JAKARTA",64,119,84,203
https://kawalpemilu.org#26047,"KALIBATA, PANCORAN, JAKARTA SELATAN, DKI JAKARTA",1,93,127,220
https://kawalpemilu.org#26047,"KALIBATA, PANCORAN, JAKARTA SELATAN, DKI JAKARTA",2,90,174,264
https://kawalpemilu.org#26047,"KALIBATA, PANCORAN, JAKARTA SELATAN, DKI JAKARTA",3,95,156,251
https://kawalpemilu.org#26047,"KALIBATA, PANCORAN, JAKARTA SELATAN, DKI JAKARTA",4,97,145,242
https://kawalpemilu.org#26047,"KALIBATA, PANCORAN, JAKARTA SELATAN, DKI JAKARTA",5,76,127,203
https://kawalpemilu.org#26047,"KALIBATA, PANCORAN, JAKARTA SELATAN, DKI JAKARTA",6,56,170,226
https://kawalpemilu.org#26047,"KALIBATA, PANCORAN, JAKARTA SELATAN, DKI JAKARTA",7,87,93,180
https://kawalpemilu.org#26047,"KALIBATA, PANCORAN, JAKARTA SELATAN, DKI JAKARTA",8,93,142,235
https://kawalpemilu.org#26047,"KALIBATA, PANCORAN, JAKARTA SELATAN, DKI JAKARTA",9,71,122,193
https://kawalpemilu.org#26047,"KALIBATA, PANCORAN, JAKARTA SELATAN, DKI JAKARTA",10,74,131,205
https://kawalpemilu.org#26047,"KALIBATA, PANCORAN, JAKARTA SELATAN, DKI JAKARTA",11,80,181,261
https://kawalpemilu.org#26047,"KALIBATA, PANCORAN, JAKARTA SELATAN, DKI JAKARTA",12,82,173,255
https://kawalpemilu.org#26047,"KALIBATA, PANCORAN, JAKARTA SELATAN, DKI JAKARTA",13,94,163,257
https://kawalpemilu.org#26047,"KALIBATA, PANCORAN, JAKARTA SELATAN, DKI JAKARTA",14,88,172,260
https://kawalpemilu.org#26047,"KALIBATA, PANCORAN, JAKARTA SELATAN, DKI JAKARTA",15,92,137,229
https://kawalpemilu.org#26047,"KALIBATA, PANCORAN, JAKARTA SELATAN, DKI JAKARTA",16,108,146,254
https://kawalpemilu.org#26047,"KALIBATA, PANCORAN, JAKARTA SELATAN, DKI JAKARTA",17,109,166,275
https://kawalpemilu.org#26047,"KALIBATA, PANCORAN, JAKARTA SELATAN, DKI JAKARTA",18,78,143,221
https://kawalpemilu.org#26047,"KALIBATA, PANCORAN, JAKARTA SELATAN, DKI JAKARTA",19,107,135,242
https://kawalpemilu.org#26047,"KALIBATA, PANCORAN, JAKARTA SELATAN, DKI JAKARTA",20,101,135,236
https://kawalpemilu.org#26047,"KALIBATA, PANCORAN, JAKARTA SELATAN, DKI JAKARTA",21,103,174,277
https://kawalpemilu.org#26047,"KALIBATA, PANCORAN, JAKARTA SELATAN, DKI JAKARTA",22,77,162,239
https://kawalpemilu.org#26047,"KALIBATA, PANCORAN, JAKARTA SELATAN, DKI JAKARTA",23,77,183,260
https://kawalpemilu.org#26047,"KALIBATA, PANCORAN, JAKARTA SELATAN, DKI JAKARTA",24,72,172,244
https://kawalpemilu.org#26047,"KALIBATA, PANCORAN, JAKARTA SELATAN, DKI JAKARTA",25,106,142,248
https://kawalpemilu.org#26047,"KALIBATA, PANCORAN, JAKARTA SELATAN, DKI JAKARTA",26,59,185,244
https://kawalpemilu.org#26047,"KALIBATA, PANCORAN, JAKARTA SELATAN, DKI JAKARTA",27,61,186,247
https://kawalpemilu.org#26047,"KALIBATA, PANCORAN, JAKARTA SELATAN, DKI JAKARTA",28,88,167,255
https://kawalpemilu.org#26047,"KALIBATA, PANCORAN, JAKARTA SELATAN, DKI JAKARTA",29,46,143,189
https://kawalpemilu.org#26047,"KALIBATA, PANCORAN, JAKARTA SELATAN, DKI JAKARTA",30,64,119,183
https://kawalpemilu.org#26047,"KALIBATA, PANCORAN, JAKARTA SELATAN, DKI JAKARTA",31,107,114,221
https://kawalpemilu.org#26047,"KALIBATA, PANCORAN, JAKARTA SELATAN, DKI JAKARTA",32,140,100,240
https://kawalpemilu.org#26047,"KALIBATA, PANCORAN, JAKARTA SELATAN, DKI JAKARTA",33,59,162,221
https://kawalpemilu.org#26047,"KALIBATA, PANCORAN, JAKARTA SELATAN, DKI JAKARTA",34,44,202,246
https://kawalpemilu.org#26047,"KALIBATA, PANCORAN, JAKARTA SELATAN, DKI JAKARTA",35,132,36,168
https://kawalpemilu.org#26047,"KALIBATA, PANCORAN, JAKARTA SELATAN, DKI JAKARTA",36,60,190,250
https://kawalpemilu.org#26047,"KALIBATA, PANCORAN, JAKARTA SELATAN, DKI JAKARTA",37,59,148,207
https://kawalpemilu.org#26047,"KALIBATA, PANCORAN, JAKARTA SELATAN, DKI JAKARTA",38,77,143,220
https://kawalpemilu.org#26047,"KALIBATA, PANCORAN, JAKARTA SELATAN, DKI JAKARTA",39,85,146,231
https://kawalpemilu.org#26047,"KALIBATA, PANCORAN, JAKARTA SELATAN, DKI JAKARTA",40,74,148,222
https://kawalpemilu.org#26047,"KALIBATA, PANCORAN, JAKARTA SELATAN, DKI JAKARTA",41,89,137,226
https://kawalpemilu.org#26047,"KALIBATA, PANCORAN, JAKARTA SELATAN, DKI JAKARTA",42,98,156,254
https://kawalpemilu.org#26047,"KALIBATA, PANCORAN, JAKARTA SELATAN, DKI JAKARTA",43,78,125,0
https://kawalpemilu.org#26047,"KALIBATA, PANCORAN, JAKARTA SELATAN, DKI JAKARTA",44,47,208,255
https://kawalpemilu.org#26047,"KALIBATA, PANCORAN, JAKARTA SELATAN, DKI JAKARTA",45,54,171,225
https://kawalpemilu.org#26047,"KALIBATA, PANCORAN, JAKARTA SELATAN, DKI JAKARTA",46,61,124,185
https://kawalpemilu.org#26047,"KALIBATA, PANCORAN, JAKARTA SELATAN, DKI JAKARTA",47,54,120,174
https://kawalpemilu.org#26047,"KALIBATA, PANCORAN, JAKARTA SELATAN, DKI JAKARTA",48,66,132,198
https://kawalpemilu.org#26047,"KALIBATA, PANCORAN, JAKARTA SELATAN, DKI JAKARTA",49,68,150,218
https://kawalpemilu.org#26047,"KALIBATA, PANCORAN, JAKARTA SELATAN, DKI JAKARTA",50,59,126,185
https://kawalpemilu.org#26047,"KALIBATA, PANCORAN, JAKARTA SELATAN, DKI JAKARTA",51,67,174,241
https://kawalpemilu.org#26047,"KALIBATA, PANCORAN, JAKARTA SELATAN, DKI JAKARTA",52,159,61,220
https://kawalpemilu.org#26047,"KALIBATA, PANCORAN, JAKARTA SELATAN, DKI JAKARTA",53,136,66,202
https://kawalpemilu.org#26047,"KALIBATA, PANCORAN, JAKARTA SELATAN, DKI JAKARTA",54,109,73,182
https://kawalpemilu.org#26047,"KALIBATA, PANCORAN, JAKARTA SELATAN, DKI JAKARTA",55,57,166,223
https://kawalpemilu.org#26047,"KALIBATA, PANCORAN, JAKARTA SELATAN, DKI JAKARTA",56,33,145,178
https://kawalpemilu.org#26047,"KALIBATA, PANCORAN, JAKARTA SELATAN, DKI JAKARTA",57,68,167,235
https://kawalpemilu.org#26047,"KALIBATA, PANCORAN, JAKARTA SELATAN, DKI JAKARTA",58,45,216,261
https://kawalpemilu.org#26047,"KALIBATA, PANCORAN, JAKARTA SELATAN, DKI JAKARTA",59,54,154,208
https://kawalpemilu.org#26047,"KALIBATA, PANCORAN, JAKARTA SELATAN, DKI JAKARTA",60,22,193,215
https://kawalpemilu.org#26047,"KALIBATA, PANCORAN, JAKARTA SELATAN, DKI JAKARTA",61,23,206,229
https://kawalpemilu.org#26047,"KALIBATA, PANCORAN, JAKARTA SELATAN, DKI JAKARTA",62,21,203,224
https://kawalpemilu.org#26047,"KALIBATA, PANCORAN, JAKARTA SELATAN, DKI JAKARTA",63,39,233,272
https://kawalpemilu.org#26047,"KALIBATA, PANCORAN, JAKARTA SELATAN, DKI JAKARTA",64,40,231,271
https://kawalpemilu.org#26047,"KALIBATA, PANCORAN, JAKARTA SELATAN, DKI JAKARTA",65,48,224,272
https://kawalpemilu.org#26047,"KALIBATA, PANCORAN, JAKARTA SELATAN, DKI JAKARTA",66,36,215,251
https://kawalpemilu.org#26047,"KALIBATA, PANCORAN, JAKARTA SELATAN, DKI JAKARTA",67,30,210,240
https://kawalpemilu.org#26047,"KALIBATA, PANCORAN, JAKARTA SELATAN, DKI JAKARTA",68,58,149,207
https://kawalpemilu.org#26047,"KALIBATA, PANCORAN, JAKARTA SELATAN, DKI JAKARTA",69,58,179,237
https://kawalpemilu.org#26047,"KALIBATA, PANCORAN, JAKARTA SELATAN, DKI JAKARTA",70,56,171,227
https://kawalpemilu.org#26047,"KALIBATA, PANCORAN, JAKARTA SELATAN, DKI JAKARTA",71,59,185,244
https://kawalpemilu.org#26047,"KALIBATA, PANCORAN, JAKARTA SELATAN, DKI JAKARTA",72,39,191,230
https://kawalpemilu.org#26047,"KALIBATA, PANCORAN, JAKARTA SELATAN, DKI JAKARTA",73,47,171,218
https://kawalpemilu.org#26047,"KALIBATA, PANCORAN, JAKARTA SELATAN, DKI JAKARTA",74,40,162,202
https://kawalpemilu.org#26047,"KALIBATA, PANCORAN, JAKARTA SELATAN, DKI JAKARTA",75,50,207,257
https://kawalpemilu.org#26047,"KALIBATA, PANCORAN, JAKARTA SELATAN, DKI JAKARTA",76,42,196,238
https://kawalpemilu.org#26047,"KALIBATA, PANCORAN, JAKARTA SELATAN, DKI JAKARTA",77,45,183,228
https://kawalpemilu.org#26047,"KALIBATA, PANCORAN, JAKARTA SELATAN, DKI JAKARTA",78,58,179,237
https://kawalpemilu.org#26047,"KALIBATA, PANCORAN, JAKARTA SELATAN, DKI JAKARTA",79,103,136,239
https://kawalpemilu.org#26047,"KALIBATA, PANCORAN, JAKARTA SELATAN, DKI JAKARTA",80,118,95,213
https://kawalpemilu.org#26047,"KALIBATA, PANCORAN, JAKARTA SELATAN, DKI JAKARTA",81,75,160,235
https://kawalpemilu.org#26047,"KALIBATA, PANCORAN, JAKARTA SELATAN, DKI JAKARTA",82,129,100,229
https://kawalpemilu.org#26047,"KALIBATA, PANCORAN, JAKARTA SELATAN, DKI JAKARTA",83,89,138,227
https://kawalpemilu.org#26047,"KALIBATA, PANCORAN, JAKARTA SELATAN, DKI JAKARTA",84,96,141,237
https://kawalpemilu.org#26047,"KALIBATA, PANCORAN, JAKARTA SELATAN, DKI JAKARTA",85,88,143,231
https://kawalpemilu.org#26047,"KALIBATA, PANCORAN, JAKARTA SELATAN, DKI JAKARTA",86,91,158,249
https://kawalpemilu.org#26047,"KALIBATA, PANCORAN, JAKARTA SELATAN, DKI JAKARTA",87,134,103,237
https://kawalpemilu.org#26047,"KALIBATA, PANCORAN, JAKARTA SELATAN, DKI JAKARTA",88,102,141,243
https://kawalpemilu.org#26047,"KALIBATA, PANCORAN, JAKARTA SELATAN, DKI JAKARTA",89,86,154,240
https://kawalpemilu.org#26047,"KALIBATA, PANCORAN, JAKARTA SELATAN, DKI JAKARTA",90,98,153,251
https://kawalpemilu.org#26047,"KALIBATA, PANCORAN, JAKARTA SELATAN, DKI JAKARTA",91,62,165,227
https://kawalpemilu.org#26047,"KALIBATA, PANCORAN, JAKARTA SELATAN, DKI JAKARTA",92,57,150,207
https://kawalpemilu.org#26047,"KALIBATA, PANCORAN, JAKARTA SELATAN, DKI JAKARTA",93,101,187,288
https://kawalpemilu.org#26047,"KALIBATA, PANCORAN, JAKARTA SELATAN, DKI JAKARTA",94,81,139,220
https://kawalpemilu.org#26047,"KALIBATA, PANCORAN, JAKARTA SELATAN, DKI JAKARTA",95,75,189,264
https://kawalpemilu.org#26047,"KALIBATA, PANCORAN, JAKARTA SELATAN, DKI JAKARTA",96,68,113,181
https://kawalpemilu.org#26047,"KALIBATA, PANCORAN, JAKARTA SELATAN, DKI JAKARTA",97,78,176,254
https://kawalpemilu.org#26047,"KALIBATA, PANCORAN, JAKARTA SELATAN, DKI JAKARTA",98,127,115,242
https://kawalpemilu.org#26047,"KALIBATA, PANCORAN, JAKARTA SELATAN, DKI JAKARTA",99,71,107,178
https://kawalpemilu.org#26047,"KALIBATA, PANCORAN, JAKARTA SELATAN, DKI JAKARTA",100,79,139,218
https://kawalpemilu.org#26047,"KALIBATA, PANCORAN, JAKARTA SELATAN, DKI JAKARTA",101,96,114,210
https://kawalpemilu.org#26047,"KALIBATA, PANCORAN, JAKARTA SELATAN, DKI JAKARTA",102,72,136,208
https://kawalpemilu.org#26047,"KALIBATA, PANCORAN, JAKARTA SELATAN, DKI JAKARTA",103,105,112,217
https://kawalpemilu.org#26047,"KALIBATA, PANCORAN, JAKARTA SELATAN, DKI JAKARTA",104,102,174,276
https://kawalpemilu.org#26047,"KALIBATA, PANCORAN, JAKARTA SELATAN, DKI JAKARTA",105,74,118,192
https://kawalpemilu.org#26047,"KALIBATA, PANCORAN, JAKARTA SELATAN, DKI JAKARTA",106,107,168,275
https://kawalpemilu.org#26047,"KALIBATA, PANCORAN, JAKARTA SELATAN, DKI JAKARTA",107,75,178,253
https://kawalpemilu.org#26047,"KALIBATA, PANCORAN, JAKARTA SELATAN, DKI JAKARTA",108,90,177,267
https://kawalpemilu.org#26047,"KALIBATA, PANCORAN, JAKARTA SELATAN, DKI JAKARTA",109,89,128,217
https://kawalpemilu.org#26047,"KALIBATA, PANCORAN, JAKARTA SELATAN, DKI JAKARTA",110,117,94,211
https://kawalpemilu.org#26047,"KALIBATA, PANCORAN, JAKARTA SELATAN, DKI JAKARTA",111,78,105,183
https://kawalpemilu.org#26047,"KALIBATA, PANCORAN, JAKARTA SELATAN, DKI JAKARTA",112,82,96,178
https://kawalpemilu.org#26047,"KALIBATA, PANCORAN, JAKARTA SELATAN, DKI JAKARTA",113,67,152,219
https://kawalpemilu.org#26047,"KALIBATA, PANCORAN, JAKARTA SELATAN, DKI JAKARTA",114,54,182,236
https://kawalpemilu.org#26047,"KALIBATA, PANCORAN, JAKARTA SELATAN, DKI JAKARTA",115,52,180,232
https://kawalpemilu.org#26047,"KALIBATA, PANCORAN, JAKARTA SELATAN, DKI JAKARTA",116,63,189,252
https://kawalpemilu.org#26047,"KALIBATA, PANCORAN, JAKARTA SELATAN, DKI JAKARTA",117,51,184,235
https://kawalpemilu.org#26047,"KALIBATA, PANCORAN, JAKARTA SELATAN, DKI JAKARTA",118,51,203,254
https://kawalpemilu.org#26047,"KALIBATA, PANCORAN, JAKARTA SELATAN, DKI JAKARTA",119,89,146,235
https://kawalpemilu.org#26047,"KALIBATA, PANCORAN, JAKARTA SELATAN, DKI JAKARTA",120,87,88,175
https://kawalpemilu.org#26047,"KALIBATA, PANCORAN, JAKARTA SELATAN, DKI JAKARTA",121,72,169,241
https://kawalpemilu.org#26047,"KALIBATA, PANCORAN, JAKARTA SELATAN, DKI JAKARTA",122,54,139,193
https://kawalpemilu.org#26047,"KALIBATA, PANCORAN, JAKARTA SELATAN, DKI JAKARTA",123,60,219,279
https://kawalpemilu.org#26047,"KALIBATA, PANCORAN, JAKARTA SELATAN, DKI JAKARTA",124,56,187,243
https://kawalpemilu.org#26047,"KALIBATA, PANCORAN, JAKARTA SELATAN, DKI JAKARTA",125,101,101,202
https://kawalpemilu.org#26047,"KALIBATA, PANCORAN, JAKARTA SELATAN, DKI JAKARTA",126,100,118,218
https://kawalpemilu.org#26047,"KALIBATA, PANCORAN, JAKARTA SELATAN, DKI JAKARTA",127,98,98,196
https://kawalpemilu.org#26047,"KALIBATA, PANCORAN, JAKARTA SELATAN, DKI JAKARTA",128,97,140,237
https://kawalpemilu.org#26047,"KALIBATA, PANCORAN, JAKARTA SELATAN, DKI JAKARTA",129,123,121,244
https://kawalpemilu.org#26047,"KALIBATA, PANCORAN, JAKARTA SELATAN, DKI JAKARTA",130,77,129,206
https://kawalpemilu.org#26047,"KALIBATA, PANCORAN, JAKARTA SELATAN, DKI JAKARTA",131,122,141,263
https://kawalpemilu.org#26047,"KALIBATA, PANCORAN, JAKARTA SELATAN, DKI JAKARTA",132,43,133,156
https://kawalpemilu.org#26047,"KALIBATA, PANCORAN, JAKARTA SELATAN, DKI JAKARTA",133,61,134,195
https://kawalpemilu.org#26047,"KALIBATA, PANCORAN, JAKARTA SELATAN, DKI JAKARTA",134,69,108,177
https://kawalpemilu.org#26047,"KALIBATA, PANCORAN, JAKARTA SELATAN, DKI JAKARTA",135,126,37,163
https://kawalpemilu.org#26047,"KALIBATA, PANCORAN, JAKARTA SELATAN, DKI JAKARTA",136,90,72,162
https://kawalpemilu.org#26047,"KALIBATA, PANCORAN, JAKARTA SELATAN, DKI JAKARTA",137,17,127,144
https://kawalpemilu.org#26047,"KALIBATA, PANCORAN, JAKARTA SELATAN, DKI JAKARTA",138,63,99,162
https://kawalpemilu.org#26048,"RAWAJATI, PANCORAN, JAKARTA SELATAN, DKI JAKARTA",1,93,107,200
https://kawalpemilu.org#26048,"RAWAJATI, PANCORAN, JAKARTA SELATAN, DKI JAKARTA",2,73,149,222
https://kawalpemilu.org#26048,"RAWAJATI, PANCORAN, JAKARTA SELATAN, DKI JAKARTA",3,80,134,214
https://kawalpemilu.org#26048,"RAWAJATI, PANCORAN, JAKARTA SELATAN, DKI JAKARTA",4,52,141,193
https://kawalpemilu.org#26048,"RAWAJATI, PANCORAN, JAKARTA SELATAN, DKI JAKARTA",5,53,208,261
https://kawalpemilu.org#26048,"RAWAJATI, PANCORAN, JAKARTA SELATAN, DKI JAKARTA",6,73,182,255
https://kawalpemilu.org#26048,"RAWAJATI, PANCORAN, JAKARTA SELATAN, DKI JAKARTA",7,78,159,237
https://kawalpemilu.org#26048,"RAWAJATI, PANCORAN, JAKARTA SELATAN, DKI JAKARTA",8,98,112,210
https://kawalpemilu.org#26048,"RAWAJATI, PANCORAN, JAKARTA SELATAN, DKI JAKARTA",9,91,154,245
https://kawalpemilu.org#26048,"RAWAJATI, PANCORAN, JAKARTA SELATAN, DKI JAKARTA",10,103,130,233
https://kawalpemilu.org#26048,"RAWAJATI, PANCORAN, JAKARTA SELATAN, DKI JAKARTA",11,83,114,197
https://kawalpemilu.org#26048,"RAWAJATI, PANCORAN, JAKARTA SELATAN, DKI JAKARTA",12,88,147,235
https://kawalpemilu.org#26048,"RAWAJATI, PANCORAN, JAKARTA SELATAN, DKI JAKARTA",13,60,179,239
https://kawalpemilu.org#26048,"RAWAJATI, PANCORAN, JAKARTA SELATAN, DKI JAKARTA",14,106,111,217
https://kawalpemilu.org#26048,"RAWAJATI, PANCORAN, JAKARTA SELATAN, DKI JAKARTA",15,101,117,218
https://kawalpemilu.org#26048,"RAWAJATI, PANCORAN, JAKARTA SELATAN, DKI JAKARTA",16,77,116,193
https://kawalpemilu.org#26048,"RAWAJATI, PANCORAN, JAKARTA SELATAN, DKI JAKARTA",17,83,102,185
https://kawalpemilu.org#26048,"RAWAJATI, PANCORAN, JAKARTA SELATAN, DKI JAKARTA",18,81,96,177
https://kawalpemilu.org#26048,"RAWAJATI, PANCORAN, JAKARTA SELATAN, DKI JAKARTA",19,83,114,197
https://kawalpemilu.org#26048,"RAWAJATI, PANCORAN, JAKARTA SELATAN, DKI JAKARTA",20,76,160,236
https://kawalpemilu.org#26048,"RAWAJATI, PANCORAN, JAKARTA SELATAN, DKI JAKARTA",21,59,181,240
https://kawalpemilu.org#26048,"RAWAJATI, PANCORAN, JAKARTA SELATAN, DKI JAKARTA",22,105,100,205
https://kawalpemilu.org#26048,"RAWAJATI, PANCORAN, JAKARTA SELATAN, DKI JAKARTA",23,80,128,208
https://kawalpemilu.org#26048,"RAWAJATI, PANCORAN, JAKARTA SELATAN, DKI JAKARTA",24,78,97,175
https://kawalpemilu.org#26048,"RAWAJATI, PANCORAN, JAKARTA SELATAN, DKI JAKARTA",25,117,110,227
https://kawalpemilu.org#26048,"RAWAJATI, PANCORAN, JAKARTA SELATAN, DKI JAKARTA",26,91,91,182
https://kawalpemilu.org#26048,"RAWAJATI, PANCORAN, JAKARTA SELATAN, DKI JAKARTA",27,63,214,277
https://kawalpemilu.org#26048,"RAWAJATI, PANCORAN, JAKARTA SELATAN, DKI JAKARTA",28,87,170,257
https://kawalpemilu.org#26048,"RAWAJATI, PANCORAN, JAKARTA SELATAN, DKI JAKARTA",29,85,120,205
https://kawalpemilu.org#26048,"RAWAJATI, PANCORAN, JAKARTA SELATAN, DKI JAKARTA",30,79,95,174
https://kawalpemilu.org#26048,"RAWAJATI, PANCORAN, JAKARTA SELATAN, DKI JAKARTA",31,85,157,242
https://kawalpemilu.org#26048,"RAWAJATI, PANCORAN, JAKARTA SELATAN, DKI JAKARTA",32,75,143,218
https://kawalpemilu.org#26048,"RAWAJATI, PANCORAN, JAKARTA SELATAN, DKI JAKARTA",33,94,108,2
https://kawalpemilu.org#26048,"RAWAJATI, PANCORAN, JAKARTA SELATAN, DKI JAKARTA",34,89,140,229
https://kawalpemilu.org#26048,"RAWAJATI, PANCORAN, JAKARTA SELATAN, DKI JAKARTA",35,115,130,245
https://kawalpemilu.org#26048,"RAWAJATI, PANCORAN, JAKARTA SELATAN, DKI JAKARTA",36,103,110,213
https://kawalpemilu.org#26048,"RAWAJATI, PANCORAN, JAKARTA SELATAN, DKI JAKARTA",37,99,64,163
https://kawalpemilu.org#26048,"RAWAJATI, PANCORAN, JAKARTA SELATAN, DKI JAKARTA",38,86,161,247
https://kawalpemilu.org#26048,"RAWAJATI, PANCORAN, JAKARTA SELATAN, DKI JAKARTA",39,78,137,215
https://kawalpemilu.org#26048,"RAWAJATI, PANCORAN, JAKARTA SELATAN, DKI JAKARTA",40,90,137,227
https://kawalpemilu.org#26048,"RAWAJATI, PANCORAN, JAKARTA SELATAN, DKI JAKARTA",41,98,161,259
https://kawalpemilu.org#26048,"RAWAJATI, PANCORAN, JAKARTA SELATAN, DKI JAKARTA",42,48,36,84
https://kawalpemilu.org#26048,"RAWAJATI, PANCORAN, JAKARTA SELATAN, DKI JAKARTA",43,63,69,132
https://kawalpemilu.org#26048,"RAWAJATI, PANCORAN, JAKARTA SELATAN, DKI JAKARTA",44,48,41,89
https://kawalpemilu.org#26048,"RAWAJATI, PANCORAN, JAKARTA SELATAN, DKI JAKARTA",45,161,73,234
https://kawalpemilu.org#26048,"RAWAJATI, PANCORAN, JAKARTA SELATAN, DKI JAKARTA",46,140,73,213
https://kawalpemilu.org#26048,"RAWAJATI, PANCORAN, JAKARTA SELATAN, DKI JAKARTA",47,152,62,214
https://kawalpemilu.org#26048,"RAWAJATI, PANCORAN, JAKARTA SELATAN, DKI JAKARTA",48,117,77,194
https://kawalpemilu.org#26048,"RAWAJATI, PANCORAN, JAKARTA SELATAN, DKI JAKARTA",49,135,91,226
https://kawalpemilu.org#26048,"RAWAJATI, PANCORAN, JAKARTA SELATAN, DKI JAKARTA",50,61,140,201
https://kawalpemilu.org#26048,"RAWAJATI, PANCORAN, JAKARTA SELATAN, DKI JAKARTA",51,56,151,207
https://kawalpemilu.org#26048,"RAWAJATI, PANCORAN, JAKARTA SELATAN, DKI JAKARTA",52,75,139,214
https://kawalpemilu.org#26048,"RAWAJATI, PANCORAN, JAKARTA SELATAN, DKI JAKARTA",53,66,106,172
https://kawalpemilu.org#26048,"RAWAJATI, PANCORAN, JAKARTA SELATAN, DKI JAKARTA",54,81,150,231
https://kawalpemilu.org#26048,"RAWAJATI, PANCORAN, JAKARTA SELATAN, DKI JAKARTA",55,117,100,217
https://kawalpemilu.org#26048,"RAWAJATI, PANCORAN, JAKARTA SELATAN, DKI JAKARTA",56,123,91,217
https://kawalpemilu.org#26048,"RAWAJATI, PANCORAN, JAKARTA SELATAN, DKI JAKARTA",57,94,111,205
https://kawalpemilu.org#26048,"RAWAJATI, PANCORAN, JAKARTA SELATAN, DKI JAKARTA",58,106,112,218
https://kawalpemilu.org#26048,"RAWAJATI, PANCORAN, JAKARTA SELATAN, DKI JAKARTA",59,147,56,203
https://kawalpemilu.org#26048,"RAWAJATI, PANCORAN, JAKARTA SELATAN, DKI JAKARTA",60,135,82,217
https://kawalpemilu.org#26048,"RAWAJATI, PANCORAN, JAKARTA SELATAN, DKI JAKARTA",61,129,101,230
https://kawalpemilu.org#26048,"RAWAJATI, PANCORAN, JAKARTA SELATAN, DKI JAKARTA",62,176,68,244
https://kawalpemilu.org#26048,"RAWAJATI, PANCORAN, JAKARTA SELATAN, DKI JAKARTA",63,142,71,213
https://kawalpemilu.org#26048,"RAWAJATI, PANCORAN, JAKARTA SELATAN, DKI JAKARTA",64,133,79,212
https://kawalpemilu.org#26048,"RAWAJATI, PANCORAN, JAKARTA SELATAN, DKI JAKARTA",65,139,76,215
https://kawalpemilu.org#26048,"RAWAJATI, PANCORAN, JAKARTA SELATAN, DKI JAKARTA",66,136,71,207
https://kawalpemilu.org#26048,"RAWAJATI, PANCORAN, JAKARTA SELATAN, DKI JAKARTA",67,139,85,224
https://kawalpemilu.org#26048,"RAWAJATI, PANCORAN, JAKARTA SELATAN, DKI JAKARTA",68,133,122,255
https://kawalpemilu.org#26048,"RAWAJATI, PANCORAN, JAKARTA SELATAN, DKI JAKARTA",69,155,49,204
https://kawalpemilu.org#26048,"RAWAJATI, PANCORAN, JAKARTA SELATAN, DKI JAKARTA",70,89,109,197
https://kawalpemilu.org#26048,"RAWAJATI, PANCORAN, JAKARTA SELATAN, DKI JAKARTA",71,207,112,319
https://kawalpemilu.org#26049,"DUREN TIGA, PANCORAN, JAKARTA SELATAN, DKI JAKARTA",2,76,123,199
https://kawalpemilu.org#26049,"DUREN TIGA, PANCORAN, JAKARTA SELATAN, DKI JAKARTA",3,68,101,169
https://kawalpemilu.org#26049,"DUREN TIGA, PANCORAN, JAKARTA SELATAN, DKI JAKARTA",4,71,88,159
https://kawalpemilu.org#26049,"DUREN TIGA, PANCORAN, JAKARTA SELATAN, DKI JAKARTA",5,67,116,183
https://kawalpemilu.org#26049,"DUREN TIGA, PANCORAN, JAKARTA SELATAN, DKI JAKARTA",6,139,36,175
https://kawalpemilu.org#26049,"DUREN TIGA, PANCORAN, JAKARTA SELATAN, DKI JAKARTA",7,102,111,213
https://kawalpemilu.org#26049,"DUREN TIGA, PANCORAN, JAKARTA SELATAN, DKI JAKARTA",8,90,124,214
https://kawalpemilu.org#26049,"DUREN TIGA, PANCORAN, JAKARTA SELATAN, DKI JAKARTA",9,60,140,200
https://kawalpemilu.org#26049,"DUREN TIGA, PANCORAN, JAKARTA SELATAN, DKI JAKARTA",10,112,71,183
https://kawalpemilu.org#26049,"DUREN TIGA, PANCORAN, JAKARTA SELATAN, DKI JAKARTA",11,166,98,264
https://kawalpemilu.org#26049,"DUREN TIGA, PANCORAN, JAKARTA SELATAN, DKI JAKARTA",12,95,107,202
https://kawalpemilu.org#26049,"DUREN TIGA, PANCORAN, JAKARTA SELATAN, DKI JAKARTA",13,60,131,191
https://kawalpemilu.org#26049,"DUREN TIGA, PANCORAN, JAKARTA SELATAN, DKI JAKARTA",14,87,107,194
https://kawalpemilu.org#26049,"DUREN TIGA, PANCORAN, JAKARTA SELATAN, DKI JAKARTA",15,69,187,256
https://kawalpemilu.org#26049,"DUREN TIGA, PANCORAN, JAKARTA SELATAN, DKI JAKARTA",16,81,146,227
https://kawalpemilu.org#26049,"DUREN TIGA, PANCORAN, JAKARTA SELATAN, DKI JAKARTA",17,70,179,249
https://kawalpemilu.org#26049,"DUREN TIGA, PANCORAN, JAKARTA SELATAN, DKI JAKARTA",18,78,135,213
https://kawalpemilu.org#26049,"DUREN TIGA, PANCORAN, JAKARTA SELATAN, DKI JAKARTA",19,60,142,202
https://kawalpemilu.org#26049,"DUREN TIGA, PANCORAN, JAKARTA SELATAN, DKI JAKARTA",20,66,121,187
https://kawalpemilu.org#26049,"DUREN TIGA, PANCORAN, JAKARTA SELATAN, DKI JAKARTA",21,55,166,221
https://kawalpemilu.org#26049,"DUREN TIGA, PANCORAN, JAKARTA SELATAN, DKI JAKARTA",22,87,125,212
https://kawalpemilu.org#26049,"DUREN TIGA, PANCORAN, JAKARTA SELATAN, DKI JAKARTA",23,83,104,187
https://kawalpemilu.org#26049,"DUREN TIGA, PANCORAN, JAKARTA SELATAN, DKI JAKARTA",24,73,88,161
https://kawalpemilu.org#26049,"DUREN TIGA, PANCORAN, JAKARTA SELATAN, DKI JAKARTA",25,103,141,244
https://kawalpemilu.org#26049,"DUREN TIGA, PANCORAN, JAKARTA SELATAN, DKI JAKARTA",26,91,142,233
https://kawalpemilu.org#26049,"DUREN TIGA, PANCORAN, JAKARTA SELATAN, DKI JAKARTA",27,80,78,158
https://kawalpemilu.org#26049,"DUREN TIGA, PANCORAN, JAKARTA SELATAN, DKI JAKARTA",28,113,93,206
https://kawalpemilu.org#26049,"DUREN TIGA, PANCORAN, JAKARTA SELATAN, DKI JAKARTA",29,123,82,205
https://kawalpemilu.org#26049,"DUREN TIGA, PANCORAN, JAKARTA SELATAN, DKI JAKARTA",30,105,92,197
https://kawalpemilu.org#26049,"DUREN TIGA, PANCORAN, JAKARTA SELATAN, DKI JAKARTA",31,118,129,247
https://kawalpemilu.org#26049,"DUREN TIGA, PANCORAN, JAKARTA SELATAN, DKI JAKARTA",32,113,98,211
https://kawalpemilu.org#26049,"DUREN TIGA, PANCORAN, JAKARTA SELATAN, DKI JAKARTA",33,112,128,240
https://kawalpemilu.org#26049,"DUREN TIGA, PANCORAN, JAKARTA SELATAN, DKI JAKARTA",34,82,124,206
https://kawalpemilu.org#26049,"DUREN TIGA, PANCORAN, JAKARTA SELATAN, DKI JAKARTA",35,97,146,243
https://kawalpemilu.org#26049,"DUREN TIGA, PANCORAN, JAKARTA SELATAN, DKI JAKARTA",36,137,76,213
https://kawalpemilu.org#26049,"DUREN TIGA, PANCORAN, JAKARTA SELATAN, DKI JAKARTA",37,123,111,234
https://kawalpemilu.org#26049,"DUREN TIGA, PANCORAN, JAKARTA SELATAN, DKI JAKARTA",38,102,176,278
https://kawalpemilu.org#26049,"DUREN TIGA, PANCORAN, JAKARTA SELATAN, DKI JAKARTA",39,71,142,213
https://kawalpemilu.org#26049,"DUREN TIGA, PANCORAN, JAKARTA SELATAN, DKI JAKARTA",40,77,128,205
https://kawalpemilu.org#26049,"DUREN TIGA, PANCORAN, JAKARTA SELATAN, DKI JAKARTA",41,136,126,262
https://kawalpemilu.org#26049,"DUREN TIGA, PANCORAN, JAKARTA SELATAN, DKI JAKARTA",42,148,95,243
https://kawalpemilu.org#26049,"DUREN TIGA, PANCORAN, JAKARTA SELATAN, DKI JAKARTA",43,68,130,198
https://kawalpemilu.org#26049,"DUREN TIGA, PANCORAN, JAKARTA SELATAN, DKI JAKARTA",44,95,112,207
https://kawalpemilu.org#26049,"DUREN TIGA, PANCORAN, JAKARTA SELATAN, DKI JAKARTA",45,109,110,219
https://kawalpemilu.org#26049,"DUREN TIGA, PANCORAN, JAKARTA SELATAN, DKI JAKARTA",46,82,129,211
https://kawalpemilu.org#26049,"DUREN TIGA, PANCORAN, JAKARTA SELATAN, DKI JAKARTA",47,102,68,170
https://kawalpemilu.org#26049,"DUREN TIGA, PANCORAN, JAKARTA SELATAN, DKI JAKARTA",48,83,84,167
https://kawalpemilu.org#26049,"DUREN TIGA, PANCORAN, JAKARTA SELATAN, DKI JAKARTA",49,85,158,243
https://kawalpemilu.org#26049,"DUREN TIGA, PANCORAN, JAKARTA SELATAN, DKI JAKARTA",50,91,149,240
https://kawalpemilu.org#26049,"DUREN TIGA, PANCORAN, JAKARTA SELATAN, DKI JAKARTA",51,87,140,227
https://kawalpemilu.org#26049,"DUREN TIGA, PANCORAN, JAKARTA SELATAN, DKI JAKARTA",52,128,50,178
https://kawalpemilu.org#26049,"DUREN TIGA, PANCORAN, JAKARTA SELATAN, DKI JAKARTA",53,135,62,197
https://kawalpemilu.org#26049,"DUREN TIGA, PANCORAN, JAKARTA SELATAN, DKI JAKARTA",54,99,58,157
https://kawalpemilu.org#26049,"DUREN TIGA, PANCORAN, JAKARTA SELATAN, DKI JAKARTA",55,99,101,200
https://kawalpemilu.org#26049,"DUREN TIGA, PANCORAN, JAKARTA SELATAN, DKI JAKARTA",56,73,67,140
https://kawalpemilu.org#26049,"DUREN TIGA, PANCORAN, JAKARTA SELATAN, DKI JAKARTA",57,163,80,243
https://kawalpemilu.org#26049,"DUREN TIGA, PANCORAN, JAKARTA SELATAN, DKI JAKARTA",58,151,61,212
https://kawalpemilu.org#26049,"DUREN TIGA, PANCORAN, JAKARTA SELATAN, DKI JAKARTA",59,125,105,230
https://kawalpemilu.org#26049,"DUREN TIGA, PANCORAN, JAKARTA SELATAN, DKI JAKARTA",60,118,93,211
https://kawalpemilu.org#26049,"DUREN TIGA, PANCORAN, JAKARTA SELATAN, DKI JAKARTA",61,124,131,255
https://kawalpemilu.org#26049,"DUREN TIGA, PANCORAN, JAKARTA SELATAN, DKI JAKARTA",62,57,86,143
https://kawalpemilu.org#26049,"DUREN TIGA, PANCORAN, JAKARTA SELATAN, DKI JAKARTA",63,43,182,225
https://kawalpemilu.org#26049,"DUREN TIGA, PANCORAN, JAKARTA SELATAN, DKI JAKARTA",64,80,189,269
https://kawalpemilu.org#26049,"DUREN TIGA, PANCORAN, JAKARTA SELATAN, DKI JAKARTA",65,76,152,228
https://kawalpemilu.org#26049,"DUREN TIGA, PANCORAN, JAKARTA SELATAN, DKI JAKARTA",66,70,173,243
https://kawalpemilu.org#26049,"DUREN TIGA, PANCORAN, JAKARTA SELATAN, DKI JAKARTA",67,67,159,226
https://kawalpemilu.org#26049,"DUREN TIGA, PANCORAN, JAKARTA SELATAN, DKI JAKARTA",68,66,174,240
https://kawalpemilu.org#26049,"DUREN TIGA, PANCORAN, JAKARTA SELATAN, DKI JAKARTA",69,66,180,246
https://kawalpemilu.org#26049,"DUREN TIGA, PANCORAN, JAKARTA SELATAN, DKI JAKARTA",70,88,137,225
https://kawalpemilu.org#26049,"DUREN TIGA, PANCORAN, JAKARTA SELATAN, DKI JAKARTA",71,66,181,247
https://kawalpemilu.org#26049,"DUREN TIGA, PANCORAN, JAKARTA SELATAN, DKI JAKARTA",72,93,78,171
https://kawalpemilu.org#26049,"DUREN TIGA, PANCORAN, JAKARTA SELATAN, DKI JAKARTA",73,75,96,171
https://kawalpemilu.org#26049,"DUREN TIGA, PANCORAN, JAKARTA SELATAN, DKI JAKARTA",74,77,134,211
https://kawalpemilu.org#26049,"DUREN TIGA, PANCORAN, JAKARTA SELATAN, DKI JAKARTA",75,116,94,210
https://kawalpemilu.org#26049,"DUREN TIGA, PANCORAN, JAKARTA SELATAN, DKI JAKARTA",76,81,133,214
https://kawalpemilu.org#26049,"DUREN TIGA, PANCORAN, JAKARTA SELATAN, DKI JAKARTA",77,93,152,245
https://kawalpemilu.org#26049,"DUREN TIGA, PANCORAN, JAKARTA SELATAN, DKI JAKARTA",78,78,158,236
https://kawalpemilu.org#26049,"DUREN TIGA, PANCORAN, JAKARTA SELATAN, DKI JAKARTA",79,93,127,220
https://kawalpemilu.org#26049,"DUREN TIGA, PANCORAN, JAKARTA SELATAN, DKI JAKARTA",80,101,134,135
https://kawalpemilu.org#26049,"DUREN TIGA, PANCORAN, JAKARTA SELATAN, DKI JAKARTA",81,67,190,257
https://kawalpemilu.org#26049,"DUREN TIGA, PANCORAN, JAKARTA SELATAN, DKI JAKARTA",82,102,115,217
https://kawalpemilu.org#26049,"DUREN TIGA, PANCORAN, JAKARTA SELATAN, DKI JAKARTA",83,109,116,225
https://kawalpemilu.org#26049,"DUREN TIGA, PANCORAN, JAKARTA SELATAN, DKI JAKARTA",84,76,174,250
https://kawalpemilu.org#26049,"DUREN TIGA, PANCORAN, JAKARTA SELATAN, DKI JAKARTA",85,118,105,223
https://kawalpemilu.org#26049,"DUREN TIGA, PANCORAN, JAKARTA SELATAN, DKI JAKARTA",86,111,133,244
https://kawalpemilu.org#26049,"DUREN TIGA, PANCORAN, JAKARTA SELATAN, DKI JAKARTA",87,113,136,249
https://kawalpemilu.org#26049,"DUREN TIGA, PANCORAN, JAKARTA SELATAN, DKI JAKARTA",88,156,76,232
https://kawalpemilu.org#26049,"DUREN TIGA, PANCORAN, JAKARTA SELATAN, DKI JAKARTA",89,105,54,159
https://kawalpemilu.org#26049,"DUREN TIGA, PANCORAN, JAKARTA SELATAN, DKI JAKARTA",90,89,123,212
https://kawalpemilu.org#26049,"DUREN TIGA, PANCORAN, JAKARTA SELATAN, DKI JAKARTA",91,70,105,175
https://kawalpemilu.org#26049,"DUREN TIGA, PANCORAN, JAKARTA SELATAN, DKI JAKARTA",92,106,122,228
https://kawalpemilu.org#26049,"DUREN TIGA, PANCORAN, JAKARTA SELATAN, DKI JAKARTA",93,67,133,200
https://kawalpemilu.org#26049,"DUREN TIGA, PANCORAN, JAKARTA SELATAN, DKI JAKARTA",95,126,87,213
https://kawalpemilu.org#26049,"DUREN TIGA, PANCORAN, JAKARTA SELATAN, DKI JAKARTA",96,126,104,230
https://kawalpemilu.org#26049,"DUREN TIGA, PANCORAN, JAKARTA SELATAN, DKI JAKARTA",97,62,92,154
https://kawalpemilu.org#26049,"DUREN TIGA, PANCORAN, JAKARTA SELATAN, DKI JAKARTA",98,99,82,181
https://kawalpemilu.org#26050,"PENGADEGAN, PANCORAN, JAKARTA SELATAN, DKI JAKARTA",1,94,135,229
https://kawalpemilu.org#26050,"PENGADEGAN, PANCORAN, JAKARTA SELATAN, DKI JAKARTA",2,78,99,177
https://kawalpemilu.org#26050,"PENGADEGAN, PANCORAN, JAKARTA SELATAN, DKI JAKARTA",3,142,91,233
https://kawalpemilu.org#26050,"PENGADEGAN, PANCORAN, JAKARTA SELATAN, DKI JAKARTA",4,100,132,232
https://kawalpemilu.org#26050,"PENGADEGAN, PANCORAN, JAKARTA SELATAN, DKI JAKARTA",5,111,149,260
https://kawalpemilu.org#26050,"PENGADEGAN, PANCORAN, JAKARTA SELATAN, DKI JAKARTA",6,79,138,217
https://kawalpemilu.org#26050,"PENGADEGAN, PANCORAN, JAKARTA SELATAN, DKI JAKARTA",7,52,114,166
https://kawalpemilu.org#26050,"PENGADEGAN, PANCORAN, JAKARTA SELATAN, DKI JAKARTA",8,73,107,180
https://kawalpemilu.org#26050,"PENGADEGAN, PANCORAN, JAKARTA SELATAN, DKI JAKARTA",9,60,109,169
https://kawalpemilu.org#26050,"PENGADEGAN, PANCORAN, JAKARTA SELATAN, DKI JAKARTA",10,112,102,214
https://kawalpemilu.org#26050,"PENGADEGAN, PANCORAN, JAKARTA SELATAN, DKI JAKARTA",11,81,92,173
https://kawalpemilu.org#26050,"PENGADEGAN, PANCORAN, JAKARTA SELATAN, DKI JAKARTA",12,44,197,241
https://kawalpemilu.org#26050,"PENGADEGAN, PANCORAN, JAKARTA SELATAN, DKI JAKARTA",13,42,145,187
https://kawalpemilu.org#26050,"PENGADEGAN, PANCORAN, JAKARTA SELATAN, DKI JAKARTA",14,52,98,150
https://kawalpemilu.org#26050,"PENGADEGAN, PANCORAN, JAKARTA SELATAN, DKI JAKARTA",15,90,129,219
https://kawalpemilu.org#26050,"PENGADEGAN, PANCORAN, JAKARTA SELATAN, DKI JAKARTA",16,92,123,215
https://kawalpemilu.org#26050,"PENGADEGAN, PANCORAN, JAKARTA SELATAN, DKI JAKARTA",17,84,147,231
https://kawalpemilu.org#26050,"PENGADEGAN, PANCORAN, JAKARTA SELATAN, DKI JAKARTA",18,106,105,211
https://kawalpemilu.org#26050,"PENGADEGAN, PANCORAN, JAKARTA SELATAN, DKI JAKARTA",19,70,89,159
https://kawalpemilu.org#26050,"PENGADEGAN, PANCORAN, JAKARTA SELATAN, DKI JAKARTA",20,54,136,190
https://kawalpemilu.org#26050,"PENGADEGAN, PANCORAN, JAKARTA SELATAN, DKI JAKARTA",21,22,121,143
https://kawalpemilu.org#26050,"PENGADEGAN, PANCORAN, JAKARTA SELATAN, DKI JAKARTA",22,33,178,211
https://kawalpemilu.org#26050,"PENGADEGAN, PANCORAN, JAKARTA SELATAN, DKI JAKARTA",23,55,166,221
https://kawalpemilu.org#26050,"PENGADEGAN, PANCORAN, JAKARTA SELATAN, DKI JAKARTA",24,67,123,190
https://kawalpemilu.org#26050,"PENGADEGAN, PANCORAN, JAKARTA SELATAN, DKI JAKARTA",25,79,77,156
https://kawalpemilu.org#26050,"PENGADEGAN, PANCORAN, JAKARTA SELATAN, DKI JAKARTA",26,110,131,241
https://kawalpemilu.org#26050,"PENGADEGAN, PANCORAN, JAKARTA SELATAN, DKI JAKARTA",27,75,62,137
https://kawalpemilu.org#26050,"PENGADEGAN, PANCORAN, JAKARTA SELATAN, DKI JAKARTA",28,117,69,186
https://kawalpemilu.org#26050,"PENGADEGAN, PANCORAN, JAKARTA SELATAN, DKI JAKARTA",30,136,77,213
https://kawalpemilu.org#26050,"PENGADEGAN, PANCORAN, JAKARTA SELATAN, DKI JAKARTA",31,109,41,150
https://kawalpemilu.org#26050,"PENGADEGAN, PANCORAN, JAKARTA SELATAN, DKI JAKARTA",32,135,121,256
https://kawalpemilu.org#26050,"PENGADEGAN, PANCORAN, JAKARTA SELATAN, DKI JAKARTA",33,118,139,257
https://kawalpemilu.org#26050,"PENGADEGAN, PANCORAN, JAKARTA SELATAN, DKI JAKARTA",34,97,137,234
https://kawalpemilu.org#26050,"PENGADEGAN, PANCORAN, JAKARTA SELATAN, DKI JAKARTA",35,109,109,218
https://kawalpemilu.org#26050,"PENGADEGAN, PANCORAN, JAKARTA SELATAN, DKI JAKARTA",36,111,114,225
https://kawalpemilu.org#26050,"PENGADEGAN, PANCORAN, JAKARTA SELATAN, DKI JAKARTA",37,83,72,155
https://kawalpemilu.org#26050,"PENGADEGAN, PANCORAN, JAKARTA SELATAN, DKI JAKARTA",38,131,103,234
https://kawalpemilu.org#26050,"PENGADEGAN, PANCORAN, JAKARTA SELATAN, DKI JAKARTA",39,128,109,237
https://kawalpemilu.org#26050,"PENGADEGAN, PANCORAN, JAKARTA SELATAN, DKI JAKARTA",40,100,95,195
https://kawalpemilu.org#26050,"PENGADEGAN, PANCORAN, JAKARTA SELATAN, DKI JAKARTA",41,64,109,173
https://kawalpemilu.org#26050,"PENGADEGAN, PANCORAN, JAKARTA SELATAN, DKI JAKARTA",42,107,138,245
https://kawalpemilu.org#26050,"PENGADEGAN, PANCORAN, JAKARTA SELATAN, DKI JAKARTA",43,101,145,246
https://kawalpemilu.org#26050,"PENGADEGAN, PANCORAN, JAKARTA SELATAN, DKI JAKARTA",44,76,171,247
https://kawalpemilu.org#26050,"PENGADEGAN, PANCORAN, JAKARTA SELATAN, DKI JAKARTA",45,69,126,195
https://kawalpemilu.org#26050,"PENGADEGAN, PANCORAN, JAKARTA SELATAN, DKI JAKARTA",46,79,83,162
https://kawalpemilu.org#26050,"PENGADEGAN, PANCORAN, JAKARTA SELATAN, DKI JAKARTA",47,96,113,209
https://kawalpemilu.org#26050,"PENGADEGAN, PANCORAN, JAKARTA SELATAN, DKI JAKARTA",48,72,88,160
https://kawalpemilu.org#26050,"PENGADEGAN, PANCORAN, JAKARTA SELATAN, DKI JAKARTA",49,59,114,173
https://kawalpemilu.org#26050,"PENGADEGAN, PANCORAN, JAKARTA SELATAN, DKI JAKARTA",50,73,89,162
https://kawalpemilu.org#26050,"PENGADEGAN, PANCORAN, JAKARTA SELATAN, DKI JAKARTA",51,95,141,236
https://kawalpemilu.org#26050,"PENGADEGAN, PANCORAN, JAKARTA SELATAN, DKI JAKARTA",52,118,122,240
https://kawalpemilu.org#26050,"PENGADEGAN, PANCORAN, JAKARTA SELATAN, DKI JAKARTA",53,81,134,215
https://kawalpemilu.org#26050,"PENGADEGAN, PANCORAN, JAKARTA SELATAN, DKI JAKARTA",54,129,101,230
https://kawalpemilu.org#26050,"PENGADEGAN, PANCORAN, JAKARTA SELATAN, DKI JAKARTA",55,119,114,233
https://kawalpemilu.org#26050,"PENGADEGAN, PANCORAN, JAKARTA SELATAN, DKI JAKARTA",56,101,77,178
https://kawalpemilu.org#26050,"PENGADEGAN, PANCORAN, JAKARTA SELATAN, DKI JAKARTA",57,107,73,180
https://kawalpemilu.org#26050,"PENGADEGAN, PANCORAN, JAKARTA SELATAN, DKI JAKARTA",58,110,117,227
https://kawalpemilu.org#26050,"PENGADEGAN, PANCORAN, JAKARTA SELATAN, DKI JAKARTA",60,122,120,242
https://kawalpemilu.org#26050,"PENGADEGAN, PANCORAN, JAKARTA SELATAN, DKI JAKARTA",61,33,112,145
https://kawalpemilu.org#26050,"PENGADEGAN, PANCORAN, JAKARTA SELATAN, DKI JAKARTA",62,147,93,240
https://kawalpemilu.org#26050,"PENGADEGAN, PANCORAN, JAKARTA SELATAN, DKI JAKARTA",63,73,109,182
https://kawalpemilu.org#26050,"PENGADEGAN, PANCORAN, JAKARTA SELATAN, DKI JAKARTA",64,111,90,201
https://kawalpemilu.org#26050,"PENGADEGAN, PANCORAN, JAKARTA SELATAN, DKI JAKARTA",65,68,63,131
https://kawalpemilu.org#26050,"PENGADEGAN, PANCORAN, JAKARTA SELATAN, DKI JAKARTA",66,101,93,194
https://kawalpemilu.org#26050,"PENGADEGAN, PANCORAN, JAKARTA SELATAN, DKI JAKARTA",67,96,115,211
https://kawalpemilu.org#26050,"PENGADEGAN, PANCORAN, JAKARTA SELATAN, DKI JAKARTA",68,83,103,186
https://kawalpemilu.org#26050,"PENGADEGAN, PANCORAN, JAKARTA SELATAN, DKI JAKARTA",69,106,107,213
https://kawalpemilu.org#26050,"PENGADEGAN, PANCORAN, JAKARTA SELATAN, DKI JAKARTA",70,92,139,231
https://kawalpemilu.org#26050,"PENGADEGAN, PANCORAN, JAKARTA SELATAN, DKI JAKARTA",71,149,92,241
https://kawalpemilu.org#26050,"PENGADEGAN, PANCORAN, JAKARTA SELATAN, DKI JAKARTA",72,109,123,232
https://kawalpemilu.org#26050,"PENGADEGAN, PANCORAN, JAKARTA SELATAN, DKI JAKARTA",73,113,149,262
https://kawalpemilu.org#26050,"PENGADEGAN, PANCORAN, JAKARTA SELATAN, DKI JAKARTA",74,111,132,243
https://kawalpemilu.org#26050,"PENGADEGAN, PANCORAN, JAKARTA SELATAN, DKI JAKARTA",75,119,108,227
https://kawalpemilu.org#26050,"PENGADEGAN, PANCORAN, JAKARTA SELATAN, DKI JAKARTA",76,101,81,182
https://kawalpemilu.org#26051,"CIKOKO, PANCORAN, JAKARTA SELATAN, DKI JAKARTA",1,93,86,179
https://kawalpemilu.org#26051,"CIKOKO, PANCORAN, JAKARTA SELATAN, DKI JAKARTA",2,82,117,199
https://kawalpemilu.org#26051,"CIKOKO, PANCORAN, JAKARTA SELATAN, DKI JAKARTA",3,64,119,183
https://kawalpemilu.org#26051,"CIKOKO, PANCORAN, JAKARTA SELATAN, DKI JAKARTA",4,129,112,241
https://kawalpemilu.org#26051,"CIKOKO, PANCORAN, JAKARTA SELATAN, DKI JAKARTA",5,67,167,234
https://kawalpemilu.org#26051,"CIKOKO, PANCORAN, JAKARTA SELATAN, DKI JAKARTA",6,81,179,260
https://kawalpemilu.org#26051,"CIKOKO, PANCORAN, JAKARTA SELATAN, DKI JAKARTA",7,113,100,213
https://kawalpemilu.org#26051,"CIKOKO, PANCORAN, JAKARTA SELATAN, DKI JAKARTA",8,94,149,243
https://kawalpemilu.org#26051,"CIKOKO, PANCORAN, JAKARTA SELATAN, DKI JAKARTA",9,85,86,171
https://kawalpemilu.org#26051,"CIKOKO, PANCORAN, JAKARTA SELATAN, DKI JAKARTA",10,146,41,187
https://kawalpemilu.org#26051,"CIKOKO, PANCORAN, JAKARTA SELATAN, DKI JAKARTA",11,64,81,145
https://kawalpemilu.org#26051,"CIKOKO, PANCORAN, JAKARTA SELATAN, DKI JAKARTA",12,76,110,186
https://kawalpemilu.org#26051,"CIKOKO, PANCORAN, JAKARTA SELATAN, DKI JAKARTA",13,103,127,230
https://kawalpemilu.org#26051,"CIKOKO, PANCORAN, JAKARTA SELATAN, DKI JAKARTA",14,115,128,243
https://kawalpemilu.org#26051,"CIKOKO, PANCORAN, JAKARTA SELATAN, DKI JAKARTA",15,72,173,245
https://kawalpemilu.org#26051,"CIKOKO, PANCORAN, JAKARTA SELATAN, DKI JAKARTA",16,120,135,255
https://kawalpemilu.org#26051,"CIKOKO, PANCORAN, JAKARTA SELATAN, DKI JAKARTA",17,86,128,214
https://kawalpemilu.org#26051,"CIKOKO, PANCORAN, JAKARTA SELATAN, DKI JAKARTA",18,134,54,188
https://kawalpemilu.org#26051,"CIKOKO, PANCORAN, JAKARTA SELATAN, DKI JAKARTA",19,90,140,230
https://kawalpemilu.org#26051,"CIKOKO, PANCORAN, JAKARTA SELATAN, DKI JAKARTA",20,97,71,168
https://kawalpemilu.org#26051,"CIKOKO, PANCORAN, JAKARTA SELATAN, DKI JAKARTA",21,102,94,196
https://kawalpemilu.org#26051,"CIKOKO, PANCORAN, JAKARTA SELATAN, DKI JAKARTA",22,110,84,194
https://kawalpemilu.org#26051,"CIKOKO, PANCORAN, JAKARTA SELATAN, DKI JAKARTA",23,133,112,245
https://kawalpemilu.org#26051,"CIKOKO, PANCORAN, JAKARTA SELATAN, DKI JAKARTA",24,105,118,223
https://kawalpemilu.org#26051,"CIKOKO, PANCORAN, JAKARTA SELATAN, DKI JAKARTA",25,75,140,215
https://kawalpemilu.org#26051,"CIKOKO, PANCORAN, JAKARTA SELATAN, DKI JAKARTA",26,102,100,202
https://kawalpemilu.org#26051,"CIKOKO, PANCORAN, JAKARTA SELATAN, DKI JAKARTA",27,103,149,252
https://kawalpemilu.org#26051,"CIKOKO, PANCORAN, JAKARTA SELATAN, DKI JAKARTA",28,149,98,247
https://kawalpemilu.org#26051,"CIKOKO, PANCORAN, JAKARTA SELATAN, DKI JAKARTA",29,85,78,163
https://kawalpemilu.org#26051,"CIKOKO, PANCORAN, JAKARTA SELATAN, DKI JAKARTA",30,85,115,200
https://kawalpemilu.org#26051,"CIKOKO, PANCORAN, JAKARTA SELATAN, DKI JAKARTA",31,63,173,236
https://kawalpemilu.org#26051,"CIKOKO, PANCORAN, JAKARTA SELATAN, DKI JAKARTA",32,110,106,216
https://kawalpemilu.org#26051,"CIKOKO, PANCORAN, JAKARTA SELATAN, DKI JAKARTA",33,108,115,223
https://kawalpemilu.org#26051,"CIKOKO, PANCORAN, JAKARTA SELATAN, DKI JAKARTA",34,103,146,249
https://kawalpemilu.org#26051,"CIKOKO, PANCORAN, JAKARTA SELATAN, DKI JAKARTA",35,97,137,234
https://kawalpemilu.org#26051,"CIKOKO, PANCORAN, JAKARTA SELATAN, DKI JAKARTA",36,86,118,204
https://kawalpemilu.org#26051,"CIKOKO, PANCORAN, JAKARTA SELATAN, DKI JAKARTA",37,82,194,276
https://kawalpemilu.org#26053,"JAGAKARSA, JAGAKARSA, JAKARTA SELATAN, DKI JAKARTA",1,122,80,202
https://kawalpemilu.org#26053,"JAGAKARSA, JAGAKARSA, JAKARTA SELATAN, DKI JAKARTA",2,101,121,222
https://kawalpemilu.org#26053,"JAGAKARSA, JAGAKARSA, JAKARTA SELATAN, DKI JAKARTA",3,69,102,171
https://kawalpemilu.org#26053,"JAGAKARSA, JAGAKARSA, JAKARTA SELATAN, DKI JAKARTA",4,110,88,198
https://kawalpemilu.org#26053,"JAGAKARSA, JAGAKARSA, JAKARTA SELATAN, DKI JAKARTA",5,98,137,235
https://kawalpemilu.org#26053,"JAGAKARSA, JAGAKARSA, JAKARTA SELATAN, DKI JAKARTA",6,94,140,234
https://kawalpemilu.org#26053,"JAGAKARSA, JAGAKARSA, JAKARTA SELATAN, DKI JAKARTA",7,95,96,191
https://kawalpemilu.org#26053,"JAGAKARSA, JAGAKARSA, JAKARTA SELATAN, DKI JAKARTA",8,66,123,189
https://kawalpemilu.org#26053,"JAGAKARSA, JAGAKARSA, JAKARTA SELATAN, DKI JAKARTA",9,82,105,187
https://kawalpemilu.org#26053,"JAGAKARSA, JAGAKARSA, JAKARTA SELATAN, DKI JAKARTA",10,92,96,188
https://kawalpemilu.org#26053,"JAGAKARSA, JAGAKARSA, JAKARTA SELATAN, DKI JAKARTA",11,82,123,205
https://kawalpemilu.org#26053,"JAGAKARSA, JAGAKARSA, JAKARTA SELATAN, DKI JAKARTA",12,114,93,207
https://kawalpemilu.org#26053,"JAGAKARSA, JAGAKARSA, JAKARTA SELATAN, DKI JAKARTA",13,95,94,189
https://kawalpemilu.org#26053,"JAGAKARSA, JAGAKARSA, JAKARTA SELATAN, DKI JAKARTA",14,102,84,186
https://kawalpemilu.org#26053,"JAGAKARSA, JAGAKARSA, JAKARTA SELATAN, DKI JAKARTA",15,114,88,202
https://kawalpemilu.org#26053,"JAGAKARSA, JAGAKARSA, JAKARTA SELATAN, DKI JAKARTA",16,70,126,196
https://kawalpemilu.org#26053,"JAGAKARSA, JAGAKARSA, JAKARTA SELATAN, DKI JAKARTA",17,90,125,215
https://kawalpemilu.org#26053,"JAGAKARSA, JAGAKARSA, JAKARTA SELATAN, DKI JAKARTA",18,87,112,199
https://kawalpemilu.org#26053,"JAGAKARSA, JAGAKARSA, JAKARTA SELATAN, DKI JAKARTA",19,91,108,199
https://kawalpemilu.org#26053,"JAGAKARSA, JAGAKARSA, JAKARTA SELATAN, DKI JAKARTA",20,100,122,222
https://kawalpemilu.org#26053,"JAGAKARSA, JAGAKARSA, JAKARTA SELATAN, DKI JAKARTA",21,130,86,216
https://kawalpemilu.org#26053,"JAGAKARSA, JAGAKARSA, JAKARTA SELATAN, DKI JAKARTA",22,106,103,209
https://kawalpemilu.org#26053,"JAGAKARSA, JAGAKARSA, JAKARTA SELATAN, DKI JAKARTA",23,99,106,205
https://kawalpemilu.org#26053,"JAGAKARSA, JAGAKARSA, JAKARTA SELATAN, DKI JAKARTA",24,99,95,194
https://kawalpemilu.org#26053,"JAGAKARSA, JAGAKARSA, JAKARTA SELATAN, DKI JAKARTA",25,101,97,198
https://kawalpemilu.org#26053,"JAGAKARSA, JAGAKARSA, JAKARTA SELATAN, DKI JAKARTA",27,128,84,212
https://kawalpemilu.org#26053,"JAGAKARSA, JAGAKARSA, JAKARTA SELATAN, DKI JAKARTA",28,96,108,204
https://kawalpemilu.org#26053,"JAGAKARSA, JAGAKARSA, JAKARTA SELATAN, DKI JAKARTA",29,110,70,180
https://kawalpemilu.org#26053,"JAGAKARSA, JAGAKARSA, JAKARTA SELATAN, DKI JAKARTA",30,121,67,188
https://kawalpemilu.org#26053,"JAGAKARSA, JAGAKARSA, JAKARTA SELATAN, DKI JAKARTA",31,97,67,164
https://kawalpemilu.org#26053,"JAGAKARSA, JAGAKARSA, JAKARTA SELATAN, DKI JAKARTA",32,114,122,236
https://kawalpemilu.org#26053,"JAGAKARSA, JAGAKARSA, JAKARTA SELATAN, DKI JAKARTA",33,122,102,224
https://kawalpemilu.org#26053,"JAGAKARSA, JAGAKARSA, JAKARTA SELATAN, DKI JAKARTA",35,106,100,206
https://kawalpemilu.org#26053,"JAGAKARSA, JAGAKARSA, JAKARTA SELATAN, DKI JAKARTA",36,114,104,218
https://kawalpemilu.org#26053,"JAGAKARSA, JAGAKARSA, JAKARTA SELATAN, DKI JAKARTA",37,111,87,198
https://kawalpemilu.org#26053,"JAGAKARSA, JAGAKARSA, JAKARTA SELATAN, DKI JAKARTA",38,100,131,231
https://kawalpemilu.org#26053,"JAGAKARSA, JAGAKARSA, JAKARTA SELATAN, DKI JAKARTA",39,121,108,229
https://kawalpemilu.org#26053,"JAGAKARSA, JAGAKARSA, JAKARTA SELATAN, DKI JAKARTA",40,109,117,226
https://kawalpemilu.org#26053,"JAGAKARSA, JAGAKARSA, JAKARTA SELATAN, DKI JAKARTA",41,70,140,210
https://kawalpemilu.org#26053,"JAGAKARSA, JAGAKARSA, JAKARTA SELATAN, DKI JAKARTA",42,91,116,207
https://kawalpemilu.org#26053,"JAGAKARSA, JAGAKARSA, JAKARTA SELATAN, DKI JAKARTA",43,90,124,214
https://kawalpemilu.org#26053,"JAGAKARSA, JAGAKARSA, JAKARTA SELATAN, DKI JAKARTA",44,88,122,210
https://kawalpemilu.org#26053,"JAGAKARSA, JAGAKARSA, JAKARTA SELATAN, DKI JAKARTA",45,79,127,206
https://kawalpemilu.org#26053,"JAGAKARSA, JAGAKARSA, JAKARTA SELATAN, DKI JAKARTA",46,83,112,195
https://kawalpemilu.org#26053,"JAGAKARSA, JAGAKARSA, JAKARTA SELATAN, DKI JAKARTA",47,123,129,252
https://kawalpemilu.org#26053,"JAGAKARSA, JAGAKARSA, JAKARTA SELATAN, DKI JAKARTA",48,104,99,203
https://kawalpemilu.org#26053,"JAGAKARSA, JAGAKARSA, JAKARTA SELATAN, DKI JAKARTA",49,85,117,202
https://kawalpemilu.org#26053,"JAGAKARSA, JAGAKARSA, JAKARTA SELATAN, DKI JAKARTA",50,93,91,184
https://kawalpemilu.org#26053,"JAGAKARSA, JAGAKARSA, JAKARTA SELATAN, DKI JAKARTA",51,109,69,178
https://kawalpemilu.org#26053,"JAGAKARSA, JAGAKARSA, JAKARTA SELATAN, DKI JAKARTA",52,101,121,222
https://kawalpemilu.org#26053,"JAGAKARSA, JAGAKARSA, JAKARTA SELATAN, DKI JAKARTA",53,116,76,192
https://kawalpemilu.org#26053,"JAGAKARSA, JAGAKARSA, JAKARTA SELATAN, DKI JAKARTA",54,131,96,227
https://kawalpemilu.org#26053,"JAGAKARSA, JAGAKARSA, JAKARTA SELATAN, DKI JAKARTA",55,108,116,224
https://kawalpemilu.org#26053,"JAGAKARSA, JAGAKARSA, JAKARTA SELATAN, DKI JAKARTA",56,117,91,208
https://kawalpemilu.org#26053,"JAGAKARSA, JAGAKARSA, JAKARTA SELATAN, DKI JAKARTA",57,109,105,214
https://kawalpemilu.org#26053,"JAGAKARSA, JAGAKARSA, JAKARTA SELATAN, DKI JAKARTA",58,118,86,204
https://kawalpemilu.org#26053,"JAGAKARSA, JAGAKARSA, JAKARTA SELATAN, DKI JAKARTA",59,125,114,239
https://kawalpemilu.org#26053,"JAGAKARSA, JAGAKARSA, JAKARTA SELATAN, DKI JAKARTA",60,99,132,231
https://kawalpemilu.org#26053,"JAGAKARSA, JAGAKARSA, JAKARTA SELATAN, DKI JAKARTA",61,96,91,187
https://kawalpemilu.org#26053,"JAGAKARSA, JAGAKARSA, JAKARTA SELATAN, DKI JAKARTA",62,93,101,194
https://kawalpemilu.org#26053,"JAGAKARSA, JAGAKARSA, JAKARTA SELATAN, DKI JAKARTA",63,95,103,198
https://kawalpemilu.org#26053,"JAGAKARSA, JAGAKARSA, JAKARTA SELATAN, DKI JAKARTA",64,100,92,192
https://kawalpemilu.org#26053,"JAGAKARSA, JAGAKARSA, JAKARTA SELATAN, DKI JAKARTA",65,102,92,194
https://kawalpemilu.org#26053,"JAGAKARSA, JAGAKARSA, JAKARTA SELATAN, DKI JAKARTA",66,97,107,204
https://kawalpemilu.org#26053,"JAGAKARSA, JAGAKARSA, JAKARTA SELATAN, DKI JAKARTA",69,68,99,167
https://kawalpemilu.org#26053,"JAGAKARSA, JAGAKARSA, JAKARTA SELATAN, DKI JAKARTA",70,79,96,175
https://kawalpemilu.org#26053,"JAGAKARSA, JAGAKARSA, JAKARTA SELATAN, DKI JAKARTA",71,81,98,179
https://kawalpemilu.org#26053,"JAGAKARSA, JAGAKARSA, JAKARTA SELATAN, DKI JAKARTA",72,80,116,196
https://kawalpemilu.org#26053,"JAGAKARSA, JAGAKARSA, JAKARTA SELATAN, DKI JAKARTA",74,67,117,184
https://kawalpemilu.org#26053,"JAGAKARSA, JAGAKARSA, JAKARTA SELATAN, DKI JAKARTA",75,79,134,213
https://kawalpemilu.org#26053,"JAGAKARSA, JAGAKARSA, JAKARTA SELATAN, DKI JAKARTA",76,99,75,174
https://kawalpemilu.org#26053,"JAGAKARSA, JAGAKARSA, JAKARTA SELATAN, DKI JAKARTA",77,109,90,199
https://kawalpemilu.org#26053,"JAGAKARSA, JAGAKARSA, JAKARTA SELATAN, DKI JAKARTA",78,72,86,158
https://kawalpemilu.org#26053,"JAGAKARSA, JAGAKARSA, JAKARTA SELATAN, DKI JAKARTA",79,75,91,166
https://kawalpemilu.org#26053,"JAGAKARSA, JAGAKARSA, JAKARTA SELATAN, DKI JAKARTA",81,83,124,207
https://kawalpemilu.org#26053,"JAGAKARSA, JAGAKARSA, JAKARTA SELATAN, DKI JAKARTA",82,135,78,213
https://kawalpemilu.org#26053,"JAGAKARSA, JAGAKARSA, JAKARTA SELATAN, DKI JAKARTA",84,114,121,235
https://kawalpemilu.org#26053,"JAGAKARSA, JAGAKARSA, JAKARTA SELATAN, DKI JAKARTA",85,112,119,231
https://kawalpemilu.org#26053,"JAGAKARSA, JAGAKARSA, JAKARTA SELATAN, DKI JAKARTA",86,93,143,242
https://kawalpemilu.org#26053,"JAGAKARSA, JAGAKARSA, JAKARTA SELATAN, DKI JAKARTA",87,98,132,230
https://kawalpemilu.org#26053,"JAGAKARSA, JAGAKARSA, JAKARTA SELATAN, DKI JAKARTA",88,80,132,212
https://kawalpemilu.org#26053,"JAGAKARSA, JAGAKARSA, JAKARTA SELATAN, DKI JAKARTA",89,82,127,209
https://kawalpemilu.org#26053,"JAGAKARSA, JAGAKARSA, JAKARTA SELATAN, DKI JAKARTA",90,90,123,213
https://kawalpemilu.org#26053,"JAGAKARSA, JAGAKARSA, JAKARTA SELATAN, DKI JAKARTA",91,81,117,198
https://kawalpemilu.org#26053,"JAGAKARSA, JAGAKARSA, JAKARTA SELATAN, DKI JAKARTA",92,98,93,191
https://kawalpemilu.org#26053,"JAGAKARSA, JAGAKARSA, JAKARTA SELATAN, DKI JAKARTA",93,73,104,177
https://kawalpemilu.org#26053,"JAGAKARSA, JAGAKARSA, JAKARTA SELATAN, DKI JAKARTA",94,0,0,0
https://kawalpemilu.org#26053,"JAGAKARSA, JAGAKARSA, JAKARTA SELATAN, DKI JAKARTA",95,87,94,181
https://kawalpemilu.org#26053,"JAGAKARSA, JAGAKARSA, JAKARTA SELATAN, DKI JAKARTA",96,109,79,188
https://kawalpemilu.org#26053,"JAGAKARSA, JAGAKARSA, JAKARTA SELATAN, DKI JAKARTA",97,104,92,196
https://kawalpemilu.org#26053,"JAGAKARSA, JAGAKARSA, JAKARTA SELATAN, DKI JAKARTA",98,118,117,235
https://kawalpemilu.org#26053,"JAGAKARSA, JAGAKARSA, JAKARTA SELATAN, DKI JAKARTA",99,146,108,254
https://kawalpemilu.org#26053,"JAGAKARSA, JAGAKARSA, JAKARTA SELATAN, DKI JAKARTA",100,103,125,228
https://kawalpemilu.org#26053,"JAGAKARSA, JAGAKARSA, JAKARTA SELATAN, DKI JAKARTA",101,132,137,269
https://kawalpemilu.org#26053,"JAGAKARSA, JAGAKARSA, JAKARTA SELATAN, DKI JAKARTA",102,78,105,183
https://kawalpemilu.org#26053,"JAGAKARSA, JAGAKARSA, JAKARTA SELATAN, DKI JAKARTA",103,85,136,221
https://kawalpemilu.org#26053,"JAGAKARSA, JAGAKARSA, JAKARTA SELATAN, DKI JAKARTA",104,70,139,209
https://kawalpemilu.org#26053,"JAGAKARSA, JAGAKARSA, JAKARTA SELATAN, DKI JAKARTA",105,117,112,229
https://kawalpemilu.org#26053,"JAGAKARSA, JAGAKARSA, JAKARTA SELATAN, DKI JAKARTA",106,127,116,243
https://kawalpemilu.org#26053,"JAGAKARSA, JAGAKARSA, JAKARTA SELATAN, DKI JAKARTA",107,107,119,226
https://kawalpemilu.org#26053,"JAGAKARSA, JAGAKARSA, JAKARTA SELATAN, DKI JAKARTA",108,104,95,195
https://kawalpemilu.org#26053,"JAGAKARSA, JAGAKARSA, JAKARTA SELATAN, DKI JAKARTA",109,99,90,189
https://kawalpemilu.org#26053,"JAGAKARSA, JAGAKARSA, JAKARTA SELATAN, DKI JAKARTA",110,77,122,199
https://kawalpemilu.org#26053,"JAGAKARSA, JAGAKARSA, JAKARTA SELATAN, DKI JAKARTA",111,132,96,228
https://kawalpemilu.org#26053,"JAGAKARSA, JAGAKARSA, JAKARTA SELATAN, DKI JAKARTA",112,109,95,204
https://kawalpemilu.org#26053,"JAGAKARSA, JAGAKARSA, JAKARTA SELATAN, DKI JAKARTA",113,93,78,171
https://kawalpemilu.org#26053,"JAGAKARSA, JAGAKARSA, JAKARTA SELATAN, DKI JAKARTA",114,91,86,177
https://kawalpemilu.org#26053,"JAGAKARSA, JAGAKARSA, JAKARTA SELATAN, DKI JAKARTA",115,89,98,187
https://kawalpemilu.org#26053,"JAGAKARSA, JAGAKARSA, JAKARTA SELATAN, DKI JAKARTA",116,93,91,184
https://kawalpemilu.org#26053,"JAGAKARSA, JAGAKARSA, JAKARTA SELATAN, DKI JAKARTA",117,106,91,197
https://kawalpemilu.org#26053,"JAGAKARSA, JAGAKARSA, JAKARTA SELATAN, DKI JAKARTA",118,66,86,152
https://kawalpemilu.org#26053,"JAGAKARSA, JAGAKARSA, JAKARTA SELATAN, DKI JAKARTA",119,115,72,187
https://kawalpemilu.org#26053,"JAGAKARSA, JAGAKARSA, JAKARTA SELATAN, DKI JAKARTA",120,107,71,178
https://kawalpemilu.org#26053,"JAGAKARSA, JAGAKARSA, JAKARTA SELATAN, DKI JAKARTA",121,90,127,217
https://kawalpemilu.org#26053,"JAGAKARSA, JAGAKARSA, JAKARTA SELATAN, DKI JAKARTA",122,107,120,227
https://kawalpemilu.org#26053,"JAGAKARSA, JAGAKARSA, JAKARTA SELATAN, DKI JAKARTA",123,99,121,220
https://kawalpemilu.org#26053,"JAGAKARSA, JAGAKARSA, JAKARTA SELATAN, DKI JAKARTA",124,88,114,202
https://kawalpemilu.org#26053,"JAGAKARSA, JAGAKARSA, JAKARTA SELATAN, DKI JAKARTA",125,92,93,185
https://kawalpemilu.org#26053,"JAGAKARSA, JAGAKARSA, JAKARTA SELATAN, DKI JAKARTA",126,100,90,0
https://kawalpemilu.org#26053,"JAGAKARSA, JAGAKARSA, JAKARTA SELATAN, DKI JAKARTA",127,90,127,217
https://kawalpemilu.org#26053,"JAGAKARSA, JAGAKARSA, JAKARTA SELATAN, DKI JAKARTA",128,110,109,219
https://kawalpemilu.org#26053,"JAGAKARSA, JAGAKARSA, JAKARTA SELATAN, DKI JAKARTA",129,100,122,222
https://kawalpemilu.org#26053,"JAGAKARSA, JAGAKARSA, JAKARTA SELATAN, DKI JAKARTA",132,97,146,243
https://kawalpemilu.org#26053,"JAGAKARSA, JAGAKARSA, JAKARTA SELATAN, DKI JAKARTA",133,115,108,223
https://kawalpemilu.org#26053,"JAGAKARSA, JAGAKARSA, JAKARTA SELATAN, DKI JAKARTA",134,95,128,223
https://kawalpemilu.org#26053,"JAGAKARSA, JAGAKARSA, JAKARTA SELATAN, DKI JAKARTA",135,135,117,252
https://kawalpemilu.org#26053,"JAGAKARSA, JAGAKARSA, JAKARTA SELATAN, DKI JAKARTA",137,113,116,229
https://kawalpemilu.org#26053,"JAGAKARSA, JAGAKARSA, JAKARTA SELATAN, DKI JAKARTA",138,98,139,237
https://kawalpemilu.org#26053,"JAGAKARSA, JAGAKARSA, JAKARTA SELATAN, DKI JAKARTA",139,101,104,205
https://kawalpemilu.org#26053,"JAGAKARSA, JAGAKARSA, JAKARTA SELATAN, DKI JAKARTA",140,127,93,220
https://kawalpemilu.org#26053,"JAGAKARSA, JAGAKARSA, JAKARTA SELATAN, DKI JAKARTA",142,102,107,209
https://kawalpemilu.org#26053,"JAGAKARSA, JAGAKARSA, JAKARTA SELATAN, DKI JAKARTA",143,116,119,235
https://kawalpemilu.org#26053,"JAGAKARSA, JAGAKARSA, JAKARTA SELATAN, DKI JAKARTA",144,118,120,238
https://kawalpemilu.org#26053,"JAGAKARSA, JAGAKARSA, JAKARTA SELATAN, DKI JAKARTA",145,130,109,239
https://kawalpemilu.org#26053,"JAGAKARSA, JAGAKARSA, JAKARTA SELATAN, DKI JAKARTA",146,88,82,170
https://kawalpemilu.org#26053,"JAGAKARSA, JAGAKARSA, JAKARTA SELATAN, DKI JAKARTA",147,55,115,170
https://kawalpemilu.org#26053,"JAGAKARSA, JAGAKARSA, JAKARTA SELATAN, DKI JAKARTA",149,99,128,227
https://kawalpemilu.org#26053,"JAGAKARSA, JAGAKARSA, JAKARTA SELATAN, DKI JAKARTA",150,94,120,214
https://kawalpemilu.org#26053,"JAGAKARSA, JAGAKARSA, JAKARTA SELATAN, DKI JAKARTA",151,95,109,204
https://kawalpemilu.org#26053,"JAGAKARSA, JAGAKARSA, JAKARTA SELATAN, DKI JAKARTA",152,119,79,198
https://kawalpemilu.org#26053,"JAGAKARSA, JAGAKARSA, JAKARTA SELATAN, DKI JAKARTA",153,118,118,236
https://kawalpemilu.org#26053,"JAGAKARSA, JAGAKARSA, JAKARTA SELATAN, DKI JAKARTA",154,135,86,221
https://kawalpemilu.org#26053,"JAGAKARSA, JAGAKARSA, JAKARTA SELATAN, DKI JAKARTA",155,137,106,243
https://kawalpemilu.org#26053,"JAGAKARSA, JAGAKARSA, JAKARTA SELATAN, DKI JAKARTA",156,110,91,201
https://kawalpemilu.org#26053,"JAGAKARSA, JAGAKARSA, JAKARTA SELATAN, DKI JAKARTA",157,94,91,185
https://kawalpemilu.org#26053,"JAGAKARSA, JAGAKARSA, JAKARTA SELATAN, DKI JAKARTA",158,82,84,166
https://kawalpemilu.org#26053,"JAGAKARSA, JAGAKARSA, JAKARTA SELATAN, DKI JAKARTA",159,104,80,184
https://kawalpemilu.org#26053,"JAGAKARSA, JAGAKARSA, JAKARTA SELATAN, DKI JAKARTA",160,75,91,166
https://kawalpemilu.org#26053,"JAGAKARSA, JAGAKARSA, JAKARTA SELATAN, DKI JAKARTA",161,81,103,184
https://kawalpemilu.org#26053,"JAGAKARSA, JAGAKARSA, JAKARTA SELATAN, DKI JAKARTA",162,114,96,210
https://kawalpemilu.org#26053,"JAGAKARSA, JAGAKARSA, JAKARTA SELATAN, DKI JAKARTA",163,127,82,209
https://kawalpemilu.org#26053,"JAGAKARSA, JAGAKARSA, JAKARTA SELATAN, DKI JAKARTA",166,88,90,178
https://kawalpemilu.org#26053,"JAGAKARSA, JAGAKARSA, JAKARTA SELATAN, DKI JAKARTA",167,86,72,158
https://kawalpemilu.org#26053,"JAGAKARSA, JAGAKARSA, JAKARTA SELATAN, DKI JAKARTA",171,79,83,162
https://kawalpemilu.org#26053,"JAGAKARSA, JAGAKARSA, JAKARTA SELATAN, DKI JAKARTA",172,90,106,196
https://kawalpemilu.org#26053,"JAGAKARSA, JAGAKARSA, JAKARTA SELATAN, DKI JAKARTA",175,118,75,193
https://kawalpemilu.org#26053,"JAGAKARSA, JAGAKARSA, JAKARTA SELATAN, DKI JAKARTA",177,130,106,236
https://kawalpemilu.org#26053,"JAGAKARSA, JAGAKARSA, JAKARTA SELATAN, DKI JAKARTA",180,100,100,200
https://kawalpemilu.org#26053,"JAGAKARSA, JAGAKARSA, JAKARTA SELATAN, DKI JAKARTA",184,96,123,219
https://kawalpemilu.org#26053,"JAGAKARSA, JAGAKARSA, JAKARTA SELATAN, DKI JAKARTA",185,97,136,233
https://kawalpemilu.org#26053,"JAGAKARSA, JAGAKARSA, JAKARTA SELATAN, DKI JAKARTA",186,0,0,0
https://kawalpemilu.org#26053,"JAGAKARSA, JAGAKARSA, JAKARTA SELATAN, DKI JAKARTA",187,88,122,210
https://kawalpemilu.org#26053,"JAGAKARSA, JAGAKARSA, JAKARTA SELATAN, DKI JAKARTA",189,82,145,227
https://kawalpemilu.org#26053,"JAGAKARSA, JAGAKARSA, JAKARTA SELATAN, DKI JAKARTA",190,105,111,216
https://kawalpemilu.org#26053,"JAGAKARSA, JAGAKARSA, JAKARTA SELATAN, DKI JAKARTA",191,78,118,196
https://kawalpemilu.org#26053,"JAGAKARSA, JAGAKARSA, JAKARTA SELATAN, DKI JAKARTA",194,77,96,173
https://kawalpemilu.org#26053,"JAGAKARSA, JAGAKARSA, JAKARTA SELATAN, DKI JAKARTA",195,73,141,214
https://kawalpemilu.org#26053,"JAGAKARSA, JAGAKARSA, JAKARTA SELATAN, DKI JAKARTA",196,101,111,212
https://kawalpemilu.org#26053,"JAGAKARSA, JAGAKARSA, JAKARTA SELATAN, DKI JAKARTA",197,87,123,210
https://kawalpemilu.org#26053,"JAGAKARSA, JAGAKARSA, JAKARTA SELATAN, DKI JAKARTA",198,78,102,180
https://kawalpemilu.org#26053,"JAGAKARSA, JAGAKARSA, JAKARTA SELATAN, DKI JAKARTA",199,103,81,184
https://kawalpemilu.org#26053,"JAGAKARSA, JAGAKARSA, JAKARTA SELATAN, DKI JAKARTA",200,124,110,234
https://kawalpemilu.org#26053,"JAGAKARSA, JAGAKARSA, JAKARTA SELATAN, DKI JAKARTA",201,126,103,229
https://kawalpemilu.org#26053,"JAGAKARSA, JAGAKARSA, JAKARTA SELATAN, DKI JAKARTA",203,93,98,191
https://kawalpemilu.org#26053,"JAGAKARSA, JAGAKARSA, JAKARTA SELATAN, DKI JAKARTA",206,113,118,231
https://kawalpemilu.org#26053,"JAGAKARSA, JAGAKARSA, JAKARTA SELATAN, DKI JAKARTA",208,119,88,207
https://kawalpemilu.org#26053,"JAGAKARSA, JAGAKARSA, JAKARTA SELATAN, DKI JAKARTA",209,82,110,192
https://kawalpemilu.org#26053,"JAGAKARSA, JAGAKARSA, JAKARTA SELATAN, DKI JAKARTA",212,66,112,178
https://kawalpemilu.org#26053,"JAGAKARSA, JAGAKARSA, JAKARTA SELATAN, DKI JAKARTA",213,92,96,188
https://kawalpemilu.org#26053,"JAGAKARSA, JAGAKARSA, JAKARTA SELATAN, DKI JAKARTA",214,60,107,167
https://kawalpemilu.org#26053,"JAGAKARSA, JAGAKARSA, JAKARTA SELATAN, DKI JAKARTA",215,81,92,173
https://kawalpemilu.org#26053,"JAGAKARSA, JAGAKARSA, JAKARTA SELATAN, DKI JAKARTA",217,61,110,171
https://kawalpemilu.org#26054,"SRENGSENG SAWAH, JAGAKARSA, JAKARTA SELATAN, DKI JAKARTA",1,126,93,219
https://kawalpemilu.org#26054,"SRENGSENG SAWAH, JAGAKARSA, JAKARTA SELATAN, DKI JAKARTA",2,100,134,234
https://kawalpemilu.org#26054,"SRENGSENG SAWAH, JAGAKARSA, JAKARTA SELATAN, DKI JAKARTA",3,65,197,262
https://kawalpemilu.org#26054,"SRENGSENG SAWAH, JAGAKARSA, JAKARTA SELATAN, DKI JAKARTA",4,98,125,223
https://kawalpemilu.org#26054,"SRENGSENG SAWAH, JAGAKARSA, JAKARTA SELATAN, DKI JAKARTA",5,103,143,246
https://kawalpemilu.org#26054,"SRENGSENG SAWAH, JAGAKARSA, JAKARTA SELATAN, DKI JAKARTA",7,102,130,232
https://kawalpemilu.org#26054,"SRENGSENG SAWAH, JAGAKARSA, JAKARTA SELATAN, DKI JAKARTA",8,75,122,197
https://kawalpemilu.org#26054,"SRENGSENG SAWAH, JAGAKARSA, JAKARTA SELATAN, DKI JAKARTA",9,100,136,236
https://kawalpemilu.org#26054,"SRENGSENG SAWAH, JAGAKARSA, JAKARTA SELATAN, DKI JAKARTA",12,86,137,223
https://kawalpemilu.org#26054,"SRENGSENG SAWAH, JAGAKARSA, JAKARTA SELATAN, DKI JAKARTA",15,107,148,255
https://kawalpemilu.org#26054,"SRENGSENG SAWAH, JAGAKARSA, JAKARTA SELATAN, DKI JAKARTA",16,88,174,262
https://kawalpemilu.org#26054,"SRENGSENG SAWAH, JAGAKARSA, JAKARTA SELATAN, DKI JAKARTA",17,107,136,243
https://kawalpemilu.org#26054,"SRENGSENG SAWAH, JAGAKARSA, JAKARTA SELATAN, DKI JAKARTA",19,122,136,258
https://kawalpemilu.org#26054,"SRENGSENG SAWAH, JAGAKARSA, JAKARTA SELATAN, DKI JAKARTA",20,85,94,179
https://kawalpemilu.org#26054,"SRENGSENG SAWAH, JAGAKARSA, JAKARTA SELATAN, DKI JAKARTA",23,111,121,232
https://kawalpemilu.org#26054,"SRENGSENG SAWAH, JAGAKARSA, JAKARTA SELATAN, DKI JAKARTA",26,85,189,274
https://kawalpemilu.org#26054,"SRENGSENG SAWAH, JAGAKARSA, JAKARTA SELATAN, DKI JAKARTA",27,78,171,249
https://kawalpemilu.org#26054,"SRENGSENG SAWAH, JAGAKARSA, JAKARTA SELATAN, DKI JAKARTA",28,63,180,243
https://kawalpemilu.org#26054,"SRENGSENG SAWAH, JAGAKARSA, JAKARTA SELATAN, DKI JAKARTA",35,112,93,205
https://kawalpemilu.org#26054,"SRENGSENG SAWAH, JAGAKARSA, JAKARTA SELATAN, DKI JAKARTA",38,124,94,218
https://kawalpemilu.org#26054,"SRENGSENG SAWAH, JAGAKARSA, JAKARTA SELATAN, DKI JAKARTA",39,92,119,211
https://kawalpemilu.org#26054,"SRENGSENG SAWAH, JAGAKARSA, JAKARTA SELATAN, DKI JAKARTA",41,92,77,169
https://kawalpemilu.org#26054,"SRENGSENG SAWAH, JAGAKARSA, JAKARTA SELATAN, DKI JAKARTA",44,147,94,241
https://kawalpemilu.org#26054,"SRENGSENG SAWAH, JAGAKARSA, JAKARTA SELATAN, DKI JAKARTA",45,106,160,266
https://kawalpemilu.org#26054,"SRENGSENG SAWAH, JAGAKARSA, JAKARTA SELATAN, DKI JAKARTA",46,122,141,263
https://kawalpemilu.org#26054,"SRENGSENG SAWAH, JAGAKARSA, JAKARTA SELATAN, DKI JAKARTA",47,92,121,213
https://kawalpemilu.org#26054,"SRENGSENG SAWAH, JAGAKARSA, JAKARTA SELATAN, DKI JAKARTA",48,129,102,231
https://kawalpemilu.org#26054,"SRENGSENG SAWAH, JAGAKARSA, JAKARTA SELATAN, DKI JAKARTA",49,109,114,223
https://kawalpemilu.org#26054,"SRENGSENG SAWAH, JAGAKARSA, JAKARTA SELATAN, DKI JAKARTA",51,75,138,213
https://kawalpemilu.org#26054,"SRENGSENG SAWAH, JAGAKARSA, JAKARTA SELATAN, DKI JAKARTA",52,139,97,236
https://kawalpemilu.org#26054,"SRENGSENG SAWAH, JAGAKARSA, JAKARTA SELATAN, DKI JAKARTA",53,121,97,218
https://kawalpemilu.org#26054,"SRENGSENG SAWAH, JAGAKARSA, JAKARTA SELATAN, DKI JAKARTA",54,114,139,253
https://kawalpemilu.org#26054,"SRENGSENG SAWAH, JAGAKARSA, JAKARTA SELATAN, DKI JAKARTA",55,95,118,213
https://kawalpemilu.org#26054,"SRENGSENG SAWAH, JAGAKARSA, JAKARTA SELATAN, DKI JAKARTA",56,121,96,217
https://kawalpemilu.org#26054,"SRENGSENG SAWAH, JAGAKARSA, JAKARTA SELATAN, DKI JAKARTA",57,102,129,231
https://kawalpemilu.org#26054,"SRENGSENG SAWAH, JAGAKARSA, JAKARTA SELATAN, DKI JAKARTA",59,106,130,236
https://kawalpemilu.org#26054,"SRENGSENG SAWAH, JAGAKARSA, JAKARTA SELATAN, DKI JAKARTA",60,122,92,214
https://kawalpemilu.org#26054,"SRENGSENG SAWAH, JAGAKARSA, JAKARTA SELATAN, DKI JAKARTA",61,115,95,210
https://kawalpemilu.org#26054,"SRENGSENG SAWAH, JAGAKARSA, JAKARTA SELATAN, DKI JAKARTA",62,128,78,206
https://kawalpemilu.org#26054,"SRENGSENG SAWAH, JAGAKARSA, JAKARTA SELATAN, DKI JAKARTA",63,143,113,256
https://kawalpemilu.org#26054,"SRENGSENG SAWAH, JAGAKARSA, JAKARTA SELATAN, DKI JAKARTA",64,132,104,236
https://kawalpemilu.org#26054,"SRENGSENG SAWAH, JAGAKARSA, JAKARTA SELATAN, DKI JAKARTA",65,92,127,219
https://kawalpemilu.org#26054,"SRENGSENG SAWAH, JAGAKARSA, JAKARTA SELATAN, DKI JAKARTA",66,123,97,220
https://kawalpemilu.org#26054,"SRENGSENG SAWAH, JAGAKARSA, JAKARTA SELATAN, DKI JAKARTA",67,81,108,189
https://kawalpemilu.org#26054,"SRENGSENG SAWAH, JAGAKARSA, JAKARTA SELATAN, DKI JAKARTA",70,110,117,227
https://kawalpemilu.org#26054,"SRENGSENG SAWAH, JAGAKARSA, JAKARTA SELATAN, DKI JAKARTA",71,100,131,231
https://kawalpemilu.org#26054,"SRENGSENG SAWAH, JAGAKARSA, JAKARTA SELATAN, DKI JAKARTA",72,121,92,213
https://kawalpemilu.org#26054,"SRENGSENG SAWAH, JAGAKARSA, JAKARTA SELATAN, DKI JAKARTA",73,100,101,201
https://kawalpemilu.org#26054,"SRENGSENG SAWAH, JAGAKARSA, JAKARTA SELATAN, DKI JAKARTA",74,102,129,231
https://kawalpemilu.org#26054,"SRENGSENG SAWAH, JAGAKARSA, JAKARTA SELATAN, DKI JAKARTA",76,135,100,235
https://kawalpemilu.org#26054,"SRENGSENG SAWAH, JAGAKARSA, JAKARTA SELATAN, DKI JAKARTA",77,113,138,251
https://kawalpemilu.org#26054,"SRENGSENG SAWAH, JAGAKARSA, JAKARTA SELATAN, DKI JAKARTA",79,87,124,211
https://kawalpemilu.org#26054,"SRENGSENG SAWAH, JAGAKARSA, JAKARTA SELATAN, DKI JAKARTA",80,86,149,235
https://kawalpemilu.org#26054,"SRENGSENG SAWAH, JAGAKARSA, JAKARTA SELATAN, DKI JAKARTA",81,102,128,230
https://kawalpemilu.org#26054,"SRENGSENG SAWAH, JAGAKARSA, JAKARTA SELATAN, DKI JAKARTA",82,92,126,218
https://kawalpemilu.org#26054,"SRENGSENG SAWAH, JAGAKARSA, JAKARTA SELATAN, DKI JAKARTA",83,114,150,264
https://kawalpemilu.org#26054,"SRENGSENG SAWAH, JAGAKARSA, JAKARTA SELATAN, DKI JAKARTA",84,92,145,237
https://kawalpemilu.org#26054,"SRENGSENG SAWAH, JAGAKARSA, JAKARTA SELATAN, DKI JAKARTA",85,95,131,226
https://kawalpemilu.org#26054,"SRENGSENG SAWAH, JAGAKARSA, JAKARTA SELATAN, DKI JAKARTA",86,88,119,207
https://kawalpemilu.org#26054,"SRENGSENG SAWAH, JAGAKARSA, JAKARTA SELATAN, DKI JAKARTA",87,89,107,196
https://kawalpemilu.org#26054,"SRENGSENG SAWAH, JAGAKARSA, JAKARTA SELATAN, DKI JAKARTA",88,66,145,211
https://kawalpemilu.org#26054,"SRENGSENG SAWAH, JAGAKARSA, JAKARTA SELATAN, DKI JAKARTA",89,77,146,223
https://kawalpemilu.org#26054,"SRENGSENG SAWAH, JAGAKARSA, JAKARTA SELATAN, DKI JAKARTA",90,105,102,207
https://kawalpemilu.org#26054,"SRENGSENG SAWAH, JAGAKARSA, JAKARTA SELATAN, DKI JAKARTA",91,114,91,205
https://kawalpemilu.org#26054,"SRENGSENG SAWAH, JAGAKARSA, JAKARTA SELATAN, DKI JAKARTA",92,88,88,176
https://kawalpemilu.org#26054,"SRENGSENG SAWAH, JAGAKARSA, JAKARTA SELATAN, DKI JAKARTA",93,105,129,234
https://kawalpemilu.org#26054,"SRENGSENG SAWAH, JAGAKARSA, JAKARTA SELATAN, DKI JAKARTA",97,138,121,259
https://kawalpemilu.org#26054,"SRENGSENG SAWAH, JAGAKARSA, JAKARTA SELATAN, DKI JAKARTA",99,128,104,232
https://kawalpemilu.org#26054,"SRENGSENG SAWAH, JAGAKARSA, JAKARTA SELATAN, DKI JAKARTA",101,123,133,256
https://kawalpemilu.org#26054,"SRENGSENG SAWAH, JAGAKARSA, JAKARTA SELATAN, DKI JAKARTA",102,105,138,243
https://kawalpemilu.org#26054,"SRENGSENG SAWAH, JAGAKARSA, JAKARTA SELATAN, DKI JAKARTA",104,77,139,216
https://kawalpemilu.org#26054,"SRENGSENG SAWAH, JAGAKARSA, JAKARTA SELATAN, DKI JAKARTA",105,81,157,238
https://kawalpemilu.org#26054,"SRENGSENG SAWAH, JAGAKARSA, JAKARTA SELATAN, DKI JAKARTA",106,101,151,252
https://kawalpemilu.org#26054,"SRENGSENG SAWAH, JAGAKARSA, JAKARTA SELATAN, DKI JAKARTA",107,114,128,242
https://kawalpemilu.org#26054,"SRENGSENG SAWAH, JAGAKARSA, JAKARTA SELATAN, DKI JAKARTA",108,94,158,252
https://kawalpemilu.org#26054,"SRENGSENG SAWAH, JAGAKARSA, JAKARTA SELATAN, DKI JAKARTA",109,104,116,220
https://kawalpemilu.org#26054,"SRENGSENG SAWAH, JAGAKARSA, JAKARTA SELATAN, DKI JAKARTA",110,99,143,242
https://kawalpemilu.org#26054,"SRENGSENG SAWAH, JAGAKARSA, JAKARTA SELATAN, DKI JAKARTA",112,102,139,241
https://kawalpemilu.org#26054,"SRENGSENG SAWAH, JAGAKARSA, JAKARTA SELATAN, DKI JAKARTA",113,113,113,226
https://kawalpemilu.org#26054,"SRENGSENG SAWAH, JAGAKARSA, JAKARTA SELATAN, DKI JAKARTA",115,85,108,193
https://kawalpemilu.org#26054,"SRENGSENG SAWAH, JAGAKARSA, JAKARTA SELATAN, DKI JAKARTA",116,78,114,192
https://kawalpemilu.org#26054,"SRENGSENG SAWAH, JAGAKARSA, JAKARTA SELATAN, DKI JAKARTA",117,79,96,175
https://kawalpemilu.org#26054,"SRENGSENG SAWAH, JAGAKARSA, JAKARTA SELATAN, DKI JAKARTA",118,81,124,205
https://kawalpemilu.org#26054,"SRENGSENG SAWAH, JAGAKARSA, JAKARTA SELATAN, DKI JAKARTA",119,80,114,194
https://kawalpemilu.org#26054,"SRENGSENG SAWAH, JAGAKARSA, JAKARTA SELATAN, DKI JAKARTA",120,105,125,230
https://kawalpemilu.org#26054,"SRENGSENG SAWAH, JAGAKARSA, JAKARTA SELATAN, DKI JAKARTA",121,116,103,219
https://kawalpemilu.org#26054,"SRENGSENG SAWAH, JAGAKARSA, JAKARTA SELATAN, DKI JAKARTA",122,105,133,238
https://kawalpemilu.org#26054,"SRENGSENG SAWAH, JAGAKARSA, JAKARTA SELATAN, DKI JAKARTA",123,133,93,226
https://kawalpemilu.org#26054,"SRENGSENG SAWAH, JAGAKARSA, JAKARTA SELATAN, DKI JAKARTA",124,137,104,241
https://kawalpemilu.org#26054,"SRENGSENG SAWAH, JAGAKARSA, JAKARTA SELATAN, DKI JAKARTA",125,113,84,197
https://kawalpemilu.org#26054,"SRENGSENG SAWAH, JAGAKARSA, JAKARTA SELATAN, DKI JAKARTA",127,79,173,252
https://kawalpemilu.org#26054,"SRENGSENG SAWAH, JAGAKARSA, JAKARTA SELATAN, DKI JAKARTA",130,66,169,235
https://kawalpemilu.org#26054,"SRENGSENG SAWAH, JAGAKARSA, JAKARTA SELATAN, DKI JAKARTA",131,61,178,239
https://kawalpemilu.org#26054,"SRENGSENG SAWAH, JAGAKARSA, JAKARTA SELATAN, DKI JAKARTA",132,87,155,242
https://kawalpemilu.org#26054,"SRENGSENG SAWAH, JAGAKARSA, JAKARTA SELATAN, DKI JAKARTA",134,79,155,234
https://kawalpemilu.org#26054,"SRENGSENG SAWAH, JAGAKARSA, JAKARTA SELATAN, DKI JAKARTA",135,138,125,263
https://kawalpemilu.org#26054,"SRENGSENG SAWAH, JAGAKARSA, JAKARTA SELATAN, DKI JAKARTA",136,121,130,251
https://kawalpemilu.org#26054,"SRENGSENG SAWAH, JAGAKARSA, JAKARTA SELATAN, DKI JAKARTA",137,109,139,248
https://kawalpemilu.org#26054,"SRENGSENG SAWAH, JAGAKARSA, JAKARTA SELATAN, DKI JAKARTA",138,97,154,251
https://kawalpemilu.org#26054,"SRENGSENG SAWAH, JAGAKARSA, JAKARTA SELATAN, DKI JAKARTA",139,91,134,225
https://kawalpemilu.org#26054,"SRENGSENG SAWAH, JAGAKARSA, JAKARTA SELATAN, DKI JAKARTA",140,86,144,230
https://kawalpemilu.org#26054,"SRENGSENG SAWAH, JAGAKARSA, JAKARTA SELATAN, DKI JAKARTA",141,90,143,233
https://kawalpemilu.org#26054,"SRENGSENG SAWAH, JAGAKARSA, JAKARTA SELATAN, DKI JAKARTA",144,77,150,227
https://kawalpemilu.org#26054,"SRENGSENG SAWAH, JAGAKARSA, JAKARTA SELATAN, DKI JAKARTA",145,67,163,230
https://kawalpemilu.org#26054,"SRENGSENG SAWAH, JAGAKARSA, JAKARTA SELATAN, DKI JAKARTA",147,54,166,220
https://kawalpemilu.org#26054,"SRENGSENG SAWAH, JAGAKARSA, JAKARTA SELATAN, DKI JAKARTA",148,81,129,210
https://kawalpemilu.org#26054,"SRENGSENG SAWAH, JAGAKARSA, JAKARTA SELATAN, DKI JAKARTA",149,69,150,219
https://kawalpemilu.org#26054,"SRENGSENG SAWAH, JAGAKARSA, JAKARTA SELATAN, DKI JAKARTA",150,104,146,250
https://kawalpemilu.org#26054,"SRENGSENG SAWAH, JAGAKARSA, JAKARTA SELATAN, DKI JAKARTA",151,88,164,252
https://kawalpemilu.org#26054,"SRENGSENG SAWAH, JAGAKARSA, JAKARTA SELATAN, DKI JAKARTA",152,85,161,246
https://kawalpemilu.org#26054,"SRENGSENG SAWAH, JAGAKARSA, JAKARTA SELATAN, DKI JAKARTA",153,82,114,196
https://kawalpemilu.org#26054,"SRENGSENG SAWAH, JAGAKARSA, JAKARTA SELATAN, DKI JAKARTA",154,86,116,202
https://kawalpemilu.org#26054,"SRENGSENG SAWAH, JAGAKARSA, JAKARTA SELATAN, DKI JAKARTA",155,82,107,189
https://kawalpemilu.org#26054,"SRENGSENG SAWAH, JAGAKARSA, JAKARTA SELATAN, DKI JAKARTA",156,109,92,201
https://kawalpemilu.org#26054,"SRENGSENG SAWAH, JAGAKARSA, JAKARTA SELATAN, DKI JAKARTA",157,83,139,222
https://kawalpemilu.org#26054,"SRENGSENG SAWAH, JAGAKARSA, JAKARTA SELATAN, DKI JAKARTA",158,84,119,203
https://kawalpemilu.org#26054,"SRENGSENG SAWAH, JAGAKARSA, JAKARTA SELATAN, DKI JAKARTA",159,41,95,136
https://kawalpemilu.org#26054,"SRENGSENG SAWAH, JAGAKARSA, JAKARTA SELATAN, DKI JAKARTA",160,37,162,199
https://kawalpemilu.org#26054,"SRENGSENG SAWAH, JAGAKARSA, JAKARTA SELATAN, DKI JAKARTA",161,40,178,218
https://kawalpemilu.org#26054,"SRENGSENG SAWAH, JAGAKARSA, JAKARTA SELATAN, DKI JAKARTA",162,46,179,225
https://kawalpemilu.org#26054,"SRENGSENG SAWAH, JAGAKARSA, JAKARTA SELATAN, DKI JAKARTA",163,38,146,184
https://kawalpemilu.org#26054,"SRENGSENG SAWAH, JAGAKARSA, JAKARTA SELATAN, DKI JAKARTA",165,131,123,254
https://kawalpemilu.org#26054,"SRENGSENG SAWAH, JAGAKARSA, JAKARTA SELATAN, DKI JAKARTA",166,78,144,222
https://kawalpemilu.org#26054,"SRENGSENG SAWAH, JAGAKARSA, JAKARTA SELATAN, DKI JAKARTA",167,115,117,232
https://kawalpemilu.org#26054,"SRENGSENG SAWAH, JAGAKARSA, JAKARTA SELATAN, DKI JAKARTA",168,98,125,223
https://kawalpemilu.org#26054,"SRENGSENG SAWAH, JAGAKARSA, JAKARTA SELATAN, DKI JAKARTA",169,60,153,213
https://kawalpemilu.org#26054,"SRENGSENG SAWAH, JAGAKARSA, JAKARTA SELATAN, DKI JAKARTA",170,56,189,245
https://kawalpemilu.org#26054,"SRENGSENG SAWAH, JAGAKARSA, JAKARTA SELATAN, DKI JAKARTA",171,77,132,209
https://kawalpemilu.org#26054,"SRENGSENG SAWAH, JAGAKARSA, JAKARTA SELATAN, DKI JAKARTA",173,101,182,283
https://kawalpemilu.org#26054,"SRENGSENG SAWAH, JAGAKARSA, JAKARTA SELATAN, DKI JAKARTA",176,80,110,190
https://kawalpemilu.org#26054,"SRENGSENG SAWAH, JAGAKARSA, JAKARTA SELATAN, DKI JAKARTA",177,63,142,205
https://kawalpemilu.org#26054,"SRENGSENG SAWAH, JAGAKARSA, JAKARTA SELATAN, DKI JAKARTA",179,105,131,236
https://kawalpemilu.org#26054,"SRENGSENG SAWAH, JAGAKARSA, JAKARTA SELATAN, DKI JAKARTA",180,99,159,258
https://kawalpemilu.org#26055,"CIGANJUR, JAGAKARSA, JAKARTA SELATAN, DKI JAKARTA",1,89,89,178
https://kawalpemilu.org#26055,"CIGANJUR, JAGAKARSA, JAKARTA SELATAN, DKI JAKARTA",2,73,75,148
https://kawalpemilu.org#26055,"CIGANJUR, JAGAKARSA, JAKARTA SELATAN, DKI JAKARTA",3,103,99,202
https://kawalpemilu.org#26055,"CIGANJUR, JAGAKARSA, JAKARTA SELATAN, DKI JAKARTA",4,97,127,224
https://kawalpemilu.org#26055,"CIGANJUR, JAGAKARSA, JAKARTA SELATAN, DKI JAKARTA",5,93,109,202
https://kawalpemilu.org#26055,"CIGANJUR, JAGAKARSA, JAKARTA SELATAN, DKI JAKARTA",6,107,135,242
https://kawalpemilu.org#26055,"CIGANJUR, JAGAKARSA, JAKARTA SELATAN, DKI JAKARTA",7,100,144,244
https://kawalpemilu.org#26055,"CIGANJUR, JAGAKARSA, JAKARTA SELATAN, DKI JAKARTA",8,124,106,230
https://kawalpemilu.org#26055,"CIGANJUR, JAGAKARSA, JAKARTA SELATAN, DKI JAKARTA",9,105,93,198
https://kawalpemilu.org#26055,"CIGANJUR, JAGAKARSA, JAKARTA SELATAN, DKI JAKARTA",10,89,100,189
https://kawalpemilu.org#26055,"CIGANJUR, JAGAKARSA, JAKARTA SELATAN, DKI JAKARTA",11,123,116,239
https://kawalpemilu.org#26055,"CIGANJUR, JAGAKARSA, JAKARTA SELATAN, DKI JAKARTA",12,128,109,237
https://kawalpemilu.org#26055,"CIGANJUR, JAGAKARSA, JAKARTA SELATAN, DKI JAKARTA",13,100,142,242
https://kawalpemilu.org#26055,"CIGANJUR, JAGAKARSA, JAKARTA SELATAN, DKI JAKARTA",14,114,104,218
https://kawalpemilu.org#26055,"CIGANJUR, JAGAKARSA, JAKARTA SELATAN, DKI JAKARTA",15,113,108,221
https://kawalpemilu.org#26055,"CIGANJUR, JAGAKARSA, JAKARTA SELATAN, DKI JAKARTA",16,95,138,233
https://kawalpemilu.org#26055,"CIGANJUR, JAGAKARSA, JAKARTA SELATAN, DKI JAKARTA",17,86,102,188
https://kawalpemilu.org#26055,"CIGANJUR, JAGAKARSA, JAKARTA SELATAN, DKI JAKARTA",18,92,133,225
https://kawalpemilu.org#26055,"CIGANJUR, JAGAKARSA, JAKARTA SELATAN, DKI JAKARTA",19,82,125,207
https://kawalpemilu.org#26055,"CIGANJUR, JAGAKARSA, JAKARTA SELATAN, DKI JAKARTA",20,115,111,226
https://kawalpemilu.org#26055,"CIGANJUR, JAGAKARSA, JAKARTA SELATAN, DKI JAKARTA",21,124,96,220
https://kawalpemilu.org#26055,"CIGANJUR, JAGAKARSA, JAKARTA SELATAN, DKI JAKARTA",22,111,128,239
https://kawalpemilu.org#26055,"CIGANJUR, JAGAKARSA, JAKARTA SELATAN, DKI JAKARTA",23,72,173,245
https://kawalpemilu.org#26055,"CIGANJUR, JAGAKARSA, JAKARTA SELATAN, DKI JAKARTA",24,112,128,240
https://kawalpemilu.org#26055,"CIGANJUR, JAGAKARSA, JAKARTA SELATAN, DKI JAKARTA",25,120,131,251
https://kawalpemilu.org#26055,"CIGANJUR, JAGAKARSA, JAKARTA SELATAN, DKI JAKARTA",26,107,137,244
https://kawalpemilu.org#26055,"CIGANJUR, JAGAKARSA, JAKARTA SELATAN, DKI JAKARTA",27,112,147,259
https://kawalpemilu.org#26055,"CIGANJUR, JAGAKARSA, JAKARTA SELATAN, DKI JAKARTA",28,94,140,234
https://kawalpemilu.org#26055,"CIGANJUR, JAGAKARSA, JAKARTA SELATAN, DKI JAKARTA",29,155,71,226
https://kawalpemilu.org#26055,"CIGANJUR, JAGAKARSA, JAKARTA SELATAN, DKI JAKARTA",30,81,100,181
https://kawalpemilu.org#26055,"CIGANJUR, JAGAKARSA, JAKARTA SELATAN, DKI JAKARTA",31,87,103,190
https://kawalpemilu.org#26055,"CIGANJUR, JAGAKARSA, JAKARTA SELATAN, DKI JAKARTA",32,80,91,171
https://kawalpemilu.org#26055,"CIGANJUR, JAGAKARSA, JAKARTA SELATAN, DKI JAKARTA",33,89,118,207
https://kawalpemilu.org#26055,"CIGANJUR, JAGAKARSA, JAKARTA SELATAN, DKI JAKARTA",34,93,90,183
https://kawalpemilu.org#26055,"CIGANJUR, JAGAKARSA, JAKARTA SELATAN, DKI JAKARTA",35,87,154,241
https://kawalpemilu.org#26055,"CIGANJUR, JAGAKARSA, JAKARTA SELATAN, DKI JAKARTA",36,99,120,219
https://kawalpemilu.org#26055,"CIGANJUR, JAGAKARSA, JAKARTA SELATAN, DKI JAKARTA",37,112,122,234
https://kawalpemilu.org#26055,"CIGANJUR, JAGAKARSA, JAKARTA SELATAN, DKI JAKARTA",38,126,95,221
https://kawalpemilu.org#26055,"CIGANJUR, JAGAKARSA, JAKARTA SELATAN, DKI JAKARTA",39,112,78,190
https://kawalpemilu.org#26055,"CIGANJUR, JAGAKARSA, JAKARTA SELATAN, DKI JAKARTA",40,126,105,231
https://kawalpemilu.org#26055,"CIGANJUR, JAGAKARSA, JAKARTA SELATAN, DKI JAKARTA",41,98,108,206
https://kawalpemilu.org#26055,"CIGANJUR, JAGAKARSA, JAKARTA SELATAN, DKI JAKARTA",42,127,48,175
https://kawalpemilu.org#26055,"CIGANJUR, JAGAKARSA, JAKARTA SELATAN, DKI JAKARTA",43,116,82,198
https://kawalpemilu.org#26055,"CIGANJUR, JAGAKARSA, JAKARTA SELATAN, DKI JAKARTA",44,124,79,203
https://kawalpemilu.org#26055,"CIGANJUR, JAGAKARSA, JAKARTA SELATAN, DKI JAKARTA",45,110,79,189
https://kawalpemilu.org#26055,"CIGANJUR, JAGAKARSA, JAKARTA SELATAN, DKI JAKARTA",46,120,81,201
https://kawalpemilu.org#26055,"CIGANJUR, JAGAKARSA, JAKARTA SELATAN, DKI JAKARTA",47,99,107,206
https://kawalpemilu.org#26055,"CIGANJUR, JAGAKARSA, JAKARTA SELATAN, DKI JAKARTA",48,91,110,201
https://kawalpemilu.org#26055,"CIGANJUR, JAGAKARSA, JAKARTA SELATAN, DKI JAKARTA",49,111,111,222
https://kawalpemilu.org#26055,"CIGANJUR, JAGAKARSA, JAKARTA SELATAN, DKI JAKARTA",50,100,123,223
https://kawalpemilu.org#26055,"CIGANJUR, JAGAKARSA, JAKARTA SELATAN, DKI JAKARTA",51,93,106,199
https://kawalpemilu.org#26055,"CIGANJUR, JAGAKARSA, JAKARTA SELATAN, DKI JAKARTA",52,76,134,210
https://kawalpemilu.org#26055,"CIGANJUR, JAGAKARSA, JAKARTA SELATAN, DKI JAKARTA",53,86,97,183
https://kawalpemilu.org#26055,"CIGANJUR, JAGAKARSA, JAKARTA SELATAN, DKI JAKARTA",54,117,100,217
https://kawalpemilu.org#26055,"CIGANJUR, JAGAKARSA, JAKARTA SELATAN, DKI JAKARTA",55,98,119,217
https://kawalpemilu.org#26055,"CIGANJUR, JAGAKARSA, JAKARTA SELATAN, DKI JAKARTA",56,122,125,247
https://kawalpemilu.org#26055,"CIGANJUR, JAGAKARSA, JAKARTA SELATAN, DKI JAKARTA",57,129,119,248
https://kawalpemilu.org#26055,"CIGANJUR, JAGAKARSA, JAKARTA SELATAN, DKI JAKARTA",59,128,121,249
https://kawalpemilu.org#26055,"CIGANJUR, JAGAKARSA, JAKARTA SELATAN, DKI JAKARTA",60,73,133,206
https://kawalpemilu.org#26055,"CIGANJUR, JAGAKARSA, JAKARTA SELATAN, DKI JAKARTA",61,80,122,202
https://kawalpemilu.org#26055,"CIGANJUR, JAGAKARSA, JAKARTA SELATAN, DKI JAKARTA",62,110,160,270
https://kawalpemilu.org#26055,"CIGANJUR, JAGAKARSA, JAKARTA SELATAN, DKI JAKARTA",63,85,103,188
https://kawalpemilu.org#26055,"CIGANJUR, JAGAKARSA, JAKARTA SELATAN, DKI JAKARTA",64,74,161,235
https://kawalpemilu.org#26055,"CIGANJUR, JAGAKARSA, JAKARTA SELATAN, DKI JAKARTA",65,80,151,231
https://kawalpemilu.org#26055,"CIGANJUR, JAGAKARSA, JAKARTA SELATAN, DKI JAKARTA",66,73,147,220
https://kawalpemilu.org#26055,"CIGANJUR, JAGAKARSA, JAKARTA SELATAN, DKI JAKARTA",67,121,137,258
https://kawalpemilu.org#26055,"CIGANJUR, JAGAKARSA, JAKARTA SELATAN, DKI JAKARTA",68,103,139,242
https://kawalpemilu.org#26055,"CIGANJUR, JAGAKARSA, JAKARTA SELATAN, DKI JAKARTA",69,127,134,261
https://kawalpemilu.org#26055,"CIGANJUR, JAGAKARSA, JAKARTA SELATAN, DKI JAKARTA",70,96,139,235
https://kawalpemilu.org#26055,"CIGANJUR, JAGAKARSA, JAKARTA SELATAN, DKI JAKARTA",71,111,126,237
https://kawalpemilu.org#26055,"CIGANJUR, JAGAKARSA, JAKARTA SELATAN, DKI JAKARTA",72,95,91,186
https://kawalpemilu.org#26055,"CIGANJUR, JAGAKARSA, JAKARTA SELATAN, DKI JAKARTA",73,100,92,192
https://kawalpemilu.org#26055,"CIGANJUR, JAGAKARSA, JAKARTA SELATAN, DKI JAKARTA",74,108,149,257
https://kawalpemilu.org#26055,"CIGANJUR, JAGAKARSA, JAKARTA SELATAN, DKI JAKARTA",75,104,141,245
https://kawalpemilu.org#26055,"CIGANJUR, JAGAKARSA, JAKARTA SELATAN, DKI JAKARTA",76,125,86,211
https://kawalpemilu.org#26055,"CIGANJUR, JAGAKARSA, JAKARTA SELATAN, DKI JAKARTA",77,108,93,201
https://kawalpemilu.org#26055,"CIGANJUR, JAGAKARSA, JAKARTA SELATAN, DKI JAKARTA",78,105,87,192
https://kawalpemilu.org#26055,"CIGANJUR, JAGAKARSA, JAKARTA SELATAN, DKI JAKARTA",79,115,121,236
https://kawalpemilu.org#26055,"CIGANJUR, JAGAKARSA, JAKARTA SELATAN, DKI JAKARTA",80,98,136,234
https://kawalpemilu.org#26055,"CIGANJUR, JAGAKARSA, JAKARTA SELATAN, DKI JAKARTA",81,147,85,232
https://kawalpemilu.org#26055,"CIGANJUR, JAGAKARSA, JAKARTA SELATAN, DKI JAKARTA",82,114,115,229
https://kawalpemilu.org#26055,"CIGANJUR, JAGAKARSA, JAKARTA SELATAN, DKI JAKARTA",83,104,120,224
https://kawalpemilu.org#26055,"CIGANJUR, JAGAKARSA, JAKARTA SELATAN, DKI JAKARTA",84,136,123,259
https://kawalpemilu.org#26055,"CIGANJUR, JAGAKARSA, JAKARTA SELATAN, DKI JAKARTA",86,110,96,206
https://kawalpemilu.org#26055,"CIGANJUR, JAGAKARSA, JAKARTA SELATAN, DKI JAKARTA",87,103,118,221
https://kawalpemilu.org#26055,"CIGANJUR, JAGAKARSA, JAKARTA SELATAN, DKI JAKARTA",88,79,84,163
https://kawalpemilu.org#26055,"CIGANJUR, JAGAKARSA, JAKARTA SELATAN, DKI JAKARTA",89,106,124,230
https://kawalpemilu.org#26055,"CIGANJUR, JAGAKARSA, JAKARTA SELATAN, DKI JAKARTA",90,70,90,160
https://kawalpemilu.org#26055,"CIGANJUR, JAGAKARSA, JAKARTA SELATAN, DKI JAKARTA",91,132,90,222
https://kawalpemilu.org#26055,"CIGANJUR, JAGAKARSA, JAKARTA SELATAN, DKI JAKARTA",92,119,101,220
https://kawalpemilu.org#26055,"CIGANJUR, JAGAKARSA, JAKARTA SELATAN, DKI JAKARTA",93,121,87,208
https://kawalpemilu.org#26055,"CIGANJUR, JAGAKARSA, JAKARTA SELATAN, DKI JAKARTA",94,109,95,204
https://kawalpemilu.org#26055,"CIGANJUR, JAGAKARSA, JAKARTA SELATAN, DKI JAKARTA",95,110,93,203
https://kawalpemilu.org#26055,"CIGANJUR, JAGAKARSA, JAKARTA SELATAN, DKI JAKARTA",96,139,112,251
https://kawalpemilu.org#26055,"CIGANJUR, JAGAKARSA, JAKARTA SELATAN, DKI JAKARTA",97,95,81,176
https://kawalpemilu.org#26055,"CIGANJUR, JAGAKARSA, JAKARTA SELATAN, DKI JAKARTA",98,69,89,158
https://kawalpemilu.org#26055,"CIGANJUR, JAGAKARSA, JAKARTA SELATAN, DKI JAKARTA",100,60,147,207
https://kawalpemilu.org#26055,"CIGANJUR, JAGAKARSA, JAKARTA SELATAN, DKI JAKARTA",102,88,111,199
https://kawalpemilu.org#26055,"CIGANJUR, JAGAKARSA, JAKARTA SELATAN, DKI JAKARTA",103,82,113,195
https://kawalpemilu.org#26055,"CIGANJUR, JAGAKARSA, JAKARTA SELATAN, DKI JAKARTA",104,89,140,229
https://kawalpemilu.org#26055,"CIGANJUR, JAGAKARSA, JAKARTA SELATAN, DKI JAKARTA",105,67,155,222
https://kawalpemilu.org#26055,"CIGANJUR, JAGAKARSA, JAKARTA SELATAN, DKI JAKARTA",106,88,144,232
https://kawalpemilu.org#26055,"CIGANJUR, JAGAKARSA, JAKARTA SELATAN, DKI JAKARTA",107,101,174,275
https://kawalpemilu.org#26055,"CIGANJUR, JAGAKARSA, JAKARTA SELATAN, DKI JAKARTA",108,95,147,242
https://kawalpemilu.org#26055,"CIGANJUR, JAGAKARSA, JAKARTA SELATAN, DKI JAKARTA",109,84,182,266
https://kawalpemilu.org#26055,"CIGANJUR, JAGAKARSA, JAKARTA SELATAN, DKI JAKARTA",110,100,147,247
https://kawalpemilu.org#26055,"CIGANJUR, JAGAKARSA, JAKARTA SELATAN, DKI JAKARTA",111,121,107,228
https://kawalpemilu.org#26055,"CIGANJUR, JAGAKARSA, JAKARTA SELATAN, DKI JAKARTA",112,95,121,216
https://kawalpemilu.org#26055,"CIGANJUR, JAGAKARSA, JAKARTA SELATAN, DKI JAKARTA",113,105,134,239
https://kawalpemilu.org#26055,"CIGANJUR, JAGAKARSA, JAKARTA SELATAN, DKI JAKARTA",114,123,116,239
https://kawalpemilu.org#26055,"CIGANJUR, JAGAKARSA, JAKARTA SELATAN, DKI JAKARTA",115,112,87,199
https://kawalpemilu.org#26055,"CIGANJUR, JAGAKARSA, JAKARTA SELATAN, DKI JAKARTA",116,138,79,217
https://kawalpemilu.org#26055,"CIGANJUR, JAGAKARSA, JAKARTA SELATAN, DKI JAKARTA",117,153,83,236
https://kawalpemilu.org#26055,"CIGANJUR, JAGAKARSA, JAKARTA SELATAN, DKI JAKARTA",118,0,0,0
https://kawalpemilu.org#26055,"CIGANJUR, JAGAKARSA, JAKARTA SELATAN, DKI JAKARTA",119,102,70,172
https://kawalpemilu.org#26055,"CIGANJUR, JAGAKARSA, JAKARTA SELATAN, DKI JAKARTA",120,101,77,178
https://kawalpemilu.org#26055,"CIGANJUR, JAGAKARSA, JAKARTA SELATAN, DKI JAKARTA",121,141,91,232
https://kawalpemilu.org#26055,"CIGANJUR, JAGAKARSA, JAKARTA SELATAN, DKI JAKARTA",122,140,94,234
https://kawalpemilu.org#26055,"CIGANJUR, JAGAKARSA, JAKARTA SELATAN, DKI JAKARTA",123,87,141,228
https://kawalpemilu.org#26055,"CIGANJUR, JAGAKARSA, JAKARTA SELATAN, DKI JAKARTA",124,84,51,135
https://kawalpemilu.org#26055,"CIGANJUR, JAGAKARSA, JAKARTA SELATAN, DKI JAKARTA",125,61,112,173
https://kawalpemilu.org#26056,"LENTENG AGUNG, JAGAKARSA, JAKARTA SELATAN, DKI JAKARTA",2,122,121,243
https://kawalpemilu.org#26056,"LENTENG AGUNG, JAGAKARSA, JAKARTA SELATAN, DKI JAKARTA",3,121,54,175
https://kawalpemilu.org#26056,"LENTENG AGUNG, JAGAKARSA, JAKARTA SELATAN, DKI JAKARTA",5,87,85,172
https://kawalpemilu.org#26056,"LENTENG AGUNG, JAGAKARSA, JAKARTA SELATAN, DKI JAKARTA",7,119,89,208
https://kawalpemilu.org#26056,"LENTENG AGUNG, JAGAKARSA, JAKARTA SELATAN, DKI JAKARTA",8,117,113,230
https://kawalpemilu.org#26056,"LENTENG AGUNG, JAGAKARSA, JAKARTA SELATAN, DKI JAKARTA",9,118,63,181
https://kawalpemilu.org#26056,"LENTENG AGUNG, JAGAKARSA, JAKARTA SELATAN, DKI JAKARTA",10,92,72,164
https://kawalpemilu.org#26056,"LENTENG AGUNG, JAGAKARSA, JAKARTA SELATAN, DKI JAKARTA",11,107,91,198
https://kawalpemilu.org#26056,"LENTENG AGUNG, JAGAKARSA, JAKARTA SELATAN, DKI JAKARTA",14,92,124,216
https://kawalpemilu.org#26056,"LENTENG AGUNG, JAGAKARSA, JAKARTA SELATAN, DKI JAKARTA",15,55,163,218
https://kawalpemilu.org#26056,"LENTENG AGUNG, JAGAKARSA, JAKARTA SELATAN, DKI JAKARTA",16,96,110,206
https://kawalpemilu.org#26056,"LENTENG AGUNG, JAGAKARSA, JAKARTA SELATAN, DKI JAKARTA",17,68,127,195
https://kawalpemilu.org#26056,"LENTENG AGUNG, JAGAKARSA, JAKARTA SELATAN, DKI JAKARTA",18,43,131,174
https://kawalpemilu.org#26056,"LENTENG AGUNG, JAGAKARSA, JAKARTA SELATAN, DKI JAKARTA",19,102,138,240
https://kawalpemilu.org#26056,"LENTENG AGUNG, JAGAKARSA, JAKARTA SELATAN, DKI JAKARTA",20,111,134,245
https://kawalpemilu.org#26056,"LENTENG AGUNG, JAGAKARSA, JAKARTA SELATAN, DKI JAKARTA",21,98,137,235
https://kawalpemilu.org#26056,"LENTENG AGUNG, JAGAKARSA, JAKARTA SELATAN, DKI JAKARTA",22,81,158,239
https://kawalpemilu.org#26056,"LENTENG AGUNG, JAGAKARSA, JAKARTA SELATAN, DKI JAKARTA",23,88,146,234
https://kawalpemilu.org#26056,"LENTENG AGUNG, JAGAKARSA, JAKARTA SELATAN, DKI JAKARTA",24,93,96,189
https://kawalpemilu.org#26056,"LENTENG AGUNG, JAGAKARSA, JAKARTA SELATAN, DKI JAKARTA",25,109,114,223
https://kawalpemilu.org#26056,"LENTENG AGUNG, JAGAKARSA, JAKARTA SELATAN, DKI JAKARTA",26,92,95,187
https://kawalpemilu.org#26056,"LENTENG AGUNG, JAGAKARSA, JAKARTA SELATAN, DKI JAKARTA",27,96,117,213
https://kawalpemilu.org#26056,"LENTENG AGUNG, JAGAKARSA, JAKARTA SELATAN, DKI JAKARTA",28,99,101,200
https://kawalpemilu.org#26056,"LENTENG AGUNG, JAGAKARSA, JAKARTA SELATAN, DKI JAKARTA",30,101,141,242
https://kawalpemilu.org#26056,"LENTENG AGUNG, JAGAKARSA, JAKARTA SELATAN, DKI JAKARTA",31,104,135,239
https://kawalpemilu.org#26056,"LENTENG AGUNG, JAGAKARSA, JAKARTA SELATAN, DKI JAKARTA",32,99,148,247
https://kawalpemilu.org#26056,"LENTENG AGUNG, JAGAKARSA, JAKARTA SELATAN, DKI JAKARTA",33,102,119,221
https://kawalpemilu.org#26056,"LENTENG AGUNG, JAGAKARSA, JAKARTA SELATAN, DKI JAKARTA",34,117,126,243
https://kawalpemilu.org#26056,"LENTENG AGUNG, JAGAKARSA, JAKARTA SELATAN, DKI JAKARTA",35,94,134,228
https://kawalpemilu.org#26056,"LENTENG AGUNG, JAGAKARSA, JAKARTA SELATAN, DKI JAKARTA",36,67,126,193
https://kawalpemilu.org#26056,"LENTENG AGUNG, JAGAKARSA, JAKARTA SELATAN, DKI JAKARTA",37,85,136,221
https://kawalpemilu.org#26056,"LENTENG AGUNG, JAGAKARSA, JAKARTA SELATAN, DKI JAKARTA",39,67,138,205
https://kawalpemilu.org#26056,"LENTENG AGUNG, JAGAKARSA, JAKARTA SELATAN, DKI JAKARTA",41,76,133,209
https://kawalpemilu.org#26056,"LENTENG AGUNG, JAGAKARSA, JAKARTA SELATAN, DKI JAKARTA",43,99,120,219
https://kawalpemilu.org#26056,"LENTENG AGUNG, JAGAKARSA, JAKARTA SELATAN, DKI JAKARTA",44,104,126,230
https://kawalpemilu.org#26056,"LENTENG AGUNG, JAGAKARSA, JAKARTA SELATAN, DKI JAKARTA",45,91,132,223
https://kawalpemilu.org#26056,"LENTENG AGUNG, JAGAKARSA, JAKARTA SELATAN, DKI JAKARTA",46,96,132,228
https://kawalpemilu.org#26056,"LENTENG AGUNG, JAGAKARSA, JAKARTA SELATAN, DKI JAKARTA",47,128,115,243
https://kawalpemilu.org#26056,"LENTENG AGUNG, JAGAKARSA, JAKARTA SELATAN, DKI JAKARTA",48,103,131,234
https://kawalpemilu.org#26056,"LENTENG AGUNG, JAGAKARSA, JAKARTA SELATAN, DKI JAKARTA",49,85,173,258
https://kawalpemilu.org#26056,"LENTENG AGUNG, JAGAKARSA, JAKARTA SELATAN, DKI JAKARTA",50,89,144,233
https://kawalpemilu.org#26056,"LENTENG AGUNG, JAGAKARSA, JAKARTA SELATAN, DKI JAKARTA",51,52,108,160
https://kawalpemilu.org#26056,"LENTENG AGUNG, JAGAKARSA, JAKARTA SELATAN, DKI JAKARTA",52,63,105,168
https://kawalpemilu.org#26056,"LENTENG AGUNG, JAGAKARSA, JAKARTA SELATAN, DKI JAKARTA",53,115,132,247
https://kawalpemilu.org#26056,"LENTENG AGUNG, JAGAKARSA, JAKARTA SELATAN, DKI JAKARTA",54,100,144,244
https://kawalpemilu.org#26056,"LENTENG AGUNG, JAGAKARSA, JAKARTA SELATAN, DKI JAKARTA",55,82,110,192
https://kawalpemilu.org#26056,"LENTENG AGUNG, JAGAKARSA, JAKARTA SELATAN, DKI JAKARTA",56,85,112,197
https://kawalpemilu.org#26056,"LENTENG AGUNG, JAGAKARSA, JAKARTA SELATAN, DKI JAKARTA",57,69,151,220
https://kawalpemilu.org#26056,"LENTENG AGUNG, JAGAKARSA, JAKARTA SELATAN, DKI JAKARTA",58,90,135,225
https://kawalpemilu.org#26056,"LENTENG AGUNG, JAGAKARSA, JAKARTA SELATAN, DKI JAKARTA",59,78,169,247
https://kawalpemilu.org#26056,"LENTENG AGUNG, JAGAKARSA, JAKARTA SELATAN, DKI JAKARTA",60,97,147,244
https://kawalpemilu.org#26056,"LENTENG AGUNG, JAGAKARSA, JAKARTA SELATAN, DKI JAKARTA",61,89,157,246
https://kawalpemilu.org#26056,"LENTENG AGUNG, JAGAKARSA, JAKARTA SELATAN, DKI JAKARTA",62,85,165,250
https://kawalpemilu.org#26056,"LENTENG AGUNG, JAGAKARSA, JAKARTA SELATAN, DKI JAKARTA",63,105,104,209
https://kawalpemilu.org#26056,"LENTENG AGUNG, JAGAKARSA, JAKARTA SELATAN, DKI JAKARTA",64,83,84,167
https://kawalpemilu.org#26056,"LENTENG AGUNG, JAGAKARSA, JAKARTA SELATAN, DKI JAKARTA",66,117,99,216
https://kawalpemilu.org#26056,"LENTENG AGUNG, JAGAKARSA, JAKARTA SELATAN, DKI JAKARTA",67,98,131,229
https://kawalpemilu.org#26056,"LENTENG AGUNG, JAGAKARSA, JAKARTA SELATAN, DKI JAKARTA",68,85,150,235
https://kawalpemilu.org#26056,"LENTENG AGUNG, JAGAKARSA, JAKARTA SELATAN, DKI JAKARTA",69,95,123,218
https://kawalpemilu.org#26056,"LENTENG AGUNG, JAGAKARSA, JAKARTA SELATAN, DKI JAKARTA",70,102,127,229
https://kawalpemilu.org#26056,"LENTENG AGUNG, JAGAKARSA, JAKARTA SELATAN, DKI JAKARTA",72,74,86,160
https://kawalpemilu.org#26056,"LENTENG AGUNG, JAGAKARSA, JAKARTA SELATAN, DKI JAKARTA",73,89,146,235
https://kawalpemilu.org#26056,"LENTENG AGUNG, JAGAKARSA, JAKARTA SELATAN, DKI JAKARTA",74,78,174,252
https://kawalpemilu.org#26056,"LENTENG AGUNG, JAGAKARSA, JAKARTA SELATAN, DKI JAKARTA",75,71,87,158
https://kawalpemilu.org#26056,"LENTENG AGUNG, JAGAKARSA, JAKARTA SELATAN, DKI JAKARTA",76,76,104,180
https://kawalpemilu.org#26056,"LENTENG AGUNG, JAGAKARSA, JAKARTA SELATAN, DKI JAKARTA",77,76,113,189
https://kawalpemilu.org#26056,"LENTENG AGUNG, JAGAKARSA, JAKARTA SELATAN, DKI JAKARTA",79,42,155,197
https://kawalpemilu.org#26056,"LENTENG AGUNG, JAGAKARSA, JAKARTA SELATAN, DKI JAKARTA",80,99,98,197
https://kawalpemilu.org#26056,"LENTENG AGUNG, JAGAKARSA, JAKARTA SELATAN, DKI JAKARTA",82,71,119,190
https://kawalpemilu.org#26056,"LENTENG AGUNG, JAGAKARSA, JAKARTA SELATAN, DKI JAKARTA",83,0,0,0
https://kawalpemilu.org#26056,"LENTENG AGUNG, JAGAKARSA, JAKARTA SELATAN, DKI JAKARTA",85,94,138,232
https://kawalpemilu.org#26056,"LENTENG AGUNG, JAGAKARSA, JAKARTA SELATAN, DKI JAKARTA",87,58,131,189
https://kawalpemilu.org#26056,"LENTENG AGUNG, JAGAKARSA, JAKARTA SELATAN, DKI JAKARTA",88,100,148,248
https://kawalpemilu.org#26056,"LENTENG AGUNG, JAGAKARSA, JAKARTA SELATAN, DKI JAKARTA",91,63,97,160
https://kawalpemilu.org#26056,"LENTENG AGUNG, JAGAKARSA, JAKARTA SELATAN, DKI JAKARTA",92,86,97,183
https://kawalpemilu.org#26056,"LENTENG AGUNG, JAGAKARSA, JAKARTA SELATAN, DKI JAKARTA",93,80,88,168
https://kawalpemilu.org#26056,"LENTENG AGUNG, JAGAKARSA, JAKARTA SELATAN, DKI JAKARTA",94,117,114,231
https://kawalpemilu.org#26056,"LENTENG AGUNG, JAGAKARSA, JAKARTA SELATAN, DKI JAKARTA",95,89,90,179
https://kawalpemilu.org#26056,"LENTENG AGUNG, JAGAKARSA, JAKARTA SELATAN, DKI JAKARTA",96,68,173,241
https://kawalpemilu.org#26056,"LENTENG AGUNG, JAGAKARSA, JAKARTA SELATAN, DKI JAKARTA",98,66,141,207
https://kawalpemilu.org#26056,"LENTENG AGUNG, JAGAKARSA, JAKARTA SELATAN, DKI JAKARTA",100,79,127,206
https://kawalpemilu.org#26056,"LENTENG AGUNG, JAGAKARSA, JAKARTA SELATAN, DKI JAKARTA",102,57,124,181
https://kawalpemilu.org#26056,"LENTENG AGUNG, JAGAKARSA, JAKARTA SELATAN, DKI JAKARTA",103,93,153,246
https://kawalpemilu.org#26056,"LENTENG AGUNG, JAGAKARSA, JAKARTA SELATAN, DKI JAKARTA",104,85,135,220
https://kawalpemilu.org#26056,"LENTENG AGUNG, JAGAKARSA, JAKARTA SELATAN, DKI JAKARTA",105,74,102,176
https://kawalpemilu.org#26056,"LENTENG AGUNG, JAGAKARSA, JAKARTA SELATAN, DKI JAKARTA",106,93,111,204
https://kawalpemilu.org#26056,"LENTENG AGUNG, JAGAKARSA, JAKARTA SELATAN, DKI JAKARTA",111,90,128,218
https://kawalpemilu.org#26056,"LENTENG AGUNG, JAGAKARSA, JAKARTA SELATAN, DKI JAKARTA",112,74,128,202
https://kawalpemilu.org#26056,"LENTENG AGUNG, JAGAKARSA, JAKARTA SELATAN, DKI JAKARTA",118,83,76,159
https://kawalpemilu.org#26056,"LENTENG AGUNG, JAGAKARSA, JAKARTA SELATAN, DKI JAKARTA",125,95,110,205
https://kawalpemilu.org#26056,"LENTENG AGUNG, JAGAKARSA, JAKARTA SELATAN, DKI JAKARTA",130,132,114,246
https://kawalpemilu.org#26056,"LENTENG AGUNG, JAGAKARSA, JAKARTA SELATAN, DKI JAKARTA",131,70,156,226
https://kawalpemilu.org#26056,"LENTENG AGUNG, JAGAKARSA, JAKARTA SELATAN, DKI JAKARTA",132,90,148,238
https://kawalpemilu.org#26056,"LENTENG AGUNG, JAGAKARSA, JAKARTA SELATAN, DKI JAKARTA",133,95,131,226
https://kawalpemilu.org#26056,"LENTENG AGUNG, JAGAKARSA, JAKARTA SELATAN, DKI JAKARTA",137,148,106,254
https://kawalpemilu.org#26056,"LENTENG AGUNG, JAGAKARSA, JAKARTA SELATAN, DKI JAKARTA",138,98,102,200
https://kawalpemilu.org#26056,"LENTENG AGUNG, JAGAKARSA, JAKARTA SELATAN, DKI JAKARTA",139,121,125,246
https://kawalpemilu.org#26056,"LENTENG AGUNG, JAGAKARSA, JAKARTA SELATAN, DKI JAKARTA",140,120,109,229
https://kawalpemilu.org#26056,"LENTENG AGUNG, JAGAKARSA, JAKARTA SELATAN, DKI JAKARTA",141,89,130,219
https://kawalpemilu.org#26056,"LENTENG AGUNG, JAGAKARSA, JAKARTA SELATAN, DKI JAKARTA",142,80,141,221
https://kawalpemilu.org#26056,"LENTENG AGUNG, JAGAKARSA, JAKARTA SELATAN, DKI JAKARTA",145,73,128,201
https://kawalpemilu.org#26056,"LENTENG AGUNG, JAGAKARSA, JAKARTA SELATAN, DKI JAKARTA",146,88,118,206
https://kawalpemilu.org#26056,"LENTENG AGUNG, JAGAKARSA, JAKARTA SELATAN, DKI JAKARTA",147,135,127,262
https://kawalpemilu.org#26056,"LENTENG AGUNG, JAGAKARSA, JAKARTA SELATAN, DKI JAKARTA",148,127,105,232
https://kawalpemilu.org#26056,"LENTENG AGUNG, JAGAKARSA, JAKARTA SELATAN, DKI JAKARTA",149,115,115,230
https://kawalpemilu.org#26056,"LENTENG AGUNG, JAGAKARSA, JAKARTA SELATAN, DKI JAKARTA",150,58,125,183
https://kawalpemilu.org#26056,"LENTENG AGUNG, JAGAKARSA, JAKARTA SELATAN, DKI JAKARTA",152,54,154,208
https://kawalpemilu.org#26056,"LENTENG AGUNG, JAGAKARSA, JAKARTA SELATAN, DKI JAKARTA",153,94,89,183
https://kawalpemilu.org#26056,"LENTENG AGUNG, JAGAKARSA, JAKARTA SELATAN, DKI JAKARTA",156,100,110,210
https://kawalpemilu.org#26056,"LENTENG AGUNG, JAGAKARSA, JAKARTA SELATAN, DKI JAKARTA",158,83,130,213
https://kawalpemilu.org#26056,"LENTENG AGUNG, JAGAKARSA, JAKARTA SELATAN, DKI JAKARTA",159,97,126,223
https://kawalpemilu.org#26056,"LENTENG AGUNG, JAGAKARSA, JAKARTA SELATAN, DKI JAKARTA",162,119,99,218
https://kawalpemilu.org#26056,"LENTENG AGUNG, JAGAKARSA, JAKARTA SELATAN, DKI JAKARTA",164,108,83,191
https://kawalpemilu.org#26056,"LENTENG AGUNG, JAGAKARSA, JAKARTA SELATAN, DKI JAKARTA",165,107,81,188
https://kawalpemilu.org#26056,"LENTENG AGUNG, JAGAKARSA, JAKARTA SELATAN, DKI JAKARTA",166,106,136,242
https://kawalpemilu.org#26056,"LENTENG AGUNG, JAGAKARSA, JAKARTA SELATAN, DKI JAKARTA",167,114,107,221
https://kawalpemilu.org#26056,"LENTENG AGUNG, JAGAKARSA, JAKARTA SELATAN, DKI JAKARTA",181,62,93,155
https://kawalpemilu.org#26056,"LENTENG AGUNG, JAGAKARSA, JAKARTA SELATAN, DKI JAKARTA",184,97,87,184
https://kawalpemilu.org#26056,"LENTENG AGUNG, JAGAKARSA, JAKARTA SELATAN, DKI JAKARTA",185,108,66,174
https://kawalpemilu.org#26057,"TANJUNG BARAT, JAGAKARSA, JAKARTA SELATAN, DKI JAKARTA",1,85,94,179
https://kawalpemilu.org#26057,"TANJUNG BARAT, JAGAKARSA, JAKARTA SELATAN, DKI JAKARTA",2,128,89,217
https://kawalpemilu.org#26057,"TANJUNG BARAT, JAGAKARSA, JAKARTA SELATAN, DKI JAKARTA",3,126,82,208
https://kawalpemilu.org#26057,"TANJUNG BARAT, JAGAKARSA, JAKARTA SELATAN, DKI JAKARTA",4,114,79,193
https://kawalpemilu.org#26057,"TANJUNG BARAT, JAGAKARSA, JAKARTA SELATAN, DKI JAKARTA",5,113,85,198
https://kawalpemilu.org#26057,"TANJUNG BARAT, JAGAKARSA, JAKARTA SELATAN, DKI JAKARTA",6,111,84,195
https://kawalpemilu.org#26057,"TANJUNG BARAT, JAGAKARSA, JAKARTA SELATAN, DKI JAKARTA",7,64,175,239
https://kawalpemilu.org#26057,"TANJUNG BARAT, JAGAKARSA, JAKARTA SELATAN, DKI JAKARTA",8,65,124,189
https://kawalpemilu.org#26057,"TANJUNG BARAT, JAGAKARSA, JAKARTA SELATAN, DKI JAKARTA",9,62,106,168
https://kawalpemilu.org#26057,"TANJUNG BARAT, JAGAKARSA, JAKARTA SELATAN, DKI JAKARTA",10,65,124,189
https://kawalpemilu.org#26057,"TANJUNG BARAT, JAGAKARSA, JAKARTA SELATAN, DKI JAKARTA",11,84,170,254
https://kawalpemilu.org#26057,"TANJUNG BARAT, JAGAKARSA, JAKARTA SELATAN, DKI JAKARTA",12,93,134,227
https://kawalpemilu.org#26057,"TANJUNG BARAT, JAGAKARSA, JAKARTA SELATAN, DKI JAKARTA",13,55,133,188
https://kawalpemilu.org#26057,"TANJUNG BARAT, JAGAKARSA, JAKARTA SELATAN, DKI JAKARTA",14,53,164,217
https://kawalpemilu.org#26057,"TANJUNG BARAT, JAGAKARSA, JAKARTA SELATAN, DKI JAKARTA",15,62,138,200
https://kawalpemilu.org#26057,"TANJUNG BARAT, JAGAKARSA, JAKARTA SELATAN, DKI JAKARTA",16,84,148,232
https://kawalpemilu.org#26057,"TANJUNG BARAT, JAGAKARSA, JAKARTA SELATAN, DKI JAKARTA",19,90,81,171
https://kawalpemilu.org#26057,"TANJUNG BARAT, JAGAKARSA, JAKARTA SELATAN, DKI JAKARTA",20,77,165,242
https://kawalpemilu.org#26057,"TANJUNG BARAT, JAGAKARSA, JAKARTA SELATAN, DKI JAKARTA",21,76,129,205
https://kawalpemilu.org#26057,"TANJUNG BARAT, JAGAKARSA, JAKARTA SELATAN, DKI JAKARTA",22,67,108,175
https://kawalpemilu.org#26057,"TANJUNG BARAT, JAGAKARSA, JAKARTA SELATAN, DKI JAKARTA",23,91,107,198
https://kawalpemilu.org#26057,"TANJUNG BARAT, JAGAKARSA, JAKARTA SELATAN, DKI JAKARTA",24,79,135,214
https://kawalpemilu.org#26057,"TANJUNG BARAT, JAGAKARSA, JAKARTA SELATAN, DKI JAKARTA",25,126,61,187
https://kawalpemilu.org#26057,"TANJUNG BARAT, JAGAKARSA, JAKARTA SELATAN, DKI JAKARTA",26,118,58,176
https://kawalpemilu.org#26057,"TANJUNG BARAT, JAGAKARSA, JAKARTA SELATAN, DKI JAKARTA",27,90,81,171
https://kawalpemilu.org#26057,"TANJUNG BARAT, JAGAKARSA, JAKARTA SELATAN, DKI JAKARTA",28,126,58,184
https://kawalpemilu.org#26057,"TANJUNG BARAT, JAGAKARSA, JAKARTA SELATAN, DKI JAKARTA",29,123,55,178
https://kawalpemilu.org#26057,"TANJUNG BARAT, JAGAKARSA, JAKARTA SELATAN, DKI JAKARTA",31,77,149,226
https://kawalpemilu.org#26057,"TANJUNG BARAT, JAGAKARSA, JAKARTA SELATAN, DKI JAKARTA",33,85,116,201
https://kawalpemilu.org#26057,"TANJUNG BARAT, JAGAKARSA, JAKARTA SELATAN, DKI JAKARTA",34,110,53,163
https://kawalpemilu.org#26057,"TANJUNG BARAT, JAGAKARSA, JAKARTA SELATAN, DKI JAKARTA",35,111,67,178
https://kawalpemilu.org#26057,"TANJUNG BARAT, JAGAKARSA, JAKARTA SELATAN, DKI JAKARTA",36,82,116,198
https://kawalpemilu.org#26057,"TANJUNG BARAT, JAGAKARSA, JAKARTA SELATAN, DKI JAKARTA",37,70,119,189
https://kawalpemilu.org#26057,"TANJUNG BARAT, JAGAKARSA, JAKARTA SELATAN, DKI JAKARTA",38,84,122,206
https://kawalpemilu.org#26057,"TANJUNG BARAT, JAGAKARSA, JAKARTA SELATAN, DKI JAKARTA",39,77,168,245
https://kawalpemilu.org#26057,"TANJUNG BARAT, JAGAKARSA, JAKARTA SELATAN, DKI JAKARTA",40,88,161,249
https://kawalpemilu.org#26057,"TANJUNG BARAT, JAGAKARSA, JAKARTA SELATAN, DKI JAKARTA",41,100,135,235
https://kawalpemilu.org#26057,"TANJUNG BARAT, JAGAKARSA, JAKARTA SELATAN, DKI JAKARTA",42,65,136,201
https://kawalpemilu.org#26057,"TANJUNG BARAT, JAGAKARSA, JAKARTA SELATAN, DKI JAKARTA",43,84,118,202
https://kawalpemilu.org#26057,"TANJUNG BARAT, JAGAKARSA, JAKARTA SELATAN, DKI JAKARTA",45,63,159,222
https://kawalpemilu.org#26057,"TANJUNG BARAT, JAGAKARSA, JAKARTA SELATAN, DKI JAKARTA",46,51,164,215
https://kawalpemilu.org#26057,"TANJUNG BARAT, JAGAKARSA, JAKARTA SELATAN, DKI JAKARTA",47,67,151,218
https://kawalpemilu.org#26057,"TANJUNG BARAT, JAGAKARSA, JAKARTA SELATAN, DKI JAKARTA",48,139,54,193
https://kawalpemilu.org#26057,"TANJUNG BARAT, JAGAKARSA, JAKARTA SELATAN, DKI JAKARTA",49,110,78,188
https://kawalpemilu.org#26057,"TANJUNG BARAT, JAGAKARSA, JAKARTA SELATAN, DKI JAKARTA",50,86,150,236
https://kawalpemilu.org#26057,"TANJUNG BARAT, JAGAKARSA, JAKARTA SELATAN, DKI JAKARTA",52,64,175,239
https://kawalpemilu.org#26057,"TANJUNG BARAT, JAGAKARSA, JAKARTA SELATAN, DKI JAKARTA",53,79,151,230
https://kawalpemilu.org#26057,"TANJUNG BARAT, JAGAKARSA, JAKARTA SELATAN, DKI JAKARTA",54,57,171,228
https://kawalpemilu.org#26057,"TANJUNG BARAT, JAGAKARSA, JAKARTA SELATAN, DKI JAKARTA",55,49,193,242
https://kawalpemilu.org#26057,"TANJUNG BARAT, JAGAKARSA, JAKARTA SELATAN, DKI JAKARTA",56,75,156,231
https://kawalpemilu.org#26057,"TANJUNG BARAT, JAGAKARSA, JAKARTA SELATAN, DKI JAKARTA",57,102,156,258
https://kawalpemilu.org#26057,"TANJUNG BARAT, JAGAKARSA, JAKARTA SELATAN, DKI JAKARTA",58,87,149,236
https://kawalpemilu.org#26057,"TANJUNG BARAT, JAGAKARSA, JAKARTA SELATAN, DKI JAKARTA",59,65,164,229
https://kawalpemilu.org#26057,"TANJUNG BARAT, JAGAKARSA, JAKARTA SELATAN, DKI JAKARTA",60,54,175,229
https://kawalpemilu.org#26057,"TANJUNG BARAT, JAGAKARSA, JAKARTA SELATAN, DKI JAKARTA",61,60,165,225
https://kawalpemilu.org#26057,"TANJUNG BARAT, JAGAKARSA, JAKARTA SELATAN, DKI JAKARTA",62,53,140,193
https://kawalpemilu.org#26057,"TANJUNG BARAT, JAGAKARSA, JAKARTA SELATAN, DKI JAKARTA",63,42,148,190
https://kawalpemilu.org#26057,"TANJUNG BARAT, JAGAKARSA, JAKARTA SELATAN, DKI JAKARTA",64,75,114,189
https://kawalpemilu.org#26057,"TANJUNG BARAT, JAGAKARSA, JAKARTA SELATAN, DKI JAKARTA",65,80,140,220
https://kawalpemilu.org#26057,"TANJUNG BARAT, JAGAKARSA, JAKARTA SELATAN, DKI JAKARTA",66,129,107,236
https://kawalpemilu.org#26057,"TANJUNG BARAT, JAGAKARSA, JAKARTA SELATAN, DKI JAKARTA",67,82,115,197
https://kawalpemilu.org#26057,"TANJUNG BARAT, JAGAKARSA, JAKARTA SELATAN, DKI JAKARTA",68,51,89,140
https://kawalpemilu.org#26057,"TANJUNG BARAT, JAGAKARSA, JAKARTA SELATAN, DKI JAKARTA",69,87,134,221
https://kawalpemilu.org#26057,"TANJUNG BARAT, JAGAKARSA, JAKARTA SELATAN, DKI JAKARTA",70,92,104,196
https://kawalpemilu.org#26057,"TANJUNG BARAT, JAGAKARSA, JAKARTA SELATAN, DKI JAKARTA",71,69,122,191
https://kawalpemilu.org#26057,"TANJUNG BARAT, JAGAKARSA, JAKARTA SELATAN, DKI JAKARTA",72,96,128,224
https://kawalpemilu.org#26057,"TANJUNG BARAT, JAGAKARSA, JAKARTA SELATAN, DKI JAKARTA",73,89,118,207
https://kawalpemilu.org#26057,"TANJUNG BARAT, JAGAKARSA, JAKARTA SELATAN, DKI JAKARTA",75,70,86,156
https://kawalpemilu.org#26057,"TANJUNG BARAT, JAGAKARSA, JAKARTA SELATAN, DKI JAKARTA",76,74,120,194
https://kawalpemilu.org#26057,"TANJUNG BARAT, JAGAKARSA, JAKARTA SELATAN, DKI JAKARTA",77,82,118,200
https://kawalpemilu.org#26057,"TANJUNG BARAT, JAGAKARSA, JAKARTA SELATAN, DKI JAKARTA",78,76,160,236
https://kawalpemilu.org#26057,"TANJUNG BARAT, JAGAKARSA, JAKARTA SELATAN, DKI JAKARTA",79,98,149,247
https://kawalpemilu.org#26057,"TANJUNG BARAT, JAGAKARSA, JAKARTA SELATAN, DKI JAKARTA",80,70,111,181
https://kawalpemilu.org#26057,"TANJUNG BARAT, JAGAKARSA, JAKARTA SELATAN, DKI JAKARTA",81,75,116,191
https://kawalpemilu.org#26057,"TANJUNG BARAT, JAGAKARSA, JAKARTA SELATAN, DKI JAKARTA",87,67,128,195
https://kawalpemilu.org#26057,"TANJUNG BARAT, JAGAKARSA, JAKARTA SELATAN, DKI JAKARTA",88,114,93,207
https://kawalpemilu.org#26057,"TANJUNG BARAT, JAGAKARSA, JAKARTA SELATAN, DKI JAKARTA",90,75,77,152
https://kawalpemilu.org#26057,"TANJUNG BARAT, JAGAKARSA, JAKARTA SELATAN, DKI JAKARTA",91,81,85,166
https://kawalpemilu.org#26057,"TANJUNG BARAT, JAGAKARSA, JAKARTA SELATAN, DKI JAKARTA",92,80,136,216
https://kawalpemilu.org#26057,"TANJUNG BARAT, JAGAKARSA, JAKARTA SELATAN, DKI JAKARTA",93,82,139,221
https://kawalpemilu.org#26057,"TANJUNG BARAT, JAGAKARSA, JAKARTA SELATAN, DKI JAKARTA",96,98,110,208
https://kawalpemilu.org#26057,"TANJUNG BARAT, JAGAKARSA, JAKARTA SELATAN, DKI JAKARTA",98,68,118,186
https://kawalpemilu.org#26057,"TANJUNG BARAT, JAGAKARSA, JAKARTA SELATAN, DKI JAKARTA",99,51,132,183
https://kawalpemilu.org#26057,"TANJUNG BARAT, JAGAKARSA, JAKARTA SELATAN, DKI JAKARTA",100,98,135,233
https://kawalpemilu.org#26057,"TANJUNG BARAT, JAGAKARSA, JAKARTA SELATAN, DKI JAKARTA",101,93,138,231
https://kawalpemilu.org#26057,"TANJUNG BARAT, JAGAKARSA, JAKARTA SELATAN, DKI JAKARTA",102,55,134,189
https://kawalpemilu.org#26057,"TANJUNG BARAT, JAGAKARSA, JAKARTA SELATAN, DKI JAKARTA",104,69,104,173
https://kawalpemilu.org#26057,"TANJUNG BARAT, JAGAKARSA, JAKARTA SELATAN, DKI JAKARTA",105,86,143,229
https://kawalpemilu.org#26057,"TANJUNG BARAT, JAGAKARSA, JAKARTA SELATAN, DKI JAKARTA",107,94,129,223
https://kawalpemilu.org#26057,"TANJUNG BARAT, JAGAKARSA, JAKARTA SELATAN, DKI JAKARTA",113,85,107,192
https://kawalpemilu.org#26057,"TANJUNG BARAT, JAGAKARSA, JAKARTA SELATAN, DKI JAKARTA",114,75,114,189
https://kawalpemilu.org#26057,"TANJUNG BARAT, JAGAKARSA, JAKARTA SELATAN, DKI JAKARTA",115,57,181,238
https://kawalpemilu.org#26057,"TANJUNG BARAT, JAGAKARSA, JAKARTA SELATAN, DKI JAKARTA",116,91,123,214
https://kawalpemilu.org#26057,"TANJUNG BARAT, JAGAKARSA, JAKARTA SELATAN, DKI JAKARTA",117,60,122,182
https://kawalpemilu.org#26057,"TANJUNG BARAT, JAGAKARSA, JAKARTA SELATAN, DKI JAKARTA",118,56,134,190
https://kawalpemilu.org#26057,"TANJUNG BARAT, JAGAKARSA, JAKARTA SELATAN, DKI JAKARTA",119,56,142,198
https://kawalpemilu.org#26057,"TANJUNG BARAT, JAGAKARSA, JAKARTA SELATAN, DKI JAKARTA",120,57,122,179
https://kawalpemilu.org#26057,"TANJUNG BARAT, JAGAKARSA, JAKARTA SELATAN, DKI JAKARTA",121,69,138,207
https://kawalpemilu.org#26057,"TANJUNG BARAT, JAGAKARSA, JAKARTA SELATAN, DKI JAKARTA",122,68,151,219
https://kawalpemilu.org#26057,"TANJUNG BARAT, JAGAKARSA, JAKARTA SELATAN, DKI JAKARTA",123,68,155,223
https://kawalpemilu.org#26057,"TANJUNG BARAT, JAGAKARSA, JAKARTA SELATAN, DKI JAKARTA",124,81,119,200
https://kawalpemilu.org#26057,"TANJUNG BARAT, JAGAKARSA, JAKARTA SELATAN, DKI JAKARTA",125,76,100,176
https://kawalpemilu.org#26057,"TANJUNG BARAT, JAGAKARSA, JAKARTA SELATAN, DKI JAKARTA",127,83,96,179
https://kawalpemilu.org#26057,"TANJUNG BARAT, JAGAKARSA, JAKARTA SELATAN, DKI JAKARTA",128,58,125,183
https://kawalpemilu.org#26057,"TANJUNG BARAT, JAGAKARSA, JAKARTA SELATAN, DKI JAKARTA",129,60,131,191
https://kawalpemilu.org#26057,"TANJUNG BARAT, JAGAKARSA, JAKARTA SELATAN, DKI JAKARTA",130,50,152,202
https://kawalpemilu.org#26057,"TANJUNG BARAT, JAGAKARSA, JAKARTA SELATAN, DKI JAKARTA",131,77,105,182
https://kawalpemilu.org#26057,"TANJUNG BARAT, JAGAKARSA, JAKARTA SELATAN, DKI JAKARTA",132,74,167,241
https://kawalpemilu.org#26057,"TANJUNG BARAT, JAGAKARSA, JAKARTA SELATAN, DKI JAKARTA",133,60,131,191
https://kawalpemilu.org#26057,"TANJUNG BARAT, JAGAKARSA, JAKARTA SELATAN, DKI JAKARTA",134,75,146,221
https://kawalpemilu.org#26057,"TANJUNG BARAT, JAGAKARSA, JAKARTA SELATAN, DKI JAKARTA",137,92,87,179
https://kawalpemilu.org#26057,"TANJUNG BARAT, JAGAKARSA, JAKARTA SELATAN, DKI JAKARTA",138,80,125,205
https://kawalpemilu.org#26057,"TANJUNG BARAT, JAGAKARSA, JAKARTA SELATAN, DKI JAKARTA",140,83,83,166
https://kawalpemilu.org#26057,"TANJUNG BARAT, JAGAKARSA, JAKARTA SELATAN, DKI JAKARTA",141,62,116,178
https://kawalpemilu.org#26058,"CIPEDAK, JAGAKARSA, JAKARTA SELATAN, DKI JAKARTA",1,87,104,191
https://kawalpemilu.org#26058,"CIPEDAK, JAGAKARSA, JAKARTA SELATAN, DKI JAKARTA",2,108,94,202
https://kawalpemilu.org#26058,"CIPEDAK, JAGAKARSA, JAKARTA SELATAN, DKI JAKARTA",3,85,92,177
https://kawalpemilu.org#26058,"CIPEDAK, JAGAKARSA, JAKARTA SELATAN, DKI JAKARTA",5,114,83,197
https://kawalpemilu.org#26058,"CIPEDAK, JAGAKARSA, JAKARTA SELATAN, DKI JAKARTA",6,94,125,219
https://kawalpemilu.org#26058,"CIPEDAK, JAGAKARSA, JAKARTA SELATAN, DKI JAKARTA",8,131,107,238
https://kawalpemilu.org#26058,"CIPEDAK, JAGAKARSA, JAKARTA SELATAN, DKI JAKARTA",9,95,98,193
https://kawalpemilu.org#26058,"CIPEDAK, JAGAKARSA, JAKARTA SELATAN, DKI JAKARTA",10,82,126,208
https://kawalpemilu.org#26058,"CIPEDAK, JAGAKARSA, JAKARTA SELATAN, DKI JAKARTA",11,97,110,207
https://kawalpemilu.org#26058,"CIPEDAK, JAGAKARSA, JAKARTA SELATAN, DKI JAKARTA",12,105,102,207
https://kawalpemilu.org#26058,"CIPEDAK, JAGAKARSA, JAKARTA SELATAN, DKI JAKARTA",13,101,112,213
https://kawalpemilu.org#26058,"CIPEDAK, JAGAKARSA, JAKARTA SELATAN, DKI JAKARTA",14,81,85,166
https://kawalpemilu.org#26058,"CIPEDAK, JAGAKARSA, JAKARTA SELATAN, DKI JAKARTA",19,88,126,214
https://kawalpemilu.org#26058,"CIPEDAK, JAGAKARSA, JAKARTA SELATAN, DKI JAKARTA",20,94,132,226
https://kawalpemilu.org#26058,"CIPEDAK, JAGAKARSA, JAKARTA SELATAN, DKI JAKARTA",22,109,115,224
https://kawalpemilu.org#26058,"CIPEDAK, JAGAKARSA, JAKARTA SELATAN, DKI JAKARTA",23,108,91,199
https://kawalpemilu.org#26058,"CIPEDAK, JAGAKARSA, JAKARTA SELATAN, DKI JAKARTA",24,110,87,197
https://kawalpemilu.org#26058,"CIPEDAK, JAGAKARSA, JAKARTA SELATAN, DKI JAKARTA",25,120,75,195
https://kawalpemilu.org#26058,"CIPEDAK, JAGAKARSA, JAKARTA SELATAN, DKI JAKARTA",26,107,106,213
https://kawalpemilu.org#26058,"CIPEDAK, JAGAKARSA, JAKARTA SELATAN, DKI JAKARTA",27,100,113,213
https://kawalpemilu.org#26058,"CIPEDAK, JAGAKARSA, JAKARTA SELATAN, DKI JAKARTA",28,70,133,203
https://kawalpemilu.org#26058,"CIPEDAK, JAGAKARSA, JAKARTA SELATAN, DKI JAKARTA",30,84,143,227
https://kawalpemilu.org#26058,"CIPEDAK, JAGAKARSA, JAKARTA SELATAN, DKI JAKARTA",31,113,128,241
https://kawalpemilu.org#26058,"CIPEDAK, JAGAKARSA, JAKARTA SELATAN, DKI JAKARTA",32,95,114,209
https://kawalpemilu.org#26058,"CIPEDAK, JAGAKARSA, JAKARTA SELATAN, DKI JAKARTA",33,91,111,202
https://kawalpemilu.org#26058,"CIPEDAK, JAGAKARSA, JAKARTA SELATAN, DKI JAKARTA",35,86,116,202
https://kawalpemilu.org#26058,"CIPEDAK, JAGAKARSA, JAKARTA SELATAN, DKI JAKARTA",36,97,94,191
https://kawalpemilu.org#26058,"CIPEDAK, JAGAKARSA, JAKARTA SELATAN, DKI JAKARTA",37,107,116,223
https://kawalpemilu.org#26058,"CIPEDAK, JAGAKARSA, JAKARTA SELATAN, DKI JAKARTA",38,134,110,244
https://kawalpemilu.org#26058,"CIPEDAK, JAGAKARSA, JAKARTA SELATAN, DKI JAKARTA",39,136,116,252
https://kawalpemilu.org#26058,"CIPEDAK, JAGAKARSA, JAKARTA SELATAN, DKI JAKARTA",41,87,129,216
https://kawalpemilu.org#26058,"CIPEDAK, JAGAKARSA, JAKARTA SELATAN, DKI JAKARTA",42,99,143,242
https://kawalpemilu.org#26058,"CIPEDAK, JAGAKARSA, JAKARTA SELATAN, DKI JAKARTA",43,93,137,230
https://kawalpemilu.org#26058,"CIPEDAK, JAGAKARSA, JAKARTA SELATAN, DKI JAKARTA",44,106,142,248
https://kawalpemilu.org#26058,"CIPEDAK, JAGAKARSA, JAKARTA SELATAN, DKI JAKARTA",45,65,135,200
https://kawalpemilu.org#26058,"CIPEDAK, JAGAKARSA, JAKARTA SELATAN, DKI JAKARTA",46,82,101,183
https://kawalpemilu.org#26058,"CIPEDAK, JAGAKARSA, JAKARTA SELATAN, DKI JAKARTA",47,171,62,233
https://kawalpemilu.org#26058,"CIPEDAK, JAGAKARSA, JAKARTA SELATAN, DKI JAKARTA",48,168,74,242
https://kawalpemilu.org#26058,"CIPEDAK, JAGAKARSA, JAKARTA SELATAN, DKI JAKARTA",49,103,130,233
https://kawalpemilu.org#26058,"CIPEDAK, JAGAKARSA, JAKARTA SELATAN, DKI JAKARTA",50,95,145,240
https://kawalpemilu.org#26058,"CIPEDAK, JAGAKARSA, JAKARTA SELATAN, DKI JAKARTA",51,101,117,218
https://kawalpemilu.org#26058,"CIPEDAK, JAGAKARSA, JAKARTA SELATAN, DKI JAKARTA",52,114,117,231
https://kawalpemilu.org#26058,"CIPEDAK, JAGAKARSA, JAKARTA SELATAN, DKI JAKARTA",53,86,131,217
https://kawalpemilu.org#26058,"CIPEDAK, JAGAKARSA, JAKARTA SELATAN, DKI JAKARTA",54,0,0,0
https://kawalpemilu.org#26058,"CIPEDAK, JAGAKARSA, JAKARTA SELATAN, DKI JAKARTA",55,93,161,254
https://kawalpemilu.org#26058,"CIPEDAK, JAGAKARSA, JAKARTA SELATAN, DKI JAKARTA",56,120,118,238
https://kawalpemilu.org#26058,"CIPEDAK, JAGAKARSA, JAKARTA SELATAN, DKI JAKARTA",57,141,112,253
https://kawalpemilu.org#26058,"CIPEDAK, JAGAKARSA, JAKARTA SELATAN, DKI JAKARTA",58,126,87,213
https://kawalpemilu.org#26058,"CIPEDAK, JAGAKARSA, JAKARTA SELATAN, DKI JAKARTA",60,76,117,193
https://kawalpemilu.org#26058,"CIPEDAK, JAGAKARSA, JAKARTA SELATAN, DKI JAKARTA",65,54,203,257
https://kawalpemilu.org#26058,"CIPEDAK, JAGAKARSA, JAKARTA SELATAN, DKI JAKARTA",67,63,148,211
https://kawalpemilu.org#26058,"CIPEDAK, JAGAKARSA, JAKARTA SELATAN, DKI JAKARTA",68,73,153,226
https://kawalpemilu.org#26058,"CIPEDAK, JAGAKARSA, JAKARTA SELATAN, DKI JAKARTA",69,53,129,182
https://kawalpemilu.org#26058,"CIPEDAK, JAGAKARSA, JAKARTA SELATAN, DKI JAKARTA",70,90,139,229
https://kawalpemilu.org#26058,"CIPEDAK, JAGAKARSA, JAKARTA SELATAN, DKI JAKARTA",71,64,166,230
https://kawalpemilu.org#26058,"CIPEDAK, JAGAKARSA, JAKARTA SELATAN, DKI JAKARTA",72,87,118,205
https://kawalpemilu.org#26058,"CIPEDAK, JAGAKARSA, JAKARTA SELATAN, DKI JAKARTA",75,79,117,196
https://kawalpemilu.org#26058,"CIPEDAK, JAGAKARSA, JAKARTA SELATAN, DKI JAKARTA",76,90,126,216
https://kawalpemilu.org#26058,"CIPEDAK, JAGAKARSA, JAKARTA SELATAN, DKI JAKARTA",77,105,117,222
https://kawalpemilu.org#26058,"CIPEDAK, JAGAKARSA, JAKARTA SELATAN, DKI JAKARTA",79,104,118,222
https://kawalpemilu.org#26058,"CIPEDAK, JAGAKARSA, JAKARTA SELATAN, DKI JAKARTA",80,124,123,247
https://kawalpemilu.org#26058,"CIPEDAK, JAGAKARSA, JAKARTA SELATAN, DKI JAKARTA",81,62,125,187
https://kawalpemilu.org#26058,"CIPEDAK, JAGAKARSA, JAKARTA SELATAN, DKI JAKARTA",83,103,141,244
https://kawalpemilu.org#26058,"CIPEDAK, JAGAKARSA, JAKARTA SELATAN, DKI JAKARTA",85,108,91,199
https://kawalpemilu.org#26058,"CIPEDAK, JAGAKARSA, JAKARTA SELATAN, DKI JAKARTA",86,79,97,176
https://kawalpemilu.org#26058,"CIPEDAK, JAGAKARSA, JAKARTA SELATAN, DKI JAKARTA",88,101,135,236
https://kawalpemilu.org#26058,"CIPEDAK, JAGAKARSA, JAKARTA SELATAN, DKI JAKARTA",89,82,144,226
https://kawalpemilu.org#26058,"CIPEDAK, JAGAKARSA, JAKARTA SELATAN, DKI JAKARTA",90,110,130,240
https://kawalpemilu.org#26058,"CIPEDAK, JAGAKARSA, JAKARTA SELATAN, DKI JAKARTA",93,90,160,250
https://kawalpemilu.org#26058,"CIPEDAK, JAGAKARSA, JAKARTA SELATAN, DKI JAKARTA",94,98,137,235
https://kawalpemilu.org#26058,"CIPEDAK, JAGAKARSA, JAKARTA SELATAN, DKI JAKARTA",95,113,112,225
https://kawalpemilu.org#26058,"CIPEDAK, JAGAKARSA, JAKARTA SELATAN, DKI JAKARTA",98,110,136,246
https://kawalpemilu.org#26058,"CIPEDAK, JAGAKARSA, JAKARTA SELATAN, DKI JAKARTA",100,110,138,248
https://kawalpemilu.org#26058,"CIPEDAK, JAGAKARSA, JAKARTA SELATAN, DKI JAKARTA",101,132,137,269
https://kawalpemilu.org#26058,"CIPEDAK, JAGAKARSA, JAKARTA SELATAN, DKI JAKARTA",104,87,124,211
https://kawalpemilu.org#26058,"CIPEDAK, JAGAKARSA, JAKARTA SELATAN, DKI JAKARTA",106,120,104,224
https://kawalpemilu.org#26058,"CIPEDAK, JAGAKARSA, JAKARTA SELATAN, DKI JAKARTA",108,103,140,243
https://kawalpemilu.org#26058,"CIPEDAK, JAGAKARSA, JAKARTA SELATAN, DKI JAKARTA",109,91,144,235
https://kawalpemilu.org#26058,"CIPEDAK, JAGAKARSA, JAKARTA SELATAN, DKI JAKARTA",110,87,100,187
https://kawalpemilu.org#26058,"CIPEDAK, JAGAKARSA, JAKARTA SELATAN, DKI JAKARTA",113,106,153,259
https://kawalpemilu.org#26058,"CIPEDAK, JAGAKARSA, JAKARTA SELATAN, DKI JAKARTA",115,117,115,232
https://kawalpemilu.org#26058,"CIPEDAK, JAGAKARSA, JAKARTA SELATAN, DKI JAKARTA",116,106,109,215
https://kawalpemilu.org#26058,"CIPEDAK, JAGAKARSA, JAKARTA SELATAN, DKI JAKARTA",117,93,113,206
https://kawalpemilu.org#26058,"CIPEDAK, JAGAKARSA, JAKARTA SELATAN, DKI JAKARTA",118,95,81,176
https://kawalpemilu.org#26058,"CIPEDAK, JAGAKARSA, JAKARTA SELATAN, DKI JAKARTA",119,97,83,180
https://kawalpemilu.org#26058,"CIPEDAK, JAGAKARSA, JAKARTA SELATAN, DKI JAKARTA",120,96,113,209
https://kawalpemilu.org#26058,"CIPEDAK, JAGAKARSA, JAKARTA SELATAN, DKI JAKARTA",121,77,109,186
https://kawalpemilu.org#26058,"CIPEDAK, JAGAKARSA, JAKARTA SELATAN, DKI JAKARTA",122,113,102,215
https://kawalpemilu.org#26058,"CIPEDAK, JAGAKARSA, JAKARTA SELATAN, DKI JAKARTA",123,128,118,246
https://kawalpemilu.org#26060,"PESANGGRAHAN, PESANGGRAHAN, JAKARTA SELATAN, DKI JAKARTA",1,117,113,230
https://kawalpemilu.org#26060,"PESANGGRAHAN, PESANGGRAHAN, JAKARTA SELATAN, DKI JAKARTA",2,76,135,211
https://kawalpemilu.org#26060,"PESANGGRAHAN, PESANGGRAHAN, JAKARTA SELATAN, DKI JAKARTA",5,119,110,229
https://kawalpemilu.org#26060,"PESANGGRAHAN, PESANGGRAHAN, JAKARTA SELATAN, DKI JAKARTA",6,121,122,243
https://kawalpemilu.org#26060,"PESANGGRAHAN, PESANGGRAHAN, JAKARTA SELATAN, DKI JAKARTA",7,103,119,222
https://kawalpemilu.org#26060,"PESANGGRAHAN, PESANGGRAHAN, JAKARTA SELATAN, DKI JAKARTA",8,107,141,248
https://kawalpemilu.org#26060,"PESANGGRAHAN, PESANGGRAHAN, JAKARTA SELATAN, DKI JAKARTA",9,147,113,260
https://kawalpemilu.org#26060,"PESANGGRAHAN, PESANGGRAHAN, JAKARTA SELATAN, DKI JAKARTA",10,149,103,252
https://kawalpemilu.org#26060,"PESANGGRAHAN, PESANGGRAHAN, JAKARTA SELATAN, DKI JAKARTA",12,116,103,219
https://kawalpemilu.org#26060,"PESANGGRAHAN, PESANGGRAHAN, JAKARTA SELATAN, DKI JAKARTA",13,118,94,212
https://kawalpemilu.org#26060,"PESANGGRAHAN, PESANGGRAHAN, JAKARTA SELATAN, DKI JAKARTA",14,75,128,203
https://kawalpemilu.org#26060,"PESANGGRAHAN, PESANGGRAHAN, JAKARTA SELATAN, DKI JAKARTA",15,84,111,195
https://kawalpemilu.org#26060,"PESANGGRAHAN, PESANGGRAHAN, JAKARTA SELATAN, DKI JAKARTA",16,96,96,192
https://kawalpemilu.org#26060,"PESANGGRAHAN, PESANGGRAHAN, JAKARTA SELATAN, DKI JAKARTA",17,138,74,212
https://kawalpemilu.org#26060,"PESANGGRAHAN, PESANGGRAHAN, JAKARTA SELATAN, DKI JAKARTA",19,68,131,199
https://kawalpemilu.org#26060,"PESANGGRAHAN, PESANGGRAHAN, JAKARTA SELATAN, DKI JAKARTA",21,119,124,243
https://kawalpemilu.org#26060,"PESANGGRAHAN, PESANGGRAHAN, JAKARTA SELATAN, DKI JAKARTA",22,94,137,231
https://kawalpemilu.org#26060,"PESANGGRAHAN, PESANGGRAHAN, JAKARTA SELATAN, DKI JAKARTA",23,71,164,235
https://kawalpemilu.org#26060,"PESANGGRAHAN, PESANGGRAHAN, JAKARTA SELATAN, DKI JAKARTA",24,131,119,250
https://kawalpemilu.org#26060,"PESANGGRAHAN, PESANGGRAHAN, JAKARTA SELATAN, DKI JAKARTA",25,132,114,246
https://kawalpemilu.org#26060,"PESANGGRAHAN, PESANGGRAHAN, JAKARTA SELATAN, DKI JAKARTA",26,92,132,224
https://kawalpemilu.org#26060,"PESANGGRAHAN, PESANGGRAHAN, JAKARTA SELATAN, DKI JAKARTA",27,66,139,205
https://kawalpemilu.org#26060,"PESANGGRAHAN, PESANGGRAHAN, JAKARTA SELATAN, DKI JAKARTA",28,80,125,205
https://kawalpemilu.org#26060,"PESANGGRAHAN, PESANGGRAHAN, JAKARTA SELATAN, DKI JAKARTA",29,88,80,168
https://kawalpemilu.org#26060,"PESANGGRAHAN, PESANGGRAHAN, JAKARTA SELATAN, DKI JAKARTA",30,117,71,188
https://kawalpemilu.org#26060,"PESANGGRAHAN, PESANGGRAHAN, JAKARTA SELATAN, DKI JAKARTA",31,122,63,185
https://kawalpemilu.org#26060,"PESANGGRAHAN, PESANGGRAHAN, JAKARTA SELATAN, DKI JAKARTA",32,125,79,204
https://kawalpemilu.org#26060,"PESANGGRAHAN, PESANGGRAHAN, JAKARTA SELATAN, DKI JAKARTA",33,112,123,235
https://kawalpemilu.org#26060,"PESANGGRAHAN, PESANGGRAHAN, JAKARTA SELATAN, DKI JAKARTA",34,0,0,0
https://kawalpemilu.org#26060,"PESANGGRAHAN, PESANGGRAHAN, JAKARTA SELATAN, DKI JAKARTA",35,152,97,249
https://kawalpemilu.org#26060,"PESANGGRAHAN, PESANGGRAHAN, JAKARTA SELATAN, DKI JAKARTA",36,0,0,0
https://kawalpemilu.org#26060,"PESANGGRAHAN, PESANGGRAHAN, JAKARTA SELATAN, DKI JAKARTA",38,132,116,248
https://kawalpemilu.org#26060,"PESANGGRAHAN, PESANGGRAHAN, JAKARTA SELATAN, DKI JAKARTA",39,90,115,205
https://kawalpemilu.org#26060,"PESANGGRAHAN, PESANGGRAHAN, JAKARTA SELATAN, DKI JAKARTA",40,109,125,234
https://kawalpemilu.org#26060,"PESANGGRAHAN, PESANGGRAHAN, JAKARTA SELATAN, DKI JAKARTA",41,0,0,0
https://kawalpemilu.org#26060,"PESANGGRAHAN, PESANGGRAHAN, JAKARTA SELATAN, DKI JAKARTA",42,105,114,219
https://kawalpemilu.org#26060,"PESANGGRAHAN, PESANGGRAHAN, JAKARTA SELATAN, DKI JAKARTA",43,121,126,247
https://kawalpemilu.org#26060,"PESANGGRAHAN, PESANGGRAHAN, JAKARTA SELATAN, DKI JAKARTA",44,122,102,224
https://kawalpemilu.org#26060,"PESANGGRAHAN, PESANGGRAHAN, JAKARTA SELATAN, DKI JAKARTA",45,122,98,22
https://kawalpemilu.org#26060,"PESANGGRAHAN, PESANGGRAHAN, JAKARTA SELATAN, DKI JAKARTA",46,123,97,220
https://kawalpemilu.org#26060,"PESANGGRAHAN, PESANGGRAHAN, JAKARTA SELATAN, DKI JAKARTA",47,101,111,212
https://kawalpemilu.org#26060,"PESANGGRAHAN, PESANGGRAHAN, JAKARTA SELATAN, DKI JAKARTA",48,103,86,189
https://kawalpemilu.org#26060,"PESANGGRAHAN, PESANGGRAHAN, JAKARTA SELATAN, DKI JAKARTA",49,98,119,217
https://kawalpemilu.org#26060,"PESANGGRAHAN, PESANGGRAHAN, JAKARTA SELATAN, DKI JAKARTA",50,73,156,267
https://kawalpemilu.org#26060,"PESANGGRAHAN, PESANGGRAHAN, JAKARTA SELATAN, DKI JAKARTA",51,49,155,204
https://kawalpemilu.org#26060,"PESANGGRAHAN, PESANGGRAHAN, JAKARTA SELATAN, DKI JAKARTA",52,58,137,195
https://kawalpemilu.org#26060,"PESANGGRAHAN, PESANGGRAHAN, JAKARTA SELATAN, DKI JAKARTA",53,32,139,171
https://kawalpemilu.org#26060,"PESANGGRAHAN, PESANGGRAHAN, JAKARTA SELATAN, DKI JAKARTA",54,46,160,206
https://kawalpemilu.org#26060,"PESANGGRAHAN, PESANGGRAHAN, JAKARTA SELATAN, DKI JAKARTA",55,43,162,205
https://kawalpemilu.org#26060,"PESANGGRAHAN, PESANGGRAHAN, JAKARTA SELATAN, DKI JAKARTA",56,150,79,229
https://kawalpemilu.org#26060,"PESANGGRAHAN, PESANGGRAHAN, JAKARTA SELATAN, DKI JAKARTA",57,160,86,246
https://kawalpemilu.org#26060,"PESANGGRAHAN, PESANGGRAHAN, JAKARTA SELATAN, DKI JAKARTA",58,141,58,199
https://kawalpemilu.org#26060,"PESANGGRAHAN, PESANGGRAHAN, JAKARTA SELATAN, DKI JAKARTA",59,138,56,194
https://kawalpemilu.org#26060,"PESANGGRAHAN, PESANGGRAHAN, JAKARTA SELATAN, DKI JAKARTA",60,114,103,217
https://kawalpemilu.org#26060,"PESANGGRAHAN, PESANGGRAHAN, JAKARTA SELATAN, DKI JAKARTA",61,132,64,196
https://kawalpemilu.org#26060,"PESANGGRAHAN, PESANGGRAHAN, JAKARTA SELATAN, DKI JAKARTA",62,98,82,180
https://kawalpemilu.org#26060,"PESANGGRAHAN, PESANGGRAHAN, JAKARTA SELATAN, DKI JAKARTA",63,157,64,221
https://kawalpemilu.org#26060,"PESANGGRAHAN, PESANGGRAHAN, JAKARTA SELATAN, DKI JAKARTA",64,137,84,221
https://kawalpemilu.org#26060,"PESANGGRAHAN, PESANGGRAHAN, JAKARTA SELATAN, DKI JAKARTA",65,120,78,198
https://kawalpemilu.org#26060,"PESANGGRAHAN, PESANGGRAHAN, JAKARTA SELATAN, DKI JAKARTA",66,130,90,220
https://kawalpemilu.org#26060,"PESANGGRAHAN, PESANGGRAHAN, JAKARTA SELATAN, DKI JAKARTA",67,83,137,220
https://kawalpemilu.org#26060,"PESANGGRAHAN, PESANGGRAHAN, JAKARTA SELATAN, DKI JAKARTA",68,0,0,0
https://kawalpemilu.org#26060,"PESANGGRAHAN, PESANGGRAHAN, JAKARTA SELATAN, DKI JAKARTA",69,82,122,204
https://kawalpemilu.org#26060,"PESANGGRAHAN, PESANGGRAHAN, JAKARTA SELATAN, DKI JAKARTA",70,107,115,222
https://kawalpemilu.org#26060,"PESANGGRAHAN, PESANGGRAHAN, JAKARTA SELATAN, DKI JAKARTA",71,114,97,211
https://kawalpemilu.org#26060,"PESANGGRAHAN, PESANGGRAHAN, JAKARTA SELATAN, DKI JAKARTA",72,173,79,252
https://kawalpemilu.org#26060,"PESANGGRAHAN, PESANGGRAHAN, JAKARTA SELATAN, DKI JAKARTA",73,158,63,221
https://kawalpemilu.org#26060,"PESANGGRAHAN, PESANGGRAHAN, JAKARTA SELATAN, DKI JAKARTA",74,148,93,241
https://kawalpemilu.org#26060,"PESANGGRAHAN, PESANGGRAHAN, JAKARTA SELATAN, DKI JAKARTA",75,134,107,241
https://kawalpemilu.org#26060,"PESANGGRAHAN, PESANGGRAHAN, JAKARTA SELATAN, DKI JAKARTA",76,145,102,247
https://kawalpemilu.org#26060,"PESANGGRAHAN, PESANGGRAHAN, JAKARTA SELATAN, DKI JAKARTA",77,136,99,235
https://kawalpemilu.org#26060,"PESANGGRAHAN, PESANGGRAHAN, JAKARTA SELATAN, DKI JAKARTA",78,158,89,247
https://kawalpemilu.org#26060,"PESANGGRAHAN, PESANGGRAHAN, JAKARTA SELATAN, DKI JAKARTA",79,136,81,217
https://kawalpemilu.org#26060,"PESANGGRAHAN, PESANGGRAHAN, JAKARTA SELATAN, DKI JAKARTA",80,153,65,218
https://kawalpemilu.org#26060,"PESANGGRAHAN, PESANGGRAHAN, JAKARTA SELATAN, DKI JAKARTA",81,151,50,201
https://kawalpemilu.org#26060,"PESANGGRAHAN, PESANGGRAHAN, JAKARTA SELATAN, DKI JAKARTA",82,178,47,225
https://kawalpemilu.org#26060,"PESANGGRAHAN, PESANGGRAHAN, JAKARTA SELATAN, DKI JAKARTA",83,150,69,219
https://kawalpemilu.org#26060,"PESANGGRAHAN, PESANGGRAHAN, JAKARTA SELATAN, DKI JAKARTA",84,168,66,234
https://kawalpemilu.org#26060,"PESANGGRAHAN, PESANGGRAHAN, JAKARTA SELATAN, DKI JAKARTA",85,158,63,221
https://kawalpemilu.org#26060,"PESANGGRAHAN, PESANGGRAHAN, JAKARTA SELATAN, DKI JAKARTA",86,141,54,195
https://kawalpemilu.org#26060,"PESANGGRAHAN, PESANGGRAHAN, JAKARTA SELATAN, DKI JAKARTA",87,129,69,198
https://kawalpemilu.org#26061,"BINTARO, PESANGGRAHAN, JAKARTA SELATAN, DKI JAKARTA",1,157,98,255
https://kawalpemilu.org#26061,"BINTARO, PESANGGRAHAN, JAKARTA SELATAN, DKI JAKARTA",2,141,76,217
https://kawalpemilu.org#26061,"BINTARO, PESANGGRAHAN, JAKARTA SELATAN, DKI JAKARTA",4,66,103,169
https://kawalpemilu.org#26061,"BINTARO, PESANGGRAHAN, JAKARTA SELATAN, DKI JAKARTA",5,71,93,164
https://kawalpemilu.org#26061,"BINTARO, PESANGGRAHAN, JAKARTA SELATAN, DKI JAKARTA",6,79,184,263
https://kawalpemilu.org#26061,"BINTARO, PESANGGRAHAN, JAKARTA SELATAN, DKI JAKARTA",7,87,86,173
https://kawalpemilu.org#26061,"BINTARO, PESANGGRAHAN, JAKARTA SELATAN, DKI JAKARTA",8,103,141,244
https://kawalpemilu.org#26061,"BINTARO, PESANGGRAHAN, JAKARTA SELATAN, DKI JAKARTA",9,80,171,251
https://kawalpemilu.org#26061,"BINTARO, PESANGGRAHAN, JAKARTA SELATAN, DKI JAKARTA",10,86,135,221
https://kawalpemilu.org#26061,"BINTARO, PESANGGRAHAN, JAKARTA SELATAN, DKI JAKARTA",11,106,146,252
https://kawalpemilu.org#26061,"BINTARO, PESANGGRAHAN, JAKARTA SELATAN, DKI JAKARTA",12,119,109,228
https://kawalpemilu.org#26061,"BINTARO, PESANGGRAHAN, JAKARTA SELATAN, DKI JAKARTA",13,132,81,218
https://kawalpemilu.org#26061,"BINTARO, PESANGGRAHAN, JAKARTA SELATAN, DKI JAKARTA",14,166,97,263
https://kawalpemilu.org#26061,"BINTARO, PESANGGRAHAN, JAKARTA SELATAN, DKI JAKARTA",15,144,126,270
https://kawalpemilu.org#26061,"BINTARO, PESANGGRAHAN, JAKARTA SELATAN, DKI JAKARTA",16,146,99,245
https://kawalpemilu.org#26061,"BINTARO, PESANGGRAHAN, JAKARTA SELATAN, DKI JAKARTA",17,160,77,237
https://kawalpemilu.org#26061,"BINTARO, PESANGGRAHAN, JAKARTA SELATAN, DKI JAKARTA",18,173,72,245
https://kawalpemilu.org#26061,"BINTARO, PESANGGRAHAN, JAKARTA SELATAN, DKI JAKARTA",20,163,89,252
https://kawalpemilu.org#26061,"BINTARO, PESANGGRAHAN, JAKARTA SELATAN, DKI JAKARTA",21,147,100,247
https://kawalpemilu.org#26061,"BINTARO, PESANGGRAHAN, JAKARTA SELATAN, DKI JAKARTA",22,150,94,244
https://kawalpemilu.org#26061,"BINTARO, PESANGGRAHAN, JAKARTA SELATAN, DKI JAKARTA",23,130,89,219
https://kawalpemilu.org#26061,"BINTARO, PESANGGRAHAN, JAKARTA SELATAN, DKI JAKARTA",24,123,133,256
https://kawalpemilu.org#26061,"BINTARO, PESANGGRAHAN, JAKARTA SELATAN, DKI JAKARTA",25,121,145,266
https://kawalpemilu.org#26061,"BINTARO, PESANGGRAHAN, JAKARTA SELATAN, DKI JAKARTA",26,151,112,263
https://kawalpemilu.org#26061,"BINTARO, PESANGGRAHAN, JAKARTA SELATAN, DKI JAKARTA",27,129,119,248
https://kawalpemilu.org#26061,"BINTARO, PESANGGRAHAN, JAKARTA SELATAN, DKI JAKARTA",28,130,108,238
https://kawalpemilu.org#26061,"BINTARO, PESANGGRAHAN, JAKARTA SELATAN, DKI JAKARTA",29,139,135,274
https://kawalpemilu.org#26061,"BINTARO, PESANGGRAHAN, JAKARTA SELATAN, DKI JAKARTA",31,151,131,282
https://kawalpemilu.org#26061,"BINTARO, PESANGGRAHAN, JAKARTA SELATAN, DKI JAKARTA",32,93,89,182
https://kawalpemilu.org#26061,"BINTARO, PESANGGRAHAN, JAKARTA SELATAN, DKI JAKARTA",34,145,119,264
https://kawalpemilu.org#26061,"BINTARO, PESANGGRAHAN, JAKARTA SELATAN, DKI JAKARTA",35,144,74,218
https://kawalpemilu.org#26061,"BINTARO, PESANGGRAHAN, JAKARTA SELATAN, DKI JAKARTA",36,117,110,227
https://kawalpemilu.org#26061,"BINTARO, PESANGGRAHAN, JAKARTA SELATAN, DKI JAKARTA",37,106,65,171
https://kawalpemilu.org#26061,"BINTARO, PESANGGRAHAN, JAKARTA SELATAN, DKI JAKARTA",38,132,118,250
https://kawalpemilu.org#26061,"BINTARO, PESANGGRAHAN, JAKARTA SELATAN, DKI JAKARTA",39,121,135,256
https://kawalpemilu.org#26061,"BINTARO, PESANGGRAHAN, JAKARTA SELATAN, DKI JAKARTA",40,134,109,243
https://kawalpemilu.org#26061,"BINTARO, PESANGGRAHAN, JAKARTA SELATAN, DKI JAKARTA",41,123,82,205
https://kawalpemilu.org#26061,"BINTARO, PESANGGRAHAN, JAKARTA SELATAN, DKI JAKARTA",42,121,97,218
https://kawalpemilu.org#26061,"BINTARO, PESANGGRAHAN, JAKARTA SELATAN, DKI JAKARTA",43,91,95,186
https://kawalpemilu.org#26061,"BINTARO, PESANGGRAHAN, JAKARTA SELATAN, DKI JAKARTA",44,118,83,201
https://kawalpemilu.org#26061,"BINTARO, PESANGGRAHAN, JAKARTA SELATAN, DKI JAKARTA",45,165,99,264
https://kawalpemilu.org#26061,"BINTARO, PESANGGRAHAN, JAKARTA SELATAN, DKI JAKARTA",46,151,83,234
https://kawalpemilu.org#26061,"BINTARO, PESANGGRAHAN, JAKARTA SELATAN, DKI JAKARTA",47,124,103,227
https://kawalpemilu.org#26061,"BINTARO, PESANGGRAHAN, JAKARTA SELATAN, DKI JAKARTA",48,141,118,259
https://kawalpemilu.org#26061,"BINTARO, PESANGGRAHAN, JAKARTA SELATAN, DKI JAKARTA",49,116,59,175
https://kawalpemilu.org#26061,"BINTARO, PESANGGRAHAN, JAKARTA SELATAN, DKI JAKARTA",50,114,111,225
https://kawalpemilu.org#26061,"BINTARO, PESANGGRAHAN, JAKARTA SELATAN, DKI JAKARTA",51,141,100,241
https://kawalpemilu.org#26061,"BINTARO, PESANGGRAHAN, JAKARTA SELATAN, DKI JAKARTA",52,104,146,250
https://kawalpemilu.org#26061,"BINTARO, PESANGGRAHAN, JAKARTA SELATAN, DKI JAKARTA",53,120,121,241
https://kawalpemilu.org#26061,"BINTARO, PESANGGRAHAN, JAKARTA SELATAN, DKI JAKARTA",54,133,99,232
https://kawalpemilu.org#26061,"BINTARO, PESANGGRAHAN, JAKARTA SELATAN, DKI JAKARTA",55,156,79,235
https://kawalpemilu.org#26061,"BINTARO, PESANGGRAHAN, JAKARTA SELATAN, DKI JAKARTA",56,177,70,247
https://kawalpemilu.org#26061,"BINTARO, PESANGGRAHAN, JAKARTA SELATAN, DKI JAKARTA",57,179,77,256
https://kawalpemilu.org#26061,"BINTARO, PESANGGRAHAN, JAKARTA SELATAN, DKI JAKARTA",59,119,103,222
https://kawalpemilu.org#26061,"BINTARO, PESANGGRAHAN, JAKARTA SELATAN, DKI JAKARTA",60,120,121,241
https://kawalpemilu.org#26061,"BINTARO, PESANGGRAHAN, JAKARTA SELATAN, DKI JAKARTA",61,116,138,254
https://kawalpemilu.org#26061,"BINTARO, PESANGGRAHAN, JAKARTA SELATAN, DKI JAKARTA",62,144,119,263
https://kawalpemilu.org#26061,"BINTARO, PESANGGRAHAN, JAKARTA SELATAN, DKI JAKARTA",63,166,100,266
https://kawalpemilu.org#26061,"BINTARO, PESANGGRAHAN, JAKARTA SELATAN, DKI JAKARTA",64,186,72,258
https://kawalpemilu.org#26061,"BINTARO, PESANGGRAHAN, JAKARTA SELATAN, DKI JAKARTA",65,134,59,193
https://kawalpemilu.org#26061,"BINTARO, PESANGGRAHAN, JAKARTA SELATAN, DKI JAKARTA",66,169,66,235
https://kawalpemilu.org#26061,"BINTARO, PESANGGRAHAN, JAKARTA SELATAN, DKI JAKARTA",67,130,47,177
https://kawalpemilu.org#26061,"BINTARO, PESANGGRAHAN, JAKARTA SELATAN, DKI JAKARTA",68,156,67,223
https://kawalpemilu.org#26061,"BINTARO, PESANGGRAHAN, JAKARTA SELATAN, DKI JAKARTA",69,174,78,252
https://kawalpemilu.org#26061,"BINTARO, PESANGGRAHAN, JAKARTA SELATAN, DKI JAKARTA",70,172,53,225
https://kawalpemilu.org#26061,"BINTARO, PESANGGRAHAN, JAKARTA SELATAN, DKI JAKARTA",71,189,58,247
https://kawalpemilu.org#26061,"BINTARO, PESANGGRAHAN, JAKARTA SELATAN, DKI JAKARTA",72,161,87,248
https://kawalpemilu.org#26061,"BINTARO, PESANGGRAHAN, JAKARTA SELATAN, DKI JAKARTA",73,175,85,260
https://kawalpemilu.org#26061,"BINTARO, PESANGGRAHAN, JAKARTA SELATAN, DKI JAKARTA",74,121,122,243
https://kawalpemilu.org#26061,"BINTARO, PESANGGRAHAN, JAKARTA SELATAN, DKI JAKARTA",75,116,136,252
https://kawalpemilu.org#26061,"BINTARO, PESANGGRAHAN, JAKARTA SELATAN, DKI JAKARTA",76,174,74,248
https://kawalpemilu.org#26061,"BINTARO, PESANGGRAHAN, JAKARTA SELATAN, DKI JAKARTA",77,205,40,245
https://kawalpemilu.org#26061,"BINTARO, PESANGGRAHAN, JAKARTA SELATAN, DKI JAKARTA",78,160,88,248
https://kawalpemilu.org#26061,"BINTARO, PESANGGRAHAN, JAKARTA SELATAN, DKI JAKARTA",79,149,71,220
https://kawalpemilu.org#26061,"BINTARO, PESANGGRAHAN, JAKARTA SELATAN, DKI JAKARTA",80,159,75,234
https://kawalpemilu.org#26061,"BINTARO, PESANGGRAHAN, JAKARTA SELATAN, DKI JAKARTA",81,99,79,177
https://kawalpemilu.org#26061,"BINTARO, PESANGGRAHAN, JAKARTA SELATAN, DKI JAKARTA",82,81,167,248
https://kawalpemilu.org#26061,"BINTARO, PESANGGRAHAN, JAKARTA SELATAN, DKI JAKARTA",83,113,122,235
https://kawalpemilu.org#26061,"BINTARO, PESANGGRAHAN, JAKARTA SELATAN, DKI JAKARTA",84,172,102,274
https://kawalpemilu.org#26061,"BINTARO, PESANGGRAHAN, JAKARTA SELATAN, DKI JAKARTA",85,141,113,254
https://kawalpemilu.org#26061,"BINTARO, PESANGGRAHAN, JAKARTA SELATAN, DKI JAKARTA",87,178,97,275
https://kawalpemilu.org#26061,"BINTARO, PESANGGRAHAN, JAKARTA SELATAN, DKI JAKARTA",88,143,93,236
https://kawalpemilu.org#26061,"BINTARO, PESANGGRAHAN, JAKARTA SELATAN, DKI JAKARTA",89,78,111,189
https://kawalpemilu.org#26061,"BINTARO, PESANGGRAHAN, JAKARTA SELATAN, DKI JAKARTA",90,138,116,254
https://kawalpemilu.org#26061,"BINTARO, PESANGGRAHAN, JAKARTA SELATAN, DKI JAKARTA",91,77,115,192
https://kawalpemilu.org#26061,"BINTARO, PESANGGRAHAN, JAKARTA SELATAN, DKI JAKARTA",92,143,121,264
https://kawalpemilu.org#26061,"BINTARO, PESANGGRAHAN, JAKARTA SELATAN, DKI JAKARTA",94,125,78,203
https://kawalpemilu.org#26061,"BINTARO, PESANGGRAHAN, JAKARTA SELATAN, DKI JAKARTA",95,108,122,230
https://kawalpemilu.org#26061,"BINTARO, PESANGGRAHAN, JAKARTA SELATAN, DKI JAKARTA",96,134,94,228
https://kawalpemilu.org#26061,"BINTARO, PESANGGRAHAN, JAKARTA SELATAN, DKI JAKARTA",97,176,100,276
https://kawalpemilu.org#26061,"BINTARO, PESANGGRAHAN, JAKARTA SELATAN, DKI JAKARTA",98,127,106,233
https://kawalpemilu.org#26061,"BINTARO, PESANGGRAHAN, JAKARTA SELATAN, DKI JAKARTA",99,99,103,202
https://kawalpemilu.org#26061,"BINTARO, PESANGGRAHAN, JAKARTA SELATAN, DKI JAKARTA",100,102,136,238
https://kawalpemilu.org#26061,"BINTARO, PESANGGRAHAN, JAKARTA SELATAN, DKI JAKARTA",101,108,76,184
https://kawalpemilu.org#26061,"BINTARO, PESANGGRAHAN, JAKARTA SELATAN, DKI JAKARTA",102,114,146,260
https://kawalpemilu.org#26061,"BINTARO, PESANGGRAHAN, JAKARTA SELATAN, DKI JAKARTA",103,126,121,247
https://kawalpemilu.org#26061,"BINTARO, PESANGGRAHAN, JAKARTA SELATAN, DKI JAKARTA",104,116,123,239
https://kawalpemilu.org#26061,"BINTARO, PESANGGRAHAN, JAKARTA SELATAN, DKI JAKARTA",105,116,115,231
https://kawalpemilu.org#26061,"BINTARO, PESANGGRAHAN, JAKARTA SELATAN, DKI JAKARTA",106,128,114,242
https://kawalpemilu.org#26061,"BINTARO, PESANGGRAHAN, JAKARTA SELATAN, DKI JAKARTA",107,120,113,233
https://kawalpemilu.org#26061,"BINTARO, PESANGGRAHAN, JAKARTA SELATAN, DKI JAKARTA",108,110,89,199
https://kawalpemilu.org#26061,"BINTARO, PESANGGRAHAN, JAKARTA SELATAN, DKI JAKARTA",109,122,88,210
https://kawalpemilu.org#26061,"BINTARO, PESANGGRAHAN, JAKARTA SELATAN, DKI JAKARTA",110,91,101,192
https://kawalpemilu.org#26061,"BINTARO, PESANGGRAHAN, JAKARTA SELATAN, DKI JAKARTA",111,71,156,227
https://kawalpemilu.org#26061,"BINTARO, PESANGGRAHAN, JAKARTA SELATAN, DKI JAKARTA",112,94,108,202
https://kawalpemilu.org#26061,"BINTARO, PESANGGRAHAN, JAKARTA SELATAN, DKI JAKARTA",113,110,103,213
https://kawalpemilu.org#26061,"BINTARO, PESANGGRAHAN, JAKARTA SELATAN, DKI JAKARTA",114,96,100,196
https://kawalpemilu.org#26061,"BINTARO, PESANGGRAHAN, JAKARTA SELATAN, DKI JAKARTA",115,129,87,216
https://kawalpemilu.org#26061,"BINTARO, PESANGGRAHAN, JAKARTA SELATAN, DKI JAKARTA",116,145,61,206
https://kawalpemilu.org#26061,"BINTARO, PESANGGRAHAN, JAKARTA SELATAN, DKI JAKARTA",117,62,139,201
https://kawalpemilu.org#26061,"BINTARO, PESANGGRAHAN, JAKARTA SELATAN, DKI JAKARTA",119,105,110,215
https://kawalpemilu.org#26061,"BINTARO, PESANGGRAHAN, JAKARTA SELATAN, DKI JAKARTA",120,64,138,202
https://kawalpemilu.org#26061,"BINTARO, PESANGGRAHAN, JAKARTA SELATAN, DKI JAKARTA",121,85,135,220
https://kawalpemilu.org#26061,"BINTARO, PESANGGRAHAN, JAKARTA SELATAN, DKI JAKARTA",122,121,127,248
https://kawalpemilu.org#26061,"BINTARO, PESANGGRAHAN, JAKARTA SELATAN, DKI JAKARTA",123,117,112,229
https://kawalpemilu.org#26061,"BINTARO, PESANGGRAHAN, JAKARTA SELATAN, DKI JAKARTA",124,122,88,210
https://kawalpemilu.org#26061,"BINTARO, PESANGGRAHAN, JAKARTA SELATAN, DKI JAKARTA",125,105,96,201
https://kawalpemilu.org#26061,"BINTARO, PESANGGRAHAN, JAKARTA SELATAN, DKI JAKARTA",126,165,65,230
https://kawalpemilu.org#26061,"BINTARO, PESANGGRAHAN, JAKARTA SELATAN, DKI JAKARTA",127,75,26,101
https://kawalpemilu.org#26061,"BINTARO, PESANGGRAHAN, JAKARTA SELATAN, DKI JAKARTA",128,117,160,277
https://kawalpemilu.org#26061,"BINTARO, PESANGGRAHAN, JAKARTA SELATAN, DKI JAKARTA",130,158,78,236
https://kawalpemilu.org#26061,"BINTARO, PESANGGRAHAN, JAKARTA SELATAN, DKI JAKARTA",131,159,87,246
https://kawalpemilu.org#26061,"BINTARO, PESANGGRAHAN, JAKARTA SELATAN, DKI JAKARTA",132,97,109,206
https://kawalpemilu.org#26061,"BINTARO, PESANGGRAHAN, JAKARTA SELATAN, DKI JAKARTA",133,116,141,257
https://kawalpemilu.org#26061,"BINTARO, PESANGGRAHAN, JAKARTA SELATAN, DKI JAKARTA",135,114,104,218
https://kawalpemilu.org#26061,"BINTARO, PESANGGRAHAN, JAKARTA SELATAN, DKI JAKARTA",137,155,64,219
https://kawalpemilu.org#26061,"BINTARO, PESANGGRAHAN, JAKARTA SELATAN, DKI JAKARTA",138,131,75,206
https://kawalpemilu.org#26061,"BINTARO, PESANGGRAHAN, JAKARTA SELATAN, DKI JAKARTA",139,150,77,227
https://kawalpemilu.org#26061,"BINTARO, PESANGGRAHAN, JAKARTA SELATAN, DKI JAKARTA",140,95,76,171
https://kawalpemilu.org#26061,"BINTARO, PESANGGRAHAN, JAKARTA SELATAN, DKI JAKARTA",141,101,70,171
https://kawalpemilu.org#26061,"BINTARO, PESANGGRAHAN, JAKARTA SELATAN, DKI JAKARTA",142,143,57,200
https://kawalpemilu.org#26061,"BINTARO, PESANGGRAHAN, JAKARTA SELATAN, DKI JAKARTA",144,97,87,184
https://kawalpemilu.org#26061,"BINTARO, PESANGGRAHAN, JAKARTA SELATAN, DKI JAKARTA",145,122,79,201
https://kawalpemilu.org#26061,"BINTARO, PESANGGRAHAN, JAKARTA SELATAN, DKI JAKARTA",146,113,111,224
https://kawalpemilu.org#26061,"BINTARO, PESANGGRAHAN, JAKARTA SELATAN, DKI JAKARTA",148,62,114,176
https://kawalpemilu.org#26061,"BINTARO, PESANGGRAHAN, JAKARTA SELATAN, DKI JAKARTA",149,86,106,192
https://kawalpemilu.org#26061,"BINTARO, PESANGGRAHAN, JAKARTA SELATAN, DKI JAKARTA",150,116,129,245
https://kawalpemilu.org#26061,"BINTARO, PESANGGRAHAN, JAKARTA SELATAN, DKI JAKARTA",151,145,116,261
https://kawalpemilu.org#26061,"BINTARO, PESANGGRAHAN, JAKARTA SELATAN, DKI JAKARTA",152,131,103,234
https://kawalpemilu.org#26061,"BINTARO, PESANGGRAHAN, JAKARTA SELATAN, DKI JAKARTA",153,117,88,205
https://kawalpemilu.org#26061,"BINTARO, PESANGGRAHAN, JAKARTA SELATAN, DKI JAKARTA",154,142,104,246
https://kawalpemilu.org#26061,"BINTARO, PESANGGRAHAN, JAKARTA SELATAN, DKI JAKARTA",155,105,122,227
https://kawalpemilu.org#26061,"BINTARO, PESANGGRAHAN, JAKARTA SELATAN, DKI JAKARTA",156,151,82,233
https://kawalpemilu.org#26061,"BINTARO, PESANGGRAHAN, JAKARTA SELATAN, DKI JAKARTA",157,117,91,208
https://kawalpemilu.org#26061,"BINTARO, PESANGGRAHAN, JAKARTA SELATAN, DKI JAKARTA",159,135,139,274
https://kawalpemilu.org#26061,"BINTARO, PESANGGRAHAN, JAKARTA SELATAN, DKI JAKARTA",160,112,129,241
https://kawalpemilu.org#26061,"BINTARO, PESANGGRAHAN, JAKARTA SELATAN, DKI JAKARTA",161,129,92,221
https://kawalpemilu.org#26061,"BINTARO, PESANGGRAHAN, JAKARTA SELATAN, DKI JAKARTA",163,136,57,193
https://kawalpemilu.org#26061,"BINTARO, PESANGGRAHAN, JAKARTA SELATAN, DKI JAKARTA",164,55,132,187
https://kawalpemilu.org#26061,"BINTARO, PESANGGRAHAN, JAKARTA SELATAN, DKI JAKARTA",165,114,125,239
https://kawalpemilu.org#26061,"BINTARO, PESANGGRAHAN, JAKARTA SELATAN, DKI JAKARTA",166,121,88,209
https://kawalpemilu.org#26061,"BINTARO, PESANGGRAHAN, JAKARTA SELATAN, DKI JAKARTA",167,138,63,201
https://kawalpemilu.org#26061,"BINTARO, PESANGGRAHAN, JAKARTA SELATAN, DKI JAKARTA",169,108,85,193
https://kawalpemilu.org#26062,"PETUKANGAN UTARA, PESANGGRAHAN, JAKARTA SELATAN, DKI JAKARTA",1,118,116,234
https://kawalpemilu.org#26062,"PETUKANGAN UTARA, PESANGGRAHAN, JAKARTA SELATAN, DKI JAKARTA",2,107,123,230
https://kawalpemilu.org#26062,"PETUKANGAN UTARA, PESANGGRAHAN, JAKARTA SELATAN, DKI JAKARTA",3,89,137,226
https://kawalpemilu.org#26062,"PETUKANGAN UTARA, PESANGGRAHAN, JAKARTA SELATAN, DKI JAKARTA",4,90,104,194
https://kawalpemilu.org#26062,"PETUKANGAN UTARA, PESANGGRAHAN, JAKARTA SELATAN, DKI JAKARTA",5,158,90,248
https://kawalpemilu.org#26062,"PETUKANGAN UTARA, PESANGGRAHAN, JAKARTA SELATAN, DKI JAKARTA",6,115,89,204
https://kawalpemilu.org#26062,"PETUKANGAN UTARA, PESANGGRAHAN, JAKARTA SELATAN, DKI JAKARTA",7,118,119,237
https://kawalpemilu.org#26062,"PETUKANGAN UTARA, PESANGGRAHAN, JAKARTA SELATAN, DKI JAKARTA",9,113,121,234
https://kawalpemilu.org#26062,"PETUKANGAN UTARA, PESANGGRAHAN, JAKARTA SELATAN, DKI JAKARTA",10,97,106,203
https://kawalpemilu.org#26062,"PETUKANGAN UTARA, PESANGGRAHAN, JAKARTA SELATAN, DKI JAKARTA",11,105,114,219
https://kawalpemilu.org#26062,"PETUKANGAN UTARA, PESANGGRAHAN, JAKARTA SELATAN, DKI JAKARTA",12,95,141,236
https://kawalpemilu.org#26062,"PETUKANGAN UTARA, PESANGGRAHAN, JAKARTA SELATAN, DKI JAKARTA",13,125,124,249
https://kawalpemilu.org#26062,"PETUKANGAN UTARA, PESANGGRAHAN, JAKARTA SELATAN, DKI JAKARTA",14,101,129,230
https://kawalpemilu.org#26062,"PETUKANGAN UTARA, PESANGGRAHAN, JAKARTA SELATAN, DKI JAKARTA",15,112,120,232
https://kawalpemilu.org#26062,"PETUKANGAN UTARA, PESANGGRAHAN, JAKARTA SELATAN, DKI JAKARTA",16,112,122,234
https://kawalpemilu.org#26062,"PETUKANGAN UTARA, PESANGGRAHAN, JAKARTA SELATAN, DKI JAKARTA",17,82,103,185
https://kawalpemilu.org#26062,"PETUKANGAN UTARA, PESANGGRAHAN, JAKARTA SELATAN, DKI JAKARTA",18,78,103,181
https://kawalpemilu.org#26062,"PETUKANGAN UTARA, PESANGGRAHAN, JAKARTA SELATAN, DKI JAKARTA",19,120,90,210
https://kawalpemilu.org#26062,"PETUKANGAN UTARA, PESANGGRAHAN, JAKARTA SELATAN, DKI JAKARTA",20,124,88,212
https://kawalpemilu.org#26062,"PETUKANGAN UTARA, PESANGGRAHAN, JAKARTA SELATAN, DKI JAKARTA",21,111,115,226
https://kawalpemilu.org#26062,"PETUKANGAN UTARA, PESANGGRAHAN, JAKARTA SELATAN, DKI JAKARTA",22,102,109,211
https://kawalpemilu.org#26062,"PETUKANGAN UTARA, PESANGGRAHAN, JAKARTA SELATAN, DKI JAKARTA",23,92,143,235
https://kawalpemilu.org#26062,"PETUKANGAN UTARA, PESANGGRAHAN, JAKARTA SELATAN, DKI JAKARTA",24,89,140,229
https://kawalpemilu.org#26062,"PETUKANGAN UTARA, PESANGGRAHAN, JAKARTA SELATAN, DKI JAKARTA",25,97,114,211
https://kawalpemilu.org#26062,"PETUKANGAN UTARA, PESANGGRAHAN, JAKARTA SELATAN, DKI JAKARTA",26,126,148,274
https://kawalpemilu.org#26062,"PETUKANGAN UTARA, PESANGGRAHAN, JAKARTA SELATAN, DKI JAKARTA",27,122,110,232
https://kawalpemilu.org#26062,"PETUKANGAN UTARA, PESANGGRAHAN, JAKARTA SELATAN, DKI JAKARTA",28,120,130,250
https://kawalpemilu.org#26062,"PETUKANGAN UTARA, PESANGGRAHAN, JAKARTA SELATAN, DKI JAKARTA",29,99,122,221
https://kawalpemilu.org#26062,"PETUKANGAN UTARA, PESANGGRAHAN, JAKARTA SELATAN, DKI JAKARTA",30,168,75,243
https://kawalpemilu.org#26062,"PETUKANGAN UTARA, PESANGGRAHAN, JAKARTA SELATAN, DKI JAKARTA",31,129,112,241
https://kawalpemilu.org#26062,"PETUKANGAN UTARA, PESANGGRAHAN, JAKARTA SELATAN, DKI JAKARTA",32,118,100,218
https://kawalpemilu.org#26062,"PETUKANGAN UTARA, PESANGGRAHAN, JAKARTA SELATAN, DKI JAKARTA",33,139,99,238
https://kawalpemilu.org#26062,"PETUKANGAN UTARA, PESANGGRAHAN, JAKARTA SELATAN, DKI JAKARTA",34,115,115,230
https://kawalpemilu.org#26062,"PETUKANGAN UTARA, PESANGGRAHAN, JAKARTA SELATAN, DKI JAKARTA",35,121,91,212
https://kawalpemilu.org#26062,"PETUKANGAN UTARA, PESANGGRAHAN, JAKARTA SELATAN, DKI JAKARTA",36,103,134,237
https://kawalpemilu.org#26062,"PETUKANGAN UTARA, PESANGGRAHAN, JAKARTA SELATAN, DKI JAKARTA",38,106,130,236
https://kawalpemilu.org#26062,"PETUKANGAN UTARA, PESANGGRAHAN, JAKARTA SELATAN, DKI JAKARTA",39,115,100,215
https://kawalpemilu.org#26062,"PETUKANGAN UTARA, PESANGGRAHAN, JAKARTA SELATAN, DKI JAKARTA",40,100,116,216
https://kawalpemilu.org#26062,"PETUKANGAN UTARA, PESANGGRAHAN, JAKARTA SELATAN, DKI JAKARTA",41,104,152,256
https://kawalpemilu.org#26062,"PETUKANGAN UTARA, PESANGGRAHAN, JAKARTA SELATAN, DKI JAKARTA",42,94,158,252
https://kawalpemilu.org#26062,"PETUKANGAN UTARA, PESANGGRAHAN, JAKARTA SELATAN, DKI JAKARTA",43,89,125,214
https://kawalpemilu.org#26062,"PETUKANGAN UTARA, PESANGGRAHAN, JAKARTA SELATAN, DKI JAKARTA",44,85,111,196
https://kawalpemilu.org#26062,"PETUKANGAN UTARA, PESANGGRAHAN, JAKARTA SELATAN, DKI JAKARTA",45,117,107,224
https://kawalpemilu.org#26062,"PETUKANGAN UTARA, PESANGGRAHAN, JAKARTA SELATAN, DKI JAKARTA",46,96,110,206
https://kawalpemilu.org#26062,"PETUKANGAN UTARA, PESANGGRAHAN, JAKARTA SELATAN, DKI JAKARTA",47,102,122,224
https://kawalpemilu.org#26062,"PETUKANGAN UTARA, PESANGGRAHAN, JAKARTA SELATAN, DKI JAKARTA",48,77,84,161
https://kawalpemilu.org#26062,"PETUKANGAN UTARA, PESANGGRAHAN, JAKARTA SELATAN, DKI JAKARTA",49,94,142,236
https://kawalpemilu.org#26062,"PETUKANGAN UTARA, PESANGGRAHAN, JAKARTA SELATAN, DKI JAKARTA",50,86,136,222
https://kawalpemilu.org#26062,"PETUKANGAN UTARA, PESANGGRAHAN, JAKARTA SELATAN, DKI JAKARTA",51,81,182,263
https://kawalpemilu.org#26062,"PETUKANGAN UTARA, PESANGGRAHAN, JAKARTA SELATAN, DKI JAKARTA",52,100,162,262
https://kawalpemilu.org#26062,"PETUKANGAN UTARA, PESANGGRAHAN, JAKARTA SELATAN, DKI JAKARTA",53,123,108,231
https://kawalpemilu.org#26062,"PETUKANGAN UTARA, PESANGGRAHAN, JAKARTA SELATAN, DKI JAKARTA",54,113,113,226
https://kawalpemilu.org#26062,"PETUKANGAN UTARA, PESANGGRAHAN, JAKARTA SELATAN, DKI JAKARTA",55,83,119,202
https://kawalpemilu.org#26062,"PETUKANGAN UTARA, PESANGGRAHAN, JAKARTA SELATAN, DKI JAKARTA",56,67,134,201
https://kawalpemilu.org#26062,"PETUKANGAN UTARA, PESANGGRAHAN, JAKARTA SELATAN, DKI JAKARTA",57,80,135,215
https://kawalpemilu.org#26062,"PETUKANGAN UTARA, PESANGGRAHAN, JAKARTA SELATAN, DKI JAKARTA",60,93,132,225
https://kawalpemilu.org#26062,"PETUKANGAN UTARA, PESANGGRAHAN, JAKARTA SELATAN, DKI JAKARTA",61,101,74,175
https://kawalpemilu.org#26062,"PETUKANGAN UTARA, PESANGGRAHAN, JAKARTA SELATAN, DKI JAKARTA",62,107,90,197
https://kawalpemilu.org#26062,"PETUKANGAN UTARA, PESANGGRAHAN, JAKARTA SELATAN, DKI JAKARTA",63,97,121,218
https://kawalpemilu.org#26062,"PETUKANGAN UTARA, PESANGGRAHAN, JAKARTA SELATAN, DKI JAKARTA",64,98,141,239
https://kawalpemilu.org#26062,"PETUKANGAN UTARA, PESANGGRAHAN, JAKARTA SELATAN, DKI JAKARTA",65,106,170,276
https://kawalpemilu.org#26062,"PETUKANGAN UTARA, PESANGGRAHAN, JAKARTA SELATAN, DKI JAKARTA",66,81,130,211
https://kawalpemilu.org#26062,"PETUKANGAN UTARA, PESANGGRAHAN, JAKARTA SELATAN, DKI JAKARTA",67,75,128,203
https://kawalpemilu.org#26062,"PETUKANGAN UTARA, PESANGGRAHAN, JAKARTA SELATAN, DKI JAKARTA",68,102,110,212
https://kawalpemilu.org#26062,"PETUKANGAN UTARA, PESANGGRAHAN, JAKARTA SELATAN, DKI JAKARTA",69,108,95,203
https://kawalpemilu.org#26062,"PETUKANGAN UTARA, PESANGGRAHAN, JAKARTA SELATAN, DKI JAKARTA",70,107,150,257
https://kawalpemilu.org#26062,"PETUKANGAN UTARA, PESANGGRAHAN, JAKARTA SELATAN, DKI JAKARTA",71,123,108,231
https://kawalpemilu.org#26062,"PETUKANGAN UTARA, PESANGGRAHAN, JAKARTA SELATAN, DKI JAKARTA",72,80,145,225
https://kawalpemilu.org#26062,"PETUKANGAN UTARA, PESANGGRAHAN, JAKARTA SELATAN, DKI JAKARTA",73,101,136,237
https://kawalpemilu.org#26062,"PETUKANGAN UTARA, PESANGGRAHAN, JAKARTA SELATAN, DKI JAKARTA",74,82,168,250
https://kawalpemilu.org#26062,"PETUKANGAN UTARA, PESANGGRAHAN, JAKARTA SELATAN, DKI JAKARTA",75,86,116,202
https://kawalpemilu.org#26062,"PETUKANGAN UTARA, PESANGGRAHAN, JAKARTA SELATAN, DKI JAKARTA",76,87,107,189
https://kawalpemilu.org#26062,"PETUKANGAN UTARA, PESANGGRAHAN, JAKARTA SELATAN, DKI JAKARTA",77,65,138,203
https://kawalpemilu.org#26062,"PETUKANGAN UTARA, PESANGGRAHAN, JAKARTA SELATAN, DKI JAKARTA",78,72,139,211
https://kawalpemilu.org#26062,"PETUKANGAN UTARA, PESANGGRAHAN, JAKARTA SELATAN, DKI JAKARTA",79,58,160,218
https://kawalpemilu.org#26062,"PETUKANGAN UTARA, PESANGGRAHAN, JAKARTA SELATAN, DKI JAKARTA",80,101,104,205
https://kawalpemilu.org#26062,"PETUKANGAN UTARA, PESANGGRAHAN, JAKARTA SELATAN, DKI JAKARTA",81,85,151,236
https://kawalpemilu.org#26062,"PETUKANGAN UTARA, PESANGGRAHAN, JAKARTA SELATAN, DKI JAKARTA",82,71,114,185
https://kawalpemilu.org#26062,"PETUKANGAN UTARA, PESANGGRAHAN, JAKARTA SELATAN, DKI JAKARTA",83,89,143,232
https://kawalpemilu.org#26062,"PETUKANGAN UTARA, PESANGGRAHAN, JAKARTA SELATAN, DKI JAKARTA",85,77,146,223
https://kawalpemilu.org#26062,"PETUKANGAN UTARA, PESANGGRAHAN, JAKARTA SELATAN, DKI JAKARTA",86,90,124,214
https://kawalpemilu.org#26062,"PETUKANGAN UTARA, PESANGGRAHAN, JAKARTA SELATAN, DKI JAKARTA",87,145,83,228
https://kawalpemilu.org#26062,"PETUKANGAN UTARA, PESANGGRAHAN, JAKARTA SELATAN, DKI JAKARTA",88,117,105,222
https://kawalpemilu.org#26062,"PETUKANGAN UTARA, PESANGGRAHAN, JAKARTA SELATAN, DKI JAKARTA",89,113,110,223
https://kawalpemilu.org#26062,"PETUKANGAN UTARA, PESANGGRAHAN, JAKARTA SELATAN, DKI JAKARTA",90,110,118,228
https://kawalpemilu.org#26062,"PETUKANGAN UTARA, PESANGGRAHAN, JAKARTA SELATAN, DKI JAKARTA",91,103,108,211
https://kawalpemilu.org#26062,"PETUKANGAN UTARA, PESANGGRAHAN, JAKARTA SELATAN, DKI JAKARTA",92,158,111,269
https://kawalpemilu.org#26062,"PETUKANGAN UTARA, PESANGGRAHAN, JAKARTA SELATAN, DKI JAKARTA",93,120,114,234
https://kawalpemilu.org#26062,"PETUKANGAN UTARA, PESANGGRAHAN, JAKARTA SELATAN, DKI JAKARTA",94,123,94,217
https://kawalpemilu.org#26062,"PETUKANGAN UTARA, PESANGGRAHAN, JAKARTA SELATAN, DKI JAKARTA",95,111,115,226
https://kawalpemilu.org#26062,"PETUKANGAN UTARA, PESANGGRAHAN, JAKARTA SELATAN, DKI JAKARTA",96,112,85,197
https://kawalpemilu.org#26062,"PETUKANGAN UTARA, PESANGGRAHAN, JAKARTA SELATAN, DKI JAKARTA",97,138,77,215
https://kawalpemilu.org#26062,"PETUKANGAN UTARA, PESANGGRAHAN, JAKARTA SELATAN, DKI JAKARTA",98,146,95,241
https://kawalpemilu.org#26062,"PETUKANGAN UTARA, PESANGGRAHAN, JAKARTA SELATAN, DKI JAKARTA",99,97,153,250
https://kawalpemilu.org#26062,"PETUKANGAN UTARA, PESANGGRAHAN, JAKARTA SELATAN, DKI JAKARTA",100,111,104,215
https://kawalpemilu.org#26062,"PETUKANGAN UTARA, PESANGGRAHAN, JAKARTA SELATAN, DKI JAKARTA",101,83,69,152
https://kawalpemilu.org#26062,"PETUKANGAN UTARA, PESANGGRAHAN, JAKARTA SELATAN, DKI JAKARTA",102,62,93,155
https://kawalpemilu.org#26062,"PETUKANGAN UTARA, PESANGGRAHAN, JAKARTA SELATAN, DKI JAKARTA",103,127,101,228
https://kawalpemilu.org#26062,"PETUKANGAN UTARA, PESANGGRAHAN, JAKARTA SELATAN, DKI JAKARTA",104,116,90,206
https://kawalpemilu.org#26062,"PETUKANGAN UTARA, PESANGGRAHAN, JAKARTA SELATAN, DKI JAKARTA",106,109,88,197
https://kawalpemilu.org#26062,"PETUKANGAN UTARA, PESANGGRAHAN, JAKARTA SELATAN, DKI JAKARTA",107,116,81,197
https://kawalpemilu.org#26062,"PETUKANGAN UTARA, PESANGGRAHAN, JAKARTA SELATAN, DKI JAKARTA",108,101,76,177
https://kawalpemilu.org#26062,"PETUKANGAN UTARA, PESANGGRAHAN, JAKARTA SELATAN, DKI JAKARTA",109,100,59,159
https://kawalpemilu.org#26062,"PETUKANGAN UTARA, PESANGGRAHAN, JAKARTA SELATAN, DKI JAKARTA",110,158,80,238
https://kawalpemilu.org#26062,"PETUKANGAN UTARA, PESANGGRAHAN, JAKARTA SELATAN, DKI JAKARTA",111,108,71,179
https://kawalpemilu.org#26062,"PETUKANGAN UTARA, PESANGGRAHAN, JAKARTA SELATAN, DKI JAKARTA",112,108,134,242
https://kawalpemilu.org#26062,"PETUKANGAN UTARA, PESANGGRAHAN, JAKARTA SELATAN, DKI JAKARTA",113,202,15,217
https://kawalpemilu.org#26062,"PETUKANGAN UTARA, PESANGGRAHAN, JAKARTA SELATAN, DKI JAKARTA",114,188,20,208
https://kawalpemilu.org#26062,"PETUKANGAN UTARA, PESANGGRAHAN, JAKARTA SELATAN, DKI JAKARTA",115,183,16,199
https://kawalpemilu.org#26062,"PETUKANGAN UTARA, PESANGGRAHAN, JAKARTA SELATAN, DKI JAKARTA",116,195,20,215
https://kawalpemilu.org#26062,"PETUKANGAN UTARA, PESANGGRAHAN, JAKARTA SELATAN, DKI JAKARTA",117,203,17,220
https://kawalpemilu.org#26062,"PETUKANGAN UTARA, PESANGGRAHAN, JAKARTA SELATAN, DKI JAKARTA",118,207,41,248
https://kawalpemilu.org#26062,"PETUKANGAN UTARA, PESANGGRAHAN, JAKARTA SELATAN, DKI JAKARTA",119,203,16,219
https://kawalpemilu.org#26062,"PETUKANGAN UTARA, PESANGGRAHAN, JAKARTA SELATAN, DKI JAKARTA",120,211,41,252
https://kawalpemilu.org#26062,"PETUKANGAN UTARA, PESANGGRAHAN, JAKARTA SELATAN, DKI JAKARTA",121,105,130,235
https://kawalpemilu.org#26062,"PETUKANGAN UTARA, PESANGGRAHAN, JAKARTA SELATAN, DKI JAKARTA",122,115,116,231
https://kawalpemilu.org#26062,"PETUKANGAN UTARA, PESANGGRAHAN, JAKARTA SELATAN, DKI JAKARTA",123,74,116,190
https://kawalpemilu.org#26062,"PETUKANGAN UTARA, PESANGGRAHAN, JAKARTA SELATAN, DKI JAKARTA",124,152,100,252
https://kawalpemilu.org#26062,"PETUKANGAN UTARA, PESANGGRAHAN, JAKARTA SELATAN, DKI JAKARTA",125,91,80,171
https://kawalpemilu.org#26062,"PETUKANGAN UTARA, PESANGGRAHAN, JAKARTA SELATAN, DKI JAKARTA",126,86,101,187
https://kawalpemilu.org#26062,"PETUKANGAN UTARA, PESANGGRAHAN, JAKARTA SELATAN, DKI JAKARTA",127,130,106,236
https://kawalpemilu.org#26062,"PETUKANGAN UTARA, PESANGGRAHAN, JAKARTA SELATAN, DKI JAKARTA",128,141,116,257
https://kawalpemilu.org#26062,"PETUKANGAN UTARA, PESANGGRAHAN, JAKARTA SELATAN, DKI JAKARTA",129,117,94,211
https://kawalpemilu.org#26062,"PETUKANGAN UTARA, PESANGGRAHAN, JAKARTA SELATAN, DKI JAKARTA",130,124,118,242
https://kawalpemilu.org#26062,"PETUKANGAN UTARA, PESANGGRAHAN, JAKARTA SELATAN, DKI JAKARTA",131,87,133,220
https://kawalpemilu.org#26062,"PETUKANGAN UTARA, PESANGGRAHAN, JAKARTA SELATAN, DKI JAKARTA",132,56,160,216
https://kawalpemilu.org#26062,"PETUKANGAN UTARA, PESANGGRAHAN, JAKARTA SELATAN, DKI JAKARTA",133,66,133,199
https://kawalpemilu.org#26062,"PETUKANGAN UTARA, PESANGGRAHAN, JAKARTA SELATAN, DKI JAKARTA",134,58,156,214
https://kawalpemilu.org#26062,"PETUKANGAN UTARA, PESANGGRAHAN, JAKARTA SELATAN, DKI JAKARTA",135,136,131,267
https://kawalpemilu.org#26062,"PETUKANGAN UTARA, PESANGGRAHAN, JAKARTA SELATAN, DKI JAKARTA",136,131,86,217
https://kawalpemilu.org#26062,"PETUKANGAN UTARA, PESANGGRAHAN, JAKARTA SELATAN, DKI JAKARTA",137,134,101,235
https://kawalpemilu.org#26062,"PETUKANGAN UTARA, PESANGGRAHAN, JAKARTA SELATAN, DKI JAKARTA",138,105,117,222
https://kawalpemilu.org#26062,"PETUKANGAN UTARA, PESANGGRAHAN, JAKARTA SELATAN, DKI JAKARTA",139,119,109,228
https://kawalpemilu.org#26062,"PETUKANGAN UTARA, PESANGGRAHAN, JAKARTA SELATAN, DKI JAKARTA",140,135,90,225
https://kawalpemilu.org#26062,"PETUKANGAN UTARA, PESANGGRAHAN, JAKARTA SELATAN, DKI JAKARTA",141,113,105,118
https://kawalpemilu.org#26062,"PETUKANGAN UTARA, PESANGGRAHAN, JAKARTA SELATAN, DKI JAKARTA",142,70,118,188
https://kawalpemilu.org#26062,"PETUKANGAN UTARA, PESANGGRAHAN, JAKARTA SELATAN, DKI JAKARTA",143,122,108,230
https://kawalpemilu.org#26062,"PETUKANGAN UTARA, PESANGGRAHAN, JAKARTA SELATAN, DKI JAKARTA",144,126,80,206
https://kawalpemilu.org#26062,"PETUKANGAN UTARA, PESANGGRAHAN, JAKARTA SELATAN, DKI JAKARTA",145,105,110,215
https://kawalpemilu.org#26062,"PETUKANGAN UTARA, PESANGGRAHAN, JAKARTA SELATAN, DKI JAKARTA",146,108,103,211
https://kawalpemilu.org#26062,"PETUKANGAN UTARA, PESANGGRAHAN, JAKARTA SELATAN, DKI JAKARTA",147,115,111,226
https://kawalpemilu.org#26062,"PETUKANGAN UTARA, PESANGGRAHAN, JAKARTA SELATAN, DKI JAKARTA",148,124,113,237
https://kawalpemilu.org#26062,"PETUKANGAN UTARA, PESANGGRAHAN, JAKARTA SELATAN, DKI JAKARTA",149,120,95,215
https://kawalpemilu.org#26062,"PETUKANGAN UTARA, PESANGGRAHAN, JAKARTA SELATAN, DKI JAKARTA",151,121,109,230
https://kawalpemilu.org#26062,"PETUKANGAN UTARA, PESANGGRAHAN, JAKARTA SELATAN, DKI JAKARTA",152,120,107,227
https://kawalpemilu.org#26062,"PETUKANGAN UTARA, PESANGGRAHAN, JAKARTA SELATAN, DKI JAKARTA",153,110,97,207
https://kawalpemilu.org#26062,"PETUKANGAN UTARA, PESANGGRAHAN, JAKARTA SELATAN, DKI JAKARTA",154,114,86,200
https://kawalpemilu.org#26062,"PETUKANGAN UTARA, PESANGGRAHAN, JAKARTA SELATAN, DKI JAKARTA",155,107,118,225
https://kawalpemilu.org#26062,"PETUKANGAN UTARA, PESANGGRAHAN, JAKARTA SELATAN, DKI JAKARTA",156,71,85,156
https://kawalpemilu.org#26062,"PETUKANGAN UTARA, PESANGGRAHAN, JAKARTA SELATAN, DKI JAKARTA",157,103,77,180
https://kawalpemilu.org#26062,"PETUKANGAN UTARA, PESANGGRAHAN, JAKARTA SELATAN, DKI JAKARTA",159,92,113,205
https://kawalpemilu.org#26062,"PETUKANGAN UTARA, PESANGGRAHAN, JAKARTA SELATAN, DKI JAKARTA",160,123,94,217
https://kawalpemilu.org#26062,"PETUKANGAN UTARA, PESANGGRAHAN, JAKARTA SELATAN, DKI JAKARTA",161,94,98,192
https://kawalpemilu.org#26062,"PETUKANGAN UTARA, PESANGGRAHAN, JAKARTA SELATAN, DKI JAKARTA",163,121,109,230
https://kawalpemilu.org#26062,"PETUKANGAN UTARA, PESANGGRAHAN, JAKARTA SELATAN, DKI JAKARTA",164,127,84,211
https://kawalpemilu.org#26062,"PETUKANGAN UTARA, PESANGGRAHAN, JAKARTA SELATAN, DKI JAKARTA",165,156,39,195
https://kawalpemilu.org#26062,"PETUKANGAN UTARA, PESANGGRAHAN, JAKARTA SELATAN, DKI JAKARTA",166,101,125,226
https://kawalpemilu.org#26062,"PETUKANGAN UTARA, PESANGGRAHAN, JAKARTA SELATAN, DKI JAKARTA",167,78,121,199
https://kawalpemilu.org#26062,"PETUKANGAN UTARA, PESANGGRAHAN, JAKARTA SELATAN, DKI JAKARTA",168,85,122,207
https://kawalpemilu.org#26062,"PETUKANGAN UTARA, PESANGGRAHAN, JAKARTA SELATAN, DKI JAKARTA",169,106,81,187
https://kawalpemilu.org#26062,"PETUKANGAN UTARA, PESANGGRAHAN, JAKARTA SELATAN, DKI JAKARTA",170,90,89,179
https://kawalpemilu.org#26062,"PETUKANGAN UTARA, PESANGGRAHAN, JAKARTA SELATAN, DKI JAKARTA",171,77,97,174
https://kawalpemilu.org#26062,"PETUKANGAN UTARA, PESANGGRAHAN, JAKARTA SELATAN, DKI JAKARTA",172,107,82,189
https://kawalpemilu.org#26062,"PETUKANGAN UTARA, PESANGGRAHAN, JAKARTA SELATAN, DKI JAKARTA",173,76,91,167
https://kawalpemilu.org#26062,"PETUKANGAN UTARA, PESANGGRAHAN, JAKARTA SELATAN, DKI JAKARTA",174,66,91,157
https://kawalpemilu.org#26063,"PETUKANGAN SELATAN, PESANGGRAHAN, JAKARTA SELATAN, DKI JAKARTA",1,148,68,216
https://kawalpemilu.org#26063,"PETUKANGAN SELATAN, PESANGGRAHAN, JAKARTA SELATAN, DKI JAKARTA",2,149,79,228
https://kawalpemilu.org#26063,"PETUKANGAN SELATAN, PESANGGRAHAN, JAKARTA SELATAN, DKI JAKARTA",3,127,126,253
https://kawalpemilu.org#26063,"PETUKANGAN SELATAN, PESANGGRAHAN, JAKARTA SELATAN, DKI JAKARTA",4,126,109,235
https://kawalpemilu.org#26063,"PETUKANGAN SELATAN, PESANGGRAHAN, JAKARTA SELATAN, DKI JAKARTA",5,124,131,255
https://kawalpemilu.org#26063,"PETUKANGAN SELATAN, PESANGGRAHAN, JAKARTA SELATAN, DKI JAKARTA",6,113,129,242
https://kawalpemilu.org#26063,"PETUKANGAN SELATAN, PESANGGRAHAN, JAKARTA SELATAN, DKI JAKARTA",7,96,127,223
https://kawalpemilu.org#26063,"PETUKANGAN SELATAN, PESANGGRAHAN, JAKARTA SELATAN, DKI JAKARTA",8,97,100,197
https://kawalpemilu.org#26063,"PETUKANGAN SELATAN, PESANGGRAHAN, JAKARTA SELATAN, DKI JAKARTA",9,126,129,255
https://kawalpemilu.org#26063,"PETUKANGAN SELATAN, PESANGGRAHAN, JAKARTA SELATAN, DKI JAKARTA",10,115,116,231
https://kawalpemilu.org#26063,"PETUKANGAN SELATAN, PESANGGRAHAN, JAKARTA SELATAN, DKI JAKARTA",11,94,111,205
https://kawalpemilu.org#26063,"PETUKANGAN SELATAN, PESANGGRAHAN, JAKARTA SELATAN, DKI JAKARTA",12,106,113,219
https://kawalpemilu.org#26063,"PETUKANGAN SELATAN, PESANGGRAHAN, JAKARTA SELATAN, DKI JAKARTA",13,67,157,224
https://kawalpemilu.org#26063,"PETUKANGAN SELATAN, PESANGGRAHAN, JAKARTA SELATAN, DKI JAKARTA",14,113,111,224
https://kawalpemilu.org#26063,"PETUKANGAN SELATAN, PESANGGRAHAN, JAKARTA SELATAN, DKI JAKARTA",15,88,149,237
https://kawalpemilu.org#26063,"PETUKANGAN SELATAN, PESANGGRAHAN, JAKARTA SELATAN, DKI JAKARTA",17,164,78,242
https://kawalpemilu.org#26063,"PETUKANGAN SELATAN, PESANGGRAHAN, JAKARTA SELATAN, DKI JAKARTA",18,136,102,238
https://kawalpemilu.org#26063,"PETUKANGAN SELATAN, PESANGGRAHAN, JAKARTA SELATAN, DKI JAKARTA",19,135,96,231
https://kawalpemilu.org#26063,"PETUKANGAN SELATAN, PESANGGRAHAN, JAKARTA SELATAN, DKI JAKARTA",20,127,83,210
https://kawalpemilu.org#26063,"PETUKANGAN SELATAN, PESANGGRAHAN, JAKARTA SELATAN, DKI JAKARTA",21,111,96,207
https://kawalpemilu.org#26063,"PETUKANGAN SELATAN, PESANGGRAHAN, JAKARTA SELATAN, DKI JAKARTA",22,93,95,188
https://kawalpemilu.org#26063,"PETUKANGAN SELATAN, PESANGGRAHAN, JAKARTA SELATAN, DKI JAKARTA",23,116,115,231
https://kawalpemilu.org#26063,"PETUKANGAN SELATAN, PESANGGRAHAN, JAKARTA SELATAN, DKI JAKARTA",24,130,90,220
https://kawalpemilu.org#26063,"PETUKANGAN SELATAN, PESANGGRAHAN, JAKARTA SELATAN, DKI JAKARTA",25,118,76,194
https://kawalpemilu.org#26063,"PETUKANGAN SELATAN, PESANGGRAHAN, JAKARTA SELATAN, DKI JAKARTA",26,103,53,156
https://kawalpemilu.org#26063,"PETUKANGAN SELATAN, PESANGGRAHAN, JAKARTA SELATAN, DKI JAKARTA",27,110,124,234
https://kawalpemilu.org#26063,"PETUKANGAN SELATAN, PESANGGRAHAN, JAKARTA SELATAN, DKI JAKARTA",28,111,105,216
https://kawalpemilu.org#26063,"PETUKANGAN SELATAN, PESANGGRAHAN, JAKARTA SELATAN, DKI JAKARTA",29,118,102,220
https://kawalpemilu.org#26063,"PETUKANGAN SELATAN, PESANGGRAHAN, JAKARTA SELATAN, DKI JAKARTA",30,120,117,237
https://kawalpemilu.org#26063,"PETUKANGAN SELATAN, PESANGGRAHAN, JAKARTA SELATAN, DKI JAKARTA",31,159,83,242
https://kawalpemilu.org#26063,"PETUKANGAN SELATAN, PESANGGRAHAN, JAKARTA SELATAN, DKI JAKARTA",32,150,85,235
https://kawalpemilu.org#26063,"PETUKANGAN SELATAN, PESANGGRAHAN, JAKARTA SELATAN, DKI JAKARTA",33,175,62,237
https://kawalpemilu.org#26063,"PETUKANGAN SELATAN, PESANGGRAHAN, JAKARTA SELATAN, DKI JAKARTA",34,139,100,239
https://kawalpemilu.org#26063,"PETUKANGAN SELATAN, PESANGGRAHAN, JAKARTA SELATAN, DKI JAKARTA",35,154,87,241
https://kawalpemilu.org#26063,"PETUKANGAN SELATAN, PESANGGRAHAN, JAKARTA SELATAN, DKI JAKARTA",36,135,90,225
https://kawalpemilu.org#26063,"PETUKANGAN SELATAN, PESANGGRAHAN, JAKARTA SELATAN, DKI JAKARTA",37,105,71,176
https://kawalpemilu.org#26063,"PETUKANGAN SELATAN, PESANGGRAHAN, JAKARTA SELATAN, DKI JAKARTA",38,123,107,230
https://kawalpemilu.org#26063,"PETUKANGAN SELATAN, PESANGGRAHAN, JAKARTA SELATAN, DKI JAKARTA",39,112,106,218
https://kawalpemilu.org#26063,"PETUKANGAN SELATAN, PESANGGRAHAN, JAKARTA SELATAN, DKI JAKARTA",40,100,143,243
https://kawalpemilu.org#26063,"PETUKANGAN SELATAN, PESANGGRAHAN, JAKARTA SELATAN, DKI JAKARTA",41,94,117,211
https://kawalpemilu.org#26063,"PETUKANGAN SELATAN, PESANGGRAHAN, JAKARTA SELATAN, DKI JAKARTA",42,99,165,264
https://kawalpemilu.org#26063,"PETUKANGAN SELATAN, PESANGGRAHAN, JAKARTA SELATAN, DKI JAKARTA",43,106,129,235
https://kawalpemilu.org#26063,"PETUKANGAN SELATAN, PESANGGRAHAN, JAKARTA SELATAN, DKI JAKARTA",44,111,102,213
https://kawalpemilu.org#26063,"PETUKANGAN SELATAN, PESANGGRAHAN, JAKARTA SELATAN, DKI JAKARTA",45,66,84,150
https://kawalpemilu.org#26063,"PETUKANGAN SELATAN, PESANGGRAHAN, JAKARTA SELATAN, DKI JAKARTA",46,127,128,255
https://kawalpemilu.org#26063,"PETUKANGAN SELATAN, PESANGGRAHAN, JAKARTA SELATAN, DKI JAKARTA",47,128,130,258
https://kawalpemilu.org#26063,"PETUKANGAN SELATAN, PESANGGRAHAN, JAKARTA SELATAN, DKI JAKARTA",48,143,115,258
https://kawalpemilu.org#26063,"PETUKANGAN SELATAN, PESANGGRAHAN, JAKARTA SELATAN, DKI JAKARTA",49,154,108,262
https://kawalpemilu.org#26063,"PETUKANGAN SELATAN, PESANGGRAHAN, JAKARTA SELATAN, DKI JAKARTA",50,125,120,245
https://kawalpemilu.org#26063,"PETUKANGAN SELATAN, PESANGGRAHAN, JAKARTA SELATAN, DKI JAKARTA",51,129,81,210
https://kawalpemilu.org#26063,"PETUKANGAN SELATAN, PESANGGRAHAN, JAKARTA SELATAN, DKI JAKARTA",52,159,84,243
https://kawalpemilu.org#26063,"PETUKANGAN SELATAN, PESANGGRAHAN, JAKARTA SELATAN, DKI JAKARTA",53,123,108,231
https://kawalpemilu.org#26063,"PETUKANGAN SELATAN, PESANGGRAHAN, JAKARTA SELATAN, DKI JAKARTA",54,243,39,282
https://kawalpemilu.org#26063,"PETUKANGAN SELATAN, PESANGGRAHAN, JAKARTA SELATAN, DKI JAKARTA",55,116,92,208
https://kawalpemilu.org#26063,"PETUKANGAN SELATAN, PESANGGRAHAN, JAKARTA SELATAN, DKI JAKARTA",56,125,133,258
https://kawalpemilu.org#26063,"PETUKANGAN SELATAN, PESANGGRAHAN, JAKARTA SELATAN, DKI JAKARTA",57,86,117,203
https://kawalpemilu.org#26063,"PETUKANGAN SELATAN, PESANGGRAHAN, JAKARTA SELATAN, DKI JAKARTA",58,153,82,235
https://kawalpemilu.org#26063,"PETUKANGAN SELATAN, PESANGGRAHAN, JAKARTA SELATAN, DKI JAKARTA",61,107,120,227
https://kawalpemilu.org#26063,"PETUKANGAN SELATAN, PESANGGRAHAN, JAKARTA SELATAN, DKI JAKARTA",62,117,125,242
https://kawalpemilu.org#26063,"PETUKANGAN SELATAN, PESANGGRAHAN, JAKARTA SELATAN, DKI JAKARTA",63,99,99,198
https://kawalpemilu.org#26063,"PETUKANGAN SELATAN, PESANGGRAHAN, JAKARTA SELATAN, DKI JAKARTA",64,125,96,221
https://kawalpemilu.org#26063,"PETUKANGAN SELATAN, PESANGGRAHAN, JAKARTA SELATAN, DKI JAKARTA",65,109,90,199
https://kawalpemilu.org#26063,"PETUKANGAN SELATAN, PESANGGRAHAN, JAKARTA SELATAN, DKI JAKARTA",66,125,123,248
https://kawalpemilu.org#26063,"PETUKANGAN SELATAN, PESANGGRAHAN, JAKARTA SELATAN, DKI JAKARTA",67,139,124,263
https://kawalpemilu.org#26063,"PETUKANGAN SELATAN, PESANGGRAHAN, JAKARTA SELATAN, DKI JAKARTA",68,111,135,246
https://kawalpemilu.org#26063,"PETUKANGAN SELATAN, PESANGGRAHAN, JAKARTA SELATAN, DKI JAKARTA",69,116,137,253
https://kawalpemilu.org#26063,"PETUKANGAN SELATAN, PESANGGRAHAN, JAKARTA SELATAN, DKI JAKARTA",70,101,112,213
https://kawalpemilu.org#26063,"PETUKANGAN SELATAN, PESANGGRAHAN, JAKARTA SELATAN, DKI JAKARTA",72,100,128,228
https://kawalpemilu.org#26063,"PETUKANGAN SELATAN, PESANGGRAHAN, JAKARTA SELATAN, DKI JAKARTA",73,104,141,245
https://kawalpemilu.org#26063,"PETUKANGAN SELATAN, PESANGGRAHAN, JAKARTA SELATAN, DKI JAKARTA",74,110,124,234
https://kawalpemilu.org#26063,"PETUKANGAN SELATAN, PESANGGRAHAN, JAKARTA SELATAN, DKI JAKARTA",76,92,107,199
https://kawalpemilu.org#26063,"PETUKANGAN SELATAN, PESANGGRAHAN, JAKARTA SELATAN, DKI JAKARTA",78,83,144,227
https://kawalpemilu.org#26063,"PETUKANGAN SELATAN, PESANGGRAHAN, JAKARTA SELATAN, DKI JAKARTA",79,137,73,210
https://kawalpemilu.org#26063,"PETUKANGAN SELATAN, PESANGGRAHAN, JAKARTA SELATAN, DKI JAKARTA",80,136,66,202
https://kawalpemilu.org#26063,"PETUKANGAN SELATAN, PESANGGRAHAN, JAKARTA SELATAN, DKI JAKARTA",81,161,46,207
https://kawalpemilu.org#26063,"PETUKANGAN SELATAN, PESANGGRAHAN, JAKARTA SELATAN, DKI JAKARTA",82,154,47,201
https://kawalpemilu.org#26063,"PETUKANGAN SELATAN, PESANGGRAHAN, JAKARTA SELATAN, DKI JAKARTA",83,155,65,220
https://kawalpemilu.org#26063,"PETUKANGAN SELATAN, PESANGGRAHAN, JAKARTA SELATAN, DKI JAKARTA",84,102,146,248
https://kawalpemilu.org#26063,"PETUKANGAN SELATAN, PESANGGRAHAN, JAKARTA SELATAN, DKI JAKARTA",85,107,127,234
https://kawalpemilu.org#26063,"PETUKANGAN SELATAN, PESANGGRAHAN, JAKARTA SELATAN, DKI JAKARTA",86,94,116,210
https://kawalpemilu.org#26063,"PETUKANGAN SELATAN, PESANGGRAHAN, JAKARTA SELATAN, DKI JAKARTA",87,103,160,263
https://kawalpemilu.org#26063,"PETUKANGAN SELATAN, PESANGGRAHAN, JAKARTA SELATAN, DKI JAKARTA",88,106,115,221
https://kawalpemilu.org#26063,"PETUKANGAN SELATAN, PESANGGRAHAN, JAKARTA SELATAN, DKI JAKARTA",89,116,114,230
https://kawalpemilu.org#26063,"PETUKANGAN SELATAN, PESANGGRAHAN, JAKARTA SELATAN, DKI JAKARTA",90,126,141,267
https://kawalpemilu.org#26063,"PETUKANGAN SELATAN, PESANGGRAHAN, JAKARTA SELATAN, DKI JAKARTA",91,59,118,177
https://kawalpemilu.org#26063,"PETUKANGAN SELATAN, PESANGGRAHAN, JAKARTA SELATAN, DKI JAKARTA",92,96,138,234
https://kawalpemilu.org#26063,"PETUKANGAN SELATAN, PESANGGRAHAN, JAKARTA SELATAN, DKI JAKARTA",93,104,136,240
https://kawalpemilu.org#26063,"PETUKANGAN SELATAN, PESANGGRAHAN, JAKARTA SELATAN, DKI JAKARTA",94,145,70,215
https://kawalpemilu.org#26063,"PETUKANGAN SELATAN, PESANGGRAHAN, JAKARTA SELATAN, DKI JAKARTA",95,153,102,255
https://kawalpemilu.org#26063,"PETUKANGAN SELATAN, PESANGGRAHAN, JAKARTA SELATAN, DKI JAKARTA",96,87,114,201
https://kawalpemilu.org#26063,"PETUKANGAN SELATAN, PESANGGRAHAN, JAKARTA SELATAN, DKI JAKARTA",97,113,61,174
https://kawalpemilu.org#26063,"PETUKANGAN SELATAN, PESANGGRAHAN, JAKARTA SELATAN, DKI JAKARTA",98,100,55,155
https://kawalpemilu.org#26063,"PETUKANGAN SELATAN, PESANGGRAHAN, JAKARTA SELATAN, DKI JAKARTA",99,97,131,228
https://kawalpemilu.org#26063,"PETUKANGAN SELATAN, PESANGGRAHAN, JAKARTA SELATAN, DKI JAKARTA",100,86,134,220
https://kawalpemilu.org#26063,"PETUKANGAN SELATAN, PESANGGRAHAN, JAKARTA SELATAN, DKI JAKARTA",101,130,130,260
https://kawalpemilu.org#26063,"PETUKANGAN SELATAN, PESANGGRAHAN, JAKARTA SELATAN, DKI JAKARTA",102,83,135,218
https://kawalpemilu.org#26063,"PETUKANGAN SELATAN, PESANGGRAHAN, JAKARTA SELATAN, DKI JAKARTA",103,99,146,245
https://kawalpemilu.org#26063,"PETUKANGAN SELATAN, PESANGGRAHAN, JAKARTA SELATAN, DKI JAKARTA",104,82,109,191
https://kawalpemilu.org#26063,"PETUKANGAN SELATAN, PESANGGRAHAN, JAKARTA SELATAN, DKI JAKARTA",105,119,139,258
https://kawalpemilu.org#26063,"PETUKANGAN SELATAN, PESANGGRAHAN, JAKARTA SELATAN, DKI JAKARTA",106,125,123,248
https://kawalpemilu.org#26063,"PETUKANGAN SELATAN, PESANGGRAHAN, JAKARTA SELATAN, DKI JAKARTA",107,106,137,243
https://kawalpemilu.org#26063,"PETUKANGAN SELATAN, PESANGGRAHAN, JAKARTA SELATAN, DKI JAKARTA",108,95,134,233
https://kawalpemilu.org#26063,"PETUKANGAN SELATAN, PESANGGRAHAN, JAKARTA SELATAN, DKI JAKARTA",109,90,131,221
https://kawalpemilu.org#26063,"PETUKANGAN SELATAN, PESANGGRAHAN, JAKARTA SELATAN, DKI JAKARTA",110,106,114,220
https://kawalpemilu.org#26063,"PETUKANGAN SELATAN, PESANGGRAHAN, JAKARTA SELATAN, DKI JAKARTA",111,129,106,235
https://kawalpemilu.org#26063,"PETUKANGAN SELATAN, PESANGGRAHAN, JAKARTA SELATAN, DKI JAKARTA",112,141,97,238
https://kawalpemilu.org#26063,"PETUKANGAN SELATAN, PESANGGRAHAN, JAKARTA SELATAN, DKI JAKARTA",114,169,71,240
https://kawalpemilu.org#26064,"ULUJAMI, PESANGGRAHAN, JAKARTA SELATAN, DKI JAKARTA",2,105,89,194
https://kawalpemilu.org#26064,"ULUJAMI, PESANGGRAHAN, JAKARTA SELATAN, DKI JAKARTA",4,113,112,225
https://kawalpemilu.org#26064,"ULUJAMI, PESANGGRAHAN, JAKARTA SELATAN, DKI JAKARTA",5,114,133,247
https://kawalpemilu.org#26064,"ULUJAMI, PESANGGRAHAN, JAKARTA SELATAN, DKI JAKARTA",6,132,107,239
https://kawalpemilu.org#26064,"ULUJAMI, PESANGGRAHAN, JAKARTA SELATAN, DKI JAKARTA",7,107,86,193
https://kawalpemilu.org#26064,"ULUJAMI, PESANGGRAHAN, JAKARTA SELATAN, DKI JAKARTA",8,130,96,226
https://kawalpemilu.org#26064,"ULUJAMI, PESANGGRAHAN, JAKARTA SELATAN, DKI JAKARTA",9,144,93,237
https://kawalpemilu.org#26064,"ULUJAMI, PESANGGRAHAN, JAKARTA SELATAN, DKI JAKARTA",10,111,87,198
https://kawalpemilu.org#26064,"ULUJAMI, PESANGGRAHAN, JAKARTA SELATAN, DKI JAKARTA",11,68,117,185
https://kawalpemilu.org#26064,"ULUJAMI, PESANGGRAHAN, JAKARTA SELATAN, DKI JAKARTA",12,85,110,195
https://kawalpemilu.org#26064,"ULUJAMI, PESANGGRAHAN, JAKARTA SELATAN, DKI JAKARTA",13,100,102,202
https://kawalpemilu.org#26064,"ULUJAMI, PESANGGRAHAN, JAKARTA SELATAN, DKI JAKARTA",14,96,109,205
https://kawalpemilu.org#26064,"ULUJAMI, PESANGGRAHAN, JAKARTA SELATAN, DKI JAKARTA",15,98,118,216
https://kawalpemilu.org#26064,"ULUJAMI, PESANGGRAHAN, JAKARTA SELATAN, DKI JAKARTA",17,94,85,179
https://kawalpemilu.org#26064,"ULUJAMI, PESANGGRAHAN, JAKARTA SELATAN, DKI JAKARTA",18,78,104,182
https://kawalpemilu.org#26064,"ULUJAMI, PESANGGRAHAN, JAKARTA SELATAN, DKI JAKARTA",19,116,93,209
https://kawalpemilu.org#26064,"ULUJAMI, PESANGGRAHAN, JAKARTA SELATAN, DKI JAKARTA",20,99,138,237
https://kawalpemilu.org#26064,"ULUJAMI, PESANGGRAHAN, JAKARTA SELATAN, DKI JAKARTA",21,83,149,232
https://kawalpemilu.org#26064,"ULUJAMI, PESANGGRAHAN, JAKARTA SELATAN, DKI JAKARTA",23,114,99,213
https://kawalpemilu.org#26064,"ULUJAMI, PESANGGRAHAN, JAKARTA SELATAN, DKI JAKARTA",25,102,153,255
https://kawalpemilu.org#26064,"ULUJAMI, PESANGGRAHAN, JAKARTA SELATAN, DKI JAKARTA",26,112,134,246
https://kawalpemilu.org#26064,"ULUJAMI, PESANGGRAHAN, JAKARTA SELATAN, DKI JAKARTA",27,120,124,244
https://kawalpemilu.org#26064,"ULUJAMI, PESANGGRAHAN, JAKARTA SELATAN, DKI JAKARTA",29,114,101,215
https://kawalpemilu.org#26064,"ULUJAMI, PESANGGRAHAN, JAKARTA SELATAN, DKI JAKARTA",30,134,126,260
https://kawalpemilu.org#26064,"ULUJAMI, PESANGGRAHAN, JAKARTA SELATAN, DKI JAKARTA",31,115,121,236
https://kawalpemilu.org#26064,"ULUJAMI, PESANGGRAHAN, JAKARTA SELATAN, DKI JAKARTA",32,77,151,228
https://kawalpemilu.org#26064,"ULUJAMI, PESANGGRAHAN, JAKARTA SELATAN, DKI JAKARTA",33,78,143,221
https://kawalpemilu.org#26064,"ULUJAMI, PESANGGRAHAN, JAKARTA SELATAN, DKI JAKARTA",36,92,120,212
https://kawalpemilu.org#26064,"ULUJAMI, PESANGGRAHAN, JAKARTA SELATAN, DKI JAKARTA",37,133,123,256
https://kawalpemilu.org#26064,"ULUJAMI, PESANGGRAHAN, JAKARTA SELATAN, DKI JAKARTA",38,106,130,236
https://kawalpemilu.org#26064,"ULUJAMI, PESANGGRAHAN, JAKARTA SELATAN, DKI JAKARTA",39,120,104,224
https://kawalpemilu.org#26064,"ULUJAMI, PESANGGRAHAN, JAKARTA SELATAN, DKI JAKARTA",40,105,161,266
https://kawalpemilu.org#26064,"ULUJAMI, PESANGGRAHAN, JAKARTA SELATAN, DKI JAKARTA",41,77,106,183
https://kawalpemilu.org#26064,"ULUJAMI, PESANGGRAHAN, JAKARTA SELATAN, DKI JAKARTA",45,77,178,255
https://kawalpemilu.org#26064,"ULUJAMI, PESANGGRAHAN, JAKARTA SELATAN, DKI JAKARTA",46,65,163,228
https://kawalpemilu.org#26064,"ULUJAMI, PESANGGRAHAN, JAKARTA SELATAN, DKI JAKARTA",47,88,145,233
https://kawalpemilu.org#26064,"ULUJAMI, PESANGGRAHAN, JAKARTA SELATAN, DKI JAKARTA",50,89,147,236
https://kawalpemilu.org#26064,"ULUJAMI, PESANGGRAHAN, JAKARTA SELATAN, DKI JAKARTA",52,86,134,220
https://kawalpemilu.org#26064,"ULUJAMI, PESANGGRAHAN, JAKARTA SELATAN, DKI JAKARTA",53,73,127,200
https://kawalpemilu.org#26064,"ULUJAMI, PESANGGRAHAN, JAKARTA SELATAN, DKI JAKARTA",55,87,137,224
https://kawalpemilu.org#26064,"ULUJAMI, PESANGGRAHAN, JAKARTA SELATAN, DKI JAKARTA",56,109,132,241
https://kawalpemilu.org#26064,"ULUJAMI, PESANGGRAHAN, JAKARTA SELATAN, DKI JAKARTA",57,127,156,283
https://kawalpemilu.org#26064,"ULUJAMI, PESANGGRAHAN, JAKARTA SELATAN, DKI JAKARTA",58,86,158,244
https://kawalpemilu.org#26064,"ULUJAMI, PESANGGRAHAN, JAKARTA SELATAN, DKI JAKARTA",59,87,156,243
https://kawalpemilu.org#26064,"ULUJAMI, PESANGGRAHAN, JAKARTA SELATAN, DKI JAKARTA",61,99,106,205
https://kawalpemilu.org#26064,"ULUJAMI, PESANGGRAHAN, JAKARTA SELATAN, DKI JAKARTA",63,100,143,243
https://kawalpemilu.org#26064,"ULUJAMI, PESANGGRAHAN, JAKARTA SELATAN, DKI JAKARTA",64,53,162,215
https://kawalpemilu.org#26064,"ULUJAMI, PESANGGRAHAN, JAKARTA SELATAN, DKI JAKARTA",65,87,100,187
https://kawalpemilu.org#26064,"ULUJAMI, PESANGGRAHAN, JAKARTA SELATAN, DKI JAKARTA",66,88,96,184
https://kawalpemilu.org#26064,"ULUJAMI, PESANGGRAHAN, JAKARTA SELATAN, DKI JAKARTA",67,87,116,203
https://kawalpemilu.org#26064,"ULUJAMI, PESANGGRAHAN, JAKARTA SELATAN, DKI JAKARTA",68,54,200,254
https://kawalpemilu.org#26064,"ULUJAMI, PESANGGRAHAN, JAKARTA SELATAN, DKI JAKARTA",69,56,129,185
https://kawalpemilu.org#26064,"ULUJAMI, PESANGGRAHAN, JAKARTA SELATAN, DKI JAKARTA",70,57,175,232
https://kawalpemilu.org#26064,"ULUJAMI, PESANGGRAHAN, JAKARTA SELATAN, DKI JAKARTA",71,42,171,213
https://kawalpemilu.org#26064,"ULUJAMI, PESANGGRAHAN, JAKARTA SELATAN, DKI JAKARTA",72,54,180,234
https://kawalpemilu.org#26064,"ULUJAMI, PESANGGRAHAN, JAKARTA SELATAN, DKI JAKARTA",73,53,162,215
https://kawalpemilu.org#26064,"ULUJAMI, PESANGGRAHAN, JAKARTA SELATAN, DKI JAKARTA",74,63,127,190
https://kawalpemilu.org#26064,"ULUJAMI, PESANGGRAHAN, JAKARTA SELATAN, DKI JAKARTA",75,68,138,206
https://kawalpemilu.org#26064,"ULUJAMI, PESANGGRAHAN, JAKARTA SELATAN, DKI JAKARTA",76,63,145,208
https://kawalpemilu.org#26064,"ULUJAMI, PESANGGRAHAN, JAKARTA SELATAN, DKI JAKARTA",77,52,206,258
https://kawalpemilu.org#26064,"ULUJAMI, PESANGGRAHAN, JAKARTA SELATAN, DKI JAKARTA",78,57,140,197
https://kawalpemilu.org#26064,"ULUJAMI, PESANGGRAHAN, JAKARTA SELATAN, DKI JAKARTA",79,64,140,204
https://kawalpemilu.org#26064,"ULUJAMI, PESANGGRAHAN, JAKARTA SELATAN, DKI JAKARTA",80,71,131,202
https://kawalpemilu.org#26064,"ULUJAMI, PESANGGRAHAN, JAKARTA SELATAN, DKI JAKARTA",81,74,137,211
https://kawalpemilu.org#26064,"ULUJAMI, PESANGGRAHAN, JAKARTA SELATAN, DKI JAKARTA",83,66,158,224
https://kawalpemilu.org#26064,"ULUJAMI, PESANGGRAHAN, JAKARTA SELATAN, DKI JAKARTA",84,64,197,261
https://kawalpemilu.org#26064,"ULUJAMI, PESANGGRAHAN, JAKARTA SELATAN, DKI JAKARTA",85,95,164,259
https://kawalpemilu.org#26064,"ULUJAMI, PESANGGRAHAN, JAKARTA SELATAN, DKI JAKARTA",86,71,157,228
https://kawalpemilu.org#26064,"ULUJAMI, PESANGGRAHAN, JAKARTA SELATAN, DKI JAKARTA",87,56,188,244
https://kawalpemilu.org#26064,"ULUJAMI, PESANGGRAHAN, JAKARTA SELATAN, DKI JAKARTA",88,88,125,213
https://kawalpemilu.org#26064,"ULUJAMI, PESANGGRAHAN, JAKARTA SELATAN, DKI JAKARTA",91,114,96,210
https://kawalpemilu.org#26064,"ULUJAMI, PESANGGRAHAN, JAKARTA SELATAN, DKI JAKARTA",92,74,130,204
https://kawalpemilu.org#26064,"ULUJAMI, PESANGGRAHAN, JAKARTA SELATAN, DKI JAKARTA",93,132,99,231
https://kawalpemilu.org#26064,"ULUJAMI, PESANGGRAHAN, JAKARTA SELATAN, DKI JAKARTA",94,72,165,237
https://kawalpemilu.org#26064,"ULUJAMI, PESANGGRAHAN, JAKARTA SELATAN, DKI JAKARTA",95,105,105,210
https://kawalpemilu.org#26064,"ULUJAMI, PESANGGRAHAN, JAKARTA SELATAN, DKI JAKARTA",96,118,72,190
https://kawalpemilu.org#26064,"ULUJAMI, PESANGGRAHAN, JAKARTA SELATAN, DKI JAKARTA",98,39,140,179
https://kawalpemilu.org#26064,"ULUJAMI, PESANGGRAHAN, JAKARTA SELATAN, DKI JAKARTA",99,55,154,209
https://kawalpemilu.org#26064,"ULUJAMI, PESANGGRAHAN, JAKARTA SELATAN, DKI JAKARTA",100,74,154,228
https://kawalpemilu.org#26064,"ULUJAMI, PESANGGRAHAN, JAKARTA SELATAN, DKI JAKARTA",103,76,130,206
https://kawalpemilu.org#26064,"ULUJAMI, PESANGGRAHAN, JAKARTA SELATAN, DKI JAKARTA",104,60,126,186
https://kawalpemilu.org#26064,"ULUJAMI, PESANGGRAHAN, JAKARTA SELATAN, DKI JAKARTA",105,71,180,251
https://kawalpemilu.org#26064,"ULUJAMI, PESANGGRAHAN, JAKARTA SELATAN, DKI JAKARTA",106,55,167,222
https://kawalpemilu.org#26064,"ULUJAMI, PESANGGRAHAN, JAKARTA SELATAN, DKI JAKARTA",107,86,138,224
https://kawalpemilu.org#26064,"ULUJAMI, PESANGGRAHAN, JAKARTA SELATAN, DKI JAKARTA",108,91,141,232
https://kawalpemilu.org#26064,"ULUJAMI, PESANGGRAHAN, JAKARTA SELATAN, DKI JAKARTA",110,91,142,233
https://kawalpemilu.org#26064,"ULUJAMI, PESANGGRAHAN, JAKARTA SELATAN, DKI JAKARTA",112,79,146,225
https://kawalpemilu.org#26064,"ULUJAMI, PESANGGRAHAN, JAKARTA SELATAN, DKI JAKARTA",114,90,120,210
https://kawalpemilu.org#26064,"ULUJAMI, PESANGGRAHAN, JAKARTA SELATAN, DKI JAKARTA",115,66,139,205
https://kawalpemilu.org#26064,"ULUJAMI, PESANGGRAHAN, JAKARTA SELATAN, DKI JAKARTA",116,102,102,204
https://kawalpemilu.org#26064,"ULUJAMI, PESANGGRAHAN, JAKARTA SELATAN, DKI JAKARTA",117,116,133,249
https://kawalpemilu.org#26064,"ULUJAMI, PESANGGRAHAN, JAKARTA SELATAN, DKI JAKARTA",118,87,137,224
https://kawalpemilu.org#26064,"ULUJAMI, PESANGGRAHAN, JAKARTA SELATAN, DKI JAKARTA",120,83,130,213
https://kawalpemilu.org#26064,"ULUJAMI, PESANGGRAHAN, JAKARTA SELATAN, DKI JAKARTA",121,108,121,229
https://kawalpemilu.org#26064,"ULUJAMI, PESANGGRAHAN, JAKARTA SELATAN, DKI JAKARTA",122,86,91,177
https://kawalpemilu.org#26064,"ULUJAMI, PESANGGRAHAN, JAKARTA SELATAN, DKI JAKARTA",124,87,130,217
https://kawalpemilu.org#26064,"ULUJAMI, PESANGGRAHAN, JAKARTA SELATAN, DKI JAKARTA",128,92,141,233
https://kawalpemilu.org#26064,"ULUJAMI, PESANGGRAHAN, JAKARTA SELATAN, DKI JAKARTA",129,84,154,238
https://kawalpemilu.org#26064,"ULUJAMI, PESANGGRAHAN, JAKARTA SELATAN, DKI JAKARTA",130,147,49,196
https://kawalpemilu.org#26064,"ULUJAMI, PESANGGRAHAN, JAKARTA SELATAN, DKI JAKARTA",131,167,58,225
https://kawalpemilu.org#26064,"ULUJAMI, PESANGGRAHAN, JAKARTA SELATAN, DKI JAKARTA",132,166,37,203
https://kawalpemilu.org#26067,"PISANGAN BARU, MATRAMAN, JAKARTA TIMUR, DKI JAKARTA",1,74,162,236
https://kawalpemilu.org#26067,"PISANGAN BARU, MATRAMAN, JAKARTA TIMUR, DKI JAKARTA",2,88,139,227
https://kawalpemilu.org#26067,"PISANGAN BARU, MATRAMAN, JAKARTA TIMUR, DKI JAKARTA",3,93,129,222
https://kawalpemilu.org#26067,"PISANGAN BARU, MATRAMAN, JAKARTA TIMUR, DKI JAKARTA",4,136,83,219
https://kawalpemilu.org#26067,"PISANGAN BARU, MATRAMAN, JAKARTA TIMUR, DKI JAKARTA",5,109,80,189
https://kawalpemilu.org#26067,"PISANGAN BARU, MATRAMAN, JAKARTA TIMUR, DKI JAKARTA",6,102,102,204
https://kawalpemilu.org#26067,"PISANGAN BARU, MATRAMAN, JAKARTA TIMUR, DKI JAKARTA",7,65,166,231
https://kawalpemilu.org#26067,"PISANGAN BARU, MATRAMAN, JAKARTA TIMUR, DKI JAKARTA",8,111,103,214
https://kawalpemilu.org#26067,"PISANGAN BARU, MATRAMAN, JAKARTA TIMUR, DKI JAKARTA",9,86,114,200
https://kawalpemilu.org#26067,"PISANGAN BARU, MATRAMAN, JAKARTA TIMUR, DKI JAKARTA",10,57,122,179
https://kawalpemilu.org#26067,"PISANGAN BARU, MATRAMAN, JAKARTA TIMUR, DKI JAKARTA",11,106,82,188
https://kawalpemilu.org#26067,"PISANGAN BARU, MATRAMAN, JAKARTA TIMUR, DKI JAKARTA",12,107,122,229
https://kawalpemilu.org#26067,"PISANGAN BARU, MATRAMAN, JAKARTA TIMUR, DKI JAKARTA",13,131,106,237
https://kawalpemilu.org#26067,"PISANGAN BARU, MATRAMAN, JAKARTA TIMUR, DKI JAKARTA",14,105,105,210
https://kawalpemilu.org#26067,"PISANGAN BARU, MATRAMAN, JAKARTA TIMUR, DKI JAKARTA",15,105,109,214
https://kawalpemilu.org#26067,"PISANGAN BARU, MATRAMAN, JAKARTA TIMUR, DKI JAKARTA",16,98,131,229
https://kawalpemilu.org#26067,"PISANGAN BARU, MATRAMAN, JAKARTA TIMUR, DKI JAKARTA",17,110,107,217
https://kawalpemilu.org#26067,"PISANGAN BARU, MATRAMAN, JAKARTA TIMUR, DKI JAKARTA",18,103,127,230
https://kawalpemilu.org#26067,"PISANGAN BARU, MATRAMAN, JAKARTA TIMUR, DKI JAKARTA",19,112,131,243
https://kawalpemilu.org#26067,"PISANGAN BARU, MATRAMAN, JAKARTA TIMUR, DKI JAKARTA",20,125,132,257
https://kawalpemilu.org#26067,"PISANGAN BARU, MATRAMAN, JAKARTA TIMUR, DKI JAKARTA",21,126,111,237
https://kawalpemilu.org#26067,"PISANGAN BARU, MATRAMAN, JAKARTA TIMUR, DKI JAKARTA",22,82,161,243
https://kawalpemilu.org#26067,"PISANGAN BARU, MATRAMAN, JAKARTA TIMUR, DKI JAKARTA",23,109,131,240
https://kawalpemilu.org#26067,"PISANGAN BARU, MATRAMAN, JAKARTA TIMUR, DKI JAKARTA",24,99,120,219
https://kawalpemilu.org#26067,"PISANGAN BARU, MATRAMAN, JAKARTA TIMUR, DKI JAKARTA",25,53,138,191
https://kawalpemilu.org#26067,"PISANGAN BARU, MATRAMAN, JAKARTA TIMUR, DKI JAKARTA",26,77,150,227
https://kawalpemilu.org#26067,"PISANGAN BARU, MATRAMAN, JAKARTA TIMUR, DKI JAKARTA",27,79,155,234
https://kawalpemilu.org#26067,"PISANGAN BARU, MATRAMAN, JAKARTA TIMUR, DKI JAKARTA",28,63,142,205
https://kawalpemilu.org#26067,"PISANGAN BARU, MATRAMAN, JAKARTA TIMUR, DKI JAKARTA",29,63,139,202
https://kawalpemilu.org#26067,"PISANGAN BARU, MATRAMAN, JAKARTA TIMUR, DKI JAKARTA",30,96,111,207
https://kawalpemilu.org#26067,"PISANGAN BARU, MATRAMAN, JAKARTA TIMUR, DKI JAKARTA",31,117,97,214
https://kawalpemilu.org#26067,"PISANGAN BARU, MATRAMAN, JAKARTA TIMUR, DKI JAKARTA",32,69,161,230
https://kawalpemilu.org#26067,"PISANGAN BARU, MATRAMAN, JAKARTA TIMUR, DKI JAKARTA",33,71,168,239
https://kawalpemilu.org#26067,"PISANGAN BARU, MATRAMAN, JAKARTA TIMUR, DKI JAKARTA",34,56,135,191
https://kawalpemilu.org#26067,"PISANGAN BARU, MATRAMAN, JAKARTA TIMUR, DKI JAKARTA",35,61,134,195
https://kawalpemilu.org#26067,"PISANGAN BARU, MATRAMAN, JAKARTA TIMUR, DKI JAKARTA",36,82,132,214
https://kawalpemilu.org#26067,"PISANGAN BARU, MATRAMAN, JAKARTA TIMUR, DKI JAKARTA",37,102,138,240
https://kawalpemilu.org#26067,"PISANGAN BARU, MATRAMAN, JAKARTA TIMUR, DKI JAKARTA",38,69,143,212
https://kawalpemilu.org#26067,"PISANGAN BARU, MATRAMAN, JAKARTA TIMUR, DKI JAKARTA",39,100,124,224
https://kawalpemilu.org#26067,"PISANGAN BARU, MATRAMAN, JAKARTA TIMUR, DKI JAKARTA",40,100,152,252
https://kawalpemilu.org#26067,"PISANGAN BARU, MATRAMAN, JAKARTA TIMUR, DKI JAKARTA",41,73,148,221
https://kawalpemilu.org#26067,"PISANGAN BARU, MATRAMAN, JAKARTA TIMUR, DKI JAKARTA",42,72,158,230
https://kawalpemilu.org#26067,"PISANGAN BARU, MATRAMAN, JAKARTA TIMUR, DKI JAKARTA",43,28,209,237
https://kawalpemilu.org#26067,"PISANGAN BARU, MATRAMAN, JAKARTA TIMUR, DKI JAKARTA",44,90,129,219
https://kawalpemilu.org#26067,"PISANGAN BARU, MATRAMAN, JAKARTA TIMUR, DKI JAKARTA",45,79,162,241
https://kawalpemilu.org#26067,"PISANGAN BARU, MATRAMAN, JAKARTA TIMUR, DKI JAKARTA",46,55,153,208
https://kawalpemilu.org#26067,"PISANGAN BARU, MATRAMAN, JAKARTA TIMUR, DKI JAKARTA",47,71,128,199
https://kawalpemilu.org#26067,"PISANGAN BARU, MATRAMAN, JAKARTA TIMUR, DKI JAKARTA",48,83,156,239
https://kawalpemilu.org#26067,"PISANGAN BARU, MATRAMAN, JAKARTA TIMUR, DKI JAKARTA",49,84,138,222
https://kawalpemilu.org#26067,"PISANGAN BARU, MATRAMAN, JAKARTA TIMUR, DKI JAKARTA",50,108,104,212
https://kawalpemilu.org#26067,"PISANGAN BARU, MATRAMAN, JAKARTA TIMUR, DKI JAKARTA",51,101,128,229
https://kawalpemilu.org#26067,"PISANGAN BARU, MATRAMAN, JAKARTA TIMUR, DKI JAKARTA",52,91,107,198
https://kawalpemilu.org#26067,"PISANGAN BARU, MATRAMAN, JAKARTA TIMUR, DKI JAKARTA",53,105,127,232
https://kawalpemilu.org#26067,"PISANGAN BARU, MATRAMAN, JAKARTA TIMUR, DKI JAKARTA",54,105,127,232
https://kawalpemilu.org#26067,"PISANGAN BARU, MATRAMAN, JAKARTA TIMUR, DKI JAKARTA",55,143,91,234
https://kawalpemilu.org#26067,"PISANGAN BARU, MATRAMAN, JAKARTA TIMUR, DKI JAKARTA",56,149,84,233
https://kawalpemilu.org#26067,"PISANGAN BARU, MATRAMAN, JAKARTA TIMUR, DKI JAKARTA",57,165,74,239
https://kawalpemilu.org#26067,"PISANGAN BARU, MATRAMAN, JAKARTA TIMUR, DKI JAKARTA",58,178,70,248
https://kawalpemilu.org#26067,"PISANGAN BARU, MATRAMAN, JAKARTA TIMUR, DKI JAKARTA",59,134,120,254
https://kawalpemilu.org#26067,"PISANGAN BARU, MATRAMAN, JAKARTA TIMUR, DKI JAKARTA",60,124,120,244
https://kawalpemilu.org#26067,"PISANGAN BARU, MATRAMAN, JAKARTA TIMUR, DKI JAKARTA",61,109,143,252
https://kawalpemilu.org#26067,"PISANGAN BARU, MATRAMAN, JAKARTA TIMUR, DKI JAKARTA",62,138,102,240
https://kawalpemilu.org#26067,"PISANGAN BARU, MATRAMAN, JAKARTA TIMUR, DKI JAKARTA",63,113,143,256
https://kawalpemilu.org#26067,"PISANGAN BARU, MATRAMAN, JAKARTA TIMUR, DKI JAKARTA",64,105,123,228
https://kawalpemilu.org#26067,"PISANGAN BARU, MATRAMAN, JAKARTA TIMUR, DKI JAKARTA",65,127,118,245
https://kawalpemilu.org#26067,"PISANGAN BARU, MATRAMAN, JAKARTA TIMUR, DKI JAKARTA",66,86,122,208
https://kawalpemilu.org#26067,"PISANGAN BARU, MATRAMAN, JAKARTA TIMUR, DKI JAKARTA",67,91,140,231
https://kawalpemilu.org#26067,"PISANGAN BARU, MATRAMAN, JAKARTA TIMUR, DKI JAKARTA",68,86,153,239
https://kawalpemilu.org#26067,"PISANGAN BARU, MATRAMAN, JAKARTA TIMUR, DKI JAKARTA",69,101,129,230
https://kawalpemilu.org#26067,"PISANGAN BARU, MATRAMAN, JAKARTA TIMUR, DKI JAKARTA",70,98,122,220
https://kawalpemilu.org#26067,"PISANGAN BARU, MATRAMAN, JAKARTA TIMUR, DKI JAKARTA",71,58,146,204
https://kawalpemilu.org#26067,"PISANGAN BARU, MATRAMAN, JAKARTA TIMUR, DKI JAKARTA",72,66,190,256
https://kawalpemilu.org#26067,"PISANGAN BARU, MATRAMAN, JAKARTA TIMUR, DKI JAKARTA",73,75,158,233
https://kawalpemilu.org#26067,"PISANGAN BARU, MATRAMAN, JAKARTA TIMUR, DKI JAKARTA",74,60,163,223
https://kawalpemilu.org#26067,"PISANGAN BARU, MATRAMAN, JAKARTA TIMUR, DKI JAKARTA",75,77,178,255
https://kawalpemilu.org#26067,"PISANGAN BARU, MATRAMAN, JAKARTA TIMUR, DKI JAKARTA",76,80,140,200
https://kawalpemilu.org#26067,"PISANGAN BARU, MATRAMAN, JAKARTA TIMUR, DKI JAKARTA",77,100,133,233
https://kawalpemilu.org#26067,"PISANGAN BARU, MATRAMAN, JAKARTA TIMUR, DKI JAKARTA",78,80,132,212
https://kawalpemilu.org#26067,"PISANGAN BARU, MATRAMAN, JAKARTA TIMUR, DKI JAKARTA",79,105,111,216
https://kawalpemilu.org#26067,"PISANGAN BARU, MATRAMAN, JAKARTA TIMUR, DKI JAKARTA",80,81,123,204
https://kawalpemilu.org#26067,"PISANGAN BARU, MATRAMAN, JAKARTA TIMUR, DKI JAKARTA",81,107,133,240
https://kawalpemilu.org#26067,"PISANGAN BARU, MATRAMAN, JAKARTA TIMUR, DKI JAKARTA",82,68,171,239
https://kawalpemilu.org#26067,"PISANGAN BARU, MATRAMAN, JAKARTA TIMUR, DKI JAKARTA",83,88,159,247
https://kawalpemilu.org#26067,"PISANGAN BARU, MATRAMAN, JAKARTA TIMUR, DKI JAKARTA",84,109,120,229
https://kawalpemilu.org#26067,"PISANGAN BARU, MATRAMAN, JAKARTA TIMUR, DKI JAKARTA",85,97,113,210
https://kawalpemilu.org#26067,"PISANGAN BARU, MATRAMAN, JAKARTA TIMUR, DKI JAKARTA",86,120,105,225
https://kawalpemilu.org#26067,"PISANGAN BARU, MATRAMAN, JAKARTA TIMUR, DKI JAKARTA",87,107,112,219
https://kawalpemilu.org#26067,"PISANGAN BARU, MATRAMAN, JAKARTA TIMUR, DKI JAKARTA",88,74,141,215
https://kawalpemilu.org#26067,"PISANGAN BARU, MATRAMAN, JAKARTA TIMUR, DKI JAKARTA",89,88,127,215
https://kawalpemilu.org#26067,"PISANGAN BARU, MATRAMAN, JAKARTA TIMUR, DKI JAKARTA",90,82,164,246
https://kawalpemilu.org#26067,"PISANGAN BARU, MATRAMAN, JAKARTA TIMUR, DKI JAKARTA",91,123,105,228
https://kawalpemilu.org#26067,"PISANGAN BARU, MATRAMAN, JAKARTA TIMUR, DKI JAKARTA",92,117,102,219
https://kawalpemilu.org#26067,"PISANGAN BARU, MATRAMAN, JAKARTA TIMUR, DKI JAKARTA",93,117,111,228
https://kawalpemilu.org#26067,"PISANGAN BARU, MATRAMAN, JAKARTA TIMUR, DKI JAKARTA",94,105,124,229
https://kawalpemilu.org#26067,"PISANGAN BARU, MATRAMAN, JAKARTA TIMUR, DKI JAKARTA",95,104,138,242
https://kawalpemilu.org#26067,"PISANGAN BARU, MATRAMAN, JAKARTA TIMUR, DKI JAKARTA",96,128,94,222
https://kawalpemilu.org#26067,"PISANGAN BARU, MATRAMAN, JAKARTA TIMUR, DKI JAKARTA",97,103,85,188
https://kawalpemilu.org#26067,"PISANGAN BARU, MATRAMAN, JAKARTA TIMUR, DKI JAKARTA",98,152,92,244
https://kawalpemilu.org#26067,"PISANGAN BARU, MATRAMAN, JAKARTA TIMUR, DKI JAKARTA",99,156,111,267
https://kawalpemilu.org#26067,"PISANGAN BARU, MATRAMAN, JAKARTA TIMUR, DKI JAKARTA",100,138,94,232
https://kawalpemilu.org#26067,"PISANGAN BARU, MATRAMAN, JAKARTA TIMUR, DKI JAKARTA",101,65,113,178
https://kawalpemilu.org#26067,"PISANGAN BARU, MATRAMAN, JAKARTA TIMUR, DKI JAKARTA",102,57,72,129
https://kawalpemilu.org#26067,"PISANGAN BARU, MATRAMAN, JAKARTA TIMUR, DKI JAKARTA",103,116,100,216
https://kawalpemilu.org#26068,"UTAN KAYU UTARA, MATRAMAN, JAKARTA TIMUR, DKI JAKARTA",1,120,83,203
https://kawalpemilu.org#26068,"UTAN KAYU UTARA, MATRAMAN, JAKARTA TIMUR, DKI JAKARTA",2,128,115,243
https://kawalpemilu.org#26068,"UTAN KAYU UTARA, MATRAMAN, JAKARTA TIMUR, DKI JAKARTA",3,102,128,230
https://kawalpemilu.org#26068,"UTAN KAYU UTARA, MATRAMAN, JAKARTA TIMUR, DKI JAKARTA",4,89,123,212
https://kawalpemilu.org#26068,"UTAN KAYU UTARA, MATRAMAN, JAKARTA TIMUR, DKI JAKARTA",5,96,120,216
https://kawalpemilu.org#26068,"UTAN KAYU UTARA, MATRAMAN, JAKARTA TIMUR, DKI JAKARTA",6,127,78,205
https://kawalpemilu.org#26068,"UTAN KAYU UTARA, MATRAMAN, JAKARTA TIMUR, DKI JAKARTA",7,109,121,230
https://kawalpemilu.org#26068,"UTAN KAYU UTARA, MATRAMAN, JAKARTA TIMUR, DKI JAKARTA",8,96,159,255
https://kawalpemilu.org#26068,"UTAN KAYU UTARA, MATRAMAN, JAKARTA TIMUR, DKI JAKARTA",9,94,135,229
https://kawalpemilu.org#26068,"UTAN KAYU UTARA, MATRAMAN, JAKARTA TIMUR, DKI JAKARTA",10,105,141,246
https://kawalpemilu.org#26068,"UTAN KAYU UTARA, MATRAMAN, JAKARTA TIMUR, DKI JAKARTA",12,118,112,230
https://kawalpemilu.org#26068,"UTAN KAYU UTARA, MATRAMAN, JAKARTA TIMUR, DKI JAKARTA",13,133,87,220
https://kawalpemilu.org#26068,"UTAN KAYU UTARA, MATRAMAN, JAKARTA TIMUR, DKI JAKARTA",14,97,124,221
https://kawalpemilu.org#26068,"UTAN KAYU UTARA, MATRAMAN, JAKARTA TIMUR, DKI JAKARTA",15,95,128,223
https://kawalpemilu.org#26068,"UTAN KAYU UTARA, MATRAMAN, JAKARTA TIMUR, DKI JAKARTA",16,102,110,212
https://kawalpemilu.org#26068,"UTAN KAYU UTARA, MATRAMAN, JAKARTA TIMUR, DKI JAKARTA",17,93,99,192
https://kawalpemilu.org#26068,"UTAN KAYU UTARA, MATRAMAN, JAKARTA TIMUR, DKI JAKARTA",18,87,128,215
https://kawalpemilu.org#26068,"UTAN KAYU UTARA, MATRAMAN, JAKARTA TIMUR, DKI JAKARTA",19,128,109,237
https://kawalpemilu.org#26068,"UTAN KAYU UTARA, MATRAMAN, JAKARTA TIMUR, DKI JAKARTA",20,122,114,236
https://kawalpemilu.org#26068,"UTAN KAYU UTARA, MATRAMAN, JAKARTA TIMUR, DKI JAKARTA",21,143,93,236
https://kawalpemilu.org#26068,"UTAN KAYU UTARA, MATRAMAN, JAKARTA TIMUR, DKI JAKARTA",22,111,116,227
https://kawalpemilu.org#26068,"UTAN KAYU UTARA, MATRAMAN, JAKARTA TIMUR, DKI JAKARTA",23,106,83,189
https://kawalpemilu.org#26068,"UTAN KAYU UTARA, MATRAMAN, JAKARTA TIMUR, DKI JAKARTA",24,125,106,231
https://kawalpemilu.org#26068,"UTAN KAYU UTARA, MATRAMAN, JAKARTA TIMUR, DKI JAKARTA",25,87,142,229
https://kawalpemilu.org#26068,"UTAN KAYU UTARA, MATRAMAN, JAKARTA TIMUR, DKI JAKARTA",26,94,112,206
https://kawalpemilu.org#26068,"UTAN KAYU UTARA, MATRAMAN, JAKARTA TIMUR, DKI JAKARTA",27,109,107,216
https://kawalpemilu.org#26068,"UTAN KAYU UTARA, MATRAMAN, JAKARTA TIMUR, DKI JAKARTA",28,126,126,252
https://kawalpemilu.org#26068,"UTAN KAYU UTARA, MATRAMAN, JAKARTA TIMUR, DKI JAKARTA",29,79,140,219
https://kawalpemilu.org#26068,"UTAN KAYU UTARA, MATRAMAN, JAKARTA TIMUR, DKI JAKARTA",30,104,99,203
https://kawalpemilu.org#26068,"UTAN KAYU UTARA, MATRAMAN, JAKARTA TIMUR, DKI JAKARTA",31,127,87,214
https://kawalpemilu.org#26068,"UTAN KAYU UTARA, MATRAMAN, JAKARTA TIMUR, DKI JAKARTA",32,96,127,223
https://kawalpemilu.org#26068,"UTAN KAYU UTARA, MATRAMAN, JAKARTA TIMUR, DKI JAKARTA",33,91,125,216
https://kawalpemilu.org#26068,"UTAN KAYU UTARA, MATRAMAN, JAKARTA TIMUR, DKI JAKARTA",34,104,94,198
https://kawalpemilu.org#26068,"UTAN KAYU UTARA, MATRAMAN, JAKARTA TIMUR, DKI JAKARTA",35,111,89,200
https://kawalpemilu.org#26068,"UTAN KAYU UTARA, MATRAMAN, JAKARTA TIMUR, DKI JAKARTA",36,89,118,207
https://kawalpemilu.org#26068,"UTAN KAYU UTARA, MATRAMAN, JAKARTA TIMUR, DKI JAKARTA",37,111,84,195
https://kawalpemilu.org#26068,"UTAN KAYU UTARA, MATRAMAN, JAKARTA TIMUR, DKI JAKARTA",39,88,146,234
https://kawalpemilu.org#26068,"UTAN KAYU UTARA, MATRAMAN, JAKARTA TIMUR, DKI JAKARTA",40,79,144,223
https://kawalpemilu.org#26068,"UTAN KAYU UTARA, MATRAMAN, JAKARTA TIMUR, DKI JAKARTA",41,88,149,237
https://kawalpemilu.org#26068,"UTAN KAYU UTARA, MATRAMAN, JAKARTA TIMUR, DKI JAKARTA",42,83,151,234
https://kawalpemilu.org#26068,"UTAN KAYU UTARA, MATRAMAN, JAKARTA TIMUR, DKI JAKARTA",43,62,191,253
https://kawalpemilu.org#26068,"UTAN KAYU UTARA, MATRAMAN, JAKARTA TIMUR, DKI JAKARTA",44,81,163,244
https://kawalpemilu.org#26068,"UTAN KAYU UTARA, MATRAMAN, JAKARTA TIMUR, DKI JAKARTA",45,78,122,200
https://kawalpemilu.org#26068,"UTAN KAYU UTARA, MATRAMAN, JAKARTA TIMUR, DKI JAKARTA",46,89,122,211
https://kawalpemilu.org#26068,"UTAN KAYU UTARA, MATRAMAN, JAKARTA TIMUR, DKI JAKARTA",47,115,116,231
https://kawalpemilu.org#26068,"UTAN KAYU UTARA, MATRAMAN, JAKARTA TIMUR, DKI JAKARTA",48,124,83,207
https://kawalpemilu.org#26068,"UTAN KAYU UTARA, MATRAMAN, JAKARTA TIMUR, DKI JAKARTA",49,101,115,216
https://kawalpemilu.org#26068,"UTAN KAYU UTARA, MATRAMAN, JAKARTA TIMUR, DKI JAKARTA",50,111,90,201
https://kawalpemilu.org#26068,"UTAN KAYU UTARA, MATRAMAN, JAKARTA TIMUR, DKI JAKARTA",51,142,96,238
https://kawalpemilu.org#26068,"UTAN KAYU UTARA, MATRAMAN, JAKARTA TIMUR, DKI JAKARTA",52,99,147,246
https://kawalpemilu.org#26068,"UTAN KAYU UTARA, MATRAMAN, JAKARTA TIMUR, DKI JAKARTA",53,106,110,216
https://kawalpemilu.org#26068,"UTAN KAYU UTARA, MATRAMAN, JAKARTA TIMUR, DKI JAKARTA",54,98,136,234
https://kawalpemilu.org#26068,"UTAN KAYU UTARA, MATRAMAN, JAKARTA TIMUR, DKI JAKARTA",55,139,120,259
https://kawalpemilu.org#26068,"UTAN KAYU UTARA, MATRAMAN, JAKARTA TIMUR, DKI JAKARTA",56,104,133,237
https://kawalpemilu.org#26068,"UTAN KAYU UTARA, MATRAMAN, JAKARTA TIMUR, DKI JAKARTA",57,108,125,233
https://kawalpemilu.org#26068,"UTAN KAYU UTARA, MATRAMAN, JAKARTA TIMUR, DKI JAKARTA",58,100,104,204
https://kawalpemilu.org#26068,"UTAN KAYU UTARA, MATRAMAN, JAKARTA TIMUR, DKI JAKARTA",59,100,138,238
https://kawalpemilu.org#26068,"UTAN KAYU UTARA, MATRAMAN, JAKARTA TIMUR, DKI JAKARTA",60,91,129,220
https://kawalpemilu.org#26068,"UTAN KAYU UTARA, MATRAMAN, JAKARTA TIMUR, DKI JAKARTA",61,138,87,225
https://kawalpemilu.org#26068,"UTAN KAYU UTARA, MATRAMAN, JAKARTA TIMUR, DKI JAKARTA",62,132,105,237
https://kawalpemilu.org#26068,"UTAN KAYU UTARA, MATRAMAN, JAKARTA TIMUR, DKI JAKARTA",63,113,117,230
https://kawalpemilu.org#26068,"UTAN KAYU UTARA, MATRAMAN, JAKARTA TIMUR, DKI JAKARTA",64,124,118,242
https://kawalpemilu.org#26068,"UTAN KAYU UTARA, MATRAMAN, JAKARTA TIMUR, DKI JAKARTA",65,77,154,231
https://kawalpemilu.org#26068,"UTAN KAYU UTARA, MATRAMAN, JAKARTA TIMUR, DKI JAKARTA",66,124,116,240
https://kawalpemilu.org#26068,"UTAN KAYU UTARA, MATRAMAN, JAKARTA TIMUR, DKI JAKARTA",67,94,119,213
https://kawalpemilu.org#26068,"UTAN KAYU UTARA, MATRAMAN, JAKARTA TIMUR, DKI JAKARTA",68,97,128,225
https://kawalpemilu.org#26068,"UTAN KAYU UTARA, MATRAMAN, JAKARTA TIMUR, DKI JAKARTA",69,127,107,234
https://kawalpemilu.org#26068,"UTAN KAYU UTARA, MATRAMAN, JAKARTA TIMUR, DKI JAKARTA",70,127,78,205
https://kawalpemilu.org#26068,"UTAN KAYU UTARA, MATRAMAN, JAKARTA TIMUR, DKI JAKARTA",71,105,149,254
https://kawalpemilu.org#26068,"UTAN KAYU UTARA, MATRAMAN, JAKARTA TIMUR, DKI JAKARTA",72,70,148,218
https://kawalpemilu.org#26068,"UTAN KAYU UTARA, MATRAMAN, JAKARTA TIMUR, DKI JAKARTA",73,126,77,203
https://kawalpemilu.org#26068,"UTAN KAYU UTARA, MATRAMAN, JAKARTA TIMUR, DKI JAKARTA",74,101,111,212
https://kawalpemilu.org#26068,"UTAN KAYU UTARA, MATRAMAN, JAKARTA TIMUR, DKI JAKARTA",75,93,142,235
https://kawalpemilu.org#26068,"UTAN KAYU UTARA, MATRAMAN, JAKARTA TIMUR, DKI JAKARTA",76,100,131,231
https://kawalpemilu.org#26068,"UTAN KAYU UTARA, MATRAMAN, JAKARTA TIMUR, DKI JAKARTA",77,112,93,205
https://kawalpemilu.org#26068,"UTAN KAYU UTARA, MATRAMAN, JAKARTA TIMUR, DKI JAKARTA",78,91,126,217
https://kawalpemilu.org#26068,"UTAN KAYU UTARA, MATRAMAN, JAKARTA TIMUR, DKI JAKARTA",79,104,138,242
https://kawalpemilu.org#26068,"UTAN KAYU UTARA, MATRAMAN, JAKARTA TIMUR, DKI JAKARTA",80,107,132,239
https://kawalpemilu.org#26068,"UTAN KAYU UTARA, MATRAMAN, JAKARTA TIMUR, DKI JAKARTA",81,122,133,255
https://kawalpemilu.org#26068,"UTAN KAYU UTARA, MATRAMAN, JAKARTA TIMUR, DKI JAKARTA",82,107,142,249
https://kawalpemilu.org#26068,"UTAN KAYU UTARA, MATRAMAN, JAKARTA TIMUR, DKI JAKARTA",83,123,144,267
https://kawalpemilu.org#26068,"UTAN KAYU UTARA, MATRAMAN, JAKARTA TIMUR, DKI JAKARTA",84,106,138,244
https://kawalpemilu.org#26068,"UTAN KAYU UTARA, MATRAMAN, JAKARTA TIMUR, DKI JAKARTA",85,129,128,257
https://kawalpemilu.org#26068,"UTAN KAYU UTARA, MATRAMAN, JAKARTA TIMUR, DKI JAKARTA",86,69,172,241
https://kawalpemilu.org#26068,"UTAN KAYU UTARA, MATRAMAN, JAKARTA TIMUR, DKI JAKARTA",87,71,145,216
https://kawalpemilu.org#26068,"UTAN KAYU UTARA, MATRAMAN, JAKARTA TIMUR, DKI JAKARTA",88,110,116,226
https://kawalpemilu.org#26068,"UTAN KAYU UTARA, MATRAMAN, JAKARTA TIMUR, DKI JAKARTA",89,104,152,256
https://kawalpemilu.org#26068,"UTAN KAYU UTARA, MATRAMAN, JAKARTA TIMUR, DKI JAKARTA",90,108,125,233
https://kawalpemilu.org#26068,"UTAN KAYU UTARA, MATRAMAN, JAKARTA TIMUR, DKI JAKARTA",91,68,107,175
https://kawalpemilu.org#26068,"UTAN KAYU UTARA, MATRAMAN, JAKARTA TIMUR, DKI JAKARTA",92,97,84,181
https://kawalpemilu.org#26069,"KAYU MANIS, MATRAMAN, JAKARTA TIMUR, DKI JAKARTA",1,106,122,228
https://kawalpemilu.org#26069,"KAYU MANIS, MATRAMAN, JAKARTA TIMUR, DKI JAKARTA",2,107,135,242
https://kawalpemilu.org#26069,"KAYU MANIS, MATRAMAN, JAKARTA TIMUR, DKI JAKARTA",3,134,104,238
https://kawalpemilu.org#26069,"KAYU MANIS, MATRAMAN, JAKARTA TIMUR, DKI JAKARTA",4,121,131,252
https://kawalpemilu.org#26069,"KAYU MANIS, MATRAMAN, JAKARTA TIMUR, DKI JAKARTA",5,62,165,227
https://kawalpemilu.org#26069,"KAYU MANIS, MATRAMAN, JAKARTA TIMUR, DKI JAKARTA",6,93,131,224
https://kawalpemilu.org#26069,"KAYU MANIS, MATRAMAN, JAKARTA TIMUR, DKI JAKARTA",7,85,143,228
https://kawalpemilu.org#26069,"KAYU MANIS, MATRAMAN, JAKARTA TIMUR, DKI JAKARTA",8,98,138,236
https://kawalpemilu.org#26069,"KAYU MANIS, MATRAMAN, JAKARTA TIMUR, DKI JAKARTA",9,115,129,244
https://kawalpemilu.org#26069,"KAYU MANIS, MATRAMAN, JAKARTA TIMUR, DKI JAKARTA",10,89,174,263
https://kawalpemilu.org#26069,"KAYU MANIS, MATRAMAN, JAKARTA TIMUR, DKI JAKARTA",11,92,144,236
https://kawalpemilu.org#26069,"KAYU MANIS, MATRAMAN, JAKARTA TIMUR, DKI JAKARTA",12,109,150,259
https://kawalpemilu.org#26069,"KAYU MANIS, MATRAMAN, JAKARTA TIMUR, DKI JAKARTA",14,63,188,251
https://kawalpemilu.org#26069,"KAYU MANIS, MATRAMAN, JAKARTA TIMUR, DKI JAKARTA",15,88,154,242
https://kawalpemilu.org#26069,"KAYU MANIS, MATRAMAN, JAKARTA TIMUR, DKI JAKARTA",16,102,125,227
https://kawalpemilu.org#26069,"KAYU MANIS, MATRAMAN, JAKARTA TIMUR, DKI JAKARTA",17,113,109,222
https://kawalpemilu.org#26069,"KAYU MANIS, MATRAMAN, JAKARTA TIMUR, DKI JAKARTA",18,81,130,211
https://kawalpemilu.org#26069,"KAYU MANIS, MATRAMAN, JAKARTA TIMUR, DKI JAKARTA",19,67,154,221
https://kawalpemilu.org#26069,"KAYU MANIS, MATRAMAN, JAKARTA TIMUR, DKI JAKARTA",20,123,98,221
https://kawalpemilu.org#26069,"KAYU MANIS, MATRAMAN, JAKARTA TIMUR, DKI JAKARTA",21,102,154,256
https://kawalpemilu.org#26069,"KAYU MANIS, MATRAMAN, JAKARTA TIMUR, DKI JAKARTA",22,68,131,199
https://kawalpemilu.org#26069,"KAYU MANIS, MATRAMAN, JAKARTA TIMUR, DKI JAKARTA",23,88,123,211
https://kawalpemilu.org#26069,"KAYU MANIS, MATRAMAN, JAKARTA TIMUR, DKI JAKARTA",24,95,101,196
https://kawalpemilu.org#26069,"KAYU MANIS, MATRAMAN, JAKARTA TIMUR, DKI JAKARTA",25,107,107,214
https://kawalpemilu.org#26069,"KAYU MANIS, MATRAMAN, JAKARTA TIMUR, DKI JAKARTA",26,134,93,227
https://kawalpemilu.org#26069,"KAYU MANIS, MATRAMAN, JAKARTA TIMUR, DKI JAKARTA",27,102,136,238
https://kawalpemilu.org#26069,"KAYU MANIS, MATRAMAN, JAKARTA TIMUR, DKI JAKARTA",29,107,107,214
https://kawalpemilu.org#26069,"KAYU MANIS, MATRAMAN, JAKARTA TIMUR, DKI JAKARTA",30,110,126,236
https://kawalpemilu.org#26069,"KAYU MANIS, MATRAMAN, JAKARTA TIMUR, DKI JAKARTA",31,140,102,242
https://kawalpemilu.org#26069,"KAYU MANIS, MATRAMAN, JAKARTA TIMUR, DKI JAKARTA",32,93,160,253
https://kawalpemilu.org#26069,"KAYU MANIS, MATRAMAN, JAKARTA TIMUR, DKI JAKARTA",33,98,123,221
https://kawalpemilu.org#26069,"KAYU MANIS, MATRAMAN, JAKARTA TIMUR, DKI JAKARTA",34,100,129,229
https://kawalpemilu.org#26069,"KAYU MANIS, MATRAMAN, JAKARTA TIMUR, DKI JAKARTA",35,132,103,235
https://kawalpemilu.org#26069,"KAYU MANIS, MATRAMAN, JAKARTA TIMUR, DKI JAKARTA",36,146,96,242
https://kawalpemilu.org#26069,"KAYU MANIS, MATRAMAN, JAKARTA TIMUR, DKI JAKARTA",37,107,131,238
https://kawalpemilu.org#26069,"KAYU MANIS, MATRAMAN, JAKARTA TIMUR, DKI JAKARTA",38,117,126,243
https://kawalpemilu.org#26069,"KAYU MANIS, MATRAMAN, JAKARTA TIMUR, DKI JAKARTA",41,118,123,241
https://kawalpemilu.org#26069,"KAYU MANIS, MATRAMAN, JAKARTA TIMUR, DKI JAKARTA",42,81,153,234
https://kawalpemilu.org#26069,"KAYU MANIS, MATRAMAN, JAKARTA TIMUR, DKI JAKARTA",43,78,157,235
https://kawalpemilu.org#26069,"KAYU MANIS, MATRAMAN, JAKARTA TIMUR, DKI JAKARTA",44,139,104,243
https://kawalpemilu.org#26069,"KAYU MANIS, MATRAMAN, JAKARTA TIMUR, DKI JAKARTA",45,100,135,235
https://kawalpemilu.org#26069,"KAYU MANIS, MATRAMAN, JAKARTA TIMUR, DKI JAKARTA",46,90,133,223
https://kawalpemilu.org#26069,"KAYU MANIS, MATRAMAN, JAKARTA TIMUR, DKI JAKARTA",48,72,142,214
https://kawalpemilu.org#26069,"KAYU MANIS, MATRAMAN, JAKARTA TIMUR, DKI JAKARTA",49,95,101,196
https://kawalpemilu.org#26069,"KAYU MANIS, MATRAMAN, JAKARTA TIMUR, DKI JAKARTA",50,104,105,209
https://kawalpemilu.org#26069,"KAYU MANIS, MATRAMAN, JAKARTA TIMUR, DKI JAKARTA",51,134,102,236
https://kawalpemilu.org#26069,"KAYU MANIS, MATRAMAN, JAKARTA TIMUR, DKI JAKARTA",52,106,107,213
https://kawalpemilu.org#26069,"KAYU MANIS, MATRAMAN, JAKARTA TIMUR, DKI JAKARTA",53,130,112,242
https://kawalpemilu.org#26069,"KAYU MANIS, MATRAMAN, JAKARTA TIMUR, DKI JAKARTA",54,129,75,204
https://kawalpemilu.org#26069,"KAYU MANIS, MATRAMAN, JAKARTA TIMUR, DKI JAKARTA",55,127,105,232
https://kawalpemilu.org#26069,"KAYU MANIS, MATRAMAN, JAKARTA TIMUR, DKI JAKARTA",56,96,130,226
https://kawalpemilu.org#26069,"KAYU MANIS, MATRAMAN, JAKARTA TIMUR, DKI JAKARTA",57,105,132,237
https://kawalpemilu.org#26069,"KAYU MANIS, MATRAMAN, JAKARTA TIMUR, DKI JAKARTA",58,95,134,229
https://kawalpemilu.org#26069,"KAYU MANIS, MATRAMAN, JAKARTA TIMUR, DKI JAKARTA",59,86,142,228
https://kawalpemilu.org#26069,"KAYU MANIS, MATRAMAN, JAKARTA TIMUR, DKI JAKARTA",60,115,117,232
https://kawalpemilu.org#26069,"KAYU MANIS, MATRAMAN, JAKARTA TIMUR, DKI JAKARTA",61,130,78,208
https://kawalpemilu.org#26069,"KAYU MANIS, MATRAMAN, JAKARTA TIMUR, DKI JAKARTA",62,131,88,219
https://kawalpemilu.org#26069,"KAYU MANIS, MATRAMAN, JAKARTA TIMUR, DKI JAKARTA",63,137,109,246
https://kawalpemilu.org#26069,"KAYU MANIS, MATRAMAN, JAKARTA TIMUR, DKI JAKARTA",64,114,123,237
https://kawalpemilu.org#26069,"KAYU MANIS, MATRAMAN, JAKARTA TIMUR, DKI JAKARTA",65,95,152,247
https://kawalpemilu.org#26069,"KAYU MANIS, MATRAMAN, JAKARTA TIMUR, DKI JAKARTA",66,91,148,239
https://kawalpemilu.org#26069,"KAYU MANIS, MATRAMAN, JAKARTA TIMUR, DKI JAKARTA",67,78,153,231
https://kawalpemilu.org#26069,"KAYU MANIS, MATRAMAN, JAKARTA TIMUR, DKI JAKARTA",68,96,146,242
https://kawalpemilu.org#26069,"KAYU MANIS, MATRAMAN, JAKARTA TIMUR, DKI JAKARTA",69,85,168,253
https://kawalpemilu.org#26069,"KAYU MANIS, MATRAMAN, JAKARTA TIMUR, DKI JAKARTA",70,103,149,252
https://kawalpemilu.org#26069,"KAYU MANIS, MATRAMAN, JAKARTA TIMUR, DKI JAKARTA",71,110,111,221
https://kawalpemilu.org#26069,"KAYU MANIS, MATRAMAN, JAKARTA TIMUR, DKI JAKARTA",72,117,104,221
https://kawalpemilu.org#26069,"KAYU MANIS, MATRAMAN, JAKARTA TIMUR, DKI JAKARTA",73,104,128,232
https://kawalpemilu.org#26069,"KAYU MANIS, MATRAMAN, JAKARTA TIMUR, DKI JAKARTA",74,82,156,238
https://kawalpemilu.org#26069,"KAYU MANIS, MATRAMAN, JAKARTA TIMUR, DKI JAKARTA",75,91,148,239
https://kawalpemilu.org#26069,"KAYU MANIS, MATRAMAN, JAKARTA TIMUR, DKI JAKARTA",76,120,117,237
https://kawalpemilu.org#26069,"KAYU MANIS, MATRAMAN, JAKARTA TIMUR, DKI JAKARTA",77,119,130,249
https://kawalpemilu.org#26069,"KAYU MANIS, MATRAMAN, JAKARTA TIMUR, DKI JAKARTA",78,105,124,229
https://kawalpemilu.org#26069,"KAYU MANIS, MATRAMAN, JAKARTA TIMUR, DKI JAKARTA",79,83,161,244
https://kawalpemilu.org#26069,"KAYU MANIS, MATRAMAN, JAKARTA TIMUR, DKI JAKARTA",80,78,106,184
https://kawalpemilu.org#26069,"KAYU MANIS, MATRAMAN, JAKARTA TIMUR, DKI JAKARTA",81,51,107,158
https://kawalpemilu.org#26070,"PALMERIAM, MATRAMAN, JAKARTA TIMUR, DKI JAKARTA",1,148,79,227
https://kawalpemilu.org#26070,"PALMERIAM, MATRAMAN, JAKARTA TIMUR, DKI JAKARTA",2,71,153,224
https://kawalpemilu.org#26070,"PALMERIAM, MATRAMAN, JAKARTA TIMUR, DKI JAKARTA",3,97,140,237
https://kawalpemilu.org#26070,"PALMERIAM, MATRAMAN, JAKARTA TIMUR, DKI JAKARTA",4,107,126,233
https://kawalpemilu.org#26070,"PALMERIAM, MATRAMAN, JAKARTA TIMUR, DKI JAKARTA",5,109,123,232
https://kawalpemilu.org#26070,"PALMERIAM, MATRAMAN, JAKARTA TIMUR, DKI JAKARTA",6,123,99,222
https://kawalpemilu.org#26070,"PALMERIAM, MATRAMAN, JAKARTA TIMUR, DKI JAKARTA",7,88,153,241
https://kawalpemilu.org#26070,"PALMERIAM, MATRAMAN, JAKARTA TIMUR, DKI JAKARTA",8,82,158,240
https://kawalpemilu.org#26070,"PALMERIAM, MATRAMAN, JAKARTA TIMUR, DKI JAKARTA",9,98,135,233
https://kawalpemilu.org#26070,"PALMERIAM, MATRAMAN, JAKARTA TIMUR, DKI JAKARTA",10,106,110,216
https://kawalpemilu.org#26070,"PALMERIAM, MATRAMAN, JAKARTA TIMUR, DKI JAKARTA",11,138,88,226
https://kawalpemilu.org#26070,"PALMERIAM, MATRAMAN, JAKARTA TIMUR, DKI JAKARTA",12,126,101,227
https://kawalpemilu.org#26070,"PALMERIAM, MATRAMAN, JAKARTA TIMUR, DKI JAKARTA",13,138,112,250
https://kawalpemilu.org#26070,"PALMERIAM, MATRAMAN, JAKARTA TIMUR, DKI JAKARTA",14,118,134,252
https://kawalpemilu.org#26070,"PALMERIAM, MATRAMAN, JAKARTA TIMUR, DKI JAKARTA",15,117,122,239
https://kawalpemilu.org#26070,"PALMERIAM, MATRAMAN, JAKARTA TIMUR, DKI JAKARTA",16,146,91,237
https://kawalpemilu.org#26070,"PALMERIAM, MATRAMAN, JAKARTA TIMUR, DKI JAKARTA",17,129,100,229
https://kawalpemilu.org#26070,"PALMERIAM, MATRAMAN, JAKARTA TIMUR, DKI JAKARTA",18,128,93,221
https://kawalpemilu.org#26070,"PALMERIAM, MATRAMAN, JAKARTA TIMUR, DKI JAKARTA",19,134,54,188
https://kawalpemilu.org#26070,"PALMERIAM, MATRAMAN, JAKARTA TIMUR, DKI JAKARTA",20,118,103,221
https://kawalpemilu.org#26070,"PALMERIAM, MATRAMAN, JAKARTA TIMUR, DKI JAKARTA",21,105,144,249
https://kawalpemilu.org#26070,"PALMERIAM, MATRAMAN, JAKARTA TIMUR, DKI JAKARTA",22,130,99,229
https://kawalpemilu.org#26070,"PALMERIAM, MATRAMAN, JAKARTA TIMUR, DKI JAKARTA",23,131,102,233
https://kawalpemilu.org#26070,"PALMERIAM, MATRAMAN, JAKARTA TIMUR, DKI JAKARTA",24,82,134,216
https://kawalpemilu.org#26070,"PALMERIAM, MATRAMAN, JAKARTA TIMUR, DKI JAKARTA",25,91,134,225
https://kawalpemilu.org#26070,"PALMERIAM, MATRAMAN, JAKARTA TIMUR, DKI JAKARTA",26,98,113,211
https://kawalpemilu.org#26070,"PALMERIAM, MATRAMAN, JAKARTA TIMUR, DKI JAKARTA",27,98,157,255
https://kawalpemilu.org#26070,"PALMERIAM, MATRAMAN, JAKARTA TIMUR, DKI JAKARTA",28,126,118,244
https://kawalpemilu.org#26070,"PALMERIAM, MATRAMAN, JAKARTA TIMUR, DKI JAKARTA",29,131,114,245
https://kawalpemilu.org#26070,"PALMERIAM, MATRAMAN, JAKARTA TIMUR, DKI JAKARTA",30,133,105,238
https://kawalpemilu.org#26070,"PALMERIAM, MATRAMAN, JAKARTA TIMUR, DKI JAKARTA",31,102,120,222
https://kawalpemilu.org#26070,"PALMERIAM, MATRAMAN, JAKARTA TIMUR, DKI JAKARTA",32,91,129,220
https://kawalpemilu.org#26070,"PALMERIAM, MATRAMAN, JAKARTA TIMUR, DKI JAKARTA",33,90,96,186
https://kawalpemilu.org#26070,"PALMERIAM, MATRAMAN, JAKARTA TIMUR, DKI JAKARTA",34,110,107,217
https://kawalpemilu.org#26070,"PALMERIAM, MATRAMAN, JAKARTA TIMUR, DKI JAKARTA",35,109,135,244
https://kawalpemilu.org#26070,"PALMERIAM, MATRAMAN, JAKARTA TIMUR, DKI JAKARTA",36,76,164,240
https://kawalpemilu.org#26070,"PALMERIAM, MATRAMAN, JAKARTA TIMUR, DKI JAKARTA",37,91,149,240
https://kawalpemilu.org#26070,"PALMERIAM, MATRAMAN, JAKARTA TIMUR, DKI JAKARTA",38,95,140,235
https://kawalpemilu.org#26070,"PALMERIAM, MATRAMAN, JAKARTA TIMUR, DKI JAKARTA",39,117,119,236
https://kawalpemilu.org#26070,"PALMERIAM, MATRAMAN, JAKARTA TIMUR, DKI JAKARTA",40,117,104,221
https://kawalpemilu.org#26070,"PALMERIAM, MATRAMAN, JAKARTA TIMUR, DKI JAKARTA",41,142,95,237
https://kawalpemilu.org#26070,"PALMERIAM, MATRAMAN, JAKARTA TIMUR, DKI JAKARTA",42,114,101,215
https://kawalpemilu.org#26070,"PALMERIAM, MATRAMAN, JAKARTA TIMUR, DKI JAKARTA",43,108,136,244
https://kawalpemilu.org#26070,"PALMERIAM, MATRAMAN, JAKARTA TIMUR, DKI JAKARTA",44,154,71,225
https://kawalpemilu.org#26070,"PALMERIAM, MATRAMAN, JAKARTA TIMUR, DKI JAKARTA",45,118,131,249
https://kawalpemilu.org#26070,"PALMERIAM, MATRAMAN, JAKARTA TIMUR, DKI JAKARTA",46,138,94,232
https://kawalpemilu.org#26070,"PALMERIAM, MATRAMAN, JAKARTA TIMUR, DKI JAKARTA",47,127,92,219
https://kawalpemilu.org#26070,"PALMERIAM, MATRAMAN, JAKARTA TIMUR, DKI JAKARTA",48,114,84,198
https://kawalpemilu.org#26070,"PALMERIAM, MATRAMAN, JAKARTA TIMUR, DKI JAKARTA",49,96,116,212
https://kawalpemilu.org#26070,"PALMERIAM, MATRAMAN, JAKARTA TIMUR, DKI JAKARTA",50,102,106,208
https://kawalpemilu.org#26070,"PALMERIAM, MATRAMAN, JAKARTA TIMUR, DKI JAKARTA",51,141,58,199
https://kawalpemilu.org#26070,"PALMERIAM, MATRAMAN, JAKARTA TIMUR, DKI JAKARTA",52,101,109,210
https://kawalpemilu.org#26070,"PALMERIAM, MATRAMAN, JAKARTA TIMUR, DKI JAKARTA",53,95,119,214
https://kawalpemilu.org#26070,"PALMERIAM, MATRAMAN, JAKARTA TIMUR, DKI JAKARTA",54,127,133,260
https://kawalpemilu.org#26070,"PALMERIAM, MATRAMAN, JAKARTA TIMUR, DKI JAKARTA",55,104,112,216
https://kawalpemilu.org#26070,"PALMERIAM, MATRAMAN, JAKARTA TIMUR, DKI JAKARTA",56,142,113,255
https://kawalpemilu.org#26070,"PALMERIAM, MATRAMAN, JAKARTA TIMUR, DKI JAKARTA",57,81,140,221
https://kawalpemilu.org#26070,"PALMERIAM, MATRAMAN, JAKARTA TIMUR, DKI JAKARTA",58,97,149,246
https://kawalpemilu.org#26070,"PALMERIAM, MATRAMAN, JAKARTA TIMUR, DKI JAKARTA",59,112,151,263
https://kawalpemilu.org#26070,"PALMERIAM, MATRAMAN, JAKARTA TIMUR, DKI JAKARTA",60,107,110,217
https://kawalpemilu.org#26070,"PALMERIAM, MATRAMAN, JAKARTA TIMUR, DKI JAKARTA",61,85,116,201
https://kawalpemilu.org#26070,"PALMERIAM, MATRAMAN, JAKARTA TIMUR, DKI JAKARTA",62,97,118,215
https://kawalpemilu.org#26070,"PALMERIAM, MATRAMAN, JAKARTA TIMUR, DKI JAKARTA",63,112,54,166
https://kawalpemilu.org#26070,"PALMERIAM, MATRAMAN, JAKARTA TIMUR, DKI JAKARTA",64,68,75,143
https://kawalpemilu.org#26071,"KEBON MANGGIS, MATRAMAN, JAKARTA TIMUR, DKI JAKARTA",1,87,114,201
https://kawalpemilu.org#26071,"KEBON MANGGIS, MATRAMAN, JAKARTA TIMUR, DKI JAKARTA",2,73,111,184
https://kawalpemilu.org#26071,"KEBON MANGGIS, MATRAMAN, JAKARTA TIMUR, DKI JAKARTA",3,61,172,233
https://kawalpemilu.org#26071,"KEBON MANGGIS, MATRAMAN, JAKARTA TIMUR, DKI JAKARTA",4,92,125,217
https://kawalpemilu.org#26071,"KEBON MANGGIS, MATRAMAN, JAKARTA TIMUR, DKI JAKARTA",5,103,86,189
https://kawalpemilu.org#26071,"KEBON MANGGIS, MATRAMAN, JAKARTA TIMUR, DKI JAKARTA",6,88,147,235
https://kawalpemilu.org#26071,"KEBON MANGGIS, MATRAMAN, JAKARTA TIMUR, DKI JAKARTA",7,109,120,229
https://kawalpemilu.org#26071,"KEBON MANGGIS, MATRAMAN, JAKARTA TIMUR, DKI JAKARTA",8,77,142,219
https://kawalpemilu.org#26071,"KEBON MANGGIS, MATRAMAN, JAKARTA TIMUR, DKI JAKARTA",9,67,145,212
https://kawalpemilu.org#26071,"KEBON MANGGIS, MATRAMAN, JAKARTA TIMUR, DKI JAKARTA",10,59,163,222
https://kawalpemilu.org#26071,"KEBON MANGGIS, MATRAMAN, JAKARTA TIMUR, DKI JAKARTA",11,52,173,225
https://kawalpemilu.org#26071,"KEBON MANGGIS, MATRAMAN, JAKARTA TIMUR, DKI JAKARTA",12,39,160,199
https://kawalpemilu.org#26071,"KEBON MANGGIS, MATRAMAN, JAKARTA TIMUR, DKI JAKARTA",14,54,147,201
https://kawalpemilu.org#26071,"KEBON MANGGIS, MATRAMAN, JAKARTA TIMUR, DKI JAKARTA",15,63,150,213
https://kawalpemilu.org#26071,"KEBON MANGGIS, MATRAMAN, JAKARTA TIMUR, DKI JAKARTA",16,96,81,177
https://kawalpemilu.org#26071,"KEBON MANGGIS, MATRAMAN, JAKARTA TIMUR, DKI JAKARTA",17,109,101,210
https://kawalpemilu.org#26071,"KEBON MANGGIS, MATRAMAN, JAKARTA TIMUR, DKI JAKARTA",18,120,66,186
https://kawalpemilu.org#26071,"KEBON MANGGIS, MATRAMAN, JAKARTA TIMUR, DKI JAKARTA",19,76,161,237
https://kawalpemilu.org#26071,"KEBON MANGGIS, MATRAMAN, JAKARTA TIMUR, DKI JAKARTA",20,95,129,224
https://kawalpemilu.org#26071,"KEBON MANGGIS, MATRAMAN, JAKARTA TIMUR, DKI JAKARTA",21,80,164,244
https://kawalpemilu.org#26071,"KEBON MANGGIS, MATRAMAN, JAKARTA TIMUR, DKI JAKARTA",22,83,130,213
https://kawalpemilu.org#26071,"KEBON MANGGIS, MATRAMAN, JAKARTA TIMUR, DKI JAKARTA",23,68,145,213
https://kawalpemilu.org#26071,"KEBON MANGGIS, MATRAMAN, JAKARTA TIMUR, DKI JAKARTA",24,82,140,222
https://kawalpemilu.org#26071,"KEBON MANGGIS, MATRAMAN, JAKARTA TIMUR, DKI JAKARTA",25,119,114,233
https://kawalpemilu.org#26071,"KEBON MANGGIS, MATRAMAN, JAKARTA TIMUR, DKI JAKARTA",26,111,110,221
https://kawalpemilu.org#26071,"KEBON MANGGIS, MATRAMAN, JAKARTA TIMUR, DKI JAKARTA",27,123,117,240
https://kawalpemilu.org#26071,"KEBON MANGGIS, MATRAMAN, JAKARTA TIMUR, DKI JAKARTA",28,66,167,233
https://kawalpemilu.org#26071,"KEBON MANGGIS, MATRAMAN, JAKARTA TIMUR, DKI JAKARTA",29,85,168,253
https://kawalpemilu.org#26071,"KEBON MANGGIS, MATRAMAN, JAKARTA TIMUR, DKI JAKARTA",30,66,187,253
https://kawalpemilu.org#26071,"KEBON MANGGIS, MATRAMAN, JAKARTA TIMUR, DKI JAKARTA",31,71,124,195
https://kawalpemilu.org#26071,"KEBON MANGGIS, MATRAMAN, JAKARTA TIMUR, DKI JAKARTA",32,63,171,234
https://kawalpemilu.org#26071,"KEBON MANGGIS, MATRAMAN, JAKARTA TIMUR, DKI JAKARTA",33,92,148,240
https://kawalpemilu.org#26071,"KEBON MANGGIS, MATRAMAN, JAKARTA TIMUR, DKI JAKARTA",35,91,160,251
https://kawalpemilu.org#26071,"KEBON MANGGIS, MATRAMAN, JAKARTA TIMUR, DKI JAKARTA",36,90,137,227
https://kawalpemilu.org#26071,"KEBON MANGGIS, MATRAMAN, JAKARTA TIMUR, DKI JAKARTA",37,115,136,251
https://kawalpemilu.org#26071,"KEBON MANGGIS, MATRAMAN, JAKARTA TIMUR, DKI JAKARTA",38,108,119,227
https://kawalpemilu.org#26071,"KEBON MANGGIS, MATRAMAN, JAKARTA TIMUR, DKI JAKARTA",39,80,185,265
https://kawalpemilu.org#26071,"KEBON MANGGIS, MATRAMAN, JAKARTA TIMUR, DKI JAKARTA",40,98,152,250
https://kawalpemilu.org#26071,"KEBON MANGGIS, MATRAMAN, JAKARTA TIMUR, DKI JAKARTA",41,102,85,187
https://kawalpemilu.org#26071,"KEBON MANGGIS, MATRAMAN, JAKARTA TIMUR, DKI JAKARTA",42,83,166,249
https://kawalpemilu.org#26071,"KEBON MANGGIS, MATRAMAN, JAKARTA TIMUR, DKI JAKARTA",43,107,137,244
https://kawalpemilu.org#26071,"KEBON MANGGIS, MATRAMAN, JAKARTA TIMUR, DKI JAKARTA",44,86,101,187
https://kawalpemilu.org#26071,"KEBON MANGGIS, MATRAMAN, JAKARTA TIMUR, DKI JAKARTA",45,89,92,181
https://kawalpemilu.org#26071,"KEBON MANGGIS, MATRAMAN, JAKARTA TIMUR, DKI JAKARTA",46,114,130,244
https://kawalpemilu.org#26071,"KEBON MANGGIS, MATRAMAN, JAKARTA TIMUR, DKI JAKARTA",47,117,115,232
https://kawalpemilu.org#26071,"KEBON MANGGIS, MATRAMAN, JAKARTA TIMUR, DKI JAKARTA",48,117,130,247
https://kawalpemilu.org#26071,"KEBON MANGGIS, MATRAMAN, JAKARTA TIMUR, DKI JAKARTA",49,86,139,225
https://kawalpemilu.org#26071,"KEBON MANGGIS, MATRAMAN, JAKARTA TIMUR, DKI JAKARTA",50,71,152,223
https://kawalpemilu.org#26071,"KEBON MANGGIS, MATRAMAN, JAKARTA TIMUR, DKI JAKARTA",51,70,148,218
https://kawalpemilu.org#26071,"KEBON MANGGIS, MATRAMAN, JAKARTA TIMUR, DKI JAKARTA",52,63,164,227
https://kawalpemilu.org#26071,"KEBON MANGGIS, MATRAMAN, JAKARTA TIMUR, DKI JAKARTA",53,47,85,132
https://kawalpemilu.org#26072,"UTAN KAYU SELATAN, MATRAMAN, JAKARTA TIMUR, DKI JAKARTA",1,120,126,246
https://kawalpemilu.org#26072,"UTAN KAYU SELATAN, MATRAMAN, JAKARTA TIMUR, DKI JAKARTA",2,122,124,246
https://kawalpemilu.org#26072,"UTAN KAYU SELATAN, MATRAMAN, JAKARTA TIMUR, DKI JAKARTA",3,97,154,251
https://kawalpemilu.org#26072,"UTAN KAYU SELATAN, MATRAMAN, JAKARTA TIMUR, DKI JAKARTA",4,133,108,241
https://kawalpemilu.org#26072,"UTAN KAYU SELATAN, MATRAMAN, JAKARTA TIMUR, DKI JAKARTA",5,135,118,253
https://kawalpemilu.org#26072,"UTAN KAYU SELATAN, MATRAMAN, JAKARTA TIMUR, DKI JAKARTA",6,143,138,281
https://kawalpemilu.org#26072,"UTAN KAYU SELATAN, MATRAMAN, JAKARTA TIMUR, DKI JAKARTA",7,126,131,257
https://kawalpemilu.org#26072,"UTAN KAYU SELATAN, MATRAMAN, JAKARTA TIMUR, DKI JAKARTA",8,122,136,258
https://kawalpemilu.org#26072,"UTAN KAYU SELATAN, MATRAMAN, JAKARTA TIMUR, DKI JAKARTA",9,133,118,251
https://kawalpemilu.org#26072,"UTAN KAYU SELATAN, MATRAMAN, JAKARTA TIMUR, DKI JAKARTA",10,151,99,250
https://kawalpemilu.org#26072,"UTAN KAYU SELATAN, MATRAMAN, JAKARTA TIMUR, DKI JAKARTA",11,145,93,238
https://kawalpemilu.org#26072,"UTAN KAYU SELATAN, MATRAMAN, JAKARTA TIMUR, DKI JAKARTA",12,93,152,245
https://kawalpemilu.org#26072,"UTAN KAYU SELATAN, MATRAMAN, JAKARTA TIMUR, DKI JAKARTA",13,148,90,238
https://kawalpemilu.org#26072,"UTAN KAYU SELATAN, MATRAMAN, JAKARTA TIMUR, DKI JAKARTA",14,119,123,242
https://kawalpemilu.org#26072,"UTAN KAYU SELATAN, MATRAMAN, JAKARTA TIMUR, DKI JAKARTA",15,78,127,205
https://kawalpemilu.org#26072,"UTAN KAYU SELATAN, MATRAMAN, JAKARTA TIMUR, DKI JAKARTA",16,108,127,235
https://kawalpemilu.org#26072,"UTAN KAYU SELATAN, MATRAMAN, JAKARTA TIMUR, DKI JAKARTA",18,107,147,254
https://kawalpemilu.org#26072,"UTAN KAYU SELATAN, MATRAMAN, JAKARTA TIMUR, DKI JAKARTA",19,105,98,203
https://kawalpemilu.org#26072,"UTAN KAYU SELATAN, MATRAMAN, JAKARTA TIMUR, DKI JAKARTA",21,115,122,237
https://kawalpemilu.org#26072,"UTAN KAYU SELATAN, MATRAMAN, JAKARTA TIMUR, DKI JAKARTA",22,117,76,193
https://kawalpemilu.org#26072,"UTAN KAYU SELATAN, MATRAMAN, JAKARTA TIMUR, DKI JAKARTA",23,135,99,234
https://kawalpemilu.org#26072,"UTAN KAYU SELATAN, MATRAMAN, JAKARTA TIMUR, DKI JAKARTA",24,104,128,232
https://kawalpemilu.org#26072,"UTAN KAYU SELATAN, MATRAMAN, JAKARTA TIMUR, DKI JAKARTA",25,128,122,250
https://kawalpemilu.org#26072,"UTAN KAYU SELATAN, MATRAMAN, JAKARTA TIMUR, DKI JAKARTA",26,120,135,255
https://kawalpemilu.org#26072,"UTAN KAYU SELATAN, MATRAMAN, JAKARTA TIMUR, DKI JAKARTA",27,120,136,256
https://kawalpemilu.org#26072,"UTAN KAYU SELATAN, MATRAMAN, JAKARTA TIMUR, DKI JAKARTA",28,99,95,194
https://kawalpemilu.org#26072,"UTAN KAYU SELATAN, MATRAMAN, JAKARTA TIMUR, DKI JAKARTA",29,133,110,243
https://kawalpemilu.org#26072,"UTAN KAYU SELATAN, MATRAMAN, JAKARTA TIMUR, DKI JAKARTA",30,95,152,247
https://kawalpemilu.org#26072,"UTAN KAYU SELATAN, MATRAMAN, JAKARTA TIMUR, DKI JAKARTA",32,124,107,231
https://kawalpemilu.org#26072,"UTAN KAYU SELATAN, MATRAMAN, JAKARTA TIMUR, DKI JAKARTA",33,104,129,233
https://kawalpemilu.org#26072,"UTAN KAYU SELATAN, MATRAMAN, JAKARTA TIMUR, DKI JAKARTA",34,125,89,214
https://kawalpemilu.org#26072,"UTAN KAYU SELATAN, MATRAMAN, JAKARTA TIMUR, DKI JAKARTA",35,113,91,204
https://kawalpemilu.org#26072,"UTAN KAYU SELATAN, MATRAMAN, JAKARTA TIMUR, DKI JAKARTA",36,108,109,217
https://kawalpemilu.org#26072,"UTAN KAYU SELATAN, MATRAMAN, JAKARTA TIMUR, DKI JAKARTA",37,118,135,253
https://kawalpemilu.org#26072,"UTAN KAYU SELATAN, MATRAMAN, JAKARTA TIMUR, DKI JAKARTA",38,110,117,227
https://kawalpemilu.org#26072,"UTAN KAYU SELATAN, MATRAMAN, JAKARTA TIMUR, DKI JAKARTA",39,95,164,259
https://kawalpemilu.org#26072,"UTAN KAYU SELATAN, MATRAMAN, JAKARTA TIMUR, DKI JAKARTA",40,77,152,229
https://kawalpemilu.org#26072,"UTAN KAYU SELATAN, MATRAMAN, JAKARTA TIMUR, DKI JAKARTA",41,129,94,223
https://kawalpemilu.org#26072,"UTAN KAYU SELATAN, MATRAMAN, JAKARTA TIMUR, DKI JAKARTA",42,99,154,253
https://kawalpemilu.org#26072,"UTAN KAYU SELATAN, MATRAMAN, JAKARTA TIMUR, DKI JAKARTA",43,116,129,245
https://kawalpemilu.org#26072,"UTAN KAYU SELATAN, MATRAMAN, JAKARTA TIMUR, DKI JAKARTA",44,117,121,238
https://kawalpemilu.org#26072,"UTAN KAYU SELATAN, MATRAMAN, JAKARTA TIMUR, DKI JAKARTA",45,146,98,244
https://kawalpemilu.org#26072,"UTAN KAYU SELATAN, MATRAMAN, JAKARTA TIMUR, DKI JAKARTA",46,149,125,274
https://kawalpemilu.org#26072,"UTAN KAYU SELATAN, MATRAMAN, JAKARTA TIMUR, DKI JAKARTA",47,113,108,221
https://kawalpemilu.org#26072,"UTAN KAYU SELATAN, MATRAMAN, JAKARTA TIMUR, DKI JAKARTA",48,90,93,183
https://kawalpemilu.org#26072,"UTAN KAYU SELATAN, MATRAMAN, JAKARTA TIMUR, DKI JAKARTA",49,101,115,216
https://kawalpemilu.org#26072,"UTAN KAYU SELATAN, MATRAMAN, JAKARTA TIMUR, DKI JAKARTA",50,124,120,244
https://kawalpemilu.org#26072,"UTAN KAYU SELATAN, MATRAMAN, JAKARTA TIMUR, DKI JAKARTA",51,108,138,246
https://kawalpemilu.org#26072,"UTAN KAYU SELATAN, MATRAMAN, JAKARTA TIMUR, DKI JAKARTA",53,101,148,249
https://kawalpemilu.org#26072,"UTAN KAYU SELATAN, MATRAMAN, JAKARTA TIMUR, DKI JAKARTA",54,52,105,157
https://kawalpemilu.org#26072,"UTAN KAYU SELATAN, MATRAMAN, JAKARTA TIMUR, DKI JAKARTA",55,82,98,180
https://kawalpemilu.org#26072,"UTAN KAYU SELATAN, MATRAMAN, JAKARTA TIMUR, DKI JAKARTA",56,147,92,239
https://kawalpemilu.org#26072,"UTAN KAYU SELATAN, MATRAMAN, JAKARTA TIMUR, DKI JAKARTA",57,111,144,255
https://kawalpemilu.org#26072,"UTAN KAYU SELATAN, MATRAMAN, JAKARTA TIMUR, DKI JAKARTA",58,90,156,246
https://kawalpemilu.org#26072,"UTAN KAYU SELATAN, MATRAMAN, JAKARTA TIMUR, DKI JAKARTA",59,131,121,252
https://kawalpemilu.org#26072,"UTAN KAYU SELATAN, MATRAMAN, JAKARTA TIMUR, DKI JAKARTA",61,144,113,257
https://kawalpemilu.org#26072,"UTAN KAYU SELATAN, MATRAMAN, JAKARTA TIMUR, DKI JAKARTA",63,119,121,240
https://kawalpemilu.org#26072,"UTAN KAYU SELATAN, MATRAMAN, JAKARTA TIMUR, DKI JAKARTA",64,129,136,265
https://kawalpemilu.org#26072,"UTAN KAYU SELATAN, MATRAMAN, JAKARTA TIMUR, DKI JAKARTA",65,130,126,256
https://kawalpemilu.org#26072,"UTAN KAYU SELATAN, MATRAMAN, JAKARTA TIMUR, DKI JAKARTA",66,114,75,189
https://kawalpemilu.org#26072,"UTAN KAYU SELATAN, MATRAMAN, JAKARTA TIMUR, DKI JAKARTA",67,141,101,242
https://kawalpemilu.org#26072,"UTAN KAYU SELATAN, MATRAMAN, JAKARTA TIMUR, DKI JAKARTA",68,114,110,224
https://kawalpemilu.org#26072,"UTAN KAYU SELATAN, MATRAMAN, JAKARTA TIMUR, DKI JAKARTA",69,132,129,261
https://kawalpemilu.org#26072,"UTAN KAYU SELATAN, MATRAMAN, JAKARTA TIMUR, DKI JAKARTA",70,142,116,258
https://kawalpemilu.org#26072,"UTAN KAYU SELATAN, MATRAMAN, JAKARTA TIMUR, DKI JAKARTA",71,163,88,251
https://kawalpemilu.org#26072,"UTAN KAYU SELATAN, MATRAMAN, JAKARTA TIMUR, DKI JAKARTA",72,0,0,0
https://kawalpemilu.org#26072,"UTAN KAYU SELATAN, MATRAMAN, JAKARTA TIMUR, DKI JAKARTA",73,171,94,265
https://kawalpemilu.org#26072,"UTAN KAYU SELATAN, MATRAMAN, JAKARTA TIMUR, DKI JAKARTA",74,108,122,230
https://kawalpemilu.org#26072,"UTAN KAYU SELATAN, MATRAMAN, JAKARTA TIMUR, DKI JAKARTA",75,184,69,253
https://kawalpemilu.org#26072,"UTAN KAYU SELATAN, MATRAMAN, JAKARTA TIMUR, DKI JAKARTA",76,142,109,251
https://kawalpemilu.org#26072,"UTAN KAYU SELATAN, MATRAMAN, JAKARTA TIMUR, DKI JAKARTA",77,131,124,255
https://kawalpemilu.org#26072,"UTAN KAYU SELATAN, MATRAMAN, JAKARTA TIMUR, DKI JAKARTA",78,156,114,270
https://kawalpemilu.org#26072,"UTAN KAYU SELATAN, MATRAMAN, JAKARTA TIMUR, DKI JAKARTA",79,130,112,242
https://kawalpemilu.org#26072,"UTAN KAYU SELATAN, MATRAMAN, JAKARTA TIMUR, DKI JAKARTA",80,110,113,223
https://kawalpemilu.org#26072,"UTAN KAYU SELATAN, MATRAMAN, JAKARTA TIMUR, DKI JAKARTA",81,109,110,219
https://kawalpemilu.org#26072,"UTAN KAYU SELATAN, MATRAMAN, JAKARTA TIMUR, DKI JAKARTA",82,123,98,221
https://kawalpemilu.org#26072,"UTAN KAYU SELATAN, MATRAMAN, JAKARTA TIMUR, DKI JAKARTA",83,138,105,243
https://kawalpemilu.org#26072,"UTAN KAYU SELATAN, MATRAMAN, JAKARTA TIMUR, DKI JAKARTA",84,108,79,187
https://kawalpemilu.org#26072,"UTAN KAYU SELATAN, MATRAMAN, JAKARTA TIMUR, DKI JAKARTA",85,132,121,253
https://kawalpemilu.org#26072,"UTAN KAYU SELATAN, MATRAMAN, JAKARTA TIMUR, DKI JAKARTA",86,114,118,232
https://kawalpemilu.org#26072,"UTAN KAYU SELATAN, MATRAMAN, JAKARTA TIMUR, DKI JAKARTA",87,113,128,241
https://kawalpemilu.org#26072,"UTAN KAYU SELATAN, MATRAMAN, JAKARTA TIMUR, DKI JAKARTA",88,146,126,272
https://kawalpemilu.org#26072,"UTAN KAYU SELATAN, MATRAMAN, JAKARTA TIMUR, DKI JAKARTA",89,105,118,223
https://kawalpemilu.org#26072,"UTAN KAYU SELATAN, MATRAMAN, JAKARTA TIMUR, DKI JAKARTA",90,109,124,233
https://kawalpemilu.org#26072,"UTAN KAYU SELATAN, MATRAMAN, JAKARTA TIMUR, DKI JAKARTA",91,130,92,222
https://kawalpemilu.org#26072,"UTAN KAYU SELATAN, MATRAMAN, JAKARTA TIMUR, DKI JAKARTA",92,151,96,247
https://kawalpemilu.org#26072,"UTAN KAYU SELATAN, MATRAMAN, JAKARTA TIMUR, DKI JAKARTA",93,143,110,253
https://kawalpemilu.org#26072,"UTAN KAYU SELATAN, MATRAMAN, JAKARTA TIMUR, DKI JAKARTA",95,119,110,229
https://kawalpemilu.org#26072,"UTAN KAYU SELATAN, MATRAMAN, JAKARTA TIMUR, DKI JAKARTA",96,148,86,234
https://kawalpemilu.org#26072,"UTAN KAYU SELATAN, MATRAMAN, JAKARTA TIMUR, DKI JAKARTA",97,136,102,238
https://kawalpemilu.org#26072,"UTAN KAYU SELATAN, MATRAMAN, JAKARTA TIMUR, DKI JAKARTA",98,134,120,254
https://kawalpemilu.org#26072,"UTAN KAYU SELATAN, MATRAMAN, JAKARTA TIMUR, DKI JAKARTA",100,138,110,248
https://kawalpemilu.org#26072,"UTAN KAYU SELATAN, MATRAMAN, JAKARTA TIMUR, DKI JAKARTA",101,136,109,245
https://kawalpemilu.org#26072,"UTAN KAYU SELATAN, MATRAMAN, JAKARTA TIMUR, DKI JAKARTA",102,148,87,235
https://kawalpemilu.org#26072,"UTAN KAYU SELATAN, MATRAMAN, JAKARTA TIMUR, DKI JAKARTA",103,103,131,234
https://kawalpemilu.org#26072,"UTAN KAYU SELATAN, MATRAMAN, JAKARTA TIMUR, DKI JAKARTA",104,117,141,258
https://kawalpemilu.org#26072,"UTAN KAYU SELATAN, MATRAMAN, JAKARTA TIMUR, DKI JAKARTA",105,128,107,235
https://kawalpemilu.org#26072,"UTAN KAYU SELATAN, MATRAMAN, JAKARTA TIMUR, DKI JAKARTA",106,66,54,120
https://kawalpemilu.org#26074,"PULO GADUNG, PULOGADUNG, JAKARTA TIMUR, DKI JAKARTA",1,184,46,230
https://kawalpemilu.org#26074,"PULO GADUNG, PULOGADUNG, JAKARTA TIMUR, DKI JAKARTA",2,109,157,266
https://kawalpemilu.org#26074,"PULO GADUNG, PULOGADUNG, JAKARTA TIMUR, DKI JAKARTA",3,120,129,249
https://kawalpemilu.org#26074,"PULO GADUNG, PULOGADUNG, JAKARTA TIMUR, DKI JAKARTA",4,117,124,241
https://kawalpemilu.org#26074,"PULO GADUNG, PULOGADUNG, JAKARTA TIMUR, DKI JAKARTA",7,101,142,243
https://kawalpemilu.org#26074,"PULO GADUNG, PULOGADUNG, JAKARTA TIMUR, DKI JAKARTA",8,86,179,265
https://kawalpemilu.org#26074,"PULO GADUNG, PULOGADUNG, JAKARTA TIMUR, DKI JAKARTA",10,100,122,222
https://kawalpemilu.org#26074,"PULO GADUNG, PULOGADUNG, JAKARTA TIMUR, DKI JAKARTA",11,100,110,210
https://kawalpemilu.org#26074,"PULO GADUNG, PULOGADUNG, JAKARTA TIMUR, DKI JAKARTA",12,80,146,226
https://kawalpemilu.org#26074,"PULO GADUNG, PULOGADUNG, JAKARTA TIMUR, DKI JAKARTA",14,54,145,199
https://kawalpemilu.org#26074,"PULO GADUNG, PULOGADUNG, JAKARTA TIMUR, DKI JAKARTA",15,97,108,205
https://kawalpemilu.org#26074,"PULO GADUNG, PULOGADUNG, JAKARTA TIMUR, DKI JAKARTA",16,59,202,261
https://kawalpemilu.org#26074,"PULO GADUNG, PULOGADUNG, JAKARTA TIMUR, DKI JAKARTA",18,93,146,239
https://kawalpemilu.org#26074,"PULO GADUNG, PULOGADUNG, JAKARTA TIMUR, DKI JAKARTA",19,68,189,257
https://kawalpemilu.org#26074,"PULO GADUNG, PULOGADUNG, JAKARTA TIMUR, DKI JAKARTA",20,94,157,251
https://kawalpemilu.org#26074,"PULO GADUNG, PULOGADUNG, JAKARTA TIMUR, DKI JAKARTA",22,61,169,230
https://kawalpemilu.org#26074,"PULO GADUNG, PULOGADUNG, JAKARTA TIMUR, DKI JAKARTA",26,95,141,236
https://kawalpemilu.org#26074,"PULO GADUNG, PULOGADUNG, JAKARTA TIMUR, DKI JAKARTA",27,97,121,218
https://kawalpemilu.org#26074,"PULO GADUNG, PULOGADUNG, JAKARTA TIMUR, DKI JAKARTA",29,82,129,211
https://kawalpemilu.org#26074,"PULO GADUNG, PULOGADUNG, JAKARTA TIMUR, DKI JAKARTA",30,100,136,236
https://kawalpemilu.org#26074,"PULO GADUNG, PULOGADUNG, JAKARTA TIMUR, DKI JAKARTA",31,140,69,209
https://kawalpemilu.org#26074,"PULO GADUNG, PULOGADUNG, JAKARTA TIMUR, DKI JAKARTA",32,156,80,236
https://kawalpemilu.org#26074,"PULO GADUNG, PULOGADUNG, JAKARTA TIMUR, DKI JAKARTA",33,145,48,193
https://kawalpemilu.org#26074,"PULO GADUNG, PULOGADUNG, JAKARTA TIMUR, DKI JAKARTA",34,156,47,203
https://kawalpemilu.org#26074,"PULO GADUNG, PULOGADUNG, JAKARTA TIMUR, DKI JAKARTA",37,139,40,179
https://kawalpemilu.org#26074,"PULO GADUNG, PULOGADUNG, JAKARTA TIMUR, DKI JAKARTA",38,90,125,215
https://kawalpemilu.org#26074,"PULO GADUNG, PULOGADUNG, JAKARTA TIMUR, DKI JAKARTA",39,98,114,212
https://kawalpemilu.org#26074,"PULO GADUNG, PULOGADUNG, JAKARTA TIMUR, DKI JAKARTA",41,126,120,246
https://kawalpemilu.org#26074,"PULO GADUNG, PULOGADUNG, JAKARTA TIMUR, DKI JAKARTA",44,119,143,262
https://kawalpemilu.org#26074,"PULO GADUNG, PULOGADUNG, JAKARTA TIMUR, DKI JAKARTA",45,135,134,269
https://kawalpemilu.org#26074,"PULO GADUNG, PULOGADUNG, JAKARTA TIMUR, DKI JAKARTA",47,212,20,232
https://kawalpemilu.org#26074,"PULO GADUNG, PULOGADUNG, JAKARTA TIMUR, DKI JAKARTA",48,105,145,250
https://kawalpemilu.org#26074,"PULO GADUNG, PULOGADUNG, JAKARTA TIMUR, DKI JAKARTA",49,154,86,240
https://kawalpemilu.org#26074,"PULO GADUNG, PULOGADUNG, JAKARTA TIMUR, DKI JAKARTA",50,111,153,264
https://kawalpemilu.org#26074,"PULO GADUNG, PULOGADUNG, JAKARTA TIMUR, DKI JAKARTA",51,109,143,252
https://kawalpemilu.org#26074,"PULO GADUNG, PULOGADUNG, JAKARTA TIMUR, DKI JAKARTA",52,122,136,258
https://kawalpemilu.org#26074,"PULO GADUNG, PULOGADUNG, JAKARTA TIMUR, DKI JAKARTA",54,127,131,258
https://kawalpemilu.org#26074,"PULO GADUNG, PULOGADUNG, JAKARTA TIMUR, DKI JAKARTA",55,109,142,251
https://kawalpemilu.org#26074,"PULO GADUNG, PULOGADUNG, JAKARTA TIMUR, DKI JAKARTA",57,135,119,254
https://kawalpemilu.org#26074,"PULO GADUNG, PULOGADUNG, JAKARTA TIMUR, DKI JAKARTA",58,115,127,242
https://kawalpemilu.org#26074,"PULO GADUNG, PULOGADUNG, JAKARTA TIMUR, DKI JAKARTA",59,193,59,252
https://kawalpemilu.org#26074,"PULO GADUNG, PULOGADUNG, JAKARTA TIMUR, DKI JAKARTA",60,182,61,243
https://kawalpemilu.org#26074,"PULO GADUNG, PULOGADUNG, JAKARTA TIMUR, DKI JAKARTA",61,144,62,206
https://kawalpemilu.org#26074,"PULO GADUNG, PULOGADUNG, JAKARTA TIMUR, DKI JAKARTA",62,134,98,232
https://kawalpemilu.org#26074,"PULO GADUNG, PULOGADUNG, JAKARTA TIMUR, DKI JAKARTA",63,123,101,224
https://kawalpemilu.org#26074,"PULO GADUNG, PULOGADUNG, JAKARTA TIMUR, DKI JAKARTA",64,196,49,245
https://kawalpemilu.org#26074,"PULO GADUNG, PULOGADUNG, JAKARTA TIMUR, DKI JAKARTA",65,168,18,186
https://kawalpemilu.org#26074,"PULO GADUNG, PULOGADUNG, JAKARTA TIMUR, DKI JAKARTA",66,140,28,168
https://kawalpemilu.org#26074,"PULO GADUNG, PULOGADUNG, JAKARTA TIMUR, DKI JAKARTA",67,180,77,257
https://kawalpemilu.org#26074,"PULO GADUNG, PULOGADUNG, JAKARTA TIMUR, DKI JAKARTA",68,108,116,224
https://kawalpemilu.org#26074,"PULO GADUNG, PULOGADUNG, JAKARTA TIMUR, DKI JAKARTA",69,152,61,213
https://kawalpemilu.org#26074,"PULO GADUNG, PULOGADUNG, JAKARTA TIMUR, DKI JAKARTA",70,209,18,227
https://kawalpemilu.org#26074,"PULO GADUNG, PULOGADUNG, JAKARTA TIMUR, DKI JAKARTA",71,192,34,226
https://kawalpemilu.org#26074,"PULO GADUNG, PULOGADUNG, JAKARTA TIMUR, DKI JAKARTA",72,196,42,238
https://kawalpemilu.org#26074,"PULO GADUNG, PULOGADUNG, JAKARTA TIMUR, DKI JAKARTA",73,172,33,205
https://kawalpemilu.org#26074,"PULO GADUNG, PULOGADUNG, JAKARTA TIMUR, DKI JAKARTA",74,155,44,199
https://kawalpemilu.org#26074,"PULO GADUNG, PULOGADUNG, JAKARTA TIMUR, DKI JAKARTA",75,194,54,248
https://kawalpemilu.org#26074,"PULO GADUNG, PULOGADUNG, JAKARTA TIMUR, DKI JAKARTA",76,222,40,262
https://kawalpemilu.org#26074,"PULO GADUNG, PULOGADUNG, JAKARTA TIMUR, DKI JAKARTA",77,232,30,262
https://kawalpemilu.org#26074,"PULO GADUNG, PULOGADUNG, JAKARTA TIMUR, DKI JAKARTA",78,167,81,248
https://kawalpemilu.org#26074,"PULO GADUNG, PULOGADUNG, JAKARTA TIMUR, DKI JAKARTA",79,178,81,259
https://kawalpemilu.org#26074,"PULO GADUNG, PULOGADUNG, JAKARTA TIMUR, DKI JAKARTA",80,133,91,224
https://kawalpemilu.org#26074,"PULO GADUNG, PULOGADUNG, JAKARTA TIMUR, DKI JAKARTA",81,148,93,241
https://kawalpemilu.org#26074,"PULO GADUNG, PULOGADUNG, JAKARTA TIMUR, DKI JAKARTA",84,0,0,0
https://kawalpemilu.org#26074,"PULO GADUNG, PULOGADUNG, JAKARTA TIMUR, DKI JAKARTA",86,167,60,227
https://kawalpemilu.org#26074,"PULO GADUNG, PULOGADUNG, JAKARTA TIMUR, DKI JAKARTA",88,0,0,0
https://kawalpemilu.org#26074,"PULO GADUNG, PULOGADUNG, JAKARTA TIMUR, DKI JAKARTA",91,237,23,260
https://kawalpemilu.org#26074,"PULO GADUNG, PULOGADUNG, JAKARTA TIMUR, DKI JAKARTA",92,0,0,0
https://kawalpemilu.org#26074,"PULO GADUNG, PULOGADUNG, JAKARTA TIMUR, DKI JAKARTA",94,231,17,248
https://kawalpemilu.org#26074,"PULO GADUNG, PULOGADUNG, JAKARTA TIMUR, DKI JAKARTA",95,224,16,240
https://kawalpemilu.org#26074,"PULO GADUNG, PULOGADUNG, JAKARTA TIMUR, DKI JAKARTA",96,205,23,230
https://kawalpemilu.org#26074,"PULO GADUNG, PULOGADUNG, JAKARTA TIMUR, DKI JAKARTA",97,146,63,209
https://kawalpemilu.org#26074,"PULO GADUNG, PULOGADUNG, JAKARTA TIMUR, DKI JAKARTA",100,0,0,0
https://kawalpemilu.org#26074,"PULO GADUNG, PULOGADUNG, JAKARTA TIMUR, DKI JAKARTA",101,183,98,281
https://kawalpemilu.org#26074,"PULO GADUNG, PULOGADUNG, JAKARTA TIMUR, DKI JAKARTA",102,140,49,189
https://kawalpemilu.org#26074,"PULO GADUNG, PULOGADUNG, JAKARTA TIMUR, DKI JAKARTA",103,117,41,158
https://kawalpemilu.org#26074,"PULO GADUNG, PULOGADUNG, JAKARTA TIMUR, DKI JAKARTA",105,172,17,189
https://kawalpemilu.org#26075,"PISANGAN TIMUR, PULOGADUNG, JAKARTA TIMUR, DKI JAKARTA",1,146,59,205
https://kawalpemilu.org#26075,"PISANGAN TIMUR, PULOGADUNG, JAKARTA TIMUR, DKI JAKARTA",2,139,68,207
https://kawalpemilu.org#26075,"PISANGAN TIMUR, PULOGADUNG, JAKARTA TIMUR, DKI JAKARTA",3,95,168,263
https://kawalpemilu.org#26075,"PISANGAN TIMUR, PULOGADUNG, JAKARTA TIMUR, DKI JAKARTA",4,121,115,236
https://kawalpemilu.org#26075,"PISANGAN TIMUR, PULOGADUNG, JAKARTA TIMUR, DKI JAKARTA",5,121,113,234
https://kawalpemilu.org#26075,"PISANGAN TIMUR, PULOGADUNG, JAKARTA TIMUR, DKI JAKARTA",6,161,94,255
https://kawalpemilu.org#26075,"PISANGAN TIMUR, PULOGADUNG, JAKARTA TIMUR, DKI JAKARTA",7,119,117,236
https://kawalpemilu.org#26075,"PISANGAN TIMUR, PULOGADUNG, JAKARTA TIMUR, DKI JAKARTA",8,125,130,255
https://kawalpemilu.org#26075,"PISANGAN TIMUR, PULOGADUNG, JAKARTA TIMUR, DKI JAKARTA",9,121,110,231
https://kawalpemilu.org#26075,"PISANGAN TIMUR, PULOGADUNG, JAKARTA TIMUR, DKI JAKARTA",10,117,122,239
https://kawalpemilu.org#26075,"PISANGAN TIMUR, PULOGADUNG, JAKARTA TIMUR, DKI JAKARTA",11,89,140,229
https://kawalpemilu.org#26075,"PISANGAN TIMUR, PULOGADUNG, JAKARTA TIMUR, DKI JAKARTA",12,100,143,243
https://kawalpemilu.org#26075,"PISANGAN TIMUR, PULOGADUNG, JAKARTA TIMUR, DKI JAKARTA",13,83,150,233
https://kawalpemilu.org#26075,"PISANGAN TIMUR, PULOGADUNG, JAKARTA TIMUR, DKI JAKARTA",14,102,110,212
https://kawalpemilu.org#26075,"PISANGAN TIMUR, PULOGADUNG, JAKARTA TIMUR, DKI JAKARTA",15,102,136,238
https://kawalpemilu.org#26075,"PISANGAN TIMUR, PULOGADUNG, JAKARTA TIMUR, DKI JAKARTA",16,87,111,198
https://kawalpemilu.org#26075,"PISANGAN TIMUR, PULOGADUNG, JAKARTA TIMUR, DKI JAKARTA",17,139,116,255
https://kawalpemilu.org#26075,"PISANGAN TIMUR, PULOGADUNG, JAKARTA TIMUR, DKI JAKARTA",18,112,135,247
https://kawalpemilu.org#26075,"PISANGAN TIMUR, PULOGADUNG, JAKARTA TIMUR, DKI JAKARTA",19,114,134,248
https://kawalpemilu.org#26075,"PISANGAN TIMUR, PULOGADUNG, JAKARTA TIMUR, DKI JAKARTA",20,88,170,258
https://kawalpemilu.org#26075,"PISANGAN TIMUR, PULOGADUNG, JAKARTA TIMUR, DKI JAKARTA",21,93,134,227
https://kawalpemilu.org#26075,"PISANGAN TIMUR, PULOGADUNG, JAKARTA TIMUR, DKI JAKARTA",22,83,108,191
https://kawalpemilu.org#26075,"PISANGAN TIMUR, PULOGADUNG, JAKARTA TIMUR, DKI JAKARTA",23,112,129,241
https://kawalpemilu.org#26075,"PISANGAN TIMUR, PULOGADUNG, JAKARTA TIMUR, DKI JAKARTA",24,113,134,247
https://kawalpemilu.org#26075,"PISANGAN TIMUR, PULOGADUNG, JAKARTA TIMUR, DKI JAKARTA",25,94,118,212
https://kawalpemilu.org#26075,"PISANGAN TIMUR, PULOGADUNG, JAKARTA TIMUR, DKI JAKARTA",26,84,164,248
https://kawalpemilu.org#26075,"PISANGAN TIMUR, PULOGADUNG, JAKARTA TIMUR, DKI JAKARTA",27,110,137,247
https://kawalpemilu.org#26075,"PISANGAN TIMUR, PULOGADUNG, JAKARTA TIMUR, DKI JAKARTA",28,129,77,206
https://kawalpemilu.org#26075,"PISANGAN TIMUR, PULOGADUNG, JAKARTA TIMUR, DKI JAKARTA",29,114,136,250
https://kawalpemilu.org#26075,"PISANGAN TIMUR, PULOGADUNG, JAKARTA TIMUR, DKI JAKARTA",30,121,112,233
https://kawalpemilu.org#26075,"PISANGAN TIMUR, PULOGADUNG, JAKARTA TIMUR, DKI JAKARTA",31,119,117,236
https://kawalpemilu.org#26075,"PISANGAN TIMUR, PULOGADUNG, JAKARTA TIMUR, DKI JAKARTA",32,99,128,227
https://kawalpemilu.org#26075,"PISANGAN TIMUR, PULOGADUNG, JAKARTA TIMUR, DKI JAKARTA",33,123,109,232
https://kawalpemilu.org#26075,"PISANGAN TIMUR, PULOGADUNG, JAKARTA TIMUR, DKI JAKARTA",34,118,120,238
https://kawalpemilu.org#26075,"PISANGAN TIMUR, PULOGADUNG, JAKARTA TIMUR, DKI JAKARTA",35,88,126,214
https://kawalpemilu.org#26075,"PISANGAN TIMUR, PULOGADUNG, JAKARTA TIMUR, DKI JAKARTA",36,87,100,187
https://kawalpemilu.org#26075,"PISANGAN TIMUR, PULOGADUNG, JAKARTA TIMUR, DKI JAKARTA",37,78,123,201
https://kawalpemilu.org#26075,"PISANGAN TIMUR, PULOGADUNG, JAKARTA TIMUR, DKI JAKARTA",38,115,124,239
https://kawalpemilu.org#26075,"PISANGAN TIMUR, PULOGADUNG, JAKARTA TIMUR, DKI JAKARTA",39,126,121,247
https://kawalpemilu.org#26075,"PISANGAN TIMUR, PULOGADUNG, JAKARTA TIMUR, DKI JAKARTA",40,108,139,247
https://kawalpemilu.org#26075,"PISANGAN TIMUR, PULOGADUNG, JAKARTA TIMUR, DKI JAKARTA",41,76,141,217
https://kawalpemilu.org#26075,"PISANGAN TIMUR, PULOGADUNG, JAKARTA TIMUR, DKI JAKARTA",42,97,134,231
https://kawalpemilu.org#26075,"PISANGAN TIMUR, PULOGADUNG, JAKARTA TIMUR, DKI JAKARTA",43,105,103,208
https://kawalpemilu.org#26075,"PISANGAN TIMUR, PULOGADUNG, JAKARTA TIMUR, DKI JAKARTA",44,111,126,237
https://kawalpemilu.org#26075,"PISANGAN TIMUR, PULOGADUNG, JAKARTA TIMUR, DKI JAKARTA",45,95,117,212
https://kawalpemilu.org#26075,"PISANGAN TIMUR, PULOGADUNG, JAKARTA TIMUR, DKI JAKARTA",46,106,148,254
https://kawalpemilu.org#26075,"PISANGAN TIMUR, PULOGADUNG, JAKARTA TIMUR, DKI JAKARTA",47,129,132,261
https://kawalpemilu.org#26075,"PISANGAN TIMUR, PULOGADUNG, JAKARTA TIMUR, DKI JAKARTA",48,81,178,259
https://kawalpemilu.org#26075,"PISANGAN TIMUR, PULOGADUNG, JAKARTA TIMUR, DKI JAKARTA",49,77,180,257
https://kawalpemilu.org#26075,"PISANGAN TIMUR, PULOGADUNG, JAKARTA TIMUR, DKI JAKARTA",50,115,154,269
https://kawalpemilu.org#26075,"PISANGAN TIMUR, PULOGADUNG, JAKARTA TIMUR, DKI JAKARTA",51,125,133,258
https://kawalpemilu.org#26075,"PISANGAN TIMUR, PULOGADUNG, JAKARTA TIMUR, DKI JAKARTA",52,105,146,251
https://kawalpemilu.org#26075,"PISANGAN TIMUR, PULOGADUNG, JAKARTA TIMUR, DKI JAKARTA",53,88,148,236
https://kawalpemilu.org#26075,"PISANGAN TIMUR, PULOGADUNG, JAKARTA TIMUR, DKI JAKARTA",54,96,136,232
https://kawalpemilu.org#26075,"PISANGAN TIMUR, PULOGADUNG, JAKARTA TIMUR, DKI JAKARTA",55,86,134,220
https://kawalpemilu.org#26075,"PISANGAN TIMUR, PULOGADUNG, JAKARTA TIMUR, DKI JAKARTA",56,91,149,240
https://kawalpemilu.org#26075,"PISANGAN TIMUR, PULOGADUNG, JAKARTA TIMUR, DKI JAKARTA",57,104,138,242
https://kawalpemilu.org#26075,"PISANGAN TIMUR, PULOGADUNG, JAKARTA TIMUR, DKI JAKARTA",58,94,126,220
https://kawalpemilu.org#26075,"PISANGAN TIMUR, PULOGADUNG, JAKARTA TIMUR, DKI JAKARTA",59,105,108,213
https://kawalpemilu.org#26075,"PISANGAN TIMUR, PULOGADUNG, JAKARTA TIMUR, DKI JAKARTA",60,90,125,215
https://kawalpemilu.org#26075,"PISANGAN TIMUR, PULOGADUNG, JAKARTA TIMUR, DKI JAKARTA",61,77,163,240
https://kawalpemilu.org#26075,"PISANGAN TIMUR, PULOGADUNG, JAKARTA TIMUR, DKI JAKARTA",62,60,190,250
https://kawalpemilu.org#26075,"PISANGAN TIMUR, PULOGADUNG, JAKARTA TIMUR, DKI JAKARTA",63,85,169,254
https://kawalpemilu.org#26075,"PISANGAN TIMUR, PULOGADUNG, JAKARTA TIMUR, DKI JAKARTA",64,103,129,232
https://kawalpemilu.org#26075,"PISANGAN TIMUR, PULOGADUNG, JAKARTA TIMUR, DKI JAKARTA",65,129,112,241
https://kawalpemilu.org#26075,"PISANGAN TIMUR, PULOGADUNG, JAKARTA TIMUR, DKI JAKARTA",66,125,120,245
https://kawalpemilu.org#26075,"PISANGAN TIMUR, PULOGADUNG, JAKARTA TIMUR, DKI JAKARTA",67,99,116,215
https://kawalpemilu.org#26075,"PISANGAN TIMUR, PULOGADUNG, JAKARTA TIMUR, DKI JAKARTA",68,131,100,231
https://kawalpemilu.org#26075,"PISANGAN TIMUR, PULOGADUNG, JAKARTA TIMUR, DKI JAKARTA",69,113,116,229
https://kawalpemilu.org#26075,"PISANGAN TIMUR, PULOGADUNG, JAKARTA TIMUR, DKI JAKARTA",70,99,115,214
https://kawalpemilu.org#26075,"PISANGAN TIMUR, PULOGADUNG, JAKARTA TIMUR, DKI JAKARTA",71,130,122,252
https://kawalpemilu.org#26075,"PISANGAN TIMUR, PULOGADUNG, JAKARTA TIMUR, DKI JAKARTA",72,113,130,243
https://kawalpemilu.org#26075,"PISANGAN TIMUR, PULOGADUNG, JAKARTA TIMUR, DKI JAKARTA",73,109,136,245
https://kawalpemilu.org#26075,"PISANGAN TIMUR, PULOGADUNG, JAKARTA TIMUR, DKI JAKARTA",74,108,139,247
https://kawalpemilu.org#26075,"PISANGAN TIMUR, PULOGADUNG, JAKARTA TIMUR, DKI JAKARTA",75,77,170,247
https://kawalpemilu.org#26075,"PISANGAN TIMUR, PULOGADUNG, JAKARTA TIMUR, DKI JAKARTA",76,90,148,238
https://kawalpemilu.org#26075,"PISANGAN TIMUR, PULOGADUNG, JAKARTA TIMUR, DKI JAKARTA",77,104,126,230
https://kawalpemilu.org#26075,"PISANGAN TIMUR, PULOGADUNG, JAKARTA TIMUR, DKI JAKARTA",78,116,126,242
https://kawalpemilu.org#26075,"PISANGAN TIMUR, PULOGADUNG, JAKARTA TIMUR, DKI JAKARTA",79,161,82,243
https://kawalpemilu.org#26075,"PISANGAN TIMUR, PULOGADUNG, JAKARTA TIMUR, DKI JAKARTA",80,81,142,223
https://kawalpemilu.org#26075,"PISANGAN TIMUR, PULOGADUNG, JAKARTA TIMUR, DKI JAKARTA",81,104,161,265
https://kawalpemilu.org#26075,"PISANGAN TIMUR, PULOGADUNG, JAKARTA TIMUR, DKI JAKARTA",82,84,166,250
https://kawalpemilu.org#26075,"PISANGAN TIMUR, PULOGADUNG, JAKARTA TIMUR, DKI JAKARTA",83,116,116,232
https://kawalpemilu.org#26075,"PISANGAN TIMUR, PULOGADUNG, JAKARTA TIMUR, DKI JAKARTA",84,133,116,249
https://kawalpemilu.org#26075,"PISANGAN TIMUR, PULOGADUNG, JAKARTA TIMUR, DKI JAKARTA",85,139,109,248
https://kawalpemilu.org#26075,"PISANGAN TIMUR, PULOGADUNG, JAKARTA TIMUR, DKI JAKARTA",86,136,116,252
https://kawalpemilu.org#26075,"PISANGAN TIMUR, PULOGADUNG, JAKARTA TIMUR, DKI JAKARTA",87,134,123,257
https://kawalpemilu.org#26075,"PISANGAN TIMUR, PULOGADUNG, JAKARTA TIMUR, DKI JAKARTA",88,91,168,259
https://kawalpemilu.org#26075,"PISANGAN TIMUR, PULOGADUNG, JAKARTA TIMUR, DKI JAKARTA",89,127,132,259
https://kawalpemilu.org#26075,"PISANGAN TIMUR, PULOGADUNG, JAKARTA TIMUR, DKI JAKARTA",90,105,165,270
https://kawalpemilu.org#26075,"PISANGAN TIMUR, PULOGADUNG, JAKARTA TIMUR, DKI JAKARTA",91,108,144,252
https://kawalpemilu.org#26075,"PISANGAN TIMUR, PULOGADUNG, JAKARTA TIMUR, DKI JAKARTA",92,116,126,243
https://kawalpemilu.org#26075,"PISANGAN TIMUR, PULOGADUNG, JAKARTA TIMUR, DKI JAKARTA",93,113,112,225
https://kawalpemilu.org#26075,"PISANGAN TIMUR, PULOGADUNG, JAKARTA TIMUR, DKI JAKARTA",94,97,145,242
https://kawalpemilu.org#26075,"PISANGAN TIMUR, PULOGADUNG, JAKARTA TIMUR, DKI JAKARTA",95,86,132,218
https://kawalpemilu.org#26075,"PISANGAN TIMUR, PULOGADUNG, JAKARTA TIMUR, DKI JAKARTA",96,136,113,249
https://kawalpemilu.org#26075,"PISANGAN TIMUR, PULOGADUNG, JAKARTA TIMUR, DKI JAKARTA",97,103,114,217
https://kawalpemilu.org#26075,"PISANGAN TIMUR, PULOGADUNG, JAKARTA TIMUR, DKI JAKARTA",98,137,129,266
https://kawalpemilu.org#26075,"PISANGAN TIMUR, PULOGADUNG, JAKARTA TIMUR, DKI JAKARTA",99,123,107,230
https://kawalpemilu.org#26075,"PISANGAN TIMUR, PULOGADUNG, JAKARTA TIMUR, DKI JAKARTA",100,108,153,261
https://kawalpemilu.org#26075,"PISANGAN TIMUR, PULOGADUNG, JAKARTA TIMUR, DKI JAKARTA",101,92,144,236
https://kawalpemilu.org#26075,"PISANGAN TIMUR, PULOGADUNG, JAKARTA TIMUR, DKI JAKARTA",102,76,181,257
https://kawalpemilu.org#26075,"PISANGAN TIMUR, PULOGADUNG, JAKARTA TIMUR, DKI JAKARTA",103,88,166,254
https://kawalpemilu.org#26075,"PISANGAN TIMUR, PULOGADUNG, JAKARTA TIMUR, DKI JAKARTA",104,95,140,235
https://kawalpemilu.org#26075,"PISANGAN TIMUR, PULOGADUNG, JAKARTA TIMUR, DKI JAKARTA",105,74,152,226
https://kawalpemilu.org#26075,"PISANGAN TIMUR, PULOGADUNG, JAKARTA TIMUR, DKI JAKARTA",106,85,138,223
https://kawalpemilu.org#26075,"PISANGAN TIMUR, PULOGADUNG, JAKARTA TIMUR, DKI JAKARTA",107,125,98,223
https://kawalpemilu.org#26075,"PISANGAN TIMUR, PULOGADUNG, JAKARTA TIMUR, DKI JAKARTA",108,103,132,235
https://kawalpemilu.org#26075,"PISANGAN TIMUR, PULOGADUNG, JAKARTA TIMUR, DKI JAKARTA",109,86,163,249
https://kawalpemilu.org#26075,"PISANGAN TIMUR, PULOGADUNG, JAKARTA TIMUR, DKI JAKARTA",110,128,113,241
https://kawalpemilu.org#26075,"PISANGAN TIMUR, PULOGADUNG, JAKARTA TIMUR, DKI JAKARTA",111,111,132,243
https://kawalpemilu.org#26075,"PISANGAN TIMUR, PULOGADUNG, JAKARTA TIMUR, DKI JAKARTA",112,106,119,225
https://kawalpemilu.org#26075,"PISANGAN TIMUR, PULOGADUNG, JAKARTA TIMUR, DKI JAKARTA",113,110,165,275
https://kawalpemilu.org#26075,"PISANGAN TIMUR, PULOGADUNG, JAKARTA TIMUR, DKI JAKARTA",114,60,156,216
https://kawalpemilu.org#26075,"PISANGAN TIMUR, PULOGADUNG, JAKARTA TIMUR, DKI JAKARTA",115,65,145,210
https://kawalpemilu.org#26075,"PISANGAN TIMUR, PULOGADUNG, JAKARTA TIMUR, DKI JAKARTA",116,67,172,239
https://kawalpemilu.org#26075,"PISANGAN TIMUR, PULOGADUNG, JAKARTA TIMUR, DKI JAKARTA",117,123,115,238
https://kawalpemilu.org#26075,"PISANGAN TIMUR, PULOGADUNG, JAKARTA TIMUR, DKI JAKARTA",118,122,146,268
https://kawalpemilu.org#26075,"PISANGAN TIMUR, PULOGADUNG, JAKARTA TIMUR, DKI JAKARTA",119,138,83,221
https://kawalpemilu.org#26075,"PISANGAN TIMUR, PULOGADUNG, JAKARTA TIMUR, DKI JAKARTA",120,116,100,216
https://kawalpemilu.org#26075,"PISANGAN TIMUR, PULOGADUNG, JAKARTA TIMUR, DKI JAKARTA",121,148,103,251
https://kawalpemilu.org#26075,"PISANGAN TIMUR, PULOGADUNG, JAKARTA TIMUR, DKI JAKARTA",122,112,119,231
https://kawalpemilu.org#26075,"PISANGAN TIMUR, PULOGADUNG, JAKARTA TIMUR, DKI JAKARTA",123,118,93,211
https://kawalpemilu.org#26075,"PISANGAN TIMUR, PULOGADUNG, JAKARTA TIMUR, DKI JAKARTA",124,113,92,205
https://kawalpemilu.org#26075,"PISANGAN TIMUR, PULOGADUNG, JAKARTA TIMUR, DKI JAKARTA",125,99,112,211
https://kawalpemilu.org#26075,"PISANGAN TIMUR, PULOGADUNG, JAKARTA TIMUR, DKI JAKARTA",126,72,98,170
https://kawalpemilu.org#26075,"PISANGAN TIMUR, PULOGADUNG, JAKARTA TIMUR, DKI JAKARTA",127,66,117,183
https://kawalpemilu.org#26075,"PISANGAN TIMUR, PULOGADUNG, JAKARTA TIMUR, DKI JAKARTA",128,87,65,152
https://kawalpemilu.org#26076,"CIPINANG, PULOGADUNG, JAKARTA TIMUR, DKI JAKARTA",1,112,124,236
https://kawalpemilu.org#26076,"CIPINANG, PULOGADUNG, JAKARTA TIMUR, DKI JAKARTA",2,123,138,261
https://kawalpemilu.org#26076,"CIPINANG, PULOGADUNG, JAKARTA TIMUR, DKI JAKARTA",3,99,122,221
https://kawalpemilu.org#26076,"CIPINANG, PULOGADUNG, JAKARTA TIMUR, DKI JAKARTA",4,130,109,239
https://kawalpemilu.org#26076,"CIPINANG, PULOGADUNG, JAKARTA TIMUR, DKI JAKARTA",5,169,63,232
https://kawalpemilu.org#26076,"CIPINANG, PULOGADUNG, JAKARTA TIMUR, DKI JAKARTA",6,130,91,221
https://kawalpemilu.org#26076,"CIPINANG, PULOGADUNG, JAKARTA TIMUR, DKI JAKARTA",7,63,195,258
https://kawalpemilu.org#26076,"CIPINANG, PULOGADUNG, JAKARTA TIMUR, DKI JAKARTA",8,132,107,239
https://kawalpemilu.org#26076,"CIPINANG, PULOGADUNG, JAKARTA TIMUR, DKI JAKARTA",9,78,162,240
https://kawalpemilu.org#26076,"CIPINANG, PULOGADUNG, JAKARTA TIMUR, DKI JAKARTA",10,125,137,262
https://kawalpemilu.org#26076,"CIPINANG, PULOGADUNG, JAKARTA TIMUR, DKI JAKARTA",11,129,112,241
https://kawalpemilu.org#26076,"CIPINANG, PULOGADUNG, JAKARTA TIMUR, DKI JAKARTA",12,135,119,254
https://kawalpemilu.org#26076,"CIPINANG, PULOGADUNG, JAKARTA TIMUR, DKI JAKARTA",13,164,92,256
https://kawalpemilu.org#26076,"CIPINANG, PULOGADUNG, JAKARTA TIMUR, DKI JAKARTA",15,128,105,233
https://kawalpemilu.org#26076,"CIPINANG, PULOGADUNG, JAKARTA TIMUR, DKI JAKARTA",16,156,84,240
https://kawalpemilu.org#26076,"CIPINANG, PULOGADUNG, JAKARTA TIMUR, DKI JAKARTA",17,62,164,226
https://kawalpemilu.org#26076,"CIPINANG, PULOGADUNG, JAKARTA TIMUR, DKI JAKARTA",18,86,161,247
https://kawalpemilu.org#26076,"CIPINANG, PULOGADUNG, JAKARTA TIMUR, DKI JAKARTA",19,103,132,235
https://kawalpemilu.org#26076,"CIPINANG, PULOGADUNG, JAKARTA TIMUR, DKI JAKARTA",20,101,111,212
https://kawalpemilu.org#26076,"CIPINANG, PULOGADUNG, JAKARTA TIMUR, DKI JAKARTA",21,50,171,221
https://kawalpemilu.org#26076,"CIPINANG, PULOGADUNG, JAKARTA TIMUR, DKI JAKARTA",22,94,114,208
https://kawalpemilu.org#26076,"CIPINANG, PULOGADUNG, JAKARTA TIMUR, DKI JAKARTA",23,111,107,218
https://kawalpemilu.org#26076,"CIPINANG, PULOGADUNG, JAKARTA TIMUR, DKI JAKARTA",24,139,95,234
https://kawalpemilu.org#26076,"CIPINANG, PULOGADUNG, JAKARTA TIMUR, DKI JAKARTA",25,128,116,244
https://kawalpemilu.org#26076,"CIPINANG, PULOGADUNG, JAKARTA TIMUR, DKI JAKARTA",26,96,135,231
https://kawalpemilu.org#26076,"CIPINANG, PULOGADUNG, JAKARTA TIMUR, DKI JAKARTA",27,65,182,247
https://kawalpemilu.org#26076,"CIPINANG, PULOGADUNG, JAKARTA TIMUR, DKI JAKARTA",28,128,122,250
https://kawalpemilu.org#26076,"CIPINANG, PULOGADUNG, JAKARTA TIMUR, DKI JAKARTA",29,135,122,257
https://kawalpemilu.org#26076,"CIPINANG, PULOGADUNG, JAKARTA TIMUR, DKI JAKARTA",31,109,89,198
https://kawalpemilu.org#26076,"CIPINANG, PULOGADUNG, JAKARTA TIMUR, DKI JAKARTA",32,139,110,249
https://kawalpemilu.org#26076,"CIPINANG, PULOGADUNG, JAKARTA TIMUR, DKI JAKARTA",33,159,83,242
https://kawalpemilu.org#26076,"CIPINANG, PULOGADUNG, JAKARTA TIMUR, DKI JAKARTA",34,155,76,231
https://kawalpemilu.org#26076,"CIPINANG, PULOGADUNG, JAKARTA TIMUR, DKI JAKARTA",36,104,122,226
https://kawalpemilu.org#26076,"CIPINANG, PULOGADUNG, JAKARTA TIMUR, DKI JAKARTA",37,156,91,247
https://kawalpemilu.org#26076,"CIPINANG, PULOGADUNG, JAKARTA TIMUR, DKI JAKARTA",38,164,75,239
https://kawalpemilu.org#26076,"CIPINANG, PULOGADUNG, JAKARTA TIMUR, DKI JAKARTA",39,127,102,229
https://kawalpemilu.org#26076,"CIPINANG, PULOGADUNG, JAKARTA TIMUR, DKI JAKARTA",40,166,69,235
https://kawalpemilu.org#26076,"CIPINANG, PULOGADUNG, JAKARTA TIMUR, DKI JAKARTA",41,172,87,259
https://kawalpemilu.org#26076,"CIPINANG, PULOGADUNG, JAKARTA TIMUR, DKI JAKARTA",42,132,99,231
https://kawalpemilu.org#26076,"CIPINANG, PULOGADUNG, JAKARTA TIMUR, DKI JAKARTA",43,146,75,221
https://kawalpemilu.org#26076,"CIPINANG, PULOGADUNG, JAKARTA TIMUR, DKI JAKARTA",45,144,85,229
https://kawalpemilu.org#26076,"CIPINANG, PULOGADUNG, JAKARTA TIMUR, DKI JAKARTA",46,131,112,243
https://kawalpemilu.org#26076,"CIPINANG, PULOGADUNG, JAKARTA TIMUR, DKI JAKARTA",47,144,89,233
https://kawalpemilu.org#26076,"CIPINANG, PULOGADUNG, JAKARTA TIMUR, DKI JAKARTA",48,135,84,219
https://kawalpemilu.org#26076,"CIPINANG, PULOGADUNG, JAKARTA TIMUR, DKI JAKARTA",49,112,117,229
https://kawalpemilu.org#26076,"CIPINANG, PULOGADUNG, JAKARTA TIMUR, DKI JAKARTA",50,118,114,232
https://kawalpemilu.org#26076,"CIPINANG, PULOGADUNG, JAKARTA TIMUR, DKI JAKARTA",51,129,118,257
https://kawalpemilu.org#26076,"CIPINANG, PULOGADUNG, JAKARTA TIMUR, DKI JAKARTA",52,110,109,219
https://kawalpemilu.org#26076,"CIPINANG, PULOGADUNG, JAKARTA TIMUR, DKI JAKARTA",53,53,67,120
https://kawalpemilu.org#26076,"CIPINANG, PULOGADUNG, JAKARTA TIMUR, DKI JAKARTA",54,134,108,242
https://kawalpemilu.org#26076,"CIPINANG, PULOGADUNG, JAKARTA TIMUR, DKI JAKARTA",55,116,129,245
https://kawalpemilu.org#26076,"CIPINANG, PULOGADUNG, JAKARTA TIMUR, DKI JAKARTA",56,111,150,261
https://kawalpemilu.org#26076,"CIPINANG, PULOGADUNG, JAKARTA TIMUR, DKI JAKARTA",57,114,129,243
https://kawalpemilu.org#26076,"CIPINANG, PULOGADUNG, JAKARTA TIMUR, DKI JAKARTA",58,112,107,219
https://kawalpemilu.org#26076,"CIPINANG, PULOGADUNG, JAKARTA TIMUR, DKI JAKARTA",60,105,135,240
https://kawalpemilu.org#26076,"CIPINANG, PULOGADUNG, JAKARTA TIMUR, DKI JAKARTA",61,150,82,232
https://kawalpemilu.org#26076,"CIPINANG, PULOGADUNG, JAKARTA TIMUR, DKI JAKARTA",62,148,100,248
https://kawalpemilu.org#26076,"CIPINANG, PULOGADUNG, JAKARTA TIMUR, DKI JAKARTA",63,116,112,228
https://kawalpemilu.org#26076,"CIPINANG, PULOGADUNG, JAKARTA TIMUR, DKI JAKARTA",64,124,119,243
https://kawalpemilu.org#26076,"CIPINANG, PULOGADUNG, JAKARTA TIMUR, DKI JAKARTA",65,100,131,231
https://kawalpemilu.org#26076,"CIPINANG, PULOGADUNG, JAKARTA TIMUR, DKI JAKARTA",66,126,92,218
https://kawalpemilu.org#26076,"CIPINANG, PULOGADUNG, JAKARTA TIMUR, DKI JAKARTA",67,122,93,215
https://kawalpemilu.org#26076,"CIPINANG, PULOGADUNG, JAKARTA TIMUR, DKI JAKARTA",68,77,151,228
https://kawalpemilu.org#26076,"CIPINANG, PULOGADUNG, JAKARTA TIMUR, DKI JAKARTA",69,84,149,233
https://kawalpemilu.org#26076,"CIPINANG, PULOGADUNG, JAKARTA TIMUR, DKI JAKARTA",70,139,96,235
https://kawalpemilu.org#26076,"CIPINANG, PULOGADUNG, JAKARTA TIMUR, DKI JAKARTA",71,99,128,227
https://kawalpemilu.org#26076,"CIPINANG, PULOGADUNG, JAKARTA TIMUR, DKI JAKARTA",72,91,120,211
https://kawalpemilu.org#26076,"CIPINANG, PULOGADUNG, JAKARTA TIMUR, DKI JAKARTA",73,53,178,231
https://kawalpemilu.org#26076,"CIPINANG, PULOGADUNG, JAKARTA TIMUR, DKI JAKARTA",74,44,187,231
https://kawalpemilu.org#26076,"CIPINANG, PULOGADUNG, JAKARTA TIMUR, DKI JAKARTA",75,74,167,241
https://kawalpemilu.org#26076,"CIPINANG, PULOGADUNG, JAKARTA TIMUR, DKI JAKARTA",76,85,146,231
https://kawalpemilu.org#26076,"CIPINANG, PULOGADUNG, JAKARTA TIMUR, DKI JAKARTA",77,82,146,228
https://kawalpemilu.org#26076,"CIPINANG, PULOGADUNG, JAKARTA TIMUR, DKI JAKARTA",78,96,140,236
https://kawalpemilu.org#26076,"CIPINANG, PULOGADUNG, JAKARTA TIMUR, DKI JAKARTA",79,126,106,232
https://kawalpemilu.org#26076,"CIPINANG, PULOGADUNG, JAKARTA TIMUR, DKI JAKARTA",80,100,125,225
https://kawalpemilu.org#26076,"CIPINANG, PULOGADUNG, JAKARTA TIMUR, DKI JAKARTA",81,69,153,222
https://kawalpemilu.org#26076,"CIPINANG, PULOGADUNG, JAKARTA TIMUR, DKI JAKARTA",82,123,115,238
https://kawalpemilu.org#26076,"CIPINANG, PULOGADUNG, JAKARTA TIMUR, DKI JAKARTA",83,172,58,230
https://kawalpemilu.org#26076,"CIPINANG, PULOGADUNG, JAKARTA TIMUR, DKI JAKARTA",84,150,59,209
https://kawalpemilu.org#26076,"CIPINANG, PULOGADUNG, JAKARTA TIMUR, DKI JAKARTA",85,125,91,216
https://kawalpemilu.org#26076,"CIPINANG, PULOGADUNG, JAKARTA TIMUR, DKI JAKARTA",86,140,81,221
https://kawalpemilu.org#26076,"CIPINANG, PULOGADUNG, JAKARTA TIMUR, DKI JAKARTA",88,105,130,235
https://kawalpemilu.org#26076,"CIPINANG, PULOGADUNG, JAKARTA TIMUR, DKI JAKARTA",89,121,90,211
https://kawalpemilu.org#26076,"CIPINANG, PULOGADUNG, JAKARTA TIMUR, DKI JAKARTA",90,125,84,209
https://kawalpemilu.org#26076,"CIPINANG, PULOGADUNG, JAKARTA TIMUR, DKI JAKARTA",92,110,103,213
https://kawalpemilu.org#26076,"CIPINANG, PULOGADUNG, JAKARTA TIMUR, DKI JAKARTA",93,144,76,220
https://kawalpemilu.org#26076,"CIPINANG, PULOGADUNG, JAKARTA TIMUR, DKI JAKARTA",94,141,106,247
https://kawalpemilu.org#26076,"CIPINANG, PULOGADUNG, JAKARTA TIMUR, DKI JAKARTA",96,130,117,247
https://kawalpemilu.org#26076,"CIPINANG, PULOGADUNG, JAKARTA TIMUR, DKI JAKARTA",98,96,148,244
https://kawalpemilu.org#26076,"CIPINANG, PULOGADUNG, JAKARTA TIMUR, DKI JAKARTA",99,95,139,234
https://kawalpemilu.org#26076,"CIPINANG, PULOGADUNG, JAKARTA TIMUR, DKI JAKARTA",100,99,128,227
https://kawalpemilu.org#26076,"CIPINANG, PULOGADUNG, JAKARTA TIMUR, DKI JAKARTA",101,118,90,208
https://kawalpemilu.org#26076,"CIPINANG, PULOGADUNG, JAKARTA TIMUR, DKI JAKARTA",102,114,118,232
https://kawalpemilu.org#26076,"CIPINANG, PULOGADUNG, JAKARTA TIMUR, DKI JAKARTA",104,87,144,231
https://kawalpemilu.org#26076,"CIPINANG, PULOGADUNG, JAKARTA TIMUR, DKI JAKARTA",105,63,168,231
https://kawalpemilu.org#26076,"CIPINANG, PULOGADUNG, JAKARTA TIMUR, DKI JAKARTA",106,39,182,221
https://kawalpemilu.org#26076,"CIPINANG, PULOGADUNG, JAKARTA TIMUR, DKI JAKARTA",107,90,125,215
https://kawalpemilu.org#26076,"CIPINANG, PULOGADUNG, JAKARTA TIMUR, DKI JAKARTA",108,120,122,242
https://kawalpemilu.org#26076,"CIPINANG, PULOGADUNG, JAKARTA TIMUR, DKI JAKARTA",109,126,123,249
https://kawalpemilu.org#26076,"CIPINANG, PULOGADUNG, JAKARTA TIMUR, DKI JAKARTA",110,100,147,247
https://kawalpemilu.org#26076,"CIPINANG, PULOGADUNG, JAKARTA TIMUR, DKI JAKARTA",112,96,117,213
https://kawalpemilu.org#26076,"CIPINANG, PULOGADUNG, JAKARTA TIMUR, DKI JAKARTA",113,65,72,137
https://kawalpemilu.org#26076,"CIPINANG, PULOGADUNG, JAKARTA TIMUR, DKI JAKARTA",114,120,100,220
https://kawalpemilu.org#26076,"CIPINANG, PULOGADUNG, JAKARTA TIMUR, DKI JAKARTA",115,80,145,225
https://kawalpemilu.org#26076,"CIPINANG, PULOGADUNG, JAKARTA TIMUR, DKI JAKARTA",116,109,143,252
https://kawalpemilu.org#26076,"CIPINANG, PULOGADUNG, JAKARTA TIMUR, DKI JAKARTA",117,66,151,217
https://kawalpemilu.org#26076,"CIPINANG, PULOGADUNG, JAKARTA TIMUR, DKI JAKARTA",118,98,135,233
https://kawalpemilu.org#26076,"CIPINANG, PULOGADUNG, JAKARTA TIMUR, DKI JAKARTA",119,75,149,224
https://kawalpemilu.org#26076,"CIPINANG, PULOGADUNG, JAKARTA TIMUR, DKI JAKARTA",120,89,155,244
https://kawalpemilu.org#26076,"CIPINANG, PULOGADUNG, JAKARTA TIMUR, DKI JAKARTA",122,94,108,202
https://kawalpemilu.org#26076,"CIPINANG, PULOGADUNG, JAKARTA TIMUR, DKI JAKARTA",123,103,120,223
https://kawalpemilu.org#26077,"JATINEGARA KAUM, PULOGADUNG, JAKARTA TIMUR, DKI JAKARTA",1,75,158,233
https://kawalpemilu.org#26077,"JATINEGARA KAUM, PULOGADUNG, JAKARTA TIMUR, DKI JAKARTA",2,66,132,198
https://kawalpemilu.org#26077,"JATINEGARA KAUM, PULOGADUNG, JAKARTA TIMUR, DKI JAKARTA",3,94,100,194
https://kawalpemilu.org#26077,"JATINEGARA KAUM, PULOGADUNG, JAKARTA TIMUR, DKI JAKARTA",4,89,112,201
https://kawalpemilu.org#26077,"JATINEGARA KAUM, PULOGADUNG, JAKARTA TIMUR, DKI JAKARTA",5,111,98,209
https://kawalpemilu.org#26077,"JATINEGARA KAUM, PULOGADUNG, JAKARTA TIMUR, DKI JAKARTA",6,90,125,215
https://kawalpemilu.org#26077,"JATINEGARA KAUM, PULOGADUNG, JAKARTA TIMUR, DKI JAKARTA",7,79,116,195
https://kawalpemilu.org#26077,"JATINEGARA KAUM, PULOGADUNG, JAKARTA TIMUR, DKI JAKARTA",8,89,137,226
https://kawalpemilu.org#26077,"JATINEGARA KAUM, PULOGADUNG, JAKARTA TIMUR, DKI JAKARTA",9,91,144,235
https://kawalpemilu.org#26077,"JATINEGARA KAUM, PULOGADUNG, JAKARTA TIMUR, DKI JAKARTA",10,61,146,207
https://kawalpemilu.org#26077,"JATINEGARA KAUM, PULOGADUNG, JAKARTA TIMUR, DKI JAKARTA",11,114,99,213
https://kawalpemilu.org#26077,"JATINEGARA KAUM, PULOGADUNG, JAKARTA TIMUR, DKI JAKARTA",12,72,91,163
https://kawalpemilu.org#26077,"JATINEGARA KAUM, PULOGADUNG, JAKARTA TIMUR, DKI JAKARTA",13,83,144,227
https://kawalpemilu.org#26077,"JATINEGARA KAUM, PULOGADUNG, JAKARTA TIMUR, DKI JAKARTA",14,78,121,199
https://kawalpemilu.org#26077,"JATINEGARA KAUM, PULOGADUNG, JAKARTA TIMUR, DKI JAKARTA",15,118,161,279
https://kawalpemilu.org#26077,"JATINEGARA KAUM, PULOGADUNG, JAKARTA TIMUR, DKI JAKARTA",16,84,153,237
https://kawalpemilu.org#26077,"JATINEGARA KAUM, PULOGADUNG, JAKARTA TIMUR, DKI JAKARTA",17,60,141,201
https://kawalpemilu.org#26077,"JATINEGARA KAUM, PULOGADUNG, JAKARTA TIMUR, DKI JAKARTA",18,108,108,216
https://kawalpemilu.org#26077,"JATINEGARA KAUM, PULOGADUNG, JAKARTA TIMUR, DKI JAKARTA",19,74,126,200
https://kawalpemilu.org#26077,"JATINEGARA KAUM, PULOGADUNG, JAKARTA TIMUR, DKI JAKARTA",21,69,134,203
https://kawalpemilu.org#26077,"JATINEGARA KAUM, PULOGADUNG, JAKARTA TIMUR, DKI JAKARTA",22,65,161,226
https://kawalpemilu.org#26077,"JATINEGARA KAUM, PULOGADUNG, JAKARTA TIMUR, DKI JAKARTA",23,82,153,235
https://kawalpemilu.org#26077,"JATINEGARA KAUM, PULOGADUNG, JAKARTA TIMUR, DKI JAKARTA",24,86,117,203
https://kawalpemilu.org#26077,"JATINEGARA KAUM, PULOGADUNG, JAKARTA TIMUR, DKI JAKARTA",25,98,155,253
https://kawalpemilu.org#26077,"JATINEGARA KAUM, PULOGADUNG, JAKARTA TIMUR, DKI JAKARTA",26,87,140,227
https://kawalpemilu.org#26077,"JATINEGARA KAUM, PULOGADUNG, JAKARTA TIMUR, DKI JAKARTA",27,107,148,255
https://kawalpemilu.org#26077,"JATINEGARA KAUM, PULOGADUNG, JAKARTA TIMUR, DKI JAKARTA",28,93,99,192
https://kawalpemilu.org#26077,"JATINEGARA KAUM, PULOGADUNG, JAKARTA TIMUR, DKI JAKARTA",29,68,145,213
https://kawalpemilu.org#26077,"JATINEGARA KAUM, PULOGADUNG, JAKARTA TIMUR, DKI JAKARTA",30,77,160,237
https://kawalpemilu.org#26077,"JATINEGARA KAUM, PULOGADUNG, JAKARTA TIMUR, DKI JAKARTA",31,77,143,220
https://kawalpemilu.org#26077,"JATINEGARA KAUM, PULOGADUNG, JAKARTA TIMUR, DKI JAKARTA",32,70,110,180
https://kawalpemilu.org#26077,"JATINEGARA KAUM, PULOGADUNG, JAKARTA TIMUR, DKI JAKARTA",33,130,105,235
https://kawalpemilu.org#26077,"JATINEGARA KAUM, PULOGADUNG, JAKARTA TIMUR, DKI JAKARTA",34,104,96,200
https://kawalpemilu.org#26077,"JATINEGARA KAUM, PULOGADUNG, JAKARTA TIMUR, DKI JAKARTA",35,76,145,221
https://kawalpemilu.org#26077,"JATINEGARA KAUM, PULOGADUNG, JAKARTA TIMUR, DKI JAKARTA",36,82,126,208
https://kawalpemilu.org#26077,"JATINEGARA KAUM, PULOGADUNG, JAKARTA TIMUR, DKI JAKARTA",37,89,124,213
https://kawalpemilu.org#26077,"JATINEGARA KAUM, PULOGADUNG, JAKARTA TIMUR, DKI JAKARTA",38,95,111,206
https://kawalpemilu.org#26077,"JATINEGARA KAUM, PULOGADUNG, JAKARTA TIMUR, DKI JAKARTA",39,90,158,248
https://kawalpemilu.org#26077,"JATINEGARA KAUM, PULOGADUNG, JAKARTA TIMUR, DKI JAKARTA",40,69,127,196
https://kawalpemilu.org#26077,"JATINEGARA KAUM, PULOGADUNG, JAKARTA TIMUR, DKI JAKARTA",42,94,149,243
https://kawalpemilu.org#26077,"JATINEGARA KAUM, PULOGADUNG, JAKARTA TIMUR, DKI JAKARTA",43,86,116,202
https://kawalpemilu.org#26077,"JATINEGARA KAUM, PULOGADUNG, JAKARTA TIMUR, DKI JAKARTA",44,100,145,245
https://kawalpemilu.org#26077,"JATINEGARA KAUM, PULOGADUNG, JAKARTA TIMUR, DKI JAKARTA",45,76,107,183
https://kawalpemilu.org#26077,"JATINEGARA KAUM, PULOGADUNG, JAKARTA TIMUR, DKI JAKARTA",46,122,98,220
https://kawalpemilu.org#26077,"JATINEGARA KAUM, PULOGADUNG, JAKARTA TIMUR, DKI JAKARTA",47,80,125,205
https://kawalpemilu.org#26077,"JATINEGARA KAUM, PULOGADUNG, JAKARTA TIMUR, DKI JAKARTA",49,92,104,196
https://kawalpemilu.org#26077,"JATINEGARA KAUM, PULOGADUNG, JAKARTA TIMUR, DKI JAKARTA",50,92,139,231
https://kawalpemilu.org#26077,"JATINEGARA KAUM, PULOGADUNG, JAKARTA TIMUR, DKI JAKARTA",51,93,133,226
https://kawalpemilu.org#26077,"JATINEGARA KAUM, PULOGADUNG, JAKARTA TIMUR, DKI JAKARTA",52,102,136,238
https://kawalpemilu.org#26077,"JATINEGARA KAUM, PULOGADUNG, JAKARTA TIMUR, DKI JAKARTA",53,99,139,238
https://kawalpemilu.org#26077,"JATINEGARA KAUM, PULOGADUNG, JAKARTA TIMUR, DKI JAKARTA",54,71,168,239
https://kawalpemilu.org#26077,"JATINEGARA KAUM, PULOGADUNG, JAKARTA TIMUR, DKI JAKARTA",55,95,129,224
https://kawalpemilu.org#26077,"JATINEGARA KAUM, PULOGADUNG, JAKARTA TIMUR, DKI JAKARTA",56,110,128,238
https://kawalpemilu.org#26077,"JATINEGARA KAUM, PULOGADUNG, JAKARTA TIMUR, DKI JAKARTA",57,94,138,232
https://kawalpemilu.org#26077,"JATINEGARA KAUM, PULOGADUNG, JAKARTA TIMUR, DKI JAKARTA",58,112,119,231
https://kawalpemilu.org#26077,"JATINEGARA KAUM, PULOGADUNG, JAKARTA TIMUR, DKI JAKARTA",59,71,158,229
https://kawalpemilu.org#26077,"JATINEGARA KAUM, PULOGADUNG, JAKARTA TIMUR, DKI JAKARTA",60,96,136,232
https://kawalpemilu.org#26077,"JATINEGARA KAUM, PULOGADUNG, JAKARTA TIMUR, DKI JAKARTA",61,93,138,232
https://kawalpemilu.org#26077,"JATINEGARA KAUM, PULOGADUNG, JAKARTA TIMUR, DKI JAKARTA",62,81,113,194
https://kawalpemilu.org#26077,"JATINEGARA KAUM, PULOGADUNG, JAKARTA TIMUR, DKI JAKARTA",63,99,109,208
https://kawalpemilu.org#26077,"JATINEGARA KAUM, PULOGADUNG, JAKARTA TIMUR, DKI JAKARTA",64,100,95,195
https://kawalpemilu.org#26077,"JATINEGARA KAUM, PULOGADUNG, JAKARTA TIMUR, DKI JAKARTA",65,141,107,248
https://kawalpemilu.org#26077,"JATINEGARA KAUM, PULOGADUNG, JAKARTA TIMUR, DKI JAKARTA",66,143,71,214
https://kawalpemilu.org#26077,"JATINEGARA KAUM, PULOGADUNG, JAKARTA TIMUR, DKI JAKARTA",67,165,71,236
https://kawalpemilu.org#26077,"JATINEGARA KAUM, PULOGADUNG, JAKARTA TIMUR, DKI JAKARTA",68,61,188,249
https://kawalpemilu.org#26077,"JATINEGARA KAUM, PULOGADUNG, JAKARTA TIMUR, DKI JAKARTA",69,110,118,228
https://kawalpemilu.org#26077,"JATINEGARA KAUM, PULOGADUNG, JAKARTA TIMUR, DKI JAKARTA",70,78,129,207
https://kawalpemilu.org#26077,"JATINEGARA KAUM, PULOGADUNG, JAKARTA TIMUR, DKI JAKARTA",71,83,113,196
https://kawalpemilu.org#26077,"JATINEGARA KAUM, PULOGADUNG, JAKARTA TIMUR, DKI JAKARTA",72,128,91,219
https://kawalpemilu.org#26077,"JATINEGARA KAUM, PULOGADUNG, JAKARTA TIMUR, DKI JAKARTA",73,78,151,229
https://kawalpemilu.org#26077,"JATINEGARA KAUM, PULOGADUNG, JAKARTA TIMUR, DKI JAKARTA",74,94,128,222
https://kawalpemilu.org#26077,"JATINEGARA KAUM, PULOGADUNG, JAKARTA TIMUR, DKI JAKARTA",75,80,146,226
https://kawalpemilu.org#26077,"JATINEGARA KAUM, PULOGADUNG, JAKARTA TIMUR, DKI JAKARTA",76,106,106,212
https://kawalpemilu.org#26077,"JATINEGARA KAUM, PULOGADUNG, JAKARTA TIMUR, DKI JAKARTA",77,121,114,235
https://kawalpemilu.org#26077,"JATINEGARA KAUM, PULOGADUNG, JAKARTA TIMUR, DKI JAKARTA",78,0,0,0
https://kawalpemilu.org#26077,"JATINEGARA KAUM, PULOGADUNG, JAKARTA TIMUR, DKI JAKARTA",79,85,118,203
https://kawalpemilu.org#26078,"RAWAMANGUN, PULOGADUNG, JAKARTA TIMUR, DKI JAKARTA",1,109,102,211
https://kawalpemilu.org#26078,"RAWAMANGUN, PULOGADUNG, JAKARTA TIMUR, DKI JAKARTA",2,138,83,221
https://kawalpemilu.org#26078,"RAWAMANGUN, PULOGADUNG, JAKARTA TIMUR, DKI JAKARTA",3,136,89,225
https://kawalpemilu.org#26078,"RAWAMANGUN, PULOGADUNG, JAKARTA TIMUR, DKI JAKARTA",4,93,131,224
https://kawalpemilu.org#26078,"RAWAMANGUN, PULOGADUNG, JAKARTA TIMUR, DKI JAKARTA",5,111,119,230
https://kawalpemilu.org#26078,"RAWAMANGUN, PULOGADUNG, JAKARTA TIMUR, DKI JAKARTA",6,99,114,213
https://kawalpemilu.org#26078,"RAWAMANGUN, PULOGADUNG, JAKARTA TIMUR, DKI JAKARTA",7,97,75,172
https://kawalpemilu.org#26078,"RAWAMANGUN, PULOGADUNG, JAKARTA TIMUR, DKI JAKARTA",8,103,69,172
https://kawalpemilu.org#26078,"RAWAMANGUN, PULOGADUNG, JAKARTA TIMUR, DKI JAKARTA",9,112,138,250
https://kawalpemilu.org#26078,"RAWAMANGUN, PULOGADUNG, JAKARTA TIMUR, DKI JAKARTA",10,98,115,213
https://kawalpemilu.org#26078,"RAWAMANGUN, PULOGADUNG, JAKARTA TIMUR, DKI JAKARTA",11,121,82,203
https://kawalpemilu.org#26078,"RAWAMANGUN, PULOGADUNG, JAKARTA TIMUR, DKI JAKARTA",13,117,69,186
https://kawalpemilu.org#26078,"RAWAMANGUN, PULOGADUNG, JAKARTA TIMUR, DKI JAKARTA",14,118,93,211
https://kawalpemilu.org#26078,"RAWAMANGUN, PULOGADUNG, JAKARTA TIMUR, DKI JAKARTA",15,91,165,256
https://kawalpemilu.org#26078,"RAWAMANGUN, PULOGADUNG, JAKARTA TIMUR, DKI JAKARTA",16,131,126,257
https://kawalpemilu.org#26078,"RAWAMANGUN, PULOGADUNG, JAKARTA TIMUR, DKI JAKARTA",17,107,126,233
https://kawalpemilu.org#26078,"RAWAMANGUN, PULOGADUNG, JAKARTA TIMUR, DKI JAKARTA",18,114,126,240
https://kawalpemilu.org#26078,"RAWAMANGUN, PULOGADUNG, JAKARTA TIMUR, DKI JAKARTA",19,128,111,239
https://kawalpemilu.org#26078,"RAWAMANGUN, PULOGADUNG, JAKARTA TIMUR, DKI JAKARTA",20,92,134,226
https://kawalpemilu.org#26078,"RAWAMANGUN, PULOGADUNG, JAKARTA TIMUR, DKI JAKARTA",21,62,119,181
https://kawalpemilu.org#26078,"RAWAMANGUN, PULOGADUNG, JAKARTA TIMUR, DKI JAKARTA",22,34,102,136
https://kawalpemilu.org#26078,"RAWAMANGUN, PULOGADUNG, JAKARTA TIMUR, DKI JAKARTA",23,138,98,236
https://kawalpemilu.org#26078,"RAWAMANGUN, PULOGADUNG, JAKARTA TIMUR, DKI JAKARTA",24,104,138,242
https://kawalpemilu.org#26078,"RAWAMANGUN, PULOGADUNG, JAKARTA TIMUR, DKI JAKARTA",25,92,144,236
https://kawalpemilu.org#26078,"RAWAMANGUN, PULOGADUNG, JAKARTA TIMUR, DKI JAKARTA",26,89,169,258
https://kawalpemilu.org#26078,"RAWAMANGUN, PULOGADUNG, JAKARTA TIMUR, DKI JAKARTA",27,50,196,246
https://kawalpemilu.org#26078,"RAWAMANGUN, PULOGADUNG, JAKARTA TIMUR, DKI JAKARTA",29,82,140,222
https://kawalpemilu.org#26078,"RAWAMANGUN, PULOGADUNG, JAKARTA TIMUR, DKI JAKARTA",30,72,176,248
https://kawalpemilu.org#26078,"RAWAMANGUN, PULOGADUNG, JAKARTA TIMUR, DKI JAKARTA",31,51,207,258
https://kawalpemilu.org#26078,"RAWAMANGUN, PULOGADUNG, JAKARTA TIMUR, DKI JAKARTA",32,104,146,250
https://kawalpemilu.org#26078,"RAWAMANGUN, PULOGADUNG, JAKARTA TIMUR, DKI JAKARTA",33,102,140,242
https://kawalpemilu.org#26078,"RAWAMANGUN, PULOGADUNG, JAKARTA TIMUR, DKI JAKARTA",34,79,162,241
https://kawalpemilu.org#26078,"RAWAMANGUN, PULOGADUNG, JAKARTA TIMUR, DKI JAKARTA",35,79,139,218
https://kawalpemilu.org#26078,"RAWAMANGUN, PULOGADUNG, JAKARTA TIMUR, DKI JAKARTA",36,90,177,267
https://kawalpemilu.org#26078,"RAWAMANGUN, PULOGADUNG, JAKARTA TIMUR, DKI JAKARTA",37,75,159,234
https://kawalpemilu.org#26078,"RAWAMANGUN, PULOGADUNG, JAKARTA TIMUR, DKI JAKARTA",38,55,176,231
https://kawalpemilu.org#26078,"RAWAMANGUN, PULOGADUNG, JAKARTA TIMUR, DKI JAKARTA",39,90,128,218
https://kawalpemilu.org#26078,"RAWAMANGUN, PULOGADUNG, JAKARTA TIMUR, DKI JAKARTA",41,117,94,211
https://kawalpemilu.org#26078,"RAWAMANGUN, PULOGADUNG, JAKARTA TIMUR, DKI JAKARTA",42,97,107,204
https://kawalpemilu.org#26078,"RAWAMANGUN, PULOGADUNG, JAKARTA TIMUR, DKI JAKARTA",43,103,132,235
https://kawalpemilu.org#26078,"RAWAMANGUN, PULOGADUNG, JAKARTA TIMUR, DKI JAKARTA",44,94,146,240
https://kawalpemilu.org#26078,"RAWAMANGUN, PULOGADUNG, JAKARTA TIMUR, DKI JAKARTA",45,89,114,203
https://kawalpemilu.org#26078,"RAWAMANGUN, PULOGADUNG, JAKARTA TIMUR, DKI JAKARTA",46,114,110,224
https://kawalpemilu.org#26078,"RAWAMANGUN, PULOGADUNG, JAKARTA TIMUR, DKI JAKARTA",47,127,97,224
https://kawalpemilu.org#26078,"RAWAMANGUN, PULOGADUNG, JAKARTA TIMUR, DKI JAKARTA",48,120,82,202
https://kawalpemilu.org#26078,"RAWAMANGUN, PULOGADUNG, JAKARTA TIMUR, DKI JAKARTA",49,142,82,224
https://kawalpemilu.org#26078,"RAWAMANGUN, PULOGADUNG, JAKARTA TIMUR, DKI JAKARTA",50,125,95,220
https://kawalpemilu.org#26078,"RAWAMANGUN, PULOGADUNG, JAKARTA TIMUR, DKI JAKARTA",51,129,76,205
https://kawalpemilu.org#26078,"RAWAMANGUN, PULOGADUNG, JAKARTA TIMUR, DKI JAKARTA",52,64,147,211
https://kawalpemilu.org#26078,"RAWAMANGUN, PULOGADUNG, JAKARTA TIMUR, DKI JAKARTA",54,91,113,204
https://kawalpemilu.org#26078,"RAWAMANGUN, PULOGADUNG, JAKARTA TIMUR, DKI JAKARTA",55,103,129,232
https://kawalpemilu.org#26078,"RAWAMANGUN, PULOGADUNG, JAKARTA TIMUR, DKI JAKARTA",56,120,108,228
https://kawalpemilu.org#26078,"RAWAMANGUN, PULOGADUNG, JAKARTA TIMUR, DKI JAKARTA",57,123,99,222
https://kawalpemilu.org#26078,"RAWAMANGUN, PULOGADUNG, JAKARTA TIMUR, DKI JAKARTA",58,122,86,208
https://kawalpemilu.org#26078,"RAWAMANGUN, PULOGADUNG, JAKARTA TIMUR, DKI JAKARTA",59,119,98,217
https://kawalpemilu.org#26078,"RAWAMANGUN, PULOGADUNG, JAKARTA TIMUR, DKI JAKARTA",60,98,134,232
https://kawalpemilu.org#26078,"RAWAMANGUN, PULOGADUNG, JAKARTA TIMUR, DKI JAKARTA",61,131,86,217
https://kawalpemilu.org#26078,"RAWAMANGUN, PULOGADUNG, JAKARTA TIMUR, DKI JAKARTA",62,115,91,206
https://kawalpemilu.org#26078,"RAWAMANGUN, PULOGADUNG, JAKARTA TIMUR, DKI JAKARTA",63,74,140,214
https://kawalpemilu.org#26078,"RAWAMANGUN, PULOGADUNG, JAKARTA TIMUR, DKI JAKARTA",64,83,129,212
https://kawalpemilu.org#26078,"RAWAMANGUN, PULOGADUNG, JAKARTA TIMUR, DKI JAKARTA",65,71,138,209
https://kawalpemilu.org#26078,"RAWAMANGUN, PULOGADUNG, JAKARTA TIMUR, DKI JAKARTA",66,81,106,187
https://kawalpemilu.org#26078,"RAWAMANGUN, PULOGADUNG, JAKARTA TIMUR, DKI JAKARTA",67,104,124,228
https://kawalpemilu.org#26078,"RAWAMANGUN, PULOGADUNG, JAKARTA TIMUR, DKI JAKARTA",68,93,109,202
https://kawalpemilu.org#26078,"RAWAMANGUN, PULOGADUNG, JAKARTA TIMUR, DKI JAKARTA",69,122,98,220
https://kawalpemilu.org#26078,"RAWAMANGUN, PULOGADUNG, JAKARTA TIMUR, DKI JAKARTA",70,101,128,229
https://kawalpemilu.org#26078,"RAWAMANGUN, PULOGADUNG, JAKARTA TIMUR, DKI JAKARTA",71,82,126,208
https://kawalpemilu.org#26078,"RAWAMANGUN, PULOGADUNG, JAKARTA TIMUR, DKI JAKARTA",72,104,100,204
https://kawalpemilu.org#26078,"RAWAMANGUN, PULOGADUNG, JAKARTA TIMUR, DKI JAKARTA",73,136,102,238
https://kawalpemilu.org#26078,"RAWAMANGUN, PULOGADUNG, JAKARTA TIMUR, DKI JAKARTA",74,138,77,215
https://kawalpemilu.org#26078,"RAWAMANGUN, PULOGADUNG, JAKARTA TIMUR, DKI JAKARTA",75,149,107,256
https://kawalpemilu.org#26078,"RAWAMANGUN, PULOGADUNG, JAKARTA TIMUR, DKI JAKARTA",76,134,108,242
https://kawalpemilu.org#26078,"RAWAMANGUN, PULOGADUNG, JAKARTA TIMUR, DKI JAKARTA",77,126,116,242
https://kawalpemilu.org#26078,"RAWAMANGUN, PULOGADUNG, JAKARTA TIMUR, DKI JAKARTA",78,107,124,231
https://kawalpemilu.org#26078,"RAWAMANGUN, PULOGADUNG, JAKARTA TIMUR, DKI JAKARTA",79,96,151,247
https://kawalpemilu.org#26078,"RAWAMANGUN, PULOGADUNG, JAKARTA TIMUR, DKI JAKARTA",80,117,102,219
https://kawalpemilu.org#26078,"RAWAMANGUN, PULOGADUNG, JAKARTA TIMUR, DKI JAKARTA",81,156,91,247
https://kawalpemilu.org#26078,"RAWAMANGUN, PULOGADUNG, JAKARTA TIMUR, DKI JAKARTA",82,123,102,225
https://kawalpemilu.org#26078,"RAWAMANGUN, PULOGADUNG, JAKARTA TIMUR, DKI JAKARTA",83,97,129,226
https://kawalpemilu.org#26078,"RAWAMANGUN, PULOGADUNG, JAKARTA TIMUR, DKI JAKARTA",84,119,99,218
https://kawalpemilu.org#26078,"RAWAMANGUN, PULOGADUNG, JAKARTA TIMUR, DKI JAKARTA",85,118,83,201
https://kawalpemilu.org#26078,"RAWAMANGUN, PULOGADUNG, JAKARTA TIMUR, DKI JAKARTA",86,123,103,226
https://kawalpemilu.org#26078,"RAWAMANGUN, PULOGADUNG, JAKARTA TIMUR, DKI JAKARTA",87,104,125,229
https://kawalpemilu.org#26078,"RAWAMANGUN, PULOGADUNG, JAKARTA TIMUR, DKI JAKARTA",88,158,90,248
https://kawalpemilu.org#26078,"RAWAMANGUN, PULOGADUNG, JAKARTA TIMUR, DKI JAKARTA",89,110,100,210
https://kawalpemilu.org#26078,"RAWAMANGUN, PULOGADUNG, JAKARTA TIMUR, DKI JAKARTA",90,107,120,227
https://kawalpemilu.org#26078,"RAWAMANGUN, PULOGADUNG, JAKARTA TIMUR, DKI JAKARTA",92,120,109,229
https://kawalpemilu.org#26078,"RAWAMANGUN, PULOGADUNG, JAKARTA TIMUR, DKI JAKARTA",93,146,99,245
https://kawalpemilu.org#26078,"RAWAMANGUN, PULOGADUNG, JAKARTA TIMUR, DKI JAKARTA",94,136,89,225
https://kawalpemilu.org#26078,"RAWAMANGUN, PULOGADUNG, JAKARTA TIMUR, DKI JAKARTA",95,146,97,243
https://kawalpemilu.org#26078,"RAWAMANGUN, PULOGADUNG, JAKARTA TIMUR, DKI JAKARTA",96,129,104,233
https://kawalpemilu.org#26078,"RAWAMANGUN, PULOGADUNG, JAKARTA TIMUR, DKI JAKARTA",97,117,110,227
https://kawalpemilu.org#26078,"RAWAMANGUN, PULOGADUNG, JAKARTA TIMUR, DKI JAKARTA",98,116,133,249
https://kawalpemilu.org#26078,"RAWAMANGUN, PULOGADUNG, JAKARTA TIMUR, DKI JAKARTA",99,127,122,249
https://kawalpemilu.org#26078,"RAWAMANGUN, PULOGADUNG, JAKARTA TIMUR, DKI JAKARTA",100,123,118,241
https://kawalpemilu.org#26078,"RAWAMANGUN, PULOGADUNG, JAKARTA TIMUR, DKI JAKARTA",101,84,139,223
https://kawalpemilu.org#26078,"RAWAMANGUN, PULOGADUNG, JAKARTA TIMUR, DKI JAKARTA",102,100,143,243
https://kawalpemilu.org#26078,"RAWAMANGUN, PULOGADUNG, JAKARTA TIMUR, DKI JAKARTA",103,91,149,240
https://kawalpemilu.org#26078,"RAWAMANGUN, PULOGADUNG, JAKARTA TIMUR, DKI JAKARTA",104,110,137,247
https://kawalpemilu.org#26078,"RAWAMANGUN, PULOGADUNG, JAKARTA TIMUR, DKI JAKARTA",105,107,122,229
https://kawalpemilu.org#26078,"RAWAMANGUN, PULOGADUNG, JAKARTA TIMUR, DKI JAKARTA",106,98,133,231
https://kawalpemilu.org#26078,"RAWAMANGUN, PULOGADUNG, JAKARTA TIMUR, DKI JAKARTA",107,106,135,241
https://kawalpemilu.org#26078,"RAWAMANGUN, PULOGADUNG, JAKARTA TIMUR, DKI JAKARTA",108,102,153,255
https://kawalpemilu.org#26078,"RAWAMANGUN, PULOGADUNG, JAKARTA TIMUR, DKI JAKARTA",110,94,145,239
https://kawalpemilu.org#26078,"RAWAMANGUN, PULOGADUNG, JAKARTA TIMUR, DKI JAKARTA",111,93,127,220
https://kawalpemilu.org#26078,"RAWAMANGUN, PULOGADUNG, JAKARTA TIMUR, DKI JAKARTA",112,99,125,224
https://kawalpemilu.org#26078,"RAWAMANGUN, PULOGADUNG, JAKARTA TIMUR, DKI JAKARTA",113,112,95,207
https://kawalpemilu.org#26078,"RAWAMANGUN, PULOGADUNG, JAKARTA TIMUR, DKI JAKARTA",114,167,84,251
https://kawalpemilu.org#26078,"RAWAMANGUN, PULOGADUNG, JAKARTA TIMUR, DKI JAKARTA",115,129,52,181
https://kawalpemilu.org#26078,"RAWAMANGUN, PULOGADUNG, JAKARTA TIMUR, DKI JAKARTA",116,72,90,162
https://kawalpemilu.org#26078,"RAWAMANGUN, PULOGADUNG, JAKARTA TIMUR, DKI JAKARTA",117,145,80,225
https://kawalpemilu.org#26078,"RAWAMANGUN, PULOGADUNG, JAKARTA TIMUR, DKI JAKARTA",118,124,112,236
https://kawalpemilu.org#26078,"RAWAMANGUN, PULOGADUNG, JAKARTA TIMUR, DKI JAKARTA",119,81,154,235
https://kawalpemilu.org#26078,"RAWAMANGUN, PULOGADUNG, JAKARTA TIMUR, DKI JAKARTA",120,111,118,229
https://kawalpemilu.org#26078,"RAWAMANGUN, PULOGADUNG, JAKARTA TIMUR, DKI JAKARTA",121,120,62,182
https://kawalpemilu.org#26078,"RAWAMANGUN, PULOGADUNG, JAKARTA TIMUR, DKI JAKARTA",122,54,85,139
https://kawalpemilu.org#26078,"RAWAMANGUN, PULOGADUNG, JAKARTA TIMUR, DKI JAKARTA",123,51,41,92
https://kawalpemilu.org#26078,"RAWAMANGUN, PULOGADUNG, JAKARTA TIMUR, DKI JAKARTA",124,102,94,196
https://kawalpemilu.org#26078,"RAWAMANGUN, PULOGADUNG, JAKARTA TIMUR, DKI JAKARTA",125,85,55,140
https://kawalpemilu.org#26078,"RAWAMANGUN, PULOGADUNG, JAKARTA TIMUR, DKI JAKARTA",126,101,67,168
https://kawalpemilu.org#26079,"KAYU PUTIH, PULOGADUNG, JAKARTA TIMUR, DKI JAKARTA",1,185,46,231
https://kawalpemilu.org#26079,"KAYU PUTIH, PULOGADUNG, JAKARTA TIMUR, DKI JAKARTA",2,130,85,215
https://kawalpemilu.org#26079,"KAYU PUTIH, PULOGADUNG, JAKARTA TIMUR, DKI JAKARTA",3,101,27,128
https://kawalpemilu.org#26079,"KAYU PUTIH, PULOGADUNG, JAKARTA TIMUR, DKI JAKARTA",4,142,118,260
https://kawalpemilu.org#26079,"KAYU PUTIH, PULOGADUNG, JAKARTA TIMUR, DKI JAKARTA",5,129,127,256
https://kawalpemilu.org#26079,"KAYU PUTIH, PULOGADUNG, JAKARTA TIMUR, DKI JAKARTA",6,109,114,223
https://kawalpemilu.org#26079,"KAYU PUTIH, PULOGADUNG, JAKARTA TIMUR, DKI JAKARTA",7,167,72,239
https://kawalpemilu.org#26079,"KAYU PUTIH, PULOGADUNG, JAKARTA TIMUR, DKI JAKARTA",8,150,94,244
https://kawalpemilu.org#26079,"KAYU PUTIH, PULOGADUNG, JAKARTA TIMUR, DKI JAKARTA",9,141,89,230
https://kawalpemilu.org#26079,"KAYU PUTIH, PULOGADUNG, JAKARTA TIMUR, DKI JAKARTA",10,109,62,171
https://kawalpemilu.org#26079,"KAYU PUTIH, PULOGADUNG, JAKARTA TIMUR, DKI JAKARTA",11,105,126,231
https://kawalpemilu.org#26079,"KAYU PUTIH, PULOGADUNG, JAKARTA TIMUR, DKI JAKARTA",12,126,113,239
https://kawalpemilu.org#26079,"KAYU PUTIH, PULOGADUNG, JAKARTA TIMUR, DKI JAKARTA",13,129,126,255
https://kawalpemilu.org#26079,"KAYU PUTIH, PULOGADUNG, JAKARTA TIMUR, DKI JAKARTA",14,101,156,257
https://kawalpemilu.org#26079,"KAYU PUTIH, PULOGADUNG, JAKARTA TIMUR, DKI JAKARTA",15,105,140,245
https://kawalpemilu.org#26079,"KAYU PUTIH, PULOGADUNG, JAKARTA TIMUR, DKI JAKARTA",16,68,161,229
https://kawalpemilu.org#26079,"KAYU PUTIH, PULOGADUNG, JAKARTA TIMUR, DKI JAKARTA",17,126,106,232
https://kawalpemilu.org#26079,"KAYU PUTIH, PULOGADUNG, JAKARTA TIMUR, DKI JAKARTA",18,114,132,246
https://kawalpemilu.org#26079,"KAYU PUTIH, PULOGADUNG, JAKARTA TIMUR, DKI JAKARTA",19,129,110,239
https://kawalpemilu.org#26079,"KAYU PUTIH, PULOGADUNG, JAKARTA TIMUR, DKI JAKARTA",20,146,89,235
https://kawalpemilu.org#26079,"KAYU PUTIH, PULOGADUNG, JAKARTA TIMUR, DKI JAKARTA",22,140,110,250
https://kawalpemilu.org#26079,"KAYU PUTIH, PULOGADUNG, JAKARTA TIMUR, DKI JAKARTA",23,137,116,253
https://kawalpemilu.org#26079,"KAYU PUTIH, PULOGADUNG, JAKARTA TIMUR, DKI JAKARTA",24,124,129,253
https://kawalpemilu.org#26079,"KAYU PUTIH, PULOGADUNG, JAKARTA TIMUR, DKI JAKARTA",25,156,82,238
https://kawalpemilu.org#26079,"KAYU PUTIH, PULOGADUNG, JAKARTA TIMUR, DKI JAKARTA",26,166,78,244
https://kawalpemilu.org#26079,"KAYU PUTIH, PULOGADUNG, JAKARTA TIMUR, DKI JAKARTA",27,85,154,239
https://kawalpemilu.org#26079,"KAYU PUTIH, PULOGADUNG, JAKARTA TIMUR, DKI JAKARTA",28,142,88,230
https://kawalpemilu.org#26079,"KAYU PUTIH, PULOGADUNG, JAKARTA TIMUR, DKI JAKARTA",29,108,129,237
https://kawalpemilu.org#26079,"KAYU PUTIH, PULOGADUNG, JAKARTA TIMUR, DKI JAKARTA",30,120,118,238
https://kawalpemilu.org#26079,"KAYU PUTIH, PULOGADUNG, JAKARTA TIMUR, DKI JAKARTA",31,109,129,238
https://kawalpemilu.org#26079,"KAYU PUTIH, PULOGADUNG, JAKARTA TIMUR, DKI JAKARTA",32,86,168,254
https://kawalpemilu.org#26079,"KAYU PUTIH, PULOGADUNG, JAKARTA TIMUR, DKI JAKARTA",33,103,132,235
https://kawalpemilu.org#26079,"KAYU PUTIH, PULOGADUNG, JAKARTA TIMUR, DKI JAKARTA",34,113,131,244
https://kawalpemilu.org#26079,"KAYU PUTIH, PULOGADUNG, JAKARTA TIMUR, DKI JAKARTA",35,108,138,246
https://kawalpemilu.org#26079,"KAYU PUTIH, PULOGADUNG, JAKARTA TIMUR, DKI JAKARTA",36,138,96,234
https://kawalpemilu.org#26079,"KAYU PUTIH, PULOGADUNG, JAKARTA TIMUR, DKI JAKARTA",37,114,111,225
https://kawalpemilu.org#26079,"KAYU PUTIH, PULOGADUNG, JAKARTA TIMUR, DKI JAKARTA",38,190,54,244
https://kawalpemilu.org#26079,"KAYU PUTIH, PULOGADUNG, JAKARTA TIMUR, DKI JAKARTA",39,157,99,256
https://kawalpemilu.org#26079,"KAYU PUTIH, PULOGADUNG, JAKARTA TIMUR, DKI JAKARTA",40,134,108,242
https://kawalpemilu.org#26079,"KAYU PUTIH, PULOGADUNG, JAKARTA TIMUR, DKI JAKARTA",41,106,109,215
https://kawalpemilu.org#26079,"KAYU PUTIH, PULOGADUNG, JAKARTA TIMUR, DKI JAKARTA",42,94,128,222
https://kawalpemilu.org#26079,"KAYU PUTIH, PULOGADUNG, JAKARTA TIMUR, DKI JAKARTA",43,115,106,221
https://kawalpemilu.org#26079,"KAYU PUTIH, PULOGADUNG, JAKARTA TIMUR, DKI JAKARTA",44,138,93,231
https://kawalpemilu.org#26079,"KAYU PUTIH, PULOGADUNG, JAKARTA TIMUR, DKI JAKARTA",45,105,122,227
https://kawalpemilu.org#26079,"KAYU PUTIH, PULOGADUNG, JAKARTA TIMUR, DKI JAKARTA",46,92,135,227
https://kawalpemilu.org#26079,"KAYU PUTIH, PULOGADUNG, JAKARTA TIMUR, DKI JAKARTA",47,109,97,206
https://kawalpemilu.org#26079,"KAYU PUTIH, PULOGADUNG, JAKARTA TIMUR, DKI JAKARTA",48,112,105,217
https://kawalpemilu.org#26079,"KAYU PUTIH, PULOGADUNG, JAKARTA TIMUR, DKI JAKARTA",49,144,85,229
https://kawalpemilu.org#26079,"KAYU PUTIH, PULOGADUNG, JAKARTA TIMUR, DKI JAKARTA",50,133,103,236
https://kawalpemilu.org#26079,"KAYU PUTIH, PULOGADUNG, JAKARTA TIMUR, DKI JAKARTA",51,116,110,226
https://kawalpemilu.org#26079,"KAYU PUTIH, PULOGADUNG, JAKARTA TIMUR, DKI JAKARTA",52,141,93,234
https://kawalpemilu.org#26079,"KAYU PUTIH, PULOGADUNG, JAKARTA TIMUR, DKI JAKARTA",53,202,42,244
https://kawalpemilu.org#26079,"KAYU PUTIH, PULOGADUNG, JAKARTA TIMUR, DKI JAKARTA",54,165,53,218
https://kawalpemilu.org#26079,"KAYU PUTIH, PULOGADUNG, JAKARTA TIMUR, DKI JAKARTA",55,203,23,226
https://kawalpemilu.org#26079,"KAYU PUTIH, PULOGADUNG, JAKARTA TIMUR, DKI JAKARTA",56,166,70,236
https://kawalpemilu.org#26079,"KAYU PUTIH, PULOGADUNG, JAKARTA TIMUR, DKI JAKARTA",57,106,69,175
https://kawalpemilu.org#26079,"KAYU PUTIH, PULOGADUNG, JAKARTA TIMUR, DKI JAKARTA",58,149,60,209
https://kawalpemilu.org#26079,"KAYU PUTIH, PULOGADUNG, JAKARTA TIMUR, DKI JAKARTA",59,180,18,198
https://kawalpemilu.org#26079,"KAYU PUTIH, PULOGADUNG, JAKARTA TIMUR, DKI JAKARTA",60,232,37,269
https://kawalpemilu.org#26079,"KAYU PUTIH, PULOGADUNG, JAKARTA TIMUR, DKI JAKARTA",61,164,84,248
https://kawalpemilu.org#26079,"KAYU PUTIH, PULOGADUNG, JAKARTA TIMUR, DKI JAKARTA",63,170,81,251
https://kawalpemilu.org#26079,"KAYU PUTIH, PULOGADUNG, JAKARTA TIMUR, DKI JAKARTA",64,274,10,284
https://kawalpemilu.org#26079,"KAYU PUTIH, PULOGADUNG, JAKARTA TIMUR, DKI JAKARTA",65,249,17,266
https://kawalpemilu.org#26079,"KAYU PUTIH, PULOGADUNG, JAKARTA TIMUR, DKI JAKARTA",66,224,11,235
https://kawalpemilu.org#26079,"KAYU PUTIH, PULOGADUNG, JAKARTA TIMUR, DKI JAKARTA",67,163,82,245
https://kawalpemilu.org#26079,"KAYU PUTIH, PULOGADUNG, JAKARTA TIMUR, DKI JAKARTA",68,172,95,267
https://kawalpemilu.org#26079,"KAYU PUTIH, PULOGADUNG, JAKARTA TIMUR, DKI JAKARTA",69,209,62,271
https://kawalpemilu.org#26079,"KAYU PUTIH, PULOGADUNG, JAKARTA TIMUR, DKI JAKARTA",72,220,39,259
https://kawalpemilu.org#26079,"KAYU PUTIH, PULOGADUNG, JAKARTA TIMUR, DKI JAKARTA",73,219,32,251
https://kawalpemilu.org#26079,"KAYU PUTIH, PULOGADUNG, JAKARTA TIMUR, DKI JAKARTA",74,226,46,272
https://kawalpemilu.org#26079,"KAYU PUTIH, PULOGADUNG, JAKARTA TIMUR, DKI JAKARTA",75,173,67,240
https://kawalpemilu.org#26079,"KAYU PUTIH, PULOGADUNG, JAKARTA TIMUR, DKI JAKARTA",76,158,54,212
https://kawalpemilu.org#26079,"KAYU PUTIH, PULOGADUNG, JAKARTA TIMUR, DKI JAKARTA",77,152,88,240
https://kawalpemilu.org#26079,"KAYU PUTIH, PULOGADUNG, JAKARTA TIMUR, DKI JAKARTA",79,137,93,230
https://kawalpemilu.org#26079,"KAYU PUTIH, PULOGADUNG, JAKARTA TIMUR, DKI JAKARTA",80,128,100,228
https://kawalpemilu.org#26079,"KAYU PUTIH, PULOGADUNG, JAKARTA TIMUR, DKI JAKARTA",81,155,71,226
https://kawalpemilu.org#26079,"KAYU PUTIH, PULOGADUNG, JAKARTA TIMUR, DKI JAKARTA",82,148,68,216
https://kawalpemilu.org#26079,"KAYU PUTIH, PULOGADUNG, JAKARTA TIMUR, DKI JAKARTA",83,134,82,216
https://kawalpemilu.org#26079,"KAYU PUTIH, PULOGADUNG, JAKARTA TIMUR, DKI JAKARTA",84,224,54,278
https://kawalpemilu.org#26079,"KAYU PUTIH, PULOGADUNG, JAKARTA TIMUR, DKI JAKARTA",85,187,51,238
https://kawalpemilu.org#26079,"KAYU PUTIH, PULOGADUNG, JAKARTA TIMUR, DKI JAKARTA",86,215,27,242
https://kawalpemilu.org#26079,"KAYU PUTIH, PULOGADUNG, JAKARTA TIMUR, DKI JAKARTA",87,178,41,219
https://kawalpemilu.org#26079,"KAYU PUTIH, PULOGADUNG, JAKARTA TIMUR, DKI JAKARTA",88,203,59,262
https://kawalpemilu.org#26079,"KAYU PUTIH, PULOGADUNG, JAKARTA TIMUR, DKI JAKARTA",89,193,24,217
https://kawalpemilu.org#26079,"KAYU PUTIH, PULOGADUNG, JAKARTA TIMUR, DKI JAKARTA",90,147,67,214
https://kawalpemilu.org#26079,"KAYU PUTIH, PULOGADUNG, JAKARTA TIMUR, DKI JAKARTA",91,198,26,224
https://kawalpemilu.org#26079,"KAYU PUTIH, PULOGADUNG, JAKARTA TIMUR, DKI JAKARTA",92,180,43,223
https://kawalpemilu.org#26079,"KAYU PUTIH, PULOGADUNG, JAKARTA TIMUR, DKI JAKARTA",93,215,27,242
https://kawalpemilu.org#26079,"KAYU PUTIH, PULOGADUNG, JAKARTA TIMUR, DKI JAKARTA",95,170,55,225
https://kawalpemilu.org#26079,"KAYU PUTIH, PULOGADUNG, JAKARTA TIMUR, DKI JAKARTA",96,217,29,246
https://kawalpemilu.org#26079,"KAYU PUTIH, PULOGADUNG, JAKARTA TIMUR, DKI JAKARTA",97,197,28,225
https://kawalpemilu.org#26079,"KAYU PUTIH, PULOGADUNG, JAKARTA TIMUR, DKI JAKARTA",98,80,151,231
https://kawalpemilu.org#26079,"KAYU PUTIH, PULOGADUNG, JAKARTA TIMUR, DKI JAKARTA",99,58,171,229
https://kawalpemilu.org#26079,"KAYU PUTIH, PULOGADUNG, JAKARTA TIMUR, DKI JAKARTA",100,63,162,225
https://kawalpemilu.org#26079,"KAYU PUTIH, PULOGADUNG, JAKARTA TIMUR, DKI JAKARTA",101,77,150,227
https://kawalpemilu.org#26079,"KAYU PUTIH, PULOGADUNG, JAKARTA TIMUR, DKI JAKARTA",102,63,175,238
https://kawalpemilu.org#26079,"KAYU PUTIH, PULOGADUNG, JAKARTA TIMUR, DKI JAKARTA",103,56,166,222
https://kawalpemilu.org#26079,"KAYU PUTIH, PULOGADUNG, JAKARTA TIMUR, DKI JAKARTA",104,92,142,234
https://kawalpemilu.org#26079,"KAYU PUTIH, PULOGADUNG, JAKARTA TIMUR, DKI JAKARTA",105,97,139,236
https://kawalpemilu.org#26079,"KAYU PUTIH, PULOGADUNG, JAKARTA TIMUR, DKI JAKARTA",106,115,98,213
https://kawalpemilu.org#26079,"KAYU PUTIH, PULOGADUNG, JAKARTA TIMUR, DKI JAKARTA",107,92,100,192
https://kawalpemilu.org#26079,"KAYU PUTIH, PULOGADUNG, JAKARTA TIMUR, DKI JAKARTA",108,117,71,188
https://kawalpemilu.org#26079,"KAYU PUTIH, PULOGADUNG, JAKARTA TIMUR, DKI JAKARTA",109,105,110,215
https://kawalpemilu.org#26079,"KAYU PUTIH, PULOGADUNG, JAKARTA TIMUR, DKI JAKARTA",112,81,136,212
https://kawalpemilu.org#26079,"KAYU PUTIH, PULOGADUNG, JAKARTA TIMUR, DKI JAKARTA",113,88,145,233
https://kawalpemilu.org#26079,"KAYU PUTIH, PULOGADUNG, JAKARTA TIMUR, DKI JAKARTA",114,97,142,239
https://kawalpemilu.org#26079,"KAYU PUTIH, PULOGADUNG, JAKARTA TIMUR, DKI JAKARTA",115,93,153,246
https://kawalpemilu.org#26079,"KAYU PUTIH, PULOGADUNG, JAKARTA TIMUR, DKI JAKARTA",116,173,86,259
https://kawalpemilu.org#26079,"KAYU PUTIH, PULOGADUNG, JAKARTA TIMUR, DKI JAKARTA",117,165,76,241
https://kawalpemilu.org#26079,"KAYU PUTIH, PULOGADUNG, JAKARTA TIMUR, DKI JAKARTA",118,139,84,223
https://kawalpemilu.org#26079,"KAYU PUTIH, PULOGADUNG, JAKARTA TIMUR, DKI JAKARTA",119,117,106,223
https://kawalpemilu.org#26079,"KAYU PUTIH, PULOGADUNG, JAKARTA TIMUR, DKI JAKARTA",120,113,98,211
https://kawalpemilu.org#26079,"KAYU PUTIH, PULOGADUNG, JAKARTA TIMUR, DKI JAKARTA",121,117,108,225
https://kawalpemilu.org#26079,"KAYU PUTIH, PULOGADUNG, JAKARTA TIMUR, DKI JAKARTA",122,78,57,135
https://kawalpemilu.org#26079,"KAYU PUTIH, PULOGADUNG, JAKARTA TIMUR, DKI JAKARTA",123,77,69,146
https://kawalpemilu.org#26079,"KAYU PUTIH, PULOGADUNG, JAKARTA TIMUR, DKI JAKARTA",124,74,103,177
https://kawalpemilu.org#26079,"KAYU PUTIH, PULOGADUNG, JAKARTA TIMUR, DKI JAKARTA",125,80,76,156
https://kawalpemilu.org#26079,"KAYU PUTIH, PULOGADUNG, JAKARTA TIMUR, DKI JAKARTA",126,97,61,158
https://kawalpemilu.org#26079,"KAYU PUTIH, PULOGADUNG, JAKARTA TIMUR, DKI JAKARTA",128,120,45,165
https://kawalpemilu.org#26079,"KAYU PUTIH, PULOGADUNG, JAKARTA TIMUR, DKI JAKARTA",129,116,64,180
https://kawalpemilu.org#26079,"KAYU PUTIH, PULOGADUNG, JAKARTA TIMUR, DKI JAKARTA",130,59,111,170
https://kawalpemilu.org#26079,"KAYU PUTIH, PULOGADUNG, JAKARTA TIMUR, DKI JAKARTA",131,107,64,171
https://kawalpemilu.org#26079,"KAYU PUTIH, PULOGADUNG, JAKARTA TIMUR, DKI JAKARTA",132,86,73,159
https://kawalpemilu.org#26080,"JATI, PULOGADUNG, JAKARTA TIMUR, DKI JAKARTA",1,187,43,230
https://kawalpemilu.org#26080,"JATI, PULOGADUNG, JAKARTA TIMUR, DKI JAKARTA",2,143,91,234
https://kawalpemilu.org#26080,"JATI, PULOGADUNG, JAKARTA TIMUR, DKI JAKARTA",3,199,68,267
https://kawalpemilu.org#26080,"JATI, PULOGADUNG, JAKARTA TIMUR, DKI JAKARTA",5,139,96,235
https://kawalpemilu.org#26080,"JATI, PULOGADUNG, JAKARTA TIMUR, DKI JAKARTA",6,127,111,238
https://kawalpemilu.org#26080,"JATI, PULOGADUNG, JAKARTA TIMUR, DKI JAKARTA",7,158,76,234
https://kawalpemilu.org#26080,"JATI, PULOGADUNG, JAKARTA TIMUR, DKI JAKARTA",9,123,103,226
https://kawalpemilu.org#26080,"JATI, PULOGADUNG, JAKARTA TIMUR, DKI JAKARTA",11,137,88,225
https://kawalpemilu.org#26080,"JATI, PULOGADUNG, JAKARTA TIMUR, DKI JAKARTA",12,151,87,238
https://kawalpemilu.org#26080,"JATI, PULOGADUNG, JAKARTA TIMUR, DKI JAKARTA",13,139,90,229
https://kawalpemilu.org#26080,"JATI, PULOGADUNG, JAKARTA TIMUR, DKI JAKARTA",14,147,78,225
https://kawalpemilu.org#26080,"JATI, PULOGADUNG, JAKARTA TIMUR, DKI JAKARTA",15,182,69,251
https://kawalpemilu.org#26080,"JATI, PULOGADUNG, JAKARTA TIMUR, DKI JAKARTA",16,123,52,175
https://kawalpemilu.org#26080,"JATI, PULOGADUNG, JAKARTA TIMUR, DKI JAKARTA",17,71,41,112
https://kawalpemilu.org#26080,"JATI, PULOGADUNG, JAKARTA TIMUR, DKI JAKARTA",18,80,146,226
https://kawalpemilu.org#26080,"JATI, PULOGADUNG, JAKARTA TIMUR, DKI JAKARTA",19,76,110,186
https://kawalpemilu.org#26080,"JATI, PULOGADUNG, JAKARTA TIMUR, DKI JAKARTA",20,82,138,220
https://kawalpemilu.org#26080,"JATI, PULOGADUNG, JAKARTA TIMUR, DKI JAKARTA",22,109,154,263
https://kawalpemilu.org#26080,"JATI, PULOGADUNG, JAKARTA TIMUR, DKI JAKARTA",23,112,131,243
https://kawalpemilu.org#26080,"JATI, PULOGADUNG, JAKARTA TIMUR, DKI JAKARTA",24,92,150,242
https://kawalpemilu.org#26080,"JATI, PULOGADUNG, JAKARTA TIMUR, DKI JAKARTA",25,133,126,259
https://kawalpemilu.org#26080,"JATI, PULOGADUNG, JAKARTA TIMUR, DKI JAKARTA",27,84,163,247
https://kawalpemilu.org#26080,"JATI, PULOGADUNG, JAKARTA TIMUR, DKI JAKARTA",28,106,147,253
https://kawalpemilu.org#26080,"JATI, PULOGADUNG, JAKARTA TIMUR, DKI JAKARTA",29,53,200,253
https://kawalpemilu.org#26080,"JATI, PULOGADUNG, JAKARTA TIMUR, DKI JAKARTA",30,91,133,224
https://kawalpemilu.org#26080,"JATI, PULOGADUNG, JAKARTA TIMUR, DKI JAKARTA",32,96,130,226
https://kawalpemilu.org#26080,"JATI, PULOGADUNG, JAKARTA TIMUR, DKI JAKARTA",33,137,57,194
https://kawalpemilu.org#26080,"JATI, PULOGADUNG, JAKARTA TIMUR, DKI JAKARTA",34,90,153,243
https://kawalpemilu.org#26080,"JATI, PULOGADUNG, JAKARTA TIMUR, DKI JAKARTA",36,97,145,242
https://kawalpemilu.org#26080,"JATI, PULOGADUNG, JAKARTA TIMUR, DKI JAKARTA",38,85,182,267
https://kawalpemilu.org#26080,"JATI, PULOGADUNG, JAKARTA TIMUR, DKI JAKARTA",40,94,142,236
https://kawalpemilu.org#26080,"JATI, PULOGADUNG, JAKARTA TIMUR, DKI JAKARTA",41,88,181,269
https://kawalpemilu.org#26080,"JATI, PULOGADUNG, JAKARTA TIMUR, DKI JAKARTA",43,100,147,247
https://kawalpemilu.org#26080,"JATI, PULOGADUNG, JAKARTA TIMUR, DKI JAKARTA",44,52,198,250
https://kawalpemilu.org#26080,"JATI, PULOGADUNG, JAKARTA TIMUR, DKI JAKARTA",45,54,213,267
https://kawalpemilu.org#26080,"JATI, PULOGADUNG, JAKARTA TIMUR, DKI JAKARTA",46,149,79,228
https://kawalpemilu.org#26080,"JATI, PULOGADUNG, JAKARTA TIMUR, DKI JAKARTA",47,145,74,219
https://kawalpemilu.org#26080,"JATI, PULOGADUNG, JAKARTA TIMUR, DKI JAKARTA",48,145,67,212
https://kawalpemilu.org#26080,"JATI, PULOGADUNG, JAKARTA TIMUR, DKI JAKARTA",49,154,86,240
https://kawalpemilu.org#26080,"JATI, PULOGADUNG, JAKARTA TIMUR, DKI JAKARTA",50,127,64,191
https://kawalpemilu.org#26080,"JATI, PULOGADUNG, JAKARTA TIMUR, DKI JAKARTA",51,158,55,213
https://kawalpemilu.org#26080,"JATI, PULOGADUNG, JAKARTA TIMUR, DKI JAKARTA",52,115,109,224
https://kawalpemilu.org#26080,"JATI, PULOGADUNG, JAKARTA TIMUR, DKI JAKARTA",53,86,126,212
https://kawalpemilu.org#26080,"JATI, PULOGADUNG, JAKARTA TIMUR, DKI JAKARTA",54,90,115,205
https://kawalpemilu.org#26080,"JATI, PULOGADUNG, JAKARTA TIMUR, DKI JAKARTA",55,135,74,209
https://kawalpemilu.org#26080,"JATI, PULOGADUNG, JAKARTA TIMUR, DKI JAKARTA",56,138,84,222
https://kawalpemilu.org#26080,"JATI, PULOGADUNG, JAKARTA TIMUR, DKI JAKARTA",57,139,72,211
https://kawalpemilu.org#26080,"JATI, PULOGADUNG, JAKARTA TIMUR, DKI JAKARTA",58,148,72,220
https://kawalpemilu.org#26080,"JATI, PULOGADUNG, JAKARTA TIMUR, DKI JAKARTA",63,139,105,244
https://kawalpemilu.org#26080,"JATI, PULOGADUNG, JAKARTA TIMUR, DKI JAKARTA",64,142,86,228
https://kawalpemilu.org#26080,"JATI, PULOGADUNG, JAKARTA TIMUR, DKI JAKARTA",65,161,80,241
https://kawalpemilu.org#26080,"JATI, PULOGADUNG, JAKARTA TIMUR, DKI JAKARTA",66,138,99,237
https://kawalpemilu.org#26080,"JATI, PULOGADUNG, JAKARTA TIMUR, DKI JAKARTA",67,106,114,220
https://kawalpemilu.org#26080,"JATI, PULOGADUNG, JAKARTA TIMUR, DKI JAKARTA",68,98,72,170
https://kawalpemilu.org#26080,"JATI, PULOGADUNG, JAKARTA TIMUR, DKI JAKARTA",70,116,115,231
https://kawalpemilu.org#26080,"JATI, PULOGADUNG, JAKARTA TIMUR, DKI JAKARTA",71,98,91,189
https://kawalpemilu.org#26080,"JATI, PULOGADUNG, JAKARTA TIMUR, DKI JAKARTA",72,91,98,189
https://kawalpemilu.org#26080,"JATI, PULOGADUNG, JAKARTA TIMUR, DKI JAKARTA",73,137,101,238
https://kawalpemilu.org#26080,"JATI, PULOGADUNG, JAKARTA TIMUR, DKI JAKARTA",75,123,126,249
https://kawalpemilu.org#26080,"JATI, PULOGADUNG, JAKARTA TIMUR, DKI JAKARTA",76,100,67,167
https://kawalpemilu.org#26080,"JATI, PULOGADUNG, JAKARTA TIMUR, DKI JAKARTA",77,134,74,208
https://kawalpemilu.org#26080,"JATI, PULOGADUNG, JAKARTA TIMUR, DKI JAKARTA",78,124,99,223
https://kawalpemilu.org#26080,"JATI, PULOGADUNG, JAKARTA TIMUR, DKI JAKARTA",80,126,126,252
https://kawalpemilu.org#26080,"JATI, PULOGADUNG, JAKARTA TIMUR, DKI JAKARTA",82,88,114,202
https://kawalpemilu.org#26080,"JATI, PULOGADUNG, JAKARTA TIMUR, DKI JAKARTA",83,98,83,181
https://kawalpemilu.org#26080,"JATI, PULOGADUNG, JAKARTA TIMUR, DKI JAKARTA",84,176,63,239
https://kawalpemilu.org#26080,"JATI, PULOGADUNG, JAKARTA TIMUR, DKI JAKARTA",85,115,126,241
https://kawalpemilu.org#26080,"JATI, PULOGADUNG, JAKARTA TIMUR, DKI JAKARTA",86,131,82,213
https://kawalpemilu.org#26080,"JATI, PULOGADUNG, JAKARTA TIMUR, DKI JAKARTA",87,139,109,248
https://kawalpemilu.org#26080,"JATI, PULOGADUNG, JAKARTA TIMUR, DKI JAKARTA",88,153,70,223
https://kawalpemilu.org#26080,"JATI, PULOGADUNG, JAKARTA TIMUR, DKI JAKARTA",89,130,126,256
https://kawalpemilu.org#26080,"JATI, PULOGADUNG, JAKARTA TIMUR, DKI JAKARTA",91,113,71,184
https://kawalpemilu.org#26080,"JATI, PULOGADUNG, JAKARTA TIMUR, DKI JAKARTA",92,113,71,184
https://kawalpemilu.org#26080,"JATI, PULOGADUNG, JAKARTA TIMUR, DKI JAKARTA",95,113,81,194
https://kawalpemilu.org#26080,"JATI, PULOGADUNG, JAKARTA TIMUR, DKI JAKARTA",97,97,142,239
https://kawalpemilu.org#26080,"JATI, PULOGADUNG, JAKARTA TIMUR, DKI JAKARTA",98,105,134,239
https://kawalpemilu.org#26080,"JATI, PULOGADUNG, JAKARTA TIMUR, DKI JAKARTA",99,128,90,218
https://kawalpemilu.org#26080,"JATI, PULOGADUNG, JAKARTA TIMUR, DKI JAKARTA",100,155,78,233
https://kawalpemilu.org#26080,"JATI, PULOGADUNG, JAKARTA TIMUR, DKI JAKARTA",101,139,100,239
https://kawalpemilu.org#26080,"JATI, PULOGADUNG, JAKARTA TIMUR, DKI JAKARTA",102,137,85,222
https://kawalpemilu.org#26080,"JATI, PULOGADUNG, JAKARTA TIMUR, DKI JAKARTA",106,120,110,230
https://kawalpemilu.org#26080,"JATI, PULOGADUNG, JAKARTA TIMUR, DKI JAKARTA",109,59,60,119
https://kawalpemilu.org#26080,"JATI, PULOGADUNG, JAKARTA TIMUR, DKI JAKARTA",110,71,66,137
https://kawalpemilu.org#26082,"KAMPUNG MELAYU, JATINEGARA, JAKARTA TIMUR, DKI JAKARTA",1,228,12,240
https://kawalpemilu.org#26082,"KAMPUNG MELAYU, JATINEGARA, JAKARTA TIMUR, DKI JAKARTA",2,125,64,189
https://kawalpemilu.org#26082,"KAMPUNG MELAYU, JATINEGARA, JAKARTA TIMUR, DKI JAKARTA",4,78,163,241
https://kawalpemilu.org#26082,"KAMPUNG MELAYU, JATINEGARA, JAKARTA TIMUR, DKI JAKARTA",5,80,137,217
https://kawalpemilu.org#26082,"KAMPUNG MELAYU, JATINEGARA, JAKARTA TIMUR, DKI JAKARTA",8,31,197,228
https://kawalpemilu.org#26082,"KAMPUNG MELAYU, JATINEGARA, JAKARTA TIMUR, DKI JAKARTA",10,64,166,230
https://kawalpemilu.org#26082,"KAMPUNG MELAYU, JATINEGARA, JAKARTA TIMUR, DKI JAKARTA",11,36,185,221
https://kawalpemilu.org#26082,"KAMPUNG MELAYU, JATINEGARA, JAKARTA TIMUR, DKI JAKARTA",12,23,237,260
https://kawalpemilu.org#26082,"KAMPUNG MELAYU, JATINEGARA, JAKARTA TIMUR, DKI JAKARTA",13,52,226,278
https://kawalpemilu.org#26082,"KAMPUNG MELAYU, JATINEGARA, JAKARTA TIMUR, DKI JAKARTA",14,58,192,250
https://kawalpemilu.org#26082,"KAMPUNG MELAYU, JATINEGARA, JAKARTA TIMUR, DKI JAKARTA",16,26,249,275
https://kawalpemilu.org#26082,"KAMPUNG MELAYU, JATINEGARA, JAKARTA TIMUR, DKI JAKARTA",17,23,249,272
https://kawalpemilu.org#26082,"KAMPUNG MELAYU, JATINEGARA, JAKARTA TIMUR, DKI JAKARTA",18,70,159,229
https://kawalpemilu.org#26082,"KAMPUNG MELAYU, JATINEGARA, JAKARTA TIMUR, DKI JAKARTA",19,139,80,219
https://kawalpemilu.org#26082,"KAMPUNG MELAYU, JATINEGARA, JAKARTA TIMUR, DKI JAKARTA",20,38,203,241
https://kawalpemilu.org#26082,"KAMPUNG MELAYU, JATINEGARA, JAKARTA TIMUR, DKI JAKARTA",21,17,210,227
https://kawalpemilu.org#26082,"KAMPUNG MELAYU, JATINEGARA, JAKARTA TIMUR, DKI JAKARTA",23,21,225,246
https://kawalpemilu.org#26082,"KAMPUNG MELAYU, JATINEGARA, JAKARTA TIMUR, DKI JAKARTA",24,23,224,247
https://kawalpemilu.org#26082,"KAMPUNG MELAYU, JATINEGARA, JAKARTA TIMUR, DKI JAKARTA",25,24,220,244
https://kawalpemilu.org#26082,"KAMPUNG MELAYU, JATINEGARA, JAKARTA TIMUR, DKI JAKARTA",26,32,214,246
https://kawalpemilu.org#26082,"KAMPUNG MELAYU, JATINEGARA, JAKARTA TIMUR, DKI JAKARTA",27,31,243,274
https://kawalpemilu.org#26082,"KAMPUNG MELAYU, JATINEGARA, JAKARTA TIMUR, DKI JAKARTA",28,170,60,230
https://kawalpemilu.org#26082,"KAMPUNG MELAYU, JATINEGARA, JAKARTA TIMUR, DKI JAKARTA",29,136,99,235
https://kawalpemilu.org#26082,"KAMPUNG MELAYU, JATINEGARA, JAKARTA TIMUR, DKI JAKARTA",30,142,100,242
https://kawalpemilu.org#26082,"KAMPUNG MELAYU, JATINEGARA, JAKARTA TIMUR, DKI JAKARTA",31,245,9,254
https://kawalpemilu.org#26082,"KAMPUNG MELAYU, JATINEGARA, JAKARTA TIMUR, DKI JAKARTA",33,167,49,216
https://kawalpemilu.org#26082,"KAMPUNG MELAYU, JATINEGARA, JAKARTA TIMUR, DKI JAKARTA",34,124,109,233
https://kawalpemilu.org#26082,"KAMPUNG MELAYU, JATINEGARA, JAKARTA TIMUR, DKI JAKARTA",36,232,19,251
https://kawalpemilu.org#26082,"KAMPUNG MELAYU, JATINEGARA, JAKARTA TIMUR, DKI JAKARTA",37,188,39,227
https://kawalpemilu.org#26082,"KAMPUNG MELAYU, JATINEGARA, JAKARTA TIMUR, DKI JAKARTA",38,157,59,216
https://kawalpemilu.org#26082,"KAMPUNG MELAYU, JATINEGARA, JAKARTA TIMUR, DKI JAKARTA",39,131,66,197
https://kawalpemilu.org#26082,"KAMPUNG MELAYU, JATINEGARA, JAKARTA TIMUR, DKI JAKARTA",40,117,102,219
https://kawalpemilu.org#26082,"KAMPUNG MELAYU, JATINEGARA, JAKARTA TIMUR, DKI JAKARTA",44,95,62,157
https://kawalpemilu.org#26082,"KAMPUNG MELAYU, JATINEGARA, JAKARTA TIMUR, DKI JAKARTA",48,164,83,247
https://kawalpemilu.org#26082,"KAMPUNG MELAYU, JATINEGARA, JAKARTA TIMUR, DKI JAKARTA",49,77,152,229
https://kawalpemilu.org#26082,"KAMPUNG MELAYU, JATINEGARA, JAKARTA TIMUR, DKI JAKARTA",50,105,119,224
https://kawalpemilu.org#26082,"KAMPUNG MELAYU, JATINEGARA, JAKARTA TIMUR, DKI JAKARTA",51,73,174,247
https://kawalpemilu.org#26082,"KAMPUNG MELAYU, JATINEGARA, JAKARTA TIMUR, DKI JAKARTA",53,85,149,234
https://kawalpemilu.org#26082,"KAMPUNG MELAYU, JATINEGARA, JAKARTA TIMUR, DKI JAKARTA",55,62,207,269
https://kawalpemilu.org#26082,"KAMPUNG MELAYU, JATINEGARA, JAKARTA TIMUR, DKI JAKARTA",56,47,148,195
https://kawalpemilu.org#26082,"KAMPUNG MELAYU, JATINEGARA, JAKARTA TIMUR, DKI JAKARTA",57,71,154,225
https://kawalpemilu.org#26082,"KAMPUNG MELAYU, JATINEGARA, JAKARTA TIMUR, DKI JAKARTA",58,61,186,247
https://kawalpemilu.org#26082,"KAMPUNG MELAYU, JATINEGARA, JAKARTA TIMUR, DKI JAKARTA",60,39,161,200
https://kawalpemilu.org#26082,"KAMPUNG MELAYU, JATINEGARA, JAKARTA TIMUR, DKI JAKARTA",62,43,207,250
https://kawalpemilu.org#26082,"KAMPUNG MELAYU, JATINEGARA, JAKARTA TIMUR, DKI JAKARTA",64,58,191,249
https://kawalpemilu.org#26082,"KAMPUNG MELAYU, JATINEGARA, JAKARTA TIMUR, DKI JAKARTA",66,44,215,259
https://kawalpemilu.org#26082,"KAMPUNG MELAYU, JATINEGARA, JAKARTA TIMUR, DKI JAKARTA",67,50,211,261
https://kawalpemilu.org#26082,"KAMPUNG MELAYU, JATINEGARA, JAKARTA TIMUR, DKI JAKARTA",68,44,185,229
https://kawalpemilu.org#26082,"KAMPUNG MELAYU, JATINEGARA, JAKARTA TIMUR, DKI JAKARTA",70,41,185,226
https://kawalpemilu.org#26082,"KAMPUNG MELAYU, JATINEGARA, JAKARTA TIMUR, DKI JAKARTA",72,62,189,251
https://kawalpemilu.org#26082,"KAMPUNG MELAYU, JATINEGARA, JAKARTA TIMUR, DKI JAKARTA",73,46,209,255
https://kawalpemilu.org#26082,"KAMPUNG MELAYU, JATINEGARA, JAKARTA TIMUR, DKI JAKARTA",74,45,233,278
https://kawalpemilu.org#26082,"KAMPUNG MELAYU, JATINEGARA, JAKARTA TIMUR, DKI JAKARTA",75,40,225,265
https://kawalpemilu.org#26082,"KAMPUNG MELAYU, JATINEGARA, JAKARTA TIMUR, DKI JAKARTA",76,42,206,248
https://kawalpemilu.org#26082,"KAMPUNG MELAYU, JATINEGARA, JAKARTA TIMUR, DKI JAKARTA",77,26,208,234
https://kawalpemilu.org#26082,"KAMPUNG MELAYU, JATINEGARA, JAKARTA TIMUR, DKI JAKARTA",79,123,35,158
https://kawalpemilu.org#26082,"KAMPUNG MELAYU, JATINEGARA, JAKARTA TIMUR, DKI JAKARTA",82,30,174,204
https://kawalpemilu.org#26083,"BIDARA CINA, JATINEGARA, JAKARTA TIMUR, DKI JAKARTA",1,0,0,0
https://kawalpemilu.org#26083,"BIDARA CINA, JATINEGARA, JAKARTA TIMUR, DKI JAKARTA",4,122,92,214
https://kawalpemilu.org#26083,"BIDARA CINA, JATINEGARA, JAKARTA TIMUR, DKI JAKARTA",5,122,114,236
https://kawalpemilu.org#26083,"BIDARA CINA, JATINEGARA, JAKARTA TIMUR, DKI JAKARTA",6,107,95,202
https://kawalpemilu.org#26083,"BIDARA CINA, JATINEGARA, JAKARTA TIMUR, DKI JAKARTA",7,58,152,210
https://kawalpemilu.org#26083,"BIDARA CINA, JATINEGARA, JAKARTA TIMUR, DKI JAKARTA",8,103,98,201
https://kawalpemilu.org#26083,"BIDARA CINA, JATINEGARA, JAKARTA TIMUR, DKI JAKARTA",9,69,160,229
https://kawalpemilu.org#26083,"BIDARA CINA, JATINEGARA, JAKARTA TIMUR, DKI JAKARTA",11,135,68,203
https://kawalpemilu.org#26083,"BIDARA CINA, JATINEGARA, JAKARTA TIMUR, DKI JAKARTA",14,56,173,229
https://kawalpemilu.org#26083,"BIDARA CINA, JATINEGARA, JAKARTA TIMUR, DKI JAKARTA",15,78,174,252
https://kawalpemilu.org#26083,"BIDARA CINA, JATINEGARA, JAKARTA TIMUR, DKI JAKARTA",16,121,113,234
https://kawalpemilu.org#26083,"BIDARA CINA, JATINEGARA, JAKARTA TIMUR, DKI JAKARTA",17,51,167,218
https://kawalpemilu.org#26083,"BIDARA CINA, JATINEGARA, JAKARTA TIMUR, DKI JAKARTA",18,51,158,209
https://kawalpemilu.org#26083,"BIDARA CINA, JATINEGARA, JAKARTA TIMUR, DKI JAKARTA",19,54,134,188
https://kawalpemilu.org#26083,"BIDARA CINA, JATINEGARA, JAKARTA TIMUR, DKI JAKARTA",21,81,113,194
https://kawalpemilu.org#26083,"BIDARA CINA, JATINEGARA, JAKARTA TIMUR, DKI JAKARTA",22,107,100,207
https://kawalpemilu.org#26083,"BIDARA CINA, JATINEGARA, JAKARTA TIMUR, DKI JAKARTA",23,63,117,180
https://kawalpemilu.org#26083,"BIDARA CINA, JATINEGARA, JAKARTA TIMUR, DKI JAKARTA",24,99,97,196
https://kawalpemilu.org#26083,"BIDARA CINA, JATINEGARA, JAKARTA TIMUR, DKI JAKARTA",26,61,108,169
https://kawalpemilu.org#26083,"BIDARA CINA, JATINEGARA, JAKARTA TIMUR, DKI JAKARTA",28,130,90,220
https://kawalpemilu.org#26083,"BIDARA CINA, JATINEGARA, JAKARTA TIMUR, DKI JAKARTA",29,137,54,191
https://kawalpemilu.org#26083,"BIDARA CINA, JATINEGARA, JAKARTA TIMUR, DKI JAKARTA",30,206,22,228
https://kawalpemilu.org#26083,"BIDARA CINA, JATINEGARA, JAKARTA TIMUR, DKI JAKARTA",31,204,6,210
https://kawalpemilu.org#26083,"BIDARA CINA, JATINEGARA, JAKARTA TIMUR, DKI JAKARTA",32,175,17,192
https://kawalpemilu.org#26083,"BIDARA CINA, JATINEGARA, JAKARTA TIMUR, DKI JAKARTA",33,147,49,196
https://kawalpemilu.org#26083,"BIDARA CINA, JATINEGARA, JAKARTA TIMUR, DKI JAKARTA",34,170,23,193
https://kawalpemilu.org#26083,"BIDARA CINA, JATINEGARA, JAKARTA TIMUR, DKI JAKARTA",36,135,34,169
https://kawalpemilu.org#26083,"BIDARA CINA, JATINEGARA, JAKARTA TIMUR, DKI JAKARTA",41,114,76,190
https://kawalpemilu.org#26083,"BIDARA CINA, JATINEGARA, JAKARTA TIMUR, DKI JAKARTA",42,55,167,222
https://kawalpemilu.org#26083,"BIDARA CINA, JATINEGARA, JAKARTA TIMUR, DKI JAKARTA",43,83,131,214
https://kawalpemilu.org#26083,"BIDARA CINA, JATINEGARA, JAKARTA TIMUR, DKI JAKARTA",45,103,124,227
https://kawalpemilu.org#26083,"BIDARA CINA, JATINEGARA, JAKARTA TIMUR, DKI JAKARTA",46,123,102,225
https://kawalpemilu.org#26083,"BIDARA CINA, JATINEGARA, JAKARTA TIMUR, DKI JAKARTA",47,102,130,232
https://kawalpemilu.org#26083,"BIDARA CINA, JATINEGARA, JAKARTA TIMUR, DKI JAKARTA",48,100,142,242
https://kawalpemilu.org#26083,"BIDARA CINA, JATINEGARA, JAKARTA TIMUR, DKI JAKARTA",49,100,114,214
https://kawalpemilu.org#26083,"BIDARA CINA, JATINEGARA, JAKARTA TIMUR, DKI JAKARTA",50,110,120,230
https://kawalpemilu.org#26083,"BIDARA CINA, JATINEGARA, JAKARTA TIMUR, DKI JAKARTA",52,72,150,222
https://kawalpemilu.org#26083,"BIDARA CINA, JATINEGARA, JAKARTA TIMUR, DKI JAKARTA",53,98,126,224
https://kawalpemilu.org#26083,"BIDARA CINA, JATINEGARA, JAKARTA TIMUR, DKI JAKARTA",54,113,135,248
https://kawalpemilu.org#26083,"BIDARA CINA, JATINEGARA, JAKARTA TIMUR, DKI JAKARTA",56,84,171,255
https://kawalpemilu.org#26083,"BIDARA CINA, JATINEGARA, JAKARTA TIMUR, DKI JAKARTA",57,68,151,219
https://kawalpemilu.org#26083,"BIDARA CINA, JATINEGARA, JAKARTA TIMUR, DKI JAKARTA",58,61,149,210
https://kawalpemilu.org#26083,"BIDARA CINA, JATINEGARA, JAKARTA TIMUR, DKI JAKARTA",59,106,160,266
https://kawalpemilu.org#26083,"BIDARA CINA, JATINEGARA, JAKARTA TIMUR, DKI JAKARTA",60,84,138,222
https://kawalpemilu.org#26083,"BIDARA CINA, JATINEGARA, JAKARTA TIMUR, DKI JAKARTA",61,104,156,260
https://kawalpemilu.org#26083,"BIDARA CINA, JATINEGARA, JAKARTA TIMUR, DKI JAKARTA",62,90,157,247
https://kawalpemilu.org#26083,"BIDARA CINA, JATINEGARA, JAKARTA TIMUR, DKI JAKARTA",63,96,153,249
https://kawalpemilu.org#26083,"BIDARA CINA, JATINEGARA, JAKARTA TIMUR, DKI JAKARTA",66,115,112,227
https://kawalpemilu.org#26083,"BIDARA CINA, JATINEGARA, JAKARTA TIMUR, DKI JAKARTA",67,112,85,197
https://kawalpemilu.org#26083,"BIDARA CINA, JATINEGARA, JAKARTA TIMUR, DKI JAKARTA",68,50,189,239
https://kawalpemilu.org#26083,"BIDARA CINA, JATINEGARA, JAKARTA TIMUR, DKI JAKARTA",69,77,152,229
https://kawalpemilu.org#26083,"BIDARA CINA, JATINEGARA, JAKARTA TIMUR, DKI JAKARTA",70,51,194,245
https://kawalpemilu.org#26083,"BIDARA CINA, JATINEGARA, JAKARTA TIMUR, DKI JAKARTA",73,91,160,251
https://kawalpemilu.org#26083,"BIDARA CINA, JATINEGARA, JAKARTA TIMUR, DKI JAKARTA",75,51,156,207
https://kawalpemilu.org#26083,"BIDARA CINA, JATINEGARA, JAKARTA TIMUR, DKI JAKARTA",76,51,169,220
https://kawalpemilu.org#26083,"BIDARA CINA, JATINEGARA, JAKARTA TIMUR, DKI JAKARTA",77,40,165,205
https://kawalpemilu.org#26083,"BIDARA CINA, JATINEGARA, JAKARTA TIMUR, DKI JAKARTA",78,119,87,206
https://kawalpemilu.org#26083,"BIDARA CINA, JATINEGARA, JAKARTA TIMUR, DKI JAKARTA",79,60,135,195
https://kawalpemilu.org#26083,"BIDARA CINA, JATINEGARA, JAKARTA TIMUR, DKI JAKARTA",80,46,149,195
https://kawalpemilu.org#26083,"BIDARA CINA, JATINEGARA, JAKARTA TIMUR, DKI JAKARTA",81,35,149,184
https://kawalpemilu.org#26083,"BIDARA CINA, JATINEGARA, JAKARTA TIMUR, DKI JAKARTA",82,31,177,208
https://kawalpemilu.org#26083,"BIDARA CINA, JATINEGARA, JAKARTA TIMUR, DKI JAKARTA",84,60,149,209
https://kawalpemilu.org#26083,"BIDARA CINA, JATINEGARA, JAKARTA TIMUR, DKI JAKARTA",86,56,177,233
https://kawalpemilu.org#26083,"BIDARA CINA, JATINEGARA, JAKARTA TIMUR, DKI JAKARTA",87,44,200,244
https://kawalpemilu.org#26083,"BIDARA CINA, JATINEGARA, JAKARTA TIMUR, DKI JAKARTA",88,44,167,211
https://kawalpemilu.org#26083,"BIDARA CINA, JATINEGARA, JAKARTA TIMUR, DKI JAKARTA",89,67,180,247
https://kawalpemilu.org#26083,"BIDARA CINA, JATINEGARA, JAKARTA TIMUR, DKI JAKARTA",90,77,174,251
https://kawalpemilu.org#26083,"BIDARA CINA, JATINEGARA, JAKARTA TIMUR, DKI JAKARTA",91,120,84,204
https://kawalpemilu.org#26083,"BIDARA CINA, JATINEGARA, JAKARTA TIMUR, DKI JAKARTA",92,37,174,211
https://kawalpemilu.org#26083,"BIDARA CINA, JATINEGARA, JAKARTA TIMUR, DKI JAKARTA",93,47,162,209
https://kawalpemilu.org#26083,"BIDARA CINA, JATINEGARA, JAKARTA TIMUR, DKI JAKARTA",94,85,103,188
https://kawalpemilu.org#26083,"BIDARA CINA, JATINEGARA, JAKARTA TIMUR, DKI JAKARTA",95,78,132,210
https://kawalpemilu.org#26083,"BIDARA CINA, JATINEGARA, JAKARTA TIMUR, DKI JAKARTA",96,80,132,212
https://kawalpemilu.org#26083,"BIDARA CINA, JATINEGARA, JAKARTA TIMUR, DKI JAKARTA",97,105,126,231
https://kawalpemilu.org#26083,"BIDARA CINA, JATINEGARA, JAKARTA TIMUR, DKI JAKARTA",99,124,91,215
https://kawalpemilu.org#26083,"BIDARA CINA, JATINEGARA, JAKARTA TIMUR, DKI JAKARTA",100,195,59,254
https://kawalpemilu.org#26083,"BIDARA CINA, JATINEGARA, JAKARTA TIMUR, DKI JAKARTA",103,112,116,228
https://kawalpemilu.org#26083,"BIDARA CINA, JATINEGARA, JAKARTA TIMUR, DKI JAKARTA",104,99,127,226
https://kawalpemilu.org#26083,"BIDARA CINA, JATINEGARA, JAKARTA TIMUR, DKI JAKARTA",105,86,99,185
https://kawalpemilu.org#26083,"BIDARA CINA, JATINEGARA, JAKARTA TIMUR, DKI JAKARTA",106,74,148,222
https://kawalpemilu.org#26083,"BIDARA CINA, JATINEGARA, JAKARTA TIMUR, DKI JAKARTA",107,96,70,166
https://kawalpemilu.org#26083,"BIDARA CINA, JATINEGARA, JAKARTA TIMUR, DKI JAKARTA",108,84,100,184
https://kawalpemilu.org#26083,"BIDARA CINA, JATINEGARA, JAKARTA TIMUR, DKI JAKARTA",109,166,72,238
https://kawalpemilu.org#26083,"BIDARA CINA, JATINEGARA, JAKARTA TIMUR, DKI JAKARTA",111,92,138,230
https://kawalpemilu.org#26083,"BIDARA CINA, JATINEGARA, JAKARTA TIMUR, DKI JAKARTA",112,66,166,232
https://kawalpemilu.org#26083,"BIDARA CINA, JATINEGARA, JAKARTA TIMUR, DKI JAKARTA",113,63,139,202
https://kawalpemilu.org#26083,"BIDARA CINA, JATINEGARA, JAKARTA TIMUR, DKI JAKARTA",114,94,111,205
https://kawalpemilu.org#26083,"BIDARA CINA, JATINEGARA, JAKARTA TIMUR, DKI JAKARTA",115,90,107,197
https://kawalpemilu.org#26083,"BIDARA CINA, JATINEGARA, JAKARTA TIMUR, DKI JAKARTA",117,43,170,213
https://kawalpemilu.org#26083,"BIDARA CINA, JATINEGARA, JAKARTA TIMUR, DKI JAKARTA",120,101,126,227
https://kawalpemilu.org#26083,"BIDARA CINA, JATINEGARA, JAKARTA TIMUR, DKI JAKARTA",122,128,49,177
https://kawalpemilu.org#26083,"BIDARA CINA, JATINEGARA, JAKARTA TIMUR, DKI JAKARTA",123,144,44,188
https://kawalpemilu.org#26083,"BIDARA CINA, JATINEGARA, JAKARTA TIMUR, DKI JAKARTA",124,104,40,144
https://kawalpemilu.org#26083,"BIDARA CINA, JATINEGARA, JAKARTA TIMUR, DKI JAKARTA",126,86,70,156
https://kawalpemilu.org#26083,"BIDARA CINA, JATINEGARA, JAKARTA TIMUR, DKI JAKARTA",127,104,41,145
https://kawalpemilu.org#26083,"BIDARA CINA, JATINEGARA, JAKARTA TIMUR, DKI JAKARTA",128,108,49,157
https://kawalpemilu.org#26083,"BIDARA CINA, JATINEGARA, JAKARTA TIMUR, DKI JAKARTA",129,106,148,254
https://kawalpemilu.org#26083,"BIDARA CINA, JATINEGARA, JAKARTA TIMUR, DKI JAKARTA",130,125,123,248
https://kawalpemilu.org#26083,"BIDARA CINA, JATINEGARA, JAKARTA TIMUR, DKI JAKARTA",132,91,120,211
https://kawalpemilu.org#26084,"BALIMESTER, JATINEGARA, JAKARTA TIMUR, DKI JAKARTA",1,89,158,247
https://kawalpemilu.org#26084,"BALIMESTER, JATINEGARA, JAKARTA TIMUR, DKI JAKARTA",2,93,165,258
https://kawalpemilu.org#26084,"BALIMESTER, JATINEGARA, JAKARTA TIMUR, DKI JAKARTA",3,68,161,229
https://kawalpemilu.org#26084,"BALIMESTER, JATINEGARA, JAKARTA TIMUR, DKI JAKARTA",4,96,128,224
https://kawalpemilu.org#26084,"BALIMESTER, JATINEGARA, JAKARTA TIMUR, DKI JAKARTA",5,119,104,223
https://kawalpemilu.org#26084,"BALIMESTER, JATINEGARA, JAKARTA TIMUR, DKI JAKARTA",6,63,131,194
https://kawalpemilu.org#26084,"BALIMESTER, JATINEGARA, JAKARTA TIMUR, DKI JAKARTA",7,69,122,191
https://kawalpemilu.org#26084,"BALIMESTER, JATINEGARA, JAKARTA TIMUR, DKI JAKARTA",8,123,91,214
https://kawalpemilu.org#26084,"BALIMESTER, JATINEGARA, JAKARTA TIMUR, DKI JAKARTA",9,124,104,228
https://kawalpemilu.org#26084,"BALIMESTER, JATINEGARA, JAKARTA TIMUR, DKI JAKARTA",10,122,97,219
https://kawalpemilu.org#26084,"BALIMESTER, JATINEGARA, JAKARTA TIMUR, DKI JAKARTA",11,160,38,198
https://kawalpemilu.org#26084,"BALIMESTER, JATINEGARA, JAKARTA TIMUR, DKI JAKARTA",12,117,82,199
https://kawalpemilu.org#26084,"BALIMESTER, JATINEGARA, JAKARTA TIMUR, DKI JAKARTA",13,132,93,225
https://kawalpemilu.org#26084,"BALIMESTER, JATINEGARA, JAKARTA TIMUR, DKI JAKARTA",15,168,32,200
https://kawalpemilu.org#26084,"BALIMESTER, JATINEGARA, JAKARTA TIMUR, DKI JAKARTA",16,186,8,194
https://kawalpemilu.org#26084,"BALIMESTER, JATINEGARA, JAKARTA TIMUR, DKI JAKARTA",17,165,48,213
https://kawalpemilu.org#26084,"BALIMESTER, JATINEGARA, JAKARTA TIMUR, DKI JAKARTA",18,156,69,225
https://kawalpemilu.org#26084,"BALIMESTER, JATINEGARA, JAKARTA TIMUR, DKI JAKARTA",19,163,89,252
https://kawalpemilu.org#26084,"BALIMESTER, JATINEGARA, JAKARTA TIMUR, DKI JAKARTA",20,195,33,228
https://kawalpemilu.org#26084,"BALIMESTER, JATINEGARA, JAKARTA TIMUR, DKI JAKARTA",21,224,6,230
https://kawalpemilu.org#26084,"BALIMESTER, JATINEGARA, JAKARTA TIMUR, DKI JAKARTA",22,155,82,237
https://kawalpemilu.org#26084,"BALIMESTER, JATINEGARA, JAKARTA TIMUR, DKI JAKARTA",23,101,124,225
https://kawalpemilu.org#26084,"BALIMESTER, JATINEGARA, JAKARTA TIMUR, DKI JAKARTA",24,148,67,215
https://kawalpemilu.org#26084,"BALIMESTER, JATINEGARA, JAKARTA TIMUR, DKI JAKARTA",25,183,58,241
https://kawalpemilu.org#26084,"BALIMESTER, JATINEGARA, JAKARTA TIMUR, DKI JAKARTA",26,124,85,209
https://kawalpemilu.org#26084,"BALIMESTER, JATINEGARA, JAKARTA TIMUR, DKI JAKARTA",27,115,102,217
https://kawalpemilu.org#26084,"BALIMESTER, JATINEGARA, JAKARTA TIMUR, DKI JAKARTA",28,175,24,199
https://kawalpemilu.org#26084,"BALIMESTER, JATINEGARA, JAKARTA TIMUR, DKI JAKARTA",29,177,32,209
https://kawalpemilu.org#26084,"BALIMESTER, JATINEGARA, JAKARTA TIMUR, DKI JAKARTA",30,183,15,198
https://kawalpemilu.org#26084,"BALIMESTER, JATINEGARA, JAKARTA TIMUR, DKI JAKARTA",31,164,10,174
https://kawalpemilu.org#26084,"BALIMESTER, JATINEGARA, JAKARTA TIMUR, DKI JAKARTA",32,129,148,277
https://kawalpemilu.org#26084,"BALIMESTER, JATINEGARA, JAKARTA TIMUR, DKI JAKARTA",33,79,141,220
https://kawalpemilu.org#26084,"BALIMESTER, JATINEGARA, JAKARTA TIMUR, DKI JAKARTA",34,67,84,151
https://kawalpemilu.org#26085,"RAWA BUNGA, JATINEGARA, JAKARTA TIMUR, DKI JAKARTA",1,106,112,218
https://kawalpemilu.org#26085,"RAWA BUNGA, JATINEGARA, JAKARTA TIMUR, DKI JAKARTA",2,92,159,251
https://kawalpemilu.org#26085,"RAWA BUNGA, JATINEGARA, JAKARTA TIMUR, DKI JAKARTA",3,97,145,242
https://kawalpemilu.org#26085,"RAWA BUNGA, JATINEGARA, JAKARTA TIMUR, DKI JAKARTA",4,92,135,227
https://kawalpemilu.org#26085,"RAWA BUNGA, JATINEGARA, JAKARTA TIMUR, DKI JAKARTA",5,117,127,244
https://kawalpemilu.org#26085,"RAWA BUNGA, JATINEGARA, JAKARTA TIMUR, DKI JAKARTA",6,149,68,217
https://kawalpemilu.org#26085,"RAWA BUNGA, JATINEGARA, JAKARTA TIMUR, DKI JAKARTA",7,212,47,259
https://kawalpemilu.org#26085,"RAWA BUNGA, JATINEGARA, JAKARTA TIMUR, DKI JAKARTA",8,193,33,226
https://kawalpemilu.org#26085,"RAWA BUNGA, JATINEGARA, JAKARTA TIMUR, DKI JAKARTA",9,179,48,227
https://kawalpemilu.org#26085,"RAWA BUNGA, JATINEGARA, JAKARTA TIMUR, DKI JAKARTA",10,201,39,240
https://kawalpemilu.org#26085,"RAWA BUNGA, JATINEGARA, JAKARTA TIMUR, DKI JAKARTA",11,193,9,202
https://kawalpemilu.org#26085,"RAWA BUNGA, JATINEGARA, JAKARTA TIMUR, DKI JAKARTA",12,124,98,222
https://kawalpemilu.org#26085,"RAWA BUNGA, JATINEGARA, JAKARTA TIMUR, DKI JAKARTA",13,102,93,195
https://kawalpemilu.org#26085,"RAWA BUNGA, JATINEGARA, JAKARTA TIMUR, DKI JAKARTA",14,188,31,219
https://kawalpemilu.org#26085,"RAWA BUNGA, JATINEGARA, JAKARTA TIMUR, DKI JAKARTA",15,117,114,231
https://kawalpemilu.org#26085,"RAWA BUNGA, JATINEGARA, JAKARTA TIMUR, DKI JAKARTA",16,68,159,227
https://kawalpemilu.org#26085,"RAWA BUNGA, JATINEGARA, JAKARTA TIMUR, DKI JAKARTA",17,154,69,223
https://kawalpemilu.org#26085,"RAWA BUNGA, JATINEGARA, JAKARTA TIMUR, DKI JAKARTA",18,99,111,210
https://kawalpemilu.org#26085,"RAWA BUNGA, JATINEGARA, JAKARTA TIMUR, DKI JAKARTA",19,98,128,226
https://kawalpemilu.org#26085,"RAWA BUNGA, JATINEGARA, JAKARTA TIMUR, DKI JAKARTA",20,90,152,242
https://kawalpemilu.org#26085,"RAWA BUNGA, JATINEGARA, JAKARTA TIMUR, DKI JAKARTA",21,67,159,226
https://kawalpemilu.org#26085,"RAWA BUNGA, JATINEGARA, JAKARTA TIMUR, DKI JAKARTA",22,80,157,237
https://kawalpemilu.org#26085,"RAWA BUNGA, JATINEGARA, JAKARTA TIMUR, DKI JAKARTA",23,85,127,212
https://kawalpemilu.org#26085,"RAWA BUNGA, JATINEGARA, JAKARTA TIMUR, DKI JAKARTA",24,84,132,216
https://kawalpemilu.org#26085,"RAWA BUNGA, JATINEGARA, JAKARTA TIMUR, DKI JAKARTA",25,93,93,186
https://kawalpemilu.org#26085,"RAWA BUNGA, JATINEGARA, JAKARTA TIMUR, DKI JAKARTA",26,119,70,189
https://kawalpemilu.org#26085,"RAWA BUNGA, JATINEGARA, JAKARTA TIMUR, DKI JAKARTA",27,127,114,241
https://kawalpemilu.org#26085,"RAWA BUNGA, JATINEGARA, JAKARTA TIMUR, DKI JAKARTA",28,87,124,211
https://kawalpemilu.org#26085,"RAWA BUNGA, JATINEGARA, JAKARTA TIMUR, DKI JAKARTA",29,81,151,232
https://kawalpemilu.org#26085,"RAWA BUNGA, JATINEGARA, JAKARTA TIMUR, DKI JAKARTA",30,61,162,223
https://kawalpemilu.org#26085,"RAWA BUNGA, JATINEGARA, JAKARTA TIMUR, DKI JAKARTA",31,87,161,248
https://kawalpemilu.org#26085,"RAWA BUNGA, JATINEGARA, JAKARTA TIMUR, DKI JAKARTA",32,74,169,243
https://kawalpemilu.org#26085,"RAWA BUNGA, JATINEGARA, JAKARTA TIMUR, DKI JAKARTA",33,92,113,205
https://kawalpemilu.org#26085,"RAWA BUNGA, JATINEGARA, JAKARTA TIMUR, DKI JAKARTA",34,101,130,231
https://kawalpemilu.org#26085,"RAWA BUNGA, JATINEGARA, JAKARTA TIMUR, DKI JAKARTA",36,94,127,221
https://kawalpemilu.org#26085,"RAWA BUNGA, JATINEGARA, JAKARTA TIMUR, DKI JAKARTA",37,66,151,217
https://kawalpemilu.org#26085,"RAWA BUNGA, JATINEGARA, JAKARTA TIMUR, DKI JAKARTA",38,77,126,203
https://kawalpemilu.org#26085,"RAWA BUNGA, JATINEGARA, JAKARTA TIMUR, DKI JAKARTA",39,52,166,218
https://kawalpemilu.org#26085,"RAWA BUNGA, JATINEGARA, JAKARTA TIMUR, DKI JAKARTA",40,65,155,220
https://kawalpemilu.org#26085,"RAWA BUNGA, JATINEGARA, JAKARTA TIMUR, DKI JAKARTA",41,103,113,216
https://kawalpemilu.org#26085,"RAWA BUNGA, JATINEGARA, JAKARTA TIMUR, DKI JAKARTA",42,101,147,248
https://kawalpemilu.org#26085,"RAWA BUNGA, JATINEGARA, JAKARTA TIMUR, DKI JAKARTA",43,82,158,240
https://kawalpemilu.org#26085,"RAWA BUNGA, JATINEGARA, JAKARTA TIMUR, DKI JAKARTA",44,79,145,224
https://kawalpemilu.org#26085,"RAWA BUNGA, JATINEGARA, JAKARTA TIMUR, DKI JAKARTA",45,89,102,191
https://kawalpemilu.org#26085,"RAWA BUNGA, JATINEGARA, JAKARTA TIMUR, DKI JAKARTA",46,92,153,245
https://kawalpemilu.org#26085,"RAWA BUNGA, JATINEGARA, JAKARTA TIMUR, DKI JAKARTA",47,91,126,217
https://kawalpemilu.org#26085,"RAWA BUNGA, JATINEGARA, JAKARTA TIMUR, DKI JAKARTA",48,87,146,233
https://kawalpemilu.org#26085,"RAWA BUNGA, JATINEGARA, JAKARTA TIMUR, DKI JAKARTA",50,83,178,261
https://kawalpemilu.org#26085,"RAWA BUNGA, JATINEGARA, JAKARTA TIMUR, DKI JAKARTA",51,123,121,244
https://kawalpemilu.org#26085,"RAWA BUNGA, JATINEGARA, JAKARTA TIMUR, DKI JAKARTA",52,100,152,252
https://kawalpemilu.org#26085,"RAWA BUNGA, JATINEGARA, JAKARTA TIMUR, DKI JAKARTA",53,73,130,203
https://kawalpemilu.org#26085,"RAWA BUNGA, JATINEGARA, JAKARTA TIMUR, DKI JAKARTA",54,58,125,183
https://kawalpemilu.org#26085,"RAWA BUNGA, JATINEGARA, JAKARTA TIMUR, DKI JAKARTA",55,82,124,206
https://kawalpemilu.org#26085,"RAWA BUNGA, JATINEGARA, JAKARTA TIMUR, DKI JAKARTA",56,90,83,173
https://kawalpemilu.org#26085,"RAWA BUNGA, JATINEGARA, JAKARTA TIMUR, DKI JAKARTA",57,74,90,164
https://kawalpemilu.org#26085,"RAWA BUNGA, JATINEGARA, JAKARTA TIMUR, DKI JAKARTA",58,70,157,227
https://kawalpemilu.org#26085,"RAWA BUNGA, JATINEGARA, JAKARTA TIMUR, DKI JAKARTA",59,84,85,169
https://kawalpemilu.org#26085,"RAWA BUNGA, JATINEGARA, JAKARTA TIMUR, DKI JAKARTA",61,95,133,228
https://kawalpemilu.org#26085,"RAWA BUNGA, JATINEGARA, JAKARTA TIMUR, DKI JAKARTA",62,58,146,204
https://kawalpemilu.org#26085,"RAWA BUNGA, JATINEGARA, JAKARTA TIMUR, DKI JAKARTA",63,58,171,229
https://kawalpemilu.org#26085,"RAWA BUNGA, JATINEGARA, JAKARTA TIMUR, DKI JAKARTA",64,36,171,207
https://kawalpemilu.org#26085,"RAWA BUNGA, JATINEGARA, JAKARTA TIMUR, DKI JAKARTA",65,72,178,250
https://kawalpemilu.org#26085,"RAWA BUNGA, JATINEGARA, JAKARTA TIMUR, DKI JAKARTA",66,79,133,212
https://kawalpemilu.org#26085,"RAWA BUNGA, JATINEGARA, JAKARTA TIMUR, DKI JAKARTA",67,45,161,206
https://kawalpemilu.org#26085,"RAWA BUNGA, JATINEGARA, JAKARTA TIMUR, DKI JAKARTA",68,50,189,239
https://kawalpemilu.org#26085,"RAWA BUNGA, JATINEGARA, JAKARTA TIMUR, DKI JAKARTA",69,84,131,215
https://kawalpemilu.org#26085,"RAWA BUNGA, JATINEGARA, JAKARTA TIMUR, DKI JAKARTA",70,76,143,219
https://kawalpemilu.org#26086,"CIPINANG CEMPEDAK, JATINEGARA, JAKARTA TIMUR, DKI JAKARTA",1,92,150,242
https://kawalpemilu.org#26086,"CIPINANG CEMPEDAK, JATINEGARA, JAKARTA TIMUR, DKI JAKARTA",2,133,100,233
https://kawalpemilu.org#26086,"CIPINANG CEMPEDAK, JATINEGARA, JAKARTA TIMUR, DKI JAKARTA",3,122,110,232
https://kawalpemilu.org#26086,"CIPINANG CEMPEDAK, JATINEGARA, JAKARTA TIMUR, DKI JAKARTA",4,102,134,236
https://kawalpemilu.org#26086,"CIPINANG CEMPEDAK, JATINEGARA, JAKARTA TIMUR, DKI JAKARTA",5,103,132,235
https://kawalpemilu.org#26086,"CIPINANG CEMPEDAK, JATINEGARA, JAKARTA TIMUR, DKI JAKARTA",6,105,83,188
https://kawalpemilu.org#26086,"CIPINANG CEMPEDAK, JATINEGARA, JAKARTA TIMUR, DKI JAKARTA",7,44,161,205
https://kawalpemilu.org#26086,"CIPINANG CEMPEDAK, JATINEGARA, JAKARTA TIMUR, DKI JAKARTA",8,41,188,229
https://kawalpemilu.org#26086,"CIPINANG CEMPEDAK, JATINEGARA, JAKARTA TIMUR, DKI JAKARTA",9,127,125,252
https://kawalpemilu.org#26086,"CIPINANG CEMPEDAK, JATINEGARA, JAKARTA TIMUR, DKI JAKARTA",10,110,112,222
https://kawalpemilu.org#26086,"CIPINANG CEMPEDAK, JATINEGARA, JAKARTA TIMUR, DKI JAKARTA",11,107,129,236
https://kawalpemilu.org#26086,"CIPINANG CEMPEDAK, JATINEGARA, JAKARTA TIMUR, DKI JAKARTA",13,90,161,251
https://kawalpemilu.org#26086,"CIPINANG CEMPEDAK, JATINEGARA, JAKARTA TIMUR, DKI JAKARTA",14,62,173,235
https://kawalpemilu.org#26086,"CIPINANG CEMPEDAK, JATINEGARA, JAKARTA TIMUR, DKI JAKARTA",15,131,90,221
https://kawalpemilu.org#26086,"CIPINANG CEMPEDAK, JATINEGARA, JAKARTA TIMUR, DKI JAKARTA",16,137,82,219
https://kawalpemilu.org#26086,"CIPINANG CEMPEDAK, JATINEGARA, JAKARTA TIMUR, DKI JAKARTA",17,163,93,256
https://kawalpemilu.org#26086,"CIPINANG CEMPEDAK, JATINEGARA, JAKARTA TIMUR, DKI JAKARTA",18,98,145,243
https://kawalpemilu.org#26086,"CIPINANG CEMPEDAK, JATINEGARA, JAKARTA TIMUR, DKI JAKARTA",19,94,135,229
https://kawalpemilu.org#26086,"CIPINANG CEMPEDAK, JATINEGARA, JAKARTA TIMUR, DKI JAKARTA",20,73,137,210
https://kawalpemilu.org#26086,"CIPINANG CEMPEDAK, JATINEGARA, JAKARTA TIMUR, DKI JAKARTA",21,79,171,250
https://kawalpemilu.org#26086,"CIPINANG CEMPEDAK, JATINEGARA, JAKARTA TIMUR, DKI JAKARTA",22,105,133,238
https://kawalpemilu.org#26086,"CIPINANG CEMPEDAK, JATINEGARA, JAKARTA TIMUR, DKI JAKARTA",23,77,162,239
https://kawalpemilu.org#26086,"CIPINANG CEMPEDAK, JATINEGARA, JAKARTA TIMUR, DKI JAKARTA",24,79,159,238
https://kawalpemilu.org#26086,"CIPINANG CEMPEDAK, JATINEGARA, JAKARTA TIMUR, DKI JAKARTA",25,87,156,243
https://kawalpemilu.org#26086,"CIPINANG CEMPEDAK, JATINEGARA, JAKARTA TIMUR, DKI JAKARTA",26,157,60,217
https://kawalpemilu.org#26086,"CIPINANG CEMPEDAK, JATINEGARA, JAKARTA TIMUR, DKI JAKARTA",27,144,97,241
https://kawalpemilu.org#26086,"CIPINANG CEMPEDAK, JATINEGARA, JAKARTA TIMUR, DKI JAKARTA",28,142,71,213
https://kawalpemilu.org#26086,"CIPINANG CEMPEDAK, JATINEGARA, JAKARTA TIMUR, DKI JAKARTA",29,86,163,249
https://kawalpemilu.org#26086,"CIPINANG CEMPEDAK, JATINEGARA, JAKARTA TIMUR, DKI JAKARTA",30,78,158,236
https://kawalpemilu.org#26086,"CIPINANG CEMPEDAK, JATINEGARA, JAKARTA TIMUR, DKI JAKARTA",31,74,153,227
https://kawalpemilu.org#26086,"CIPINANG CEMPEDAK, JATINEGARA, JAKARTA TIMUR, DKI JAKARTA",32,79,149,228
https://kawalpemilu.org#26086,"CIPINANG CEMPEDAK, JATINEGARA, JAKARTA TIMUR, DKI JAKARTA",33,80,152,232
https://kawalpemilu.org#26086,"CIPINANG CEMPEDAK, JATINEGARA, JAKARTA TIMUR, DKI JAKARTA",34,102,116,218
https://kawalpemilu.org#26086,"CIPINANG CEMPEDAK, JATINEGARA, JAKARTA TIMUR, DKI JAKARTA",35,118,106,224
https://kawalpemilu.org#26086,"CIPINANG CEMPEDAK, JATINEGARA, JAKARTA TIMUR, DKI JAKARTA",36,68,165,233
https://kawalpemilu.org#26086,"CIPINANG CEMPEDAK, JATINEGARA, JAKARTA TIMUR, DKI JAKARTA",37,69,168,237
https://kawalpemilu.org#26086,"CIPINANG CEMPEDAK, JATINEGARA, JAKARTA TIMUR, DKI JAKARTA",38,91,143,234
https://kawalpemilu.org#26086,"CIPINANG CEMPEDAK, JATINEGARA, JAKARTA TIMUR, DKI JAKARTA",39,104,116,220
https://kawalpemilu.org#26086,"CIPINANG CEMPEDAK, JATINEGARA, JAKARTA TIMUR, DKI JAKARTA",41,81,149,230
https://kawalpemilu.org#26086,"CIPINANG CEMPEDAK, JATINEGARA, JAKARTA TIMUR, DKI JAKARTA",42,86,171,257
https://kawalpemilu.org#26086,"CIPINANG CEMPEDAK, JATINEGARA, JAKARTA TIMUR, DKI JAKARTA",43,57,190,247
https://kawalpemilu.org#26086,"CIPINANG CEMPEDAK, JATINEGARA, JAKARTA TIMUR, DKI JAKARTA",44,39,201,240
https://kawalpemilu.org#26086,"CIPINANG CEMPEDAK, JATINEGARA, JAKARTA TIMUR, DKI JAKARTA",45,35,151,186
https://kawalpemilu.org#26086,"CIPINANG CEMPEDAK, JATINEGARA, JAKARTA TIMUR, DKI JAKARTA",46,67,148,215
https://kawalpemilu.org#26086,"CIPINANG CEMPEDAK, JATINEGARA, JAKARTA TIMUR, DKI JAKARTA",47,64,183,247
https://kawalpemilu.org#26086,"CIPINANG CEMPEDAK, JATINEGARA, JAKARTA TIMUR, DKI JAKARTA",48,86,170,256
https://kawalpemilu.org#26086,"CIPINANG CEMPEDAK, JATINEGARA, JAKARTA TIMUR, DKI JAKARTA",49,42,223,265
https://kawalpemilu.org#26086,"CIPINANG CEMPEDAK, JATINEGARA, JAKARTA TIMUR, DKI JAKARTA",50,57,201,258
https://kawalpemilu.org#26086,"CIPINANG CEMPEDAK, JATINEGARA, JAKARTA TIMUR, DKI JAKARTA",51,38,203,241
https://kawalpemilu.org#26086,"CIPINANG CEMPEDAK, JATINEGARA, JAKARTA TIMUR, DKI JAKARTA",52,74,204,278
https://kawalpemilu.org#26086,"CIPINANG CEMPEDAK, JATINEGARA, JAKARTA TIMUR, DKI JAKARTA",53,125,96,221
https://kawalpemilu.org#26086,"CIPINANG CEMPEDAK, JATINEGARA, JAKARTA TIMUR, DKI JAKARTA",54,90,155,245
https://kawalpemilu.org#26086,"CIPINANG CEMPEDAK, JATINEGARA, JAKARTA TIMUR, DKI JAKARTA",55,84,157,241
https://kawalpemilu.org#26086,"CIPINANG CEMPEDAK, JATINEGARA, JAKARTA TIMUR, DKI JAKARTA",56,109,128,237
https://kawalpemilu.org#26086,"CIPINANG CEMPEDAK, JATINEGARA, JAKARTA TIMUR, DKI JAKARTA",57,103,143,246
https://kawalpemilu.org#26086,"CIPINANG CEMPEDAK, JATINEGARA, JAKARTA TIMUR, DKI JAKARTA",58,168,76,244
https://kawalpemilu.org#26086,"CIPINANG CEMPEDAK, JATINEGARA, JAKARTA TIMUR, DKI JAKARTA",59,127,119,246
https://kawalpemilu.org#26086,"CIPINANG CEMPEDAK, JATINEGARA, JAKARTA TIMUR, DKI JAKARTA",60,103,152,255
https://kawalpemilu.org#26086,"CIPINANG CEMPEDAK, JATINEGARA, JAKARTA TIMUR, DKI JAKARTA",61,71,125,196
https://kawalpemilu.org#26086,"CIPINANG CEMPEDAK, JATINEGARA, JAKARTA TIMUR, DKI JAKARTA",62,45,163,208
https://kawalpemilu.org#26086,"CIPINANG CEMPEDAK, JATINEGARA, JAKARTA TIMUR, DKI JAKARTA",63,32,182,214
https://kawalpemilu.org#26086,"CIPINANG CEMPEDAK, JATINEGARA, JAKARTA TIMUR, DKI JAKARTA",64,34,176,210
https://kawalpemilu.org#26086,"CIPINANG CEMPEDAK, JATINEGARA, JAKARTA TIMUR, DKI JAKARTA",65,38,186,224
https://kawalpemilu.org#26086,"CIPINANG CEMPEDAK, JATINEGARA, JAKARTA TIMUR, DKI JAKARTA",66,56,173,229
https://kawalpemilu.org#26086,"CIPINANG CEMPEDAK, JATINEGARA, JAKARTA TIMUR, DKI JAKARTA",67,44,197,241
https://kawalpemilu.org#26086,"CIPINANG CEMPEDAK, JATINEGARA, JAKARTA TIMUR, DKI JAKARTA",68,50,164,214
https://kawalpemilu.org#26086,"CIPINANG CEMPEDAK, JATINEGARA, JAKARTA TIMUR, DKI JAKARTA",69,63,167,230
https://kawalpemilu.org#26086,"CIPINANG CEMPEDAK, JATINEGARA, JAKARTA TIMUR, DKI JAKARTA",70,32,211,243
https://kawalpemilu.org#26086,"CIPINANG CEMPEDAK, JATINEGARA, JAKARTA TIMUR, DKI JAKARTA",71,82,160,242
https://kawalpemilu.org#26086,"CIPINANG CEMPEDAK, JATINEGARA, JAKARTA TIMUR, DKI JAKARTA",72,54,194,248
https://kawalpemilu.org#26086,"CIPINANG CEMPEDAK, JATINEGARA, JAKARTA TIMUR, DKI JAKARTA",73,115,130,245
https://kawalpemilu.org#26086,"CIPINANG CEMPEDAK, JATINEGARA, JAKARTA TIMUR, DKI JAKARTA",74,55,183,238
https://kawalpemilu.org#26086,"CIPINANG CEMPEDAK, JATINEGARA, JAKARTA TIMUR, DKI JAKARTA",75,91,144,235
https://kawalpemilu.org#26086,"CIPINANG CEMPEDAK, JATINEGARA, JAKARTA TIMUR, DKI JAKARTA",76,51,174,225
https://kawalpemilu.org#26086,"CIPINANG CEMPEDAK, JATINEGARA, JAKARTA TIMUR, DKI JAKARTA",77,56,206,262
https://kawalpemilu.org#26086,"CIPINANG CEMPEDAK, JATINEGARA, JAKARTA TIMUR, DKI JAKARTA",78,52,194,246
https://kawalpemilu.org#26086,"CIPINANG CEMPEDAK, JATINEGARA, JAKARTA TIMUR, DKI JAKARTA",79,67,177,244
https://kawalpemilu.org#26086,"CIPINANG CEMPEDAK, JATINEGARA, JAKARTA TIMUR, DKI JAKARTA",80,67,191,258
https://kawalpemilu.org#26086,"CIPINANG CEMPEDAK, JATINEGARA, JAKARTA TIMUR, DKI JAKARTA",81,56,196,252
https://kawalpemilu.org#26086,"CIPINANG CEMPEDAK, JATINEGARA, JAKARTA TIMUR, DKI JAKARTA",82,91,168,259
https://kawalpemilu.org#26086,"CIPINANG CEMPEDAK, JATINEGARA, JAKARTA TIMUR, DKI JAKARTA",83,74,162,236
https://kawalpemilu.org#26086,"CIPINANG CEMPEDAK, JATINEGARA, JAKARTA TIMUR, DKI JAKARTA",84,88,146,234
https://kawalpemilu.org#26086,"CIPINANG CEMPEDAK, JATINEGARA, JAKARTA TIMUR, DKI JAKARTA",85,165,83,248
https://kawalpemilu.org#26086,"CIPINANG CEMPEDAK, JATINEGARA, JAKARTA TIMUR, DKI JAKARTA",86,142,96,238
https://kawalpemilu.org#26086,"CIPINANG CEMPEDAK, JATINEGARA, JAKARTA TIMUR, DKI JAKARTA",87,160,81,241
https://kawalpemilu.org#26086,"CIPINANG CEMPEDAK, JATINEGARA, JAKARTA TIMUR, DKI JAKARTA",88,177,58,235
https://kawalpemilu.org#26086,"CIPINANG CEMPEDAK, JATINEGARA, JAKARTA TIMUR, DKI JAKARTA",89,185,58,243
https://kawalpemilu.org#26086,"CIPINANG CEMPEDAK, JATINEGARA, JAKARTA TIMUR, DKI JAKARTA",90,181,60,241
https://kawalpemilu.org#26086,"CIPINANG CEMPEDAK, JATINEGARA, JAKARTA TIMUR, DKI JAKARTA",91,244,29,253
https://kawalpemilu.org#26086,"CIPINANG CEMPEDAK, JATINEGARA, JAKARTA TIMUR, DKI JAKARTA",92,163,57,220
https://kawalpemilu.org#26086,"CIPINANG CEMPEDAK, JATINEGARA, JAKARTA TIMUR, DKI JAKARTA",93,180,56,236
https://kawalpemilu.org#26086,"CIPINANG CEMPEDAK, JATINEGARA, JAKARTA TIMUR, DKI JAKARTA",94,150,81,231
https://kawalpemilu.org#26086,"CIPINANG CEMPEDAK, JATINEGARA, JAKARTA TIMUR, DKI JAKARTA",95,182,26,208
https://kawalpemilu.org#26086,"CIPINANG CEMPEDAK, JATINEGARA, JAKARTA TIMUR, DKI JAKARTA",96,120,107,227
https://kawalpemilu.org#26086,"CIPINANG CEMPEDAK, JATINEGARA, JAKARTA TIMUR, DKI JAKARTA",97,90,132,222
https://kawalpemilu.org#26086,"CIPINANG CEMPEDAK, JATINEGARA, JAKARTA TIMUR, DKI JAKARTA",98,141,88,229
https://kawalpemilu.org#26086,"CIPINANG CEMPEDAK, JATINEGARA, JAKARTA TIMUR, DKI JAKARTA",99,177,26,203
https://kawalpemilu.org#26086,"CIPINANG CEMPEDAK, JATINEGARA, JAKARTA TIMUR, DKI JAKARTA",100,190,29,219
https://kawalpemilu.org#26086,"CIPINANG CEMPEDAK, JATINEGARA, JAKARTA TIMUR, DKI JAKARTA",101,191,39,230
https://kawalpemilu.org#26086,"CIPINANG CEMPEDAK, JATINEGARA, JAKARTA TIMUR, DKI JAKARTA",102,168,37,205
https://kawalpemilu.org#26086,"CIPINANG CEMPEDAK, JATINEGARA, JAKARTA TIMUR, DKI JAKARTA",103,207,21,228
https://kawalpemilu.org#26086,"CIPINANG CEMPEDAK, JATINEGARA, JAKARTA TIMUR, DKI JAKARTA",104,181,45,226
https://kawalpemilu.org#26086,"CIPINANG CEMPEDAK, JATINEGARA, JAKARTA TIMUR, DKI JAKARTA",105,228,31,259
https://kawalpemilu.org#26086,"CIPINANG CEMPEDAK, JATINEGARA, JAKARTA TIMUR, DKI JAKARTA",106,53,196,249
https://kawalpemilu.org#26086,"CIPINANG CEMPEDAK, JATINEGARA, JAKARTA TIMUR, DKI JAKARTA",107,36,129,165
https://kawalpemilu.org#26087,"CIPINANG MUARA, JATINEGARA, JAKARTA TIMUR, DKI JAKARTA",1,102,143,245
https://kawalpemilu.org#26087,"CIPINANG MUARA, JATINEGARA, JAKARTA TIMUR, DKI JAKARTA",2,72,173,245
https://kawalpemilu.org#26087,"CIPINANG MUARA, JATINEGARA, JAKARTA TIMUR, DKI JAKARTA",3,99,141,240
https://kawalpemilu.org#26087,"CIPINANG MUARA, JATINEGARA, JAKARTA TIMUR, DKI JAKARTA",4,98,153,251
https://kawalpemilu.org#26087,"CIPINANG MUARA, JATINEGARA, JAKARTA TIMUR, DKI JAKARTA",5,104,149,253
https://kawalpemilu.org#26087,"CIPINANG MUARA, JATINEGARA, JAKARTA TIMUR, DKI JAKARTA",7,118,111,229
https://kawalpemilu.org#26087,"CIPINANG MUARA, JATINEGARA, JAKARTA TIMUR, DKI JAKARTA",8,123,123,246
https://kawalpemilu.org#26087,"CIPINANG MUARA, JATINEGARA, JAKARTA TIMUR, DKI JAKARTA",9,107,115,1
https://kawalpemilu.org#26087,"CIPINANG MUARA, JATINEGARA, JAKARTA TIMUR, DKI JAKARTA",11,94,148,242
https://kawalpemilu.org#26087,"CIPINANG MUARA, JATINEGARA, JAKARTA TIMUR, DKI JAKARTA",12,108,115,223
https://kawalpemilu.org#26087,"CIPINANG MUARA, JATINEGARA, JAKARTA TIMUR, DKI JAKARTA",13,101,113,214
https://kawalpemilu.org#26087,"CIPINANG MUARA, JATINEGARA, JAKARTA TIMUR, DKI JAKARTA",14,102,162,264
https://kawalpemilu.org#26087,"CIPINANG MUARA, JATINEGARA, JAKARTA TIMUR, DKI JAKARTA",15,87,166,253
https://kawalpemilu.org#26087,"CIPINANG MUARA, JATINEGARA, JAKARTA TIMUR, DKI JAKARTA",16,108,142,250
https://kawalpemilu.org#26087,"CIPINANG MUARA, JATINEGARA, JAKARTA TIMUR, DKI JAKARTA",17,85,141,226
https://kawalpemilu.org#26087,"CIPINANG MUARA, JATINEGARA, JAKARTA TIMUR, DKI JAKARTA",18,105,158,263
https://kawalpemilu.org#26087,"CIPINANG MUARA, JATINEGARA, JAKARTA TIMUR, DKI JAKARTA",20,143,120,263
https://kawalpemilu.org#26087,"CIPINANG MUARA, JATINEGARA, JAKARTA TIMUR, DKI JAKARTA",21,119,138,257
https://kawalpemilu.org#26087,"CIPINANG MUARA, JATINEGARA, JAKARTA TIMUR, DKI JAKARTA",22,97,98,195
https://kawalpemilu.org#26087,"CIPINANG MUARA, JATINEGARA, JAKARTA TIMUR, DKI JAKARTA",23,115,108,223
https://kawalpemilu.org#26087,"CIPINANG MUARA, JATINEGARA, JAKARTA TIMUR, DKI JAKARTA",24,109,118,227
https://kawalpemilu.org#26087,"CIPINANG MUARA, JATINEGARA, JAKARTA TIMUR, DKI JAKARTA",25,105,138,243
https://kawalpemilu.org#26087,"CIPINANG MUARA, JATINEGARA, JAKARTA TIMUR, DKI JAKARTA",26,132,102,234
https://kawalpemilu.org#26087,"CIPINANG MUARA, JATINEGARA, JAKARTA TIMUR, DKI JAKARTA",27,150,95,245
https://kawalpemilu.org#26087,"CIPINANG MUARA, JATINEGARA, JAKARTA TIMUR, DKI JAKARTA",28,113,123,236
https://kawalpemilu.org#26087,"CIPINANG MUARA, JATINEGARA, JAKARTA TIMUR, DKI JAKARTA",29,144,88,232
https://kawalpemilu.org#26087,"CIPINANG MUARA, JATINEGARA, JAKARTA TIMUR, DKI JAKARTA",30,148,97,245
https://kawalpemilu.org#26087,"CIPINANG MUARA, JATINEGARA, JAKARTA TIMUR, DKI JAKARTA",31,109,118,227
https://kawalpemilu.org#26087,"CIPINANG MUARA, JATINEGARA, JAKARTA TIMUR, DKI JAKARTA",32,123,106,229
https://kawalpemilu.org#26087,"CIPINANG MUARA, JATINEGARA, JAKARTA TIMUR, DKI JAKARTA",33,83,163,246
https://kawalpemilu.org#26087,"CIPINANG MUARA, JATINEGARA, JAKARTA TIMUR, DKI JAKARTA",34,63,211,274
https://kawalpemilu.org#26087,"CIPINANG MUARA, JATINEGARA, JAKARTA TIMUR, DKI JAKARTA",35,53,126,179
https://kawalpemilu.org#26087,"CIPINANG MUARA, JATINEGARA, JAKARTA TIMUR, DKI JAKARTA",38,66,104,170
https://kawalpemilu.org#26087,"CIPINANG MUARA, JATINEGARA, JAKARTA TIMUR, DKI JAKARTA",39,97,165,262
https://kawalpemilu.org#26087,"CIPINANG MUARA, JATINEGARA, JAKARTA TIMUR, DKI JAKARTA",40,83,164,247
https://kawalpemilu.org#26087,"CIPINANG MUARA, JATINEGARA, JAKARTA TIMUR, DKI JAKARTA",41,123,116,239
https://kawalpemilu.org#26087,"CIPINANG MUARA, JATINEGARA, JAKARTA TIMUR, DKI JAKARTA",42,131,67,198
https://kawalpemilu.org#26087,"CIPINANG MUARA, JATINEGARA, JAKARTA TIMUR, DKI JAKARTA",43,84,167,251
https://kawalpemilu.org#26087,"CIPINANG MUARA, JATINEGARA, JAKARTA TIMUR, DKI JAKARTA",44,75,124,199
https://kawalpemilu.org#26087,"CIPINANG MUARA, JATINEGARA, JAKARTA TIMUR, DKI JAKARTA",46,96,135,231
https://kawalpemilu.org#26087,"CIPINANG MUARA, JATINEGARA, JAKARTA TIMUR, DKI JAKARTA",47,159,88,247
https://kawalpemilu.org#26087,"CIPINANG MUARA, JATINEGARA, JAKARTA TIMUR, DKI JAKARTA",48,137,140,277
https://kawalpemilu.org#26087,"CIPINANG MUARA, JATINEGARA, JAKARTA TIMUR, DKI JAKARTA",49,136,129,265
https://kawalpemilu.org#26087,"CIPINANG MUARA, JATINEGARA, JAKARTA TIMUR, DKI JAKARTA",52,144,96,240
https://kawalpemilu.org#26087,"CIPINANG MUARA, JATINEGARA, JAKARTA TIMUR, DKI JAKARTA",53,123,111,234
https://kawalpemilu.org#26087,"CIPINANG MUARA, JATINEGARA, JAKARTA TIMUR, DKI JAKARTA",54,76,176,243
https://kawalpemilu.org#26087,"CIPINANG MUARA, JATINEGARA, JAKARTA TIMUR, DKI JAKARTA",55,105,158,263
https://kawalpemilu.org#26087,"CIPINANG MUARA, JATINEGARA, JAKARTA TIMUR, DKI JAKARTA",56,147,68,215
https://kawalpemilu.org#26087,"CIPINANG MUARA, JATINEGARA, JAKARTA TIMUR, DKI JAKARTA",57,96,152,248
https://kawalpemilu.org#26087,"CIPINANG MUARA, JATINEGARA, JAKARTA TIMUR, DKI JAKARTA",59,108,131,239
https://kawalpemilu.org#26087,"CIPINANG MUARA, JATINEGARA, JAKARTA TIMUR, DKI JAKARTA",60,105,126,231
https://kawalpemilu.org#26087,"CIPINANG MUARA, JATINEGARA, JAKARTA TIMUR, DKI JAKARTA",61,99,138,237
https://kawalpemilu.org#26087,"CIPINANG MUARA, JATINEGARA, JAKARTA TIMUR, DKI JAKARTA",62,183,59,242
https://kawalpemilu.org#26087,"CIPINANG MUARA, JATINEGARA, JAKARTA TIMUR, DKI JAKARTA",63,84,139,223
https://kawalpemilu.org#26087,"CIPINANG MUARA, JATINEGARA, JAKARTA TIMUR, DKI JAKARTA",64,101,154,255
https://kawalpemilu.org#26087,"CIPINANG MUARA, JATINEGARA, JAKARTA TIMUR, DKI JAKARTA",65,95,173,268
https://kawalpemilu.org#26087,"CIPINANG MUARA, JATINEGARA, JAKARTA TIMUR, DKI JAKARTA",66,97,137,234
https://kawalpemilu.org#26087,"CIPINANG MUARA, JATINEGARA, JAKARTA TIMUR, DKI JAKARTA",67,109,116,225
https://kawalpemilu.org#26087,"CIPINANG MUARA, JATINEGARA, JAKARTA TIMUR, DKI JAKARTA",68,108,153,261
https://kawalpemilu.org#26087,"CIPINANG MUARA, JATINEGARA, JAKARTA TIMUR, DKI JAKARTA",70,142,76,218
https://kawalpemilu.org#26087,"CIPINANG MUARA, JATINEGARA, JAKARTA TIMUR, DKI JAKARTA",71,96,109,205
https://kawalpemilu.org#26087,"CIPINANG MUARA, JATINEGARA, JAKARTA TIMUR, DKI JAKARTA",72,44,212,256
https://kawalpemilu.org#26087,"CIPINANG MUARA, JATINEGARA, JAKARTA TIMUR, DKI JAKARTA",73,77,164,241
https://kawalpemilu.org#26087,"CIPINANG MUARA, JATINEGARA, JAKARTA TIMUR, DKI JAKARTA",74,76,195,271
https://kawalpemilu.org#26087,"CIPINANG MUARA, JATINEGARA, JAKARTA TIMUR, DKI JAKARTA",75,78,131,209
https://kawalpemilu.org#26087,"CIPINANG MUARA, JATINEGARA, JAKARTA TIMUR, DKI JAKARTA",76,92,154,246
https://kawalpemilu.org#26087,"CIPINANG MUARA, JATINEGARA, JAKARTA TIMUR, DKI JAKARTA",77,91,145,236
https://kawalpemilu.org#26087,"CIPINANG MUARA, JATINEGARA, JAKARTA TIMUR, DKI JAKARTA",78,83,165,248
https://kawalpemilu.org#26087,"CIPINANG MUARA, JATINEGARA, JAKARTA TIMUR, DKI JAKARTA",79,102,146,248
https://kawalpemilu.org#26087,"CIPINANG MUARA, JATINEGARA, JAKARTA TIMUR, DKI JAKARTA",80,148,70,218
https://kawalpemilu.org#26087,"CIPINANG MUARA, JATINEGARA, JAKARTA TIMUR, DKI JAKARTA",81,120,138,258
https://kawalpemilu.org#26087,"CIPINANG MUARA, JATINEGARA, JAKARTA TIMUR, DKI JAKARTA",82,124,122,246
https://kawalpemilu.org#26087,"CIPINANG MUARA, JATINEGARA, JAKARTA TIMUR, DKI JAKARTA",83,150,92,242
https://kawalpemilu.org#26087,"CIPINANG MUARA, JATINEGARA, JAKARTA TIMUR, DKI JAKARTA",85,133,125,258
https://kawalpemilu.org#26087,"CIPINANG MUARA, JATINEGARA, JAKARTA TIMUR, DKI JAKARTA",87,107,132,239
https://kawalpemilu.org#26087,"CIPINANG MUARA, JATINEGARA, JAKARTA TIMUR, DKI JAKARTA",88,177,102,279
https://kawalpemilu.org#26087,"CIPINANG MUARA, JATINEGARA, JAKARTA TIMUR, DKI JAKARTA",89,106,159,265
https://kawalpemilu.org#26087,"CIPINANG MUARA, JATINEGARA, JAKARTA TIMUR, DKI JAKARTA",90,120,134,254
https://kawalpemilu.org#26087,"CIPINANG MUARA, JATINEGARA, JAKARTA TIMUR, DKI JAKARTA",92,65,110,175
https://kawalpemilu.org#26087,"CIPINANG MUARA, JATINEGARA, JAKARTA TIMUR, DKI JAKARTA",93,40,150,190
https://kawalpemilu.org#26087,"CIPINANG MUARA, JATINEGARA, JAKARTA TIMUR, DKI JAKARTA",94,76,189,265
https://kawalpemilu.org#26087,"CIPINANG MUARA, JATINEGARA, JAKARTA TIMUR, DKI JAKARTA",95,65,134,199
https://kawalpemilu.org#26087,"CIPINANG MUARA, JATINEGARA, JAKARTA TIMUR, DKI JAKARTA",96,97,162,259
https://kawalpemilu.org#26087,"CIPINANG MUARA, JATINEGARA, JAKARTA TIMUR, DKI JAKARTA",97,111,158,269
https://kawalpemilu.org#26087,"CIPINANG MUARA, JATINEGARA, JAKARTA TIMUR, DKI JAKARTA",99,116,120,236
https://kawalpemilu.org#26087,"CIPINANG MUARA, JATINEGARA, JAKARTA TIMUR, DKI JAKARTA",100,125,132,257
https://kawalpemilu.org#26087,"CIPINANG MUARA, JATINEGARA, JAKARTA TIMUR, DKI JAKARTA",101,118,146,264
https://kawalpemilu.org#26087,"CIPINANG MUARA, JATINEGARA, JAKARTA TIMUR, DKI JAKARTA",102,89,160,249
https://kawalpemilu.org#26087,"CIPINANG MUARA, JATINEGARA, JAKARTA TIMUR, DKI JAKARTA",103,45,137,182
https://kawalpemilu.org#26087,"CIPINANG MUARA, JATINEGARA, JAKARTA TIMUR, DKI JAKARTA",104,59,201,260
https://kawalpemilu.org#26087,"CIPINANG MUARA, JATINEGARA, JAKARTA TIMUR, DKI JAKARTA",105,126,125,251
https://kawalpemilu.org#26087,"CIPINANG MUARA, JATINEGARA, JAKARTA TIMUR, DKI JAKARTA",106,140,77,217
https://kawalpemilu.org#26087,"CIPINANG MUARA, JATINEGARA, JAKARTA TIMUR, DKI JAKARTA",107,135,73,208
https://kawalpemilu.org#26087,"CIPINANG MUARA, JATINEGARA, JAKARTA TIMUR, DKI JAKARTA",108,149,62,211
https://kawalpemilu.org#26087,"CIPINANG MUARA, JATINEGARA, JAKARTA TIMUR, DKI JAKARTA",109,86,45,131
https://kawalpemilu.org#26087,"CIPINANG MUARA, JATINEGARA, JAKARTA TIMUR, DKI JAKARTA",110,211,37,248
https://kawalpemilu.org#26087,"CIPINANG MUARA, JATINEGARA, JAKARTA TIMUR, DKI JAKARTA",111,205,25,230
https://kawalpemilu.org#26087,"CIPINANG MUARA, JATINEGARA, JAKARTA TIMUR, DKI JAKARTA",112,208,26,234
https://kawalpemilu.org#26087,"CIPINANG MUARA, JATINEGARA, JAKARTA TIMUR, DKI JAKARTA",113,191,25,216
https://kawalpemilu.org#26087,"CIPINANG MUARA, JATINEGARA, JAKARTA TIMUR, DKI JAKARTA",114,218,9,227
https://kawalpemilu.org#26087,"CIPINANG MUARA, JATINEGARA, JAKARTA TIMUR, DKI JAKARTA",115,243,17,260
https://kawalpemilu.org#26087,"CIPINANG MUARA, JATINEGARA, JAKARTA TIMUR, DKI JAKARTA",116,202,46,248
https://kawalpemilu.org#26087,"CIPINANG MUARA, JATINEGARA, JAKARTA TIMUR, DKI JAKARTA",117,88,141,229
https://kawalpemilu.org#26087,"CIPINANG MUARA, JATINEGARA, JAKARTA TIMUR, DKI JAKARTA",119,96,132,228
https://kawalpemilu.org#26087,"CIPINANG MUARA, JATINEGARA, JAKARTA TIMUR, DKI JAKARTA",120,94,154,248
https://kawalpemilu.org#26087,"CIPINANG MUARA, JATINEGARA, JAKARTA TIMUR, DKI JAKARTA",121,110,118,228
https://kawalpemilu.org#26087,"CIPINANG MUARA, JATINEGARA, JAKARTA TIMUR, DKI JAKARTA",124,126,92,218
https://kawalpemilu.org#26087,"CIPINANG MUARA, JATINEGARA, JAKARTA TIMUR, DKI JAKARTA",125,100,115,215
https://kawalpemilu.org#26087,"CIPINANG MUARA, JATINEGARA, JAKARTA TIMUR, DKI JAKARTA",126,78,156,234
https://kawalpemilu.org#26087,"CIPINANG MUARA, JATINEGARA, JAKARTA TIMUR, DKI JAKARTA",127,142,91,233
https://kawalpemilu.org#26087,"CIPINANG MUARA, JATINEGARA, JAKARTA TIMUR, DKI JAKARTA",128,134,96,230
https://kawalpemilu.org#26087,"CIPINANG MUARA, JATINEGARA, JAKARTA TIMUR, DKI JAKARTA",129,131,111,242
https://kawalpemilu.org#26087,"CIPINANG MUARA, JATINEGARA, JAKARTA TIMUR, DKI JAKARTA",130,121,103,224
https://kawalpemilu.org#26087,"CIPINANG MUARA, JATINEGARA, JAKARTA TIMUR, DKI JAKARTA",131,134,107,241
https://kawalpemilu.org#26087,"CIPINANG MUARA, JATINEGARA, JAKARTA TIMUR, DKI JAKARTA",132,120,94,214
https://kawalpemilu.org#26087,"CIPINANG MUARA, JATINEGARA, JAKARTA TIMUR, DKI JAKARTA",133,90,137,227
https://kawalpemilu.org#26087,"CIPINANG MUARA, JATINEGARA, JAKARTA TIMUR, DKI JAKARTA",134,107,135,242
https://kawalpemilu.org#26087,"CIPINANG MUARA, JATINEGARA, JAKARTA TIMUR, DKI JAKARTA",135,132,98,230
https://kawalpemilu.org#26087,"CIPINANG MUARA, JATINEGARA, JAKARTA TIMUR, DKI JAKARTA",136,114,79,193
https://kawalpemilu.org#26087,"CIPINANG MUARA, JATINEGARA, JAKARTA TIMUR, DKI JAKARTA",137,115,103,218
https://kawalpemilu.org#26087,"CIPINANG MUARA, JATINEGARA, JAKARTA TIMUR, DKI JAKARTA",138,110,132,242
https://kawalpemilu.org#26087,"CIPINANG MUARA, JATINEGARA, JAKARTA TIMUR, DKI JAKARTA",139,89,63,152
https://kawalpemilu.org#26087,"CIPINANG MUARA, JATINEGARA, JAKARTA TIMUR, DKI JAKARTA",140,105,104,209
https://kawalpemilu.org#26087,"CIPINANG MUARA, JATINEGARA, JAKARTA TIMUR, DKI JAKARTA",141,118,102,220
https://kawalpemilu.org#26087,"CIPINANG MUARA, JATINEGARA, JAKARTA TIMUR, DKI JAKARTA",142,92,134,226
https://kawalpemilu.org#26087,"CIPINANG MUARA, JATINEGARA, JAKARTA TIMUR, DKI JAKARTA",143,116,128,244
https://kawalpemilu.org#26087,"CIPINANG MUARA, JATINEGARA, JAKARTA TIMUR, DKI JAKARTA",144,98,151,249
https://kawalpemilu.org#26087,"CIPINANG MUARA, JATINEGARA, JAKARTA TIMUR, DKI JAKARTA",145,85,178,263
https://kawalpemilu.org#26087,"CIPINANG MUARA, JATINEGARA, JAKARTA TIMUR, DKI JAKARTA",146,122,135,257
https://kawalpemilu.org#26087,"CIPINANG MUARA, JATINEGARA, JAKARTA TIMUR, DKI JAKARTA",147,98,165,263
https://kawalpemilu.org#26087,"CIPINANG MUARA, JATINEGARA, JAKARTA TIMUR, DKI JAKARTA",150,136,135,271
https://kawalpemilu.org#26087,"CIPINANG MUARA, JATINEGARA, JAKARTA TIMUR, DKI JAKARTA",151,90,163,253
https://kawalpemilu.org#26087,"CIPINANG MUARA, JATINEGARA, JAKARTA TIMUR, DKI JAKARTA",152,60,192,252
https://kawalpemilu.org#26087,"CIPINANG MUARA, JATINEGARA, JAKARTA TIMUR, DKI JAKARTA",154,100,133,233
https://kawalpemilu.org#26087,"CIPINANG MUARA, JATINEGARA, JAKARTA TIMUR, DKI JAKARTA",155,127,104,231
https://kawalpemilu.org#26087,"CIPINANG MUARA, JATINEGARA, JAKARTA TIMUR, DKI JAKARTA",156,118,115,233
https://kawalpemilu.org#26087,"CIPINANG MUARA, JATINEGARA, JAKARTA TIMUR, DKI JAKARTA",157,126,133,259
https://kawalpemilu.org#26087,"CIPINANG MUARA, JATINEGARA, JAKARTA TIMUR, DKI JAKARTA",159,123,124,147
https://kawalpemilu.org#26087,"CIPINANG MUARA, JATINEGARA, JAKARTA TIMUR, DKI JAKARTA",160,123,107,230
https://kawalpemilu.org#26087,"CIPINANG MUARA, JATINEGARA, JAKARTA TIMUR, DKI JAKARTA",161,143,103,246
https://kawalpemilu.org#26087,"CIPINANG MUARA, JATINEGARA, JAKARTA TIMUR, DKI JAKARTA",162,145,118,263
https://kawalpemilu.org#26087,"CIPINANG MUARA, JATINEGARA, JAKARTA TIMUR, DKI JAKARTA",163,115,117,232
https://kawalpemilu.org#26087,"CIPINANG MUARA, JATINEGARA, JAKARTA TIMUR, DKI JAKARTA",165,159,51,210
https://kawalpemilu.org#26087,"CIPINANG MUARA, JATINEGARA, JAKARTA TIMUR, DKI JAKARTA",166,155,62,217
https://kawalpemilu.org#26087,"CIPINANG MUARA, JATINEGARA, JAKARTA TIMUR, DKI JAKARTA",167,125,75,200
https://kawalpemilu.org#26087,"CIPINANG MUARA, JATINEGARA, JAKARTA TIMUR, DKI JAKARTA",168,141,45,186
https://kawalpemilu.org#26087,"CIPINANG MUARA, JATINEGARA, JAKARTA TIMUR, DKI JAKARTA",169,81,135,216
https://kawalpemilu.org#26087,"CIPINANG MUARA, JATINEGARA, JAKARTA TIMUR, DKI JAKARTA",170,64,191,255
https://kawalpemilu.org#26087,"CIPINANG MUARA, JATINEGARA, JAKARTA TIMUR, DKI JAKARTA",171,93,105,198
https://kawalpemilu.org#26087,"CIPINANG MUARA, JATINEGARA, JAKARTA TIMUR, DKI JAKARTA",172,96,84,180
https://kawalpemilu.org#26088,"CIPINANG BESAR SELATAN, JATINEGARA, JAKARTA TIMUR, DKI JAKARTA",1,96,130,226
https://kawalpemilu.org#26088,"CIPINANG BESAR SELATAN, JATINEGARA, JAKARTA TIMUR, DKI JAKARTA",2,116,114,230
https://kawalpemilu.org#26088,"CIPINANG BESAR SELATAN, JATINEGARA, JAKARTA TIMUR, DKI JAKARTA",3,82,139,221
https://kawalpemilu.org#26088,"CIPINANG BESAR SELATAN, JATINEGARA, JAKARTA TIMUR, DKI JAKARTA",4,115,139,254
https://kawalpemilu.org#26088,"CIPINANG BESAR SELATAN, JATINEGARA, JAKARTA TIMUR, DKI JAKARTA",5,84,149,233
https://kawalpemilu.org#26088,"CIPINANG BESAR SELATAN, JATINEGARA, JAKARTA TIMUR, DKI JAKARTA",6,75,185,260
https://kawalpemilu.org#26088,"CIPINANG BESAR SELATAN, JATINEGARA, JAKARTA TIMUR, DKI JAKARTA",7,64,194,258
https://kawalpemilu.org#26088,"CIPINANG BESAR SELATAN, JATINEGARA, JAKARTA TIMUR, DKI JAKARTA",8,89,154,243
https://kawalpemilu.org#26088,"CIPINANG BESAR SELATAN, JATINEGARA, JAKARTA TIMUR, DKI JAKARTA",9,97,133,230
https://kawalpemilu.org#26088,"CIPINANG BESAR SELATAN, JATINEGARA, JAKARTA TIMUR, DKI JAKARTA",10,112,123,235
https://kawalpemilu.org#26088,"CIPINANG BESAR SELATAN, JATINEGARA, JAKARTA TIMUR, DKI JAKARTA",12,118,133,251
https://kawalpemilu.org#26088,"CIPINANG BESAR SELATAN, JATINEGARA, JAKARTA TIMUR, DKI JAKARTA",13,104,142,246
https://kawalpemilu.org#26088,"CIPINANG BESAR SELATAN, JATINEGARA, JAKARTA TIMUR, DKI JAKARTA",14,117,134,251
https://kawalpemilu.org#26088,"CIPINANG BESAR SELATAN, JATINEGARA, JAKARTA TIMUR, DKI JAKARTA",15,117,127,244
https://kawalpemilu.org#26088,"CIPINANG BESAR SELATAN, JATINEGARA, JAKARTA TIMUR, DKI JAKARTA",16,173,65,238
https://kawalpemilu.org#26088,"CIPINANG BESAR SELATAN, JATINEGARA, JAKARTA TIMUR, DKI JAKARTA",17,150,107,257
https://kawalpemilu.org#26088,"CIPINANG BESAR SELATAN, JATINEGARA, JAKARTA TIMUR, DKI JAKARTA",21,113,125,238
https://kawalpemilu.org#26088,"CIPINANG BESAR SELATAN, JATINEGARA, JAKARTA TIMUR, DKI JAKARTA",22,116,113,229
https://kawalpemilu.org#26088,"CIPINANG BESAR SELATAN, JATINEGARA, JAKARTA TIMUR, DKI JAKARTA",25,140,99,239
https://kawalpemilu.org#26088,"CIPINANG BESAR SELATAN, JATINEGARA, JAKARTA TIMUR, DKI JAKARTA",26,106,120,226
https://kawalpemilu.org#26088,"CIPINANG BESAR SELATAN, JATINEGARA, JAKARTA TIMUR, DKI JAKARTA",27,81,161,242
https://kawalpemilu.org#26088,"CIPINANG BESAR SELATAN, JATINEGARA, JAKARTA TIMUR, DKI JAKARTA",28,78,176,254
https://kawalpemilu.org#26088,"CIPINANG BESAR SELATAN, JATINEGARA, JAKARTA TIMUR, DKI JAKARTA",29,82,127,209
https://kawalpemilu.org#26088,"CIPINANG BESAR SELATAN, JATINEGARA, JAKARTA TIMUR, DKI JAKARTA",30,103,112,215
https://kawalpemilu.org#26088,"CIPINANG BESAR SELATAN, JATINEGARA, JAKARTA TIMUR, DKI JAKARTA",31,125,108,233
https://kawalpemilu.org#26088,"CIPINANG BESAR SELATAN, JATINEGARA, JAKARTA TIMUR, DKI JAKARTA",32,132,112,244
https://kawalpemilu.org#26088,"CIPINANG BESAR SELATAN, JATINEGARA, JAKARTA TIMUR, DKI JAKARTA",33,114,114,228
https://kawalpemilu.org#26088,"CIPINANG BESAR SELATAN, JATINEGARA, JAKARTA TIMUR, DKI JAKARTA",34,108,134,242
https://kawalpemilu.org#26088,"CIPINANG BESAR SELATAN, JATINEGARA, JAKARTA TIMUR, DKI JAKARTA",36,139,99,238
https://kawalpemilu.org#26088,"CIPINANG BESAR SELATAN, JATINEGARA, JAKARTA TIMUR, DKI JAKARTA",37,85,151,236
https://kawalpemilu.org#26088,"CIPINANG BESAR SELATAN, JATINEGARA, JAKARTA TIMUR, DKI JAKARTA",39,90,137,227
https://kawalpemilu.org#26088,"CIPINANG BESAR SELATAN, JATINEGARA, JAKARTA TIMUR, DKI JAKARTA",40,20,243,263
https://kawalpemilu.org#26088,"CIPINANG BESAR SELATAN, JATINEGARA, JAKARTA TIMUR, DKI JAKARTA",41,63,186,249
https://kawalpemilu.org#26088,"CIPINANG BESAR SELATAN, JATINEGARA, JAKARTA TIMUR, DKI JAKARTA",44,124,116,240
https://kawalpemilu.org#26088,"CIPINANG BESAR SELATAN, JATINEGARA, JAKARTA TIMUR, DKI JAKARTA",45,121,118,239
https://kawalpemilu.org#26088,"CIPINANG BESAR SELATAN, JATINEGARA, JAKARTA TIMUR, DKI JAKARTA",46,108,122,230
https://kawalpemilu.org#26088,"CIPINANG BESAR SELATAN, JATINEGARA, JAKARTA TIMUR, DKI JAKARTA",49,147,112,259
https://kawalpemilu.org#26088,"CIPINANG BESAR SELATAN, JATINEGARA, JAKARTA TIMUR, DKI JAKARTA",50,120,124,244
https://kawalpemilu.org#26088,"CIPINANG BESAR SELATAN, JATINEGARA, JAKARTA TIMUR, DKI JAKARTA",51,91,141,232
https://kawalpemilu.org#26088,"CIPINANG BESAR SELATAN, JATINEGARA, JAKARTA TIMUR, DKI JAKARTA",52,110,122,232
https://kawalpemilu.org#26088,"CIPINANG BESAR SELATAN, JATINEGARA, JAKARTA TIMUR, DKI JAKARTA",53,80,150,230
https://kawalpemilu.org#26088,"CIPINANG BESAR SELATAN, JATINEGARA, JAKARTA TIMUR, DKI JAKARTA",54,136,85,221
https://kawalpemilu.org#26088,"CIPINANG BESAR SELATAN, JATINEGARA, JAKARTA TIMUR, DKI JAKARTA",55,79,147,226
https://kawalpemilu.org#26088,"CIPINANG BESAR SELATAN, JATINEGARA, JAKARTA TIMUR, DKI JAKARTA",56,63,180,243
https://kawalpemilu.org#26088,"CIPINANG BESAR SELATAN, JATINEGARA, JAKARTA TIMUR, DKI JAKARTA",57,128,127,255
https://kawalpemilu.org#26088,"CIPINANG BESAR SELATAN, JATINEGARA, JAKARTA TIMUR, DKI JAKARTA",59,80,150,230
https://kawalpemilu.org#26088,"CIPINANG BESAR SELATAN, JATINEGARA, JAKARTA TIMUR, DKI JAKARTA",60,80,114,194
https://kawalpemilu.org#26088,"CIPINANG BESAR SELATAN, JATINEGARA, JAKARTA TIMUR, DKI JAKARTA",61,99,115,214
https://kawalpemilu.org#26088,"CIPINANG BESAR SELATAN, JATINEGARA, JAKARTA TIMUR, DKI JAKARTA",62,95,73,168
https://kawalpemilu.org#26088,"CIPINANG BESAR SELATAN, JATINEGARA, JAKARTA TIMUR, DKI JAKARTA",63,87,107,194
https://kawalpemilu.org#26088,"CIPINANG BESAR SELATAN, JATINEGARA, JAKARTA TIMUR, DKI JAKARTA",66,166,73,239
https://kawalpemilu.org#26088,"CIPINANG BESAR SELATAN, JATINEGARA, JAKARTA TIMUR, DKI JAKARTA",67,145,72,217
https://kawalpemilu.org#26088,"CIPINANG BESAR SELATAN, JATINEGARA, JAKARTA TIMUR, DKI JAKARTA",68,147,75,222
https://kawalpemilu.org#26088,"CIPINANG BESAR SELATAN, JATINEGARA, JAKARTA TIMUR, DKI JAKARTA",69,0,0,238
https://kawalpemilu.org#26088,"CIPINANG BESAR SELATAN, JATINEGARA, JAKARTA TIMUR, DKI JAKARTA",70,135,72,207
https://kawalpemilu.org#26088,"CIPINANG BESAR SELATAN, JATINEGARA, JAKARTA TIMUR, DKI JAKARTA",71,146,89,235
https://kawalpemilu.org#26088,"CIPINANG BESAR SELATAN, JATINEGARA, JAKARTA TIMUR, DKI JAKARTA",73,88,158,246
https://kawalpemilu.org#26088,"CIPINANG BESAR SELATAN, JATINEGARA, JAKARTA TIMUR, DKI JAKARTA",74,100,133,233
https://kawalpemilu.org#26088,"CIPINANG BESAR SELATAN, JATINEGARA, JAKARTA TIMUR, DKI JAKARTA",75,91,161,252
https://kawalpemilu.org#26088,"CIPINANG BESAR SELATAN, JATINEGARA, JAKARTA TIMUR, DKI JAKARTA",76,76,138,214
https://kawalpemilu.org#26088,"CIPINANG BESAR SELATAN, JATINEGARA, JAKARTA TIMUR, DKI JAKARTA",77,87,151,238
https://kawalpemilu.org#26088,"CIPINANG BESAR SELATAN, JATINEGARA, JAKARTA TIMUR, DKI JAKARTA",78,71,168,239
https://kawalpemilu.org#26088,"CIPINANG BESAR SELATAN, JATINEGARA, JAKARTA TIMUR, DKI JAKARTA",79,57,204,261
https://kawalpemilu.org#26088,"CIPINANG BESAR SELATAN, JATINEGARA, JAKARTA TIMUR, DKI JAKARTA",80,55,187,242
https://kawalpemilu.org#26088,"CIPINANG BESAR SELATAN, JATINEGARA, JAKARTA TIMUR, DKI JAKARTA",81,58,194,252
https://kawalpemilu.org#26088,"CIPINANG BESAR SELATAN, JATINEGARA, JAKARTA TIMUR, DKI JAKARTA",82,70,153,223
https://kawalpemilu.org#26088,"CIPINANG BESAR SELATAN, JATINEGARA, JAKARTA TIMUR, DKI JAKARTA",83,75,156,231
https://kawalpemilu.org#26088,"CIPINANG BESAR SELATAN, JATINEGARA, JAKARTA TIMUR, DKI JAKARTA",84,110,127,237
https://kawalpemilu.org#26088,"CIPINANG BESAR SELATAN, JATINEGARA, JAKARTA TIMUR, DKI JAKARTA",85,114,98,212
https://kawalpemilu.org#26088,"CIPINANG BESAR SELATAN, JATINEGARA, JAKARTA TIMUR, DKI JAKARTA",86,110,112,222
https://kawalpemilu.org#26088,"CIPINANG BESAR SELATAN, JATINEGARA, JAKARTA TIMUR, DKI JAKARTA",87,92,121,213
https://kawalpemilu.org#26088,"CIPINANG BESAR SELATAN, JATINEGARA, JAKARTA TIMUR, DKI JAKARTA",88,83,133,216
https://kawalpemilu.org#26088,"CIPINANG BESAR SELATAN, JATINEGARA, JAKARTA TIMUR, DKI JAKARTA",89,83,128,211
https://kawalpemilu.org#26088,"CIPINANG BESAR SELATAN, JATINEGARA, JAKARTA TIMUR, DKI JAKARTA",91,103,124,227
https://kawalpemilu.org#26088,"CIPINANG BESAR SELATAN, JATINEGARA, JAKARTA TIMUR, DKI JAKARTA",92,83,156,239
https://kawalpemilu.org#26088,"CIPINANG BESAR SELATAN, JATINEGARA, JAKARTA TIMUR, DKI JAKARTA",95,80,149,229
https://kawalpemilu.org#26088,"CIPINANG BESAR SELATAN, JATINEGARA, JAKARTA TIMUR, DKI JAKARTA",96,105,117,222
https://kawalpemilu.org#26088,"CIPINANG BESAR SELATAN, JATINEGARA, JAKARTA TIMUR, DKI JAKARTA",98,72,88,160
https://kawalpemilu.org#26088,"CIPINANG BESAR SELATAN, JATINEGARA, JAKARTA TIMUR, DKI JAKARTA",100,0,0,0
https://kawalpemilu.org#26088,"CIPINANG BESAR SELATAN, JATINEGARA, JAKARTA TIMUR, DKI JAKARTA",101,133,83,216
https://kawalpemilu.org#26088,"CIPINANG BESAR SELATAN, JATINEGARA, JAKARTA TIMUR, DKI JAKARTA",102,85,164,249
https://kawalpemilu.org#26088,"CIPINANG BESAR SELATAN, JATINEGARA, JAKARTA TIMUR, DKI JAKARTA",103,69,131,200
https://kawalpemilu.org#26088,"CIPINANG BESAR SELATAN, JATINEGARA, JAKARTA TIMUR, DKI JAKARTA",104,91,136,227
https://kawalpemilu.org#26088,"CIPINANG BESAR SELATAN, JATINEGARA, JAKARTA TIMUR, DKI JAKARTA",105,132,63,195
https://kawalpemilu.org#26088,"CIPINANG BESAR SELATAN, JATINEGARA, JAKARTA TIMUR, DKI JAKARTA",106,108,84,192
https://kawalpemilu.org#26088,"CIPINANG BESAR SELATAN, JATINEGARA, JAKARTA TIMUR, DKI JAKARTA",107,79,144,223
https://kawalpemilu.org#26088,"CIPINANG BESAR SELATAN, JATINEGARA, JAKARTA TIMUR, DKI JAKARTA",108,71,155,226
https://kawalpemilu.org#26088,"CIPINANG BESAR SELATAN, JATINEGARA, JAKARTA TIMUR, DKI JAKARTA",109,72,151,223
https://kawalpemilu.org#26089,"CIPINANG BESAR UTARA, JATINEGARA, JAKARTA TIMUR, DKI JAKARTA",1,160,215,375
https://kawalpemilu.org#26089,"CIPINANG BESAR UTARA, JATINEGARA, JAKARTA TIMUR, DKI JAKARTA",2,110,103,213
https://kawalpemilu.org#26089,"CIPINANG BESAR UTARA, JATINEGARA, JAKARTA TIMUR, DKI JAKARTA",4,121,118,239
https://kawalpemilu.org#26089,"CIPINANG BESAR UTARA, JATINEGARA, JAKARTA TIMUR, DKI JAKARTA",5,90,103,193
https://kawalpemilu.org#26089,"CIPINANG BESAR UTARA, JATINEGARA, JAKARTA TIMUR, DKI JAKARTA",6,91,115,206
https://kawalpemilu.org#26089,"CIPINANG BESAR UTARA, JATINEGARA, JAKARTA TIMUR, DKI JAKARTA",7,70,129,199
https://kawalpemilu.org#26089,"CIPINANG BESAR UTARA, JATINEGARA, JAKARTA TIMUR, DKI JAKARTA",9,67,123,190
https://kawalpemilu.org#26089,"CIPINANG BESAR UTARA, JATINEGARA, JAKARTA TIMUR, DKI JAKARTA",10,46,103,149
https://kawalpemilu.org#26089,"CIPINANG BESAR UTARA, JATINEGARA, JAKARTA TIMUR, DKI JAKARTA",11,103,131,234
https://kawalpemilu.org#26089,"CIPINANG BESAR UTARA, JATINEGARA, JAKARTA TIMUR, DKI JAKARTA",12,95,115,210
https://kawalpemilu.org#26089,"CIPINANG BESAR UTARA, JATINEGARA, JAKARTA TIMUR, DKI JAKARTA",14,77,138,215
https://kawalpemilu.org#26089,"CIPINANG BESAR UTARA, JATINEGARA, JAKARTA TIMUR, DKI JAKARTA",15,107,110,217
https://kawalpemilu.org#26089,"CIPINANG BESAR UTARA, JATINEGARA, JAKARTA TIMUR, DKI JAKARTA",16,111,112,223
https://kawalpemilu.org#26089,"CIPINANG BESAR UTARA, JATINEGARA, JAKARTA TIMUR, DKI JAKARTA",17,67,151,218
https://kawalpemilu.org#26089,"CIPINANG BESAR UTARA, JATINEGARA, JAKARTA TIMUR, DKI JAKARTA",18,88,144,232
https://kawalpemilu.org#26089,"CIPINANG BESAR UTARA, JATINEGARA, JAKARTA TIMUR, DKI JAKARTA",19,57,150,207
https://kawalpemilu.org#26089,"CIPINANG BESAR UTARA, JATINEGARA, JAKARTA TIMUR, DKI JAKARTA",21,76,115,191
https://kawalpemilu.org#26089,"CIPINANG BESAR UTARA, JATINEGARA, JAKARTA TIMUR, DKI JAKARTA",22,85,73,158
https://kawalpemilu.org#26089,"CIPINANG BESAR UTARA, JATINEGARA, JAKARTA TIMUR, DKI JAKARTA",23,86,39,125
https://kawalpemilu.org#26089,"CIPINANG BESAR UTARA, JATINEGARA, JAKARTA TIMUR, DKI JAKARTA",24,100,134,234
https://kawalpemilu.org#26089,"CIPINANG BESAR UTARA, JATINEGARA, JAKARTA TIMUR, DKI JAKARTA",25,79,129,208
https://kawalpemilu.org#26089,"CIPINANG BESAR UTARA, JATINEGARA, JAKARTA TIMUR, DKI JAKARTA",26,76,161,237
https://kawalpemilu.org#26089,"CIPINANG BESAR UTARA, JATINEGARA, JAKARTA TIMUR, DKI JAKARTA",27,75,126,201
https://kawalpemilu.org#26089,"CIPINANG BESAR UTARA, JATINEGARA, JAKARTA TIMUR, DKI JAKARTA",29,92,106,198
https://kawalpemilu.org#26089,"CIPINANG BESAR UTARA, JATINEGARA, JAKARTA TIMUR, DKI JAKARTA",30,107,117,224
https://kawalpemilu.org#26089,"CIPINANG BESAR UTARA, JATINEGARA, JAKARTA TIMUR, DKI JAKARTA",31,81,109,190
https://kawalpemilu.org#26089,"CIPINANG BESAR UTARA, JATINEGARA, JAKARTA TIMUR, DKI JAKARTA",32,76,107,183
https://kawalpemilu.org#26089,"CIPINANG BESAR UTARA, JATINEGARA, JAKARTA TIMUR, DKI JAKARTA",33,86,106,192
https://kawalpemilu.org#26089,"CIPINANG BESAR UTARA, JATINEGARA, JAKARTA TIMUR, DKI JAKARTA",34,54,118,172
https://kawalpemilu.org#26089,"CIPINANG BESAR UTARA, JATINEGARA, JAKARTA TIMUR, DKI JAKARTA",35,117,109,226
https://kawalpemilu.org#26089,"CIPINANG BESAR UTARA, JATINEGARA, JAKARTA TIMUR, DKI JAKARTA",36,107,114,221
https://kawalpemilu.org#26089,"CIPINANG BESAR UTARA, JATINEGARA, JAKARTA TIMUR, DKI JAKARTA",37,102,128,230
https://kawalpemilu.org#26089,"CIPINANG BESAR UTARA, JATINEGARA, JAKARTA TIMUR, DKI JAKARTA",38,82,109,191
https://kawalpemilu.org#26089,"CIPINANG BESAR UTARA, JATINEGARA, JAKARTA TIMUR, DKI JAKARTA",39,110,113,223
https://kawalpemilu.org#26089,"CIPINANG BESAR UTARA, JATINEGARA, JAKARTA TIMUR, DKI JAKARTA",40,95,105,200
https://kawalpemilu.org#26089,"CIPINANG BESAR UTARA, JATINEGARA, JAKARTA TIMUR, DKI JAKARTA",41,97,149,246
https://kawalpemilu.org#26089,"CIPINANG BESAR UTARA, JATINEGARA, JAKARTA TIMUR, DKI JAKARTA",42,100,106,206
https://kawalpemilu.org#26089,"CIPINANG BESAR UTARA, JATINEGARA, JAKARTA TIMUR, DKI JAKARTA",43,77,131,208
https://kawalpemilu.org#26089,"CIPINANG BESAR UTARA, JATINEGARA, JAKARTA TIMUR, DKI JAKARTA",45,136,82,218
https://kawalpemilu.org#26089,"CIPINANG BESAR UTARA, JATINEGARA, JAKARTA TIMUR, DKI JAKARTA",46,78,112,190
https://kawalpemilu.org#26089,"CIPINANG BESAR UTARA, JATINEGARA, JAKARTA TIMUR, DKI JAKARTA",47,103,118,221
https://kawalpemilu.org#26089,"CIPINANG BESAR UTARA, JATINEGARA, JAKARTA TIMUR, DKI JAKARTA",49,134,51,185
https://kawalpemilu.org#26089,"CIPINANG BESAR UTARA, JATINEGARA, JAKARTA TIMUR, DKI JAKARTA",50,124,65,189
https://kawalpemilu.org#26089,"CIPINANG BESAR UTARA, JATINEGARA, JAKARTA TIMUR, DKI JAKARTA",51,71,144,215
https://kawalpemilu.org#26089,"CIPINANG BESAR UTARA, JATINEGARA, JAKARTA TIMUR, DKI JAKARTA",53,63,143,206
https://kawalpemilu.org#26089,"CIPINANG BESAR UTARA, JATINEGARA, JAKARTA TIMUR, DKI JAKARTA",54,88,135,223
https://kawalpemilu.org#26089,"CIPINANG BESAR UTARA, JATINEGARA, JAKARTA TIMUR, DKI JAKARTA",55,75,161,236
https://kawalpemilu.org#26089,"CIPINANG BESAR UTARA, JATINEGARA, JAKARTA TIMUR, DKI JAKARTA",56,99,134,233
https://kawalpemilu.org#26089,"CIPINANG BESAR UTARA, JATINEGARA, JAKARTA TIMUR, DKI JAKARTA",57,53,152,205
https://kawalpemilu.org#26089,"CIPINANG BESAR UTARA, JATINEGARA, JAKARTA TIMUR, DKI JAKARTA",58,94,110,204
https://kawalpemilu.org#26089,"CIPINANG BESAR UTARA, JATINEGARA, JAKARTA TIMUR, DKI JAKARTA",59,83,89,172
https://kawalpemilu.org#26089,"CIPINANG BESAR UTARA, JATINEGARA, JAKARTA TIMUR, DKI JAKARTA",60,129,90,219
https://kawalpemilu.org#26089,"CIPINANG BESAR UTARA, JATINEGARA, JAKARTA TIMUR, DKI JAKARTA",61,108,87,195
https://kawalpemilu.org#26089,"CIPINANG BESAR UTARA, JATINEGARA, JAKARTA TIMUR, DKI JAKARTA",65,66,188,254
https://kawalpemilu.org#26089,"CIPINANG BESAR UTARA, JATINEGARA, JAKARTA TIMUR, DKI JAKARTA",67,90,136,226
https://kawalpemilu.org#26089,"CIPINANG BESAR UTARA, JATINEGARA, JAKARTA TIMUR, DKI JAKARTA",68,83,158,241
https://kawalpemilu.org#26089,"CIPINANG BESAR UTARA, JATINEGARA, JAKARTA TIMUR, DKI JAKARTA",69,72,124,196
https://kawalpemilu.org#26089,"CIPINANG BESAR UTARA, JATINEGARA, JAKARTA TIMUR, DKI JAKARTA",73,90,129,219
https://kawalpemilu.org#26089,"CIPINANG BESAR UTARA, JATINEGARA, JAKARTA TIMUR, DKI JAKARTA",74,90,132,222
https://kawalpemilu.org#26089,"CIPINANG BESAR UTARA, JATINEGARA, JAKARTA TIMUR, DKI JAKARTA",75,99,127,226
https://kawalpemilu.org#26089,"CIPINANG BESAR UTARA, JATINEGARA, JAKARTA TIMUR, DKI JAKARTA",76,76,120,196
https://kawalpemilu.org#26089,"CIPINANG BESAR UTARA, JATINEGARA, JAKARTA TIMUR, DKI JAKARTA",77,90,138,228
https://kawalpemilu.org#26089,"CIPINANG BESAR UTARA, JATINEGARA, JAKARTA TIMUR, DKI JAKARTA",78,71,117,188
https://kawalpemilu.org#26089,"CIPINANG BESAR UTARA, JATINEGARA, JAKARTA TIMUR, DKI JAKARTA",79,60,117,177
https://kawalpemilu.org#26089,"CIPINANG BESAR UTARA, JATINEGARA, JAKARTA TIMUR, DKI JAKARTA",80,60,107,167
https://kawalpemilu.org#26089,"CIPINANG BESAR UTARA, JATINEGARA, JAKARTA TIMUR, DKI JAKARTA",81,73,110,183
https://kawalpemilu.org#26089,"CIPINANG BESAR UTARA, JATINEGARA, JAKARTA TIMUR, DKI JAKARTA",82,51,163,214
https://kawalpemilu.org#26089,"CIPINANG BESAR UTARA, JATINEGARA, JAKARTA TIMUR, DKI JAKARTA",83,93,114,207
https://kawalpemilu.org#26089,"CIPINANG BESAR UTARA, JATINEGARA, JAKARTA TIMUR, DKI JAKARTA",84,92,124,216
https://kawalpemilu.org#26089,"CIPINANG BESAR UTARA, JATINEGARA, JAKARTA TIMUR, DKI JAKARTA",85,83,112,195
https://kawalpemilu.org#26089,"CIPINANG BESAR UTARA, JATINEGARA, JAKARTA TIMUR, DKI JAKARTA",86,90,128,218
https://kawalpemilu.org#26089,"CIPINANG BESAR UTARA, JATINEGARA, JAKARTA TIMUR, DKI JAKARTA",87,86,131,217
https://kawalpemilu.org#26089,"CIPINANG BESAR UTARA, JATINEGARA, JAKARTA TIMUR, DKI JAKARTA",88,63,160,223
https://kawalpemilu.org#26089,"CIPINANG BESAR UTARA, JATINEGARA, JAKARTA TIMUR, DKI JAKARTA",89,64,114,178
https://kawalpemilu.org#26089,"CIPINANG BESAR UTARA, JATINEGARA, JAKARTA TIMUR, DKI JAKARTA",90,75,133,208
https://kawalpemilu.org#26089,"CIPINANG BESAR UTARA, JATINEGARA, JAKARTA TIMUR, DKI JAKARTA",91,96,116,212
https://kawalpemilu.org#26089,"CIPINANG BESAR UTARA, JATINEGARA, JAKARTA TIMUR, DKI JAKARTA",92,102,123,225
https://kawalpemilu.org#26089,"CIPINANG BESAR UTARA, JATINEGARA, JAKARTA TIMUR, DKI JAKARTA",93,107,105,212
https://kawalpemilu.org#26089,"CIPINANG BESAR UTARA, JATINEGARA, JAKARTA TIMUR, DKI JAKARTA",94,162,57,219
https://kawalpemilu.org#26089,"CIPINANG BESAR UTARA, JATINEGARA, JAKARTA TIMUR, DKI JAKARTA",95,180,39,219
https://kawalpemilu.org#26089,"CIPINANG BESAR UTARA, JATINEGARA, JAKARTA TIMUR, DKI JAKARTA",96,129,89,218
https://kawalpemilu.org#26089,"CIPINANG BESAR UTARA, JATINEGARA, JAKARTA TIMUR, DKI JAKARTA",97,154,56,210
https://kawalpemilu.org#26089,"CIPINANG BESAR UTARA, JATINEGARA, JAKARTA TIMUR, DKI JAKARTA",98,123,81,204
https://kawalpemilu.org#26089,"CIPINANG BESAR UTARA, JATINEGARA, JAKARTA TIMUR, DKI JAKARTA",99,119,105,224
https://kawalpemilu.org#26089,"CIPINANG BESAR UTARA, JATINEGARA, JAKARTA TIMUR, DKI JAKARTA",100,136,104,239
https://kawalpemilu.org#26089,"CIPINANG BESAR UTARA, JATINEGARA, JAKARTA TIMUR, DKI JAKARTA",103,118,111,229
https://kawalpemilu.org#26089,"CIPINANG BESAR UTARA, JATINEGARA, JAKARTA TIMUR, DKI JAKARTA",105,100,103,203
https://kawalpemilu.org#26089,"CIPINANG BESAR UTARA, JATINEGARA, JAKARTA TIMUR, DKI JAKARTA",106,74,115,189
https://kawalpemilu.org#26089,"CIPINANG BESAR UTARA, JATINEGARA, JAKARTA TIMUR, DKI JAKARTA",107,104,109,213
https://kawalpemilu.org#26089,"CIPINANG BESAR UTARA, JATINEGARA, JAKARTA TIMUR, DKI JAKARTA",108,149,98,247
https://kawalpemilu.org#26089,"CIPINANG BESAR UTARA, JATINEGARA, JAKARTA TIMUR, DKI JAKARTA",109,81,133,214
https://kawalpemilu.org#26089,"CIPINANG BESAR UTARA, JATINEGARA, JAKARTA TIMUR, DKI JAKARTA",111,119,101,220
https://kawalpemilu.org#26089,"CIPINANG BESAR UTARA, JATINEGARA, JAKARTA TIMUR, DKI JAKARTA",112,84,155,239
https://kawalpemilu.org#26089,"CIPINANG BESAR UTARA, JATINEGARA, JAKARTA TIMUR, DKI JAKARTA",113,90,149,239
https://kawalpemilu.org#26089,"CIPINANG BESAR UTARA, JATINEGARA, JAKARTA TIMUR, DKI JAKARTA",114,98,133,231
https://kawalpemilu.org#26089,"CIPINANG BESAR UTARA, JATINEGARA, JAKARTA TIMUR, DKI JAKARTA",115,108,130,238
https://kawalpemilu.org#26089,"CIPINANG BESAR UTARA, JATINEGARA, JAKARTA TIMUR, DKI JAKARTA",116,123,96,219
https://kawalpemilu.org#26089,"CIPINANG BESAR UTARA, JATINEGARA, JAKARTA TIMUR, DKI JAKARTA",117,125,106,231
https://kawalpemilu.org#26089,"CIPINANG BESAR UTARA, JATINEGARA, JAKARTA TIMUR, DKI JAKARTA",119,133,83,216
https://kawalpemilu.org#26089,"CIPINANG BESAR UTARA, JATINEGARA, JAKARTA TIMUR, DKI JAKARTA",120,105,104,209
https://kawalpemilu.org#26089,"CIPINANG BESAR UTARA, JATINEGARA, JAKARTA TIMUR, DKI JAKARTA",121,107,124,231
https://kawalpemilu.org#26089,"CIPINANG BESAR UTARA, JATINEGARA, JAKARTA TIMUR, DKI JAKARTA",123,73,154,227
https://kawalpemilu.org#26089,"CIPINANG BESAR UTARA, JATINEGARA, JAKARTA TIMUR, DKI JAKARTA",124,71,161,232
https://kawalpemilu.org#26089,"CIPINANG BESAR UTARA, JATINEGARA, JAKARTA TIMUR, DKI JAKARTA",125,87,168,255
https://kawalpemilu.org#26089,"CIPINANG BESAR UTARA, JATINEGARA, JAKARTA TIMUR, DKI JAKARTA",126,95,145,240
https://kawalpemilu.org#26089,"CIPINANG BESAR UTARA, JATINEGARA, JAKARTA TIMUR, DKI JAKARTA",127,119,112,231
https://kawalpemilu.org#26089,"CIPINANG BESAR UTARA, JATINEGARA, JAKARTA TIMUR, DKI JAKARTA",128,130,101,231
https://kawalpemilu.org#26089,"CIPINANG BESAR UTARA, JATINEGARA, JAKARTA TIMUR, DKI JAKARTA",129,140,74,214
https://kawalpemilu.org#26089,"CIPINANG BESAR UTARA, JATINEGARA, JAKARTA TIMUR, DKI JAKARTA",130,124,92,216
https://kawalpemilu.org#26089,"CIPINANG BESAR UTARA, JATINEGARA, JAKARTA TIMUR, DKI JAKARTA",131,144,78,222
https://kawalpemilu.org#26089,"CIPINANG BESAR UTARA, JATINEGARA, JAKARTA TIMUR, DKI JAKARTA",132,63,114,177
https://kawalpemilu.org#26089,"CIPINANG BESAR UTARA, JATINEGARA, JAKARTA TIMUR, DKI JAKARTA",134,154,67,221
https://kawalpemilu.org#26089,"CIPINANG BESAR UTARA, JATINEGARA, JAKARTA TIMUR, DKI JAKARTA",135,123,82,205
https://kawalpemilu.org#26089,"CIPINANG BESAR UTARA, JATINEGARA, JAKARTA TIMUR, DKI JAKARTA",136,191,50,241
https://kawalpemilu.org#26089,"CIPINANG BESAR UTARA, JATINEGARA, JAKARTA TIMUR, DKI JAKARTA",137,149,93,242
https://kawalpemilu.org#26089,"CIPINANG BESAR UTARA, JATINEGARA, JAKARTA TIMUR, DKI JAKARTA",138,100,111,211
https://kawalpemilu.org#26089,"CIPINANG BESAR UTARA, JATINEGARA, JAKARTA TIMUR, DKI JAKARTA",139,117,113,230
https://kawalpemilu.org#26089,"CIPINANG BESAR UTARA, JATINEGARA, JAKARTA TIMUR, DKI JAKARTA",141,120,100,220
https://kawalpemilu.org#26089,"CIPINANG BESAR UTARA, JATINEGARA, JAKARTA TIMUR, DKI JAKARTA",142,122,94,216
https://kawalpemilu.org#26089,"CIPINANG BESAR UTARA, JATINEGARA, JAKARTA TIMUR, DKI JAKARTA",146,112,79,201
https://kawalpemilu.org#26089,"CIPINANG BESAR UTARA, JATINEGARA, JAKARTA TIMUR, DKI JAKARTA",148,116,121,237
https://kawalpemilu.org#26089,"CIPINANG BESAR UTARA, JATINEGARA, JAKARTA TIMUR, DKI JAKARTA",149,92,146,238
https://kawalpemilu.org#26089,"CIPINANG BESAR UTARA, JATINEGARA, JAKARTA TIMUR, DKI JAKARTA",151,149,98,247
https://kawalpemilu.org#26089,"CIPINANG BESAR UTARA, JATINEGARA, JAKARTA TIMUR, DKI JAKARTA",152,121,97,218
https://kawalpemilu.org#26089,"CIPINANG BESAR UTARA, JATINEGARA, JAKARTA TIMUR, DKI JAKARTA",153,107,95,202
https://kawalpemilu.org#26089,"CIPINANG BESAR UTARA, JATINEGARA, JAKARTA TIMUR, DKI JAKARTA",154,120,109,229
https://kawalpemilu.org#26089,"CIPINANG BESAR UTARA, JATINEGARA, JAKARTA TIMUR, DKI JAKARTA",155,144,100,244
https://kawalpemilu.org#26089,"CIPINANG BESAR UTARA, JATINEGARA, JAKARTA TIMUR, DKI JAKARTA",156,98,139,237
https://kawalpemilu.org#26089,"CIPINANG BESAR UTARA, JATINEGARA, JAKARTA TIMUR, DKI JAKARTA",157,73,147,220
https://kawalpemilu.org#26089,"CIPINANG BESAR UTARA, JATINEGARA, JAKARTA TIMUR, DKI JAKARTA",158,92,139,231
https://kawalpemilu.org#26089,"CIPINANG BESAR UTARA, JATINEGARA, JAKARTA TIMUR, DKI JAKARTA",159,78,133,211
https://kawalpemilu.org#26089,"CIPINANG BESAR UTARA, JATINEGARA, JAKARTA TIMUR, DKI JAKARTA",160,78,98,176
https://kawalpemilu.org#26089,"CIPINANG BESAR UTARA, JATINEGARA, JAKARTA TIMUR, DKI JAKARTA",162,97,133,230
https://kawalpemilu.org#26089,"CIPINANG BESAR UTARA, JATINEGARA, JAKARTA TIMUR, DKI JAKARTA",163,80,143,223
https://kawalpemilu.org#26089,"CIPINANG BESAR UTARA, JATINEGARA, JAKARTA TIMUR, DKI JAKARTA",164,72,138,210
https://kawalpemilu.org#26089,"CIPINANG BESAR UTARA, JATINEGARA, JAKARTA TIMUR, DKI JAKARTA",165,86,91,177
https://kawalpemilu.org#26089,"CIPINANG BESAR UTARA, JATINEGARA, JAKARTA TIMUR, DKI JAKARTA",166,66,100,166
https://kawalpemilu.org#26089,"CIPINANG BESAR UTARA, JATINEGARA, JAKARTA TIMUR, DKI JAKARTA",167,56,87,143
https://kawalpemilu.org#26089,"CIPINANG BESAR UTARA, JATINEGARA, JAKARTA TIMUR, DKI JAKARTA",170,55,52,107
https://kawalpemilu.org#26089,"CIPINANG BESAR UTARA, JATINEGARA, JAKARTA TIMUR, DKI JAKARTA",171,68,63,131
https://kawalpemilu.org#26089,"CIPINANG BESAR UTARA, JATINEGARA, JAKARTA TIMUR, DKI JAKARTA",172,66,49,115
https://kawalpemilu.org#26089,"CIPINANG BESAR UTARA, JATINEGARA, JAKARTA TIMUR, DKI JAKARTA",173,45,61,106
https://kawalpemilu.org#26089,"CIPINANG BESAR UTARA, JATINEGARA, JAKARTA TIMUR, DKI JAKARTA",174,79,55,134
https://kawalpemilu.org#26089,"CIPINANG BESAR UTARA, JATINEGARA, JAKARTA TIMUR, DKI JAKARTA",175,77,129,206
https://kawalpemilu.org#26089,"CIPINANG BESAR UTARA, JATINEGARA, JAKARTA TIMUR, DKI JAKARTA",178,73,116,189
https://kawalpemilu.org#26091,"KRAMATJATI, KRAMATJATI, JAKARTA TIMUR, DKI JAKARTA",1,101,133,234
https://kawalpemilu.org#26091,"KRAMATJATI, KRAMATJATI, JAKARTA TIMUR, DKI JAKARTA",2,94,125,219
https://kawalpemilu.org#26091,"KRAMATJATI, KRAMATJATI, JAKARTA TIMUR, DKI JAKARTA",3,127,63,190
https://kawalpemilu.org#26091,"KRAMATJATI, KRAMATJATI, JAKARTA TIMUR, DKI JAKARTA",4,150,68,218
https://kawalpemilu.org#26091,"KRAMATJATI, KRAMATJATI, JAKARTA TIMUR, DKI JAKARTA",5,128,91,219
https://kawalpemilu.org#26091,"KRAMATJATI, KRAMATJATI, JAKARTA TIMUR, DKI JAKARTA",6,115,93,208
https://kawalpemilu.org#26091,"KRAMATJATI, KRAMATJATI, JAKARTA TIMUR, DKI JAKARTA",7,117,105,222
https://kawalpemilu.org#26091,"KRAMATJATI, KRAMATJATI, JAKARTA TIMUR, DKI JAKARTA",8,83,151,234
https://kawalpemilu.org#26091,"KRAMATJATI, KRAMATJATI, JAKARTA TIMUR, DKI JAKARTA",9,111,130,241
https://kawalpemilu.org#26091,"KRAMATJATI, KRAMATJATI, JAKARTA TIMUR, DKI JAKARTA",10,58,158,216
https://kawalpemilu.org#26091,"KRAMATJATI, KRAMATJATI, JAKARTA TIMUR, DKI JAKARTA",11,95,157,252
https://kawalpemilu.org#26091,"KRAMATJATI, KRAMATJATI, JAKARTA TIMUR, DKI JAKARTA",12,112,125,237
https://kawalpemilu.org#26091,"KRAMATJATI, KRAMATJATI, JAKARTA TIMUR, DKI JAKARTA",15,63,176,239
https://kawalpemilu.org#26091,"KRAMATJATI, KRAMATJATI, JAKARTA TIMUR, DKI JAKARTA",16,73,126,199
https://kawalpemilu.org#26091,"KRAMATJATI, KRAMATJATI, JAKARTA TIMUR, DKI JAKARTA",17,72,117,189
https://kawalpemilu.org#26091,"KRAMATJATI, KRAMATJATI, JAKARTA TIMUR, DKI JAKARTA",18,64,116,180
https://kawalpemilu.org#26091,"KRAMATJATI, KRAMATJATI, JAKARTA TIMUR, DKI JAKARTA",19,141,92,233
https://kawalpemilu.org#26091,"KRAMATJATI, KRAMATJATI, JAKARTA TIMUR, DKI JAKARTA",20,134,109,243
https://kawalpemilu.org#26091,"KRAMATJATI, KRAMATJATI, JAKARTA TIMUR, DKI JAKARTA",21,94,86,180
https://kawalpemilu.org#26091,"KRAMATJATI, KRAMATJATI, JAKARTA TIMUR, DKI JAKARTA",22,133,77,210
https://kawalpemilu.org#26091,"KRAMATJATI, KRAMATJATI, JAKARTA TIMUR, DKI JAKARTA",23,127,87,214
https://kawalpemilu.org#26091,"KRAMATJATI, KRAMATJATI, JAKARTA TIMUR, DKI JAKARTA",24,92,112,204
https://kawalpemilu.org#26091,"KRAMATJATI, KRAMATJATI, JAKARTA TIMUR, DKI JAKARTA",25,132,97,229
https://kawalpemilu.org#26091,"KRAMATJATI, KRAMATJATI, JAKARTA TIMUR, DKI JAKARTA",26,113,113,226
https://kawalpemilu.org#26091,"KRAMATJATI, KRAMATJATI, JAKARTA TIMUR, DKI JAKARTA",27,149,74,223
https://kawalpemilu.org#26091,"KRAMATJATI, KRAMATJATI, JAKARTA TIMUR, DKI JAKARTA",28,141,80,221
https://kawalpemilu.org#26091,"KRAMATJATI, KRAMATJATI, JAKARTA TIMUR, DKI JAKARTA",29,115,100,215
https://kawalpemilu.org#26091,"KRAMATJATI, KRAMATJATI, JAKARTA TIMUR, DKI JAKARTA",31,90,103,193
https://kawalpemilu.org#26091,"KRAMATJATI, KRAMATJATI, JAKARTA TIMUR, DKI JAKARTA",32,40,98,138
https://kawalpemilu.org#26091,"KRAMATJATI, KRAMATJATI, JAKARTA TIMUR, DKI JAKARTA",34,140,86,226
https://kawalpemilu.org#26091,"KRAMATJATI, KRAMATJATI, JAKARTA TIMUR, DKI JAKARTA",35,92,108,200
https://kawalpemilu.org#26091,"KRAMATJATI, KRAMATJATI, JAKARTA TIMUR, DKI JAKARTA",38,104,94,198
https://kawalpemilu.org#26091,"KRAMATJATI, KRAMATJATI, JAKARTA TIMUR, DKI JAKARTA",39,139,113,252
https://kawalpemilu.org#26091,"KRAMATJATI, KRAMATJATI, JAKARTA TIMUR, DKI JAKARTA",41,124,144,268
https://kawalpemilu.org#26091,"KRAMATJATI, KRAMATJATI, JAKARTA TIMUR, DKI JAKARTA",42,131,124,255
https://kawalpemilu.org#26091,"KRAMATJATI, KRAMATJATI, JAKARTA TIMUR, DKI JAKARTA",43,131,88,219
https://kawalpemilu.org#26091,"KRAMATJATI, KRAMATJATI, JAKARTA TIMUR, DKI JAKARTA",45,72,162,234
https://kawalpemilu.org#26091,"KRAMATJATI, KRAMATJATI, JAKARTA TIMUR, DKI JAKARTA",46,100,110,210
https://kawalpemilu.org#26091,"KRAMATJATI, KRAMATJATI, JAKARTA TIMUR, DKI JAKARTA",48,84,125,209
https://kawalpemilu.org#26091,"KRAMATJATI, KRAMATJATI, JAKARTA TIMUR, DKI JAKARTA",49,80,144,224
https://kawalpemilu.org#26091,"KRAMATJATI, KRAMATJATI, JAKARTA TIMUR, DKI JAKARTA",50,92,145,237
https://kawalpemilu.org#26091,"KRAMATJATI, KRAMATJATI, JAKARTA TIMUR, DKI JAKARTA",52,111,132,243
https://kawalpemilu.org#26091,"KRAMATJATI, KRAMATJATI, JAKARTA TIMUR, DKI JAKARTA",53,86,172,258
https://kawalpemilu.org#26091,"KRAMATJATI, KRAMATJATI, JAKARTA TIMUR, DKI JAKARTA",55,111,120,231
https://kawalpemilu.org#26091,"KRAMATJATI, KRAMATJATI, JAKARTA TIMUR, DKI JAKARTA",56,101,132,233
https://kawalpemilu.org#26091,"KRAMATJATI, KRAMATJATI, JAKARTA TIMUR, DKI JAKARTA",60,91,124,215
https://kawalpemilu.org#26091,"KRAMATJATI, KRAMATJATI, JAKARTA TIMUR, DKI JAKARTA",61,121,118,239
https://kawalpemilu.org#26091,"KRAMATJATI, KRAMATJATI, JAKARTA TIMUR, DKI JAKARTA",62,84,111,195
https://kawalpemilu.org#26091,"KRAMATJATI, KRAMATJATI, JAKARTA TIMUR, DKI JAKARTA",63,109,116,225
https://kawalpemilu.org#26091,"KRAMATJATI, KRAMATJATI, JAKARTA TIMUR, DKI JAKARTA",65,92,76,168
https://kawalpemilu.org#26091,"KRAMATJATI, KRAMATJATI, JAKARTA TIMUR, DKI JAKARTA",66,100,85,185
https://kawalpemilu.org#26091,"KRAMATJATI, KRAMATJATI, JAKARTA TIMUR, DKI JAKARTA",67,0,0,0
https://kawalpemilu.org#26091,"KRAMATJATI, KRAMATJATI, JAKARTA TIMUR, DKI JAKARTA",68,124,97,221
https://kawalpemilu.org#26091,"KRAMATJATI, KRAMATJATI, JAKARTA TIMUR, DKI JAKARTA",69,91,71,162
https://kawalpemilu.org#26091,"KRAMATJATI, KRAMATJATI, JAKARTA TIMUR, DKI JAKARTA",70,117,105,222
https://kawalpemilu.org#26091,"KRAMATJATI, KRAMATJATI, JAKARTA TIMUR, DKI JAKARTA",71,123,95,218
https://kawalpemilu.org#26091,"KRAMATJATI, KRAMATJATI, JAKARTA TIMUR, DKI JAKARTA",72,128,94,222
https://kawalpemilu.org#26091,"KRAMATJATI, KRAMATJATI, JAKARTA TIMUR, DKI JAKARTA",73,123,92,215
https://kawalpemilu.org#26091,"KRAMATJATI, KRAMATJATI, JAKARTA TIMUR, DKI JAKARTA",75,123,92,215
https://kawalpemilu.org#26091,"KRAMATJATI, KRAMATJATI, JAKARTA TIMUR, DKI JAKARTA",78,139,93,232
https://kawalpemilu.org#26091,"KRAMATJATI, KRAMATJATI, JAKARTA TIMUR, DKI JAKARTA",80,153,97,250
https://kawalpemilu.org#26091,"KRAMATJATI, KRAMATJATI, JAKARTA TIMUR, DKI JAKARTA",81,120,116,236
https://kawalpemilu.org#26091,"KRAMATJATI, KRAMATJATI, JAKARTA TIMUR, DKI JAKARTA",83,116,86,202
https://kawalpemilu.org#26091,"KRAMATJATI, KRAMATJATI, JAKARTA TIMUR, DKI JAKARTA",84,135,108,243
https://kawalpemilu.org#26091,"KRAMATJATI, KRAMATJATI, JAKARTA TIMUR, DKI JAKARTA",85,110,153,263
https://kawalpemilu.org#26091,"KRAMATJATI, KRAMATJATI, JAKARTA TIMUR, DKI JAKARTA",87,120,129,249
https://kawalpemilu.org#26091,"KRAMATJATI, KRAMATJATI, JAKARTA TIMUR, DKI JAKARTA",88,127,110,237
https://kawalpemilu.org#26091,"KRAMATJATI, KRAMATJATI, JAKARTA TIMUR, DKI JAKARTA",90,86,150,236
https://kawalpemilu.org#26091,"KRAMATJATI, KRAMATJATI, JAKARTA TIMUR, DKI JAKARTA",92,71,151,222
https://kawalpemilu.org#26091,"KRAMATJATI, KRAMATJATI, JAKARTA TIMUR, DKI JAKARTA",94,105,117,222
https://kawalpemilu.org#26091,"KRAMATJATI, KRAMATJATI, JAKARTA TIMUR, DKI JAKARTA",95,136,115,251
https://kawalpemilu.org#26091,"KRAMATJATI, KRAMATJATI, JAKARTA TIMUR, DKI JAKARTA",97,115,111,226
https://kawalpemilu.org#26091,"KRAMATJATI, KRAMATJATI, JAKARTA TIMUR, DKI JAKARTA",98,110,124,234
https://kawalpemilu.org#26091,"KRAMATJATI, KRAMATJATI, JAKARTA TIMUR, DKI JAKARTA",100,100,148,248
https://kawalpemilu.org#26091,"KRAMATJATI, KRAMATJATI, JAKARTA TIMUR, DKI JAKARTA",102,138,86,224
https://kawalpemilu.org#26091,"KRAMATJATI, KRAMATJATI, JAKARTA TIMUR, DKI JAKARTA",103,119,117,236
https://kawalpemilu.org#26091,"KRAMATJATI, KRAMATJATI, JAKARTA TIMUR, DKI JAKARTA",104,112,126,238
https://kawalpemilu.org#26091,"KRAMATJATI, KRAMATJATI, JAKARTA TIMUR, DKI JAKARTA",105,61,123,184
https://kawalpemilu.org#26092,"TENGAH, KRAMATJATI, JAKARTA TIMUR, DKI JAKARTA",1,110,144,254
https://kawalpemilu.org#26092,"TENGAH, KRAMATJATI, JAKARTA TIMUR, DKI JAKARTA",2,100,135,235
https://kawalpemilu.org#26092,"TENGAH, KRAMATJATI, JAKARTA TIMUR, DKI JAKARTA",4,138,136,274
https://kawalpemilu.org#26092,"TENGAH, KRAMATJATI, JAKARTA TIMUR, DKI JAKARTA",6,107,134,241
https://kawalpemilu.org#26092,"TENGAH, KRAMATJATI, JAKARTA TIMUR, DKI JAKARTA",9,91,149,240
https://kawalpemilu.org#26092,"TENGAH, KRAMATJATI, JAKARTA TIMUR, DKI JAKARTA",10,103,123,226
https://kawalpemilu.org#26092,"TENGAH, KRAMATJATI, JAKARTA TIMUR, DKI JAKARTA",11,92,124,216
https://kawalpemilu.org#26092,"TENGAH, KRAMATJATI, JAKARTA TIMUR, DKI JAKARTA",12,116,101,217
https://kawalpemilu.org#26092,"TENGAH, KRAMATJATI, JAKARTA TIMUR, DKI JAKARTA",13,98,119,217
https://kawalpemilu.org#26092,"TENGAH, KRAMATJATI, JAKARTA TIMUR, DKI JAKARTA",14,145,74,219
https://kawalpemilu.org#26092,"TENGAH, KRAMATJATI, JAKARTA TIMUR, DKI JAKARTA",15,227,11,238
https://kawalpemilu.org#26092,"TENGAH, KRAMATJATI, JAKARTA TIMUR, DKI JAKARTA",16,160,85,245
https://kawalpemilu.org#26092,"TENGAH, KRAMATJATI, JAKARTA TIMUR, DKI JAKARTA",17,64,125,189
https://kawalpemilu.org#26092,"TENGAH, KRAMATJATI, JAKARTA TIMUR, DKI JAKARTA",18,58,157,215
https://kawalpemilu.org#26092,"TENGAH, KRAMATJATI, JAKARTA TIMUR, DKI JAKARTA",19,137,88,225
https://kawalpemilu.org#26092,"TENGAH, KRAMATJATI, JAKARTA TIMUR, DKI JAKARTA",20,133,102,235
https://kawalpemilu.org#26092,"TENGAH, KRAMATJATI, JAKARTA TIMUR, DKI JAKARTA",21,155,97,252
https://kawalpemilu.org#26092,"TENGAH, KRAMATJATI, JAKARTA TIMUR, DKI JAKARTA",22,133,90,223
https://kawalpemilu.org#26092,"TENGAH, KRAMATJATI, JAKARTA TIMUR, DKI JAKARTA",23,150,63,213
https://kawalpemilu.org#26092,"TENGAH, KRAMATJATI, JAKARTA TIMUR, DKI JAKARTA",24,104,59,163
https://kawalpemilu.org#26092,"TENGAH, KRAMATJATI, JAKARTA TIMUR, DKI JAKARTA",26,103,154,257
https://kawalpemilu.org#26092,"TENGAH, KRAMATJATI, JAKARTA TIMUR, DKI JAKARTA",27,84,114,198
https://kawalpemilu.org#26092,"TENGAH, KRAMATJATI, JAKARTA TIMUR, DKI JAKARTA",29,101,142,243
https://kawalpemilu.org#26092,"TENGAH, KRAMATJATI, JAKARTA TIMUR, DKI JAKARTA",30,79,105,184
https://kawalpemilu.org#26092,"TENGAH, KRAMATJATI, JAKARTA TIMUR, DKI JAKARTA",31,103,119,222
https://kawalpemilu.org#26092,"TENGAH, KRAMATJATI, JAKARTA TIMUR, DKI JAKARTA",32,118,128,246
https://kawalpemilu.org#26092,"TENGAH, KRAMATJATI, JAKARTA TIMUR, DKI JAKARTA",33,113,131,244
https://kawalpemilu.org#26092,"TENGAH, KRAMATJATI, JAKARTA TIMUR, DKI JAKARTA",34,99,141,240
https://kawalpemilu.org#26092,"TENGAH, KRAMATJATI, JAKARTA TIMUR, DKI JAKARTA",35,103,130,233
https://kawalpemilu.org#26092,"TENGAH, KRAMATJATI, JAKARTA TIMUR, DKI JAKARTA",36,77,140,217
https://kawalpemilu.org#26092,"TENGAH, KRAMATJATI, JAKARTA TIMUR, DKI JAKARTA",37,78,183,261
https://kawalpemilu.org#26092,"TENGAH, KRAMATJATI, JAKARTA TIMUR, DKI JAKARTA",38,93,172,265
https://kawalpemilu.org#26092,"TENGAH, KRAMATJATI, JAKARTA TIMUR, DKI JAKARTA",39,83,163,246
https://kawalpemilu.org#26092,"TENGAH, KRAMATJATI, JAKARTA TIMUR, DKI JAKARTA",40,92,161,253
https://kawalpemilu.org#26092,"TENGAH, KRAMATJATI, JAKARTA TIMUR, DKI JAKARTA",41,77,155,232
https://kawalpemilu.org#26092,"TENGAH, KRAMATJATI, JAKARTA TIMUR, DKI JAKARTA",42,95,173,268
https://kawalpemilu.org#26092,"TENGAH, KRAMATJATI, JAKARTA TIMUR, DKI JAKARTA",43,135,109,244
https://kawalpemilu.org#26092,"TENGAH, KRAMATJATI, JAKARTA TIMUR, DKI JAKARTA",44,94,108,202
https://kawalpemilu.org#26092,"TENGAH, KRAMATJATI, JAKARTA TIMUR, DKI JAKARTA",49,70,118,188
https://kawalpemilu.org#26092,"TENGAH, KRAMATJATI, JAKARTA TIMUR, DKI JAKARTA",51,127,68,195
https://kawalpemilu.org#26092,"TENGAH, KRAMATJATI, JAKARTA TIMUR, DKI JAKARTA",54,131,97,228
https://kawalpemilu.org#26092,"TENGAH, KRAMATJATI, JAKARTA TIMUR, DKI JAKARTA",55,86,111,197
https://kawalpemilu.org#26092,"TENGAH, KRAMATJATI, JAKARTA TIMUR, DKI JAKARTA",56,114,79,193
https://kawalpemilu.org#26092,"TENGAH, KRAMATJATI, JAKARTA TIMUR, DKI JAKARTA",57,95,119,214
https://kawalpemilu.org#26092,"TENGAH, KRAMATJATI, JAKARTA TIMUR, DKI JAKARTA",58,100,75,175
https://kawalpemilu.org#26092,"TENGAH, KRAMATJATI, JAKARTA TIMUR, DKI JAKARTA",60,119,73,192
https://kawalpemilu.org#26092,"TENGAH, KRAMATJATI, JAKARTA TIMUR, DKI JAKARTA",61,112,36,148
https://kawalpemilu.org#26092,"TENGAH, KRAMATJATI, JAKARTA TIMUR, DKI JAKARTA",62,160,63,223
https://kawalpemilu.org#26092,"TENGAH, KRAMATJATI, JAKARTA TIMUR, DKI JAKARTA",63,136,65,201
https://kawalpemilu.org#26092,"TENGAH, KRAMATJATI, JAKARTA TIMUR, DKI JAKARTA",65,138,75,213
https://kawalpemilu.org#26092,"TENGAH, KRAMATJATI, JAKARTA TIMUR, DKI JAKARTA",66,92,134,226
https://kawalpemilu.org#26092,"TENGAH, KRAMATJATI, JAKARTA TIMUR, DKI JAKARTA",67,151,82,233
https://kawalpemilu.org#26092,"TENGAH, KRAMATJATI, JAKARTA TIMUR, DKI JAKARTA",68,104,69,173
https://kawalpemilu.org#26092,"TENGAH, KRAMATJATI, JAKARTA TIMUR, DKI JAKARTA",69,99,135,234
https://kawalpemilu.org#26092,"TENGAH, KRAMATJATI, JAKARTA TIMUR, DKI JAKARTA",70,111,124,235
https://kawalpemilu.org#26092,"TENGAH, KRAMATJATI, JAKARTA TIMUR, DKI JAKARTA",72,179,66,245
https://kawalpemilu.org#26092,"TENGAH, KRAMATJATI, JAKARTA TIMUR, DKI JAKARTA",73,92,92,184
https://kawalpemilu.org#26092,"TENGAH, KRAMATJATI, JAKARTA TIMUR, DKI JAKARTA",74,133,90,223
https://kawalpemilu.org#26092,"TENGAH, KRAMATJATI, JAKARTA TIMUR, DKI JAKARTA",75,147,80,227
https://kawalpemilu.org#26092,"TENGAH, KRAMATJATI, JAKARTA TIMUR, DKI JAKARTA",76,117,98,215
https://kawalpemilu.org#26092,"TENGAH, KRAMATJATI, JAKARTA TIMUR, DKI JAKARTA",77,109,107,216
https://kawalpemilu.org#26092,"TENGAH, KRAMATJATI, JAKARTA TIMUR, DKI JAKARTA",78,66,108,174
https://kawalpemilu.org#26092,"TENGAH, KRAMATJATI, JAKARTA TIMUR, DKI JAKARTA",79,121,131,252
https://kawalpemilu.org#26092,"TENGAH, KRAMATJATI, JAKARTA TIMUR, DKI JAKARTA",80,62,152,214
https://kawalpemilu.org#26092,"TENGAH, KRAMATJATI, JAKARTA TIMUR, DKI JAKARTA",81,122,109,231
https://kawalpemilu.org#26092,"TENGAH, KRAMATJATI, JAKARTA TIMUR, DKI JAKARTA",82,67,155,222
https://kawalpemilu.org#26092,"TENGAH, KRAMATJATI, JAKARTA TIMUR, DKI JAKARTA",83,89,137,226
https://kawalpemilu.org#26092,"TENGAH, KRAMATJATI, JAKARTA TIMUR, DKI JAKARTA",84,79,118,197
https://kawalpemilu.org#26092,"TENGAH, KRAMATJATI, JAKARTA TIMUR, DKI JAKARTA",86,86,129,215
https://kawalpemilu.org#26092,"TENGAH, KRAMATJATI, JAKARTA TIMUR, DKI JAKARTA",87,125,100,225
https://kawalpemilu.org#26092,"TENGAH, KRAMATJATI, JAKARTA TIMUR, DKI JAKARTA",89,116,91,207
https://kawalpemilu.org#26092,"TENGAH, KRAMATJATI, JAKARTA TIMUR, DKI JAKARTA",92,84,130,214
https://kawalpemilu.org#26092,"TENGAH, KRAMATJATI, JAKARTA TIMUR, DKI JAKARTA",93,118,96,214
https://kawalpemilu.org#26092,"TENGAH, KRAMATJATI, JAKARTA TIMUR, DKI JAKARTA",94,122,56,178
https://kawalpemilu.org#26092,"TENGAH, KRAMATJATI, JAKARTA TIMUR, DKI JAKARTA",95,127,60,187
https://kawalpemilu.org#26092,"TENGAH, KRAMATJATI, JAKARTA TIMUR, DKI JAKARTA",96,147,59,206
https://kawalpemilu.org#26092,"TENGAH, KRAMATJATI, JAKARTA TIMUR, DKI JAKARTA",97,130,112,242
https://kawalpemilu.org#26092,"TENGAH, KRAMATJATI, JAKARTA TIMUR, DKI JAKARTA",99,138,88,226
https://kawalpemilu.org#26092,"TENGAH, KRAMATJATI, JAKARTA TIMUR, DKI JAKARTA",100,110,75,185
https://kawalpemilu.org#26092,"TENGAH, KRAMATJATI, JAKARTA TIMUR, DKI JAKARTA",101,121,82,203
https://kawalpemilu.org#26092,"TENGAH, KRAMATJATI, JAKARTA TIMUR, DKI JAKARTA",102,94,71,165
https://kawalpemilu.org#26092,"TENGAH, KRAMATJATI, JAKARTA TIMUR, DKI JAKARTA",103,98,61,159
https://kawalpemilu.org#26092,"TENGAH, KRAMATJATI, JAKARTA TIMUR, DKI JAKARTA",105,129,88,217
https://kawalpemilu.org#26092,"TENGAH, KRAMATJATI, JAKARTA TIMUR, DKI JAKARTA",106,122,65,187
https://kawalpemilu.org#26092,"TENGAH, KRAMATJATI, JAKARTA TIMUR, DKI JAKARTA",108,80,113,193
https://kawalpemilu.org#26092,"TENGAH, KRAMATJATI, JAKARTA TIMUR, DKI JAKARTA",109,90,134,224
https://kawalpemilu.org#26092,"TENGAH, KRAMATJATI, JAKARTA TIMUR, DKI JAKARTA",110,110,109,219
https://kawalpemilu.org#26092,"TENGAH, KRAMATJATI, JAKARTA TIMUR, DKI JAKARTA",111,86,127,213
https://kawalpemilu.org#26092,"TENGAH, KRAMATJATI, JAKARTA TIMUR, DKI JAKARTA",112,108,127,235
https://kawalpemilu.org#26092,"TENGAH, KRAMATJATI, JAKARTA TIMUR, DKI JAKARTA",113,72,145,217
https://kawalpemilu.org#26092,"TENGAH, KRAMATJATI, JAKARTA TIMUR, DKI JAKARTA",114,75,91,166
https://kawalpemilu.org#26092,"TENGAH, KRAMATJATI, JAKARTA TIMUR, DKI JAKARTA",115,101,76,177
https://kawalpemilu.org#26092,"TENGAH, KRAMATJATI, JAKARTA TIMUR, DKI JAKARTA",116,83,85,168
https://kawalpemilu.org#26092,"TENGAH, KRAMATJATI, JAKARTA TIMUR, DKI JAKARTA",117,77,135,212
https://kawalpemilu.org#26092,"TENGAH, KRAMATJATI, JAKARTA TIMUR, DKI JAKARTA",118,98,162,260
https://kawalpemilu.org#26092,"TENGAH, KRAMATJATI, JAKARTA TIMUR, DKI JAKARTA",120,91,137,228
https://kawalpemilu.org#26092,"TENGAH, KRAMATJATI, JAKARTA TIMUR, DKI JAKARTA",121,68,161,229
https://kawalpemilu.org#26092,"TENGAH, KRAMATJATI, JAKARTA TIMUR, DKI JAKARTA",123,73,127,200
https://kawalpemilu.org#26092,"TENGAH, KRAMATJATI, JAKARTA TIMUR, DKI JAKARTA",124,100,116,216
https://kawalpemilu.org#26092,"TENGAH, KRAMATJATI, JAKARTA TIMUR, DKI JAKARTA",126,69,106,175
https://kawalpemilu.org#26092,"TENGAH, KRAMATJATI, JAKARTA TIMUR, DKI JAKARTA",127,97,114,211
https://kawalpemilu.org#26092,"TENGAH, KRAMATJATI, JAKARTA TIMUR, DKI JAKARTA",128,107,132,239
https://kawalpemilu.org#26092,"TENGAH, KRAMATJATI, JAKARTA TIMUR, DKI JAKARTA",129,125,106,231
https://kawalpemilu.org#26092,"TENGAH, KRAMATJATI, JAKARTA TIMUR, DKI JAKARTA",130,91,101,192
https://kawalpemilu.org#26092,"TENGAH, KRAMATJATI, JAKARTA TIMUR, DKI JAKARTA",131,89,119,208
https://kawalpemilu.org#26092,"TENGAH, KRAMATJATI, JAKARTA TIMUR, DKI JAKARTA",132,111,84,195
https://kawalpemilu.org#26092,"TENGAH, KRAMATJATI, JAKARTA TIMUR, DKI JAKARTA",133,76,83,159
https://kawalpemilu.org#26092,"TENGAH, KRAMATJATI, JAKARTA TIMUR, DKI JAKARTA",134,121,116,237
https://kawalpemilu.org#26092,"TENGAH, KRAMATJATI, JAKARTA TIMUR, DKI JAKARTA",135,69,167,236
https://kawalpemilu.org#26092,"TENGAH, KRAMATJATI, JAKARTA TIMUR, DKI JAKARTA",136,83,168,251
https://kawalpemilu.org#26092,"TENGAH, KRAMATJATI, JAKARTA TIMUR, DKI JAKARTA",138,106,98,204
https://kawalpemilu.org#26092,"TENGAH, KRAMATJATI, JAKARTA TIMUR, DKI JAKARTA",139,88,136,224
https://kawalpemilu.org#26092,"TENGAH, KRAMATJATI, JAKARTA TIMUR, DKI JAKARTA",141,125,98,223
https://kawalpemilu.org#26092,"TENGAH, KRAMATJATI, JAKARTA TIMUR, DKI JAKARTA",142,72,101,173
https://kawalpemilu.org#26093,"DUKUH, KRAMATJATI, JAKARTA TIMUR, DKI JAKARTA",1,105,129,234
https://kawalpemilu.org#26093,"DUKUH, KRAMATJATI, JAKARTA TIMUR, DKI JAKARTA",2,70,175,245
https://kawalpemilu.org#26093,"DUKUH, KRAMATJATI, JAKARTA TIMUR, DKI JAKARTA",4,74,181,255
https://kawalpemilu.org#26093,"DUKUH, KRAMATJATI, JAKARTA TIMUR, DKI JAKARTA",5,117,128,245
https://kawalpemilu.org#26093,"DUKUH, KRAMATJATI, JAKARTA TIMUR, DKI JAKARTA",6,88,142,230
https://kawalpemilu.org#26093,"DUKUH, KRAMATJATI, JAKARTA TIMUR, DKI JAKARTA",7,101,112,213
https://kawalpemilu.org#26093,"DUKUH, KRAMATJATI, JAKARTA TIMUR, DKI JAKARTA",8,92,122,214
https://kawalpemilu.org#26093,"DUKUH, KRAMATJATI, JAKARTA TIMUR, DKI JAKARTA",9,138,89,227
https://kawalpemilu.org#26093,"DUKUH, KRAMATJATI, JAKARTA TIMUR, DKI JAKARTA",10,83,176,259
https://kawalpemilu.org#26093,"DUKUH, KRAMATJATI, JAKARTA TIMUR, DKI JAKARTA",11,118,133,251
https://kawalpemilu.org#26093,"DUKUH, KRAMATJATI, JAKARTA TIMUR, DKI JAKARTA",12,138,111,249
https://kawalpemilu.org#26093,"DUKUH, KRAMATJATI, JAKARTA TIMUR, DKI JAKARTA",13,130,129,259
https://kawalpemilu.org#26093,"DUKUH, KRAMATJATI, JAKARTA TIMUR, DKI JAKARTA",14,102,138,240
https://kawalpemilu.org#26093,"DUKUH, KRAMATJATI, JAKARTA TIMUR, DKI JAKARTA",15,118,117,235
https://kawalpemilu.org#26093,"DUKUH, KRAMATJATI, JAKARTA TIMUR, DKI JAKARTA",16,77,147,224
https://kawalpemilu.org#26093,"DUKUH, KRAMATJATI, JAKARTA TIMUR, DKI JAKARTA",17,103,155,258
https://kawalpemilu.org#26093,"DUKUH, KRAMATJATI, JAKARTA TIMUR, DKI JAKARTA",18,132,113,245
https://kawalpemilu.org#26093,"DUKUH, KRAMATJATI, JAKARTA TIMUR, DKI JAKARTA",19,113,133,246
https://kawalpemilu.org#26093,"DUKUH, KRAMATJATI, JAKARTA TIMUR, DKI JAKARTA",20,100,140,240
https://kawalpemilu.org#26093,"DUKUH, KRAMATJATI, JAKARTA TIMUR, DKI JAKARTA",21,119,119,238
https://kawalpemilu.org#26093,"DUKUH, KRAMATJATI, JAKARTA TIMUR, DKI JAKARTA",23,123,107,230
https://kawalpemilu.org#26093,"DUKUH, KRAMATJATI, JAKARTA TIMUR, DKI JAKARTA",24,116,135,251
https://kawalpemilu.org#26093,"DUKUH, KRAMATJATI, JAKARTA TIMUR, DKI JAKARTA",25,97,116,213
https://kawalpemilu.org#26093,"DUKUH, KRAMATJATI, JAKARTA TIMUR, DKI JAKARTA",26,101,126,227
https://kawalpemilu.org#26093,"DUKUH, KRAMATJATI, JAKARTA TIMUR, DKI JAKARTA",27,95,124,219
https://kawalpemilu.org#26093,"DUKUH, KRAMATJATI, JAKARTA TIMUR, DKI JAKARTA",28,112,114,226
https://kawalpemilu.org#26093,"DUKUH, KRAMATJATI, JAKARTA TIMUR, DKI JAKARTA",29,0,0,0
https://kawalpemilu.org#26093,"DUKUH, KRAMATJATI, JAKARTA TIMUR, DKI JAKARTA",30,109,127,236
https://kawalpemilu.org#26093,"DUKUH, KRAMATJATI, JAKARTA TIMUR, DKI JAKARTA",31,113,128,241
https://kawalpemilu.org#26093,"DUKUH, KRAMATJATI, JAKARTA TIMUR, DKI JAKARTA",32,106,123,229
https://kawalpemilu.org#26093,"DUKUH, KRAMATJATI, JAKARTA TIMUR, DKI JAKARTA",33,123,91,214
https://kawalpemilu.org#26093,"DUKUH, KRAMATJATI, JAKARTA TIMUR, DKI JAKARTA",34,100,140,240
https://kawalpemilu.org#26093,"DUKUH, KRAMATJATI, JAKARTA TIMUR, DKI JAKARTA",35,120,133,253
https://kawalpemilu.org#26093,"DUKUH, KRAMATJATI, JAKARTA TIMUR, DKI JAKARTA",36,113,138,251
https://kawalpemilu.org#26093,"DUKUH, KRAMATJATI, JAKARTA TIMUR, DKI JAKARTA",37,97,143,240
https://kawalpemilu.org#26093,"DUKUH, KRAMATJATI, JAKARTA TIMUR, DKI JAKARTA",38,106,140,246
https://kawalpemilu.org#26093,"DUKUH, KRAMATJATI, JAKARTA TIMUR, DKI JAKARTA",39,120,127,247
https://kawalpemilu.org#26093,"DUKUH, KRAMATJATI, JAKARTA TIMUR, DKI JAKARTA",40,83,146,229
https://kawalpemilu.org#26093,"DUKUH, KRAMATJATI, JAKARTA TIMUR, DKI JAKARTA",41,92,132,224
https://kawalpemilu.org#26093,"DUKUH, KRAMATJATI, JAKARTA TIMUR, DKI JAKARTA",42,115,153,268
https://kawalpemilu.org#26093,"DUKUH, KRAMATJATI, JAKARTA TIMUR, DKI JAKARTA",43,104,146,250
https://kawalpemilu.org#26093,"DUKUH, KRAMATJATI, JAKARTA TIMUR, DKI JAKARTA",44,109,117,226
https://kawalpemilu.org#26093,"DUKUH, KRAMATJATI, JAKARTA TIMUR, DKI JAKARTA",45,114,136,250
https://kawalpemilu.org#26093,"DUKUH, KRAMATJATI, JAKARTA TIMUR, DKI JAKARTA",46,99,109,208
https://kawalpemilu.org#26093,"DUKUH, KRAMATJATI, JAKARTA TIMUR, DKI JAKARTA",47,108,154,262
https://kawalpemilu.org#26093,"DUKUH, KRAMATJATI, JAKARTA TIMUR, DKI JAKARTA",48,97,154,251
https://kawalpemilu.org#26093,"DUKUH, KRAMATJATI, JAKARTA TIMUR, DKI JAKARTA",49,110,148,258
https://kawalpemilu.org#26093,"DUKUH, KRAMATJATI, JAKARTA TIMUR, DKI JAKARTA",50,112,135,247
https://kawalpemilu.org#26093,"DUKUH, KRAMATJATI, JAKARTA TIMUR, DKI JAKARTA",51,97,87,184
https://kawalpemilu.org#26093,"DUKUH, KRAMATJATI, JAKARTA TIMUR, DKI JAKARTA",52,104,135,239
https://kawalpemilu.org#26093,"DUKUH, KRAMATJATI, JAKARTA TIMUR, DKI JAKARTA",53,117,74,191
https://kawalpemilu.org#26093,"DUKUH, KRAMATJATI, JAKARTA TIMUR, DKI JAKARTA",54,88,169,257
https://kawalpemilu.org#26093,"DUKUH, KRAMATJATI, JAKARTA TIMUR, DKI JAKARTA",55,124,123,247
https://kawalpemilu.org#26093,"DUKUH, KRAMATJATI, JAKARTA TIMUR, DKI JAKARTA",56,95,143,238
https://kawalpemilu.org#26093,"DUKUH, KRAMATJATI, JAKARTA TIMUR, DKI JAKARTA",57,132,112,244
https://kawalpemilu.org#26093,"DUKUH, KRAMATJATI, JAKARTA TIMUR, DKI JAKARTA",58,109,142,251
https://kawalpemilu.org#26093,"DUKUH, KRAMATJATI, JAKARTA TIMUR, DKI JAKARTA",59,102,122,224
https://kawalpemilu.org#26093,"DUKUH, KRAMATJATI, JAKARTA TIMUR, DKI JAKARTA",60,127,125,252
https://kawalpemilu.org#26093,"DUKUH, KRAMATJATI, JAKARTA TIMUR, DKI JAKARTA",61,102,134,236
https://kawalpemilu.org#26093,"DUKUH, KRAMATJATI, JAKARTA TIMUR, DKI JAKARTA",62,116,117,233
https://kawalpemilu.org#26093,"DUKUH, KRAMATJATI, JAKARTA TIMUR, DKI JAKARTA",63,123,102,225
https://kawalpemilu.org#26093,"DUKUH, KRAMATJATI, JAKARTA TIMUR, DKI JAKARTA",64,124,122,246
https://kawalpemilu.org#26093,"DUKUH, KRAMATJATI, JAKARTA TIMUR, DKI JAKARTA",65,96,92,188
https://kawalpemilu.org#26093,"DUKUH, KRAMATJATI, JAKARTA TIMUR, DKI JAKARTA",66,124,116,240
https://kawalpemilu.org#26093,"DUKUH, KRAMATJATI, JAKARTA TIMUR, DKI JAKARTA",67,91,121,212
https://kawalpemilu.org#26093,"DUKUH, KRAMATJATI, JAKARTA TIMUR, DKI JAKARTA",68,108,139,247
https://kawalpemilu.org#26093,"DUKUH, KRAMATJATI, JAKARTA TIMUR, DKI JAKARTA",71,108,73,181
https://kawalpemilu.org#26093,"DUKUH, KRAMATJATI, JAKARTA TIMUR, DKI JAKARTA",72,154,70,224
https://kawalpemilu.org#26093,"DUKUH, KRAMATJATI, JAKARTA TIMUR, DKI JAKARTA",73,158,52,210
https://kawalpemilu.org#26093,"DUKUH, KRAMATJATI, JAKARTA TIMUR, DKI JAKARTA",74,139,68,207
https://kawalpemilu.org#26093,"DUKUH, KRAMATJATI, JAKARTA TIMUR, DKI JAKARTA",75,110,64,174
https://kawalpemilu.org#26093,"DUKUH, KRAMATJATI, JAKARTA TIMUR, DKI JAKARTA",76,129,49,178
https://kawalpemilu.org#26094,"BATU AMPAR, KRAMATJATI, JAKARTA TIMUR, DKI JAKARTA",1,132,108,240
https://kawalpemilu.org#26094,"BATU AMPAR, KRAMATJATI, JAKARTA TIMUR, DKI JAKARTA",2,105,123,228
https://kawalpemilu.org#26094,"BATU AMPAR, KRAMATJATI, JAKARTA TIMUR, DKI JAKARTA",5,107,107,214
https://kawalpemilu.org#26094,"BATU AMPAR, KRAMATJATI, JAKARTA TIMUR, DKI JAKARTA",7,116,132,248
https://kawalpemilu.org#26094,"BATU AMPAR, KRAMATJATI, JAKARTA TIMUR, DKI JAKARTA",8,75,98,173
https://kawalpemilu.org#26094,"BATU AMPAR, KRAMATJATI, JAKARTA TIMUR, DKI JAKARTA",9,74,125,199
https://kawalpemilu.org#26094,"BATU AMPAR, KRAMATJATI, JAKARTA TIMUR, DKI JAKARTA",10,100,148,248
https://kawalpemilu.org#26094,"BATU AMPAR, KRAMATJATI, JAKARTA TIMUR, DKI JAKARTA",11,106,158,264
https://kawalpemilu.org#26094,"BATU AMPAR, KRAMATJATI, JAKARTA TIMUR, DKI JAKARTA",12,102,149,251
https://kawalpemilu.org#26094,"BATU AMPAR, KRAMATJATI, JAKARTA TIMUR, DKI JAKARTA",14,97,121,218
https://kawalpemilu.org#26094,"BATU AMPAR, KRAMATJATI, JAKARTA TIMUR, DKI JAKARTA",15,95,133,228
https://kawalpemilu.org#26094,"BATU AMPAR, KRAMATJATI, JAKARTA TIMUR, DKI JAKARTA",17,110,111,221
https://kawalpemilu.org#26094,"BATU AMPAR, KRAMATJATI, JAKARTA TIMUR, DKI JAKARTA",18,81,141,222
https://kawalpemilu.org#26094,"BATU AMPAR, KRAMATJATI, JAKARTA TIMUR, DKI JAKARTA",19,110,144,254
https://kawalpemilu.org#26094,"BATU AMPAR, KRAMATJATI, JAKARTA TIMUR, DKI JAKARTA",20,94,171,265
https://kawalpemilu.org#26094,"BATU AMPAR, KRAMATJATI, JAKARTA TIMUR, DKI JAKARTA",21,92,143,235
https://kawalpemilu.org#26094,"BATU AMPAR, KRAMATJATI, JAKARTA TIMUR, DKI JAKARTA",22,106,135,241
https://kawalpemilu.org#26094,"BATU AMPAR, KRAMATJATI, JAKARTA TIMUR, DKI JAKARTA",23,86,164,250
https://kawalpemilu.org#26094,"BATU AMPAR, KRAMATJATI, JAKARTA TIMUR, DKI JAKARTA",24,100,154,254
https://kawalpemilu.org#26094,"BATU AMPAR, KRAMATJATI, JAKARTA TIMUR, DKI JAKARTA",25,73,145,218
https://kawalpemilu.org#26094,"BATU AMPAR, KRAMATJATI, JAKARTA TIMUR, DKI JAKARTA",26,104,129,233
https://kawalpemilu.org#26094,"BATU AMPAR, KRAMATJATI, JAKARTA TIMUR, DKI JAKARTA",28,88,122,210
https://kawalpemilu.org#26094,"BATU AMPAR, KRAMATJATI, JAKARTA TIMUR, DKI JAKARTA",29,102,151,253
https://kawalpemilu.org#26094,"BATU AMPAR, KRAMATJATI, JAKARTA TIMUR, DKI JAKARTA",30,85,167,252
https://kawalpemilu.org#26094,"BATU AMPAR, KRAMATJATI, JAKARTA TIMUR, DKI JAKARTA",31,56,130,186
https://kawalpemilu.org#26094,"BATU AMPAR, KRAMATJATI, JAKARTA TIMUR, DKI JAKARTA",32,103,128,231
https://kawalpemilu.org#26094,"BATU AMPAR, KRAMATJATI, JAKARTA TIMUR, DKI JAKARTA",33,98,131,229
https://kawalpemilu.org#26094,"BATU AMPAR, KRAMATJATI, JAKARTA TIMUR, DKI JAKARTA",34,87,111,198
https://kawalpemilu.org#26094,"BATU AMPAR, KRAMATJATI, JAKARTA TIMUR, DKI JAKARTA",35,88,166,254
https://kawalpemilu.org#26094,"BATU AMPAR, KRAMATJATI, JAKARTA TIMUR, DKI JAKARTA",36,78,134,212
https://kawalpemilu.org#26094,"BATU AMPAR, KRAMATJATI, JAKARTA TIMUR, DKI JAKARTA",37,89,114,203
https://kawalpemilu.org#26094,"BATU AMPAR, KRAMATJATI, JAKARTA TIMUR, DKI JAKARTA",38,69,111,180
https://kawalpemilu.org#26094,"BATU AMPAR, KRAMATJATI, JAKARTA TIMUR, DKI JAKARTA",39,76,150,226
https://kawalpemilu.org#26094,"BATU AMPAR, KRAMATJATI, JAKARTA TIMUR, DKI JAKARTA",40,89,132,221
https://kawalpemilu.org#26094,"BATU AMPAR, KRAMATJATI, JAKARTA TIMUR, DKI JAKARTA",41,94,159,253
https://kawalpemilu.org#26094,"BATU AMPAR, KRAMATJATI, JAKARTA TIMUR, DKI JAKARTA",43,91,107,198
https://kawalpemilu.org#26094,"BATU AMPAR, KRAMATJATI, JAKARTA TIMUR, DKI JAKARTA",44,88,137,225
https://kawalpemilu.org#26094,"BATU AMPAR, KRAMATJATI, JAKARTA TIMUR, DKI JAKARTA",45,89,143,232
https://kawalpemilu.org#26094,"BATU AMPAR, KRAMATJATI, JAKARTA TIMUR, DKI JAKARTA",46,84,121,205
https://kawalpemilu.org#26094,"BATU AMPAR, KRAMATJATI, JAKARTA TIMUR, DKI JAKARTA",47,59,124,183
https://kawalpemilu.org#26094,"BATU AMPAR, KRAMATJATI, JAKARTA TIMUR, DKI JAKARTA",48,101,146,247
https://kawalpemilu.org#26094,"BATU AMPAR, KRAMATJATI, JAKARTA TIMUR, DKI JAKARTA",49,89,149,238
https://kawalpemilu.org#26094,"BATU AMPAR, KRAMATJATI, JAKARTA TIMUR, DKI JAKARTA",50,57,132,189
https://kawalpemilu.org#26094,"BATU AMPAR, KRAMATJATI, JAKARTA TIMUR, DKI JAKARTA",51,68,167,235
https://kawalpemilu.org#26094,"BATU AMPAR, KRAMATJATI, JAKARTA TIMUR, DKI JAKARTA",53,62,134,196
https://kawalpemilu.org#26094,"BATU AMPAR, KRAMATJATI, JAKARTA TIMUR, DKI JAKARTA",54,75,156,231
https://kawalpemilu.org#26094,"BATU AMPAR, KRAMATJATI, JAKARTA TIMUR, DKI JAKARTA",55,74,178,252
https://kawalpemilu.org#26094,"BATU AMPAR, KRAMATJATI, JAKARTA TIMUR, DKI JAKARTA",56,88,108,196
https://kawalpemilu.org#26094,"BATU AMPAR, KRAMATJATI, JAKARTA TIMUR, DKI JAKARTA",57,90,135,225
https://kawalpemilu.org#26094,"BATU AMPAR, KRAMATJATI, JAKARTA TIMUR, DKI JAKARTA",58,87,135,222
https://kawalpemilu.org#26094,"BATU AMPAR, KRAMATJATI, JAKARTA TIMUR, DKI JAKARTA",59,69,136,205
https://kawalpemilu.org#26094,"BATU AMPAR, KRAMATJATI, JAKARTA TIMUR, DKI JAKARTA",60,89,127,216
https://kawalpemilu.org#26094,"BATU AMPAR, KRAMATJATI, JAKARTA TIMUR, DKI JAKARTA",61,93,137,230
https://kawalpemilu.org#26094,"BATU AMPAR, KRAMATJATI, JAKARTA TIMUR, DKI JAKARTA",62,90,155,245
https://kawalpemilu.org#26094,"BATU AMPAR, KRAMATJATI, JAKARTA TIMUR, DKI JAKARTA",63,72,118,190
https://kawalpemilu.org#26094,"BATU AMPAR, KRAMATJATI, JAKARTA TIMUR, DKI JAKARTA",65,81,173,254
https://kawalpemilu.org#26094,"BATU AMPAR, KRAMATJATI, JAKARTA TIMUR, DKI JAKARTA",66,63,117,180
https://kawalpemilu.org#26094,"BATU AMPAR, KRAMATJATI, JAKARTA TIMUR, DKI JAKARTA",67,73,140,213
https://kawalpemilu.org#26094,"BATU AMPAR, KRAMATJATI, JAKARTA TIMUR, DKI JAKARTA",68,73,118,191
https://kawalpemilu.org#26094,"BATU AMPAR, KRAMATJATI, JAKARTA TIMUR, DKI JAKARTA",69,100,118,218
https://kawalpemilu.org#26094,"BATU AMPAR, KRAMATJATI, JAKARTA TIMUR, DKI JAKARTA",70,89,124,213
https://kawalpemilu.org#26094,"BATU AMPAR, KRAMATJATI, JAKARTA TIMUR, DKI JAKARTA",71,91,178,269
https://kawalpemilu.org#26094,"BATU AMPAR, KRAMATJATI, JAKARTA TIMUR, DKI JAKARTA",72,73,151,224
https://kawalpemilu.org#26094,"BATU AMPAR, KRAMATJATI, JAKARTA TIMUR, DKI JAKARTA",73,72,170,242
https://kawalpemilu.org#26094,"BATU AMPAR, KRAMATJATI, JAKARTA TIMUR, DKI JAKARTA",75,76,188,264
https://kawalpemilu.org#26094,"BATU AMPAR, KRAMATJATI, JAKARTA TIMUR, DKI JAKARTA",76,84,153,237
https://kawalpemilu.org#26094,"BATU AMPAR, KRAMATJATI, JAKARTA TIMUR, DKI JAKARTA",77,111,165,276
https://kawalpemilu.org#26094,"BATU AMPAR, KRAMATJATI, JAKARTA TIMUR, DKI JAKARTA",78,107,137,244
https://kawalpemilu.org#26094,"BATU AMPAR, KRAMATJATI, JAKARTA TIMUR, DKI JAKARTA",79,90,172,262
https://kawalpemilu.org#26094,"BATU AMPAR, KRAMATJATI, JAKARTA TIMUR, DKI JAKARTA",80,60,153,213
https://kawalpemilu.org#26094,"BATU AMPAR, KRAMATJATI, JAKARTA TIMUR, DKI JAKARTA",81,89,152,241
https://kawalpemilu.org#26094,"BATU AMPAR, KRAMATJATI, JAKARTA TIMUR, DKI JAKARTA",82,85,158,243
https://kawalpemilu.org#26094,"BATU AMPAR, KRAMATJATI, JAKARTA TIMUR, DKI JAKARTA",83,67,132,199
https://kawalpemilu.org#26094,"BATU AMPAR, KRAMATJATI, JAKARTA TIMUR, DKI JAKARTA",84,90,176,266
https://kawalpemilu.org#26094,"BATU AMPAR, KRAMATJATI, JAKARTA TIMUR, DKI JAKARTA",85,94,122,216
https://kawalpemilu.org#26094,"BATU AMPAR, KRAMATJATI, JAKARTA TIMUR, DKI JAKARTA",86,59,138,197
https://kawalpemilu.org#26094,"BATU AMPAR, KRAMATJATI, JAKARTA TIMUR, DKI JAKARTA",87,70,178,248
https://kawalpemilu.org#26094,"BATU AMPAR, KRAMATJATI, JAKARTA TIMUR, DKI JAKARTA",89,97,147,244
https://kawalpemilu.org#26094,"BATU AMPAR, KRAMATJATI, JAKARTA TIMUR, DKI JAKARTA",90,112,141,253
https://kawalpemilu.org#26094,"BATU AMPAR, KRAMATJATI, JAKARTA TIMUR, DKI JAKARTA",91,86,133,219
https://kawalpemilu.org#26094,"BATU AMPAR, KRAMATJATI, JAKARTA TIMUR, DKI JAKARTA",93,85,144,229
https://kawalpemilu.org#26094,"BATU AMPAR, KRAMATJATI, JAKARTA TIMUR, DKI JAKARTA",94,106,127,233
https://kawalpemilu.org#26094,"BATU AMPAR, KRAMATJATI, JAKARTA TIMUR, DKI JAKARTA",95,95,141,236
https://kawalpemilu.org#26094,"BATU AMPAR, KRAMATJATI, JAKARTA TIMUR, DKI JAKARTA",96,89,172,261
https://kawalpemilu.org#26094,"BATU AMPAR, KRAMATJATI, JAKARTA TIMUR, DKI JAKARTA",97,88,156,244
https://kawalpemilu.org#26094,"BATU AMPAR, KRAMATJATI, JAKARTA TIMUR, DKI JAKARTA",98,74,175,249
https://kawalpemilu.org#26094,"BATU AMPAR, KRAMATJATI, JAKARTA TIMUR, DKI JAKARTA",99,96,148,244
https://kawalpemilu.org#26094,"BATU AMPAR, KRAMATJATI, JAKARTA TIMUR, DKI JAKARTA",100,56,149,205
https://kawalpemilu.org#26094,"BATU AMPAR, KRAMATJATI, JAKARTA TIMUR, DKI JAKARTA",101,108,141,249
https://kawalpemilu.org#26094,"BATU AMPAR, KRAMATJATI, JAKARTA TIMUR, DKI JAKARTA",102,140,100,240
https://kawalpemilu.org#26094,"BATU AMPAR, KRAMATJATI, JAKARTA TIMUR, DKI JAKARTA",103,86,148,234
https://kawalpemilu.org#26094,"BATU AMPAR, KRAMATJATI, JAKARTA TIMUR, DKI JAKARTA",104,55,189,244
https://kawalpemilu.org#26094,"BATU AMPAR, KRAMATJATI, JAKARTA TIMUR, DKI JAKARTA",105,78,140,218
https://kawalpemilu.org#26094,"BATU AMPAR, KRAMATJATI, JAKARTA TIMUR, DKI JAKARTA",106,99,96,195
https://kawalpemilu.org#26094,"BATU AMPAR, KRAMATJATI, JAKARTA TIMUR, DKI JAKARTA",107,89,114,203
https://kawalpemilu.org#26094,"BATU AMPAR, KRAMATJATI, JAKARTA TIMUR, DKI JAKARTA",108,86,80,166
https://kawalpemilu.org#26094,"BATU AMPAR, KRAMATJATI, JAKARTA TIMUR, DKI JAKARTA",109,92,95,187
https://kawalpemilu.org#26094,"BATU AMPAR, KRAMATJATI, JAKARTA TIMUR, DKI JAKARTA",110,75,125,200
https://kawalpemilu.org#26094,"BATU AMPAR, KRAMATJATI, JAKARTA TIMUR, DKI JAKARTA",111,101,126,227
https://kawalpemilu.org#26094,"BATU AMPAR, KRAMATJATI, JAKARTA TIMUR, DKI JAKARTA",112,77,156,233
https://kawalpemilu.org#26094,"BATU AMPAR, KRAMATJATI, JAKARTA TIMUR, DKI JAKARTA",113,108,151,259
https://kawalpemilu.org#26094,"BATU AMPAR, KRAMATJATI, JAKARTA TIMUR, DKI JAKARTA",114,99,147,246
https://kawalpemilu.org#26094,"BATU AMPAR, KRAMATJATI, JAKARTA TIMUR, DKI JAKARTA",115,101,152,253
https://kawalpemilu.org#26094,"BATU AMPAR, KRAMATJATI, JAKARTA TIMUR, DKI JAKARTA",116,99,130,229
https://kawalpemilu.org#26094,"BATU AMPAR, KRAMATJATI, JAKARTA TIMUR, DKI JAKARTA",117,112,96,208
https://kawalpemilu.org#26094,"BATU AMPAR, KRAMATJATI, JAKARTA TIMUR, DKI JAKARTA",118,101,121,222
https://kawalpemilu.org#26094,"BATU AMPAR, KRAMATJATI, JAKARTA TIMUR, DKI JAKARTA",119,95,124,219
https://kawalpemilu.org#26094,"BATU AMPAR, KRAMATJATI, JAKARTA TIMUR, DKI JAKARTA",120,139,115,254
https://kawalpemilu.org#26094,"BATU AMPAR, KRAMATJATI, JAKARTA TIMUR, DKI JAKARTA",122,149,91,240
https://kawalpemilu.org#26094,"BATU AMPAR, KRAMATJATI, JAKARTA TIMUR, DKI JAKARTA",123,111,143,254
https://kawalpemilu.org#26094,"BATU AMPAR, KRAMATJATI, JAKARTA TIMUR, DKI JAKARTA",124,65,121,186
https://kawalpemilu.org#26094,"BATU AMPAR, KRAMATJATI, JAKARTA TIMUR, DKI JAKARTA",125,79,117,196
https://kawalpemilu.org#26094,"BATU AMPAR, KRAMATJATI, JAKARTA TIMUR, DKI JAKARTA",127,102,110,212
https://kawalpemilu.org#26094,"BATU AMPAR, KRAMATJATI, JAKARTA TIMUR, DKI JAKARTA",128,106,130,236
https://kawalpemilu.org#26094,"BATU AMPAR, KRAMATJATI, JAKARTA TIMUR, DKI JAKARTA",129,106,130,236
https://kawalpemilu.org#26094,"BATU AMPAR, KRAMATJATI, JAKARTA TIMUR, DKI JAKARTA",130,129,136,265
https://kawalpemilu.org#26094,"BATU AMPAR, KRAMATJATI, JAKARTA TIMUR, DKI JAKARTA",131,113,164,277
https://kawalpemilu.org#26094,"BATU AMPAR, KRAMATJATI, JAKARTA TIMUR, DKI JAKARTA",134,121,112,233
https://kawalpemilu.org#26094,"BATU AMPAR, KRAMATJATI, JAKARTA TIMUR, DKI JAKARTA",135,91,79,170
https://kawalpemilu.org#26094,"BATU AMPAR, KRAMATJATI, JAKARTA TIMUR, DKI JAKARTA",136,85,132,217
https://kawalpemilu.org#26094,"BATU AMPAR, KRAMATJATI, JAKARTA TIMUR, DKI JAKARTA",137,78,124,202
https://kawalpemilu.org#26094,"BATU AMPAR, KRAMATJATI, JAKARTA TIMUR, DKI JAKARTA",138,79,166,245
https://kawalpemilu.org#26094,"BATU AMPAR, KRAMATJATI, JAKARTA TIMUR, DKI JAKARTA",139,75,112,187
https://kawalpemilu.org#26094,"BATU AMPAR, KRAMATJATI, JAKARTA TIMUR, DKI JAKARTA",140,86,116,202
https://kawalpemilu.org#26094,"BATU AMPAR, KRAMATJATI, JAKARTA TIMUR, DKI JAKARTA",141,85,170,255
https://kawalpemilu.org#26094,"BATU AMPAR, KRAMATJATI, JAKARTA TIMUR, DKI JAKARTA",142,122,93,215
https://kawalpemilu.org#26094,"BATU AMPAR, KRAMATJATI, JAKARTA TIMUR, DKI JAKARTA",143,91,137,228
https://kawalpemilu.org#26094,"BATU AMPAR, KRAMATJATI, JAKARTA TIMUR, DKI JAKARTA",144,48,175,223
https://kawalpemilu.org#26094,"BATU AMPAR, KRAMATJATI, JAKARTA TIMUR, DKI JAKARTA",145,61,157,218
https://kawalpemilu.org#26094,"BATU AMPAR, KRAMATJATI, JAKARTA TIMUR, DKI JAKARTA",146,87,134,221
https://kawalpemilu.org#26094,"BATU AMPAR, KRAMATJATI, JAKARTA TIMUR, DKI JAKARTA",147,90,135,225
https://kawalpemilu.org#26094,"BATU AMPAR, KRAMATJATI, JAKARTA TIMUR, DKI JAKARTA",149,58,181,239
https://kawalpemilu.org#26094,"BATU AMPAR, KRAMATJATI, JAKARTA TIMUR, DKI JAKARTA",150,58,153,211
https://kawalpemilu.org#26094,"BATU AMPAR, KRAMATJATI, JAKARTA TIMUR, DKI JAKARTA",151,52,159,211
https://kawalpemilu.org#26094,"BATU AMPAR, KRAMATJATI, JAKARTA TIMUR, DKI JAKARTA",152,68,134,202
https://kawalpemilu.org#26094,"BATU AMPAR, KRAMATJATI, JAKARTA TIMUR, DKI JAKARTA",153,99,131,230
https://kawalpemilu.org#26095,"BALEKAMBANG, KRAMATJATI, JAKARTA TIMUR, DKI JAKARTA",1,100,127,227
https://kawalpemilu.org#26095,"BALEKAMBANG, KRAMATJATI, JAKARTA TIMUR, DKI JAKARTA",2,67,143,210
https://kawalpemilu.org#26095,"BALEKAMBANG, KRAMATJATI, JAKARTA TIMUR, DKI JAKARTA",3,56,171,227
https://kawalpemilu.org#26095,"BALEKAMBANG, KRAMATJATI, JAKARTA TIMUR, DKI JAKARTA",4,68,172,240
https://kawalpemilu.org#26095,"BALEKAMBANG, KRAMATJATI, JAKARTA TIMUR, DKI JAKARTA",5,46,166,212
https://kawalpemilu.org#26095,"BALEKAMBANG, KRAMATJATI, JAKARTA TIMUR, DKI JAKARTA",6,75,164,239
https://kawalpemilu.org#26095,"BALEKAMBANG, KRAMATJATI, JAKARTA TIMUR, DKI JAKARTA",7,70,190,260
https://kawalpemilu.org#26095,"BALEKAMBANG, KRAMATJATI, JAKARTA TIMUR, DKI JAKARTA",8,85,162,247
https://kawalpemilu.org#26095,"BALEKAMBANG, KRAMATJATI, JAKARTA TIMUR, DKI JAKARTA",9,51,170,2
https://kawalpemilu.org#26095,"BALEKAMBANG, KRAMATJATI, JAKARTA TIMUR, DKI JAKARTA",10,54,146,200
https://kawalpemilu.org#26095,"BALEKAMBANG, KRAMATJATI, JAKARTA TIMUR, DKI JAKARTA",11,62,151,213
https://kawalpemilu.org#26095,"BALEKAMBANG, KRAMATJATI, JAKARTA TIMUR, DKI JAKARTA",12,48,121,169
https://kawalpemilu.org#26095,"BALEKAMBANG, KRAMATJATI, JAKARTA TIMUR, DKI JAKARTA",13,42,154,196
https://kawalpemilu.org#26095,"BALEKAMBANG, KRAMATJATI, JAKARTA TIMUR, DKI JAKARTA",14,68,152,220
https://kawalpemilu.org#26095,"BALEKAMBANG, KRAMATJATI, JAKARTA TIMUR, DKI JAKARTA",15,46,153,199
https://kawalpemilu.org#26095,"BALEKAMBANG, KRAMATJATI, JAKARTA TIMUR, DKI JAKARTA",16,107,111,218
https://kawalpemilu.org#26095,"BALEKAMBANG, KRAMATJATI, JAKARTA TIMUR, DKI JAKARTA",17,60,128,188
https://kawalpemilu.org#26095,"BALEKAMBANG, KRAMATJATI, JAKARTA TIMUR, DKI JAKARTA",18,93,117,210
https://kawalpemilu.org#26095,"BALEKAMBANG, KRAMATJATI, JAKARTA TIMUR, DKI JAKARTA",19,87,133,220
https://kawalpemilu.org#26095,"BALEKAMBANG, KRAMATJATI, JAKARTA TIMUR, DKI JAKARTA",20,70,138,208
https://kawalpemilu.org#26095,"BALEKAMBANG, KRAMATJATI, JAKARTA TIMUR, DKI JAKARTA",21,57,182,239
https://kawalpemilu.org#26095,"BALEKAMBANG, KRAMATJATI, JAKARTA TIMUR, DKI JAKARTA",22,69,138,207
https://kawalpemilu.org#26095,"BALEKAMBANG, KRAMATJATI, JAKARTA TIMUR, DKI JAKARTA",24,57,164,221
https://kawalpemilu.org#26095,"BALEKAMBANG, KRAMATJATI, JAKARTA TIMUR, DKI JAKARTA",25,53,153,206
https://kawalpemilu.org#26095,"BALEKAMBANG, KRAMATJATI, JAKARTA TIMUR, DKI JAKARTA",26,72,160,232
https://kawalpemilu.org#26095,"BALEKAMBANG, KRAMATJATI, JAKARTA TIMUR, DKI JAKARTA",27,63,127,190
https://kawalpemilu.org#26095,"BALEKAMBANG, KRAMATJATI, JAKARTA TIMUR, DKI JAKARTA",28,77,141,218
https://kawalpemilu.org#26095,"BALEKAMBANG, KRAMATJATI, JAKARTA TIMUR, DKI JAKARTA",29,77,133,210
https://kawalpemilu.org#26095,"BALEKAMBANG, KRAMATJATI, JAKARTA TIMUR, DKI JAKARTA",30,107,115,222
https://kawalpemilu.org#26095,"BALEKAMBANG, KRAMATJATI, JAKARTA TIMUR, DKI JAKARTA",31,86,113,199
https://kawalpemilu.org#26095,"BALEKAMBANG, KRAMATJATI, JAKARTA TIMUR, DKI JAKARTA",32,99,111,210
https://kawalpemilu.org#26095,"BALEKAMBANG, KRAMATJATI, JAKARTA TIMUR, DKI JAKARTA",33,87,115,202
https://kawalpemilu.org#26095,"BALEKAMBANG, KRAMATJATI, JAKARTA TIMUR, DKI JAKARTA",34,62,146,208
https://kawalpemilu.org#26095,"BALEKAMBANG, KRAMATJATI, JAKARTA TIMUR, DKI JAKARTA",35,88,128,216
https://kawalpemilu.org#26095,"BALEKAMBANG, KRAMATJATI, JAKARTA TIMUR, DKI JAKARTA",36,69,157,226
https://kawalpemilu.org#26095,"BALEKAMBANG, KRAMATJATI, JAKARTA TIMUR, DKI JAKARTA",37,80,164,244
https://kawalpemilu.org#26095,"BALEKAMBANG, KRAMATJATI, JAKARTA TIMUR, DKI JAKARTA",38,78,170,248
https://kawalpemilu.org#26095,"BALEKAMBANG, KRAMATJATI, JAKARTA TIMUR, DKI JAKARTA",39,59,153,212
https://kawalpemilu.org#26095,"BALEKAMBANG, KRAMATJATI, JAKARTA TIMUR, DKI JAKARTA",40,94,136,230
https://kawalpemilu.org#26095,"BALEKAMBANG, KRAMATJATI, JAKARTA TIMUR, DKI JAKARTA",41,94,108,202
https://kawalpemilu.org#26095,"BALEKAMBANG, KRAMATJATI, JAKARTA TIMUR, DKI JAKARTA",42,74,114,188
https://kawalpemilu.org#26095,"BALEKAMBANG, KRAMATJATI, JAKARTA TIMUR, DKI JAKARTA",44,81,130,211
https://kawalpemilu.org#26095,"BALEKAMBANG, KRAMATJATI, JAKARTA TIMUR, DKI JAKARTA",45,63,146,209
https://kawalpemilu.org#26095,"BALEKAMBANG, KRAMATJATI, JAKARTA TIMUR, DKI JAKARTA",46,82,143,225
https://kawalpemilu.org#26095,"BALEKAMBANG, KRAMATJATI, JAKARTA TIMUR, DKI JAKARTA",47,76,129,205
https://kawalpemilu.org#26095,"BALEKAMBANG, KRAMATJATI, JAKARTA TIMUR, DKI JAKARTA",48,101,131,232
https://kawalpemilu.org#26095,"BALEKAMBANG, KRAMATJATI, JAKARTA TIMUR, DKI JAKARTA",49,84,130,214
https://kawalpemilu.org#26095,"BALEKAMBANG, KRAMATJATI, JAKARTA TIMUR, DKI JAKARTA",51,69,181,250
https://kawalpemilu.org#26095,"BALEKAMBANG, KRAMATJATI, JAKARTA TIMUR, DKI JAKARTA",52,84,153,237
https://kawalpemilu.org#26095,"BALEKAMBANG, KRAMATJATI, JAKARTA TIMUR, DKI JAKARTA",53,74,137,211
https://kawalpemilu.org#26095,"BALEKAMBANG, KRAMATJATI, JAKARTA TIMUR, DKI JAKARTA",54,64,154,218
https://kawalpemilu.org#26095,"BALEKAMBANG, KRAMATJATI, JAKARTA TIMUR, DKI JAKARTA",55,75,154,229
https://kawalpemilu.org#26095,"BALEKAMBANG, KRAMATJATI, JAKARTA TIMUR, DKI JAKARTA",56,102,112,214
https://kawalpemilu.org#26095,"BALEKAMBANG, KRAMATJATI, JAKARTA TIMUR, DKI JAKARTA",57,100,116,216
https://kawalpemilu.org#26095,"BALEKAMBANG, KRAMATJATI, JAKARTA TIMUR, DKI JAKARTA",58,84,129,213
https://kawalpemilu.org#26095,"BALEKAMBANG, KRAMATJATI, JAKARTA TIMUR, DKI JAKARTA",59,59,176,235
https://kawalpemilu.org#26095,"BALEKAMBANG, KRAMATJATI, JAKARTA TIMUR, DKI JAKARTA",60,66,131,197
https://kawalpemilu.org#26095,"BALEKAMBANG, KRAMATJATI, JAKARTA TIMUR, DKI JAKARTA",62,110,116,226
https://kawalpemilu.org#26095,"BALEKAMBANG, KRAMATJATI, JAKARTA TIMUR, DKI JAKARTA",64,53,198,251
https://kawalpemilu.org#26095,"BALEKAMBANG, KRAMATJATI, JAKARTA TIMUR, DKI JAKARTA",65,57,158,215
https://kawalpemilu.org#26095,"BALEKAMBANG, KRAMATJATI, JAKARTA TIMUR, DKI JAKARTA",66,88,159,247
https://kawalpemilu.org#26095,"BALEKAMBANG, KRAMATJATI, JAKARTA TIMUR, DKI JAKARTA",67,83,180,263
https://kawalpemilu.org#26095,"BALEKAMBANG, KRAMATJATI, JAKARTA TIMUR, DKI JAKARTA",68,60,199,259
https://kawalpemilu.org#26095,"BALEKAMBANG, KRAMATJATI, JAKARTA TIMUR, DKI JAKARTA",70,72,181,253
https://kawalpemilu.org#26095,"BALEKAMBANG, KRAMATJATI, JAKARTA TIMUR, DKI JAKARTA",71,67,175,242
https://kawalpemilu.org#26095,"BALEKAMBANG, KRAMATJATI, JAKARTA TIMUR, DKI JAKARTA",73,79,125,204
https://kawalpemilu.org#26095,"BALEKAMBANG, KRAMATJATI, JAKARTA TIMUR, DKI JAKARTA",74,80,146,226
https://kawalpemilu.org#26095,"BALEKAMBANG, KRAMATJATI, JAKARTA TIMUR, DKI JAKARTA",75,66,167,233
https://kawalpemilu.org#26095,"BALEKAMBANG, KRAMATJATI, JAKARTA TIMUR, DKI JAKARTA",77,85,108,193
https://kawalpemilu.org#26095,"BALEKAMBANG, KRAMATJATI, JAKARTA TIMUR, DKI JAKARTA",79,76,175,251
https://kawalpemilu.org#26095,"BALEKAMBANG, KRAMATJATI, JAKARTA TIMUR, DKI JAKARTA",80,58,203,261
https://kawalpemilu.org#26095,"BALEKAMBANG, KRAMATJATI, JAKARTA TIMUR, DKI JAKARTA",81,77,156,233
https://kawalpemilu.org#26095,"BALEKAMBANG, KRAMATJATI, JAKARTA TIMUR, DKI JAKARTA",82,84,168,252
https://kawalpemilu.org#26095,"BALEKAMBANG, KRAMATJATI, JAKARTA TIMUR, DKI JAKARTA",83,103,147,250
https://kawalpemilu.org#26095,"BALEKAMBANG, KRAMATJATI, JAKARTA TIMUR, DKI JAKARTA",84,75,97,172
https://kawalpemilu.org#26095,"BALEKAMBANG, KRAMATJATI, JAKARTA TIMUR, DKI JAKARTA",86,61,150,211
https://kawalpemilu.org#26095,"BALEKAMBANG, KRAMATJATI, JAKARTA TIMUR, DKI JAKARTA",92,108,113,221
https://kawalpemilu.org#26095,"BALEKAMBANG, KRAMATJATI, JAKARTA TIMUR, DKI JAKARTA",93,92,113,205
https://kawalpemilu.org#26095,"BALEKAMBANG, KRAMATJATI, JAKARTA TIMUR, DKI JAKARTA",94,71,112,183
https://kawalpemilu.org#26096,"CILILITAN, KRAMATJATI, JAKARTA TIMUR, DKI JAKARTA",1,121,122,243
https://kawalpemilu.org#26096,"CILILITAN, KRAMATJATI, JAKARTA TIMUR, DKI JAKARTA",5,102,131,233
https://kawalpemilu.org#26096,"CILILITAN, KRAMATJATI, JAKARTA TIMUR, DKI JAKARTA",6,0,0,0
https://kawalpemilu.org#26096,"CILILITAN, KRAMATJATI, JAKARTA TIMUR, DKI JAKARTA",7,121,66,187
https://kawalpemilu.org#26096,"CILILITAN, KRAMATJATI, JAKARTA TIMUR, DKI JAKARTA",10,79,136,215
https://kawalpemilu.org#26096,"CILILITAN, KRAMATJATI, JAKARTA TIMUR, DKI JAKARTA",13,79,165,244
https://kawalpemilu.org#26096,"CILILITAN, KRAMATJATI, JAKARTA TIMUR, DKI JAKARTA",14,72,178,250
https://kawalpemilu.org#26096,"CILILITAN, KRAMATJATI, JAKARTA TIMUR, DKI JAKARTA",15,98,148,246
https://kawalpemilu.org#26096,"CILILITAN, KRAMATJATI, JAKARTA TIMUR, DKI JAKARTA",16,82,170,252
https://kawalpemilu.org#26096,"CILILITAN, KRAMATJATI, JAKARTA TIMUR, DKI JAKARTA",17,0,0,0
https://kawalpemilu.org#26096,"CILILITAN, KRAMATJATI, JAKARTA TIMUR, DKI JAKARTA",18,90,154,244
https://kawalpemilu.org#26096,"CILILITAN, KRAMATJATI, JAKARTA TIMUR, DKI JAKARTA",19,125,74,199
https://kawalpemilu.org#26096,"CILILITAN, KRAMATJATI, JAKARTA TIMUR, DKI JAKARTA",20,148,90,238
https://kawalpemilu.org#26096,"CILILITAN, KRAMATJATI, JAKARTA TIMUR, DKI JAKARTA",21,128,87,215
https://kawalpemilu.org#26096,"CILILITAN, KRAMATJATI, JAKARTA TIMUR, DKI JAKARTA",22,87,114,201
https://kawalpemilu.org#26096,"CILILITAN, KRAMATJATI, JAKARTA TIMUR, DKI JAKARTA",23,85,141,226
https://kawalpemilu.org#26096,"CILILITAN, KRAMATJATI, JAKARTA TIMUR, DKI JAKARTA",24,142,91,233
https://kawalpemilu.org#26096,"CILILITAN, KRAMATJATI, JAKARTA TIMUR, DKI JAKARTA",25,116,102,218
https://kawalpemilu.org#26096,"CILILITAN, KRAMATJATI, JAKARTA TIMUR, DKI JAKARTA",26,85,157,242
https://kawalpemilu.org#26096,"CILILITAN, KRAMATJATI, JAKARTA TIMUR, DKI JAKARTA",28,88,130,218
https://kawalpemilu.org#26096,"CILILITAN, KRAMATJATI, JAKARTA TIMUR, DKI JAKARTA",29,70,130,200
https://kawalpemilu.org#26096,"CILILITAN, KRAMATJATI, JAKARTA TIMUR, DKI JAKARTA",30,84,120,204
https://kawalpemilu.org#26096,"CILILITAN, KRAMATJATI, JAKARTA TIMUR, DKI JAKARTA",33,125,120,245
https://kawalpemilu.org#26096,"CILILITAN, KRAMATJATI, JAKARTA TIMUR, DKI JAKARTA",34,75,173,248
https://kawalpemilu.org#26096,"CILILITAN, KRAMATJATI, JAKARTA TIMUR, DKI JAKARTA",35,76,163,239
https://kawalpemilu.org#26096,"CILILITAN, KRAMATJATI, JAKARTA TIMUR, DKI JAKARTA",36,78,125,203
https://kawalpemilu.org#26096,"CILILITAN, KRAMATJATI, JAKARTA TIMUR, DKI JAKARTA",37,93,124,217
https://kawalpemilu.org#26096,"CILILITAN, KRAMATJATI, JAKARTA TIMUR, DKI JAKARTA",38,84,129,213
https://kawalpemilu.org#26096,"CILILITAN, KRAMATJATI, JAKARTA TIMUR, DKI JAKARTA",39,79,139,218
https://kawalpemilu.org#26096,"CILILITAN, KRAMATJATI, JAKARTA TIMUR, DKI JAKARTA",40,82,146,228
https://kawalpemilu.org#26096,"CILILITAN, KRAMATJATI, JAKARTA TIMUR, DKI JAKARTA",41,58,180,238
https://kawalpemilu.org#26096,"CILILITAN, KRAMATJATI, JAKARTA TIMUR, DKI JAKARTA",43,53,158,211
https://kawalpemilu.org#26096,"CILILITAN, KRAMATJATI, JAKARTA TIMUR, DKI JAKARTA",44,107,150,257
https://kawalpemilu.org#26096,"CILILITAN, KRAMATJATI, JAKARTA TIMUR, DKI JAKARTA",45,51,148,199
https://kawalpemilu.org#26096,"CILILITAN, KRAMATJATI, JAKARTA TIMUR, DKI JAKARTA",46,73,154,227
https://kawalpemilu.org#26096,"CILILITAN, KRAMATJATI, JAKARTA TIMUR, DKI JAKARTA",47,82,122,204
https://kawalpemilu.org#26096,"CILILITAN, KRAMATJATI, JAKARTA TIMUR, DKI JAKARTA",48,94,130,224
https://kawalpemilu.org#26096,"CILILITAN, KRAMATJATI, JAKARTA TIMUR, DKI JAKARTA",49,67,116,183
https://kawalpemilu.org#26096,"CILILITAN, KRAMATJATI, JAKARTA TIMUR, DKI JAKARTA",50,57,188,245
https://kawalpemilu.org#26096,"CILILITAN, KRAMATJATI, JAKARTA TIMUR, DKI JAKARTA",52,75,153,228
https://kawalpemilu.org#26096,"CILILITAN, KRAMATJATI, JAKARTA TIMUR, DKI JAKARTA",53,60,167,227
https://kawalpemilu.org#26096,"CILILITAN, KRAMATJATI, JAKARTA TIMUR, DKI JAKARTA",54,78,157,235
https://kawalpemilu.org#26096,"CILILITAN, KRAMATJATI, JAKARTA TIMUR, DKI JAKARTA",57,73,161,234
https://kawalpemilu.org#26096,"CILILITAN, KRAMATJATI, JAKARTA TIMUR, DKI JAKARTA",58,66,159,225
https://kawalpemilu.org#26096,"CILILITAN, KRAMATJATI, JAKARTA TIMUR, DKI JAKARTA",59,35,206,241
https://kawalpemilu.org#26096,"CILILITAN, KRAMATJATI, JAKARTA TIMUR, DKI JAKARTA",60,63,159,222
https://kawalpemilu.org#26096,"CILILITAN, KRAMATJATI, JAKARTA TIMUR, DKI JAKARTA",62,57,145,202
https://kawalpemilu.org#26096,"CILILITAN, KRAMATJATI, JAKARTA TIMUR, DKI JAKARTA",63,66,173,239
https://kawalpemilu.org#26096,"CILILITAN, KRAMATJATI, JAKARTA TIMUR, DKI JAKARTA",65,90,150,240
https://kawalpemilu.org#26096,"CILILITAN, KRAMATJATI, JAKARTA TIMUR, DKI JAKARTA",66,55,178,233
https://kawalpemilu.org#26096,"CILILITAN, KRAMATJATI, JAKARTA TIMUR, DKI JAKARTA",67,59,131,190
https://kawalpemilu.org#26096,"CILILITAN, KRAMATJATI, JAKARTA TIMUR, DKI JAKARTA",68,90,112,202
https://kawalpemilu.org#26096,"CILILITAN, KRAMATJATI, JAKARTA TIMUR, DKI JAKARTA",69,102,102,204
https://kawalpemilu.org#26096,"CILILITAN, KRAMATJATI, JAKARTA TIMUR, DKI JAKARTA",70,64,130,194
https://kawalpemilu.org#26096,"CILILITAN, KRAMATJATI, JAKARTA TIMUR, DKI JAKARTA",72,108,147,255
https://kawalpemilu.org#26096,"CILILITAN, KRAMATJATI, JAKARTA TIMUR, DKI JAKARTA",76,62,158,220
https://kawalpemilu.org#26096,"CILILITAN, KRAMATJATI, JAKARTA TIMUR, DKI JAKARTA",77,61,132,193
https://kawalpemilu.org#26096,"CILILITAN, KRAMATJATI, JAKARTA TIMUR, DKI JAKARTA",78,79,129,208
https://kawalpemilu.org#26096,"CILILITAN, KRAMATJATI, JAKARTA TIMUR, DKI JAKARTA",79,224,6,230
https://kawalpemilu.org#26096,"CILILITAN, KRAMATJATI, JAKARTA TIMUR, DKI JAKARTA",80,230,8,238
https://kawalpemilu.org#26096,"CILILITAN, KRAMATJATI, JAKARTA TIMUR, DKI JAKARTA",81,212,6,218
https://kawalpemilu.org#26096,"CILILITAN, KRAMATJATI, JAKARTA TIMUR, DKI JAKARTA",82,235,2,237
https://kawalpemilu.org#26096,"CILILITAN, KRAMATJATI, JAKARTA TIMUR, DKI JAKARTA",83,230,0,230
https://kawalpemilu.org#26096,"CILILITAN, KRAMATJATI, JAKARTA TIMUR, DKI JAKARTA",84,228,4,232
https://kawalpemilu.org#26096,"CILILITAN, KRAMATJATI, JAKARTA TIMUR, DKI JAKARTA",86,240,7,247
https://kawalpemilu.org#26096,"CILILITAN, KRAMATJATI, JAKARTA TIMUR, DKI JAKARTA",87,110,76,186
https://kawalpemilu.org#26096,"CILILITAN, KRAMATJATI, JAKARTA TIMUR, DKI JAKARTA",91,91,143,234
https://kawalpemilu.org#26096,"CILILITAN, KRAMATJATI, JAKARTA TIMUR, DKI JAKARTA",92,119,92,211
https://kawalpemilu.org#26096,"CILILITAN, KRAMATJATI, JAKARTA TIMUR, DKI JAKARTA",96,97,153,250
https://kawalpemilu.org#26096,"CILILITAN, KRAMATJATI, JAKARTA TIMUR, DKI JAKARTA",99,90,149,239
https://kawalpemilu.org#26096,"CILILITAN, KRAMATJATI, JAKARTA TIMUR, DKI JAKARTA",100,98,141,239
https://kawalpemilu.org#26096,"CILILITAN, KRAMATJATI, JAKARTA TIMUR, DKI JAKARTA",101,48,198,246
https://kawalpemilu.org#26096,"CILILITAN, KRAMATJATI, JAKARTA TIMUR, DKI JAKARTA",102,75,157,232
https://kawalpemilu.org#26096,"CILILITAN, KRAMATJATI, JAKARTA TIMUR, DKI JAKARTA",103,80,174,254
https://kawalpemilu.org#26096,"CILILITAN, KRAMATJATI, JAKARTA TIMUR, DKI JAKARTA",104,107,119,226
https://kawalpemilu.org#26096,"CILILITAN, KRAMATJATI, JAKARTA TIMUR, DKI JAKARTA",108,121,111,232
https://kawalpemilu.org#26096,"CILILITAN, KRAMATJATI, JAKARTA TIMUR, DKI JAKARTA",109,88,149,237
https://kawalpemilu.org#26096,"CILILITAN, KRAMATJATI, JAKARTA TIMUR, DKI JAKARTA",110,66,122,188
https://kawalpemilu.org#26096,"CILILITAN, KRAMATJATI, JAKARTA TIMUR, DKI JAKARTA",111,61,120,181
https://kawalpemilu.org#26096,"CILILITAN, KRAMATJATI, JAKARTA TIMUR, DKI JAKARTA",112,80,174,254
https://kawalpemilu.org#26096,"CILILITAN, KRAMATJATI, JAKARTA TIMUR, DKI JAKARTA",115,63,164,227
https://kawalpemilu.org#26096,"CILILITAN, KRAMATJATI, JAKARTA TIMUR, DKI JAKARTA",117,85,147,232
https://kawalpemilu.org#26096,"CILILITAN, KRAMATJATI, JAKARTA TIMUR, DKI JAKARTA",119,75,103,178
https://kawalpemilu.org#26096,"CILILITAN, KRAMATJATI, JAKARTA TIMUR, DKI JAKARTA",125,69,178,247
https://kawalpemilu.org#26096,"CILILITAN, KRAMATJATI, JAKARTA TIMUR, DKI JAKARTA",126,61,192,253
https://kawalpemilu.org#26096,"CILILITAN, KRAMATJATI, JAKARTA TIMUR, DKI JAKARTA",127,62,180,242
https://kawalpemilu.org#26096,"CILILITAN, KRAMATJATI, JAKARTA TIMUR, DKI JAKARTA",128,86,182,268
https://kawalpemilu.org#26096,"CILILITAN, KRAMATJATI, JAKARTA TIMUR, DKI JAKARTA",129,78,177,255
https://kawalpemilu.org#26096,"CILILITAN, KRAMATJATI, JAKARTA TIMUR, DKI JAKARTA",130,95,164,259
https://kawalpemilu.org#26097,"CAWANG, KRAMATJATI, JAKARTA TIMUR, DKI JAKARTA",2,77,67,144
https://kawalpemilu.org#26097,"CAWANG, KRAMATJATI, JAKARTA TIMUR, DKI JAKARTA",3,43,147,190
https://kawalpemilu.org#26097,"CAWANG, KRAMATJATI, JAKARTA TIMUR, DKI JAKARTA",5,72,120,192
https://kawalpemilu.org#26097,"CAWANG, KRAMATJATI, JAKARTA TIMUR, DKI JAKARTA",6,79,88,167
https://kawalpemilu.org#26097,"CAWANG, KRAMATJATI, JAKARTA TIMUR, DKI JAKARTA",7,75,166,241
https://kawalpemilu.org#26097,"CAWANG, KRAMATJATI, JAKARTA TIMUR, DKI JAKARTA",8,128,103,231
https://kawalpemilu.org#26097,"CAWANG, KRAMATJATI, JAKARTA TIMUR, DKI JAKARTA",9,121,103,224
https://kawalpemilu.org#26097,"CAWANG, KRAMATJATI, JAKARTA TIMUR, DKI JAKARTA",10,84,145,229
https://kawalpemilu.org#26097,"CAWANG, KRAMATJATI, JAKARTA TIMUR, DKI JAKARTA",11,90,128,218
https://kawalpemilu.org#26097,"CAWANG, KRAMATJATI, JAKARTA TIMUR, DKI JAKARTA",12,76,124,200
https://kawalpemilu.org#26097,"CAWANG, KRAMATJATI, JAKARTA TIMUR, DKI JAKARTA",13,63,128,191
https://kawalpemilu.org#26097,"CAWANG, KRAMATJATI, JAKARTA TIMUR, DKI JAKARTA",14,54,121,175
https://kawalpemilu.org#26097,"CAWANG, KRAMATJATI, JAKARTA TIMUR, DKI JAKARTA",20,66,128,194
https://kawalpemilu.org#26097,"CAWANG, KRAMATJATI, JAKARTA TIMUR, DKI JAKARTA",23,125,34,159
https://kawalpemilu.org#26097,"CAWANG, KRAMATJATI, JAKARTA TIMUR, DKI JAKARTA",24,116,47,163
https://kawalpemilu.org#26097,"CAWANG, KRAMATJATI, JAKARTA TIMUR, DKI JAKARTA",25,167,30,197
https://kawalpemilu.org#26097,"CAWANG, KRAMATJATI, JAKARTA TIMUR, DKI JAKARTA",26,73,147,220
https://kawalpemilu.org#26097,"CAWANG, KRAMATJATI, JAKARTA TIMUR, DKI JAKARTA",27,105,104,209
https://kawalpemilu.org#26097,"CAWANG, KRAMATJATI, JAKARTA TIMUR, DKI JAKARTA",28,128,99,227
https://kawalpemilu.org#26097,"CAWANG, KRAMATJATI, JAKARTA TIMUR, DKI JAKARTA",29,143,93,236
https://kawalpemilu.org#26097,"CAWANG, KRAMATJATI, JAKARTA TIMUR, DKI JAKARTA",31,138,74,212
https://kawalpemilu.org#26097,"CAWANG, KRAMATJATI, JAKARTA TIMUR, DKI JAKARTA",34,118,85,203
https://kawalpemilu.org#26097,"CAWANG, KRAMATJATI, JAKARTA TIMUR, DKI JAKARTA",35,85,134,219
https://kawalpemilu.org#26097,"CAWANG, KRAMATJATI, JAKARTA TIMUR, DKI JAKARTA",36,63,146,209
https://kawalpemilu.org#26097,"CAWANG, KRAMATJATI, JAKARTA TIMUR, DKI JAKARTA",37,62,153,215
https://kawalpemilu.org#26097,"CAWANG, KRAMATJATI, JAKARTA TIMUR, DKI JAKARTA",38,54,159,213
https://kawalpemilu.org#26097,"CAWANG, KRAMATJATI, JAKARTA TIMUR, DKI JAKARTA",39,52,186,238
https://kawalpemilu.org#26097,"CAWANG, KRAMATJATI, JAKARTA TIMUR, DKI JAKARTA",41,61,148,209
https://kawalpemilu.org#26097,"CAWANG, KRAMATJATI, JAKARTA TIMUR, DKI JAKARTA",42,67,150,217
https://kawalpemilu.org#26097,"CAWANG, KRAMATJATI, JAKARTA TIMUR, DKI JAKARTA",43,53,151,204
https://kawalpemilu.org#26097,"CAWANG, KRAMATJATI, JAKARTA TIMUR, DKI JAKARTA",44,62,176,238
https://kawalpemilu.org#26097,"CAWANG, KRAMATJATI, JAKARTA TIMUR, DKI JAKARTA",45,102,114,216
https://kawalpemilu.org#26097,"CAWANG, KRAMATJATI, JAKARTA TIMUR, DKI JAKARTA",46,88,124,212
https://kawalpemilu.org#26097,"CAWANG, KRAMATJATI, JAKARTA TIMUR, DKI JAKARTA",48,117,73,190
https://kawalpemilu.org#26097,"CAWANG, KRAMATJATI, JAKARTA TIMUR, DKI JAKARTA",51,72,118,190
https://kawalpemilu.org#26097,"CAWANG, KRAMATJATI, JAKARTA TIMUR, DKI JAKARTA",52,136,124,260
https://kawalpemilu.org#26097,"CAWANG, KRAMATJATI, JAKARTA TIMUR, DKI JAKARTA",53,93,136,229
https://kawalpemilu.org#26097,"CAWANG, KRAMATJATI, JAKARTA TIMUR, DKI JAKARTA",56,77,118,195
https://kawalpemilu.org#26097,"CAWANG, KRAMATJATI, JAKARTA TIMUR, DKI JAKARTA",57,71,119,190
https://kawalpemilu.org#26097,"CAWANG, KRAMATJATI, JAKARTA TIMUR, DKI JAKARTA",58,197,53,250
https://kawalpemilu.org#26097,"CAWANG, KRAMATJATI, JAKARTA TIMUR, DKI JAKARTA",59,150,88,238
https://kawalpemilu.org#26097,"CAWANG, KRAMATJATI, JAKARTA TIMUR, DKI JAKARTA",61,70,165,235
https://kawalpemilu.org#26097,"CAWANG, KRAMATJATI, JAKARTA TIMUR, DKI JAKARTA",63,65,161,226
https://kawalpemilu.org#26097,"CAWANG, KRAMATJATI, JAKARTA TIMUR, DKI JAKARTA",64,104,113,217
https://kawalpemilu.org#26097,"CAWANG, KRAMATJATI, JAKARTA TIMUR, DKI JAKARTA",66,97,106,203
https://kawalpemilu.org#26097,"CAWANG, KRAMATJATI, JAKARTA TIMUR, DKI JAKARTA",67,77,142,219
https://kawalpemilu.org#26097,"CAWANG, KRAMATJATI, JAKARTA TIMUR, DKI JAKARTA",69,95,157,252
https://kawalpemilu.org#26097,"CAWANG, KRAMATJATI, JAKARTA TIMUR, DKI JAKARTA",70,53,170,223
https://kawalpemilu.org#26097,"CAWANG, KRAMATJATI, JAKARTA TIMUR, DKI JAKARTA",71,75,145,220
https://kawalpemilu.org#26097,"CAWANG, KRAMATJATI, JAKARTA TIMUR, DKI JAKARTA",72,102,128,230
https://kawalpemilu.org#26097,"CAWANG, KRAMATJATI, JAKARTA TIMUR, DKI JAKARTA",73,75,157,232
https://kawalpemilu.org#26097,"CAWANG, KRAMATJATI, JAKARTA TIMUR, DKI JAKARTA",74,118,73,191
https://kawalpemilu.org#26097,"CAWANG, KRAMATJATI, JAKARTA TIMUR, DKI JAKARTA",75,110,114,224
https://kawalpemilu.org#26097,"CAWANG, KRAMATJATI, JAKARTA TIMUR, DKI JAKARTA",77,119,82,201
https://kawalpemilu.org#26097,"CAWANG, KRAMATJATI, JAKARTA TIMUR, DKI JAKARTA",80,112,101,213
https://kawalpemilu.org#26097,"CAWANG, KRAMATJATI, JAKARTA TIMUR, DKI JAKARTA",82,112,93,205
https://kawalpemilu.org#26097,"CAWANG, KRAMATJATI, JAKARTA TIMUR, DKI JAKARTA",84,130,110,240
https://kawalpemilu.org#26097,"CAWANG, KRAMATJATI, JAKARTA TIMUR, DKI JAKARTA",85,86,158,244
https://kawalpemilu.org#26097,"CAWANG, KRAMATJATI, JAKARTA TIMUR, DKI JAKARTA",87,87,138,225
https://kawalpemilu.org#26097,"CAWANG, KRAMATJATI, JAKARTA TIMUR, DKI JAKARTA",88,92,133,225
https://kawalpemilu.org#26097,"CAWANG, KRAMATJATI, JAKARTA TIMUR, DKI JAKARTA",89,93,123,216
https://kawalpemilu.org#26097,"CAWANG, KRAMATJATI, JAKARTA TIMUR, DKI JAKARTA",90,94,92,186
https://kawalpemilu.org#26097,"CAWANG, KRAMATJATI, JAKARTA TIMUR, DKI JAKARTA",92,96,99,195
https://kawalpemilu.org#26097,"CAWANG, KRAMATJATI, JAKARTA TIMUR, DKI JAKARTA",94,79,127,206
https://kawalpemilu.org#26097,"CAWANG, KRAMATJATI, JAKARTA TIMUR, DKI JAKARTA",95,136,100,236
https://kawalpemilu.org#26097,"CAWANG, KRAMATJATI, JAKARTA TIMUR, DKI JAKARTA",96,141,97,238
https://kawalpemilu.org#26097,"CAWANG, KRAMATJATI, JAKARTA TIMUR, DKI JAKARTA",97,108,133,241
https://kawalpemilu.org#26097,"CAWANG, KRAMATJATI, JAKARTA TIMUR, DKI JAKARTA",98,154,78,232
https://kawalpemilu.org#26097,"CAWANG, KRAMATJATI, JAKARTA TIMUR, DKI JAKARTA",102,101,117,218
https://kawalpemilu.org#26097,"CAWANG, KRAMATJATI, JAKARTA TIMUR, DKI JAKARTA",104,212,16,228
https://kawalpemilu.org#26097,"CAWANG, KRAMATJATI, JAKARTA TIMUR, DKI JAKARTA",105,59,192,251
https://kawalpemilu.org#26097,"CAWANG, KRAMATJATI, JAKARTA TIMUR, DKI JAKARTA",106,75,152,227
https://kawalpemilu.org#26097,"CAWANG, KRAMATJATI, JAKARTA TIMUR, DKI JAKARTA",107,104,120,224
https://kawalpemilu.org#26097,"CAWANG, KRAMATJATI, JAKARTA TIMUR, DKI JAKARTA",108,108,92,200
https://kawalpemilu.org#26097,"CAWANG, KRAMATJATI, JAKARTA TIMUR, DKI JAKARTA",109,95,138,233
https://kawalpemilu.org#26097,"CAWANG, KRAMATJATI, JAKARTA TIMUR, DKI JAKARTA",110,94,135,229
https://kawalpemilu.org#26097,"CAWANG, KRAMATJATI, JAKARTA TIMUR, DKI JAKARTA",111,64,99,163
https://kawalpemilu.org#26099,"PEKAYON, PASAR REBO, JAKARTA TIMUR, DKI JAKARTA",1,42,128,170
https://kawalpemilu.org#26099,"PEKAYON, PASAR REBO, JAKARTA TIMUR, DKI JAKARTA",3,82,152,234
https://kawalpemilu.org#26099,"PEKAYON, PASAR REBO, JAKARTA TIMUR, DKI JAKARTA",4,55,169,224
https://kawalpemilu.org#26099,"PEKAYON, PASAR REBO, JAKARTA TIMUR, DKI JAKARTA",5,94,163,257
https://kawalpemilu.org#26099,"PEKAYON, PASAR REBO, JAKARTA TIMUR, DKI JAKARTA",6,118,124,242
https://kawalpemilu.org#26099,"PEKAYON, PASAR REBO, JAKARTA TIMUR, DKI JAKARTA",7,110,145,255
https://kawalpemilu.org#26099,"PEKAYON, PASAR REBO, JAKARTA TIMUR, DKI JAKARTA",8,106,113,219
https://kawalpemilu.org#26099,"PEKAYON, PASAR REBO, JAKARTA TIMUR, DKI JAKARTA",9,112,149,261
https://kawalpemilu.org#26099,"PEKAYON, PASAR REBO, JAKARTA TIMUR, DKI JAKARTA",10,88,177,265
https://kawalpemilu.org#26099,"PEKAYON, PASAR REBO, JAKARTA TIMUR, DKI JAKARTA",11,87,97,184
https://kawalpemilu.org#26099,"PEKAYON, PASAR REBO, JAKARTA TIMUR, DKI JAKARTA",12,80,133,213
https://kawalpemilu.org#26099,"PEKAYON, PASAR REBO, JAKARTA TIMUR, DKI JAKARTA",13,57,131,188
https://kawalpemilu.org#26099,"PEKAYON, PASAR REBO, JAKARTA TIMUR, DKI JAKARTA",14,129,115,244
https://kawalpemilu.org#26099,"PEKAYON, PASAR REBO, JAKARTA TIMUR, DKI JAKARTA",15,68,76,144
https://kawalpemilu.org#26099,"PEKAYON, PASAR REBO, JAKARTA TIMUR, DKI JAKARTA",16,0,0,0
https://kawalpemilu.org#26099,"PEKAYON, PASAR REBO, JAKARTA TIMUR, DKI JAKARTA",17,70,168,238
https://kawalpemilu.org#26099,"PEKAYON, PASAR REBO, JAKARTA TIMUR, DKI JAKARTA",18,74,183,257
https://kawalpemilu.org#26099,"PEKAYON, PASAR REBO, JAKARTA TIMUR, DKI JAKARTA",19,68,165,233
https://kawalpemilu.org#26099,"PEKAYON, PASAR REBO, JAKARTA TIMUR, DKI JAKARTA",20,98,101,199
https://kawalpemilu.org#26099,"PEKAYON, PASAR REBO, JAKARTA TIMUR, DKI JAKARTA",21,86,119,205
https://kawalpemilu.org#26099,"PEKAYON, PASAR REBO, JAKARTA TIMUR, DKI JAKARTA",22,74,136,210
https://kawalpemilu.org#26099,"PEKAYON, PASAR REBO, JAKARTA TIMUR, DKI JAKARTA",23,70,165,235
https://kawalpemilu.org#26099,"PEKAYON, PASAR REBO, JAKARTA TIMUR, DKI JAKARTA",24,135,92,227
https://kawalpemilu.org#26099,"PEKAYON, PASAR REBO, JAKARTA TIMUR, DKI JAKARTA",25,126,103,229
https://kawalpemilu.org#26099,"PEKAYON, PASAR REBO, JAKARTA TIMUR, DKI JAKARTA",27,91,141,232
https://kawalpemilu.org#26099,"PEKAYON, PASAR REBO, JAKARTA TIMUR, DKI JAKARTA",28,108,119,227
https://kawalpemilu.org#26099,"PEKAYON, PASAR REBO, JAKARTA TIMUR, DKI JAKARTA",29,138,111,249
https://kawalpemilu.org#26099,"PEKAYON, PASAR REBO, JAKARTA TIMUR, DKI JAKARTA",30,128,111,239
https://kawalpemilu.org#26099,"PEKAYON, PASAR REBO, JAKARTA TIMUR, DKI JAKARTA",32,143,79,222
https://kawalpemilu.org#26099,"PEKAYON, PASAR REBO, JAKARTA TIMUR, DKI JAKARTA",34,114,107,221
https://kawalpemilu.org#26099,"PEKAYON, PASAR REBO, JAKARTA TIMUR, DKI JAKARTA",35,87,121,208
https://kawalpemilu.org#26099,"PEKAYON, PASAR REBO, JAKARTA TIMUR, DKI JAKARTA",36,97,123,220
https://kawalpemilu.org#26099,"PEKAYON, PASAR REBO, JAKARTA TIMUR, DKI JAKARTA",37,109,92,201
https://kawalpemilu.org#26099,"PEKAYON, PASAR REBO, JAKARTA TIMUR, DKI JAKARTA",38,97,100,197
https://kawalpemilu.org#26099,"PEKAYON, PASAR REBO, JAKARTA TIMUR, DKI JAKARTA",39,84,138,222
https://kawalpemilu.org#26099,"PEKAYON, PASAR REBO, JAKARTA TIMUR, DKI JAKARTA",40,102,99,201
https://kawalpemilu.org#26099,"PEKAYON, PASAR REBO, JAKARTA TIMUR, DKI JAKARTA",41,98,87,185
https://kawalpemilu.org#26099,"PEKAYON, PASAR REBO, JAKARTA TIMUR, DKI JAKARTA",43,97,155,252
https://kawalpemilu.org#26099,"PEKAYON, PASAR REBO, JAKARTA TIMUR, DKI JAKARTA",46,74,126,200
https://kawalpemilu.org#26099,"PEKAYON, PASAR REBO, JAKARTA TIMUR, DKI JAKARTA",47,74,151,225
https://kawalpemilu.org#26099,"PEKAYON, PASAR REBO, JAKARTA TIMUR, DKI JAKARTA",48,151,100,251
https://kawalpemilu.org#26099,"PEKAYON, PASAR REBO, JAKARTA TIMUR, DKI JAKARTA",49,145,99,244
https://kawalpemilu.org#26099,"PEKAYON, PASAR REBO, JAKARTA TIMUR, DKI JAKARTA",50,114,100,214
https://kawalpemilu.org#26099,"PEKAYON, PASAR REBO, JAKARTA TIMUR, DKI JAKARTA",51,111,133,244
https://kawalpemilu.org#26099,"PEKAYON, PASAR REBO, JAKARTA TIMUR, DKI JAKARTA",52,100,111,211
https://kawalpemilu.org#26099,"PEKAYON, PASAR REBO, JAKARTA TIMUR, DKI JAKARTA",53,98,120,218
https://kawalpemilu.org#26099,"PEKAYON, PASAR REBO, JAKARTA TIMUR, DKI JAKARTA",55,98,101,199
https://kawalpemilu.org#26099,"PEKAYON, PASAR REBO, JAKARTA TIMUR, DKI JAKARTA",57,23,169,192
https://kawalpemilu.org#26099,"PEKAYON, PASAR REBO, JAKARTA TIMUR, DKI JAKARTA",58,7,174,181
https://kawalpemilu.org#26099,"PEKAYON, PASAR REBO, JAKARTA TIMUR, DKI JAKARTA",59,24,167,191
https://kawalpemilu.org#26099,"PEKAYON, PASAR REBO, JAKARTA TIMUR, DKI JAKARTA",60,125,88,213
https://kawalpemilu.org#26099,"PEKAYON, PASAR REBO, JAKARTA TIMUR, DKI JAKARTA",61,172,101,273
https://kawalpemilu.org#26099,"PEKAYON, PASAR REBO, JAKARTA TIMUR, DKI JAKARTA",62,92,118,210
https://kawalpemilu.org#26099,"PEKAYON, PASAR REBO, JAKARTA TIMUR, DKI JAKARTA",63,118,98,216
https://kawalpemilu.org#26099,"PEKAYON, PASAR REBO, JAKARTA TIMUR, DKI JAKARTA",64,155,105,264
https://kawalpemilu.org#26099,"PEKAYON, PASAR REBO, JAKARTA TIMUR, DKI JAKARTA",65,81,157,238
https://kawalpemilu.org#26099,"PEKAYON, PASAR REBO, JAKARTA TIMUR, DKI JAKARTA",66,105,90,195
https://kawalpemilu.org#26099,"PEKAYON, PASAR REBO, JAKARTA TIMUR, DKI JAKARTA",67,107,126,233
https://kawalpemilu.org#26099,"PEKAYON, PASAR REBO, JAKARTA TIMUR, DKI JAKARTA",68,172,28,200
https://kawalpemilu.org#26099,"PEKAYON, PASAR REBO, JAKARTA TIMUR, DKI JAKARTA",69,193,13,206
https://kawalpemilu.org#26099,"PEKAYON, PASAR REBO, JAKARTA TIMUR, DKI JAKARTA",70,137,33,170
https://kawalpemilu.org#26099,"PEKAYON, PASAR REBO, JAKARTA TIMUR, DKI JAKARTA",71,126,98,224
https://kawalpemilu.org#26099,"PEKAYON, PASAR REBO, JAKARTA TIMUR, DKI JAKARTA",72,77,152,229
https://kawalpemilu.org#26099,"PEKAYON, PASAR REBO, JAKARTA TIMUR, DKI JAKARTA",73,71,145,216
https://kawalpemilu.org#26099,"PEKAYON, PASAR REBO, JAKARTA TIMUR, DKI JAKARTA",74,79,153,232
https://kawalpemilu.org#26099,"PEKAYON, PASAR REBO, JAKARTA TIMUR, DKI JAKARTA",75,109,139,248
https://kawalpemilu.org#26099,"PEKAYON, PASAR REBO, JAKARTA TIMUR, DKI JAKARTA",76,74,125,199
https://kawalpemilu.org#26099,"PEKAYON, PASAR REBO, JAKARTA TIMUR, DKI JAKARTA",77,58,161,219
https://kawalpemilu.org#26099,"PEKAYON, PASAR REBO, JAKARTA TIMUR, DKI JAKARTA",78,99,90,189
https://kawalpemilu.org#26099,"PEKAYON, PASAR REBO, JAKARTA TIMUR, DKI JAKARTA",79,112,89,201
https://kawalpemilu.org#26099,"PEKAYON, PASAR REBO, JAKARTA TIMUR, DKI JAKARTA",80,65,170,235
https://kawalpemilu.org#26099,"PEKAYON, PASAR REBO, JAKARTA TIMUR, DKI JAKARTA",81,69,162,231
https://kawalpemilu.org#26099,"PEKAYON, PASAR REBO, JAKARTA TIMUR, DKI JAKARTA",82,104,137,241
https://kawalpemilu.org#26099,"PEKAYON, PASAR REBO, JAKARTA TIMUR, DKI JAKARTA",84,94,77,171
https://kawalpemilu.org#26099,"PEKAYON, PASAR REBO, JAKARTA TIMUR, DKI JAKARTA",85,140,124,264
https://kawalpemilu.org#26099,"PEKAYON, PASAR REBO, JAKARTA TIMUR, DKI JAKARTA",86,108,132,240
https://kawalpemilu.org#26099,"PEKAYON, PASAR REBO, JAKARTA TIMUR, DKI JAKARTA",87,147,120,267
https://kawalpemilu.org#26099,"PEKAYON, PASAR REBO, JAKARTA TIMUR, DKI JAKARTA",88,197,72,269
https://kawalpemilu.org#26099,"PEKAYON, PASAR REBO, JAKARTA TIMUR, DKI JAKARTA",89,138,101,239
https://kawalpemilu.org#26099,"PEKAYON, PASAR REBO, JAKARTA TIMUR, DKI JAKARTA",90,138,96,234
https://kawalpemilu.org#26099,"PEKAYON, PASAR REBO, JAKARTA TIMUR, DKI JAKARTA",91,86,134,220
https://kawalpemilu.org#26099,"PEKAYON, PASAR REBO, JAKARTA TIMUR, DKI JAKARTA",92,125,86,211
https://kawalpemilu.org#26099,"PEKAYON, PASAR REBO, JAKARTA TIMUR, DKI JAKARTA",93,93,141,234
https://kawalpemilu.org#26099,"PEKAYON, PASAR REBO, JAKARTA TIMUR, DKI JAKARTA",94,96,129,225
https://kawalpemilu.org#26099,"PEKAYON, PASAR REBO, JAKARTA TIMUR, DKI JAKARTA",95,126,97,223
https://kawalpemilu.org#26099,"PEKAYON, PASAR REBO, JAKARTA TIMUR, DKI JAKARTA",96,80,150,230
https://kawalpemilu.org#26099,"PEKAYON, PASAR REBO, JAKARTA TIMUR, DKI JAKARTA",97,103,127,230
https://kawalpemilu.org#26099,"PEKAYON, PASAR REBO, JAKARTA TIMUR, DKI JAKARTA",98,83,154,237
https://kawalpemilu.org#26099,"PEKAYON, PASAR REBO, JAKARTA TIMUR, DKI JAKARTA",99,91,146,237
https://kawalpemilu.org#26099,"PEKAYON, PASAR REBO, JAKARTA TIMUR, DKI JAKARTA",100,108,125,233
https://kawalpemilu.org#26099,"PEKAYON, PASAR REBO, JAKARTA TIMUR, DKI JAKARTA",101,124,106,230
https://kawalpemilu.org#26099,"PEKAYON, PASAR REBO, JAKARTA TIMUR, DKI JAKARTA",102,73,130,203
https://kawalpemilu.org#26099,"PEKAYON, PASAR REBO, JAKARTA TIMUR, DKI JAKARTA",103,77,133,210
https://kawalpemilu.org#26099,"PEKAYON, PASAR REBO, JAKARTA TIMUR, DKI JAKARTA",104,62,182,244
https://kawalpemilu.org#26099,"PEKAYON, PASAR REBO, JAKARTA TIMUR, DKI JAKARTA",106,85,142,227
https://kawalpemilu.org#26099,"PEKAYON, PASAR REBO, JAKARTA TIMUR, DKI JAKARTA",107,86,149,235
https://kawalpemilu.org#26099,"PEKAYON, PASAR REBO, JAKARTA TIMUR, DKI JAKARTA",108,102,134,236
https://kawalpemilu.org#26099,"PEKAYON, PASAR REBO, JAKARTA TIMUR, DKI JAKARTA",109,71,174,245
https://kawalpemilu.org#26099,"PEKAYON, PASAR REBO, JAKARTA TIMUR, DKI JAKARTA",110,87,146,233
https://kawalpemilu.org#26099,"PEKAYON, PASAR REBO, JAKARTA TIMUR, DKI JAKARTA",111,136,110,246
https://kawalpemilu.org#26099,"PEKAYON, PASAR REBO, JAKARTA TIMUR, DKI JAKARTA",112,114,152,266
https://kawalpemilu.org#26099,"PEKAYON, PASAR REBO, JAKARTA TIMUR, DKI JAKARTA",113,184,52,236
https://kawalpemilu.org#26099,"PEKAYON, PASAR REBO, JAKARTA TIMUR, DKI JAKARTA",114,118,127,245
https://kawalpemilu.org#26099,"PEKAYON, PASAR REBO, JAKARTA TIMUR, DKI JAKARTA",115,145,94,239
https://kawalpemilu.org#26099,"PEKAYON, PASAR REBO, JAKARTA TIMUR, DKI JAKARTA",116,157,58,215
https://kawalpemilu.org#26099,"PEKAYON, PASAR REBO, JAKARTA TIMUR, DKI JAKARTA",117,92,150,242
https://kawalpemilu.org#26099,"PEKAYON, PASAR REBO, JAKARTA TIMUR, DKI JAKARTA",118,132,111,243
https://kawalpemilu.org#26099,"PEKAYON, PASAR REBO, JAKARTA TIMUR, DKI JAKARTA",119,68,165,233
https://kawalpemilu.org#26099,"PEKAYON, PASAR REBO, JAKARTA TIMUR, DKI JAKARTA",120,102,142,244
https://kawalpemilu.org#26099,"PEKAYON, PASAR REBO, JAKARTA TIMUR, DKI JAKARTA",121,108,134,242
https://kawalpemilu.org#26099,"PEKAYON, PASAR REBO, JAKARTA TIMUR, DKI JAKARTA",122,110,113,223
https://kawalpemilu.org#26099,"PEKAYON, PASAR REBO, JAKARTA TIMUR, DKI JAKARTA",123,104,108,212
https://kawalpemilu.org#26099,"PEKAYON, PASAR REBO, JAKARTA TIMUR, DKI JAKARTA",124,127,113,240
https://kawalpemilu.org#26099,"PEKAYON, PASAR REBO, JAKARTA TIMUR, DKI JAKARTA",125,121,128,249
https://kawalpemilu.org#26099,"PEKAYON, PASAR REBO, JAKARTA TIMUR, DKI JAKARTA",127,77,107,184
https://kawalpemilu.org#26099,"PEKAYON, PASAR REBO, JAKARTA TIMUR, DKI JAKARTA",128,82,119,201
https://kawalpemilu.org#26099,"PEKAYON, PASAR REBO, JAKARTA TIMUR, DKI JAKARTA",130,160,33,193
https://kawalpemilu.org#26099,"PEKAYON, PASAR REBO, JAKARTA TIMUR, DKI JAKARTA",131,96,59,155
https://kawalpemilu.org#26099,"PEKAYON, PASAR REBO, JAKARTA TIMUR, DKI JAKARTA",132,121,97,218
https://kawalpemilu.org#26099,"PEKAYON, PASAR REBO, JAKARTA TIMUR, DKI JAKARTA",133,70,104,174
https://kawalpemilu.org#26099,"PEKAYON, PASAR REBO, JAKARTA TIMUR, DKI JAKARTA",134,77,126,203
https://kawalpemilu.org#26099,"PEKAYON, PASAR REBO, JAKARTA TIMUR, DKI JAKARTA",136,133,81,214
https://kawalpemilu.org#26100,"KALISARI, PASAR REBO, JAKARTA TIMUR, DKI JAKARTA",2,127,112,239
https://kawalpemilu.org#26100,"KALISARI, PASAR REBO, JAKARTA TIMUR, DKI JAKARTA",3,101,146,247
https://kawalpemilu.org#26100,"KALISARI, PASAR REBO, JAKARTA TIMUR, DKI JAKARTA",4,133,149,282
https://kawalpemilu.org#26100,"KALISARI, PASAR REBO, JAKARTA TIMUR, DKI JAKARTA",5,116,146,262
https://kawalpemilu.org#26100,"KALISARI, PASAR REBO, JAKARTA TIMUR, DKI JAKARTA",6,124,144,268
https://kawalpemilu.org#26100,"KALISARI, PASAR REBO, JAKARTA TIMUR, DKI JAKARTA",7,90,175,265
https://kawalpemilu.org#26100,"KALISARI, PASAR REBO, JAKARTA TIMUR, DKI JAKARTA",8,99,157,256
https://kawalpemilu.org#26100,"KALISARI, PASAR REBO, JAKARTA TIMUR, DKI JAKARTA",9,81,183,264
https://kawalpemilu.org#26100,"KALISARI, PASAR REBO, JAKARTA TIMUR, DKI JAKARTA",10,73,157,230
https://kawalpemilu.org#26100,"KALISARI, PASAR REBO, JAKARTA TIMUR, DKI JAKARTA",11,80,179,259
https://kawalpemilu.org#26100,"KALISARI, PASAR REBO, JAKARTA TIMUR, DKI JAKARTA",12,90,134,224
https://kawalpemilu.org#26100,"KALISARI, PASAR REBO, JAKARTA TIMUR, DKI JAKARTA",13,91,167,258
https://kawalpemilu.org#26100,"KALISARI, PASAR REBO, JAKARTA TIMUR, DKI JAKARTA",14,71,166,237
https://kawalpemilu.org#26100,"KALISARI, PASAR REBO, JAKARTA TIMUR, DKI JAKARTA",15,79,129,208
https://kawalpemilu.org#26100,"KALISARI, PASAR REBO, JAKARTA TIMUR, DKI JAKARTA",16,92,126,218
https://kawalpemilu.org#26100,"KALISARI, PASAR REBO, JAKARTA TIMUR, DKI JAKARTA",17,75,118,193
https://kawalpemilu.org#26100,"KALISARI, PASAR REBO, JAKARTA TIMUR, DKI JAKARTA",18,120,99,219
https://kawalpemilu.org#26100,"KALISARI, PASAR REBO, JAKARTA TIMUR, DKI JAKARTA",19,134,104,238
https://kawalpemilu.org#26100,"KALISARI, PASAR REBO, JAKARTA TIMUR, DKI JAKARTA",20,91,141,232
https://kawalpemilu.org#26100,"KALISARI, PASAR REBO, JAKARTA TIMUR, DKI JAKARTA",21,119,127,246
https://kawalpemilu.org#26100,"KALISARI, PASAR REBO, JAKARTA TIMUR, DKI JAKARTA",22,97,146,243
https://kawalpemilu.org#26100,"KALISARI, PASAR REBO, JAKARTA TIMUR, DKI JAKARTA",23,81,118,199
https://kawalpemilu.org#26100,"KALISARI, PASAR REBO, JAKARTA TIMUR, DKI JAKARTA",24,100,169,269
https://kawalpemilu.org#26100,"KALISARI, PASAR REBO, JAKARTA TIMUR, DKI JAKARTA",25,104,174,278
https://kawalpemilu.org#26100,"KALISARI, PASAR REBO, JAKARTA TIMUR, DKI JAKARTA",26,90,166,256
https://kawalpemilu.org#26100,"KALISARI, PASAR REBO, JAKARTA TIMUR, DKI JAKARTA",27,69,176,245
https://kawalpemilu.org#26100,"KALISARI, PASAR REBO, JAKARTA TIMUR, DKI JAKARTA",28,98,181,279
https://kawalpemilu.org#26100,"KALISARI, PASAR REBO, JAKARTA TIMUR, DKI JAKARTA",29,90,160,250
https://kawalpemilu.org#26100,"KALISARI, PASAR REBO, JAKARTA TIMUR, DKI JAKARTA",30,105,150,255
https://kawalpemilu.org#26100,"KALISARI, PASAR REBO, JAKARTA TIMUR, DKI JAKARTA",31,88,158,246
https://kawalpemilu.org#26100,"KALISARI, PASAR REBO, JAKARTA TIMUR, DKI JAKARTA",33,106,161,267
https://kawalpemilu.org#26100,"KALISARI, PASAR REBO, JAKARTA TIMUR, DKI JAKARTA",34,144,136,280
https://kawalpemilu.org#26100,"KALISARI, PASAR REBO, JAKARTA TIMUR, DKI JAKARTA",35,165,108,273
https://kawalpemilu.org#26100,"KALISARI, PASAR REBO, JAKARTA TIMUR, DKI JAKARTA",36,126,121,247
https://kawalpemilu.org#26100,"KALISARI, PASAR REBO, JAKARTA TIMUR, DKI JAKARTA",37,112,172,284
https://kawalpemilu.org#26100,"KALISARI, PASAR REBO, JAKARTA TIMUR, DKI JAKARTA",38,127,132,259
https://kawalpemilu.org#26100,"KALISARI, PASAR REBO, JAKARTA TIMUR, DKI JAKARTA",39,114,133,247
https://kawalpemilu.org#26100,"KALISARI, PASAR REBO, JAKARTA TIMUR, DKI JAKARTA",40,135,164,299
https://kawalpemilu.org#26100,"KALISARI, PASAR REBO, JAKARTA TIMUR, DKI JAKARTA",41,112,136,248
https://kawalpemilu.org#26100,"KALISARI, PASAR REBO, JAKARTA TIMUR, DKI JAKARTA",42,132,122,254
https://kawalpemilu.org#26100,"KALISARI, PASAR REBO, JAKARTA TIMUR, DKI JAKARTA",43,104,157,261
https://kawalpemilu.org#26100,"KALISARI, PASAR REBO, JAKARTA TIMUR, DKI JAKARTA",44,139,123,262
https://kawalpemilu.org#26100,"KALISARI, PASAR REBO, JAKARTA TIMUR, DKI JAKARTA",45,80,127,207
https://kawalpemilu.org#26100,"KALISARI, PASAR REBO, JAKARTA TIMUR, DKI JAKARTA",46,79,172,251
https://kawalpemilu.org#26100,"KALISARI, PASAR REBO, JAKARTA TIMUR, DKI JAKARTA",47,89,144,233
https://kawalpemilu.org#26100,"KALISARI, PASAR REBO, JAKARTA TIMUR, DKI JAKARTA",48,73,176,249
https://kawalpemilu.org#26100,"KALISARI, PASAR REBO, JAKARTA TIMUR, DKI JAKARTA",49,105,146,251
https://kawalpemilu.org#26100,"KALISARI, PASAR REBO, JAKARTA TIMUR, DKI JAKARTA",51,132,133,265
https://kawalpemilu.org#26100,"KALISARI, PASAR REBO, JAKARTA TIMUR, DKI JAKARTA",52,106,141,247
https://kawalpemilu.org#26100,"KALISARI, PASAR REBO, JAKARTA TIMUR, DKI JAKARTA",53,81,161,242
https://kawalpemilu.org#26100,"KALISARI, PASAR REBO, JAKARTA TIMUR, DKI JAKARTA",55,142,120,262
https://kawalpemilu.org#26100,"KALISARI, PASAR REBO, JAKARTA TIMUR, DKI JAKARTA",56,136,128,264
https://kawalpemilu.org#26100,"KALISARI, PASAR REBO, JAKARTA TIMUR, DKI JAKARTA",57,109,139,248
https://kawalpemilu.org#26100,"KALISARI, PASAR REBO, JAKARTA TIMUR, DKI JAKARTA",58,92,161,253
https://kawalpemilu.org#26100,"KALISARI, PASAR REBO, JAKARTA TIMUR, DKI JAKARTA",60,157,121,278
https://kawalpemilu.org#26100,"KALISARI, PASAR REBO, JAKARTA TIMUR, DKI JAKARTA",63,141,123,264
https://kawalpemilu.org#26100,"KALISARI, PASAR REBO, JAKARTA TIMUR, DKI JAKARTA",65,111,145,256
https://kawalpemilu.org#26100,"KALISARI, PASAR REBO, JAKARTA TIMUR, DKI JAKARTA",66,91,144,235
https://kawalpemilu.org#26100,"KALISARI, PASAR REBO, JAKARTA TIMUR, DKI JAKARTA",67,80,161,241
https://kawalpemilu.org#26100,"KALISARI, PASAR REBO, JAKARTA TIMUR, DKI JAKARTA",68,137,138,275
https://kawalpemilu.org#26100,"KALISARI, PASAR REBO, JAKARTA TIMUR, DKI JAKARTA",69,86,174,260
https://kawalpemilu.org#26100,"KALISARI, PASAR REBO, JAKARTA TIMUR, DKI JAKARTA",71,108,141,249
https://kawalpemilu.org#26100,"KALISARI, PASAR REBO, JAKARTA TIMUR, DKI JAKARTA",72,109,114,223
https://kawalpemilu.org#26100,"KALISARI, PASAR REBO, JAKARTA TIMUR, DKI JAKARTA",73,45,231,276
https://kawalpemilu.org#26100,"KALISARI, PASAR REBO, JAKARTA TIMUR, DKI JAKARTA",74,123,126,249
https://kawalpemilu.org#26100,"KALISARI, PASAR REBO, JAKARTA TIMUR, DKI JAKARTA",75,120,148,268
https://kawalpemilu.org#26100,"KALISARI, PASAR REBO, JAKARTA TIMUR, DKI JAKARTA",76,127,168,295
https://kawalpemilu.org#26100,"KALISARI, PASAR REBO, JAKARTA TIMUR, DKI JAKARTA",77,123,126,249
https://kawalpemilu.org#26100,"KALISARI, PASAR REBO, JAKARTA TIMUR, DKI JAKARTA",78,83,142,225
https://kawalpemilu.org#26100,"KALISARI, PASAR REBO, JAKARTA TIMUR, DKI JAKARTA",79,99,161,260
https://kawalpemilu.org#26100,"KALISARI, PASAR REBO, JAKARTA TIMUR, DKI JAKARTA",80,139,111,250
https://kawalpemilu.org#26100,"KALISARI, PASAR REBO, JAKARTA TIMUR, DKI JAKARTA",81,90,137,227
https://kawalpemilu.org#26100,"KALISARI, PASAR REBO, JAKARTA TIMUR, DKI JAKARTA",82,102,123,225
https://kawalpemilu.org#26100,"KALISARI, PASAR REBO, JAKARTA TIMUR, DKI JAKARTA",83,106,131,237
https://kawalpemilu.org#26100,"KALISARI, PASAR REBO, JAKARTA TIMUR, DKI JAKARTA",84,62,187,249
https://kawalpemilu.org#26100,"KALISARI, PASAR REBO, JAKARTA TIMUR, DKI JAKARTA",85,101,163,264
https://kawalpemilu.org#26100,"KALISARI, PASAR REBO, JAKARTA TIMUR, DKI JAKARTA",86,113,132,245
https://kawalpemilu.org#26100,"KALISARI, PASAR REBO, JAKARTA TIMUR, DKI JAKARTA",87,110,143,253
https://kawalpemilu.org#26100,"KALISARI, PASAR REBO, JAKARTA TIMUR, DKI JAKARTA",88,110,111,221
https://kawalpemilu.org#26100,"KALISARI, PASAR REBO, JAKARTA TIMUR, DKI JAKARTA",89,109,129,238
https://kawalpemilu.org#26100,"KALISARI, PASAR REBO, JAKARTA TIMUR, DKI JAKARTA",92,82,159,241
https://kawalpemilu.org#26100,"KALISARI, PASAR REBO, JAKARTA TIMUR, DKI JAKARTA",93,100,150,250
https://kawalpemilu.org#26100,"KALISARI, PASAR REBO, JAKARTA TIMUR, DKI JAKARTA",94,95,157,252
https://kawalpemilu.org#26100,"KALISARI, PASAR REBO, JAKARTA TIMUR, DKI JAKARTA",95,104,158,262
https://kawalpemilu.org#26100,"KALISARI, PASAR REBO, JAKARTA TIMUR, DKI JAKARTA",96,135,104,239
https://kawalpemilu.org#26100,"KALISARI, PASAR REBO, JAKARTA TIMUR, DKI JAKARTA",97,123,84,207
https://kawalpemilu.org#26100,"KALISARI, PASAR REBO, JAKARTA TIMUR, DKI JAKARTA",98,107,125,232
https://kawalpemilu.org#26100,"KALISARI, PASAR REBO, JAKARTA TIMUR, DKI JAKARTA",99,60,173,233
https://kawalpemilu.org#26100,"KALISARI, PASAR REBO, JAKARTA TIMUR, DKI JAKARTA",100,189,56,245
https://kawalpemilu.org#26100,"KALISARI, PASAR REBO, JAKARTA TIMUR, DKI JAKARTA",101,143,105,248
https://kawalpemilu.org#26100,"KALISARI, PASAR REBO, JAKARTA TIMUR, DKI JAKARTA",102,114,144,258
https://kawalpemilu.org#26100,"KALISARI, PASAR REBO, JAKARTA TIMUR, DKI JAKARTA",103,80,142,222
https://kawalpemilu.org#26100,"KALISARI, PASAR REBO, JAKARTA TIMUR, DKI JAKARTA",104,126,145,271
https://kawalpemilu.org#26100,"KALISARI, PASAR REBO, JAKARTA TIMUR, DKI JAKARTA",105,104,137,241
https://kawalpemilu.org#26100,"KALISARI, PASAR REBO, JAKARTA TIMUR, DKI JAKARTA",108,121,137,258
https://kawalpemilu.org#26100,"KALISARI, PASAR REBO, JAKARTA TIMUR, DKI JAKARTA",109,109,146,255
https://kawalpemilu.org#26100,"KALISARI, PASAR REBO, JAKARTA TIMUR, DKI JAKARTA",111,84,129,213
https://kawalpemilu.org#26100,"KALISARI, PASAR REBO, JAKARTA TIMUR, DKI JAKARTA",118,126,127,253
https://kawalpemilu.org#26100,"KALISARI, PASAR REBO, JAKARTA TIMUR, DKI JAKARTA",119,102,138,240
https://kawalpemilu.org#26100,"KALISARI, PASAR REBO, JAKARTA TIMUR, DKI JAKARTA",120,124,148,272
https://kawalpemilu.org#26100,"KALISARI, PASAR REBO, JAKARTA TIMUR, DKI JAKARTA",121,98,108,206
https://kawalpemilu.org#26101,"BARU, PASAR REBO, JAKARTA TIMUR, DKI JAKARTA",1,84,180,264
https://kawalpemilu.org#26101,"BARU, PASAR REBO, JAKARTA TIMUR, DKI JAKARTA",2,104,149,253
https://kawalpemilu.org#26101,"BARU, PASAR REBO, JAKARTA TIMUR, DKI JAKARTA",3,100,124,224
https://kawalpemilu.org#26101,"BARU, PASAR REBO, JAKARTA TIMUR, DKI JAKARTA",4,102,131,233
https://kawalpemilu.org#26101,"BARU, PASAR REBO, JAKARTA TIMUR, DKI JAKARTA",5,87,150,237
https://kawalpemilu.org#26101,"BARU, PASAR REBO, JAKARTA TIMUR, DKI JAKARTA",6,104,141,245
https://kawalpemilu.org#26101,"BARU, PASAR REBO, JAKARTA TIMUR, DKI JAKARTA",7,94,162,256
https://kawalpemilu.org#26101,"BARU, PASAR REBO, JAKARTA TIMUR, DKI JAKARTA",8,97,141,238
https://kawalpemilu.org#26101,"BARU, PASAR REBO, JAKARTA TIMUR, DKI JAKARTA",9,111,127,238
https://kawalpemilu.org#26101,"BARU, PASAR REBO, JAKARTA TIMUR, DKI JAKARTA",10,104,135,239
https://kawalpemilu.org#26101,"BARU, PASAR REBO, JAKARTA TIMUR, DKI JAKARTA",11,109,129,238
https://kawalpemilu.org#26101,"BARU, PASAR REBO, JAKARTA TIMUR, DKI JAKARTA",12,79,159,238
https://kawalpemilu.org#26101,"BARU, PASAR REBO, JAKARTA TIMUR, DKI JAKARTA",13,68,174,242
https://kawalpemilu.org#26101,"BARU, PASAR REBO, JAKARTA TIMUR, DKI JAKARTA",14,85,150,235
https://kawalpemilu.org#26101,"BARU, PASAR REBO, JAKARTA TIMUR, DKI JAKARTA",15,79,129,208
https://kawalpemilu.org#26101,"BARU, PASAR REBO, JAKARTA TIMUR, DKI JAKARTA",16,98,114,212
https://kawalpemilu.org#26101,"BARU, PASAR REBO, JAKARTA TIMUR, DKI JAKARTA",17,91,140,231
https://kawalpemilu.org#26101,"BARU, PASAR REBO, JAKARTA TIMUR, DKI JAKARTA",18,108,142,250
https://kawalpemilu.org#26101,"BARU, PASAR REBO, JAKARTA TIMUR, DKI JAKARTA",19,74,158,232
https://kawalpemilu.org#26101,"BARU, PASAR REBO, JAKARTA TIMUR, DKI JAKARTA",20,118,153,271
https://kawalpemilu.org#26101,"BARU, PASAR REBO, JAKARTA TIMUR, DKI JAKARTA",21,92,158,250
https://kawalpemilu.org#26101,"BARU, PASAR REBO, JAKARTA TIMUR, DKI JAKARTA",22,57,202,259
https://kawalpemilu.org#26101,"BARU, PASAR REBO, JAKARTA TIMUR, DKI JAKARTA",23,100,156,256
https://kawalpemilu.org#26101,"BARU, PASAR REBO, JAKARTA TIMUR, DKI JAKARTA",24,86,163,249
https://kawalpemilu.org#26101,"BARU, PASAR REBO, JAKARTA TIMUR, DKI JAKARTA",25,85,151,236
https://kawalpemilu.org#26101,"BARU, PASAR REBO, JAKARTA TIMUR, DKI JAKARTA",26,110,146,256
https://kawalpemilu.org#26101,"BARU, PASAR REBO, JAKARTA TIMUR, DKI JAKARTA",27,104,129,233
https://kawalpemilu.org#26101,"BARU, PASAR REBO, JAKARTA TIMUR, DKI JAKARTA",28,148,90,238
https://kawalpemilu.org#26101,"BARU, PASAR REBO, JAKARTA TIMUR, DKI JAKARTA",29,76,188,264
https://kawalpemilu.org#26101,"BARU, PASAR REBO, JAKARTA TIMUR, DKI JAKARTA",30,94,139,233
https://kawalpemilu.org#26101,"BARU, PASAR REBO, JAKARTA TIMUR, DKI JAKARTA",31,125,140,265
https://kawalpemilu.org#26101,"BARU, PASAR REBO, JAKARTA TIMUR, DKI JAKARTA",32,71,154,225
https://kawalpemilu.org#26101,"BARU, PASAR REBO, JAKARTA TIMUR, DKI JAKARTA",33,76,128,204
https://kawalpemilu.org#26101,"BARU, PASAR REBO, JAKARTA TIMUR, DKI JAKARTA",34,100,146,246
https://kawalpemilu.org#26101,"BARU, PASAR REBO, JAKARTA TIMUR, DKI JAKARTA",35,96,112,208
https://kawalpemilu.org#26101,"BARU, PASAR REBO, JAKARTA TIMUR, DKI JAKARTA",36,93,110,203
https://kawalpemilu.org#26101,"BARU, PASAR REBO, JAKARTA TIMUR, DKI JAKARTA",37,81,178,259
https://kawalpemilu.org#26101,"BARU, PASAR REBO, JAKARTA TIMUR, DKI JAKARTA",38,96,145,241
https://kawalpemilu.org#26101,"BARU, PASAR REBO, JAKARTA TIMUR, DKI JAKARTA",39,90,163,253
https://kawalpemilu.org#26101,"BARU, PASAR REBO, JAKARTA TIMUR, DKI JAKARTA",40,87,147,234
https://kawalpemilu.org#26101,"BARU, PASAR REBO, JAKARTA TIMUR, DKI JAKARTA",41,116,150,266
https://kawalpemilu.org#26101,"BARU, PASAR REBO, JAKARTA TIMUR, DKI JAKARTA",42,106,153,259
https://kawalpemilu.org#26101,"BARU, PASAR REBO, JAKARTA TIMUR, DKI JAKARTA",43,94,126,220
https://kawalpemilu.org#26101,"BARU, PASAR REBO, JAKARTA TIMUR, DKI JAKARTA",44,103,139,242
https://kawalpemilu.org#26101,"BARU, PASAR REBO, JAKARTA TIMUR, DKI JAKARTA",45,66,140,206
https://kawalpemilu.org#26101,"BARU, PASAR REBO, JAKARTA TIMUR, DKI JAKARTA",46,79,128,207
https://kawalpemilu.org#26101,"BARU, PASAR REBO, JAKARTA TIMUR, DKI JAKARTA",47,73,151,224
https://kawalpemilu.org#26101,"BARU, PASAR REBO, JAKARTA TIMUR, DKI JAKARTA",48,91,148,239
https://kawalpemilu.org#26101,"BARU, PASAR REBO, JAKARTA TIMUR, DKI JAKARTA",49,116,121,237
https://kawalpemilu.org#26101,"BARU, PASAR REBO, JAKARTA TIMUR, DKI JAKARTA",50,44,205,249
https://kawalpemilu.org#26101,"BARU, PASAR REBO, JAKARTA TIMUR, DKI JAKARTA",51,44,216,260
https://kawalpemilu.org#26101,"BARU, PASAR REBO, JAKARTA TIMUR, DKI JAKARTA",52,40,222,262
https://kawalpemilu.org#26101,"BARU, PASAR REBO, JAKARTA TIMUR, DKI JAKARTA",53,30,203,233
https://kawalpemilu.org#26101,"BARU, PASAR REBO, JAKARTA TIMUR, DKI JAKARTA",54,15,224,239
https://kawalpemilu.org#26101,"BARU, PASAR REBO, JAKARTA TIMUR, DKI JAKARTA",55,17,281,298
https://kawalpemilu.org#26101,"BARU, PASAR REBO, JAKARTA TIMUR, DKI JAKARTA",56,29,253,282
https://kawalpemilu.org#26101,"BARU, PASAR REBO, JAKARTA TIMUR, DKI JAKARTA",58,31,241,272
https://kawalpemilu.org#26101,"BARU, PASAR REBO, JAKARTA TIMUR, DKI JAKARTA",59,34,225,259
https://kawalpemilu.org#26101,"BARU, PASAR REBO, JAKARTA TIMUR, DKI JAKARTA",60,23,236,259
https://kawalpemilu.org#26102,"CIJANTUNG, PASAR REBO, JAKARTA TIMUR, DKI JAKARTA",1,149,109,258
https://kawalpemilu.org#26102,"CIJANTUNG, PASAR REBO, JAKARTA TIMUR, DKI JAKARTA",2,146,96,242
https://kawalpemilu.org#26102,"CIJANTUNG, PASAR REBO, JAKARTA TIMUR, DKI JAKARTA",3,162,97,259
https://kawalpemilu.org#26102,"CIJANTUNG, PASAR REBO, JAKARTA TIMUR, DKI JAKARTA",4,109,86,195
https://kawalpemilu.org#26102,"CIJANTUNG, PASAR REBO, JAKARTA TIMUR, DKI JAKARTA",5,126,134,260
https://kawalpemilu.org#26102,"CIJANTUNG, PASAR REBO, JAKARTA TIMUR, DKI JAKARTA",6,123,157,280
https://kawalpemilu.org#26102,"CIJANTUNG, PASAR REBO, JAKARTA TIMUR, DKI JAKARTA",7,121,129,250
https://kawalpemilu.org#26102,"CIJANTUNG, PASAR REBO, JAKARTA TIMUR, DKI JAKARTA",8,108,149,257
https://kawalpemilu.org#26102,"CIJANTUNG, PASAR REBO, JAKARTA TIMUR, DKI JAKARTA",9,99,104,203
https://kawalpemilu.org#26102,"CIJANTUNG, PASAR REBO, JAKARTA TIMUR, DKI JAKARTA",10,117,112,229
https://kawalpemilu.org#26102,"CIJANTUNG, PASAR REBO, JAKARTA TIMUR, DKI JAKARTA",11,147,62,209
https://kawalpemilu.org#26102,"CIJANTUNG, PASAR REBO, JAKARTA TIMUR, DKI JAKARTA",12,110,119,229
https://kawalpemilu.org#26102,"CIJANTUNG, PASAR REBO, JAKARTA TIMUR, DKI JAKARTA",13,88,161,249
https://kawalpemilu.org#26102,"CIJANTUNG, PASAR REBO, JAKARTA TIMUR, DKI JAKARTA",14,84,130,214
https://kawalpemilu.org#26102,"CIJANTUNG, PASAR REBO, JAKARTA TIMUR, DKI JAKARTA",15,119,121,240
https://kawalpemilu.org#26102,"CIJANTUNG, PASAR REBO, JAKARTA TIMUR, DKI JAKARTA",16,127,91,218
https://kawalpemilu.org#26102,"CIJANTUNG, PASAR REBO, JAKARTA TIMUR, DKI JAKARTA",17,123,115,238
https://kawalpemilu.org#26102,"CIJANTUNG, PASAR REBO, JAKARTA TIMUR, DKI JAKARTA",18,128,106,234
https://kawalpemilu.org#26102,"CIJANTUNG, PASAR REBO, JAKARTA TIMUR, DKI JAKARTA",19,60,133,193
https://kawalpemilu.org#26102,"CIJANTUNG, PASAR REBO, JAKARTA TIMUR, DKI JAKARTA",20,107,144,251
https://kawalpemilu.org#26102,"CIJANTUNG, PASAR REBO, JAKARTA TIMUR, DKI JAKARTA",21,95,148,243
https://kawalpemilu.org#26102,"CIJANTUNG, PASAR REBO, JAKARTA TIMUR, DKI JAKARTA",22,93,171,264
https://kawalpemilu.org#26102,"CIJANTUNG, PASAR REBO, JAKARTA TIMUR, DKI JAKARTA",23,79,147,226
https://kawalpemilu.org#26102,"CIJANTUNG, PASAR REBO, JAKARTA TIMUR, DKI JAKARTA",24,88,129,217
https://kawalpemilu.org#26102,"CIJANTUNG, PASAR REBO, JAKARTA TIMUR, DKI JAKARTA",25,105,103,208
https://kawalpemilu.org#26102,"CIJANTUNG, PASAR REBO, JAKARTA TIMUR, DKI JAKARTA",27,82,120,202
https://kawalpemilu.org#26102,"CIJANTUNG, PASAR REBO, JAKARTA TIMUR, DKI JAKARTA",28,108,121,229
https://kawalpemilu.org#26102,"CIJANTUNG, PASAR REBO, JAKARTA TIMUR, DKI JAKARTA",29,130,108,238
https://kawalpemilu.org#26102,"CIJANTUNG, PASAR REBO, JAKARTA TIMUR, DKI JAKARTA",30,150,105,255
https://kawalpemilu.org#26102,"CIJANTUNG, PASAR REBO, JAKARTA TIMUR, DKI JAKARTA",31,95,136,231
https://kawalpemilu.org#26102,"CIJANTUNG, PASAR REBO, JAKARTA TIMUR, DKI JAKARTA",32,96,133,229
https://kawalpemilu.org#26102,"CIJANTUNG, PASAR REBO, JAKARTA TIMUR, DKI JAKARTA",33,116,117,233
https://kawalpemilu.org#26102,"CIJANTUNG, PASAR REBO, JAKARTA TIMUR, DKI JAKARTA",34,89,175,264
https://kawalpemilu.org#26102,"CIJANTUNG, PASAR REBO, JAKARTA TIMUR, DKI JAKARTA",35,79,151,230
https://kawalpemilu.org#26102,"CIJANTUNG, PASAR REBO, JAKARTA TIMUR, DKI JAKARTA",36,147,92,239
https://kawalpemilu.org#26102,"CIJANTUNG, PASAR REBO, JAKARTA TIMUR, DKI JAKARTA",38,113,122,235
https://kawalpemilu.org#26102,"CIJANTUNG, PASAR REBO, JAKARTA TIMUR, DKI JAKARTA",39,120,130,250
https://kawalpemilu.org#26102,"CIJANTUNG, PASAR REBO, JAKARTA TIMUR, DKI JAKARTA",40,104,161,265
https://kawalpemilu.org#26102,"CIJANTUNG, PASAR REBO, JAKARTA TIMUR, DKI JAKARTA",41,140,124,264
https://kawalpemilu.org#26102,"CIJANTUNG, PASAR REBO, JAKARTA TIMUR, DKI JAKARTA",42,89,158,247
https://kawalpemilu.org#26102,"CIJANTUNG, PASAR REBO, JAKARTA TIMUR, DKI JAKARTA",43,127,121,248
https://kawalpemilu.org#26102,"CIJANTUNG, PASAR REBO, JAKARTA TIMUR, DKI JAKARTA",44,88,151,239
https://kawalpemilu.org#26102,"CIJANTUNG, PASAR REBO, JAKARTA TIMUR, DKI JAKARTA",45,114,141,255
https://kawalpemilu.org#26102,"CIJANTUNG, PASAR REBO, JAKARTA TIMUR, DKI JAKARTA",46,70,155,225
https://kawalpemilu.org#26102,"CIJANTUNG, PASAR REBO, JAKARTA TIMUR, DKI JAKARTA",47,79,167,246
https://kawalpemilu.org#26102,"CIJANTUNG, PASAR REBO, JAKARTA TIMUR, DKI JAKARTA",48,113,148,261
https://kawalpemilu.org#26102,"CIJANTUNG, PASAR REBO, JAKARTA TIMUR, DKI JAKARTA",49,104,149,253
https://kawalpemilu.org#26102,"CIJANTUNG, PASAR REBO, JAKARTA TIMUR, DKI JAKARTA",50,77,97,174
https://kawalpemilu.org#26102,"CIJANTUNG, PASAR REBO, JAKARTA TIMUR, DKI JAKARTA",51,63,142,205
https://kawalpemilu.org#26102,"CIJANTUNG, PASAR REBO, JAKARTA TIMUR, DKI JAKARTA",52,164,76,240
https://kawalpemilu.org#26102,"CIJANTUNG, PASAR REBO, JAKARTA TIMUR, DKI JAKARTA",53,59,191,250
https://kawalpemilu.org#26102,"CIJANTUNG, PASAR REBO, JAKARTA TIMUR, DKI JAKARTA",54,86,159,245
https://kawalpemilu.org#26102,"CIJANTUNG, PASAR REBO, JAKARTA TIMUR, DKI JAKARTA",55,85,173,258
https://kawalpemilu.org#26102,"CIJANTUNG, PASAR REBO, JAKARTA TIMUR, DKI JAKARTA",56,38,164,202
https://kawalpemilu.org#26102,"CIJANTUNG, PASAR REBO, JAKARTA TIMUR, DKI JAKARTA",57,14,168,182
https://kawalpemilu.org#26102,"CIJANTUNG, PASAR REBO, JAKARTA TIMUR, DKI JAKARTA",59,16,163,179
https://kawalpemilu.org#26102,"CIJANTUNG, PASAR REBO, JAKARTA TIMUR, DKI JAKARTA",60,35,169,204
https://kawalpemilu.org#26102,"CIJANTUNG, PASAR REBO, JAKARTA TIMUR, DKI JAKARTA",62,155,84,239
https://kawalpemilu.org#26102,"CIJANTUNG, PASAR REBO, JAKARTA TIMUR, DKI JAKARTA",63,129,91,220
https://kawalpemilu.org#26102,"CIJANTUNG, PASAR REBO, JAKARTA TIMUR, DKI JAKARTA",64,148,79,227
https://kawalpemilu.org#26102,"CIJANTUNG, PASAR REBO, JAKARTA TIMUR, DKI JAKARTA",65,162,66,228
https://kawalpemilu.org#26102,"CIJANTUNG, PASAR REBO, JAKARTA TIMUR, DKI JAKARTA",67,165,79,244
https://kawalpemilu.org#26102,"CIJANTUNG, PASAR REBO, JAKARTA TIMUR, DKI JAKARTA",68,156,74,230
https://kawalpemilu.org#26102,"CIJANTUNG, PASAR REBO, JAKARTA TIMUR, DKI JAKARTA",69,140,92,232
https://kawalpemilu.org#26102,"CIJANTUNG, PASAR REBO, JAKARTA TIMUR, DKI JAKARTA",70,164,76,240
https://kawalpemilu.org#26102,"CIJANTUNG, PASAR REBO, JAKARTA TIMUR, DKI JAKARTA",71,98,63,161
https://kawalpemilu.org#26102,"CIJANTUNG, PASAR REBO, JAKARTA TIMUR, DKI JAKARTA",72,163,108,271
https://kawalpemilu.org#26102,"CIJANTUNG, PASAR REBO, JAKARTA TIMUR, DKI JAKARTA",74,160,67,227
https://kawalpemilu.org#26102,"CIJANTUNG, PASAR REBO, JAKARTA TIMUR, DKI JAKARTA",75,100,145,245
https://kawalpemilu.org#26102,"CIJANTUNG, PASAR REBO, JAKARTA TIMUR, DKI JAKARTA",76,98,124,222
https://kawalpemilu.org#26102,"CIJANTUNG, PASAR REBO, JAKARTA TIMUR, DKI JAKARTA",77,125,110,235
https://kawalpemilu.org#26102,"CIJANTUNG, PASAR REBO, JAKARTA TIMUR, DKI JAKARTA",78,94,159,253
https://kawalpemilu.org#26102,"CIJANTUNG, PASAR REBO, JAKARTA TIMUR, DKI JAKARTA",79,116,127,243
https://kawalpemilu.org#26102,"CIJANTUNG, PASAR REBO, JAKARTA TIMUR, DKI JAKARTA",80,113,139,252
https://kawalpemilu.org#26102,"CIJANTUNG, PASAR REBO, JAKARTA TIMUR, DKI JAKARTA",81,130,108,238
https://kawalpemilu.org#26102,"CIJANTUNG, PASAR REBO, JAKARTA TIMUR, DKI JAKARTA",82,144,118,262
https://kawalpemilu.org#26102,"CIJANTUNG, PASAR REBO, JAKARTA TIMUR, DKI JAKARTA",83,119,131,250
https://kawalpemilu.org#26102,"CIJANTUNG, PASAR REBO, JAKARTA TIMUR, DKI JAKARTA",84,116,126,242
https://kawalpemilu.org#26102,"CIJANTUNG, PASAR REBO, JAKARTA TIMUR, DKI JAKARTA",85,73,133,206
https://kawalpemilu.org#26102,"CIJANTUNG, PASAR REBO, JAKARTA TIMUR, DKI JAKARTA",86,82,142,224
https://kawalpemilu.org#26102,"CIJANTUNG, PASAR REBO, JAKARTA TIMUR, DKI JAKARTA",87,96,158,254
https://kawalpemilu.org#26102,"CIJANTUNG, PASAR REBO, JAKARTA TIMUR, DKI JAKARTA",88,84,165,249
https://kawalpemilu.org#26102,"CIJANTUNG, PASAR REBO, JAKARTA TIMUR, DKI JAKARTA",89,97,168,265
https://kawalpemilu.org#26102,"CIJANTUNG, PASAR REBO, JAKARTA TIMUR, DKI JAKARTA",90,151,125,276
https://kawalpemilu.org#26102,"CIJANTUNG, PASAR REBO, JAKARTA TIMUR, DKI JAKARTA",91,131,97,228
https://kawalpemilu.org#26102,"CIJANTUNG, PASAR REBO, JAKARTA TIMUR, DKI JAKARTA",92,143,100,243
https://kawalpemilu.org#26102,"CIJANTUNG, PASAR REBO, JAKARTA TIMUR, DKI JAKARTA",93,139,96,235
https://kawalpemilu.org#26102,"CIJANTUNG, PASAR REBO, JAKARTA TIMUR, DKI JAKARTA",94,92,63,155
https://kawalpemilu.org#26102,"CIJANTUNG, PASAR REBO, JAKARTA TIMUR, DKI JAKARTA",95,135,90,225
https://kawalpemilu.org#26102,"CIJANTUNG, PASAR REBO, JAKARTA TIMUR, DKI JAKARTA",96,132,84,216
https://kawalpemilu.org#26102,"CIJANTUNG, PASAR REBO, JAKARTA TIMUR, DKI JAKARTA",97,127,107,234
https://kawalpemilu.org#26102,"CIJANTUNG, PASAR REBO, JAKARTA TIMUR, DKI JAKARTA",98,174,86,260
https://kawalpemilu.org#26102,"CIJANTUNG, PASAR REBO, JAKARTA TIMUR, DKI JAKARTA",99,114,76,190
https://kawalpemilu.org#26102,"CIJANTUNG, PASAR REBO, JAKARTA TIMUR, DKI JAKARTA",100,135,101,236
https://kawalpemilu.org#26102,"CIJANTUNG, PASAR REBO, JAKARTA TIMUR, DKI JAKARTA",101,106,93,199
https://kawalpemilu.org#26102,"CIJANTUNG, PASAR REBO, JAKARTA TIMUR, DKI JAKARTA",102,145,80,225
https://kawalpemilu.org#26102,"CIJANTUNG, PASAR REBO, JAKARTA TIMUR, DKI JAKARTA",103,131,66,197
https://kawalpemilu.org#26102,"CIJANTUNG, PASAR REBO, JAKARTA TIMUR, DKI JAKARTA",104,88,152,240
https://kawalpemilu.org#26102,"CIJANTUNG, PASAR REBO, JAKARTA TIMUR, DKI JAKARTA",105,114,128,242
https://kawalpemilu.org#26102,"CIJANTUNG, PASAR REBO, JAKARTA TIMUR, DKI JAKARTA",106,166,78,244
https://kawalpemilu.org#26102,"CIJANTUNG, PASAR REBO, JAKARTA TIMUR, DKI JAKARTA",107,111,125,236
https://kawalpemilu.org#26102,"CIJANTUNG, PASAR REBO, JAKARTA TIMUR, DKI JAKARTA",108,125,81,206
https://kawalpemilu.org#26102,"CIJANTUNG, PASAR REBO, JAKARTA TIMUR, DKI JAKARTA",109,117,103,220
https://kawalpemilu.org#26102,"CIJANTUNG, PASAR REBO, JAKARTA TIMUR, DKI JAKARTA",111,120,96,216
https://kawalpemilu.org#26102,"CIJANTUNG, PASAR REBO, JAKARTA TIMUR, DKI JAKARTA",112,129,115,244
https://kawalpemilu.org#26102,"CIJANTUNG, PASAR REBO, JAKARTA TIMUR, DKI JAKARTA",113,127,115,242
https://kawalpemilu.org#26102,"CIJANTUNG, PASAR REBO, JAKARTA TIMUR, DKI JAKARTA",114,150,96,246
https://kawalpemilu.org#26102,"CIJANTUNG, PASAR REBO, JAKARTA TIMUR, DKI JAKARTA",115,134,113,247
https://kawalpemilu.org#26102,"CIJANTUNG, PASAR REBO, JAKARTA TIMUR, DKI JAKARTA",116,95,129,224
https://kawalpemilu.org#26102,"CIJANTUNG, PASAR REBO, JAKARTA TIMUR, DKI JAKARTA",117,87,178,265
https://kawalpemilu.org#26102,"CIJANTUNG, PASAR REBO, JAKARTA TIMUR, DKI JAKARTA",118,79,171,250
https://kawalpemilu.org#26102,"CIJANTUNG, PASAR REBO, JAKARTA TIMUR, DKI JAKARTA",119,70,191,261
https://kawalpemilu.org#26102,"CIJANTUNG, PASAR REBO, JAKARTA TIMUR, DKI JAKARTA",120,114,110,224
https://kawalpemilu.org#26102,"CIJANTUNG, PASAR REBO, JAKARTA TIMUR, DKI JAKARTA",121,113,106,219
https://kawalpemilu.org#26102,"CIJANTUNG, PASAR REBO, JAKARTA TIMUR, DKI JAKARTA",122,156,69,225
https://kawalpemilu.org#26102,"CIJANTUNG, PASAR REBO, JAKARTA TIMUR, DKI JAKARTA",123,94,97,191
https://kawalpemilu.org#26102,"CIJANTUNG, PASAR REBO, JAKARTA TIMUR, DKI JAKARTA",124,92,180,272
https://kawalpemilu.org#26102,"CIJANTUNG, PASAR REBO, JAKARTA TIMUR, DKI JAKARTA",125,85,154,239
https://kawalpemilu.org#26103,"GEDONG, PASAR REBO, JAKARTA TIMUR, DKI JAKARTA",1,96,154,250
https://kawalpemilu.org#26103,"GEDONG, PASAR REBO, JAKARTA TIMUR, DKI JAKARTA",2,80,164,244
https://kawalpemilu.org#26103,"GEDONG, PASAR REBO, JAKARTA TIMUR, DKI JAKARTA",3,80,188,268
https://kawalpemilu.org#26103,"GEDONG, PASAR REBO, JAKARTA TIMUR, DKI JAKARTA",4,94,162,256
https://kawalpemilu.org#26103,"GEDONG, PASAR REBO, JAKARTA TIMUR, DKI JAKARTA",5,74,100,174
https://kawalpemilu.org#26103,"GEDONG, PASAR REBO, JAKARTA TIMUR, DKI JAKARTA",6,118,143,261
https://kawalpemilu.org#26103,"GEDONG, PASAR REBO, JAKARTA TIMUR, DKI JAKARTA",8,73,190,263
https://kawalpemilu.org#26103,"GEDONG, PASAR REBO, JAKARTA TIMUR, DKI JAKARTA",9,98,114,212
https://kawalpemilu.org#26103,"GEDONG, PASAR REBO, JAKARTA TIMUR, DKI JAKARTA",10,139,113,252
https://kawalpemilu.org#26103,"GEDONG, PASAR REBO, JAKARTA TIMUR, DKI JAKARTA",11,116,130,246
https://kawalpemilu.org#26103,"GEDONG, PASAR REBO, JAKARTA TIMUR, DKI JAKARTA",13,101,138,239
https://kawalpemilu.org#26103,"GEDONG, PASAR REBO, JAKARTA TIMUR, DKI JAKARTA",14,144,124,268
https://kawalpemilu.org#26103,"GEDONG, PASAR REBO, JAKARTA TIMUR, DKI JAKARTA",15,103,130,233
https://kawalpemilu.org#26103,"GEDONG, PASAR REBO, JAKARTA TIMUR, DKI JAKARTA",16,80,145,225
https://kawalpemilu.org#26103,"GEDONG, PASAR REBO, JAKARTA TIMUR, DKI JAKARTA",17,104,143,247
https://kawalpemilu.org#26103,"GEDONG, PASAR REBO, JAKARTA TIMUR, DKI JAKARTA",18,123,125,248
https://kawalpemilu.org#26103,"GEDONG, PASAR REBO, JAKARTA TIMUR, DKI JAKARTA",19,118,113,231
https://kawalpemilu.org#26103,"GEDONG, PASAR REBO, JAKARTA TIMUR, DKI JAKARTA",20,114,124,238
https://kawalpemilu.org#26103,"GEDONG, PASAR REBO, JAKARTA TIMUR, DKI JAKARTA",21,0,0,0
https://kawalpemilu.org#26103,"GEDONG, PASAR REBO, JAKARTA TIMUR, DKI JAKARTA",22,108,130,238
https://kawalpemilu.org#26103,"GEDONG, PASAR REBO, JAKARTA TIMUR, DKI JAKARTA",23,80,164,244
https://kawalpemilu.org#26103,"GEDONG, PASAR REBO, JAKARTA TIMUR, DKI JAKARTA",24,119,106,225
https://kawalpemilu.org#26103,"GEDONG, PASAR REBO, JAKARTA TIMUR, DKI JAKARTA",25,95,140,235
https://kawalpemilu.org#26103,"GEDONG, PASAR REBO, JAKARTA TIMUR, DKI JAKARTA",27,136,102,238
https://kawalpemilu.org#26103,"GEDONG, PASAR REBO, JAKARTA TIMUR, DKI JAKARTA",28,137,134,271
https://kawalpemilu.org#26103,"GEDONG, PASAR REBO, JAKARTA TIMUR, DKI JAKARTA",29,113,128,241
https://kawalpemilu.org#26103,"GEDONG, PASAR REBO, JAKARTA TIMUR, DKI JAKARTA",30,103,126,229
https://kawalpemilu.org#26103,"GEDONG, PASAR REBO, JAKARTA TIMUR, DKI JAKARTA",31,80,141,221
https://kawalpemilu.org#26103,"GEDONG, PASAR REBO, JAKARTA TIMUR, DKI JAKARTA",32,81,149,230
https://kawalpemilu.org#26103,"GEDONG, PASAR REBO, JAKARTA TIMUR, DKI JAKARTA",33,104,132,236
https://kawalpemilu.org#26103,"GEDONG, PASAR REBO, JAKARTA TIMUR, DKI JAKARTA",34,76,136,212
https://kawalpemilu.org#26103,"GEDONG, PASAR REBO, JAKARTA TIMUR, DKI JAKARTA",35,90,135,225
https://kawalpemilu.org#26103,"GEDONG, PASAR REBO, JAKARTA TIMUR, DKI JAKARTA",37,95,103,198
https://kawalpemilu.org#26103,"GEDONG, PASAR REBO, JAKARTA TIMUR, DKI JAKARTA",38,79,111,190
https://kawalpemilu.org#26103,"GEDONG, PASAR REBO, JAKARTA TIMUR, DKI JAKARTA",39,103,89,192
https://kawalpemilu.org#26103,"GEDONG, PASAR REBO, JAKARTA TIMUR, DKI JAKARTA",40,107,104,211
https://kawalpemilu.org#26103,"GEDONG, PASAR REBO, JAKARTA TIMUR, DKI JAKARTA",41,83,100,183
https://kawalpemilu.org#26103,"GEDONG, PASAR REBO, JAKARTA TIMUR, DKI JAKARTA",42,93,111,204
https://kawalpemilu.org#26103,"GEDONG, PASAR REBO, JAKARTA TIMUR, DKI JAKARTA",43,76,92,168
https://kawalpemilu.org#26103,"GEDONG, PASAR REBO, JAKARTA TIMUR, DKI JAKARTA",44,18,175,193
https://kawalpemilu.org#26103,"GEDONG, PASAR REBO, JAKARTA TIMUR, DKI JAKARTA",45,23,202,225
https://kawalpemilu.org#26103,"GEDONG, PASAR REBO, JAKARTA TIMUR, DKI JAKARTA",46,28,205,233
https://kawalpemilu.org#26103,"GEDONG, PASAR REBO, JAKARTA TIMUR, DKI JAKARTA",47,0,0,0
https://kawalpemilu.org#26103,"GEDONG, PASAR REBO, JAKARTA TIMUR, DKI JAKARTA",48,132,122,254
https://kawalpemilu.org#26103,"GEDONG, PASAR REBO, JAKARTA TIMUR, DKI JAKARTA",49,136,114,250
https://kawalpemilu.org#26103,"GEDONG, PASAR REBO, JAKARTA TIMUR, DKI JAKARTA",50,112,117,229
https://kawalpemilu.org#26103,"GEDONG, PASAR REBO, JAKARTA TIMUR, DKI JAKARTA",51,157,60,217
https://kawalpemilu.org#26103,"GEDONG, PASAR REBO, JAKARTA TIMUR, DKI JAKARTA",52,108,122,230
https://kawalpemilu.org#26103,"GEDONG, PASAR REBO, JAKARTA TIMUR, DKI JAKARTA",53,80,109,189
https://kawalpemilu.org#26103,"GEDONG, PASAR REBO, JAKARTA TIMUR, DKI JAKARTA",54,114,149,263
https://kawalpemilu.org#26103,"GEDONG, PASAR REBO, JAKARTA TIMUR, DKI JAKARTA",55,115,125,240
https://kawalpemilu.org#26103,"GEDONG, PASAR REBO, JAKARTA TIMUR, DKI JAKARTA",56,117,146,263
https://kawalpemilu.org#26103,"GEDONG, PASAR REBO, JAKARTA TIMUR, DKI JAKARTA",57,83,164,247
https://kawalpemilu.org#26103,"GEDONG, PASAR REBO, JAKARTA TIMUR, DKI JAKARTA",58,116,107,223
https://kawalpemilu.org#26103,"GEDONG, PASAR REBO, JAKARTA TIMUR, DKI JAKARTA",59,98,125,223
https://kawalpemilu.org#26103,"GEDONG, PASAR REBO, JAKARTA TIMUR, DKI JAKARTA",60,111,128,239
https://kawalpemilu.org#26103,"GEDONG, PASAR REBO, JAKARTA TIMUR, DKI JAKARTA",61,97,125,222
https://kawalpemilu.org#26103,"GEDONG, PASAR REBO, JAKARTA TIMUR, DKI JAKARTA",62,97,159,256
https://kawalpemilu.org#26103,"GEDONG, PASAR REBO, JAKARTA TIMUR, DKI JAKARTA",63,119,105,224
https://kawalpemilu.org#26103,"GEDONG, PASAR REBO, JAKARTA TIMUR, DKI JAKARTA",64,145,95,240
https://kawalpemilu.org#26103,"GEDONG, PASAR REBO, JAKARTA TIMUR, DKI JAKARTA",65,102,111,213
https://kawalpemilu.org#26103,"GEDONG, PASAR REBO, JAKARTA TIMUR, DKI JAKARTA",66,118,67,185
https://kawalpemilu.org#26103,"GEDONG, PASAR REBO, JAKARTA TIMUR, DKI JAKARTA",68,92,133,225
https://kawalpemilu.org#26103,"GEDONG, PASAR REBO, JAKARTA TIMUR, DKI JAKARTA",69,127,93,220
https://kawalpemilu.org#26103,"GEDONG, PASAR REBO, JAKARTA TIMUR, DKI JAKARTA",70,80,131,211
https://kawalpemilu.org#26103,"GEDONG, PASAR REBO, JAKARTA TIMUR, DKI JAKARTA",72,91,90,181
https://kawalpemilu.org#26103,"GEDONG, PASAR REBO, JAKARTA TIMUR, DKI JAKARTA",74,142,80,222
https://kawalpemilu.org#26103,"GEDONG, PASAR REBO, JAKARTA TIMUR, DKI JAKARTA",75,105,101,206
https://kawalpemilu.org#26103,"GEDONG, PASAR REBO, JAKARTA TIMUR, DKI JAKARTA",76,124,107,231
https://kawalpemilu.org#26103,"GEDONG, PASAR REBO, JAKARTA TIMUR, DKI JAKARTA",77,77,172,249
https://kawalpemilu.org#26103,"GEDONG, PASAR REBO, JAKARTA TIMUR, DKI JAKARTA",78,101,142,243
https://kawalpemilu.org#26103,"GEDONG, PASAR REBO, JAKARTA TIMUR, DKI JAKARTA",79,122,131,253
https://kawalpemilu.org#26103,"GEDONG, PASAR REBO, JAKARTA TIMUR, DKI JAKARTA",80,128,121,249
https://kawalpemilu.org#26103,"GEDONG, PASAR REBO, JAKARTA TIMUR, DKI JAKARTA",82,135,106,241
https://kawalpemilu.org#26103,"GEDONG, PASAR REBO, JAKARTA TIMUR, DKI JAKARTA",83,134,108,242
https://kawalpemilu.org#26103,"GEDONG, PASAR REBO, JAKARTA TIMUR, DKI JAKARTA",84,122,117,239
https://kawalpemilu.org#26103,"GEDONG, PASAR REBO, JAKARTA TIMUR, DKI JAKARTA",85,126,113,239
https://kawalpemilu.org#26103,"GEDONG, PASAR REBO, JAKARTA TIMUR, DKI JAKARTA",86,129,94,223
https://kawalpemilu.org#26103,"GEDONG, PASAR REBO, JAKARTA TIMUR, DKI JAKARTA",88,124,120,244
https://kawalpemilu.org#26103,"GEDONG, PASAR REBO, JAKARTA TIMUR, DKI JAKARTA",89,111,93,204
https://kawalpemilu.org#26103,"GEDONG, PASAR REBO, JAKARTA TIMUR, DKI JAKARTA",91,187,53,240
https://kawalpemilu.org#26103,"GEDONG, PASAR REBO, JAKARTA TIMUR, DKI JAKARTA",92,145,92,237
https://kawalpemilu.org#26103,"GEDONG, PASAR REBO, JAKARTA TIMUR, DKI JAKARTA",93,134,86,220
https://kawalpemilu.org#26103,"GEDONG, PASAR REBO, JAKARTA TIMUR, DKI JAKARTA",94,137,86,223
https://kawalpemilu.org#26103,"GEDONG, PASAR REBO, JAKARTA TIMUR, DKI JAKARTA",95,100,120,220
https://kawalpemilu.org#26103,"GEDONG, PASAR REBO, JAKARTA TIMUR, DKI JAKARTA",97,85,146,231
https://kawalpemilu.org#26103,"GEDONG, PASAR REBO, JAKARTA TIMUR, DKI JAKARTA",99,123,100,223
https://kawalpemilu.org#26103,"GEDONG, PASAR REBO, JAKARTA TIMUR, DKI JAKARTA",100,124,123,247
https://kawalpemilu.org#26103,"GEDONG, PASAR REBO, JAKARTA TIMUR, DKI JAKARTA",101,152,119,271
https://kawalpemilu.org#26103,"GEDONG, PASAR REBO, JAKARTA TIMUR, DKI JAKARTA",102,105,140,245
https://kawalpemilu.org#26103,"GEDONG, PASAR REBO, JAKARTA TIMUR, DKI JAKARTA",104,115,125,240
https://kawalpemilu.org#26103,"GEDONG, PASAR REBO, JAKARTA TIMUR, DKI JAKARTA",105,94,141,235
https://kawalpemilu.org#26103,"GEDONG, PASAR REBO, JAKARTA TIMUR, DKI JAKARTA",106,97,128,225
https://kawalpemilu.org#26103,"GEDONG, PASAR REBO, JAKARTA TIMUR, DKI JAKARTA",107,119,104,223
https://kawalpemilu.org#26103,"GEDONG, PASAR REBO, JAKARTA TIMUR, DKI JAKARTA",108,125,129,254
https://kawalpemilu.org#26103,"GEDONG, PASAR REBO, JAKARTA TIMUR, DKI JAKARTA",109,145,103,248
https://kawalpemilu.org#26105,"CAKUNG TIMUR, CAKUNG, JAKARTA TIMUR, DKI JAKARTA",1,99,137,236
https://kawalpemilu.org#26105,"CAKUNG TIMUR, CAKUNG, JAKARTA TIMUR, DKI JAKARTA",2,136,129,265
https://kawalpemilu.org#26105,"CAKUNG TIMUR, CAKUNG, JAKARTA TIMUR, DKI JAKARTA",3,71,185,256
https://kawalpemilu.org#26105,"CAKUNG TIMUR, CAKUNG, JAKARTA TIMUR, DKI JAKARTA",4,60,182,242
https://kawalpemilu.org#26105,"CAKUNG TIMUR, CAKUNG, JAKARTA TIMUR, DKI JAKARTA",5,70,130,200
https://kawalpemilu.org#26105,"CAKUNG TIMUR, CAKUNG, JAKARTA TIMUR, DKI JAKARTA",6,75,185,260
https://kawalpemilu.org#26105,"CAKUNG TIMUR, CAKUNG, JAKARTA TIMUR, DKI JAKARTA",7,70,154,224
https://kawalpemilu.org#26105,"CAKUNG TIMUR, CAKUNG, JAKARTA TIMUR, DKI JAKARTA",8,90,153,243
https://kawalpemilu.org#26105,"CAKUNG TIMUR, CAKUNG, JAKARTA TIMUR, DKI JAKARTA",9,71,174,245
https://kawalpemilu.org#26105,"CAKUNG TIMUR, CAKUNG, JAKARTA TIMUR, DKI JAKARTA",10,90,157,247
https://kawalpemilu.org#26105,"CAKUNG TIMUR, CAKUNG, JAKARTA TIMUR, DKI JAKARTA",11,74,136,210
https://kawalpemilu.org#26105,"CAKUNG TIMUR, CAKUNG, JAKARTA TIMUR, DKI JAKARTA",12,87,158,245
https://kawalpemilu.org#26105,"CAKUNG TIMUR, CAKUNG, JAKARTA TIMUR, DKI JAKARTA",13,105,160,265
https://kawalpemilu.org#26105,"CAKUNG TIMUR, CAKUNG, JAKARTA TIMUR, DKI JAKARTA",14,109,141,250
https://kawalpemilu.org#26105,"CAKUNG TIMUR, CAKUNG, JAKARTA TIMUR, DKI JAKARTA",15,129,132,261
https://kawalpemilu.org#26105,"CAKUNG TIMUR, CAKUNG, JAKARTA TIMUR, DKI JAKARTA",16,113,146,259
https://kawalpemilu.org#26105,"CAKUNG TIMUR, CAKUNG, JAKARTA TIMUR, DKI JAKARTA",17,94,131,225
https://kawalpemilu.org#26105,"CAKUNG TIMUR, CAKUNG, JAKARTA TIMUR, DKI JAKARTA",18,82,174,256
https://kawalpemilu.org#26105,"CAKUNG TIMUR, CAKUNG, JAKARTA TIMUR, DKI JAKARTA",19,128,129,257
https://kawalpemilu.org#26105,"CAKUNG TIMUR, CAKUNG, JAKARTA TIMUR, DKI JAKARTA",20,98,130,228
https://kawalpemilu.org#26105,"CAKUNG TIMUR, CAKUNG, JAKARTA TIMUR, DKI JAKARTA",21,85,140,225
https://kawalpemilu.org#26105,"CAKUNG TIMUR, CAKUNG, JAKARTA TIMUR, DKI JAKARTA",22,113,86,199
https://kawalpemilu.org#26105,"CAKUNG TIMUR, CAKUNG, JAKARTA TIMUR, DKI JAKARTA",23,180,63,243
https://kawalpemilu.org#26105,"CAKUNG TIMUR, CAKUNG, JAKARTA TIMUR, DKI JAKARTA",24,89,135,224
https://kawalpemilu.org#26105,"CAKUNG TIMUR, CAKUNG, JAKARTA TIMUR, DKI JAKARTA",25,84,113,197
https://kawalpemilu.org#26105,"CAKUNG TIMUR, CAKUNG, JAKARTA TIMUR, DKI JAKARTA",26,88,131,219
https://kawalpemilu.org#26105,"CAKUNG TIMUR, CAKUNG, JAKARTA TIMUR, DKI JAKARTA",27,92,150,242
https://kawalpemilu.org#26105,"CAKUNG TIMUR, CAKUNG, JAKARTA TIMUR, DKI JAKARTA",28,97,148,245
https://kawalpemilu.org#26105,"CAKUNG TIMUR, CAKUNG, JAKARTA TIMUR, DKI JAKARTA",30,84,147,231
https://kawalpemilu.org#26105,"CAKUNG TIMUR, CAKUNG, JAKARTA TIMUR, DKI JAKARTA",31,127,91,218
https://kawalpemilu.org#26105,"CAKUNG TIMUR, CAKUNG, JAKARTA TIMUR, DKI JAKARTA",32,77,161,238
https://kawalpemilu.org#26105,"CAKUNG TIMUR, CAKUNG, JAKARTA TIMUR, DKI JAKARTA",33,69,100,169
https://kawalpemilu.org#26105,"CAKUNG TIMUR, CAKUNG, JAKARTA TIMUR, DKI JAKARTA",34,116,131,247
https://kawalpemilu.org#26105,"CAKUNG TIMUR, CAKUNG, JAKARTA TIMUR, DKI JAKARTA",35,97,141,238
https://kawalpemilu.org#26105,"CAKUNG TIMUR, CAKUNG, JAKARTA TIMUR, DKI JAKARTA",36,170,99,269
https://kawalpemilu.org#26105,"CAKUNG TIMUR, CAKUNG, JAKARTA TIMUR, DKI JAKARTA",37,95,150,245
https://kawalpemilu.org#26105,"CAKUNG TIMUR, CAKUNG, JAKARTA TIMUR, DKI JAKARTA",38,120,128,248
https://kawalpemilu.org#26105,"CAKUNG TIMUR, CAKUNG, JAKARTA TIMUR, DKI JAKARTA",39,82,174,256
https://kawalpemilu.org#26105,"CAKUNG TIMUR, CAKUNG, JAKARTA TIMUR, DKI JAKARTA",40,117,115,232
https://kawalpemilu.org#26105,"CAKUNG TIMUR, CAKUNG, JAKARTA TIMUR, DKI JAKARTA",41,99,117,216
https://kawalpemilu.org#26105,"CAKUNG TIMUR, CAKUNG, JAKARTA TIMUR, DKI JAKARTA",43,79,120,199
https://kawalpemilu.org#26105,"CAKUNG TIMUR, CAKUNG, JAKARTA TIMUR, DKI JAKARTA",44,36,119,155
https://kawalpemilu.org#26105,"CAKUNG TIMUR, CAKUNG, JAKARTA TIMUR, DKI JAKARTA",45,88,133,221
https://kawalpemilu.org#26105,"CAKUNG TIMUR, CAKUNG, JAKARTA TIMUR, DKI JAKARTA",46,111,115,226
https://kawalpemilu.org#26105,"CAKUNG TIMUR, CAKUNG, JAKARTA TIMUR, DKI JAKARTA",47,96,122,218
https://kawalpemilu.org#26105,"CAKUNG TIMUR, CAKUNG, JAKARTA TIMUR, DKI JAKARTA",48,101,100,201
https://kawalpemilu.org#26105,"CAKUNG TIMUR, CAKUNG, JAKARTA TIMUR, DKI JAKARTA",49,113,111,224
https://kawalpemilu.org#26105,"CAKUNG TIMUR, CAKUNG, JAKARTA TIMUR, DKI JAKARTA",50,107,104,211
https://kawalpemilu.org#26105,"CAKUNG TIMUR, CAKUNG, JAKARTA TIMUR, DKI JAKARTA",51,86,145,231
https://kawalpemilu.org#26105,"CAKUNG TIMUR, CAKUNG, JAKARTA TIMUR, DKI JAKARTA",52,100,136,236
https://kawalpemilu.org#26105,"CAKUNG TIMUR, CAKUNG, JAKARTA TIMUR, DKI JAKARTA",54,123,126,249
https://kawalpemilu.org#26105,"CAKUNG TIMUR, CAKUNG, JAKARTA TIMUR, DKI JAKARTA",55,67,158,225
https://kawalpemilu.org#26105,"CAKUNG TIMUR, CAKUNG, JAKARTA TIMUR, DKI JAKARTA",56,85,130,215
https://kawalpemilu.org#26105,"CAKUNG TIMUR, CAKUNG, JAKARTA TIMUR, DKI JAKARTA",57,114,94,208
https://kawalpemilu.org#26105,"CAKUNG TIMUR, CAKUNG, JAKARTA TIMUR, DKI JAKARTA",58,109,66,175
https://kawalpemilu.org#26105,"CAKUNG TIMUR, CAKUNG, JAKARTA TIMUR, DKI JAKARTA",59,90,154,244
https://kawalpemilu.org#26105,"CAKUNG TIMUR, CAKUNG, JAKARTA TIMUR, DKI JAKARTA",60,91,124,215
https://kawalpemilu.org#26105,"CAKUNG TIMUR, CAKUNG, JAKARTA TIMUR, DKI JAKARTA",61,39,130,169
https://kawalpemilu.org#26105,"CAKUNG TIMUR, CAKUNG, JAKARTA TIMUR, DKI JAKARTA",62,96,145,241
https://kawalpemilu.org#26105,"CAKUNG TIMUR, CAKUNG, JAKARTA TIMUR, DKI JAKARTA",63,82,124,206
https://kawalpemilu.org#26105,"CAKUNG TIMUR, CAKUNG, JAKARTA TIMUR, DKI JAKARTA",64,73,133,206
https://kawalpemilu.org#26105,"CAKUNG TIMUR, CAKUNG, JAKARTA TIMUR, DKI JAKARTA",65,88,92,180
https://kawalpemilu.org#26105,"CAKUNG TIMUR, CAKUNG, JAKARTA TIMUR, DKI JAKARTA",66,70,72,142
https://kawalpemilu.org#26105,"CAKUNG TIMUR, CAKUNG, JAKARTA TIMUR, DKI JAKARTA",67,104,125,229
https://kawalpemilu.org#26105,"CAKUNG TIMUR, CAKUNG, JAKARTA TIMUR, DKI JAKARTA",68,65,138,203
https://kawalpemilu.org#26105,"CAKUNG TIMUR, CAKUNG, JAKARTA TIMUR, DKI JAKARTA",69,98,87,185
https://kawalpemilu.org#26105,"CAKUNG TIMUR, CAKUNG, JAKARTA TIMUR, DKI JAKARTA",70,111,75,186
https://kawalpemilu.org#26105,"CAKUNG TIMUR, CAKUNG, JAKARTA TIMUR, DKI JAKARTA",71,125,64,189
https://kawalpemilu.org#26105,"CAKUNG TIMUR, CAKUNG, JAKARTA TIMUR, DKI JAKARTA",72,139,90,229
https://kawalpemilu.org#26105,"CAKUNG TIMUR, CAKUNG, JAKARTA TIMUR, DKI JAKARTA",73,89,160,249
https://kawalpemilu.org#26105,"CAKUNG TIMUR, CAKUNG, JAKARTA TIMUR, DKI JAKARTA",74,88,138,226
https://kawalpemilu.org#26105,"CAKUNG TIMUR, CAKUNG, JAKARTA TIMUR, DKI JAKARTA",75,132,119,251
https://kawalpemilu.org#26105,"CAKUNG TIMUR, CAKUNG, JAKARTA TIMUR, DKI JAKARTA",76,107,146,253
https://kawalpemilu.org#26105,"CAKUNG TIMUR, CAKUNG, JAKARTA TIMUR, DKI JAKARTA",77,78,165,243
https://kawalpemilu.org#26105,"CAKUNG TIMUR, CAKUNG, JAKARTA TIMUR, DKI JAKARTA",78,76,133,209
https://kawalpemilu.org#26105,"CAKUNG TIMUR, CAKUNG, JAKARTA TIMUR, DKI JAKARTA",79,97,128,225
https://kawalpemilu.org#26105,"CAKUNG TIMUR, CAKUNG, JAKARTA TIMUR, DKI JAKARTA",80,88,118,206
https://kawalpemilu.org#26105,"CAKUNG TIMUR, CAKUNG, JAKARTA TIMUR, DKI JAKARTA",81,102,118,220
https://kawalpemilu.org#26105,"CAKUNG TIMUR, CAKUNG, JAKARTA TIMUR, DKI JAKARTA",83,122,64,186
https://kawalpemilu.org#26105,"CAKUNG TIMUR, CAKUNG, JAKARTA TIMUR, DKI JAKARTA",84,94,76,170
https://kawalpemilu.org#26105,"CAKUNG TIMUR, CAKUNG, JAKARTA TIMUR, DKI JAKARTA",85,94,147,241
https://kawalpemilu.org#26105,"CAKUNG TIMUR, CAKUNG, JAKARTA TIMUR, DKI JAKARTA",86,91,177,268
https://kawalpemilu.org#26105,"CAKUNG TIMUR, CAKUNG, JAKARTA TIMUR, DKI JAKARTA",87,116,115,231
https://kawalpemilu.org#26105,"CAKUNG TIMUR, CAKUNG, JAKARTA TIMUR, DKI JAKARTA",88,118,136,254
https://kawalpemilu.org#26105,"CAKUNG TIMUR, CAKUNG, JAKARTA TIMUR, DKI JAKARTA",89,0,0,0
https://kawalpemilu.org#26105,"CAKUNG TIMUR, CAKUNG, JAKARTA TIMUR, DKI JAKARTA",90,81,133,214
https://kawalpemilu.org#26105,"CAKUNG TIMUR, CAKUNG, JAKARTA TIMUR, DKI JAKARTA",91,92,151,243
https://kawalpemilu.org#26105,"CAKUNG TIMUR, CAKUNG, JAKARTA TIMUR, DKI JAKARTA",92,75,128,203
https://kawalpemilu.org#26105,"CAKUNG TIMUR, CAKUNG, JAKARTA TIMUR, DKI JAKARTA",93,81,122,203
https://kawalpemilu.org#26105,"CAKUNG TIMUR, CAKUNG, JAKARTA TIMUR, DKI JAKARTA",94,71,144,215
https://kawalpemilu.org#26105,"CAKUNG TIMUR, CAKUNG, JAKARTA TIMUR, DKI JAKARTA",95,95,148,243
https://kawalpemilu.org#26105,"CAKUNG TIMUR, CAKUNG, JAKARTA TIMUR, DKI JAKARTA",96,85,110,195
https://kawalpemilu.org#26105,"CAKUNG TIMUR, CAKUNG, JAKARTA TIMUR, DKI JAKARTA",97,123,114,237
https://kawalpemilu.org#26105,"CAKUNG TIMUR, CAKUNG, JAKARTA TIMUR, DKI JAKARTA",98,107,94,201
https://kawalpemilu.org#26105,"CAKUNG TIMUR, CAKUNG, JAKARTA TIMUR, DKI JAKARTA",99,120,98,218
https://kawalpemilu.org#26105,"CAKUNG TIMUR, CAKUNG, JAKARTA TIMUR, DKI JAKARTA",100,130,113,243
https://kawalpemilu.org#26105,"CAKUNG TIMUR, CAKUNG, JAKARTA TIMUR, DKI JAKARTA",101,92,118,210
https://kawalpemilu.org#26105,"CAKUNG TIMUR, CAKUNG, JAKARTA TIMUR, DKI JAKARTA",102,101,148,249
https://kawalpemilu.org#26105,"CAKUNG TIMUR, CAKUNG, JAKARTA TIMUR, DKI JAKARTA",103,58,197,255
https://kawalpemilu.org#26105,"CAKUNG TIMUR, CAKUNG, JAKARTA TIMUR, DKI JAKARTA",104,78,180,258
https://kawalpemilu.org#26105,"CAKUNG TIMUR, CAKUNG, JAKARTA TIMUR, DKI JAKARTA",105,138,107,245
https://kawalpemilu.org#26105,"CAKUNG TIMUR, CAKUNG, JAKARTA TIMUR, DKI JAKARTA",106,96,124,220
https://kawalpemilu.org#26105,"CAKUNG TIMUR, CAKUNG, JAKARTA TIMUR, DKI JAKARTA",107,49,216,265
https://kawalpemilu.org#26105,"CAKUNG TIMUR, CAKUNG, JAKARTA TIMUR, DKI JAKARTA",108,45,211,256
https://kawalpemilu.org#26105,"CAKUNG TIMUR, CAKUNG, JAKARTA TIMUR, DKI JAKARTA",109,25,247,272
https://kawalpemilu.org#26105,"CAKUNG TIMUR, CAKUNG, JAKARTA TIMUR, DKI JAKARTA",110,42,233,275
https://kawalpemilu.org#26105,"CAKUNG TIMUR, CAKUNG, JAKARTA TIMUR, DKI JAKARTA",111,34,213,247
https://kawalpemilu.org#26105,"CAKUNG TIMUR, CAKUNG, JAKARTA TIMUR, DKI JAKARTA",112,60,180,240
https://kawalpemilu.org#26105,"CAKUNG TIMUR, CAKUNG, JAKARTA TIMUR, DKI JAKARTA",113,49,213,262
https://kawalpemilu.org#26105,"CAKUNG TIMUR, CAKUNG, JAKARTA TIMUR, DKI JAKARTA",114,72,186,258
https://kawalpemilu.org#26105,"CAKUNG TIMUR, CAKUNG, JAKARTA TIMUR, DKI JAKARTA",115,49,204,253
https://kawalpemilu.org#26105,"CAKUNG TIMUR, CAKUNG, JAKARTA TIMUR, DKI JAKARTA",116,48,206,254
https://kawalpemilu.org#26105,"CAKUNG TIMUR, CAKUNG, JAKARTA TIMUR, DKI JAKARTA",117,90,176,266
https://kawalpemilu.org#26105,"CAKUNG TIMUR, CAKUNG, JAKARTA TIMUR, DKI JAKARTA",118,59,203,262
https://kawalpemilu.org#26105,"CAKUNG TIMUR, CAKUNG, JAKARTA TIMUR, DKI JAKARTA",119,46,244,290
https://kawalpemilu.org#26105,"CAKUNG TIMUR, CAKUNG, JAKARTA TIMUR, DKI JAKARTA",120,30,234,264
https://kawalpemilu.org#26105,"CAKUNG TIMUR, CAKUNG, JAKARTA TIMUR, DKI JAKARTA",121,86,179,265
https://kawalpemilu.org#26105,"CAKUNG TIMUR, CAKUNG, JAKARTA TIMUR, DKI JAKARTA",122,46,218,264
https://kawalpemilu.org#26105,"CAKUNG TIMUR, CAKUNG, JAKARTA TIMUR, DKI JAKARTA",123,52,216,268
https://kawalpemilu.org#26105,"CAKUNG TIMUR, CAKUNG, JAKARTA TIMUR, DKI JAKARTA",124,64,189,253
https://kawalpemilu.org#26105,"CAKUNG TIMUR, CAKUNG, JAKARTA TIMUR, DKI JAKARTA",125,26,183,209
https://kawalpemilu.org#26105,"CAKUNG TIMUR, CAKUNG, JAKARTA TIMUR, DKI JAKARTA",126,50,171,221
https://kawalpemilu.org#26105,"CAKUNG TIMUR, CAKUNG, JAKARTA TIMUR, DKI JAKARTA",127,37,229,266
https://kawalpemilu.org#26105,"CAKUNG TIMUR, CAKUNG, JAKARTA TIMUR, DKI JAKARTA",128,85,133,218
https://kawalpemilu.org#26105,"CAKUNG TIMUR, CAKUNG, JAKARTA TIMUR, DKI JAKARTA",129,116,134,250
https://kawalpemilu.org#26105,"CAKUNG TIMUR, CAKUNG, JAKARTA TIMUR, DKI JAKARTA",130,132,137,269
https://kawalpemilu.org#26105,"CAKUNG TIMUR, CAKUNG, JAKARTA TIMUR, DKI JAKARTA",131,116,79,195
https://kawalpemilu.org#26105,"CAKUNG TIMUR, CAKUNG, JAKARTA TIMUR, DKI JAKARTA",132,104,105,209
https://kawalpemilu.org#26105,"CAKUNG TIMUR, CAKUNG, JAKARTA TIMUR, DKI JAKARTA",133,113,98,211
https://kawalpemilu.org#26105,"CAKUNG TIMUR, CAKUNG, JAKARTA TIMUR, DKI JAKARTA",134,164,87,251
https://kawalpemilu.org#26105,"CAKUNG TIMUR, CAKUNG, JAKARTA TIMUR, DKI JAKARTA",135,150,91,241
https://kawalpemilu.org#26105,"CAKUNG TIMUR, CAKUNG, JAKARTA TIMUR, DKI JAKARTA",136,100,116,216
https://kawalpemilu.org#26105,"CAKUNG TIMUR, CAKUNG, JAKARTA TIMUR, DKI JAKARTA",137,95,92,187
https://kawalpemilu.org#26105,"CAKUNG TIMUR, CAKUNG, JAKARTA TIMUR, DKI JAKARTA",138,116,109,225
https://kawalpemilu.org#26105,"CAKUNG TIMUR, CAKUNG, JAKARTA TIMUR, DKI JAKARTA",139,159,72,231
https://kawalpemilu.org#26105,"CAKUNG TIMUR, CAKUNG, JAKARTA TIMUR, DKI JAKARTA",140,132,116,248
https://kawalpemilu.org#26105,"CAKUNG TIMUR, CAKUNG, JAKARTA TIMUR, DKI JAKARTA",141,137,88,225
https://kawalpemilu.org#26105,"CAKUNG TIMUR, CAKUNG, JAKARTA TIMUR, DKI JAKARTA",142,116,101,217
https://kawalpemilu.org#26105,"CAKUNG TIMUR, CAKUNG, JAKARTA TIMUR, DKI JAKARTA",143,207,55,262
https://kawalpemilu.org#26105,"CAKUNG TIMUR, CAKUNG, JAKARTA TIMUR, DKI JAKARTA",144,130,105,235
https://kawalpemilu.org#26105,"CAKUNG TIMUR, CAKUNG, JAKARTA TIMUR, DKI JAKARTA",145,179,80,259
https://kawalpemilu.org#26105,"CAKUNG TIMUR, CAKUNG, JAKARTA TIMUR, DKI JAKARTA",146,53,151,204
https://kawalpemilu.org#26105,"CAKUNG TIMUR, CAKUNG, JAKARTA TIMUR, DKI JAKARTA",147,39,153,192
https://kawalpemilu.org#26105,"CAKUNG TIMUR, CAKUNG, JAKARTA TIMUR, DKI JAKARTA",148,75,121,196
https://kawalpemilu.org#26105,"CAKUNG TIMUR, CAKUNG, JAKARTA TIMUR, DKI JAKARTA",149,79,134,213
https://kawalpemilu.org#26105,"CAKUNG TIMUR, CAKUNG, JAKARTA TIMUR, DKI JAKARTA",150,33,89,122
https://kawalpemilu.org#26105,"CAKUNG TIMUR, CAKUNG, JAKARTA TIMUR, DKI JAKARTA",151,82,146,228
https://kawalpemilu.org#26105,"CAKUNG TIMUR, CAKUNG, JAKARTA TIMUR, DKI JAKARTA",152,72,146,218
https://kawalpemilu.org#26105,"CAKUNG TIMUR, CAKUNG, JAKARTA TIMUR, DKI JAKARTA",153,106,116,222
https://kawalpemilu.org#26105,"CAKUNG TIMUR, CAKUNG, JAKARTA TIMUR, DKI JAKARTA",154,99,129,228
https://kawalpemilu.org#26105,"CAKUNG TIMUR, CAKUNG, JAKARTA TIMUR, DKI JAKARTA",155,95,98,193
https://kawalpemilu.org#26105,"CAKUNG TIMUR, CAKUNG, JAKARTA TIMUR, DKI JAKARTA",156,83,138,221
https://kawalpemilu.org#26105,"CAKUNG TIMUR, CAKUNG, JAKARTA TIMUR, DKI JAKARTA",157,108,133,241
https://kawalpemilu.org#26105,"CAKUNG TIMUR, CAKUNG, JAKARTA TIMUR, DKI JAKARTA",158,81,129,210
https://kawalpemilu.org#26105,"CAKUNG TIMUR, CAKUNG, JAKARTA TIMUR, DKI JAKARTA",159,104,139,243
https://kawalpemilu.org#26105,"CAKUNG TIMUR, CAKUNG, JAKARTA TIMUR, DKI JAKARTA",160,133,108,241
https://kawalpemilu.org#26105,"CAKUNG TIMUR, CAKUNG, JAKARTA TIMUR, DKI JAKARTA",161,78,141,219
https://kawalpemilu.org#26105,"CAKUNG TIMUR, CAKUNG, JAKARTA TIMUR, DKI JAKARTA",162,103,142,245
https://kawalpemilu.org#26105,"CAKUNG TIMUR, CAKUNG, JAKARTA TIMUR, DKI JAKARTA",163,126,105,231
https://kawalpemilu.org#26105,"CAKUNG TIMUR, CAKUNG, JAKARTA TIMUR, DKI JAKARTA",164,120,139,259
https://kawalpemilu.org#26105,"CAKUNG TIMUR, CAKUNG, JAKARTA TIMUR, DKI JAKARTA",165,113,156,269
https://kawalpemilu.org#26105,"CAKUNG TIMUR, CAKUNG, JAKARTA TIMUR, DKI JAKARTA",166,122,77,199
https://kawalpemilu.org#26105,"CAKUNG TIMUR, CAKUNG, JAKARTA TIMUR, DKI JAKARTA",167,62,196,258
https://kawalpemilu.org#26105,"CAKUNG TIMUR, CAKUNG, JAKARTA TIMUR, DKI JAKARTA",168,123,91,214
https://kawalpemilu.org#26105,"CAKUNG TIMUR, CAKUNG, JAKARTA TIMUR, DKI JAKARTA",169,163,31,194
https://kawalpemilu.org#26105,"CAKUNG TIMUR, CAKUNG, JAKARTA TIMUR, DKI JAKARTA",170,0,0,0
https://kawalpemilu.org#26105,"CAKUNG TIMUR, CAKUNG, JAKARTA TIMUR, DKI JAKARTA",171,159,66,225
https://kawalpemilu.org#26105,"CAKUNG TIMUR, CAKUNG, JAKARTA TIMUR, DKI JAKARTA",172,189,36,225
https://kawalpemilu.org#26105,"CAKUNG TIMUR, CAKUNG, JAKARTA TIMUR, DKI JAKARTA",173,206,46,252
https://kawalpemilu.org#26105,"CAKUNG TIMUR, CAKUNG, JAKARTA TIMUR, DKI JAKARTA",174,232,37,269
https://kawalpemilu.org#26105,"CAKUNG TIMUR, CAKUNG, JAKARTA TIMUR, DKI JAKARTA",175,175,23,198
https://kawalpemilu.org#26105,"CAKUNG TIMUR, CAKUNG, JAKARTA TIMUR, DKI JAKARTA",176,80,123,203
https://kawalpemilu.org#26105,"CAKUNG TIMUR, CAKUNG, JAKARTA TIMUR, DKI JAKARTA",177,104,133,237
https://kawalpemilu.org#26105,"CAKUNG TIMUR, CAKUNG, JAKARTA TIMUR, DKI JAKARTA",179,0,0,133
https://kawalpemilu.org#26105,"CAKUNG TIMUR, CAKUNG, JAKARTA TIMUR, DKI JAKARTA",180,85,113,198
https://kawalpemilu.org#26105,"CAKUNG TIMUR, CAKUNG, JAKARTA TIMUR, DKI JAKARTA",181,52,132,184
https://kawalpemilu.org#26105,"CAKUNG TIMUR, CAKUNG, JAKARTA TIMUR, DKI JAKARTA",182,107,93,200
https://kawalpemilu.org#26105,"CAKUNG TIMUR, CAKUNG, JAKARTA TIMUR, DKI JAKARTA",183,139,86,225
https://kawalpemilu.org#26105,"CAKUNG TIMUR, CAKUNG, JAKARTA TIMUR, DKI JAKARTA",184,76,112,188
https://kawalpemilu.org#26105,"CAKUNG TIMUR, CAKUNG, JAKARTA TIMUR, DKI JAKARTA",185,72,111,183
https://kawalpemilu.org#26106,"JATINEGARA, CAKUNG, JAKARTA TIMUR, DKI JAKARTA",1,67,129,196
https://kawalpemilu.org#26106,"JATINEGARA, CAKUNG, JAKARTA TIMUR, DKI JAKARTA",2,113,116,229
https://kawalpemilu.org#26106,"JATINEGARA, CAKUNG, JAKARTA TIMUR, DKI JAKARTA",3,87,121,208
https://kawalpemilu.org#26106,"JATINEGARA, CAKUNG, JAKARTA TIMUR, DKI JAKARTA",4,99,117,216
https://kawalpemilu.org#26106,"JATINEGARA, CAKUNG, JAKARTA TIMUR, DKI JAKARTA",5,92,130,222
https://kawalpemilu.org#26106,"JATINEGARA, CAKUNG, JAKARTA TIMUR, DKI JAKARTA",6,100,108,208
https://kawalpemilu.org#26106,"JATINEGARA, CAKUNG, JAKARTA TIMUR, DKI JAKARTA",7,92,145,237
https://kawalpemilu.org#26106,"JATINEGARA, CAKUNG, JAKARTA TIMUR, DKI JAKARTA",8,63,132,195
https://kawalpemilu.org#26106,"JATINEGARA, CAKUNG, JAKARTA TIMUR, DKI JAKARTA",9,94,125,219
https://kawalpemilu.org#26106,"JATINEGARA, CAKUNG, JAKARTA TIMUR, DKI JAKARTA",10,78,107,185
https://kawalpemilu.org#26106,"JATINEGARA, CAKUNG, JAKARTA TIMUR, DKI JAKARTA",11,56,149,205
https://kawalpemilu.org#26106,"JATINEGARA, CAKUNG, JAKARTA TIMUR, DKI JAKARTA",12,83,130,213
https://kawalpemilu.org#26106,"JATINEGARA, CAKUNG, JAKARTA TIMUR, DKI JAKARTA",13,78,145,223
https://kawalpemilu.org#26106,"JATINEGARA, CAKUNG, JAKARTA TIMUR, DKI JAKARTA",14,101,124,225
https://kawalpemilu.org#26106,"JATINEGARA, CAKUNG, JAKARTA TIMUR, DKI JAKARTA",15,96,143,239
https://kawalpemilu.org#26106,"JATINEGARA, CAKUNG, JAKARTA TIMUR, DKI JAKARTA",16,88,153,241
https://kawalpemilu.org#26106,"JATINEGARA, CAKUNG, JAKARTA TIMUR, DKI JAKARTA",17,88,110,198
https://kawalpemilu.org#26106,"JATINEGARA, CAKUNG, JAKARTA TIMUR, DKI JAKARTA",18,92,135,227
https://kawalpemilu.org#26106,"JATINEGARA, CAKUNG, JAKARTA TIMUR, DKI JAKARTA",19,81,148,229
https://kawalpemilu.org#26106,"JATINEGARA, CAKUNG, JAKARTA TIMUR, DKI JAKARTA",20,51,183,234
https://kawalpemilu.org#26106,"JATINEGARA, CAKUNG, JAKARTA TIMUR, DKI JAKARTA",21,115,114,229
https://kawalpemilu.org#26106,"JATINEGARA, CAKUNG, JAKARTA TIMUR, DKI JAKARTA",22,70,114,184
https://kawalpemilu.org#26106,"JATINEGARA, CAKUNG, JAKARTA TIMUR, DKI JAKARTA",23,102,145,247
https://kawalpemilu.org#26106,"JATINEGARA, CAKUNG, JAKARTA TIMUR, DKI JAKARTA",24,95,155,250
https://kawalpemilu.org#26106,"JATINEGARA, CAKUNG, JAKARTA TIMUR, DKI JAKARTA",25,98,144,242
https://kawalpemilu.org#26106,"JATINEGARA, CAKUNG, JAKARTA TIMUR, DKI JAKARTA",26,75,63,138
https://kawalpemilu.org#26106,"JATINEGARA, CAKUNG, JAKARTA TIMUR, DKI JAKARTA",27,126,111,237
https://kawalpemilu.org#26106,"JATINEGARA, CAKUNG, JAKARTA TIMUR, DKI JAKARTA",28,109,129,238
https://kawalpemilu.org#26106,"JATINEGARA, CAKUNG, JAKARTA TIMUR, DKI JAKARTA",29,62,131,193
https://kawalpemilu.org#26106,"JATINEGARA, CAKUNG, JAKARTA TIMUR, DKI JAKARTA",30,110,128,238
https://kawalpemilu.org#26106,"JATINEGARA, CAKUNG, JAKARTA TIMUR, DKI JAKARTA",31,95,118,213
https://kawalpemilu.org#26106,"JATINEGARA, CAKUNG, JAKARTA TIMUR, DKI JAKARTA",32,107,168,275
https://kawalpemilu.org#26106,"JATINEGARA, CAKUNG, JAKARTA TIMUR, DKI JAKARTA",33,95,121,216
https://kawalpemilu.org#26106,"JATINEGARA, CAKUNG, JAKARTA TIMUR, DKI JAKARTA",34,60,149,209
https://kawalpemilu.org#26106,"JATINEGARA, CAKUNG, JAKARTA TIMUR, DKI JAKARTA",35,80,142,222
https://kawalpemilu.org#26106,"JATINEGARA, CAKUNG, JAKARTA TIMUR, DKI JAKARTA",36,94,177,271
https://kawalpemilu.org#26106,"JATINEGARA, CAKUNG, JAKARTA TIMUR, DKI JAKARTA",38,84,112,196
https://kawalpemilu.org#26106,"JATINEGARA, CAKUNG, JAKARTA TIMUR, DKI JAKARTA",39,90,88,178
https://kawalpemilu.org#26106,"JATINEGARA, CAKUNG, JAKARTA TIMUR, DKI JAKARTA",40,102,104,206
https://kawalpemilu.org#26106,"JATINEGARA, CAKUNG, JAKARTA TIMUR, DKI JAKARTA",41,71,128,199
https://kawalpemilu.org#26106,"JATINEGARA, CAKUNG, JAKARTA TIMUR, DKI JAKARTA",42,105,139,244
https://kawalpemilu.org#26106,"JATINEGARA, CAKUNG, JAKARTA TIMUR, DKI JAKARTA",43,95,109,204
https://kawalpemilu.org#26106,"JATINEGARA, CAKUNG, JAKARTA TIMUR, DKI JAKARTA",44,95,127,222
https://kawalpemilu.org#26106,"JATINEGARA, CAKUNG, JAKARTA TIMUR, DKI JAKARTA",45,75,154,229
https://kawalpemilu.org#26106,"JATINEGARA, CAKUNG, JAKARTA TIMUR, DKI JAKARTA",46,70,186,256
https://kawalpemilu.org#26106,"JATINEGARA, CAKUNG, JAKARTA TIMUR, DKI JAKARTA",47,72,176,248
https://kawalpemilu.org#26106,"JATINEGARA, CAKUNG, JAKARTA TIMUR, DKI JAKARTA",48,116,149,265
https://kawalpemilu.org#26106,"JATINEGARA, CAKUNG, JAKARTA TIMUR, DKI JAKARTA",49,98,116,214
https://kawalpemilu.org#26106,"JATINEGARA, CAKUNG, JAKARTA TIMUR, DKI JAKARTA",50,115,105,220
https://kawalpemilu.org#26106,"JATINEGARA, CAKUNG, JAKARTA TIMUR, DKI JAKARTA",51,117,110,227
https://kawalpemilu.org#26106,"JATINEGARA, CAKUNG, JAKARTA TIMUR, DKI JAKARTA",52,144,116,260
https://kawalpemilu.org#26106,"JATINEGARA, CAKUNG, JAKARTA TIMUR, DKI JAKARTA",53,76,145,221
https://kawalpemilu.org#26106,"JATINEGARA, CAKUNG, JAKARTA TIMUR, DKI JAKARTA",54,107,132,239
https://kawalpemilu.org#26106,"JATINEGARA, CAKUNG, JAKARTA TIMUR, DKI JAKARTA",55,73,71,144
https://kawalpemilu.org#26106,"JATINEGARA, CAKUNG, JAKARTA TIMUR, DKI JAKARTA",56,80,148,228
https://kawalpemilu.org#26106,"JATINEGARA, CAKUNG, JAKARTA TIMUR, DKI JAKARTA",57,84,124,208
https://kawalpemilu.org#26106,"JATINEGARA, CAKUNG, JAKARTA TIMUR, DKI JAKARTA",58,88,117,205
https://kawalpemilu.org#26106,"JATINEGARA, CAKUNG, JAKARTA TIMUR, DKI JAKARTA",59,98,108,206
https://kawalpemilu.org#26106,"JATINEGARA, CAKUNG, JAKARTA TIMUR, DKI JAKARTA",60,88,123,211
https://kawalpemilu.org#26106,"JATINEGARA, CAKUNG, JAKARTA TIMUR, DKI JAKARTA",61,106,126,232
https://kawalpemilu.org#26106,"JATINEGARA, CAKUNG, JAKARTA TIMUR, DKI JAKARTA",62,100,94,194
https://kawalpemilu.org#26106,"JATINEGARA, CAKUNG, JAKARTA TIMUR, DKI JAKARTA",63,83,103,186
https://kawalpemilu.org#26106,"JATINEGARA, CAKUNG, JAKARTA TIMUR, DKI JAKARTA",64,73,80,153
https://kawalpemilu.org#26106,"JATINEGARA, CAKUNG, JAKARTA TIMUR, DKI JAKARTA",65,120,105,225
https://kawalpemilu.org#26106,"JATINEGARA, CAKUNG, JAKARTA TIMUR, DKI JAKARTA",66,63,131,194
https://kawalpemilu.org#26106,"JATINEGARA, CAKUNG, JAKARTA TIMUR, DKI JAKARTA",67,94,109,203
https://kawalpemilu.org#26106,"JATINEGARA, CAKUNG, JAKARTA TIMUR, DKI JAKARTA",68,69,141,210
https://kawalpemilu.org#26106,"JATINEGARA, CAKUNG, JAKARTA TIMUR, DKI JAKARTA",69,87,117,204
https://kawalpemilu.org#26106,"JATINEGARA, CAKUNG, JAKARTA TIMUR, DKI JAKARTA",70,85,154,239
https://kawalpemilu.org#26106,"JATINEGARA, CAKUNG, JAKARTA TIMUR, DKI JAKARTA",71,67,72,139
https://kawalpemilu.org#26106,"JATINEGARA, CAKUNG, JAKARTA TIMUR, DKI JAKARTA",72,73,137,210
https://kawalpemilu.org#26106,"JATINEGARA, CAKUNG, JAKARTA TIMUR, DKI JAKARTA",73,81,112,193
https://kawalpemilu.org#26106,"JATINEGARA, CAKUNG, JAKARTA TIMUR, DKI JAKARTA",74,103,120,223
https://kawalpemilu.org#26106,"JATINEGARA, CAKUNG, JAKARTA TIMUR, DKI JAKARTA",75,111,111,222
https://kawalpemilu.org#26106,"JATINEGARA, CAKUNG, JAKARTA TIMUR, DKI JAKARTA",76,105,129,234
https://kawalpemilu.org#26106,"JATINEGARA, CAKUNG, JAKARTA TIMUR, DKI JAKARTA",77,79,128,207
https://kawalpemilu.org#26106,"JATINEGARA, CAKUNG, JAKARTA TIMUR, DKI JAKARTA",78,147,110,257
https://kawalpemilu.org#26106,"JATINEGARA, CAKUNG, JAKARTA TIMUR, DKI JAKARTA",79,108,131,239
https://kawalpemilu.org#26106,"JATINEGARA, CAKUNG, JAKARTA TIMUR, DKI JAKARTA",80,109,119,228
https://kawalpemilu.org#26106,"JATINEGARA, CAKUNG, JAKARTA TIMUR, DKI JAKARTA",81,98,83,182
https://kawalpemilu.org#26106,"JATINEGARA, CAKUNG, JAKARTA TIMUR, DKI JAKARTA",82,55,203,258
https://kawalpemilu.org#26106,"JATINEGARA, CAKUNG, JAKARTA TIMUR, DKI JAKARTA",83,105,112,217
https://kawalpemilu.org#26106,"JATINEGARA, CAKUNG, JAKARTA TIMUR, DKI JAKARTA",84,103,101,204
https://kawalpemilu.org#26106,"JATINEGARA, CAKUNG, JAKARTA TIMUR, DKI JAKARTA",85,106,113,219
https://kawalpemilu.org#26106,"JATINEGARA, CAKUNG, JAKARTA TIMUR, DKI JAKARTA",86,97,126,223
https://kawalpemilu.org#26106,"JATINEGARA, CAKUNG, JAKARTA TIMUR, DKI JAKARTA",87,105,143,248
https://kawalpemilu.org#26106,"JATINEGARA, CAKUNG, JAKARTA TIMUR, DKI JAKARTA",88,91,132,223
https://kawalpemilu.org#26106,"JATINEGARA, CAKUNG, JAKARTA TIMUR, DKI JAKARTA",89,83,138,221
https://kawalpemilu.org#26106,"JATINEGARA, CAKUNG, JAKARTA TIMUR, DKI JAKARTA",90,61,133,194
https://kawalpemilu.org#26106,"JATINEGARA, CAKUNG, JAKARTA TIMUR, DKI JAKARTA",92,70,144,214
https://kawalpemilu.org#26106,"JATINEGARA, CAKUNG, JAKARTA TIMUR, DKI JAKARTA",93,92,164,256
https://kawalpemilu.org#26106,"JATINEGARA, CAKUNG, JAKARTA TIMUR, DKI JAKARTA",94,97,134,231
https://kawalpemilu.org#26106,"JATINEGARA, CAKUNG, JAKARTA TIMUR, DKI JAKARTA",95,78,152,230
https://kawalpemilu.org#26106,"JATINEGARA, CAKUNG, JAKARTA TIMUR, DKI JAKARTA",96,112,115,227
https://kawalpemilu.org#26106,"JATINEGARA, CAKUNG, JAKARTA TIMUR, DKI JAKARTA",97,89,111,200
https://kawalpemilu.org#26106,"JATINEGARA, CAKUNG, JAKARTA TIMUR, DKI JAKARTA",98,86,118,204
https://kawalpemilu.org#26106,"JATINEGARA, CAKUNG, JAKARTA TIMUR, DKI JAKARTA",99,56,105,161
https://kawalpemilu.org#26106,"JATINEGARA, CAKUNG, JAKARTA TIMUR, DKI JAKARTA",100,99,116,215
https://kawalpemilu.org#26106,"JATINEGARA, CAKUNG, JAKARTA TIMUR, DKI JAKARTA",102,94,126,220
https://kawalpemilu.org#26106,"JATINEGARA, CAKUNG, JAKARTA TIMUR, DKI JAKARTA",103,115,117,232
https://kawalpemilu.org#26106,"JATINEGARA, CAKUNG, JAKARTA TIMUR, DKI JAKARTA",104,102,102,204
https://kawalpemilu.org#26106,"JATINEGARA, CAKUNG, JAKARTA TIMUR, DKI JAKARTA",105,72,145,217
https://kawalpemilu.org#26106,"JATINEGARA, CAKUNG, JAKARTA TIMUR, DKI JAKARTA",106,65,134,199
https://kawalpemilu.org#26106,"JATINEGARA, CAKUNG, JAKARTA TIMUR, DKI JAKARTA",108,79,152,231
https://kawalpemilu.org#26106,"JATINEGARA, CAKUNG, JAKARTA TIMUR, DKI JAKARTA",109,65,151,216
https://kawalpemilu.org#26106,"JATINEGARA, CAKUNG, JAKARTA TIMUR, DKI JAKARTA",110,94,160,254
https://kawalpemilu.org#26106,"JATINEGARA, CAKUNG, JAKARTA TIMUR, DKI JAKARTA",111,72,158,230
https://kawalpemilu.org#26106,"JATINEGARA, CAKUNG, JAKARTA TIMUR, DKI JAKARTA",112,69,109,178
https://kawalpemilu.org#26106,"JATINEGARA, CAKUNG, JAKARTA TIMUR, DKI JAKARTA",113,42,92,134
https://kawalpemilu.org#26106,"JATINEGARA, CAKUNG, JAKARTA TIMUR, DKI JAKARTA",114,83,127,210
https://kawalpemilu.org#26106,"JATINEGARA, CAKUNG, JAKARTA TIMUR, DKI JAKARTA",115,73,147,220
https://kawalpemilu.org#26106,"JATINEGARA, CAKUNG, JAKARTA TIMUR, DKI JAKARTA",116,66,93,159
https://kawalpemilu.org#26106,"JATINEGARA, CAKUNG, JAKARTA TIMUR, DKI JAKARTA",117,122,91,213
https://kawalpemilu.org#26106,"JATINEGARA, CAKUNG, JAKARTA TIMUR, DKI JAKARTA",118,79,100,179
https://kawalpemilu.org#26106,"JATINEGARA, CAKUNG, JAKARTA TIMUR, DKI JAKARTA",119,89,65,154
https://kawalpemilu.org#26106,"JATINEGARA, CAKUNG, JAKARTA TIMUR, DKI JAKARTA",120,100,83,183
https://kawalpemilu.org#26106,"JATINEGARA, CAKUNG, JAKARTA TIMUR, DKI JAKARTA",121,116,93,209
https://kawalpemilu.org#26106,"JATINEGARA, CAKUNG, JAKARTA TIMUR, DKI JAKARTA",123,132,63,195
https://kawalpemilu.org#26106,"JATINEGARA, CAKUNG, JAKARTA TIMUR, DKI JAKARTA",124,88,64,152
https://kawalpemilu.org#26106,"JATINEGARA, CAKUNG, JAKARTA TIMUR, DKI JAKARTA",125,97,115,212
https://kawalpemilu.org#26106,"JATINEGARA, CAKUNG, JAKARTA TIMUR, DKI JAKARTA",128,67,129,196
https://kawalpemilu.org#26106,"JATINEGARA, CAKUNG, JAKARTA TIMUR, DKI JAKARTA",130,107,132,239
https://kawalpemilu.org#26106,"JATINEGARA, CAKUNG, JAKARTA TIMUR, DKI JAKARTA",131,76,135,211
https://kawalpemilu.org#26106,"JATINEGARA, CAKUNG, JAKARTA TIMUR, DKI JAKARTA",132,95,138,233
https://kawalpemilu.org#26106,"JATINEGARA, CAKUNG, JAKARTA TIMUR, DKI JAKARTA",133,70,114,184
https://kawalpemilu.org#26106,"JATINEGARA, CAKUNG, JAKARTA TIMUR, DKI JAKARTA",134,55,105,160
https://kawalpemilu.org#26106,"JATINEGARA, CAKUNG, JAKARTA TIMUR, DKI JAKARTA",135,75,160,235
https://kawalpemilu.org#26106,"JATINEGARA, CAKUNG, JAKARTA TIMUR, DKI JAKARTA",136,72,166,238
https://kawalpemilu.org#26106,"JATINEGARA, CAKUNG, JAKARTA TIMUR, DKI JAKARTA",137,62,137,199
https://kawalpemilu.org#26106,"JATINEGARA, CAKUNG, JAKARTA TIMUR, DKI JAKARTA",138,92,70,162
https://kawalpemilu.org#26106,"JATINEGARA, CAKUNG, JAKARTA TIMUR, DKI JAKARTA",139,96,97,193
https://kawalpemilu.org#26106,"JATINEGARA, CAKUNG, JAKARTA TIMUR, DKI JAKARTA",140,100,84,184
https://kawalpemilu.org#26106,"JATINEGARA, CAKUNG, JAKARTA TIMUR, DKI JAKARTA",141,102,64,166
https://kawalpemilu.org#26106,"JATINEGARA, CAKUNG, JAKARTA TIMUR, DKI JAKARTA",142,103,79,182
https://kawalpemilu.org#26106,"JATINEGARA, CAKUNG, JAKARTA TIMUR, DKI JAKARTA",143,118,143,261
https://kawalpemilu.org#26106,"JATINEGARA, CAKUNG, JAKARTA TIMUR, DKI JAKARTA",144,129,104,233
https://kawalpemilu.org#26106,"JATINEGARA, CAKUNG, JAKARTA TIMUR, DKI JAKARTA",146,84,169,253
https://kawalpemilu.org#26106,"JATINEGARA, CAKUNG, JAKARTA TIMUR, DKI JAKARTA",148,68,113,181
https://kawalpemilu.org#26106,"JATINEGARA, CAKUNG, JAKARTA TIMUR, DKI JAKARTA",149,97,132,229
https://kawalpemilu.org#26106,"JATINEGARA, CAKUNG, JAKARTA TIMUR, DKI JAKARTA",150,87,159,246
https://kawalpemilu.org#26106,"JATINEGARA, CAKUNG, JAKARTA TIMUR, DKI JAKARTA",151,90,96,186
https://kawalpemilu.org#26106,"JATINEGARA, CAKUNG, JAKARTA TIMUR, DKI JAKARTA",152,89,147,236
https://kawalpemilu.org#26106,"JATINEGARA, CAKUNG, JAKARTA TIMUR, DKI JAKARTA",153,95,142,237
https://kawalpemilu.org#26106,"JATINEGARA, CAKUNG, JAKARTA TIMUR, DKI JAKARTA",154,85,129,214
https://kawalpemilu.org#26106,"JATINEGARA, CAKUNG, JAKARTA TIMUR, DKI JAKARTA",155,93,164,257
https://kawalpemilu.org#26106,"JATINEGARA, CAKUNG, JAKARTA TIMUR, DKI JAKARTA",156,81,137,218
https://kawalpemilu.org#26106,"JATINEGARA, CAKUNG, JAKARTA TIMUR, DKI JAKARTA",157,86,167,253
https://kawalpemilu.org#26106,"JATINEGARA, CAKUNG, JAKARTA TIMUR, DKI JAKARTA",159,83,146,229
https://kawalpemilu.org#26106,"JATINEGARA, CAKUNG, JAKARTA TIMUR, DKI JAKARTA",160,59,180,239
https://kawalpemilu.org#26106,"JATINEGARA, CAKUNG, JAKARTA TIMUR, DKI JAKARTA",161,87,135,222
https://kawalpemilu.org#26106,"JATINEGARA, CAKUNG, JAKARTA TIMUR, DKI JAKARTA",162,82,133,215
https://kawalpemilu.org#26106,"JATINEGARA, CAKUNG, JAKARTA TIMUR, DKI JAKARTA",165,92,109,201
https://kawalpemilu.org#26106,"JATINEGARA, CAKUNG, JAKARTA TIMUR, DKI JAKARTA",166,107,100,207
https://kawalpemilu.org#26106,"JATINEGARA, CAKUNG, JAKARTA TIMUR, DKI JAKARTA",168,84,83,167
https://kawalpemilu.org#26106,"JATINEGARA, CAKUNG, JAKARTA TIMUR, DKI JAKARTA",169,109,103,212
https://kawalpemilu.org#26106,"JATINEGARA, CAKUNG, JAKARTA TIMUR, DKI JAKARTA",170,103,104,207
https://kawalpemilu.org#26106,"JATINEGARA, CAKUNG, JAKARTA TIMUR, DKI JAKARTA",173,91,150,241
https://kawalpemilu.org#26106,"JATINEGARA, CAKUNG, JAKARTA TIMUR, DKI JAKARTA",174,115,127,242
https://kawalpemilu.org#26106,"JATINEGARA, CAKUNG, JAKARTA TIMUR, DKI JAKARTA",175,98,133,231
https://kawalpemilu.org#26106,"JATINEGARA, CAKUNG, JAKARTA TIMUR, DKI JAKARTA",177,156,113,269
https://kawalpemilu.org#26106,"JATINEGARA, CAKUNG, JAKARTA TIMUR, DKI JAKARTA",178,139,103,242
https://kawalpemilu.org#26106,"JATINEGARA, CAKUNG, JAKARTA TIMUR, DKI JAKARTA",179,116,106,222
https://kawalpemilu.org#26106,"JATINEGARA, CAKUNG, JAKARTA TIMUR, DKI JAKARTA",180,156,65,221
https://kawalpemilu.org#26106,"JATINEGARA, CAKUNG, JAKARTA TIMUR, DKI JAKARTA",181,170,89,259
https://kawalpemilu.org#26106,"JATINEGARA, CAKUNG, JAKARTA TIMUR, DKI JAKARTA",182,110,137,247
https://kawalpemilu.org#26106,"JATINEGARA, CAKUNG, JAKARTA TIMUR, DKI JAKARTA",184,100,142,242
https://kawalpemilu.org#26106,"JATINEGARA, CAKUNG, JAKARTA TIMUR, DKI JAKARTA",185,81,94,175
https://kawalpemilu.org#26106,"JATINEGARA, CAKUNG, JAKARTA TIMUR, DKI JAKARTA",186,96,130,226
https://kawalpemilu.org#26106,"JATINEGARA, CAKUNG, JAKARTA TIMUR, DKI JAKARTA",187,96,108,204
https://kawalpemilu.org#26106,"JATINEGARA, CAKUNG, JAKARTA TIMUR, DKI JAKARTA",188,115,124,239
https://kawalpemilu.org#26106,"JATINEGARA, CAKUNG, JAKARTA TIMUR, DKI JAKARTA",189,84,174,261
https://kawalpemilu.org#26106,"JATINEGARA, CAKUNG, JAKARTA TIMUR, DKI JAKARTA",190,53,60,113
https://kawalpemilu.org#26106,"JATINEGARA, CAKUNG, JAKARTA TIMUR, DKI JAKARTA",194,90,124,214
https://kawalpemilu.org#26106,"JATINEGARA, CAKUNG, JAKARTA TIMUR, DKI JAKARTA",196,74,147,221
https://kawalpemilu.org#26106,"JATINEGARA, CAKUNG, JAKARTA TIMUR, DKI JAKARTA",197,87,110,197
https://kawalpemilu.org#26106,"JATINEGARA, CAKUNG, JAKARTA TIMUR, DKI JAKARTA",198,113,174,287
https://kawalpemilu.org#26106,"JATINEGARA, CAKUNG, JAKARTA TIMUR, DKI JAKARTA",199,102,71,173
https://kawalpemilu.org#26106,"JATINEGARA, CAKUNG, JAKARTA TIMUR, DKI JAKARTA",200,75,96,171
https://kawalpemilu.org#26106,"JATINEGARA, CAKUNG, JAKARTA TIMUR, DKI JAKARTA",202,61,118,179
https://kawalpemilu.org#26106,"JATINEGARA, CAKUNG, JAKARTA TIMUR, DKI JAKARTA",205,83,127,210
https://kawalpemilu.org#26106,"JATINEGARA, CAKUNG, JAKARTA TIMUR, DKI JAKARTA",206,89,144,233
https://kawalpemilu.org#26106,"JATINEGARA, CAKUNG, JAKARTA TIMUR, DKI JAKARTA",207,84,162,246
https://kawalpemilu.org#26106,"JATINEGARA, CAKUNG, JAKARTA TIMUR, DKI JAKARTA",208,35,73,108
https://kawalpemilu.org#26106,"JATINEGARA, CAKUNG, JAKARTA TIMUR, DKI JAKARTA",209,109,108,217
https://kawalpemilu.org#26106,"JATINEGARA, CAKUNG, JAKARTA TIMUR, DKI JAKARTA",210,109,120,229
https://kawalpemilu.org#26106,"JATINEGARA, CAKUNG, JAKARTA TIMUR, DKI JAKARTA",211,103,115,218
https://kawalpemilu.org#26106,"JATINEGARA, CAKUNG, JAKARTA TIMUR, DKI JAKARTA",212,76,85,161
https://kawalpemilu.org#26106,"JATINEGARA, CAKUNG, JAKARTA TIMUR, DKI JAKARTA",213,60,100,160
https://kawalpemilu.org#26106,"JATINEGARA, CAKUNG, JAKARTA TIMUR, DKI JAKARTA",214,78,97,175
https://kawalpemilu.org#26106,"JATINEGARA, CAKUNG, JAKARTA TIMUR, DKI JAKARTA",215,66,80,146
https://kawalpemilu.org#26106,"JATINEGARA, CAKUNG, JAKARTA TIMUR, DKI JAKARTA",217,73,113,186
https://kawalpemilu.org#26106,"JATINEGARA, CAKUNG, JAKARTA TIMUR, DKI JAKARTA",218,111,122,233
https://kawalpemilu.org#26106,"JATINEGARA, CAKUNG, JAKARTA TIMUR, DKI JAKARTA",219,51,144,195
https://kawalpemilu.org#26106,"JATINEGARA, CAKUNG, JAKARTA TIMUR, DKI JAKARTA",220,85,153,238
https://kawalpemilu.org#26106,"JATINEGARA, CAKUNG, JAKARTA TIMUR, DKI JAKARTA",221,73,124,197
https://kawalpemilu.org#26106,"JATINEGARA, CAKUNG, JAKARTA TIMUR, DKI JAKARTA",222,89,140,229
https://kawalpemilu.org#26106,"JATINEGARA, CAKUNG, JAKARTA TIMUR, DKI JAKARTA",223,115,114,229
https://kawalpemilu.org#26106,"JATINEGARA, CAKUNG, JAKARTA TIMUR, DKI JAKARTA",224,80,125,205
https://kawalpemilu.org#26106,"JATINEGARA, CAKUNG, JAKARTA TIMUR, DKI JAKARTA",226,63,35,98
https://kawalpemilu.org#26106,"JATINEGARA, CAKUNG, JAKARTA TIMUR, DKI JAKARTA",230,31,135,166
https://kawalpemilu.org#26106,"JATINEGARA, CAKUNG, JAKARTA TIMUR, DKI JAKARTA",232,70,100,170
https://kawalpemilu.org#26106,"JATINEGARA, CAKUNG, JAKARTA TIMUR, DKI JAKARTA",233,100,114,214
https://kawalpemilu.org#26106,"JATINEGARA, CAKUNG, JAKARTA TIMUR, DKI JAKARTA",234,88,119,207
https://kawalpemilu.org#26106,"JATINEGARA, CAKUNG, JAKARTA TIMUR, DKI JAKARTA",235,123,116,239
https://kawalpemilu.org#26106,"JATINEGARA, CAKUNG, JAKARTA TIMUR, DKI JAKARTA",236,65,88,153
https://kawalpemilu.org#26106,"JATINEGARA, CAKUNG, JAKARTA TIMUR, DKI JAKARTA",237,71,141,212
https://kawalpemilu.org#26106,"JATINEGARA, CAKUNG, JAKARTA TIMUR, DKI JAKARTA",239,97,134,231
https://kawalpemilu.org#26106,"JATINEGARA, CAKUNG, JAKARTA TIMUR, DKI JAKARTA",240,71,171,188
https://kawalpemilu.org#26106,"JATINEGARA, CAKUNG, JAKARTA TIMUR, DKI JAKARTA",241,91,130,221
https://kawalpemilu.org#26106,"JATINEGARA, CAKUNG, JAKARTA TIMUR, DKI JAKARTA",243,77,85,162
https://kawalpemilu.org#26106,"JATINEGARA, CAKUNG, JAKARTA TIMUR, DKI JAKARTA",244,96,153,249
https://kawalpemilu.org#26106,"JATINEGARA, CAKUNG, JAKARTA TIMUR, DKI JAKARTA",245,92,121,213
https://kawalpemilu.org#26106,"JATINEGARA, CAKUNG, JAKARTA TIMUR, DKI JAKARTA",246,78,113,191
https://kawalpemilu.org#26106,"JATINEGARA, CAKUNG, JAKARTA TIMUR, DKI JAKARTA",247,76,109,185
https://kawalpemilu.org#26106,"JATINEGARA, CAKUNG, JAKARTA TIMUR, DKI JAKARTA",248,43,53,96
https://kawalpemilu.org#26106,"JATINEGARA, CAKUNG, JAKARTA TIMUR, DKI JAKARTA",249,94,131,225
https://kawalpemilu.org#26106,"JATINEGARA, CAKUNG, JAKARTA TIMUR, DKI JAKARTA",250,77,94,172
https://kawalpemilu.org#26106,"JATINEGARA, CAKUNG, JAKARTA TIMUR, DKI JAKARTA",251,73,120,193
https://kawalpemilu.org#26106,"JATINEGARA, CAKUNG, JAKARTA TIMUR, DKI JAKARTA",252,112,94,206
https://kawalpemilu.org#26106,"JATINEGARA, CAKUNG, JAKARTA TIMUR, DKI JAKARTA",253,72,82,154
https://kawalpemilu.org#26106,"JATINEGARA, CAKUNG, JAKARTA TIMUR, DKI JAKARTA",254,112,86,198
https://kawalpemilu.org#26106,"JATINEGARA, CAKUNG, JAKARTA TIMUR, DKI JAKARTA",255,84,93,177
https://kawalpemilu.org#26106,"JATINEGARA, CAKUNG, JAKARTA TIMUR, DKI JAKARTA",256,75,161,236
https://kawalpemilu.org#26106,"JATINEGARA, CAKUNG, JAKARTA TIMUR, DKI JAKARTA",258,63,133,196
https://kawalpemilu.org#26106,"JATINEGARA, CAKUNG, JAKARTA TIMUR, DKI JAKARTA",259,85,100,185
https://kawalpemilu.org#26106,"JATINEGARA, CAKUNG, JAKARTA TIMUR, DKI JAKARTA",260,88,104,192
https://kawalpemilu.org#26106,"JATINEGARA, CAKUNG, JAKARTA TIMUR, DKI JAKARTA",262,92,82,174
https://kawalpemilu.org#26106,"JATINEGARA, CAKUNG, JAKARTA TIMUR, DKI JAKARTA",263,138,96,234
https://kawalpemilu.org#26106,"JATINEGARA, CAKUNG, JAKARTA TIMUR, DKI JAKARTA",264,120,144,264
https://kawalpemilu.org#26106,"JATINEGARA, CAKUNG, JAKARTA TIMUR, DKI JAKARTA",265,120,101,221
https://kawalpemilu.org#26106,"JATINEGARA, CAKUNG, JAKARTA TIMUR, DKI JAKARTA",266,74,92,166
https://kawalpemilu.org#26106,"JATINEGARA, CAKUNG, JAKARTA TIMUR, DKI JAKARTA",269,75,87,162
https://kawalpemilu.org#26106,"JATINEGARA, CAKUNG, JAKARTA TIMUR, DKI JAKARTA",270,81,103,184
https://kawalpemilu.org#26106,"JATINEGARA, CAKUNG, JAKARTA TIMUR, DKI JAKARTA",272,66,54,120
https://kawalpemilu.org#26106,"JATINEGARA, CAKUNG, JAKARTA TIMUR, DKI JAKARTA",274,50,74,124
https://kawalpemilu.org#26106,"JATINEGARA, CAKUNG, JAKARTA TIMUR, DKI JAKARTA",276,53,77,130
https://kawalpemilu.org#26106,"JATINEGARA, CAKUNG, JAKARTA TIMUR, DKI JAKARTA",277,89,72,161
https://kawalpemilu.org#26106,"JATINEGARA, CAKUNG, JAKARTA TIMUR, DKI JAKARTA",278,73,90,163
https://kawalpemilu.org#26107,"RAWA TERATE, CAKUNG, JAKARTA TIMUR, DKI JAKARTA",1,58,80,138
https://kawalpemilu.org#26107,"RAWA TERATE, CAKUNG, JAKARTA TIMUR, DKI JAKARTA",2,73,109,182
https://kawalpemilu.org#26107,"RAWA TERATE, CAKUNG, JAKARTA TIMUR, DKI JAKARTA",3,76,109,185
https://kawalpemilu.org#26107,"RAWA TERATE, CAKUNG, JAKARTA TIMUR, DKI JAKARTA",4,70,124,194
https://kawalpemilu.org#26107,"RAWA TERATE, CAKUNG, JAKARTA TIMUR, DKI JAKARTA",5,92,140,232
https://kawalpemilu.org#26107,"RAWA TERATE, CAKUNG, JAKARTA TIMUR, DKI JAKARTA",6,116,107,223
https://kawalpemilu.org#26107,"RAWA TERATE, CAKUNG, JAKARTA TIMUR, DKI JAKARTA",7,95,102,197
https://kawalpemilu.org#26107,"RAWA TERATE, CAKUNG, JAKARTA TIMUR, DKI JAKARTA",8,124,109,233
https://kawalpemilu.org#26107,"RAWA TERATE, CAKUNG, JAKARTA TIMUR, DKI JAKARTA",9,108,126,234
https://kawalpemilu.org#26107,"RAWA TERATE, CAKUNG, JAKARTA TIMUR, DKI JAKARTA",10,86,134,220
https://kawalpemilu.org#26107,"RAWA TERATE, CAKUNG, JAKARTA TIMUR, DKI JAKARTA",11,115,116,231
https://kawalpemilu.org#26107,"RAWA TERATE, CAKUNG, JAKARTA TIMUR, DKI JAKARTA",12,118,117,235
https://kawalpemilu.org#26107,"RAWA TERATE, CAKUNG, JAKARTA TIMUR, DKI JAKARTA",13,90,88,178
https://kawalpemilu.org#26107,"RAWA TERATE, CAKUNG, JAKARTA TIMUR, DKI JAKARTA",14,125,74,199
https://kawalpemilu.org#26107,"RAWA TERATE, CAKUNG, JAKARTA TIMUR, DKI JAKARTA",15,66,114,180
https://kawalpemilu.org#26107,"RAWA TERATE, CAKUNG, JAKARTA TIMUR, DKI JAKARTA",16,71,96,167
https://kawalpemilu.org#26107,"RAWA TERATE, CAKUNG, JAKARTA TIMUR, DKI JAKARTA",17,81,84,165
https://kawalpemilu.org#26107,"RAWA TERATE, CAKUNG, JAKARTA TIMUR, DKI JAKARTA",18,98,118,216
https://kawalpemilu.org#26107,"RAWA TERATE, CAKUNG, JAKARTA TIMUR, DKI JAKARTA",19,124,92,216
https://kawalpemilu.org#26107,"RAWA TERATE, CAKUNG, JAKARTA TIMUR, DKI JAKARTA",20,124,102,226
https://kawalpemilu.org#26107,"RAWA TERATE, CAKUNG, JAKARTA TIMUR, DKI JAKARTA",21,106,132,238
https://kawalpemilu.org#26107,"RAWA TERATE, CAKUNG, JAKARTA TIMUR, DKI JAKARTA",22,120,92,212
https://kawalpemilu.org#26107,"RAWA TERATE, CAKUNG, JAKARTA TIMUR, DKI JAKARTA",23,97,83,180
https://kawalpemilu.org#26107,"RAWA TERATE, CAKUNG, JAKARTA TIMUR, DKI JAKARTA",24,135,83,218
https://kawalpemilu.org#26107,"RAWA TERATE, CAKUNG, JAKARTA TIMUR, DKI JAKARTA",25,121,71,192
https://kawalpemilu.org#26107,"RAWA TERATE, CAKUNG, JAKARTA TIMUR, DKI JAKARTA",26,75,152,227
https://kawalpemilu.org#26107,"RAWA TERATE, CAKUNG, JAKARTA TIMUR, DKI JAKARTA",27,71,121,192
https://kawalpemilu.org#26107,"RAWA TERATE, CAKUNG, JAKARTA TIMUR, DKI JAKARTA",28,75,113,188
https://kawalpemilu.org#26107,"RAWA TERATE, CAKUNG, JAKARTA TIMUR, DKI JAKARTA",29,122,115,237
https://kawalpemilu.org#26107,"RAWA TERATE, CAKUNG, JAKARTA TIMUR, DKI JAKARTA",30,113,83,196
https://kawalpemilu.org#26107,"RAWA TERATE, CAKUNG, JAKARTA TIMUR, DKI JAKARTA",31,61,92,153
https://kawalpemilu.org#26107,"RAWA TERATE, CAKUNG, JAKARTA TIMUR, DKI JAKARTA",32,59,117,176
https://kawalpemilu.org#26107,"RAWA TERATE, CAKUNG, JAKARTA TIMUR, DKI JAKARTA",33,71,75,146
https://kawalpemilu.org#26107,"RAWA TERATE, CAKUNG, JAKARTA TIMUR, DKI JAKARTA",34,83,118,201
https://kawalpemilu.org#26107,"RAWA TERATE, CAKUNG, JAKARTA TIMUR, DKI JAKARTA",36,105,130,235
https://kawalpemilu.org#26107,"RAWA TERATE, CAKUNG, JAKARTA TIMUR, DKI JAKARTA",37,69,144,213
https://kawalpemilu.org#26107,"RAWA TERATE, CAKUNG, JAKARTA TIMUR, DKI JAKARTA",38,90,126,216
https://kawalpemilu.org#26107,"RAWA TERATE, CAKUNG, JAKARTA TIMUR, DKI JAKARTA",39,77,149,226
https://kawalpemilu.org#26107,"RAWA TERATE, CAKUNG, JAKARTA TIMUR, DKI JAKARTA",40,81,161,242
https://kawalpemilu.org#26107,"RAWA TERATE, CAKUNG, JAKARTA TIMUR, DKI JAKARTA",41,90,119,209
https://kawalpemilu.org#26107,"RAWA TERATE, CAKUNG, JAKARTA TIMUR, DKI JAKARTA",42,110,130,240
https://kawalpemilu.org#26107,"RAWA TERATE, CAKUNG, JAKARTA TIMUR, DKI JAKARTA",43,61,95,156
https://kawalpemilu.org#26107,"RAWA TERATE, CAKUNG, JAKARTA TIMUR, DKI JAKARTA",44,48,119,167
https://kawalpemilu.org#26107,"RAWA TERATE, CAKUNG, JAKARTA TIMUR, DKI JAKARTA",45,68,101,169
https://kawalpemilu.org#26107,"RAWA TERATE, CAKUNG, JAKARTA TIMUR, DKI JAKARTA",46,82,150,232
https://kawalpemilu.org#26107,"RAWA TERATE, CAKUNG, JAKARTA TIMUR, DKI JAKARTA",47,65,111,176
https://kawalpemilu.org#26107,"RAWA TERATE, CAKUNG, JAKARTA TIMUR, DKI JAKARTA",48,93,132,225
https://kawalpemilu.org#26107,"RAWA TERATE, CAKUNG, JAKARTA TIMUR, DKI JAKARTA",49,147,61,208
https://kawalpemilu.org#26107,"RAWA TERATE, CAKUNG, JAKARTA TIMUR, DKI JAKARTA",50,145,51,196
https://kawalpemilu.org#26107,"RAWA TERATE, CAKUNG, JAKARTA TIMUR, DKI JAKARTA",51,116,55,171
https://kawalpemilu.org#26107,"RAWA TERATE, CAKUNG, JAKARTA TIMUR, DKI JAKARTA",52,87,58,145
https://kawalpemilu.org#26107,"RAWA TERATE, CAKUNG, JAKARTA TIMUR, DKI JAKARTA",53,80,70,150
https://kawalpemilu.org#26107,"RAWA TERATE, CAKUNG, JAKARTA TIMUR, DKI JAKARTA",54,54,144,198
https://kawalpemilu.org#26107,"RAWA TERATE, CAKUNG, JAKARTA TIMUR, DKI JAKARTA",55,74,186,260
https://kawalpemilu.org#26107,"RAWA TERATE, CAKUNG, JAKARTA TIMUR, DKI JAKARTA",56,53,138,191
https://kawalpemilu.org#26107,"RAWA TERATE, CAKUNG, JAKARTA TIMUR, DKI JAKARTA",57,69,120,189
https://kawalpemilu.org#26107,"RAWA TERATE, CAKUNG, JAKARTA TIMUR, DKI JAKARTA",58,58,131,189
https://kawalpemilu.org#26107,"RAWA TERATE, CAKUNG, JAKARTA TIMUR, DKI JAKARTA",59,44,121,165
https://kawalpemilu.org#26107,"RAWA TERATE, CAKUNG, JAKARTA TIMUR, DKI JAKARTA",60,49,95,141
https://kawalpemilu.org#26107,"RAWA TERATE, CAKUNG, JAKARTA TIMUR, DKI JAKARTA",61,64,163,227
https://kawalpemilu.org#26107,"RAWA TERATE, CAKUNG, JAKARTA TIMUR, DKI JAKARTA",62,56,135,191
https://kawalpemilu.org#26107,"RAWA TERATE, CAKUNG, JAKARTA TIMUR, DKI JAKARTA",63,114,74,188
https://kawalpemilu.org#26107,"RAWA TERATE, CAKUNG, JAKARTA TIMUR, DKI JAKARTA",64,114,80,194
https://kawalpemilu.org#26107,"RAWA TERATE, CAKUNG, JAKARTA TIMUR, DKI JAKARTA",65,103,78,181
https://kawalpemilu.org#26107,"RAWA TERATE, CAKUNG, JAKARTA TIMUR, DKI JAKARTA",66,57,123,180
https://kawalpemilu.org#26107,"RAWA TERATE, CAKUNG, JAKARTA TIMUR, DKI JAKARTA",67,28,204,232
https://kawalpemilu.org#26107,"RAWA TERATE, CAKUNG, JAKARTA TIMUR, DKI JAKARTA",68,57,162,219
https://kawalpemilu.org#26107,"RAWA TERATE, CAKUNG, JAKARTA TIMUR, DKI JAKARTA",69,94,104,198
https://kawalpemilu.org#26107,"RAWA TERATE, CAKUNG, JAKARTA TIMUR, DKI JAKARTA",70,103,91,194
https://kawalpemilu.org#26107,"RAWA TERATE, CAKUNG, JAKARTA TIMUR, DKI JAKARTA",71,63,87,150
https://kawalpemilu.org#26107,"RAWA TERATE, CAKUNG, JAKARTA TIMUR, DKI JAKARTA",72,53,77,130
https://kawalpemilu.org#26107,"RAWA TERATE, CAKUNG, JAKARTA TIMUR, DKI JAKARTA",73,92,146,238
https://kawalpemilu.org#26107,"RAWA TERATE, CAKUNG, JAKARTA TIMUR, DKI JAKARTA",74,102,93,195
https://kawalpemilu.org#26107,"RAWA TERATE, CAKUNG, JAKARTA TIMUR, DKI JAKARTA",75,89,85,174
https://kawalpemilu.org#26107,"RAWA TERATE, CAKUNG, JAKARTA TIMUR, DKI JAKARTA",76,72,131,203
https://kawalpemilu.org#26107,"RAWA TERATE, CAKUNG, JAKARTA TIMUR, DKI JAKARTA",77,99,128,227
https://kawalpemilu.org#26107,"RAWA TERATE, CAKUNG, JAKARTA TIMUR, DKI JAKARTA",78,112,99,211
https://kawalpemilu.org#26107,"RAWA TERATE, CAKUNG, JAKARTA TIMUR, DKI JAKARTA",79,64,156,220
https://kawalpemilu.org#26107,"RAWA TERATE, CAKUNG, JAKARTA TIMUR, DKI JAKARTA",80,46,135,181
https://kawalpemilu.org#26107,"RAWA TERATE, CAKUNG, JAKARTA TIMUR, DKI JAKARTA",81,60,158,218
https://kawalpemilu.org#26107,"RAWA TERATE, CAKUNG, JAKARTA TIMUR, DKI JAKARTA",82,55,130,185
https://kawalpemilu.org#26107,"RAWA TERATE, CAKUNG, JAKARTA TIMUR, DKI JAKARTA",83,110,103,213
https://kawalpemilu.org#26107,"RAWA TERATE, CAKUNG, JAKARTA TIMUR, DKI JAKARTA",84,113,74,187
https://kawalpemilu.org#26107,"RAWA TERATE, CAKUNG, JAKARTA TIMUR, DKI JAKARTA",85,97,83,180
https://kawalpemilu.org#26107,"RAWA TERATE, CAKUNG, JAKARTA TIMUR, DKI JAKARTA",86,83,80,163
https://kawalpemilu.org#26108,"PENGGILINGAN, CAKUNG, JAKARTA TIMUR, DKI JAKARTA",1,105,110,215
https://kawalpemilu.org#26108,"PENGGILINGAN, CAKUNG, JAKARTA TIMUR, DKI JAKARTA",2,87,141,228
https://kawalpemilu.org#26108,"PENGGILINGAN, CAKUNG, JAKARTA TIMUR, DKI JAKARTA",3,81,143,224
https://kawalpemilu.org#26108,"PENGGILINGAN, CAKUNG, JAKARTA TIMUR, DKI JAKARTA",4,78,165,243
https://kawalpemilu.org#26108,"PENGGILINGAN, CAKUNG, JAKARTA TIMUR, DKI JAKARTA",5,121,143,264
https://kawalpemilu.org#26108,"PENGGILINGAN, CAKUNG, JAKARTA TIMUR, DKI JAKARTA",6,110,146,256
https://kawalpemilu.org#26108,"PENGGILINGAN, CAKUNG, JAKARTA TIMUR, DKI JAKARTA",7,110,149,259
https://kawalpemilu.org#26108,"PENGGILINGAN, CAKUNG, JAKARTA TIMUR, DKI JAKARTA",8,110,141,251
https://kawalpemilu.org#26108,"PENGGILINGAN, CAKUNG, JAKARTA TIMUR, DKI JAKARTA",10,66,149,215
https://kawalpemilu.org#26108,"PENGGILINGAN, CAKUNG, JAKARTA TIMUR, DKI JAKARTA",11,87,144,231
https://kawalpemilu.org#26108,"PENGGILINGAN, CAKUNG, JAKARTA TIMUR, DKI JAKARTA",12,70,121,191
https://kawalpemilu.org#26108,"PENGGILINGAN, CAKUNG, JAKARTA TIMUR, DKI JAKARTA",13,78,185,263
https://kawalpemilu.org#26108,"PENGGILINGAN, CAKUNG, JAKARTA TIMUR, DKI JAKARTA",14,98,132,230
https://kawalpemilu.org#26108,"PENGGILINGAN, CAKUNG, JAKARTA TIMUR, DKI JAKARTA",15,81,129,210
https://kawalpemilu.org#26108,"PENGGILINGAN, CAKUNG, JAKARTA TIMUR, DKI JAKARTA",16,89,107,196
https://kawalpemilu.org#26108,"PENGGILINGAN, CAKUNG, JAKARTA TIMUR, DKI JAKARTA",17,80,171,251
https://kawalpemilu.org#26108,"PENGGILINGAN, CAKUNG, JAKARTA TIMUR, DKI JAKARTA",19,102,124,226
https://kawalpemilu.org#26108,"PENGGILINGAN, CAKUNG, JAKARTA TIMUR, DKI JAKARTA",21,119,103,222
https://kawalpemilu.org#26108,"PENGGILINGAN, CAKUNG, JAKARTA TIMUR, DKI JAKARTA",23,93,131,224
https://kawalpemilu.org#26108,"PENGGILINGAN, CAKUNG, JAKARTA TIMUR, DKI JAKARTA",24,117,132,249
https://kawalpemilu.org#26108,"PENGGILINGAN, CAKUNG, JAKARTA TIMUR, DKI JAKARTA",25,122,133,255
https://kawalpemilu.org#26108,"PENGGILINGAN, CAKUNG, JAKARTA TIMUR, DKI JAKARTA",26,82,122,204
https://kawalpemilu.org#26108,"PENGGILINGAN, CAKUNG, JAKARTA TIMUR, DKI JAKARTA",27,101,166,267
https://kawalpemilu.org#26108,"PENGGILINGAN, CAKUNG, JAKARTA TIMUR, DKI JAKARTA",28,79,84,163
https://kawalpemilu.org#26108,"PENGGILINGAN, CAKUNG, JAKARTA TIMUR, DKI JAKARTA",29,93,95,188
https://kawalpemilu.org#26108,"PENGGILINGAN, CAKUNG, JAKARTA TIMUR, DKI JAKARTA",30,111,123,234
https://kawalpemilu.org#26108,"PENGGILINGAN, CAKUNG, JAKARTA TIMUR, DKI JAKARTA",31,86,104,190
https://kawalpemilu.org#26108,"PENGGILINGAN, CAKUNG, JAKARTA TIMUR, DKI JAKARTA",33,70,125,195
https://kawalpemilu.org#26108,"PENGGILINGAN, CAKUNG, JAKARTA TIMUR, DKI JAKARTA",34,81,125,206
https://kawalpemilu.org#26108,"PENGGILINGAN, CAKUNG, JAKARTA TIMUR, DKI JAKARTA",35,85,128,213
https://kawalpemilu.org#26108,"PENGGILINGAN, CAKUNG, JAKARTA TIMUR, DKI JAKARTA",36,97,111,208
https://kawalpemilu.org#26108,"PENGGILINGAN, CAKUNG, JAKARTA TIMUR, DKI JAKARTA",38,99,105,204
https://kawalpemilu.org#26108,"PENGGILINGAN, CAKUNG, JAKARTA TIMUR, DKI JAKARTA",39,81,132,213
https://kawalpemilu.org#26108,"PENGGILINGAN, CAKUNG, JAKARTA TIMUR, DKI JAKARTA",42,91,109,200
https://kawalpemilu.org#26108,"PENGGILINGAN, CAKUNG, JAKARTA TIMUR, DKI JAKARTA",44,76,106,182
https://kawalpemilu.org#26108,"PENGGILINGAN, CAKUNG, JAKARTA TIMUR, DKI JAKARTA",45,94,106,200
https://kawalpemilu.org#26108,"PENGGILINGAN, CAKUNG, JAKARTA TIMUR, DKI JAKARTA",46,96,124,220
https://kawalpemilu.org#26108,"PENGGILINGAN, CAKUNG, JAKARTA TIMUR, DKI JAKARTA",47,96,133,229
https://kawalpemilu.org#26108,"PENGGILINGAN, CAKUNG, JAKARTA TIMUR, DKI JAKARTA",48,65,118,183
https://kawalpemilu.org#26108,"PENGGILINGAN, CAKUNG, JAKARTA TIMUR, DKI JAKARTA",49,114,118,232
https://kawalpemilu.org#26108,"PENGGILINGAN, CAKUNG, JAKARTA TIMUR, DKI JAKARTA",51,84,146,230
https://kawalpemilu.org#26108,"PENGGILINGAN, CAKUNG, JAKARTA TIMUR, DKI JAKARTA",52,87,118,205
https://kawalpemilu.org#26108,"PENGGILINGAN, CAKUNG, JAKARTA TIMUR, DKI JAKARTA",53,100,106,206
https://kawalpemilu.org#26108,"PENGGILINGAN, CAKUNG, JAKARTA TIMUR, DKI JAKARTA",54,121,95,216
https://kawalpemilu.org#26108,"PENGGILINGAN, CAKUNG, JAKARTA TIMUR, DKI JAKARTA",55,81,117,198
https://kawalpemilu.org#26108,"PENGGILINGAN, CAKUNG, JAKARTA TIMUR, DKI JAKARTA",56,102,91,193
https://kawalpemilu.org#26108,"PENGGILINGAN, CAKUNG, JAKARTA TIMUR, DKI JAKARTA",59,98,134,232
https://kawalpemilu.org#26108,"PENGGILINGAN, CAKUNG, JAKARTA TIMUR, DKI JAKARTA",60,117,130,247
https://kawalpemilu.org#26108,"PENGGILINGAN, CAKUNG, JAKARTA TIMUR, DKI JAKARTA",61,76,112,188
https://kawalpemilu.org#26108,"PENGGILINGAN, CAKUNG, JAKARTA TIMUR, DKI JAKARTA",62,107,157,264
https://kawalpemilu.org#26108,"PENGGILINGAN, CAKUNG, JAKARTA TIMUR, DKI JAKARTA",63,57,122,179
https://kawalpemilu.org#26108,"PENGGILINGAN, CAKUNG, JAKARTA TIMUR, DKI JAKARTA",64,59,102,161
https://kawalpemilu.org#26108,"PENGGILINGAN, CAKUNG, JAKARTA TIMUR, DKI JAKARTA",65,103,112,215
https://kawalpemilu.org#26108,"PENGGILINGAN, CAKUNG, JAKARTA TIMUR, DKI JAKARTA",66,112,118,230
https://kawalpemilu.org#26108,"PENGGILINGAN, CAKUNG, JAKARTA TIMUR, DKI JAKARTA",67,86,145,231
https://kawalpemilu.org#26108,"PENGGILINGAN, CAKUNG, JAKARTA TIMUR, DKI JAKARTA",69,71,84,155
https://kawalpemilu.org#26108,"PENGGILINGAN, CAKUNG, JAKARTA TIMUR, DKI JAKARTA",71,86,146,232
https://kawalpemilu.org#26108,"PENGGILINGAN, CAKUNG, JAKARTA TIMUR, DKI JAKARTA",72,97,127,224
https://kawalpemilu.org#26108,"PENGGILINGAN, CAKUNG, JAKARTA TIMUR, DKI JAKARTA",73,82,153,235
https://kawalpemilu.org#26108,"PENGGILINGAN, CAKUNG, JAKARTA TIMUR, DKI JAKARTA",74,81,119,200
https://kawalpemilu.org#26108,"PENGGILINGAN, CAKUNG, JAKARTA TIMUR, DKI JAKARTA",75,88,126,214
https://kawalpemilu.org#26108,"PENGGILINGAN, CAKUNG, JAKARTA TIMUR, DKI JAKARTA",76,86,157,243
https://kawalpemilu.org#26108,"PENGGILINGAN, CAKUNG, JAKARTA TIMUR, DKI JAKARTA",77,71,99,170
https://kawalpemilu.org#26108,"PENGGILINGAN, CAKUNG, JAKARTA TIMUR, DKI JAKARTA",78,70,110,180
https://kawalpemilu.org#26108,"PENGGILINGAN, CAKUNG, JAKARTA TIMUR, DKI JAKARTA",80,121,86,207
https://kawalpemilu.org#26108,"PENGGILINGAN, CAKUNG, JAKARTA TIMUR, DKI JAKARTA",81,160,90,250
https://kawalpemilu.org#26108,"PENGGILINGAN, CAKUNG, JAKARTA TIMUR, DKI JAKARTA",83,96,155,251
https://kawalpemilu.org#26108,"PENGGILINGAN, CAKUNG, JAKARTA TIMUR, DKI JAKARTA",84,117,111,228
https://kawalpemilu.org#26108,"PENGGILINGAN, CAKUNG, JAKARTA TIMUR, DKI JAKARTA",85,107,128,235
https://kawalpemilu.org#26108,"PENGGILINGAN, CAKUNG, JAKARTA TIMUR, DKI JAKARTA",86,86,138,224
https://kawalpemilu.org#26108,"PENGGILINGAN, CAKUNG, JAKARTA TIMUR, DKI JAKARTA",87,93,131,224
https://kawalpemilu.org#26108,"PENGGILINGAN, CAKUNG, JAKARTA TIMUR, DKI JAKARTA",88,94,140,234
https://kawalpemilu.org#26108,"PENGGILINGAN, CAKUNG, JAKARTA TIMUR, DKI JAKARTA",89,0,0,0
https://kawalpemilu.org#26108,"PENGGILINGAN, CAKUNG, JAKARTA TIMUR, DKI JAKARTA",90,140,113,253
https://kawalpemilu.org#26108,"PENGGILINGAN, CAKUNG, JAKARTA TIMUR, DKI JAKARTA",91,95,134,229
https://kawalpemilu.org#26108,"PENGGILINGAN, CAKUNG, JAKARTA TIMUR, DKI JAKARTA",92,118,122,240
https://kawalpemilu.org#26108,"PENGGILINGAN, CAKUNG, JAKARTA TIMUR, DKI JAKARTA",93,85,110,195
https://kawalpemilu.org#26108,"PENGGILINGAN, CAKUNG, JAKARTA TIMUR, DKI JAKARTA",94,95,116,211
https://kawalpemilu.org#26108,"PENGGILINGAN, CAKUNG, JAKARTA TIMUR, DKI JAKARTA",96,93,123,216
https://kawalpemilu.org#26108,"PENGGILINGAN, CAKUNG, JAKARTA TIMUR, DKI JAKARTA",97,127,113,240
https://kawalpemilu.org#26108,"PENGGILINGAN, CAKUNG, JAKARTA TIMUR, DKI JAKARTA",98,108,136,244
https://kawalpemilu.org#26108,"PENGGILINGAN, CAKUNG, JAKARTA TIMUR, DKI JAKARTA",99,117,99,216
https://kawalpemilu.org#26108,"PENGGILINGAN, CAKUNG, JAKARTA TIMUR, DKI JAKARTA",100,81,99,180
https://kawalpemilu.org#26108,"PENGGILINGAN, CAKUNG, JAKARTA TIMUR, DKI JAKARTA",101,114,115,229
https://kawalpemilu.org#26108,"PENGGILINGAN, CAKUNG, JAKARTA TIMUR, DKI JAKARTA",102,109,115,224
https://kawalpemilu.org#26108,"PENGGILINGAN, CAKUNG, JAKARTA TIMUR, DKI JAKARTA",103,110,120,230
https://kawalpemilu.org#26108,"PENGGILINGAN, CAKUNG, JAKARTA TIMUR, DKI JAKARTA",104,103,119,222
https://kawalpemilu.org#26108,"PENGGILINGAN, CAKUNG, JAKARTA TIMUR, DKI JAKARTA",105,110,125,235
https://kawalpemilu.org#26108,"PENGGILINGAN, CAKUNG, JAKARTA TIMUR, DKI JAKARTA",107,93,136,229
https://kawalpemilu.org#26108,"PENGGILINGAN, CAKUNG, JAKARTA TIMUR, DKI JAKARTA",108,81,149,230
https://kawalpemilu.org#26108,"PENGGILINGAN, CAKUNG, JAKARTA TIMUR, DKI JAKARTA",109,102,128,230
https://kawalpemilu.org#26108,"PENGGILINGAN, CAKUNG, JAKARTA TIMUR, DKI JAKARTA",110,106,143,249
https://kawalpemilu.org#26108,"PENGGILINGAN, CAKUNG, JAKARTA TIMUR, DKI JAKARTA",111,87,128,215
https://kawalpemilu.org#26108,"PENGGILINGAN, CAKUNG, JAKARTA TIMUR, DKI JAKARTA",112,112,107,219
https://kawalpemilu.org#26108,"PENGGILINGAN, CAKUNG, JAKARTA TIMUR, DKI JAKARTA",113,85,144,229
https://kawalpemilu.org#26108,"PENGGILINGAN, CAKUNG, JAKARTA TIMUR, DKI JAKARTA",114,131,140,271
https://kawalpemilu.org#26108,"PENGGILINGAN, CAKUNG, JAKARTA TIMUR, DKI JAKARTA",115,103,139,242
https://kawalpemilu.org#26108,"PENGGILINGAN, CAKUNG, JAKARTA TIMUR, DKI JAKARTA",116,99,107,206
https://kawalpemilu.org#26108,"PENGGILINGAN, CAKUNG, JAKARTA TIMUR, DKI JAKARTA",117,103,124,227
https://kawalpemilu.org#26108,"PENGGILINGAN, CAKUNG, JAKARTA TIMUR, DKI JAKARTA",118,84,137,221
https://kawalpemilu.org#26108,"PENGGILINGAN, CAKUNG, JAKARTA TIMUR, DKI JAKARTA",120,65,124,189
https://kawalpemilu.org#26108,"PENGGILINGAN, CAKUNG, JAKARTA TIMUR, DKI JAKARTA",121,39,141,180
https://kawalpemilu.org#26108,"PENGGILINGAN, CAKUNG, JAKARTA TIMUR, DKI JAKARTA",123,79,112,191
https://kawalpemilu.org#26108,"PENGGILINGAN, CAKUNG, JAKARTA TIMUR, DKI JAKARTA",124,88,116,204
https://kawalpemilu.org#26108,"PENGGILINGAN, CAKUNG, JAKARTA TIMUR, DKI JAKARTA",125,112,96,208
https://kawalpemilu.org#26108,"PENGGILINGAN, CAKUNG, JAKARTA TIMUR, DKI JAKARTA",126,128,139,267
https://kawalpemilu.org#26108,"PENGGILINGAN, CAKUNG, JAKARTA TIMUR, DKI JAKARTA",127,107,118,225
https://kawalpemilu.org#26108,"PENGGILINGAN, CAKUNG, JAKARTA TIMUR, DKI JAKARTA",128,79,159,238
https://kawalpemilu.org#26108,"PENGGILINGAN, CAKUNG, JAKARTA TIMUR, DKI JAKARTA",129,65,152,217
https://kawalpemilu.org#26108,"PENGGILINGAN, CAKUNG, JAKARTA TIMUR, DKI JAKARTA",130,83,125,208
https://kawalpemilu.org#26108,"PENGGILINGAN, CAKUNG, JAKARTA TIMUR, DKI JAKARTA",132,67,89,156
https://kawalpemilu.org#26108,"PENGGILINGAN, CAKUNG, JAKARTA TIMUR, DKI JAKARTA",133,64,129,193
https://kawalpemilu.org#26108,"PENGGILINGAN, CAKUNG, JAKARTA TIMUR, DKI JAKARTA",135,103,85,188
https://kawalpemilu.org#26108,"PENGGILINGAN, CAKUNG, JAKARTA TIMUR, DKI JAKARTA",136,104,109,213
https://kawalpemilu.org#26108,"PENGGILINGAN, CAKUNG, JAKARTA TIMUR, DKI JAKARTA",137,102,130,232
https://kawalpemilu.org#26108,"PENGGILINGAN, CAKUNG, JAKARTA TIMUR, DKI JAKARTA",139,101,68,169
https://kawalpemilu.org#26108,"PENGGILINGAN, CAKUNG, JAKARTA TIMUR, DKI JAKARTA",140,88,109,197
https://kawalpemilu.org#26108,"PENGGILINGAN, CAKUNG, JAKARTA TIMUR, DKI JAKARTA",141,72,102,174
https://kawalpemilu.org#26108,"PENGGILINGAN, CAKUNG, JAKARTA TIMUR, DKI JAKARTA",143,84,135,219
https://kawalpemilu.org#26108,"PENGGILINGAN, CAKUNG, JAKARTA TIMUR, DKI JAKARTA",144,94,125,219
https://kawalpemilu.org#26108,"PENGGILINGAN, CAKUNG, JAKARTA TIMUR, DKI JAKARTA",145,76,133,209
https://kawalpemilu.org#26108,"PENGGILINGAN, CAKUNG, JAKARTA TIMUR, DKI JAKARTA",146,69,149,258
https://kawalpemilu.org#26108,"PENGGILINGAN, CAKUNG, JAKARTA TIMUR, DKI JAKARTA",147,74,115,189
https://kawalpemilu.org#26108,"PENGGILINGAN, CAKUNG, JAKARTA TIMUR, DKI JAKARTA",149,98,153,251
https://kawalpemilu.org#26108,"PENGGILINGAN, CAKUNG, JAKARTA TIMUR, DKI JAKARTA",151,130,137,267
https://kawalpemilu.org#26108,"PENGGILINGAN, CAKUNG, JAKARTA TIMUR, DKI JAKARTA",152,81,129,210
https://kawalpemilu.org#26108,"PENGGILINGAN, CAKUNG, JAKARTA TIMUR, DKI JAKARTA",153,105,134,239
https://kawalpemilu.org#26108,"PENGGILINGAN, CAKUNG, JAKARTA TIMUR, DKI JAKARTA",154,60,156,216
https://kawalpemilu.org#26108,"PENGGILINGAN, CAKUNG, JAKARTA TIMUR, DKI JAKARTA",155,78,124,202
https://kawalpemilu.org#26108,"PENGGILINGAN, CAKUNG, JAKARTA TIMUR, DKI JAKARTA",156,59,197,256
https://kawalpemilu.org#26108,"PENGGILINGAN, CAKUNG, JAKARTA TIMUR, DKI JAKARTA",157,79,120,199
https://kawalpemilu.org#26108,"PENGGILINGAN, CAKUNG, JAKARTA TIMUR, DKI JAKARTA",160,74,173,247
https://kawalpemilu.org#26108,"PENGGILINGAN, CAKUNG, JAKARTA TIMUR, DKI JAKARTA",161,82,134,216
https://kawalpemilu.org#26108,"PENGGILINGAN, CAKUNG, JAKARTA TIMUR, DKI JAKARTA",162,76,128,204
https://kawalpemilu.org#26108,"PENGGILINGAN, CAKUNG, JAKARTA TIMUR, DKI JAKARTA",163,92,155,247
https://kawalpemilu.org#26108,"PENGGILINGAN, CAKUNG, JAKARTA TIMUR, DKI JAKARTA",164,91,149,240
https://kawalpemilu.org#26108,"PENGGILINGAN, CAKUNG, JAKARTA TIMUR, DKI JAKARTA",165,93,99,192
https://kawalpemilu.org#26108,"PENGGILINGAN, CAKUNG, JAKARTA TIMUR, DKI JAKARTA",166,77,154,231
https://kawalpemilu.org#26108,"PENGGILINGAN, CAKUNG, JAKARTA TIMUR, DKI JAKARTA",167,85,105,190
https://kawalpemilu.org#26108,"PENGGILINGAN, CAKUNG, JAKARTA TIMUR, DKI JAKARTA",168,54,93,147
https://kawalpemilu.org#26108,"PENGGILINGAN, CAKUNG, JAKARTA TIMUR, DKI JAKARTA",169,64,173,237
https://kawalpemilu.org#26108,"PENGGILINGAN, CAKUNG, JAKARTA TIMUR, DKI JAKARTA",171,104,124,228
https://kawalpemilu.org#26108,"PENGGILINGAN, CAKUNG, JAKARTA TIMUR, DKI JAKARTA",176,50,132,182
https://kawalpemilu.org#26108,"PENGGILINGAN, CAKUNG, JAKARTA TIMUR, DKI JAKARTA",179,66,108,174
https://kawalpemilu.org#26108,"PENGGILINGAN, CAKUNG, JAKARTA TIMUR, DKI JAKARTA",180,70,117,187
https://kawalpemilu.org#26108,"PENGGILINGAN, CAKUNG, JAKARTA TIMUR, DKI JAKARTA",182,128,134,262
https://kawalpemilu.org#26108,"PENGGILINGAN, CAKUNG, JAKARTA TIMUR, DKI JAKARTA",183,101,131,232
https://kawalpemilu.org#26108,"PENGGILINGAN, CAKUNG, JAKARTA TIMUR, DKI JAKARTA",184,124,109,233
https://kawalpemilu.org#26108,"PENGGILINGAN, CAKUNG, JAKARTA TIMUR, DKI JAKARTA",185,136,115,251
https://kawalpemilu.org#26108,"PENGGILINGAN, CAKUNG, JAKARTA TIMUR, DKI JAKARTA",186,141,112,253
https://kawalpemilu.org#26108,"PENGGILINGAN, CAKUNG, JAKARTA TIMUR, DKI JAKARTA",187,144,112,256
https://kawalpemilu.org#26108,"PENGGILINGAN, CAKUNG, JAKARTA TIMUR, DKI JAKARTA",188,130,117,247
https://kawalpemilu.org#26108,"PENGGILINGAN, CAKUNG, JAKARTA TIMUR, DKI JAKARTA",189,73,120,193
https://kawalpemilu.org#26108,"PENGGILINGAN, CAKUNG, JAKARTA TIMUR, DKI JAKARTA",190,123,136,259
https://kawalpemilu.org#26108,"PENGGILINGAN, CAKUNG, JAKARTA TIMUR, DKI JAKARTA",191,88,98,186
https://kawalpemilu.org#26108,"PENGGILINGAN, CAKUNG, JAKARTA TIMUR, DKI JAKARTA",192,184,71,255
https://kawalpemilu.org#26108,"PENGGILINGAN, CAKUNG, JAKARTA TIMUR, DKI JAKARTA",194,28,202,230
https://kawalpemilu.org#26108,"PENGGILINGAN, CAKUNG, JAKARTA TIMUR, DKI JAKARTA",195,71,167,238
https://kawalpemilu.org#26108,"PENGGILINGAN, CAKUNG, JAKARTA TIMUR, DKI JAKARTA",196,74,178,252
https://kawalpemilu.org#26108,"PENGGILINGAN, CAKUNG, JAKARTA TIMUR, DKI JAKARTA",197,140,97,237
https://kawalpemilu.org#26108,"PENGGILINGAN, CAKUNG, JAKARTA TIMUR, DKI JAKARTA",198,103,125,228
https://kawalpemilu.org#26108,"PENGGILINGAN, CAKUNG, JAKARTA TIMUR, DKI JAKARTA",199,70,96,166
https://kawalpemilu.org#26108,"PENGGILINGAN, CAKUNG, JAKARTA TIMUR, DKI JAKARTA",200,106,146,252
https://kawalpemilu.org#26108,"PENGGILINGAN, CAKUNG, JAKARTA TIMUR, DKI JAKARTA",201,83,113,196
https://kawalpemilu.org#26108,"PENGGILINGAN, CAKUNG, JAKARTA TIMUR, DKI JAKARTA",202,77,133,210
https://kawalpemilu.org#26108,"PENGGILINGAN, CAKUNG, JAKARTA TIMUR, DKI JAKARTA",203,79,164,243
https://kawalpemilu.org#26108,"PENGGILINGAN, CAKUNG, JAKARTA TIMUR, DKI JAKARTA",204,74,152,226
https://kawalpemilu.org#26108,"PENGGILINGAN, CAKUNG, JAKARTA TIMUR, DKI JAKARTA",205,79,143,222
https://kawalpemilu.org#26108,"PENGGILINGAN, CAKUNG, JAKARTA TIMUR, DKI JAKARTA",206,101,113,214
https://kawalpemilu.org#26108,"PENGGILINGAN, CAKUNG, JAKARTA TIMUR, DKI JAKARTA",207,80,151,231
https://kawalpemilu.org#26108,"PENGGILINGAN, CAKUNG, JAKARTA TIMUR, DKI JAKARTA",208,95,146,241
https://kawalpemilu.org#26108,"PENGGILINGAN, CAKUNG, JAKARTA TIMUR, DKI JAKARTA",209,97,93,190
https://kawalpemilu.org#26108,"PENGGILINGAN, CAKUNG, JAKARTA TIMUR, DKI JAKARTA",210,72,145,217
https://kawalpemilu.org#26108,"PENGGILINGAN, CAKUNG, JAKARTA TIMUR, DKI JAKARTA",211,84,143,227
https://kawalpemilu.org#26108,"PENGGILINGAN, CAKUNG, JAKARTA TIMUR, DKI JAKARTA",212,61,120,181
https://kawalpemilu.org#26108,"PENGGILINGAN, CAKUNG, JAKARTA TIMUR, DKI JAKARTA",213,76,111,187
https://kawalpemilu.org#26108,"PENGGILINGAN, CAKUNG, JAKARTA TIMUR, DKI JAKARTA",214,83,113,196
https://kawalpemilu.org#26108,"PENGGILINGAN, CAKUNG, JAKARTA TIMUR, DKI JAKARTA",215,89,126,215
https://kawalpemilu.org#26108,"PENGGILINGAN, CAKUNG, JAKARTA TIMUR, DKI JAKARTA",216,68,140,208
https://kawalpemilu.org#26108,"PENGGILINGAN, CAKUNG, JAKARTA TIMUR, DKI JAKARTA",217,76,105,181
https://kawalpemilu.org#26108,"PENGGILINGAN, CAKUNG, JAKARTA TIMUR, DKI JAKARTA",218,108,120,228
https://kawalpemilu.org#26108,"PENGGILINGAN, CAKUNG, JAKARTA TIMUR, DKI JAKARTA",219,89,146,235
https://kawalpemilu.org#26108,"PENGGILINGAN, CAKUNG, JAKARTA TIMUR, DKI JAKARTA",220,96,150,246
https://kawalpemilu.org#26108,"PENGGILINGAN, CAKUNG, JAKARTA TIMUR, DKI JAKARTA",221,84,123,207
https://kawalpemilu.org#26108,"PENGGILINGAN, CAKUNG, JAKARTA TIMUR, DKI JAKARTA",222,72,134,206
https://kawalpemilu.org#26108,"PENGGILINGAN, CAKUNG, JAKARTA TIMUR, DKI JAKARTA",223,95,84,179
https://kawalpemilu.org#26108,"PENGGILINGAN, CAKUNG, JAKARTA TIMUR, DKI JAKARTA",224,112,98,210
https://kawalpemilu.org#26108,"PENGGILINGAN, CAKUNG, JAKARTA TIMUR, DKI JAKARTA",225,118,102,220
https://kawalpemilu.org#26108,"PENGGILINGAN, CAKUNG, JAKARTA TIMUR, DKI JAKARTA",226,80,175,255
https://kawalpemilu.org#26108,"PENGGILINGAN, CAKUNG, JAKARTA TIMUR, DKI JAKARTA",227,72,134,206
https://kawalpemilu.org#26108,"PENGGILINGAN, CAKUNG, JAKARTA TIMUR, DKI JAKARTA",228,95,151,246
https://kawalpemilu.org#26108,"PENGGILINGAN, CAKUNG, JAKARTA TIMUR, DKI JAKARTA",229,90,109,199
https://kawalpemilu.org#26108,"PENGGILINGAN, CAKUNG, JAKARTA TIMUR, DKI JAKARTA",230,108,117,225
https://kawalpemilu.org#26108,"PENGGILINGAN, CAKUNG, JAKARTA TIMUR, DKI JAKARTA",231,146,95,241
https://kawalpemilu.org#26108,"PENGGILINGAN, CAKUNG, JAKARTA TIMUR, DKI JAKARTA",232,109,89,198
https://kawalpemilu.org#26108,"PENGGILINGAN, CAKUNG, JAKARTA TIMUR, DKI JAKARTA",233,85,116,201
https://kawalpemilu.org#26108,"PENGGILINGAN, CAKUNG, JAKARTA TIMUR, DKI JAKARTA",234,126,90,216
https://kawalpemilu.org#26108,"PENGGILINGAN, CAKUNG, JAKARTA TIMUR, DKI JAKARTA",235,111,126,237
https://kawalpemilu.org#26108,"PENGGILINGAN, CAKUNG, JAKARTA TIMUR, DKI JAKARTA",236,99,99,198
https://kawalpemilu.org#26108,"PENGGILINGAN, CAKUNG, JAKARTA TIMUR, DKI JAKARTA",238,88,160,248
https://kawalpemilu.org#26108,"PENGGILINGAN, CAKUNG, JAKARTA TIMUR, DKI JAKARTA",239,107,100,207
https://kawalpemilu.org#26108,"PENGGILINGAN, CAKUNG, JAKARTA TIMUR, DKI JAKARTA",240,80,95,175
https://kawalpemilu.org#26108,"PENGGILINGAN, CAKUNG, JAKARTA TIMUR, DKI JAKARTA",241,88,134,222
https://kawalpemilu.org#26108,"PENGGILINGAN, CAKUNG, JAKARTA TIMUR, DKI JAKARTA",242,88,141,229
https://kawalpemilu.org#26108,"PENGGILINGAN, CAKUNG, JAKARTA TIMUR, DKI JAKARTA",243,109,90,199
https://kawalpemilu.org#26108,"PENGGILINGAN, CAKUNG, JAKARTA TIMUR, DKI JAKARTA",244,108,92,200
https://kawalpemilu.org#26108,"PENGGILINGAN, CAKUNG, JAKARTA TIMUR, DKI JAKARTA",245,109,132,241
https://kawalpemilu.org#26108,"PENGGILINGAN, CAKUNG, JAKARTA TIMUR, DKI JAKARTA",246,114,131,245
https://kawalpemilu.org#26108,"PENGGILINGAN, CAKUNG, JAKARTA TIMUR, DKI JAKARTA",247,106,131,237
https://kawalpemilu.org#26108,"PENGGILINGAN, CAKUNG, JAKARTA TIMUR, DKI JAKARTA",248,98,177,275
https://kawalpemilu.org#26108,"PENGGILINGAN, CAKUNG, JAKARTA TIMUR, DKI JAKARTA",249,66,160,226
https://kawalpemilu.org#26108,"PENGGILINGAN, CAKUNG, JAKARTA TIMUR, DKI JAKARTA",250,132,100,232
https://kawalpemilu.org#26108,"PENGGILINGAN, CAKUNG, JAKARTA TIMUR, DKI JAKARTA",251,130,106,236
https://kawalpemilu.org#26108,"PENGGILINGAN, CAKUNG, JAKARTA TIMUR, DKI JAKARTA",252,125,70,195
https://kawalpemilu.org#26108,"PENGGILINGAN, CAKUNG, JAKARTA TIMUR, DKI JAKARTA",253,92,101,193
https://kawalpemilu.org#26108,"PENGGILINGAN, CAKUNG, JAKARTA TIMUR, DKI JAKARTA",254,120,79,199
https://kawalpemilu.org#26108,"PENGGILINGAN, CAKUNG, JAKARTA TIMUR, DKI JAKARTA",255,56,121,177
https://kawalpemilu.org#26108,"PENGGILINGAN, CAKUNG, JAKARTA TIMUR, DKI JAKARTA",256,45,139,184
https://kawalpemilu.org#26108,"PENGGILINGAN, CAKUNG, JAKARTA TIMUR, DKI JAKARTA",257,76,174,250
https://kawalpemilu.org#26108,"PENGGILINGAN, CAKUNG, JAKARTA TIMUR, DKI JAKARTA",258,100,154,254
https://kawalpemilu.org#26108,"PENGGILINGAN, CAKUNG, JAKARTA TIMUR, DKI JAKARTA",259,62,128,190
https://kawalpemilu.org#26108,"PENGGILINGAN, CAKUNG, JAKARTA TIMUR, DKI JAKARTA",260,72,115,187
https://kawalpemilu.org#26108,"PENGGILINGAN, CAKUNG, JAKARTA TIMUR, DKI JAKARTA",261,105,159,264
https://kawalpemilu.org#26108,"PENGGILINGAN, CAKUNG, JAKARTA TIMUR, DKI JAKARTA",262,105,152,257
https://kawalpemilu.org#26108,"PENGGILINGAN, CAKUNG, JAKARTA TIMUR, DKI JAKARTA",263,112,152,264
https://kawalpemilu.org#26108,"PENGGILINGAN, CAKUNG, JAKARTA TIMUR, DKI JAKARTA",264,115,138,253
https://kawalpemilu.org#26108,"PENGGILINGAN, CAKUNG, JAKARTA TIMUR, DKI JAKARTA",265,82,156,238
https://kawalpemilu.org#26108,"PENGGILINGAN, CAKUNG, JAKARTA TIMUR, DKI JAKARTA",266,184,83,231
https://kawalpemilu.org#26108,"PENGGILINGAN, CAKUNG, JAKARTA TIMUR, DKI JAKARTA",267,151,44,195
https://kawalpemilu.org#26108,"PENGGILINGAN, CAKUNG, JAKARTA TIMUR, DKI JAKARTA",268,124,88,212
https://kawalpemilu.org#26108,"PENGGILINGAN, CAKUNG, JAKARTA TIMUR, DKI JAKARTA",269,175,63,238
https://kawalpemilu.org#26108,"PENGGILINGAN, CAKUNG, JAKARTA TIMUR, DKI JAKARTA",270,169,64,233
https://kawalpemilu.org#26108,"PENGGILINGAN, CAKUNG, JAKARTA TIMUR, DKI JAKARTA",272,125,113,238
https://kawalpemilu.org#26108,"PENGGILINGAN, CAKUNG, JAKARTA TIMUR, DKI JAKARTA",273,124,94,218
https://kawalpemilu.org#26108,"PENGGILINGAN, CAKUNG, JAKARTA TIMUR, DKI JAKARTA",274,148,85,233
https://kawalpemilu.org#26108,"PENGGILINGAN, CAKUNG, JAKARTA TIMUR, DKI JAKARTA",275,46,30,76
https://kawalpemilu.org#26108,"PENGGILINGAN, CAKUNG, JAKARTA TIMUR, DKI JAKARTA",276,118,55,1
https://kawalpemilu.org#26108,"PENGGILINGAN, CAKUNG, JAKARTA TIMUR, DKI JAKARTA",277,78,95,179
https://kawalpemilu.org#26108,"PENGGILINGAN, CAKUNG, JAKARTA TIMUR, DKI JAKARTA",278,78,95,173
https://kawalpemilu.org#26108,"PENGGILINGAN, CAKUNG, JAKARTA TIMUR, DKI JAKARTA",279,94,108,202
https://kawalpemilu.org#26108,"PENGGILINGAN, CAKUNG, JAKARTA TIMUR, DKI JAKARTA",281,45,132,177
https://kawalpemilu.org#26108,"PENGGILINGAN, CAKUNG, JAKARTA TIMUR, DKI JAKARTA",283,80,107,187
https://kawalpemilu.org#26108,"PENGGILINGAN, CAKUNG, JAKARTA TIMUR, DKI JAKARTA",285,74,96,170
https://kawalpemilu.org#26108,"PENGGILINGAN, CAKUNG, JAKARTA TIMUR, DKI JAKARTA",286,62,144,206
https://kawalpemilu.org#26108,"PENGGILINGAN, CAKUNG, JAKARTA TIMUR, DKI JAKARTA",287,63,123,186
https://kawalpemilu.org#26108,"PENGGILINGAN, CAKUNG, JAKARTA TIMUR, DKI JAKARTA",288,97,101,198
https://kawalpemilu.org#26108,"PENGGILINGAN, CAKUNG, JAKARTA TIMUR, DKI JAKARTA",289,66,68,134
https://kawalpemilu.org#26108,"PENGGILINGAN, CAKUNG, JAKARTA TIMUR, DKI JAKARTA",290,78,81,159
https://kawalpemilu.org#26108,"PENGGILINGAN, CAKUNG, JAKARTA TIMUR, DKI JAKARTA",291,69,97,166
https://kawalpemilu.org#26108,"PENGGILINGAN, CAKUNG, JAKARTA TIMUR, DKI JAKARTA",292,112,103,215
https://kawalpemilu.org#26108,"PENGGILINGAN, CAKUNG, JAKARTA TIMUR, DKI JAKARTA",293,64,110,174
https://kawalpemilu.org#26108,"PENGGILINGAN, CAKUNG, JAKARTA TIMUR, DKI JAKARTA",294,0,0,0
https://kawalpemilu.org#26108,"PENGGILINGAN, CAKUNG, JAKARTA TIMUR, DKI JAKARTA",295,56,120,176
https://kawalpemilu.org#26108,"PENGGILINGAN, CAKUNG, JAKARTA TIMUR, DKI JAKARTA",296,67,106,173
https://kawalpemilu.org#26108,"PENGGILINGAN, CAKUNG, JAKARTA TIMUR, DKI JAKARTA",297,66,136,202
https://kawalpemilu.org#26108,"PENGGILINGAN, CAKUNG, JAKARTA TIMUR, DKI JAKARTA",298,69,97,166
https://kawalpemilu.org#26108,"PENGGILINGAN, CAKUNG, JAKARTA TIMUR, DKI JAKARTA",299,106,128,234
https://kawalpemilu.org#26108,"PENGGILINGAN, CAKUNG, JAKARTA TIMUR, DKI JAKARTA",300,97,113,210
https://kawalpemilu.org#26108,"PENGGILINGAN, CAKUNG, JAKARTA TIMUR, DKI JAKARTA",302,70,99,169
https://kawalpemilu.org#26108,"PENGGILINGAN, CAKUNG, JAKARTA TIMUR, DKI JAKARTA",303,100,118,218
https://kawalpemilu.org#26108,"PENGGILINGAN, CAKUNG, JAKARTA TIMUR, DKI JAKARTA",304,128,133,261
https://kawalpemilu.org#26108,"PENGGILINGAN, CAKUNG, JAKARTA TIMUR, DKI JAKARTA",306,73,106,179
https://kawalpemilu.org#26108,"PENGGILINGAN, CAKUNG, JAKARTA TIMUR, DKI JAKARTA",307,76,111,187
https://kawalpemilu.org#26108,"PENGGILINGAN, CAKUNG, JAKARTA TIMUR, DKI JAKARTA",308,56,74,130
https://kawalpemilu.org#26108,"PENGGILINGAN, CAKUNG, JAKARTA TIMUR, DKI JAKARTA",309,87,102,189
https://kawalpemilu.org#26108,"PENGGILINGAN, CAKUNG, JAKARTA TIMUR, DKI JAKARTA",310,86,85,171
https://kawalpemilu.org#26108,"PENGGILINGAN, CAKUNG, JAKARTA TIMUR, DKI JAKARTA",311,104,108,212
https://kawalpemilu.org#26108,"PENGGILINGAN, CAKUNG, JAKARTA TIMUR, DKI JAKARTA",312,140,53,193
https://kawalpemilu.org#26109,"PULO GEBANG, CAKUNG, JAKARTA TIMUR, DKI JAKARTA",1,103,83,186
https://kawalpemilu.org#26109,"PULO GEBANG, CAKUNG, JAKARTA TIMUR, DKI JAKARTA",2,99,104,203
https://kawalpemilu.org#26109,"PULO GEBANG, CAKUNG, JAKARTA TIMUR, DKI JAKARTA",3,104,112,216
https://kawalpemilu.org#26109,"PULO GEBANG, CAKUNG, JAKARTA TIMUR, DKI JAKARTA",4,112,134,246
https://kawalpemilu.org#26109,"PULO GEBANG, CAKUNG, JAKARTA TIMUR, DKI JAKARTA",5,109,106,215
https://kawalpemilu.org#26109,"PULO GEBANG, CAKUNG, JAKARTA TIMUR, DKI JAKARTA",6,110,146,256
https://kawalpemilu.org#26109,"PULO GEBANG, CAKUNG, JAKARTA TIMUR, DKI JAKARTA",7,129,103,232
https://kawalpemilu.org#26109,"PULO GEBANG, CAKUNG, JAKARTA TIMUR, DKI JAKARTA",8,123,120,243
https://kawalpemilu.org#26109,"PULO GEBANG, CAKUNG, JAKARTA TIMUR, DKI JAKARTA",9,91,137,228
https://kawalpemilu.org#26109,"PULO GEBANG, CAKUNG, JAKARTA TIMUR, DKI JAKARTA",10,107,131,238
https://kawalpemilu.org#26109,"PULO GEBANG, CAKUNG, JAKARTA TIMUR, DKI JAKARTA",11,58,122,180
https://kawalpemilu.org#26109,"PULO GEBANG, CAKUNG, JAKARTA TIMUR, DKI JAKARTA",12,85,103,188
https://kawalpemilu.org#26109,"PULO GEBANG, CAKUNG, JAKARTA TIMUR, DKI JAKARTA",13,88,116,204
https://kawalpemilu.org#26109,"PULO GEBANG, CAKUNG, JAKARTA TIMUR, DKI JAKARTA",14,76,156,232
https://kawalpemilu.org#26109,"PULO GEBANG, CAKUNG, JAKARTA TIMUR, DKI JAKARTA",15,113,136,249
https://kawalpemilu.org#26109,"PULO GEBANG, CAKUNG, JAKARTA TIMUR, DKI JAKARTA",16,106,115,221
https://kawalpemilu.org#26109,"PULO GEBANG, CAKUNG, JAKARTA TIMUR, DKI JAKARTA",17,92,114,206
https://kawalpemilu.org#26109,"PULO GEBANG, CAKUNG, JAKARTA TIMUR, DKI JAKARTA",18,120,113,233
https://kawalpemilu.org#26109,"PULO GEBANG, CAKUNG, JAKARTA TIMUR, DKI JAKARTA",19,116,134,250
https://kawalpemilu.org#26109,"PULO GEBANG, CAKUNG, JAKARTA TIMUR, DKI JAKARTA",20,127,126,253
https://kawalpemilu.org#26109,"PULO GEBANG, CAKUNG, JAKARTA TIMUR, DKI JAKARTA",21,112,129,241
https://kawalpemilu.org#26109,"PULO GEBANG, CAKUNG, JAKARTA TIMUR, DKI JAKARTA",22,71,134,205
https://kawalpemilu.org#26109,"PULO GEBANG, CAKUNG, JAKARTA TIMUR, DKI JAKARTA",23,56,156,212
https://kawalpemilu.org#26109,"PULO GEBANG, CAKUNG, JAKARTA TIMUR, DKI JAKARTA",24,59,135,194
https://kawalpemilu.org#26109,"PULO GEBANG, CAKUNG, JAKARTA TIMUR, DKI JAKARTA",25,80,131,211
https://kawalpemilu.org#26109,"PULO GEBANG, CAKUNG, JAKARTA TIMUR, DKI JAKARTA",26,126,142,268
https://kawalpemilu.org#26109,"PULO GEBANG, CAKUNG, JAKARTA TIMUR, DKI JAKARTA",27,63,144,207
https://kawalpemilu.org#26109,"PULO GEBANG, CAKUNG, JAKARTA TIMUR, DKI JAKARTA",28,91,131,222
https://kawalpemilu.org#26109,"PULO GEBANG, CAKUNG, JAKARTA TIMUR, DKI JAKARTA",29,80,111,191
https://kawalpemilu.org#26109,"PULO GEBANG, CAKUNG, JAKARTA TIMUR, DKI JAKARTA",30,87,132,219
https://kawalpemilu.org#26109,"PULO GEBANG, CAKUNG, JAKARTA TIMUR, DKI JAKARTA",31,61,156,217
https://kawalpemilu.org#26109,"PULO GEBANG, CAKUNG, JAKARTA TIMUR, DKI JAKARTA",32,52,167,219
https://kawalpemilu.org#26109,"PULO GEBANG, CAKUNG, JAKARTA TIMUR, DKI JAKARTA",33,69,126,195
https://kawalpemilu.org#26109,"PULO GEBANG, CAKUNG, JAKARTA TIMUR, DKI JAKARTA",34,136,119,255
https://kawalpemilu.org#26109,"PULO GEBANG, CAKUNG, JAKARTA TIMUR, DKI JAKARTA",35,102,155,257
https://kawalpemilu.org#26109,"PULO GEBANG, CAKUNG, JAKARTA TIMUR, DKI JAKARTA",36,58,135,193
https://kawalpemilu.org#26109,"PULO GEBANG, CAKUNG, JAKARTA TIMUR, DKI JAKARTA",37,77,108,185
https://kawalpemilu.org#26109,"PULO GEBANG, CAKUNG, JAKARTA TIMUR, DKI JAKARTA",38,108,72,180
https://kawalpemilu.org#26109,"PULO GEBANG, CAKUNG, JAKARTA TIMUR, DKI JAKARTA",39,95,79,174
https://kawalpemilu.org#26109,"PULO GEBANG, CAKUNG, JAKARTA TIMUR, DKI JAKARTA",40,90,119,209
https://kawalpemilu.org#26109,"PULO GEBANG, CAKUNG, JAKARTA TIMUR, DKI JAKARTA",41,90,93,183
https://kawalpemilu.org#26109,"PULO GEBANG, CAKUNG, JAKARTA TIMUR, DKI JAKARTA",42,69,122,191
https://kawalpemilu.org#26109,"PULO GEBANG, CAKUNG, JAKARTA TIMUR, DKI JAKARTA",43,90,109,199
https://kawalpemilu.org#26109,"PULO GEBANG, CAKUNG, JAKARTA TIMUR, DKI JAKARTA",44,100,110,210
https://kawalpemilu.org#26109,"PULO GEBANG, CAKUNG, JAKARTA TIMUR, DKI JAKARTA",45,110,137,247
https://kawalpemilu.org#26109,"PULO GEBANG, CAKUNG, JAKARTA TIMUR, DKI JAKARTA",46,77,100,177
https://kawalpemilu.org#26109,"PULO GEBANG, CAKUNG, JAKARTA TIMUR, DKI JAKARTA",47,78,83,161
https://kawalpemilu.org#26109,"PULO GEBANG, CAKUNG, JAKARTA TIMUR, DKI JAKARTA",48,92,91,183
https://kawalpemilu.org#26109,"PULO GEBANG, CAKUNG, JAKARTA TIMUR, DKI JAKARTA",49,90,140,230
https://kawalpemilu.org#26109,"PULO GEBANG, CAKUNG, JAKARTA TIMUR, DKI JAKARTA",50,70,171,241
https://kawalpemilu.org#26109,"PULO GEBANG, CAKUNG, JAKARTA TIMUR, DKI JAKARTA",51,110,109,219
https://kawalpemilu.org#26109,"PULO GEBANG, CAKUNG, JAKARTA TIMUR, DKI JAKARTA",52,123,120,243
https://kawalpemilu.org#26109,"PULO GEBANG, CAKUNG, JAKARTA TIMUR, DKI JAKARTA",54,100,128,228
https://kawalpemilu.org#26109,"PULO GEBANG, CAKUNG, JAKARTA TIMUR, DKI JAKARTA",55,87,137,224
https://kawalpemilu.org#26109,"PULO GEBANG, CAKUNG, JAKARTA TIMUR, DKI JAKARTA",57,71,97,168
https://kawalpemilu.org#26109,"PULO GEBANG, CAKUNG, JAKARTA TIMUR, DKI JAKARTA",58,72,104,176
https://kawalpemilu.org#26109,"PULO GEBANG, CAKUNG, JAKARTA TIMUR, DKI JAKARTA",59,61,143,204
https://kawalpemilu.org#26109,"PULO GEBANG, CAKUNG, JAKARTA TIMUR, DKI JAKARTA",60,72,150,222
https://kawalpemilu.org#26109,"PULO GEBANG, CAKUNG, JAKARTA TIMUR, DKI JAKARTA",61,51,162,213
https://kawalpemilu.org#26109,"PULO GEBANG, CAKUNG, JAKARTA TIMUR, DKI JAKARTA",62,69,144,213
https://kawalpemilu.org#26109,"PULO GEBANG, CAKUNG, JAKARTA TIMUR, DKI JAKARTA",63,57,171,228
https://kawalpemilu.org#26109,"PULO GEBANG, CAKUNG, JAKARTA TIMUR, DKI JAKARTA",64,59,160,219
https://kawalpemilu.org#26109,"PULO GEBANG, CAKUNG, JAKARTA TIMUR, DKI JAKARTA",65,38,160,198
https://kawalpemilu.org#26109,"PULO GEBANG, CAKUNG, JAKARTA TIMUR, DKI JAKARTA",66,98,105,203
https://kawalpemilu.org#26109,"PULO GEBANG, CAKUNG, JAKARTA TIMUR, DKI JAKARTA",67,70,148,218
https://kawalpemilu.org#26109,"PULO GEBANG, CAKUNG, JAKARTA TIMUR, DKI JAKARTA",68,72,121,193
https://kawalpemilu.org#26109,"PULO GEBANG, CAKUNG, JAKARTA TIMUR, DKI JAKARTA",69,142,104,246
https://kawalpemilu.org#26109,"PULO GEBANG, CAKUNG, JAKARTA TIMUR, DKI JAKARTA",70,74,139,213
https://kawalpemilu.org#26109,"PULO GEBANG, CAKUNG, JAKARTA TIMUR, DKI JAKARTA",71,121,85,206
https://kawalpemilu.org#26109,"PULO GEBANG, CAKUNG, JAKARTA TIMUR, DKI JAKARTA",72,133,49,182
https://kawalpemilu.org#26109,"PULO GEBANG, CAKUNG, JAKARTA TIMUR, DKI JAKARTA",73,149,48,197
https://kawalpemilu.org#26109,"PULO GEBANG, CAKUNG, JAKARTA TIMUR, DKI JAKARTA",74,106,76,182
https://kawalpemilu.org#26109,"PULO GEBANG, CAKUNG, JAKARTA TIMUR, DKI JAKARTA",75,95,82,177
https://kawalpemilu.org#26109,"PULO GEBANG, CAKUNG, JAKARTA TIMUR, DKI JAKARTA",76,119,104,223
https://kawalpemilu.org#26109,"PULO GEBANG, CAKUNG, JAKARTA TIMUR, DKI JAKARTA",77,77,129,206
https://kawalpemilu.org#26109,"PULO GEBANG, CAKUNG, JAKARTA TIMUR, DKI JAKARTA",78,55,94,149
https://kawalpemilu.org#26109,"PULO GEBANG, CAKUNG, JAKARTA TIMUR, DKI JAKARTA",79,64,103,167
https://kawalpemilu.org#26109,"PULO GEBANG, CAKUNG, JAKARTA TIMUR, DKI JAKARTA",81,83,160,243
https://kawalpemilu.org#26109,"PULO GEBANG, CAKUNG, JAKARTA TIMUR, DKI JAKARTA",82,100,120,220
https://kawalpemilu.org#26109,"PULO GEBANG, CAKUNG, JAKARTA TIMUR, DKI JAKARTA",83,114,101,215
https://kawalpemilu.org#26109,"PULO GEBANG, CAKUNG, JAKARTA TIMUR, DKI JAKARTA",84,106,118,224
https://kawalpemilu.org#26109,"PULO GEBANG, CAKUNG, JAKARTA TIMUR, DKI JAKARTA",85,98,137,235
https://kawalpemilu.org#26109,"PULO GEBANG, CAKUNG, JAKARTA TIMUR, DKI JAKARTA",86,95,139,234
https://kawalpemilu.org#26109,"PULO GEBANG, CAKUNG, JAKARTA TIMUR, DKI JAKARTA",87,68,130,198
https://kawalpemilu.org#26109,"PULO GEBANG, CAKUNG, JAKARTA TIMUR, DKI JAKARTA",88,68,137,205
https://kawalpemilu.org#26109,"PULO GEBANG, CAKUNG, JAKARTA TIMUR, DKI JAKARTA",89,97,137,234
https://kawalpemilu.org#26109,"PULO GEBANG, CAKUNG, JAKARTA TIMUR, DKI JAKARTA",90,86,131,217
https://kawalpemilu.org#26109,"PULO GEBANG, CAKUNG, JAKARTA TIMUR, DKI JAKARTA",91,61,144,205
https://kawalpemilu.org#26109,"PULO GEBANG, CAKUNG, JAKARTA TIMUR, DKI JAKARTA",92,74,92,166
https://kawalpemilu.org#26109,"PULO GEBANG, CAKUNG, JAKARTA TIMUR, DKI JAKARTA",93,90,100,190
https://kawalpemilu.org#26109,"PULO GEBANG, CAKUNG, JAKARTA TIMUR, DKI JAKARTA",94,80,72,152
https://kawalpemilu.org#26109,"PULO GEBANG, CAKUNG, JAKARTA TIMUR, DKI JAKARTA",95,93,86,179
https://kawalpemilu.org#26109,"PULO GEBANG, CAKUNG, JAKARTA TIMUR, DKI JAKARTA",96,105,104,209
https://kawalpemilu.org#26109,"PULO GEBANG, CAKUNG, JAKARTA TIMUR, DKI JAKARTA",97,101,108,209
https://kawalpemilu.org#26109,"PULO GEBANG, CAKUNG, JAKARTA TIMUR, DKI JAKARTA",98,107,112,219
https://kawalpemilu.org#26109,"PULO GEBANG, CAKUNG, JAKARTA TIMUR, DKI JAKARTA",99,74,108,182
https://kawalpemilu.org#26109,"PULO GEBANG, CAKUNG, JAKARTA TIMUR, DKI JAKARTA",100,86,105,191
https://kawalpemilu.org#26109,"PULO GEBANG, CAKUNG, JAKARTA TIMUR, DKI JAKARTA",101,144,82,226
https://kawalpemilu.org#26109,"PULO GEBANG, CAKUNG, JAKARTA TIMUR, DKI JAKARTA",102,90,116,206
https://kawalpemilu.org#26109,"PULO GEBANG, CAKUNG, JAKARTA TIMUR, DKI JAKARTA",103,94,91,185
https://kawalpemilu.org#26109,"PULO GEBANG, CAKUNG, JAKARTA TIMUR, DKI JAKARTA",104,95,139,234
https://kawalpemilu.org#26109,"PULO GEBANG, CAKUNG, JAKARTA TIMUR, DKI JAKARTA",105,90,82,172
https://kawalpemilu.org#26109,"PULO GEBANG, CAKUNG, JAKARTA TIMUR, DKI JAKARTA",106,101,96,197
https://kawalpemilu.org#26109,"PULO GEBANG, CAKUNG, JAKARTA TIMUR, DKI JAKARTA",107,92,85,177
https://kawalpemilu.org#26109,"PULO GEBANG, CAKUNG, JAKARTA TIMUR, DKI JAKARTA",108,91,119,210
https://kawalpemilu.org#26109,"PULO GEBANG, CAKUNG, JAKARTA TIMUR, DKI JAKARTA",109,94,105,199
https://kawalpemilu.org#26109,"PULO GEBANG, CAKUNG, JAKARTA TIMUR, DKI JAKARTA",110,82,103,185
https://kawalpemilu.org#26109,"PULO GEBANG, CAKUNG, JAKARTA TIMUR, DKI JAKARTA",111,88,121,209
https://kawalpemilu.org#26109,"PULO GEBANG, CAKUNG, JAKARTA TIMUR, DKI JAKARTA",112,96,93,189
https://kawalpemilu.org#26109,"PULO GEBANG, CAKUNG, JAKARTA TIMUR, DKI JAKARTA",113,68,113,181
https://kawalpemilu.org#26109,"PULO GEBANG, CAKUNG, JAKARTA TIMUR, DKI JAKARTA",114,77,100,177
https://kawalpemilu.org#26109,"PULO GEBANG, CAKUNG, JAKARTA TIMUR, DKI JAKARTA",115,79,110,189
https://kawalpemilu.org#26109,"PULO GEBANG, CAKUNG, JAKARTA TIMUR, DKI JAKARTA",116,96,107,203
https://kawalpemilu.org#26109,"PULO GEBANG, CAKUNG, JAKARTA TIMUR, DKI JAKARTA",117,78,117,195
https://kawalpemilu.org#26109,"PULO GEBANG, CAKUNG, JAKARTA TIMUR, DKI JAKARTA",118,99,107,206
https://kawalpemilu.org#26109,"PULO GEBANG, CAKUNG, JAKARTA TIMUR, DKI JAKARTA",119,102,104,206
https://kawalpemilu.org#26109,"PULO GEBANG, CAKUNG, JAKARTA TIMUR, DKI JAKARTA",120,72,126,198
https://kawalpemilu.org#26109,"PULO GEBANG, CAKUNG, JAKARTA TIMUR, DKI JAKARTA",121,89,103,192
https://kawalpemilu.org#26109,"PULO GEBANG, CAKUNG, JAKARTA TIMUR, DKI JAKARTA",122,96,97,193
https://kawalpemilu.org#26109,"PULO GEBANG, CAKUNG, JAKARTA TIMUR, DKI JAKARTA",123,124,77,201
https://kawalpemilu.org#26109,"PULO GEBANG, CAKUNG, JAKARTA TIMUR, DKI JAKARTA",124,103,124,227
https://kawalpemilu.org#26109,"PULO GEBANG, CAKUNG, JAKARTA TIMUR, DKI JAKARTA",125,110,120,230
https://kawalpemilu.org#26109,"PULO GEBANG, CAKUNG, JAKARTA TIMUR, DKI JAKARTA",126,79,135,214
https://kawalpemilu.org#26109,"PULO GEBANG, CAKUNG, JAKARTA TIMUR, DKI JAKARTA",127,62,150,212
https://kawalpemilu.org#26109,"PULO GEBANG, CAKUNG, JAKARTA TIMUR, DKI JAKARTA",128,47,110,157
https://kawalpemilu.org#26109,"PULO GEBANG, CAKUNG, JAKARTA TIMUR, DKI JAKARTA",129,76,145,221
https://kawalpemilu.org#26109,"PULO GEBANG, CAKUNG, JAKARTA TIMUR, DKI JAKARTA",130,62,106,168
https://kawalpemilu.org#26109,"PULO GEBANG, CAKUNG, JAKARTA TIMUR, DKI JAKARTA",131,66,123,189
https://kawalpemilu.org#26109,"PULO GEBANG, CAKUNG, JAKARTA TIMUR, DKI JAKARTA",132,79,97,176
https://kawalpemilu.org#26109,"PULO GEBANG, CAKUNG, JAKARTA TIMUR, DKI JAKARTA",133,75,108,183
https://kawalpemilu.org#26109,"PULO GEBANG, CAKUNG, JAKARTA TIMUR, DKI JAKARTA",134,99,145,244
https://kawalpemilu.org#26109,"PULO GEBANG, CAKUNG, JAKARTA TIMUR, DKI JAKARTA",135,104,130,234
https://kawalpemilu.org#26109,"PULO GEBANG, CAKUNG, JAKARTA TIMUR, DKI JAKARTA",136,122,117,239
https://kawalpemilu.org#26109,"PULO GEBANG, CAKUNG, JAKARTA TIMUR, DKI JAKARTA",137,123,92,215
https://kawalpemilu.org#26109,"PULO GEBANG, CAKUNG, JAKARTA TIMUR, DKI JAKARTA",138,95,112,207
https://kawalpemilu.org#26109,"PULO GEBANG, CAKUNG, JAKARTA TIMUR, DKI JAKARTA",139,111,116,227
https://kawalpemilu.org#26109,"PULO GEBANG, CAKUNG, JAKARTA TIMUR, DKI JAKARTA",140,91,111,202
https://kawalpemilu.org#26109,"PULO GEBANG, CAKUNG, JAKARTA TIMUR, DKI JAKARTA",141,77,91,168
https://kawalpemilu.org#26109,"PULO GEBANG, CAKUNG, JAKARTA TIMUR, DKI JAKARTA",142,104,97,201
https://kawalpemilu.org#26109,"PULO GEBANG, CAKUNG, JAKARTA TIMUR, DKI JAKARTA",145,71,110,181
https://kawalpemilu.org#26109,"PULO GEBANG, CAKUNG, JAKARTA TIMUR, DKI JAKARTA",146,92,76,168
https://kawalpemilu.org#26109,"PULO GEBANG, CAKUNG, JAKARTA TIMUR, DKI JAKARTA",147,86,62,148
https://kawalpemilu.org#26109,"PULO GEBANG, CAKUNG, JAKARTA TIMUR, DKI JAKARTA",148,116,74,190
https://kawalpemilu.org#26109,"PULO GEBANG, CAKUNG, JAKARTA TIMUR, DKI JAKARTA",149,0,0,0
https://kawalpemilu.org#26109,"PULO GEBANG, CAKUNG, JAKARTA TIMUR, DKI JAKARTA",151,133,123,256
https://kawalpemilu.org#26109,"PULO GEBANG, CAKUNG, JAKARTA TIMUR, DKI JAKARTA",153,76,87,163
https://kawalpemilu.org#26109,"PULO GEBANG, CAKUNG, JAKARTA TIMUR, DKI JAKARTA",154,65,121,186
https://kawalpemilu.org#26109,"PULO GEBANG, CAKUNG, JAKARTA TIMUR, DKI JAKARTA",155,94,153,247
https://kawalpemilu.org#26109,"PULO GEBANG, CAKUNG, JAKARTA TIMUR, DKI JAKARTA",157,84,152,236
https://kawalpemilu.org#26109,"PULO GEBANG, CAKUNG, JAKARTA TIMUR, DKI JAKARTA",158,92,123,215
https://kawalpemilu.org#26109,"PULO GEBANG, CAKUNG, JAKARTA TIMUR, DKI JAKARTA",159,85,122,207
https://kawalpemilu.org#26109,"PULO GEBANG, CAKUNG, JAKARTA TIMUR, DKI JAKARTA",160,77,152,229
https://kawalpemilu.org#26109,"PULO GEBANG, CAKUNG, JAKARTA TIMUR, DKI JAKARTA",161,47,119,166
https://kawalpemilu.org#26109,"PULO GEBANG, CAKUNG, JAKARTA TIMUR, DKI JAKARTA",162,66,120,186
https://kawalpemilu.org#26109,"PULO GEBANG, CAKUNG, JAKARTA TIMUR, DKI JAKARTA",163,20,26,46
https://kawalpemilu.org#26109,"PULO GEBANG, CAKUNG, JAKARTA TIMUR, DKI JAKARTA",164,103,85,188
https://kawalpemilu.org#26109,"PULO GEBANG, CAKUNG, JAKARTA TIMUR, DKI JAKARTA",165,104,112,216
https://kawalpemilu.org#26109,"PULO GEBANG, CAKUNG, JAKARTA TIMUR, DKI JAKARTA",166,101,133,234
https://kawalpemilu.org#26109,"PULO GEBANG, CAKUNG, JAKARTA TIMUR, DKI JAKARTA",167,106,124,230
https://kawalpemilu.org#26109,"PULO GEBANG, CAKUNG, JAKARTA TIMUR, DKI JAKARTA",168,134,108,242
https://kawalpemilu.org#26109,"PULO GEBANG, CAKUNG, JAKARTA TIMUR, DKI JAKARTA",169,108,143,251
https://kawalpemilu.org#26109,"PULO GEBANG, CAKUNG, JAKARTA TIMUR, DKI JAKARTA",170,110,100,210
https://kawalpemilu.org#26109,"PULO GEBANG, CAKUNG, JAKARTA TIMUR, DKI JAKARTA",171,89,104,193
https://kawalpemilu.org#26109,"PULO GEBANG, CAKUNG, JAKARTA TIMUR, DKI JAKARTA",172,95,115,210
https://kawalpemilu.org#26109,"PULO GEBANG, CAKUNG, JAKARTA TIMUR, DKI JAKARTA",173,87,130,217
https://kawalpemilu.org#26109,"PULO GEBANG, CAKUNG, JAKARTA TIMUR, DKI JAKARTA",174,83,142,225
https://kawalpemilu.org#26109,"PULO GEBANG, CAKUNG, JAKARTA TIMUR, DKI JAKARTA",175,100,129,229
https://kawalpemilu.org#26109,"PULO GEBANG, CAKUNG, JAKARTA TIMUR, DKI JAKARTA",176,85,162,247
https://kawalpemilu.org#26109,"PULO GEBANG, CAKUNG, JAKARTA TIMUR, DKI JAKARTA",177,89,124,213
https://kawalpemilu.org#26109,"PULO GEBANG, CAKUNG, JAKARTA TIMUR, DKI JAKARTA",179,153,61,214
https://kawalpemilu.org#26109,"PULO GEBANG, CAKUNG, JAKARTA TIMUR, DKI JAKARTA",180,184,48,232
https://kawalpemilu.org#26109,"PULO GEBANG, CAKUNG, JAKARTA TIMUR, DKI JAKARTA",181,91,87,178
https://kawalpemilu.org#26109,"PULO GEBANG, CAKUNG, JAKARTA TIMUR, DKI JAKARTA",182,86,90,176
https://kawalpemilu.org#26109,"PULO GEBANG, CAKUNG, JAKARTA TIMUR, DKI JAKARTA",183,71,97,168
https://kawalpemilu.org#26109,"PULO GEBANG, CAKUNG, JAKARTA TIMUR, DKI JAKARTA",184,85,116,201
https://kawalpemilu.org#26109,"PULO GEBANG, CAKUNG, JAKARTA TIMUR, DKI JAKARTA",185,85,113,198
https://kawalpemilu.org#26109,"PULO GEBANG, CAKUNG, JAKARTA TIMUR, DKI JAKARTA",186,96,140,236
https://kawalpemilu.org#26109,"PULO GEBANG, CAKUNG, JAKARTA TIMUR, DKI JAKARTA",187,95,127,222
https://kawalpemilu.org#26109,"PULO GEBANG, CAKUNG, JAKARTA TIMUR, DKI JAKARTA",188,104,135,239
https://kawalpemilu.org#26109,"PULO GEBANG, CAKUNG, JAKARTA TIMUR, DKI JAKARTA",189,108,147,255
https://kawalpemilu.org#26109,"PULO GEBANG, CAKUNG, JAKARTA TIMUR, DKI JAKARTA",190,62,112,174
https://kawalpemilu.org#26109,"PULO GEBANG, CAKUNG, JAKARTA TIMUR, DKI JAKARTA",192,54,168,222
https://kawalpemilu.org#26109,"PULO GEBANG, CAKUNG, JAKARTA TIMUR, DKI JAKARTA",193,77,105,182
https://kawalpemilu.org#26109,"PULO GEBANG, CAKUNG, JAKARTA TIMUR, DKI JAKARTA",194,80,107,187
https://kawalpemilu.org#26109,"PULO GEBANG, CAKUNG, JAKARTA TIMUR, DKI JAKARTA",195,99,123,222
https://kawalpemilu.org#26109,"PULO GEBANG, CAKUNG, JAKARTA TIMUR, DKI JAKARTA",196,93,134,227
https://kawalpemilu.org#26109,"PULO GEBANG, CAKUNG, JAKARTA TIMUR, DKI JAKARTA",197,102,97,199
https://kawalpemilu.org#26109,"PULO GEBANG, CAKUNG, JAKARTA TIMUR, DKI JAKARTA",198,69,134,203
https://kawalpemilu.org#26109,"PULO GEBANG, CAKUNG, JAKARTA TIMUR, DKI JAKARTA",199,73,84,157
https://kawalpemilu.org#26109,"PULO GEBANG, CAKUNG, JAKARTA TIMUR, DKI JAKARTA",200,75,102,177
https://kawalpemilu.org#26109,"PULO GEBANG, CAKUNG, JAKARTA TIMUR, DKI JAKARTA",201,59,127,187
https://kawalpemilu.org#26109,"PULO GEBANG, CAKUNG, JAKARTA TIMUR, DKI JAKARTA",203,93,105,198
https://kawalpemilu.org#26109,"PULO GEBANG, CAKUNG, JAKARTA TIMUR, DKI JAKARTA",204,110,138,248
https://kawalpemilu.org#26109,"PULO GEBANG, CAKUNG, JAKARTA TIMUR, DKI JAKARTA",205,108,126,234
https://kawalpemilu.org#26109,"PULO GEBANG, CAKUNG, JAKARTA TIMUR, DKI JAKARTA",206,111,125,236
https://kawalpemilu.org#26109,"PULO GEBANG, CAKUNG, JAKARTA TIMUR, DKI JAKARTA",207,84,146,230
https://kawalpemilu.org#26109,"PULO GEBANG, CAKUNG, JAKARTA TIMUR, DKI JAKARTA",208,113,121,234
https://kawalpemilu.org#26109,"PULO GEBANG, CAKUNG, JAKARTA TIMUR, DKI JAKARTA",209,109,117,226
https://kawalpemilu.org#26109,"PULO GEBANG, CAKUNG, JAKARTA TIMUR, DKI JAKARTA",210,87,158,245
https://kawalpemilu.org#26109,"PULO GEBANG, CAKUNG, JAKARTA TIMUR, DKI JAKARTA",211,119,133,252
https://kawalpemilu.org#26109,"PULO GEBANG, CAKUNG, JAKARTA TIMUR, DKI JAKARTA",212,113,130,243
https://kawalpemilu.org#26109,"PULO GEBANG, CAKUNG, JAKARTA TIMUR, DKI JAKARTA",213,118,130,248
https://kawalpemilu.org#26109,"PULO GEBANG, CAKUNG, JAKARTA TIMUR, DKI JAKARTA",214,108,149,257
https://kawalpemilu.org#26109,"PULO GEBANG, CAKUNG, JAKARTA TIMUR, DKI JAKARTA",215,90,120,210
https://kawalpemilu.org#26109,"PULO GEBANG, CAKUNG, JAKARTA TIMUR, DKI JAKARTA",216,84,114,198
https://kawalpemilu.org#26109,"PULO GEBANG, CAKUNG, JAKARTA TIMUR, DKI JAKARTA",217,76,101,177
https://kawalpemilu.org#26109,"PULO GEBANG, CAKUNG, JAKARTA TIMUR, DKI JAKARTA",218,63,129,192
https://kawalpemilu.org#26109,"PULO GEBANG, CAKUNG, JAKARTA TIMUR, DKI JAKARTA",219,86,95,181
https://kawalpemilu.org#26109,"PULO GEBANG, CAKUNG, JAKARTA TIMUR, DKI JAKARTA",220,144,59,203
https://kawalpemilu.org#26109,"PULO GEBANG, CAKUNG, JAKARTA TIMUR, DKI JAKARTA",221,151,62,213
https://kawalpemilu.org#26109,"PULO GEBANG, CAKUNG, JAKARTA TIMUR, DKI JAKARTA",222,154,73,227
https://kawalpemilu.org#26109,"PULO GEBANG, CAKUNG, JAKARTA TIMUR, DKI JAKARTA",223,136,96,232
https://kawalpemilu.org#26109,"PULO GEBANG, CAKUNG, JAKARTA TIMUR, DKI JAKARTA",224,158,90,248
https://kawalpemilu.org#26109,"PULO GEBANG, CAKUNG, JAKARTA TIMUR, DKI JAKARTA",225,128,102,130
https://kawalpemilu.org#26109,"PULO GEBANG, CAKUNG, JAKARTA TIMUR, DKI JAKARTA",226,123,102,225
https://kawalpemilu.org#26109,"PULO GEBANG, CAKUNG, JAKARTA TIMUR, DKI JAKARTA",227,120,110,230
https://kawalpemilu.org#26109,"PULO GEBANG, CAKUNG, JAKARTA TIMUR, DKI JAKARTA",228,103,131,234
https://kawalpemilu.org#26109,"PULO GEBANG, CAKUNG, JAKARTA TIMUR, DKI JAKARTA",229,105,126,231
https://kawalpemilu.org#26109,"PULO GEBANG, CAKUNG, JAKARTA TIMUR, DKI JAKARTA",230,124,104,228
https://kawalpemilu.org#26109,"PULO GEBANG, CAKUNG, JAKARTA TIMUR, DKI JAKARTA",231,94,143,237
https://kawalpemilu.org#26109,"PULO GEBANG, CAKUNG, JAKARTA TIMUR, DKI JAKARTA",232,79,113,192
https://kawalpemilu.org#26109,"PULO GEBANG, CAKUNG, JAKARTA TIMUR, DKI JAKARTA",234,82,116,198
https://kawalpemilu.org#26109,"PULO GEBANG, CAKUNG, JAKARTA TIMUR, DKI JAKARTA",235,86,100,186
https://kawalpemilu.org#26109,"PULO GEBANG, CAKUNG, JAKARTA TIMUR, DKI JAKARTA",236,87,98,185
https://kawalpemilu.org#26109,"PULO GEBANG, CAKUNG, JAKARTA TIMUR, DKI JAKARTA",237,89,111,200
https://kawalpemilu.org#26109,"PULO GEBANG, CAKUNG, JAKARTA TIMUR, DKI JAKARTA",238,78,112,190
https://kawalpemilu.org#26109,"PULO GEBANG, CAKUNG, JAKARTA TIMUR, DKI JAKARTA",239,64,111,175
https://kawalpemilu.org#26109,"PULO GEBANG, CAKUNG, JAKARTA TIMUR, DKI JAKARTA",240,69,132,201
https://kawalpemilu.org#26109,"PULO GEBANG, CAKUNG, JAKARTA TIMUR, DKI JAKARTA",241,112,109,221
https://kawalpemilu.org#26109,"PULO GEBANG, CAKUNG, JAKARTA TIMUR, DKI JAKARTA",242,78,114,192
https://kawalpemilu.org#26109,"PULO GEBANG, CAKUNG, JAKARTA TIMUR, DKI JAKARTA",243,67,106,173
https://kawalpemilu.org#26109,"PULO GEBANG, CAKUNG, JAKARTA TIMUR, DKI JAKARTA",244,79,147,226
https://kawalpemilu.org#26109,"PULO GEBANG, CAKUNG, JAKARTA TIMUR, DKI JAKARTA",245,96,130,226
https://kawalpemilu.org#26109,"PULO GEBANG, CAKUNG, JAKARTA TIMUR, DKI JAKARTA",246,118,112,230
https://kawalpemilu.org#26109,"PULO GEBANG, CAKUNG, JAKARTA TIMUR, DKI JAKARTA",247,82,179,261
https://kawalpemilu.org#26109,"PULO GEBANG, CAKUNG, JAKARTA TIMUR, DKI JAKARTA",248,116,152,268
https://kawalpemilu.org#26109,"PULO GEBANG, CAKUNG, JAKARTA TIMUR, DKI JAKARTA",249,100,133,233
https://kawalpemilu.org#26109,"PULO GEBANG, CAKUNG, JAKARTA TIMUR, DKI JAKARTA",250,116,122,238
https://kawalpemilu.org#26109,"PULO GEBANG, CAKUNG, JAKARTA TIMUR, DKI JAKARTA",251,105,146,251
https://kawalpemilu.org#26109,"PULO GEBANG, CAKUNG, JAKARTA TIMUR, DKI JAKARTA",253,110,132,242
https://kawalpemilu.org#26109,"PULO GEBANG, CAKUNG, JAKARTA TIMUR, DKI JAKARTA",255,116,131,247
https://kawalpemilu.org#26109,"PULO GEBANG, CAKUNG, JAKARTA TIMUR, DKI JAKARTA",256,110,133,243
https://kawalpemilu.org#26109,"PULO GEBANG, CAKUNG, JAKARTA TIMUR, DKI JAKARTA",257,108,132,240
https://kawalpemilu.org#26109,"PULO GEBANG, CAKUNG, JAKARTA TIMUR, DKI JAKARTA",259,118,58,176
https://kawalpemilu.org#26109,"PULO GEBANG, CAKUNG, JAKARTA TIMUR, DKI JAKARTA",260,108,55,163
https://kawalpemilu.org#26109,"PULO GEBANG, CAKUNG, JAKARTA TIMUR, DKI JAKARTA",261,173,65,238
https://kawalpemilu.org#26109,"PULO GEBANG, CAKUNG, JAKARTA TIMUR, DKI JAKARTA",262,149,85,234
https://kawalpemilu.org#26109,"PULO GEBANG, CAKUNG, JAKARTA TIMUR, DKI JAKARTA",263,154,73,227
https://kawalpemilu.org#26109,"PULO GEBANG, CAKUNG, JAKARTA TIMUR, DKI JAKARTA",264,156,58,214
https://kawalpemilu.org#26109,"PULO GEBANG, CAKUNG, JAKARTA TIMUR, DKI JAKARTA",265,128,88,216
https://kawalpemilu.org#26109,"PULO GEBANG, CAKUNG, JAKARTA TIMUR, DKI JAKARTA",266,119,121,240
https://kawalpemilu.org#26109,"PULO GEBANG, CAKUNG, JAKARTA TIMUR, DKI JAKARTA",267,85,120,205
https://kawalpemilu.org#26109,"PULO GEBANG, CAKUNG, JAKARTA TIMUR, DKI JAKARTA",268,108,65,173
https://kawalpemilu.org#26109,"PULO GEBANG, CAKUNG, JAKARTA TIMUR, DKI JAKARTA",269,78,87,165
https://kawalpemilu.org#26109,"PULO GEBANG, CAKUNG, JAKARTA TIMUR, DKI JAKARTA",270,157,39,196
https://kawalpemilu.org#26109,"PULO GEBANG, CAKUNG, JAKARTA TIMUR, DKI JAKARTA",271,161,47,208
https://kawalpemilu.org#26109,"PULO GEBANG, CAKUNG, JAKARTA TIMUR, DKI JAKARTA",275,124,91,215
https://kawalpemilu.org#26109,"PULO GEBANG, CAKUNG, JAKARTA TIMUR, DKI JAKARTA",276,142,80,222
https://kawalpemilu.org#26109,"PULO GEBANG, CAKUNG, JAKARTA TIMUR, DKI JAKARTA",277,130,87,217
https://kawalpemilu.org#26109,"PULO GEBANG, CAKUNG, JAKARTA TIMUR, DKI JAKARTA",278,100,97,197
https://kawalpemilu.org#26109,"PULO GEBANG, CAKUNG, JAKARTA TIMUR, DKI JAKARTA",279,132,62,194
https://kawalpemilu.org#26109,"PULO GEBANG, CAKUNG, JAKARTA TIMUR, DKI JAKARTA",280,130,116,246
https://kawalpemilu.org#26109,"PULO GEBANG, CAKUNG, JAKARTA TIMUR, DKI JAKARTA",281,151,58,209
https://kawalpemilu.org#26109,"PULO GEBANG, CAKUNG, JAKARTA TIMUR, DKI JAKARTA",282,155,38,193
https://kawalpemilu.org#26109,"PULO GEBANG, CAKUNG, JAKARTA TIMUR, DKI JAKARTA",283,97,90,187
https://kawalpemilu.org#26109,"PULO GEBANG, CAKUNG, JAKARTA TIMUR, DKI JAKARTA",284,142,53,195
https://kawalpemilu.org#26109,"PULO GEBANG, CAKUNG, JAKARTA TIMUR, DKI JAKARTA",285,111,63,174
https://kawalpemilu.org#26109,"PULO GEBANG, CAKUNG, JAKARTA TIMUR, DKI JAKARTA",286,138,49,187
https://kawalpemilu.org#26109,"PULO GEBANG, CAKUNG, JAKARTA TIMUR, DKI JAKARTA",288,138,43,181
https://kawalpemilu.org#26109,"PULO GEBANG, CAKUNG, JAKARTA TIMUR, DKI JAKARTA",290,133,89,222
https://kawalpemilu.org#26109,"PULO GEBANG, CAKUNG, JAKARTA TIMUR, DKI JAKARTA",291,165,56,221
https://kawalpemilu.org#26109,"PULO GEBANG, CAKUNG, JAKARTA TIMUR, DKI JAKARTA",292,122,86,208
https://kawalpemilu.org#26109,"PULO GEBANG, CAKUNG, JAKARTA TIMUR, DKI JAKARTA",293,95,87,182
https://kawalpemilu.org#26109,"PULO GEBANG, CAKUNG, JAKARTA TIMUR, DKI JAKARTA",294,151,103,254
https://kawalpemilu.org#26109,"PULO GEBANG, CAKUNG, JAKARTA TIMUR, DKI JAKARTA",295,103,125,228
https://kawalpemilu.org#26109,"PULO GEBANG, CAKUNG, JAKARTA TIMUR, DKI JAKARTA",296,103,127,230
https://kawalpemilu.org#26109,"PULO GEBANG, CAKUNG, JAKARTA TIMUR, DKI JAKARTA",297,108,121,229
https://kawalpemilu.org#26109,"PULO GEBANG, CAKUNG, JAKARTA TIMUR, DKI JAKARTA",298,96,132,228
https://kawalpemilu.org#26109,"PULO GEBANG, CAKUNG, JAKARTA TIMUR, DKI JAKARTA",299,100,136,236
https://kawalpemilu.org#26109,"PULO GEBANG, CAKUNG, JAKARTA TIMUR, DKI JAKARTA",300,84,147,231
https://kawalpemilu.org#26109,"PULO GEBANG, CAKUNG, JAKARTA TIMUR, DKI JAKARTA",301,79,100,179
https://kawalpemilu.org#26109,"PULO GEBANG, CAKUNG, JAKARTA TIMUR, DKI JAKARTA",302,77,102,179
https://kawalpemilu.org#26109,"PULO GEBANG, CAKUNG, JAKARTA TIMUR, DKI JAKARTA",303,85,109,194
https://kawalpemilu.org#26109,"PULO GEBANG, CAKUNG, JAKARTA TIMUR, DKI JAKARTA",305,108,70,178
https://kawalpemilu.org#26109,"PULO GEBANG, CAKUNG, JAKARTA TIMUR, DKI JAKARTA",306,94,120,214
https://kawalpemilu.org#26109,"PULO GEBANG, CAKUNG, JAKARTA TIMUR, DKI JAKARTA",307,92,126,218
https://kawalpemilu.org#26109,"PULO GEBANG, CAKUNG, JAKARTA TIMUR, DKI JAKARTA",308,89,113,202
https://kawalpemilu.org#26109,"PULO GEBANG, CAKUNG, JAKARTA TIMUR, DKI JAKARTA",309,96,122,218
https://kawalpemilu.org#26109,"PULO GEBANG, CAKUNG, JAKARTA TIMUR, DKI JAKARTA",310,96,93,189
https://kawalpemilu.org#26109,"PULO GEBANG, CAKUNG, JAKARTA TIMUR, DKI JAKARTA",311,80,83,163
https://kawalpemilu.org#26109,"PULO GEBANG, CAKUNG, JAKARTA TIMUR, DKI JAKARTA",312,106,79,185
https://kawalpemilu.org#26109,"PULO GEBANG, CAKUNG, JAKARTA TIMUR, DKI JAKARTA",313,54,131,185
https://kawalpemilu.org#26109,"PULO GEBANG, CAKUNG, JAKARTA TIMUR, DKI JAKARTA",314,60,129,189
https://kawalpemilu.org#26109,"PULO GEBANG, CAKUNG, JAKARTA TIMUR, DKI JAKARTA",315,49,142,197
https://kawalpemilu.org#26109,"PULO GEBANG, CAKUNG, JAKARTA TIMUR, DKI JAKARTA",316,37,158,195
https://kawalpemilu.org#26109,"PULO GEBANG, CAKUNG, JAKARTA TIMUR, DKI JAKARTA",317,85,180,265
https://kawalpemilu.org#26109,"PULO GEBANG, CAKUNG, JAKARTA TIMUR, DKI JAKARTA",318,60,196,256
https://kawalpemilu.org#26109,"PULO GEBANG, CAKUNG, JAKARTA TIMUR, DKI JAKARTA",319,68,182,250
https://kawalpemilu.org#26110,"UJUNG MENTENG, CAKUNG, JAKARTA TIMUR, DKI JAKARTA",1,132,87,219
https://kawalpemilu.org#26110,"UJUNG MENTENG, CAKUNG, JAKARTA TIMUR, DKI JAKARTA",2,55,196,251
https://kawalpemilu.org#26110,"UJUNG MENTENG, CAKUNG, JAKARTA TIMUR, DKI JAKARTA",3,140,69,209
https://kawalpemilu.org#26110,"UJUNG MENTENG, CAKUNG, JAKARTA TIMUR, DKI JAKARTA",4,135,59,194
https://kawalpemilu.org#26110,"UJUNG MENTENG, CAKUNG, JAKARTA TIMUR, DKI JAKARTA",5,103,161,264
https://kawalpemilu.org#26110,"UJUNG MENTENG, CAKUNG, JAKARTA TIMUR, DKI JAKARTA",6,127,107,234
https://kawalpemilu.org#26110,"UJUNG MENTENG, CAKUNG, JAKARTA TIMUR, DKI JAKARTA",7,112,137,249
https://kawalpemilu.org#26110,"UJUNG MENTENG, CAKUNG, JAKARTA TIMUR, DKI JAKARTA",9,150,62,212
https://kawalpemilu.org#26110,"UJUNG MENTENG, CAKUNG, JAKARTA TIMUR, DKI JAKARTA",10,116,87,203
https://kawalpemilu.org#26110,"UJUNG MENTENG, CAKUNG, JAKARTA TIMUR, DKI JAKARTA",11,69,151,220
https://kawalpemilu.org#26110,"UJUNG MENTENG, CAKUNG, JAKARTA TIMUR, DKI JAKARTA",12,81,157,238
https://kawalpemilu.org#26110,"UJUNG MENTENG, CAKUNG, JAKARTA TIMUR, DKI JAKARTA",13,124,115,239
https://kawalpemilu.org#26110,"UJUNG MENTENG, CAKUNG, JAKARTA TIMUR, DKI JAKARTA",14,128,127,255
https://kawalpemilu.org#26110,"UJUNG MENTENG, CAKUNG, JAKARTA TIMUR, DKI JAKARTA",15,45,206,251
https://kawalpemilu.org#26110,"UJUNG MENTENG, CAKUNG, JAKARTA TIMUR, DKI JAKARTA",16,60,166,226
https://kawalpemilu.org#26110,"UJUNG MENTENG, CAKUNG, JAKARTA TIMUR, DKI JAKARTA",17,45,140,185
https://kawalpemilu.org#26110,"UJUNG MENTENG, CAKUNG, JAKARTA TIMUR, DKI JAKARTA",18,43,166,209
https://kawalpemilu.org#26110,"UJUNG MENTENG, CAKUNG, JAKARTA TIMUR, DKI JAKARTA",19,61,142,203
https://kawalpemilu.org#26110,"UJUNG MENTENG, CAKUNG, JAKARTA TIMUR, DKI JAKARTA",20,60,187,247
https://kawalpemilu.org#26110,"UJUNG MENTENG, CAKUNG, JAKARTA TIMUR, DKI JAKARTA",21,82,160,242
https://kawalpemilu.org#26110,"UJUNG MENTENG, CAKUNG, JAKARTA TIMUR, DKI JAKARTA",22,94,147,241
https://kawalpemilu.org#26110,"UJUNG MENTENG, CAKUNG, JAKARTA TIMUR, DKI JAKARTA",23,78,152,230
https://kawalpemilu.org#26110,"UJUNG MENTENG, CAKUNG, JAKARTA TIMUR, DKI JAKARTA",24,64,125,189
https://kawalpemilu.org#26110,"UJUNG MENTENG, CAKUNG, JAKARTA TIMUR, DKI JAKARTA",25,65,133,198
https://kawalpemilu.org#26110,"UJUNG MENTENG, CAKUNG, JAKARTA TIMUR, DKI JAKARTA",26,70,185,255
https://kawalpemilu.org#26110,"UJUNG MENTENG, CAKUNG, JAKARTA TIMUR, DKI JAKARTA",27,90,157,247
https://kawalpemilu.org#26110,"UJUNG MENTENG, CAKUNG, JAKARTA TIMUR, DKI JAKARTA",28,79,136,215
https://kawalpemilu.org#26110,"UJUNG MENTENG, CAKUNG, JAKARTA TIMUR, DKI JAKARTA",29,65,120,185
https://kawalpemilu.org#26110,"UJUNG MENTENG, CAKUNG, JAKARTA TIMUR, DKI JAKARTA",30,65,123,188
https://kawalpemilu.org#26110,"UJUNG MENTENG, CAKUNG, JAKARTA TIMUR, DKI JAKARTA",31,112,116,228
https://kawalpemilu.org#26110,"UJUNG MENTENG, CAKUNG, JAKARTA TIMUR, DKI JAKARTA",32,107,111,218
https://kawalpemilu.org#26110,"UJUNG MENTENG, CAKUNG, JAKARTA TIMUR, DKI JAKARTA",33,76,176,252
https://kawalpemilu.org#26110,"UJUNG MENTENG, CAKUNG, JAKARTA TIMUR, DKI JAKARTA",34,73,153,226
https://kawalpemilu.org#26110,"UJUNG MENTENG, CAKUNG, JAKARTA TIMUR, DKI JAKARTA",35,66,175,241
https://kawalpemilu.org#26110,"UJUNG MENTENG, CAKUNG, JAKARTA TIMUR, DKI JAKARTA",36,71,137,208
https://kawalpemilu.org#26110,"UJUNG MENTENG, CAKUNG, JAKARTA TIMUR, DKI JAKARTA",37,100,144,244
https://kawalpemilu.org#26110,"UJUNG MENTENG, CAKUNG, JAKARTA TIMUR, DKI JAKARTA",38,107,122,229
https://kawalpemilu.org#26110,"UJUNG MENTENG, CAKUNG, JAKARTA TIMUR, DKI JAKARTA",39,108,145,253
https://kawalpemilu.org#26110,"UJUNG MENTENG, CAKUNG, JAKARTA TIMUR, DKI JAKARTA",40,124,113,237
https://kawalpemilu.org#26110,"UJUNG MENTENG, CAKUNG, JAKARTA TIMUR, DKI JAKARTA",41,92,132,224
https://kawalpemilu.org#26110,"UJUNG MENTENG, CAKUNG, JAKARTA TIMUR, DKI JAKARTA",42,114,91,205
https://kawalpemilu.org#26110,"UJUNG MENTENG, CAKUNG, JAKARTA TIMUR, DKI JAKARTA",43,82,107,189
https://kawalpemilu.org#26110,"UJUNG MENTENG, CAKUNG, JAKARTA TIMUR, DKI JAKARTA",44,91,119,210
https://kawalpemilu.org#26110,"UJUNG MENTENG, CAKUNG, JAKARTA TIMUR, DKI JAKARTA",45,133,111,244
https://kawalpemilu.org#26110,"UJUNG MENTENG, CAKUNG, JAKARTA TIMUR, DKI JAKARTA",46,69,139,208
https://kawalpemilu.org#26110,"UJUNG MENTENG, CAKUNG, JAKARTA TIMUR, DKI JAKARTA",47,80,102,182
https://kawalpemilu.org#26110,"UJUNG MENTENG, CAKUNG, JAKARTA TIMUR, DKI JAKARTA",48,95,129,224
https://kawalpemilu.org#26110,"UJUNG MENTENG, CAKUNG, JAKARTA TIMUR, DKI JAKARTA",49,83,140,223
https://kawalpemilu.org#26110,"UJUNG MENTENG, CAKUNG, JAKARTA TIMUR, DKI JAKARTA",50,76,113,189
https://kawalpemilu.org#26110,"UJUNG MENTENG, CAKUNG, JAKARTA TIMUR, DKI JAKARTA",51,83,120,203
https://kawalpemilu.org#26110,"UJUNG MENTENG, CAKUNG, JAKARTA TIMUR, DKI JAKARTA",52,112,103,215
https://kawalpemilu.org#26110,"UJUNG MENTENG, CAKUNG, JAKARTA TIMUR, DKI JAKARTA",53,92,99,191
https://kawalpemilu.org#26110,"UJUNG MENTENG, CAKUNG, JAKARTA TIMUR, DKI JAKARTA",54,79,112,191
https://kawalpemilu.org#26110,"UJUNG MENTENG, CAKUNG, JAKARTA TIMUR, DKI JAKARTA",55,89,102,191
https://kawalpemilu.org#26110,"UJUNG MENTENG, CAKUNG, JAKARTA TIMUR, DKI JAKARTA",57,79,135,214
https://kawalpemilu.org#26110,"UJUNG MENTENG, CAKUNG, JAKARTA TIMUR, DKI JAKARTA",58,107,117,224
https://kawalpemilu.org#26110,"UJUNG MENTENG, CAKUNG, JAKARTA TIMUR, DKI JAKARTA",59,96,128,224
https://kawalpemilu.org#26110,"UJUNG MENTENG, CAKUNG, JAKARTA TIMUR, DKI JAKARTA",60,119,103,222
https://kawalpemilu.org#26110,"UJUNG MENTENG, CAKUNG, JAKARTA TIMUR, DKI JAKARTA",61,103,147,250
https://kawalpemilu.org#26110,"UJUNG MENTENG, CAKUNG, JAKARTA TIMUR, DKI JAKARTA",62,63,150,213
https://kawalpemilu.org#26110,"UJUNG MENTENG, CAKUNG, JAKARTA TIMUR, DKI JAKARTA",63,65,130,195
https://kawalpemilu.org#26110,"UJUNG MENTENG, CAKUNG, JAKARTA TIMUR, DKI JAKARTA",64,231,12,243
https://kawalpemilu.org#26110,"UJUNG MENTENG, CAKUNG, JAKARTA TIMUR, DKI JAKARTA",65,201,30,231
https://kawalpemilu.org#26110,"UJUNG MENTENG, CAKUNG, JAKARTA TIMUR, DKI JAKARTA",66,159,14,173
https://kawalpemilu.org#26110,"UJUNG MENTENG, CAKUNG, JAKARTA TIMUR, DKI JAKARTA",67,184,24,208
https://kawalpemilu.org#26110,"UJUNG MENTENG, CAKUNG, JAKARTA TIMUR, DKI JAKARTA",68,221,21,242
https://kawalpemilu.org#26110,"UJUNG MENTENG, CAKUNG, JAKARTA TIMUR, DKI JAKARTA",69,194,18,212
https://kawalpemilu.org#26110,"UJUNG MENTENG, CAKUNG, JAKARTA TIMUR, DKI JAKARTA",70,177,35,212
https://kawalpemilu.org#26110,"UJUNG MENTENG, CAKUNG, JAKARTA TIMUR, DKI JAKARTA",72,177,18,195
https://kawalpemilu.org#26110,"UJUNG MENTENG, CAKUNG, JAKARTA TIMUR, DKI JAKARTA",73,192,34,226
https://kawalpemilu.org#26110,"UJUNG MENTENG, CAKUNG, JAKARTA TIMUR, DKI JAKARTA",74,134,71,205
https://kawalpemilu.org#26110,"UJUNG MENTENG, CAKUNG, JAKARTA TIMUR, DKI JAKARTA",75,175,82,257
https://kawalpemilu.org#26110,"UJUNG MENTENG, CAKUNG, JAKARTA TIMUR, DKI JAKARTA",76,151,84,235
https://kawalpemilu.org#26110,"UJUNG MENTENG, CAKUNG, JAKARTA TIMUR, DKI JAKARTA",77,185,49,234
https://kawalpemilu.org#26110,"UJUNG MENTENG, CAKUNG, JAKARTA TIMUR, DKI JAKARTA",78,199,61,260
https://kawalpemilu.org#26110,"UJUNG MENTENG, CAKUNG, JAKARTA TIMUR, DKI JAKARTA",79,176,90,266
https://kawalpemilu.org#26110,"UJUNG MENTENG, CAKUNG, JAKARTA TIMUR, DKI JAKARTA",80,154,41,195
https://kawalpemilu.org#26110,"UJUNG MENTENG, CAKUNG, JAKARTA TIMUR, DKI JAKARTA",81,143,107,250
https://kawalpemilu.org#26110,"UJUNG MENTENG, CAKUNG, JAKARTA TIMUR, DKI JAKARTA",83,83,148,231
https://kawalpemilu.org#26110,"UJUNG MENTENG, CAKUNG, JAKARTA TIMUR, DKI JAKARTA",84,147,121,268
https://kawalpemilu.org#26110,"UJUNG MENTENG, CAKUNG, JAKARTA TIMUR, DKI JAKARTA",85,159,93,252
https://kawalpemilu.org#26110,"UJUNG MENTENG, CAKUNG, JAKARTA TIMUR, DKI JAKARTA",86,155,118,273
https://kawalpemilu.org#26110,"UJUNG MENTENG, CAKUNG, JAKARTA TIMUR, DKI JAKARTA",87,133,57,190
https://kawalpemilu.org#26110,"UJUNG MENTENG, CAKUNG, JAKARTA TIMUR, DKI JAKARTA",88,124,66,190
https://kawalpemilu.org#26110,"UJUNG MENTENG, CAKUNG, JAKARTA TIMUR, DKI JAKARTA",89,92,93,185
https://kawalpemilu.org#26110,"UJUNG MENTENG, CAKUNG, JAKARTA TIMUR, DKI JAKARTA",91,63,117,180
https://kawalpemilu.org#26110,"UJUNG MENTENG, CAKUNG, JAKARTA TIMUR, DKI JAKARTA",93,97,134,231
https://kawalpemilu.org#26110,"UJUNG MENTENG, CAKUNG, JAKARTA TIMUR, DKI JAKARTA",94,160,24,184
https://kawalpemilu.org#26110,"UJUNG MENTENG, CAKUNG, JAKARTA TIMUR, DKI JAKARTA",95,151,39,190
https://kawalpemilu.org#26110,"UJUNG MENTENG, CAKUNG, JAKARTA TIMUR, DKI JAKARTA",96,131,54,185
https://kawalpemilu.org#26111,"CAKUNG BARAT, CAKUNG, JAKARTA TIMUR, DKI JAKARTA",1,53,167,220
https://kawalpemilu.org#26111,"CAKUNG BARAT, CAKUNG, JAKARTA TIMUR, DKI JAKARTA",2,76,150,226
https://kawalpemilu.org#26111,"CAKUNG BARAT, CAKUNG, JAKARTA TIMUR, DKI JAKARTA",3,65,156,221
https://kawalpemilu.org#26111,"CAKUNG BARAT, CAKUNG, JAKARTA TIMUR, DKI JAKARTA",4,82,166,248
https://kawalpemilu.org#26111,"CAKUNG BARAT, CAKUNG, JAKARTA TIMUR, DKI JAKARTA",5,66,173,239
https://kawalpemilu.org#26111,"CAKUNG BARAT, CAKUNG, JAKARTA TIMUR, DKI JAKARTA",6,83,117,200
https://kawalpemilu.org#26111,"CAKUNG BARAT, CAKUNG, JAKARTA TIMUR, DKI JAKARTA",7,56,113,169
https://kawalpemilu.org#26111,"CAKUNG BARAT, CAKUNG, JAKARTA TIMUR, DKI JAKARTA",8,56,101,157
https://kawalpemilu.org#26111,"CAKUNG BARAT, CAKUNG, JAKARTA TIMUR, DKI JAKARTA",9,62,95,157
https://kawalpemilu.org#26111,"CAKUNG BARAT, CAKUNG, JAKARTA TIMUR, DKI JAKARTA",10,71,176,247
https://kawalpemilu.org#26111,"CAKUNG BARAT, CAKUNG, JAKARTA TIMUR, DKI JAKARTA",11,67,124,191
https://kawalpemilu.org#26111,"CAKUNG BARAT, CAKUNG, JAKARTA TIMUR, DKI JAKARTA",12,71,127,198
https://kawalpemilu.org#26111,"CAKUNG BARAT, CAKUNG, JAKARTA TIMUR, DKI JAKARTA",13,75,162,237
https://kawalpemilu.org#26111,"CAKUNG BARAT, CAKUNG, JAKARTA TIMUR, DKI JAKARTA",14,77,116,193
https://kawalpemilu.org#26111,"CAKUNG BARAT, CAKUNG, JAKARTA TIMUR, DKI JAKARTA",15,70,141,211
https://kawalpemilu.org#26111,"CAKUNG BARAT, CAKUNG, JAKARTA TIMUR, DKI JAKARTA",16,59,197,256
https://kawalpemilu.org#26111,"CAKUNG BARAT, CAKUNG, JAKARTA TIMUR, DKI JAKARTA",17,75,162,237
https://kawalpemilu.org#26111,"CAKUNG BARAT, CAKUNG, JAKARTA TIMUR, DKI JAKARTA",18,96,150,246
https://kawalpemilu.org#26111,"CAKUNG BARAT, CAKUNG, JAKARTA TIMUR, DKI JAKARTA",19,106,126,232
https://kawalpemilu.org#26111,"CAKUNG BARAT, CAKUNG, JAKARTA TIMUR, DKI JAKARTA",20,92,171,263
https://kawalpemilu.org#26111,"CAKUNG BARAT, CAKUNG, JAKARTA TIMUR, DKI JAKARTA",21,83,170,253
https://kawalpemilu.org#26111,"CAKUNG BARAT, CAKUNG, JAKARTA TIMUR, DKI JAKARTA",22,64,134,198
https://kawalpemilu.org#26111,"CAKUNG BARAT, CAKUNG, JAKARTA TIMUR, DKI JAKARTA",23,74,152,226
https://kawalpemilu.org#26111,"CAKUNG BARAT, CAKUNG, JAKARTA TIMUR, DKI JAKARTA",24,75,126,201
https://kawalpemilu.org#26111,"CAKUNG BARAT, CAKUNG, JAKARTA TIMUR, DKI JAKARTA",25,69,128,197
https://kawalpemilu.org#26111,"CAKUNG BARAT, CAKUNG, JAKARTA TIMUR, DKI JAKARTA",26,68,171,239
https://kawalpemilu.org#26111,"CAKUNG BARAT, CAKUNG, JAKARTA TIMUR, DKI JAKARTA",27,100,91,191
https://kawalpemilu.org#26111,"CAKUNG BARAT, CAKUNG, JAKARTA TIMUR, DKI JAKARTA",28,91,75,166
https://kawalpemilu.org#26111,"CAKUNG BARAT, CAKUNG, JAKARTA TIMUR, DKI JAKARTA",29,84,139,223
https://kawalpemilu.org#26111,"CAKUNG BARAT, CAKUNG, JAKARTA TIMUR, DKI JAKARTA",30,72,132,204
https://kawalpemilu.org#26111,"CAKUNG BARAT, CAKUNG, JAKARTA TIMUR, DKI JAKARTA",32,123,113,236
https://kawalpemilu.org#26111,"CAKUNG BARAT, CAKUNG, JAKARTA TIMUR, DKI JAKARTA",33,136,115,251
https://kawalpemilu.org#26111,"CAKUNG BARAT, CAKUNG, JAKARTA TIMUR, DKI JAKARTA",34,77,126,203
https://kawalpemilu.org#26111,"CAKUNG BARAT, CAKUNG, JAKARTA TIMUR, DKI JAKARTA",35,96,123,219
https://kawalpemilu.org#26111,"CAKUNG BARAT, CAKUNG, JAKARTA TIMUR, DKI JAKARTA",36,95,125,220
https://kawalpemilu.org#26111,"CAKUNG BARAT, CAKUNG, JAKARTA TIMUR, DKI JAKARTA",37,105,127,232
https://kawalpemilu.org#26111,"CAKUNG BARAT, CAKUNG, JAKARTA TIMUR, DKI JAKARTA",38,89,162,251
https://kawalpemilu.org#26111,"CAKUNG BARAT, CAKUNG, JAKARTA TIMUR, DKI JAKARTA",39,81,138,219
https://kawalpemilu.org#26111,"CAKUNG BARAT, CAKUNG, JAKARTA TIMUR, DKI JAKARTA",40,102,114,216
https://kawalpemilu.org#26111,"CAKUNG BARAT, CAKUNG, JAKARTA TIMUR, DKI JAKARTA",41,86,164,250
https://kawalpemilu.org#26111,"CAKUNG BARAT, CAKUNG, JAKARTA TIMUR, DKI JAKARTA",42,99,144,243
https://kawalpemilu.org#26111,"CAKUNG BARAT, CAKUNG, JAKARTA TIMUR, DKI JAKARTA",44,76,83,159
https://kawalpemilu.org#26111,"CAKUNG BARAT, CAKUNG, JAKARTA TIMUR, DKI JAKARTA",45,91,141,232
https://kawalpemilu.org#26111,"CAKUNG BARAT, CAKUNG, JAKARTA TIMUR, DKI JAKARTA",46,78,161,239
https://kawalpemilu.org#26111,"CAKUNG BARAT, CAKUNG, JAKARTA TIMUR, DKI JAKARTA",47,108,135,243
https://kawalpemilu.org#26111,"CAKUNG BARAT, CAKUNG, JAKARTA TIMUR, DKI JAKARTA",48,116,159,275
https://kawalpemilu.org#26111,"CAKUNG BARAT, CAKUNG, JAKARTA TIMUR, DKI JAKARTA",49,58,107,165
https://kawalpemilu.org#26111,"CAKUNG BARAT, CAKUNG, JAKARTA TIMUR, DKI JAKARTA",50,83,134,217
https://kawalpemilu.org#26111,"CAKUNG BARAT, CAKUNG, JAKARTA TIMUR, DKI JAKARTA",51,129,98,227
https://kawalpemilu.org#26111,"CAKUNG BARAT, CAKUNG, JAKARTA TIMUR, DKI JAKARTA",52,92,117,209
https://kawalpemilu.org#26111,"CAKUNG BARAT, CAKUNG, JAKARTA TIMUR, DKI JAKARTA",53,110,133,243
https://kawalpemilu.org#26111,"CAKUNG BARAT, CAKUNG, JAKARTA TIMUR, DKI JAKARTA",54,117,87,204
https://kawalpemilu.org#26111,"CAKUNG BARAT, CAKUNG, JAKARTA TIMUR, DKI JAKARTA",55,101,165,266
https://kawalpemilu.org#26111,"CAKUNG BARAT, CAKUNG, JAKARTA TIMUR, DKI JAKARTA",56,94,142,236
https://kawalpemilu.org#26111,"CAKUNG BARAT, CAKUNG, JAKARTA TIMUR, DKI JAKARTA",57,99,147,246
https://kawalpemilu.org#26111,"CAKUNG BARAT, CAKUNG, JAKARTA TIMUR, DKI JAKARTA",58,67,146,213
https://kawalpemilu.org#26111,"CAKUNG BARAT, CAKUNG, JAKARTA TIMUR, DKI JAKARTA",59,69,123,192
https://kawalpemilu.org#26111,"CAKUNG BARAT, CAKUNG, JAKARTA TIMUR, DKI JAKARTA",60,56,111,167
https://kawalpemilu.org#26111,"CAKUNG BARAT, CAKUNG, JAKARTA TIMUR, DKI JAKARTA",61,96,114,210
https://kawalpemilu.org#26111,"CAKUNG BARAT, CAKUNG, JAKARTA TIMUR, DKI JAKARTA",62,81,111,192
https://kawalpemilu.org#26111,"CAKUNG BARAT, CAKUNG, JAKARTA TIMUR, DKI JAKARTA",63,88,151,239
https://kawalpemilu.org#26111,"CAKUNG BARAT, CAKUNG, JAKARTA TIMUR, DKI JAKARTA",64,60,124,184
https://kawalpemilu.org#26111,"CAKUNG BARAT, CAKUNG, JAKARTA TIMUR, DKI JAKARTA",65,66,160,226
https://kawalpemilu.org#26111,"CAKUNG BARAT, CAKUNG, JAKARTA TIMUR, DKI JAKARTA",66,71,175,246
https://kawalpemilu.org#26111,"CAKUNG BARAT, CAKUNG, JAKARTA TIMUR, DKI JAKARTA",67,64,116,180
https://kawalpemilu.org#26111,"CAKUNG BARAT, CAKUNG, JAKARTA TIMUR, DKI JAKARTA",68,40,108,148
https://kawalpemilu.org#26111,"CAKUNG BARAT, CAKUNG, JAKARTA TIMUR, DKI JAKARTA",69,78,62,140
https://kawalpemilu.org#26111,"CAKUNG BARAT, CAKUNG, JAKARTA TIMUR, DKI JAKARTA",70,86,131,217
https://kawalpemilu.org#26111,"CAKUNG BARAT, CAKUNG, JAKARTA TIMUR, DKI JAKARTA",71,95,113,208
https://kawalpemilu.org#26111,"CAKUNG BARAT, CAKUNG, JAKARTA TIMUR, DKI JAKARTA",72,82,122,204
https://kawalpemilu.org#26111,"CAKUNG BARAT, CAKUNG, JAKARTA TIMUR, DKI JAKARTA",73,71,107,178
https://kawalpemilu.org#26111,"CAKUNG BARAT, CAKUNG, JAKARTA TIMUR, DKI JAKARTA",74,86,100,186
https://kawalpemilu.org#26111,"CAKUNG BARAT, CAKUNG, JAKARTA TIMUR, DKI JAKARTA",75,82,69,151
https://kawalpemilu.org#26111,"CAKUNG BARAT, CAKUNG, JAKARTA TIMUR, DKI JAKARTA",76,98,111,209
https://kawalpemilu.org#26111,"CAKUNG BARAT, CAKUNG, JAKARTA TIMUR, DKI JAKARTA",77,104,122,226
https://kawalpemilu.org#26111,"CAKUNG BARAT, CAKUNG, JAKARTA TIMUR, DKI JAKARTA",78,90,77,167
https://kawalpemilu.org#26111,"CAKUNG BARAT, CAKUNG, JAKARTA TIMUR, DKI JAKARTA",79,119,53,172
https://kawalpemilu.org#26111,"CAKUNG BARAT, CAKUNG, JAKARTA TIMUR, DKI JAKARTA",80,107,115,222
https://kawalpemilu.org#26111,"CAKUNG BARAT, CAKUNG, JAKARTA TIMUR, DKI JAKARTA",81,78,95,173
https://kawalpemilu.org#26111,"CAKUNG BARAT, CAKUNG, JAKARTA TIMUR, DKI JAKARTA",83,121,116,237
https://kawalpemilu.org#26111,"CAKUNG BARAT, CAKUNG, JAKARTA TIMUR, DKI JAKARTA",84,90,87,177
https://kawalpemilu.org#26111,"CAKUNG BARAT, CAKUNG, JAKARTA TIMUR, DKI JAKARTA",85,67,96,163
https://kawalpemilu.org#26111,"CAKUNG BARAT, CAKUNG, JAKARTA TIMUR, DKI JAKARTA",86,98,142,240
https://kawalpemilu.org#26111,"CAKUNG BARAT, CAKUNG, JAKARTA TIMUR, DKI JAKARTA",87,75,141,216
https://kawalpemilu.org#26111,"CAKUNG BARAT, CAKUNG, JAKARTA TIMUR, DKI JAKARTA",88,84,133,217
https://kawalpemilu.org#26111,"CAKUNG BARAT, CAKUNG, JAKARTA TIMUR, DKI JAKARTA",89,78,144,222
https://kawalpemilu.org#26111,"CAKUNG BARAT, CAKUNG, JAKARTA TIMUR, DKI JAKARTA",90,81,115,196
https://kawalpemilu.org#26111,"CAKUNG BARAT, CAKUNG, JAKARTA TIMUR, DKI JAKARTA",91,94,124,218
https://kawalpemilu.org#26111,"CAKUNG BARAT, CAKUNG, JAKARTA TIMUR, DKI JAKARTA",92,103,136,239
https://kawalpemilu.org#26111,"CAKUNG BARAT, CAKUNG, JAKARTA TIMUR, DKI JAKARTA",93,96,94,190
https://kawalpemilu.org#26111,"CAKUNG BARAT, CAKUNG, JAKARTA TIMUR, DKI JAKARTA",94,87,132,219
https://kawalpemilu.org#26111,"CAKUNG BARAT, CAKUNG, JAKARTA TIMUR, DKI JAKARTA",95,77,130,207
https://kawalpemilu.org#26111,"CAKUNG BARAT, CAKUNG, JAKARTA TIMUR, DKI JAKARTA",96,99,100,199
https://kawalpemilu.org#26111,"CAKUNG BARAT, CAKUNG, JAKARTA TIMUR, DKI JAKARTA",97,97,132,229
https://kawalpemilu.org#26111,"CAKUNG BARAT, CAKUNG, JAKARTA TIMUR, DKI JAKARTA",98,91,125,216
https://kawalpemilu.org#26111,"CAKUNG BARAT, CAKUNG, JAKARTA TIMUR, DKI JAKARTA",99,76,141,217
https://kawalpemilu.org#26111,"CAKUNG BARAT, CAKUNG, JAKARTA TIMUR, DKI JAKARTA",101,64,145,209
https://kawalpemilu.org#26111,"CAKUNG BARAT, CAKUNG, JAKARTA TIMUR, DKI JAKARTA",102,59,90,149
https://kawalpemilu.org#26111,"CAKUNG BARAT, CAKUNG, JAKARTA TIMUR, DKI JAKARTA",105,91,164,255
https://kawalpemilu.org#26111,"CAKUNG BARAT, CAKUNG, JAKARTA TIMUR, DKI JAKARTA",106,69,154,223
https://kawalpemilu.org#26111,"CAKUNG BARAT, CAKUNG, JAKARTA TIMUR, DKI JAKARTA",107,102,161,263
https://kawalpemilu.org#26111,"CAKUNG BARAT, CAKUNG, JAKARTA TIMUR, DKI JAKARTA",108,79,147,226
https://kawalpemilu.org#26111,"CAKUNG BARAT, CAKUNG, JAKARTA TIMUR, DKI JAKARTA",110,92,96,188
https://kawalpemilu.org#26111,"CAKUNG BARAT, CAKUNG, JAKARTA TIMUR, DKI JAKARTA",112,81,79,160
https://kawalpemilu.org#26111,"CAKUNG BARAT, CAKUNG, JAKARTA TIMUR, DKI JAKARTA",113,109,127,236
https://kawalpemilu.org#26111,"CAKUNG BARAT, CAKUNG, JAKARTA TIMUR, DKI JAKARTA",114,91,125,216
https://kawalpemilu.org#26111,"CAKUNG BARAT, CAKUNG, JAKARTA TIMUR, DKI JAKARTA",115,71,82,153
https://kawalpemilu.org#26111,"CAKUNG BARAT, CAKUNG, JAKARTA TIMUR, DKI JAKARTA",116,83,141,224
https://kawalpemilu.org#26111,"CAKUNG BARAT, CAKUNG, JAKARTA TIMUR, DKI JAKARTA",117,85,118,203
https://kawalpemilu.org#26111,"CAKUNG BARAT, CAKUNG, JAKARTA TIMUR, DKI JAKARTA",118,63,132,195
https://kawalpemilu.org#26111,"CAKUNG BARAT, CAKUNG, JAKARTA TIMUR, DKI JAKARTA",119,106,162,268
https://kawalpemilu.org#26111,"CAKUNG BARAT, CAKUNG, JAKARTA TIMUR, DKI JAKARTA",120,88,147,235
https://kawalpemilu.org#26111,"CAKUNG BARAT, CAKUNG, JAKARTA TIMUR, DKI JAKARTA",121,89,126,215
https://kawalpemilu.org#26111,"CAKUNG BARAT, CAKUNG, JAKARTA TIMUR, DKI JAKARTA",122,101,100,201
https://kawalpemilu.org#26111,"CAKUNG BARAT, CAKUNG, JAKARTA TIMUR, DKI JAKARTA",123,95,123,218
https://kawalpemilu.org#26111,"CAKUNG BARAT, CAKUNG, JAKARTA TIMUR, DKI JAKARTA",124,99,124,223
https://kawalpemilu.org#26111,"CAKUNG BARAT, CAKUNG, JAKARTA TIMUR, DKI JAKARTA",125,103,119,222
https://kawalpemilu.org#26111,"CAKUNG BARAT, CAKUNG, JAKARTA TIMUR, DKI JAKARTA",126,82,107,189
https://kawalpemilu.org#26111,"CAKUNG BARAT, CAKUNG, JAKARTA TIMUR, DKI JAKARTA",127,94,104,198
https://kawalpemilu.org#26111,"CAKUNG BARAT, CAKUNG, JAKARTA TIMUR, DKI JAKARTA",128,112,130,242
https://kawalpemilu.org#26111,"CAKUNG BARAT, CAKUNG, JAKARTA TIMUR, DKI JAKARTA",129,101,112,213
https://kawalpemilu.org#26111,"CAKUNG BARAT, CAKUNG, JAKARTA TIMUR, DKI JAKARTA",130,83,147,230
https://kawalpemilu.org#26111,"CAKUNG BARAT, CAKUNG, JAKARTA TIMUR, DKI JAKARTA",131,111,85,196
https://kawalpemilu.org#26111,"CAKUNG BARAT, CAKUNG, JAKARTA TIMUR, DKI JAKARTA",132,80,90,170
https://kawalpemilu.org#26111,"CAKUNG BARAT, CAKUNG, JAKARTA TIMUR, DKI JAKARTA",133,100,86,186
https://kawalpemilu.org#26111,"CAKUNG BARAT, CAKUNG, JAKARTA TIMUR, DKI JAKARTA",134,91,68,159
https://kawalpemilu.org#26111,"CAKUNG BARAT, CAKUNG, JAKARTA TIMUR, DKI JAKARTA",135,156,97,253
https://kawalpemilu.org#26111,"CAKUNG BARAT, CAKUNG, JAKARTA TIMUR, DKI JAKARTA",136,114,95,209
https://kawalpemilu.org#26111,"CAKUNG BARAT, CAKUNG, JAKARTA TIMUR, DKI JAKARTA",137,114,115,229
https://kawalpemilu.org#26111,"CAKUNG BARAT, CAKUNG, JAKARTA TIMUR, DKI JAKARTA",138,114,100,214
https://kawalpemilu.org#26111,"CAKUNG BARAT, CAKUNG, JAKARTA TIMUR, DKI JAKARTA",139,103,116,216
https://kawalpemilu.org#26111,"CAKUNG BARAT, CAKUNG, JAKARTA TIMUR, DKI JAKARTA",141,97,107,204
https://kawalpemilu.org#26111,"CAKUNG BARAT, CAKUNG, JAKARTA TIMUR, DKI JAKARTA",143,102,106,208
https://kawalpemilu.org#26111,"CAKUNG BARAT, CAKUNG, JAKARTA TIMUR, DKI JAKARTA",144,153,42,195
https://kawalpemilu.org#26111,"CAKUNG BARAT, CAKUNG, JAKARTA TIMUR, DKI JAKARTA",145,140,36,176
https://kawalpemilu.org#26111,"CAKUNG BARAT, CAKUNG, JAKARTA TIMUR, DKI JAKARTA",146,111,50,161
https://kawalpemilu.org#26111,"CAKUNG BARAT, CAKUNG, JAKARTA TIMUR, DKI JAKARTA",147,50,140,190
https://kawalpemilu.org#26111,"CAKUNG BARAT, CAKUNG, JAKARTA TIMUR, DKI JAKARTA",148,61,157,218
https://kawalpemilu.org#26111,"CAKUNG BARAT, CAKUNG, JAKARTA TIMUR, DKI JAKARTA",149,60,131,191
https://kawalpemilu.org#26111,"CAKUNG BARAT, CAKUNG, JAKARTA TIMUR, DKI JAKARTA",150,56,131,187
https://kawalpemilu.org#26111,"CAKUNG BARAT, CAKUNG, JAKARTA TIMUR, DKI JAKARTA",151,93,124,217
https://kawalpemilu.org#26111,"CAKUNG BARAT, CAKUNG, JAKARTA TIMUR, DKI JAKARTA",152,63,88,151
https://kawalpemilu.org#26111,"CAKUNG BARAT, CAKUNG, JAKARTA TIMUR, DKI JAKARTA",153,52,155,207
https://kawalpemilu.org#26111,"CAKUNG BARAT, CAKUNG, JAKARTA TIMUR, DKI JAKARTA",154,62,151,213
https://kawalpemilu.org#26111,"CAKUNG BARAT, CAKUNG, JAKARTA TIMUR, DKI JAKARTA",155,95,135,230
https://kawalpemilu.org#26111,"CAKUNG BARAT, CAKUNG, JAKARTA TIMUR, DKI JAKARTA",156,74,138,212
https://kawalpemilu.org#26111,"CAKUNG BARAT, CAKUNG, JAKARTA TIMUR, DKI JAKARTA",157,68,124,192
https://kawalpemilu.org#26111,"CAKUNG BARAT, CAKUNG, JAKARTA TIMUR, DKI JAKARTA",158,60,161,221
https://kawalpemilu.org#26111,"CAKUNG BARAT, CAKUNG, JAKARTA TIMUR, DKI JAKARTA",159,76,143,219
https://kawalpemilu.org#26111,"CAKUNG BARAT, CAKUNG, JAKARTA TIMUR, DKI JAKARTA",160,45,209,254
https://kawalpemilu.org#26111,"CAKUNG BARAT, CAKUNG, JAKARTA TIMUR, DKI JAKARTA",161,51,126,177
https://kawalpemilu.org#26111,"CAKUNG BARAT, CAKUNG, JAKARTA TIMUR, DKI JAKARTA",162,50,132,182
https://kawalpemilu.org#26111,"CAKUNG BARAT, CAKUNG, JAKARTA TIMUR, DKI JAKARTA",163,143,51,194
https://kawalpemilu.org#26111,"CAKUNG BARAT, CAKUNG, JAKARTA TIMUR, DKI JAKARTA",164,162,52,214
https://kawalpemilu.org#26111,"CAKUNG BARAT, CAKUNG, JAKARTA TIMUR, DKI JAKARTA",168,140,72,212
https://kawalpemilu.org#26111,"CAKUNG BARAT, CAKUNG, JAKARTA TIMUR, DKI JAKARTA",171,49,80,129
https://kawalpemilu.org#26111,"CAKUNG BARAT, CAKUNG, JAKARTA TIMUR, DKI JAKARTA",172,76,135,211
https://kawalpemilu.org#26111,"CAKUNG BARAT, CAKUNG, JAKARTA TIMUR, DKI JAKARTA",173,48,91,139
https://kawalpemilu.org#26111,"CAKUNG BARAT, CAKUNG, JAKARTA TIMUR, DKI JAKARTA",174,63,68,131
https://kawalpemilu.org#26111,"CAKUNG BARAT, CAKUNG, JAKARTA TIMUR, DKI JAKARTA",175,67,100,167
https://kawalpemilu.org#26111,"CAKUNG BARAT, CAKUNG, JAKARTA TIMUR, DKI JAKARTA",177,77,94,171
https://kawalpemilu.org#26111,"CAKUNG BARAT, CAKUNG, JAKARTA TIMUR, DKI JAKARTA",178,91,91,182
https://kawalpemilu.org#26111,"CAKUNG BARAT, CAKUNG, JAKARTA TIMUR, DKI JAKARTA",179,79,96,175
https://kawalpemilu.org#26111,"CAKUNG BARAT, CAKUNG, JAKARTA TIMUR, DKI JAKARTA",181,111,25,136
https://kawalpemilu.org#26111,"CAKUNG BARAT, CAKUNG, JAKARTA TIMUR, DKI JAKARTA",184,108,81,189
https://kawalpemilu.org#26111,"CAKUNG BARAT, CAKUNG, JAKARTA TIMUR, DKI JAKARTA",185,62,102,164
https://kawalpemilu.org#26113,"DUREN SAWIT, DUREN SAWIT, JAKARTA TIMUR, DKI JAKARTA",1,132,114,246
https://kawalpemilu.org#26113,"DUREN SAWIT, DUREN SAWIT, JAKARTA TIMUR, DKI JAKARTA",2,132,105,237
https://kawalpemilu.org#26113,"DUREN SAWIT, DUREN SAWIT, JAKARTA TIMUR, DKI JAKARTA",3,94,169,263
https://kawalpemilu.org#26113,"DUREN SAWIT, DUREN SAWIT, JAKARTA TIMUR, DKI JAKARTA",4,110,149,259
https://kawalpemilu.org#26113,"DUREN SAWIT, DUREN SAWIT, JAKARTA TIMUR, DKI JAKARTA",5,113,158,271
https://kawalpemilu.org#26113,"DUREN SAWIT, DUREN SAWIT, JAKARTA TIMUR, DKI JAKARTA",6,230,41,271
https://kawalpemilu.org#26113,"DUREN SAWIT, DUREN SAWIT, JAKARTA TIMUR, DKI JAKARTA",7,220,36,256
https://kawalpemilu.org#26113,"DUREN SAWIT, DUREN SAWIT, JAKARTA TIMUR, DKI JAKARTA",9,150,115,265
https://kawalpemilu.org#26113,"DUREN SAWIT, DUREN SAWIT, JAKARTA TIMUR, DKI JAKARTA",10,99,128,227
https://kawalpemilu.org#26113,"DUREN SAWIT, DUREN SAWIT, JAKARTA TIMUR, DKI JAKARTA",11,126,111,237
https://kawalpemilu.org#26113,"DUREN SAWIT, DUREN SAWIT, JAKARTA TIMUR, DKI JAKARTA",12,131,121,252
https://kawalpemilu.org#26113,"DUREN SAWIT, DUREN SAWIT, JAKARTA TIMUR, DKI JAKARTA",13,109,141,250
https://kawalpemilu.org#26113,"DUREN SAWIT, DUREN SAWIT, JAKARTA TIMUR, DKI JAKARTA",16,139,111,250
https://kawalpemilu.org#26113,"DUREN SAWIT, DUREN SAWIT, JAKARTA TIMUR, DKI JAKARTA",17,100,124,224
https://kawalpemilu.org#26113,"DUREN SAWIT, DUREN SAWIT, JAKARTA TIMUR, DKI JAKARTA",18,75,155,230
https://kawalpemilu.org#26113,"DUREN SAWIT, DUREN SAWIT, JAKARTA TIMUR, DKI JAKARTA",19,103,150,253
https://kawalpemilu.org#26113,"DUREN SAWIT, DUREN SAWIT, JAKARTA TIMUR, DKI JAKARTA",21,98,147,245
https://kawalpemilu.org#26113,"DUREN SAWIT, DUREN SAWIT, JAKARTA TIMUR, DKI JAKARTA",22,90,133,223
https://kawalpemilu.org#26113,"DUREN SAWIT, DUREN SAWIT, JAKARTA TIMUR, DKI JAKARTA",23,92,134,226
https://kawalpemilu.org#26113,"DUREN SAWIT, DUREN SAWIT, JAKARTA TIMUR, DKI JAKARTA",24,102,115,217
https://kawalpemilu.org#26113,"DUREN SAWIT, DUREN SAWIT, JAKARTA TIMUR, DKI JAKARTA",25,55,73,128
https://kawalpemilu.org#26113,"DUREN SAWIT, DUREN SAWIT, JAKARTA TIMUR, DKI JAKARTA",27,77,111,188
https://kawalpemilu.org#26113,"DUREN SAWIT, DUREN SAWIT, JAKARTA TIMUR, DKI JAKARTA",28,119,123,242
https://kawalpemilu.org#26113,"DUREN SAWIT, DUREN SAWIT, JAKARTA TIMUR, DKI JAKARTA",29,98,151,249
https://kawalpemilu.org#26113,"DUREN SAWIT, DUREN SAWIT, JAKARTA TIMUR, DKI JAKARTA",30,89,137,226
https://kawalpemilu.org#26113,"DUREN SAWIT, DUREN SAWIT, JAKARTA TIMUR, DKI JAKARTA",31,69,180,249
https://kawalpemilu.org#26113,"DUREN SAWIT, DUREN SAWIT, JAKARTA TIMUR, DKI JAKARTA",32,110,138,248
https://kawalpemilu.org#26113,"DUREN SAWIT, DUREN SAWIT, JAKARTA TIMUR, DKI JAKARTA",33,105,146,251
https://kawalpemilu.org#26113,"DUREN SAWIT, DUREN SAWIT, JAKARTA TIMUR, DKI JAKARTA",34,84,152,236
https://kawalpemilu.org#26113,"DUREN SAWIT, DUREN SAWIT, JAKARTA TIMUR, DKI JAKARTA",35,124,114,238
https://kawalpemilu.org#26113,"DUREN SAWIT, DUREN SAWIT, JAKARTA TIMUR, DKI JAKARTA",36,83,119,202
https://kawalpemilu.org#26113,"DUREN SAWIT, DUREN SAWIT, JAKARTA TIMUR, DKI JAKARTA",38,81,163,244
https://kawalpemilu.org#26113,"DUREN SAWIT, DUREN SAWIT, JAKARTA TIMUR, DKI JAKARTA",39,122,104,226
https://kawalpemilu.org#26113,"DUREN SAWIT, DUREN SAWIT, JAKARTA TIMUR, DKI JAKARTA",40,129,116,245
https://kawalpemilu.org#26113,"DUREN SAWIT, DUREN SAWIT, JAKARTA TIMUR, DKI JAKARTA",41,97,131,228
https://kawalpemilu.org#26113,"DUREN SAWIT, DUREN SAWIT, JAKARTA TIMUR, DKI JAKARTA",42,128,94,222
https://kawalpemilu.org#26113,"DUREN SAWIT, DUREN SAWIT, JAKARTA TIMUR, DKI JAKARTA",43,110,117,227
https://kawalpemilu.org#26113,"DUREN SAWIT, DUREN SAWIT, JAKARTA TIMUR, DKI JAKARTA",45,79,143,222
https://kawalpemilu.org#26113,"DUREN SAWIT, DUREN SAWIT, JAKARTA TIMUR, DKI JAKARTA",46,106,129,235
https://kawalpemilu.org#26113,"DUREN SAWIT, DUREN SAWIT, JAKARTA TIMUR, DKI JAKARTA",47,107,132,239
https://kawalpemilu.org#26113,"DUREN SAWIT, DUREN SAWIT, JAKARTA TIMUR, DKI JAKARTA",48,61,150,211
https://kawalpemilu.org#26113,"DUREN SAWIT, DUREN SAWIT, JAKARTA TIMUR, DKI JAKARTA",49,186,59,245
https://kawalpemilu.org#26113,"DUREN SAWIT, DUREN SAWIT, JAKARTA TIMUR, DKI JAKARTA",50,133,109,242
https://kawalpemilu.org#26113,"DUREN SAWIT, DUREN SAWIT, JAKARTA TIMUR, DKI JAKARTA",52,82,162,244
https://kawalpemilu.org#26113,"DUREN SAWIT, DUREN SAWIT, JAKARTA TIMUR, DKI JAKARTA",53,66,128,194
https://kawalpemilu.org#26113,"DUREN SAWIT, DUREN SAWIT, JAKARTA TIMUR, DKI JAKARTA",54,98,132,230
https://kawalpemilu.org#26113,"DUREN SAWIT, DUREN SAWIT, JAKARTA TIMUR, DKI JAKARTA",55,80,192,272
https://kawalpemilu.org#26113,"DUREN SAWIT, DUREN SAWIT, JAKARTA TIMUR, DKI JAKARTA",56,90,162,252
https://kawalpemilu.org#26113,"DUREN SAWIT, DUREN SAWIT, JAKARTA TIMUR, DKI JAKARTA",57,81,160,241
https://kawalpemilu.org#26113,"DUREN SAWIT, DUREN SAWIT, JAKARTA TIMUR, DKI JAKARTA",58,78,177,255
https://kawalpemilu.org#26113,"DUREN SAWIT, DUREN SAWIT, JAKARTA TIMUR, DKI JAKARTA",59,85,125,210
https://kawalpemilu.org#26113,"DUREN SAWIT, DUREN SAWIT, JAKARTA TIMUR, DKI JAKARTA",60,122,111,233
https://kawalpemilu.org#26113,"DUREN SAWIT, DUREN SAWIT, JAKARTA TIMUR, DKI JAKARTA",62,97,160,257
https://kawalpemilu.org#26113,"DUREN SAWIT, DUREN SAWIT, JAKARTA TIMUR, DKI JAKARTA",63,87,158,245
https://kawalpemilu.org#26113,"DUREN SAWIT, DUREN SAWIT, JAKARTA TIMUR, DKI JAKARTA",64,136,121,257
https://kawalpemilu.org#26113,"DUREN SAWIT, DUREN SAWIT, JAKARTA TIMUR, DKI JAKARTA",65,147,93,240
https://kawalpemilu.org#26113,"DUREN SAWIT, DUREN SAWIT, JAKARTA TIMUR, DKI JAKARTA",67,120,92,212
https://kawalpemilu.org#26113,"DUREN SAWIT, DUREN SAWIT, JAKARTA TIMUR, DKI JAKARTA",69,131,121,252
https://kawalpemilu.org#26113,"DUREN SAWIT, DUREN SAWIT, JAKARTA TIMUR, DKI JAKARTA",70,135,108,243
https://kawalpemilu.org#26113,"DUREN SAWIT, DUREN SAWIT, JAKARTA TIMUR, DKI JAKARTA",71,117,119,236
https://kawalpemilu.org#26113,"DUREN SAWIT, DUREN SAWIT, JAKARTA TIMUR, DKI JAKARTA",72,120,89,209
https://kawalpemilu.org#26113,"DUREN SAWIT, DUREN SAWIT, JAKARTA TIMUR, DKI JAKARTA",73,128,113,241
https://kawalpemilu.org#26113,"DUREN SAWIT, DUREN SAWIT, JAKARTA TIMUR, DKI JAKARTA",74,100,126,226
https://kawalpemilu.org#26113,"DUREN SAWIT, DUREN SAWIT, JAKARTA TIMUR, DKI JAKARTA",75,107,123,230
https://kawalpemilu.org#26113,"DUREN SAWIT, DUREN SAWIT, JAKARTA TIMUR, DKI JAKARTA",76,90,167,257
https://kawalpemilu.org#26113,"DUREN SAWIT, DUREN SAWIT, JAKARTA TIMUR, DKI JAKARTA",77,73,156,229
https://kawalpemilu.org#26113,"DUREN SAWIT, DUREN SAWIT, JAKARTA TIMUR, DKI JAKARTA",78,77,176,253
https://kawalpemilu.org#26113,"DUREN SAWIT, DUREN SAWIT, JAKARTA TIMUR, DKI JAKARTA",79,81,153,234
https://kawalpemilu.org#26113,"DUREN SAWIT, DUREN SAWIT, JAKARTA TIMUR, DKI JAKARTA",80,103,150,253
https://kawalpemilu.org#26113,"DUREN SAWIT, DUREN SAWIT, JAKARTA TIMUR, DKI JAKARTA",81,95,153,248
https://kawalpemilu.org#26113,"DUREN SAWIT, DUREN SAWIT, JAKARTA TIMUR, DKI JAKARTA",82,91,144,235
https://kawalpemilu.org#26113,"DUREN SAWIT, DUREN SAWIT, JAKARTA TIMUR, DKI JAKARTA",83,96,142,238
https://kawalpemilu.org#26113,"DUREN SAWIT, DUREN SAWIT, JAKARTA TIMUR, DKI JAKARTA",84,81,110,191
https://kawalpemilu.org#26113,"DUREN SAWIT, DUREN SAWIT, JAKARTA TIMUR, DKI JAKARTA",85,102,144,246
https://kawalpemilu.org#26113,"DUREN SAWIT, DUREN SAWIT, JAKARTA TIMUR, DKI JAKARTA",86,91,159,250
https://kawalpemilu.org#26113,"DUREN SAWIT, DUREN SAWIT, JAKARTA TIMUR, DKI JAKARTA",87,82,162,244
https://kawalpemilu.org#26113,"DUREN SAWIT, DUREN SAWIT, JAKARTA TIMUR, DKI JAKARTA",88,94,121,215
https://kawalpemilu.org#26113,"DUREN SAWIT, DUREN SAWIT, JAKARTA TIMUR, DKI JAKARTA",90,90,136,226
https://kawalpemilu.org#26113,"DUREN SAWIT, DUREN SAWIT, JAKARTA TIMUR, DKI JAKARTA",91,75,173,248
https://kawalpemilu.org#26113,"DUREN SAWIT, DUREN SAWIT, JAKARTA TIMUR, DKI JAKARTA",92,186,72,258
https://kawalpemilu.org#26113,"DUREN SAWIT, DUREN SAWIT, JAKARTA TIMUR, DKI JAKARTA",93,156,66,222
https://kawalpemilu.org#26113,"DUREN SAWIT, DUREN SAWIT, JAKARTA TIMUR, DKI JAKARTA",94,190,67,257
https://kawalpemilu.org#26113,"DUREN SAWIT, DUREN SAWIT, JAKARTA TIMUR, DKI JAKARTA",95,171,62,233
https://kawalpemilu.org#26113,"DUREN SAWIT, DUREN SAWIT, JAKARTA TIMUR, DKI JAKARTA",96,184,59,243
https://kawalpemilu.org#26113,"DUREN SAWIT, DUREN SAWIT, JAKARTA TIMUR, DKI JAKARTA",97,156,53,209
https://kawalpemilu.org#26113,"DUREN SAWIT, DUREN SAWIT, JAKARTA TIMUR, DKI JAKARTA",98,148,65,213
https://kawalpemilu.org#26113,"DUREN SAWIT, DUREN SAWIT, JAKARTA TIMUR, DKI JAKARTA",100,164,79,243
https://kawalpemilu.org#26113,"DUREN SAWIT, DUREN SAWIT, JAKARTA TIMUR, DKI JAKARTA",102,145,113,258
https://kawalpemilu.org#26113,"DUREN SAWIT, DUREN SAWIT, JAKARTA TIMUR, DKI JAKARTA",103,146,88,234
https://kawalpemilu.org#26113,"DUREN SAWIT, DUREN SAWIT, JAKARTA TIMUR, DKI JAKARTA",104,133,113,246
https://kawalpemilu.org#26113,"DUREN SAWIT, DUREN SAWIT, JAKARTA TIMUR, DKI JAKARTA",105,112,117,229
https://kawalpemilu.org#26113,"DUREN SAWIT, DUREN SAWIT, JAKARTA TIMUR, DKI JAKARTA",106,92,151,243
https://kawalpemilu.org#26113,"DUREN SAWIT, DUREN SAWIT, JAKARTA TIMUR, DKI JAKARTA",107,122,105,227
https://kawalpemilu.org#26113,"DUREN SAWIT, DUREN SAWIT, JAKARTA TIMUR, DKI JAKARTA",108,132,115,247
https://kawalpemilu.org#26113,"DUREN SAWIT, DUREN SAWIT, JAKARTA TIMUR, DKI JAKARTA",109,87,124,211
https://kawalpemilu.org#26113,"DUREN SAWIT, DUREN SAWIT, JAKARTA TIMUR, DKI JAKARTA",110,120,135,255
https://kawalpemilu.org#26113,"DUREN SAWIT, DUREN SAWIT, JAKARTA TIMUR, DKI JAKARTA",111,120,107,227
https://kawalpemilu.org#26113,"DUREN SAWIT, DUREN SAWIT, JAKARTA TIMUR, DKI JAKARTA",113,98,143,241
https://kawalpemilu.org#26113,"DUREN SAWIT, DUREN SAWIT, JAKARTA TIMUR, DKI JAKARTA",114,99,153,252
https://kawalpemilu.org#26113,"DUREN SAWIT, DUREN SAWIT, JAKARTA TIMUR, DKI JAKARTA",115,87,168,255
https://kawalpemilu.org#26113,"DUREN SAWIT, DUREN SAWIT, JAKARTA TIMUR, DKI JAKARTA",116,83,159,242
https://kawalpemilu.org#26113,"DUREN SAWIT, DUREN SAWIT, JAKARTA TIMUR, DKI JAKARTA",117,92,150,242
https://kawalpemilu.org#26113,"DUREN SAWIT, DUREN SAWIT, JAKARTA TIMUR, DKI JAKARTA",119,83,103,186
https://kawalpemilu.org#26113,"DUREN SAWIT, DUREN SAWIT, JAKARTA TIMUR, DKI JAKARTA",120,72,183,255
https://kawalpemilu.org#26113,"DUREN SAWIT, DUREN SAWIT, JAKARTA TIMUR, DKI JAKARTA",121,94,153,247
https://kawalpemilu.org#26113,"DUREN SAWIT, DUREN SAWIT, JAKARTA TIMUR, DKI JAKARTA",122,0,0,0
https://kawalpemilu.org#26113,"DUREN SAWIT, DUREN SAWIT, JAKARTA TIMUR, DKI JAKARTA",123,130,111,241
https://kawalpemilu.org#26113,"DUREN SAWIT, DUREN SAWIT, JAKARTA TIMUR, DKI JAKARTA",124,139,104,243
https://kawalpemilu.org#26113,"DUREN SAWIT, DUREN SAWIT, JAKARTA TIMUR, DKI JAKARTA",125,161,74,235
https://kawalpemilu.org#26113,"DUREN SAWIT, DUREN SAWIT, JAKARTA TIMUR, DKI JAKARTA",127,173,59,232
https://kawalpemilu.org#26113,"DUREN SAWIT, DUREN SAWIT, JAKARTA TIMUR, DKI JAKARTA",128,171,51,222
https://kawalpemilu.org#26113,"DUREN SAWIT, DUREN SAWIT, JAKARTA TIMUR, DKI JAKARTA",130,93,143,236
https://kawalpemilu.org#26113,"DUREN SAWIT, DUREN SAWIT, JAKARTA TIMUR, DKI JAKARTA",131,98,136,234
https://kawalpemilu.org#26113,"DUREN SAWIT, DUREN SAWIT, JAKARTA TIMUR, DKI JAKARTA",132,129,123,252
https://kawalpemilu.org#26113,"DUREN SAWIT, DUREN SAWIT, JAKARTA TIMUR, DKI JAKARTA",133,135,121,256
https://kawalpemilu.org#26113,"DUREN SAWIT, DUREN SAWIT, JAKARTA TIMUR, DKI JAKARTA",135,128,105,233
https://kawalpemilu.org#26113,"DUREN SAWIT, DUREN SAWIT, JAKARTA TIMUR, DKI JAKARTA",136,110,142,252
https://kawalpemilu.org#26113,"DUREN SAWIT, DUREN SAWIT, JAKARTA TIMUR, DKI JAKARTA",138,72,187,259
https://kawalpemilu.org#26113,"DUREN SAWIT, DUREN SAWIT, JAKARTA TIMUR, DKI JAKARTA",140,56,184,240
https://kawalpemilu.org#26113,"DUREN SAWIT, DUREN SAWIT, JAKARTA TIMUR, DKI JAKARTA",141,66,165,231
https://kawalpemilu.org#26113,"DUREN SAWIT, DUREN SAWIT, JAKARTA TIMUR, DKI JAKARTA",142,80,158,238
https://kawalpemilu.org#26113,"DUREN SAWIT, DUREN SAWIT, JAKARTA TIMUR, DKI JAKARTA",143,105,151,256
https://kawalpemilu.org#26113,"DUREN SAWIT, DUREN SAWIT, JAKARTA TIMUR, DKI JAKARTA",144,113,125,238
https://kawalpemilu.org#26113,"DUREN SAWIT, DUREN SAWIT, JAKARTA TIMUR, DKI JAKARTA",145,139,128,267
https://kawalpemilu.org#26113,"DUREN SAWIT, DUREN SAWIT, JAKARTA TIMUR, DKI JAKARTA",146,145,122,267
https://kawalpemilu.org#26113,"DUREN SAWIT, DUREN SAWIT, JAKARTA TIMUR, DKI JAKARTA",147,117,95,212
https://kawalpemilu.org#26113,"DUREN SAWIT, DUREN SAWIT, JAKARTA TIMUR, DKI JAKARTA",148,113,113,226
https://kawalpemilu.org#26113,"DUREN SAWIT, DUREN SAWIT, JAKARTA TIMUR, DKI JAKARTA",149,106,88,194
https://kawalpemilu.org#26113,"DUREN SAWIT, DUREN SAWIT, JAKARTA TIMUR, DKI JAKARTA",150,82,148,230
https://kawalpemilu.org#26113,"DUREN SAWIT, DUREN SAWIT, JAKARTA TIMUR, DKI JAKARTA",151,107,145,252
https://kawalpemilu.org#26113,"DUREN SAWIT, DUREN SAWIT, JAKARTA TIMUR, DKI JAKARTA",152,95,145,240
https://kawalpemilu.org#26113,"DUREN SAWIT, DUREN SAWIT, JAKARTA TIMUR, DKI JAKARTA",153,101,119,220
https://kawalpemilu.org#26113,"DUREN SAWIT, DUREN SAWIT, JAKARTA TIMUR, DKI JAKARTA",154,172,81,253
https://kawalpemilu.org#26113,"DUREN SAWIT, DUREN SAWIT, JAKARTA TIMUR, DKI JAKARTA",155,101,119,220
https://kawalpemilu.org#26113,"DUREN SAWIT, DUREN SAWIT, JAKARTA TIMUR, DKI JAKARTA",156,135,90,225
https://kawalpemilu.org#26113,"DUREN SAWIT, DUREN SAWIT, JAKARTA TIMUR, DKI JAKARTA",157,141,121,262
https://kawalpemilu.org#26113,"DUREN SAWIT, DUREN SAWIT, JAKARTA TIMUR, DKI JAKARTA",158,189,43,232
https://kawalpemilu.org#26113,"DUREN SAWIT, DUREN SAWIT, JAKARTA TIMUR, DKI JAKARTA",159,131,97,228
https://kawalpemilu.org#26113,"DUREN SAWIT, DUREN SAWIT, JAKARTA TIMUR, DKI JAKARTA",160,145,96,241
https://kawalpemilu.org#26113,"DUREN SAWIT, DUREN SAWIT, JAKARTA TIMUR, DKI JAKARTA",161,117,108,225
https://kawalpemilu.org#26113,"DUREN SAWIT, DUREN SAWIT, JAKARTA TIMUR, DKI JAKARTA",162,132,123,255
https://kawalpemilu.org#26113,"DUREN SAWIT, DUREN SAWIT, JAKARTA TIMUR, DKI JAKARTA",163,108,140,248
https://kawalpemilu.org#26113,"DUREN SAWIT, DUREN SAWIT, JAKARTA TIMUR, DKI JAKARTA",166,141,118,259
https://kawalpemilu.org#26113,"DUREN SAWIT, DUREN SAWIT, JAKARTA TIMUR, DKI JAKARTA",169,89,147,236
https://kawalpemilu.org#26113,"DUREN SAWIT, DUREN SAWIT, JAKARTA TIMUR, DKI JAKARTA",170,161,84,245
https://kawalpemilu.org#26113,"DUREN SAWIT, DUREN SAWIT, JAKARTA TIMUR, DKI JAKARTA",171,163,84,247
https://kawalpemilu.org#26113,"DUREN SAWIT, DUREN SAWIT, JAKARTA TIMUR, DKI JAKARTA",172,161,73,234
https://kawalpemilu.org#26113,"DUREN SAWIT, DUREN SAWIT, JAKARTA TIMUR, DKI JAKARTA",173,182,69,251
https://kawalpemilu.org#26113,"DUREN SAWIT, DUREN SAWIT, JAKARTA TIMUR, DKI JAKARTA",174,155,107,262
https://kawalpemilu.org#26113,"DUREN SAWIT, DUREN SAWIT, JAKARTA TIMUR, DKI JAKARTA",175,140,120,263
https://kawalpemilu.org#26113,"DUREN SAWIT, DUREN SAWIT, JAKARTA TIMUR, DKI JAKARTA",176,180,79,259
https://kawalpemilu.org#26113,"DUREN SAWIT, DUREN SAWIT, JAKARTA TIMUR, DKI JAKARTA",177,162,78,240
https://kawalpemilu.org#26113,"DUREN SAWIT, DUREN SAWIT, JAKARTA TIMUR, DKI JAKARTA",178,155,94,249
https://kawalpemilu.org#26113,"DUREN SAWIT, DUREN SAWIT, JAKARTA TIMUR, DKI JAKARTA",179,160,89,249
https://kawalpemilu.org#26113,"DUREN SAWIT, DUREN SAWIT, JAKARTA TIMUR, DKI JAKARTA",180,107,118,225
https://kawalpemilu.org#26113,"DUREN SAWIT, DUREN SAWIT, JAKARTA TIMUR, DKI JAKARTA",181,115,70,185
https://kawalpemilu.org#26113,"DUREN SAWIT, DUREN SAWIT, JAKARTA TIMUR, DKI JAKARTA",182,143,92,235
https://kawalpemilu.org#26113,"DUREN SAWIT, DUREN SAWIT, JAKARTA TIMUR, DKI JAKARTA",183,134,113,247
https://kawalpemilu.org#26113,"DUREN SAWIT, DUREN SAWIT, JAKARTA TIMUR, DKI JAKARTA",184,127,80,207
https://kawalpemilu.org#26113,"DUREN SAWIT, DUREN SAWIT, JAKARTA TIMUR, DKI JAKARTA",185,80,125,205
https://kawalpemilu.org#26113,"DUREN SAWIT, DUREN SAWIT, JAKARTA TIMUR, DKI JAKARTA",186,67,116,183
https://kawalpemilu.org#26113,"DUREN SAWIT, DUREN SAWIT, JAKARTA TIMUR, DKI JAKARTA",188,103,108,211
https://kawalpemilu.org#26113,"DUREN SAWIT, DUREN SAWIT, JAKARTA TIMUR, DKI JAKARTA",189,56,104,160
https://kawalpemilu.org#26113,"DUREN SAWIT, DUREN SAWIT, JAKARTA TIMUR, DKI JAKARTA",190,99,64,163
https://kawalpemilu.org#26113,"DUREN SAWIT, DUREN SAWIT, JAKARTA TIMUR, DKI JAKARTA",192,105,94,199
https://kawalpemilu.org#26114,"PONDOK BAMBU, DUREN SAWIT, JAKARTA TIMUR, DKI JAKARTA",1,119,142,261
https://kawalpemilu.org#26114,"PONDOK BAMBU, DUREN SAWIT, JAKARTA TIMUR, DKI JAKARTA",2,96,153,249
https://kawalpemilu.org#26114,"PONDOK BAMBU, DUREN SAWIT, JAKARTA TIMUR, DKI JAKARTA",5,117,134,251
https://kawalpemilu.org#26114,"PONDOK BAMBU, DUREN SAWIT, JAKARTA TIMUR, DKI JAKARTA",6,69,155,224
https://kawalpemilu.org#26114,"PONDOK BAMBU, DUREN SAWIT, JAKARTA TIMUR, DKI JAKARTA",7,71,177,248
https://kawalpemilu.org#26114,"PONDOK BAMBU, DUREN SAWIT, JAKARTA TIMUR, DKI JAKARTA",8,112,133,245
https://kawalpemilu.org#26114,"PONDOK BAMBU, DUREN SAWIT, JAKARTA TIMUR, DKI JAKARTA",9,107,80,187
https://kawalpemilu.org#26114,"PONDOK BAMBU, DUREN SAWIT, JAKARTA TIMUR, DKI JAKARTA",10,94,122,216
https://kawalpemilu.org#26114,"PONDOK BAMBU, DUREN SAWIT, JAKARTA TIMUR, DKI JAKARTA",11,108,165,273
https://kawalpemilu.org#26114,"PONDOK BAMBU, DUREN SAWIT, JAKARTA TIMUR, DKI JAKARTA",12,76,190,266
https://kawalpemilu.org#26114,"PONDOK BAMBU, DUREN SAWIT, JAKARTA TIMUR, DKI JAKARTA",13,101,127,228
https://kawalpemilu.org#26114,"PONDOK BAMBU, DUREN SAWIT, JAKARTA TIMUR, DKI JAKARTA",14,123,115,238
https://kawalpemilu.org#26114,"PONDOK BAMBU, DUREN SAWIT, JAKARTA TIMUR, DKI JAKARTA",15,103,156,259
https://kawalpemilu.org#26114,"PONDOK BAMBU, DUREN SAWIT, JAKARTA TIMUR, DKI JAKARTA",16,50,74,124
https://kawalpemilu.org#26114,"PONDOK BAMBU, DUREN SAWIT, JAKARTA TIMUR, DKI JAKARTA",17,87,125,212
https://kawalpemilu.org#26114,"PONDOK BAMBU, DUREN SAWIT, JAKARTA TIMUR, DKI JAKARTA",18,114,81,195
https://kawalpemilu.org#26114,"PONDOK BAMBU, DUREN SAWIT, JAKARTA TIMUR, DKI JAKARTA",19,171,79,250
https://kawalpemilu.org#26114,"PONDOK BAMBU, DUREN SAWIT, JAKARTA TIMUR, DKI JAKARTA",20,144,149,293
https://kawalpemilu.org#26114,"PONDOK BAMBU, DUREN SAWIT, JAKARTA TIMUR, DKI JAKARTA",21,112,133,245
https://kawalpemilu.org#26114,"PONDOK BAMBU, DUREN SAWIT, JAKARTA TIMUR, DKI JAKARTA",22,103,165,268
https://kawalpemilu.org#26114,"PONDOK BAMBU, DUREN SAWIT, JAKARTA TIMUR, DKI JAKARTA",23,83,171,254
https://kawalpemilu.org#26114,"PONDOK BAMBU, DUREN SAWIT, JAKARTA TIMUR, DKI JAKARTA",24,118,123,241
https://kawalpemilu.org#26114,"PONDOK BAMBU, DUREN SAWIT, JAKARTA TIMUR, DKI JAKARTA",25,92,149,241
https://kawalpemilu.org#26114,"PONDOK BAMBU, DUREN SAWIT, JAKARTA TIMUR, DKI JAKARTA",26,96,153,249
https://kawalpemilu.org#26114,"PONDOK BAMBU, DUREN SAWIT, JAKARTA TIMUR, DKI JAKARTA",27,82,74,156
https://kawalpemilu.org#26114,"PONDOK BAMBU, DUREN SAWIT, JAKARTA TIMUR, DKI JAKARTA",28,108,149,257
https://kawalpemilu.org#26114,"PONDOK BAMBU, DUREN SAWIT, JAKARTA TIMUR, DKI JAKARTA",30,122,129,251
https://kawalpemilu.org#26114,"PONDOK BAMBU, DUREN SAWIT, JAKARTA TIMUR, DKI JAKARTA",31,132,110,242
https://kawalpemilu.org#26114,"PONDOK BAMBU, DUREN SAWIT, JAKARTA TIMUR, DKI JAKARTA",32,109,151,260
https://kawalpemilu.org#26114,"PONDOK BAMBU, DUREN SAWIT, JAKARTA TIMUR, DKI JAKARTA",33,112,152,264
https://kawalpemilu.org#26114,"PONDOK BAMBU, DUREN SAWIT, JAKARTA TIMUR, DKI JAKARTA",34,108,107,215
https://kawalpemilu.org#26114,"PONDOK BAMBU, DUREN SAWIT, JAKARTA TIMUR, DKI JAKARTA",35,112,114,226
https://kawalpemilu.org#26114,"PONDOK BAMBU, DUREN SAWIT, JAKARTA TIMUR, DKI JAKARTA",36,137,137,274
https://kawalpemilu.org#26114,"PONDOK BAMBU, DUREN SAWIT, JAKARTA TIMUR, DKI JAKARTA",37,134,110,244
https://kawalpemilu.org#26114,"PONDOK BAMBU, DUREN SAWIT, JAKARTA TIMUR, DKI JAKARTA",38,131,109,240
https://kawalpemilu.org#26114,"PONDOK BAMBU, DUREN SAWIT, JAKARTA TIMUR, DKI JAKARTA",39,89,154,243
https://kawalpemilu.org#26114,"PONDOK BAMBU, DUREN SAWIT, JAKARTA TIMUR, DKI JAKARTA",40,131,140,271
https://kawalpemilu.org#26114,"PONDOK BAMBU, DUREN SAWIT, JAKARTA TIMUR, DKI JAKARTA",41,73,139,212
https://kawalpemilu.org#26114,"PONDOK BAMBU, DUREN SAWIT, JAKARTA TIMUR, DKI JAKARTA",42,53,124,177
https://kawalpemilu.org#26114,"PONDOK BAMBU, DUREN SAWIT, JAKARTA TIMUR, DKI JAKARTA",43,54,134,188
https://kawalpemilu.org#26114,"PONDOK BAMBU, DUREN SAWIT, JAKARTA TIMUR, DKI JAKARTA",44,71,185,256
https://kawalpemilu.org#26114,"PONDOK BAMBU, DUREN SAWIT, JAKARTA TIMUR, DKI JAKARTA",45,78,162,240
https://kawalpemilu.org#26114,"PONDOK BAMBU, DUREN SAWIT, JAKARTA TIMUR, DKI JAKARTA",46,98,152,250
https://kawalpemilu.org#26114,"PONDOK BAMBU, DUREN SAWIT, JAKARTA TIMUR, DKI JAKARTA",47,85,158,243
https://kawalpemilu.org#26114,"PONDOK BAMBU, DUREN SAWIT, JAKARTA TIMUR, DKI JAKARTA",48,83,180,263
https://kawalpemilu.org#26114,"PONDOK BAMBU, DUREN SAWIT, JAKARTA TIMUR, DKI JAKARTA",49,104,118,222
https://kawalpemilu.org#26114,"PONDOK BAMBU, DUREN SAWIT, JAKARTA TIMUR, DKI JAKARTA",50,80,120,200
https://kawalpemilu.org#26114,"PONDOK BAMBU, DUREN SAWIT, JAKARTA TIMUR, DKI JAKARTA",51,122,115,237
https://kawalpemilu.org#26114,"PONDOK BAMBU, DUREN SAWIT, JAKARTA TIMUR, DKI JAKARTA",52,115,120,235
https://kawalpemilu.org#26114,"PONDOK BAMBU, DUREN SAWIT, JAKARTA TIMUR, DKI JAKARTA",53,101,150,251
https://kawalpemilu.org#26114,"PONDOK BAMBU, DUREN SAWIT, JAKARTA TIMUR, DKI JAKARTA",54,94,126,220
https://kawalpemilu.org#26114,"PONDOK BAMBU, DUREN SAWIT, JAKARTA TIMUR, DKI JAKARTA",55,136,80,216
https://kawalpemilu.org#26114,"PONDOK BAMBU, DUREN SAWIT, JAKARTA TIMUR, DKI JAKARTA",56,100,53,153
https://kawalpemilu.org#26114,"PONDOK BAMBU, DUREN SAWIT, JAKARTA TIMUR, DKI JAKARTA",57,91,119,210
https://kawalpemilu.org#26114,"PONDOK BAMBU, DUREN SAWIT, JAKARTA TIMUR, DKI JAKARTA",58,74,151,225
https://kawalpemilu.org#26114,"PONDOK BAMBU, DUREN SAWIT, JAKARTA TIMUR, DKI JAKARTA",59,205,44,249
https://kawalpemilu.org#26114,"PONDOK BAMBU, DUREN SAWIT, JAKARTA TIMUR, DKI JAKARTA",60,210,56,266
https://kawalpemilu.org#26114,"PONDOK BAMBU, DUREN SAWIT, JAKARTA TIMUR, DKI JAKARTA",63,88,154,242
https://kawalpemilu.org#26114,"PONDOK BAMBU, DUREN SAWIT, JAKARTA TIMUR, DKI JAKARTA",64,151,76,227
https://kawalpemilu.org#26114,"PONDOK BAMBU, DUREN SAWIT, JAKARTA TIMUR, DKI JAKARTA",65,153,86,239
https://kawalpemilu.org#26114,"PONDOK BAMBU, DUREN SAWIT, JAKARTA TIMUR, DKI JAKARTA",66,111,163,274
https://kawalpemilu.org#26114,"PONDOK BAMBU, DUREN SAWIT, JAKARTA TIMUR, DKI JAKARTA",68,110,124,234
https://kawalpemilu.org#26114,"PONDOK BAMBU, DUREN SAWIT, JAKARTA TIMUR, DKI JAKARTA",69,90,144,234
https://kawalpemilu.org#26114,"PONDOK BAMBU, DUREN SAWIT, JAKARTA TIMUR, DKI JAKARTA",70,95,116,211
https://kawalpemilu.org#26114,"PONDOK BAMBU, DUREN SAWIT, JAKARTA TIMUR, DKI JAKARTA",71,98,137,235
https://kawalpemilu.org#26114,"PONDOK BAMBU, DUREN SAWIT, JAKARTA TIMUR, DKI JAKARTA",72,124,114,238
https://kawalpemilu.org#26114,"PONDOK BAMBU, DUREN SAWIT, JAKARTA TIMUR, DKI JAKARTA",73,124,87,211
https://kawalpemilu.org#26114,"PONDOK BAMBU, DUREN SAWIT, JAKARTA TIMUR, DKI JAKARTA",74,96,58,154
https://kawalpemilu.org#26114,"PONDOK BAMBU, DUREN SAWIT, JAKARTA TIMUR, DKI JAKARTA",75,119,135,254
https://kawalpemilu.org#26114,"PONDOK BAMBU, DUREN SAWIT, JAKARTA TIMUR, DKI JAKARTA",76,54,198,252
https://kawalpemilu.org#26114,"PONDOK BAMBU, DUREN SAWIT, JAKARTA TIMUR, DKI JAKARTA",77,111,126,237
https://kawalpemilu.org#26114,"PONDOK BAMBU, DUREN SAWIT, JAKARTA TIMUR, DKI JAKARTA",78,94,162,256
https://kawalpemilu.org#26114,"PONDOK BAMBU, DUREN SAWIT, JAKARTA TIMUR, DKI JAKARTA",79,108,109,217
https://kawalpemilu.org#26114,"PONDOK BAMBU, DUREN SAWIT, JAKARTA TIMUR, DKI JAKARTA",80,115,121,236
https://kawalpemilu.org#26114,"PONDOK BAMBU, DUREN SAWIT, JAKARTA TIMUR, DKI JAKARTA",81,140,98,238
https://kawalpemilu.org#26114,"PONDOK BAMBU, DUREN SAWIT, JAKARTA TIMUR, DKI JAKARTA",82,98,138,236
https://kawalpemilu.org#26114,"PONDOK BAMBU, DUREN SAWIT, JAKARTA TIMUR, DKI JAKARTA",83,95,135,230
https://kawalpemilu.org#26114,"PONDOK BAMBU, DUREN SAWIT, JAKARTA TIMUR, DKI JAKARTA",84,94,120,214
https://kawalpemilu.org#26114,"PONDOK BAMBU, DUREN SAWIT, JAKARTA TIMUR, DKI JAKARTA",85,101,137,238
https://kawalpemilu.org#26114,"PONDOK BAMBU, DUREN SAWIT, JAKARTA TIMUR, DKI JAKARTA",86,128,123,251
https://kawalpemilu.org#26114,"PONDOK BAMBU, DUREN SAWIT, JAKARTA TIMUR, DKI JAKARTA",87,96,140,236
https://kawalpemilu.org#26114,"PONDOK BAMBU, DUREN SAWIT, JAKARTA TIMUR, DKI JAKARTA",88,124,147,271
https://kawalpemilu.org#26114,"PONDOK BAMBU, DUREN SAWIT, JAKARTA TIMUR, DKI JAKARTA",89,120,122,242
https://kawalpemilu.org#26114,"PONDOK BAMBU, DUREN SAWIT, JAKARTA TIMUR, DKI JAKARTA",90,108,135,243
https://kawalpemilu.org#26114,"PONDOK BAMBU, DUREN SAWIT, JAKARTA TIMUR, DKI JAKARTA",91,74,181,255
https://kawalpemilu.org#26114,"PONDOK BAMBU, DUREN SAWIT, JAKARTA TIMUR, DKI JAKARTA",92,113,131,244
https://kawalpemilu.org#26114,"PONDOK BAMBU, DUREN SAWIT, JAKARTA TIMUR, DKI JAKARTA",93,106,144,250
https://kawalpemilu.org#26114,"PONDOK BAMBU, DUREN SAWIT, JAKARTA TIMUR, DKI JAKARTA",94,105,106,211
https://kawalpemilu.org#26114,"PONDOK BAMBU, DUREN SAWIT, JAKARTA TIMUR, DKI JAKARTA",95,102,131,233
https://kawalpemilu.org#26114,"PONDOK BAMBU, DUREN SAWIT, JAKARTA TIMUR, DKI JAKARTA",96,163,64,227
https://kawalpemilu.org#26114,"PONDOK BAMBU, DUREN SAWIT, JAKARTA TIMUR, DKI JAKARTA",97,114,113,227
https://kawalpemilu.org#26114,"PONDOK BAMBU, DUREN SAWIT, JAKARTA TIMUR, DKI JAKARTA",98,157,89,246
https://kawalpemilu.org#26114,"PONDOK BAMBU, DUREN SAWIT, JAKARTA TIMUR, DKI JAKARTA",99,104,142,246
https://kawalpemilu.org#26114,"PONDOK BAMBU, DUREN SAWIT, JAKARTA TIMUR, DKI JAKARTA",100,100,155,255
https://kawalpemilu.org#26114,"PONDOK BAMBU, DUREN SAWIT, JAKARTA TIMUR, DKI JAKARTA",101,110,146,256
https://kawalpemilu.org#26114,"PONDOK BAMBU, DUREN SAWIT, JAKARTA TIMUR, DKI JAKARTA",102,84,173,257
https://kawalpemilu.org#26114,"PONDOK BAMBU, DUREN SAWIT, JAKARTA TIMUR, DKI JAKARTA",103,79,146,225
https://kawalpemilu.org#26114,"PONDOK BAMBU, DUREN SAWIT, JAKARTA TIMUR, DKI JAKARTA",104,75,103,178
https://kawalpemilu.org#26114,"PONDOK BAMBU, DUREN SAWIT, JAKARTA TIMUR, DKI JAKARTA",105,63,148,211
https://kawalpemilu.org#26114,"PONDOK BAMBU, DUREN SAWIT, JAKARTA TIMUR, DKI JAKARTA",106,111,122,233
https://kawalpemilu.org#26114,"PONDOK BAMBU, DUREN SAWIT, JAKARTA TIMUR, DKI JAKARTA",107,99,123,222
https://kawalpemilu.org#26114,"PONDOK BAMBU, DUREN SAWIT, JAKARTA TIMUR, DKI JAKARTA",108,172,92,264
https://kawalpemilu.org#26114,"PONDOK BAMBU, DUREN SAWIT, JAKARTA TIMUR, DKI JAKARTA",109,94,155,249
https://kawalpemilu.org#26114,"PONDOK BAMBU, DUREN SAWIT, JAKARTA TIMUR, DKI JAKARTA",110,78,149,227
https://kawalpemilu.org#26114,"PONDOK BAMBU, DUREN SAWIT, JAKARTA TIMUR, DKI JAKARTA",111,115,114,229
https://kawalpemilu.org#26114,"PONDOK BAMBU, DUREN SAWIT, JAKARTA TIMUR, DKI JAKARTA",112,130,108,238
https://kawalpemilu.org#26114,"PONDOK BAMBU, DUREN SAWIT, JAKARTA TIMUR, DKI JAKARTA",114,97,149,246
https://kawalpemilu.org#26114,"PONDOK BAMBU, DUREN SAWIT, JAKARTA TIMUR, DKI JAKARTA",115,118,140,258
https://kawalpemilu.org#26114,"PONDOK BAMBU, DUREN SAWIT, JAKARTA TIMUR, DKI JAKARTA",117,149,91,240
https://kawalpemilu.org#26114,"PONDOK BAMBU, DUREN SAWIT, JAKARTA TIMUR, DKI JAKARTA",118,88,100,188
https://kawalpemilu.org#26114,"PONDOK BAMBU, DUREN SAWIT, JAKARTA TIMUR, DKI JAKARTA",119,100,110,210
https://kawalpemilu.org#26114,"PONDOK BAMBU, DUREN SAWIT, JAKARTA TIMUR, DKI JAKARTA",120,89,138,227
https://kawalpemilu.org#26114,"PONDOK BAMBU, DUREN SAWIT, JAKARTA TIMUR, DKI JAKARTA",121,94,125,219
https://kawalpemilu.org#26114,"PONDOK BAMBU, DUREN SAWIT, JAKARTA TIMUR, DKI JAKARTA",122,96,134,230
https://kawalpemilu.org#26114,"PONDOK BAMBU, DUREN SAWIT, JAKARTA TIMUR, DKI JAKARTA",124,117,135,252
https://kawalpemilu.org#26114,"PONDOK BAMBU, DUREN SAWIT, JAKARTA TIMUR, DKI JAKARTA",125,104,148,252
https://kawalpemilu.org#26114,"PONDOK BAMBU, DUREN SAWIT, JAKARTA TIMUR, DKI JAKARTA",126,100,139,239
https://kawalpemilu.org#26114,"PONDOK BAMBU, DUREN SAWIT, JAKARTA TIMUR, DKI JAKARTA",127,99,134,236
https://kawalpemilu.org#26114,"PONDOK BAMBU, DUREN SAWIT, JAKARTA TIMUR, DKI JAKARTA",128,106,121,227
https://kawalpemilu.org#26114,"PONDOK BAMBU, DUREN SAWIT, JAKARTA TIMUR, DKI JAKARTA",130,111,133,244
https://kawalpemilu.org#26114,"PONDOK BAMBU, DUREN SAWIT, JAKARTA TIMUR, DKI JAKARTA",131,140,91,231
https://kawalpemilu.org#26114,"PONDOK BAMBU, DUREN SAWIT, JAKARTA TIMUR, DKI JAKARTA",132,105,146,251
https://kawalpemilu.org#26114,"PONDOK BAMBU, DUREN SAWIT, JAKARTA TIMUR, DKI JAKARTA",133,85,164,249
https://kawalpemilu.org#26114,"PONDOK BAMBU, DUREN SAWIT, JAKARTA TIMUR, DKI JAKARTA",134,91,117,208
https://kawalpemilu.org#26114,"PONDOK BAMBU, DUREN SAWIT, JAKARTA TIMUR, DKI JAKARTA",135,86,92,178
https://kawalpemilu.org#26114,"PONDOK BAMBU, DUREN SAWIT, JAKARTA TIMUR, DKI JAKARTA",136,116,138,254
https://kawalpemilu.org#26114,"PONDOK BAMBU, DUREN SAWIT, JAKARTA TIMUR, DKI JAKARTA",137,0,0,235
https://kawalpemilu.org#26114,"PONDOK BAMBU, DUREN SAWIT, JAKARTA TIMUR, DKI JAKARTA",138,88,81,169
https://kawalpemilu.org#26114,"PONDOK BAMBU, DUREN SAWIT, JAKARTA TIMUR, DKI JAKARTA",139,109,144,253
https://kawalpemilu.org#26114,"PONDOK BAMBU, DUREN SAWIT, JAKARTA TIMUR, DKI JAKARTA",140,49,121,170
https://kawalpemilu.org#26114,"PONDOK BAMBU, DUREN SAWIT, JAKARTA TIMUR, DKI JAKARTA",141,112,142,254
https://kawalpemilu.org#26114,"PONDOK BAMBU, DUREN SAWIT, JAKARTA TIMUR, DKI JAKARTA",142,78,146,224
https://kawalpemilu.org#26114,"PONDOK BAMBU, DUREN SAWIT, JAKARTA TIMUR, DKI JAKARTA",143,87,102,189
https://kawalpemilu.org#26114,"PONDOK BAMBU, DUREN SAWIT, JAKARTA TIMUR, DKI JAKARTA",144,87,146,233
https://kawalpemilu.org#26114,"PONDOK BAMBU, DUREN SAWIT, JAKARTA TIMUR, DKI JAKARTA",145,162,73,235
https://kawalpemilu.org#26114,"PONDOK BAMBU, DUREN SAWIT, JAKARTA TIMUR, DKI JAKARTA",146,150,69,219
https://kawalpemilu.org#26114,"PONDOK BAMBU, DUREN SAWIT, JAKARTA TIMUR, DKI JAKARTA",147,146,108,254
https://kawalpemilu.org#26114,"PONDOK BAMBU, DUREN SAWIT, JAKARTA TIMUR, DKI JAKARTA",148,135,86,221
https://kawalpemilu.org#26114,"PONDOK BAMBU, DUREN SAWIT, JAKARTA TIMUR, DKI JAKARTA",149,103,151,254
https://kawalpemilu.org#26114,"PONDOK BAMBU, DUREN SAWIT, JAKARTA TIMUR, DKI JAKARTA",151,100,110,210
https://kawalpemilu.org#26114,"PONDOK BAMBU, DUREN SAWIT, JAKARTA TIMUR, DKI JAKARTA",152,100,127,227
https://kawalpemilu.org#26114,"PONDOK BAMBU, DUREN SAWIT, JAKARTA TIMUR, DKI JAKARTA",153,123,99,222
https://kawalpemilu.org#26114,"PONDOK BAMBU, DUREN SAWIT, JAKARTA TIMUR, DKI JAKARTA",154,158,94,252
https://kawalpemilu.org#26114,"PONDOK BAMBU, DUREN SAWIT, JAKARTA TIMUR, DKI JAKARTA",155,135,115,250
https://kawalpemilu.org#26114,"PONDOK BAMBU, DUREN SAWIT, JAKARTA TIMUR, DKI JAKARTA",158,125,109,234
https://kawalpemilu.org#26114,"PONDOK BAMBU, DUREN SAWIT, JAKARTA TIMUR, DKI JAKARTA",159,141,121,262
https://kawalpemilu.org#26114,"PONDOK BAMBU, DUREN SAWIT, JAKARTA TIMUR, DKI JAKARTA",160,115,131,246
https://kawalpemilu.org#26114,"PONDOK BAMBU, DUREN SAWIT, JAKARTA TIMUR, DKI JAKARTA",161,150,98,248
https://kawalpemilu.org#26114,"PONDOK BAMBU, DUREN SAWIT, JAKARTA TIMUR, DKI JAKARTA",162,131,102,233
https://kawalpemilu.org#26114,"PONDOK BAMBU, DUREN SAWIT, JAKARTA TIMUR, DKI JAKARTA",163,102,98,200
https://kawalpemilu.org#26114,"PONDOK BAMBU, DUREN SAWIT, JAKARTA TIMUR, DKI JAKARTA",164,178,75,253
https://kawalpemilu.org#26114,"PONDOK BAMBU, DUREN SAWIT, JAKARTA TIMUR, DKI JAKARTA",165,137,118,255
https://kawalpemilu.org#26114,"PONDOK BAMBU, DUREN SAWIT, JAKARTA TIMUR, DKI JAKARTA",166,127,104,231
https://kawalpemilu.org#26114,"PONDOK BAMBU, DUREN SAWIT, JAKARTA TIMUR, DKI JAKARTA",167,141,100,241
https://kawalpemilu.org#26114,"PONDOK BAMBU, DUREN SAWIT, JAKARTA TIMUR, DKI JAKARTA",168,151,105,256
https://kawalpemilu.org#26114,"PONDOK BAMBU, DUREN SAWIT, JAKARTA TIMUR, DKI JAKARTA",169,162,86,248
https://kawalpemilu.org#26114,"PONDOK BAMBU, DUREN SAWIT, JAKARTA TIMUR, DKI JAKARTA",170,89,138,227
https://kawalpemilu.org#26114,"PONDOK BAMBU, DUREN SAWIT, JAKARTA TIMUR, DKI JAKARTA",171,123,138,261
https://kawalpemilu.org#26114,"PONDOK BAMBU, DUREN SAWIT, JAKARTA TIMUR, DKI JAKARTA",173,109,141,250
https://kawalpemilu.org#26114,"PONDOK BAMBU, DUREN SAWIT, JAKARTA TIMUR, DKI JAKARTA",174,95,152,247
https://kawalpemilu.org#26114,"PONDOK BAMBU, DUREN SAWIT, JAKARTA TIMUR, DKI JAKARTA",175,132,114,246
https://kawalpemilu.org#26114,"PONDOK BAMBU, DUREN SAWIT, JAKARTA TIMUR, DKI JAKARTA",176,161,85,246
https://kawalpemilu.org#26114,"PONDOK BAMBU, DUREN SAWIT, JAKARTA TIMUR, DKI JAKARTA",177,140,120,260
https://kawalpemilu.org#26114,"PONDOK BAMBU, DUREN SAWIT, JAKARTA TIMUR, DKI JAKARTA",178,136,99,235
https://kawalpemilu.org#26114,"PONDOK BAMBU, DUREN SAWIT, JAKARTA TIMUR, DKI JAKARTA",179,121,88,209
https://kawalpemilu.org#26114,"PONDOK BAMBU, DUREN SAWIT, JAKARTA TIMUR, DKI JAKARTA",181,107,148,255
https://kawalpemilu.org#26114,"PONDOK BAMBU, DUREN SAWIT, JAKARTA TIMUR, DKI JAKARTA",182,101,136,237
https://kawalpemilu.org#26114,"PONDOK BAMBU, DUREN SAWIT, JAKARTA TIMUR, DKI JAKARTA",183,119,130,249
https://kawalpemilu.org#26114,"PONDOK BAMBU, DUREN SAWIT, JAKARTA TIMUR, DKI JAKARTA",187,91,94,185
https://kawalpemilu.org#26114,"PONDOK BAMBU, DUREN SAWIT, JAKARTA TIMUR, DKI JAKARTA",188,91,86,177
https://kawalpemilu.org#26114,"PONDOK BAMBU, DUREN SAWIT, JAKARTA TIMUR, DKI JAKARTA",189,90,131,221
https://kawalpemilu.org#26114,"PONDOK BAMBU, DUREN SAWIT, JAKARTA TIMUR, DKI JAKARTA",190,67,95,162
https://kawalpemilu.org#26114,"PONDOK BAMBU, DUREN SAWIT, JAKARTA TIMUR, DKI JAKARTA",191,62,51,113
https://kawalpemilu.org#26114,"PONDOK BAMBU, DUREN SAWIT, JAKARTA TIMUR, DKI JAKARTA",192,112,111,223
https://kawalpemilu.org#26114,"PONDOK BAMBU, DUREN SAWIT, JAKARTA TIMUR, DKI JAKARTA",193,67,76,143
https://kawalpemilu.org#26115,"KLENDER, DUREN SAWIT, JAKARTA TIMUR, DKI JAKARTA",1,128,117,245
https://kawalpemilu.org#26115,"KLENDER, DUREN SAWIT, JAKARTA TIMUR, DKI JAKARTA",2,129,108,237
https://kawalpemilu.org#26115,"KLENDER, DUREN SAWIT, JAKARTA TIMUR, DKI JAKARTA",3,144,92,236
https://kawalpemilu.org#26115,"KLENDER, DUREN SAWIT, JAKARTA TIMUR, DKI JAKARTA",4,109,88,197
https://kawalpemilu.org#26115,"KLENDER, DUREN SAWIT, JAKARTA TIMUR, DKI JAKARTA",5,125,101,226
https://kawalpemilu.org#26115,"KLENDER, DUREN SAWIT, JAKARTA TIMUR, DKI JAKARTA",6,145,98,243
https://kawalpemilu.org#26115,"KLENDER, DUREN SAWIT, JAKARTA TIMUR, DKI JAKARTA",7,122,119,241
https://kawalpemilu.org#26115,"KLENDER, DUREN SAWIT, JAKARTA TIMUR, DKI JAKARTA",9,127,113,240
https://kawalpemilu.org#26115,"KLENDER, DUREN SAWIT, JAKARTA TIMUR, DKI JAKARTA",10,124,104,228
https://kawalpemilu.org#26115,"KLENDER, DUREN SAWIT, JAKARTA TIMUR, DKI JAKARTA",11,126,123,249
https://kawalpemilu.org#26115,"KLENDER, DUREN SAWIT, JAKARTA TIMUR, DKI JAKARTA",12,98,132,230
https://kawalpemilu.org#26115,"KLENDER, DUREN SAWIT, JAKARTA TIMUR, DKI JAKARTA",13,90,154,244
https://kawalpemilu.org#26115,"KLENDER, DUREN SAWIT, JAKARTA TIMUR, DKI JAKARTA",14,80,137,217
https://kawalpemilu.org#26115,"KLENDER, DUREN SAWIT, JAKARTA TIMUR, DKI JAKARTA",15,86,110,196
https://kawalpemilu.org#26115,"KLENDER, DUREN SAWIT, JAKARTA TIMUR, DKI JAKARTA",16,80,158,238
https://kawalpemilu.org#26115,"KLENDER, DUREN SAWIT, JAKARTA TIMUR, DKI JAKARTA",17,81,154,235
https://kawalpemilu.org#26115,"KLENDER, DUREN SAWIT, JAKARTA TIMUR, DKI JAKARTA",18,119,132,251
https://kawalpemilu.org#26115,"KLENDER, DUREN SAWIT, JAKARTA TIMUR, DKI JAKARTA",19,94,139,233
https://kawalpemilu.org#26115,"KLENDER, DUREN SAWIT, JAKARTA TIMUR, DKI JAKARTA",20,105,141,246
https://kawalpemilu.org#26115,"KLENDER, DUREN SAWIT, JAKARTA TIMUR, DKI JAKARTA",21,96,147,243
https://kawalpemilu.org#26115,"KLENDER, DUREN SAWIT, JAKARTA TIMUR, DKI JAKARTA",22,78,158,236
https://kawalpemilu.org#26115,"KLENDER, DUREN SAWIT, JAKARTA TIMUR, DKI JAKARTA",23,144,114,258
https://kawalpemilu.org#26115,"KLENDER, DUREN SAWIT, JAKARTA TIMUR, DKI JAKARTA",24,138,126,264
https://kawalpemilu.org#26115,"KLENDER, DUREN SAWIT, JAKARTA TIMUR, DKI JAKARTA",25,66,180,246
https://kawalpemilu.org#26115,"KLENDER, DUREN SAWIT, JAKARTA TIMUR, DKI JAKARTA",26,75,151,226
https://kawalpemilu.org#26115,"KLENDER, DUREN SAWIT, JAKARTA TIMUR, DKI JAKARTA",27,68,152,220
https://kawalpemilu.org#26115,"KLENDER, DUREN SAWIT, JAKARTA TIMUR, DKI JAKARTA",28,61,163,224
https://kawalpemilu.org#26115,"KLENDER, DUREN SAWIT, JAKARTA TIMUR, DKI JAKARTA",29,93,169,262
https://kawalpemilu.org#26115,"KLENDER, DUREN SAWIT, JAKARTA TIMUR, DKI JAKARTA",30,124,139,263
https://kawalpemilu.org#26115,"KLENDER, DUREN SAWIT, JAKARTA TIMUR, DKI JAKARTA",32,130,95,225
https://kawalpemilu.org#26115,"KLENDER, DUREN SAWIT, JAKARTA TIMUR, DKI JAKARTA",33,138,99,237
https://kawalpemilu.org#26115,"KLENDER, DUREN SAWIT, JAKARTA TIMUR, DKI JAKARTA",34,178,80,258
https://kawalpemilu.org#26115,"KLENDER, DUREN SAWIT, JAKARTA TIMUR, DKI JAKARTA",35,138,101,239
https://kawalpemilu.org#26115,"KLENDER, DUREN SAWIT, JAKARTA TIMUR, DKI JAKARTA",37,152,105,257
https://kawalpemilu.org#26115,"KLENDER, DUREN SAWIT, JAKARTA TIMUR, DKI JAKARTA",38,137,87,224
https://kawalpemilu.org#26115,"KLENDER, DUREN SAWIT, JAKARTA TIMUR, DKI JAKARTA",39,150,84,234
https://kawalpemilu.org#26115,"KLENDER, DUREN SAWIT, JAKARTA TIMUR, DKI JAKARTA",40,186,42,228
https://kawalpemilu.org#26115,"KLENDER, DUREN SAWIT, JAKARTA TIMUR, DKI JAKARTA",41,145,55,200
https://kawalpemilu.org#26115,"KLENDER, DUREN SAWIT, JAKARTA TIMUR, DKI JAKARTA",42,146,99,245
https://kawalpemilu.org#26115,"KLENDER, DUREN SAWIT, JAKARTA TIMUR, DKI JAKARTA",43,101,150,251
https://kawalpemilu.org#26115,"KLENDER, DUREN SAWIT, JAKARTA TIMUR, DKI JAKARTA",44,91,140,231
https://kawalpemilu.org#26115,"KLENDER, DUREN SAWIT, JAKARTA TIMUR, DKI JAKARTA",45,103,136,239
https://kawalpemilu.org#26115,"KLENDER, DUREN SAWIT, JAKARTA TIMUR, DKI JAKARTA",46,143,97,240
https://kawalpemilu.org#26115,"KLENDER, DUREN SAWIT, JAKARTA TIMUR, DKI JAKARTA",47,124,107,231
https://kawalpemilu.org#26115,"KLENDER, DUREN SAWIT, JAKARTA TIMUR, DKI JAKARTA",49,145,115,260
https://kawalpemilu.org#26115,"KLENDER, DUREN SAWIT, JAKARTA TIMUR, DKI JAKARTA",50,151,102,253
https://kawalpemilu.org#26115,"KLENDER, DUREN SAWIT, JAKARTA TIMUR, DKI JAKARTA",51,137,109,246
https://kawalpemilu.org#26115,"KLENDER, DUREN SAWIT, JAKARTA TIMUR, DKI JAKARTA",52,112,149,261
https://kawalpemilu.org#26115,"KLENDER, DUREN SAWIT, JAKARTA TIMUR, DKI JAKARTA",53,123,147,270
https://kawalpemilu.org#26115,"KLENDER, DUREN SAWIT, JAKARTA TIMUR, DKI JAKARTA",54,73,183,256
https://kawalpemilu.org#26115,"KLENDER, DUREN SAWIT, JAKARTA TIMUR, DKI JAKARTA",57,61,204,265
https://kawalpemilu.org#26115,"KLENDER, DUREN SAWIT, JAKARTA TIMUR, DKI JAKARTA",58,77,159,236
https://kawalpemilu.org#26115,"KLENDER, DUREN SAWIT, JAKARTA TIMUR, DKI JAKARTA",61,87,150,237
https://kawalpemilu.org#26115,"KLENDER, DUREN SAWIT, JAKARTA TIMUR, DKI JAKARTA",62,119,145,264
https://kawalpemilu.org#26115,"KLENDER, DUREN SAWIT, JAKARTA TIMUR, DKI JAKARTA",63,200,57,257
https://kawalpemilu.org#26115,"KLENDER, DUREN SAWIT, JAKARTA TIMUR, DKI JAKARTA",64,174,79,253
https://kawalpemilu.org#26115,"KLENDER, DUREN SAWIT, JAKARTA TIMUR, DKI JAKARTA",67,133,117,250
https://kawalpemilu.org#26115,"KLENDER, DUREN SAWIT, JAKARTA TIMUR, DKI JAKARTA",68,130,124,254
https://kawalpemilu.org#26115,"KLENDER, DUREN SAWIT, JAKARTA TIMUR, DKI JAKARTA",69,130,118,248
https://kawalpemilu.org#26115,"KLENDER, DUREN SAWIT, JAKARTA TIMUR, DKI JAKARTA",70,137,111,248
https://kawalpemilu.org#26115,"KLENDER, DUREN SAWIT, JAKARTA TIMUR, DKI JAKARTA",71,109,146,255
https://kawalpemilu.org#26115,"KLENDER, DUREN SAWIT, JAKARTA TIMUR, DKI JAKARTA",75,88,153,241
https://kawalpemilu.org#26115,"KLENDER, DUREN SAWIT, JAKARTA TIMUR, DKI JAKARTA",76,97,135,232
https://kawalpemilu.org#26115,"KLENDER, DUREN SAWIT, JAKARTA TIMUR, DKI JAKARTA",77,114,124,238
https://kawalpemilu.org#26115,"KLENDER, DUREN SAWIT, JAKARTA TIMUR, DKI JAKARTA",78,80,170,250
https://kawalpemilu.org#26115,"KLENDER, DUREN SAWIT, JAKARTA TIMUR, DKI JAKARTA",79,111,160,271
https://kawalpemilu.org#26115,"KLENDER, DUREN SAWIT, JAKARTA TIMUR, DKI JAKARTA",81,107,155,262
https://kawalpemilu.org#26115,"KLENDER, DUREN SAWIT, JAKARTA TIMUR, DKI JAKARTA",82,129,52,181
https://kawalpemilu.org#26115,"KLENDER, DUREN SAWIT, JAKARTA TIMUR, DKI JAKARTA",83,166,73,239
https://kawalpemilu.org#26115,"KLENDER, DUREN SAWIT, JAKARTA TIMUR, DKI JAKARTA",85,79,167,246
https://kawalpemilu.org#26115,"KLENDER, DUREN SAWIT, JAKARTA TIMUR, DKI JAKARTA",86,87,135,222
https://kawalpemilu.org#26115,"KLENDER, DUREN SAWIT, JAKARTA TIMUR, DKI JAKARTA",87,78,166,244
https://kawalpemilu.org#26115,"KLENDER, DUREN SAWIT, JAKARTA TIMUR, DKI JAKARTA",88,63,144,207
https://kawalpemilu.org#26115,"KLENDER, DUREN SAWIT, JAKARTA TIMUR, DKI JAKARTA",90,88,160,248
https://kawalpemilu.org#26115,"KLENDER, DUREN SAWIT, JAKARTA TIMUR, DKI JAKARTA",92,80,143,223
https://kawalpemilu.org#26115,"KLENDER, DUREN SAWIT, JAKARTA TIMUR, DKI JAKARTA",93,60,149,209
https://kawalpemilu.org#26115,"KLENDER, DUREN SAWIT, JAKARTA TIMUR, DKI JAKARTA",94,56,201,257
https://kawalpemilu.org#26115,"KLENDER, DUREN SAWIT, JAKARTA TIMUR, DKI JAKARTA",96,92,133,225
https://kawalpemilu.org#26115,"KLENDER, DUREN SAWIT, JAKARTA TIMUR, DKI JAKARTA",97,82,130,212
https://kawalpemilu.org#26115,"KLENDER, DUREN SAWIT, JAKARTA TIMUR, DKI JAKARTA",98,73,145,218
https://kawalpemilu.org#26115,"KLENDER, DUREN SAWIT, JAKARTA TIMUR, DKI JAKARTA",99,85,113,198
https://kawalpemilu.org#26115,"KLENDER, DUREN SAWIT, JAKARTA TIMUR, DKI JAKARTA",100,97,133,230
https://kawalpemilu.org#26115,"KLENDER, DUREN SAWIT, JAKARTA TIMUR, DKI JAKARTA",101,84,134,218
https://kawalpemilu.org#26115,"KLENDER, DUREN SAWIT, JAKARTA TIMUR, DKI JAKARTA",102,93,137,230
https://kawalpemilu.org#26115,"KLENDER, DUREN SAWIT, JAKARTA TIMUR, DKI JAKARTA",103,84,175,259
https://kawalpemilu.org#26115,"KLENDER, DUREN SAWIT, JAKARTA TIMUR, DKI JAKARTA",104,82,178,260
https://kawalpemilu.org#26115,"KLENDER, DUREN SAWIT, JAKARTA TIMUR, DKI JAKARTA",105,101,171,272
https://kawalpemilu.org#26115,"KLENDER, DUREN SAWIT, JAKARTA TIMUR, DKI JAKARTA",106,128,97,225
https://kawalpemilu.org#26115,"KLENDER, DUREN SAWIT, JAKARTA TIMUR, DKI JAKARTA",107,115,112,227
https://kawalpemilu.org#26115,"KLENDER, DUREN SAWIT, JAKARTA TIMUR, DKI JAKARTA",108,136,101,237
https://kawalpemilu.org#26115,"KLENDER, DUREN SAWIT, JAKARTA TIMUR, DKI JAKARTA",109,139,100,239
https://kawalpemilu.org#26115,"KLENDER, DUREN SAWIT, JAKARTA TIMUR, DKI JAKARTA",110,85,115,200
https://kawalpemilu.org#26115,"KLENDER, DUREN SAWIT, JAKARTA TIMUR, DKI JAKARTA",111,81,143,224
https://kawalpemilu.org#26115,"KLENDER, DUREN SAWIT, JAKARTA TIMUR, DKI JAKARTA",112,72,180,252
https://kawalpemilu.org#26115,"KLENDER, DUREN SAWIT, JAKARTA TIMUR, DKI JAKARTA",113,69,178,247
https://kawalpemilu.org#26115,"KLENDER, DUREN SAWIT, JAKARTA TIMUR, DKI JAKARTA",114,71,123,194
https://kawalpemilu.org#26115,"KLENDER, DUREN SAWIT, JAKARTA TIMUR, DKI JAKARTA",115,110,129,239
https://kawalpemilu.org#26115,"KLENDER, DUREN SAWIT, JAKARTA TIMUR, DKI JAKARTA",116,65,199,264
https://kawalpemilu.org#26115,"KLENDER, DUREN SAWIT, JAKARTA TIMUR, DKI JAKARTA",117,114,153,267
https://kawalpemilu.org#26115,"KLENDER, DUREN SAWIT, JAKARTA TIMUR, DKI JAKARTA",118,156,96,252
https://kawalpemilu.org#26115,"KLENDER, DUREN SAWIT, JAKARTA TIMUR, DKI JAKARTA",119,173,76,249
https://kawalpemilu.org#26115,"KLENDER, DUREN SAWIT, JAKARTA TIMUR, DKI JAKARTA",120,171,75,246
https://kawalpemilu.org#26115,"KLENDER, DUREN SAWIT, JAKARTA TIMUR, DKI JAKARTA",122,164,71,235
https://kawalpemilu.org#26115,"KLENDER, DUREN SAWIT, JAKARTA TIMUR, DKI JAKARTA",123,166,79,245
https://kawalpemilu.org#26115,"KLENDER, DUREN SAWIT, JAKARTA TIMUR, DKI JAKARTA",124,150,93,243
https://kawalpemilu.org#26115,"KLENDER, DUREN SAWIT, JAKARTA TIMUR, DKI JAKARTA",125,78,195,273
https://kawalpemilu.org#26115,"KLENDER, DUREN SAWIT, JAKARTA TIMUR, DKI JAKARTA",126,85,171,256
https://kawalpemilu.org#26115,"KLENDER, DUREN SAWIT, JAKARTA TIMUR, DKI JAKARTA",127,116,148,264
https://kawalpemilu.org#26115,"KLENDER, DUREN SAWIT, JAKARTA TIMUR, DKI JAKARTA",128,80,176,256
https://kawalpemilu.org#26115,"KLENDER, DUREN SAWIT, JAKARTA TIMUR, DKI JAKARTA",129,113,123,236
https://kawalpemilu.org#26115,"KLENDER, DUREN SAWIT, JAKARTA TIMUR, DKI JAKARTA",130,183,74,257
https://kawalpemilu.org#26115,"KLENDER, DUREN SAWIT, JAKARTA TIMUR, DKI JAKARTA",131,111,145,256
https://kawalpemilu.org#26115,"KLENDER, DUREN SAWIT, JAKARTA TIMUR, DKI JAKARTA",133,130,116,246
https://kawalpemilu.org#26115,"KLENDER, DUREN SAWIT, JAKARTA TIMUR, DKI JAKARTA",134,77,164,241
https://kawalpemilu.org#26115,"KLENDER, DUREN SAWIT, JAKARTA TIMUR, DKI JAKARTA",135,127,101,228
https://kawalpemilu.org#26115,"KLENDER, DUREN SAWIT, JAKARTA TIMUR, DKI JAKARTA",136,112,137,249
https://kawalpemilu.org#26115,"KLENDER, DUREN SAWIT, JAKARTA TIMUR, DKI JAKARTA",137,96,126,222
https://kawalpemilu.org#26115,"KLENDER, DUREN SAWIT, JAKARTA TIMUR, DKI JAKARTA",138,134,121,255
https://kawalpemilu.org#26115,"KLENDER, DUREN SAWIT, JAKARTA TIMUR, DKI JAKARTA",140,103,162,265
https://kawalpemilu.org#26115,"KLENDER, DUREN SAWIT, JAKARTA TIMUR, DKI JAKARTA",142,150,107,257
https://kawalpemilu.org#26115,"KLENDER, DUREN SAWIT, JAKARTA TIMUR, DKI JAKARTA",143,66,162,228
https://kawalpemilu.org#26115,"KLENDER, DUREN SAWIT, JAKARTA TIMUR, DKI JAKARTA",144,61,185,246
https://kawalpemilu.org#26115,"KLENDER, DUREN SAWIT, JAKARTA TIMUR, DKI JAKARTA",145,106,151,257
https://kawalpemilu.org#26115,"KLENDER, DUREN SAWIT, JAKARTA TIMUR, DKI JAKARTA",146,84,137,221
https://kawalpemilu.org#26115,"KLENDER, DUREN SAWIT, JAKARTA TIMUR, DKI JAKARTA",147,98,144,242
https://kawalpemilu.org#26115,"KLENDER, DUREN SAWIT, JAKARTA TIMUR, DKI JAKARTA",148,71,200,271
https://kawalpemilu.org#26115,"KLENDER, DUREN SAWIT, JAKARTA TIMUR, DKI JAKARTA",149,80,180,260
https://kawalpemilu.org#26115,"KLENDER, DUREN SAWIT, JAKARTA TIMUR, DKI JAKARTA",150,76,162,238
https://kawalpemilu.org#26115,"KLENDER, DUREN SAWIT, JAKARTA TIMUR, DKI JAKARTA",151,130,88,218
https://kawalpemilu.org#26115,"KLENDER, DUREN SAWIT, JAKARTA TIMUR, DKI JAKARTA",152,136,98,234
https://kawalpemilu.org#26115,"KLENDER, DUREN SAWIT, JAKARTA TIMUR, DKI JAKARTA",153,135,94,229
https://kawalpemilu.org#26115,"KLENDER, DUREN SAWIT, JAKARTA TIMUR, DKI JAKARTA",154,154,71,225
https://kawalpemilu.org#26115,"KLENDER, DUREN SAWIT, JAKARTA TIMUR, DKI JAKARTA",155,94,140,234
https://kawalpemilu.org#26115,"KLENDER, DUREN SAWIT, JAKARTA TIMUR, DKI JAKARTA",156,131,141,272
https://kawalpemilu.org#26115,"KLENDER, DUREN SAWIT, JAKARTA TIMUR, DKI JAKARTA",157,116,135,251
https://kawalpemilu.org#26115,"KLENDER, DUREN SAWIT, JAKARTA TIMUR, DKI JAKARTA",158,93,166,259
https://kawalpemilu.org#26115,"KLENDER, DUREN SAWIT, JAKARTA TIMUR, DKI JAKARTA",159,94,148,242
https://kawalpemilu.org#26115,"KLENDER, DUREN SAWIT, JAKARTA TIMUR, DKI JAKARTA",160,141,123,264
https://kawalpemilu.org#26115,"KLENDER, DUREN SAWIT, JAKARTA TIMUR, DKI JAKARTA",161,115,157,272
https://kawalpemilu.org#26115,"KLENDER, DUREN SAWIT, JAKARTA TIMUR, DKI JAKARTA",162,84,173,257
https://kawalpemilu.org#26115,"KLENDER, DUREN SAWIT, JAKARTA TIMUR, DKI JAKARTA",163,58,193,251
https://kawalpemilu.org#26115,"KLENDER, DUREN SAWIT, JAKARTA TIMUR, DKI JAKARTA",164,88,182,270
https://kawalpemilu.org#26115,"KLENDER, DUREN SAWIT, JAKARTA TIMUR, DKI JAKARTA",165,131,127,258
https://kawalpemilu.org#26115,"KLENDER, DUREN SAWIT, JAKARTA TIMUR, DKI JAKARTA",166,108,123,231
https://kawalpemilu.org#26115,"KLENDER, DUREN SAWIT, JAKARTA TIMUR, DKI JAKARTA",167,93,155,248
https://kawalpemilu.org#26115,"KLENDER, DUREN SAWIT, JAKARTA TIMUR, DKI JAKARTA",168,69,167,236
https://kawalpemilu.org#26115,"KLENDER, DUREN SAWIT, JAKARTA TIMUR, DKI JAKARTA",169,89,141,230
https://kawalpemilu.org#26115,"KLENDER, DUREN SAWIT, JAKARTA TIMUR, DKI JAKARTA",170,106,147,253
https://kawalpemilu.org#26115,"KLENDER, DUREN SAWIT, JAKARTA TIMUR, DKI JAKARTA",171,107,181,288
https://kawalpemilu.org#26115,"KLENDER, DUREN SAWIT, JAKARTA TIMUR, DKI JAKARTA",172,70,177,247
https://kawalpemilu.org#26115,"KLENDER, DUREN SAWIT, JAKARTA TIMUR, DKI JAKARTA",173,79,167,246
https://kawalpemilu.org#26115,"KLENDER, DUREN SAWIT, JAKARTA TIMUR, DKI JAKARTA",174,57,181,238
https://kawalpemilu.org#26115,"KLENDER, DUREN SAWIT, JAKARTA TIMUR, DKI JAKARTA",176,74,164,238
https://kawalpemilu.org#26115,"KLENDER, DUREN SAWIT, JAKARTA TIMUR, DKI JAKARTA",177,72,142,214
https://kawalpemilu.org#26115,"KLENDER, DUREN SAWIT, JAKARTA TIMUR, DKI JAKARTA",178,95,132,227
https://kawalpemilu.org#26115,"KLENDER, DUREN SAWIT, JAKARTA TIMUR, DKI JAKARTA",180,99,131,230
https://kawalpemilu.org#26115,"KLENDER, DUREN SAWIT, JAKARTA TIMUR, DKI JAKARTA",181,73,117,190
https://kawalpemilu.org#26115,"KLENDER, DUREN SAWIT, JAKARTA TIMUR, DKI JAKARTA",182,94,145,239
https://kawalpemilu.org#26115,"KLENDER, DUREN SAWIT, JAKARTA TIMUR, DKI JAKARTA",183,70,134,204
https://kawalpemilu.org#26115,"KLENDER, DUREN SAWIT, JAKARTA TIMUR, DKI JAKARTA",184,110,132,242
https://kawalpemilu.org#26115,"KLENDER, DUREN SAWIT, JAKARTA TIMUR, DKI JAKARTA",185,98,120,218
https://kawalpemilu.org#26115,"KLENDER, DUREN SAWIT, JAKARTA TIMUR, DKI JAKARTA",186,71,154,225
https://kawalpemilu.org#26115,"KLENDER, DUREN SAWIT, JAKARTA TIMUR, DKI JAKARTA",187,84,127,211
https://kawalpemilu.org#26115,"KLENDER, DUREN SAWIT, JAKARTA TIMUR, DKI JAKARTA",188,83,139,222
https://kawalpemilu.org#26115,"KLENDER, DUREN SAWIT, JAKARTA TIMUR, DKI JAKARTA",189,74,185,259
https://kawalpemilu.org#26115,"KLENDER, DUREN SAWIT, JAKARTA TIMUR, DKI JAKARTA",190,90,167,257
https://kawalpemilu.org#26115,"KLENDER, DUREN SAWIT, JAKARTA TIMUR, DKI JAKARTA",191,70,136,206
https://kawalpemilu.org#26115,"KLENDER, DUREN SAWIT, JAKARTA TIMUR, DKI JAKARTA",192,84,107,191
https://kawalpemilu.org#26115,"KLENDER, DUREN SAWIT, JAKARTA TIMUR, DKI JAKARTA",193,88,114,202
https://kawalpemilu.org#26115,"KLENDER, DUREN SAWIT, JAKARTA TIMUR, DKI JAKARTA",194,86,148,234
https://kawalpemilu.org#26115,"KLENDER, DUREN SAWIT, JAKARTA TIMUR, DKI JAKARTA",196,68,167,235
https://kawalpemilu.org#26115,"KLENDER, DUREN SAWIT, JAKARTA TIMUR, DKI JAKARTA",197,84,139,223
https://kawalpemilu.org#26115,"KLENDER, DUREN SAWIT, JAKARTA TIMUR, DKI JAKARTA",198,105,116,221
https://kawalpemilu.org#26115,"KLENDER, DUREN SAWIT, JAKARTA TIMUR, DKI JAKARTA",199,82,141,223
https://kawalpemilu.org#26115,"KLENDER, DUREN SAWIT, JAKARTA TIMUR, DKI JAKARTA",200,96,128,224
https://kawalpemilu.org#26115,"KLENDER, DUREN SAWIT, JAKARTA TIMUR, DKI JAKARTA",201,105,135,240
https://kawalpemilu.org#26115,"KLENDER, DUREN SAWIT, JAKARTA TIMUR, DKI JAKARTA",202,103,40,143
https://kawalpemilu.org#26115,"KLENDER, DUREN SAWIT, JAKARTA TIMUR, DKI JAKARTA",203,39,139,178
https://kawalpemilu.org#26115,"KLENDER, DUREN SAWIT, JAKARTA TIMUR, DKI JAKARTA",204,58,112,170
https://kawalpemilu.org#26115,"KLENDER, DUREN SAWIT, JAKARTA TIMUR, DKI JAKARTA",205,77,73,150
https://kawalpemilu.org#26115,"KLENDER, DUREN SAWIT, JAKARTA TIMUR, DKI JAKARTA",206,85,67,152
https://kawalpemilu.org#26115,"KLENDER, DUREN SAWIT, JAKARTA TIMUR, DKI JAKARTA",207,78,81,159
https://kawalpemilu.org#26115,"KLENDER, DUREN SAWIT, JAKARTA TIMUR, DKI JAKARTA",208,76,53,129
https://kawalpemilu.org#26115,"KLENDER, DUREN SAWIT, JAKARTA TIMUR, DKI JAKARTA",209,59,96,155
https://kawalpemilu.org#26115,"KLENDER, DUREN SAWIT, JAKARTA TIMUR, DKI JAKARTA",210,103,91,194
https://kawalpemilu.org#26115,"KLENDER, DUREN SAWIT, JAKARTA TIMUR, DKI JAKARTA",211,96,102,198
https://kawalpemilu.org#26116,"PONDOK KELAPA, DUREN SAWIT, JAKARTA TIMUR, DKI JAKARTA",1,93,132,225
https://kawalpemilu.org#26116,"PONDOK KELAPA, DUREN SAWIT, JAKARTA TIMUR, DKI JAKARTA",2,93,108,201
https://kawalpemilu.org#26116,"PONDOK KELAPA, DUREN SAWIT, JAKARTA TIMUR, DKI JAKARTA",3,77,106,183
https://kawalpemilu.org#26116,"PONDOK KELAPA, DUREN SAWIT, JAKARTA TIMUR, DKI JAKARTA",6,48,122,170
https://kawalpemilu.org#26116,"PONDOK KELAPA, DUREN SAWIT, JAKARTA TIMUR, DKI JAKARTA",7,119,146,265
https://kawalpemilu.org#26116,"PONDOK KELAPA, DUREN SAWIT, JAKARTA TIMUR, DKI JAKARTA",8,90,120,210
https://kawalpemilu.org#26116,"PONDOK KELAPA, DUREN SAWIT, JAKARTA TIMUR, DKI JAKARTA",9,97,133,230
https://kawalpemilu.org#26116,"PONDOK KELAPA, DUREN SAWIT, JAKARTA TIMUR, DKI JAKARTA",10,119,92,211
https://kawalpemilu.org#26116,"PONDOK KELAPA, DUREN SAWIT, JAKARTA TIMUR, DKI JAKARTA",12,117,125,242
https://kawalpemilu.org#26116,"PONDOK KELAPA, DUREN SAWIT, JAKARTA TIMUR, DKI JAKARTA",13,82,112,194
https://kawalpemilu.org#26116,"PONDOK KELAPA, DUREN SAWIT, JAKARTA TIMUR, DKI JAKARTA",14,92,110,202
https://kawalpemilu.org#26116,"PONDOK KELAPA, DUREN SAWIT, JAKARTA TIMUR, DKI JAKARTA",15,0,0,0
https://kawalpemilu.org#26116,"PONDOK KELAPA, DUREN SAWIT, JAKARTA TIMUR, DKI JAKARTA",17,72,119,191
https://kawalpemilu.org#26116,"PONDOK KELAPA, DUREN SAWIT, JAKARTA TIMUR, DKI JAKARTA",18,116,147,263
https://kawalpemilu.org#26116,"PONDOK KELAPA, DUREN SAWIT, JAKARTA TIMUR, DKI JAKARTA",19,112,234,346
https://kawalpemilu.org#26116,"PONDOK KELAPA, DUREN SAWIT, JAKARTA TIMUR, DKI JAKARTA",20,124,115,239
https://kawalpemilu.org#26116,"PONDOK KELAPA, DUREN SAWIT, JAKARTA TIMUR, DKI JAKARTA",21,79,133,212
https://kawalpemilu.org#26116,"PONDOK KELAPA, DUREN SAWIT, JAKARTA TIMUR, DKI JAKARTA",22,117,143,260
https://kawalpemilu.org#26116,"PONDOK KELAPA, DUREN SAWIT, JAKARTA TIMUR, DKI JAKARTA",23,105,96,201
https://kawalpemilu.org#26116,"PONDOK KELAPA, DUREN SAWIT, JAKARTA TIMUR, DKI JAKARTA",24,62,111,173
https://kawalpemilu.org#26116,"PONDOK KELAPA, DUREN SAWIT, JAKARTA TIMUR, DKI JAKARTA",25,51,122,173
https://kawalpemilu.org#26116,"PONDOK KELAPA, DUREN SAWIT, JAKARTA TIMUR, DKI JAKARTA",26,86,159,245
https://kawalpemilu.org#26116,"PONDOK KELAPA, DUREN SAWIT, JAKARTA TIMUR, DKI JAKARTA",27,59,170,229
https://kawalpemilu.org#26116,"PONDOK KELAPA, DUREN SAWIT, JAKARTA TIMUR, DKI JAKARTA",28,100,161,261
https://kawalpemilu.org#26116,"PONDOK KELAPA, DUREN SAWIT, JAKARTA TIMUR, DKI JAKARTA",29,90,120,210
https://kawalpemilu.org#26116,"PONDOK KELAPA, DUREN SAWIT, JAKARTA TIMUR, DKI JAKARTA",30,49,104,153
https://kawalpemilu.org#26116,"PONDOK KELAPA, DUREN SAWIT, JAKARTA TIMUR, DKI JAKARTA",31,123,90,213
https://kawalpemilu.org#26116,"PONDOK KELAPA, DUREN SAWIT, JAKARTA TIMUR, DKI JAKARTA",32,98,83,181
https://kawalpemilu.org#26116,"PONDOK KELAPA, DUREN SAWIT, JAKARTA TIMUR, DKI JAKARTA",33,66,90,156
https://kawalpemilu.org#26116,"PONDOK KELAPA, DUREN SAWIT, JAKARTA TIMUR, DKI JAKARTA",34,115,91,206
https://kawalpemilu.org#26116,"PONDOK KELAPA, DUREN SAWIT, JAKARTA TIMUR, DKI JAKARTA",35,107,100,207
https://kawalpemilu.org#26116,"PONDOK KELAPA, DUREN SAWIT, JAKARTA TIMUR, DKI JAKARTA",36,85,122,207
https://kawalpemilu.org#26116,"PONDOK KELAPA, DUREN SAWIT, JAKARTA TIMUR, DKI JAKARTA",37,98,135,233
https://kawalpemilu.org#26116,"PONDOK KELAPA, DUREN SAWIT, JAKARTA TIMUR, DKI JAKARTA",38,94,115,209
https://kawalpemilu.org#26116,"PONDOK KELAPA, DUREN SAWIT, JAKARTA TIMUR, DKI JAKARTA",39,109,106,215
https://kawalpemilu.org#26116,"PONDOK KELAPA, DUREN SAWIT, JAKARTA TIMUR, DKI JAKARTA",40,70,144,214
https://kawalpemilu.org#26116,"PONDOK KELAPA, DUREN SAWIT, JAKARTA TIMUR, DKI JAKARTA",41,92,111,203
https://kawalpemilu.org#26116,"PONDOK KELAPA, DUREN SAWIT, JAKARTA TIMUR, DKI JAKARTA",42,82,146,228
https://kawalpemilu.org#26116,"PONDOK KELAPA, DUREN SAWIT, JAKARTA TIMUR, DKI JAKARTA",43,77,106,183
https://kawalpemilu.org#26116,"PONDOK KELAPA, DUREN SAWIT, JAKARTA TIMUR, DKI JAKARTA",44,77,102,179
https://kawalpemilu.org#26116,"PONDOK KELAPA, DUREN SAWIT, JAKARTA TIMUR, DKI JAKARTA",45,110,131,241
https://kawalpemilu.org#26116,"PONDOK KELAPA, DUREN SAWIT, JAKARTA TIMUR, DKI JAKARTA",46,0,0,0
https://kawalpemilu.org#26116,"PONDOK KELAPA, DUREN SAWIT, JAKARTA TIMUR, DKI JAKARTA",47,107,77,184
https://kawalpemilu.org#26116,"PONDOK KELAPA, DUREN SAWIT, JAKARTA TIMUR, DKI JAKARTA",49,52,75,127
https://kawalpemilu.org#26116,"PONDOK KELAPA, DUREN SAWIT, JAKARTA TIMUR, DKI JAKARTA",50,86,87,173
https://kawalpemilu.org#26116,"PONDOK KELAPA, DUREN SAWIT, JAKARTA TIMUR, DKI JAKARTA",51,85,103,188
https://kawalpemilu.org#26116,"PONDOK KELAPA, DUREN SAWIT, JAKARTA TIMUR, DKI JAKARTA",52,102,128,230
https://kawalpemilu.org#26116,"PONDOK KELAPA, DUREN SAWIT, JAKARTA TIMUR, DKI JAKARTA",53,102,115,217
https://kawalpemilu.org#26116,"PONDOK KELAPA, DUREN SAWIT, JAKARTA TIMUR, DKI JAKARTA",55,75,94,169
https://kawalpemilu.org#26116,"PONDOK KELAPA, DUREN SAWIT, JAKARTA TIMUR, DKI JAKARTA",56,64,93,157
https://kawalpemilu.org#26116,"PONDOK KELAPA, DUREN SAWIT, JAKARTA TIMUR, DKI JAKARTA",57,117,91,208
https://kawalpemilu.org#26116,"PONDOK KELAPA, DUREN SAWIT, JAKARTA TIMUR, DKI JAKARTA",58,102,107,209
https://kawalpemilu.org#26116,"PONDOK KELAPA, DUREN SAWIT, JAKARTA TIMUR, DKI JAKARTA",59,118,123,241
https://kawalpemilu.org#26116,"PONDOK KELAPA, DUREN SAWIT, JAKARTA TIMUR, DKI JAKARTA",60,139,96,235
https://kawalpemilu.org#26116,"PONDOK KELAPA, DUREN SAWIT, JAKARTA TIMUR, DKI JAKARTA",61,131,135,266
https://kawalpemilu.org#26116,"PONDOK KELAPA, DUREN SAWIT, JAKARTA TIMUR, DKI JAKARTA",62,74,182,256
https://kawalpemilu.org#26116,"PONDOK KELAPA, DUREN SAWIT, JAKARTA TIMUR, DKI JAKARTA",63,89,138,227
https://kawalpemilu.org#26116,"PONDOK KELAPA, DUREN SAWIT, JAKARTA TIMUR, DKI JAKARTA",64,91,174,265
https://kawalpemilu.org#26116,"PONDOK KELAPA, DUREN SAWIT, JAKARTA TIMUR, DKI JAKARTA",65,82,167,249
https://kawalpemilu.org#26116,"PONDOK KELAPA, DUREN SAWIT, JAKARTA TIMUR, DKI JAKARTA",66,107,126,233
https://kawalpemilu.org#26116,"PONDOK KELAPA, DUREN SAWIT, JAKARTA TIMUR, DKI JAKARTA",67,86,138,224
https://kawalpemilu.org#26116,"PONDOK KELAPA, DUREN SAWIT, JAKARTA TIMUR, DKI JAKARTA",68,70,188,258
https://kawalpemilu.org#26116,"PONDOK KELAPA, DUREN SAWIT, JAKARTA TIMUR, DKI JAKARTA",69,99,170,269
https://kawalpemilu.org#26116,"PONDOK KELAPA, DUREN SAWIT, JAKARTA TIMUR, DKI JAKARTA",70,125,125,250
https://kawalpemilu.org#26116,"PONDOK KELAPA, DUREN SAWIT, JAKARTA TIMUR, DKI JAKARTA",71,90,116,206
https://kawalpemilu.org#26116,"PONDOK KELAPA, DUREN SAWIT, JAKARTA TIMUR, DKI JAKARTA",72,97,130,227
https://kawalpemilu.org#26116,"PONDOK KELAPA, DUREN SAWIT, JAKARTA TIMUR, DKI JAKARTA",73,65,126,191
https://kawalpemilu.org#26116,"PONDOK KELAPA, DUREN SAWIT, JAKARTA TIMUR, DKI JAKARTA",74,124,114,238
https://kawalpemilu.org#26116,"PONDOK KELAPA, DUREN SAWIT, JAKARTA TIMUR, DKI JAKARTA",75,114,105,219
https://kawalpemilu.org#26116,"PONDOK KELAPA, DUREN SAWIT, JAKARTA TIMUR, DKI JAKARTA",76,136,98,234
https://kawalpemilu.org#26116,"PONDOK KELAPA, DUREN SAWIT, JAKARTA TIMUR, DKI JAKARTA",77,139,77,216
https://kawalpemilu.org#26116,"PONDOK KELAPA, DUREN SAWIT, JAKARTA TIMUR, DKI JAKARTA",78,133,105,238
https://kawalpemilu.org#26116,"PONDOK KELAPA, DUREN SAWIT, JAKARTA TIMUR, DKI JAKARTA",79,132,113,245
https://kawalpemilu.org#26116,"PONDOK KELAPA, DUREN SAWIT, JAKARTA TIMUR, DKI JAKARTA",80,118,107,225
https://kawalpemilu.org#26116,"PONDOK KELAPA, DUREN SAWIT, JAKARTA TIMUR, DKI JAKARTA",81,137,85,222
https://kawalpemilu.org#26116,"PONDOK KELAPA, DUREN SAWIT, JAKARTA TIMUR, DKI JAKARTA",82,134,72,206
https://kawalpemilu.org#26116,"PONDOK KELAPA, DUREN SAWIT, JAKARTA TIMUR, DKI JAKARTA",83,155,108,263
https://kawalpemilu.org#26116,"PONDOK KELAPA, DUREN SAWIT, JAKARTA TIMUR, DKI JAKARTA",84,85,139,224
https://kawalpemilu.org#26116,"PONDOK KELAPA, DUREN SAWIT, JAKARTA TIMUR, DKI JAKARTA",85,123,91,214
https://kawalpemilu.org#26116,"PONDOK KELAPA, DUREN SAWIT, JAKARTA TIMUR, DKI JAKARTA",86,80,75,155
https://kawalpemilu.org#26116,"PONDOK KELAPA, DUREN SAWIT, JAKARTA TIMUR, DKI JAKARTA",87,128,69,197
https://kawalpemilu.org#26116,"PONDOK KELAPA, DUREN SAWIT, JAKARTA TIMUR, DKI JAKARTA",88,121,71,192
https://kawalpemilu.org#26116,"PONDOK KELAPA, DUREN SAWIT, JAKARTA TIMUR, DKI JAKARTA",89,105,79,0
https://kawalpemilu.org#26116,"PONDOK KELAPA, DUREN SAWIT, JAKARTA TIMUR, DKI JAKARTA",90,94,124,218
https://kawalpemilu.org#26116,"PONDOK KELAPA, DUREN SAWIT, JAKARTA TIMUR, DKI JAKARTA",91,87,154,241
https://kawalpemilu.org#26116,"PONDOK KELAPA, DUREN SAWIT, JAKARTA TIMUR, DKI JAKARTA",92,95,162,257
https://kawalpemilu.org#26116,"PONDOK KELAPA, DUREN SAWIT, JAKARTA TIMUR, DKI JAKARTA",93,122,132,254
https://kawalpemilu.org#26116,"PONDOK KELAPA, DUREN SAWIT, JAKARTA TIMUR, DKI JAKARTA",94,100,116,216
https://kawalpemilu.org#26116,"PONDOK KELAPA, DUREN SAWIT, JAKARTA TIMUR, DKI JAKARTA",96,124,90,214
https://kawalpemilu.org#26116,"PONDOK KELAPA, DUREN SAWIT, JAKARTA TIMUR, DKI JAKARTA",97,94,98,192
https://kawalpemilu.org#26116,"PONDOK KELAPA, DUREN SAWIT, JAKARTA TIMUR, DKI JAKARTA",98,121,120,241
https://kawalpemilu.org#26116,"PONDOK KELAPA, DUREN SAWIT, JAKARTA TIMUR, DKI JAKARTA",100,125,143,268
https://kawalpemilu.org#26116,"PONDOK KELAPA, DUREN SAWIT, JAKARTA TIMUR, DKI JAKARTA",101,148,107,255
https://kawalpemilu.org#26116,"PONDOK KELAPA, DUREN SAWIT, JAKARTA TIMUR, DKI JAKARTA",102,140,130,270
https://kawalpemilu.org#26116,"PONDOK KELAPA, DUREN SAWIT, JAKARTA TIMUR, DKI JAKARTA",103,105,141,246
https://kawalpemilu.org#26116,"PONDOK KELAPA, DUREN SAWIT, JAKARTA TIMUR, DKI JAKARTA",104,119,146,265
https://kawalpemilu.org#26116,"PONDOK KELAPA, DUREN SAWIT, JAKARTA TIMUR, DKI JAKARTA",105,112,129,241
https://kawalpemilu.org#26116,"PONDOK KELAPA, DUREN SAWIT, JAKARTA TIMUR, DKI JAKARTA",107,118,105,223
https://kawalpemilu.org#26116,"PONDOK KELAPA, DUREN SAWIT, JAKARTA TIMUR, DKI JAKARTA",108,105,123,228
https://kawalpemilu.org#26116,"PONDOK KELAPA, DUREN SAWIT, JAKARTA TIMUR, DKI JAKARTA",109,63,170,233
https://kawalpemilu.org#26116,"PONDOK KELAPA, DUREN SAWIT, JAKARTA TIMUR, DKI JAKARTA",111,58,164,222
https://kawalpemilu.org#26116,"PONDOK KELAPA, DUREN SAWIT, JAKARTA TIMUR, DKI JAKARTA",112,57,129,186
https://kawalpemilu.org#26116,"PONDOK KELAPA, DUREN SAWIT, JAKARTA TIMUR, DKI JAKARTA",113,104,130,234
https://kawalpemilu.org#26116,"PONDOK KELAPA, DUREN SAWIT, JAKARTA TIMUR, DKI JAKARTA",114,93,130,223
https://kawalpemilu.org#26116,"PONDOK KELAPA, DUREN SAWIT, JAKARTA TIMUR, DKI JAKARTA",115,92,134,226
https://kawalpemilu.org#26116,"PONDOK KELAPA, DUREN SAWIT, JAKARTA TIMUR, DKI JAKARTA",116,70,141,211
https://kawalpemilu.org#26116,"PONDOK KELAPA, DUREN SAWIT, JAKARTA TIMUR, DKI JAKARTA",118,108,158,266
https://kawalpemilu.org#26116,"PONDOK KELAPA, DUREN SAWIT, JAKARTA TIMUR, DKI JAKARTA",120,88,195,283
https://kawalpemilu.org#26116,"PONDOK KELAPA, DUREN SAWIT, JAKARTA TIMUR, DKI JAKARTA",121,144,66,210
https://kawalpemilu.org#26116,"PONDOK KELAPA, DUREN SAWIT, JAKARTA TIMUR, DKI JAKARTA",122,105,106,211
https://kawalpemilu.org#26116,"PONDOK KELAPA, DUREN SAWIT, JAKARTA TIMUR, DKI JAKARTA",124,115,125,240
https://kawalpemilu.org#26116,"PONDOK KELAPA, DUREN SAWIT, JAKARTA TIMUR, DKI JAKARTA",125,106,122,228
https://kawalpemilu.org#26116,"PONDOK KELAPA, DUREN SAWIT, JAKARTA TIMUR, DKI JAKARTA",127,127,125,252
https://kawalpemilu.org#26116,"PONDOK KELAPA, DUREN SAWIT, JAKARTA TIMUR, DKI JAKARTA",128,120,164,284
https://kawalpemilu.org#26116,"PONDOK KELAPA, DUREN SAWIT, JAKARTA TIMUR, DKI JAKARTA",129,95,173,268
https://kawalpemilu.org#26116,"PONDOK KELAPA, DUREN SAWIT, JAKARTA TIMUR, DKI JAKARTA",130,117,117,234
https://kawalpemilu.org#26116,"PONDOK KELAPA, DUREN SAWIT, JAKARTA TIMUR, DKI JAKARTA",131,86,161,247
https://kawalpemilu.org#26116,"PONDOK KELAPA, DUREN SAWIT, JAKARTA TIMUR, DKI JAKARTA",132,71,140,211
https://kawalpemilu.org#26116,"PONDOK KELAPA, DUREN SAWIT, JAKARTA TIMUR, DKI JAKARTA",133,98,84,182
https://kawalpemilu.org#26116,"PONDOK KELAPA, DUREN SAWIT, JAKARTA TIMUR, DKI JAKARTA",134,86,58,144
https://kawalpemilu.org#26116,"PONDOK KELAPA, DUREN SAWIT, JAKARTA TIMUR, DKI JAKARTA",135,174,60,234
https://kawalpemilu.org#26116,"PONDOK KELAPA, DUREN SAWIT, JAKARTA TIMUR, DKI JAKARTA",136,152,95,247
https://kawalpemilu.org#26116,"PONDOK KELAPA, DUREN SAWIT, JAKARTA TIMUR, DKI JAKARTA",137,101,160,261
https://kawalpemilu.org#26116,"PONDOK KELAPA, DUREN SAWIT, JAKARTA TIMUR, DKI JAKARTA",138,95,145,240
https://kawalpemilu.org#26116,"PONDOK KELAPA, DUREN SAWIT, JAKARTA TIMUR, DKI JAKARTA",139,69,82,151
https://kawalpemilu.org#26116,"PONDOK KELAPA, DUREN SAWIT, JAKARTA TIMUR, DKI JAKARTA",140,111,81,192
https://kawalpemilu.org#26116,"PONDOK KELAPA, DUREN SAWIT, JAKARTA TIMUR, DKI JAKARTA",141,85,179,264
https://kawalpemilu.org#26116,"PONDOK KELAPA, DUREN SAWIT, JAKARTA TIMUR, DKI JAKARTA",142,152,85,237
https://kawalpemilu.org#26116,"PONDOK KELAPA, DUREN SAWIT, JAKARTA TIMUR, DKI JAKARTA",143,146,81,227
https://kawalpemilu.org#26116,"PONDOK KELAPA, DUREN SAWIT, JAKARTA TIMUR, DKI JAKARTA",144,142,64,206
https://kawalpemilu.org#26116,"PONDOK KELAPA, DUREN SAWIT, JAKARTA TIMUR, DKI JAKARTA",145,99,32,131
https://kawalpemilu.org#26116,"PONDOK KELAPA, DUREN SAWIT, JAKARTA TIMUR, DKI JAKARTA",146,142,52,194
https://kawalpemilu.org#26116,"PONDOK KELAPA, DUREN SAWIT, JAKARTA TIMUR, DKI JAKARTA",147,87,177,264
https://kawalpemilu.org#26116,"PONDOK KELAPA, DUREN SAWIT, JAKARTA TIMUR, DKI JAKARTA",148,75,165,240
https://kawalpemilu.org#26116,"PONDOK KELAPA, DUREN SAWIT, JAKARTA TIMUR, DKI JAKARTA",149,85,101,186
https://kawalpemilu.org#26116,"PONDOK KELAPA, DUREN SAWIT, JAKARTA TIMUR, DKI JAKARTA",150,106,121,227
https://kawalpemilu.org#26116,"PONDOK KELAPA, DUREN SAWIT, JAKARTA TIMUR, DKI JAKARTA",151,110,104,214
https://kawalpemilu.org#26116,"PONDOK KELAPA, DUREN SAWIT, JAKARTA TIMUR, DKI JAKARTA",152,79,124,203
https://kawalpemilu.org#26116,"PONDOK KELAPA, DUREN SAWIT, JAKARTA TIMUR, DKI JAKARTA",154,79,70,149
https://kawalpemilu.org#26116,"PONDOK KELAPA, DUREN SAWIT, JAKARTA TIMUR, DKI JAKARTA",155,115,88,203
https://kawalpemilu.org#26116,"PONDOK KELAPA, DUREN SAWIT, JAKARTA TIMUR, DKI JAKARTA",156,125,115,240
https://kawalpemilu.org#26116,"PONDOK KELAPA, DUREN SAWIT, JAKARTA TIMUR, DKI JAKARTA",157,142,133,275
https://kawalpemilu.org#26116,"PONDOK KELAPA, DUREN SAWIT, JAKARTA TIMUR, DKI JAKARTA",158,115,135,250
https://kawalpemilu.org#26116,"PONDOK KELAPA, DUREN SAWIT, JAKARTA TIMUR, DKI JAKARTA",159,133,107,240
https://kawalpemilu.org#26116,"PONDOK KELAPA, DUREN SAWIT, JAKARTA TIMUR, DKI JAKARTA",160,127,87,214
https://kawalpemilu.org#26116,"PONDOK KELAPA, DUREN SAWIT, JAKARTA TIMUR, DKI JAKARTA",162,108,111,219
https://kawalpemilu.org#26116,"PONDOK KELAPA, DUREN SAWIT, JAKARTA TIMUR, DKI JAKARTA",163,96,105,201
https://kawalpemilu.org#26116,"PONDOK KELAPA, DUREN SAWIT, JAKARTA TIMUR, DKI JAKARTA",164,125,88,213
https://kawalpemilu.org#26116,"PONDOK KELAPA, DUREN SAWIT, JAKARTA TIMUR, DKI JAKARTA",165,99,72,171
https://kawalpemilu.org#26116,"PONDOK KELAPA, DUREN SAWIT, JAKARTA TIMUR, DKI JAKARTA",166,115,45,160
https://kawalpemilu.org#26116,"PONDOK KELAPA, DUREN SAWIT, JAKARTA TIMUR, DKI JAKARTA",167,128,90,218
https://kawalpemilu.org#26116,"PONDOK KELAPA, DUREN SAWIT, JAKARTA TIMUR, DKI JAKARTA",168,107,107,214
https://kawalpemilu.org#26116,"PONDOK KELAPA, DUREN SAWIT, JAKARTA TIMUR, DKI JAKARTA",169,97,154,251
https://kawalpemilu.org#26116,"PONDOK KELAPA, DUREN SAWIT, JAKARTA TIMUR, DKI JAKARTA",171,95,145,240
https://kawalpemilu.org#26116,"PONDOK KELAPA, DUREN SAWIT, JAKARTA TIMUR, DKI JAKARTA",173,103,146,249
https://kawalpemilu.org#26116,"PONDOK KELAPA, DUREN SAWIT, JAKARTA TIMUR, DKI JAKARTA",174,141,114,255
https://kawalpemilu.org#26116,"PONDOK KELAPA, DUREN SAWIT, JAKARTA TIMUR, DKI JAKARTA",175,139,94,233
https://kawalpemilu.org#26116,"PONDOK KELAPA, DUREN SAWIT, JAKARTA TIMUR, DKI JAKARTA",176,111,97,208
https://kawalpemilu.org#26116,"PONDOK KELAPA, DUREN SAWIT, JAKARTA TIMUR, DKI JAKARTA",177,85,136,221
https://kawalpemilu.org#26116,"PONDOK KELAPA, DUREN SAWIT, JAKARTA TIMUR, DKI JAKARTA",178,78,139,217
https://kawalpemilu.org#26116,"PONDOK KELAPA, DUREN SAWIT, JAKARTA TIMUR, DKI JAKARTA",179,113,92,205
https://kawalpemilu.org#26116,"PONDOK KELAPA, DUREN SAWIT, JAKARTA TIMUR, DKI JAKARTA",180,88,107,195
https://kawalpemilu.org#26116,"PONDOK KELAPA, DUREN SAWIT, JAKARTA TIMUR, DKI JAKARTA",181,122,82,204
https://kawalpemilu.org#26116,"PONDOK KELAPA, DUREN SAWIT, JAKARTA TIMUR, DKI JAKARTA",182,112,95,207
https://kawalpemilu.org#26116,"PONDOK KELAPA, DUREN SAWIT, JAKARTA TIMUR, DKI JAKARTA",183,104,72,176
https://kawalpemilu.org#26116,"PONDOK KELAPA, DUREN SAWIT, JAKARTA TIMUR, DKI JAKARTA",184,120,126,246
https://kawalpemilu.org#26116,"PONDOK KELAPA, DUREN SAWIT, JAKARTA TIMUR, DKI JAKARTA",185,112,120,232
https://kawalpemilu.org#26116,"PONDOK KELAPA, DUREN SAWIT, JAKARTA TIMUR, DKI JAKARTA",186,97,143,240
https://kawalpemilu.org#26116,"PONDOK KELAPA, DUREN SAWIT, JAKARTA TIMUR, DKI JAKARTA",187,81,105,186
https://kawalpemilu.org#26116,"PONDOK KELAPA, DUREN SAWIT, JAKARTA TIMUR, DKI JAKARTA",188,103,144,247
https://kawalpemilu.org#26116,"PONDOK KELAPA, DUREN SAWIT, JAKARTA TIMUR, DKI JAKARTA",189,183,73,256
https://kawalpemilu.org#26116,"PONDOK KELAPA, DUREN SAWIT, JAKARTA TIMUR, DKI JAKARTA",190,91,146,237
https://kawalpemilu.org#26116,"PONDOK KELAPA, DUREN SAWIT, JAKARTA TIMUR, DKI JAKARTA",191,130,67,197
https://kawalpemilu.org#26116,"PONDOK KELAPA, DUREN SAWIT, JAKARTA TIMUR, DKI JAKARTA",192,118,52,170
https://kawalpemilu.org#26116,"PONDOK KELAPA, DUREN SAWIT, JAKARTA TIMUR, DKI JAKARTA",193,130,48,178
https://kawalpemilu.org#26116,"PONDOK KELAPA, DUREN SAWIT, JAKARTA TIMUR, DKI JAKARTA",195,150,67,217
https://kawalpemilu.org#26116,"PONDOK KELAPA, DUREN SAWIT, JAKARTA TIMUR, DKI JAKARTA",196,132,95,227
https://kawalpemilu.org#26116,"PONDOK KELAPA, DUREN SAWIT, JAKARTA TIMUR, DKI JAKARTA",197,174,59,233
https://kawalpemilu.org#26116,"PONDOK KELAPA, DUREN SAWIT, JAKARTA TIMUR, DKI JAKARTA",198,116,60,176
https://kawalpemilu.org#26116,"PONDOK KELAPA, DUREN SAWIT, JAKARTA TIMUR, DKI JAKARTA",199,168,69,237
https://kawalpemilu.org#26116,"PONDOK KELAPA, DUREN SAWIT, JAKARTA TIMUR, DKI JAKARTA",200,159,91,250
https://kawalpemilu.org#26116,"PONDOK KELAPA, DUREN SAWIT, JAKARTA TIMUR, DKI JAKARTA",201,116,141,257
https://kawalpemilu.org#26116,"PONDOK KELAPA, DUREN SAWIT, JAKARTA TIMUR, DKI JAKARTA",202,140,111,251
https://kawalpemilu.org#26116,"PONDOK KELAPA, DUREN SAWIT, JAKARTA TIMUR, DKI JAKARTA",203,110,130,240
https://kawalpemilu.org#26116,"PONDOK KELAPA, DUREN SAWIT, JAKARTA TIMUR, DKI JAKARTA",204,115,153,268
https://kawalpemilu.org#26116,"PONDOK KELAPA, DUREN SAWIT, JAKARTA TIMUR, DKI JAKARTA",205,99,146,245
https://kawalpemilu.org#26116,"PONDOK KELAPA, DUREN SAWIT, JAKARTA TIMUR, DKI JAKARTA",206,94,87,181
https://kawalpemilu.org#26116,"PONDOK KELAPA, DUREN SAWIT, JAKARTA TIMUR, DKI JAKARTA",207,114,71,185
https://kawalpemilu.org#26116,"PONDOK KELAPA, DUREN SAWIT, JAKARTA TIMUR, DKI JAKARTA",208,107,103,210
https://kawalpemilu.org#26116,"PONDOK KELAPA, DUREN SAWIT, JAKARTA TIMUR, DKI JAKARTA",210,128,120,248
https://kawalpemilu.org#26116,"PONDOK KELAPA, DUREN SAWIT, JAKARTA TIMUR, DKI JAKARTA",211,80,164,244
https://kawalpemilu.org#26116,"PONDOK KELAPA, DUREN SAWIT, JAKARTA TIMUR, DKI JAKARTA",213,110,142,252
https://kawalpemilu.org#26116,"PONDOK KELAPA, DUREN SAWIT, JAKARTA TIMUR, DKI JAKARTA",214,137,130,267
https://kawalpemilu.org#26116,"PONDOK KELAPA, DUREN SAWIT, JAKARTA TIMUR, DKI JAKARTA",215,92,102,194
https://kawalpemilu.org#26116,"PONDOK KELAPA, DUREN SAWIT, JAKARTA TIMUR, DKI JAKARTA",216,60,108,168
https://kawalpemilu.org#26116,"PONDOK KELAPA, DUREN SAWIT, JAKARTA TIMUR, DKI JAKARTA",217,119,76,195
https://kawalpemilu.org#26116,"PONDOK KELAPA, DUREN SAWIT, JAKARTA TIMUR, DKI JAKARTA",219,142,86,228
https://kawalpemilu.org#26116,"PONDOK KELAPA, DUREN SAWIT, JAKARTA TIMUR, DKI JAKARTA",220,100,94,194
https://kawalpemilu.org#26116,"PONDOK KELAPA, DUREN SAWIT, JAKARTA TIMUR, DKI JAKARTA",221,84,92,176
https://kawalpemilu.org#26116,"PONDOK KELAPA, DUREN SAWIT, JAKARTA TIMUR, DKI JAKARTA",222,96,87,183
https://kawalpemilu.org#26116,"PONDOK KELAPA, DUREN SAWIT, JAKARTA TIMUR, DKI JAKARTA",223,116,120,236
https://kawalpemilu.org#26116,"PONDOK KELAPA, DUREN SAWIT, JAKARTA TIMUR, DKI JAKARTA",224,145,79,224
https://kawalpemilu.org#26116,"PONDOK KELAPA, DUREN SAWIT, JAKARTA TIMUR, DKI JAKARTA",227,160,105,265
https://kawalpemilu.org#26116,"PONDOK KELAPA, DUREN SAWIT, JAKARTA TIMUR, DKI JAKARTA",228,90,93,183
https://kawalpemilu.org#26116,"PONDOK KELAPA, DUREN SAWIT, JAKARTA TIMUR, DKI JAKARTA",229,103,58,161
https://kawalpemilu.org#26116,"PONDOK KELAPA, DUREN SAWIT, JAKARTA TIMUR, DKI JAKARTA",230,114,57,171
https://kawalpemilu.org#26116,"PONDOK KELAPA, DUREN SAWIT, JAKARTA TIMUR, DKI JAKARTA",231,91,39,130
https://kawalpemilu.org#26116,"PONDOK KELAPA, DUREN SAWIT, JAKARTA TIMUR, DKI JAKARTA",232,83,61,144
https://kawalpemilu.org#26116,"PONDOK KELAPA, DUREN SAWIT, JAKARTA TIMUR, DKI JAKARTA",233,142,104,246
https://kawalpemilu.org#26116,"PONDOK KELAPA, DUREN SAWIT, JAKARTA TIMUR, DKI JAKARTA",234,130,96,226
https://kawalpemilu.org#26116,"PONDOK KELAPA, DUREN SAWIT, JAKARTA TIMUR, DKI JAKARTA",235,74,56,130
https://kawalpemilu.org#26116,"PONDOK KELAPA, DUREN SAWIT, JAKARTA TIMUR, DKI JAKARTA",236,109,85,194
https://kawalpemilu.org#26116,"PONDOK KELAPA, DUREN SAWIT, JAKARTA TIMUR, DKI JAKARTA",237,91,69,160
https://kawalpemilu.org#26116,"PONDOK KELAPA, DUREN SAWIT, JAKARTA TIMUR, DKI JAKARTA",238,127,86,213
https://kawalpemilu.org#26117,"MALAKA SARI, DUREN SAWIT, JAKARTA TIMUR, DKI JAKARTA",1,141,94,235
https://kawalpemilu.org#26117,"MALAKA SARI, DUREN SAWIT, JAKARTA TIMUR, DKI JAKARTA",2,154,88,242
https://kawalpemilu.org#26117,"MALAKA SARI, DUREN SAWIT, JAKARTA TIMUR, DKI JAKARTA",5,205,56,261
https://kawalpemilu.org#26117,"MALAKA SARI, DUREN SAWIT, JAKARTA TIMUR, DKI JAKARTA",6,139,102,241
https://kawalpemilu.org#26117,"MALAKA SARI, DUREN SAWIT, JAKARTA TIMUR, DKI JAKARTA",7,114,118,232
https://kawalpemilu.org#26117,"MALAKA SARI, DUREN SAWIT, JAKARTA TIMUR, DKI JAKARTA",8,119,128,247
https://kawalpemilu.org#26117,"MALAKA SARI, DUREN SAWIT, JAKARTA TIMUR, DKI JAKARTA",9,136,90,226
https://kawalpemilu.org#26117,"MALAKA SARI, DUREN SAWIT, JAKARTA TIMUR, DKI JAKARTA",10,154,91,245
https://kawalpemilu.org#26117,"MALAKA SARI, DUREN SAWIT, JAKARTA TIMUR, DKI JAKARTA",11,97,159,256
https://kawalpemilu.org#26117,"MALAKA SARI, DUREN SAWIT, JAKARTA TIMUR, DKI JAKARTA",12,132,111,243
https://kawalpemilu.org#26117,"MALAKA SARI, DUREN SAWIT, JAKARTA TIMUR, DKI JAKARTA",13,126,123,249
https://kawalpemilu.org#26117,"MALAKA SARI, DUREN SAWIT, JAKARTA TIMUR, DKI JAKARTA",14,120,116,236
https://kawalpemilu.org#26117,"MALAKA SARI, DUREN SAWIT, JAKARTA TIMUR, DKI JAKARTA",15,90,152,242
https://kawalpemilu.org#26117,"MALAKA SARI, DUREN SAWIT, JAKARTA TIMUR, DKI JAKARTA",16,108,114,222
https://kawalpemilu.org#26117,"MALAKA SARI, DUREN SAWIT, JAKARTA TIMUR, DKI JAKARTA",17,98,131,229
https://kawalpemilu.org#26117,"MALAKA SARI, DUREN SAWIT, JAKARTA TIMUR, DKI JAKARTA",19,99,139,238
https://kawalpemilu.org#26117,"MALAKA SARI, DUREN SAWIT, JAKARTA TIMUR, DKI JAKARTA",21,112,107,219
https://kawalpemilu.org#26117,"MALAKA SARI, DUREN SAWIT, JAKARTA TIMUR, DKI JAKARTA",22,99,141,240
https://kawalpemilu.org#26117,"MALAKA SARI, DUREN SAWIT, JAKARTA TIMUR, DKI JAKARTA",23,69,155,224
https://kawalpemilu.org#26117,"MALAKA SARI, DUREN SAWIT, JAKARTA TIMUR, DKI JAKARTA",24,96,130,226
https://kawalpemilu.org#26117,"MALAKA SARI, DUREN SAWIT, JAKARTA TIMUR, DKI JAKARTA",27,70,156,226
https://kawalpemilu.org#26117,"MALAKA SARI, DUREN SAWIT, JAKARTA TIMUR, DKI JAKARTA",29,97,142,239
https://kawalpemilu.org#26117,"MALAKA SARI, DUREN SAWIT, JAKARTA TIMUR, DKI JAKARTA",30,88,168,256
https://kawalpemilu.org#26117,"MALAKA SARI, DUREN SAWIT, JAKARTA TIMUR, DKI JAKARTA",31,88,151,239
https://kawalpemilu.org#26117,"MALAKA SARI, DUREN SAWIT, JAKARTA TIMUR, DKI JAKARTA",33,121,137,258
https://kawalpemilu.org#26117,"MALAKA SARI, DUREN SAWIT, JAKARTA TIMUR, DKI JAKARTA",34,129,130,259
https://kawalpemilu.org#26117,"MALAKA SARI, DUREN SAWIT, JAKARTA TIMUR, DKI JAKARTA",35,87,145,232
https://kawalpemilu.org#26117,"MALAKA SARI, DUREN SAWIT, JAKARTA TIMUR, DKI JAKARTA",36,141,108,249
https://kawalpemilu.org#26117,"MALAKA SARI, DUREN SAWIT, JAKARTA TIMUR, DKI JAKARTA",37,99,138,237
https://kawalpemilu.org#26117,"MALAKA SARI, DUREN SAWIT, JAKARTA TIMUR, DKI JAKARTA",39,67,162,229
https://kawalpemilu.org#26117,"MALAKA SARI, DUREN SAWIT, JAKARTA TIMUR, DKI JAKARTA",40,109,134,243
https://kawalpemilu.org#26117,"MALAKA SARI, DUREN SAWIT, JAKARTA TIMUR, DKI JAKARTA",41,83,122,205
https://kawalpemilu.org#26117,"MALAKA SARI, DUREN SAWIT, JAKARTA TIMUR, DKI JAKARTA",42,145,102,247
https://kawalpemilu.org#26117,"MALAKA SARI, DUREN SAWIT, JAKARTA TIMUR, DKI JAKARTA",44,112,127,239
https://kawalpemilu.org#26117,"MALAKA SARI, DUREN SAWIT, JAKARTA TIMUR, DKI JAKARTA",45,98,129,227
https://kawalpemilu.org#26117,"MALAKA SARI, DUREN SAWIT, JAKARTA TIMUR, DKI JAKARTA",46,80,144,224
https://kawalpemilu.org#26117,"MALAKA SARI, DUREN SAWIT, JAKARTA TIMUR, DKI JAKARTA",47,104,141,245
https://kawalpemilu.org#26117,"MALAKA SARI, DUREN SAWIT, JAKARTA TIMUR, DKI JAKARTA",48,115,107,222
https://kawalpemilu.org#26117,"MALAKA SARI, DUREN SAWIT, JAKARTA TIMUR, DKI JAKARTA",49,105,129,233
https://kawalpemilu.org#26117,"MALAKA SARI, DUREN SAWIT, JAKARTA TIMUR, DKI JAKARTA",50,100,109,209
https://kawalpemilu.org#26117,"MALAKA SARI, DUREN SAWIT, JAKARTA TIMUR, DKI JAKARTA",51,108,121,229
https://kawalpemilu.org#26117,"MALAKA SARI, DUREN SAWIT, JAKARTA TIMUR, DKI JAKARTA",52,120,125,245
https://kawalpemilu.org#26117,"MALAKA SARI, DUREN SAWIT, JAKARTA TIMUR, DKI JAKARTA",53,101,155,256
https://kawalpemilu.org#26117,"MALAKA SARI, DUREN SAWIT, JAKARTA TIMUR, DKI JAKARTA",54,75,162,237
https://kawalpemilu.org#26117,"MALAKA SARI, DUREN SAWIT, JAKARTA TIMUR, DKI JAKARTA",55,90,157,247
https://kawalpemilu.org#26117,"MALAKA SARI, DUREN SAWIT, JAKARTA TIMUR, DKI JAKARTA",57,104,147,251
https://kawalpemilu.org#26117,"MALAKA SARI, DUREN SAWIT, JAKARTA TIMUR, DKI JAKARTA",58,118,139,257
https://kawalpemilu.org#26117,"MALAKA SARI, DUREN SAWIT, JAKARTA TIMUR, DKI JAKARTA",60,132,118,250
https://kawalpemilu.org#26117,"MALAKA SARI, DUREN SAWIT, JAKARTA TIMUR, DKI JAKARTA",61,73,155,228
https://kawalpemilu.org#26117,"MALAKA SARI, DUREN SAWIT, JAKARTA TIMUR, DKI JAKARTA",64,91,155,246
https://kawalpemilu.org#26117,"MALAKA SARI, DUREN SAWIT, JAKARTA TIMUR, DKI JAKARTA",65,149,99,248
https://kawalpemilu.org#26117,"MALAKA SARI, DUREN SAWIT, JAKARTA TIMUR, DKI JAKARTA",66,123,122,245
https://kawalpemilu.org#26117,"MALAKA SARI, DUREN SAWIT, JAKARTA TIMUR, DKI JAKARTA",67,95,152,247
https://kawalpemilu.org#26117,"MALAKA SARI, DUREN SAWIT, JAKARTA TIMUR, DKI JAKARTA",68,141,104,245
https://kawalpemilu.org#26117,"MALAKA SARI, DUREN SAWIT, JAKARTA TIMUR, DKI JAKARTA",69,100,141,241
https://kawalpemilu.org#26117,"MALAKA SARI, DUREN SAWIT, JAKARTA TIMUR, DKI JAKARTA",70,119,119,238
https://kawalpemilu.org#26117,"MALAKA SARI, DUREN SAWIT, JAKARTA TIMUR, DKI JAKARTA",71,88,126,214
https://kawalpemilu.org#26117,"MALAKA SARI, DUREN SAWIT, JAKARTA TIMUR, DKI JAKARTA",72,76,113,189
https://kawalpemilu.org#26117,"MALAKA SARI, DUREN SAWIT, JAKARTA TIMUR, DKI JAKARTA",73,157,101,258
https://kawalpemilu.org#26117,"MALAKA SARI, DUREN SAWIT, JAKARTA TIMUR, DKI JAKARTA",74,96,162,258
https://kawalpemilu.org#26117,"MALAKA SARI, DUREN SAWIT, JAKARTA TIMUR, DKI JAKARTA",76,98,140,238
https://kawalpemilu.org#26117,"MALAKA SARI, DUREN SAWIT, JAKARTA TIMUR, DKI JAKARTA",77,125,119,244
https://kawalpemilu.org#26117,"MALAKA SARI, DUREN SAWIT, JAKARTA TIMUR, DKI JAKARTA",78,137,120,257
https://kawalpemilu.org#26117,"MALAKA SARI, DUREN SAWIT, JAKARTA TIMUR, DKI JAKARTA",79,99,139,238
https://kawalpemilu.org#26117,"MALAKA SARI, DUREN SAWIT, JAKARTA TIMUR, DKI JAKARTA",80,113,138,251
https://kawalpemilu.org#26117,"MALAKA SARI, DUREN SAWIT, JAKARTA TIMUR, DKI JAKARTA",81,91,144,235
https://kawalpemilu.org#26117,"MALAKA SARI, DUREN SAWIT, JAKARTA TIMUR, DKI JAKARTA",82,88,79,167
https://kawalpemilu.org#26117,"MALAKA SARI, DUREN SAWIT, JAKARTA TIMUR, DKI JAKARTA",83,115,150,265
https://kawalpemilu.org#26117,"MALAKA SARI, DUREN SAWIT, JAKARTA TIMUR, DKI JAKARTA",84,135,97,232
https://kawalpemilu.org#26117,"MALAKA SARI, DUREN SAWIT, JAKARTA TIMUR, DKI JAKARTA",85,133,105,238
https://kawalpemilu.org#26117,"MALAKA SARI, DUREN SAWIT, JAKARTA TIMUR, DKI JAKARTA",86,138,104,242
https://kawalpemilu.org#26117,"MALAKA SARI, DUREN SAWIT, JAKARTA TIMUR, DKI JAKARTA",87,113,112,225
https://kawalpemilu.org#26118,"MALAKA JAYA, DUREN SAWIT, JAKARTA TIMUR, DKI JAKARTA",4,119,108,227
https://kawalpemilu.org#26118,"MALAKA JAYA, DUREN SAWIT, JAKARTA TIMUR, DKI JAKARTA",5,0,0,254
https://kawalpemilu.org#26118,"MALAKA JAYA, DUREN SAWIT, JAKARTA TIMUR, DKI JAKARTA",6,122,105,227
https://kawalpemilu.org#26118,"MALAKA JAYA, DUREN SAWIT, JAKARTA TIMUR, DKI JAKARTA",9,97,163,260
https://kawalpemilu.org#26118,"MALAKA JAYA, DUREN SAWIT, JAKARTA TIMUR, DKI JAKARTA",10,103,157,260
https://kawalpemilu.org#26118,"MALAKA JAYA, DUREN SAWIT, JAKARTA TIMUR, DKI JAKARTA",12,102,161,263
https://kawalpemilu.org#26118,"MALAKA JAYA, DUREN SAWIT, JAKARTA TIMUR, DKI JAKARTA",13,123,124,247
https://kawalpemilu.org#26118,"MALAKA JAYA, DUREN SAWIT, JAKARTA TIMUR, DKI JAKARTA",15,81,164,245
https://kawalpemilu.org#26118,"MALAKA JAYA, DUREN SAWIT, JAKARTA TIMUR, DKI JAKARTA",16,91,133,224
https://kawalpemilu.org#26118,"MALAKA JAYA, DUREN SAWIT, JAKARTA TIMUR, DKI JAKARTA",17,79,171,250
https://kawalpemilu.org#26118,"MALAKA JAYA, DUREN SAWIT, JAKARTA TIMUR, DKI JAKARTA",18,109,124,233
https://kawalpemilu.org#26118,"MALAKA JAYA, DUREN SAWIT, JAKARTA TIMUR, DKI JAKARTA",19,143,84,227
https://kawalpemilu.org#26118,"MALAKA JAYA, DUREN SAWIT, JAKARTA TIMUR, DKI JAKARTA",20,101,136,237
https://kawalpemilu.org#26118,"MALAKA JAYA, DUREN SAWIT, JAKARTA TIMUR, DKI JAKARTA",21,100,147,247
https://kawalpemilu.org#26118,"MALAKA JAYA, DUREN SAWIT, JAKARTA TIMUR, DKI JAKARTA",22,100,146,246
https://kawalpemilu.org#26118,"MALAKA JAYA, DUREN SAWIT, JAKARTA TIMUR, DKI JAKARTA",23,93,161,254
https://kawalpemilu.org#26118,"MALAKA JAYA, DUREN SAWIT, JAKARTA TIMUR, DKI JAKARTA",24,108,129,237
https://kawalpemilu.org#26118,"MALAKA JAYA, DUREN SAWIT, JAKARTA TIMUR, DKI JAKARTA",25,66,164,230
https://kawalpemilu.org#26118,"MALAKA JAYA, DUREN SAWIT, JAKARTA TIMUR, DKI JAKARTA",26,87,152,239
https://kawalpemilu.org#26118,"MALAKA JAYA, DUREN SAWIT, JAKARTA TIMUR, DKI JAKARTA",27,143,102,245
https://kawalpemilu.org#26118,"MALAKA JAYA, DUREN SAWIT, JAKARTA TIMUR, DKI JAKARTA",28,100,144,244
https://kawalpemilu.org#26118,"MALAKA JAYA, DUREN SAWIT, JAKARTA TIMUR, DKI JAKARTA",29,106,127,233
https://kawalpemilu.org#26118,"MALAKA JAYA, DUREN SAWIT, JAKARTA TIMUR, DKI JAKARTA",30,118,136,254
https://kawalpemilu.org#26118,"MALAKA JAYA, DUREN SAWIT, JAKARTA TIMUR, DKI JAKARTA",31,112,128,240
https://kawalpemilu.org#26118,"MALAKA JAYA, DUREN SAWIT, JAKARTA TIMUR, DKI JAKARTA",32,106,131,237
https://kawalpemilu.org#26118,"MALAKA JAYA, DUREN SAWIT, JAKARTA TIMUR, DKI JAKARTA",33,91,153,244
https://kawalpemilu.org#26118,"MALAKA JAYA, DUREN SAWIT, JAKARTA TIMUR, DKI JAKARTA",34,77,158,235
https://kawalpemilu.org#26118,"MALAKA JAYA, DUREN SAWIT, JAKARTA TIMUR, DKI JAKARTA",35,106,129,235
https://kawalpemilu.org#26118,"MALAKA JAYA, DUREN SAWIT, JAKARTA TIMUR, DKI JAKARTA",36,85,158,243
https://kawalpemilu.org#26118,"MALAKA JAYA, DUREN SAWIT, JAKARTA TIMUR, DKI JAKARTA",37,112,125,237
https://kawalpemilu.org#26118,"MALAKA JAYA, DUREN SAWIT, JAKARTA TIMUR, DKI JAKARTA",38,104,110,214
https://kawalpemilu.org#26118,"MALAKA JAYA, DUREN SAWIT, JAKARTA TIMUR, DKI JAKARTA",39,124,138,262
https://kawalpemilu.org#26118,"MALAKA JAYA, DUREN SAWIT, JAKARTA TIMUR, DKI JAKARTA",40,93,136,229
https://kawalpemilu.org#26118,"MALAKA JAYA, DUREN SAWIT, JAKARTA TIMUR, DKI JAKARTA",41,111,135,246
https://kawalpemilu.org#26118,"MALAKA JAYA, DUREN SAWIT, JAKARTA TIMUR, DKI JAKARTA",43,98,184,282
https://kawalpemilu.org#26118,"MALAKA JAYA, DUREN SAWIT, JAKARTA TIMUR, DKI JAKARTA",44,85,185,270
https://kawalpemilu.org#26118,"MALAKA JAYA, DUREN SAWIT, JAKARTA TIMUR, DKI JAKARTA",45,100,159,259
https://kawalpemilu.org#26118,"MALAKA JAYA, DUREN SAWIT, JAKARTA TIMUR, DKI JAKARTA",46,87,165,252
https://kawalpemilu.org#26118,"MALAKA JAYA, DUREN SAWIT, JAKARTA TIMUR, DKI JAKARTA",47,95,131,226
https://kawalpemilu.org#26118,"MALAKA JAYA, DUREN SAWIT, JAKARTA TIMUR, DKI JAKARTA",48,74,176,250
https://kawalpemilu.org#26118,"MALAKA JAYA, DUREN SAWIT, JAKARTA TIMUR, DKI JAKARTA",49,89,153,242
https://kawalpemilu.org#26118,"MALAKA JAYA, DUREN SAWIT, JAKARTA TIMUR, DKI JAKARTA",50,86,146,232
https://kawalpemilu.org#26118,"MALAKA JAYA, DUREN SAWIT, JAKARTA TIMUR, DKI JAKARTA",51,88,166,254
https://kawalpemilu.org#26118,"MALAKA JAYA, DUREN SAWIT, JAKARTA TIMUR, DKI JAKARTA",52,88,181,269
https://kawalpemilu.org#26118,"MALAKA JAYA, DUREN SAWIT, JAKARTA TIMUR, DKI JAKARTA",53,128,127,255
https://kawalpemilu.org#26118,"MALAKA JAYA, DUREN SAWIT, JAKARTA TIMUR, DKI JAKARTA",54,103,138,241
https://kawalpemilu.org#26118,"MALAKA JAYA, DUREN SAWIT, JAKARTA TIMUR, DKI JAKARTA",55,92,127,219
https://kawalpemilu.org#26118,"MALAKA JAYA, DUREN SAWIT, JAKARTA TIMUR, DKI JAKARTA",56,106,133,239
https://kawalpemilu.org#26118,"MALAKA JAYA, DUREN SAWIT, JAKARTA TIMUR, DKI JAKARTA",57,131,113,244
https://kawalpemilu.org#26118,"MALAKA JAYA, DUREN SAWIT, JAKARTA TIMUR, DKI JAKARTA",58,100,109,209
https://kawalpemilu.org#26118,"MALAKA JAYA, DUREN SAWIT, JAKARTA TIMUR, DKI JAKARTA",60,107,143,250
https://kawalpemilu.org#26118,"MALAKA JAYA, DUREN SAWIT, JAKARTA TIMUR, DKI JAKARTA",61,76,132,208
https://kawalpemilu.org#26118,"MALAKA JAYA, DUREN SAWIT, JAKARTA TIMUR, DKI JAKARTA",62,98,136,234
https://kawalpemilu.org#26118,"MALAKA JAYA, DUREN SAWIT, JAKARTA TIMUR, DKI JAKARTA",63,87,141,228
https://kawalpemilu.org#26118,"MALAKA JAYA, DUREN SAWIT, JAKARTA TIMUR, DKI JAKARTA",64,90,141,231
https://kawalpemilu.org#26118,"MALAKA JAYA, DUREN SAWIT, JAKARTA TIMUR, DKI JAKARTA",67,107,128,235
https://kawalpemilu.org#26118,"MALAKA JAYA, DUREN SAWIT, JAKARTA TIMUR, DKI JAKARTA",69,104,154,258
https://kawalpemilu.org#26118,"MALAKA JAYA, DUREN SAWIT, JAKARTA TIMUR, DKI JAKARTA",70,113,105,218
https://kawalpemilu.org#26118,"MALAKA JAYA, DUREN SAWIT, JAKARTA TIMUR, DKI JAKARTA",71,121,141,262
https://kawalpemilu.org#26118,"MALAKA JAYA, DUREN SAWIT, JAKARTA TIMUR, DKI JAKARTA",72,126,146,272
https://kawalpemilu.org#26118,"MALAKA JAYA, DUREN SAWIT, JAKARTA TIMUR, DKI JAKARTA",73,105,175,280
https://kawalpemilu.org#26118,"MALAKA JAYA, DUREN SAWIT, JAKARTA TIMUR, DKI JAKARTA",74,89,77,166
https://kawalpemilu.org#26118,"MALAKA JAYA, DUREN SAWIT, JAKARTA TIMUR, DKI JAKARTA",75,146,118,264
https://kawalpemilu.org#26118,"MALAKA JAYA, DUREN SAWIT, JAKARTA TIMUR, DKI JAKARTA",76,114,146,260
https://kawalpemilu.org#26118,"MALAKA JAYA, DUREN SAWIT, JAKARTA TIMUR, DKI JAKARTA",77,94,148,242
https://kawalpemilu.org#26118,"MALAKA JAYA, DUREN SAWIT, JAKARTA TIMUR, DKI JAKARTA",78,165,94,259
https://kawalpemilu.org#26118,"MALAKA JAYA, DUREN SAWIT, JAKARTA TIMUR, DKI JAKARTA",79,134,127,261
https://kawalpemilu.org#26118,"MALAKA JAYA, DUREN SAWIT, JAKARTA TIMUR, DKI JAKARTA",80,128,124,252
https://kawalpemilu.org#26118,"MALAKA JAYA, DUREN SAWIT, JAKARTA TIMUR, DKI JAKARTA",81,131,69,200
https://kawalpemilu.org#26118,"MALAKA JAYA, DUREN SAWIT, JAKARTA TIMUR, DKI JAKARTA",82,114,149,263
https://kawalpemilu.org#26118,"MALAKA JAYA, DUREN SAWIT, JAKARTA TIMUR, DKI JAKARTA",83,103,164,267
https://kawalpemilu.org#26118,"MALAKA JAYA, DUREN SAWIT, JAKARTA TIMUR, DKI JAKARTA",85,97,150,247
https://kawalpemilu.org#26118,"MALAKA JAYA, DUREN SAWIT, JAKARTA TIMUR, DKI JAKARTA",86,91,185,276
https://kawalpemilu.org#26118,"MALAKA JAYA, DUREN SAWIT, JAKARTA TIMUR, DKI JAKARTA",87,125,140,265
https://kawalpemilu.org#26118,"MALAKA JAYA, DUREN SAWIT, JAKARTA TIMUR, DKI JAKARTA",88,107,162,269
https://kawalpemilu.org#26118,"MALAKA JAYA, DUREN SAWIT, JAKARTA TIMUR, DKI JAKARTA",89,99,166,265
https://kawalpemilu.org#26118,"MALAKA JAYA, DUREN SAWIT, JAKARTA TIMUR, DKI JAKARTA",90,88,177,265
https://kawalpemilu.org#26118,"MALAKA JAYA, DUREN SAWIT, JAKARTA TIMUR, DKI JAKARTA",92,107,129,236
https://kawalpemilu.org#26118,"MALAKA JAYA, DUREN SAWIT, JAKARTA TIMUR, DKI JAKARTA",93,143,125,268
https://kawalpemilu.org#26118,"MALAKA JAYA, DUREN SAWIT, JAKARTA TIMUR, DKI JAKARTA",94,115,130,245
https://kawalpemilu.org#26118,"MALAKA JAYA, DUREN SAWIT, JAKARTA TIMUR, DKI JAKARTA",95,101,139,240
https://kawalpemilu.org#26119,"PONDOK KOPI, DUREN SAWIT, JAKARTA TIMUR, DKI JAKARTA",1,123,119,242
https://kawalpemilu.org#26119,"PONDOK KOPI, DUREN SAWIT, JAKARTA TIMUR, DKI JAKARTA",3,104,164,268
https://kawalpemilu.org#26119,"PONDOK KOPI, DUREN SAWIT, JAKARTA TIMUR, DKI JAKARTA",6,95,107,202
https://kawalpemilu.org#26119,"PONDOK KOPI, DUREN SAWIT, JAKARTA TIMUR, DKI JAKARTA",8,93,135,228
https://kawalpemilu.org#26119,"PONDOK KOPI, DUREN SAWIT, JAKARTA TIMUR, DKI JAKARTA",9,112,132,244
https://kawalpemilu.org#26119,"PONDOK KOPI, DUREN SAWIT, JAKARTA TIMUR, DKI JAKARTA",10,85,143,228
https://kawalpemilu.org#26119,"PONDOK KOPI, DUREN SAWIT, JAKARTA TIMUR, DKI JAKARTA",11,113,155,268
https://kawalpemilu.org#26119,"PONDOK KOPI, DUREN SAWIT, JAKARTA TIMUR, DKI JAKARTA",13,132,80,212
https://kawalpemilu.org#26119,"PONDOK KOPI, DUREN SAWIT, JAKARTA TIMUR, DKI JAKARTA",14,90,143,233
https://kawalpemilu.org#26119,"PONDOK KOPI, DUREN SAWIT, JAKARTA TIMUR, DKI JAKARTA",16,57,160,217
https://kawalpemilu.org#26119,"PONDOK KOPI, DUREN SAWIT, JAKARTA TIMUR, DKI JAKARTA",17,54,192,246
https://kawalpemilu.org#26119,"PONDOK KOPI, DUREN SAWIT, JAKARTA TIMUR, DKI JAKARTA",20,105,69,174
https://kawalpemilu.org#26119,"PONDOK KOPI, DUREN SAWIT, JAKARTA TIMUR, DKI JAKARTA",21,97,71,168
https://kawalpemilu.org#26119,"PONDOK KOPI, DUREN SAWIT, JAKARTA TIMUR, DKI JAKARTA",22,96,130,226
https://kawalpemilu.org#26119,"PONDOK KOPI, DUREN SAWIT, JAKARTA TIMUR, DKI JAKARTA",23,114,114,228
https://kawalpemilu.org#26119,"PONDOK KOPI, DUREN SAWIT, JAKARTA TIMUR, DKI JAKARTA",24,78,127,205
https://kawalpemilu.org#26119,"PONDOK KOPI, DUREN SAWIT, JAKARTA TIMUR, DKI JAKARTA",25,93,106,199
https://kawalpemilu.org#26119,"PONDOK KOPI, DUREN SAWIT, JAKARTA TIMUR, DKI JAKARTA",26,132,89,221
https://kawalpemilu.org#26119,"PONDOK KOPI, DUREN SAWIT, JAKARTA TIMUR, DKI JAKARTA",27,123,113,236
https://kawalpemilu.org#26119,"PONDOK KOPI, DUREN SAWIT, JAKARTA TIMUR, DKI JAKARTA",28,123,108,231
https://kawalpemilu.org#26119,"PONDOK KOPI, DUREN SAWIT, JAKARTA TIMUR, DKI JAKARTA",29,128,91,219
https://kawalpemilu.org#26119,"PONDOK KOPI, DUREN SAWIT, JAKARTA TIMUR, DKI JAKARTA",30,175,63,238
https://kawalpemilu.org#26119,"PONDOK KOPI, DUREN SAWIT, JAKARTA TIMUR, DKI JAKARTA",32,112,118,230
https://kawalpemilu.org#26119,"PONDOK KOPI, DUREN SAWIT, JAKARTA TIMUR, DKI JAKARTA",33,92,119,211
https://kawalpemilu.org#26119,"PONDOK KOPI, DUREN SAWIT, JAKARTA TIMUR, DKI JAKARTA",34,96,136,232
https://kawalpemilu.org#26119,"PONDOK KOPI, DUREN SAWIT, JAKARTA TIMUR, DKI JAKARTA",35,107,157,264
https://kawalpemilu.org#26119,"PONDOK KOPI, DUREN SAWIT, JAKARTA TIMUR, DKI JAKARTA",36,100,151,251
https://kawalpemilu.org#26119,"PONDOK KOPI, DUREN SAWIT, JAKARTA TIMUR, DKI JAKARTA",37,83,180,263
https://kawalpemilu.org#26119,"PONDOK KOPI, DUREN SAWIT, JAKARTA TIMUR, DKI JAKARTA",38,81,188,269
https://kawalpemilu.org#26119,"PONDOK KOPI, DUREN SAWIT, JAKARTA TIMUR, DKI JAKARTA",40,93,144,237
https://kawalpemilu.org#26119,"PONDOK KOPI, DUREN SAWIT, JAKARTA TIMUR, DKI JAKARTA",41,84,116,200
https://kawalpemilu.org#26119,"PONDOK KOPI, DUREN SAWIT, JAKARTA TIMUR, DKI JAKARTA",42,88,128,216
https://kawalpemilu.org#26119,"PONDOK KOPI, DUREN SAWIT, JAKARTA TIMUR, DKI JAKARTA",43,96,136,232
https://kawalpemilu.org#26119,"PONDOK KOPI, DUREN SAWIT, JAKARTA TIMUR, DKI JAKARTA",44,109,118,227
https://kawalpemilu.org#26119,"PONDOK KOPI, DUREN SAWIT, JAKARTA TIMUR, DKI JAKARTA",45,93,146,239
https://kawalpemilu.org#26119,"PONDOK KOPI, DUREN SAWIT, JAKARTA TIMUR, DKI JAKARTA",46,88,131,219
https://kawalpemilu.org#26119,"PONDOK KOPI, DUREN SAWIT, JAKARTA TIMUR, DKI JAKARTA",53,146,100,246
https://kawalpemilu.org#26119,"PONDOK KOPI, DUREN SAWIT, JAKARTA TIMUR, DKI JAKARTA",54,104,139,243
https://kawalpemilu.org#26119,"PONDOK KOPI, DUREN SAWIT, JAKARTA TIMUR, DKI JAKARTA",57,127,130,257
https://kawalpemilu.org#26119,"PONDOK KOPI, DUREN SAWIT, JAKARTA TIMUR, DKI JAKARTA",58,109,143,252
https://kawalpemilu.org#26119,"PONDOK KOPI, DUREN SAWIT, JAKARTA TIMUR, DKI JAKARTA",59,134,120,254
https://kawalpemilu.org#26119,"PONDOK KOPI, DUREN SAWIT, JAKARTA TIMUR, DKI JAKARTA",60,151,91,242
https://kawalpemilu.org#26119,"PONDOK KOPI, DUREN SAWIT, JAKARTA TIMUR, DKI JAKARTA",61,112,122,234
https://kawalpemilu.org#26119,"PONDOK KOPI, DUREN SAWIT, JAKARTA TIMUR, DKI JAKARTA",62,125,102,227
https://kawalpemilu.org#26119,"PONDOK KOPI, DUREN SAWIT, JAKARTA TIMUR, DKI JAKARTA",63,91,138,229
https://kawalpemilu.org#26119,"PONDOK KOPI, DUREN SAWIT, JAKARTA TIMUR, DKI JAKARTA",64,125,131,256
https://kawalpemilu.org#26119,"PONDOK KOPI, DUREN SAWIT, JAKARTA TIMUR, DKI JAKARTA",66,130,105,235
https://kawalpemilu.org#26119,"PONDOK KOPI, DUREN SAWIT, JAKARTA TIMUR, DKI JAKARTA",67,127,104,231
https://kawalpemilu.org#26119,"PONDOK KOPI, DUREN SAWIT, JAKARTA TIMUR, DKI JAKARTA",68,129,105,234
https://kawalpemilu.org#26119,"PONDOK KOPI, DUREN SAWIT, JAKARTA TIMUR, DKI JAKARTA",69,136,104,240
https://kawalpemilu.org#26119,"PONDOK KOPI, DUREN SAWIT, JAKARTA TIMUR, DKI JAKARTA",71,107,138,245
https://kawalpemilu.org#26119,"PONDOK KOPI, DUREN SAWIT, JAKARTA TIMUR, DKI JAKARTA",72,124,138,262
https://kawalpemilu.org#26119,"PONDOK KOPI, DUREN SAWIT, JAKARTA TIMUR, DKI JAKARTA",75,122,101,223
https://kawalpemilu.org#26119,"PONDOK KOPI, DUREN SAWIT, JAKARTA TIMUR, DKI JAKARTA",79,98,143,241
https://kawalpemilu.org#26119,"PONDOK KOPI, DUREN SAWIT, JAKARTA TIMUR, DKI JAKARTA",80,172,98,270
https://kawalpemilu.org#26119,"PONDOK KOPI, DUREN SAWIT, JAKARTA TIMUR, DKI JAKARTA",81,180,101,281
https://kawalpemilu.org#26119,"PONDOK KOPI, DUREN SAWIT, JAKARTA TIMUR, DKI JAKARTA",82,160,124,284
https://kawalpemilu.org#26119,"PONDOK KOPI, DUREN SAWIT, JAKARTA TIMUR, DKI JAKARTA",83,138,92,230
https://kawalpemilu.org#26119,"PONDOK KOPI, DUREN SAWIT, JAKARTA TIMUR, DKI JAKARTA",84,134,107,241
https://kawalpemilu.org#26119,"PONDOK KOPI, DUREN SAWIT, JAKARTA TIMUR, DKI JAKARTA",85,109,141,250
https://kawalpemilu.org#26119,"PONDOK KOPI, DUREN SAWIT, JAKARTA TIMUR, DKI JAKARTA",86,132,103,235
https://kawalpemilu.org#26119,"PONDOK KOPI, DUREN SAWIT, JAKARTA TIMUR, DKI JAKARTA",88,139,93,232
https://kawalpemilu.org#26119,"PONDOK KOPI, DUREN SAWIT, JAKARTA TIMUR, DKI JAKARTA",89,145,91,236
https://kawalpemilu.org#26119,"PONDOK KOPI, DUREN SAWIT, JAKARTA TIMUR, DKI JAKARTA",90,176,79,255
https://kawalpemilu.org#26119,"PONDOK KOPI, DUREN SAWIT, JAKARTA TIMUR, DKI JAKARTA",91,123,93,216
https://kawalpemilu.org#26119,"PONDOK KOPI, DUREN SAWIT, JAKARTA TIMUR, DKI JAKARTA",92,137,88,225
https://kawalpemilu.org#26119,"PONDOK KOPI, DUREN SAWIT, JAKARTA TIMUR, DKI JAKARTA",93,89,177,266
https://kawalpemilu.org#26119,"PONDOK KOPI, DUREN SAWIT, JAKARTA TIMUR, DKI JAKARTA",94,0,0,0
https://kawalpemilu.org#26119,"PONDOK KOPI, DUREN SAWIT, JAKARTA TIMUR, DKI JAKARTA",95,107,132,239
https://kawalpemilu.org#26119,"PONDOK KOPI, DUREN SAWIT, JAKARTA TIMUR, DKI JAKARTA",97,127,130,257
https://kawalpemilu.org#26119,"PONDOK KOPI, DUREN SAWIT, JAKARTA TIMUR, DKI JAKARTA",98,159,91,250
https://kawalpemilu.org#26119,"PONDOK KOPI, DUREN SAWIT, JAKARTA TIMUR, DKI JAKARTA",99,104,81,185
https://kawalpemilu.org#26119,"PONDOK KOPI, DUREN SAWIT, JAKARTA TIMUR, DKI JAKARTA",100,91,155,246
https://kawalpemilu.org#26119,"PONDOK KOPI, DUREN SAWIT, JAKARTA TIMUR, DKI JAKARTA",103,110,160,270
https://kawalpemilu.org#26119,"PONDOK KOPI, DUREN SAWIT, JAKARTA TIMUR, DKI JAKARTA",105,129,74,203
https://kawalpemilu.org#26119,"PONDOK KOPI, DUREN SAWIT, JAKARTA TIMUR, DKI JAKARTA",107,94,113,207
https://kawalpemilu.org#26119,"PONDOK KOPI, DUREN SAWIT, JAKARTA TIMUR, DKI JAKARTA",109,99,110,209
https://kawalpemilu.org#26121,"MAKASAR, MAKASAR, JAKARTA TIMUR, DKI JAKARTA",1,116,122,238
https://kawalpemilu.org#26121,"MAKASAR, MAKASAR, JAKARTA TIMUR, DKI JAKARTA",2,99,86,185
https://kawalpemilu.org#26121,"MAKASAR, MAKASAR, JAKARTA TIMUR, DKI JAKARTA",3,124,104,228
https://kawalpemilu.org#26121,"MAKASAR, MAKASAR, JAKARTA TIMUR, DKI JAKARTA",4,98,96,194
https://kawalpemilu.org#26121,"MAKASAR, MAKASAR, JAKARTA TIMUR, DKI JAKARTA",6,112,97,209
https://kawalpemilu.org#26121,"MAKASAR, MAKASAR, JAKARTA TIMUR, DKI JAKARTA",7,68,140,208
https://kawalpemilu.org#26121,"MAKASAR, MAKASAR, JAKARTA TIMUR, DKI JAKARTA",8,71,112,183
https://kawalpemilu.org#26121,"MAKASAR, MAKASAR, JAKARTA TIMUR, DKI JAKARTA",9,114,71,185
https://kawalpemilu.org#26121,"MAKASAR, MAKASAR, JAKARTA TIMUR, DKI JAKARTA",10,104,41,145
https://kawalpemilu.org#26121,"MAKASAR, MAKASAR, JAKARTA TIMUR, DKI JAKARTA",11,103,83,186
https://kawalpemilu.org#26121,"MAKASAR, MAKASAR, JAKARTA TIMUR, DKI JAKARTA",12,103,93,196
https://kawalpemilu.org#26121,"MAKASAR, MAKASAR, JAKARTA TIMUR, DKI JAKARTA",13,63,86,149
https://kawalpemilu.org#26121,"MAKASAR, MAKASAR, JAKARTA TIMUR, DKI JAKARTA",14,121,98,219
https://kawalpemilu.org#26121,"MAKASAR, MAKASAR, JAKARTA TIMUR, DKI JAKARTA",15,80,100,180
https://kawalpemilu.org#26121,"MAKASAR, MAKASAR, JAKARTA TIMUR, DKI JAKARTA",17,93,78,171
https://kawalpemilu.org#26121,"MAKASAR, MAKASAR, JAKARTA TIMUR, DKI JAKARTA",18,128,123,251
https://kawalpemilu.org#26121,"MAKASAR, MAKASAR, JAKARTA TIMUR, DKI JAKARTA",19,130,93,223
https://kawalpemilu.org#26121,"MAKASAR, MAKASAR, JAKARTA TIMUR, DKI JAKARTA",20,121,96,217
https://kawalpemilu.org#26121,"MAKASAR, MAKASAR, JAKARTA TIMUR, DKI JAKARTA",21,109,128,237
https://kawalpemilu.org#26121,"MAKASAR, MAKASAR, JAKARTA TIMUR, DKI JAKARTA",22,112,124,236
https://kawalpemilu.org#26121,"MAKASAR, MAKASAR, JAKARTA TIMUR, DKI JAKARTA",23,84,125,209
https://kawalpemilu.org#26121,"MAKASAR, MAKASAR, JAKARTA TIMUR, DKI JAKARTA",24,125,97,222
https://kawalpemilu.org#26121,"MAKASAR, MAKASAR, JAKARTA TIMUR, DKI JAKARTA",25,102,82,184
https://kawalpemilu.org#26121,"MAKASAR, MAKASAR, JAKARTA TIMUR, DKI JAKARTA",26,88,104,192
https://kawalpemilu.org#26121,"MAKASAR, MAKASAR, JAKARTA TIMUR, DKI JAKARTA",27,116,68,184
https://kawalpemilu.org#26121,"MAKASAR, MAKASAR, JAKARTA TIMUR, DKI JAKARTA",28,104,62,166
https://kawalpemilu.org#26121,"MAKASAR, MAKASAR, JAKARTA TIMUR, DKI JAKARTA",29,78,127,205
https://kawalpemilu.org#26121,"MAKASAR, MAKASAR, JAKARTA TIMUR, DKI JAKARTA",30,145,100,245
https://kawalpemilu.org#26121,"MAKASAR, MAKASAR, JAKARTA TIMUR, DKI JAKARTA",31,118,107,225
https://kawalpemilu.org#26121,"MAKASAR, MAKASAR, JAKARTA TIMUR, DKI JAKARTA",32,133,135,268
https://kawalpemilu.org#26121,"MAKASAR, MAKASAR, JAKARTA TIMUR, DKI JAKARTA",33,153,92,245
https://kawalpemilu.org#26121,"MAKASAR, MAKASAR, JAKARTA TIMUR, DKI JAKARTA",35,128,96,224
https://kawalpemilu.org#26121,"MAKASAR, MAKASAR, JAKARTA TIMUR, DKI JAKARTA",36,107,97,204
https://kawalpemilu.org#26121,"MAKASAR, MAKASAR, JAKARTA TIMUR, DKI JAKARTA",37,133,75,208
https://kawalpemilu.org#26121,"MAKASAR, MAKASAR, JAKARTA TIMUR, DKI JAKARTA",38,94,98,192
https://kawalpemilu.org#26121,"MAKASAR, MAKASAR, JAKARTA TIMUR, DKI JAKARTA",39,76,93,169
https://kawalpemilu.org#26121,"MAKASAR, MAKASAR, JAKARTA TIMUR, DKI JAKARTA",40,119,126,245
https://kawalpemilu.org#26121,"MAKASAR, MAKASAR, JAKARTA TIMUR, DKI JAKARTA",41,143,97,240
https://kawalpemilu.org#26121,"MAKASAR, MAKASAR, JAKARTA TIMUR, DKI JAKARTA",43,103,112,215
https://kawalpemilu.org#26121,"MAKASAR, MAKASAR, JAKARTA TIMUR, DKI JAKARTA",44,111,108,219
https://kawalpemilu.org#26121,"MAKASAR, MAKASAR, JAKARTA TIMUR, DKI JAKARTA",45,107,84,191
https://kawalpemilu.org#26121,"MAKASAR, MAKASAR, JAKARTA TIMUR, DKI JAKARTA",46,95,101,196
https://kawalpemilu.org#26121,"MAKASAR, MAKASAR, JAKARTA TIMUR, DKI JAKARTA",47,143,104,247
https://kawalpemilu.org#26121,"MAKASAR, MAKASAR, JAKARTA TIMUR, DKI JAKARTA",48,166,86,252
https://kawalpemilu.org#26121,"MAKASAR, MAKASAR, JAKARTA TIMUR, DKI JAKARTA",50,147,70,217
https://kawalpemilu.org#26121,"MAKASAR, MAKASAR, JAKARTA TIMUR, DKI JAKARTA",51,114,99,213
https://kawalpemilu.org#26121,"MAKASAR, MAKASAR, JAKARTA TIMUR, DKI JAKARTA",52,108,108,216
https://kawalpemilu.org#26121,"MAKASAR, MAKASAR, JAKARTA TIMUR, DKI JAKARTA",53,112,96,208
https://kawalpemilu.org#26121,"MAKASAR, MAKASAR, JAKARTA TIMUR, DKI JAKARTA",54,147,109,256
https://kawalpemilu.org#26121,"MAKASAR, MAKASAR, JAKARTA TIMUR, DKI JAKARTA",55,117,123,240
https://kawalpemilu.org#26121,"MAKASAR, MAKASAR, JAKARTA TIMUR, DKI JAKARTA",58,73,86,159
https://kawalpemilu.org#26121,"MAKASAR, MAKASAR, JAKARTA TIMUR, DKI JAKARTA",59,78,77,155
https://kawalpemilu.org#26121,"MAKASAR, MAKASAR, JAKARTA TIMUR, DKI JAKARTA",61,129,100,229
https://kawalpemilu.org#26121,"MAKASAR, MAKASAR, JAKARTA TIMUR, DKI JAKARTA",62,136,89,225
https://kawalpemilu.org#26121,"MAKASAR, MAKASAR, JAKARTA TIMUR, DKI JAKARTA",63,121,70,191
https://kawalpemilu.org#26121,"MAKASAR, MAKASAR, JAKARTA TIMUR, DKI JAKARTA",64,133,80,213
https://kawalpemilu.org#26121,"MAKASAR, MAKASAR, JAKARTA TIMUR, DKI JAKARTA",65,117,83,200
https://kawalpemilu.org#26121,"MAKASAR, MAKASAR, JAKARTA TIMUR, DKI JAKARTA",66,79,98,177
https://kawalpemilu.org#26121,"MAKASAR, MAKASAR, JAKARTA TIMUR, DKI JAKARTA",67,128,96,224
https://kawalpemilu.org#26121,"MAKASAR, MAKASAR, JAKARTA TIMUR, DKI JAKARTA",68,119,91,210
https://kawalpemilu.org#26121,"MAKASAR, MAKASAR, JAKARTA TIMUR, DKI JAKARTA",69,103,85,188
https://kawalpemilu.org#26121,"MAKASAR, MAKASAR, JAKARTA TIMUR, DKI JAKARTA",70,115,87,202
https://kawalpemilu.org#26121,"MAKASAR, MAKASAR, JAKARTA TIMUR, DKI JAKARTA",71,87,90,177
https://kawalpemilu.org#26121,"MAKASAR, MAKASAR, JAKARTA TIMUR, DKI JAKARTA",73,147,85,232
https://kawalpemilu.org#26121,"MAKASAR, MAKASAR, JAKARTA TIMUR, DKI JAKARTA",74,111,99,210
https://kawalpemilu.org#26121,"MAKASAR, MAKASAR, JAKARTA TIMUR, DKI JAKARTA",75,91,83,174
https://kawalpemilu.org#26121,"MAKASAR, MAKASAR, JAKARTA TIMUR, DKI JAKARTA",76,91,110,201
https://kawalpemilu.org#26121,"MAKASAR, MAKASAR, JAKARTA TIMUR, DKI JAKARTA",78,122,109,231
https://kawalpemilu.org#26121,"MAKASAR, MAKASAR, JAKARTA TIMUR, DKI JAKARTA",79,81,96,177
https://kawalpemilu.org#26121,"MAKASAR, MAKASAR, JAKARTA TIMUR, DKI JAKARTA",80,121,80,201
https://kawalpemilu.org#26121,"MAKASAR, MAKASAR, JAKARTA TIMUR, DKI JAKARTA",81,108,128,236
https://kawalpemilu.org#26121,"MAKASAR, MAKASAR, JAKARTA TIMUR, DKI JAKARTA",82,0,0,196
https://kawalpemilu.org#26121,"MAKASAR, MAKASAR, JAKARTA TIMUR, DKI JAKARTA",83,116,118,234
https://kawalpemilu.org#26121,"MAKASAR, MAKASAR, JAKARTA TIMUR, DKI JAKARTA",84,113,119,232
https://kawalpemilu.org#26121,"MAKASAR, MAKASAR, JAKARTA TIMUR, DKI JAKARTA",85,99,115,214
https://kawalpemilu.org#26121,"MAKASAR, MAKASAR, JAKARTA TIMUR, DKI JAKARTA",86,100,100,200
https://kawalpemilu.org#26121,"MAKASAR, MAKASAR, JAKARTA TIMUR, DKI JAKARTA",88,100,106,206
https://kawalpemilu.org#26121,"MAKASAR, MAKASAR, JAKARTA TIMUR, DKI JAKARTA",91,98,125,223
https://kawalpemilu.org#26121,"MAKASAR, MAKASAR, JAKARTA TIMUR, DKI JAKARTA",92,90,114,204
https://kawalpemilu.org#26121,"MAKASAR, MAKASAR, JAKARTA TIMUR, DKI JAKARTA",93,71,114,185
https://kawalpemilu.org#26121,"MAKASAR, MAKASAR, JAKARTA TIMUR, DKI JAKARTA",94,78,133,211
https://kawalpemilu.org#26121,"MAKASAR, MAKASAR, JAKARTA TIMUR, DKI JAKARTA",95,85,108,193
https://kawalpemilu.org#26121,"MAKASAR, MAKASAR, JAKARTA TIMUR, DKI JAKARTA",97,96,99,195
https://kawalpemilu.org#26121,"MAKASAR, MAKASAR, JAKARTA TIMUR, DKI JAKARTA",98,109,94,203
https://kawalpemilu.org#26121,"MAKASAR, MAKASAR, JAKARTA TIMUR, DKI JAKARTA",99,119,98,217
https://kawalpemilu.org#26121,"MAKASAR, MAKASAR, JAKARTA TIMUR, DKI JAKARTA",100,74,85,159
https://kawalpemilu.org#26121,"MAKASAR, MAKASAR, JAKARTA TIMUR, DKI JAKARTA",101,97,87,184
https://kawalpemilu.org#26121,"MAKASAR, MAKASAR, JAKARTA TIMUR, DKI JAKARTA",102,135,69,204
https://kawalpemilu.org#26121,"MAKASAR, MAKASAR, JAKARTA TIMUR, DKI JAKARTA",103,61,81,142
https://kawalpemilu.org#26121,"MAKASAR, MAKASAR, JAKARTA TIMUR, DKI JAKARTA",104,126,106,232
https://kawalpemilu.org#26121,"MAKASAR, MAKASAR, JAKARTA TIMUR, DKI JAKARTA",105,119,99,218
https://kawalpemilu.org#26121,"MAKASAR, MAKASAR, JAKARTA TIMUR, DKI JAKARTA",106,117,122,239
https://kawalpemilu.org#26121,"MAKASAR, MAKASAR, JAKARTA TIMUR, DKI JAKARTA",107,75,75,150
https://kawalpemilu.org#26121,"MAKASAR, MAKASAR, JAKARTA TIMUR, DKI JAKARTA",109,81,131,212
https://kawalpemilu.org#26121,"MAKASAR, MAKASAR, JAKARTA TIMUR, DKI JAKARTA",110,78,130,208
https://kawalpemilu.org#26121,"MAKASAR, MAKASAR, JAKARTA TIMUR, DKI JAKARTA",111,109,88,197
https://kawalpemilu.org#26121,"MAKASAR, MAKASAR, JAKARTA TIMUR, DKI JAKARTA",112,119,90,209
https://kawalpemilu.org#26121,"MAKASAR, MAKASAR, JAKARTA TIMUR, DKI JAKARTA",113,79,114,193
https://kawalpemilu.org#26121,"MAKASAR, MAKASAR, JAKARTA TIMUR, DKI JAKARTA",114,96,79,175
https://kawalpemilu.org#26121,"MAKASAR, MAKASAR, JAKARTA TIMUR, DKI JAKARTA",115,104,95,199
https://kawalpemilu.org#26121,"MAKASAR, MAKASAR, JAKARTA TIMUR, DKI JAKARTA",116,116,104,220
https://kawalpemilu.org#26121,"MAKASAR, MAKASAR, JAKARTA TIMUR, DKI JAKARTA",117,130,103,233
https://kawalpemilu.org#26121,"MAKASAR, MAKASAR, JAKARTA TIMUR, DKI JAKARTA",120,103,100,203
https://kawalpemilu.org#26121,"MAKASAR, MAKASAR, JAKARTA TIMUR, DKI JAKARTA",121,97,94,191
https://kawalpemilu.org#26121,"MAKASAR, MAKASAR, JAKARTA TIMUR, DKI JAKARTA",122,0,0,0
https://kawalpemilu.org#26122,"PINANGRANTI, MAKASAR, JAKARTA TIMUR, DKI JAKARTA",1,116,135,251
https://kawalpemilu.org#26122,"PINANGRANTI, MAKASAR, JAKARTA TIMUR, DKI JAKARTA",2,70,127,197
https://kawalpemilu.org#26122,"PINANGRANTI, MAKASAR, JAKARTA TIMUR, DKI JAKARTA",3,95,124,219
https://kawalpemilu.org#26122,"PINANGRANTI, MAKASAR, JAKARTA TIMUR, DKI JAKARTA",5,113,148,261
https://kawalpemilu.org#26122,"PINANGRANTI, MAKASAR, JAKARTA TIMUR, DKI JAKARTA",6,95,149,244
https://kawalpemilu.org#26122,"PINANGRANTI, MAKASAR, JAKARTA TIMUR, DKI JAKARTA",7,83,154,237
https://kawalpemilu.org#26122,"PINANGRANTI, MAKASAR, JAKARTA TIMUR, DKI JAKARTA",8,104,137,241
https://kawalpemilu.org#26122,"PINANGRANTI, MAKASAR, JAKARTA TIMUR, DKI JAKARTA",9,82,94,176
https://kawalpemilu.org#26122,"PINANGRANTI, MAKASAR, JAKARTA TIMUR, DKI JAKARTA",10,107,105,212
https://kawalpemilu.org#26122,"PINANGRANTI, MAKASAR, JAKARTA TIMUR, DKI JAKARTA",11,86,155,241
https://kawalpemilu.org#26122,"PINANGRANTI, MAKASAR, JAKARTA TIMUR, DKI JAKARTA",13,103,108,211
https://kawalpemilu.org#26122,"PINANGRANTI, MAKASAR, JAKARTA TIMUR, DKI JAKARTA",14,77,123,200
https://kawalpemilu.org#26122,"PINANGRANTI, MAKASAR, JAKARTA TIMUR, DKI JAKARTA",17,101,114,215
https://kawalpemilu.org#26122,"PINANGRANTI, MAKASAR, JAKARTA TIMUR, DKI JAKARTA",18,98,120,218
https://kawalpemilu.org#26122,"PINANGRANTI, MAKASAR, JAKARTA TIMUR, DKI JAKARTA",19,75,102,177
https://kawalpemilu.org#26122,"PINANGRANTI, MAKASAR, JAKARTA TIMUR, DKI JAKARTA",20,95,101,196
https://kawalpemilu.org#26122,"PINANGRANTI, MAKASAR, JAKARTA TIMUR, DKI JAKARTA",21,88,114,202
https://kawalpemilu.org#26122,"PINANGRANTI, MAKASAR, JAKARTA TIMUR, DKI JAKARTA",22,58,76,134
https://kawalpemilu.org#26122,"PINANGRANTI, MAKASAR, JAKARTA TIMUR, DKI JAKARTA",24,96,152,248
https://kawalpemilu.org#26122,"PINANGRANTI, MAKASAR, JAKARTA TIMUR, DKI JAKARTA",25,96,150,246
https://kawalpemilu.org#26122,"PINANGRANTI, MAKASAR, JAKARTA TIMUR, DKI JAKARTA",26,65,149,214
https://kawalpemilu.org#26122,"PINANGRANTI, MAKASAR, JAKARTA TIMUR, DKI JAKARTA",27,77,156,233
https://kawalpemilu.org#26122,"PINANGRANTI, MAKASAR, JAKARTA TIMUR, DKI JAKARTA",30,93,123,216
https://kawalpemilu.org#26122,"PINANGRANTI, MAKASAR, JAKARTA TIMUR, DKI JAKARTA",31,120,103,223
https://kawalpemilu.org#26122,"PINANGRANTI, MAKASAR, JAKARTA TIMUR, DKI JAKARTA",32,96,81,177
https://kawalpemilu.org#26122,"PINANGRANTI, MAKASAR, JAKARTA TIMUR, DKI JAKARTA",33,94,110,204
https://kawalpemilu.org#26122,"PINANGRANTI, MAKASAR, JAKARTA TIMUR, DKI JAKARTA",34,77,127,204
https://kawalpemilu.org#26122,"PINANGRANTI, MAKASAR, JAKARTA TIMUR, DKI JAKARTA",35,90,89,179
https://kawalpemilu.org#26122,"PINANGRANTI, MAKASAR, JAKARTA TIMUR, DKI JAKARTA",36,77,165,242
https://kawalpemilu.org#26122,"PINANGRANTI, MAKASAR, JAKARTA TIMUR, DKI JAKARTA",37,136,110,246
https://kawalpemilu.org#26122,"PINANGRANTI, MAKASAR, JAKARTA TIMUR, DKI JAKARTA",38,119,127,246
https://kawalpemilu.org#26122,"PINANGRANTI, MAKASAR, JAKARTA TIMUR, DKI JAKARTA",39,67,165,232
https://kawalpemilu.org#26122,"PINANGRANTI, MAKASAR, JAKARTA TIMUR, DKI JAKARTA",40,104,148,252
https://kawalpemilu.org#26122,"PINANGRANTI, MAKASAR, JAKARTA TIMUR, DKI JAKARTA",41,83,113,196
https://kawalpemilu.org#26122,"PINANGRANTI, MAKASAR, JAKARTA TIMUR, DKI JAKARTA",43,124,116,240
https://kawalpemilu.org#26122,"PINANGRANTI, MAKASAR, JAKARTA TIMUR, DKI JAKARTA",44,107,126,233
https://kawalpemilu.org#26122,"PINANGRANTI, MAKASAR, JAKARTA TIMUR, DKI JAKARTA",45,83,106,189
https://kawalpemilu.org#26122,"PINANGRANTI, MAKASAR, JAKARTA TIMUR, DKI JAKARTA",46,72,177,249
https://kawalpemilu.org#26122,"PINANGRANTI, MAKASAR, JAKARTA TIMUR, DKI JAKARTA",48,147,77,224
https://kawalpemilu.org#26122,"PINANGRANTI, MAKASAR, JAKARTA TIMUR, DKI JAKARTA",49,110,101,211
https://kawalpemilu.org#26122,"PINANGRANTI, MAKASAR, JAKARTA TIMUR, DKI JAKARTA",50,78,99,177
https://kawalpemilu.org#26122,"PINANGRANTI, MAKASAR, JAKARTA TIMUR, DKI JAKARTA",51,163,81,244
https://kawalpemilu.org#26122,"PINANGRANTI, MAKASAR, JAKARTA TIMUR, DKI JAKARTA",53,180,84,264
https://kawalpemilu.org#26122,"PINANGRANTI, MAKASAR, JAKARTA TIMUR, DKI JAKARTA",55,220,22,242
https://kawalpemilu.org#26122,"PINANGRANTI, MAKASAR, JAKARTA TIMUR, DKI JAKARTA",56,258,20,278
https://kawalpemilu.org#26122,"PINANGRANTI, MAKASAR, JAKARTA TIMUR, DKI JAKARTA",58,142,18,160
https://kawalpemilu.org#26122,"PINANGRANTI, MAKASAR, JAKARTA TIMUR, DKI JAKARTA",59,118,132,250
https://kawalpemilu.org#26122,"PINANGRANTI, MAKASAR, JAKARTA TIMUR, DKI JAKARTA",60,99,83,182
https://kawalpemilu.org#26122,"PINANGRANTI, MAKASAR, JAKARTA TIMUR, DKI JAKARTA",61,146,81,227
https://kawalpemilu.org#26122,"PINANGRANTI, MAKASAR, JAKARTA TIMUR, DKI JAKARTA",62,171,80,251
https://kawalpemilu.org#26122,"PINANGRANTI, MAKASAR, JAKARTA TIMUR, DKI JAKARTA",63,145,58,203
https://kawalpemilu.org#26122,"PINANGRANTI, MAKASAR, JAKARTA TIMUR, DKI JAKARTA",65,78,86,164
https://kawalpemilu.org#26122,"PINANGRANTI, MAKASAR, JAKARTA TIMUR, DKI JAKARTA",68,65,137,202
https://kawalpemilu.org#26122,"PINANGRANTI, MAKASAR, JAKARTA TIMUR, DKI JAKARTA",69,68,118,186
https://kawalpemilu.org#26122,"PINANGRANTI, MAKASAR, JAKARTA TIMUR, DKI JAKARTA",70,127,138,265
https://kawalpemilu.org#26122,"PINANGRANTI, MAKASAR, JAKARTA TIMUR, DKI JAKARTA",71,173,71,244
https://kawalpemilu.org#26122,"PINANGRANTI, MAKASAR, JAKARTA TIMUR, DKI JAKARTA",73,65,111,176
https://kawalpemilu.org#26122,"PINANGRANTI, MAKASAR, JAKARTA TIMUR, DKI JAKARTA",74,89,122,211
https://kawalpemilu.org#26122,"PINANGRANTI, MAKASAR, JAKARTA TIMUR, DKI JAKARTA",75,115,109,224
https://kawalpemilu.org#26122,"PINANGRANTI, MAKASAR, JAKARTA TIMUR, DKI JAKARTA",76,109,81,190
https://kawalpemilu.org#26122,"PINANGRANTI, MAKASAR, JAKARTA TIMUR, DKI JAKARTA",77,113,67,180
https://kawalpemilu.org#26122,"PINANGRANTI, MAKASAR, JAKARTA TIMUR, DKI JAKARTA",78,79,98,177
https://kawalpemilu.org#26122,"PINANGRANTI, MAKASAR, JAKARTA TIMUR, DKI JAKARTA",79,99,121,220
https://kawalpemilu.org#26122,"PINANGRANTI, MAKASAR, JAKARTA TIMUR, DKI JAKARTA",81,128,79,207
https://kawalpemilu.org#26122,"PINANGRANTI, MAKASAR, JAKARTA TIMUR, DKI JAKARTA",82,94,132,226
https://kawalpemilu.org#26122,"PINANGRANTI, MAKASAR, JAKARTA TIMUR, DKI JAKARTA",83,73,91,164
https://kawalpemilu.org#26122,"PINANGRANTI, MAKASAR, JAKARTA TIMUR, DKI JAKARTA",85,42,121,163
https://kawalpemilu.org#26122,"PINANGRANTI, MAKASAR, JAKARTA TIMUR, DKI JAKARTA",87,88,136,224
https://kawalpemilu.org#26122,"PINANGRANTI, MAKASAR, JAKARTA TIMUR, DKI JAKARTA",88,86,126,212
https://kawalpemilu.org#26123,"KEBON PALA, MAKASAR, JAKARTA TIMUR, DKI JAKARTA",2,108,80,188
https://kawalpemilu.org#26123,"KEBON PALA, MAKASAR, JAKARTA TIMUR, DKI JAKARTA",6,120,92,212
https://kawalpemilu.org#26123,"KEBON PALA, MAKASAR, JAKARTA TIMUR, DKI JAKARTA",7,89,129,218
https://kawalpemilu.org#26123,"KEBON PALA, MAKASAR, JAKARTA TIMUR, DKI JAKARTA",8,84,134,218
https://kawalpemilu.org#26123,"KEBON PALA, MAKASAR, JAKARTA TIMUR, DKI JAKARTA",9,109,99,208
https://kawalpemilu.org#26123,"KEBON PALA, MAKASAR, JAKARTA TIMUR, DKI JAKARTA",10,99,132,231
https://kawalpemilu.org#26123,"KEBON PALA, MAKASAR, JAKARTA TIMUR, DKI JAKARTA",11,93,114,207
https://kawalpemilu.org#26123,"KEBON PALA, MAKASAR, JAKARTA TIMUR, DKI JAKARTA",14,121,122,243
https://kawalpemilu.org#26123,"KEBON PALA, MAKASAR, JAKARTA TIMUR, DKI JAKARTA",16,98,82,180
https://kawalpemilu.org#26123,"KEBON PALA, MAKASAR, JAKARTA TIMUR, DKI JAKARTA",17,102,82,184
https://kawalpemilu.org#26123,"KEBON PALA, MAKASAR, JAKARTA TIMUR, DKI JAKARTA",19,100,98,198
https://kawalpemilu.org#26123,"KEBON PALA, MAKASAR, JAKARTA TIMUR, DKI JAKARTA",20,81,86,167
https://kawalpemilu.org#26123,"KEBON PALA, MAKASAR, JAKARTA TIMUR, DKI JAKARTA",21,100,120,220
https://kawalpemilu.org#26123,"KEBON PALA, MAKASAR, JAKARTA TIMUR, DKI JAKARTA",22,99,131,230
https://kawalpemilu.org#26123,"KEBON PALA, MAKASAR, JAKARTA TIMUR, DKI JAKARTA",23,92,112,204
https://kawalpemilu.org#26123,"KEBON PALA, MAKASAR, JAKARTA TIMUR, DKI JAKARTA",24,105,122,227
https://kawalpemilu.org#26123,"KEBON PALA, MAKASAR, JAKARTA TIMUR, DKI JAKARTA",25,100,102,202
https://kawalpemilu.org#26123,"KEBON PALA, MAKASAR, JAKARTA TIMUR, DKI JAKARTA",26,103,134,237
https://kawalpemilu.org#26123,"KEBON PALA, MAKASAR, JAKARTA TIMUR, DKI JAKARTA",27,94,109,203
https://kawalpemilu.org#26123,"KEBON PALA, MAKASAR, JAKARTA TIMUR, DKI JAKARTA",28,159,70,229
https://kawalpemilu.org#26123,"KEBON PALA, MAKASAR, JAKARTA TIMUR, DKI JAKARTA",29,118,105,223
https://kawalpemilu.org#26123,"KEBON PALA, MAKASAR, JAKARTA TIMUR, DKI JAKARTA",30,132,93,225
https://kawalpemilu.org#26123,"KEBON PALA, MAKASAR, JAKARTA TIMUR, DKI JAKARTA",31,92,115,207
https://kawalpemilu.org#26123,"KEBON PALA, MAKASAR, JAKARTA TIMUR, DKI JAKARTA",32,137,93,230
https://kawalpemilu.org#26123,"KEBON PALA, MAKASAR, JAKARTA TIMUR, DKI JAKARTA",33,76,109,185
https://kawalpemilu.org#26123,"KEBON PALA, MAKASAR, JAKARTA TIMUR, DKI JAKARTA",36,133,139,272
https://kawalpemilu.org#26123,"KEBON PALA, MAKASAR, JAKARTA TIMUR, DKI JAKARTA",37,109,104,213
https://kawalpemilu.org#26123,"KEBON PALA, MAKASAR, JAKARTA TIMUR, DKI JAKARTA",40,127,128,255
https://kawalpemilu.org#26123,"KEBON PALA, MAKASAR, JAKARTA TIMUR, DKI JAKARTA",41,109,122,231
https://kawalpemilu.org#26123,"KEBON PALA, MAKASAR, JAKARTA TIMUR, DKI JAKARTA",42,85,146,231
https://kawalpemilu.org#26123,"KEBON PALA, MAKASAR, JAKARTA TIMUR, DKI JAKARTA",43,98,134,232
https://kawalpemilu.org#26123,"KEBON PALA, MAKASAR, JAKARTA TIMUR, DKI JAKARTA",45,94,140,234
https://kawalpemilu.org#26123,"KEBON PALA, MAKASAR, JAKARTA TIMUR, DKI JAKARTA",46,106,113,219
https://kawalpemilu.org#26123,"KEBON PALA, MAKASAR, JAKARTA TIMUR, DKI JAKARTA",47,82,171,253
https://kawalpemilu.org#26123,"KEBON PALA, MAKASAR, JAKARTA TIMUR, DKI JAKARTA",48,110,137,247
https://kawalpemilu.org#26123,"KEBON PALA, MAKASAR, JAKARTA TIMUR, DKI JAKARTA",49,99,145,244
https://kawalpemilu.org#26123,"KEBON PALA, MAKASAR, JAKARTA TIMUR, DKI JAKARTA",51,156,93,249
https://kawalpemilu.org#26123,"KEBON PALA, MAKASAR, JAKARTA TIMUR, DKI JAKARTA",52,98,148,246
https://kawalpemilu.org#26123,"KEBON PALA, MAKASAR, JAKARTA TIMUR, DKI JAKARTA",53,108,101,209
https://kawalpemilu.org#26123,"KEBON PALA, MAKASAR, JAKARTA TIMUR, DKI JAKARTA",54,108,127,235
https://kawalpemilu.org#26123,"KEBON PALA, MAKASAR, JAKARTA TIMUR, DKI JAKARTA",55,87,153,240
https://kawalpemilu.org#26123,"KEBON PALA, MAKASAR, JAKARTA TIMUR, DKI JAKARTA",57,70,115,185
https://kawalpemilu.org#26123,"KEBON PALA, MAKASAR, JAKARTA TIMUR, DKI JAKARTA",58,88,131,219
https://kawalpemilu.org#26123,"KEBON PALA, MAKASAR, JAKARTA TIMUR, DKI JAKARTA",60,114,60,174
https://kawalpemilu.org#26123,"KEBON PALA, MAKASAR, JAKARTA TIMUR, DKI JAKARTA",61,121,54,175
https://kawalpemilu.org#26123,"KEBON PALA, MAKASAR, JAKARTA TIMUR, DKI JAKARTA",63,116,86,202
https://kawalpemilu.org#26123,"KEBON PALA, MAKASAR, JAKARTA TIMUR, DKI JAKARTA",65,202,51,253
https://kawalpemilu.org#26123,"KEBON PALA, MAKASAR, JAKARTA TIMUR, DKI JAKARTA",67,193,8,201
https://kawalpemilu.org#26123,"KEBON PALA, MAKASAR, JAKARTA TIMUR, DKI JAKARTA",68,135,33,168
https://kawalpemilu.org#26123,"KEBON PALA, MAKASAR, JAKARTA TIMUR, DKI JAKARTA",69,115,25,140
https://kawalpemilu.org#26123,"KEBON PALA, MAKASAR, JAKARTA TIMUR, DKI JAKARTA",70,156,31,187
https://kawalpemilu.org#26123,"KEBON PALA, MAKASAR, JAKARTA TIMUR, DKI JAKARTA",73,112,91,203
https://kawalpemilu.org#26123,"KEBON PALA, MAKASAR, JAKARTA TIMUR, DKI JAKARTA",77,113,82,195
https://kawalpemilu.org#26123,"KEBON PALA, MAKASAR, JAKARTA TIMUR, DKI JAKARTA",78,90,100,190
https://kawalpemilu.org#26123,"KEBON PALA, MAKASAR, JAKARTA TIMUR, DKI JAKARTA",79,132,94,226
https://kawalpemilu.org#26123,"KEBON PALA, MAKASAR, JAKARTA TIMUR, DKI JAKARTA",80,112,110,222
https://kawalpemilu.org#26123,"KEBON PALA, MAKASAR, JAKARTA TIMUR, DKI JAKARTA",81,102,108,210
https://kawalpemilu.org#26123,"KEBON PALA, MAKASAR, JAKARTA TIMUR, DKI JAKARTA",82,110,140,250
https://kawalpemilu.org#26123,"KEBON PALA, MAKASAR, JAKARTA TIMUR, DKI JAKARTA",83,82,153,235
https://kawalpemilu.org#26123,"KEBON PALA, MAKASAR, JAKARTA TIMUR, DKI JAKARTA",84,116,65,181
https://kawalpemilu.org#26123,"KEBON PALA, MAKASAR, JAKARTA TIMUR, DKI JAKARTA",87,95,80,175
https://kawalpemilu.org#26123,"KEBON PALA, MAKASAR, JAKARTA TIMUR, DKI JAKARTA",88,126,64,190
https://kawalpemilu.org#26123,"KEBON PALA, MAKASAR, JAKARTA TIMUR, DKI JAKARTA",89,124,73,197
https://kawalpemilu.org#26123,"KEBON PALA, MAKASAR, JAKARTA TIMUR, DKI JAKARTA",92,147,46,193
https://kawalpemilu.org#26123,"KEBON PALA, MAKASAR, JAKARTA TIMUR, DKI JAKARTA",93,154,42,196
https://kawalpemilu.org#26123,"KEBON PALA, MAKASAR, JAKARTA TIMUR, DKI JAKARTA",94,106,61,167
https://kawalpemilu.org#26123,"KEBON PALA, MAKASAR, JAKARTA TIMUR, DKI JAKARTA",95,132,40,172
https://kawalpemilu.org#26123,"KEBON PALA, MAKASAR, JAKARTA TIMUR, DKI JAKARTA",96,123,68,191
https://kawalpemilu.org#26123,"KEBON PALA, MAKASAR, JAKARTA TIMUR, DKI JAKARTA",97,162,39,201
https://kawalpemilu.org#26123,"KEBON PALA, MAKASAR, JAKARTA TIMUR, DKI JAKARTA",98,154,50,204
https://kawalpemilu.org#26123,"KEBON PALA, MAKASAR, JAKARTA TIMUR, DKI JAKARTA",102,164,52,216
https://kawalpemilu.org#26123,"KEBON PALA, MAKASAR, JAKARTA TIMUR, DKI JAKARTA",105,134,76,210
https://kawalpemilu.org#26123,"KEBON PALA, MAKASAR, JAKARTA TIMUR, DKI JAKARTA",106,96,127,223
https://kawalpemilu.org#26123,"KEBON PALA, MAKASAR, JAKARTA TIMUR, DKI JAKARTA",107,80,97,177
https://kawalpemilu.org#26123,"KEBON PALA, MAKASAR, JAKARTA TIMUR, DKI JAKARTA",108,97,70,167
https://kawalpemilu.org#26123,"KEBON PALA, MAKASAR, JAKARTA TIMUR, DKI JAKARTA",109,83,101,184
https://kawalpemilu.org#26123,"KEBON PALA, MAKASAR, JAKARTA TIMUR, DKI JAKARTA",110,103,79,182
https://kawalpemilu.org#26123,"KEBON PALA, MAKASAR, JAKARTA TIMUR, DKI JAKARTA",111,74,110,184
https://kawalpemilu.org#26123,"KEBON PALA, MAKASAR, JAKARTA TIMUR, DKI JAKARTA",113,126,112,238
https://kawalpemilu.org#26123,"KEBON PALA, MAKASAR, JAKARTA TIMUR, DKI JAKARTA",114,86,79,165
https://kawalpemilu.org#26123,"KEBON PALA, MAKASAR, JAKARTA TIMUR, DKI JAKARTA",115,104,108,212
https://kawalpemilu.org#26123,"KEBON PALA, MAKASAR, JAKARTA TIMUR, DKI JAKARTA",117,127,105,232
https://kawalpemilu.org#26123,"KEBON PALA, MAKASAR, JAKARTA TIMUR, DKI JAKARTA",118,101,103,204
https://kawalpemilu.org#26123,"KEBON PALA, MAKASAR, JAKARTA TIMUR, DKI JAKARTA",121,80,141,221
https://kawalpemilu.org#26123,"KEBON PALA, MAKASAR, JAKARTA TIMUR, DKI JAKARTA",122,103,114,217
https://kawalpemilu.org#26123,"KEBON PALA, MAKASAR, JAKARTA TIMUR, DKI JAKARTA",123,91,150,241
https://kawalpemilu.org#26123,"KEBON PALA, MAKASAR, JAKARTA TIMUR, DKI JAKARTA",124,125,109,234
https://kawalpemilu.org#26123,"KEBON PALA, MAKASAR, JAKARTA TIMUR, DKI JAKARTA",126,161,98,259
https://kawalpemilu.org#26123,"KEBON PALA, MAKASAR, JAKARTA TIMUR, DKI JAKARTA",128,92,157,249
https://kawalpemilu.org#26123,"KEBON PALA, MAKASAR, JAKARTA TIMUR, DKI JAKARTA",130,97,108,205
https://kawalpemilu.org#26123,"KEBON PALA, MAKASAR, JAKARTA TIMUR, DKI JAKARTA",131,70,126,196
https://kawalpemilu.org#26123,"KEBON PALA, MAKASAR, JAKARTA TIMUR, DKI JAKARTA",133,121,87,208
https://kawalpemilu.org#26123,"KEBON PALA, MAKASAR, JAKARTA TIMUR, DKI JAKARTA",134,108,87,196
https://kawalpemilu.org#26123,"KEBON PALA, MAKASAR, JAKARTA TIMUR, DKI JAKARTA",135,89,63,152
https://kawalpemilu.org#26123,"KEBON PALA, MAKASAR, JAKARTA TIMUR, DKI JAKARTA",138,82,128,210
https://kawalpemilu.org#26123,"KEBON PALA, MAKASAR, JAKARTA TIMUR, DKI JAKARTA",139,95,108,203
https://kawalpemilu.org#26123,"KEBON PALA, MAKASAR, JAKARTA TIMUR, DKI JAKARTA",140,86,78,164
https://kawalpemilu.org#26123,"KEBON PALA, MAKASAR, JAKARTA TIMUR, DKI JAKARTA",142,96,74,170
https://kawalpemilu.org#26123,"KEBON PALA, MAKASAR, JAKARTA TIMUR, DKI JAKARTA",143,147,102,249
https://kawalpemilu.org#26123,"KEBON PALA, MAKASAR, JAKARTA TIMUR, DKI JAKARTA",144,110,119,229
https://kawalpemilu.org#26123,"KEBON PALA, MAKASAR, JAKARTA TIMUR, DKI JAKARTA",145,161,108,269
https://kawalpemilu.org#26123,"KEBON PALA, MAKASAR, JAKARTA TIMUR, DKI JAKARTA",147,79,97,176
https://kawalpemilu.org#26123,"KEBON PALA, MAKASAR, JAKARTA TIMUR, DKI JAKARTA",149,91,115,206
https://kawalpemilu.org#26123,"KEBON PALA, MAKASAR, JAKARTA TIMUR, DKI JAKARTA",150,71,140,211
https://kawalpemilu.org#26123,"KEBON PALA, MAKASAR, JAKARTA TIMUR, DKI JAKARTA",151,108,75,183
https://kawalpemilu.org#26123,"KEBON PALA, MAKASAR, JAKARTA TIMUR, DKI JAKARTA",152,126,96,222
https://kawalpemilu.org#26123,"KEBON PALA, MAKASAR, JAKARTA TIMUR, DKI JAKARTA",155,60,120,180
https://kawalpemilu.org#26123,"KEBON PALA, MAKASAR, JAKARTA TIMUR, DKI JAKARTA",156,84,142,226
https://kawalpemilu.org#26123,"KEBON PALA, MAKASAR, JAKARTA TIMUR, DKI JAKARTA",158,62,115,177
https://kawalpemilu.org#26123,"KEBON PALA, MAKASAR, JAKARTA TIMUR, DKI JAKARTA",159,101,105,206
https://kawalpemilu.org#26123,"KEBON PALA, MAKASAR, JAKARTA TIMUR, DKI JAKARTA",160,108,104,212
https://kawalpemilu.org#26123,"KEBON PALA, MAKASAR, JAKARTA TIMUR, DKI JAKARTA",162,79,83,162
https://kawalpemilu.org#26123,"KEBON PALA, MAKASAR, JAKARTA TIMUR, DKI JAKARTA",164,127,77,204
https://kawalpemilu.org#26124,"HALIM PERDANA KUSUMA, MAKASAR, JAKARTA TIMUR, DKI JAKARTA",1,126,129,255
https://kawalpemilu.org#26124,"HALIM PERDANA KUSUMA, MAKASAR, JAKARTA TIMUR, DKI JAKARTA",3,92,161,253
https://kawalpemilu.org#26124,"HALIM PERDANA KUSUMA, MAKASAR, JAKARTA TIMUR, DKI JAKARTA",4,48,116,164
https://kawalpemilu.org#26124,"HALIM PERDANA KUSUMA, MAKASAR, JAKARTA TIMUR, DKI JAKARTA",5,49,101,150
https://kawalpemilu.org#26124,"HALIM PERDANA KUSUMA, MAKASAR, JAKARTA TIMUR, DKI JAKARTA",6,49,148,197
https://kawalpemilu.org#26124,"HALIM PERDANA KUSUMA, MAKASAR, JAKARTA TIMUR, DKI JAKARTA",7,68,169,237
https://kawalpemilu.org#26124,"HALIM PERDANA KUSUMA, MAKASAR, JAKARTA TIMUR, DKI JAKARTA",8,47,152,199
https://kawalpemilu.org#26124,"HALIM PERDANA KUSUMA, MAKASAR, JAKARTA TIMUR, DKI JAKARTA",9,83,158,241
https://kawalpemilu.org#26124,"HALIM PERDANA KUSUMA, MAKASAR, JAKARTA TIMUR, DKI JAKARTA",10,72,72,144
https://kawalpemilu.org#26124,"HALIM PERDANA KUSUMA, MAKASAR, JAKARTA TIMUR, DKI JAKARTA",11,76,169,245
https://kawalpemilu.org#26124,"HALIM PERDANA KUSUMA, MAKASAR, JAKARTA TIMUR, DKI JAKARTA",12,83,152,235
https://kawalpemilu.org#26124,"HALIM PERDANA KUSUMA, MAKASAR, JAKARTA TIMUR, DKI JAKARTA",13,54,155,209
https://kawalpemilu.org#26124,"HALIM PERDANA KUSUMA, MAKASAR, JAKARTA TIMUR, DKI JAKARTA",14,94,146,240
https://kawalpemilu.org#26124,"HALIM PERDANA KUSUMA, MAKASAR, JAKARTA TIMUR, DKI JAKARTA",15,94,179,273
https://kawalpemilu.org#26124,"HALIM PERDANA KUSUMA, MAKASAR, JAKARTA TIMUR, DKI JAKARTA",16,58,185,243
https://kawalpemilu.org#26124,"HALIM PERDANA KUSUMA, MAKASAR, JAKARTA TIMUR, DKI JAKARTA",17,94,141,235
https://kawalpemilu.org#26124,"HALIM PERDANA KUSUMA, MAKASAR, JAKARTA TIMUR, DKI JAKARTA",18,132,114,246
https://kawalpemilu.org#26124,"HALIM PERDANA KUSUMA, MAKASAR, JAKARTA TIMUR, DKI JAKARTA",20,94,137,231
https://kawalpemilu.org#26124,"HALIM PERDANA KUSUMA, MAKASAR, JAKARTA TIMUR, DKI JAKARTA",21,157,89,246
https://kawalpemilu.org#26124,"HALIM PERDANA KUSUMA, MAKASAR, JAKARTA TIMUR, DKI JAKARTA",22,134,78,212
https://kawalpemilu.org#26124,"HALIM PERDANA KUSUMA, MAKASAR, JAKARTA TIMUR, DKI JAKARTA",23,156,117,273
https://kawalpemilu.org#26124,"HALIM PERDANA KUSUMA, MAKASAR, JAKARTA TIMUR, DKI JAKARTA",24,139,87,226
https://kawalpemilu.org#26124,"HALIM PERDANA KUSUMA, MAKASAR, JAKARTA TIMUR, DKI JAKARTA",25,146,107,253
https://kawalpemilu.org#26124,"HALIM PERDANA KUSUMA, MAKASAR, JAKARTA TIMUR, DKI JAKARTA",26,117,110,227
https://kawalpemilu.org#26124,"HALIM PERDANA KUSUMA, MAKASAR, JAKARTA TIMUR, DKI JAKARTA",27,134,84,218
https://kawalpemilu.org#26124,"HALIM PERDANA KUSUMA, MAKASAR, JAKARTA TIMUR, DKI JAKARTA",28,118,84,202
https://kawalpemilu.org#26124,"HALIM PERDANA KUSUMA, MAKASAR, JAKARTA TIMUR, DKI JAKARTA",29,96,103,199
https://kawalpemilu.org#26124,"HALIM PERDANA KUSUMA, MAKASAR, JAKARTA TIMUR, DKI JAKARTA",31,157,84,241
https://kawalpemilu.org#26124,"HALIM PERDANA KUSUMA, MAKASAR, JAKARTA TIMUR, DKI JAKARTA",32,85,109,194
https://kawalpemilu.org#26124,"HALIM PERDANA KUSUMA, MAKASAR, JAKARTA TIMUR, DKI JAKARTA",33,104,62,166
https://kawalpemilu.org#26124,"HALIM PERDANA KUSUMA, MAKASAR, JAKARTA TIMUR, DKI JAKARTA",34,105,58,163
https://kawalpemilu.org#26124,"HALIM PERDANA KUSUMA, MAKASAR, JAKARTA TIMUR, DKI JAKARTA",35,84,85,169
https://kawalpemilu.org#26124,"HALIM PERDANA KUSUMA, MAKASAR, JAKARTA TIMUR, DKI JAKARTA",36,104,65,169
https://kawalpemilu.org#26124,"HALIM PERDANA KUSUMA, MAKASAR, JAKARTA TIMUR, DKI JAKARTA",37,102,107,209
https://kawalpemilu.org#26124,"HALIM PERDANA KUSUMA, MAKASAR, JAKARTA TIMUR, DKI JAKARTA",38,103,154,257
https://kawalpemilu.org#26124,"HALIM PERDANA KUSUMA, MAKASAR, JAKARTA TIMUR, DKI JAKARTA",39,85,173,258
https://kawalpemilu.org#26124,"HALIM PERDANA KUSUMA, MAKASAR, JAKARTA TIMUR, DKI JAKARTA",40,108,146,254
https://kawalpemilu.org#26124,"HALIM PERDANA KUSUMA, MAKASAR, JAKARTA TIMUR, DKI JAKARTA",41,131,95,226
https://kawalpemilu.org#26124,"HALIM PERDANA KUSUMA, MAKASAR, JAKARTA TIMUR, DKI JAKARTA",42,87,131,218
https://kawalpemilu.org#26124,"HALIM PERDANA KUSUMA, MAKASAR, JAKARTA TIMUR, DKI JAKARTA",43,102,71,173
https://kawalpemilu.org#26124,"HALIM PERDANA KUSUMA, MAKASAR, JAKARTA TIMUR, DKI JAKARTA",44,137,111,248
https://kawalpemilu.org#26124,"HALIM PERDANA KUSUMA, MAKASAR, JAKARTA TIMUR, DKI JAKARTA",45,95,142,237
https://kawalpemilu.org#26124,"HALIM PERDANA KUSUMA, MAKASAR, JAKARTA TIMUR, DKI JAKARTA",46,80,113,193
https://kawalpemilu.org#26124,"HALIM PERDANA KUSUMA, MAKASAR, JAKARTA TIMUR, DKI JAKARTA",47,99,126,225
https://kawalpemilu.org#26124,"HALIM PERDANA KUSUMA, MAKASAR, JAKARTA TIMUR, DKI JAKARTA",48,95,138,233
https://kawalpemilu.org#26124,"HALIM PERDANA KUSUMA, MAKASAR, JAKARTA TIMUR, DKI JAKARTA",49,111,147,258
https://kawalpemilu.org#26124,"HALIM PERDANA KUSUMA, MAKASAR, JAKARTA TIMUR, DKI JAKARTA",50,111,156,167
https://kawalpemilu.org#26124,"HALIM PERDANA KUSUMA, MAKASAR, JAKARTA TIMUR, DKI JAKARTA",51,145,95,240
https://kawalpemilu.org#26124,"HALIM PERDANA KUSUMA, MAKASAR, JAKARTA TIMUR, DKI JAKARTA",52,140,90,230
https://kawalpemilu.org#26124,"HALIM PERDANA KUSUMA, MAKASAR, JAKARTA TIMUR, DKI JAKARTA",54,0,0,221
https://kawalpemilu.org#26124,"HALIM PERDANA KUSUMA, MAKASAR, JAKARTA TIMUR, DKI JAKARTA",55,86,102,188
https://kawalpemilu.org#26124,"HALIM PERDANA KUSUMA, MAKASAR, JAKARTA TIMUR, DKI JAKARTA",56,75,148,223
https://kawalpemilu.org#26124,"HALIM PERDANA KUSUMA, MAKASAR, JAKARTA TIMUR, DKI JAKARTA",57,81,162,243
https://kawalpemilu.org#26124,"HALIM PERDANA KUSUMA, MAKASAR, JAKARTA TIMUR, DKI JAKARTA",58,75,160,235
https://kawalpemilu.org#26124,"HALIM PERDANA KUSUMA, MAKASAR, JAKARTA TIMUR, DKI JAKARTA",59,113,111,224
https://kawalpemilu.org#26124,"HALIM PERDANA KUSUMA, MAKASAR, JAKARTA TIMUR, DKI JAKARTA",60,73,110,183
https://kawalpemilu.org#26124,"HALIM PERDANA KUSUMA, MAKASAR, JAKARTA TIMUR, DKI JAKARTA",61,120,111,231
https://kawalpemilu.org#26124,"HALIM PERDANA KUSUMA, MAKASAR, JAKARTA TIMUR, DKI JAKARTA",62,115,142,257
https://kawalpemilu.org#26124,"HALIM PERDANA KUSUMA, MAKASAR, JAKARTA TIMUR, DKI JAKARTA",64,83,137,220
https://kawalpemilu.org#26124,"HALIM PERDANA KUSUMA, MAKASAR, JAKARTA TIMUR, DKI JAKARTA",66,48,123,171
https://kawalpemilu.org#26124,"HALIM PERDANA KUSUMA, MAKASAR, JAKARTA TIMUR, DKI JAKARTA",67,96,112,208
https://kawalpemilu.org#26124,"HALIM PERDANA KUSUMA, MAKASAR, JAKARTA TIMUR, DKI JAKARTA",68,83,105,188
https://kawalpemilu.org#26124,"HALIM PERDANA KUSUMA, MAKASAR, JAKARTA TIMUR, DKI JAKARTA",69,108,143,251
https://kawalpemilu.org#26124,"HALIM PERDANA KUSUMA, MAKASAR, JAKARTA TIMUR, DKI JAKARTA",70,117,114,231
https://kawalpemilu.org#26124,"HALIM PERDANA KUSUMA, MAKASAR, JAKARTA TIMUR, DKI JAKARTA",71,120,135,255
https://kawalpemilu.org#26124,"HALIM PERDANA KUSUMA, MAKASAR, JAKARTA TIMUR, DKI JAKARTA",72,100,155,255
https://kawalpemilu.org#26124,"HALIM PERDANA KUSUMA, MAKASAR, JAKARTA TIMUR, DKI JAKARTA",74,81,140,221
https://kawalpemilu.org#26124,"HALIM PERDANA KUSUMA, MAKASAR, JAKARTA TIMUR, DKI JAKARTA",75,114,125,239
https://kawalpemilu.org#26124,"HALIM PERDANA KUSUMA, MAKASAR, JAKARTA TIMUR, DKI JAKARTA",76,70,90,160
https://kawalpemilu.org#26125,"CIPINANG MELAYU, MAKASAR, JAKARTA TIMUR, DKI JAKARTA",1,125,102,227
https://kawalpemilu.org#26125,"CIPINANG MELAYU, MAKASAR, JAKARTA TIMUR, DKI JAKARTA",2,101,122,223
https://kawalpemilu.org#26125,"CIPINANG MELAYU, MAKASAR, JAKARTA TIMUR, DKI JAKARTA",3,108,116,224
https://kawalpemilu.org#26125,"CIPINANG MELAYU, MAKASAR, JAKARTA TIMUR, DKI JAKARTA",4,0,0,0
https://kawalpemilu.org#26125,"CIPINANG MELAYU, MAKASAR, JAKARTA TIMUR, DKI JAKARTA",5,66,159,225
https://kawalpemilu.org#26125,"CIPINANG MELAYU, MAKASAR, JAKARTA TIMUR, DKI JAKARTA",6,48,178,226
https://kawalpemilu.org#26125,"CIPINANG MELAYU, MAKASAR, JAKARTA TIMUR, DKI JAKARTA",10,71,77,148
https://kawalpemilu.org#26125,"CIPINANG MELAYU, MAKASAR, JAKARTA TIMUR, DKI JAKARTA",15,96,137,233
https://kawalpemilu.org#26125,"CIPINANG MELAYU, MAKASAR, JAKARTA TIMUR, DKI JAKARTA",16,119,108,227
https://kawalpemilu.org#26125,"CIPINANG MELAYU, MAKASAR, JAKARTA TIMUR, DKI JAKARTA",17,102,109,211
https://kawalpemilu.org#26125,"CIPINANG MELAYU, MAKASAR, JAKARTA TIMUR, DKI JAKARTA",18,63,139,202
https://kawalpemilu.org#26125,"CIPINANG MELAYU, MAKASAR, JAKARTA TIMUR, DKI JAKARTA",19,73,103,176
https://kawalpemilu.org#26125,"CIPINANG MELAYU, MAKASAR, JAKARTA TIMUR, DKI JAKARTA",20,99,149,248
https://kawalpemilu.org#26125,"CIPINANG MELAYU, MAKASAR, JAKARTA TIMUR, DKI JAKARTA",21,96,105,201
https://kawalpemilu.org#26125,"CIPINANG MELAYU, MAKASAR, JAKARTA TIMUR, DKI JAKARTA",23,120,100,220
https://kawalpemilu.org#26125,"CIPINANG MELAYU, MAKASAR, JAKARTA TIMUR, DKI JAKARTA",24,114,78,192
https://kawalpemilu.org#26125,"CIPINANG MELAYU, MAKASAR, JAKARTA TIMUR, DKI JAKARTA",25,103,117,220
https://kawalpemilu.org#26125,"CIPINANG MELAYU, MAKASAR, JAKARTA TIMUR, DKI JAKARTA",27,72,198,270
https://kawalpemilu.org#26125,"CIPINANG MELAYU, MAKASAR, JAKARTA TIMUR, DKI JAKARTA",28,73,89,162
https://kawalpemilu.org#26125,"CIPINANG MELAYU, MAKASAR, JAKARTA TIMUR, DKI JAKARTA",29,128,114,242
https://kawalpemilu.org#26125,"CIPINANG MELAYU, MAKASAR, JAKARTA TIMUR, DKI JAKARTA",30,113,102,215
https://kawalpemilu.org#26125,"CIPINANG MELAYU, MAKASAR, JAKARTA TIMUR, DKI JAKARTA",31,105,104,209
https://kawalpemilu.org#26125,"CIPINANG MELAYU, MAKASAR, JAKARTA TIMUR, DKI JAKARTA",32,133,101,236
https://kawalpemilu.org#26125,"CIPINANG MELAYU, MAKASAR, JAKARTA TIMUR, DKI JAKARTA",34,117,128,245
https://kawalpemilu.org#26125,"CIPINANG MELAYU, MAKASAR, JAKARTA TIMUR, DKI JAKARTA",35,77,178,255
https://kawalpemilu.org#26125,"CIPINANG MELAYU, MAKASAR, JAKARTA TIMUR, DKI JAKARTA",36,142,116,258
https://kawalpemilu.org#26125,"CIPINANG MELAYU, MAKASAR, JAKARTA TIMUR, DKI JAKARTA",37,108,131,239
https://kawalpemilu.org#26125,"CIPINANG MELAYU, MAKASAR, JAKARTA TIMUR, DKI JAKARTA",38,187,72,259
https://kawalpemilu.org#26125,"CIPINANG MELAYU, MAKASAR, JAKARTA TIMUR, DKI JAKARTA",39,126,126,252
https://kawalpemilu.org#26125,"CIPINANG MELAYU, MAKASAR, JAKARTA TIMUR, DKI JAKARTA",40,121,75,196
https://kawalpemilu.org#26125,"CIPINANG MELAYU, MAKASAR, JAKARTA TIMUR, DKI JAKARTA",42,122,109,231
https://kawalpemilu.org#26125,"CIPINANG MELAYU, MAKASAR, JAKARTA TIMUR, DKI JAKARTA",43,75,151,226
https://kawalpemilu.org#26125,"CIPINANG MELAYU, MAKASAR, JAKARTA TIMUR, DKI JAKARTA",44,64,134,198
https://kawalpemilu.org#26125,"CIPINANG MELAYU, MAKASAR, JAKARTA TIMUR, DKI JAKARTA",45,125,116,241
https://kawalpemilu.org#26125,"CIPINANG MELAYU, MAKASAR, JAKARTA TIMUR, DKI JAKARTA",46,74,54,128
https://kawalpemilu.org#26125,"CIPINANG MELAYU, MAKASAR, JAKARTA TIMUR, DKI JAKARTA",47,67,107,174
https://kawalpemilu.org#26125,"CIPINANG MELAYU, MAKASAR, JAKARTA TIMUR, DKI JAKARTA",48,92,177,269
https://kawalpemilu.org#26125,"CIPINANG MELAYU, MAKASAR, JAKARTA TIMUR, DKI JAKARTA",49,106,147,253
https://kawalpemilu.org#26125,"CIPINANG MELAYU, MAKASAR, JAKARTA TIMUR, DKI JAKARTA",50,86,113,199
https://kawalpemilu.org#26125,"CIPINANG MELAYU, MAKASAR, JAKARTA TIMUR, DKI JAKARTA",51,109,140,249
https://kawalpemilu.org#26125,"CIPINANG MELAYU, MAKASAR, JAKARTA TIMUR, DKI JAKARTA",52,86,104,190
https://kawalpemilu.org#26125,"CIPINANG MELAYU, MAKASAR, JAKARTA TIMUR, DKI JAKARTA",53,103,146,249
https://kawalpemilu.org#26125,"CIPINANG MELAYU, MAKASAR, JAKARTA TIMUR, DKI JAKARTA",54,102,149,251
https://kawalpemilu.org#26125,"CIPINANG MELAYU, MAKASAR, JAKARTA TIMUR, DKI JAKARTA",55,68,174,242
https://kawalpemilu.org#26125,"CIPINANG MELAYU, MAKASAR, JAKARTA TIMUR, DKI JAKARTA",58,91,158,249
https://kawalpemilu.org#26125,"CIPINANG MELAYU, MAKASAR, JAKARTA TIMUR, DKI JAKARTA",59,71,142,213
https://kawalpemilu.org#26125,"CIPINANG MELAYU, MAKASAR, JAKARTA TIMUR, DKI JAKARTA",60,116,145,261
https://kawalpemilu.org#26125,"CIPINANG MELAYU, MAKASAR, JAKARTA TIMUR, DKI JAKARTA",61,107,123,230
https://kawalpemilu.org#26125,"CIPINANG MELAYU, MAKASAR, JAKARTA TIMUR, DKI JAKARTA",62,79,190,269
https://kawalpemilu.org#26125,"CIPINANG MELAYU, MAKASAR, JAKARTA TIMUR, DKI JAKARTA",63,93,159,252
https://kawalpemilu.org#26125,"CIPINANG MELAYU, MAKASAR, JAKARTA TIMUR, DKI JAKARTA",64,129,125,254
https://kawalpemilu.org#26125,"CIPINANG MELAYU, MAKASAR, JAKARTA TIMUR, DKI JAKARTA",65,56,88,144
https://kawalpemilu.org#26125,"CIPINANG MELAYU, MAKASAR, JAKARTA TIMUR, DKI JAKARTA",66,55,115,170
https://kawalpemilu.org#26125,"CIPINANG MELAYU, MAKASAR, JAKARTA TIMUR, DKI JAKARTA",68,106,114,220
https://kawalpemilu.org#26125,"CIPINANG MELAYU, MAKASAR, JAKARTA TIMUR, DKI JAKARTA",69,101,118,219
https://kawalpemilu.org#26125,"CIPINANG MELAYU, MAKASAR, JAKARTA TIMUR, DKI JAKARTA",70,111,106,217
https://kawalpemilu.org#26125,"CIPINANG MELAYU, MAKASAR, JAKARTA TIMUR, DKI JAKARTA",71,120,117,237
https://kawalpemilu.org#26125,"CIPINANG MELAYU, MAKASAR, JAKARTA TIMUR, DKI JAKARTA",72,86,135,221
https://kawalpemilu.org#26125,"CIPINANG MELAYU, MAKASAR, JAKARTA TIMUR, DKI JAKARTA",73,123,127,250
https://kawalpemilu.org#26125,"CIPINANG MELAYU, MAKASAR, JAKARTA TIMUR, DKI JAKARTA",75,106,147,253
https://kawalpemilu.org#26125,"CIPINANG MELAYU, MAKASAR, JAKARTA TIMUR, DKI JAKARTA",76,80,154,234
https://kawalpemilu.org#26125,"CIPINANG MELAYU, MAKASAR, JAKARTA TIMUR, DKI JAKARTA",77,116,125,241
https://kawalpemilu.org#26125,"CIPINANG MELAYU, MAKASAR, JAKARTA TIMUR, DKI JAKARTA",78,142,113,255
https://kawalpemilu.org#26125,"CIPINANG MELAYU, MAKASAR, JAKARTA TIMUR, DKI JAKARTA",79,142,123,265
https://kawalpemilu.org#26125,"CIPINANG MELAYU, MAKASAR, JAKARTA TIMUR, DKI JAKARTA",80,137,126,263
https://kawalpemilu.org#26125,"CIPINANG MELAYU, MAKASAR, JAKARTA TIMUR, DKI JAKARTA",81,132,111,243
https://kawalpemilu.org#26125,"CIPINANG MELAYU, MAKASAR, JAKARTA TIMUR, DKI JAKARTA",82,128,98,226
https://kawalpemilu.org#26125,"CIPINANG MELAYU, MAKASAR, JAKARTA TIMUR, DKI JAKARTA",83,159,95,254
https://kawalpemilu.org#26125,"CIPINANG MELAYU, MAKASAR, JAKARTA TIMUR, DKI JAKARTA",84,144,97,241
https://kawalpemilu.org#26125,"CIPINANG MELAYU, MAKASAR, JAKARTA TIMUR, DKI JAKARTA",85,155,61,216
https://kawalpemilu.org#26125,"CIPINANG MELAYU, MAKASAR, JAKARTA TIMUR, DKI JAKARTA",86,126,89,215
https://kawalpemilu.org#26125,"CIPINANG MELAYU, MAKASAR, JAKARTA TIMUR, DKI JAKARTA",87,99,50,149
https://kawalpemilu.org#26125,"CIPINANG MELAYU, MAKASAR, JAKARTA TIMUR, DKI JAKARTA",88,164,72,236
https://kawalpemilu.org#26125,"CIPINANG MELAYU, MAKASAR, JAKARTA TIMUR, DKI JAKARTA",89,154,77,231
https://kawalpemilu.org#26125,"CIPINANG MELAYU, MAKASAR, JAKARTA TIMUR, DKI JAKARTA",90,154,82,236
https://kawalpemilu.org#26125,"CIPINANG MELAYU, MAKASAR, JAKARTA TIMUR, DKI JAKARTA",91,121,85,206
https://kawalpemilu.org#26125,"CIPINANG MELAYU, MAKASAR, JAKARTA TIMUR, DKI JAKARTA",92,81,49,130
https://kawalpemilu.org#26125,"CIPINANG MELAYU, MAKASAR, JAKARTA TIMUR, DKI JAKARTA",93,127,100,227
https://kawalpemilu.org#26125,"CIPINANG MELAYU, MAKASAR, JAKARTA TIMUR, DKI JAKARTA",94,108,36,144
https://kawalpemilu.org#26125,"CIPINANG MELAYU, MAKASAR, JAKARTA TIMUR, DKI JAKARTA",95,158,95,253
https://kawalpemilu.org#26125,"CIPINANG MELAYU, MAKASAR, JAKARTA TIMUR, DKI JAKARTA",96,142,59,201
https://kawalpemilu.org#26125,"CIPINANG MELAYU, MAKASAR, JAKARTA TIMUR, DKI JAKARTA",97,57,130,187
https://kawalpemilu.org#26125,"CIPINANG MELAYU, MAKASAR, JAKARTA TIMUR, DKI JAKARTA",98,46,132,178
https://kawalpemilu.org#26125,"CIPINANG MELAYU, MAKASAR, JAKARTA TIMUR, DKI JAKARTA",99,90,171,261
https://kawalpemilu.org#26125,"CIPINANG MELAYU, MAKASAR, JAKARTA TIMUR, DKI JAKARTA",100,52,79,131
https://kawalpemilu.org#26125,"CIPINANG MELAYU, MAKASAR, JAKARTA TIMUR, DKI JAKARTA",102,125,93,218
https://kawalpemilu.org#26125,"CIPINANG MELAYU, MAKASAR, JAKARTA TIMUR, DKI JAKARTA",103,66,128,194
https://kawalpemilu.org#26125,"CIPINANG MELAYU, MAKASAR, JAKARTA TIMUR, DKI JAKARTA",104,79,91,170
https://kawalpemilu.org#26125,"CIPINANG MELAYU, MAKASAR, JAKARTA TIMUR, DKI JAKARTA",105,117,113,230
https://kawalpemilu.org#26125,"CIPINANG MELAYU, MAKASAR, JAKARTA TIMUR, DKI JAKARTA",106,103,124,227
https://kawalpemilu.org#26125,"CIPINANG MELAYU, MAKASAR, JAKARTA TIMUR, DKI JAKARTA",107,142,97,239
https://kawalpemilu.org#26125,"CIPINANG MELAYU, MAKASAR, JAKARTA TIMUR, DKI JAKARTA",108,59,88,147
https://kawalpemilu.org#26125,"CIPINANG MELAYU, MAKASAR, JAKARTA TIMUR, DKI JAKARTA",109,156,105,261
https://kawalpemilu.org#26125,"CIPINANG MELAYU, MAKASAR, JAKARTA TIMUR, DKI JAKARTA",110,107,163,270
https://kawalpemilu.org#26125,"CIPINANG MELAYU, MAKASAR, JAKARTA TIMUR, DKI JAKARTA",112,71,168,239
https://kawalpemilu.org#26125,"CIPINANG MELAYU, MAKASAR, JAKARTA TIMUR, DKI JAKARTA",113,96,118,214
https://kawalpemilu.org#26125,"CIPINANG MELAYU, MAKASAR, JAKARTA TIMUR, DKI JAKARTA",114,172,85,257
https://kawalpemilu.org#26125,"CIPINANG MELAYU, MAKASAR, JAKARTA TIMUR, DKI JAKARTA",115,116,100,216
https://kawalpemilu.org#26125,"CIPINANG MELAYU, MAKASAR, JAKARTA TIMUR, DKI JAKARTA",116,143,89,232
https://kawalpemilu.org#26125,"CIPINANG MELAYU, MAKASAR, JAKARTA TIMUR, DKI JAKARTA",117,151,64,215
https://kawalpemilu.org#26125,"CIPINANG MELAYU, MAKASAR, JAKARTA TIMUR, DKI JAKARTA",121,102,139,241
https://kawalpemilu.org#26125,"CIPINANG MELAYU, MAKASAR, JAKARTA TIMUR, DKI JAKARTA",122,96,108,204
https://kawalpemilu.org#26125,"CIPINANG MELAYU, MAKASAR, JAKARTA TIMUR, DKI JAKARTA",123,163,87,250
https://kawalpemilu.org#26125,"CIPINANG MELAYU, MAKASAR, JAKARTA TIMUR, DKI JAKARTA",124,148,111,259
https://kawalpemilu.org#26125,"CIPINANG MELAYU, MAKASAR, JAKARTA TIMUR, DKI JAKARTA",125,145,87,232
https://kawalpemilu.org#26125,"CIPINANG MELAYU, MAKASAR, JAKARTA TIMUR, DKI JAKARTA",126,147,86,233
https://kawalpemilu.org#26125,"CIPINANG MELAYU, MAKASAR, JAKARTA TIMUR, DKI JAKARTA",127,141,101,242
https://kawalpemilu.org#26125,"CIPINANG MELAYU, MAKASAR, JAKARTA TIMUR, DKI JAKARTA",128,91,83,174
https://kawalpemilu.org#26125,"CIPINANG MELAYU, MAKASAR, JAKARTA TIMUR, DKI JAKARTA",129,150,68,218
https://kawalpemilu.org#26125,"CIPINANG MELAYU, MAKASAR, JAKARTA TIMUR, DKI JAKARTA",130,134,130,264
https://kawalpemilu.org#26125,"CIPINANG MELAYU, MAKASAR, JAKARTA TIMUR, DKI JAKARTA",132,138,96,234
https://kawalpemilu.org#26125,"CIPINANG MELAYU, MAKASAR, JAKARTA TIMUR, DKI JAKARTA",135,92,69,161
https://kawalpemilu.org#26125,"CIPINANG MELAYU, MAKASAR, JAKARTA TIMUR, DKI JAKARTA",138,67,101,168
https://kawalpemilu.org#26125,"CIPINANG MELAYU, MAKASAR, JAKARTA TIMUR, DKI JAKARTA",139,79,152,231
https://kawalpemilu.org#26125,"CIPINANG MELAYU, MAKASAR, JAKARTA TIMUR, DKI JAKARTA",140,74,104,178
https://kawalpemilu.org#26125,"CIPINANG MELAYU, MAKASAR, JAKARTA TIMUR, DKI JAKARTA",141,49,68,117
https://kawalpemilu.org#26125,"CIPINANG MELAYU, MAKASAR, JAKARTA TIMUR, DKI JAKARTA",143,119,140,259
https://kawalpemilu.org#26125,"CIPINANG MELAYU, MAKASAR, JAKARTA TIMUR, DKI JAKARTA",145,98,123,221
https://kawalpemilu.org#26125,"CIPINANG MELAYU, MAKASAR, JAKARTA TIMUR, DKI JAKARTA",146,92,129,221
https://kawalpemilu.org#26127,"CIRACAS, CIRACAS, JAKARTA TIMUR, DKI JAKARTA",1,163,98,261
https://kawalpemilu.org#26127,"CIRACAS, CIRACAS, JAKARTA TIMUR, DKI JAKARTA",2,136,121,257
https://kawalpemilu.org#26127,"CIRACAS, CIRACAS, JAKARTA TIMUR, DKI JAKARTA",3,126,83,209
https://kawalpemilu.org#26127,"CIRACAS, CIRACAS, JAKARTA TIMUR, DKI JAKARTA",4,130,86,216
https://kawalpemilu.org#26127,"CIRACAS, CIRACAS, JAKARTA TIMUR, DKI JAKARTA",5,168,58,226
https://kawalpemilu.org#26127,"CIRACAS, CIRACAS, JAKARTA TIMUR, DKI JAKARTA",6,173,69,242
https://kawalpemilu.org#26127,"CIRACAS, CIRACAS, JAKARTA TIMUR, DKI JAKARTA",7,160,54,214
https://kawalpemilu.org#26127,"CIRACAS, CIRACAS, JAKARTA TIMUR, DKI JAKARTA",8,0,0,199
https://kawalpemilu.org#26127,"CIRACAS, CIRACAS, JAKARTA TIMUR, DKI JAKARTA",9,93,85,178
https://kawalpemilu.org#26127,"CIRACAS, CIRACAS, JAKARTA TIMUR, DKI JAKARTA",10,78,129,207
https://kawalpemilu.org#26127,"CIRACAS, CIRACAS, JAKARTA TIMUR, DKI JAKARTA",11,81,129,210
https://kawalpemilu.org#26127,"CIRACAS, CIRACAS, JAKARTA TIMUR, DKI JAKARTA",12,82,113,195
https://kawalpemilu.org#26127,"CIRACAS, CIRACAS, JAKARTA TIMUR, DKI JAKARTA",13,121,83,204
https://kawalpemilu.org#26127,"CIRACAS, CIRACAS, JAKARTA TIMUR, DKI JAKARTA",14,125,110,235
https://kawalpemilu.org#26127,"CIRACAS, CIRACAS, JAKARTA TIMUR, DKI JAKARTA",15,98,130,228
https://kawalpemilu.org#26127,"CIRACAS, CIRACAS, JAKARTA TIMUR, DKI JAKARTA",16,111,149,260
https://kawalpemilu.org#26127,"CIRACAS, CIRACAS, JAKARTA TIMUR, DKI JAKARTA",17,114,95,209
https://kawalpemilu.org#26127,"CIRACAS, CIRACAS, JAKARTA TIMUR, DKI JAKARTA",18,90,155,245
https://kawalpemilu.org#26127,"CIRACAS, CIRACAS, JAKARTA TIMUR, DKI JAKARTA",19,90,108,198
https://kawalpemilu.org#26127,"CIRACAS, CIRACAS, JAKARTA TIMUR, DKI JAKARTA",20,100,73,173
https://kawalpemilu.org#26127,"CIRACAS, CIRACAS, JAKARTA TIMUR, DKI JAKARTA",21,135,101,236
https://kawalpemilu.org#26127,"CIRACAS, CIRACAS, JAKARTA TIMUR, DKI JAKARTA",22,92,116,208
https://kawalpemilu.org#26127,"CIRACAS, CIRACAS, JAKARTA TIMUR, DKI JAKARTA",23,105,135,240
https://kawalpemilu.org#26127,"CIRACAS, CIRACAS, JAKARTA TIMUR, DKI JAKARTA",24,93,95,188
https://kawalpemilu.org#26127,"CIRACAS, CIRACAS, JAKARTA TIMUR, DKI JAKARTA",25,109,100,209
https://kawalpemilu.org#26127,"CIRACAS, CIRACAS, JAKARTA TIMUR, DKI JAKARTA",26,109,121,230
https://kawalpemilu.org#26127,"CIRACAS, CIRACAS, JAKARTA TIMUR, DKI JAKARTA",27,123,114,237
https://kawalpemilu.org#26127,"CIRACAS, CIRACAS, JAKARTA TIMUR, DKI JAKARTA",28,95,110,205
https://kawalpemilu.org#26127,"CIRACAS, CIRACAS, JAKARTA TIMUR, DKI JAKARTA",29,115,126,241
https://kawalpemilu.org#26127,"CIRACAS, CIRACAS, JAKARTA TIMUR, DKI JAKARTA",30,88,95,183
https://kawalpemilu.org#26127,"CIRACAS, CIRACAS, JAKARTA TIMUR, DKI JAKARTA",32,142,114,256
https://kawalpemilu.org#26127,"CIRACAS, CIRACAS, JAKARTA TIMUR, DKI JAKARTA",33,130,138,268
https://kawalpemilu.org#26127,"CIRACAS, CIRACAS, JAKARTA TIMUR, DKI JAKARTA",34,120,120,240
https://kawalpemilu.org#26127,"CIRACAS, CIRACAS, JAKARTA TIMUR, DKI JAKARTA",35,106,135,241
https://kawalpemilu.org#26127,"CIRACAS, CIRACAS, JAKARTA TIMUR, DKI JAKARTA",36,92,181,273
https://kawalpemilu.org#26127,"CIRACAS, CIRACAS, JAKARTA TIMUR, DKI JAKARTA",37,94,110,204
https://kawalpemilu.org#26127,"CIRACAS, CIRACAS, JAKARTA TIMUR, DKI JAKARTA",38,143,89,232
https://kawalpemilu.org#26127,"CIRACAS, CIRACAS, JAKARTA TIMUR, DKI JAKARTA",39,107,130,237
https://kawalpemilu.org#26127,"CIRACAS, CIRACAS, JAKARTA TIMUR, DKI JAKARTA",40,80,140,220
https://kawalpemilu.org#26127,"CIRACAS, CIRACAS, JAKARTA TIMUR, DKI JAKARTA",41,71,112,183
https://kawalpemilu.org#26127,"CIRACAS, CIRACAS, JAKARTA TIMUR, DKI JAKARTA",42,130,93,223
https://kawalpemilu.org#26127,"CIRACAS, CIRACAS, JAKARTA TIMUR, DKI JAKARTA",43,83,134,217
https://kawalpemilu.org#26127,"CIRACAS, CIRACAS, JAKARTA TIMUR, DKI JAKARTA",44,150,89,239
https://kawalpemilu.org#26127,"CIRACAS, CIRACAS, JAKARTA TIMUR, DKI JAKARTA",45,126,99,225
https://kawalpemilu.org#26127,"CIRACAS, CIRACAS, JAKARTA TIMUR, DKI JAKARTA",46,85,154,239
https://kawalpemilu.org#26127,"CIRACAS, CIRACAS, JAKARTA TIMUR, DKI JAKARTA",47,125,93,218
https://kawalpemilu.org#26127,"CIRACAS, CIRACAS, JAKARTA TIMUR, DKI JAKARTA",48,163,96,259
https://kawalpemilu.org#26127,"CIRACAS, CIRACAS, JAKARTA TIMUR, DKI JAKARTA",49,130,94,224
https://kawalpemilu.org#26127,"CIRACAS, CIRACAS, JAKARTA TIMUR, DKI JAKARTA",50,132,89,221
https://kawalpemilu.org#26127,"CIRACAS, CIRACAS, JAKARTA TIMUR, DKI JAKARTA",51,150,72,222
https://kawalpemilu.org#26127,"CIRACAS, CIRACAS, JAKARTA TIMUR, DKI JAKARTA",52,131,131,262
https://kawalpemilu.org#26127,"CIRACAS, CIRACAS, JAKARTA TIMUR, DKI JAKARTA",53,129,126,255
https://kawalpemilu.org#26127,"CIRACAS, CIRACAS, JAKARTA TIMUR, DKI JAKARTA",54,142,100,242
https://kawalpemilu.org#26127,"CIRACAS, CIRACAS, JAKARTA TIMUR, DKI JAKARTA",55,112,120,232
https://kawalpemilu.org#26127,"CIRACAS, CIRACAS, JAKARTA TIMUR, DKI JAKARTA",56,113,103,216
https://kawalpemilu.org#26127,"CIRACAS, CIRACAS, JAKARTA TIMUR, DKI JAKARTA",57,122,109,231
https://kawalpemilu.org#26127,"CIRACAS, CIRACAS, JAKARTA TIMUR, DKI JAKARTA",58,118,124,242
https://kawalpemilu.org#26127,"CIRACAS, CIRACAS, JAKARTA TIMUR, DKI JAKARTA",59,106,136,242
https://kawalpemilu.org#26127,"CIRACAS, CIRACAS, JAKARTA TIMUR, DKI JAKARTA",60,106,111,217
https://kawalpemilu.org#26127,"CIRACAS, CIRACAS, JAKARTA TIMUR, DKI JAKARTA",61,93,128,221
https://kawalpemilu.org#26127,"CIRACAS, CIRACAS, JAKARTA TIMUR, DKI JAKARTA",62,137,124,261
https://kawalpemilu.org#26127,"CIRACAS, CIRACAS, JAKARTA TIMUR, DKI JAKARTA",63,153,109,262
https://kawalpemilu.org#26127,"CIRACAS, CIRACAS, JAKARTA TIMUR, DKI JAKARTA",64,138,94,228
https://kawalpemilu.org#26127,"CIRACAS, CIRACAS, JAKARTA TIMUR, DKI JAKARTA",65,161,66,227
https://kawalpemilu.org#26127,"CIRACAS, CIRACAS, JAKARTA TIMUR, DKI JAKARTA",66,182,60,242
https://kawalpemilu.org#26127,"CIRACAS, CIRACAS, JAKARTA TIMUR, DKI JAKARTA",67,130,111,241
https://kawalpemilu.org#26127,"CIRACAS, CIRACAS, JAKARTA TIMUR, DKI JAKARTA",68,121,105,226
https://kawalpemilu.org#26127,"CIRACAS, CIRACAS, JAKARTA TIMUR, DKI JAKARTA",69,133,131,264
https://kawalpemilu.org#26127,"CIRACAS, CIRACAS, JAKARTA TIMUR, DKI JAKARTA",70,146,101,247
https://kawalpemilu.org#26127,"CIRACAS, CIRACAS, JAKARTA TIMUR, DKI JAKARTA",71,143,128,271
https://kawalpemilu.org#26127,"CIRACAS, CIRACAS, JAKARTA TIMUR, DKI JAKARTA",72,124,117,241
https://kawalpemilu.org#26127,"CIRACAS, CIRACAS, JAKARTA TIMUR, DKI JAKARTA",73,112,122,234
https://kawalpemilu.org#26127,"CIRACAS, CIRACAS, JAKARTA TIMUR, DKI JAKARTA",74,118,98,216
https://kawalpemilu.org#26127,"CIRACAS, CIRACAS, JAKARTA TIMUR, DKI JAKARTA",75,119,136,255
https://kawalpemilu.org#26127,"CIRACAS, CIRACAS, JAKARTA TIMUR, DKI JAKARTA",76,158,99,257
https://kawalpemilu.org#26127,"CIRACAS, CIRACAS, JAKARTA TIMUR, DKI JAKARTA",78,133,137,270
https://kawalpemilu.org#26127,"CIRACAS, CIRACAS, JAKARTA TIMUR, DKI JAKARTA",79,127,99,225
https://kawalpemilu.org#26127,"CIRACAS, CIRACAS, JAKARTA TIMUR, DKI JAKARTA",80,143,85,228
https://kawalpemilu.org#26127,"CIRACAS, CIRACAS, JAKARTA TIMUR, DKI JAKARTA",82,130,89,219
https://kawalpemilu.org#26127,"CIRACAS, CIRACAS, JAKARTA TIMUR, DKI JAKARTA",83,106,95,201
https://kawalpemilu.org#26127,"CIRACAS, CIRACAS, JAKARTA TIMUR, DKI JAKARTA",84,155,102,257
https://kawalpemilu.org#26127,"CIRACAS, CIRACAS, JAKARTA TIMUR, DKI JAKARTA",85,166,91,257
https://kawalpemilu.org#26127,"CIRACAS, CIRACAS, JAKARTA TIMUR, DKI JAKARTA",86,147,110,257
https://kawalpemilu.org#26127,"CIRACAS, CIRACAS, JAKARTA TIMUR, DKI JAKARTA",87,111,132,243
https://kawalpemilu.org#26127,"CIRACAS, CIRACAS, JAKARTA TIMUR, DKI JAKARTA",88,133,107,240
https://kawalpemilu.org#26127,"CIRACAS, CIRACAS, JAKARTA TIMUR, DKI JAKARTA",89,104,108,212
https://kawalpemilu.org#26127,"CIRACAS, CIRACAS, JAKARTA TIMUR, DKI JAKARTA",90,104,137,241
https://kawalpemilu.org#26127,"CIRACAS, CIRACAS, JAKARTA TIMUR, DKI JAKARTA",91,123,137,260
https://kawalpemilu.org#26127,"CIRACAS, CIRACAS, JAKARTA TIMUR, DKI JAKARTA",92,108,140,248
https://kawalpemilu.org#26127,"CIRACAS, CIRACAS, JAKARTA TIMUR, DKI JAKARTA",93,133,143,276
https://kawalpemilu.org#26127,"CIRACAS, CIRACAS, JAKARTA TIMUR, DKI JAKARTA",94,106,123,229
https://kawalpemilu.org#26127,"CIRACAS, CIRACAS, JAKARTA TIMUR, DKI JAKARTA",95,153,95,248
https://kawalpemilu.org#26127,"CIRACAS, CIRACAS, JAKARTA TIMUR, DKI JAKARTA",96,149,91,240
https://kawalpemilu.org#26127,"CIRACAS, CIRACAS, JAKARTA TIMUR, DKI JAKARTA",97,128,135,263
https://kawalpemilu.org#26127,"CIRACAS, CIRACAS, JAKARTA TIMUR, DKI JAKARTA",98,131,151,282
https://kawalpemilu.org#26127,"CIRACAS, CIRACAS, JAKARTA TIMUR, DKI JAKARTA",99,117,134,251
https://kawalpemilu.org#26127,"CIRACAS, CIRACAS, JAKARTA TIMUR, DKI JAKARTA",101,144,108,252
https://kawalpemilu.org#26127,"CIRACAS, CIRACAS, JAKARTA TIMUR, DKI JAKARTA",102,118,129,247
https://kawalpemilu.org#26127,"CIRACAS, CIRACAS, JAKARTA TIMUR, DKI JAKARTA",103,109,115,224
https://kawalpemilu.org#26127,"CIRACAS, CIRACAS, JAKARTA TIMUR, DKI JAKARTA",104,101,144,245
https://kawalpemilu.org#26127,"CIRACAS, CIRACAS, JAKARTA TIMUR, DKI JAKARTA",105,105,131,236
https://kawalpemilu.org#26127,"CIRACAS, CIRACAS, JAKARTA TIMUR, DKI JAKARTA",106,113,132,245
https://kawalpemilu.org#26127,"CIRACAS, CIRACAS, JAKARTA TIMUR, DKI JAKARTA",107,96,118,214
https://kawalpemilu.org#26127,"CIRACAS, CIRACAS, JAKARTA TIMUR, DKI JAKARTA",108,129,130,259
https://kawalpemilu.org#26127,"CIRACAS, CIRACAS, JAKARTA TIMUR, DKI JAKARTA",109,144,113,257
https://kawalpemilu.org#26127,"CIRACAS, CIRACAS, JAKARTA TIMUR, DKI JAKARTA",110,141,95,236
https://kawalpemilu.org#26127,"CIRACAS, CIRACAS, JAKARTA TIMUR, DKI JAKARTA",111,137,108,245
https://kawalpemilu.org#26127,"CIRACAS, CIRACAS, JAKARTA TIMUR, DKI JAKARTA",112,94,101,195
https://kawalpemilu.org#26127,"CIRACAS, CIRACAS, JAKARTA TIMUR, DKI JAKARTA",113,101,113,214
https://kawalpemilu.org#26127,"CIRACAS, CIRACAS, JAKARTA TIMUR, DKI JAKARTA",115,127,109,236
https://kawalpemilu.org#26127,"CIRACAS, CIRACAS, JAKARTA TIMUR, DKI JAKARTA",116,113,135,248
https://kawalpemilu.org#26127,"CIRACAS, CIRACAS, JAKARTA TIMUR, DKI JAKARTA",117,116,127,243
https://kawalpemilu.org#26127,"CIRACAS, CIRACAS, JAKARTA TIMUR, DKI JAKARTA",120,127,116,243
https://kawalpemilu.org#26127,"CIRACAS, CIRACAS, JAKARTA TIMUR, DKI JAKARTA",122,147,113,260
https://kawalpemilu.org#26127,"CIRACAS, CIRACAS, JAKARTA TIMUR, DKI JAKARTA",123,135,107,242
https://kawalpemilu.org#26127,"CIRACAS, CIRACAS, JAKARTA TIMUR, DKI JAKARTA",124,125,86,211
https://kawalpemilu.org#26127,"CIRACAS, CIRACAS, JAKARTA TIMUR, DKI JAKARTA",126,153,95,248
https://kawalpemilu.org#26127,"CIRACAS, CIRACAS, JAKARTA TIMUR, DKI JAKARTA",128,97,110,207
https://kawalpemilu.org#26127,"CIRACAS, CIRACAS, JAKARTA TIMUR, DKI JAKARTA",129,89,168,257
https://kawalpemilu.org#26127,"CIRACAS, CIRACAS, JAKARTA TIMUR, DKI JAKARTA",130,117,149,266
https://kawalpemilu.org#26127,"CIRACAS, CIRACAS, JAKARTA TIMUR, DKI JAKARTA",131,158,109,267
https://kawalpemilu.org#26127,"CIRACAS, CIRACAS, JAKARTA TIMUR, DKI JAKARTA",133,86,136,222
https://kawalpemilu.org#26127,"CIRACAS, CIRACAS, JAKARTA TIMUR, DKI JAKARTA",134,118,103,221
https://kawalpemilu.org#26127,"CIRACAS, CIRACAS, JAKARTA TIMUR, DKI JAKARTA",135,134,125,259
https://kawalpemilu.org#26127,"CIRACAS, CIRACAS, JAKARTA TIMUR, DKI JAKARTA",137,108,159,267
https://kawalpemilu.org#26127,"CIRACAS, CIRACAS, JAKARTA TIMUR, DKI JAKARTA",138,155,107,262
https://kawalpemilu.org#26127,"CIRACAS, CIRACAS, JAKARTA TIMUR, DKI JAKARTA",141,105,99,204
https://kawalpemilu.org#26127,"CIRACAS, CIRACAS, JAKARTA TIMUR, DKI JAKARTA",142,65,147,207
https://kawalpemilu.org#26127,"CIRACAS, CIRACAS, JAKARTA TIMUR, DKI JAKARTA",143,124,102,226
https://kawalpemilu.org#26127,"CIRACAS, CIRACAS, JAKARTA TIMUR, DKI JAKARTA",144,107,82,189
https://kawalpemilu.org#26127,"CIRACAS, CIRACAS, JAKARTA TIMUR, DKI JAKARTA",145,96,126,222
https://kawalpemilu.org#26127,"CIRACAS, CIRACAS, JAKARTA TIMUR, DKI JAKARTA",146,96,101,197
https://kawalpemilu.org#26127,"CIRACAS, CIRACAS, JAKARTA TIMUR, DKI JAKARTA",148,131,130,261
https://kawalpemilu.org#26127,"CIRACAS, CIRACAS, JAKARTA TIMUR, DKI JAKARTA",149,100,101,201
https://kawalpemilu.org#26127,"CIRACAS, CIRACAS, JAKARTA TIMUR, DKI JAKARTA",150,130,87,217
https://kawalpemilu.org#26127,"CIRACAS, CIRACAS, JAKARTA TIMUR, DKI JAKARTA",151,86,60,146
https://kawalpemilu.org#26127,"CIRACAS, CIRACAS, JAKARTA TIMUR, DKI JAKARTA",152,138,108,246
https://kawalpemilu.org#26127,"CIRACAS, CIRACAS, JAKARTA TIMUR, DKI JAKARTA",154,89,115,204
https://kawalpemilu.org#26127,"CIRACAS, CIRACAS, JAKARTA TIMUR, DKI JAKARTA",155,98,140,238
https://kawalpemilu.org#26127,"CIRACAS, CIRACAS, JAKARTA TIMUR, DKI JAKARTA",156,149,93,242
https://kawalpemilu.org#26127,"CIRACAS, CIRACAS, JAKARTA TIMUR, DKI JAKARTA",157,124,102,226
https://kawalpemilu.org#26127,"CIRACAS, CIRACAS, JAKARTA TIMUR, DKI JAKARTA",158,129,123,252
https://kawalpemilu.org#26127,"CIRACAS, CIRACAS, JAKARTA TIMUR, DKI JAKARTA",159,151,111,262
https://kawalpemilu.org#26127,"CIRACAS, CIRACAS, JAKARTA TIMUR, DKI JAKARTA",160,157,96,253
https://kawalpemilu.org#26127,"CIRACAS, CIRACAS, JAKARTA TIMUR, DKI JAKARTA",161,150,91,241
https://kawalpemilu.org#26127,"CIRACAS, CIRACAS, JAKARTA TIMUR, DKI JAKARTA",162,133,98,231
https://kawalpemilu.org#26127,"CIRACAS, CIRACAS, JAKARTA TIMUR, DKI JAKARTA",163,120,154,274
https://kawalpemilu.org#26127,"CIRACAS, CIRACAS, JAKARTA TIMUR, DKI JAKARTA",164,136,93,229
https://kawalpemilu.org#26127,"CIRACAS, CIRACAS, JAKARTA TIMUR, DKI JAKARTA",165,149,100,249
https://kawalpemilu.org#26127,"CIRACAS, CIRACAS, JAKARTA TIMUR, DKI JAKARTA",166,100,91,191
https://kawalpemilu.org#26127,"CIRACAS, CIRACAS, JAKARTA TIMUR, DKI JAKARTA",167,129,97,226
https://kawalpemilu.org#26127,"CIRACAS, CIRACAS, JAKARTA TIMUR, DKI JAKARTA",168,136,92,232
https://kawalpemilu.org#26127,"CIRACAS, CIRACAS, JAKARTA TIMUR, DKI JAKARTA",170,99,98,197
https://kawalpemilu.org#26127,"CIRACAS, CIRACAS, JAKARTA TIMUR, DKI JAKARTA",172,116,103,219
https://kawalpemilu.org#26127,"CIRACAS, CIRACAS, JAKARTA TIMUR, DKI JAKARTA",173,124,104,228
https://kawalpemilu.org#26127,"CIRACAS, CIRACAS, JAKARTA TIMUR, DKI JAKARTA",174,142,100,242
https://kawalpemilu.org#26127,"CIRACAS, CIRACAS, JAKARTA TIMUR, DKI JAKARTA",176,115,133,248
https://kawalpemilu.org#26127,"CIRACAS, CIRACAS, JAKARTA TIMUR, DKI JAKARTA",177,123,136,259
https://kawalpemilu.org#26127,"CIRACAS, CIRACAS, JAKARTA TIMUR, DKI JAKARTA",179,161,106,267
https://kawalpemilu.org#26127,"CIRACAS, CIRACAS, JAKARTA TIMUR, DKI JAKARTA",180,138,158,296
https://kawalpemilu.org#26127,"CIRACAS, CIRACAS, JAKARTA TIMUR, DKI JAKARTA",181,136,105,241
https://kawalpemilu.org#26127,"CIRACAS, CIRACAS, JAKARTA TIMUR, DKI JAKARTA",182,120,134,254
https://kawalpemilu.org#26127,"CIRACAS, CIRACAS, JAKARTA TIMUR, DKI JAKARTA",183,115,133,248
https://kawalpemilu.org#26127,"CIRACAS, CIRACAS, JAKARTA TIMUR, DKI JAKARTA",184,100,142,242
https://kawalpemilu.org#26127,"CIRACAS, CIRACAS, JAKARTA TIMUR, DKI JAKARTA",185,97,138,235
https://kawalpemilu.org#26127,"CIRACAS, CIRACAS, JAKARTA TIMUR, DKI JAKARTA",186,103,163,266
https://kawalpemilu.org#26127,"CIRACAS, CIRACAS, JAKARTA TIMUR, DKI JAKARTA",187,113,144,257
https://kawalpemilu.org#26127,"CIRACAS, CIRACAS, JAKARTA TIMUR, DKI JAKARTA",188,116,159,275
https://kawalpemilu.org#26127,"CIRACAS, CIRACAS, JAKARTA TIMUR, DKI JAKARTA",190,120,125,245
https://kawalpemilu.org#26127,"CIRACAS, CIRACAS, JAKARTA TIMUR, DKI JAKARTA",191,130,99,229
https://kawalpemilu.org#26127,"CIRACAS, CIRACAS, JAKARTA TIMUR, DKI JAKARTA",192,152,90,242
https://kawalpemilu.org#26127,"CIRACAS, CIRACAS, JAKARTA TIMUR, DKI JAKARTA",193,142,91,233
https://kawalpemilu.org#26128,"CIBUBUR, CIRACAS, JAKARTA TIMUR, DKI JAKARTA",1,132,46,178
https://kawalpemilu.org#26128,"CIBUBUR, CIRACAS, JAKARTA TIMUR, DKI JAKARTA",2,109,73,182
https://kawalpemilu.org#26128,"CIBUBUR, CIRACAS, JAKARTA TIMUR, DKI JAKARTA",3,85,108,193
https://kawalpemilu.org#26128,"CIBUBUR, CIRACAS, JAKARTA TIMUR, DKI JAKARTA",4,102,120,222
https://kawalpemilu.org#26128,"CIBUBUR, CIRACAS, JAKARTA TIMUR, DKI JAKARTA",5,81,91,172
https://kawalpemilu.org#26128,"CIBUBUR, CIRACAS, JAKARTA TIMUR, DKI JAKARTA",6,123,107,230
https://kawalpemilu.org#26128,"CIBUBUR, CIRACAS, JAKARTA TIMUR, DKI JAKARTA",7,91,119,210
https://kawalpemilu.org#26128,"CIBUBUR, CIRACAS, JAKARTA TIMUR, DKI JAKARTA",9,170,64,234
https://kawalpemilu.org#26128,"CIBUBUR, CIRACAS, JAKARTA TIMUR, DKI JAKARTA",10,135,88,223
https://kawalpemilu.org#26128,"CIBUBUR, CIRACAS, JAKARTA TIMUR, DKI JAKARTA",11,148,98,246
https://kawalpemilu.org#26128,"CIBUBUR, CIRACAS, JAKARTA TIMUR, DKI JAKARTA",12,101,129,230
https://kawalpemilu.org#26128,"CIBUBUR, CIRACAS, JAKARTA TIMUR, DKI JAKARTA",13,115,82,197
https://kawalpemilu.org#26128,"CIBUBUR, CIRACAS, JAKARTA TIMUR, DKI JAKARTA",14,120,76,196
https://kawalpemilu.org#26128,"CIBUBUR, CIRACAS, JAKARTA TIMUR, DKI JAKARTA",15,99,112,211
https://kawalpemilu.org#26128,"CIBUBUR, CIRACAS, JAKARTA TIMUR, DKI JAKARTA",16,87,104,191
https://kawalpemilu.org#26128,"CIBUBUR, CIRACAS, JAKARTA TIMUR, DKI JAKARTA",17,81,93,174
https://kawalpemilu.org#26128,"CIBUBUR, CIRACAS, JAKARTA TIMUR, DKI JAKARTA",18,100,91,191
https://kawalpemilu.org#26128,"CIBUBUR, CIRACAS, JAKARTA TIMUR, DKI JAKARTA",19,140,120,260
https://kawalpemilu.org#26128,"CIBUBUR, CIRACAS, JAKARTA TIMUR, DKI JAKARTA",20,121,126,247
https://kawalpemilu.org#26128,"CIBUBUR, CIRACAS, JAKARTA TIMUR, DKI JAKARTA",21,77,99,176
https://kawalpemilu.org#26128,"CIBUBUR, CIRACAS, JAKARTA TIMUR, DKI JAKARTA",22,71,124,195
https://kawalpemilu.org#26128,"CIBUBUR, CIRACAS, JAKARTA TIMUR, DKI JAKARTA",23,94,135,229
https://kawalpemilu.org#26128,"CIBUBUR, CIRACAS, JAKARTA TIMUR, DKI JAKARTA",24,90,145,235
https://kawalpemilu.org#26128,"CIBUBUR, CIRACAS, JAKARTA TIMUR, DKI JAKARTA",25,79,92,171
https://kawalpemilu.org#26128,"CIBUBUR, CIRACAS, JAKARTA TIMUR, DKI JAKARTA",26,77,112,189
https://kawalpemilu.org#26128,"CIBUBUR, CIRACAS, JAKARTA TIMUR, DKI JAKARTA",27,61,117,178
https://kawalpemilu.org#26128,"CIBUBUR, CIRACAS, JAKARTA TIMUR, DKI JAKARTA",28,106,120,226
https://kawalpemilu.org#26128,"CIBUBUR, CIRACAS, JAKARTA TIMUR, DKI JAKARTA",29,99,80,179
https://kawalpemilu.org#26128,"CIBUBUR, CIRACAS, JAKARTA TIMUR, DKI JAKARTA",30,67,118,185
https://kawalpemilu.org#26128,"CIBUBUR, CIRACAS, JAKARTA TIMUR, DKI JAKARTA",31,102,91,193
https://kawalpemilu.org#26128,"CIBUBUR, CIRACAS, JAKARTA TIMUR, DKI JAKARTA",32,77,102,179
https://kawalpemilu.org#26128,"CIBUBUR, CIRACAS, JAKARTA TIMUR, DKI JAKARTA",33,71,127,198
https://kawalpemilu.org#26128,"CIBUBUR, CIRACAS, JAKARTA TIMUR, DKI JAKARTA",34,109,102,211
https://kawalpemilu.org#26128,"CIBUBUR, CIRACAS, JAKARTA TIMUR, DKI JAKARTA",35,75,127,202
https://kawalpemilu.org#26128,"CIBUBUR, CIRACAS, JAKARTA TIMUR, DKI JAKARTA",36,96,130,226
https://kawalpemilu.org#26128,"CIBUBUR, CIRACAS, JAKARTA TIMUR, DKI JAKARTA",37,95,138,233
https://kawalpemilu.org#26128,"CIBUBUR, CIRACAS, JAKARTA TIMUR, DKI JAKARTA",38,75,138,213
https://kawalpemilu.org#26128,"CIBUBUR, CIRACAS, JAKARTA TIMUR, DKI JAKARTA",39,149,88,237
https://kawalpemilu.org#26128,"CIBUBUR, CIRACAS, JAKARTA TIMUR, DKI JAKARTA",40,106,100,206
https://kawalpemilu.org#26128,"CIBUBUR, CIRACAS, JAKARTA TIMUR, DKI JAKARTA",41,101,104,205
https://kawalpemilu.org#26128,"CIBUBUR, CIRACAS, JAKARTA TIMUR, DKI JAKARTA",42,131,90,221
https://kawalpemilu.org#26128,"CIBUBUR, CIRACAS, JAKARTA TIMUR, DKI JAKARTA",43,129,114,243
https://kawalpemilu.org#26128,"CIBUBUR, CIRACAS, JAKARTA TIMUR, DKI JAKARTA",44,129,124,253
https://kawalpemilu.org#26128,"CIBUBUR, CIRACAS, JAKARTA TIMUR, DKI JAKARTA",45,93,139,232
https://kawalpemilu.org#26128,"CIBUBUR, CIRACAS, JAKARTA TIMUR, DKI JAKARTA",46,96,109,205
https://kawalpemilu.org#26128,"CIBUBUR, CIRACAS, JAKARTA TIMUR, DKI JAKARTA",47,67,113,180
https://kawalpemilu.org#26128,"CIBUBUR, CIRACAS, JAKARTA TIMUR, DKI JAKARTA",48,88,97,185
https://kawalpemilu.org#26128,"CIBUBUR, CIRACAS, JAKARTA TIMUR, DKI JAKARTA",49,91,81,172
https://kawalpemilu.org#26128,"CIBUBUR, CIRACAS, JAKARTA TIMUR, DKI JAKARTA",50,94,131,225
https://kawalpemilu.org#26128,"CIBUBUR, CIRACAS, JAKARTA TIMUR, DKI JAKARTA",51,125,128,253
https://kawalpemilu.org#26128,"CIBUBUR, CIRACAS, JAKARTA TIMUR, DKI JAKARTA",52,107,128,235
https://kawalpemilu.org#26128,"CIBUBUR, CIRACAS, JAKARTA TIMUR, DKI JAKARTA",53,109,133,242
https://kawalpemilu.org#26128,"CIBUBUR, CIRACAS, JAKARTA TIMUR, DKI JAKARTA",54,111,148,259
https://kawalpemilu.org#26128,"CIBUBUR, CIRACAS, JAKARTA TIMUR, DKI JAKARTA",55,105,131,236
https://kawalpemilu.org#26128,"CIBUBUR, CIRACAS, JAKARTA TIMUR, DKI JAKARTA",56,112,117,229
https://kawalpemilu.org#26128,"CIBUBUR, CIRACAS, JAKARTA TIMUR, DKI JAKARTA",57,100,137,237
https://kawalpemilu.org#26128,"CIBUBUR, CIRACAS, JAKARTA TIMUR, DKI JAKARTA",58,103,120,223
https://kawalpemilu.org#26128,"CIBUBUR, CIRACAS, JAKARTA TIMUR, DKI JAKARTA",59,92,129,221
https://kawalpemilu.org#26128,"CIBUBUR, CIRACAS, JAKARTA TIMUR, DKI JAKARTA",60,84,141,225
https://kawalpemilu.org#26128,"CIBUBUR, CIRACAS, JAKARTA TIMUR, DKI JAKARTA",61,116,82,198
https://kawalpemilu.org#26128,"CIBUBUR, CIRACAS, JAKARTA TIMUR, DKI JAKARTA",62,122,132,254
https://kawalpemilu.org#26128,"CIBUBUR, CIRACAS, JAKARTA TIMUR, DKI JAKARTA",63,106,144,250
https://kawalpemilu.org#26128,"CIBUBUR, CIRACAS, JAKARTA TIMUR, DKI JAKARTA",64,124,95,219
https://kawalpemilu.org#26128,"CIBUBUR, CIRACAS, JAKARTA TIMUR, DKI JAKARTA",65,127,119,246
https://kawalpemilu.org#26128,"CIBUBUR, CIRACAS, JAKARTA TIMUR, DKI JAKARTA",66,92,120,212
https://kawalpemilu.org#26128,"CIBUBUR, CIRACAS, JAKARTA TIMUR, DKI JAKARTA",67,85,116,201
https://kawalpemilu.org#26128,"CIBUBUR, CIRACAS, JAKARTA TIMUR, DKI JAKARTA",68,83,116,199
https://kawalpemilu.org#26128,"CIBUBUR, CIRACAS, JAKARTA TIMUR, DKI JAKARTA",69,136,119,255
https://kawalpemilu.org#26128,"CIBUBUR, CIRACAS, JAKARTA TIMUR, DKI JAKARTA",70,113,115,228
https://kawalpemilu.org#26128,"CIBUBUR, CIRACAS, JAKARTA TIMUR, DKI JAKARTA",71,112,133,245
https://kawalpemilu.org#26128,"CIBUBUR, CIRACAS, JAKARTA TIMUR, DKI JAKARTA",72,127,113,240
https://kawalpemilu.org#26128,"CIBUBUR, CIRACAS, JAKARTA TIMUR, DKI JAKARTA",73,128,134,262
https://kawalpemilu.org#26128,"CIBUBUR, CIRACAS, JAKARTA TIMUR, DKI JAKARTA",74,131,97,228
https://kawalpemilu.org#26128,"CIBUBUR, CIRACAS, JAKARTA TIMUR, DKI JAKARTA",75,173,82,255
https://kawalpemilu.org#26128,"CIBUBUR, CIRACAS, JAKARTA TIMUR, DKI JAKARTA",76,171,83,254
https://kawalpemilu.org#26128,"CIBUBUR, CIRACAS, JAKARTA TIMUR, DKI JAKARTA",77,138,135,273
https://kawalpemilu.org#26128,"CIBUBUR, CIRACAS, JAKARTA TIMUR, DKI JAKARTA",79,111,145,256
https://kawalpemilu.org#26128,"CIBUBUR, CIRACAS, JAKARTA TIMUR, DKI JAKARTA",80,115,131,246
https://kawalpemilu.org#26128,"CIBUBUR, CIRACAS, JAKARTA TIMUR, DKI JAKARTA",81,130,128,258
https://kawalpemilu.org#26128,"CIBUBUR, CIRACAS, JAKARTA TIMUR, DKI JAKARTA",83,102,108,210
https://kawalpemilu.org#26128,"CIBUBUR, CIRACAS, JAKARTA TIMUR, DKI JAKARTA",84,123,99,222
https://kawalpemilu.org#26128,"CIBUBUR, CIRACAS, JAKARTA TIMUR, DKI JAKARTA",85,91,103,194
https://kawalpemilu.org#26128,"CIBUBUR, CIRACAS, JAKARTA TIMUR, DKI JAKARTA",86,112,118,230
https://kawalpemilu.org#26128,"CIBUBUR, CIRACAS, JAKARTA TIMUR, DKI JAKARTA",87,110,115,225
https://kawalpemilu.org#26128,"CIBUBUR, CIRACAS, JAKARTA TIMUR, DKI JAKARTA",88,154,108,262
https://kawalpemilu.org#26128,"CIBUBUR, CIRACAS, JAKARTA TIMUR, DKI JAKARTA",89,148,128,276
https://kawalpemilu.org#26128,"CIBUBUR, CIRACAS, JAKARTA TIMUR, DKI JAKARTA",90,135,121,256
https://kawalpemilu.org#26128,"CIBUBUR, CIRACAS, JAKARTA TIMUR, DKI JAKARTA",91,95,148,243
https://kawalpemilu.org#26128,"CIBUBUR, CIRACAS, JAKARTA TIMUR, DKI JAKARTA",92,161,85,246
https://kawalpemilu.org#26128,"CIBUBUR, CIRACAS, JAKARTA TIMUR, DKI JAKARTA",93,137,74,211
https://kawalpemilu.org#26128,"CIBUBUR, CIRACAS, JAKARTA TIMUR, DKI JAKARTA",94,133,119,252
https://kawalpemilu.org#26128,"CIBUBUR, CIRACAS, JAKARTA TIMUR, DKI JAKARTA",95,129,115,244
https://kawalpemilu.org#26128,"CIBUBUR, CIRACAS, JAKARTA TIMUR, DKI JAKARTA",96,96,138,234
https://kawalpemilu.org#26128,"CIBUBUR, CIRACAS, JAKARTA TIMUR, DKI JAKARTA",97,111,126,237
https://kawalpemilu.org#26128,"CIBUBUR, CIRACAS, JAKARTA TIMUR, DKI JAKARTA",98,131,124,255
https://kawalpemilu.org#26128,"CIBUBUR, CIRACAS, JAKARTA TIMUR, DKI JAKARTA",99,136,106,242
https://kawalpemilu.org#26128,"CIBUBUR, CIRACAS, JAKARTA TIMUR, DKI JAKARTA",100,141,94,235
https://kawalpemilu.org#26128,"CIBUBUR, CIRACAS, JAKARTA TIMUR, DKI JAKARTA",101,129,128,257
https://kawalpemilu.org#26128,"CIBUBUR, CIRACAS, JAKARTA TIMUR, DKI JAKARTA",102,142,116,258
https://kawalpemilu.org#26128,"CIBUBUR, CIRACAS, JAKARTA TIMUR, DKI JAKARTA",103,117,119,236
https://kawalpemilu.org#26128,"CIBUBUR, CIRACAS, JAKARTA TIMUR, DKI JAKARTA",104,125,117,242
https://kawalpemilu.org#26128,"CIBUBUR, CIRACAS, JAKARTA TIMUR, DKI JAKARTA",105,99,127,226
https://kawalpemilu.org#26128,"CIBUBUR, CIRACAS, JAKARTA TIMUR, DKI JAKARTA",106,86,84,170
https://kawalpemilu.org#26128,"CIBUBUR, CIRACAS, JAKARTA TIMUR, DKI JAKARTA",107,80,82,162
https://kawalpemilu.org#26128,"CIBUBUR, CIRACAS, JAKARTA TIMUR, DKI JAKARTA",108,81,122,203
https://kawalpemilu.org#26128,"CIBUBUR, CIRACAS, JAKARTA TIMUR, DKI JAKARTA",109,114,98,212
https://kawalpemilu.org#26128,"CIBUBUR, CIRACAS, JAKARTA TIMUR, DKI JAKARTA",110,135,116,251
https://kawalpemilu.org#26128,"CIBUBUR, CIRACAS, JAKARTA TIMUR, DKI JAKARTA",111,111,111,222
https://kawalpemilu.org#26128,"CIBUBUR, CIRACAS, JAKARTA TIMUR, DKI JAKARTA",112,148,113,261
https://kawalpemilu.org#26128,"CIBUBUR, CIRACAS, JAKARTA TIMUR, DKI JAKARTA",113,126,109,235
https://kawalpemilu.org#26128,"CIBUBUR, CIRACAS, JAKARTA TIMUR, DKI JAKARTA",114,145,76,221
https://kawalpemilu.org#26128,"CIBUBUR, CIRACAS, JAKARTA TIMUR, DKI JAKARTA",115,154,65,219
https://kawalpemilu.org#26128,"CIBUBUR, CIRACAS, JAKARTA TIMUR, DKI JAKARTA",116,123,103,226
https://kawalpemilu.org#26128,"CIBUBUR, CIRACAS, JAKARTA TIMUR, DKI JAKARTA",117,107,138,245
https://kawalpemilu.org#26128,"CIBUBUR, CIRACAS, JAKARTA TIMUR, DKI JAKARTA",118,125,111,236
https://kawalpemilu.org#26128,"CIBUBUR, CIRACAS, JAKARTA TIMUR, DKI JAKARTA",119,65,111,176
https://kawalpemilu.org#26128,"CIBUBUR, CIRACAS, JAKARTA TIMUR, DKI JAKARTA",120,136,106,242
https://kawalpemilu.org#26128,"CIBUBUR, CIRACAS, JAKARTA TIMUR, DKI JAKARTA",121,145,86,231
https://kawalpemilu.org#26128,"CIBUBUR, CIRACAS, JAKARTA TIMUR, DKI JAKARTA",122,129,143,272
https://kawalpemilu.org#26128,"CIBUBUR, CIRACAS, JAKARTA TIMUR, DKI JAKARTA",123,116,124,240
https://kawalpemilu.org#26128,"CIBUBUR, CIRACAS, JAKARTA TIMUR, DKI JAKARTA",124,137,129,266
https://kawalpemilu.org#26128,"CIBUBUR, CIRACAS, JAKARTA TIMUR, DKI JAKARTA",125,105,132,237
https://kawalpemilu.org#26128,"CIBUBUR, CIRACAS, JAKARTA TIMUR, DKI JAKARTA",126,115,100,215
https://kawalpemilu.org#26128,"CIBUBUR, CIRACAS, JAKARTA TIMUR, DKI JAKARTA",127,116,128,244
https://kawalpemilu.org#26128,"CIBUBUR, CIRACAS, JAKARTA TIMUR, DKI JAKARTA",128,90,125,215
https://kawalpemilu.org#26128,"CIBUBUR, CIRACAS, JAKARTA TIMUR, DKI JAKARTA",129,116,126,242
https://kawalpemilu.org#26128,"CIBUBUR, CIRACAS, JAKARTA TIMUR, DKI JAKARTA",130,136,77,213
https://kawalpemilu.org#26128,"CIBUBUR, CIRACAS, JAKARTA TIMUR, DKI JAKARTA",131,121,95,216
https://kawalpemilu.org#26128,"CIBUBUR, CIRACAS, JAKARTA TIMUR, DKI JAKARTA",132,143,107,250
https://kawalpemilu.org#26128,"CIBUBUR, CIRACAS, JAKARTA TIMUR, DKI JAKARTA",133,110,70,180
https://kawalpemilu.org#26128,"CIBUBUR, CIRACAS, JAKARTA TIMUR, DKI JAKARTA",134,138,84,222
https://kawalpemilu.org#26128,"CIBUBUR, CIRACAS, JAKARTA TIMUR, DKI JAKARTA",135,116,75,191
https://kawalpemilu.org#26128,"CIBUBUR, CIRACAS, JAKARTA TIMUR, DKI JAKARTA",136,138,75,213
https://kawalpemilu.org#26128,"CIBUBUR, CIRACAS, JAKARTA TIMUR, DKI JAKARTA",137,114,51,165
https://kawalpemilu.org#26128,"CIBUBUR, CIRACAS, JAKARTA TIMUR, DKI JAKARTA",138,96,146,242
https://kawalpemilu.org#26128,"CIBUBUR, CIRACAS, JAKARTA TIMUR, DKI JAKARTA",139,82,113,195
https://kawalpemilu.org#26128,"CIBUBUR, CIRACAS, JAKARTA TIMUR, DKI JAKARTA",140,96,156,252
https://kawalpemilu.org#26128,"CIBUBUR, CIRACAS, JAKARTA TIMUR, DKI JAKARTA",141,80,148,228
https://kawalpemilu.org#26128,"CIBUBUR, CIRACAS, JAKARTA TIMUR, DKI JAKARTA",142,94,86,180
https://kawalpemilu.org#26128,"CIBUBUR, CIRACAS, JAKARTA TIMUR, DKI JAKARTA",143,112,121,233
https://kawalpemilu.org#26128,"CIBUBUR, CIRACAS, JAKARTA TIMUR, DKI JAKARTA",144,91,123,214
https://kawalpemilu.org#26128,"CIBUBUR, CIRACAS, JAKARTA TIMUR, DKI JAKARTA",145,74,158,232
https://kawalpemilu.org#26128,"CIBUBUR, CIRACAS, JAKARTA TIMUR, DKI JAKARTA",146,63,191,254
https://kawalpemilu.org#26128,"CIBUBUR, CIRACAS, JAKARTA TIMUR, DKI JAKARTA",147,81,184,265
https://kawalpemilu.org#26128,"CIBUBUR, CIRACAS, JAKARTA TIMUR, DKI JAKARTA",148,0,0,253
https://kawalpemilu.org#26128,"CIBUBUR, CIRACAS, JAKARTA TIMUR, DKI JAKARTA",149,52,168,220
https://kawalpemilu.org#26128,"CIBUBUR, CIRACAS, JAKARTA TIMUR, DKI JAKARTA",150,41,135,176
https://kawalpemilu.org#26128,"CIBUBUR, CIRACAS, JAKARTA TIMUR, DKI JAKARTA",151,49,197,246
https://kawalpemilu.org#26128,"CIBUBUR, CIRACAS, JAKARTA TIMUR, DKI JAKARTA",152,122,131,253
https://kawalpemilu.org#26128,"CIBUBUR, CIRACAS, JAKARTA TIMUR, DKI JAKARTA",153,118,116,234
https://kawalpemilu.org#26128,"CIBUBUR, CIRACAS, JAKARTA TIMUR, DKI JAKARTA",154,110,102,212
https://kawalpemilu.org#26128,"CIBUBUR, CIRACAS, JAKARTA TIMUR, DKI JAKARTA",155,118,128,246
https://kawalpemilu.org#26128,"CIBUBUR, CIRACAS, JAKARTA TIMUR, DKI JAKARTA",156,106,104,210
https://kawalpemilu.org#26128,"CIBUBUR, CIRACAS, JAKARTA TIMUR, DKI JAKARTA",157,108,143,251
https://kawalpemilu.org#26128,"CIBUBUR, CIRACAS, JAKARTA TIMUR, DKI JAKARTA",159,131,117,248
https://kawalpemilu.org#26128,"CIBUBUR, CIRACAS, JAKARTA TIMUR, DKI JAKARTA",160,140,88,228
https://kawalpemilu.org#26128,"CIBUBUR, CIRACAS, JAKARTA TIMUR, DKI JAKARTA",162,147,104,251
https://kawalpemilu.org#26128,"CIBUBUR, CIRACAS, JAKARTA TIMUR, DKI JAKARTA",163,122,131,253
https://kawalpemilu.org#26128,"CIBUBUR, CIRACAS, JAKARTA TIMUR, DKI JAKARTA",164,107,134,241
https://kawalpemilu.org#26128,"CIBUBUR, CIRACAS, JAKARTA TIMUR, DKI JAKARTA",165,103,149,252
https://kawalpemilu.org#26128,"CIBUBUR, CIRACAS, JAKARTA TIMUR, DKI JAKARTA",166,123,89,213
https://kawalpemilu.org#26128,"CIBUBUR, CIRACAS, JAKARTA TIMUR, DKI JAKARTA",167,126,117,243
https://kawalpemilu.org#26128,"CIBUBUR, CIRACAS, JAKARTA TIMUR, DKI JAKARTA",168,128,111,239
https://kawalpemilu.org#26128,"CIBUBUR, CIRACAS, JAKARTA TIMUR, DKI JAKARTA",169,115,113,228
https://kawalpemilu.org#26128,"CIBUBUR, CIRACAS, JAKARTA TIMUR, DKI JAKARTA",170,93,168,261
https://kawalpemilu.org#26128,"CIBUBUR, CIRACAS, JAKARTA TIMUR, DKI JAKARTA",171,119,136,255
https://kawalpemilu.org#26128,"CIBUBUR, CIRACAS, JAKARTA TIMUR, DKI JAKARTA",172,130,124,254
https://kawalpemilu.org#26128,"CIBUBUR, CIRACAS, JAKARTA TIMUR, DKI JAKARTA",173,133,132,265
https://kawalpemilu.org#26128,"CIBUBUR, CIRACAS, JAKARTA TIMUR, DKI JAKARTA",174,117,126,243
https://kawalpemilu.org#26128,"CIBUBUR, CIRACAS, JAKARTA TIMUR, DKI JAKARTA",176,119,118,237
https://kawalpemilu.org#26128,"CIBUBUR, CIRACAS, JAKARTA TIMUR, DKI JAKARTA",177,123,139,262
https://kawalpemilu.org#26128,"CIBUBUR, CIRACAS, JAKARTA TIMUR, DKI JAKARTA",178,101,130,231
https://kawalpemilu.org#26128,"CIBUBUR, CIRACAS, JAKARTA TIMUR, DKI JAKARTA",179,96,109,205
https://kawalpemilu.org#26128,"CIBUBUR, CIRACAS, JAKARTA TIMUR, DKI JAKARTA",180,123,81,204
https://kawalpemilu.org#26128,"CIBUBUR, CIRACAS, JAKARTA TIMUR, DKI JAKARTA",181,102,87,189
https://kawalpemilu.org#26128,"CIBUBUR, CIRACAS, JAKARTA TIMUR, DKI JAKARTA",182,104,110,214
https://kawalpemilu.org#26128,"CIBUBUR, CIRACAS, JAKARTA TIMUR, DKI JAKARTA",183,108,65,173
https://kawalpemilu.org#26128,"CIBUBUR, CIRACAS, JAKARTA TIMUR, DKI JAKARTA",184,102,129,231
https://kawalpemilu.org#26128,"CIBUBUR, CIRACAS, JAKARTA TIMUR, DKI JAKARTA",185,104,110,214
https://kawalpemilu.org#26128,"CIBUBUR, CIRACAS, JAKARTA TIMUR, DKI JAKARTA",186,127,122,249
https://kawalpemilu.org#26128,"CIBUBUR, CIRACAS, JAKARTA TIMUR, DKI JAKARTA",187,113,144,257
https://kawalpemilu.org#26128,"CIBUBUR, CIRACAS, JAKARTA TIMUR, DKI JAKARTA",188,103,124,227
https://kawalpemilu.org#26128,"CIBUBUR, CIRACAS, JAKARTA TIMUR, DKI JAKARTA",189,77,160,237
https://kawalpemilu.org#26128,"CIBUBUR, CIRACAS, JAKARTA TIMUR, DKI JAKARTA",190,99,129,228
https://kawalpemilu.org#26128,"CIBUBUR, CIRACAS, JAKARTA TIMUR, DKI JAKARTA",191,96,133,229
https://kawalpemilu.org#26128,"CIBUBUR, CIRACAS, JAKARTA TIMUR, DKI JAKARTA",192,139,101,240
https://kawalpemilu.org#26128,"CIBUBUR, CIRACAS, JAKARTA TIMUR, DKI JAKARTA",193,102,80,182
https://kawalpemilu.org#26128,"CIBUBUR, CIRACAS, JAKARTA TIMUR, DKI JAKARTA",194,93,100,193
https://kawalpemilu.org#26128,"CIBUBUR, CIRACAS, JAKARTA TIMUR, DKI JAKARTA",195,89,86,175
https://kawalpemilu.org#26128,"CIBUBUR, CIRACAS, JAKARTA TIMUR, DKI JAKARTA",196,120,80,200
https://kawalpemilu.org#26128,"CIBUBUR, CIRACAS, JAKARTA TIMUR, DKI JAKARTA",197,112,92,204
https://kawalpemilu.org#26128,"CIBUBUR, CIRACAS, JAKARTA TIMUR, DKI JAKARTA",198,113,102,215
https://kawalpemilu.org#26128,"CIBUBUR, CIRACAS, JAKARTA TIMUR, DKI JAKARTA",199,91,103,194
https://kawalpemilu.org#26128,"CIBUBUR, CIRACAS, JAKARTA TIMUR, DKI JAKARTA",200,108,132,240
https://kawalpemilu.org#26128,"CIBUBUR, CIRACAS, JAKARTA TIMUR, DKI JAKARTA",201,96,120,216
https://kawalpemilu.org#26128,"CIBUBUR, CIRACAS, JAKARTA TIMUR, DKI JAKARTA",202,77,152,229
https://kawalpemilu.org#26128,"CIBUBUR, CIRACAS, JAKARTA TIMUR, DKI JAKARTA",203,77,122,199
https://kawalpemilu.org#26128,"CIBUBUR, CIRACAS, JAKARTA TIMUR, DKI JAKARTA",205,82,133,215
https://kawalpemilu.org#26128,"CIBUBUR, CIRACAS, JAKARTA TIMUR, DKI JAKARTA",206,100,105,205
https://kawalpemilu.org#26128,"CIBUBUR, CIRACAS, JAKARTA TIMUR, DKI JAKARTA",207,83,108,191
https://kawalpemilu.org#26128,"CIBUBUR, CIRACAS, JAKARTA TIMUR, DKI JAKARTA",208,141,45,186
https://kawalpemilu.org#26128,"CIBUBUR, CIRACAS, JAKARTA TIMUR, DKI JAKARTA",209,95,136,231
https://kawalpemilu.org#26129,"KELAPA DUA WETAN, CIRACAS, JAKARTA TIMUR, DKI JAKARTA",1,102,140,242
https://kawalpemilu.org#26129,"KELAPA DUA WETAN, CIRACAS, JAKARTA TIMUR, DKI JAKARTA",2,124,111,235
https://kawalpemilu.org#26129,"KELAPA DUA WETAN, CIRACAS, JAKARTA TIMUR, DKI JAKARTA",3,122,104,226
https://kawalpemilu.org#26129,"KELAPA DUA WETAN, CIRACAS, JAKARTA TIMUR, DKI JAKARTA",4,126,127,253
https://kawalpemilu.org#26129,"KELAPA DUA WETAN, CIRACAS, JAKARTA TIMUR, DKI JAKARTA",5,137,132,269
https://kawalpemilu.org#26129,"KELAPA DUA WETAN, CIRACAS, JAKARTA TIMUR, DKI JAKARTA",6,102,179,281
https://kawalpemilu.org#26129,"KELAPA DUA WETAN, CIRACAS, JAKARTA TIMUR, DKI JAKARTA",7,138,107,245
https://kawalpemilu.org#26129,"KELAPA DUA WETAN, CIRACAS, JAKARTA TIMUR, DKI JAKARTA",8,144,104,248
https://kawalpemilu.org#26129,"KELAPA DUA WETAN, CIRACAS, JAKARTA TIMUR, DKI JAKARTA",9,110,126,236
https://kawalpemilu.org#26129,"KELAPA DUA WETAN, CIRACAS, JAKARTA TIMUR, DKI JAKARTA",12,135,131,266
https://kawalpemilu.org#26129,"KELAPA DUA WETAN, CIRACAS, JAKARTA TIMUR, DKI JAKARTA",13,141,85,226
https://kawalpemilu.org#26129,"KELAPA DUA WETAN, CIRACAS, JAKARTA TIMUR, DKI JAKARTA",14,156,93,249
https://kawalpemilu.org#26129,"KELAPA DUA WETAN, CIRACAS, JAKARTA TIMUR, DKI JAKARTA",15,122,85,207
https://kawalpemilu.org#26129,"KELAPA DUA WETAN, CIRACAS, JAKARTA TIMUR, DKI JAKARTA",16,101,104,205
https://kawalpemilu.org#26129,"KELAPA DUA WETAN, CIRACAS, JAKARTA TIMUR, DKI JAKARTA",17,132,122,254
https://kawalpemilu.org#26129,"KELAPA DUA WETAN, CIRACAS, JAKARTA TIMUR, DKI JAKARTA",18,141,121,262
https://kawalpemilu.org#26129,"KELAPA DUA WETAN, CIRACAS, JAKARTA TIMUR, DKI JAKARTA",19,114,126,240
https://kawalpemilu.org#26129,"KELAPA DUA WETAN, CIRACAS, JAKARTA TIMUR, DKI JAKARTA",20,131,111,242
https://kawalpemilu.org#26129,"KELAPA DUA WETAN, CIRACAS, JAKARTA TIMUR, DKI JAKARTA",21,103,105,208
https://kawalpemilu.org#26129,"KELAPA DUA WETAN, CIRACAS, JAKARTA TIMUR, DKI JAKARTA",22,75,133,208
https://kawalpemilu.org#26129,"KELAPA DUA WETAN, CIRACAS, JAKARTA TIMUR, DKI JAKARTA",23,117,107,224
https://kawalpemilu.org#26129,"KELAPA DUA WETAN, CIRACAS, JAKARTA TIMUR, DKI JAKARTA",24,104,118,222
https://kawalpemilu.org#26129,"KELAPA DUA WETAN, CIRACAS, JAKARTA TIMUR, DKI JAKARTA",25,73,128,201
https://kawalpemilu.org#26129,"KELAPA DUA WETAN, CIRACAS, JAKARTA TIMUR, DKI JAKARTA",26,83,126,209
https://kawalpemilu.org#26129,"KELAPA DUA WETAN, CIRACAS, JAKARTA TIMUR, DKI JAKARTA",27,82,90,172
https://kawalpemilu.org#26129,"KELAPA DUA WETAN, CIRACAS, JAKARTA TIMUR, DKI JAKARTA",28,68,172,240
https://kawalpemilu.org#26129,"KELAPA DUA WETAN, CIRACAS, JAKARTA TIMUR, DKI JAKARTA",29,66,108,174
https://kawalpemilu.org#26129,"KELAPA DUA WETAN, CIRACAS, JAKARTA TIMUR, DKI JAKARTA",32,96,146,242
https://kawalpemilu.org#26129,"KELAPA DUA WETAN, CIRACAS, JAKARTA TIMUR, DKI JAKARTA",33,83,142,225
https://kawalpemilu.org#26129,"KELAPA DUA WETAN, CIRACAS, JAKARTA TIMUR, DKI JAKARTA",34,89,130,219
https://kawalpemilu.org#26129,"KELAPA DUA WETAN, CIRACAS, JAKARTA TIMUR, DKI JAKARTA",36,69,177,246
https://kawalpemilu.org#26129,"KELAPA DUA WETAN, CIRACAS, JAKARTA TIMUR, DKI JAKARTA",37,130,60,190
https://kawalpemilu.org#26129,"KELAPA DUA WETAN, CIRACAS, JAKARTA TIMUR, DKI JAKARTA",38,91,93,184
https://kawalpemilu.org#26129,"KELAPA DUA WETAN, CIRACAS, JAKARTA TIMUR, DKI JAKARTA",39,113,115,228
https://kawalpemilu.org#26129,"KELAPA DUA WETAN, CIRACAS, JAKARTA TIMUR, DKI JAKARTA",40,133,137,270
https://kawalpemilu.org#26129,"KELAPA DUA WETAN, CIRACAS, JAKARTA TIMUR, DKI JAKARTA",41,112,123,235
https://kawalpemilu.org#26129,"KELAPA DUA WETAN, CIRACAS, JAKARTA TIMUR, DKI JAKARTA",42,100,97,197
https://kawalpemilu.org#26129,"KELAPA DUA WETAN, CIRACAS, JAKARTA TIMUR, DKI JAKARTA",43,162,115,277
https://kawalpemilu.org#26129,"KELAPA DUA WETAN, CIRACAS, JAKARTA TIMUR, DKI JAKARTA",46,174,82,256
https://kawalpemilu.org#26129,"KELAPA DUA WETAN, CIRACAS, JAKARTA TIMUR, DKI JAKARTA",47,142,99,241
https://kawalpemilu.org#26129,"KELAPA DUA WETAN, CIRACAS, JAKARTA TIMUR, DKI JAKARTA",48,107,75,182
https://kawalpemilu.org#26129,"KELAPA DUA WETAN, CIRACAS, JAKARTA TIMUR, DKI JAKARTA",49,123,105,228
https://kawalpemilu.org#26129,"KELAPA DUA WETAN, CIRACAS, JAKARTA TIMUR, DKI JAKARTA",50,116,93,209
https://kawalpemilu.org#26129,"KELAPA DUA WETAN, CIRACAS, JAKARTA TIMUR, DKI JAKARTA",52,212,12,224
https://kawalpemilu.org#26129,"KELAPA DUA WETAN, CIRACAS, JAKARTA TIMUR, DKI JAKARTA",53,207,14,221
https://kawalpemilu.org#26129,"KELAPA DUA WETAN, CIRACAS, JAKARTA TIMUR, DKI JAKARTA",54,161,11,172
https://kawalpemilu.org#26129,"KELAPA DUA WETAN, CIRACAS, JAKARTA TIMUR, DKI JAKARTA",56,155,24,179
https://kawalpemilu.org#26129,"KELAPA DUA WETAN, CIRACAS, JAKARTA TIMUR, DKI JAKARTA",58,168,51,219
https://kawalpemilu.org#26129,"KELAPA DUA WETAN, CIRACAS, JAKARTA TIMUR, DKI JAKARTA",59,172,24,196
https://kawalpemilu.org#26129,"KELAPA DUA WETAN, CIRACAS, JAKARTA TIMUR, DKI JAKARTA",60,150,43,193
https://kawalpemilu.org#26129,"KELAPA DUA WETAN, CIRACAS, JAKARTA TIMUR, DKI JAKARTA",61,102,140,242
https://kawalpemilu.org#26129,"KELAPA DUA WETAN, CIRACAS, JAKARTA TIMUR, DKI JAKARTA",62,117,95,212
https://kawalpemilu.org#26129,"KELAPA DUA WETAN, CIRACAS, JAKARTA TIMUR, DKI JAKARTA",63,144,79,223
https://kawalpemilu.org#26129,"KELAPA DUA WETAN, CIRACAS, JAKARTA TIMUR, DKI JAKARTA",64,147,91,238
https://kawalpemilu.org#26129,"KELAPA DUA WETAN, CIRACAS, JAKARTA TIMUR, DKI JAKARTA",65,118,75,193
https://kawalpemilu.org#26129,"KELAPA DUA WETAN, CIRACAS, JAKARTA TIMUR, DKI JAKARTA",66,126,62,188
https://kawalpemilu.org#26129,"KELAPA DUA WETAN, CIRACAS, JAKARTA TIMUR, DKI JAKARTA",67,135,93,228
https://kawalpemilu.org#26129,"KELAPA DUA WETAN, CIRACAS, JAKARTA TIMUR, DKI JAKARTA",68,121,85,206
https://kawalpemilu.org#26129,"KELAPA DUA WETAN, CIRACAS, JAKARTA TIMUR, DKI JAKARTA",69,121,85,206
https://kawalpemilu.org#26129,"KELAPA DUA WETAN, CIRACAS, JAKARTA TIMUR, DKI JAKARTA",70,144,109,253
https://kawalpemilu.org#26129,"KELAPA DUA WETAN, CIRACAS, JAKARTA TIMUR, DKI JAKARTA",71,134,81,215
https://kawalpemilu.org#26129,"KELAPA DUA WETAN, CIRACAS, JAKARTA TIMUR, DKI JAKARTA",72,151,97,248
https://kawalpemilu.org#26129,"KELAPA DUA WETAN, CIRACAS, JAKARTA TIMUR, DKI JAKARTA",73,100,119,219
https://kawalpemilu.org#26129,"KELAPA DUA WETAN, CIRACAS, JAKARTA TIMUR, DKI JAKARTA",74,105,130,235
https://kawalpemilu.org#26129,"KELAPA DUA WETAN, CIRACAS, JAKARTA TIMUR, DKI JAKARTA",75,139,125,264
https://kawalpemilu.org#26129,"KELAPA DUA WETAN, CIRACAS, JAKARTA TIMUR, DKI JAKARTA",76,131,87,218
https://kawalpemilu.org#26129,"KELAPA DUA WETAN, CIRACAS, JAKARTA TIMUR, DKI JAKARTA",77,135,117,252
https://kawalpemilu.org#26129,"KELAPA DUA WETAN, CIRACAS, JAKARTA TIMUR, DKI JAKARTA",78,144,103,247
https://kawalpemilu.org#26129,"KELAPA DUA WETAN, CIRACAS, JAKARTA TIMUR, DKI JAKARTA",79,161,77,238
https://kawalpemilu.org#26129,"KELAPA DUA WETAN, CIRACAS, JAKARTA TIMUR, DKI JAKARTA",80,121,99,220
https://kawalpemilu.org#26129,"KELAPA DUA WETAN, CIRACAS, JAKARTA TIMUR, DKI JAKARTA",81,126,112,238
https://kawalpemilu.org#26129,"KELAPA DUA WETAN, CIRACAS, JAKARTA TIMUR, DKI JAKARTA",83,99,126,225
https://kawalpemilu.org#26129,"KELAPA DUA WETAN, CIRACAS, JAKARTA TIMUR, DKI JAKARTA",84,146,102,248
https://kawalpemilu.org#26129,"KELAPA DUA WETAN, CIRACAS, JAKARTA TIMUR, DKI JAKARTA",85,128,117,245
https://kawalpemilu.org#26129,"KELAPA DUA WETAN, CIRACAS, JAKARTA TIMUR, DKI JAKARTA",86,145,105,250
https://kawalpemilu.org#26129,"KELAPA DUA WETAN, CIRACAS, JAKARTA TIMUR, DKI JAKARTA",87,137,98,235
https://kawalpemilu.org#26129,"KELAPA DUA WETAN, CIRACAS, JAKARTA TIMUR, DKI JAKARTA",88,223,19,242
https://kawalpemilu.org#26129,"KELAPA DUA WETAN, CIRACAS, JAKARTA TIMUR, DKI JAKARTA",89,104,111,215
https://kawalpemilu.org#26129,"KELAPA DUA WETAN, CIRACAS, JAKARTA TIMUR, DKI JAKARTA",90,131,121,252
https://kawalpemilu.org#26129,"KELAPA DUA WETAN, CIRACAS, JAKARTA TIMUR, DKI JAKARTA",91,132,106,238
https://kawalpemilu.org#26129,"KELAPA DUA WETAN, CIRACAS, JAKARTA TIMUR, DKI JAKARTA",92,98,93,191
https://kawalpemilu.org#26129,"KELAPA DUA WETAN, CIRACAS, JAKARTA TIMUR, DKI JAKARTA",93,102,89,191
https://kawalpemilu.org#26129,"KELAPA DUA WETAN, CIRACAS, JAKARTA TIMUR, DKI JAKARTA",94,113,108,221
https://kawalpemilu.org#26129,"KELAPA DUA WETAN, CIRACAS, JAKARTA TIMUR, DKI JAKARTA",95,111,111,222
https://kawalpemilu.org#26129,"KELAPA DUA WETAN, CIRACAS, JAKARTA TIMUR, DKI JAKARTA",96,89,90,179
https://kawalpemilu.org#26129,"KELAPA DUA WETAN, CIRACAS, JAKARTA TIMUR, DKI JAKARTA",97,89,91,180
https://kawalpemilu.org#26129,"KELAPA DUA WETAN, CIRACAS, JAKARTA TIMUR, DKI JAKARTA",98,105,118,223
https://kawalpemilu.org#26129,"KELAPA DUA WETAN, CIRACAS, JAKARTA TIMUR, DKI JAKARTA",99,109,107,216
https://kawalpemilu.org#26129,"KELAPA DUA WETAN, CIRACAS, JAKARTA TIMUR, DKI JAKARTA",100,86,132,218
https://kawalpemilu.org#26129,"KELAPA DUA WETAN, CIRACAS, JAKARTA TIMUR, DKI JAKARTA",101,93,132,225
https://kawalpemilu.org#26129,"KELAPA DUA WETAN, CIRACAS, JAKARTA TIMUR, DKI JAKARTA",103,91,97,188
https://kawalpemilu.org#26129,"KELAPA DUA WETAN, CIRACAS, JAKARTA TIMUR, DKI JAKARTA",104,143,123,266
https://kawalpemilu.org#26129,"KELAPA DUA WETAN, CIRACAS, JAKARTA TIMUR, DKI JAKARTA",105,123,133,256
https://kawalpemilu.org#26129,"KELAPA DUA WETAN, CIRACAS, JAKARTA TIMUR, DKI JAKARTA",106,82,105,187
https://kawalpemilu.org#26129,"KELAPA DUA WETAN, CIRACAS, JAKARTA TIMUR, DKI JAKARTA",107,88,97,185
https://kawalpemilu.org#26129,"KELAPA DUA WETAN, CIRACAS, JAKARTA TIMUR, DKI JAKARTA",108,79,108,187
https://kawalpemilu.org#26129,"KELAPA DUA WETAN, CIRACAS, JAKARTA TIMUR, DKI JAKARTA",109,122,111,233
https://kawalpemilu.org#26129,"KELAPA DUA WETAN, CIRACAS, JAKARTA TIMUR, DKI JAKARTA",110,121,66,187
https://kawalpemilu.org#26129,"KELAPA DUA WETAN, CIRACAS, JAKARTA TIMUR, DKI JAKARTA",111,55,120,175
https://kawalpemilu.org#26129,"KELAPA DUA WETAN, CIRACAS, JAKARTA TIMUR, DKI JAKARTA",112,62,108,170
https://kawalpemilu.org#26129,"KELAPA DUA WETAN, CIRACAS, JAKARTA TIMUR, DKI JAKARTA",113,106,77,183
https://kawalpemilu.org#26129,"KELAPA DUA WETAN, CIRACAS, JAKARTA TIMUR, DKI JAKARTA",116,223,4,227
https://kawalpemilu.org#26129,"KELAPA DUA WETAN, CIRACAS, JAKARTA TIMUR, DKI JAKARTA",117,76,108,184
https://kawalpemilu.org#26129,"KELAPA DUA WETAN, CIRACAS, JAKARTA TIMUR, DKI JAKARTA",118,81,90,171
https://kawalpemilu.org#26129,"KELAPA DUA WETAN, CIRACAS, JAKARTA TIMUR, DKI JAKARTA",119,120,67,187
https://kawalpemilu.org#26129,"KELAPA DUA WETAN, CIRACAS, JAKARTA TIMUR, DKI JAKARTA",120,114,56,170
https://kawalpemilu.org#26129,"KELAPA DUA WETAN, CIRACAS, JAKARTA TIMUR, DKI JAKARTA",121,81,102,183
https://kawalpemilu.org#26129,"KELAPA DUA WETAN, CIRACAS, JAKARTA TIMUR, DKI JAKARTA",122,119,124,243
https://kawalpemilu.org#26129,"KELAPA DUA WETAN, CIRACAS, JAKARTA TIMUR, DKI JAKARTA",123,77,109,186
https://kawalpemilu.org#26129,"KELAPA DUA WETAN, CIRACAS, JAKARTA TIMUR, DKI JAKARTA",124,122,131,253
https://kawalpemilu.org#26129,"KELAPA DUA WETAN, CIRACAS, JAKARTA TIMUR, DKI JAKARTA",125,116,114,230
https://kawalpemilu.org#26129,"KELAPA DUA WETAN, CIRACAS, JAKARTA TIMUR, DKI JAKARTA",126,110,147,4
https://kawalpemilu.org#26129,"KELAPA DUA WETAN, CIRACAS, JAKARTA TIMUR, DKI JAKARTA",127,85,186,271
https://kawalpemilu.org#26129,"KELAPA DUA WETAN, CIRACAS, JAKARTA TIMUR, DKI JAKARTA",128,81,185,266
https://kawalpemilu.org#26129,"KELAPA DUA WETAN, CIRACAS, JAKARTA TIMUR, DKI JAKARTA",129,127,108,235
https://kawalpemilu.org#26129,"KELAPA DUA WETAN, CIRACAS, JAKARTA TIMUR, DKI JAKARTA",132,97,115,212
https://kawalpemilu.org#26129,"KELAPA DUA WETAN, CIRACAS, JAKARTA TIMUR, DKI JAKARTA",134,103,101,204
https://kawalpemilu.org#26129,"KELAPA DUA WETAN, CIRACAS, JAKARTA TIMUR, DKI JAKARTA",135,109,108,217
https://kawalpemilu.org#26129,"KELAPA DUA WETAN, CIRACAS, JAKARTA TIMUR, DKI JAKARTA",136,112,109,221
https://kawalpemilu.org#26129,"KELAPA DUA WETAN, CIRACAS, JAKARTA TIMUR, DKI JAKARTA",137,90,124,214
https://kawalpemilu.org#26129,"KELAPA DUA WETAN, CIRACAS, JAKARTA TIMUR, DKI JAKARTA",138,94,106,200
https://kawalpemilu.org#26129,"KELAPA DUA WETAN, CIRACAS, JAKARTA TIMUR, DKI JAKARTA",139,116,83,199
https://kawalpemilu.org#26129,"KELAPA DUA WETAN, CIRACAS, JAKARTA TIMUR, DKI JAKARTA",140,88,109,197
https://kawalpemilu.org#26129,"KELAPA DUA WETAN, CIRACAS, JAKARTA TIMUR, DKI JAKARTA",141,105,97,202
https://kawalpemilu.org#26129,"KELAPA DUA WETAN, CIRACAS, JAKARTA TIMUR, DKI JAKARTA",142,159,97,256
https://kawalpemilu.org#26129,"KELAPA DUA WETAN, CIRACAS, JAKARTA TIMUR, DKI JAKARTA",143,123,93,216
https://kawalpemilu.org#26129,"KELAPA DUA WETAN, CIRACAS, JAKARTA TIMUR, DKI JAKARTA",144,135,107,242
https://kawalpemilu.org#26129,"KELAPA DUA WETAN, CIRACAS, JAKARTA TIMUR, DKI JAKARTA",145,129,86,215
https://kawalpemilu.org#26129,"KELAPA DUA WETAN, CIRACAS, JAKARTA TIMUR, DKI JAKARTA",146,118,126,244
https://kawalpemilu.org#26129,"KELAPA DUA WETAN, CIRACAS, JAKARTA TIMUR, DKI JAKARTA",147,104,123,227
https://kawalpemilu.org#26129,"KELAPA DUA WETAN, CIRACAS, JAKARTA TIMUR, DKI JAKARTA",148,126,96,222
https://kawalpemilu.org#26129,"KELAPA DUA WETAN, CIRACAS, JAKARTA TIMUR, DKI JAKARTA",149,120,105,225
https://kawalpemilu.org#26129,"KELAPA DUA WETAN, CIRACAS, JAKARTA TIMUR, DKI JAKARTA",150,155,96,251
https://kawalpemilu.org#26130,"SUSUKAN, CIRACAS, JAKARTA TIMUR, DKI JAKARTA",1,124,92,216
https://kawalpemilu.org#26130,"SUSUKAN, CIRACAS, JAKARTA TIMUR, DKI JAKARTA",2,66,173,239
https://kawalpemilu.org#26130,"SUSUKAN, CIRACAS, JAKARTA TIMUR, DKI JAKARTA",3,67,186,253
https://kawalpemilu.org#26130,"SUSUKAN, CIRACAS, JAKARTA TIMUR, DKI JAKARTA",4,68,170,238
https://kawalpemilu.org#26130,"SUSUKAN, CIRACAS, JAKARTA TIMUR, DKI JAKARTA",5,102,149,251
https://kawalpemilu.org#26130,"SUSUKAN, CIRACAS, JAKARTA TIMUR, DKI JAKARTA",6,78,141,219
https://kawalpemilu.org#26130,"SUSUKAN, CIRACAS, JAKARTA TIMUR, DKI JAKARTA",7,109,124,233
https://kawalpemilu.org#26130,"SUSUKAN, CIRACAS, JAKARTA TIMUR, DKI JAKARTA",8,99,146,245
https://kawalpemilu.org#26130,"SUSUKAN, CIRACAS, JAKARTA TIMUR, DKI JAKARTA",10,73,159,232
https://kawalpemilu.org#26130,"SUSUKAN, CIRACAS, JAKARTA TIMUR, DKI JAKARTA",11,113,141,254
https://kawalpemilu.org#26130,"SUSUKAN, CIRACAS, JAKARTA TIMUR, DKI JAKARTA",12,105,123,228
https://kawalpemilu.org#26130,"SUSUKAN, CIRACAS, JAKARTA TIMUR, DKI JAKARTA",13,116,148,264
https://kawalpemilu.org#26130,"SUSUKAN, CIRACAS, JAKARTA TIMUR, DKI JAKARTA",14,129,138,267
https://kawalpemilu.org#26130,"SUSUKAN, CIRACAS, JAKARTA TIMUR, DKI JAKARTA",15,71,112,183
https://kawalpemilu.org#26130,"SUSUKAN, CIRACAS, JAKARTA TIMUR, DKI JAKARTA",17,82,67,149
https://kawalpemilu.org#26130,"SUSUKAN, CIRACAS, JAKARTA TIMUR, DKI JAKARTA",18,123,116,239
https://kawalpemilu.org#26130,"SUSUKAN, CIRACAS, JAKARTA TIMUR, DKI JAKARTA",19,132,124,256
https://kawalpemilu.org#26130,"SUSUKAN, CIRACAS, JAKARTA TIMUR, DKI JAKARTA",20,147,97,244
https://kawalpemilu.org#26130,"SUSUKAN, CIRACAS, JAKARTA TIMUR, DKI JAKARTA",21,90,106,196
https://kawalpemilu.org#26130,"SUSUKAN, CIRACAS, JAKARTA TIMUR, DKI JAKARTA",22,81,128,209
https://kawalpemilu.org#26130,"SUSUKAN, CIRACAS, JAKARTA TIMUR, DKI JAKARTA",23,59,86,145
https://kawalpemilu.org#26130,"SUSUKAN, CIRACAS, JAKARTA TIMUR, DKI JAKARTA",25,97,106,203
https://kawalpemilu.org#26130,"SUSUKAN, CIRACAS, JAKARTA TIMUR, DKI JAKARTA",26,97,113,210
https://kawalpemilu.org#26130,"SUSUKAN, CIRACAS, JAKARTA TIMUR, DKI JAKARTA",27,127,156,283
https://kawalpemilu.org#26130,"SUSUKAN, CIRACAS, JAKARTA TIMUR, DKI JAKARTA",28,125,129,254
https://kawalpemilu.org#26130,"SUSUKAN, CIRACAS, JAKARTA TIMUR, DKI JAKARTA",29,119,143,262
https://kawalpemilu.org#26130,"SUSUKAN, CIRACAS, JAKARTA TIMUR, DKI JAKARTA",31,128,144,272
https://kawalpemilu.org#26130,"SUSUKAN, CIRACAS, JAKARTA TIMUR, DKI JAKARTA",32,88,131,219
https://kawalpemilu.org#26130,"SUSUKAN, CIRACAS, JAKARTA TIMUR, DKI JAKARTA",33,95,86,181
https://kawalpemilu.org#26130,"SUSUKAN, CIRACAS, JAKARTA TIMUR, DKI JAKARTA",35,90,122,212
https://kawalpemilu.org#26130,"SUSUKAN, CIRACAS, JAKARTA TIMUR, DKI JAKARTA",36,113,89,202
https://kawalpemilu.org#26130,"SUSUKAN, CIRACAS, JAKARTA TIMUR, DKI JAKARTA",37,60,98,158
https://kawalpemilu.org#26130,"SUSUKAN, CIRACAS, JAKARTA TIMUR, DKI JAKARTA",38,143,94,237
https://kawalpemilu.org#26130,"SUSUKAN, CIRACAS, JAKARTA TIMUR, DKI JAKARTA",39,91,138,229
https://kawalpemilu.org#26130,"SUSUKAN, CIRACAS, JAKARTA TIMUR, DKI JAKARTA",41,0,0,0
https://kawalpemilu.org#26130,"SUSUKAN, CIRACAS, JAKARTA TIMUR, DKI JAKARTA",42,120,81,201
https://kawalpemilu.org#26130,"SUSUKAN, CIRACAS, JAKARTA TIMUR, DKI JAKARTA",45,64,106,170
https://kawalpemilu.org#26130,"SUSUKAN, CIRACAS, JAKARTA TIMUR, DKI JAKARTA",48,120,81,201
https://kawalpemilu.org#26130,"SUSUKAN, CIRACAS, JAKARTA TIMUR, DKI JAKARTA",49,105,95,200
https://kawalpemilu.org#26130,"SUSUKAN, CIRACAS, JAKARTA TIMUR, DKI JAKARTA",50,93,154,247
https://kawalpemilu.org#26130,"SUSUKAN, CIRACAS, JAKARTA TIMUR, DKI JAKARTA",52,92,147,239
https://kawalpemilu.org#26130,"SUSUKAN, CIRACAS, JAKARTA TIMUR, DKI JAKARTA",53,108,111,219
https://kawalpemilu.org#26130,"SUSUKAN, CIRACAS, JAKARTA TIMUR, DKI JAKARTA",56,86,124,210
https://kawalpemilu.org#26130,"SUSUKAN, CIRACAS, JAKARTA TIMUR, DKI JAKARTA",57,76,117,193
https://kawalpemilu.org#26130,"SUSUKAN, CIRACAS, JAKARTA TIMUR, DKI JAKARTA",58,55,100,155
https://kawalpemilu.org#26130,"SUSUKAN, CIRACAS, JAKARTA TIMUR, DKI JAKARTA",59,98,104,202
https://kawalpemilu.org#26130,"SUSUKAN, CIRACAS, JAKARTA TIMUR, DKI JAKARTA",60,88,115,203
https://kawalpemilu.org#26130,"SUSUKAN, CIRACAS, JAKARTA TIMUR, DKI JAKARTA",61,92,168,260
https://kawalpemilu.org#26130,"SUSUKAN, CIRACAS, JAKARTA TIMUR, DKI JAKARTA",62,89,145,234
https://kawalpemilu.org#26130,"SUSUKAN, CIRACAS, JAKARTA TIMUR, DKI JAKARTA",64,105,138,243
https://kawalpemilu.org#26130,"SUSUKAN, CIRACAS, JAKARTA TIMUR, DKI JAKARTA",65,129,128,257
https://kawalpemilu.org#26130,"SUSUKAN, CIRACAS, JAKARTA TIMUR, DKI JAKARTA",66,116,127,243
https://kawalpemilu.org#26130,"SUSUKAN, CIRACAS, JAKARTA TIMUR, DKI JAKARTA",67,88,161,249
https://kawalpemilu.org#26130,"SUSUKAN, CIRACAS, JAKARTA TIMUR, DKI JAKARTA",68,87,150,237
https://kawalpemilu.org#26130,"SUSUKAN, CIRACAS, JAKARTA TIMUR, DKI JAKARTA",69,0,0,0
https://kawalpemilu.org#26130,"SUSUKAN, CIRACAS, JAKARTA TIMUR, DKI JAKARTA",73,70,98,168
https://kawalpemilu.org#26130,"SUSUKAN, CIRACAS, JAKARTA TIMUR, DKI JAKARTA",75,97,123,220
https://kawalpemilu.org#26130,"SUSUKAN, CIRACAS, JAKARTA TIMUR, DKI JAKARTA",78,90,143,233
https://kawalpemilu.org#26130,"SUSUKAN, CIRACAS, JAKARTA TIMUR, DKI JAKARTA",79,83,123,206
https://kawalpemilu.org#26130,"SUSUKAN, CIRACAS, JAKARTA TIMUR, DKI JAKARTA",80,77,125,202
https://kawalpemilu.org#26130,"SUSUKAN, CIRACAS, JAKARTA TIMUR, DKI JAKARTA",81,71,117,188
https://kawalpemilu.org#26130,"SUSUKAN, CIRACAS, JAKARTA TIMUR, DKI JAKARTA",84,83,172,255
https://kawalpemilu.org#26130,"SUSUKAN, CIRACAS, JAKARTA TIMUR, DKI JAKARTA",85,82,118,200
https://kawalpemilu.org#26130,"SUSUKAN, CIRACAS, JAKARTA TIMUR, DKI JAKARTA",87,76,150,226
https://kawalpemilu.org#26130,"SUSUKAN, CIRACAS, JAKARTA TIMUR, DKI JAKARTA",88,107,96,203
https://kawalpemilu.org#26130,"SUSUKAN, CIRACAS, JAKARTA TIMUR, DKI JAKARTA",90,116,101,217
https://kawalpemilu.org#26130,"SUSUKAN, CIRACAS, JAKARTA TIMUR, DKI JAKARTA",94,90,147,237
https://kawalpemilu.org#26130,"SUSUKAN, CIRACAS, JAKARTA TIMUR, DKI JAKARTA",95,93,141,234
https://kawalpemilu.org#26130,"SUSUKAN, CIRACAS, JAKARTA TIMUR, DKI JAKARTA",97,120,120,240
https://kawalpemilu.org#26130,"SUSUKAN, CIRACAS, JAKARTA TIMUR, DKI JAKARTA",99,101,133,234
https://kawalpemilu.org#26130,"SUSUKAN, CIRACAS, JAKARTA TIMUR, DKI JAKARTA",101,135,103,238
https://kawalpemilu.org#26130,"SUSUKAN, CIRACAS, JAKARTA TIMUR, DKI JAKARTA",102,97,128,225
https://kawalpemilu.org#26130,"SUSUKAN, CIRACAS, JAKARTA TIMUR, DKI JAKARTA",103,97,178,275
https://kawalpemilu.org#26130,"SUSUKAN, CIRACAS, JAKARTA TIMUR, DKI JAKARTA",104,105,143,248
https://kawalpemilu.org#26130,"SUSUKAN, CIRACAS, JAKARTA TIMUR, DKI JAKARTA",106,99,85,184
https://kawalpemilu.org#26130,"SUSUKAN, CIRACAS, JAKARTA TIMUR, DKI JAKARTA",108,109,103,212
https://kawalpemilu.org#26130,"SUSUKAN, CIRACAS, JAKARTA TIMUR, DKI JAKARTA",109,94,132,226
https://kawalpemilu.org#26130,"SUSUKAN, CIRACAS, JAKARTA TIMUR, DKI JAKARTA",110,130,111,241
https://kawalpemilu.org#26130,"SUSUKAN, CIRACAS, JAKARTA TIMUR, DKI JAKARTA",112,116,119,235
https://kawalpemilu.org#26130,"SUSUKAN, CIRACAS, JAKARTA TIMUR, DKI JAKARTA",113,130,99,229
https://kawalpemilu.org#26130,"SUSUKAN, CIRACAS, JAKARTA TIMUR, DKI JAKARTA",114,110,138,248
https://kawalpemilu.org#26130,"SUSUKAN, CIRACAS, JAKARTA TIMUR, DKI JAKARTA",115,96,166,262
https://kawalpemilu.org#26130,"SUSUKAN, CIRACAS, JAKARTA TIMUR, DKI JAKARTA",117,103,150,253
https://kawalpemilu.org#26130,"SUSUKAN, CIRACAS, JAKARTA TIMUR, DKI JAKARTA",118,80,142,222
https://kawalpemilu.org#26131,"RAMBUTAN, CIRACAS, JAKARTA TIMUR, DKI JAKARTA",1,146,105,251
https://kawalpemilu.org#26131,"RAMBUTAN, CIRACAS, JAKARTA TIMUR, DKI JAKARTA",2,174,77,251
https://kawalpemilu.org#26131,"RAMBUTAN, CIRACAS, JAKARTA TIMUR, DKI JAKARTA",3,136,96,232
https://kawalpemilu.org#26131,"RAMBUTAN, CIRACAS, JAKARTA TIMUR, DKI JAKARTA",4,150,81,231
https://kawalpemilu.org#26131,"RAMBUTAN, CIRACAS, JAKARTA TIMUR, DKI JAKARTA",5,154,111,265
https://kawalpemilu.org#26131,"RAMBUTAN, CIRACAS, JAKARTA TIMUR, DKI JAKARTA",6,164,93,257
https://kawalpemilu.org#26131,"RAMBUTAN, CIRACAS, JAKARTA TIMUR, DKI JAKARTA",7,127,84,211
https://kawalpemilu.org#26131,"RAMBUTAN, CIRACAS, JAKARTA TIMUR, DKI JAKARTA",8,71,184,255
https://kawalpemilu.org#26131,"RAMBUTAN, CIRACAS, JAKARTA TIMUR, DKI JAKARTA",9,49,160,209
https://kawalpemilu.org#26131,"RAMBUTAN, CIRACAS, JAKARTA TIMUR, DKI JAKARTA",10,70,155,225
https://kawalpemilu.org#26131,"RAMBUTAN, CIRACAS, JAKARTA TIMUR, DKI JAKARTA",11,70,126,196
https://kawalpemilu.org#26131,"RAMBUTAN, CIRACAS, JAKARTA TIMUR, DKI JAKARTA",12,61,180,241
https://kawalpemilu.org#26131,"RAMBUTAN, CIRACAS, JAKARTA TIMUR, DKI JAKARTA",13,72,145,217
https://kawalpemilu.org#26131,"RAMBUTAN, CIRACAS, JAKARTA TIMUR, DKI JAKARTA",14,102,147,249
https://kawalpemilu.org#26131,"RAMBUTAN, CIRACAS, JAKARTA TIMUR, DKI JAKARTA",15,88,155,243
https://kawalpemilu.org#26131,"RAMBUTAN, CIRACAS, JAKARTA TIMUR, DKI JAKARTA",16,89,143,232
https://kawalpemilu.org#26131,"RAMBUTAN, CIRACAS, JAKARTA TIMUR, DKI JAKARTA",17,97,148,245
https://kawalpemilu.org#26131,"RAMBUTAN, CIRACAS, JAKARTA TIMUR, DKI JAKARTA",18,74,171,245
https://kawalpemilu.org#26131,"RAMBUTAN, CIRACAS, JAKARTA TIMUR, DKI JAKARTA",19,65,142,207
https://kawalpemilu.org#26131,"RAMBUTAN, CIRACAS, JAKARTA TIMUR, DKI JAKARTA",20,103,162,265
https://kawalpemilu.org#26131,"RAMBUTAN, CIRACAS, JAKARTA TIMUR, DKI JAKARTA",21,94,138,232
https://kawalpemilu.org#26131,"RAMBUTAN, CIRACAS, JAKARTA TIMUR, DKI JAKARTA",22,85,168,253
https://kawalpemilu.org#26131,"RAMBUTAN, CIRACAS, JAKARTA TIMUR, DKI JAKARTA",23,93,142,235
https://kawalpemilu.org#26131,"RAMBUTAN, CIRACAS, JAKARTA TIMUR, DKI JAKARTA",24,81,149,230
https://kawalpemilu.org#26131,"RAMBUTAN, CIRACAS, JAKARTA TIMUR, DKI JAKARTA",25,102,143,245
https://kawalpemilu.org#26131,"RAMBUTAN, CIRACAS, JAKARTA TIMUR, DKI JAKARTA",26,59,167,226
https://kawalpemilu.org#26131,"RAMBUTAN, CIRACAS, JAKARTA TIMUR, DKI JAKARTA",27,78,144,222
https://kawalpemilu.org#26131,"RAMBUTAN, CIRACAS, JAKARTA TIMUR, DKI JAKARTA",28,82,160,242
https://kawalpemilu.org#26131,"RAMBUTAN, CIRACAS, JAKARTA TIMUR, DKI JAKARTA",29,77,153,230
https://kawalpemilu.org#26131,"RAMBUTAN, CIRACAS, JAKARTA TIMUR, DKI JAKARTA",30,96,126,222
https://kawalpemilu.org#26131,"RAMBUTAN, CIRACAS, JAKARTA TIMUR, DKI JAKARTA",31,125,118,243
https://kawalpemilu.org#26131,"RAMBUTAN, CIRACAS, JAKARTA TIMUR, DKI JAKARTA",32,58,106,164
https://kawalpemilu.org#26131,"RAMBUTAN, CIRACAS, JAKARTA TIMUR, DKI JAKARTA",34,64,141,205
https://kawalpemilu.org#26131,"RAMBUTAN, CIRACAS, JAKARTA TIMUR, DKI JAKARTA",35,79,129,208
https://kawalpemilu.org#26131,"RAMBUTAN, CIRACAS, JAKARTA TIMUR, DKI JAKARTA",36,76,108,184
https://kawalpemilu.org#26131,"RAMBUTAN, CIRACAS, JAKARTA TIMUR, DKI JAKARTA",37,70,89,159
https://kawalpemilu.org#26131,"RAMBUTAN, CIRACAS, JAKARTA TIMUR, DKI JAKARTA",38,149,107,256
https://kawalpemilu.org#26131,"RAMBUTAN, CIRACAS, JAKARTA TIMUR, DKI JAKARTA",39,118,106,224
https://kawalpemilu.org#26131,"RAMBUTAN, CIRACAS, JAKARTA TIMUR, DKI JAKARTA",40,113,92,205
https://kawalpemilu.org#26131,"RAMBUTAN, CIRACAS, JAKARTA TIMUR, DKI JAKARTA",41,151,63,214
https://kawalpemilu.org#26131,"RAMBUTAN, CIRACAS, JAKARTA TIMUR, DKI JAKARTA",42,106,128,234
https://kawalpemilu.org#26131,"RAMBUTAN, CIRACAS, JAKARTA TIMUR, DKI JAKARTA",43,108,141,249
https://kawalpemilu.org#26131,"RAMBUTAN, CIRACAS, JAKARTA TIMUR, DKI JAKARTA",44,96,135,231
https://kawalpemilu.org#26131,"RAMBUTAN, CIRACAS, JAKARTA TIMUR, DKI JAKARTA",45,99,148,247
https://kawalpemilu.org#26131,"RAMBUTAN, CIRACAS, JAKARTA TIMUR, DKI JAKARTA",46,95,137,232
https://kawalpemilu.org#26131,"RAMBUTAN, CIRACAS, JAKARTA TIMUR, DKI JAKARTA",47,83,170,253
https://kawalpemilu.org#26131,"RAMBUTAN, CIRACAS, JAKARTA TIMUR, DKI JAKARTA",48,86,91,177
https://kawalpemilu.org#26131,"RAMBUTAN, CIRACAS, JAKARTA TIMUR, DKI JAKARTA",49,87,105,192
https://kawalpemilu.org#26131,"RAMBUTAN, CIRACAS, JAKARTA TIMUR, DKI JAKARTA",50,87,154,241
https://kawalpemilu.org#26131,"RAMBUTAN, CIRACAS, JAKARTA TIMUR, DKI JAKARTA",51,100,137,237
https://kawalpemilu.org#26131,"RAMBUTAN, CIRACAS, JAKARTA TIMUR, DKI JAKARTA",52,83,157,240
https://kawalpemilu.org#26131,"RAMBUTAN, CIRACAS, JAKARTA TIMUR, DKI JAKARTA",53,93,137,230
https://kawalpemilu.org#26131,"RAMBUTAN, CIRACAS, JAKARTA TIMUR, DKI JAKARTA",54,91,144,235
https://kawalpemilu.org#26131,"RAMBUTAN, CIRACAS, JAKARTA TIMUR, DKI JAKARTA",55,131,123,254
https://kawalpemilu.org#26131,"RAMBUTAN, CIRACAS, JAKARTA TIMUR, DKI JAKARTA",56,121,133,254
https://kawalpemilu.org#26131,"RAMBUTAN, CIRACAS, JAKARTA TIMUR, DKI JAKARTA",57,124,100,224
https://kawalpemilu.org#26131,"RAMBUTAN, CIRACAS, JAKARTA TIMUR, DKI JAKARTA",58,117,124,241
https://kawalpemilu.org#26131,"RAMBUTAN, CIRACAS, JAKARTA TIMUR, DKI JAKARTA",59,70,166,236
https://kawalpemilu.org#26131,"RAMBUTAN, CIRACAS, JAKARTA TIMUR, DKI JAKARTA",60,79,163,242
https://kawalpemilu.org#26131,"RAMBUTAN, CIRACAS, JAKARTA TIMUR, DKI JAKARTA",61,91,146,237
https://kawalpemilu.org#26131,"RAMBUTAN, CIRACAS, JAKARTA TIMUR, DKI JAKARTA",62,115,125,240
https://kawalpemilu.org#26131,"RAMBUTAN, CIRACAS, JAKARTA TIMUR, DKI JAKARTA",63,136,109,245
https://kawalpemilu.org#26131,"RAMBUTAN, CIRACAS, JAKARTA TIMUR, DKI JAKARTA",64,102,118,220
https://kawalpemilu.org#26131,"RAMBUTAN, CIRACAS, JAKARTA TIMUR, DKI JAKARTA",65,120,120,240
https://kawalpemilu.org#26131,"RAMBUTAN, CIRACAS, JAKARTA TIMUR, DKI JAKARTA",66,106,109,215
https://kawalpemilu.org#26131,"RAMBUTAN, CIRACAS, JAKARTA TIMUR, DKI JAKARTA",68,134,81,215
https://kawalpemilu.org#26131,"RAMBUTAN, CIRACAS, JAKARTA TIMUR, DKI JAKARTA",69,99,153,252
https://kawalpemilu.org#26131,"RAMBUTAN, CIRACAS, JAKARTA TIMUR, DKI JAKARTA",70,89,141,230
https://kawalpemilu.org#26131,"RAMBUTAN, CIRACAS, JAKARTA TIMUR, DKI JAKARTA",71,120,121,241
https://kawalpemilu.org#26131,"RAMBUTAN, CIRACAS, JAKARTA TIMUR, DKI JAKARTA",72,91,128,219
https://kawalpemilu.org#26131,"RAMBUTAN, CIRACAS, JAKARTA TIMUR, DKI JAKARTA",73,106,115,221
https://kawalpemilu.org#26131,"RAMBUTAN, CIRACAS, JAKARTA TIMUR, DKI JAKARTA",76,95,145,240
https://kawalpemilu.org#26131,"RAMBUTAN, CIRACAS, JAKARTA TIMUR, DKI JAKARTA",77,128,130,258
https://kawalpemilu.org#26131,"RAMBUTAN, CIRACAS, JAKARTA TIMUR, DKI JAKARTA",78,99,158,257
https://kawalpemilu.org#26131,"RAMBUTAN, CIRACAS, JAKARTA TIMUR, DKI JAKARTA",79,103,143,246
https://kawalpemilu.org#26131,"RAMBUTAN, CIRACAS, JAKARTA TIMUR, DKI JAKARTA",80,89,113,202
https://kawalpemilu.org#26131,"RAMBUTAN, CIRACAS, JAKARTA TIMUR, DKI JAKARTA",81,105,141,246
https://kawalpemilu.org#26131,"RAMBUTAN, CIRACAS, JAKARTA TIMUR, DKI JAKARTA",83,119,81,200
https://kawalpemilu.org#26131,"RAMBUTAN, CIRACAS, JAKARTA TIMUR, DKI JAKARTA",85,124,125,249
https://kawalpemilu.org#26131,"RAMBUTAN, CIRACAS, JAKARTA TIMUR, DKI JAKARTA",86,102,140,242
https://kawalpemilu.org#26131,"RAMBUTAN, CIRACAS, JAKARTA TIMUR, DKI JAKARTA",87,91,148,239
https://kawalpemilu.org#26131,"RAMBUTAN, CIRACAS, JAKARTA TIMUR, DKI JAKARTA",88,88,155,243
https://kawalpemilu.org#26131,"RAMBUTAN, CIRACAS, JAKARTA TIMUR, DKI JAKARTA",89,105,137,242
https://kawalpemilu.org#26131,"RAMBUTAN, CIRACAS, JAKARTA TIMUR, DKI JAKARTA",90,103,135,238
https://kawalpemilu.org#26131,"RAMBUTAN, CIRACAS, JAKARTA TIMUR, DKI JAKARTA",92,63,164,227
https://kawalpemilu.org#26131,"RAMBUTAN, CIRACAS, JAKARTA TIMUR, DKI JAKARTA",93,78,146,224
https://kawalpemilu.org#26131,"RAMBUTAN, CIRACAS, JAKARTA TIMUR, DKI JAKARTA",94,139,97,236
https://kawalpemilu.org#26131,"RAMBUTAN, CIRACAS, JAKARTA TIMUR, DKI JAKARTA",95,109,98,207
https://kawalpemilu.org#26131,"RAMBUTAN, CIRACAS, JAKARTA TIMUR, DKI JAKARTA",96,95,176,271
https://kawalpemilu.org#26131,"RAMBUTAN, CIRACAS, JAKARTA TIMUR, DKI JAKARTA",97,97,156,253
https://kawalpemilu.org#26131,"RAMBUTAN, CIRACAS, JAKARTA TIMUR, DKI JAKARTA",99,120,120,240
https://kawalpemilu.org#26131,"RAMBUTAN, CIRACAS, JAKARTA TIMUR, DKI JAKARTA",100,140,107,247
https://kawalpemilu.org#26131,"RAMBUTAN, CIRACAS, JAKARTA TIMUR, DKI JAKARTA",101,118,106,224
https://kawalpemilu.org#26131,"RAMBUTAN, CIRACAS, JAKARTA TIMUR, DKI JAKARTA",102,113,159,272
https://kawalpemilu.org#26131,"RAMBUTAN, CIRACAS, JAKARTA TIMUR, DKI JAKARTA",103,103,135,238
https://kawalpemilu.org#26131,"RAMBUTAN, CIRACAS, JAKARTA TIMUR, DKI JAKARTA",105,122,117,239
https://kawalpemilu.org#26131,"RAMBUTAN, CIRACAS, JAKARTA TIMUR, DKI JAKARTA",106,117,114,231
https://kawalpemilu.org#26131,"RAMBUTAN, CIRACAS, JAKARTA TIMUR, DKI JAKARTA",107,116,121,237
https://kawalpemilu.org#26131,"RAMBUTAN, CIRACAS, JAKARTA TIMUR, DKI JAKARTA",108,107,115,222
https://kawalpemilu.org#26131,"RAMBUTAN, CIRACAS, JAKARTA TIMUR, DKI JAKARTA",110,59,126,185
https://kawalpemilu.org#26131,"RAMBUTAN, CIRACAS, JAKARTA TIMUR, DKI JAKARTA",111,87,96,183
https://kawalpemilu.org#26131,"RAMBUTAN, CIRACAS, JAKARTA TIMUR, DKI JAKARTA",112,70,99,169
https://kawalpemilu.org#26133,"CIPAYUNG, CIPAYUNG, JAKARTA TIMUR, DKI JAKARTA",1,108,141,249
https://kawalpemilu.org#26133,"CIPAYUNG, CIPAYUNG, JAKARTA TIMUR, DKI JAKARTA",2,122,77,199
https://kawalpemilu.org#26133,"CIPAYUNG, CIPAYUNG, JAKARTA TIMUR, DKI JAKARTA",3,144,93,237
https://kawalpemilu.org#26133,"CIPAYUNG, CIPAYUNG, JAKARTA TIMUR, DKI JAKARTA",4,151,124,275
https://kawalpemilu.org#26133,"CIPAYUNG, CIPAYUNG, JAKARTA TIMUR, DKI JAKARTA",5,157,74,231
https://kawalpemilu.org#26133,"CIPAYUNG, CIPAYUNG, JAKARTA TIMUR, DKI JAKARTA",6,139,90,229
https://kawalpemilu.org#26133,"CIPAYUNG, CIPAYUNG, JAKARTA TIMUR, DKI JAKARTA",7,145,120,265
https://kawalpemilu.org#26133,"CIPAYUNG, CIPAYUNG, JAKARTA TIMUR, DKI JAKARTA",8,203,47,250
https://kawalpemilu.org#26133,"CIPAYUNG, CIPAYUNG, JAKARTA TIMUR, DKI JAKARTA",9,151,131,282
https://kawalpemilu.org#26133,"CIPAYUNG, CIPAYUNG, JAKARTA TIMUR, DKI JAKARTA",10,132,100,232
https://kawalpemilu.org#26133,"CIPAYUNG, CIPAYUNG, JAKARTA TIMUR, DKI JAKARTA",11,129,100,229
https://kawalpemilu.org#26133,"CIPAYUNG, CIPAYUNG, JAKARTA TIMUR, DKI JAKARTA",12,116,81,197
https://kawalpemilu.org#26133,"CIPAYUNG, CIPAYUNG, JAKARTA TIMUR, DKI JAKARTA",13,102,123,225
https://kawalpemilu.org#26133,"CIPAYUNG, CIPAYUNG, JAKARTA TIMUR, DKI JAKARTA",14,128,124,252
https://kawalpemilu.org#26133,"CIPAYUNG, CIPAYUNG, JAKARTA TIMUR, DKI JAKARTA",15,94,100,194
https://kawalpemilu.org#26133,"CIPAYUNG, CIPAYUNG, JAKARTA TIMUR, DKI JAKARTA",16,108,88,196
https://kawalpemilu.org#26133,"CIPAYUNG, CIPAYUNG, JAKARTA TIMUR, DKI JAKARTA",17,94,97,191
https://kawalpemilu.org#26133,"CIPAYUNG, CIPAYUNG, JAKARTA TIMUR, DKI JAKARTA",18,100,77,177
https://kawalpemilu.org#26133,"CIPAYUNG, CIPAYUNG, JAKARTA TIMUR, DKI JAKARTA",19,109,69,178
https://kawalpemilu.org#26133,"CIPAYUNG, CIPAYUNG, JAKARTA TIMUR, DKI JAKARTA",20,112,124,236
https://kawalpemilu.org#26133,"CIPAYUNG, CIPAYUNG, JAKARTA TIMUR, DKI JAKARTA",21,94,103,197
https://kawalpemilu.org#26133,"CIPAYUNG, CIPAYUNG, JAKARTA TIMUR, DKI JAKARTA",22,124,137,261
https://kawalpemilu.org#26133,"CIPAYUNG, CIPAYUNG, JAKARTA TIMUR, DKI JAKARTA",23,123,94,217
https://kawalpemilu.org#26133,"CIPAYUNG, CIPAYUNG, JAKARTA TIMUR, DKI JAKARTA",24,130,86,216
https://kawalpemilu.org#26133,"CIPAYUNG, CIPAYUNG, JAKARTA TIMUR, DKI JAKARTA",25,126,101,227
https://kawalpemilu.org#26133,"CIPAYUNG, CIPAYUNG, JAKARTA TIMUR, DKI JAKARTA",26,137,107,244
https://kawalpemilu.org#26133,"CIPAYUNG, CIPAYUNG, JAKARTA TIMUR, DKI JAKARTA",27,117,118,235
https://kawalpemilu.org#26133,"CIPAYUNG, CIPAYUNG, JAKARTA TIMUR, DKI JAKARTA",28,133,121,254
https://kawalpemilu.org#26133,"CIPAYUNG, CIPAYUNG, JAKARTA TIMUR, DKI JAKARTA",29,113,105,218
https://kawalpemilu.org#26133,"CIPAYUNG, CIPAYUNG, JAKARTA TIMUR, DKI JAKARTA",30,122,50,172
https://kawalpemilu.org#26133,"CIPAYUNG, CIPAYUNG, JAKARTA TIMUR, DKI JAKARTA",31,98,141,239
https://kawalpemilu.org#26133,"CIPAYUNG, CIPAYUNG, JAKARTA TIMUR, DKI JAKARTA",32,138,109,247
https://kawalpemilu.org#26133,"CIPAYUNG, CIPAYUNG, JAKARTA TIMUR, DKI JAKARTA",33,136,111,247
https://kawalpemilu.org#26133,"CIPAYUNG, CIPAYUNG, JAKARTA TIMUR, DKI JAKARTA",34,144,78,222
https://kawalpemilu.org#26133,"CIPAYUNG, CIPAYUNG, JAKARTA TIMUR, DKI JAKARTA",35,130,82,212
https://kawalpemilu.org#26133,"CIPAYUNG, CIPAYUNG, JAKARTA TIMUR, DKI JAKARTA",36,137,90,227
https://kawalpemilu.org#26133,"CIPAYUNG, CIPAYUNG, JAKARTA TIMUR, DKI JAKARTA",37,159,60,219
https://kawalpemilu.org#26133,"CIPAYUNG, CIPAYUNG, JAKARTA TIMUR, DKI JAKARTA",38,114,143,257
https://kawalpemilu.org#26133,"CIPAYUNG, CIPAYUNG, JAKARTA TIMUR, DKI JAKARTA",39,146,109,255
https://kawalpemilu.org#26133,"CIPAYUNG, CIPAYUNG, JAKARTA TIMUR, DKI JAKARTA",40,180,62,242
https://kawalpemilu.org#26133,"CIPAYUNG, CIPAYUNG, JAKARTA TIMUR, DKI JAKARTA",42,83,138,221
https://kawalpemilu.org#26133,"CIPAYUNG, CIPAYUNG, JAKARTA TIMUR, DKI JAKARTA",43,90,155,245
https://kawalpemilu.org#26133,"CIPAYUNG, CIPAYUNG, JAKARTA TIMUR, DKI JAKARTA",44,167,61,228
https://kawalpemilu.org#26133,"CIPAYUNG, CIPAYUNG, JAKARTA TIMUR, DKI JAKARTA",45,179,51,230
https://kawalpemilu.org#26133,"CIPAYUNG, CIPAYUNG, JAKARTA TIMUR, DKI JAKARTA",46,169,55,224
https://kawalpemilu.org#26133,"CIPAYUNG, CIPAYUNG, JAKARTA TIMUR, DKI JAKARTA",47,94,154,248
https://kawalpemilu.org#26133,"CIPAYUNG, CIPAYUNG, JAKARTA TIMUR, DKI JAKARTA",48,105,138,243
https://kawalpemilu.org#26133,"CIPAYUNG, CIPAYUNG, JAKARTA TIMUR, DKI JAKARTA",49,107,139,246
https://kawalpemilu.org#26133,"CIPAYUNG, CIPAYUNG, JAKARTA TIMUR, DKI JAKARTA",50,94,115,209
https://kawalpemilu.org#26133,"CIPAYUNG, CIPAYUNG, JAKARTA TIMUR, DKI JAKARTA",51,113,109,222
https://kawalpemilu.org#26133,"CIPAYUNG, CIPAYUNG, JAKARTA TIMUR, DKI JAKARTA",52,134,81,215
https://kawalpemilu.org#26133,"CIPAYUNG, CIPAYUNG, JAKARTA TIMUR, DKI JAKARTA",53,137,139,276
https://kawalpemilu.org#26133,"CIPAYUNG, CIPAYUNG, JAKARTA TIMUR, DKI JAKARTA",54,114,122,236
https://kawalpemilu.org#26133,"CIPAYUNG, CIPAYUNG, JAKARTA TIMUR, DKI JAKARTA",55,116,116,232
https://kawalpemilu.org#26133,"CIPAYUNG, CIPAYUNG, JAKARTA TIMUR, DKI JAKARTA",56,88,124,212
https://kawalpemilu.org#26133,"CIPAYUNG, CIPAYUNG, JAKARTA TIMUR, DKI JAKARTA",57,73,133,206
https://kawalpemilu.org#26133,"CIPAYUNG, CIPAYUNG, JAKARTA TIMUR, DKI JAKARTA",58,103,132,235
https://kawalpemilu.org#26133,"CIPAYUNG, CIPAYUNG, JAKARTA TIMUR, DKI JAKARTA",59,115,105,220
https://kawalpemilu.org#26133,"CIPAYUNG, CIPAYUNG, JAKARTA TIMUR, DKI JAKARTA",60,128,105,233
https://kawalpemilu.org#26133,"CIPAYUNG, CIPAYUNG, JAKARTA TIMUR, DKI JAKARTA",61,111,127,238
https://kawalpemilu.org#26133,"CIPAYUNG, CIPAYUNG, JAKARTA TIMUR, DKI JAKARTA",62,119,112,231
https://kawalpemilu.org#26133,"CIPAYUNG, CIPAYUNG, JAKARTA TIMUR, DKI JAKARTA",63,87,159,246
https://kawalpemilu.org#26133,"CIPAYUNG, CIPAYUNG, JAKARTA TIMUR, DKI JAKARTA",65,97,129,226
https://kawalpemilu.org#26133,"CIPAYUNG, CIPAYUNG, JAKARTA TIMUR, DKI JAKARTA",66,134,129,263
https://kawalpemilu.org#26133,"CIPAYUNG, CIPAYUNG, JAKARTA TIMUR, DKI JAKARTA",67,168,87,255
https://kawalpemilu.org#26133,"CIPAYUNG, CIPAYUNG, JAKARTA TIMUR, DKI JAKARTA",68,169,80,249
https://kawalpemilu.org#26133,"CIPAYUNG, CIPAYUNG, JAKARTA TIMUR, DKI JAKARTA",69,46,113,159
https://kawalpemilu.org#26133,"CIPAYUNG, CIPAYUNG, JAKARTA TIMUR, DKI JAKARTA",70,89,161,250
https://kawalpemilu.org#26133,"CIPAYUNG, CIPAYUNG, JAKARTA TIMUR, DKI JAKARTA",71,117,119,236
https://kawalpemilu.org#26133,"CIPAYUNG, CIPAYUNG, JAKARTA TIMUR, DKI JAKARTA",72,95,157,252
https://kawalpemilu.org#26133,"CIPAYUNG, CIPAYUNG, JAKARTA TIMUR, DKI JAKARTA",73,131,126,257
https://kawalpemilu.org#26133,"CIPAYUNG, CIPAYUNG, JAKARTA TIMUR, DKI JAKARTA",74,130,103,233
https://kawalpemilu.org#26133,"CIPAYUNG, CIPAYUNG, JAKARTA TIMUR, DKI JAKARTA",75,120,153,273
https://kawalpemilu.org#26133,"CIPAYUNG, CIPAYUNG, JAKARTA TIMUR, DKI JAKARTA",76,131,141,272
https://kawalpemilu.org#26133,"CIPAYUNG, CIPAYUNG, JAKARTA TIMUR, DKI JAKARTA",77,65,38,103
https://kawalpemilu.org#26133,"CIPAYUNG, CIPAYUNG, JAKARTA TIMUR, DKI JAKARTA",78,64,54,118
https://kawalpemilu.org#26133,"CIPAYUNG, CIPAYUNG, JAKARTA TIMUR, DKI JAKARTA",79,61,55,116
https://kawalpemilu.org#26133,"CIPAYUNG, CIPAYUNG, JAKARTA TIMUR, DKI JAKARTA",80,76,54,130
https://kawalpemilu.org#26133,"CIPAYUNG, CIPAYUNG, JAKARTA TIMUR, DKI JAKARTA",81,142,78,220
https://kawalpemilu.org#26133,"CIPAYUNG, CIPAYUNG, JAKARTA TIMUR, DKI JAKARTA",82,99,56,155
https://kawalpemilu.org#26133,"CIPAYUNG, CIPAYUNG, JAKARTA TIMUR, DKI JAKARTA",83,119,102,221
https://kawalpemilu.org#26134,"CILANGKAP, CIPAYUNG, JAKARTA TIMUR, DKI JAKARTA",1,90,148,238
https://kawalpemilu.org#26134,"CILANGKAP, CIPAYUNG, JAKARTA TIMUR, DKI JAKARTA",2,96,102,198
https://kawalpemilu.org#26134,"CILANGKAP, CIPAYUNG, JAKARTA TIMUR, DKI JAKARTA",3,63,104,167
https://kawalpemilu.org#26134,"CILANGKAP, CIPAYUNG, JAKARTA TIMUR, DKI JAKARTA",4,72,161,233
https://kawalpemilu.org#26134,"CILANGKAP, CIPAYUNG, JAKARTA TIMUR, DKI JAKARTA",5,105,131,236
https://kawalpemilu.org#26134,"CILANGKAP, CIPAYUNG, JAKARTA TIMUR, DKI JAKARTA",6,95,131,226
https://kawalpemilu.org#26134,"CILANGKAP, CIPAYUNG, JAKARTA TIMUR, DKI JAKARTA",7,92,100,192
https://kawalpemilu.org#26134,"CILANGKAP, CIPAYUNG, JAKARTA TIMUR, DKI JAKARTA",8,94,87,181
https://kawalpemilu.org#26134,"CILANGKAP, CIPAYUNG, JAKARTA TIMUR, DKI JAKARTA",9,72,176,248
https://kawalpemilu.org#26134,"CILANGKAP, CIPAYUNG, JAKARTA TIMUR, DKI JAKARTA",10,102,120,222
https://kawalpemilu.org#26134,"CILANGKAP, CIPAYUNG, JAKARTA TIMUR, DKI JAKARTA",11,100,154,254
https://kawalpemilu.org#26134,"CILANGKAP, CIPAYUNG, JAKARTA TIMUR, DKI JAKARTA",12,75,86,161
https://kawalpemilu.org#26134,"CILANGKAP, CIPAYUNG, JAKARTA TIMUR, DKI JAKARTA",13,110,119,229
https://kawalpemilu.org#26134,"CILANGKAP, CIPAYUNG, JAKARTA TIMUR, DKI JAKARTA",14,105,111,216
https://kawalpemilu.org#26134,"CILANGKAP, CIPAYUNG, JAKARTA TIMUR, DKI JAKARTA",15,192,34,226
https://kawalpemilu.org#26134,"CILANGKAP, CIPAYUNG, JAKARTA TIMUR, DKI JAKARTA",16,118,108,226
https://kawalpemilu.org#26134,"CILANGKAP, CIPAYUNG, JAKARTA TIMUR, DKI JAKARTA",17,147,91,238
https://kawalpemilu.org#26134,"CILANGKAP, CIPAYUNG, JAKARTA TIMUR, DKI JAKARTA",18,78,139,217
https://kawalpemilu.org#26134,"CILANGKAP, CIPAYUNG, JAKARTA TIMUR, DKI JAKARTA",19,89,109,198
https://kawalpemilu.org#26134,"CILANGKAP, CIPAYUNG, JAKARTA TIMUR, DKI JAKARTA",20,86,148,234
https://kawalpemilu.org#26134,"CILANGKAP, CIPAYUNG, JAKARTA TIMUR, DKI JAKARTA",21,132,100,232
https://kawalpemilu.org#26134,"CILANGKAP, CIPAYUNG, JAKARTA TIMUR, DKI JAKARTA",22,111,127,238
https://kawalpemilu.org#26134,"CILANGKAP, CIPAYUNG, JAKARTA TIMUR, DKI JAKARTA",23,159,59,218
https://kawalpemilu.org#26134,"CILANGKAP, CIPAYUNG, JAKARTA TIMUR, DKI JAKARTA",24,88,158,246
https://kawalpemilu.org#26134,"CILANGKAP, CIPAYUNG, JAKARTA TIMUR, DKI JAKARTA",25,116,75,191
https://kawalpemilu.org#26134,"CILANGKAP, CIPAYUNG, JAKARTA TIMUR, DKI JAKARTA",26,81,131,212
https://kawalpemilu.org#26134,"CILANGKAP, CIPAYUNG, JAKARTA TIMUR, DKI JAKARTA",27,115,134,249
https://kawalpemilu.org#26134,"CILANGKAP, CIPAYUNG, JAKARTA TIMUR, DKI JAKARTA",28,71,120,191
https://kawalpemilu.org#26134,"CILANGKAP, CIPAYUNG, JAKARTA TIMUR, DKI JAKARTA",29,93,134,227
https://kawalpemilu.org#26134,"CILANGKAP, CIPAYUNG, JAKARTA TIMUR, DKI JAKARTA",30,72,129,201
https://kawalpemilu.org#26134,"CILANGKAP, CIPAYUNG, JAKARTA TIMUR, DKI JAKARTA",31,88,125,213
https://kawalpemilu.org#26134,"CILANGKAP, CIPAYUNG, JAKARTA TIMUR, DKI JAKARTA",32,94,122,216
https://kawalpemilu.org#26134,"CILANGKAP, CIPAYUNG, JAKARTA TIMUR, DKI JAKARTA",33,99,124,223
https://kawalpemilu.org#26134,"CILANGKAP, CIPAYUNG, JAKARTA TIMUR, DKI JAKARTA",34,81,143,224
https://kawalpemilu.org#26134,"CILANGKAP, CIPAYUNG, JAKARTA TIMUR, DKI JAKARTA",35,85,144,229
https://kawalpemilu.org#26134,"CILANGKAP, CIPAYUNG, JAKARTA TIMUR, DKI JAKARTA",36,81,143,224
https://kawalpemilu.org#26134,"CILANGKAP, CIPAYUNG, JAKARTA TIMUR, DKI JAKARTA",37,120,122,242
https://kawalpemilu.org#26134,"CILANGKAP, CIPAYUNG, JAKARTA TIMUR, DKI JAKARTA",38,106,98,204
https://kawalpemilu.org#26134,"CILANGKAP, CIPAYUNG, JAKARTA TIMUR, DKI JAKARTA",39,102,125,227
https://kawalpemilu.org#26134,"CILANGKAP, CIPAYUNG, JAKARTA TIMUR, DKI JAKARTA",40,201,13,214
https://kawalpemilu.org#26134,"CILANGKAP, CIPAYUNG, JAKARTA TIMUR, DKI JAKARTA",41,83,151,234
https://kawalpemilu.org#26134,"CILANGKAP, CIPAYUNG, JAKARTA TIMUR, DKI JAKARTA",42,93,123,216
https://kawalpemilu.org#26134,"CILANGKAP, CIPAYUNG, JAKARTA TIMUR, DKI JAKARTA",43,91,137,228
https://kawalpemilu.org#26134,"CILANGKAP, CIPAYUNG, JAKARTA TIMUR, DKI JAKARTA",44,103,132,235
https://kawalpemilu.org#26134,"CILANGKAP, CIPAYUNG, JAKARTA TIMUR, DKI JAKARTA",45,110,124,234
https://kawalpemilu.org#26134,"CILANGKAP, CIPAYUNG, JAKARTA TIMUR, DKI JAKARTA",46,108,131,239
https://kawalpemilu.org#26134,"CILANGKAP, CIPAYUNG, JAKARTA TIMUR, DKI JAKARTA",47,108,136,244
https://kawalpemilu.org#26134,"CILANGKAP, CIPAYUNG, JAKARTA TIMUR, DKI JAKARTA",48,73,101,174
https://kawalpemilu.org#26134,"CILANGKAP, CIPAYUNG, JAKARTA TIMUR, DKI JAKARTA",49,111,127,238
https://kawalpemilu.org#26134,"CILANGKAP, CIPAYUNG, JAKARTA TIMUR, DKI JAKARTA",50,97,152,249
https://kawalpemilu.org#26134,"CILANGKAP, CIPAYUNG, JAKARTA TIMUR, DKI JAKARTA",51,107,136,243
https://kawalpemilu.org#26134,"CILANGKAP, CIPAYUNG, JAKARTA TIMUR, DKI JAKARTA",52,83,127,210
https://kawalpemilu.org#26134,"CILANGKAP, CIPAYUNG, JAKARTA TIMUR, DKI JAKARTA",53,98,141,239
https://kawalpemilu.org#26134,"CILANGKAP, CIPAYUNG, JAKARTA TIMUR, DKI JAKARTA",54,77,157,234
https://kawalpemilu.org#26134,"CILANGKAP, CIPAYUNG, JAKARTA TIMUR, DKI JAKARTA",55,74,163,237
https://kawalpemilu.org#26134,"CILANGKAP, CIPAYUNG, JAKARTA TIMUR, DKI JAKARTA",56,138,131,269
https://kawalpemilu.org#26134,"CILANGKAP, CIPAYUNG, JAKARTA TIMUR, DKI JAKARTA",57,102,125,227
https://kawalpemilu.org#26134,"CILANGKAP, CIPAYUNG, JAKARTA TIMUR, DKI JAKARTA",58,124,123,247
https://kawalpemilu.org#26134,"CILANGKAP, CIPAYUNG, JAKARTA TIMUR, DKI JAKARTA",59,127,99,226
https://kawalpemilu.org#26134,"CILANGKAP, CIPAYUNG, JAKARTA TIMUR, DKI JAKARTA",60,119,120,239
https://kawalpemilu.org#26134,"CILANGKAP, CIPAYUNG, JAKARTA TIMUR, DKI JAKARTA",61,144,103,247
https://kawalpemilu.org#26134,"CILANGKAP, CIPAYUNG, JAKARTA TIMUR, DKI JAKARTA",62,103,153,256
https://kawalpemilu.org#26134,"CILANGKAP, CIPAYUNG, JAKARTA TIMUR, DKI JAKARTA",63,92,110,202
https://kawalpemilu.org#26134,"CILANGKAP, CIPAYUNG, JAKARTA TIMUR, DKI JAKARTA",64,90,171,261
https://kawalpemilu.org#26134,"CILANGKAP, CIPAYUNG, JAKARTA TIMUR, DKI JAKARTA",65,110,128,238
https://kawalpemilu.org#26134,"CILANGKAP, CIPAYUNG, JAKARTA TIMUR, DKI JAKARTA",66,86,147,233
https://kawalpemilu.org#26134,"CILANGKAP, CIPAYUNG, JAKARTA TIMUR, DKI JAKARTA",67,115,91,206
https://kawalpemilu.org#26134,"CILANGKAP, CIPAYUNG, JAKARTA TIMUR, DKI JAKARTA",68,95,111,206
https://kawalpemilu.org#26134,"CILANGKAP, CIPAYUNG, JAKARTA TIMUR, DKI JAKARTA",69,96,115,211
https://kawalpemilu.org#26134,"CILANGKAP, CIPAYUNG, JAKARTA TIMUR, DKI JAKARTA",70,85,92,177
https://kawalpemilu.org#26134,"CILANGKAP, CIPAYUNG, JAKARTA TIMUR, DKI JAKARTA",71,98,125,223
https://kawalpemilu.org#26134,"CILANGKAP, CIPAYUNG, JAKARTA TIMUR, DKI JAKARTA",72,128,132,260
https://kawalpemilu.org#26134,"CILANGKAP, CIPAYUNG, JAKARTA TIMUR, DKI JAKARTA",73,126,135,261
https://kawalpemilu.org#26134,"CILANGKAP, CIPAYUNG, JAKARTA TIMUR, DKI JAKARTA",74,118,116,234
https://kawalpemilu.org#26134,"CILANGKAP, CIPAYUNG, JAKARTA TIMUR, DKI JAKARTA",75,88,125,213
https://kawalpemilu.org#26134,"CILANGKAP, CIPAYUNG, JAKARTA TIMUR, DKI JAKARTA",76,86,86,172
https://kawalpemilu.org#26134,"CILANGKAP, CIPAYUNG, JAKARTA TIMUR, DKI JAKARTA",77,85,95,180
https://kawalpemilu.org#26134,"CILANGKAP, CIPAYUNG, JAKARTA TIMUR, DKI JAKARTA",78,43,93,136
https://kawalpemilu.org#26134,"CILANGKAP, CIPAYUNG, JAKARTA TIMUR, DKI JAKARTA",79,48,81,129
https://kawalpemilu.org#26134,"CILANGKAP, CIPAYUNG, JAKARTA TIMUR, DKI JAKARTA",80,93,83,176
https://kawalpemilu.org#26134,"CILANGKAP, CIPAYUNG, JAKARTA TIMUR, DKI JAKARTA",81,109,104,213
https://kawalpemilu.org#26134,"CILANGKAP, CIPAYUNG, JAKARTA TIMUR, DKI JAKARTA",82,69,102,171
https://kawalpemilu.org#26134,"CILANGKAP, CIPAYUNG, JAKARTA TIMUR, DKI JAKARTA",83,142,89,231
https://kawalpemilu.org#26134,"CILANGKAP, CIPAYUNG, JAKARTA TIMUR, DKI JAKARTA",84,101,123,224
https://kawalpemilu.org#26135,"PONDOK RANGGON, CIPAYUNG, JAKARTA TIMUR, DKI JAKARTA",1,50,88,138
https://kawalpemilu.org#26135,"PONDOK RANGGON, CIPAYUNG, JAKARTA TIMUR, DKI JAKARTA",2,125,160,285
https://kawalpemilu.org#26135,"PONDOK RANGGON, CIPAYUNG, JAKARTA TIMUR, DKI JAKARTA",3,98,135,233
https://kawalpemilu.org#26135,"PONDOK RANGGON, CIPAYUNG, JAKARTA TIMUR, DKI JAKARTA",6,63,232,295
https://kawalpemilu.org#26135,"PONDOK RANGGON, CIPAYUNG, JAKARTA TIMUR, DKI JAKARTA",7,83,174,257
https://kawalpemilu.org#26135,"PONDOK RANGGON, CIPAYUNG, JAKARTA TIMUR, DKI JAKARTA",8,109,164,273
https://kawalpemilu.org#26135,"PONDOK RANGGON, CIPAYUNG, JAKARTA TIMUR, DKI JAKARTA",9,95,143,238
https://kawalpemilu.org#26135,"PONDOK RANGGON, CIPAYUNG, JAKARTA TIMUR, DKI JAKARTA",10,107,147,254
https://kawalpemilu.org#26135,"PONDOK RANGGON, CIPAYUNG, JAKARTA TIMUR, DKI JAKARTA",11,83,148,231
https://kawalpemilu.org#26135,"PONDOK RANGGON, CIPAYUNG, JAKARTA TIMUR, DKI JAKARTA",12,91,123,214
https://kawalpemilu.org#26135,"PONDOK RANGGON, CIPAYUNG, JAKARTA TIMUR, DKI JAKARTA",13,112,91,203
https://kawalpemilu.org#26135,"PONDOK RANGGON, CIPAYUNG, JAKARTA TIMUR, DKI JAKARTA",14,118,110,228
https://kawalpemilu.org#26135,"PONDOK RANGGON, CIPAYUNG, JAKARTA TIMUR, DKI JAKARTA",15,109,142,251
https://kawalpemilu.org#26135,"PONDOK RANGGON, CIPAYUNG, JAKARTA TIMUR, DKI JAKARTA",16,106,137,243
https://kawalpemilu.org#26135,"PONDOK RANGGON, CIPAYUNG, JAKARTA TIMUR, DKI JAKARTA",17,117,142,259
https://kawalpemilu.org#26135,"PONDOK RANGGON, CIPAYUNG, JAKARTA TIMUR, DKI JAKARTA",18,96,154,250
https://kawalpemilu.org#26135,"PONDOK RANGGON, CIPAYUNG, JAKARTA TIMUR, DKI JAKARTA",19,83,150,233
https://kawalpemilu.org#26135,"PONDOK RANGGON, CIPAYUNG, JAKARTA TIMUR, DKI JAKARTA",20,133,118,251
https://kawalpemilu.org#26135,"PONDOK RANGGON, CIPAYUNG, JAKARTA TIMUR, DKI JAKARTA",21,104,88,192
https://kawalpemilu.org#26135,"PONDOK RANGGON, CIPAYUNG, JAKARTA TIMUR, DKI JAKARTA",22,134,117,251
https://kawalpemilu.org#26135,"PONDOK RANGGON, CIPAYUNG, JAKARTA TIMUR, DKI JAKARTA",23,90,114,204
https://kawalpemilu.org#26135,"PONDOK RANGGON, CIPAYUNG, JAKARTA TIMUR, DKI JAKARTA",24,59,176,235
https://kawalpemilu.org#26135,"PONDOK RANGGON, CIPAYUNG, JAKARTA TIMUR, DKI JAKARTA",25,84,100,184
https://kawalpemilu.org#26135,"PONDOK RANGGON, CIPAYUNG, JAKARTA TIMUR, DKI JAKARTA",26,65,121,186
https://kawalpemilu.org#26135,"PONDOK RANGGON, CIPAYUNG, JAKARTA TIMUR, DKI JAKARTA",27,71,167,238
https://kawalpemilu.org#26135,"PONDOK RANGGON, CIPAYUNG, JAKARTA TIMUR, DKI JAKARTA",28,110,166,276
https://kawalpemilu.org#26135,"PONDOK RANGGON, CIPAYUNG, JAKARTA TIMUR, DKI JAKARTA",29,116,150,266
https://kawalpemilu.org#26135,"PONDOK RANGGON, CIPAYUNG, JAKARTA TIMUR, DKI JAKARTA",30,132,147,279
https://kawalpemilu.org#26135,"PONDOK RANGGON, CIPAYUNG, JAKARTA TIMUR, DKI JAKARTA",31,96,116,212
https://kawalpemilu.org#26135,"PONDOK RANGGON, CIPAYUNG, JAKARTA TIMUR, DKI JAKARTA",32,94,147,241
https://kawalpemilu.org#26135,"PONDOK RANGGON, CIPAYUNG, JAKARTA TIMUR, DKI JAKARTA",34,108,150,258
https://kawalpemilu.org#26135,"PONDOK RANGGON, CIPAYUNG, JAKARTA TIMUR, DKI JAKARTA",35,139,100,239
https://kawalpemilu.org#26135,"PONDOK RANGGON, CIPAYUNG, JAKARTA TIMUR, DKI JAKARTA",36,112,100,212
https://kawalpemilu.org#26135,"PONDOK RANGGON, CIPAYUNG, JAKARTA TIMUR, DKI JAKARTA",38,116,153,269
https://kawalpemilu.org#26135,"PONDOK RANGGON, CIPAYUNG, JAKARTA TIMUR, DKI JAKARTA",39,63,154,217
https://kawalpemilu.org#26135,"PONDOK RANGGON, CIPAYUNG, JAKARTA TIMUR, DKI JAKARTA",41,101,162,252
https://kawalpemilu.org#26135,"PONDOK RANGGON, CIPAYUNG, JAKARTA TIMUR, DKI JAKARTA",42,133,127,260
https://kawalpemilu.org#26135,"PONDOK RANGGON, CIPAYUNG, JAKARTA TIMUR, DKI JAKARTA",43,92,173,265
https://kawalpemilu.org#26135,"PONDOK RANGGON, CIPAYUNG, JAKARTA TIMUR, DKI JAKARTA",44,109,143,252
https://kawalpemilu.org#26135,"PONDOK RANGGON, CIPAYUNG, JAKARTA TIMUR, DKI JAKARTA",45,102,159,261
https://kawalpemilu.org#26135,"PONDOK RANGGON, CIPAYUNG, JAKARTA TIMUR, DKI JAKARTA",46,120,126,246
https://kawalpemilu.org#26135,"PONDOK RANGGON, CIPAYUNG, JAKARTA TIMUR, DKI JAKARTA",48,85,147,232
https://kawalpemilu.org#26135,"PONDOK RANGGON, CIPAYUNG, JAKARTA TIMUR, DKI JAKARTA",51,100,148,248
https://kawalpemilu.org#26135,"PONDOK RANGGON, CIPAYUNG, JAKARTA TIMUR, DKI JAKARTA",52,93,137,230
https://kawalpemilu.org#26135,"PONDOK RANGGON, CIPAYUNG, JAKARTA TIMUR, DKI JAKARTA",53,106,142,248
https://kawalpemilu.org#26135,"PONDOK RANGGON, CIPAYUNG, JAKARTA TIMUR, DKI JAKARTA",54,88,132,220
https://kawalpemilu.org#26135,"PONDOK RANGGON, CIPAYUNG, JAKARTA TIMUR, DKI JAKARTA",55,105,109,214
https://kawalpemilu.org#26135,"PONDOK RANGGON, CIPAYUNG, JAKARTA TIMUR, DKI JAKARTA",56,129,132,261
https://kawalpemilu.org#26135,"PONDOK RANGGON, CIPAYUNG, JAKARTA TIMUR, DKI JAKARTA",57,105,160,265
https://kawalpemilu.org#26135,"PONDOK RANGGON, CIPAYUNG, JAKARTA TIMUR, DKI JAKARTA",58,108,173,281
https://kawalpemilu.org#26135,"PONDOK RANGGON, CIPAYUNG, JAKARTA TIMUR, DKI JAKARTA",59,116,152,268
https://kawalpemilu.org#26135,"PONDOK RANGGON, CIPAYUNG, JAKARTA TIMUR, DKI JAKARTA",60,104,140,244
https://kawalpemilu.org#26135,"PONDOK RANGGON, CIPAYUNG, JAKARTA TIMUR, DKI JAKARTA",61,104,136,240
https://kawalpemilu.org#26135,"PONDOK RANGGON, CIPAYUNG, JAKARTA TIMUR, DKI JAKARTA",62,94,148,242
https://kawalpemilu.org#26135,"PONDOK RANGGON, CIPAYUNG, JAKARTA TIMUR, DKI JAKARTA",63,118,113,233
https://kawalpemilu.org#26135,"PONDOK RANGGON, CIPAYUNG, JAKARTA TIMUR, DKI JAKARTA",64,133,132,265
https://kawalpemilu.org#26135,"PONDOK RANGGON, CIPAYUNG, JAKARTA TIMUR, DKI JAKARTA",65,116,129,245
https://kawalpemilu.org#26135,"PONDOK RANGGON, CIPAYUNG, JAKARTA TIMUR, DKI JAKARTA",66,85,108,193
https://kawalpemilu.org#26135,"PONDOK RANGGON, CIPAYUNG, JAKARTA TIMUR, DKI JAKARTA",67,161,99,260
https://kawalpemilu.org#26135,"PONDOK RANGGON, CIPAYUNG, JAKARTA TIMUR, DKI JAKARTA",68,130,139,269
https://kawalpemilu.org#26135,"PONDOK RANGGON, CIPAYUNG, JAKARTA TIMUR, DKI JAKARTA",69,121,128,249
https://kawalpemilu.org#26135,"PONDOK RANGGON, CIPAYUNG, JAKARTA TIMUR, DKI JAKARTA",71,96,64,160
https://kawalpemilu.org#26135,"PONDOK RANGGON, CIPAYUNG, JAKARTA TIMUR, DKI JAKARTA",72,91,101,192
https://kawalpemilu.org#26136,"MUNJUL, CIPAYUNG, JAKARTA TIMUR, DKI JAKARTA",1,137,96,233
https://kawalpemilu.org#26136,"MUNJUL, CIPAYUNG, JAKARTA TIMUR, DKI JAKARTA",2,133,96,229
https://kawalpemilu.org#26136,"MUNJUL, CIPAYUNG, JAKARTA TIMUR, DKI JAKARTA",3,111,130,241
https://kawalpemilu.org#26136,"MUNJUL, CIPAYUNG, JAKARTA TIMUR, DKI JAKARTA",4,116,105,221
https://kawalpemilu.org#26136,"MUNJUL, CIPAYUNG, JAKARTA TIMUR, DKI JAKARTA",6,106,130,236
https://kawalpemilu.org#26136,"MUNJUL, CIPAYUNG, JAKARTA TIMUR, DKI JAKARTA",7,91,140,231
https://kawalpemilu.org#26136,"MUNJUL, CIPAYUNG, JAKARTA TIMUR, DKI JAKARTA",8,107,142,249
https://kawalpemilu.org#26136,"MUNJUL, CIPAYUNG, JAKARTA TIMUR, DKI JAKARTA",9,102,119,221
https://kawalpemilu.org#26136,"MUNJUL, CIPAYUNG, JAKARTA TIMUR, DKI JAKARTA",10,103,134,237
https://kawalpemilu.org#26136,"MUNJUL, CIPAYUNG, JAKARTA TIMUR, DKI JAKARTA",13,114,97,211
https://kawalpemilu.org#26136,"MUNJUL, CIPAYUNG, JAKARTA TIMUR, DKI JAKARTA",14,93,141,234
https://kawalpemilu.org#26136,"MUNJUL, CIPAYUNG, JAKARTA TIMUR, DKI JAKARTA",15,97,123,220
https://kawalpemilu.org#26136,"MUNJUL, CIPAYUNG, JAKARTA TIMUR, DKI JAKARTA",17,119,98,217
https://kawalpemilu.org#26136,"MUNJUL, CIPAYUNG, JAKARTA TIMUR, DKI JAKARTA",20,121,86,207
https://kawalpemilu.org#26136,"MUNJUL, CIPAYUNG, JAKARTA TIMUR, DKI JAKARTA",21,107,110,217
https://kawalpemilu.org#26136,"MUNJUL, CIPAYUNG, JAKARTA TIMUR, DKI JAKARTA",22,165,79,244
https://kawalpemilu.org#26136,"MUNJUL, CIPAYUNG, JAKARTA TIMUR, DKI JAKARTA",23,136,98,234
https://kawalpemilu.org#26136,"MUNJUL, CIPAYUNG, JAKARTA TIMUR, DKI JAKARTA",24,117,147,264
https://kawalpemilu.org#26136,"MUNJUL, CIPAYUNG, JAKARTA TIMUR, DKI JAKARTA",25,135,114,249
https://kawalpemilu.org#26136,"MUNJUL, CIPAYUNG, JAKARTA TIMUR, DKI JAKARTA",27,120,129,249
https://kawalpemilu.org#26136,"MUNJUL, CIPAYUNG, JAKARTA TIMUR, DKI JAKARTA",28,144,105,249
https://kawalpemilu.org#26136,"MUNJUL, CIPAYUNG, JAKARTA TIMUR, DKI JAKARTA",29,111,119,230
https://kawalpemilu.org#26136,"MUNJUL, CIPAYUNG, JAKARTA TIMUR, DKI JAKARTA",30,133,111,244
https://kawalpemilu.org#26136,"MUNJUL, CIPAYUNG, JAKARTA TIMUR, DKI JAKARTA",31,133,120,253
https://kawalpemilu.org#26136,"MUNJUL, CIPAYUNG, JAKARTA TIMUR, DKI JAKARTA",32,118,121,239
https://kawalpemilu.org#26136,"MUNJUL, CIPAYUNG, JAKARTA TIMUR, DKI JAKARTA",34,112,112,224
https://kawalpemilu.org#26136,"MUNJUL, CIPAYUNG, JAKARTA TIMUR, DKI JAKARTA",35,72,178,250
https://kawalpemilu.org#26136,"MUNJUL, CIPAYUNG, JAKARTA TIMUR, DKI JAKARTA",36,92,160,252
https://kawalpemilu.org#26136,"MUNJUL, CIPAYUNG, JAKARTA TIMUR, DKI JAKARTA",37,105,144,249
https://kawalpemilu.org#26136,"MUNJUL, CIPAYUNG, JAKARTA TIMUR, DKI JAKARTA",38,124,139,263
https://kawalpemilu.org#26136,"MUNJUL, CIPAYUNG, JAKARTA TIMUR, DKI JAKARTA",39,110,145,255
https://kawalpemilu.org#26136,"MUNJUL, CIPAYUNG, JAKARTA TIMUR, DKI JAKARTA",40,78,186,264
https://kawalpemilu.org#26136,"MUNJUL, CIPAYUNG, JAKARTA TIMUR, DKI JAKARTA",41,113,125,238
https://kawalpemilu.org#26136,"MUNJUL, CIPAYUNG, JAKARTA TIMUR, DKI JAKARTA",42,116,142,258
https://kawalpemilu.org#26136,"MUNJUL, CIPAYUNG, JAKARTA TIMUR, DKI JAKARTA",43,101,143,244
https://kawalpemilu.org#26136,"MUNJUL, CIPAYUNG, JAKARTA TIMUR, DKI JAKARTA",44,101,151,252
https://kawalpemilu.org#26136,"MUNJUL, CIPAYUNG, JAKARTA TIMUR, DKI JAKARTA",45,90,137,227
https://kawalpemilu.org#26136,"MUNJUL, CIPAYUNG, JAKARTA TIMUR, DKI JAKARTA",46,96,157,253
https://kawalpemilu.org#26136,"MUNJUL, CIPAYUNG, JAKARTA TIMUR, DKI JAKARTA",47,148,98,246
https://kawalpemilu.org#26136,"MUNJUL, CIPAYUNG, JAKARTA TIMUR, DKI JAKARTA",48,148,110,258
https://kawalpemilu.org#26136,"MUNJUL, CIPAYUNG, JAKARTA TIMUR, DKI JAKARTA",49,111,136,247
https://kawalpemilu.org#26136,"MUNJUL, CIPAYUNG, JAKARTA TIMUR, DKI JAKARTA",50,136,117,253
https://kawalpemilu.org#26136,"MUNJUL, CIPAYUNG, JAKARTA TIMUR, DKI JAKARTA",51,133,109,242
https://kawalpemilu.org#26136,"MUNJUL, CIPAYUNG, JAKARTA TIMUR, DKI JAKARTA",52,117,124,241
https://kawalpemilu.org#26136,"MUNJUL, CIPAYUNG, JAKARTA TIMUR, DKI JAKARTA",53,158,81,240
https://kawalpemilu.org#26136,"MUNJUL, CIPAYUNG, JAKARTA TIMUR, DKI JAKARTA",54,138,98,236
https://kawalpemilu.org#26136,"MUNJUL, CIPAYUNG, JAKARTA TIMUR, DKI JAKARTA",55,141,126,267
https://kawalpemilu.org#26136,"MUNJUL, CIPAYUNG, JAKARTA TIMUR, DKI JAKARTA",57,124,121,245
https://kawalpemilu.org#26136,"MUNJUL, CIPAYUNG, JAKARTA TIMUR, DKI JAKARTA",58,155,104,259
https://kawalpemilu.org#26136,"MUNJUL, CIPAYUNG, JAKARTA TIMUR, DKI JAKARTA",59,133,92,225
https://kawalpemilu.org#26136,"MUNJUL, CIPAYUNG, JAKARTA TIMUR, DKI JAKARTA",60,119,115,234
https://kawalpemilu.org#26136,"MUNJUL, CIPAYUNG, JAKARTA TIMUR, DKI JAKARTA",61,110,126,236
https://kawalpemilu.org#26136,"MUNJUL, CIPAYUNG, JAKARTA TIMUR, DKI JAKARTA",62,100,111,211
https://kawalpemilu.org#26136,"MUNJUL, CIPAYUNG, JAKARTA TIMUR, DKI JAKARTA",63,103,142,245
https://kawalpemilu.org#26136,"MUNJUL, CIPAYUNG, JAKARTA TIMUR, DKI JAKARTA",64,94,107,201
https://kawalpemilu.org#26136,"MUNJUL, CIPAYUNG, JAKARTA TIMUR, DKI JAKARTA",65,85,143,228
https://kawalpemilu.org#26136,"MUNJUL, CIPAYUNG, JAKARTA TIMUR, DKI JAKARTA",66,112,120,232
https://kawalpemilu.org#26136,"MUNJUL, CIPAYUNG, JAKARTA TIMUR, DKI JAKARTA",68,100,164,264
https://kawalpemilu.org#26136,"MUNJUL, CIPAYUNG, JAKARTA TIMUR, DKI JAKARTA",69,163,70,233
https://kawalpemilu.org#26137,"SETU, CIPAYUNG, JAKARTA TIMUR, DKI JAKARTA",1,112,125,237
https://kawalpemilu.org#26137,"SETU, CIPAYUNG, JAKARTA TIMUR, DKI JAKARTA",2,126,144,270
https://kawalpemilu.org#26137,"SETU, CIPAYUNG, JAKARTA TIMUR, DKI JAKARTA",3,107,154,261
https://kawalpemilu.org#26137,"SETU, CIPAYUNG, JAKARTA TIMUR, DKI JAKARTA",4,136,117,253
https://kawalpemilu.org#26137,"SETU, CIPAYUNG, JAKARTA TIMUR, DKI JAKARTA",5,103,139,242
https://kawalpemilu.org#26137,"SETU, CIPAYUNG, JAKARTA TIMUR, DKI JAKARTA",6,95,132,227
https://kawalpemilu.org#26137,"SETU, CIPAYUNG, JAKARTA TIMUR, DKI JAKARTA",7,94,151,245
https://kawalpemilu.org#26137,"SETU, CIPAYUNG, JAKARTA TIMUR, DKI JAKARTA",8,121,146,267
https://kawalpemilu.org#26137,"SETU, CIPAYUNG, JAKARTA TIMUR, DKI JAKARTA",9,109,124,233
https://kawalpemilu.org#26137,"SETU, CIPAYUNG, JAKARTA TIMUR, DKI JAKARTA",10,107,96,203
https://kawalpemilu.org#26137,"SETU, CIPAYUNG, JAKARTA TIMUR, DKI JAKARTA",11,84,158,242
https://kawalpemilu.org#26137,"SETU, CIPAYUNG, JAKARTA TIMUR, DKI JAKARTA",12,119,146,265
https://kawalpemilu.org#26137,"SETU, CIPAYUNG, JAKARTA TIMUR, DKI JAKARTA",13,92,153,245
https://kawalpemilu.org#26137,"SETU, CIPAYUNG, JAKARTA TIMUR, DKI JAKARTA",14,144,100,244
https://kawalpemilu.org#26137,"SETU, CIPAYUNG, JAKARTA TIMUR, DKI JAKARTA",15,121,135,256
https://kawalpemilu.org#26137,"SETU, CIPAYUNG, JAKARTA TIMUR, DKI JAKARTA",16,96,132,228
https://kawalpemilu.org#26137,"SETU, CIPAYUNG, JAKARTA TIMUR, DKI JAKARTA",17,63,104,173
https://kawalpemilu.org#26137,"SETU, CIPAYUNG, JAKARTA TIMUR, DKI JAKARTA",18,53,132,185
https://kawalpemilu.org#26137,"SETU, CIPAYUNG, JAKARTA TIMUR, DKI JAKARTA",19,109,113,222
https://kawalpemilu.org#26137,"SETU, CIPAYUNG, JAKARTA TIMUR, DKI JAKARTA",20,81,157,238
https://kawalpemilu.org#26137,"SETU, CIPAYUNG, JAKARTA TIMUR, DKI JAKARTA",21,96,147,243
https://kawalpemilu.org#26137,"SETU, CIPAYUNG, JAKARTA TIMUR, DKI JAKARTA",22,114,124,238
https://kawalpemilu.org#26137,"SETU, CIPAYUNG, JAKARTA TIMUR, DKI JAKARTA",23,122,107,229
https://kawalpemilu.org#26137,"SETU, CIPAYUNG, JAKARTA TIMUR, DKI JAKARTA",24,113,128,241
https://kawalpemilu.org#26137,"SETU, CIPAYUNG, JAKARTA TIMUR, DKI JAKARTA",25,144,120,264
https://kawalpemilu.org#26137,"SETU, CIPAYUNG, JAKARTA TIMUR, DKI JAKARTA",26,135,127,262
https://kawalpemilu.org#26137,"SETU, CIPAYUNG, JAKARTA TIMUR, DKI JAKARTA",27,149,119,268
https://kawalpemilu.org#26137,"SETU, CIPAYUNG, JAKARTA TIMUR, DKI JAKARTA",28,123,112,235
https://kawalpemilu.org#26137,"SETU, CIPAYUNG, JAKARTA TIMUR, DKI JAKARTA",29,89,163,252
https://kawalpemilu.org#26137,"SETU, CIPAYUNG, JAKARTA TIMUR, DKI JAKARTA",30,97,131,228
https://kawalpemilu.org#26137,"SETU, CIPAYUNG, JAKARTA TIMUR, DKI JAKARTA",31,113,135,248
https://kawalpemilu.org#26137,"SETU, CIPAYUNG, JAKARTA TIMUR, DKI JAKARTA",32,122,129,251
https://kawalpemilu.org#26137,"SETU, CIPAYUNG, JAKARTA TIMUR, DKI JAKARTA",33,105,126,231
https://kawalpemilu.org#26137,"SETU, CIPAYUNG, JAKARTA TIMUR, DKI JAKARTA",34,102,157,259
https://kawalpemilu.org#26137,"SETU, CIPAYUNG, JAKARTA TIMUR, DKI JAKARTA",35,93,139,232
https://kawalpemilu.org#26137,"SETU, CIPAYUNG, JAKARTA TIMUR, DKI JAKARTA",36,96,141,237
https://kawalpemilu.org#26137,"SETU, CIPAYUNG, JAKARTA TIMUR, DKI JAKARTA",38,108,117,225
https://kawalpemilu.org#26137,"SETU, CIPAYUNG, JAKARTA TIMUR, DKI JAKARTA",39,87,116,203
https://kawalpemilu.org#26137,"SETU, CIPAYUNG, JAKARTA TIMUR, DKI JAKARTA",40,128,131,259
https://kawalpemilu.org#26137,"SETU, CIPAYUNG, JAKARTA TIMUR, DKI JAKARTA",41,112,133,245
https://kawalpemilu.org#26137,"SETU, CIPAYUNG, JAKARTA TIMUR, DKI JAKARTA",42,117,112,229
https://kawalpemilu.org#26137,"SETU, CIPAYUNG, JAKARTA TIMUR, DKI JAKARTA",43,110,126,236
https://kawalpemilu.org#26137,"SETU, CIPAYUNG, JAKARTA TIMUR, DKI JAKARTA",44,104,154,258
https://kawalpemilu.org#26137,"SETU, CIPAYUNG, JAKARTA TIMUR, DKI JAKARTA",45,91,77,168
https://kawalpemilu.org#26137,"SETU, CIPAYUNG, JAKARTA TIMUR, DKI JAKARTA",46,106,138,244
https://kawalpemilu.org#26137,"SETU, CIPAYUNG, JAKARTA TIMUR, DKI JAKARTA",47,91,132,223
https://kawalpemilu.org#26137,"SETU, CIPAYUNG, JAKARTA TIMUR, DKI JAKARTA",48,99,113,212
https://kawalpemilu.org#26137,"SETU, CIPAYUNG, JAKARTA TIMUR, DKI JAKARTA",49,81,81,162
https://kawalpemilu.org#26137,"SETU, CIPAYUNG, JAKARTA TIMUR, DKI JAKARTA",50,109,161,270
https://kawalpemilu.org#26137,"SETU, CIPAYUNG, JAKARTA TIMUR, DKI JAKARTA",51,75,174,249
https://kawalpemilu.org#26137,"SETU, CIPAYUNG, JAKARTA TIMUR, DKI JAKARTA",52,106,143,249
https://kawalpemilu.org#26137,"SETU, CIPAYUNG, JAKARTA TIMUR, DKI JAKARTA",53,114,137,251
https://kawalpemilu.org#26137,"SETU, CIPAYUNG, JAKARTA TIMUR, DKI JAKARTA",54,123,118,241
https://kawalpemilu.org#26137,"SETU, CIPAYUNG, JAKARTA TIMUR, DKI JAKARTA",55,122,126,248
https://kawalpemilu.org#26137,"SETU, CIPAYUNG, JAKARTA TIMUR, DKI JAKARTA",56,64,98,162
https://kawalpemilu.org#26137,"SETU, CIPAYUNG, JAKARTA TIMUR, DKI JAKARTA",57,107,118,225
https://kawalpemilu.org#26137,"SETU, CIPAYUNG, JAKARTA TIMUR, DKI JAKARTA",58,91,142,233
https://kawalpemilu.org#26137,"SETU, CIPAYUNG, JAKARTA TIMUR, DKI JAKARTA",59,72,51,123
https://kawalpemilu.org#26137,"SETU, CIPAYUNG, JAKARTA TIMUR, DKI JAKARTA",60,74,78,152
https://kawalpemilu.org#26137,"SETU, CIPAYUNG, JAKARTA TIMUR, DKI JAKARTA",61,103,121,224
https://kawalpemilu.org#26138,"BAMBU APUS, CIPAYUNG, JAKARTA TIMUR, DKI JAKARTA",1,109,128,237
https://kawalpemilu.org#26138,"BAMBU APUS, CIPAYUNG, JAKARTA TIMUR, DKI JAKARTA",2,104,105,209
https://kawalpemilu.org#26138,"BAMBU APUS, CIPAYUNG, JAKARTA TIMUR, DKI JAKARTA",3,115,132,247
https://kawalpemilu.org#26138,"BAMBU APUS, CIPAYUNG, JAKARTA TIMUR, DKI JAKARTA",4,81,94,175
https://kawalpemilu.org#26138,"BAMBU APUS, CIPAYUNG, JAKARTA TIMUR, DKI JAKARTA",5,105,137,242
https://kawalpemilu.org#26138,"BAMBU APUS, CIPAYUNG, JAKARTA TIMUR, DKI JAKARTA",6,108,146,254
https://kawalpemilu.org#26138,"BAMBU APUS, CIPAYUNG, JAKARTA TIMUR, DKI JAKARTA",7,115,128,243
https://kawalpemilu.org#26138,"BAMBU APUS, CIPAYUNG, JAKARTA TIMUR, DKI JAKARTA",8,109,133,242
https://kawalpemilu.org#26138,"BAMBU APUS, CIPAYUNG, JAKARTA TIMUR, DKI JAKARTA",9,172,73,245
https://kawalpemilu.org#26138,"BAMBU APUS, CIPAYUNG, JAKARTA TIMUR, DKI JAKARTA",10,145,110,255
https://kawalpemilu.org#26138,"BAMBU APUS, CIPAYUNG, JAKARTA TIMUR, DKI JAKARTA",12,112,149,261
https://kawalpemilu.org#26138,"BAMBU APUS, CIPAYUNG, JAKARTA TIMUR, DKI JAKARTA",14,91,121,212
https://kawalpemilu.org#26138,"BAMBU APUS, CIPAYUNG, JAKARTA TIMUR, DKI JAKARTA",15,103,114,217
https://kawalpemilu.org#26138,"BAMBU APUS, CIPAYUNG, JAKARTA TIMUR, DKI JAKARTA",16,95,148,243
https://kawalpemilu.org#26138,"BAMBU APUS, CIPAYUNG, JAKARTA TIMUR, DKI JAKARTA",17,101,138,239
https://kawalpemilu.org#26138,"BAMBU APUS, CIPAYUNG, JAKARTA TIMUR, DKI JAKARTA",18,82,139,221
https://kawalpemilu.org#26138,"BAMBU APUS, CIPAYUNG, JAKARTA TIMUR, DKI JAKARTA",19,0,0,242
https://kawalpemilu.org#26138,"BAMBU APUS, CIPAYUNG, JAKARTA TIMUR, DKI JAKARTA",20,134,118,252
https://kawalpemilu.org#26138,"BAMBU APUS, CIPAYUNG, JAKARTA TIMUR, DKI JAKARTA",21,99,140,239
https://kawalpemilu.org#26138,"BAMBU APUS, CIPAYUNG, JAKARTA TIMUR, DKI JAKARTA",23,118,96,214
https://kawalpemilu.org#26138,"BAMBU APUS, CIPAYUNG, JAKARTA TIMUR, DKI JAKARTA",24,113,101,214
https://kawalpemilu.org#26138,"BAMBU APUS, CIPAYUNG, JAKARTA TIMUR, DKI JAKARTA",25,98,110,208
https://kawalpemilu.org#26138,"BAMBU APUS, CIPAYUNG, JAKARTA TIMUR, DKI JAKARTA",27,70,167,237
https://kawalpemilu.org#26138,"BAMBU APUS, CIPAYUNG, JAKARTA TIMUR, DKI JAKARTA",28,124,131,255
https://kawalpemilu.org#26138,"BAMBU APUS, CIPAYUNG, JAKARTA TIMUR, DKI JAKARTA",29,140,108,248
https://kawalpemilu.org#26138,"BAMBU APUS, CIPAYUNG, JAKARTA TIMUR, DKI JAKARTA",30,90,95,185
https://kawalpemilu.org#26138,"BAMBU APUS, CIPAYUNG, JAKARTA TIMUR, DKI JAKARTA",31,106,84,190
https://kawalpemilu.org#26138,"BAMBU APUS, CIPAYUNG, JAKARTA TIMUR, DKI JAKARTA",32,91,107,198
https://kawalpemilu.org#26138,"BAMBU APUS, CIPAYUNG, JAKARTA TIMUR, DKI JAKARTA",33,107,101,208
https://kawalpemilu.org#26138,"BAMBU APUS, CIPAYUNG, JAKARTA TIMUR, DKI JAKARTA",36,120,113,233
https://kawalpemilu.org#26138,"BAMBU APUS, CIPAYUNG, JAKARTA TIMUR, DKI JAKARTA",38,133,92,225
https://kawalpemilu.org#26138,"BAMBU APUS, CIPAYUNG, JAKARTA TIMUR, DKI JAKARTA",39,93,157,250
https://kawalpemilu.org#26138,"BAMBU APUS, CIPAYUNG, JAKARTA TIMUR, DKI JAKARTA",40,128,98,226
https://kawalpemilu.org#26138,"BAMBU APUS, CIPAYUNG, JAKARTA TIMUR, DKI JAKARTA",41,88,162,250
https://kawalpemilu.org#26138,"BAMBU APUS, CIPAYUNG, JAKARTA TIMUR, DKI JAKARTA",42,100,126,226
https://kawalpemilu.org#26138,"BAMBU APUS, CIPAYUNG, JAKARTA TIMUR, DKI JAKARTA",43,116,94,210
https://kawalpemilu.org#26138,"BAMBU APUS, CIPAYUNG, JAKARTA TIMUR, DKI JAKARTA",45,93,99,192
https://kawalpemilu.org#26138,"BAMBU APUS, CIPAYUNG, JAKARTA TIMUR, DKI JAKARTA",46,99,96,195
https://kawalpemilu.org#26138,"BAMBU APUS, CIPAYUNG, JAKARTA TIMUR, DKI JAKARTA",48,131,118,249
https://kawalpemilu.org#26138,"BAMBU APUS, CIPAYUNG, JAKARTA TIMUR, DKI JAKARTA",49,121,151,172
https://kawalpemilu.org#26138,"BAMBU APUS, CIPAYUNG, JAKARTA TIMUR, DKI JAKARTA",50,126,141,267
https://kawalpemilu.org#26138,"BAMBU APUS, CIPAYUNG, JAKARTA TIMUR, DKI JAKARTA",51,89,159,248
https://kawalpemilu.org#26138,"BAMBU APUS, CIPAYUNG, JAKARTA TIMUR, DKI JAKARTA",52,106,124,230
https://kawalpemilu.org#26138,"BAMBU APUS, CIPAYUNG, JAKARTA TIMUR, DKI JAKARTA",53,107,133,240
https://kawalpemilu.org#26138,"BAMBU APUS, CIPAYUNG, JAKARTA TIMUR, DKI JAKARTA",54,83,160,243
https://kawalpemilu.org#26138,"BAMBU APUS, CIPAYUNG, JAKARTA TIMUR, DKI JAKARTA",55,112,100,212
https://kawalpemilu.org#26138,"BAMBU APUS, CIPAYUNG, JAKARTA TIMUR, DKI JAKARTA",56,85,128,213
https://kawalpemilu.org#26138,"BAMBU APUS, CIPAYUNG, JAKARTA TIMUR, DKI JAKARTA",57,133,102,235
https://kawalpemilu.org#26138,"BAMBU APUS, CIPAYUNG, JAKARTA TIMUR, DKI JAKARTA",58,114,96,210
https://kawalpemilu.org#26138,"BAMBU APUS, CIPAYUNG, JAKARTA TIMUR, DKI JAKARTA",59,113,152,265
https://kawalpemilu.org#26138,"BAMBU APUS, CIPAYUNG, JAKARTA TIMUR, DKI JAKARTA",61,92,112,204
https://kawalpemilu.org#26138,"BAMBU APUS, CIPAYUNG, JAKARTA TIMUR, DKI JAKARTA",62,91,154,245
https://kawalpemilu.org#26138,"BAMBU APUS, CIPAYUNG, JAKARTA TIMUR, DKI JAKARTA",63,91,151,242
https://kawalpemilu.org#26138,"BAMBU APUS, CIPAYUNG, JAKARTA TIMUR, DKI JAKARTA",64,98,160,258
https://kawalpemilu.org#26138,"BAMBU APUS, CIPAYUNG, JAKARTA TIMUR, DKI JAKARTA",65,92,99,191
https://kawalpemilu.org#26138,"BAMBU APUS, CIPAYUNG, JAKARTA TIMUR, DKI JAKARTA",67,107,139,246
https://kawalpemilu.org#26138,"BAMBU APUS, CIPAYUNG, JAKARTA TIMUR, DKI JAKARTA",68,79,129,208
https://kawalpemilu.org#26138,"BAMBU APUS, CIPAYUNG, JAKARTA TIMUR, DKI JAKARTA",69,79,166,245
https://kawalpemilu.org#26138,"BAMBU APUS, CIPAYUNG, JAKARTA TIMUR, DKI JAKARTA",70,91,120,211
https://kawalpemilu.org#26138,"BAMBU APUS, CIPAYUNG, JAKARTA TIMUR, DKI JAKARTA",71,93,142,235
https://kawalpemilu.org#26138,"BAMBU APUS, CIPAYUNG, JAKARTA TIMUR, DKI JAKARTA",72,111,121,232
https://kawalpemilu.org#26138,"BAMBU APUS, CIPAYUNG, JAKARTA TIMUR, DKI JAKARTA",73,102,144,246
https://kawalpemilu.org#26138,"BAMBU APUS, CIPAYUNG, JAKARTA TIMUR, DKI JAKARTA",74,97,138,235
https://kawalpemilu.org#26138,"BAMBU APUS, CIPAYUNG, JAKARTA TIMUR, DKI JAKARTA",76,95,142,237
https://kawalpemilu.org#26138,"BAMBU APUS, CIPAYUNG, JAKARTA TIMUR, DKI JAKARTA",77,74,79,153
https://kawalpemilu.org#26138,"BAMBU APUS, CIPAYUNG, JAKARTA TIMUR, DKI JAKARTA",78,141,105,246
https://kawalpemilu.org#26138,"BAMBU APUS, CIPAYUNG, JAKARTA TIMUR, DKI JAKARTA",79,81,113,194
https://kawalpemilu.org#26138,"BAMBU APUS, CIPAYUNG, JAKARTA TIMUR, DKI JAKARTA",80,86,177,263
https://kawalpemilu.org#26139,"LUBANG BUAYA, CIPAYUNG, JAKARTA TIMUR, DKI JAKARTA",1,95,155,250
https://kawalpemilu.org#26139,"LUBANG BUAYA, CIPAYUNG, JAKARTA TIMUR, DKI JAKARTA",2,77,145,222
https://kawalpemilu.org#26139,"LUBANG BUAYA, CIPAYUNG, JAKARTA TIMUR, DKI JAKARTA",3,69,123,192
https://kawalpemilu.org#26139,"LUBANG BUAYA, CIPAYUNG, JAKARTA TIMUR, DKI JAKARTA",4,96,114,210
https://kawalpemilu.org#26139,"LUBANG BUAYA, CIPAYUNG, JAKARTA TIMUR, DKI JAKARTA",5,95,153,248
https://kawalpemilu.org#26139,"LUBANG BUAYA, CIPAYUNG, JAKARTA TIMUR, DKI JAKARTA",6,99,106,205
https://kawalpemilu.org#26139,"LUBANG BUAYA, CIPAYUNG, JAKARTA TIMUR, DKI JAKARTA",7,80,121,201
https://kawalpemilu.org#26139,"LUBANG BUAYA, CIPAYUNG, JAKARTA TIMUR, DKI JAKARTA",8,104,136,240
https://kawalpemilu.org#26139,"LUBANG BUAYA, CIPAYUNG, JAKARTA TIMUR, DKI JAKARTA",9,94,115,209
https://kawalpemilu.org#26139,"LUBANG BUAYA, CIPAYUNG, JAKARTA TIMUR, DKI JAKARTA",10,94,78,172
https://kawalpemilu.org#26139,"LUBANG BUAYA, CIPAYUNG, JAKARTA TIMUR, DKI JAKARTA",11,112,133,245
https://kawalpemilu.org#26139,"LUBANG BUAYA, CIPAYUNG, JAKARTA TIMUR, DKI JAKARTA",12,108,141,249
https://kawalpemilu.org#26139,"LUBANG BUAYA, CIPAYUNG, JAKARTA TIMUR, DKI JAKARTA",13,74,116,74
https://kawalpemilu.org#26139,"LUBANG BUAYA, CIPAYUNG, JAKARTA TIMUR, DKI JAKARTA",14,74,146,220
https://kawalpemilu.org#26139,"LUBANG BUAYA, CIPAYUNG, JAKARTA TIMUR, DKI JAKARTA",15,74,165,239
https://kawalpemilu.org#26139,"LUBANG BUAYA, CIPAYUNG, JAKARTA TIMUR, DKI JAKARTA",16,101,150,251
https://kawalpemilu.org#26139,"LUBANG BUAYA, CIPAYUNG, JAKARTA TIMUR, DKI JAKARTA",17,100,148,248
https://kawalpemilu.org#26139,"LUBANG BUAYA, CIPAYUNG, JAKARTA TIMUR, DKI JAKARTA",18,84,143,227
https://kawalpemilu.org#26139,"LUBANG BUAYA, CIPAYUNG, JAKARTA TIMUR, DKI JAKARTA",19,82,144,226
https://kawalpemilu.org#26139,"LUBANG BUAYA, CIPAYUNG, JAKARTA TIMUR, DKI JAKARTA",20,89,148,237
https://kawalpemilu.org#26139,"LUBANG BUAYA, CIPAYUNG, JAKARTA TIMUR, DKI JAKARTA",21,0,0,0
https://kawalpemilu.org#26139,"LUBANG BUAYA, CIPAYUNG, JAKARTA TIMUR, DKI JAKARTA",22,118,138,256
https://kawalpemilu.org#26139,"LUBANG BUAYA, CIPAYUNG, JAKARTA TIMUR, DKI JAKARTA",23,125,120,245
https://kawalpemilu.org#26139,"LUBANG BUAYA, CIPAYUNG, JAKARTA TIMUR, DKI JAKARTA",24,131,120,251
https://kawalpemilu.org#26139,"LUBANG BUAYA, CIPAYUNG, JAKARTA TIMUR, DKI JAKARTA",25,95,137,232
https://kawalpemilu.org#26139,"LUBANG BUAYA, CIPAYUNG, JAKARTA TIMUR, DKI JAKARTA",26,105,122,227
https://kawalpemilu.org#26139,"LUBANG BUAYA, CIPAYUNG, JAKARTA TIMUR, DKI JAKARTA",27,88,130,218
https://kawalpemilu.org#26139,"LUBANG BUAYA, CIPAYUNG, JAKARTA TIMUR, DKI JAKARTA",28,85,152,237
https://kawalpemilu.org#26139,"LUBANG BUAYA, CIPAYUNG, JAKARTA TIMUR, DKI JAKARTA",29,114,134,248
https://kawalpemilu.org#26139,"LUBANG BUAYA, CIPAYUNG, JAKARTA TIMUR, DKI JAKARTA",30,102,124,226
https://kawalpemilu.org#26139,"LUBANG BUAYA, CIPAYUNG, JAKARTA TIMUR, DKI JAKARTA",31,127,101,228
https://kawalpemilu.org#26139,"LUBANG BUAYA, CIPAYUNG, JAKARTA TIMUR, DKI JAKARTA",32,89,139,228
https://kawalpemilu.org#26139,"LUBANG BUAYA, CIPAYUNG, JAKARTA TIMUR, DKI JAKARTA",33,124,111,235
https://kawalpemilu.org#26139,"LUBANG BUAYA, CIPAYUNG, JAKARTA TIMUR, DKI JAKARTA",34,93,161,254
https://kawalpemilu.org#26139,"LUBANG BUAYA, CIPAYUNG, JAKARTA TIMUR, DKI JAKARTA",35,69,152,221
https://kawalpemilu.org#26139,"LUBANG BUAYA, CIPAYUNG, JAKARTA TIMUR, DKI JAKARTA",36,110,145,255
https://kawalpemilu.org#26139,"LUBANG BUAYA, CIPAYUNG, JAKARTA TIMUR, DKI JAKARTA",37,122,139,261
https://kawalpemilu.org#26139,"LUBANG BUAYA, CIPAYUNG, JAKARTA TIMUR, DKI JAKARTA",38,98,142,240
https://kawalpemilu.org#26139,"LUBANG BUAYA, CIPAYUNG, JAKARTA TIMUR, DKI JAKARTA",39,92,89,181
https://kawalpemilu.org#26139,"LUBANG BUAYA, CIPAYUNG, JAKARTA TIMUR, DKI JAKARTA",40,130,134,264
https://kawalpemilu.org#26139,"LUBANG BUAYA, CIPAYUNG, JAKARTA TIMUR, DKI JAKARTA",41,96,137,233
https://kawalpemilu.org#26139,"LUBANG BUAYA, CIPAYUNG, JAKARTA TIMUR, DKI JAKARTA",42,99,129,228
https://kawalpemilu.org#26139,"LUBANG BUAYA, CIPAYUNG, JAKARTA TIMUR, DKI JAKARTA",43,96,104,200
https://kawalpemilu.org#26139,"LUBANG BUAYA, CIPAYUNG, JAKARTA TIMUR, DKI JAKARTA",44,100,134,234
https://kawalpemilu.org#26139,"LUBANG BUAYA, CIPAYUNG, JAKARTA TIMUR, DKI JAKARTA",45,102,128,230
https://kawalpemilu.org#26139,"LUBANG BUAYA, CIPAYUNG, JAKARTA TIMUR, DKI JAKARTA",46,87,147,234
https://kawalpemilu.org#26139,"LUBANG BUAYA, CIPAYUNG, JAKARTA TIMUR, DKI JAKARTA",47,118,112,230
https://kawalpemilu.org#26139,"LUBANG BUAYA, CIPAYUNG, JAKARTA TIMUR, DKI JAKARTA",48,75,111,186
https://kawalpemilu.org#26139,"LUBANG BUAYA, CIPAYUNG, JAKARTA TIMUR, DKI JAKARTA",49,108,144,252
https://kawalpemilu.org#26139,"LUBANG BUAYA, CIPAYUNG, JAKARTA TIMUR, DKI JAKARTA",50,97,140,237
https://kawalpemilu.org#26139,"LUBANG BUAYA, CIPAYUNG, JAKARTA TIMUR, DKI JAKARTA",52,90,155,245
https://kawalpemilu.org#26139,"LUBANG BUAYA, CIPAYUNG, JAKARTA TIMUR, DKI JAKARTA",53,85,158,243
https://kawalpemilu.org#26139,"LUBANG BUAYA, CIPAYUNG, JAKARTA TIMUR, DKI JAKARTA",54,87,127,214
https://kawalpemilu.org#26139,"LUBANG BUAYA, CIPAYUNG, JAKARTA TIMUR, DKI JAKARTA",55,131,115,246
https://kawalpemilu.org#26139,"LUBANG BUAYA, CIPAYUNG, JAKARTA TIMUR, DKI JAKARTA",56,145,99,244
https://kawalpemilu.org#26139,"LUBANG BUAYA, CIPAYUNG, JAKARTA TIMUR, DKI JAKARTA",57,53,145,198
https://kawalpemilu.org#26139,"LUBANG BUAYA, CIPAYUNG, JAKARTA TIMUR, DKI JAKARTA",58,89,117,206
https://kawalpemilu.org#26139,"LUBANG BUAYA, CIPAYUNG, JAKARTA TIMUR, DKI JAKARTA",59,83,133,216
https://kawalpemilu.org#26139,"LUBANG BUAYA, CIPAYUNG, JAKARTA TIMUR, DKI JAKARTA",60,76,151,131
https://kawalpemilu.org#26139,"LUBANG BUAYA, CIPAYUNG, JAKARTA TIMUR, DKI JAKARTA",61,60,127,187
https://kawalpemilu.org#26139,"LUBANG BUAYA, CIPAYUNG, JAKARTA TIMUR, DKI JAKARTA",63,90,159,249
https://kawalpemilu.org#26139,"LUBANG BUAYA, CIPAYUNG, JAKARTA TIMUR, DKI JAKARTA",64,85,129,214
https://kawalpemilu.org#26139,"LUBANG BUAYA, CIPAYUNG, JAKARTA TIMUR, DKI JAKARTA",65,104,141,245
https://kawalpemilu.org#26139,"LUBANG BUAYA, CIPAYUNG, JAKARTA TIMUR, DKI JAKARTA",66,83,142,225
https://kawalpemilu.org#26139,"LUBANG BUAYA, CIPAYUNG, JAKARTA TIMUR, DKI JAKARTA",67,121,133,254
https://kawalpemilu.org#26139,"LUBANG BUAYA, CIPAYUNG, JAKARTA TIMUR, DKI JAKARTA",68,111,115,226
https://kawalpemilu.org#26139,"LUBANG BUAYA, CIPAYUNG, JAKARTA TIMUR, DKI JAKARTA",69,95,112,207
https://kawalpemilu.org#26139,"LUBANG BUAYA, CIPAYUNG, JAKARTA TIMUR, DKI JAKARTA",70,95,129,224
https://kawalpemilu.org#26139,"LUBANG BUAYA, CIPAYUNG, JAKARTA TIMUR, DKI JAKARTA",71,122,118,240
https://kawalpemilu.org#26139,"LUBANG BUAYA, CIPAYUNG, JAKARTA TIMUR, DKI JAKARTA",72,103,104,207
https://kawalpemilu.org#26139,"LUBANG BUAYA, CIPAYUNG, JAKARTA TIMUR, DKI JAKARTA",73,107,149,256
https://kawalpemilu.org#26139,"LUBANG BUAYA, CIPAYUNG, JAKARTA TIMUR, DKI JAKARTA",74,90,127,217
https://kawalpemilu.org#26139,"LUBANG BUAYA, CIPAYUNG, JAKARTA TIMUR, DKI JAKARTA",75,89,144,233
https://kawalpemilu.org#26139,"LUBANG BUAYA, CIPAYUNG, JAKARTA TIMUR, DKI JAKARTA",76,108,137,245
https://kawalpemilu.org#26139,"LUBANG BUAYA, CIPAYUNG, JAKARTA TIMUR, DKI JAKARTA",77,78,134,212
https://kawalpemilu.org#26139,"LUBANG BUAYA, CIPAYUNG, JAKARTA TIMUR, DKI JAKARTA",78,97,135,232
https://kawalpemilu.org#26139,"LUBANG BUAYA, CIPAYUNG, JAKARTA TIMUR, DKI JAKARTA",79,91,120,211
https://kawalpemilu.org#26139,"LUBANG BUAYA, CIPAYUNG, JAKARTA TIMUR, DKI JAKARTA",81,107,144,251
https://kawalpemilu.org#26139,"LUBANG BUAYA, CIPAYUNG, JAKARTA TIMUR, DKI JAKARTA",82,106,104,210
https://kawalpemilu.org#26139,"LUBANG BUAYA, CIPAYUNG, JAKARTA TIMUR, DKI JAKARTA",83,114,145,259
https://kawalpemilu.org#26139,"LUBANG BUAYA, CIPAYUNG, JAKARTA TIMUR, DKI JAKARTA",84,87,144,231
https://kawalpemilu.org#26139,"LUBANG BUAYA, CIPAYUNG, JAKARTA TIMUR, DKI JAKARTA",85,125,135,260
https://kawalpemilu.org#26139,"LUBANG BUAYA, CIPAYUNG, JAKARTA TIMUR, DKI JAKARTA",86,94,140,234
https://kawalpemilu.org#26139,"LUBANG BUAYA, CIPAYUNG, JAKARTA TIMUR, DKI JAKARTA",87,84,157,241
https://kawalpemilu.org#26139,"LUBANG BUAYA, CIPAYUNG, JAKARTA TIMUR, DKI JAKARTA",89,124,104,228
https://kawalpemilu.org#26139,"LUBANG BUAYA, CIPAYUNG, JAKARTA TIMUR, DKI JAKARTA",90,86,109,195
https://kawalpemilu.org#26139,"LUBANG BUAYA, CIPAYUNG, JAKARTA TIMUR, DKI JAKARTA",91,95,142,237
https://kawalpemilu.org#26139,"LUBANG BUAYA, CIPAYUNG, JAKARTA TIMUR, DKI JAKARTA",92,109,139,248
https://kawalpemilu.org#26139,"LUBANG BUAYA, CIPAYUNG, JAKARTA TIMUR, DKI JAKARTA",93,129,118,247
https://kawalpemilu.org#26139,"LUBANG BUAYA, CIPAYUNG, JAKARTA TIMUR, DKI JAKARTA",94,111,114,225
https://kawalpemilu.org#26139,"LUBANG BUAYA, CIPAYUNG, JAKARTA TIMUR, DKI JAKARTA",95,104,103,207
https://kawalpemilu.org#26139,"LUBANG BUAYA, CIPAYUNG, JAKARTA TIMUR, DKI JAKARTA",96,93,100,193
https://kawalpemilu.org#26139,"LUBANG BUAYA, CIPAYUNG, JAKARTA TIMUR, DKI JAKARTA",97,116,118,234
https://kawalpemilu.org#26139,"LUBANG BUAYA, CIPAYUNG, JAKARTA TIMUR, DKI JAKARTA",98,107,127,234
https://kawalpemilu.org#26139,"LUBANG BUAYA, CIPAYUNG, JAKARTA TIMUR, DKI JAKARTA",99,132,124,256
https://kawalpemilu.org#26139,"LUBANG BUAYA, CIPAYUNG, JAKARTA TIMUR, DKI JAKARTA",100,117,126,243
https://kawalpemilu.org#26139,"LUBANG BUAYA, CIPAYUNG, JAKARTA TIMUR, DKI JAKARTA",101,91,155,246
https://kawalpemilu.org#26139,"LUBANG BUAYA, CIPAYUNG, JAKARTA TIMUR, DKI JAKARTA",102,108,121,229
https://kawalpemilu.org#26139,"LUBANG BUAYA, CIPAYUNG, JAKARTA TIMUR, DKI JAKARTA",103,115,155,270
https://kawalpemilu.org#26139,"LUBANG BUAYA, CIPAYUNG, JAKARTA TIMUR, DKI JAKARTA",104,99,134,233
https://kawalpemilu.org#26139,"LUBANG BUAYA, CIPAYUNG, JAKARTA TIMUR, DKI JAKARTA",105,135,137,272
https://kawalpemilu.org#26139,"LUBANG BUAYA, CIPAYUNG, JAKARTA TIMUR, DKI JAKARTA",106,131,121,252
https://kawalpemilu.org#26139,"LUBANG BUAYA, CIPAYUNG, JAKARTA TIMUR, DKI JAKARTA",107,134,131,265
https://kawalpemilu.org#26139,"LUBANG BUAYA, CIPAYUNG, JAKARTA TIMUR, DKI JAKARTA",108,112,140,252
https://kawalpemilu.org#26139,"LUBANG BUAYA, CIPAYUNG, JAKARTA TIMUR, DKI JAKARTA",109,93,166,259
https://kawalpemilu.org#26139,"LUBANG BUAYA, CIPAYUNG, JAKARTA TIMUR, DKI JAKARTA",110,96,150,246
https://kawalpemilu.org#26139,"LUBANG BUAYA, CIPAYUNG, JAKARTA TIMUR, DKI JAKARTA",111,90,162,254
https://kawalpemilu.org#26139,"LUBANG BUAYA, CIPAYUNG, JAKARTA TIMUR, DKI JAKARTA",112,72,182,254
https://kawalpemilu.org#26139,"LUBANG BUAYA, CIPAYUNG, JAKARTA TIMUR, DKI JAKARTA",113,79,142,221
https://kawalpemilu.org#26139,"LUBANG BUAYA, CIPAYUNG, JAKARTA TIMUR, DKI JAKARTA",114,101,146,247
https://kawalpemilu.org#26139,"LUBANG BUAYA, CIPAYUNG, JAKARTA TIMUR, DKI JAKARTA",115,77,156,233
https://kawalpemilu.org#26139,"LUBANG BUAYA, CIPAYUNG, JAKARTA TIMUR, DKI JAKARTA",116,100,125,225
https://kawalpemilu.org#26139,"LUBANG BUAYA, CIPAYUNG, JAKARTA TIMUR, DKI JAKARTA",117,104,133,237
https://kawalpemilu.org#26139,"LUBANG BUAYA, CIPAYUNG, JAKARTA TIMUR, DKI JAKARTA",118,92,95,187
https://kawalpemilu.org#26139,"LUBANG BUAYA, CIPAYUNG, JAKARTA TIMUR, DKI JAKARTA",119,95,146,241
https://kawalpemilu.org#26139,"LUBANG BUAYA, CIPAYUNG, JAKARTA TIMUR, DKI JAKARTA",120,99,126,225
https://kawalpemilu.org#26139,"LUBANG BUAYA, CIPAYUNG, JAKARTA TIMUR, DKI JAKARTA",121,77,132,209
https://kawalpemilu.org#26139,"LUBANG BUAYA, CIPAYUNG, JAKARTA TIMUR, DKI JAKARTA",122,66,115,181
https://kawalpemilu.org#26139,"LUBANG BUAYA, CIPAYUNG, JAKARTA TIMUR, DKI JAKARTA",123,150,120,270
https://kawalpemilu.org#26139,"LUBANG BUAYA, CIPAYUNG, JAKARTA TIMUR, DKI JAKARTA",124,92,141,233
https://kawalpemilu.org#26139,"LUBANG BUAYA, CIPAYUNG, JAKARTA TIMUR, DKI JAKARTA",125,116,104,220
https://kawalpemilu.org#26139,"LUBANG BUAYA, CIPAYUNG, JAKARTA TIMUR, DKI JAKARTA",126,93,118,211
https://kawalpemilu.org#26139,"LUBANG BUAYA, CIPAYUNG, JAKARTA TIMUR, DKI JAKARTA",127,56,184,240
https://kawalpemilu.org#26139,"LUBANG BUAYA, CIPAYUNG, JAKARTA TIMUR, DKI JAKARTA",128,0,0,221
https://kawalpemilu.org#26139,"LUBANG BUAYA, CIPAYUNG, JAKARTA TIMUR, DKI JAKARTA",129,92,165,257
https://kawalpemilu.org#26139,"LUBANG BUAYA, CIPAYUNG, JAKARTA TIMUR, DKI JAKARTA",131,74,138,212
https://kawalpemilu.org#26139,"LUBANG BUAYA, CIPAYUNG, JAKARTA TIMUR, DKI JAKARTA",132,47,148,195
https://kawalpemilu.org#26139,"LUBANG BUAYA, CIPAYUNG, JAKARTA TIMUR, DKI JAKARTA",133,41,162,203
https://kawalpemilu.org#26139,"LUBANG BUAYA, CIPAYUNG, JAKARTA TIMUR, DKI JAKARTA",134,97,51,148
https://kawalpemilu.org#26139,"LUBANG BUAYA, CIPAYUNG, JAKARTA TIMUR, DKI JAKARTA",135,84,117,201
https://kawalpemilu.org#26139,"LUBANG BUAYA, CIPAYUNG, JAKARTA TIMUR, DKI JAKARTA",136,85,95,180
https://kawalpemilu.org#26139,"LUBANG BUAYA, CIPAYUNG, JAKARTA TIMUR, DKI JAKARTA",137,91,129,220
https://kawalpemilu.org#26139,"LUBANG BUAYA, CIPAYUNG, JAKARTA TIMUR, DKI JAKARTA",138,87,105,192
https://kawalpemilu.org#26139,"LUBANG BUAYA, CIPAYUNG, JAKARTA TIMUR, DKI JAKARTA",139,120,124,244
https://kawalpemilu.org#26139,"LUBANG BUAYA, CIPAYUNG, JAKARTA TIMUR, DKI JAKARTA",140,99,153,252
https://kawalpemilu.org#26139,"LUBANG BUAYA, CIPAYUNG, JAKARTA TIMUR, DKI JAKARTA",141,123,138,261
https://kawalpemilu.org#26139,"LUBANG BUAYA, CIPAYUNG, JAKARTA TIMUR, DKI JAKARTA",142,79,131,210
https://kawalpemilu.org#26139,"LUBANG BUAYA, CIPAYUNG, JAKARTA TIMUR, DKI JAKARTA",143,117,130,247
https://kawalpemilu.org#26139,"LUBANG BUAYA, CIPAYUNG, JAKARTA TIMUR, DKI JAKARTA",145,142,107,249
https://kawalpemilu.org#26139,"LUBANG BUAYA, CIPAYUNG, JAKARTA TIMUR, DKI JAKARTA",146,74,164,238
https://kawalpemilu.org#26139,"LUBANG BUAYA, CIPAYUNG, JAKARTA TIMUR, DKI JAKARTA",147,110,124,234
https://kawalpemilu.org#26139,"LUBANG BUAYA, CIPAYUNG, JAKARTA TIMUR, DKI JAKARTA",148,93,123,216
https://kawalpemilu.org#26139,"LUBANG BUAYA, CIPAYUNG, JAKARTA TIMUR, DKI JAKARTA",149,117,147,264
https://kawalpemilu.org#26139,"LUBANG BUAYA, CIPAYUNG, JAKARTA TIMUR, DKI JAKARTA",150,105,129,234
https://kawalpemilu.org#26139,"LUBANG BUAYA, CIPAYUNG, JAKARTA TIMUR, DKI JAKARTA",151,73,141,214
https://kawalpemilu.org#26139,"LUBANG BUAYA, CIPAYUNG, JAKARTA TIMUR, DKI JAKARTA",152,115,122,237
https://kawalpemilu.org#26139,"LUBANG BUAYA, CIPAYUNG, JAKARTA TIMUR, DKI JAKARTA",153,125,132,257
https://kawalpemilu.org#26139,"LUBANG BUAYA, CIPAYUNG, JAKARTA TIMUR, DKI JAKARTA",154,83,165,248
https://kawalpemilu.org#26139,"LUBANG BUAYA, CIPAYUNG, JAKARTA TIMUR, DKI JAKARTA",155,151,104,255
https://kawalpemilu.org#26139,"LUBANG BUAYA, CIPAYUNG, JAKARTA TIMUR, DKI JAKARTA",156,92,126,218
https://kawalpemilu.org#26139,"LUBANG BUAYA, CIPAYUNG, JAKARTA TIMUR, DKI JAKARTA",157,87,98,185
https://kawalpemilu.org#26139,"LUBANG BUAYA, CIPAYUNG, JAKARTA TIMUR, DKI JAKARTA",158,105,118,223
https://kawalpemilu.org#26139,"LUBANG BUAYA, CIPAYUNG, JAKARTA TIMUR, DKI JAKARTA",159,105,141,246
https://kawalpemilu.org#26139,"LUBANG BUAYA, CIPAYUNG, JAKARTA TIMUR, DKI JAKARTA",160,112,107,219
https://kawalpemilu.org#26139,"LUBANG BUAYA, CIPAYUNG, JAKARTA TIMUR, DKI JAKARTA",161,147,110,257
https://kawalpemilu.org#26139,"LUBANG BUAYA, CIPAYUNG, JAKARTA TIMUR, DKI JAKARTA",162,122,121,243
https://kawalpemilu.org#26139,"LUBANG BUAYA, CIPAYUNG, JAKARTA TIMUR, DKI JAKARTA",163,131,116,247
https://kawalpemilu.org#26139,"LUBANG BUAYA, CIPAYUNG, JAKARTA TIMUR, DKI JAKARTA",165,95,147,242
https://kawalpemilu.org#26139,"LUBANG BUAYA, CIPAYUNG, JAKARTA TIMUR, DKI JAKARTA",166,95,142,237
https://kawalpemilu.org#26139,"LUBANG BUAYA, CIPAYUNG, JAKARTA TIMUR, DKI JAKARTA",167,96,162,258
https://kawalpemilu.org#26139,"LUBANG BUAYA, CIPAYUNG, JAKARTA TIMUR, DKI JAKARTA",168,117,128,245
https://kawalpemilu.org#26139,"LUBANG BUAYA, CIPAYUNG, JAKARTA TIMUR, DKI JAKARTA",169,96,104,200
https://kawalpemilu.org#26139,"LUBANG BUAYA, CIPAYUNG, JAKARTA TIMUR, DKI JAKARTA",170,119,134,253
https://kawalpemilu.org#26139,"LUBANG BUAYA, CIPAYUNG, JAKARTA TIMUR, DKI JAKARTA",171,116,122,238
https://kawalpemilu.org#26139,"LUBANG BUAYA, CIPAYUNG, JAKARTA TIMUR, DKI JAKARTA",172,83,107,190
https://kawalpemilu.org#26139,"LUBANG BUAYA, CIPAYUNG, JAKARTA TIMUR, DKI JAKARTA",173,106,135,241
https://kawalpemilu.org#26139,"LUBANG BUAYA, CIPAYUNG, JAKARTA TIMUR, DKI JAKARTA",174,106,163,269
https://kawalpemilu.org#26139,"LUBANG BUAYA, CIPAYUNG, JAKARTA TIMUR, DKI JAKARTA",175,95,138,233
https://kawalpemilu.org#26139,"LUBANG BUAYA, CIPAYUNG, JAKARTA TIMUR, DKI JAKARTA",176,93,113,206
https://kawalpemilu.org#26139,"LUBANG BUAYA, CIPAYUNG, JAKARTA TIMUR, DKI JAKARTA",177,134,110,244
https://kawalpemilu.org#26139,"LUBANG BUAYA, CIPAYUNG, JAKARTA TIMUR, DKI JAKARTA",178,136,109,245
https://kawalpemilu.org#26139,"LUBANG BUAYA, CIPAYUNG, JAKARTA TIMUR, DKI JAKARTA",180,102,135,237
https://kawalpemilu.org#26139,"LUBANG BUAYA, CIPAYUNG, JAKARTA TIMUR, DKI JAKARTA",181,113,142,255
https://kawalpemilu.org#26139,"LUBANG BUAYA, CIPAYUNG, JAKARTA TIMUR, DKI JAKARTA",182,87,136,223
https://kawalpemilu.org#26139,"LUBANG BUAYA, CIPAYUNG, JAKARTA TIMUR, DKI JAKARTA",183,120,104,224
https://kawalpemilu.org#26139,"LUBANG BUAYA, CIPAYUNG, JAKARTA TIMUR, DKI JAKARTA",184,105,98,203
https://kawalpemilu.org#26139,"LUBANG BUAYA, CIPAYUNG, JAKARTA TIMUR, DKI JAKARTA",185,148,86,234
https://kawalpemilu.org#26139,"LUBANG BUAYA, CIPAYUNG, JAKARTA TIMUR, DKI JAKARTA",186,107,84,191
https://kawalpemilu.org#26139,"LUBANG BUAYA, CIPAYUNG, JAKARTA TIMUR, DKI JAKARTA",187,129,109,238
https://kawalpemilu.org#26139,"LUBANG BUAYA, CIPAYUNG, JAKARTA TIMUR, DKI JAKARTA",188,116,88,204
https://kawalpemilu.org#26139,"LUBANG BUAYA, CIPAYUNG, JAKARTA TIMUR, DKI JAKARTA",189,109,91,200
https://kawalpemilu.org#26139,"LUBANG BUAYA, CIPAYUNG, JAKARTA TIMUR, DKI JAKARTA",190,124,115,239
https://kawalpemilu.org#26139,"LUBANG BUAYA, CIPAYUNG, JAKARTA TIMUR, DKI JAKARTA",191,149,90,239
https://kawalpemilu.org#26139,"LUBANG BUAYA, CIPAYUNG, JAKARTA TIMUR, DKI JAKARTA",192,98,120,218
https://kawalpemilu.org#26139,"LUBANG BUAYA, CIPAYUNG, JAKARTA TIMUR, DKI JAKARTA",193,105,93,198
https://kawalpemilu.org#26139,"LUBANG BUAYA, CIPAYUNG, JAKARTA TIMUR, DKI JAKARTA",194,145,78,223
https://kawalpemilu.org#26139,"LUBANG BUAYA, CIPAYUNG, JAKARTA TIMUR, DKI JAKARTA",195,89,143,232
https://kawalpemilu.org#26139,"LUBANG BUAYA, CIPAYUNG, JAKARTA TIMUR, DKI JAKARTA",196,106,144,250
https://kawalpemilu.org#26139,"LUBANG BUAYA, CIPAYUNG, JAKARTA TIMUR, DKI JAKARTA",197,108,134,242
https://kawalpemilu.org#26139,"LUBANG BUAYA, CIPAYUNG, JAKARTA TIMUR, DKI JAKARTA",198,72,78,150
https://kawalpemilu.org#26140,"CEGER, CIPAYUNG, JAKARTA TIMUR, DKI JAKARTA",1,103,112,215
https://kawalpemilu.org#26140,"CEGER, CIPAYUNG, JAKARTA TIMUR, DKI JAKARTA",2,84,129,213
https://kawalpemilu.org#26140,"CEGER, CIPAYUNG, JAKARTA TIMUR, DKI JAKARTA",3,116,91,207
https://kawalpemilu.org#26140,"CEGER, CIPAYUNG, JAKARTA TIMUR, DKI JAKARTA",4,109,151,260
https://kawalpemilu.org#26140,"CEGER, CIPAYUNG, JAKARTA TIMUR, DKI JAKARTA",5,106,134,240
https://kawalpemilu.org#26140,"CEGER, CIPAYUNG, JAKARTA TIMUR, DKI JAKARTA",6,87,150,237
https://kawalpemilu.org#26140,"CEGER, CIPAYUNG, JAKARTA TIMUR, DKI JAKARTA",7,100,143,243
https://kawalpemilu.org#26140,"CEGER, CIPAYUNG, JAKARTA TIMUR, DKI JAKARTA",9,95,162,257
https://kawalpemilu.org#26140,"CEGER, CIPAYUNG, JAKARTA TIMUR, DKI JAKARTA",11,114,129,243
https://kawalpemilu.org#26140,"CEGER, CIPAYUNG, JAKARTA TIMUR, DKI JAKARTA",12,92,128,220
https://kawalpemilu.org#26140,"CEGER, CIPAYUNG, JAKARTA TIMUR, DKI JAKARTA",13,106,111,217
https://kawalpemilu.org#26140,"CEGER, CIPAYUNG, JAKARTA TIMUR, DKI JAKARTA",14,98,115,213
https://kawalpemilu.org#26140,"CEGER, CIPAYUNG, JAKARTA TIMUR, DKI JAKARTA",15,110,97,207
https://kawalpemilu.org#26140,"CEGER, CIPAYUNG, JAKARTA TIMUR, DKI JAKARTA",17,62,160,222
https://kawalpemilu.org#26140,"CEGER, CIPAYUNG, JAKARTA TIMUR, DKI JAKARTA",18,100,127,227
https://kawalpemilu.org#26140,"CEGER, CIPAYUNG, JAKARTA TIMUR, DKI JAKARTA",19,107,121,228
https://kawalpemilu.org#26140,"CEGER, CIPAYUNG, JAKARTA TIMUR, DKI JAKARTA",20,131,123,254
https://kawalpemilu.org#26140,"CEGER, CIPAYUNG, JAKARTA TIMUR, DKI JAKARTA",21,100,167,267
https://kawalpemilu.org#26140,"CEGER, CIPAYUNG, JAKARTA TIMUR, DKI JAKARTA",22,146,101,247
https://kawalpemilu.org#26140,"CEGER, CIPAYUNG, JAKARTA TIMUR, DKI JAKARTA",23,143,83,226
https://kawalpemilu.org#26140,"CEGER, CIPAYUNG, JAKARTA TIMUR, DKI JAKARTA",24,103,122,225
https://kawalpemilu.org#26140,"CEGER, CIPAYUNG, JAKARTA TIMUR, DKI JAKARTA",25,114,91,205
https://kawalpemilu.org#26140,"CEGER, CIPAYUNG, JAKARTA TIMUR, DKI JAKARTA",26,60,163,223
https://kawalpemilu.org#26140,"CEGER, CIPAYUNG, JAKARTA TIMUR, DKI JAKARTA",27,170,68,238
https://kawalpemilu.org#26140,"CEGER, CIPAYUNG, JAKARTA TIMUR, DKI JAKARTA",28,104,120,224
https://kawalpemilu.org#26140,"CEGER, CIPAYUNG, JAKARTA TIMUR, DKI JAKARTA",29,108,104,212
https://kawalpemilu.org#26140,"CEGER, CIPAYUNG, JAKARTA TIMUR, DKI JAKARTA",30,116,103,219
https://kawalpemilu.org#26140,"CEGER, CIPAYUNG, JAKARTA TIMUR, DKI JAKARTA",31,112,72,184
https://kawalpemilu.org#26140,"CEGER, CIPAYUNG, JAKARTA TIMUR, DKI JAKARTA",32,102,107,209
https://kawalpemilu.org#26140,"CEGER, CIPAYUNG, JAKARTA TIMUR, DKI JAKARTA",34,117,112,229
https://kawalpemilu.org#26140,"CEGER, CIPAYUNG, JAKARTA TIMUR, DKI JAKARTA",35,108,122,230
https://kawalpemilu.org#26140,"CEGER, CIPAYUNG, JAKARTA TIMUR, DKI JAKARTA",36,101,141,242
https://kawalpemilu.org#26140,"CEGER, CIPAYUNG, JAKARTA TIMUR, DKI JAKARTA",37,114,131,245
https://kawalpemilu.org#26140,"CEGER, CIPAYUNG, JAKARTA TIMUR, DKI JAKARTA",38,95,106,201
https://kawalpemilu.org#26140,"CEGER, CIPAYUNG, JAKARTA TIMUR, DKI JAKARTA",39,100,81,181
https://kawalpemilu.org#26140,"CEGER, CIPAYUNG, JAKARTA TIMUR, DKI JAKARTA",40,121,144,265
https://kawalpemilu.org#26140,"CEGER, CIPAYUNG, JAKARTA TIMUR, DKI JAKARTA",41,131,138,269
https://kawalpemilu.org#26140,"CEGER, CIPAYUNG, JAKARTA TIMUR, DKI JAKARTA",42,65,178,243
https://kawalpemilu.org#26140,"CEGER, CIPAYUNG, JAKARTA TIMUR, DKI JAKARTA",43,82,177,259
https://kawalpemilu.org#26140,"CEGER, CIPAYUNG, JAKARTA TIMUR, DKI JAKARTA",44,90,102,192
https://kawalpemilu.org#26140,"CEGER, CIPAYUNG, JAKARTA TIMUR, DKI JAKARTA",45,79,144,223
https://kawalpemilu.org#26140,"CEGER, CIPAYUNG, JAKARTA TIMUR, DKI JAKARTA",46,79,170,249
https://kawalpemilu.org#26140,"CEGER, CIPAYUNG, JAKARTA TIMUR, DKI JAKARTA",47,96,124,220
https://kawalpemilu.org#26140,"CEGER, CIPAYUNG, JAKARTA TIMUR, DKI JAKARTA",48,66,111,177
https://kawalpemilu.org#26140,"CEGER, CIPAYUNG, JAKARTA TIMUR, DKI JAKARTA",49,82,136,218
https://kawalpemilu.org#26140,"CEGER, CIPAYUNG, JAKARTA TIMUR, DKI JAKARTA",50,91,125,216
https://kawalpemilu.org#26140,"CEGER, CIPAYUNG, JAKARTA TIMUR, DKI JAKARTA",52,96,154,250
https://kawalpemilu.org#26140,"CEGER, CIPAYUNG, JAKARTA TIMUR, DKI JAKARTA",53,95,97,192
https://kawalpemilu.org#26140,"CEGER, CIPAYUNG, JAKARTA TIMUR, DKI JAKARTA",54,139,113,252
https://kawalpemilu.org#26140,"CEGER, CIPAYUNG, JAKARTA TIMUR, DKI JAKARTA",55,97,138,235
https://kawalpemilu.org#26140,"CEGER, CIPAYUNG, JAKARTA TIMUR, DKI JAKARTA",56,202,71,273
https://kawalpemilu.org#26140,"CEGER, CIPAYUNG, JAKARTA TIMUR, DKI JAKARTA",57,111,146,257
https://kawalpemilu.org#26140,"CEGER, CIPAYUNG, JAKARTA TIMUR, DKI JAKARTA",58,131,91,222
https://kawalpemilu.org#26140,"CEGER, CIPAYUNG, JAKARTA TIMUR, DKI JAKARTA",59,214,47,261
https://kawalpemilu.org#26140,"CEGER, CIPAYUNG, JAKARTA TIMUR, DKI JAKARTA",60,106,138,244
