Link KawalPemilu,Nama Kelurahan,Nomor TPS,Suara 01,Suara 02,Suara Sah
https://kawalpemilu.org#60374,"CANDI, KUMAI, KOTAWARINGIN BARAT, KALIMANTAN TENGAH",1,77,183,260
https://kawalpemilu.org#60374,"CANDI, KUMAI, KOTAWARINGIN BARAT, KALIMANTAN TENGAH",2,82,194,276
https://kawalpemilu.org#60374,"CANDI, KUMAI, KOTAWARINGIN BARAT, KALIMANTAN TENGAH",3,84,141,225
https://kawalpemilu.org#60374,"CANDI, KUMAI, KOTAWARINGIN BARAT, KALIMANTAN TENGAH",4,70,170,240
https://kawalpemilu.org#60374,"CANDI, KUMAI, KOTAWARINGIN BARAT, KALIMANTAN TENGAH",5,60,220,280
https://kawalpemilu.org#60374,"CANDI, KUMAI, KOTAWARINGIN BARAT, KALIMANTAN TENGAH",6,21,199,220
https://kawalpemilu.org#60374,"CANDI, KUMAI, KOTAWARINGIN BARAT, KALIMANTAN TENGAH",7,36,237,273
https://kawalpemilu.org#60374,"CANDI, KUMAI, KOTAWARINGIN BARAT, KALIMANTAN TENGAH",8,31,232,263
https://kawalpemilu.org#60374,"CANDI, KUMAI, KOTAWARINGIN BARAT, KALIMANTAN TENGAH",9,63,149,212
https://kawalpemilu.org#60374,"CANDI, KUMAI, KOTAWARINGIN BARAT, KALIMANTAN TENGAH",10,66,158,224
https://kawalpemilu.org#60375,"KUMAI HULU, KUMAI, KOTAWARINGIN BARAT, KALIMANTAN TENGAH",1,121,73,194
https://kawalpemilu.org#60375,"KUMAI HULU, KUMAI, KOTAWARINGIN BARAT, KALIMANTAN TENGAH",2,77,61,138
https://kawalpemilu.org#60375,"KUMAI HULU, KUMAI, KOTAWARINGIN BARAT, KALIMANTAN TENGAH",3,93,128,221
https://kawalpemilu.org#60375,"KUMAI HULU, KUMAI, KOTAWARINGIN BARAT, KALIMANTAN TENGAH",4,114,113,227
https://kawalpemilu.org#60375,"KUMAI HULU, KUMAI, KOTAWARINGIN BARAT, KALIMANTAN TENGAH",5,65,76,141
https://kawalpemilu.org#60375,"KUMAI HULU, KUMAI, KOTAWARINGIN BARAT, KALIMANTAN TENGAH",6,120,88,208
https://kawalpemilu.org#60375,"KUMAI HULU, KUMAI, KOTAWARINGIN BARAT, KALIMANTAN TENGAH",7,69,93,162
https://kawalpemilu.org#60375,"KUMAI HULU, KUMAI, KOTAWARINGIN BARAT, KALIMANTAN TENGAH",8,69,79,148
https://kawalpemilu.org#60375,"KUMAI HULU, KUMAI, KOTAWARINGIN BARAT, KALIMANTAN TENGAH",9,69,81,150
https://kawalpemilu.org#60375,"KUMAI HULU, KUMAI, KOTAWARINGIN BARAT, KALIMANTAN TENGAH",10,65,95,160
https://kawalpemilu.org#60375,"KUMAI HULU, KUMAI, KOTAWARINGIN BARAT, KALIMANTAN TENGAH",11,59,116,175
https://kawalpemilu.org#60375,"KUMAI HULU, KUMAI, KOTAWARINGIN BARAT, KALIMANTAN TENGAH",12,67,75,142
https://kawalpemilu.org#60375,"KUMAI HULU, KUMAI, KOTAWARINGIN BARAT, KALIMANTAN TENGAH",13,83,67,150
https://kawalpemilu.org#60375,"KUMAI HULU, KUMAI, KOTAWARINGIN BARAT, KALIMANTAN TENGAH",14,71,90,161
https://kawalpemilu.org#60375,"KUMAI HULU, KUMAI, KOTAWARINGIN BARAT, KALIMANTAN TENGAH",15,115,103,218
https://kawalpemilu.org#60375,"KUMAI HULU, KUMAI, KOTAWARINGIN BARAT, KALIMANTAN TENGAH",16,66,112,178
https://kawalpemilu.org#60375,"KUMAI HULU, KUMAI, KOTAWARINGIN BARAT, KALIMANTAN TENGAH",17,83,101,184
https://kawalpemilu.org#60375,"KUMAI HULU, KUMAI, KOTAWARINGIN BARAT, KALIMANTAN TENGAH",18,64,40,104
https://kawalpemilu.org#60375,"KUMAI HULU, KUMAI, KOTAWARINGIN BARAT, KALIMANTAN TENGAH",19,22,29,51
https://kawalpemilu.org#60375,"KUMAI HULU, KUMAI, KOTAWARINGIN BARAT, KALIMANTAN TENGAH",20,78,75,153
https://kawalpemilu.org#60375,"KUMAI HULU, KUMAI, KOTAWARINGIN BARAT, KALIMANTAN TENGAH",21,67,75,142
https://kawalpemilu.org#60375,"KUMAI HULU, KUMAI, KOTAWARINGIN BARAT, KALIMANTAN TENGAH",22,39,62,101
https://kawalpemilu.org#60375,"KUMAI HULU, KUMAI, KOTAWARINGIN BARAT, KALIMANTAN TENGAH",23,77,71,148
https://kawalpemilu.org#60375,"KUMAI HULU, KUMAI, KOTAWARINGIN BARAT, KALIMANTAN TENGAH",24,83,98,181
https://kawalpemilu.org#60375,"KUMAI HULU, KUMAI, KOTAWARINGIN BARAT, KALIMANTAN TENGAH",25,67,67,134
https://kawalpemilu.org#60375,"KUMAI HULU, KUMAI, KOTAWARINGIN BARAT, KALIMANTAN TENGAH",26,58,93,151
https://kawalpemilu.org#60375,"KUMAI HULU, KUMAI, KOTAWARINGIN BARAT, KALIMANTAN TENGAH",27,69,86,155
https://kawalpemilu.org#60376,"KUMAI HILIR, KUMAI, KOTAWARINGIN BARAT, KALIMANTAN TENGAH",1,110,103,213
https://kawalpemilu.org#60376,"KUMAI HILIR, KUMAI, KOTAWARINGIN BARAT, KALIMANTAN TENGAH",2,84,133,217
https://kawalpemilu.org#60376,"KUMAI HILIR, KUMAI, KOTAWARINGIN BARAT, KALIMANTAN TENGAH",3,81,131,212
https://kawalpemilu.org#60376,"KUMAI HILIR, KUMAI, KOTAWARINGIN BARAT, KALIMANTAN TENGAH",4,74,86,160
https://kawalpemilu.org#60376,"KUMAI HILIR, KUMAI, KOTAWARINGIN BARAT, KALIMANTAN TENGAH",5,88,105,193
https://kawalpemilu.org#60376,"KUMAI HILIR, KUMAI, KOTAWARINGIN BARAT, KALIMANTAN TENGAH",6,49,94,143
https://kawalpemilu.org#60376,"KUMAI HILIR, KUMAI, KOTAWARINGIN BARAT, KALIMANTAN TENGAH",7,66,122,188
https://kawalpemilu.org#60376,"KUMAI HILIR, KUMAI, KOTAWARINGIN BARAT, KALIMANTAN TENGAH",8,33,100,133
https://kawalpemilu.org#60376,"KUMAI HILIR, KUMAI, KOTAWARINGIN BARAT, KALIMANTAN TENGAH",9,66,109,175
https://kawalpemilu.org#60376,"KUMAI HILIR, KUMAI, KOTAWARINGIN BARAT, KALIMANTAN TENGAH",10,63,81,144
https://kawalpemilu.org#60376,"KUMAI HILIR, KUMAI, KOTAWARINGIN BARAT, KALIMANTAN TENGAH",11,63,89,152
https://kawalpemilu.org#60376,"KUMAI HILIR, KUMAI, KOTAWARINGIN BARAT, KALIMANTAN TENGAH",12,72,114,186
https://kawalpemilu.org#60376,"KUMAI HILIR, KUMAI, KOTAWARINGIN BARAT, KALIMANTAN TENGAH",13,107,102,209
https://kawalpemilu.org#60376,"KUMAI HILIR, KUMAI, KOTAWARINGIN BARAT, KALIMANTAN TENGAH",14,59,83,142
https://kawalpemilu.org#60376,"KUMAI HILIR, KUMAI, KOTAWARINGIN BARAT, KALIMANTAN TENGAH",15,58,112,170
https://kawalpemilu.org#60376,"KUMAI HILIR, KUMAI, KOTAWARINGIN BARAT, KALIMANTAN TENGAH",16,59,95,154
https://kawalpemilu.org#60376,"KUMAI HILIR, KUMAI, KOTAWARINGIN BARAT, KALIMANTAN TENGAH",17,120,19,139
https://kawalpemilu.org#60376,"KUMAI HILIR, KUMAI, KOTAWARINGIN BARAT, KALIMANTAN TENGAH",18,94,106,200
https://kawalpemilu.org#60376,"KUMAI HILIR, KUMAI, KOTAWARINGIN BARAT, KALIMANTAN TENGAH",19,65,112,177
https://kawalpemilu.org#60376,"KUMAI HILIR, KUMAI, KOTAWARINGIN BARAT, KALIMANTAN TENGAH",20,27,90,117
https://kawalpemilu.org#60376,"KUMAI HILIR, KUMAI, KOTAWARINGIN BARAT, KALIMANTAN TENGAH",21,47,79,126
https://kawalpemilu.org#60376,"KUMAI HILIR, KUMAI, KOTAWARINGIN BARAT, KALIMANTAN TENGAH",22,86,146,232
https://kawalpemilu.org#60376,"KUMAI HILIR, KUMAI, KOTAWARINGIN BARAT, KALIMANTAN TENGAH",23,47,102,149
https://kawalpemilu.org#60376,"KUMAI HILIR, KUMAI, KOTAWARINGIN BARAT, KALIMANTAN TENGAH",24,43,95,138
https://kawalpemilu.org#60376,"KUMAI HILIR, KUMAI, KOTAWARINGIN BARAT, KALIMANTAN TENGAH",25,72,79,151
https://kawalpemilu.org#60376,"KUMAI HILIR, KUMAI, KOTAWARINGIN BARAT, KALIMANTAN TENGAH",26,96,114,210
https://kawalpemilu.org#60376,"KUMAI HILIR, KUMAI, KOTAWARINGIN BARAT, KALIMANTAN TENGAH",27,45,80,125
https://kawalpemilu.org#60376,"KUMAI HILIR, KUMAI, KOTAWARINGIN BARAT, KALIMANTAN TENGAH",28,59,80,139
https://kawalpemilu.org#60376,"KUMAI HILIR, KUMAI, KOTAWARINGIN BARAT, KALIMANTAN TENGAH",29,54,84,138
https://kawalpemilu.org#60376,"KUMAI HILIR, KUMAI, KOTAWARINGIN BARAT, KALIMANTAN TENGAH",30,94,26,120
https://kawalpemilu.org#60377,"SUNGAI CABANG, KUMAI, KOTAWARINGIN BARAT, KALIMANTAN TENGAH",1,49,116,165
https://kawalpemilu.org#60377,"SUNGAI CABANG, KUMAI, KOTAWARINGIN BARAT, KALIMANTAN TENGAH",2,64,68,132
https://kawalpemilu.org#60377,"SUNGAI CABANG, KUMAI, KOTAWARINGIN BARAT, KALIMANTAN TENGAH",3,41,99,140
https://kawalpemilu.org#60378,"TELUK PULAI, KUMAI, KOTAWARINGIN BARAT, KALIMANTAN TENGAH",1,40,156,196
https://kawalpemilu.org#60379,"SEBUAI, KUMAI, KOTAWARINGIN BARAT, KALIMANTAN TENGAH",1,92,111,203
https://kawalpemilu.org#60379,"SEBUAI, KUMAI, KOTAWARINGIN BARAT, KALIMANTAN TENGAH",2,60,76,136
https://kawalpemilu.org#60380,"KERAYA, KUMAI, KOTAWARINGIN BARAT, KALIMANTAN TENGAH",2,47,121,168
https://kawalpemilu.org#60381,"TELUK BOGAM, KUMAI, KOTAWARINGIN BARAT, KALIMANTAN TENGAH",1,109,118,227
https://kawalpemilu.org#60381,"TELUK BOGAM, KUMAI, KOTAWARINGIN BARAT, KALIMANTAN TENGAH",3,70,123,193
https://kawalpemilu.org#60381,"TELUK BOGAM, KUMAI, KOTAWARINGIN BARAT, KALIMANTAN TENGAH",4,72,106,178
https://kawalpemilu.org#60382,"SUNGAI BAKAU, KUMAI, KOTAWARINGIN BARAT, KALIMANTAN TENGAH",1,117,108,6
https://kawalpemilu.org#60382,"SUNGAI BAKAU, KUMAI, KOTAWARINGIN BARAT, KALIMANTAN TENGAH",2,82,111,193
https://kawalpemilu.org#60382,"SUNGAI BAKAU, KUMAI, KOTAWARINGIN BARAT, KALIMANTAN TENGAH",3,117,81,198
https://kawalpemilu.org#60382,"SUNGAI BAKAU, KUMAI, KOTAWARINGIN BARAT, KALIMANTAN TENGAH",4,66,68,134
https://kawalpemilu.org#60382,"SUNGAI BAKAU, KUMAI, KOTAWARINGIN BARAT, KALIMANTAN TENGAH",5,76,140,216
https://kawalpemilu.org#60382,"SUNGAI BAKAU, KUMAI, KOTAWARINGIN BARAT, KALIMANTAN TENGAH",6,62,21,83
https://kawalpemilu.org#60383,"KUBU, KUMAI, KOTAWARINGIN BARAT, KALIMANTAN TENGAH",1,102,86,188
https://kawalpemilu.org#60383,"KUBU, KUMAI, KOTAWARINGIN BARAT, KALIMANTAN TENGAH",2,99,85,184
https://kawalpemilu.org#60383,"KUBU, KUMAI, KOTAWARINGIN BARAT, KALIMANTAN TENGAH",3,92,72,164
https://kawalpemilu.org#60383,"KUBU, KUMAI, KOTAWARINGIN BARAT, KALIMANTAN TENGAH",4,65,79,144
https://kawalpemilu.org#60383,"KUBU, KUMAI, KOTAWARINGIN BARAT, KALIMANTAN TENGAH",5,66,85,151
https://kawalpemilu.org#60383,"KUBU, KUMAI, KOTAWARINGIN BARAT, KALIMANTAN TENGAH",6,77,105,182
https://kawalpemilu.org#60383,"KUBU, KUMAI, KOTAWARINGIN BARAT, KALIMANTAN TENGAH",7,52,82,134
https://kawalpemilu.org#60383,"KUBU, KUMAI, KOTAWARINGIN BARAT, KALIMANTAN TENGAH",8,44,58,102
https://kawalpemilu.org#60383,"KUBU, KUMAI, KOTAWARINGIN BARAT, KALIMANTAN TENGAH",9,61,98,159
https://kawalpemilu.org#60383,"KUBU, KUMAI, KOTAWARINGIN BARAT, KALIMANTAN TENGAH",10,55,89,144
https://kawalpemilu.org#60383,"KUBU, KUMAI, KOTAWARINGIN BARAT, KALIMANTAN TENGAH",11,101,62,163
https://kawalpemilu.org#60383,"KUBU, KUMAI, KOTAWARINGIN BARAT, KALIMANTAN TENGAH",12,59,116,175
https://kawalpemilu.org#60383,"KUBU, KUMAI, KOTAWARINGIN BARAT, KALIMANTAN TENGAH",13,83,75,158
https://kawalpemilu.org#60384,"SUNGAI KAPITAN, KUMAI, KOTAWARINGIN BARAT, KALIMANTAN TENGAH",1,91,96,187
https://kawalpemilu.org#60384,"SUNGAI KAPITAN, KUMAI, KOTAWARINGIN BARAT, KALIMANTAN TENGAH",2,98,160,258
https://kawalpemilu.org#60384,"SUNGAI KAPITAN, KUMAI, KOTAWARINGIN BARAT, KALIMANTAN TENGAH",3,24,141,165
https://kawalpemilu.org#60384,"SUNGAI KAPITAN, KUMAI, KOTAWARINGIN BARAT, KALIMANTAN TENGAH",4,52,158,210
https://kawalpemilu.org#60384,"SUNGAI KAPITAN, KUMAI, KOTAWARINGIN BARAT, KALIMANTAN TENGAH",5,36,102,138
https://kawalpemilu.org#60384,"SUNGAI KAPITAN, KUMAI, KOTAWARINGIN BARAT, KALIMANTAN TENGAH",6,54,164,218
https://kawalpemilu.org#60384,"SUNGAI KAPITAN, KUMAI, KOTAWARINGIN BARAT, KALIMANTAN TENGAH",7,92,152,244
https://kawalpemilu.org#60384,"SUNGAI KAPITAN, KUMAI, KOTAWARINGIN BARAT, KALIMANTAN TENGAH",8,101,135,236
https://kawalpemilu.org#60384,"SUNGAI KAPITAN, KUMAI, KOTAWARINGIN BARAT, KALIMANTAN TENGAH",9,83,142,225
https://kawalpemilu.org#60384,"SUNGAI KAPITAN, KUMAI, KOTAWARINGIN BARAT, KALIMANTAN TENGAH",10,112,82,194
https://kawalpemilu.org#60384,"SUNGAI KAPITAN, KUMAI, KOTAWARINGIN BARAT, KALIMANTAN TENGAH",11,84,84,168
https://kawalpemilu.org#60384,"SUNGAI KAPITAN, KUMAI, KOTAWARINGIN BARAT, KALIMANTAN TENGAH",12,40,92,132
https://kawalpemilu.org#60384,"SUNGAI KAPITAN, KUMAI, KOTAWARINGIN BARAT, KALIMANTAN TENGAH",13,48,85,133
https://kawalpemilu.org#60384,"SUNGAI KAPITAN, KUMAI, KOTAWARINGIN BARAT, KALIMANTAN TENGAH",14,38,156,194
https://kawalpemilu.org#60384,"SUNGAI KAPITAN, KUMAI, KOTAWARINGIN BARAT, KALIMANTAN TENGAH",15,71,126,197
https://kawalpemilu.org#60384,"SUNGAI KAPITAN, KUMAI, KOTAWARINGIN BARAT, KALIMANTAN TENGAH",16,83,154,237
https://kawalpemilu.org#60384,"SUNGAI KAPITAN, KUMAI, KOTAWARINGIN BARAT, KALIMANTAN TENGAH",17,82,68,154
https://kawalpemilu.org#60385,"BATU BELAMAN, KUMAI, KOTAWARINGIN BARAT, KALIMANTAN TENGAH",1,80,119,199
https://kawalpemilu.org#60385,"BATU BELAMAN, KUMAI, KOTAWARINGIN BARAT, KALIMANTAN TENGAH",2,44,136,180
https://kawalpemilu.org#60385,"BATU BELAMAN, KUMAI, KOTAWARINGIN BARAT, KALIMANTAN TENGAH",3,57,85,142
https://kawalpemilu.org#60385,"BATU BELAMAN, KUMAI, KOTAWARINGIN BARAT, KALIMANTAN TENGAH",4,71,84,155
https://kawalpemilu.org#60385,"BATU BELAMAN, KUMAI, KOTAWARINGIN BARAT, KALIMANTAN TENGAH",5,50,124,174
https://kawalpemilu.org#60385,"BATU BELAMAN, KUMAI, KOTAWARINGIN BARAT, KALIMANTAN TENGAH",6,46,109,155
https://kawalpemilu.org#60385,"BATU BELAMAN, KUMAI, KOTAWARINGIN BARAT, KALIMANTAN TENGAH",7,113,88,201
https://kawalpemilu.org#60386,"SUNGAI TENDANG, KUMAI, KOTAWARINGIN BARAT, KALIMANTAN TENGAH",1,50,109,159
https://kawalpemilu.org#60386,"SUNGAI TENDANG, KUMAI, KOTAWARINGIN BARAT, KALIMANTAN TENGAH",2,23,160,123
https://kawalpemilu.org#60386,"SUNGAI TENDANG, KUMAI, KOTAWARINGIN BARAT, KALIMANTAN TENGAH",3,26,149,175
https://kawalpemilu.org#60386,"SUNGAI TENDANG, KUMAI, KOTAWARINGIN BARAT, KALIMANTAN TENGAH",4,28,165,193
https://kawalpemilu.org#60386,"SUNGAI TENDANG, KUMAI, KOTAWARINGIN BARAT, KALIMANTAN TENGAH",5,21,168,189
https://kawalpemilu.org#60386,"SUNGAI TENDANG, KUMAI, KOTAWARINGIN BARAT, KALIMANTAN TENGAH",7,92,73,165
https://kawalpemilu.org#60386,"SUNGAI TENDANG, KUMAI, KOTAWARINGIN BARAT, KALIMANTAN TENGAH",8,24,115,139
https://kawalpemilu.org#60386,"SUNGAI TENDANG, KUMAI, KOTAWARINGIN BARAT, KALIMANTAN TENGAH",10,38,90,128
https://kawalpemilu.org#60386,"SUNGAI TENDANG, KUMAI, KOTAWARINGIN BARAT, KALIMANTAN TENGAH",11,22,98,120
https://kawalpemilu.org#60386,"SUNGAI TENDANG, KUMAI, KOTAWARINGIN BARAT, KALIMANTAN TENGAH",12,18,107,125
https://kawalpemilu.org#60386,"SUNGAI TENDANG, KUMAI, KOTAWARINGIN BARAT, KALIMANTAN TENGAH",13,80,82,162
https://kawalpemilu.org#60387,"SUNGAI SEKONYER, KUMAI, KOTAWARINGIN BARAT, KALIMANTAN TENGAH",1,67,52,119
https://kawalpemilu.org#60387,"SUNGAI SEKONYER, KUMAI, KOTAWARINGIN BARAT, KALIMANTAN TENGAH",2,48,41,89
https://kawalpemilu.org#60387,"SUNGAI SEKONYER, KUMAI, KOTAWARINGIN BARAT, KALIMANTAN TENGAH",3,69,31,100
https://kawalpemilu.org#60388,"SUNGAI BADAUN, KUMAI, KOTAWARINGIN BARAT, KALIMANTAN TENGAH",1,26,133,159
https://kawalpemilu.org#60388,"SUNGAI BADAUN, KUMAI, KOTAWARINGIN BARAT, KALIMANTAN TENGAH",3,62,19,81
https://kawalpemilu.org#60388,"SUNGAI BADAUN, KUMAI, KOTAWARINGIN BARAT, KALIMANTAN TENGAH",4,121,34,155
https://kawalpemilu.org#60388,"SUNGAI BADAUN, KUMAI, KOTAWARINGIN BARAT, KALIMANTAN TENGAH",5,18,116,136
https://kawalpemilu.org#60388,"SUNGAI BADAUN, KUMAI, KOTAWARINGIN BARAT, KALIMANTAN TENGAH",6,24,175,199
https://kawalpemilu.org#60388,"SUNGAI BADAUN, KUMAI, KOTAWARINGIN BARAT, KALIMANTAN TENGAH",7,89,41,130
https://kawalpemilu.org#60388,"SUNGAI BADAUN, KUMAI, KOTAWARINGIN BARAT, KALIMANTAN TENGAH",8,60,22,82
https://kawalpemilu.org#60389,"BUMI HARJO, KUMAI, KOTAWARINGIN BARAT, KALIMANTAN TENGAH",1,100,31,131
https://kawalpemilu.org#60389,"BUMI HARJO, KUMAI, KOTAWARINGIN BARAT, KALIMANTAN TENGAH",2,128,47,175
https://kawalpemilu.org#60389,"BUMI HARJO, KUMAI, KOTAWARINGIN BARAT, KALIMANTAN TENGAH",3,140,68,208
https://kawalpemilu.org#60389,"BUMI HARJO, KUMAI, KOTAWARINGIN BARAT, KALIMANTAN TENGAH",4,65,43,108
https://kawalpemilu.org#60389,"BUMI HARJO, KUMAI, KOTAWARINGIN BARAT, KALIMANTAN TENGAH",5,130,53,183
https://kawalpemilu.org#60389,"BUMI HARJO, KUMAI, KOTAWARINGIN BARAT, KALIMANTAN TENGAH",6,108,63,171
https://kawalpemilu.org#60389,"BUMI HARJO, KUMAI, KOTAWARINGIN BARAT, KALIMANTAN TENGAH",7,157,71,228
https://kawalpemilu.org#60389,"BUMI HARJO, KUMAI, KOTAWARINGIN BARAT, KALIMANTAN TENGAH",8,109,71,180
https://kawalpemilu.org#60389,"BUMI HARJO, KUMAI, KOTAWARINGIN BARAT, KALIMANTAN TENGAH",9,104,37,141
https://kawalpemilu.org#60389,"BUMI HARJO, KUMAI, KOTAWARINGIN BARAT, KALIMANTAN TENGAH",10,45,40,85
https://kawalpemilu.org#60389,"BUMI HARJO, KUMAI, KOTAWARINGIN BARAT, KALIMANTAN TENGAH",11,116,40,156
https://kawalpemilu.org#60389,"BUMI HARJO, KUMAI, KOTAWARINGIN BARAT, KALIMANTAN TENGAH",12,40,37,77
https://kawalpemilu.org#60389,"BUMI HARJO, KUMAI, KOTAWARINGIN BARAT, KALIMANTAN TENGAH",13,102,27,129
https://kawalpemilu.org#60389,"BUMI HARJO, KUMAI, KOTAWARINGIN BARAT, KALIMANTAN TENGAH",14,114,49,163
https://kawalpemilu.org#60389,"BUMI HARJO, KUMAI, KOTAWARINGIN BARAT, KALIMANTAN TENGAH",15,124,42,166
https://kawalpemilu.org#60389,"BUMI HARJO, KUMAI, KOTAWARINGIN BARAT, KALIMANTAN TENGAH",16,75,27,102
https://kawalpemilu.org#60389,"BUMI HARJO, KUMAI, KOTAWARINGIN BARAT, KALIMANTAN TENGAH",17,139,33,172
https://kawalpemilu.org#60389,"BUMI HARJO, KUMAI, KOTAWARINGIN BARAT, KALIMANTAN TENGAH",18,82,20,102
https://kawalpemilu.org#60389,"BUMI HARJO, KUMAI, KOTAWARINGIN BARAT, KALIMANTAN TENGAH",19,102,53,155
https://kawalpemilu.org#60390,"PANGKALAN SATU, KUMAI, KOTAWARINGIN BARAT, KALIMANTAN TENGAH",1,154,54,208
https://kawalpemilu.org#60390,"PANGKALAN SATU, KUMAI, KOTAWARINGIN BARAT, KALIMANTAN TENGAH",2,93,27,120
https://kawalpemilu.org#60390,"PANGKALAN SATU, KUMAI, KOTAWARINGIN BARAT, KALIMANTAN TENGAH",3,156,63,219
https://kawalpemilu.org#60390,"PANGKALAN SATU, KUMAI, KOTAWARINGIN BARAT, KALIMANTAN TENGAH",4,180,54,234
https://kawalpemilu.org#60390,"PANGKALAN SATU, KUMAI, KOTAWARINGIN BARAT, KALIMANTAN TENGAH",5,143,47,190
https://kawalpemilu.org#60390,"PANGKALAN SATU, KUMAI, KOTAWARINGIN BARAT, KALIMANTAN TENGAH",6,162,59,221
https://kawalpemilu.org#60390,"PANGKALAN SATU, KUMAI, KOTAWARINGIN BARAT, KALIMANTAN TENGAH",7,116,25,141
https://kawalpemilu.org#85360,"SEBUAI TIMUR, KUMAI, KOTAWARINGIN BARAT, KALIMANTAN TENGAH",1,102,73,175
https://kawalpemilu.org#60392,"MENDAWAI SEBERANG, ARUT SELATAN, KOTAWARINGIN BARAT, KALIMANTAN TENGAH",1,107,118,225
https://kawalpemilu.org#60392,"MENDAWAI SEBERANG, ARUT SELATAN, KOTAWARINGIN BARAT, KALIMANTAN TENGAH",2,89,149,238
https://kawalpemilu.org#60392,"MENDAWAI SEBERANG, ARUT SELATAN, KOTAWARINGIN BARAT, KALIMANTAN TENGAH",3,81,146,227
https://kawalpemilu.org#60392,"MENDAWAI SEBERANG, ARUT SELATAN, KOTAWARINGIN BARAT, KALIMANTAN TENGAH",4,95,117,212
https://kawalpemilu.org#60392,"MENDAWAI SEBERANG, ARUT SELATAN, KOTAWARINGIN BARAT, KALIMANTAN TENGAH",5,89,134,223
https://kawalpemilu.org#60392,"MENDAWAI SEBERANG, ARUT SELATAN, KOTAWARINGIN BARAT, KALIMANTAN TENGAH",6,81,130,211
https://kawalpemilu.org#60393,"MENDAWAI, ARUT SELATAN, KOTAWARINGIN BARAT, KALIMANTAN TENGAH",1,59,108,167
https://kawalpemilu.org#60393,"MENDAWAI, ARUT SELATAN, KOTAWARINGIN BARAT, KALIMANTAN TENGAH",2,37,105,142
https://kawalpemilu.org#60393,"MENDAWAI, ARUT SELATAN, KOTAWARINGIN BARAT, KALIMANTAN TENGAH",3,85,151,236
https://kawalpemilu.org#60393,"MENDAWAI, ARUT SELATAN, KOTAWARINGIN BARAT, KALIMANTAN TENGAH",4,83,146,229
https://kawalpemilu.org#60393,"MENDAWAI, ARUT SELATAN, KOTAWARINGIN BARAT, KALIMANTAN TENGAH",5,86,128,214
https://kawalpemilu.org#60393,"MENDAWAI, ARUT SELATAN, KOTAWARINGIN BARAT, KALIMANTAN TENGAH",6,51,91,142
https://kawalpemilu.org#60393,"MENDAWAI, ARUT SELATAN, KOTAWARINGIN BARAT, KALIMANTAN TENGAH",7,87,100,187
https://kawalpemilu.org#60393,"MENDAWAI, ARUT SELATAN, KOTAWARINGIN BARAT, KALIMANTAN TENGAH",8,65,102,167
https://kawalpemilu.org#60393,"MENDAWAI, ARUT SELATAN, KOTAWARINGIN BARAT, KALIMANTAN TENGAH",9,50,100,150
https://kawalpemilu.org#60393,"MENDAWAI, ARUT SELATAN, KOTAWARINGIN BARAT, KALIMANTAN TENGAH",10,77,69,146
https://kawalpemilu.org#60393,"MENDAWAI, ARUT SELATAN, KOTAWARINGIN BARAT, KALIMANTAN TENGAH",11,70,75,145
https://kawalpemilu.org#60393,"MENDAWAI, ARUT SELATAN, KOTAWARINGIN BARAT, KALIMANTAN TENGAH",12,66,119,185
https://kawalpemilu.org#60393,"MENDAWAI, ARUT SELATAN, KOTAWARINGIN BARAT, KALIMANTAN TENGAH",13,49,111,160
https://kawalpemilu.org#60393,"MENDAWAI, ARUT SELATAN, KOTAWARINGIN BARAT, KALIMANTAN TENGAH",14,68,81,149
https://kawalpemilu.org#60393,"MENDAWAI, ARUT SELATAN, KOTAWARINGIN BARAT, KALIMANTAN TENGAH",15,39,106,145
https://kawalpemilu.org#60393,"MENDAWAI, ARUT SELATAN, KOTAWARINGIN BARAT, KALIMANTAN TENGAH",16,79,71,150
https://kawalpemilu.org#60393,"MENDAWAI, ARUT SELATAN, KOTAWARINGIN BARAT, KALIMANTAN TENGAH",17,40,110,150
https://kawalpemilu.org#60393,"MENDAWAI, ARUT SELATAN, KOTAWARINGIN BARAT, KALIMANTAN TENGAH",18,33,79,112
https://kawalpemilu.org#60393,"MENDAWAI, ARUT SELATAN, KOTAWARINGIN BARAT, KALIMANTAN TENGAH",19,65,107,172
https://kawalpemilu.org#60393,"MENDAWAI, ARUT SELATAN, KOTAWARINGIN BARAT, KALIMANTAN TENGAH",20,83,145,228
https://kawalpemilu.org#60393,"MENDAWAI, ARUT SELATAN, KOTAWARINGIN BARAT, KALIMANTAN TENGAH",21,95,140,235
https://kawalpemilu.org#60393,"MENDAWAI, ARUT SELATAN, KOTAWARINGIN BARAT, KALIMANTAN TENGAH",22,60,82,142
https://kawalpemilu.org#60393,"MENDAWAI, ARUT SELATAN, KOTAWARINGIN BARAT, KALIMANTAN TENGAH",23,78,124,202
https://kawalpemilu.org#60393,"MENDAWAI, ARUT SELATAN, KOTAWARINGIN BARAT, KALIMANTAN TENGAH",24,37,75,112
https://kawalpemilu.org#60393,"MENDAWAI, ARUT SELATAN, KOTAWARINGIN BARAT, KALIMANTAN TENGAH",25,87,85,172
https://kawalpemilu.org#60393,"MENDAWAI, ARUT SELATAN, KOTAWARINGIN BARAT, KALIMANTAN TENGAH",26,55,51,106
https://kawalpemilu.org#60393,"MENDAWAI, ARUT SELATAN, KOTAWARINGIN BARAT, KALIMANTAN TENGAH",27,60,78,138
https://kawalpemilu.org#60393,"MENDAWAI, ARUT SELATAN, KOTAWARINGIN BARAT, KALIMANTAN TENGAH",28,69,66,135
https://kawalpemilu.org#60393,"MENDAWAI, ARUT SELATAN, KOTAWARINGIN BARAT, KALIMANTAN TENGAH",29,108,66,174
https://kawalpemilu.org#60393,"MENDAWAI, ARUT SELATAN, KOTAWARINGIN BARAT, KALIMANTAN TENGAH",30,127,78,205
https://kawalpemilu.org#60393,"MENDAWAI, ARUT SELATAN, KOTAWARINGIN BARAT, KALIMANTAN TENGAH",31,62,47,109
https://kawalpemilu.org#60393,"MENDAWAI, ARUT SELATAN, KOTAWARINGIN BARAT, KALIMANTAN TENGAH",32,128,95,223
https://kawalpemilu.org#60393,"MENDAWAI, ARUT SELATAN, KOTAWARINGIN BARAT, KALIMANTAN TENGAH",33,55,90,145
https://kawalpemilu.org#60393,"MENDAWAI, ARUT SELATAN, KOTAWARINGIN BARAT, KALIMANTAN TENGAH",34,49,75,124
https://kawalpemilu.org#60393,"MENDAWAI, ARUT SELATAN, KOTAWARINGIN BARAT, KALIMANTAN TENGAH",35,72,87,159
https://kawalpemilu.org#60393,"MENDAWAI, ARUT SELATAN, KOTAWARINGIN BARAT, KALIMANTAN TENGAH",36,51,66,117
https://kawalpemilu.org#60393,"MENDAWAI, ARUT SELATAN, KOTAWARINGIN BARAT, KALIMANTAN TENGAH",37,64,50,114
https://kawalpemilu.org#60393,"MENDAWAI, ARUT SELATAN, KOTAWARINGIN BARAT, KALIMANTAN TENGAH",38,94,66,160
https://kawalpemilu.org#60393,"MENDAWAI, ARUT SELATAN, KOTAWARINGIN BARAT, KALIMANTAN TENGAH",39,70,77,147
https://kawalpemilu.org#60393,"MENDAWAI, ARUT SELATAN, KOTAWARINGIN BARAT, KALIMANTAN TENGAH",40,62,66,128
https://kawalpemilu.org#60393,"MENDAWAI, ARUT SELATAN, KOTAWARINGIN BARAT, KALIMANTAN TENGAH",41,43,85,128
https://kawalpemilu.org#60393,"MENDAWAI, ARUT SELATAN, KOTAWARINGIN BARAT, KALIMANTAN TENGAH",42,68,85,153
https://kawalpemilu.org#60393,"MENDAWAI, ARUT SELATAN, KOTAWARINGIN BARAT, KALIMANTAN TENGAH",43,51,89,140
https://kawalpemilu.org#60393,"MENDAWAI, ARUT SELATAN, KOTAWARINGIN BARAT, KALIMANTAN TENGAH",44,42,68,110
https://kawalpemilu.org#60393,"MENDAWAI, ARUT SELATAN, KOTAWARINGIN BARAT, KALIMANTAN TENGAH",45,63,66,129
https://kawalpemilu.org#60393,"MENDAWAI, ARUT SELATAN, KOTAWARINGIN BARAT, KALIMANTAN TENGAH",46,84,63,147
https://kawalpemilu.org#60393,"MENDAWAI, ARUT SELATAN, KOTAWARINGIN BARAT, KALIMANTAN TENGAH",47,36,80,116
https://kawalpemilu.org#60393,"MENDAWAI, ARUT SELATAN, KOTAWARINGIN BARAT, KALIMANTAN TENGAH",48,35,42,77
https://kawalpemilu.org#60393,"MENDAWAI, ARUT SELATAN, KOTAWARINGIN BARAT, KALIMANTAN TENGAH",49,35,43,78
https://kawalpemilu.org#60393,"MENDAWAI, ARUT SELATAN, KOTAWARINGIN BARAT, KALIMANTAN TENGAH",50,138,51,189
https://kawalpemilu.org#60393,"MENDAWAI, ARUT SELATAN, KOTAWARINGIN BARAT, KALIMANTAN TENGAH",51,52,37,89
https://kawalpemilu.org#60393,"MENDAWAI, ARUT SELATAN, KOTAWARINGIN BARAT, KALIMANTAN TENGAH",52,89,65,154
https://kawalpemilu.org#60394,"MADUREJO, ARUT SELATAN, KOTAWARINGIN BARAT, KALIMANTAN TENGAH",1,60,151,211
https://kawalpemilu.org#60394,"MADUREJO, ARUT SELATAN, KOTAWARINGIN BARAT, KALIMANTAN TENGAH",2,31,138,169
https://kawalpemilu.org#60394,"MADUREJO, ARUT SELATAN, KOTAWARINGIN BARAT, KALIMANTAN TENGAH",3,39,96,135
https://kawalpemilu.org#60394,"MADUREJO, ARUT SELATAN, KOTAWARINGIN BARAT, KALIMANTAN TENGAH",4,71,117,188
https://kawalpemilu.org#60394,"MADUREJO, ARUT SELATAN, KOTAWARINGIN BARAT, KALIMANTAN TENGAH",5,19,165,184
https://kawalpemilu.org#60394,"MADUREJO, ARUT SELATAN, KOTAWARINGIN BARAT, KALIMANTAN TENGAH",6,90,148,238
https://kawalpemilu.org#60394,"MADUREJO, ARUT SELATAN, KOTAWARINGIN BARAT, KALIMANTAN TENGAH",7,68,92,160
https://kawalpemilu.org#60394,"MADUREJO, ARUT SELATAN, KOTAWARINGIN BARAT, KALIMANTAN TENGAH",8,57,103,160
https://kawalpemilu.org#60394,"MADUREJO, ARUT SELATAN, KOTAWARINGIN BARAT, KALIMANTAN TENGAH",9,53,89,142
https://kawalpemilu.org#60394,"MADUREJO, ARUT SELATAN, KOTAWARINGIN BARAT, KALIMANTAN TENGAH",10,36,115,151
https://kawalpemilu.org#60394,"MADUREJO, ARUT SELATAN, KOTAWARINGIN BARAT, KALIMANTAN TENGAH",11,59,178,237
https://kawalpemilu.org#60394,"MADUREJO, ARUT SELATAN, KOTAWARINGIN BARAT, KALIMANTAN TENGAH",12,80,139,219
https://kawalpemilu.org#60394,"MADUREJO, ARUT SELATAN, KOTAWARINGIN BARAT, KALIMANTAN TENGAH",13,47,87,134
https://kawalpemilu.org#60394,"MADUREJO, ARUT SELATAN, KOTAWARINGIN BARAT, KALIMANTAN TENGAH",14,77,99,176
https://kawalpemilu.org#60394,"MADUREJO, ARUT SELATAN, KOTAWARINGIN BARAT, KALIMANTAN TENGAH",15,104,98,202
https://kawalpemilu.org#60394,"MADUREJO, ARUT SELATAN, KOTAWARINGIN BARAT, KALIMANTAN TENGAH",16,54,88,142
https://kawalpemilu.org#60394,"MADUREJO, ARUT SELATAN, KOTAWARINGIN BARAT, KALIMANTAN TENGAH",17,71,147,218
https://kawalpemilu.org#60394,"MADUREJO, ARUT SELATAN, KOTAWARINGIN BARAT, KALIMANTAN TENGAH",18,51,204,255
https://kawalpemilu.org#60394,"MADUREJO, ARUT SELATAN, KOTAWARINGIN BARAT, KALIMANTAN TENGAH",19,52,168,220
https://kawalpemilu.org#60394,"MADUREJO, ARUT SELATAN, KOTAWARINGIN BARAT, KALIMANTAN TENGAH",20,80,98,178
https://kawalpemilu.org#60394,"MADUREJO, ARUT SELATAN, KOTAWARINGIN BARAT, KALIMANTAN TENGAH",21,49,119,168
https://kawalpemilu.org#60394,"MADUREJO, ARUT SELATAN, KOTAWARINGIN BARAT, KALIMANTAN TENGAH",22,37,76,113
https://kawalpemilu.org#60394,"MADUREJO, ARUT SELATAN, KOTAWARINGIN BARAT, KALIMANTAN TENGAH",23,80,119,199
https://kawalpemilu.org#60394,"MADUREJO, ARUT SELATAN, KOTAWARINGIN BARAT, KALIMANTAN TENGAH",24,46,74,120
https://kawalpemilu.org#60394,"MADUREJO, ARUT SELATAN, KOTAWARINGIN BARAT, KALIMANTAN TENGAH",25,75,52,127
https://kawalpemilu.org#60394,"MADUREJO, ARUT SELATAN, KOTAWARINGIN BARAT, KALIMANTAN TENGAH",26,143,102,245
https://kawalpemilu.org#60394,"MADUREJO, ARUT SELATAN, KOTAWARINGIN BARAT, KALIMANTAN TENGAH",27,96,111,207
https://kawalpemilu.org#60394,"MADUREJO, ARUT SELATAN, KOTAWARINGIN BARAT, KALIMANTAN TENGAH",28,71,83,154
https://kawalpemilu.org#60394,"MADUREJO, ARUT SELATAN, KOTAWARINGIN BARAT, KALIMANTAN TENGAH",29,78,78,156
https://kawalpemilu.org#60394,"MADUREJO, ARUT SELATAN, KOTAWARINGIN BARAT, KALIMANTAN TENGAH",30,127,116,243
https://kawalpemilu.org#60394,"MADUREJO, ARUT SELATAN, KOTAWARINGIN BARAT, KALIMANTAN TENGAH",31,61,94,155
https://kawalpemilu.org#60394,"MADUREJO, ARUT SELATAN, KOTAWARINGIN BARAT, KALIMANTAN TENGAH",32,91,114,205
https://kawalpemilu.org#60394,"MADUREJO, ARUT SELATAN, KOTAWARINGIN BARAT, KALIMANTAN TENGAH",33,67,96,163
https://kawalpemilu.org#60394,"MADUREJO, ARUT SELATAN, KOTAWARINGIN BARAT, KALIMANTAN TENGAH",34,61,91,152
https://kawalpemilu.org#60394,"MADUREJO, ARUT SELATAN, KOTAWARINGIN BARAT, KALIMANTAN TENGAH",35,82,57,139
https://kawalpemilu.org#60394,"MADUREJO, ARUT SELATAN, KOTAWARINGIN BARAT, KALIMANTAN TENGAH",36,101,81,182
https://kawalpemilu.org#60394,"MADUREJO, ARUT SELATAN, KOTAWARINGIN BARAT, KALIMANTAN TENGAH",37,17,135,152
https://kawalpemilu.org#60394,"MADUREJO, ARUT SELATAN, KOTAWARINGIN BARAT, KALIMANTAN TENGAH",38,34,79,113
https://kawalpemilu.org#60394,"MADUREJO, ARUT SELATAN, KOTAWARINGIN BARAT, KALIMANTAN TENGAH",39,17,177,194
https://kawalpemilu.org#60394,"MADUREJO, ARUT SELATAN, KOTAWARINGIN BARAT, KALIMANTAN TENGAH",40,51,96,147
https://kawalpemilu.org#60394,"MADUREJO, ARUT SELATAN, KOTAWARINGIN BARAT, KALIMANTAN TENGAH",41,49,61,110
https://kawalpemilu.org#60394,"MADUREJO, ARUT SELATAN, KOTAWARINGIN BARAT, KALIMANTAN TENGAH",42,56,157,213
https://kawalpemilu.org#60394,"MADUREJO, ARUT SELATAN, KOTAWARINGIN BARAT, KALIMANTAN TENGAH",43,72,159,231
https://kawalpemilu.org#60394,"MADUREJO, ARUT SELATAN, KOTAWARINGIN BARAT, KALIMANTAN TENGAH",44,37,105,142
https://kawalpemilu.org#60394,"MADUREJO, ARUT SELATAN, KOTAWARINGIN BARAT, KALIMANTAN TENGAH",45,44,79,123
https://kawalpemilu.org#60394,"MADUREJO, ARUT SELATAN, KOTAWARINGIN BARAT, KALIMANTAN TENGAH",46,43,144,187
https://kawalpemilu.org#60394,"MADUREJO, ARUT SELATAN, KOTAWARINGIN BARAT, KALIMANTAN TENGAH",47,70,93,163
https://kawalpemilu.org#60394,"MADUREJO, ARUT SELATAN, KOTAWARINGIN BARAT, KALIMANTAN TENGAH",48,36,139,175
https://kawalpemilu.org#60394,"MADUREJO, ARUT SELATAN, KOTAWARINGIN BARAT, KALIMANTAN TENGAH",49,55,140,195
https://kawalpemilu.org#60394,"MADUREJO, ARUT SELATAN, KOTAWARINGIN BARAT, KALIMANTAN TENGAH",50,30,153,186
https://kawalpemilu.org#60394,"MADUREJO, ARUT SELATAN, KOTAWARINGIN BARAT, KALIMANTAN TENGAH",51,50,67,117
https://kawalpemilu.org#60394,"MADUREJO, ARUT SELATAN, KOTAWARINGIN BARAT, KALIMANTAN TENGAH",52,122,106,228
https://kawalpemilu.org#60394,"MADUREJO, ARUT SELATAN, KOTAWARINGIN BARAT, KALIMANTAN TENGAH",53,92,101,193
https://kawalpemilu.org#60394,"MADUREJO, ARUT SELATAN, KOTAWARINGIN BARAT, KALIMANTAN TENGAH",54,90,131,221
https://kawalpemilu.org#60394,"MADUREJO, ARUT SELATAN, KOTAWARINGIN BARAT, KALIMANTAN TENGAH",55,70,70,140
https://kawalpemilu.org#60394,"MADUREJO, ARUT SELATAN, KOTAWARINGIN BARAT, KALIMANTAN TENGAH",56,68,59,127
https://kawalpemilu.org#60394,"MADUREJO, ARUT SELATAN, KOTAWARINGIN BARAT, KALIMANTAN TENGAH",57,57,77,134
https://kawalpemilu.org#60394,"MADUREJO, ARUT SELATAN, KOTAWARINGIN BARAT, KALIMANTAN TENGAH",58,50,56,106
https://kawalpemilu.org#60394,"MADUREJO, ARUT SELATAN, KOTAWARINGIN BARAT, KALIMANTAN TENGAH",59,47,45,92
https://kawalpemilu.org#60394,"MADUREJO, ARUT SELATAN, KOTAWARINGIN BARAT, KALIMANTAN TENGAH",60,94,106,200
https://kawalpemilu.org#60394,"MADUREJO, ARUT SELATAN, KOTAWARINGIN BARAT, KALIMANTAN TENGAH",61,84,85,169
https://kawalpemilu.org#60395,"SIDOREJO, ARUT SELATAN, KOTAWARINGIN BARAT, KALIMANTAN TENGAH",1,104,73,177
https://kawalpemilu.org#60395,"SIDOREJO, ARUT SELATAN, KOTAWARINGIN BARAT, KALIMANTAN TENGAH",2,94,59,153
https://kawalpemilu.org#60395,"SIDOREJO, ARUT SELATAN, KOTAWARINGIN BARAT, KALIMANTAN TENGAH",3,68,134,202
https://kawalpemilu.org#60395,"SIDOREJO, ARUT SELATAN, KOTAWARINGIN BARAT, KALIMANTAN TENGAH",4,91,108,199
https://kawalpemilu.org#60395,"SIDOREJO, ARUT SELATAN, KOTAWARINGIN BARAT, KALIMANTAN TENGAH",5,99,93,192
https://kawalpemilu.org#60395,"SIDOREJO, ARUT SELATAN, KOTAWARINGIN BARAT, KALIMANTAN TENGAH",6,76,77,153
https://kawalpemilu.org#60395,"SIDOREJO, ARUT SELATAN, KOTAWARINGIN BARAT, KALIMANTAN TENGAH",7,53,101,154
https://kawalpemilu.org#60395,"SIDOREJO, ARUT SELATAN, KOTAWARINGIN BARAT, KALIMANTAN TENGAH",8,100,63,163
https://kawalpemilu.org#60395,"SIDOREJO, ARUT SELATAN, KOTAWARINGIN BARAT, KALIMANTAN TENGAH",9,89,108,197
https://kawalpemilu.org#60395,"SIDOREJO, ARUT SELATAN, KOTAWARINGIN BARAT, KALIMANTAN TENGAH",10,59,45,104
https://kawalpemilu.org#60395,"SIDOREJO, ARUT SELATAN, KOTAWARINGIN BARAT, KALIMANTAN TENGAH",11,62,78,140
https://kawalpemilu.org#60395,"SIDOREJO, ARUT SELATAN, KOTAWARINGIN BARAT, KALIMANTAN TENGAH",12,77,68,145
https://kawalpemilu.org#60395,"SIDOREJO, ARUT SELATAN, KOTAWARINGIN BARAT, KALIMANTAN TENGAH",13,50,100,150
https://kawalpemilu.org#60395,"SIDOREJO, ARUT SELATAN, KOTAWARINGIN BARAT, KALIMANTAN TENGAH",14,60,133,193
https://kawalpemilu.org#60395,"SIDOREJO, ARUT SELATAN, KOTAWARINGIN BARAT, KALIMANTAN TENGAH",15,92,177,269
https://kawalpemilu.org#60395,"SIDOREJO, ARUT SELATAN, KOTAWARINGIN BARAT, KALIMANTAN TENGAH",16,96,75,171
https://kawalpemilu.org#60395,"SIDOREJO, ARUT SELATAN, KOTAWARINGIN BARAT, KALIMANTAN TENGAH",17,61,83,144
https://kawalpemilu.org#60395,"SIDOREJO, ARUT SELATAN, KOTAWARINGIN BARAT, KALIMANTAN TENGAH",18,90,95,185
https://kawalpemilu.org#60395,"SIDOREJO, ARUT SELATAN, KOTAWARINGIN BARAT, KALIMANTAN TENGAH",19,78,79,157
https://kawalpemilu.org#60395,"SIDOREJO, ARUT SELATAN, KOTAWARINGIN BARAT, KALIMANTAN TENGAH",20,73,81,154
https://kawalpemilu.org#60395,"SIDOREJO, ARUT SELATAN, KOTAWARINGIN BARAT, KALIMANTAN TENGAH",21,76,136,212
https://kawalpemilu.org#60395,"SIDOREJO, ARUT SELATAN, KOTAWARINGIN BARAT, KALIMANTAN TENGAH",22,37,89,126
https://kawalpemilu.org#60395,"SIDOREJO, ARUT SELATAN, KOTAWARINGIN BARAT, KALIMANTAN TENGAH",23,58,139,197
https://kawalpemilu.org#60395,"SIDOREJO, ARUT SELATAN, KOTAWARINGIN BARAT, KALIMANTAN TENGAH",24,76,92,168
https://kawalpemilu.org#60395,"SIDOREJO, ARUT SELATAN, KOTAWARINGIN BARAT, KALIMANTAN TENGAH",25,47,54,101
https://kawalpemilu.org#60395,"SIDOREJO, ARUT SELATAN, KOTAWARINGIN BARAT, KALIMANTAN TENGAH",26,70,104,174
https://kawalpemilu.org#60395,"SIDOREJO, ARUT SELATAN, KOTAWARINGIN BARAT, KALIMANTAN TENGAH",27,130,50,180
https://kawalpemilu.org#60395,"SIDOREJO, ARUT SELATAN, KOTAWARINGIN BARAT, KALIMANTAN TENGAH",28,100,49,149
https://kawalpemilu.org#60395,"SIDOREJO, ARUT SELATAN, KOTAWARINGIN BARAT, KALIMANTAN TENGAH",29,83,52,135
https://kawalpemilu.org#60395,"SIDOREJO, ARUT SELATAN, KOTAWARINGIN BARAT, KALIMANTAN TENGAH",30,75,57,132
https://kawalpemilu.org#60395,"SIDOREJO, ARUT SELATAN, KOTAWARINGIN BARAT, KALIMANTAN TENGAH",31,102,67,169
https://kawalpemilu.org#60395,"SIDOREJO, ARUT SELATAN, KOTAWARINGIN BARAT, KALIMANTAN TENGAH",32,131,67,198
https://kawalpemilu.org#60395,"SIDOREJO, ARUT SELATAN, KOTAWARINGIN BARAT, KALIMANTAN TENGAH",33,132,110,242
https://kawalpemilu.org#60395,"SIDOREJO, ARUT SELATAN, KOTAWARINGIN BARAT, KALIMANTAN TENGAH",34,148,47,195
https://kawalpemilu.org#60395,"SIDOREJO, ARUT SELATAN, KOTAWARINGIN BARAT, KALIMANTAN TENGAH",35,106,55,161
https://kawalpemilu.org#60395,"SIDOREJO, ARUT SELATAN, KOTAWARINGIN BARAT, KALIMANTAN TENGAH",36,79,111,190
https://kawalpemilu.org#60395,"SIDOREJO, ARUT SELATAN, KOTAWARINGIN BARAT, KALIMANTAN TENGAH",38,103,87,190
https://kawalpemilu.org#60395,"SIDOREJO, ARUT SELATAN, KOTAWARINGIN BARAT, KALIMANTAN TENGAH",39,54,68,122
https://kawalpemilu.org#60395,"SIDOREJO, ARUT SELATAN, KOTAWARINGIN BARAT, KALIMANTAN TENGAH",40,68,92,160
https://kawalpemilu.org#60395,"SIDOREJO, ARUT SELATAN, KOTAWARINGIN BARAT, KALIMANTAN TENGAH",41,72,53,125
https://kawalpemilu.org#60395,"SIDOREJO, ARUT SELATAN, KOTAWARINGIN BARAT, KALIMANTAN TENGAH",42,81,73,154
https://kawalpemilu.org#60395,"SIDOREJO, ARUT SELATAN, KOTAWARINGIN BARAT, KALIMANTAN TENGAH",43,76,60,136
https://kawalpemilu.org#60395,"SIDOREJO, ARUT SELATAN, KOTAWARINGIN BARAT, KALIMANTAN TENGAH",44,43,83,126
https://kawalpemilu.org#60395,"SIDOREJO, ARUT SELATAN, KOTAWARINGIN BARAT, KALIMANTAN TENGAH",45,85,73,158
https://kawalpemilu.org#60395,"SIDOREJO, ARUT SELATAN, KOTAWARINGIN BARAT, KALIMANTAN TENGAH",46,76,66,142
https://kawalpemilu.org#60395,"SIDOREJO, ARUT SELATAN, KOTAWARINGIN BARAT, KALIMANTAN TENGAH",47,69,98,167
https://kawalpemilu.org#60395,"SIDOREJO, ARUT SELATAN, KOTAWARINGIN BARAT, KALIMANTAN TENGAH",48,47,73,120
https://kawalpemilu.org#60395,"SIDOREJO, ARUT SELATAN, KOTAWARINGIN BARAT, KALIMANTAN TENGAH",49,73,68,141
https://kawalpemilu.org#60395,"SIDOREJO, ARUT SELATAN, KOTAWARINGIN BARAT, KALIMANTAN TENGAH",50,35,96,131
https://kawalpemilu.org#60395,"SIDOREJO, ARUT SELATAN, KOTAWARINGIN BARAT, KALIMANTAN TENGAH",51,71,122,193
https://kawalpemilu.org#60395,"SIDOREJO, ARUT SELATAN, KOTAWARINGIN BARAT, KALIMANTAN TENGAH",52,73,56,129
https://kawalpemilu.org#60395,"SIDOREJO, ARUT SELATAN, KOTAWARINGIN BARAT, KALIMANTAN TENGAH",53,102,39,141
https://kawalpemilu.org#60395,"SIDOREJO, ARUT SELATAN, KOTAWARINGIN BARAT, KALIMANTAN TENGAH",54,67,57,124
https://kawalpemilu.org#60395,"SIDOREJO, ARUT SELATAN, KOTAWARINGIN BARAT, KALIMANTAN TENGAH",55,95,72,167
https://kawalpemilu.org#60395,"SIDOREJO, ARUT SELATAN, KOTAWARINGIN BARAT, KALIMANTAN TENGAH",56,81,52,133
https://kawalpemilu.org#60395,"SIDOREJO, ARUT SELATAN, KOTAWARINGIN BARAT, KALIMANTAN TENGAH",57,110,56,166
https://kawalpemilu.org#60395,"SIDOREJO, ARUT SELATAN, KOTAWARINGIN BARAT, KALIMANTAN TENGAH",58,70,149,219
https://kawalpemilu.org#60396,"RAJA, ARUT SELATAN, KOTAWARINGIN BARAT, KALIMANTAN TENGAH",1,81,139,220
https://kawalpemilu.org#60396,"RAJA, ARUT SELATAN, KOTAWARINGIN BARAT, KALIMANTAN TENGAH",2,0,0,0
https://kawalpemilu.org#60396,"RAJA, ARUT SELATAN, KOTAWARINGIN BARAT, KALIMANTAN TENGAH",3,80,115,195
https://kawalpemilu.org#60396,"RAJA, ARUT SELATAN, KOTAWARINGIN BARAT, KALIMANTAN TENGAH",4,102,157,259
https://kawalpemilu.org#60396,"RAJA, ARUT SELATAN, KOTAWARINGIN BARAT, KALIMANTAN TENGAH",5,79,70,149
https://kawalpemilu.org#60396,"RAJA, ARUT SELATAN, KOTAWARINGIN BARAT, KALIMANTAN TENGAH",6,67,123,190
https://kawalpemilu.org#60396,"RAJA, ARUT SELATAN, KOTAWARINGIN BARAT, KALIMANTAN TENGAH",7,95,114,209
https://kawalpemilu.org#60396,"RAJA, ARUT SELATAN, KOTAWARINGIN BARAT, KALIMANTAN TENGAH",8,129,128,257
https://kawalpemilu.org#60396,"RAJA, ARUT SELATAN, KOTAWARINGIN BARAT, KALIMANTAN TENGAH",9,64,71,135
https://kawalpemilu.org#60396,"RAJA, ARUT SELATAN, KOTAWARINGIN BARAT, KALIMANTAN TENGAH",10,61,51,112
https://kawalpemilu.org#60396,"RAJA, ARUT SELATAN, KOTAWARINGIN BARAT, KALIMANTAN TENGAH",11,74,142,216
https://kawalpemilu.org#60396,"RAJA, ARUT SELATAN, KOTAWARINGIN BARAT, KALIMANTAN TENGAH",12,48,112,160
https://kawalpemilu.org#60396,"RAJA, ARUT SELATAN, KOTAWARINGIN BARAT, KALIMANTAN TENGAH",13,105,126,231
https://kawalpemilu.org#60396,"RAJA, ARUT SELATAN, KOTAWARINGIN BARAT, KALIMANTAN TENGAH",14,72,124,196
https://kawalpemilu.org#60396,"RAJA, ARUT SELATAN, KOTAWARINGIN BARAT, KALIMANTAN TENGAH",15,47,80,127
https://kawalpemilu.org#60396,"RAJA, ARUT SELATAN, KOTAWARINGIN BARAT, KALIMANTAN TENGAH",16,76,85,161
https://kawalpemilu.org#60396,"RAJA, ARUT SELATAN, KOTAWARINGIN BARAT, KALIMANTAN TENGAH",17,80,85,165
https://kawalpemilu.org#60396,"RAJA, ARUT SELATAN, KOTAWARINGIN BARAT, KALIMANTAN TENGAH",18,60,111,171
https://kawalpemilu.org#60397,"RAJA SEBERANG, ARUT SELATAN, KOTAWARINGIN BARAT, KALIMANTAN TENGAH",1,126,64,190
https://kawalpemilu.org#60397,"RAJA SEBERANG, ARUT SELATAN, KOTAWARINGIN BARAT, KALIMANTAN TENGAH",2,87,82,169
https://kawalpemilu.org#60397,"RAJA SEBERANG, ARUT SELATAN, KOTAWARINGIN BARAT, KALIMANTAN TENGAH",3,107,94,201
https://kawalpemilu.org#60397,"RAJA SEBERANG, ARUT SELATAN, KOTAWARINGIN BARAT, KALIMANTAN TENGAH",4,89,76,165
https://kawalpemilu.org#60397,"RAJA SEBERANG, ARUT SELATAN, KOTAWARINGIN BARAT, KALIMANTAN TENGAH",5,112,88,200
https://kawalpemilu.org#60397,"RAJA SEBERANG, ARUT SELATAN, KOTAWARINGIN BARAT, KALIMANTAN TENGAH",6,88,58,146
https://kawalpemilu.org#60398,"BARU, ARUT SELATAN, KOTAWARINGIN BARAT, KALIMANTAN TENGAH",1,66,153,219
https://kawalpemilu.org#60398,"BARU, ARUT SELATAN, KOTAWARINGIN BARAT, KALIMANTAN TENGAH",2,72,123,195
https://kawalpemilu.org#60398,"BARU, ARUT SELATAN, KOTAWARINGIN BARAT, KALIMANTAN TENGAH",3,70,64,134
https://kawalpemilu.org#60398,"BARU, ARUT SELATAN, KOTAWARINGIN BARAT, KALIMANTAN TENGAH",5,28,75,103
https://kawalpemilu.org#60398,"BARU, ARUT SELATAN, KOTAWARINGIN BARAT, KALIMANTAN TENGAH",6,86,48,134
https://kawalpemilu.org#60398,"BARU, ARUT SELATAN, KOTAWARINGIN BARAT, KALIMANTAN TENGAH",7,42,99,141
https://kawalpemilu.org#60398,"BARU, ARUT SELATAN, KOTAWARINGIN BARAT, KALIMANTAN TENGAH",8,32,52,84
https://kawalpemilu.org#60398,"BARU, ARUT SELATAN, KOTAWARINGIN BARAT, KALIMANTAN TENGAH",9,92,136,228
https://kawalpemilu.org#60398,"BARU, ARUT SELATAN, KOTAWARINGIN BARAT, KALIMANTAN TENGAH",10,45,106,151
https://kawalpemilu.org#60398,"BARU, ARUT SELATAN, KOTAWARINGIN BARAT, KALIMANTAN TENGAH",11,33,81,114
https://kawalpemilu.org#60398,"BARU, ARUT SELATAN, KOTAWARINGIN BARAT, KALIMANTAN TENGAH",12,22,90,112
https://kawalpemilu.org#60398,"BARU, ARUT SELATAN, KOTAWARINGIN BARAT, KALIMANTAN TENGAH",13,101,157,258
https://kawalpemilu.org#60398,"BARU, ARUT SELATAN, KOTAWARINGIN BARAT, KALIMANTAN TENGAH",14,98,112,210
https://kawalpemilu.org#60398,"BARU, ARUT SELATAN, KOTAWARINGIN BARAT, KALIMANTAN TENGAH",15,66,116,182
https://kawalpemilu.org#60398,"BARU, ARUT SELATAN, KOTAWARINGIN BARAT, KALIMANTAN TENGAH",16,56,80,136
https://kawalpemilu.org#60398,"BARU, ARUT SELATAN, KOTAWARINGIN BARAT, KALIMANTAN TENGAH",17,67,109,176
https://kawalpemilu.org#60398,"BARU, ARUT SELATAN, KOTAWARINGIN BARAT, KALIMANTAN TENGAH",18,85,126,211
https://kawalpemilu.org#60398,"BARU, ARUT SELATAN, KOTAWARINGIN BARAT, KALIMANTAN TENGAH",19,70,78,148
https://kawalpemilu.org#60398,"BARU, ARUT SELATAN, KOTAWARINGIN BARAT, KALIMANTAN TENGAH",20,68,160,228
https://kawalpemilu.org#60398,"BARU, ARUT SELATAN, KOTAWARINGIN BARAT, KALIMANTAN TENGAH",21,106,156,262
https://kawalpemilu.org#60398,"BARU, ARUT SELATAN, KOTAWARINGIN BARAT, KALIMANTAN TENGAH",22,76,126,202
https://kawalpemilu.org#60398,"BARU, ARUT SELATAN, KOTAWARINGIN BARAT, KALIMANTAN TENGAH",23,84,131,215
https://kawalpemilu.org#60398,"BARU, ARUT SELATAN, KOTAWARINGIN BARAT, KALIMANTAN TENGAH",24,51,166,217
https://kawalpemilu.org#60398,"BARU, ARUT SELATAN, KOTAWARINGIN BARAT, KALIMANTAN TENGAH",25,81,142,223
https://kawalpemilu.org#60398,"BARU, ARUT SELATAN, KOTAWARINGIN BARAT, KALIMANTAN TENGAH",26,75,103,178
https://kawalpemilu.org#60398,"BARU, ARUT SELATAN, KOTAWARINGIN BARAT, KALIMANTAN TENGAH",27,94,135,229
https://kawalpemilu.org#60398,"BARU, ARUT SELATAN, KOTAWARINGIN BARAT, KALIMANTAN TENGAH",28,48,120,168
https://kawalpemilu.org#60398,"BARU, ARUT SELATAN, KOTAWARINGIN BARAT, KALIMANTAN TENGAH",29,100,111,211
https://kawalpemilu.org#60398,"BARU, ARUT SELATAN, KOTAWARINGIN BARAT, KALIMANTAN TENGAH",30,63,85,148
https://kawalpemilu.org#60398,"BARU, ARUT SELATAN, KOTAWARINGIN BARAT, KALIMANTAN TENGAH",32,88,100,188
https://kawalpemilu.org#60398,"BARU, ARUT SELATAN, KOTAWARINGIN BARAT, KALIMANTAN TENGAH",33,56,94,150
https://kawalpemilu.org#60398,"BARU, ARUT SELATAN, KOTAWARINGIN BARAT, KALIMANTAN TENGAH",34,42,102,144
https://kawalpemilu.org#60398,"BARU, ARUT SELATAN, KOTAWARINGIN BARAT, KALIMANTAN TENGAH",35,82,89,171
https://kawalpemilu.org#60398,"BARU, ARUT SELATAN, KOTAWARINGIN BARAT, KALIMANTAN TENGAH",36,99,77,176
https://kawalpemilu.org#60398,"BARU, ARUT SELATAN, KOTAWARINGIN BARAT, KALIMANTAN TENGAH",37,121,92,213
https://kawalpemilu.org#60398,"BARU, ARUT SELATAN, KOTAWARINGIN BARAT, KALIMANTAN TENGAH",38,61,134,195
https://kawalpemilu.org#60398,"BARU, ARUT SELATAN, KOTAWARINGIN BARAT, KALIMANTAN TENGAH",39,106,48,154
https://kawalpemilu.org#60398,"BARU, ARUT SELATAN, KOTAWARINGIN BARAT, KALIMANTAN TENGAH",40,81,68,149
https://kawalpemilu.org#60398,"BARU, ARUT SELATAN, KOTAWARINGIN BARAT, KALIMANTAN TENGAH",41,77,93,170
https://kawalpemilu.org#60398,"BARU, ARUT SELATAN, KOTAWARINGIN BARAT, KALIMANTAN TENGAH",42,98,103,201
https://kawalpemilu.org#60398,"BARU, ARUT SELATAN, KOTAWARINGIN BARAT, KALIMANTAN TENGAH",43,162,100,262
https://kawalpemilu.org#60398,"BARU, ARUT SELATAN, KOTAWARINGIN BARAT, KALIMANTAN TENGAH",44,66,115,181
https://kawalpemilu.org#60398,"BARU, ARUT SELATAN, KOTAWARINGIN BARAT, KALIMANTAN TENGAH",45,52,121,173
https://kawalpemilu.org#60398,"BARU, ARUT SELATAN, KOTAWARINGIN BARAT, KALIMANTAN TENGAH",46,95,41,136
https://kawalpemilu.org#60398,"BARU, ARUT SELATAN, KOTAWARINGIN BARAT, KALIMANTAN TENGAH",47,106,40,146
https://kawalpemilu.org#60398,"BARU, ARUT SELATAN, KOTAWARINGIN BARAT, KALIMANTAN TENGAH",48,59,72,131
https://kawalpemilu.org#60398,"BARU, ARUT SELATAN, KOTAWARINGIN BARAT, KALIMANTAN TENGAH",49,101,59,160
https://kawalpemilu.org#60398,"BARU, ARUT SELATAN, KOTAWARINGIN BARAT, KALIMANTAN TENGAH",50,48,76,124
https://kawalpemilu.org#60398,"BARU, ARUT SELATAN, KOTAWARINGIN BARAT, KALIMANTAN TENGAH",51,54,92,146
https://kawalpemilu.org#60398,"BARU, ARUT SELATAN, KOTAWARINGIN BARAT, KALIMANTAN TENGAH",52,61,171,232
https://kawalpemilu.org#60398,"BARU, ARUT SELATAN, KOTAWARINGIN BARAT, KALIMANTAN TENGAH",54,69,97,166
https://kawalpemilu.org#60398,"BARU, ARUT SELATAN, KOTAWARINGIN BARAT, KALIMANTAN TENGAH",55,40,55,95
https://kawalpemilu.org#60398,"BARU, ARUT SELATAN, KOTAWARINGIN BARAT, KALIMANTAN TENGAH",56,61,80,141
https://kawalpemilu.org#60398,"BARU, ARUT SELATAN, KOTAWARINGIN BARAT, KALIMANTAN TENGAH",57,47,79,126
https://kawalpemilu.org#60398,"BARU, ARUT SELATAN, KOTAWARINGIN BARAT, KALIMANTAN TENGAH",58,35,43,78
https://kawalpemilu.org#60398,"BARU, ARUT SELATAN, KOTAWARINGIN BARAT, KALIMANTAN TENGAH",59,66,63,129
https://kawalpemilu.org#60398,"BARU, ARUT SELATAN, KOTAWARINGIN BARAT, KALIMANTAN TENGAH",60,76,98,174
https://kawalpemilu.org#60398,"BARU, ARUT SELATAN, KOTAWARINGIN BARAT, KALIMANTAN TENGAH",61,103,61,164
https://kawalpemilu.org#60398,"BARU, ARUT SELATAN, KOTAWARINGIN BARAT, KALIMANTAN TENGAH",62,117,39,156
https://kawalpemilu.org#60398,"BARU, ARUT SELATAN, KOTAWARINGIN BARAT, KALIMANTAN TENGAH",63,71,87,158
https://kawalpemilu.org#60398,"BARU, ARUT SELATAN, KOTAWARINGIN BARAT, KALIMANTAN TENGAH",64,80,85,165
https://kawalpemilu.org#60398,"BARU, ARUT SELATAN, KOTAWARINGIN BARAT, KALIMANTAN TENGAH",65,71,92,163
https://kawalpemilu.org#60398,"BARU, ARUT SELATAN, KOTAWARINGIN BARAT, KALIMANTAN TENGAH",66,106,45,151
https://kawalpemilu.org#60399,"TANJUNG PUTRI, ARUT SELATAN, KOTAWARINGIN BARAT, KALIMANTAN TENGAH",1,73,79,152
https://kawalpemilu.org#60399,"TANJUNG PUTRI, ARUT SELATAN, KOTAWARINGIN BARAT, KALIMANTAN TENGAH",2,40,80,120
https://kawalpemilu.org#60399,"TANJUNG PUTRI, ARUT SELATAN, KOTAWARINGIN BARAT, KALIMANTAN TENGAH",3,34,25,59
https://kawalpemilu.org#60399,"TANJUNG PUTRI, ARUT SELATAN, KOTAWARINGIN BARAT, KALIMANTAN TENGAH",4,31,40,71
https://kawalpemilu.org#60400,"PASIR PANJANG, ARUT SELATAN, KOTAWARINGIN BARAT, KALIMANTAN TENGAH",1,114,57,171
https://kawalpemilu.org#60400,"PASIR PANJANG, ARUT SELATAN, KOTAWARINGIN BARAT, KALIMANTAN TENGAH",2,101,37,138
https://kawalpemilu.org#60400,"PASIR PANJANG, ARUT SELATAN, KOTAWARINGIN BARAT, KALIMANTAN TENGAH",3,105,37,142
https://kawalpemilu.org#60400,"PASIR PANJANG, ARUT SELATAN, KOTAWARINGIN BARAT, KALIMANTAN TENGAH",4,58,44,102
https://kawalpemilu.org#60400,"PASIR PANJANG, ARUT SELATAN, KOTAWARINGIN BARAT, KALIMANTAN TENGAH",5,43,75,118
https://kawalpemilu.org#60400,"PASIR PANJANG, ARUT SELATAN, KOTAWARINGIN BARAT, KALIMANTAN TENGAH",6,168,52,220
https://kawalpemilu.org#60400,"PASIR PANJANG, ARUT SELATAN, KOTAWARINGIN BARAT, KALIMANTAN TENGAH",7,110,115,225
https://kawalpemilu.org#60400,"PASIR PANJANG, ARUT SELATAN, KOTAWARINGIN BARAT, KALIMANTAN TENGAH",8,63,99,162
https://kawalpemilu.org#60400,"PASIR PANJANG, ARUT SELATAN, KOTAWARINGIN BARAT, KALIMANTAN TENGAH",9,82,120,202
https://kawalpemilu.org#60400,"PASIR PANJANG, ARUT SELATAN, KOTAWARINGIN BARAT, KALIMANTAN TENGAH",10,67,71,138
https://kawalpemilu.org#60400,"PASIR PANJANG, ARUT SELATAN, KOTAWARINGIN BARAT, KALIMANTAN TENGAH",11,83,71,154
https://kawalpemilu.org#60400,"PASIR PANJANG, ARUT SELATAN, KOTAWARINGIN BARAT, KALIMANTAN TENGAH",12,74,95,169
https://kawalpemilu.org#60400,"PASIR PANJANG, ARUT SELATAN, KOTAWARINGIN BARAT, KALIMANTAN TENGAH",13,106,80,186
https://kawalpemilu.org#60400,"PASIR PANJANG, ARUT SELATAN, KOTAWARINGIN BARAT, KALIMANTAN TENGAH",14,140,110,250
https://kawalpemilu.org#60400,"PASIR PANJANG, ARUT SELATAN, KOTAWARINGIN BARAT, KALIMANTAN TENGAH",15,101,94,195
https://kawalpemilu.org#60400,"PASIR PANJANG, ARUT SELATAN, KOTAWARINGIN BARAT, KALIMANTAN TENGAH",16,79,80,159
https://kawalpemilu.org#60400,"PASIR PANJANG, ARUT SELATAN, KOTAWARINGIN BARAT, KALIMANTAN TENGAH",17,106,152,258
https://kawalpemilu.org#60400,"PASIR PANJANG, ARUT SELATAN, KOTAWARINGIN BARAT, KALIMANTAN TENGAH",18,100,73,173
https://kawalpemilu.org#60400,"PASIR PANJANG, ARUT SELATAN, KOTAWARINGIN BARAT, KALIMANTAN TENGAH",19,109,109,218
https://kawalpemilu.org#60400,"PASIR PANJANG, ARUT SELATAN, KOTAWARINGIN BARAT, KALIMANTAN TENGAH",20,145,103,248
https://kawalpemilu.org#60400,"PASIR PANJANG, ARUT SELATAN, KOTAWARINGIN BARAT, KALIMANTAN TENGAH",21,118,101,219
https://kawalpemilu.org#60400,"PASIR PANJANG, ARUT SELATAN, KOTAWARINGIN BARAT, KALIMANTAN TENGAH",22,136,60,196
https://kawalpemilu.org#60400,"PASIR PANJANG, ARUT SELATAN, KOTAWARINGIN BARAT, KALIMANTAN TENGAH",23,0,0,124
https://kawalpemilu.org#60400,"PASIR PANJANG, ARUT SELATAN, KOTAWARINGIN BARAT, KALIMANTAN TENGAH",24,127,44,171
https://kawalpemilu.org#60400,"PASIR PANJANG, ARUT SELATAN, KOTAWARINGIN BARAT, KALIMANTAN TENGAH",25,64,33,97
https://kawalpemilu.org#60400,"PASIR PANJANG, ARUT SELATAN, KOTAWARINGIN BARAT, KALIMANTAN TENGAH",26,127,58,185
https://kawalpemilu.org#60400,"PASIR PANJANG, ARUT SELATAN, KOTAWARINGIN BARAT, KALIMANTAN TENGAH",27,106,121,227
https://kawalpemilu.org#60400,"PASIR PANJANG, ARUT SELATAN, KOTAWARINGIN BARAT, KALIMANTAN TENGAH",28,66,77,143
https://kawalpemilu.org#60400,"PASIR PANJANG, ARUT SELATAN, KOTAWARINGIN BARAT, KALIMANTAN TENGAH",29,67,53,120
https://kawalpemilu.org#60400,"PASIR PANJANG, ARUT SELATAN, KOTAWARINGIN BARAT, KALIMANTAN TENGAH",30,102,77,179
https://kawalpemilu.org#60400,"PASIR PANJANG, ARUT SELATAN, KOTAWARINGIN BARAT, KALIMANTAN TENGAH",31,101,41,142
https://kawalpemilu.org#60400,"PASIR PANJANG, ARUT SELATAN, KOTAWARINGIN BARAT, KALIMANTAN TENGAH",32,112,36,148
https://kawalpemilu.org#60400,"PASIR PANJANG, ARUT SELATAN, KOTAWARINGIN BARAT, KALIMANTAN TENGAH",33,83,33,116
https://kawalpemilu.org#60401,"RANGDA, ARUT SELATAN, KOTAWARINGIN BARAT, KALIMANTAN TENGAH",1,97,31,128
https://kawalpemilu.org#60401,"RANGDA, ARUT SELATAN, KOTAWARINGIN BARAT, KALIMANTAN TENGAH",2,106,29,135
https://kawalpemilu.org#60401,"RANGDA, ARUT SELATAN, KOTAWARINGIN BARAT, KALIMANTAN TENGAH",3,133,44,177
https://kawalpemilu.org#60401,"RANGDA, ARUT SELATAN, KOTAWARINGIN BARAT, KALIMANTAN TENGAH",4,89,30,119
https://kawalpemilu.org#60402,"KENAMBUI, ARUT SELATAN, KOTAWARINGIN BARAT, KALIMANTAN TENGAH",1,83,46,129
https://kawalpemilu.org#60402,"KENAMBUI, ARUT SELATAN, KOTAWARINGIN BARAT, KALIMANTAN TENGAH",2,37,64,101
https://kawalpemilu.org#60402,"KENAMBUI, ARUT SELATAN, KOTAWARINGIN BARAT, KALIMANTAN TENGAH",3,45,80,125
https://kawalpemilu.org#60402,"KENAMBUI, ARUT SELATAN, KOTAWARINGIN BARAT, KALIMANTAN TENGAH",4,92,20,112
https://kawalpemilu.org#60403,"RUNTU, ARUT SELATAN, KOTAWARINGIN BARAT, KALIMANTAN TENGAH",1,101,126,227
https://kawalpemilu.org#60403,"RUNTU, ARUT SELATAN, KOTAWARINGIN BARAT, KALIMANTAN TENGAH",2,121,84,205
https://kawalpemilu.org#60403,"RUNTU, ARUT SELATAN, KOTAWARINGIN BARAT, KALIMANTAN TENGAH",3,86,73,159
https://kawalpemilu.org#60403,"RUNTU, ARUT SELATAN, KOTAWARINGIN BARAT, KALIMANTAN TENGAH",4,109,86,195
https://kawalpemilu.org#60404,"UMPANG, ARUT SELATAN, KOTAWARINGIN BARAT, KALIMANTAN TENGAH",1,68,70,138
https://kawalpemilu.org#60404,"UMPANG, ARUT SELATAN, KOTAWARINGIN BARAT, KALIMANTAN TENGAH",2,71,7,78
https://kawalpemilu.org#60404,"UMPANG, ARUT SELATAN, KOTAWARINGIN BARAT, KALIMANTAN TENGAH",3,78,36,114
https://kawalpemilu.org#60404,"UMPANG, ARUT SELATAN, KOTAWARINGIN BARAT, KALIMANTAN TENGAH",4,79,84,163
https://kawalpemilu.org#60405,"KUMPAI BATU BAWAH, ARUT SELATAN, KOTAWARINGIN BARAT, KALIMANTAN TENGAH",1,151,77,228
https://kawalpemilu.org#60405,"KUMPAI BATU BAWAH, ARUT SELATAN, KOTAWARINGIN BARAT, KALIMANTAN TENGAH",2,130,99,229
https://kawalpemilu.org#60405,"KUMPAI BATU BAWAH, ARUT SELATAN, KOTAWARINGIN BARAT, KALIMANTAN TENGAH",3,144,76,220
https://kawalpemilu.org#60405,"KUMPAI BATU BAWAH, ARUT SELATAN, KOTAWARINGIN BARAT, KALIMANTAN TENGAH",4,125,66,191
https://kawalpemilu.org#60405,"KUMPAI BATU BAWAH, ARUT SELATAN, KOTAWARINGIN BARAT, KALIMANTAN TENGAH",5,108,105,213
https://kawalpemilu.org#60405,"KUMPAI BATU BAWAH, ARUT SELATAN, KOTAWARINGIN BARAT, KALIMANTAN TENGAH",6,162,66,228
https://kawalpemilu.org#60406,"KUMPAI BATU ATAS, ARUT SELATAN, KOTAWARINGIN BARAT, KALIMANTAN TENGAH",1,163,83,246
https://kawalpemilu.org#60406,"KUMPAI BATU ATAS, ARUT SELATAN, KOTAWARINGIN BARAT, KALIMANTAN TENGAH",2,163,83,246
https://kawalpemilu.org#60406,"KUMPAI BATU ATAS, ARUT SELATAN, KOTAWARINGIN BARAT, KALIMANTAN TENGAH",3,137,80,217
https://kawalpemilu.org#60406,"KUMPAI BATU ATAS, ARUT SELATAN, KOTAWARINGIN BARAT, KALIMANTAN TENGAH",4,177,75,252
https://kawalpemilu.org#60406,"KUMPAI BATU ATAS, ARUT SELATAN, KOTAWARINGIN BARAT, KALIMANTAN TENGAH",5,144,79,223
https://kawalpemilu.org#60406,"KUMPAI BATU ATAS, ARUT SELATAN, KOTAWARINGIN BARAT, KALIMANTAN TENGAH",6,116,76,192
https://kawalpemilu.org#60406,"KUMPAI BATU ATAS, ARUT SELATAN, KOTAWARINGIN BARAT, KALIMANTAN TENGAH",7,153,77,230
https://kawalpemilu.org#60406,"KUMPAI BATU ATAS, ARUT SELATAN, KOTAWARINGIN BARAT, KALIMANTAN TENGAH",8,171,74,245
https://kawalpemilu.org#60406,"KUMPAI BATU ATAS, ARUT SELATAN, KOTAWARINGIN BARAT, KALIMANTAN TENGAH",9,117,90,207
https://kawalpemilu.org#60407,"NATAI RAYA, ARUT SELATAN, KOTAWARINGIN BARAT, KALIMANTAN TENGAH",1,151,51,202
https://kawalpemilu.org#60407,"NATAI RAYA, ARUT SELATAN, KOTAWARINGIN BARAT, KALIMANTAN TENGAH",2,157,48,205
https://kawalpemilu.org#60407,"NATAI RAYA, ARUT SELATAN, KOTAWARINGIN BARAT, KALIMANTAN TENGAH",3,131,64,195
https://kawalpemilu.org#60407,"NATAI RAYA, ARUT SELATAN, KOTAWARINGIN BARAT, KALIMANTAN TENGAH",4,151,56,207
https://kawalpemilu.org#60407,"NATAI RAYA, ARUT SELATAN, KOTAWARINGIN BARAT, KALIMANTAN TENGAH",5,188,53,241
https://kawalpemilu.org#60408,"MEDANG SARI, ARUT SELATAN, KOTAWARINGIN BARAT, KALIMANTAN TENGAH",4,130,95,225
https://kawalpemilu.org#60409,"NATAI BARU, ARUT SELATAN, KOTAWARINGIN BARAT, KALIMANTAN TENGAH",1,166,46,212
https://kawalpemilu.org#60409,"NATAI BARU, ARUT SELATAN, KOTAWARINGIN BARAT, KALIMANTAN TENGAH",2,172,60,232
https://kawalpemilu.org#60409,"NATAI BARU, ARUT SELATAN, KOTAWARINGIN BARAT, KALIMANTAN TENGAH",3,147,75,222
https://kawalpemilu.org#60410,"TANJUNG TERANTANG, ARUT SELATAN, KOTAWARINGIN BARAT, KALIMANTAN TENGAH",1,157,67,224
https://kawalpemilu.org#60410,"TANJUNG TERANTANG, ARUT SELATAN, KOTAWARINGIN BARAT, KALIMANTAN TENGAH",2,142,47,189
https://kawalpemilu.org#60410,"TANJUNG TERANTANG, ARUT SELATAN, KOTAWARINGIN BARAT, KALIMANTAN TENGAH",3,80,103,183
https://kawalpemilu.org#60411,"SULUNG, ARUT SELATAN, KOTAWARINGIN BARAT, KALIMANTAN TENGAH",1,105,22,127
https://kawalpemilu.org#60411,"SULUNG, ARUT SELATAN, KOTAWARINGIN BARAT, KALIMANTAN TENGAH",2,58,73,131
https://kawalpemilu.org#60411,"SULUNG, ARUT SELATAN, KOTAWARINGIN BARAT, KALIMANTAN TENGAH",3,55,64,119
https://kawalpemilu.org#60411,"SULUNG, ARUT SELATAN, KOTAWARINGIN BARAT, KALIMANTAN TENGAH",4,116,55,171
https://kawalpemilu.org#60413,"KOTAWARINGIN HULU, KOTAWARINGIN LAMA, KOTAWARINGIN BARAT, KALIMANTAN TENGAH",1,51,96,147
https://kawalpemilu.org#60413,"KOTAWARINGIN HULU, KOTAWARINGIN LAMA, KOTAWARINGIN BARAT, KALIMANTAN TENGAH",2,41,77,118
https://kawalpemilu.org#60413,"KOTAWARINGIN HULU, KOTAWARINGIN LAMA, KOTAWARINGIN BARAT, KALIMANTAN TENGAH",3,70,124,194
https://kawalpemilu.org#60413,"KOTAWARINGIN HULU, KOTAWARINGIN LAMA, KOTAWARINGIN BARAT, KALIMANTAN TENGAH",4,59,81,140
https://kawalpemilu.org#60413,"KOTAWARINGIN HULU, KOTAWARINGIN LAMA, KOTAWARINGIN BARAT, KALIMANTAN TENGAH",5,87,124,211
https://kawalpemilu.org#60413,"KOTAWARINGIN HULU, KOTAWARINGIN LAMA, KOTAWARINGIN BARAT, KALIMANTAN TENGAH",6,87,61,148
https://kawalpemilu.org#60413,"KOTAWARINGIN HULU, KOTAWARINGIN LAMA, KOTAWARINGIN BARAT, KALIMANTAN TENGAH",7,41,13,54
https://kawalpemilu.org#60413,"KOTAWARINGIN HULU, KOTAWARINGIN LAMA, KOTAWARINGIN BARAT, KALIMANTAN TENGAH",8,58,75,133
https://kawalpemilu.org#60414,"KOTAWARINGIN HILIR, KOTAWARINGIN LAMA, KOTAWARINGIN BARAT, KALIMANTAN TENGAH",1,121,47,168
https://kawalpemilu.org#60414,"KOTAWARINGIN HILIR, KOTAWARINGIN LAMA, KOTAWARINGIN BARAT, KALIMANTAN TENGAH",2,79,113,192
https://kawalpemilu.org#60414,"KOTAWARINGIN HILIR, KOTAWARINGIN LAMA, KOTAWARINGIN BARAT, KALIMANTAN TENGAH",3,99,87,186
https://kawalpemilu.org#60414,"KOTAWARINGIN HILIR, KOTAWARINGIN LAMA, KOTAWARINGIN BARAT, KALIMANTAN TENGAH",4,86,57,143
https://kawalpemilu.org#60414,"KOTAWARINGIN HILIR, KOTAWARINGIN LAMA, KOTAWARINGIN BARAT, KALIMANTAN TENGAH",5,86,54,140
https://kawalpemilu.org#60414,"KOTAWARINGIN HILIR, KOTAWARINGIN LAMA, KOTAWARINGIN BARAT, KALIMANTAN TENGAH",6,63,73,136
https://kawalpemilu.org#60414,"KOTAWARINGIN HILIR, KOTAWARINGIN LAMA, KOTAWARINGIN BARAT, KALIMANTAN TENGAH",7,73,43,116
https://kawalpemilu.org#60414,"KOTAWARINGIN HILIR, KOTAWARINGIN LAMA, KOTAWARINGIN BARAT, KALIMANTAN TENGAH",8,19,6,25
https://kawalpemilu.org#60414,"KOTAWARINGIN HILIR, KOTAWARINGIN LAMA, KOTAWARINGIN BARAT, KALIMANTAN TENGAH",9,84,87,171
https://kawalpemilu.org#60414,"KOTAWARINGIN HILIR, KOTAWARINGIN LAMA, KOTAWARINGIN BARAT, KALIMANTAN TENGAH",10,67,61,128
https://kawalpemilu.org#60414,"KOTAWARINGIN HILIR, KOTAWARINGIN LAMA, KOTAWARINGIN BARAT, KALIMANTAN TENGAH",11,81,51,132
https://kawalpemilu.org#60414,"KOTAWARINGIN HILIR, KOTAWARINGIN LAMA, KOTAWARINGIN BARAT, KALIMANTAN TENGAH",12,66,56,122
https://kawalpemilu.org#60415,"BABUAL BABOTI, KOTAWARINGIN LAMA, KOTAWARINGIN BARAT, KALIMANTAN TENGAH",1,67,49,116
https://kawalpemilu.org#60415,"BABUAL BABOTI, KOTAWARINGIN LAMA, KOTAWARINGIN BARAT, KALIMANTAN TENGAH",2,81,71,152
https://kawalpemilu.org#60415,"BABUAL BABOTI, KOTAWARINGIN LAMA, KOTAWARINGIN BARAT, KALIMANTAN TENGAH",3,68,43,111
https://kawalpemilu.org#60416,"TEMPAYUNG, KOTAWARINGIN LAMA, KOTAWARINGIN BARAT, KALIMANTAN TENGAH",1,72,113,185
https://kawalpemilu.org#60416,"TEMPAYUNG, KOTAWARINGIN LAMA, KOTAWARINGIN BARAT, KALIMANTAN TENGAH",2,47,76,123
https://kawalpemilu.org#60416,"TEMPAYUNG, KOTAWARINGIN LAMA, KOTAWARINGIN BARAT, KALIMANTAN TENGAH",3,54,88,142
https://kawalpemilu.org#60417,"SAKABULIN, KOTAWARINGIN LAMA, KOTAWARINGIN BARAT, KALIMANTAN TENGAH",1,63,166,229
https://kawalpemilu.org#60417,"SAKABULIN, KOTAWARINGIN LAMA, KOTAWARINGIN BARAT, KALIMANTAN TENGAH",2,48,121,169
https://kawalpemilu.org#60418,"KINJIL, KOTAWARINGIN LAMA, KOTAWARINGIN BARAT, KALIMANTAN TENGAH",1,96,91,187
https://kawalpemilu.org#60418,"KINJIL, KOTAWARINGIN LAMA, KOTAWARINGIN BARAT, KALIMANTAN TENGAH",2,105,64,169
https://kawalpemilu.org#60419,"DAWAK, KOTAWARINGIN LAMA, KOTAWARINGIN BARAT, KALIMANTAN TENGAH",1,128,59,187
https://kawalpemilu.org#60419,"DAWAK, KOTAWARINGIN LAMA, KOTAWARINGIN BARAT, KALIMANTAN TENGAH",2,127,42,169
https://kawalpemilu.org#60420,"RIAM DURIAN, KOTAWARINGIN LAMA, KOTAWARINGIN BARAT, KALIMANTAN TENGAH",1,122,67,189
https://kawalpemilu.org#60420,"RIAM DURIAN, KOTAWARINGIN LAMA, KOTAWARINGIN BARAT, KALIMANTAN TENGAH",2,97,55,152
https://kawalpemilu.org#60420,"RIAM DURIAN, KOTAWARINGIN LAMA, KOTAWARINGIN BARAT, KALIMANTAN TENGAH",3,146,66,212
https://kawalpemilu.org#60420,"RIAM DURIAN, KOTAWARINGIN LAMA, KOTAWARINGIN BARAT, KALIMANTAN TENGAH",4,138,39,177
https://kawalpemilu.org#60420,"RIAM DURIAN, KOTAWARINGIN LAMA, KOTAWARINGIN BARAT, KALIMANTAN TENGAH",5,175,65,240
https://kawalpemilu.org#60420,"RIAM DURIAN, KOTAWARINGIN LAMA, KOTAWARINGIN BARAT, KALIMANTAN TENGAH",6,155,41,196
https://kawalpemilu.org#60421,"LALANG, KOTAWARINGIN LAMA, KOTAWARINGIN BARAT, KALIMANTAN TENGAH",1,91,69,160
https://kawalpemilu.org#60422,"RUNGUN, KOTAWARINGIN LAMA, KOTAWARINGIN BARAT, KALIMANTAN TENGAH",1,140,43,183
https://kawalpemilu.org#60422,"RUNGUN, KOTAWARINGIN LAMA, KOTAWARINGIN BARAT, KALIMANTAN TENGAH",2,71,70,141
https://kawalpemilu.org#60422,"RUNGUN, KOTAWARINGIN LAMA, KOTAWARINGIN BARAT, KALIMANTAN TENGAH",3,86,81,167
https://kawalpemilu.org#60422,"RUNGUN, KOTAWARINGIN LAMA, KOTAWARINGIN BARAT, KALIMANTAN TENGAH",4,64,78,142
https://kawalpemilu.org#60422,"RUNGUN, KOTAWARINGIN LAMA, KOTAWARINGIN BARAT, KALIMANTAN TENGAH",5,60,90,150
https://kawalpemilu.org#60423,"KONDANG, KOTAWARINGIN LAMA, KOTAWARINGIN BARAT, KALIMANTAN TENGAH",1,130,85,215
https://kawalpemilu.org#60423,"KONDANG, KOTAWARINGIN LAMA, KOTAWARINGIN BARAT, KALIMANTAN TENGAH",2,50,8,58
https://kawalpemilu.org#60425,"SUKA MAKMUR, KOTAWARINGIN LAMA, KOTAWARINGIN BARAT, KALIMANTAN TENGAH",1,170,35,205
https://kawalpemilu.org#60425,"SUKA MAKMUR, KOTAWARINGIN LAMA, KOTAWARINGIN BARAT, KALIMANTAN TENGAH",2,186,44,230
https://kawalpemilu.org#60426,"SUKAJAYA, KOTAWARINGIN LAMA, KOTAWARINGIN BARAT, KALIMANTAN TENGAH",1,147,35,182
https://kawalpemilu.org#60426,"SUKAJAYA, KOTAWARINGIN LAMA, KOTAWARINGIN BARAT, KALIMANTAN TENGAH",2,154,33,187
https://kawalpemilu.org#60426,"SUKAJAYA, KOTAWARINGIN LAMA, KOTAWARINGIN BARAT, KALIMANTAN TENGAH",3,173,26,199
https://kawalpemilu.org#60427,"IPUH BANGUN JAYA, KOTAWARINGIN LAMA, KOTAWARINGIN BARAT, KALIMANTAN TENGAH",1,132,21,153
https://kawalpemilu.org#60427,"IPUH BANGUN JAYA, KOTAWARINGIN LAMA, KOTAWARINGIN BARAT, KALIMANTAN TENGAH",2,178,43,221
https://kawalpemilu.org#60427,"IPUH BANGUN JAYA, KOTAWARINGIN LAMA, KOTAWARINGIN BARAT, KALIMANTAN TENGAH",3,137,30,167
https://kawalpemilu.org#60428,"SUMBER MUKTI, KOTAWARINGIN LAMA, KOTAWARINGIN BARAT, KALIMANTAN TENGAH",1,118,23,141
https://kawalpemilu.org#60428,"SUMBER MUKTI, KOTAWARINGIN LAMA, KOTAWARINGIN BARAT, KALIMANTAN TENGAH",2,124,39,163
https://kawalpemilu.org#60428,"SUMBER MUKTI, KOTAWARINGIN LAMA, KOTAWARINGIN BARAT, KALIMANTAN TENGAH",3,96,20,116
https://kawalpemilu.org#60429,"PALIH BARU, KOTAWARINGIN LAMA, KOTAWARINGIN BARAT, KALIMANTAN TENGAH",1,115,28,143
https://kawalpemilu.org#60429,"PALIH BARU, KOTAWARINGIN LAMA, KOTAWARINGIN BARAT, KALIMANTAN TENGAH",2,114,31,145
https://kawalpemilu.org#60429,"PALIH BARU, KOTAWARINGIN LAMA, KOTAWARINGIN BARAT, KALIMANTAN TENGAH",3,95,21,116
https://kawalpemilu.org#60429,"PALIH BARU, KOTAWARINGIN LAMA, KOTAWARINGIN BARAT, KALIMANTAN TENGAH",4,109,14,123
https://kawalpemilu.org#85362,"SAGU SUKA MULYA, KOTAWARINGIN LAMA, KOTAWARINGIN BARAT, KALIMANTAN TENGAH",1,89,63,152
https://kawalpemilu.org#85362,"SAGU SUKA MULYA, KOTAWARINGIN LAMA, KOTAWARINGIN BARAT, KALIMANTAN TENGAH",2,91,23,114
https://kawalpemilu.org#85362,"SAGU SUKA MULYA, KOTAWARINGIN LAMA, KOTAWARINGIN BARAT, KALIMANTAN TENGAH",3,66,41,107
https://kawalpemilu.org#85362,"SAGU SUKA MULYA, KOTAWARINGIN LAMA, KOTAWARINGIN BARAT, KALIMANTAN TENGAH",4,99,33,132
https://kawalpemilu.org#85362,"SAGU SUKA MULYA, KOTAWARINGIN LAMA, KOTAWARINGIN BARAT, KALIMANTAN TENGAH",5,108,23,131
https://kawalpemilu.org#60431,"PANGKUT, ARUT UTARA, KOTAWARINGIN BARAT, KALIMANTAN TENGAH",1,147,8,155
https://kawalpemilu.org#60431,"PANGKUT, ARUT UTARA, KOTAWARINGIN BARAT, KALIMANTAN TENGAH",2,123,8,131
https://kawalpemilu.org#60431,"PANGKUT, ARUT UTARA, KOTAWARINGIN BARAT, KALIMANTAN TENGAH",3,109,22,131
https://kawalpemilu.org#60431,"PANGKUT, ARUT UTARA, KOTAWARINGIN BARAT, KALIMANTAN TENGAH",4,49,14,63
https://kawalpemilu.org#60431,"PANGKUT, ARUT UTARA, KOTAWARINGIN BARAT, KALIMANTAN TENGAH",5,134,41,175
https://kawalpemilu.org#60431,"PANGKUT, ARUT UTARA, KOTAWARINGIN BARAT, KALIMANTAN TENGAH",6,132,40,172
https://kawalpemilu.org#60431,"PANGKUT, ARUT UTARA, KOTAWARINGIN BARAT, KALIMANTAN TENGAH",7,21,7,28
https://kawalpemilu.org#60431,"PANGKUT, ARUT UTARA, KOTAWARINGIN BARAT, KALIMANTAN TENGAH",9,189,21,210
https://kawalpemilu.org#60431,"PANGKUT, ARUT UTARA, KOTAWARINGIN BARAT, KALIMANTAN TENGAH",10,152,13,165
https://kawalpemilu.org#60431,"PANGKUT, ARUT UTARA, KOTAWARINGIN BARAT, KALIMANTAN TENGAH",11,93,24,117
https://kawalpemilu.org#60431,"PANGKUT, ARUT UTARA, KOTAWARINGIN BARAT, KALIMANTAN TENGAH",12,42,8,50
https://kawalpemilu.org#60431,"PANGKUT, ARUT UTARA, KOTAWARINGIN BARAT, KALIMANTAN TENGAH",13,73,18,91
https://kawalpemilu.org#60431,"PANGKUT, ARUT UTARA, KOTAWARINGIN BARAT, KALIMANTAN TENGAH",14,75,17,92
https://kawalpemilu.org#60431,"PANGKUT, ARUT UTARA, KOTAWARINGIN BARAT, KALIMANTAN TENGAH",15,140,7,147
https://kawalpemilu.org#60431,"PANGKUT, ARUT UTARA, KOTAWARINGIN BARAT, KALIMANTAN TENGAH",16,44,12,56
https://kawalpemilu.org#60431,"PANGKUT, ARUT UTARA, KOTAWARINGIN BARAT, KALIMANTAN TENGAH",17,39,15,54
https://kawalpemilu.org#60432,"NANGA MUA, ARUT UTARA, KOTAWARINGIN BARAT, KALIMANTAN TENGAH",1,87,26,113
https://kawalpemilu.org#60432,"NANGA MUA, ARUT UTARA, KOTAWARINGIN BARAT, KALIMANTAN TENGAH",2,105,24,129
https://kawalpemilu.org#60432,"NANGA MUA, ARUT UTARA, KOTAWARINGIN BARAT, KALIMANTAN TENGAH",3,72,13,85
https://kawalpemilu.org#60433,"SUKARAMI, ARUT UTARA, KOTAWARINGIN BARAT, KALIMANTAN TENGAH",1,165,16,181
https://kawalpemilu.org#60433,"SUKARAMI, ARUT UTARA, KOTAWARINGIN BARAT, KALIMANTAN TENGAH",2,98,11,109
https://kawalpemilu.org#60434,"GANDIS, ARUT UTARA, KOTAWARINGIN BARAT, KALIMANTAN TENGAH",1,190,20,210
https://kawalpemilu.org#60435,"KERABU, ARUT UTARA, KOTAWARINGIN BARAT, KALIMANTAN TENGAH",1,114,26,140
https://kawalpemilu.org#60435,"KERABU, ARUT UTARA, KOTAWARINGIN BARAT, KALIMANTAN TENGAH",2,67,6,73
https://kawalpemilu.org#60436,"SAMBI, ARUT UTARA, KOTAWARINGIN BARAT, KALIMANTAN TENGAH",1,112,34,146
https://kawalpemilu.org#60436,"SAMBI, ARUT UTARA, KOTAWARINGIN BARAT, KALIMANTAN TENGAH",2,158,19,177
https://kawalpemilu.org#60437,"PENYOMBAAN, ARUT UTARA, KOTAWARINGIN BARAT, KALIMANTAN TENGAH",1,66,59,125
https://kawalpemilu.org#60437,"PENYOMBAAN, ARUT UTARA, KOTAWARINGIN BARAT, KALIMANTAN TENGAH",2,86,63,149
https://kawalpemilu.org#60438,"PANDAU, ARUT UTARA, KOTAWARINGIN BARAT, KALIMANTAN TENGAH",1,221,9,230
https://kawalpemilu.org#60439,"RIAM, ARUT UTARA, KOTAWARINGIN BARAT, KALIMANTAN TENGAH",1,167,4,171
https://kawalpemilu.org#60440,"PANAHAN, ARUT UTARA, KOTAWARINGIN BARAT, KALIMANTAN TENGAH",1,174,4,178
https://kawalpemilu.org#60440,"PANAHAN, ARUT UTARA, KOTAWARINGIN BARAT, KALIMANTAN TENGAH",2,154,13,167
https://kawalpemilu.org#60441,"SUNGAI DAU, ARUT UTARA, KOTAWARINGIN BARAT, KALIMANTAN TENGAH",1,91,11,102
https://kawalpemilu.org#60443,"PANGKALAN TIGA, PANGKALAN LADA, KOTAWARINGIN BARAT, KALIMANTAN TENGAH",1,220,21,241
https://kawalpemilu.org#60443,"PANGKALAN TIGA, PANGKALAN LADA, KOTAWARINGIN BARAT, KALIMANTAN TENGAH",2,133,31,164
https://kawalpemilu.org#60443,"PANGKALAN TIGA, PANGKALAN LADA, KOTAWARINGIN BARAT, KALIMANTAN TENGAH",3,188,27,215
https://kawalpemilu.org#60443,"PANGKALAN TIGA, PANGKALAN LADA, KOTAWARINGIN BARAT, KALIMANTAN TENGAH",4,0,0,0
https://kawalpemilu.org#60443,"PANGKALAN TIGA, PANGKALAN LADA, KOTAWARINGIN BARAT, KALIMANTAN TENGAH",5,194,14,208
https://kawalpemilu.org#60443,"PANGKALAN TIGA, PANGKALAN LADA, KOTAWARINGIN BARAT, KALIMANTAN TENGAH",6,121,37,158
https://kawalpemilu.org#60443,"PANGKALAN TIGA, PANGKALAN LADA, KOTAWARINGIN BARAT, KALIMANTAN TENGAH",7,158,37,195
https://kawalpemilu.org#60443,"PANGKALAN TIGA, PANGKALAN LADA, KOTAWARINGIN BARAT, KALIMANTAN TENGAH",8,108,33,141
https://kawalpemilu.org#60443,"PANGKALAN TIGA, PANGKALAN LADA, KOTAWARINGIN BARAT, KALIMANTAN TENGAH",9,160,20,180
https://kawalpemilu.org#60443,"PANGKALAN TIGA, PANGKALAN LADA, KOTAWARINGIN BARAT, KALIMANTAN TENGAH",10,142,33,175
https://kawalpemilu.org#60444,"PANDU SANJAYA, PANGKALAN LADA, KOTAWARINGIN BARAT, KALIMANTAN TENGAH",1,179,55,234
https://kawalpemilu.org#60444,"PANDU SANJAYA, PANGKALAN LADA, KOTAWARINGIN BARAT, KALIMANTAN TENGAH",2,170,37,207
https://kawalpemilu.org#60444,"PANDU SANJAYA, PANGKALAN LADA, KOTAWARINGIN BARAT, KALIMANTAN TENGAH",3,164,71,235
https://kawalpemilu.org#60444,"PANDU SANJAYA, PANGKALAN LADA, KOTAWARINGIN BARAT, KALIMANTAN TENGAH",4,207,38,245
https://kawalpemilu.org#60444,"PANDU SANJAYA, PANGKALAN LADA, KOTAWARINGIN BARAT, KALIMANTAN TENGAH",5,170,55,225
https://kawalpemilu.org#60444,"PANDU SANJAYA, PANGKALAN LADA, KOTAWARINGIN BARAT, KALIMANTAN TENGAH",6,136,47,183
https://kawalpemilu.org#60444,"PANDU SANJAYA, PANGKALAN LADA, KOTAWARINGIN BARAT, KALIMANTAN TENGAH",7,168,55,223
https://kawalpemilu.org#60444,"PANDU SANJAYA, PANGKALAN LADA, KOTAWARINGIN BARAT, KALIMANTAN TENGAH",8,153,48,201
https://kawalpemilu.org#60444,"PANDU SANJAYA, PANGKALAN LADA, KOTAWARINGIN BARAT, KALIMANTAN TENGAH",9,109,81,190
https://kawalpemilu.org#60444,"PANDU SANJAYA, PANGKALAN LADA, KOTAWARINGIN BARAT, KALIMANTAN TENGAH",10,132,97,229
https://kawalpemilu.org#60444,"PANDU SANJAYA, PANGKALAN LADA, KOTAWARINGIN BARAT, KALIMANTAN TENGAH",11,175,30,205
https://kawalpemilu.org#60444,"PANDU SANJAYA, PANGKALAN LADA, KOTAWARINGIN BARAT, KALIMANTAN TENGAH",12,201,13,214
https://kawalpemilu.org#60444,"PANDU SANJAYA, PANGKALAN LADA, KOTAWARINGIN BARAT, KALIMANTAN TENGAH",13,199,32,231
https://kawalpemilu.org#60444,"PANDU SANJAYA, PANGKALAN LADA, KOTAWARINGIN BARAT, KALIMANTAN TENGAH",14,158,28,186
https://kawalpemilu.org#60444,"PANDU SANJAYA, PANGKALAN LADA, KOTAWARINGIN BARAT, KALIMANTAN TENGAH",15,160,25,185
https://kawalpemilu.org#60444,"PANDU SANJAYA, PANGKALAN LADA, KOTAWARINGIN BARAT, KALIMANTAN TENGAH",16,133,38,171
https://kawalpemilu.org#60444,"PANDU SANJAYA, PANGKALAN LADA, KOTAWARINGIN BARAT, KALIMANTAN TENGAH",17,121,42,163
https://kawalpemilu.org#60444,"PANDU SANJAYA, PANGKALAN LADA, KOTAWARINGIN BARAT, KALIMANTAN TENGAH",18,143,60,203
https://kawalpemilu.org#60444,"PANDU SANJAYA, PANGKALAN LADA, KOTAWARINGIN BARAT, KALIMANTAN TENGAH",19,117,88,205
https://kawalpemilu.org#60445,"LADA MANDALA JAYA, PANGKALAN LADA, KOTAWARINGIN BARAT, KALIMANTAN TENGAH",1,111,78,189
https://kawalpemilu.org#60445,"LADA MANDALA JAYA, PANGKALAN LADA, KOTAWARINGIN BARAT, KALIMANTAN TENGAH",2,166,47,213
https://kawalpemilu.org#60445,"LADA MANDALA JAYA, PANGKALAN LADA, KOTAWARINGIN BARAT, KALIMANTAN TENGAH",3,172,63,235
https://kawalpemilu.org#60445,"LADA MANDALA JAYA, PANGKALAN LADA, KOTAWARINGIN BARAT, KALIMANTAN TENGAH",4,183,57,240
https://kawalpemilu.org#60445,"LADA MANDALA JAYA, PANGKALAN LADA, KOTAWARINGIN BARAT, KALIMANTAN TENGAH",5,155,74,229
https://kawalpemilu.org#60445,"LADA MANDALA JAYA, PANGKALAN LADA, KOTAWARINGIN BARAT, KALIMANTAN TENGAH",6,161,57,218
https://kawalpemilu.org#60445,"LADA MANDALA JAYA, PANGKALAN LADA, KOTAWARINGIN BARAT, KALIMANTAN TENGAH",7,193,49,242
https://kawalpemilu.org#60446,"MAKARTI JAYA, PANGKALAN LADA, KOTAWARINGIN BARAT, KALIMANTAN TENGAH",1,191,41,232
https://kawalpemilu.org#60446,"MAKARTI JAYA, PANGKALAN LADA, KOTAWARINGIN BARAT, KALIMANTAN TENGAH",2,150,59,209
https://kawalpemilu.org#60446,"MAKARTI JAYA, PANGKALAN LADA, KOTAWARINGIN BARAT, KALIMANTAN TENGAH",3,133,23,156
https://kawalpemilu.org#60446,"MAKARTI JAYA, PANGKALAN LADA, KOTAWARINGIN BARAT, KALIMANTAN TENGAH",4,135,70,205
https://kawalpemilu.org#60446,"MAKARTI JAYA, PANGKALAN LADA, KOTAWARINGIN BARAT, KALIMANTAN TENGAH",5,154,30,184
https://kawalpemilu.org#60446,"MAKARTI JAYA, PANGKALAN LADA, KOTAWARINGIN BARAT, KALIMANTAN TENGAH",6,160,25,185
https://kawalpemilu.org#60447,"SUMBER AGUNG, PANGKALAN LADA, KOTAWARINGIN BARAT, KALIMANTAN TENGAH",1,143,89,232
https://kawalpemilu.org#60447,"SUMBER AGUNG, PANGKALAN LADA, KOTAWARINGIN BARAT, KALIMANTAN TENGAH",2,148,46,194
https://kawalpemilu.org#60447,"SUMBER AGUNG, PANGKALAN LADA, KOTAWARINGIN BARAT, KALIMANTAN TENGAH",3,157,45,202
https://kawalpemilu.org#60447,"SUMBER AGUNG, PANGKALAN LADA, KOTAWARINGIN BARAT, KALIMANTAN TENGAH",4,158,67,225
https://kawalpemilu.org#60447,"SUMBER AGUNG, PANGKALAN LADA, KOTAWARINGIN BARAT, KALIMANTAN TENGAH",5,162,52,214
https://kawalpemilu.org#60447,"SUMBER AGUNG, PANGKALAN LADA, KOTAWARINGIN BARAT, KALIMANTAN TENGAH",6,189,25,214
https://kawalpemilu.org#60447,"SUMBER AGUNG, PANGKALAN LADA, KOTAWARINGIN BARAT, KALIMANTAN TENGAH",7,165,61,226
https://kawalpemilu.org#60447,"SUMBER AGUNG, PANGKALAN LADA, KOTAWARINGIN BARAT, KALIMANTAN TENGAH",8,127,74,201
https://kawalpemilu.org#60447,"SUMBER AGUNG, PANGKALAN LADA, KOTAWARINGIN BARAT, KALIMANTAN TENGAH",9,165,50,215
https://kawalpemilu.org#60447,"SUMBER AGUNG, PANGKALAN LADA, KOTAWARINGIN BARAT, KALIMANTAN TENGAH",10,162,56,218
https://kawalpemilu.org#60448,"PURBASARI, PANGKALAN LADA, KOTAWARINGIN BARAT, KALIMANTAN TENGAH",1,183,51,234
https://kawalpemilu.org#60448,"PURBASARI, PANGKALAN LADA, KOTAWARINGIN BARAT, KALIMANTAN TENGAH",2,137,79,216
https://kawalpemilu.org#60448,"PURBASARI, PANGKALAN LADA, KOTAWARINGIN BARAT, KALIMANTAN TENGAH",3,131,63,194
https://kawalpemilu.org#60448,"PURBASARI, PANGKALAN LADA, KOTAWARINGIN BARAT, KALIMANTAN TENGAH",4,94,103,197
https://kawalpemilu.org#60448,"PURBASARI, PANGKALAN LADA, KOTAWARINGIN BARAT, KALIMANTAN TENGAH",5,164,75,239
https://kawalpemilu.org#60448,"PURBASARI, PANGKALAN LADA, KOTAWARINGIN BARAT, KALIMANTAN TENGAH",6,113,23,136
https://kawalpemilu.org#60448,"PURBASARI, PANGKALAN LADA, KOTAWARINGIN BARAT, KALIMANTAN TENGAH",7,187,43,230
https://kawalpemilu.org#60448,"PURBASARI, PANGKALAN LADA, KOTAWARINGIN BARAT, KALIMANTAN TENGAH",8,169,35,204
https://kawalpemilu.org#60448,"PURBASARI, PANGKALAN LADA, KOTAWARINGIN BARAT, KALIMANTAN TENGAH",9,160,44,204
https://kawalpemilu.org#60448,"PURBASARI, PANGKALAN LADA, KOTAWARINGIN BARAT, KALIMANTAN TENGAH",10,156,51,207
https://kawalpemilu.org#60449,"SUNGAI RANGIT JAYA, PANGKALAN LADA, KOTAWARINGIN BARAT, KALIMANTAN TENGAH",1,160,65,225
https://kawalpemilu.org#60449,"SUNGAI RANGIT JAYA, PANGKALAN LADA, KOTAWARINGIN BARAT, KALIMANTAN TENGAH",2,130,71,201
https://kawalpemilu.org#60449,"SUNGAI RANGIT JAYA, PANGKALAN LADA, KOTAWARINGIN BARAT, KALIMANTAN TENGAH",3,153,104,257
https://kawalpemilu.org#60449,"SUNGAI RANGIT JAYA, PANGKALAN LADA, KOTAWARINGIN BARAT, KALIMANTAN TENGAH",4,124,97,221
https://kawalpemilu.org#60449,"SUNGAI RANGIT JAYA, PANGKALAN LADA, KOTAWARINGIN BARAT, KALIMANTAN TENGAH",5,118,32,150
https://kawalpemilu.org#60449,"SUNGAI RANGIT JAYA, PANGKALAN LADA, KOTAWARINGIN BARAT, KALIMANTAN TENGAH",6,132,60,192
https://kawalpemilu.org#60450,"PANGKALAN DEWA, PANGKALAN LADA, KOTAWARINGIN BARAT, KALIMANTAN TENGAH",1,174,47,221
https://kawalpemilu.org#60450,"PANGKALAN DEWA, PANGKALAN LADA, KOTAWARINGIN BARAT, KALIMANTAN TENGAH",2,130,48,178
https://kawalpemilu.org#60450,"PANGKALAN DEWA, PANGKALAN LADA, KOTAWARINGIN BARAT, KALIMANTAN TENGAH",3,145,59,204
https://kawalpemilu.org#60450,"PANGKALAN DEWA, PANGKALAN LADA, KOTAWARINGIN BARAT, KALIMANTAN TENGAH",4,118,37,155
https://kawalpemilu.org#60450,"PANGKALAN DEWA, PANGKALAN LADA, KOTAWARINGIN BARAT, KALIMANTAN TENGAH",5,180,35,215
https://kawalpemilu.org#60450,"PANGKALAN DEWA, PANGKALAN LADA, KOTAWARINGIN BARAT, KALIMANTAN TENGAH",6,220,23,243
https://kawalpemilu.org#60450,"PANGKALAN DEWA, PANGKALAN LADA, KOTAWARINGIN BARAT, KALIMANTAN TENGAH",7,175,39,214
https://kawalpemilu.org#60450,"PANGKALAN DEWA, PANGKALAN LADA, KOTAWARINGIN BARAT, KALIMANTAN TENGAH",8,145,37,182
https://kawalpemilu.org#60451,"KADIPI ATAS, PANGKALAN LADA, KOTAWARINGIN BARAT, KALIMANTAN TENGAH",1,164,42,206
https://kawalpemilu.org#60451,"KADIPI ATAS, PANGKALAN LADA, KOTAWARINGIN BARAT, KALIMANTAN TENGAH",2,186,27,213
https://kawalpemilu.org#60451,"KADIPI ATAS, PANGKALAN LADA, KOTAWARINGIN BARAT, KALIMANTAN TENGAH",3,156,30,186
https://kawalpemilu.org#60451,"KADIPI ATAS, PANGKALAN LADA, KOTAWARINGIN BARAT, KALIMANTAN TENGAH",4,163,47,210
https://kawalpemilu.org#60452,"SUNGAI MELAWEN, PANGKALAN LADA, KOTAWARINGIN BARAT, KALIMANTAN TENGAH",1,167,49,216
https://kawalpemilu.org#60452,"SUNGAI MELAWEN, PANGKALAN LADA, KOTAWARINGIN BARAT, KALIMANTAN TENGAH",2,147,74,221
https://kawalpemilu.org#60452,"SUNGAI MELAWEN, PANGKALAN LADA, KOTAWARINGIN BARAT, KALIMANTAN TENGAH",3,155,59,214
https://kawalpemilu.org#60452,"SUNGAI MELAWEN, PANGKALAN LADA, KOTAWARINGIN BARAT, KALIMANTAN TENGAH",4,184,68,252
https://kawalpemilu.org#60452,"SUNGAI MELAWEN, PANGKALAN LADA, KOTAWARINGIN BARAT, KALIMANTAN TENGAH",5,173,69,242
https://kawalpemilu.org#60452,"SUNGAI MELAWEN, PANGKALAN LADA, KOTAWARINGIN BARAT, KALIMANTAN TENGAH",6,164,41,205
https://kawalpemilu.org#60452,"SUNGAI MELAWEN, PANGKALAN LADA, KOTAWARINGIN BARAT, KALIMANTAN TENGAH",7,177,53,230
https://kawalpemilu.org#60453,"PANGKALAN DURIN, PANGKALAN LADA, KOTAWARINGIN BARAT, KALIMANTAN TENGAH",1,201,39,240
https://kawalpemilu.org#60453,"PANGKALAN DURIN, PANGKALAN LADA, KOTAWARINGIN BARAT, KALIMANTAN TENGAH",2,154,35,189
https://kawalpemilu.org#60453,"PANGKALAN DURIN, PANGKALAN LADA, KOTAWARINGIN BARAT, KALIMANTAN TENGAH",3,161,28,189
https://kawalpemilu.org#60453,"PANGKALAN DURIN, PANGKALAN LADA, KOTAWARINGIN BARAT, KALIMANTAN TENGAH",4,151,55,206
https://kawalpemilu.org#60453,"PANGKALAN DURIN, PANGKALAN LADA, KOTAWARINGIN BARAT, KALIMANTAN TENGAH",5,134,105,239
https://kawalpemilu.org#60453,"PANGKALAN DURIN, PANGKALAN LADA, KOTAWARINGIN BARAT, KALIMANTAN TENGAH",6,96,39,135
https://kawalpemilu.org#60453,"PANGKALAN DURIN, PANGKALAN LADA, KOTAWARINGIN BARAT, KALIMANTAN TENGAH",7,35,17,52
https://kawalpemilu.org#60455,"PANGKALAN BANTENG, PANGKALAN BANTENG, KOTAWARINGIN BARAT, KALIMANTAN TENGAH",1,85,85,170
https://kawalpemilu.org#60455,"PANGKALAN BANTENG, PANGKALAN BANTENG, KOTAWARINGIN BARAT, KALIMANTAN TENGAH",2,100,95,195
https://kawalpemilu.org#60455,"PANGKALAN BANTENG, PANGKALAN BANTENG, KOTAWARINGIN BARAT, KALIMANTAN TENGAH",3,107,39,146
https://kawalpemilu.org#60455,"PANGKALAN BANTENG, PANGKALAN BANTENG, KOTAWARINGIN BARAT, KALIMANTAN TENGAH",4,171,57,228
https://kawalpemilu.org#60455,"PANGKALAN BANTENG, PANGKALAN BANTENG, KOTAWARINGIN BARAT, KALIMANTAN TENGAH",5,107,82,189
https://kawalpemilu.org#60456,"MULYA JADI, PANGKALAN BANTENG, KOTAWARINGIN BARAT, KALIMANTAN TENGAH",1,105,57,162
https://kawalpemilu.org#60456,"MULYA JADI, PANGKALAN BANTENG, KOTAWARINGIN BARAT, KALIMANTAN TENGAH",2,74,56,130
https://kawalpemilu.org#60456,"MULYA JADI, PANGKALAN BANTENG, KOTAWARINGIN BARAT, KALIMANTAN TENGAH",3,108,73,181
https://kawalpemilu.org#60456,"MULYA JADI, PANGKALAN BANTENG, KOTAWARINGIN BARAT, KALIMANTAN TENGAH",4,112,62,174
https://kawalpemilu.org#60457,"KARANG MULYA, PANGKALAN BANTENG, KOTAWARINGIN BARAT, KALIMANTAN TENGAH",1,137,69,206
https://kawalpemilu.org#60457,"KARANG MULYA, PANGKALAN BANTENG, KOTAWARINGIN BARAT, KALIMANTAN TENGAH",2,156,67,223
https://kawalpemilu.org#60457,"KARANG MULYA, PANGKALAN BANTENG, KOTAWARINGIN BARAT, KALIMANTAN TENGAH",3,166,83,249
https://kawalpemilu.org#60457,"KARANG MULYA, PANGKALAN BANTENG, KOTAWARINGIN BARAT, KALIMANTAN TENGAH",4,198,82,280
https://kawalpemilu.org#60457,"KARANG MULYA, PANGKALAN BANTENG, KOTAWARINGIN BARAT, KALIMANTAN TENGAH",5,172,59,231
https://kawalpemilu.org#60457,"KARANG MULYA, PANGKALAN BANTENG, KOTAWARINGIN BARAT, KALIMANTAN TENGAH",6,231,51,282
https://kawalpemilu.org#60457,"KARANG MULYA, PANGKALAN BANTENG, KOTAWARINGIN BARAT, KALIMANTAN TENGAH",7,194,36,230
https://kawalpemilu.org#60457,"KARANG MULYA, PANGKALAN BANTENG, KOTAWARINGIN BARAT, KALIMANTAN TENGAH",8,140,56,196
https://kawalpemilu.org#60457,"KARANG MULYA, PANGKALAN BANTENG, KOTAWARINGIN BARAT, KALIMANTAN TENGAH",9,162,91,253
https://kawalpemilu.org#60457,"KARANG MULYA, PANGKALAN BANTENG, KOTAWARINGIN BARAT, KALIMANTAN TENGAH",10,186,67,253
https://kawalpemilu.org#60458,"KEBUN AGUNG, PANGKALAN BANTENG, KOTAWARINGIN BARAT, KALIMANTAN TENGAH",1,163,50,213
https://kawalpemilu.org#60458,"KEBUN AGUNG, PANGKALAN BANTENG, KOTAWARINGIN BARAT, KALIMANTAN TENGAH",2,169,61,230
https://kawalpemilu.org#60458,"KEBUN AGUNG, PANGKALAN BANTENG, KOTAWARINGIN BARAT, KALIMANTAN TENGAH",3,103,13,116
https://kawalpemilu.org#60458,"KEBUN AGUNG, PANGKALAN BANTENG, KOTAWARINGIN BARAT, KALIMANTAN TENGAH",4,121,47,168
https://kawalpemilu.org#60459,"SIDO MULYO, PANGKALAN BANTENG, KOTAWARINGIN BARAT, KALIMANTAN TENGAH",1,156,30,186
https://kawalpemilu.org#60459,"SIDO MULYO, PANGKALAN BANTENG, KOTAWARINGIN BARAT, KALIMANTAN TENGAH",2,123,43,166
https://kawalpemilu.org#60459,"SIDO MULYO, PANGKALAN BANTENG, KOTAWARINGIN BARAT, KALIMANTAN TENGAH",3,96,50,146
https://kawalpemilu.org#60459,"SIDO MULYO, PANGKALAN BANTENG, KOTAWARINGIN BARAT, KALIMANTAN TENGAH",4,112,54,166
https://kawalpemilu.org#60459,"SIDO MULYO, PANGKALAN BANTENG, KOTAWARINGIN BARAT, KALIMANTAN TENGAH",5,139,43,182
https://kawalpemilu.org#60459,"SIDO MULYO, PANGKALAN BANTENG, KOTAWARINGIN BARAT, KALIMANTAN TENGAH",6,145,26,171
https://kawalpemilu.org#60460,"MARGA MULYA, PANGKALAN BANTENG, KOTAWARINGIN BARAT, KALIMANTAN TENGAH",1,163,69,232
https://kawalpemilu.org#60460,"MARGA MULYA, PANGKALAN BANTENG, KOTAWARINGIN BARAT, KALIMANTAN TENGAH",2,163,46,209
https://kawalpemilu.org#60460,"MARGA MULYA, PANGKALAN BANTENG, KOTAWARINGIN BARAT, KALIMANTAN TENGAH",3,106,109,215
https://kawalpemilu.org#60460,"MARGA MULYA, PANGKALAN BANTENG, KOTAWARINGIN BARAT, KALIMANTAN TENGAH",4,132,79,211
https://kawalpemilu.org#60461,"AMIN JAYA, PANGKALAN BANTENG, KOTAWARINGIN BARAT, KALIMANTAN TENGAH",1,189,56,245
https://kawalpemilu.org#60461,"AMIN JAYA, PANGKALAN BANTENG, KOTAWARINGIN BARAT, KALIMANTAN TENGAH",2,169,65,234
https://kawalpemilu.org#60461,"AMIN JAYA, PANGKALAN BANTENG, KOTAWARINGIN BARAT, KALIMANTAN TENGAH",3,204,71,275
https://kawalpemilu.org#60461,"AMIN JAYA, PANGKALAN BANTENG, KOTAWARINGIN BARAT, KALIMANTAN TENGAH",4,157,58,215
https://kawalpemilu.org#60461,"AMIN JAYA, PANGKALAN BANTENG, KOTAWARINGIN BARAT, KALIMANTAN TENGAH",5,103,106,209
https://kawalpemilu.org#60461,"AMIN JAYA, PANGKALAN BANTENG, KOTAWARINGIN BARAT, KALIMANTAN TENGAH",6,212,31,243
https://kawalpemilu.org#60461,"AMIN JAYA, PANGKALAN BANTENG, KOTAWARINGIN BARAT, KALIMANTAN TENGAH",7,180,84,264
https://kawalpemilu.org#60461,"AMIN JAYA, PANGKALAN BANTENG, KOTAWARINGIN BARAT, KALIMANTAN TENGAH",8,177,69,246
https://kawalpemilu.org#60461,"AMIN JAYA, PANGKALAN BANTENG, KOTAWARINGIN BARAT, KALIMANTAN TENGAH",9,180,20,200
https://kawalpemilu.org#60461,"AMIN JAYA, PANGKALAN BANTENG, KOTAWARINGIN BARAT, KALIMANTAN TENGAH",10,226,39,265
https://kawalpemilu.org#60461,"AMIN JAYA, PANGKALAN BANTENG, KOTAWARINGIN BARAT, KALIMANTAN TENGAH",11,112,24,136
https://kawalpemilu.org#60461,"AMIN JAYA, PANGKALAN BANTENG, KOTAWARINGIN BARAT, KALIMANTAN TENGAH",12,104,37,141
https://kawalpemilu.org#60461,"AMIN JAYA, PANGKALAN BANTENG, KOTAWARINGIN BARAT, KALIMANTAN TENGAH",13,96,80,176
https://kawalpemilu.org#60461,"AMIN JAYA, PANGKALAN BANTENG, KOTAWARINGIN BARAT, KALIMANTAN TENGAH",14,138,38,176
https://kawalpemilu.org#60462,"ARGA MULYA, PANGKALAN BANTENG, KOTAWARINGIN BARAT, KALIMANTAN TENGAH",1,150,58,208
https://kawalpemilu.org#60462,"ARGA MULYA, PANGKALAN BANTENG, KOTAWARINGIN BARAT, KALIMANTAN TENGAH",2,147,48,195
https://kawalpemilu.org#60462,"ARGA MULYA, PANGKALAN BANTENG, KOTAWARINGIN BARAT, KALIMANTAN TENGAH",3,143,17,160
https://kawalpemilu.org#60462,"ARGA MULYA, PANGKALAN BANTENG, KOTAWARINGIN BARAT, KALIMANTAN TENGAH",4,119,28,147
https://kawalpemilu.org#60462,"ARGA MULYA, PANGKALAN BANTENG, KOTAWARINGIN BARAT, KALIMANTAN TENGAH",5,138,40,178
https://kawalpemilu.org#60463,"NATAI KERBAU, PANGKALAN BANTENG, KOTAWARINGIN BARAT, KALIMANTAN TENGAH",1,180,57,237
https://kawalpemilu.org#60463,"NATAI KERBAU, PANGKALAN BANTENG, KOTAWARINGIN BARAT, KALIMANTAN TENGAH",2,174,52,226
https://kawalpemilu.org#60463,"NATAI KERBAU, PANGKALAN BANTENG, KOTAWARINGIN BARAT, KALIMANTAN TENGAH",3,119,79,198
https://kawalpemilu.org#60463,"NATAI KERBAU, PANGKALAN BANTENG, KOTAWARINGIN BARAT, KALIMANTAN TENGAH",4,146,60,206
https://kawalpemilu.org#60464,"SIMPANG BERAMBAI, PANGKALAN BANTENG, KOTAWARINGIN BARAT, KALIMANTAN TENGAH",1,117,59,176
https://kawalpemilu.org#60464,"SIMPANG BERAMBAI, PANGKALAN BANTENG, KOTAWARINGIN BARAT, KALIMANTAN TENGAH",2,147,47,194
https://kawalpemilu.org#60464,"SIMPANG BERAMBAI, PANGKALAN BANTENG, KOTAWARINGIN BARAT, KALIMANTAN TENGAH",3,174,34,208
https://kawalpemilu.org#60464,"SIMPANG BERAMBAI, PANGKALAN BANTENG, KOTAWARINGIN BARAT, KALIMANTAN TENGAH",4,161,64,225
https://kawalpemilu.org#60464,"SIMPANG BERAMBAI, PANGKALAN BANTENG, KOTAWARINGIN BARAT, KALIMANTAN TENGAH",5,145,78,223
https://kawalpemilu.org#60465,"SUNGAI HIJAU, PANGKALAN BANTENG, KOTAWARINGIN BARAT, KALIMANTAN TENGAH",1,149,58,207
https://kawalpemilu.org#60465,"SUNGAI HIJAU, PANGKALAN BANTENG, KOTAWARINGIN BARAT, KALIMANTAN TENGAH",2,197,4,201
https://kawalpemilu.org#60465,"SUNGAI HIJAU, PANGKALAN BANTENG, KOTAWARINGIN BARAT, KALIMANTAN TENGAH",3,138,29,167
https://kawalpemilu.org#60465,"SUNGAI HIJAU, PANGKALAN BANTENG, KOTAWARINGIN BARAT, KALIMANTAN TENGAH",4,177,22,199
https://kawalpemilu.org#60465,"SUNGAI HIJAU, PANGKALAN BANTENG, KOTAWARINGIN BARAT, KALIMANTAN TENGAH",5,188,9,197
https://kawalpemilu.org#60465,"SUNGAI HIJAU, PANGKALAN BANTENG, KOTAWARINGIN BARAT, KALIMANTAN TENGAH",6,144,2,146
https://kawalpemilu.org#60466,"SUNGAI KUNING, PANGKALAN BANTENG, KOTAWARINGIN BARAT, KALIMANTAN TENGAH",1,125,19,144
https://kawalpemilu.org#60466,"SUNGAI KUNING, PANGKALAN BANTENG, KOTAWARINGIN BARAT, KALIMANTAN TENGAH",2,119,44,163
https://kawalpemilu.org#60466,"SUNGAI KUNING, PANGKALAN BANTENG, KOTAWARINGIN BARAT, KALIMANTAN TENGAH",3,112,31,143
https://kawalpemilu.org#60466,"SUNGAI KUNING, PANGKALAN BANTENG, KOTAWARINGIN BARAT, KALIMANTAN TENGAH",4,115,23,138
https://kawalpemilu.org#60466,"SUNGAI KUNING, PANGKALAN BANTENG, KOTAWARINGIN BARAT, KALIMANTAN TENGAH",5,104,39,143
https://kawalpemilu.org#60467,"SUNGAI BENGKUANG, PANGKALAN BANTENG, KOTAWARINGIN BARAT, KALIMANTAN TENGAH",1,110,32,142
https://kawalpemilu.org#60467,"SUNGAI BENGKUANG, PANGKALAN BANTENG, KOTAWARINGIN BARAT, KALIMANTAN TENGAH",2,113,36,149
https://kawalpemilu.org#60467,"SUNGAI BENGKUANG, PANGKALAN BANTENG, KOTAWARINGIN BARAT, KALIMANTAN TENGAH",3,136,32,168
https://kawalpemilu.org#60467,"SUNGAI BENGKUANG, PANGKALAN BANTENG, KOTAWARINGIN BARAT, KALIMANTAN TENGAH",4,119,7,126
https://kawalpemilu.org#60467,"SUNGAI BENGKUANG, PANGKALAN BANTENG, KOTAWARINGIN BARAT, KALIMANTAN TENGAH",5,137,12,149
https://kawalpemilu.org#60467,"SUNGAI BENGKUANG, PANGKALAN BANTENG, KOTAWARINGIN BARAT, KALIMANTAN TENGAH",6,83,13,96
https://kawalpemilu.org#60467,"SUNGAI BENGKUANG, PANGKALAN BANTENG, KOTAWARINGIN BARAT, KALIMANTAN TENGAH",7,142,18,160
https://kawalpemilu.org#60467,"SUNGAI BENGKUANG, PANGKALAN BANTENG, KOTAWARINGIN BARAT, KALIMANTAN TENGAH",8,86,16,102
https://kawalpemilu.org#85363,"SUNGAI PULAU, PANGKALAN BANTENG, KOTAWARINGIN BARAT, KALIMANTAN TENGAH",1,123,52,175
https://kawalpemilu.org#85363,"SUNGAI PULAU, PANGKALAN BANTENG, KOTAWARINGIN BARAT, KALIMANTAN TENGAH",2,149,34,183
https://kawalpemilu.org#85365,"SUNGAI PAKIT, PANGKALAN BANTENG, KOTAWARINGIN BARAT, KALIMANTAN TENGAH",1,173,57,230
https://kawalpemilu.org#85365,"SUNGAI PAKIT, PANGKALAN BANTENG, KOTAWARINGIN BARAT, KALIMANTAN TENGAH",2,160,40,200
https://kawalpemilu.org#85365,"SUNGAI PAKIT, PANGKALAN BANTENG, KOTAWARINGIN BARAT, KALIMANTAN TENGAH",3,160,34,194
https://kawalpemilu.org#85365,"SUNGAI PAKIT, PANGKALAN BANTENG, KOTAWARINGIN BARAT, KALIMANTAN TENGAH",4,170,74,244
https://kawalpemilu.org#85365,"SUNGAI PAKIT, PANGKALAN BANTENG, KOTAWARINGIN BARAT, KALIMANTAN TENGAH",5,106,51,157
https://kawalpemilu.org#88417,"KARANG SARI, PANGKALAN BANTENG, KOTAWARINGIN BARAT, KALIMANTAN TENGAH",1,121,66,187
https://kawalpemilu.org#88417,"KARANG SARI, PANGKALAN BANTENG, KOTAWARINGIN BARAT, KALIMANTAN TENGAH",2,142,48,190
https://kawalpemilu.org#88418,"BERAMBAI MAKMUR, PANGKALAN BANTENG, KOTAWARINGIN BARAT, KALIMANTAN TENGAH",1,112,44,156
https://kawalpemilu.org#88418,"BERAMBAI MAKMUR, PANGKALAN BANTENG, KOTAWARINGIN BARAT, KALIMANTAN TENGAH",2,125,44,169
https://kawalpemilu.org#60470,"KOTA BESI HULU, KOTA BESI, KOTAWARINGIN TIMUR, KALIMANTAN TENGAH",1,112,156,268
https://kawalpemilu.org#60470,"KOTA BESI HULU, KOTA BESI, KOTAWARINGIN TIMUR, KALIMANTAN TENGAH",2,113,84,197
https://kawalpemilu.org#60470,"KOTA BESI HULU, KOTA BESI, KOTAWARINGIN TIMUR, KALIMANTAN TENGAH",3,84,51,135
https://kawalpemilu.org#60470,"KOTA BESI HULU, KOTA BESI, KOTAWARINGIN TIMUR, KALIMANTAN TENGAH",4,123,76,199
https://kawalpemilu.org#60470,"KOTA BESI HULU, KOTA BESI, KOTAWARINGIN TIMUR, KALIMANTAN TENGAH",5,108,85,193
https://kawalpemilu.org#60470,"KOTA BESI HULU, KOTA BESI, KOTAWARINGIN TIMUR, KALIMANTAN TENGAH",6,139,115,254
https://kawalpemilu.org#60470,"KOTA BESI HULU, KOTA BESI, KOTAWARINGIN TIMUR, KALIMANTAN TENGAH",7,65,78,143
https://kawalpemilu.org#60470,"KOTA BESI HULU, KOTA BESI, KOTAWARINGIN TIMUR, KALIMANTAN TENGAH",8,111,112,223
https://kawalpemilu.org#60470,"KOTA BESI HULU, KOTA BESI, KOTAWARINGIN TIMUR, KALIMANTAN TENGAH",9,123,114,237
https://kawalpemilu.org#60470,"KOTA BESI HULU, KOTA BESI, KOTAWARINGIN TIMUR, KALIMANTAN TENGAH",10,114,111,225
https://kawalpemilu.org#60470,"KOTA BESI HULU, KOTA BESI, KOTAWARINGIN TIMUR, KALIMANTAN TENGAH",11,106,84,190
https://kawalpemilu.org#60470,"KOTA BESI HULU, KOTA BESI, KOTAWARINGIN TIMUR, KALIMANTAN TENGAH",12,128,84,212
https://kawalpemilu.org#60470,"KOTA BESI HULU, KOTA BESI, KOTAWARINGIN TIMUR, KALIMANTAN TENGAH",13,83,48,131
https://kawalpemilu.org#60470,"KOTA BESI HULU, KOTA BESI, KOTAWARINGIN TIMUR, KALIMANTAN TENGAH",14,94,105,199
https://kawalpemilu.org#60471,"KOTA BESI HILIR, KOTA BESI, KOTAWARINGIN TIMUR, KALIMANTAN TENGAH",1,124,85,209
https://kawalpemilu.org#60471,"KOTA BESI HILIR, KOTA BESI, KOTAWARINGIN TIMUR, KALIMANTAN TENGAH",2,61,41,102
https://kawalpemilu.org#60471,"KOTA BESI HILIR, KOTA BESI, KOTAWARINGIN TIMUR, KALIMANTAN TENGAH",3,117,88,205
https://kawalpemilu.org#60471,"KOTA BESI HILIR, KOTA BESI, KOTAWARINGIN TIMUR, KALIMANTAN TENGAH",4,123,104,227
https://kawalpemilu.org#60471,"KOTA BESI HILIR, KOTA BESI, KOTAWARINGIN TIMUR, KALIMANTAN TENGAH",5,119,74,193
https://kawalpemilu.org#60471,"KOTA BESI HILIR, KOTA BESI, KOTAWARINGIN TIMUR, KALIMANTAN TENGAH",6,111,115,226
https://kawalpemilu.org#60471,"KOTA BESI HILIR, KOTA BESI, KOTAWARINGIN TIMUR, KALIMANTAN TENGAH",7,78,99,177
https://kawalpemilu.org#60471,"KOTA BESI HILIR, KOTA BESI, KOTAWARINGIN TIMUR, KALIMANTAN TENGAH",8,94,102,196
https://kawalpemilu.org#60472,"PALANGAN, KOTA BESI, KOTAWARINGIN TIMUR, KALIMANTAN TENGAH",1,209,19,228
https://kawalpemilu.org#60472,"PALANGAN, KOTA BESI, KOTAWARINGIN TIMUR, KALIMANTAN TENGAH",2,137,18,155
https://kawalpemilu.org#60472,"PALANGAN, KOTA BESI, KOTAWARINGIN TIMUR, KALIMANTAN TENGAH",3,88,11,99
https://kawalpemilu.org#60473,"HANJALIPAN, KOTA BESI, KOTAWARINGIN TIMUR, KALIMANTAN TENGAH",1,117,46,163
https://kawalpemilu.org#60473,"HANJALIPAN, KOTA BESI, KOTAWARINGIN TIMUR, KALIMANTAN TENGAH",2,111,60,171
https://kawalpemilu.org#60473,"HANJALIPAN, KOTA BESI, KOTAWARINGIN TIMUR, KALIMANTAN TENGAH",3,95,55,150
https://kawalpemilu.org#60473,"HANJALIPAN, KOTA BESI, KOTAWARINGIN TIMUR, KALIMANTAN TENGAH",4,110,69,179
https://kawalpemilu.org#60474,"SIMPUR, KOTA BESI, KOTAWARINGIN TIMUR, KALIMANTAN TENGAH",1,101,33,134
https://kawalpemilu.org#60474,"SIMPUR, KOTA BESI, KOTAWARINGIN TIMUR, KALIMANTAN TENGAH",2,47,36,83
https://kawalpemilu.org#60475,"PEMALIAN, KOTA BESI, KOTAWARINGIN TIMUR, KALIMANTAN TENGAH",1,41,142,183
https://kawalpemilu.org#60475,"PEMALIAN, KOTA BESI, KOTAWARINGIN TIMUR, KALIMANTAN TENGAH",2,99,82,181
https://kawalpemilu.org#60475,"PEMALIAN, KOTA BESI, KOTAWARINGIN TIMUR, KALIMANTAN TENGAH",3,77,76,153
https://kawalpemilu.org#60476,"CAMBA, KOTA BESI, KOTAWARINGIN TIMUR, KALIMANTAN TENGAH",1,155,17,172
https://kawalpemilu.org#60476,"CAMBA, KOTA BESI, KOTAWARINGIN TIMUR, KALIMANTAN TENGAH",2,185,45,230
https://kawalpemilu.org#60476,"CAMBA, KOTA BESI, KOTAWARINGIN TIMUR, KALIMANTAN TENGAH",3,167,60,227
https://kawalpemilu.org#60476,"CAMBA, KOTA BESI, KOTAWARINGIN TIMUR, KALIMANTAN TENGAH",4,172,64,236
https://kawalpemilu.org#60477,"KANDAN, KOTA BESI, KOTAWARINGIN TIMUR, KALIMANTAN TENGAH",1,157,37,194
https://kawalpemilu.org#60477,"KANDAN, KOTA BESI, KOTAWARINGIN TIMUR, KALIMANTAN TENGAH",2,162,27,189
https://kawalpemilu.org#60477,"KANDAN, KOTA BESI, KOTAWARINGIN TIMUR, KALIMANTAN TENGAH",3,106,90,196
https://kawalpemilu.org#60477,"KANDAN, KOTA BESI, KOTAWARINGIN TIMUR, KALIMANTAN TENGAH",4,161,35,196
https://kawalpemilu.org#60477,"KANDAN, KOTA BESI, KOTAWARINGIN TIMUR, KALIMANTAN TENGAH",5,185,52,237
https://kawalpemilu.org#60477,"KANDAN, KOTA BESI, KOTAWARINGIN TIMUR, KALIMANTAN TENGAH",6,164,59,223
https://kawalpemilu.org#60477,"KANDAN, KOTA BESI, KOTAWARINGIN TIMUR, KALIMANTAN TENGAH",7,180,56,236
https://kawalpemilu.org#60478,"BAJARUM, KOTA BESI, KOTAWARINGIN TIMUR, KALIMANTAN TENGAH",1,107,24,131
https://kawalpemilu.org#60478,"BAJARUM, KOTA BESI, KOTAWARINGIN TIMUR, KALIMANTAN TENGAH",2,147,57,204
https://kawalpemilu.org#60478,"BAJARUM, KOTA BESI, KOTAWARINGIN TIMUR, KALIMANTAN TENGAH",3,101,99,157
https://kawalpemilu.org#60478,"BAJARUM, KOTA BESI, KOTAWARINGIN TIMUR, KALIMANTAN TENGAH",4,62,141,203
https://kawalpemilu.org#60479,"RASAU TUMBUH, KOTA BESI, KOTAWARINGIN TIMUR, KALIMANTAN TENGAH",1,85,64,149
https://kawalpemilu.org#60479,"RASAU TUMBUH, KOTA BESI, KOTAWARINGIN TIMUR, KALIMANTAN TENGAH",2,53,99,152
https://kawalpemilu.org#60479,"RASAU TUMBUH, KOTA BESI, KOTAWARINGIN TIMUR, KALIMANTAN TENGAH",3,83,124,207
https://kawalpemilu.org#60480,"SOREN, KOTA BESI, KOTAWARINGIN TIMUR, KALIMANTAN TENGAH",1,80,45,125
https://kawalpemilu.org#60480,"SOREN, KOTA BESI, KOTAWARINGIN TIMUR, KALIMANTAN TENGAH",2,90,42,132
https://kawalpemilu.org#60482,"RUBUNG BUYUNG, CEMPAGA, KOTAWARINGIN TIMUR, KALIMANTAN TENGAH",1,101,91,192
https://kawalpemilu.org#60482,"RUBUNG BUYUNG, CEMPAGA, KOTAWARINGIN TIMUR, KALIMANTAN TENGAH",2,113,31,144
https://kawalpemilu.org#60482,"RUBUNG BUYUNG, CEMPAGA, KOTAWARINGIN TIMUR, KALIMANTAN TENGAH",3,150,18,168
https://kawalpemilu.org#60482,"RUBUNG BUYUNG, CEMPAGA, KOTAWARINGIN TIMUR, KALIMANTAN TENGAH",4,148,35,183
https://kawalpemilu.org#60482,"RUBUNG BUYUNG, CEMPAGA, KOTAWARINGIN TIMUR, KALIMANTAN TENGAH",5,94,19,113
https://kawalpemilu.org#60482,"RUBUNG BUYUNG, CEMPAGA, KOTAWARINGIN TIMUR, KALIMANTAN TENGAH",6,91,92,183
https://kawalpemilu.org#60482,"RUBUNG BUYUNG, CEMPAGA, KOTAWARINGIN TIMUR, KALIMANTAN TENGAH",7,70,45,115
https://kawalpemilu.org#60482,"RUBUNG BUYUNG, CEMPAGA, KOTAWARINGIN TIMUR, KALIMANTAN TENGAH",8,12,3,15
https://kawalpemilu.org#60483,"PATAI, CEMPAGA, KOTAWARINGIN TIMUR, KALIMANTAN TENGAH",1,28,88,116
https://kawalpemilu.org#60483,"PATAI, CEMPAGA, KOTAWARINGIN TIMUR, KALIMANTAN TENGAH",2,99,83,182
https://kawalpemilu.org#60483,"PATAI, CEMPAGA, KOTAWARINGIN TIMUR, KALIMANTAN TENGAH",3,74,113,187
https://kawalpemilu.org#60483,"PATAI, CEMPAGA, KOTAWARINGIN TIMUR, KALIMANTAN TENGAH",4,92,102,194
https://kawalpemilu.org#60483,"PATAI, CEMPAGA, KOTAWARINGIN TIMUR, KALIMANTAN TENGAH",5,89,110,199
https://kawalpemilu.org#60483,"PATAI, CEMPAGA, KOTAWARINGIN TIMUR, KALIMANTAN TENGAH",6,94,84,178
https://kawalpemilu.org#60483,"PATAI, CEMPAGA, KOTAWARINGIN TIMUR, KALIMANTAN TENGAH",7,48,92,140
https://kawalpemilu.org#60483,"PATAI, CEMPAGA, KOTAWARINGIN TIMUR, KALIMANTAN TENGAH",8,102,62,164
https://kawalpemilu.org#60483,"PATAI, CEMPAGA, KOTAWARINGIN TIMUR, KALIMANTAN TENGAH",9,103,60,163
https://kawalpemilu.org#60484,"LUWUK RANGGAN, CEMPAGA, KOTAWARINGIN TIMUR, KALIMANTAN TENGAH",1,110,87,197
https://kawalpemilu.org#60484,"LUWUK RANGGAN, CEMPAGA, KOTAWARINGIN TIMUR, KALIMANTAN TENGAH",2,79,88,167
https://kawalpemilu.org#60484,"LUWUK RANGGAN, CEMPAGA, KOTAWARINGIN TIMUR, KALIMANTAN TENGAH",3,37,75,112
https://kawalpemilu.org#60484,"LUWUK RANGGAN, CEMPAGA, KOTAWARINGIN TIMUR, KALIMANTAN TENGAH",4,47,102,149
https://kawalpemilu.org#60484,"LUWUK RANGGAN, CEMPAGA, KOTAWARINGIN TIMUR, KALIMANTAN TENGAH",5,56,125,181
https://kawalpemilu.org#60484,"LUWUK RANGGAN, CEMPAGA, KOTAWARINGIN TIMUR, KALIMANTAN TENGAH",6,75,120,195
https://kawalpemilu.org#60484,"LUWUK RANGGAN, CEMPAGA, KOTAWARINGIN TIMUR, KALIMANTAN TENGAH",7,75,120,195
https://kawalpemilu.org#60484,"LUWUK RANGGAN, CEMPAGA, KOTAWARINGIN TIMUR, KALIMANTAN TENGAH",8,108,117,225
https://kawalpemilu.org#60484,"LUWUK RANGGAN, CEMPAGA, KOTAWARINGIN TIMUR, KALIMANTAN TENGAH",9,44,152,196
https://kawalpemilu.org#60484,"LUWUK RANGGAN, CEMPAGA, KOTAWARINGIN TIMUR, KALIMANTAN TENGAH",10,17,116,133
https://kawalpemilu.org#60485,"JEMARAS, CEMPAGA, KOTAWARINGIN TIMUR, KALIMANTAN TENGAH",1,108,135,243
https://kawalpemilu.org#60485,"JEMARAS, CEMPAGA, KOTAWARINGIN TIMUR, KALIMANTAN TENGAH",2,95,122,217
https://kawalpemilu.org#60485,"JEMARAS, CEMPAGA, KOTAWARINGIN TIMUR, KALIMANTAN TENGAH",3,69,92,161
https://kawalpemilu.org#60485,"JEMARAS, CEMPAGA, KOTAWARINGIN TIMUR, KALIMANTAN TENGAH",4,52,105,157
https://kawalpemilu.org#60485,"JEMARAS, CEMPAGA, KOTAWARINGIN TIMUR, KALIMANTAN TENGAH",5,107,112,219
https://kawalpemilu.org#60485,"JEMARAS, CEMPAGA, KOTAWARINGIN TIMUR, KALIMANTAN TENGAH",6,62,50,112
https://kawalpemilu.org#60486,"CEMPAKA MULIA TIMUR, CEMPAGA, KOTAWARINGIN TIMUR, KALIMANTAN TENGAH",1,128,79,207
https://kawalpemilu.org#60486,"CEMPAKA MULIA TIMUR, CEMPAGA, KOTAWARINGIN TIMUR, KALIMANTAN TENGAH",2,61,154,215
https://kawalpemilu.org#60486,"CEMPAKA MULIA TIMUR, CEMPAGA, KOTAWARINGIN TIMUR, KALIMANTAN TENGAH",3,86,90,176
https://kawalpemilu.org#60486,"CEMPAKA MULIA TIMUR, CEMPAGA, KOTAWARINGIN TIMUR, KALIMANTAN TENGAH",4,83,99,182
https://kawalpemilu.org#60486,"CEMPAKA MULIA TIMUR, CEMPAGA, KOTAWARINGIN TIMUR, KALIMANTAN TENGAH",5,82,79,161
https://kawalpemilu.org#60487,"CEMPAKA MULIA BARAT, CEMPAGA, KOTAWARINGIN TIMUR, KALIMANTAN TENGAH",1,89,133,222
https://kawalpemilu.org#60487,"CEMPAKA MULIA BARAT, CEMPAGA, KOTAWARINGIN TIMUR, KALIMANTAN TENGAH",2,76,132,208
https://kawalpemilu.org#60487,"CEMPAKA MULIA BARAT, CEMPAGA, KOTAWARINGIN TIMUR, KALIMANTAN TENGAH",3,76,102,178
https://kawalpemilu.org#60487,"CEMPAKA MULIA BARAT, CEMPAGA, KOTAWARINGIN TIMUR, KALIMANTAN TENGAH",4,58,143,201
https://kawalpemilu.org#60487,"CEMPAKA MULIA BARAT, CEMPAGA, KOTAWARINGIN TIMUR, KALIMANTAN TENGAH",5,79,82,161
https://kawalpemilu.org#60487,"CEMPAKA MULIA BARAT, CEMPAGA, KOTAWARINGIN TIMUR, KALIMANTAN TENGAH",6,70,75,145
https://kawalpemilu.org#60487,"CEMPAKA MULIA BARAT, CEMPAGA, KOTAWARINGIN TIMUR, KALIMANTAN TENGAH",7,76,111,187
https://kawalpemilu.org#60487,"CEMPAKA MULIA BARAT, CEMPAGA, KOTAWARINGIN TIMUR, KALIMANTAN TENGAH",8,91,139,230
https://kawalpemilu.org#60487,"CEMPAKA MULIA BARAT, CEMPAGA, KOTAWARINGIN TIMUR, KALIMANTAN TENGAH",9,67,144,211
https://kawalpemilu.org#60487,"CEMPAKA MULIA BARAT, CEMPAGA, KOTAWARINGIN TIMUR, KALIMANTAN TENGAH",10,74,105,179
https://kawalpemilu.org#60487,"CEMPAKA MULIA BARAT, CEMPAGA, KOTAWARINGIN TIMUR, KALIMANTAN TENGAH",11,88,90,178
https://kawalpemilu.org#60487,"CEMPAKA MULIA BARAT, CEMPAGA, KOTAWARINGIN TIMUR, KALIMANTAN TENGAH",12,69,107,176
https://kawalpemilu.org#60487,"CEMPAKA MULIA BARAT, CEMPAGA, KOTAWARINGIN TIMUR, KALIMANTAN TENGAH",13,87,88,175
https://kawalpemilu.org#60487,"CEMPAKA MULIA BARAT, CEMPAGA, KOTAWARINGIN TIMUR, KALIMANTAN TENGAH",14,88,108,196
https://kawalpemilu.org#60487,"CEMPAKA MULIA BARAT, CEMPAGA, KOTAWARINGIN TIMUR, KALIMANTAN TENGAH",15,53,109,162
https://kawalpemilu.org#60487,"CEMPAKA MULIA BARAT, CEMPAGA, KOTAWARINGIN TIMUR, KALIMANTAN TENGAH",16,53,61,114
https://kawalpemilu.org#60488,"LUWUK BUNTER, CEMPAGA, KOTAWARINGIN TIMUR, KALIMANTAN TENGAH",1,85,38,123
https://kawalpemilu.org#60488,"LUWUK BUNTER, CEMPAGA, KOTAWARINGIN TIMUR, KALIMANTAN TENGAH",2,135,55,190
https://kawalpemilu.org#60488,"LUWUK BUNTER, CEMPAGA, KOTAWARINGIN TIMUR, KALIMANTAN TENGAH",3,191,53,244
https://kawalpemilu.org#60488,"LUWUK BUNTER, CEMPAGA, KOTAWARINGIN TIMUR, KALIMANTAN TENGAH",4,44,121,165
https://kawalpemilu.org#60488,"LUWUK BUNTER, CEMPAGA, KOTAWARINGIN TIMUR, KALIMANTAN TENGAH",5,28,96,124
https://kawalpemilu.org#60489,"SUNGAI PARING, CEMPAGA, KOTAWARINGIN TIMUR, KALIMANTAN TENGAH",1,122,112,234
https://kawalpemilu.org#60489,"SUNGAI PARING, CEMPAGA, KOTAWARINGIN TIMUR, KALIMANTAN TENGAH",2,136,73,209
https://kawalpemilu.org#60489,"SUNGAI PARING, CEMPAGA, KOTAWARINGIN TIMUR, KALIMANTAN TENGAH",3,98,86,184
https://kawalpemilu.org#60489,"SUNGAI PARING, CEMPAGA, KOTAWARINGIN TIMUR, KALIMANTAN TENGAH",4,71,171,242
https://kawalpemilu.org#60489,"SUNGAI PARING, CEMPAGA, KOTAWARINGIN TIMUR, KALIMANTAN TENGAH",5,100,101,201
https://kawalpemilu.org#60489,"SUNGAI PARING, CEMPAGA, KOTAWARINGIN TIMUR, KALIMANTAN TENGAH",6,93,61,154
https://kawalpemilu.org#60489,"SUNGAI PARING, CEMPAGA, KOTAWARINGIN TIMUR, KALIMANTAN TENGAH",7,104,83,187
https://kawalpemilu.org#60491,"KUALA KUAYAN, MENTAYA HULU, KOTAWARINGIN TIMUR, KALIMANTAN TENGAH",1,50,34,84
https://kawalpemilu.org#60491,"KUALA KUAYAN, MENTAYA HULU, KOTAWARINGIN TIMUR, KALIMANTAN TENGAH",2,66,47,113
https://kawalpemilu.org#60491,"KUALA KUAYAN, MENTAYA HULU, KOTAWARINGIN TIMUR, KALIMANTAN TENGAH",3,121,59,180
https://kawalpemilu.org#60491,"KUALA KUAYAN, MENTAYA HULU, KOTAWARINGIN TIMUR, KALIMANTAN TENGAH",4,157,49,206
https://kawalpemilu.org#60491,"KUALA KUAYAN, MENTAYA HULU, KOTAWARINGIN TIMUR, KALIMANTAN TENGAH",5,87,72,159
https://kawalpemilu.org#60491,"KUALA KUAYAN, MENTAYA HULU, KOTAWARINGIN TIMUR, KALIMANTAN TENGAH",6,138,72,210
https://kawalpemilu.org#60491,"KUALA KUAYAN, MENTAYA HULU, KOTAWARINGIN TIMUR, KALIMANTAN TENGAH",7,86,78,164
https://kawalpemilu.org#60491,"KUALA KUAYAN, MENTAYA HULU, KOTAWARINGIN TIMUR, KALIMANTAN TENGAH",8,134,62,196
https://kawalpemilu.org#60491,"KUALA KUAYAN, MENTAYA HULU, KOTAWARINGIN TIMUR, KALIMANTAN TENGAH",9,136,60,196
https://kawalpemilu.org#60491,"KUALA KUAYAN, MENTAYA HULU, KOTAWARINGIN TIMUR, KALIMANTAN TENGAH",10,136,54,190
https://kawalpemilu.org#60491,"KUALA KUAYAN, MENTAYA HULU, KOTAWARINGIN TIMUR, KALIMANTAN TENGAH",11,115,22,137
https://kawalpemilu.org#60491,"KUALA KUAYAN, MENTAYA HULU, KOTAWARINGIN TIMUR, KALIMANTAN TENGAH",12,105,16,121
https://kawalpemilu.org#60491,"KUALA KUAYAN, MENTAYA HULU, KOTAWARINGIN TIMUR, KALIMANTAN TENGAH",13,89,9,98
https://kawalpemilu.org#60491,"KUALA KUAYAN, MENTAYA HULU, KOTAWARINGIN TIMUR, KALIMANTAN TENGAH",14,42,13,55
https://kawalpemilu.org#60491,"KUALA KUAYAN, MENTAYA HULU, KOTAWARINGIN TIMUR, KALIMANTAN TENGAH",15,168,23,191
https://kawalpemilu.org#60491,"KUALA KUAYAN, MENTAYA HULU, KOTAWARINGIN TIMUR, KALIMANTAN TENGAH",16,125,26,151
https://kawalpemilu.org#60492,"TANGAR, MENTAYA HULU, KOTAWARINGIN TIMUR, KALIMANTAN TENGAH",1,138,31,169
https://kawalpemilu.org#60492,"TANGAR, MENTAYA HULU, KOTAWARINGIN TIMUR, KALIMANTAN TENGAH",2,120,42,162
https://kawalpemilu.org#60492,"TANGAR, MENTAYA HULU, KOTAWARINGIN TIMUR, KALIMANTAN TENGAH",3,107,24,131
https://kawalpemilu.org#60492,"TANGAR, MENTAYA HULU, KOTAWARINGIN TIMUR, KALIMANTAN TENGAH",4,59,17,76
https://kawalpemilu.org#60493,"BAAMPAH, MENTAYA HULU, KOTAWARINGIN TIMUR, KALIMANTAN TENGAH",1,67,55,122
https://kawalpemilu.org#60493,"BAAMPAH, MENTAYA HULU, KOTAWARINGIN TIMUR, KALIMANTAN TENGAH",2,89,17,106
https://kawalpemilu.org#60494,"KAWAN BATU, MENTAYA HULU, KOTAWARINGIN TIMUR, KALIMANTAN TENGAH",1,105,73,178
https://kawalpemilu.org#60494,"KAWAN BATU, MENTAYA HULU, KOTAWARINGIN TIMUR, KALIMANTAN TENGAH",2,125,43,168
https://kawalpemilu.org#60494,"KAWAN BATU, MENTAYA HULU, KOTAWARINGIN TIMUR, KALIMANTAN TENGAH",3,85,37,122
https://kawalpemilu.org#60495,"TANJUNG BANTUR, MENTAYA HULU, KOTAWARINGIN TIMUR, KALIMANTAN TENGAH",1,148,36,184
https://kawalpemilu.org#60495,"TANJUNG BANTUR, MENTAYA HULU, KOTAWARINGIN TIMUR, KALIMANTAN TENGAH",2,151,25,176
https://kawalpemilu.org#60496,"PENDA DURIAN, MENTAYA HULU, KOTAWARINGIN TIMUR, KALIMANTAN TENGAH",1,92,88,180
https://kawalpemilu.org#60496,"PENDA DURIAN, MENTAYA HULU, KOTAWARINGIN TIMUR, KALIMANTAN TENGAH",2,63,31,94
https://kawalpemilu.org#60497,"PAHIRANGAN, MENTAYA HULU, KOTAWARINGIN TIMUR, KALIMANTAN TENGAH",1,150,14,164
https://kawalpemilu.org#60498,"SATIUNG, MENTAYA HULU, KOTAWARINGIN TIMUR, KALIMANTAN TENGAH",1,117,26,143
https://kawalpemilu.org#60499,"SANTILIK, MENTAYA HULU, KOTAWARINGIN TIMUR, KALIMANTAN TENGAH",1,56,67,123
https://kawalpemilu.org#60499,"SANTILIK, MENTAYA HULU, KOTAWARINGIN TIMUR, KALIMANTAN TENGAH",2,90,18,108
https://kawalpemilu.org#60500,"TANGKA ROBAH, MENTAYA HULU, KOTAWARINGIN TIMUR, KALIMANTAN TENGAH",1,117,41,158
https://kawalpemilu.org#60500,"TANGKA ROBAH, MENTAYA HULU, KOTAWARINGIN TIMUR, KALIMANTAN TENGAH",2,97,54,151
https://kawalpemilu.org#60500,"TANGKA ROBAH, MENTAYA HULU, KOTAWARINGIN TIMUR, KALIMANTAN TENGAH",3,174,23,197
https://kawalpemilu.org#60500,"TANGKA ROBAH, MENTAYA HULU, KOTAWARINGIN TIMUR, KALIMANTAN TENGAH",4,166,65,231
https://kawalpemilu.org#60501,"PEMANTANG, MENTAYA HULU, KOTAWARINGIN TIMUR, KALIMANTAN TENGAH",1,71,7,78
https://kawalpemilu.org#60501,"PEMANTANG, MENTAYA HULU, KOTAWARINGIN TIMUR, KALIMANTAN TENGAH",2,24,21,45
https://kawalpemilu.org#60501,"PEMANTANG, MENTAYA HULU, KOTAWARINGIN TIMUR, KALIMANTAN TENGAH",3,49,8,57
https://kawalpemilu.org#60501,"PEMANTANG, MENTAYA HULU, KOTAWARINGIN TIMUR, KALIMANTAN TENGAH",4,125,30,155
https://kawalpemilu.org#60501,"PEMANTANG, MENTAYA HULU, KOTAWARINGIN TIMUR, KALIMANTAN TENGAH",5,129,30,159
https://kawalpemilu.org#60501,"PEMANTANG, MENTAYA HULU, KOTAWARINGIN TIMUR, KALIMANTAN TENGAH",6,147,27,174
https://kawalpemilu.org#60502,"TUMBANG SAPIRI, MENTAYA HULU, KOTAWARINGIN TIMUR, KALIMANTAN TENGAH",1,148,14,162
https://kawalpemilu.org#60502,"TUMBANG SAPIRI, MENTAYA HULU, KOTAWARINGIN TIMUR, KALIMANTAN TENGAH",2,59,5,64
https://kawalpemilu.org#60503,"BAWAN, MENTAYA HULU, KOTAWARINGIN TIMUR, KALIMANTAN TENGAH",1,123,27,150
https://kawalpemilu.org#60504,"TANJUNG JARIANGAU, MENTAYA HULU, KOTAWARINGIN TIMUR, KALIMANTAN TENGAH",1,65,105,170
https://kawalpemilu.org#60504,"TANJUNG JARIANGAU, MENTAYA HULU, KOTAWARINGIN TIMUR, KALIMANTAN TENGAH",2,75,57,132
https://kawalpemilu.org#60504,"TANJUNG JARIANGAU, MENTAYA HULU, KOTAWARINGIN TIMUR, KALIMANTAN TENGAH",3,110,65,175
https://kawalpemilu.org#60504,"TANJUNG JARIANGAU, MENTAYA HULU, KOTAWARINGIN TIMUR, KALIMANTAN TENGAH",4,78,48,126
https://kawalpemilu.org#60504,"TANJUNG JARIANGAU, MENTAYA HULU, KOTAWARINGIN TIMUR, KALIMANTAN TENGAH",5,86,63,149
https://kawalpemilu.org#60504,"TANJUNG JARIANGAU, MENTAYA HULU, KOTAWARINGIN TIMUR, KALIMANTAN TENGAH",6,53,71,124
https://kawalpemilu.org#60504,"TANJUNG JARIANGAU, MENTAYA HULU, KOTAWARINGIN TIMUR, KALIMANTAN TENGAH",7,84,87,173
https://kawalpemilu.org#60504,"TANJUNG JARIANGAU, MENTAYA HULU, KOTAWARINGIN TIMUR, KALIMANTAN TENGAH",8,68,81,149
https://kawalpemilu.org#60504,"TANJUNG JARIANGAU, MENTAYA HULU, KOTAWARINGIN TIMUR, KALIMANTAN TENGAH",9,112,40,152
https://kawalpemilu.org#60504,"TANJUNG JARIANGAU, MENTAYA HULU, KOTAWARINGIN TIMUR, KALIMANTAN TENGAH",10,80,21,101
https://kawalpemilu.org#60504,"TANJUNG JARIANGAU, MENTAYA HULU, KOTAWARINGIN TIMUR, KALIMANTAN TENGAH",11,122,43,165
https://kawalpemilu.org#60504,"TANJUNG JARIANGAU, MENTAYA HULU, KOTAWARINGIN TIMUR, KALIMANTAN TENGAH",12,56,26,82
https://kawalpemilu.org#60504,"TANJUNG JARIANGAU, MENTAYA HULU, KOTAWARINGIN TIMUR, KALIMANTAN TENGAH",13,88,16,104
https://kawalpemilu.org#88420,"KAPUK, MENTAYA HULU, KOTAWARINGIN TIMUR, KALIMANTAN TENGAH",1,117,26,143
https://kawalpemilu.org#88420,"KAPUK, MENTAYA HULU, KOTAWARINGIN TIMUR, KALIMANTAN TENGAH",2,48,18,66
https://kawalpemilu.org#88420,"KAPUK, MENTAYA HULU, KOTAWARINGIN TIMUR, KALIMANTAN TENGAH",3,76,16,92
https://kawalpemilu.org#88420,"KAPUK, MENTAYA HULU, KOTAWARINGIN TIMUR, KALIMANTAN TENGAH",4,92,8,100
https://kawalpemilu.org#88420,"KAPUK, MENTAYA HULU, KOTAWARINGIN TIMUR, KALIMANTAN TENGAH",5,67,17,84
https://kawalpemilu.org#927891,"PANTAP, MENTAYA HULU, KOTAWARINGIN TIMUR, KALIMANTAN TENGAH",1,125,19,144
https://kawalpemilu.org#927891,"PANTAP, MENTAYA HULU, KOTAWARINGIN TIMUR, KALIMANTAN TENGAH",2,47,10,57
https://kawalpemilu.org#60508,"PARENGGEAN, PARENGGEAN, KOTAWARINGIN TIMUR, KALIMANTAN TENGAH",1,141,53,194
https://kawalpemilu.org#60508,"PARENGGEAN, PARENGGEAN, KOTAWARINGIN TIMUR, KALIMANTAN TENGAH",2,146,79,225
https://kawalpemilu.org#60508,"PARENGGEAN, PARENGGEAN, KOTAWARINGIN TIMUR, KALIMANTAN TENGAH",3,124,110,234
https://kawalpemilu.org#60508,"PARENGGEAN, PARENGGEAN, KOTAWARINGIN TIMUR, KALIMANTAN TENGAH",4,134,91,225
https://kawalpemilu.org#60508,"PARENGGEAN, PARENGGEAN, KOTAWARINGIN TIMUR, KALIMANTAN TENGAH",5,118,88,206
https://kawalpemilu.org#60508,"PARENGGEAN, PARENGGEAN, KOTAWARINGIN TIMUR, KALIMANTAN TENGAH",6,73,106,179
https://kawalpemilu.org#60508,"PARENGGEAN, PARENGGEAN, KOTAWARINGIN TIMUR, KALIMANTAN TENGAH",7,169,60,229
https://kawalpemilu.org#60508,"PARENGGEAN, PARENGGEAN, KOTAWARINGIN TIMUR, KALIMANTAN TENGAH",8,186,47,233
https://kawalpemilu.org#60508,"PARENGGEAN, PARENGGEAN, KOTAWARINGIN TIMUR, KALIMANTAN TENGAH",9,152,52,204
https://kawalpemilu.org#60508,"PARENGGEAN, PARENGGEAN, KOTAWARINGIN TIMUR, KALIMANTAN TENGAH",10,175,65,240
https://kawalpemilu.org#60508,"PARENGGEAN, PARENGGEAN, KOTAWARINGIN TIMUR, KALIMANTAN TENGAH",11,139,77,216
https://kawalpemilu.org#60508,"PARENGGEAN, PARENGGEAN, KOTAWARINGIN TIMUR, KALIMANTAN TENGAH",12,123,100,223
https://kawalpemilu.org#60508,"PARENGGEAN, PARENGGEAN, KOTAWARINGIN TIMUR, KALIMANTAN TENGAH",13,128,27,155
https://kawalpemilu.org#60508,"PARENGGEAN, PARENGGEAN, KOTAWARINGIN TIMUR, KALIMANTAN TENGAH",14,181,57,238
https://kawalpemilu.org#60508,"PARENGGEAN, PARENGGEAN, KOTAWARINGIN TIMUR, KALIMANTAN TENGAH",15,128,39,167
https://kawalpemilu.org#60508,"PARENGGEAN, PARENGGEAN, KOTAWARINGIN TIMUR, KALIMANTAN TENGAH",16,38,6,44
https://kawalpemilu.org#60509,"TEHANG, PARENGGEAN, KOTAWARINGIN TIMUR, KALIMANTAN TENGAH",1,84,15,99
https://kawalpemilu.org#60509,"TEHANG, PARENGGEAN, KOTAWARINGIN TIMUR, KALIMANTAN TENGAH",2,122,8,130
https://kawalpemilu.org#60509,"TEHANG, PARENGGEAN, KOTAWARINGIN TIMUR, KALIMANTAN TENGAH",3,105,17,122
https://kawalpemilu.org#60509,"TEHANG, PARENGGEAN, KOTAWARINGIN TIMUR, KALIMANTAN TENGAH",4,39,7,46
https://kawalpemilu.org#60510,"KABUAU, PARENGGEAN, KOTAWARINGIN TIMUR, KALIMANTAN TENGAH",1,152,35,187
https://kawalpemilu.org#60510,"KABUAU, PARENGGEAN, KOTAWARINGIN TIMUR, KALIMANTAN TENGAH",2,148,42,190
https://kawalpemilu.org#60510,"KABUAU, PARENGGEAN, KOTAWARINGIN TIMUR, KALIMANTAN TENGAH",3,109,26,135
https://kawalpemilu.org#60510,"KABUAU, PARENGGEAN, KOTAWARINGIN TIMUR, KALIMANTAN TENGAH",4,112,32,144
https://kawalpemilu.org#60510,"KABUAU, PARENGGEAN, KOTAWARINGIN TIMUR, KALIMANTAN TENGAH",5,88,25,113
https://kawalpemilu.org#60510,"KABUAU, PARENGGEAN, KOTAWARINGIN TIMUR, KALIMANTAN TENGAH",6,98,23,121
https://kawalpemilu.org#60510,"KABUAU, PARENGGEAN, KOTAWARINGIN TIMUR, KALIMANTAN TENGAH",7,87,22,109
https://kawalpemilu.org#60510,"KABUAU, PARENGGEAN, KOTAWARINGIN TIMUR, KALIMANTAN TENGAH",8,42,5,47
https://kawalpemilu.org#60510,"KABUAU, PARENGGEAN, KOTAWARINGIN TIMUR, KALIMANTAN TENGAH",9,34,15,49
https://kawalpemilu.org#60514,"BARUNANG MIRI, PARENGGEAN, KOTAWARINGIN TIMUR, KALIMANTAN TENGAH",1,166,60,226
https://kawalpemilu.org#60514,"BARUNANG MIRI, PARENGGEAN, KOTAWARINGIN TIMUR, KALIMANTAN TENGAH",2,101,43,144
https://kawalpemilu.org#60514,"BARUNANG MIRI, PARENGGEAN, KOTAWARINGIN TIMUR, KALIMANTAN TENGAH",3,82,37,119
https://kawalpemilu.org#60514,"BARUNANG MIRI, PARENGGEAN, KOTAWARINGIN TIMUR, KALIMANTAN TENGAH",4,53,14,67
https://kawalpemilu.org#60514,"BARUNANG MIRI, PARENGGEAN, KOTAWARINGIN TIMUR, KALIMANTAN TENGAH",5,83,15,98
https://kawalpemilu.org#60514,"BARUNANG MIRI, PARENGGEAN, KOTAWARINGIN TIMUR, KALIMANTAN TENGAH",6,87,8,95
https://kawalpemilu.org#60514,"BARUNANG MIRI, PARENGGEAN, KOTAWARINGIN TIMUR, KALIMANTAN TENGAH",7,53,9,62
https://kawalpemilu.org#60516,"SUMBER MAKMUR, PARENGGEAN, KOTAWARINGIN TIMUR, KALIMANTAN TENGAH",1,181,18,199
https://kawalpemilu.org#60516,"SUMBER MAKMUR, PARENGGEAN, KOTAWARINGIN TIMUR, KALIMANTAN TENGAH",2,158,35,193
https://kawalpemilu.org#60516,"SUMBER MAKMUR, PARENGGEAN, KOTAWARINGIN TIMUR, KALIMANTAN TENGAH",3,173,19,192
https://kawalpemilu.org#60516,"SUMBER MAKMUR, PARENGGEAN, KOTAWARINGIN TIMUR, KALIMANTAN TENGAH",4,168,18,186
https://kawalpemilu.org#60517,"MEKAR JAYA, PARENGGEAN, KOTAWARINGIN TIMUR, KALIMANTAN TENGAH",1,139,33,172
https://kawalpemilu.org#60517,"MEKAR JAYA, PARENGGEAN, KOTAWARINGIN TIMUR, KALIMANTAN TENGAH",2,175,50,225
https://kawalpemilu.org#60517,"MEKAR JAYA, PARENGGEAN, KOTAWARINGIN TIMUR, KALIMANTAN TENGAH",3,122,46,168
https://kawalpemilu.org#60517,"MEKAR JAYA, PARENGGEAN, KOTAWARINGIN TIMUR, KALIMANTAN TENGAH",4,187,22,209
https://kawalpemilu.org#60517,"MEKAR JAYA, PARENGGEAN, KOTAWARINGIN TIMUR, KALIMANTAN TENGAH",5,176,45,221
https://kawalpemilu.org#60517,"MEKAR JAYA, PARENGGEAN, KOTAWARINGIN TIMUR, KALIMANTAN TENGAH",6,149,18,167
https://kawalpemilu.org#60517,"MEKAR JAYA, PARENGGEAN, KOTAWARINGIN TIMUR, KALIMANTAN TENGAH",7,179,55,234
https://kawalpemilu.org#60518,"KARANG TUNGGAL, PARENGGEAN, KOTAWARINGIN TIMUR, KALIMANTAN TENGAH",1,209,36,245
https://kawalpemilu.org#60518,"KARANG TUNGGAL, PARENGGEAN, KOTAWARINGIN TIMUR, KALIMANTAN TENGAH",2,174,55,229
https://kawalpemilu.org#60518,"KARANG TUNGGAL, PARENGGEAN, KOTAWARINGIN TIMUR, KALIMANTAN TENGAH",3,197,38,235
https://kawalpemilu.org#60518,"KARANG TUNGGAL, PARENGGEAN, KOTAWARINGIN TIMUR, KALIMANTAN TENGAH",4,148,43,191
https://kawalpemilu.org#60518,"KARANG TUNGGAL, PARENGGEAN, KOTAWARINGIN TIMUR, KALIMANTAN TENGAH",5,91,37,128
https://kawalpemilu.org#60519,"BANDAR AGUNG, PARENGGEAN, KOTAWARINGIN TIMUR, KALIMANTAN TENGAH",1,208,30,238
https://kawalpemilu.org#60519,"BANDAR AGUNG, PARENGGEAN, KOTAWARINGIN TIMUR, KALIMANTAN TENGAH",2,121,44,165
https://kawalpemilu.org#60519,"BANDAR AGUNG, PARENGGEAN, KOTAWARINGIN TIMUR, KALIMANTAN TENGAH",3,125,26,151
https://kawalpemilu.org#60520,"BERINGIN TUNGGAL JAYA, PARENGGEAN, KOTAWARINGIN TIMUR, KALIMANTAN TENGAH",1,171,37,208
https://kawalpemilu.org#60520,"BERINGIN TUNGGAL JAYA, PARENGGEAN, KOTAWARINGIN TIMUR, KALIMANTAN TENGAH",2,171,28,199
https://kawalpemilu.org#60522,"SARI HARAPAN, PARENGGEAN, KOTAWARINGIN TIMUR, KALIMANTAN TENGAH",1,155,54,209
https://kawalpemilu.org#60522,"SARI HARAPAN, PARENGGEAN, KOTAWARINGIN TIMUR, KALIMANTAN TENGAH",2,195,21,216
https://kawalpemilu.org#60522,"SARI HARAPAN, PARENGGEAN, KOTAWARINGIN TIMUR, KALIMANTAN TENGAH",3,177,32,209
https://kawalpemilu.org#60522,"SARI HARAPAN, PARENGGEAN, KOTAWARINGIN TIMUR, KALIMANTAN TENGAH",4,84,8,92
https://kawalpemilu.org#60523,"KARANG SARI, PARENGGEAN, KOTAWARINGIN TIMUR, KALIMANTAN TENGAH",1,157,64,221
https://kawalpemilu.org#60523,"KARANG SARI, PARENGGEAN, KOTAWARINGIN TIMUR, KALIMANTAN TENGAH",2,157,33,190
https://kawalpemilu.org#60523,"KARANG SARI, PARENGGEAN, KOTAWARINGIN TIMUR, KALIMANTAN TENGAH",3,188,52,240
https://kawalpemilu.org#60523,"KARANG SARI, PARENGGEAN, KOTAWARINGIN TIMUR, KALIMANTAN TENGAH",4,202,25,227
https://kawalpemilu.org#60523,"KARANG SARI, PARENGGEAN, KOTAWARINGIN TIMUR, KALIMANTAN TENGAH",5,103,30,133
https://kawalpemilu.org#60526,"BAJARAU, PARENGGEAN, KOTAWARINGIN TIMUR, KALIMANTAN TENGAH",1,107,32,139
https://kawalpemilu.org#60526,"BAJARAU, PARENGGEAN, KOTAWARINGIN TIMUR, KALIMANTAN TENGAH",2,102,30,132
https://kawalpemilu.org#60526,"BAJARAU, PARENGGEAN, KOTAWARINGIN TIMUR, KALIMANTAN TENGAH",3,171,55,226
https://kawalpemilu.org#60526,"BAJARAU, PARENGGEAN, KOTAWARINGIN TIMUR, KALIMANTAN TENGAH",4,118,18,136
https://kawalpemilu.org#60526,"BAJARAU, PARENGGEAN, KOTAWARINGIN TIMUR, KALIMANTAN TENGAH",5,142,25,167
https://kawalpemilu.org#60530,"BUKIT HARAPAN, PARENGGEAN, KOTAWARINGIN TIMUR, KALIMANTAN TENGAH",1,159,51,210
https://kawalpemilu.org#60530,"BUKIT HARAPAN, PARENGGEAN, KOTAWARINGIN TIMUR, KALIMANTAN TENGAH",2,156,55,211
https://kawalpemilu.org#60530,"BUKIT HARAPAN, PARENGGEAN, KOTAWARINGIN TIMUR, KALIMANTAN TENGAH",3,135,37,172
https://kawalpemilu.org#927885,"MANJALIN, PARENGGEAN, KOTAWARINGIN TIMUR, KALIMANTAN TENGAH",1,94,32,126
https://kawalpemilu.org#927885,"MANJALIN, PARENGGEAN, KOTAWARINGIN TIMUR, KALIMANTAN TENGAH",2,95,19,114
https://kawalpemilu.org#927886,"KARYA BERSAMA, PARENGGEAN, KOTAWARINGIN TIMUR, KALIMANTAN TENGAH",1,145,49,194
https://kawalpemilu.org#927886,"KARYA BERSAMA, PARENGGEAN, KOTAWARINGIN TIMUR, KALIMANTAN TENGAH",2,126,20,146
https://kawalpemilu.org#60533,"BAAMANG HILIR, BAAMANG, KOTAWARINGIN TIMUR, KALIMANTAN TENGAH",1,40,75,115
https://kawalpemilu.org#60533,"BAAMANG HILIR, BAAMANG, KOTAWARINGIN TIMUR, KALIMANTAN TENGAH",2,46,100,146
https://kawalpemilu.org#60533,"BAAMANG HILIR, BAAMANG, KOTAWARINGIN TIMUR, KALIMANTAN TENGAH",3,46,122,168
https://kawalpemilu.org#60533,"BAAMANG HILIR, BAAMANG, KOTAWARINGIN TIMUR, KALIMANTAN TENGAH",4,60,156,216
https://kawalpemilu.org#60533,"BAAMANG HILIR, BAAMANG, KOTAWARINGIN TIMUR, KALIMANTAN TENGAH",5,72,151,223
https://kawalpemilu.org#60533,"BAAMANG HILIR, BAAMANG, KOTAWARINGIN TIMUR, KALIMANTAN TENGAH",6,72,139,211
https://kawalpemilu.org#60533,"BAAMANG HILIR, BAAMANG, KOTAWARINGIN TIMUR, KALIMANTAN TENGAH",7,40,116,156
https://kawalpemilu.org#60533,"BAAMANG HILIR, BAAMANG, KOTAWARINGIN TIMUR, KALIMANTAN TENGAH",8,35,80,115
https://kawalpemilu.org#60533,"BAAMANG HILIR, BAAMANG, KOTAWARINGIN TIMUR, KALIMANTAN TENGAH",9,48,89,137
https://kawalpemilu.org#60533,"BAAMANG HILIR, BAAMANG, KOTAWARINGIN TIMUR, KALIMANTAN TENGAH",10,23,81,104
https://kawalpemilu.org#60533,"BAAMANG HILIR, BAAMANG, KOTAWARINGIN TIMUR, KALIMANTAN TENGAH",11,26,103,129
https://kawalpemilu.org#60533,"BAAMANG HILIR, BAAMANG, KOTAWARINGIN TIMUR, KALIMANTAN TENGAH",12,60,110,170
https://kawalpemilu.org#60533,"BAAMANG HILIR, BAAMANG, KOTAWARINGIN TIMUR, KALIMANTAN TENGAH",13,31,95,126
https://kawalpemilu.org#60533,"BAAMANG HILIR, BAAMANG, KOTAWARINGIN TIMUR, KALIMANTAN TENGAH",14,46,96,142
https://kawalpemilu.org#60533,"BAAMANG HILIR, BAAMANG, KOTAWARINGIN TIMUR, KALIMANTAN TENGAH",15,72,144,216
https://kawalpemilu.org#60533,"BAAMANG HILIR, BAAMANG, KOTAWARINGIN TIMUR, KALIMANTAN TENGAH",16,79,189,268
https://kawalpemilu.org#60533,"BAAMANG HILIR, BAAMANG, KOTAWARINGIN TIMUR, KALIMANTAN TENGAH",17,78,59,137
https://kawalpemilu.org#60533,"BAAMANG HILIR, BAAMANG, KOTAWARINGIN TIMUR, KALIMANTAN TENGAH",18,151,97,248
https://kawalpemilu.org#60533,"BAAMANG HILIR, BAAMANG, KOTAWARINGIN TIMUR, KALIMANTAN TENGAH",19,108,120,228
https://kawalpemilu.org#60533,"BAAMANG HILIR, BAAMANG, KOTAWARINGIN TIMUR, KALIMANTAN TENGAH",20,75,112,187
https://kawalpemilu.org#60533,"BAAMANG HILIR, BAAMANG, KOTAWARINGIN TIMUR, KALIMANTAN TENGAH",21,92,111,203
https://kawalpemilu.org#60533,"BAAMANG HILIR, BAAMANG, KOTAWARINGIN TIMUR, KALIMANTAN TENGAH",22,167,90,257
https://kawalpemilu.org#60533,"BAAMANG HILIR, BAAMANG, KOTAWARINGIN TIMUR, KALIMANTAN TENGAH",23,87,127,214
https://kawalpemilu.org#60533,"BAAMANG HILIR, BAAMANG, KOTAWARINGIN TIMUR, KALIMANTAN TENGAH",24,68,131,199
https://kawalpemilu.org#60533,"BAAMANG HILIR, BAAMANG, KOTAWARINGIN TIMUR, KALIMANTAN TENGAH",25,75,111,186
https://kawalpemilu.org#60533,"BAAMANG HILIR, BAAMANG, KOTAWARINGIN TIMUR, KALIMANTAN TENGAH",26,56,98,154
https://kawalpemilu.org#60534,"BAAMANG TENGAH, BAAMANG, KOTAWARINGIN TIMUR, KALIMANTAN TENGAH",1,84,112,196
https://kawalpemilu.org#60534,"BAAMANG TENGAH, BAAMANG, KOTAWARINGIN TIMUR, KALIMANTAN TENGAH",2,80,96,176
https://kawalpemilu.org#60534,"BAAMANG TENGAH, BAAMANG, KOTAWARINGIN TIMUR, KALIMANTAN TENGAH",3,64,116,180
https://kawalpemilu.org#60534,"BAAMANG TENGAH, BAAMANG, KOTAWARINGIN TIMUR, KALIMANTAN TENGAH",4,54,157,211
https://kawalpemilu.org#60534,"BAAMANG TENGAH, BAAMANG, KOTAWARINGIN TIMUR, KALIMANTAN TENGAH",5,69,96,165
https://kawalpemilu.org#60534,"BAAMANG TENGAH, BAAMANG, KOTAWARINGIN TIMUR, KALIMANTAN TENGAH",6,51,54,105
https://kawalpemilu.org#60534,"BAAMANG TENGAH, BAAMANG, KOTAWARINGIN TIMUR, KALIMANTAN TENGAH",7,52,112,164
https://kawalpemilu.org#60534,"BAAMANG TENGAH, BAAMANG, KOTAWARINGIN TIMUR, KALIMANTAN TENGAH",8,54,89,143
https://kawalpemilu.org#60534,"BAAMANG TENGAH, BAAMANG, KOTAWARINGIN TIMUR, KALIMANTAN TENGAH",9,75,153,228
https://kawalpemilu.org#60534,"BAAMANG TENGAH, BAAMANG, KOTAWARINGIN TIMUR, KALIMANTAN TENGAH",10,58,102,160
https://kawalpemilu.org#60534,"BAAMANG TENGAH, BAAMANG, KOTAWARINGIN TIMUR, KALIMANTAN TENGAH",11,92,145,237
https://kawalpemilu.org#60534,"BAAMANG TENGAH, BAAMANG, KOTAWARINGIN TIMUR, KALIMANTAN TENGAH",12,79,124,203
https://kawalpemilu.org#60534,"BAAMANG TENGAH, BAAMANG, KOTAWARINGIN TIMUR, KALIMANTAN TENGAH",13,61,72,0
https://kawalpemilu.org#60534,"BAAMANG TENGAH, BAAMANG, KOTAWARINGIN TIMUR, KALIMANTAN TENGAH",14,84,114,198
https://kawalpemilu.org#60534,"BAAMANG TENGAH, BAAMANG, KOTAWARINGIN TIMUR, KALIMANTAN TENGAH",15,66,129,0
https://kawalpemilu.org#60534,"BAAMANG TENGAH, BAAMANG, KOTAWARINGIN TIMUR, KALIMANTAN TENGAH",16,100,100,200
https://kawalpemilu.org#60534,"BAAMANG TENGAH, BAAMANG, KOTAWARINGIN TIMUR, KALIMANTAN TENGAH",17,40,112,152
https://kawalpemilu.org#60534,"BAAMANG TENGAH, BAAMANG, KOTAWARINGIN TIMUR, KALIMANTAN TENGAH",18,41,76,117
https://kawalpemilu.org#60534,"BAAMANG TENGAH, BAAMANG, KOTAWARINGIN TIMUR, KALIMANTAN TENGAH",19,73,86,159
https://kawalpemilu.org#60534,"BAAMANG TENGAH, BAAMANG, KOTAWARINGIN TIMUR, KALIMANTAN TENGAH",20,65,127,192
https://kawalpemilu.org#60534,"BAAMANG TENGAH, BAAMANG, KOTAWARINGIN TIMUR, KALIMANTAN TENGAH",21,56,84,140
https://kawalpemilu.org#60534,"BAAMANG TENGAH, BAAMANG, KOTAWARINGIN TIMUR, KALIMANTAN TENGAH",22,24,77,101
https://kawalpemilu.org#60534,"BAAMANG TENGAH, BAAMANG, KOTAWARINGIN TIMUR, KALIMANTAN TENGAH",23,37,98,135
https://kawalpemilu.org#60534,"BAAMANG TENGAH, BAAMANG, KOTAWARINGIN TIMUR, KALIMANTAN TENGAH",24,56,98,154
https://kawalpemilu.org#60534,"BAAMANG TENGAH, BAAMANG, KOTAWARINGIN TIMUR, KALIMANTAN TENGAH",26,53,59,112
https://kawalpemilu.org#60534,"BAAMANG TENGAH, BAAMANG, KOTAWARINGIN TIMUR, KALIMANTAN TENGAH",27,28,70,98
https://kawalpemilu.org#60534,"BAAMANG TENGAH, BAAMANG, KOTAWARINGIN TIMUR, KALIMANTAN TENGAH",28,63,114,177
https://kawalpemilu.org#60534,"BAAMANG TENGAH, BAAMANG, KOTAWARINGIN TIMUR, KALIMANTAN TENGAH",29,39,55,94
https://kawalpemilu.org#60534,"BAAMANG TENGAH, BAAMANG, KOTAWARINGIN TIMUR, KALIMANTAN TENGAH",30,25,64,89
https://kawalpemilu.org#60534,"BAAMANG TENGAH, BAAMANG, KOTAWARINGIN TIMUR, KALIMANTAN TENGAH",31,77,99,176
https://kawalpemilu.org#60534,"BAAMANG TENGAH, BAAMANG, KOTAWARINGIN TIMUR, KALIMANTAN TENGAH",32,62,120,182
https://kawalpemilu.org#60534,"BAAMANG TENGAH, BAAMANG, KOTAWARINGIN TIMUR, KALIMANTAN TENGAH",33,82,75,157
https://kawalpemilu.org#60534,"BAAMANG TENGAH, BAAMANG, KOTAWARINGIN TIMUR, KALIMANTAN TENGAH",34,86,166,252
https://kawalpemilu.org#60534,"BAAMANG TENGAH, BAAMANG, KOTAWARINGIN TIMUR, KALIMANTAN TENGAH",35,49,104,153
https://kawalpemilu.org#60534,"BAAMANG TENGAH, BAAMANG, KOTAWARINGIN TIMUR, KALIMANTAN TENGAH",36,68,118,186
https://kawalpemilu.org#60534,"BAAMANG TENGAH, BAAMANG, KOTAWARINGIN TIMUR, KALIMANTAN TENGAH",37,67,139,206
https://kawalpemilu.org#60534,"BAAMANG TENGAH, BAAMANG, KOTAWARINGIN TIMUR, KALIMANTAN TENGAH",38,53,172,225
https://kawalpemilu.org#60534,"BAAMANG TENGAH, BAAMANG, KOTAWARINGIN TIMUR, KALIMANTAN TENGAH",39,67,117,184
https://kawalpemilu.org#60534,"BAAMANG TENGAH, BAAMANG, KOTAWARINGIN TIMUR, KALIMANTAN TENGAH",40,49,96,145
https://kawalpemilu.org#60534,"BAAMANG TENGAH, BAAMANG, KOTAWARINGIN TIMUR, KALIMANTAN TENGAH",41,29,62,91
https://kawalpemilu.org#60534,"BAAMANG TENGAH, BAAMANG, KOTAWARINGIN TIMUR, KALIMANTAN TENGAH",42,60,84,144
https://kawalpemilu.org#60534,"BAAMANG TENGAH, BAAMANG, KOTAWARINGIN TIMUR, KALIMANTAN TENGAH",43,36,102,138
https://kawalpemilu.org#60534,"BAAMANG TENGAH, BAAMANG, KOTAWARINGIN TIMUR, KALIMANTAN TENGAH",44,20,43,63
https://kawalpemilu.org#60534,"BAAMANG TENGAH, BAAMANG, KOTAWARINGIN TIMUR, KALIMANTAN TENGAH",45,85,132,217
https://kawalpemilu.org#60534,"BAAMANG TENGAH, BAAMANG, KOTAWARINGIN TIMUR, KALIMANTAN TENGAH",46,48,165,213
https://kawalpemilu.org#60534,"BAAMANG TENGAH, BAAMANG, KOTAWARINGIN TIMUR, KALIMANTAN TENGAH",47,85,111,196
https://kawalpemilu.org#60534,"BAAMANG TENGAH, BAAMANG, KOTAWARINGIN TIMUR, KALIMANTAN TENGAH",48,66,70,136
https://kawalpemilu.org#60534,"BAAMANG TENGAH, BAAMANG, KOTAWARINGIN TIMUR, KALIMANTAN TENGAH",49,76,123,199
https://kawalpemilu.org#60534,"BAAMANG TENGAH, BAAMANG, KOTAWARINGIN TIMUR, KALIMANTAN TENGAH",50,42,68,110
https://kawalpemilu.org#60534,"BAAMANG TENGAH, BAAMANG, KOTAWARINGIN TIMUR, KALIMANTAN TENGAH",51,79,124,203
https://kawalpemilu.org#60534,"BAAMANG TENGAH, BAAMANG, KOTAWARINGIN TIMUR, KALIMANTAN TENGAH",52,66,152,218
https://kawalpemilu.org#60534,"BAAMANG TENGAH, BAAMANG, KOTAWARINGIN TIMUR, KALIMANTAN TENGAH",53,52,84,136
https://kawalpemilu.org#60534,"BAAMANG TENGAH, BAAMANG, KOTAWARINGIN TIMUR, KALIMANTAN TENGAH",54,52,78,130
https://kawalpemilu.org#60534,"BAAMANG TENGAH, BAAMANG, KOTAWARINGIN TIMUR, KALIMANTAN TENGAH",55,103,106,209
https://kawalpemilu.org#60534,"BAAMANG TENGAH, BAAMANG, KOTAWARINGIN TIMUR, KALIMANTAN TENGAH",56,96,139,235
https://kawalpemilu.org#60534,"BAAMANG TENGAH, BAAMANG, KOTAWARINGIN TIMUR, KALIMANTAN TENGAH",57,66,165,231
https://kawalpemilu.org#60534,"BAAMANG TENGAH, BAAMANG, KOTAWARINGIN TIMUR, KALIMANTAN TENGAH",58,59,162,221
https://kawalpemilu.org#60534,"BAAMANG TENGAH, BAAMANG, KOTAWARINGIN TIMUR, KALIMANTAN TENGAH",59,47,81,128
https://kawalpemilu.org#60534,"BAAMANG TENGAH, BAAMANG, KOTAWARINGIN TIMUR, KALIMANTAN TENGAH",60,80,90,170
https://kawalpemilu.org#60534,"BAAMANG TENGAH, BAAMANG, KOTAWARINGIN TIMUR, KALIMANTAN TENGAH",61,90,108,198
https://kawalpemilu.org#60534,"BAAMANG TENGAH, BAAMANG, KOTAWARINGIN TIMUR, KALIMANTAN TENGAH",62,44,138,182
https://kawalpemilu.org#60534,"BAAMANG TENGAH, BAAMANG, KOTAWARINGIN TIMUR, KALIMANTAN TENGAH",63,46,114,160
https://kawalpemilu.org#60534,"BAAMANG TENGAH, BAAMANG, KOTAWARINGIN TIMUR, KALIMANTAN TENGAH",64,33,113,146
https://kawalpemilu.org#60534,"BAAMANG TENGAH, BAAMANG, KOTAWARINGIN TIMUR, KALIMANTAN TENGAH",65,54,57,111
https://kawalpemilu.org#60534,"BAAMANG TENGAH, BAAMANG, KOTAWARINGIN TIMUR, KALIMANTAN TENGAH",66,60,125,185
https://kawalpemilu.org#60534,"BAAMANG TENGAH, BAAMANG, KOTAWARINGIN TIMUR, KALIMANTAN TENGAH",67,91,91,182
https://kawalpemilu.org#60534,"BAAMANG TENGAH, BAAMANG, KOTAWARINGIN TIMUR, KALIMANTAN TENGAH",68,22,46,68
https://kawalpemilu.org#60534,"BAAMANG TENGAH, BAAMANG, KOTAWARINGIN TIMUR, KALIMANTAN TENGAH",69,76,146,222
https://kawalpemilu.org#60534,"BAAMANG TENGAH, BAAMANG, KOTAWARINGIN TIMUR, KALIMANTAN TENGAH",70,76,113,189
https://kawalpemilu.org#60534,"BAAMANG TENGAH, BAAMANG, KOTAWARINGIN TIMUR, KALIMANTAN TENGAH",71,75,123,198
https://kawalpemilu.org#60534,"BAAMANG TENGAH, BAAMANG, KOTAWARINGIN TIMUR, KALIMANTAN TENGAH",72,96,120,216
https://kawalpemilu.org#60534,"BAAMANG TENGAH, BAAMANG, KOTAWARINGIN TIMUR, KALIMANTAN TENGAH",73,57,140,197
https://kawalpemilu.org#60534,"BAAMANG TENGAH, BAAMANG, KOTAWARINGIN TIMUR, KALIMANTAN TENGAH",74,69,47,116
https://kawalpemilu.org#60534,"BAAMANG TENGAH, BAAMANG, KOTAWARINGIN TIMUR, KALIMANTAN TENGAH",75,52,103,155
https://kawalpemilu.org#60534,"BAAMANG TENGAH, BAAMANG, KOTAWARINGIN TIMUR, KALIMANTAN TENGAH",76,33,53,86
https://kawalpemilu.org#60534,"BAAMANG TENGAH, BAAMANG, KOTAWARINGIN TIMUR, KALIMANTAN TENGAH",77,74,110,184
https://kawalpemilu.org#60534,"BAAMANG TENGAH, BAAMANG, KOTAWARINGIN TIMUR, KALIMANTAN TENGAH",78,76,105,181
https://kawalpemilu.org#60534,"BAAMANG TENGAH, BAAMANG, KOTAWARINGIN TIMUR, KALIMANTAN TENGAH",79,58,53,111
https://kawalpemilu.org#60534,"BAAMANG TENGAH, BAAMANG, KOTAWARINGIN TIMUR, KALIMANTAN TENGAH",80,61,138,199
https://kawalpemilu.org#60534,"BAAMANG TENGAH, BAAMANG, KOTAWARINGIN TIMUR, KALIMANTAN TENGAH",81,67,71,138
https://kawalpemilu.org#60534,"BAAMANG TENGAH, BAAMANG, KOTAWARINGIN TIMUR, KALIMANTAN TENGAH",82,57,118,175
https://kawalpemilu.org#60534,"BAAMANG TENGAH, BAAMANG, KOTAWARINGIN TIMUR, KALIMANTAN TENGAH",83,61,118,179
https://kawalpemilu.org#60534,"BAAMANG TENGAH, BAAMANG, KOTAWARINGIN TIMUR, KALIMANTAN TENGAH",84,56,150,206
https://kawalpemilu.org#60534,"BAAMANG TENGAH, BAAMANG, KOTAWARINGIN TIMUR, KALIMANTAN TENGAH",85,62,116,178
https://kawalpemilu.org#60534,"BAAMANG TENGAH, BAAMANG, KOTAWARINGIN TIMUR, KALIMANTAN TENGAH",86,45,66,111
https://kawalpemilu.org#60534,"BAAMANG TENGAH, BAAMANG, KOTAWARINGIN TIMUR, KALIMANTAN TENGAH",87,64,96,160
https://kawalpemilu.org#60534,"BAAMANG TENGAH, BAAMANG, KOTAWARINGIN TIMUR, KALIMANTAN TENGAH",88,54,80,134
https://kawalpemilu.org#60534,"BAAMANG TENGAH, BAAMANG, KOTAWARINGIN TIMUR, KALIMANTAN TENGAH",89,44,135,179
https://kawalpemilu.org#60534,"BAAMANG TENGAH, BAAMANG, KOTAWARINGIN TIMUR, KALIMANTAN TENGAH",90,48,135,183
https://kawalpemilu.org#60534,"BAAMANG TENGAH, BAAMANG, KOTAWARINGIN TIMUR, KALIMANTAN TENGAH",91,53,105,158
https://kawalpemilu.org#60534,"BAAMANG TENGAH, BAAMANG, KOTAWARINGIN TIMUR, KALIMANTAN TENGAH",92,56,111,167
https://kawalpemilu.org#60534,"BAAMANG TENGAH, BAAMANG, KOTAWARINGIN TIMUR, KALIMANTAN TENGAH",93,47,44,91
https://kawalpemilu.org#60535,"BAAMANG HULU, BAAMANG, KOTAWARINGIN TIMUR, KALIMANTAN TENGAH",1,73,82,155
https://kawalpemilu.org#60535,"BAAMANG HULU, BAAMANG, KOTAWARINGIN TIMUR, KALIMANTAN TENGAH",2,99,98,197
https://kawalpemilu.org#60535,"BAAMANG HULU, BAAMANG, KOTAWARINGIN TIMUR, KALIMANTAN TENGAH",3,93,117,210
https://kawalpemilu.org#60535,"BAAMANG HULU, BAAMANG, KOTAWARINGIN TIMUR, KALIMANTAN TENGAH",4,90,122,212
https://kawalpemilu.org#60535,"BAAMANG HULU, BAAMANG, KOTAWARINGIN TIMUR, KALIMANTAN TENGAH",5,68,82,150
https://kawalpemilu.org#60535,"BAAMANG HULU, BAAMANG, KOTAWARINGIN TIMUR, KALIMANTAN TENGAH",6,75,82,157
https://kawalpemilu.org#60535,"BAAMANG HULU, BAAMANG, KOTAWARINGIN TIMUR, KALIMANTAN TENGAH",7,54,120,174
https://kawalpemilu.org#60535,"BAAMANG HULU, BAAMANG, KOTAWARINGIN TIMUR, KALIMANTAN TENGAH",8,60,98,158
https://kawalpemilu.org#60535,"BAAMANG HULU, BAAMANG, KOTAWARINGIN TIMUR, KALIMANTAN TENGAH",9,73,70,143
https://kawalpemilu.org#60535,"BAAMANG HULU, BAAMANG, KOTAWARINGIN TIMUR, KALIMANTAN TENGAH",10,77,154,231
https://kawalpemilu.org#60535,"BAAMANG HULU, BAAMANG, KOTAWARINGIN TIMUR, KALIMANTAN TENGAH",11,81,93,174
https://kawalpemilu.org#60535,"BAAMANG HULU, BAAMANG, KOTAWARINGIN TIMUR, KALIMANTAN TENGAH",12,60,127,187
https://kawalpemilu.org#60535,"BAAMANG HULU, BAAMANG, KOTAWARINGIN TIMUR, KALIMANTAN TENGAH",13,92,143,235
https://kawalpemilu.org#60535,"BAAMANG HULU, BAAMANG, KOTAWARINGIN TIMUR, KALIMANTAN TENGAH",14,124,90,214
https://kawalpemilu.org#60535,"BAAMANG HULU, BAAMANG, KOTAWARINGIN TIMUR, KALIMANTAN TENGAH",15,107,73,180
https://kawalpemilu.org#60535,"BAAMANG HULU, BAAMANG, KOTAWARINGIN TIMUR, KALIMANTAN TENGAH",16,61,55,116
https://kawalpemilu.org#60535,"BAAMANG HULU, BAAMANG, KOTAWARINGIN TIMUR, KALIMANTAN TENGAH",17,113,127,240
https://kawalpemilu.org#60535,"BAAMANG HULU, BAAMANG, KOTAWARINGIN TIMUR, KALIMANTAN TENGAH",18,94,103,197
https://kawalpemilu.org#60535,"BAAMANG HULU, BAAMANG, KOTAWARINGIN TIMUR, KALIMANTAN TENGAH",19,39,40,79
https://kawalpemilu.org#60535,"BAAMANG HULU, BAAMANG, KOTAWARINGIN TIMUR, KALIMANTAN TENGAH",20,69,93,162
https://kawalpemilu.org#60535,"BAAMANG HULU, BAAMANG, KOTAWARINGIN TIMUR, KALIMANTAN TENGAH",21,78,99,177
https://kawalpemilu.org#60535,"BAAMANG HULU, BAAMANG, KOTAWARINGIN TIMUR, KALIMANTAN TENGAH",22,84,124,208
https://kawalpemilu.org#60535,"BAAMANG HULU, BAAMANG, KOTAWARINGIN TIMUR, KALIMANTAN TENGAH",23,75,110,185
https://kawalpemilu.org#60535,"BAAMANG HULU, BAAMANG, KOTAWARINGIN TIMUR, KALIMANTAN TENGAH",24,61,108,169
https://kawalpemilu.org#60535,"BAAMANG HULU, BAAMANG, KOTAWARINGIN TIMUR, KALIMANTAN TENGAH",25,97,110,207
https://kawalpemilu.org#60535,"BAAMANG HULU, BAAMANG, KOTAWARINGIN TIMUR, KALIMANTAN TENGAH",26,92,99,191
https://kawalpemilu.org#60535,"BAAMANG HULU, BAAMANG, KOTAWARINGIN TIMUR, KALIMANTAN TENGAH",27,85,96,181
https://kawalpemilu.org#60535,"BAAMANG HULU, BAAMANG, KOTAWARINGIN TIMUR, KALIMANTAN TENGAH",28,62,109,171
https://kawalpemilu.org#60535,"BAAMANG HULU, BAAMANG, KOTAWARINGIN TIMUR, KALIMANTAN TENGAH",29,73,93,166
https://kawalpemilu.org#60535,"BAAMANG HULU, BAAMANG, KOTAWARINGIN TIMUR, KALIMANTAN TENGAH",30,89,85,174
https://kawalpemilu.org#60535,"BAAMANG HULU, BAAMANG, KOTAWARINGIN TIMUR, KALIMANTAN TENGAH",31,61,107,168
https://kawalpemilu.org#60535,"BAAMANG HULU, BAAMANG, KOTAWARINGIN TIMUR, KALIMANTAN TENGAH",32,51,93,144
https://kawalpemilu.org#60535,"BAAMANG HULU, BAAMANG, KOTAWARINGIN TIMUR, KALIMANTAN TENGAH",33,50,48,98
https://kawalpemilu.org#60535,"BAAMANG HULU, BAAMANG, KOTAWARINGIN TIMUR, KALIMANTAN TENGAH",34,62,65,127
https://kawalpemilu.org#60536,"TANAH MAS, BAAMANG, KOTAWARINGIN TIMUR, KALIMANTAN TENGAH",1,193,59,252
https://kawalpemilu.org#60536,"TANAH MAS, BAAMANG, KOTAWARINGIN TIMUR, KALIMANTAN TENGAH",2,74,77,151
https://kawalpemilu.org#60536,"TANAH MAS, BAAMANG, KOTAWARINGIN TIMUR, KALIMANTAN TENGAH",3,55,104,159
https://kawalpemilu.org#60536,"TANAH MAS, BAAMANG, KOTAWARINGIN TIMUR, KALIMANTAN TENGAH",4,135,32,167
https://kawalpemilu.org#60537,"BAAMANG BARAT, BAAMANG, KOTAWARINGIN TIMUR, KALIMANTAN TENGAH",1,99,125,224
https://kawalpemilu.org#60537,"BAAMANG BARAT, BAAMANG, KOTAWARINGIN TIMUR, KALIMANTAN TENGAH",2,145,107,252
https://kawalpemilu.org#60537,"BAAMANG BARAT, BAAMANG, KOTAWARINGIN TIMUR, KALIMANTAN TENGAH",3,113,128,241
https://kawalpemilu.org#60537,"BAAMANG BARAT, BAAMANG, KOTAWARINGIN TIMUR, KALIMANTAN TENGAH",4,72,121,193
https://kawalpemilu.org#60537,"BAAMANG BARAT, BAAMANG, KOTAWARINGIN TIMUR, KALIMANTAN TENGAH",5,74,94,168
https://kawalpemilu.org#60537,"BAAMANG BARAT, BAAMANG, KOTAWARINGIN TIMUR, KALIMANTAN TENGAH",6,156,92,248
https://kawalpemilu.org#60537,"BAAMANG BARAT, BAAMANG, KOTAWARINGIN TIMUR, KALIMANTAN TENGAH",7,147,52,199
https://kawalpemilu.org#60537,"BAAMANG BARAT, BAAMANG, KOTAWARINGIN TIMUR, KALIMANTAN TENGAH",8,105,109,214
https://kawalpemilu.org#60537,"BAAMANG BARAT, BAAMANG, KOTAWARINGIN TIMUR, KALIMANTAN TENGAH",9,132,93,225
https://kawalpemilu.org#60537,"BAAMANG BARAT, BAAMANG, KOTAWARINGIN TIMUR, KALIMANTAN TENGAH",10,95,83,178
https://kawalpemilu.org#60537,"BAAMANG BARAT, BAAMANG, KOTAWARINGIN TIMUR, KALIMANTAN TENGAH",11,103,99,202
https://kawalpemilu.org#60537,"BAAMANG BARAT, BAAMANG, KOTAWARINGIN TIMUR, KALIMANTAN TENGAH",12,98,91,189
https://kawalpemilu.org#60537,"BAAMANG BARAT, BAAMANG, KOTAWARINGIN TIMUR, KALIMANTAN TENGAH",13,134,66,200
https://kawalpemilu.org#60537,"BAAMANG BARAT, BAAMANG, KOTAWARINGIN TIMUR, KALIMANTAN TENGAH",14,116,69,185
https://kawalpemilu.org#60537,"BAAMANG BARAT, BAAMANG, KOTAWARINGIN TIMUR, KALIMANTAN TENGAH",15,85,95,180
https://kawalpemilu.org#60537,"BAAMANG BARAT, BAAMANG, KOTAWARINGIN TIMUR, KALIMANTAN TENGAH",16,95,130,225
https://kawalpemilu.org#60537,"BAAMANG BARAT, BAAMANG, KOTAWARINGIN TIMUR, KALIMANTAN TENGAH",17,59,38,97
https://kawalpemilu.org#60537,"BAAMANG BARAT, BAAMANG, KOTAWARINGIN TIMUR, KALIMANTAN TENGAH",18,102,81,183
https://kawalpemilu.org#60537,"BAAMANG BARAT, BAAMANG, KOTAWARINGIN TIMUR, KALIMANTAN TENGAH",19,98,107,205
https://kawalpemilu.org#60537,"BAAMANG BARAT, BAAMANG, KOTAWARINGIN TIMUR, KALIMANTAN TENGAH",20,126,100,226
https://kawalpemilu.org#60537,"BAAMANG BARAT, BAAMANG, KOTAWARINGIN TIMUR, KALIMANTAN TENGAH",21,83,59,142
https://kawalpemilu.org#60537,"BAAMANG BARAT, BAAMANG, KOTAWARINGIN TIMUR, KALIMANTAN TENGAH",22,100,121,221
https://kawalpemilu.org#60537,"BAAMANG BARAT, BAAMANG, KOTAWARINGIN TIMUR, KALIMANTAN TENGAH",23,75,54,129
https://kawalpemilu.org#60537,"BAAMANG BARAT, BAAMANG, KOTAWARINGIN TIMUR, KALIMANTAN TENGAH",24,68,57,125
https://kawalpemilu.org#60537,"BAAMANG BARAT, BAAMANG, KOTAWARINGIN TIMUR, KALIMANTAN TENGAH",25,113,96,209
https://kawalpemilu.org#60537,"BAAMANG BARAT, BAAMANG, KOTAWARINGIN TIMUR, KALIMANTAN TENGAH",26,93,115,208
https://kawalpemilu.org#60537,"BAAMANG BARAT, BAAMANG, KOTAWARINGIN TIMUR, KALIMANTAN TENGAH",27,92,83,175
https://kawalpemilu.org#60537,"BAAMANG BARAT, BAAMANG, KOTAWARINGIN TIMUR, KALIMANTAN TENGAH",28,86,42,128
https://kawalpemilu.org#60537,"BAAMANG BARAT, BAAMANG, KOTAWARINGIN TIMUR, KALIMANTAN TENGAH",29,71,56,127
https://kawalpemilu.org#60537,"BAAMANG BARAT, BAAMANG, KOTAWARINGIN TIMUR, KALIMANTAN TENGAH",30,61,84,145
https://kawalpemilu.org#60537,"BAAMANG BARAT, BAAMANG, KOTAWARINGIN TIMUR, KALIMANTAN TENGAH",31,42,41,83
https://kawalpemilu.org#60537,"BAAMANG BARAT, BAAMANG, KOTAWARINGIN TIMUR, KALIMANTAN TENGAH",32,70,28,98
https://kawalpemilu.org#60537,"BAAMANG BARAT, BAAMANG, KOTAWARINGIN TIMUR, KALIMANTAN TENGAH",33,91,87,178
https://kawalpemilu.org#60538,"TINDUK, BAAMANG, KOTAWARINGIN TIMUR, KALIMANTAN TENGAH",1,98,117,215
https://kawalpemilu.org#60538,"TINDUK, BAAMANG, KOTAWARINGIN TIMUR, KALIMANTAN TENGAH",2,104,69,173
https://kawalpemilu.org#60538,"TINDUK, BAAMANG, KOTAWARINGIN TIMUR, KALIMANTAN TENGAH",3,67,140,207
https://kawalpemilu.org#60538,"TINDUK, BAAMANG, KOTAWARINGIN TIMUR, KALIMANTAN TENGAH",4,95,60,155
https://kawalpemilu.org#60540,"MENTAWA BARU HULU, MENTAWA BARU KETAPANG, KOTAWARINGIN TIMUR, KALIMANTAN TENGAH",1,49,166,215
https://kawalpemilu.org#60540,"MENTAWA BARU HULU, MENTAWA BARU KETAPANG, KOTAWARINGIN TIMUR, KALIMANTAN TENGAH",2,90,55,145
https://kawalpemilu.org#60540,"MENTAWA BARU HULU, MENTAWA BARU KETAPANG, KOTAWARINGIN TIMUR, KALIMANTAN TENGAH",3,74,150,224
https://kawalpemilu.org#60540,"MENTAWA BARU HULU, MENTAWA BARU KETAPANG, KOTAWARINGIN TIMUR, KALIMANTAN TENGAH",4,96,137,233
https://kawalpemilu.org#60540,"MENTAWA BARU HULU, MENTAWA BARU KETAPANG, KOTAWARINGIN TIMUR, KALIMANTAN TENGAH",5,120,120,240
https://kawalpemilu.org#60540,"MENTAWA BARU HULU, MENTAWA BARU KETAPANG, KOTAWARINGIN TIMUR, KALIMANTAN TENGAH",6,57,213,270
https://kawalpemilu.org#60540,"MENTAWA BARU HULU, MENTAWA BARU KETAPANG, KOTAWARINGIN TIMUR, KALIMANTAN TENGAH",7,59,134,193
https://kawalpemilu.org#60540,"MENTAWA BARU HULU, MENTAWA BARU KETAPANG, KOTAWARINGIN TIMUR, KALIMANTAN TENGAH",8,103,161,264
https://kawalpemilu.org#60540,"MENTAWA BARU HULU, MENTAWA BARU KETAPANG, KOTAWARINGIN TIMUR, KALIMANTAN TENGAH",9,107,87,194
https://kawalpemilu.org#60540,"MENTAWA BARU HULU, MENTAWA BARU KETAPANG, KOTAWARINGIN TIMUR, KALIMANTAN TENGAH",10,102,110,212
https://kawalpemilu.org#60540,"MENTAWA BARU HULU, MENTAWA BARU KETAPANG, KOTAWARINGIN TIMUR, KALIMANTAN TENGAH",11,105,103,208
https://kawalpemilu.org#60540,"MENTAWA BARU HULU, MENTAWA BARU KETAPANG, KOTAWARINGIN TIMUR, KALIMANTAN TENGAH",13,68,139,207
https://kawalpemilu.org#60540,"MENTAWA BARU HULU, MENTAWA BARU KETAPANG, KOTAWARINGIN TIMUR, KALIMANTAN TENGAH",14,69,154,223
https://kawalpemilu.org#60540,"MENTAWA BARU HULU, MENTAWA BARU KETAPANG, KOTAWARINGIN TIMUR, KALIMANTAN TENGAH",15,56,138,194
https://kawalpemilu.org#60540,"MENTAWA BARU HULU, MENTAWA BARU KETAPANG, KOTAWARINGIN TIMUR, KALIMANTAN TENGAH",16,66,124,192
https://kawalpemilu.org#60540,"MENTAWA BARU HULU, MENTAWA BARU KETAPANG, KOTAWARINGIN TIMUR, KALIMANTAN TENGAH",17,84,78,162
https://kawalpemilu.org#60540,"MENTAWA BARU HULU, MENTAWA BARU KETAPANG, KOTAWARINGIN TIMUR, KALIMANTAN TENGAH",18,53,90,143
https://kawalpemilu.org#60540,"MENTAWA BARU HULU, MENTAWA BARU KETAPANG, KOTAWARINGIN TIMUR, KALIMANTAN TENGAH",19,74,112,186
https://kawalpemilu.org#60540,"MENTAWA BARU HULU, MENTAWA BARU KETAPANG, KOTAWARINGIN TIMUR, KALIMANTAN TENGAH",20,29,103,132
https://kawalpemilu.org#60540,"MENTAWA BARU HULU, MENTAWA BARU KETAPANG, KOTAWARINGIN TIMUR, KALIMANTAN TENGAH",21,79,112,191
https://kawalpemilu.org#60540,"MENTAWA BARU HULU, MENTAWA BARU KETAPANG, KOTAWARINGIN TIMUR, KALIMANTAN TENGAH",22,42,145,187
https://kawalpemilu.org#60540,"MENTAWA BARU HULU, MENTAWA BARU KETAPANG, KOTAWARINGIN TIMUR, KALIMANTAN TENGAH",23,70,108,178
https://kawalpemilu.org#60540,"MENTAWA BARU HULU, MENTAWA BARU KETAPANG, KOTAWARINGIN TIMUR, KALIMANTAN TENGAH",24,99,146,245
https://kawalpemilu.org#60540,"MENTAWA BARU HULU, MENTAWA BARU KETAPANG, KOTAWARINGIN TIMUR, KALIMANTAN TENGAH",25,85,95,180
https://kawalpemilu.org#60540,"MENTAWA BARU HULU, MENTAWA BARU KETAPANG, KOTAWARINGIN TIMUR, KALIMANTAN TENGAH",26,45,39,84
https://kawalpemilu.org#60540,"MENTAWA BARU HULU, MENTAWA BARU KETAPANG, KOTAWARINGIN TIMUR, KALIMANTAN TENGAH",27,70,83,153
https://kawalpemilu.org#60540,"MENTAWA BARU HULU, MENTAWA BARU KETAPANG, KOTAWARINGIN TIMUR, KALIMANTAN TENGAH",28,34,86,120
https://kawalpemilu.org#60540,"MENTAWA BARU HULU, MENTAWA BARU KETAPANG, KOTAWARINGIN TIMUR, KALIMANTAN TENGAH",29,74,79,153
https://kawalpemilu.org#60540,"MENTAWA BARU HULU, MENTAWA BARU KETAPANG, KOTAWARINGIN TIMUR, KALIMANTAN TENGAH",30,97,135,232
https://kawalpemilu.org#60540,"MENTAWA BARU HULU, MENTAWA BARU KETAPANG, KOTAWARINGIN TIMUR, KALIMANTAN TENGAH",31,60,98,158
https://kawalpemilu.org#60540,"MENTAWA BARU HULU, MENTAWA BARU KETAPANG, KOTAWARINGIN TIMUR, KALIMANTAN TENGAH",32,74,61,135
https://kawalpemilu.org#60540,"MENTAWA BARU HULU, MENTAWA BARU KETAPANG, KOTAWARINGIN TIMUR, KALIMANTAN TENGAH",33,53,53,106
https://kawalpemilu.org#60540,"MENTAWA BARU HULU, MENTAWA BARU KETAPANG, KOTAWARINGIN TIMUR, KALIMANTAN TENGAH",34,82,126,208
https://kawalpemilu.org#60540,"MENTAWA BARU HULU, MENTAWA BARU KETAPANG, KOTAWARINGIN TIMUR, KALIMANTAN TENGAH",35,98,151,249
https://kawalpemilu.org#60540,"MENTAWA BARU HULU, MENTAWA BARU KETAPANG, KOTAWARINGIN TIMUR, KALIMANTAN TENGAH",36,161,69,230
https://kawalpemilu.org#60540,"MENTAWA BARU HULU, MENTAWA BARU KETAPANG, KOTAWARINGIN TIMUR, KALIMANTAN TENGAH",37,110,95,205
https://kawalpemilu.org#60540,"MENTAWA BARU HULU, MENTAWA BARU KETAPANG, KOTAWARINGIN TIMUR, KALIMANTAN TENGAH",38,162,74,236
https://kawalpemilu.org#60540,"MENTAWA BARU HULU, MENTAWA BARU KETAPANG, KOTAWARINGIN TIMUR, KALIMANTAN TENGAH",39,105,92,197
https://kawalpemilu.org#60540,"MENTAWA BARU HULU, MENTAWA BARU KETAPANG, KOTAWARINGIN TIMUR, KALIMANTAN TENGAH",40,110,136,246
https://kawalpemilu.org#60540,"MENTAWA BARU HULU, MENTAWA BARU KETAPANG, KOTAWARINGIN TIMUR, KALIMANTAN TENGAH",41,86,147,233
https://kawalpemilu.org#60540,"MENTAWA BARU HULU, MENTAWA BARU KETAPANG, KOTAWARINGIN TIMUR, KALIMANTAN TENGAH",42,115,50,165
https://kawalpemilu.org#60540,"MENTAWA BARU HULU, MENTAWA BARU KETAPANG, KOTAWARINGIN TIMUR, KALIMANTAN TENGAH",43,159,50,209
https://kawalpemilu.org#60540,"MENTAWA BARU HULU, MENTAWA BARU KETAPANG, KOTAWARINGIN TIMUR, KALIMANTAN TENGAH",44,103,52,155
https://kawalpemilu.org#60541,"MENTAWA BARU HILIR, MENTAWA BARU KETAPANG, KOTAWARINGIN TIMUR, KALIMANTAN TENGAH",1,21,54,75
https://kawalpemilu.org#60541,"MENTAWA BARU HILIR, MENTAWA BARU KETAPANG, KOTAWARINGIN TIMUR, KALIMANTAN TENGAH",2,59,165,224
https://kawalpemilu.org#60541,"MENTAWA BARU HILIR, MENTAWA BARU KETAPANG, KOTAWARINGIN TIMUR, KALIMANTAN TENGAH",3,35,54,89
https://kawalpemilu.org#60541,"MENTAWA BARU HILIR, MENTAWA BARU KETAPANG, KOTAWARINGIN TIMUR, KALIMANTAN TENGAH",4,54,138,192
https://kawalpemilu.org#60541,"MENTAWA BARU HILIR, MENTAWA BARU KETAPANG, KOTAWARINGIN TIMUR, KALIMANTAN TENGAH",5,73,121,194
https://kawalpemilu.org#60541,"MENTAWA BARU HILIR, MENTAWA BARU KETAPANG, KOTAWARINGIN TIMUR, KALIMANTAN TENGAH",6,64,120,184
https://kawalpemilu.org#60541,"MENTAWA BARU HILIR, MENTAWA BARU KETAPANG, KOTAWARINGIN TIMUR, KALIMANTAN TENGAH",7,50,145,195
https://kawalpemilu.org#60541,"MENTAWA BARU HILIR, MENTAWA BARU KETAPANG, KOTAWARINGIN TIMUR, KALIMANTAN TENGAH",8,42,196,238
https://kawalpemilu.org#60541,"MENTAWA BARU HILIR, MENTAWA BARU KETAPANG, KOTAWARINGIN TIMUR, KALIMANTAN TENGAH",9,83,160,243
https://kawalpemilu.org#60541,"MENTAWA BARU HILIR, MENTAWA BARU KETAPANG, KOTAWARINGIN TIMUR, KALIMANTAN TENGAH",10,61,132,193
https://kawalpemilu.org#60541,"MENTAWA BARU HILIR, MENTAWA BARU KETAPANG, KOTAWARINGIN TIMUR, KALIMANTAN TENGAH",11,61,153,214
https://kawalpemilu.org#60541,"MENTAWA BARU HILIR, MENTAWA BARU KETAPANG, KOTAWARINGIN TIMUR, KALIMANTAN TENGAH",12,39,145,184
https://kawalpemilu.org#60541,"MENTAWA BARU HILIR, MENTAWA BARU KETAPANG, KOTAWARINGIN TIMUR, KALIMANTAN TENGAH",13,47,191,238
https://kawalpemilu.org#60541,"MENTAWA BARU HILIR, MENTAWA BARU KETAPANG, KOTAWARINGIN TIMUR, KALIMANTAN TENGAH",14,58,63,121
https://kawalpemilu.org#60541,"MENTAWA BARU HILIR, MENTAWA BARU KETAPANG, KOTAWARINGIN TIMUR, KALIMANTAN TENGAH",15,111,113,224
https://kawalpemilu.org#60541,"MENTAWA BARU HILIR, MENTAWA BARU KETAPANG, KOTAWARINGIN TIMUR, KALIMANTAN TENGAH",16,162,94,256
https://kawalpemilu.org#60541,"MENTAWA BARU HILIR, MENTAWA BARU KETAPANG, KOTAWARINGIN TIMUR, KALIMANTAN TENGAH",17,84,107,191
https://kawalpemilu.org#60541,"MENTAWA BARU HILIR, MENTAWA BARU KETAPANG, KOTAWARINGIN TIMUR, KALIMANTAN TENGAH",18,50,114,164
https://kawalpemilu.org#60541,"MENTAWA BARU HILIR, MENTAWA BARU KETAPANG, KOTAWARINGIN TIMUR, KALIMANTAN TENGAH",19,73,116,189
https://kawalpemilu.org#60541,"MENTAWA BARU HILIR, MENTAWA BARU KETAPANG, KOTAWARINGIN TIMUR, KALIMANTAN TENGAH",20,59,113,172
https://kawalpemilu.org#60541,"MENTAWA BARU HILIR, MENTAWA BARU KETAPANG, KOTAWARINGIN TIMUR, KALIMANTAN TENGAH",21,42,116,158
https://kawalpemilu.org#60541,"MENTAWA BARU HILIR, MENTAWA BARU KETAPANG, KOTAWARINGIN TIMUR, KALIMANTAN TENGAH",22,114,134,248
https://kawalpemilu.org#60541,"MENTAWA BARU HILIR, MENTAWA BARU KETAPANG, KOTAWARINGIN TIMUR, KALIMANTAN TENGAH",23,104,128,232
https://kawalpemilu.org#60541,"MENTAWA BARU HILIR, MENTAWA BARU KETAPANG, KOTAWARINGIN TIMUR, KALIMANTAN TENGAH",24,88,138,226
https://kawalpemilu.org#60541,"MENTAWA BARU HILIR, MENTAWA BARU KETAPANG, KOTAWARINGIN TIMUR, KALIMANTAN TENGAH",25,83,74,157
https://kawalpemilu.org#60541,"MENTAWA BARU HILIR, MENTAWA BARU KETAPANG, KOTAWARINGIN TIMUR, KALIMANTAN TENGAH",26,100,135,235
https://kawalpemilu.org#60541,"MENTAWA BARU HILIR, MENTAWA BARU KETAPANG, KOTAWARINGIN TIMUR, KALIMANTAN TENGAH",27,106,114,220
https://kawalpemilu.org#60541,"MENTAWA BARU HILIR, MENTAWA BARU KETAPANG, KOTAWARINGIN TIMUR, KALIMANTAN TENGAH",28,117,128,245
https://kawalpemilu.org#60541,"MENTAWA BARU HILIR, MENTAWA BARU KETAPANG, KOTAWARINGIN TIMUR, KALIMANTAN TENGAH",29,21,151,172
https://kawalpemilu.org#60541,"MENTAWA BARU HILIR, MENTAWA BARU KETAPANG, KOTAWARINGIN TIMUR, KALIMANTAN TENGAH",30,117,131,248
https://kawalpemilu.org#60541,"MENTAWA BARU HILIR, MENTAWA BARU KETAPANG, KOTAWARINGIN TIMUR, KALIMANTAN TENGAH",31,66,174,240
https://kawalpemilu.org#60541,"MENTAWA BARU HILIR, MENTAWA BARU KETAPANG, KOTAWARINGIN TIMUR, KALIMANTAN TENGAH",32,43,68,111
https://kawalpemilu.org#60541,"MENTAWA BARU HILIR, MENTAWA BARU KETAPANG, KOTAWARINGIN TIMUR, KALIMANTAN TENGAH",33,99,134,233
https://kawalpemilu.org#60541,"MENTAWA BARU HILIR, MENTAWA BARU KETAPANG, KOTAWARINGIN TIMUR, KALIMANTAN TENGAH",34,73,131,204
https://kawalpemilu.org#60541,"MENTAWA BARU HILIR, MENTAWA BARU KETAPANG, KOTAWARINGIN TIMUR, KALIMANTAN TENGAH",35,86,136,222
https://kawalpemilu.org#60541,"MENTAWA BARU HILIR, MENTAWA BARU KETAPANG, KOTAWARINGIN TIMUR, KALIMANTAN TENGAH",36,46,178,224
https://kawalpemilu.org#60541,"MENTAWA BARU HILIR, MENTAWA BARU KETAPANG, KOTAWARINGIN TIMUR, KALIMANTAN TENGAH",37,42,142,184
https://kawalpemilu.org#60541,"MENTAWA BARU HILIR, MENTAWA BARU KETAPANG, KOTAWARINGIN TIMUR, KALIMANTAN TENGAH",38,39,135,174
https://kawalpemilu.org#60541,"MENTAWA BARU HILIR, MENTAWA BARU KETAPANG, KOTAWARINGIN TIMUR, KALIMANTAN TENGAH",39,35,71,106
https://kawalpemilu.org#60541,"MENTAWA BARU HILIR, MENTAWA BARU KETAPANG, KOTAWARINGIN TIMUR, KALIMANTAN TENGAH",40,82,179,261
https://kawalpemilu.org#60541,"MENTAWA BARU HILIR, MENTAWA BARU KETAPANG, KOTAWARINGIN TIMUR, KALIMANTAN TENGAH",41,92,116,208
https://kawalpemilu.org#60541,"MENTAWA BARU HILIR, MENTAWA BARU KETAPANG, KOTAWARINGIN TIMUR, KALIMANTAN TENGAH",42,36,146,182
https://kawalpemilu.org#60541,"MENTAWA BARU HILIR, MENTAWA BARU KETAPANG, KOTAWARINGIN TIMUR, KALIMANTAN TENGAH",43,43,122,165
https://kawalpemilu.org#60541,"MENTAWA BARU HILIR, MENTAWA BARU KETAPANG, KOTAWARINGIN TIMUR, KALIMANTAN TENGAH",44,33,120,153
https://kawalpemilu.org#60541,"MENTAWA BARU HILIR, MENTAWA BARU KETAPANG, KOTAWARINGIN TIMUR, KALIMANTAN TENGAH",45,66,72,138
https://kawalpemilu.org#60541,"MENTAWA BARU HILIR, MENTAWA BARU KETAPANG, KOTAWARINGIN TIMUR, KALIMANTAN TENGAH",46,68,223,291
https://kawalpemilu.org#60541,"MENTAWA BARU HILIR, MENTAWA BARU KETAPANG, KOTAWARINGIN TIMUR, KALIMANTAN TENGAH",47,44,210,254
https://kawalpemilu.org#60541,"MENTAWA BARU HILIR, MENTAWA BARU KETAPANG, KOTAWARINGIN TIMUR, KALIMANTAN TENGAH",48,104,164,268
https://kawalpemilu.org#60541,"MENTAWA BARU HILIR, MENTAWA BARU KETAPANG, KOTAWARINGIN TIMUR, KALIMANTAN TENGAH",49,77,89,166
https://kawalpemilu.org#60541,"MENTAWA BARU HILIR, MENTAWA BARU KETAPANG, KOTAWARINGIN TIMUR, KALIMANTAN TENGAH",50,83,160,243
https://kawalpemilu.org#60541,"MENTAWA BARU HILIR, MENTAWA BARU KETAPANG, KOTAWARINGIN TIMUR, KALIMANTAN TENGAH",51,48,57,105
https://kawalpemilu.org#60541,"MENTAWA BARU HILIR, MENTAWA BARU KETAPANG, KOTAWARINGIN TIMUR, KALIMANTAN TENGAH",52,56,133,189
https://kawalpemilu.org#60541,"MENTAWA BARU HILIR, MENTAWA BARU KETAPANG, KOTAWARINGIN TIMUR, KALIMANTAN TENGAH",53,28,108,136
https://kawalpemilu.org#60541,"MENTAWA BARU HILIR, MENTAWA BARU KETAPANG, KOTAWARINGIN TIMUR, KALIMANTAN TENGAH",54,89,137,226
https://kawalpemilu.org#60541,"MENTAWA BARU HILIR, MENTAWA BARU KETAPANG, KOTAWARINGIN TIMUR, KALIMANTAN TENGAH",55,28,26,54
https://kawalpemilu.org#60541,"MENTAWA BARU HILIR, MENTAWA BARU KETAPANG, KOTAWARINGIN TIMUR, KALIMANTAN TENGAH",56,36,115,151
https://kawalpemilu.org#60541,"MENTAWA BARU HILIR, MENTAWA BARU KETAPANG, KOTAWARINGIN TIMUR, KALIMANTAN TENGAH",57,71,89,160
https://kawalpemilu.org#60541,"MENTAWA BARU HILIR, MENTAWA BARU KETAPANG, KOTAWARINGIN TIMUR, KALIMANTAN TENGAH",58,53,124,177
https://kawalpemilu.org#60541,"MENTAWA BARU HILIR, MENTAWA BARU KETAPANG, KOTAWARINGIN TIMUR, KALIMANTAN TENGAH",59,80,85,165
https://kawalpemilu.org#60541,"MENTAWA BARU HILIR, MENTAWA BARU KETAPANG, KOTAWARINGIN TIMUR, KALIMANTAN TENGAH",60,67,153,220
https://kawalpemilu.org#60541,"MENTAWA BARU HILIR, MENTAWA BARU KETAPANG, KOTAWARINGIN TIMUR, KALIMANTAN TENGAH",61,35,123,158
https://kawalpemilu.org#60541,"MENTAWA BARU HILIR, MENTAWA BARU KETAPANG, KOTAWARINGIN TIMUR, KALIMANTAN TENGAH",62,69,55,124
https://kawalpemilu.org#60541,"MENTAWA BARU HILIR, MENTAWA BARU KETAPANG, KOTAWARINGIN TIMUR, KALIMANTAN TENGAH",63,98,146,244
https://kawalpemilu.org#60542,"KETAPANG, MENTAWA BARU KETAPANG, KOTAWARINGIN TIMUR, KALIMANTAN TENGAH",1,64,163,227
https://kawalpemilu.org#60542,"KETAPANG, MENTAWA BARU KETAPANG, KOTAWARINGIN TIMUR, KALIMANTAN TENGAH",2,59,75,134
https://kawalpemilu.org#60542,"KETAPANG, MENTAWA BARU KETAPANG, KOTAWARINGIN TIMUR, KALIMANTAN TENGAH",3,41,151,192
https://kawalpemilu.org#60542,"KETAPANG, MENTAWA BARU KETAPANG, KOTAWARINGIN TIMUR, KALIMANTAN TENGAH",4,31,89,120
https://kawalpemilu.org#60542,"KETAPANG, MENTAWA BARU KETAPANG, KOTAWARINGIN TIMUR, KALIMANTAN TENGAH",5,46,162,208
https://kawalpemilu.org#60542,"KETAPANG, MENTAWA BARU KETAPANG, KOTAWARINGIN TIMUR, KALIMANTAN TENGAH",6,145,142,287
https://kawalpemilu.org#60542,"KETAPANG, MENTAWA BARU KETAPANG, KOTAWARINGIN TIMUR, KALIMANTAN TENGAH",7,59,80,139
https://kawalpemilu.org#60542,"KETAPANG, MENTAWA BARU KETAPANG, KOTAWARINGIN TIMUR, KALIMANTAN TENGAH",8,24,98,122
https://kawalpemilu.org#60542,"KETAPANG, MENTAWA BARU KETAPANG, KOTAWARINGIN TIMUR, KALIMANTAN TENGAH",9,119,148,267
https://kawalpemilu.org#60542,"KETAPANG, MENTAWA BARU KETAPANG, KOTAWARINGIN TIMUR, KALIMANTAN TENGAH",10,18,52,70
https://kawalpemilu.org#60542,"KETAPANG, MENTAWA BARU KETAPANG, KOTAWARINGIN TIMUR, KALIMANTAN TENGAH",11,62,116,178
https://kawalpemilu.org#60542,"KETAPANG, MENTAWA BARU KETAPANG, KOTAWARINGIN TIMUR, KALIMANTAN TENGAH",12,44,92,36
https://kawalpemilu.org#60542,"KETAPANG, MENTAWA BARU KETAPANG, KOTAWARINGIN TIMUR, KALIMANTAN TENGAH",13,30,41,71
https://kawalpemilu.org#60542,"KETAPANG, MENTAWA BARU KETAPANG, KOTAWARINGIN TIMUR, KALIMANTAN TENGAH",14,90,171,261
https://kawalpemilu.org#60542,"KETAPANG, MENTAWA BARU KETAPANG, KOTAWARINGIN TIMUR, KALIMANTAN TENGAH",15,85,157,242
https://kawalpemilu.org#60542,"KETAPANG, MENTAWA BARU KETAPANG, KOTAWARINGIN TIMUR, KALIMANTAN TENGAH",16,86,143,229
https://kawalpemilu.org#60542,"KETAPANG, MENTAWA BARU KETAPANG, KOTAWARINGIN TIMUR, KALIMANTAN TENGAH",17,77,122,199
https://kawalpemilu.org#60542,"KETAPANG, MENTAWA BARU KETAPANG, KOTAWARINGIN TIMUR, KALIMANTAN TENGAH",18,58,90,148
https://kawalpemilu.org#60542,"KETAPANG, MENTAWA BARU KETAPANG, KOTAWARINGIN TIMUR, KALIMANTAN TENGAH",19,28,52,80
https://kawalpemilu.org#60542,"KETAPANG, MENTAWA BARU KETAPANG, KOTAWARINGIN TIMUR, KALIMANTAN TENGAH",20,43,70,113
https://kawalpemilu.org#60542,"KETAPANG, MENTAWA BARU KETAPANG, KOTAWARINGIN TIMUR, KALIMANTAN TENGAH",21,75,106,181
https://kawalpemilu.org#60542,"KETAPANG, MENTAWA BARU KETAPANG, KOTAWARINGIN TIMUR, KALIMANTAN TENGAH",22,58,68,126
https://kawalpemilu.org#60542,"KETAPANG, MENTAWA BARU KETAPANG, KOTAWARINGIN TIMUR, KALIMANTAN TENGAH",23,51,71,122
https://kawalpemilu.org#60542,"KETAPANG, MENTAWA BARU KETAPANG, KOTAWARINGIN TIMUR, KALIMANTAN TENGAH",24,79,143,222
https://kawalpemilu.org#60542,"KETAPANG, MENTAWA BARU KETAPANG, KOTAWARINGIN TIMUR, KALIMANTAN TENGAH",25,54,104,158
https://kawalpemilu.org#60542,"KETAPANG, MENTAWA BARU KETAPANG, KOTAWARINGIN TIMUR, KALIMANTAN TENGAH",26,35,89,128
https://kawalpemilu.org#60542,"KETAPANG, MENTAWA BARU KETAPANG, KOTAWARINGIN TIMUR, KALIMANTAN TENGAH",27,55,76,131
https://kawalpemilu.org#60542,"KETAPANG, MENTAWA BARU KETAPANG, KOTAWARINGIN TIMUR, KALIMANTAN TENGAH",28,94,91,185
https://kawalpemilu.org#60542,"KETAPANG, MENTAWA BARU KETAPANG, KOTAWARINGIN TIMUR, KALIMANTAN TENGAH",29,71,141,212
https://kawalpemilu.org#60542,"KETAPANG, MENTAWA BARU KETAPANG, KOTAWARINGIN TIMUR, KALIMANTAN TENGAH",30,57,99,156
https://kawalpemilu.org#60542,"KETAPANG, MENTAWA BARU KETAPANG, KOTAWARINGIN TIMUR, KALIMANTAN TENGAH",31,41,61,102
https://kawalpemilu.org#60542,"KETAPANG, MENTAWA BARU KETAPANG, KOTAWARINGIN TIMUR, KALIMANTAN TENGAH",32,67,86,153
https://kawalpemilu.org#60542,"KETAPANG, MENTAWA BARU KETAPANG, KOTAWARINGIN TIMUR, KALIMANTAN TENGAH",33,17,36,53
https://kawalpemilu.org#60542,"KETAPANG, MENTAWA BARU KETAPANG, KOTAWARINGIN TIMUR, KALIMANTAN TENGAH",34,47,101,148
https://kawalpemilu.org#60542,"KETAPANG, MENTAWA BARU KETAPANG, KOTAWARINGIN TIMUR, KALIMANTAN TENGAH",35,46,104,150
https://kawalpemilu.org#60542,"KETAPANG, MENTAWA BARU KETAPANG, KOTAWARINGIN TIMUR, KALIMANTAN TENGAH",36,84,170,254
https://kawalpemilu.org#60542,"KETAPANG, MENTAWA BARU KETAPANG, KOTAWARINGIN TIMUR, KALIMANTAN TENGAH",37,90,144,234
https://kawalpemilu.org#60542,"KETAPANG, MENTAWA BARU KETAPANG, KOTAWARINGIN TIMUR, KALIMANTAN TENGAH",38,45,137,182
https://kawalpemilu.org#60542,"KETAPANG, MENTAWA BARU KETAPANG, KOTAWARINGIN TIMUR, KALIMANTAN TENGAH",39,46,117,163
https://kawalpemilu.org#60542,"KETAPANG, MENTAWA BARU KETAPANG, KOTAWARINGIN TIMUR, KALIMANTAN TENGAH",40,29,25,54
https://kawalpemilu.org#60542,"KETAPANG, MENTAWA BARU KETAPANG, KOTAWARINGIN TIMUR, KALIMANTAN TENGAH",41,46,172,218
https://kawalpemilu.org#60542,"KETAPANG, MENTAWA BARU KETAPANG, KOTAWARINGIN TIMUR, KALIMANTAN TENGAH",42,56,92,148
https://kawalpemilu.org#60542,"KETAPANG, MENTAWA BARU KETAPANG, KOTAWARINGIN TIMUR, KALIMANTAN TENGAH",43,57,119,176
https://kawalpemilu.org#60542,"KETAPANG, MENTAWA BARU KETAPANG, KOTAWARINGIN TIMUR, KALIMANTAN TENGAH",44,81,172,253
https://kawalpemilu.org#60542,"KETAPANG, MENTAWA BARU KETAPANG, KOTAWARINGIN TIMUR, KALIMANTAN TENGAH",45,30,147,177
https://kawalpemilu.org#60542,"KETAPANG, MENTAWA BARU KETAPANG, KOTAWARINGIN TIMUR, KALIMANTAN TENGAH",46,49,81,130
https://kawalpemilu.org#60542,"KETAPANG, MENTAWA BARU KETAPANG, KOTAWARINGIN TIMUR, KALIMANTAN TENGAH",47,43,81,124
https://kawalpemilu.org#60542,"KETAPANG, MENTAWA BARU KETAPANG, KOTAWARINGIN TIMUR, KALIMANTAN TENGAH",48,53,140,193
https://kawalpemilu.org#60542,"KETAPANG, MENTAWA BARU KETAPANG, KOTAWARINGIN TIMUR, KALIMANTAN TENGAH",49,39,62,101
https://kawalpemilu.org#60542,"KETAPANG, MENTAWA BARU KETAPANG, KOTAWARINGIN TIMUR, KALIMANTAN TENGAH",50,54,84,138
https://kawalpemilu.org#60542,"KETAPANG, MENTAWA BARU KETAPANG, KOTAWARINGIN TIMUR, KALIMANTAN TENGAH",51,88,130,218
https://kawalpemilu.org#60542,"KETAPANG, MENTAWA BARU KETAPANG, KOTAWARINGIN TIMUR, KALIMANTAN TENGAH",52,69,100,169
https://kawalpemilu.org#60542,"KETAPANG, MENTAWA BARU KETAPANG, KOTAWARINGIN TIMUR, KALIMANTAN TENGAH",53,79,76,155
https://kawalpemilu.org#60542,"KETAPANG, MENTAWA BARU KETAPANG, KOTAWARINGIN TIMUR, KALIMANTAN TENGAH",54,114,137,251
https://kawalpemilu.org#60542,"KETAPANG, MENTAWA BARU KETAPANG, KOTAWARINGIN TIMUR, KALIMANTAN TENGAH",55,29,39,68
https://kawalpemilu.org#60542,"KETAPANG, MENTAWA BARU KETAPANG, KOTAWARINGIN TIMUR, KALIMANTAN TENGAH",56,54,42,96
https://kawalpemilu.org#60542,"KETAPANG, MENTAWA BARU KETAPANG, KOTAWARINGIN TIMUR, KALIMANTAN TENGAH",57,62,69,131
https://kawalpemilu.org#60542,"KETAPANG, MENTAWA BARU KETAPANG, KOTAWARINGIN TIMUR, KALIMANTAN TENGAH",58,121,179,300
https://kawalpemilu.org#60542,"KETAPANG, MENTAWA BARU KETAPANG, KOTAWARINGIN TIMUR, KALIMANTAN TENGAH",59,46,50,96
https://kawalpemilu.org#60542,"KETAPANG, MENTAWA BARU KETAPANG, KOTAWARINGIN TIMUR, KALIMANTAN TENGAH",60,88,73,161
https://kawalpemilu.org#60542,"KETAPANG, MENTAWA BARU KETAPANG, KOTAWARINGIN TIMUR, KALIMANTAN TENGAH",61,54,75,129
https://kawalpemilu.org#60542,"KETAPANG, MENTAWA BARU KETAPANG, KOTAWARINGIN TIMUR, KALIMANTAN TENGAH",62,76,56,132
https://kawalpemilu.org#60542,"KETAPANG, MENTAWA BARU KETAPANG, KOTAWARINGIN TIMUR, KALIMANTAN TENGAH",63,139,96,235
https://kawalpemilu.org#60542,"KETAPANG, MENTAWA BARU KETAPANG, KOTAWARINGIN TIMUR, KALIMANTAN TENGAH",64,89,61,150
https://kawalpemilu.org#60542,"KETAPANG, MENTAWA BARU KETAPANG, KOTAWARINGIN TIMUR, KALIMANTAN TENGAH",65,77,29,106
https://kawalpemilu.org#60542,"KETAPANG, MENTAWA BARU KETAPANG, KOTAWARINGIN TIMUR, KALIMANTAN TENGAH",66,74,88,162
https://kawalpemilu.org#60542,"KETAPANG, MENTAWA BARU KETAPANG, KOTAWARINGIN TIMUR, KALIMANTAN TENGAH",67,54,37,91
https://kawalpemilu.org#60542,"KETAPANG, MENTAWA BARU KETAPANG, KOTAWARINGIN TIMUR, KALIMANTAN TENGAH",68,71,104,175
https://kawalpemilu.org#60542,"KETAPANG, MENTAWA BARU KETAPANG, KOTAWARINGIN TIMUR, KALIMANTAN TENGAH",69,71,101,172
https://kawalpemilu.org#60542,"KETAPANG, MENTAWA BARU KETAPANG, KOTAWARINGIN TIMUR, KALIMANTAN TENGAH",70,82,122,204
https://kawalpemilu.org#60542,"KETAPANG, MENTAWA BARU KETAPANG, KOTAWARINGIN TIMUR, KALIMANTAN TENGAH",71,74,98,172
https://kawalpemilu.org#60542,"KETAPANG, MENTAWA BARU KETAPANG, KOTAWARINGIN TIMUR, KALIMANTAN TENGAH",72,40,99,139
https://kawalpemilu.org#60542,"KETAPANG, MENTAWA BARU KETAPANG, KOTAWARINGIN TIMUR, KALIMANTAN TENGAH",73,35,126,161
https://kawalpemilu.org#60542,"KETAPANG, MENTAWA BARU KETAPANG, KOTAWARINGIN TIMUR, KALIMANTAN TENGAH",74,86,107,193
https://kawalpemilu.org#60542,"KETAPANG, MENTAWA BARU KETAPANG, KOTAWARINGIN TIMUR, KALIMANTAN TENGAH",75,46,89,135
https://kawalpemilu.org#60542,"KETAPANG, MENTAWA BARU KETAPANG, KOTAWARINGIN TIMUR, KALIMANTAN TENGAH",76,66,104,170
https://kawalpemilu.org#60543,"SAWAHAN, MENTAWA BARU KETAPANG, KOTAWARINGIN TIMUR, KALIMANTAN TENGAH",1,44,122,166
https://kawalpemilu.org#60543,"SAWAHAN, MENTAWA BARU KETAPANG, KOTAWARINGIN TIMUR, KALIMANTAN TENGAH",2,48,156,204
https://kawalpemilu.org#60543,"SAWAHAN, MENTAWA BARU KETAPANG, KOTAWARINGIN TIMUR, KALIMANTAN TENGAH",3,72,106,178
https://kawalpemilu.org#60543,"SAWAHAN, MENTAWA BARU KETAPANG, KOTAWARINGIN TIMUR, KALIMANTAN TENGAH",4,83,130,213
https://kawalpemilu.org#60543,"SAWAHAN, MENTAWA BARU KETAPANG, KOTAWARINGIN TIMUR, KALIMANTAN TENGAH",5,68,64,132
https://kawalpemilu.org#60543,"SAWAHAN, MENTAWA BARU KETAPANG, KOTAWARINGIN TIMUR, KALIMANTAN TENGAH",6,18,54,72
https://kawalpemilu.org#60543,"SAWAHAN, MENTAWA BARU KETAPANG, KOTAWARINGIN TIMUR, KALIMANTAN TENGAH",7,28,56,84
https://kawalpemilu.org#60543,"SAWAHAN, MENTAWA BARU KETAPANG, KOTAWARINGIN TIMUR, KALIMANTAN TENGAH",8,83,132,215
https://kawalpemilu.org#60543,"SAWAHAN, MENTAWA BARU KETAPANG, KOTAWARINGIN TIMUR, KALIMANTAN TENGAH",9,31,106,137
https://kawalpemilu.org#60543,"SAWAHAN, MENTAWA BARU KETAPANG, KOTAWARINGIN TIMUR, KALIMANTAN TENGAH",10,75,122,197
https://kawalpemilu.org#60543,"SAWAHAN, MENTAWA BARU KETAPANG, KOTAWARINGIN TIMUR, KALIMANTAN TENGAH",11,29,84,113
https://kawalpemilu.org#60543,"SAWAHAN, MENTAWA BARU KETAPANG, KOTAWARINGIN TIMUR, KALIMANTAN TENGAH",12,56,163,219
https://kawalpemilu.org#60543,"SAWAHAN, MENTAWA BARU KETAPANG, KOTAWARINGIN TIMUR, KALIMANTAN TENGAH",13,25,123,148
https://kawalpemilu.org#60543,"SAWAHAN, MENTAWA BARU KETAPANG, KOTAWARINGIN TIMUR, KALIMANTAN TENGAH",14,42,88,130
https://kawalpemilu.org#60543,"SAWAHAN, MENTAWA BARU KETAPANG, KOTAWARINGIN TIMUR, KALIMANTAN TENGAH",15,68,161,229
https://kawalpemilu.org#60543,"SAWAHAN, MENTAWA BARU KETAPANG, KOTAWARINGIN TIMUR, KALIMANTAN TENGAH",16,31,103,134
https://kawalpemilu.org#60543,"SAWAHAN, MENTAWA BARU KETAPANG, KOTAWARINGIN TIMUR, KALIMANTAN TENGAH",17,58,123,181
https://kawalpemilu.org#60543,"SAWAHAN, MENTAWA BARU KETAPANG, KOTAWARINGIN TIMUR, KALIMANTAN TENGAH",18,57,184,241
https://kawalpemilu.org#60543,"SAWAHAN, MENTAWA BARU KETAPANG, KOTAWARINGIN TIMUR, KALIMANTAN TENGAH",19,62,124,186
https://kawalpemilu.org#60543,"SAWAHAN, MENTAWA BARU KETAPANG, KOTAWARINGIN TIMUR, KALIMANTAN TENGAH",20,6,13,19
https://kawalpemilu.org#60543,"SAWAHAN, MENTAWA BARU KETAPANG, KOTAWARINGIN TIMUR, KALIMANTAN TENGAH",21,37,39,76
https://kawalpemilu.org#60543,"SAWAHAN, MENTAWA BARU KETAPANG, KOTAWARINGIN TIMUR, KALIMANTAN TENGAH",22,30,91,121
https://kawalpemilu.org#60543,"SAWAHAN, MENTAWA BARU KETAPANG, KOTAWARINGIN TIMUR, KALIMANTAN TENGAH",23,41,132,173
https://kawalpemilu.org#60543,"SAWAHAN, MENTAWA BARU KETAPANG, KOTAWARINGIN TIMUR, KALIMANTAN TENGAH",24,23,117,140
https://kawalpemilu.org#60543,"SAWAHAN, MENTAWA BARU KETAPANG, KOTAWARINGIN TIMUR, KALIMANTAN TENGAH",25,30,124,154
https://kawalpemilu.org#60543,"SAWAHAN, MENTAWA BARU KETAPANG, KOTAWARINGIN TIMUR, KALIMANTAN TENGAH",26,31,115,146
https://kawalpemilu.org#60543,"SAWAHAN, MENTAWA BARU KETAPANG, KOTAWARINGIN TIMUR, KALIMANTAN TENGAH",27,92,172,264
https://kawalpemilu.org#60544,"PASIR PUTIH, MENTAWA BARU KETAPANG, KOTAWARINGIN TIMUR, KALIMANTAN TENGAH",1,102,96,197
https://kawalpemilu.org#60544,"PASIR PUTIH, MENTAWA BARU KETAPANG, KOTAWARINGIN TIMUR, KALIMANTAN TENGAH",2,80,29,109
https://kawalpemilu.org#60544,"PASIR PUTIH, MENTAWA BARU KETAPANG, KOTAWARINGIN TIMUR, KALIMANTAN TENGAH",3,158,64,222
https://kawalpemilu.org#60544,"PASIR PUTIH, MENTAWA BARU KETAPANG, KOTAWARINGIN TIMUR, KALIMANTAN TENGAH",4,96,67,163
https://kawalpemilu.org#60544,"PASIR PUTIH, MENTAWA BARU KETAPANG, KOTAWARINGIN TIMUR, KALIMANTAN TENGAH",5,128,90,218
https://kawalpemilu.org#60544,"PASIR PUTIH, MENTAWA BARU KETAPANG, KOTAWARINGIN TIMUR, KALIMANTAN TENGAH",6,78,95,173
https://kawalpemilu.org#60544,"PASIR PUTIH, MENTAWA BARU KETAPANG, KOTAWARINGIN TIMUR, KALIMANTAN TENGAH",7,103,58,161
https://kawalpemilu.org#60544,"PASIR PUTIH, MENTAWA BARU KETAPANG, KOTAWARINGIN TIMUR, KALIMANTAN TENGAH",8,168,83,251
https://kawalpemilu.org#60544,"PASIR PUTIH, MENTAWA BARU KETAPANG, KOTAWARINGIN TIMUR, KALIMANTAN TENGAH",9,76,48,124
https://kawalpemilu.org#60544,"PASIR PUTIH, MENTAWA BARU KETAPANG, KOTAWARINGIN TIMUR, KALIMANTAN TENGAH",10,134,115,249
https://kawalpemilu.org#60544,"PASIR PUTIH, MENTAWA BARU KETAPANG, KOTAWARINGIN TIMUR, KALIMANTAN TENGAH",11,86,24,110
https://kawalpemilu.org#60544,"PASIR PUTIH, MENTAWA BARU KETAPANG, KOTAWARINGIN TIMUR, KALIMANTAN TENGAH",12,108,19,127
https://kawalpemilu.org#60544,"PASIR PUTIH, MENTAWA BARU KETAPANG, KOTAWARINGIN TIMUR, KALIMANTAN TENGAH",13,158,29,187
https://kawalpemilu.org#60544,"PASIR PUTIH, MENTAWA BARU KETAPANG, KOTAWARINGIN TIMUR, KALIMANTAN TENGAH",14,169,28,197
https://kawalpemilu.org#60544,"PASIR PUTIH, MENTAWA BARU KETAPANG, KOTAWARINGIN TIMUR, KALIMANTAN TENGAH",15,103,26,129
https://kawalpemilu.org#60544,"PASIR PUTIH, MENTAWA BARU KETAPANG, KOTAWARINGIN TIMUR, KALIMANTAN TENGAH",16,156,24,180
https://kawalpemilu.org#60545,"PELANGSIAN, MENTAWA BARU KETAPANG, KOTAWARINGIN TIMUR, KALIMANTAN TENGAH",1,64,110,174
https://kawalpemilu.org#60545,"PELANGSIAN, MENTAWA BARU KETAPANG, KOTAWARINGIN TIMUR, KALIMANTAN TENGAH",2,61,113,174
https://kawalpemilu.org#60545,"PELANGSIAN, MENTAWA BARU KETAPANG, KOTAWARINGIN TIMUR, KALIMANTAN TENGAH",3,79,100,179
https://kawalpemilu.org#60545,"PELANGSIAN, MENTAWA BARU KETAPANG, KOTAWARINGIN TIMUR, KALIMANTAN TENGAH",4,50,95,145
https://kawalpemilu.org#60545,"PELANGSIAN, MENTAWA BARU KETAPANG, KOTAWARINGIN TIMUR, KALIMANTAN TENGAH",5,89,87,176
https://kawalpemilu.org#60545,"PELANGSIAN, MENTAWA BARU KETAPANG, KOTAWARINGIN TIMUR, KALIMANTAN TENGAH",6,95,100,195
https://kawalpemilu.org#60545,"PELANGSIAN, MENTAWA BARU KETAPANG, KOTAWARINGIN TIMUR, KALIMANTAN TENGAH",7,74,88,162
https://kawalpemilu.org#60545,"PELANGSIAN, MENTAWA BARU KETAPANG, KOTAWARINGIN TIMUR, KALIMANTAN TENGAH",8,52,35,87
https://kawalpemilu.org#60545,"PELANGSIAN, MENTAWA BARU KETAPANG, KOTAWARINGIN TIMUR, KALIMANTAN TENGAH",9,70,128,198
https://kawalpemilu.org#60545,"PELANGSIAN, MENTAWA BARU KETAPANG, KOTAWARINGIN TIMUR, KALIMANTAN TENGAH",10,35,135,170
https://kawalpemilu.org#60545,"PELANGSIAN, MENTAWA BARU KETAPANG, KOTAWARINGIN TIMUR, KALIMANTAN TENGAH",11,75,32,107
https://kawalpemilu.org#60545,"PELANGSIAN, MENTAWA BARU KETAPANG, KOTAWARINGIN TIMUR, KALIMANTAN TENGAH",12,80,95,175
https://kawalpemilu.org#60545,"PELANGSIAN, MENTAWA BARU KETAPANG, KOTAWARINGIN TIMUR, KALIMANTAN TENGAH",13,80,46,126
https://kawalpemilu.org#60545,"PELANGSIAN, MENTAWA BARU KETAPANG, KOTAWARINGIN TIMUR, KALIMANTAN TENGAH",14,51,38,89
https://kawalpemilu.org#60546,"BAPEANG, MENTAWA BARU KETAPANG, KOTAWARINGIN TIMUR, KALIMANTAN TENGAH",1,156,50,206
https://kawalpemilu.org#60546,"BAPEANG, MENTAWA BARU KETAPANG, KOTAWARINGIN TIMUR, KALIMANTAN TENGAH",2,102,40,142
https://kawalpemilu.org#60546,"BAPEANG, MENTAWA BARU KETAPANG, KOTAWARINGIN TIMUR, KALIMANTAN TENGAH",3,91,66,157
https://kawalpemilu.org#60546,"BAPEANG, MENTAWA BARU KETAPANG, KOTAWARINGIN TIMUR, KALIMANTAN TENGAH",4,89,89,178
https://kawalpemilu.org#60546,"BAPEANG, MENTAWA BARU KETAPANG, KOTAWARINGIN TIMUR, KALIMANTAN TENGAH",5,139,89,228
https://kawalpemilu.org#60546,"BAPEANG, MENTAWA BARU KETAPANG, KOTAWARINGIN TIMUR, KALIMANTAN TENGAH",6,91,125,216
https://kawalpemilu.org#60546,"BAPEANG, MENTAWA BARU KETAPANG, KOTAWARINGIN TIMUR, KALIMANTAN TENGAH",7,99,93,192
https://kawalpemilu.org#60546,"BAPEANG, MENTAWA BARU KETAPANG, KOTAWARINGIN TIMUR, KALIMANTAN TENGAH",8,79,149,228
https://kawalpemilu.org#60547,"EKA BAHURUI, MENTAWA BARU KETAPANG, KOTAWARINGIN TIMUR, KALIMANTAN TENGAH",1,105,79,184
https://kawalpemilu.org#60547,"EKA BAHURUI, MENTAWA BARU KETAPANG, KOTAWARINGIN TIMUR, KALIMANTAN TENGAH",2,105,91,196
https://kawalpemilu.org#60547,"EKA BAHURUI, MENTAWA BARU KETAPANG, KOTAWARINGIN TIMUR, KALIMANTAN TENGAH",3,82,91,173
https://kawalpemilu.org#60547,"EKA BAHURUI, MENTAWA BARU KETAPANG, KOTAWARINGIN TIMUR, KALIMANTAN TENGAH",4,102,66,168
https://kawalpemilu.org#60547,"EKA BAHURUI, MENTAWA BARU KETAPANG, KOTAWARINGIN TIMUR, KALIMANTAN TENGAH",5,114,85,199
https://kawalpemilu.org#60547,"EKA BAHURUI, MENTAWA BARU KETAPANG, KOTAWARINGIN TIMUR, KALIMANTAN TENGAH",6,96,51,147
https://kawalpemilu.org#60547,"EKA BAHURUI, MENTAWA BARU KETAPANG, KOTAWARINGIN TIMUR, KALIMANTAN TENGAH",7,63,62,125
https://kawalpemilu.org#60547,"EKA BAHURUI, MENTAWA BARU KETAPANG, KOTAWARINGIN TIMUR, KALIMANTAN TENGAH",8,67,68,135
https://kawalpemilu.org#60547,"EKA BAHURUI, MENTAWA BARU KETAPANG, KOTAWARINGIN TIMUR, KALIMANTAN TENGAH",9,87,50,137
https://kawalpemilu.org#85366,"BENGKUANG MAKMUR, MENTAWA BARU KETAPANG, KOTAWARINGIN TIMUR, KALIMANTAN TENGAH",1,135,71,206
https://kawalpemilu.org#85366,"BENGKUANG MAKMUR, MENTAWA BARU KETAPANG, KOTAWARINGIN TIMUR, KALIMANTAN TENGAH",2,70,81,151
https://kawalpemilu.org#85366,"BENGKUANG MAKMUR, MENTAWA BARU KETAPANG, KOTAWARINGIN TIMUR, KALIMANTAN TENGAH",3,77,96,173
https://kawalpemilu.org#85366,"BENGKUANG MAKMUR, MENTAWA BARU KETAPANG, KOTAWARINGIN TIMUR, KALIMANTAN TENGAH",4,155,60,215
https://kawalpemilu.org#85366,"BENGKUANG MAKMUR, MENTAWA BARU KETAPANG, KOTAWARINGIN TIMUR, KALIMANTAN TENGAH",5,107,104,211
https://kawalpemilu.org#85366,"BENGKUANG MAKMUR, MENTAWA BARU KETAPANG, KOTAWARINGIN TIMUR, KALIMANTAN TENGAH",6,79,69,148
https://kawalpemilu.org#85367,"BAPANGGANG RAYA, MENTAWA BARU KETAPANG, KOTAWARINGIN TIMUR, KALIMANTAN TENGAH",1,120,69,189
https://kawalpemilu.org#85367,"BAPANGGANG RAYA, MENTAWA BARU KETAPANG, KOTAWARINGIN TIMUR, KALIMANTAN TENGAH",3,135,78,213
https://kawalpemilu.org#85367,"BAPANGGANG RAYA, MENTAWA BARU KETAPANG, KOTAWARINGIN TIMUR, KALIMANTAN TENGAH",4,145,97,242
https://kawalpemilu.org#88421,"TELAGA BARU, MENTAWA BARU KETAPANG, KOTAWARINGIN TIMUR, KALIMANTAN TENGAH",1,87,153,240
https://kawalpemilu.org#88421,"TELAGA BARU, MENTAWA BARU KETAPANG, KOTAWARINGIN TIMUR, KALIMANTAN TENGAH",2,53,99,152
https://kawalpemilu.org#88421,"TELAGA BARU, MENTAWA BARU KETAPANG, KOTAWARINGIN TIMUR, KALIMANTAN TENGAH",3,63,120,183
https://kawalpemilu.org#88421,"TELAGA BARU, MENTAWA BARU KETAPANG, KOTAWARINGIN TIMUR, KALIMANTAN TENGAH",4,124,99,223
https://kawalpemilu.org#88421,"TELAGA BARU, MENTAWA BARU KETAPANG, KOTAWARINGIN TIMUR, KALIMANTAN TENGAH",5,34,113,147
https://kawalpemilu.org#88421,"TELAGA BARU, MENTAWA BARU KETAPANG, KOTAWARINGIN TIMUR, KALIMANTAN TENGAH",6,55,106,161
https://kawalpemilu.org#88421,"TELAGA BARU, MENTAWA BARU KETAPANG, KOTAWARINGIN TIMUR, KALIMANTAN TENGAH",7,57,79,136
https://kawalpemilu.org#88421,"TELAGA BARU, MENTAWA BARU KETAPANG, KOTAWARINGIN TIMUR, KALIMANTAN TENGAH",8,85,100,185
https://kawalpemilu.org#88421,"TELAGA BARU, MENTAWA BARU KETAPANG, KOTAWARINGIN TIMUR, KALIMANTAN TENGAH",9,66,166,232
https://kawalpemilu.org#60549,"PONDOK DAMAR, MENTAYA HILIR UTARA, KOTAWARINGIN TIMUR, KALIMANTAN TENGAH",1,111,21,132
https://kawalpemilu.org#60549,"PONDOK DAMAR, MENTAYA HILIR UTARA, KOTAWARINGIN TIMUR, KALIMANTAN TENGAH",2,122,35,157
https://kawalpemilu.org#60549,"PONDOK DAMAR, MENTAYA HILIR UTARA, KOTAWARINGIN TIMUR, KALIMANTAN TENGAH",3,96,36,132
https://kawalpemilu.org#60549,"PONDOK DAMAR, MENTAYA HILIR UTARA, KOTAWARINGIN TIMUR, KALIMANTAN TENGAH",4,95,21,116
https://kawalpemilu.org#60549,"PONDOK DAMAR, MENTAYA HILIR UTARA, KOTAWARINGIN TIMUR, KALIMANTAN TENGAH",5,31,5,36
https://kawalpemilu.org#60549,"PONDOK DAMAR, MENTAYA HILIR UTARA, KOTAWARINGIN TIMUR, KALIMANTAN TENGAH",6,68,9,77
https://kawalpemilu.org#60549,"PONDOK DAMAR, MENTAYA HILIR UTARA, KOTAWARINGIN TIMUR, KALIMANTAN TENGAH",7,32,13,45
https://kawalpemilu.org#60549,"PONDOK DAMAR, MENTAYA HILIR UTARA, KOTAWARINGIN TIMUR, KALIMANTAN TENGAH",8,79,9,88
https://kawalpemilu.org#60549,"PONDOK DAMAR, MENTAYA HILIR UTARA, KOTAWARINGIN TIMUR, KALIMANTAN TENGAH",9,71,16,87
https://kawalpemilu.org#60550,"BAGENDANG HILIR, MENTAYA HILIR UTARA, KOTAWARINGIN TIMUR, KALIMANTAN TENGAH",1,91,91,182
https://kawalpemilu.org#60550,"BAGENDANG HILIR, MENTAYA HILIR UTARA, KOTAWARINGIN TIMUR, KALIMANTAN TENGAH",2,103,118,221
https://kawalpemilu.org#60550,"BAGENDANG HILIR, MENTAYA HILIR UTARA, KOTAWARINGIN TIMUR, KALIMANTAN TENGAH",3,85,120,205
https://kawalpemilu.org#60550,"BAGENDANG HILIR, MENTAYA HILIR UTARA, KOTAWARINGIN TIMUR, KALIMANTAN TENGAH",4,32,94,126
https://kawalpemilu.org#60550,"BAGENDANG HILIR, MENTAYA HILIR UTARA, KOTAWARINGIN TIMUR, KALIMANTAN TENGAH",5,63,116,179
https://kawalpemilu.org#60550,"BAGENDANG HILIR, MENTAYA HILIR UTARA, KOTAWARINGIN TIMUR, KALIMANTAN TENGAH",6,64,109,173
https://kawalpemilu.org#60551,"BAGENDANG TENGAH, MENTAYA HILIR UTARA, KOTAWARINGIN TIMUR, KALIMANTAN TENGAH",1,86,62,148
https://kawalpemilu.org#60551,"BAGENDANG TENGAH, MENTAYA HILIR UTARA, KOTAWARINGIN TIMUR, KALIMANTAN TENGAH",2,74,82,156
https://kawalpemilu.org#60551,"BAGENDANG TENGAH, MENTAYA HILIR UTARA, KOTAWARINGIN TIMUR, KALIMANTAN TENGAH",3,80,35,115
https://kawalpemilu.org#60551,"BAGENDANG TENGAH, MENTAYA HILIR UTARA, KOTAWARINGIN TIMUR, KALIMANTAN TENGAH",4,92,58,150
https://kawalpemilu.org#60551,"BAGENDANG TENGAH, MENTAYA HILIR UTARA, KOTAWARINGIN TIMUR, KALIMANTAN TENGAH",5,99,56,155
https://kawalpemilu.org#60551,"BAGENDANG TENGAH, MENTAYA HILIR UTARA, KOTAWARINGIN TIMUR, KALIMANTAN TENGAH",6,70,64,134
https://kawalpemilu.org#60551,"BAGENDANG TENGAH, MENTAYA HILIR UTARA, KOTAWARINGIN TIMUR, KALIMANTAN TENGAH",7,110,41,151
https://kawalpemilu.org#60551,"BAGENDANG TENGAH, MENTAYA HILIR UTARA, KOTAWARINGIN TIMUR, KALIMANTAN TENGAH",8,109,42,151
https://kawalpemilu.org#60552,"NATAI BARU, MENTAYA HILIR UTARA, KOTAWARINGIN TIMUR, KALIMANTAN TENGAH",1,113,62,175
https://kawalpemilu.org#60552,"NATAI BARU, MENTAYA HILIR UTARA, KOTAWARINGIN TIMUR, KALIMANTAN TENGAH",2,64,37,101
https://kawalpemilu.org#60552,"NATAI BARU, MENTAYA HILIR UTARA, KOTAWARINGIN TIMUR, KALIMANTAN TENGAH",3,150,72,222
https://kawalpemilu.org#60552,"NATAI BARU, MENTAYA HILIR UTARA, KOTAWARINGIN TIMUR, KALIMANTAN TENGAH",4,131,60,191
https://kawalpemilu.org#60552,"NATAI BARU, MENTAYA HILIR UTARA, KOTAWARINGIN TIMUR, KALIMANTAN TENGAH",5,59,67,126
https://kawalpemilu.org#60552,"NATAI BARU, MENTAYA HILIR UTARA, KOTAWARINGIN TIMUR, KALIMANTAN TENGAH",6,117,28,145
https://kawalpemilu.org#60552,"NATAI BARU, MENTAYA HILIR UTARA, KOTAWARINGIN TIMUR, KALIMANTAN TENGAH",7,60,11,71
https://kawalpemilu.org#60553,"BAGENDANG HULU, MENTAYA HILIR UTARA, KOTAWARINGIN TIMUR, KALIMANTAN TENGAH",1,85,79,164
https://kawalpemilu.org#60553,"BAGENDANG HULU, MENTAYA HILIR UTARA, KOTAWARINGIN TIMUR, KALIMANTAN TENGAH",2,77,74,151
https://kawalpemilu.org#60553,"BAGENDANG HULU, MENTAYA HILIR UTARA, KOTAWARINGIN TIMUR, KALIMANTAN TENGAH",3,52,46,98
https://kawalpemilu.org#60553,"BAGENDANG HULU, MENTAYA HILIR UTARA, KOTAWARINGIN TIMUR, KALIMANTAN TENGAH",4,54,80,134
https://kawalpemilu.org#60553,"BAGENDANG HULU, MENTAYA HILIR UTARA, KOTAWARINGIN TIMUR, KALIMANTAN TENGAH",5,82,87,169
https://kawalpemilu.org#60553,"BAGENDANG HULU, MENTAYA HILIR UTARA, KOTAWARINGIN TIMUR, KALIMANTAN TENGAH",6,59,44,103
https://kawalpemilu.org#60553,"BAGENDANG HULU, MENTAYA HILIR UTARA, KOTAWARINGIN TIMUR, KALIMANTAN TENGAH",7,60,37,97
https://kawalpemilu.org#60553,"BAGENDANG HULU, MENTAYA HILIR UTARA, KOTAWARINGIN TIMUR, KALIMANTAN TENGAH",8,77,76,153
https://kawalpemilu.org#60553,"BAGENDANG HULU, MENTAYA HILIR UTARA, KOTAWARINGIN TIMUR, KALIMANTAN TENGAH",9,43,88,131
https://kawalpemilu.org#60553,"BAGENDANG HULU, MENTAYA HILIR UTARA, KOTAWARINGIN TIMUR, KALIMANTAN TENGAH",10,55,91,146
https://kawalpemilu.org#60553,"BAGENDANG HULU, MENTAYA HILIR UTARA, KOTAWARINGIN TIMUR, KALIMANTAN TENGAH",11,42,77,119
https://kawalpemilu.org#60553,"BAGENDANG HULU, MENTAYA HILIR UTARA, KOTAWARINGIN TIMUR, KALIMANTAN TENGAH",12,26,62,88
https://kawalpemilu.org#60554,"SUMBER MAKMUR, MENTAYA HILIR UTARA, KOTAWARINGIN TIMUR, KALIMANTAN TENGAH",1,180,57,237
https://kawalpemilu.org#60554,"SUMBER MAKMUR, MENTAYA HILIR UTARA, KOTAWARINGIN TIMUR, KALIMANTAN TENGAH",2,124,31,155
https://kawalpemilu.org#60554,"SUMBER MAKMUR, MENTAYA HILIR UTARA, KOTAWARINGIN TIMUR, KALIMANTAN TENGAH",3,132,42,174
https://kawalpemilu.org#60554,"SUMBER MAKMUR, MENTAYA HILIR UTARA, KOTAWARINGIN TIMUR, KALIMANTAN TENGAH",4,106,63,169
https://kawalpemilu.org#60554,"SUMBER MAKMUR, MENTAYA HILIR UTARA, KOTAWARINGIN TIMUR, KALIMANTAN TENGAH",5,67,38,105
https://kawalpemilu.org#60555,"BAGENDANG PERMAI, MENTAYA HILIR UTARA, KOTAWARINGIN TIMUR, KALIMANTAN TENGAH",1,54,54,108
https://kawalpemilu.org#60555,"BAGENDANG PERMAI, MENTAYA HILIR UTARA, KOTAWARINGIN TIMUR, KALIMANTAN TENGAH",2,86,122,208
https://kawalpemilu.org#60555,"BAGENDANG PERMAI, MENTAYA HILIR UTARA, KOTAWARINGIN TIMUR, KALIMANTAN TENGAH",3,58,92,150
https://kawalpemilu.org#60555,"BAGENDANG PERMAI, MENTAYA HILIR UTARA, KOTAWARINGIN TIMUR, KALIMANTAN TENGAH",4,100,83,183
https://kawalpemilu.org#60555,"BAGENDANG PERMAI, MENTAYA HILIR UTARA, KOTAWARINGIN TIMUR, KALIMANTAN TENGAH",5,35,32,67
https://kawalpemilu.org#60555,"BAGENDANG PERMAI, MENTAYA HILIR UTARA, KOTAWARINGIN TIMUR, KALIMANTAN TENGAH",6,69,84,153
https://kawalpemilu.org#60555,"BAGENDANG PERMAI, MENTAYA HILIR UTARA, KOTAWARINGIN TIMUR, KALIMANTAN TENGAH",7,61,72,133
https://kawalpemilu.org#60557,"SAMUDA KOTA, MENTAYA HILIR SELATAN, KOTAWARINGIN TIMUR, KALIMANTAN TENGAH",1,32,109,141
https://kawalpemilu.org#60557,"SAMUDA KOTA, MENTAYA HILIR SELATAN, KOTAWARINGIN TIMUR, KALIMANTAN TENGAH",2,46,80,126
https://kawalpemilu.org#60557,"SAMUDA KOTA, MENTAYA HILIR SELATAN, KOTAWARINGIN TIMUR, KALIMANTAN TENGAH",3,41,69,110
https://kawalpemilu.org#60557,"SAMUDA KOTA, MENTAYA HILIR SELATAN, KOTAWARINGIN TIMUR, KALIMANTAN TENGAH",4,60,125,185
https://kawalpemilu.org#60557,"SAMUDA KOTA, MENTAYA HILIR SELATAN, KOTAWARINGIN TIMUR, KALIMANTAN TENGAH",5,78,115,193
https://kawalpemilu.org#60557,"SAMUDA KOTA, MENTAYA HILIR SELATAN, KOTAWARINGIN TIMUR, KALIMANTAN TENGAH",6,50,68,118
https://kawalpemilu.org#60557,"SAMUDA KOTA, MENTAYA HILIR SELATAN, KOTAWARINGIN TIMUR, KALIMANTAN TENGAH",7,55,107,162
https://kawalpemilu.org#60557,"SAMUDA KOTA, MENTAYA HILIR SELATAN, KOTAWARINGIN TIMUR, KALIMANTAN TENGAH",8,14,97,111
https://kawalpemilu.org#60557,"SAMUDA KOTA, MENTAYA HILIR SELATAN, KOTAWARINGIN TIMUR, KALIMANTAN TENGAH",9,34,160,194
https://kawalpemilu.org#60558,"BASIRIH HILIR, MENTAYA HILIR SELATAN, KOTAWARINGIN TIMUR, KALIMANTAN TENGAH",1,78,133,211
https://kawalpemilu.org#60558,"BASIRIH HILIR, MENTAYA HILIR SELATAN, KOTAWARINGIN TIMUR, KALIMANTAN TENGAH",2,55,126,182
https://kawalpemilu.org#60558,"BASIRIH HILIR, MENTAYA HILIR SELATAN, KOTAWARINGIN TIMUR, KALIMANTAN TENGAH",3,55,143,198
https://kawalpemilu.org#60558,"BASIRIH HILIR, MENTAYA HILIR SELATAN, KOTAWARINGIN TIMUR, KALIMANTAN TENGAH",4,53,107,160
https://kawalpemilu.org#60558,"BASIRIH HILIR, MENTAYA HILIR SELATAN, KOTAWARINGIN TIMUR, KALIMANTAN TENGAH",5,44,91,135
https://kawalpemilu.org#60558,"BASIRIH HILIR, MENTAYA HILIR SELATAN, KOTAWARINGIN TIMUR, KALIMANTAN TENGAH",6,48,106,154
https://kawalpemilu.org#60558,"BASIRIH HILIR, MENTAYA HILIR SELATAN, KOTAWARINGIN TIMUR, KALIMANTAN TENGAH",7,46,94,140
https://kawalpemilu.org#60558,"BASIRIH HILIR, MENTAYA HILIR SELATAN, KOTAWARINGIN TIMUR, KALIMANTAN TENGAH",8,37,132,169
https://kawalpemilu.org#60558,"BASIRIH HILIR, MENTAYA HILIR SELATAN, KOTAWARINGIN TIMUR, KALIMANTAN TENGAH",9,41,103,144
https://kawalpemilu.org#60558,"BASIRIH HILIR, MENTAYA HILIR SELATAN, KOTAWARINGIN TIMUR, KALIMANTAN TENGAH",10,35,148,183
https://kawalpemilu.org#60558,"BASIRIH HILIR, MENTAYA HILIR SELATAN, KOTAWARINGIN TIMUR, KALIMANTAN TENGAH",11,56,84,140
https://kawalpemilu.org#60558,"BASIRIH HILIR, MENTAYA HILIR SELATAN, KOTAWARINGIN TIMUR, KALIMANTAN TENGAH",12,27,127,154
https://kawalpemilu.org#60558,"BASIRIH HILIR, MENTAYA HILIR SELATAN, KOTAWARINGIN TIMUR, KALIMANTAN TENGAH",13,48,130,178
https://kawalpemilu.org#60558,"BASIRIH HILIR, MENTAYA HILIR SELATAN, KOTAWARINGIN TIMUR, KALIMANTAN TENGAH",14,51,126,177
https://kawalpemilu.org#60558,"BASIRIH HILIR, MENTAYA HILIR SELATAN, KOTAWARINGIN TIMUR, KALIMANTAN TENGAH",15,61,124,185
https://kawalpemilu.org#60558,"BASIRIH HILIR, MENTAYA HILIR SELATAN, KOTAWARINGIN TIMUR, KALIMANTAN TENGAH",16,40,152,192
https://kawalpemilu.org#60558,"BASIRIH HILIR, MENTAYA HILIR SELATAN, KOTAWARINGIN TIMUR, KALIMANTAN TENGAH",17,14,153,167
https://kawalpemilu.org#60558,"BASIRIH HILIR, MENTAYA HILIR SELATAN, KOTAWARINGIN TIMUR, KALIMANTAN TENGAH",18,38,119,157
https://kawalpemilu.org#60558,"BASIRIH HILIR, MENTAYA HILIR SELATAN, KOTAWARINGIN TIMUR, KALIMANTAN TENGAH",19,43,99,142
https://kawalpemilu.org#60558,"BASIRIH HILIR, MENTAYA HILIR SELATAN, KOTAWARINGIN TIMUR, KALIMANTAN TENGAH",20,53,112,163
https://kawalpemilu.org#60558,"BASIRIH HILIR, MENTAYA HILIR SELATAN, KOTAWARINGIN TIMUR, KALIMANTAN TENGAH",21,33,144,177
https://kawalpemilu.org#60559,"SEBAMBAN, MENTAYA HILIR SELATAN, KOTAWARINGIN TIMUR, KALIMANTAN TENGAH",1,48,123,171
https://kawalpemilu.org#60559,"SEBAMBAN, MENTAYA HILIR SELATAN, KOTAWARINGIN TIMUR, KALIMANTAN TENGAH",2,40,93,133
https://kawalpemilu.org#60560,"SAMUDA BESAR, MENTAYA HILIR SELATAN, KOTAWARINGIN TIMUR, KALIMANTAN TENGAH",1,35,114,149
https://kawalpemilu.org#60560,"SAMUDA BESAR, MENTAYA HILIR SELATAN, KOTAWARINGIN TIMUR, KALIMANTAN TENGAH",2,28,113,141
https://kawalpemilu.org#60560,"SAMUDA BESAR, MENTAYA HILIR SELATAN, KOTAWARINGIN TIMUR, KALIMANTAN TENGAH",3,39,128,167
https://kawalpemilu.org#60560,"SAMUDA BESAR, MENTAYA HILIR SELATAN, KOTAWARINGIN TIMUR, KALIMANTAN TENGAH",4,39,178,217
https://kawalpemilu.org#60561,"SAMUDA KECIL, MENTAYA HILIR SELATAN, KOTAWARINGIN TIMUR, KALIMANTAN TENGAH",1,69,87,156
https://kawalpemilu.org#60561,"SAMUDA KECIL, MENTAYA HILIR SELATAN, KOTAWARINGIN TIMUR, KALIMANTAN TENGAH",2,94,91,185
https://kawalpemilu.org#60562,"JAYA KELAPA, MENTAYA HILIR SELATAN, KOTAWARINGIN TIMUR, KALIMANTAN TENGAH",1,56,175,231
https://kawalpemilu.org#60562,"JAYA KELAPA, MENTAYA HILIR SELATAN, KOTAWARINGIN TIMUR, KALIMANTAN TENGAH",2,55,156,211
https://kawalpemilu.org#60562,"JAYA KELAPA, MENTAYA HILIR SELATAN, KOTAWARINGIN TIMUR, KALIMANTAN TENGAH",3,42,145,187
https://kawalpemilu.org#60562,"JAYA KELAPA, MENTAYA HILIR SELATAN, KOTAWARINGIN TIMUR, KALIMANTAN TENGAH",4,52,159,211
https://kawalpemilu.org#60562,"JAYA KELAPA, MENTAYA HILIR SELATAN, KOTAWARINGIN TIMUR, KALIMANTAN TENGAH",5,29,156,185
https://kawalpemilu.org#60562,"JAYA KELAPA, MENTAYA HILIR SELATAN, KOTAWARINGIN TIMUR, KALIMANTAN TENGAH",6,40,185,225
https://kawalpemilu.org#60562,"JAYA KELAPA, MENTAYA HILIR SELATAN, KOTAWARINGIN TIMUR, KALIMANTAN TENGAH",7,59,135,194
https://kawalpemilu.org#60562,"JAYA KELAPA, MENTAYA HILIR SELATAN, KOTAWARINGIN TIMUR, KALIMANTAN TENGAH",8,66,144,210
https://kawalpemilu.org#60562,"JAYA KELAPA, MENTAYA HILIR SELATAN, KOTAWARINGIN TIMUR, KALIMANTAN TENGAH",9,64,158,222
https://kawalpemilu.org#60563,"BASIRIH HULU, MENTAYA HILIR SELATAN, KOTAWARINGIN TIMUR, KALIMANTAN TENGAH",1,16,136,152
https://kawalpemilu.org#60563,"BASIRIH HULU, MENTAYA HILIR SELATAN, KOTAWARINGIN TIMUR, KALIMANTAN TENGAH",2,25,165,190
https://kawalpemilu.org#60563,"BASIRIH HULU, MENTAYA HILIR SELATAN, KOTAWARINGIN TIMUR, KALIMANTAN TENGAH",3,23,138,161
https://kawalpemilu.org#60563,"BASIRIH HULU, MENTAYA HILIR SELATAN, KOTAWARINGIN TIMUR, KALIMANTAN TENGAH",4,47,140,187
https://kawalpemilu.org#60563,"BASIRIH HULU, MENTAYA HILIR SELATAN, KOTAWARINGIN TIMUR, KALIMANTAN TENGAH",5,32,186,218
https://kawalpemilu.org#60563,"BASIRIH HULU, MENTAYA HILIR SELATAN, KOTAWARINGIN TIMUR, KALIMANTAN TENGAH",6,41,136,177
https://kawalpemilu.org#60563,"BASIRIH HULU, MENTAYA HILIR SELATAN, KOTAWARINGIN TIMUR, KALIMANTAN TENGAH",7,22,91,113
https://kawalpemilu.org#60564,"JAYA KARET, MENTAYA HILIR SELATAN, KOTAWARINGIN TIMUR, KALIMANTAN TENGAH",1,57,161,218
https://kawalpemilu.org#60564,"JAYA KARET, MENTAYA HILIR SELATAN, KOTAWARINGIN TIMUR, KALIMANTAN TENGAH",2,43,150,193
https://kawalpemilu.org#60564,"JAYA KARET, MENTAYA HILIR SELATAN, KOTAWARINGIN TIMUR, KALIMANTAN TENGAH",3,74,133,197
https://kawalpemilu.org#60564,"JAYA KARET, MENTAYA HILIR SELATAN, KOTAWARINGIN TIMUR, KALIMANTAN TENGAH",4,46,174,220
https://kawalpemilu.org#60564,"JAYA KARET, MENTAYA HILIR SELATAN, KOTAWARINGIN TIMUR, KALIMANTAN TENGAH",5,38,167,7
https://kawalpemilu.org#60564,"JAYA KARET, MENTAYA HILIR SELATAN, KOTAWARINGIN TIMUR, KALIMANTAN TENGAH",6,36,108,144
https://kawalpemilu.org#60564,"JAYA KARET, MENTAYA HILIR SELATAN, KOTAWARINGIN TIMUR, KALIMANTAN TENGAH",7,17,95,112
https://kawalpemilu.org#60565,"HANDIL SOHOR, MENTAYA HILIR SELATAN, KOTAWARINGIN TIMUR, KALIMANTAN TENGAH",1,90,123,213
https://kawalpemilu.org#60565,"HANDIL SOHOR, MENTAYA HILIR SELATAN, KOTAWARINGIN TIMUR, KALIMANTAN TENGAH",2,110,81,191
https://kawalpemilu.org#60565,"HANDIL SOHOR, MENTAYA HILIR SELATAN, KOTAWARINGIN TIMUR, KALIMANTAN TENGAH",3,39,108,147
https://kawalpemilu.org#60565,"HANDIL SOHOR, MENTAYA HILIR SELATAN, KOTAWARINGIN TIMUR, KALIMANTAN TENGAH",4,52,133,185
https://kawalpemilu.org#60565,"HANDIL SOHOR, MENTAYA HILIR SELATAN, KOTAWARINGIN TIMUR, KALIMANTAN TENGAH",5,24,104,128
https://kawalpemilu.org#60565,"HANDIL SOHOR, MENTAYA HILIR SELATAN, KOTAWARINGIN TIMUR, KALIMANTAN TENGAH",6,87,58,145
https://kawalpemilu.org#60565,"HANDIL SOHOR, MENTAYA HILIR SELATAN, KOTAWARINGIN TIMUR, KALIMANTAN TENGAH",7,95,40,135
https://kawalpemilu.org#60566,"SEI IJUM RAYA, MENTAYA HILIR SELATAN, KOTAWARINGIN TIMUR, KALIMANTAN TENGAH",1,74,91,165
https://kawalpemilu.org#60566,"SEI IJUM RAYA, MENTAYA HILIR SELATAN, KOTAWARINGIN TIMUR, KALIMANTAN TENGAH",2,37,125,162
https://kawalpemilu.org#60566,"SEI IJUM RAYA, MENTAYA HILIR SELATAN, KOTAWARINGIN TIMUR, KALIMANTAN TENGAH",3,31,136,167
https://kawalpemilu.org#60568,"BAPINANG HULU, PULAU HANAUT, KOTAWARINGIN TIMUR, KALIMANTAN TENGAH",1,69,61,130
https://kawalpemilu.org#60568,"BAPINANG HULU, PULAU HANAUT, KOTAWARINGIN TIMUR, KALIMANTAN TENGAH",2,12,72,84
https://kawalpemilu.org#60568,"BAPINANG HULU, PULAU HANAUT, KOTAWARINGIN TIMUR, KALIMANTAN TENGAH",3,65,66,131
https://kawalpemilu.org#60568,"BAPINANG HULU, PULAU HANAUT, KOTAWARINGIN TIMUR, KALIMANTAN TENGAH",4,25,34,59
https://kawalpemilu.org#60568,"BAPINANG HULU, PULAU HANAUT, KOTAWARINGIN TIMUR, KALIMANTAN TENGAH",5,25,71,96
https://kawalpemilu.org#60568,"BAPINANG HULU, PULAU HANAUT, KOTAWARINGIN TIMUR, KALIMANTAN TENGAH",6,28,31,59
https://kawalpemilu.org#60569,"BAPINANG HILIR, PULAU HANAUT, KOTAWARINGIN TIMUR, KALIMANTAN TENGAH",1,48,129,177
https://kawalpemilu.org#60569,"BAPINANG HILIR, PULAU HANAUT, KOTAWARINGIN TIMUR, KALIMANTAN TENGAH",2,63,101,164
https://kawalpemilu.org#60569,"BAPINANG HILIR, PULAU HANAUT, KOTAWARINGIN TIMUR, KALIMANTAN TENGAH",3,33,121,154
https://kawalpemilu.org#60569,"BAPINANG HILIR, PULAU HANAUT, KOTAWARINGIN TIMUR, KALIMANTAN TENGAH",4,46,77,123
https://kawalpemilu.org#60569,"BAPINANG HILIR, PULAU HANAUT, KOTAWARINGIN TIMUR, KALIMANTAN TENGAH",5,62,64,126
https://kawalpemilu.org#60569,"BAPINANG HILIR, PULAU HANAUT, KOTAWARINGIN TIMUR, KALIMANTAN TENGAH",6,83,94,177
https://kawalpemilu.org#60570,"BAPINANG HILIR LAUT, PULAU HANAUT, KOTAWARINGIN TIMUR, KALIMANTAN TENGAH",1,57,114,171
https://kawalpemilu.org#60570,"BAPINANG HILIR LAUT, PULAU HANAUT, KOTAWARINGIN TIMUR, KALIMANTAN TENGAH",2,40,84,124
https://kawalpemilu.org#60570,"BAPINANG HILIR LAUT, PULAU HANAUT, KOTAWARINGIN TIMUR, KALIMANTAN TENGAH",3,78,100,178
https://kawalpemilu.org#60570,"BAPINANG HILIR LAUT, PULAU HANAUT, KOTAWARINGIN TIMUR, KALIMANTAN TENGAH",4,47,103,150
https://kawalpemilu.org#60571,"SATIRUK, PULAU HANAUT, KOTAWARINGIN TIMUR, KALIMANTAN TENGAH",3,25,12,37
https://kawalpemilu.org#60571,"SATIRUK, PULAU HANAUT, KOTAWARINGIN TIMUR, KALIMANTAN TENGAH",4,28,46,74
https://kawalpemilu.org#60571,"SATIRUK, PULAU HANAUT, KOTAWARINGIN TIMUR, KALIMANTAN TENGAH",5,22,51,73
https://kawalpemilu.org#60571,"SATIRUK, PULAU HANAUT, KOTAWARINGIN TIMUR, KALIMANTAN TENGAH",6,40,54,94
https://kawalpemilu.org#60572,"MAKARTI JAYA, PULAU HANAUT, KOTAWARINGIN TIMUR, KALIMANTAN TENGAH",1,126,13,139
https://kawalpemilu.org#60572,"MAKARTI JAYA, PULAU HANAUT, KOTAWARINGIN TIMUR, KALIMANTAN TENGAH",2,101,27,128
https://kawalpemilu.org#60572,"MAKARTI JAYA, PULAU HANAUT, KOTAWARINGIN TIMUR, KALIMANTAN TENGAH",3,118,71,189
https://kawalpemilu.org#60573,"RAWA SARI, PULAU HANAUT, KOTAWARINGIN TIMUR, KALIMANTAN TENGAH",1,132,54,186
https://kawalpemilu.org#60573,"RAWA SARI, PULAU HANAUT, KOTAWARINGIN TIMUR, KALIMANTAN TENGAH",2,152,44,196
https://kawalpemilu.org#60574,"HANAUT, PULAU HANAUT, KOTAWARINGIN TIMUR, KALIMANTAN TENGAH",1,70,69,139
https://kawalpemilu.org#60574,"HANAUT, PULAU HANAUT, KOTAWARINGIN TIMUR, KALIMANTAN TENGAH",2,63,59,122
https://kawalpemilu.org#60574,"HANAUT, PULAU HANAUT, KOTAWARINGIN TIMUR, KALIMANTAN TENGAH",3,57,77,134
https://kawalpemilu.org#60574,"HANAUT, PULAU HANAUT, KOTAWARINGIN TIMUR, KALIMANTAN TENGAH",4,41,144,185
https://kawalpemilu.org#60574,"HANAUT, PULAU HANAUT, KOTAWARINGIN TIMUR, KALIMANTAN TENGAH",5,78,18,96
https://kawalpemilu.org#60574,"HANAUT, PULAU HANAUT, KOTAWARINGIN TIMUR, KALIMANTAN TENGAH",6,44,12,56
https://kawalpemilu.org#60574,"HANAUT, PULAU HANAUT, KOTAWARINGIN TIMUR, KALIMANTAN TENGAH",7,69,28,97
https://kawalpemilu.org#60575,"BABIRAH, PULAU HANAUT, KOTAWARINGIN TIMUR, KALIMANTAN TENGAH",1,13,47,60
https://kawalpemilu.org#60575,"BABIRAH, PULAU HANAUT, KOTAWARINGIN TIMUR, KALIMANTAN TENGAH",2,66,127,193
https://kawalpemilu.org#60575,"BABIRAH, PULAU HANAUT, KOTAWARINGIN TIMUR, KALIMANTAN TENGAH",3,83,85,168
https://kawalpemilu.org#60575,"BABIRAH, PULAU HANAUT, KOTAWARINGIN TIMUR, KALIMANTAN TENGAH",4,76,108,184
https://kawalpemilu.org#60575,"BABIRAH, PULAU HANAUT, KOTAWARINGIN TIMUR, KALIMANTAN TENGAH",5,42,71,113
https://kawalpemilu.org#60576,"SERAMBUT, PULAU HANAUT, KOTAWARINGIN TIMUR, KALIMANTAN TENGAH",1,59,113,172
https://kawalpemilu.org#60576,"SERAMBUT, PULAU HANAUT, KOTAWARINGIN TIMUR, KALIMANTAN TENGAH",2,38,69,107
https://kawalpemilu.org#60576,"SERAMBUT, PULAU HANAUT, KOTAWARINGIN TIMUR, KALIMANTAN TENGAH",3,26,62,88
https://kawalpemilu.org#60576,"SERAMBUT, PULAU HANAUT, KOTAWARINGIN TIMUR, KALIMANTAN TENGAH",4,26,98,124
https://kawalpemilu.org#60577,"BABAUNG, PULAU HANAUT, KOTAWARINGIN TIMUR, KALIMANTAN TENGAH",1,38,129,167
https://kawalpemilu.org#60577,"BABAUNG, PULAU HANAUT, KOTAWARINGIN TIMUR, KALIMANTAN TENGAH",2,60,110,170
https://kawalpemilu.org#60577,"BABAUNG, PULAU HANAUT, KOTAWARINGIN TIMUR, KALIMANTAN TENGAH",3,63,115,178
https://kawalpemilu.org#60577,"BABAUNG, PULAU HANAUT, KOTAWARINGIN TIMUR, KALIMANTAN TENGAH",4,51,122,173
https://kawalpemilu.org#60577,"BABAUNG, PULAU HANAUT, KOTAWARINGIN TIMUR, KALIMANTAN TENGAH",5,31,108,139
https://kawalpemilu.org#60577,"BABAUNG, PULAU HANAUT, KOTAWARINGIN TIMUR, KALIMANTAN TENGAH",6,42,81,123
https://kawalpemilu.org#60577,"BABAUNG, PULAU HANAUT, KOTAWARINGIN TIMUR, KALIMANTAN TENGAH",7,45,65,110
https://kawalpemilu.org#927887,"PANYANGUAN, PULAU HANAUT, KOTAWARINGIN TIMUR, KALIMANTAN TENGAH",1,46,104,150
https://kawalpemilu.org#927887,"PANYANGUAN, PULAU HANAUT, KOTAWARINGIN TIMUR, KALIMANTAN TENGAH",2,95,75,170
https://kawalpemilu.org#927888,"BAMADU, PULAU HANAUT, KOTAWARINGIN TIMUR, KALIMANTAN TENGAH",1,105,57,162
https://kawalpemilu.org#927888,"BAMADU, PULAU HANAUT, KOTAWARINGIN TIMUR, KALIMANTAN TENGAH",2,110,52,162
https://kawalpemilu.org#927889,"HANTIPAN, PULAU HANAUT, KOTAWARINGIN TIMUR, KALIMANTAN TENGAH",1,93,100,193
https://kawalpemilu.org#927889,"HANTIPAN, PULAU HANAUT, KOTAWARINGIN TIMUR, KALIMANTAN TENGAH",2,95,56,151
https://kawalpemilu.org#927890,"BANTIAN, PULAU HANAUT, KOTAWARINGIN TIMUR, KALIMANTAN TENGAH",1,40,115,155
https://kawalpemilu.org#927890,"BANTIAN, PULAU HANAUT, KOTAWARINGIN TIMUR, KALIMANTAN TENGAH",2,54,90,144
https://kawalpemilu.org#927890,"BANTIAN, PULAU HANAUT, KOTAWARINGIN TIMUR, KALIMANTAN TENGAH",3,21,144,165
https://kawalpemilu.org#927890,"BANTIAN, PULAU HANAUT, KOTAWARINGIN TIMUR, KALIMANTAN TENGAH",4,16,62,78
https://kawalpemilu.org#60579,"TUMBANG KALANG, ANTANG KALANG, KOTAWARINGIN TIMUR, KALIMANTAN TENGAH",1,172,18,190
https://kawalpemilu.org#60579,"TUMBANG KALANG, ANTANG KALANG, KOTAWARINGIN TIMUR, KALIMANTAN TENGAH",2,127,43,170
https://kawalpemilu.org#60579,"TUMBANG KALANG, ANTANG KALANG, KOTAWARINGIN TIMUR, KALIMANTAN TENGAH",3,111,25,136
https://kawalpemilu.org#60579,"TUMBANG KALANG, ANTANG KALANG, KOTAWARINGIN TIMUR, KALIMANTAN TENGAH",4,86,35,121
https://kawalpemilu.org#60579,"TUMBANG KALANG, ANTANG KALANG, KOTAWARINGIN TIMUR, KALIMANTAN TENGAH",5,122,26,148
https://kawalpemilu.org#60579,"TUMBANG KALANG, ANTANG KALANG, KOTAWARINGIN TIMUR, KALIMANTAN TENGAH",6,88,37,125
https://kawalpemilu.org#60580,"KULUK TELAWANG, ANTANG KALANG, KOTAWARINGIN TIMUR, KALIMANTAN TENGAH",1,90,22,112
https://kawalpemilu.org#60580,"KULUK TELAWANG, ANTANG KALANG, KOTAWARINGIN TIMUR, KALIMANTAN TENGAH",2,81,5,86
https://kawalpemilu.org#60581,"SUNGAI PURING, ANTANG KALANG, KOTAWARINGIN TIMUR, KALIMANTAN TENGAH",1,129,21,150
https://kawalpemilu.org#60581,"SUNGAI PURING, ANTANG KALANG, KOTAWARINGIN TIMUR, KALIMANTAN TENGAH",2,143,10,153
https://kawalpemilu.org#60582,"TUMBANG NGAHAN, ANTANG KALANG, KOTAWARINGIN TIMUR, KALIMANTAN TENGAH",1,144,9,153
https://kawalpemilu.org#60583,"TUMBANG RAMEI, ANTANG KALANG, KOTAWARINGIN TIMUR, KALIMANTAN TENGAH",1,128,15,143
https://kawalpemilu.org#60584,"TUMBANG HEJAN, ANTANG KALANG, KOTAWARINGIN TIMUR, KALIMANTAN TENGAH",1,84,10,94
https://kawalpemilu.org#60584,"TUMBANG HEJAN, ANTANG KALANG, KOTAWARINGIN TIMUR, KALIMANTAN TENGAH",2,87,13,100
https://kawalpemilu.org#60585,"SUNGAI HANYA, ANTANG KALANG, KOTAWARINGIN TIMUR, KALIMANTAN TENGAH",1,137,18,155
https://kawalpemilu.org#60585,"SUNGAI HANYA, ANTANG KALANG, KOTAWARINGIN TIMUR, KALIMANTAN TENGAH",2,154,10,164
https://kawalpemilu.org#60585,"SUNGAI HANYA, ANTANG KALANG, KOTAWARINGIN TIMUR, KALIMANTAN TENGAH",3,103,5,108
https://kawalpemilu.org#60586,"TUMBANG SEPANYANG, ANTANG KALANG, KOTAWARINGIN TIMUR, KALIMANTAN TENGAH",1,104,6,110
https://kawalpemilu.org#60586,"TUMBANG SEPANYANG, ANTANG KALANG, KOTAWARINGIN TIMUR, KALIMANTAN TENGAH",2,168,18,186
https://kawalpemilu.org#60586,"TUMBANG SEPANYANG, ANTANG KALANG, KOTAWARINGIN TIMUR, KALIMANTAN TENGAH",3,76,4,80
https://kawalpemilu.org#60586,"TUMBANG SEPANYANG, ANTANG KALANG, KOTAWARINGIN TIMUR, KALIMANTAN TENGAH",4,187,21,208
https://kawalpemilu.org#60586,"TUMBANG SEPANYANG, ANTANG KALANG, KOTAWARINGIN TIMUR, KALIMANTAN TENGAH",5,178,16,194
https://kawalpemilu.org#60594,"BUNTUT NUSA, ANTANG KALANG, KOTAWARINGIN TIMUR, KALIMANTAN TENGAH",1,58,10,68
https://kawalpemilu.org#60595,"TUMBANG GAGU, ANTANG KALANG, KOTAWARINGIN TIMUR, KALIMANTAN TENGAH",1,98,11,109
https://kawalpemilu.org#60595,"TUMBANG GAGU, ANTANG KALANG, KOTAWARINGIN TIMUR, KALIMANTAN TENGAH",2,87,7,94
https://kawalpemilu.org#60599,"TUMBANG MANYA, ANTANG KALANG, KOTAWARINGIN TIMUR, KALIMANTAN TENGAH",1,120,21,141
https://kawalpemilu.org#60599,"TUMBANG MANYA, ANTANG KALANG, KOTAWARINGIN TIMUR, KALIMANTAN TENGAH",2,125,8,133
https://kawalpemilu.org#60599,"TUMBANG MANYA, ANTANG KALANG, KOTAWARINGIN TIMUR, KALIMANTAN TENGAH",3,92,12,104
https://kawalpemilu.org#60603,"GUNUNG MAKMUR, ANTANG KALANG, KOTAWARINGIN TIMUR, KALIMANTAN TENGAH",1,132,32,164
https://kawalpemilu.org#60603,"GUNUNG MAKMUR, ANTANG KALANG, KOTAWARINGIN TIMUR, KALIMANTAN TENGAH",2,145,33,178
https://kawalpemilu.org#60603,"GUNUNG MAKMUR, ANTANG KALANG, KOTAWARINGIN TIMUR, KALIMANTAN TENGAH",3,155,42,197
https://kawalpemilu.org#60603,"GUNUNG MAKMUR, ANTANG KALANG, KOTAWARINGIN TIMUR, KALIMANTAN TENGAH",4,142,35,177
https://kawalpemilu.org#60603,"GUNUNG MAKMUR, ANTANG KALANG, KOTAWARINGIN TIMUR, KALIMANTAN TENGAH",5,162,36,198
https://kawalpemilu.org#60605,"MULYA AGUNG, ANTANG KALANG, KOTAWARINGIN TIMUR, KALIMANTAN TENGAH",1,206,16,222
https://kawalpemilu.org#60605,"MULYA AGUNG, ANTANG KALANG, KOTAWARINGIN TIMUR, KALIMANTAN TENGAH",2,201,18,219
https://kawalpemilu.org#60605,"MULYA AGUNG, ANTANG KALANG, KOTAWARINGIN TIMUR, KALIMANTAN TENGAH",3,187,11,198
https://kawalpemilu.org#60606,"BAKTI KARYA, ANTANG KALANG, KOTAWARINGIN TIMUR, KALIMANTAN TENGAH",1,161,26,187
https://kawalpemilu.org#60606,"BAKTI KARYA, ANTANG KALANG, KOTAWARINGIN TIMUR, KALIMANTAN TENGAH",2,163,11,174
https://kawalpemilu.org#60606,"BAKTI KARYA, ANTANG KALANG, KOTAWARINGIN TIMUR, KALIMANTAN TENGAH",3,158,16,174
https://kawalpemilu.org#60607,"WARINGIN AGUNG, ANTANG KALANG, KOTAWARINGIN TIMUR, KALIMANTAN TENGAH",1,165,14,179
https://kawalpemilu.org#60607,"WARINGIN AGUNG, ANTANG KALANG, KOTAWARINGIN TIMUR, KALIMANTAN TENGAH",2,196,11,207
https://kawalpemilu.org#60607,"WARINGIN AGUNG, ANTANG KALANG, KOTAWARINGIN TIMUR, KALIMANTAN TENGAH",3,120,18,138
https://kawalpemilu.org#60610,"PAREBOK, TELUK SAMPIT, KOTAWARINGIN TIMUR, KALIMANTAN TENGAH",1,34,143,177
https://kawalpemilu.org#60610,"PAREBOK, TELUK SAMPIT, KOTAWARINGIN TIMUR, KALIMANTAN TENGAH",2,34,172,206
https://kawalpemilu.org#60610,"PAREBOK, TELUK SAMPIT, KOTAWARINGIN TIMUR, KALIMANTAN TENGAH",3,26,159,185
https://kawalpemilu.org#60610,"PAREBOK, TELUK SAMPIT, KOTAWARINGIN TIMUR, KALIMANTAN TENGAH",4,16,179,195
https://kawalpemilu.org#60610,"PAREBOK, TELUK SAMPIT, KOTAWARINGIN TIMUR, KALIMANTAN TENGAH",5,12,139,151
https://kawalpemilu.org#60610,"PAREBOK, TELUK SAMPIT, KOTAWARINGIN TIMUR, KALIMANTAN TENGAH",6,21,182,203
https://kawalpemilu.org#60611,"BASAWANG, TELUK SAMPIT, KOTAWARINGIN TIMUR, KALIMANTAN TENGAH",1,90,67,157
https://kawalpemilu.org#60611,"BASAWANG, TELUK SAMPIT, KOTAWARINGIN TIMUR, KALIMANTAN TENGAH",2,63,122,185
https://kawalpemilu.org#60611,"BASAWANG, TELUK SAMPIT, KOTAWARINGIN TIMUR, KALIMANTAN TENGAH",3,42,183,225
https://kawalpemilu.org#60611,"BASAWANG, TELUK SAMPIT, KOTAWARINGIN TIMUR, KALIMANTAN TENGAH",4,20,143,163
https://kawalpemilu.org#60612,"LAMPUYANG, TELUK SAMPIT, KOTAWARINGIN TIMUR, KALIMANTAN TENGAH",1,110,85,195
https://kawalpemilu.org#60612,"LAMPUYANG, TELUK SAMPIT, KOTAWARINGIN TIMUR, KALIMANTAN TENGAH",2,87,146,233
https://kawalpemilu.org#60612,"LAMPUYANG, TELUK SAMPIT, KOTAWARINGIN TIMUR, KALIMANTAN TENGAH",3,92,76,168
https://kawalpemilu.org#60612,"LAMPUYANG, TELUK SAMPIT, KOTAWARINGIN TIMUR, KALIMANTAN TENGAH",4,87,99,186
https://kawalpemilu.org#60612,"LAMPUYANG, TELUK SAMPIT, KOTAWARINGIN TIMUR, KALIMANTAN TENGAH",5,41,102,143
https://kawalpemilu.org#60612,"LAMPUYANG, TELUK SAMPIT, KOTAWARINGIN TIMUR, KALIMANTAN TENGAH",6,110,97,207
https://kawalpemilu.org#60612,"LAMPUYANG, TELUK SAMPIT, KOTAWARINGIN TIMUR, KALIMANTAN TENGAH",7,61,115,176
https://kawalpemilu.org#60612,"LAMPUYANG, TELUK SAMPIT, KOTAWARINGIN TIMUR, KALIMANTAN TENGAH",8,55,88,143
https://kawalpemilu.org#60613,"UJUNG PANDARAN, TELUK SAMPIT, KOTAWARINGIN TIMUR, KALIMANTAN TENGAH",1,131,44,175
https://kawalpemilu.org#60613,"UJUNG PANDARAN, TELUK SAMPIT, KOTAWARINGIN TIMUR, KALIMANTAN TENGAH",2,160,26,186
https://kawalpemilu.org#60613,"UJUNG PANDARAN, TELUK SAMPIT, KOTAWARINGIN TIMUR, KALIMANTAN TENGAH",3,117,29,146
https://kawalpemilu.org#60613,"UJUNG PANDARAN, TELUK SAMPIT, KOTAWARINGIN TIMUR, KALIMANTAN TENGAH",4,93,22,115
https://kawalpemilu.org#60613,"UJUNG PANDARAN, TELUK SAMPIT, KOTAWARINGIN TIMUR, KALIMANTAN TENGAH",5,123,17,140
https://kawalpemilu.org#85368,"REGEI LESTARI, TELUK SAMPIT, KOTAWARINGIN TIMUR, KALIMANTAN TENGAH",1,48,172,220
https://kawalpemilu.org#85368,"REGEI LESTARI, TELUK SAMPIT, KOTAWARINGIN TIMUR, KALIMANTAN TENGAH",2,40,180,220
https://kawalpemilu.org#85368,"REGEI LESTARI, TELUK SAMPIT, KOTAWARINGIN TIMUR, KALIMANTAN TENGAH",3,74,104,178
https://kawalpemilu.org#85369,"KUIN PERMAI, TELUK SAMPIT, KOTAWARINGIN TIMUR, KALIMANTAN TENGAH",1,100,115,215
https://kawalpemilu.org#85369,"KUIN PERMAI, TELUK SAMPIT, KOTAWARINGIN TIMUR, KALIMANTAN TENGAH",2,136,66,202
https://kawalpemilu.org#85369,"KUIN PERMAI, TELUK SAMPIT, KOTAWARINGIN TIMUR, KALIMANTAN TENGAH",3,54,121,175
https://kawalpemilu.org#60615,"MENTAYA SEBERANG, SERANAU, KOTAWARINGIN TIMUR, KALIMANTAN TENGAH",1,102,92,194
https://kawalpemilu.org#60615,"MENTAYA SEBERANG, SERANAU, KOTAWARINGIN TIMUR, KALIMANTAN TENGAH",2,74,146,220
https://kawalpemilu.org#60615,"MENTAYA SEBERANG, SERANAU, KOTAWARINGIN TIMUR, KALIMANTAN TENGAH",3,35,180,215
https://kawalpemilu.org#60615,"MENTAYA SEBERANG, SERANAU, KOTAWARINGIN TIMUR, KALIMANTAN TENGAH",4,53,96,149
https://kawalpemilu.org#60615,"MENTAYA SEBERANG, SERANAU, KOTAWARINGIN TIMUR, KALIMANTAN TENGAH",5,47,65,112
https://kawalpemilu.org#60615,"MENTAYA SEBERANG, SERANAU, KOTAWARINGIN TIMUR, KALIMANTAN TENGAH",6,110,118,228
https://kawalpemilu.org#60615,"MENTAYA SEBERANG, SERANAU, KOTAWARINGIN TIMUR, KALIMANTAN TENGAH",7,77,24,101
https://kawalpemilu.org#60615,"MENTAYA SEBERANG, SERANAU, KOTAWARINGIN TIMUR, KALIMANTAN TENGAH",8,6,101,107
https://kawalpemilu.org#60615,"MENTAYA SEBERANG, SERANAU, KOTAWARINGIN TIMUR, KALIMANTAN TENGAH",9,3,157,160
https://kawalpemilu.org#60615,"MENTAYA SEBERANG, SERANAU, KOTAWARINGIN TIMUR, KALIMANTAN TENGAH",10,21,167,188
https://kawalpemilu.org#60615,"MENTAYA SEBERANG, SERANAU, KOTAWARINGIN TIMUR, KALIMANTAN TENGAH",11,6,138,144
https://kawalpemilu.org#60615,"MENTAYA SEBERANG, SERANAU, KOTAWARINGIN TIMUR, KALIMANTAN TENGAH",12,7,93,100
https://kawalpemilu.org#60615,"MENTAYA SEBERANG, SERANAU, KOTAWARINGIN TIMUR, KALIMANTAN TENGAH",13,26,10,36
https://kawalpemilu.org#60616,"TERANTANG, SERANAU, KOTAWARINGIN TIMUR, KALIMANTAN TENGAH",1,142,81,223
https://kawalpemilu.org#60616,"TERANTANG, SERANAU, KOTAWARINGIN TIMUR, KALIMANTAN TENGAH",2,131,63,194
https://kawalpemilu.org#60616,"TERANTANG, SERANAU, KOTAWARINGIN TIMUR, KALIMANTAN TENGAH",3,116,71,187
https://kawalpemilu.org#60616,"TERANTANG, SERANAU, KOTAWARINGIN TIMUR, KALIMANTAN TENGAH",4,108,114,222
https://kawalpemilu.org#60616,"TERANTANG, SERANAU, KOTAWARINGIN TIMUR, KALIMANTAN TENGAH",5,77,74,151
https://kawalpemilu.org#60616,"TERANTANG, SERANAU, KOTAWARINGIN TIMUR, KALIMANTAN TENGAH",6,145,54,199
https://kawalpemilu.org#60617,"BATUAH, SERANAU, KOTAWARINGIN TIMUR, KALIMANTAN TENGAH",1,129,47,176
https://kawalpemilu.org#60617,"BATUAH, SERANAU, KOTAWARINGIN TIMUR, KALIMANTAN TENGAH",2,72,56,128
https://kawalpemilu.org#60617,"BATUAH, SERANAU, KOTAWARINGIN TIMUR, KALIMANTAN TENGAH",3,59,103,162
https://kawalpemilu.org#60617,"BATUAH, SERANAU, KOTAWARINGIN TIMUR, KALIMANTAN TENGAH",4,39,129,168
https://kawalpemilu.org#60617,"BATUAH, SERANAU, KOTAWARINGIN TIMUR, KALIMANTAN TENGAH",5,20,139,159
https://kawalpemilu.org#60617,"BATUAH, SERANAU, KOTAWARINGIN TIMUR, KALIMANTAN TENGAH",6,19,121,140
https://kawalpemilu.org#60617,"BATUAH, SERANAU, KOTAWARINGIN TIMUR, KALIMANTAN TENGAH",7,13,134,147
https://kawalpemilu.org#60618,"TERANTANG HILIR, SERANAU, KOTAWARINGIN TIMUR, KALIMANTAN TENGAH",1,188,56,244
https://kawalpemilu.org#60618,"TERANTANG HILIR, SERANAU, KOTAWARINGIN TIMUR, KALIMANTAN TENGAH",2,116,89,205
https://kawalpemilu.org#60618,"TERANTANG HILIR, SERANAU, KOTAWARINGIN TIMUR, KALIMANTAN TENGAH",3,93,109,202
https://kawalpemilu.org#60618,"TERANTANG HILIR, SERANAU, KOTAWARINGIN TIMUR, KALIMANTAN TENGAH",4,149,73,222
https://kawalpemilu.org#60618,"TERANTANG HILIR, SERANAU, KOTAWARINGIN TIMUR, KALIMANTAN TENGAH",5,108,92,200
https://kawalpemilu.org#60619,"GANEPO, SERANAU, KOTAWARINGIN TIMUR, KALIMANTAN TENGAH",1,84,43,127
https://kawalpemilu.org#60619,"GANEPO, SERANAU, KOTAWARINGIN TIMUR, KALIMANTAN TENGAH",2,104,39,143
https://kawalpemilu.org#60619,"GANEPO, SERANAU, KOTAWARINGIN TIMUR, KALIMANTAN TENGAH",3,115,44,159
https://kawalpemilu.org#60619,"GANEPO, SERANAU, KOTAWARINGIN TIMUR, KALIMANTAN TENGAH",4,108,39,147
https://kawalpemilu.org#60619,"GANEPO, SERANAU, KOTAWARINGIN TIMUR, KALIMANTAN TENGAH",5,119,51,170
https://kawalpemilu.org#60619,"GANEPO, SERANAU, KOTAWARINGIN TIMUR, KALIMANTAN TENGAH",6,45,5,50
https://kawalpemilu.org#927892,"SERAGAM JAYA, SERANAU, KOTAWARINGIN TIMUR, KALIMANTAN TENGAH",1,82,40,122
https://kawalpemilu.org#927892,"SERAGAM JAYA, SERANAU, KOTAWARINGIN TIMUR, KALIMANTAN TENGAH",2,82,35,117
https://kawalpemilu.org#60621,"PUNDU, CEMPAGA HULU, KOTAWARINGIN TIMUR, KALIMANTAN TENGAH",1,155,42,197
https://kawalpemilu.org#60621,"PUNDU, CEMPAGA HULU, KOTAWARINGIN TIMUR, KALIMANTAN TENGAH",2,134,63,197
https://kawalpemilu.org#60621,"PUNDU, CEMPAGA HULU, KOTAWARINGIN TIMUR, KALIMANTAN TENGAH",3,152,59,211
https://kawalpemilu.org#60621,"PUNDU, CEMPAGA HULU, KOTAWARINGIN TIMUR, KALIMANTAN TENGAH",4,158,53,211
https://kawalpemilu.org#60621,"PUNDU, CEMPAGA HULU, KOTAWARINGIN TIMUR, KALIMANTAN TENGAH",5,144,69,213
https://kawalpemilu.org#60621,"PUNDU, CEMPAGA HULU, KOTAWARINGIN TIMUR, KALIMANTAN TENGAH",6,118,29,147
https://kawalpemilu.org#60621,"PUNDU, CEMPAGA HULU, KOTAWARINGIN TIMUR, KALIMANTAN TENGAH",7,114,47,161
https://kawalpemilu.org#60621,"PUNDU, CEMPAGA HULU, KOTAWARINGIN TIMUR, KALIMANTAN TENGAH",8,120,56,176
https://kawalpemilu.org#60621,"PUNDU, CEMPAGA HULU, KOTAWARINGIN TIMUR, KALIMANTAN TENGAH",9,96,35,131
https://kawalpemilu.org#60621,"PUNDU, CEMPAGA HULU, KOTAWARINGIN TIMUR, KALIMANTAN TENGAH",10,122,34,156
https://kawalpemilu.org#60621,"PUNDU, CEMPAGA HULU, KOTAWARINGIN TIMUR, KALIMANTAN TENGAH",11,142,20,162
https://kawalpemilu.org#60621,"PUNDU, CEMPAGA HULU, KOTAWARINGIN TIMUR, KALIMANTAN TENGAH",12,117,28,145
https://kawalpemilu.org#60621,"PUNDU, CEMPAGA HULU, KOTAWARINGIN TIMUR, KALIMANTAN TENGAH",13,124,28,152
https://kawalpemilu.org#60621,"PUNDU, CEMPAGA HULU, KOTAWARINGIN TIMUR, KALIMANTAN TENGAH",14,100,39,139
https://kawalpemilu.org#60621,"PUNDU, CEMPAGA HULU, KOTAWARINGIN TIMUR, KALIMANTAN TENGAH",15,85,29,114
https://kawalpemilu.org#60621,"PUNDU, CEMPAGA HULU, KOTAWARINGIN TIMUR, KALIMANTAN TENGAH",16,58,4,62
https://kawalpemilu.org#60621,"PUNDU, CEMPAGA HULU, KOTAWARINGIN TIMUR, KALIMANTAN TENGAH",17,84,11,95
https://kawalpemilu.org#60621,"PUNDU, CEMPAGA HULU, KOTAWARINGIN TIMUR, KALIMANTAN TENGAH",18,63,22,85
https://kawalpemilu.org#60621,"PUNDU, CEMPAGA HULU, KOTAWARINGIN TIMUR, KALIMANTAN TENGAH",19,68,18,0
https://kawalpemilu.org#60622,"KERUING, CEMPAGA HULU, KOTAWARINGIN TIMUR, KALIMANTAN TENGAH",1,148,10,158
https://kawalpemilu.org#60622,"KERUING, CEMPAGA HULU, KOTAWARINGIN TIMUR, KALIMANTAN TENGAH",2,31,5,36
https://kawalpemilu.org#60622,"KERUING, CEMPAGA HULU, KOTAWARINGIN TIMUR, KALIMANTAN TENGAH",3,47,14,61
https://kawalpemilu.org#60622,"KERUING, CEMPAGA HULU, KOTAWARINGIN TIMUR, KALIMANTAN TENGAH",4,41,7,48
https://kawalpemilu.org#60622,"KERUING, CEMPAGA HULU, KOTAWARINGIN TIMUR, KALIMANTAN TENGAH",5,48,7,55
https://kawalpemilu.org#60623,"PARIT, CEMPAGA HULU, KOTAWARINGIN TIMUR, KALIMANTAN TENGAH",1,137,18,155
https://kawalpemilu.org#60623,"PARIT, CEMPAGA HULU, KOTAWARINGIN TIMUR, KALIMANTAN TENGAH",2,112,8,120
https://kawalpemilu.org#60623,"PARIT, CEMPAGA HULU, KOTAWARINGIN TIMUR, KALIMANTAN TENGAH",3,116,24,140
https://kawalpemilu.org#60623,"PARIT, CEMPAGA HULU, KOTAWARINGIN TIMUR, KALIMANTAN TENGAH",4,153,18,171
https://kawalpemilu.org#60624,"PANTAI HARAPAN, CEMPAGA HULU, KOTAWARINGIN TIMUR, KALIMANTAN TENGAH",1,49,41,90
https://kawalpemilu.org#60624,"PANTAI HARAPAN, CEMPAGA HULU, KOTAWARINGIN TIMUR, KALIMANTAN TENGAH",2,95,44,139
https://kawalpemilu.org#60624,"PANTAI HARAPAN, CEMPAGA HULU, KOTAWARINGIN TIMUR, KALIMANTAN TENGAH",3,82,44,126
https://kawalpemilu.org#60624,"PANTAI HARAPAN, CEMPAGA HULU, KOTAWARINGIN TIMUR, KALIMANTAN TENGAH",4,64,46,110
https://kawalpemilu.org#60624,"PANTAI HARAPAN, CEMPAGA HULU, KOTAWARINGIN TIMUR, KALIMANTAN TENGAH",5,32,39,71
https://kawalpemilu.org#60624,"PANTAI HARAPAN, CEMPAGA HULU, KOTAWARINGIN TIMUR, KALIMANTAN TENGAH",6,64,49,113
https://kawalpemilu.org#60624,"PANTAI HARAPAN, CEMPAGA HULU, KOTAWARINGIN TIMUR, KALIMANTAN TENGAH",7,38,10,48
https://kawalpemilu.org#60624,"PANTAI HARAPAN, CEMPAGA HULU, KOTAWARINGIN TIMUR, KALIMANTAN TENGAH",8,11,3,14
https://kawalpemilu.org#60624,"PANTAI HARAPAN, CEMPAGA HULU, KOTAWARINGIN TIMUR, KALIMANTAN TENGAH",9,79,7,86
https://kawalpemilu.org#60624,"PANTAI HARAPAN, CEMPAGA HULU, KOTAWARINGIN TIMUR, KALIMANTAN TENGAH",10,31,1,32
https://kawalpemilu.org#60625,"PELANTARAN, CEMPAGA HULU, KOTAWARINGIN TIMUR, KALIMANTAN TENGAH",1,127,14,141
https://kawalpemilu.org#60625,"PELANTARAN, CEMPAGA HULU, KOTAWARINGIN TIMUR, KALIMANTAN TENGAH",2,144,36,180
https://kawalpemilu.org#60625,"PELANTARAN, CEMPAGA HULU, KOTAWARINGIN TIMUR, KALIMANTAN TENGAH",3,107,21,128
https://kawalpemilu.org#60625,"PELANTARAN, CEMPAGA HULU, KOTAWARINGIN TIMUR, KALIMANTAN TENGAH",4,89,24,113
https://kawalpemilu.org#60625,"PELANTARAN, CEMPAGA HULU, KOTAWARINGIN TIMUR, KALIMANTAN TENGAH",5,127,8,135
https://kawalpemilu.org#60625,"PELANTARAN, CEMPAGA HULU, KOTAWARINGIN TIMUR, KALIMANTAN TENGAH",6,77,29,106
https://kawalpemilu.org#60625,"PELANTARAN, CEMPAGA HULU, KOTAWARINGIN TIMUR, KALIMANTAN TENGAH",7,109,59,168
https://kawalpemilu.org#60625,"PELANTARAN, CEMPAGA HULU, KOTAWARINGIN TIMUR, KALIMANTAN TENGAH",8,49,30,79
https://kawalpemilu.org#60625,"PELANTARAN, CEMPAGA HULU, KOTAWARINGIN TIMUR, KALIMANTAN TENGAH",10,89,23,112
https://kawalpemilu.org#60625,"PELANTARAN, CEMPAGA HULU, KOTAWARINGIN TIMUR, KALIMANTAN TENGAH",12,79,21,100
https://kawalpemilu.org#60626,"TUMBANG KOLING, CEMPAGA HULU, KOTAWARINGIN TIMUR, KALIMANTAN TENGAH",1,170,7,177
https://kawalpemilu.org#60626,"TUMBANG KOLING, CEMPAGA HULU, KOTAWARINGIN TIMUR, KALIMANTAN TENGAH",2,129,13,142
https://kawalpemilu.org#60626,"TUMBANG KOLING, CEMPAGA HULU, KOTAWARINGIN TIMUR, KALIMANTAN TENGAH",3,108,4,112
https://kawalpemilu.org#60626,"TUMBANG KOLING, CEMPAGA HULU, KOTAWARINGIN TIMUR, KALIMANTAN TENGAH",4,39,4,43
https://kawalpemilu.org#60626,"TUMBANG KOLING, CEMPAGA HULU, KOTAWARINGIN TIMUR, KALIMANTAN TENGAH",5,65,8,73
https://kawalpemilu.org#60627,"SUDAN, CEMPAGA HULU, KOTAWARINGIN TIMUR, KALIMANTAN TENGAH",1,119,91,210
https://kawalpemilu.org#60627,"SUDAN, CEMPAGA HULU, KOTAWARINGIN TIMUR, KALIMANTAN TENGAH",2,100,49,149
https://kawalpemilu.org#60627,"SUDAN, CEMPAGA HULU, KOTAWARINGIN TIMUR, KALIMANTAN TENGAH",3,145,38,2
https://kawalpemilu.org#60628,"BUKIT BATU, CEMPAGA HULU, KOTAWARINGIN TIMUR, KALIMANTAN TENGAH",1,151,43,194
https://kawalpemilu.org#60628,"BUKIT BATU, CEMPAGA HULU, KOTAWARINGIN TIMUR, KALIMANTAN TENGAH",2,110,44,154
https://kawalpemilu.org#60628,"BUKIT BATU, CEMPAGA HULU, KOTAWARINGIN TIMUR, KALIMANTAN TENGAH",3,81,43,124
https://kawalpemilu.org#60629,"BUKIT RAYA, CEMPAGA HULU, KOTAWARINGIN TIMUR, KALIMANTAN TENGAH",1,25,33,58
https://kawalpemilu.org#60629,"BUKIT RAYA, CEMPAGA HULU, KOTAWARINGIN TIMUR, KALIMANTAN TENGAH",2,135,65,200
https://kawalpemilu.org#60629,"BUKIT RAYA, CEMPAGA HULU, KOTAWARINGIN TIMUR, KALIMANTAN TENGAH",3,175,44,219
https://kawalpemilu.org#60629,"BUKIT RAYA, CEMPAGA HULU, KOTAWARINGIN TIMUR, KALIMANTAN TENGAH",4,108,45,153
https://kawalpemilu.org#60629,"BUKIT RAYA, CEMPAGA HULU, KOTAWARINGIN TIMUR, KALIMANTAN TENGAH",5,133,37,170
https://kawalpemilu.org#60629,"BUKIT RAYA, CEMPAGA HULU, KOTAWARINGIN TIMUR, KALIMANTAN TENGAH",6,11,9,20
https://kawalpemilu.org#60630,"SUNGAI UBAR MANDIIRI, CEMPAGA HULU, KOTAWARINGIN TIMUR, KALIMANTAN TENGAH",1,117,37,154
https://kawalpemilu.org#60630,"SUNGAI UBAR MANDIIRI, CEMPAGA HULU, KOTAWARINGIN TIMUR, KALIMANTAN TENGAH",2,66,57,123
https://kawalpemilu.org#60630,"SUNGAI UBAR MANDIIRI, CEMPAGA HULU, KOTAWARINGIN TIMUR, KALIMANTAN TENGAH",3,79,27,106
https://kawalpemilu.org#60630,"SUNGAI UBAR MANDIIRI, CEMPAGA HULU, KOTAWARINGIN TIMUR, KALIMANTAN TENGAH",4,132,26,158
https://kawalpemilu.org#60630,"SUNGAI UBAR MANDIIRI, CEMPAGA HULU, KOTAWARINGIN TIMUR, KALIMANTAN TENGAH",5,17,7,24
https://kawalpemilu.org#60630,"SUNGAI UBAR MANDIIRI, CEMPAGA HULU, KOTAWARINGIN TIMUR, KALIMANTAN TENGAH",6,18,1,19
https://kawalpemilu.org#83957,"SELUCING, CEMPAGA HULU, KOTAWARINGIN TIMUR, KALIMANTAN TENGAH",1,142,22,164
https://kawalpemilu.org#60632,"SEBABI, TELAWANG, KOTAWARINGIN TIMUR, KALIMANTAN TENGAH",1,185,22,207
https://kawalpemilu.org#60632,"SEBABI, TELAWANG, KOTAWARINGIN TIMUR, KALIMANTAN TENGAH",2,157,22,179
https://kawalpemilu.org#60632,"SEBABI, TELAWANG, KOTAWARINGIN TIMUR, KALIMANTAN TENGAH",3,183,19,202
https://kawalpemilu.org#60632,"SEBABI, TELAWANG, KOTAWARINGIN TIMUR, KALIMANTAN TENGAH",4,167,28,195
https://kawalpemilu.org#60632,"SEBABI, TELAWANG, KOTAWARINGIN TIMUR, KALIMANTAN TENGAH",5,142,62,204
https://kawalpemilu.org#60632,"SEBABI, TELAWANG, KOTAWARINGIN TIMUR, KALIMANTAN TENGAH",6,154,32,186
https://kawalpemilu.org#60632,"SEBABI, TELAWANG, KOTAWARINGIN TIMUR, KALIMANTAN TENGAH",7,144,21,165
https://kawalpemilu.org#60632,"SEBABI, TELAWANG, KOTAWARINGIN TIMUR, KALIMANTAN TENGAH",8,107,16,123
https://kawalpemilu.org#60632,"SEBABI, TELAWANG, KOTAWARINGIN TIMUR, KALIMANTAN TENGAH",9,182,35,217
https://kawalpemilu.org#60632,"SEBABI, TELAWANG, KOTAWARINGIN TIMUR, KALIMANTAN TENGAH",10,139,59,190
https://kawalpemilu.org#60632,"SEBABI, TELAWANG, KOTAWARINGIN TIMUR, KALIMANTAN TENGAH",11,140,30,170
https://kawalpemilu.org#60632,"SEBABI, TELAWANG, KOTAWARINGIN TIMUR, KALIMANTAN TENGAH",12,209,29,238
https://kawalpemilu.org#60632,"SEBABI, TELAWANG, KOTAWARINGIN TIMUR, KALIMANTAN TENGAH",13,62,6,68
https://kawalpemilu.org#60632,"SEBABI, TELAWANG, KOTAWARINGIN TIMUR, KALIMANTAN TENGAH",14,64,8,72
https://kawalpemilu.org#60632,"SEBABI, TELAWANG, KOTAWARINGIN TIMUR, KALIMANTAN TENGAH",15,94,11,105
https://kawalpemilu.org#60632,"SEBABI, TELAWANG, KOTAWARINGIN TIMUR, KALIMANTAN TENGAH",16,74,7,81
https://kawalpemilu.org#60632,"SEBABI, TELAWANG, KOTAWARINGIN TIMUR, KALIMANTAN TENGAH",17,30,5,35
https://kawalpemilu.org#60632,"SEBABI, TELAWANG, KOTAWARINGIN TIMUR, KALIMANTAN TENGAH",18,35,8,43
https://kawalpemilu.org#60632,"SEBABI, TELAWANG, KOTAWARINGIN TIMUR, KALIMANTAN TENGAH",19,119,23,142
https://kawalpemilu.org#60632,"SEBABI, TELAWANG, KOTAWARINGIN TIMUR, KALIMANTAN TENGAH",20,35,15,50
https://kawalpemilu.org#60632,"SEBABI, TELAWANG, KOTAWARINGIN TIMUR, KALIMANTAN TENGAH",21,9,8,17
https://kawalpemilu.org#60632,"SEBABI, TELAWANG, KOTAWARINGIN TIMUR, KALIMANTAN TENGAH",22,48,22,70
https://kawalpemilu.org#60632,"SEBABI, TELAWANG, KOTAWARINGIN TIMUR, KALIMANTAN TENGAH",24,174,21,195
https://kawalpemilu.org#60633,"TANAH PUTIH, TELAWANG, KOTAWARINGIN TIMUR, KALIMANTAN TENGAH",1,102,9,111
https://kawalpemilu.org#60633,"TANAH PUTIH, TELAWANG, KOTAWARINGIN TIMUR, KALIMANTAN TENGAH",2,167,15,182
https://kawalpemilu.org#60633,"TANAH PUTIH, TELAWANG, KOTAWARINGIN TIMUR, KALIMANTAN TENGAH",3,156,19,175
https://kawalpemilu.org#60633,"TANAH PUTIH, TELAWANG, KOTAWARINGIN TIMUR, KALIMANTAN TENGAH",4,28,38,66
https://kawalpemilu.org#60633,"TANAH PUTIH, TELAWANG, KOTAWARINGIN TIMUR, KALIMANTAN TENGAH",5,59,43,102
https://kawalpemilu.org#60633,"TANAH PUTIH, TELAWANG, KOTAWARINGIN TIMUR, KALIMANTAN TENGAH",6,147,27,174
https://kawalpemilu.org#60633,"TANAH PUTIH, TELAWANG, KOTAWARINGIN TIMUR, KALIMANTAN TENGAH",7,119,17,136
https://kawalpemilu.org#60633,"TANAH PUTIH, TELAWANG, KOTAWARINGIN TIMUR, KALIMANTAN TENGAH",8,55,6,61
https://kawalpemilu.org#60633,"TANAH PUTIH, TELAWANG, KOTAWARINGIN TIMUR, KALIMANTAN TENGAH",9,23,6,29
https://kawalpemilu.org#60633,"TANAH PUTIH, TELAWANG, KOTAWARINGIN TIMUR, KALIMANTAN TENGAH",10,52,14,66
https://kawalpemilu.org#60633,"TANAH PUTIH, TELAWANG, KOTAWARINGIN TIMUR, KALIMANTAN TENGAH",11,47,8,55
https://kawalpemilu.org#60633,"TANAH PUTIH, TELAWANG, KOTAWARINGIN TIMUR, KALIMANTAN TENGAH",12,53,12,65
https://kawalpemilu.org#60633,"TANAH PUTIH, TELAWANG, KOTAWARINGIN TIMUR, KALIMANTAN TENGAH",13,39,4,43
https://kawalpemilu.org#60633,"TANAH PUTIH, TELAWANG, KOTAWARINGIN TIMUR, KALIMANTAN TENGAH",14,32,7,39
https://kawalpemilu.org#60633,"TANAH PUTIH, TELAWANG, KOTAWARINGIN TIMUR, KALIMANTAN TENGAH",15,156,42,198
https://kawalpemilu.org#60634,"SUMBER MAKMUR, TELAWANG, KOTAWARINGIN TIMUR, KALIMANTAN TENGAH",1,190,27,217
https://kawalpemilu.org#60634,"SUMBER MAKMUR, TELAWANG, KOTAWARINGIN TIMUR, KALIMANTAN TENGAH",2,141,24,165
https://kawalpemilu.org#60634,"SUMBER MAKMUR, TELAWANG, KOTAWARINGIN TIMUR, KALIMANTAN TENGAH",3,174,29,203
https://kawalpemilu.org#60634,"SUMBER MAKMUR, TELAWANG, KOTAWARINGIN TIMUR, KALIMANTAN TENGAH",4,77,17,94
https://kawalpemilu.org#60634,"SUMBER MAKMUR, TELAWANG, KOTAWARINGIN TIMUR, KALIMANTAN TENGAH",5,46,11,57
https://kawalpemilu.org#60634,"SUMBER MAKMUR, TELAWANG, KOTAWARINGIN TIMUR, KALIMANTAN TENGAH",6,41,7,48
https://kawalpemilu.org#60635,"KENYALA, TELAWANG, KOTAWARINGIN TIMUR, KALIMANTAN TENGAH",1,142,24,166
https://kawalpemilu.org#60635,"KENYALA, TELAWANG, KOTAWARINGIN TIMUR, KALIMANTAN TENGAH",2,114,40,154
https://kawalpemilu.org#60635,"KENYALA, TELAWANG, KOTAWARINGIN TIMUR, KALIMANTAN TENGAH",3,152,33,185
https://kawalpemilu.org#60635,"KENYALA, TELAWANG, KOTAWARINGIN TIMUR, KALIMANTAN TENGAH",4,40,24,64
https://kawalpemilu.org#60635,"KENYALA, TELAWANG, KOTAWARINGIN TIMUR, KALIMANTAN TENGAH",5,21,7,28
https://kawalpemilu.org#60635,"KENYALA, TELAWANG, KOTAWARINGIN TIMUR, KALIMANTAN TENGAH",6,29,8,37
https://kawalpemilu.org#60635,"KENYALA, TELAWANG, KOTAWARINGIN TIMUR, KALIMANTAN TENGAH",7,42,17,59
https://kawalpemilu.org#60636,"PENYANG, TELAWANG, KOTAWARINGIN TIMUR, KALIMANTAN TENGAH",1,176,19,195
https://kawalpemilu.org#60636,"PENYANG, TELAWANG, KOTAWARINGIN TIMUR, KALIMANTAN TENGAH",2,204,29,233
https://kawalpemilu.org#60636,"PENYANG, TELAWANG, KOTAWARINGIN TIMUR, KALIMANTAN TENGAH",3,127,14,141
https://kawalpemilu.org#60636,"PENYANG, TELAWANG, KOTAWARINGIN TIMUR, KALIMANTAN TENGAH",4,100,50,150
https://kawalpemilu.org#60636,"PENYANG, TELAWANG, KOTAWARINGIN TIMUR, KALIMANTAN TENGAH",6,60,10,70
https://kawalpemilu.org#60636,"PENYANG, TELAWANG, KOTAWARINGIN TIMUR, KALIMANTAN TENGAH",7,75,14,89
https://kawalpemilu.org#60636,"PENYANG, TELAWANG, KOTAWARINGIN TIMUR, KALIMANTAN TENGAH",8,71,12,83
https://kawalpemilu.org#60637,"BIRU MAJU, TELAWANG, KOTAWARINGIN TIMUR, KALIMANTAN TENGAH",1,93,14,107
https://kawalpemilu.org#60637,"BIRU MAJU, TELAWANG, KOTAWARINGIN TIMUR, KALIMANTAN TENGAH",2,114,17,131
https://kawalpemilu.org#60637,"BIRU MAJU, TELAWANG, KOTAWARINGIN TIMUR, KALIMANTAN TENGAH",3,106,27,133
https://kawalpemilu.org#60637,"BIRU MAJU, TELAWANG, KOTAWARINGIN TIMUR, KALIMANTAN TENGAH",4,31,9,40
https://kawalpemilu.org#60637,"BIRU MAJU, TELAWANG, KOTAWARINGIN TIMUR, KALIMANTAN TENGAH",5,54,9,63
https://kawalpemilu.org#60637,"BIRU MAJU, TELAWANG, KOTAWARINGIN TIMUR, KALIMANTAN TENGAH",6,15,4,19
https://kawalpemilu.org#60637,"BIRU MAJU, TELAWANG, KOTAWARINGIN TIMUR, KALIMANTAN TENGAH",7,37,6,43
https://kawalpemilu.org#60639,"TUMBANG TILAP, BUKIT SANTUAI, KOTAWARINGIN TIMUR, KALIMANTAN TENGAH",1,142,7,149
https://kawalpemilu.org#60640,"TUMBANG KAMINTING, BUKIT SANTUAI, KOTAWARINGIN TIMUR, KALIMANTAN TENGAH",1,132,46,178
https://kawalpemilu.org#60640,"TUMBANG KAMINTING, BUKIT SANTUAI, KOTAWARINGIN TIMUR, KALIMANTAN TENGAH",2,158,36,194
https://kawalpemilu.org#60640,"TUMBANG KAMINTING, BUKIT SANTUAI, KOTAWARINGIN TIMUR, KALIMANTAN TENGAH",3,51,21,72
https://kawalpemilu.org#60640,"TUMBANG KAMINTING, BUKIT SANTUAI, KOTAWARINGIN TIMUR, KALIMANTAN TENGAH",4,155,18,173
https://kawalpemilu.org#60640,"TUMBANG KAMINTING, BUKIT SANTUAI, KOTAWARINGIN TIMUR, KALIMANTAN TENGAH",5,315,54,369
https://kawalpemilu.org#60641,"TANAH HALUAN, BUKIT SANTUAI, KOTAWARINGIN TIMUR, KALIMANTAN TENGAH",1,106,29,135
https://kawalpemilu.org#60642,"TUMBANG PENYAHUAN, BUKIT SANTUAI, KOTAWARINGIN TIMUR, KALIMANTAN TENGAH",1,99,42,141
https://kawalpemilu.org#60642,"TUMBANG PENYAHUAN, BUKIT SANTUAI, KOTAWARINGIN TIMUR, KALIMANTAN TENGAH",2,87,48,135
https://kawalpemilu.org#60642,"TUMBANG PENYAHUAN, BUKIT SANTUAI, KOTAWARINGIN TIMUR, KALIMANTAN TENGAH",3,89,25,114
https://kawalpemilu.org#60642,"TUMBANG PENYAHUAN, BUKIT SANTUAI, KOTAWARINGIN TIMUR, KALIMANTAN TENGAH",4,91,69,160
https://kawalpemilu.org#60642,"TUMBANG PENYAHUAN, BUKIT SANTUAI, KOTAWARINGIN TIMUR, KALIMANTAN TENGAH",5,73,23,96
https://kawalpemilu.org#60642,"TUMBANG PENYAHUAN, BUKIT SANTUAI, KOTAWARINGIN TIMUR, KALIMANTAN TENGAH",6,73,22,95
https://kawalpemilu.org#60642,"TUMBANG PENYAHUAN, BUKIT SANTUAI, KOTAWARINGIN TIMUR, KALIMANTAN TENGAH",7,71,23,94
https://kawalpemilu.org#60642,"TUMBANG PENYAHUAN, BUKIT SANTUAI, KOTAWARINGIN TIMUR, KALIMANTAN TENGAH",8,88,17,105
https://kawalpemilu.org#60643,"TUMBANG SAPIA, BUKIT SANTUAI, KOTAWARINGIN TIMUR, KALIMANTAN TENGAH",1,56,20,76
https://kawalpemilu.org#60644,"TUMBANG GETAS, BUKIT SANTUAI, KOTAWARINGIN TIMUR, KALIMANTAN TENGAH",1,96,20,116
https://kawalpemilu.org#60645,"TEWEI HARA, BUKIT SANTUAI, KOTAWARINGIN TIMUR, KALIMANTAN TENGAH",1,89,48,137
https://kawalpemilu.org#60645,"TEWEI HARA, BUKIT SANTUAI, KOTAWARINGIN TIMUR, KALIMANTAN TENGAH",2,126,34,160
https://kawalpemilu.org#60646,"TUMBANG PAYANG, BUKIT SANTUAI, KOTAWARINGIN TIMUR, KALIMANTAN TENGAH",1,66,14,80
https://kawalpemilu.org#60646,"TUMBANG PAYANG, BUKIT SANTUAI, KOTAWARINGIN TIMUR, KALIMANTAN TENGAH",2,76,27,103
https://kawalpemilu.org#60646,"TUMBANG PAYANG, BUKIT SANTUAI, KOTAWARINGIN TIMUR, KALIMANTAN TENGAH",3,69,10,79
https://kawalpemilu.org#60646,"TUMBANG PAYANG, BUKIT SANTUAI, KOTAWARINGIN TIMUR, KALIMANTAN TENGAH",4,48,17,65
https://kawalpemilu.org#60646,"TUMBANG PAYANG, BUKIT SANTUAI, KOTAWARINGIN TIMUR, KALIMANTAN TENGAH",5,56,14,70
https://kawalpemilu.org#60646,"TUMBANG PAYANG, BUKIT SANTUAI, KOTAWARINGIN TIMUR, KALIMANTAN TENGAH",6,58,19,77
https://kawalpemilu.org#60646,"TUMBANG PAYANG, BUKIT SANTUAI, KOTAWARINGIN TIMUR, KALIMANTAN TENGAH",7,19,3,22
https://kawalpemilu.org#60646,"TUMBANG PAYANG, BUKIT SANTUAI, KOTAWARINGIN TIMUR, KALIMANTAN TENGAH",8,39,19,58
https://kawalpemilu.org#60646,"TUMBANG PAYANG, BUKIT SANTUAI, KOTAWARINGIN TIMUR, KALIMANTAN TENGAH",9,64,22,86
https://kawalpemilu.org#60647,"TUMBANG KANIA, BUKIT SANTUAI, KOTAWARINGIN TIMUR, KALIMANTAN TENGAH",1,84,15,99
https://kawalpemilu.org#60648,"TUMBANG TAWAN, BUKIT SANTUAI, KOTAWARINGIN TIMUR, KALIMANTAN TENGAH",1,144,26,170
https://kawalpemilu.org#60649,"LUNUK BAGANTUNG, BUKIT SANTUAI, KOTAWARINGIN TIMUR, KALIMANTAN TENGAH",1,115,12,127
https://kawalpemilu.org#60650,"TUMBANG TORUNG, BUKIT SANTUAI, KOTAWARINGIN TIMUR, KALIMANTAN TENGAH",1,89,5,94
https://kawalpemilu.org#60650,"TUMBANG TORUNG, BUKIT SANTUAI, KOTAWARINGIN TIMUR, KALIMANTAN TENGAH",2,84,17,101
https://kawalpemilu.org#60650,"TUMBANG TORUNG, BUKIT SANTUAI, KOTAWARINGIN TIMUR, KALIMANTAN TENGAH",3,85,35,120
https://kawalpemilu.org#60651,"TUMBANG BATU, BUKIT SANTUAI, KOTAWARINGIN TIMUR, KALIMANTAN TENGAH",1,110,26,136
https://kawalpemilu.org#60651,"TUMBANG BATU, BUKIT SANTUAI, KOTAWARINGIN TIMUR, KALIMANTAN TENGAH",2,119,36,155
https://kawalpemilu.org#60651,"TUMBANG BATU, BUKIT SANTUAI, KOTAWARINGIN TIMUR, KALIMANTAN TENGAH",3,107,29,136
https://kawalpemilu.org#60652,"TUMBANG SALUANG, BUKIT SANTUAI, KOTAWARINGIN TIMUR, KALIMANTAN TENGAH",1,72,10,82
https://kawalpemilu.org#60513,"TANJUNG JORONG, TUALAN HULU, KOTAWARINGIN TIMUR, KALIMANTAN TENGAH",1,150,19,169
https://kawalpemilu.org#60513,"TANJUNG JORONG, TUALAN HULU, KOTAWARINGIN TIMUR, KALIMANTAN TENGAH",2,110,13,123
https://kawalpemilu.org#60515,"LUWUK SAMPUN, TUALAN HULU, KOTAWARINGIN TIMUR, KALIMANTAN TENGAH",1,120,6,126
https://kawalpemilu.org#60515,"LUWUK SAMPUN, TUALAN HULU, KOTAWARINGIN TIMUR, KALIMANTAN TENGAH",2,117,5,122
https://kawalpemilu.org#60521,"TUMBANG MUJAM, TUALAN HULU, KOTAWARINGIN TIMUR, KALIMANTAN TENGAH",1,168,20,188
https://kawalpemilu.org#60524,"WONOSARI, TUALAN HULU, KOTAWARINGIN TIMUR, KALIMANTAN TENGAH",1,200,15,215
https://kawalpemilu.org#60524,"WONOSARI, TUALAN HULU, KOTAWARINGIN TIMUR, KALIMANTAN TENGAH",2,190,32,222
https://kawalpemilu.org#60524,"WONOSARI, TUALAN HULU, KOTAWARINGIN TIMUR, KALIMANTAN TENGAH",3,87,10,97
https://kawalpemilu.org#60525,"BUKIT MAKMUR, TUALAN HULU, KOTAWARINGIN TIMUR, KALIMANTAN TENGAH",1,113,9,122
https://kawalpemilu.org#60525,"BUKIT MAKMUR, TUALAN HULU, KOTAWARINGIN TIMUR, KALIMANTAN TENGAH",2,186,18,204
https://kawalpemilu.org#60525,"BUKIT MAKMUR, TUALAN HULU, KOTAWARINGIN TIMUR, KALIMANTAN TENGAH",3,120,13,133
https://kawalpemilu.org#60527,"DAMAR MAKMUR, TUALAN HULU, KOTAWARINGIN TIMUR, KALIMANTAN TENGAH",1,207,11,218
https://kawalpemilu.org#60527,"DAMAR MAKMUR, TUALAN HULU, KOTAWARINGIN TIMUR, KALIMANTAN TENGAH",2,121,16,137
https://kawalpemilu.org#60528,"MEKAR SARI, TUALAN HULU, KOTAWARINGIN TIMUR, KALIMANTAN TENGAH",1,150,10,160
https://kawalpemilu.org#60529,"CEMPAKA PUTIH, TUALAN HULU, KOTAWARINGIN TIMUR, KALIMANTAN TENGAH",1,120,17,137
https://kawalpemilu.org#60529,"CEMPAKA PUTIH, TUALAN HULU, KOTAWARINGIN TIMUR, KALIMANTAN TENGAH",2,153,30,183
https://kawalpemilu.org#60529,"CEMPAKA PUTIH, TUALAN HULU, KOTAWARINGIN TIMUR, KALIMANTAN TENGAH",3,121,16,137
https://kawalpemilu.org#60529,"CEMPAKA PUTIH, TUALAN HULU, KOTAWARINGIN TIMUR, KALIMANTAN TENGAH",4,73,9,82
https://kawalpemilu.org#60531,"JATI WARINGIN, TUALAN HULU, KOTAWARINGIN TIMUR, KALIMANTAN TENGAH",1,118,15,133
https://kawalpemilu.org#60531,"JATI WARINGIN, TUALAN HULU, KOTAWARINGIN TIMUR, KALIMANTAN TENGAH",2,108,8,116
https://kawalpemilu.org#60531,"JATI WARINGIN, TUALAN HULU, KOTAWARINGIN TIMUR, KALIMANTAN TENGAH",3,135,17,152
https://kawalpemilu.org#60531,"JATI WARINGIN, TUALAN HULU, KOTAWARINGIN TIMUR, KALIMANTAN TENGAH",4,106,19,125
https://kawalpemilu.org#85371,"SEBUNGSU, TUALAN HULU, KOTAWARINGIN TIMUR, KALIMANTAN TENGAH",1,235,9,244
https://kawalpemilu.org#85371,"SEBUNGSU, TUALAN HULU, KOTAWARINGIN TIMUR, KALIMANTAN TENGAH",2,46,2,48
https://kawalpemilu.org#88422,"MERAH, TUALAN HULU, KOTAWARINGIN TIMUR, KALIMANTAN TENGAH",1,124,10,134
https://kawalpemilu.org#60505,"BUANA MUSTIKA, TELAGA ANTANG, KOTAWARINGIN TIMUR, KALIMANTAN TENGAH",1,170,20,190
https://kawalpemilu.org#60505,"BUANA MUSTIKA, TELAGA ANTANG, KOTAWARINGIN TIMUR, KALIMANTAN TENGAH",2,148,28,176
https://kawalpemilu.org#60505,"BUANA MUSTIKA, TELAGA ANTANG, KOTAWARINGIN TIMUR, KALIMANTAN TENGAH",3,145,26,171
https://kawalpemilu.org#60505,"BUANA MUSTIKA, TELAGA ANTANG, KOTAWARINGIN TIMUR, KALIMANTAN TENGAH",4,150,32,182
https://kawalpemilu.org#60505,"BUANA MUSTIKA, TELAGA ANTANG, KOTAWARINGIN TIMUR, KALIMANTAN TENGAH",5,155,25,180
https://kawalpemilu.org#60505,"BUANA MUSTIKA, TELAGA ANTANG, KOTAWARINGIN TIMUR, KALIMANTAN TENGAH",6,118,17,135
https://kawalpemilu.org#60506,"TANJUNG HARAPAN, TELAGA ANTANG, KOTAWARINGIN TIMUR, KALIMANTAN TENGAH",1,146,52,198
https://kawalpemilu.org#60506,"TANJUNG HARAPAN, TELAGA ANTANG, KOTAWARINGIN TIMUR, KALIMANTAN TENGAH",2,142,34,176
https://kawalpemilu.org#60506,"TANJUNG HARAPAN, TELAGA ANTANG, KOTAWARINGIN TIMUR, KALIMANTAN TENGAH",3,181,35,216
https://kawalpemilu.org#60506,"TANJUNG HARAPAN, TELAGA ANTANG, KOTAWARINGIN TIMUR, KALIMANTAN TENGAH",4,182,33,215
https://kawalpemilu.org#60506,"TANJUNG HARAPAN, TELAGA ANTANG, KOTAWARINGIN TIMUR, KALIMANTAN TENGAH",5,154,26,180
https://kawalpemilu.org#60506,"TANJUNG HARAPAN, TELAGA ANTANG, KOTAWARINGIN TIMUR, KALIMANTAN TENGAH",6,140,26,166
https://kawalpemilu.org#60506,"TANJUNG HARAPAN, TELAGA ANTANG, KOTAWARINGIN TIMUR, KALIMANTAN TENGAH",7,97,17,114
https://kawalpemilu.org#60587,"TUMBANG BOLOI, TELAGA ANTANG, KOTAWARINGIN TIMUR, KALIMANTAN TENGAH",1,134,20,154
https://kawalpemilu.org#60587,"TUMBANG BOLOI, TELAGA ANTANG, KOTAWARINGIN TIMUR, KALIMANTAN TENGAH",2,134,15,149
https://kawalpemilu.org#60589,"LUWUK KUWAN, TELAGA ANTANG, KOTAWARINGIN TIMUR, KALIMANTAN TENGAH",1,136,16,152
https://kawalpemilu.org#60589,"LUWUK KUWAN, TELAGA ANTANG, KOTAWARINGIN TIMUR, KALIMANTAN TENGAH",2,70,4,74
https://kawalpemilu.org#60590,"TUMBANG MANGKUP, TELAGA ANTANG, KOTAWARINGIN TIMUR, KALIMANTAN TENGAH",1,102,41,143
https://kawalpemilu.org#60590,"TUMBANG MANGKUP, TELAGA ANTANG, KOTAWARINGIN TIMUR, KALIMANTAN TENGAH",2,86,56,142
https://kawalpemilu.org#60591,"RANTAU KATANG, TELAGA ANTANG, KOTAWARINGIN TIMUR, KALIMANTAN TENGAH",1,114,53,167
https://kawalpemilu.org#60591,"RANTAU KATANG, TELAGA ANTANG, KOTAWARINGIN TIMUR, KALIMANTAN TENGAH",2,83,35,118
https://kawalpemilu.org#60591,"RANTAU KATANG, TELAGA ANTANG, KOTAWARINGIN TIMUR, KALIMANTAN TENGAH",3,95,34,129
https://kawalpemilu.org#60591,"RANTAU KATANG, TELAGA ANTANG, KOTAWARINGIN TIMUR, KALIMANTAN TENGAH",4,104,30,134
https://kawalpemilu.org#60592,"TUMBANG SANGAI, TELAGA ANTANG, KOTAWARINGIN TIMUR, KALIMANTAN TENGAH",1,146,22,168
https://kawalpemilu.org#60592,"TUMBANG SANGAI, TELAGA ANTANG, KOTAWARINGIN TIMUR, KALIMANTAN TENGAH",2,66,25,91
https://kawalpemilu.org#60592,"TUMBANG SANGAI, TELAGA ANTANG, KOTAWARINGIN TIMUR, KALIMANTAN TENGAH",3,138,38,176
https://kawalpemilu.org#60592,"TUMBANG SANGAI, TELAGA ANTANG, KOTAWARINGIN TIMUR, KALIMANTAN TENGAH",4,119,40,159
https://kawalpemilu.org#60592,"TUMBANG SANGAI, TELAGA ANTANG, KOTAWARINGIN TIMUR, KALIMANTAN TENGAH",5,108,33,141
https://kawalpemilu.org#60592,"TUMBANG SANGAI, TELAGA ANTANG, KOTAWARINGIN TIMUR, KALIMANTAN TENGAH",6,146,40,186
https://kawalpemilu.org#60592,"TUMBANG SANGAI, TELAGA ANTANG, KOTAWARINGIN TIMUR, KALIMANTAN TENGAH",7,77,17,94
https://kawalpemilu.org#60593,"TUKANG LANGIT, TELAGA ANTANG, KOTAWARINGIN TIMUR, KALIMANTAN TENGAH",1,93,36,129
https://kawalpemilu.org#60596,"RANTAU SUANG, TELAGA ANTANG, KOTAWARINGIN TIMUR, KALIMANTAN TENGAH",1,158,1,159
https://kawalpemilu.org#60597,"RANTAU SAWANG, TELAGA ANTANG, KOTAWARINGIN TIMUR, KALIMANTAN TENGAH",1,111,1,112
https://kawalpemilu.org#60598,"TUMBANG PUAN, TELAGA ANTANG, KOTAWARINGIN TIMUR, KALIMANTAN TENGAH",1,141,16,157
https://kawalpemilu.org#60598,"TUMBANG PUAN, TELAGA ANTANG, KOTAWARINGIN TIMUR, KALIMANTAN TENGAH",2,164,9,173
https://kawalpemilu.org#60598,"TUMBANG PUAN, TELAGA ANTANG, KOTAWARINGIN TIMUR, KALIMANTAN TENGAH",3,118,7,125
https://kawalpemilu.org#60600,"RANTAU TAMPANG, TELAGA ANTANG, KOTAWARINGIN TIMUR, KALIMANTAN TENGAH",1,161,18,179
https://kawalpemilu.org#60600,"RANTAU TAMPANG, TELAGA ANTANG, KOTAWARINGIN TIMUR, KALIMANTAN TENGAH",2,143,18,161
https://kawalpemilu.org#60601,"BERINGIN AGUNG, TELAGA ANTANG, KOTAWARINGIN TIMUR, KALIMANTAN TENGAH",1,171,16,187
https://kawalpemilu.org#60601,"BERINGIN AGUNG, TELAGA ANTANG, KOTAWARINGIN TIMUR, KALIMANTAN TENGAH",2,180,13,193
https://kawalpemilu.org#60601,"BERINGIN AGUNG, TELAGA ANTANG, KOTAWARINGIN TIMUR, KALIMANTAN TENGAH",3,33,10,43
https://kawalpemilu.org#60601,"BERINGIN AGUNG, TELAGA ANTANG, KOTAWARINGIN TIMUR, KALIMANTAN TENGAH",4,32,6,38
https://kawalpemilu.org#60601,"BERINGIN AGUNG, TELAGA ANTANG, KOTAWARINGIN TIMUR, KALIMANTAN TENGAH",5,39,6,45
https://kawalpemilu.org#60601,"BERINGIN AGUNG, TELAGA ANTANG, KOTAWARINGIN TIMUR, KALIMANTAN TENGAH",6,17,2,19
https://kawalpemilu.org#60601,"BERINGIN AGUNG, TELAGA ANTANG, KOTAWARINGIN TIMUR, KALIMANTAN TENGAH",7,70,13,83
https://kawalpemilu.org#60602,"BATU AGUNG, TELAGA ANTANG, KOTAWARINGIN TIMUR, KALIMANTAN TENGAH",1,155,13,168
https://kawalpemilu.org#60602,"BATU AGUNG, TELAGA ANTANG, KOTAWARINGIN TIMUR, KALIMANTAN TENGAH",2,162,14,176
https://kawalpemilu.org#60602,"BATU AGUNG, TELAGA ANTANG, KOTAWARINGIN TIMUR, KALIMANTAN TENGAH",3,179,26,205
https://kawalpemilu.org#60602,"BATU AGUNG, TELAGA ANTANG, KOTAWARINGIN TIMUR, KALIMANTAN TENGAH",4,119,7,126
https://kawalpemilu.org#60604,"BUKIT INDAH, TELAGA ANTANG, KOTAWARINGIN TIMUR, KALIMANTAN TENGAH",1,143,6,149
https://kawalpemilu.org#60604,"BUKIT INDAH, TELAGA ANTANG, KOTAWARINGIN TIMUR, KALIMANTAN TENGAH",2,158,8,166
https://kawalpemilu.org#60604,"BUKIT INDAH, TELAGA ANTANG, KOTAWARINGIN TIMUR, KALIMANTAN TENGAH",3,172,8,180
https://kawalpemilu.org#60604,"BUKIT INDAH, TELAGA ANTANG, KOTAWARINGIN TIMUR, KALIMANTAN TENGAH",4,131,12,143
https://kawalpemilu.org#60604,"BUKIT INDAH, TELAGA ANTANG, KOTAWARINGIN TIMUR, KALIMANTAN TENGAH",5,99,4,103
https://kawalpemilu.org#60608,"AGUNG MULYA, TELAGA ANTANG, KOTAWARINGIN TIMUR, KALIMANTAN TENGAH",1,142,70,212
https://kawalpemilu.org#60608,"AGUNG MULYA, TELAGA ANTANG, KOTAWARINGIN TIMUR, KALIMANTAN TENGAH",2,149,55,204
https://kawalpemilu.org#60608,"AGUNG MULYA, TELAGA ANTANG, KOTAWARINGIN TIMUR, KALIMANTAN TENGAH",3,149,71,220
https://kawalpemilu.org#60608,"AGUNG MULYA, TELAGA ANTANG, KOTAWARINGIN TIMUR, KALIMANTAN TENGAH",4,152,48,200
https://kawalpemilu.org#60608,"AGUNG MULYA, TELAGA ANTANG, KOTAWARINGIN TIMUR, KALIMANTAN TENGAH",5,176,27,203
https://kawalpemilu.org#85372,"TRI BUANA, TELAGA ANTANG, KOTAWARINGIN TIMUR, KALIMANTAN TENGAH",1,175,7,182
https://kawalpemilu.org#85372,"TRI BUANA, TELAGA ANTANG, KOTAWARINGIN TIMUR, KALIMANTAN TENGAH",2,126,7,133
https://kawalpemilu.org#927582,"TUMBANG BAJANEI, TELAGA ANTANG, KOTAWARINGIN TIMUR, KALIMANTAN TENGAH",1,95,33,128
https://kawalpemilu.org#60655,"MURUNG KERAMAT, SELAT, KAPUAS, KALIMANTAN TENGAH",1,30,66,96
https://kawalpemilu.org#60655,"MURUNG KERAMAT, SELAT, KAPUAS, KALIMANTAN TENGAH",2,50,67,117
https://kawalpemilu.org#60655,"MURUNG KERAMAT, SELAT, KAPUAS, KALIMANTAN TENGAH",3,0,0,0
https://kawalpemilu.org#60655,"MURUNG KERAMAT, SELAT, KAPUAS, KALIMANTAN TENGAH",4,39,86,125
https://kawalpemilu.org#60655,"MURUNG KERAMAT, SELAT, KAPUAS, KALIMANTAN TENGAH",5,76,147,223
https://kawalpemilu.org#60655,"MURUNG KERAMAT, SELAT, KAPUAS, KALIMANTAN TENGAH",6,43,87,114
https://kawalpemilu.org#60655,"MURUNG KERAMAT, SELAT, KAPUAS, KALIMANTAN TENGAH",7,82,136,218
https://kawalpemilu.org#60655,"MURUNG KERAMAT, SELAT, KAPUAS, KALIMANTAN TENGAH",8,55,46,101
https://kawalpemilu.org#60655,"MURUNG KERAMAT, SELAT, KAPUAS, KALIMANTAN TENGAH",9,14,47,61
https://kawalpemilu.org#60655,"MURUNG KERAMAT, SELAT, KAPUAS, KALIMANTAN TENGAH",10,56,82,138
https://kawalpemilu.org#60655,"MURUNG KERAMAT, SELAT, KAPUAS, KALIMANTAN TENGAH",11,43,55,98
https://kawalpemilu.org#60655,"MURUNG KERAMAT, SELAT, KAPUAS, KALIMANTAN TENGAH",12,50,75,125
https://kawalpemilu.org#60655,"MURUNG KERAMAT, SELAT, KAPUAS, KALIMANTAN TENGAH",13,38,88,126
https://kawalpemilu.org#60655,"MURUNG KERAMAT, SELAT, KAPUAS, KALIMANTAN TENGAH",14,93,66,159
https://kawalpemilu.org#60656,"SELAT HILIR, SELAT, KAPUAS, KALIMANTAN TENGAH",1,42,134,176
https://kawalpemilu.org#60656,"SELAT HILIR, SELAT, KAPUAS, KALIMANTAN TENGAH",2,24,63,87
https://kawalpemilu.org#60656,"SELAT HILIR, SELAT, KAPUAS, KALIMANTAN TENGAH",3,41,118,159
https://kawalpemilu.org#60656,"SELAT HILIR, SELAT, KAPUAS, KALIMANTAN TENGAH",4,39,52,91
https://kawalpemilu.org#60656,"SELAT HILIR, SELAT, KAPUAS, KALIMANTAN TENGAH",6,80,45,125
https://kawalpemilu.org#60656,"SELAT HILIR, SELAT, KAPUAS, KALIMANTAN TENGAH",7,47,53,100
https://kawalpemilu.org#60656,"SELAT HILIR, SELAT, KAPUAS, KALIMANTAN TENGAH",8,20,28,48
https://kawalpemilu.org#60656,"SELAT HILIR, SELAT, KAPUAS, KALIMANTAN TENGAH",9,105,76,181
https://kawalpemilu.org#60656,"SELAT HILIR, SELAT, KAPUAS, KALIMANTAN TENGAH",10,51,82,133
https://kawalpemilu.org#60656,"SELAT HILIR, SELAT, KAPUAS, KALIMANTAN TENGAH",11,83,89,172
https://kawalpemilu.org#60656,"SELAT HILIR, SELAT, KAPUAS, KALIMANTAN TENGAH",12,151,59,210
https://kawalpemilu.org#60656,"SELAT HILIR, SELAT, KAPUAS, KALIMANTAN TENGAH",13,50,42,92
https://kawalpemilu.org#60656,"SELAT HILIR, SELAT, KAPUAS, KALIMANTAN TENGAH",14,78,74,152
https://kawalpemilu.org#60656,"SELAT HILIR, SELAT, KAPUAS, KALIMANTAN TENGAH",15,39,135,174
https://kawalpemilu.org#60656,"SELAT HILIR, SELAT, KAPUAS, KALIMANTAN TENGAH",16,29,58,87
https://kawalpemilu.org#60656,"SELAT HILIR, SELAT, KAPUAS, KALIMANTAN TENGAH",17,32,119,151
https://kawalpemilu.org#60656,"SELAT HILIR, SELAT, KAPUAS, KALIMANTAN TENGAH",18,37,148,185
https://kawalpemilu.org#60656,"SELAT HILIR, SELAT, KAPUAS, KALIMANTAN TENGAH",19,39,197,236
https://kawalpemilu.org#60656,"SELAT HILIR, SELAT, KAPUAS, KALIMANTAN TENGAH",20,133,106,239
https://kawalpemilu.org#60656,"SELAT HILIR, SELAT, KAPUAS, KALIMANTAN TENGAH",21,112,143,255
https://kawalpemilu.org#60656,"SELAT HILIR, SELAT, KAPUAS, KALIMANTAN TENGAH",22,57,71,128
https://kawalpemilu.org#60656,"SELAT HILIR, SELAT, KAPUAS, KALIMANTAN TENGAH",23,12,78,90
https://kawalpemilu.org#60656,"SELAT HILIR, SELAT, KAPUAS, KALIMANTAN TENGAH",24,114,65,179
https://kawalpemilu.org#60656,"SELAT HILIR, SELAT, KAPUAS, KALIMANTAN TENGAH",25,99,113,212
https://kawalpemilu.org#60656,"SELAT HILIR, SELAT, KAPUAS, KALIMANTAN TENGAH",26,14,28,42
https://kawalpemilu.org#60656,"SELAT HILIR, SELAT, KAPUAS, KALIMANTAN TENGAH",27,31,43,74
https://kawalpemilu.org#60656,"SELAT HILIR, SELAT, KAPUAS, KALIMANTAN TENGAH",28,61,115,176
https://kawalpemilu.org#60656,"SELAT HILIR, SELAT, KAPUAS, KALIMANTAN TENGAH",29,49,95,144
https://kawalpemilu.org#60656,"SELAT HILIR, SELAT, KAPUAS, KALIMANTAN TENGAH",30,70,78,148
https://kawalpemilu.org#60656,"SELAT HILIR, SELAT, KAPUAS, KALIMANTAN TENGAH",31,46,24,70
https://kawalpemilu.org#60656,"SELAT HILIR, SELAT, KAPUAS, KALIMANTAN TENGAH",32,69,67,138
https://kawalpemilu.org#60656,"SELAT HILIR, SELAT, KAPUAS, KALIMANTAN TENGAH",33,26,52,78
https://kawalpemilu.org#60656,"SELAT HILIR, SELAT, KAPUAS, KALIMANTAN TENGAH",34,40,56,96
https://kawalpemilu.org#60656,"SELAT HILIR, SELAT, KAPUAS, KALIMANTAN TENGAH",35,29,72,101
https://kawalpemilu.org#60656,"SELAT HILIR, SELAT, KAPUAS, KALIMANTAN TENGAH",36,16,29,45
https://kawalpemilu.org#60656,"SELAT HILIR, SELAT, KAPUAS, KALIMANTAN TENGAH",37,69,95,164
https://kawalpemilu.org#60656,"SELAT HILIR, SELAT, KAPUAS, KALIMANTAN TENGAH",38,22,74,96
https://kawalpemilu.org#60656,"SELAT HILIR, SELAT, KAPUAS, KALIMANTAN TENGAH",39,99,79,178
https://kawalpemilu.org#60657,"SELAT TENGAH, SELAT, KAPUAS, KALIMANTAN TENGAH",1,44,172,216
https://kawalpemilu.org#60657,"SELAT TENGAH, SELAT, KAPUAS, KALIMANTAN TENGAH",2,22,159,181
https://kawalpemilu.org#60657,"SELAT TENGAH, SELAT, KAPUAS, KALIMANTAN TENGAH",3,38,94,132
https://kawalpemilu.org#60657,"SELAT TENGAH, SELAT, KAPUAS, KALIMANTAN TENGAH",4,33,236,269
https://kawalpemilu.org#60657,"SELAT TENGAH, SELAT, KAPUAS, KALIMANTAN TENGAH",5,19,78,97
https://kawalpemilu.org#60657,"SELAT TENGAH, SELAT, KAPUAS, KALIMANTAN TENGAH",6,23,121,144
https://kawalpemilu.org#60657,"SELAT TENGAH, SELAT, KAPUAS, KALIMANTAN TENGAH",8,24,78,102
https://kawalpemilu.org#60657,"SELAT TENGAH, SELAT, KAPUAS, KALIMANTAN TENGAH",9,50,170,220
https://kawalpemilu.org#60657,"SELAT TENGAH, SELAT, KAPUAS, KALIMANTAN TENGAH",10,25,115,140
https://kawalpemilu.org#60657,"SELAT TENGAH, SELAT, KAPUAS, KALIMANTAN TENGAH",11,53,196,249
https://kawalpemilu.org#60657,"SELAT TENGAH, SELAT, KAPUAS, KALIMANTAN TENGAH",12,30,168,198
https://kawalpemilu.org#60657,"SELAT TENGAH, SELAT, KAPUAS, KALIMANTAN TENGAH",13,36,184,220
https://kawalpemilu.org#60657,"SELAT TENGAH, SELAT, KAPUAS, KALIMANTAN TENGAH",14,0,0,191
https://kawalpemilu.org#60657,"SELAT TENGAH, SELAT, KAPUAS, KALIMANTAN TENGAH",15,17,66,83
https://kawalpemilu.org#60657,"SELAT TENGAH, SELAT, KAPUAS, KALIMANTAN TENGAH",16,17,138,155
https://kawalpemilu.org#60657,"SELAT TENGAH, SELAT, KAPUAS, KALIMANTAN TENGAH",17,28,123,151
https://kawalpemilu.org#60657,"SELAT TENGAH, SELAT, KAPUAS, KALIMANTAN TENGAH",18,15,145,160
https://kawalpemilu.org#60657,"SELAT TENGAH, SELAT, KAPUAS, KALIMANTAN TENGAH",19,35,230,265
https://kawalpemilu.org#60657,"SELAT TENGAH, SELAT, KAPUAS, KALIMANTAN TENGAH",20,53,123,176
https://kawalpemilu.org#60657,"SELAT TENGAH, SELAT, KAPUAS, KALIMANTAN TENGAH",21,33,92,125
https://kawalpemilu.org#60657,"SELAT TENGAH, SELAT, KAPUAS, KALIMANTAN TENGAH",22,44,179,223
https://kawalpemilu.org#60657,"SELAT TENGAH, SELAT, KAPUAS, KALIMANTAN TENGAH",23,17,139,156
https://kawalpemilu.org#60657,"SELAT TENGAH, SELAT, KAPUAS, KALIMANTAN TENGAH",24,30,96,126
https://kawalpemilu.org#60657,"SELAT TENGAH, SELAT, KAPUAS, KALIMANTAN TENGAH",25,12,80,92
https://kawalpemilu.org#60657,"SELAT TENGAH, SELAT, KAPUAS, KALIMANTAN TENGAH",26,44,131,175
https://kawalpemilu.org#60657,"SELAT TENGAH, SELAT, KAPUAS, KALIMANTAN TENGAH",27,55,127,182
https://kawalpemilu.org#60657,"SELAT TENGAH, SELAT, KAPUAS, KALIMANTAN TENGAH",28,74,66,140
https://kawalpemilu.org#60657,"SELAT TENGAH, SELAT, KAPUAS, KALIMANTAN TENGAH",29,95,87,182
https://kawalpemilu.org#60657,"SELAT TENGAH, SELAT, KAPUAS, KALIMANTAN TENGAH",30,137,35,172
https://kawalpemilu.org#60657,"SELAT TENGAH, SELAT, KAPUAS, KALIMANTAN TENGAH",31,50,135,185
https://kawalpemilu.org#60657,"SELAT TENGAH, SELAT, KAPUAS, KALIMANTAN TENGAH",32,47,120,167
https://kawalpemilu.org#60657,"SELAT TENGAH, SELAT, KAPUAS, KALIMANTAN TENGAH",33,61,118,179
https://kawalpemilu.org#60657,"SELAT TENGAH, SELAT, KAPUAS, KALIMANTAN TENGAH",34,84,129,213
https://kawalpemilu.org#60657,"SELAT TENGAH, SELAT, KAPUAS, KALIMANTAN TENGAH",35,54,119,173
https://kawalpemilu.org#60657,"SELAT TENGAH, SELAT, KAPUAS, KALIMANTAN TENGAH",36,61,182,243
https://kawalpemilu.org#60657,"SELAT TENGAH, SELAT, KAPUAS, KALIMANTAN TENGAH",37,63,61,124
https://kawalpemilu.org#60657,"SELAT TENGAH, SELAT, KAPUAS, KALIMANTAN TENGAH",39,35,72,107
https://kawalpemilu.org#60657,"SELAT TENGAH, SELAT, KAPUAS, KALIMANTAN TENGAH",40,16,53,69
https://kawalpemilu.org#60657,"SELAT TENGAH, SELAT, KAPUAS, KALIMANTAN TENGAH",41,21,126,147
https://kawalpemilu.org#60657,"SELAT TENGAH, SELAT, KAPUAS, KALIMANTAN TENGAH",42,35,108,143
https://kawalpemilu.org#60657,"SELAT TENGAH, SELAT, KAPUAS, KALIMANTAN TENGAH",43,61,89,150
https://kawalpemilu.org#60657,"SELAT TENGAH, SELAT, KAPUAS, KALIMANTAN TENGAH",44,50,127,177
https://kawalpemilu.org#60657,"SELAT TENGAH, SELAT, KAPUAS, KALIMANTAN TENGAH",45,38,79,117
https://kawalpemilu.org#60657,"SELAT TENGAH, SELAT, KAPUAS, KALIMANTAN TENGAH",46,47,124,171
https://kawalpemilu.org#60658,"SELAT HULU, SELAT, KAPUAS, KALIMANTAN TENGAH",1,53,158,211
https://kawalpemilu.org#60658,"SELAT HULU, SELAT, KAPUAS, KALIMANTAN TENGAH",2,39,155,194
https://kawalpemilu.org#60658,"SELAT HULU, SELAT, KAPUAS, KALIMANTAN TENGAH",3,17,88,105
https://kawalpemilu.org#60658,"SELAT HULU, SELAT, KAPUAS, KALIMANTAN TENGAH",4,26,172,198
https://kawalpemilu.org#60658,"SELAT HULU, SELAT, KAPUAS, KALIMANTAN TENGAH",5,23,78,101
https://kawalpemilu.org#60658,"SELAT HULU, SELAT, KAPUAS, KALIMANTAN TENGAH",6,35,118,153
https://kawalpemilu.org#60658,"SELAT HULU, SELAT, KAPUAS, KALIMANTAN TENGAH",7,47,153,200
https://kawalpemilu.org#60658,"SELAT HULU, SELAT, KAPUAS, KALIMANTAN TENGAH",8,23,75,98
https://kawalpemilu.org#60658,"SELAT HULU, SELAT, KAPUAS, KALIMANTAN TENGAH",9,48,136,184
https://kawalpemilu.org#60658,"SELAT HULU, SELAT, KAPUAS, KALIMANTAN TENGAH",11,28,125,153
https://kawalpemilu.org#60658,"SELAT HULU, SELAT, KAPUAS, KALIMANTAN TENGAH",12,11,109,120
https://kawalpemilu.org#60658,"SELAT HULU, SELAT, KAPUAS, KALIMANTAN TENGAH",13,35,147,182
https://kawalpemilu.org#60658,"SELAT HULU, SELAT, KAPUAS, KALIMANTAN TENGAH",15,23,93,116
https://kawalpemilu.org#60658,"SELAT HULU, SELAT, KAPUAS, KALIMANTAN TENGAH",16,38,156,194
https://kawalpemilu.org#60658,"SELAT HULU, SELAT, KAPUAS, KALIMANTAN TENGAH",17,28,132,160
https://kawalpemilu.org#60658,"SELAT HULU, SELAT, KAPUAS, KALIMANTAN TENGAH",19,30,131,161
https://kawalpemilu.org#60658,"SELAT HULU, SELAT, KAPUAS, KALIMANTAN TENGAH",20,29,167,196
https://kawalpemilu.org#60658,"SELAT HULU, SELAT, KAPUAS, KALIMANTAN TENGAH",21,27,162,189
https://kawalpemilu.org#60658,"SELAT HULU, SELAT, KAPUAS, KALIMANTAN TENGAH",22,28,135,163
https://kawalpemilu.org#60658,"SELAT HULU, SELAT, KAPUAS, KALIMANTAN TENGAH",23,33,167,200
https://kawalpemilu.org#60658,"SELAT HULU, SELAT, KAPUAS, KALIMANTAN TENGAH",24,37,111,148
https://kawalpemilu.org#60658,"SELAT HULU, SELAT, KAPUAS, KALIMANTAN TENGAH",25,39,151,190
https://kawalpemilu.org#60658,"SELAT HULU, SELAT, KAPUAS, KALIMANTAN TENGAH",26,23,127,150
https://kawalpemilu.org#60658,"SELAT HULU, SELAT, KAPUAS, KALIMANTAN TENGAH",27,13,82,95
https://kawalpemilu.org#60658,"SELAT HULU, SELAT, KAPUAS, KALIMANTAN TENGAH",28,34,109,143
https://kawalpemilu.org#60658,"SELAT HULU, SELAT, KAPUAS, KALIMANTAN TENGAH",29,29,81,110
https://kawalpemilu.org#60658,"SELAT HULU, SELAT, KAPUAS, KALIMANTAN TENGAH",30,28,117,145
https://kawalpemilu.org#60658,"SELAT HULU, SELAT, KAPUAS, KALIMANTAN TENGAH",31,26,96,122
https://kawalpemilu.org#60658,"SELAT HULU, SELAT, KAPUAS, KALIMANTAN TENGAH",32,15,139,154
https://kawalpemilu.org#60658,"SELAT HULU, SELAT, KAPUAS, KALIMANTAN TENGAH",34,12,91,103
https://kawalpemilu.org#60658,"SELAT HULU, SELAT, KAPUAS, KALIMANTAN TENGAH",35,31,117,148
https://kawalpemilu.org#60658,"SELAT HULU, SELAT, KAPUAS, KALIMANTAN TENGAH",36,26,114,140
https://kawalpemilu.org#60658,"SELAT HULU, SELAT, KAPUAS, KALIMANTAN TENGAH",37,36,133,169
https://kawalpemilu.org#60658,"SELAT HULU, SELAT, KAPUAS, KALIMANTAN TENGAH",38,30,155,185
https://kawalpemilu.org#60658,"SELAT HULU, SELAT, KAPUAS, KALIMANTAN TENGAH",39,19,156,175
https://kawalpemilu.org#60658,"SELAT HULU, SELAT, KAPUAS, KALIMANTAN TENGAH",40,29,121,150
https://kawalpemilu.org#60658,"SELAT HULU, SELAT, KAPUAS, KALIMANTAN TENGAH",41,35,108,143
https://kawalpemilu.org#60658,"SELAT HULU, SELAT, KAPUAS, KALIMANTAN TENGAH",42,43,120,163
https://kawalpemilu.org#60658,"SELAT HULU, SELAT, KAPUAS, KALIMANTAN TENGAH",44,36,132,168
https://kawalpemilu.org#60658,"SELAT HULU, SELAT, KAPUAS, KALIMANTAN TENGAH",45,23,131,154
https://kawalpemilu.org#60659,"SELAT DALAM, SELAT, KAPUAS, KALIMANTAN TENGAH",1,66,49,115
https://kawalpemilu.org#60659,"SELAT DALAM, SELAT, KAPUAS, KALIMANTAN TENGAH",2,26,95,121
https://kawalpemilu.org#60659,"SELAT DALAM, SELAT, KAPUAS, KALIMANTAN TENGAH",3,69,90,159
https://kawalpemilu.org#60659,"SELAT DALAM, SELAT, KAPUAS, KALIMANTAN TENGAH",4,62,128,190
https://kawalpemilu.org#60659,"SELAT DALAM, SELAT, KAPUAS, KALIMANTAN TENGAH",5,34,158,192
https://kawalpemilu.org#60659,"SELAT DALAM, SELAT, KAPUAS, KALIMANTAN TENGAH",6,20,108,128
https://kawalpemilu.org#60659,"SELAT DALAM, SELAT, KAPUAS, KALIMANTAN TENGAH",7,55,130,185
https://kawalpemilu.org#60659,"SELAT DALAM, SELAT, KAPUAS, KALIMANTAN TENGAH",8,42,125,167
https://kawalpemilu.org#60659,"SELAT DALAM, SELAT, KAPUAS, KALIMANTAN TENGAH",9,59,159,218
https://kawalpemilu.org#60659,"SELAT DALAM, SELAT, KAPUAS, KALIMANTAN TENGAH",11,72,79,151
https://kawalpemilu.org#60659,"SELAT DALAM, SELAT, KAPUAS, KALIMANTAN TENGAH",12,61,93,154
https://kawalpemilu.org#60659,"SELAT DALAM, SELAT, KAPUAS, KALIMANTAN TENGAH",14,79,157,236
https://kawalpemilu.org#60659,"SELAT DALAM, SELAT, KAPUAS, KALIMANTAN TENGAH",15,63,123,186
https://kawalpemilu.org#60659,"SELAT DALAM, SELAT, KAPUAS, KALIMANTAN TENGAH",16,49,76,125
https://kawalpemilu.org#60659,"SELAT DALAM, SELAT, KAPUAS, KALIMANTAN TENGAH",17,39,97,136
https://kawalpemilu.org#60659,"SELAT DALAM, SELAT, KAPUAS, KALIMANTAN TENGAH",18,64,155,219
https://kawalpemilu.org#60659,"SELAT DALAM, SELAT, KAPUAS, KALIMANTAN TENGAH",19,42,172,214
https://kawalpemilu.org#60659,"SELAT DALAM, SELAT, KAPUAS, KALIMANTAN TENGAH",21,5,9,14
https://kawalpemilu.org#60659,"SELAT DALAM, SELAT, KAPUAS, KALIMANTAN TENGAH",22,70,133,203
https://kawalpemilu.org#60659,"SELAT DALAM, SELAT, KAPUAS, KALIMANTAN TENGAH",23,41,116,157
https://kawalpemilu.org#60659,"SELAT DALAM, SELAT, KAPUAS, KALIMANTAN TENGAH",24,63,67,130
https://kawalpemilu.org#60659,"SELAT DALAM, SELAT, KAPUAS, KALIMANTAN TENGAH",25,54,88,142
https://kawalpemilu.org#60659,"SELAT DALAM, SELAT, KAPUAS, KALIMANTAN TENGAH",26,30,84,114
https://kawalpemilu.org#60659,"SELAT DALAM, SELAT, KAPUAS, KALIMANTAN TENGAH",27,77,63,140
https://kawalpemilu.org#60659,"SELAT DALAM, SELAT, KAPUAS, KALIMANTAN TENGAH",28,48,133,181
https://kawalpemilu.org#60659,"SELAT DALAM, SELAT, KAPUAS, KALIMANTAN TENGAH",29,35,130,165
https://kawalpemilu.org#60659,"SELAT DALAM, SELAT, KAPUAS, KALIMANTAN TENGAH",31,41,126,167
https://kawalpemilu.org#60659,"SELAT DALAM, SELAT, KAPUAS, KALIMANTAN TENGAH",32,56,109,165
https://kawalpemilu.org#60659,"SELAT DALAM, SELAT, KAPUAS, KALIMANTAN TENGAH",33,50,132,182
https://kawalpemilu.org#60659,"SELAT DALAM, SELAT, KAPUAS, KALIMANTAN TENGAH",34,105,77,182
https://kawalpemilu.org#60659,"SELAT DALAM, SELAT, KAPUAS, KALIMANTAN TENGAH",35,85,88,173
https://kawalpemilu.org#60659,"SELAT DALAM, SELAT, KAPUAS, KALIMANTAN TENGAH",36,104,36,140
https://kawalpemilu.org#60659,"SELAT DALAM, SELAT, KAPUAS, KALIMANTAN TENGAH",37,67,98,165
https://kawalpemilu.org#60659,"SELAT DALAM, SELAT, KAPUAS, KALIMANTAN TENGAH",38,47,106,153
https://kawalpemilu.org#60659,"SELAT DALAM, SELAT, KAPUAS, KALIMANTAN TENGAH",39,60,88,148
https://kawalpemilu.org#60665,"PULAU TELO, SELAT, KAPUAS, KALIMANTAN TENGAH",1,103,77,180
https://kawalpemilu.org#60665,"PULAU TELO, SELAT, KAPUAS, KALIMANTAN TENGAH",2,119,68,187
https://kawalpemilu.org#60665,"PULAU TELO, SELAT, KAPUAS, KALIMANTAN TENGAH",3,31,98,129
https://kawalpemilu.org#60665,"PULAU TELO, SELAT, KAPUAS, KALIMANTAN TENGAH",4,37,76,113
https://kawalpemilu.org#60665,"PULAU TELO, SELAT, KAPUAS, KALIMANTAN TENGAH",5,67,90,157
https://kawalpemilu.org#60665,"PULAU TELO, SELAT, KAPUAS, KALIMANTAN TENGAH",6,85,58,143
https://kawalpemilu.org#60665,"PULAU TELO, SELAT, KAPUAS, KALIMANTAN TENGAH",7,40,66,106
https://kawalpemilu.org#60665,"PULAU TELO, SELAT, KAPUAS, KALIMANTAN TENGAH",8,62,64,126
https://kawalpemilu.org#60665,"PULAU TELO, SELAT, KAPUAS, KALIMANTAN TENGAH",9,41,67,108
https://kawalpemilu.org#60665,"PULAU TELO, SELAT, KAPUAS, KALIMANTAN TENGAH",10,55,63,118
https://kawalpemilu.org#928265,"SELAT UTARA, SELAT, KAPUAS, KALIMANTAN TENGAH",1,59,65,124
https://kawalpemilu.org#928265,"SELAT UTARA, SELAT, KAPUAS, KALIMANTAN TENGAH",2,68,95,163
https://kawalpemilu.org#928265,"SELAT UTARA, SELAT, KAPUAS, KALIMANTAN TENGAH",3,130,137,267
https://kawalpemilu.org#928265,"SELAT UTARA, SELAT, KAPUAS, KALIMANTAN TENGAH",4,192,64,256
https://kawalpemilu.org#928265,"SELAT UTARA, SELAT, KAPUAS, KALIMANTAN TENGAH",5,84,77,161
https://kawalpemilu.org#928265,"SELAT UTARA, SELAT, KAPUAS, KALIMANTAN TENGAH",6,68,95,163
https://kawalpemilu.org#928265,"SELAT UTARA, SELAT, KAPUAS, KALIMANTAN TENGAH",7,50,147,197
https://kawalpemilu.org#928265,"SELAT UTARA, SELAT, KAPUAS, KALIMANTAN TENGAH",8,66,194,260
https://kawalpemilu.org#928265,"SELAT UTARA, SELAT, KAPUAS, KALIMANTAN TENGAH",9,69,153,222
https://kawalpemilu.org#928265,"SELAT UTARA, SELAT, KAPUAS, KALIMANTAN TENGAH",10,23,155,178
https://kawalpemilu.org#928265,"SELAT UTARA, SELAT, KAPUAS, KALIMANTAN TENGAH",11,33,99,132
https://kawalpemilu.org#928265,"SELAT UTARA, SELAT, KAPUAS, KALIMANTAN TENGAH",12,31,65,96
https://kawalpemilu.org#928280,"SELAT BARAT, SELAT, KAPUAS, KALIMANTAN TENGAH",1,69,127,196
https://kawalpemilu.org#928280,"SELAT BARAT, SELAT, KAPUAS, KALIMANTAN TENGAH",2,46,137,183
https://kawalpemilu.org#928280,"SELAT BARAT, SELAT, KAPUAS, KALIMANTAN TENGAH",3,102,100,202
https://kawalpemilu.org#928280,"SELAT BARAT, SELAT, KAPUAS, KALIMANTAN TENGAH",4,60,107,167
https://kawalpemilu.org#928280,"SELAT BARAT, SELAT, KAPUAS, KALIMANTAN TENGAH",5,49,145,194
https://kawalpemilu.org#928280,"SELAT BARAT, SELAT, KAPUAS, KALIMANTAN TENGAH",6,89,90,179
https://kawalpemilu.org#928280,"SELAT BARAT, SELAT, KAPUAS, KALIMANTAN TENGAH",7,83,58,141
https://kawalpemilu.org#928280,"SELAT BARAT, SELAT, KAPUAS, KALIMANTAN TENGAH",8,51,92,143
https://kawalpemilu.org#928280,"SELAT BARAT, SELAT, KAPUAS, KALIMANTAN TENGAH",9,93,124,217
https://kawalpemilu.org#928280,"SELAT BARAT, SELAT, KAPUAS, KALIMANTAN TENGAH",10,89,108,197
https://kawalpemilu.org#928280,"SELAT BARAT, SELAT, KAPUAS, KALIMANTAN TENGAH",11,178,85,263
https://kawalpemilu.org#928280,"SELAT BARAT, SELAT, KAPUAS, KALIMANTAN TENGAH",12,131,63,194
https://kawalpemilu.org#928280,"SELAT BARAT, SELAT, KAPUAS, KALIMANTAN TENGAH",13,34,112,146
https://kawalpemilu.org#928280,"SELAT BARAT, SELAT, KAPUAS, KALIMANTAN TENGAH",14,33,58,91
https://kawalpemilu.org#928280,"SELAT BARAT, SELAT, KAPUAS, KALIMANTAN TENGAH",15,51,126,177
https://kawalpemilu.org#928280,"SELAT BARAT, SELAT, KAPUAS, KALIMANTAN TENGAH",16,57,118,175
https://kawalpemilu.org#928280,"SELAT BARAT, SELAT, KAPUAS, KALIMANTAN TENGAH",17,74,94,168
https://kawalpemilu.org#928280,"SELAT BARAT, SELAT, KAPUAS, KALIMANTAN TENGAH",18,70,81,151
https://kawalpemilu.org#928280,"SELAT BARAT, SELAT, KAPUAS, KALIMANTAN TENGAH",19,38,83,121
https://kawalpemilu.org#928280,"SELAT BARAT, SELAT, KAPUAS, KALIMANTAN TENGAH",20,89,23,112
https://kawalpemilu.org#928280,"SELAT BARAT, SELAT, KAPUAS, KALIMANTAN TENGAH",21,78,81,159
https://kawalpemilu.org#928280,"SELAT BARAT, SELAT, KAPUAS, KALIMANTAN TENGAH",22,88,44,132
https://kawalpemilu.org#928280,"SELAT BARAT, SELAT, KAPUAS, KALIMANTAN TENGAH",23,35,99,134
https://kawalpemilu.org#928281,"PANAMAS, SELAT, KAPUAS, KALIMANTAN TENGAH",1,76,113,189
https://kawalpemilu.org#928281,"PANAMAS, SELAT, KAPUAS, KALIMANTAN TENGAH",2,102,113,215
https://kawalpemilu.org#928281,"PANAMAS, SELAT, KAPUAS, KALIMANTAN TENGAH",3,130,59,189
https://kawalpemilu.org#928281,"PANAMAS, SELAT, KAPUAS, KALIMANTAN TENGAH",4,37,56,93
https://kawalpemilu.org#928281,"PANAMAS, SELAT, KAPUAS, KALIMANTAN TENGAH",5,64,105,169
https://kawalpemilu.org#928282,"PULAU TELO BARU, SELAT, KAPUAS, KALIMANTAN TENGAH",1,95,86,181
https://kawalpemilu.org#928282,"PULAU TELO BARU, SELAT, KAPUAS, KALIMANTAN TENGAH",2,59,51,110
https://kawalpemilu.org#928282,"PULAU TELO BARU, SELAT, KAPUAS, KALIMANTAN TENGAH",3,76,55,131
https://kawalpemilu.org#928282,"PULAU TELO BARU, SELAT, KAPUAS, KALIMANTAN TENGAH",4,74,69,143
https://kawalpemilu.org#928282,"PULAU TELO BARU, SELAT, KAPUAS, KALIMANTAN TENGAH",5,69,92,161
https://kawalpemilu.org#928282,"PULAU TELO BARU, SELAT, KAPUAS, KALIMANTAN TENGAH",6,59,51,110
https://kawalpemilu.org#928282,"PULAU TELO BARU, SELAT, KAPUAS, KALIMANTAN TENGAH",7,88,37,125
https://kawalpemilu.org#60675,"MAMBULAU, KAPUAS HILIR, KAPUAS, KALIMANTAN TENGAH",1,36,173,209
https://kawalpemilu.org#60675,"MAMBULAU, KAPUAS HILIR, KAPUAS, KALIMANTAN TENGAH",2,33,124,157
https://kawalpemilu.org#60675,"MAMBULAU, KAPUAS HILIR, KAPUAS, KALIMANTAN TENGAH",3,47,150,197
https://kawalpemilu.org#60675,"MAMBULAU, KAPUAS HILIR, KAPUAS, KALIMANTAN TENGAH",4,58,123,181
https://kawalpemilu.org#60675,"MAMBULAU, KAPUAS HILIR, KAPUAS, KALIMANTAN TENGAH",5,15,128,143
https://kawalpemilu.org#60675,"MAMBULAU, KAPUAS HILIR, KAPUAS, KALIMANTAN TENGAH",6,43,102,145
https://kawalpemilu.org#60675,"MAMBULAU, KAPUAS HILIR, KAPUAS, KALIMANTAN TENGAH",7,21,73,94
https://kawalpemilu.org#60675,"MAMBULAU, KAPUAS HILIR, KAPUAS, KALIMANTAN TENGAH",8,39,85,124
https://kawalpemilu.org#60675,"MAMBULAU, KAPUAS HILIR, KAPUAS, KALIMANTAN TENGAH",9,70,112,182
https://kawalpemilu.org#60675,"MAMBULAU, KAPUAS HILIR, KAPUAS, KALIMANTAN TENGAH",10,66,74,140
https://kawalpemilu.org#60676,"HAMPATUNG, KAPUAS HILIR, KAPUAS, KALIMANTAN TENGAH",1,64,109,173
https://kawalpemilu.org#60676,"HAMPATUNG, KAPUAS HILIR, KAPUAS, KALIMANTAN TENGAH",2,70,98,168
https://kawalpemilu.org#60676,"HAMPATUNG, KAPUAS HILIR, KAPUAS, KALIMANTAN TENGAH",3,124,67,191
https://kawalpemilu.org#60676,"HAMPATUNG, KAPUAS HILIR, KAPUAS, KALIMANTAN TENGAH",4,180,33,213
https://kawalpemilu.org#60676,"HAMPATUNG, KAPUAS HILIR, KAPUAS, KALIMANTAN TENGAH",5,84,86,170
https://kawalpemilu.org#60676,"HAMPATUNG, KAPUAS HILIR, KAPUAS, KALIMANTAN TENGAH",6,124,73,197
https://kawalpemilu.org#60677,"DAHIRANG, KAPUAS HILIR, KAPUAS, KALIMANTAN TENGAH",1,174,33,207
https://kawalpemilu.org#60677,"DAHIRANG, KAPUAS HILIR, KAPUAS, KALIMANTAN TENGAH",2,154,43,197
https://kawalpemilu.org#60677,"DAHIRANG, KAPUAS HILIR, KAPUAS, KALIMANTAN TENGAH",3,76,35,111
https://kawalpemilu.org#60678,"BARIMBA, KAPUAS HILIR, KAPUAS, KALIMANTAN TENGAH",1,78,127,205
https://kawalpemilu.org#60678,"BARIMBA, KAPUAS HILIR, KAPUAS, KALIMANTAN TENGAH",2,137,55,192
https://kawalpemilu.org#60678,"BARIMBA, KAPUAS HILIR, KAPUAS, KALIMANTAN TENGAH",3,153,19,172
https://kawalpemilu.org#60678,"BARIMBA, KAPUAS HILIR, KAPUAS, KALIMANTAN TENGAH",4,169,22,191
https://kawalpemilu.org#60678,"BARIMBA, KAPUAS HILIR, KAPUAS, KALIMANTAN TENGAH",5,58,29,87
https://kawalpemilu.org#60678,"BARIMBA, KAPUAS HILIR, KAPUAS, KALIMANTAN TENGAH",6,128,67,195
https://kawalpemilu.org#60679,"SEI PASAH, KAPUAS HILIR, KAPUAS, KALIMANTAN TENGAH",1,165,61,226
https://kawalpemilu.org#60679,"SEI PASAH, KAPUAS HILIR, KAPUAS, KALIMANTAN TENGAH",2,104,30,134
https://kawalpemilu.org#60679,"SEI PASAH, KAPUAS HILIR, KAPUAS, KALIMANTAN TENGAH",3,134,41,175
https://kawalpemilu.org#60679,"SEI PASAH, KAPUAS HILIR, KAPUAS, KALIMANTAN TENGAH",4,15,44,59
https://kawalpemilu.org#60679,"SEI PASAH, KAPUAS HILIR, KAPUAS, KALIMANTAN TENGAH",5,128,20,148
https://kawalpemilu.org#60679,"SEI PASAH, KAPUAS HILIR, KAPUAS, KALIMANTAN TENGAH",6,95,24,119
https://kawalpemilu.org#60680,"BAKUNGIN, KAPUAS HILIR, KAPUAS, KALIMANTAN TENGAH",1,45,99,144
https://kawalpemilu.org#60680,"BAKUNGIN, KAPUAS HILIR, KAPUAS, KALIMANTAN TENGAH",2,59,100,159
https://kawalpemilu.org#60680,"BAKUNGIN, KAPUAS HILIR, KAPUAS, KALIMANTAN TENGAH",3,74,75,149
https://kawalpemilu.org#60680,"BAKUNGIN, KAPUAS HILIR, KAPUAS, KALIMANTAN TENGAH",4,33,111,144
https://kawalpemilu.org#60681,"SEI ASAM, KAPUAS HILIR, KAPUAS, KALIMANTAN TENGAH",1,84,145,229
https://kawalpemilu.org#60681,"SEI ASAM, KAPUAS HILIR, KAPUAS, KALIMANTAN TENGAH",2,53,134,187
https://kawalpemilu.org#60681,"SEI ASAM, KAPUAS HILIR, KAPUAS, KALIMANTAN TENGAH",4,76,70,146
https://kawalpemilu.org#60681,"SEI ASAM, KAPUAS HILIR, KAPUAS, KALIMANTAN TENGAH",5,124,12,136
https://kawalpemilu.org#60681,"SEI ASAM, KAPUAS HILIR, KAPUAS, KALIMANTAN TENGAH",6,107,34,141
https://kawalpemilu.org#60681,"SEI ASAM, KAPUAS HILIR, KAPUAS, KALIMANTAN TENGAH",7,22,29,51
https://kawalpemilu.org#60682,"SAKA BATUR, KAPUAS HILIR, KAPUAS, KALIMANTAN TENGAH",1,57,47,104
https://kawalpemilu.org#60682,"SAKA BATUR, KAPUAS HILIR, KAPUAS, KALIMANTAN TENGAH",2,29,75,104
https://kawalpemilu.org#60682,"SAKA BATUR, KAPUAS HILIR, KAPUAS, KALIMANTAN TENGAH",3,55,100,155
https://kawalpemilu.org#60682,"SAKA BATUR, KAPUAS HILIR, KAPUAS, KALIMANTAN TENGAH",4,54,115,169
https://kawalpemilu.org#60682,"SAKA BATUR, KAPUAS HILIR, KAPUAS, KALIMANTAN TENGAH",5,47,75,122
https://kawalpemilu.org#60682,"SAKA BATUR, KAPUAS HILIR, KAPUAS, KALIMANTAN TENGAH",6,60,66,126
https://kawalpemilu.org#60684,"ANJIR SERAPAT TIMUR, KAPUAS TIMUR, KAPUAS, KALIMANTAN TENGAH",1,25,107,132
https://kawalpemilu.org#60684,"ANJIR SERAPAT TIMUR, KAPUAS TIMUR, KAPUAS, KALIMANTAN TENGAH",2,24,110,134
https://kawalpemilu.org#60684,"ANJIR SERAPAT TIMUR, KAPUAS TIMUR, KAPUAS, KALIMANTAN TENGAH",3,36,98,134
https://kawalpemilu.org#60684,"ANJIR SERAPAT TIMUR, KAPUAS TIMUR, KAPUAS, KALIMANTAN TENGAH",4,103,107,210
https://kawalpemilu.org#60684,"ANJIR SERAPAT TIMUR, KAPUAS TIMUR, KAPUAS, KALIMANTAN TENGAH",5,68,151,219
https://kawalpemilu.org#60684,"ANJIR SERAPAT TIMUR, KAPUAS TIMUR, KAPUAS, KALIMANTAN TENGAH",6,29,167,196
https://kawalpemilu.org#60684,"ANJIR SERAPAT TIMUR, KAPUAS TIMUR, KAPUAS, KALIMANTAN TENGAH",7,24,112,136
https://kawalpemilu.org#60684,"ANJIR SERAPAT TIMUR, KAPUAS TIMUR, KAPUAS, KALIMANTAN TENGAH",8,39,196,235
https://kawalpemilu.org#60684,"ANJIR SERAPAT TIMUR, KAPUAS TIMUR, KAPUAS, KALIMANTAN TENGAH",9,25,63,88
https://kawalpemilu.org#60684,"ANJIR SERAPAT TIMUR, KAPUAS TIMUR, KAPUAS, KALIMANTAN TENGAH",10,19,101,120
https://kawalpemilu.org#60684,"ANJIR SERAPAT TIMUR, KAPUAS TIMUR, KAPUAS, KALIMANTAN TENGAH",11,36,86,122
https://kawalpemilu.org#60684,"ANJIR SERAPAT TIMUR, KAPUAS TIMUR, KAPUAS, KALIMANTAN TENGAH",12,57,49,106
https://kawalpemilu.org#60684,"ANJIR SERAPAT TIMUR, KAPUAS TIMUR, KAPUAS, KALIMANTAN TENGAH",13,23,93,116
https://kawalpemilu.org#60684,"ANJIR SERAPAT TIMUR, KAPUAS TIMUR, KAPUAS, KALIMANTAN TENGAH",14,53,82,135
https://kawalpemilu.org#60685,"ANJIR SERAPAT TENGAH, KAPUAS TIMUR, KAPUAS, KALIMANTAN TENGAH",1,24,132,156
https://kawalpemilu.org#60685,"ANJIR SERAPAT TENGAH, KAPUAS TIMUR, KAPUAS, KALIMANTAN TENGAH",2,29,189,218
https://kawalpemilu.org#60685,"ANJIR SERAPAT TENGAH, KAPUAS TIMUR, KAPUAS, KALIMANTAN TENGAH",3,47,176,223
https://kawalpemilu.org#60685,"ANJIR SERAPAT TENGAH, KAPUAS TIMUR, KAPUAS, KALIMANTAN TENGAH",4,40,47,87
https://kawalpemilu.org#60685,"ANJIR SERAPAT TENGAH, KAPUAS TIMUR, KAPUAS, KALIMANTAN TENGAH",5,75,107,182
https://kawalpemilu.org#60685,"ANJIR SERAPAT TENGAH, KAPUAS TIMUR, KAPUAS, KALIMANTAN TENGAH",6,28,131,159
https://kawalpemilu.org#60685,"ANJIR SERAPAT TENGAH, KAPUAS TIMUR, KAPUAS, KALIMANTAN TENGAH",7,12,197,209
https://kawalpemilu.org#60685,"ANJIR SERAPAT TENGAH, KAPUAS TIMUR, KAPUAS, KALIMANTAN TENGAH",8,27,175,202
https://kawalpemilu.org#60685,"ANJIR SERAPAT TENGAH, KAPUAS TIMUR, KAPUAS, KALIMANTAN TENGAH",9,20,122,142
https://kawalpemilu.org#60685,"ANJIR SERAPAT TENGAH, KAPUAS TIMUR, KAPUAS, KALIMANTAN TENGAH",10,37,141,178
https://kawalpemilu.org#60685,"ANJIR SERAPAT TENGAH, KAPUAS TIMUR, KAPUAS, KALIMANTAN TENGAH",11,30,138,168
https://kawalpemilu.org#60685,"ANJIR SERAPAT TENGAH, KAPUAS TIMUR, KAPUAS, KALIMANTAN TENGAH",12,32,135,167
https://kawalpemilu.org#60685,"ANJIR SERAPAT TENGAH, KAPUAS TIMUR, KAPUAS, KALIMANTAN TENGAH",13,42,199,241
https://kawalpemilu.org#60685,"ANJIR SERAPAT TENGAH, KAPUAS TIMUR, KAPUAS, KALIMANTAN TENGAH",14,6,84,90
https://kawalpemilu.org#60685,"ANJIR SERAPAT TENGAH, KAPUAS TIMUR, KAPUAS, KALIMANTAN TENGAH",15,8,111,119
https://kawalpemilu.org#60685,"ANJIR SERAPAT TENGAH, KAPUAS TIMUR, KAPUAS, KALIMANTAN TENGAH",16,69,131,200
https://kawalpemilu.org#60685,"ANJIR SERAPAT TENGAH, KAPUAS TIMUR, KAPUAS, KALIMANTAN TENGAH",17,69,56,125
https://kawalpemilu.org#60685,"ANJIR SERAPAT TENGAH, KAPUAS TIMUR, KAPUAS, KALIMANTAN TENGAH",18,52,98,150
https://kawalpemilu.org#60685,"ANJIR SERAPAT TENGAH, KAPUAS TIMUR, KAPUAS, KALIMANTAN TENGAH",19,47,131,178
https://kawalpemilu.org#60685,"ANJIR SERAPAT TENGAH, KAPUAS TIMUR, KAPUAS, KALIMANTAN TENGAH",20,34,131,165
https://kawalpemilu.org#60685,"ANJIR SERAPAT TENGAH, KAPUAS TIMUR, KAPUAS, KALIMANTAN TENGAH",21,41,118,159
https://kawalpemilu.org#60685,"ANJIR SERAPAT TENGAH, KAPUAS TIMUR, KAPUAS, KALIMANTAN TENGAH",22,63,83,146
https://kawalpemilu.org#60685,"ANJIR SERAPAT TENGAH, KAPUAS TIMUR, KAPUAS, KALIMANTAN TENGAH",23,29,131,160
https://kawalpemilu.org#60685,"ANJIR SERAPAT TENGAH, KAPUAS TIMUR, KAPUAS, KALIMANTAN TENGAH",24,59,70,129
https://kawalpemilu.org#60685,"ANJIR SERAPAT TENGAH, KAPUAS TIMUR, KAPUAS, KALIMANTAN TENGAH",25,56,136,192
https://kawalpemilu.org#60686,"ANJIR SERAPAT BARAT, KAPUAS TIMUR, KAPUAS, KALIMANTAN TENGAH",1,27,168,195
https://kawalpemilu.org#60686,"ANJIR SERAPAT BARAT, KAPUAS TIMUR, KAPUAS, KALIMANTAN TENGAH",2,33,133,166
https://kawalpemilu.org#60686,"ANJIR SERAPAT BARAT, KAPUAS TIMUR, KAPUAS, KALIMANTAN TENGAH",3,45,174,219
https://kawalpemilu.org#60686,"ANJIR SERAPAT BARAT, KAPUAS TIMUR, KAPUAS, KALIMANTAN TENGAH",4,27,95,122
https://kawalpemilu.org#60686,"ANJIR SERAPAT BARAT, KAPUAS TIMUR, KAPUAS, KALIMANTAN TENGAH",5,55,66,121
https://kawalpemilu.org#60686,"ANJIR SERAPAT BARAT, KAPUAS TIMUR, KAPUAS, KALIMANTAN TENGAH",6,46,109,155
https://kawalpemilu.org#60686,"ANJIR SERAPAT BARAT, KAPUAS TIMUR, KAPUAS, KALIMANTAN TENGAH",7,58,105,163
https://kawalpemilu.org#60686,"ANJIR SERAPAT BARAT, KAPUAS TIMUR, KAPUAS, KALIMANTAN TENGAH",8,20,98,118
https://kawalpemilu.org#60686,"ANJIR SERAPAT BARAT, KAPUAS TIMUR, KAPUAS, KALIMANTAN TENGAH",9,51,153,204
https://kawalpemilu.org#60686,"ANJIR SERAPAT BARAT, KAPUAS TIMUR, KAPUAS, KALIMANTAN TENGAH",10,52,120,172
https://kawalpemilu.org#60686,"ANJIR SERAPAT BARAT, KAPUAS TIMUR, KAPUAS, KALIMANTAN TENGAH",11,27,128,155
https://kawalpemilu.org#60686,"ANJIR SERAPAT BARAT, KAPUAS TIMUR, KAPUAS, KALIMANTAN TENGAH",12,35,134,169
https://kawalpemilu.org#60686,"ANJIR SERAPAT BARAT, KAPUAS TIMUR, KAPUAS, KALIMANTAN TENGAH",13,34,89,123
https://kawalpemilu.org#60686,"ANJIR SERAPAT BARAT, KAPUAS TIMUR, KAPUAS, KALIMANTAN TENGAH",14,38,81,119
https://kawalpemilu.org#60686,"ANJIR SERAPAT BARAT, KAPUAS TIMUR, KAPUAS, KALIMANTAN TENGAH",15,42,118,160
https://kawalpemilu.org#60686,"ANJIR SERAPAT BARAT, KAPUAS TIMUR, KAPUAS, KALIMANTAN TENGAH",16,56,57,113
https://kawalpemilu.org#60686,"ANJIR SERAPAT BARAT, KAPUAS TIMUR, KAPUAS, KALIMANTAN TENGAH",17,21,94,115
https://kawalpemilu.org#60686,"ANJIR SERAPAT BARAT, KAPUAS TIMUR, KAPUAS, KALIMANTAN TENGAH",18,62,92,154
https://kawalpemilu.org#60687,"ANJIR MAMBULAU TIMUR, KAPUAS TIMUR, KAPUAS, KALIMANTAN TENGAH",1,19,49,68
https://kawalpemilu.org#60687,"ANJIR MAMBULAU TIMUR, KAPUAS TIMUR, KAPUAS, KALIMANTAN TENGAH",2,20,107,127
https://kawalpemilu.org#60687,"ANJIR MAMBULAU TIMUR, KAPUAS TIMUR, KAPUAS, KALIMANTAN TENGAH",3,55,145,200
https://kawalpemilu.org#60687,"ANJIR MAMBULAU TIMUR, KAPUAS TIMUR, KAPUAS, KALIMANTAN TENGAH",4,35,111,146
https://kawalpemilu.org#60687,"ANJIR MAMBULAU TIMUR, KAPUAS TIMUR, KAPUAS, KALIMANTAN TENGAH",5,52,144,196
https://kawalpemilu.org#60687,"ANJIR MAMBULAU TIMUR, KAPUAS TIMUR, KAPUAS, KALIMANTAN TENGAH",6,45,71,116
https://kawalpemilu.org#60687,"ANJIR MAMBULAU TIMUR, KAPUAS TIMUR, KAPUAS, KALIMANTAN TENGAH",7,59,127,186
https://kawalpemilu.org#60687,"ANJIR MAMBULAU TIMUR, KAPUAS TIMUR, KAPUAS, KALIMANTAN TENGAH",8,46,139,185
https://kawalpemilu.org#60687,"ANJIR MAMBULAU TIMUR, KAPUAS TIMUR, KAPUAS, KALIMANTAN TENGAH",9,44,57,101
https://kawalpemilu.org#60687,"ANJIR MAMBULAU TIMUR, KAPUAS TIMUR, KAPUAS, KALIMANTAN TENGAH",10,41,162,203
https://kawalpemilu.org#60687,"ANJIR MAMBULAU TIMUR, KAPUAS TIMUR, KAPUAS, KALIMANTAN TENGAH",11,26,113,2
https://kawalpemilu.org#60687,"ANJIR MAMBULAU TIMUR, KAPUAS TIMUR, KAPUAS, KALIMANTAN TENGAH",12,12,166,178
https://kawalpemilu.org#60687,"ANJIR MAMBULAU TIMUR, KAPUAS TIMUR, KAPUAS, KALIMANTAN TENGAH",13,15,91,106
https://kawalpemilu.org#60688,"ANJIR MAMBULAU TENGAH, KAPUAS TIMUR, KAPUAS, KALIMANTAN TENGAH",1,51,144,195
https://kawalpemilu.org#60688,"ANJIR MAMBULAU TENGAH, KAPUAS TIMUR, KAPUAS, KALIMANTAN TENGAH",2,90,57,147
https://kawalpemilu.org#60688,"ANJIR MAMBULAU TENGAH, KAPUAS TIMUR, KAPUAS, KALIMANTAN TENGAH",3,47,142,189
https://kawalpemilu.org#60688,"ANJIR MAMBULAU TENGAH, KAPUAS TIMUR, KAPUAS, KALIMANTAN TENGAH",4,54,140,194
https://kawalpemilu.org#60688,"ANJIR MAMBULAU TENGAH, KAPUAS TIMUR, KAPUAS, KALIMANTAN TENGAH",5,43,105,148
https://kawalpemilu.org#60688,"ANJIR MAMBULAU TENGAH, KAPUAS TIMUR, KAPUAS, KALIMANTAN TENGAH",6,32,47,79
https://kawalpemilu.org#60688,"ANJIR MAMBULAU TENGAH, KAPUAS TIMUR, KAPUAS, KALIMANTAN TENGAH",7,6,151,157
https://kawalpemilu.org#60688,"ANJIR MAMBULAU TENGAH, KAPUAS TIMUR, KAPUAS, KALIMANTAN TENGAH",8,37,130,167
https://kawalpemilu.org#60688,"ANJIR MAMBULAU TENGAH, KAPUAS TIMUR, KAPUAS, KALIMANTAN TENGAH",9,42,63,105
https://kawalpemilu.org#60689,"ANJIR MAMBULAU BARAT, KAPUAS TIMUR, KAPUAS, KALIMANTAN TENGAH",1,29,162,191
https://kawalpemilu.org#60689,"ANJIR MAMBULAU BARAT, KAPUAS TIMUR, KAPUAS, KALIMANTAN TENGAH",2,37,200,237
https://kawalpemilu.org#60689,"ANJIR MAMBULAU BARAT, KAPUAS TIMUR, KAPUAS, KALIMANTAN TENGAH",3,124,88,212
https://kawalpemilu.org#60689,"ANJIR MAMBULAU BARAT, KAPUAS TIMUR, KAPUAS, KALIMANTAN TENGAH",4,39,132,171
https://kawalpemilu.org#60689,"ANJIR MAMBULAU BARAT, KAPUAS TIMUR, KAPUAS, KALIMANTAN TENGAH",5,38,123,161
https://kawalpemilu.org#60689,"ANJIR MAMBULAU BARAT, KAPUAS TIMUR, KAPUAS, KALIMANTAN TENGAH",6,11,129,136
https://kawalpemilu.org#60689,"ANJIR MAMBULAU BARAT, KAPUAS TIMUR, KAPUAS, KALIMANTAN TENGAH",7,25,148,173
https://kawalpemilu.org#60689,"ANJIR MAMBULAU BARAT, KAPUAS TIMUR, KAPUAS, KALIMANTAN TENGAH",8,47,88,135
https://kawalpemilu.org#60689,"ANJIR MAMBULAU BARAT, KAPUAS TIMUR, KAPUAS, KALIMANTAN TENGAH",9,58,115,173
https://kawalpemilu.org#60689,"ANJIR MAMBULAU BARAT, KAPUAS TIMUR, KAPUAS, KALIMANTAN TENGAH",10,79,124,203
https://kawalpemilu.org#60689,"ANJIR MAMBULAU BARAT, KAPUAS TIMUR, KAPUAS, KALIMANTAN TENGAH",11,24,68,92
https://kawalpemilu.org#60689,"ANJIR MAMBULAU BARAT, KAPUAS TIMUR, KAPUAS, KALIMANTAN TENGAH",12,3,72,75
https://kawalpemilu.org#60689,"ANJIR MAMBULAU BARAT, KAPUAS TIMUR, KAPUAS, KALIMANTAN TENGAH",13,13,142,155
https://kawalpemilu.org#60689,"ANJIR MAMBULAU BARAT, KAPUAS TIMUR, KAPUAS, KALIMANTAN TENGAH",14,43,53,96
https://kawalpemilu.org#60690,"ANJIR SERAPAT BARU, KAPUAS TIMUR, KAPUAS, KALIMANTAN TENGAH",1,31,65,96
https://kawalpemilu.org#60690,"ANJIR SERAPAT BARU, KAPUAS TIMUR, KAPUAS, KALIMANTAN TENGAH",2,57,110,167
https://kawalpemilu.org#60690,"ANJIR SERAPAT BARU, KAPUAS TIMUR, KAPUAS, KALIMANTAN TENGAH",3,30,103,133
https://kawalpemilu.org#60690,"ANJIR SERAPAT BARU, KAPUAS TIMUR, KAPUAS, KALIMANTAN TENGAH",4,43,81,124
https://kawalpemilu.org#60690,"ANJIR SERAPAT BARU, KAPUAS TIMUR, KAPUAS, KALIMANTAN TENGAH",5,30,99,129
https://kawalpemilu.org#60690,"ANJIR SERAPAT BARU, KAPUAS TIMUR, KAPUAS, KALIMANTAN TENGAH",7,36,102,138
https://kawalpemilu.org#60692,"BATANJUNG, KAPUAS KUALA, KAPUAS, KALIMANTAN TENGAH",1,69,98,167
https://kawalpemilu.org#60692,"BATANJUNG, KAPUAS KUALA, KAPUAS, KALIMANTAN TENGAH",2,59,85,144
https://kawalpemilu.org#60692,"BATANJUNG, KAPUAS KUALA, KAPUAS, KALIMANTAN TENGAH",3,109,124,233
https://kawalpemilu.org#60692,"BATANJUNG, KAPUAS KUALA, KAPUAS, KALIMANTAN TENGAH",4,90,97,187
https://kawalpemilu.org#60692,"BATANJUNG, KAPUAS KUALA, KAPUAS, KALIMANTAN TENGAH",5,44,54,98
https://kawalpemilu.org#60693,"CEMARA LABAT, KAPUAS KUALA, KAPUAS, KALIMANTAN TENGAH",1,62,76,138
https://kawalpemilu.org#60693,"CEMARA LABAT, KAPUAS KUALA, KAPUAS, KALIMANTAN TENGAH",2,105,69,174
https://kawalpemilu.org#60693,"CEMARA LABAT, KAPUAS KUALA, KAPUAS, KALIMANTAN TENGAH",3,73,67,140
https://kawalpemilu.org#60693,"CEMARA LABAT, KAPUAS KUALA, KAPUAS, KALIMANTAN TENGAH",4,193,40,233
https://kawalpemilu.org#60694,"PALAMPAI, KAPUAS KUALA, KAPUAS, KALIMANTAN TENGAH",1,69,60,129
https://kawalpemilu.org#60694,"PALAMPAI, KAPUAS KUALA, KAPUAS, KALIMANTAN TENGAH",2,13,126,139
https://kawalpemilu.org#60694,"PALAMPAI, KAPUAS KUALA, KAPUAS, KALIMANTAN TENGAH",3,68,59,127
https://kawalpemilu.org#60695,"LUPAK  DALAM, KAPUAS KUALA, KAPUAS, KALIMANTAN TENGAH",1,77,133,210
https://kawalpemilu.org#60695,"LUPAK  DALAM, KAPUAS KUALA, KAPUAS, KALIMANTAN TENGAH",2,49,78,127
https://kawalpemilu.org#60695,"LUPAK  DALAM, KAPUAS KUALA, KAPUAS, KALIMANTAN TENGAH",3,74,139,213
https://kawalpemilu.org#60695,"LUPAK  DALAM, KAPUAS KUALA, KAPUAS, KALIMANTAN TENGAH",4,53,70,123
https://kawalpemilu.org#60695,"LUPAK  DALAM, KAPUAS KUALA, KAPUAS, KALIMANTAN TENGAH",5,31,109,140
https://kawalpemilu.org#60695,"LUPAK  DALAM, KAPUAS KUALA, KAPUAS, KALIMANTAN TENGAH",6,69,114,183
https://kawalpemilu.org#60695,"LUPAK  DALAM, KAPUAS KUALA, KAPUAS, KALIMANTAN TENGAH",7,78,187,265
https://kawalpemilu.org#60695,"LUPAK  DALAM, KAPUAS KUALA, KAPUAS, KALIMANTAN TENGAH",8,42,26,68
https://kawalpemilu.org#60695,"LUPAK  DALAM, KAPUAS KUALA, KAPUAS, KALIMANTAN TENGAH",9,31,47,78
https://kawalpemilu.org#60695,"LUPAK  DALAM, KAPUAS KUALA, KAPUAS, KALIMANTAN TENGAH",10,59,62,121
https://kawalpemilu.org#60695,"LUPAK  DALAM, KAPUAS KUALA, KAPUAS, KALIMANTAN TENGAH",11,63,103,166
https://kawalpemilu.org#60695,"LUPAK  DALAM, KAPUAS KUALA, KAPUAS, KALIMANTAN TENGAH",12,31,129,160
https://kawalpemilu.org#60695,"LUPAK  DALAM, KAPUAS KUALA, KAPUAS, KALIMANTAN TENGAH",13,31,89,120
https://kawalpemilu.org#60696,"TAMBAN LUPAK, KAPUAS KUALA, KAPUAS, KALIMANTAN TENGAH",1,105,67,172
https://kawalpemilu.org#60696,"TAMBAN LUPAK, KAPUAS KUALA, KAPUAS, KALIMANTAN TENGAH",2,78,117,195
https://kawalpemilu.org#60696,"TAMBAN LUPAK, KAPUAS KUALA, KAPUAS, KALIMANTAN TENGAH",3,80,58,138
https://kawalpemilu.org#60696,"TAMBAN LUPAK, KAPUAS KUALA, KAPUAS, KALIMANTAN TENGAH",4,58,87,145
https://kawalpemilu.org#60696,"TAMBAN LUPAK, KAPUAS KUALA, KAPUAS, KALIMANTAN TENGAH",5,97,35,132
https://kawalpemilu.org#60698,"TAMBAN BARU SELATAN, KAPUAS KUALA, KAPUAS, KALIMANTAN TENGAH",1,57,80,137
https://kawalpemilu.org#60698,"TAMBAN BARU SELATAN, KAPUAS KUALA, KAPUAS, KALIMANTAN TENGAH",2,58,77,135
https://kawalpemilu.org#60698,"TAMBAN BARU SELATAN, KAPUAS KUALA, KAPUAS, KALIMANTAN TENGAH",3,77,72,149
https://kawalpemilu.org#60698,"TAMBAN BARU SELATAN, KAPUAS KUALA, KAPUAS, KALIMANTAN TENGAH",4,51,87,138
https://kawalpemilu.org#60698,"TAMBAN BARU SELATAN, KAPUAS KUALA, KAPUAS, KALIMANTAN TENGAH",5,95,93,188
https://kawalpemilu.org#60698,"TAMBAN BARU SELATAN, KAPUAS KUALA, KAPUAS, KALIMANTAN TENGAH",6,9,9,18
https://kawalpemilu.org#60701,"SEI TERAS, KAPUAS KUALA, KAPUAS, KALIMANTAN TENGAH",1,39,100,139
https://kawalpemilu.org#60701,"SEI TERAS, KAPUAS KUALA, KAPUAS, KALIMANTAN TENGAH",2,12,135,147
https://kawalpemilu.org#60701,"SEI TERAS, KAPUAS KUALA, KAPUAS, KALIMANTAN TENGAH",3,6,111,117
https://kawalpemilu.org#60701,"SEI TERAS, KAPUAS KUALA, KAPUAS, KALIMANTAN TENGAH",4,20,132,152
https://kawalpemilu.org#60701,"SEI TERAS, KAPUAS KUALA, KAPUAS, KALIMANTAN TENGAH",5,28,116,144
https://kawalpemilu.org#60701,"SEI TERAS, KAPUAS KUALA, KAPUAS, KALIMANTAN TENGAH",6,19,38,57
https://kawalpemilu.org#60701,"SEI TERAS, KAPUAS KUALA, KAPUAS, KALIMANTAN TENGAH",7,18,59,77
https://kawalpemilu.org#60701,"SEI TERAS, KAPUAS KUALA, KAPUAS, KALIMANTAN TENGAH",8,20,131,151
https://kawalpemilu.org#60701,"SEI TERAS, KAPUAS KUALA, KAPUAS, KALIMANTAN TENGAH",9,27,111,138
https://kawalpemilu.org#60701,"SEI TERAS, KAPUAS KUALA, KAPUAS, KALIMANTAN TENGAH",10,26,45,71
https://kawalpemilu.org#60704,"LUPAK TIMUR, KAPUAS KUALA, KAPUAS, KALIMANTAN TENGAH",1,91,50,141
https://kawalpemilu.org#60704,"LUPAK TIMUR, KAPUAS KUALA, KAPUAS, KALIMANTAN TENGAH",2,82,107,189
https://kawalpemilu.org#60704,"LUPAK TIMUR, KAPUAS KUALA, KAPUAS, KALIMANTAN TENGAH",3,64,77,141
https://kawalpemilu.org#60706,"WARGO MULYO, KAPUAS KUALA, KAPUAS, KALIMANTAN TENGAH",1,92,71,163
https://kawalpemilu.org#60706,"WARGO MULYO, KAPUAS KUALA, KAPUAS, KALIMANTAN TENGAH",2,108,77,185
https://kawalpemilu.org#60706,"WARGO MULYO, KAPUAS KUALA, KAPUAS, KALIMANTAN TENGAH",3,87,116,203
https://kawalpemilu.org#60708,"SEI BAKUT, KAPUAS KUALA, KAPUAS, KALIMANTAN TENGAH",1,113,66,179
https://kawalpemilu.org#60708,"SEI BAKUT, KAPUAS KUALA, KAPUAS, KALIMANTAN TENGAH",2,94,82,176
https://kawalpemilu.org#60708,"SEI BAKUT, KAPUAS KUALA, KAPUAS, KALIMANTAN TENGAH",3,68,76,144
https://kawalpemilu.org#60708,"SEI BAKUT, KAPUAS KUALA, KAPUAS, KALIMANTAN TENGAH",4,89,71,160
https://kawalpemilu.org#60709,"PEMATANG, KAPUAS KUALA, KAPUAS, KALIMANTAN TENGAH",1,67,152,219
https://kawalpemilu.org#60709,"PEMATANG, KAPUAS KUALA, KAPUAS, KALIMANTAN TENGAH",2,53,77,130
https://kawalpemilu.org#60709,"PEMATANG, KAPUAS KUALA, KAPUAS, KALIMANTAN TENGAH",3,66,48,114
https://kawalpemilu.org#60709,"PEMATANG, KAPUAS KUALA, KAPUAS, KALIMANTAN TENGAH",4,47,72,119
https://kawalpemilu.org#928283,"SIMPANG BUNGA TANJUNG, KAPUAS KUALA, KAPUAS, KALIMANTAN TENGAH",1,33,105,138
https://kawalpemilu.org#928283,"SIMPANG BUNGA TANJUNG, KAPUAS KUALA, KAPUAS, KALIMANTAN TENGAH",2,51,119,170
https://kawalpemilu.org#928283,"SIMPANG BUNGA TANJUNG, KAPUAS KUALA, KAPUAS, KALIMANTAN TENGAH",3,23,48,71
https://kawalpemilu.org#928283,"SIMPANG BUNGA TANJUNG, KAPUAS KUALA, KAPUAS, KALIMANTAN TENGAH",4,27,71,98
https://kawalpemilu.org#928283,"SIMPANG BUNGA TANJUNG, KAPUAS KUALA, KAPUAS, KALIMANTAN TENGAH",5,38,70,108
https://kawalpemilu.org#928284,"BARANGGAU, KAPUAS KUALA, KAPUAS, KALIMANTAN TENGAH",1,62,77,139
https://kawalpemilu.org#928284,"BARANGGAU, KAPUAS KUALA, KAPUAS, KALIMANTAN TENGAH",2,48,41,89
https://kawalpemilu.org#928284,"BARANGGAU, KAPUAS KUALA, KAPUAS, KALIMANTAN TENGAH",3,93,125,218
https://kawalpemilu.org#60711,"MANDOMAI, KAPUAS BARAT, KAPUAS, KALIMANTAN TENGAH",1,95,110,205
https://kawalpemilu.org#60711,"MANDOMAI, KAPUAS BARAT, KAPUAS, KALIMANTAN TENGAH",2,50,48,98
https://kawalpemilu.org#60711,"MANDOMAI, KAPUAS BARAT, KAPUAS, KALIMANTAN TENGAH",3,56,17,73
https://kawalpemilu.org#60711,"MANDOMAI, KAPUAS BARAT, KAPUAS, KALIMANTAN TENGAH",4,20,37,57
https://kawalpemilu.org#60711,"MANDOMAI, KAPUAS BARAT, KAPUAS, KALIMANTAN TENGAH",5,27,93,120
https://kawalpemilu.org#60711,"MANDOMAI, KAPUAS BARAT, KAPUAS, KALIMANTAN TENGAH",6,23,65,88
https://kawalpemilu.org#60711,"MANDOMAI, KAPUAS BARAT, KAPUAS, KALIMANTAN TENGAH",7,68,51,119
https://kawalpemilu.org#60711,"MANDOMAI, KAPUAS BARAT, KAPUAS, KALIMANTAN TENGAH",10,35,94,129
https://kawalpemilu.org#60711,"MANDOMAI, KAPUAS BARAT, KAPUAS, KALIMANTAN TENGAH",11,37,158,195
https://kawalpemilu.org#60711,"MANDOMAI, KAPUAS BARAT, KAPUAS, KALIMANTAN TENGAH",12,31,85,116
https://kawalpemilu.org#60711,"MANDOMAI, KAPUAS BARAT, KAPUAS, KALIMANTAN TENGAH",13,58,64,122
https://kawalpemilu.org#60711,"MANDOMAI, KAPUAS BARAT, KAPUAS, KALIMANTAN TENGAH",14,44,57,101
https://kawalpemilu.org#60711,"MANDOMAI, KAPUAS BARAT, KAPUAS, KALIMANTAN TENGAH",16,79,49,128
https://kawalpemilu.org#60711,"MANDOMAI, KAPUAS BARAT, KAPUAS, KALIMANTAN TENGAH",17,31,74,105
https://kawalpemilu.org#60711,"MANDOMAI, KAPUAS BARAT, KAPUAS, KALIMANTAN TENGAH",18,96,20,116
https://kawalpemilu.org#60712,"SEI KAYU, KAPUAS BARAT, KAPUAS, KALIMANTAN TENGAH",1,146,31,177
https://kawalpemilu.org#60712,"SEI KAYU, KAPUAS BARAT, KAPUAS, KALIMANTAN TENGAH",2,70,54,124
https://kawalpemilu.org#60712,"SEI KAYU, KAPUAS BARAT, KAPUAS, KALIMANTAN TENGAH",3,64,32,96
https://kawalpemilu.org#60712,"SEI KAYU, KAPUAS BARAT, KAPUAS, KALIMANTAN TENGAH",4,125,58,183
https://kawalpemilu.org#60712,"SEI KAYU, KAPUAS BARAT, KAPUAS, KALIMANTAN TENGAH",5,79,81,160
https://kawalpemilu.org#60712,"SEI KAYU, KAPUAS BARAT, KAPUAS, KALIMANTAN TENGAH",6,52,26,78
https://kawalpemilu.org#60712,"SEI KAYU, KAPUAS BARAT, KAPUAS, KALIMANTAN TENGAH",7,116,56,172
https://kawalpemilu.org#60713,"SAKA MANGKAHAI, KAPUAS BARAT, KAPUAS, KALIMANTAN TENGAH",1,126,34,160
https://kawalpemilu.org#60713,"SAKA MANGKAHAI, KAPUAS BARAT, KAPUAS, KALIMANTAN TENGAH",2,114,25,139
https://kawalpemilu.org#60713,"SAKA MANGKAHAI, KAPUAS BARAT, KAPUAS, KALIMANTAN TENGAH",3,132,49,181
https://kawalpemilu.org#60713,"SAKA MANGKAHAI, KAPUAS BARAT, KAPUAS, KALIMANTAN TENGAH",4,132,57,189
https://kawalpemilu.org#60713,"SAKA MANGKAHAI, KAPUAS BARAT, KAPUAS, KALIMANTAN TENGAH",5,117,65,182
https://kawalpemilu.org#60713,"SAKA MANGKAHAI, KAPUAS BARAT, KAPUAS, KALIMANTAN TENGAH",6,113,80,193
https://kawalpemilu.org#60713,"SAKA MANGKAHAI, KAPUAS BARAT, KAPUAS, KALIMANTAN TENGAH",7,79,31,110
https://kawalpemilu.org#60713,"SAKA MANGKAHAI, KAPUAS BARAT, KAPUAS, KALIMANTAN TENGAH",8,57,69,126
https://kawalpemilu.org#60714,"ANJIR KALAMPAN, KAPUAS BARAT, KAPUAS, KALIMANTAN TENGAH",1,124,94,218
https://kawalpemilu.org#60714,"ANJIR KALAMPAN, KAPUAS BARAT, KAPUAS, KALIMANTAN TENGAH",2,62,86,148
https://kawalpemilu.org#60714,"ANJIR KALAMPAN, KAPUAS BARAT, KAPUAS, KALIMANTAN TENGAH",3,35,85,120
https://kawalpemilu.org#60714,"ANJIR KALAMPAN, KAPUAS BARAT, KAPUAS, KALIMANTAN TENGAH",4,74,79,153
https://kawalpemilu.org#60714,"ANJIR KALAMPAN, KAPUAS BARAT, KAPUAS, KALIMANTAN TENGAH",5,105,29,134
https://kawalpemilu.org#60714,"ANJIR KALAMPAN, KAPUAS BARAT, KAPUAS, KALIMANTAN TENGAH",6,44,87,131
https://kawalpemilu.org#60714,"ANJIR KALAMPAN, KAPUAS BARAT, KAPUAS, KALIMANTAN TENGAH",7,25,69,94
https://kawalpemilu.org#60714,"ANJIR KALAMPAN, KAPUAS BARAT, KAPUAS, KALIMANTAN TENGAH",8,32,83,115
https://kawalpemilu.org#60714,"ANJIR KALAMPAN, KAPUAS BARAT, KAPUAS, KALIMANTAN TENGAH",9,105,101,206
https://kawalpemilu.org#60714,"ANJIR KALAMPAN, KAPUAS BARAT, KAPUAS, KALIMANTAN TENGAH",10,105,9,114
https://kawalpemilu.org#60715,"PANTAI, KAPUAS BARAT, KAPUAS, KALIMANTAN TENGAH",1,95,99,194
https://kawalpemilu.org#60715,"PANTAI, KAPUAS BARAT, KAPUAS, KALIMANTAN TENGAH",2,89,45,134
https://kawalpemilu.org#60715,"PANTAI, KAPUAS BARAT, KAPUAS, KALIMANTAN TENGAH",3,96,48,144
https://kawalpemilu.org#60715,"PANTAI, KAPUAS BARAT, KAPUAS, KALIMANTAN TENGAH",4,143,44,187
https://kawalpemilu.org#60715,"PANTAI, KAPUAS BARAT, KAPUAS, KALIMANTAN TENGAH",5,113,22,135
https://kawalpemilu.org#60715,"PANTAI, KAPUAS BARAT, KAPUAS, KALIMANTAN TENGAH",6,93,31,124
https://kawalpemilu.org#60716,"SAKA TAMIANG, KAPUAS BARAT, KAPUAS, KALIMANTAN TENGAH",1,40,116,156
https://kawalpemilu.org#60716,"SAKA TAMIANG, KAPUAS BARAT, KAPUAS, KALIMANTAN TENGAH",2,97,61,158
https://kawalpemilu.org#60716,"SAKA TAMIANG, KAPUAS BARAT, KAPUAS, KALIMANTAN TENGAH",3,96,107,203
https://kawalpemilu.org#60716,"SAKA TAMIANG, KAPUAS BARAT, KAPUAS, KALIMANTAN TENGAH",4,67,61,128
https://kawalpemilu.org#60716,"SAKA TAMIANG, KAPUAS BARAT, KAPUAS, KALIMANTAN TENGAH",5,56,32,88
https://kawalpemilu.org#60716,"SAKA TAMIANG, KAPUAS BARAT, KAPUAS, KALIMANTAN TENGAH",6,19,31,50
https://kawalpemilu.org#60716,"SAKA TAMIANG, KAPUAS BARAT, KAPUAS, KALIMANTAN TENGAH",7,52,50,102
https://kawalpemilu.org#60717,"PENDA KATAPI, KAPUAS BARAT, KAPUAS, KALIMANTAN TENGAH",1,126,50,176
https://kawalpemilu.org#60717,"PENDA KATAPI, KAPUAS BARAT, KAPUAS, KALIMANTAN TENGAH",2,145,66,211
https://kawalpemilu.org#60717,"PENDA KATAPI, KAPUAS BARAT, KAPUAS, KALIMANTAN TENGAH",3,132,50,182
https://kawalpemilu.org#60718,"TELUK HIRI, KAPUAS BARAT, KAPUAS, KALIMANTAN TENGAH",1,129,71,200
https://kawalpemilu.org#60719,"SEI DUSUN, KAPUAS BARAT, KAPUAS, KALIMANTAN TENGAH",1,135,52,187
https://kawalpemilu.org#60719,"SEI DUSUN, KAPUAS BARAT, KAPUAS, KALIMANTAN TENGAH",2,100,48,148
https://kawalpemilu.org#60719,"SEI DUSUN, KAPUAS BARAT, KAPUAS, KALIMANTAN TENGAH",3,69,62,131
https://kawalpemilu.org#60719,"SEI DUSUN, KAPUAS BARAT, KAPUAS, KALIMANTAN TENGAH",4,41,34,75
https://kawalpemilu.org#60719,"SEI DUSUN, KAPUAS BARAT, KAPUAS, KALIMANTAN TENGAH",5,75,22,97
https://kawalpemilu.org#60721,"SEI PITUNG, KAPUAS BARAT, KAPUAS, KALIMANTAN TENGAH",1,47,73,120
https://kawalpemilu.org#60721,"SEI PITUNG, KAPUAS BARAT, KAPUAS, KALIMANTAN TENGAH",2,63,59,122
https://kawalpemilu.org#60721,"SEI PITUNG, KAPUAS BARAT, KAPUAS, KALIMANTAN TENGAH",3,51,84,135
https://kawalpemilu.org#60721,"SEI PITUNG, KAPUAS BARAT, KAPUAS, KALIMANTAN TENGAH",4,34,67,101
https://kawalpemilu.org#60721,"SEI PITUNG, KAPUAS BARAT, KAPUAS, KALIMANTAN TENGAH",5,31,47,78
https://kawalpemilu.org#60721,"SEI PITUNG, KAPUAS BARAT, KAPUAS, KALIMANTAN TENGAH",6,43,95,138
https://kawalpemilu.org#60721,"SEI PITUNG, KAPUAS BARAT, KAPUAS, KALIMANTAN TENGAH",7,83,111,194
https://kawalpemilu.org#928285,"MAJU BERSAMA, KAPUAS BARAT, KAPUAS, KALIMANTAN TENGAH",1,87,28,115
https://kawalpemilu.org#928285,"MAJU BERSAMA, KAPUAS BARAT, KAPUAS, KALIMANTAN TENGAH",2,60,59,119
https://kawalpemilu.org#928285,"MAJU BERSAMA, KAPUAS BARAT, KAPUAS, KALIMANTAN TENGAH",3,71,79,150
https://kawalpemilu.org#928286,"BASUTA RAYA, KAPUAS BARAT, KAPUAS, KALIMANTAN TENGAH",1,85,38,123
https://kawalpemilu.org#928286,"BASUTA RAYA, KAPUAS BARAT, KAPUAS, KALIMANTAN TENGAH",2,78,63,141
https://kawalpemilu.org#60723,"SAKA LAGUN, PULAU PETAK, KAPUAS, KALIMANTAN TENGAH",1,64,76,140
https://kawalpemilu.org#60723,"SAKA LAGUN, PULAU PETAK, KAPUAS, KALIMANTAN TENGAH",2,81,134,215
https://kawalpemilu.org#60723,"SAKA LAGUN, PULAU PETAK, KAPUAS, KALIMANTAN TENGAH",3,59,100,159
https://kawalpemilu.org#60723,"SAKA LAGUN, PULAU PETAK, KAPUAS, KALIMANTAN TENGAH",4,51,54,105
https://kawalpemilu.org#60723,"SAKA LAGUN, PULAU PETAK, KAPUAS, KALIMANTAN TENGAH",5,27,127,154
https://kawalpemilu.org#60723,"SAKA LAGUN, PULAU PETAK, KAPUAS, KALIMANTAN TENGAH",6,24,113,137
https://kawalpemilu.org#60723,"SAKA LAGUN, PULAU PETAK, KAPUAS, KALIMANTAN TENGAH",7,49,74,123
https://kawalpemilu.org#60723,"SAKA LAGUN, PULAU PETAK, KAPUAS, KALIMANTAN TENGAH",8,42,79,121
https://kawalpemilu.org#60724,"BUNGA MAWAR, PULAU PETAK, KAPUAS, KALIMANTAN TENGAH",1,61,108,169
https://kawalpemilu.org#60724,"BUNGA MAWAR, PULAU PETAK, KAPUAS, KALIMANTAN TENGAH",2,24,41,65
https://kawalpemilu.org#60724,"BUNGA MAWAR, PULAU PETAK, KAPUAS, KALIMANTAN TENGAH",3,41,68,109
https://kawalpemilu.org#60724,"BUNGA MAWAR, PULAU PETAK, KAPUAS, KALIMANTAN TENGAH",4,69,93,162
https://kawalpemilu.org#60724,"BUNGA MAWAR, PULAU PETAK, KAPUAS, KALIMANTAN TENGAH",5,33,87,120
https://kawalpemilu.org#60724,"BUNGA MAWAR, PULAU PETAK, KAPUAS, KALIMANTAN TENGAH",6,42,62,104
https://kawalpemilu.org#60724,"BUNGA MAWAR, PULAU PETAK, KAPUAS, KALIMANTAN TENGAH",7,39,58,97
https://kawalpemilu.org#60724,"BUNGA MAWAR, PULAU PETAK, KAPUAS, KALIMANTAN TENGAH",8,52,111,163
https://kawalpemilu.org#60725,"SEI TATAS, PULAU PETAK, KAPUAS, KALIMANTAN TENGAH",1,20,58,78
https://kawalpemilu.org#60725,"SEI TATAS, PULAU PETAK, KAPUAS, KALIMANTAN TENGAH",2,36,116,152
https://kawalpemilu.org#60725,"SEI TATAS, PULAU PETAK, KAPUAS, KALIMANTAN TENGAH",3,47,89,136
https://kawalpemilu.org#60725,"SEI TATAS, PULAU PETAK, KAPUAS, KALIMANTAN TENGAH",4,50,126,176
https://kawalpemilu.org#60725,"SEI TATAS, PULAU PETAK, KAPUAS, KALIMANTAN TENGAH",5,49,105,154
https://kawalpemilu.org#60726,"NARAHAN, PULAU PETAK, KAPUAS, KALIMANTAN TENGAH",1,48,135,183
https://kawalpemilu.org#60726,"NARAHAN, PULAU PETAK, KAPUAS, KALIMANTAN TENGAH",2,42,107,149
https://kawalpemilu.org#60726,"NARAHAN, PULAU PETAK, KAPUAS, KALIMANTAN TENGAH",3,62,58,120
https://kawalpemilu.org#60726,"NARAHAN, PULAU PETAK, KAPUAS, KALIMANTAN TENGAH",4,57,83,140
https://kawalpemilu.org#60726,"NARAHAN, PULAU PETAK, KAPUAS, KALIMANTAN TENGAH",5,70,68,138
https://kawalpemilu.org#60727,"HANDIWUNG, PULAU PETAK, KAPUAS, KALIMANTAN TENGAH",1,55,103,158
https://kawalpemilu.org#60727,"HANDIWUNG, PULAU PETAK, KAPUAS, KALIMANTAN TENGAH",2,72,125,197
https://kawalpemilu.org#60727,"HANDIWUNG, PULAU PETAK, KAPUAS, KALIMANTAN TENGAH",3,24,96,120
https://kawalpemilu.org#60727,"HANDIWUNG, PULAU PETAK, KAPUAS, KALIMANTAN TENGAH",4,32,130,162
https://kawalpemilu.org#60727,"HANDIWUNG, PULAU PETAK, KAPUAS, KALIMANTAN TENGAH",5,55,158,213
https://kawalpemilu.org#60727,"HANDIWUNG, PULAU PETAK, KAPUAS, KALIMANTAN TENGAH",6,68,91,159
https://kawalpemilu.org#60727,"HANDIWUNG, PULAU PETAK, KAPUAS, KALIMANTAN TENGAH",7,16,111,127
https://kawalpemilu.org#60728,"ANJIR PALAMBANG, PULAU PETAK, KAPUAS, KALIMANTAN TENGAH",1,43,70,113
https://kawalpemilu.org#60728,"ANJIR PALAMBANG, PULAU PETAK, KAPUAS, KALIMANTAN TENGAH",2,19,81,100
https://kawalpemilu.org#60728,"ANJIR PALAMBANG, PULAU PETAK, KAPUAS, KALIMANTAN TENGAH",3,15,138,153
https://kawalpemilu.org#60728,"ANJIR PALAMBANG, PULAU PETAK, KAPUAS, KALIMANTAN TENGAH",4,12,107,119
https://kawalpemilu.org#60728,"ANJIR PALAMBANG, PULAU PETAK, KAPUAS, KALIMANTAN TENGAH",5,11,107,118
https://kawalpemilu.org#60729,"PALANGKAI, PULAU PETAK, KAPUAS, KALIMANTAN TENGAH",1,55,144,199
https://kawalpemilu.org#60729,"PALANGKAI, PULAU PETAK, KAPUAS, KALIMANTAN TENGAH",2,42,72,114
https://kawalpemilu.org#60729,"PALANGKAI, PULAU PETAK, KAPUAS, KALIMANTAN TENGAH",3,41,106,147
https://kawalpemilu.org#60730,"TELUK PALINGET, PULAU PETAK, KAPUAS, KALIMANTAN TENGAH",1,41,150,191
https://kawalpemilu.org#60730,"TELUK PALINGET, PULAU PETAK, KAPUAS, KALIMANTAN TENGAH",2,49,136,185
https://kawalpemilu.org#60730,"TELUK PALINGET, PULAU PETAK, KAPUAS, KALIMANTAN TENGAH",3,40,126,166
https://kawalpemilu.org#60730,"TELUK PALINGET, PULAU PETAK, KAPUAS, KALIMANTAN TENGAH",4,56,77,133
https://kawalpemilu.org#60730,"TELUK PALINGET, PULAU PETAK, KAPUAS, KALIMANTAN TENGAH",5,45,113,158
https://kawalpemilu.org#60730,"TELUK PALINGET, PULAU PETAK, KAPUAS, KALIMANTAN TENGAH",6,26,96,122
https://kawalpemilu.org#60730,"TELUK PALINGET, PULAU PETAK, KAPUAS, KALIMANTAN TENGAH",7,72,100,172
https://kawalpemilu.org#60730,"TELUK PALINGET, PULAU PETAK, KAPUAS, KALIMANTAN TENGAH",8,76,124,200
https://kawalpemilu.org#60730,"TELUK PALINGET, PULAU PETAK, KAPUAS, KALIMANTAN TENGAH",9,27,92,119
https://kawalpemilu.org#60730,"TELUK PALINGET, PULAU PETAK, KAPUAS, KALIMANTAN TENGAH",10,24,39,63
https://kawalpemilu.org#60730,"TELUK PALINGET, PULAU PETAK, KAPUAS, KALIMANTAN TENGAH",11,27,87,114
https://kawalpemilu.org#60730,"TELUK PALINGET, PULAU PETAK, KAPUAS, KALIMANTAN TENGAH",12,37,59,96
https://kawalpemilu.org#85375,"SEI TATAS HILIR, PULAU PETAK, KAPUAS, KALIMANTAN TENGAH",1,102,44,146
https://kawalpemilu.org#85375,"SEI TATAS HILIR, PULAU PETAK, KAPUAS, KALIMANTAN TENGAH",2,67,64,131
https://kawalpemilu.org#85375,"SEI TATAS HILIR, PULAU PETAK, KAPUAS, KALIMANTAN TENGAH",3,109,59,168
https://kawalpemilu.org#85375,"SEI TATAS HILIR, PULAU PETAK, KAPUAS, KALIMANTAN TENGAH",4,108,89,197
https://kawalpemilu.org#85375,"SEI TATAS HILIR, PULAU PETAK, KAPUAS, KALIMANTAN TENGAH",5,92,91,183
https://kawalpemilu.org#85375,"SEI TATAS HILIR, PULAU PETAK, KAPUAS, KALIMANTAN TENGAH",6,54,69,123
https://kawalpemilu.org#85375,"SEI TATAS HILIR, PULAU PETAK, KAPUAS, KALIMANTAN TENGAH",7,29,62,91
https://kawalpemilu.org#85375,"SEI TATAS HILIR, PULAU PETAK, KAPUAS, KALIMANTAN TENGAH",8,49,11,60
https://kawalpemilu.org#928287,"MAWAR MEKAR, PULAU PETAK, KAPUAS, KALIMANTAN TENGAH",1,39,165,204
https://kawalpemilu.org#928287,"MAWAR MEKAR, PULAU PETAK, KAPUAS, KALIMANTAN TENGAH",2,41,87,128
https://kawalpemilu.org#928287,"MAWAR MEKAR, PULAU PETAK, KAPUAS, KALIMANTAN TENGAH",3,25,91,116
https://kawalpemilu.org#928287,"MAWAR MEKAR, PULAU PETAK, KAPUAS, KALIMANTAN TENGAH",4,50,144,194
https://kawalpemilu.org#928288,"BANAMA, PULAU PETAK, KAPUAS, KALIMANTAN TENGAH",1,27,134,161
https://kawalpemilu.org#928288,"BANAMA, PULAU PETAK, KAPUAS, KALIMANTAN TENGAH",2,64,82,146
https://kawalpemilu.org#928288,"BANAMA, PULAU PETAK, KAPUAS, KALIMANTAN TENGAH",3,45,133,178
https://kawalpemilu.org#928288,"BANAMA, PULAU PETAK, KAPUAS, KALIMANTAN TENGAH",4,20,91,111
https://kawalpemilu.org#928288,"BANAMA, PULAU PETAK, KAPUAS, KALIMANTAN TENGAH",5,12,103,115
https://kawalpemilu.org#928289,"NARAHAN BARU, PULAU PETAK, KAPUAS, KALIMANTAN TENGAH",1,68,114,182
https://kawalpemilu.org#928289,"NARAHAN BARU, PULAU PETAK, KAPUAS, KALIMANTAN TENGAH",2,59,109,168
https://kawalpemilu.org#928289,"NARAHAN BARU, PULAU PETAK, KAPUAS, KALIMANTAN TENGAH",3,57,135,192
https://kawalpemilu.org#60732,"PALINGKAU BARU, KAPUAS MURUNG, KAPUAS, KALIMANTAN TENGAH",1,30,99,129
https://kawalpemilu.org#60732,"PALINGKAU BARU, KAPUAS MURUNG, KAPUAS, KALIMANTAN TENGAH",2,44,142,186
https://kawalpemilu.org#60732,"PALINGKAU BARU, KAPUAS MURUNG, KAPUAS, KALIMANTAN TENGAH",3,66,111,177
https://kawalpemilu.org#60732,"PALINGKAU BARU, KAPUAS MURUNG, KAPUAS, KALIMANTAN TENGAH",4,37,88,125
https://kawalpemilu.org#60732,"PALINGKAU BARU, KAPUAS MURUNG, KAPUAS, KALIMANTAN TENGAH",5,37,145,182
https://kawalpemilu.org#60732,"PALINGKAU BARU, KAPUAS MURUNG, KAPUAS, KALIMANTAN TENGAH",6,21,79,100
https://kawalpemilu.org#60732,"PALINGKAU BARU, KAPUAS MURUNG, KAPUAS, KALIMANTAN TENGAH",7,56,130,186
https://kawalpemilu.org#60732,"PALINGKAU BARU, KAPUAS MURUNG, KAPUAS, KALIMANTAN TENGAH",8,48,43,91
https://kawalpemilu.org#60732,"PALINGKAU BARU, KAPUAS MURUNG, KAPUAS, KALIMANTAN TENGAH",9,55,151,206
https://kawalpemilu.org#60732,"PALINGKAU BARU, KAPUAS MURUNG, KAPUAS, KALIMANTAN TENGAH",10,30,63,93
https://kawalpemilu.org#60732,"PALINGKAU BARU, KAPUAS MURUNG, KAPUAS, KALIMANTAN TENGAH",11,43,86,129
https://kawalpemilu.org#60732,"PALINGKAU BARU, KAPUAS MURUNG, KAPUAS, KALIMANTAN TENGAH",12,56,77,132
https://kawalpemilu.org#60733,"PALINGKAU LAMA, KAPUAS MURUNG, KAPUAS, KALIMANTAN TENGAH",1,48,127,175
https://kawalpemilu.org#60733,"PALINGKAU LAMA, KAPUAS MURUNG, KAPUAS, KALIMANTAN TENGAH",2,35,110,145
https://kawalpemilu.org#60733,"PALINGKAU LAMA, KAPUAS MURUNG, KAPUAS, KALIMANTAN TENGAH",3,39,125,164
https://kawalpemilu.org#60733,"PALINGKAU LAMA, KAPUAS MURUNG, KAPUAS, KALIMANTAN TENGAH",4,37,171,208
https://kawalpemilu.org#60733,"PALINGKAU LAMA, KAPUAS MURUNG, KAPUAS, KALIMANTAN TENGAH",5,63,138,201
https://kawalpemilu.org#60733,"PALINGKAU LAMA, KAPUAS MURUNG, KAPUAS, KALIMANTAN TENGAH",6,22,70,92
https://kawalpemilu.org#60733,"PALINGKAU LAMA, KAPUAS MURUNG, KAPUAS, KALIMANTAN TENGAH",7,100,116,216
https://kawalpemilu.org#60733,"PALINGKAU LAMA, KAPUAS MURUNG, KAPUAS, KALIMANTAN TENGAH",8,56,214,270
https://kawalpemilu.org#60733,"PALINGKAU LAMA, KAPUAS MURUNG, KAPUAS, KALIMANTAN TENGAH",9,25,186,211
https://kawalpemilu.org#60733,"PALINGKAU LAMA, KAPUAS MURUNG, KAPUAS, KALIMANTAN TENGAH",10,53,107,160
https://kawalpemilu.org#60733,"PALINGKAU LAMA, KAPUAS MURUNG, KAPUAS, KALIMANTAN TENGAH",11,56,60,116
https://kawalpemilu.org#60733,"PALINGKAU LAMA, KAPUAS MURUNG, KAPUAS, KALIMANTAN TENGAH",12,73,55,128
https://kawalpemilu.org#60733,"PALINGKAU LAMA, KAPUAS MURUNG, KAPUAS, KALIMANTAN TENGAH",13,51,145,196
https://kawalpemilu.org#60733,"PALINGKAU LAMA, KAPUAS MURUNG, KAPUAS, KALIMANTAN TENGAH",14,18,150,168
https://kawalpemilu.org#60733,"PALINGKAU LAMA, KAPUAS MURUNG, KAPUAS, KALIMANTAN TENGAH",15,42,142,184
https://kawalpemilu.org#60733,"PALINGKAU LAMA, KAPUAS MURUNG, KAPUAS, KALIMANTAN TENGAH",16,19,157,176
https://kawalpemilu.org#60733,"PALINGKAU LAMA, KAPUAS MURUNG, KAPUAS, KALIMANTAN TENGAH",17,40,106,146
https://kawalpemilu.org#60733,"PALINGKAU LAMA, KAPUAS MURUNG, KAPUAS, KALIMANTAN TENGAH",18,52,74,126
https://kawalpemilu.org#60733,"PALINGKAU LAMA, KAPUAS MURUNG, KAPUAS, KALIMANTAN TENGAH",19,35,141,176
https://kawalpemilu.org#60734,"TAJEPAN, KAPUAS MURUNG, KAPUAS, KALIMANTAN TENGAH",1,66,157,223
https://kawalpemilu.org#60734,"TAJEPAN, KAPUAS MURUNG, KAPUAS, KALIMANTAN TENGAH",2,76,135,211
https://kawalpemilu.org#60734,"TAJEPAN, KAPUAS MURUNG, KAPUAS, KALIMANTAN TENGAH",3,68,163,231
https://kawalpemilu.org#60734,"TAJEPAN, KAPUAS MURUNG, KAPUAS, KALIMANTAN TENGAH",4,96,113,209
https://kawalpemilu.org#60734,"TAJEPAN, KAPUAS MURUNG, KAPUAS, KALIMANTAN TENGAH",5,57,119,0
https://kawalpemilu.org#60734,"TAJEPAN, KAPUAS MURUNG, KAPUAS, KALIMANTAN TENGAH",6,47,133,180
https://kawalpemilu.org#60734,"TAJEPAN, KAPUAS MURUNG, KAPUAS, KALIMANTAN TENGAH",7,37,119,156
https://kawalpemilu.org#60735,"MAMPAI, KAPUAS MURUNG, KAPUAS, KALIMANTAN TENGAH",1,52,120,172
https://kawalpemilu.org#60735,"MAMPAI, KAPUAS MURUNG, KAPUAS, KALIMANTAN TENGAH",2,32,55,87
https://kawalpemilu.org#60735,"MAMPAI, KAPUAS MURUNG, KAPUAS, KALIMANTAN TENGAH",3,47,103,150
https://kawalpemilu.org#60735,"MAMPAI, KAPUAS MURUNG, KAPUAS, KALIMANTAN TENGAH",4,14,182,196
https://kawalpemilu.org#60735,"MAMPAI, KAPUAS MURUNG, KAPUAS, KALIMANTAN TENGAH",5,28,147,175
https://kawalpemilu.org#60735,"MAMPAI, KAPUAS MURUNG, KAPUAS, KALIMANTAN TENGAH",6,78,125,203
https://kawalpemilu.org#60736,"MUARA DADAHUP, KAPUAS MURUNG, KAPUAS, KALIMANTAN TENGAH",1,37,98,135
https://kawalpemilu.org#60736,"MUARA DADAHUP, KAPUAS MURUNG, KAPUAS, KALIMANTAN TENGAH",2,123,105,228
https://kawalpemilu.org#60736,"MUARA DADAHUP, KAPUAS MURUNG, KAPUAS, KALIMANTAN TENGAH",3,67,77,144
https://kawalpemilu.org#60736,"MUARA DADAHUP, KAPUAS MURUNG, KAPUAS, KALIMANTAN TENGAH",4,83,96,179
https://kawalpemilu.org#60736,"MUARA DADAHUP, KAPUAS MURUNG, KAPUAS, KALIMANTAN TENGAH",5,82,73,155
https://kawalpemilu.org#60737,"BELAWANG, KAPUAS MURUNG, KAPUAS, KALIMANTAN TENGAH",1,12,153,165
https://kawalpemilu.org#60737,"BELAWANG, KAPUAS MURUNG, KAPUAS, KALIMANTAN TENGAH",2,31,148,179
https://kawalpemilu.org#60739,"PALANGKAU LAMA, KAPUAS MURUNG, KAPUAS, KALIMANTAN TENGAH",1,117,61,178
https://kawalpemilu.org#60739,"PALANGKAU LAMA, KAPUAS MURUNG, KAPUAS, KALIMANTAN TENGAH",2,76,67,143
https://kawalpemilu.org#60759,"PALANGKAU BARU, KAPUAS MURUNG, KAPUAS, KALIMANTAN TENGAH",1,38,163,201
https://kawalpemilu.org#60759,"PALANGKAU BARU, KAPUAS MURUNG, KAPUAS, KALIMANTAN TENGAH",2,39,144,183
https://kawalpemilu.org#928290,"TALEKUNG PUNEI, KAPUAS MURUNG, KAPUAS, KALIMANTAN TENGAH",1,45,112,157
https://kawalpemilu.org#928290,"TALEKUNG PUNEI, KAPUAS MURUNG, KAPUAS, KALIMANTAN TENGAH",2,37,59,96
https://kawalpemilu.org#928291,"KARYA BERSAMA, KAPUAS MURUNG, KAPUAS, KALIMANTAN TENGAH",1,86,107,193
https://kawalpemilu.org#928291,"KARYA BERSAMA, KAPUAS MURUNG, KAPUAS, KALIMANTAN TENGAH",2,37,129,166
https://kawalpemilu.org#928291,"KARYA BERSAMA, KAPUAS MURUNG, KAPUAS, KALIMANTAN TENGAH",3,91,71,162
https://kawalpemilu.org#928291,"KARYA BERSAMA, KAPUAS MURUNG, KAPUAS, KALIMANTAN TENGAH",4,95,51,146
https://kawalpemilu.org#928291,"KARYA BERSAMA, KAPUAS MURUNG, KAPUAS, KALIMANTAN TENGAH",5,35,59,94
https://kawalpemilu.org#928292,"PALINGKAU JAYA, KAPUAS MURUNG, KAPUAS, KALIMANTAN TENGAH",1,100,68,168
https://kawalpemilu.org#928292,"PALINGKAU JAYA, KAPUAS MURUNG, KAPUAS, KALIMANTAN TENGAH",2,77,59,136
https://kawalpemilu.org#928292,"PALINGKAU JAYA, KAPUAS MURUNG, KAPUAS, KALIMANTAN TENGAH",3,117,20,137
https://kawalpemilu.org#928293,"PALINGKAU ASRI, KAPUAS MURUNG, KAPUAS, KALIMANTAN TENGAH",1,94,54,148
https://kawalpemilu.org#928293,"PALINGKAU ASRI, KAPUAS MURUNG, KAPUAS, KALIMANTAN TENGAH",2,119,89,208
https://kawalpemilu.org#928294,"PALINGKAU SEJAHTERA, KAPUAS MURUNG, KAPUAS, KALIMANTAN TENGAH",1,120,90,210
https://kawalpemilu.org#928294,"PALINGKAU SEJAHTERA, KAPUAS MURUNG, KAPUAS, KALIMANTAN TENGAH",2,80,58,138
https://kawalpemilu.org#928295,"SAKA BINJAI, KAPUAS MURUNG, KAPUAS, KALIMANTAN TENGAH",1,46,45,91
https://kawalpemilu.org#928296,"BINA SEJAHTERA, KAPUAS MURUNG, KAPUAS, KALIMANTAN TENGAH",1,138,44,182
https://kawalpemilu.org#928297,"SUKA REJA, KAPUAS MURUNG, KAPUAS, KALIMANTAN TENGAH",1,64,39,103
https://kawalpemilu.org#928298,"SUKA MUKTI, KAPUAS MURUNG, KAPUAS, KALIMANTAN TENGAH",1,34,79,113
https://kawalpemilu.org#928299,"BINA KARYA, KAPUAS MURUNG, KAPUAS, KALIMANTAN TENGAH",1,193,51,244
https://kawalpemilu.org#928300,"BINA MEKAR, KAPUAS MURUNG, KAPUAS, KALIMANTAN TENGAH",1,124,37,161
https://kawalpemilu.org#928301,"RAWA SUBUR, KAPUAS MURUNG, KAPUAS, KALIMANTAN TENGAH",1,230,32,262
https://kawalpemilu.org#928301,"RAWA SUBUR, KAPUAS MURUNG, KAPUAS, KALIMANTAN TENGAH",2,144,78,222
https://kawalpemilu.org#928302,"SUMBER MULYA, KAPUAS MURUNG, KAPUAS, KALIMANTAN TENGAH",1,40,38,78
https://kawalpemilu.org#928302,"SUMBER MULYA, KAPUAS MURUNG, KAPUAS, KALIMANTAN TENGAH",2,37,9,46
https://kawalpemilu.org#928303,"BUMI RAHAYU, KAPUAS MURUNG, KAPUAS, KALIMANTAN TENGAH",1,104,70,174
https://kawalpemilu.org#928303,"BUMI RAHAYU, KAPUAS MURUNG, KAPUAS, KALIMANTAN TENGAH",2,114,54,168
https://kawalpemilu.org#928304,"MANGGALA PERMAI, KAPUAS MURUNG, KAPUAS, KALIMANTAN TENGAH",1,146,73,219
https://kawalpemilu.org#928304,"MANGGALA PERMAI, KAPUAS MURUNG, KAPUAS, KALIMANTAN TENGAH",2,142,74,216
https://kawalpemilu.org#60769,"PANGKALAN REKAN, BASARANG, KAPUAS, KALIMANTAN TENGAH",1,130,79,209
https://kawalpemilu.org#60769,"PANGKALAN REKAN, BASARANG, KAPUAS, KALIMANTAN TENGAH",2,30,86,116
https://kawalpemilu.org#60769,"PANGKALAN REKAN, BASARANG, KAPUAS, KALIMANTAN TENGAH",3,57,117,174
https://kawalpemilu.org#60769,"PANGKALAN REKAN, BASARANG, KAPUAS, KALIMANTAN TENGAH",4,65,124,189
https://kawalpemilu.org#60769,"PANGKALAN REKAN, BASARANG, KAPUAS, KALIMANTAN TENGAH",5,75,119,194
https://kawalpemilu.org#60769,"PANGKALAN REKAN, BASARANG, KAPUAS, KALIMANTAN TENGAH",6,46,86,132
https://kawalpemilu.org#60770,"BATUAH, BASARANG, KAPUAS, KALIMANTAN TENGAH",1,95,103,198
https://kawalpemilu.org#60770,"BATUAH, BASARANG, KAPUAS, KALIMANTAN TENGAH",2,84,71,155
https://kawalpemilu.org#60770,"BATUAH, BASARANG, KAPUAS, KALIMANTAN TENGAH",3,115,58,174
https://kawalpemilu.org#60770,"BATUAH, BASARANG, KAPUAS, KALIMANTAN TENGAH",4,69,95,164
https://kawalpemilu.org#60771,"BASARANG, BASARANG, KAPUAS, KALIMANTAN TENGAH",1,94,112,206
https://kawalpemilu.org#60771,"BASARANG, BASARANG, KAPUAS, KALIMANTAN TENGAH",2,70,101,171
https://kawalpemilu.org#60771,"BASARANG, BASARANG, KAPUAS, KALIMANTAN TENGAH",3,58,114,172
https://kawalpemilu.org#60771,"BASARANG, BASARANG, KAPUAS, KALIMANTAN TENGAH",4,62,131,193
https://kawalpemilu.org#60771,"BASARANG, BASARANG, KAPUAS, KALIMANTAN TENGAH",5,100,73,173
https://kawalpemilu.org#60771,"BASARANG, BASARANG, KAPUAS, KALIMANTAN TENGAH",6,123,81,204
https://kawalpemilu.org#60771,"BASARANG, BASARANG, KAPUAS, KALIMANTAN TENGAH",7,83,103,186
https://kawalpemilu.org#60771,"BASARANG, BASARANG, KAPUAS, KALIMANTAN TENGAH",8,88,71,159
https://kawalpemilu.org#60772,"BASUNGKAI, BASARANG, KAPUAS, KALIMANTAN TENGAH",1,82,148,230
https://kawalpemilu.org#60772,"BASUNGKAI, BASARANG, KAPUAS, KALIMANTAN TENGAH",2,113,124,237
https://kawalpemilu.org#60772,"BASUNGKAI, BASARANG, KAPUAS, KALIMANTAN TENGAH",3,75,89,164
https://kawalpemilu.org#60773,"MALUEN, BASARANG, KAPUAS, KALIMANTAN TENGAH",1,64,132,196
https://kawalpemilu.org#60773,"MALUEN, BASARANG, KAPUAS, KALIMANTAN TENGAH",2,62,131,193
https://kawalpemilu.org#60773,"MALUEN, BASARANG, KAPUAS, KALIMANTAN TENGAH",3,72,126,198
https://kawalpemilu.org#60773,"MALUEN, BASARANG, KAPUAS, KALIMANTAN TENGAH",4,80,111,191
https://kawalpemilu.org#60773,"MALUEN, BASARANG, KAPUAS, KALIMANTAN TENGAH",5,71,128,199
https://kawalpemilu.org#60773,"MALUEN, BASARANG, KAPUAS, KALIMANTAN TENGAH",6,89,82,171
https://kawalpemilu.org#60774,"PANGKALAN SARI, BASARANG, KAPUAS, KALIMANTAN TENGAH",1,76,68,144
https://kawalpemilu.org#60774,"PANGKALAN SARI, BASARANG, KAPUAS, KALIMANTAN TENGAH",2,72,55,127
https://kawalpemilu.org#60774,"PANGKALAN SARI, BASARANG, KAPUAS, KALIMANTAN TENGAH",3,83,56,139
https://kawalpemilu.org#60774,"PANGKALAN SARI, BASARANG, KAPUAS, KALIMANTAN TENGAH",4,49,82,131
https://kawalpemilu.org#60774,"PANGKALAN SARI, BASARANG, KAPUAS, KALIMANTAN TENGAH",5,24,80,104
https://kawalpemilu.org#60775,"LUNUK RAMBA, BASARANG, KAPUAS, KALIMANTAN TENGAH",1,140,55,195
https://kawalpemilu.org#60775,"LUNUK RAMBA, BASARANG, KAPUAS, KALIMANTAN TENGAH",2,120,27,147
https://kawalpemilu.org#60775,"LUNUK RAMBA, BASARANG, KAPUAS, KALIMANTAN TENGAH",3,72,134,206
https://kawalpemilu.org#60776,"BATU NINDAN, BASARANG, KAPUAS, KALIMANTAN TENGAH",1,153,68,221
https://kawalpemilu.org#60776,"BATU NINDAN, BASARANG, KAPUAS, KALIMANTAN TENGAH",2,105,61,166
https://kawalpemilu.org#60776,"BATU NINDAN, BASARANG, KAPUAS, KALIMANTAN TENGAH",3,119,81,200
https://kawalpemilu.org#60776,"BATU NINDAN, BASARANG, KAPUAS, KALIMANTAN TENGAH",4,72,143,215
https://kawalpemilu.org#60777,"BASARANG JAYA, BASARANG, KAPUAS, KALIMANTAN TENGAH",1,225,12,237
https://kawalpemilu.org#60777,"BASARANG JAYA, BASARANG, KAPUAS, KALIMANTAN TENGAH",2,208,36,244
https://kawalpemilu.org#60777,"BASARANG JAYA, BASARANG, KAPUAS, KALIMANTAN TENGAH",3,210,14,224
https://kawalpemilu.org#60777,"BASARANG JAYA, BASARANG, KAPUAS, KALIMANTAN TENGAH",4,207,37,244
https://kawalpemilu.org#60778,"BUNGAI JAYA, BASARANG, KAPUAS, KALIMANTAN TENGAH",1,45,166,211
https://kawalpemilu.org#60778,"BUNGAI JAYA, BASARANG, KAPUAS, KALIMANTAN TENGAH",2,94,129,223
https://kawalpemilu.org#60778,"BUNGAI JAYA, BASARANG, KAPUAS, KALIMANTAN TENGAH",3,82,126,208
https://kawalpemilu.org#60778,"BUNGAI JAYA, BASARANG, KAPUAS, KALIMANTAN TENGAH",4,115,124,239
https://kawalpemilu.org#60778,"BUNGAI JAYA, BASARANG, KAPUAS, KALIMANTAN TENGAH",5,42,127,169
https://kawalpemilu.org#60779,"PANARUNG, BASARANG, KAPUAS, KALIMANTAN TENGAH",1,93,94,187
https://kawalpemilu.org#60779,"PANARUNG, BASARANG, KAPUAS, KALIMANTAN TENGAH",2,125,91,216
https://kawalpemilu.org#60780,"TARUNG MANUAH, BASARANG, KAPUAS, KALIMANTAN TENGAH",1,67,160,227
https://kawalpemilu.org#60780,"TARUNG MANUAH, BASARANG, KAPUAS, KALIMANTAN TENGAH",2,76,95,171
https://kawalpemilu.org#60781,"TAMBUN RAYA, BASARANG, KAPUAS, KALIMANTAN TENGAH",1,122,106,228
https://kawalpemilu.org#60781,"TAMBUN RAYA, BASARANG, KAPUAS, KALIMANTAN TENGAH",2,105,118,223
https://kawalpemilu.org#60781,"TAMBUN RAYA, BASARANG, KAPUAS, KALIMANTAN TENGAH",3,117,91,208
https://kawalpemilu.org#60781,"TAMBUN RAYA, BASARANG, KAPUAS, KALIMANTAN TENGAH",4,114,99,213
https://kawalpemilu.org#60781,"TAMBUN RAYA, BASARANG, KAPUAS, KALIMANTAN TENGAH",5,106,115,221
https://kawalpemilu.org#60781,"TAMBUN RAYA, BASARANG, KAPUAS, KALIMANTAN TENGAH",6,86,114,200
https://kawalpemilu.org#60782,"NANING, BASARANG, KAPUAS, KALIMANTAN TENGAH",1,70,148,218
https://kawalpemilu.org#60782,"NANING, BASARANG, KAPUAS, KALIMANTAN TENGAH",2,35,141,176
https://kawalpemilu.org#60784,"MANUSUP, MANTANGAI, KAPUAS, KALIMANTAN TENGAH",1,58,151,209
https://kawalpemilu.org#60784,"MANUSUP, MANTANGAI, KAPUAS, KALIMANTAN TENGAH",2,43,138,181
https://kawalpemilu.org#60784,"MANUSUP, MANTANGAI, KAPUAS, KALIMANTAN TENGAH",3,66,113,179
https://kawalpemilu.org#60784,"MANUSUP, MANTANGAI, KAPUAS, KALIMANTAN TENGAH",4,66,107,173
https://kawalpemilu.org#60784,"MANUSUP, MANTANGAI, KAPUAS, KALIMANTAN TENGAH",5,26,71,97
https://kawalpemilu.org#60785,"SEI KAPAR, MANTANGAI, KAPUAS, KALIMANTAN TENGAH",1,101,76,177
https://kawalpemilu.org#60785,"SEI KAPAR, MANTANGAI, KAPUAS, KALIMANTAN TENGAH",2,61,69,130
https://kawalpemilu.org#60785,"SEI KAPAR, MANTANGAI, KAPUAS, KALIMANTAN TENGAH",3,67,64,131
https://kawalpemilu.org#60786,"TARANTANG, MANTANGAI, KAPUAS, KALIMANTAN TENGAH",1,123,35,158
https://kawalpemilu.org#60786,"TARANTANG, MANTANGAI, KAPUAS, KALIMANTAN TENGAH",2,124,29,153
https://kawalpemilu.org#60786,"TARANTANG, MANTANGAI, KAPUAS, KALIMANTAN TENGAH",3,111,33,144
https://kawalpemilu.org#60786,"TARANTANG, MANTANGAI, KAPUAS, KALIMANTAN TENGAH",4,115,38,153
https://kawalpemilu.org#60786,"TARANTANG, MANTANGAI, KAPUAS, KALIMANTAN TENGAH",5,77,38,115
https://kawalpemilu.org#60786,"TARANTANG, MANTANGAI, KAPUAS, KALIMANTAN TENGAH",6,52,84,136
https://kawalpemilu.org#60787,"LAMUNTI, MANTANGAI, KAPUAS, KALIMANTAN TENGAH",1,133,68,201
https://kawalpemilu.org#60787,"LAMUNTI, MANTANGAI, KAPUAS, KALIMANTAN TENGAH",2,145,38,183
https://kawalpemilu.org#60788,"PULAU KALADAN, MANTANGAI, KAPUAS, KALIMANTAN TENGAH",1,150,20,170
https://kawalpemilu.org#60788,"PULAU KALADAN, MANTANGAI, KAPUAS, KALIMANTAN TENGAH",2,203,58,261
https://kawalpemilu.org#60788,"PULAU KALADAN, MANTANGAI, KAPUAS, KALIMANTAN TENGAH",3,190,29,219
https://kawalpemilu.org#60788,"PULAU KALADAN, MANTANGAI, KAPUAS, KALIMANTAN TENGAH",4,128,40,168
https://kawalpemilu.org#60788,"PULAU KALADAN, MANTANGAI, KAPUAS, KALIMANTAN TENGAH",5,91,111,202
https://kawalpemilu.org#60788,"PULAU KALADAN, MANTANGAI, KAPUAS, KALIMANTAN TENGAH",6,112,30,142
https://kawalpemilu.org#60789,"MANTANGAI HILIR, MANTANGAI, KAPUAS, KALIMANTAN TENGAH",1,85,70,155
https://kawalpemilu.org#60789,"MANTANGAI HILIR, MANTANGAI, KAPUAS, KALIMANTAN TENGAH",2,36,120,156
https://kawalpemilu.org#60789,"MANTANGAI HILIR, MANTANGAI, KAPUAS, KALIMANTAN TENGAH",3,51,89,140
https://kawalpemilu.org#60789,"MANTANGAI HILIR, MANTANGAI, KAPUAS, KALIMANTAN TENGAH",4,62,95,157
https://kawalpemilu.org#60789,"MANTANGAI HILIR, MANTANGAI, KAPUAS, KALIMANTAN TENGAH",5,60,107,167
https://kawalpemilu.org#60789,"MANTANGAI HILIR, MANTANGAI, KAPUAS, KALIMANTAN TENGAH",6,77,89,166
https://kawalpemilu.org#60789,"MANTANGAI HILIR, MANTANGAI, KAPUAS, KALIMANTAN TENGAH",7,69,100,169
https://kawalpemilu.org#60789,"MANTANGAI HILIR, MANTANGAI, KAPUAS, KALIMANTAN TENGAH",8,68,121,189
https://kawalpemilu.org#60789,"MANTANGAI HILIR, MANTANGAI, KAPUAS, KALIMANTAN TENGAH",9,41,118,159
https://kawalpemilu.org#60789,"MANTANGAI HILIR, MANTANGAI, KAPUAS, KALIMANTAN TENGAH",10,44,59,103
https://kawalpemilu.org#60790,"MANTANGAI TENGAH, MANTANGAI, KAPUAS, KALIMANTAN TENGAH",1,39,142,181
https://kawalpemilu.org#60790,"MANTANGAI TENGAH, MANTANGAI, KAPUAS, KALIMANTAN TENGAH",2,81,75,156
https://kawalpemilu.org#60790,"MANTANGAI TENGAH, MANTANGAI, KAPUAS, KALIMANTAN TENGAH",3,64,81,145
https://kawalpemilu.org#60790,"MANTANGAI TENGAH, MANTANGAI, KAPUAS, KALIMANTAN TENGAH",4,50,95,145
https://kawalpemilu.org#60790,"MANTANGAI TENGAH, MANTANGAI, KAPUAS, KALIMANTAN TENGAH",5,47,76,123
https://kawalpemilu.org#60790,"MANTANGAI TENGAH, MANTANGAI, KAPUAS, KALIMANTAN TENGAH",6,8,43,51
https://kawalpemilu.org#60791,"MANTANGAI HULU, MANTANGAI, KAPUAS, KALIMANTAN TENGAH",1,70,130,200
https://kawalpemilu.org#60791,"MANTANGAI HULU, MANTANGAI, KAPUAS, KALIMANTAN TENGAH",2,61,126,187
https://kawalpemilu.org#60791,"MANTANGAI HULU, MANTANGAI, KAPUAS, KALIMANTAN TENGAH",3,143,56,199
https://kawalpemilu.org#60791,"MANTANGAI HULU, MANTANGAI, KAPUAS, KALIMANTAN TENGAH",4,67,42,109
https://kawalpemilu.org#60791,"MANTANGAI HULU, MANTANGAI, KAPUAS, KALIMANTAN TENGAH",5,94,32,126
https://kawalpemilu.org#60792,"KALUMPANG, MANTANGAI, KAPUAS, KALIMANTAN TENGAH",1,137,29,166
https://kawalpemilu.org#60792,"KALUMPANG, MANTANGAI, KAPUAS, KALIMANTAN TENGAH",2,131,72,203
https://kawalpemilu.org#60792,"KALUMPANG, MANTANGAI, KAPUAS, KALIMANTAN TENGAH",3,141,48,189
https://kawalpemilu.org#60793,"SEI AHAS, MANTANGAI, KAPUAS, KALIMANTAN TENGAH",1,50,79,129
https://kawalpemilu.org#60793,"SEI AHAS, MANTANGAI, KAPUAS, KALIMANTAN TENGAH",2,41,104,145
https://kawalpemilu.org#60793,"SEI AHAS, MANTANGAI, KAPUAS, KALIMANTAN TENGAH",3,43,64,107
https://kawalpemilu.org#60794,"KATUNJUNG, MANTANGAI, KAPUAS, KALIMANTAN TENGAH",1,59,84,143
https://kawalpemilu.org#60794,"KATUNJUNG, MANTANGAI, KAPUAS, KALIMANTAN TENGAH",2,68,54,122
https://kawalpemilu.org#60795,"LAHEI MANGKUTUP, MANTANGAI, KAPUAS, KALIMANTAN TENGAH",1,194,24,218
https://kawalpemilu.org#60795,"LAHEI MANGKUTUP, MANTANGAI, KAPUAS, KALIMANTAN TENGAH",2,168,71,239
https://kawalpemilu.org#60795,"LAHEI MANGKUTUP, MANTANGAI, KAPUAS, KALIMANTAN TENGAH",3,131,8,139
https://kawalpemilu.org#60795,"LAHEI MANGKUTUP, MANTANGAI, KAPUAS, KALIMANTAN TENGAH",4,127,50,177
https://kawalpemilu.org#60796,"TUMBANG MUROI, MANTANGAI, KAPUAS, KALIMANTAN TENGAH",1,171,39,210
https://kawalpemilu.org#60796,"TUMBANG MUROI, MANTANGAI, KAPUAS, KALIMANTAN TENGAH",2,121,26,147
https://kawalpemilu.org#60796,"TUMBANG MUROI, MANTANGAI, KAPUAS, KALIMANTAN TENGAH",3,62,9,71
https://kawalpemilu.org#60796,"TUMBANG MUROI, MANTANGAI, KAPUAS, KALIMANTAN TENGAH",4,78,18,96
https://kawalpemilu.org#60797,"DANAU RAWAH, MANTANGAI, KAPUAS, KALIMANTAN TENGAH",1,97,77,174
https://kawalpemilu.org#60797,"DANAU RAWAH, MANTANGAI, KAPUAS, KALIMANTAN TENGAH",2,103,40,143
https://kawalpemilu.org#60797,"DANAU RAWAH, MANTANGAI, KAPUAS, KALIMANTAN TENGAH",3,29,42,71
https://kawalpemilu.org#60797,"DANAU RAWAH, MANTANGAI, KAPUAS, KALIMANTAN TENGAH",4,12,106,118
https://kawalpemilu.org#60797,"DANAU RAWAH, MANTANGAI, KAPUAS, KALIMANTAN TENGAH",5,65,4,69
https://kawalpemilu.org#60797,"DANAU RAWAH, MANTANGAI, KAPUAS, KALIMANTAN TENGAH",6,92,28,120
https://kawalpemilu.org#60797,"DANAU RAWAH, MANTANGAI, KAPUAS, KALIMANTAN TENGAH",7,149,10,159
https://kawalpemilu.org#60797,"DANAU RAWAH, MANTANGAI, KAPUAS, KALIMANTAN TENGAH",8,134,47,181
https://kawalpemilu.org#60812,"MUROI RAYA, MANTANGAI, KAPUAS, KALIMANTAN TENGAH",1,70,34,104
https://kawalpemilu.org#60812,"MUROI RAYA, MANTANGAI, KAPUAS, KALIMANTAN TENGAH",2,36,6,42
https://kawalpemilu.org#60812,"MUROI RAYA, MANTANGAI, KAPUAS, KALIMANTAN TENGAH",3,68,10,78
https://kawalpemilu.org#60812,"MUROI RAYA, MANTANGAI, KAPUAS, KALIMANTAN TENGAH",4,55,8,63
https://kawalpemilu.org#60812,"MUROI RAYA, MANTANGAI, KAPUAS, KALIMANTAN TENGAH",5,87,33,120
https://kawalpemilu.org#60812,"MUROI RAYA, MANTANGAI, KAPUAS, KALIMANTAN TENGAH",6,92,58,150
https://kawalpemilu.org#60812,"MUROI RAYA, MANTANGAI, KAPUAS, KALIMANTAN TENGAH",7,23,5,28
https://kawalpemilu.org#60813,"KATIMPUN, MANTANGAI, KAPUAS, KALIMANTAN TENGAH",1,117,77,194
https://kawalpemilu.org#60813,"KATIMPUN, MANTANGAI, KAPUAS, KALIMANTAN TENGAH",2,112,82,194
https://kawalpemilu.org#60814,"MANUSUP HILIR, MANTANGAI, KAPUAS, KALIMANTAN TENGAH",1,48,87,135
https://kawalpemilu.org#60814,"MANUSUP HILIR, MANTANGAI, KAPUAS, KALIMANTAN TENGAH",2,65,65,130
https://kawalpemilu.org#60814,"MANUSUP HILIR, MANTANGAI, KAPUAS, KALIMANTAN TENGAH",3,54,97,151
https://kawalpemilu.org#60814,"MANUSUP HILIR, MANTANGAI, KAPUAS, KALIMANTAN TENGAH",4,60,125,185
https://kawalpemilu.org#928305,"SEI GITA, MANTANGAI, KAPUAS, KALIMANTAN TENGAH",1,155,108,263
https://kawalpemilu.org#928305,"SEI GITA, MANTANGAI, KAPUAS, KALIMANTAN TENGAH",2,56,20,76
https://kawalpemilu.org#928305,"SEI GITA, MANTANGAI, KAPUAS, KALIMANTAN TENGAH",3,77,44,121
https://kawalpemilu.org#928306,"BUKIT BATU, MANTANGAI, KAPUAS, KALIMANTAN TENGAH",1,172,39,211
https://kawalpemilu.org#928306,"BUKIT BATU, MANTANGAI, KAPUAS, KALIMANTAN TENGAH",2,70,14,84
https://kawalpemilu.org#928306,"BUKIT BATU, MANTANGAI, KAPUAS, KALIMANTAN TENGAH",3,149,37,186
https://kawalpemilu.org#928307,"SEI GAWING, MANTANGAI, KAPUAS, KALIMANTAN TENGAH",1,142,40,182
https://kawalpemilu.org#928307,"SEI GAWING, MANTANGAI, KAPUAS, KALIMANTAN TENGAH",2,121,55,176
https://kawalpemilu.org#928308,"HUMBANG RAYA, MANTANGAI, KAPUAS, KALIMANTAN TENGAH",1,80,40,120
https://kawalpemilu.org#928308,"HUMBANG RAYA, MANTANGAI, KAPUAS, KALIMANTAN TENGAH",2,94,43,137
https://kawalpemilu.org#928308,"HUMBANG RAYA, MANTANGAI, KAPUAS, KALIMANTAN TENGAH",3,22,14,36
https://kawalpemilu.org#928308,"HUMBANG RAYA, MANTANGAI, KAPUAS, KALIMANTAN TENGAH",4,94,38,132
https://kawalpemilu.org#928309,"TABORE, MANTANGAI, KAPUAS, KALIMANTAN TENGAH",1,132,83,215
https://kawalpemilu.org#928309,"TABORE, MANTANGAI, KAPUAS, KALIMANTAN TENGAH",2,111,68,179
https://kawalpemilu.org#928310,"TUMBANG MANGKUTUP, MANTANGAI, KAPUAS, KALIMANTAN TENGAH",1,85,53,138
https://kawalpemilu.org#928310,"TUMBANG MANGKUTUP, MANTANGAI, KAPUAS, KALIMANTAN TENGAH",2,51,7,58
https://kawalpemilu.org#928311,"LAPETAN, MANTANGAI, KAPUAS, KALIMANTAN TENGAH",1,96,8,104
https://kawalpemilu.org#928311,"LAPETAN, MANTANGAI, KAPUAS, KALIMANTAN TENGAH",2,95,22,117
https://kawalpemilu.org#928312,"LAMUNTI PERMAI, MANTANGAI, KAPUAS, KALIMANTAN TENGAH",1,107,43,150
https://kawalpemilu.org#928312,"LAMUNTI PERMAI, MANTANGAI, KAPUAS, KALIMANTAN TENGAH",2,117,45,162
https://kawalpemilu.org#928312,"LAMUNTI PERMAI, MANTANGAI, KAPUAS, KALIMANTAN TENGAH",3,90,72,162
https://kawalpemilu.org#928312,"LAMUNTI PERMAI, MANTANGAI, KAPUAS, KALIMANTAN TENGAH",4,70,41,111
https://kawalpemilu.org#928313,"MANYAHI, MANTANGAI, KAPUAS, KALIMANTAN TENGAH",1,138,75,213
https://kawalpemilu.org#928313,"MANYAHI, MANTANGAI, KAPUAS, KALIMANTAN TENGAH",2,118,62,180
https://kawalpemilu.org#928313,"MANYAHI, MANTANGAI, KAPUAS, KALIMANTAN TENGAH",3,148,63,211
https://kawalpemilu.org#928314,"SEKATA MAKMUR, MANTANGAI, KAPUAS, KALIMANTAN TENGAH",1,84,40,124
https://kawalpemilu.org#928314,"SEKATA MAKMUR, MANTANGAI, KAPUAS, KALIMANTAN TENGAH",2,59,54,113
https://kawalpemilu.org#928315,"KALADAN JAYA, MANTANGAI, KAPUAS, KALIMANTAN TENGAH",1,118,79,197
https://kawalpemilu.org#928315,"KALADAN JAYA, MANTANGAI, KAPUAS, KALIMANTAN TENGAH",2,93,30,123
https://kawalpemilu.org#928316,"RANTAU JAYA, MANTANGAI, KAPUAS, KALIMANTAN TENGAH",1,100,39,139
https://kawalpemilu.org#928317,"WARGA MULYA, MANTANGAI, KAPUAS, KALIMANTAN TENGAH",1,145,45,190
https://kawalpemilu.org#928317,"WARGA MULYA, MANTANGAI, KAPUAS, KALIMANTAN TENGAH",2,131,35,166
https://kawalpemilu.org#928317,"WARGA MULYA, MANTANGAI, KAPUAS, KALIMANTAN TENGAH",3,124,22,146
https://kawalpemilu.org#928318,"LAMUNTI BARU, MANTANGAI, KAPUAS, KALIMANTAN TENGAH",1,64,44,108
https://kawalpemilu.org#928318,"LAMUNTI BARU, MANTANGAI, KAPUAS, KALIMANTAN TENGAH",2,97,51,148
https://kawalpemilu.org#928318,"LAMUNTI BARU, MANTANGAI, KAPUAS, KALIMANTAN TENGAH",3,56,18,74
https://kawalpemilu.org#928319,"SRIWIDADI, MANTANGAI, KAPUAS, KALIMANTAN TENGAH",1,100,37,137
https://kawalpemilu.org#928319,"SRIWIDADI, MANTANGAI, KAPUAS, KALIMANTAN TENGAH",2,109,62,171
https://kawalpemilu.org#928320,"SUMBER MAKMUR, MANTANGAI, KAPUAS, KALIMANTAN TENGAH",1,164,53,217
https://kawalpemilu.org#928321,"SIDOMULYO, MANTANGAI, KAPUAS, KALIMANTAN TENGAH",1,114,54,168
https://kawalpemilu.org#928321,"SIDOMULYO, MANTANGAI, KAPUAS, KALIMANTAN TENGAH",2,105,50,155
https://kawalpemilu.org#928322,"HARAPAN JAYA, MANTANGAI, KAPUAS, KALIMANTAN TENGAH",1,77,20,97
https://kawalpemilu.org#928322,"HARAPAN JAYA, MANTANGAI, KAPUAS, KALIMANTAN TENGAH",2,112,54,166
https://kawalpemilu.org#928323,"SEKATA BANGUN, MANTANGAI, KAPUAS, KALIMANTAN TENGAH",1,57,71,128
https://kawalpemilu.org#928323,"SEKATA BANGUN, MANTANGAI, KAPUAS, KALIMANTAN TENGAH",2,106,105,211
https://kawalpemilu.org#928324,"SARI MAKMUR, MANTANGAI, KAPUAS, KALIMANTAN TENGAH",1,116,64,180
https://kawalpemilu.org#928324,"SARI MAKMUR, MANTANGAI, KAPUAS, KALIMANTAN TENGAH",2,141,42,183
https://kawalpemilu.org#928324,"SARI MAKMUR, MANTANGAI, KAPUAS, KALIMANTAN TENGAH",3,130,44,174
https://kawalpemilu.org#928325,"SUKA MAJU, MANTANGAI, KAPUAS, KALIMANTAN TENGAH",1,87,40,127
https://kawalpemilu.org#928325,"SUKA MAJU, MANTANGAI, KAPUAS, KALIMANTAN TENGAH",2,104,33,137
https://kawalpemilu.org#60816,"PETAK PUTI, TIMPAH, KAPUAS, KALIMANTAN TENGAH",1,191,62,253
https://kawalpemilu.org#60816,"PETAK PUTI, TIMPAH, KAPUAS, KALIMANTAN TENGAH",2,132,52,184
https://kawalpemilu.org#60816,"PETAK PUTI, TIMPAH, KAPUAS, KALIMANTAN TENGAH",3,190,12,202
https://kawalpemilu.org#60817,"ARUK, TIMPAH, KAPUAS, KALIMANTAN TENGAH",1,194,13,207
https://kawalpemilu.org#60817,"ARUK, TIMPAH, KAPUAS, KALIMANTAN TENGAH",2,226,8,234
https://kawalpemilu.org#60818,"LAWANG KAJANG, TIMPAH, KAPUAS, KALIMANTAN TENGAH",1,115,21,136
https://kawalpemilu.org#60818,"LAWANG KAJANG, TIMPAH, KAPUAS, KALIMANTAN TENGAH",2,173,5,178
https://kawalpemilu.org#60818,"LAWANG KAJANG, TIMPAH, KAPUAS, KALIMANTAN TENGAH",3,62,4,66
https://kawalpemilu.org#60818,"LAWANG KAJANG, TIMPAH, KAPUAS, KALIMANTAN TENGAH",4,147,3,150
https://kawalpemilu.org#60819,"TIMPAH, TIMPAH, KAPUAS, KALIMANTAN TENGAH",1,26,2,28
https://kawalpemilu.org#60819,"TIMPAH, TIMPAH, KAPUAS, KALIMANTAN TENGAH",2,87,8,95
https://kawalpemilu.org#60819,"TIMPAH, TIMPAH, KAPUAS, KALIMANTAN TENGAH",3,128,37,165
https://kawalpemilu.org#60819,"TIMPAH, TIMPAH, KAPUAS, KALIMANTAN TENGAH",4,185,21,206
https://kawalpemilu.org#60819,"TIMPAH, TIMPAH, KAPUAS, KALIMANTAN TENGAH",5,80,40,120
https://kawalpemilu.org#60819,"TIMPAH, TIMPAH, KAPUAS, KALIMANTAN TENGAH",6,121,45,166
https://kawalpemilu.org#60819,"TIMPAH, TIMPAH, KAPUAS, KALIMANTAN TENGAH",7,107,24,131
https://kawalpemilu.org#60819,"TIMPAH, TIMPAH, KAPUAS, KALIMANTAN TENGAH",8,155,22,177
https://kawalpemilu.org#60819,"TIMPAH, TIMPAH, KAPUAS, KALIMANTAN TENGAH",9,120,35,155
https://kawalpemilu.org#60819,"TIMPAH, TIMPAH, KAPUAS, KALIMANTAN TENGAH",10,163,25,188
https://kawalpemilu.org#60820,"LUNGKUH LAYANG, TIMPAH, KAPUAS, KALIMANTAN TENGAH",1,188,33,221
https://kawalpemilu.org#60820,"LUNGKUH LAYANG, TIMPAH, KAPUAS, KALIMANTAN TENGAH",2,213,19,232
https://kawalpemilu.org#60820,"LUNGKUH LAYANG, TIMPAH, KAPUAS, KALIMANTAN TENGAH",3,105,17,122
https://kawalpemilu.org#60820,"LUNGKUH LAYANG, TIMPAH, KAPUAS, KALIMANTAN TENGAH",4,25,2,27
https://kawalpemilu.org#60821,"LAWANG KAMAH, TIMPAH, KAPUAS, KALIMANTAN TENGAH",1,135,25,160
https://kawalpemilu.org#60821,"LAWANG KAMAH, TIMPAH, KAPUAS, KALIMANTAN TENGAH",2,123,13,136
https://kawalpemilu.org#60821,"LAWANG KAMAH, TIMPAH, KAPUAS, KALIMANTAN TENGAH",3,148,15,163
https://kawalpemilu.org#60822,"TUMBANG RANDANG, TIMPAH, KAPUAS, KALIMANTAN TENGAH",1,191,6,197
https://kawalpemilu.org#60822,"TUMBANG RANDANG, TIMPAH, KAPUAS, KALIMANTAN TENGAH",2,189,2,191
https://kawalpemilu.org#60822,"TUMBANG RANDANG, TIMPAH, KAPUAS, KALIMANTAN TENGAH",3,189,2,189
https://kawalpemilu.org#60823,"BATAPAH, TIMPAH, KAPUAS, KALIMANTAN TENGAH",1,110,24,134
https://kawalpemilu.org#60823,"BATAPAH, TIMPAH, KAPUAS, KALIMANTAN TENGAH",2,110,33,143
https://kawalpemilu.org#60824,"DANAU PANTAU, TIMPAH, KAPUAS, KALIMANTAN TENGAH",1,144,17,161
https://kawalpemilu.org#60824,"DANAU PANTAU, TIMPAH, KAPUAS, KALIMANTAN TENGAH",2,148,11,159
https://kawalpemilu.org#60824,"DANAU PANTAU, TIMPAH, KAPUAS, KALIMANTAN TENGAH",3,111,12,123
https://kawalpemilu.org#60826,"MASARAN, KAPUAS TENGAH, KAPUAS, KALIMANTAN TENGAH",1,97,19,116
https://kawalpemilu.org#60826,"MASARAN, KAPUAS TENGAH, KAPUAS, KALIMANTAN TENGAH",2,128,28,156
https://kawalpemilu.org#60827,"KAYU BULAN, KAPUAS TENGAH, KAPUAS, KALIMANTAN TENGAH",1,185,4,189
https://kawalpemilu.org#60827,"KAYU BULAN, KAPUAS TENGAH, KAPUAS, KALIMANTAN TENGAH",2,90,5,95
https://kawalpemilu.org#60827,"KAYU BULAN, KAPUAS TENGAH, KAPUAS, KALIMANTAN TENGAH",3,135,13,148
https://kawalpemilu.org#60827,"KAYU BULAN, KAPUAS TENGAH, KAPUAS, KALIMANTAN TENGAH",4,180,14,194
https://kawalpemilu.org#60828,"KOTA BARU, KAPUAS TENGAH, KAPUAS, KALIMANTAN TENGAH",1,90,7,97
https://kawalpemilu.org#60828,"KOTA BARU, KAPUAS TENGAH, KAPUAS, KALIMANTAN TENGAH",2,121,10,131
https://kawalpemilu.org#60828,"KOTA BARU, KAPUAS TENGAH, KAPUAS, KALIMANTAN TENGAH",3,182,11,193
https://kawalpemilu.org#60829,"PENDA MUNTEI, KAPUAS TENGAH, KAPUAS, KALIMANTAN TENGAH",1,64,2,66
https://kawalpemilu.org#60829,"PENDA MUNTEI, KAPUAS TENGAH, KAPUAS, KALIMANTAN TENGAH",2,127,5,132
https://kawalpemilu.org#60830,"TAPEN, KAPUAS TENGAH, KAPUAS, KALIMANTAN TENGAH",1,105,4,109
https://kawalpemilu.org#60830,"TAPEN, KAPUAS TENGAH, KAPUAS, KALIMANTAN TENGAH",2,97,28,125
https://kawalpemilu.org#60830,"TAPEN, KAPUAS TENGAH, KAPUAS, KALIMANTAN TENGAH",3,96,16,112
https://kawalpemilu.org#60830,"TAPEN, KAPUAS TENGAH, KAPUAS, KALIMANTAN TENGAH",4,77,4,81
https://kawalpemilu.org#60831,"PUJON, KAPUAS TENGAH, KAPUAS, KALIMANTAN TENGAH",1,188,21,209
https://kawalpemilu.org#60831,"PUJON, KAPUAS TENGAH, KAPUAS, KALIMANTAN TENGAH",2,172,14,186
https://kawalpemilu.org#60831,"PUJON, KAPUAS TENGAH, KAPUAS, KALIMANTAN TENGAH",3,121,54,175
https://kawalpemilu.org#60831,"PUJON, KAPUAS TENGAH, KAPUAS, KALIMANTAN TENGAH",4,108,46,154
https://kawalpemilu.org#60831,"PUJON, KAPUAS TENGAH, KAPUAS, KALIMANTAN TENGAH",5,149,20,169
https://kawalpemilu.org#60831,"PUJON, KAPUAS TENGAH, KAPUAS, KALIMANTAN TENGAH",6,199,20,219
https://kawalpemilu.org#60831,"PUJON, KAPUAS TENGAH, KAPUAS, KALIMANTAN TENGAH",7,216,24,240
https://kawalpemilu.org#60831,"PUJON, KAPUAS TENGAH, KAPUAS, KALIMANTAN TENGAH",8,207,19,226
https://kawalpemilu.org#60831,"PUJON, KAPUAS TENGAH, KAPUAS, KALIMANTAN TENGAH",9,165,4,169
https://kawalpemilu.org#60831,"PUJON, KAPUAS TENGAH, KAPUAS, KALIMANTAN TENGAH",10,163,29,192
https://kawalpemilu.org#60831,"PUJON, KAPUAS TENGAH, KAPUAS, KALIMANTAN TENGAH",11,172,32,204
https://kawalpemilu.org#60832,"MARAPIT, KAPUAS TENGAH, KAPUAS, KALIMANTAN TENGAH",1,147,21,168
https://kawalpemilu.org#60832,"MARAPIT, KAPUAS TENGAH, KAPUAS, KALIMANTAN TENGAH",2,123,26,149
https://kawalpemilu.org#60832,"MARAPIT, KAPUAS TENGAH, KAPUAS, KALIMANTAN TENGAH",3,147,12,159
https://kawalpemilu.org#60832,"MARAPIT, KAPUAS TENGAH, KAPUAS, KALIMANTAN TENGAH",4,173,4,177
https://kawalpemilu.org#60832,"MARAPIT, KAPUAS TENGAH, KAPUAS, KALIMANTAN TENGAH",5,177,4,181
https://kawalpemilu.org#60832,"MARAPIT, KAPUAS TENGAH, KAPUAS, KALIMANTAN TENGAH",6,184,2,186
https://kawalpemilu.org#60833,"MANIS, KAPUAS TENGAH, KAPUAS, KALIMANTAN TENGAH",1,117,12,129
https://kawalpemilu.org#60833,"MANIS, KAPUAS TENGAH, KAPUAS, KALIMANTAN TENGAH",2,106,9,115
https://kawalpemilu.org#60834,"KARUKUS, KAPUAS TENGAH, KAPUAS, KALIMANTAN TENGAH",1,77,4,81
https://kawalpemilu.org#60834,"KARUKUS, KAPUAS TENGAH, KAPUAS, KALIMANTAN TENGAH",2,61,2,63
https://kawalpemilu.org#60835,"BAJUH, KAPUAS TENGAH, KAPUAS, KALIMANTAN TENGAH",1,101,12,112
https://kawalpemilu.org#60835,"BAJUH, KAPUAS TENGAH, KAPUAS, KALIMANTAN TENGAH",2,157,10,167
https://kawalpemilu.org#60835,"BAJUH, KAPUAS TENGAH, KAPUAS, KALIMANTAN TENGAH",3,155,11,166
https://kawalpemilu.org#60835,"BAJUH, KAPUAS TENGAH, KAPUAS, KALIMANTAN TENGAH",4,131,5,136
https://kawalpemilu.org#60835,"BAJUH, KAPUAS TENGAH, KAPUAS, KALIMANTAN TENGAH",5,34,5,39
https://kawalpemilu.org#60836,"BARUNANG 1, KAPUAS TENGAH, KAPUAS, KALIMANTAN TENGAH",1,66,25,91
https://kawalpemilu.org#60836,"BARUNANG 1, KAPUAS TENGAH, KAPUAS, KALIMANTAN TENGAH",2,98,10,108
https://kawalpemilu.org#60836,"BARUNANG 1, KAPUAS TENGAH, KAPUAS, KALIMANTAN TENGAH",3,43,14,57
https://kawalpemilu.org#60836,"BARUNANG 1, KAPUAS TENGAH, KAPUAS, KALIMANTAN TENGAH",4,79,24,103
https://kawalpemilu.org#60836,"BARUNANG 1, KAPUAS TENGAH, KAPUAS, KALIMANTAN TENGAH",5,42,15,57
https://kawalpemilu.org#60836,"BARUNANG 1, KAPUAS TENGAH, KAPUAS, KALIMANTAN TENGAH",6,69,32,101
https://kawalpemilu.org#60844,"BUHUT JAYA, KAPUAS TENGAH, KAPUAS, KALIMANTAN TENGAH",1,116,58,174
https://kawalpemilu.org#60844,"BUHUT JAYA, KAPUAS TENGAH, KAPUAS, KALIMANTAN TENGAH",2,117,44,161
https://kawalpemilu.org#60844,"BUHUT JAYA, KAPUAS TENGAH, KAPUAS, KALIMANTAN TENGAH",3,129,41,170
https://kawalpemilu.org#60844,"BUHUT JAYA, KAPUAS TENGAH, KAPUAS, KALIMANTAN TENGAH",4,82,21,103
https://kawalpemilu.org#85380,"HURUNG PUKUNG, KAPUAS TENGAH, KAPUAS, KALIMANTAN TENGAH",1,87,2,89
https://kawalpemilu.org#85380,"HURUNG PUKUNG, KAPUAS TENGAH, KAPUAS, KALIMANTAN TENGAH",2,63,7,70
https://kawalpemilu.org#60847,"SEI HANYO, KAPUAS HULU, KAPUAS, KALIMANTAN TENGAH",1,61,11,72
https://kawalpemilu.org#60847,"SEI HANYO, KAPUAS HULU, KAPUAS, KALIMANTAN TENGAH",2,121,34,155
https://kawalpemilu.org#60847,"SEI HANYO, KAPUAS HULU, KAPUAS, KALIMANTAN TENGAH",3,154,24,178
https://kawalpemilu.org#60847,"SEI HANYO, KAPUAS HULU, KAPUAS, KALIMANTAN TENGAH",4,122,44,166
https://kawalpemilu.org#60847,"SEI HANYO, KAPUAS HULU, KAPUAS, KALIMANTAN TENGAH",5,86,21,107
https://kawalpemilu.org#60847,"SEI HANYO, KAPUAS HULU, KAPUAS, KALIMANTAN TENGAH",6,84,33,117
https://kawalpemilu.org#60847,"SEI HANYO, KAPUAS HULU, KAPUAS, KALIMANTAN TENGAH",7,73,21,93
https://kawalpemilu.org#60847,"SEI HANYO, KAPUAS HULU, KAPUAS, KALIMANTAN TENGAH",8,139,20,159
https://kawalpemilu.org#60847,"SEI HANYO, KAPUAS HULU, KAPUAS, KALIMANTAN TENGAH",9,103,26,130
https://kawalpemilu.org#60847,"SEI HANYO, KAPUAS HULU, KAPUAS, KALIMANTAN TENGAH",10,104,8,112
https://kawalpemilu.org#60848,"HURUNG TABENGAN, KAPUAS HULU, KAPUAS, KALIMANTAN TENGAH",1,111,0,111
https://kawalpemilu.org#60849,"RAHUNG BUNGAI, KAPUAS HULU, KAPUAS, KALIMANTAN TENGAH",1,120,13,133
https://kawalpemilu.org#60851,"BULAU NGANDUNG, KAPUAS HULU, KAPUAS, KALIMANTAN TENGAH",1,92,10,102
https://kawalpemilu.org#60852,"TUMBANG PUROH, KAPUAS HULU, KAPUAS, KALIMANTAN TENGAH",1,122,21,143
https://kawalpemilu.org#60852,"TUMBANG PUROH, KAPUAS HULU, KAPUAS, KALIMANTAN TENGAH",2,140,2,142
https://kawalpemilu.org#60854,"TANGIRANG, KAPUAS HULU, KAPUAS, KALIMANTAN TENGAH",1,131,5,136
https://kawalpemilu.org#60859,"BARUNANG II, KAPUAS HULU, KAPUAS, KALIMANTAN TENGAH",1,244,2,246
https://kawalpemilu.org#60859,"BARUNANG II, KAPUAS HULU, KAPUAS, KALIMANTAN TENGAH",2,202,1,203
https://kawalpemilu.org#60860,"HURUNG TAMPANG, KAPUAS HULU, KAPUAS, KALIMANTAN TENGAH",1,123,3,126
https://kawalpemilu.org#60860,"HURUNG TAMPANG, KAPUAS HULU, KAPUAS, KALIMANTAN TENGAH",2,112,0,112
https://kawalpemilu.org#60861,"SUPANG, KAPUAS HULU, KAPUAS, KALIMANTAN TENGAH",1,104,1,105
https://kawalpemilu.org#60861,"SUPANG, KAPUAS HULU, KAPUAS, KALIMANTAN TENGAH",2,113,9,122
https://kawalpemilu.org#60861,"SUPANG, KAPUAS HULU, KAPUAS, KALIMANTAN TENGAH",3,83,6,89
https://kawalpemilu.org#60861,"SUPANG, KAPUAS HULU, KAPUAS, KALIMANTAN TENGAH",4,111,6,117
https://kawalpemilu.org#60861,"SUPANG, KAPUAS HULU, KAPUAS, KALIMANTAN TENGAH",5,116,5,121
https://kawalpemilu.org#60861,"SUPANG, KAPUAS HULU, KAPUAS, KALIMANTAN TENGAH",6,99,9,108
https://kawalpemilu.org#60862,"KATANJUNG, KAPUAS HULU, KAPUAS, KALIMANTAN TENGAH",1,72,4,76
https://kawalpemilu.org#60864,"TUMBANG SIRAT, KAPUAS HULU, KAPUAS, KALIMANTAN TENGAH",1,102,25,127
https://kawalpemilu.org#60864,"TUMBANG SIRAT, KAPUAS HULU, KAPUAS, KALIMANTAN TENGAH",2,113,13,126
https://kawalpemilu.org#60866,"JAKATAN PARI, KAPUAS HULU, KAPUAS, KALIMANTAN TENGAH",1,108,13,121
https://kawalpemilu.org#60866,"JAKATAN PARI, KAPUAS HULU, KAPUAS, KALIMANTAN TENGAH",2,110,14,124
https://kawalpemilu.org#60866,"JAKATAN PARI, KAPUAS HULU, KAPUAS, KALIMANTAN TENGAH",3,100,10,110
https://kawalpemilu.org#928326,"DIRUNG KORAM, KAPUAS HULU, KAPUAS, KALIMANTAN TENGAH",1,148,5,153
https://kawalpemilu.org#928327,"MAMPAI JAYA, KAPUAS HULU, KAPUAS, KALIMANTAN TENGAH",1,38,0,38
https://kawalpemilu.org#60697,"TAMBAN BARU TENGAH, TAMBAN CATUR, KAPUAS, KALIMANTAN TENGAH",1,37,99,136
https://kawalpemilu.org#60697,"TAMBAN BARU TENGAH, TAMBAN CATUR, KAPUAS, KALIMANTAN TENGAH",2,45,165,210
https://kawalpemilu.org#60697,"TAMBAN BARU TENGAH, TAMBAN CATUR, KAPUAS, KALIMANTAN TENGAH",3,64,137,201
https://kawalpemilu.org#60697,"TAMBAN BARU TENGAH, TAMBAN CATUR, KAPUAS, KALIMANTAN TENGAH",4,34,135,169
https://kawalpemilu.org#60697,"TAMBAN BARU TENGAH, TAMBAN CATUR, KAPUAS, KALIMANTAN TENGAH",5,94,110,204
https://kawalpemilu.org#60697,"TAMBAN BARU TENGAH, TAMBAN CATUR, KAPUAS, KALIMANTAN TENGAH",6,88,115,203
https://kawalpemilu.org#60700,"WARNA SARI, TAMBAN CATUR, KAPUAS, KALIMANTAN TENGAH",1,63,114,177
https://kawalpemilu.org#60700,"WARNA SARI, TAMBAN CATUR, KAPUAS, KALIMANTAN TENGAH",2,78,76,154
https://kawalpemilu.org#60700,"WARNA SARI, TAMBAN CATUR, KAPUAS, KALIMANTAN TENGAH",3,66,96,162
https://kawalpemilu.org#60700,"WARNA SARI, TAMBAN CATUR, KAPUAS, KALIMANTAN TENGAH",4,42,120,162
https://kawalpemilu.org#60700,"WARNA SARI, TAMBAN CATUR, KAPUAS, KALIMANTAN TENGAH",5,45,151,196
https://kawalpemilu.org#60700,"WARNA SARI, TAMBAN CATUR, KAPUAS, KALIMANTAN TENGAH",6,77,58,135
https://kawalpemilu.org#60700,"WARNA SARI, TAMBAN CATUR, KAPUAS, KALIMANTAN TENGAH",7,96,29,125
https://kawalpemilu.org#60700,"WARNA SARI, TAMBAN CATUR, KAPUAS, KALIMANTAN TENGAH",8,88,53,141
https://kawalpemilu.org#60702,"TAMBAN BARU TIMUR, TAMBAN CATUR, KAPUAS, KALIMANTAN TENGAH",1,85,54,139
https://kawalpemilu.org#60702,"TAMBAN BARU TIMUR, TAMBAN CATUR, KAPUAS, KALIMANTAN TENGAH",3,112,124,236
https://kawalpemilu.org#60702,"TAMBAN BARU TIMUR, TAMBAN CATUR, KAPUAS, KALIMANTAN TENGAH",4,80,132,212
https://kawalpemilu.org#60703,"SIDOREJO, TAMBAN CATUR, KAPUAS, KALIMANTAN TENGAH",1,126,71,197
https://kawalpemilu.org#60703,"SIDOREJO, TAMBAN CATUR, KAPUAS, KALIMANTAN TENGAH",2,54,91,145
https://kawalpemilu.org#60703,"SIDOREJO, TAMBAN CATUR, KAPUAS, KALIMANTAN TENGAH",3,83,67,150
https://kawalpemilu.org#60703,"SIDOREJO, TAMBAN CATUR, KAPUAS, KALIMANTAN TENGAH",4,102,98,200
https://kawalpemilu.org#60703,"SIDOREJO, TAMBAN CATUR, KAPUAS, KALIMANTAN TENGAH",5,38,137,175
https://kawalpemilu.org#60703,"SIDOREJO, TAMBAN CATUR, KAPUAS, KALIMANTAN TENGAH",6,46,123,169
https://kawalpemilu.org#60705,"TAMBAN BARU MEKAR, TAMBAN CATUR, KAPUAS, KALIMANTAN TENGAH",1,80,114,194
https://kawalpemilu.org#60705,"TAMBAN BARU MEKAR, TAMBAN CATUR, KAPUAS, KALIMANTAN TENGAH",2,114,104,218
https://kawalpemilu.org#60705,"TAMBAN BARU MEKAR, TAMBAN CATUR, KAPUAS, KALIMANTAN TENGAH",3,27,107,134
https://kawalpemilu.org#60705,"TAMBAN BARU MEKAR, TAMBAN CATUR, KAPUAS, KALIMANTAN TENGAH",4,58,77,135
https://kawalpemilu.org#60705,"TAMBAN BARU MEKAR, TAMBAN CATUR, KAPUAS, KALIMANTAN TENGAH",5,38,22,60
https://kawalpemilu.org#85381,"BANDARAYA, TAMBAN CATUR, KAPUAS, KALIMANTAN TENGAH",1,114,107,221
https://kawalpemilu.org#85381,"BANDARAYA, TAMBAN CATUR, KAPUAS, KALIMANTAN TENGAH",2,79,110,189
https://kawalpemilu.org#85381,"BANDARAYA, TAMBAN CATUR, KAPUAS, KALIMANTAN TENGAH",3,59,124,183
https://kawalpemilu.org#85381,"BANDARAYA, TAMBAN CATUR, KAPUAS, KALIMANTAN TENGAH",4,35,83,118
https://kawalpemilu.org#85381,"BANDARAYA, TAMBAN CATUR, KAPUAS, KALIMANTAN TENGAH",5,57,81,138
https://kawalpemilu.org#89201,"SIDOMULYO, TAMBAN CATUR, KAPUAS, KALIMANTAN TENGAH",1,68,109,177
https://kawalpemilu.org#89201,"SIDOMULYO, TAMBAN CATUR, KAPUAS, KALIMANTAN TENGAH",2,30,101,131
https://kawalpemilu.org#89201,"SIDOMULYO, TAMBAN CATUR, KAPUAS, KALIMANTAN TENGAH",3,27,134,161
https://kawalpemilu.org#89201,"SIDOMULYO, TAMBAN CATUR, KAPUAS, KALIMANTAN TENGAH",4,43,160,203
https://kawalpemilu.org#928328,"BANDAR MEKAR, TAMBAN CATUR, KAPUAS, KALIMANTAN TENGAH",1,24,31,55
https://kawalpemilu.org#928328,"BANDAR MEKAR, TAMBAN CATUR, KAPUAS, KALIMANTAN TENGAH",2,83,92,175
https://kawalpemilu.org#928328,"BANDAR MEKAR, TAMBAN CATUR, KAPUAS, KALIMANTAN TENGAH",3,42,73,115
https://kawalpemilu.org#928328,"BANDAR MEKAR, TAMBAN CATUR, KAPUAS, KALIMANTAN TENGAH",4,85,78,163
https://kawalpemilu.org#928328,"BANDAR MEKAR, TAMBAN CATUR, KAPUAS, KALIMANTAN TENGAH",5,60,90,150
https://kawalpemilu.org#928328,"BANDAR MEKAR, TAMBAN CATUR, KAPUAS, KALIMANTAN TENGAH",6,81,51,132
https://kawalpemilu.org#928328,"BANDAR MEKAR, TAMBAN CATUR, KAPUAS, KALIMANTAN TENGAH",7,55,36,91
https://kawalpemilu.org#928329,"TAMBAN MAKMUR, TAMBAN CATUR, KAPUAS, KALIMANTAN TENGAH",1,55,73,128
https://kawalpemilu.org#928329,"TAMBAN MAKMUR, TAMBAN CATUR, KAPUAS, KALIMANTAN TENGAH",2,67,121,188
https://kawalpemilu.org#928329,"TAMBAN MAKMUR, TAMBAN CATUR, KAPUAS, KALIMANTAN TENGAH",3,45,101,146
https://kawalpemilu.org#928330,"TAMBAN JAYA, TAMBAN CATUR, KAPUAS, KALIMANTAN TENGAH",1,58,144,202
https://kawalpemilu.org#928330,"TAMBAN JAYA, TAMBAN CATUR, KAPUAS, KALIMANTAN TENGAH",2,86,76,162
https://kawalpemilu.org#928330,"TAMBAN JAYA, TAMBAN CATUR, KAPUAS, KALIMANTAN TENGAH",3,90,81,171
https://kawalpemilu.org#60837,"DANDANG, PASAK TALAWANG, KAPUAS, KALIMANTAN TENGAH",1,162,42,204
https://kawalpemilu.org#60837,"DANDANG, PASAK TALAWANG, KAPUAS, KALIMANTAN TENGAH",2,153,30,183
https://kawalpemilu.org#60837,"DANDANG, PASAK TALAWANG, KAPUAS, KALIMANTAN TENGAH",3,126,35,161
https://kawalpemilu.org#60837,"DANDANG, PASAK TALAWANG, KAPUAS, KALIMANTAN TENGAH",4,122,30,152
https://kawalpemilu.org#60838,"BALAI BANJANG, PASAK TALAWANG, KAPUAS, KALIMANTAN TENGAH",1,125,46,171
https://kawalpemilu.org#60838,"BALAI BANJANG, PASAK TALAWANG, KAPUAS, KALIMANTAN TENGAH",2,78,28,106
https://kawalpemilu.org#60839,"JANGKANG, PASAK TALAWANG, KAPUAS, KALIMANTAN TENGAH",1,77,26,103
https://kawalpemilu.org#60839,"JANGKANG, PASAK TALAWANG, KAPUAS, KALIMANTAN TENGAH",2,66,82,148
https://kawalpemilu.org#60839,"JANGKANG, PASAK TALAWANG, KAPUAS, KALIMANTAN TENGAH",3,76,19,95
https://kawalpemilu.org#60839,"JANGKANG, PASAK TALAWANG, KAPUAS, KALIMANTAN TENGAH",4,122,13,135
https://kawalpemilu.org#60839,"JANGKANG, PASAK TALAWANG, KAPUAS, KALIMANTAN TENGAH",5,71,15,86
https://kawalpemilu.org#60839,"JANGKANG, PASAK TALAWANG, KAPUAS, KALIMANTAN TENGAH",6,103,12,115
https://kawalpemilu.org#60839,"JANGKANG, PASAK TALAWANG, KAPUAS, KALIMANTAN TENGAH",7,47,6,53
https://kawalpemilu.org#60840,"KABURAN, PASAK TALAWANG, KAPUAS, KALIMANTAN TENGAH",1,119,27,146
https://kawalpemilu.org#60840,"KABURAN, PASAK TALAWANG, KAPUAS, KALIMANTAN TENGAH",2,107,11,118
https://kawalpemilu.org#60842,"SEI RINGIN, PASAK TALAWANG, KAPUAS, KALIMANTAN TENGAH",1,170,21,191
https://kawalpemilu.org#60842,"SEI RINGIN, PASAK TALAWANG, KAPUAS, KALIMANTAN TENGAH",2,123,14,137
https://kawalpemilu.org#60843,"TUMBANG TUKUN, PASAK TALAWANG, KAPUAS, KALIMANTAN TENGAH",1,132,10,142
https://kawalpemilu.org#60843,"TUMBANG TUKUN, PASAK TALAWANG, KAPUAS, KALIMANTAN TENGAH",2,132,19,151
https://kawalpemilu.org#60843,"TUMBANG TUKUN, PASAK TALAWANG, KAPUAS, KALIMANTAN TENGAH",3,120,21,141
https://kawalpemilu.org#60843,"TUMBANG TUKUN, PASAK TALAWANG, KAPUAS, KALIMANTAN TENGAH",4,155,66,221
https://kawalpemilu.org#60843,"TUMBANG TUKUN, PASAK TALAWANG, KAPUAS, KALIMANTAN TENGAH",5,185,20,205
https://kawalpemilu.org#60845,"HURUNG KAMPIN, PASAK TALAWANG, KAPUAS, KALIMANTAN TENGAH",1,156,10,166
https://kawalpemilu.org#89204,"TUMBANG DIRING, PASAK TALAWANG, KAPUAS, KALIMANTAN TENGAH",1,50,26,76
https://kawalpemilu.org#89204,"TUMBANG DIRING, PASAK TALAWANG, KAPUAS, KALIMANTAN TENGAH",2,59,10,69
https://kawalpemilu.org#928331,"BATU SAMBUNG, PASAK TALAWANG, KAPUAS, KALIMANTAN TENGAH",1,104,6,110
https://kawalpemilu.org#928332,"TUMBANG NUSA, PASAK TALAWANG, KAPUAS, KALIMANTAN TENGAH",1,113,14,127
https://kawalpemilu.org#60850,"MASAHA, MANDAU TALAWANG, KAPUAS, KALIMANTAN TENGAH",1,190,7,197
https://kawalpemilu.org#60853,"TUMBANG TIHIS, MANDAU TALAWANG, KAPUAS, KALIMANTAN TENGAH",1,104,1,105
https://kawalpemilu.org#60853,"TUMBANG TIHIS, MANDAU TALAWANG, KAPUAS, KALIMANTAN TENGAH",2,117,0,117
https://kawalpemilu.org#60855,"SEI PINANG, MANDAU TALAWANG, KAPUAS, KALIMANTAN TENGAH",1,129,15,144
https://kawalpemilu.org#60855,"SEI PINANG, MANDAU TALAWANG, KAPUAS, KALIMANTAN TENGAH",2,136,11,147
https://kawalpemilu.org#60855,"SEI PINANG, MANDAU TALAWANG, KAPUAS, KALIMANTAN TENGAH",3,134,7,141
https://kawalpemilu.org#60855,"SEI PINANG, MANDAU TALAWANG, KAPUAS, KALIMANTAN TENGAH",4,164,9,173
https://kawalpemilu.org#60855,"SEI PINANG, MANDAU TALAWANG, KAPUAS, KALIMANTAN TENGAH",5,88,7,95
https://kawalpemilu.org#60855,"SEI PINANG, MANDAU TALAWANG, KAPUAS, KALIMANTAN TENGAH",6,103,0,103
https://kawalpemilu.org#60856,"LAWANG TAMANG, MANDAU TALAWANG, KAPUAS, KALIMANTAN TENGAH",1,157,3,160
https://kawalpemilu.org#60856,"LAWANG TAMANG, MANDAU TALAWANG, KAPUAS, KALIMANTAN TENGAH",2,165,13,178
https://kawalpemilu.org#60858,"TUMBANG BUKOI, MANDAU TALAWANG, KAPUAS, KALIMANTAN TENGAH",1,80,20,100
https://kawalpemilu.org#60858,"TUMBANG BUKOI, MANDAU TALAWANG, KAPUAS, KALIMANTAN TENGAH",2,130,6,136
https://kawalpemilu.org#60863,"TUMBANG MANYARUNG, MANDAU TALAWANG, KAPUAS, KALIMANTAN TENGAH",1,133,0,133
https://kawalpemilu.org#60863,"TUMBANG MANYARUNG, MANDAU TALAWANG, KAPUAS, KALIMANTAN TENGAH",2,122,0,122
https://kawalpemilu.org#60863,"TUMBANG MANYARUNG, MANDAU TALAWANG, KAPUAS, KALIMANTAN TENGAH",3,61,3,64
https://kawalpemilu.org#89207,"KARETAU MANTA'A, MANDAU TALAWANG, KAPUAS, KALIMANTAN TENGAH",1,135,9,144
https://kawalpemilu.org#89208,"TANJUNG RENDAN, MANDAU TALAWANG, KAPUAS, KALIMANTAN TENGAH",1,154,8,162
https://kawalpemilu.org#89208,"TANJUNG RENDAN, MANDAU TALAWANG, KAPUAS, KALIMANTAN TENGAH",2,129,18,147
https://kawalpemilu.org#928333,"JAKATAN MASAHA, MANDAU TALAWANG, KAPUAS, KALIMANTAN TENGAH",1,130,32,162
https://kawalpemilu.org#928333,"JAKATAN MASAHA, MANDAU TALAWANG, KAPUAS, KALIMANTAN TENGAH",2,103,16,119
https://kawalpemilu.org#928334,"MASUPA RIA, MANDAU TALAWANG, KAPUAS, KALIMANTAN TENGAH",1,188,30,218
https://kawalpemilu.org#60738,"DADAHUP, DADAHUP, KAPUAS, KALIMANTAN TENGAH",1,119,50,169
https://kawalpemilu.org#60738,"DADAHUP, DADAHUP, KAPUAS, KALIMANTAN TENGAH",2,75,104,179
https://kawalpemilu.org#60738,"DADAHUP, DADAHUP, KAPUAS, KALIMANTAN TENGAH",3,117,66,183
https://kawalpemilu.org#60738,"DADAHUP, DADAHUP, KAPUAS, KALIMANTAN TENGAH",4,128,46,174
https://kawalpemilu.org#60738,"DADAHUP, DADAHUP, KAPUAS, KALIMANTAN TENGAH",5,138,69,206
https://kawalpemilu.org#60738,"DADAHUP, DADAHUP, KAPUAS, KALIMANTAN TENGAH",6,125,75,200
https://kawalpemilu.org#60738,"DADAHUP, DADAHUP, KAPUAS, KALIMANTAN TENGAH",7,143,80,223
https://kawalpemilu.org#60738,"DADAHUP, DADAHUP, KAPUAS, KALIMANTAN TENGAH",8,89,65,154
https://kawalpemilu.org#60740,"TAMBAK BAJAI, DADAHUP, KAPUAS, KALIMANTAN TENGAH",1,81,19,100
https://kawalpemilu.org#60740,"TAMBAK BAJAI, DADAHUP, KAPUAS, KALIMANTAN TENGAH",2,143,19,162
https://kawalpemilu.org#60764,"BINA JAYA, DADAHUP, KAPUAS, KALIMANTAN TENGAH",1,148,74,222
https://kawalpemilu.org#60764,"BINA JAYA, DADAHUP, KAPUAS, KALIMANTAN TENGAH",2,123,34,157
https://kawalpemilu.org#60764,"BINA JAYA, DADAHUP, KAPUAS, KALIMANTAN TENGAH",3,111,87,198
https://kawalpemilu.org#60765,"HARAPAN BARU, DADAHUP, KAPUAS, KALIMANTAN TENGAH",1,77,27,104
https://kawalpemilu.org#60765,"HARAPAN BARU, DADAHUP, KAPUAS, KALIMANTAN TENGAH",2,37,36,73
https://kawalpemilu.org#60765,"HARAPAN BARU, DADAHUP, KAPUAS, KALIMANTAN TENGAH",3,33,81,114
https://kawalpemilu.org#60765,"HARAPAN BARU, DADAHUP, KAPUAS, KALIMANTAN TENGAH",4,64,57,121
https://kawalpemilu.org#60765,"HARAPAN BARU, DADAHUP, KAPUAS, KALIMANTAN TENGAH",5,30,47,77
https://kawalpemilu.org#60765,"HARAPAN BARU, DADAHUP, KAPUAS, KALIMANTAN TENGAH",6,15,55,70
https://kawalpemilu.org#60766,"BENTUK JAYA, DADAHUP, KAPUAS, KALIMANTAN TENGAH",1,54,78,132
https://kawalpemilu.org#60766,"BENTUK JAYA, DADAHUP, KAPUAS, KALIMANTAN TENGAH",2,43,148,191
https://kawalpemilu.org#60766,"BENTUK JAYA, DADAHUP, KAPUAS, KALIMANTAN TENGAH",3,67,44,111
https://kawalpemilu.org#60766,"BENTUK JAYA, DADAHUP, KAPUAS, KALIMANTAN TENGAH",4,58,74,132
https://kawalpemilu.org#60767,"SUMBER AGUNG, DADAHUP, KAPUAS, KALIMANTAN TENGAH",1,52,41,93
https://kawalpemilu.org#60767,"SUMBER AGUNG, DADAHUP, KAPUAS, KALIMANTAN TENGAH",2,39,58,97
https://kawalpemilu.org#928335,"PETAK BATUAH, DADAHUP, KAPUAS, KALIMANTAN TENGAH",1,78,61,139
https://kawalpemilu.org#928335,"PETAK BATUAH, DADAHUP, KAPUAS, KALIMANTAN TENGAH",2,111,86,197
https://kawalpemilu.org#928335,"PETAK BATUAH, DADAHUP, KAPUAS, KALIMANTAN TENGAH",3,30,61,91
https://kawalpemilu.org#928336,"MANUNTUNG, DADAHUP, KAPUAS, KALIMANTAN TENGAH",1,34,56,90
https://kawalpemilu.org#928336,"MANUNTUNG, DADAHUP, KAPUAS, KALIMANTAN TENGAH",2,60,123,183
https://kawalpemilu.org#928337,"SUMBER ALASKA, DADAHUP, KAPUAS, KALIMANTAN TENGAH",1,80,44,124
https://kawalpemilu.org#928337,"SUMBER ALASKA, DADAHUP, KAPUAS, KALIMANTAN TENGAH",2,108,29,137
https://kawalpemilu.org#928337,"SUMBER ALASKA, DADAHUP, KAPUAS, KALIMANTAN TENGAH",3,64,17,81
https://kawalpemilu.org#928337,"SUMBER ALASKA, DADAHUP, KAPUAS, KALIMANTAN TENGAH",4,26,11,37
https://kawalpemilu.org#928337,"SUMBER ALASKA, DADAHUP, KAPUAS, KALIMANTAN TENGAH",5,21,5,26
https://kawalpemilu.org#928337,"SUMBER ALASKA, DADAHUP, KAPUAS, KALIMANTAN TENGAH",6,80,54,134
https://kawalpemilu.org#928337,"SUMBER ALASKA, DADAHUP, KAPUAS, KALIMANTAN TENGAH",7,61,36,95
https://kawalpemilu.org#928338,"MENTENG KARYA, DADAHUP, KAPUAS, KALIMANTAN TENGAH",1,103,50,153
https://kawalpemilu.org#928338,"MENTENG KARYA, DADAHUP, KAPUAS, KALIMANTAN TENGAH",2,126,35,161
https://kawalpemilu.org#928339,"TANJUNG HARAPAN, DADAHUP, KAPUAS, KALIMANTAN TENGAH",1,27,64,91
https://kawalpemilu.org#928340,"KAHURIPAN PERMAI, DADAHUP, KAPUAS, KALIMANTAN TENGAH",1,82,41,123
https://kawalpemilu.org#928341,"DADAHUP RAYA, DADAHUP, KAPUAS, KALIMANTAN TENGAH",1,88,36,124
https://kawalpemilu.org#928341,"DADAHUP RAYA, DADAHUP, KAPUAS, KALIMANTAN TENGAH",2,82,29,111
https://kawalpemilu.org#60661,"TERUSAN RAYA, BATAGUH, KAPUAS, KALIMANTAN TENGAH",1,112,46,158
https://kawalpemilu.org#60661,"TERUSAN RAYA, BATAGUH, KAPUAS, KALIMANTAN TENGAH",2,151,34,185
https://kawalpemilu.org#60661,"TERUSAN RAYA, BATAGUH, KAPUAS, KALIMANTAN TENGAH",3,126,38,164
https://kawalpemilu.org#60661,"TERUSAN RAYA, BATAGUH, KAPUAS, KALIMANTAN TENGAH",4,100,43,143
https://kawalpemilu.org#60661,"TERUSAN RAYA, BATAGUH, KAPUAS, KALIMANTAN TENGAH",5,128,38,166
https://kawalpemilu.org#60661,"TERUSAN RAYA, BATAGUH, KAPUAS, KALIMANTAN TENGAH",6,90,51,141
https://kawalpemilu.org#60662,"SEI JANGKIT, BATAGUH, KAPUAS, KALIMANTAN TENGAH",1,30,141,171
https://kawalpemilu.org#60662,"SEI JANGKIT, BATAGUH, KAPUAS, KALIMANTAN TENGAH",2,62,110,172
https://kawalpemilu.org#60662,"SEI JANGKIT, BATAGUH, KAPUAS, KALIMANTAN TENGAH",3,86,179,265
https://kawalpemilu.org#60662,"SEI JANGKIT, BATAGUH, KAPUAS, KALIMANTAN TENGAH",4,83,64,147
https://kawalpemilu.org#60662,"SEI JANGKIT, BATAGUH, KAPUAS, KALIMANTAN TENGAH",5,65,86,151
https://kawalpemilu.org#60662,"SEI JANGKIT, BATAGUH, KAPUAS, KALIMANTAN TENGAH",6,62,117,179
https://kawalpemilu.org#60662,"SEI JANGKIT, BATAGUH, KAPUAS, KALIMANTAN TENGAH",7,60,80,140
https://kawalpemilu.org#60662,"SEI JANGKIT, BATAGUH, KAPUAS, KALIMANTAN TENGAH",8,113,59,172
https://kawalpemilu.org#60662,"SEI JANGKIT, BATAGUH, KAPUAS, KALIMANTAN TENGAH",9,43,115,158
https://kawalpemilu.org#60662,"SEI JANGKIT, BATAGUH, KAPUAS, KALIMANTAN TENGAH",10,27,98,125
https://kawalpemilu.org#60662,"SEI JANGKIT, BATAGUH, KAPUAS, KALIMANTAN TENGAH",11,69,60,129
https://kawalpemilu.org#60662,"SEI JANGKIT, BATAGUH, KAPUAS, KALIMANTAN TENGAH",12,45,104,149
https://kawalpemilu.org#60662,"SEI JANGKIT, BATAGUH, KAPUAS, KALIMANTAN TENGAH",13,44,116,160
https://kawalpemilu.org#60662,"SEI JANGKIT, BATAGUH, KAPUAS, KALIMANTAN TENGAH",14,39,62,101
https://kawalpemilu.org#60662,"SEI JANGKIT, BATAGUH, KAPUAS, KALIMANTAN TENGAH",15,31,46,77
https://kawalpemilu.org#60663,"SEI LUNUK, BATAGUH, KAPUAS, KALIMANTAN TENGAH",1,56,100,156
https://kawalpemilu.org#60663,"SEI LUNUK, BATAGUH, KAPUAS, KALIMANTAN TENGAH",2,46,65,111
https://kawalpemilu.org#60663,"SEI LUNUK, BATAGUH, KAPUAS, KALIMANTAN TENGAH",3,39,127,166
https://kawalpemilu.org#60663,"SEI LUNUK, BATAGUH, KAPUAS, KALIMANTAN TENGAH",4,85,81,166
https://kawalpemilu.org#60663,"SEI LUNUK, BATAGUH, KAPUAS, KALIMANTAN TENGAH",5,74,110,184
https://kawalpemilu.org#60663,"SEI LUNUK, BATAGUH, KAPUAS, KALIMANTAN TENGAH",6,42,89,131
https://kawalpemilu.org#60664,"PULAU MAMBULAU, BATAGUH, KAPUAS, KALIMANTAN TENGAH",1,68,118,186
https://kawalpemilu.org#60664,"PULAU MAMBULAU, BATAGUH, KAPUAS, KALIMANTAN TENGAH",2,56,149,205
https://kawalpemilu.org#60664,"PULAU MAMBULAU, BATAGUH, KAPUAS, KALIMANTAN TENGAH",3,52,168,220
https://kawalpemilu.org#60664,"PULAU MAMBULAU, BATAGUH, KAPUAS, KALIMANTAN TENGAH",4,82,159,241
https://kawalpemilu.org#60664,"PULAU MAMBULAU, BATAGUH, KAPUAS, KALIMANTAN TENGAH",5,48,185,233
https://kawalpemilu.org#60664,"PULAU MAMBULAU, BATAGUH, KAPUAS, KALIMANTAN TENGAH",6,34,145,179
https://kawalpemilu.org#60664,"PULAU MAMBULAU, BATAGUH, KAPUAS, KALIMANTAN TENGAH",7,45,140,185
https://kawalpemilu.org#60664,"PULAU MAMBULAU, BATAGUH, KAPUAS, KALIMANTAN TENGAH",8,63,55,118
https://kawalpemilu.org#60664,"PULAU MAMBULAU, BATAGUH, KAPUAS, KALIMANTAN TENGAH",9,53,167,220
https://kawalpemilu.org#60664,"PULAU MAMBULAU, BATAGUH, KAPUAS, KALIMANTAN TENGAH",10,21,146,167
https://kawalpemilu.org#60664,"PULAU MAMBULAU, BATAGUH, KAPUAS, KALIMANTAN TENGAH",11,38,121,159
https://kawalpemilu.org#60666,"TAMBAN LUAR, BATAGUH, KAPUAS, KALIMANTAN TENGAH",1,100,73,173
https://kawalpemilu.org#60666,"TAMBAN LUAR, BATAGUH, KAPUAS, KALIMANTAN TENGAH",2,62,113,175
https://kawalpemilu.org#60666,"TAMBAN LUAR, BATAGUH, KAPUAS, KALIMANTAN TENGAH",3,36,81,117
https://kawalpemilu.org#60666,"TAMBAN LUAR, BATAGUH, KAPUAS, KALIMANTAN TENGAH",4,67,66,133
https://kawalpemilu.org#60666,"TAMBAN LUAR, BATAGUH, KAPUAS, KALIMANTAN TENGAH",5,84,33,117
https://kawalpemilu.org#60666,"TAMBAN LUAR, BATAGUH, KAPUAS, KALIMANTAN TENGAH",6,52,118,170
https://kawalpemilu.org#60666,"TAMBAN LUAR, BATAGUH, KAPUAS, KALIMANTAN TENGAH",7,80,78,158
https://kawalpemilu.org#60666,"TAMBAN LUAR, BATAGUH, KAPUAS, KALIMANTAN TENGAH",8,60,149,209
https://kawalpemilu.org#60666,"TAMBAN LUAR, BATAGUH, KAPUAS, KALIMANTAN TENGAH",9,90,103,193
https://kawalpemilu.org#60666,"TAMBAN LUAR, BATAGUH, KAPUAS, KALIMANTAN TENGAH",10,64,100,164
https://kawalpemilu.org#60667,"TERUSAN KARYA, BATAGUH, KAPUAS, KALIMANTAN TENGAH",1,77,74,151
https://kawalpemilu.org#60667,"TERUSAN KARYA, BATAGUH, KAPUAS, KALIMANTAN TENGAH",2,92,18,110
https://kawalpemilu.org#60667,"TERUSAN KARYA, BATAGUH, KAPUAS, KALIMANTAN TENGAH",3,85,61,146
https://kawalpemilu.org#60667,"TERUSAN KARYA, BATAGUH, KAPUAS, KALIMANTAN TENGAH",4,148,45,193
https://kawalpemilu.org#60667,"TERUSAN KARYA, BATAGUH, KAPUAS, KALIMANTAN TENGAH",5,87,83,170
https://kawalpemilu.org#60667,"TERUSAN KARYA, BATAGUH, KAPUAS, KALIMANTAN TENGAH",6,64,71,135
https://kawalpemilu.org#60667,"TERUSAN KARYA, BATAGUH, KAPUAS, KALIMANTAN TENGAH",7,44,115,159
https://kawalpemilu.org#60667,"TERUSAN KARYA, BATAGUH, KAPUAS, KALIMANTAN TENGAH",8,72,65,137
https://kawalpemilu.org#60668,"TERUSAN MAKMUR, BATAGUH, KAPUAS, KALIMANTAN TENGAH",1,142,15,157
https://kawalpemilu.org#60668,"TERUSAN MAKMUR, BATAGUH, KAPUAS, KALIMANTAN TENGAH",2,106,6,112
https://kawalpemilu.org#60668,"TERUSAN MAKMUR, BATAGUH, KAPUAS, KALIMANTAN TENGAH",3,146,36,182
https://kawalpemilu.org#60668,"TERUSAN MAKMUR, BATAGUH, KAPUAS, KALIMANTAN TENGAH",4,85,22,107
https://kawalpemilu.org#60668,"TERUSAN MAKMUR, BATAGUH, KAPUAS, KALIMANTAN TENGAH",5,118,22,140
https://kawalpemilu.org#60668,"TERUSAN MAKMUR, BATAGUH, KAPUAS, KALIMANTAN TENGAH",6,121,6,127
https://kawalpemilu.org#60668,"TERUSAN MAKMUR, BATAGUH, KAPUAS, KALIMANTAN TENGAH",7,116,2,118
https://kawalpemilu.org#60669,"TERUSAN MULYA, BATAGUH, KAPUAS, KALIMANTAN TENGAH",1,117,82,199
https://kawalpemilu.org#60669,"TERUSAN MULYA, BATAGUH, KAPUAS, KALIMANTAN TENGAH",2,152,39,191
https://kawalpemilu.org#60669,"TERUSAN MULYA, BATAGUH, KAPUAS, KALIMANTAN TENGAH",3,197,25,222
https://kawalpemilu.org#60669,"TERUSAN MULYA, BATAGUH, KAPUAS, KALIMANTAN TENGAH",4,170,28,198
https://kawalpemilu.org#60669,"TERUSAN MULYA, BATAGUH, KAPUAS, KALIMANTAN TENGAH",5,165,30,195
https://kawalpemilu.org#60669,"TERUSAN MULYA, BATAGUH, KAPUAS, KALIMANTAN TENGAH",6,186,27,213
https://kawalpemilu.org#60669,"TERUSAN MULYA, BATAGUH, KAPUAS, KALIMANTAN TENGAH",7,132,37,169
https://kawalpemilu.org#60670,"BAMBAN RAYA, BATAGUH, KAPUAS, KALIMANTAN TENGAH",1,60,90,150
https://kawalpemilu.org#60670,"BAMBAN RAYA, BATAGUH, KAPUAS, KALIMANTAN TENGAH",2,137,48,185
https://kawalpemilu.org#60670,"BAMBAN RAYA, BATAGUH, KAPUAS, KALIMANTAN TENGAH",3,136,26,162
https://kawalpemilu.org#60670,"BAMBAN RAYA, BATAGUH, KAPUAS, KALIMANTAN TENGAH",4,148,78,226
https://kawalpemilu.org#60671,"BANGUN HARJO, BATAGUH, KAPUAS, KALIMANTAN TENGAH",1,38,88,126
https://kawalpemilu.org#60671,"BANGUN HARJO, BATAGUH, KAPUAS, KALIMANTAN TENGAH",2,40,114,154
https://kawalpemilu.org#60671,"BANGUN HARJO, BATAGUH, KAPUAS, KALIMANTAN TENGAH",3,25,127,152
https://kawalpemilu.org#60671,"BANGUN HARJO, BATAGUH, KAPUAS, KALIMANTAN TENGAH",4,31,142,173
https://kawalpemilu.org#60673,"TERUSAN BAGUNTAN RAYA, BATAGUH, KAPUAS, KALIMANTAN TENGAH",1,59,48,107
https://kawalpemilu.org#60673,"TERUSAN BAGUNTAN RAYA, BATAGUH, KAPUAS, KALIMANTAN TENGAH",2,60,47,107
https://kawalpemilu.org#60673,"TERUSAN BAGUNTAN RAYA, BATAGUH, KAPUAS, KALIMANTAN TENGAH",3,105,8,113
https://kawalpemilu.org#60673,"TERUSAN BAGUNTAN RAYA, BATAGUH, KAPUAS, KALIMANTAN TENGAH",4,83,41,124
https://kawalpemilu.org#60673,"TERUSAN BAGUNTAN RAYA, BATAGUH, KAPUAS, KALIMANTAN TENGAH",5,28,123,151
https://kawalpemilu.org#60673,"TERUSAN BAGUNTAN RAYA, BATAGUH, KAPUAS, KALIMANTAN TENGAH",6,37,40,77
https://kawalpemilu.org#60673,"TERUSAN BAGUNTAN RAYA, BATAGUH, KAPUAS, KALIMANTAN TENGAH",7,32,20,52
https://kawalpemilu.org#88537,"PULAU KUPANG, BATAGUH, KAPUAS, KALIMANTAN TENGAH",1,123,46,169
https://kawalpemilu.org#88537,"PULAU KUPANG, BATAGUH, KAPUAS, KALIMANTAN TENGAH",2,82,63,145
https://kawalpemilu.org#88537,"PULAU KUPANG, BATAGUH, KAPUAS, KALIMANTAN TENGAH",3,121,110,231
https://kawalpemilu.org#88537,"PULAU KUPANG, BATAGUH, KAPUAS, KALIMANTAN TENGAH",4,110,100,210
https://kawalpemilu.org#88537,"PULAU KUPANG, BATAGUH, KAPUAS, KALIMANTAN TENGAH",5,61,153,214
https://kawalpemilu.org#88537,"PULAU KUPANG, BATAGUH, KAPUAS, KALIMANTAN TENGAH",6,112,41,153
https://kawalpemilu.org#88537,"PULAU KUPANG, BATAGUH, KAPUAS, KALIMANTAN TENGAH",7,85,109,194
https://kawalpemilu.org#88537,"PULAU KUPANG, BATAGUH, KAPUAS, KALIMANTAN TENGAH",8,135,48,183
https://kawalpemilu.org#88537,"PULAU KUPANG, BATAGUH, KAPUAS, KALIMANTAN TENGAH",9,75,99,174
https://kawalpemilu.org#88537,"PULAU KUPANG, BATAGUH, KAPUAS, KALIMANTAN TENGAH",10,55,100,155
https://kawalpemilu.org#88537,"PULAU KUPANG, BATAGUH, KAPUAS, KALIMANTAN TENGAH",11,31,143,174
https://kawalpemilu.org#88537,"PULAU KUPANG, BATAGUH, KAPUAS, KALIMANTAN TENGAH",12,81,125,206
https://kawalpemilu.org#88537,"PULAU KUPANG, BATAGUH, KAPUAS, KALIMANTAN TENGAH",13,93,143,236
https://kawalpemilu.org#88537,"PULAU KUPANG, BATAGUH, KAPUAS, KALIMANTAN TENGAH",14,73,113,186
https://kawalpemilu.org#88537,"PULAU KUPANG, BATAGUH, KAPUAS, KALIMANTAN TENGAH",15,46,160,206
https://kawalpemilu.org#88537,"PULAU KUPANG, BATAGUH, KAPUAS, KALIMANTAN TENGAH",16,66,136,202
https://kawalpemilu.org#88537,"PULAU KUPANG, BATAGUH, KAPUAS, KALIMANTAN TENGAH",17,32,157,189
https://kawalpemilu.org#88537,"PULAU KUPANG, BATAGUH, KAPUAS, KALIMANTAN TENGAH",18,60,153,213
https://kawalpemilu.org#88537,"PULAU KUPANG, BATAGUH, KAPUAS, KALIMANTAN TENGAH",19,68,66,134
https://kawalpemilu.org#88537,"PULAU KUPANG, BATAGUH, KAPUAS, KALIMANTAN TENGAH",20,88,53,141
https://kawalpemilu.org#88537,"PULAU KUPANG, BATAGUH, KAPUAS, KALIMANTAN TENGAH",21,77,30,107
https://kawalpemilu.org#88537,"PULAU KUPANG, BATAGUH, KAPUAS, KALIMANTAN TENGAH",22,40,69,109
https://kawalpemilu.org#88538,"TERUSAN RAYA HULU, BATAGUH, KAPUAS, KALIMANTAN TENGAH",1,144,43,187
https://kawalpemilu.org#88538,"TERUSAN RAYA HULU, BATAGUH, KAPUAS, KALIMANTAN TENGAH",2,134,53,187
https://kawalpemilu.org#88538,"TERUSAN RAYA HULU, BATAGUH, KAPUAS, KALIMANTAN TENGAH",3,97,38,135
https://kawalpemilu.org#88538,"TERUSAN RAYA HULU, BATAGUH, KAPUAS, KALIMANTAN TENGAH",4,124,111,235
https://kawalpemilu.org#88538,"TERUSAN RAYA HULU, BATAGUH, KAPUAS, KALIMANTAN TENGAH",5,97,84,181
https://kawalpemilu.org#88540,"TERUSAN RAYA BARAT, BATAGUH, KAPUAS, KALIMANTAN TENGAH",1,108,36,144
https://kawalpemilu.org#88540,"TERUSAN RAYA BARAT, BATAGUH, KAPUAS, KALIMANTAN TENGAH",2,111,56,167
https://kawalpemilu.org#88540,"TERUSAN RAYA BARAT, BATAGUH, KAPUAS, KALIMANTAN TENGAH",3,82,79,161
https://kawalpemilu.org#88540,"TERUSAN RAYA BARAT, BATAGUH, KAPUAS, KALIMANTAN TENGAH",4,107,49,156
https://kawalpemilu.org#928342,"BUDI MUFAKAT, BATAGUH, KAPUAS, KALIMANTAN TENGAH",1,25,103,128
https://kawalpemilu.org#928342,"BUDI MUFAKAT, BATAGUH, KAPUAS, KALIMANTAN TENGAH",2,26,124,150
https://kawalpemilu.org#928342,"BUDI MUFAKAT, BATAGUH, KAPUAS, KALIMANTAN TENGAH",3,99,69,168
https://kawalpemilu.org#928342,"BUDI MUFAKAT, BATAGUH, KAPUAS, KALIMANTAN TENGAH",4,126,36,162
https://kawalpemilu.org#928342,"BUDI MUFAKAT, BATAGUH, KAPUAS, KALIMANTAN TENGAH",5,48,30,78
https://kawalpemilu.org#928342,"BUDI MUFAKAT, BATAGUH, KAPUAS, KALIMANTAN TENGAH",6,114,46,160
https://kawalpemilu.org#928342,"BUDI MUFAKAT, BATAGUH, KAPUAS, KALIMANTAN TENGAH",7,43,71,114
https://kawalpemilu.org#60869,"RANTAU KUJANG, JENAMAS, BARITO SELATAN, KALIMANTAN TENGAH",1,77,122,199
https://kawalpemilu.org#60869,"RANTAU KUJANG, JENAMAS, BARITO SELATAN, KALIMANTAN TENGAH",2,82,88,170
https://kawalpemilu.org#60869,"RANTAU KUJANG, JENAMAS, BARITO SELATAN, KALIMANTAN TENGAH",3,6,97,103
https://kawalpemilu.org#60869,"RANTAU KUJANG, JENAMAS, BARITO SELATAN, KALIMANTAN TENGAH",4,13,131,144
https://kawalpemilu.org#60869,"RANTAU KUJANG, JENAMAS, BARITO SELATAN, KALIMANTAN TENGAH",5,20,199,219
https://kawalpemilu.org#60869,"RANTAU KUJANG, JENAMAS, BARITO SELATAN, KALIMANTAN TENGAH",6,44,180,224
https://kawalpemilu.org#60869,"RANTAU KUJANG, JENAMAS, BARITO SELATAN, KALIMANTAN TENGAH",7,52,192,244
https://kawalpemilu.org#60869,"RANTAU KUJANG, JENAMAS, BARITO SELATAN, KALIMANTAN TENGAH",8,40,207,247
https://kawalpemilu.org#60869,"RANTAU KUJANG, JENAMAS, BARITO SELATAN, KALIMANTAN TENGAH",9,59,180,239
https://kawalpemilu.org#60869,"RANTAU KUJANG, JENAMAS, BARITO SELATAN, KALIMANTAN TENGAH",10,65,147,212
https://kawalpemilu.org#60870,"TAMPULANG, JENAMAS, BARITO SELATAN, KALIMANTAN TENGAH",1,80,91,171
https://kawalpemilu.org#60870,"TAMPULANG, JENAMAS, BARITO SELATAN, KALIMANTAN TENGAH",2,16,151,167
https://kawalpemilu.org#60870,"TAMPULANG, JENAMAS, BARITO SELATAN, KALIMANTAN TENGAH",3,19,105,124
https://kawalpemilu.org#60870,"TAMPULANG, JENAMAS, BARITO SELATAN, KALIMANTAN TENGAH",4,14,6,20
https://kawalpemilu.org#60870,"TAMPULANG, JENAMAS, BARITO SELATAN, KALIMANTAN TENGAH",5,28,6,34
https://kawalpemilu.org#60871,"RANTAU BAHUANG, JENAMAS, BARITO SELATAN, KALIMANTAN TENGAH",1,55,71,126
https://kawalpemilu.org#60871,"RANTAU BAHUANG, JENAMAS, BARITO SELATAN, KALIMANTAN TENGAH",2,53,54,107
https://kawalpemilu.org#60871,"RANTAU BAHUANG, JENAMAS, BARITO SELATAN, KALIMANTAN TENGAH",3,66,155,221
https://kawalpemilu.org#60871,"RANTAU BAHUANG, JENAMAS, BARITO SELATAN, KALIMANTAN TENGAH",4,75,158,233
https://kawalpemilu.org#60872,"RANGGA ILUNG, JENAMAS, BARITO SELATAN, KALIMANTAN TENGAH",1,124,105,229
https://kawalpemilu.org#60872,"RANGGA ILUNG, JENAMAS, BARITO SELATAN, KALIMANTAN TENGAH",2,77,70,147
https://kawalpemilu.org#60872,"RANGGA ILUNG, JENAMAS, BARITO SELATAN, KALIMANTAN TENGAH",3,129,72,201
https://kawalpemilu.org#60872,"RANGGA ILUNG, JENAMAS, BARITO SELATAN, KALIMANTAN TENGAH",4,69,80,149
https://kawalpemilu.org#60872,"RANGGA ILUNG, JENAMAS, BARITO SELATAN, KALIMANTAN TENGAH",5,115,84,199
https://kawalpemilu.org#60872,"RANGGA ILUNG, JENAMAS, BARITO SELATAN, KALIMANTAN TENGAH",6,127,86,213
https://kawalpemilu.org#60872,"RANGGA ILUNG, JENAMAS, BARITO SELATAN, KALIMANTAN TENGAH",7,92,59,151
https://kawalpemilu.org#60872,"RANGGA ILUNG, JENAMAS, BARITO SELATAN, KALIMANTAN TENGAH",8,66,58,124
https://kawalpemilu.org#60872,"RANGGA ILUNG, JENAMAS, BARITO SELATAN, KALIMANTAN TENGAH",9,97,112,209
https://kawalpemilu.org#60873,"TABATAN, JENAMAS, BARITO SELATAN, KALIMANTAN TENGAH",1,34,185,219
https://kawalpemilu.org#60875,"MENGKATIP, DUSUN HILIR, BARITO SELATAN, KALIMANTAN TENGAH",1,66,147,213
https://kawalpemilu.org#60875,"MENGKATIP, DUSUN HILIR, BARITO SELATAN, KALIMANTAN TENGAH",2,143,52,195
https://kawalpemilu.org#60875,"MENGKATIP, DUSUN HILIR, BARITO SELATAN, KALIMANTAN TENGAH",3,84,101,185
https://kawalpemilu.org#60875,"MENGKATIP, DUSUN HILIR, BARITO SELATAN, KALIMANTAN TENGAH",4,87,119,211
https://kawalpemilu.org#60875,"MENGKATIP, DUSUN HILIR, BARITO SELATAN, KALIMANTAN TENGAH",5,52,135,187
https://kawalpemilu.org#60875,"MENGKATIP, DUSUN HILIR, BARITO SELATAN, KALIMANTAN TENGAH",6,47,146,193
https://kawalpemilu.org#60875,"MENGKATIP, DUSUN HILIR, BARITO SELATAN, KALIMANTAN TENGAH",7,70,98,168
https://kawalpemilu.org#60875,"MENGKATIP, DUSUN HILIR, BARITO SELATAN, KALIMANTAN TENGAH",8,67,147,214
https://kawalpemilu.org#60875,"MENGKATIP, DUSUN HILIR, BARITO SELATAN, KALIMANTAN TENGAH",9,57,151,208
https://kawalpemilu.org#60875,"MENGKATIP, DUSUN HILIR, BARITO SELATAN, KALIMANTAN TENGAH",10,43,184,227
https://kawalpemilu.org#60876,"LEHAI, DUSUN HILIR, BARITO SELATAN, KALIMANTAN TENGAH",1,48,185,233
https://kawalpemilu.org#60876,"LEHAI, DUSUN HILIR, BARITO SELATAN, KALIMANTAN TENGAH",2,25,199,224
https://kawalpemilu.org#60876,"LEHAI, DUSUN HILIR, BARITO SELATAN, KALIMANTAN TENGAH",3,39,97,136
https://kawalpemilu.org#60876,"LEHAI, DUSUN HILIR, BARITO SELATAN, KALIMANTAN TENGAH",4,36,99,135
https://kawalpemilu.org#60876,"LEHAI, DUSUN HILIR, BARITO SELATAN, KALIMANTAN TENGAH",5,20,81,101
https://kawalpemilu.org#60877,"SUNGAI JAYA, DUSUN HILIR, BARITO SELATAN, KALIMANTAN TENGAH",1,101,61,162
https://kawalpemilu.org#60877,"SUNGAI JAYA, DUSUN HILIR, BARITO SELATAN, KALIMANTAN TENGAH",2,109,89,198
https://kawalpemilu.org#60877,"SUNGAI JAYA, DUSUN HILIR, BARITO SELATAN, KALIMANTAN TENGAH",3,83,29,112
https://kawalpemilu.org#60877,"SUNGAI JAYA, DUSUN HILIR, BARITO SELATAN, KALIMANTAN TENGAH",4,69,58,127
https://kawalpemilu.org#60877,"SUNGAI JAYA, DUSUN HILIR, BARITO SELATAN, KALIMANTAN TENGAH",5,116,30,146
https://kawalpemilu.org#60878,"MAHAJANDAU, DUSUN HILIR, BARITO SELATAN, KALIMANTAN TENGAH",1,186,24,210
https://kawalpemilu.org#60878,"MAHAJANDAU, DUSUN HILIR, BARITO SELATAN, KALIMANTAN TENGAH",2,124,47,171
https://kawalpemilu.org#60878,"MAHAJANDAU, DUSUN HILIR, BARITO SELATAN, KALIMANTAN TENGAH",3,157,47,204
https://kawalpemilu.org#60879,"KALANIS, DUSUN HILIR, BARITO SELATAN, KALIMANTAN TENGAH",1,27,188,215
https://kawalpemilu.org#60879,"KALANIS, DUSUN HILIR, BARITO SELATAN, KALIMANTAN TENGAH",2,46,228,274
https://kawalpemilu.org#60879,"KALANIS, DUSUN HILIR, BARITO SELATAN, KALIMANTAN TENGAH",3,39,209,248
https://kawalpemilu.org#60879,"KALANIS, DUSUN HILIR, BARITO SELATAN, KALIMANTAN TENGAH",4,117,119,236
https://kawalpemilu.org#60879,"KALANIS, DUSUN HILIR, BARITO SELATAN, KALIMANTAN TENGAH",5,39,95,134
https://kawalpemilu.org#60879,"KALANIS, DUSUN HILIR, BARITO SELATAN, KALIMANTAN TENGAH",6,42,96,138
https://kawalpemilu.org#60879,"KALANIS, DUSUN HILIR, BARITO SELATAN, KALIMANTAN TENGAH",7,32,143,175
https://kawalpemilu.org#60879,"KALANIS, DUSUN HILIR, BARITO SELATAN, KALIMANTAN TENGAH",8,45,119,164
https://kawalpemilu.org#60880,"DAMPARAN, DUSUN HILIR, BARITO SELATAN, KALIMANTAN TENGAH",1,137,89,226
https://kawalpemilu.org#60880,"DAMPARAN, DUSUN HILIR, BARITO SELATAN, KALIMANTAN TENGAH",2,86,123,209
https://kawalpemilu.org#60880,"DAMPARAN, DUSUN HILIR, BARITO SELATAN, KALIMANTAN TENGAH",3,63,118,181
https://kawalpemilu.org#60880,"DAMPARAN, DUSUN HILIR, BARITO SELATAN, KALIMANTAN TENGAH",4,114,79,193
https://kawalpemilu.org#60880,"DAMPARAN, DUSUN HILIR, BARITO SELATAN, KALIMANTAN TENGAH",5,122,94,216
https://kawalpemilu.org#60880,"DAMPARAN, DUSUN HILIR, BARITO SELATAN, KALIMANTAN TENGAH",6,91,115,206
https://kawalpemilu.org#60880,"DAMPARAN, DUSUN HILIR, BARITO SELATAN, KALIMANTAN TENGAH",7,72,152,224
https://kawalpemilu.org#60881,"TELUK TIMBAU, DUSUN HILIR, BARITO SELATAN, KALIMANTAN TENGAH",1,184,62,246
https://kawalpemilu.org#60881,"TELUK TIMBAU, DUSUN HILIR, BARITO SELATAN, KALIMANTAN TENGAH",2,180,82,262
https://kawalpemilu.org#60881,"TELUK TIMBAU, DUSUN HILIR, BARITO SELATAN, KALIMANTAN TENGAH",3,50,31,81
https://kawalpemilu.org#60881,"TELUK TIMBAU, DUSUN HILIR, BARITO SELATAN, KALIMANTAN TENGAH",4,211,52,263
https://kawalpemilu.org#60882,"BATILAP, DUSUN HILIR, BARITO SELATAN, KALIMANTAN TENGAH",1,144,71,215
https://kawalpemilu.org#60882,"BATILAP, DUSUN HILIR, BARITO SELATAN, KALIMANTAN TENGAH",2,184,42,226
https://kawalpemilu.org#60883,"BATAMPANG, DUSUN HILIR, BARITO SELATAN, KALIMANTAN TENGAH",1,148,78,232
https://kawalpemilu.org#60883,"BATAMPANG, DUSUN HILIR, BARITO SELATAN, KALIMANTAN TENGAH",2,110,52,162
https://kawalpemilu.org#60883,"BATAMPANG, DUSUN HILIR, BARITO SELATAN, KALIMANTAN TENGAH",3,43,107,150
https://kawalpemilu.org#60883,"BATAMPANG, DUSUN HILIR, BARITO SELATAN, KALIMANTAN TENGAH",4,122,75,197
https://kawalpemilu.org#60883,"BATAMPANG, DUSUN HILIR, BARITO SELATAN, KALIMANTAN TENGAH",5,46,112,158
https://kawalpemilu.org#60884,"MANGKATIR, DUSUN HILIR, BARITO SELATAN, KALIMANTAN TENGAH",1,54,159,213
https://kawalpemilu.org#60886,"BANGKUANG, KARAU KUALA, BARITO SELATAN, KALIMANTAN TENGAH",1,123,95,218
https://kawalpemilu.org#60886,"BANGKUANG, KARAU KUALA, BARITO SELATAN, KALIMANTAN TENGAH",2,110,121,231
https://kawalpemilu.org#60886,"BANGKUANG, KARAU KUALA, BARITO SELATAN, KALIMANTAN TENGAH",3,99,125,224
https://kawalpemilu.org#60886,"BANGKUANG, KARAU KUALA, BARITO SELATAN, KALIMANTAN TENGAH",4,130,92,222
https://kawalpemilu.org#60886,"BANGKUANG, KARAU KUALA, BARITO SELATAN, KALIMANTAN TENGAH",5,132,100,232
https://kawalpemilu.org#60886,"BANGKUANG, KARAU KUALA, BARITO SELATAN, KALIMANTAN TENGAH",6,109,129,238
https://kawalpemilu.org#60886,"BANGKUANG, KARAU KUALA, BARITO SELATAN, KALIMANTAN TENGAH",7,119,143,262
https://kawalpemilu.org#60886,"BANGKUANG, KARAU KUALA, BARITO SELATAN, KALIMANTAN TENGAH",8,102,149,251
https://kawalpemilu.org#60886,"BANGKUANG, KARAU KUALA, BARITO SELATAN, KALIMANTAN TENGAH",9,51,153,204
https://kawalpemilu.org#60886,"BANGKUANG, KARAU KUALA, BARITO SELATAN, KALIMANTAN TENGAH",10,127,107,234
https://kawalpemilu.org#60886,"BANGKUANG, KARAU KUALA, BARITO SELATAN, KALIMANTAN TENGAH",11,63,162,225
https://kawalpemilu.org#60886,"BANGKUANG, KARAU KUALA, BARITO SELATAN, KALIMANTAN TENGAH",12,107,154,261
https://kawalpemilu.org#60887,"MALITIN, KARAU KUALA, BARITO SELATAN, KALIMANTAN TENGAH",1,139,66,205
https://kawalpemilu.org#60888,"SALAT BARU, KARAU KUALA, BARITO SELATAN, KALIMANTAN TENGAH",1,44,127,171
https://kawalpemilu.org#60889,"TELUK BETUNG, KARAU KUALA, BARITO SELATAN, KALIMANTAN TENGAH",1,186,46,232
https://kawalpemilu.org#60889,"TELUK BETUNG, KARAU KUALA, BARITO SELATAN, KALIMANTAN TENGAH",2,184,54,238
https://kawalpemilu.org#60889,"TELUK BETUNG, KARAU KUALA, BARITO SELATAN, KALIMANTAN TENGAH",3,164,98,262
https://kawalpemilu.org#60890,"BABAI, KARAU KUALA, BARITO SELATAN, KALIMANTAN TENGAH",1,113,68,181
https://kawalpemilu.org#60890,"BABAI, KARAU KUALA, BARITO SELATAN, KALIMANTAN TENGAH",2,154,71,225
https://kawalpemilu.org#60890,"BABAI, KARAU KUALA, BARITO SELATAN, KALIMANTAN TENGAH",3,74,152,226
https://kawalpemilu.org#60890,"BABAI, KARAU KUALA, BARITO SELATAN, KALIMANTAN TENGAH",4,78,159,237
https://kawalpemilu.org#60890,"BABAI, KARAU KUALA, BARITO SELATAN, KALIMANTAN TENGAH",5,118,107,225
https://kawalpemilu.org#60890,"BABAI, KARAU KUALA, BARITO SELATAN, KALIMANTAN TENGAH",6,73,101,174
https://kawalpemilu.org#60890,"BABAI, KARAU KUALA, BARITO SELATAN, KALIMANTAN TENGAH",7,80,97,177
https://kawalpemilu.org#60890,"BABAI, KARAU KUALA, BARITO SELATAN, KALIMANTAN TENGAH",9,119,100,219
https://kawalpemilu.org#60890,"BABAI, KARAU KUALA, BARITO SELATAN, KALIMANTAN TENGAH",10,131,96,227
https://kawalpemilu.org#60890,"BABAI, KARAU KUALA, BARITO SELATAN, KALIMANTAN TENGAH",11,111,89,200
https://kawalpemilu.org#60890,"BABAI, KARAU KUALA, BARITO SELATAN, KALIMANTAN TENGAH",12,78,72,150
https://kawalpemilu.org#60891,"JANGGI, KARAU KUALA, BARITO SELATAN, KALIMANTAN TENGAH",1,76,96,172
https://kawalpemilu.org#60892,"MUARA ARAI, KARAU KUALA, BARITO SELATAN, KALIMANTAN TENGAH",1,109,59,168
https://kawalpemilu.org#60892,"MUARA ARAI, KARAU KUALA, BARITO SELATAN, KALIMANTAN TENGAH",2,174,38,212
https://kawalpemilu.org#60893,"TALIO, KARAU KUALA, BARITO SELATAN, KALIMANTAN TENGAH",1,200,28,228
https://kawalpemilu.org#60893,"TALIO, KARAU KUALA, BARITO SELATAN, KALIMANTAN TENGAH",2,186,30,216
https://kawalpemilu.org#60893,"TALIO, KARAU KUALA, BARITO SELATAN, KALIMANTAN TENGAH",3,138,27,165
https://kawalpemilu.org#60893,"TALIO, KARAU KUALA, BARITO SELATAN, KALIMANTAN TENGAH",4,148,65,213
https://kawalpemilu.org#60893,"TALIO, KARAU KUALA, BARITO SELATAN, KALIMANTAN TENGAH",5,142,51,193
https://kawalpemilu.org#60894,"TAMPIJAK, KARAU KUALA, BARITO SELATAN, KALIMANTAN TENGAH",1,162,55,217
https://kawalpemilu.org#60895,"BINTANG KURUNG, KARAU KUALA, BARITO SELATAN, KALIMANTAN TENGAH",1,99,94,196
https://kawalpemilu.org#60895,"BINTANG KURUNG, KARAU KUALA, BARITO SELATAN, KALIMANTAN TENGAH",2,130,53,183
https://kawalpemilu.org#60895,"BINTANG KURUNG, KARAU KUALA, BARITO SELATAN, KALIMANTAN TENGAH",3,130,48,178
https://kawalpemilu.org#60895,"BINTANG KURUNG, KARAU KUALA, BARITO SELATAN, KALIMANTAN TENGAH",4,58,43,101
https://kawalpemilu.org#60896,"TELUK SAMPUDAU, KARAU KUALA, BARITO SELATAN, KALIMANTAN TENGAH",1,199,7,206
https://kawalpemilu.org#60898,"PENDANG, DUSUN UTARA, BARITO SELATAN, KALIMANTAN TENGAH",1,151,93,244
https://kawalpemilu.org#60898,"PENDANG, DUSUN UTARA, BARITO SELATAN, KALIMANTAN TENGAH",2,121,88,6
https://kawalpemilu.org#60898,"PENDANG, DUSUN UTARA, BARITO SELATAN, KALIMANTAN TENGAH",3,105,91,196
https://kawalpemilu.org#60898,"PENDANG, DUSUN UTARA, BARITO SELATAN, KALIMANTAN TENGAH",4,105,131,236
https://kawalpemilu.org#60898,"PENDANG, DUSUN UTARA, BARITO SELATAN, KALIMANTAN TENGAH",5,65,168,233
https://kawalpemilu.org#60898,"PENDANG, DUSUN UTARA, BARITO SELATAN, KALIMANTAN TENGAH",6,75,129,204
https://kawalpemilu.org#60898,"PENDANG, DUSUN UTARA, BARITO SELATAN, KALIMANTAN TENGAH",7,90,133,223
https://kawalpemilu.org#60898,"PENDANG, DUSUN UTARA, BARITO SELATAN, KALIMANTAN TENGAH",8,101,106,207
https://kawalpemilu.org#60898,"PENDANG, DUSUN UTARA, BARITO SELATAN, KALIMANTAN TENGAH",9,114,120,234
https://kawalpemilu.org#60899,"HULU TAMPANG, DUSUN UTARA, BARITO SELATAN, KALIMANTAN TENGAH",1,129,70,199
https://kawalpemilu.org#60899,"HULU TAMPANG, DUSUN UTARA, BARITO SELATAN, KALIMANTAN TENGAH",2,134,73,207
https://kawalpemilu.org#60900,"SUNGAI TELANG, DUSUN UTARA, BARITO SELATAN, KALIMANTAN TENGAH",1,112,22,134
https://kawalpemilu.org#60900,"SUNGAI TELANG, DUSUN UTARA, BARITO SELATAN, KALIMANTAN TENGAH",2,131,11,142
https://kawalpemilu.org#60901,"MAJUNDRE, DUSUN UTARA, BARITO SELATAN, KALIMANTAN TENGAH",1,226,28,254
https://kawalpemilu.org#60902,"BUNDAR, DUSUN UTARA, BARITO SELATAN, KALIMANTAN TENGAH",1,136,40,176
https://kawalpemilu.org#60902,"BUNDAR, DUSUN UTARA, BARITO SELATAN, KALIMANTAN TENGAH",2,164,28,192
https://kawalpemilu.org#60902,"BUNDAR, DUSUN UTARA, BARITO SELATAN, KALIMANTAN TENGAH",3,115,14,129
https://kawalpemilu.org#60902,"BUNDAR, DUSUN UTARA, BARITO SELATAN, KALIMANTAN TENGAH",4,132,32,164
https://kawalpemilu.org#60903,"TELEKOI, DUSUN UTARA, BARITO SELATAN, KALIMANTAN TENGAH",1,99,58,157
https://kawalpemilu.org#60904,"MARAWAN LAMA, DUSUN UTARA, BARITO SELATAN, KALIMANTAN TENGAH",1,105,19,124
https://kawalpemilu.org#60904,"MARAWAN LAMA, DUSUN UTARA, BARITO SELATAN, KALIMANTAN TENGAH",2,152,29,181
https://kawalpemilu.org#60904,"MARAWAN LAMA, DUSUN UTARA, BARITO SELATAN, KALIMANTAN TENGAH",3,148,40,188
https://kawalpemilu.org#60904,"MARAWAN LAMA, DUSUN UTARA, BARITO SELATAN, KALIMANTAN TENGAH",4,121,39,160
https://kawalpemilu.org#60904,"MARAWAN LAMA, DUSUN UTARA, BARITO SELATAN, KALIMANTAN TENGAH",5,80,21,101
https://kawalpemilu.org#60904,"MARAWAN LAMA, DUSUN UTARA, BARITO SELATAN, KALIMANTAN TENGAH",6,144,28,172
https://kawalpemilu.org#60905,"MARAWAN BARU, DUSUN UTARA, BARITO SELATAN, KALIMANTAN TENGAH",1,116,103,219
https://kawalpemilu.org#60906,"REONG, DUSUN UTARA, BARITO SELATAN, KALIMANTAN TENGAH",1,91,41,132
https://kawalpemilu.org#60906,"REONG, DUSUN UTARA, BARITO SELATAN, KALIMANTAN TENGAH",2,113,70,183
https://kawalpemilu.org#60906,"REONG, DUSUN UTARA, BARITO SELATAN, KALIMANTAN TENGAH",3,156,62,224
https://kawalpemilu.org#60907,"TARUSAN, DUSUN UTARA, BARITO SELATAN, KALIMANTAN TENGAH",1,151,27,178
https://kawalpemilu.org#60907,"TARUSAN, DUSUN UTARA, BARITO SELATAN, KALIMANTAN TENGAH",2,148,50,198
https://kawalpemilu.org#60907,"TARUSAN, DUSUN UTARA, BARITO SELATAN, KALIMANTAN TENGAH",3,120,35,155
https://kawalpemilu.org#60907,"TARUSAN, DUSUN UTARA, BARITO SELATAN, KALIMANTAN TENGAH",4,172,34,206
https://kawalpemilu.org#60907,"TARUSAN, DUSUN UTARA, BARITO SELATAN, KALIMANTAN TENGAH",5,79,30,109
https://kawalpemilu.org#60908,"PANARUKAN, DUSUN UTARA, BARITO SELATAN, KALIMANTAN TENGAH",1,137,22,159
https://kawalpemilu.org#60908,"PANARUKAN, DUSUN UTARA, BARITO SELATAN, KALIMANTAN TENGAH",2,108,13,121
https://kawalpemilu.org#60909,"MARUGA, DUSUN UTARA, BARITO SELATAN, KALIMANTAN TENGAH",1,147,16,163
https://kawalpemilu.org#60909,"MARUGA, DUSUN UTARA, BARITO SELATAN, KALIMANTAN TENGAH",2,128,15,143
https://kawalpemilu.org#60909,"MARUGA, DUSUN UTARA, BARITO SELATAN, KALIMANTAN TENGAH",3,105,7,112
https://kawalpemilu.org#60910,"HINGAN, DUSUN UTARA, BARITO SELATAN, KALIMANTAN TENGAH",1,108,16,124
https://kawalpemilu.org#60910,"HINGAN, DUSUN UTARA, BARITO SELATAN, KALIMANTAN TENGAH",2,9,3,12
https://kawalpemilu.org#60911,"DANAU BAMBURE, DUSUN UTARA, BARITO SELATAN, KALIMANTAN TENGAH",1,164,19,183
https://kawalpemilu.org#60912,"TAMPARAK, DUSUN UTARA, BARITO SELATAN, KALIMANTAN TENGAH",1,83,41,124
https://kawalpemilu.org#60912,"TAMPARAK, DUSUN UTARA, BARITO SELATAN, KALIMANTAN TENGAH",2,147,9,156
https://kawalpemilu.org#60912,"TAMPARAK, DUSUN UTARA, BARITO SELATAN, KALIMANTAN TENGAH",3,147,6,153
https://kawalpemilu.org#60913,"BANTAI BAMBURE, DUSUN UTARA, BARITO SELATAN, KALIMANTAN TENGAH",1,105,33,138
https://kawalpemilu.org#60913,"BANTAI BAMBURE, DUSUN UTARA, BARITO SELATAN, KALIMANTAN TENGAH",2,100,40,140
https://kawalpemilu.org#60913,"BANTAI BAMBURE, DUSUN UTARA, BARITO SELATAN, KALIMANTAN TENGAH",3,200,36,236
https://kawalpemilu.org#60914,"RAMPA MEA, DUSUN UTARA, BARITO SELATAN, KALIMANTAN TENGAH",1,198,23,221
https://kawalpemilu.org#60914,"RAMPA MEA, DUSUN UTARA, BARITO SELATAN, KALIMANTAN TENGAH",2,165,43,208
https://kawalpemilu.org#60915,"GUNUNG RANTAU, DUSUN UTARA, BARITO SELATAN, KALIMANTAN TENGAH",1,205,28,233
https://kawalpemilu.org#60915,"GUNUNG RANTAU, DUSUN UTARA, BARITO SELATAN, KALIMANTAN TENGAH",2,110,34,144
https://kawalpemilu.org#60916,"TAMPARAK LAYUNG, DUSUN UTARA, BARITO SELATAN, KALIMANTAN TENGAH",1,202,29,231
https://kawalpemilu.org#60916,"TAMPARAK LAYUNG, DUSUN UTARA, BARITO SELATAN, KALIMANTAN TENGAH",2,170,18,188
https://kawalpemilu.org#60918,"TABAK KANILAN, GN. BINTANG AWAI, BARITO SELATAN, KALIMANTAN TENGAH",1,119,25,144
https://kawalpemilu.org#60918,"TABAK KANILAN, GN. BINTANG AWAI, BARITO SELATAN, KALIMANTAN TENGAH",2,171,31,202
https://kawalpemilu.org#60918,"TABAK KANILAN, GN. BINTANG AWAI, BARITO SELATAN, KALIMANTAN TENGAH",3,134,34,168
https://kawalpemilu.org#60918,"TABAK KANILAN, GN. BINTANG AWAI, BARITO SELATAN, KALIMANTAN TENGAH",4,124,66,190
https://kawalpemilu.org#60918,"TABAK KANILAN, GN. BINTANG AWAI, BARITO SELATAN, KALIMANTAN TENGAH",5,102,18,120
https://kawalpemilu.org#60918,"TABAK KANILAN, GN. BINTANG AWAI, BARITO SELATAN, KALIMANTAN TENGAH",6,146,31,177
https://kawalpemilu.org#60918,"TABAK KANILAN, GN. BINTANG AWAI, BARITO SELATAN, KALIMANTAN TENGAH",7,130,13,143
https://kawalpemilu.org#60919,"BARUANG, GN. BINTANG AWAI, BARITO SELATAN, KALIMANTAN TENGAH",1,108,9,117
https://kawalpemilu.org#60920,"KAYUMBAN, GN. BINTANG AWAI, BARITO SELATAN, KALIMANTAN TENGAH",1,201,40,241
https://kawalpemilu.org#60920,"KAYUMBAN, GN. BINTANG AWAI, BARITO SELATAN, KALIMANTAN TENGAH",2,167,69,236
https://kawalpemilu.org#60921,"SARIMBUAH, GN. BINTANG AWAI, BARITO SELATAN, KALIMANTAN TENGAH",1,161,30,191
https://kawalpemilu.org#60922,"GAGUTUR, GN. BINTANG AWAI, BARITO SELATAN, KALIMANTAN TENGAH",1,145,35,180
https://kawalpemilu.org#60922,"GAGUTUR, GN. BINTANG AWAI, BARITO SELATAN, KALIMANTAN TENGAH",2,185,33,218
https://kawalpemilu.org#60922,"GAGUTUR, GN. BINTANG AWAI, BARITO SELATAN, KALIMANTAN TENGAH",3,95,43,138
https://kawalpemilu.org#60923,"MUKA HAJI, GN. BINTANG AWAI, BARITO SELATAN, KALIMANTAN TENGAH",1,69,118,187
https://kawalpemilu.org#60923,"MUKA HAJI, GN. BINTANG AWAI, BARITO SELATAN, KALIMANTAN TENGAH",2,84,115,199
https://kawalpemilu.org#60924,"SIRE, GN. BINTANG AWAI, BARITO SELATAN, KALIMANTAN TENGAH",1,76,28,104
https://kawalpemilu.org#60924,"SIRE, GN. BINTANG AWAI, BARITO SELATAN, KALIMANTAN TENGAH",2,97,133,230
https://kawalpemilu.org#60925,"MUARA SINGAN, GN. BINTANG AWAI, BARITO SELATAN, KALIMANTAN TENGAH",1,69,57,126
https://kawalpemilu.org#60925,"MUARA SINGAN, GN. BINTANG AWAI, BARITO SELATAN, KALIMANTAN TENGAH",2,117,72,189
https://kawalpemilu.org#60925,"MUARA SINGAN, GN. BINTANG AWAI, BARITO SELATAN, KALIMANTAN TENGAH",3,27,11,38
https://kawalpemilu.org#60925,"MUARA SINGAN, GN. BINTANG AWAI, BARITO SELATAN, KALIMANTAN TENGAH",4,121,112,233
https://kawalpemilu.org#60925,"MUARA SINGAN, GN. BINTANG AWAI, BARITO SELATAN, KALIMANTAN TENGAH",5,134,78,212
https://kawalpemilu.org#60926,"PATAS I, GN. BINTANG AWAI, BARITO SELATAN, KALIMANTAN TENGAH",1,111,97,208
https://kawalpemilu.org#60926,"PATAS I, GN. BINTANG AWAI, BARITO SELATAN, KALIMANTAN TENGAH",2,106,79,185
https://kawalpemilu.org#60926,"PATAS I, GN. BINTANG AWAI, BARITO SELATAN, KALIMANTAN TENGAH",3,82,69,151
https://kawalpemilu.org#60926,"PATAS I, GN. BINTANG AWAI, BARITO SELATAN, KALIMANTAN TENGAH",4,152,75,227
https://kawalpemilu.org#60926,"PATAS I, GN. BINTANG AWAI, BARITO SELATAN, KALIMANTAN TENGAH",5,145,94,239
https://kawalpemilu.org#60926,"PATAS I, GN. BINTANG AWAI, BARITO SELATAN, KALIMANTAN TENGAH",6,116,18,134
https://kawalpemilu.org#60926,"PATAS I, GN. BINTANG AWAI, BARITO SELATAN, KALIMANTAN TENGAH",7,108,29,137
https://kawalpemilu.org#60926,"PATAS I, GN. BINTANG AWAI, BARITO SELATAN, KALIMANTAN TENGAH",8,118,19,137
https://kawalpemilu.org#60926,"PATAS I, GN. BINTANG AWAI, BARITO SELATAN, KALIMANTAN TENGAH",9,87,29,116
https://kawalpemilu.org#60927,"PATAS II, GN. BINTANG AWAI, BARITO SELATAN, KALIMANTAN TENGAH",1,146,38,184
https://kawalpemilu.org#60928,"BINTANG ARA, GN. BINTANG AWAI, BARITO SELATAN, KALIMANTAN TENGAH",1,142,7,149
https://kawalpemilu.org#60928,"BINTANG ARA, GN. BINTANG AWAI, BARITO SELATAN, KALIMANTAN TENGAH",2,158,14,172
https://kawalpemilu.org#60929,"UGANG SAYU, GN. BINTANG AWAI, BARITO SELATAN, KALIMANTAN TENGAH",1,188,45,233
https://kawalpemilu.org#60929,"UGANG SAYU, GN. BINTANG AWAI, BARITO SELATAN, KALIMANTAN TENGAH",2,169,19,188
https://kawalpemilu.org#60929,"UGANG SAYU, GN. BINTANG AWAI, BARITO SELATAN, KALIMANTAN TENGAH",3,184,40,224
https://kawalpemilu.org#60930,"WUNGKUR BARU, GN. BINTANG AWAI, BARITO SELATAN, KALIMANTAN TENGAH",1,198,25,223
https://kawalpemilu.org#60931,"RUHING RAYA, GN. BINTANG AWAI, BARITO SELATAN, KALIMANTAN TENGAH",1,108,31,139
https://kawalpemilu.org#60931,"RUHING RAYA, GN. BINTANG AWAI, BARITO SELATAN, KALIMANTAN TENGAH",2,89,40,129
https://kawalpemilu.org#60932,"MARGA JAYA, GN. BINTANG AWAI, BARITO SELATAN, KALIMANTAN TENGAH",1,166,39,205
https://kawalpemilu.org#60933,"BIPAK KALI, GN. BINTANG AWAI, BARITO SELATAN, KALIMANTAN TENGAH",1,153,36,189
https://kawalpemilu.org#60933,"BIPAK KALI, GN. BINTANG AWAI, BARITO SELATAN, KALIMANTAN TENGAH",2,73,15,88
https://kawalpemilu.org#60933,"BIPAK KALI, GN. BINTANG AWAI, BARITO SELATAN, KALIMANTAN TENGAH",3,133,23,156
https://kawalpemilu.org#60934,"MALUNGAI RAYA, GN. BINTANG AWAI, BARITO SELATAN, KALIMANTAN TENGAH",1,126,14,140
https://kawalpemilu.org#60934,"MALUNGAI RAYA, GN. BINTANG AWAI, BARITO SELATAN, KALIMANTAN TENGAH",2,148,17,165
https://kawalpemilu.org#60935,"NGURIT, GN. BINTANG AWAI, BARITO SELATAN, KALIMANTAN TENGAH",1,146,41,187
https://kawalpemilu.org#60935,"NGURIT, GN. BINTANG AWAI, BARITO SELATAN, KALIMANTAN TENGAH",2,152,34,186
https://kawalpemilu.org#60935,"NGURIT, GN. BINTANG AWAI, BARITO SELATAN, KALIMANTAN TENGAH",3,142,26,168
https://kawalpemilu.org#60936,"SEI PAKEN, GN. BINTANG AWAI, BARITO SELATAN, KALIMANTAN TENGAH",1,141,27,168
https://kawalpemilu.org#60936,"SEI PAKEN, GN. BINTANG AWAI, BARITO SELATAN, KALIMANTAN TENGAH",2,126,43,169
https://kawalpemilu.org#60936,"SEI PAKEN, GN. BINTANG AWAI, BARITO SELATAN, KALIMANTAN TENGAH",3,85,26,111
https://kawalpemilu.org#60937,"PALU REJO, GN. BINTANG AWAI, BARITO SELATAN, KALIMANTAN TENGAH",1,172,75,247
https://kawalpemilu.org#60937,"PALU REJO, GN. BINTANG AWAI, BARITO SELATAN, KALIMANTAN TENGAH",2,167,57,224
https://kawalpemilu.org#60937,"PALU REJO, GN. BINTANG AWAI, BARITO SELATAN, KALIMANTAN TENGAH",3,134,57,191
https://kawalpemilu.org#60937,"PALU REJO, GN. BINTANG AWAI, BARITO SELATAN, KALIMANTAN TENGAH",4,74,67,141
https://kawalpemilu.org#60937,"PALU REJO, GN. BINTANG AWAI, BARITO SELATAN, KALIMANTAN TENGAH",5,118,60,178
https://kawalpemilu.org#60937,"PALU REJO, GN. BINTANG AWAI, BARITO SELATAN, KALIMANTAN TENGAH",6,146,37,183
https://kawalpemilu.org#60937,"PALU REJO, GN. BINTANG AWAI, BARITO SELATAN, KALIMANTAN TENGAH",7,185,43,228
https://kawalpemilu.org#60937,"PALU REJO, GN. BINTANG AWAI, BARITO SELATAN, KALIMANTAN TENGAH",8,84,42,126
https://kawalpemilu.org#60938,"WAYUN, GN. BINTANG AWAI, BARITO SELATAN, KALIMANTAN TENGAH",1,119,86,205
https://kawalpemilu.org#60938,"WAYUN, GN. BINTANG AWAI, BARITO SELATAN, KALIMANTAN TENGAH",2,112,82,194
https://kawalpemilu.org#60938,"WAYUN, GN. BINTANG AWAI, BARITO SELATAN, KALIMANTAN TENGAH",3,133,63,196
https://kawalpemilu.org#60940,"JELAPAT, DUSUN SELATAN, BARITO SELATAN, KALIMANTAN TENGAH",1,47,181,228
https://kawalpemilu.org#60940,"JELAPAT, DUSUN SELATAN, BARITO SELATAN, KALIMANTAN TENGAH",2,48,204,252
https://kawalpemilu.org#60940,"JELAPAT, DUSUN SELATAN, BARITO SELATAN, KALIMANTAN TENGAH",3,58,147,205
https://kawalpemilu.org#60940,"JELAPAT, DUSUN SELATAN, BARITO SELATAN, KALIMANTAN TENGAH",4,86,142,228
https://kawalpemilu.org#60940,"JELAPAT, DUSUN SELATAN, BARITO SELATAN, KALIMANTAN TENGAH",5,145,99,244
https://kawalpemilu.org#60940,"JELAPAT, DUSUN SELATAN, BARITO SELATAN, KALIMANTAN TENGAH",6,94,83,177
https://kawalpemilu.org#60940,"JELAPAT, DUSUN SELATAN, BARITO SELATAN, KALIMANTAN TENGAH",7,110,136,246
https://kawalpemilu.org#60940,"JELAPAT, DUSUN SELATAN, BARITO SELATAN, KALIMANTAN TENGAH",8,142,27,169
https://kawalpemilu.org#60941,"HILIR SPER, DUSUN SELATAN, BARITO SELATAN, KALIMANTAN TENGAH",1,63,129,192
https://kawalpemilu.org#60941,"HILIR SPER, DUSUN SELATAN, BARITO SELATAN, KALIMANTAN TENGAH",2,54,178,232
https://kawalpemilu.org#60941,"HILIR SPER, DUSUN SELATAN, BARITO SELATAN, KALIMANTAN TENGAH",3,58,111,169
https://kawalpemilu.org#60941,"HILIR SPER, DUSUN SELATAN, BARITO SELATAN, KALIMANTAN TENGAH",4,51,116,167
https://kawalpemilu.org#60941,"HILIR SPER, DUSUN SELATAN, BARITO SELATAN, KALIMANTAN TENGAH",5,68,171,239
https://kawalpemilu.org#60941,"HILIR SPER, DUSUN SELATAN, BARITO SELATAN, KALIMANTAN TENGAH",6,64,125,189
https://kawalpemilu.org#60941,"HILIR SPER, DUSUN SELATAN, BARITO SELATAN, KALIMANTAN TENGAH",7,60,144,204
https://kawalpemilu.org#60941,"HILIR SPER, DUSUN SELATAN, BARITO SELATAN, KALIMANTAN TENGAH",8,116,125,241
https://kawalpemilu.org#60941,"HILIR SPER, DUSUN SELATAN, BARITO SELATAN, KALIMANTAN TENGAH",9,108,90,198
https://kawalpemilu.org#60941,"HILIR SPER, DUSUN SELATAN, BARITO SELATAN, KALIMANTAN TENGAH",10,63,75,138
https://kawalpemilu.org#60941,"HILIR SPER, DUSUN SELATAN, BARITO SELATAN, KALIMANTAN TENGAH",11,68,180,248
https://kawalpemilu.org#60941,"HILIR SPER, DUSUN SELATAN, BARITO SELATAN, KALIMANTAN TENGAH",12,57,118,175
https://kawalpemilu.org#60941,"HILIR SPER, DUSUN SELATAN, BARITO SELATAN, KALIMANTAN TENGAH",13,91,149,240
https://kawalpemilu.org#60941,"HILIR SPER, DUSUN SELATAN, BARITO SELATAN, KALIMANTAN TENGAH",14,39,136,175
https://kawalpemilu.org#60941,"HILIR SPER, DUSUN SELATAN, BARITO SELATAN, KALIMANTAN TENGAH",15,126,105,231
https://kawalpemilu.org#60941,"HILIR SPER, DUSUN SELATAN, BARITO SELATAN, KALIMANTAN TENGAH",16,60,78,138
https://kawalpemilu.org#60941,"HILIR SPER, DUSUN SELATAN, BARITO SELATAN, KALIMANTAN TENGAH",17,45,94,139
https://kawalpemilu.org#60941,"HILIR SPER, DUSUN SELATAN, BARITO SELATAN, KALIMANTAN TENGAH",18,153,123,276
https://kawalpemilu.org#60941,"HILIR SPER, DUSUN SELATAN, BARITO SELATAN, KALIMANTAN TENGAH",19,91,76,167
https://kawalpemilu.org#60941,"HILIR SPER, DUSUN SELATAN, BARITO SELATAN, KALIMANTAN TENGAH",20,112,157,269
https://kawalpemilu.org#60941,"HILIR SPER, DUSUN SELATAN, BARITO SELATAN, KALIMANTAN TENGAH",21,67,94,161
https://kawalpemilu.org#60941,"HILIR SPER, DUSUN SELATAN, BARITO SELATAN, KALIMANTAN TENGAH",22,59,69,128
https://kawalpemilu.org#60941,"HILIR SPER, DUSUN SELATAN, BARITO SELATAN, KALIMANTAN TENGAH",23,51,126,177
https://kawalpemilu.org#60941,"HILIR SPER, DUSUN SELATAN, BARITO SELATAN, KALIMANTAN TENGAH",24,52,112,164
https://kawalpemilu.org#60941,"HILIR SPER, DUSUN SELATAN, BARITO SELATAN, KALIMANTAN TENGAH",25,84,77,161
https://kawalpemilu.org#60941,"HILIR SPER, DUSUN SELATAN, BARITO SELATAN, KALIMANTAN TENGAH",26,58,137,195
https://kawalpemilu.org#60941,"HILIR SPER, DUSUN SELATAN, BARITO SELATAN, KALIMANTAN TENGAH",27,74,117,191
https://kawalpemilu.org#60941,"HILIR SPER, DUSUN SELATAN, BARITO SELATAN, KALIMANTAN TENGAH",28,80,138,218
https://kawalpemilu.org#60941,"HILIR SPER, DUSUN SELATAN, BARITO SELATAN, KALIMANTAN TENGAH",29,55,151,206
https://kawalpemilu.org#60941,"HILIR SPER, DUSUN SELATAN, BARITO SELATAN, KALIMANTAN TENGAH",30,156,30,186
https://kawalpemilu.org#60941,"HILIR SPER, DUSUN SELATAN, BARITO SELATAN, KALIMANTAN TENGAH",31,30,153,183
https://kawalpemilu.org#60941,"HILIR SPER, DUSUN SELATAN, BARITO SELATAN, KALIMANTAN TENGAH",32,112,147,259
https://kawalpemilu.org#60941,"HILIR SPER, DUSUN SELATAN, BARITO SELATAN, KALIMANTAN TENGAH",33,97,88,185
https://kawalpemilu.org#60941,"HILIR SPER, DUSUN SELATAN, BARITO SELATAN, KALIMANTAN TENGAH",34,195,41,236
https://kawalpemilu.org#60941,"HILIR SPER, DUSUN SELATAN, BARITO SELATAN, KALIMANTAN TENGAH",35,179,84,263
https://kawalpemilu.org#60941,"HILIR SPER, DUSUN SELATAN, BARITO SELATAN, KALIMANTAN TENGAH",36,111,89,200
https://kawalpemilu.org#60941,"HILIR SPER, DUSUN SELATAN, BARITO SELATAN, KALIMANTAN TENGAH",37,104,135,239
https://kawalpemilu.org#60941,"HILIR SPER, DUSUN SELATAN, BARITO SELATAN, KALIMANTAN TENGAH",38,112,101,213
https://kawalpemilu.org#60941,"HILIR SPER, DUSUN SELATAN, BARITO SELATAN, KALIMANTAN TENGAH",39,71,90,161
https://kawalpemilu.org#60941,"HILIR SPER, DUSUN SELATAN, BARITO SELATAN, KALIMANTAN TENGAH",40,110,108,218
https://kawalpemilu.org#60941,"HILIR SPER, DUSUN SELATAN, BARITO SELATAN, KALIMANTAN TENGAH",41,84,67,151
https://kawalpemilu.org#60942,"BUNTOK KOTA, DUSUN SELATAN, BARITO SELATAN, KALIMANTAN TENGAH",1,30,111,141
https://kawalpemilu.org#60942,"BUNTOK KOTA, DUSUN SELATAN, BARITO SELATAN, KALIMANTAN TENGAH",2,23,94,123
https://kawalpemilu.org#60942,"BUNTOK KOTA, DUSUN SELATAN, BARITO SELATAN, KALIMANTAN TENGAH",3,27,31,58
https://kawalpemilu.org#60942,"BUNTOK KOTA, DUSUN SELATAN, BARITO SELATAN, KALIMANTAN TENGAH",4,42,92,134
https://kawalpemilu.org#60942,"BUNTOK KOTA, DUSUN SELATAN, BARITO SELATAN, KALIMANTAN TENGAH",5,55,175,230
https://kawalpemilu.org#60942,"BUNTOK KOTA, DUSUN SELATAN, BARITO SELATAN, KALIMANTAN TENGAH",6,36,97,133
https://kawalpemilu.org#60942,"BUNTOK KOTA, DUSUN SELATAN, BARITO SELATAN, KALIMANTAN TENGAH",7,57,107,164
https://kawalpemilu.org#60942,"BUNTOK KOTA, DUSUN SELATAN, BARITO SELATAN, KALIMANTAN TENGAH",8,94,124,218
https://kawalpemilu.org#60942,"BUNTOK KOTA, DUSUN SELATAN, BARITO SELATAN, KALIMANTAN TENGAH",9,70,128,198
https://kawalpemilu.org#60942,"BUNTOK KOTA, DUSUN SELATAN, BARITO SELATAN, KALIMANTAN TENGAH",10,29,120,149
https://kawalpemilu.org#60942,"BUNTOK KOTA, DUSUN SELATAN, BARITO SELATAN, KALIMANTAN TENGAH",11,164,66,230
https://kawalpemilu.org#60942,"BUNTOK KOTA, DUSUN SELATAN, BARITO SELATAN, KALIMANTAN TENGAH",12,87,108,195
https://kawalpemilu.org#60942,"BUNTOK KOTA, DUSUN SELATAN, BARITO SELATAN, KALIMANTAN TENGAH",13,44,87,131
https://kawalpemilu.org#60942,"BUNTOK KOTA, DUSUN SELATAN, BARITO SELATAN, KALIMANTAN TENGAH",14,63,91,154
https://kawalpemilu.org#60942,"BUNTOK KOTA, DUSUN SELATAN, BARITO SELATAN, KALIMANTAN TENGAH",15,24,63,87
https://kawalpemilu.org#60942,"BUNTOK KOTA, DUSUN SELATAN, BARITO SELATAN, KALIMANTAN TENGAH",16,53,151,204
https://kawalpemilu.org#60942,"BUNTOK KOTA, DUSUN SELATAN, BARITO SELATAN, KALIMANTAN TENGAH",17,51,89,140
https://kawalpemilu.org#60942,"BUNTOK KOTA, DUSUN SELATAN, BARITO SELATAN, KALIMANTAN TENGAH",18,42,114,156
https://kawalpemilu.org#60942,"BUNTOK KOTA, DUSUN SELATAN, BARITO SELATAN, KALIMANTAN TENGAH",19,46,111,157
https://kawalpemilu.org#60942,"BUNTOK KOTA, DUSUN SELATAN, BARITO SELATAN, KALIMANTAN TENGAH",20,89,131,220
https://kawalpemilu.org#60942,"BUNTOK KOTA, DUSUN SELATAN, BARITO SELATAN, KALIMANTAN TENGAH",21,69,91,160
https://kawalpemilu.org#60942,"BUNTOK KOTA, DUSUN SELATAN, BARITO SELATAN, KALIMANTAN TENGAH",22,53,148,171
https://kawalpemilu.org#60942,"BUNTOK KOTA, DUSUN SELATAN, BARITO SELATAN, KALIMANTAN TENGAH",23,136,117,253
https://kawalpemilu.org#60942,"BUNTOK KOTA, DUSUN SELATAN, BARITO SELATAN, KALIMANTAN TENGAH",24,70,83,153
https://kawalpemilu.org#60942,"BUNTOK KOTA, DUSUN SELATAN, BARITO SELATAN, KALIMANTAN TENGAH",25,115,102,217
https://kawalpemilu.org#60942,"BUNTOK KOTA, DUSUN SELATAN, BARITO SELATAN, KALIMANTAN TENGAH",26,148,73,221
https://kawalpemilu.org#60942,"BUNTOK KOTA, DUSUN SELATAN, BARITO SELATAN, KALIMANTAN TENGAH",27,94,206,300
https://kawalpemilu.org#60942,"BUNTOK KOTA, DUSUN SELATAN, BARITO SELATAN, KALIMANTAN TENGAH",28,159,62,221
https://kawalpemilu.org#60942,"BUNTOK KOTA, DUSUN SELATAN, BARITO SELATAN, KALIMANTAN TENGAH",29,119,83,172
https://kawalpemilu.org#60942,"BUNTOK KOTA, DUSUN SELATAN, BARITO SELATAN, KALIMANTAN TENGAH",30,71,159,230
https://kawalpemilu.org#60942,"BUNTOK KOTA, DUSUN SELATAN, BARITO SELATAN, KALIMANTAN TENGAH",31,129,89,218
https://kawalpemilu.org#60942,"BUNTOK KOTA, DUSUN SELATAN, BARITO SELATAN, KALIMANTAN TENGAH",32,101,136,237
https://kawalpemilu.org#60942,"BUNTOK KOTA, DUSUN SELATAN, BARITO SELATAN, KALIMANTAN TENGAH",33,163,55,218
https://kawalpemilu.org#60942,"BUNTOK KOTA, DUSUN SELATAN, BARITO SELATAN, KALIMANTAN TENGAH",34,88,43,131
https://kawalpemilu.org#60942,"BUNTOK KOTA, DUSUN SELATAN, BARITO SELATAN, KALIMANTAN TENGAH",35,77,56,133
https://kawalpemilu.org#60942,"BUNTOK KOTA, DUSUN SELATAN, BARITO SELATAN, KALIMANTAN TENGAH",36,69,113,182
https://kawalpemilu.org#60942,"BUNTOK KOTA, DUSUN SELATAN, BARITO SELATAN, KALIMANTAN TENGAH",37,164,85,249
https://kawalpemilu.org#60942,"BUNTOK KOTA, DUSUN SELATAN, BARITO SELATAN, KALIMANTAN TENGAH",38,140,119,259
https://kawalpemilu.org#60942,"BUNTOK KOTA, DUSUN SELATAN, BARITO SELATAN, KALIMANTAN TENGAH",39,91,142,233
https://kawalpemilu.org#60942,"BUNTOK KOTA, DUSUN SELATAN, BARITO SELATAN, KALIMANTAN TENGAH",40,90,117,207
https://kawalpemilu.org#60942,"BUNTOK KOTA, DUSUN SELATAN, BARITO SELATAN, KALIMANTAN TENGAH",41,154,87,241
https://kawalpemilu.org#60942,"BUNTOK KOTA, DUSUN SELATAN, BARITO SELATAN, KALIMANTAN TENGAH",42,54,96,150
https://kawalpemilu.org#60942,"BUNTOK KOTA, DUSUN SELATAN, BARITO SELATAN, KALIMANTAN TENGAH",43,191,98,289
https://kawalpemilu.org#60942,"BUNTOK KOTA, DUSUN SELATAN, BARITO SELATAN, KALIMANTAN TENGAH",44,90,92,182
https://kawalpemilu.org#60942,"BUNTOK KOTA, DUSUN SELATAN, BARITO SELATAN, KALIMANTAN TENGAH",45,106,93,199
https://kawalpemilu.org#60942,"BUNTOK KOTA, DUSUN SELATAN, BARITO SELATAN, KALIMANTAN TENGAH",46,111,28,139
https://kawalpemilu.org#60942,"BUNTOK KOTA, DUSUN SELATAN, BARITO SELATAN, KALIMANTAN TENGAH",47,116,63,179
https://kawalpemilu.org#60942,"BUNTOK KOTA, DUSUN SELATAN, BARITO SELATAN, KALIMANTAN TENGAH",48,83,195,278
https://kawalpemilu.org#60942,"BUNTOK KOTA, DUSUN SELATAN, BARITO SELATAN, KALIMANTAN TENGAH",49,93,108,201
https://kawalpemilu.org#60942,"BUNTOK KOTA, DUSUN SELATAN, BARITO SELATAN, KALIMANTAN TENGAH",50,120,105,4
https://kawalpemilu.org#60942,"BUNTOK KOTA, DUSUN SELATAN, BARITO SELATAN, KALIMANTAN TENGAH",51,32,99,131
https://kawalpemilu.org#60943,"DANAU GANTING, DUSUN SELATAN, BARITO SELATAN, KALIMANTAN TENGAH",1,50,122,172
https://kawalpemilu.org#60943,"DANAU GANTING, DUSUN SELATAN, BARITO SELATAN, KALIMANTAN TENGAH",2,42,88,130
https://kawalpemilu.org#60944,"MUARA TALANG, DUSUN SELATAN, BARITO SELATAN, KALIMANTAN TENGAH",1,97,128,225
https://kawalpemilu.org#60945,"TELUK TELAGA, DUSUN SELATAN, BARITO SELATAN, KALIMANTAN TENGAH",1,52,181,233
https://kawalpemilu.org#60946,"BARU, DUSUN SELATAN, BARITO SELATAN, KALIMANTAN TENGAH",1,153,68,221
https://kawalpemilu.org#60946,"BARU, DUSUN SELATAN, BARITO SELATAN, KALIMANTAN TENGAH",2,88,144,232
https://kawalpemilu.org#60946,"BARU, DUSUN SELATAN, BARITO SELATAN, KALIMANTAN TENGAH",3,72,153,225
https://kawalpemilu.org#60946,"BARU, DUSUN SELATAN, BARITO SELATAN, KALIMANTAN TENGAH",4,56,183,239
https://kawalpemilu.org#60946,"BARU, DUSUN SELATAN, BARITO SELATAN, KALIMANTAN TENGAH",5,55,194,249
https://kawalpemilu.org#60946,"BARU, DUSUN SELATAN, BARITO SELATAN, KALIMANTAN TENGAH",6,48,173,221
https://kawalpemilu.org#60946,"BARU, DUSUN SELATAN, BARITO SELATAN, KALIMANTAN TENGAH",7,72,143,215
https://kawalpemilu.org#60946,"BARU, DUSUN SELATAN, BARITO SELATAN, KALIMANTAN TENGAH",8,93,144,237
https://kawalpemilu.org#60946,"BARU, DUSUN SELATAN, BARITO SELATAN, KALIMANTAN TENGAH",9,98,140,238
https://kawalpemilu.org#60946,"BARU, DUSUN SELATAN, BARITO SELATAN, KALIMANTAN TENGAH",10,101,145,246
https://kawalpemilu.org#60946,"BARU, DUSUN SELATAN, BARITO SELATAN, KALIMANTAN TENGAH",11,95,144,239
https://kawalpemilu.org#60946,"BARU, DUSUN SELATAN, BARITO SELATAN, KALIMANTAN TENGAH",12,91,93,184
https://kawalpemilu.org#60947,"DANAU SADAR, DUSUN SELATAN, BARITO SELATAN, KALIMANTAN TENGAH",1,140,67,207
https://kawalpemilu.org#60947,"DANAU SADAR, DUSUN SELATAN, BARITO SELATAN, KALIMANTAN TENGAH",2,131,64,195
https://kawalpemilu.org#60947,"DANAU SADAR, DUSUN SELATAN, BARITO SELATAN, KALIMANTAN TENGAH",3,100,69,169
https://kawalpemilu.org#60948,"PAMAIT, DUSUN SELATAN, BARITO SELATAN, KALIMANTAN TENGAH",1,93,165,258
https://kawalpemilu.org#60948,"PAMAIT, DUSUN SELATAN, BARITO SELATAN, KALIMANTAN TENGAH",2,54,110,164
https://kawalpemilu.org#60948,"PAMAIT, DUSUN SELATAN, BARITO SELATAN, KALIMANTAN TENGAH",3,52,81,133
https://kawalpemilu.org#60949,"SABABILAH, DUSUN SELATAN, BARITO SELATAN, KALIMANTAN TENGAH",1,177,77,248
https://kawalpemilu.org#60949,"SABABILAH, DUSUN SELATAN, BARITO SELATAN, KALIMANTAN TENGAH",2,220,35,255
https://kawalpemilu.org#60949,"SABABILAH, DUSUN SELATAN, BARITO SELATAN, KALIMANTAN TENGAH",3,152,57,209
https://kawalpemilu.org#60949,"SABABILAH, DUSUN SELATAN, BARITO SELATAN, KALIMANTAN TENGAH",4,168,34,202
https://kawalpemilu.org#60949,"SABABILAH, DUSUN SELATAN, BARITO SELATAN, KALIMANTAN TENGAH",5,108,23,131
https://kawalpemilu.org#60950,"MANGARIS, DUSUN SELATAN, BARITO SELATAN, KALIMANTAN TENGAH",1,142,59,201
https://kawalpemilu.org#60951,"TATEI LANAN, DUSUN SELATAN, BARITO SELATAN, KALIMANTAN TENGAH",1,177,36,213
https://kawalpemilu.org#60952,"PAMANGKA, DUSUN SELATAN, BARITO SELATAN, KALIMANTAN TENGAH",1,113,40,153
https://kawalpemilu.org#60953,"SANGGU, DUSUN SELATAN, BARITO SELATAN, KALIMANTAN TENGAH",1,136,13,149
https://kawalpemilu.org#60953,"SANGGU, DUSUN SELATAN, BARITO SELATAN, KALIMANTAN TENGAH",2,186,22,208
https://kawalpemilu.org#60953,"SANGGU, DUSUN SELATAN, BARITO SELATAN, KALIMANTAN TENGAH",3,209,22,231
https://kawalpemilu.org#60954,"LEMBENG, DUSUN SELATAN, BARITO SELATAN, KALIMANTAN TENGAH",1,116,30,146
https://kawalpemilu.org#60954,"LEMBENG, DUSUN SELATAN, BARITO SELATAN, KALIMANTAN TENGAH",2,98,34,132
https://kawalpemilu.org#60954,"LEMBENG, DUSUN SELATAN, BARITO SELATAN, KALIMANTAN TENGAH",3,57,15,72
https://kawalpemilu.org#60955,"MUARA RIPUNG, DUSUN SELATAN, BARITO SELATAN, KALIMANTAN TENGAH",1,104,2,106
https://kawalpemilu.org#60955,"MUARA RIPUNG, DUSUN SELATAN, BARITO SELATAN, KALIMANTAN TENGAH",2,144,10,154
https://kawalpemilu.org#60956,"MADARA, DUSUN SELATAN, BARITO SELATAN, KALIMANTAN TENGAH",1,113,22,135
https://kawalpemilu.org#60956,"MADARA, DUSUN SELATAN, BARITO SELATAN, KALIMANTAN TENGAH",2,168,10,178
https://kawalpemilu.org#60957,"MURUNG PAKEN, DUSUN SELATAN, BARITO SELATAN, KALIMANTAN TENGAH",1,19,123,142
https://kawalpemilu.org#60958,"MABUAN, DUSUN SELATAN, BARITO SELATAN, KALIMANTAN TENGAH",1,193,8,201
https://kawalpemilu.org#60958,"MABUAN, DUSUN SELATAN, BARITO SELATAN, KALIMANTAN TENGAH",2,105,6,111
https://kawalpemilu.org#60959,"KALAHIEN, DUSUN SELATAN, BARITO SELATAN, KALIMANTAN TENGAH",1,201,6,207
https://kawalpemilu.org#60959,"KALAHIEN, DUSUN SELATAN, BARITO SELATAN, KALIMANTAN TENGAH",2,172,33,205
https://kawalpemilu.org#60959,"KALAHIEN, DUSUN SELATAN, BARITO SELATAN, KALIMANTAN TENGAH",3,186,32,218
https://kawalpemilu.org#60959,"KALAHIEN, DUSUN SELATAN, BARITO SELATAN, KALIMANTAN TENGAH",4,186,16,202
https://kawalpemilu.org#60959,"KALAHIEN, DUSUN SELATAN, BARITO SELATAN, KALIMANTAN TENGAH",5,141,19,160
https://kawalpemilu.org#60959,"KALAHIEN, DUSUN SELATAN, BARITO SELATAN, KALIMANTAN TENGAH",6,155,24,179
https://kawalpemilu.org#60959,"KALAHIEN, DUSUN SELATAN, BARITO SELATAN, KALIMANTAN TENGAH",7,180,23,203
https://kawalpemilu.org#60959,"KALAHIEN, DUSUN SELATAN, BARITO SELATAN, KALIMANTAN TENGAH",8,128,28,156
https://kawalpemilu.org#60960,"PENDA ASAM, DUSUN SELATAN, BARITO SELATAN, KALIMANTAN TENGAH",1,151,50,201
https://kawalpemilu.org#60960,"PENDA ASAM, DUSUN SELATAN, BARITO SELATAN, KALIMANTAN TENGAH",2,109,69,178
https://kawalpemilu.org#60960,"PENDA ASAM, DUSUN SELATAN, BARITO SELATAN, KALIMANTAN TENGAH",3,103,79,182
https://kawalpemilu.org#60960,"PENDA ASAM, DUSUN SELATAN, BARITO SELATAN, KALIMANTAN TENGAH",4,145,81,226
https://kawalpemilu.org#60960,"PENDA ASAM, DUSUN SELATAN, BARITO SELATAN, KALIMANTAN TENGAH",5,200,47,247
https://kawalpemilu.org#60960,"PENDA ASAM, DUSUN SELATAN, BARITO SELATAN, KALIMANTAN TENGAH",6,179,39,218
https://kawalpemilu.org#60961,"PARARAPAK, DUSUN SELATAN, BARITO SELATAN, KALIMANTAN TENGAH",1,169,7,176
https://kawalpemilu.org#60961,"PARARAPAK, DUSUN SELATAN, BARITO SELATAN, KALIMANTAN TENGAH",2,153,10,163
https://kawalpemilu.org#60961,"PARARAPAK, DUSUN SELATAN, BARITO SELATAN, KALIMANTAN TENGAH",3,148,48,196
https://kawalpemilu.org#60962,"TELUK MAMPUN, DUSUN SELATAN, BARITO SELATAN, KALIMANTAN TENGAH",1,24,149,173
https://kawalpemilu.org#60962,"TELUK MAMPUN, DUSUN SELATAN, BARITO SELATAN, KALIMANTAN TENGAH",2,52,102,154
https://kawalpemilu.org#60963,"TANJUNG JAWA, DUSUN SELATAN, BARITO SELATAN, KALIMANTAN TENGAH",1,183,22,205
https://kawalpemilu.org#60963,"TANJUNG JAWA, DUSUN SELATAN, BARITO SELATAN, KALIMANTAN TENGAH",2,103,7,110
https://kawalpemilu.org#60963,"TANJUNG JAWA, DUSUN SELATAN, BARITO SELATAN, KALIMANTAN TENGAH",3,157,36,193
https://kawalpemilu.org#60963,"TANJUNG JAWA, DUSUN SELATAN, BARITO SELATAN, KALIMANTAN TENGAH",4,137,45,182
https://kawalpemilu.org#60963,"TANJUNG JAWA, DUSUN SELATAN, BARITO SELATAN, KALIMANTAN TENGAH",5,104,37,141
https://kawalpemilu.org#60963,"TANJUNG JAWA, DUSUN SELATAN, BARITO SELATAN, KALIMANTAN TENGAH",6,85,64,149
https://kawalpemilu.org#60963,"TANJUNG JAWA, DUSUN SELATAN, BARITO SELATAN, KALIMANTAN TENGAH",7,136,86,222
https://kawalpemilu.org#60964,"TELANG ANDRAU, DUSUN SELATAN, BARITO SELATAN, KALIMANTAN TENGAH",1,98,6,104
https://kawalpemilu.org#60965,"DANGKA, DUSUN SELATAN, BARITO SELATAN, KALIMANTAN TENGAH",1,136,30,166
https://kawalpemilu.org#60966,"DANAU MASURA, DUSUN SELATAN, BARITO SELATAN, KALIMANTAN TENGAH",1,114,11,125
https://kawalpemilu.org#60966,"DANAU MASURA, DUSUN SELATAN, BARITO SELATAN, KALIMANTAN TENGAH",2,82,57,139
https://kawalpemilu.org#60969,"MONTALLAT I, MONTALLAT, BARITO UTARA, KALIMANTAN TENGAH",1,57,18,75
https://kawalpemilu.org#60970,"MONTALLAT II, MONTALLAT, BARITO UTARA, KALIMANTAN TENGAH",1,80,43,123
https://kawalpemilu.org#60970,"MONTALLAT II, MONTALLAT, BARITO UTARA, KALIMANTAN TENGAH",2,117,77,194
https://kawalpemilu.org#60970,"MONTALLAT II, MONTALLAT, BARITO UTARA, KALIMANTAN TENGAH",3,103,76,179
https://kawalpemilu.org#60970,"MONTALLAT II, MONTALLAT, BARITO UTARA, KALIMANTAN TENGAH",4,89,66,155
https://kawalpemilu.org#60970,"MONTALLAT II, MONTALLAT, BARITO UTARA, KALIMANTAN TENGAH",5,108,35,143
https://kawalpemilu.org#60971,"TUMPUNG LAUNG I, MONTALLAT, BARITO UTARA, KALIMANTAN TENGAH",1,124,80,204
https://kawalpemilu.org#60971,"TUMPUNG LAUNG I, MONTALLAT, BARITO UTARA, KALIMANTAN TENGAH",2,116,87,203
https://kawalpemilu.org#60971,"TUMPUNG LAUNG I, MONTALLAT, BARITO UTARA, KALIMANTAN TENGAH",3,130,61,191
https://kawalpemilu.org#60972,"TUMPUNG LAUNG II, MONTALLAT, BARITO UTARA, KALIMANTAN TENGAH",1,172,74,246
https://kawalpemilu.org#60972,"TUMPUNG LAUNG II, MONTALLAT, BARITO UTARA, KALIMANTAN TENGAH",2,139,73,212
https://kawalpemilu.org#60972,"TUMPUNG LAUNG II, MONTALLAT, BARITO UTARA, KALIMANTAN TENGAH",3,141,72,213
https://kawalpemilu.org#60972,"TUMPUNG LAUNG II, MONTALLAT, BARITO UTARA, KALIMANTAN TENGAH",4,128,77,205
https://kawalpemilu.org#60972,"TUMPUNG LAUNG II, MONTALLAT, BARITO UTARA, KALIMANTAN TENGAH",5,122,117,239
https://kawalpemilu.org#60972,"TUMPUNG LAUNG II, MONTALLAT, BARITO UTARA, KALIMANTAN TENGAH",6,98,107,205
https://kawalpemilu.org#60973,"SIKAN, MONTALLAT, BARITO UTARA, KALIMANTAN TENGAH",1,145,47,192
https://kawalpemilu.org#60973,"SIKAN, MONTALLAT, BARITO UTARA, KALIMANTAN TENGAH",2,119,38,157
https://kawalpemilu.org#60973,"SIKAN, MONTALLAT, BARITO UTARA, KALIMANTAN TENGAH",3,122,56,178
https://kawalpemilu.org#60973,"SIKAN, MONTALLAT, BARITO UTARA, KALIMANTAN TENGAH",4,127,36,163
https://kawalpemilu.org#60973,"SIKAN, MONTALLAT, BARITO UTARA, KALIMANTAN TENGAH",5,118,22,140
https://kawalpemilu.org#60973,"SIKAN, MONTALLAT, BARITO UTARA, KALIMANTAN TENGAH",6,131,28,159
https://kawalpemilu.org#60974,"RUBEI, MONTALLAT, BARITO UTARA, KALIMANTAN TENGAH",1,69,7,76
https://kawalpemilu.org#60975,"PEPAS, MONTALLAT, BARITO UTARA, KALIMANTAN TENGAH",2,155,29,184
https://kawalpemilu.org#60975,"PEPAS, MONTALLAT, BARITO UTARA, KALIMANTAN TENGAH",3,156,39,195
https://kawalpemilu.org#60975,"PEPAS, MONTALLAT, BARITO UTARA, KALIMANTAN TENGAH",4,156,13,169
https://kawalpemilu.org#60976,"RUJI, MONTALLAT, BARITO UTARA, KALIMANTAN TENGAH",1,128,40,168
https://kawalpemilu.org#60977,"PERING LAHUNG, MONTALLAT, BARITO UTARA, KALIMANTAN TENGAH",1,106,65,171
https://kawalpemilu.org#60977,"PERING LAHUNG, MONTALLAT, BARITO UTARA, KALIMANTAN TENGAH",2,154,49,203
https://kawalpemilu.org#60977,"PERING LAHUNG, MONTALLAT, BARITO UTARA, KALIMANTAN TENGAH",3,85,85,170
https://kawalpemilu.org#60978,"KAMAWEN, MONTALLAT, BARITO UTARA, KALIMANTAN TENGAH",1,90,23,113
https://kawalpemilu.org#60978,"KAMAWEN, MONTALLAT, BARITO UTARA, KALIMANTAN TENGAH",2,135,39,174
https://kawalpemilu.org#60978,"KAMAWEN, MONTALLAT, BARITO UTARA, KALIMANTAN TENGAH",3,136,36,172
https://kawalpemilu.org#60980,"MALUNGAI, GUNUNG TIMANG, BARITO UTARA, KALIMANTAN TENGAH",1,161,19,180
https://kawalpemilu.org#60980,"MALUNGAI, GUNUNG TIMANG, BARITO UTARA, KALIMANTAN TENGAH",2,96,7,103
https://kawalpemilu.org#60981,"RARAWA, GUNUNG TIMANG, BARITO UTARA, KALIMANTAN TENGAH",1,160,33,193
https://kawalpemilu.org#60982,"KETAPANG, GUNUNG TIMANG, BARITO UTARA, KALIMANTAN TENGAH",1,95,14,109
https://kawalpemilu.org#60982,"KETAPANG, GUNUNG TIMANG, BARITO UTARA, KALIMANTAN TENGAH",2,129,27,156
https://kawalpemilu.org#60983,"WALUR, GUNUNG TIMANG, BARITO UTARA, KALIMANTAN TENGAH",1,90,42,132
https://kawalpemilu.org#60983,"WALUR, GUNUNG TIMANG, BARITO UTARA, KALIMANTAN TENGAH",2,158,84,242
https://kawalpemilu.org#60984,"BALITI, GUNUNG TIMANG, BARITO UTARA, KALIMANTAN TENGAH",1,180,10,190
https://kawalpemilu.org#60985,"MAJANGKAN, GUNUNG TIMANG, BARITO UTARA, KALIMANTAN TENGAH",1,103,41,144
https://kawalpemilu.org#60985,"MAJANGKAN, GUNUNG TIMANG, BARITO UTARA, KALIMANTAN TENGAH",2,132,33,165
https://kawalpemilu.org#60986,"KANDUI, GUNUNG TIMANG, BARITO UTARA, KALIMANTAN TENGAH",1,173,57,230
https://kawalpemilu.org#60986,"KANDUI, GUNUNG TIMANG, BARITO UTARA, KALIMANTAN TENGAH",2,143,66,209
https://kawalpemilu.org#60986,"KANDUI, GUNUNG TIMANG, BARITO UTARA, KALIMANTAN TENGAH",3,136,41,177
https://kawalpemilu.org#60986,"KANDUI, GUNUNG TIMANG, BARITO UTARA, KALIMANTAN TENGAH",4,140,70,210
https://kawalpemilu.org#60986,"KANDUI, GUNUNG TIMANG, BARITO UTARA, KALIMANTAN TENGAH",5,96,84,180
https://kawalpemilu.org#60986,"KANDUI, GUNUNG TIMANG, BARITO UTARA, KALIMANTAN TENGAH",6,93,45,138
https://kawalpemilu.org#60986,"KANDUI, GUNUNG TIMANG, BARITO UTARA, KALIMANTAN TENGAH",7,40,16,56
https://kawalpemilu.org#60986,"KANDUI, GUNUNG TIMANG, BARITO UTARA, KALIMANTAN TENGAH",8,97,42,139
https://kawalpemilu.org#60986,"KANDUI, GUNUNG TIMANG, BARITO UTARA, KALIMANTAN TENGAH",9,102,51,153
https://kawalpemilu.org#60986,"KANDUI, GUNUNG TIMANG, BARITO UTARA, KALIMANTAN TENGAH",10,106,47,153
https://kawalpemilu.org#60987,"PAYANG ARA, GUNUNG TIMANG, BARITO UTARA, KALIMANTAN TENGAH",1,132,26,158
https://kawalpemilu.org#60987,"PAYANG ARA, GUNUNG TIMANG, BARITO UTARA, KALIMANTAN TENGAH",2,119,23,142
https://kawalpemilu.org#60988,"JAMAN, GUNUNG TIMANG, BARITO UTARA, KALIMANTAN TENGAH",1,24,163,187
https://kawalpemilu.org#60989,"PELARI, GUNUNG TIMANG, BARITO UTARA, KALIMANTAN TENGAH",1,147,64,211
https://kawalpemilu.org#60990,"SANGKORANG, GUNUNG TIMANG, BARITO UTARA, KALIMANTAN TENGAH",1,174,7,181
https://kawalpemilu.org#60991,"SIWAU, GUNUNG TIMANG, BARITO UTARA, KALIMANTAN TENGAH",1,49,11,60
https://kawalpemilu.org#60992,"TONGKA, GUNUNG TIMANG, BARITO UTARA, KALIMANTAN TENGAH",1,149,48,197
https://kawalpemilu.org#60992,"TONGKA, GUNUNG TIMANG, BARITO UTARA, KALIMANTAN TENGAH",2,91,33,124
https://kawalpemilu.org#60992,"TONGKA, GUNUNG TIMANG, BARITO UTARA, KALIMANTAN TENGAH",3,113,29,142
https://kawalpemilu.org#60993,"BATU RAYA I, GUNUNG TIMANG, BARITO UTARA, KALIMANTAN TENGAH",1,157,59,216
https://kawalpemilu.org#60993,"BATU RAYA I, GUNUNG TIMANG, BARITO UTARA, KALIMANTAN TENGAH",2,149,48,197
https://kawalpemilu.org#60993,"BATU RAYA I, GUNUNG TIMANG, BARITO UTARA, KALIMANTAN TENGAH",3,146,14,160
https://kawalpemilu.org#60993,"BATU RAYA I, GUNUNG TIMANG, BARITO UTARA, KALIMANTAN TENGAH",4,173,16,189
https://kawalpemilu.org#60993,"BATU RAYA I, GUNUNG TIMANG, BARITO UTARA, KALIMANTAN TENGAH",5,201,15,216
https://kawalpemilu.org#60994,"BATU RAYA II, GUNUNG TIMANG, BARITO UTARA, KALIMANTAN TENGAH",1,148,15,163
https://kawalpemilu.org#60994,"BATU RAYA II, GUNUNG TIMANG, BARITO UTARA, KALIMANTAN TENGAH",2,128,45,173
https://kawalpemilu.org#60994,"BATU RAYA II, GUNUNG TIMANG, BARITO UTARA, KALIMANTAN TENGAH",3,171,26,197
https://kawalpemilu.org#60994,"BATU RAYA II, GUNUNG TIMANG, BARITO UTARA, KALIMANTAN TENGAH",4,156,6,162
https://kawalpemilu.org#60995,"TAPEN RAYA, GUNUNG TIMANG, BARITO UTARA, KALIMANTAN TENGAH",1,147,22,169
https://kawalpemilu.org#60997,"TANJUNG HARAPAN, GUNUNG PUREI, BARITO UTARA, KALIMANTAN TENGAH",1,42,9,51
https://kawalpemilu.org#60998,"LINON BESI I, GUNUNG PUREI, BARITO UTARA, KALIMANTAN TENGAH",1,58,48,106
https://kawalpemilu.org#60999,"LINON BESI II, GUNUNG PUREI, BARITO UTARA, KALIMANTAN TENGAH",1,28,22,50
https://kawalpemilu.org#61000,"MUARA MEA, GUNUNG PUREI, BARITO UTARA, KALIMANTAN TENGAH",1,118,58,176
https://kawalpemilu.org#61001,"LAWARANG, GUNUNG PUREI, BARITO UTARA, KALIMANTAN TENGAH",1,53,12,65
https://kawalpemilu.org#61002,"LAMPEONG I, GUNUNG PUREI, BARITO UTARA, KALIMANTAN TENGAH",1,111,53,164
https://kawalpemilu.org#61003,"LAMPEONG II, GUNUNG PUREI, BARITO UTARA, KALIMANTAN TENGAH",1,83,72,155
https://kawalpemilu.org#61003,"LAMPEONG II, GUNUNG PUREI, BARITO UTARA, KALIMANTAN TENGAH",2,35,64,99
https://kawalpemilu.org#61003,"LAMPEONG II, GUNUNG PUREI, BARITO UTARA, KALIMANTAN TENGAH",3,70,81,151
https://kawalpemilu.org#61004,"PAYANG, GUNUNG PUREI, BARITO UTARA, KALIMANTAN TENGAH",1,143,15,158
https://kawalpemilu.org#61005,"BERONG, GUNUNG PUREI, BARITO UTARA, KALIMANTAN TENGAH",1,122,25,147
https://kawalpemilu.org#61006,"BAOK, GUNUNG PUREI, BARITO UTARA, KALIMANTAN TENGAH",1,180,21,201
https://kawalpemilu.org#61007,"TAMBABA, GUNUNG PUREI, BARITO UTARA, KALIMANTAN TENGAH",1,124,38,162
https://kawalpemilu.org#61009,"SAMPIRANG I, TEWEH TIMUR, BARITO UTARA, KALIMANTAN TENGAH",1,112,44,156
https://kawalpemilu.org#61010,"SAMPIRANG II, TEWEH TIMUR, BARITO UTARA, KALIMANTAN TENGAH",1,42,92,134
https://kawalpemilu.org#61010,"SAMPIRANG II, TEWEH TIMUR, BARITO UTARA, KALIMANTAN TENGAH",2,19,72,91
https://kawalpemilu.org#61011,"LIJU, TEWEH TIMUR, BARITO UTARA, KALIMANTAN TENGAH",1,75,21,96
https://kawalpemilu.org#61012,"BENANGIN III, TEWEH TIMUR, BARITO UTARA, KALIMANTAN TENGAH",1,76,41,117
https://kawalpemilu.org#61013,"BENANGIN II, TEWEH TIMUR, BARITO UTARA, KALIMANTAN TENGAH",1,89,58,147
https://kawalpemilu.org#61013,"BENANGIN II, TEWEH TIMUR, BARITO UTARA, KALIMANTAN TENGAH",2,72,14,86
https://kawalpemilu.org#61013,"BENANGIN II, TEWEH TIMUR, BARITO UTARA, KALIMANTAN TENGAH",3,130,32,162
https://kawalpemilu.org#61014,"BENANGIN V, TEWEH TIMUR, BARITO UTARA, KALIMANTAN TENGAH",1,49,91,140
https://kawalpemilu.org#61014,"BENANGIN V, TEWEH TIMUR, BARITO UTARA, KALIMANTAN TENGAH",2,45,153,198
https://kawalpemilu.org#61014,"BENANGIN V, TEWEH TIMUR, BARITO UTARA, KALIMANTAN TENGAH",3,32,118,150
https://kawalpemilu.org#61015,"BENANGIN I, TEWEH TIMUR, BARITO UTARA, KALIMANTAN TENGAH",1,111,85,196
https://kawalpemilu.org#61015,"BENANGIN I, TEWEH TIMUR, BARITO UTARA, KALIMANTAN TENGAH",2,63,84,147
https://kawalpemilu.org#61015,"BENANGIN I, TEWEH TIMUR, BARITO UTARA, KALIMANTAN TENGAH",3,131,39,170
https://kawalpemilu.org#61015,"BENANGIN I, TEWEH TIMUR, BARITO UTARA, KALIMANTAN TENGAH",4,141,16,157
https://kawalpemilu.org#61016,"MUARA WAKAT, TEWEH TIMUR, BARITO UTARA, KALIMANTAN TENGAH",1,87,43,130
https://kawalpemilu.org#61016,"MUARA WAKAT, TEWEH TIMUR, BARITO UTARA, KALIMANTAN TENGAH",2,87,16,103
https://kawalpemilu.org#61020,"MAMPUAK I, TEWEH TIMUR, BARITO UTARA, KALIMANTAN TENGAH",1,121,44,165
https://kawalpemilu.org#61020,"MAMPUAK I, TEWEH TIMUR, BARITO UTARA, KALIMANTAN TENGAH",2,172,43,215
https://kawalpemilu.org#61021,"JAMUT, TEWEH TIMUR, BARITO UTARA, KALIMANTAN TENGAH",1,111,5,116
https://kawalpemilu.org#61021,"JAMUT, TEWEH TIMUR, BARITO UTARA, KALIMANTAN TENGAH",2,115,19,134
https://kawalpemilu.org#61022,"SEI LIJU, TEWEH TIMUR, BARITO UTARA, KALIMANTAN TENGAH",1,76,63,139
https://kawalpemilu.org#61022,"SEI LIJU, TEWEH TIMUR, BARITO UTARA, KALIMANTAN TENGAH",2,95,48,143
https://kawalpemilu.org#61023,"MAMPUAK II, TEWEH TIMUR, BARITO UTARA, KALIMANTAN TENGAH",1,114,20,134
https://kawalpemilu.org#61023,"MAMPUAK II, TEWEH TIMUR, BARITO UTARA, KALIMANTAN TENGAH",2,169,14,183
https://kawalpemilu.org#61027,"LANJAS, TEWEH TENGAH, BARITO UTARA, KALIMANTAN TENGAH",1,69,163,232
https://kawalpemilu.org#61027,"LANJAS, TEWEH TENGAH, BARITO UTARA, KALIMANTAN TENGAH",2,36,117,153
https://kawalpemilu.org#61027,"LANJAS, TEWEH TENGAH, BARITO UTARA, KALIMANTAN TENGAH",3,77,168,245
https://kawalpemilu.org#61027,"LANJAS, TEWEH TENGAH, BARITO UTARA, KALIMANTAN TENGAH",4,52,80,132
https://kawalpemilu.org#61027,"LANJAS, TEWEH TENGAH, BARITO UTARA, KALIMANTAN TENGAH",5,71,188,259
https://kawalpemilu.org#61027,"LANJAS, TEWEH TENGAH, BARITO UTARA, KALIMANTAN TENGAH",6,82,120,202
https://kawalpemilu.org#61027,"LANJAS, TEWEH TENGAH, BARITO UTARA, KALIMANTAN TENGAH",7,76,162,238
https://kawalpemilu.org#61027,"LANJAS, TEWEH TENGAH, BARITO UTARA, KALIMANTAN TENGAH",8,71,139,210
https://kawalpemilu.org#61027,"LANJAS, TEWEH TENGAH, BARITO UTARA, KALIMANTAN TENGAH",9,91,138,229
https://kawalpemilu.org#61027,"LANJAS, TEWEH TENGAH, BARITO UTARA, KALIMANTAN TENGAH",10,105,104,209
https://kawalpemilu.org#61027,"LANJAS, TEWEH TENGAH, BARITO UTARA, KALIMANTAN TENGAH",11,99,34,133
https://kawalpemilu.org#61027,"LANJAS, TEWEH TENGAH, BARITO UTARA, KALIMANTAN TENGAH",12,50,125,175
https://kawalpemilu.org#61027,"LANJAS, TEWEH TENGAH, BARITO UTARA, KALIMANTAN TENGAH",13,68,130,198
https://kawalpemilu.org#61027,"LANJAS, TEWEH TENGAH, BARITO UTARA, KALIMANTAN TENGAH",14,47,108,155
https://kawalpemilu.org#61027,"LANJAS, TEWEH TENGAH, BARITO UTARA, KALIMANTAN TENGAH",15,85,133,218
https://kawalpemilu.org#61027,"LANJAS, TEWEH TENGAH, BARITO UTARA, KALIMANTAN TENGAH",17,106,68,174
https://kawalpemilu.org#61027,"LANJAS, TEWEH TENGAH, BARITO UTARA, KALIMANTAN TENGAH",18,89,80,169
https://kawalpemilu.org#61027,"LANJAS, TEWEH TENGAH, BARITO UTARA, KALIMANTAN TENGAH",19,65,152,217
https://kawalpemilu.org#61027,"LANJAS, TEWEH TENGAH, BARITO UTARA, KALIMANTAN TENGAH",20,72,112,184
https://kawalpemilu.org#61027,"LANJAS, TEWEH TENGAH, BARITO UTARA, KALIMANTAN TENGAH",21,59,98,157
https://kawalpemilu.org#61027,"LANJAS, TEWEH TENGAH, BARITO UTARA, KALIMANTAN TENGAH",22,113,36,149
https://kawalpemilu.org#61027,"LANJAS, TEWEH TENGAH, BARITO UTARA, KALIMANTAN TENGAH",23,93,35,128
https://kawalpemilu.org#61027,"LANJAS, TEWEH TENGAH, BARITO UTARA, KALIMANTAN TENGAH",24,84,13,97
https://kawalpemilu.org#61027,"LANJAS, TEWEH TENGAH, BARITO UTARA, KALIMANTAN TENGAH",25,103,38,141
https://kawalpemilu.org#61027,"LANJAS, TEWEH TENGAH, BARITO UTARA, KALIMANTAN TENGAH",26,67,64,131
https://kawalpemilu.org#61027,"LANJAS, TEWEH TENGAH, BARITO UTARA, KALIMANTAN TENGAH",27,66,132,198
https://kawalpemilu.org#61027,"LANJAS, TEWEH TENGAH, BARITO UTARA, KALIMANTAN TENGAH",28,62,143,205
https://kawalpemilu.org#61027,"LANJAS, TEWEH TENGAH, BARITO UTARA, KALIMANTAN TENGAH",29,41,114,155
https://kawalpemilu.org#61027,"LANJAS, TEWEH TENGAH, BARITO UTARA, KALIMANTAN TENGAH",30,65,106,171
https://kawalpemilu.org#61027,"LANJAS, TEWEH TENGAH, BARITO UTARA, KALIMANTAN TENGAH",31,90,94,184
https://kawalpemilu.org#61027,"LANJAS, TEWEH TENGAH, BARITO UTARA, KALIMANTAN TENGAH",32,64,90,154
https://kawalpemilu.org#61027,"LANJAS, TEWEH TENGAH, BARITO UTARA, KALIMANTAN TENGAH",33,42,93,135
https://kawalpemilu.org#61027,"LANJAS, TEWEH TENGAH, BARITO UTARA, KALIMANTAN TENGAH",34,93,118,211
https://kawalpemilu.org#61027,"LANJAS, TEWEH TENGAH, BARITO UTARA, KALIMANTAN TENGAH",35,43,172,215
https://kawalpemilu.org#61027,"LANJAS, TEWEH TENGAH, BARITO UTARA, KALIMANTAN TENGAH",36,75,67,142
https://kawalpemilu.org#61027,"LANJAS, TEWEH TENGAH, BARITO UTARA, KALIMANTAN TENGAH",37,53,117,170
https://kawalpemilu.org#61027,"LANJAS, TEWEH TENGAH, BARITO UTARA, KALIMANTAN TENGAH",38,66,139,205
https://kawalpemilu.org#61027,"LANJAS, TEWEH TENGAH, BARITO UTARA, KALIMANTAN TENGAH",39,67,106,173
https://kawalpemilu.org#61027,"LANJAS, TEWEH TENGAH, BARITO UTARA, KALIMANTAN TENGAH",40,78,97,175
https://kawalpemilu.org#61027,"LANJAS, TEWEH TENGAH, BARITO UTARA, KALIMANTAN TENGAH",41,65,148,213
https://kawalpemilu.org#61027,"LANJAS, TEWEH TENGAH, BARITO UTARA, KALIMANTAN TENGAH",42,35,88,123
https://kawalpemilu.org#61027,"LANJAS, TEWEH TENGAH, BARITO UTARA, KALIMANTAN TENGAH",43,98,78,176
https://kawalpemilu.org#61027,"LANJAS, TEWEH TENGAH, BARITO UTARA, KALIMANTAN TENGAH",44,158,99,257
https://kawalpemilu.org#61027,"LANJAS, TEWEH TENGAH, BARITO UTARA, KALIMANTAN TENGAH",45,58,87,145
https://kawalpemilu.org#61027,"LANJAS, TEWEH TENGAH, BARITO UTARA, KALIMANTAN TENGAH",46,62,66,128
https://kawalpemilu.org#61027,"LANJAS, TEWEH TENGAH, BARITO UTARA, KALIMANTAN TENGAH",47,52,91,143
https://kawalpemilu.org#61027,"LANJAS, TEWEH TENGAH, BARITO UTARA, KALIMANTAN TENGAH",48,43,69,112
https://kawalpemilu.org#61027,"LANJAS, TEWEH TENGAH, BARITO UTARA, KALIMANTAN TENGAH",49,116,24,140
https://kawalpemilu.org#61027,"LANJAS, TEWEH TENGAH, BARITO UTARA, KALIMANTAN TENGAH",50,125,66,191
https://kawalpemilu.org#61027,"LANJAS, TEWEH TENGAH, BARITO UTARA, KALIMANTAN TENGAH",51,59,97,156
https://kawalpemilu.org#61027,"LANJAS, TEWEH TENGAH, BARITO UTARA, KALIMANTAN TENGAH",52,53,81,134
https://kawalpemilu.org#61027,"LANJAS, TEWEH TENGAH, BARITO UTARA, KALIMANTAN TENGAH",53,56,99,155
https://kawalpemilu.org#61027,"LANJAS, TEWEH TENGAH, BARITO UTARA, KALIMANTAN TENGAH",54,60,67,127
https://kawalpemilu.org#61027,"LANJAS, TEWEH TENGAH, BARITO UTARA, KALIMANTAN TENGAH",55,63,19,82
https://kawalpemilu.org#61027,"LANJAS, TEWEH TENGAH, BARITO UTARA, KALIMANTAN TENGAH",56,43,35,78
https://kawalpemilu.org#61027,"LANJAS, TEWEH TENGAH, BARITO UTARA, KALIMANTAN TENGAH",57,93,39,132
https://kawalpemilu.org#61027,"LANJAS, TEWEH TENGAH, BARITO UTARA, KALIMANTAN TENGAH",58,51,61,112
https://kawalpemilu.org#61028,"MELAYU, TEWEH TENGAH, BARITO UTARA, KALIMANTAN TENGAH",1,91,110,201
https://kawalpemilu.org#61028,"MELAYU, TEWEH TENGAH, BARITO UTARA, KALIMANTAN TENGAH",2,50,87,137
https://kawalpemilu.org#61028,"MELAYU, TEWEH TENGAH, BARITO UTARA, KALIMANTAN TENGAH",3,71,141,212
https://kawalpemilu.org#61028,"MELAYU, TEWEH TENGAH, BARITO UTARA, KALIMANTAN TENGAH",4,52,94,146
https://kawalpemilu.org#61028,"MELAYU, TEWEH TENGAH, BARITO UTARA, KALIMANTAN TENGAH",5,82,173,255
https://kawalpemilu.org#61028,"MELAYU, TEWEH TENGAH, BARITO UTARA, KALIMANTAN TENGAH",6,45,73,118
https://kawalpemilu.org#61028,"MELAYU, TEWEH TENGAH, BARITO UTARA, KALIMANTAN TENGAH",7,91,112,203
https://kawalpemilu.org#61028,"MELAYU, TEWEH TENGAH, BARITO UTARA, KALIMANTAN TENGAH",8,45,125,170
https://kawalpemilu.org#61028,"MELAYU, TEWEH TENGAH, BARITO UTARA, KALIMANTAN TENGAH",9,21,44,65
https://kawalpemilu.org#61028,"MELAYU, TEWEH TENGAH, BARITO UTARA, KALIMANTAN TENGAH",10,61,94,155
https://kawalpemilu.org#61028,"MELAYU, TEWEH TENGAH, BARITO UTARA, KALIMANTAN TENGAH",11,38,98,136
https://kawalpemilu.org#61028,"MELAYU, TEWEH TENGAH, BARITO UTARA, KALIMANTAN TENGAH",12,108,138,246
https://kawalpemilu.org#61028,"MELAYU, TEWEH TENGAH, BARITO UTARA, KALIMANTAN TENGAH",13,60,73,133
https://kawalpemilu.org#61028,"MELAYU, TEWEH TENGAH, BARITO UTARA, KALIMANTAN TENGAH",14,55,70,125
https://kawalpemilu.org#61028,"MELAYU, TEWEH TENGAH, BARITO UTARA, KALIMANTAN TENGAH",15,48,108,156
https://kawalpemilu.org#61028,"MELAYU, TEWEH TENGAH, BARITO UTARA, KALIMANTAN TENGAH",16,63,80,143
https://kawalpemilu.org#61028,"MELAYU, TEWEH TENGAH, BARITO UTARA, KALIMANTAN TENGAH",17,56,112,168
https://kawalpemilu.org#61028,"MELAYU, TEWEH TENGAH, BARITO UTARA, KALIMANTAN TENGAH",18,29,79,107
https://kawalpemilu.org#61028,"MELAYU, TEWEH TENGAH, BARITO UTARA, KALIMANTAN TENGAH",19,88,146,234
https://kawalpemilu.org#61028,"MELAYU, TEWEH TENGAH, BARITO UTARA, KALIMANTAN TENGAH",20,54,70,124
https://kawalpemilu.org#61028,"MELAYU, TEWEH TENGAH, BARITO UTARA, KALIMANTAN TENGAH",21,53,86,139
https://kawalpemilu.org#61028,"MELAYU, TEWEH TENGAH, BARITO UTARA, KALIMANTAN TENGAH",22,48,77,125
https://kawalpemilu.org#61028,"MELAYU, TEWEH TENGAH, BARITO UTARA, KALIMANTAN TENGAH",23,90,99,189
https://kawalpemilu.org#61028,"MELAYU, TEWEH TENGAH, BARITO UTARA, KALIMANTAN TENGAH",24,46,87,133
https://kawalpemilu.org#61028,"MELAYU, TEWEH TENGAH, BARITO UTARA, KALIMANTAN TENGAH",25,196,38,234
https://kawalpemilu.org#61028,"MELAYU, TEWEH TENGAH, BARITO UTARA, KALIMANTAN TENGAH",26,98,151,249
https://kawalpemilu.org#61028,"MELAYU, TEWEH TENGAH, BARITO UTARA, KALIMANTAN TENGAH",27,140,98,238
https://kawalpemilu.org#61028,"MELAYU, TEWEH TENGAH, BARITO UTARA, KALIMANTAN TENGAH",28,62,73,135
https://kawalpemilu.org#61028,"MELAYU, TEWEH TENGAH, BARITO UTARA, KALIMANTAN TENGAH",29,83,137,220
https://kawalpemilu.org#61028,"MELAYU, TEWEH TENGAH, BARITO UTARA, KALIMANTAN TENGAH",30,87,58,145
https://kawalpemilu.org#61028,"MELAYU, TEWEH TENGAH, BARITO UTARA, KALIMANTAN TENGAH",31,101,80,181
https://kawalpemilu.org#61028,"MELAYU, TEWEH TENGAH, BARITO UTARA, KALIMANTAN TENGAH",32,87,99,186
https://kawalpemilu.org#61028,"MELAYU, TEWEH TENGAH, BARITO UTARA, KALIMANTAN TENGAH",33,107,55,162
https://kawalpemilu.org#61028,"MELAYU, TEWEH TENGAH, BARITO UTARA, KALIMANTAN TENGAH",34,91,59,150
https://kawalpemilu.org#61028,"MELAYU, TEWEH TENGAH, BARITO UTARA, KALIMANTAN TENGAH",35,150,80,230
https://kawalpemilu.org#61028,"MELAYU, TEWEH TENGAH, BARITO UTARA, KALIMANTAN TENGAH",36,53,27,80
https://kawalpemilu.org#61028,"MELAYU, TEWEH TENGAH, BARITO UTARA, KALIMANTAN TENGAH",37,77,62,139
https://kawalpemilu.org#61028,"MELAYU, TEWEH TENGAH, BARITO UTARA, KALIMANTAN TENGAH",38,113,112,225
https://kawalpemilu.org#61028,"MELAYU, TEWEH TENGAH, BARITO UTARA, KALIMANTAN TENGAH",39,96,108,204
https://kawalpemilu.org#61028,"MELAYU, TEWEH TENGAH, BARITO UTARA, KALIMANTAN TENGAH",40,70,80,150
https://kawalpemilu.org#61028,"MELAYU, TEWEH TENGAH, BARITO UTARA, KALIMANTAN TENGAH",41,98,26,124
https://kawalpemilu.org#61028,"MELAYU, TEWEH TENGAH, BARITO UTARA, KALIMANTAN TENGAH",42,113,74,187
https://kawalpemilu.org#61028,"MELAYU, TEWEH TENGAH, BARITO UTARA, KALIMANTAN TENGAH",43,67,116,183
https://kawalpemilu.org#61028,"MELAYU, TEWEH TENGAH, BARITO UTARA, KALIMANTAN TENGAH",44,73,122,195
https://kawalpemilu.org#61028,"MELAYU, TEWEH TENGAH, BARITO UTARA, KALIMANTAN TENGAH",45,105,84,189
https://kawalpemilu.org#61028,"MELAYU, TEWEH TENGAH, BARITO UTARA, KALIMANTAN TENGAH",46,92,127,219
https://kawalpemilu.org#61028,"MELAYU, TEWEH TENGAH, BARITO UTARA, KALIMANTAN TENGAH",47,62,128,190
https://kawalpemilu.org#61028,"MELAYU, TEWEH TENGAH, BARITO UTARA, KALIMANTAN TENGAH",48,30,64,94
https://kawalpemilu.org#61028,"MELAYU, TEWEH TENGAH, BARITO UTARA, KALIMANTAN TENGAH",49,64,74,138
https://kawalpemilu.org#61028,"MELAYU, TEWEH TENGAH, BARITO UTARA, KALIMANTAN TENGAH",50,60,93,153
https://kawalpemilu.org#61028,"MELAYU, TEWEH TENGAH, BARITO UTARA, KALIMANTAN TENGAH",51,106,79,185
https://kawalpemilu.org#61028,"MELAYU, TEWEH TENGAH, BARITO UTARA, KALIMANTAN TENGAH",52,45,64,109
https://kawalpemilu.org#61028,"MELAYU, TEWEH TENGAH, BARITO UTARA, KALIMANTAN TENGAH",53,34,89,123
https://kawalpemilu.org#61028,"MELAYU, TEWEH TENGAH, BARITO UTARA, KALIMANTAN TENGAH",54,60,78,138
https://kawalpemilu.org#61028,"MELAYU, TEWEH TENGAH, BARITO UTARA, KALIMANTAN TENGAH",55,48,130,178
https://kawalpemilu.org#61028,"MELAYU, TEWEH TENGAH, BARITO UTARA, KALIMANTAN TENGAH",56,36,62,98
https://kawalpemilu.org#61028,"MELAYU, TEWEH TENGAH, BARITO UTARA, KALIMANTAN TENGAH",57,88,53,141
https://kawalpemilu.org#61028,"MELAYU, TEWEH TENGAH, BARITO UTARA, KALIMANTAN TENGAH",58,78,73,151
https://kawalpemilu.org#61028,"MELAYU, TEWEH TENGAH, BARITO UTARA, KALIMANTAN TENGAH",59,53,91,144
https://kawalpemilu.org#61028,"MELAYU, TEWEH TENGAH, BARITO UTARA, KALIMANTAN TENGAH",60,60,70,130
https://kawalpemilu.org#61028,"MELAYU, TEWEH TENGAH, BARITO UTARA, KALIMANTAN TENGAH",61,44,88,132
https://kawalpemilu.org#61028,"MELAYU, TEWEH TENGAH, BARITO UTARA, KALIMANTAN TENGAH",62,55,105,160
https://kawalpemilu.org#61028,"MELAYU, TEWEH TENGAH, BARITO UTARA, KALIMANTAN TENGAH",63,100,75,175
https://kawalpemilu.org#61028,"MELAYU, TEWEH TENGAH, BARITO UTARA, KALIMANTAN TENGAH",64,77,61,138
https://kawalpemilu.org#61028,"MELAYU, TEWEH TENGAH, BARITO UTARA, KALIMANTAN TENGAH",65,77,77,154
https://kawalpemilu.org#61028,"MELAYU, TEWEH TENGAH, BARITO UTARA, KALIMANTAN TENGAH",66,119,76,195
https://kawalpemilu.org#61028,"MELAYU, TEWEH TENGAH, BARITO UTARA, KALIMANTAN TENGAH",67,73,68,141
https://kawalpemilu.org#61028,"MELAYU, TEWEH TENGAH, BARITO UTARA, KALIMANTAN TENGAH",68,93,93,186
https://kawalpemilu.org#61028,"MELAYU, TEWEH TENGAH, BARITO UTARA, KALIMANTAN TENGAH",69,70,117,187
https://kawalpemilu.org#61028,"MELAYU, TEWEH TENGAH, BARITO UTARA, KALIMANTAN TENGAH",70,67,79,146
https://kawalpemilu.org#61028,"MELAYU, TEWEH TENGAH, BARITO UTARA, KALIMANTAN TENGAH",71,100,75,175
https://kawalpemilu.org#61028,"MELAYU, TEWEH TENGAH, BARITO UTARA, KALIMANTAN TENGAH",72,51,97,148
https://kawalpemilu.org#61028,"MELAYU, TEWEH TENGAH, BARITO UTARA, KALIMANTAN TENGAH",73,39,56,95
https://kawalpemilu.org#61028,"MELAYU, TEWEH TENGAH, BARITO UTARA, KALIMANTAN TENGAH",74,50,134,184
https://kawalpemilu.org#61028,"MELAYU, TEWEH TENGAH, BARITO UTARA, KALIMANTAN TENGAH",75,71,41,112
https://kawalpemilu.org#61028,"MELAYU, TEWEH TENGAH, BARITO UTARA, KALIMANTAN TENGAH",76,33,68,101
https://kawalpemilu.org#61036,"LEMO I, TEWEH TENGAH, BARITO UTARA, KALIMANTAN TENGAH",1,86,118,204
https://kawalpemilu.org#61036,"LEMO I, TEWEH TENGAH, BARITO UTARA, KALIMANTAN TENGAH",2,159,92,251
https://kawalpemilu.org#61036,"LEMO I, TEWEH TENGAH, BARITO UTARA, KALIMANTAN TENGAH",3,13,19,32
https://kawalpemilu.org#61036,"LEMO I, TEWEH TENGAH, BARITO UTARA, KALIMANTAN TENGAH",4,49,32,81
https://kawalpemilu.org#61036,"LEMO I, TEWEH TENGAH, BARITO UTARA, KALIMANTAN TENGAH",5,52,15,67
https://kawalpemilu.org#61036,"LEMO I, TEWEH TENGAH, BARITO UTARA, KALIMANTAN TENGAH",6,32,9,41
https://kawalpemilu.org#61036,"LEMO I, TEWEH TENGAH, BARITO UTARA, KALIMANTAN TENGAH",7,89,80,169
https://kawalpemilu.org#61036,"LEMO I, TEWEH TENGAH, BARITO UTARA, KALIMANTAN TENGAH",8,78,77,155
https://kawalpemilu.org#61037,"LEMO II, TEWEH TENGAH, BARITO UTARA, KALIMANTAN TENGAH",1,78,134,212
https://kawalpemilu.org#61037,"LEMO II, TEWEH TENGAH, BARITO UTARA, KALIMANTAN TENGAH",2,121,130,251
https://kawalpemilu.org#61037,"LEMO II, TEWEH TENGAH, BARITO UTARA, KALIMANTAN TENGAH",3,56,114,170
https://kawalpemilu.org#61037,"LEMO II, TEWEH TENGAH, BARITO UTARA, KALIMANTAN TENGAH",4,114,121,235
https://kawalpemilu.org#61037,"LEMO II, TEWEH TENGAH, BARITO UTARA, KALIMANTAN TENGAH",5,78,116,194
https://kawalpemilu.org#61037,"LEMO II, TEWEH TENGAH, BARITO UTARA, KALIMANTAN TENGAH",6,114,159,273
https://kawalpemilu.org#61037,"LEMO II, TEWEH TENGAH, BARITO UTARA, KALIMANTAN TENGAH",7,116,50,166
https://kawalpemilu.org#61037,"LEMO II, TEWEH TENGAH, BARITO UTARA, KALIMANTAN TENGAH",8,107,160,267
https://kawalpemilu.org#61038,"PENDREH, TEWEH TENGAH, BARITO UTARA, KALIMANTAN TENGAH",1,175,19,194
https://kawalpemilu.org#61038,"PENDREH, TEWEH TENGAH, BARITO UTARA, KALIMANTAN TENGAH",2,203,13,216
https://kawalpemilu.org#61038,"PENDREH, TEWEH TENGAH, BARITO UTARA, KALIMANTAN TENGAH",3,203,46,249
https://kawalpemilu.org#61038,"PENDREH, TEWEH TENGAH, BARITO UTARA, KALIMANTAN TENGAH",4,56,4,60
https://kawalpemilu.org#61038,"PENDREH, TEWEH TENGAH, BARITO UTARA, KALIMANTAN TENGAH",5,87,8,95
https://kawalpemilu.org#61038,"PENDREH, TEWEH TENGAH, BARITO UTARA, KALIMANTAN TENGAH",6,131,17,148
https://kawalpemilu.org#61038,"PENDREH, TEWEH TENGAH, BARITO UTARA, KALIMANTAN TENGAH",7,152,40,192
https://kawalpemilu.org#61041,"RIMBA SARI, TEWEH TENGAH, BARITO UTARA, KALIMANTAN TENGAH",1,208,45,253
https://kawalpemilu.org#61041,"RIMBA SARI, TEWEH TENGAH, BARITO UTARA, KALIMANTAN TENGAH",2,193,38,231
https://kawalpemilu.org#61041,"RIMBA SARI, TEWEH TENGAH, BARITO UTARA, KALIMANTAN TENGAH",3,167,40,207
https://kawalpemilu.org#61042,"SEI RAHAYU I, TEWEH TENGAH, BARITO UTARA, KALIMANTAN TENGAH",1,125,20,145
https://kawalpemilu.org#61042,"SEI RAHAYU I, TEWEH TENGAH, BARITO UTARA, KALIMANTAN TENGAH",2,127,41,168
https://kawalpemilu.org#61042,"SEI RAHAYU I, TEWEH TENGAH, BARITO UTARA, KALIMANTAN TENGAH",3,127,16,143
https://kawalpemilu.org#61046,"SEI RAHAYU II, TEWEH TENGAH, BARITO UTARA, KALIMANTAN TENGAH",1,66,44,110
https://kawalpemilu.org#61046,"SEI RAHAYU II, TEWEH TENGAH, BARITO UTARA, KALIMANTAN TENGAH",2,145,75,220
https://kawalpemilu.org#61046,"SEI RAHAYU II, TEWEH TENGAH, BARITO UTARA, KALIMANTAN TENGAH",3,109,88,197
https://kawalpemilu.org#61048,"BERINGIN RAYA, TEWEH TENGAH, BARITO UTARA, KALIMANTAN TENGAH",1,127,41,168
https://kawalpemilu.org#61049,"DATAI NIRUI, TEWEH TENGAH, BARITO UTARA, KALIMANTAN TENGAH",1,121,28,149
https://kawalpemilu.org#61053,"LAHEI I, LAHEI, BARITO UTARA, KALIMANTAN TENGAH",1,71,69,140
https://kawalpemilu.org#61053,"LAHEI I, LAHEI, BARITO UTARA, KALIMANTAN TENGAH",2,124,86,210
https://kawalpemilu.org#61053,"LAHEI I, LAHEI, BARITO UTARA, KALIMANTAN TENGAH",3,108,94,202
https://kawalpemilu.org#61053,"LAHEI I, LAHEI, BARITO UTARA, KALIMANTAN TENGAH",4,144,47,191
https://kawalpemilu.org#61054,"LAHEI II, LAHEI, BARITO UTARA, KALIMANTAN TENGAH",1,108,73,181
https://kawalpemilu.org#61054,"LAHEI II, LAHEI, BARITO UTARA, KALIMANTAN TENGAH",2,95,101,196
https://kawalpemilu.org#61054,"LAHEI II, LAHEI, BARITO UTARA, KALIMANTAN TENGAH",3,109,119,228
https://kawalpemilu.org#61054,"LAHEI II, LAHEI, BARITO UTARA, KALIMANTAN TENGAH",4,111,107,218
https://kawalpemilu.org#61054,"LAHEI II, LAHEI, BARITO UTARA, KALIMANTAN TENGAH",5,79,138,217
https://kawalpemilu.org#61054,"LAHEI II, LAHEI, BARITO UTARA, KALIMANTAN TENGAH",6,52,102,154
https://kawalpemilu.org#61054,"LAHEI II, LAHEI, BARITO UTARA, KALIMANTAN TENGAH",7,59,100,159
https://kawalpemilu.org#61054,"LAHEI II, LAHEI, BARITO UTARA, KALIMANTAN TENGAH",8,68,143,211
https://kawalpemilu.org#61054,"LAHEI II, LAHEI, BARITO UTARA, KALIMANTAN TENGAH",9,71,70,141
https://kawalpemilu.org#61054,"LAHEI II, LAHEI, BARITO UTARA, KALIMANTAN TENGAH",10,64,70,134
https://kawalpemilu.org#61055,"IPU, LAHEI, BARITO UTARA, KALIMANTAN TENGAH",1,145,31,176
https://kawalpemilu.org#61055,"IPU, LAHEI, BARITO UTARA, KALIMANTAN TENGAH",2,206,23,229
https://kawalpemilu.org#61055,"IPU, LAHEI, BARITO UTARA, KALIMANTAN TENGAH",3,109,24,133
https://kawalpemilu.org#61056,"MUKUT, LAHEI, BARITO UTARA, KALIMANTAN TENGAH",1,86,123,209
https://kawalpemilu.org#61056,"MUKUT, LAHEI, BARITO UTARA, KALIMANTAN TENGAH",3,115,55,170
https://kawalpemilu.org#61056,"MUKUT, LAHEI, BARITO UTARA, KALIMANTAN TENGAH",4,55,91,146
https://kawalpemilu.org#61068,"MUARA BAKAH, LAHEI, BARITO UTARA, KALIMANTAN TENGAH",1,41,48,89
https://kawalpemilu.org#61068,"MUARA BAKAH, LAHEI, BARITO UTARA, KALIMANTAN TENGAH",2,72,61,133
https://kawalpemilu.org#61069,"JUJU BARU, LAHEI, BARITO UTARA, KALIMANTAN TENGAH",1,115,11,126
https://kawalpemilu.org#61069,"JUJU BARU, LAHEI, BARITO UTARA, KALIMANTAN TENGAH",2,136,14,150
https://kawalpemilu.org#61069,"JUJU BARU, LAHEI, BARITO UTARA, KALIMANTAN TENGAH",3,207,20,227
https://kawalpemilu.org#61070,"MUARA INU, LAHEI, BARITO UTARA, KALIMANTAN TENGAH",1,92,66,158
https://kawalpemilu.org#61070,"MUARA INU, LAHEI, BARITO UTARA, KALIMANTAN TENGAH",2,123,61,184
https://kawalpemilu.org#61070,"MUARA INU, LAHEI, BARITO UTARA, KALIMANTAN TENGAH",3,89,79,168
https://kawalpemilu.org#61070,"MUARA INU, LAHEI, BARITO UTARA, KALIMANTAN TENGAH",4,108,24,132
https://kawalpemilu.org#61070,"MUARA INU, LAHEI, BARITO UTARA, KALIMANTAN TENGAH",5,96,0,96
https://kawalpemilu.org#61070,"MUARA INU, LAHEI, BARITO UTARA, KALIMANTAN TENGAH",6,100,55,155
https://kawalpemilu.org#61071,"BENGAHON, LAHEI, BARITO UTARA, KALIMANTAN TENGAH",1,104,22,126
https://kawalpemilu.org#61071,"BENGAHON, LAHEI, BARITO UTARA, KALIMANTAN TENGAH",2,35,1,36
https://kawalpemilu.org#61072,"RAHADEN, LAHEI, BARITO UTARA, KALIMANTAN TENGAH",1,65,48,113
https://kawalpemilu.org#61072,"RAHADEN, LAHEI, BARITO UTARA, KALIMANTAN TENGAH",2,74,40,114
https://kawalpemilu.org#61072,"RAHADEN, LAHEI, BARITO UTARA, KALIMANTAN TENGAH",3,46,64,110
https://kawalpemilu.org#61073,"MUARA PARI, LAHEI, BARITO UTARA, KALIMANTAN TENGAH",1,141,51,192
https://kawalpemilu.org#61073,"MUARA PARI, LAHEI, BARITO UTARA, KALIMANTAN TENGAH",2,76,71,147
https://kawalpemilu.org#61074,"HARAGANDANG, LAHEI, BARITO UTARA, KALIMANTAN TENGAH",1,116,67,183
https://kawalpemilu.org#61074,"HARAGANDANG, LAHEI, BARITO UTARA, KALIMANTAN TENGAH",2,81,70,151
https://kawalpemilu.org#61075,"KARENDAN, LAHEI, BARITO UTARA, KALIMANTAN TENGAH",1,187,57,244
https://kawalpemilu.org#61075,"KARENDAN, LAHEI, BARITO UTARA, KALIMANTAN TENGAH",2,206,71,277
https://kawalpemilu.org#61076,"HURUNG ENEP, LAHEI, BARITO UTARA, KALIMANTAN TENGAH",1,97,14,93
https://kawalpemilu.org#61076,"HURUNG ENEP, LAHEI, BARITO UTARA, KALIMANTAN TENGAH",2,99,39,138
https://kawalpemilu.org#61076,"HURUNG ENEP, LAHEI, BARITO UTARA, KALIMANTAN TENGAH",3,42,21,63
https://kawalpemilu.org#61017,"LIANG BUAH, TEWEH BARU, BARITO UTARA, KALIMANTAN TENGAH",1,102,21,123
https://kawalpemilu.org#61017,"LIANG BUAH, TEWEH BARU, BARITO UTARA, KALIMANTAN TENGAH",2,120,15,135
https://kawalpemilu.org#61018,"PANAEN, TEWEH BARU, BARITO UTARA, KALIMANTAN TENGAH",1,116,23,139
https://kawalpemilu.org#61018,"PANAEN, TEWEH BARU, BARITO UTARA, KALIMANTAN TENGAH",2,140,14,154
https://kawalpemilu.org#61019,"GANDRING, TEWEH BARU, BARITO UTARA, KALIMANTAN TENGAH",1,74,54,128
https://kawalpemilu.org#61019,"GANDRING, TEWEH BARU, BARITO UTARA, KALIMANTAN TENGAH",2,88,52,140
https://kawalpemilu.org#61025,"JAMBU, TEWEH BARU, BARITO UTARA, KALIMANTAN TENGAH",1,47,115,162
https://kawalpemilu.org#61025,"JAMBU, TEWEH BARU, BARITO UTARA, KALIMANTAN TENGAH",2,119,117,236
https://kawalpemilu.org#61025,"JAMBU, TEWEH BARU, BARITO UTARA, KALIMANTAN TENGAH",3,97,120,217
https://kawalpemilu.org#61025,"JAMBU, TEWEH BARU, BARITO UTARA, KALIMANTAN TENGAH",4,45,98,143
https://kawalpemilu.org#61025,"JAMBU, TEWEH BARU, BARITO UTARA, KALIMANTAN TENGAH",5,111,108,219
https://kawalpemilu.org#61025,"JAMBU, TEWEH BARU, BARITO UTARA, KALIMANTAN TENGAH",6,65,148,213
https://kawalpemilu.org#61025,"JAMBU, TEWEH BARU, BARITO UTARA, KALIMANTAN TENGAH",7,46,59,105
https://kawalpemilu.org#61025,"JAMBU, TEWEH BARU, BARITO UTARA, KALIMANTAN TENGAH",8,13,16,29
https://kawalpemilu.org#61025,"JAMBU, TEWEH BARU, BARITO UTARA, KALIMANTAN TENGAH",9,51,165,216
https://kawalpemilu.org#61025,"JAMBU, TEWEH BARU, BARITO UTARA, KALIMANTAN TENGAH",10,43,104,147
https://kawalpemilu.org#61025,"JAMBU, TEWEH BARU, BARITO UTARA, KALIMANTAN TENGAH",11,86,108,194
https://kawalpemilu.org#61025,"JAMBU, TEWEH BARU, BARITO UTARA, KALIMANTAN TENGAH",12,52,116,168
https://kawalpemilu.org#61026,"JINGAH, TEWEH BARU, BARITO UTARA, KALIMANTAN TENGAH",1,104,115,219
https://kawalpemilu.org#61026,"JINGAH, TEWEH BARU, BARITO UTARA, KALIMANTAN TENGAH",2,133,42,175
https://kawalpemilu.org#61026,"JINGAH, TEWEH BARU, BARITO UTARA, KALIMANTAN TENGAH",3,70,47,117
https://kawalpemilu.org#61026,"JINGAH, TEWEH BARU, BARITO UTARA, KALIMANTAN TENGAH",4,91,94,185
https://kawalpemilu.org#61026,"JINGAH, TEWEH BARU, BARITO UTARA, KALIMANTAN TENGAH",5,100,59,159
https://kawalpemilu.org#61026,"JINGAH, TEWEH BARU, BARITO UTARA, KALIMANTAN TENGAH",6,110,94,204
https://kawalpemilu.org#61026,"JINGAH, TEWEH BARU, BARITO UTARA, KALIMANTAN TENGAH",7,91,123,214
https://kawalpemilu.org#61026,"JINGAH, TEWEH BARU, BARITO UTARA, KALIMANTAN TENGAH",8,95,126,221
https://kawalpemilu.org#61026,"JINGAH, TEWEH BARU, BARITO UTARA, KALIMANTAN TENGAH",9,109,127,236
https://kawalpemilu.org#61026,"JINGAH, TEWEH BARU, BARITO UTARA, KALIMANTAN TENGAH",10,93,87,180
https://kawalpemilu.org#61026,"JINGAH, TEWEH BARU, BARITO UTARA, KALIMANTAN TENGAH",11,56,42,98
https://kawalpemilu.org#61026,"JINGAH, TEWEH BARU, BARITO UTARA, KALIMANTAN TENGAH",12,62,59,121
https://kawalpemilu.org#61026,"JINGAH, TEWEH BARU, BARITO UTARA, KALIMANTAN TENGAH",13,102,115,217
https://kawalpemilu.org#61026,"JINGAH, TEWEH BARU, BARITO UTARA, KALIMANTAN TENGAH",14,57,32,89
https://kawalpemilu.org#61033,"HAJAK, TEWEH BARU, BARITO UTARA, KALIMANTAN TENGAH",2,125,15,144
https://kawalpemilu.org#61033,"HAJAK, TEWEH BARU, BARITO UTARA, KALIMANTAN TENGAH",3,166,39,205
https://kawalpemilu.org#61033,"HAJAK, TEWEH BARU, BARITO UTARA, KALIMANTAN TENGAH",4,138,13,4
https://kawalpemilu.org#61033,"HAJAK, TEWEH BARU, BARITO UTARA, KALIMANTAN TENGAH",5,133,22,155
https://kawalpemilu.org#61033,"HAJAK, TEWEH BARU, BARITO UTARA, KALIMANTAN TENGAH",6,71,10,81
https://kawalpemilu.org#61033,"HAJAK, TEWEH BARU, BARITO UTARA, KALIMANTAN TENGAH",7,124,22,146
https://kawalpemilu.org#61033,"HAJAK, TEWEH BARU, BARITO UTARA, KALIMANTAN TENGAH",8,109,32,141
https://kawalpemilu.org#61033,"HAJAK, TEWEH BARU, BARITO UTARA, KALIMANTAN TENGAH",9,195,16,211
https://kawalpemilu.org#61033,"HAJAK, TEWEH BARU, BARITO UTARA, KALIMANTAN TENGAH",10,137,29,166
https://kawalpemilu.org#61033,"HAJAK, TEWEH BARU, BARITO UTARA, KALIMANTAN TENGAH",11,102,16,112
https://kawalpemilu.org#61034,"LIANG NAGA, TEWEH BARU, BARITO UTARA, KALIMANTAN TENGAH",1,128,115,243
https://kawalpemilu.org#61034,"LIANG NAGA, TEWEH BARU, BARITO UTARA, KALIMANTAN TENGAH",2,43,146,189
https://kawalpemilu.org#61035,"SABUH, TEWEH BARU, BARITO UTARA, KALIMANTAN TENGAH",1,133,57,190
https://kawalpemilu.org#61035,"SABUH, TEWEH BARU, BARITO UTARA, KALIMANTAN TENGAH",2,101,51,152
https://kawalpemilu.org#61035,"SABUH, TEWEH BARU, BARITO UTARA, KALIMANTAN TENGAH",3,42,24,66
https://kawalpemilu.org#61035,"SABUH, TEWEH BARU, BARITO UTARA, KALIMANTAN TENGAH",4,111,45,156
https://kawalpemilu.org#61035,"SABUH, TEWEH BARU, BARITO UTARA, KALIMANTAN TENGAH",5,79,70,149
https://kawalpemilu.org#61039,"MALAWAKEN, TEWEH BARU, BARITO UTARA, KALIMANTAN TENGAH",1,70,31,101
https://kawalpemilu.org#61039,"MALAWAKEN, TEWEH BARU, BARITO UTARA, KALIMANTAN TENGAH",2,140,69,209
https://kawalpemilu.org#61039,"MALAWAKEN, TEWEH BARU, BARITO UTARA, KALIMANTAN TENGAH",3,109,21,130
https://kawalpemilu.org#61039,"MALAWAKEN, TEWEH BARU, BARITO UTARA, KALIMANTAN TENGAH",4,122,82,204
https://kawalpemilu.org#61039,"MALAWAKEN, TEWEH BARU, BARITO UTARA, KALIMANTAN TENGAH",5,103,34,137
https://kawalpemilu.org#61039,"MALAWAKEN, TEWEH BARU, BARITO UTARA, KALIMANTAN TENGAH",6,115,73,188
https://kawalpemilu.org#61039,"MALAWAKEN, TEWEH BARU, BARITO UTARA, KALIMANTAN TENGAH",7,164,22,186
https://kawalpemilu.org#61050,"SIKUI, TEWEH BARU, BARITO UTARA, KALIMANTAN TENGAH",1,109,66,175
https://kawalpemilu.org#61050,"SIKUI, TEWEH BARU, BARITO UTARA, KALIMANTAN TENGAH",2,71,70,141
https://kawalpemilu.org#61050,"SIKUI, TEWEH BARU, BARITO UTARA, KALIMANTAN TENGAH",3,101,58,159
https://kawalpemilu.org#61050,"SIKUI, TEWEH BARU, BARITO UTARA, KALIMANTAN TENGAH",4,160,44,204
https://kawalpemilu.org#61050,"SIKUI, TEWEH BARU, BARITO UTARA, KALIMANTAN TENGAH",5,36,25,61
https://kawalpemilu.org#61050,"SIKUI, TEWEH BARU, BARITO UTARA, KALIMANTAN TENGAH",6,91,88,179
https://kawalpemilu.org#61050,"SIKUI, TEWEH BARU, BARITO UTARA, KALIMANTAN TENGAH",7,164,54,218
https://kawalpemilu.org#61029,"BUNTOK BARU, TEWEH SELATAN, BARITO UTARA, KALIMANTAN TENGAH",1,92,89,181
https://kawalpemilu.org#61029,"BUNTOK BARU, TEWEH SELATAN, BARITO UTARA, KALIMANTAN TENGAH",2,92,61,153
https://kawalpemilu.org#61029,"BUNTOK BARU, TEWEH SELATAN, BARITO UTARA, KALIMANTAN TENGAH",3,95,54,149
https://kawalpemilu.org#61030,"BUTONG, TEWEH SELATAN, BARITO UTARA, KALIMANTAN TENGAH",1,122,16,138
https://kawalpemilu.org#61030,"BUTONG, TEWEH SELATAN, BARITO UTARA, KALIMANTAN TENGAH",2,177,39,216
https://kawalpemilu.org#61030,"BUTONG, TEWEH SELATAN, BARITO UTARA, KALIMANTAN TENGAH",3,67,19,86
https://kawalpemilu.org#61030,"BUTONG, TEWEH SELATAN, BARITO UTARA, KALIMANTAN TENGAH",4,101,17,118
https://kawalpemilu.org#61030,"BUTONG, TEWEH SELATAN, BARITO UTARA, KALIMANTAN TENGAH",5,175,23,198
https://kawalpemilu.org#61040,"BUKIT SAWIT, TEWEH SELATAN, BARITO UTARA, KALIMANTAN TENGAH",1,139,12,151
https://kawalpemilu.org#61040,"BUKIT SAWIT, TEWEH SELATAN, BARITO UTARA, KALIMANTAN TENGAH",2,185,8,193
https://kawalpemilu.org#61040,"BUKIT SAWIT, TEWEH SELATAN, BARITO UTARA, KALIMANTAN TENGAH",3,164,3,167
https://kawalpemilu.org#61040,"BUKIT SAWIT, TEWEH SELATAN, BARITO UTARA, KALIMANTAN TENGAH",4,133,29,162
https://kawalpemilu.org#61040,"BUKIT SAWIT, TEWEH SELATAN, BARITO UTARA, KALIMANTAN TENGAH",5,159,35,194
https://kawalpemilu.org#61040,"BUKIT SAWIT, TEWEH SELATAN, BARITO UTARA, KALIMANTAN TENGAH",6,118,100,218
https://kawalpemilu.org#61040,"BUKIT SAWIT, TEWEH SELATAN, BARITO UTARA, KALIMANTAN TENGAH",7,157,46,203
https://kawalpemilu.org#61040,"BUKIT SAWIT, TEWEH SELATAN, BARITO UTARA, KALIMANTAN TENGAH",8,92,17,109
https://kawalpemilu.org#61040,"BUKIT SAWIT, TEWEH SELATAN, BARITO UTARA, KALIMANTAN TENGAH",9,103,23,126
https://kawalpemilu.org#61040,"BUKIT SAWIT, TEWEH SELATAN, BARITO UTARA, KALIMANTAN TENGAH",10,53,15,68
https://kawalpemilu.org#61040,"BUKIT SAWIT, TEWEH SELATAN, BARITO UTARA, KALIMANTAN TENGAH",11,102,39,141
https://kawalpemilu.org#61040,"BUKIT SAWIT, TEWEH SELATAN, BARITO UTARA, KALIMANTAN TENGAH",12,31,13,44
https://kawalpemilu.org#61043,"TAWAN JAYA, TEWEH SELATAN, BARITO UTARA, KALIMANTAN TENGAH",1,235,24,259
https://kawalpemilu.org#61043,"TAWAN JAYA, TEWEH SELATAN, BARITO UTARA, KALIMANTAN TENGAH",2,162,42,204
https://kawalpemilu.org#61043,"TAWAN JAYA, TEWEH SELATAN, BARITO UTARA, KALIMANTAN TENGAH",3,164,44,208
https://kawalpemilu.org#61044,"PANDRAN PERMAI, TEWEH SELATAN, BARITO UTARA, KALIMANTAN TENGAH",1,155,44,199
https://kawalpemilu.org#61044,"PANDRAN PERMAI, TEWEH SELATAN, BARITO UTARA, KALIMANTAN TENGAH",2,161,19,180
https://kawalpemilu.org#61045,"TRAHEAN, TEWEH SELATAN, BARITO UTARA, KALIMANTAN TENGAH",1,190,50,240
https://kawalpemilu.org#61045,"TRAHEAN, TEWEH SELATAN, BARITO UTARA, KALIMANTAN TENGAH",2,155,45,200
https://kawalpemilu.org#61045,"TRAHEAN, TEWEH SELATAN, BARITO UTARA, KALIMANTAN TENGAH",3,145,54,199
https://kawalpemilu.org#61047,"PANDRAN RAYA, TEWEH SELATAN, BARITO UTARA, KALIMANTAN TENGAH",1,133,30,163
https://kawalpemilu.org#61047,"PANDRAN RAYA, TEWEH SELATAN, BARITO UTARA, KALIMANTAN TENGAH",2,74,25,99
https://kawalpemilu.org#61047,"PANDRAN RAYA, TEWEH SELATAN, BARITO UTARA, KALIMANTAN TENGAH",3,89,41,130
https://kawalpemilu.org#61047,"PANDRAN RAYA, TEWEH SELATAN, BARITO UTARA, KALIMANTAN TENGAH",4,123,48,171
https://kawalpemilu.org#61047,"PANDRAN RAYA, TEWEH SELATAN, BARITO UTARA, KALIMANTAN TENGAH",5,169,35,204
https://kawalpemilu.org#61051,"TRINSING, TEWEH SELATAN, BARITO UTARA, KALIMANTAN TENGAH",1,141,35,176
https://kawalpemilu.org#61051,"TRINSING, TEWEH SELATAN, BARITO UTARA, KALIMANTAN TENGAH",2,128,34,162
https://kawalpemilu.org#61051,"TRINSING, TEWEH SELATAN, BARITO UTARA, KALIMANTAN TENGAH",3,173,43,216
https://kawalpemilu.org#61051,"TRINSING, TEWEH SELATAN, BARITO UTARA, KALIMANTAN TENGAH",4,128,117,245
https://kawalpemilu.org#85384,"BINTANG NINGGI SATU, TEWEH SELATAN, BARITO UTARA, KALIMANTAN TENGAH",1,84,73,157
https://kawalpemilu.org#85384,"BINTANG NINGGI SATU, TEWEH SELATAN, BARITO UTARA, KALIMANTAN TENGAH",2,104,58,162
https://kawalpemilu.org#85384,"BINTANG NINGGI SATU, TEWEH SELATAN, BARITO UTARA, KALIMANTAN TENGAH",3,124,40,164
https://kawalpemilu.org#85384,"BINTANG NINGGI SATU, TEWEH SELATAN, BARITO UTARA, KALIMANTAN TENGAH",4,143,79,222
https://kawalpemilu.org#85384,"BINTANG NINGGI SATU, TEWEH SELATAN, BARITO UTARA, KALIMANTAN TENGAH",5,149,75,224
https://kawalpemilu.org#85385,"BINTANG NINGGI DUA, TEWEH SELATAN, BARITO UTARA, KALIMANTAN TENGAH",1,87,143,230
https://kawalpemilu.org#85385,"BINTANG NINGGI DUA, TEWEH SELATAN, BARITO UTARA, KALIMANTAN TENGAH",2,101,153,254
https://kawalpemilu.org#85385,"BINTANG NINGGI DUA, TEWEH SELATAN, BARITO UTARA, KALIMANTAN TENGAH",3,116,130,246
https://kawalpemilu.org#61057,"NIHAN HILIR, LAHEI BARAT, BARITO UTARA, KALIMANTAN TENGAH",1,86,20,106
https://kawalpemilu.org#61057,"NIHAN HILIR, LAHEI BARAT, BARITO UTARA, KALIMANTAN TENGAH",2,126,36,162
https://kawalpemilu.org#61057,"NIHAN HILIR, LAHEI BARAT, BARITO UTARA, KALIMANTAN TENGAH",3,96,77,173
https://kawalpemilu.org#61057,"NIHAN HILIR, LAHEI BARAT, BARITO UTARA, KALIMANTAN TENGAH",4,68,121,189
https://kawalpemilu.org#61057,"NIHAN HILIR, LAHEI BARAT, BARITO UTARA, KALIMANTAN TENGAH",5,97,111,208
https://kawalpemilu.org#61057,"NIHAN HILIR, LAHEI BARAT, BARITO UTARA, KALIMANTAN TENGAH",6,111,93,204
https://kawalpemilu.org#61058,"KARAMUAN, LAHEI BARAT, BARITO UTARA, KALIMANTAN TENGAH",1,95,82,177
https://kawalpemilu.org#61058,"KARAMUAN, LAHEI BARAT, BARITO UTARA, KALIMANTAN TENGAH",2,134,40,174
https://kawalpemilu.org#61058,"KARAMUAN, LAHEI BARAT, BARITO UTARA, KALIMANTAN TENGAH",3,144,28,172
https://kawalpemilu.org#61059,"BENAO HULU, LAHEI BARAT, BARITO UTARA, KALIMANTAN TENGAH",1,71,102,173
https://kawalpemilu.org#61059,"BENAO HULU, LAHEI BARAT, BARITO UTARA, KALIMANTAN TENGAH",2,59,116,175
https://kawalpemilu.org#61059,"BENAO HULU, LAHEI BARAT, BARITO UTARA, KALIMANTAN TENGAH",3,82,108,190
https://kawalpemilu.org#61060,"BENAO HILIR, LAHEI BARAT, BARITO UTARA, KALIMANTAN TENGAH",1,57,126,183
https://kawalpemilu.org#61060,"BENAO HILIR, LAHEI BARAT, BARITO UTARA, KALIMANTAN TENGAH",2,88,68,156
https://kawalpemilu.org#61060,"BENAO HILIR, LAHEI BARAT, BARITO UTARA, KALIMANTAN TENGAH",3,103,52,155
https://kawalpemilu.org#61060,"BENAO HILIR, LAHEI BARAT, BARITO UTARA, KALIMANTAN TENGAH",4,72,96,168
https://kawalpemilu.org#61062,"PAPAR PUJUNG, LAHEI BARAT, BARITO UTARA, KALIMANTAN TENGAH",1,67,108,175
https://kawalpemilu.org#61062,"PAPAR PUJUNG, LAHEI BARAT, BARITO UTARA, KALIMANTAN TENGAH",2,74,66,140
https://kawalpemilu.org#61062,"PAPAR PUJUNG, LAHEI BARAT, BARITO UTARA, KALIMANTAN TENGAH",3,31,158,189
https://kawalpemilu.org#61063,"JANGKANG LAMA, LAHEI BARAT, BARITO UTARA, KALIMANTAN TENGAH",1,19,67,86
https://kawalpemilu.org#61064,"NIHAN HULU, LAHEI BARAT, BARITO UTARA, KALIMANTAN TENGAH",1,6,163,169
https://kawalpemilu.org#61065,"JANGKANG BARU, LAHEI BARAT, BARITO UTARA, KALIMANTAN TENGAH",1,71,159,230
https://kawalpemilu.org#61065,"JANGKANG BARU, LAHEI BARAT, BARITO UTARA, KALIMANTAN TENGAH",2,57,118,175
https://kawalpemilu.org#61065,"JANGKANG BARU, LAHEI BARAT, BARITO UTARA, KALIMANTAN TENGAH",3,34,158,192
https://kawalpemilu.org#61066,"LUWE HULU, LAHEI BARAT, BARITO UTARA, KALIMANTAN TENGAH",1,160,78,238
https://kawalpemilu.org#61066,"LUWE HULU, LAHEI BARAT, BARITO UTARA, KALIMANTAN TENGAH",2,146,76,225
https://kawalpemilu.org#61066,"LUWE HULU, LAHEI BARAT, BARITO UTARA, KALIMANTAN TENGAH",3,122,77,199
https://kawalpemilu.org#61066,"LUWE HULU, LAHEI BARAT, BARITO UTARA, KALIMANTAN TENGAH",4,121,72,193
https://kawalpemilu.org#61067,"LUWE HILIR, LAHEI BARAT, BARITO UTARA, KALIMANTAN TENGAH",1,146,51,197
https://kawalpemilu.org#61067,"LUWE HILIR, LAHEI BARAT, BARITO UTARA, KALIMANTAN TENGAH",2,70,21,91
https://kawalpemilu.org#85386,"TELUKMALEWAI, LAHEI BARAT, BARITO UTARA, KALIMANTAN TENGAH",1,107,39,146
https://kawalpemilu.org#85386,"TELUKMALEWAI, LAHEI BARAT, BARITO UTARA, KALIMANTAN TENGAH",2,110,24,134
https://kawalpemilu.org#85386,"TELUKMALEWAI, LAHEI BARAT, BARITO UTARA, KALIMANTAN TENGAH",3,97,53,150
https://kawalpemilu.org#61079,"GALINGGANG, KAMIPANG, KATINGAN, KALIMANTAN TENGAH",1,138,67,205
https://kawalpemilu.org#61079,"GALINGGANG, KAMIPANG, KATINGAN, KALIMANTAN TENGAH",2,109,98,207
https://kawalpemilu.org#61079,"GALINGGANG, KAMIPANG, KATINGAN, KALIMANTAN TENGAH",3,98,53,151
https://kawalpemilu.org#61079,"GALINGGANG, KAMIPANG, KATINGAN, KALIMANTAN TENGAH",4,68,6,74
https://kawalpemilu.org#61079,"GALINGGANG, KAMIPANG, KATINGAN, KALIMANTAN TENGAH",5,75,5,80
https://kawalpemilu.org#61080,"TAMPELAS, KAMIPANG, KATINGAN, KALIMANTAN TENGAH",1,81,58,139
https://kawalpemilu.org#61080,"TAMPELAS, KAMIPANG, KATINGAN, KALIMANTAN TENGAH",2,36,19,55
https://kawalpemilu.org#61081,"TELAGA, KAMIPANG, KATINGAN, KALIMANTAN TENGAH",1,175,29,204
https://kawalpemilu.org#61081,"TELAGA, KAMIPANG, KATINGAN, KALIMANTAN TENGAH",2,134,50,184
https://kawalpemilu.org#61081,"TELAGA, KAMIPANG, KATINGAN, KALIMANTAN TENGAH",3,169,28,197
https://kawalpemilu.org#61081,"TELAGA, KAMIPANG, KATINGAN, KALIMANTAN TENGAH",4,91,16,107
https://kawalpemilu.org#61082,"PARUPUK, KAMIPANG, KATINGAN, KALIMANTAN TENGAH",1,32,35,67
https://kawalpemilu.org#61083,"KARUING, KAMIPANG, KATINGAN, KALIMANTAN TENGAH",1,166,28,194
https://kawalpemilu.org#61083,"KARUING, KAMIPANG, KATINGAN, KALIMANTAN TENGAH",2,89,22,111
https://kawalpemilu.org#61084,"JAHANJANG, KAMIPANG, KATINGAN, KALIMANTAN TENGAH",1,168,64,232
https://kawalpemilu.org#61084,"JAHANJANG, KAMIPANG, KATINGAN, KALIMANTAN TENGAH",2,143,66,209
https://kawalpemilu.org#61085,"TUMBANG RUNEN, KAMIPANG, KATINGAN, KALIMANTAN TENGAH",1,137,70,207
https://kawalpemilu.org#61085,"TUMBANG RUNEN, KAMIPANG, KATINGAN, KALIMANTAN TENGAH",2,57,26,83
https://kawalpemilu.org#61085,"TUMBANG RUNEN, KAMIPANG, KATINGAN, KALIMANTAN TENGAH",3,43,6,49
https://kawalpemilu.org#61086,"BAUN BANGO, KAMIPANG, KATINGAN, KALIMANTAN TENGAH",1,124,107,231
https://kawalpemilu.org#61086,"BAUN BANGO, KAMIPANG, KATINGAN, KALIMANTAN TENGAH",2,209,58,267
https://kawalpemilu.org#61087,"ASEM KUMBANG, KAMIPANG, KATINGAN, KALIMANTAN TENGAH",1,218,27,245
https://kawalpemilu.org#61087,"ASEM KUMBANG, KAMIPANG, KATINGAN, KALIMANTAN TENGAH",2,202,42,244
https://kawalpemilu.org#61087,"ASEM KUMBANG, KAMIPANG, KATINGAN, KALIMANTAN TENGAH",3,216,29,245
https://kawalpemilu.org#61087,"ASEM KUMBANG, KAMIPANG, KATINGAN, KALIMANTAN TENGAH",4,105,15,120
https://kawalpemilu.org#61089,"KASONGAN BARU, KATINGAN HILIR, KATINGAN, KALIMANTAN TENGAH",1,197,31,228
https://kawalpemilu.org#61089,"KASONGAN BARU, KATINGAN HILIR, KATINGAN, KALIMANTAN TENGAH",2,148,52,200
https://kawalpemilu.org#61089,"KASONGAN BARU, KATINGAN HILIR, KATINGAN, KALIMANTAN TENGAH",3,184,36,220
https://kawalpemilu.org#61089,"KASONGAN BARU, KATINGAN HILIR, KATINGAN, KALIMANTAN TENGAH",4,177,33,210
https://kawalpemilu.org#61089,"KASONGAN BARU, KATINGAN HILIR, KATINGAN, KALIMANTAN TENGAH",5,150,44,194
https://kawalpemilu.org#61089,"KASONGAN BARU, KATINGAN HILIR, KATINGAN, KALIMANTAN TENGAH",6,147,52,199
https://kawalpemilu.org#61089,"KASONGAN BARU, KATINGAN HILIR, KATINGAN, KALIMANTAN TENGAH",7,102,50,152
https://kawalpemilu.org#61089,"KASONGAN BARU, KATINGAN HILIR, KATINGAN, KALIMANTAN TENGAH",8,173,33,206
https://kawalpemilu.org#61089,"KASONGAN BARU, KATINGAN HILIR, KATINGAN, KALIMANTAN TENGAH",10,187,42,229
https://kawalpemilu.org#61090,"KASONGAN LAMA, KATINGAN HILIR, KATINGAN, KALIMANTAN TENGAH",1,101,107,208
https://kawalpemilu.org#61090,"KASONGAN LAMA, KATINGAN HILIR, KATINGAN, KALIMANTAN TENGAH",2,84,130,214
https://kawalpemilu.org#61090,"KASONGAN LAMA, KATINGAN HILIR, KATINGAN, KALIMANTAN TENGAH",3,79,151,230
https://kawalpemilu.org#61090,"KASONGAN LAMA, KATINGAN HILIR, KATINGAN, KALIMANTAN TENGAH",4,67,164,231
https://kawalpemilu.org#61090,"KASONGAN LAMA, KATINGAN HILIR, KATINGAN, KALIMANTAN TENGAH",5,47,141,188
https://kawalpemilu.org#61090,"KASONGAN LAMA, KATINGAN HILIR, KATINGAN, KALIMANTAN TENGAH",6,95,80,175
https://kawalpemilu.org#61090,"KASONGAN LAMA, KATINGAN HILIR, KATINGAN, KALIMANTAN TENGAH",7,91,64,155
https://kawalpemilu.org#61090,"KASONGAN LAMA, KATINGAN HILIR, KATINGAN, KALIMANTAN TENGAH",8,111,114,225
https://kawalpemilu.org#61090,"KASONGAN LAMA, KATINGAN HILIR, KATINGAN, KALIMANTAN TENGAH",9,111,73,184
https://kawalpemilu.org#61090,"KASONGAN LAMA, KATINGAN HILIR, KATINGAN, KALIMANTAN TENGAH",10,92,95,187
https://kawalpemilu.org#61090,"KASONGAN LAMA, KATINGAN HILIR, KATINGAN, KALIMANTAN TENGAH",11,89,112,201
https://kawalpemilu.org#61090,"KASONGAN LAMA, KATINGAN HILIR, KATINGAN, KALIMANTAN TENGAH",12,72,88,160
https://kawalpemilu.org#61090,"KASONGAN LAMA, KATINGAN HILIR, KATINGAN, KALIMANTAN TENGAH",13,121,73,191
https://kawalpemilu.org#61090,"KASONGAN LAMA, KATINGAN HILIR, KATINGAN, KALIMANTAN TENGAH",14,79,71,150
https://kawalpemilu.org#61090,"KASONGAN LAMA, KATINGAN HILIR, KATINGAN, KALIMANTAN TENGAH",15,78,98,170
https://kawalpemilu.org#61090,"KASONGAN LAMA, KATINGAN HILIR, KATINGAN, KALIMANTAN TENGAH",16,111,118,229
https://kawalpemilu.org#61090,"KASONGAN LAMA, KATINGAN HILIR, KATINGAN, KALIMANTAN TENGAH",17,117,123,240
https://kawalpemilu.org#61090,"KASONGAN LAMA, KATINGAN HILIR, KATINGAN, KALIMANTAN TENGAH",19,81,91,172
https://kawalpemilu.org#61090,"KASONGAN LAMA, KATINGAN HILIR, KATINGAN, KALIMANTAN TENGAH",20,162,93,255
https://kawalpemilu.org#61090,"KASONGAN LAMA, KATINGAN HILIR, KATINGAN, KALIMANTAN TENGAH",21,142,95,237
https://kawalpemilu.org#61090,"KASONGAN LAMA, KATINGAN HILIR, KATINGAN, KALIMANTAN TENGAH",22,151,101,252
https://kawalpemilu.org#61090,"KASONGAN LAMA, KATINGAN HILIR, KATINGAN, KALIMANTAN TENGAH",23,136,95,231
https://kawalpemilu.org#61090,"KASONGAN LAMA, KATINGAN HILIR, KATINGAN, KALIMANTAN TENGAH",24,128,59,187
https://kawalpemilu.org#61090,"KASONGAN LAMA, KATINGAN HILIR, KATINGAN, KALIMANTAN TENGAH",25,122,81,203
https://kawalpemilu.org#61090,"KASONGAN LAMA, KATINGAN HILIR, KATINGAN, KALIMANTAN TENGAH",26,91,78,169
https://kawalpemilu.org#61090,"KASONGAN LAMA, KATINGAN HILIR, KATINGAN, KALIMANTAN TENGAH",27,168,96,264
https://kawalpemilu.org#61090,"KASONGAN LAMA, KATINGAN HILIR, KATINGAN, KALIMANTAN TENGAH",28,189,97,288
https://kawalpemilu.org#61090,"KASONGAN LAMA, KATINGAN HILIR, KATINGAN, KALIMANTAN TENGAH",29,200,56,256
https://kawalpemilu.org#61090,"KASONGAN LAMA, KATINGAN HILIR, KATINGAN, KALIMANTAN TENGAH",30,212,76,288
https://kawalpemilu.org#61090,"KASONGAN LAMA, KATINGAN HILIR, KATINGAN, KALIMANTAN TENGAH",33,91,31,122
https://kawalpemilu.org#61090,"KASONGAN LAMA, KATINGAN HILIR, KATINGAN, KALIMANTAN TENGAH",34,97,33,130
https://kawalpemilu.org#61090,"KASONGAN LAMA, KATINGAN HILIR, KATINGAN, KALIMANTAN TENGAH",35,100,26,0
https://kawalpemilu.org#61090,"KASONGAN LAMA, KATINGAN HILIR, KATINGAN, KALIMANTAN TENGAH",36,37,74,111
https://kawalpemilu.org#61091,"TEWANG KADAMBA, KATINGAN HILIR, KATINGAN, KALIMANTAN TENGAH",1,162,15,177
https://kawalpemilu.org#61091,"TEWANG KADAMBA, KATINGAN HILIR, KATINGAN, KALIMANTAN TENGAH",2,157,29,186
https://kawalpemilu.org#61092,"TUMBANG LITING, KATINGAN HILIR, KATINGAN, KALIMANTAN TENGAH",1,161,30,191
https://kawalpemilu.org#61092,"TUMBANG LITING, KATINGAN HILIR, KATINGAN, KALIMANTAN TENGAH",2,143,17,160
https://kawalpemilu.org#61092,"TUMBANG LITING, KATINGAN HILIR, KATINGAN, KALIMANTAN TENGAH",3,107,41,148
https://kawalpemilu.org#61092,"TUMBANG LITING, KATINGAN HILIR, KATINGAN, KALIMANTAN TENGAH",4,123,15,138
https://kawalpemilu.org#61093,"TALIAN KERENG, KATINGAN HILIR, KATINGAN, KALIMANTAN TENGAH",1,223,24,247
https://kawalpemilu.org#61093,"TALIAN KERENG, KATINGAN HILIR, KATINGAN, KALIMANTAN TENGAH",2,192,22,214
https://kawalpemilu.org#61093,"TALIAN KERENG, KATINGAN HILIR, KATINGAN, KALIMANTAN TENGAH",3,237,13,250
https://kawalpemilu.org#61093,"TALIAN KERENG, KATINGAN HILIR, KATINGAN, KALIMANTAN TENGAH",5,191,28,219
https://kawalpemilu.org#61094,"BANUT KALANAMAN, KATINGAN HILIR, KATINGAN, KALIMANTAN TENGAH",1,149,47,196
https://kawalpemilu.org#61094,"BANUT KALANAMAN, KATINGAN HILIR, KATINGAN, KALIMANTAN TENGAH",2,147,42,189
https://kawalpemilu.org#61094,"BANUT KALANAMAN, KATINGAN HILIR, KATINGAN, KALIMANTAN TENGAH",3,167,26,193
https://kawalpemilu.org#61095,"TALANGKAH, KATINGAN HILIR, KATINGAN, KALIMANTAN TENGAH",1,205,39,244
https://kawalpemilu.org#61095,"TALANGKAH, KATINGAN HILIR, KATINGAN, KALIMANTAN TENGAH",2,211,24,235
https://kawalpemilu.org#61095,"TALANGKAH, KATINGAN HILIR, KATINGAN, KALIMANTAN TENGAH",4,176,43,219
https://kawalpemilu.org#61095,"TALANGKAH, KATINGAN HILIR, KATINGAN, KALIMANTAN TENGAH",5,180,53,233
https://kawalpemilu.org#61095,"TALANGKAH, KATINGAN HILIR, KATINGAN, KALIMANTAN TENGAH",6,128,28,156
https://kawalpemilu.org#61095,"TALANGKAH, KATINGAN HILIR, KATINGAN, KALIMANTAN TENGAH",7,124,24,148
https://kawalpemilu.org#61095,"TALANGKAH, KATINGAN HILIR, KATINGAN, KALIMANTAN TENGAH",8,87,32,119
https://kawalpemilu.org#61096,"HAMPALIT, KATINGAN HILIR, KATINGAN, KALIMANTAN TENGAH",1,206,26,232
https://kawalpemilu.org#61096,"HAMPALIT, KATINGAN HILIR, KATINGAN, KALIMANTAN TENGAH",2,171,27,198
https://kawalpemilu.org#61096,"HAMPALIT, KATINGAN HILIR, KATINGAN, KALIMANTAN TENGAH",3,206,54,260
https://kawalpemilu.org#61096,"HAMPALIT, KATINGAN HILIR, KATINGAN, KALIMANTAN TENGAH",4,158,54,212
https://kawalpemilu.org#61096,"HAMPALIT, KATINGAN HILIR, KATINGAN, KALIMANTAN TENGAH",5,155,59,214
https://kawalpemilu.org#61096,"HAMPALIT, KATINGAN HILIR, KATINGAN, KALIMANTAN TENGAH",6,82,24,106
https://kawalpemilu.org#61096,"HAMPALIT, KATINGAN HILIR, KATINGAN, KALIMANTAN TENGAH",7,155,81,236
https://kawalpemilu.org#61096,"HAMPALIT, KATINGAN HILIR, KATINGAN, KALIMANTAN TENGAH",8,89,65,154
https://kawalpemilu.org#61096,"HAMPALIT, KATINGAN HILIR, KATINGAN, KALIMANTAN TENGAH",9,113,51,164
https://kawalpemilu.org#61096,"HAMPALIT, KATINGAN HILIR, KATINGAN, KALIMANTAN TENGAH",10,99,69,168
https://kawalpemilu.org#61096,"HAMPALIT, KATINGAN HILIR, KATINGAN, KALIMANTAN TENGAH",11,177,81,258
https://kawalpemilu.org#61096,"HAMPALIT, KATINGAN HILIR, KATINGAN, KALIMANTAN TENGAH",12,144,94,238
https://kawalpemilu.org#61096,"HAMPALIT, KATINGAN HILIR, KATINGAN, KALIMANTAN TENGAH",13,128,64,192
https://kawalpemilu.org#61096,"HAMPALIT, KATINGAN HILIR, KATINGAN, KALIMANTAN TENGAH",14,138,65,203
https://kawalpemilu.org#61096,"HAMPALIT, KATINGAN HILIR, KATINGAN, KALIMANTAN TENGAH",15,87,53,140
https://kawalpemilu.org#61096,"HAMPALIT, KATINGAN HILIR, KATINGAN, KALIMANTAN TENGAH",16,75,29,104
https://kawalpemilu.org#61096,"HAMPALIT, KATINGAN HILIR, KATINGAN, KALIMANTAN TENGAH",17,92,37,129
https://kawalpemilu.org#61096,"HAMPALIT, KATINGAN HILIR, KATINGAN, KALIMANTAN TENGAH",18,119,72,191
https://kawalpemilu.org#61096,"HAMPALIT, KATINGAN HILIR, KATINGAN, KALIMANTAN TENGAH",19,103,99,202
https://kawalpemilu.org#61096,"HAMPALIT, KATINGAN HILIR, KATINGAN, KALIMANTAN TENGAH",20,110,77,187
https://kawalpemilu.org#61096,"HAMPALIT, KATINGAN HILIR, KATINGAN, KALIMANTAN TENGAH",21,63,46,109
https://kawalpemilu.org#61096,"HAMPALIT, KATINGAN HILIR, KATINGAN, KALIMANTAN TENGAH",22,78,144,222
https://kawalpemilu.org#61096,"HAMPALIT, KATINGAN HILIR, KATINGAN, KALIMANTAN TENGAH",23,81,77,158
https://kawalpemilu.org#61096,"HAMPALIT, KATINGAN HILIR, KATINGAN, KALIMANTAN TENGAH",24,143,44,187
https://kawalpemilu.org#61096,"HAMPALIT, KATINGAN HILIR, KATINGAN, KALIMANTAN TENGAH",25,76,81,157
https://kawalpemilu.org#61096,"HAMPALIT, KATINGAN HILIR, KATINGAN, KALIMANTAN TENGAH",26,46,46,92
https://kawalpemilu.org#61096,"HAMPALIT, KATINGAN HILIR, KATINGAN, KALIMANTAN TENGAH",27,132,56,188
https://kawalpemilu.org#61096,"HAMPALIT, KATINGAN HILIR, KATINGAN, KALIMANTAN TENGAH",28,139,33,172
https://kawalpemilu.org#61096,"HAMPALIT, KATINGAN HILIR, KATINGAN, KALIMANTAN TENGAH",29,84,20,104
https://kawalpemilu.org#61096,"HAMPALIT, KATINGAN HILIR, KATINGAN, KALIMANTAN TENGAH",30,137,20,157
https://kawalpemilu.org#61096,"HAMPALIT, KATINGAN HILIR, KATINGAN, KALIMANTAN TENGAH",31,93,13,106
https://kawalpemilu.org#61096,"HAMPALIT, KATINGAN HILIR, KATINGAN, KALIMANTAN TENGAH",32,204,36,240
https://kawalpemilu.org#61096,"HAMPALIT, KATINGAN HILIR, KATINGAN, KALIMANTAN TENGAH",33,139,60,199
https://kawalpemilu.org#61096,"HAMPALIT, KATINGAN HILIR, KATINGAN, KALIMANTAN TENGAH",34,73,24,97
https://kawalpemilu.org#61096,"HAMPALIT, KATINGAN HILIR, KATINGAN, KALIMANTAN TENGAH",35,80,36,116
https://kawalpemilu.org#61096,"HAMPALIT, KATINGAN HILIR, KATINGAN, KALIMANTAN TENGAH",36,157,45,202
https://kawalpemilu.org#61096,"HAMPALIT, KATINGAN HILIR, KATINGAN, KALIMANTAN TENGAH",37,158,72,230
https://kawalpemilu.org#61096,"HAMPALIT, KATINGAN HILIR, KATINGAN, KALIMANTAN TENGAH",38,20,20,40
https://kawalpemilu.org#61098,"TEWANG BERINGIN, TEWANG SANGALANG GARING, KATINGAN, KALIMANTAN TENGAH",1,158,34,192
https://kawalpemilu.org#61098,"TEWANG BERINGIN, TEWANG SANGALANG GARING, KATINGAN, KALIMANTAN TENGAH",2,180,22,202
https://kawalpemilu.org#61098,"TEWANG BERINGIN, TEWANG SANGALANG GARING, KATINGAN, KALIMANTAN TENGAH",3,176,36,212
https://kawalpemilu.org#61098,"TEWANG BERINGIN, TEWANG SANGALANG GARING, KATINGAN, KALIMANTAN TENGAH",4,204,11,215
https://kawalpemilu.org#61099,"HAPALAM, TEWANG SANGALANG GARING, KATINGAN, KALIMANTAN TENGAH",1,176,39,215
https://kawalpemilu.org#61099,"HAPALAM, TEWANG SANGALANG GARING, KATINGAN, KALIMANTAN TENGAH",2,202,38,240
https://kawalpemilu.org#61100,"PENDAHARA, TEWANG SANGALANG GARING, KATINGAN, KALIMANTAN TENGAH",2,203,32,235
https://kawalpemilu.org#61100,"PENDAHARA, TEWANG SANGALANG GARING, KATINGAN, KALIMANTAN TENGAH",3,192,42,234
https://kawalpemilu.org#61100,"PENDAHARA, TEWANG SANGALANG GARING, KATINGAN, KALIMANTAN TENGAH",4,203,31,234
https://kawalpemilu.org#61100,"PENDAHARA, TEWANG SANGALANG GARING, KATINGAN, KALIMANTAN TENGAH",5,214,19,233
https://kawalpemilu.org#61100,"PENDAHARA, TEWANG SANGALANG GARING, KATINGAN, KALIMANTAN TENGAH",6,196,27,6
https://kawalpemilu.org#61100,"PENDAHARA, TEWANG SANGALANG GARING, KATINGAN, KALIMANTAN TENGAH",7,219,12,231
https://kawalpemilu.org#61100,"PENDAHARA, TEWANG SANGALANG GARING, KATINGAN, KALIMANTAN TENGAH",8,210,20,230
https://kawalpemilu.org#61100,"PENDAHARA, TEWANG SANGALANG GARING, KATINGAN, KALIMANTAN TENGAH",9,200,24,224
https://kawalpemilu.org#61101,"TEWANG RANGAS, TEWANG SANGALANG GARING, KATINGAN, KALIMANTAN TENGAH",1,123,7,130
https://kawalpemilu.org#61101,"TEWANG RANGAS, TEWANG SANGALANG GARING, KATINGAN, KALIMANTAN TENGAH",2,136,3,139
https://kawalpemilu.org#61102,"BANGKUANG, TEWANG SANGALANG GARING, KATINGAN, KALIMANTAN TENGAH",1,152,12,164
https://kawalpemilu.org#61102,"BANGKUANG, TEWANG SANGALANG GARING, KATINGAN, KALIMANTAN TENGAH",2,153,15,168
https://kawalpemilu.org#61102,"BANGKUANG, TEWANG SANGALANG GARING, KATINGAN, KALIMANTAN TENGAH",3,193,84,277
https://kawalpemilu.org#61102,"BANGKUANG, TEWANG SANGALANG GARING, KATINGAN, KALIMANTAN TENGAH",4,90,10,100
https://kawalpemilu.org#61102,"BANGKUANG, TEWANG SANGALANG GARING, KATINGAN, KALIMANTAN TENGAH",5,19,11,30
https://kawalpemilu.org#61103,"TARUSAN DANUM, TEWANG SANGALANG GARING, KATINGAN, KALIMANTAN TENGAH",1,196,35,231
https://kawalpemilu.org#61103,"TARUSAN DANUM, TEWANG SANGALANG GARING, KATINGAN, KALIMANTAN TENGAH",2,211,37,248
https://kawalpemilu.org#61104,"TUMBANG TARUSAN, TEWANG SANGALANG GARING, KATINGAN, KALIMANTAN TENGAH",1,206,18,224
https://kawalpemilu.org#61104,"TUMBANG TARUSAN, TEWANG SANGALANG GARING, KATINGAN, KALIMANTAN TENGAH",2,203,18,221
https://kawalpemilu.org#61105,"TEWANG RANGKANG, TEWANG SANGALANG GARING, KATINGAN, KALIMANTAN TENGAH",1,184,18,202
https://kawalpemilu.org#61105,"TEWANG RANGKANG, TEWANG SANGALANG GARING, KATINGAN, KALIMANTAN TENGAH",2,204,21,225
https://kawalpemilu.org#61105,"TEWANG RANGKANG, TEWANG SANGALANG GARING, KATINGAN, KALIMANTAN TENGAH",3,174,18,192
https://kawalpemilu.org#61106,"TEWANG MANYANGEN, TEWANG SANGALANG GARING, KATINGAN, KALIMANTAN TENGAH",1,249,15,264
https://kawalpemilu.org#61106,"TEWANG MANYANGEN, TEWANG SANGALANG GARING, KATINGAN, KALIMANTAN TENGAH",2,222,20,242
https://kawalpemilu.org#61107,"KARYA UNGGANG, TEWANG SANGALANG GARING, KATINGAN, KALIMANTAN TENGAH",1,124,40,164
https://kawalpemilu.org#61107,"KARYA UNGGANG, TEWANG SANGALANG GARING, KATINGAN, KALIMANTAN TENGAH",2,119,76,195
https://kawalpemilu.org#61107,"KARYA UNGGANG, TEWANG SANGALANG GARING, KATINGAN, KALIMANTAN TENGAH",3,104,74,178
https://kawalpemilu.org#61109,"TEWANG PAPARI, PULAU MALAN, KATINGAN, KALIMANTAN TENGAH",1,140,91,231
https://kawalpemilu.org#61110,"TEWANG DERAYU, PULAU MALAN, KATINGAN, KALIMANTAN TENGAH",1,133,22,155
https://kawalpemilu.org#61110,"TEWANG DERAYU, PULAU MALAN, KATINGAN, KALIMANTAN TENGAH",2,150,27,177
https://kawalpemilu.org#61111,"BUNTUT BALI, PULAU MALAN, KATINGAN, KALIMANTAN TENGAH",1,118,57,175
https://kawalpemilu.org#61111,"BUNTUT BALI, PULAU MALAN, KATINGAN, KALIMANTAN TENGAH",2,139,37,176
https://kawalpemilu.org#61111,"BUNTUT BALI, PULAU MALAN, KATINGAN, KALIMANTAN TENGAH",3,145,25,170
https://kawalpemilu.org#61111,"BUNTUT BALI, PULAU MALAN, KATINGAN, KALIMANTAN TENGAH",4,126,19,145
https://kawalpemilu.org#61111,"BUNTUT BALI, PULAU MALAN, KATINGAN, KALIMANTAN TENGAH",5,165,24,189
https://kawalpemilu.org#61111,"BUNTUT BALI, PULAU MALAN, KATINGAN, KALIMANTAN TENGAH",6,198,20,218
https://kawalpemilu.org#61112,"KULUK BALI, PULAU MALAN, KATINGAN, KALIMANTAN TENGAH",1,176,45,221
https://kawalpemilu.org#61113,"MANDUING TAHETA, PULAU MALAN, KATINGAN, KALIMANTAN TENGAH",1,134,36,170
https://kawalpemilu.org#61113,"MANDUING TAHETA, PULAU MALAN, KATINGAN, KALIMANTAN TENGAH",2,140,54,194
https://kawalpemilu.org#61114,"MANDUING LAMA, PULAU MALAN, KATINGAN, KALIMANTAN TENGAH",1,192,54,246
https://kawalpemilu.org#61115,"TUMBANG BANJANG, PULAU MALAN, KATINGAN, KALIMANTAN TENGAH",1,162,15,177
https://kawalpemilu.org#61115,"TUMBANG BANJANG, PULAU MALAN, KATINGAN, KALIMANTAN TENGAH",2,165,17,182
https://kawalpemilu.org#61116,"TUMBANG LAWANG, PULAU MALAN, KATINGAN, KALIMANTAN TENGAH",1,205,22,227
https://kawalpemilu.org#61117,"DAHIAN TUNGGAL, PULAU MALAN, KATINGAN, KALIMANTAN TENGAH",1,181,18,199
https://kawalpemilu.org#61117,"DAHIAN TUNGGAL, PULAU MALAN, KATINGAN, KALIMANTAN TENGAH",2,96,102,198
https://kawalpemilu.org#61117,"DAHIAN TUNGGAL, PULAU MALAN, KATINGAN, KALIMANTAN TENGAH",3,132,69,201
https://kawalpemilu.org#61117,"DAHIAN TUNGGAL, PULAU MALAN, KATINGAN, KALIMANTAN TENGAH",4,165,64,229
https://kawalpemilu.org#61117,"DAHIAN TUNGGAL, PULAU MALAN, KATINGAN, KALIMANTAN TENGAH",5,189,40,229
https://kawalpemilu.org#61118,"TEWANG KARANGAN, PULAU MALAN, KATINGAN, KALIMANTAN TENGAH",1,168,11,179
https://kawalpemilu.org#61118,"TEWANG KARANGAN, PULAU MALAN, KATINGAN, KALIMANTAN TENGAH",2,167,9,176
https://kawalpemilu.org#61119,"TUMBANG TUNGKU, PULAU MALAN, KATINGAN, KALIMANTAN TENGAH",1,186,40,226
https://kawalpemilu.org#61119,"TUMBANG TUNGKU, PULAU MALAN, KATINGAN, KALIMANTAN TENGAH",2,165,61,226
https://kawalpemilu.org#61120,"GARAGU, PULAU MALAN, KATINGAN, KALIMANTAN TENGAH",1,220,11,231
https://kawalpemilu.org#61121,"TUMBANG TANJUNG, PULAU MALAN, KATINGAN, KALIMANTAN TENGAH",2,159,13,172
https://kawalpemilu.org#61121,"TUMBANG TANJUNG, PULAU MALAN, KATINGAN, KALIMANTAN TENGAH",3,78,11,89
https://kawalpemilu.org#61122,"TURA, PULAU MALAN, KATINGAN, KALIMANTAN TENGAH",1,128,6,134
https://kawalpemilu.org#61122,"TURA, PULAU MALAN, KATINGAN, KALIMANTAN TENGAH",2,142,5,147
https://kawalpemilu.org#61124,"SAMBA KAHAYAN, KATINGAN TENGAH, KATINGAN, KALIMANTAN TENGAH",1,69,147,216
https://kawalpemilu.org#61124,"SAMBA KAHAYAN, KATINGAN TENGAH, KATINGAN, KALIMANTAN TENGAH",2,64,120,184
https://kawalpemilu.org#61124,"SAMBA KAHAYAN, KATINGAN TENGAH, KATINGAN, KALIMANTAN TENGAH",3,145,85,230
https://kawalpemilu.org#61124,"SAMBA KAHAYAN, KATINGAN TENGAH, KATINGAN, KALIMANTAN TENGAH",4,111,69,180
https://kawalpemilu.org#61124,"SAMBA KAHAYAN, KATINGAN TENGAH, KATINGAN, KALIMANTAN TENGAH",5,102,86,188
https://kawalpemilu.org#61124,"SAMBA KAHAYAN, KATINGAN TENGAH, KATINGAN, KALIMANTAN TENGAH",6,121,96,217
https://kawalpemilu.org#61124,"SAMBA KAHAYAN, KATINGAN TENGAH, KATINGAN, KALIMANTAN TENGAH",7,92,110,202
https://kawalpemilu.org#61124,"SAMBA KAHAYAN, KATINGAN TENGAH, KATINGAN, KALIMANTAN TENGAH",8,50,68,118
https://kawalpemilu.org#61125,"TUMBANG LAHANG, KATINGAN TENGAH, KATINGAN, KALIMANTAN TENGAH",1,181,9,190
https://kawalpemilu.org#61125,"TUMBANG LAHANG, KATINGAN TENGAH, KATINGAN, KALIMANTAN TENGAH",2,195,14,209
https://kawalpemilu.org#61125,"TUMBANG LAHANG, KATINGAN TENGAH, KATINGAN, KALIMANTAN TENGAH",3,187,16,203
https://kawalpemilu.org#61125,"TUMBANG LAHANG, KATINGAN TENGAH, KATINGAN, KALIMANTAN TENGAH",4,213,17,230
https://kawalpemilu.org#61126,"TEWANG PANJANG, KATINGAN TENGAH, KATINGAN, KALIMANTAN TENGAH",1,163,2,165
https://kawalpemilu.org#61127,"PETAK PUTI, KATINGAN TENGAH, KATINGAN, KALIMANTAN TENGAH",1,145,12,157
https://kawalpemilu.org#61128,"TELOK, KATINGAN TENGAH, KATINGAN, KALIMANTAN TENGAH",1,216,5,221
https://kawalpemilu.org#61128,"TELOK, KATINGAN TENGAH, KATINGAN, KALIMANTAN TENGAH",2,231,6,237
https://kawalpemilu.org#61128,"TELOK, KATINGAN TENGAH, KATINGAN, KALIMANTAN TENGAH",3,199,9,208
https://kawalpemilu.org#61128,"TELOK, KATINGAN TENGAH, KATINGAN, KALIMANTAN TENGAH",4,221,20,241
https://kawalpemilu.org#61129,"SAMBA DANUM, KATINGAN TENGAH, KATINGAN, KALIMANTAN TENGAH",1,99,78,177
https://kawalpemilu.org#61129,"SAMBA DANUM, KATINGAN TENGAH, KATINGAN, KALIMANTAN TENGAH",2,96,61,157
https://kawalpemilu.org#61129,"SAMBA DANUM, KATINGAN TENGAH, KATINGAN, KALIMANTAN TENGAH",3,119,58,177
https://kawalpemilu.org#61129,"SAMBA DANUM, KATINGAN TENGAH, KATINGAN, KALIMANTAN TENGAH",4,178,38,216
https://kawalpemilu.org#61129,"SAMBA DANUM, KATINGAN TENGAH, KATINGAN, KALIMANTAN TENGAH",5,198,37,235
https://kawalpemilu.org#61129,"SAMBA DANUM, KATINGAN TENGAH, KATINGAN, KALIMANTAN TENGAH",6,176,55,231
https://kawalpemilu.org#61129,"SAMBA DANUM, KATINGAN TENGAH, KATINGAN, KALIMANTAN TENGAH",7,113,84,197
https://kawalpemilu.org#61129,"SAMBA DANUM, KATINGAN TENGAH, KATINGAN, KALIMANTAN TENGAH",8,95,92,187
https://kawalpemilu.org#61129,"SAMBA DANUM, KATINGAN TENGAH, KATINGAN, KALIMANTAN TENGAH",9,153,108,261
https://kawalpemilu.org#61129,"SAMBA DANUM, KATINGAN TENGAH, KATINGAN, KALIMANTAN TENGAH",10,93,107,200
https://kawalpemilu.org#61129,"SAMBA DANUM, KATINGAN TENGAH, KATINGAN, KALIMANTAN TENGAH",11,127,93,220
https://kawalpemilu.org#61129,"SAMBA DANUM, KATINGAN TENGAH, KATINGAN, KALIMANTAN TENGAH",12,156,93,249
https://kawalpemilu.org#61130,"SAMBA BAKUMPAI, KATINGAN TENGAH, KATINGAN, KALIMANTAN TENGAH",1,160,99,259
https://kawalpemilu.org#61130,"SAMBA BAKUMPAI, KATINGAN TENGAH, KATINGAN, KALIMANTAN TENGAH",2,132,104,236
https://kawalpemilu.org#61130,"SAMBA BAKUMPAI, KATINGAN TENGAH, KATINGAN, KALIMANTAN TENGAH",3,92,134,226
https://kawalpemilu.org#61130,"SAMBA BAKUMPAI, KATINGAN TENGAH, KATINGAN, KALIMANTAN TENGAH",4,96,73,169
https://kawalpemilu.org#61130,"SAMBA BAKUMPAI, KATINGAN TENGAH, KATINGAN, KALIMANTAN TENGAH",5,117,72,189
https://kawalpemilu.org#61131,"SAMBA KATUNG, KATINGAN TENGAH, KATINGAN, KALIMANTAN TENGAH",1,178,89,267
https://kawalpemilu.org#61131,"SAMBA KATUNG, KATINGAN TENGAH, KATINGAN, KALIMANTAN TENGAH",2,186,69,255
https://kawalpemilu.org#61131,"SAMBA KATUNG, KATINGAN TENGAH, KATINGAN, KALIMANTAN TENGAH",3,175,51,226
https://kawalpemilu.org#61131,"SAMBA KATUNG, KATINGAN TENGAH, KATINGAN, KALIMANTAN TENGAH",4,194,58,252
https://kawalpemilu.org#61131,"SAMBA KATUNG, KATINGAN TENGAH, KATINGAN, KALIMANTAN TENGAH",5,190,80,270
https://kawalpemilu.org#61131,"SAMBA KATUNG, KATINGAN TENGAH, KATINGAN, KALIMANTAN TENGAH",6,179,74,253
https://kawalpemilu.org#61131,"SAMBA KATUNG, KATINGAN TENGAH, KATINGAN, KALIMANTAN TENGAH",7,181,47,228
https://kawalpemilu.org#61132,"NAPU SAHUR, KATINGAN TENGAH, KATINGAN, KALIMANTAN TENGAH",1,40,72,112
https://kawalpemilu.org#61132,"NAPU SAHUR, KATINGAN TENGAH, KATINGAN, KALIMANTAN TENGAH",2,53,96,149
https://kawalpemilu.org#61133,"BATU BADINDING, KATINGAN TENGAH, KATINGAN, KALIMANTAN TENGAH",1,48,183,231
https://kawalpemilu.org#61133,"BATU BADINDING, KATINGAN TENGAH, KATINGAN, KALIMANTAN TENGAH",2,154,66,220
https://kawalpemilu.org#61133,"BATU BADINDING, KATINGAN TENGAH, KATINGAN, KALIMANTAN TENGAH",3,158,44,202
https://kawalpemilu.org#61133,"BATU BADINDING, KATINGAN TENGAH, KATINGAN, KALIMANTAN TENGAH",4,156,43,199
https://kawalpemilu.org#61133,"BATU BADINDING, KATINGAN TENGAH, KATINGAN, KALIMANTAN TENGAH",5,66,32,98
https://kawalpemilu.org#61133,"BATU BADINDING, KATINGAN TENGAH, KATINGAN, KALIMANTAN TENGAH",6,163,36,199
https://kawalpemilu.org#61133,"BATU BADINDING, KATINGAN TENGAH, KATINGAN, KALIMANTAN TENGAH",7,66,17,83
https://kawalpemilu.org#61134,"RANTAU ASEM, KATINGAN TENGAH, KATINGAN, KALIMANTAN TENGAH",1,149,36,185
https://kawalpemilu.org#61134,"RANTAU ASEM, KATINGAN TENGAH, KATINGAN, KALIMANTAN TENGAH",2,154,9,163
https://kawalpemilu.org#61134,"RANTAU ASEM, KATINGAN TENGAH, KATINGAN, KALIMANTAN TENGAH",3,178,31,209
https://kawalpemilu.org#61134,"RANTAU ASEM, KATINGAN TENGAH, KATINGAN, KALIMANTAN TENGAH",4,116,13,129
https://kawalpemilu.org#61135,"MIRAH KALANAMAN, KATINGAN TENGAH, KATINGAN, KALIMANTAN TENGAH",1,171,7,178
https://kawalpemilu.org#61135,"MIRAH KALANAMAN, KATINGAN TENGAH, KATINGAN, KALIMANTAN TENGAH",2,194,19,213
https://kawalpemilu.org#61135,"MIRAH KALANAMAN, KATINGAN TENGAH, KATINGAN, KALIMANTAN TENGAH",3,165,13,178
https://kawalpemilu.org#61135,"MIRAH KALANAMAN, KATINGAN TENGAH, KATINGAN, KALIMANTAN TENGAH",4,133,12,145
https://kawalpemilu.org#61135,"MIRAH KALANAMAN, KATINGAN TENGAH, KATINGAN, KALIMANTAN TENGAH",5,156,26,182
https://kawalpemilu.org#61135,"MIRAH KALANAMAN, KATINGAN TENGAH, KATINGAN, KALIMANTAN TENGAH",6,110,5,115
https://kawalpemilu.org#61135,"MIRAH KALANAMAN, KATINGAN TENGAH, KATINGAN, KALIMANTAN TENGAH",7,74,11,85
https://kawalpemilu.org#61135,"MIRAH KALANAMAN, KATINGAN TENGAH, KATINGAN, KALIMANTAN TENGAH",8,43,2,45
https://kawalpemilu.org#61135,"MIRAH KALANAMAN, KATINGAN TENGAH, KATINGAN, KALIMANTAN TENGAH",9,201,26,227
https://kawalpemilu.org#61135,"MIRAH KALANAMAN, KATINGAN TENGAH, KATINGAN, KALIMANTAN TENGAH",10,28,4,32
https://kawalpemilu.org#61135,"MIRAH KALANAMAN, KATINGAN TENGAH, KATINGAN, KALIMANTAN TENGAH",11,138,24,162
https://kawalpemilu.org#61135,"MIRAH KALANAMAN, KATINGAN TENGAH, KATINGAN, KALIMANTAN TENGAH",12,1,0,1
https://kawalpemilu.org#61135,"MIRAH KALANAMAN, KATINGAN TENGAH, KATINGAN, KALIMANTAN TENGAH",13,112,45,157
https://kawalpemilu.org#61136,"TUMBANG MARAK, KATINGAN TENGAH, KATINGAN, KALIMANTAN TENGAH",1,195,14,209
https://kawalpemilu.org#61136,"TUMBANG MARAK, KATINGAN TENGAH, KATINGAN, KALIMANTAN TENGAH",2,233,20,253
https://kawalpemilu.org#61136,"TUMBANG MARAK, KATINGAN TENGAH, KATINGAN, KALIMANTAN TENGAH",3,125,35,160
https://kawalpemilu.org#61136,"TUMBANG MARAK, KATINGAN TENGAH, KATINGAN, KALIMANTAN TENGAH",4,36,11,47
https://kawalpemilu.org#61137,"TUMBANG HANGEI, KATINGAN TENGAH, KATINGAN, KALIMANTAN TENGAH",1,176,11,187
https://kawalpemilu.org#61137,"TUMBANG HANGEI, KATINGAN TENGAH, KATINGAN, KALIMANTAN TENGAH",2,153,14,167
https://kawalpemilu.org#61139,"TUMBANG PARIYEI, KATINGAN TENGAH, KATINGAN, KALIMANTAN TENGAH",1,154,11,165
https://kawalpemilu.org#61139,"TUMBANG PARIYEI, KATINGAN TENGAH, KATINGAN, KALIMANTAN TENGAH",2,136,12,148
https://kawalpemilu.org#85387,"TUMBANG KALEMEI, KATINGAN TENGAH, KATINGAN, KALIMANTAN TENGAH",1,125,11,136
https://kawalpemilu.org#85387,"TUMBANG KALEMEI, KATINGAN TENGAH, KATINGAN, KALIMANTAN TENGAH",2,203,18,221
https://kawalpemilu.org#85387,"TUMBANG KALEMEI, KATINGAN TENGAH, KATINGAN, KALIMANTAN TENGAH",3,164,30,194
https://kawalpemilu.org#85387,"TUMBANG KALEMEI, KATINGAN TENGAH, KATINGAN, KALIMANTAN TENGAH",4,163,26,189
https://kawalpemilu.org#61141,"DEHES, SANAMAN MANTIKEI, KATINGAN, KALIMANTAN TENGAH",1,179,41,220
https://kawalpemilu.org#61142,"TUMBANG LABEHU, SANAMAN MANTIKEI, KATINGAN, KALIMANTAN TENGAH",1,123,24,147
https://kawalpemilu.org#61143,"TUMBANG KAMAN, SANAMAN MANTIKEI, KATINGAN, KALIMANTAN TENGAH",1,179,26,205
https://kawalpemilu.org#61143,"TUMBANG KAMAN, SANAMAN MANTIKEI, KATINGAN, KALIMANTAN TENGAH",2,164,28,192
https://kawalpemilu.org#61143,"TUMBANG KAMAN, SANAMAN MANTIKEI, KATINGAN, KALIMANTAN TENGAH",3,192,8,200
https://kawalpemilu.org#61143,"TUMBANG KAMAN, SANAMAN MANTIKEI, KATINGAN, KALIMANTAN TENGAH",4,156,11,167
https://kawalpemilu.org#61143,"TUMBANG KAMAN, SANAMAN MANTIKEI, KATINGAN, KALIMANTAN TENGAH",5,139,32,171
https://kawalpemilu.org#61144,"TUMBANG MANGGO, SANAMAN MANTIKEI, KATINGAN, KALIMANTAN TENGAH",1,226,14,240
https://kawalpemilu.org#61144,"TUMBANG MANGGO, SANAMAN MANTIKEI, KATINGAN, KALIMANTAN TENGAH",2,228,14,242
https://kawalpemilu.org#61144,"TUMBANG MANGGO, SANAMAN MANTIKEI, KATINGAN, KALIMANTAN TENGAH",3,226,29,255
https://kawalpemilu.org#61144,"TUMBANG MANGGO, SANAMAN MANTIKEI, KATINGAN, KALIMANTAN TENGAH",4,150,42,192
https://kawalpemilu.org#61144,"TUMBANG MANGGO, SANAMAN MANTIKEI, KATINGAN, KALIMANTAN TENGAH",5,151,50,201
https://kawalpemilu.org#61144,"TUMBANG MANGGO, SANAMAN MANTIKEI, KATINGAN, KALIMANTAN TENGAH",6,180,26,206
https://kawalpemilu.org#61144,"TUMBANG MANGGO, SANAMAN MANTIKEI, KATINGAN, KALIMANTAN TENGAH",7,138,24,162
https://kawalpemilu.org#61144,"TUMBANG MANGGO, SANAMAN MANTIKEI, KATINGAN, KALIMANTAN TENGAH",8,163,38,201
https://kawalpemilu.org#61144,"TUMBANG MANGGO, SANAMAN MANTIKEI, KATINGAN, KALIMANTAN TENGAH",9,160,28,188
https://kawalpemilu.org#61144,"TUMBANG MANGGO, SANAMAN MANTIKEI, KATINGAN, KALIMANTAN TENGAH",10,196,23,219
https://kawalpemilu.org#61144,"TUMBANG MANGGO, SANAMAN MANTIKEI, KATINGAN, KALIMANTAN TENGAH",11,115,10,125
https://kawalpemilu.org#61144,"TUMBANG MANGGO, SANAMAN MANTIKEI, KATINGAN, KALIMANTAN TENGAH",12,117,31,148
https://kawalpemilu.org#61145,"KAMANTO, SANAMAN MANTIKEI, KATINGAN, KALIMANTAN TENGAH",1,152,6,158
https://kawalpemilu.org#61146,"KULUK HABUHUS, SANAMAN MANTIKEI, KATINGAN, KALIMANTAN TENGAH",1,152,7,159
https://kawalpemilu.org#61146,"KULUK HABUHUS, SANAMAN MANTIKEI, KATINGAN, KALIMANTAN TENGAH",2,145,16,161
https://kawalpemilu.org#61147,"TUMBANG KANEI, SANAMAN MANTIKEI, KATINGAN, KALIMANTAN TENGAH",1,202,10,212
https://kawalpemilu.org#61148,"TUMBANG TARANEI, SANAMAN MANTIKEI, KATINGAN, KALIMANTAN TENGAH",1,171,10,181
https://kawalpemilu.org#61149,"TUMBANG KAWEI, SANAMAN MANTIKEI, KATINGAN, KALIMANTAN TENGAH",1,119,8,127
https://kawalpemilu.org#61150,"TUMBANG MANGARA, SANAMAN MANTIKEI, KATINGAN, KALIMANTAN TENGAH",1,119,9,128
https://kawalpemilu.org#61151,"TUMBANG PANGKA, SANAMAN MANTIKEI, KATINGAN, KALIMANTAN TENGAH",1,132,5,137
https://kawalpemilu.org#61152,"TUMBANG ATEI, SANAMAN MANTIKEI, KATINGAN, KALIMANTAN TENGAH",1,188,11,199
https://kawalpemilu.org#61152,"TUMBANG ATEI, SANAMAN MANTIKEI, KATINGAN, KALIMANTAN TENGAH",2,174,9,183
https://kawalpemilu.org#61152,"TUMBANG ATEI, SANAMAN MANTIKEI, KATINGAN, KALIMANTAN TENGAH",3,160,13,173
https://kawalpemilu.org#61153,"DAYA MANUNGGAL, SANAMAN MANTIKEI, KATINGAN, KALIMANTAN TENGAH",1,82,2,84
https://kawalpemilu.org#61154,"RANTAU BANGKIANG, SANAMAN MANTIKEI, KATINGAN, KALIMANTAN TENGAH",1,163,33,196
https://kawalpemilu.org#61154,"RANTAU BANGKIANG, SANAMAN MANTIKEI, KATINGAN, KALIMANTAN TENGAH",2,141,30,171
https://kawalpemilu.org#61154,"RANTAU BANGKIANG, SANAMAN MANTIKEI, KATINGAN, KALIMANTAN TENGAH",3,139,17,156
https://kawalpemilu.org#61156,"TUMBANG MANDUREI, MARIKIT, KATINGAN, KALIMANTAN TENGAH",1,99,19,118
https://kawalpemilu.org#61157,"TUMBANG PAKU, MARIKIT, KATINGAN, KALIMANTAN TENGAH",1,162,12,174
https://kawalpemilu.org#61157,"TUMBANG PAKU, MARIKIT, KATINGAN, KALIMANTAN TENGAH",2,151,10,161
https://kawalpemilu.org#61158,"BUNTUT LELENG, MARIKIT, KATINGAN, KALIMANTAN TENGAH",1,126,7,133
https://kawalpemilu.org#61158,"BUNTUT LELENG, MARIKIT, KATINGAN, KALIMANTAN TENGAH",2,122,5,127
https://kawalpemilu.org#61159,"KULUK LELENG, MARIKIT, KATINGAN, KALIMANTAN TENGAH",1,73,4,77
https://kawalpemilu.org#61160,"SABAUNG, MARIKIT, KATINGAN, KALIMANTAN TENGAH",1,106,11,117
https://kawalpemilu.org#61161,"TUMBANG MALAWAN, MARIKIT, KATINGAN, KALIMANTAN TENGAH",1,122,5,127
https://kawalpemilu.org#61162,"TUMBANG TAEI, MARIKIT, KATINGAN, KALIMANTAN TENGAH",1,88,2,90
https://kawalpemilu.org#61163,"RANGAN SURAI, MARIKIT, KATINGAN, KALIMANTAN TENGAH",1,138,4,142
https://kawalpemilu.org#61163,"RANGAN SURAI, MARIKIT, KATINGAN, KALIMANTAN TENGAH",2,114,8,122
https://kawalpemilu.org#61164,"TUMBANG HIRAN, MARIKIT, KATINGAN, KALIMANTAN TENGAH",1,128,91,219
https://kawalpemilu.org#61164,"TUMBANG HIRAN, MARIKIT, KATINGAN, KALIMANTAN TENGAH",2,131,60,191
https://kawalpemilu.org#61164,"TUMBANG HIRAN, MARIKIT, KATINGAN, KALIMANTAN TENGAH",3,141,48,189
https://kawalpemilu.org#61165,"TUMBANG PAHANEI, MARIKIT, KATINGAN, KALIMANTAN TENGAH",1,160,6,166
https://kawalpemilu.org#61165,"TUMBANG PAHANEI, MARIKIT, KATINGAN, KALIMANTAN TENGAH",2,220,5,225
https://kawalpemilu.org#61166,"TUMBANG DAKEI, MARIKIT, KATINGAN, KALIMANTAN TENGAH",1,187,10,197
https://kawalpemilu.org#61166,"TUMBANG DAKEI, MARIKIT, KATINGAN, KALIMANTAN TENGAH",2,119,6,125
https://kawalpemilu.org#61167,"RANGAN BURIH, MARIKIT, KATINGAN, KALIMANTAN TENGAH",1,124,6,130
https://kawalpemilu.org#61168,"TUMBANG BEMBAN, MARIKIT, KATINGAN, KALIMANTAN TENGAH",1,123,7,130
https://kawalpemilu.org#61168,"TUMBANG BEMBAN, MARIKIT, KATINGAN, KALIMANTAN TENGAH",2,103,6,109
https://kawalpemilu.org#61169,"TUMBANG LAMBI, MARIKIT, KATINGAN, KALIMANTAN TENGAH",1,84,5,89
https://kawalpemilu.org#61170,"RANGAN TANGKO, MARIKIT, KATINGAN, KALIMANTAN TENGAH",1,188,6,194
https://kawalpemilu.org#61170,"RANGAN TANGKO, MARIKIT, KATINGAN, KALIMANTAN TENGAH",2,178,8,186
https://kawalpemilu.org#61171,"TUMBANG TUNDU, MARIKIT, KATINGAN, KALIMANTAN TENGAH",1,61,7,68
https://kawalpemilu.org#61172,"BATU PANAHAN, MARIKIT, KATINGAN, KALIMANTAN TENGAH",1,88,5,93
https://kawalpemilu.org#61173,"TUMBANG TABULUS, MARIKIT, KATINGAN, KALIMANTAN TENGAH",1,163,25,188
https://kawalpemilu.org#61175,"TUMBANG SANAMANG, KATINGAN HULU, KATINGAN, KALIMANTAN TENGAH",1,80,60,140
https://kawalpemilu.org#61175,"TUMBANG SANAMANG, KATINGAN HULU, KATINGAN, KALIMANTAN TENGAH",2,51,108,159
https://kawalpemilu.org#61175,"TUMBANG SANAMANG, KATINGAN HULU, KATINGAN, KALIMANTAN TENGAH",3,61,108,169
https://kawalpemilu.org#61175,"TUMBANG SANAMANG, KATINGAN HULU, KATINGAN, KALIMANTAN TENGAH",4,58,111,169
https://kawalpemilu.org#61175,"TUMBANG SANAMANG, KATINGAN HULU, KATINGAN, KALIMANTAN TENGAH",5,80,77,157
https://kawalpemilu.org#61175,"TUMBANG SANAMANG, KATINGAN HULU, KATINGAN, KALIMANTAN TENGAH",6,134,56,190
https://kawalpemilu.org#61176,"KIHAM BATANG, KATINGAN HULU, KATINGAN, KALIMANTAN TENGAH",1,145,6,151
https://kawalpemilu.org#61177,"TUMBANG KABAYAN, KATINGAN HULU, KATINGAN, KALIMANTAN TENGAH",1,54,28,82
https://kawalpemilu.org#61178,"RANGAN KAWIT, KATINGAN HULU, KATINGAN, KALIMANTAN TENGAH",1,183,14,197
https://kawalpemilu.org#61179,"DEHES ASEM, KATINGAN HULU, KATINGAN, KALIMANTAN TENGAH",1,82,22,104
https://kawalpemilu.org#61180,"KULUK SEPANGI, KATINGAN HULU, KATINGAN, KALIMANTAN TENGAH",1,102,9,111
https://kawalpemilu.org#61181,"TUMBANG KUAI, KATINGAN HULU, KATINGAN, KALIMANTAN TENGAH",1,79,21,100
https://kawalpemilu.org#61182,"TUMBANG SALAMAN, KATINGAN HULU, KATINGAN, KALIMANTAN TENGAH",1,102,22,124
https://kawalpemilu.org#61183,"RANTAU PUKA, KATINGAN HULU, KATINGAN, KALIMANTAN TENGAH",1,119,32,151
https://kawalpemilu.org#61184,"RANTAU BAHAI, KATINGAN HULU, KATINGAN, KALIMANTAN TENGAH",1,101,52,153
https://kawalpemilu.org#61184,"RANTAU BAHAI, KATINGAN HULU, KATINGAN, KALIMANTAN TENGAH",2,102,24,126
https://kawalpemilu.org#61185,"RANGAN RANJING, KATINGAN HULU, KATINGAN, KALIMANTAN TENGAH",1,86,4,90
https://kawalpemilu.org#61186,"TUMBANG LABANING, KATINGAN HULU, KATINGAN, KALIMANTAN TENGAH",1,164,19,183
https://kawalpemilu.org#61187,"BATU BANGO, KATINGAN HULU, KATINGAN, KALIMANTAN TENGAH",1,82,4,86
https://kawalpemilu.org#61188,"TUMBANG HANGEI II, KATINGAN HULU, KATINGAN, KALIMANTAN TENGAH",1,108,19,127
https://kawalpemilu.org#61188,"TUMBANG HANGEI II, KATINGAN HULU, KATINGAN, KALIMANTAN TENGAH",2,104,22,126
https://kawalpemilu.org#61189,"SEI NANJAN, KATINGAN HULU, KATINGAN, KALIMANTAN TENGAH",1,74,37,111
https://kawalpemilu.org#61190,"TUMBANG JIGA, KATINGAN HULU, KATINGAN, KALIMANTAN TENGAH",1,82,52,134
https://kawalpemilu.org#61190,"TUMBANG JIGA, KATINGAN HULU, KATINGAN, KALIMANTAN TENGAH",2,69,65,134
https://kawalpemilu.org#61191,"TUMBANG MANGKETAI, KATINGAN HULU, KATINGAN, KALIMANTAN TENGAH",1,98,10,108
https://kawalpemilu.org#61192,"TUMBANG MAHOP, KATINGAN HULU, KATINGAN, KALIMANTAN TENGAH",1,149,13,162
https://kawalpemilu.org#61192,"TUMBANG MAHOP, KATINGAN HULU, KATINGAN, KALIMANTAN TENGAH",2,136,9,145
https://kawalpemilu.org#61192,"TUMBANG MAHOP, KATINGAN HULU, KATINGAN, KALIMANTAN TENGAH",3,86,4,90
https://kawalpemilu.org#61193,"TUMBANG SABETUNG, KATINGAN HULU, KATINGAN, KALIMANTAN TENGAH",1,88,1,89
https://kawalpemilu.org#61194,"PENDA TANGARING LAMA, KATINGAN HULU, KATINGAN, KALIMANTAN TENGAH",1,127,15,142
https://kawalpemilu.org#61195,"PENDA TANGARING BARU, KATINGAN HULU, KATINGAN, KALIMANTAN TENGAH",1,164,14,178
https://kawalpemilu.org#61196,"TUMBANG MANANGEI, KATINGAN HULU, KATINGAN, KALIMANTAN TENGAH",1,81,15,96
https://kawalpemilu.org#85388,"TELOK TAMPANG, KATINGAN HULU, KATINGAN, KALIMANTAN TENGAH",1,35,0,35
https://kawalpemilu.org#61198,"MENDAWAI, MENDAWAI, KATINGAN, KALIMANTAN TENGAH",1,101,88,189
https://kawalpemilu.org#61198,"MENDAWAI, MENDAWAI, KATINGAN, KALIMANTAN TENGAH",2,89,118,207
https://kawalpemilu.org#61198,"MENDAWAI, MENDAWAI, KATINGAN, KALIMANTAN TENGAH",3,108,85,193
https://kawalpemilu.org#61199,"TELUK SEBULU, MENDAWAI, KATINGAN, KALIMANTAN TENGAH",1,69,61,130
https://kawalpemilu.org#61200,"KAMPUNG MELAYU, MENDAWAI, KATINGAN, KALIMANTAN TENGAH",1,35,67,102
https://kawalpemilu.org#61200,"KAMPUNG MELAYU, MENDAWAI, KATINGAN, KALIMANTAN TENGAH",2,56,70,126
https://kawalpemilu.org#61200,"KAMPUNG MELAYU, MENDAWAI, KATINGAN, KALIMANTAN TENGAH",3,38,64,102
https://kawalpemilu.org#61201,"TEWANG KAMPUNG, MENDAWAI, KATINGAN, KALIMANTAN TENGAH",1,99,63,162
https://kawalpemilu.org#61201,"TEWANG KAMPUNG, MENDAWAI, KATINGAN, KALIMANTAN TENGAH",2,100,68,168
https://kawalpemilu.org#61202,"PERIGI, MENDAWAI, KATINGAN, KALIMANTAN TENGAH",1,104,10,114
https://kawalpemilu.org#61202,"PERIGI, MENDAWAI, KATINGAN, KALIMANTAN TENGAH",2,95,17,112
https://kawalpemilu.org#61203,"MEKAR TANI, MENDAWAI, KATINGAN, KALIMANTAN TENGAH",1,82,50,132
https://kawalpemilu.org#61203,"MEKAR TANI, MENDAWAI, KATINGAN, KALIMANTAN TENGAH",2,79,47,126
https://kawalpemilu.org#61203,"MEKAR TANI, MENDAWAI, KATINGAN, KALIMANTAN TENGAH",3,118,24,142
https://kawalpemilu.org#61204,"TUMBANG BULAN, MENDAWAI, KATINGAN, KALIMANTAN TENGAH",1,151,21,172
https://kawalpemilu.org#61204,"TUMBANG BULAN, MENDAWAI, KATINGAN, KALIMANTAN TENGAH",2,115,30,145
https://kawalpemilu.org#61206,"PAGATAN HILIR, KATINGAN KUALA, KATINGAN, KALIMANTAN TENGAH",1,79,134,213
https://kawalpemilu.org#61206,"PAGATAN HILIR, KATINGAN KUALA, KATINGAN, KALIMANTAN TENGAH",2,56,161,217
https://kawalpemilu.org#61206,"PAGATAN HILIR, KATINGAN KUALA, KATINGAN, KALIMANTAN TENGAH",3,84,111,194
https://kawalpemilu.org#61206,"PAGATAN HILIR, KATINGAN KUALA, KATINGAN, KALIMANTAN TENGAH",4,67,117,184
https://kawalpemilu.org#61206,"PAGATAN HILIR, KATINGAN KUALA, KATINGAN, KALIMANTAN TENGAH",5,47,106,153
https://kawalpemilu.org#61206,"PAGATAN HILIR, KATINGAN KUALA, KATINGAN, KALIMANTAN TENGAH",6,49,125,174
https://kawalpemilu.org#61206,"PAGATAN HILIR, KATINGAN KUALA, KATINGAN, KALIMANTAN TENGAH",7,26,57,83
https://kawalpemilu.org#61206,"PAGATAN HILIR, KATINGAN KUALA, KATINGAN, KALIMANTAN TENGAH",8,49,97,146
https://kawalpemilu.org#61206,"PAGATAN HILIR, KATINGAN KUALA, KATINGAN, KALIMANTAN TENGAH",9,10,68,78
https://kawalpemilu.org#61207,"PAGATAN HULU, KATINGAN KUALA, KATINGAN, KALIMANTAN TENGAH",1,57,137,6
https://kawalpemilu.org#61207,"PAGATAN HULU, KATINGAN KUALA, KATINGAN, KALIMANTAN TENGAH",2,86,120,206
https://kawalpemilu.org#61207,"PAGATAN HULU, KATINGAN KUALA, KATINGAN, KALIMANTAN TENGAH",3,140,70,210
https://kawalpemilu.org#61207,"PAGATAN HULU, KATINGAN KUALA, KATINGAN, KALIMANTAN TENGAH",4,126,52,178
https://kawalpemilu.org#61207,"PAGATAN HULU, KATINGAN KUALA, KATINGAN, KALIMANTAN TENGAH",5,86,113,199
https://kawalpemilu.org#61207,"PAGATAN HULU, KATINGAN KUALA, KATINGAN, KALIMANTAN TENGAH",6,108,83,191
https://kawalpemilu.org#61208,"KAMPUNG KERAMAT, KATINGAN KUALA, KATINGAN, KALIMANTAN TENGAH",1,176,40,216
https://kawalpemilu.org#61208,"KAMPUNG KERAMAT, KATINGAN KUALA, KATINGAN, KALIMANTAN TENGAH",2,153,52,205
https://kawalpemilu.org#61208,"KAMPUNG KERAMAT, KATINGAN KUALA, KATINGAN, KALIMANTAN TENGAH",3,154,63,217
https://kawalpemilu.org#61209,"KAMPUNG TENGAH, KATINGAN KUALA, KATINGAN, KALIMANTAN TENGAH",1,181,44,225
https://kawalpemilu.org#61209,"KAMPUNG TENGAH, KATINGAN KUALA, KATINGAN, KALIMANTAN TENGAH",2,129,46,175
https://kawalpemilu.org#61209,"KAMPUNG TENGAH, KATINGAN KUALA, KATINGAN, KALIMANTAN TENGAH",3,146,52,198
https://kawalpemilu.org#61209,"KAMPUNG TENGAH, KATINGAN KUALA, KATINGAN, KALIMANTAN TENGAH",4,163,31,194
https://kawalpemilu.org#61210,"JAYA MAKMUR, KATINGAN KUALA, KATINGAN, KALIMANTAN TENGAH",1,136,50,186
https://kawalpemilu.org#61210,"JAYA MAKMUR, KATINGAN KUALA, KATINGAN, KALIMANTAN TENGAH",2,176,27,203
https://kawalpemilu.org#61210,"JAYA MAKMUR, KATINGAN KUALA, KATINGAN, KALIMANTAN TENGAH",3,189,20,209
https://kawalpemilu.org#61210,"JAYA MAKMUR, KATINGAN KUALA, KATINGAN, KALIMANTAN TENGAH",4,196,25,221
https://kawalpemilu.org#61210,"JAYA MAKMUR, KATINGAN KUALA, KATINGAN, KALIMANTAN TENGAH",5,167,27,194
https://kawalpemilu.org#61210,"JAYA MAKMUR, KATINGAN KUALA, KATINGAN, KALIMANTAN TENGAH",6,175,45,220
https://kawalpemilu.org#61211,"SUBUR INDAH, KATINGAN KUALA, KATINGAN, KALIMANTAN TENGAH",1,135,36,171
https://kawalpemilu.org#61211,"SUBUR INDAH, KATINGAN KUALA, KATINGAN, KALIMANTAN TENGAH",2,137,31,168
https://kawalpemilu.org#61211,"SUBUR INDAH, KATINGAN KUALA, KATINGAN, KALIMANTAN TENGAH",3,153,22,175
https://kawalpemilu.org#61211,"SUBUR INDAH, KATINGAN KUALA, KATINGAN, KALIMANTAN TENGAH",4,92,38,130
https://kawalpemilu.org#61211,"SUBUR INDAH, KATINGAN KUALA, KATINGAN, KALIMANTAN TENGAH",5,94,29,123
https://kawalpemilu.org#61212,"KAMPUNG BARU, KATINGAN KUALA, KATINGAN, KALIMANTAN TENGAH",1,117,26,143
https://kawalpemilu.org#61212,"KAMPUNG BARU, KATINGAN KUALA, KATINGAN, KALIMANTAN TENGAH",2,124,32,156
https://kawalpemilu.org#61212,"KAMPUNG BARU, KATINGAN KUALA, KATINGAN, KALIMANTAN TENGAH",3,172,20,192
https://kawalpemilu.org#61212,"KAMPUNG BARU, KATINGAN KUALA, KATINGAN, KALIMANTAN TENGAH",4,65,69,134
https://kawalpemilu.org#61212,"KAMPUNG BARU, KATINGAN KUALA, KATINGAN, KALIMANTAN TENGAH",5,47,50,97
https://kawalpemilu.org#61213,"BANGUN JAYA, KATINGAN KUALA, KATINGAN, KALIMANTAN TENGAH",1,136,15,151
https://kawalpemilu.org#61213,"BANGUN JAYA, KATINGAN KUALA, KATINGAN, KALIMANTAN TENGAH",2,123,18,141
https://kawalpemilu.org#61213,"BANGUN JAYA, KATINGAN KUALA, KATINGAN, KALIMANTAN TENGAH",3,111,14,125
https://kawalpemilu.org#61213,"BANGUN JAYA, KATINGAN KUALA, KATINGAN, KALIMANTAN TENGAH",5,78,49,127
https://kawalpemilu.org#61213,"BANGUN JAYA, KATINGAN KUALA, KATINGAN, KALIMANTAN TENGAH",6,89,5,94
https://kawalpemilu.org#61214,"SETIA MULIA, KATINGAN KUALA, KATINGAN, KALIMANTAN TENGAH",1,95,74,169
https://kawalpemilu.org#61214,"SETIA MULIA, KATINGAN KUALA, KATINGAN, KALIMANTAN TENGAH",2,119,59,178
https://kawalpemilu.org#61215,"SINGAM RAYA, KATINGAN KUALA, KATINGAN, KALIMANTAN TENGAH",1,62,6,68
https://kawalpemilu.org#61215,"SINGAM RAYA, KATINGAN KUALA, KATINGAN, KALIMANTAN TENGAH",2,68,16,84
https://kawalpemilu.org#61215,"SINGAM RAYA, KATINGAN KUALA, KATINGAN, KALIMANTAN TENGAH",3,98,22,120
https://kawalpemilu.org#61216,"SEBANGAU JAYA, KATINGAN KUALA, KATINGAN, KALIMANTAN TENGAH",1,104,22,126
https://kawalpemilu.org#61216,"SEBANGAU JAYA, KATINGAN KUALA, KATINGAN, KALIMANTAN TENGAH",2,168,43,211
https://kawalpemilu.org#61216,"SEBANGAU JAYA, KATINGAN KUALA, KATINGAN, KALIMANTAN TENGAH",3,83,46,129
https://kawalpemilu.org#61217,"SUNGAI KAKI, KATINGAN KUALA, KATINGAN, KALIMANTAN TENGAH",1,82,63,145
https://kawalpemilu.org#61218,"SELAT BANING, KATINGAN KUALA, KATINGAN, KALIMANTAN TENGAH",1,92,42,134
https://kawalpemilu.org#61219,"MAKMUR UTAMA, KATINGAN KUALA, KATINGAN, KALIMANTAN TENGAH",1,131,52,183
https://kawalpemilu.org#61219,"MAKMUR UTAMA, KATINGAN KUALA, KATINGAN, KALIMANTAN TENGAH",2,155,14,169
https://kawalpemilu.org#61219,"MAKMUR UTAMA, KATINGAN KUALA, KATINGAN, KALIMANTAN TENGAH",3,108,50,158
https://kawalpemilu.org#61219,"MAKMUR UTAMA, KATINGAN KUALA, KATINGAN, KALIMANTAN TENGAH",4,95,30,125
https://kawalpemilu.org#61220,"BUMI SUBUR, KATINGAN KUALA, KATINGAN, KALIMANTAN TENGAH",1,171,16,187
https://kawalpemilu.org#61220,"BUMI SUBUR, KATINGAN KUALA, KATINGAN, KALIMANTAN TENGAH",2,158,23,181
https://kawalpemilu.org#61220,"BUMI SUBUR, KATINGAN KUALA, KATINGAN, KALIMANTAN TENGAH",3,111,12,123
https://kawalpemilu.org#61220,"BUMI SUBUR, KATINGAN KUALA, KATINGAN, KALIMANTAN TENGAH",4,126,20,146
https://kawalpemilu.org#61221,"BAKUNG RAYA, KATINGAN KUALA, KATINGAN, KALIMANTAN TENGAH",1,76,61,137
https://kawalpemilu.org#61221,"BAKUNG RAYA, KATINGAN KUALA, KATINGAN, KALIMANTAN TENGAH",2,78,38,116
https://kawalpemilu.org#61223,"TALINGKE, TASIK PAYAWAN, KATINGAN, KALIMANTAN TENGAH",1,130,39,169
https://kawalpemilu.org#61223,"TALINGKE, TASIK PAYAWAN, KATINGAN, KALIMANTAN TENGAH",2,162,20,182
https://kawalpemilu.org#61224,"HIYANG BANA, TASIK PAYAWAN, KATINGAN, KALIMANTAN TENGAH",1,140,25,165
https://kawalpemilu.org#61224,"HIYANG BANA, TASIK PAYAWAN, KATINGAN, KALIMANTAN TENGAH",2,169,42,211
https://kawalpemilu.org#61224,"HIYANG BANA, TASIK PAYAWAN, KATINGAN, KALIMANTAN TENGAH",3,148,27,175
https://kawalpemilu.org#61224,"HIYANG BANA, TASIK PAYAWAN, KATINGAN, KALIMANTAN TENGAH",4,46,10,56
https://kawalpemilu.org#61225,"PETAK BAHANDANG, TASIK PAYAWAN, KATINGAN, KALIMANTAN TENGAH",2,171,75,246
https://kawalpemilu.org#61225,"PETAK BAHANDANG, TASIK PAYAWAN, KATINGAN, KALIMANTAN TENGAH",3,158,67,225
https://kawalpemilu.org#61225,"PETAK BAHANDANG, TASIK PAYAWAN, KATINGAN, KALIMANTAN TENGAH",4,190,40,230
https://kawalpemilu.org#61226,"HANDIWUNG, TASIK PAYAWAN, KATINGAN, KALIMANTAN TENGAH",1,176,44,220
https://kawalpemilu.org#61226,"HANDIWUNG, TASIK PAYAWAN, KATINGAN, KALIMANTAN TENGAH",2,128,82,210
https://kawalpemilu.org#61227,"TUMBANG PANGGO, TASIK PAYAWAN, KATINGAN, KALIMANTAN TENGAH",1,203,25,228
https://kawalpemilu.org#61227,"TUMBANG PANGGO, TASIK PAYAWAN, KATINGAN, KALIMANTAN TENGAH",2,200,35,235
https://kawalpemilu.org#61228,"TEWANG TAMPANG, TASIK PAYAWAN, KATINGAN, KALIMANTAN TENGAH",1,133,45,178
https://kawalpemilu.org#61228,"TEWANG TAMPANG, TASIK PAYAWAN, KATINGAN, KALIMANTAN TENGAH",2,137,53,190
https://kawalpemilu.org#61229,"LUWUK KANAN, TASIK PAYAWAN, KATINGAN, KALIMANTAN TENGAH",1,174,72,246
https://kawalpemilu.org#61229,"LUWUK KANAN, TASIK PAYAWAN, KATINGAN, KALIMANTAN TENGAH",2,107,98,205
https://kawalpemilu.org#61229,"LUWUK KANAN, TASIK PAYAWAN, KATINGAN, KALIMANTAN TENGAH",3,136,41,177
https://kawalpemilu.org#61229,"LUWUK KANAN, TASIK PAYAWAN, KATINGAN, KALIMANTAN TENGAH",4,156,18,174
https://kawalpemilu.org#61229,"LUWUK KANAN, TASIK PAYAWAN, KATINGAN, KALIMANTAN TENGAH",5,85,70,155
https://kawalpemilu.org#61229,"LUWUK KANAN, TASIK PAYAWAN, KATINGAN, KALIMANTAN TENGAH",6,91,56,147
https://kawalpemilu.org#61230,"LUWUK KIRI, TASIK PAYAWAN, KATINGAN, KALIMANTAN TENGAH",1,114,142,256
https://kawalpemilu.org#61232,"TUMBANG BARAOI, PETAK MALAI, KATINGAN, KALIMANTAN TENGAH",1,163,20,183
https://kawalpemilu.org#61232,"TUMBANG BARAOI, PETAK MALAI, KATINGAN, KALIMANTAN TENGAH",2,81,25,106
https://kawalpemilu.org#61232,"TUMBANG BARAOI, PETAK MALAI, KATINGAN, KALIMANTAN TENGAH",3,73,14,87
https://kawalpemilu.org#61233,"TUMBANG JALA, PETAK MALAI, KATINGAN, KALIMANTAN TENGAH",1,138,18,156
https://kawalpemilu.org#61233,"TUMBANG JALA, PETAK MALAI, KATINGAN, KALIMANTAN TENGAH",2,63,3,66
https://kawalpemilu.org#61233,"TUMBANG JALA, PETAK MALAI, KATINGAN, KALIMANTAN TENGAH",3,126,10,136
https://kawalpemilu.org#61234,"BATU BADAK, PETAK MALAI, KATINGAN, KALIMANTAN TENGAH",1,91,17,108
https://kawalpemilu.org#61235,"BATU TUKAN, PETAK MALAI, KATINGAN, KALIMANTAN TENGAH",1,95,10,105
https://kawalpemilu.org#61235,"BATU TUKAN, PETAK MALAI, KATINGAN, KALIMANTAN TENGAH",2,98,6,104
https://kawalpemilu.org#61236,"TUMBANG TANGOI, PETAK MALAI, KATINGAN, KALIMANTAN TENGAH",1,187,17,204
https://kawalpemilu.org#61237,"NUSA KUTAU, PETAK MALAI, KATINGAN, KALIMANTAN TENGAH",1,99,38,137
https://kawalpemilu.org#61238,"TUMBANG HABANGOI, PETAK MALAI, KATINGAN, KALIMANTAN TENGAH",1,189,9,198
https://kawalpemilu.org#61238,"TUMBANG HABANGOI, PETAK MALAI, KATINGAN, KALIMANTAN TENGAH",2,137,7,144
https://kawalpemilu.org#61238,"TUMBANG HABANGOI, PETAK MALAI, KATINGAN, KALIMANTAN TENGAH",3,122,13,135
https://kawalpemilu.org#61240,"TUMBANG GAEI, BUKIT RAYA, KATINGAN, KALIMANTAN TENGAH",1,107,43,150
https://kawalpemilu.org#61240,"TUMBANG GAEI, BUKIT RAYA, KATINGAN, KALIMANTAN TENGAH",2,81,23,104
https://kawalpemilu.org#61241,"TUMBANG KATAEI, BUKIT RAYA, KATINGAN, KALIMANTAN TENGAH",1,36,40,76
https://kawalpemilu.org#61242,"TUMBANG KARUEI, BUKIT RAYA, KATINGAN, KALIMANTAN TENGAH",1,134,7,141
https://kawalpemilu.org#61242,"TUMBANG KARUEI, BUKIT RAYA, KATINGAN, KALIMANTAN TENGAH",2,99,12,111
https://kawalpemilu.org#61242,"TUMBANG KARUEI, BUKIT RAYA, KATINGAN, KALIMANTAN TENGAH",3,80,2,82
https://kawalpemilu.org#61244,"RANTAU PANDAN, BUKIT RAYA, KATINGAN, KALIMANTAN TENGAH",1,130,28,158
https://kawalpemilu.org#61246,"RANGAN BAHEKANG, BUKIT RAYA, KATINGAN, KALIMANTAN TENGAH",1,32,20,52
https://kawalpemilu.org#61247,"TUMBANG KAJAMEI, BUKIT RAYA, KATINGAN, KALIMANTAN TENGAH",1,143,28,171
https://kawalpemilu.org#61247,"TUMBANG KAJAMEI, BUKIT RAYA, KATINGAN, KALIMANTAN TENGAH",2,112,28,140
https://kawalpemilu.org#61248,"TUMBANG KABURAI, BUKIT RAYA, KATINGAN, KALIMANTAN TENGAH",1,88,4,92
https://kawalpemilu.org#61248,"TUMBANG KABURAI, BUKIT RAYA, KATINGAN, KALIMANTAN TENGAH",2,91,12,103
https://kawalpemilu.org#61249,"TANJUNG BATIK, BUKIT RAYA, KATINGAN, KALIMANTAN TENGAH",1,81,3,84
https://kawalpemilu.org#61250,"PENDA NANGE, BUKIT RAYA, KATINGAN, KALIMANTAN TENGAH",1,66,28,94
https://kawalpemilu.org#61253,"KUALA PEMBUANG I, SERUYAN HILIR, SERUYAN, KALIMANTAN TENGAH",1,32,55,87
https://kawalpemilu.org#61253,"KUALA PEMBUANG I, SERUYAN HILIR, SERUYAN, KALIMANTAN TENGAH",2,74,73,147
https://kawalpemilu.org#61253,"KUALA PEMBUANG I, SERUYAN HILIR, SERUYAN, KALIMANTAN TENGAH",3,82,78,160
https://kawalpemilu.org#61253,"KUALA PEMBUANG I, SERUYAN HILIR, SERUYAN, KALIMANTAN TENGAH",5,100,132,232
https://kawalpemilu.org#61253,"KUALA PEMBUANG I, SERUYAN HILIR, SERUYAN, KALIMANTAN TENGAH",6,69,85,154
https://kawalpemilu.org#61253,"KUALA PEMBUANG I, SERUYAN HILIR, SERUYAN, KALIMANTAN TENGAH",7,82,99,181
https://kawalpemilu.org#61253,"KUALA PEMBUANG I, SERUYAN HILIR, SERUYAN, KALIMANTAN TENGAH",8,67,109,176
https://kawalpemilu.org#61253,"KUALA PEMBUANG I, SERUYAN HILIR, SERUYAN, KALIMANTAN TENGAH",9,84,87,171
https://kawalpemilu.org#61253,"KUALA PEMBUANG I, SERUYAN HILIR, SERUYAN, KALIMANTAN TENGAH",10,91,78,169
https://kawalpemilu.org#61253,"KUALA PEMBUANG I, SERUYAN HILIR, SERUYAN, KALIMANTAN TENGAH",11,53,51,104
https://kawalpemilu.org#61253,"KUALA PEMBUANG I, SERUYAN HILIR, SERUYAN, KALIMANTAN TENGAH",12,55,72,127
https://kawalpemilu.org#61253,"KUALA PEMBUANG I, SERUYAN HILIR, SERUYAN, KALIMANTAN TENGAH",14,83,58,141
https://kawalpemilu.org#61253,"KUALA PEMBUANG I, SERUYAN HILIR, SERUYAN, KALIMANTAN TENGAH",15,58,65,123
https://kawalpemilu.org#61253,"KUALA PEMBUANG I, SERUYAN HILIR, SERUYAN, KALIMANTAN TENGAH",16,67,39,106
https://kawalpemilu.org#61253,"KUALA PEMBUANG I, SERUYAN HILIR, SERUYAN, KALIMANTAN TENGAH",17,29,28,57
https://kawalpemilu.org#61253,"KUALA PEMBUANG I, SERUYAN HILIR, SERUYAN, KALIMANTAN TENGAH",18,66,82,148
https://kawalpemilu.org#61253,"KUALA PEMBUANG I, SERUYAN HILIR, SERUYAN, KALIMANTAN TENGAH",19,87,56,143
https://kawalpemilu.org#61253,"KUALA PEMBUANG I, SERUYAN HILIR, SERUYAN, KALIMANTAN TENGAH",21,85,72,157
https://kawalpemilu.org#61253,"KUALA PEMBUANG I, SERUYAN HILIR, SERUYAN, KALIMANTAN TENGAH",24,52,85,137
https://kawalpemilu.org#61253,"KUALA PEMBUANG I, SERUYAN HILIR, SERUYAN, KALIMANTAN TENGAH",25,43,56,99
https://kawalpemilu.org#61253,"KUALA PEMBUANG I, SERUYAN HILIR, SERUYAN, KALIMANTAN TENGAH",26,81,96,177
https://kawalpemilu.org#61253,"KUALA PEMBUANG I, SERUYAN HILIR, SERUYAN, KALIMANTAN TENGAH",27,43,46,89
https://kawalpemilu.org#61253,"KUALA PEMBUANG I, SERUYAN HILIR, SERUYAN, KALIMANTAN TENGAH",29,60,48,108
https://kawalpemilu.org#61253,"KUALA PEMBUANG I, SERUYAN HILIR, SERUYAN, KALIMANTAN TENGAH",30,58,52,110
https://kawalpemilu.org#61253,"KUALA PEMBUANG I, SERUYAN HILIR, SERUYAN, KALIMANTAN TENGAH",31,88,95,183
https://kawalpemilu.org#61253,"KUALA PEMBUANG I, SERUYAN HILIR, SERUYAN, KALIMANTAN TENGAH",32,92,85,177
https://kawalpemilu.org#61253,"KUALA PEMBUANG I, SERUYAN HILIR, SERUYAN, KALIMANTAN TENGAH",33,94,59,153
https://kawalpemilu.org#61253,"KUALA PEMBUANG I, SERUYAN HILIR, SERUYAN, KALIMANTAN TENGAH",34,51,72,123
https://kawalpemilu.org#61253,"KUALA PEMBUANG I, SERUYAN HILIR, SERUYAN, KALIMANTAN TENGAH",35,73,107,180
https://kawalpemilu.org#61254,"KUALA PEMBUANG II, SERUYAN HILIR, SERUYAN, KALIMANTAN TENGAH",1,47,63,110
https://kawalpemilu.org#61254,"KUALA PEMBUANG II, SERUYAN HILIR, SERUYAN, KALIMANTAN TENGAH",2,91,70,161
https://kawalpemilu.org#61254,"KUALA PEMBUANG II, SERUYAN HILIR, SERUYAN, KALIMANTAN TENGAH",3,92,119,211
https://kawalpemilu.org#61254,"KUALA PEMBUANG II, SERUYAN HILIR, SERUYAN, KALIMANTAN TENGAH",4,109,41,150
https://kawalpemilu.org#61254,"KUALA PEMBUANG II, SERUYAN HILIR, SERUYAN, KALIMANTAN TENGAH",5,116,97,213
https://kawalpemilu.org#61254,"KUALA PEMBUANG II, SERUYAN HILIR, SERUYAN, KALIMANTAN TENGAH",6,54,51,105
https://kawalpemilu.org#61254,"KUALA PEMBUANG II, SERUYAN HILIR, SERUYAN, KALIMANTAN TENGAH",7,129,111,240
https://kawalpemilu.org#61254,"KUALA PEMBUANG II, SERUYAN HILIR, SERUYAN, KALIMANTAN TENGAH",8,86,133,219
https://kawalpemilu.org#61254,"KUALA PEMBUANG II, SERUYAN HILIR, SERUYAN, KALIMANTAN TENGAH",9,44,62,106
https://kawalpemilu.org#61254,"KUALA PEMBUANG II, SERUYAN HILIR, SERUYAN, KALIMANTAN TENGAH",10,93,97,190
https://kawalpemilu.org#61254,"KUALA PEMBUANG II, SERUYAN HILIR, SERUYAN, KALIMANTAN TENGAH",11,81,55,136
https://kawalpemilu.org#61254,"KUALA PEMBUANG II, SERUYAN HILIR, SERUYAN, KALIMANTAN TENGAH",12,81,84,165
https://kawalpemilu.org#61254,"KUALA PEMBUANG II, SERUYAN HILIR, SERUYAN, KALIMANTAN TENGAH",13,89,42,131
https://kawalpemilu.org#61254,"KUALA PEMBUANG II, SERUYAN HILIR, SERUYAN, KALIMANTAN TENGAH",14,64,70,134
https://kawalpemilu.org#61254,"KUALA PEMBUANG II, SERUYAN HILIR, SERUYAN, KALIMANTAN TENGAH",15,118,82,200
https://kawalpemilu.org#61254,"KUALA PEMBUANG II, SERUYAN HILIR, SERUYAN, KALIMANTAN TENGAH",16,130,134,264
https://kawalpemilu.org#61254,"KUALA PEMBUANG II, SERUYAN HILIR, SERUYAN, KALIMANTAN TENGAH",17,140,44,184
https://kawalpemilu.org#61254,"KUALA PEMBUANG II, SERUYAN HILIR, SERUYAN, KALIMANTAN TENGAH",18,72,114,186
https://kawalpemilu.org#61254,"KUALA PEMBUANG II, SERUYAN HILIR, SERUYAN, KALIMANTAN TENGAH",19,79,119,198
https://kawalpemilu.org#61254,"KUALA PEMBUANG II, SERUYAN HILIR, SERUYAN, KALIMANTAN TENGAH",20,80,70,150
https://kawalpemilu.org#61254,"KUALA PEMBUANG II, SERUYAN HILIR, SERUYAN, KALIMANTAN TENGAH",22,68,110,178
https://kawalpemilu.org#61254,"KUALA PEMBUANG II, SERUYAN HILIR, SERUYAN, KALIMANTAN TENGAH",23,92,89,181
https://kawalpemilu.org#61254,"KUALA PEMBUANG II, SERUYAN HILIR, SERUYAN, KALIMANTAN TENGAH",25,94,93,187
https://kawalpemilu.org#61254,"KUALA PEMBUANG II, SERUYAN HILIR, SERUYAN, KALIMANTAN TENGAH",26,117,119,236
https://kawalpemilu.org#61254,"KUALA PEMBUANG II, SERUYAN HILIR, SERUYAN, KALIMANTAN TENGAH",28,68,75,143
https://kawalpemilu.org#61254,"KUALA PEMBUANG II, SERUYAN HILIR, SERUYAN, KALIMANTAN TENGAH",29,90,116,206
https://kawalpemilu.org#61254,"KUALA PEMBUANG II, SERUYAN HILIR, SERUYAN, KALIMANTAN TENGAH",30,124,81,205
https://kawalpemilu.org#61254,"KUALA PEMBUANG II, SERUYAN HILIR, SERUYAN, KALIMANTAN TENGAH",32,30,4,30
https://kawalpemilu.org#61254,"KUALA PEMBUANG II, SERUYAN HILIR, SERUYAN, KALIMANTAN TENGAH",33,101,75,176
https://kawalpemilu.org#61254,"KUALA PEMBUANG II, SERUYAN HILIR, SERUYAN, KALIMANTAN TENGAH",34,52,62,114
https://kawalpemilu.org#61254,"KUALA PEMBUANG II, SERUYAN HILIR, SERUYAN, KALIMANTAN TENGAH",35,33,41,74
https://kawalpemilu.org#61254,"KUALA PEMBUANG II, SERUYAN HILIR, SERUYAN, KALIMANTAN TENGAH",36,60,60,120
https://kawalpemilu.org#61254,"KUALA PEMBUANG II, SERUYAN HILIR, SERUYAN, KALIMANTAN TENGAH",37,48,59,107
https://kawalpemilu.org#61254,"KUALA PEMBUANG II, SERUYAN HILIR, SERUYAN, KALIMANTAN TENGAH",38,59,60,119
https://kawalpemilu.org#61255,"PEMATANG LIMAU, SERUYAN HILIR, SERUYAN, KALIMANTAN TENGAH",1,139,53,192
https://kawalpemilu.org#61255,"PEMATANG LIMAU, SERUYAN HILIR, SERUYAN, KALIMANTAN TENGAH",2,120,50,170
https://kawalpemilu.org#61255,"PEMATANG LIMAU, SERUYAN HILIR, SERUYAN, KALIMANTAN TENGAH",3,119,36,154
https://kawalpemilu.org#61255,"PEMATANG LIMAU, SERUYAN HILIR, SERUYAN, KALIMANTAN TENGAH",4,102,31,133
https://kawalpemilu.org#61255,"PEMATANG LIMAU, SERUYAN HILIR, SERUYAN, KALIMANTAN TENGAH",5,154,68,222
https://kawalpemilu.org#61255,"PEMATANG LIMAU, SERUYAN HILIR, SERUYAN, KALIMANTAN TENGAH",6,208,40,248
https://kawalpemilu.org#61255,"PEMATANG LIMAU, SERUYAN HILIR, SERUYAN, KALIMANTAN TENGAH",7,117,27,144
https://kawalpemilu.org#61255,"PEMATANG LIMAU, SERUYAN HILIR, SERUYAN, KALIMANTAN TENGAH",8,105,30,135
https://kawalpemilu.org#61255,"PEMATANG LIMAU, SERUYAN HILIR, SERUYAN, KALIMANTAN TENGAH",9,125,63,188
https://kawalpemilu.org#61255,"PEMATANG LIMAU, SERUYAN HILIR, SERUYAN, KALIMANTAN TENGAH",10,105,48,153
https://kawalpemilu.org#61256,"SUNGAI PERLU, SERUYAN HILIR, SERUYAN, KALIMANTAN TENGAH",1,55,34,89
https://kawalpemilu.org#61257,"TANJUNG RANGAS, SERUYAN HILIR, SERUYAN, KALIMANTAN TENGAH",1,127,66,193
https://kawalpemilu.org#61257,"TANJUNG RANGAS, SERUYAN HILIR, SERUYAN, KALIMANTAN TENGAH",2,92,28,120
https://kawalpemilu.org#61257,"TANJUNG RANGAS, SERUYAN HILIR, SERUYAN, KALIMANTAN TENGAH",3,126,26,152
https://kawalpemilu.org#61257,"TANJUNG RANGAS, SERUYAN HILIR, SERUYAN, KALIMANTAN TENGAH",4,108,25,133
https://kawalpemilu.org#61257,"TANJUNG RANGAS, SERUYAN HILIR, SERUYAN, KALIMANTAN TENGAH",5,109,31,140
https://kawalpemilu.org#61257,"TANJUNG RANGAS, SERUYAN HILIR, SERUYAN, KALIMANTAN TENGAH",6,118,25,143
https://kawalpemilu.org#61257,"TANJUNG RANGAS, SERUYAN HILIR, SERUYAN, KALIMANTAN TENGAH",7,100,50,150
https://kawalpemilu.org#61257,"TANJUNG RANGAS, SERUYAN HILIR, SERUYAN, KALIMANTAN TENGAH",8,107,30,137
https://kawalpemilu.org#61257,"TANJUNG RANGAS, SERUYAN HILIR, SERUYAN, KALIMANTAN TENGAH",9,73,26,99
https://kawalpemilu.org#61258,"MUARA DUA, SERUYAN HILIR, SERUYAN, KALIMANTAN TENGAH",1,98,95,193
https://kawalpemilu.org#61258,"MUARA DUA, SERUYAN HILIR, SERUYAN, KALIMANTAN TENGAH",2,95,18,113
https://kawalpemilu.org#61258,"MUARA DUA, SERUYAN HILIR, SERUYAN, KALIMANTAN TENGAH",3,54,13,67
https://kawalpemilu.org#61259,"JAHITAN, SERUYAN HILIR, SERUYAN, KALIMANTAN TENGAH",1,147,44,191
https://kawalpemilu.org#61259,"JAHITAN, SERUYAN HILIR, SERUYAN, KALIMANTAN TENGAH",2,66,5,71
https://kawalpemilu.org#61259,"JAHITAN, SERUYAN HILIR, SERUYAN, KALIMANTAN TENGAH",3,157,25,182
https://kawalpemilu.org#61259,"JAHITAN, SERUYAN HILIR, SERUYAN, KALIMANTAN TENGAH",4,79,34,113
https://kawalpemilu.org#61260,"BAUNG, SERUYAN HILIR, SERUYAN, KALIMANTAN TENGAH",1,75,58,133
https://kawalpemilu.org#61260,"BAUNG, SERUYAN HILIR, SERUYAN, KALIMANTAN TENGAH",2,68,43,111
https://kawalpemilu.org#61260,"BAUNG, SERUYAN HILIR, SERUYAN, KALIMANTAN TENGAH",3,65,70,135
https://kawalpemilu.org#61260,"BAUNG, SERUYAN HILIR, SERUYAN, KALIMANTAN TENGAH",4,70,67,137
https://kawalpemilu.org#61260,"BAUNG, SERUYAN HILIR, SERUYAN, KALIMANTAN TENGAH",5,106,30,136
https://kawalpemilu.org#61260,"BAUNG, SERUYAN HILIR, SERUYAN, KALIMANTAN TENGAH",6,136,9,145
https://kawalpemilu.org#61260,"BAUNG, SERUYAN HILIR, SERUYAN, KALIMANTAN TENGAH",7,104,31,135
https://kawalpemilu.org#61260,"BAUNG, SERUYAN HILIR, SERUYAN, KALIMANTAN TENGAH",8,104,39,143
https://kawalpemilu.org#61261,"PERSIL RAYA, SERUYAN HILIR, SERUYAN, KALIMANTAN TENGAH",1,57,67,124
https://kawalpemilu.org#61261,"PERSIL RAYA, SERUYAN HILIR, SERUYAN, KALIMANTAN TENGAH",2,77,60,137
https://kawalpemilu.org#61261,"PERSIL RAYA, SERUYAN HILIR, SERUYAN, KALIMANTAN TENGAH",3,123,80,203
https://kawalpemilu.org#61261,"PERSIL RAYA, SERUYAN HILIR, SERUYAN, KALIMANTAN TENGAH",4,138,68,202
https://kawalpemilu.org#61261,"PERSIL RAYA, SERUYAN HILIR, SERUYAN, KALIMANTAN TENGAH",5,116,37,153
https://kawalpemilu.org#61261,"PERSIL RAYA, SERUYAN HILIR, SERUYAN, KALIMANTAN TENGAH",6,118,38,156
https://kawalpemilu.org#61261,"PERSIL RAYA, SERUYAN HILIR, SERUYAN, KALIMANTAN TENGAH",7,100,26,126
https://kawalpemilu.org#61261,"PERSIL RAYA, SERUYAN HILIR, SERUYAN, KALIMANTAN TENGAH",8,98,75,173
https://kawalpemilu.org#61261,"PERSIL RAYA, SERUYAN HILIR, SERUYAN, KALIMANTAN TENGAH",9,87,58,145
https://kawalpemilu.org#61262,"SUNGAI UNDANG, SERUYAN HILIR, SERUYAN, KALIMANTAN TENGAH",1,145,77,222
https://kawalpemilu.org#61262,"SUNGAI UNDANG, SERUYAN HILIR, SERUYAN, KALIMANTAN TENGAH",2,126,57,183
https://kawalpemilu.org#61262,"SUNGAI UNDANG, SERUYAN HILIR, SERUYAN, KALIMANTAN TENGAH",3,98,38,136
https://kawalpemilu.org#61262,"SUNGAI UNDANG, SERUYAN HILIR, SERUYAN, KALIMANTAN TENGAH",4,79,32,111
https://kawalpemilu.org#61262,"SUNGAI UNDANG, SERUYAN HILIR, SERUYAN, KALIMANTAN TENGAH",5,113,39,152
https://kawalpemilu.org#61262,"SUNGAI UNDANG, SERUYAN HILIR, SERUYAN, KALIMANTAN TENGAH",6,184,40,224
https://kawalpemilu.org#61262,"SUNGAI UNDANG, SERUYAN HILIR, SERUYAN, KALIMANTAN TENGAH",7,134,17,151
https://kawalpemilu.org#61262,"SUNGAI UNDANG, SERUYAN HILIR, SERUYAN, KALIMANTAN TENGAH",8,88,14,102
https://kawalpemilu.org#61262,"SUNGAI UNDANG, SERUYAN HILIR, SERUYAN, KALIMANTAN TENGAH",9,26,0,26
https://kawalpemilu.org#61262,"SUNGAI UNDANG, SERUYAN HILIR, SERUYAN, KALIMANTAN TENGAH",10,95,29,124
https://kawalpemilu.org#61262,"SUNGAI UNDANG, SERUYAN HILIR, SERUYAN, KALIMANTAN TENGAH",11,78,55,131
https://kawalpemilu.org#61264,"RANTAU PULUT, SERUYAN TENGAH, SERUYAN, KALIMANTAN TENGAH",1,133,87,220
https://kawalpemilu.org#61264,"RANTAU PULUT, SERUYAN TENGAH, SERUYAN, KALIMANTAN TENGAH",2,100,76,176
https://kawalpemilu.org#61264,"RANTAU PULUT, SERUYAN TENGAH, SERUYAN, KALIMANTAN TENGAH",3,126,74,200
https://kawalpemilu.org#61264,"RANTAU PULUT, SERUYAN TENGAH, SERUYAN, KALIMANTAN TENGAH",4,138,66,204
https://kawalpemilu.org#61264,"RANTAU PULUT, SERUYAN TENGAH, SERUYAN, KALIMANTAN TENGAH",5,156,36,192
https://kawalpemilu.org#61264,"RANTAU PULUT, SERUYAN TENGAH, SERUYAN, KALIMANTAN TENGAH",6,150,43,193
https://kawalpemilu.org#61264,"RANTAU PULUT, SERUYAN TENGAH, SERUYAN, KALIMANTAN TENGAH",7,134,31,165
https://kawalpemilu.org#61264,"RANTAU PULUT, SERUYAN TENGAH, SERUYAN, KALIMANTAN TENGAH",8,122,56,178
https://kawalpemilu.org#61264,"RANTAU PULUT, SERUYAN TENGAH, SERUYAN, KALIMANTAN TENGAH",9,65,4,69
https://kawalpemilu.org#61265,"GANTUNG PENGAYUH, SERUYAN TENGAH, SERUYAN, KALIMANTAN TENGAH",1,124,13,137
https://kawalpemilu.org#61265,"GANTUNG PENGAYUH, SERUYAN TENGAH, SERUYAN, KALIMANTAN TENGAH",2,142,23,165
https://kawalpemilu.org#61265,"GANTUNG PENGAYUH, SERUYAN TENGAH, SERUYAN, KALIMANTAN TENGAH",3,167,11,178
https://kawalpemilu.org#61265,"GANTUNG PENGAYUH, SERUYAN TENGAH, SERUYAN, KALIMANTAN TENGAH",4,31,0,31
https://kawalpemilu.org#61265,"GANTUNG PENGAYUH, SERUYAN TENGAH, SERUYAN, KALIMANTAN TENGAH",5,43,10,53
https://kawalpemilu.org#61266,"TELUK BAYUR, SERUYAN TENGAH, SERUYAN, KALIMANTAN TENGAH",1,168,21,189
https://kawalpemilu.org#61267,"SUKA MANDANG, SERUYAN TENGAH, SERUYAN, KALIMANTAN TENGAH",1,191,9,200
https://kawalpemilu.org#61267,"SUKA MANDANG, SERUYAN TENGAH, SERUYAN, KALIMANTAN TENGAH",2,182,8,190
https://kawalpemilu.org#61267,"SUKA MANDANG, SERUYAN TENGAH, SERUYAN, KALIMANTAN TENGAH",3,165,24,189
https://kawalpemilu.org#61267,"SUKA MANDANG, SERUYAN TENGAH, SERUYAN, KALIMANTAN TENGAH",4,187,10,197
https://kawalpemilu.org#61267,"SUKA MANDANG, SERUYAN TENGAH, SERUYAN, KALIMANTAN TENGAH",5,102,54,156
https://kawalpemilu.org#61267,"SUKA MANDANG, SERUYAN TENGAH, SERUYAN, KALIMANTAN TENGAH",6,57,11,68
https://kawalpemilu.org#61267,"SUKA MANDANG, SERUYAN TENGAH, SERUYAN, KALIMANTAN TENGAH",7,145,20,165
https://kawalpemilu.org#61267,"SUKA MANDANG, SERUYAN TENGAH, SERUYAN, KALIMANTAN TENGAH",8,104,2,106
https://kawalpemilu.org#61267,"SUKA MANDANG, SERUYAN TENGAH, SERUYAN, KALIMANTAN TENGAH",9,183,18,201
https://kawalpemilu.org#61267,"SUKA MANDANG, SERUYAN TENGAH, SERUYAN, KALIMANTAN TENGAH",10,98,10,108
https://kawalpemilu.org#61268,"AYAWAN, SERUYAN TENGAH, SERUYAN, KALIMANTAN TENGAH",1,109,37,146
https://kawalpemilu.org#61268,"AYAWAN, SERUYAN TENGAH, SERUYAN, KALIMANTAN TENGAH",2,134,58,192
https://kawalpemilu.org#61268,"AYAWAN, SERUYAN TENGAH, SERUYAN, KALIMANTAN TENGAH",3,132,44,176
https://kawalpemilu.org#61268,"AYAWAN, SERUYAN TENGAH, SERUYAN, KALIMANTAN TENGAH",4,93,42,35
https://kawalpemilu.org#61268,"AYAWAN, SERUYAN TENGAH, SERUYAN, KALIMANTAN TENGAH",5,83,48,131
https://kawalpemilu.org#61268,"AYAWAN, SERUYAN TENGAH, SERUYAN, KALIMANTAN TENGAH",6,101,15,116
https://kawalpemilu.org#61268,"AYAWAN, SERUYAN TENGAH, SERUYAN, KALIMANTAN TENGAH",7,66,7,73
https://kawalpemilu.org#61269,"MUGI PANYUHU, SERUYAN TENGAH, SERUYAN, KALIMANTAN TENGAH",1,122,55,177
https://kawalpemilu.org#61270,"BUKIT BULUH, SERUYAN TENGAH, SERUYAN, KALIMANTAN TENGAH",1,101,58,159
https://kawalpemilu.org#61271,"TUMBANG BAI, SERUYAN TENGAH, SERUYAN, KALIMANTAN TENGAH",1,186,22,208
https://kawalpemilu.org#61271,"TUMBANG BAI, SERUYAN TENGAH, SERUYAN, KALIMANTAN TENGAH",2,183,30,213
https://kawalpemilu.org#61271,"TUMBANG BAI, SERUYAN TENGAH, SERUYAN, KALIMANTAN TENGAH",3,30,7,37
https://kawalpemilu.org#61272,"DURIAN TUNGGAL, SERUYAN TENGAH, SERUYAN, KALIMANTAN TENGAH",1,86,49,135
https://kawalpemilu.org#61272,"DURIAN TUNGGAL, SERUYAN TENGAH, SERUYAN, KALIMANTAN TENGAH",2,90,47,137
https://kawalpemilu.org#61274,"PANGKE, SERUYAN TENGAH, SERUYAN, KALIMANTAN TENGAH",1,96,41,137
https://kawalpemilu.org#61274,"PANGKE, SERUYAN TENGAH, SERUYAN, KALIMANTAN TENGAH",2,61,55,116
https://kawalpemilu.org#61275,"PANYUMPA, SERUYAN TENGAH, SERUYAN, KALIMANTAN TENGAH",1,175,11,186
https://kawalpemilu.org#61277,"SUKA MAJU, SERUYAN TENGAH, SERUYAN, KALIMANTAN TENGAH",1,121,22,143
https://kawalpemilu.org#61277,"SUKA MAJU, SERUYAN TENGAH, SERUYAN, KALIMANTAN TENGAH",2,134,23,157
https://kawalpemilu.org#61277,"SUKA MAJU, SERUYAN TENGAH, SERUYAN, KALIMANTAN TENGAH",3,170,36,206
https://kawalpemilu.org#61277,"SUKA MAJU, SERUYAN TENGAH, SERUYAN, KALIMANTAN TENGAH",4,176,10,186
https://kawalpemilu.org#61278,"SUKA MAKMUR, SERUYAN TENGAH, SERUYAN, KALIMANTAN TENGAH",1,207,32,239
https://kawalpemilu.org#61278,"SUKA MAKMUR, SERUYAN TENGAH, SERUYAN, KALIMANTAN TENGAH",2,236,20,256
https://kawalpemilu.org#61278,"SUKA MAKMUR, SERUYAN TENGAH, SERUYAN, KALIMANTAN TENGAH",3,144,16,159
https://kawalpemilu.org#61278,"SUKA MAKMUR, SERUYAN TENGAH, SERUYAN, KALIMANTAN TENGAH",4,151,18,169
https://kawalpemilu.org#61279,"SUKOREJO, SERUYAN TENGAH, SERUYAN, KALIMANTAN TENGAH",1,191,23,214
https://kawalpemilu.org#61279,"SUKOREJO, SERUYAN TENGAH, SERUYAN, KALIMANTAN TENGAH",2,179,14,193
https://kawalpemilu.org#61279,"SUKOREJO, SERUYAN TENGAH, SERUYAN, KALIMANTAN TENGAH",3,181,20,201
https://kawalpemilu.org#61279,"SUKOREJO, SERUYAN TENGAH, SERUYAN, KALIMANTAN TENGAH",4,225,22,247
https://kawalpemilu.org#61280,"BUMI JAYA, SERUYAN TENGAH, SERUYAN, KALIMANTAN TENGAH",1,179,25,204
https://kawalpemilu.org#61280,"BUMI JAYA, SERUYAN TENGAH, SERUYAN, KALIMANTAN TENGAH",2,155,30,185
https://kawalpemilu.org#61280,"BUMI JAYA, SERUYAN TENGAH, SERUYAN, KALIMANTAN TENGAH",3,173,21,194
https://kawalpemilu.org#61280,"BUMI JAYA, SERUYAN TENGAH, SERUYAN, KALIMANTAN TENGAH",4,175,31,206
https://kawalpemilu.org#61281,"SUKA JAYA, SERUYAN TENGAH, SERUYAN, KALIMANTAN TENGAH",1,191,29,220
https://kawalpemilu.org#61281,"SUKA JAYA, SERUYAN TENGAH, SERUYAN, KALIMANTAN TENGAH",2,171,28,199
https://kawalpemilu.org#61281,"SUKA JAYA, SERUYAN TENGAH, SERUYAN, KALIMANTAN TENGAH",3,180,24,204
https://kawalpemilu.org#61282,"RINGIN AGUNG, SERUYAN TENGAH, SERUYAN, KALIMANTAN TENGAH",1,108,16,124
https://kawalpemilu.org#61282,"RINGIN AGUNG, SERUYAN TENGAH, SERUYAN, KALIMANTAN TENGAH",3,107,14,121
https://kawalpemilu.org#61282,"RINGIN AGUNG, SERUYAN TENGAH, SERUYAN, KALIMANTAN TENGAH",4,37,27,64
https://kawalpemilu.org#61283,"PANCA JAYA, SERUYAN TENGAH, SERUYAN, KALIMANTAN TENGAH",1,139,15,154
https://kawalpemilu.org#61283,"PANCA JAYA, SERUYAN TENGAH, SERUYAN, KALIMANTAN TENGAH",2,95,31,126
https://kawalpemilu.org#92558,"TANGGA BATU, SERUYAN TENGAH, SERUYAN, KALIMANTAN TENGAH",1,88,45,133
https://kawalpemilu.org#92559,"BATU AGUNG, SERUYAN TENGAH, SERUYAN, KALIMANTAN TENGAH",1,165,28,193
https://kawalpemilu.org#92559,"BATU AGUNG, SERUYAN TENGAH, SERUYAN, KALIMANTAN TENGAH",2,185,41,226
https://kawalpemilu.org#92559,"BATU AGUNG, SERUYAN TENGAH, SERUYAN, KALIMANTAN TENGAH",3,172,31,203
https://kawalpemilu.org#92559,"BATU AGUNG, SERUYAN TENGAH, SERUYAN, KALIMANTAN TENGAH",4,182,21,203
https://kawalpemilu.org#61285,"TELAGA PULANG, DANAU SEMBULUH, SERUYAN, KALIMANTAN TENGAH",1,107,59,166
https://kawalpemilu.org#61285,"TELAGA PULANG, DANAU SEMBULUH, SERUYAN, KALIMANTAN TENGAH",2,122,63,185
https://kawalpemilu.org#61285,"TELAGA PULANG, DANAU SEMBULUH, SERUYAN, KALIMANTAN TENGAH",3,109,52,161
https://kawalpemilu.org#61285,"TELAGA PULANG, DANAU SEMBULUH, SERUYAN, KALIMANTAN TENGAH",4,88,35,123
https://kawalpemilu.org#61285,"TELAGA PULANG, DANAU SEMBULUH, SERUYAN, KALIMANTAN TENGAH",5,143,18,161
https://kawalpemilu.org#61285,"TELAGA PULANG, DANAU SEMBULUH, SERUYAN, KALIMANTAN TENGAH",6,108,14,122
https://kawalpemilu.org#61285,"TELAGA PULANG, DANAU SEMBULUH, SERUYAN, KALIMANTAN TENGAH",7,84,35,119
https://kawalpemilu.org#61286,"CEMPAKA BARU, DANAU SEMBULUH, SERUYAN, KALIMANTAN TENGAH",1,127,30,157
https://kawalpemilu.org#61286,"CEMPAKA BARU, DANAU SEMBULUH, SERUYAN, KALIMANTAN TENGAH",2,133,21,154
https://kawalpemilu.org#61287,"PALINGKAU, DANAU SEMBULUH, SERUYAN, KALIMANTAN TENGAH",1,74,36,110
https://kawalpemilu.org#61288,"ULAK BATU, DANAU SEMBULUH, SERUYAN, KALIMANTAN TENGAH",1,104,39,143
https://kawalpemilu.org#61288,"ULAK BATU, DANAU SEMBULUH, SERUYAN, KALIMANTAN TENGAH",2,8,1,9
https://kawalpemilu.org#61289,"PAREN, DANAU SEMBULUH, SERUYAN, KALIMANTAN TENGAH",1,101,20,121
https://kawalpemilu.org#61289,"PAREN, DANAU SEMBULUH, SERUYAN, KALIMANTAN TENGAH",2,88,37,125
https://kawalpemilu.org#61290,"BANUA USANG, DANAU SEMBULUH, SERUYAN, KALIMANTAN TENGAH",1,143,61,204
https://kawalpemilu.org#61290,"BANUA USANG, DANAU SEMBULUH, SERUYAN, KALIMANTAN TENGAH",2,153,39,192
https://kawalpemilu.org#61290,"BANUA USANG, DANAU SEMBULUH, SERUYAN, KALIMANTAN TENGAH",3,78,10,88
https://kawalpemilu.org#92563,"SEMBULUH I, DANAU SEMBULUH, SERUYAN, KALIMANTAN TENGAH",1,110,45,155
https://kawalpemilu.org#92563,"SEMBULUH I, DANAU SEMBULUH, SERUYAN, KALIMANTAN TENGAH",2,107,45,152
https://kawalpemilu.org#92563,"SEMBULUH I, DANAU SEMBULUH, SERUYAN, KALIMANTAN TENGAH",3,106,42,148
https://kawalpemilu.org#92563,"SEMBULUH I, DANAU SEMBULUH, SERUYAN, KALIMANTAN TENGAH",4,118,52,170
https://kawalpemilu.org#92563,"SEMBULUH I, DANAU SEMBULUH, SERUYAN, KALIMANTAN TENGAH",5,107,59,166
https://kawalpemilu.org#92563,"SEMBULUH I, DANAU SEMBULUH, SERUYAN, KALIMANTAN TENGAH",6,108,55,163
https://kawalpemilu.org#92563,"SEMBULUH I, DANAU SEMBULUH, SERUYAN, KALIMANTAN TENGAH",7,109,50,159
https://kawalpemilu.org#92563,"SEMBULUH I, DANAU SEMBULUH, SERUYAN, KALIMANTAN TENGAH",8,113,40,153
https://kawalpemilu.org#92563,"SEMBULUH I, DANAU SEMBULUH, SERUYAN, KALIMANTAN TENGAH",9,63,13,76
https://kawalpemilu.org#92563,"SEMBULUH I, DANAU SEMBULUH, SERUYAN, KALIMANTAN TENGAH",10,83,12,95
https://kawalpemilu.org#92563,"SEMBULUH I, DANAU SEMBULUH, SERUYAN, KALIMANTAN TENGAH",11,47,26,73
https://kawalpemilu.org#92563,"SEMBULUH I, DANAU SEMBULUH, SERUYAN, KALIMANTAN TENGAH",12,44,22,66
https://kawalpemilu.org#92563,"SEMBULUH I, DANAU SEMBULUH, SERUYAN, KALIMANTAN TENGAH",13,60,14,74
https://kawalpemilu.org#92563,"SEMBULUH I, DANAU SEMBULUH, SERUYAN, KALIMANTAN TENGAH",14,26,4,30
https://kawalpemilu.org#92563,"SEMBULUH I, DANAU SEMBULUH, SERUYAN, KALIMANTAN TENGAH",15,42,14,56
https://kawalpemilu.org#92564,"SEMBULUH II, DANAU SEMBULUH, SERUYAN, KALIMANTAN TENGAH",1,126,41,167
https://kawalpemilu.org#92564,"SEMBULUH II, DANAU SEMBULUH, SERUYAN, KALIMANTAN TENGAH",2,105,49,154
https://kawalpemilu.org#92564,"SEMBULUH II, DANAU SEMBULUH, SERUYAN, KALIMANTAN TENGAH",3,110,20,130
https://kawalpemilu.org#92564,"SEMBULUH II, DANAU SEMBULUH, SERUYAN, KALIMANTAN TENGAH",4,130,18,148
https://kawalpemilu.org#92564,"SEMBULUH II, DANAU SEMBULUH, SERUYAN, KALIMANTAN TENGAH",5,154,31,185
https://kawalpemilu.org#92564,"SEMBULUH II, DANAU SEMBULUH, SERUYAN, KALIMANTAN TENGAH",6,110,60,170
https://kawalpemilu.org#92564,"SEMBULUH II, DANAU SEMBULUH, SERUYAN, KALIMANTAN TENGAH",7,115,32,148
https://kawalpemilu.org#92564,"SEMBULUH II, DANAU SEMBULUH, SERUYAN, KALIMANTAN TENGAH",8,59,31,90
https://kawalpemilu.org#92564,"SEMBULUH II, DANAU SEMBULUH, SERUYAN, KALIMANTAN TENGAH",9,85,44,129
https://kawalpemilu.org#92564,"SEMBULUH II, DANAU SEMBULUH, SERUYAN, KALIMANTAN TENGAH",10,67,28,95
https://kawalpemilu.org#92564,"SEMBULUH II, DANAU SEMBULUH, SERUYAN, KALIMANTAN TENGAH",11,63,23,86
https://kawalpemilu.org#92564,"SEMBULUH II, DANAU SEMBULUH, SERUYAN, KALIMANTAN TENGAH",12,23,11,34
https://kawalpemilu.org#92564,"SEMBULUH II, DANAU SEMBULUH, SERUYAN, KALIMANTAN TENGAH",13,136,24,160
https://kawalpemilu.org#92564,"SEMBULUH II, DANAU SEMBULUH, SERUYAN, KALIMANTAN TENGAH",14,178,58,236
https://kawalpemilu.org#61294,"TANJUNG HANAU, HANAU, SERUYAN, KALIMANTAN TENGAH",1,157,50,207
https://kawalpemilu.org#61294,"TANJUNG HANAU, HANAU, SERUYAN, KALIMANTAN TENGAH",2,79,16,95
https://kawalpemilu.org#61294,"TANJUNG HANAU, HANAU, SERUYAN, KALIMANTAN TENGAH",3,96,26,122
https://kawalpemilu.org#61294,"TANJUNG HANAU, HANAU, SERUYAN, KALIMANTAN TENGAH",4,87,21,108
https://kawalpemilu.org#61295,"PARANG BATANG, HANAU, SERUYAN, KALIMANTAN TENGAH",1,100,77,177
https://kawalpemilu.org#61295,"PARANG BATANG, HANAU, SERUYAN, KALIMANTAN TENGAH",2,84,88,172
https://kawalpemilu.org#61295,"PARANG BATANG, HANAU, SERUYAN, KALIMANTAN TENGAH",3,67,22,89
https://kawalpemilu.org#61295,"PARANG BATANG, HANAU, SERUYAN, KALIMANTAN TENGAH",4,157,39,196
https://kawalpemilu.org#61296,"BAHAUR, HANAU, SERUYAN, KALIMANTAN TENGAH",1,86,134,220
https://kawalpemilu.org#61296,"BAHAUR, HANAU, SERUYAN, KALIMANTAN TENGAH",2,111,133,244
https://kawalpemilu.org#61296,"BAHAUR, HANAU, SERUYAN, KALIMANTAN TENGAH",3,67,34,101
https://kawalpemilu.org#61296,"BAHAUR, HANAU, SERUYAN, KALIMANTAN TENGAH",4,63,8,71
https://kawalpemilu.org#61296,"BAHAUR, HANAU, SERUYAN, KALIMANTAN TENGAH",5,49,23,72
https://kawalpemilu.org#61297,"PEMBUANG HULU I, HANAU, SERUYAN, KALIMANTAN TENGAH",1,69,183,252
https://kawalpemilu.org#61297,"PEMBUANG HULU I, HANAU, SERUYAN, KALIMANTAN TENGAH",2,75,172,247
https://kawalpemilu.org#61297,"PEMBUANG HULU I, HANAU, SERUYAN, KALIMANTAN TENGAH",3,84,136,219
https://kawalpemilu.org#61297,"PEMBUANG HULU I, HANAU, SERUYAN, KALIMANTAN TENGAH",4,89,167,256
https://kawalpemilu.org#61297,"PEMBUANG HULU I, HANAU, SERUYAN, KALIMANTAN TENGAH",5,103,147,250
https://kawalpemilu.org#61297,"PEMBUANG HULU I, HANAU, SERUYAN, KALIMANTAN TENGAH",6,70,136,206
https://kawalpemilu.org#61297,"PEMBUANG HULU I, HANAU, SERUYAN, KALIMANTAN TENGAH",7,55,98,153
https://kawalpemilu.org#61297,"PEMBUANG HULU I, HANAU, SERUYAN, KALIMANTAN TENGAH",8,128,117,245
https://kawalpemilu.org#61297,"PEMBUANG HULU I, HANAU, SERUYAN, KALIMANTAN TENGAH",9,117,140,257
https://kawalpemilu.org#61297,"PEMBUANG HULU I, HANAU, SERUYAN, KALIMANTAN TENGAH",10,116,152,268
https://kawalpemilu.org#61297,"PEMBUANG HULU I, HANAU, SERUYAN, KALIMANTAN TENGAH",11,72,24,96
https://kawalpemilu.org#61297,"PEMBUANG HULU I, HANAU, SERUYAN, KALIMANTAN TENGAH",12,174,40,214
https://kawalpemilu.org#61297,"PEMBUANG HULU I, HANAU, SERUYAN, KALIMANTAN TENGAH",13,92,35,127
https://kawalpemilu.org#61297,"PEMBUANG HULU I, HANAU, SERUYAN, KALIMANTAN TENGAH",14,28,79,107
https://kawalpemilu.org#61297,"PEMBUANG HULU I, HANAU, SERUYAN, KALIMANTAN TENGAH",15,70,61,131
https://kawalpemilu.org#61298,"PEMBUANG HULU II, HANAU, SERUYAN, KALIMANTAN TENGAH",1,99,149,248
https://kawalpemilu.org#61298,"PEMBUANG HULU II, HANAU, SERUYAN, KALIMANTAN TENGAH",2,85,191,276
https://kawalpemilu.org#61298,"PEMBUANG HULU II, HANAU, SERUYAN, KALIMANTAN TENGAH",3,66,160,226
https://kawalpemilu.org#61298,"PEMBUANG HULU II, HANAU, SERUYAN, KALIMANTAN TENGAH",4,71,105,176
https://kawalpemilu.org#61298,"PEMBUANG HULU II, HANAU, SERUYAN, KALIMANTAN TENGAH",5,73,150,223
https://kawalpemilu.org#61298,"PEMBUANG HULU II, HANAU, SERUYAN, KALIMANTAN TENGAH",6,88,138,226
https://kawalpemilu.org#61298,"PEMBUANG HULU II, HANAU, SERUYAN, KALIMANTAN TENGAH",8,77,184,261
https://kawalpemilu.org#61298,"PEMBUANG HULU II, HANAU, SERUYAN, KALIMANTAN TENGAH",9,129,51,180
https://kawalpemilu.org#61298,"PEMBUANG HULU II, HANAU, SERUYAN, KALIMANTAN TENGAH",10,152,21,173
https://kawalpemilu.org#61298,"PEMBUANG HULU II, HANAU, SERUYAN, KALIMANTAN TENGAH",11,142,17,159
https://kawalpemilu.org#61298,"PEMBUANG HULU II, HANAU, SERUYAN, KALIMANTAN TENGAH",12,96,16,112
https://kawalpemilu.org#61298,"PEMBUANG HULU II, HANAU, SERUYAN, KALIMANTAN TENGAH",13,71,58,129
https://kawalpemilu.org#61298,"PEMBUANG HULU II, HANAU, SERUYAN, KALIMANTAN TENGAH",14,71,67,138
https://kawalpemilu.org#61299,"DERANGGA, HANAU, SERUYAN, KALIMANTAN TENGAH",1,98,104,202
https://kawalpemilu.org#61299,"DERANGGA, HANAU, SERUYAN, KALIMANTAN TENGAH",2,129,90,219
https://kawalpemilu.org#61299,"DERANGGA, HANAU, SERUYAN, KALIMANTAN TENGAH",3,105,75,180
https://kawalpemilu.org#61299,"DERANGGA, HANAU, SERUYAN, KALIMANTAN TENGAH",4,83,61,144
https://kawalpemilu.org#61299,"DERANGGA, HANAU, SERUYAN, KALIMANTAN TENGAH",5,155,29,184
https://kawalpemilu.org#61299,"DERANGGA, HANAU, SERUYAN, KALIMANTAN TENGAH",6,144,59,203
https://kawalpemilu.org#61299,"DERANGGA, HANAU, SERUYAN, KALIMANTAN TENGAH",7,149,72,221
https://kawalpemilu.org#61299,"DERANGGA, HANAU, SERUYAN, KALIMANTAN TENGAH",8,231,34,265
https://kawalpemilu.org#61299,"DERANGGA, HANAU, SERUYAN, KALIMANTAN TENGAH",9,41,7,48
https://kawalpemilu.org#61299,"DERANGGA, HANAU, SERUYAN, KALIMANTAN TENGAH",10,87,37,124
https://kawalpemilu.org#61300,"PARING RAYA, HANAU, SERUYAN, KALIMANTAN TENGAH",1,89,48,137
https://kawalpemilu.org#61300,"PARING RAYA, HANAU, SERUYAN, KALIMANTAN TENGAH",2,84,9,93
https://kawalpemilu.org#61300,"PARING RAYA, HANAU, SERUYAN, KALIMANTAN TENGAH",3,69,42,111
https://kawalpemilu.org#61313,"TUMBANG BAHAN, SERUYAN HULU, SERUYAN, KALIMANTAN TENGAH",1,102,74,176
https://kawalpemilu.org#61314,"TUMBANG KALAM, SERUYAN HULU, SERUYAN, KALIMANTAN TENGAH",1,128,6,134
https://kawalpemilu.org#61315,"TUSUK BELAWAN, SERUYAN HULU, SERUYAN, KALIMANTAN TENGAH",1,82,75,157
https://kawalpemilu.org#61316,"MARANDANG, SERUYAN HULU, SERUYAN, KALIMANTAN TENGAH",1,53,47,100
https://kawalpemilu.org#92570,"TANJUNG PAKU, SERUYAN HULU, SERUYAN, KALIMANTAN TENGAH",1,109,4,113
https://kawalpemilu.org#92570,"TANJUNG PAKU, SERUYAN HULU, SERUYAN, KALIMANTAN TENGAH",2,126,10,136
https://kawalpemilu.org#92570,"TANJUNG PAKU, SERUYAN HULU, SERUYAN, KALIMANTAN TENGAH",3,94,8,102
https://kawalpemilu.org#92571,"TUMBANG TABERAU, SERUYAN HULU, SERUYAN, KALIMANTAN TENGAH",1,77,7,84
https://kawalpemilu.org#61323,"MEKAR INDAH, SERUYAN HILIR TIMUR, SERUYAN, KALIMANTAN TENGAH",1,97,28,125
https://kawalpemilu.org#61323,"MEKAR INDAH, SERUYAN HILIR TIMUR, SERUYAN, KALIMANTAN TENGAH",2,138,22,160
https://kawalpemilu.org#61323,"MEKAR INDAH, SERUYAN HILIR TIMUR, SERUYAN, KALIMANTAN TENGAH",3,82,19,101
https://kawalpemilu.org#61324,"HALIMAUNG JAYA, SERUYAN HILIR TIMUR, SERUYAN, KALIMANTAN TENGAH",1,160,37,197
https://kawalpemilu.org#61324,"HALIMAUNG JAYA, SERUYAN HILIR TIMUR, SERUYAN, KALIMANTAN TENGAH",2,177,32,209
https://kawalpemilu.org#61325,"BANGUN HARJA, SERUYAN HILIR TIMUR, SERUYAN, KALIMANTAN TENGAH",1,152,82,234
https://kawalpemilu.org#61325,"BANGUN HARJA, SERUYAN HILIR TIMUR, SERUYAN, KALIMANTAN TENGAH",2,133,66,199
https://kawalpemilu.org#61325,"BANGUN HARJA, SERUYAN HILIR TIMUR, SERUYAN, KALIMANTAN TENGAH",3,142,59,201
https://kawalpemilu.org#61326,"KARTIKA BHAKTI, SERUYAN HILIR TIMUR, SERUYAN, KALIMANTAN TENGAH",1,118,103,221
https://kawalpemilu.org#61326,"KARTIKA BHAKTI, SERUYAN HILIR TIMUR, SERUYAN, KALIMANTAN TENGAH",2,105,87,192
https://kawalpemilu.org#61326,"KARTIKA BHAKTI, SERUYAN HILIR TIMUR, SERUYAN, KALIMANTAN TENGAH",3,126,88,214
https://kawalpemilu.org#61326,"KARTIKA BHAKTI, SERUYAN HILIR TIMUR, SERUYAN, KALIMANTAN TENGAH",4,164,69,233
https://kawalpemilu.org#61327,"PEMATANG PANJANG, SERUYAN HILIR TIMUR, SERUYAN, KALIMANTAN TENGAH",1,121,91,212
https://kawalpemilu.org#61327,"PEMATANG PANJANG, SERUYAN HILIR TIMUR, SERUYAN, KALIMANTAN TENGAH",2,90,108,198
https://kawalpemilu.org#61327,"PEMATANG PANJANG, SERUYAN HILIR TIMUR, SERUYAN, KALIMANTAN TENGAH",3,137,89,226
https://kawalpemilu.org#61327,"PEMATANG PANJANG, SERUYAN HILIR TIMUR, SERUYAN, KALIMANTAN TENGAH",4,54,153,207
https://kawalpemilu.org#61327,"PEMATANG PANJANG, SERUYAN HILIR TIMUR, SERUYAN, KALIMANTAN TENGAH",5,105,131,236
https://kawalpemilu.org#61327,"PEMATANG PANJANG, SERUYAN HILIR TIMUR, SERUYAN, KALIMANTAN TENGAH",6,91,116,207
https://kawalpemilu.org#61327,"PEMATANG PANJANG, SERUYAN HILIR TIMUR, SERUYAN, KALIMANTAN TENGAH",8,140,66,206
https://kawalpemilu.org#61327,"PEMATANG PANJANG, SERUYAN HILIR TIMUR, SERUYAN, KALIMANTAN TENGAH",9,95,58,153
https://kawalpemilu.org#61327,"PEMATANG PANJANG, SERUYAN HILIR TIMUR, SERUYAN, KALIMANTAN TENGAH",10,110,111,221
https://kawalpemilu.org#61327,"PEMATANG PANJANG, SERUYAN HILIR TIMUR, SERUYAN, KALIMANTAN TENGAH",11,37,50,87
https://kawalpemilu.org#61328,"SUNGAI BAKAU, SERUYAN HILIR TIMUR, SERUYAN, KALIMANTAN TENGAH",1,130,68,198
https://kawalpemilu.org#61328,"SUNGAI BAKAU, SERUYAN HILIR TIMUR, SERUYAN, KALIMANTAN TENGAH",2,129,81,210
https://kawalpemilu.org#61328,"SUNGAI BAKAU, SERUYAN HILIR TIMUR, SERUYAN, KALIMANTAN TENGAH",3,111,77,188
https://kawalpemilu.org#61330,"TERAWAN, SERUYAN RAYA, SERUYAN, KALIMANTAN TENGAH",1,165,50,215
https://kawalpemilu.org#61330,"TERAWAN, SERUYAN RAYA, SERUYAN, KALIMANTAN TENGAH",3,144,51,195
https://kawalpemilu.org#61330,"TERAWAN, SERUYAN RAYA, SERUYAN, KALIMANTAN TENGAH",4,111,32,143
https://kawalpemilu.org#61330,"TERAWAN, SERUYAN RAYA, SERUYAN, KALIMANTAN TENGAH",5,123,40,163
https://kawalpemilu.org#61330,"TERAWAN, SERUYAN RAYA, SERUYAN, KALIMANTAN TENGAH",6,186,29,215
https://kawalpemilu.org#61330,"TERAWAN, SERUYAN RAYA, SERUYAN, KALIMANTAN TENGAH",7,150,17,167
https://kawalpemilu.org#61330,"TERAWAN, SERUYAN RAYA, SERUYAN, KALIMANTAN TENGAH",8,124,36,160
https://kawalpemilu.org#61330,"TERAWAN, SERUYAN RAYA, SERUYAN, KALIMANTAN TENGAH",9,160,26,186
https://kawalpemilu.org#61330,"TERAWAN, SERUYAN RAYA, SERUYAN, KALIMANTAN TENGAH",10,170,30,201
https://kawalpemilu.org#61331,"SELUNUK, SERUYAN RAYA, SERUYAN, KALIMANTAN TENGAH",1,156,38,194
https://kawalpemilu.org#61331,"SELUNUK, SERUYAN RAYA, SERUYAN, KALIMANTAN TENGAH",2,132,15,147
https://kawalpemilu.org#61331,"SELUNUK, SERUYAN RAYA, SERUYAN, KALIMANTAN TENGAH",3,190,36,226
https://kawalpemilu.org#61331,"SELUNUK, SERUYAN RAYA, SERUYAN, KALIMANTAN TENGAH",4,126,34,160
https://kawalpemilu.org#61331,"SELUNUK, SERUYAN RAYA, SERUYAN, KALIMANTAN TENGAH",5,78,17,95
https://kawalpemilu.org#61331,"SELUNUK, SERUYAN RAYA, SERUYAN, KALIMANTAN TENGAH",6,136,21,151
https://kawalpemilu.org#61331,"SELUNUK, SERUYAN RAYA, SERUYAN, KALIMANTAN TENGAH",7,101,15,116
https://kawalpemilu.org#61331,"SELUNUK, SERUYAN RAYA, SERUYAN, KALIMANTAN TENGAH",8,107,33,140
https://kawalpemilu.org#61331,"SELUNUK, SERUYAN RAYA, SERUYAN, KALIMANTAN TENGAH",9,172,31,203
https://kawalpemilu.org#61331,"SELUNUK, SERUYAN RAYA, SERUYAN, KALIMANTAN TENGAH",10,123,3,126
https://kawalpemilu.org#61331,"SELUNUK, SERUYAN RAYA, SERUYAN, KALIMANTAN TENGAH",11,190,18,208
https://kawalpemilu.org#61331,"SELUNUK, SERUYAN RAYA, SERUYAN, KALIMANTAN TENGAH",12,96,7,103
https://kawalpemilu.org#61331,"SELUNUK, SERUYAN RAYA, SERUYAN, KALIMANTAN TENGAH",13,88,10,98
https://kawalpemilu.org#61331,"SELUNUK, SERUYAN RAYA, SERUYAN, KALIMANTAN TENGAH",14,130,16,146
https://kawalpemilu.org#61331,"SELUNUK, SERUYAN RAYA, SERUYAN, KALIMANTAN TENGAH",15,105,20,125
https://kawalpemilu.org#61332,"LANPASA, SERUYAN RAYA, SERUYAN, KALIMANTAN TENGAH",1,117,58,175
https://kawalpemilu.org#61332,"LANPASA, SERUYAN RAYA, SERUYAN, KALIMANTAN TENGAH",3,149,37,186
https://kawalpemilu.org#61332,"LANPASA, SERUYAN RAYA, SERUYAN, KALIMANTAN TENGAH",4,143,26,169
https://kawalpemilu.org#61332,"LANPASA, SERUYAN RAYA, SERUYAN, KALIMANTAN TENGAH",5,170,17,187
https://kawalpemilu.org#61332,"LANPASA, SERUYAN RAYA, SERUYAN, KALIMANTAN TENGAH",6,148,68,216
https://kawalpemilu.org#61333,"TABIKU, SERUYAN RAYA, SERUYAN, KALIMANTAN TENGAH",1,84,75,159
https://kawalpemilu.org#61333,"TABIKU, SERUYAN RAYA, SERUYAN, KALIMANTAN TENGAH",2,100,77,177
https://kawalpemilu.org#61333,"TABIKU, SERUYAN RAYA, SERUYAN, KALIMANTAN TENGAH",3,108,68,176
https://kawalpemilu.org#61333,"TABIKU, SERUYAN RAYA, SERUYAN, KALIMANTAN TENGAH",4,153,32,185
https://kawalpemilu.org#61333,"TABIKU, SERUYAN RAYA, SERUYAN, KALIMANTAN TENGAH",5,256,41,297
https://kawalpemilu.org#61334,"BANGKAL, SERUYAN RAYA, SERUYAN, KALIMANTAN TENGAH",1,159,15,174
https://kawalpemilu.org#61334,"BANGKAL, SERUYAN RAYA, SERUYAN, KALIMANTAN TENGAH",2,169,20,189
https://kawalpemilu.org#61334,"BANGKAL, SERUYAN RAYA, SERUYAN, KALIMANTAN TENGAH",3,170,7,177
https://kawalpemilu.org#61334,"BANGKAL, SERUYAN RAYA, SERUYAN, KALIMANTAN TENGAH",4,138,7,145
https://kawalpemilu.org#61334,"BANGKAL, SERUYAN RAYA, SERUYAN, KALIMANTAN TENGAH",5,136,19,155
https://kawalpemilu.org#61334,"BANGKAL, SERUYAN RAYA, SERUYAN, KALIMANTAN TENGAH",6,102,12,114
https://kawalpemilu.org#61334,"BANGKAL, SERUYAN RAYA, SERUYAN, KALIMANTAN TENGAH",7,111,13,124
https://kawalpemilu.org#61334,"BANGKAL, SERUYAN RAYA, SERUYAN, KALIMANTAN TENGAH",8,157,31,188
https://kawalpemilu.org#61334,"BANGKAL, SERUYAN RAYA, SERUYAN, KALIMANTAN TENGAH",9,109,38,147
https://kawalpemilu.org#61334,"BANGKAL, SERUYAN RAYA, SERUYAN, KALIMANTAN TENGAH",10,64,15,76
https://kawalpemilu.org#61334,"BANGKAL, SERUYAN RAYA, SERUYAN, KALIMANTAN TENGAH",11,87,25,112
https://kawalpemilu.org#61334,"BANGKAL, SERUYAN RAYA, SERUYAN, KALIMANTAN TENGAH",12,272,101,373
https://kawalpemilu.org#61336,"ASAM BARU, DANAU SELULUK, SERUYAN, KALIMANTAN TENGAH",1,0,0,0
https://kawalpemilu.org#61336,"ASAM BARU, DANAU SELULUK, SERUYAN, KALIMANTAN TENGAH",2,170,48,218
https://kawalpemilu.org#61336,"ASAM BARU, DANAU SELULUK, SERUYAN, KALIMANTAN TENGAH",3,131,105,236
https://kawalpemilu.org#61336,"ASAM BARU, DANAU SELULUK, SERUYAN, KALIMANTAN TENGAH",4,98,52,150
https://kawalpemilu.org#61336,"ASAM BARU, DANAU SELULUK, SERUYAN, KALIMANTAN TENGAH",5,125,83,208
https://kawalpemilu.org#61336,"ASAM BARU, DANAU SELULUK, SERUYAN, KALIMANTAN TENGAH",6,142,58,200
https://kawalpemilu.org#61336,"ASAM BARU, DANAU SELULUK, SERUYAN, KALIMANTAN TENGAH",7,109,36,145
https://kawalpemilu.org#61336,"ASAM BARU, DANAU SELULUK, SERUYAN, KALIMANTAN TENGAH",8,138,29,167
https://kawalpemilu.org#61336,"ASAM BARU, DANAU SELULUK, SERUYAN, KALIMANTAN TENGAH",9,154,18,172
https://kawalpemilu.org#61336,"ASAM BARU, DANAU SELULUK, SERUYAN, KALIMANTAN TENGAH",10,109,6,115
https://kawalpemilu.org#61336,"ASAM BARU, DANAU SELULUK, SERUYAN, KALIMANTAN TENGAH",11,97,14,111
https://kawalpemilu.org#61336,"ASAM BARU, DANAU SELULUK, SERUYAN, KALIMANTAN TENGAH",12,83,30,113
https://kawalpemilu.org#61336,"ASAM BARU, DANAU SELULUK, SERUYAN, KALIMANTAN TENGAH",13,114,35,149
https://kawalpemilu.org#61337,"TANJUNG HARA, DANAU SELULUK, SERUYAN, KALIMANTAN TENGAH",1,98,103,201
https://kawalpemilu.org#61337,"TANJUNG HARA, DANAU SELULUK, SERUYAN, KALIMANTAN TENGAH",2,86,110,196
https://kawalpemilu.org#61338,"TANJUNG PARING, DANAU SELULUK, SERUYAN, KALIMANTAN TENGAH",1,116,40,156
https://kawalpemilu.org#61338,"TANJUNG PARING, DANAU SELULUK, SERUYAN, KALIMANTAN TENGAH",2,131,57,185
https://kawalpemilu.org#61338,"TANJUNG PARING, DANAU SELULUK, SERUYAN, KALIMANTAN TENGAH",3,176,14,190
https://kawalpemilu.org#61339,"TANJUNG RANGAS II, DANAU SELULUK, SERUYAN, KALIMANTAN TENGAH",1,105,47,152
https://kawalpemilu.org#61339,"TANJUNG RANGAS II, DANAU SELULUK, SERUYAN, KALIMANTAN TENGAH",2,111,7,118
https://kawalpemilu.org#61340,"PANIMBA RAYA, DANAU SELULUK, SERUYAN, KALIMANTAN TENGAH",1,58,67,125
https://kawalpemilu.org#61341,"RUNGAU RAYA, DANAU SELULUK, SERUYAN, KALIMANTAN TENGAH",1,187,40,227
https://kawalpemilu.org#61341,"RUNGAU RAYA, DANAU SELULUK, SERUYAN, KALIMANTAN TENGAH",2,114,42,158
https://kawalpemilu.org#61341,"RUNGAU RAYA, DANAU SELULUK, SERUYAN, KALIMANTAN TENGAH",3,117,26,143
https://kawalpemilu.org#61341,"RUNGAU RAYA, DANAU SELULUK, SERUYAN, KALIMANTAN TENGAH",4,118,36,154
https://kawalpemilu.org#61341,"RUNGAU RAYA, DANAU SELULUK, SERUYAN, KALIMANTAN TENGAH",5,140,61,201
https://kawalpemilu.org#61341,"RUNGAU RAYA, DANAU SELULUK, SERUYAN, KALIMANTAN TENGAH",6,102,10,112
https://kawalpemilu.org#61341,"RUNGAU RAYA, DANAU SELULUK, SERUYAN, KALIMANTAN TENGAH",7,162,40,202
https://kawalpemilu.org#61341,"RUNGAU RAYA, DANAU SELULUK, SERUYAN, KALIMANTAN TENGAH",8,153,39,192
https://kawalpemilu.org#61341,"RUNGAU RAYA, DANAU SELULUK, SERUYAN, KALIMANTAN TENGAH",9,109,7,116
https://kawalpemilu.org#61341,"RUNGAU RAYA, DANAU SELULUK, SERUYAN, KALIMANTAN TENGAH",10,201,13,214
https://kawalpemilu.org#61341,"RUNGAU RAYA, DANAU SELULUK, SERUYAN, KALIMANTAN TENGAH",11,164,7,171
https://kawalpemilu.org#61341,"RUNGAU RAYA, DANAU SELULUK, SERUYAN, KALIMANTAN TENGAH",12,217,24,241
https://kawalpemilu.org#61341,"RUNGAU RAYA, DANAU SELULUK, SERUYAN, KALIMANTAN TENGAH",13,163,30,193
https://kawalpemilu.org#61341,"RUNGAU RAYA, DANAU SELULUK, SERUYAN, KALIMANTAN TENGAH",14,145,20,165
https://kawalpemilu.org#61341,"RUNGAU RAYA, DANAU SELULUK, SERUYAN, KALIMANTAN TENGAH",15,226,54,280
https://kawalpemilu.org#61341,"RUNGAU RAYA, DANAU SELULUK, SERUYAN, KALIMANTAN TENGAH",16,169,27,169
https://kawalpemilu.org#61341,"RUNGAU RAYA, DANAU SELULUK, SERUYAN, KALIMANTAN TENGAH",17,65,37,102
https://kawalpemilu.org#61341,"RUNGAU RAYA, DANAU SELULUK, SERUYAN, KALIMANTAN TENGAH",18,173,28,201
https://kawalpemilu.org#61341,"RUNGAU RAYA, DANAU SELULUK, SERUYAN, KALIMANTAN TENGAH",19,225,30,255
https://kawalpemilu.org#61341,"RUNGAU RAYA, DANAU SELULUK, SERUYAN, KALIMANTAN TENGAH",20,64,12,76
https://kawalpemilu.org#61341,"RUNGAU RAYA, DANAU SELULUK, SERUYAN, KALIMANTAN TENGAH",21,214,26,240
https://kawalpemilu.org#61341,"RUNGAU RAYA, DANAU SELULUK, SERUYAN, KALIMANTAN TENGAH",22,152,9,161
https://kawalpemilu.org#61341,"RUNGAU RAYA, DANAU SELULUK, SERUYAN, KALIMANTAN TENGAH",23,128,44,172
https://kawalpemilu.org#61343,"SEBABI, BATU AMPAR, SERUYAN, KALIMANTAN TENGAH",1,113,37,150
https://kawalpemilu.org#61343,"SEBABI, BATU AMPAR, SERUYAN, KALIMANTAN TENGAH",2,126,48,174
https://kawalpemilu.org#61343,"SEBABI, BATU AMPAR, SERUYAN, KALIMANTAN TENGAH",3,24,3,27
https://kawalpemilu.org#61343,"SEBABI, BATU AMPAR, SERUYAN, KALIMANTAN TENGAH",4,28,0,28
https://kawalpemilu.org#61344,"SANDUL, BATU AMPAR, SERUYAN, KALIMANTAN TENGAH",1,48,116,164
https://kawalpemilu.org#61344,"SANDUL, BATU AMPAR, SERUYAN, KALIMANTAN TENGAH",2,60,121,181
https://kawalpemilu.org#61344,"SANDUL, BATU AMPAR, SERUYAN, KALIMANTAN TENGAH",3,98,79,177
https://kawalpemilu.org#61344,"SANDUL, BATU AMPAR, SERUYAN, KALIMANTAN TENGAH",4,73,72,145
https://kawalpemilu.org#61344,"SANDUL, BATU AMPAR, SERUYAN, KALIMANTAN TENGAH",5,101,76,177
https://kawalpemilu.org#61344,"SANDUL, BATU AMPAR, SERUYAN, KALIMANTAN TENGAH",6,121,53,174
https://kawalpemilu.org#61344,"SANDUL, BATU AMPAR, SERUYAN, KALIMANTAN TENGAH",7,95,12,107
https://kawalpemilu.org#61345,"KALANG, BATU AMPAR, SERUYAN, KALIMANTAN TENGAH",1,112,87,189
https://kawalpemilu.org#61345,"KALANG, BATU AMPAR, SERUYAN, KALIMANTAN TENGAH",2,129,15,144
https://kawalpemilu.org#61346,"DERAWA, BATU AMPAR, SERUYAN, KALIMANTAN TENGAH",1,228,14,242
https://kawalpemilu.org#61347,"WANA TIRTA, BATU AMPAR, SERUYAN, KALIMANTAN TENGAH",1,154,29,183
https://kawalpemilu.org#61347,"WANA TIRTA, BATU AMPAR, SERUYAN, KALIMANTAN TENGAH",2,160,25,185
https://kawalpemilu.org#61347,"WANA TIRTA, BATU AMPAR, SERUYAN, KALIMANTAN TENGAH",3,107,19,126
https://kawalpemilu.org#61347,"WANA TIRTA, BATU AMPAR, SERUYAN, KALIMANTAN TENGAH",4,111,10,121
https://kawalpemilu.org#61347,"WANA TIRTA, BATU AMPAR, SERUYAN, KALIMANTAN TENGAH",5,59,15,74
https://kawalpemilu.org#61348,"SUKA MULYA, BATU AMPAR, SERUYAN, KALIMANTAN TENGAH",1,138,46,184
https://kawalpemilu.org#61348,"SUKA MULYA, BATU AMPAR, SERUYAN, KALIMANTAN TENGAH",2,107,35,142
https://kawalpemilu.org#61348,"SUKA MULYA, BATU AMPAR, SERUYAN, KALIMANTAN TENGAH",3,124,34,158
https://kawalpemilu.org#61349,"DURIAN KAIT, BATU AMPAR, SERUYAN, KALIMANTAN TENGAH",1,187,7,194
https://kawalpemilu.org#61349,"DURIAN KAIT, BATU AMPAR, SERUYAN, KALIMANTAN TENGAH",2,225,15,240
https://kawalpemilu.org#61350,"SAHABU, BATU AMPAR, SERUYAN, KALIMANTAN TENGAH",1,65,30,95
https://kawalpemilu.org#61350,"SAHABU, BATU AMPAR, SERUYAN, KALIMANTAN TENGAH",2,137,35,172
https://kawalpemilu.org#61350,"SAHABU, BATU AMPAR, SERUYAN, KALIMANTAN TENGAH",3,102,20,122
https://kawalpemilu.org#61350,"SAHABU, BATU AMPAR, SERUYAN, KALIMANTAN TENGAH",4,168,44,212
https://kawalpemilu.org#61350,"SAHABU, BATU AMPAR, SERUYAN, KALIMANTAN TENGAH",5,129,24,153
https://kawalpemilu.org#61351,"BATU MENANGIS, BATU AMPAR, SERUYAN, KALIMANTAN TENGAH",1,74,29,103
https://kawalpemilu.org#61353,"TUMBANG MAGIN, SULING TAMBUN, SERUYAN, KALIMANTAN TENGAH",1,79,21,100
https://kawalpemilu.org#61355,"TUMBANG HENTAS, SULING TAMBUN, SERUYAN, KALIMANTAN TENGAH",1,21,12,33
https://kawalpemilu.org#61360,"TANJUNG TUKAL, SULING TAMBUN, SERUYAN, KALIMANTAN TENGAH",1,42,27,69
https://kawalpemilu.org#61361,"RANTAU BETUNG, SULING TAMBUN, SERUYAN, KALIMANTAN TENGAH",1,101,23,124
https://kawalpemilu.org#61364,"MENDAWAI, SUKAMARA, SUKAMARA, KALIMANTAN TENGAH",1,161,88,249
https://kawalpemilu.org#61364,"MENDAWAI, SUKAMARA, SUKAMARA, KALIMANTAN TENGAH",2,139,92,231
https://kawalpemilu.org#61364,"MENDAWAI, SUKAMARA, SUKAMARA, KALIMANTAN TENGAH",3,129,81,210
https://kawalpemilu.org#61364,"MENDAWAI, SUKAMARA, SUKAMARA, KALIMANTAN TENGAH",4,149,86,235
https://kawalpemilu.org#61364,"MENDAWAI, SUKAMARA, SUKAMARA, KALIMANTAN TENGAH",5,129,75,204
https://kawalpemilu.org#61364,"MENDAWAI, SUKAMARA, SUKAMARA, KALIMANTAN TENGAH",6,144,95,239
https://kawalpemilu.org#61364,"MENDAWAI, SUKAMARA, SUKAMARA, KALIMANTAN TENGAH",7,129,85,214
https://kawalpemilu.org#61364,"MENDAWAI, SUKAMARA, SUKAMARA, KALIMANTAN TENGAH",8,123,105,228
https://kawalpemilu.org#61364,"MENDAWAI, SUKAMARA, SUKAMARA, KALIMANTAN TENGAH",9,136,72,208
https://kawalpemilu.org#61364,"MENDAWAI, SUKAMARA, SUKAMARA, KALIMANTAN TENGAH",10,144,97,241
https://kawalpemilu.org#61364,"MENDAWAI, SUKAMARA, SUKAMARA, KALIMANTAN TENGAH",11,111,97,208
https://kawalpemilu.org#61364,"MENDAWAI, SUKAMARA, SUKAMARA, KALIMANTAN TENGAH",12,150,78,228
https://kawalpemilu.org#61364,"MENDAWAI, SUKAMARA, SUKAMARA, KALIMANTAN TENGAH",13,147,82,229
https://kawalpemilu.org#61364,"MENDAWAI, SUKAMARA, SUKAMARA, KALIMANTAN TENGAH",14,137,92,229
https://kawalpemilu.org#61364,"MENDAWAI, SUKAMARA, SUKAMARA, KALIMANTAN TENGAH",15,116,101,217
https://kawalpemilu.org#61364,"MENDAWAI, SUKAMARA, SUKAMARA, KALIMANTAN TENGAH",16,147,88,235
https://kawalpemilu.org#61364,"MENDAWAI, SUKAMARA, SUKAMARA, KALIMANTAN TENGAH",17,143,108,251
https://kawalpemilu.org#61364,"MENDAWAI, SUKAMARA, SUKAMARA, KALIMANTAN TENGAH",18,137,89,226
https://kawalpemilu.org#61364,"MENDAWAI, SUKAMARA, SUKAMARA, KALIMANTAN TENGAH",19,150,98,248
https://kawalpemilu.org#61364,"MENDAWAI, SUKAMARA, SUKAMARA, KALIMANTAN TENGAH",20,115,81,196
https://kawalpemilu.org#61364,"MENDAWAI, SUKAMARA, SUKAMARA, KALIMANTAN TENGAH",21,139,77,216
https://kawalpemilu.org#61364,"MENDAWAI, SUKAMARA, SUKAMARA, KALIMANTAN TENGAH",22,138,82,220
https://kawalpemilu.org#61364,"MENDAWAI, SUKAMARA, SUKAMARA, KALIMANTAN TENGAH",23,122,86,208
https://kawalpemilu.org#61364,"MENDAWAI, SUKAMARA, SUKAMARA, KALIMANTAN TENGAH",24,90,73,163
https://kawalpemilu.org#61364,"MENDAWAI, SUKAMARA, SUKAMARA, KALIMANTAN TENGAH",25,89,70,159
https://kawalpemilu.org#61364,"MENDAWAI, SUKAMARA, SUKAMARA, KALIMANTAN TENGAH",26,86,85,171
https://kawalpemilu.org#61365,"PADANG, SUKAMARA, SUKAMARA, KALIMANTAN TENGAH",1,150,63,213
https://kawalpemilu.org#61365,"PADANG, SUKAMARA, SUKAMARA, KALIMANTAN TENGAH",2,130,66,196
https://kawalpemilu.org#61365,"PADANG, SUKAMARA, SUKAMARA, KALIMANTAN TENGAH",3,163,80,243
https://kawalpemilu.org#61365,"PADANG, SUKAMARA, SUKAMARA, KALIMANTAN TENGAH",4,148,105,253
https://kawalpemilu.org#61365,"PADANG, SUKAMARA, SUKAMARA, KALIMANTAN TENGAH",5,144,94,238
https://kawalpemilu.org#61365,"PADANG, SUKAMARA, SUKAMARA, KALIMANTAN TENGAH",6,119,111,230
https://kawalpemilu.org#61365,"PADANG, SUKAMARA, SUKAMARA, KALIMANTAN TENGAH",7,144,75,219
https://kawalpemilu.org#61365,"PADANG, SUKAMARA, SUKAMARA, KALIMANTAN TENGAH",8,131,94,225
https://kawalpemilu.org#61365,"PADANG, SUKAMARA, SUKAMARA, KALIMANTAN TENGAH",9,117,122,239
https://kawalpemilu.org#61365,"PADANG, SUKAMARA, SUKAMARA, KALIMANTAN TENGAH",10,117,124,241
https://kawalpemilu.org#61365,"PADANG, SUKAMARA, SUKAMARA, KALIMANTAN TENGAH",11,129,118,247
https://kawalpemilu.org#61365,"PADANG, SUKAMARA, SUKAMARA, KALIMANTAN TENGAH",12,130,112,242
https://kawalpemilu.org#61365,"PADANG, SUKAMARA, SUKAMARA, KALIMANTAN TENGAH",13,117,108,225
https://kawalpemilu.org#61365,"PADANG, SUKAMARA, SUKAMARA, KALIMANTAN TENGAH",15,130,114,244
https://kawalpemilu.org#61366,"NATAI SEDAWAK, SUKAMARA, SUKAMARA, KALIMANTAN TENGAH",1,165,48,213
https://kawalpemilu.org#61366,"NATAI SEDAWAK, SUKAMARA, SUKAMARA, KALIMANTAN TENGAH",3,186,82,268
https://kawalpemilu.org#61366,"NATAI SEDAWAK, SUKAMARA, SUKAMARA, KALIMANTAN TENGAH",4,169,63,232
https://kawalpemilu.org#61366,"NATAI SEDAWAK, SUKAMARA, SUKAMARA, KALIMANTAN TENGAH",5,184,75,259
https://kawalpemilu.org#61367,"PUDU, SUKAMARA, SUKAMARA, KALIMANTAN TENGAH",1,147,57,204
https://kawalpemilu.org#61367,"PUDU, SUKAMARA, SUKAMARA, KALIMANTAN TENGAH",2,118,41,159
https://kawalpemilu.org#61367,"PUDU, SUKAMARA, SUKAMARA, KALIMANTAN TENGAH",3,161,37,198
https://kawalpemilu.org#61368,"KERTA MULYA, SUKAMARA, SUKAMARA, KALIMANTAN TENGAH",1,66,50,116
https://kawalpemilu.org#61368,"KERTA MULYA, SUKAMARA, SUKAMARA, KALIMANTAN TENGAH",2,98,98,196
https://kawalpemilu.org#61368,"KERTA MULYA, SUKAMARA, SUKAMARA, KALIMANTAN TENGAH",3,133,63,196
https://kawalpemilu.org#61368,"KERTA MULYA, SUKAMARA, SUKAMARA, KALIMANTAN TENGAH",4,116,76,192
https://kawalpemilu.org#61368,"KERTA MULYA, SUKAMARA, SUKAMARA, KALIMANTAN TENGAH",5,105,72,177
https://kawalpemilu.org#61368,"KERTA MULYA, SUKAMARA, SUKAMARA, KALIMANTAN TENGAH",6,103,112,215
https://kawalpemilu.org#61368,"KERTA MULYA, SUKAMARA, SUKAMARA, KALIMANTAN TENGAH",7,92,30,122
https://kawalpemilu.org#61368,"KERTA MULYA, SUKAMARA, SUKAMARA, KALIMANTAN TENGAH",8,126,30,156
https://kawalpemilu.org#61368,"KERTA MULYA, SUKAMARA, SUKAMARA, KALIMANTAN TENGAH",10,107,36,143
https://kawalpemilu.org#61368,"KERTA MULYA, SUKAMARA, SUKAMARA, KALIMANTAN TENGAH",11,139,50,189
https://kawalpemilu.org#61368,"KERTA MULYA, SUKAMARA, SUKAMARA, KALIMANTAN TENGAH",12,147,34,181
https://kawalpemilu.org#61368,"KERTA MULYA, SUKAMARA, SUKAMARA, KALIMANTAN TENGAH",13,113,25,138
https://kawalpemilu.org#61368,"KERTA MULYA, SUKAMARA, SUKAMARA, KALIMANTAN TENGAH",14,121,17,138
https://kawalpemilu.org#61368,"KERTA MULYA, SUKAMARA, SUKAMARA, KALIMANTAN TENGAH",15,58,53,111
https://kawalpemilu.org#61369,"SUKARAJA, SUKAMARA, SUKAMARA, KALIMANTAN TENGAH",1,147,105,252
https://kawalpemilu.org#61369,"SUKARAJA, SUKAMARA, SUKAMARA, KALIMANTAN TENGAH",2,96,80,176
https://kawalpemilu.org#61370,"PANGKALAN MUNTAI, SUKAMARA, SUKAMARA, KALIMANTAN TENGAH",1,82,72,154
https://kawalpemilu.org#61370,"PANGKALAN MUNTAI, SUKAMARA, SUKAMARA, KALIMANTAN TENGAH",2,76,71,147
https://kawalpemilu.org#61370,"PANGKALAN MUNTAI, SUKAMARA, SUKAMARA, KALIMANTAN TENGAH",3,97,132,229
https://kawalpemilu.org#61370,"PANGKALAN MUNTAI, SUKAMARA, SUKAMARA, KALIMANTAN TENGAH",5,79,82,161
https://kawalpemilu.org#61370,"PANGKALAN MUNTAI, SUKAMARA, SUKAMARA, KALIMANTAN TENGAH",6,101,14,115
https://kawalpemilu.org#61370,"PANGKALAN MUNTAI, SUKAMARA, SUKAMARA, KALIMANTAN TENGAH",8,86,7,93
https://kawalpemilu.org#61371,"PETARIKAN, SUKAMARA, SUKAMARA, KALIMANTAN TENGAH",1,86,59,145
https://kawalpemilu.org#61371,"PETARIKAN, SUKAMARA, SUKAMARA, KALIMANTAN TENGAH",2,171,60,231
https://kawalpemilu.org#61371,"PETARIKAN, SUKAMARA, SUKAMARA, KALIMANTAN TENGAH",3,122,26,148
https://kawalpemilu.org#61373,"KUALA JELAI, JELAI, SUKAMARA, KALIMANTAN TENGAH",1,146,42,188
https://kawalpemilu.org#61373,"KUALA JELAI, JELAI, SUKAMARA, KALIMANTAN TENGAH",2,139,85,224
https://kawalpemilu.org#61373,"KUALA JELAI, JELAI, SUKAMARA, KALIMANTAN TENGAH",3,146,90,236
https://kawalpemilu.org#61373,"KUALA JELAI, JELAI, SUKAMARA, KALIMANTAN TENGAH",4,115,85,200
https://kawalpemilu.org#61373,"KUALA JELAI, JELAI, SUKAMARA, KALIMANTAN TENGAH",5,113,135,248
https://kawalpemilu.org#61373,"KUALA JELAI, JELAI, SUKAMARA, KALIMANTAN TENGAH",6,96,145,241
https://kawalpemilu.org#61373,"KUALA JELAI, JELAI, SUKAMARA, KALIMANTAN TENGAH",7,105,134,239
https://kawalpemilu.org#61373,"KUALA JELAI, JELAI, SUKAMARA, KALIMANTAN TENGAH",8,118,116,234
https://kawalpemilu.org#61373,"KUALA JELAI, JELAI, SUKAMARA, KALIMANTAN TENGAH",9,102,124,226
https://kawalpemilu.org#61373,"KUALA JELAI, JELAI, SUKAMARA, KALIMANTAN TENGAH",10,55,53,108
https://kawalpemilu.org#61374,"PULAU NIBUNG, JELAI, SUKAMARA, KALIMANTAN TENGAH",1,106,36,142
https://kawalpemilu.org#61374,"PULAU NIBUNG, JELAI, SUKAMARA, KALIMANTAN TENGAH",2,95,73,168
https://kawalpemilu.org#61374,"PULAU NIBUNG, JELAI, SUKAMARA, KALIMANTAN TENGAH",3,94,67,161
https://kawalpemilu.org#61374,"PULAU NIBUNG, JELAI, SUKAMARA, KALIMANTAN TENGAH",4,75,14,89
https://kawalpemilu.org#61375,"SUNGAI BARU, JELAI, SUKAMARA, KALIMANTAN TENGAH",1,34,141,175
https://kawalpemilu.org#61376,"SUNGAI BUNDUNG, JELAI, SUKAMARA, KALIMANTAN TENGAH",1,59,79,138
https://kawalpemilu.org#61377,"SUNGAI RAJA, JELAI, SUKAMARA, KALIMANTAN TENGAH",1,46,158,204
https://kawalpemilu.org#61379,"JIHING, BALAI RIAM, SUKAMARA, KALIMANTAN TENGAH",1,169,18,187
https://kawalpemilu.org#61379,"JIHING, BALAI RIAM, SUKAMARA, KALIMANTAN TENGAH",2,212,21,233
https://kawalpemilu.org#61379,"JIHING, BALAI RIAM, SUKAMARA, KALIMANTAN TENGAH",3,119,36,155
https://kawalpemilu.org#61380,"AIR DUA, BALAI RIAM, SUKAMARA, KALIMANTAN TENGAH",1,133,17,150
https://kawalpemilu.org#61380,"AIR DUA, BALAI RIAM, SUKAMARA, KALIMANTAN TENGAH",2,108,10,118
https://kawalpemilu.org#61381,"LUPU PERUCA, BALAI RIAM, SUKAMARA, KALIMANTAN TENGAH",1,185,54,239
https://kawalpemilu.org#61381,"LUPU PERUCA, BALAI RIAM, SUKAMARA, KALIMANTAN TENGAH",2,163,35,198
https://kawalpemilu.org#61381,"LUPU PERUCA, BALAI RIAM, SUKAMARA, KALIMANTAN TENGAH",3,89,13,102
https://kawalpemilu.org#61382,"BALAI RIAM, BALAI RIAM, SUKAMARA, KALIMANTAN TENGAH",1,202,52,254
https://kawalpemilu.org#61382,"BALAI RIAM, BALAI RIAM, SUKAMARA, KALIMANTAN TENGAH",2,190,53,243
https://kawalpemilu.org#61382,"BALAI RIAM, BALAI RIAM, SUKAMARA, KALIMANTAN TENGAH",3,192,53,245
https://kawalpemilu.org#61383,"PEMPANING, BALAI RIAM, SUKAMARA, KALIMANTAN TENGAH",1,124,7,131
https://kawalpemilu.org#61384,"SEKUNINGAN BARU, BALAI RIAM, SUKAMARA, KALIMANTAN TENGAH",1,231,20,251
https://kawalpemilu.org#61384,"SEKUNINGAN BARU, BALAI RIAM, SUKAMARA, KALIMANTAN TENGAH",2,201,31,232
https://kawalpemilu.org#61384,"SEKUNINGAN BARU, BALAI RIAM, SUKAMARA, KALIMANTAN TENGAH",3,196,32,228
https://kawalpemilu.org#61384,"SEKUNINGAN BARU, BALAI RIAM, SUKAMARA, KALIMANTAN TENGAH",4,159,54,213
https://kawalpemilu.org#61384,"SEKUNINGAN BARU, BALAI RIAM, SUKAMARA, KALIMANTAN TENGAH",5,222,32,254
https://kawalpemilu.org#61385,"BANGUN JAYA, BALAI RIAM, SUKAMARA, KALIMANTAN TENGAH",1,215,57,272
https://kawalpemilu.org#61385,"BANGUN JAYA, BALAI RIAM, SUKAMARA, KALIMANTAN TENGAH",2,185,66,251
https://kawalpemilu.org#61385,"BANGUN JAYA, BALAI RIAM, SUKAMARA, KALIMANTAN TENGAH",3,210,51,261
https://kawalpemilu.org#61385,"BANGUN JAYA, BALAI RIAM, SUKAMARA, KALIMANTAN TENGAH",4,187,37,224
https://kawalpemilu.org#61385,"BANGUN JAYA, BALAI RIAM, SUKAMARA, KALIMANTAN TENGAH",5,205,51,256
https://kawalpemilu.org#61385,"BANGUN JAYA, BALAI RIAM, SUKAMARA, KALIMANTAN TENGAH",6,104,24,128
https://kawalpemilu.org#61386,"BUKIT SUNGKAI, BALAI RIAM, SUKAMARA, KALIMANTAN TENGAH",1,186,47,233
https://kawalpemilu.org#61386,"BUKIT SUNGKAI, BALAI RIAM, SUKAMARA, KALIMANTAN TENGAH",2,246,18,264
https://kawalpemilu.org#61386,"BUKIT SUNGKAI, BALAI RIAM, SUKAMARA, KALIMANTAN TENGAH",3,200,41,241
https://kawalpemilu.org#61386,"BUKIT SUNGKAI, BALAI RIAM, SUKAMARA, KALIMANTAN TENGAH",4,181,53,234
https://kawalpemilu.org#61388,"SUNGAI DAMAR, PANTAI LUNCI, SUKAMARA, KALIMANTAN TENGAH",1,52,221,273
https://kawalpemilu.org#61388,"SUNGAI DAMAR, PANTAI LUNCI, SUKAMARA, KALIMANTAN TENGAH",2,61,152,213
https://kawalpemilu.org#61388,"SUNGAI DAMAR, PANTAI LUNCI, SUKAMARA, KALIMANTAN TENGAH",3,45,154,199
https://kawalpemilu.org#61389,"SUNGAI TABUK, PANTAI LUNCI, SUKAMARA, KALIMANTAN TENGAH",1,145,105,250
https://kawalpemilu.org#61389,"SUNGAI TABUK, PANTAI LUNCI, SUKAMARA, KALIMANTAN TENGAH",2,143,96,239
https://kawalpemilu.org#61390,"SUNGAI CABANG BARAT, PANTAI LUNCI, SUKAMARA, KALIMANTAN TENGAH",1,158,75,233
https://kawalpemilu.org#61390,"SUNGAI CABANG BARAT, PANTAI LUNCI, SUKAMARA, KALIMANTAN TENGAH",2,93,158,251
https://kawalpemilu.org#61390,"SUNGAI CABANG BARAT, PANTAI LUNCI, SUKAMARA, KALIMANTAN TENGAH",3,68,170,238
https://kawalpemilu.org#61390,"SUNGAI CABANG BARAT, PANTAI LUNCI, SUKAMARA, KALIMANTAN TENGAH",4,125,116,241
https://kawalpemilu.org#61390,"SUNGAI CABANG BARAT, PANTAI LUNCI, SUKAMARA, KALIMANTAN TENGAH",5,170,78,248
https://kawalpemilu.org#61390,"SUNGAI CABANG BARAT, PANTAI LUNCI, SUKAMARA, KALIMANTAN TENGAH",6,54,94,148
https://kawalpemilu.org#61391,"SUNGAI PASIR, PANTAI LUNCI, SUKAMARA, KALIMANTAN TENGAH",1,128,112,240
https://kawalpemilu.org#61391,"SUNGAI PASIR, PANTAI LUNCI, SUKAMARA, KALIMANTAN TENGAH",2,75,183,258
https://kawalpemilu.org#61391,"SUNGAI PASIR, PANTAI LUNCI, SUKAMARA, KALIMANTAN TENGAH",3,116,157,273
https://kawalpemilu.org#61391,"SUNGAI PASIR, PANTAI LUNCI, SUKAMARA, KALIMANTAN TENGAH",4,47,145,192
https://kawalpemilu.org#61391,"SUNGAI PASIR, PANTAI LUNCI, SUKAMARA, KALIMANTAN TENGAH",5,57,17,74
https://kawalpemilu.org#61393,"KENAWAN, PERMATA KECUBUNG, SUKAMARA, KALIMANTAN TENGAH",1,128,41,169
https://kawalpemilu.org#61393,"KENAWAN, PERMATA KECUBUNG, SUKAMARA, KALIMANTAN TENGAH",3,96,15,111
https://kawalpemilu.org#61394,"LAMAN BARU, PERMATA KECUBUNG, SUKAMARA, KALIMANTAN TENGAH",1,183,19,202
https://kawalpemilu.org#61394,"LAMAN BARU, PERMATA KECUBUNG, SUKAMARA, KALIMANTAN TENGAH",2,179,29,208
https://kawalpemilu.org#61394,"LAMAN BARU, PERMATA KECUBUNG, SUKAMARA, KALIMANTAN TENGAH",3,53,15,68
https://kawalpemilu.org#61395,"AJANG, PERMATA KECUBUNG, SUKAMARA, KALIMANTAN TENGAH",1,189,35,224
https://kawalpemilu.org#61395,"AJANG, PERMATA KECUBUNG, SUKAMARA, KALIMANTAN TENGAH",2,138,49,187
https://kawalpemilu.org#61395,"AJANG, PERMATA KECUBUNG, SUKAMARA, KALIMANTAN TENGAH",3,151,57,208
https://kawalpemilu.org#61395,"AJANG, PERMATA KECUBUNG, SUKAMARA, KALIMANTAN TENGAH",4,188,37,225
https://kawalpemilu.org#61395,"AJANG, PERMATA KECUBUNG, SUKAMARA, KALIMANTAN TENGAH",5,198,25,223
https://kawalpemilu.org#61396,"SEMANTUN, PERMATA KECUBUNG, SUKAMARA, KALIMANTAN TENGAH",1,161,31,192
https://kawalpemilu.org#61396,"SEMANTUN, PERMATA KECUBUNG, SUKAMARA, KALIMANTAN TENGAH",2,159,28,187
https://kawalpemilu.org#61396,"SEMANTUN, PERMATA KECUBUNG, SUKAMARA, KALIMANTAN TENGAH",3,135,29,164
https://kawalpemilu.org#61396,"SEMANTUN, PERMATA KECUBUNG, SUKAMARA, KALIMANTAN TENGAH",4,102,13,115
https://kawalpemilu.org#61396,"SEMANTUN, PERMATA KECUBUNG, SUKAMARA, KALIMANTAN TENGAH",5,115,23,138
https://kawalpemilu.org#61396,"SEMANTUN, PERMATA KECUBUNG, SUKAMARA, KALIMANTAN TENGAH",6,168,34,202
https://kawalpemilu.org#61397,"NIBUNG TERJUN, PERMATA KECUBUNG, SUKAMARA, KALIMANTAN TENGAH",1,153,27,180
https://kawalpemilu.org#61397,"NIBUNG TERJUN, PERMATA KECUBUNG, SUKAMARA, KALIMANTAN TENGAH",2,173,35,208
https://kawalpemilu.org#61397,"NIBUNG TERJUN, PERMATA KECUBUNG, SUKAMARA, KALIMANTAN TENGAH",3,185,15,200
https://kawalpemilu.org#61398,"NATAI KONDANG, PERMATA KECUBUNG, SUKAMARA, KALIMANTAN TENGAH",1,202,19,221
https://kawalpemilu.org#61398,"NATAI KONDANG, PERMATA KECUBUNG, SUKAMARA, KALIMANTAN TENGAH",2,208,24,232
https://kawalpemilu.org#61398,"NATAI KONDANG, PERMATA KECUBUNG, SUKAMARA, KALIMANTAN TENGAH",3,219,31,250
https://kawalpemilu.org#61399,"SEMBIKUAN, PERMATA KECUBUNG, SUKAMARA, KALIMANTAN TENGAH",1,177,48,225
https://kawalpemilu.org#61399,"SEMBIKUAN, PERMATA KECUBUNG, SUKAMARA, KALIMANTAN TENGAH",2,179,36,215
https://kawalpemilu.org#61399,"SEMBIKUAN, PERMATA KECUBUNG, SUKAMARA, KALIMANTAN TENGAH",3,202,49,251
https://kawalpemilu.org#61402,"TAPIN BINI, LAMANDAU, LAMANDAU, KALIMANTAN TENGAH",1,146,38,184
https://kawalpemilu.org#61402,"TAPIN BINI, LAMANDAU, LAMANDAU, KALIMANTAN TENGAH",2,184,16,200
https://kawalpemilu.org#61402,"TAPIN BINI, LAMANDAU, LAMANDAU, KALIMANTAN TENGAH",3,33,3,36
https://kawalpemilu.org#61403,"SUNGAI TUAT, LAMANDAU, LAMANDAU, KALIMANTAN TENGAH",1,150,15,165
https://kawalpemilu.org#61403,"SUNGAI TUAT, LAMANDAU, LAMANDAU, KALIMANTAN TENGAH",2,117,12,129
https://kawalpemilu.org#61404,"TANJUNG BERINGIN, LAMANDAU, LAMANDAU, KALIMANTAN TENGAH",1,142,25,167
https://kawalpemilu.org#61404,"TANJUNG BERINGIN, LAMANDAU, LAMANDAU, KALIMANTAN TENGAH",2,115,19,134
https://kawalpemilu.org#61405,"CUHAI, LAMANDAU, LAMANDAU, KALIMANTAN TENGAH",1,122,38,160
https://kawalpemilu.org#61405,"CUHAI, LAMANDAU, LAMANDAU, KALIMANTAN TENGAH",2,74,11,85
https://kawalpemilu.org#61406,"KAWA, LAMANDAU, LAMANDAU, KALIMANTAN TENGAH",1,95,50,145
https://kawalpemilu.org#61406,"KAWA, LAMANDAU, LAMANDAU, KALIMANTAN TENGAH",2,79,51,130
https://kawalpemilu.org#61407,"KARANG TABA, LAMANDAU, LAMANDAU, KALIMANTAN TENGAH",1,107,23,130
https://kawalpemilu.org#61407,"KARANG TABA, LAMANDAU, LAMANDAU, KALIMANTAN TENGAH",2,115,43,158
https://kawalpemilu.org#61408,"PENOPA, LAMANDAU, LAMANDAU, KALIMANTAN TENGAH",1,217,26,243
https://kawalpemilu.org#61408,"PENOPA, LAMANDAU, LAMANDAU, KALIMANTAN TENGAH",2,130,22,152
https://kawalpemilu.org#61408,"PENOPA, LAMANDAU, LAMANDAU, KALIMANTAN TENGAH",3,150,26,176
https://kawalpemilu.org#61408,"PENOPA, LAMANDAU, LAMANDAU, KALIMANTAN TENGAH",4,50,11,61
https://kawalpemilu.org#61409,"SUJA, LAMANDAU, LAMANDAU, KALIMANTAN TENGAH",1,155,50,205
https://kawalpemilu.org#61409,"SUJA, LAMANDAU, LAMANDAU, KALIMANTAN TENGAH",2,139,24,163
https://kawalpemilu.org#61410,"SEKOBAN, LAMANDAU, LAMANDAU, KALIMANTAN TENGAH",1,187,9,196
https://kawalpemilu.org#61410,"SEKOBAN, LAMANDAU, LAMANDAU, KALIMANTAN TENGAH",2,130,5,135
https://kawalpemilu.org#61411,"BAKONSU, LAMANDAU, LAMANDAU, KALIMANTAN TENGAH",1,182,13,195
https://kawalpemilu.org#61411,"BAKONSU, LAMANDAU, LAMANDAU, KALIMANTAN TENGAH",2,72,14,86
https://kawalpemilu.org#61411,"BAKONSU, LAMANDAU, LAMANDAU, KALIMANTAN TENGAH",3,44,12,56
https://kawalpemilu.org#61411,"BAKONSU, LAMANDAU, LAMANDAU, KALIMANTAN TENGAH",4,160,21,181
https://kawalpemilu.org#61411,"BAKONSU, LAMANDAU, LAMANDAU, KALIMANTAN TENGAH",5,129,11,140
https://kawalpemilu.org#928450,"SAMU JAYA, LAMANDAU, LAMANDAU, KALIMANTAN TENGAH",1,159,33,192
https://kawalpemilu.org#928450,"SAMU JAYA, LAMANDAU, LAMANDAU, KALIMANTAN TENGAH",2,135,24,159
https://kawalpemilu.org#928450,"SAMU JAYA, LAMANDAU, LAMANDAU, KALIMANTAN TENGAH",3,166,9,175
https://kawalpemilu.org#928450,"SAMU JAYA, LAMANDAU, LAMANDAU, KALIMANTAN TENGAH",4,139,41,180
https://kawalpemilu.org#61413,"KUDANGAN, DELANG, LAMANDAU, KALIMANTAN TENGAH",1,178,43,221
https://kawalpemilu.org#61413,"KUDANGAN, DELANG, LAMANDAU, KALIMANTAN TENGAH",2,149,55,204
https://kawalpemilu.org#61413,"KUDANGAN, DELANG, LAMANDAU, KALIMANTAN TENGAH",3,154,57,211
https://kawalpemilu.org#61413,"KUDANGAN, DELANG, LAMANDAU, KALIMANTAN TENGAH",4,83,26,109
https://kawalpemilu.org#61414,"RIAM PENAHAN, DELANG, LAMANDAU, KALIMANTAN TENGAH",1,129,51,180
https://kawalpemilu.org#61415,"SEPOYU, DELANG, LAMANDAU, KALIMANTAN TENGAH",1,185,7,192
https://kawalpemilu.org#61415,"SEPOYU, DELANG, LAMANDAU, KALIMANTAN TENGAH",2,122,10,132
https://kawalpemilu.org#61416,"NYALANG, DELANG, LAMANDAU, KALIMANTAN TENGAH",1,188,31,219
https://kawalpemilu.org#61417,"RIAM TINGGI, DELANG, LAMANDAU, KALIMANTAN TENGAH",1,77,28,105
https://kawalpemilu.org#61418,"LANDAU KANTU, DELANG, LAMANDAU, KALIMANTAN TENGAH",1,63,18,81
https://kawalpemilu.org#61419,"LOPUS, DELANG, LAMANDAU, KALIMANTAN TENGAH",1,227,20,247
https://kawalpemilu.org#61419,"LOPUS, DELANG, LAMANDAU, KALIMANTAN TENGAH",2,174,15,189
https://kawalpemilu.org#61420,"KUBUNG, DELANG, LAMANDAU, KALIMANTAN TENGAH",1,181,19,200
https://kawalpemilu.org#61420,"KUBUNG, DELANG, LAMANDAU, KALIMANTAN TENGAH",2,90,6,96
https://kawalpemilu.org#61421,"SEKOMBULAN, DELANG, LAMANDAU, KALIMANTAN TENGAH",1,177,37,214
https://kawalpemilu.org#61421,"SEKOMBULAN, DELANG, LAMANDAU, KALIMANTAN TENGAH",2,191,37,228
https://kawalpemilu.org#61422,"PENYOMBAAN, DELANG, LAMANDAU, KALIMANTAN TENGAH",1,128,47,175
https://kawalpemilu.org#61422,"PENYOMBAAN, DELANG, LAMANDAU, KALIMANTAN TENGAH",2,130,44,174
https://kawalpemilu.org#61422,"PENYOMBAAN, DELANG, LAMANDAU, KALIMANTAN TENGAH",3,107,45,152
https://kawalpemilu.org#928451,"HULU JOJABO, DELANG, LAMANDAU, KALIMANTAN TENGAH",1,161,30,191
https://kawalpemilu.org#61424,"NANGA BULIK, BULIK, LAMANDAU, KALIMANTAN TENGAH",1,88,35,123
https://kawalpemilu.org#61424,"NANGA BULIK, BULIK, LAMANDAU, KALIMANTAN TENGAH",2,113,67,180
https://kawalpemilu.org#61424,"NANGA BULIK, BULIK, LAMANDAU, KALIMANTAN TENGAH",3,107,61,168
https://kawalpemilu.org#61424,"NANGA BULIK, BULIK, LAMANDAU, KALIMANTAN TENGAH",4,113,71,184
https://kawalpemilu.org#61424,"NANGA BULIK, BULIK, LAMANDAU, KALIMANTAN TENGAH",5,75,97,172
https://kawalpemilu.org#61424,"NANGA BULIK, BULIK, LAMANDAU, KALIMANTAN TENGAH",6,59,102,161
https://kawalpemilu.org#61424,"NANGA BULIK, BULIK, LAMANDAU, KALIMANTAN TENGAH",7,69,49,118
https://kawalpemilu.org#61424,"NANGA BULIK, BULIK, LAMANDAU, KALIMANTAN TENGAH",8,84,69,149
https://kawalpemilu.org#61424,"NANGA BULIK, BULIK, LAMANDAU, KALIMANTAN TENGAH",9,79,72,151
https://kawalpemilu.org#61424,"NANGA BULIK, BULIK, LAMANDAU, KALIMANTAN TENGAH",10,100,86,186
https://kawalpemilu.org#61424,"NANGA BULIK, BULIK, LAMANDAU, KALIMANTAN TENGAH",11,84,67,151
https://kawalpemilu.org#61424,"NANGA BULIK, BULIK, LAMANDAU, KALIMANTAN TENGAH",12,121,79,200
https://kawalpemilu.org#61424,"NANGA BULIK, BULIK, LAMANDAU, KALIMANTAN TENGAH",13,92,69,161
https://kawalpemilu.org#61424,"NANGA BULIK, BULIK, LAMANDAU, KALIMANTAN TENGAH",14,88,114,202
https://kawalpemilu.org#61424,"NANGA BULIK, BULIK, LAMANDAU, KALIMANTAN TENGAH",15,84,110,194
https://kawalpemilu.org#61424,"NANGA BULIK, BULIK, LAMANDAU, KALIMANTAN TENGAH",16,72,73,145
https://kawalpemilu.org#61424,"NANGA BULIK, BULIK, LAMANDAU, KALIMANTAN TENGAH",17,91,62,153
https://kawalpemilu.org#61424,"NANGA BULIK, BULIK, LAMANDAU, KALIMANTAN TENGAH",18,85,84,169
https://kawalpemilu.org#61424,"NANGA BULIK, BULIK, LAMANDAU, KALIMANTAN TENGAH",19,111,35,146
https://kawalpemilu.org#61424,"NANGA BULIK, BULIK, LAMANDAU, KALIMANTAN TENGAH",20,126,46,172
https://kawalpemilu.org#61424,"NANGA BULIK, BULIK, LAMANDAU, KALIMANTAN TENGAH",21,130,50,180
https://kawalpemilu.org#61424,"NANGA BULIK, BULIK, LAMANDAU, KALIMANTAN TENGAH",22,69,25,94
https://kawalpemilu.org#61424,"NANGA BULIK, BULIK, LAMANDAU, KALIMANTAN TENGAH",23,62,26,88
https://kawalpemilu.org#61424,"NANGA BULIK, BULIK, LAMANDAU, KALIMANTAN TENGAH",24,102,59,161
https://kawalpemilu.org#61424,"NANGA BULIK, BULIK, LAMANDAU, KALIMANTAN TENGAH",25,114,49,163
https://kawalpemilu.org#61424,"NANGA BULIK, BULIK, LAMANDAU, KALIMANTAN TENGAH",26,112,49,161
https://kawalpemilu.org#61424,"NANGA BULIK, BULIK, LAMANDAU, KALIMANTAN TENGAH",27,87,52,139
https://kawalpemilu.org#61424,"NANGA BULIK, BULIK, LAMANDAU, KALIMANTAN TENGAH",28,36,66,102
https://kawalpemilu.org#61424,"NANGA BULIK, BULIK, LAMANDAU, KALIMANTAN TENGAH",29,60,11,71
https://kawalpemilu.org#61424,"NANGA BULIK, BULIK, LAMANDAU, KALIMANTAN TENGAH",30,105,14,119
https://kawalpemilu.org#61424,"NANGA BULIK, BULIK, LAMANDAU, KALIMANTAN TENGAH",31,152,62,214
https://kawalpemilu.org#61424,"NANGA BULIK, BULIK, LAMANDAU, KALIMANTAN TENGAH",32,155,54,209
https://kawalpemilu.org#61424,"NANGA BULIK, BULIK, LAMANDAU, KALIMANTAN TENGAH",33,133,47,180
https://kawalpemilu.org#61424,"NANGA BULIK, BULIK, LAMANDAU, KALIMANTAN TENGAH",34,148,75,223
https://kawalpemilu.org#61424,"NANGA BULIK, BULIK, LAMANDAU, KALIMANTAN TENGAH",35,112,61,173
https://kawalpemilu.org#61424,"NANGA BULIK, BULIK, LAMANDAU, KALIMANTAN TENGAH",36,95,31,126
https://kawalpemilu.org#61424,"NANGA BULIK, BULIK, LAMANDAU, KALIMANTAN TENGAH",37,123,87,210
https://kawalpemilu.org#61424,"NANGA BULIK, BULIK, LAMANDAU, KALIMANTAN TENGAH",38,136,72,208
https://kawalpemilu.org#61424,"NANGA BULIK, BULIK, LAMANDAU, KALIMANTAN TENGAH",39,155,44,199
https://kawalpemilu.org#61424,"NANGA BULIK, BULIK, LAMANDAU, KALIMANTAN TENGAH",40,153,29,182
https://kawalpemilu.org#61424,"NANGA BULIK, BULIK, LAMANDAU, KALIMANTAN TENGAH",41,122,20,142
https://kawalpemilu.org#61424,"NANGA BULIK, BULIK, LAMANDAU, KALIMANTAN TENGAH",42,106,39,145
https://kawalpemilu.org#61424,"NANGA BULIK, BULIK, LAMANDAU, KALIMANTAN TENGAH",43,103,38,141
https://kawalpemilu.org#61424,"NANGA BULIK, BULIK, LAMANDAU, KALIMANTAN TENGAH",44,115,33,148
https://kawalpemilu.org#61424,"NANGA BULIK, BULIK, LAMANDAU, KALIMANTAN TENGAH",45,164,47,211
https://kawalpemilu.org#61424,"NANGA BULIK, BULIK, LAMANDAU, KALIMANTAN TENGAH",47,100,28,128
https://kawalpemilu.org#61424,"NANGA BULIK, BULIK, LAMANDAU, KALIMANTAN TENGAH",48,71,10,81
https://kawalpemilu.org#61424,"NANGA BULIK, BULIK, LAMANDAU, KALIMANTAN TENGAH",49,47,10,57
https://kawalpemilu.org#61424,"NANGA BULIK, BULIK, LAMANDAU, KALIMANTAN TENGAH",50,60,15,75
https://kawalpemilu.org#61424,"NANGA BULIK, BULIK, LAMANDAU, KALIMANTAN TENGAH",51,55,12,67
https://kawalpemilu.org#61424,"NANGA BULIK, BULIK, LAMANDAU, KALIMANTAN TENGAH",52,72,32,104
https://kawalpemilu.org#61425,"SUNGAI MENTAWA, BULIK, LAMANDAU, KALIMANTAN TENGAH",1,76,97,173
https://kawalpemilu.org#61425,"SUNGAI MENTAWA, BULIK, LAMANDAU, KALIMANTAN TENGAH",2,63,107,170
https://kawalpemilu.org#61426,"GUCI, BULIK, LAMANDAU, KALIMANTAN TENGAH",1,93,103,196
https://kawalpemilu.org#61427,"BATU KOTAM, BULIK, LAMANDAU, KALIMANTAN TENGAH",1,119,123,242
https://kawalpemilu.org#61427,"BATU KOTAM, BULIK, LAMANDAU, KALIMANTAN TENGAH",2,122,105,227
https://kawalpemilu.org#61427,"BATU KOTAM, BULIK, LAMANDAU, KALIMANTAN TENGAH",3,109,120,229
https://kawalpemilu.org#61428,"KUJAN, BULIK, LAMANDAU, KALIMANTAN TENGAH",1,132,66,198
https://kawalpemilu.org#61428,"KUJAN, BULIK, LAMANDAU, KALIMANTAN TENGAH",2,137,56,193
https://kawalpemilu.org#61428,"KUJAN, BULIK, LAMANDAU, KALIMANTAN TENGAH",3,112,75,187
https://kawalpemilu.org#61428,"KUJAN, BULIK, LAMANDAU, KALIMANTAN TENGAH",4,117,89,206
https://kawalpemilu.org#61428,"KUJAN, BULIK, LAMANDAU, KALIMANTAN TENGAH",5,106,92,198
https://kawalpemilu.org#61428,"KUJAN, BULIK, LAMANDAU, KALIMANTAN TENGAH",6,140,62,202
https://kawalpemilu.org#61428,"KUJAN, BULIK, LAMANDAU, KALIMANTAN TENGAH",7,118,57,175
https://kawalpemilu.org#61428,"KUJAN, BULIK, LAMANDAU, KALIMANTAN TENGAH",8,124,41,165
https://kawalpemilu.org#61429,"BUNUT, BULIK, LAMANDAU, KALIMANTAN TENGAH",1,146,49,195
https://kawalpemilu.org#61429,"BUNUT, BULIK, LAMANDAU, KALIMANTAN TENGAH",2,113,82,195
https://kawalpemilu.org#61430,"BERUTA, BULIK, LAMANDAU, KALIMANTAN TENGAH",1,149,41,190
https://kawalpemilu.org#61430,"BERUTA, BULIK, LAMANDAU, KALIMANTAN TENGAH",2,157,49,206
https://kawalpemilu.org#61430,"BERUTA, BULIK, LAMANDAU, KALIMANTAN TENGAH",3,201,40,241
https://kawalpemilu.org#61431,"TAMIANG, BULIK, LAMANDAU, KALIMANTAN TENGAH",1,120,20,140
https://kawalpemilu.org#61431,"TAMIANG, BULIK, LAMANDAU, KALIMANTAN TENGAH",2,130,25,155
https://kawalpemilu.org#61431,"TAMIANG, BULIK, LAMANDAU, KALIMANTAN TENGAH",3,121,10,131
https://kawalpemilu.org#61432,"BUMI AGUNG, BULIK, LAMANDAU, KALIMANTAN TENGAH",1,167,47,214
https://kawalpemilu.org#61432,"BUMI AGUNG, BULIK, LAMANDAU, KALIMANTAN TENGAH",2,184,65,249
https://kawalpemilu.org#61432,"BUMI AGUNG, BULIK, LAMANDAU, KALIMANTAN TENGAH",3,140,40,180
https://kawalpemilu.org#61432,"BUMI AGUNG, BULIK, LAMANDAU, KALIMANTAN TENGAH",4,175,53,227
https://kawalpemilu.org#61433,"SUMBER MULYA, BULIK, LAMANDAU, KALIMANTAN TENGAH",1,140,20,160
https://kawalpemilu.org#61433,"SUMBER MULYA, BULIK, LAMANDAU, KALIMANTAN TENGAH",2,136,26,162
https://kawalpemilu.org#61433,"SUMBER MULYA, BULIK, LAMANDAU, KALIMANTAN TENGAH",3,158,24,182
https://kawalpemilu.org#61433,"SUMBER MULYA, BULIK, LAMANDAU, KALIMANTAN TENGAH",4,135,14,149
https://kawalpemilu.org#61433,"SUMBER MULYA, BULIK, LAMANDAU, KALIMANTAN TENGAH",5,147,52,199
https://kawalpemilu.org#61434,"BUKIT INDAH, BULIK, LAMANDAU, KALIMANTAN TENGAH",1,105,19,124
https://kawalpemilu.org#61434,"BUKIT INDAH, BULIK, LAMANDAU, KALIMANTAN TENGAH",2,163,23,186
https://kawalpemilu.org#61434,"BUKIT INDAH, BULIK, LAMANDAU, KALIMANTAN TENGAH",3,166,26,192
https://kawalpemilu.org#61434,"BUKIT INDAH, BULIK, LAMANDAU, KALIMANTAN TENGAH",4,116,16,132
https://kawalpemilu.org#61434,"BUKIT INDAH, BULIK, LAMANDAU, KALIMANTAN TENGAH",5,126,45,171
https://kawalpemilu.org#61434,"BUKIT INDAH, BULIK, LAMANDAU, KALIMANTAN TENGAH",6,99,9,108
https://kawalpemilu.org#61434,"BUKIT INDAH, BULIK, LAMANDAU, KALIMANTAN TENGAH",8,116,16,132
https://kawalpemilu.org#61434,"BUKIT INDAH, BULIK, LAMANDAU, KALIMANTAN TENGAH",9,124,14,138
https://kawalpemilu.org#61434,"BUKIT INDAH, BULIK, LAMANDAU, KALIMANTAN TENGAH",11,109,15,124
https://kawalpemilu.org#61434,"BUKIT INDAH, BULIK, LAMANDAU, KALIMANTAN TENGAH",12,182,23,205
https://kawalpemilu.org#61435,"ARGA MULYA, BULIK, LAMANDAU, KALIMANTAN TENGAH",1,179,31,210
https://kawalpemilu.org#61435,"ARGA MULYA, BULIK, LAMANDAU, KALIMANTAN TENGAH",2,160,24,184
https://kawalpemilu.org#61435,"ARGA MULYA, BULIK, LAMANDAU, KALIMANTAN TENGAH",3,172,28,200
https://kawalpemilu.org#61435,"ARGA MULYA, BULIK, LAMANDAU, KALIMANTAN TENGAH",4,79,8,87
https://kawalpemilu.org#928452,"PERIGI RAYA, BULIK, LAMANDAU, KALIMANTAN TENGAH",1,175,26,201
https://kawalpemilu.org#928452,"PERIGI RAYA, BULIK, LAMANDAU, KALIMANTAN TENGAH",2,169,27,196
https://kawalpemilu.org#928452,"PERIGI RAYA, BULIK, LAMANDAU, KALIMANTAN TENGAH",3,77,4,81
https://kawalpemilu.org#928453,"NANGA PAMALONTIAN, BULIK, LAMANDAU, KALIMANTAN TENGAH",1,149,14,163
https://kawalpemilu.org#928453,"NANGA PAMALONTIAN, BULIK, LAMANDAU, KALIMANTAN TENGAH",2,72,12,84
https://kawalpemilu.org#61437,"NANGA PALIKODAN, BULIK TIMUR, LAMANDAU, KALIMANTAN TENGAH",1,135,12,147
https://kawalpemilu.org#61438,"SUNGKUP, BULIK TIMUR, LAMANDAU, KALIMANTAN TENGAH",1,158,15,173
https://kawalpemilu.org#61438,"SUNGKUP, BULIK TIMUR, LAMANDAU, KALIMANTAN TENGAH",2,108,17,125
https://kawalpemilu.org#61439,"NUANGAN, BULIK TIMUR, LAMANDAU, KALIMANTAN TENGAH",1,44,22,66
https://kawalpemilu.org#61440,"NANGA KORING, BULIK TIMUR, LAMANDAU, KALIMANTAN TENGAH",1,126,25,151
https://kawalpemilu.org#61441,"TOKA, BULIK TIMUR, LAMANDAU, KALIMANTAN TENGAH",1,203,19,222
https://kawalpemilu.org#61442,"SEPONDAM, BULIK TIMUR, LAMANDAU, KALIMANTAN TENGAH",1,133,78,211
https://kawalpemilu.org#61443,"MERAMBANG, BULIK TIMUR, LAMANDAU, KALIMANTAN TENGAH",1,135,110,245
https://kawalpemilu.org#61443,"MERAMBANG, BULIK TIMUR, LAMANDAU, KALIMANTAN TENGAH",2,69,77,146
https://kawalpemilu.org#61443,"MERAMBANG, BULIK TIMUR, LAMANDAU, KALIMANTAN TENGAH",3,73,179,252
https://kawalpemilu.org#61443,"MERAMBANG, BULIK TIMUR, LAMANDAU, KALIMANTAN TENGAH",4,160,19,1
https://kawalpemilu.org#61444,"PEDONGATAN, BULIK TIMUR, LAMANDAU, KALIMANTAN TENGAH",1,166,65,231
https://kawalpemilu.org#61444,"PEDONGATAN, BULIK TIMUR, LAMANDAU, KALIMANTAN TENGAH",2,156,70,226
https://kawalpemilu.org#61445,"BATU TUNGGAL, BULIK TIMUR, LAMANDAU, KALIMANTAN TENGAH",1,125,83,208
https://kawalpemilu.org#61445,"BATU TUNGGAL, BULIK TIMUR, LAMANDAU, KALIMANTAN TENGAH",2,106,100,206
https://kawalpemilu.org#61446,"NANGA KEMUJAN, BULIK TIMUR, LAMANDAU, KALIMANTAN TENGAH",1,48,5,53
https://kawalpemilu.org#61447,"BUKIT JAYA, BULIK TIMUR, LAMANDAU, KALIMANTAN TENGAH",1,190,13,203
https://kawalpemilu.org#61447,"BUKIT JAYA, BULIK TIMUR, LAMANDAU, KALIMANTAN TENGAH",2,140,24,164
https://kawalpemilu.org#61447,"BUKIT JAYA, BULIK TIMUR, LAMANDAU, KALIMANTAN TENGAH",3,169,21,190
https://kawalpemilu.org#61447,"BUKIT JAYA, BULIK TIMUR, LAMANDAU, KALIMANTAN TENGAH",4,210,25,235
https://kawalpemilu.org#61447,"BUKIT JAYA, BULIK TIMUR, LAMANDAU, KALIMANTAN TENGAH",5,190,34,224
https://kawalpemilu.org#61447,"BUKIT JAYA, BULIK TIMUR, LAMANDAU, KALIMANTAN TENGAH",6,217,19,236
https://kawalpemilu.org#61448,"SUKA MAJU, BULIK TIMUR, LAMANDAU, KALIMANTAN TENGAH",1,237,18,255
https://kawalpemilu.org#61448,"SUKA MAJU, BULIK TIMUR, LAMANDAU, KALIMANTAN TENGAH",2,227,14,241
https://kawalpemilu.org#61450,"MELATA, MENTHOBI RAYA, LAMANDAU, KALIMANTAN TENGAH",1,197,26,223
https://kawalpemilu.org#61450,"MELATA, MENTHOBI RAYA, LAMANDAU, KALIMANTAN TENGAH",2,169,30,199
https://kawalpemilu.org#61450,"MELATA, MENTHOBI RAYA, LAMANDAU, KALIMANTAN TENGAH",3,76,36,112
https://kawalpemilu.org#61451,"NANUAH, MENTHOBI RAYA, LAMANDAU, KALIMANTAN TENGAH",1,211,28,239
https://kawalpemilu.org#61452,"BATU AMPAR, MENTHOBI RAYA, LAMANDAU, KALIMANTAN TENGAH",1,145,22,167
https://kawalpemilu.org#61453,"LUBUK HIJU, MENTHOBI RAYA, LAMANDAU, KALIMANTAN TENGAH",1,165,35,200
https://kawalpemilu.org#61453,"LUBUK HIJU, MENTHOBI RAYA, LAMANDAU, KALIMANTAN TENGAH",2,172,45,217
https://kawalpemilu.org#61454,"TOPALAN, MENTHOBI RAYA, LAMANDAU, KALIMANTAN TENGAH",1,116,40,156
https://kawalpemilu.org#61455,"BUKIT MAKMUR, MENTHOBI RAYA, LAMANDAU, KALIMANTAN TENGAH",1,158,26,184
https://kawalpemilu.org#61455,"BUKIT MAKMUR, MENTHOBI RAYA, LAMANDAU, KALIMANTAN TENGAH",2,140,6,146
https://kawalpemilu.org#61455,"BUKIT MAKMUR, MENTHOBI RAYA, LAMANDAU, KALIMANTAN TENGAH",3,171,33,204
https://kawalpemilu.org#61455,"BUKIT MAKMUR, MENTHOBI RAYA, LAMANDAU, KALIMANTAN TENGAH",4,122,8,130
https://kawalpemilu.org#61456,"MODANG MAS, MENTHOBI RAYA, LAMANDAU, KALIMANTAN TENGAH",1,193,37,230
https://kawalpemilu.org#61456,"MODANG MAS, MENTHOBI RAYA, LAMANDAU, KALIMANTAN TENGAH",2,139,33,172
https://kawalpemilu.org#61456,"MODANG MAS, MENTHOBI RAYA, LAMANDAU, KALIMANTAN TENGAH",3,175,20,195
https://kawalpemilu.org#61456,"MODANG MAS, MENTHOBI RAYA, LAMANDAU, KALIMANTAN TENGAH",4,194,24,218
https://kawalpemilu.org#61457,"BUKIT RAYA, MENTHOBI RAYA, LAMANDAU, KALIMANTAN TENGAH",1,175,24,199
https://kawalpemilu.org#61457,"BUKIT RAYA, MENTHOBI RAYA, LAMANDAU, KALIMANTAN TENGAH",2,189,43,232
https://kawalpemilu.org#61457,"BUKIT RAYA, MENTHOBI RAYA, LAMANDAU, KALIMANTAN TENGAH",3,139,27,166
https://kawalpemilu.org#61457,"BUKIT RAYA, MENTHOBI RAYA, LAMANDAU, KALIMANTAN TENGAH",4,183,28,211
https://kawalpemilu.org#61457,"BUKIT RAYA, MENTHOBI RAYA, LAMANDAU, KALIMANTAN TENGAH",5,151,53,204
https://kawalpemilu.org#61457,"BUKIT RAYA, MENTHOBI RAYA, LAMANDAU, KALIMANTAN TENGAH",6,137,52,189
https://kawalpemilu.org#61457,"BUKIT RAYA, MENTHOBI RAYA, LAMANDAU, KALIMANTAN TENGAH",7,109,20,129
https://kawalpemilu.org#61458,"MUKTI MANUNGGAL, MENTHOBI RAYA, LAMANDAU, KALIMANTAN TENGAH",1,201,33,234
https://kawalpemilu.org#61458,"MUKTI MANUNGGAL, MENTHOBI RAYA, LAMANDAU, KALIMANTAN TENGAH",2,186,47,233
https://kawalpemilu.org#61458,"MUKTI MANUNGGAL, MENTHOBI RAYA, LAMANDAU, KALIMANTAN TENGAH",3,179,36,215
https://kawalpemilu.org#61459,"SUMBER JAYA, MENTHOBI RAYA, LAMANDAU, KALIMANTAN TENGAH",1,192,47,239
https://kawalpemilu.org#61459,"SUMBER JAYA, MENTHOBI RAYA, LAMANDAU, KALIMANTAN TENGAH",2,186,37,223
https://kawalpemilu.org#61459,"SUMBER JAYA, MENTHOBI RAYA, LAMANDAU, KALIMANTAN TENGAH",3,198,36,234
https://kawalpemilu.org#61460,"BUKIT HARUM, MENTHOBI RAYA, LAMANDAU, KALIMANTAN TENGAH",1,188,51,239
https://kawalpemilu.org#61460,"BUKIT HARUM, MENTHOBI RAYA, LAMANDAU, KALIMANTAN TENGAH",2,166,57,223
https://kawalpemilu.org#61460,"BUKIT HARUM, MENTHOBI RAYA, LAMANDAU, KALIMANTAN TENGAH",3,179,51,230
https://kawalpemilu.org#61460,"BUKIT HARUM, MENTHOBI RAYA, LAMANDAU, KALIMANTAN TENGAH",4,167,43,210
https://kawalpemilu.org#61462,"PURWAREJA, SEMATU JAYA, LAMANDAU, KALIMANTAN TENGAH",1,198,34,232
https://kawalpemilu.org#61462,"PURWAREJA, SEMATU JAYA, LAMANDAU, KALIMANTAN TENGAH",2,211,30,241
https://kawalpemilu.org#61462,"PURWAREJA, SEMATU JAYA, LAMANDAU, KALIMANTAN TENGAH",3,224,29,253
https://kawalpemilu.org#61462,"PURWAREJA, SEMATU JAYA, LAMANDAU, KALIMANTAN TENGAH",4,183,28,211
https://kawalpemilu.org#61462,"PURWAREJA, SEMATU JAYA, LAMANDAU, KALIMANTAN TENGAH",5,170,42,212
https://kawalpemilu.org#61462,"PURWAREJA, SEMATU JAYA, LAMANDAU, KALIMANTAN TENGAH",6,202,37,239
https://kawalpemilu.org#61462,"PURWAREJA, SEMATU JAYA, LAMANDAU, KALIMANTAN TENGAH",7,151,23,174
https://kawalpemilu.org#61462,"PURWAREJA, SEMATU JAYA, LAMANDAU, KALIMANTAN TENGAH",8,75,7,82
https://kawalpemilu.org#61463,"BINA BHAKTI, SEMATU JAYA, LAMANDAU, KALIMANTAN TENGAH",1,156,65,221
https://kawalpemilu.org#61463,"BINA BHAKTI, SEMATU JAYA, LAMANDAU, KALIMANTAN TENGAH",2,176,89,265
https://kawalpemilu.org#61463,"BINA BHAKTI, SEMATU JAYA, LAMANDAU, KALIMANTAN TENGAH",3,193,55,248
https://kawalpemilu.org#61464,"TRI TUNGGAL, SEMATU JAYA, LAMANDAU, KALIMANTAN TENGAH",1,200,58,258
https://kawalpemilu.org#61464,"TRI TUNGGAL, SEMATU JAYA, LAMANDAU, KALIMANTAN TENGAH",2,212,25,237
https://kawalpemilu.org#61464,"TRI TUNGGAL, SEMATU JAYA, LAMANDAU, KALIMANTAN TENGAH",3,172,27,199
https://kawalpemilu.org#61464,"TRI TUNGGAL, SEMATU JAYA, LAMANDAU, KALIMANTAN TENGAH",4,148,13,161
https://kawalpemilu.org#61464,"TRI TUNGGAL, SEMATU JAYA, LAMANDAU, KALIMANTAN TENGAH",5,152,17,169
https://kawalpemilu.org#61465,"JANGKAR PRIMA, SEMATU JAYA, LAMANDAU, KALIMANTAN TENGAH",1,175,26,201
https://kawalpemilu.org#61465,"JANGKAR PRIMA, SEMATU JAYA, LAMANDAU, KALIMANTAN TENGAH",2,183,21,204
https://kawalpemilu.org#61465,"JANGKAR PRIMA, SEMATU JAYA, LAMANDAU, KALIMANTAN TENGAH",3,182,18,200
https://kawalpemilu.org#61465,"JANGKAR PRIMA, SEMATU JAYA, LAMANDAU, KALIMANTAN TENGAH",4,202,24,226
https://kawalpemilu.org#61465,"JANGKAR PRIMA, SEMATU JAYA, LAMANDAU, KALIMANTAN TENGAH",5,165,30,195
https://kawalpemilu.org#61466,"WONOREJO, SEMATU JAYA, LAMANDAU, KALIMANTAN TENGAH",1,182,29,211
https://kawalpemilu.org#61466,"WONOREJO, SEMATU JAYA, LAMANDAU, KALIMANTAN TENGAH",2,167,46,213
https://kawalpemilu.org#61466,"WONOREJO, SEMATU JAYA, LAMANDAU, KALIMANTAN TENGAH",3,198,43,241
https://kawalpemilu.org#61466,"WONOREJO, SEMATU JAYA, LAMANDAU, KALIMANTAN TENGAH",4,168,59,227
https://kawalpemilu.org#61466,"WONOREJO, SEMATU JAYA, LAMANDAU, KALIMANTAN TENGAH",5,187,56,243
https://kawalpemilu.org#61467,"MEKAR MULYA, SEMATU JAYA, LAMANDAU, KALIMANTAN TENGAH",1,219,54,273
https://kawalpemilu.org#61467,"MEKAR MULYA, SEMATU JAYA, LAMANDAU, KALIMANTAN TENGAH",2,203,66,269
https://kawalpemilu.org#61467,"MEKAR MULYA, SEMATU JAYA, LAMANDAU, KALIMANTAN TENGAH",3,219,39,258
https://kawalpemilu.org#61467,"MEKAR MULYA, SEMATU JAYA, LAMANDAU, KALIMANTAN TENGAH",4,204,38,242
https://kawalpemilu.org#61468,"BATU HAMBAWANG, SEMATU JAYA, LAMANDAU, KALIMANTAN TENGAH",1,146,80,226
https://kawalpemilu.org#928454,"RIMBA JAYA, SEMATU JAYA, LAMANDAU, KALIMANTAN TENGAH",1,114,48,162
https://kawalpemilu.org#928454,"RIMBA JAYA, SEMATU JAYA, LAMANDAU, KALIMANTAN TENGAH",2,131,30,161
https://kawalpemilu.org#61470,"BAYAT, BELANTIKAN RAYA, LAMANDAU, KALIMANTAN TENGAH",1,177,24,201
https://kawalpemilu.org#61470,"BAYAT, BELANTIKAN RAYA, LAMANDAU, KALIMANTAN TENGAH",2,185,16,201
https://kawalpemilu.org#61470,"BAYAT, BELANTIKAN RAYA, LAMANDAU, KALIMANTAN TENGAH",3,151,46,197
https://kawalpemilu.org#61470,"BAYAT, BELANTIKAN RAYA, LAMANDAU, KALIMANTAN TENGAH",4,165,18,183
https://kawalpemilu.org#61470,"BAYAT, BELANTIKAN RAYA, LAMANDAU, KALIMANTAN TENGAH",5,164,27,191
https://kawalpemilu.org#61470,"BAYAT, BELANTIKAN RAYA, LAMANDAU, KALIMANTAN TENGAH",6,102,3,105
https://kawalpemilu.org#61471,"KARANG BESI, BELANTIKAN RAYA, LAMANDAU, KALIMANTAN TENGAH",1,172,13,185
https://kawalpemilu.org#61472,"BENUATAN, BELANTIKAN RAYA, LAMANDAU, KALIMANTAN TENGAH",1,62,17,79
https://kawalpemilu.org#61473,"KAHINGAI, BELANTIKAN RAYA, LAMANDAU, KALIMANTAN TENGAH",1,111,40,151
https://kawalpemilu.org#61474,"NANGA MATU, BELANTIKAN RAYA, LAMANDAU, KALIMANTAN TENGAH",1,45,13,58
https://kawalpemilu.org#61475,"PETARIKAN, BELANTIKAN RAYA, LAMANDAU, KALIMANTAN TENGAH",1,60,47,107
https://kawalpemilu.org#61476,"BINTANG MENGALIH, BELANTIKAN RAYA, LAMANDAU, KALIMANTAN TENGAH",1,103,82,185
https://kawalpemilu.org#61477,"BELIBI, BELANTIKAN RAYA, LAMANDAU, KALIMANTAN TENGAH",1,169,10,179
https://kawalpemilu.org#61477,"BELIBI, BELANTIKAN RAYA, LAMANDAU, KALIMANTAN TENGAH",2,80,4,84
https://kawalpemilu.org#61478,"TANGGA BATU, BELANTIKAN RAYA, LAMANDAU, KALIMANTAN TENGAH",1,136,13,149
https://kawalpemilu.org#61478,"TANGGA BATU, BELANTIKAN RAYA, LAMANDAU, KALIMANTAN TENGAH",2,115,6,121
https://kawalpemilu.org#61479,"SUNGAI BULUH, BELANTIKAN RAYA, LAMANDAU, KALIMANTAN TENGAH",1,161,27,188
https://kawalpemilu.org#61479,"SUNGAI BULUH, BELANTIKAN RAYA, LAMANDAU, KALIMANTAN TENGAH",2,156,19,175
https://kawalpemilu.org#61479,"SUNGAI BULUH, BELANTIKAN RAYA, LAMANDAU, KALIMANTAN TENGAH",3,166,19,185
https://kawalpemilu.org#61480,"SUMBER CAHAYA, BELANTIKAN RAYA, LAMANDAU, KALIMANTAN TENGAH",1,140,25,165
https://kawalpemilu.org#61480,"SUMBER CAHAYA, BELANTIKAN RAYA, LAMANDAU, KALIMANTAN TENGAH",2,147,24,171
https://kawalpemilu.org#61480,"SUMBER CAHAYA, BELANTIKAN RAYA, LAMANDAU, KALIMANTAN TENGAH",3,150,24,174
https://kawalpemilu.org#61481,"NANGA BELANTIKAN, BELANTIKAN RAYA, LAMANDAU, KALIMANTAN TENGAH",1,207,28,235
https://kawalpemilu.org#61483,"BATU TAMBUN, BATANG KAWA, LAMANDAU, KALIMANTAN TENGAH",1,101,37,138
https://kawalpemilu.org#61484,"KINIPAN, BATANG KAWA, LAMANDAU, KALIMANTAN TENGAH",1,170,9,179
https://kawalpemilu.org#61484,"KINIPAN, BATANG KAWA, LAMANDAU, KALIMANTAN TENGAH",2,171,5,176
https://kawalpemilu.org#61485,"GINIH, BATANG KAWA, LAMANDAU, KALIMANTAN TENGAH",1,141,7,148
https://kawalpemilu.org#61486,"BENAKITAN, BATANG KAWA, LAMANDAU, KALIMANTAN TENGAH",1,140,15,155
https://kawalpemilu.org#61487,"LIKU, BATANG KAWA, LAMANDAU, KALIMANTAN TENGAH",1,55,26,81
https://kawalpemilu.org#61488,"MENGKALANG, BATANG KAWA, LAMANDAU, KALIMANTAN TENGAH",1,133,19,152
https://kawalpemilu.org#61488,"MENGKALANG, BATANG KAWA, LAMANDAU, KALIMANTAN TENGAH",2,100,14,114
https://kawalpemilu.org#61489,"KARANG MAS, BATANG KAWA, LAMANDAU, KALIMANTAN TENGAH",1,117,22,139
https://kawalpemilu.org#61490,"KINA, BATANG KAWA, LAMANDAU, KALIMANTAN TENGAH",1,130,90,220
https://kawalpemilu.org#61491,"JEMUAT, BATANG KAWA, LAMANDAU, KALIMANTAN TENGAH",1,157,42,199
https://kawalpemilu.org#61494,"TAMPANG TUMBANG ANJIR, KURUN, GUNUNG MAS, KALIMANTAN TENGAH",1,0,0,0
https://kawalpemilu.org#61494,"TAMPANG TUMBANG ANJIR, KURUN, GUNUNG MAS, KALIMANTAN TENGAH",2,153,24,177
https://kawalpemilu.org#61494,"TAMPANG TUMBANG ANJIR, KURUN, GUNUNG MAS, KALIMANTAN TENGAH",3,134,30,164
https://kawalpemilu.org#61494,"TAMPANG TUMBANG ANJIR, KURUN, GUNUNG MAS, KALIMANTAN TENGAH",4,202,21,223
https://kawalpemilu.org#61494,"TAMPANG TUMBANG ANJIR, KURUN, GUNUNG MAS, KALIMANTAN TENGAH",5,219,16,235
https://kawalpemilu.org#61494,"TAMPANG TUMBANG ANJIR, KURUN, GUNUNG MAS, KALIMANTAN TENGAH",6,203,10,213
https://kawalpemilu.org#61494,"TAMPANG TUMBANG ANJIR, KURUN, GUNUNG MAS, KALIMANTAN TENGAH",7,170,32,202
https://kawalpemilu.org#61494,"TAMPANG TUMBANG ANJIR, KURUN, GUNUNG MAS, KALIMANTAN TENGAH",8,223,26,249
https://kawalpemilu.org#61494,"TAMPANG TUMBANG ANJIR, KURUN, GUNUNG MAS, KALIMANTAN TENGAH",9,150,34,184
https://kawalpemilu.org#61494,"TAMPANG TUMBANG ANJIR, KURUN, GUNUNG MAS, KALIMANTAN TENGAH",10,174,33,207
https://kawalpemilu.org#61494,"TAMPANG TUMBANG ANJIR, KURUN, GUNUNG MAS, KALIMANTAN TENGAH",12,142,46,188
https://kawalpemilu.org#61494,"TAMPANG TUMBANG ANJIR, KURUN, GUNUNG MAS, KALIMANTAN TENGAH",13,197,17,215
https://kawalpemilu.org#61494,"TAMPANG TUMBANG ANJIR, KURUN, GUNUNG MAS, KALIMANTAN TENGAH",14,199,20,219
https://kawalpemilu.org#61494,"TAMPANG TUMBANG ANJIR, KURUN, GUNUNG MAS, KALIMANTAN TENGAH",15,156,30,186
https://kawalpemilu.org#61495,"KUALA KURUN, KURUN, GUNUNG MAS, KALIMANTAN TENGAH",1,128,8,136
https://kawalpemilu.org#61495,"KUALA KURUN, KURUN, GUNUNG MAS, KALIMANTAN TENGAH",2,173,18,191
https://kawalpemilu.org#61495,"KUALA KURUN, KURUN, GUNUNG MAS, KALIMANTAN TENGAH",3,192,11,203
https://kawalpemilu.org#61495,"KUALA KURUN, KURUN, GUNUNG MAS, KALIMANTAN TENGAH",4,185,13,198
https://kawalpemilu.org#61495,"KUALA KURUN, KURUN, GUNUNG MAS, KALIMANTAN TENGAH",5,193,18,211
https://kawalpemilu.org#61495,"KUALA KURUN, KURUN, GUNUNG MAS, KALIMANTAN TENGAH",6,160,12,172
https://kawalpemilu.org#61495,"KUALA KURUN, KURUN, GUNUNG MAS, KALIMANTAN TENGAH",7,195,57,252
https://kawalpemilu.org#61495,"KUALA KURUN, KURUN, GUNUNG MAS, KALIMANTAN TENGAH",8,131,44,175
https://kawalpemilu.org#61495,"KUALA KURUN, KURUN, GUNUNG MAS, KALIMANTAN TENGAH",9,115,100,215
https://kawalpemilu.org#61495,"KUALA KURUN, KURUN, GUNUNG MAS, KALIMANTAN TENGAH",10,136,65,201
https://kawalpemilu.org#61495,"KUALA KURUN, KURUN, GUNUNG MAS, KALIMANTAN TENGAH",11,103,59,162
https://kawalpemilu.org#61495,"KUALA KURUN, KURUN, GUNUNG MAS, KALIMANTAN TENGAH",12,128,64,192
https://kawalpemilu.org#61495,"KUALA KURUN, KURUN, GUNUNG MAS, KALIMANTAN TENGAH",13,180,98,278
https://kawalpemilu.org#61495,"KUALA KURUN, KURUN, GUNUNG MAS, KALIMANTAN TENGAH",14,155,80,235
https://kawalpemilu.org#61495,"KUALA KURUN, KURUN, GUNUNG MAS, KALIMANTAN TENGAH",15,151,43,194
https://kawalpemilu.org#61495,"KUALA KURUN, KURUN, GUNUNG MAS, KALIMANTAN TENGAH",16,206,73,297
https://kawalpemilu.org#61495,"KUALA KURUN, KURUN, GUNUNG MAS, KALIMANTAN TENGAH",17,249,40,289
https://kawalpemilu.org#61495,"KUALA KURUN, KURUN, GUNUNG MAS, KALIMANTAN TENGAH",18,164,24,188
https://kawalpemilu.org#61495,"KUALA KURUN, KURUN, GUNUNG MAS, KALIMANTAN TENGAH",19,117,13,130
https://kawalpemilu.org#61495,"KUALA KURUN, KURUN, GUNUNG MAS, KALIMANTAN TENGAH",20,80,9,89
https://kawalpemilu.org#61495,"KUALA KURUN, KURUN, GUNUNG MAS, KALIMANTAN TENGAH",21,166,38,204
https://kawalpemilu.org#61495,"KUALA KURUN, KURUN, GUNUNG MAS, KALIMANTAN TENGAH",22,179,32,211
https://kawalpemilu.org#61495,"KUALA KURUN, KURUN, GUNUNG MAS, KALIMANTAN TENGAH",23,176,29,205
https://kawalpemilu.org#61495,"KUALA KURUN, KURUN, GUNUNG MAS, KALIMANTAN TENGAH",24,123,33,156
https://kawalpemilu.org#61495,"KUALA KURUN, KURUN, GUNUNG MAS, KALIMANTAN TENGAH",25,176,23,199
https://kawalpemilu.org#61495,"KUALA KURUN, KURUN, GUNUNG MAS, KALIMANTAN TENGAH",26,144,30,174
https://kawalpemilu.org#61495,"KUALA KURUN, KURUN, GUNUNG MAS, KALIMANTAN TENGAH",27,217,29,246
https://kawalpemilu.org#61495,"KUALA KURUN, KURUN, GUNUNG MAS, KALIMANTAN TENGAH",28,162,23,185
https://kawalpemilu.org#61495,"KUALA KURUN, KURUN, GUNUNG MAS, KALIMANTAN TENGAH",29,108,19,127
https://kawalpemilu.org#61496,"PETAK BAHANDANG, KURUN, GUNUNG MAS, KALIMANTAN TENGAH",1,215,8,223
https://kawalpemilu.org#61496,"PETAK BAHANDANG, KURUN, GUNUNG MAS, KALIMANTAN TENGAH",2,238,7,245
https://kawalpemilu.org#61496,"PETAK BAHANDANG, KURUN, GUNUNG MAS, KALIMANTAN TENGAH",3,227,5,232
https://kawalpemilu.org#61497,"TANJUNGRIU, KURUN, GUNUNG MAS, KALIMANTAN TENGAH",1,124,10,134
https://kawalpemilu.org#61497,"TANJUNGRIU, KURUN, GUNUNG MAS, KALIMANTAN TENGAH",2,141,13,154
https://kawalpemilu.org#61498,"TELUKNYATU, KURUN, GUNUNG MAS, KALIMANTAN TENGAH",1,164,20,184
https://kawalpemilu.org#61498,"TELUKNYATU, KURUN, GUNUNG MAS, KALIMANTAN TENGAH",2,172,15,187
https://kawalpemilu.org#61498,"TELUKNYATU, KURUN, GUNUNG MAS, KALIMANTAN TENGAH",3,167,22,189
https://kawalpemilu.org#61498,"TELUKNYATU, KURUN, GUNUNG MAS, KALIMANTAN TENGAH",4,30,3,33
https://kawalpemilu.org#61499,"TUMBANG LAMPAHUNG, KURUN, GUNUNG MAS, KALIMANTAN TENGAH",1,145,7,152
https://kawalpemilu.org#61499,"TUMBANG LAMPAHUNG, KURUN, GUNUNG MAS, KALIMANTAN TENGAH",2,133,5,138
https://kawalpemilu.org#61500,"TEWANG PAJANGAN, KURUN, GUNUNG MAS, KALIMANTAN TENGAH",1,197,18,215
https://kawalpemilu.org#61500,"TEWANG PAJANGAN, KURUN, GUNUNG MAS, KALIMANTAN TENGAH",2,197,18,215
https://kawalpemilu.org#61500,"TEWANG PAJANGAN, KURUN, GUNUNG MAS, KALIMANTAN TENGAH",3,211,18,229
https://kawalpemilu.org#61501,"TUMBANG TARIAK, KURUN, GUNUNG MAS, KALIMANTAN TENGAH",1,186,9,195
https://kawalpemilu.org#61501,"TUMBANG TARIAK, KURUN, GUNUNG MAS, KALIMANTAN TENGAH",2,158,26,184
https://kawalpemilu.org#61502,"TUMBANG MIWAN, KURUN, GUNUNG MAS, KALIMANTAN TENGAH",1,176,37,213
https://kawalpemilu.org#61502,"TUMBANG MIWAN, KURUN, GUNUNG MAS, KALIMANTAN TENGAH",2,135,29,164
https://kawalpemilu.org#61502,"TUMBANG MIWAN, KURUN, GUNUNG MAS, KALIMANTAN TENGAH",3,182,47,229
https://kawalpemilu.org#61502,"TUMBANG MIWAN, KURUN, GUNUNG MAS, KALIMANTAN TENGAH",4,125,47,172
https://kawalpemilu.org#61503,"HURUNG BUNUT, KURUN, GUNUNG MAS, KALIMANTAN TENGAH",1,206,12,218
https://kawalpemilu.org#61503,"HURUNG BUNUT, KURUN, GUNUNG MAS, KALIMANTAN TENGAH",2,239,8,247
https://kawalpemilu.org#61503,"HURUNG BUNUT, KURUN, GUNUNG MAS, KALIMANTAN TENGAH",3,220,6,226
https://kawalpemilu.org#61504,"TUMBANG HAKAU, KURUN, GUNUNG MAS, KALIMANTAN TENGAH",1,180,15,195
https://kawalpemilu.org#61504,"TUMBANG HAKAU, KURUN, GUNUNG MAS, KALIMANTAN TENGAH",2,197,13,210
https://kawalpemilu.org#61504,"TUMBANG HAKAU, KURUN, GUNUNG MAS, KALIMANTAN TENGAH",3,204,12,216
https://kawalpemilu.org#61505,"PILANG MUNDUK, KURUN, GUNUNG MAS, KALIMANTAN TENGAH",1,187,9,196
https://kawalpemilu.org#61505,"PILANG MUNDUK, KURUN, GUNUNG MAS, KALIMANTAN TENGAH",2,190,10,200
https://kawalpemilu.org#61506,"TUMBANG MANYANGAN, KURUN, GUNUNG MAS, KALIMANTAN TENGAH",1,207,31,238
https://kawalpemilu.org#61507,"PENDA PILANG, KURUN, GUNUNG MAS, KALIMANTAN TENGAH",2,132,7,139
https://kawalpemilu.org#61508,"TUMBANG TAMBIRAH, KURUN, GUNUNG MAS, KALIMANTAN TENGAH",1,159,7,166
https://kawalpemilu.org#61508,"TUMBANG TAMBIRAH, KURUN, GUNUNG MAS, KALIMANTAN TENGAH",2,158,27,185
https://kawalpemilu.org#61508,"TUMBANG TAMBIRAH, KURUN, GUNUNG MAS, KALIMANTAN TENGAH",3,143,33,176
https://kawalpemilu.org#61510,"TEWAH, TEWAH, GUNUNG MAS, KALIMANTAN TENGAH",1,187,26,213
https://kawalpemilu.org#61510,"TEWAH, TEWAH, GUNUNG MAS, KALIMANTAN TENGAH",2,164,29,193
https://kawalpemilu.org#61510,"TEWAH, TEWAH, GUNUNG MAS, KALIMANTAN TENGAH",3,192,50,242
https://kawalpemilu.org#61510,"TEWAH, TEWAH, GUNUNG MAS, KALIMANTAN TENGAH",4,191,32,223
https://kawalpemilu.org#61510,"TEWAH, TEWAH, GUNUNG MAS, KALIMANTAN TENGAH",5,134,19,153
https://kawalpemilu.org#61510,"TEWAH, TEWAH, GUNUNG MAS, KALIMANTAN TENGAH",6,124,8,132
https://kawalpemilu.org#61510,"TEWAH, TEWAH, GUNUNG MAS, KALIMANTAN TENGAH",7,121,14,135
https://kawalpemilu.org#61510,"TEWAH, TEWAH, GUNUNG MAS, KALIMANTAN TENGAH",8,208,11,219
https://kawalpemilu.org#61510,"TEWAH, TEWAH, GUNUNG MAS, KALIMANTAN TENGAH",9,198,22,220
https://kawalpemilu.org#61510,"TEWAH, TEWAH, GUNUNG MAS, KALIMANTAN TENGAH",10,168,44,212
https://kawalpemilu.org#61510,"TEWAH, TEWAH, GUNUNG MAS, KALIMANTAN TENGAH",11,58,118,176
https://kawalpemilu.org#61510,"TEWAH, TEWAH, GUNUNG MAS, KALIMANTAN TENGAH",12,107,115,222
https://kawalpemilu.org#61510,"TEWAH, TEWAH, GUNUNG MAS, KALIMANTAN TENGAH",13,55,146,201
https://kawalpemilu.org#61510,"TEWAH, TEWAH, GUNUNG MAS, KALIMANTAN TENGAH",14,73,117,190
https://kawalpemilu.org#61510,"TEWAH, TEWAH, GUNUNG MAS, KALIMANTAN TENGAH",15,75,123,198
https://kawalpemilu.org#61510,"TEWAH, TEWAH, GUNUNG MAS, KALIMANTAN TENGAH",16,158,26,184
https://kawalpemilu.org#61510,"TEWAH, TEWAH, GUNUNG MAS, KALIMANTAN TENGAH",17,185,26,211
https://kawalpemilu.org#61510,"TEWAH, TEWAH, GUNUNG MAS, KALIMANTAN TENGAH",18,135,19,154
https://kawalpemilu.org#61510,"TEWAH, TEWAH, GUNUNG MAS, KALIMANTAN TENGAH",19,126,19,145
https://kawalpemilu.org#61510,"TEWAH, TEWAH, GUNUNG MAS, KALIMANTAN TENGAH",20,136,31,167
https://kawalpemilu.org#61510,"TEWAH, TEWAH, GUNUNG MAS, KALIMANTAN TENGAH",21,117,12,129
https://kawalpemilu.org#61510,"TEWAH, TEWAH, GUNUNG MAS, KALIMANTAN TENGAH",22,147,9,156
https://kawalpemilu.org#61510,"TEWAH, TEWAH, GUNUNG MAS, KALIMANTAN TENGAH",23,112,36,148
https://kawalpemilu.org#61510,"TEWAH, TEWAH, GUNUNG MAS, KALIMANTAN TENGAH",24,181,54,235
https://kawalpemilu.org#61510,"TEWAH, TEWAH, GUNUNG MAS, KALIMANTAN TENGAH",25,171,44,215
https://kawalpemilu.org#61510,"TEWAH, TEWAH, GUNUNG MAS, KALIMANTAN TENGAH",26,136,35,171
https://kawalpemilu.org#61511,"SARERANGAN, TEWAH, GUNUNG MAS, KALIMANTAN TENGAH",1,106,37,143
https://kawalpemilu.org#61511,"SARERANGAN, TEWAH, GUNUNG MAS, KALIMANTAN TENGAH",2,167,38,205
https://kawalpemilu.org#61511,"SARERANGAN, TEWAH, GUNUNG MAS, KALIMANTAN TENGAH",3,180,31,211
https://kawalpemilu.org#61512,"TUMBANG PAJANGEI, TEWAH, GUNUNG MAS, KALIMANTAN TENGAH",1,146,7,153
https://kawalpemilu.org#61512,"TUMBANG PAJANGEI, TEWAH, GUNUNG MAS, KALIMANTAN TENGAH",2,152,6,158
https://kawalpemilu.org#61513,"KASINTU, TEWAH, GUNUNG MAS, KALIMANTAN TENGAH",1,146,12,158
https://kawalpemilu.org#61513,"KASINTU, TEWAH, GUNUNG MAS, KALIMANTAN TENGAH",2,154,13,167
https://kawalpemilu.org#61514,"BATU NYIWUH, TEWAH, GUNUNG MAS, KALIMANTAN TENGAH",1,153,14,167
https://kawalpemilu.org#61514,"BATU NYIWUH, TEWAH, GUNUNG MAS, KALIMANTAN TENGAH",2,136,29,165
https://kawalpemilu.org#61514,"BATU NYIWUH, TEWAH, GUNUNG MAS, KALIMANTAN TENGAH",3,157,14,171
https://kawalpemilu.org#61514,"BATU NYIWUH, TEWAH, GUNUNG MAS, KALIMANTAN TENGAH",4,181,20,201
https://kawalpemilu.org#61515,"TUMBANG HABAON, TEWAH, GUNUNG MAS, KALIMANTAN TENGAH",1,213,13,226
https://kawalpemilu.org#61515,"TUMBANG HABAON, TEWAH, GUNUNG MAS, KALIMANTAN TENGAH",2,78,26,104
https://kawalpemilu.org#61516,"SEI RIANG, TEWAH, GUNUNG MAS, KALIMANTAN TENGAH",1,203,27,230
https://kawalpemilu.org#61517,"SANDUNG TAMBUN, TEWAH, GUNUNG MAS, KALIMANTAN TENGAH",1,134,14,148
https://kawalpemilu.org#61517,"SANDUNG TAMBUN, TEWAH, GUNUNG MAS, KALIMANTAN TENGAH",2,108,5,113
https://kawalpemilu.org#61517,"SANDUNG TAMBUN, TEWAH, GUNUNG MAS, KALIMANTAN TENGAH",3,109,9,118
https://kawalpemilu.org#61517,"SANDUNG TAMBUN, TEWAH, GUNUNG MAS, KALIMANTAN TENGAH",4,110,12,122
https://kawalpemilu.org#61518,"TANJUNGUNTUNG, TEWAH, GUNUNG MAS, KALIMANTAN TENGAH",1,76,40,116
https://kawalpemilu.org#61518,"TANJUNGUNTUNG, TEWAH, GUNUNG MAS, KALIMANTAN TENGAH",2,91,43,134
https://kawalpemilu.org#61518,"TANJUNGUNTUNG, TEWAH, GUNUNG MAS, KALIMANTAN TENGAH",3,111,26,137
https://kawalpemilu.org#61518,"TANJUNGUNTUNG, TEWAH, GUNUNG MAS, KALIMANTAN TENGAH",4,90,46,136
https://kawalpemilu.org#61519,"UPON BATU, TEWAH, GUNUNG MAS, KALIMANTAN TENGAH",1,119,24,143
https://kawalpemilu.org#61519,"UPON BATU, TEWAH, GUNUNG MAS, KALIMANTAN TENGAH",2,169,17,186
https://kawalpemilu.org#61520,"SUMUR MAS, TEWAH, GUNUNG MAS, KALIMANTAN TENGAH",1,179,21,200
https://kawalpemilu.org#61520,"SUMUR MAS, TEWAH, GUNUNG MAS, KALIMANTAN TENGAH",2,205,16,221
https://kawalpemilu.org#61521,"TAJA URAP, TEWAH, GUNUNG MAS, KALIMANTAN TENGAH",1,128,6,134
https://kawalpemilu.org#61521,"TAJA URAP, TEWAH, GUNUNG MAS, KALIMANTAN TENGAH",2,160,5,165
https://kawalpemilu.org#61522,"TELUKLAWAH, TEWAH, GUNUNG MAS, KALIMANTAN TENGAH",1,160,31,191
https://kawalpemilu.org#61522,"TELUKLAWAH, TEWAH, GUNUNG MAS, KALIMANTAN TENGAH",2,94,14,108
https://kawalpemilu.org#61522,"TELUKLAWAH, TEWAH, GUNUNG MAS, KALIMANTAN TENGAH",3,91,7,98
https://kawalpemilu.org#61523,"KARASON RAYA, TEWAH, GUNUNG MAS, KALIMANTAN TENGAH",1,117,13,130
https://kawalpemilu.org#61523,"KARASON RAYA, TEWAH, GUNUNG MAS, KALIMANTAN TENGAH",2,100,12,112
https://kawalpemilu.org#61524,"RANGAN MIHING, TEWAH, GUNUNG MAS, KALIMANTAN TENGAH",1,182,27,209
https://kawalpemilu.org#61525,"BATU NYAPAU, TEWAH, GUNUNG MAS, KALIMANTAN TENGAH",1,108,40,148
https://kawalpemilu.org#61525,"BATU NYAPAU, TEWAH, GUNUNG MAS, KALIMANTAN TENGAH",2,117,17,134
https://kawalpemilu.org#61527,"TUMBANG MIRI, KAHAYAN HULU UTARA, GUNUNG MAS, KALIMANTAN TENGAH",1,245,14,259
https://kawalpemilu.org#61527,"TUMBANG MIRI, KAHAYAN HULU UTARA, GUNUNG MAS, KALIMANTAN TENGAH",2,135,17,152
https://kawalpemilu.org#61527,"TUMBANG MIRI, KAHAYAN HULU UTARA, GUNUNG MAS, KALIMANTAN TENGAH",3,146,23,169
https://kawalpemilu.org#61527,"TUMBANG MIRI, KAHAYAN HULU UTARA, GUNUNG MAS, KALIMANTAN TENGAH",4,102,17,119
https://kawalpemilu.org#61527,"TUMBANG MIRI, KAHAYAN HULU UTARA, GUNUNG MAS, KALIMANTAN TENGAH",5,0,0,0
https://kawalpemilu.org#61527,"TUMBANG MIRI, KAHAYAN HULU UTARA, GUNUNG MAS, KALIMANTAN TENGAH",6,113,14,127
https://kawalpemilu.org#61527,"TUMBANG MIRI, KAHAYAN HULU UTARA, GUNUNG MAS, KALIMANTAN TENGAH",7,141,18,159
https://kawalpemilu.org#61528,"BATU TANGKOI, KAHAYAN HULU UTARA, GUNUNG MAS, KALIMANTAN TENGAH",1,169,17,186
https://kawalpemilu.org#61529,"PENDA RANGAS, KAHAYAN HULU UTARA, GUNUNG MAS, KALIMANTAN TENGAH",1,162,43,205
https://kawalpemilu.org#61530,"TUMBANG SIAN, KAHAYAN HULU UTARA, GUNUNG MAS, KALIMANTAN TENGAH",2,136,20,156
https://kawalpemilu.org#61531,"TUMBANG PASANGON, KAHAYAN HULU UTARA, GUNUNG MAS, KALIMANTAN TENGAH",1,143,19,162
https://kawalpemilu.org#61531,"TUMBANG PASANGON, KAHAYAN HULU UTARA, GUNUNG MAS, KALIMANTAN TENGAH",2,163,4,167
https://kawalpemilu.org#61531,"TUMBANG PASANGON, KAHAYAN HULU UTARA, GUNUNG MAS, KALIMANTAN TENGAH",3,165,9,174
https://kawalpemilu.org#61532,"TUMBANG KORIK, KAHAYAN HULU UTARA, GUNUNG MAS, KALIMANTAN TENGAH",1,187,5,192
https://kawalpemilu.org#61533,"TUMBANG PONYOI, KAHAYAN HULU UTARA, GUNUNG MAS, KALIMANTAN TENGAH",1,134,5,139
https://kawalpemilu.org#61534,"DANDANG, KAHAYAN HULU UTARA, GUNUNG MAS, KALIMANTAN TENGAH",1,125,32,157
https://kawalpemilu.org#61534,"DANDANG, KAHAYAN HULU UTARA, GUNUNG MAS, KALIMANTAN TENGAH",2,130,29,159
https://kawalpemilu.org#61534,"DANDANG, KAHAYAN HULU UTARA, GUNUNG MAS, KALIMANTAN TENGAH",3,0,0,0
https://kawalpemilu.org#61534,"DANDANG, KAHAYAN HULU UTARA, GUNUNG MAS, KALIMANTAN TENGAH",4,163,12,175
https://kawalpemilu.org#61535,"TUMBANG HAMPUTUNG, KAHAYAN HULU UTARA, GUNUNG MAS, KALIMANTAN TENGAH",1,144,14,158
https://kawalpemilu.org#61535,"TUMBANG HAMPUTUNG, KAHAYAN HULU UTARA, GUNUNG MAS, KALIMANTAN TENGAH",2,91,26,117
https://kawalpemilu.org#61536,"TUMBANG TANJUNGAN, KAHAYAN HULU UTARA, GUNUNG MAS, KALIMANTAN TENGAH",1,136,4,140
https://kawalpemilu.org#61536,"TUMBANG TANJUNGAN, KAHAYAN HULU UTARA, GUNUNG MAS, KALIMANTAN TENGAH",2,130,6,136
https://kawalpemilu.org#61537,"TUMBANG TAKAOI, KAHAYAN HULU UTARA, GUNUNG MAS, KALIMANTAN TENGAH",1,176,6,182
https://kawalpemilu.org#61538,"TELUK KANDURI, KAHAYAN HULU UTARA, GUNUNG MAS, KALIMANTAN TENGAH",1,146,18,164
https://kawalpemilu.org#61540,"JAKATAN RAYA, RUNGAN, GUNUNG MAS, KALIMANTAN TENGAH",1,134,40,174
https://kawalpemilu.org#61540,"JAKATAN RAYA, RUNGAN, GUNUNG MAS, KALIMANTAN TENGAH",2,113,114,227
https://kawalpemilu.org#61540,"JAKATAN RAYA, RUNGAN, GUNUNG MAS, KALIMANTAN TENGAH",3,167,96,263
https://kawalpemilu.org#61540,"JAKATAN RAYA, RUNGAN, GUNUNG MAS, KALIMANTAN TENGAH",4,172,54,226
https://kawalpemilu.org#61540,"JAKATAN RAYA, RUNGAN, GUNUNG MAS, KALIMANTAN TENGAH",5,181,33,214
https://kawalpemilu.org#61541,"TUMBANG JUTUH, RUNGAN, GUNUNG MAS, KALIMANTAN TENGAH",1,180,51,231
https://kawalpemilu.org#61541,"TUMBANG JUTUH, RUNGAN, GUNUNG MAS, KALIMANTAN TENGAH",2,185,40,225
https://kawalpemilu.org#61542,"TUMBANG BARINGEI, RUNGAN, GUNUNG MAS, KALIMANTAN TENGAH",1,182,26,208
https://kawalpemilu.org#61542,"TUMBANG BARINGEI, RUNGAN, GUNUNG MAS, KALIMANTAN TENGAH",2,191,38,229
https://kawalpemilu.org#61543,"TUMBANG MALAHOI, RUNGAN, GUNUNG MAS, KALIMANTAN TENGAH",1,197,19,216
https://kawalpemilu.org#61543,"TUMBANG MALAHOI, RUNGAN, GUNUNG MAS, KALIMANTAN TENGAH",2,139,9,148
https://kawalpemilu.org#61543,"TUMBANG MALAHOI, RUNGAN, GUNUNG MAS, KALIMANTAN TENGAH",3,167,12,179
https://kawalpemilu.org#61543,"TUMBANG MALAHOI, RUNGAN, GUNUNG MAS, KALIMANTAN TENGAH",4,133,17,150
https://kawalpemilu.org#61548,"TUMBANG BUNUT, RUNGAN, GUNUNG MAS, KALIMANTAN TENGAH",1,122,19,180
https://kawalpemilu.org#61548,"TUMBANG BUNUT, RUNGAN, GUNUNG MAS, KALIMANTAN TENGAH",2,122,24,146
https://kawalpemilu.org#61549,"TUMBANG KAJUEI, RUNGAN, GUNUNG MAS, KALIMANTAN TENGAH",1,131,41,174
https://kawalpemilu.org#61549,"TUMBANG KAJUEI, RUNGAN, GUNUNG MAS, KALIMANTAN TENGAH",2,144,35,179
https://kawalpemilu.org#61549,"TUMBANG KAJUEI, RUNGAN, GUNUNG MAS, KALIMANTAN TENGAH",3,164,43,207
https://kawalpemilu.org#61550,"LUWUK KANTOR, RUNGAN, GUNUNG MAS, KALIMANTAN TENGAH",1,63,58,121
https://kawalpemilu.org#61551,"LUWUK LANGKUAS, RUNGAN, GUNUNG MAS, KALIMANTAN TENGAH",2,184,32,216
https://kawalpemilu.org#61551,"LUWUK LANGKUAS, RUNGAN, GUNUNG MAS, KALIMANTAN TENGAH",3,41,8,49
https://kawalpemilu.org#61552,"TALANGKAH, RUNGAN, GUNUNG MAS, KALIMANTAN TENGAH",1,74,59,133
https://kawalpemilu.org#61553,"PAREMPEI, RUNGAN, GUNUNG MAS, KALIMANTAN TENGAH",1,139,27,166
https://kawalpemilu.org#61554,"LINAU, RUNGAN, GUNUNG MAS, KALIMANTAN TENGAH",1,94,75,169
https://kawalpemilu.org#61554,"LINAU, RUNGAN, GUNUNG MAS, KALIMANTAN TENGAH",2,100,71,171
https://kawalpemilu.org#61555,"BERENG BARU, RUNGAN, GUNUNG MAS, KALIMANTAN TENGAH",1,147,33,180
https://kawalpemilu.org#61556,"BERENG MALAKA, RUNGAN, GUNUNG MAS, KALIMANTAN TENGAH",1,158,16,174
https://kawalpemilu.org#61556,"BERENG MALAKA, RUNGAN, GUNUNG MAS, KALIMANTAN TENGAH",2,70,9,79
https://kawalpemilu.org#61560,"KARYA BHAKTI, RUNGAN, GUNUNG MAS, KALIMANTAN TENGAH",1,183,17,200
https://kawalpemilu.org#61562,"TUMBANG TALAKEN, MANUHING, GUNUNG MAS, KALIMANTAN TENGAH",1,181,13,195
https://kawalpemilu.org#61562,"TUMBANG TALAKEN, MANUHING, GUNUNG MAS, KALIMANTAN TENGAH",2,218,19,237
https://kawalpemilu.org#61562,"TUMBANG TALAKEN, MANUHING, GUNUNG MAS, KALIMANTAN TENGAH",3,130,15,145
https://kawalpemilu.org#61562,"TUMBANG TALAKEN, MANUHING, GUNUNG MAS, KALIMANTAN TENGAH",4,124,17,141
https://kawalpemilu.org#61562,"TUMBANG TALAKEN, MANUHING, GUNUNG MAS, KALIMANTAN TENGAH",5,135,26,161
https://kawalpemilu.org#61562,"TUMBANG TALAKEN, MANUHING, GUNUNG MAS, KALIMANTAN TENGAH",6,136,31,167
https://kawalpemilu.org#61562,"TUMBANG TALAKEN, MANUHING, GUNUNG MAS, KALIMANTAN TENGAH",7,138,23,161
https://kawalpemilu.org#61562,"TUMBANG TALAKEN, MANUHING, GUNUNG MAS, KALIMANTAN TENGAH",8,165,40,205
https://kawalpemilu.org#61563,"TUMBANG SEPAN, MANUHING, GUNUNG MAS, KALIMANTAN TENGAH",1,88,19,107
https://kawalpemilu.org#61564,"TANGKI DAHUYAN, MANUHING, GUNUNG MAS, KALIMANTAN TENGAH",1,192,26,218
https://kawalpemilu.org#61564,"TANGKI DAHUYAN, MANUHING, GUNUNG MAS, KALIMANTAN TENGAH",2,126,25,151
https://kawalpemilu.org#61564,"TANGKI DAHUYAN, MANUHING, GUNUNG MAS, KALIMANTAN TENGAH",3,121,22,143
https://kawalpemilu.org#61565,"BERENG BALAWAN, MANUHING, GUNUNG MAS, KALIMANTAN TENGAH",1,129,28,157
https://kawalpemilu.org#61566,"BERENG JUN, MANUHING, GUNUNG MAS, KALIMANTAN TENGAH",3,120,14,134
https://kawalpemilu.org#61566,"BERENG JUN, MANUHING, GUNUNG MAS, KALIMANTAN TENGAH",4,138,19,157
https://kawalpemilu.org#61567,"TAKARAS, MANUHING, GUNUNG MAS, KALIMANTAN TENGAH",1,198,13,211
https://kawalpemilu.org#61567,"TAKARAS, MANUHING, GUNUNG MAS, KALIMANTAN TENGAH",2,194,26,220
https://kawalpemilu.org#61568,"TUMBANG JALEMU, MANUHING, GUNUNG MAS, KALIMANTAN TENGAH",1,204,37,241
https://kawalpemilu.org#61569,"BELAWAN MULIA, MANUHING, GUNUNG MAS, KALIMANTAN TENGAH",1,148,20,168
https://kawalpemilu.org#61569,"BELAWAN MULIA, MANUHING, GUNUNG MAS, KALIMANTAN TENGAH",2,138,17,155
https://kawalpemilu.org#61570,"GOHONG, MANUHING, GUNUNG MAS, KALIMANTAN TENGAH",1,99,24,123
https://kawalpemilu.org#61570,"GOHONG, MANUHING, GUNUNG MAS, KALIMANTAN TENGAH",2,120,7,127
https://kawalpemilu.org#61571,"TARINGEN, MANUHING, GUNUNG MAS, KALIMANTAN TENGAH",1,153,37,190
https://kawalpemilu.org#61571,"TARINGEN, MANUHING, GUNUNG MAS, KALIMANTAN TENGAH",2,126,30,156
https://kawalpemilu.org#61572,"BANGUN SARI, MANUHING, GUNUNG MAS, KALIMANTAN TENGAH",1,121,26,147
https://kawalpemilu.org#61572,"BANGUN SARI, MANUHING, GUNUNG MAS, KALIMANTAN TENGAH",2,99,28,127
https://kawalpemilu.org#61573,"FAJAR HARAPAN, MANUHING, GUNUNG MAS, KALIMANTAN TENGAH",1,102,22,124
https://kawalpemilu.org#61573,"FAJAR HARAPAN, MANUHING, GUNUNG MAS, KALIMANTAN TENGAH",2,95,38,133
https://kawalpemilu.org#61573,"FAJAR HARAPAN, MANUHING, GUNUNG MAS, KALIMANTAN TENGAH",3,104,30,134
https://kawalpemilu.org#61573,"FAJAR HARAPAN, MANUHING, GUNUNG MAS, KALIMANTAN TENGAH",4,130,43,173
https://kawalpemilu.org#61573,"FAJAR HARAPAN, MANUHING, GUNUNG MAS, KALIMANTAN TENGAH",5,134,22,156
https://kawalpemilu.org#61575,"TUMBANG MARIKOI, DAMANG BATU, GUNUNG MAS, KALIMANTAN TENGAH",1,120,28,148
https://kawalpemilu.org#61575,"TUMBANG MARIKOI, DAMANG BATU, GUNUNG MAS, KALIMANTAN TENGAH",2,112,13,125
https://kawalpemilu.org#61575,"TUMBANG MARIKOI, DAMANG BATU, GUNUNG MAS, KALIMANTAN TENGAH",3,163,9,172
https://kawalpemilu.org#61575,"TUMBANG MARIKOI, DAMANG BATU, GUNUNG MAS, KALIMANTAN TENGAH",4,120,19,139
https://kawalpemilu.org#61576,"LAWANG KANJI, DAMANG BATU, GUNUNG MAS, KALIMANTAN TENGAH",1,146,5,151
https://kawalpemilu.org#61576,"LAWANG KANJI, DAMANG BATU, GUNUNG MAS, KALIMANTAN TENGAH",2,130,4,134
https://kawalpemilu.org#61577,"TUMBANG MAHUROI, DAMANG BATU, GUNUNG MAS, KALIMANTAN TENGAH",1,143,11,154
https://kawalpemilu.org#61577,"TUMBANG MAHUROI, DAMANG BATU, GUNUNG MAS, KALIMANTAN TENGAH",2,138,7,145
https://kawalpemilu.org#61577,"TUMBANG MAHUROI, DAMANG BATU, GUNUNG MAS, KALIMANTAN TENGAH",3,192,2,194
https://kawalpemilu.org#61578,"KERETAU RAMBANGUN, DAMANG BATU, GUNUNG MAS, KALIMANTAN TENGAH",1,96,8,104
https://kawalpemilu.org#61579,"KERETAU SARIAN, DAMANG BATU, GUNUNG MAS, KALIMANTAN TENGAH",1,157,9,166
https://kawalpemilu.org#61579,"KERETAU SARIAN, DAMANG BATU, GUNUNG MAS, KALIMANTAN TENGAH",2,138,6,144
https://kawalpemilu.org#61581,"TUMBANG MARAYA, DAMANG BATU, GUNUNG MAS, KALIMANTAN TENGAH",1,169,18,187
https://kawalpemilu.org#61582,"TUMBANG ANOI, DAMANG BATU, GUNUNG MAS, KALIMANTAN TENGAH",1,109,27,136
https://kawalpemilu.org#61582,"TUMBANG ANOI, DAMANG BATU, GUNUNG MAS, KALIMANTAN TENGAH",2,114,21,135
https://kawalpemilu.org#61584,"TUMBANG NAPOI, MIRI MANASA, GUNUNG MAS, KALIMANTAN TENGAH",1,151,20,171
https://kawalpemilu.org#61584,"TUMBANG NAPOI, MIRI MANASA, GUNUNG MAS, KALIMANTAN TENGAH",2,152,27,179
https://kawalpemilu.org#61587,"TUMBANG MASUKIH, MIRI MANASA, GUNUNG MAS, KALIMANTAN TENGAH",1,126,19,145
https://kawalpemilu.org#61587,"TUMBANG MASUKIH, MIRI MANASA, GUNUNG MAS, KALIMANTAN TENGAH",2,128,24,152
https://kawalpemilu.org#61588,"RANGAN HIRAN, MIRI MANASA, GUNUNG MAS, KALIMANTAN TENGAH",1,136,27,163
https://kawalpemilu.org#61589,"HAROWO, MIRI MANASA, GUNUNG MAS, KALIMANTAN TENGAH",1,94,16,110
https://kawalpemilu.org#61590,"TUMBANG MANYOI, MIRI MANASA, GUNUNG MAS, KALIMANTAN TENGAH",1,166,16,182
https://kawalpemilu.org#61591,"TUMBANG LAPAN, MIRI MANASA, GUNUNG MAS, KALIMANTAN TENGAH",1,166,24,190
https://kawalpemilu.org#61592,"BONTOI, MIRI MANASA, GUNUNG MAS, KALIMANTAN TENGAH",1,77,5,82
https://kawalpemilu.org#61593,"TUMBANG KOROI, MIRI MANASA, GUNUNG MAS, KALIMANTAN TENGAH",1,85,7,92
https://kawalpemilu.org#61594,"TUMBANG HATUNG, MIRI MANASA, GUNUNG MAS, KALIMANTAN TENGAH",1,85,9,94
https://kawalpemilu.org#61596,"TUMBANG RAHUYAN, RUNGAN HULU, GUNUNG MAS, KALIMANTAN TENGAH",1,167,55,222
https://kawalpemilu.org#61596,"TUMBANG RAHUYAN, RUNGAN HULU, GUNUNG MAS, KALIMANTAN TENGAH",2,123,67,190
https://kawalpemilu.org#61596,"TUMBANG RAHUYAN, RUNGAN HULU, GUNUNG MAS, KALIMANTAN TENGAH",3,153,33,186
https://kawalpemilu.org#61596,"TUMBANG RAHUYAN, RUNGAN HULU, GUNUNG MAS, KALIMANTAN TENGAH",4,144,67,211
https://kawalpemilu.org#61597,"JANGKIT, RUNGAN HULU, GUNUNG MAS, KALIMANTAN TENGAH",1,92,22,114
https://kawalpemilu.org#61597,"JANGKIT, RUNGAN HULU, GUNUNG MAS, KALIMANTAN TENGAH",2,98,29,127
https://kawalpemilu.org#61598,"TUMBANG LAPAN, RUNGAN HULU, GUNUNG MAS, KALIMANTAN TENGAH",1,146,21,167
https://kawalpemilu.org#61598,"TUMBANG LAPAN, RUNGAN HULU, GUNUNG MAS, KALIMANTAN TENGAH",2,146,13,159
https://kawalpemilu.org#61598,"TUMBANG LAPAN, RUNGAN HULU, GUNUNG MAS, KALIMANTAN TENGAH",3,130,13,143
https://kawalpemilu.org#61599,"BATU PUTER, RUNGAN HULU, GUNUNG MAS, KALIMANTAN TENGAH",1,153,39,192
https://kawalpemilu.org#61599,"BATU PUTER, RUNGAN HULU, GUNUNG MAS, KALIMANTAN TENGAH",2,157,38,195
https://kawalpemilu.org#61599,"BATU PUTER, RUNGAN HULU, GUNUNG MAS, KALIMANTAN TENGAH",3,139,52,191
https://kawalpemilu.org#61600,"SEI ANTAI, RUNGAN HULU, GUNUNG MAS, KALIMANTAN TENGAH",1,162,27,189
https://kawalpemilu.org#61600,"SEI ANTAI, RUNGAN HULU, GUNUNG MAS, KALIMANTAN TENGAH",2,147,21,168
https://kawalpemilu.org#61600,"SEI ANTAI, RUNGAN HULU, GUNUNG MAS, KALIMANTAN TENGAH",3,148,43,191
https://kawalpemilu.org#61601,"TUMBANG MUJAI, RUNGAN HULU, GUNUNG MAS, KALIMANTAN TENGAH",1,96,20,116
https://kawalpemilu.org#61602,"SANGAL, RUNGAN HULU, GUNUNG MAS, KALIMANTAN TENGAH",1,104,37,141
https://kawalpemilu.org#61602,"SANGAL, RUNGAN HULU, GUNUNG MAS, KALIMANTAN TENGAH",2,100,29,129
https://kawalpemilu.org#61603,"TUMBANG TUWE, RUNGAN HULU, GUNUNG MAS, KALIMANTAN TENGAH",1,118,13,131
https://kawalpemilu.org#61604,"HANTAPANG, RUNGAN HULU, GUNUNG MAS, KALIMANTAN TENGAH",1,180,27,207
https://kawalpemilu.org#61604,"HANTAPANG, RUNGAN HULU, GUNUNG MAS, KALIMANTAN TENGAH",2,168,17,185
https://kawalpemilu.org#61608,"TEHANG, MAHUNING RAYA, GUNUNG MAS, KALIMANTAN TENGAH",1,128,22,150
https://kawalpemilu.org#61608,"TEHANG, MAHUNING RAYA, GUNUNG MAS, KALIMANTAN TENGAH",2,120,16,136
https://kawalpemilu.org#61608,"TEHANG, MAHUNING RAYA, GUNUNG MAS, KALIMANTAN TENGAH",3,111,8,119
https://kawalpemilu.org#61608,"TEHANG, MAHUNING RAYA, GUNUNG MAS, KALIMANTAN TENGAH",4,90,9,99
https://kawalpemilu.org#61608,"TEHANG, MAHUNING RAYA, GUNUNG MAS, KALIMANTAN TENGAH",5,109,11,120
https://kawalpemilu.org#61608,"TEHANG, MAHUNING RAYA, GUNUNG MAS, KALIMANTAN TENGAH",6,119,12,131
https://kawalpemilu.org#61608,"TEHANG, MAHUNING RAYA, GUNUNG MAS, KALIMANTAN TENGAH",7,141,20,161
https://kawalpemilu.org#61608,"TEHANG, MAHUNING RAYA, GUNUNG MAS, KALIMANTAN TENGAH",8,137,15,152
https://kawalpemilu.org#61608,"TEHANG, MAHUNING RAYA, GUNUNG MAS, KALIMANTAN TENGAH",9,186,14,199
https://kawalpemilu.org#61609,"TUMBANG SAMUI, MAHUNING RAYA, GUNUNG MAS, KALIMANTAN TENGAH",1,131,20,151
https://kawalpemilu.org#61609,"TUMBANG SAMUI, MAHUNING RAYA, GUNUNG MAS, KALIMANTAN TENGAH",2,139,58,197
https://kawalpemilu.org#61610,"TUMBANG OROI, MAHUNING RAYA, GUNUNG MAS, KALIMANTAN TENGAH",1,119,23,142
https://kawalpemilu.org#61610,"TUMBANG OROI, MAHUNING RAYA, GUNUNG MAS, KALIMANTAN TENGAH",2,112,32,144
https://kawalpemilu.org#61611,"LUWUK TUKAU, MAHUNING RAYA, GUNUNG MAS, KALIMANTAN TENGAH",1,190,14,204
https://kawalpemilu.org#61611,"LUWUK TUKAU, MAHUNING RAYA, GUNUNG MAS, KALIMANTAN TENGAH",2,153,7,160
https://kawalpemilu.org#61611,"LUWUK TUKAU, MAHUNING RAYA, GUNUNG MAS, KALIMANTAN TENGAH",3,146,11,157
https://kawalpemilu.org#61612,"PUTAT DUREI, MAHUNING RAYA, GUNUNG MAS, KALIMANTAN TENGAH",1,108,10,118
https://kawalpemilu.org#61612,"PUTAT DUREI, MAHUNING RAYA, GUNUNG MAS, KALIMANTAN TENGAH",2,111,8,119
https://kawalpemilu.org#85392,"SEPANG KOTA, SEPANG SIMIN, GUNUNG MAS, KALIMANTAN TENGAH",1,201,12,213
https://kawalpemilu.org#85392,"SEPANG KOTA, SEPANG SIMIN, GUNUNG MAS, KALIMANTAN TENGAH",2,200,12,212
https://kawalpemilu.org#85392,"SEPANG KOTA, SEPANG SIMIN, GUNUNG MAS, KALIMANTAN TENGAH",3,204,18,222
https://kawalpemilu.org#85392,"SEPANG KOTA, SEPANG SIMIN, GUNUNG MAS, KALIMANTAN TENGAH",4,203,9,212
https://kawalpemilu.org#85392,"SEPANG KOTA, SEPANG SIMIN, GUNUNG MAS, KALIMANTAN TENGAH",5,215,21,236
https://kawalpemilu.org#85393,"TEWAI BARU, SEPANG SIMIN, GUNUNG MAS, KALIMANTAN TENGAH",1,198,10,208
https://kawalpemilu.org#85393,"TEWAI BARU, SEPANG SIMIN, GUNUNG MAS, KALIMANTAN TENGAH",2,181,12,193
https://kawalpemilu.org#85393,"TEWAI BARU, SEPANG SIMIN, GUNUNG MAS, KALIMANTAN TENGAH",3,187,8,195
https://kawalpemilu.org#85394,"TANJUNG KARITAK, SEPANG SIMIN, GUNUNG MAS, KALIMANTAN TENGAH",1,176,42,218
https://kawalpemilu.org#85394,"TANJUNG KARITAK, SEPANG SIMIN, GUNUNG MAS, KALIMANTAN TENGAH",2,181,41,222
https://kawalpemilu.org#85394,"TANJUNG KARITAK, SEPANG SIMIN, GUNUNG MAS, KALIMANTAN TENGAH",3,193,29,222
https://kawalpemilu.org#88607,"SEPANG SIMIN, SEPANG SIMIN, GUNUNG MAS, KALIMANTAN TENGAH",1,214,25,239
https://kawalpemilu.org#88607,"SEPANG SIMIN, SEPANG SIMIN, GUNUNG MAS, KALIMANTAN TENGAH",2,200,29,229
https://kawalpemilu.org#88607,"SEPANG SIMIN, SEPANG SIMIN, GUNUNG MAS, KALIMANTAN TENGAH",3,208,15,223
https://kawalpemilu.org#88607,"SEPANG SIMIN, SEPANG SIMIN, GUNUNG MAS, KALIMANTAN TENGAH",4,187,1,205
https://kawalpemilu.org#88609,"TAMPELAS, SEPANG SIMIN, GUNUNG MAS, KALIMANTAN TENGAH",1,187,22,209
https://kawalpemilu.org#88609,"TAMPELAS, SEPANG SIMIN, GUNUNG MAS, KALIMANTAN TENGAH",2,171,19,190
https://kawalpemilu.org#88610,"RABAUH, SEPANG SIMIN, GUNUNG MAS, KALIMANTAN TENGAH",1,179,5,184
https://kawalpemilu.org#88610,"RABAUH, SEPANG SIMIN, GUNUNG MAS, KALIMANTAN TENGAH",2,174,10,184
https://kawalpemilu.org#92578,"PAMATANG LIMAU, SEPANG SIMIN, GUNUNG MAS, KALIMANTAN TENGAH",1,162,12,174
https://kawalpemilu.org#92578,"PAMATANG LIMAU, SEPANG SIMIN, GUNUNG MAS, KALIMANTAN TENGAH",2,165,8,173
https://kawalpemilu.org#61544,"TUMBANG KUAYAN, RUNGAN BARAT, GUNUNG MAS, KALIMANTAN TENGAH",1,137,34,171
https://kawalpemilu.org#61544,"TUMBANG KUAYAN, RUNGAN BARAT, GUNUNG MAS, KALIMANTAN TENGAH",2,147,14,161
https://kawalpemilu.org#61545,"RABAMBANG, RUNGAN BARAT, GUNUNG MAS, KALIMANTAN TENGAH",1,107,46,153
https://kawalpemilu.org#61545,"RABAMBANG, RUNGAN BARAT, GUNUNG MAS, KALIMANTAN TENGAH",2,112,19,131
https://kawalpemilu.org#61545,"RABAMBANG, RUNGAN BARAT, GUNUNG MAS, KALIMANTAN TENGAH",3,117,16,133
https://kawalpemilu.org#61545,"RABAMBANG, RUNGAN BARAT, GUNUNG MAS, KALIMANTAN TENGAH",4,98,17,115
https://kawalpemilu.org#61545,"RABAMBANG, RUNGAN BARAT, GUNUNG MAS, KALIMANTAN TENGAH",5,76,52,128
https://kawalpemilu.org#61545,"RABAMBANG, RUNGAN BARAT, GUNUNG MAS, KALIMANTAN TENGAH",6,97,27,124
https://kawalpemilu.org#61545,"RABAMBANG, RUNGAN BARAT, GUNUNG MAS, KALIMANTAN TENGAH",7,109,72,181
https://kawalpemilu.org#61546,"JALEMU MASULAN, RUNGAN BARAT, GUNUNG MAS, KALIMANTAN TENGAH",1,123,29,152
https://kawalpemilu.org#61605,"TUMBANG LANGGAH, RUNGAN BARAT, GUNUNG MAS, KALIMANTAN TENGAH",1,89,31,120
https://kawalpemilu.org#61605,"TUMBANG LANGGAH, RUNGAN BARAT, GUNUNG MAS, KALIMANTAN TENGAH",2,71,41,112
https://kawalpemilu.org#61606,"TUMBANG BAHANEI, RUNGAN BARAT, GUNUNG MAS, KALIMANTAN TENGAH",1,121,6,127
https://kawalpemilu.org#61606,"TUMBANG BAHANEI, RUNGAN BARAT, GUNUNG MAS, KALIMANTAN TENGAH",2,126,10,136
https://kawalpemilu.org#85395,"HUJUNG PATA, RUNGAN BARAT, GUNUNG MAS, KALIMANTAN TENGAH",1,125,9,134
https://kawalpemilu.org#85395,"HUJUNG PATA, RUNGAN BARAT, GUNUNG MAS, KALIMANTAN TENGAH",2,135,7,142
https://kawalpemilu.org#85395,"HUJUNG PATA, RUNGAN BARAT, GUNUNG MAS, KALIMANTAN TENGAH",3,125,30,155
https://kawalpemilu.org#85396,"TUMBANG JELEMU KAJUEI, RUNGAN BARAT, GUNUNG MAS, KALIMANTAN TENGAH",1,165,10,175
https://kawalpemilu.org#85397,"JELEMU RAYA, RUNGAN BARAT, GUNUNG MAS, KALIMANTAN TENGAH",1,150,22,172
https://kawalpemilu.org#85397,"JELEMU RAYA, RUNGAN BARAT, GUNUNG MAS, KALIMANTAN TENGAH",2,173,18,191
https://kawalpemilu.org#85398,"MANGKAWUK, RUNGAN BARAT, GUNUNG MAS, KALIMANTAN TENGAH",1,156,29,185
https://kawalpemilu.org#85399,"TAJAH ANTANG RAYA, RUNGAN BARAT, GUNUNG MAS, KALIMANTAN TENGAH",1,113,26,139
https://kawalpemilu.org#88611,"TUSANG RAYA, RUNGAN BARAT, GUNUNG MAS, KALIMANTAN TENGAH",1,132,12,144
https://kawalpemilu.org#85400,"KAMPURI, MIHING RAYA, GUNUNG MAS, KALIMANTAN TENGAH",1,220,20,240
https://kawalpemilu.org#85400,"KAMPURI, MIHING RAYA, GUNUNG MAS, KALIMANTAN TENGAH",2,149,13,162
https://kawalpemilu.org#85400,"KAMPURI, MIHING RAYA, GUNUNG MAS, KALIMANTAN TENGAH",3,140,9,149
https://kawalpemilu.org#85400,"KAMPURI, MIHING RAYA, GUNUNG MAS, KALIMANTAN TENGAH",4,182,7,189
https://kawalpemilu.org#85400,"KAMPURI, MIHING RAYA, GUNUNG MAS, KALIMANTAN TENGAH",5,167,30,197
https://kawalpemilu.org#85401,"TUYUN, MIHING RAYA, GUNUNG MAS, KALIMANTAN TENGAH",1,219,4,223
https://kawalpemilu.org#85401,"TUYUN, MIHING RAYA, GUNUNG MAS, KALIMANTAN TENGAH",2,185,8,193
https://kawalpemilu.org#85401,"TUYUN, MIHING RAYA, GUNUNG MAS, KALIMANTAN TENGAH",3,102,6,108
https://kawalpemilu.org#85402,"TUMBANG EMPAS, MIHING RAYA, GUNUNG MAS, KALIMANTAN TENGAH",1,155,18,173
https://kawalpemilu.org#85402,"TUMBANG EMPAS, MIHING RAYA, GUNUNG MAS, KALIMANTAN TENGAH",2,157,18,175
https://kawalpemilu.org#85402,"TUMBANG EMPAS, MIHING RAYA, GUNUNG MAS, KALIMANTAN TENGAH",3,199,11,210
https://kawalpemilu.org#85403,"RANGAN TATE, MIHING RAYA, GUNUNG MAS, KALIMANTAN TENGAH",1,232,11,243
https://kawalpemilu.org#85403,"RANGAN TATE, MIHING RAYA, GUNUNG MAS, KALIMANTAN TENGAH",2,215,14,229
https://kawalpemilu.org#85404,"DAHIAN TAMBUK, MIHING RAYA, GUNUNG MAS, KALIMANTAN TENGAH",1,134,7,141
https://kawalpemilu.org#85404,"DAHIAN TAMBUK, MIHING RAYA, GUNUNG MAS, KALIMANTAN TENGAH",2,112,4,116
https://kawalpemilu.org#85404,"DAHIAN TAMBUK, MIHING RAYA, GUNUNG MAS, KALIMANTAN TENGAH",4,120,3,123
https://kawalpemilu.org#85404,"DAHIAN TAMBUK, MIHING RAYA, GUNUNG MAS, KALIMANTAN TENGAH",5,127,4,131
https://kawalpemilu.org#85405,"TUMBANG DANAU, MIHING RAYA, GUNUNG MAS, KALIMANTAN TENGAH",1,146,16,162
https://kawalpemilu.org#85405,"TUMBANG DANAU, MIHING RAYA, GUNUNG MAS, KALIMANTAN TENGAH",2,132,17,149
https://kawalpemilu.org#61616,"DANDANG, PANDIH BATU, PULANG PISAU, KALIMANTAN TENGAH",1,72,54,126
https://kawalpemilu.org#61616,"DANDANG, PANDIH BATU, PULANG PISAU, KALIMANTAN TENGAH",2,71,50,121
https://kawalpemilu.org#61616,"DANDANG, PANDIH BATU, PULANG PISAU, KALIMANTAN TENGAH",3,82,62,144
https://kawalpemilu.org#61616,"DANDANG, PANDIH BATU, PULANG PISAU, KALIMANTAN TENGAH",4,92,43,135
https://kawalpemilu.org#61616,"DANDANG, PANDIH BATU, PULANG PISAU, KALIMANTAN TENGAH",5,71,59,130
https://kawalpemilu.org#61616,"DANDANG, PANDIH BATU, PULANG PISAU, KALIMANTAN TENGAH",6,83,19,102
https://kawalpemilu.org#61617,"TALIO, PANDIH BATU, PULANG PISAU, KALIMANTAN TENGAH",1,103,16,119
https://kawalpemilu.org#61618,"PANGKOH HILIR, PANDIH BATU, PULANG PISAU, KALIMANTAN TENGAH",1,209,26,235
https://kawalpemilu.org#61618,"PANGKOH HILIR, PANDIH BATU, PULANG PISAU, KALIMANTAN TENGAH",2,139,74,213
https://kawalpemilu.org#61619,"PANGKOH HULU, PANDIH BATU, PULANG PISAU, KALIMANTAN TENGAH",1,147,64,211
https://kawalpemilu.org#61619,"PANGKOH HULU, PANDIH BATU, PULANG PISAU, KALIMANTAN TENGAH",2,152,39,191
https://kawalpemilu.org#61619,"PANGKOH HULU, PANDIH BATU, PULANG PISAU, KALIMANTAN TENGAH",3,76,117,193
https://kawalpemilu.org#61620,"KANTAN MUARA, PANDIH BATU, PULANG PISAU, KALIMANTAN TENGAH",1,94,95,189
https://kawalpemilu.org#61620,"KANTAN MUARA, PANDIH BATU, PULANG PISAU, KALIMANTAN TENGAH",2,106,81,187
https://kawalpemilu.org#61620,"KANTAN MUARA, PANDIH BATU, PULANG PISAU, KALIMANTAN TENGAH",3,82,82,164
https://kawalpemilu.org#61620,"KANTAN MUARA, PANDIH BATU, PULANG PISAU, KALIMANTAN TENGAH",4,101,35,136
https://kawalpemilu.org#61620,"KANTAN MUARA, PANDIH BATU, PULANG PISAU, KALIMANTAN TENGAH",5,79,76,156
https://kawalpemilu.org#61620,"KANTAN MUARA, PANDIH BATU, PULANG PISAU, KALIMANTAN TENGAH",6,107,36,143
https://kawalpemilu.org#61621,"TALIO MUARA, PANDIH BATU, PULANG PISAU, KALIMANTAN TENGAH",1,129,54,183
https://kawalpemilu.org#61621,"TALIO MUARA, PANDIH BATU, PULANG PISAU, KALIMANTAN TENGAH",2,111,45,156
https://kawalpemilu.org#61621,"TALIO MUARA, PANDIH BATU, PULANG PISAU, KALIMANTAN TENGAH",3,149,54,203
https://kawalpemilu.org#61621,"TALIO MUARA, PANDIH BATU, PULANG PISAU, KALIMANTAN TENGAH",4,126,57,183
https://kawalpemilu.org#61621,"TALIO MUARA, PANDIH BATU, PULANG PISAU, KALIMANTAN TENGAH",5,135,59,194
https://kawalpemilu.org#61621,"TALIO MUARA, PANDIH BATU, PULANG PISAU, KALIMANTAN TENGAH",6,126,68,194
https://kawalpemilu.org#61621,"TALIO MUARA, PANDIH BATU, PULANG PISAU, KALIMANTAN TENGAH",7,133,30,163
https://kawalpemilu.org#61622,"TALIO HULU, PANDIH BATU, PULANG PISAU, KALIMANTAN TENGAH",1,88,67,155
https://kawalpemilu.org#61622,"TALIO HULU, PANDIH BATU, PULANG PISAU, KALIMANTAN TENGAH",2,42,112,154
https://kawalpemilu.org#61622,"TALIO HULU, PANDIH BATU, PULANG PISAU, KALIMANTAN TENGAH",3,69,102,171
https://kawalpemilu.org#61622,"TALIO HULU, PANDIH BATU, PULANG PISAU, KALIMANTAN TENGAH",4,113,27,140
https://kawalpemilu.org#61622,"TALIO HULU, PANDIH BATU, PULANG PISAU, KALIMANTAN TENGAH",5,104,93,197
https://kawalpemilu.org#61622,"TALIO HULU, PANDIH BATU, PULANG PISAU, KALIMANTAN TENGAH",6,121,59,180
https://kawalpemilu.org#61622,"TALIO HULU, PANDIH BATU, PULANG PISAU, KALIMANTAN TENGAH",7,85,99,184
https://kawalpemilu.org#61623,"PANGKOH SARI, PANDIH BATU, PULANG PISAU, KALIMANTAN TENGAH",1,78,92,170
https://kawalpemilu.org#61623,"PANGKOH SARI, PANDIH BATU, PULANG PISAU, KALIMANTAN TENGAH",2,84,91,171
https://kawalpemilu.org#61623,"PANGKOH SARI, PANDIH BATU, PULANG PISAU, KALIMANTAN TENGAH",3,96,73,169
https://kawalpemilu.org#61623,"PANGKOH SARI, PANDIH BATU, PULANG PISAU, KALIMANTAN TENGAH",4,110,65,175
https://kawalpemilu.org#61624,"SANGGANG, PANDIH BATU, PULANG PISAU, KALIMANTAN TENGAH",1,135,40,175
https://kawalpemilu.org#61624,"SANGGANG, PANDIH BATU, PULANG PISAU, KALIMANTAN TENGAH",2,149,52,201
https://kawalpemilu.org#61624,"SANGGANG, PANDIH BATU, PULANG PISAU, KALIMANTAN TENGAH",3,116,28,144
https://kawalpemilu.org#61625,"PANTIK, PANDIH BATU, PULANG PISAU, KALIMANTAN TENGAH",1,75,83,158
https://kawalpemilu.org#61625,"PANTIK, PANDIH BATU, PULANG PISAU, KALIMANTAN TENGAH",2,96,39,135
https://kawalpemilu.org#61626,"BELANTI SIAM, PANDIH BATU, PULANG PISAU, KALIMANTAN TENGAH",1,117,26,143
https://kawalpemilu.org#61626,"BELANTI SIAM, PANDIH BATU, PULANG PISAU, KALIMANTAN TENGAH",2,128,20,148
https://kawalpemilu.org#61626,"BELANTI SIAM, PANDIH BATU, PULANG PISAU, KALIMANTAN TENGAH",3,180,25,205
https://kawalpemilu.org#61626,"BELANTI SIAM, PANDIH BATU, PULANG PISAU, KALIMANTAN TENGAH",4,131,33,164
https://kawalpemilu.org#61626,"BELANTI SIAM, PANDIH BATU, PULANG PISAU, KALIMANTAN TENGAH",5,171,72,243
https://kawalpemilu.org#61626,"BELANTI SIAM, PANDIH BATU, PULANG PISAU, KALIMANTAN TENGAH",6,196,39,235
https://kawalpemilu.org#61626,"BELANTI SIAM, PANDIH BATU, PULANG PISAU, KALIMANTAN TENGAH",7,96,34,130
https://kawalpemilu.org#61626,"BELANTI SIAM, PANDIH BATU, PULANG PISAU, KALIMANTAN TENGAH",8,153,48,201
https://kawalpemilu.org#61626,"BELANTI SIAM, PANDIH BATU, PULANG PISAU, KALIMANTAN TENGAH",9,175,24,199
https://kawalpemilu.org#61627,"GADABUNG, PANDIH BATU, PULANG PISAU, KALIMANTAN TENGAH",1,157,36,193
https://kawalpemilu.org#61627,"GADABUNG, PANDIH BATU, PULANG PISAU, KALIMANTAN TENGAH",2,121,25,146
https://kawalpemilu.org#61627,"GADABUNG, PANDIH BATU, PULANG PISAU, KALIMANTAN TENGAH",3,129,42,171
https://kawalpemilu.org#61627,"GADABUNG, PANDIH BATU, PULANG PISAU, KALIMANTAN TENGAH",4,162,65,227
https://kawalpemilu.org#61627,"GADABUNG, PANDIH BATU, PULANG PISAU, KALIMANTAN TENGAH",5,200,35,235
https://kawalpemilu.org#61628,"MULYA SARI, PANDIH BATU, PULANG PISAU, KALIMANTAN TENGAH",1,134,34,168
https://kawalpemilu.org#61628,"MULYA SARI, PANDIH BATU, PULANG PISAU, KALIMANTAN TENGAH",2,111,42,153
https://kawalpemilu.org#61628,"MULYA SARI, PANDIH BATU, PULANG PISAU, KALIMANTAN TENGAH",3,130,42,172
https://kawalpemilu.org#61628,"MULYA SARI, PANDIH BATU, PULANG PISAU, KALIMANTAN TENGAH",4,111,46,157
https://kawalpemilu.org#61628,"MULYA SARI, PANDIH BATU, PULANG PISAU, KALIMANTAN TENGAH",5,85,50,135
https://kawalpemilu.org#61629,"KANTAN DALAM, PANDIH BATU, PULANG PISAU, KALIMANTAN TENGAH",1,144,65,209
https://kawalpemilu.org#61629,"KANTAN DALAM, PANDIH BATU, PULANG PISAU, KALIMANTAN TENGAH",2,147,70,217
https://kawalpemilu.org#61629,"KANTAN DALAM, PANDIH BATU, PULANG PISAU, KALIMANTAN TENGAH",3,116,16,132
https://kawalpemilu.org#61629,"KANTAN DALAM, PANDIH BATU, PULANG PISAU, KALIMANTAN TENGAH",4,162,59,221
https://kawalpemilu.org#61629,"KANTAN DALAM, PANDIH BATU, PULANG PISAU, KALIMANTAN TENGAH",5,97,56,153
https://kawalpemilu.org#61630,"KANTAN ATAS, PANDIH BATU, PULANG PISAU, KALIMANTAN TENGAH",1,85,108,193
https://kawalpemilu.org#61630,"KANTAN ATAS, PANDIH BATU, PULANG PISAU, KALIMANTAN TENGAH",2,123,61,184
https://kawalpemilu.org#61630,"KANTAN ATAS, PANDIH BATU, PULANG PISAU, KALIMANTAN TENGAH",3,104,37,141
https://kawalpemilu.org#61630,"KANTAN ATAS, PANDIH BATU, PULANG PISAU, KALIMANTAN TENGAH",4,110,74,184
https://kawalpemilu.org#88612,"KARYA BERSAMA, PANDIH BATU, PULANG PISAU, KALIMANTAN TENGAH",1,79,39,118
https://kawalpemilu.org#88612,"KARYA BERSAMA, PANDIH BATU, PULANG PISAU, KALIMANTAN TENGAH",2,105,111,216
https://kawalpemilu.org#88612,"KARYA BERSAMA, PANDIH BATU, PULANG PISAU, KALIMANTAN TENGAH",3,73,77,150
https://kawalpemilu.org#61632,"CEMANTAN, KAHAYAN KUALA, PULANG PISAU, KALIMANTAN TENGAH",1,104,122,226
https://kawalpemilu.org#61632,"CEMANTAN, KAHAYAN KUALA, PULANG PISAU, KALIMANTAN TENGAH",2,87,69,156
https://kawalpemilu.org#61632,"CEMANTAN, KAHAYAN KUALA, PULANG PISAU, KALIMANTAN TENGAH",3,79,144,223
https://kawalpemilu.org#61633,"SEI BARUNAI, KAHAYAN KUALA, PULANG PISAU, KALIMANTAN TENGAH",1,60,103,163
https://kawalpemilu.org#61633,"SEI BARUNAI, KAHAYAN KUALA, PULANG PISAU, KALIMANTAN TENGAH",2,34,79,113
https://kawalpemilu.org#61633,"SEI BARUNAI, KAHAYAN KUALA, PULANG PISAU, KALIMANTAN TENGAH",3,34,115,149
https://kawalpemilu.org#61634,"KIAPAK, KAHAYAN KUALA, PULANG PISAU, KALIMANTAN TENGAH",1,47,69,116
https://kawalpemilu.org#61634,"KIAPAK, KAHAYAN KUALA, PULANG PISAU, KALIMANTAN TENGAH",2,49,99,148
https://kawalpemilu.org#61634,"KIAPAK, KAHAYAN KUALA, PULANG PISAU, KALIMANTAN TENGAH",3,41,105,146
https://kawalpemilu.org#61636,"SUNGAI RUNGUN, KAHAYAN KUALA, PULANG PISAU, KALIMANTAN TENGAH",2,38,146,184
https://kawalpemilu.org#61636,"SUNGAI RUNGUN, KAHAYAN KUALA, PULANG PISAU, KALIMANTAN TENGAH",3,40,161,201
https://kawalpemilu.org#61636,"SUNGAI RUNGUN, KAHAYAN KUALA, PULANG PISAU, KALIMANTAN TENGAH",4,24,144,168
https://kawalpemilu.org#61637,"BAHAUR HILIR, KAHAYAN KUALA, PULANG PISAU, KALIMANTAN TENGAH",1,23,110,133
https://kawalpemilu.org#61637,"BAHAUR HILIR, KAHAYAN KUALA, PULANG PISAU, KALIMANTAN TENGAH",2,70,168,238
https://kawalpemilu.org#61637,"BAHAUR HILIR, KAHAYAN KUALA, PULANG PISAU, KALIMANTAN TENGAH",3,64,151,215
https://kawalpemilu.org#61637,"BAHAUR HILIR, KAHAYAN KUALA, PULANG PISAU, KALIMANTAN TENGAH",4,61,158,219
https://kawalpemilu.org#61637,"BAHAUR HILIR, KAHAYAN KUALA, PULANG PISAU, KALIMANTAN TENGAH",5,68,95,163
https://kawalpemilu.org#61637,"BAHAUR HILIR, KAHAYAN KUALA, PULANG PISAU, KALIMANTAN TENGAH",6,31,93,124
https://kawalpemilu.org#61638,"BAHAUR TENGAH, KAHAYAN KUALA, PULANG PISAU, KALIMANTAN TENGAH",1,119,127,246
https://kawalpemilu.org#61638,"BAHAUR TENGAH, KAHAYAN KUALA, PULANG PISAU, KALIMANTAN TENGAH",2,107,97,204
https://kawalpemilu.org#61638,"BAHAUR TENGAH, KAHAYAN KUALA, PULANG PISAU, KALIMANTAN TENGAH",3,97,114,211
https://kawalpemilu.org#61638,"BAHAUR TENGAH, KAHAYAN KUALA, PULANG PISAU, KALIMANTAN TENGAH",4,92,82,174
https://kawalpemilu.org#61638,"BAHAUR TENGAH, KAHAYAN KUALA, PULANG PISAU, KALIMANTAN TENGAH",5,92,81,173
https://kawalpemilu.org#61638,"BAHAUR TENGAH, KAHAYAN KUALA, PULANG PISAU, KALIMANTAN TENGAH",6,55,140,195
https://kawalpemilu.org#61638,"BAHAUR TENGAH, KAHAYAN KUALA, PULANG PISAU, KALIMANTAN TENGAH",7,62,121,183
https://kawalpemilu.org#61638,"BAHAUR TENGAH, KAHAYAN KUALA, PULANG PISAU, KALIMANTAN TENGAH",8,85,152,237
https://kawalpemilu.org#61638,"BAHAUR TENGAH, KAHAYAN KUALA, PULANG PISAU, KALIMANTAN TENGAH",9,32,56,88
https://kawalpemilu.org#61639,"BAHAUR HULU, KAHAYAN KUALA, PULANG PISAU, KALIMANTAN TENGAH",1,89,70,159
https://kawalpemilu.org#61639,"BAHAUR HULU, KAHAYAN KUALA, PULANG PISAU, KALIMANTAN TENGAH",2,48,164,212
https://kawalpemilu.org#61639,"BAHAUR HULU, KAHAYAN KUALA, PULANG PISAU, KALIMANTAN TENGAH",3,114,90,204
https://kawalpemilu.org#61639,"BAHAUR HULU, KAHAYAN KUALA, PULANG PISAU, KALIMANTAN TENGAH",4,103,63,166
https://kawalpemilu.org#61639,"BAHAUR HULU, KAHAYAN KUALA, PULANG PISAU, KALIMANTAN TENGAH",5,49,31,80
https://kawalpemilu.org#61640,"SEI PUDAK, KAHAYAN KUALA, PULANG PISAU, KALIMANTAN TENGAH",1,99,97,196
https://kawalpemilu.org#61640,"SEI PUDAK, KAHAYAN KUALA, PULANG PISAU, KALIMANTAN TENGAH",3,90,122,212
https://kawalpemilu.org#61640,"SEI PUDAK, KAHAYAN KUALA, PULANG PISAU, KALIMANTAN TENGAH",4,81,74,155
https://kawalpemilu.org#61640,"SEI PUDAK, KAHAYAN KUALA, PULANG PISAU, KALIMANTAN TENGAH",5,101,49,150
https://kawalpemilu.org#61640,"SEI PUDAK, KAHAYAN KUALA, PULANG PISAU, KALIMANTAN TENGAH",6,70,88,158
https://kawalpemilu.org#61640,"SEI PUDAK, KAHAYAN KUALA, PULANG PISAU, KALIMANTAN TENGAH",7,80,36,116
https://kawalpemilu.org#61640,"SEI PUDAK, KAHAYAN KUALA, PULANG PISAU, KALIMANTAN TENGAH",8,53,82,135
https://kawalpemilu.org#61640,"SEI PUDAK, KAHAYAN KUALA, PULANG PISAU, KALIMANTAN TENGAH",9,148,60,208
https://kawalpemilu.org#61640,"SEI PUDAK, KAHAYAN KUALA, PULANG PISAU, KALIMANTAN TENGAH",10,100,28,128
https://kawalpemilu.org#61641,"TANJUNG PERAWAN, KAHAYAN KUALA, PULANG PISAU, KALIMANTAN TENGAH",1,92,125,217
https://kawalpemilu.org#61641,"TANJUNG PERAWAN, KAHAYAN KUALA, PULANG PISAU, KALIMANTAN TENGAH",2,81,153,234
https://kawalpemilu.org#61641,"TANJUNG PERAWAN, KAHAYAN KUALA, PULANG PISAU, KALIMANTAN TENGAH",3,77,113,190
https://kawalpemilu.org#61641,"TANJUNG PERAWAN, KAHAYAN KUALA, PULANG PISAU, KALIMANTAN TENGAH",4,51,149,200
https://kawalpemilu.org#88614,"BAHAUR BASANTAN, KAHAYAN KUALA, PULANG PISAU, KALIMANTAN TENGAH",1,37,105,142
https://kawalpemilu.org#88614,"BAHAUR BASANTAN, KAHAYAN KUALA, PULANG PISAU, KALIMANTAN TENGAH",2,36,122,158
https://kawalpemilu.org#88614,"BAHAUR BASANTAN, KAHAYAN KUALA, PULANG PISAU, KALIMANTAN TENGAH",3,68,109,177
https://kawalpemilu.org#88615,"BAHAUR HULU PERMAI, KAHAYAN KUALA, PULANG PISAU, KALIMANTAN TENGAH",1,98,114,212
https://kawalpemilu.org#88615,"BAHAUR HULU PERMAI, KAHAYAN KUALA, PULANG PISAU, KALIMANTAN TENGAH",2,74,149,223
https://kawalpemilu.org#88615,"BAHAUR HULU PERMAI, KAHAYAN KUALA, PULANG PISAU, KALIMANTAN TENGAH",3,93,96,189
https://kawalpemilu.org#88615,"BAHAUR HULU PERMAI, KAHAYAN KUALA, PULANG PISAU, KALIMANTAN TENGAH",4,127,64,191
https://kawalpemilu.org#88615,"BAHAUR HULU PERMAI, KAHAYAN KUALA, PULANG PISAU, KALIMANTAN TENGAH",5,73,74,147
https://kawalpemilu.org#92612,"BAHAUR BATU RAYA, KAHAYAN KUALA, PULANG PISAU, KALIMANTAN TENGAH",1,54,74,128
https://kawalpemilu.org#92612,"BAHAUR BATU RAYA, KAHAYAN KUALA, PULANG PISAU, KALIMANTAN TENGAH",2,90,48,138
https://kawalpemilu.org#92612,"BAHAUR BATU RAYA, KAHAYAN KUALA, PULANG PISAU, KALIMANTAN TENGAH",3,28,36,64
https://kawalpemilu.org#927865,"SEI PASANAN, KAHAYAN KUALA, PULANG PISAU, KALIMANTAN TENGAH",1,128,96,224
https://kawalpemilu.org#927865,"SEI PASANAN, KAHAYAN KUALA, PULANG PISAU, KALIMANTAN TENGAH",2,66,103,169
https://kawalpemilu.org#927865,"SEI PASANAN, KAHAYAN KUALA, PULANG PISAU, KALIMANTAN TENGAH",3,51,137,188
https://kawalpemilu.org#927865,"SEI PASANAN, KAHAYAN KUALA, PULANG PISAU, KALIMANTAN TENGAH",4,36,135,171
https://kawalpemilu.org#927865,"SEI PASANAN, KAHAYAN KUALA, PULANG PISAU, KALIMANTAN TENGAH",5,49,105,154
https://kawalpemilu.org#927865,"SEI PASANAN, KAHAYAN KUALA, PULANG PISAU, KALIMANTAN TENGAH",6,71,73,144
https://kawalpemilu.org#61643,"TANJUNG SANGALANG, KAHAYAN TENGAH, PULANG PISAU, KALIMANTAN TENGAH",1,198,21,219
https://kawalpemilu.org#61644,"PENDA BARANIA, KAHAYAN TENGAH, PULANG PISAU, KALIMANTAN TENGAH",1,91,8,99
https://kawalpemilu.org#61645,"BUKIT RAWI, KAHAYAN TENGAH, PULANG PISAU, KALIMANTAN TENGAH",1,248,8,256
https://kawalpemilu.org#61645,"BUKIT RAWI, KAHAYAN TENGAH, PULANG PISAU, KALIMANTAN TENGAH",2,143,19,162
https://kawalpemilu.org#61645,"BUKIT RAWI, KAHAYAN TENGAH, PULANG PISAU, KALIMANTAN TENGAH",3,182,25,207
https://kawalpemilu.org#61646,"TUWUNG, KAHAYAN TENGAH, PULANG PISAU, KALIMANTAN TENGAH",1,159,17,176
https://kawalpemilu.org#61646,"TUWUNG, KAHAYAN TENGAH, PULANG PISAU, KALIMANTAN TENGAH",2,240,22,262
https://kawalpemilu.org#61647,"SIGI, KAHAYAN TENGAH, PULANG PISAU, KALIMANTAN TENGAH",1,152,39,191
https://kawalpemilu.org#61647,"SIGI, KAHAYAN TENGAH, PULANG PISAU, KALIMANTAN TENGAH",2,181,12,193
https://kawalpemilu.org#61648,"PETUK LITI, KAHAYAN TENGAH, PULANG PISAU, KALIMANTAN TENGAH",1,168,9,177
https://kawalpemilu.org#61648,"PETUK LITI, KAHAYAN TENGAH, PULANG PISAU, KALIMANTAN TENGAH",2,156,11,0
https://kawalpemilu.org#61649,"BUKIT LITI, KAHAYAN TENGAH, PULANG PISAU, KALIMANTAN TENGAH",1,211,27,238
https://kawalpemilu.org#61649,"BUKIT LITI, KAHAYAN TENGAH, PULANG PISAU, KALIMANTAN TENGAH",2,159,20,179
https://kawalpemilu.org#61649,"BUKIT LITI, KAHAYAN TENGAH, PULANG PISAU, KALIMANTAN TENGAH",3,142,35,177
https://kawalpemilu.org#61650,"BAHU PALAWA, KAHAYAN TENGAH, PULANG PISAU, KALIMANTAN TENGAH",1,133,21,154
https://kawalpemilu.org#61650,"BAHU PALAWA, KAHAYAN TENGAH, PULANG PISAU, KALIMANTAN TENGAH",2,138,12,150
https://kawalpemilu.org#61651,"PAMARUNAN, KAHAYAN TENGAH, PULANG PISAU, KALIMANTAN TENGAH",1,147,22,169
https://kawalpemilu.org#61651,"PAMARUNAN, KAHAYAN TENGAH, PULANG PISAU, KALIMANTAN TENGAH",2,177,11,188
https://kawalpemilu.org#61652,"BALUKON, KAHAYAN TENGAH, PULANG PISAU, KALIMANTAN TENGAH",1,152,8,160
https://kawalpemilu.org#61652,"BALUKON, KAHAYAN TENGAH, PULANG PISAU, KALIMANTAN TENGAH",2,48,4,48
https://kawalpemilu.org#61653,"BUKIT BAMBA, KAHAYAN TENGAH, PULANG PISAU, KALIMANTAN TENGAH",1,242,12,254
https://kawalpemilu.org#61654,"TAHAWA, KAHAYAN TENGAH, PULANG PISAU, KALIMANTAN TENGAH",1,152,20,172
https://kawalpemilu.org#61654,"TAHAWA, KAHAYAN TENGAH, PULANG PISAU, KALIMANTAN TENGAH",2,151,25,176
https://kawalpemilu.org#61654,"TAHAWA, KAHAYAN TENGAH, PULANG PISAU, KALIMANTAN TENGAH",3,157,21,178
https://kawalpemilu.org#61655,"PARAHANGAN, KAHAYAN TENGAH, PULANG PISAU, KALIMANTAN TENGAH",1,213,26,239
https://kawalpemilu.org#61655,"PARAHANGAN, KAHAYAN TENGAH, PULANG PISAU, KALIMANTAN TENGAH",2,146,10,156
https://kawalpemilu.org#61655,"PARAHANGAN, KAHAYAN TENGAH, PULANG PISAU, KALIMANTAN TENGAH",3,118,10,128
https://kawalpemilu.org#61656,"BERENG RAMBANG, KAHAYAN TENGAH, PULANG PISAU, KALIMANTAN TENGAH",1,187,9,196
https://kawalpemilu.org#61656,"BERENG RAMBANG, KAHAYAN TENGAH, PULANG PISAU, KALIMANTAN TENGAH",2,194,6,200
https://kawalpemilu.org#61658,"MANEN PADURAN, BANAMA TINGANG, PULANG PISAU, KALIMANTAN TENGAH",1,105,10,115
https://kawalpemilu.org#61658,"MANEN PADURAN, BANAMA TINGANG, PULANG PISAU, KALIMANTAN TENGAH",2,156,1,157
https://kawalpemilu.org#61659,"MANEN KALEKA, BANAMA TINGANG, PULANG PISAU, KALIMANTAN TENGAH",1,92,2,94
https://kawalpemilu.org#61659,"MANEN KALEKA, BANAMA TINGANG, PULANG PISAU, KALIMANTAN TENGAH",2,168,7,175
https://kawalpemilu.org#61660,"LAWANG URU, BANAMA TINGANG, PULANG PISAU, KALIMANTAN TENGAH",1,98,4,102
https://kawalpemilu.org#61660,"LAWANG URU, BANAMA TINGANG, PULANG PISAU, KALIMANTAN TENGAH",2,251,9,260
https://kawalpemilu.org#61660,"LAWANG URU, BANAMA TINGANG, PULANG PISAU, KALIMANTAN TENGAH",3,257,5,262
https://kawalpemilu.org#61661,"HURUNG, BANAMA TINGANG, PULANG PISAU, KALIMANTAN TENGAH",1,237,17,254
https://kawalpemilu.org#61662,"HANUA, BANAMA TINGANG, PULANG PISAU, KALIMANTAN TENGAH",1,221,27,248
https://kawalpemilu.org#61663,"RAMANG, BANAMA TINGANG, PULANG PISAU, KALIMANTAN TENGAH",1,220,4,224
https://kawalpemilu.org#61663,"RAMANG, BANAMA TINGANG, PULANG PISAU, KALIMANTAN TENGAH",2,161,7,168
https://kawalpemilu.org#61664,"TAMBAK, BANAMA TINGANG, PULANG PISAU, KALIMANTAN TENGAH",1,176,18,194
https://kawalpemilu.org#61665,"PAHAWAN, BANAMA TINGANG, PULANG PISAU, KALIMANTAN TENGAH",1,140,8,148
https://kawalpemilu.org#61665,"PAHAWAN, BANAMA TINGANG, PULANG PISAU, KALIMANTAN TENGAH",2,142,5,147
https://kawalpemilu.org#61666,"GOHA, BANAMA TINGANG, PULANG PISAU, KALIMANTAN TENGAH",1,215,11,226
https://kawalpemilu.org#61666,"GOHA, BANAMA TINGANG, PULANG PISAU, KALIMANTAN TENGAH",2,246,10,256
https://kawalpemilu.org#61667,"BAWAN, BANAMA TINGANG, PULANG PISAU, KALIMANTAN TENGAH",1,172,11,183
https://kawalpemilu.org#61667,"BAWAN, BANAMA TINGANG, PULANG PISAU, KALIMANTAN TENGAH",2,158,10,168
https://kawalpemilu.org#61667,"BAWAN, BANAMA TINGANG, PULANG PISAU, KALIMANTAN TENGAH",3,203,11,214
https://kawalpemilu.org#61668,"TUMBANG TERUSAN, BANAMA TINGANG, PULANG PISAU, KALIMANTAN TENGAH",1,158,9,167
https://kawalpemilu.org#61668,"TUMBANG TERUSAN, BANAMA TINGANG, PULANG PISAU, KALIMANTAN TENGAH",2,147,10,157
https://kawalpemilu.org#61669,"PANDAWEI, BANAMA TINGANG, PULANG PISAU, KALIMANTAN TENGAH",1,146,15,161
https://kawalpemilu.org#61670,"PANGI, BANAMA TINGANG, PULANG PISAU, KALIMANTAN TENGAH",1,231,22,253
https://kawalpemilu.org#61670,"PANGI, BANAMA TINGANG, PULANG PISAU, KALIMANTAN TENGAH",2,0,0,0
https://kawalpemilu.org#61671,"TANGKAHEN, BANAMA TINGANG, PULANG PISAU, KALIMANTAN TENGAH",1,194,22,216
https://kawalpemilu.org#61671,"TANGKAHEN, BANAMA TINGANG, PULANG PISAU, KALIMANTAN TENGAH",2,198,33,231
https://kawalpemilu.org#61671,"TANGKAHEN, BANAMA TINGANG, PULANG PISAU, KALIMANTAN TENGAH",3,193,33,226
https://kawalpemilu.org#61671,"TANGKAHEN, BANAMA TINGANG, PULANG PISAU, KALIMANTAN TENGAH",4,126,38,164
https://kawalpemilu.org#61672,"KASALI BARU, BANAMA TINGANG, PULANG PISAU, KALIMANTAN TENGAH",1,113,9,122
https://kawalpemilu.org#61675,"BUNTOI, KAHAYAN HILIR, PULANG PISAU, KALIMANTAN TENGAH",1,174,44,218
https://kawalpemilu.org#61675,"BUNTOI, KAHAYAN HILIR, PULANG PISAU, KALIMANTAN TENGAH",2,232,18,250
https://kawalpemilu.org#61675,"BUNTOI, KAHAYAN HILIR, PULANG PISAU, KALIMANTAN TENGAH",3,126,41,167
https://kawalpemilu.org#61675,"BUNTOI, KAHAYAN HILIR, PULANG PISAU, KALIMANTAN TENGAH",4,113,46,159
https://kawalpemilu.org#61675,"BUNTOI, KAHAYAN HILIR, PULANG PISAU, KALIMANTAN TENGAH",5,197,44,241
https://kawalpemilu.org#61675,"BUNTOI, KAHAYAN HILIR, PULANG PISAU, KALIMANTAN TENGAH",6,73,76,149
https://kawalpemilu.org#61675,"BUNTOI, KAHAYAN HILIR, PULANG PISAU, KALIMANTAN TENGAH",7,64,72,136
https://kawalpemilu.org#61675,"BUNTOI, KAHAYAN HILIR, PULANG PISAU, KALIMANTAN TENGAH",8,96,109,205
https://kawalpemilu.org#61675,"BUNTOI, KAHAYAN HILIR, PULANG PISAU, KALIMANTAN TENGAH",9,111,26,137
https://kawalpemilu.org#61676,"MINTIN, KAHAYAN HILIR, PULANG PISAU, KALIMANTAN TENGAH",1,198,25,223
https://kawalpemilu.org#61676,"MINTIN, KAHAYAN HILIR, PULANG PISAU, KALIMANTAN TENGAH",2,64,84,148
https://kawalpemilu.org#61676,"MINTIN, KAHAYAN HILIR, PULANG PISAU, KALIMANTAN TENGAH",3,138,77,215
https://kawalpemilu.org#61676,"MINTIN, KAHAYAN HILIR, PULANG PISAU, KALIMANTAN TENGAH",4,155,78,233
https://kawalpemilu.org#61676,"MINTIN, KAHAYAN HILIR, PULANG PISAU, KALIMANTAN TENGAH",5,60,72,132
https://kawalpemilu.org#61676,"MINTIN, KAHAYAN HILIR, PULANG PISAU, KALIMANTAN TENGAH",6,150,60,210
https://kawalpemilu.org#61676,"MINTIN, KAHAYAN HILIR, PULANG PISAU, KALIMANTAN TENGAH",7,144,83,227
https://kawalpemilu.org#61676,"MINTIN, KAHAYAN HILIR, PULANG PISAU, KALIMANTAN TENGAH",8,64,128,192
https://kawalpemilu.org#61676,"MINTIN, KAHAYAN HILIR, PULANG PISAU, KALIMANTAN TENGAH",9,67,109,176
https://kawalpemilu.org#61676,"MINTIN, KAHAYAN HILIR, PULANG PISAU, KALIMANTAN TENGAH",10,75,133,208
https://kawalpemilu.org#61677,"MANTAREN I, KAHAYAN HILIR, PULANG PISAU, KALIMANTAN TENGAH",2,153,52,205
https://kawalpemilu.org#61677,"MANTAREN I, KAHAYAN HILIR, PULANG PISAU, KALIMANTAN TENGAH",3,129,40,129
https://kawalpemilu.org#61677,"MANTAREN I, KAHAYAN HILIR, PULANG PISAU, KALIMANTAN TENGAH",4,152,33,185
https://kawalpemilu.org#61677,"MANTAREN I, KAHAYAN HILIR, PULANG PISAU, KALIMANTAN TENGAH",5,159,72,231
https://kawalpemilu.org#61677,"MANTAREN I, KAHAYAN HILIR, PULANG PISAU, KALIMANTAN TENGAH",6,123,111,234
https://kawalpemilu.org#61677,"MANTAREN I, KAHAYAN HILIR, PULANG PISAU, KALIMANTAN TENGAH",7,88,116,204
https://kawalpemilu.org#61678,"ANJIR PULANG PISAU, KAHAYAN HILIR, PULANG PISAU, KALIMANTAN TENGAH",1,84,72,156
https://kawalpemilu.org#61678,"ANJIR PULANG PISAU, KAHAYAN HILIR, PULANG PISAU, KALIMANTAN TENGAH",2,136,49,185
https://kawalpemilu.org#61678,"ANJIR PULANG PISAU, KAHAYAN HILIR, PULANG PISAU, KALIMANTAN TENGAH",3,93,90,185
https://kawalpemilu.org#61678,"ANJIR PULANG PISAU, KAHAYAN HILIR, PULANG PISAU, KALIMANTAN TENGAH",4,100,106,206
https://kawalpemilu.org#61678,"ANJIR PULANG PISAU, KAHAYAN HILIR, PULANG PISAU, KALIMANTAN TENGAH",5,77,81,158
https://kawalpemilu.org#61678,"ANJIR PULANG PISAU, KAHAYAN HILIR, PULANG PISAU, KALIMANTAN TENGAH",6,158,49,207
https://kawalpemilu.org#61678,"ANJIR PULANG PISAU, KAHAYAN HILIR, PULANG PISAU, KALIMANTAN TENGAH",7,83,51,134
https://kawalpemilu.org#61678,"ANJIR PULANG PISAU, KAHAYAN HILIR, PULANG PISAU, KALIMANTAN TENGAH",8,44,92,136
https://kawalpemilu.org#61678,"ANJIR PULANG PISAU, KAHAYAN HILIR, PULANG PISAU, KALIMANTAN TENGAH",9,111,103,214
https://kawalpemilu.org#61678,"ANJIR PULANG PISAU, KAHAYAN HILIR, PULANG PISAU, KALIMANTAN TENGAH",10,64,57,121
https://kawalpemilu.org#61678,"ANJIR PULANG PISAU, KAHAYAN HILIR, PULANG PISAU, KALIMANTAN TENGAH",11,85,161,246
https://kawalpemilu.org#61678,"ANJIR PULANG PISAU, KAHAYAN HILIR, PULANG PISAU, KALIMANTAN TENGAH",12,81,66,147
https://kawalpemilu.org#61678,"ANJIR PULANG PISAU, KAHAYAN HILIR, PULANG PISAU, KALIMANTAN TENGAH",13,29,125,154
https://kawalpemilu.org#61678,"ANJIR PULANG PISAU, KAHAYAN HILIR, PULANG PISAU, KALIMANTAN TENGAH",14,77,75,152
https://kawalpemilu.org#61678,"ANJIR PULANG PISAU, KAHAYAN HILIR, PULANG PISAU, KALIMANTAN TENGAH",15,112,68,180
https://kawalpemilu.org#61678,"ANJIR PULANG PISAU, KAHAYAN HILIR, PULANG PISAU, KALIMANTAN TENGAH",16,71,72,143
https://kawalpemilu.org#61678,"ANJIR PULANG PISAU, KAHAYAN HILIR, PULANG PISAU, KALIMANTAN TENGAH",17,104,46,150
https://kawalpemilu.org#61679,"GOHONG, KAHAYAN HILIR, PULANG PISAU, KALIMANTAN TENGAH",1,95,86,181
https://kawalpemilu.org#61679,"GOHONG, KAHAYAN HILIR, PULANG PISAU, KALIMANTAN TENGAH",2,156,92,248
https://kawalpemilu.org#61679,"GOHONG, KAHAYAN HILIR, PULANG PISAU, KALIMANTAN TENGAH",3,175,69,244
https://kawalpemilu.org#61679,"GOHONG, KAHAYAN HILIR, PULANG PISAU, KALIMANTAN TENGAH",4,192,76,267
https://kawalpemilu.org#61679,"GOHONG, KAHAYAN HILIR, PULANG PISAU, KALIMANTAN TENGAH",5,152,89,241
https://kawalpemilu.org#88618,"HANJAK MAJU, KAHAYAN HILIR, PULANG PISAU, KALIMANTAN TENGAH",1,106,61,167
https://kawalpemilu.org#88618,"HANJAK MAJU, KAHAYAN HILIR, PULANG PISAU, KALIMANTAN TENGAH",2,114,40,154
https://kawalpemilu.org#88618,"HANJAK MAJU, KAHAYAN HILIR, PULANG PISAU, KALIMANTAN TENGAH",3,141,53,194
https://kawalpemilu.org#88618,"HANJAK MAJU, KAHAYAN HILIR, PULANG PISAU, KALIMANTAN TENGAH",4,115,40,155
https://kawalpemilu.org#88618,"HANJAK MAJU, KAHAYAN HILIR, PULANG PISAU, KALIMANTAN TENGAH",6,93,68,161
https://kawalpemilu.org#88618,"HANJAK MAJU, KAHAYAN HILIR, PULANG PISAU, KALIMANTAN TENGAH",7,92,45,137
https://kawalpemilu.org#92617,"PULANG PISAU, KAHAYAN HILIR, PULANG PISAU, KALIMANTAN TENGAH",1,184,60,244
https://kawalpemilu.org#92617,"PULANG PISAU, KAHAYAN HILIR, PULANG PISAU, KALIMANTAN TENGAH",2,143,122,265
https://kawalpemilu.org#92617,"PULANG PISAU, KAHAYAN HILIR, PULANG PISAU, KALIMANTAN TENGAH",3,92,140,232
https://kawalpemilu.org#92617,"PULANG PISAU, KAHAYAN HILIR, PULANG PISAU, KALIMANTAN TENGAH",4,135,134,269
https://kawalpemilu.org#92617,"PULANG PISAU, KAHAYAN HILIR, PULANG PISAU, KALIMANTAN TENGAH",5,57,85,142
https://kawalpemilu.org#92617,"PULANG PISAU, KAHAYAN HILIR, PULANG PISAU, KALIMANTAN TENGAH",7,75,184,259
https://kawalpemilu.org#92617,"PULANG PISAU, KAHAYAN HILIR, PULANG PISAU, KALIMANTAN TENGAH",8,121,78,199
https://kawalpemilu.org#92617,"PULANG PISAU, KAHAYAN HILIR, PULANG PISAU, KALIMANTAN TENGAH",9,148,89,237
https://kawalpemilu.org#92617,"PULANG PISAU, KAHAYAN HILIR, PULANG PISAU, KALIMANTAN TENGAH",10,95,105,200
https://kawalpemilu.org#92617,"PULANG PISAU, KAHAYAN HILIR, PULANG PISAU, KALIMANTAN TENGAH",11,84,135,219
https://kawalpemilu.org#92617,"PULANG PISAU, KAHAYAN HILIR, PULANG PISAU, KALIMANTAN TENGAH",12,74,126,200
https://kawalpemilu.org#92617,"PULANG PISAU, KAHAYAN HILIR, PULANG PISAU, KALIMANTAN TENGAH",13,68,106,174
https://kawalpemilu.org#92617,"PULANG PISAU, KAHAYAN HILIR, PULANG PISAU, KALIMANTAN TENGAH",14,116,81,197
https://kawalpemilu.org#92617,"PULANG PISAU, KAHAYAN HILIR, PULANG PISAU, KALIMANTAN TENGAH",15,123,135,258
https://kawalpemilu.org#92617,"PULANG PISAU, KAHAYAN HILIR, PULANG PISAU, KALIMANTAN TENGAH",16,124,101,225
https://kawalpemilu.org#92617,"PULANG PISAU, KAHAYAN HILIR, PULANG PISAU, KALIMANTAN TENGAH",17,85,82,167
https://kawalpemilu.org#92618,"MANTAREN II, KAHAYAN HILIR, PULANG PISAU, KALIMANTAN TENGAH",1,99,54,153
https://kawalpemilu.org#92618,"MANTAREN II, KAHAYAN HILIR, PULANG PISAU, KALIMANTAN TENGAH",2,96,57,153
https://kawalpemilu.org#92618,"MANTAREN II, KAHAYAN HILIR, PULANG PISAU, KALIMANTAN TENGAH",3,150,106,256
https://kawalpemilu.org#92618,"MANTAREN II, KAHAYAN HILIR, PULANG PISAU, KALIMANTAN TENGAH",4,189,44,233
https://kawalpemilu.org#92618,"MANTAREN II, KAHAYAN HILIR, PULANG PISAU, KALIMANTAN TENGAH",5,101,15,116
https://kawalpemilu.org#92618,"MANTAREN II, KAHAYAN HILIR, PULANG PISAU, KALIMANTAN TENGAH",6,106,69,175
https://kawalpemilu.org#92618,"MANTAREN II, KAHAYAN HILIR, PULANG PISAU, KALIMANTAN TENGAH",7,172,65,237
https://kawalpemilu.org#92618,"MANTAREN II, KAHAYAN HILIR, PULANG PISAU, KALIMANTAN TENGAH",8,105,33,138
https://kawalpemilu.org#92618,"MANTAREN II, KAHAYAN HILIR, PULANG PISAU, KALIMANTAN TENGAH",9,91,26,117
https://kawalpemilu.org#92619,"KALAWA, KAHAYAN HILIR, PULANG PISAU, KALIMANTAN TENGAH",1,145,31,176
https://kawalpemilu.org#92619,"KALAWA, KAHAYAN HILIR, PULANG PISAU, KALIMANTAN TENGAH",2,78,54,132
https://kawalpemilu.org#92619,"KALAWA, KAHAYAN HILIR, PULANG PISAU, KALIMANTAN TENGAH",3,144,27,171
https://kawalpemilu.org#92619,"KALAWA, KAHAYAN HILIR, PULANG PISAU, KALIMANTAN TENGAH",5,115,34,149
https://kawalpemilu.org#92619,"KALAWA, KAHAYAN HILIR, PULANG PISAU, KALIMANTAN TENGAH",6,119,24,143
https://kawalpemilu.org#92620,"BERENG, KAHAYAN HILIR, PULANG PISAU, KALIMANTAN TENGAH",1,112,36,148
https://kawalpemilu.org#92620,"BERENG, KAHAYAN HILIR, PULANG PISAU, KALIMANTAN TENGAH",2,71,75,146
https://kawalpemilu.org#92620,"BERENG, KAHAYAN HILIR, PULANG PISAU, KALIMANTAN TENGAH",3,81,55,136
https://kawalpemilu.org#92620,"BERENG, KAHAYAN HILIR, PULANG PISAU, KALIMANTAN TENGAH",4,73,55,128
https://kawalpemilu.org#92620,"BERENG, KAHAYAN HILIR, PULANG PISAU, KALIMANTAN TENGAH",5,151,20,171
https://kawalpemilu.org#92620,"BERENG, KAHAYAN HILIR, PULANG PISAU, KALIMANTAN TENGAH",6,172,92,264
https://kawalpemilu.org#92620,"BERENG, KAHAYAN HILIR, PULANG PISAU, KALIMANTAN TENGAH",7,82,100,182
https://kawalpemilu.org#92620,"BERENG, KAHAYAN HILIR, PULANG PISAU, KALIMANTAN TENGAH",8,73,87,160
https://kawalpemilu.org#92620,"BERENG, KAHAYAN HILIR, PULANG PISAU, KALIMANTAN TENGAH",9,77,102,179
https://kawalpemilu.org#92620,"BERENG, KAHAYAN HILIR, PULANG PISAU, KALIMANTAN TENGAH",10,82,100,182
https://kawalpemilu.org#61683,"TAHAI JAYA, MALIKU, PULANG PISAU, KALIMANTAN TENGAH",1,169,56,225
https://kawalpemilu.org#61683,"TAHAI JAYA, MALIKU, PULANG PISAU, KALIMANTAN TENGAH",2,174,60,234
https://kawalpemilu.org#61683,"TAHAI JAYA, MALIKU, PULANG PISAU, KALIMANTAN TENGAH",3,151,66,217
https://kawalpemilu.org#61683,"TAHAI JAYA, MALIKU, PULANG PISAU, KALIMANTAN TENGAH",4,204,37,241
https://kawalpemilu.org#61683,"TAHAI JAYA, MALIKU, PULANG PISAU, KALIMANTAN TENGAH",5,136,85,221
https://kawalpemilu.org#61683,"TAHAI JAYA, MALIKU, PULANG PISAU, KALIMANTAN TENGAH",6,157,64,221
https://kawalpemilu.org#61683,"TAHAI JAYA, MALIKU, PULANG PISAU, KALIMANTAN TENGAH",7,127,65,192
https://kawalpemilu.org#61684,"PURWODADI, MALIKU, PULANG PISAU, KALIMANTAN TENGAH",1,170,48,218
https://kawalpemilu.org#61684,"PURWODADI, MALIKU, PULANG PISAU, KALIMANTAN TENGAH",2,108,82,190
https://kawalpemilu.org#61684,"PURWODADI, MALIKU, PULANG PISAU, KALIMANTAN TENGAH",3,126,80,206
https://kawalpemilu.org#61684,"PURWODADI, MALIKU, PULANG PISAU, KALIMANTAN TENGAH",4,157,77,234
https://kawalpemilu.org#61684,"PURWODADI, MALIKU, PULANG PISAU, KALIMANTAN TENGAH",5,152,71,223
https://kawalpemilu.org#61684,"PURWODADI, MALIKU, PULANG PISAU, KALIMANTAN TENGAH",6,153,54,207
https://kawalpemilu.org#61685,"WONO AGUNG, MALIKU, PULANG PISAU, KALIMANTAN TENGAH",1,162,40,202
https://kawalpemilu.org#61685,"WONO AGUNG, MALIKU, PULANG PISAU, KALIMANTAN TENGAH",2,185,51,236
https://kawalpemilu.org#61685,"WONO AGUNG, MALIKU, PULANG PISAU, KALIMANTAN TENGAH",3,172,47,219
https://kawalpemilu.org#61685,"WONO AGUNG, MALIKU, PULANG PISAU, KALIMANTAN TENGAH",4,164,66,230
https://kawalpemilu.org#61685,"WONO AGUNG, MALIKU, PULANG PISAU, KALIMANTAN TENGAH",5,158,51,209
https://kawalpemilu.org#61686,"KANAMIT BARAT, MALIKU, PULANG PISAU, KALIMANTAN TENGAH",1,166,49,215
https://kawalpemilu.org#61686,"KANAMIT BARAT, MALIKU, PULANG PISAU, KALIMANTAN TENGAH",2,168,36,204
https://kawalpemilu.org#61686,"KANAMIT BARAT, MALIKU, PULANG PISAU, KALIMANTAN TENGAH",3,137,59,196
https://kawalpemilu.org#61686,"KANAMIT BARAT, MALIKU, PULANG PISAU, KALIMANTAN TENGAH",4,104,71,175
https://kawalpemilu.org#61686,"KANAMIT BARAT, MALIKU, PULANG PISAU, KALIMANTAN TENGAH",5,139,50,189
https://kawalpemilu.org#61687,"SUNGAI BARU TEWU, MALIKU, PULANG PISAU, KALIMANTAN TENGAH",1,134,27,161
https://kawalpemilu.org#61687,"SUNGAI BARU TEWU, MALIKU, PULANG PISAU, KALIMANTAN TENGAH",2,122,43,165
https://kawalpemilu.org#61688,"KANAMIT, MALIKU, PULANG PISAU, KALIMANTAN TENGAH",1,140,67,207
https://kawalpemilu.org#61688,"KANAMIT, MALIKU, PULANG PISAU, KALIMANTAN TENGAH",2,78,53,131
https://kawalpemilu.org#61688,"KANAMIT, MALIKU, PULANG PISAU, KALIMANTAN TENGAH",3,91,76,167
https://kawalpemilu.org#61688,"KANAMIT, MALIKU, PULANG PISAU, KALIMANTAN TENGAH",4,108,136,244
https://kawalpemilu.org#61688,"KANAMIT, MALIKU, PULANG PISAU, KALIMANTAN TENGAH",5,45,5,50
https://kawalpemilu.org#61688,"KANAMIT, MALIKU, PULANG PISAU, KALIMANTAN TENGAH",6,127,33,160
https://kawalpemilu.org#61688,"KANAMIT, MALIKU, PULANG PISAU, KALIMANTAN TENGAH",7,128,76,204
https://kawalpemilu.org#61689,"GARANTUNG, MALIKU, PULANG PISAU, KALIMANTAN TENGAH",1,146,54,200
https://kawalpemilu.org#61689,"GARANTUNG, MALIKU, PULANG PISAU, KALIMANTAN TENGAH",2,112,91,203
https://kawalpemilu.org#61689,"GARANTUNG, MALIKU, PULANG PISAU, KALIMANTAN TENGAH",3,172,45,217
https://kawalpemilu.org#61689,"GARANTUNG, MALIKU, PULANG PISAU, KALIMANTAN TENGAH",4,122,75,197
https://kawalpemilu.org#61689,"GARANTUNG, MALIKU, PULANG PISAU, KALIMANTAN TENGAH",5,106,66,172
https://kawalpemilu.org#61689,"GARANTUNG, MALIKU, PULANG PISAU, KALIMANTAN TENGAH",6,159,46,205
https://kawalpemilu.org#61689,"GARANTUNG, MALIKU, PULANG PISAU, KALIMANTAN TENGAH",7,189,18,207
https://kawalpemilu.org#61689,"GARANTUNG, MALIKU, PULANG PISAU, KALIMANTAN TENGAH",8,109,59,163
https://kawalpemilu.org#61690,"GANDANG, MALIKU, PULANG PISAU, KALIMANTAN TENGAH",1,77,105,182
https://kawalpemilu.org#61690,"GANDANG, MALIKU, PULANG PISAU, KALIMANTAN TENGAH",2,85,79,6
https://kawalpemilu.org#61690,"GANDANG, MALIKU, PULANG PISAU, KALIMANTAN TENGAH",3,108,117,225
https://kawalpemilu.org#61690,"GANDANG, MALIKU, PULANG PISAU, KALIMANTAN TENGAH",4,97,83,180
https://kawalpemilu.org#61690,"GANDANG, MALIKU, PULANG PISAU, KALIMANTAN TENGAH",5,124,46,170
https://kawalpemilu.org#61690,"GANDANG, MALIKU, PULANG PISAU, KALIMANTAN TENGAH",6,118,91,209
https://kawalpemilu.org#61690,"GANDANG, MALIKU, PULANG PISAU, KALIMANTAN TENGAH",7,72,129,201
https://kawalpemilu.org#61690,"GANDANG, MALIKU, PULANG PISAU, KALIMANTAN TENGAH",8,106,89,195
https://kawalpemilu.org#61691,"BADIRIH, MALIKU, PULANG PISAU, KALIMANTAN TENGAH",1,186,30,216
https://kawalpemilu.org#61691,"BADIRIH, MALIKU, PULANG PISAU, KALIMANTAN TENGAH",2,97,40,137
https://kawalpemilu.org#61691,"BADIRIH, MALIKU, PULANG PISAU, KALIMANTAN TENGAH",3,95,48,143
https://kawalpemilu.org#61692,"TAHAI BARU, MALIKU, PULANG PISAU, KALIMANTAN TENGAH",1,152,53,205
https://kawalpemilu.org#61692,"TAHAI BARU, MALIKU, PULANG PISAU, KALIMANTAN TENGAH",2,152,65,217
https://kawalpemilu.org#61692,"TAHAI BARU, MALIKU, PULANG PISAU, KALIMANTAN TENGAH",3,179,51,230
https://kawalpemilu.org#61692,"TAHAI BARU, MALIKU, PULANG PISAU, KALIMANTAN TENGAH",4,177,54,231
https://kawalpemilu.org#61692,"TAHAI BARU, MALIKU, PULANG PISAU, KALIMANTAN TENGAH",5,87,60,147
https://kawalpemilu.org#61692,"TAHAI BARU, MALIKU, PULANG PISAU, KALIMANTAN TENGAH",6,64,34,98
https://kawalpemilu.org#61693,"MALIKU BARU, MALIKU, PULANG PISAU, KALIMANTAN TENGAH",1,71,120,200
https://kawalpemilu.org#61693,"MALIKU BARU, MALIKU, PULANG PISAU, KALIMANTAN TENGAH",2,100,111,211
https://kawalpemilu.org#61693,"MALIKU BARU, MALIKU, PULANG PISAU, KALIMANTAN TENGAH",3,53,96,149
https://kawalpemilu.org#61693,"MALIKU BARU, MALIKU, PULANG PISAU, KALIMANTAN TENGAH",4,132,63,195
https://kawalpemilu.org#61693,"MALIKU BARU, MALIKU, PULANG PISAU, KALIMANTAN TENGAH",5,171,39,210
https://kawalpemilu.org#61693,"MALIKU BARU, MALIKU, PULANG PISAU, KALIMANTAN TENGAH",6,77,92,169
https://kawalpemilu.org#61693,"MALIKU BARU, MALIKU, PULANG PISAU, KALIMANTAN TENGAH",7,84,100,184
https://kawalpemilu.org#61693,"MALIKU BARU, MALIKU, PULANG PISAU, KALIMANTAN TENGAH",8,65,132,197
https://kawalpemilu.org#61693,"MALIKU BARU, MALIKU, PULANG PISAU, KALIMANTAN TENGAH",9,114,53,167
https://kawalpemilu.org#61694,"SIDODADI, MALIKU, PULANG PISAU, KALIMANTAN TENGAH",1,168,51,219
https://kawalpemilu.org#61694,"SIDODADI, MALIKU, PULANG PISAU, KALIMANTAN TENGAH",2,186,31,217
https://kawalpemilu.org#61694,"SIDODADI, MALIKU, PULANG PISAU, KALIMANTAN TENGAH",3,177,42,219
https://kawalpemilu.org#61695,"KANAMIT JAYA, MALIKU, PULANG PISAU, KALIMANTAN TENGAH",1,75,84,159
https://kawalpemilu.org#61695,"KANAMIT JAYA, MALIKU, PULANG PISAU, KALIMANTAN TENGAH",2,109,78,187
https://kawalpemilu.org#61695,"KANAMIT JAYA, MALIKU, PULANG PISAU, KALIMANTAN TENGAH",3,120,49,169
https://kawalpemilu.org#85407,"GANDANG BARAT, MALIKU, PULANG PISAU, KALIMANTAN TENGAH",1,117,53,170
https://kawalpemilu.org#85407,"GANDANG BARAT, MALIKU, PULANG PISAU, KALIMANTAN TENGAH",2,133,70,203
https://kawalpemilu.org#85407,"GANDANG BARAT, MALIKU, PULANG PISAU, KALIMANTAN TENGAH",3,113,48,161
https://kawalpemilu.org#85408,"MALIKU MULYA, MALIKU, PULANG PISAU, KALIMANTAN TENGAH",1,92,50,142
https://kawalpemilu.org#85408,"MALIKU MULYA, MALIKU, PULANG PISAU, KALIMANTAN TENGAH",2,85,64,149
https://kawalpemilu.org#61697,"GARUNG, JABIREN, PULANG PISAU, KALIMANTAN TENGAH",1,94,30,124
https://kawalpemilu.org#61697,"GARUNG, JABIREN, PULANG PISAU, KALIMANTAN TENGAH",2,150,107,257
https://kawalpemilu.org#61697,"GARUNG, JABIREN, PULANG PISAU, KALIMANTAN TENGAH",3,92,47,139
https://kawalpemilu.org#61697,"GARUNG, JABIREN, PULANG PISAU, KALIMANTAN TENGAH",4,120,73,193
https://kawalpemilu.org#61698,"HENDA, JABIREN, PULANG PISAU, KALIMANTAN TENGAH",1,186,23,209
https://kawalpemilu.org#61698,"HENDA, JABIREN, PULANG PISAU, KALIMANTAN TENGAH",2,195,15,210
https://kawalpemilu.org#61699,"SIMPUR, JABIREN, PULANG PISAU, KALIMANTAN TENGAH",1,104,29,133
https://kawalpemilu.org#61699,"SIMPUR, JABIREN, PULANG PISAU, KALIMANTAN TENGAH",2,91,29,120
https://kawalpemilu.org#61700,"SAKA KAJANG, JABIREN, PULANG PISAU, KALIMANTAN TENGAH",1,185,69,254
https://kawalpemilu.org#61700,"SAKA KAJANG, JABIREN, PULANG PISAU, KALIMANTAN TENGAH",2,184,71,255
https://kawalpemilu.org#61701,"JABIREN, JABIREN, PULANG PISAU, KALIMANTAN TENGAH",1,99,65,164
https://kawalpemilu.org#61701,"JABIREN, JABIREN, PULANG PISAU, KALIMANTAN TENGAH",2,112,55,167
https://kawalpemilu.org#61701,"JABIREN, JABIREN, PULANG PISAU, KALIMANTAN TENGAH",3,207,51,258
https://kawalpemilu.org#61701,"JABIREN, JABIREN, PULANG PISAU, KALIMANTAN TENGAH",4,213,62,275
https://kawalpemilu.org#61701,"JABIREN, JABIREN, PULANG PISAU, KALIMANTAN TENGAH",5,127,68,195
https://kawalpemilu.org#61701,"JABIREN, JABIREN, PULANG PISAU, KALIMANTAN TENGAH",6,112,68,180
https://kawalpemilu.org#61701,"JABIREN, JABIREN, PULANG PISAU, KALIMANTAN TENGAH",7,196,67,263
https://kawalpemilu.org#61701,"JABIREN, JABIREN, PULANG PISAU, KALIMANTAN TENGAH",8,87,29,116
https://kawalpemilu.org#61702,"PILANG, JABIREN, PULANG PISAU, KALIMANTAN TENGAH",1,168,74,242
https://kawalpemilu.org#61702,"PILANG, JABIREN, PULANG PISAU, KALIMANTAN TENGAH",2,142,36,178
https://kawalpemilu.org#61702,"PILANG, JABIREN, PULANG PISAU, KALIMANTAN TENGAH",3,167,59,226
https://kawalpemilu.org#61702,"PILANG, JABIREN, PULANG PISAU, KALIMANTAN TENGAH",4,173,67,240
https://kawalpemilu.org#61703,"TUMBANG NUSA, JABIREN, PULANG PISAU, KALIMANTAN TENGAH",1,115,24,139
https://kawalpemilu.org#61703,"TUMBANG NUSA, JABIREN, PULANG PISAU, KALIMANTAN TENGAH",2,121,14,135
https://kawalpemilu.org#61703,"TUMBANG NUSA, JABIREN, PULANG PISAU, KALIMANTAN TENGAH",3,86,15,101
https://kawalpemilu.org#61703,"TUMBANG NUSA, JABIREN, PULANG PISAU, KALIMANTAN TENGAH",4,155,100,255
https://kawalpemilu.org#88619,"TANJUNG TARUNA, JABIREN, PULANG PISAU, KALIMANTAN TENGAH",1,87,48,135
https://kawalpemilu.org#88619,"TANJUNG TARUNA, JABIREN, PULANG PISAU, KALIMANTAN TENGAH",2,139,31,170
https://kawalpemilu.org#88619,"TANJUNG TARUNA, JABIREN, PULANG PISAU, KALIMANTAN TENGAH",3,67,20,87
https://kawalpemilu.org#61705,"SEBANGAU PERMAI, SEBANGAU KUALA, PULANG PISAU, KALIMANTAN TENGAH",1,103,55,158
https://kawalpemilu.org#61705,"SEBANGAU PERMAI, SEBANGAU KUALA, PULANG PISAU, KALIMANTAN TENGAH",2,72,57,129
https://kawalpemilu.org#61705,"SEBANGAU PERMAI, SEBANGAU KUALA, PULANG PISAU, KALIMANTAN TENGAH",3,146,63,209
https://kawalpemilu.org#61705,"SEBANGAU PERMAI, SEBANGAU KUALA, PULANG PISAU, KALIMANTAN TENGAH",4,150,66,216
https://kawalpemilu.org#61706,"PADURAN SEBANGAU, SEBANGAU KUALA, PULANG PISAU, KALIMANTAN TENGAH",1,54,36,90
https://kawalpemilu.org#61706,"PADURAN SEBANGAU, SEBANGAU KUALA, PULANG PISAU, KALIMANTAN TENGAH",2,53,19,72
https://kawalpemilu.org#61706,"PADURAN SEBANGAU, SEBANGAU KUALA, PULANG PISAU, KALIMANTAN TENGAH",3,52,15,67
https://kawalpemilu.org#61706,"PADURAN SEBANGAU, SEBANGAU KUALA, PULANG PISAU, KALIMANTAN TENGAH",4,95,39,134
https://kawalpemilu.org#61706,"PADURAN SEBANGAU, SEBANGAU KUALA, PULANG PISAU, KALIMANTAN TENGAH",5,38,19,57
https://kawalpemilu.org#61706,"PADURAN SEBANGAU, SEBANGAU KUALA, PULANG PISAU, KALIMANTAN TENGAH",6,54,48,102
https://kawalpemilu.org#61706,"PADURAN SEBANGAU, SEBANGAU KUALA, PULANG PISAU, KALIMANTAN TENGAH",7,13,7,20
https://kawalpemilu.org#61707,"SEBANGAU MULYA, SEBANGAU KUALA, PULANG PISAU, KALIMANTAN TENGAH",1,122,10,132
https://kawalpemilu.org#61707,"SEBANGAU MULYA, SEBANGAU KUALA, PULANG PISAU, KALIMANTAN TENGAH",2,138,12,150
https://kawalpemilu.org#61707,"SEBANGAU MULYA, SEBANGAU KUALA, PULANG PISAU, KALIMANTAN TENGAH",3,111,20,131
https://kawalpemilu.org#61708,"PADURAN MULYA, SEBANGAU KUALA, PULANG PISAU, KALIMANTAN TENGAH",1,87,30,117
https://kawalpemilu.org#61708,"PADURAN MULYA, SEBANGAU KUALA, PULANG PISAU, KALIMANTAN TENGAH",2,76,44,120
https://kawalpemilu.org#61709,"SEBANGAU JAYA, SEBANGAU KUALA, PULANG PISAU, KALIMANTAN TENGAH",1,152,42,194
https://kawalpemilu.org#61710,"MEKAR JAYA, SEBANGAU KUALA, PULANG PISAU, KALIMANTAN TENGAH",1,130,22,152
https://kawalpemilu.org#61710,"MEKAR JAYA, SEBANGAU KUALA, PULANG PISAU, KALIMANTAN TENGAH",2,132,41,173
https://kawalpemilu.org#61710,"MEKAR JAYA, SEBANGAU KUALA, PULANG PISAU, KALIMANTAN TENGAH",3,116,23,139
https://kawalpemilu.org#85410,"SEI HAMBAWANG, SEBANGAU KUALA, PULANG PISAU, KALIMANTAN TENGAH",1,49,61,110
https://kawalpemilu.org#85410,"SEI HAMBAWANG, SEBANGAU KUALA, PULANG PISAU, KALIMANTAN TENGAH",2,50,34,84
https://kawalpemilu.org#85410,"SEI HAMBAWANG, SEBANGAU KUALA, PULANG PISAU, KALIMANTAN TENGAH",3,46,40,86
https://kawalpemilu.org#85410,"SEI HAMBAWANG, SEBANGAU KUALA, PULANG PISAU, KALIMANTAN TENGAH",4,103,30,133
https://kawalpemilu.org#85411,"SEI BAKAU, SEBANGAU KUALA, PULANG PISAU, KALIMANTAN TENGAH",1,40,65,105
https://kawalpemilu.org#85411,"SEI BAKAU, SEBANGAU KUALA, PULANG PISAU, KALIMANTAN TENGAH",2,28,99,127
https://kawalpemilu.org#85411,"SEI BAKAU, SEBANGAU KUALA, PULANG PISAU, KALIMANTAN TENGAH",3,52,95,147
https://kawalpemilu.org#85411,"SEI BAKAU, SEBANGAU KUALA, PULANG PISAU, KALIMANTAN TENGAH",4,33,49,82
https://kawalpemilu.org#61713,"PURUK CAHU, MURUNG, MURUNG RAYA, KALIMANTAN TENGAH",1,30,230,260
https://kawalpemilu.org#61713,"PURUK CAHU, MURUNG, MURUNG RAYA, KALIMANTAN TENGAH",2,23,195,218
https://kawalpemilu.org#61713,"PURUK CAHU, MURUNG, MURUNG RAYA, KALIMANTAN TENGAH",3,51,231,282
https://kawalpemilu.org#61713,"PURUK CAHU, MURUNG, MURUNG RAYA, KALIMANTAN TENGAH",4,24,253,277
https://kawalpemilu.org#61713,"PURUK CAHU, MURUNG, MURUNG RAYA, KALIMANTAN TENGAH",5,52,191,243
https://kawalpemilu.org#61713,"PURUK CAHU, MURUNG, MURUNG RAYA, KALIMANTAN TENGAH",6,87,199,286
https://kawalpemilu.org#61714,"BERIWIT, MURUNG, MURUNG RAYA, KALIMANTAN TENGAH",1,186,105,291
https://kawalpemilu.org#61714,"BERIWIT, MURUNG, MURUNG RAYA, KALIMANTAN TENGAH",2,204,67,271
https://kawalpemilu.org#61714,"BERIWIT, MURUNG, MURUNG RAYA, KALIMANTAN TENGAH",3,232,41,273
https://kawalpemilu.org#61714,"BERIWIT, MURUNG, MURUNG RAYA, KALIMANTAN TENGAH",4,146,126,272
https://kawalpemilu.org#61714,"BERIWIT, MURUNG, MURUNG RAYA, KALIMANTAN TENGAH",5,181,111,292
https://kawalpemilu.org#61714,"BERIWIT, MURUNG, MURUNG RAYA, KALIMANTAN TENGAH",6,150,97,247
https://kawalpemilu.org#61714,"BERIWIT, MURUNG, MURUNG RAYA, KALIMANTAN TENGAH",7,156,127,283
https://kawalpemilu.org#61714,"BERIWIT, MURUNG, MURUNG RAYA, KALIMANTAN TENGAH",8,155,133,288
https://kawalpemilu.org#61714,"BERIWIT, MURUNG, MURUNG RAYA, KALIMANTAN TENGAH",9,119,153,272
https://kawalpemilu.org#61714,"BERIWIT, MURUNG, MURUNG RAYA, KALIMANTAN TENGAH",10,182,102,284
https://kawalpemilu.org#61714,"BERIWIT, MURUNG, MURUNG RAYA, KALIMANTAN TENGAH",11,160,104,264
https://kawalpemilu.org#61714,"BERIWIT, MURUNG, MURUNG RAYA, KALIMANTAN TENGAH",12,119,112,231
https://kawalpemilu.org#61714,"BERIWIT, MURUNG, MURUNG RAYA, KALIMANTAN TENGAH",13,94,115,209
https://kawalpemilu.org#61714,"BERIWIT, MURUNG, MURUNG RAYA, KALIMANTAN TENGAH",14,65,198,263
https://kawalpemilu.org#61714,"BERIWIT, MURUNG, MURUNG RAYA, KALIMANTAN TENGAH",15,118,88,206
https://kawalpemilu.org#61714,"BERIWIT, MURUNG, MURUNG RAYA, KALIMANTAN TENGAH",16,107,96,203
https://kawalpemilu.org#61714,"BERIWIT, MURUNG, MURUNG RAYA, KALIMANTAN TENGAH",17,117,137,254
https://kawalpemilu.org#61714,"BERIWIT, MURUNG, MURUNG RAYA, KALIMANTAN TENGAH",18,110,164,274
https://kawalpemilu.org#61714,"BERIWIT, MURUNG, MURUNG RAYA, KALIMANTAN TENGAH",19,47,213,260
https://kawalpemilu.org#61714,"BERIWIT, MURUNG, MURUNG RAYA, KALIMANTAN TENGAH",20,59,178,237
https://kawalpemilu.org#61714,"BERIWIT, MURUNG, MURUNG RAYA, KALIMANTAN TENGAH",21,67,206,273
https://kawalpemilu.org#61714,"BERIWIT, MURUNG, MURUNG RAYA, KALIMANTAN TENGAH",22,47,221,268
https://kawalpemilu.org#61714,"BERIWIT, MURUNG, MURUNG RAYA, KALIMANTAN TENGAH",23,103,163,266
https://kawalpemilu.org#61714,"BERIWIT, MURUNG, MURUNG RAYA, KALIMANTAN TENGAH",25,65,207,272
https://kawalpemilu.org#61714,"BERIWIT, MURUNG, MURUNG RAYA, KALIMANTAN TENGAH",26,109,155,264
https://kawalpemilu.org#61714,"BERIWIT, MURUNG, MURUNG RAYA, KALIMANTAN TENGAH",27,73,198,271
https://kawalpemilu.org#61714,"BERIWIT, MURUNG, MURUNG RAYA, KALIMANTAN TENGAH",28,115,98,213
https://kawalpemilu.org#61714,"BERIWIT, MURUNG, MURUNG RAYA, KALIMANTAN TENGAH",29,133,140,273
https://kawalpemilu.org#61714,"BERIWIT, MURUNG, MURUNG RAYA, KALIMANTAN TENGAH",30,125,84,209
https://kawalpemilu.org#61714,"BERIWIT, MURUNG, MURUNG RAYA, KALIMANTAN TENGAH",31,131,122,253
https://kawalpemilu.org#61714,"BERIWIT, MURUNG, MURUNG RAYA, KALIMANTAN TENGAH",32,84,145,229
https://kawalpemilu.org#61714,"BERIWIT, MURUNG, MURUNG RAYA, KALIMANTAN TENGAH",33,104,153,257
https://kawalpemilu.org#61714,"BERIWIT, MURUNG, MURUNG RAYA, KALIMANTAN TENGAH",34,83,171,254
https://kawalpemilu.org#61715,"DIRUNG, MURUNG, MURUNG RAYA, KALIMANTAN TENGAH",1,228,35,263
https://kawalpemilu.org#61716,"MALASAN, MURUNG, MURUNG RAYA, KALIMANTAN TENGAH",1,38,126,164
https://kawalpemilu.org#61716,"MALASAN, MURUNG, MURUNG RAYA, KALIMANTAN TENGAH",2,41,74,115
https://kawalpemilu.org#61717,"BATU PUTIH, MURUNG, MURUNG RAYA, KALIMANTAN TENGAH",1,18,193,211
https://kawalpemilu.org#61717,"BATU PUTIH, MURUNG, MURUNG RAYA, KALIMANTAN TENGAH",2,39,178,217
https://kawalpemilu.org#61718,"MANGKAHUI, MURUNG, MURUNG RAYA, KALIMANTAN TENGAH",1,72,170,242
https://kawalpemilu.org#61718,"MANGKAHUI, MURUNG, MURUNG RAYA, KALIMANTAN TENGAH",2,84,194,284
https://kawalpemilu.org#61718,"MANGKAHUI, MURUNG, MURUNG RAYA, KALIMANTAN TENGAH",3,81,188,269
https://kawalpemilu.org#61718,"MANGKAHUI, MURUNG, MURUNG RAYA, KALIMANTAN TENGAH",4,60,92,152
https://kawalpemilu.org#61718,"MANGKAHUI, MURUNG, MURUNG RAYA, KALIMANTAN TENGAH",5,55,104,159
https://kawalpemilu.org#61718,"MANGKAHUI, MURUNG, MURUNG RAYA, KALIMANTAN TENGAH",6,62,155,217
https://kawalpemilu.org#61718,"MANGKAHUI, MURUNG, MURUNG RAYA, KALIMANTAN TENGAH",7,71,153,224
https://kawalpemilu.org#61718,"MANGKAHUI, MURUNG, MURUNG RAYA, KALIMANTAN TENGAH",8,59,147,206
https://kawalpemilu.org#61719,"PANUUT, MURUNG, MURUNG RAYA, KALIMANTAN TENGAH",1,38,156,194
https://kawalpemilu.org#61719,"PANUUT, MURUNG, MURUNG RAYA, KALIMANTAN TENGAH",2,71,122,193
https://kawalpemilu.org#61720,"MUARA UNTU, MURUNG, MURUNG RAYA, KALIMANTAN TENGAH",1,62,130,192
https://kawalpemilu.org#61720,"MUARA UNTU, MURUNG, MURUNG RAYA, KALIMANTAN TENGAH",2,60,130,190
https://kawalpemilu.org#61720,"MUARA UNTU, MURUNG, MURUNG RAYA, KALIMANTAN TENGAH",3,55,167,222
https://kawalpemilu.org#61720,"MUARA UNTU, MURUNG, MURUNG RAYA, KALIMANTAN TENGAH",4,38,202,240
https://kawalpemilu.org#61720,"MUARA UNTU, MURUNG, MURUNG RAYA, KALIMANTAN TENGAH",5,49,158,207
https://kawalpemilu.org#61720,"MUARA UNTU, MURUNG, MURUNG RAYA, KALIMANTAN TENGAH",6,52,138,190
https://kawalpemilu.org#61720,"MUARA UNTU, MURUNG, MURUNG RAYA, KALIMANTAN TENGAH",7,59,102,161
https://kawalpemilu.org#61721,"MUARA JAAN, MURUNG, MURUNG RAYA, KALIMANTAN TENGAH",1,66,184,250
https://kawalpemilu.org#61721,"MUARA JAAN, MURUNG, MURUNG RAYA, KALIMANTAN TENGAH",2,52,141,193
https://kawalpemilu.org#61722,"BAHITOM, MURUNG, MURUNG RAYA, KALIMANTAN TENGAH",1,113,169,282
https://kawalpemilu.org#61722,"BAHITOM, MURUNG, MURUNG RAYA, KALIMANTAN TENGAH",2,123,170,293
https://kawalpemilu.org#61722,"BAHITOM, MURUNG, MURUNG RAYA, KALIMANTAN TENGAH",3,82,146,228
https://kawalpemilu.org#61722,"BAHITOM, MURUNG, MURUNG RAYA, KALIMANTAN TENGAH",4,84,194,272
https://kawalpemilu.org#61722,"BAHITOM, MURUNG, MURUNG RAYA, KALIMANTAN TENGAH",5,100,184,284
https://kawalpemilu.org#61722,"BAHITOM, MURUNG, MURUNG RAYA, KALIMANTAN TENGAH",6,101,170,271
https://kawalpemilu.org#61722,"BAHITOM, MURUNG, MURUNG RAYA, KALIMANTAN TENGAH",7,214,81,295
https://kawalpemilu.org#61722,"BAHITOM, MURUNG, MURUNG RAYA, KALIMANTAN TENGAH",8,117,131,248
https://kawalpemilu.org#61723,"DANAU USUNG, MURUNG, MURUNG RAYA, KALIMANTAN TENGAH",1,83,154,237
https://kawalpemilu.org#61723,"DANAU USUNG, MURUNG, MURUNG RAYA, KALIMANTAN TENGAH",2,21,111,132
https://kawalpemilu.org#61723,"DANAU USUNG, MURUNG, MURUNG RAYA, KALIMANTAN TENGAH",3,74,144,218
https://kawalpemilu.org#61723,"DANAU USUNG, MURUNG, MURUNG RAYA, KALIMANTAN TENGAH",4,53,95,148
https://kawalpemilu.org#61724,"JUKING PAJANG, MURUNG, MURUNG RAYA, KALIMANTAN TENGAH",1,32,188,220
https://kawalpemilu.org#61724,"JUKING PAJANG, MURUNG, MURUNG RAYA, KALIMANTAN TENGAH",2,21,139,160
https://kawalpemilu.org#61724,"JUKING PAJANG, MURUNG, MURUNG RAYA, KALIMANTAN TENGAH",3,54,189,243
https://kawalpemilu.org#61724,"JUKING PAJANG, MURUNG, MURUNG RAYA, KALIMANTAN TENGAH",4,35,149,184
https://kawalpemilu.org#61724,"JUKING PAJANG, MURUNG, MURUNG RAYA, KALIMANTAN TENGAH",5,31,143,174
https://kawalpemilu.org#61724,"JUKING PAJANG, MURUNG, MURUNG RAYA, KALIMANTAN TENGAH",6,22,181,203
https://kawalpemilu.org#61724,"JUKING PAJANG, MURUNG, MURUNG RAYA, KALIMANTAN TENGAH",7,22,79,101
https://kawalpemilu.org#61725,"MUARA SUMPOI, MURUNG, MURUNG RAYA, KALIMANTAN TENGAH",1,57,166,223
https://kawalpemilu.org#61725,"MUARA SUMPOI, MURUNG, MURUNG RAYA, KALIMANTAN TENGAH",2,57,152,209
https://kawalpemilu.org#61725,"MUARA SUMPOI, MURUNG, MURUNG RAYA, KALIMANTAN TENGAH",3,54,144,198
https://kawalpemilu.org#61726,"MUARA BUMBAN, MURUNG, MURUNG RAYA, KALIMANTAN TENGAH",1,49,149,198
https://kawalpemilu.org#61726,"MUARA BUMBAN, MURUNG, MURUNG RAYA, KALIMANTAN TENGAH",2,61,155,216
https://kawalpemilu.org#61726,"MUARA BUMBAN, MURUNG, MURUNG RAYA, KALIMANTAN TENGAH",3,69,147,216
https://kawalpemilu.org#61727,"PENYANG, MURUNG, MURUNG RAYA, KALIMANTAN TENGAH",1,140,132,272
https://kawalpemilu.org#61729,"SARIPOI, TANAH SIANG, MURUNG RAYA, KALIMANTAN TENGAH",1,173,41,214
https://kawalpemilu.org#61729,"SARIPOI, TANAH SIANG, MURUNG RAYA, KALIMANTAN TENGAH",2,144,39,183
https://kawalpemilu.org#61729,"SARIPOI, TANAH SIANG, MURUNG RAYA, KALIMANTAN TENGAH",3,106,41,147
https://kawalpemilu.org#61729,"SARIPOI, TANAH SIANG, MURUNG RAYA, KALIMANTAN TENGAH",4,45,41,86
https://kawalpemilu.org#61730,"SUNGAI LUNUK, TANAH SIANG, MURUNG RAYA, KALIMANTAN TENGAH",1,161,28,189
https://kawalpemilu.org#61730,"SUNGAI LUNUK, TANAH SIANG, MURUNG RAYA, KALIMANTAN TENGAH",2,180,28,208
https://kawalpemilu.org#61730,"SUNGAI LUNUK, TANAH SIANG, MURUNG RAYA, KALIMANTAN TENGAH",3,179,33,212
https://kawalpemilu.org#61731,"KONUT, TANAH SIANG, MURUNG RAYA, KALIMANTAN TENGAH",1,152,19,171
https://kawalpemilu.org#61731,"KONUT, TANAH SIANG, MURUNG RAYA, KALIMANTAN TENGAH",2,130,23,153
https://kawalpemilu.org#61731,"KONUT, TANAH SIANG, MURUNG RAYA, KALIMANTAN TENGAH",3,175,24,199
https://kawalpemilu.org#61731,"KONUT, TANAH SIANG, MURUNG RAYA, KALIMANTAN TENGAH",4,144,24,168
https://kawalpemilu.org#61731,"KONUT, TANAH SIANG, MURUNG RAYA, KALIMANTAN TENGAH",5,66,15,81
https://kawalpemilu.org#61732,"BELAWAN, TANAH SIANG, MURUNG RAYA, KALIMANTAN TENGAH",1,112,16,128
https://kawalpemilu.org#61732,"BELAWAN, TANAH SIANG, MURUNG RAYA, KALIMANTAN TENGAH",2,85,15,100
https://kawalpemilu.org#61733,"MANGKALISOI, TANAH SIANG, MURUNG RAYA, KALIMANTAN TENGAH",1,148,26,174
https://kawalpemilu.org#61734,"KALANG KALUH, TANAH SIANG, MURUNG RAYA, KALIMANTAN TENGAH",1,168,59,227
https://kawalpemilu.org#61735,"MANTIAT PARI, TANAH SIANG, MURUNG RAYA, KALIMANTAN TENGAH",1,120,22,142
https://kawalpemilu.org#61735,"MANTIAT PARI, TANAH SIANG, MURUNG RAYA, KALIMANTAN TENGAH",2,120,16,136
https://kawalpemilu.org#61735,"MANTIAT PARI, TANAH SIANG, MURUNG RAYA, KALIMANTAN TENGAH",3,153,35,188
https://kawalpemilu.org#61736,"OLONG ULU, TANAH SIANG, MURUNG RAYA, KALIMANTAN TENGAH",1,88,94,182
https://kawalpemilu.org#61736,"OLONG ULU, TANAH SIANG, MURUNG RAYA, KALIMANTAN TENGAH",2,51,13,64
https://kawalpemilu.org#61737,"PURUK BATU, TANAH SIANG, MURUNG RAYA, KALIMANTAN TENGAH",1,122,22,144
https://kawalpemilu.org#61738,"OLUNG SIRON, TANAH SIANG, MURUNG RAYA, KALIMANTAN TENGAH",1,178,11,189
https://kawalpemilu.org#61739,"TINO TALIH, TANAH SIANG, MURUNG RAYA, KALIMANTAN TENGAH",1,66,33,99
https://kawalpemilu.org#61740,"OLONG NANGO, TANAH SIANG, MURUNG RAYA, KALIMANTAN TENGAH",1,186,13,199
https://kawalpemilu.org#61740,"OLONG NANGO, TANAH SIANG, MURUNG RAYA, KALIMANTAN TENGAH",2,161,12,173
https://kawalpemilu.org#61741,"MAHANYAN, TANAH SIANG, MURUNG RAYA, KALIMANTAN TENGAH",1,100,21,121
https://kawalpemilu.org#61742,"DIRUNG BAKUNG, TANAH SIANG, MURUNG RAYA, KALIMANTAN TENGAH",1,57,67,124
https://kawalpemilu.org#61742,"DIRUNG BAKUNG, TANAH SIANG, MURUNG RAYA, KALIMANTAN TENGAH",2,78,82,160
https://kawalpemilu.org#61742,"DIRUNG BAKUNG, TANAH SIANG, MURUNG RAYA, KALIMANTAN TENGAH",3,73,75,148
https://kawalpemilu.org#61743,"TABULANG, TANAH SIANG, MURUNG RAYA, KALIMANTAN TENGAH",1,108,41,149
https://kawalpemilu.org#61743,"TABULANG, TANAH SIANG, MURUNG RAYA, KALIMANTAN TENGAH",2,90,31,121
https://kawalpemilu.org#61744,"CANGKANG, TANAH SIANG, MURUNG RAYA, KALIMANTAN TENGAH",1,176,38,214
https://kawalpemilu.org#61745,"OLONG DOJOU, TANAH SIANG, MURUNG RAYA, KALIMANTAN TENGAH",1,101,98,199
https://kawalpemilu.org#61746,"DOAN ARUNG, TANAH SIANG, MURUNG RAYA, KALIMANTAN TENGAH",1,87,79,166
https://kawalpemilu.org#61747,"MUWUN, TANAH SIANG, MURUNG RAYA, KALIMANTAN TENGAH",1,93,47,140
https://kawalpemilu.org#61747,"MUWUN, TANAH SIANG, MURUNG RAYA, KALIMANTAN TENGAH",2,95,37,132
https://kawalpemilu.org#61748,"NONO KLIWON, TANAH SIANG, MURUNG RAYA, KALIMANTAN TENGAH",1,133,23,156
https://kawalpemilu.org#61749,"KOLAM, TANAH SIANG, MURUNG RAYA, KALIMANTAN TENGAH",1,207,11,218
https://kawalpemilu.org#61750,"SARUHUNG, TANAH SIANG, MURUNG RAYA, KALIMANTAN TENGAH",1,103,38,141
https://kawalpemilu.org#61751,"OLUNG SOLOI, TANAH SIANG, MURUNG RAYA, KALIMANTAN TENGAH",1,60,23,83
https://kawalpemilu.org#61752,"TOKUNG, TANAH SIANG, MURUNG RAYA, KALIMANTAN TENGAH",1,154,22,176
https://kawalpemilu.org#61753,"OLUNG BALO, TANAH SIANG, MURUNG RAYA, KALIMANTAN TENGAH",1,96,38,134
https://kawalpemilu.org#61753,"OLUNG BALO, TANAH SIANG, MURUNG RAYA, KALIMANTAN TENGAH",2,89,10,99
https://kawalpemilu.org#61753,"OLUNG BALO, TANAH SIANG, MURUNG RAYA, KALIMANTAN TENGAH",3,124,38,162
https://kawalpemilu.org#61754,"KARALI, TANAH SIANG, MURUNG RAYA, KALIMANTAN TENGAH",1,167,34,201
https://kawalpemilu.org#61754,"KARALI, TANAH SIANG, MURUNG RAYA, KALIMANTAN TENGAH",2,171,50,221
https://kawalpemilu.org#61754,"KARALI, TANAH SIANG, MURUNG RAYA, KALIMANTAN TENGAH",3,28,12,40
https://kawalpemilu.org#61755,"OSOM TOMPOK, TANAH SIANG, MURUNG RAYA, KALIMANTAN TENGAH",1,108,40,148
https://kawalpemilu.org#61755,"OSOM TOMPOK, TANAH SIANG, MURUNG RAYA, KALIMANTAN TENGAH",2,100,49,149
https://kawalpemilu.org#61755,"OSOM TOMPOK, TANAH SIANG, MURUNG RAYA, KALIMANTAN TENGAH",3,128,76,204
https://kawalpemilu.org#61757,"MUARA LAUNG I, LAUNG TUHUP, MURUNG RAYA, KALIMANTAN TENGAH",1,17,160,177
https://kawalpemilu.org#61757,"MUARA LAUNG I, LAUNG TUHUP, MURUNG RAYA, KALIMANTAN TENGAH",2,48,158,206
https://kawalpemilu.org#61757,"MUARA LAUNG I, LAUNG TUHUP, MURUNG RAYA, KALIMANTAN TENGAH",3,41,202,243
https://kawalpemilu.org#61757,"MUARA LAUNG I, LAUNG TUHUP, MURUNG RAYA, KALIMANTAN TENGAH",4,57,187,244
https://kawalpemilu.org#61757,"MUARA LAUNG I, LAUNG TUHUP, MURUNG RAYA, KALIMANTAN TENGAH",5,73,194,267
https://kawalpemilu.org#61757,"MUARA LAUNG I, LAUNG TUHUP, MURUNG RAYA, KALIMANTAN TENGAH",6,45,191,236
https://kawalpemilu.org#61757,"MUARA LAUNG I, LAUNG TUHUP, MURUNG RAYA, KALIMANTAN TENGAH",7,45,198,243
https://kawalpemilu.org#61757,"MUARA LAUNG I, LAUNG TUHUP, MURUNG RAYA, KALIMANTAN TENGAH",8,58,185,243
https://kawalpemilu.org#61757,"MUARA LAUNG I, LAUNG TUHUP, MURUNG RAYA, KALIMANTAN TENGAH",9,38,217,255
https://kawalpemilu.org#61757,"MUARA LAUNG I, LAUNG TUHUP, MURUNG RAYA, KALIMANTAN TENGAH",10,37,192,229
https://kawalpemilu.org#61757,"MUARA LAUNG I, LAUNG TUHUP, MURUNG RAYA, KALIMANTAN TENGAH",11,25,210,235
https://kawalpemilu.org#61757,"MUARA LAUNG I, LAUNG TUHUP, MURUNG RAYA, KALIMANTAN TENGAH",12,40,197,237
https://kawalpemilu.org#61757,"MUARA LAUNG I, LAUNG TUHUP, MURUNG RAYA, KALIMANTAN TENGAH",13,20,126,146
https://kawalpemilu.org#61758,"MUARA TUHUP, LAUNG TUHUP, MURUNG RAYA, KALIMANTAN TENGAH",1,68,156,224
https://kawalpemilu.org#61758,"MUARA TUHUP, LAUNG TUHUP, MURUNG RAYA, KALIMANTAN TENGAH",2,75,129,204
https://kawalpemilu.org#61758,"MUARA TUHUP, LAUNG TUHUP, MURUNG RAYA, KALIMANTAN TENGAH",3,55,160,215
https://kawalpemilu.org#61758,"MUARA TUHUP, LAUNG TUHUP, MURUNG RAYA, KALIMANTAN TENGAH",4,74,178,252
https://kawalpemilu.org#61758,"MUARA TUHUP, LAUNG TUHUP, MURUNG RAYA, KALIMANTAN TENGAH",5,68,166,234
https://kawalpemilu.org#61758,"MUARA TUHUP, LAUNG TUHUP, MURUNG RAYA, KALIMANTAN TENGAH",6,95,166,261
https://kawalpemilu.org#61758,"MUARA TUHUP, LAUNG TUHUP, MURUNG RAYA, KALIMANTAN TENGAH",7,77,172,249
https://kawalpemilu.org#61758,"MUARA TUHUP, LAUNG TUHUP, MURUNG RAYA, KALIMANTAN TENGAH",8,86,128,214
https://kawalpemilu.org#61758,"MUARA TUHUP, LAUNG TUHUP, MURUNG RAYA, KALIMANTAN TENGAH",9,99,139,238
https://kawalpemilu.org#61758,"MUARA TUHUP, LAUNG TUHUP, MURUNG RAYA, KALIMANTAN TENGAH",10,94,127,221
https://kawalpemilu.org#61759,"BATU BUA I, LAUNG TUHUP, MURUNG RAYA, KALIMANTAN TENGAH",1,30,191,221
https://kawalpemilu.org#61759,"BATU BUA I, LAUNG TUHUP, MURUNG RAYA, KALIMANTAN TENGAH",2,51,198,249
https://kawalpemilu.org#61759,"BATU BUA I, LAUNG TUHUP, MURUNG RAYA, KALIMANTAN TENGAH",3,45,196,241
https://kawalpemilu.org#61760,"BATU TUHUP, LAUNG TUHUP, MURUNG RAYA, KALIMANTAN TENGAH",1,44,121,165
https://kawalpemilu.org#61760,"BATU TUHUP, LAUNG TUHUP, MURUNG RAYA, KALIMANTAN TENGAH",2,65,99,164
https://kawalpemilu.org#61761,"TUMBANG BAHAN, LAUNG TUHUP, MURUNG RAYA, KALIMANTAN TENGAH",1,114,31,145
https://kawalpemilu.org#61762,"MUARA LAUNG II, LAUNG TUHUP, MURUNG RAYA, KALIMANTAN TENGAH",1,68,153,221
https://kawalpemilu.org#61762,"MUARA LAUNG II, LAUNG TUHUP, MURUNG RAYA, KALIMANTAN TENGAH",2,64,188,252
https://kawalpemilu.org#61763,"BERAS BELANGE, LAUNG TUHUP, MURUNG RAYA, KALIMANTAN TENGAH",1,115,43,158
https://kawalpemilu.org#61764,"PELACI, LAUNG TUHUP, MURUNG RAYA, KALIMANTAN TENGAH",1,131,41,172
https://kawalpemilu.org#61765,"BIHA, LAUNG TUHUP, MURUNG RAYA, KALIMANTAN TENGAH",1,61,61,122
https://kawalpemilu.org#61765,"BIHA, LAUNG TUHUP, MURUNG RAYA, KALIMANTAN TENGAH",2,56,77,133
https://kawalpemilu.org#61766,"DIRUNG PUNDU, LAUNG TUHUP, MURUNG RAYA, KALIMANTAN TENGAH",1,70,49,119
https://kawalpemilu.org#61766,"DIRUNG PUNDU, LAUNG TUHUP, MURUNG RAYA, KALIMANTAN TENGAH",2,67,40,107
https://kawalpemilu.org#61767,"DIRUNG PINANG, LAUNG TUHUP, MURUNG RAYA, KALIMANTAN TENGAH",1,36,77,113
https://kawalpemilu.org#61768,"MUARA TUPUH, LAUNG TUHUP, MURUNG RAYA, KALIMANTAN TENGAH",1,33,140,173
https://kawalpemilu.org#61768,"MUARA TUPUH, LAUNG TUHUP, MURUNG RAYA, KALIMANTAN TENGAH",2,27,144,171
https://kawalpemilu.org#61768,"MUARA TUPUH, LAUNG TUHUP, MURUNG RAYA, KALIMANTAN TENGAH",3,14,132,146
https://kawalpemilu.org#61768,"MUARA TUPUH, LAUNG TUHUP, MURUNG RAYA, KALIMANTAN TENGAH",4,24,137,161
https://kawalpemilu.org#61769,"NARUI, LAUNG TUHUP, MURUNG RAYA, KALIMANTAN TENGAH",1,128,63,191
https://kawalpemilu.org#61770,"LAKUTAN, LAUNG TUHUP, MURUNG RAYA, KALIMANTAN TENGAH",1,86,36,122
https://kawalpemilu.org#61771,"TAWAI HAUI, LAUNG TUHUP, MURUNG RAYA, KALIMANTAN TENGAH",1,193,26,219
https://kawalpemilu.org#61772,"PENDA SIRON, LAUNG TUHUP, MURUNG RAYA, KALIMANTAN TENGAH",1,174,50,224
https://kawalpemilu.org#61773,"MUARA MARUWEI I, LAUNG TUHUP, MURUNG RAYA, KALIMANTAN TENGAH",1,181,48,229
https://kawalpemilu.org#61773,"MUARA MARUWEI I, LAUNG TUHUP, MURUNG RAYA, KALIMANTAN TENGAH",2,183,33,216
https://kawalpemilu.org#61774,"MUARA MARUWEI II, LAUNG TUHUP, MURUNG RAYA, KALIMANTAN TENGAH",1,117,70,187
https://kawalpemilu.org#61774,"MUARA MARUWEI II, LAUNG TUHUP, MURUNG RAYA, KALIMANTAN TENGAH",2,113,100,213
https://kawalpemilu.org#61775,"BERALANG, LAUNG TUHUP, MURUNG RAYA, KALIMANTAN TENGAH",1,91,22,113
https://kawalpemilu.org#61776,"BATU BUA II, LAUNG TUHUP, MURUNG RAYA, KALIMANTAN TENGAH",1,89,104,193
https://kawalpemilu.org#61776,"BATU BUA II, LAUNG TUHUP, MURUNG RAYA, KALIMANTAN TENGAH",2,54,173,227
https://kawalpemilu.org#61777,"TAHUJAN LAUNG, LAUNG TUHUP, MURUNG RAYA, KALIMANTAN TENGAH",1,30,13,43
https://kawalpemilu.org#61778,"TUMBANG BONDANG, LAUNG TUHUP, MURUNG RAYA, KALIMANTAN TENGAH",1,141,85,226
https://kawalpemilu.org#61778,"TUMBANG BONDANG, LAUNG TUHUP, MURUNG RAYA, KALIMANTAN TENGAH",2,151,75,226
https://kawalpemilu.org#61779,"TUMBANG TONDUK, LAUNG TUHUP, MURUNG RAYA, KALIMANTAN TENGAH",1,65,12,77
https://kawalpemilu.org#61780,"BATU KARANG, LAUNG TUHUP, MURUNG RAYA, KALIMANTAN TENGAH",1,94,41,135
https://kawalpemilu.org#61781,"TUMBANG BANA, LAUNG TUHUP, MURUNG RAYA, KALIMANTAN TENGAH",1,122,77,199
https://kawalpemilu.org#61782,"KALANG DOHONG, LAUNG TUHUP, MURUNG RAYA, KALIMANTAN TENGAH",1,81,36,117
https://kawalpemilu.org#61784,"MUARA BAKANON, PERMATA INTAN, MURUNG RAYA, KALIMANTAN TENGAH",1,56,112,168
https://kawalpemilu.org#61784,"MUARA BAKANON, PERMATA INTAN, MURUNG RAYA, KALIMANTAN TENGAH",2,37,142,179
https://kawalpemilu.org#61784,"MUARA BAKANON, PERMATA INTAN, MURUNG RAYA, KALIMANTAN TENGAH",3,34,191,225
https://kawalpemilu.org#61784,"MUARA BAKANON, PERMATA INTAN, MURUNG RAYA, KALIMANTAN TENGAH",4,58,162,220
https://kawalpemilu.org#61784,"MUARA BAKANON, PERMATA INTAN, MURUNG RAYA, KALIMANTAN TENGAH",5,47,183,230
https://kawalpemilu.org#61784,"MUARA BAKANON, PERMATA INTAN, MURUNG RAYA, KALIMANTAN TENGAH",6,65,127,192
https://kawalpemilu.org#61784,"MUARA BAKANON, PERMATA INTAN, MURUNG RAYA, KALIMANTAN TENGAH",7,28,39,67
https://kawalpemilu.org#61785,"TUMBANG LAHUNG, PERMATA INTAN, MURUNG RAYA, KALIMANTAN TENGAH",1,94,97,191
https://kawalpemilu.org#61785,"TUMBANG LAHUNG, PERMATA INTAN, MURUNG RAYA, KALIMANTAN TENGAH",2,79,125,204
https://kawalpemilu.org#61785,"TUMBANG LAHUNG, PERMATA INTAN, MURUNG RAYA, KALIMANTAN TENGAH",4,60,114,174
https://kawalpemilu.org#61785,"TUMBANG LAHUNG, PERMATA INTAN, MURUNG RAYA, KALIMANTAN TENGAH",5,62,67,129
https://kawalpemilu.org#61785,"TUMBANG LAHUNG, PERMATA INTAN, MURUNG RAYA, KALIMANTAN TENGAH",7,61,121,182
https://kawalpemilu.org#61785,"TUMBANG LAHUNG, PERMATA INTAN, MURUNG RAYA, KALIMANTAN TENGAH",8,101,112,213
https://kawalpemilu.org#61785,"TUMBANG LAHUNG, PERMATA INTAN, MURUNG RAYA, KALIMANTAN TENGAH",9,88,47,135
https://kawalpemilu.org#61786,"SUNGAI GULA, PERMATA INTAN, MURUNG RAYA, KALIMANTAN TENGAH",1,82,94,176
https://kawalpemilu.org#61786,"SUNGAI GULA, PERMATA INTAN, MURUNG RAYA, KALIMANTAN TENGAH",2,48,64,112
https://kawalpemilu.org#61786,"SUNGAI GULA, PERMATA INTAN, MURUNG RAYA, KALIMANTAN TENGAH",3,110,58,168
https://kawalpemilu.org#61786,"SUNGAI GULA, PERMATA INTAN, MURUNG RAYA, KALIMANTAN TENGAH",4,36,2,38
https://kawalpemilu.org#61787,"SUNGAI BATANG, PERMATA INTAN, MURUNG RAYA, KALIMANTAN TENGAH",1,124,77,201
https://kawalpemilu.org#61788,"TUMBANG SALIO, PERMATA INTAN, MURUNG RAYA, KALIMANTAN TENGAH",1,217,24,241
https://kawalpemilu.org#61789,"PURNAMA, PERMATA INTAN, MURUNG RAYA, KALIMANTAN TENGAH",1,100,109,209
https://kawalpemilu.org#61789,"PURNAMA, PERMATA INTAN, MURUNG RAYA, KALIMANTAN TENGAH",2,101,110,211
https://kawalpemilu.org#61790,"SUNGAI LOBANG, PERMATA INTAN, MURUNG RAYA, KALIMANTAN TENGAH",1,40,89,129
https://kawalpemilu.org#61790,"SUNGAI LOBANG, PERMATA INTAN, MURUNG RAYA, KALIMANTAN TENGAH",2,70,67,137
https://kawalpemilu.org#61791,"PANTAI LAGA, PERMATA INTAN, MURUNG RAYA, KALIMANTAN TENGAH",1,46,39,85
https://kawalpemilu.org#61791,"PANTAI LAGA, PERMATA INTAN, MURUNG RAYA, KALIMANTAN TENGAH",2,41,125,166
https://kawalpemilu.org#61792,"BARATU, PERMATA INTAN, MURUNG RAYA, KALIMANTAN TENGAH",1,162,17,179
https://kawalpemilu.org#61793,"JUKING SOPAN, PERMATA INTAN, MURUNG RAYA, KALIMANTAN TENGAH",1,68,130,204
https://kawalpemilu.org#61793,"JUKING SOPAN, PERMATA INTAN, MURUNG RAYA, KALIMANTAN TENGAH",2,72,115,187
https://kawalpemilu.org#61793,"JUKING SOPAN, PERMATA INTAN, MURUNG RAYA, KALIMANTAN TENGAH",3,74,115,189
https://kawalpemilu.org#61793,"JUKING SOPAN, PERMATA INTAN, MURUNG RAYA, KALIMANTAN TENGAH",4,153,53,188
https://kawalpemilu.org#61794,"MUARA BABUAT, PERMATA INTAN, MURUNG RAYA, KALIMANTAN TENGAH",1,56,183,239
https://kawalpemilu.org#61794,"MUARA BABUAT, PERMATA INTAN, MURUNG RAYA, KALIMANTAN TENGAH",2,50,168,218
https://kawalpemilu.org#61794,"MUARA BABUAT, PERMATA INTAN, MURUNG RAYA, KALIMANTAN TENGAH",3,59,169,228
https://kawalpemilu.org#61794,"MUARA BABUAT, PERMATA INTAN, MURUNG RAYA, KALIMANTAN TENGAH",4,84,165,249
https://kawalpemilu.org#61795,"SEI BAKANON, PERMATA INTAN, MURUNG RAYA, KALIMANTAN TENGAH",1,85,18,103
https://kawalpemilu.org#61795,"SEI BAKANON, PERMATA INTAN, MURUNG RAYA, KALIMANTAN TENGAH",2,102,22,124
https://kawalpemilu.org#61797,"TUMBANG KUNYI, SUMBER BARITO, MURUNG RAYA, KALIMANTAN TENGAH",1,159,15,174
https://kawalpemilu.org#61797,"TUMBANG KUNYI, SUMBER BARITO, MURUNG RAYA, KALIMANTAN TENGAH",3,145,35,180
https://kawalpemilu.org#61797,"TUMBANG KUNYI, SUMBER BARITO, MURUNG RAYA, KALIMANTAN TENGAH",4,94,70,164
https://kawalpemilu.org#61797,"TUMBANG KUNYI, SUMBER BARITO, MURUNG RAYA, KALIMANTAN TENGAH",5,80,107,187
https://kawalpemilu.org#61798,"KALAPEH BARU, SUMBER BARITO, MURUNG RAYA, KALIMANTAN TENGAH",1,136,53,189
https://kawalpemilu.org#61798,"KALAPEH BARU, SUMBER BARITO, MURUNG RAYA, KALIMANTAN TENGAH",2,126,59,185
https://kawalpemilu.org#61799,"TUMBANG MASAO, SUMBER BARITO, MURUNG RAYA, KALIMANTAN TENGAH",1,144,62,206
https://kawalpemilu.org#61799,"TUMBANG MASAO, SUMBER BARITO, MURUNG RAYA, KALIMANTAN TENGAH",2,120,91,211
https://kawalpemilu.org#61799,"TUMBANG MASAO, SUMBER BARITO, MURUNG RAYA, KALIMANTAN TENGAH",3,118,46,164
https://kawalpemilu.org#61799,"TUMBANG MASAO, SUMBER BARITO, MURUNG RAYA, KALIMANTAN TENGAH",4,117,72,189
https://kawalpemilu.org#61799,"TUMBANG MASAO, SUMBER BARITO, MURUNG RAYA, KALIMANTAN TENGAH",5,139,89,228
https://kawalpemilu.org#61800,"BATU MAKAP, SUMBER BARITO, MURUNG RAYA, KALIMANTAN TENGAH",1,183,4,187
https://kawalpemilu.org#61800,"BATU MAKAP, SUMBER BARITO, MURUNG RAYA, KALIMANTAN TENGAH",2,162,10,172
https://kawalpemilu.org#61800,"BATU MAKAP, SUMBER BARITO, MURUNG RAYA, KALIMANTAN TENGAH",3,169,7,176
https://kawalpemilu.org#61801,"OLONG LIKO, SUMBER BARITO, MURUNG RAYA, KALIMANTAN TENGAH",1,110,5,115
https://kawalpemilu.org#61802,"TELOK JOLO, SUMBER BARITO, MURUNG RAYA, KALIMANTAN TENGAH",1,129,12,141
https://kawalpemilu.org#61802,"TELOK JOLO, SUMBER BARITO, MURUNG RAYA, KALIMANTAN TENGAH",2,100,28,0
https://kawalpemilu.org#61802,"TELOK JOLO, SUMBER BARITO, MURUNG RAYA, KALIMANTAN TENGAH",3,105,24,129
https://kawalpemilu.org#61803,"LAAS BARU, SUMBER BARITO, MURUNG RAYA, KALIMANTAN TENGAH",1,137,62,199
https://kawalpemilu.org#61804,"TUMBANG MOLUT, SUMBER BARITO, MURUNG RAYA, KALIMANTAN TENGAH",1,100,97,197
https://kawalpemilu.org#61804,"TUMBANG MOLUT, SUMBER BARITO, MURUNG RAYA, KALIMANTAN TENGAH",2,70,78,148
https://kawalpemilu.org#61805,"TUMBANG TUAN, SUMBER BARITO, MURUNG RAYA, KALIMANTAN TENGAH",1,129,23,152
https://kawalpemilu.org#61805,"TUMBANG TUAN, SUMBER BARITO, MURUNG RAYA, KALIMANTAN TENGAH",2,118,37,155
https://kawalpemilu.org#61805,"TUMBANG TUAN, SUMBER BARITO, MURUNG RAYA, KALIMANTAN TENGAH",3,90,52,142
https://kawalpemilu.org#61807,"BUMBAN TUHUP, BARITO TUHUP RAYA, MURUNG RAYA, KALIMANTAN TENGAH",1,127,86,213
https://kawalpemilu.org#61807,"BUMBAN TUHUP, BARITO TUHUP RAYA, MURUNG RAYA, KALIMANTAN TENGAH",2,112,79,191
https://kawalpemilu.org#61808,"MAKUNJUNG, BARITO TUHUP RAYA, MURUNG RAYA, KALIMANTAN TENGAH",1,141,16,157
https://kawalpemilu.org#61808,"MAKUNJUNG, BARITO TUHUP RAYA, MURUNG RAYA, KALIMANTAN TENGAH",2,211,22,233
https://kawalpemilu.org#61808,"MAKUNJUNG, BARITO TUHUP RAYA, MURUNG RAYA, KALIMANTAN TENGAH",3,121,103,224
https://kawalpemilu.org#61809,"DIRUNG SERARUNG, BARITO TUHUP RAYA, MURUNG RAYA, KALIMANTAN TENGAH",1,119,54,173
https://kawalpemilu.org#61809,"DIRUNG SERARUNG, BARITO TUHUP RAYA, MURUNG RAYA, KALIMANTAN TENGAH",2,54,23,77
https://kawalpemilu.org#61810,"KOHONG, BARITO TUHUP RAYA, MURUNG RAYA, KALIMANTAN TENGAH",1,87,4,91
https://kawalpemilu.org#61810,"KOHONG, BARITO TUHUP RAYA, MURUNG RAYA, KALIMANTAN TENGAH",2,167,9,176
https://kawalpemilu.org#61811,"HINGAN TOKUNG, BARITO TUHUP RAYA, MURUNG RAYA, KALIMANTAN TENGAH",1,112,53,165
https://kawalpemilu.org#61812,"LIANG NYALING, BARITO TUHUP RAYA, MURUNG RAYA, KALIMANTAN TENGAH",1,64,30,94
https://kawalpemilu.org#61813,"TUMBANG BAUH, BARITO TUHUP RAYA, MURUNG RAYA, KALIMANTAN TENGAH",1,90,49,139
https://kawalpemilu.org#61813,"TUMBANG BAUH, BARITO TUHUP RAYA, MURUNG RAYA, KALIMANTAN TENGAH",2,86,50,136
https://kawalpemilu.org#61814,"TUMBANG MASALO, BARITO TUHUP RAYA, MURUNG RAYA, KALIMANTAN TENGAH",1,61,17,78
https://kawalpemilu.org#61815,"BATU TOJAH, BARITO TUHUP RAYA, MURUNG RAYA, KALIMANTAN TENGAH",1,164,17,181
https://kawalpemilu.org#61816,"TUMBANG BALOI, BARITO TUHUP RAYA, MURUNG RAYA, KALIMANTAN TENGAH",1,213,29,242
https://kawalpemilu.org#61816,"TUMBANG BALOI, BARITO TUHUP RAYA, MURUNG RAYA, KALIMANTAN TENGAH",2,68,60,128
https://kawalpemilu.org#61817,"CINTA BUDIMAN, BARITO TUHUP RAYA, MURUNG RAYA, KALIMANTAN TENGAH",1,123,60,183
https://kawalpemilu.org#61819,"ORENG, TANAH SIANG SELATAN, MURUNG RAYA, KALIMANTAN TENGAH",1,135,14,149
https://kawalpemilu.org#61819,"ORENG, TANAH SIANG SELATAN, MURUNG RAYA, KALIMANTAN TENGAH",2,0,0,0
https://kawalpemilu.org#61820,"OLUNG MURO, TANAH SIANG SELATAN, MURUNG RAYA, KALIMANTAN TENGAH",1,208,13,221
https://kawalpemilu.org#61820,"OLUNG MURO, TANAH SIANG SELATAN, MURUNG RAYA, KALIMANTAN TENGAH",2,120,16,136
https://kawalpemilu.org#61821,"OLUNG HANANGAN, TANAH SIANG SELATAN, MURUNG RAYA, KALIMANTAN TENGAH",1,221,43,264
https://kawalpemilu.org#61821,"OLUNG HANANGAN, TANAH SIANG SELATAN, MURUNG RAYA, KALIMANTAN TENGAH",2,91,28,119
https://kawalpemilu.org#61822,"DIRUNG LINGKIN, TANAH SIANG SELATAN, MURUNG RAYA, KALIMANTAN TENGAH",1,211,35,246
https://kawalpemilu.org#61822,"DIRUNG LINGKIN, TANAH SIANG SELATAN, MURUNG RAYA, KALIMANTAN TENGAH",2,89,167,256
https://kawalpemilu.org#61822,"DIRUNG LINGKIN, TANAH SIANG SELATAN, MURUNG RAYA, KALIMANTAN TENGAH",3,97,109,206
https://kawalpemilu.org#61822,"DIRUNG LINGKIN, TANAH SIANG SELATAN, MURUNG RAYA, KALIMANTAN TENGAH",4,131,81,212
https://kawalpemilu.org#61823,"DATAH KOTOU, TANAH SIANG SELATAN, MURUNG RAYA, KALIMANTAN TENGAH",1,148,14,162
https://kawalpemilu.org#61823,"DATAH KOTOU, TANAH SIANG SELATAN, MURUNG RAYA, KALIMANTAN TENGAH",2,156,23,179
https://kawalpemilu.org#61824,"TAHUJAN ONTU, TANAH SIANG SELATAN, MURUNG RAYA, KALIMANTAN TENGAH",1,155,35,190
https://kawalpemilu.org#61824,"TAHUJAN ONTU, TANAH SIANG SELATAN, MURUNG RAYA, KALIMANTAN TENGAH",2,148,28,176
https://kawalpemilu.org#931076,"PURUK KAMBANG, TANAH SIANG SELATAN, MURUNG RAYA, KALIMANTAN TENGAH",1,124,100,224
https://kawalpemilu.org#931076,"PURUK KAMBANG, TANAH SIANG SELATAN, MURUNG RAYA, KALIMANTAN TENGAH",2,146,77,223
https://kawalpemilu.org#61826,"BATU MIRAU, SUNGAI BABUAT, MURUNG RAYA, KALIMANTAN TENGAH",1,145,5,150
https://kawalpemilu.org#61826,"BATU MIRAU, SUNGAI BABUAT, MURUNG RAYA, KALIMANTAN TENGAH",2,136,17,153
https://kawalpemilu.org#61827,"TAMBELUM, SUNGAI BABUAT, MURUNG RAYA, KALIMANTAN TENGAH",1,134,10,144
https://kawalpemilu.org#61827,"TAMBELUM, SUNGAI BABUAT, MURUNG RAYA, KALIMANTAN TENGAH",2,138,3,141
https://kawalpemilu.org#61828,"TUMBANG BANTIAN, SUNGAI BABUAT, MURUNG RAYA, KALIMANTAN TENGAH",1,159,11,170
https://kawalpemilu.org#61828,"TUMBANG BANTIAN, SUNGAI BABUAT, MURUNG RAYA, KALIMANTAN TENGAH",2,103,8,111
https://kawalpemilu.org#61829,"TUMBANG SAAN, SUNGAI BABUAT, MURUNG RAYA, KALIMANTAN TENGAH",1,140,34,174
https://kawalpemilu.org#61830,"TUMBANG KOLON, SUNGAI BABUAT, MURUNG RAYA, KALIMANTAN TENGAH",1,184,28,212
https://kawalpemilu.org#61831,"TUMBANG APAT, SUNGAI BABUAT, MURUNG RAYA, KALIMANTAN TENGAH",1,99,10,109
https://kawalpemilu.org#61831,"TUMBANG APAT, SUNGAI BABUAT, MURUNG RAYA, KALIMANTAN TENGAH",2,125,9,134
https://kawalpemilu.org#61833,"TUMBANG TOHAN, SERIBU RIAM, MURUNG RAYA, KALIMANTAN TENGAH",1,204,3,207
https://kawalpemilu.org#61834,"TUMBANG NAAN, SERIBU RIAM, MURUNG RAYA, KALIMANTAN TENGAH",1,233,10,243
https://kawalpemilu.org#61834,"TUMBANG NAAN, SERIBU RIAM, MURUNG RAYA, KALIMANTAN TENGAH",2,185,10,195
https://kawalpemilu.org#61834,"TUMBANG NAAN, SERIBU RIAM, MURUNG RAYA, KALIMANTAN TENGAH",3,154,3,157
https://kawalpemilu.org#61834,"TUMBANG NAAN, SERIBU RIAM, MURUNG RAYA, KALIMANTAN TENGAH",4,182,13,195
https://kawalpemilu.org#61835,"MUARA JOLOI 1, SERIBU RIAM, MURUNG RAYA, KALIMANTAN TENGAH",1,72,127,199
https://kawalpemilu.org#61835,"MUARA JOLOI 1, SERIBU RIAM, MURUNG RAYA, KALIMANTAN TENGAH",2,74,101,175
https://kawalpemilu.org#61836,"MUARA JOLOI 2, SERIBU RIAM, MURUNG RAYA, KALIMANTAN TENGAH",1,135,10,145
https://kawalpemilu.org#61836,"MUARA JOLOI 2, SERIBU RIAM, MURUNG RAYA, KALIMANTAN TENGAH",2,146,14,160
https://kawalpemilu.org#61837,"PARAHAU, SERIBU RIAM, MURUNG RAYA, KALIMANTAN TENGAH",1,121,15,136
https://kawalpemilu.org#61838,"TUMBANG JOJANG, SERIBU RIAM, MURUNG RAYA, KALIMANTAN TENGAH",1,140,16,156
https://kawalpemilu.org#61838,"TUMBANG JOJANG, SERIBU RIAM, MURUNG RAYA, KALIMANTAN TENGAH",2,82,15,97
https://kawalpemilu.org#61838,"TUMBANG JOJANG, SERIBU RIAM, MURUNG RAYA, KALIMANTAN TENGAH",3,105,3,108
https://kawalpemilu.org#61839,"TAKAJUNG, SERIBU RIAM, MURUNG RAYA, KALIMANTAN TENGAH",1,140,4,144
https://kawalpemilu.org#61841,"TUMBANG TUJANG, UUT MURUNG, MURUNG RAYA, KALIMANTAN TENGAH",1,108,44,152
https://kawalpemilu.org#61841,"TUMBANG TUJANG, UUT MURUNG, MURUNG RAYA, KALIMANTAN TENGAH",2,40,26,66
https://kawalpemilu.org#61841,"TUMBANG TUJANG, UUT MURUNG, MURUNG RAYA, KALIMANTAN TENGAH",3,100,40,140
https://kawalpemilu.org#61842,"TUMBANG OLONG I, UUT MURUNG, MURUNG RAYA, KALIMANTAN TENGAH",1,181,22,203
https://kawalpemilu.org#61843,"KALASIN, UUT MURUNG, MURUNG RAYA, KALIMANTAN TENGAH",1,109,10,119
https://kawalpemilu.org#61843,"KALASIN, UUT MURUNG, MURUNG RAYA, KALIMANTAN TENGAH",2,119,13,132
https://kawalpemilu.org#61844,"TUMBANG TOPUS, UUT MURUNG, MURUNG RAYA, KALIMANTAN TENGAH",1,88,0,88
https://kawalpemilu.org#61845,"TUMBANG OLONG II, UUT MURUNG, MURUNG RAYA, KALIMANTAN TENGAH",1,205,65,270
https://kawalpemilu.org#61845,"TUMBANG OLONG II, UUT MURUNG, MURUNG RAYA, KALIMANTAN TENGAH",2,147,52,199
https://kawalpemilu.org#61848,"TAMIANG LAYANG, DUSUN TIMUR, BARITO TIMUR, KALIMANTAN TENGAH",1,74,130,204
https://kawalpemilu.org#61848,"TAMIANG LAYANG, DUSUN TIMUR, BARITO TIMUR, KALIMANTAN TENGAH",2,73,117,190
https://kawalpemilu.org#61848,"TAMIANG LAYANG, DUSUN TIMUR, BARITO TIMUR, KALIMANTAN TENGAH",3,44,154,198
https://kawalpemilu.org#61848,"TAMIANG LAYANG, DUSUN TIMUR, BARITO TIMUR, KALIMANTAN TENGAH",4,40,162,202
https://kawalpemilu.org#61848,"TAMIANG LAYANG, DUSUN TIMUR, BARITO TIMUR, KALIMANTAN TENGAH",5,77,90,167
https://kawalpemilu.org#61848,"TAMIANG LAYANG, DUSUN TIMUR, BARITO TIMUR, KALIMANTAN TENGAH",6,128,20,148
https://kawalpemilu.org#61848,"TAMIANG LAYANG, DUSUN TIMUR, BARITO TIMUR, KALIMANTAN TENGAH",7,198,27,225
https://kawalpemilu.org#61848,"TAMIANG LAYANG, DUSUN TIMUR, BARITO TIMUR, KALIMANTAN TENGAH",8,184,37,221
https://kawalpemilu.org#61848,"TAMIANG LAYANG, DUSUN TIMUR, BARITO TIMUR, KALIMANTAN TENGAH",9,231,43,274
https://kawalpemilu.org#61848,"TAMIANG LAYANG, DUSUN TIMUR, BARITO TIMUR, KALIMANTAN TENGAH",10,209,35,244
https://kawalpemilu.org#61848,"TAMIANG LAYANG, DUSUN TIMUR, BARITO TIMUR, KALIMANTAN TENGAH",11,155,28,183
https://kawalpemilu.org#61848,"TAMIANG LAYANG, DUSUN TIMUR, BARITO TIMUR, KALIMANTAN TENGAH",12,155,32,186
https://kawalpemilu.org#61848,"TAMIANG LAYANG, DUSUN TIMUR, BARITO TIMUR, KALIMANTAN TENGAH",13,109,96,205
https://kawalpemilu.org#61848,"TAMIANG LAYANG, DUSUN TIMUR, BARITO TIMUR, KALIMANTAN TENGAH",14,72,34,106
https://kawalpemilu.org#61848,"TAMIANG LAYANG, DUSUN TIMUR, BARITO TIMUR, KALIMANTAN TENGAH",15,123,66,189
https://kawalpemilu.org#61848,"TAMIANG LAYANG, DUSUN TIMUR, BARITO TIMUR, KALIMANTAN TENGAH",16,42,111,153
https://kawalpemilu.org#61848,"TAMIANG LAYANG, DUSUN TIMUR, BARITO TIMUR, KALIMANTAN TENGAH",17,83,131,214
https://kawalpemilu.org#61848,"TAMIANG LAYANG, DUSUN TIMUR, BARITO TIMUR, KALIMANTAN TENGAH",18,125,33,158
https://kawalpemilu.org#61848,"TAMIANG LAYANG, DUSUN TIMUR, BARITO TIMUR, KALIMANTAN TENGAH",19,48,78,126
https://kawalpemilu.org#61848,"TAMIANG LAYANG, DUSUN TIMUR, BARITO TIMUR, KALIMANTAN TENGAH",20,89,11,100
https://kawalpemilu.org#61848,"TAMIANG LAYANG, DUSUN TIMUR, BARITO TIMUR, KALIMANTAN TENGAH",21,255,34,289
https://kawalpemilu.org#61848,"TAMIANG LAYANG, DUSUN TIMUR, BARITO TIMUR, KALIMANTAN TENGAH",22,221,23,244
https://kawalpemilu.org#61848,"TAMIANG LAYANG, DUSUN TIMUR, BARITO TIMUR, KALIMANTAN TENGAH",23,107,137,244
https://kawalpemilu.org#61848,"TAMIANG LAYANG, DUSUN TIMUR, BARITO TIMUR, KALIMANTAN TENGAH",24,157,50,207
https://kawalpemilu.org#61848,"TAMIANG LAYANG, DUSUN TIMUR, BARITO TIMUR, KALIMANTAN TENGAH",25,132,59,191
https://kawalpemilu.org#61848,"TAMIANG LAYANG, DUSUN TIMUR, BARITO TIMUR, KALIMANTAN TENGAH",26,132,37,169
https://kawalpemilu.org#61848,"TAMIANG LAYANG, DUSUN TIMUR, BARITO TIMUR, KALIMANTAN TENGAH",27,102,55,157
https://kawalpemilu.org#61848,"TAMIANG LAYANG, DUSUN TIMUR, BARITO TIMUR, KALIMANTAN TENGAH",28,131,64,195
https://kawalpemilu.org#61849,"PULAU PATAI, DUSUN TIMUR, BARITO TIMUR, KALIMANTAN TENGAH",1,105,9,114
https://kawalpemilu.org#61849,"PULAU PATAI, DUSUN TIMUR, BARITO TIMUR, KALIMANTAN TENGAH",2,149,19,168
https://kawalpemilu.org#61850,"SARAPAT, DUSUN TIMUR, BARITO TIMUR, KALIMANTAN TENGAH",1,129,18,147
https://kawalpemilu.org#61850,"SARAPAT, DUSUN TIMUR, BARITO TIMUR, KALIMANTAN TENGAH",2,135,15,150
https://kawalpemilu.org#61850,"SARAPAT, DUSUN TIMUR, BARITO TIMUR, KALIMANTAN TENGAH",3,196,20,216
https://kawalpemilu.org#61850,"SARAPAT, DUSUN TIMUR, BARITO TIMUR, KALIMANTAN TENGAH",4,52,128,180
https://kawalpemilu.org#61851,"MAGANTIS, DUSUN TIMUR, BARITO TIMUR, KALIMANTAN TENGAH",1,23,194,217
https://kawalpemilu.org#61851,"MAGANTIS, DUSUN TIMUR, BARITO TIMUR, KALIMANTAN TENGAH",2,26,174,200
https://kawalpemilu.org#61851,"MAGANTIS, DUSUN TIMUR, BARITO TIMUR, KALIMANTAN TENGAH",3,24,183,207
https://kawalpemilu.org#61851,"MAGANTIS, DUSUN TIMUR, BARITO TIMUR, KALIMANTAN TENGAH",4,24,158,182
https://kawalpemilu.org#61851,"MAGANTIS, DUSUN TIMUR, BARITO TIMUR, KALIMANTAN TENGAH",5,21,161,182
https://kawalpemilu.org#61852,"JA'AR, DUSUN TIMUR, BARITO TIMUR, KALIMANTAN TENGAH",1,178,94,270
https://kawalpemilu.org#61852,"JA'AR, DUSUN TIMUR, BARITO TIMUR, KALIMANTAN TENGAH",2,93,6,99
https://kawalpemilu.org#61852,"JA'AR, DUSUN TIMUR, BARITO TIMUR, KALIMANTAN TENGAH",3,175,20,195
https://kawalpemilu.org#61852,"JA'AR, DUSUN TIMUR, BARITO TIMUR, KALIMANTAN TENGAH",4,187,11,198
https://kawalpemilu.org#61852,"JA'AR, DUSUN TIMUR, BARITO TIMUR, KALIMANTAN TENGAH",5,154,14,168
https://kawalpemilu.org#61852,"JA'AR, DUSUN TIMUR, BARITO TIMUR, KALIMANTAN TENGAH",6,160,10,170
https://kawalpemilu.org#61852,"JA'AR, DUSUN TIMUR, BARITO TIMUR, KALIMANTAN TENGAH",7,172,5,177
https://kawalpemilu.org#61852,"JA'AR, DUSUN TIMUR, BARITO TIMUR, KALIMANTAN TENGAH",8,165,14,179
https://kawalpemilu.org#61852,"JA'AR, DUSUN TIMUR, BARITO TIMUR, KALIMANTAN TENGAH",9,196,45,241
https://kawalpemilu.org#61853,"MATABU, DUSUN TIMUR, BARITO TIMUR, KALIMANTAN TENGAH",1,34,178,212
https://kawalpemilu.org#61853,"MATABU, DUSUN TIMUR, BARITO TIMUR, KALIMANTAN TENGAH",2,35,183,218
https://kawalpemilu.org#61853,"MATABU, DUSUN TIMUR, BARITO TIMUR, KALIMANTAN TENGAH",3,60,215,275
https://kawalpemilu.org#61853,"MATABU, DUSUN TIMUR, BARITO TIMUR, KALIMANTAN TENGAH",4,45,163,208
https://kawalpemilu.org#61853,"MATABU, DUSUN TIMUR, BARITO TIMUR, KALIMANTAN TENGAH",5,94,140,234
https://kawalpemilu.org#61853,"MATABU, DUSUN TIMUR, BARITO TIMUR, KALIMANTAN TENGAH",6,36,147,183
https://kawalpemilu.org#61853,"MATABU, DUSUN TIMUR, BARITO TIMUR, KALIMANTAN TENGAH",7,72,144,216
https://kawalpemilu.org#61853,"MATABU, DUSUN TIMUR, BARITO TIMUR, KALIMANTAN TENGAH",8,68,92,160
https://kawalpemilu.org#61854,"DORONG, DUSUN TIMUR, BARITO TIMUR, KALIMANTAN TENGAH",1,149,16,165
https://kawalpemilu.org#61854,"DORONG, DUSUN TIMUR, BARITO TIMUR, KALIMANTAN TENGAH",2,163,8,171
https://kawalpemilu.org#61854,"DORONG, DUSUN TIMUR, BARITO TIMUR, KALIMANTAN TENGAH",3,150,6,156
https://kawalpemilu.org#61854,"DORONG, DUSUN TIMUR, BARITO TIMUR, KALIMANTAN TENGAH",4,146,11,157
https://kawalpemilu.org#61855,"DIDI, DUSUN TIMUR, BARITO TIMUR, KALIMANTAN TENGAH",1,154,40,194
https://kawalpemilu.org#61855,"DIDI, DUSUN TIMUR, BARITO TIMUR, KALIMANTAN TENGAH",2,156,29,185
https://kawalpemilu.org#61856,"KARANG LANGIT, DUSUN TIMUR, BARITO TIMUR, KALIMANTAN TENGAH",1,142,24,166
https://kawalpemilu.org#61856,"KARANG LANGIT, DUSUN TIMUR, BARITO TIMUR, KALIMANTAN TENGAH",2,155,7,162
https://kawalpemilu.org#61856,"KARANG LANGIT, DUSUN TIMUR, BARITO TIMUR, KALIMANTAN TENGAH",3,147,16,163
https://kawalpemilu.org#61857,"HARINGEN, DUSUN TIMUR, BARITO TIMUR, KALIMANTAN TENGAH",1,212,24,236
https://kawalpemilu.org#61857,"HARINGEN, DUSUN TIMUR, BARITO TIMUR, KALIMANTAN TENGAH",2,93,3,96
https://kawalpemilu.org#61857,"HARINGEN, DUSUN TIMUR, BARITO TIMUR, KALIMANTAN TENGAH",3,185,37,222
https://kawalpemilu.org#61858,"JAWETEN, DUSUN TIMUR, BARITO TIMUR, KALIMANTAN TENGAH",1,130,13,143
https://kawalpemilu.org#61858,"JAWETEN, DUSUN TIMUR, BARITO TIMUR, KALIMANTAN TENGAH",2,125,23,148
https://kawalpemilu.org#61858,"JAWETEN, DUSUN TIMUR, BARITO TIMUR, KALIMANTAN TENGAH",3,167,22,189
https://kawalpemilu.org#61858,"JAWETEN, DUSUN TIMUR, BARITO TIMUR, KALIMANTAN TENGAH",4,141,10,151
https://kawalpemilu.org#61858,"JAWETEN, DUSUN TIMUR, BARITO TIMUR, KALIMANTAN TENGAH",5,147,27,174
https://kawalpemilu.org#61858,"JAWETEN, DUSUN TIMUR, BARITO TIMUR, KALIMANTAN TENGAH",6,136,19,155
https://kawalpemilu.org#61858,"JAWETEN, DUSUN TIMUR, BARITO TIMUR, KALIMANTAN TENGAH",7,122,17,139
https://kawalpemilu.org#85412,"MATARAH, DUSUN TIMUR, BARITO TIMUR, KALIMANTAN TENGAH",1,139,7,146
https://kawalpemilu.org#85412,"MATARAH, DUSUN TIMUR, BARITO TIMUR, KALIMANTAN TENGAH",2,129,9,138
https://kawalpemilu.org#85412,"MATARAH, DUSUN TIMUR, BARITO TIMUR, KALIMANTAN TENGAH",3,127,14,141
https://kawalpemilu.org#85412,"MATARAH, DUSUN TIMUR, BARITO TIMUR, KALIMANTAN TENGAH",4,127,10,137
https://kawalpemilu.org#85413,"MARAGUT, DUSUN TIMUR, BARITO TIMUR, KALIMANTAN TENGAH",1,77,137,214
https://kawalpemilu.org#85413,"MARAGUT, DUSUN TIMUR, BARITO TIMUR, KALIMANTAN TENGAH",2,30,188,218
https://kawalpemilu.org#85414,"MANGKARAP, DUSUN TIMUR, BARITO TIMUR, KALIMANTAN TENGAH",1,141,21,162
https://kawalpemilu.org#85414,"MANGKARAP, DUSUN TIMUR, BARITO TIMUR, KALIMANTAN TENGAH",2,150,23,173
https://kawalpemilu.org#85415,"GUMPA, DUSUN TIMUR, BARITO TIMUR, KALIMANTAN TENGAH",1,154,15,169
https://kawalpemilu.org#85415,"GUMPA, DUSUN TIMUR, BARITO TIMUR, KALIMANTAN TENGAH",2,165,8,173
https://kawalpemilu.org#85415,"GUMPA, DUSUN TIMUR, BARITO TIMUR, KALIMANTAN TENGAH",3,142,27,169
https://kawalpemilu.org#85416,"HARARA, DUSUN TIMUR, BARITO TIMUR, KALIMANTAN TENGAH",1,85,12,97
https://kawalpemilu.org#88160,"SUMUR, DUSUN TIMUR, BARITO TIMUR, KALIMANTAN TENGAH",1,155,22,177
https://kawalpemilu.org#88160,"SUMUR, DUSUN TIMUR, BARITO TIMUR, KALIMANTAN TENGAH",2,120,17,137
https://kawalpemilu.org#61860,"TANIRAN, BENUA LIMA, BARITO TIMUR, KALIMANTAN TENGAH",1,148,90,238
https://kawalpemilu.org#61860,"TANIRAN, BENUA LIMA, BARITO TIMUR, KALIMANTAN TENGAH",2,232,30,262
https://kawalpemilu.org#61860,"TANIRAN, BENUA LIMA, BARITO TIMUR, KALIMANTAN TENGAH",3,151,68,219
https://kawalpemilu.org#61860,"TANIRAN, BENUA LIMA, BARITO TIMUR, KALIMANTAN TENGAH",4,152,78,230
https://kawalpemilu.org#61861,"KANDRIS, BENUA LIMA, BARITO TIMUR, KALIMANTAN TENGAH",1,18,152,170
https://kawalpemilu.org#61861,"KANDRIS, BENUA LIMA, BARITO TIMUR, KALIMANTAN TENGAH",2,11,117,128
https://kawalpemilu.org#61861,"KANDRIS, BENUA LIMA, BARITO TIMUR, KALIMANTAN TENGAH",3,21,137,158
https://kawalpemilu.org#61861,"KANDRIS, BENUA LIMA, BARITO TIMUR, KALIMANTAN TENGAH",4,28,125,153
https://kawalpemilu.org#61861,"KANDRIS, BENUA LIMA, BARITO TIMUR, KALIMANTAN TENGAH",5,30,123,153
https://kawalpemilu.org#61861,"KANDRIS, BENUA LIMA, BARITO TIMUR, KALIMANTAN TENGAH",6,35,112,147
https://kawalpemilu.org#61862,"BANYU LANDAS, BENUA LIMA, BARITO TIMUR, KALIMANTAN TENGAH",1,43,127,170
https://kawalpemilu.org#61862,"BANYU LANDAS, BENUA LIMA, BARITO TIMUR, KALIMANTAN TENGAH",2,107,94,201
https://kawalpemilu.org#61863,"BAGOK, BENUA LIMA, BARITO TIMUR, KALIMANTAN TENGAH",1,233,15,248
https://kawalpemilu.org#61863,"BAGOK, BENUA LIMA, BARITO TIMUR, KALIMANTAN TENGAH",2,79,52,131
https://kawalpemilu.org#61864,"BAMBAN, BENUA LIMA, BARITO TIMUR, KALIMANTAN TENGAH",1,167,24,191
https://kawalpemilu.org#61864,"BAMBAN, BENUA LIMA, BARITO TIMUR, KALIMANTAN TENGAH",2,202,24,226
https://kawalpemilu.org#61864,"BAMBAN, BENUA LIMA, BARITO TIMUR, KALIMANTAN TENGAH",3,218,16,234
https://kawalpemilu.org#61865,"TEWAH PUPUH, BENUA LIMA, BARITO TIMUR, KALIMANTAN TENGAH",1,176,26,202
https://kawalpemilu.org#61865,"TEWAH PUPUH, BENUA LIMA, BARITO TIMUR, KALIMANTAN TENGAH",3,209,39,248
https://kawalpemilu.org#88161,"GUDANG SENG, BENUA LIMA, BARITO TIMUR, KALIMANTAN TENGAH",1,30,40,70
https://kawalpemilu.org#61867,"PULAU PANDANG, PATANGKEP TUTUI, BARITO TIMUR, KALIMANTAN TENGAH",1,111,31,142
https://kawalpemilu.org#61867,"PULAU PANDANG, PATANGKEP TUTUI, BARITO TIMUR, KALIMANTAN TENGAH",2,159,19,178
https://kawalpemilu.org#61868,"KAMBITIN, PATANGKEP TUTUI, BARITO TIMUR, KALIMANTAN TENGAH",1,107,111,218
https://kawalpemilu.org#61869,"RAMANIA, PATANGKEP TUTUI, BARITO TIMUR, KALIMANTAN TENGAH",1,25,128,153
https://kawalpemilu.org#61869,"RAMANIA, PATANGKEP TUTUI, BARITO TIMUR, KALIMANTAN TENGAH",2,69,104,173
https://kawalpemilu.org#61870,"BENTOT, PATANGKEP TUTUI, BARITO TIMUR, KALIMANTAN TENGAH",1,168,81,249
https://kawalpemilu.org#61870,"BENTOT, PATANGKEP TUTUI, BARITO TIMUR, KALIMANTAN TENGAH",2,130,38,168
https://kawalpemilu.org#61870,"BENTOT, PATANGKEP TUTUI, BARITO TIMUR, KALIMANTAN TENGAH",3,136,14,150
https://kawalpemilu.org#61870,"BENTOT, PATANGKEP TUTUI, BARITO TIMUR, KALIMANTAN TENGAH",4,128,23,151
https://kawalpemilu.org#61870,"BENTOT, PATANGKEP TUTUI, BARITO TIMUR, KALIMANTAN TENGAH",5,123,11,134
https://kawalpemilu.org#61870,"BENTOT, PATANGKEP TUTUI, BARITO TIMUR, KALIMANTAN TENGAH",6,145,47,192
https://kawalpemilu.org#61870,"BENTOT, PATANGKEP TUTUI, BARITO TIMUR, KALIMANTAN TENGAH",7,158,49,207
https://kawalpemilu.org#61871,"AMPARI BURA, PATANGKEP TUTUI, BARITO TIMUR, KALIMANTAN TENGAH",1,118,5,123
https://kawalpemilu.org#61871,"AMPARI BURA, PATANGKEP TUTUI, BARITO TIMUR, KALIMANTAN TENGAH",2,198,62,260
https://kawalpemilu.org#61871,"AMPARI BURA, PATANGKEP TUTUI, BARITO TIMUR, KALIMANTAN TENGAH",3,127,27,154
https://kawalpemilu.org#61872,"KOTAM, PATANGKEP TUTUI, BARITO TIMUR, KALIMANTAN TENGAH",1,196,36,232
https://kawalpemilu.org#61872,"KOTAM, PATANGKEP TUTUI, BARITO TIMUR, KALIMANTAN TENGAH",2,99,24,123
https://kawalpemilu.org#85417,"BETANG NALONG, PATANGKEP TUTUI, BARITO TIMUR, KALIMANTAN TENGAH",1,156,34,190
https://kawalpemilu.org#85418,"MAWANI, PATANGKEP TUTUI, BARITO TIMUR, KALIMANTAN TENGAH",1,56,50,106
https://kawalpemilu.org#85419,"JANGO, PATANGKEP TUTUI, BARITO TIMUR, KALIMANTAN TENGAH",1,80,79,159
https://kawalpemilu.org#85419,"JANGO, PATANGKEP TUTUI, BARITO TIMUR, KALIMANTAN TENGAH",2,56,69,125
https://kawalpemilu.org#85420,"LALAP, PATANGKEP TUTUI, BARITO TIMUR, KALIMANTAN TENGAH",1,213,24,237
https://kawalpemilu.org#61875,"JANAH JARI, AWANG, BARITO TIMUR, KALIMANTAN TENGAH",1,218,14,232
https://kawalpemilu.org#61875,"JANAH JARI, AWANG, BARITO TIMUR, KALIMANTAN TENGAH",2,156,19,175
https://kawalpemilu.org#61875,"JANAH JARI, AWANG, BARITO TIMUR, KALIMANTAN TENGAH",3,86,8,94
https://kawalpemilu.org#61876,"BANGKIRAYEN, AWANG, BARITO TIMUR, KALIMANTAN TENGAH",1,189,24,213
https://kawalpemilu.org#61876,"BANGKIRAYEN, AWANG, BARITO TIMUR, KALIMANTAN TENGAH",2,189,49,238
https://kawalpemilu.org#61877,"HAYAPING, AWANG, BARITO TIMUR, KALIMANTAN TENGAH",1,151,38,189
https://kawalpemilu.org#61877,"HAYAPING, AWANG, BARITO TIMUR, KALIMANTAN TENGAH",2,231,21,252
https://kawalpemilu.org#61877,"HAYAPING, AWANG, BARITO TIMUR, KALIMANTAN TENGAH",3,195,36,231
https://kawalpemilu.org#61877,"HAYAPING, AWANG, BARITO TIMUR, KALIMANTAN TENGAH",4,212,22,234
https://kawalpemilu.org#61878,"TANGKAN, AWANG, BARITO TIMUR, KALIMANTAN TENGAH",1,178,22,200
https://kawalpemilu.org#61878,"TANGKAN, AWANG, BARITO TIMUR, KALIMANTAN TENGAH",2,136,42,178
https://kawalpemilu.org#61879,"WUNGKUR NANAKAN, AWANG, BARITO TIMUR, KALIMANTAN TENGAH",1,97,135,232
https://kawalpemilu.org#61879,"WUNGKUR NANAKAN, AWANG, BARITO TIMUR, KALIMANTAN TENGAH",2,65,12,77
https://kawalpemilu.org#61880,"AMPARI, AWANG, BARITO TIMUR, KALIMANTAN TENGAH",1,149,14,163
https://kawalpemilu.org#61880,"AMPARI, AWANG, BARITO TIMUR, KALIMANTAN TENGAH",2,81,9,90
https://kawalpemilu.org#61881,"APAR BATU, AWANG, BARITO TIMUR, KALIMANTAN TENGAH",1,252,9,261
https://kawalpemilu.org#61881,"APAR BATU, AWANG, BARITO TIMUR, KALIMANTAN TENGAH",2,72,1,73
https://kawalpemilu.org#61882,"BIWAN, AWANG, BARITO TIMUR, KALIMANTAN TENGAH",1,161,25,186
https://kawalpemilu.org#88162,"DANAU, AWANG, BARITO TIMUR, KALIMANTAN TENGAH",1,224,13,237
https://kawalpemilu.org#88163,"PIANGGU, AWANG, BARITO TIMUR, KALIMANTAN TENGAH",1,173,9,182
https://kawalpemilu.org#61884,"AMPAH KOTA, DUSUN TENGAH, BARITO TIMUR, KALIMANTAN TENGAH",1,84,77,161
https://kawalpemilu.org#61884,"AMPAH KOTA, DUSUN TENGAH, BARITO TIMUR, KALIMANTAN TENGAH",2,20,17,37
https://kawalpemilu.org#61884,"AMPAH KOTA, DUSUN TENGAH, BARITO TIMUR, KALIMANTAN TENGAH",3,65,92,157
https://kawalpemilu.org#61884,"AMPAH KOTA, DUSUN TENGAH, BARITO TIMUR, KALIMANTAN TENGAH",5,147,85,232
https://kawalpemilu.org#61884,"AMPAH KOTA, DUSUN TENGAH, BARITO TIMUR, KALIMANTAN TENGAH",6,226,32,258
https://kawalpemilu.org#61884,"AMPAH KOTA, DUSUN TENGAH, BARITO TIMUR, KALIMANTAN TENGAH",7,84,80,164
https://kawalpemilu.org#61884,"AMPAH KOTA, DUSUN TENGAH, BARITO TIMUR, KALIMANTAN TENGAH",8,130,90,220
https://kawalpemilu.org#61884,"AMPAH KOTA, DUSUN TENGAH, BARITO TIMUR, KALIMANTAN TENGAH",9,66,64,130
https://kawalpemilu.org#61884,"AMPAH KOTA, DUSUN TENGAH, BARITO TIMUR, KALIMANTAN TENGAH",10,59,74,133
https://kawalpemilu.org#61884,"AMPAH KOTA, DUSUN TENGAH, BARITO TIMUR, KALIMANTAN TENGAH",11,55,160,215
https://kawalpemilu.org#61884,"AMPAH KOTA, DUSUN TENGAH, BARITO TIMUR, KALIMANTAN TENGAH",12,40,106,146
https://kawalpemilu.org#61884,"AMPAH KOTA, DUSUN TENGAH, BARITO TIMUR, KALIMANTAN TENGAH",14,56,116,172
https://kawalpemilu.org#61884,"AMPAH KOTA, DUSUN TENGAH, BARITO TIMUR, KALIMANTAN TENGAH",15,54,141,195
https://kawalpemilu.org#61884,"AMPAH KOTA, DUSUN TENGAH, BARITO TIMUR, KALIMANTAN TENGAH",16,54,139,193
https://kawalpemilu.org#61884,"AMPAH KOTA, DUSUN TENGAH, BARITO TIMUR, KALIMANTAN TENGAH",17,53,125,178
https://kawalpemilu.org#61884,"AMPAH KOTA, DUSUN TENGAH, BARITO TIMUR, KALIMANTAN TENGAH",18,69,68,137
https://kawalpemilu.org#61884,"AMPAH KOTA, DUSUN TENGAH, BARITO TIMUR, KALIMANTAN TENGAH",19,59,83,142
https://kawalpemilu.org#61884,"AMPAH KOTA, DUSUN TENGAH, BARITO TIMUR, KALIMANTAN TENGAH",20,74,83,157
https://kawalpemilu.org#61884,"AMPAH KOTA, DUSUN TENGAH, BARITO TIMUR, KALIMANTAN TENGAH",21,104,88,192
https://kawalpemilu.org#61884,"AMPAH KOTA, DUSUN TENGAH, BARITO TIMUR, KALIMANTAN TENGAH",22,121,76,197
https://kawalpemilu.org#61884,"AMPAH KOTA, DUSUN TENGAH, BARITO TIMUR, KALIMANTAN TENGAH",23,111,110,221
https://kawalpemilu.org#61884,"AMPAH KOTA, DUSUN TENGAH, BARITO TIMUR, KALIMANTAN TENGAH",24,89,35,124
https://kawalpemilu.org#61884,"AMPAH KOTA, DUSUN TENGAH, BARITO TIMUR, KALIMANTAN TENGAH",25,78,38,116
https://kawalpemilu.org#61884,"AMPAH KOTA, DUSUN TENGAH, BARITO TIMUR, KALIMANTAN TENGAH",26,70,48,118
https://kawalpemilu.org#61884,"AMPAH KOTA, DUSUN TENGAH, BARITO TIMUR, KALIMANTAN TENGAH",27,55,94,149
https://kawalpemilu.org#61884,"AMPAH KOTA, DUSUN TENGAH, BARITO TIMUR, KALIMANTAN TENGAH",28,58,92,150
https://kawalpemilu.org#61884,"AMPAH KOTA, DUSUN TENGAH, BARITO TIMUR, KALIMANTAN TENGAH",29,109,113,222
https://kawalpemilu.org#61884,"AMPAH KOTA, DUSUN TENGAH, BARITO TIMUR, KALIMANTAN TENGAH",30,129,100,229
https://kawalpemilu.org#61884,"AMPAH KOTA, DUSUN TENGAH, BARITO TIMUR, KALIMANTAN TENGAH",31,20,88,108
https://kawalpemilu.org#61884,"AMPAH KOTA, DUSUN TENGAH, BARITO TIMUR, KALIMANTAN TENGAH",32,27,79,110
https://kawalpemilu.org#61884,"AMPAH KOTA, DUSUN TENGAH, BARITO TIMUR, KALIMANTAN TENGAH",33,52,62,114
https://kawalpemilu.org#61884,"AMPAH KOTA, DUSUN TENGAH, BARITO TIMUR, KALIMANTAN TENGAH",34,60,54,114
https://kawalpemilu.org#61884,"AMPAH KOTA, DUSUN TENGAH, BARITO TIMUR, KALIMANTAN TENGAH",35,50,86,136
https://kawalpemilu.org#61884,"AMPAH KOTA, DUSUN TENGAH, BARITO TIMUR, KALIMANTAN TENGAH",36,51,59,110
https://kawalpemilu.org#61884,"AMPAH KOTA, DUSUN TENGAH, BARITO TIMUR, KALIMANTAN TENGAH",37,69,123,192
https://kawalpemilu.org#61884,"AMPAH KOTA, DUSUN TENGAH, BARITO TIMUR, KALIMANTAN TENGAH",38,74,87,161
https://kawalpemilu.org#61884,"AMPAH KOTA, DUSUN TENGAH, BARITO TIMUR, KALIMANTAN TENGAH",39,62,56,118
https://kawalpemilu.org#61884,"AMPAH KOTA, DUSUN TENGAH, BARITO TIMUR, KALIMANTAN TENGAH",40,78,54,132
https://kawalpemilu.org#61884,"AMPAH KOTA, DUSUN TENGAH, BARITO TIMUR, KALIMANTAN TENGAH",41,74,59,133
https://kawalpemilu.org#61884,"AMPAH KOTA, DUSUN TENGAH, BARITO TIMUR, KALIMANTAN TENGAH",42,91,68,159
https://kawalpemilu.org#61884,"AMPAH KOTA, DUSUN TENGAH, BARITO TIMUR, KALIMANTAN TENGAH",43,57,132,189
https://kawalpemilu.org#61884,"AMPAH KOTA, DUSUN TENGAH, BARITO TIMUR, KALIMANTAN TENGAH",44,83,104,187
https://kawalpemilu.org#61884,"AMPAH KOTA, DUSUN TENGAH, BARITO TIMUR, KALIMANTAN TENGAH",45,16,131,147
https://kawalpemilu.org#61884,"AMPAH KOTA, DUSUN TENGAH, BARITO TIMUR, KALIMANTAN TENGAH",46,18,127,145
https://kawalpemilu.org#61884,"AMPAH KOTA, DUSUN TENGAH, BARITO TIMUR, KALIMANTAN TENGAH",47,82,125,207
https://kawalpemilu.org#61884,"AMPAH KOTA, DUSUN TENGAH, BARITO TIMUR, KALIMANTAN TENGAH",49,149,59,208
https://kawalpemilu.org#61884,"AMPAH KOTA, DUSUN TENGAH, BARITO TIMUR, KALIMANTAN TENGAH",51,60,104,164
https://kawalpemilu.org#61884,"AMPAH KOTA, DUSUN TENGAH, BARITO TIMUR, KALIMANTAN TENGAH",52,40,110,150
https://kawalpemilu.org#61884,"AMPAH KOTA, DUSUN TENGAH, BARITO TIMUR, KALIMANTAN TENGAH",53,43,124,167
https://kawalpemilu.org#61884,"AMPAH KOTA, DUSUN TENGAH, BARITO TIMUR, KALIMANTAN TENGAH",54,35,98,133
https://kawalpemilu.org#61884,"AMPAH KOTA, DUSUN TENGAH, BARITO TIMUR, KALIMANTAN TENGAH",55,105,57,162
https://kawalpemilu.org#61884,"AMPAH KOTA, DUSUN TENGAH, BARITO TIMUR, KALIMANTAN TENGAH",56,80,45,125
https://kawalpemilu.org#61885,"SAING, DUSUN TENGAH, BARITO TIMUR, KALIMANTAN TENGAH",1,221,27,248
https://kawalpemilu.org#61885,"SAING, DUSUN TENGAH, BARITO TIMUR, KALIMANTAN TENGAH",2,228,11,239
https://kawalpemilu.org#61886,"RODOK, DUSUN TENGAH, BARITO TIMUR, KALIMANTAN TENGAH",1,106,99,205
https://kawalpemilu.org#61886,"RODOK, DUSUN TENGAH, BARITO TIMUR, KALIMANTAN TENGAH",2,126,69,195
https://kawalpemilu.org#61886,"RODOK, DUSUN TENGAH, BARITO TIMUR, KALIMANTAN TENGAH",3,110,54,164
https://kawalpemilu.org#61886,"RODOK, DUSUN TENGAH, BARITO TIMUR, KALIMANTAN TENGAH",4,156,48,204
https://kawalpemilu.org#61886,"RODOK, DUSUN TENGAH, BARITO TIMUR, KALIMANTAN TENGAH",5,176,33,206
https://kawalpemilu.org#61887,"AMPAH II, DUSUN TENGAH, BARITO TIMUR, KALIMANTAN TENGAH",1,73,146,219
https://kawalpemilu.org#61887,"AMPAH II, DUSUN TENGAH, BARITO TIMUR, KALIMANTAN TENGAH",2,32,128,160
https://kawalpemilu.org#61888,"PUTAI, DUSUN TENGAH, BARITO TIMUR, KALIMANTAN TENGAH",1,65,145,210
https://kawalpemilu.org#61888,"PUTAI, DUSUN TENGAH, BARITO TIMUR, KALIMANTAN TENGAH",2,49,144,193
https://kawalpemilu.org#61888,"PUTAI, DUSUN TENGAH, BARITO TIMUR, KALIMANTAN TENGAH",3,64,144,208
https://kawalpemilu.org#61888,"PUTAI, DUSUN TENGAH, BARITO TIMUR, KALIMANTAN TENGAH",4,52,139,191
https://kawalpemilu.org#61888,"PUTAI, DUSUN TENGAH, BARITO TIMUR, KALIMANTAN TENGAH",5,56,135,191
https://kawalpemilu.org#61888,"PUTAI, DUSUN TENGAH, BARITO TIMUR, KALIMANTAN TENGAH",6,87,103,190
https://kawalpemilu.org#61889,"NETAMPIN, DUSUN TENGAH, BARITO TIMUR, KALIMANTAN TENGAH",1,122,98,220
https://kawalpemilu.org#61889,"NETAMPIN, DUSUN TENGAH, BARITO TIMUR, KALIMANTAN TENGAH",2,104,89,193
https://kawalpemilu.org#61889,"NETAMPIN, DUSUN TENGAH, BARITO TIMUR, KALIMANTAN TENGAH",3,101,54,155
https://kawalpemilu.org#61889,"NETAMPIN, DUSUN TENGAH, BARITO TIMUR, KALIMANTAN TENGAH",4,89,42,131
https://kawalpemilu.org#85422,"SUMBER GARUNGGUNG, DUSUN TENGAH, BARITO TIMUR, KALIMANTAN TENGAH",1,140,26,166
https://kawalpemilu.org#85422,"SUMBER GARUNGGUNG, DUSUN TENGAH, BARITO TIMUR, KALIMANTAN TENGAH",2,123,26,149
https://kawalpemilu.org#85422,"SUMBER GARUNGGUNG, DUSUN TENGAH, BARITO TIMUR, KALIMANTAN TENGAH",3,158,45,203
https://kawalpemilu.org#85422,"SUMBER GARUNGGUNG, DUSUN TENGAH, BARITO TIMUR, KALIMANTAN TENGAH",4,167,21,188
https://kawalpemilu.org#85422,"SUMBER GARUNGGUNG, DUSUN TENGAH, BARITO TIMUR, KALIMANTAN TENGAH",5,66,11,77
https://kawalpemilu.org#85423,"MUARA AWANG, DUSUN TENGAH, BARITO TIMUR, KALIMANTAN TENGAH",1,84,48,132
https://kawalpemilu.org#85423,"MUARA AWANG, DUSUN TENGAH, BARITO TIMUR, KALIMANTAN TENGAH",2,102,60,162
https://kawalpemilu.org#85423,"MUARA AWANG, DUSUN TENGAH, BARITO TIMUR, KALIMANTAN TENGAH",3,85,51,136
https://kawalpemilu.org#931209,"DAMBUNG, DUSUN TENGAH, BARITO TIMUR, KALIMANTAN TENGAH",1,96,16,112
https://kawalpemilu.org#61891,"MUARA PLANTAU, PEMATANG KARAU, BARITO TIMUR, KALIMANTAN TENGAH",1,31,197,228
https://kawalpemilu.org#61891,"MUARA PLANTAU, PEMATANG KARAU, BARITO TIMUR, KALIMANTAN TENGAH",2,15,170,185
https://kawalpemilu.org#61891,"MUARA PLANTAU, PEMATANG KARAU, BARITO TIMUR, KALIMANTAN TENGAH",3,31,139,170
https://kawalpemilu.org#61891,"MUARA PLANTAU, PEMATANG KARAU, BARITO TIMUR, KALIMANTAN TENGAH",4,35,126,161
https://kawalpemilu.org#61891,"MUARA PLANTAU, PEMATANG KARAU, BARITO TIMUR, KALIMANTAN TENGAH",5,28,113,141
https://kawalpemilu.org#61892,"KETAB, PEMATANG KARAU, BARITO TIMUR, KALIMANTAN TENGAH",1,50,105,155
https://kawalpemilu.org#61892,"KETAB, PEMATANG KARAU, BARITO TIMUR, KALIMANTAN TENGAH",2,51,127,178
https://kawalpemilu.org#61892,"KETAB, PEMATANG KARAU, BARITO TIMUR, KALIMANTAN TENGAH",3,34,107,141
https://kawalpemilu.org#61892,"KETAB, PEMATANG KARAU, BARITO TIMUR, KALIMANTAN TENGAH",4,50,162,212
https://kawalpemilu.org#61893,"KUPANG BERSIH, PEMATANG KARAU, BARITO TIMUR, KALIMANTAN TENGAH",1,160,52,212
https://kawalpemilu.org#61893,"KUPANG BERSIH, PEMATANG KARAU, BARITO TIMUR, KALIMANTAN TENGAH",2,71,145,216
https://kawalpemilu.org#61893,"KUPANG BERSIH, PEMATANG KARAU, BARITO TIMUR, KALIMANTAN TENGAH",3,56,203,259
https://kawalpemilu.org#61894,"TUYAU, PEMATANG KARAU, BARITO TIMUR, KALIMANTAN TENGAH",1,48,196,244
https://kawalpemilu.org#61894,"TUYAU, PEMATANG KARAU, BARITO TIMUR, KALIMANTAN TENGAH",2,26,218,244
https://kawalpemilu.org#61894,"TUYAU, PEMATANG KARAU, BARITO TIMUR, KALIMANTAN TENGAH",3,32,229,261
https://kawalpemilu.org#61894,"TUYAU, PEMATANG KARAU, BARITO TIMUR, KALIMANTAN TENGAH",4,39,215,254
https://kawalpemilu.org#61895,"PINANG TUNGGAL, PEMATANG KARAU, BARITO TIMUR, KALIMANTAN TENGAH",1,122,21,143
https://kawalpemilu.org#61895,"PINANG TUNGGAL, PEMATANG KARAU, BARITO TIMUR, KALIMANTAN TENGAH",2,91,19,110
https://kawalpemilu.org#61896,"NAGALEAH, PEMATANG KARAU, BARITO TIMUR, KALIMANTAN TENGAH",1,47,139,186
https://kawalpemilu.org#61896,"NAGALEAH, PEMATANG KARAU, BARITO TIMUR, KALIMANTAN TENGAH",2,31,192,223
https://kawalpemilu.org#61897,"LAMPEONG, PEMATANG KARAU, BARITO TIMUR, KALIMANTAN TENGAH",1,73,79,152
https://kawalpemilu.org#61897,"LAMPEONG, PEMATANG KARAU, BARITO TIMUR, KALIMANTAN TENGAH",2,49,104,153
https://kawalpemilu.org#61897,"LAMPEONG, PEMATANG KARAU, BARITO TIMUR, KALIMANTAN TENGAH",3,75,58,133
https://kawalpemilu.org#61897,"LAMPEONG, PEMATANG KARAU, BARITO TIMUR, KALIMANTAN TENGAH",4,72,66,138
https://kawalpemilu.org#61898,"BARARAWA, PEMATANG KARAU, BARITO TIMUR, KALIMANTAN TENGAH",1,101,105,206
https://kawalpemilu.org#61898,"BARARAWA, PEMATANG KARAU, BARITO TIMUR, KALIMANTAN TENGAH",2,43,153,196
https://kawalpemilu.org#61899,"BAMBULUNG, PEMATANG KARAU, BARITO TIMUR, KALIMANTAN TENGAH",1,88,26,114
https://kawalpemilu.org#61899,"BAMBULUNG, PEMATANG KARAU, BARITO TIMUR, KALIMANTAN TENGAH",2,93,35,128
https://kawalpemilu.org#61899,"BAMBULUNG, PEMATANG KARAU, BARITO TIMUR, KALIMANTAN TENGAH",3,135,31,166
https://kawalpemilu.org#61899,"BAMBULUNG, PEMATANG KARAU, BARITO TIMUR, KALIMANTAN TENGAH",4,106,89,195
https://kawalpemilu.org#61899,"BAMBULUNG, PEMATANG KARAU, BARITO TIMUR, KALIMANTAN TENGAH",5,73,85,158
https://kawalpemilu.org#61899,"BAMBULUNG, PEMATANG KARAU, BARITO TIMUR, KALIMANTAN TENGAH",6,80,140,220
https://kawalpemilu.org#61899,"BAMBULUNG, PEMATANG KARAU, BARITO TIMUR, KALIMANTAN TENGAH",7,219,33,252
https://kawalpemilu.org#61899,"BAMBULUNG, PEMATANG KARAU, BARITO TIMUR, KALIMANTAN TENGAH",8,146,29,175
https://kawalpemilu.org#61900,"LEBO, PEMATANG KARAU, BARITO TIMUR, KALIMANTAN TENGAH",1,170,50,220
https://kawalpemilu.org#61900,"LEBO, PEMATANG KARAU, BARITO TIMUR, KALIMANTAN TENGAH",2,179,28,207
https://kawalpemilu.org#85424,"MURU DUYUNG, PEMATANG KARAU, BARITO TIMUR, KALIMANTAN TENGAH",1,157,14,171
https://kawalpemilu.org#85425,"TUMPUNG ULUNG, PEMATANG KARAU, BARITO TIMUR, KALIMANTAN TENGAH",1,51,90,141
https://kawalpemilu.org#85425,"TUMPUNG ULUNG, PEMATANG KARAU, BARITO TIMUR, KALIMANTAN TENGAH",2,28,102,130
https://kawalpemilu.org#85425,"TUMPUNG ULUNG, PEMATANG KARAU, BARITO TIMUR, KALIMANTAN TENGAH",3,49,62,111
https://kawalpemilu.org#85425,"TUMPUNG ULUNG, PEMATANG KARAU, BARITO TIMUR, KALIMANTAN TENGAH",4,44,69,113
https://kawalpemilu.org#88164,"SUMBEREJO, PEMATANG KARAU, BARITO TIMUR, KALIMANTAN TENGAH",1,111,62,173
https://kawalpemilu.org#88164,"SUMBEREJO, PEMATANG KARAU, BARITO TIMUR, KALIMANTAN TENGAH",2,78,38,116
https://kawalpemilu.org#88164,"SUMBEREJO, PEMATANG KARAU, BARITO TIMUR, KALIMANTAN TENGAH",3,129,60,189
https://kawalpemilu.org#61902,"JURU BANU, PAJU EPAT, BARITO TIMUR, KALIMANTAN TENGAH",1,48,156,204
https://kawalpemilu.org#61902,"JURU BANU, PAJU EPAT, BARITO TIMUR, KALIMANTAN TENGAH",2,27,79,106
https://kawalpemilu.org#61903,"TELANG BARU, PAJU EPAT, BARITO TIMUR, KALIMANTAN TENGAH",1,56,156,212
https://kawalpemilu.org#61903,"TELANG BARU, PAJU EPAT, BARITO TIMUR, KALIMANTAN TENGAH",2,98,100,198
https://kawalpemilu.org#61903,"TELANG BARU, PAJU EPAT, BARITO TIMUR, KALIMANTAN TENGAH",3,62,153,215
https://kawalpemilu.org#61904,"TAMPU LANGIT, PAJU EPAT, BARITO TIMUR, KALIMANTAN TENGAH",1,83,84,167
https://kawalpemilu.org#61904,"TAMPU LANGIT, PAJU EPAT, BARITO TIMUR, KALIMANTAN TENGAH",2,108,62,170
https://kawalpemilu.org#61905,"TELANG, PAJU EPAT, BARITO TIMUR, KALIMANTAN TENGAH",1,162,24,186
https://kawalpemilu.org#61906,"MAIPE, PAJU EPAT, BARITO TIMUR, KALIMANTAN TENGAH",1,89,43,132
https://kawalpemilu.org#61907,"MURUTUWU, PAJU EPAT, BARITO TIMUR, KALIMANTAN TENGAH",1,112,36,148
https://kawalpemilu.org#61907,"MURUTUWU, PAJU EPAT, BARITO TIMUR, KALIMANTAN TENGAH",2,134,13,147
https://kawalpemilu.org#61907,"MURUTUWU, PAJU EPAT, BARITO TIMUR, KALIMANTAN TENGAH",3,156,7,163
https://kawalpemilu.org#61907,"MURUTUWU, PAJU EPAT, BARITO TIMUR, KALIMANTAN TENGAH",4,123,17,140
https://kawalpemilu.org#61908,"BALAWA, PAJU EPAT, BARITO TIMUR, KALIMANTAN TENGAH",1,174,50,224
https://kawalpemilu.org#61908,"BALAWA, PAJU EPAT, BARITO TIMUR, KALIMANTAN TENGAH",2,183,13,196
https://kawalpemilu.org#61908,"BALAWA, PAJU EPAT, BARITO TIMUR, KALIMANTAN TENGAH",3,103,10,113
https://kawalpemilu.org#61908,"BALAWA, PAJU EPAT, BARITO TIMUR, KALIMANTAN TENGAH",4,97,5,102
https://kawalpemilu.org#85426,"KALI NAPU, PAJU EPAT, BARITO TIMUR, KALIMANTAN TENGAH",1,50,103,153
https://kawalpemilu.org#85427,"SIONG, PAJU EPAT, BARITO TIMUR, KALIMANTAN TENGAH",1,149,20,169
https://kawalpemilu.org#85427,"SIONG, PAJU EPAT, BARITO TIMUR, KALIMANTAN TENGAH",2,122,32,154
https://kawalpemilu.org#85427,"SIONG, PAJU EPAT, BARITO TIMUR, KALIMANTAN TENGAH",3,122,28,150
https://kawalpemilu.org#61910,"PURI, RAREN BATUAH, BARITO TIMUR, KALIMANTAN TENGAH",1,155,72,227
https://kawalpemilu.org#61910,"PURI, RAREN BATUAH, BARITO TIMUR, KALIMANTAN TENGAH",2,140,131,271
https://kawalpemilu.org#61910,"PURI, RAREN BATUAH, BARITO TIMUR, KALIMANTAN TENGAH",3,61,167,228
https://kawalpemilu.org#61911,"LENGGANG, RAREN BATUAH, BARITO TIMUR, KALIMANTAN TENGAH",1,122,46,168
https://kawalpemilu.org#61911,"LENGGANG, RAREN BATUAH, BARITO TIMUR, KALIMANTAN TENGAH",2,149,54,203
https://kawalpemilu.org#61911,"LENGGANG, RAREN BATUAH, BARITO TIMUR, KALIMANTAN TENGAH",3,162,21,183
https://kawalpemilu.org#61911,"LENGGANG, RAREN BATUAH, BARITO TIMUR, KALIMANTAN TENGAH",4,153,30,183
https://kawalpemilu.org#61912,"BATUAH, RAREN BATUAH, BARITO TIMUR, KALIMANTAN TENGAH",1,106,33,139
https://kawalpemilu.org#61912,"BATUAH, RAREN BATUAH, BARITO TIMUR, KALIMANTAN TENGAH",2,98,56,154
https://kawalpemilu.org#61912,"BATUAH, RAREN BATUAH, BARITO TIMUR, KALIMANTAN TENGAH",3,55,56,111
https://kawalpemilu.org#61912,"BATUAH, RAREN BATUAH, BARITO TIMUR, KALIMANTAN TENGAH",4,65,53,118
https://kawalpemilu.org#61913,"UNSUM, RAREN BATUAH, BARITO TIMUR, KALIMANTAN TENGAH",1,199,31,230
https://kawalpemilu.org#61913,"UNSUM, RAREN BATUAH, BARITO TIMUR, KALIMANTAN TENGAH",2,122,28,150
https://kawalpemilu.org#61913,"UNSUM, RAREN BATUAH, BARITO TIMUR, KALIMANTAN TENGAH",3,122,29,151
https://kawalpemilu.org#61913,"UNSUM, RAREN BATUAH, BARITO TIMUR, KALIMANTAN TENGAH",4,157,35,192
https://kawalpemilu.org#61913,"UNSUM, RAREN BATUAH, BARITO TIMUR, KALIMANTAN TENGAH",5,90,39,129
https://kawalpemilu.org#61914,"BARUYAN, RAREN BATUAH, BARITO TIMUR, KALIMANTAN TENGAH",1,149,42,191
https://kawalpemilu.org#61914,"BARUYAN, RAREN BATUAH, BARITO TIMUR, KALIMANTAN TENGAH",2,83,63,146
https://kawalpemilu.org#85428,"TURAN AMIS, RAREN BATUAH, BARITO TIMUR, KALIMANTAN TENGAH",1,95,84,179
https://kawalpemilu.org#85428,"TURAN AMIS, RAREN BATUAH, BARITO TIMUR, KALIMANTAN TENGAH",2,99,80,179
https://kawalpemilu.org#85429,"MALINTUT, RAREN BATUAH, BARITO TIMUR, KALIMANTAN TENGAH",1,109,99,208
https://kawalpemilu.org#85429,"MALINTUT, RAREN BATUAH, BARITO TIMUR, KALIMANTAN TENGAH",2,117,86,203
https://kawalpemilu.org#85430,"TANGKUM, RAREN BATUAH, BARITO TIMUR, KALIMANTAN TENGAH",1,142,64,206
https://kawalpemilu.org#85430,"TANGKUM, RAREN BATUAH, BARITO TIMUR, KALIMANTAN TENGAH",2,126,85,211
https://kawalpemilu.org#85431,"SIBUNG, RAREN BATUAH, BARITO TIMUR, KALIMANTAN TENGAH",1,153,46,199
https://kawalpemilu.org#85431,"SIBUNG, RAREN BATUAH, BARITO TIMUR, KALIMANTAN TENGAH",2,144,48,192
https://kawalpemilu.org#85431,"SIBUNG, RAREN BATUAH, BARITO TIMUR, KALIMANTAN TENGAH",3,114,64,178
https://kawalpemilu.org#85431,"SIBUNG, RAREN BATUAH, BARITO TIMUR, KALIMANTAN TENGAH",4,132,50,182
https://kawalpemilu.org#61916,"TAMPA, PAKU, BARITO TIMUR, KALIMANTAN TENGAH",1,167,15,182
https://kawalpemilu.org#61916,"TAMPA, PAKU, BARITO TIMUR, KALIMANTAN TENGAH",2,210,21,231
https://kawalpemilu.org#61916,"TAMPA, PAKU, BARITO TIMUR, KALIMANTAN TENGAH",3,140,7,147
https://kawalpemilu.org#61916,"TAMPA, PAKU, BARITO TIMUR, KALIMANTAN TENGAH",4,140,10,150
https://kawalpemilu.org#61916,"TAMPA, PAKU, BARITO TIMUR, KALIMANTAN TENGAH",5,136,25,161
https://kawalpemilu.org#61917,"KALAMUS, PAKU, BARITO TIMUR, KALIMANTAN TENGAH",1,131,8,139
https://kawalpemilu.org#61917,"KALAMUS, PAKU, BARITO TIMUR, KALIMANTAN TENGAH",2,135,25,160
https://kawalpemilu.org#61917,"KALAMUS, PAKU, BARITO TIMUR, KALIMANTAN TENGAH",3,87,26,113
https://kawalpemilu.org#61917,"KALAMUS, PAKU, BARITO TIMUR, KALIMANTAN TENGAH",4,90,33,123
https://kawalpemilu.org#61917,"KALAMUS, PAKU, BARITO TIMUR, KALIMANTAN TENGAH",5,86,51,137
https://kawalpemilu.org#61917,"KALAMUS, PAKU, BARITO TIMUR, KALIMANTAN TENGAH",6,95,40,135
https://kawalpemilu.org#61917,"KALAMUS, PAKU, BARITO TIMUR, KALIMANTAN TENGAH",7,73,24,97
https://kawalpemilu.org#61918,"SIMPANG BANGKUANG, PAKU, BARITO TIMUR, KALIMANTAN TENGAH",1,143,31,174
https://kawalpemilu.org#61918,"SIMPANG BANGKUANG, PAKU, BARITO TIMUR, KALIMANTAN TENGAH",2,166,25,191
https://kawalpemilu.org#61919,"PATUNG, PAKU, BARITO TIMUR, KALIMANTAN TENGAH",1,133,12,145
https://kawalpemilu.org#61919,"PATUNG, PAKU, BARITO TIMUR, KALIMANTAN TENGAH",2,121,13,134
https://kawalpemilu.org#61919,"PATUNG, PAKU, BARITO TIMUR, KALIMANTAN TENGAH",3,120,18,138
https://kawalpemilu.org#61920,"RUNGGU RAYA, PAKU, BARITO TIMUR, KALIMANTAN TENGAH",1,148,15,163
https://kawalpemilu.org#61920,"RUNGGU RAYA, PAKU, BARITO TIMUR, KALIMANTAN TENGAH",2,100,18,118
https://kawalpemilu.org#61920,"RUNGGU RAYA, PAKU, BARITO TIMUR, KALIMANTAN TENGAH",3,166,16,182
https://kawalpemilu.org#85432,"BANTAI NAPU, PAKU, BARITO TIMUR, KALIMANTAN TENGAH",1,137,16,153
https://kawalpemilu.org#85432,"BANTAI NAPU, PAKU, BARITO TIMUR, KALIMANTAN TENGAH",2,125,22,147
https://kawalpemilu.org#85433,"TARINGSING, PAKU, BARITO TIMUR, KALIMANTAN TENGAH",1,112,8,120
https://kawalpemilu.org#85434,"PAKU BETO, PAKU, BARITO TIMUR, KALIMANTAN TENGAH",1,129,19,148
https://kawalpemilu.org#85434,"PAKU BETO, PAKU, BARITO TIMUR, KALIMANTAN TENGAH",2,125,14,139
https://kawalpemilu.org#85435,"GANDRUNG, PAKU, BARITO TIMUR, KALIMANTAN TENGAH",1,188,35,223
https://kawalpemilu.org#85435,"GANDRUNG, PAKU, BARITO TIMUR, KALIMANTAN TENGAH",2,112,13,125
https://kawalpemilu.org#85436,"PANGKAN, PAKU, BARITO TIMUR, KALIMANTAN TENGAH",1,188,29,217
https://kawalpemilu.org#85436,"PANGKAN, PAKU, BARITO TIMUR, KALIMANTAN TENGAH",2,120,29,149
https://kawalpemilu.org#85436,"PANGKAN, PAKU, BARITO TIMUR, KALIMANTAN TENGAH",3,100,23,123
https://kawalpemilu.org#85437,"LUAU JAWUK, PAKU, BARITO TIMUR, KALIMANTAN TENGAH",1,112,42,154
https://kawalpemilu.org#85437,"LUAU JAWUK, PAKU, BARITO TIMUR, KALIMANTAN TENGAH",2,131,32,163
https://kawalpemilu.org#88165,"KUPANG BARU, PAKU, BARITO TIMUR, KALIMANTAN TENGAH",1,198,10,208
https://kawalpemilu.org#88165,"KUPANG BARU, PAKU, BARITO TIMUR, KALIMANTAN TENGAH",2,194,5,199
https://kawalpemilu.org#61922,"DAYU, KARUSEN JANANG, BARITO TIMUR, KALIMANTAN TENGAH",1,142,21,163
https://kawalpemilu.org#61922,"DAYU, KARUSEN JANANG, BARITO TIMUR, KALIMANTAN TENGAH",2,101,11,112
https://kawalpemilu.org#61922,"DAYU, KARUSEN JANANG, BARITO TIMUR, KALIMANTAN TENGAH",3,190,18,208
https://kawalpemilu.org#61922,"DAYU, KARUSEN JANANG, BARITO TIMUR, KALIMANTAN TENGAH",4,131,25,156
https://kawalpemilu.org#61922,"DAYU, KARUSEN JANANG, BARITO TIMUR, KALIMANTAN TENGAH",5,144,22,166
https://kawalpemilu.org#61922,"DAYU, KARUSEN JANANG, BARITO TIMUR, KALIMANTAN TENGAH",6,127,18,145
https://kawalpemilu.org#61922,"DAYU, KARUSEN JANANG, BARITO TIMUR, KALIMANTAN TENGAH",7,9,17,26
https://kawalpemilu.org#61923,"WURAN, KARUSEN JANANG, BARITO TIMUR, KALIMANTAN TENGAH",1,109,9,118
https://kawalpemilu.org#61923,"WURAN, KARUSEN JANANG, BARITO TIMUR, KALIMANTAN TENGAH",2,119,5,124
https://kawalpemilu.org#61923,"WURAN, KARUSEN JANANG, BARITO TIMUR, KALIMANTAN TENGAH",3,117,14,131
https://kawalpemilu.org#61923,"WURAN, KARUSEN JANANG, BARITO TIMUR, KALIMANTAN TENGAH",4,186,15,201
https://kawalpemilu.org#61924,"IPU MEA, KARUSEN JANANG, BARITO TIMUR, KALIMANTAN TENGAH",1,125,9,134
https://kawalpemilu.org#61924,"IPU MEA, KARUSEN JANANG, BARITO TIMUR, KALIMANTAN TENGAH",2,148,9,157
https://kawalpemilu.org#61925,"LAGAN, KARUSEN JANANG, BARITO TIMUR, KALIMANTAN TENGAH",1,151,35,186
https://kawalpemilu.org#61925,"LAGAN, KARUSEN JANANG, BARITO TIMUR, KALIMANTAN TENGAH",2,128,83,211
https://kawalpemilu.org#61926,"PUTUT TAWULUH, KARUSEN JANANG, BARITO TIMUR, KALIMANTAN TENGAH",1,119,17,136
https://kawalpemilu.org#61927,"SIMPANG NANENG, KARUSEN JANANG, BARITO TIMUR, KALIMANTAN TENGAH",1,159,27,186
https://kawalpemilu.org#61927,"SIMPANG NANENG, KARUSEN JANANG, BARITO TIMUR, KALIMANTAN TENGAH",2,150,39,189
https://kawalpemilu.org#61928,"KANDRIS, KARUSEN JANANG, BARITO TIMUR, KALIMANTAN TENGAH",1,185,43,228
https://kawalpemilu.org#61931,"PAHANDUT, PAHANDUT, KOTA PALANGKARAYA, KALIMANTAN TENGAH",1,26,192,218
https://kawalpemilu.org#61931,"PAHANDUT, PAHANDUT, KOTA PALANGKARAYA, KALIMANTAN TENGAH",2,61,94,155
https://kawalpemilu.org#61931,"PAHANDUT, PAHANDUT, KOTA PALANGKARAYA, KALIMANTAN TENGAH",3,51,88,139
https://kawalpemilu.org#61931,"PAHANDUT, PAHANDUT, KOTA PALANGKARAYA, KALIMANTAN TENGAH",4,39,130,169
https://kawalpemilu.org#61931,"PAHANDUT, PAHANDUT, KOTA PALANGKARAYA, KALIMANTAN TENGAH",5,49,154,203
https://kawalpemilu.org#61931,"PAHANDUT, PAHANDUT, KOTA PALANGKARAYA, KALIMANTAN TENGAH",6,15,130,145
https://kawalpemilu.org#61931,"PAHANDUT, PAHANDUT, KOTA PALANGKARAYA, KALIMANTAN TENGAH",7,53,99,152
https://kawalpemilu.org#61931,"PAHANDUT, PAHANDUT, KOTA PALANGKARAYA, KALIMANTAN TENGAH",8,75,102,177
https://kawalpemilu.org#61931,"PAHANDUT, PAHANDUT, KOTA PALANGKARAYA, KALIMANTAN TENGAH",9,35,157,192
https://kawalpemilu.org#61931,"PAHANDUT, PAHANDUT, KOTA PALANGKARAYA, KALIMANTAN TENGAH",10,42,170,212
https://kawalpemilu.org#61931,"PAHANDUT, PAHANDUT, KOTA PALANGKARAYA, KALIMANTAN TENGAH",11,88,160,248
https://kawalpemilu.org#61931,"PAHANDUT, PAHANDUT, KOTA PALANGKARAYA, KALIMANTAN TENGAH",12,82,165,247
https://kawalpemilu.org#61931,"PAHANDUT, PAHANDUT, KOTA PALANGKARAYA, KALIMANTAN TENGAH",13,45,63,108
https://kawalpemilu.org#61931,"PAHANDUT, PAHANDUT, KOTA PALANGKARAYA, KALIMANTAN TENGAH",14,69,190,259
https://kawalpemilu.org#61931,"PAHANDUT, PAHANDUT, KOTA PALANGKARAYA, KALIMANTAN TENGAH",15,47,107,154
https://kawalpemilu.org#61931,"PAHANDUT, PAHANDUT, KOTA PALANGKARAYA, KALIMANTAN TENGAH",16,44,112,156
https://kawalpemilu.org#61931,"PAHANDUT, PAHANDUT, KOTA PALANGKARAYA, KALIMANTAN TENGAH",17,27,126,153
https://kawalpemilu.org#61931,"PAHANDUT, PAHANDUT, KOTA PALANGKARAYA, KALIMANTAN TENGAH",18,38,116,154
https://kawalpemilu.org#61931,"PAHANDUT, PAHANDUT, KOTA PALANGKARAYA, KALIMANTAN TENGAH",19,35,114,149
https://kawalpemilu.org#61931,"PAHANDUT, PAHANDUT, KOTA PALANGKARAYA, KALIMANTAN TENGAH",20,29,137,166
https://kawalpemilu.org#61931,"PAHANDUT, PAHANDUT, KOTA PALANGKARAYA, KALIMANTAN TENGAH",21,35,103,138
https://kawalpemilu.org#61931,"PAHANDUT, PAHANDUT, KOTA PALANGKARAYA, KALIMANTAN TENGAH",22,47,144,191
https://kawalpemilu.org#61931,"PAHANDUT, PAHANDUT, KOTA PALANGKARAYA, KALIMANTAN TENGAH",23,28,83,111
https://kawalpemilu.org#61931,"PAHANDUT, PAHANDUT, KOTA PALANGKARAYA, KALIMANTAN TENGAH",24,66,132,198
https://kawalpemilu.org#61931,"PAHANDUT, PAHANDUT, KOTA PALANGKARAYA, KALIMANTAN TENGAH",25,55,135,190
https://kawalpemilu.org#61931,"PAHANDUT, PAHANDUT, KOTA PALANGKARAYA, KALIMANTAN TENGAH",26,30,137,167
https://kawalpemilu.org#61931,"PAHANDUT, PAHANDUT, KOTA PALANGKARAYA, KALIMANTAN TENGAH",27,54,175,229
https://kawalpemilu.org#61931,"PAHANDUT, PAHANDUT, KOTA PALANGKARAYA, KALIMANTAN TENGAH",28,28,156,184
https://kawalpemilu.org#61931,"PAHANDUT, PAHANDUT, KOTA PALANGKARAYA, KALIMANTAN TENGAH",29,37,113,150
https://kawalpemilu.org#61931,"PAHANDUT, PAHANDUT, KOTA PALANGKARAYA, KALIMANTAN TENGAH",30,57,160,217
https://kawalpemilu.org#61931,"PAHANDUT, PAHANDUT, KOTA PALANGKARAYA, KALIMANTAN TENGAH",31,26,74,100
https://kawalpemilu.org#61931,"PAHANDUT, PAHANDUT, KOTA PALANGKARAYA, KALIMANTAN TENGAH",32,65,122,187
https://kawalpemilu.org#61931,"PAHANDUT, PAHANDUT, KOTA PALANGKARAYA, KALIMANTAN TENGAH",33,33,184,217
https://kawalpemilu.org#61931,"PAHANDUT, PAHANDUT, KOTA PALANGKARAYA, KALIMANTAN TENGAH",34,75,161,236
https://kawalpemilu.org#61931,"PAHANDUT, PAHANDUT, KOTA PALANGKARAYA, KALIMANTAN TENGAH",35,58,39,97
https://kawalpemilu.org#61931,"PAHANDUT, PAHANDUT, KOTA PALANGKARAYA, KALIMANTAN TENGAH",36,64,176,240
https://kawalpemilu.org#61931,"PAHANDUT, PAHANDUT, KOTA PALANGKARAYA, KALIMANTAN TENGAH",37,59,100,159
https://kawalpemilu.org#61931,"PAHANDUT, PAHANDUT, KOTA PALANGKARAYA, KALIMANTAN TENGAH",38,146,76,222
https://kawalpemilu.org#61931,"PAHANDUT, PAHANDUT, KOTA PALANGKARAYA, KALIMANTAN TENGAH",39,47,65,112
https://kawalpemilu.org#61931,"PAHANDUT, PAHANDUT, KOTA PALANGKARAYA, KALIMANTAN TENGAH",40,53,122,175
https://kawalpemilu.org#61931,"PAHANDUT, PAHANDUT, KOTA PALANGKARAYA, KALIMANTAN TENGAH",41,122,147,269
https://kawalpemilu.org#61931,"PAHANDUT, PAHANDUT, KOTA PALANGKARAYA, KALIMANTAN TENGAH",42,84,59,143
https://kawalpemilu.org#61931,"PAHANDUT, PAHANDUT, KOTA PALANGKARAYA, KALIMANTAN TENGAH",43,92,76,168
https://kawalpemilu.org#61931,"PAHANDUT, PAHANDUT, KOTA PALANGKARAYA, KALIMANTAN TENGAH",44,120,111,231
https://kawalpemilu.org#61931,"PAHANDUT, PAHANDUT, KOTA PALANGKARAYA, KALIMANTAN TENGAH",45,100,50,150
https://kawalpemilu.org#61931,"PAHANDUT, PAHANDUT, KOTA PALANGKARAYA, KALIMANTAN TENGAH",46,48,71,119
https://kawalpemilu.org#61931,"PAHANDUT, PAHANDUT, KOTA PALANGKARAYA, KALIMANTAN TENGAH",47,38,78,116
https://kawalpemilu.org#61931,"PAHANDUT, PAHANDUT, KOTA PALANGKARAYA, KALIMANTAN TENGAH",48,99,81,180
https://kawalpemilu.org#61931,"PAHANDUT, PAHANDUT, KOTA PALANGKARAYA, KALIMANTAN TENGAH",49,33,101,134
https://kawalpemilu.org#61931,"PAHANDUT, PAHANDUT, KOTA PALANGKARAYA, KALIMANTAN TENGAH",50,26,63,89
https://kawalpemilu.org#61931,"PAHANDUT, PAHANDUT, KOTA PALANGKARAYA, KALIMANTAN TENGAH",51,56,127,183
https://kawalpemilu.org#61931,"PAHANDUT, PAHANDUT, KOTA PALANGKARAYA, KALIMANTAN TENGAH",52,92,127,219
https://kawalpemilu.org#61931,"PAHANDUT, PAHANDUT, KOTA PALANGKARAYA, KALIMANTAN TENGAH",53,72,122,194
https://kawalpemilu.org#61931,"PAHANDUT, PAHANDUT, KOTA PALANGKARAYA, KALIMANTAN TENGAH",54,68,79,147
https://kawalpemilu.org#61931,"PAHANDUT, PAHANDUT, KOTA PALANGKARAYA, KALIMANTAN TENGAH",55,112,6,118
https://kawalpemilu.org#61931,"PAHANDUT, PAHANDUT, KOTA PALANGKARAYA, KALIMANTAN TENGAH",56,57,183,240
https://kawalpemilu.org#61931,"PAHANDUT, PAHANDUT, KOTA PALANGKARAYA, KALIMANTAN TENGAH",57,33,197,230
https://kawalpemilu.org#61931,"PAHANDUT, PAHANDUT, KOTA PALANGKARAYA, KALIMANTAN TENGAH",58,29,58,87
https://kawalpemilu.org#61931,"PAHANDUT, PAHANDUT, KOTA PALANGKARAYA, KALIMANTAN TENGAH",59,32,189,221
https://kawalpemilu.org#61931,"PAHANDUT, PAHANDUT, KOTA PALANGKARAYA, KALIMANTAN TENGAH",60,35,88,127
https://kawalpemilu.org#61931,"PAHANDUT, PAHANDUT, KOTA PALANGKARAYA, KALIMANTAN TENGAH",61,30,104,134
https://kawalpemilu.org#61931,"PAHANDUT, PAHANDUT, KOTA PALANGKARAYA, KALIMANTAN TENGAH",62,46,133,179
https://kawalpemilu.org#61931,"PAHANDUT, PAHANDUT, KOTA PALANGKARAYA, KALIMANTAN TENGAH",63,44,95,139
https://kawalpemilu.org#61931,"PAHANDUT, PAHANDUT, KOTA PALANGKARAYA, KALIMANTAN TENGAH",64,35,152,187
https://kawalpemilu.org#61931,"PAHANDUT, PAHANDUT, KOTA PALANGKARAYA, KALIMANTAN TENGAH",65,73,105,178
https://kawalpemilu.org#61931,"PAHANDUT, PAHANDUT, KOTA PALANGKARAYA, KALIMANTAN TENGAH",66,50,155,205
https://kawalpemilu.org#61931,"PAHANDUT, PAHANDUT, KOTA PALANGKARAYA, KALIMANTAN TENGAH",67,31,99,130
https://kawalpemilu.org#61931,"PAHANDUT, PAHANDUT, KOTA PALANGKARAYA, KALIMANTAN TENGAH",68,92,49,141
https://kawalpemilu.org#61931,"PAHANDUT, PAHANDUT, KOTA PALANGKARAYA, KALIMANTAN TENGAH",69,34,48,82
https://kawalpemilu.org#61931,"PAHANDUT, PAHANDUT, KOTA PALANGKARAYA, KALIMANTAN TENGAH",70,33,76,109
https://kawalpemilu.org#61931,"PAHANDUT, PAHANDUT, KOTA PALANGKARAYA, KALIMANTAN TENGAH",71,37,143,180
https://kawalpemilu.org#61931,"PAHANDUT, PAHANDUT, KOTA PALANGKARAYA, KALIMANTAN TENGAH",72,33,117,150
https://kawalpemilu.org#61931,"PAHANDUT, PAHANDUT, KOTA PALANGKARAYA, KALIMANTAN TENGAH",73,56,82,138
https://kawalpemilu.org#61931,"PAHANDUT, PAHANDUT, KOTA PALANGKARAYA, KALIMANTAN TENGAH",74,40,81,121
https://kawalpemilu.org#61931,"PAHANDUT, PAHANDUT, KOTA PALANGKARAYA, KALIMANTAN TENGAH",75,31,98,129
https://kawalpemilu.org#61931,"PAHANDUT, PAHANDUT, KOTA PALANGKARAYA, KALIMANTAN TENGAH",76,35,120,155
https://kawalpemilu.org#61931,"PAHANDUT, PAHANDUT, KOTA PALANGKARAYA, KALIMANTAN TENGAH",77,29,105,134
https://kawalpemilu.org#61931,"PAHANDUT, PAHANDUT, KOTA PALANGKARAYA, KALIMANTAN TENGAH",78,26,114,140
https://kawalpemilu.org#61931,"PAHANDUT, PAHANDUT, KOTA PALANGKARAYA, KALIMANTAN TENGAH",79,36,103,139
https://kawalpemilu.org#61931,"PAHANDUT, PAHANDUT, KOTA PALANGKARAYA, KALIMANTAN TENGAH",80,22,92,114
https://kawalpemilu.org#61931,"PAHANDUT, PAHANDUT, KOTA PALANGKARAYA, KALIMANTAN TENGAH",81,25,84,109
https://kawalpemilu.org#61931,"PAHANDUT, PAHANDUT, KOTA PALANGKARAYA, KALIMANTAN TENGAH",82,22,108,130
https://kawalpemilu.org#61931,"PAHANDUT, PAHANDUT, KOTA PALANGKARAYA, KALIMANTAN TENGAH",83,42,45,87
https://kawalpemilu.org#61931,"PAHANDUT, PAHANDUT, KOTA PALANGKARAYA, KALIMANTAN TENGAH",84,31,109,140
https://kawalpemilu.org#61931,"PAHANDUT, PAHANDUT, KOTA PALANGKARAYA, KALIMANTAN TENGAH",85,50,69,119
https://kawalpemilu.org#61931,"PAHANDUT, PAHANDUT, KOTA PALANGKARAYA, KALIMANTAN TENGAH",86,74,69,143
https://kawalpemilu.org#61931,"PAHANDUT, PAHANDUT, KOTA PALANGKARAYA, KALIMANTAN TENGAH",87,60,129,189
https://kawalpemilu.org#61931,"PAHANDUT, PAHANDUT, KOTA PALANGKARAYA, KALIMANTAN TENGAH",88,52,89,141
https://kawalpemilu.org#61931,"PAHANDUT, PAHANDUT, KOTA PALANGKARAYA, KALIMANTAN TENGAH",89,53,29,82
https://kawalpemilu.org#61931,"PAHANDUT, PAHANDUT, KOTA PALANGKARAYA, KALIMANTAN TENGAH",90,73,158,231
https://kawalpemilu.org#61931,"PAHANDUT, PAHANDUT, KOTA PALANGKARAYA, KALIMANTAN TENGAH",91,27,105,132
https://kawalpemilu.org#61931,"PAHANDUT, PAHANDUT, KOTA PALANGKARAYA, KALIMANTAN TENGAH",92,28,83,111
https://kawalpemilu.org#61931,"PAHANDUT, PAHANDUT, KOTA PALANGKARAYA, KALIMANTAN TENGAH",93,48,112,160
https://kawalpemilu.org#61931,"PAHANDUT, PAHANDUT, KOTA PALANGKARAYA, KALIMANTAN TENGAH",94,39,84,123
https://kawalpemilu.org#61931,"PAHANDUT, PAHANDUT, KOTA PALANGKARAYA, KALIMANTAN TENGAH",95,44,124,168
https://kawalpemilu.org#61931,"PAHANDUT, PAHANDUT, KOTA PALANGKARAYA, KALIMANTAN TENGAH",96,73,95,168
https://kawalpemilu.org#61931,"PAHANDUT, PAHANDUT, KOTA PALANGKARAYA, KALIMANTAN TENGAH",97,62,121,183
https://kawalpemilu.org#61932,"PANARUNG, PAHANDUT, KOTA PALANGKARAYA, KALIMANTAN TENGAH",1,74,57,131
https://kawalpemilu.org#61932,"PANARUNG, PAHANDUT, KOTA PALANGKARAYA, KALIMANTAN TENGAH",2,178,43,221
https://kawalpemilu.org#61932,"PANARUNG, PAHANDUT, KOTA PALANGKARAYA, KALIMANTAN TENGAH",3,113,105,218
https://kawalpemilu.org#61932,"PANARUNG, PAHANDUT, KOTA PALANGKARAYA, KALIMANTAN TENGAH",4,141,91,232
https://kawalpemilu.org#61932,"PANARUNG, PAHANDUT, KOTA PALANGKARAYA, KALIMANTAN TENGAH",5,72,98,170
https://kawalpemilu.org#61932,"PANARUNG, PAHANDUT, KOTA PALANGKARAYA, KALIMANTAN TENGAH",6,69,210,279
https://kawalpemilu.org#61932,"PANARUNG, PAHANDUT, KOTA PALANGKARAYA, KALIMANTAN TENGAH",7,75,125,200
https://kawalpemilu.org#61932,"PANARUNG, PAHANDUT, KOTA PALANGKARAYA, KALIMANTAN TENGAH",8,117,131,248
https://kawalpemilu.org#61932,"PANARUNG, PAHANDUT, KOTA PALANGKARAYA, KALIMANTAN TENGAH",9,177,23,200
https://kawalpemilu.org#61932,"PANARUNG, PAHANDUT, KOTA PALANGKARAYA, KALIMANTAN TENGAH",10,53,102,155
https://kawalpemilu.org#61932,"PANARUNG, PAHANDUT, KOTA PALANGKARAYA, KALIMANTAN TENGAH",11,33,88,121
https://kawalpemilu.org#61932,"PANARUNG, PAHANDUT, KOTA PALANGKARAYA, KALIMANTAN TENGAH",12,72,172,244
https://kawalpemilu.org#61932,"PANARUNG, PAHANDUT, KOTA PALANGKARAYA, KALIMANTAN TENGAH",13,35,87,122
https://kawalpemilu.org#61932,"PANARUNG, PAHANDUT, KOTA PALANGKARAYA, KALIMANTAN TENGAH",14,75,61,136
https://kawalpemilu.org#61932,"PANARUNG, PAHANDUT, KOTA PALANGKARAYA, KALIMANTAN TENGAH",15,39,78,117
https://kawalpemilu.org#61932,"PANARUNG, PAHANDUT, KOTA PALANGKARAYA, KALIMANTAN TENGAH",16,26,101,127
https://kawalpemilu.org#61932,"PANARUNG, PAHANDUT, KOTA PALANGKARAYA, KALIMANTAN TENGAH",17,72,130,202
https://kawalpemilu.org#61932,"PANARUNG, PAHANDUT, KOTA PALANGKARAYA, KALIMANTAN TENGAH",18,68,145,213
https://kawalpemilu.org#61932,"PANARUNG, PAHANDUT, KOTA PALANGKARAYA, KALIMANTAN TENGAH",19,68,138,206
https://kawalpemilu.org#61932,"PANARUNG, PAHANDUT, KOTA PALANGKARAYA, KALIMANTAN TENGAH",20,55,126,181
https://kawalpemilu.org#61932,"PANARUNG, PAHANDUT, KOTA PALANGKARAYA, KALIMANTAN TENGAH",21,83,164,247
https://kawalpemilu.org#61932,"PANARUNG, PAHANDUT, KOTA PALANGKARAYA, KALIMANTAN TENGAH",22,107,118,225
https://kawalpemilu.org#61932,"PANARUNG, PAHANDUT, KOTA PALANGKARAYA, KALIMANTAN TENGAH",23,90,86,176
https://kawalpemilu.org#61932,"PANARUNG, PAHANDUT, KOTA PALANGKARAYA, KALIMANTAN TENGAH",24,78,86,164
https://kawalpemilu.org#61932,"PANARUNG, PAHANDUT, KOTA PALANGKARAYA, KALIMANTAN TENGAH",25,24,66,90
https://kawalpemilu.org#61932,"PANARUNG, PAHANDUT, KOTA PALANGKARAYA, KALIMANTAN TENGAH",26,98,129,227
https://kawalpemilu.org#61932,"PANARUNG, PAHANDUT, KOTA PALANGKARAYA, KALIMANTAN TENGAH",27,67,85,152
https://kawalpemilu.org#61932,"PANARUNG, PAHANDUT, KOTA PALANGKARAYA, KALIMANTAN TENGAH",28,120,65,185
https://kawalpemilu.org#61932,"PANARUNG, PAHANDUT, KOTA PALANGKARAYA, KALIMANTAN TENGAH",29,123,93,216
https://kawalpemilu.org#61932,"PANARUNG, PAHANDUT, KOTA PALANGKARAYA, KALIMANTAN TENGAH",30,61,117,178
https://kawalpemilu.org#61932,"PANARUNG, PAHANDUT, KOTA PALANGKARAYA, KALIMANTAN TENGAH",31,150,98,248
https://kawalpemilu.org#61932,"PANARUNG, PAHANDUT, KOTA PALANGKARAYA, KALIMANTAN TENGAH",32,44,142,186
https://kawalpemilu.org#61932,"PANARUNG, PAHANDUT, KOTA PALANGKARAYA, KALIMANTAN TENGAH",33,90,45,135
https://kawalpemilu.org#61932,"PANARUNG, PAHANDUT, KOTA PALANGKARAYA, KALIMANTAN TENGAH",34,58,87,145
https://kawalpemilu.org#61932,"PANARUNG, PAHANDUT, KOTA PALANGKARAYA, KALIMANTAN TENGAH",35,147,71,218
https://kawalpemilu.org#61932,"PANARUNG, PAHANDUT, KOTA PALANGKARAYA, KALIMANTAN TENGAH",36,147,53,200
https://kawalpemilu.org#61932,"PANARUNG, PAHANDUT, KOTA PALANGKARAYA, KALIMANTAN TENGAH",37,99,30,129
https://kawalpemilu.org#61932,"PANARUNG, PAHANDUT, KOTA PALANGKARAYA, KALIMANTAN TENGAH",38,153,75,228
https://kawalpemilu.org#61932,"PANARUNG, PAHANDUT, KOTA PALANGKARAYA, KALIMANTAN TENGAH",39,45,143,188
https://kawalpemilu.org#61932,"PANARUNG, PAHANDUT, KOTA PALANGKARAYA, KALIMANTAN TENGAH",40,42,101,143
https://kawalpemilu.org#61932,"PANARUNG, PAHANDUT, KOTA PALANGKARAYA, KALIMANTAN TENGAH",41,152,113,265
https://kawalpemilu.org#61932,"PANARUNG, PAHANDUT, KOTA PALANGKARAYA, KALIMANTAN TENGAH",42,43,86,129
https://kawalpemilu.org#61932,"PANARUNG, PAHANDUT, KOTA PALANGKARAYA, KALIMANTAN TENGAH",43,75,105,180
https://kawalpemilu.org#61932,"PANARUNG, PAHANDUT, KOTA PALANGKARAYA, KALIMANTAN TENGAH",44,79,108,187
https://kawalpemilu.org#61932,"PANARUNG, PAHANDUT, KOTA PALANGKARAYA, KALIMANTAN TENGAH",45,98,104,202
https://kawalpemilu.org#61932,"PANARUNG, PAHANDUT, KOTA PALANGKARAYA, KALIMANTAN TENGAH",46,111,161,272
https://kawalpemilu.org#61932,"PANARUNG, PAHANDUT, KOTA PALANGKARAYA, KALIMANTAN TENGAH",47,61,187,248
https://kawalpemilu.org#61932,"PANARUNG, PAHANDUT, KOTA PALANGKARAYA, KALIMANTAN TENGAH",48,109,140,249
https://kawalpemilu.org#61932,"PANARUNG, PAHANDUT, KOTA PALANGKARAYA, KALIMANTAN TENGAH",49,77,76,153
https://kawalpemilu.org#61932,"PANARUNG, PAHANDUT, KOTA PALANGKARAYA, KALIMANTAN TENGAH",50,61,40,101
https://kawalpemilu.org#61932,"PANARUNG, PAHANDUT, KOTA PALANGKARAYA, KALIMANTAN TENGAH",51,78,63,141
https://kawalpemilu.org#61932,"PANARUNG, PAHANDUT, KOTA PALANGKARAYA, KALIMANTAN TENGAH",52,44,85,129
https://kawalpemilu.org#61932,"PANARUNG, PAHANDUT, KOTA PALANGKARAYA, KALIMANTAN TENGAH",53,38,81,119
https://kawalpemilu.org#61932,"PANARUNG, PAHANDUT, KOTA PALANGKARAYA, KALIMANTAN TENGAH",54,88,55,143
https://kawalpemilu.org#61932,"PANARUNG, PAHANDUT, KOTA PALANGKARAYA, KALIMANTAN TENGAH",55,40,70,110
https://kawalpemilu.org#61932,"PANARUNG, PAHANDUT, KOTA PALANGKARAYA, KALIMANTAN TENGAH",56,25,95,120
https://kawalpemilu.org#61932,"PANARUNG, PAHANDUT, KOTA PALANGKARAYA, KALIMANTAN TENGAH",57,56,76,132
https://kawalpemilu.org#61932,"PANARUNG, PAHANDUT, KOTA PALANGKARAYA, KALIMANTAN TENGAH",58,49,57,106
https://kawalpemilu.org#61932,"PANARUNG, PAHANDUT, KOTA PALANGKARAYA, KALIMANTAN TENGAH",59,27,60,87
https://kawalpemilu.org#61932,"PANARUNG, PAHANDUT, KOTA PALANGKARAYA, KALIMANTAN TENGAH",60,75,91,166
https://kawalpemilu.org#61932,"PANARUNG, PAHANDUT, KOTA PALANGKARAYA, KALIMANTAN TENGAH",61,50,121,171
https://kawalpemilu.org#61932,"PANARUNG, PAHANDUT, KOTA PALANGKARAYA, KALIMANTAN TENGAH",62,65,83,148
https://kawalpemilu.org#61932,"PANARUNG, PAHANDUT, KOTA PALANGKARAYA, KALIMANTAN TENGAH",63,89,106,195
https://kawalpemilu.org#61932,"PANARUNG, PAHANDUT, KOTA PALANGKARAYA, KALIMANTAN TENGAH",64,83,74,157
https://kawalpemilu.org#61932,"PANARUNG, PAHANDUT, KOTA PALANGKARAYA, KALIMANTAN TENGAH",65,47,64,111
https://kawalpemilu.org#61932,"PANARUNG, PAHANDUT, KOTA PALANGKARAYA, KALIMANTAN TENGAH",66,99,43,142
https://kawalpemilu.org#61932,"PANARUNG, PAHANDUT, KOTA PALANGKARAYA, KALIMANTAN TENGAH",67,63,101,164
https://kawalpemilu.org#61932,"PANARUNG, PAHANDUT, KOTA PALANGKARAYA, KALIMANTAN TENGAH",68,87,71,158
https://kawalpemilu.org#61932,"PANARUNG, PAHANDUT, KOTA PALANGKARAYA, KALIMANTAN TENGAH",69,76,45,121
https://kawalpemilu.org#61932,"PANARUNG, PAHANDUT, KOTA PALANGKARAYA, KALIMANTAN TENGAH",70,62,140,202
https://kawalpemilu.org#61932,"PANARUNG, PAHANDUT, KOTA PALANGKARAYA, KALIMANTAN TENGAH",71,91,64,155
https://kawalpemilu.org#61932,"PANARUNG, PAHANDUT, KOTA PALANGKARAYA, KALIMANTAN TENGAH",72,66,26,92
https://kawalpemilu.org#61932,"PANARUNG, PAHANDUT, KOTA PALANGKARAYA, KALIMANTAN TENGAH",73,77,16,93
https://kawalpemilu.org#61932,"PANARUNG, PAHANDUT, KOTA PALANGKARAYA, KALIMANTAN TENGAH",74,59,92,151
https://kawalpemilu.org#61932,"PANARUNG, PAHANDUT, KOTA PALANGKARAYA, KALIMANTAN TENGAH",75,79,90,169
https://kawalpemilu.org#61932,"PANARUNG, PAHANDUT, KOTA PALANGKARAYA, KALIMANTAN TENGAH",76,80,87,167
https://kawalpemilu.org#61932,"PANARUNG, PAHANDUT, KOTA PALANGKARAYA, KALIMANTAN TENGAH",77,101,134,235
https://kawalpemilu.org#61932,"PANARUNG, PAHANDUT, KOTA PALANGKARAYA, KALIMANTAN TENGAH",78,114,101,215
https://kawalpemilu.org#61932,"PANARUNG, PAHANDUT, KOTA PALANGKARAYA, KALIMANTAN TENGAH",79,47,71,118
https://kawalpemilu.org#61932,"PANARUNG, PAHANDUT, KOTA PALANGKARAYA, KALIMANTAN TENGAH",80,0,0,0
https://kawalpemilu.org#61933,"LANGKAI, PAHANDUT, KOTA PALANGKARAYA, KALIMANTAN TENGAH",1,55,24,79
https://kawalpemilu.org#61933,"LANGKAI, PAHANDUT, KOTA PALANGKARAYA, KALIMANTAN TENGAH",2,83,74,157
https://kawalpemilu.org#61933,"LANGKAI, PAHANDUT, KOTA PALANGKARAYA, KALIMANTAN TENGAH",3,71,41,112
https://kawalpemilu.org#61933,"LANGKAI, PAHANDUT, KOTA PALANGKARAYA, KALIMANTAN TENGAH",4,82,107,189
https://kawalpemilu.org#61933,"LANGKAI, PAHANDUT, KOTA PALANGKARAYA, KALIMANTAN TENGAH",5,138,27,165
https://kawalpemilu.org#61933,"LANGKAI, PAHANDUT, KOTA PALANGKARAYA, KALIMANTAN TENGAH",6,79,73,152
https://kawalpemilu.org#61933,"LANGKAI, PAHANDUT, KOTA PALANGKARAYA, KALIMANTAN TENGAH",7,145,97,242
https://kawalpemilu.org#61933,"LANGKAI, PAHANDUT, KOTA PALANGKARAYA, KALIMANTAN TENGAH",8,132,77,210
https://kawalpemilu.org#61933,"LANGKAI, PAHANDUT, KOTA PALANGKARAYA, KALIMANTAN TENGAH",9,50,61,111
https://kawalpemilu.org#61933,"LANGKAI, PAHANDUT, KOTA PALANGKARAYA, KALIMANTAN TENGAH",10,101,72,173
https://kawalpemilu.org#61933,"LANGKAI, PAHANDUT, KOTA PALANGKARAYA, KALIMANTAN TENGAH",11,117,43,160
https://kawalpemilu.org#61933,"LANGKAI, PAHANDUT, KOTA PALANGKARAYA, KALIMANTAN TENGAH",12,82,48,130
https://kawalpemilu.org#61933,"LANGKAI, PAHANDUT, KOTA PALANGKARAYA, KALIMANTAN TENGAH",13,123,38,161
https://kawalpemilu.org#61933,"LANGKAI, PAHANDUT, KOTA PALANGKARAYA, KALIMANTAN TENGAH",14,77,30,107
https://kawalpemilu.org#61933,"LANGKAI, PAHANDUT, KOTA PALANGKARAYA, KALIMANTAN TENGAH",15,91,32,123
https://kawalpemilu.org#61933,"LANGKAI, PAHANDUT, KOTA PALANGKARAYA, KALIMANTAN TENGAH",16,97,24,121
https://kawalpemilu.org#61933,"LANGKAI, PAHANDUT, KOTA PALANGKARAYA, KALIMANTAN TENGAH",17,119,88,207
https://kawalpemilu.org#61933,"LANGKAI, PAHANDUT, KOTA PALANGKARAYA, KALIMANTAN TENGAH",18,56,21,77
https://kawalpemilu.org#61933,"LANGKAI, PAHANDUT, KOTA PALANGKARAYA, KALIMANTAN TENGAH",19,134,19,153
https://kawalpemilu.org#61933,"LANGKAI, PAHANDUT, KOTA PALANGKARAYA, KALIMANTAN TENGAH",20,74,46,120
https://kawalpemilu.org#61933,"LANGKAI, PAHANDUT, KOTA PALANGKARAYA, KALIMANTAN TENGAH",21,134,55,189
https://kawalpemilu.org#61933,"LANGKAI, PAHANDUT, KOTA PALANGKARAYA, KALIMANTAN TENGAH",22,157,65,222
https://kawalpemilu.org#61933,"LANGKAI, PAHANDUT, KOTA PALANGKARAYA, KALIMANTAN TENGAH",23,117,69,186
https://kawalpemilu.org#61933,"LANGKAI, PAHANDUT, KOTA PALANGKARAYA, KALIMANTAN TENGAH",24,66,57,123
https://kawalpemilu.org#61933,"LANGKAI, PAHANDUT, KOTA PALANGKARAYA, KALIMANTAN TENGAH",25,82,50,132
https://kawalpemilu.org#61933,"LANGKAI, PAHANDUT, KOTA PALANGKARAYA, KALIMANTAN TENGAH",26,117,74,191
https://kawalpemilu.org#61933,"LANGKAI, PAHANDUT, KOTA PALANGKARAYA, KALIMANTAN TENGAH",27,71,152,223
https://kawalpemilu.org#61933,"LANGKAI, PAHANDUT, KOTA PALANGKARAYA, KALIMANTAN TENGAH",28,75,142,217
https://kawalpemilu.org#61933,"LANGKAI, PAHANDUT, KOTA PALANGKARAYA, KALIMANTAN TENGAH",29,44,63,107
https://kawalpemilu.org#61933,"LANGKAI, PAHANDUT, KOTA PALANGKARAYA, KALIMANTAN TENGAH",30,64,72,136
https://kawalpemilu.org#61933,"LANGKAI, PAHANDUT, KOTA PALANGKARAYA, KALIMANTAN TENGAH",31,153,53,206
https://kawalpemilu.org#61933,"LANGKAI, PAHANDUT, KOTA PALANGKARAYA, KALIMANTAN TENGAH",32,135,57,192
https://kawalpemilu.org#61933,"LANGKAI, PAHANDUT, KOTA PALANGKARAYA, KALIMANTAN TENGAH",33,197,73,270
https://kawalpemilu.org#61933,"LANGKAI, PAHANDUT, KOTA PALANGKARAYA, KALIMANTAN TENGAH",34,141,19,160
https://kawalpemilu.org#61933,"LANGKAI, PAHANDUT, KOTA PALANGKARAYA, KALIMANTAN TENGAH",35,137,39,176
https://kawalpemilu.org#61933,"LANGKAI, PAHANDUT, KOTA PALANGKARAYA, KALIMANTAN TENGAH",36,144,45,189
https://kawalpemilu.org#61933,"LANGKAI, PAHANDUT, KOTA PALANGKARAYA, KALIMANTAN TENGAH",37,132,55,187
https://kawalpemilu.org#61933,"LANGKAI, PAHANDUT, KOTA PALANGKARAYA, KALIMANTAN TENGAH",38,148,101,249
https://kawalpemilu.org#61933,"LANGKAI, PAHANDUT, KOTA PALANGKARAYA, KALIMANTAN TENGAH",39,180,86,266
https://kawalpemilu.org#61933,"LANGKAI, PAHANDUT, KOTA PALANGKARAYA, KALIMANTAN TENGAH",40,151,72,223
https://kawalpemilu.org#61933,"LANGKAI, PAHANDUT, KOTA PALANGKARAYA, KALIMANTAN TENGAH",41,52,109,161
https://kawalpemilu.org#61933,"LANGKAI, PAHANDUT, KOTA PALANGKARAYA, KALIMANTAN TENGAH",42,75,88,163
https://kawalpemilu.org#61933,"LANGKAI, PAHANDUT, KOTA PALANGKARAYA, KALIMANTAN TENGAH",43,95,68,163
https://kawalpemilu.org#61933,"LANGKAI, PAHANDUT, KOTA PALANGKARAYA, KALIMANTAN TENGAH",44,102,81,183
https://kawalpemilu.org#61933,"LANGKAI, PAHANDUT, KOTA PALANGKARAYA, KALIMANTAN TENGAH",45,50,84,134
https://kawalpemilu.org#61933,"LANGKAI, PAHANDUT, KOTA PALANGKARAYA, KALIMANTAN TENGAH",46,110,67,177
https://kawalpemilu.org#61933,"LANGKAI, PAHANDUT, KOTA PALANGKARAYA, KALIMANTAN TENGAH",47,140,49,189
https://kawalpemilu.org#61933,"LANGKAI, PAHANDUT, KOTA PALANGKARAYA, KALIMANTAN TENGAH",48,146,69,215
https://kawalpemilu.org#61933,"LANGKAI, PAHANDUT, KOTA PALANGKARAYA, KALIMANTAN TENGAH",49,98,52,150
https://kawalpemilu.org#61933,"LANGKAI, PAHANDUT, KOTA PALANGKARAYA, KALIMANTAN TENGAH",50,157,63,220
https://kawalpemilu.org#61933,"LANGKAI, PAHANDUT, KOTA PALANGKARAYA, KALIMANTAN TENGAH",51,134,99,233
https://kawalpemilu.org#61933,"LANGKAI, PAHANDUT, KOTA PALANGKARAYA, KALIMANTAN TENGAH",52,96,48,144
https://kawalpemilu.org#61933,"LANGKAI, PAHANDUT, KOTA PALANGKARAYA, KALIMANTAN TENGAH",53,87,34,121
https://kawalpemilu.org#61933,"LANGKAI, PAHANDUT, KOTA PALANGKARAYA, KALIMANTAN TENGAH",54,89,127,216
https://kawalpemilu.org#61933,"LANGKAI, PAHANDUT, KOTA PALANGKARAYA, KALIMANTAN TENGAH",55,59,82,141
https://kawalpemilu.org#61933,"LANGKAI, PAHANDUT, KOTA PALANGKARAYA, KALIMANTAN TENGAH",56,104,73,177
https://kawalpemilu.org#61933,"LANGKAI, PAHANDUT, KOTA PALANGKARAYA, KALIMANTAN TENGAH",57,93,86,179
https://kawalpemilu.org#61933,"LANGKAI, PAHANDUT, KOTA PALANGKARAYA, KALIMANTAN TENGAH",58,99,105,204
https://kawalpemilu.org#61933,"LANGKAI, PAHANDUT, KOTA PALANGKARAYA, KALIMANTAN TENGAH",59,72,90,162
https://kawalpemilu.org#61933,"LANGKAI, PAHANDUT, KOTA PALANGKARAYA, KALIMANTAN TENGAH",60,54,64,118
https://kawalpemilu.org#61933,"LANGKAI, PAHANDUT, KOTA PALANGKARAYA, KALIMANTAN TENGAH",61,158,88,246
https://kawalpemilu.org#61933,"LANGKAI, PAHANDUT, KOTA PALANGKARAYA, KALIMANTAN TENGAH",62,62,95,157
https://kawalpemilu.org#61933,"LANGKAI, PAHANDUT, KOTA PALANGKARAYA, KALIMANTAN TENGAH",63,68,67,135
https://kawalpemilu.org#61933,"LANGKAI, PAHANDUT, KOTA PALANGKARAYA, KALIMANTAN TENGAH",64,112,42,154
https://kawalpemilu.org#61933,"LANGKAI, PAHANDUT, KOTA PALANGKARAYA, KALIMANTAN TENGAH",65,55,131,186
https://kawalpemilu.org#61933,"LANGKAI, PAHANDUT, KOTA PALANGKARAYA, KALIMANTAN TENGAH",66,112,30,142
https://kawalpemilu.org#61933,"LANGKAI, PAHANDUT, KOTA PALANGKARAYA, KALIMANTAN TENGAH",67,131,78,209
https://kawalpemilu.org#61933,"LANGKAI, PAHANDUT, KOTA PALANGKARAYA, KALIMANTAN TENGAH",68,69,61,130
https://kawalpemilu.org#61933,"LANGKAI, PAHANDUT, KOTA PALANGKARAYA, KALIMANTAN TENGAH",69,103,45,148
https://kawalpemilu.org#61933,"LANGKAI, PAHANDUT, KOTA PALANGKARAYA, KALIMANTAN TENGAH",70,58,25,83
https://kawalpemilu.org#61933,"LANGKAI, PAHANDUT, KOTA PALANGKARAYA, KALIMANTAN TENGAH",71,78,42,120
https://kawalpemilu.org#61933,"LANGKAI, PAHANDUT, KOTA PALANGKARAYA, KALIMANTAN TENGAH",72,74,34,108
https://kawalpemilu.org#61933,"LANGKAI, PAHANDUT, KOTA PALANGKARAYA, KALIMANTAN TENGAH",73,40,77,117
https://kawalpemilu.org#61933,"LANGKAI, PAHANDUT, KOTA PALANGKARAYA, KALIMANTAN TENGAH",74,99,22,121
https://kawalpemilu.org#61933,"LANGKAI, PAHANDUT, KOTA PALANGKARAYA, KALIMANTAN TENGAH",75,150,30,180
https://kawalpemilu.org#61933,"LANGKAI, PAHANDUT, KOTA PALANGKARAYA, KALIMANTAN TENGAH",76,158,54,212
https://kawalpemilu.org#61933,"LANGKAI, PAHANDUT, KOTA PALANGKARAYA, KALIMANTAN TENGAH",77,150,97,247
https://kawalpemilu.org#61933,"LANGKAI, PAHANDUT, KOTA PALANGKARAYA, KALIMANTAN TENGAH",78,141,44,185
https://kawalpemilu.org#61933,"LANGKAI, PAHANDUT, KOTA PALANGKARAYA, KALIMANTAN TENGAH",79,124,55,179
https://kawalpemilu.org#61933,"LANGKAI, PAHANDUT, KOTA PALANGKARAYA, KALIMANTAN TENGAH",80,80,63,143
https://kawalpemilu.org#61933,"LANGKAI, PAHANDUT, KOTA PALANGKARAYA, KALIMANTAN TENGAH",81,75,72,147
https://kawalpemilu.org#61933,"LANGKAI, PAHANDUT, KOTA PALANGKARAYA, KALIMANTAN TENGAH",82,109,81,190
https://kawalpemilu.org#61933,"LANGKAI, PAHANDUT, KOTA PALANGKARAYA, KALIMANTAN TENGAH",83,76,36,112
https://kawalpemilu.org#61933,"LANGKAI, PAHANDUT, KOTA PALANGKARAYA, KALIMANTAN TENGAH",84,38,97,135
https://kawalpemilu.org#61933,"LANGKAI, PAHANDUT, KOTA PALANGKARAYA, KALIMANTAN TENGAH",85,93,78,171
https://kawalpemilu.org#61933,"LANGKAI, PAHANDUT, KOTA PALANGKARAYA, KALIMANTAN TENGAH",86,123,38,161
https://kawalpemilu.org#61933,"LANGKAI, PAHANDUT, KOTA PALANGKARAYA, KALIMANTAN TENGAH",87,106,30,136
https://kawalpemilu.org#61933,"LANGKAI, PAHANDUT, KOTA PALANGKARAYA, KALIMANTAN TENGAH",88,144,58,202
https://kawalpemilu.org#61933,"LANGKAI, PAHANDUT, KOTA PALANGKARAYA, KALIMANTAN TENGAH",89,111,28,139
https://kawalpemilu.org#61933,"LANGKAI, PAHANDUT, KOTA PALANGKARAYA, KALIMANTAN TENGAH",90,93,40,133
https://kawalpemilu.org#61933,"LANGKAI, PAHANDUT, KOTA PALANGKARAYA, KALIMANTAN TENGAH",91,143,34,177
https://kawalpemilu.org#61933,"LANGKAI, PAHANDUT, KOTA PALANGKARAYA, KALIMANTAN TENGAH",92,132,82,215
https://kawalpemilu.org#61933,"LANGKAI, PAHANDUT, KOTA PALANGKARAYA, KALIMANTAN TENGAH",93,67,49,116
https://kawalpemilu.org#61933,"LANGKAI, PAHANDUT, KOTA PALANGKARAYA, KALIMANTAN TENGAH",94,62,33,95
https://kawalpemilu.org#61933,"LANGKAI, PAHANDUT, KOTA PALANGKARAYA, KALIMANTAN TENGAH",95,81,81,162
https://kawalpemilu.org#61933,"LANGKAI, PAHANDUT, KOTA PALANGKARAYA, KALIMANTAN TENGAH",96,60,59,119
https://kawalpemilu.org#61933,"LANGKAI, PAHANDUT, KOTA PALANGKARAYA, KALIMANTAN TENGAH",98,88,108,196
https://kawalpemilu.org#61933,"LANGKAI, PAHANDUT, KOTA PALANGKARAYA, KALIMANTAN TENGAH",99,84,80,164
https://kawalpemilu.org#61933,"LANGKAI, PAHANDUT, KOTA PALANGKARAYA, KALIMANTAN TENGAH",100,64,83,147
https://kawalpemilu.org#61933,"LANGKAI, PAHANDUT, KOTA PALANGKARAYA, KALIMANTAN TENGAH",101,112,25,137
https://kawalpemilu.org#61934,"TUMBANG RUNGAN, PAHANDUT, KOTA PALANGKARAYA, KALIMANTAN TENGAH",1,131,104,235
https://kawalpemilu.org#61934,"TUMBANG RUNGAN, PAHANDUT, KOTA PALANGKARAYA, KALIMANTAN TENGAH",2,101,117,218
https://kawalpemilu.org#61935,"PAHANDUT SEBERANG, PAHANDUT, KOTA PALANGKARAYA, KALIMANTAN TENGAH",1,44,195,239
https://kawalpemilu.org#61935,"PAHANDUT SEBERANG, PAHANDUT, KOTA PALANGKARAYA, KALIMANTAN TENGAH",2,36,88,124
https://kawalpemilu.org#61935,"PAHANDUT SEBERANG, PAHANDUT, KOTA PALANGKARAYA, KALIMANTAN TENGAH",3,63,145,208
https://kawalpemilu.org#61935,"PAHANDUT SEBERANG, PAHANDUT, KOTA PALANGKARAYA, KALIMANTAN TENGAH",4,35,84,119
https://kawalpemilu.org#61935,"PAHANDUT SEBERANG, PAHANDUT, KOTA PALANGKARAYA, KALIMANTAN TENGAH",5,55,111,166
https://kawalpemilu.org#61935,"PAHANDUT SEBERANG, PAHANDUT, KOTA PALANGKARAYA, KALIMANTAN TENGAH",6,58,141,199
https://kawalpemilu.org#61935,"PAHANDUT SEBERANG, PAHANDUT, KOTA PALANGKARAYA, KALIMANTAN TENGAH",7,70,119,189
https://kawalpemilu.org#61935,"PAHANDUT SEBERANG, PAHANDUT, KOTA PALANGKARAYA, KALIMANTAN TENGAH",8,59,163,222
https://kawalpemilu.org#61935,"PAHANDUT SEBERANG, PAHANDUT, KOTA PALANGKARAYA, KALIMANTAN TENGAH",9,38,164,202
https://kawalpemilu.org#61935,"PAHANDUT SEBERANG, PAHANDUT, KOTA PALANGKARAYA, KALIMANTAN TENGAH",10,56,127,183
https://kawalpemilu.org#61935,"PAHANDUT SEBERANG, PAHANDUT, KOTA PALANGKARAYA, KALIMANTAN TENGAH",11,30,72,102
https://kawalpemilu.org#61935,"PAHANDUT SEBERANG, PAHANDUT, KOTA PALANGKARAYA, KALIMANTAN TENGAH",12,61,83,144
https://kawalpemilu.org#61935,"PAHANDUT SEBERANG, PAHANDUT, KOTA PALANGKARAYA, KALIMANTAN TENGAH",13,35,53,88
https://kawalpemilu.org#61935,"PAHANDUT SEBERANG, PAHANDUT, KOTA PALANGKARAYA, KALIMANTAN TENGAH",14,49,108,157
https://kawalpemilu.org#61935,"PAHANDUT SEBERANG, PAHANDUT, KOTA PALANGKARAYA, KALIMANTAN TENGAH",15,80,125,205
https://kawalpemilu.org#61935,"PAHANDUT SEBERANG, PAHANDUT, KOTA PALANGKARAYA, KALIMANTAN TENGAH",16,48,90,138
https://kawalpemilu.org#61936,"TANJUNG PINANG, PAHANDUT, KOTA PALANGKARAYA, KALIMANTAN TENGAH",1,113,26,139
https://kawalpemilu.org#61936,"TANJUNG PINANG, PAHANDUT, KOTA PALANGKARAYA, KALIMANTAN TENGAH",2,150,71,221
https://kawalpemilu.org#61936,"TANJUNG PINANG, PAHANDUT, KOTA PALANGKARAYA, KALIMANTAN TENGAH",3,94,5,99
https://kawalpemilu.org#61936,"TANJUNG PINANG, PAHANDUT, KOTA PALANGKARAYA, KALIMANTAN TENGAH",4,113,80,193
https://kawalpemilu.org#61936,"TANJUNG PINANG, PAHANDUT, KOTA PALANGKARAYA, KALIMANTAN TENGAH",5,63,86,149
https://kawalpemilu.org#61936,"TANJUNG PINANG, PAHANDUT, KOTA PALANGKARAYA, KALIMANTAN TENGAH",6,109,115,224
https://kawalpemilu.org#61936,"TANJUNG PINANG, PAHANDUT, KOTA PALANGKARAYA, KALIMANTAN TENGAH",7,107,133,240
https://kawalpemilu.org#61936,"TANJUNG PINANG, PAHANDUT, KOTA PALANGKARAYA, KALIMANTAN TENGAH",8,152,135,287
https://kawalpemilu.org#61936,"TANJUNG PINANG, PAHANDUT, KOTA PALANGKARAYA, KALIMANTAN TENGAH",9,172,71,243
https://kawalpemilu.org#61936,"TANJUNG PINANG, PAHANDUT, KOTA PALANGKARAYA, KALIMANTAN TENGAH",10,97,75,172
https://kawalpemilu.org#61936,"TANJUNG PINANG, PAHANDUT, KOTA PALANGKARAYA, KALIMANTAN TENGAH",11,73,84,157
https://kawalpemilu.org#61936,"TANJUNG PINANG, PAHANDUT, KOTA PALANGKARAYA, KALIMANTAN TENGAH",12,80,135,215
https://kawalpemilu.org#61938,"MARANG, BUKIT BATU, KOTA PALANGKARAYA, KALIMANTAN TENGAH",1,128,77,205
https://kawalpemilu.org#61938,"MARANG, BUKIT BATU, KOTA PALANGKARAYA, KALIMANTAN TENGAH",2,56,41,97
https://kawalpemilu.org#61938,"MARANG, BUKIT BATU, KOTA PALANGKARAYA, KALIMANTAN TENGAH",3,123,39,162
https://kawalpemilu.org#61938,"MARANG, BUKIT BATU, KOTA PALANGKARAYA, KALIMANTAN TENGAH",4,57,36,93
https://kawalpemilu.org#61939,"TUMBANG TAHAI, BUKIT BATU, KOTA PALANGKARAYA, KALIMANTAN TENGAH",1,114,24,138
https://kawalpemilu.org#61939,"TUMBANG TAHAI, BUKIT BATU, KOTA PALANGKARAYA, KALIMANTAN TENGAH",2,221,46,267
https://kawalpemilu.org#61939,"TUMBANG TAHAI, BUKIT BATU, KOTA PALANGKARAYA, KALIMANTAN TENGAH",3,181,28,209
https://kawalpemilu.org#61939,"TUMBANG TAHAI, BUKIT BATU, KOTA PALANGKARAYA, KALIMANTAN TENGAH",4,136,45,181
https://kawalpemilu.org#61939,"TUMBANG TAHAI, BUKIT BATU, KOTA PALANGKARAYA, KALIMANTAN TENGAH",5,133,22,155
https://kawalpemilu.org#61939,"TUMBANG TAHAI, BUKIT BATU, KOTA PALANGKARAYA, KALIMANTAN TENGAH",6,151,35,186
https://kawalpemilu.org#61939,"TUMBANG TAHAI, BUKIT BATU, KOTA PALANGKARAYA, KALIMANTAN TENGAH",7,113,27,140
https://kawalpemilu.org#61939,"TUMBANG TAHAI, BUKIT BATU, KOTA PALANGKARAYA, KALIMANTAN TENGAH",8,108,35,143
https://kawalpemilu.org#61939,"TUMBANG TAHAI, BUKIT BATU, KOTA PALANGKARAYA, KALIMANTAN TENGAH",9,77,36,113
https://kawalpemilu.org#61940,"BANTURUNG, BUKIT BATU, KOTA PALANGKARAYA, KALIMANTAN TENGAH",1,131,11,142
https://kawalpemilu.org#61940,"BANTURUNG, BUKIT BATU, KOTA PALANGKARAYA, KALIMANTAN TENGAH",2,144,35,179
https://kawalpemilu.org#61940,"BANTURUNG, BUKIT BATU, KOTA PALANGKARAYA, KALIMANTAN TENGAH",3,174,25,199
https://kawalpemilu.org#61940,"BANTURUNG, BUKIT BATU, KOTA PALANGKARAYA, KALIMANTAN TENGAH",4,131,53,184
https://kawalpemilu.org#61940,"BANTURUNG, BUKIT BATU, KOTA PALANGKARAYA, KALIMANTAN TENGAH",5,122,42,164
https://kawalpemilu.org#61940,"BANTURUNG, BUKIT BATU, KOTA PALANGKARAYA, KALIMANTAN TENGAH",6,132,51,183
https://kawalpemilu.org#61940,"BANTURUNG, BUKIT BATU, KOTA PALANGKARAYA, KALIMANTAN TENGAH",7,185,31,216
https://kawalpemilu.org#61940,"BANTURUNG, BUKIT BATU, KOTA PALANGKARAYA, KALIMANTAN TENGAH",8,135,9,144
https://kawalpemilu.org#61940,"BANTURUNG, BUKIT BATU, KOTA PALANGKARAYA, KALIMANTAN TENGAH",9,136,24,160
https://kawalpemilu.org#61940,"BANTURUNG, BUKIT BATU, KOTA PALANGKARAYA, KALIMANTAN TENGAH",10,112,44,156
https://kawalpemilu.org#61940,"BANTURUNG, BUKIT BATU, KOTA PALANGKARAYA, KALIMANTAN TENGAH",11,114,27,141
https://kawalpemilu.org#61940,"BANTURUNG, BUKIT BATU, KOTA PALANGKARAYA, KALIMANTAN TENGAH",12,170,19,189
https://kawalpemilu.org#61940,"BANTURUNG, BUKIT BATU, KOTA PALANGKARAYA, KALIMANTAN TENGAH",13,120,10,130
https://kawalpemilu.org#61941,"TANGKILING, BUKIT BATU, KOTA PALANGKARAYA, KALIMANTAN TENGAH",1,94,54,148
https://kawalpemilu.org#61941,"TANGKILING, BUKIT BATU, KOTA PALANGKARAYA, KALIMANTAN TENGAH",2,88,73,161
https://kawalpemilu.org#61941,"TANGKILING, BUKIT BATU, KOTA PALANGKARAYA, KALIMANTAN TENGAH",3,250,36,286
https://kawalpemilu.org#61941,"TANGKILING, BUKIT BATU, KOTA PALANGKARAYA, KALIMANTAN TENGAH",4,164,23,187
https://kawalpemilu.org#61941,"TANGKILING, BUKIT BATU, KOTA PALANGKARAYA, KALIMANTAN TENGAH",5,126,38,164
https://kawalpemilu.org#61941,"TANGKILING, BUKIT BATU, KOTA PALANGKARAYA, KALIMANTAN TENGAH",6,173,22,195
https://kawalpemilu.org#61941,"TANGKILING, BUKIT BATU, KOTA PALANGKARAYA, KALIMANTAN TENGAH",7,203,36,239
https://kawalpemilu.org#61941,"TANGKILING, BUKIT BATU, KOTA PALANGKARAYA, KALIMANTAN TENGAH",8,83,29,112
https://kawalpemilu.org#61941,"TANGKILING, BUKIT BATU, KOTA PALANGKARAYA, KALIMANTAN TENGAH",9,84,46,130
https://kawalpemilu.org#61941,"TANGKILING, BUKIT BATU, KOTA PALANGKARAYA, KALIMANTAN TENGAH",10,136,23,159
https://kawalpemilu.org#61942,"SEI GOHONG, BUKIT BATU, KOTA PALANGKARAYA, KALIMANTAN TENGAH",1,206,39,245
https://kawalpemilu.org#61942,"SEI GOHONG, BUKIT BATU, KOTA PALANGKARAYA, KALIMANTAN TENGAH",2,119,5,124
https://kawalpemilu.org#61942,"SEI GOHONG, BUKIT BATU, KOTA PALANGKARAYA, KALIMANTAN TENGAH",3,146,38,184
https://kawalpemilu.org#61942,"SEI GOHONG, BUKIT BATU, KOTA PALANGKARAYA, KALIMANTAN TENGAH",4,111,21,132
https://kawalpemilu.org#61942,"SEI GOHONG, BUKIT BATU, KOTA PALANGKARAYA, KALIMANTAN TENGAH",5,94,12,106
https://kawalpemilu.org#61943,"KANARAKAN, BUKIT BATU, KOTA PALANGKARAYA, KALIMANTAN TENGAH",1,124,57,181
https://kawalpemilu.org#61944,"HABARING HURUNG, BUKIT BATU, KOTA PALANGKARAYA, KALIMANTAN TENGAH",1,150,12,162
https://kawalpemilu.org#61944,"HABARING HURUNG, BUKIT BATU, KOTA PALANGKARAYA, KALIMANTAN TENGAH",2,124,32,156
https://kawalpemilu.org#61944,"HABARING HURUNG, BUKIT BATU, KOTA PALANGKARAYA, KALIMANTAN TENGAH",3,121,21,142
https://kawalpemilu.org#61944,"HABARING HURUNG, BUKIT BATU, KOTA PALANGKARAYA, KALIMANTAN TENGAH",4,106,22,128
https://kawalpemilu.org#61946,"PALANGKA, JEKAN RAYA, KOTA PALANGKARAYA, KALIMANTAN TENGAH",1,190,44,234
https://kawalpemilu.org#61946,"PALANGKA, JEKAN RAYA, KOTA PALANGKARAYA, KALIMANTAN TENGAH",2,142,44,186
https://kawalpemilu.org#61946,"PALANGKA, JEKAN RAYA, KOTA PALANGKARAYA, KALIMANTAN TENGAH",3,110,97,207
https://kawalpemilu.org#61946,"PALANGKA, JEKAN RAYA, KOTA PALANGKARAYA, KALIMANTAN TENGAH",4,101,96,197
https://kawalpemilu.org#61946,"PALANGKA, JEKAN RAYA, KOTA PALANGKARAYA, KALIMANTAN TENGAH",5,128,56,184
https://kawalpemilu.org#61946,"PALANGKA, JEKAN RAYA, KOTA PALANGKARAYA, KALIMANTAN TENGAH",6,68,117,185
https://kawalpemilu.org#61946,"PALANGKA, JEKAN RAYA, KOTA PALANGKARAYA, KALIMANTAN TENGAH",7,195,29,224
https://kawalpemilu.org#61946,"PALANGKA, JEKAN RAYA, KOTA PALANGKARAYA, KALIMANTAN TENGAH",8,128,12,140
https://kawalpemilu.org#61946,"PALANGKA, JEKAN RAYA, KOTA PALANGKARAYA, KALIMANTAN TENGAH",9,134,77,211
https://kawalpemilu.org#61946,"PALANGKA, JEKAN RAYA, KOTA PALANGKARAYA, KALIMANTAN TENGAH",10,95,61,156
https://kawalpemilu.org#61946,"PALANGKA, JEKAN RAYA, KOTA PALANGKARAYA, KALIMANTAN TENGAH",11,115,113,228
https://kawalpemilu.org#61946,"PALANGKA, JEKAN RAYA, KOTA PALANGKARAYA, KALIMANTAN TENGAH",12,154,53,207
https://kawalpemilu.org#61946,"PALANGKA, JEKAN RAYA, KOTA PALANGKARAYA, KALIMANTAN TENGAH",13,48,130,178
https://kawalpemilu.org#61946,"PALANGKA, JEKAN RAYA, KOTA PALANGKARAYA, KALIMANTAN TENGAH",14,40,209,249
https://kawalpemilu.org#61946,"PALANGKA, JEKAN RAYA, KOTA PALANGKARAYA, KALIMANTAN TENGAH",15,37,159,196
https://kawalpemilu.org#61946,"PALANGKA, JEKAN RAYA, KOTA PALANGKARAYA, KALIMANTAN TENGAH",16,30,119,149
https://kawalpemilu.org#61946,"PALANGKA, JEKAN RAYA, KOTA PALANGKARAYA, KALIMANTAN TENGAH",17,85,125,0
https://kawalpemilu.org#61946,"PALANGKA, JEKAN RAYA, KOTA PALANGKARAYA, KALIMANTAN TENGAH",18,43,71,114
https://kawalpemilu.org#61946,"PALANGKA, JEKAN RAYA, KOTA PALANGKARAYA, KALIMANTAN TENGAH",19,85,97,182
https://kawalpemilu.org#61946,"PALANGKA, JEKAN RAYA, KOTA PALANGKARAYA, KALIMANTAN TENGAH",20,44,104,148
https://kawalpemilu.org#61946,"PALANGKA, JEKAN RAYA, KOTA PALANGKARAYA, KALIMANTAN TENGAH",21,53,67,120
https://kawalpemilu.org#61946,"PALANGKA, JEKAN RAYA, KOTA PALANGKARAYA, KALIMANTAN TENGAH",22,167,60,227
https://kawalpemilu.org#61946,"PALANGKA, JEKAN RAYA, KOTA PALANGKARAYA, KALIMANTAN TENGAH",23,87,78,165
https://kawalpemilu.org#61946,"PALANGKA, JEKAN RAYA, KOTA PALANGKARAYA, KALIMANTAN TENGAH",24,103,60,163
https://kawalpemilu.org#61946,"PALANGKA, JEKAN RAYA, KOTA PALANGKARAYA, KALIMANTAN TENGAH",25,142,15,157
https://kawalpemilu.org#61946,"PALANGKA, JEKAN RAYA, KOTA PALANGKARAYA, KALIMANTAN TENGAH",26,110,110,220
https://kawalpemilu.org#61946,"PALANGKA, JEKAN RAYA, KOTA PALANGKARAYA, KALIMANTAN TENGAH",27,61,123,184
https://kawalpemilu.org#61946,"PALANGKA, JEKAN RAYA, KOTA PALANGKARAYA, KALIMANTAN TENGAH",28,88,157,245
https://kawalpemilu.org#61946,"PALANGKA, JEKAN RAYA, KOTA PALANGKARAYA, KALIMANTAN TENGAH",29,136,47,183
https://kawalpemilu.org#61946,"PALANGKA, JEKAN RAYA, KOTA PALANGKARAYA, KALIMANTAN TENGAH",30,41,90,131
https://kawalpemilu.org#61946,"PALANGKA, JEKAN RAYA, KOTA PALANGKARAYA, KALIMANTAN TENGAH",31,43,91,134
https://kawalpemilu.org#61946,"PALANGKA, JEKAN RAYA, KOTA PALANGKARAYA, KALIMANTAN TENGAH",32,63,133,196
https://kawalpemilu.org#61946,"PALANGKA, JEKAN RAYA, KOTA PALANGKARAYA, KALIMANTAN TENGAH",33,161,32,193
https://kawalpemilu.org#61946,"PALANGKA, JEKAN RAYA, KOTA PALANGKARAYA, KALIMANTAN TENGAH",34,75,44,119
https://kawalpemilu.org#61946,"PALANGKA, JEKAN RAYA, KOTA PALANGKARAYA, KALIMANTAN TENGAH",35,182,34,216
https://kawalpemilu.org#61946,"PALANGKA, JEKAN RAYA, KOTA PALANGKARAYA, KALIMANTAN TENGAH",36,129,44,173
https://kawalpemilu.org#61946,"PALANGKA, JEKAN RAYA, KOTA PALANGKARAYA, KALIMANTAN TENGAH",37,174,75,249
https://kawalpemilu.org#61946,"PALANGKA, JEKAN RAYA, KOTA PALANGKARAYA, KALIMANTAN TENGAH",38,86,76,162
https://kawalpemilu.org#61946,"PALANGKA, JEKAN RAYA, KOTA PALANGKARAYA, KALIMANTAN TENGAH",39,105,51,156
https://kawalpemilu.org#61946,"PALANGKA, JEKAN RAYA, KOTA PALANGKARAYA, KALIMANTAN TENGAH",40,85,48,133
https://kawalpemilu.org#61946,"PALANGKA, JEKAN RAYA, KOTA PALANGKARAYA, KALIMANTAN TENGAH",41,147,49,196
https://kawalpemilu.org#61946,"PALANGKA, JEKAN RAYA, KOTA PALANGKARAYA, KALIMANTAN TENGAH",42,100,24,124
https://kawalpemilu.org#61946,"PALANGKA, JEKAN RAYA, KOTA PALANGKARAYA, KALIMANTAN TENGAH",43,137,35,172
https://kawalpemilu.org#61946,"PALANGKA, JEKAN RAYA, KOTA PALANGKARAYA, KALIMANTAN TENGAH",44,123,42,165
https://kawalpemilu.org#61946,"PALANGKA, JEKAN RAYA, KOTA PALANGKARAYA, KALIMANTAN TENGAH",45,110,45,155
https://kawalpemilu.org#61946,"PALANGKA, JEKAN RAYA, KOTA PALANGKARAYA, KALIMANTAN TENGAH",46,146,41,187
https://kawalpemilu.org#61946,"PALANGKA, JEKAN RAYA, KOTA PALANGKARAYA, KALIMANTAN TENGAH",47,123,55,178
https://kawalpemilu.org#61946,"PALANGKA, JEKAN RAYA, KOTA PALANGKARAYA, KALIMANTAN TENGAH",48,91,18,109
https://kawalpemilu.org#61946,"PALANGKA, JEKAN RAYA, KOTA PALANGKARAYA, KALIMANTAN TENGAH",49,101,22,123
https://kawalpemilu.org#61946,"PALANGKA, JEKAN RAYA, KOTA PALANGKARAYA, KALIMANTAN TENGAH",50,136,24,160
https://kawalpemilu.org#61946,"PALANGKA, JEKAN RAYA, KOTA PALANGKARAYA, KALIMANTAN TENGAH",51,150,42,192
https://kawalpemilu.org#61946,"PALANGKA, JEKAN RAYA, KOTA PALANGKARAYA, KALIMANTAN TENGAH",52,172,43,215
https://kawalpemilu.org#61946,"PALANGKA, JEKAN RAYA, KOTA PALANGKARAYA, KALIMANTAN TENGAH",53,65,17,82
https://kawalpemilu.org#61946,"PALANGKA, JEKAN RAYA, KOTA PALANGKARAYA, KALIMANTAN TENGAH",54,152,13,165
https://kawalpemilu.org#61946,"PALANGKA, JEKAN RAYA, KOTA PALANGKARAYA, KALIMANTAN TENGAH",55,81,38,119
https://kawalpemilu.org#61946,"PALANGKA, JEKAN RAYA, KOTA PALANGKARAYA, KALIMANTAN TENGAH",56,154,17,171
https://kawalpemilu.org#61946,"PALANGKA, JEKAN RAYA, KOTA PALANGKARAYA, KALIMANTAN TENGAH",57,146,31,177
https://kawalpemilu.org#61946,"PALANGKA, JEKAN RAYA, KOTA PALANGKARAYA, KALIMANTAN TENGAH",58,187,16,203
https://kawalpemilu.org#61946,"PALANGKA, JEKAN RAYA, KOTA PALANGKARAYA, KALIMANTAN TENGAH",59,149,18,167
https://kawalpemilu.org#61946,"PALANGKA, JEKAN RAYA, KOTA PALANGKARAYA, KALIMANTAN TENGAH",60,189,29,218
https://kawalpemilu.org#61946,"PALANGKA, JEKAN RAYA, KOTA PALANGKARAYA, KALIMANTAN TENGAH",61,239,51,290
https://kawalpemilu.org#61946,"PALANGKA, JEKAN RAYA, KOTA PALANGKARAYA, KALIMANTAN TENGAH",62,179,18,197
https://kawalpemilu.org#61946,"PALANGKA, JEKAN RAYA, KOTA PALANGKARAYA, KALIMANTAN TENGAH",63,98,60,158
https://kawalpemilu.org#61946,"PALANGKA, JEKAN RAYA, KOTA PALANGKARAYA, KALIMANTAN TENGAH",64,105,21,126
https://kawalpemilu.org#61946,"PALANGKA, JEKAN RAYA, KOTA PALANGKARAYA, KALIMANTAN TENGAH",65,89,64,153
https://kawalpemilu.org#61946,"PALANGKA, JEKAN RAYA, KOTA PALANGKARAYA, KALIMANTAN TENGAH",66,133,36,169
https://kawalpemilu.org#61946,"PALANGKA, JEKAN RAYA, KOTA PALANGKARAYA, KALIMANTAN TENGAH",67,164,33,197
https://kawalpemilu.org#61946,"PALANGKA, JEKAN RAYA, KOTA PALANGKARAYA, KALIMANTAN TENGAH",68,99,40,139
https://kawalpemilu.org#61946,"PALANGKA, JEKAN RAYA, KOTA PALANGKARAYA, KALIMANTAN TENGAH",69,118,37,155
https://kawalpemilu.org#61946,"PALANGKA, JEKAN RAYA, KOTA PALANGKARAYA, KALIMANTAN TENGAH",70,145,50,195
https://kawalpemilu.org#61946,"PALANGKA, JEKAN RAYA, KOTA PALANGKARAYA, KALIMANTAN TENGAH",71,167,32,199
https://kawalpemilu.org#61946,"PALANGKA, JEKAN RAYA, KOTA PALANGKARAYA, KALIMANTAN TENGAH",72,228,54,282
https://kawalpemilu.org#61946,"PALANGKA, JEKAN RAYA, KOTA PALANGKARAYA, KALIMANTAN TENGAH",73,170,48,218
https://kawalpemilu.org#61946,"PALANGKA, JEKAN RAYA, KOTA PALANGKARAYA, KALIMANTAN TENGAH",74,96,51,147
https://kawalpemilu.org#61946,"PALANGKA, JEKAN RAYA, KOTA PALANGKARAYA, KALIMANTAN TENGAH",75,193,51,244
https://kawalpemilu.org#61946,"PALANGKA, JEKAN RAYA, KOTA PALANGKARAYA, KALIMANTAN TENGAH",76,129,87,216
https://kawalpemilu.org#61946,"PALANGKA, JEKAN RAYA, KOTA PALANGKARAYA, KALIMANTAN TENGAH",77,161,90,251
https://kawalpemilu.org#61946,"PALANGKA, JEKAN RAYA, KOTA PALANGKARAYA, KALIMANTAN TENGAH",78,63,61,124
https://kawalpemilu.org#61946,"PALANGKA, JEKAN RAYA, KOTA PALANGKARAYA, KALIMANTAN TENGAH",79,103,98,201
https://kawalpemilu.org#61946,"PALANGKA, JEKAN RAYA, KOTA PALANGKARAYA, KALIMANTAN TENGAH",80,101,37,138
https://kawalpemilu.org#61946,"PALANGKA, JEKAN RAYA, KOTA PALANGKARAYA, KALIMANTAN TENGAH",81,88,65,154
https://kawalpemilu.org#61946,"PALANGKA, JEKAN RAYA, KOTA PALANGKARAYA, KALIMANTAN TENGAH",82,62,68,130
https://kawalpemilu.org#61946,"PALANGKA, JEKAN RAYA, KOTA PALANGKARAYA, KALIMANTAN TENGAH",83,104,66,170
https://kawalpemilu.org#61946,"PALANGKA, JEKAN RAYA, KOTA PALANGKARAYA, KALIMANTAN TENGAH",84,71,52,123
https://kawalpemilu.org#61946,"PALANGKA, JEKAN RAYA, KOTA PALANGKARAYA, KALIMANTAN TENGAH",85,122,32,154
https://kawalpemilu.org#61946,"PALANGKA, JEKAN RAYA, KOTA PALANGKARAYA, KALIMANTAN TENGAH",86,107,26,133
https://kawalpemilu.org#61946,"PALANGKA, JEKAN RAYA, KOTA PALANGKARAYA, KALIMANTAN TENGAH",87,150,39,189
https://kawalpemilu.org#61946,"PALANGKA, JEKAN RAYA, KOTA PALANGKARAYA, KALIMANTAN TENGAH",88,139,31,170
https://kawalpemilu.org#61946,"PALANGKA, JEKAN RAYA, KOTA PALANGKARAYA, KALIMANTAN TENGAH",89,199,23,222
https://kawalpemilu.org#61946,"PALANGKA, JEKAN RAYA, KOTA PALANGKARAYA, KALIMANTAN TENGAH",90,59,108,167
https://kawalpemilu.org#61946,"PALANGKA, JEKAN RAYA, KOTA PALANGKARAYA, KALIMANTAN TENGAH",91,110,88,198
https://kawalpemilu.org#61946,"PALANGKA, JEKAN RAYA, KOTA PALANGKARAYA, KALIMANTAN TENGAH",92,84,44,128
https://kawalpemilu.org#61946,"PALANGKA, JEKAN RAYA, KOTA PALANGKARAYA, KALIMANTAN TENGAH",93,61,22,83
https://kawalpemilu.org#61946,"PALANGKA, JEKAN RAYA, KOTA PALANGKARAYA, KALIMANTAN TENGAH",94,67,55,122
https://kawalpemilu.org#61946,"PALANGKA, JEKAN RAYA, KOTA PALANGKARAYA, KALIMANTAN TENGAH",95,83,33,116
https://kawalpemilu.org#61946,"PALANGKA, JEKAN RAYA, KOTA PALANGKARAYA, KALIMANTAN TENGAH",96,47,59,106
https://kawalpemilu.org#61946,"PALANGKA, JEKAN RAYA, KOTA PALANGKARAYA, KALIMANTAN TENGAH",97,89,37,126
https://kawalpemilu.org#61946,"PALANGKA, JEKAN RAYA, KOTA PALANGKARAYA, KALIMANTAN TENGAH",98,191,32,223
https://kawalpemilu.org#61946,"PALANGKA, JEKAN RAYA, KOTA PALANGKARAYA, KALIMANTAN TENGAH",99,199,29,228
https://kawalpemilu.org#61946,"PALANGKA, JEKAN RAYA, KOTA PALANGKARAYA, KALIMANTAN TENGAH",100,143,40,183
https://kawalpemilu.org#61946,"PALANGKA, JEKAN RAYA, KOTA PALANGKARAYA, KALIMANTAN TENGAH",101,133,49,182
https://kawalpemilu.org#61946,"PALANGKA, JEKAN RAYA, KOTA PALANGKARAYA, KALIMANTAN TENGAH",102,194,94,288
https://kawalpemilu.org#61946,"PALANGKA, JEKAN RAYA, KOTA PALANGKARAYA, KALIMANTAN TENGAH",103,157,37,194
https://kawalpemilu.org#61946,"PALANGKA, JEKAN RAYA, KOTA PALANGKARAYA, KALIMANTAN TENGAH",104,61,110,171
https://kawalpemilu.org#61946,"PALANGKA, JEKAN RAYA, KOTA PALANGKARAYA, KALIMANTAN TENGAH",105,150,45,195
https://kawalpemilu.org#61946,"PALANGKA, JEKAN RAYA, KOTA PALANGKARAYA, KALIMANTAN TENGAH",106,122,41,163
https://kawalpemilu.org#61946,"PALANGKA, JEKAN RAYA, KOTA PALANGKARAYA, KALIMANTAN TENGAH",107,80,114,194
https://kawalpemilu.org#61946,"PALANGKA, JEKAN RAYA, KOTA PALANGKARAYA, KALIMANTAN TENGAH",108,71,111,182
https://kawalpemilu.org#61946,"PALANGKA, JEKAN RAYA, KOTA PALANGKARAYA, KALIMANTAN TENGAH",109,104,23,127
https://kawalpemilu.org#61946,"PALANGKA, JEKAN RAYA, KOTA PALANGKARAYA, KALIMANTAN TENGAH",110,118,20,138
https://kawalpemilu.org#61946,"PALANGKA, JEKAN RAYA, KOTA PALANGKARAYA, KALIMANTAN TENGAH",111,73,160,233
https://kawalpemilu.org#61946,"PALANGKA, JEKAN RAYA, KOTA PALANGKARAYA, KALIMANTAN TENGAH",112,125,29,154
https://kawalpemilu.org#61946,"PALANGKA, JEKAN RAYA, KOTA PALANGKARAYA, KALIMANTAN TENGAH",113,64,48,112
https://kawalpemilu.org#61946,"PALANGKA, JEKAN RAYA, KOTA PALANGKARAYA, KALIMANTAN TENGAH",114,49,108,157
https://kawalpemilu.org#61946,"PALANGKA, JEKAN RAYA, KOTA PALANGKARAYA, KALIMANTAN TENGAH",115,48,168,216
https://kawalpemilu.org#61946,"PALANGKA, JEKAN RAYA, KOTA PALANGKARAYA, KALIMANTAN TENGAH",116,31,133,164
https://kawalpemilu.org#61946,"PALANGKA, JEKAN RAYA, KOTA PALANGKARAYA, KALIMANTAN TENGAH",117,30,106,136
https://kawalpemilu.org#61946,"PALANGKA, JEKAN RAYA, KOTA PALANGKARAYA, KALIMANTAN TENGAH",118,94,25,119
https://kawalpemilu.org#61946,"PALANGKA, JEKAN RAYA, KOTA PALANGKARAYA, KALIMANTAN TENGAH",119,67,60,127
https://kawalpemilu.org#61946,"PALANGKA, JEKAN RAYA, KOTA PALANGKARAYA, KALIMANTAN TENGAH",120,81,92,173
https://kawalpemilu.org#61946,"PALANGKA, JEKAN RAYA, KOTA PALANGKARAYA, KALIMANTAN TENGAH",121,93,65,158
https://kawalpemilu.org#61946,"PALANGKA, JEKAN RAYA, KOTA PALANGKARAYA, KALIMANTAN TENGAH",122,36,79,115
https://kawalpemilu.org#61946,"PALANGKA, JEKAN RAYA, KOTA PALANGKARAYA, KALIMANTAN TENGAH",123,76,53,129
https://kawalpemilu.org#61946,"PALANGKA, JEKAN RAYA, KOTA PALANGKARAYA, KALIMANTAN TENGAH",124,155,32,187
https://kawalpemilu.org#61946,"PALANGKA, JEKAN RAYA, KOTA PALANGKARAYA, KALIMANTAN TENGAH",125,150,37,187
https://kawalpemilu.org#61946,"PALANGKA, JEKAN RAYA, KOTA PALANGKARAYA, KALIMANTAN TENGAH",126,135,30,165
https://kawalpemilu.org#61946,"PALANGKA, JEKAN RAYA, KOTA PALANGKARAYA, KALIMANTAN TENGAH",127,110,25,135
https://kawalpemilu.org#61946,"PALANGKA, JEKAN RAYA, KOTA PALANGKARAYA, KALIMANTAN TENGAH",128,114,24,138
https://kawalpemilu.org#61946,"PALANGKA, JEKAN RAYA, KOTA PALANGKARAYA, KALIMANTAN TENGAH",129,94,21,115
https://kawalpemilu.org#61946,"PALANGKA, JEKAN RAYA, KOTA PALANGKARAYA, KALIMANTAN TENGAH",130,96,10,106
https://kawalpemilu.org#61946,"PALANGKA, JEKAN RAYA, KOTA PALANGKARAYA, KALIMANTAN TENGAH",131,107,20,127
https://kawalpemilu.org#61946,"PALANGKA, JEKAN RAYA, KOTA PALANGKARAYA, KALIMANTAN TENGAH",132,75,24,99
https://kawalpemilu.org#61946,"PALANGKA, JEKAN RAYA, KOTA PALANGKARAYA, KALIMANTAN TENGAH",133,109,29,138
https://kawalpemilu.org#61946,"PALANGKA, JEKAN RAYA, KOTA PALANGKARAYA, KALIMANTAN TENGAH",134,91,21,112
https://kawalpemilu.org#61946,"PALANGKA, JEKAN RAYA, KOTA PALANGKARAYA, KALIMANTAN TENGAH",135,136,28,164
https://kawalpemilu.org#61946,"PALANGKA, JEKAN RAYA, KOTA PALANGKARAYA, KALIMANTAN TENGAH",136,97,66,163
https://kawalpemilu.org#61946,"PALANGKA, JEKAN RAYA, KOTA PALANGKARAYA, KALIMANTAN TENGAH",137,126,36,162
https://kawalpemilu.org#61946,"PALANGKA, JEKAN RAYA, KOTA PALANGKARAYA, KALIMANTAN TENGAH",138,141,28,169
https://kawalpemilu.org#61946,"PALANGKA, JEKAN RAYA, KOTA PALANGKARAYA, KALIMANTAN TENGAH",139,115,34,149
https://kawalpemilu.org#61946,"PALANGKA, JEKAN RAYA, KOTA PALANGKARAYA, KALIMANTAN TENGAH",140,198,46,244
https://kawalpemilu.org#61946,"PALANGKA, JEKAN RAYA, KOTA PALANGKARAYA, KALIMANTAN TENGAH",141,65,60,125
https://kawalpemilu.org#61946,"PALANGKA, JEKAN RAYA, KOTA PALANGKARAYA, KALIMANTAN TENGAH",142,156,53,209
https://kawalpemilu.org#61946,"PALANGKA, JEKAN RAYA, KOTA PALANGKARAYA, KALIMANTAN TENGAH",143,111,39,150
https://kawalpemilu.org#61946,"PALANGKA, JEKAN RAYA, KOTA PALANGKARAYA, KALIMANTAN TENGAH",144,165,22,187
https://kawalpemilu.org#61946,"PALANGKA, JEKAN RAYA, KOTA PALANGKARAYA, KALIMANTAN TENGAH",145,136,74,210
https://kawalpemilu.org#61946,"PALANGKA, JEKAN RAYA, KOTA PALANGKARAYA, KALIMANTAN TENGAH",146,111,31,142
https://kawalpemilu.org#61946,"PALANGKA, JEKAN RAYA, KOTA PALANGKARAYA, KALIMANTAN TENGAH",147,117,34,151
https://kawalpemilu.org#61946,"PALANGKA, JEKAN RAYA, KOTA PALANGKARAYA, KALIMANTAN TENGAH",148,51,95,146
https://kawalpemilu.org#61946,"PALANGKA, JEKAN RAYA, KOTA PALANGKARAYA, KALIMANTAN TENGAH",149,86,15,0
https://kawalpemilu.org#61947,"MENTENG, JEKAN RAYA, KOTA PALANGKARAYA, KALIMANTAN TENGAH",1,91,62,153
https://kawalpemilu.org#61947,"MENTENG, JEKAN RAYA, KOTA PALANGKARAYA, KALIMANTAN TENGAH",2,85,42,127
https://kawalpemilu.org#61947,"MENTENG, JEKAN RAYA, KOTA PALANGKARAYA, KALIMANTAN TENGAH",3,104,50,154
https://kawalpemilu.org#61947,"MENTENG, JEKAN RAYA, KOTA PALANGKARAYA, KALIMANTAN TENGAH",4,83,66,149
https://kawalpemilu.org#61947,"MENTENG, JEKAN RAYA, KOTA PALANGKARAYA, KALIMANTAN TENGAH",5,71,40,111
https://kawalpemilu.org#61947,"MENTENG, JEKAN RAYA, KOTA PALANGKARAYA, KALIMANTAN TENGAH",6,190,61,251
https://kawalpemilu.org#61947,"MENTENG, JEKAN RAYA, KOTA PALANGKARAYA, KALIMANTAN TENGAH",7,169,44,213
https://kawalpemilu.org#61947,"MENTENG, JEKAN RAYA, KOTA PALANGKARAYA, KALIMANTAN TENGAH",8,101,27,128
https://kawalpemilu.org#61947,"MENTENG, JEKAN RAYA, KOTA PALANGKARAYA, KALIMANTAN TENGAH",9,167,45,212
https://kawalpemilu.org#61947,"MENTENG, JEKAN RAYA, KOTA PALANGKARAYA, KALIMANTAN TENGAH",10,158,64,222
https://kawalpemilu.org#61947,"MENTENG, JEKAN RAYA, KOTA PALANGKARAYA, KALIMANTAN TENGAH",11,127,13,140
https://kawalpemilu.org#61947,"MENTENG, JEKAN RAYA, KOTA PALANGKARAYA, KALIMANTAN TENGAH",12,85,34,119
https://kawalpemilu.org#61947,"MENTENG, JEKAN RAYA, KOTA PALANGKARAYA, KALIMANTAN TENGAH",13,104,55,159
https://kawalpemilu.org#61947,"MENTENG, JEKAN RAYA, KOTA PALANGKARAYA, KALIMANTAN TENGAH",14,118,54,172
https://kawalpemilu.org#61947,"MENTENG, JEKAN RAYA, KOTA PALANGKARAYA, KALIMANTAN TENGAH",15,96,69,165
https://kawalpemilu.org#61947,"MENTENG, JEKAN RAYA, KOTA PALANGKARAYA, KALIMANTAN TENGAH",16,155,50,205
https://kawalpemilu.org#61947,"MENTENG, JEKAN RAYA, KOTA PALANGKARAYA, KALIMANTAN TENGAH",17,86,159,245
https://kawalpemilu.org#61947,"MENTENG, JEKAN RAYA, KOTA PALANGKARAYA, KALIMANTAN TENGAH",18,165,75,240
https://kawalpemilu.org#61947,"MENTENG, JEKAN RAYA, KOTA PALANGKARAYA, KALIMANTAN TENGAH",19,126,16,142
https://kawalpemilu.org#61947,"MENTENG, JEKAN RAYA, KOTA PALANGKARAYA, KALIMANTAN TENGAH",20,149,37,186
https://kawalpemilu.org#61947,"MENTENG, JEKAN RAYA, KOTA PALANGKARAYA, KALIMANTAN TENGAH",21,125,58,183
https://kawalpemilu.org#61947,"MENTENG, JEKAN RAYA, KOTA PALANGKARAYA, KALIMANTAN TENGAH",22,134,36,170
https://kawalpemilu.org#61947,"MENTENG, JEKAN RAYA, KOTA PALANGKARAYA, KALIMANTAN TENGAH",23,100,35,135
https://kawalpemilu.org#61947,"MENTENG, JEKAN RAYA, KOTA PALANGKARAYA, KALIMANTAN TENGAH",24,51,68,119
https://kawalpemilu.org#61947,"MENTENG, JEKAN RAYA, KOTA PALANGKARAYA, KALIMANTAN TENGAH",25,60,74,134
https://kawalpemilu.org#61947,"MENTENG, JEKAN RAYA, KOTA PALANGKARAYA, KALIMANTAN TENGAH",26,148,70,218
https://kawalpemilu.org#61947,"MENTENG, JEKAN RAYA, KOTA PALANGKARAYA, KALIMANTAN TENGAH",27,183,39,222
https://kawalpemilu.org#61947,"MENTENG, JEKAN RAYA, KOTA PALANGKARAYA, KALIMANTAN TENGAH",28,97,80,177
https://kawalpemilu.org#61947,"MENTENG, JEKAN RAYA, KOTA PALANGKARAYA, KALIMANTAN TENGAH",29,115,85,200
https://kawalpemilu.org#61947,"MENTENG, JEKAN RAYA, KOTA PALANGKARAYA, KALIMANTAN TENGAH",30,78,62,140
https://kawalpemilu.org#61947,"MENTENG, JEKAN RAYA, KOTA PALANGKARAYA, KALIMANTAN TENGAH",31,25,58,83
https://kawalpemilu.org#61947,"MENTENG, JEKAN RAYA, KOTA PALANGKARAYA, KALIMANTAN TENGAH",32,51,89,140
https://kawalpemilu.org#61947,"MENTENG, JEKAN RAYA, KOTA PALANGKARAYA, KALIMANTAN TENGAH",33,83,113,196
https://kawalpemilu.org#61947,"MENTENG, JEKAN RAYA, KOTA PALANGKARAYA, KALIMANTAN TENGAH",34,101,129,230
https://kawalpemilu.org#61947,"MENTENG, JEKAN RAYA, KOTA PALANGKARAYA, KALIMANTAN TENGAH",35,119,62,3
https://kawalpemilu.org#61947,"MENTENG, JEKAN RAYA, KOTA PALANGKARAYA, KALIMANTAN TENGAH",36,92,88,180
https://kawalpemilu.org#61947,"MENTENG, JEKAN RAYA, KOTA PALANGKARAYA, KALIMANTAN TENGAH",37,65,25,90
https://kawalpemilu.org#61947,"MENTENG, JEKAN RAYA, KOTA PALANGKARAYA, KALIMANTAN TENGAH",38,113,40,153
https://kawalpemilu.org#61947,"MENTENG, JEKAN RAYA, KOTA PALANGKARAYA, KALIMANTAN TENGAH",39,96,77,173
https://kawalpemilu.org#61947,"MENTENG, JEKAN RAYA, KOTA PALANGKARAYA, KALIMANTAN TENGAH",40,140,57,197
https://kawalpemilu.org#61947,"MENTENG, JEKAN RAYA, KOTA PALANGKARAYA, KALIMANTAN TENGAH",41,176,36,212
https://kawalpemilu.org#61947,"MENTENG, JEKAN RAYA, KOTA PALANGKARAYA, KALIMANTAN TENGAH",42,89,28,117
https://kawalpemilu.org#61947,"MENTENG, JEKAN RAYA, KOTA PALANGKARAYA, KALIMANTAN TENGAH",43,66,27,93
https://kawalpemilu.org#61947,"MENTENG, JEKAN RAYA, KOTA PALANGKARAYA, KALIMANTAN TENGAH",44,209,61,270
https://kawalpemilu.org#61947,"MENTENG, JEKAN RAYA, KOTA PALANGKARAYA, KALIMANTAN TENGAH",45,207,45,252
https://kawalpemilu.org#61947,"MENTENG, JEKAN RAYA, KOTA PALANGKARAYA, KALIMANTAN TENGAH",46,71,35,106
https://kawalpemilu.org#61947,"MENTENG, JEKAN RAYA, KOTA PALANGKARAYA, KALIMANTAN TENGAH",47,184,36,220
https://kawalpemilu.org#61947,"MENTENG, JEKAN RAYA, KOTA PALANGKARAYA, KALIMANTAN TENGAH",48,121,38,159
https://kawalpemilu.org#61947,"MENTENG, JEKAN RAYA, KOTA PALANGKARAYA, KALIMANTAN TENGAH",49,128,79,207
https://kawalpemilu.org#61947,"MENTENG, JEKAN RAYA, KOTA PALANGKARAYA, KALIMANTAN TENGAH",50,159,69,228
https://kawalpemilu.org#61947,"MENTENG, JEKAN RAYA, KOTA PALANGKARAYA, KALIMANTAN TENGAH",51,133,43,176
https://kawalpemilu.org#61947,"MENTENG, JEKAN RAYA, KOTA PALANGKARAYA, KALIMANTAN TENGAH",52,75,51,126
https://kawalpemilu.org#61947,"MENTENG, JEKAN RAYA, KOTA PALANGKARAYA, KALIMANTAN TENGAH",53,91,32,123
https://kawalpemilu.org#61947,"MENTENG, JEKAN RAYA, KOTA PALANGKARAYA, KALIMANTAN TENGAH",54,126,22,146
https://kawalpemilu.org#61947,"MENTENG, JEKAN RAYA, KOTA PALANGKARAYA, KALIMANTAN TENGAH",55,144,16,160
https://kawalpemilu.org#61947,"MENTENG, JEKAN RAYA, KOTA PALANGKARAYA, KALIMANTAN TENGAH",56,126,32,158
https://kawalpemilu.org#61947,"MENTENG, JEKAN RAYA, KOTA PALANGKARAYA, KALIMANTAN TENGAH",57,114,59,173
https://kawalpemilu.org#61947,"MENTENG, JEKAN RAYA, KOTA PALANGKARAYA, KALIMANTAN TENGAH",58,103,117,220
https://kawalpemilu.org#61947,"MENTENG, JEKAN RAYA, KOTA PALANGKARAYA, KALIMANTAN TENGAH",59,72,62,134
https://kawalpemilu.org#61947,"MENTENG, JEKAN RAYA, KOTA PALANGKARAYA, KALIMANTAN TENGAH",60,136,93,229
https://kawalpemilu.org#61947,"MENTENG, JEKAN RAYA, KOTA PALANGKARAYA, KALIMANTAN TENGAH",61,78,105,183
https://kawalpemilu.org#61947,"MENTENG, JEKAN RAYA, KOTA PALANGKARAYA, KALIMANTAN TENGAH",62,40,65,105
https://kawalpemilu.org#61947,"MENTENG, JEKAN RAYA, KOTA PALANGKARAYA, KALIMANTAN TENGAH",63,85,148,233
https://kawalpemilu.org#61947,"MENTENG, JEKAN RAYA, KOTA PALANGKARAYA, KALIMANTAN TENGAH",64,208,54,262
https://kawalpemilu.org#61947,"MENTENG, JEKAN RAYA, KOTA PALANGKARAYA, KALIMANTAN TENGAH",65,85,32,117
https://kawalpemilu.org#61947,"MENTENG, JEKAN RAYA, KOTA PALANGKARAYA, KALIMANTAN TENGAH",66,67,37,104
https://kawalpemilu.org#61947,"MENTENG, JEKAN RAYA, KOTA PALANGKARAYA, KALIMANTAN TENGAH",67,181,51,232
https://kawalpemilu.org#61947,"MENTENG, JEKAN RAYA, KOTA PALANGKARAYA, KALIMANTAN TENGAH",68,143,83,226
https://kawalpemilu.org#61947,"MENTENG, JEKAN RAYA, KOTA PALANGKARAYA, KALIMANTAN TENGAH",69,158,26,184
https://kawalpemilu.org#61947,"MENTENG, JEKAN RAYA, KOTA PALANGKARAYA, KALIMANTAN TENGAH",70,69,68,137
https://kawalpemilu.org#61947,"MENTENG, JEKAN RAYA, KOTA PALANGKARAYA, KALIMANTAN TENGAH",71,149,72,221
https://kawalpemilu.org#61947,"MENTENG, JEKAN RAYA, KOTA PALANGKARAYA, KALIMANTAN TENGAH",72,73,90,163
https://kawalpemilu.org#61947,"MENTENG, JEKAN RAYA, KOTA PALANGKARAYA, KALIMANTAN TENGAH",73,87,62,149
https://kawalpemilu.org#61947,"MENTENG, JEKAN RAYA, KOTA PALANGKARAYA, KALIMANTAN TENGAH",74,138,112,250
https://kawalpemilu.org#61947,"MENTENG, JEKAN RAYA, KOTA PALANGKARAYA, KALIMANTAN TENGAH",75,118,174,292
https://kawalpemilu.org#61947,"MENTENG, JEKAN RAYA, KOTA PALANGKARAYA, KALIMANTAN TENGAH",76,25,63,88
https://kawalpemilu.org#61947,"MENTENG, JEKAN RAYA, KOTA PALANGKARAYA, KALIMANTAN TENGAH",77,71,76,147
https://kawalpemilu.org#61947,"MENTENG, JEKAN RAYA, KOTA PALANGKARAYA, KALIMANTAN TENGAH",78,164,65,229
https://kawalpemilu.org#61947,"MENTENG, JEKAN RAYA, KOTA PALANGKARAYA, KALIMANTAN TENGAH",79,123,79,202
https://kawalpemilu.org#61947,"MENTENG, JEKAN RAYA, KOTA PALANGKARAYA, KALIMANTAN TENGAH",80,81,129,210
https://kawalpemilu.org#61947,"MENTENG, JEKAN RAYA, KOTA PALANGKARAYA, KALIMANTAN TENGAH",81,102,55,157
https://kawalpemilu.org#61947,"MENTENG, JEKAN RAYA, KOTA PALANGKARAYA, KALIMANTAN TENGAH",82,110,56,166
https://kawalpemilu.org#61947,"MENTENG, JEKAN RAYA, KOTA PALANGKARAYA, KALIMANTAN TENGAH",83,152,51,203
https://kawalpemilu.org#61947,"MENTENG, JEKAN RAYA, KOTA PALANGKARAYA, KALIMANTAN TENGAH",84,115,42,157
https://kawalpemilu.org#61947,"MENTENG, JEKAN RAYA, KOTA PALANGKARAYA, KALIMANTAN TENGAH",85,124,42,166
https://kawalpemilu.org#61947,"MENTENG, JEKAN RAYA, KOTA PALANGKARAYA, KALIMANTAN TENGAH",86,50,84,134
https://kawalpemilu.org#61947,"MENTENG, JEKAN RAYA, KOTA PALANGKARAYA, KALIMANTAN TENGAH",87,142,70,212
https://kawalpemilu.org#61947,"MENTENG, JEKAN RAYA, KOTA PALANGKARAYA, KALIMANTAN TENGAH",88,57,24,81
https://kawalpemilu.org#61947,"MENTENG, JEKAN RAYA, KOTA PALANGKARAYA, KALIMANTAN TENGAH",89,119,15,134
https://kawalpemilu.org#61947,"MENTENG, JEKAN RAYA, KOTA PALANGKARAYA, KALIMANTAN TENGAH",90,69,24,93
https://kawalpemilu.org#61947,"MENTENG, JEKAN RAYA, KOTA PALANGKARAYA, KALIMANTAN TENGAH",91,59,43,102
https://kawalpemilu.org#61947,"MENTENG, JEKAN RAYA, KOTA PALANGKARAYA, KALIMANTAN TENGAH",92,111,46,157
https://kawalpemilu.org#61947,"MENTENG, JEKAN RAYA, KOTA PALANGKARAYA, KALIMANTAN TENGAH",93,121,35,156
https://kawalpemilu.org#61947,"MENTENG, JEKAN RAYA, KOTA PALANGKARAYA, KALIMANTAN TENGAH",94,83,41,124
https://kawalpemilu.org#61947,"MENTENG, JEKAN RAYA, KOTA PALANGKARAYA, KALIMANTAN TENGAH",95,95,54,149
https://kawalpemilu.org#61947,"MENTENG, JEKAN RAYA, KOTA PALANGKARAYA, KALIMANTAN TENGAH",96,81,64,145
https://kawalpemilu.org#61947,"MENTENG, JEKAN RAYA, KOTA PALANGKARAYA, KALIMANTAN TENGAH",97,84,68,152
https://kawalpemilu.org#61947,"MENTENG, JEKAN RAYA, KOTA PALANGKARAYA, KALIMANTAN TENGAH",98,27,75,102
https://kawalpemilu.org#61947,"MENTENG, JEKAN RAYA, KOTA PALANGKARAYA, KALIMANTAN TENGAH",99,51,93,144
https://kawalpemilu.org#61947,"MENTENG, JEKAN RAYA, KOTA PALANGKARAYA, KALIMANTAN TENGAH",100,77,68,145
https://kawalpemilu.org#61947,"MENTENG, JEKAN RAYA, KOTA PALANGKARAYA, KALIMANTAN TENGAH",101,91,93,184
https://kawalpemilu.org#61947,"MENTENG, JEKAN RAYA, KOTA PALANGKARAYA, KALIMANTAN TENGAH",102,53,31,84
https://kawalpemilu.org#61947,"MENTENG, JEKAN RAYA, KOTA PALANGKARAYA, KALIMANTAN TENGAH",103,67,63,130
https://kawalpemilu.org#61947,"MENTENG, JEKAN RAYA, KOTA PALANGKARAYA, KALIMANTAN TENGAH",104,78,52,130
https://kawalpemilu.org#61947,"MENTENG, JEKAN RAYA, KOTA PALANGKARAYA, KALIMANTAN TENGAH",105,135,60,195
https://kawalpemilu.org#61947,"MENTENG, JEKAN RAYA, KOTA PALANGKARAYA, KALIMANTAN TENGAH",106,134,37,171
https://kawalpemilu.org#61947,"MENTENG, JEKAN RAYA, KOTA PALANGKARAYA, KALIMANTAN TENGAH",107,42,40,82
https://kawalpemilu.org#61947,"MENTENG, JEKAN RAYA, KOTA PALANGKARAYA, KALIMANTAN TENGAH",108,73,44,117
https://kawalpemilu.org#61947,"MENTENG, JEKAN RAYA, KOTA PALANGKARAYA, KALIMANTAN TENGAH",109,77,47,124
https://kawalpemilu.org#61947,"MENTENG, JEKAN RAYA, KOTA PALANGKARAYA, KALIMANTAN TENGAH",110,99,58,157
https://kawalpemilu.org#61947,"MENTENG, JEKAN RAYA, KOTA PALANGKARAYA, KALIMANTAN TENGAH",111,153,33,186
https://kawalpemilu.org#61947,"MENTENG, JEKAN RAYA, KOTA PALANGKARAYA, KALIMANTAN TENGAH",112,106,26,132
https://kawalpemilu.org#61947,"MENTENG, JEKAN RAYA, KOTA PALANGKARAYA, KALIMANTAN TENGAH",113,48,33,81
https://kawalpemilu.org#61947,"MENTENG, JEKAN RAYA, KOTA PALANGKARAYA, KALIMANTAN TENGAH",114,50,18,68
https://kawalpemilu.org#61947,"MENTENG, JEKAN RAYA, KOTA PALANGKARAYA, KALIMANTAN TENGAH",115,149,41,190
https://kawalpemilu.org#61947,"MENTENG, JEKAN RAYA, KOTA PALANGKARAYA, KALIMANTAN TENGAH",116,173,54,227
https://kawalpemilu.org#61947,"MENTENG, JEKAN RAYA, KOTA PALANGKARAYA, KALIMANTAN TENGAH",117,76,48,124
https://kawalpemilu.org#61947,"MENTENG, JEKAN RAYA, KOTA PALANGKARAYA, KALIMANTAN TENGAH",118,98,36,134
https://kawalpemilu.org#61947,"MENTENG, JEKAN RAYA, KOTA PALANGKARAYA, KALIMANTAN TENGAH",119,102,37,139
https://kawalpemilu.org#61947,"MENTENG, JEKAN RAYA, KOTA PALANGKARAYA, KALIMANTAN TENGAH",120,87,26,113
https://kawalpemilu.org#61947,"MENTENG, JEKAN RAYA, KOTA PALANGKARAYA, KALIMANTAN TENGAH",121,112,67,179
https://kawalpemilu.org#61947,"MENTENG, JEKAN RAYA, KOTA PALANGKARAYA, KALIMANTAN TENGAH",122,113,73,186
https://kawalpemilu.org#61947,"MENTENG, JEKAN RAYA, KOTA PALANGKARAYA, KALIMANTAN TENGAH",123,120,72,192
https://kawalpemilu.org#61947,"MENTENG, JEKAN RAYA, KOTA PALANGKARAYA, KALIMANTAN TENGAH",124,78,74,152
https://kawalpemilu.org#61947,"MENTENG, JEKAN RAYA, KOTA PALANGKARAYA, KALIMANTAN TENGAH",125,55,68,123
https://kawalpemilu.org#61947,"MENTENG, JEKAN RAYA, KOTA PALANGKARAYA, KALIMANTAN TENGAH",126,65,45,110
https://kawalpemilu.org#61947,"MENTENG, JEKAN RAYA, KOTA PALANGKARAYA, KALIMANTAN TENGAH",127,123,26,149
https://kawalpemilu.org#61947,"MENTENG, JEKAN RAYA, KOTA PALANGKARAYA, KALIMANTAN TENGAH",128,132,24,156
https://kawalpemilu.org#61947,"MENTENG, JEKAN RAYA, KOTA PALANGKARAYA, KALIMANTAN TENGAH",129,130,28,158
https://kawalpemilu.org#61947,"MENTENG, JEKAN RAYA, KOTA PALANGKARAYA, KALIMANTAN TENGAH",130,69,35,104
https://kawalpemilu.org#61947,"MENTENG, JEKAN RAYA, KOTA PALANGKARAYA, KALIMANTAN TENGAH",131,84,115,199
https://kawalpemilu.org#61947,"MENTENG, JEKAN RAYA, KOTA PALANGKARAYA, KALIMANTAN TENGAH",132,62,48,110
https://kawalpemilu.org#61947,"MENTENG, JEKAN RAYA, KOTA PALANGKARAYA, KALIMANTAN TENGAH",133,76,95,171
https://kawalpemilu.org#61947,"MENTENG, JEKAN RAYA, KOTA PALANGKARAYA, KALIMANTAN TENGAH",134,62,99,161
https://kawalpemilu.org#61947,"MENTENG, JEKAN RAYA, KOTA PALANGKARAYA, KALIMANTAN TENGAH",135,160,23,183
https://kawalpemilu.org#61947,"MENTENG, JEKAN RAYA, KOTA PALANGKARAYA, KALIMANTAN TENGAH",136,122,36,158
https://kawalpemilu.org#61947,"MENTENG, JEKAN RAYA, KOTA PALANGKARAYA, KALIMANTAN TENGAH",137,100,28,128
https://kawalpemilu.org#61947,"MENTENG, JEKAN RAYA, KOTA PALANGKARAYA, KALIMANTAN TENGAH",138,54,16,70
https://kawalpemilu.org#61947,"MENTENG, JEKAN RAYA, KOTA PALANGKARAYA, KALIMANTAN TENGAH",139,111,49,160
https://kawalpemilu.org#61947,"MENTENG, JEKAN RAYA, KOTA PALANGKARAYA, KALIMANTAN TENGAH",140,119,22,141
https://kawalpemilu.org#61947,"MENTENG, JEKAN RAYA, KOTA PALANGKARAYA, KALIMANTAN TENGAH",141,77,92,169
https://kawalpemilu.org#61947,"MENTENG, JEKAN RAYA, KOTA PALANGKARAYA, KALIMANTAN TENGAH",142,159,66,225
https://kawalpemilu.org#61947,"MENTENG, JEKAN RAYA, KOTA PALANGKARAYA, KALIMANTAN TENGAH",143,61,83,144
https://kawalpemilu.org#61947,"MENTENG, JEKAN RAYA, KOTA PALANGKARAYA, KALIMANTAN TENGAH",144,86,63,149
https://kawalpemilu.org#61947,"MENTENG, JEKAN RAYA, KOTA PALANGKARAYA, KALIMANTAN TENGAH",145,99,83,182
https://kawalpemilu.org#61947,"MENTENG, JEKAN RAYA, KOTA PALANGKARAYA, KALIMANTAN TENGAH",146,153,110,263
https://kawalpemilu.org#61947,"MENTENG, JEKAN RAYA, KOTA PALANGKARAYA, KALIMANTAN TENGAH",147,46,61,1
https://kawalpemilu.org#61947,"MENTENG, JEKAN RAYA, KOTA PALANGKARAYA, KALIMANTAN TENGAH",148,49,51,100
https://kawalpemilu.org#61947,"MENTENG, JEKAN RAYA, KOTA PALANGKARAYA, KALIMANTAN TENGAH",149,191,99,290
https://kawalpemilu.org#61947,"MENTENG, JEKAN RAYA, KOTA PALANGKARAYA, KALIMANTAN TENGAH",150,95,81,176
https://kawalpemilu.org#61947,"MENTENG, JEKAN RAYA, KOTA PALANGKARAYA, KALIMANTAN TENGAH",151,90,52,142
https://kawalpemilu.org#61947,"MENTENG, JEKAN RAYA, KOTA PALANGKARAYA, KALIMANTAN TENGAH",152,152,83,235
https://kawalpemilu.org#61947,"MENTENG, JEKAN RAYA, KOTA PALANGKARAYA, KALIMANTAN TENGAH",153,101,45,146
https://kawalpemilu.org#61947,"MENTENG, JEKAN RAYA, KOTA PALANGKARAYA, KALIMANTAN TENGAH",154,111,37,148
https://kawalpemilu.org#61947,"MENTENG, JEKAN RAYA, KOTA PALANGKARAYA, KALIMANTAN TENGAH",155,59,80,139
https://kawalpemilu.org#61947,"MENTENG, JEKAN RAYA, KOTA PALANGKARAYA, KALIMANTAN TENGAH",156,122,82,204
https://kawalpemilu.org#61948,"BUKIT TUNGGAL, JEKAN RAYA, KOTA PALANGKARAYA, KALIMANTAN TENGAH",1,112,106,218
https://kawalpemilu.org#61948,"BUKIT TUNGGAL, JEKAN RAYA, KOTA PALANGKARAYA, KALIMANTAN TENGAH",2,133,54,187
https://kawalpemilu.org#61948,"BUKIT TUNGGAL, JEKAN RAYA, KOTA PALANGKARAYA, KALIMANTAN TENGAH",3,90,51,141
https://kawalpemilu.org#61948,"BUKIT TUNGGAL, JEKAN RAYA, KOTA PALANGKARAYA, KALIMANTAN TENGAH",4,124,47,171
https://kawalpemilu.org#61948,"BUKIT TUNGGAL, JEKAN RAYA, KOTA PALANGKARAYA, KALIMANTAN TENGAH",5,92,76,168
https://kawalpemilu.org#61948,"BUKIT TUNGGAL, JEKAN RAYA, KOTA PALANGKARAYA, KALIMANTAN TENGAH",6,60,42,102
https://kawalpemilu.org#61948,"BUKIT TUNGGAL, JEKAN RAYA, KOTA PALANGKARAYA, KALIMANTAN TENGAH",7,86,50,136
https://kawalpemilu.org#61948,"BUKIT TUNGGAL, JEKAN RAYA, KOTA PALANGKARAYA, KALIMANTAN TENGAH",8,78,71,149
https://kawalpemilu.org#61948,"BUKIT TUNGGAL, JEKAN RAYA, KOTA PALANGKARAYA, KALIMANTAN TENGAH",9,97,48,145
https://kawalpemilu.org#61948,"BUKIT TUNGGAL, JEKAN RAYA, KOTA PALANGKARAYA, KALIMANTAN TENGAH",10,144,68,3
https://kawalpemilu.org#61948,"BUKIT TUNGGAL, JEKAN RAYA, KOTA PALANGKARAYA, KALIMANTAN TENGAH",11,152,52,204
https://kawalpemilu.org#61948,"BUKIT TUNGGAL, JEKAN RAYA, KOTA PALANGKARAYA, KALIMANTAN TENGAH",12,155,47,202
https://kawalpemilu.org#61948,"BUKIT TUNGGAL, JEKAN RAYA, KOTA PALANGKARAYA, KALIMANTAN TENGAH",13,137,47,184
https://kawalpemilu.org#61948,"BUKIT TUNGGAL, JEKAN RAYA, KOTA PALANGKARAYA, KALIMANTAN TENGAH",14,150,24,173
https://kawalpemilu.org#61948,"BUKIT TUNGGAL, JEKAN RAYA, KOTA PALANGKARAYA, KALIMANTAN TENGAH",15,104,73,177
https://kawalpemilu.org#61948,"BUKIT TUNGGAL, JEKAN RAYA, KOTA PALANGKARAYA, KALIMANTAN TENGAH",16,76,145,221
https://kawalpemilu.org#61948,"BUKIT TUNGGAL, JEKAN RAYA, KOTA PALANGKARAYA, KALIMANTAN TENGAH",17,83,136,219
https://kawalpemilu.org#61948,"BUKIT TUNGGAL, JEKAN RAYA, KOTA PALANGKARAYA, KALIMANTAN TENGAH",18,90,100,190
https://kawalpemilu.org#61948,"BUKIT TUNGGAL, JEKAN RAYA, KOTA PALANGKARAYA, KALIMANTAN TENGAH",19,146,45,191
https://kawalpemilu.org#61948,"BUKIT TUNGGAL, JEKAN RAYA, KOTA PALANGKARAYA, KALIMANTAN TENGAH",20,85,147,232
https://kawalpemilu.org#61948,"BUKIT TUNGGAL, JEKAN RAYA, KOTA PALANGKARAYA, KALIMANTAN TENGAH",21,76,45,121
https://kawalpemilu.org#61948,"BUKIT TUNGGAL, JEKAN RAYA, KOTA PALANGKARAYA, KALIMANTAN TENGAH",22,52,41,93
https://kawalpemilu.org#61948,"BUKIT TUNGGAL, JEKAN RAYA, KOTA PALANGKARAYA, KALIMANTAN TENGAH",23,133,88,221
https://kawalpemilu.org#61948,"BUKIT TUNGGAL, JEKAN RAYA, KOTA PALANGKARAYA, KALIMANTAN TENGAH",24,81,58,139
https://kawalpemilu.org#61948,"BUKIT TUNGGAL, JEKAN RAYA, KOTA PALANGKARAYA, KALIMANTAN TENGAH",25,86,37,123
https://kawalpemilu.org#61948,"BUKIT TUNGGAL, JEKAN RAYA, KOTA PALANGKARAYA, KALIMANTAN TENGAH",26,174,24,198
https://kawalpemilu.org#61948,"BUKIT TUNGGAL, JEKAN RAYA, KOTA PALANGKARAYA, KALIMANTAN TENGAH",27,56,185,241
https://kawalpemilu.org#61948,"BUKIT TUNGGAL, JEKAN RAYA, KOTA PALANGKARAYA, KALIMANTAN TENGAH",28,126,103,229
https://kawalpemilu.org#61948,"BUKIT TUNGGAL, JEKAN RAYA, KOTA PALANGKARAYA, KALIMANTAN TENGAH",29,78,88,166
https://kawalpemilu.org#61948,"BUKIT TUNGGAL, JEKAN RAYA, KOTA PALANGKARAYA, KALIMANTAN TENGAH",30,131,78,209
https://kawalpemilu.org#61948,"BUKIT TUNGGAL, JEKAN RAYA, KOTA PALANGKARAYA, KALIMANTAN TENGAH",31,132,80,212
https://kawalpemilu.org#61948,"BUKIT TUNGGAL, JEKAN RAYA, KOTA PALANGKARAYA, KALIMANTAN TENGAH",33,70,36,106
https://kawalpemilu.org#61948,"BUKIT TUNGGAL, JEKAN RAYA, KOTA PALANGKARAYA, KALIMANTAN TENGAH",34,89,61,150
https://kawalpemilu.org#61948,"BUKIT TUNGGAL, JEKAN RAYA, KOTA PALANGKARAYA, KALIMANTAN TENGAH",35,135,122,257
https://kawalpemilu.org#61948,"BUKIT TUNGGAL, JEKAN RAYA, KOTA PALANGKARAYA, KALIMANTAN TENGAH",36,80,71,151
https://kawalpemilu.org#61948,"BUKIT TUNGGAL, JEKAN RAYA, KOTA PALANGKARAYA, KALIMANTAN TENGAH",37,160,53,213
https://kawalpemilu.org#61948,"BUKIT TUNGGAL, JEKAN RAYA, KOTA PALANGKARAYA, KALIMANTAN TENGAH",38,134,28,162
https://kawalpemilu.org#61948,"BUKIT TUNGGAL, JEKAN RAYA, KOTA PALANGKARAYA, KALIMANTAN TENGAH",39,126,120,246
https://kawalpemilu.org#61948,"BUKIT TUNGGAL, JEKAN RAYA, KOTA PALANGKARAYA, KALIMANTAN TENGAH",40,100,38,138
https://kawalpemilu.org#61948,"BUKIT TUNGGAL, JEKAN RAYA, KOTA PALANGKARAYA, KALIMANTAN TENGAH",41,53,80,133
https://kawalpemilu.org#61948,"BUKIT TUNGGAL, JEKAN RAYA, KOTA PALANGKARAYA, KALIMANTAN TENGAH",42,66,41,107
https://kawalpemilu.org#61948,"BUKIT TUNGGAL, JEKAN RAYA, KOTA PALANGKARAYA, KALIMANTAN TENGAH",43,72,73,145
https://kawalpemilu.org#61948,"BUKIT TUNGGAL, JEKAN RAYA, KOTA PALANGKARAYA, KALIMANTAN TENGAH",44,77,31,108
https://kawalpemilu.org#61948,"BUKIT TUNGGAL, JEKAN RAYA, KOTA PALANGKARAYA, KALIMANTAN TENGAH",45,123,111,234
https://kawalpemilu.org#61948,"BUKIT TUNGGAL, JEKAN RAYA, KOTA PALANGKARAYA, KALIMANTAN TENGAH",46,99,90,189
https://kawalpemilu.org#61948,"BUKIT TUNGGAL, JEKAN RAYA, KOTA PALANGKARAYA, KALIMANTAN TENGAH",47,129,55,184
https://kawalpemilu.org#61948,"BUKIT TUNGGAL, JEKAN RAYA, KOTA PALANGKARAYA, KALIMANTAN TENGAH",48,111,83,194
https://kawalpemilu.org#61948,"BUKIT TUNGGAL, JEKAN RAYA, KOTA PALANGKARAYA, KALIMANTAN TENGAH",49,156,75,231
https://kawalpemilu.org#61948,"BUKIT TUNGGAL, JEKAN RAYA, KOTA PALANGKARAYA, KALIMANTAN TENGAH",50,137,89,226
https://kawalpemilu.org#61948,"BUKIT TUNGGAL, JEKAN RAYA, KOTA PALANGKARAYA, KALIMANTAN TENGAH",51,110,128,238
https://kawalpemilu.org#61948,"BUKIT TUNGGAL, JEKAN RAYA, KOTA PALANGKARAYA, KALIMANTAN TENGAH",52,63,82,145
https://kawalpemilu.org#61948,"BUKIT TUNGGAL, JEKAN RAYA, KOTA PALANGKARAYA, KALIMANTAN TENGAH",53,68,60,128
https://kawalpemilu.org#61948,"BUKIT TUNGGAL, JEKAN RAYA, KOTA PALANGKARAYA, KALIMANTAN TENGAH",54,84,69,153
https://kawalpemilu.org#61948,"BUKIT TUNGGAL, JEKAN RAYA, KOTA PALANGKARAYA, KALIMANTAN TENGAH",55,91,67,158
https://kawalpemilu.org#61948,"BUKIT TUNGGAL, JEKAN RAYA, KOTA PALANGKARAYA, KALIMANTAN TENGAH",56,106,79,185
https://kawalpemilu.org#61948,"BUKIT TUNGGAL, JEKAN RAYA, KOTA PALANGKARAYA, KALIMANTAN TENGAH",57,70,57,127
https://kawalpemilu.org#61948,"BUKIT TUNGGAL, JEKAN RAYA, KOTA PALANGKARAYA, KALIMANTAN TENGAH",58,109,95,204
https://kawalpemilu.org#61948,"BUKIT TUNGGAL, JEKAN RAYA, KOTA PALANGKARAYA, KALIMANTAN TENGAH",59,80,46,126
https://kawalpemilu.org#61948,"BUKIT TUNGGAL, JEKAN RAYA, KOTA PALANGKARAYA, KALIMANTAN TENGAH",60,78,77,155
https://kawalpemilu.org#61948,"BUKIT TUNGGAL, JEKAN RAYA, KOTA PALANGKARAYA, KALIMANTAN TENGAH",61,107,66,173
https://kawalpemilu.org#61948,"BUKIT TUNGGAL, JEKAN RAYA, KOTA PALANGKARAYA, KALIMANTAN TENGAH",62,82,34,116
https://kawalpemilu.org#61948,"BUKIT TUNGGAL, JEKAN RAYA, KOTA PALANGKARAYA, KALIMANTAN TENGAH",63,188,37,225
https://kawalpemilu.org#61948,"BUKIT TUNGGAL, JEKAN RAYA, KOTA PALANGKARAYA, KALIMANTAN TENGAH",64,121,72,193
https://kawalpemilu.org#61948,"BUKIT TUNGGAL, JEKAN RAYA, KOTA PALANGKARAYA, KALIMANTAN TENGAH",65,76,47,123
https://kawalpemilu.org#61948,"BUKIT TUNGGAL, JEKAN RAYA, KOTA PALANGKARAYA, KALIMANTAN TENGAH",66,152,59,211
https://kawalpemilu.org#61948,"BUKIT TUNGGAL, JEKAN RAYA, KOTA PALANGKARAYA, KALIMANTAN TENGAH",67,157,90,247
https://kawalpemilu.org#61948,"BUKIT TUNGGAL, JEKAN RAYA, KOTA PALANGKARAYA, KALIMANTAN TENGAH",68,65,68,133
https://kawalpemilu.org#61948,"BUKIT TUNGGAL, JEKAN RAYA, KOTA PALANGKARAYA, KALIMANTAN TENGAH",69,89,47,136
https://kawalpemilu.org#61948,"BUKIT TUNGGAL, JEKAN RAYA, KOTA PALANGKARAYA, KALIMANTAN TENGAH",70,85,37,122
https://kawalpemilu.org#61948,"BUKIT TUNGGAL, JEKAN RAYA, KOTA PALANGKARAYA, KALIMANTAN TENGAH",71,108,111,219
https://kawalpemilu.org#61948,"BUKIT TUNGGAL, JEKAN RAYA, KOTA PALANGKARAYA, KALIMANTAN TENGAH",72,106,53,159
https://kawalpemilu.org#61948,"BUKIT TUNGGAL, JEKAN RAYA, KOTA PALANGKARAYA, KALIMANTAN TENGAH",73,127,80,207
https://kawalpemilu.org#61948,"BUKIT TUNGGAL, JEKAN RAYA, KOTA PALANGKARAYA, KALIMANTAN TENGAH",74,66,78,144
https://kawalpemilu.org#61948,"BUKIT TUNGGAL, JEKAN RAYA, KOTA PALANGKARAYA, KALIMANTAN TENGAH",75,143,39,182
https://kawalpemilu.org#61948,"BUKIT TUNGGAL, JEKAN RAYA, KOTA PALANGKARAYA, KALIMANTAN TENGAH",76,118,53,171
https://kawalpemilu.org#61948,"BUKIT TUNGGAL, JEKAN RAYA, KOTA PALANGKARAYA, KALIMANTAN TENGAH",77,116,66,182
https://kawalpemilu.org#61948,"BUKIT TUNGGAL, JEKAN RAYA, KOTA PALANGKARAYA, KALIMANTAN TENGAH",78,116,30,146
https://kawalpemilu.org#61948,"BUKIT TUNGGAL, JEKAN RAYA, KOTA PALANGKARAYA, KALIMANTAN TENGAH",79,134,67,201
https://kawalpemilu.org#61948,"BUKIT TUNGGAL, JEKAN RAYA, KOTA PALANGKARAYA, KALIMANTAN TENGAH",80,53,119,172
https://kawalpemilu.org#61948,"BUKIT TUNGGAL, JEKAN RAYA, KOTA PALANGKARAYA, KALIMANTAN TENGAH",81,112,64,176
https://kawalpemilu.org#61948,"BUKIT TUNGGAL, JEKAN RAYA, KOTA PALANGKARAYA, KALIMANTAN TENGAH",82,121,73,194
https://kawalpemilu.org#61948,"BUKIT TUNGGAL, JEKAN RAYA, KOTA PALANGKARAYA, KALIMANTAN TENGAH",83,109,72,181
https://kawalpemilu.org#61948,"BUKIT TUNGGAL, JEKAN RAYA, KOTA PALANGKARAYA, KALIMANTAN TENGAH",84,139,105,244
https://kawalpemilu.org#61948,"BUKIT TUNGGAL, JEKAN RAYA, KOTA PALANGKARAYA, KALIMANTAN TENGAH",85,111,110,221
https://kawalpemilu.org#61948,"BUKIT TUNGGAL, JEKAN RAYA, KOTA PALANGKARAYA, KALIMANTAN TENGAH",86,86,84,170
https://kawalpemilu.org#61948,"BUKIT TUNGGAL, JEKAN RAYA, KOTA PALANGKARAYA, KALIMANTAN TENGAH",87,155,112,267
https://kawalpemilu.org#61948,"BUKIT TUNGGAL, JEKAN RAYA, KOTA PALANGKARAYA, KALIMANTAN TENGAH",88,126,91,217
https://kawalpemilu.org#61948,"BUKIT TUNGGAL, JEKAN RAYA, KOTA PALANGKARAYA, KALIMANTAN TENGAH",89,109,45,154
https://kawalpemilu.org#61948,"BUKIT TUNGGAL, JEKAN RAYA, KOTA PALANGKARAYA, KALIMANTAN TENGAH",90,152,48,200
https://kawalpemilu.org#61948,"BUKIT TUNGGAL, JEKAN RAYA, KOTA PALANGKARAYA, KALIMANTAN TENGAH",91,101,83,184
https://kawalpemilu.org#61948,"BUKIT TUNGGAL, JEKAN RAYA, KOTA PALANGKARAYA, KALIMANTAN TENGAH",92,116,52,168
https://kawalpemilu.org#61948,"BUKIT TUNGGAL, JEKAN RAYA, KOTA PALANGKARAYA, KALIMANTAN TENGAH",93,106,40,146
https://kawalpemilu.org#61948,"BUKIT TUNGGAL, JEKAN RAYA, KOTA PALANGKARAYA, KALIMANTAN TENGAH",94,113,75,188
https://kawalpemilu.org#61948,"BUKIT TUNGGAL, JEKAN RAYA, KOTA PALANGKARAYA, KALIMANTAN TENGAH",95,107,54,161
https://kawalpemilu.org#61948,"BUKIT TUNGGAL, JEKAN RAYA, KOTA PALANGKARAYA, KALIMANTAN TENGAH",96,117,81,198
https://kawalpemilu.org#61948,"BUKIT TUNGGAL, JEKAN RAYA, KOTA PALANGKARAYA, KALIMANTAN TENGAH",97,101,71,172
https://kawalpemilu.org#61948,"BUKIT TUNGGAL, JEKAN RAYA, KOTA PALANGKARAYA, KALIMANTAN TENGAH",98,153,16,169
https://kawalpemilu.org#61948,"BUKIT TUNGGAL, JEKAN RAYA, KOTA PALANGKARAYA, KALIMANTAN TENGAH",99,141,54,195
https://kawalpemilu.org#61948,"BUKIT TUNGGAL, JEKAN RAYA, KOTA PALANGKARAYA, KALIMANTAN TENGAH",100,71,17,88
https://kawalpemilu.org#61948,"BUKIT TUNGGAL, JEKAN RAYA, KOTA PALANGKARAYA, KALIMANTAN TENGAH",101,79,45,124
https://kawalpemilu.org#61948,"BUKIT TUNGGAL, JEKAN RAYA, KOTA PALANGKARAYA, KALIMANTAN TENGAH",102,84,65,149
https://kawalpemilu.org#61948,"BUKIT TUNGGAL, JEKAN RAYA, KOTA PALANGKARAYA, KALIMANTAN TENGAH",103,65,34,99
https://kawalpemilu.org#61948,"BUKIT TUNGGAL, JEKAN RAYA, KOTA PALANGKARAYA, KALIMANTAN TENGAH",104,104,44,148
https://kawalpemilu.org#61948,"BUKIT TUNGGAL, JEKAN RAYA, KOTA PALANGKARAYA, KALIMANTAN TENGAH",105,105,63,168
https://kawalpemilu.org#61948,"BUKIT TUNGGAL, JEKAN RAYA, KOTA PALANGKARAYA, KALIMANTAN TENGAH",106,114,56,170
https://kawalpemilu.org#61948,"BUKIT TUNGGAL, JEKAN RAYA, KOTA PALANGKARAYA, KALIMANTAN TENGAH",107,132,75,207
https://kawalpemilu.org#61948,"BUKIT TUNGGAL, JEKAN RAYA, KOTA PALANGKARAYA, KALIMANTAN TENGAH",108,83,64,147
https://kawalpemilu.org#61948,"BUKIT TUNGGAL, JEKAN RAYA, KOTA PALANGKARAYA, KALIMANTAN TENGAH",109,160,32,192
https://kawalpemilu.org#61948,"BUKIT TUNGGAL, JEKAN RAYA, KOTA PALANGKARAYA, KALIMANTAN TENGAH",110,77,86,163
https://kawalpemilu.org#61948,"BUKIT TUNGGAL, JEKAN RAYA, KOTA PALANGKARAYA, KALIMANTAN TENGAH",111,80,22,102
https://kawalpemilu.org#61948,"BUKIT TUNGGAL, JEKAN RAYA, KOTA PALANGKARAYA, KALIMANTAN TENGAH",112,55,23,78
https://kawalpemilu.org#61948,"BUKIT TUNGGAL, JEKAN RAYA, KOTA PALANGKARAYA, KALIMANTAN TENGAH",113,63,32,95
https://kawalpemilu.org#61948,"BUKIT TUNGGAL, JEKAN RAYA, KOTA PALANGKARAYA, KALIMANTAN TENGAH",114,60,43,103
https://kawalpemilu.org#61948,"BUKIT TUNGGAL, JEKAN RAYA, KOTA PALANGKARAYA, KALIMANTAN TENGAH",115,182,37,219
https://kawalpemilu.org#61948,"BUKIT TUNGGAL, JEKAN RAYA, KOTA PALANGKARAYA, KALIMANTAN TENGAH",116,59,73,132
https://kawalpemilu.org#61948,"BUKIT TUNGGAL, JEKAN RAYA, KOTA PALANGKARAYA, KALIMANTAN TENGAH",117,77,64,141
https://kawalpemilu.org#61948,"BUKIT TUNGGAL, JEKAN RAYA, KOTA PALANGKARAYA, KALIMANTAN TENGAH",118,129,55,184
https://kawalpemilu.org#61948,"BUKIT TUNGGAL, JEKAN RAYA, KOTA PALANGKARAYA, KALIMANTAN TENGAH",119,93,29,122
https://kawalpemilu.org#61948,"BUKIT TUNGGAL, JEKAN RAYA, KOTA PALANGKARAYA, KALIMANTAN TENGAH",120,124,80,204
https://kawalpemilu.org#61948,"BUKIT TUNGGAL, JEKAN RAYA, KOTA PALANGKARAYA, KALIMANTAN TENGAH",121,107,45,152
https://kawalpemilu.org#61948,"BUKIT TUNGGAL, JEKAN RAYA, KOTA PALANGKARAYA, KALIMANTAN TENGAH",122,117,62,179
https://kawalpemilu.org#61948,"BUKIT TUNGGAL, JEKAN RAYA, KOTA PALANGKARAYA, KALIMANTAN TENGAH",123,107,79,186
https://kawalpemilu.org#61948,"BUKIT TUNGGAL, JEKAN RAYA, KOTA PALANGKARAYA, KALIMANTAN TENGAH",124,125,84,209
https://kawalpemilu.org#61948,"BUKIT TUNGGAL, JEKAN RAYA, KOTA PALANGKARAYA, KALIMANTAN TENGAH",125,51,63,114
https://kawalpemilu.org#61948,"BUKIT TUNGGAL, JEKAN RAYA, KOTA PALANGKARAYA, KALIMANTAN TENGAH",126,60,61,121
https://kawalpemilu.org#61948,"BUKIT TUNGGAL, JEKAN RAYA, KOTA PALANGKARAYA, KALIMANTAN TENGAH",127,75,60,135
https://kawalpemilu.org#61948,"BUKIT TUNGGAL, JEKAN RAYA, KOTA PALANGKARAYA, KALIMANTAN TENGAH",128,117,89,206
https://kawalpemilu.org#61948,"BUKIT TUNGGAL, JEKAN RAYA, KOTA PALANGKARAYA, KALIMANTAN TENGAH",129,117,49,161
https://kawalpemilu.org#61948,"BUKIT TUNGGAL, JEKAN RAYA, KOTA PALANGKARAYA, KALIMANTAN TENGAH",130,151,25,176
https://kawalpemilu.org#61948,"BUKIT TUNGGAL, JEKAN RAYA, KOTA PALANGKARAYA, KALIMANTAN TENGAH",131,107,53,160
https://kawalpemilu.org#61948,"BUKIT TUNGGAL, JEKAN RAYA, KOTA PALANGKARAYA, KALIMANTAN TENGAH",132,74,45,119
https://kawalpemilu.org#61948,"BUKIT TUNGGAL, JEKAN RAYA, KOTA PALANGKARAYA, KALIMANTAN TENGAH",133,129,37,166
https://kawalpemilu.org#61948,"BUKIT TUNGGAL, JEKAN RAYA, KOTA PALANGKARAYA, KALIMANTAN TENGAH",134,102,43,145
https://kawalpemilu.org#61948,"BUKIT TUNGGAL, JEKAN RAYA, KOTA PALANGKARAYA, KALIMANTAN TENGAH",135,98,52,150
https://kawalpemilu.org#61948,"BUKIT TUNGGAL, JEKAN RAYA, KOTA PALANGKARAYA, KALIMANTAN TENGAH",136,105,43,148
https://kawalpemilu.org#61948,"BUKIT TUNGGAL, JEKAN RAYA, KOTA PALANGKARAYA, KALIMANTAN TENGAH",137,132,70,202
https://kawalpemilu.org#61948,"BUKIT TUNGGAL, JEKAN RAYA, KOTA PALANGKARAYA, KALIMANTAN TENGAH",138,72,82,154
https://kawalpemilu.org#61948,"BUKIT TUNGGAL, JEKAN RAYA, KOTA PALANGKARAYA, KALIMANTAN TENGAH",139,120,59,179
https://kawalpemilu.org#61948,"BUKIT TUNGGAL, JEKAN RAYA, KOTA PALANGKARAYA, KALIMANTAN TENGAH",140,111,43,154
https://kawalpemilu.org#61948,"BUKIT TUNGGAL, JEKAN RAYA, KOTA PALANGKARAYA, KALIMANTAN TENGAH",141,88,71,159
https://kawalpemilu.org#61948,"BUKIT TUNGGAL, JEKAN RAYA, KOTA PALANGKARAYA, KALIMANTAN TENGAH",142,111,38,149
https://kawalpemilu.org#61948,"BUKIT TUNGGAL, JEKAN RAYA, KOTA PALANGKARAYA, KALIMANTAN TENGAH",143,47,29,76
https://kawalpemilu.org#61948,"BUKIT TUNGGAL, JEKAN RAYA, KOTA PALANGKARAYA, KALIMANTAN TENGAH",144,51,33,84
https://kawalpemilu.org#61948,"BUKIT TUNGGAL, JEKAN RAYA, KOTA PALANGKARAYA, KALIMANTAN TENGAH",145,100,61,161
https://kawalpemilu.org#61948,"BUKIT TUNGGAL, JEKAN RAYA, KOTA PALANGKARAYA, KALIMANTAN TENGAH",146,108,76,184
https://kawalpemilu.org#61948,"BUKIT TUNGGAL, JEKAN RAYA, KOTA PALANGKARAYA, KALIMANTAN TENGAH",147,102,60,162
https://kawalpemilu.org#61949,"PETUK KATIMPUN, JEKAN RAYA, KOTA PALANGKARAYA, KALIMANTAN TENGAH",1,113,27,140
https://kawalpemilu.org#61949,"PETUK KATIMPUN, JEKAN RAYA, KOTA PALANGKARAYA, KALIMANTAN TENGAH",2,157,29,186
https://kawalpemilu.org#61949,"PETUK KATIMPUN, JEKAN RAYA, KOTA PALANGKARAYA, KALIMANTAN TENGAH",3,85,62,147
https://kawalpemilu.org#61949,"PETUK KATIMPUN, JEKAN RAYA, KOTA PALANGKARAYA, KALIMANTAN TENGAH",4,148,41,189
https://kawalpemilu.org#61949,"PETUK KATIMPUN, JEKAN RAYA, KOTA PALANGKARAYA, KALIMANTAN TENGAH",5,118,108,226
https://kawalpemilu.org#61949,"PETUK KATIMPUN, JEKAN RAYA, KOTA PALANGKARAYA, KALIMANTAN TENGAH",6,57,39,96
https://kawalpemilu.org#61949,"PETUK KATIMPUN, JEKAN RAYA, KOTA PALANGKARAYA, KALIMANTAN TENGAH",7,66,21,87
https://kawalpemilu.org#61949,"PETUK KATIMPUN, JEKAN RAYA, KOTA PALANGKARAYA, KALIMANTAN TENGAH",8,106,11,117
https://kawalpemilu.org#61949,"PETUK KATIMPUN, JEKAN RAYA, KOTA PALANGKARAYA, KALIMANTAN TENGAH",9,78,39,117
https://kawalpemilu.org#61949,"PETUK KATIMPUN, JEKAN RAYA, KOTA PALANGKARAYA, KALIMANTAN TENGAH",10,106,33,139
https://kawalpemilu.org#61951,"BERENG BENGKEL, SABANGAU, KOTA PALANGKARAYA, KALIMANTAN TENGAH",1,128,40,168
https://kawalpemilu.org#61951,"BERENG BENGKEL, SABANGAU, KOTA PALANGKARAYA, KALIMANTAN TENGAH",2,128,29,157
https://kawalpemilu.org#61951,"BERENG BENGKEL, SABANGAU, KOTA PALANGKARAYA, KALIMANTAN TENGAH",3,128,46,174
https://kawalpemilu.org#61951,"BERENG BENGKEL, SABANGAU, KOTA PALANGKARAYA, KALIMANTAN TENGAH",4,115,37,152
https://kawalpemilu.org#61952,"KALAMPANGAN, SABANGAU, KOTA PALANGKARAYA, KALIMANTAN TENGAH",1,81,77,158
https://kawalpemilu.org#61952,"KALAMPANGAN, SABANGAU, KOTA PALANGKARAYA, KALIMANTAN TENGAH",2,154,102,256
https://kawalpemilu.org#61952,"KALAMPANGAN, SABANGAU, KOTA PALANGKARAYA, KALIMANTAN TENGAH",3,118,74,192
https://kawalpemilu.org#61952,"KALAMPANGAN, SABANGAU, KOTA PALANGKARAYA, KALIMANTAN TENGAH",4,115,98,213
https://kawalpemilu.org#61952,"KALAMPANGAN, SABANGAU, KOTA PALANGKARAYA, KALIMANTAN TENGAH",5,101,81,182
https://kawalpemilu.org#61952,"KALAMPANGAN, SABANGAU, KOTA PALANGKARAYA, KALIMANTAN TENGAH",6,156,102,258
https://kawalpemilu.org#61952,"KALAMPANGAN, SABANGAU, KOTA PALANGKARAYA, KALIMANTAN TENGAH",7,155,111,266
https://kawalpemilu.org#61952,"KALAMPANGAN, SABANGAU, KOTA PALANGKARAYA, KALIMANTAN TENGAH",8,77,77,154
https://kawalpemilu.org#61952,"KALAMPANGAN, SABANGAU, KOTA PALANGKARAYA, KALIMANTAN TENGAH",9,124,124,248
https://kawalpemilu.org#61952,"KALAMPANGAN, SABANGAU, KOTA PALANGKARAYA, KALIMANTAN TENGAH",10,64,77,141
https://kawalpemilu.org#61952,"KALAMPANGAN, SABANGAU, KOTA PALANGKARAYA, KALIMANTAN TENGAH",11,103,66,169
https://kawalpemilu.org#61952,"KALAMPANGAN, SABANGAU, KOTA PALANGKARAYA, KALIMANTAN TENGAH",12,117,77,194
https://kawalpemilu.org#61952,"KALAMPANGAN, SABANGAU, KOTA PALANGKARAYA, KALIMANTAN TENGAH",13,93,59,152
https://kawalpemilu.org#61952,"KALAMPANGAN, SABANGAU, KOTA PALANGKARAYA, KALIMANTAN TENGAH",14,77,88,165
https://kawalpemilu.org#61953,"KERENG BANGKIRAI, SABANGAU, KOTA PALANGKARAYA, KALIMANTAN TENGAH",1,114,76,190
https://kawalpemilu.org#61953,"KERENG BANGKIRAI, SABANGAU, KOTA PALANGKARAYA, KALIMANTAN TENGAH",2,140,99,239
https://kawalpemilu.org#61953,"KERENG BANGKIRAI, SABANGAU, KOTA PALANGKARAYA, KALIMANTAN TENGAH",3,169,54,223
https://kawalpemilu.org#61953,"KERENG BANGKIRAI, SABANGAU, KOTA PALANGKARAYA, KALIMANTAN TENGAH",4,150,52,202
https://kawalpemilu.org#61953,"KERENG BANGKIRAI, SABANGAU, KOTA PALANGKARAYA, KALIMANTAN TENGAH",5,88,47,135
https://kawalpemilu.org#61953,"KERENG BANGKIRAI, SABANGAU, KOTA PALANGKARAYA, KALIMANTAN TENGAH",6,128,89,217
https://kawalpemilu.org#61953,"KERENG BANGKIRAI, SABANGAU, KOTA PALANGKARAYA, KALIMANTAN TENGAH",7,65,91,156
https://kawalpemilu.org#61953,"KERENG BANGKIRAI, SABANGAU, KOTA PALANGKARAYA, KALIMANTAN TENGAH",8,103,68,171
https://kawalpemilu.org#61953,"KERENG BANGKIRAI, SABANGAU, KOTA PALANGKARAYA, KALIMANTAN TENGAH",9,106,43,149
https://kawalpemilu.org#61953,"KERENG BANGKIRAI, SABANGAU, KOTA PALANGKARAYA, KALIMANTAN TENGAH",10,87,67,154
https://kawalpemilu.org#61953,"KERENG BANGKIRAI, SABANGAU, KOTA PALANGKARAYA, KALIMANTAN TENGAH",11,129,76,205
https://kawalpemilu.org#61953,"KERENG BANGKIRAI, SABANGAU, KOTA PALANGKARAYA, KALIMANTAN TENGAH",12,99,23,122
https://kawalpemilu.org#61953,"KERENG BANGKIRAI, SABANGAU, KOTA PALANGKARAYA, KALIMANTAN TENGAH",13,173,75,248
https://kawalpemilu.org#61953,"KERENG BANGKIRAI, SABANGAU, KOTA PALANGKARAYA, KALIMANTAN TENGAH",14,148,64,112
https://kawalpemilu.org#61953,"KERENG BANGKIRAI, SABANGAU, KOTA PALANGKARAYA, KALIMANTAN TENGAH",15,116,59,175
https://kawalpemilu.org#61953,"KERENG BANGKIRAI, SABANGAU, KOTA PALANGKARAYA, KALIMANTAN TENGAH",16,90,76,166
https://kawalpemilu.org#61953,"KERENG BANGKIRAI, SABANGAU, KOTA PALANGKARAYA, KALIMANTAN TENGAH",17,136,48,184
https://kawalpemilu.org#61953,"KERENG BANGKIRAI, SABANGAU, KOTA PALANGKARAYA, KALIMANTAN TENGAH",18,141,44,185
https://kawalpemilu.org#61953,"KERENG BANGKIRAI, SABANGAU, KOTA PALANGKARAYA, KALIMANTAN TENGAH",19,148,42,190
https://kawalpemilu.org#61953,"KERENG BANGKIRAI, SABANGAU, KOTA PALANGKARAYA, KALIMANTAN TENGAH",20,68,47,115
https://kawalpemilu.org#61953,"KERENG BANGKIRAI, SABANGAU, KOTA PALANGKARAYA, KALIMANTAN TENGAH",21,117,97,214
https://kawalpemilu.org#61953,"KERENG BANGKIRAI, SABANGAU, KOTA PALANGKARAYA, KALIMANTAN TENGAH",22,65,70,135
https://kawalpemilu.org#61953,"KERENG BANGKIRAI, SABANGAU, KOTA PALANGKARAYA, KALIMANTAN TENGAH",23,88,55,143
https://kawalpemilu.org#61953,"KERENG BANGKIRAI, SABANGAU, KOTA PALANGKARAYA, KALIMANTAN TENGAH",24,98,62,160
https://kawalpemilu.org#61953,"KERENG BANGKIRAI, SABANGAU, KOTA PALANGKARAYA, KALIMANTAN TENGAH",25,131,28,159
https://kawalpemilu.org#61953,"KERENG BANGKIRAI, SABANGAU, KOTA PALANGKARAYA, KALIMANTAN TENGAH",26,73,44,117
https://kawalpemilu.org#61953,"KERENG BANGKIRAI, SABANGAU, KOTA PALANGKARAYA, KALIMANTAN TENGAH",27,165,93,258
https://kawalpemilu.org#61953,"KERENG BANGKIRAI, SABANGAU, KOTA PALANGKARAYA, KALIMANTAN TENGAH",28,99,29,128
https://kawalpemilu.org#61953,"KERENG BANGKIRAI, SABANGAU, KOTA PALANGKARAYA, KALIMANTAN TENGAH",29,170,55,225
https://kawalpemilu.org#61954,"KAMELOH BARU, SABANGAU, KOTA PALANGKARAYA, KALIMANTAN TENGAH",1,109,97,206
https://kawalpemilu.org#61954,"KAMELOH BARU, SABANGAU, KOTA PALANGKARAYA, KALIMANTAN TENGAH",2,201,42,243
https://kawalpemilu.org#61955,"DANAU TUNDAI, SABANGAU, KOTA PALANGKARAYA, KALIMANTAN TENGAH",1,110,25,135
https://kawalpemilu.org#61956,"SABARU, SABANGAU, KOTA PALANGKARAYA, KALIMANTAN TENGAH",1,162,66,228
https://kawalpemilu.org#61956,"SABARU, SABANGAU, KOTA PALANGKARAYA, KALIMANTAN TENGAH",2,149,46,195
https://kawalpemilu.org#61956,"SABARU, SABANGAU, KOTA PALANGKARAYA, KALIMANTAN TENGAH",3,132,53,185
https://kawalpemilu.org#61956,"SABARU, SABANGAU, KOTA PALANGKARAYA, KALIMANTAN TENGAH",4,112,68,180
https://kawalpemilu.org#61956,"SABARU, SABANGAU, KOTA PALANGKARAYA, KALIMANTAN TENGAH",5,100,100,200
https://kawalpemilu.org#61956,"SABARU, SABANGAU, KOTA PALANGKARAYA, KALIMANTAN TENGAH",6,141,45,186
https://kawalpemilu.org#61956,"SABARU, SABANGAU, KOTA PALANGKARAYA, KALIMANTAN TENGAH",7,98,36,134
https://kawalpemilu.org#61956,"SABARU, SABANGAU, KOTA PALANGKARAYA, KALIMANTAN TENGAH",8,88,114,202
https://kawalpemilu.org#61956,"SABARU, SABANGAU, KOTA PALANGKARAYA, KALIMANTAN TENGAH",9,86,59,145
https://kawalpemilu.org#61956,"SABARU, SABANGAU, KOTA PALANGKARAYA, KALIMANTAN TENGAH",10,164,50,214
https://kawalpemilu.org#61956,"SABARU, SABANGAU, KOTA PALANGKARAYA, KALIMANTAN TENGAH",11,113,60,173
https://kawalpemilu.org#61956,"SABARU, SABANGAU, KOTA PALANGKARAYA, KALIMANTAN TENGAH",12,102,49,151
https://kawalpemilu.org#61956,"SABARU, SABANGAU, KOTA PALANGKARAYA, KALIMANTAN TENGAH",13,131,51,182
https://kawalpemilu.org#61956,"SABARU, SABANGAU, KOTA PALANGKARAYA, KALIMANTAN TENGAH",14,129,78,207
https://kawalpemilu.org#61958,"PETUK BUKIT, RAKUMPIT, KOTA PALANGKARAYA, KALIMANTAN TENGAH",1,152,24,176
https://kawalpemilu.org#61958,"PETUK BUKIT, RAKUMPIT, KOTA PALANGKARAYA, KALIMANTAN TENGAH",2,88,17,0
https://kawalpemilu.org#61958,"PETUK BUKIT, RAKUMPIT, KOTA PALANGKARAYA, KALIMANTAN TENGAH",3,139,13,152
https://kawalpemilu.org#61958,"PETUK BUKIT, RAKUMPIT, KOTA PALANGKARAYA, KALIMANTAN TENGAH",4,139,25,164
https://kawalpemilu.org#61959,"PANJEHANG, RAKUMPIT, KOTA PALANGKARAYA, KALIMANTAN TENGAH",1,141,11,152
https://kawalpemilu.org#61960,"PETUK BARUNAI, RAKUMPIT, KOTA PALANGKARAYA, KALIMANTAN TENGAH",1,113,19,132
https://kawalpemilu.org#61960,"PETUK BARUNAI, RAKUMPIT, KOTA PALANGKARAYA, KALIMANTAN TENGAH",2,123,35,158
https://kawalpemilu.org#61960,"PETUK BARUNAI, RAKUMPIT, KOTA PALANGKARAYA, KALIMANTAN TENGAH",3,94,23,117
https://kawalpemilu.org#61961,"MUNGKU BARU, RAKUMPIT, KOTA PALANGKARAYA, KALIMANTAN TENGAH",1,171,29,200
https://kawalpemilu.org#61961,"MUNGKU BARU, RAKUMPIT, KOTA PALANGKARAYA, KALIMANTAN TENGAH",2,154,34,188
https://kawalpemilu.org#61962,"PAGER, RAKUMPIT, KOTA PALANGKARAYA, KALIMANTAN TENGAH",1,142,19,161
https://kawalpemilu.org#61962,"PAGER, RAKUMPIT, KOTA PALANGKARAYA, KALIMANTAN TENGAH",2,106,5,111
https://kawalpemilu.org#61963,"GAUNG BARU, RAKUMPIT, KOTA PALANGKARAYA, KALIMANTAN TENGAH",1,136,5,141
https://kawalpemilu.org#61964,"BUKIT SUA, RAKUMPIT, KOTA PALANGKARAYA, KALIMANTAN TENGAH",1,127,16,143
