Link KawalPemilu,Nama Kelurahan,Nomor TPS,Suara 01,Suara 02,Suara Sah
https://kawalpemilu.org#64619,"TANJUNG PALAS HULU, TANJUNG PALAS, BULUNGAN, KALIMANTAN UTARA",1,67,128,195
https://kawalpemilu.org#64619,"TANJUNG PALAS HULU, TANJUNG PALAS, BULUNGAN, KALIMANTAN UTARA",2,0,0,0
https://kawalpemilu.org#64619,"TANJUNG PALAS HULU, TANJUNG PALAS, BULUNGAN, KALIMANTAN UTARA",3,77,101,178
https://kawalpemilu.org#64619,"TANJUNG PALAS HULU, TANJUNG PALAS, BULUNGAN, KALIMANTAN UTARA",4,86,72,158
https://kawalpemilu.org#64619,"TANJUNG PALAS HULU, TANJUNG PALAS, BULUNGAN, KALIMANTAN UTARA",5,88,88,176
https://kawalpemilu.org#64620,"TANJUNG PALAS TENGAH, TANJUNG PALAS, BULUNGAN, KALIMANTAN UTARA",1,73,109,182
https://kawalpemilu.org#64620,"TANJUNG PALAS TENGAH, TANJUNG PALAS, BULUNGAN, KALIMANTAN UTARA",2,81,93,174
https://kawalpemilu.org#64620,"TANJUNG PALAS TENGAH, TANJUNG PALAS, BULUNGAN, KALIMANTAN UTARA",3,65,85,150
https://kawalpemilu.org#64620,"TANJUNG PALAS TENGAH, TANJUNG PALAS, BULUNGAN, KALIMANTAN UTARA",4,71,79,150
https://kawalpemilu.org#64620,"TANJUNG PALAS TENGAH, TANJUNG PALAS, BULUNGAN, KALIMANTAN UTARA",5,108,96,204
https://kawalpemilu.org#64620,"TANJUNG PALAS TENGAH, TANJUNG PALAS, BULUNGAN, KALIMANTAN UTARA",6,85,98,183
https://kawalpemilu.org#64620,"TANJUNG PALAS TENGAH, TANJUNG PALAS, BULUNGAN, KALIMANTAN UTARA",7,58,78,136
https://kawalpemilu.org#64620,"TANJUNG PALAS TENGAH, TANJUNG PALAS, BULUNGAN, KALIMANTAN UTARA",8,68,64,132
https://kawalpemilu.org#64621,"TANJUNG PALAS HILIR, TANJUNG PALAS, BULUNGAN, KALIMANTAN UTARA",1,86,141,227
https://kawalpemilu.org#64621,"TANJUNG PALAS HILIR, TANJUNG PALAS, BULUNGAN, KALIMANTAN UTARA",2,82,63,145
https://kawalpemilu.org#64621,"TANJUNG PALAS HILIR, TANJUNG PALAS, BULUNGAN, KALIMANTAN UTARA",3,144,104,248
https://kawalpemilu.org#64621,"TANJUNG PALAS HILIR, TANJUNG PALAS, BULUNGAN, KALIMANTAN UTARA",4,104,94,198
https://kawalpemilu.org#64621,"TANJUNG PALAS HILIR, TANJUNG PALAS, BULUNGAN, KALIMANTAN UTARA",5,129,98,227
https://kawalpemilu.org#64621,"TANJUNG PALAS HILIR, TANJUNG PALAS, BULUNGAN, KALIMANTAN UTARA",6,76,8,84
https://kawalpemilu.org#64621,"TANJUNG PALAS HILIR, TANJUNG PALAS, BULUNGAN, KALIMANTAN UTARA",7,98,53,151
https://kawalpemilu.org#64621,"TANJUNG PALAS HILIR, TANJUNG PALAS, BULUNGAN, KALIMANTAN UTARA",8,98,3,101
https://kawalpemilu.org#64621,"TANJUNG PALAS HILIR, TANJUNG PALAS, BULUNGAN, KALIMANTAN UTARA",9,172,40,212
https://kawalpemilu.org#64621,"TANJUNG PALAS HILIR, TANJUNG PALAS, BULUNGAN, KALIMANTAN UTARA",10,119,20,139
https://kawalpemilu.org#64621,"TANJUNG PALAS HILIR, TANJUNG PALAS, BULUNGAN, KALIMANTAN UTARA",11,110,135,245
https://kawalpemilu.org#64622,"KARANG ANYAR, TANJUNG PALAS, BULUNGAN, KALIMANTAN UTARA",1,88,98,186
https://kawalpemilu.org#64622,"KARANG ANYAR, TANJUNG PALAS, BULUNGAN, KALIMANTAN UTARA",2,127,101,228
https://kawalpemilu.org#64622,"KARANG ANYAR, TANJUNG PALAS, BULUNGAN, KALIMANTAN UTARA",3,108,100,208
https://kawalpemilu.org#64623,"GUNUNG PUTIH, TANJUNG PALAS, BULUNGAN, KALIMANTAN UTARA",1,99,58,157
https://kawalpemilu.org#64623,"GUNUNG PUTIH, TANJUNG PALAS, BULUNGAN, KALIMANTAN UTARA",2,105,77,182
https://kawalpemilu.org#64623,"GUNUNG PUTIH, TANJUNG PALAS, BULUNGAN, KALIMANTAN UTARA",3,131,97,228
https://kawalpemilu.org#64623,"GUNUNG PUTIH, TANJUNG PALAS, BULUNGAN, KALIMANTAN UTARA",4,102,83,185
https://kawalpemilu.org#64623,"GUNUNG PUTIH, TANJUNG PALAS, BULUNGAN, KALIMANTAN UTARA",5,99,73,172
https://kawalpemilu.org#64623,"GUNUNG PUTIH, TANJUNG PALAS, BULUNGAN, KALIMANTAN UTARA",6,139,59,198
https://kawalpemilu.org#64623,"GUNUNG PUTIH, TANJUNG PALAS, BULUNGAN, KALIMANTAN UTARA",7,132,49,181
https://kawalpemilu.org#64623,"GUNUNG PUTIH, TANJUNG PALAS, BULUNGAN, KALIMANTAN UTARA",8,127,36,163
https://kawalpemilu.org#64623,"GUNUNG PUTIH, TANJUNG PALAS, BULUNGAN, KALIMANTAN UTARA",9,132,38,170
https://kawalpemilu.org#64623,"GUNUNG PUTIH, TANJUNG PALAS, BULUNGAN, KALIMANTAN UTARA",10,174,39,213
https://kawalpemilu.org#64624,"PEJALIN, TANJUNG PALAS, BULUNGAN, KALIMANTAN UTARA",1,137,29,166
https://kawalpemilu.org#64624,"PEJALIN, TANJUNG PALAS, BULUNGAN, KALIMANTAN UTARA",2,160,9,169
https://kawalpemilu.org#64624,"PEJALIN, TANJUNG PALAS, BULUNGAN, KALIMANTAN UTARA",3,77,55,132
https://kawalpemilu.org#64624,"PEJALIN, TANJUNG PALAS, BULUNGAN, KALIMANTAN UTARA",4,90,50,140
https://kawalpemilu.org#64625,"ANTUTAN, TANJUNG PALAS, BULUNGAN, KALIMANTAN UTARA",1,210,3,213
https://kawalpemilu.org#64625,"ANTUTAN, TANJUNG PALAS, BULUNGAN, KALIMANTAN UTARA",2,127,101,228
https://kawalpemilu.org#64625,"ANTUTAN, TANJUNG PALAS, BULUNGAN, KALIMANTAN UTARA",3,99,112,211
https://kawalpemilu.org#64625,"ANTUTAN, TANJUNG PALAS, BULUNGAN, KALIMANTAN UTARA",4,142,25,167
https://kawalpemilu.org#64625,"ANTUTAN, TANJUNG PALAS, BULUNGAN, KALIMANTAN UTARA",5,116,17,133
https://kawalpemilu.org#64625,"ANTUTAN, TANJUNG PALAS, BULUNGAN, KALIMANTAN UTARA",6,94,24,118
https://kawalpemilu.org#64625,"ANTUTAN, TANJUNG PALAS, BULUNGAN, KALIMANTAN UTARA",7,110,19,129
https://kawalpemilu.org#64625,"ANTUTAN, TANJUNG PALAS, BULUNGAN, KALIMANTAN UTARA",8,113,86,199
https://kawalpemilu.org#64626,"TERAS NAWANG, TANJUNG PALAS, BULUNGAN, KALIMANTAN UTARA",1,165,2,167
https://kawalpemilu.org#64626,"TERAS NAWANG, TANJUNG PALAS, BULUNGAN, KALIMANTAN UTARA",2,141,5,146
https://kawalpemilu.org#64626,"TERAS NAWANG, TANJUNG PALAS, BULUNGAN, KALIMANTAN UTARA",3,121,4,125
https://kawalpemilu.org#64626,"TERAS NAWANG, TANJUNG PALAS, BULUNGAN, KALIMANTAN UTARA",4,160,4,164
https://kawalpemilu.org#64627,"TERAS BARU, TANJUNG PALAS, BULUNGAN, KALIMANTAN UTARA",1,201,3,204
https://kawalpemilu.org#64627,"TERAS BARU, TANJUNG PALAS, BULUNGAN, KALIMANTAN UTARA",2,157,12,169
https://kawalpemilu.org#64627,"TERAS BARU, TANJUNG PALAS, BULUNGAN, KALIMANTAN UTARA",3,107,5,112
https://kawalpemilu.org#64629,"LONG BELUAH, TANJUNG PALAS BARAT, BULUNGAN, KALIMANTAN UTARA",1,204,38,242
https://kawalpemilu.org#64629,"LONG BELUAH, TANJUNG PALAS BARAT, BULUNGAN, KALIMANTAN UTARA",2,165,42,207
https://kawalpemilu.org#64629,"LONG BELUAH, TANJUNG PALAS BARAT, BULUNGAN, KALIMANTAN UTARA",3,174,42,216
https://kawalpemilu.org#64629,"LONG BELUAH, TANJUNG PALAS BARAT, BULUNGAN, KALIMANTAN UTARA",4,217,28,245
https://kawalpemilu.org#64629,"LONG BELUAH, TANJUNG PALAS BARAT, BULUNGAN, KALIMANTAN UTARA",5,213,17,230
https://kawalpemilu.org#64629,"LONG BELUAH, TANJUNG PALAS BARAT, BULUNGAN, KALIMANTAN UTARA",6,206,23,229
https://kawalpemilu.org#64629,"LONG BELUAH, TANJUNG PALAS BARAT, BULUNGAN, KALIMANTAN UTARA",7,191,21,212
https://kawalpemilu.org#64630,"LONG SAM, TANJUNG PALAS BARAT, BULUNGAN, KALIMANTAN UTARA",1,197,13,210
https://kawalpemilu.org#64630,"LONG SAM, TANJUNG PALAS BARAT, BULUNGAN, KALIMANTAN UTARA",2,190,26,216
https://kawalpemilu.org#64630,"LONG SAM, TANJUNG PALAS BARAT, BULUNGAN, KALIMANTAN UTARA",3,76,19,95
https://kawalpemilu.org#64631,"MARA SATU, TANJUNG PALAS BARAT, BULUNGAN, KALIMANTAN UTARA",1,150,9,159
https://kawalpemilu.org#64631,"MARA SATU, TANJUNG PALAS BARAT, BULUNGAN, KALIMANTAN UTARA",2,191,6,197
https://kawalpemilu.org#64631,"MARA SATU, TANJUNG PALAS BARAT, BULUNGAN, KALIMANTAN UTARA",3,209,4,213
https://kawalpemilu.org#64631,"MARA SATU, TANJUNG PALAS BARAT, BULUNGAN, KALIMANTAN UTARA",4,157,11,168
https://kawalpemilu.org#64631,"MARA SATU, TANJUNG PALAS BARAT, BULUNGAN, KALIMANTAN UTARA",5,117,15,132
https://kawalpemilu.org#64632,"MARA HILIR, TANJUNG PALAS BARAT, BULUNGAN, KALIMANTAN UTARA",1,166,55,221
https://kawalpemilu.org#64632,"MARA HILIR, TANJUNG PALAS BARAT, BULUNGAN, KALIMANTAN UTARA",2,168,31,199
https://kawalpemilu.org#64633,"LONG PARI, TANJUNG PALAS BARAT, BULUNGAN, KALIMANTAN UTARA",1,120,4,124
https://kawalpemilu.org#64633,"LONG PARI, TANJUNG PALAS BARAT, BULUNGAN, KALIMANTAN UTARA",2,124,10,134
https://kawalpemilu.org#64635,"KARANG AGUNG, TANJUNG PALAS UTARA, BULUNGAN, KALIMANTAN UTARA",1,96,37,133
https://kawalpemilu.org#64635,"KARANG AGUNG, TANJUNG PALAS UTARA, BULUNGAN, KALIMANTAN UTARA",2,93,50,143
https://kawalpemilu.org#64635,"KARANG AGUNG, TANJUNG PALAS UTARA, BULUNGAN, KALIMANTAN UTARA",3,156,80,236
https://kawalpemilu.org#64635,"KARANG AGUNG, TANJUNG PALAS UTARA, BULUNGAN, KALIMANTAN UTARA",4,85,41,126
https://kawalpemilu.org#64635,"KARANG AGUNG, TANJUNG PALAS UTARA, BULUNGAN, KALIMANTAN UTARA",6,65,65,130
https://kawalpemilu.org#64635,"KARANG AGUNG, TANJUNG PALAS UTARA, BULUNGAN, KALIMANTAN UTARA",7,92,38,130
https://kawalpemilu.org#64635,"KARANG AGUNG, TANJUNG PALAS UTARA, BULUNGAN, KALIMANTAN UTARA",8,92,82,174
https://kawalpemilu.org#64635,"KARANG AGUNG, TANJUNG PALAS UTARA, BULUNGAN, KALIMANTAN UTARA",9,65,47,112
https://kawalpemilu.org#64636,"PIMPING, TANJUNG PALAS UTARA, BULUNGAN, KALIMANTAN UTARA",1,152,10,162
https://kawalpemilu.org#64636,"PIMPING, TANJUNG PALAS UTARA, BULUNGAN, KALIMANTAN UTARA",2,174,12,186
https://kawalpemilu.org#64636,"PIMPING, TANJUNG PALAS UTARA, BULUNGAN, KALIMANTAN UTARA",3,192,12,204
https://kawalpemilu.org#64636,"PIMPING, TANJUNG PALAS UTARA, BULUNGAN, KALIMANTAN UTARA",4,143,8,151
https://kawalpemilu.org#64636,"PIMPING, TANJUNG PALAS UTARA, BULUNGAN, KALIMANTAN UTARA",5,132,16,148
https://kawalpemilu.org#64636,"PIMPING, TANJUNG PALAS UTARA, BULUNGAN, KALIMANTAN UTARA",6,74,26,100
https://kawalpemilu.org#64636,"PIMPING, TANJUNG PALAS UTARA, BULUNGAN, KALIMANTAN UTARA",7,165,16,181
https://kawalpemilu.org#64637,"PANCA AGUNG, TANJUNG PALAS UTARA, BULUNGAN, KALIMANTAN UTARA",1,180,77,257
https://kawalpemilu.org#64637,"PANCA AGUNG, TANJUNG PALAS UTARA, BULUNGAN, KALIMANTAN UTARA",2,172,30,202
https://kawalpemilu.org#64637,"PANCA AGUNG, TANJUNG PALAS UTARA, BULUNGAN, KALIMANTAN UTARA",3,104,55,159
https://kawalpemilu.org#64637,"PANCA AGUNG, TANJUNG PALAS UTARA, BULUNGAN, KALIMANTAN UTARA",4,190,45,235
https://kawalpemilu.org#64637,"PANCA AGUNG, TANJUNG PALAS UTARA, BULUNGAN, KALIMANTAN UTARA",5,170,48,218
https://kawalpemilu.org#64637,"PANCA AGUNG, TANJUNG PALAS UTARA, BULUNGAN, KALIMANTAN UTARA",6,121,19,140
https://kawalpemilu.org#64637,"PANCA AGUNG, TANJUNG PALAS UTARA, BULUNGAN, KALIMANTAN UTARA",7,92,38,130
https://kawalpemilu.org#64638,"RUHUI RAHAYU, TANJUNG PALAS UTARA, BULUNGAN, KALIMANTAN UTARA",1,107,35,142
https://kawalpemilu.org#64638,"RUHUI RAHAYU, TANJUNG PALAS UTARA, BULUNGAN, KALIMANTAN UTARA",2,148,62,210
https://kawalpemilu.org#64638,"RUHUI RAHAYU, TANJUNG PALAS UTARA, BULUNGAN, KALIMANTAN UTARA",3,139,26,165
https://kawalpemilu.org#64638,"RUHUI RAHAYU, TANJUNG PALAS UTARA, BULUNGAN, KALIMANTAN UTARA",4,157,26,183
https://kawalpemilu.org#64638,"RUHUI RAHAYU, TANJUNG PALAS UTARA, BULUNGAN, KALIMANTAN UTARA",5,128,29,157
https://kawalpemilu.org#64638,"RUHUI RAHAYU, TANJUNG PALAS UTARA, BULUNGAN, KALIMANTAN UTARA",6,117,62,179
https://kawalpemilu.org#64639,"ARDI MULYO, TANJUNG PALAS UTARA, BULUNGAN, KALIMANTAN UTARA",1,190,19,209
https://kawalpemilu.org#64639,"ARDI MULYO, TANJUNG PALAS UTARA, BULUNGAN, KALIMANTAN UTARA",2,136,45,181
https://kawalpemilu.org#64640,"KELUBIR, TANJUNG PALAS UTARA, BULUNGAN, KALIMANTAN UTARA",1,162,30,192
https://kawalpemilu.org#64640,"KELUBIR, TANJUNG PALAS UTARA, BULUNGAN, KALIMANTAN UTARA",2,100,19,119
https://kawalpemilu.org#64640,"KELUBIR, TANJUNG PALAS UTARA, BULUNGAN, KALIMANTAN UTARA",3,120,16,136
https://kawalpemilu.org#64640,"KELUBIR, TANJUNG PALAS UTARA, BULUNGAN, KALIMANTAN UTARA",4,162,29,191
https://kawalpemilu.org#64640,"KELUBIR, TANJUNG PALAS UTARA, BULUNGAN, KALIMANTAN UTARA",5,160,49,209
https://kawalpemilu.org#64642,"TANAH KUNING, TANJUNG PALAS TIMUR, BULUNGAN, KALIMANTAN UTARA",1,113,84,197
https://kawalpemilu.org#64642,"TANAH KUNING, TANJUNG PALAS TIMUR, BULUNGAN, KALIMANTAN UTARA",2,95,66,161
https://kawalpemilu.org#64642,"TANAH KUNING, TANJUNG PALAS TIMUR, BULUNGAN, KALIMANTAN UTARA",3,136,83,219
https://kawalpemilu.org#64642,"TANAH KUNING, TANJUNG PALAS TIMUR, BULUNGAN, KALIMANTAN UTARA",4,147,68,215
https://kawalpemilu.org#64642,"TANAH KUNING, TANJUNG PALAS TIMUR, BULUNGAN, KALIMANTAN UTARA",5,99,81,180
https://kawalpemilu.org#64642,"TANAH KUNING, TANJUNG PALAS TIMUR, BULUNGAN, KALIMANTAN UTARA",6,132,98,230
https://kawalpemilu.org#64642,"TANAH KUNING, TANJUNG PALAS TIMUR, BULUNGAN, KALIMANTAN UTARA",7,158,49,207
https://kawalpemilu.org#64642,"TANAH KUNING, TANJUNG PALAS TIMUR, BULUNGAN, KALIMANTAN UTARA",8,146,49,195
https://kawalpemilu.org#64643,"MANGKUPADI, TANJUNG PALAS TIMUR, BULUNGAN, KALIMANTAN UTARA",1,153,24,177
https://kawalpemilu.org#64643,"MANGKUPADI, TANJUNG PALAS TIMUR, BULUNGAN, KALIMANTAN UTARA",2,149,38,187
https://kawalpemilu.org#64643,"MANGKUPADI, TANJUNG PALAS TIMUR, BULUNGAN, KALIMANTAN UTARA",3,181,42,223
https://kawalpemilu.org#64643,"MANGKUPADI, TANJUNG PALAS TIMUR, BULUNGAN, KALIMANTAN UTARA",4,171,38,209
https://kawalpemilu.org#64643,"MANGKUPADI, TANJUNG PALAS TIMUR, BULUNGAN, KALIMANTAN UTARA",5,161,45,206
https://kawalpemilu.org#64643,"MANGKUPADI, TANJUNG PALAS TIMUR, BULUNGAN, KALIMANTAN UTARA",6,98,38,136
https://kawalpemilu.org#64643,"MANGKUPADI, TANJUNG PALAS TIMUR, BULUNGAN, KALIMANTAN UTARA",7,183,32,215
https://kawalpemilu.org#64643,"MANGKUPADI, TANJUNG PALAS TIMUR, BULUNGAN, KALIMANTAN UTARA",8,111,53,164
https://kawalpemilu.org#64644,"SAJAU, TANJUNG PALAS TIMUR, BULUNGAN, KALIMANTAN UTARA",1,225,8,233
https://kawalpemilu.org#64644,"SAJAU, TANJUNG PALAS TIMUR, BULUNGAN, KALIMANTAN UTARA",2,231,3,234
https://kawalpemilu.org#64644,"SAJAU, TANJUNG PALAS TIMUR, BULUNGAN, KALIMANTAN UTARA",3,190,12,202
https://kawalpemilu.org#64644,"SAJAU, TANJUNG PALAS TIMUR, BULUNGAN, KALIMANTAN UTARA",4,40,20,60
https://kawalpemilu.org#64645,"WONOMULYO, TANJUNG PALAS TIMUR, BULUNGAN, KALIMANTAN UTARA",1,150,50,200
https://kawalpemilu.org#64645,"WONOMULYO, TANJUNG PALAS TIMUR, BULUNGAN, KALIMANTAN UTARA",2,194,9,203
https://kawalpemilu.org#64645,"WONOMULYO, TANJUNG PALAS TIMUR, BULUNGAN, KALIMANTAN UTARA",3,176,34,210
https://kawalpemilu.org#64645,"WONOMULYO, TANJUNG PALAS TIMUR, BULUNGAN, KALIMANTAN UTARA",4,118,43,161
https://kawalpemilu.org#64646,"TANJUNG AGUNG, TANJUNG PALAS TIMUR, BULUNGAN, KALIMANTAN UTARA",1,148,56,204
https://kawalpemilu.org#64646,"TANJUNG AGUNG, TANJUNG PALAS TIMUR, BULUNGAN, KALIMANTAN UTARA",2,109,33,142
https://kawalpemilu.org#64646,"TANJUNG AGUNG, TANJUNG PALAS TIMUR, BULUNGAN, KALIMANTAN UTARA",3,141,80,221
https://kawalpemilu.org#64647,"BINAI, TANJUNG PALAS TIMUR, BULUNGAN, KALIMANTAN UTARA",1,194,7,101
https://kawalpemilu.org#64647,"BINAI, TANJUNG PALAS TIMUR, BULUNGAN, KALIMANTAN UTARA",2,168,16,184
https://kawalpemilu.org#64647,"BINAI, TANJUNG PALAS TIMUR, BULUNGAN, KALIMANTAN UTARA",3,137,30,167
https://kawalpemilu.org#64647,"BINAI, TANJUNG PALAS TIMUR, BULUNGAN, KALIMANTAN UTARA",4,130,28,158
https://kawalpemilu.org#64647,"BINAI, TANJUNG PALAS TIMUR, BULUNGAN, KALIMANTAN UTARA",5,114,50,164
https://kawalpemilu.org#64647,"BINAI, TANJUNG PALAS TIMUR, BULUNGAN, KALIMANTAN UTARA",6,242,27,269
https://kawalpemilu.org#64647,"BINAI, TANJUNG PALAS TIMUR, BULUNGAN, KALIMANTAN UTARA",7,240,38,278
https://kawalpemilu.org#64648,"PURA SAJAU, TANJUNG PALAS TIMUR, BULUNGAN, KALIMANTAN UTARA",1,185,20,205
https://kawalpemilu.org#64648,"PURA SAJAU, TANJUNG PALAS TIMUR, BULUNGAN, KALIMANTAN UTARA",2,135,44,179
https://kawalpemilu.org#64648,"PURA SAJAU, TANJUNG PALAS TIMUR, BULUNGAN, KALIMANTAN UTARA",3,53,22,75
https://kawalpemilu.org#64649,"SAJAU HILIR, TANJUNG PALAS TIMUR, BULUNGAN, KALIMANTAN UTARA",1,188,31,219
https://kawalpemilu.org#64649,"SAJAU HILIR, TANJUNG PALAS TIMUR, BULUNGAN, KALIMANTAN UTARA",2,179,46,225
https://kawalpemilu.org#64649,"SAJAU HILIR, TANJUNG PALAS TIMUR, BULUNGAN, KALIMANTAN UTARA",3,151,31,182
https://kawalpemilu.org#64649,"SAJAU HILIR, TANJUNG PALAS TIMUR, BULUNGAN, KALIMANTAN UTARA",4,132,21,153
https://kawalpemilu.org#64649,"SAJAU HILIR, TANJUNG PALAS TIMUR, BULUNGAN, KALIMANTAN UTARA",5,193,25,218
https://kawalpemilu.org#64651,"TANJUNG SELOR HULU, TANJUNG SELOR, BULUNGAN, KALIMANTAN UTARA",1,71,117,188
https://kawalpemilu.org#64651,"TANJUNG SELOR HULU, TANJUNG SELOR, BULUNGAN, KALIMANTAN UTARA",2,25,100,125
https://kawalpemilu.org#64651,"TANJUNG SELOR HULU, TANJUNG SELOR, BULUNGAN, KALIMANTAN UTARA",3,47,170,217
https://kawalpemilu.org#64651,"TANJUNG SELOR HULU, TANJUNG SELOR, BULUNGAN, KALIMANTAN UTARA",4,45,115,160
https://kawalpemilu.org#64651,"TANJUNG SELOR HULU, TANJUNG SELOR, BULUNGAN, KALIMANTAN UTARA",5,41,98,139
https://kawalpemilu.org#64651,"TANJUNG SELOR HULU, TANJUNG SELOR, BULUNGAN, KALIMANTAN UTARA",6,82,88,170
https://kawalpemilu.org#64651,"TANJUNG SELOR HULU, TANJUNG SELOR, BULUNGAN, KALIMANTAN UTARA",7,79,154,233
https://kawalpemilu.org#64651,"TANJUNG SELOR HULU, TANJUNG SELOR, BULUNGAN, KALIMANTAN UTARA",8,49,49,98
https://kawalpemilu.org#64651,"TANJUNG SELOR HULU, TANJUNG SELOR, BULUNGAN, KALIMANTAN UTARA",9,79,89,168
https://kawalpemilu.org#64651,"TANJUNG SELOR HULU, TANJUNG SELOR, BULUNGAN, KALIMANTAN UTARA",10,66,118,184
https://kawalpemilu.org#64651,"TANJUNG SELOR HULU, TANJUNG SELOR, BULUNGAN, KALIMANTAN UTARA",11,60,19,79
https://kawalpemilu.org#64651,"TANJUNG SELOR HULU, TANJUNG SELOR, BULUNGAN, KALIMANTAN UTARA",12,87,57,144
https://kawalpemilu.org#64651,"TANJUNG SELOR HULU, TANJUNG SELOR, BULUNGAN, KALIMANTAN UTARA",13,89,68,157
https://kawalpemilu.org#64651,"TANJUNG SELOR HULU, TANJUNG SELOR, BULUNGAN, KALIMANTAN UTARA",14,93,107,200
https://kawalpemilu.org#64651,"TANJUNG SELOR HULU, TANJUNG SELOR, BULUNGAN, KALIMANTAN UTARA",15,48,82,130
https://kawalpemilu.org#64651,"TANJUNG SELOR HULU, TANJUNG SELOR, BULUNGAN, KALIMANTAN UTARA",16,19,38,117
https://kawalpemilu.org#64651,"TANJUNG SELOR HULU, TANJUNG SELOR, BULUNGAN, KALIMANTAN UTARA",17,78,100,178
https://kawalpemilu.org#64651,"TANJUNG SELOR HULU, TANJUNG SELOR, BULUNGAN, KALIMANTAN UTARA",18,100,73,173
https://kawalpemilu.org#64651,"TANJUNG SELOR HULU, TANJUNG SELOR, BULUNGAN, KALIMANTAN UTARA",19,180,42,222
https://kawalpemilu.org#64651,"TANJUNG SELOR HULU, TANJUNG SELOR, BULUNGAN, KALIMANTAN UTARA",20,31,46,77
https://kawalpemilu.org#64652,"TANJUNG SELOR HILIR, TANJUNG SELOR, BULUNGAN, KALIMANTAN UTARA",1,142,49,191
https://kawalpemilu.org#64652,"TANJUNG SELOR HILIR, TANJUNG SELOR, BULUNGAN, KALIMANTAN UTARA",2,129,115,244
https://kawalpemilu.org#64652,"TANJUNG SELOR HILIR, TANJUNG SELOR, BULUNGAN, KALIMANTAN UTARA",3,144,82,226
https://kawalpemilu.org#64652,"TANJUNG SELOR HILIR, TANJUNG SELOR, BULUNGAN, KALIMANTAN UTARA",4,94,68,162
https://kawalpemilu.org#64652,"TANJUNG SELOR HILIR, TANJUNG SELOR, BULUNGAN, KALIMANTAN UTARA",5,118,65,183
https://kawalpemilu.org#64652,"TANJUNG SELOR HILIR, TANJUNG SELOR, BULUNGAN, KALIMANTAN UTARA",6,154,79,233
https://kawalpemilu.org#64652,"TANJUNG SELOR HILIR, TANJUNG SELOR, BULUNGAN, KALIMANTAN UTARA",7,73,64,137
https://kawalpemilu.org#64652,"TANJUNG SELOR HILIR, TANJUNG SELOR, BULUNGAN, KALIMANTAN UTARA",8,95,76,171
https://kawalpemilu.org#64652,"TANJUNG SELOR HILIR, TANJUNG SELOR, BULUNGAN, KALIMANTAN UTARA",9,79,96,175
https://kawalpemilu.org#64652,"TANJUNG SELOR HILIR, TANJUNG SELOR, BULUNGAN, KALIMANTAN UTARA",10,98,64,162
https://kawalpemilu.org#64652,"TANJUNG SELOR HILIR, TANJUNG SELOR, BULUNGAN, KALIMANTAN UTARA",11,54,43,97
https://kawalpemilu.org#64652,"TANJUNG SELOR HILIR, TANJUNG SELOR, BULUNGAN, KALIMANTAN UTARA",12,97,110,207
https://kawalpemilu.org#64652,"TANJUNG SELOR HILIR, TANJUNG SELOR, BULUNGAN, KALIMANTAN UTARA",13,81,72,153
https://kawalpemilu.org#64652,"TANJUNG SELOR HILIR, TANJUNG SELOR, BULUNGAN, KALIMANTAN UTARA",14,102,107,209
https://kawalpemilu.org#64652,"TANJUNG SELOR HILIR, TANJUNG SELOR, BULUNGAN, KALIMANTAN UTARA",15,95,81,176
https://kawalpemilu.org#64652,"TANJUNG SELOR HILIR, TANJUNG SELOR, BULUNGAN, KALIMANTAN UTARA",16,76,58,134
https://kawalpemilu.org#64652,"TANJUNG SELOR HILIR, TANJUNG SELOR, BULUNGAN, KALIMANTAN UTARA",17,113,109,222
https://kawalpemilu.org#64652,"TANJUNG SELOR HILIR, TANJUNG SELOR, BULUNGAN, KALIMANTAN UTARA",18,64,80,144
https://kawalpemilu.org#64652,"TANJUNG SELOR HILIR, TANJUNG SELOR, BULUNGAN, KALIMANTAN UTARA",19,123,127,250
https://kawalpemilu.org#64652,"TANJUNG SELOR HILIR, TANJUNG SELOR, BULUNGAN, KALIMANTAN UTARA",20,90,82,172
https://kawalpemilu.org#64652,"TANJUNG SELOR HILIR, TANJUNG SELOR, BULUNGAN, KALIMANTAN UTARA",21,146,130,276
https://kawalpemilu.org#64652,"TANJUNG SELOR HILIR, TANJUNG SELOR, BULUNGAN, KALIMANTAN UTARA",22,141,73,214
https://kawalpemilu.org#64652,"TANJUNG SELOR HILIR, TANJUNG SELOR, BULUNGAN, KALIMANTAN UTARA",23,84,81,165
https://kawalpemilu.org#64652,"TANJUNG SELOR HILIR, TANJUNG SELOR, BULUNGAN, KALIMANTAN UTARA",24,122,72,194
https://kawalpemilu.org#64652,"TANJUNG SELOR HILIR, TANJUNG SELOR, BULUNGAN, KALIMANTAN UTARA",25,114,97,211
https://kawalpemilu.org#64652,"TANJUNG SELOR HILIR, TANJUNG SELOR, BULUNGAN, KALIMANTAN UTARA",26,48,66,114
https://kawalpemilu.org#64652,"TANJUNG SELOR HILIR, TANJUNG SELOR, BULUNGAN, KALIMANTAN UTARA",27,119,117,236
https://kawalpemilu.org#64652,"TANJUNG SELOR HILIR, TANJUNG SELOR, BULUNGAN, KALIMANTAN UTARA",28,44,83,127
https://kawalpemilu.org#64652,"TANJUNG SELOR HILIR, TANJUNG SELOR, BULUNGAN, KALIMANTAN UTARA",29,65,108,173
https://kawalpemilu.org#64652,"TANJUNG SELOR HILIR, TANJUNG SELOR, BULUNGAN, KALIMANTAN UTARA",30,98,59,157
https://kawalpemilu.org#64652,"TANJUNG SELOR HILIR, TANJUNG SELOR, BULUNGAN, KALIMANTAN UTARA",31,107,107,214
https://kawalpemilu.org#64652,"TANJUNG SELOR HILIR, TANJUNG SELOR, BULUNGAN, KALIMANTAN UTARA",32,113,106,219
https://kawalpemilu.org#64652,"TANJUNG SELOR HILIR, TANJUNG SELOR, BULUNGAN, KALIMANTAN UTARA",33,132,130,262
https://kawalpemilu.org#64652,"TANJUNG SELOR HILIR, TANJUNG SELOR, BULUNGAN, KALIMANTAN UTARA",34,127,105,232
https://kawalpemilu.org#64652,"TANJUNG SELOR HILIR, TANJUNG SELOR, BULUNGAN, KALIMANTAN UTARA",35,105,60,165
https://kawalpemilu.org#64652,"TANJUNG SELOR HILIR, TANJUNG SELOR, BULUNGAN, KALIMANTAN UTARA",36,68,45,113
https://kawalpemilu.org#64652,"TANJUNG SELOR HILIR, TANJUNG SELOR, BULUNGAN, KALIMANTAN UTARA",37,143,105,248
https://kawalpemilu.org#64652,"TANJUNG SELOR HILIR, TANJUNG SELOR, BULUNGAN, KALIMANTAN UTARA",38,126,124,250
https://kawalpemilu.org#64652,"TANJUNG SELOR HILIR, TANJUNG SELOR, BULUNGAN, KALIMANTAN UTARA",39,139,113,252
https://kawalpemilu.org#64652,"TANJUNG SELOR HILIR, TANJUNG SELOR, BULUNGAN, KALIMANTAN UTARA",40,102,107,209
https://kawalpemilu.org#64652,"TANJUNG SELOR HILIR, TANJUNG SELOR, BULUNGAN, KALIMANTAN UTARA",41,105,97,202
https://kawalpemilu.org#64652,"TANJUNG SELOR HILIR, TANJUNG SELOR, BULUNGAN, KALIMANTAN UTARA",42,117,107,224
https://kawalpemilu.org#64652,"TANJUNG SELOR HILIR, TANJUNG SELOR, BULUNGAN, KALIMANTAN UTARA",43,0,0,0
https://kawalpemilu.org#64652,"TANJUNG SELOR HILIR, TANJUNG SELOR, BULUNGAN, KALIMANTAN UTARA",44,73,68,141
https://kawalpemilu.org#64652,"TANJUNG SELOR HILIR, TANJUNG SELOR, BULUNGAN, KALIMANTAN UTARA",45,131,119,250
https://kawalpemilu.org#64652,"TANJUNG SELOR HILIR, TANJUNG SELOR, BULUNGAN, KALIMANTAN UTARA",46,137,79,216
https://kawalpemilu.org#64652,"TANJUNG SELOR HILIR, TANJUNG SELOR, BULUNGAN, KALIMANTAN UTARA",47,136,83,219
https://kawalpemilu.org#64652,"TANJUNG SELOR HILIR, TANJUNG SELOR, BULUNGAN, KALIMANTAN UTARA",48,106,107,213
https://kawalpemilu.org#64652,"TANJUNG SELOR HILIR, TANJUNG SELOR, BULUNGAN, KALIMANTAN UTARA",49,98,126,224
https://kawalpemilu.org#64652,"TANJUNG SELOR HILIR, TANJUNG SELOR, BULUNGAN, KALIMANTAN UTARA",50,108,54,162
https://kawalpemilu.org#64652,"TANJUNG SELOR HILIR, TANJUNG SELOR, BULUNGAN, KALIMANTAN UTARA",51,119,90,209
https://kawalpemilu.org#64652,"TANJUNG SELOR HILIR, TANJUNG SELOR, BULUNGAN, KALIMANTAN UTARA",52,130,85,215
https://kawalpemilu.org#64652,"TANJUNG SELOR HILIR, TANJUNG SELOR, BULUNGAN, KALIMANTAN UTARA",53,48,78,126
https://kawalpemilu.org#64652,"TANJUNG SELOR HILIR, TANJUNG SELOR, BULUNGAN, KALIMANTAN UTARA",54,121,87,208
https://kawalpemilu.org#64652,"TANJUNG SELOR HILIR, TANJUNG SELOR, BULUNGAN, KALIMANTAN UTARA",55,158,82,240
https://kawalpemilu.org#64652,"TANJUNG SELOR HILIR, TANJUNG SELOR, BULUNGAN, KALIMANTAN UTARA",56,186,83,269
https://kawalpemilu.org#64652,"TANJUNG SELOR HILIR, TANJUNG SELOR, BULUNGAN, KALIMANTAN UTARA",57,171,102,273
https://kawalpemilu.org#64652,"TANJUNG SELOR HILIR, TANJUNG SELOR, BULUNGAN, KALIMANTAN UTARA",58,109,140,249
https://kawalpemilu.org#64652,"TANJUNG SELOR HILIR, TANJUNG SELOR, BULUNGAN, KALIMANTAN UTARA",59,130,117,247
https://kawalpemilu.org#64652,"TANJUNG SELOR HILIR, TANJUNG SELOR, BULUNGAN, KALIMANTAN UTARA",61,117,63,180
https://kawalpemilu.org#64652,"TANJUNG SELOR HILIR, TANJUNG SELOR, BULUNGAN, KALIMANTAN UTARA",62,107,84,191
https://kawalpemilu.org#64652,"TANJUNG SELOR HILIR, TANJUNG SELOR, BULUNGAN, KALIMANTAN UTARA",63,88,74,162
https://kawalpemilu.org#64652,"TANJUNG SELOR HILIR, TANJUNG SELOR, BULUNGAN, KALIMANTAN UTARA",64,94,99,193
https://kawalpemilu.org#64652,"TANJUNG SELOR HILIR, TANJUNG SELOR, BULUNGAN, KALIMANTAN UTARA",65,92,101,193
https://kawalpemilu.org#64652,"TANJUNG SELOR HILIR, TANJUNG SELOR, BULUNGAN, KALIMANTAN UTARA",66,62,50,112
https://kawalpemilu.org#64652,"TANJUNG SELOR HILIR, TANJUNG SELOR, BULUNGAN, KALIMANTAN UTARA",67,99,134,233
https://kawalpemilu.org#64652,"TANJUNG SELOR HILIR, TANJUNG SELOR, BULUNGAN, KALIMANTAN UTARA",68,133,83,216
https://kawalpemilu.org#64652,"TANJUNG SELOR HILIR, TANJUNG SELOR, BULUNGAN, KALIMANTAN UTARA",69,103,105,208
https://kawalpemilu.org#64652,"TANJUNG SELOR HILIR, TANJUNG SELOR, BULUNGAN, KALIMANTAN UTARA",70,126,108,234
https://kawalpemilu.org#64652,"TANJUNG SELOR HILIR, TANJUNG SELOR, BULUNGAN, KALIMANTAN UTARA",71,136,110,246
https://kawalpemilu.org#64652,"TANJUNG SELOR HILIR, TANJUNG SELOR, BULUNGAN, KALIMANTAN UTARA",72,89,165,254
https://kawalpemilu.org#64652,"TANJUNG SELOR HILIR, TANJUNG SELOR, BULUNGAN, KALIMANTAN UTARA",73,148,37,185
https://kawalpemilu.org#64652,"TANJUNG SELOR HILIR, TANJUNG SELOR, BULUNGAN, KALIMANTAN UTARA",74,54,24,78
https://kawalpemilu.org#64652,"TANJUNG SELOR HILIR, TANJUNG SELOR, BULUNGAN, KALIMANTAN UTARA",75,69,57,126
https://kawalpemilu.org#64653,"TANJUNG SELOR TIMUR, TANJUNG SELOR, BULUNGAN, KALIMANTAN UTARA",1,156,94,250
https://kawalpemilu.org#64653,"TANJUNG SELOR TIMUR, TANJUNG SELOR, BULUNGAN, KALIMANTAN UTARA",2,159,33,192
https://kawalpemilu.org#64653,"TANJUNG SELOR TIMUR, TANJUNG SELOR, BULUNGAN, KALIMANTAN UTARA",3,168,73,241
https://kawalpemilu.org#64653,"TANJUNG SELOR TIMUR, TANJUNG SELOR, BULUNGAN, KALIMANTAN UTARA",4,138,87,225
https://kawalpemilu.org#64653,"TANJUNG SELOR TIMUR, TANJUNG SELOR, BULUNGAN, KALIMANTAN UTARA",5,104,130,234
https://kawalpemilu.org#64653,"TANJUNG SELOR TIMUR, TANJUNG SELOR, BULUNGAN, KALIMANTAN UTARA",6,146,98,244
https://kawalpemilu.org#64653,"TANJUNG SELOR TIMUR, TANJUNG SELOR, BULUNGAN, KALIMANTAN UTARA",7,207,46,253
https://kawalpemilu.org#64653,"TANJUNG SELOR TIMUR, TANJUNG SELOR, BULUNGAN, KALIMANTAN UTARA",8,185,57,242
https://kawalpemilu.org#64653,"TANJUNG SELOR TIMUR, TANJUNG SELOR, BULUNGAN, KALIMANTAN UTARA",9,163,99,262
https://kawalpemilu.org#64653,"TANJUNG SELOR TIMUR, TANJUNG SELOR, BULUNGAN, KALIMANTAN UTARA",10,178,46,224
https://kawalpemilu.org#64653,"TANJUNG SELOR TIMUR, TANJUNG SELOR, BULUNGAN, KALIMANTAN UTARA",11,108,14,122
https://kawalpemilu.org#64653,"TANJUNG SELOR TIMUR, TANJUNG SELOR, BULUNGAN, KALIMANTAN UTARA",12,108,33,141
https://kawalpemilu.org#64653,"TANJUNG SELOR TIMUR, TANJUNG SELOR, BULUNGAN, KALIMANTAN UTARA",13,139,31,170
https://kawalpemilu.org#64653,"TANJUNG SELOR TIMUR, TANJUNG SELOR, BULUNGAN, KALIMANTAN UTARA",14,102,32,134
https://kawalpemilu.org#64654,"JELARAI SELOR, TANJUNG SELOR, BULUNGAN, KALIMANTAN UTARA",1,191,75,265
https://kawalpemilu.org#64654,"JELARAI SELOR, TANJUNG SELOR, BULUNGAN, KALIMANTAN UTARA",2,172,19,191
https://kawalpemilu.org#64654,"JELARAI SELOR, TANJUNG SELOR, BULUNGAN, KALIMANTAN UTARA",3,207,14,221
https://kawalpemilu.org#64654,"JELARAI SELOR, TANJUNG SELOR, BULUNGAN, KALIMANTAN UTARA",4,163,17,180
https://kawalpemilu.org#64654,"JELARAI SELOR, TANJUNG SELOR, BULUNGAN, KALIMANTAN UTARA",5,140,8,148
https://kawalpemilu.org#64654,"JELARAI SELOR, TANJUNG SELOR, BULUNGAN, KALIMANTAN UTARA",6,116,12,128
https://kawalpemilu.org#64654,"JELARAI SELOR, TANJUNG SELOR, BULUNGAN, KALIMANTAN UTARA",7,183,10,193
https://kawalpemilu.org#64654,"JELARAI SELOR, TANJUNG SELOR, BULUNGAN, KALIMANTAN UTARA",8,119,11,1
https://kawalpemilu.org#64654,"JELARAI SELOR, TANJUNG SELOR, BULUNGAN, KALIMANTAN UTARA",9,162,56,218
https://kawalpemilu.org#64654,"JELARAI SELOR, TANJUNG SELOR, BULUNGAN, KALIMANTAN UTARA",10,136,51,187
https://kawalpemilu.org#64654,"JELARAI SELOR, TANJUNG SELOR, BULUNGAN, KALIMANTAN UTARA",11,94,19,113
https://kawalpemilu.org#64654,"JELARAI SELOR, TANJUNG SELOR, BULUNGAN, KALIMANTAN UTARA",12,193,18,211
https://kawalpemilu.org#64654,"JELARAI SELOR, TANJUNG SELOR, BULUNGAN, KALIMANTAN UTARA",13,175,31,206
https://kawalpemilu.org#64654,"JELARAI SELOR, TANJUNG SELOR, BULUNGAN, KALIMANTAN UTARA",14,88,32,120
https://kawalpemilu.org#64654,"JELARAI SELOR, TANJUNG SELOR, BULUNGAN, KALIMANTAN UTARA",15,99,38,137
https://kawalpemilu.org#64654,"JELARAI SELOR, TANJUNG SELOR, BULUNGAN, KALIMANTAN UTARA",16,40,133,173
https://kawalpemilu.org#64655,"GUNUNG SERIANG, TANJUNG SELOR, BULUNGAN, KALIMANTAN UTARA",1,190,63,253
https://kawalpemilu.org#64655,"GUNUNG SERIANG, TANJUNG SELOR, BULUNGAN, KALIMANTAN UTARA",2,125,27,152
https://kawalpemilu.org#64655,"GUNUNG SERIANG, TANJUNG SELOR, BULUNGAN, KALIMANTAN UTARA",3,73,10,83
https://kawalpemilu.org#64656,"BUMI RAHAYU, TANJUNG SELOR, BULUNGAN, KALIMANTAN UTARA",1,92,50,142
https://kawalpemilu.org#64656,"BUMI RAHAYU, TANJUNG SELOR, BULUNGAN, KALIMANTAN UTARA",2,91,61,152
https://kawalpemilu.org#64656,"BUMI RAHAYU, TANJUNG SELOR, BULUNGAN, KALIMANTAN UTARA",3,127,75,202
https://kawalpemilu.org#64656,"BUMI RAHAYU, TANJUNG SELOR, BULUNGAN, KALIMANTAN UTARA",4,95,36,131
https://kawalpemilu.org#64657,"GUNUNG SARI, TANJUNG SELOR, BULUNGAN, KALIMANTAN UTARA",1,134,51,185
https://kawalpemilu.org#64657,"GUNUNG SARI, TANJUNG SELOR, BULUNGAN, KALIMANTAN UTARA",2,98,47,145
https://kawalpemilu.org#64657,"GUNUNG SARI, TANJUNG SELOR, BULUNGAN, KALIMANTAN UTARA",3,55,121,176
https://kawalpemilu.org#64657,"GUNUNG SARI, TANJUNG SELOR, BULUNGAN, KALIMANTAN UTARA",4,112,51,163
https://kawalpemilu.org#64657,"GUNUNG SARI, TANJUNG SELOR, BULUNGAN, KALIMANTAN UTARA",5,109,57,166
https://kawalpemilu.org#64658,"APUNG, TANJUNG SELOR, BULUNGAN, KALIMANTAN UTARA",1,201,58,259
https://kawalpemilu.org#64658,"APUNG, TANJUNG SELOR, BULUNGAN, KALIMANTAN UTARA",2,167,86,253
https://kawalpemilu.org#64658,"APUNG, TANJUNG SELOR, BULUNGAN, KALIMANTAN UTARA",3,194,74,268
https://kawalpemilu.org#64658,"APUNG, TANJUNG SELOR, BULUNGAN, KALIMANTAN UTARA",4,208,61,269
https://kawalpemilu.org#64658,"APUNG, TANJUNG SELOR, BULUNGAN, KALIMANTAN UTARA",5,166,36,202
https://kawalpemilu.org#64658,"APUNG, TANJUNG SELOR, BULUNGAN, KALIMANTAN UTARA",6,135,40,175
https://kawalpemilu.org#64658,"APUNG, TANJUNG SELOR, BULUNGAN, KALIMANTAN UTARA",7,111,36,1
https://kawalpemilu.org#64659,"TENGKAPAK, TANJUNG SELOR, BULUNGAN, KALIMANTAN UTARA",1,155,10,165
https://kawalpemilu.org#64659,"TENGKAPAK, TANJUNG SELOR, BULUNGAN, KALIMANTAN UTARA",2,166,13,179
https://kawalpemilu.org#64659,"TENGKAPAK, TANJUNG SELOR, BULUNGAN, KALIMANTAN UTARA",3,86,7,93
https://kawalpemilu.org#64659,"TENGKAPAK, TANJUNG SELOR, BULUNGAN, KALIMANTAN UTARA",4,105,16,121
https://kawalpemilu.org#64661,"SALIMBATU, TANJUNG PALAS TENGAH, BULUNGAN, KALIMANTAN UTARA",1,171,81,252
https://kawalpemilu.org#64661,"SALIMBATU, TANJUNG PALAS TENGAH, BULUNGAN, KALIMANTAN UTARA",2,106,96,202
https://kawalpemilu.org#64661,"SALIMBATU, TANJUNG PALAS TENGAH, BULUNGAN, KALIMANTAN UTARA",3,166,42,208
https://kawalpemilu.org#64661,"SALIMBATU, TANJUNG PALAS TENGAH, BULUNGAN, KALIMANTAN UTARA",4,125,87,212
https://kawalpemilu.org#64661,"SALIMBATU, TANJUNG PALAS TENGAH, BULUNGAN, KALIMANTAN UTARA",5,121,63,184
https://kawalpemilu.org#64661,"SALIMBATU, TANJUNG PALAS TENGAH, BULUNGAN, KALIMANTAN UTARA",6,126,80,206
https://kawalpemilu.org#64661,"SALIMBATU, TANJUNG PALAS TENGAH, BULUNGAN, KALIMANTAN UTARA",7,150,83,233
https://kawalpemilu.org#64661,"SALIMBATU, TANJUNG PALAS TENGAH, BULUNGAN, KALIMANTAN UTARA",8,169,64,232
https://kawalpemilu.org#64661,"SALIMBATU, TANJUNG PALAS TENGAH, BULUNGAN, KALIMANTAN UTARA",9,119,54,173
https://kawalpemilu.org#64661,"SALIMBATU, TANJUNG PALAS TENGAH, BULUNGAN, KALIMANTAN UTARA",10,134,17,151
https://kawalpemilu.org#64661,"SALIMBATU, TANJUNG PALAS TENGAH, BULUNGAN, KALIMANTAN UTARA",11,118,54,172
https://kawalpemilu.org#64661,"SALIMBATU, TANJUNG PALAS TENGAH, BULUNGAN, KALIMANTAN UTARA",12,63,18,81
https://kawalpemilu.org#64661,"SALIMBATU, TANJUNG PALAS TENGAH, BULUNGAN, KALIMANTAN UTARA",13,136,46,182
https://kawalpemilu.org#64661,"SALIMBATU, TANJUNG PALAS TENGAH, BULUNGAN, KALIMANTAN UTARA",14,93,62,155
https://kawalpemilu.org#64661,"SALIMBATU, TANJUNG PALAS TENGAH, BULUNGAN, KALIMANTAN UTARA",15,154,12,166
https://kawalpemilu.org#64661,"SALIMBATU, TANJUNG PALAS TENGAH, BULUNGAN, KALIMANTAN UTARA",16,169,26,195
https://kawalpemilu.org#64661,"SALIMBATU, TANJUNG PALAS TENGAH, BULUNGAN, KALIMANTAN UTARA",17,120,39,159
https://kawalpemilu.org#64662,"SILVA RAHAYU, TANJUNG PALAS TENGAH, BULUNGAN, KALIMANTAN UTARA",1,155,56,211
https://kawalpemilu.org#64662,"SILVA RAHAYU, TANJUNG PALAS TENGAH, BULUNGAN, KALIMANTAN UTARA",2,124,60,184
https://kawalpemilu.org#64662,"SILVA RAHAYU, TANJUNG PALAS TENGAH, BULUNGAN, KALIMANTAN UTARA",3,147,38,185
https://kawalpemilu.org#64662,"SILVA RAHAYU, TANJUNG PALAS TENGAH, BULUNGAN, KALIMANTAN UTARA",4,149,8,157
https://kawalpemilu.org#64663,"TANJUNG BUKA, TANJUNG PALAS TENGAH, BULUNGAN, KALIMANTAN UTARA",1,109,97,206
https://kawalpemilu.org#64663,"TANJUNG BUKA, TANJUNG PALAS TENGAH, BULUNGAN, KALIMANTAN UTARA",2,172,33,205
https://kawalpemilu.org#64663,"TANJUNG BUKA, TANJUNG PALAS TENGAH, BULUNGAN, KALIMANTAN UTARA",3,139,26,165
https://kawalpemilu.org#64663,"TANJUNG BUKA, TANJUNG PALAS TENGAH, BULUNGAN, KALIMANTAN UTARA",4,111,32,143
https://kawalpemilu.org#64663,"TANJUNG BUKA, TANJUNG PALAS TENGAH, BULUNGAN, KALIMANTAN UTARA",5,142,24,166
https://kawalpemilu.org#64663,"TANJUNG BUKA, TANJUNG PALAS TENGAH, BULUNGAN, KALIMANTAN UTARA",6,108,67,175
https://kawalpemilu.org#64663,"TANJUNG BUKA, TANJUNG PALAS TENGAH, BULUNGAN, KALIMANTAN UTARA",7,70,54,124
https://kawalpemilu.org#64663,"TANJUNG BUKA, TANJUNG PALAS TENGAH, BULUNGAN, KALIMANTAN UTARA",8,120,66,186
https://kawalpemilu.org#64663,"TANJUNG BUKA, TANJUNG PALAS TENGAH, BULUNGAN, KALIMANTAN UTARA",9,158,22,180
https://kawalpemilu.org#64663,"TANJUNG BUKA, TANJUNG PALAS TENGAH, BULUNGAN, KALIMANTAN UTARA",10,76,18,94
https://kawalpemilu.org#64663,"TANJUNG BUKA, TANJUNG PALAS TENGAH, BULUNGAN, KALIMANTAN UTARA",11,88,28,116
https://kawalpemilu.org#64663,"TANJUNG BUKA, TANJUNG PALAS TENGAH, BULUNGAN, KALIMANTAN UTARA",12,91,71,162
https://kawalpemilu.org#64663,"TANJUNG BUKA, TANJUNG PALAS TENGAH, BULUNGAN, KALIMANTAN UTARA",13,132,59,191
https://kawalpemilu.org#64663,"TANJUNG BUKA, TANJUNG PALAS TENGAH, BULUNGAN, KALIMANTAN UTARA",14,95,21,116
https://kawalpemilu.org#64665,"LEPAK ARU, PESO, BULUNGAN, KALIMANTAN UTARA",1,217,19,236
https://kawalpemilu.org#64665,"LEPAK ARU, PESO, BULUNGAN, KALIMANTAN UTARA",2,112,17,129
https://kawalpemilu.org#64666,"LONG LASAN, PESO, BULUNGAN, KALIMANTAN UTARA",1,108,15,123
https://kawalpemilu.org#64666,"LONG LASAN, PESO, BULUNGAN, KALIMANTAN UTARA",2,107,14,121
https://kawalpemilu.org#64667,"LONG PESO, PESO, BULUNGAN, KALIMANTAN UTARA",1,168,30,198
https://kawalpemilu.org#64667,"LONG PESO, PESO, BULUNGAN, KALIMANTAN UTARA",2,196,30,226
https://kawalpemilu.org#64668,"LONG BIA, PESO, BULUNGAN, KALIMANTAN UTARA",1,140,47,187
https://kawalpemilu.org#64668,"LONG BIA, PESO, BULUNGAN, KALIMANTAN UTARA",2,56,3,59
https://kawalpemilu.org#64669,"MUARA PENGEAN, PESO, BULUNGAN, KALIMANTAN UTARA",1,126,23,149
https://kawalpemilu.org#64669,"MUARA PENGEAN, PESO, BULUNGAN, KALIMANTAN UTARA",2,105,16,122
https://kawalpemilu.org#64670,"LONG LIAN, PESO, BULUNGAN, KALIMANTAN UTARA",1,160,9,169
https://kawalpemilu.org#64671,"LONG PELAAH, PESO, BULUNGAN, KALIMANTAN UTARA",1,86,1,87
https://kawalpemilu.org#64672,"LONG LEJUH, PESO, BULUNGAN, KALIMANTAN UTARA",1,198,11,209
https://kawalpemilu.org#64673,"LONG PELBAN, PESO, BULUNGAN, KALIMANTAN UTARA",1,102,12,114
https://kawalpemilu.org#64674,"LONG BUANG, PESO, BULUNGAN, KALIMANTAN UTARA",1,211,22,233
https://kawalpemilu.org#64676,"LONG TUNGU, PESO HILIR, BULUNGAN, KALIMANTAN UTARA",1,163,13,176
https://kawalpemilu.org#64676,"LONG TUNGU, PESO HILIR, BULUNGAN, KALIMANTAN UTARA",2,112,9,121
https://kawalpemilu.org#64676,"LONG TUNGU, PESO HILIR, BULUNGAN, KALIMANTAN UTARA",3,150,44,194
https://kawalpemilu.org#64676,"LONG TUNGU, PESO HILIR, BULUNGAN, KALIMANTAN UTARA",4,22,7,29
https://kawalpemilu.org#64677,"LONG BANG, PESO HILIR, BULUNGAN, KALIMANTAN UTARA",1,204,13,217
https://kawalpemilu.org#64677,"LONG BANG, PESO HILIR, BULUNGAN, KALIMANTAN UTARA",2,230,7,237
https://kawalpemilu.org#64678,"LONG TELENJAU, PESO HILIR, BULUNGAN, KALIMANTAN UTARA",1,192,9,201
https://kawalpemilu.org#64678,"LONG TELENJAU, PESO HILIR, BULUNGAN, KALIMANTAN UTARA",2,84,2,86
https://kawalpemilu.org#64679,"NAHA AYA, PESO HILIR, BULUNGAN, KALIMANTAN UTARA",1,118,7,125
https://kawalpemilu.org#64679,"NAHA AYA, PESO HILIR, BULUNGAN, KALIMANTAN UTARA",2,121,11,132
https://kawalpemilu.org#64679,"NAHA AYA, PESO HILIR, BULUNGAN, KALIMANTAN UTARA",3,153,8,161
https://kawalpemilu.org#64679,"NAHA AYA, PESO HILIR, BULUNGAN, KALIMANTAN UTARA",4,39,1,40
https://kawalpemilu.org#64680,"LONG LEMBU, PESO HILIR, BULUNGAN, KALIMANTAN UTARA",1,193,23,216
https://kawalpemilu.org#64681,"LONG BANG HULU, PESO HILIR, BULUNGAN, KALIMANTAN UTARA",1,174,4,178
https://kawalpemilu.org#64681,"LONG BANG HULU, PESO HILIR, BULUNGAN, KALIMANTAN UTARA",2,158,1,159
https://kawalpemilu.org#64683,"SEKATAK BUJI, SEKATAK, BULUNGAN, KALIMANTAN UTARA",1,109,101,210
https://kawalpemilu.org#64683,"SEKATAK BUJI, SEKATAK, BULUNGAN, KALIMANTAN UTARA",2,101,87,188
https://kawalpemilu.org#64683,"SEKATAK BUJI, SEKATAK, BULUNGAN, KALIMANTAN UTARA",3,121,86,207
https://kawalpemilu.org#64683,"SEKATAK BUJI, SEKATAK, BULUNGAN, KALIMANTAN UTARA",4,119,61,180
https://kawalpemilu.org#64683,"SEKATAK BUJI, SEKATAK, BULUNGAN, KALIMANTAN UTARA",5,117,11,128
https://kawalpemilu.org#64683,"SEKATAK BUJI, SEKATAK, BULUNGAN, KALIMANTAN UTARA",6,170,25,195
https://kawalpemilu.org#64683,"SEKATAK BUJI, SEKATAK, BULUNGAN, KALIMANTAN UTARA",7,42,10,52
https://kawalpemilu.org#64684,"PARU ABANG, SEKATAK, BULUNGAN, KALIMANTAN UTARA",1,160,18,178
https://kawalpemilu.org#64685,"BUNAU, SEKATAK, BULUNGAN, KALIMANTAN UTARA",1,115,29,144
https://kawalpemilu.org#64685,"BUNAU, SEKATAK, BULUNGAN, KALIMANTAN UTARA",2,76,5,81
https://kawalpemilu.org#64686,"UJANG, SEKATAK, BULUNGAN, KALIMANTAN UTARA",1,162,8,170
https://kawalpemilu.org#64687,"TENGGILING, SEKATAK, BULUNGAN, KALIMANTAN UTARA",1,116,13,129
https://kawalpemilu.org#64688,"KELEMBUNAN, SEKATAK, BULUNGAN, KALIMANTAN UTARA",1,178,16,194
https://kawalpemilu.org#64689,"TURUNG, SEKATAK, BULUNGAN, KALIMANTAN UTARA",1,154,3,157
https://kawalpemilu.org#64690,"TERINDAK, SEKATAK, BULUNGAN, KALIMANTAN UTARA",1,155,4,159
https://kawalpemilu.org#64691,"KELISING, SEKATAK, BULUNGAN, KALIMANTAN UTARA",1,147,15,162
https://kawalpemilu.org#64692,"AMBALAT, SEKATAK, BULUNGAN, KALIMANTAN UTARA",1,143,9,152
https://kawalpemilu.org#64693,"KERITING, SEKATAK, BULUNGAN, KALIMANTAN UTARA",1,52,1,53
https://kawalpemilu.org#64694,"KENDARI, SEKATAK, BULUNGAN, KALIMANTAN UTARA",1,93,3,96
https://kawalpemilu.org#64695,"BAMBANG, SEKATAK, BULUNGAN, KALIMANTAN UTARA",1,65,13,78
https://kawalpemilu.org#64696,"MARITAM, SEKATAK, BULUNGAN, KALIMANTAN UTARA",1,118,26,144
https://kawalpemilu.org#64697,"PENTIAN, SEKATAK, BULUNGAN, KALIMANTAN UTARA",1,169,17,186
https://kawalpemilu.org#64698,"PUNAN DULAU, SEKATAK, BULUNGAN, KALIMANTAN UTARA",1,134,22,156
https://kawalpemilu.org#64699,"KELINCAUAN, SEKATAK, BULUNGAN, KALIMANTAN UTARA",1,202,24,226
https://kawalpemilu.org#64700,"BEKILIU, SEKATAK, BULUNGAN, KALIMANTAN UTARA",1,181,12,193
https://kawalpemilu.org#64701,"SEKATAK BENGARA, SEKATAK, BULUNGAN, KALIMANTAN UTARA",1,89,48,137
https://kawalpemilu.org#64701,"SEKATAK BENGARA, SEKATAK, BULUNGAN, KALIMANTAN UTARA",2,99,39,138
https://kawalpemilu.org#64701,"SEKATAK BENGARA, SEKATAK, BULUNGAN, KALIMANTAN UTARA",3,117,39,156
https://kawalpemilu.org#64701,"SEKATAK BENGARA, SEKATAK, BULUNGAN, KALIMANTAN UTARA",4,124,6,130
https://kawalpemilu.org#64702,"PUNGIT, SEKATAK, BULUNGAN, KALIMANTAN UTARA",1,126,36,162
https://kawalpemilu.org#64702,"PUNGIT, SEKATAK, BULUNGAN, KALIMANTAN UTARA",2,146,8,154
https://kawalpemilu.org#64703,"ANJAR ARIP, SEKATAK, BULUNGAN, KALIMANTAN UTARA",1,86,7,93
https://kawalpemilu.org#64704,"LIAGU, SEKATAK, BULUNGAN, KALIMANTAN UTARA",1,130,48,178
https://kawalpemilu.org#64704,"LIAGU, SEKATAK, BULUNGAN, KALIMANTAN UTARA",2,83,22,105
https://kawalpemilu.org#64704,"LIAGU, SEKATAK, BULUNGAN, KALIMANTAN UTARA",3,38,6,44
https://kawalpemilu.org#64706,"BUNYU BARAT, BUNYU, BULUNGAN, KALIMANTAN UTARA",1,144,103,247
https://kawalpemilu.org#64706,"BUNYU BARAT, BUNYU, BULUNGAN, KALIMANTAN UTARA",2,131,113,244
https://kawalpemilu.org#64706,"BUNYU BARAT, BUNYU, BULUNGAN, KALIMANTAN UTARA",3,133,68,201
https://kawalpemilu.org#64706,"BUNYU BARAT, BUNYU, BULUNGAN, KALIMANTAN UTARA",4,118,103,221
https://kawalpemilu.org#64706,"BUNYU BARAT, BUNYU, BULUNGAN, KALIMANTAN UTARA",5,171,70,241
https://kawalpemilu.org#64706,"BUNYU BARAT, BUNYU, BULUNGAN, KALIMANTAN UTARA",6,73,73,146
https://kawalpemilu.org#64706,"BUNYU BARAT, BUNYU, BULUNGAN, KALIMANTAN UTARA",7,157,98,255
https://kawalpemilu.org#64706,"BUNYU BARAT, BUNYU, BULUNGAN, KALIMANTAN UTARA",8,114,54,168
https://kawalpemilu.org#64706,"BUNYU BARAT, BUNYU, BULUNGAN, KALIMANTAN UTARA",9,154,55,209
https://kawalpemilu.org#64706,"BUNYU BARAT, BUNYU, BULUNGAN, KALIMANTAN UTARA",10,109,146,255
https://kawalpemilu.org#64706,"BUNYU BARAT, BUNYU, BULUNGAN, KALIMANTAN UTARA",11,114,80,194
https://kawalpemilu.org#64706,"BUNYU BARAT, BUNYU, BULUNGAN, KALIMANTAN UTARA",12,162,95,257
https://kawalpemilu.org#64706,"BUNYU BARAT, BUNYU, BULUNGAN, KALIMANTAN UTARA",13,135,61,196
https://kawalpemilu.org#64706,"BUNYU BARAT, BUNYU, BULUNGAN, KALIMANTAN UTARA",14,212,35,247
https://kawalpemilu.org#64706,"BUNYU BARAT, BUNYU, BULUNGAN, KALIMANTAN UTARA",15,175,55,230
https://kawalpemilu.org#64706,"BUNYU BARAT, BUNYU, BULUNGAN, KALIMANTAN UTARA",16,99,56,155
https://kawalpemilu.org#64707,"BUNYU SELATAN, BUNYU, BULUNGAN, KALIMANTAN UTARA",1,115,32,147
https://kawalpemilu.org#64707,"BUNYU SELATAN, BUNYU, BULUNGAN, KALIMANTAN UTARA",2,77,38,115
https://kawalpemilu.org#64707,"BUNYU SELATAN, BUNYU, BULUNGAN, KALIMANTAN UTARA",3,158,55,213
https://kawalpemilu.org#64707,"BUNYU SELATAN, BUNYU, BULUNGAN, KALIMANTAN UTARA",4,118,42,160
https://kawalpemilu.org#64707,"BUNYU SELATAN, BUNYU, BULUNGAN, KALIMANTAN UTARA",5,122,99,221
https://kawalpemilu.org#64707,"BUNYU SELATAN, BUNYU, BULUNGAN, KALIMANTAN UTARA",6,132,41,173
https://kawalpemilu.org#64707,"BUNYU SELATAN, BUNYU, BULUNGAN, KALIMANTAN UTARA",7,133,88,221
https://kawalpemilu.org#64707,"BUNYU SELATAN, BUNYU, BULUNGAN, KALIMANTAN UTARA",8,120,99,219
https://kawalpemilu.org#64707,"BUNYU SELATAN, BUNYU, BULUNGAN, KALIMANTAN UTARA",9,83,34,117
https://kawalpemilu.org#64708,"BUNYU TIMUR, BUNYU, BULUNGAN, KALIMANTAN UTARA",1,48,33,81
https://kawalpemilu.org#64708,"BUNYU TIMUR, BUNYU, BULUNGAN, KALIMANTAN UTARA",2,124,86,210
https://kawalpemilu.org#64708,"BUNYU TIMUR, BUNYU, BULUNGAN, KALIMANTAN UTARA",3,113,62,175
https://kawalpemilu.org#64708,"BUNYU TIMUR, BUNYU, BULUNGAN, KALIMANTAN UTARA",4,60,59,119
https://kawalpemilu.org#64708,"BUNYU TIMUR, BUNYU, BULUNGAN, KALIMANTAN UTARA",5,119,79,198
https://kawalpemilu.org#64708,"BUNYU TIMUR, BUNYU, BULUNGAN, KALIMANTAN UTARA",6,145,58,203
https://kawalpemilu.org#64708,"BUNYU TIMUR, BUNYU, BULUNGAN, KALIMANTAN UTARA",7,107,31,138
https://kawalpemilu.org#64708,"BUNYU TIMUR, BUNYU, BULUNGAN, KALIMANTAN UTARA",8,60,60,120
https://kawalpemilu.org#64708,"BUNYU TIMUR, BUNYU, BULUNGAN, KALIMANTAN UTARA",9,127,33,160
https://kawalpemilu.org#64708,"BUNYU TIMUR, BUNYU, BULUNGAN, KALIMANTAN UTARA",10,139,108,247
https://kawalpemilu.org#64711,"TANJUNGKARANG, SEBATIK, NUNUKAN, KALIMANTAN UTARA",1,144,28,172
https://kawalpemilu.org#64711,"TANJUNGKARANG, SEBATIK, NUNUKAN, KALIMANTAN UTARA",2,197,36,233
https://kawalpemilu.org#64711,"TANJUNGKARANG, SEBATIK, NUNUKAN, KALIMANTAN UTARA",3,215,24,239
https://kawalpemilu.org#64711,"TANJUNGKARANG, SEBATIK, NUNUKAN, KALIMANTAN UTARA",4,109,31,140
https://kawalpemilu.org#64711,"TANJUNGKARANG, SEBATIK, NUNUKAN, KALIMANTAN UTARA",5,167,20,187
https://kawalpemilu.org#64711,"TANJUNGKARANG, SEBATIK, NUNUKAN, KALIMANTAN UTARA",6,115,50,165
https://kawalpemilu.org#64711,"TANJUNGKARANG, SEBATIK, NUNUKAN, KALIMANTAN UTARA",7,185,35,220
https://kawalpemilu.org#64711,"TANJUNGKARANG, SEBATIK, NUNUKAN, KALIMANTAN UTARA",8,124,28,152
https://kawalpemilu.org#64715,"BALANSIKU, SEBATIK, NUNUKAN, KALIMANTAN UTARA",1,129,31,160
https://kawalpemilu.org#64715,"BALANSIKU, SEBATIK, NUNUKAN, KALIMANTAN UTARA",2,110,30,140
https://kawalpemilu.org#64715,"BALANSIKU, SEBATIK, NUNUKAN, KALIMANTAN UTARA",3,118,17,135
https://kawalpemilu.org#64715,"BALANSIKU, SEBATIK, NUNUKAN, KALIMANTAN UTARA",4,112,43,155
https://kawalpemilu.org#64715,"BALANSIKU, SEBATIK, NUNUKAN, KALIMANTAN UTARA",5,93,10,103
https://kawalpemilu.org#64716,"SEI MANURUNG, SEBATIK, NUNUKAN, KALIMANTAN UTARA",1,160,29,189
https://kawalpemilu.org#64716,"SEI MANURUNG, SEBATIK, NUNUKAN, KALIMANTAN UTARA",2,84,22,106
https://kawalpemilu.org#64716,"SEI MANURUNG, SEBATIK, NUNUKAN, KALIMANTAN UTARA",3,131,31,162
https://kawalpemilu.org#92763,"PADAIDI, SEBATIK, NUNUKAN, KALIMANTAN UTARA",1,156,47,203
https://kawalpemilu.org#92763,"PADAIDI, SEBATIK, NUNUKAN, KALIMANTAN UTARA",2,156,51,207
https://kawalpemilu.org#64724,"NUNUKAN TIMUR, NUNUKAN, NUNUKAN, KALIMANTAN UTARA",1,91,32,123
https://kawalpemilu.org#64724,"NUNUKAN TIMUR, NUNUKAN, NUNUKAN, KALIMANTAN UTARA",2,54,21,75
https://kawalpemilu.org#64724,"NUNUKAN TIMUR, NUNUKAN, NUNUKAN, KALIMANTAN UTARA",3,54,28,82
https://kawalpemilu.org#64724,"NUNUKAN TIMUR, NUNUKAN, NUNUKAN, KALIMANTAN UTARA",4,86,50,136
https://kawalpemilu.org#64724,"NUNUKAN TIMUR, NUNUKAN, NUNUKAN, KALIMANTAN UTARA",5,71,106,177
https://kawalpemilu.org#64724,"NUNUKAN TIMUR, NUNUKAN, NUNUKAN, KALIMANTAN UTARA",6,67,43,110
https://kawalpemilu.org#64724,"NUNUKAN TIMUR, NUNUKAN, NUNUKAN, KALIMANTAN UTARA",7,47,55,102
https://kawalpemilu.org#64724,"NUNUKAN TIMUR, NUNUKAN, NUNUKAN, KALIMANTAN UTARA",8,100,53,153
https://kawalpemilu.org#64724,"NUNUKAN TIMUR, NUNUKAN, NUNUKAN, KALIMANTAN UTARA",9,80,70,150
https://kawalpemilu.org#64724,"NUNUKAN TIMUR, NUNUKAN, NUNUKAN, KALIMANTAN UTARA",10,52,45,97
https://kawalpemilu.org#64724,"NUNUKAN TIMUR, NUNUKAN, NUNUKAN, KALIMANTAN UTARA",11,61,32,93
https://kawalpemilu.org#64724,"NUNUKAN TIMUR, NUNUKAN, NUNUKAN, KALIMANTAN UTARA",12,50,48,98
https://kawalpemilu.org#64724,"NUNUKAN TIMUR, NUNUKAN, NUNUKAN, KALIMANTAN UTARA",13,84,63,147
https://kawalpemilu.org#64724,"NUNUKAN TIMUR, NUNUKAN, NUNUKAN, KALIMANTAN UTARA",14,82,106,188
https://kawalpemilu.org#64724,"NUNUKAN TIMUR, NUNUKAN, NUNUKAN, KALIMANTAN UTARA",15,115,41,156
https://kawalpemilu.org#64724,"NUNUKAN TIMUR, NUNUKAN, NUNUKAN, KALIMANTAN UTARA",16,94,31,125
https://kawalpemilu.org#64724,"NUNUKAN TIMUR, NUNUKAN, NUNUKAN, KALIMANTAN UTARA",17,89,39,128
https://kawalpemilu.org#64724,"NUNUKAN TIMUR, NUNUKAN, NUNUKAN, KALIMANTAN UTARA",18,48,39,87
https://kawalpemilu.org#64724,"NUNUKAN TIMUR, NUNUKAN, NUNUKAN, KALIMANTAN UTARA",19,62,28,90
https://kawalpemilu.org#64724,"NUNUKAN TIMUR, NUNUKAN, NUNUKAN, KALIMANTAN UTARA",20,68,52,120
https://kawalpemilu.org#64724,"NUNUKAN TIMUR, NUNUKAN, NUNUKAN, KALIMANTAN UTARA",21,80,79,159
https://kawalpemilu.org#64724,"NUNUKAN TIMUR, NUNUKAN, NUNUKAN, KALIMANTAN UTARA",23,85,64,149
https://kawalpemilu.org#64724,"NUNUKAN TIMUR, NUNUKAN, NUNUKAN, KALIMANTAN UTARA",24,93,43,136
https://kawalpemilu.org#64724,"NUNUKAN TIMUR, NUNUKAN, NUNUKAN, KALIMANTAN UTARA",25,78,54,132
https://kawalpemilu.org#64724,"NUNUKAN TIMUR, NUNUKAN, NUNUKAN, KALIMANTAN UTARA",26,69,25,94
https://kawalpemilu.org#64724,"NUNUKAN TIMUR, NUNUKAN, NUNUKAN, KALIMANTAN UTARA",27,68,19,87
https://kawalpemilu.org#64724,"NUNUKAN TIMUR, NUNUKAN, NUNUKAN, KALIMANTAN UTARA",28,57,26,83
https://kawalpemilu.org#64724,"NUNUKAN TIMUR, NUNUKAN, NUNUKAN, KALIMANTAN UTARA",29,87,40,127
https://kawalpemilu.org#64724,"NUNUKAN TIMUR, NUNUKAN, NUNUKAN, KALIMANTAN UTARA",30,94,59,153
https://kawalpemilu.org#64724,"NUNUKAN TIMUR, NUNUKAN, NUNUKAN, KALIMANTAN UTARA",31,77,58,135
https://kawalpemilu.org#64724,"NUNUKAN TIMUR, NUNUKAN, NUNUKAN, KALIMANTAN UTARA",32,76,38,114
https://kawalpemilu.org#64724,"NUNUKAN TIMUR, NUNUKAN, NUNUKAN, KALIMANTAN UTARA",33,71,42,113
https://kawalpemilu.org#64724,"NUNUKAN TIMUR, NUNUKAN, NUNUKAN, KALIMANTAN UTARA",34,46,44,90
https://kawalpemilu.org#64724,"NUNUKAN TIMUR, NUNUKAN, NUNUKAN, KALIMANTAN UTARA",35,77,46,123
https://kawalpemilu.org#64724,"NUNUKAN TIMUR, NUNUKAN, NUNUKAN, KALIMANTAN UTARA",36,46,16,62
https://kawalpemilu.org#64724,"NUNUKAN TIMUR, NUNUKAN, NUNUKAN, KALIMANTAN UTARA",37,76,31,107
https://kawalpemilu.org#64724,"NUNUKAN TIMUR, NUNUKAN, NUNUKAN, KALIMANTAN UTARA",38,85,71,156
https://kawalpemilu.org#64724,"NUNUKAN TIMUR, NUNUKAN, NUNUKAN, KALIMANTAN UTARA",39,50,47,97
https://kawalpemilu.org#64724,"NUNUKAN TIMUR, NUNUKAN, NUNUKAN, KALIMANTAN UTARA",40,48,31,79
https://kawalpemilu.org#64724,"NUNUKAN TIMUR, NUNUKAN, NUNUKAN, KALIMANTAN UTARA",41,87,60,147
https://kawalpemilu.org#64724,"NUNUKAN TIMUR, NUNUKAN, NUNUKAN, KALIMANTAN UTARA",42,106,55,161
https://kawalpemilu.org#64724,"NUNUKAN TIMUR, NUNUKAN, NUNUKAN, KALIMANTAN UTARA",43,62,63,125
https://kawalpemilu.org#64724,"NUNUKAN TIMUR, NUNUKAN, NUNUKAN, KALIMANTAN UTARA",44,61,36,97
https://kawalpemilu.org#64724,"NUNUKAN TIMUR, NUNUKAN, NUNUKAN, KALIMANTAN UTARA",45,49,42,91
https://kawalpemilu.org#64724,"NUNUKAN TIMUR, NUNUKAN, NUNUKAN, KALIMANTAN UTARA",46,63,56,119
https://kawalpemilu.org#64724,"NUNUKAN TIMUR, NUNUKAN, NUNUKAN, KALIMANTAN UTARA",47,36,28,64
https://kawalpemilu.org#64724,"NUNUKAN TIMUR, NUNUKAN, NUNUKAN, KALIMANTAN UTARA",48,81,147,228
https://kawalpemilu.org#64724,"NUNUKAN TIMUR, NUNUKAN, NUNUKAN, KALIMANTAN UTARA",49,130,50,180
https://kawalpemilu.org#64724,"NUNUKAN TIMUR, NUNUKAN, NUNUKAN, KALIMANTAN UTARA",50,68,27,95
https://kawalpemilu.org#64724,"NUNUKAN TIMUR, NUNUKAN, NUNUKAN, KALIMANTAN UTARA",51,83,42,125
https://kawalpemilu.org#64724,"NUNUKAN TIMUR, NUNUKAN, NUNUKAN, KALIMANTAN UTARA",52,67,32,99
https://kawalpemilu.org#64724,"NUNUKAN TIMUR, NUNUKAN, NUNUKAN, KALIMANTAN UTARA",53,56,26,82
https://kawalpemilu.org#64724,"NUNUKAN TIMUR, NUNUKAN, NUNUKAN, KALIMANTAN UTARA",54,42,30,72
https://kawalpemilu.org#64724,"NUNUKAN TIMUR, NUNUKAN, NUNUKAN, KALIMANTAN UTARA",55,57,30,87
https://kawalpemilu.org#64724,"NUNUKAN TIMUR, NUNUKAN, NUNUKAN, KALIMANTAN UTARA",56,49,45,94
https://kawalpemilu.org#64724,"NUNUKAN TIMUR, NUNUKAN, NUNUKAN, KALIMANTAN UTARA",57,90,33,123
https://kawalpemilu.org#64724,"NUNUKAN TIMUR, NUNUKAN, NUNUKAN, KALIMANTAN UTARA",58,52,49,101
https://kawalpemilu.org#64724,"NUNUKAN TIMUR, NUNUKAN, NUNUKAN, KALIMANTAN UTARA",59,57,29,86
https://kawalpemilu.org#64724,"NUNUKAN TIMUR, NUNUKAN, NUNUKAN, KALIMANTAN UTARA",60,53,79,102
https://kawalpemilu.org#64724,"NUNUKAN TIMUR, NUNUKAN, NUNUKAN, KALIMANTAN UTARA",61,50,19,69
https://kawalpemilu.org#64724,"NUNUKAN TIMUR, NUNUKAN, NUNUKAN, KALIMANTAN UTARA",62,66,32,98
https://kawalpemilu.org#64724,"NUNUKAN TIMUR, NUNUKAN, NUNUKAN, KALIMANTAN UTARA",63,56,37,93
https://kawalpemilu.org#64724,"NUNUKAN TIMUR, NUNUKAN, NUNUKAN, KALIMANTAN UTARA",64,64,38,102
https://kawalpemilu.org#64724,"NUNUKAN TIMUR, NUNUKAN, NUNUKAN, KALIMANTAN UTARA",65,52,24,76
https://kawalpemilu.org#64724,"NUNUKAN TIMUR, NUNUKAN, NUNUKAN, KALIMANTAN UTARA",66,88,39,127
https://kawalpemilu.org#64724,"NUNUKAN TIMUR, NUNUKAN, NUNUKAN, KALIMANTAN UTARA",67,55,34,89
https://kawalpemilu.org#64724,"NUNUKAN TIMUR, NUNUKAN, NUNUKAN, KALIMANTAN UTARA",68,78,67,145
https://kawalpemilu.org#64725,"NUNUKAN BARAT, NUNUKAN, NUNUKAN, KALIMANTAN UTARA",1,131,41,172
https://kawalpemilu.org#64725,"NUNUKAN BARAT, NUNUKAN, NUNUKAN, KALIMANTAN UTARA",2,68,67,135
https://kawalpemilu.org#64725,"NUNUKAN BARAT, NUNUKAN, NUNUKAN, KALIMANTAN UTARA",3,144,91,235
https://kawalpemilu.org#64725,"NUNUKAN BARAT, NUNUKAN, NUNUKAN, KALIMANTAN UTARA",4,114,54,168
https://kawalpemilu.org#64725,"NUNUKAN BARAT, NUNUKAN, NUNUKAN, KALIMANTAN UTARA",5,80,35,115
https://kawalpemilu.org#64725,"NUNUKAN BARAT, NUNUKAN, NUNUKAN, KALIMANTAN UTARA",6,127,66,193
https://kawalpemilu.org#64725,"NUNUKAN BARAT, NUNUKAN, NUNUKAN, KALIMANTAN UTARA",7,101,22,123
https://kawalpemilu.org#64725,"NUNUKAN BARAT, NUNUKAN, NUNUKAN, KALIMANTAN UTARA",8,120,63,183
https://kawalpemilu.org#64725,"NUNUKAN BARAT, NUNUKAN, NUNUKAN, KALIMANTAN UTARA",9,123,65,188
https://kawalpemilu.org#64725,"NUNUKAN BARAT, NUNUKAN, NUNUKAN, KALIMANTAN UTARA",10,118,103,221
https://kawalpemilu.org#64725,"NUNUKAN BARAT, NUNUKAN, NUNUKAN, KALIMANTAN UTARA",11,59,38,97
https://kawalpemilu.org#64725,"NUNUKAN BARAT, NUNUKAN, NUNUKAN, KALIMANTAN UTARA",12,72,50,122
https://kawalpemilu.org#64725,"NUNUKAN BARAT, NUNUKAN, NUNUKAN, KALIMANTAN UTARA",13,83,36,119
https://kawalpemilu.org#64725,"NUNUKAN BARAT, NUNUKAN, NUNUKAN, KALIMANTAN UTARA",14,92,51,143
https://kawalpemilu.org#64725,"NUNUKAN BARAT, NUNUKAN, NUNUKAN, KALIMANTAN UTARA",15,97,55,152
https://kawalpemilu.org#64725,"NUNUKAN BARAT, NUNUKAN, NUNUKAN, KALIMANTAN UTARA",16,141,42,183
https://kawalpemilu.org#64725,"NUNUKAN BARAT, NUNUKAN, NUNUKAN, KALIMANTAN UTARA",17,169,10,179
https://kawalpemilu.org#64725,"NUNUKAN BARAT, NUNUKAN, NUNUKAN, KALIMANTAN UTARA",18,162,13,175
https://kawalpemilu.org#64725,"NUNUKAN BARAT, NUNUKAN, NUNUKAN, KALIMANTAN UTARA",19,101,39,140
https://kawalpemilu.org#64725,"NUNUKAN BARAT, NUNUKAN, NUNUKAN, KALIMANTAN UTARA",20,94,55,149
https://kawalpemilu.org#64725,"NUNUKAN BARAT, NUNUKAN, NUNUKAN, KALIMANTAN UTARA",21,68,37,105
https://kawalpemilu.org#64725,"NUNUKAN BARAT, NUNUKAN, NUNUKAN, KALIMANTAN UTARA",22,87,34,121
https://kawalpemilu.org#64725,"NUNUKAN BARAT, NUNUKAN, NUNUKAN, KALIMANTAN UTARA",23,142,79,221
https://kawalpemilu.org#64725,"NUNUKAN BARAT, NUNUKAN, NUNUKAN, KALIMANTAN UTARA",24,87,44,131
https://kawalpemilu.org#64725,"NUNUKAN BARAT, NUNUKAN, NUNUKAN, KALIMANTAN UTARA",25,91,61,152
https://kawalpemilu.org#64725,"NUNUKAN BARAT, NUNUKAN, NUNUKAN, KALIMANTAN UTARA",26,136,24,160
https://kawalpemilu.org#64725,"NUNUKAN BARAT, NUNUKAN, NUNUKAN, KALIMANTAN UTARA",27,92,17,109
https://kawalpemilu.org#64725,"NUNUKAN BARAT, NUNUKAN, NUNUKAN, KALIMANTAN UTARA",28,152,18,170
https://kawalpemilu.org#64725,"NUNUKAN BARAT, NUNUKAN, NUNUKAN, KALIMANTAN UTARA",29,116,49,165
https://kawalpemilu.org#64725,"NUNUKAN BARAT, NUNUKAN, NUNUKAN, KALIMANTAN UTARA",30,62,37,99
https://kawalpemilu.org#64725,"NUNUKAN BARAT, NUNUKAN, NUNUKAN, KALIMANTAN UTARA",31,87,59,146
https://kawalpemilu.org#64725,"NUNUKAN BARAT, NUNUKAN, NUNUKAN, KALIMANTAN UTARA",32,68,38,106
https://kawalpemilu.org#64725,"NUNUKAN BARAT, NUNUKAN, NUNUKAN, KALIMANTAN UTARA",33,96,51,147
https://kawalpemilu.org#64725,"NUNUKAN BARAT, NUNUKAN, NUNUKAN, KALIMANTAN UTARA",34,62,35,97
https://kawalpemilu.org#64725,"NUNUKAN BARAT, NUNUKAN, NUNUKAN, KALIMANTAN UTARA",35,37,39,76
https://kawalpemilu.org#64725,"NUNUKAN BARAT, NUNUKAN, NUNUKAN, KALIMANTAN UTARA",36,148,72,220
https://kawalpemilu.org#64725,"NUNUKAN BARAT, NUNUKAN, NUNUKAN, KALIMANTAN UTARA",37,61,47,108
https://kawalpemilu.org#64725,"NUNUKAN BARAT, NUNUKAN, NUNUKAN, KALIMANTAN UTARA",38,82,30,112
https://kawalpemilu.org#64725,"NUNUKAN BARAT, NUNUKAN, NUNUKAN, KALIMANTAN UTARA",39,103,51,154
https://kawalpemilu.org#64725,"NUNUKAN BARAT, NUNUKAN, NUNUKAN, KALIMANTAN UTARA",40,85,52,137
https://kawalpemilu.org#64725,"NUNUKAN BARAT, NUNUKAN, NUNUKAN, KALIMANTAN UTARA",41,70,72,142
https://kawalpemilu.org#64725,"NUNUKAN BARAT, NUNUKAN, NUNUKAN, KALIMANTAN UTARA",42,117,45,162
https://kawalpemilu.org#64725,"NUNUKAN BARAT, NUNUKAN, NUNUKAN, KALIMANTAN UTARA",43,148,22,170
https://kawalpemilu.org#64725,"NUNUKAN BARAT, NUNUKAN, NUNUKAN, KALIMANTAN UTARA",44,92,46,138
https://kawalpemilu.org#64725,"NUNUKAN BARAT, NUNUKAN, NUNUKAN, KALIMANTAN UTARA",45,78,14,92
https://kawalpemilu.org#64725,"NUNUKAN BARAT, NUNUKAN, NUNUKAN, KALIMANTAN UTARA",46,79,23,102
https://kawalpemilu.org#64725,"NUNUKAN BARAT, NUNUKAN, NUNUKAN, KALIMANTAN UTARA",47,65,40,105
https://kawalpemilu.org#64725,"NUNUKAN BARAT, NUNUKAN, NUNUKAN, KALIMANTAN UTARA",48,164,37,201
https://kawalpemilu.org#64725,"NUNUKAN BARAT, NUNUKAN, NUNUKAN, KALIMANTAN UTARA",49,78,8,86
https://kawalpemilu.org#64725,"NUNUKAN BARAT, NUNUKAN, NUNUKAN, KALIMANTAN UTARA",50,120,14,134
https://kawalpemilu.org#64725,"NUNUKAN BARAT, NUNUKAN, NUNUKAN, KALIMANTAN UTARA",51,93,35,128
https://kawalpemilu.org#64725,"NUNUKAN BARAT, NUNUKAN, NUNUKAN, KALIMANTAN UTARA",52,113,12,125
https://kawalpemilu.org#64726,"NUNUKAN UTARA, NUNUKAN, NUNUKAN, KALIMANTAN UTARA",1,28,22,50
https://kawalpemilu.org#64726,"NUNUKAN UTARA, NUNUKAN, NUNUKAN, KALIMANTAN UTARA",2,89,55,144
https://kawalpemilu.org#64726,"NUNUKAN UTARA, NUNUKAN, NUNUKAN, KALIMANTAN UTARA",3,127,37,164
https://kawalpemilu.org#64726,"NUNUKAN UTARA, NUNUKAN, NUNUKAN, KALIMANTAN UTARA",4,60,34,94
https://kawalpemilu.org#64726,"NUNUKAN UTARA, NUNUKAN, NUNUKAN, KALIMANTAN UTARA",5,42,29,71
https://kawalpemilu.org#64726,"NUNUKAN UTARA, NUNUKAN, NUNUKAN, KALIMANTAN UTARA",6,70,38,108
https://kawalpemilu.org#64726,"NUNUKAN UTARA, NUNUKAN, NUNUKAN, KALIMANTAN UTARA",7,69,54,123
https://kawalpemilu.org#64726,"NUNUKAN UTARA, NUNUKAN, NUNUKAN, KALIMANTAN UTARA",8,67,42,109
https://kawalpemilu.org#64726,"NUNUKAN UTARA, NUNUKAN, NUNUKAN, KALIMANTAN UTARA",9,43,53,96
https://kawalpemilu.org#64726,"NUNUKAN UTARA, NUNUKAN, NUNUKAN, KALIMANTAN UTARA",10,104,74,178
https://kawalpemilu.org#64726,"NUNUKAN UTARA, NUNUKAN, NUNUKAN, KALIMANTAN UTARA",11,68,43,111
https://kawalpemilu.org#64726,"NUNUKAN UTARA, NUNUKAN, NUNUKAN, KALIMANTAN UTARA",12,110,86,196
https://kawalpemilu.org#64726,"NUNUKAN UTARA, NUNUKAN, NUNUKAN, KALIMANTAN UTARA",13,128,54,182
https://kawalpemilu.org#64726,"NUNUKAN UTARA, NUNUKAN, NUNUKAN, KALIMANTAN UTARA",14,112,59,171
https://kawalpemilu.org#64726,"NUNUKAN UTARA, NUNUKAN, NUNUKAN, KALIMANTAN UTARA",15,159,34,183
https://kawalpemilu.org#64726,"NUNUKAN UTARA, NUNUKAN, NUNUKAN, KALIMANTAN UTARA",16,51,26,77
https://kawalpemilu.org#64726,"NUNUKAN UTARA, NUNUKAN, NUNUKAN, KALIMANTAN UTARA",17,79,54,133
https://kawalpemilu.org#64726,"NUNUKAN UTARA, NUNUKAN, NUNUKAN, KALIMANTAN UTARA",18,39,37,76
https://kawalpemilu.org#64726,"NUNUKAN UTARA, NUNUKAN, NUNUKAN, KALIMANTAN UTARA",19,104,57,161
https://kawalpemilu.org#64726,"NUNUKAN UTARA, NUNUKAN, NUNUKAN, KALIMANTAN UTARA",20,44,33,77
https://kawalpemilu.org#64726,"NUNUKAN UTARA, NUNUKAN, NUNUKAN, KALIMANTAN UTARA",21,29,45,74
https://kawalpemilu.org#64726,"NUNUKAN UTARA, NUNUKAN, NUNUKAN, KALIMANTAN UTARA",22,100,60,160
https://kawalpemilu.org#64726,"NUNUKAN UTARA, NUNUKAN, NUNUKAN, KALIMANTAN UTARA",23,99,53,152
https://kawalpemilu.org#64726,"NUNUKAN UTARA, NUNUKAN, NUNUKAN, KALIMANTAN UTARA",24,37,9,46
https://kawalpemilu.org#64726,"NUNUKAN UTARA, NUNUKAN, NUNUKAN, KALIMANTAN UTARA",25,31,30,61
https://kawalpemilu.org#64726,"NUNUKAN UTARA, NUNUKAN, NUNUKAN, KALIMANTAN UTARA",26,46,68,114
https://kawalpemilu.org#64726,"NUNUKAN UTARA, NUNUKAN, NUNUKAN, KALIMANTAN UTARA",27,89,79,168
https://kawalpemilu.org#64726,"NUNUKAN UTARA, NUNUKAN, NUNUKAN, KALIMANTAN UTARA",28,37,24,61
https://kawalpemilu.org#64726,"NUNUKAN UTARA, NUNUKAN, NUNUKAN, KALIMANTAN UTARA",29,79,80,159
https://kawalpemilu.org#64726,"NUNUKAN UTARA, NUNUKAN, NUNUKAN, KALIMANTAN UTARA",30,89,43,132
https://kawalpemilu.org#64726,"NUNUKAN UTARA, NUNUKAN, NUNUKAN, KALIMANTAN UTARA",31,103,30,133
https://kawalpemilu.org#64726,"NUNUKAN UTARA, NUNUKAN, NUNUKAN, KALIMANTAN UTARA",32,97,22,119
https://kawalpemilu.org#64727,"NUNUKAN TENGAH, NUNUKAN, NUNUKAN, KALIMANTAN UTARA",1,53,17,70
https://kawalpemilu.org#64727,"NUNUKAN TENGAH, NUNUKAN, NUNUKAN, KALIMANTAN UTARA",2,100,33,133
https://kawalpemilu.org#64727,"NUNUKAN TENGAH, NUNUKAN, NUNUKAN, KALIMANTAN UTARA",3,90,58,148
https://kawalpemilu.org#64727,"NUNUKAN TENGAH, NUNUKAN, NUNUKAN, KALIMANTAN UTARA",4,82,49,131
https://kawalpemilu.org#64727,"NUNUKAN TENGAH, NUNUKAN, NUNUKAN, KALIMANTAN UTARA",5,132,24,1
https://kawalpemilu.org#64727,"NUNUKAN TENGAH, NUNUKAN, NUNUKAN, KALIMANTAN UTARA",6,91,15,106
https://kawalpemilu.org#64727,"NUNUKAN TENGAH, NUNUKAN, NUNUKAN, KALIMANTAN UTARA",7,118,42,160
https://kawalpemilu.org#64727,"NUNUKAN TENGAH, NUNUKAN, NUNUKAN, KALIMANTAN UTARA",8,81,42,123
https://kawalpemilu.org#64727,"NUNUKAN TENGAH, NUNUKAN, NUNUKAN, KALIMANTAN UTARA",9,74,55,129
https://kawalpemilu.org#64727,"NUNUKAN TENGAH, NUNUKAN, NUNUKAN, KALIMANTAN UTARA",10,68,30,98
https://kawalpemilu.org#64727,"NUNUKAN TENGAH, NUNUKAN, NUNUKAN, KALIMANTAN UTARA",11,119,25,144
https://kawalpemilu.org#64727,"NUNUKAN TENGAH, NUNUKAN, NUNUKAN, KALIMANTAN UTARA",12,60,29,89
https://kawalpemilu.org#64727,"NUNUKAN TENGAH, NUNUKAN, NUNUKAN, KALIMANTAN UTARA",13,56,19,75
https://kawalpemilu.org#64727,"NUNUKAN TENGAH, NUNUKAN, NUNUKAN, KALIMANTAN UTARA",14,177,89,266
https://kawalpemilu.org#64727,"NUNUKAN TENGAH, NUNUKAN, NUNUKAN, KALIMANTAN UTARA",15,141,102,243
https://kawalpemilu.org#64727,"NUNUKAN TENGAH, NUNUKAN, NUNUKAN, KALIMANTAN UTARA",16,100,79,179
https://kawalpemilu.org#64727,"NUNUKAN TENGAH, NUNUKAN, NUNUKAN, KALIMANTAN UTARA",17,77,29,106
https://kawalpemilu.org#64727,"NUNUKAN TENGAH, NUNUKAN, NUNUKAN, KALIMANTAN UTARA",18,57,44,101
https://kawalpemilu.org#64727,"NUNUKAN TENGAH, NUNUKAN, NUNUKAN, KALIMANTAN UTARA",19,87,50,137
https://kawalpemilu.org#64727,"NUNUKAN TENGAH, NUNUKAN, NUNUKAN, KALIMANTAN UTARA",20,72,47,119
https://kawalpemilu.org#64727,"NUNUKAN TENGAH, NUNUKAN, NUNUKAN, KALIMANTAN UTARA",21,124,8,132
https://kawalpemilu.org#64727,"NUNUKAN TENGAH, NUNUKAN, NUNUKAN, KALIMANTAN UTARA",22,157,12,169
https://kawalpemilu.org#64727,"NUNUKAN TENGAH, NUNUKAN, NUNUKAN, KALIMANTAN UTARA",23,162,28,190
https://kawalpemilu.org#64727,"NUNUKAN TENGAH, NUNUKAN, NUNUKAN, KALIMANTAN UTARA",24,136,10,146
https://kawalpemilu.org#64727,"NUNUKAN TENGAH, NUNUKAN, NUNUKAN, KALIMANTAN UTARA",25,180,3,183
https://kawalpemilu.org#64727,"NUNUKAN TENGAH, NUNUKAN, NUNUKAN, KALIMANTAN UTARA",26,144,62,206
https://kawalpemilu.org#64727,"NUNUKAN TENGAH, NUNUKAN, NUNUKAN, KALIMANTAN UTARA",27,132,5,137
https://kawalpemilu.org#64727,"NUNUKAN TENGAH, NUNUKAN, NUNUKAN, KALIMANTAN UTARA",28,174,23,197
https://kawalpemilu.org#64727,"NUNUKAN TENGAH, NUNUKAN, NUNUKAN, KALIMANTAN UTARA",29,68,36,104
https://kawalpemilu.org#64727,"NUNUKAN TENGAH, NUNUKAN, NUNUKAN, KALIMANTAN UTARA",30,36,23,59
https://kawalpemilu.org#64727,"NUNUKAN TENGAH, NUNUKAN, NUNUKAN, KALIMANTAN UTARA",31,102,18,120
https://kawalpemilu.org#64727,"NUNUKAN TENGAH, NUNUKAN, NUNUKAN, KALIMANTAN UTARA",32,63,22,85
https://kawalpemilu.org#64727,"NUNUKAN TENGAH, NUNUKAN, NUNUKAN, KALIMANTAN UTARA",33,85,16,101
https://kawalpemilu.org#64727,"NUNUKAN TENGAH, NUNUKAN, NUNUKAN, KALIMANTAN UTARA",34,46,9,55
https://kawalpemilu.org#64727,"NUNUKAN TENGAH, NUNUKAN, NUNUKAN, KALIMANTAN UTARA",35,86,65,151
https://kawalpemilu.org#64727,"NUNUKAN TENGAH, NUNUKAN, NUNUKAN, KALIMANTAN UTARA",36,46,21,67
https://kawalpemilu.org#64727,"NUNUKAN TENGAH, NUNUKAN, NUNUKAN, KALIMANTAN UTARA",37,102,33,135
https://kawalpemilu.org#64727,"NUNUKAN TENGAH, NUNUKAN, NUNUKAN, KALIMANTAN UTARA",38,71,16,87
https://kawalpemilu.org#64727,"NUNUKAN TENGAH, NUNUKAN, NUNUKAN, KALIMANTAN UTARA",39,67,67,134
https://kawalpemilu.org#64727,"NUNUKAN TENGAH, NUNUKAN, NUNUKAN, KALIMANTAN UTARA",40,80,60,140
https://kawalpemilu.org#64727,"NUNUKAN TENGAH, NUNUKAN, NUNUKAN, KALIMANTAN UTARA",41,96,56,152
https://kawalpemilu.org#64727,"NUNUKAN TENGAH, NUNUKAN, NUNUKAN, KALIMANTAN UTARA",42,67,34,101
https://kawalpemilu.org#64727,"NUNUKAN TENGAH, NUNUKAN, NUNUKAN, KALIMANTAN UTARA",43,96,10,106
https://kawalpemilu.org#64727,"NUNUKAN TENGAH, NUNUKAN, NUNUKAN, KALIMANTAN UTARA",44,99,7,106
https://kawalpemilu.org#64727,"NUNUKAN TENGAH, NUNUKAN, NUNUKAN, KALIMANTAN UTARA",45,120,15,135
https://kawalpemilu.org#64727,"NUNUKAN TENGAH, NUNUKAN, NUNUKAN, KALIMANTAN UTARA",46,94,6,100
https://kawalpemilu.org#64727,"NUNUKAN TENGAH, NUNUKAN, NUNUKAN, KALIMANTAN UTARA",47,115,5,120
https://kawalpemilu.org#64727,"NUNUKAN TENGAH, NUNUKAN, NUNUKAN, KALIMANTAN UTARA",48,138,8,146
https://kawalpemilu.org#64727,"NUNUKAN TENGAH, NUNUKAN, NUNUKAN, KALIMANTAN UTARA",49,89,83,172
https://kawalpemilu.org#64727,"NUNUKAN TENGAH, NUNUKAN, NUNUKAN, KALIMANTAN UTARA",50,96,4,100
https://kawalpemilu.org#64727,"NUNUKAN TENGAH, NUNUKAN, NUNUKAN, KALIMANTAN UTARA",51,64,22,86
https://kawalpemilu.org#64727,"NUNUKAN TENGAH, NUNUKAN, NUNUKAN, KALIMANTAN UTARA",52,82,30,112
https://kawalpemilu.org#64727,"NUNUKAN TENGAH, NUNUKAN, NUNUKAN, KALIMANTAN UTARA",53,59,44,103
https://kawalpemilu.org#64728,"BINUSAN, NUNUKAN, NUNUKAN, KALIMANTAN UTARA",1,78,26,104
https://kawalpemilu.org#64728,"BINUSAN, NUNUKAN, NUNUKAN, KALIMANTAN UTARA",2,148,70,218
https://kawalpemilu.org#64728,"BINUSAN, NUNUKAN, NUNUKAN, KALIMANTAN UTARA",3,103,75,178
https://kawalpemilu.org#64728,"BINUSAN, NUNUKAN, NUNUKAN, KALIMANTAN UTARA",4,113,61,174
https://kawalpemilu.org#64728,"BINUSAN, NUNUKAN, NUNUKAN, KALIMANTAN UTARA",5,71,26,97
https://kawalpemilu.org#64728,"BINUSAN, NUNUKAN, NUNUKAN, KALIMANTAN UTARA",6,50,15,65
https://kawalpemilu.org#64728,"BINUSAN, NUNUKAN, NUNUKAN, KALIMANTAN UTARA",7,117,30,147
https://kawalpemilu.org#64728,"BINUSAN, NUNUKAN, NUNUKAN, KALIMANTAN UTARA",8,90,10,100
https://kawalpemilu.org#64728,"BINUSAN, NUNUKAN, NUNUKAN, KALIMANTAN UTARA",9,71,6,77
https://kawalpemilu.org#64728,"BINUSAN, NUNUKAN, NUNUKAN, KALIMANTAN UTARA",10,97,16,113
https://kawalpemilu.org#64728,"BINUSAN, NUNUKAN, NUNUKAN, KALIMANTAN UTARA",11,86,15,101
https://kawalpemilu.org#64728,"BINUSAN, NUNUKAN, NUNUKAN, KALIMANTAN UTARA",12,93,27,120
https://kawalpemilu.org#64728,"BINUSAN, NUNUKAN, NUNUKAN, KALIMANTAN UTARA",13,102,65,167
https://kawalpemilu.org#64728,"BINUSAN, NUNUKAN, NUNUKAN, KALIMANTAN UTARA",14,112,29,141
https://kawalpemilu.org#64728,"BINUSAN, NUNUKAN, NUNUKAN, KALIMANTAN UTARA",15,106,30,136
https://kawalpemilu.org#64728,"BINUSAN, NUNUKAN, NUNUKAN, KALIMANTAN UTARA",16,89,81,170
https://kawalpemilu.org#64728,"BINUSAN, NUNUKAN, NUNUKAN, KALIMANTAN UTARA",17,107,86,193
https://kawalpemilu.org#64728,"BINUSAN, NUNUKAN, NUNUKAN, KALIMANTAN UTARA",18,71,5,76
https://kawalpemilu.org#64728,"BINUSAN, NUNUKAN, NUNUKAN, KALIMANTAN UTARA",19,102,17,119
https://kawalpemilu.org#64728,"BINUSAN, NUNUKAN, NUNUKAN, KALIMANTAN UTARA",20,62,2,64
https://kawalpemilu.org#64734,"TAGUL, SEMBAKUNG, NUNUKAN, KALIMANTAN UTARA",1,103,27,130
https://kawalpemilu.org#64734,"TAGUL, SEMBAKUNG, NUNUKAN, KALIMANTAN UTARA",2,96,44,140
https://kawalpemilu.org#64735,"LUBAKAN, SEMBAKUNG, NUNUKAN, KALIMANTAN UTARA",1,140,30,170
https://kawalpemilu.org#64735,"LUBAKAN, SEMBAKUNG, NUNUKAN, KALIMANTAN UTARA",2,96,41,137
https://kawalpemilu.org#64736,"ATAP, SEMBAKUNG, NUNUKAN, KALIMANTAN UTARA",1,111,36,147
https://kawalpemilu.org#64736,"ATAP, SEMBAKUNG, NUNUKAN, KALIMANTAN UTARA",2,82,46,128
https://kawalpemilu.org#64736,"ATAP, SEMBAKUNG, NUNUKAN, KALIMANTAN UTARA",3,109,52,161
https://kawalpemilu.org#64736,"ATAP, SEMBAKUNG, NUNUKAN, KALIMANTAN UTARA",4,73,110,183
https://kawalpemilu.org#64736,"ATAP, SEMBAKUNG, NUNUKAN, KALIMANTAN UTARA",5,58,62,120
https://kawalpemilu.org#64736,"ATAP, SEMBAKUNG, NUNUKAN, KALIMANTAN UTARA",6,80,27,107
https://kawalpemilu.org#64736,"ATAP, SEMBAKUNG, NUNUKAN, KALIMANTAN UTARA",7,44,51,95
https://kawalpemilu.org#64736,"ATAP, SEMBAKUNG, NUNUKAN, KALIMANTAN UTARA",8,70,41,111
https://kawalpemilu.org#64736,"ATAP, SEMBAKUNG, NUNUKAN, KALIMANTAN UTARA",9,67,79,146
https://kawalpemilu.org#64736,"ATAP, SEMBAKUNG, NUNUKAN, KALIMANTAN UTARA",10,218,45,263
https://kawalpemilu.org#64737,"MANUK BUNGKUL, SEMBAKUNG, NUNUKAN, KALIMANTAN UTARA",1,88,21,109
https://kawalpemilu.org#64737,"MANUK BUNGKUL, SEMBAKUNG, NUNUKAN, KALIMANTAN UTARA",2,70,23,93
https://kawalpemilu.org#64738,"TUJUNG, SEMBAKUNG, NUNUKAN, KALIMANTAN UTARA",1,78,0,78
https://kawalpemilu.org#64738,"TUJUNG, SEMBAKUNG, NUNUKAN, KALIMANTAN UTARA",2,156,1,157
https://kawalpemilu.org#64739,"PAGAR, SEMBAKUNG, NUNUKAN, KALIMANTAN UTARA",1,265,6,271
https://kawalpemilu.org#64740,"LABUK, SEMBAKUNG, NUNUKAN, KALIMANTAN UTARA",1,192,7,199
https://kawalpemilu.org#64741,"BUTAS BAGU, SEMBAKUNG, NUNUKAN, KALIMANTAN UTARA",1,240,10,250
https://kawalpemilu.org#64752,"PELAJU, SEMBAKUNG, NUNUKAN, KALIMANTAN UTARA",1,99,17,116
https://kawalpemilu.org#64752,"PELAJU, SEMBAKUNG, NUNUKAN, KALIMANTAN UTARA",2,93,1,94
https://kawalpemilu.org#64752,"PELAJU, SEMBAKUNG, NUNUKAN, KALIMANTAN UTARA",3,82,14,96
https://kawalpemilu.org#64752,"PELAJU, SEMBAKUNG, NUNUKAN, KALIMANTAN UTARA",4,127,14,141
https://kawalpemilu.org#64753,"TEPIAN, SEMBAKUNG, NUNUKAN, KALIMANTAN UTARA",1,138,24,162
https://kawalpemilu.org#64753,"TEPIAN, SEMBAKUNG, NUNUKAN, KALIMANTAN UTARA",2,156,20,176
https://kawalpemilu.org#64753,"TEPIAN, SEMBAKUNG, NUNUKAN, KALIMANTAN UTARA",3,81,23,104
https://kawalpemilu.org#64762,"DERALON, LUMBIS, NUNUKAN, KALIMANTAN UTARA",1,74,4,78
https://kawalpemilu.org#64764,"LIANG, LUMBIS, NUNUKAN, KALIMANTAN UTARA",1,86,3,89
https://kawalpemilu.org#64765,"DABULON, LUMBIS, NUNUKAN, KALIMANTAN UTARA",1,44,1,45
https://kawalpemilu.org#64769,"PODONG, LUMBIS, NUNUKAN, KALIMANTAN UTARA",1,75,12,87
https://kawalpemilu.org#64770,"PATAL I, LUMBIS, NUNUKAN, KALIMANTAN UTARA",1,61,4,65
https://kawalpemilu.org#64777,"TALUAN, LUMBIS, NUNUKAN, KALIMANTAN UTARA",1,54,5,59
https://kawalpemilu.org#64784,"SIAWANG, LUMBIS, NUNUKAN, KALIMANTAN UTARA",1,58,0,58
https://kawalpemilu.org#64788,"SAPUYAN, LUMBIS, NUNUKAN, KALIMANTAN UTARA",1,108,5,113
https://kawalpemilu.org#64790,"NAINSID, LUMBIS, NUNUKAN, KALIMANTAN UTARA",1,124,2,126
https://kawalpemilu.org#64791,"SASIBU, LUMBIS, NUNUKAN, KALIMANTAN UTARA",1,76,3,79
https://kawalpemilu.org#64792,"SALUDAN, LUMBIS, NUNUKAN, KALIMANTAN UTARA",1,48,8,56
https://kawalpemilu.org#64793,"SEMALAT, LUMBIS, NUNUKAN, KALIMANTAN UTARA",1,45,2,47
https://kawalpemilu.org#64799,"LIBANG, LUMBIS, NUNUKAN, KALIMANTAN UTARA",1,115,10,125
https://kawalpemilu.org#64800,"SEDONGON, LUMBIS, NUNUKAN, KALIMANTAN UTARA",1,0,0,0
https://kawalpemilu.org#64801,"TANJUNG HILIR, LUMBIS, NUNUKAN, KALIMANTAN UTARA",1,256,6,262
https://kawalpemilu.org#64802,"SUMALUMUNG, LUMBIS, NUNUKAN, KALIMANTAN UTARA",1,219,2,221
https://kawalpemilu.org#64803,"LINTONG, LUMBIS, NUNUKAN, KALIMANTAN UTARA",1,127,13,140
https://kawalpemilu.org#64809,"PULU BULAWAN, LUMBIS, NUNUKAN, KALIMANTAN UTARA",1,54,5,59
https://kawalpemilu.org#64814,"TANJUNG HULU, LUMBIS, NUNUKAN, KALIMANTAN UTARA",1,165,4,169
https://kawalpemilu.org#64815,"PATAL II, LUMBIS, NUNUKAN, KALIMANTAN UTARA",1,104,4,108
https://kawalpemilu.org#64816,"PA'LOO, LUMBIS, NUNUKAN, KALIMANTAN UTARA",1,53,10,63
https://kawalpemilu.org#64817,"SANGKUB, LUMBIS, NUNUKAN, KALIMANTAN UTARA",1,48,4,52
https://kawalpemilu.org#64820,"TUBUS, LUMBIS, NUNUKAN, KALIMANTAN UTARA",1,94,2,96
https://kawalpemilu.org#64821,"LIKOS, LUMBIS, NUNUKAN, KALIMANTAN UTARA",1,76,3,79
https://kawalpemilu.org#64822,"BULAN-BULAN, LUMBIS, NUNUKAN, KALIMANTAN UTARA",1,116,15,131
https://kawalpemilu.org#64823,"KALAMPISING, LUMBIS, NUNUKAN, KALIMANTAN UTARA",1,146,2,148
https://kawalpemilu.org#64823,"KALAMPISING, LUMBIS, NUNUKAN, KALIMANTAN UTARA",2,131,2,133
https://kawalpemilu.org#64824,"PA'LEMUMUT, LUMBIS, NUNUKAN, KALIMANTAN UTARA",1,34,9,43
https://kawalpemilu.org#64827,"MANSALONG, LUMBIS, NUNUKAN, KALIMANTAN UTARA",1,136,55,191
https://kawalpemilu.org#64827,"MANSALONG, LUMBIS, NUNUKAN, KALIMANTAN UTARA",2,63,83,146
https://kawalpemilu.org#64827,"MANSALONG, LUMBIS, NUNUKAN, KALIMANTAN UTARA",3,104,66,170
https://kawalpemilu.org#64827,"MANSALONG, LUMBIS, NUNUKAN, KALIMANTAN UTARA",4,81,122,203
https://kawalpemilu.org#64827,"MANSALONG, LUMBIS, NUNUKAN, KALIMANTAN UTARA",5,100,29,129
https://kawalpemilu.org#64827,"MANSALONG, LUMBIS, NUNUKAN, KALIMANTAN UTARA",6,121,54,175
https://kawalpemilu.org#64831,"PA' PADI, KRAYAN, NUNUKAN, KALIMANTAN UTARA",1,120,2,122
https://kawalpemilu.org#64832,"CINGLAT, KRAYAN, NUNUKAN, KALIMANTAN UTARA",1,86,1,87
https://kawalpemilu.org#64850,"LIANG BUTAN, KRAYAN, NUNUKAN, KALIMANTAN UTARA",1,167,25,192
https://kawalpemilu.org#64850,"LIANG BUTAN, KRAYAN, NUNUKAN, KALIMANTAN UTARA",2,131,7,138
https://kawalpemilu.org#64856,"PA' RUPAI, KRAYAN, NUNUKAN, KALIMANTAN UTARA",1,71,1,72
https://kawalpemilu.org#64857,"BA SIKOR, KRAYAN, NUNUKAN, KALIMANTAN UTARA",1,102,0,102
https://kawalpemilu.org#64858,"PA' NADO, KRAYAN, NUNUKAN, KALIMANTAN UTARA",1,90,0,90
https://kawalpemilu.org#64859,"BUDUK KINANGAN, KRAYAN, NUNUKAN, KALIMANTAN UTARA",1,91,2,93
https://kawalpemilu.org#64860,"LIANG TUER, KRAYAN, NUNUKAN, KALIMANTAN UTARA",1,146,2,148
https://kawalpemilu.org#64861,"BUDUK TUMU, KRAYAN, NUNUKAN, KALIMANTAN UTARA",1,96,2,98
https://kawalpemilu.org#64862,"LONG BERAYANG, KRAYAN, NUNUKAN, KALIMANTAN UTARA",1,49,1,50
https://kawalpemilu.org#64863,"PA' API, KRAYAN, NUNUKAN, KALIMANTAN UTARA",1,209,2,211
https://kawalpemilu.org#64864,"PA' SIRE, KRAYAN, NUNUKAN, KALIMANTAN UTARA",1,153,2,155
https://kawalpemilu.org#64864,"PA' SIRE, KRAYAN, NUNUKAN, KALIMANTAN UTARA",2,139,2,141
https://kawalpemilu.org#64865,"WA' YANUD, KRAYAN, NUNUKAN, KALIMANTAN UTARA",1,183,2,185
https://kawalpemilu.org#64866,"LONG KATUNG, KRAYAN, NUNUKAN, KALIMANTAN UTARA",1,134,15,149
https://kawalpemilu.org#64867,"LONG BAWAN, KRAYAN, NUNUKAN, KALIMANTAN UTARA",1,100,8,108
https://kawalpemilu.org#64867,"LONG BAWAN, KRAYAN, NUNUKAN, KALIMANTAN UTARA",2,120,15,135
https://kawalpemilu.org#64870,"LONG MATUNG, KRAYAN, NUNUKAN, KALIMANTAN UTARA",1,121,0,121
https://kawalpemilu.org#64871,"LIANG BIADUNG, KRAYAN, NUNUKAN, KALIMANTAN UTARA",1,63,1,64
https://kawalpemilu.org#64872,"WA' LAYA, KRAYAN, NUNUKAN, KALIMANTAN UTARA",1,248,6,254
https://kawalpemilu.org#64873,"PA' MATUNG, KRAYAN, NUNUKAN, KALIMANTAN UTARA",1,42,4,46
https://kawalpemilu.org#64874,"PA' TERUTUN, KRAYAN, NUNUKAN, KALIMANTAN UTARA",1,123,0,123
https://kawalpemilu.org#64887,"PA' PUTUK, KRAYAN, NUNUKAN, KALIMANTAN UTARA",1,37,5,42
https://kawalpemilu.org#85468,"LONG RUPAN, KRAYAN, NUNUKAN, KALIMANTAN UTARA",1,25,0,25
https://kawalpemilu.org#92811,"LONG NAWAN, KRAYAN, NUNUKAN, KALIMANTAN UTARA",1,102,3,105
https://kawalpemilu.org#64891,"PEMBELIANGAN, SEBUKU, NUNUKAN, KALIMANTAN UTARA",1,90,16,106
https://kawalpemilu.org#64891,"PEMBELIANGAN, SEBUKU, NUNUKAN, KALIMANTAN UTARA",2,89,54,143
https://kawalpemilu.org#64891,"PEMBELIANGAN, SEBUKU, NUNUKAN, KALIMANTAN UTARA",3,105,43,148
https://kawalpemilu.org#64891,"PEMBELIANGAN, SEBUKU, NUNUKAN, KALIMANTAN UTARA",4,112,12,124
https://kawalpemilu.org#64891,"PEMBELIANGAN, SEBUKU, NUNUKAN, KALIMANTAN UTARA",5,81,9,90
https://kawalpemilu.org#64891,"PEMBELIANGAN, SEBUKU, NUNUKAN, KALIMANTAN UTARA",6,98,8,106
https://kawalpemilu.org#64891,"PEMBELIANGAN, SEBUKU, NUNUKAN, KALIMANTAN UTARA",7,25,5,30
https://kawalpemilu.org#64891,"PEMBELIANGAN, SEBUKU, NUNUKAN, KALIMANTAN UTARA",8,75,11,86
https://kawalpemilu.org#64891,"PEMBELIANGAN, SEBUKU, NUNUKAN, KALIMANTAN UTARA",9,132,17,149
https://kawalpemilu.org#64891,"PEMBELIANGAN, SEBUKU, NUNUKAN, KALIMANTAN UTARA",10,57,27,84
https://kawalpemilu.org#64891,"PEMBELIANGAN, SEBUKU, NUNUKAN, KALIMANTAN UTARA",11,119,23,142
https://kawalpemilu.org#64891,"PEMBELIANGAN, SEBUKU, NUNUKAN, KALIMANTAN UTARA",12,64,39,103
https://kawalpemilu.org#64891,"PEMBELIANGAN, SEBUKU, NUNUKAN, KALIMANTAN UTARA",13,66,45,111
https://kawalpemilu.org#64891,"PEMBELIANGAN, SEBUKU, NUNUKAN, KALIMANTAN UTARA",14,142,25,167
https://kawalpemilu.org#64891,"PEMBELIANGAN, SEBUKU, NUNUKAN, KALIMANTAN UTARA",15,105,6,111
https://kawalpemilu.org#64891,"PEMBELIANGAN, SEBUKU, NUNUKAN, KALIMANTAN UTARA",16,57,4,61
https://kawalpemilu.org#64891,"PEMBELIANGAN, SEBUKU, NUNUKAN, KALIMANTAN UTARA",17,105,11,116
https://kawalpemilu.org#64891,"PEMBELIANGAN, SEBUKU, NUNUKAN, KALIMANTAN UTARA",18,117,12,129
https://kawalpemilu.org#64891,"PEMBELIANGAN, SEBUKU, NUNUKAN, KALIMANTAN UTARA",19,36,12,48
https://kawalpemilu.org#64891,"PEMBELIANGAN, SEBUKU, NUNUKAN, KALIMANTAN UTARA",20,46,17,63
https://kawalpemilu.org#64891,"PEMBELIANGAN, SEBUKU, NUNUKAN, KALIMANTAN UTARA",21,34,5,39
https://kawalpemilu.org#64892,"APAS, SEBUKU, NUNUKAN, KALIMANTAN UTARA",1,213,23,236
https://kawalpemilu.org#64892,"APAS, SEBUKU, NUNUKAN, KALIMANTAN UTARA",2,157,36,193
https://kawalpemilu.org#64893,"KUNYIT, SEBUKU, NUNUKAN, KALIMANTAN UTARA",1,165,5,170
https://kawalpemilu.org#64893,"KUNYIT, SEBUKU, NUNUKAN, KALIMANTAN UTARA",2,173,19,192
https://kawalpemilu.org#64894,"TETABAN, SEBUKU, NUNUKAN, KALIMANTAN UTARA",1,238,21,259
https://kawalpemilu.org#64895,"KEKAYAP, SEBUKU, NUNUKAN, KALIMANTAN UTARA",1,181,7,188
https://kawalpemilu.org#64895,"KEKAYAP, SEBUKU, NUNUKAN, KALIMANTAN UTARA",2,118,3,121
https://kawalpemilu.org#64896,"BEBANAS, SEBUKU, NUNUKAN, KALIMANTAN UTARA",1,198,2,200
https://kawalpemilu.org#64897,"LULU, SEBUKU, NUNUKAN, KALIMANTAN UTARA",1,258,12,270
https://kawalpemilu.org#64898,"SUJAU, SEBUKU, NUNUKAN, KALIMANTAN UTARA",1,147,12,159
https://kawalpemilu.org#64898,"SUJAU, SEBUKU, NUNUKAN, KALIMANTAN UTARA",2,167,6,175
https://kawalpemilu.org#64907,"MELASU BARU, SEBUKU, NUNUKAN, KALIMANTAN UTARA",1,219,10,229
https://kawalpemilu.org#87653,"HARAPAN, SEBUKU, NUNUKAN, KALIMANTAN UTARA",1,107,32,139
https://kawalpemilu.org#87653,"HARAPAN, SEBUKU, NUNUKAN, KALIMANTAN UTARA",2,102,27,129
https://kawalpemilu.org#87653,"HARAPAN, SEBUKU, NUNUKAN, KALIMANTAN UTARA",3,107,19,126
https://kawalpemilu.org#87653,"HARAPAN, SEBUKU, NUNUKAN, KALIMANTAN UTARA",4,128,15,143
https://kawalpemilu.org#87653,"HARAPAN, SEBUKU, NUNUKAN, KALIMANTAN UTARA",5,85,22,107
https://kawalpemilu.org#87653,"HARAPAN, SEBUKU, NUNUKAN, KALIMANTAN UTARA",6,80,21,101
https://kawalpemilu.org#87653,"HARAPAN, SEBUKU, NUNUKAN, KALIMANTAN UTARA",7,130,25,155
https://kawalpemilu.org#64914,"LIANG LUNUK, KRAYAN SELATAN, NUNUKAN, KALIMANTAN UTARA",1,160,46,206
https://kawalpemilu.org#64917,"PA' KABER, KRAYAN SELATAN, NUNUKAN, KALIMANTAN UTARA",1,77,0,77
https://kawalpemilu.org#64918,"PA' TERA, KRAYAN SELATAN, NUNUKAN, KALIMANTAN UTARA",1,87,1,88
https://kawalpemilu.org#64919,"PA' SING, KRAYAN SELATAN, NUNUKAN, KALIMANTAN UTARA",1,121,0,121
https://kawalpemilu.org#64922,"PA' UPAN, KRAYAN SELATAN, NUNUKAN, KALIMANTAN UTARA",1,77,0,77
https://kawalpemilu.org#928247,"LONG PASIA, KRAYAN SELATAN, NUNUKAN, KALIMANTAN UTARA",1,53,0,53
https://kawalpemilu.org#928490,"PA' IBANG, KRAYAN SELATAN, NUNUKAN, KALIMANTAN UTARA",1,62,2,64
https://kawalpemilu.org#928491,"PA' AMAI, KRAYAN SELATAN, NUNUKAN, KALIMANTAN UTARA",1,46,2,48
https://kawalpemilu.org#928492,"PA' DALAN, KRAYAN SELATAN, NUNUKAN, KALIMANTAN UTARA",1,30,0,30
https://kawalpemilu.org#928493,"LONG BIRAR, KRAYAN SELATAN, NUNUKAN, KALIMANTAN UTARA",1,52,0,52
https://kawalpemilu.org#928496,"LONG BUDUNG, KRAYAN SELATAN, NUNUKAN, KALIMANTAN UTARA",1,83,2,85
https://kawalpemilu.org#928498,"LONG PUPUNG, KRAYAN SELATAN, NUNUKAN, KALIMANTAN UTARA",1,82,0,82
https://kawalpemilu.org#928499,"PA' URANG, KRAYAN SELATAN, NUNUKAN, KALIMANTAN UTARA",1,36,0,36
https://kawalpemilu.org#64938,"LIANG BUNYU, SEBATIK BARAT, NUNUKAN, KALIMANTAN UTARA",1,91,119,210
https://kawalpemilu.org#64938,"LIANG BUNYU, SEBATIK BARAT, NUNUKAN, KALIMANTAN UTARA",2,65,43,108
https://kawalpemilu.org#64938,"LIANG BUNYU, SEBATIK BARAT, NUNUKAN, KALIMANTAN UTARA",3,82,112,194
https://kawalpemilu.org#64938,"LIANG BUNYU, SEBATIK BARAT, NUNUKAN, KALIMANTAN UTARA",4,99,126,225
https://kawalpemilu.org#64938,"LIANG BUNYU, SEBATIK BARAT, NUNUKAN, KALIMANTAN UTARA",5,141,49,190
https://kawalpemilu.org#64938,"LIANG BUNYU, SEBATIK BARAT, NUNUKAN, KALIMANTAN UTARA",6,81,29,110
https://kawalpemilu.org#64938,"LIANG BUNYU, SEBATIK BARAT, NUNUKAN, KALIMANTAN UTARA",7,75,49,124
https://kawalpemilu.org#64939,"BINALAWAN, SEBATIK BARAT, NUNUKAN, KALIMANTAN UTARA",1,89,66,155
https://kawalpemilu.org#64939,"BINALAWAN, SEBATIK BARAT, NUNUKAN, KALIMANTAN UTARA",2,152,56,208
https://kawalpemilu.org#64939,"BINALAWAN, SEBATIK BARAT, NUNUKAN, KALIMANTAN UTARA",3,143,53,196
https://kawalpemilu.org#64939,"BINALAWAN, SEBATIK BARAT, NUNUKAN, KALIMANTAN UTARA",4,131,27,158
https://kawalpemilu.org#64939,"BINALAWAN, SEBATIK BARAT, NUNUKAN, KALIMANTAN UTARA",5,92,47,139
https://kawalpemilu.org#64939,"BINALAWAN, SEBATIK BARAT, NUNUKAN, KALIMANTAN UTARA",6,157,51,208
https://kawalpemilu.org#64939,"BINALAWAN, SEBATIK BARAT, NUNUKAN, KALIMANTAN UTARA",7,86,13,99
https://kawalpemilu.org#64939,"BINALAWAN, SEBATIK BARAT, NUNUKAN, KALIMANTAN UTARA",8,79,52,131
https://kawalpemilu.org#64940,"SETABU, SEBATIK BARAT, NUNUKAN, KALIMANTAN UTARA",1,192,25,217
https://kawalpemilu.org#64940,"SETABU, SEBATIK BARAT, NUNUKAN, KALIMANTAN UTARA",2,174,74,248
https://kawalpemilu.org#64940,"SETABU, SEBATIK BARAT, NUNUKAN, KALIMANTAN UTARA",3,168,52,220
https://kawalpemilu.org#64940,"SETABU, SEBATIK BARAT, NUNUKAN, KALIMANTAN UTARA",4,160,59,219
https://kawalpemilu.org#64940,"SETABU, SEBATIK BARAT, NUNUKAN, KALIMANTAN UTARA",5,183,35,218
https://kawalpemilu.org#64940,"SETABU, SEBATIK BARAT, NUNUKAN, KALIMANTAN UTARA",6,114,22,136
https://kawalpemilu.org#64940,"SETABU, SEBATIK BARAT, NUNUKAN, KALIMANTAN UTARA",7,121,26,147
https://kawalpemilu.org#64940,"SETABU, SEBATIK BARAT, NUNUKAN, KALIMANTAN UTARA",8,158,36,194
https://kawalpemilu.org#64943,"BAMBANGAN, SEBATIK BARAT, NUNUKAN, KALIMANTAN UTARA",1,109,31,140
https://kawalpemilu.org#64943,"BAMBANGAN, SEBATIK BARAT, NUNUKAN, KALIMANTAN UTARA",2,92,16,108
https://kawalpemilu.org#64943,"BAMBANGAN, SEBATIK BARAT, NUNUKAN, KALIMANTAN UTARA",3,120,10,130
https://kawalpemilu.org#64943,"BAMBANGAN, SEBATIK BARAT, NUNUKAN, KALIMANTAN UTARA",4,90,26,116
https://kawalpemilu.org#64943,"BAMBANGAN, SEBATIK BARAT, NUNUKAN, KALIMANTAN UTARA",5,143,22,165
https://kawalpemilu.org#64943,"BAMBANGAN, SEBATIK BARAT, NUNUKAN, KALIMANTAN UTARA",6,84,19,103
https://kawalpemilu.org#64943,"BAMBANGAN, SEBATIK BARAT, NUNUKAN, KALIMANTAN UTARA",7,82,17,99
https://kawalpemilu.org#64943,"BAMBANGAN, SEBATIK BARAT, NUNUKAN, KALIMANTAN UTARA",8,122,16,138
https://kawalpemilu.org#64943,"BAMBANGAN, SEBATIK BARAT, NUNUKAN, KALIMANTAN UTARA",9,90,22,112
https://kawalpemilu.org#64945,"SELISUN, NUNUKAN SELATAN, NUNUKAN, KALIMANTAN UTARA",1,115,62,177
https://kawalpemilu.org#64945,"SELISUN, NUNUKAN SELATAN, NUNUKAN, KALIMANTAN UTARA",2,113,42,155
https://kawalpemilu.org#64945,"SELISUN, NUNUKAN SELATAN, NUNUKAN, KALIMANTAN UTARA",3,146,33,179
https://kawalpemilu.org#64945,"SELISUN, NUNUKAN SELATAN, NUNUKAN, KALIMANTAN UTARA",4,158,92,250
https://kawalpemilu.org#64945,"SELISUN, NUNUKAN SELATAN, NUNUKAN, KALIMANTAN UTARA",5,121,84,205
https://kawalpemilu.org#64945,"SELISUN, NUNUKAN SELATAN, NUNUKAN, KALIMANTAN UTARA",6,107,72,179
https://kawalpemilu.org#64945,"SELISUN, NUNUKAN SELATAN, NUNUKAN, KALIMANTAN UTARA",7,84,87,171
https://kawalpemilu.org#64945,"SELISUN, NUNUKAN SELATAN, NUNUKAN, KALIMANTAN UTARA",8,122,63,185
https://kawalpemilu.org#64945,"SELISUN, NUNUKAN SELATAN, NUNUKAN, KALIMANTAN UTARA",9,133,79,212
https://kawalpemilu.org#64945,"SELISUN, NUNUKAN SELATAN, NUNUKAN, KALIMANTAN UTARA",10,105,14,119
https://kawalpemilu.org#64945,"SELISUN, NUNUKAN SELATAN, NUNUKAN, KALIMANTAN UTARA",11,115,29,144
https://kawalpemilu.org#64945,"SELISUN, NUNUKAN SELATAN, NUNUKAN, KALIMANTAN UTARA",12,119,21,140
https://kawalpemilu.org#64945,"SELISUN, NUNUKAN SELATAN, NUNUKAN, KALIMANTAN UTARA",13,5,88,93
https://kawalpemilu.org#64945,"SELISUN, NUNUKAN SELATAN, NUNUKAN, KALIMANTAN UTARA",14,153,51,204
https://kawalpemilu.org#64945,"SELISUN, NUNUKAN SELATAN, NUNUKAN, KALIMANTAN UTARA",15,161,68,229
https://kawalpemilu.org#64945,"SELISUN, NUNUKAN SELATAN, NUNUKAN, KALIMANTAN UTARA",16,106,69,175
https://kawalpemilu.org#64946,"NUNUKAN SELATAN, NUNUKAN SELATAN, NUNUKAN, KALIMANTAN UTARA",1,109,118,227
https://kawalpemilu.org#64946,"NUNUKAN SELATAN, NUNUKAN SELATAN, NUNUKAN, KALIMANTAN UTARA",2,79,77,156
https://kawalpemilu.org#64946,"NUNUKAN SELATAN, NUNUKAN SELATAN, NUNUKAN, KALIMANTAN UTARA",3,122,55,177
https://kawalpemilu.org#64946,"NUNUKAN SELATAN, NUNUKAN SELATAN, NUNUKAN, KALIMANTAN UTARA",4,102,68,170
https://kawalpemilu.org#64946,"NUNUKAN SELATAN, NUNUKAN SELATAN, NUNUKAN, KALIMANTAN UTARA",5,94,40,134
https://kawalpemilu.org#64946,"NUNUKAN SELATAN, NUNUKAN SELATAN, NUNUKAN, KALIMANTAN UTARA",6,91,55,146
https://kawalpemilu.org#64946,"NUNUKAN SELATAN, NUNUKAN SELATAN, NUNUKAN, KALIMANTAN UTARA",7,77,156,233
https://kawalpemilu.org#64946,"NUNUKAN SELATAN, NUNUKAN SELATAN, NUNUKAN, KALIMANTAN UTARA",8,115,48,163
https://kawalpemilu.org#64946,"NUNUKAN SELATAN, NUNUKAN SELATAN, NUNUKAN, KALIMANTAN UTARA",9,99,39,138
https://kawalpemilu.org#64946,"NUNUKAN SELATAN, NUNUKAN SELATAN, NUNUKAN, KALIMANTAN UTARA",10,101,38,139
https://kawalpemilu.org#64946,"NUNUKAN SELATAN, NUNUKAN SELATAN, NUNUKAN, KALIMANTAN UTARA",11,63,17,80
https://kawalpemilu.org#64946,"NUNUKAN SELATAN, NUNUKAN SELATAN, NUNUKAN, KALIMANTAN UTARA",12,95,29,124
https://kawalpemilu.org#64946,"NUNUKAN SELATAN, NUNUKAN SELATAN, NUNUKAN, KALIMANTAN UTARA",13,112,47,159
https://kawalpemilu.org#64946,"NUNUKAN SELATAN, NUNUKAN SELATAN, NUNUKAN, KALIMANTAN UTARA",14,79,79,158
https://kawalpemilu.org#64946,"NUNUKAN SELATAN, NUNUKAN SELATAN, NUNUKAN, KALIMANTAN UTARA",15,123,79,202
https://kawalpemilu.org#64946,"NUNUKAN SELATAN, NUNUKAN SELATAN, NUNUKAN, KALIMANTAN UTARA",16,89,41,130
https://kawalpemilu.org#64946,"NUNUKAN SELATAN, NUNUKAN SELATAN, NUNUKAN, KALIMANTAN UTARA",17,70,45,115
https://kawalpemilu.org#64946,"NUNUKAN SELATAN, NUNUKAN SELATAN, NUNUKAN, KALIMANTAN UTARA",18,60,52,112
https://kawalpemilu.org#64946,"NUNUKAN SELATAN, NUNUKAN SELATAN, NUNUKAN, KALIMANTAN UTARA",19,99,49,148
https://kawalpemilu.org#64947,"MANSAPA, NUNUKAN SELATAN, NUNUKAN, KALIMANTAN UTARA",1,69,14,83
https://kawalpemilu.org#64947,"MANSAPA, NUNUKAN SELATAN, NUNUKAN, KALIMANTAN UTARA",2,103,76,179
https://kawalpemilu.org#64947,"MANSAPA, NUNUKAN SELATAN, NUNUKAN, KALIMANTAN UTARA",3,135,73,208
https://kawalpemilu.org#64947,"MANSAPA, NUNUKAN SELATAN, NUNUKAN, KALIMANTAN UTARA",4,149,12,161
https://kawalpemilu.org#64947,"MANSAPA, NUNUKAN SELATAN, NUNUKAN, KALIMANTAN UTARA",5,79,74,153
https://kawalpemilu.org#64947,"MANSAPA, NUNUKAN SELATAN, NUNUKAN, KALIMANTAN UTARA",6,115,59,164
https://kawalpemilu.org#64947,"MANSAPA, NUNUKAN SELATAN, NUNUKAN, KALIMANTAN UTARA",7,186,26,212
https://kawalpemilu.org#64947,"MANSAPA, NUNUKAN SELATAN, NUNUKAN, KALIMANTAN UTARA",8,74,34,108
https://kawalpemilu.org#64948,"TANJUNG HARAPAN, NUNUKAN SELATAN, NUNUKAN, KALIMANTAN UTARA",1,229,61,290
https://kawalpemilu.org#64948,"TANJUNG HARAPAN, NUNUKAN SELATAN, NUNUKAN, KALIMANTAN UTARA",2,204,54,258
https://kawalpemilu.org#64948,"TANJUNG HARAPAN, NUNUKAN SELATAN, NUNUKAN, KALIMANTAN UTARA",3,178,46,224
https://kawalpemilu.org#64948,"TANJUNG HARAPAN, NUNUKAN SELATAN, NUNUKAN, KALIMANTAN UTARA",4,137,51,188
https://kawalpemilu.org#64948,"TANJUNG HARAPAN, NUNUKAN SELATAN, NUNUKAN, KALIMANTAN UTARA",5,162,25,187
https://kawalpemilu.org#64948,"TANJUNG HARAPAN, NUNUKAN SELATAN, NUNUKAN, KALIMANTAN UTARA",6,127,28,155
https://kawalpemilu.org#64948,"TANJUNG HARAPAN, NUNUKAN SELATAN, NUNUKAN, KALIMANTAN UTARA",7,99,15,114
https://kawalpemilu.org#64948,"TANJUNG HARAPAN, NUNUKAN SELATAN, NUNUKAN, KALIMANTAN UTARA",8,142,22,164
https://kawalpemilu.org#64948,"TANJUNG HARAPAN, NUNUKAN SELATAN, NUNUKAN, KALIMANTAN UTARA",9,107,22,129
https://kawalpemilu.org#64948,"TANJUNG HARAPAN, NUNUKAN SELATAN, NUNUKAN, KALIMANTAN UTARA",10,51,74,125
https://kawalpemilu.org#64948,"TANJUNG HARAPAN, NUNUKAN SELATAN, NUNUKAN, KALIMANTAN UTARA",11,166,40,206
https://kawalpemilu.org#64948,"TANJUNG HARAPAN, NUNUKAN SELATAN, NUNUKAN, KALIMANTAN UTARA",12,105,25,130
https://kawalpemilu.org#64948,"TANJUNG HARAPAN, NUNUKAN SELATAN, NUNUKAN, KALIMANTAN UTARA",13,131,17,148
https://kawalpemilu.org#64714,"TANJUNG ARU, SEBATIK TIMUR, NUNUKAN, KALIMANTAN UTARA",1,110,27,137
https://kawalpemilu.org#64714,"TANJUNG ARU, SEBATIK TIMUR, NUNUKAN, KALIMANTAN UTARA",2,77,48,125
https://kawalpemilu.org#64714,"TANJUNG ARU, SEBATIK TIMUR, NUNUKAN, KALIMANTAN UTARA",3,115,38,153
https://kawalpemilu.org#64714,"TANJUNG ARU, SEBATIK TIMUR, NUNUKAN, KALIMANTAN UTARA",4,90,74,164
https://kawalpemilu.org#64714,"TANJUNG ARU, SEBATIK TIMUR, NUNUKAN, KALIMANTAN UTARA",5,72,61,133
https://kawalpemilu.org#64714,"TANJUNG ARU, SEBATIK TIMUR, NUNUKAN, KALIMANTAN UTARA",6,129,56,185
https://kawalpemilu.org#64714,"TANJUNG ARU, SEBATIK TIMUR, NUNUKAN, KALIMANTAN UTARA",7,114,17,131
https://kawalpemilu.org#64714,"TANJUNG ARU, SEBATIK TIMUR, NUNUKAN, KALIMANTAN UTARA",8,121,28,149
https://kawalpemilu.org#64717,"BUKIT ARU INDAH, SEBATIK TIMUR, NUNUKAN, KALIMANTAN UTARA",1,56,38,94
https://kawalpemilu.org#64717,"BUKIT ARU INDAH, SEBATIK TIMUR, NUNUKAN, KALIMANTAN UTARA",2,68,27,95
https://kawalpemilu.org#64717,"BUKIT ARU INDAH, SEBATIK TIMUR, NUNUKAN, KALIMANTAN UTARA",3,58,20,78
https://kawalpemilu.org#64717,"BUKIT ARU INDAH, SEBATIK TIMUR, NUNUKAN, KALIMANTAN UTARA",4,118,24,142
https://kawalpemilu.org#64717,"BUKIT ARU INDAH, SEBATIK TIMUR, NUNUKAN, KALIMANTAN UTARA",5,88,25,113
https://kawalpemilu.org#64717,"BUKIT ARU INDAH, SEBATIK TIMUR, NUNUKAN, KALIMANTAN UTARA",6,131,29,160
https://kawalpemilu.org#64717,"BUKIT ARU INDAH, SEBATIK TIMUR, NUNUKAN, KALIMANTAN UTARA",7,89,13,102
https://kawalpemilu.org#64717,"BUKIT ARU INDAH, SEBATIK TIMUR, NUNUKAN, KALIMANTAN UTARA",8,118,50,168
https://kawalpemilu.org#64717,"BUKIT ARU INDAH, SEBATIK TIMUR, NUNUKAN, KALIMANTAN UTARA",9,149,28,177
https://kawalpemilu.org#64717,"BUKIT ARU INDAH, SEBATIK TIMUR, NUNUKAN, KALIMANTAN UTARA",10,98,57,155
https://kawalpemilu.org#64717,"BUKIT ARU INDAH, SEBATIK TIMUR, NUNUKAN, KALIMANTAN UTARA",11,129,29,158
https://kawalpemilu.org#64717,"BUKIT ARU INDAH, SEBATIK TIMUR, NUNUKAN, KALIMANTAN UTARA",12,63,41,104
https://kawalpemilu.org#64717,"BUKIT ARU INDAH, SEBATIK TIMUR, NUNUKAN, KALIMANTAN UTARA",13,54,32,86
https://kawalpemilu.org#64717,"BUKIT ARU INDAH, SEBATIK TIMUR, NUNUKAN, KALIMANTAN UTARA",14,62,22,84
https://kawalpemilu.org#64722,"TANJUNG HARAPAN, SEBATIK TIMUR, NUNUKAN, KALIMANTAN UTARA",1,76,41,117
https://kawalpemilu.org#64722,"TANJUNG HARAPAN, SEBATIK TIMUR, NUNUKAN, KALIMANTAN UTARA",2,66,25,91
https://kawalpemilu.org#64722,"TANJUNG HARAPAN, SEBATIK TIMUR, NUNUKAN, KALIMANTAN UTARA",3,77,19,96
https://kawalpemilu.org#64722,"TANJUNG HARAPAN, SEBATIK TIMUR, NUNUKAN, KALIMANTAN UTARA",4,66,32,98
https://kawalpemilu.org#64722,"TANJUNG HARAPAN, SEBATIK TIMUR, NUNUKAN, KALIMANTAN UTARA",5,62,20,82
https://kawalpemilu.org#64722,"TANJUNG HARAPAN, SEBATIK TIMUR, NUNUKAN, KALIMANTAN UTARA",6,125,66,191
https://kawalpemilu.org#64722,"TANJUNG HARAPAN, SEBATIK TIMUR, NUNUKAN, KALIMANTAN UTARA",7,81,16,97
https://kawalpemilu.org#64722,"TANJUNG HARAPAN, SEBATIK TIMUR, NUNUKAN, KALIMANTAN UTARA",8,89,16,105
https://kawalpemilu.org#64722,"TANJUNG HARAPAN, SEBATIK TIMUR, NUNUKAN, KALIMANTAN UTARA",9,64,9,73
https://kawalpemilu.org#64722,"TANJUNG HARAPAN, SEBATIK TIMUR, NUNUKAN, KALIMANTAN UTARA",10,78,41,119
https://kawalpemilu.org#64722,"TANJUNG HARAPAN, SEBATIK TIMUR, NUNUKAN, KALIMANTAN UTARA",11,61,43,104
https://kawalpemilu.org#64722,"TANJUNG HARAPAN, SEBATIK TIMUR, NUNUKAN, KALIMANTAN UTARA",12,106,14,120
https://kawalpemilu.org#64722,"TANJUNG HARAPAN, SEBATIK TIMUR, NUNUKAN, KALIMANTAN UTARA",13,52,22,74
https://kawalpemilu.org#64722,"TANJUNG HARAPAN, SEBATIK TIMUR, NUNUKAN, KALIMANTAN UTARA",14,71,9,80
https://kawalpemilu.org#85473,"SUNGAI NYAMUK, SEBATIK TIMUR, NUNUKAN, KALIMANTAN UTARA",1,106,26,132
https://kawalpemilu.org#85473,"SUNGAI NYAMUK, SEBATIK TIMUR, NUNUKAN, KALIMANTAN UTARA",2,112,78,190
https://kawalpemilu.org#85473,"SUNGAI NYAMUK, SEBATIK TIMUR, NUNUKAN, KALIMANTAN UTARA",3,140,63,203
https://kawalpemilu.org#85473,"SUNGAI NYAMUK, SEBATIK TIMUR, NUNUKAN, KALIMANTAN UTARA",4,85,39,124
https://kawalpemilu.org#85473,"SUNGAI NYAMUK, SEBATIK TIMUR, NUNUKAN, KALIMANTAN UTARA",6,124,48,171
https://kawalpemilu.org#85473,"SUNGAI NYAMUK, SEBATIK TIMUR, NUNUKAN, KALIMANTAN UTARA",7,79,28,107
https://kawalpemilu.org#85473,"SUNGAI NYAMUK, SEBATIK TIMUR, NUNUKAN, KALIMANTAN UTARA",8,147,44,191
https://kawalpemilu.org#85473,"SUNGAI NYAMUK, SEBATIK TIMUR, NUNUKAN, KALIMANTAN UTARA",9,117,60,177
https://kawalpemilu.org#85473,"SUNGAI NYAMUK, SEBATIK TIMUR, NUNUKAN, KALIMANTAN UTARA",10,161,29,190
https://kawalpemilu.org#85473,"SUNGAI NYAMUK, SEBATIK TIMUR, NUNUKAN, KALIMANTAN UTARA",11,132,47,179
https://kawalpemilu.org#85473,"SUNGAI NYAMUK, SEBATIK TIMUR, NUNUKAN, KALIMANTAN UTARA",12,142,36,178
https://kawalpemilu.org#85473,"SUNGAI NYAMUK, SEBATIK TIMUR, NUNUKAN, KALIMANTAN UTARA",13,54,27,81
https://kawalpemilu.org#85473,"SUNGAI NYAMUK, SEBATIK TIMUR, NUNUKAN, KALIMANTAN UTARA",14,59,33,92
https://kawalpemilu.org#85473,"SUNGAI NYAMUK, SEBATIK TIMUR, NUNUKAN, KALIMANTAN UTARA",15,53,29,82
https://kawalpemilu.org#85473,"SUNGAI NYAMUK, SEBATIK TIMUR, NUNUKAN, KALIMANTAN UTARA",16,57,14,71
https://kawalpemilu.org#85473,"SUNGAI NYAMUK, SEBATIK TIMUR, NUNUKAN, KALIMANTAN UTARA",17,97,34,131
https://kawalpemilu.org#85473,"SUNGAI NYAMUK, SEBATIK TIMUR, NUNUKAN, KALIMANTAN UTARA",18,70,46,116
https://kawalpemilu.org#85473,"SUNGAI NYAMUK, SEBATIK TIMUR, NUNUKAN, KALIMANTAN UTARA",19,68,52,120
https://kawalpemilu.org#64719,"LAPRI, SEBATIK UTARA, NUNUKAN, KALIMANTAN UTARA",1,109,17,126
https://kawalpemilu.org#64719,"LAPRI, SEBATIK UTARA, NUNUKAN, KALIMANTAN UTARA",2,145,46,191
https://kawalpemilu.org#64719,"LAPRI, SEBATIK UTARA, NUNUKAN, KALIMANTAN UTARA",3,115,40,155
https://kawalpemilu.org#64719,"LAPRI, SEBATIK UTARA, NUNUKAN, KALIMANTAN UTARA",4,123,33,156
https://kawalpemilu.org#85474,"SUNGAI PANCANG, SEBATIK UTARA, NUNUKAN, KALIMANTAN UTARA",1,113,47,160
https://kawalpemilu.org#85474,"SUNGAI PANCANG, SEBATIK UTARA, NUNUKAN, KALIMANTAN UTARA",2,101,49,150
https://kawalpemilu.org#85474,"SUNGAI PANCANG, SEBATIK UTARA, NUNUKAN, KALIMANTAN UTARA",3,103,39,142
https://kawalpemilu.org#85474,"SUNGAI PANCANG, SEBATIK UTARA, NUNUKAN, KALIMANTAN UTARA",4,122,60,182
https://kawalpemilu.org#85474,"SUNGAI PANCANG, SEBATIK UTARA, NUNUKAN, KALIMANTAN UTARA",5,123,57,180
https://kawalpemilu.org#85474,"SUNGAI PANCANG, SEBATIK UTARA, NUNUKAN, KALIMANTAN UTARA",6,134,55,189
https://kawalpemilu.org#85474,"SUNGAI PANCANG, SEBATIK UTARA, NUNUKAN, KALIMANTAN UTARA",7,103,33,136
https://kawalpemilu.org#85474,"SUNGAI PANCANG, SEBATIK UTARA, NUNUKAN, KALIMANTAN UTARA",8,184,42,226
https://kawalpemilu.org#85474,"SUNGAI PANCANG, SEBATIK UTARA, NUNUKAN, KALIMANTAN UTARA",9,70,34,104
https://kawalpemilu.org#85474,"SUNGAI PANCANG, SEBATIK UTARA, NUNUKAN, KALIMANTAN UTARA",10,113,52,165
https://kawalpemilu.org#85474,"SUNGAI PANCANG, SEBATIK UTARA, NUNUKAN, KALIMANTAN UTARA",11,105,31,136
https://kawalpemilu.org#85474,"SUNGAI PANCANG, SEBATIK UTARA, NUNUKAN, KALIMANTAN UTARA",12,128,29,157
https://kawalpemilu.org#85474,"SUNGAI PANCANG, SEBATIK UTARA, NUNUKAN, KALIMANTAN UTARA",13,130,27,157
https://kawalpemilu.org#85474,"SUNGAI PANCANG, SEBATIK UTARA, NUNUKAN, KALIMANTAN UTARA",14,108,30,138
https://kawalpemilu.org#85474,"SUNGAI PANCANG, SEBATIK UTARA, NUNUKAN, KALIMANTAN UTARA",15,130,54,184
https://kawalpemilu.org#87654,"SEBERANG, SEBATIK UTARA, NUNUKAN, KALIMANTAN UTARA",1,91,22,113
https://kawalpemilu.org#87654,"SEBERANG, SEBATIK UTARA, NUNUKAN, KALIMANTAN UTARA",2,94,22,119
https://kawalpemilu.org#87654,"SEBERANG, SEBATIK UTARA, NUNUKAN, KALIMANTAN UTARA",3,74,16,90
https://kawalpemilu.org#87654,"SEBERANG, SEBATIK UTARA, NUNUKAN, KALIMANTAN UTARA",4,142,28,170
https://kawalpemilu.org#87654,"SEBERANG, SEBATIK UTARA, NUNUKAN, KALIMANTAN UTARA",5,90,22,112
https://kawalpemilu.org#64721,"BUKIT HARAPAN, SEBATIK TENGAH, NUNUKAN, KALIMANTAN UTARA",1,160,37,197
https://kawalpemilu.org#64721,"BUKIT HARAPAN, SEBATIK TENGAH, NUNUKAN, KALIMANTAN UTARA",2,125,37,162
https://kawalpemilu.org#64721,"BUKIT HARAPAN, SEBATIK TENGAH, NUNUKAN, KALIMANTAN UTARA",3,103,11,114
https://kawalpemilu.org#64721,"BUKIT HARAPAN, SEBATIK TENGAH, NUNUKAN, KALIMANTAN UTARA",4,66,26,92
https://kawalpemilu.org#64937,"AJI KUNING, SEBATIK TENGAH, NUNUKAN, KALIMANTAN UTARA",1,165,46,211
https://kawalpemilu.org#64937,"AJI KUNING, SEBATIK TENGAH, NUNUKAN, KALIMANTAN UTARA",2,155,57,212
https://kawalpemilu.org#64937,"AJI KUNING, SEBATIK TENGAH, NUNUKAN, KALIMANTAN UTARA",3,125,26,151
https://kawalpemilu.org#64937,"AJI KUNING, SEBATIK TENGAH, NUNUKAN, KALIMANTAN UTARA",4,142,39,181
https://kawalpemilu.org#64937,"AJI KUNING, SEBATIK TENGAH, NUNUKAN, KALIMANTAN UTARA",5,187,48,235
https://kawalpemilu.org#64937,"AJI KUNING, SEBATIK TENGAH, NUNUKAN, KALIMANTAN UTARA",6,79,11,90
https://kawalpemilu.org#64937,"AJI KUNING, SEBATIK TENGAH, NUNUKAN, KALIMANTAN UTARA",7,52,12,64
https://kawalpemilu.org#64937,"AJI KUNING, SEBATIK TENGAH, NUNUKAN, KALIMANTAN UTARA",8,89,27,116
https://kawalpemilu.org#64937,"AJI KUNING, SEBATIK TENGAH, NUNUKAN, KALIMANTAN UTARA",9,104,36,140
https://kawalpemilu.org#64937,"AJI KUNING, SEBATIK TENGAH, NUNUKAN, KALIMANTAN UTARA",10,70,19,89
https://kawalpemilu.org#64941,"MASPUL, SEBATIK TENGAH, NUNUKAN, KALIMANTAN UTARA",1,112,10,122
https://kawalpemilu.org#64941,"MASPUL, SEBATIK TENGAH, NUNUKAN, KALIMANTAN UTARA",2,114,18,132
https://kawalpemilu.org#64941,"MASPUL, SEBATIK TENGAH, NUNUKAN, KALIMANTAN UTARA",3,87,21,108
https://kawalpemilu.org#85475,"SUNGAI LIMAU, SEBATIK TENGAH, NUNUKAN, KALIMANTAN UTARA",1,135,23,158
https://kawalpemilu.org#85475,"SUNGAI LIMAU, SEBATIK TENGAH, NUNUKAN, KALIMANTAN UTARA",2,179,25,204
https://kawalpemilu.org#85475,"SUNGAI LIMAU, SEBATIK TENGAH, NUNUKAN, KALIMANTAN UTARA",3,114,7,121
https://kawalpemilu.org#85475,"SUNGAI LIMAU, SEBATIK TENGAH, NUNUKAN, KALIMANTAN UTARA",4,138,14,152
https://kawalpemilu.org#85475,"SUNGAI LIMAU, SEBATIK TENGAH, NUNUKAN, KALIMANTAN UTARA",5,124,3,127
https://kawalpemilu.org#85475,"SUNGAI LIMAU, SEBATIK TENGAH, NUNUKAN, KALIMANTAN UTARA",6,139,15,154
https://kawalpemilu.org#85475,"SUNGAI LIMAU, SEBATIK TENGAH, NUNUKAN, KALIMANTAN UTARA",7,130,20,150
https://kawalpemilu.org#85475,"SUNGAI LIMAU, SEBATIK TENGAH, NUNUKAN, KALIMANTAN UTARA",8,68,1,69
https://kawalpemilu.org#85475,"SUNGAI LIMAU, SEBATIK TENGAH, NUNUKAN, KALIMANTAN UTARA",9,93,8,101
https://kawalpemilu.org#85475,"SUNGAI LIMAU, SEBATIK TENGAH, NUNUKAN, KALIMANTAN UTARA",10,94,17,111
https://kawalpemilu.org#64729,"TABUR LESTARI, SEI MENGGARIS, NUNUKAN, KALIMANTAN UTARA",1,117,33,150
https://kawalpemilu.org#64729,"TABUR LESTARI, SEI MENGGARIS, NUNUKAN, KALIMANTAN UTARA",2,122,28,150
https://kawalpemilu.org#64729,"TABUR LESTARI, SEI MENGGARIS, NUNUKAN, KALIMANTAN UTARA",3,90,84,174
https://kawalpemilu.org#64729,"TABUR LESTARI, SEI MENGGARIS, NUNUKAN, KALIMANTAN UTARA",4,134,36,170
https://kawalpemilu.org#64729,"TABUR LESTARI, SEI MENGGARIS, NUNUKAN, KALIMANTAN UTARA",5,92,11,103
https://kawalpemilu.org#64729,"TABUR LESTARI, SEI MENGGARIS, NUNUKAN, KALIMANTAN UTARA",6,113,48,161
https://kawalpemilu.org#64729,"TABUR LESTARI, SEI MENGGARIS, NUNUKAN, KALIMANTAN UTARA",7,194,23,217
https://kawalpemilu.org#64729,"TABUR LESTARI, SEI MENGGARIS, NUNUKAN, KALIMANTAN UTARA",8,127,22,149
https://kawalpemilu.org#64729,"TABUR LESTARI, SEI MENGGARIS, NUNUKAN, KALIMANTAN UTARA",9,87,33,120
https://kawalpemilu.org#64729,"TABUR LESTARI, SEI MENGGARIS, NUNUKAN, KALIMANTAN UTARA",10,82,32,114
https://kawalpemilu.org#64729,"TABUR LESTARI, SEI MENGGARIS, NUNUKAN, KALIMANTAN UTARA",11,109,23,132
https://kawalpemilu.org#64729,"TABUR LESTARI, SEI MENGGARIS, NUNUKAN, KALIMANTAN UTARA",12,70,8,78
https://kawalpemilu.org#64730,"SRINANTI, SEI MENGGARIS, NUNUKAN, KALIMANTAN UTARA",1,94,21,115
https://kawalpemilu.org#64730,"SRINANTI, SEI MENGGARIS, NUNUKAN, KALIMANTAN UTARA",2,145,20,165
https://kawalpemilu.org#64730,"SRINANTI, SEI MENGGARIS, NUNUKAN, KALIMANTAN UTARA",3,81,10,91
https://kawalpemilu.org#64730,"SRINANTI, SEI MENGGARIS, NUNUKAN, KALIMANTAN UTARA",4,160,18,178
https://kawalpemilu.org#64730,"SRINANTI, SEI MENGGARIS, NUNUKAN, KALIMANTAN UTARA",5,121,15,136
https://kawalpemilu.org#64730,"SRINANTI, SEI MENGGARIS, NUNUKAN, KALIMANTAN UTARA",6,94,14,108
https://kawalpemilu.org#64730,"SRINANTI, SEI MENGGARIS, NUNUKAN, KALIMANTAN UTARA",7,106,27,133
https://kawalpemilu.org#64731,"SEKADUYAN TAKA, SEI MENGGARIS, NUNUKAN, KALIMANTAN UTARA",1,54,17,71
https://kawalpemilu.org#64731,"SEKADUYAN TAKA, SEI MENGGARIS, NUNUKAN, KALIMANTAN UTARA",2,139,26,165
https://kawalpemilu.org#64731,"SEKADUYAN TAKA, SEI MENGGARIS, NUNUKAN, KALIMANTAN UTARA",3,101,34,135
https://kawalpemilu.org#64731,"SEKADUYAN TAKA, SEI MENGGARIS, NUNUKAN, KALIMANTAN UTARA",4,116,57,173
https://kawalpemilu.org#64731,"SEKADUYAN TAKA, SEI MENGGARIS, NUNUKAN, KALIMANTAN UTARA",5,154,26,180
https://kawalpemilu.org#64731,"SEKADUYAN TAKA, SEI MENGGARIS, NUNUKAN, KALIMANTAN UTARA",6,127,13,140
https://kawalpemilu.org#64731,"SEKADUYAN TAKA, SEI MENGGARIS, NUNUKAN, KALIMANTAN UTARA",7,87,10,97
https://kawalpemilu.org#64731,"SEKADUYAN TAKA, SEI MENGGARIS, NUNUKAN, KALIMANTAN UTARA",8,107,13,120
https://kawalpemilu.org#64731,"SEKADUYAN TAKA, SEI MENGGARIS, NUNUKAN, KALIMANTAN UTARA",9,42,20,62
https://kawalpemilu.org#64732,"SAMAENRE SEMAJA, SEI MENGGARIS, NUNUKAN, KALIMANTAN UTARA",1,127,14,141
https://kawalpemilu.org#64732,"SAMAENRE SEMAJA, SEI MENGGARIS, NUNUKAN, KALIMANTAN UTARA",2,47,11,58
https://kawalpemilu.org#64732,"SAMAENRE SEMAJA, SEI MENGGARIS, NUNUKAN, KALIMANTAN UTARA",3,45,3,48
https://kawalpemilu.org#64732,"SAMAENRE SEMAJA, SEI MENGGARIS, NUNUKAN, KALIMANTAN UTARA",4,75,7,82
https://kawalpemilu.org#64732,"SAMAENRE SEMAJA, SEI MENGGARIS, NUNUKAN, KALIMANTAN UTARA",5,49,8,57
https://kawalpemilu.org#64899,"SEMUNAD, TULIN ONSOI, NUNUKAN, KALIMANTAN UTARA",1,253,8,261
https://kawalpemilu.org#64899,"SEMUNAD, TULIN ONSOI, NUNUKAN, KALIMANTAN UTARA",2,138,4,142
https://kawalpemilu.org#64900,"SEKIKILAN, TULIN ONSOI, NUNUKAN, KALIMANTAN UTARA",1,206,10,216
https://kawalpemilu.org#64900,"SEKIKILAN, TULIN ONSOI, NUNUKAN, KALIMANTAN UTARA",2,223,1,224
https://kawalpemilu.org#64900,"SEKIKILAN, TULIN ONSOI, NUNUKAN, KALIMANTAN UTARA",3,140,10,150
https://kawalpemilu.org#64900,"SEKIKILAN, TULIN ONSOI, NUNUKAN, KALIMANTAN UTARA",4,236,10,246
https://kawalpemilu.org#64900,"SEKIKILAN, TULIN ONSOI, NUNUKAN, KALIMANTAN UTARA",5,162,19,181
https://kawalpemilu.org#64900,"SEKIKILAN, TULIN ONSOI, NUNUKAN, KALIMANTAN UTARA",6,82,10,92
https://kawalpemilu.org#64900,"SEKIKILAN, TULIN ONSOI, NUNUKAN, KALIMANTAN UTARA",7,59,1,60
https://kawalpemilu.org#64902,"TEMBALANG, TULIN ONSOI, NUNUKAN, KALIMANTAN UTARA",1,148,3,151
https://kawalpemilu.org#64903,"SALANG, TULIN ONSOI, NUNUKAN, KALIMANTAN UTARA",1,140,16,156
https://kawalpemilu.org#64903,"SALANG, TULIN ONSOI, NUNUKAN, KALIMANTAN UTARA",2,133,11,144
https://kawalpemilu.org#64904,"TINAMPAK I, TULIN ONSOI, NUNUKAN, KALIMANTAN UTARA",1,198,10,208
https://kawalpemilu.org#64905,"TINAMPAK II, TULIN ONSOI, NUNUKAN, KALIMANTAN UTARA",1,106,2,108
https://kawalpemilu.org#64906,"TAU BARU, TULIN ONSOI, NUNUKAN, KALIMANTAN UTARA",1,197,5,202
https://kawalpemilu.org#64908,"NAPUTI, TULIN ONSOI, NUNUKAN, KALIMANTAN UTARA",1,159,6,165
https://kawalpemilu.org#64909,"BALATIKON, TULIN ONSOI, NUNUKAN, KALIMANTAN UTARA",1,143,2,145
https://kawalpemilu.org#64910,"SANUR, TULIN ONSOI, NUNUKAN, KALIMANTAN UTARA",1,170,43,213
https://kawalpemilu.org#64910,"SANUR, TULIN ONSOI, NUNUKAN, KALIMANTAN UTARA",2,162,19,181
https://kawalpemilu.org#64910,"SANUR, TULIN ONSOI, NUNUKAN, KALIMANTAN UTARA",3,154,31,185
https://kawalpemilu.org#64910,"SANUR, TULIN ONSOI, NUNUKAN, KALIMANTAN UTARA",4,141,37,178
https://kawalpemilu.org#64910,"SANUR, TULIN ONSOI, NUNUKAN, KALIMANTAN UTARA",5,110,26,136
https://kawalpemilu.org#64910,"SANUR, TULIN ONSOI, NUNUKAN, KALIMANTAN UTARA",6,101,19,120
https://kawalpemilu.org#64910,"SANUR, TULIN ONSOI, NUNUKAN, KALIMANTAN UTARA",7,39,12,51
https://kawalpemilu.org#64910,"SANUR, TULIN ONSOI, NUNUKAN, KALIMANTAN UTARA",8,90,20,110
https://kawalpemilu.org#64911,"MAKMUR, TULIN ONSOI, NUNUKAN, KALIMANTAN UTARA",1,121,31,152
https://kawalpemilu.org#64911,"MAKMUR, TULIN ONSOI, NUNUKAN, KALIMANTAN UTARA",2,111,30,141
https://kawalpemilu.org#64911,"MAKMUR, TULIN ONSOI, NUNUKAN, KALIMANTAN UTARA",3,169,23,192
https://kawalpemilu.org#64911,"MAKMUR, TULIN ONSOI, NUNUKAN, KALIMANTAN UTARA",4,106,26,131
https://kawalpemilu.org#64911,"MAKMUR, TULIN ONSOI, NUNUKAN, KALIMANTAN UTARA",5,110,32,142
https://kawalpemilu.org#64911,"MAKMUR, TULIN ONSOI, NUNUKAN, KALIMANTAN UTARA",6,118,14,132
https://kawalpemilu.org#85476,"KELUN SAYAN, TULIN ONSOI, NUNUKAN, KALIMANTAN UTARA",1,278,3,281
https://kawalpemilu.org#85476,"KELUN SAYAN, TULIN ONSOI, NUNUKAN, KALIMANTAN UTARA",2,56,5,61
https://kawalpemilu.org#64756,"LABANG, LUMBIS OGONG, NUNUKAN, KALIMANTAN UTARA",1,64,0,64
https://kawalpemilu.org#64758,"LONG BULU, LUMBIS OGONG, NUNUKAN, KALIMANTAN UTARA",1,166,6,172
https://kawalpemilu.org#64760,"SINAMPILA II, LUMBIS OGONG, NUNUKAN, KALIMANTAN UTARA",1,127,7,134
https://kawalpemilu.org#64761,"SAMUNTI, LUMBIS OGONG, NUNUKAN, KALIMANTAN UTARA",1,122,6,128
https://kawalpemilu.org#64767,"SUMENTOBOL, LUMBIS OGONG, NUNUKAN, KALIMANTAN UTARA",1,80,0,80
https://kawalpemilu.org#64773,"UBOL SULOK, LUMBIS OGONG, NUNUKAN, KALIMANTAN UTARA",1,87,5,92
https://kawalpemilu.org#64775,"SEDALIT, LUMBIS OGONG, NUNUKAN, KALIMANTAN UTARA",1,52,2,54
https://kawalpemilu.org#64778,"SUMANTIPAL, LUMBIS OGONG, NUNUKAN, KALIMANTAN UTARA",1,189,1,190
https://kawalpemilu.org#64781,"NANTUKIDAN, LUMBIS OGONG, NUNUKAN, KALIMANTAN UTARA",1,73,0,73
https://kawalpemilu.org#64794,"SIBALU, LUMBIS OGONG, NUNUKAN, KALIMANTAN UTARA",1,35,0,35
https://kawalpemilu.org#64795,"KUYO, LUMBIS OGONG, NUNUKAN, KALIMANTAN UTARA",1,41,4,45
https://kawalpemilu.org#64796,"PANAS, LUMBIS OGONG, NUNUKAN, KALIMANTAN UTARA",1,105,1,106
https://kawalpemilu.org#64804,"SUYADON, LUMBIS OGONG, NUNUKAN, KALIMANTAN UTARA",1,73,0,73
https://kawalpemilu.org#64805,"UBOL ALUNG, LUMBIS OGONG, NUNUKAN, KALIMANTAN UTARA",1,99,1,100
https://kawalpemilu.org#64806,"SEMATA, LUMBIS OGONG, NUNUKAN, KALIMANTAN UTARA",1,82,16,98
https://kawalpemilu.org#64808,"TADUNGUS, LUMBIS OGONG, NUNUKAN, KALIMANTAN UTARA",1,77,5,82
https://kawalpemilu.org#64813,"TAU LUMBIS, LUMBIS OGONG, NUNUKAN, KALIMANTAN UTARA",1,79,1,80
https://kawalpemilu.org#85477,"BULU MENGOLOM, LUMBIS OGONG, NUNUKAN, KALIMANTAN UTARA",1,96,1,97
https://kawalpemilu.org#85478,"TUKULON, LUMBIS OGONG, NUNUKAN, KALIMANTAN UTARA",1,213,1,214
https://kawalpemilu.org#928503,"PAYANG, LUMBIS OGONG, NUNUKAN, KALIMANTAN UTARA",1,42,1,43
https://kawalpemilu.org#928504,"BATUNG, LUMBIS OGONG, NUNUKAN, KALIMANTAN UTARA",1,64,3,67
https://kawalpemilu.org#928505,"NANSAPAN, LUMBIS OGONG, NUNUKAN, KALIMANTAN UTARA",1,64,4,68
https://kawalpemilu.org#928506,"SUNGOI, LUMBIS OGONG, NUNUKAN, KALIMANTAN UTARA",1,54,6,60
https://kawalpemilu.org#928508,"PALUAN, LUMBIS OGONG, NUNUKAN, KALIMANTAN UTARA",1,66,0,66
https://kawalpemilu.org#928509,"TAMBALANG HILIR, LUMBIS OGONG, NUNUKAN, KALIMANTAN UTARA",1,46,0,46
https://kawalpemilu.org#928510,"KALAMBUKU, LUMBIS OGONG, NUNUKAN, KALIMANTAN UTARA",1,54,3,57
https://kawalpemilu.org#928511,"JUKUP, LUMBIS OGONG, NUNUKAN, KALIMANTAN UTARA",1,78,1,79
https://kawalpemilu.org#928512,"LINSAYUNG, LUMBIS OGONG, NUNUKAN, KALIMANTAN UTARA",1,35,1,36
https://kawalpemilu.org#928513,"TUMANTALAS, LUMBIS OGONG, NUNUKAN, KALIMANTAN UTARA",1,37,1,38
https://kawalpemilu.org#928514,"SANAL, LUMBIS OGONG, NUNUKAN, KALIMANTAN UTARA",1,71,0,71
https://kawalpemilu.org#928515,"LIMPAKON, LUMBIS OGONG, NUNUKAN, KALIMANTAN UTARA",1,41,0,41
https://kawalpemilu.org#928516,"LABUK, LUMBIS OGONG, NUNUKAN, KALIMANTAN UTARA",1,21,0,21
https://kawalpemilu.org#928518,"BULULAUN HILIR, LUMBIS OGONG, NUNUKAN, KALIMANTAN UTARA",1,74,0,74
https://kawalpemilu.org#928519,"LAGAS, LUMBIS OGONG, NUNUKAN, KALIMANTAN UTARA",1,47,7,54
https://kawalpemilu.org#928520,"LANGGASON, LUMBIS OGONG, NUNUKAN, KALIMANTAN UTARA",1,69,4,73
https://kawalpemilu.org#928521,"TAMBALANG HULU, LUMBIS OGONG, NUNUKAN, KALIMANTAN UTARA",1,97,2,99
https://kawalpemilu.org#928522,"BOKOK, LUMBIS OGONG, NUNUKAN, KALIMANTAN UTARA",1,37,2,39
https://kawalpemilu.org#928523,"BULULAUN HULU, LUMBIS OGONG, NUNUKAN, KALIMANTAN UTARA",1,40,0,40
https://kawalpemilu.org#928524,"KALISUN, LUMBIS OGONG, NUNUKAN, KALIMANTAN UTARA",1,33,2,35
https://kawalpemilu.org#928525,"MAMASIN, LUMBIS OGONG, NUNUKAN, KALIMANTAN UTARA",1,46,0,46
https://kawalpemilu.org#928526,"DUYAN, LUMBIS OGONG, NUNUKAN, KALIMANTAN UTARA",1,48,1,49
https://kawalpemilu.org#928527,"TUNTULIBING, LUMBIS OGONG, NUNUKAN, KALIMANTAN UTARA",1,65,1,66
https://kawalpemilu.org#928528,"TETAGAS, LUMBIS OGONG, NUNUKAN, KALIMANTAN UTARA",1,43,0,43
https://kawalpemilu.org#928529,"KABUNGOLOR, LUMBIS OGONG, NUNUKAN, KALIMANTAN UTARA",1,38,0,38
https://kawalpemilu.org#928530,"LIPAGA, LUMBIS OGONG, NUNUKAN, KALIMANTAN UTARA",1,40,0,40
https://kawalpemilu.org#928531,"TANTALUJUK, LUMBIS OGONG, NUNUKAN, KALIMANTAN UTARA",1,33,0,33
https://kawalpemilu.org#64742,"LUBOK BUAT, SEMBAKUNG ATULAI, NUNUKAN, KALIMANTAN UTARA",1,179,25,204
https://kawalpemilu.org#64742,"LUBOK BUAT, SEMBAKUNG ATULAI, NUNUKAN, KALIMANTAN UTARA",2,154,17,171
https://kawalpemilu.org#64743,"KATUL, SEMBAKUNG ATULAI, NUNUKAN, KALIMANTAN UTARA",1,154,13,167
https://kawalpemilu.org#64744,"MAMBULU, SEMBAKUNG ATULAI, NUNUKAN, KALIMANTAN UTARA",1,164,9,173
https://kawalpemilu.org#64745,"PAGALUYON, SEMBAKUNG ATULAI, NUNUKAN, KALIMANTAN UTARA",1,183,25,208
https://kawalpemilu.org#64746,"SADUMAN, SEMBAKUNG ATULAI, NUNUKAN, KALIMANTAN UTARA",1,207,6,213
https://kawalpemilu.org#64747,"TULANG, SEMBAKUNG ATULAI, NUNUKAN, KALIMANTAN UTARA",1,192,7,199
https://kawalpemilu.org#64748,"SABULUAN, SEMBAKUNG ATULAI, NUNUKAN, KALIMANTAN UTARA",1,118,4,122
https://kawalpemilu.org#64749,"BINANUN, SEMBAKUNG ATULAI, NUNUKAN, KALIMANTAN UTARA",1,174,7,181
https://kawalpemilu.org#64750,"PULAU KERAS, SEMBAKUNG ATULAI, NUNUKAN, KALIMANTAN UTARA",1,186,15,201
https://kawalpemilu.org#64751,"LIUK BULU, SEMBAKUNG ATULAI, NUNUKAN, KALIMANTAN UTARA",1,134,1,135
https://kawalpemilu.org#64920,"LONG PADI, KRAYAN TENGAH, NUNUKAN, KALIMANTAN UTARA",1,58,1,59
https://kawalpemilu.org#64925,"LONG RUNGAN, KRAYAN TENGAH, NUNUKAN, KALIMANTAN UTARA",1,163,0,163
https://kawalpemilu.org#64926,"LONG MUTAN, KRAYAN TENGAH, NUNUKAN, KALIMANTAN UTARA",1,216,1,217
https://kawalpemilu.org#64930,"BA' LIKU, KRAYAN TENGAH, NUNUKAN, KALIMANTAN UTARA",1,142,6,148
https://kawalpemilu.org#64933,"BINUANG, KRAYAN TENGAH, NUNUKAN, KALIMANTAN UTARA",1,240,5,245
https://kawalpemilu.org#928494,"TANG PAYE, KRAYAN TENGAH, NUNUKAN, KALIMANTAN UTARA",1,47,0,47
https://kawalpemilu.org#928495,"LONG KLUPAN, KRAYAN TENGAH, NUNUKAN, KALIMANTAN UTARA",1,47,0,47
https://kawalpemilu.org#928497,"LONG RIAN, KRAYAN TENGAH, NUNUKAN, KALIMANTAN UTARA",1,85,0,85
https://kawalpemilu.org#928500,"PA' YALAU, KRAYAN TENGAH, NUNUKAN, KALIMANTAN UTARA",1,46,1,47
https://kawalpemilu.org#928501,"PA' MILAU, KRAYAN TENGAH, NUNUKAN, KALIMANTAN UTARA",1,108,0,108
https://kawalpemilu.org#928502,"TANG BADUI, KRAYAN TENGAH, NUNUKAN, KALIMANTAN UTARA",1,37,0,37
https://kawalpemilu.org#64868,"KAMPUNG BARU, KRAYAN TIMUR, NUNUKAN, KALIMANTAN UTARA",1,130,5,135
https://kawalpemilu.org#64869,"PA' BETUNG, KRAYAN TIMUR, NUNUKAN, KALIMANTAN UTARA",1,94,2,96
https://kawalpemilu.org#64875,"PA' RANGEB, KRAYAN TIMUR, NUNUKAN, KALIMANTAN UTARA",1,83,1,84
https://kawalpemilu.org#64876,"PA' KEBUAN, KRAYAN TIMUR, NUNUKAN, KALIMANTAN UTARA",1,83,2,85
https://kawalpemilu.org#64877,"PA' PAWAN, KRAYAN TIMUR, NUNUKAN, KALIMANTAN UTARA",1,77,0,77
https://kawalpemilu.org#64878,"LONG TENEM, KRAYAN TIMUR, NUNUKAN, KALIMANTAN UTARA",1,98,0,98
https://kawalpemilu.org#64879,"PA' UMUNG, KRAYAN TIMUR, NUNUKAN, KALIMANTAN UTARA",1,85,2,87
https://kawalpemilu.org#64880,"PA' RAYE, KRAYAN TIMUR, NUNUKAN, KALIMANTAN UTARA",1,145,2,147
https://kawalpemilu.org#64881,"PA' MELADE, KRAYAN TIMUR, NUNUKAN, KALIMANTAN UTARA",1,69,2,71
https://kawalpemilu.org#64882,"WA' YAGUNG, KRAYAN TIMUR, NUNUKAN, KALIMANTAN UTARA",1,126,0,126
https://kawalpemilu.org#64883,"PA' PALA, KRAYAN TIMUR, NUNUKAN, KALIMANTAN UTARA",1,96,0,96
https://kawalpemilu.org#64884,"SINAR BARU, KRAYAN TIMUR, NUNUKAN, KALIMANTAN UTARA",1,77,5,82
https://kawalpemilu.org#64885,"LONG NUAT, KRAYAN TIMUR, NUNUKAN, KALIMANTAN UTARA",1,67,0,67
https://kawalpemilu.org#64886,"LONG SEPAYANG, KRAYAN TIMUR, NUNUKAN, KALIMANTAN UTARA",1,59,1,60
https://kawalpemilu.org#85470,"BUNGAYAN, KRAYAN TIMUR, NUNUKAN, KALIMANTAN UTARA",1,85,0,85
https://kawalpemilu.org#85471,"PA' LIDUNG, KRAYAN TIMUR, NUNUKAN, KALIMANTAN UTARA",1,42,0,42
https://kawalpemilu.org#64830,"PA' MULAK, KRAYAN BARAT, NUNUKAN, KALIMANTAN UTARA",1,39,1,40
https://kawalpemilu.org#64833,"LONG PUAK, KRAYAN BARAT, NUNUKAN, KALIMANTAN UTARA",1,91,1,92
https://kawalpemilu.org#64834,"BUDUK KUBUL, KRAYAN BARAT, NUNUKAN, KALIMANTAN UTARA",1,153,0,153
https://kawalpemilu.org#64835,"LONG KABID, KRAYAN BARAT, NUNUKAN, KALIMANTAN UTARA",1,105,0,105
https://kawalpemilu.org#64836,"PA' INAN, KRAYAN BARAT, NUNUKAN, KALIMANTAN UTARA",1,55,0,55
https://kawalpemilu.org#64837,"LEMBUDUD, KRAYAN BARAT, NUNUKAN, KALIMANTAN UTARA",1,181,0,181
https://kawalpemilu.org#64838,"LONG TUGUL, KRAYAN BARAT, NUNUKAN, KALIMANTAN UTARA",1,148,1,149
https://kawalpemilu.org#64839,"PA' BUTAL, KRAYAN BARAT, NUNUKAN, KALIMANTAN UTARA",1,206,0,206
https://kawalpemilu.org#64840,"PA' DELUNG, KRAYAN BARAT, NUNUKAN, KALIMANTAN UTARA",1,149,2,151
https://kawalpemilu.org#64841,"PA' URUD, KRAYAN BARAT, NUNUKAN, KALIMANTAN UTARA",1,82,0,82
https://kawalpemilu.org#64842,"PA' KEMUT, KRAYAN BARAT, NUNUKAN, KALIMANTAN UTARA",1,84,0,84
https://kawalpemilu.org#64843,"PA' KIDANG, KRAYAN BARAT, NUNUKAN, KALIMANTAN UTARA",1,101,1,102
https://kawalpemilu.org#64844,"LEMBADA, KRAYAN BARAT, NUNUKAN, KALIMANTAN UTARA",1,127,3,130
https://kawalpemilu.org#64845,"PA' PAYAK, KRAYAN BARAT, NUNUKAN, KALIMANTAN UTARA",1,101,0,101
https://kawalpemilu.org#64846,"PA' PIRIT, KRAYAN BARAT, NUNUKAN, KALIMANTAN UTARA",1,81,0,81
https://kawalpemilu.org#64847,"LIANG ALIQ, KRAYAN BARAT, NUNUKAN, KALIMANTAN UTARA",1,127,1,128
https://kawalpemilu.org#64848,"SEMBUDUD, KRAYAN BARAT, NUNUKAN, KALIMANTAN UTARA",1,82,2,84
https://kawalpemilu.org#64849,"LIANG TURAN, KRAYAN BARAT, NUNUKAN, KALIMANTAN UTARA",1,184,0,184
https://kawalpemilu.org#64851,"LIANG BUA, KRAYAN BARAT, NUNUKAN, KALIMANTAN UTARA",1,74,2,76
https://kawalpemilu.org#64852,"LEPATAR, KRAYAN BARAT, NUNUKAN, KALIMANTAN UTARA",1,149,1,150
https://kawalpemilu.org#64853,"PA' MERING, KRAYAN BARAT, NUNUKAN, KALIMANTAN UTARA",1,109,3,112
https://kawalpemilu.org#64854,"PA' PANI, KRAYAN BARAT, NUNUKAN, KALIMANTAN UTARA",1,66,0,66
https://kawalpemilu.org#64855,"PA' LUTUT, KRAYAN BARAT, NUNUKAN, KALIMANTAN UTARA",1,54,2,56
https://kawalpemilu.org#85465,"LONG MANGAN, KRAYAN BARAT, NUNUKAN, KALIMANTAN UTARA",1,31,0,31
https://kawalpemilu.org#92812,"MA' LIBU, KRAYAN BARAT, NUNUKAN, KALIMANTAN UTARA",1,92,0,92
https://kawalpemilu.org#64951,"LONG GAFID, MENTARANG, MALINAU, KALIMANTAN UTARA",1,170,4,174
https://kawalpemilu.org#64952,"LONG BISAI, MENTARANG, MALINAU, KALIMANTAN UTARA",1,137,23,160
https://kawalpemilu.org#64952,"LONG BISAI, MENTARANG, MALINAU, KALIMANTAN UTARA",2,124,19,143
https://kawalpemilu.org#64953,"TEMALANG, MENTARANG, MALINAU, KALIMANTAN UTARA",1,108,9,117
https://kawalpemilu.org#64954,"LONG LIKU, MENTARANG, MALINAU, KALIMANTAN UTARA",1,81,2,83
https://kawalpemilu.org#64955,"PULAU SAPI, MENTARANG, MALINAU, KALIMANTAN UTARA",1,148,6,154
https://kawalpemilu.org#64955,"PULAU SAPI, MENTARANG, MALINAU, KALIMANTAN UTARA",2,175,11,4
https://kawalpemilu.org#64955,"PULAU SAPI, MENTARANG, MALINAU, KALIMANTAN UTARA",3,181,17,198
https://kawalpemilu.org#64955,"PULAU SAPI, MENTARANG, MALINAU, KALIMANTAN UTARA",4,121,2,123
https://kawalpemilu.org#64955,"PULAU SAPI, MENTARANG, MALINAU, KALIMANTAN UTARA",5,189,13,202
https://kawalpemilu.org#64955,"PULAU SAPI, MENTARANG, MALINAU, KALIMANTAN UTARA",6,193,18,211
https://kawalpemilu.org#64956,"PAKING, MENTARANG, MALINAU, KALIMANTAN UTARA",1,178,22,200
https://kawalpemilu.org#64956,"PAKING, MENTARANG, MALINAU, KALIMANTAN UTARA",2,58,2,60
https://kawalpemilu.org#64962,"LIDUNG KEMINCI, MENTARANG, MALINAU, KALIMANTAN UTARA",1,107,4,111
https://kawalpemilu.org#64962,"LIDUNG KEMINCI, MENTARANG, MALINAU, KALIMANTAN UTARA",2,139,9,148
https://kawalpemilu.org#64963,"MENTARANG BARU, MENTARANG, MALINAU, KALIMANTAN UTARA",1,118,12,130
https://kawalpemilu.org#64963,"MENTARANG BARU, MENTARANG, MALINAU, KALIMANTAN UTARA",2,108,5,113
https://kawalpemilu.org#64963,"MENTARANG BARU, MENTARANG, MALINAU, KALIMANTAN UTARA",3,154,13,167
https://kawalpemilu.org#64963,"MENTARANG BARU, MENTARANG, MALINAU, KALIMANTAN UTARA",4,172,13,185
https://kawalpemilu.org#64964,"HARAPAN MAJU, MENTARANG, MALINAU, KALIMANTAN UTARA",1,137,6,143
https://kawalpemilu.org#64964,"HARAPAN MAJU, MENTARANG, MALINAU, KALIMANTAN UTARA",3,34,2,36
https://kawalpemilu.org#64966,"MALINAU KOTA, MALINAU KOTA, MALINAU, KALIMANTAN UTARA",1,43,48,91
https://kawalpemilu.org#64966,"MALINAU KOTA, MALINAU KOTA, MALINAU, KALIMANTAN UTARA",2,91,110,201
https://kawalpemilu.org#64966,"MALINAU KOTA, MALINAU KOTA, MALINAU, KALIMANTAN UTARA",3,66,73,139
https://kawalpemilu.org#64966,"MALINAU KOTA, MALINAU KOTA, MALINAU, KALIMANTAN UTARA",4,25,85,110
https://kawalpemilu.org#64966,"MALINAU KOTA, MALINAU KOTA, MALINAU, KALIMANTAN UTARA",5,82,86,168
https://kawalpemilu.org#64966,"MALINAU KOTA, MALINAU KOTA, MALINAU, KALIMANTAN UTARA",6,51,40,91
https://kawalpemilu.org#64966,"MALINAU KOTA, MALINAU KOTA, MALINAU, KALIMANTAN UTARA",7,60,48,108
https://kawalpemilu.org#64966,"MALINAU KOTA, MALINAU KOTA, MALINAU, KALIMANTAN UTARA",8,89,55,144
https://kawalpemilu.org#64966,"MALINAU KOTA, MALINAU KOTA, MALINAU, KALIMANTAN UTARA",9,97,57,154
https://kawalpemilu.org#64966,"MALINAU KOTA, MALINAU KOTA, MALINAU, KALIMANTAN UTARA",10,111,83,194
https://kawalpemilu.org#64966,"MALINAU KOTA, MALINAU KOTA, MALINAU, KALIMANTAN UTARA",11,94,66,160
https://kawalpemilu.org#64966,"MALINAU KOTA, MALINAU KOTA, MALINAU, KALIMANTAN UTARA",12,65,41,106
https://kawalpemilu.org#64966,"MALINAU KOTA, MALINAU KOTA, MALINAU, KALIMANTAN UTARA",13,55,35,90
https://kawalpemilu.org#64966,"MALINAU KOTA, MALINAU KOTA, MALINAU, KALIMANTAN UTARA",14,72,44,116
https://kawalpemilu.org#64966,"MALINAU KOTA, MALINAU KOTA, MALINAU, KALIMANTAN UTARA",15,107,81,188
https://kawalpemilu.org#64966,"MALINAU KOTA, MALINAU KOTA, MALINAU, KALIMANTAN UTARA",16,108,59,167
https://kawalpemilu.org#64966,"MALINAU KOTA, MALINAU KOTA, MALINAU, KALIMANTAN UTARA",17,129,56,185
https://kawalpemilu.org#64966,"MALINAU KOTA, MALINAU KOTA, MALINAU, KALIMANTAN UTARA",18,142,58,200
https://kawalpemilu.org#64966,"MALINAU KOTA, MALINAU KOTA, MALINAU, KALIMANTAN UTARA",19,48,56,104
https://kawalpemilu.org#64966,"MALINAU KOTA, MALINAU KOTA, MALINAU, KALIMANTAN UTARA",20,64,54,118
https://kawalpemilu.org#64966,"MALINAU KOTA, MALINAU KOTA, MALINAU, KALIMANTAN UTARA",21,106,47,153
https://kawalpemilu.org#64966,"MALINAU KOTA, MALINAU KOTA, MALINAU, KALIMANTAN UTARA",22,99,63,162
https://kawalpemilu.org#64966,"MALINAU KOTA, MALINAU KOTA, MALINAU, KALIMANTAN UTARA",23,92,68,160
https://kawalpemilu.org#64966,"MALINAU KOTA, MALINAU KOTA, MALINAU, KALIMANTAN UTARA",24,114,54,168
https://kawalpemilu.org#64966,"MALINAU KOTA, MALINAU KOTA, MALINAU, KALIMANTAN UTARA",25,120,80,200
https://kawalpemilu.org#64966,"MALINAU KOTA, MALINAU KOTA, MALINAU, KALIMANTAN UTARA",26,79,58,137
https://kawalpemilu.org#64966,"MALINAU KOTA, MALINAU KOTA, MALINAU, KALIMANTAN UTARA",27,98,56,154
https://kawalpemilu.org#64966,"MALINAU KOTA, MALINAU KOTA, MALINAU, KALIMANTAN UTARA",28,81,51,132
https://kawalpemilu.org#64966,"MALINAU KOTA, MALINAU KOTA, MALINAU, KALIMANTAN UTARA",29,63,30,93
https://kawalpemilu.org#64966,"MALINAU KOTA, MALINAU KOTA, MALINAU, KALIMANTAN UTARA",30,78,33,111
https://kawalpemilu.org#64966,"MALINAU KOTA, MALINAU KOTA, MALINAU, KALIMANTAN UTARA",31,101,65,166
https://kawalpemilu.org#64966,"MALINAU KOTA, MALINAU KOTA, MALINAU, KALIMANTAN UTARA",32,87,154,241
https://kawalpemilu.org#64966,"MALINAU KOTA, MALINAU KOTA, MALINAU, KALIMANTAN UTARA",33,56,60,116
https://kawalpemilu.org#64966,"MALINAU KOTA, MALINAU KOTA, MALINAU, KALIMANTAN UTARA",34,74,47,121
https://kawalpemilu.org#64966,"MALINAU KOTA, MALINAU KOTA, MALINAU, KALIMANTAN UTARA",35,85,78,163
https://kawalpemilu.org#64966,"MALINAU KOTA, MALINAU KOTA, MALINAU, KALIMANTAN UTARA",36,88,97,185
https://kawalpemilu.org#64966,"MALINAU KOTA, MALINAU KOTA, MALINAU, KALIMANTAN UTARA",37,102,85,187
https://kawalpemilu.org#64966,"MALINAU KOTA, MALINAU KOTA, MALINAU, KALIMANTAN UTARA",38,167,95,262
https://kawalpemilu.org#64966,"MALINAU KOTA, MALINAU KOTA, MALINAU, KALIMANTAN UTARA",39,166,74,240
https://kawalpemilu.org#64966,"MALINAU KOTA, MALINAU KOTA, MALINAU, KALIMANTAN UTARA",40,178,71,249
https://kawalpemilu.org#64967,"BATU LIDUNG, MALINAU KOTA, MALINAU, KALIMANTAN UTARA",1,190,14,204
https://kawalpemilu.org#64967,"BATU LIDUNG, MALINAU KOTA, MALINAU, KALIMANTAN UTARA",2,168,18,186
https://kawalpemilu.org#64967,"BATU LIDUNG, MALINAU KOTA, MALINAU, KALIMANTAN UTARA",3,233,15,248
https://kawalpemilu.org#64967,"BATU LIDUNG, MALINAU KOTA, MALINAU, KALIMANTAN UTARA",4,150,5,155
https://kawalpemilu.org#64968,"PELITA KANAAN, MALINAU KOTA, MALINAU, KALIMANTAN UTARA",1,140,7,147
https://kawalpemilu.org#64968,"PELITA KANAAN, MALINAU KOTA, MALINAU, KALIMANTAN UTARA",2,93,5,98
https://kawalpemilu.org#64968,"PELITA KANAAN, MALINAU KOTA, MALINAU, KALIMANTAN UTARA",3,130,13,143
https://kawalpemilu.org#64968,"PELITA KANAAN, MALINAU KOTA, MALINAU, KALIMANTAN UTARA",4,130,7,137
https://kawalpemilu.org#64968,"PELITA KANAAN, MALINAU KOTA, MALINAU, KALIMANTAN UTARA",5,97,4,101
https://kawalpemilu.org#64968,"PELITA KANAAN, MALINAU KOTA, MALINAU, KALIMANTAN UTARA",6,151,4,155
https://kawalpemilu.org#64968,"PELITA KANAAN, MALINAU KOTA, MALINAU, KALIMANTAN UTARA",7,155,2,157
https://kawalpemilu.org#64968,"PELITA KANAAN, MALINAU KOTA, MALINAU, KALIMANTAN UTARA",8,141,9,150
https://kawalpemilu.org#64969,"MALINAU HULU, MALINAU KOTA, MALINAU, KALIMANTAN UTARA",1,122,47,169
https://kawalpemilu.org#64969,"MALINAU HULU, MALINAU KOTA, MALINAU, KALIMANTAN UTARA",2,107,34,141
https://kawalpemilu.org#64969,"MALINAU HULU, MALINAU KOTA, MALINAU, KALIMANTAN UTARA",3,80,25,105
https://kawalpemilu.org#64969,"MALINAU HULU, MALINAU KOTA, MALINAU, KALIMANTAN UTARA",4,112,49,161
https://kawalpemilu.org#64969,"MALINAU HULU, MALINAU KOTA, MALINAU, KALIMANTAN UTARA",5,72,22,94
https://kawalpemilu.org#64969,"MALINAU HULU, MALINAU KOTA, MALINAU, KALIMANTAN UTARA",6,130,48,178
https://kawalpemilu.org#64969,"MALINAU HULU, MALINAU KOTA, MALINAU, KALIMANTAN UTARA",7,138,14,152
https://kawalpemilu.org#64969,"MALINAU HULU, MALINAU KOTA, MALINAU, KALIMANTAN UTARA",8,84,41,125
https://kawalpemilu.org#64969,"MALINAU HULU, MALINAU KOTA, MALINAU, KALIMANTAN UTARA",9,57,34,91
https://kawalpemilu.org#64969,"MALINAU HULU, MALINAU KOTA, MALINAU, KALIMANTAN UTARA",10,82,35,117
https://kawalpemilu.org#64969,"MALINAU HULU, MALINAU KOTA, MALINAU, KALIMANTAN UTARA",11,83,20,103
https://kawalpemilu.org#64969,"MALINAU HULU, MALINAU KOTA, MALINAU, KALIMANTAN UTARA",12,92,27,119
https://kawalpemilu.org#64969,"MALINAU HULU, MALINAU KOTA, MALINAU, KALIMANTAN UTARA",13,82,24,1
https://kawalpemilu.org#64969,"MALINAU HULU, MALINAU KOTA, MALINAU, KALIMANTAN UTARA",14,125,25,150
https://kawalpemilu.org#64969,"MALINAU HULU, MALINAU KOTA, MALINAU, KALIMANTAN UTARA",15,81,22,103
https://kawalpemilu.org#64969,"MALINAU HULU, MALINAU KOTA, MALINAU, KALIMANTAN UTARA",16,64,40,104
https://kawalpemilu.org#64969,"MALINAU HULU, MALINAU KOTA, MALINAU, KALIMANTAN UTARA",18,95,26,121
https://kawalpemilu.org#64969,"MALINAU HULU, MALINAU KOTA, MALINAU, KALIMANTAN UTARA",19,100,43,143
https://kawalpemilu.org#64969,"MALINAU HULU, MALINAU KOTA, MALINAU, KALIMANTAN UTARA",20,124,40,164
https://kawalpemilu.org#64969,"MALINAU HULU, MALINAU KOTA, MALINAU, KALIMANTAN UTARA",21,120,81,201
https://kawalpemilu.org#64969,"MALINAU HULU, MALINAU KOTA, MALINAU, KALIMANTAN UTARA",22,103,52,155
https://kawalpemilu.org#64969,"MALINAU HULU, MALINAU KOTA, MALINAU, KALIMANTAN UTARA",23,93,80,173
https://kawalpemilu.org#64969,"MALINAU HULU, MALINAU KOTA, MALINAU, KALIMANTAN UTARA",24,87,29,116
https://kawalpemilu.org#64969,"MALINAU HULU, MALINAU KOTA, MALINAU, KALIMANTAN UTARA",25,85,46,131
https://kawalpemilu.org#64970,"MALINAU HILIR, MALINAU KOTA, MALINAU, KALIMANTAN UTARA",1,139,46,185
https://kawalpemilu.org#64970,"MALINAU HILIR, MALINAU KOTA, MALINAU, KALIMANTAN UTARA",2,73,32,105
https://kawalpemilu.org#64970,"MALINAU HILIR, MALINAU KOTA, MALINAU, KALIMANTAN UTARA",3,106,30,136
https://kawalpemilu.org#64970,"MALINAU HILIR, MALINAU KOTA, MALINAU, KALIMANTAN UTARA",4,129,51,180
https://kawalpemilu.org#64971,"TANJUNG KERANJANG, MALINAU KOTA, MALINAU, KALIMANTAN UTARA",1,166,6,172
https://kawalpemilu.org#64971,"TANJUNG KERANJANG, MALINAU KOTA, MALINAU, KALIMANTAN UTARA",2,149,9,158
https://kawalpemilu.org#64973,"LONG PUJUNGAN, PUJUNGAN, MALINAU, KALIMANTAN UTARA",1,123,15,138
https://kawalpemilu.org#64973,"LONG PUJUNGAN, PUJUNGAN, MALINAU, KALIMANTAN UTARA",2,73,34,107
https://kawalpemilu.org#64974,"LONG KETAMAN, PUJUNGAN, MALINAU, KALIMANTAN UTARA",1,73,4,77
https://kawalpemilu.org#64975,"LONG PUA, PUJUNGAN, MALINAU, KALIMANTAN UTARA",1,50,4,54
https://kawalpemilu.org#64976,"LONG JELET, PUJUNGAN, MALINAU, KALIMANTAN UTARA",1,53,0,53
https://kawalpemilu.org#64977,"LONG PALIRAN, PUJUNGAN, MALINAU, KALIMANTAN UTARA",1,52,10,62
https://kawalpemilu.org#64978,"LONG BENA, PUJUNGAN, MALINAU, KALIMANTAN UTARA",1,41,2,43
https://kawalpemilu.org#64979,"LONG ARAN, PUJUNGAN, MALINAU, KALIMANTAN UTARA",1,77,20,97
https://kawalpemilu.org#64979,"LONG ARAN, PUJUNGAN, MALINAU, KALIMANTAN UTARA",2,73,34,107
https://kawalpemilu.org#64980,"LONG LAME, PUJUNGAN, MALINAU, KALIMANTAN UTARA",1,117,2,119
https://kawalpemilu.org#64981,"LONG BELAKA PITAU, PUJUNGAN, MALINAU, KALIMANTAN UTARA",1,92,2,94
https://kawalpemilu.org#64983,"DATA DIAN, KAYAN HILIR, MALINAU, KALIMANTAN UTARA",1,0,0,0
https://kawalpemilu.org#64984,"LONG PIPA, KAYAN HILIR, MALINAU, KALIMANTAN UTARA",1,166,10,176
https://kawalpemilu.org#64985,"LONG METUN, KAYAN HILIR, MALINAU, KALIMANTAN UTARA",1,63,0,63
https://kawalpemilu.org#64986,"LONG SULE, KAYAN HILIR, MALINAU, KALIMANTAN UTARA",1,135,7,142
https://kawalpemilu.org#64986,"LONG SULE, KAYAN HILIR, MALINAU, KALIMANTAN UTARA",2,139,7,146
https://kawalpemilu.org#64989,"LONG NAWANG, KAYAN HULU, MALINAU, KALIMANTAN UTARA",1,266,19,285
https://kawalpemilu.org#64989,"LONG NAWANG, KAYAN HULU, MALINAU, KALIMANTAN UTARA",2,277,7,284
https://kawalpemilu.org#64989,"LONG NAWANG, KAYAN HULU, MALINAU, KALIMANTAN UTARA",3,273,9,282
https://kawalpemilu.org#64990,"NAWANG BARU, KAYAN HULU, MALINAU, KALIMANTAN UTARA",1,226,3,229
https://kawalpemilu.org#64990,"NAWANG BARU, KAYAN HULU, MALINAU, KALIMANTAN UTARA",2,287,2,289
https://kawalpemilu.org#64990,"NAWANG BARU, KAYAN HULU, MALINAU, KALIMANTAN UTARA",3,281,2,283
https://kawalpemilu.org#64991,"LONG TEMUNYAT, KAYAN HULU, MALINAU, KALIMANTAN UTARA",1,293,0,293
https://kawalpemilu.org#64991,"LONG TEMUNYAT, KAYAN HULU, MALINAU, KALIMANTAN UTARA",2,147,4,151
https://kawalpemilu.org#64991,"LONG TEMUNYAT, KAYAN HULU, MALINAU, KALIMANTAN UTARA",3,171,0,171
https://kawalpemilu.org#64992,"LONG BETAOH, KAYAN HULU, MALINAU, KALIMANTAN UTARA",1,143,0,143
https://kawalpemilu.org#64993,"LONG PAYAU, KAYAN HULU, MALINAU, KALIMANTAN UTARA",1,92,3,95
https://kawalpemilu.org#64997,"BILA BEKAYUK, MALINAU SELATAN, MALINAU, KALIMANTAN UTARA",1,129,7,136
https://kawalpemilu.org#65003,"LONG LOREH, MALINAU SELATAN, MALINAU, KALIMANTAN UTARA",1,245,17,262
https://kawalpemilu.org#65003,"LONG LOREH, MALINAU SELATAN, MALINAU, KALIMANTAN UTARA",2,222,40,262
https://kawalpemilu.org#65003,"LONG LOREH, MALINAU SELATAN, MALINAU, KALIMANTAN UTARA",3,230,26,256
https://kawalpemilu.org#65004,"LANGAP, MALINAU SELATAN, MALINAU, KALIMANTAN UTARA",1,236,36,272
https://kawalpemilu.org#65004,"LANGAP, MALINAU SELATAN, MALINAU, KALIMANTAN UTARA",2,242,34,276
https://kawalpemilu.org#65004,"LANGAP, MALINAU SELATAN, MALINAU, KALIMANTAN UTARA",3,202,48,250
https://kawalpemilu.org#65004,"LANGAP, MALINAU SELATAN, MALINAU, KALIMANTAN UTARA",4,112,25,137
https://kawalpemilu.org#65004,"LANGAP, MALINAU SELATAN, MALINAU, KALIMANTAN UTARA",5,144,34,178
https://kawalpemilu.org#65004,"LANGAP, MALINAU SELATAN, MALINAU, KALIMANTAN UTARA",6,163,56,219
https://kawalpemilu.org#65006,"LABAN NYARIT, MALINAU SELATAN, MALINAU, KALIMANTAN UTARA",1,163,11,174
https://kawalpemilu.org#65009,"NUNUK TANAH KIBANG, MALINAU SELATAN, MALINAU, KALIMANTAN UTARA",1,66,2,68
https://kawalpemilu.org#65010,"PELENCAU, MALINAU SELATAN, MALINAU, KALIMANTAN UTARA",1,118,19,137
https://kawalpemilu.org#65011,"PAYA SETURAN, MALINAU SELATAN, MALINAU, KALIMANTAN UTARA",1,184,21,205
https://kawalpemilu.org#65013,"PUNAN RIAN, MALINAU SELATAN, MALINAU, KALIMANTAN UTARA",1,59,3,62
https://kawalpemilu.org#65014,"SENGAYAN, MALINAU SELATAN, MALINAU, KALIMANTAN UTARA",1,128,39,167
https://kawalpemilu.org#65014,"SENGAYAN, MALINAU SELATAN, MALINAU, KALIMANTAN UTARA",2,97,27,124
https://kawalpemilu.org#65020,"KALIAMOK, MALINAU UTARA, MALINAU, KALIMANTAN UTARA",1,121,19,140
https://kawalpemilu.org#65020,"KALIAMOK, MALINAU UTARA, MALINAU, KALIMANTAN UTARA",2,133,8,141
https://kawalpemilu.org#65020,"KALIAMOK, MALINAU UTARA, MALINAU, KALIMANTAN UTARA",3,191,5,196
https://kawalpemilu.org#65020,"KALIAMOK, MALINAU UTARA, MALINAU, KALIMANTAN UTARA",4,190,14,204
https://kawalpemilu.org#65021,"LUSO, MALINAU UTARA, MALINAU, KALIMANTAN UTARA",1,133,4,137
https://kawalpemilu.org#65021,"LUSO, MALINAU UTARA, MALINAU, KALIMANTAN UTARA",2,124,3,127
https://kawalpemilu.org#65022,"MALINAU SEBERANG, MALINAU UTARA, MALINAU, KALIMANTAN UTARA",1,90,115,205
https://kawalpemilu.org#65022,"MALINAU SEBERANG, MALINAU UTARA, MALINAU, KALIMANTAN UTARA",2,56,73,129
https://kawalpemilu.org#65022,"MALINAU SEBERANG, MALINAU UTARA, MALINAU, KALIMANTAN UTARA",3,45,49,94
https://kawalpemilu.org#65022,"MALINAU SEBERANG, MALINAU UTARA, MALINAU, KALIMANTAN UTARA",4,64,81,145
https://kawalpemilu.org#65022,"MALINAU SEBERANG, MALINAU UTARA, MALINAU, KALIMANTAN UTARA",5,35,79,114
https://kawalpemilu.org#65022,"MALINAU SEBERANG, MALINAU UTARA, MALINAU, KALIMANTAN UTARA",6,42,78,120
https://kawalpemilu.org#65022,"MALINAU SEBERANG, MALINAU UTARA, MALINAU, KALIMANTAN UTARA",7,130,100,230
https://kawalpemilu.org#65022,"MALINAU SEBERANG, MALINAU UTARA, MALINAU, KALIMANTAN UTARA",8,111,92,203
https://kawalpemilu.org#65022,"MALINAU SEBERANG, MALINAU UTARA, MALINAU, KALIMANTAN UTARA",9,74,73,147
https://kawalpemilu.org#65022,"MALINAU SEBERANG, MALINAU UTARA, MALINAU, KALIMANTAN UTARA",10,115,116,231
https://kawalpemilu.org#65022,"MALINAU SEBERANG, MALINAU UTARA, MALINAU, KALIMANTAN UTARA",11,104,88,192
https://kawalpemilu.org#65022,"MALINAU SEBERANG, MALINAU UTARA, MALINAU, KALIMANTAN UTARA",12,137,96,233
https://kawalpemilu.org#65023,"PUTAT, MALINAU UTARA, MALINAU, KALIMANTAN UTARA",1,96,0,96
https://kawalpemilu.org#65023,"PUTAT, MALINAU UTARA, MALINAU, KALIMANTAN UTARA",2,185,13,198
https://kawalpemilu.org#65024,"SALAP, MALINAU UTARA, MALINAU, KALIMANTAN UTARA",1,68,2,70
https://kawalpemilu.org#65024,"SALAP, MALINAU UTARA, MALINAU, KALIMANTAN UTARA",2,120,12,132
https://kawalpemilu.org#65025,"SERUYUNG, MALINAU UTARA, MALINAU, KALIMANTAN UTARA",1,158,8,166
https://kawalpemilu.org#65026,"RESPEN TUBU, MALINAU UTARA, MALINAU, KALIMANTAN UTARA",1,110,35,145
https://kawalpemilu.org#65026,"RESPEN TUBU, MALINAU UTARA, MALINAU, KALIMANTAN UTARA",2,128,6,134
https://kawalpemilu.org#65026,"RESPEN TUBU, MALINAU UTARA, MALINAU, KALIMANTAN UTARA",3,181,11,192
https://kawalpemilu.org#65026,"RESPEN TUBU, MALINAU UTARA, MALINAU, KALIMANTAN UTARA",4,187,2,189
https://kawalpemilu.org#65026,"RESPEN TUBU, MALINAU UTARA, MALINAU, KALIMANTAN UTARA",5,169,15,184
https://kawalpemilu.org#65026,"RESPEN TUBU, MALINAU UTARA, MALINAU, KALIMANTAN UTARA",6,80,13,93
https://kawalpemilu.org#65026,"RESPEN TUBU, MALINAU UTARA, MALINAU, KALIMANTAN UTARA",7,137,23,160
https://kawalpemilu.org#65026,"RESPEN TUBU, MALINAU UTARA, MALINAU, KALIMANTAN UTARA",8,198,10,208
https://kawalpemilu.org#65027,"BELAYAN, MALINAU UTARA, MALINAU, KALIMANTAN UTARA",1,191,15,206
https://kawalpemilu.org#65027,"BELAYAN, MALINAU UTARA, MALINAU, KALIMANTAN UTARA",2,89,20,109
https://kawalpemilu.org#65027,"BELAYAN, MALINAU UTARA, MALINAU, KALIMANTAN UTARA",3,53,132,185
https://kawalpemilu.org#65027,"BELAYAN, MALINAU UTARA, MALINAU, KALIMANTAN UTARA",4,136,53,136
https://kawalpemilu.org#65028,"SEMBUAK WAROD, MALINAU UTARA, MALINAU, KALIMANTAN UTARA",1,112,8,120
https://kawalpemilu.org#65028,"SEMBUAK WAROD, MALINAU UTARA, MALINAU, KALIMANTAN UTARA",2,0,0,0
https://kawalpemilu.org#65029,"LUBAK MANIS, MALINAU UTARA, MALINAU, KALIMANTAN UTARA",1,141,12,153
https://kawalpemilu.org#65029,"LUBAK MANIS, MALINAU UTARA, MALINAU, KALIMANTAN UTARA",2,151,29,180
https://kawalpemilu.org#65030,"KELAPIS, MALINAU UTARA, MALINAU, KALIMANTAN UTARA",1,220,7,227
https://kawalpemilu.org#65030,"KELAPIS, MALINAU UTARA, MALINAU, KALIMANTAN UTARA",2,231,11,242
https://kawalpemilu.org#65031,"SEMENGARIS, MALINAU UTARA, MALINAU, KALIMANTAN UTARA",1,181,17,198
https://kawalpemilu.org#65033,"LONG BILA, MALINAU BARAT, MALINAU, KALIMANTAN UTARA",1,116,2,118
https://kawalpemilu.org#65034,"LONG KENIPE, MALINAU BARAT, MALINAU, KALIMANTAN UTARA",1,105,15,120
https://kawalpemilu.org#65035,"PUNAN BENGALUN, MALINAU BARAT, MALINAU, KALIMANTAN UTARA",1,140,4,144
https://kawalpemilu.org#65036,"SESUA, MALINAU BARAT, MALINAU, KALIMANTAN UTARA",1,166,3,169
https://kawalpemilu.org#65036,"SESUA, MALINAU BARAT, MALINAU, KALIMANTAN UTARA",2,188,8,196
https://kawalpemilu.org#65036,"SESUA, MALINAU BARAT, MALINAU, KALIMANTAN UTARA",3,194,10,204
https://kawalpemilu.org#65036,"SESUA, MALINAU BARAT, MALINAU, KALIMANTAN UTARA",4,177,9,186
https://kawalpemilu.org#65037,"SENTABAN, MALINAU BARAT, MALINAU, KALIMANTAN UTARA",1,156,22,178
https://kawalpemilu.org#65038,"TANJUNG LAPANG, MALINAU BARAT, MALINAU, KALIMANTAN UTARA",1,168,17,185
https://kawalpemilu.org#65038,"TANJUNG LAPANG, MALINAU BARAT, MALINAU, KALIMANTAN UTARA",2,147,19,166
https://kawalpemilu.org#65038,"TANJUNG LAPANG, MALINAU BARAT, MALINAU, KALIMANTAN UTARA",3,189,6,195
https://kawalpemilu.org#65038,"TANJUNG LAPANG, MALINAU BARAT, MALINAU, KALIMANTAN UTARA",4,117,4,121
https://kawalpemilu.org#65038,"TANJUNG LAPANG, MALINAU BARAT, MALINAU, KALIMANTAN UTARA",5,128,9,137
https://kawalpemilu.org#65038,"TANJUNG LAPANG, MALINAU BARAT, MALINAU, KALIMANTAN UTARA",6,104,15,119
https://kawalpemilu.org#65038,"TANJUNG LAPANG, MALINAU BARAT, MALINAU, KALIMANTAN UTARA",7,148,19,167
https://kawalpemilu.org#65038,"TANJUNG LAPANG, MALINAU BARAT, MALINAU, KALIMANTAN UTARA",8,139,11,150
https://kawalpemilu.org#65038,"TANJUNG LAPANG, MALINAU BARAT, MALINAU, KALIMANTAN UTARA",9,206,2,208
https://kawalpemilu.org#65038,"TANJUNG LAPANG, MALINAU BARAT, MALINAU, KALIMANTAN UTARA",10,160,19,179
https://kawalpemilu.org#65038,"TANJUNG LAPANG, MALINAU BARAT, MALINAU, KALIMANTAN UTARA",11,148,3,151
https://kawalpemilu.org#65038,"TANJUNG LAPANG, MALINAU BARAT, MALINAU, KALIMANTAN UTARA",12,140,15,155
https://kawalpemilu.org#65038,"TANJUNG LAPANG, MALINAU BARAT, MALINAU, KALIMANTAN UTARA",13,73,14,87
https://kawalpemilu.org#65038,"TANJUNG LAPANG, MALINAU BARAT, MALINAU, KALIMANTAN UTARA",14,123,29,152
https://kawalpemilu.org#65038,"TANJUNG LAPANG, MALINAU BARAT, MALINAU, KALIMANTAN UTARA",16,150,29,179
https://kawalpemilu.org#65039,"TARAS, MALINAU BARAT, MALINAU, KALIMANTAN UTARA",1,172,1,173
https://kawalpemilu.org#65040,"KUALA LAPANG, MALINAU BARAT, MALINAU, KALIMANTAN UTARA",1,204,25,229
https://kawalpemilu.org#65040,"KUALA LAPANG, MALINAU BARAT, MALINAU, KALIMANTAN UTARA",2,137,5,142
https://kawalpemilu.org#65040,"KUALA LAPANG, MALINAU BARAT, MALINAU, KALIMANTAN UTARA",3,180,8,188
https://kawalpemilu.org#65040,"KUALA LAPANG, MALINAU BARAT, MALINAU, KALIMANTAN UTARA",4,216,6,222
https://kawalpemilu.org#65040,"KUALA LAPANG, MALINAU BARAT, MALINAU, KALIMANTAN UTARA",5,154,5,159
https://kawalpemilu.org#65040,"KUALA LAPANG, MALINAU BARAT, MALINAU, KALIMANTAN UTARA",6,181,17,198
https://kawalpemilu.org#65040,"KUALA LAPANG, MALINAU BARAT, MALINAU, KALIMANTAN UTARA",7,134,8,142
https://kawalpemilu.org#65040,"KUALA LAPANG, MALINAU BARAT, MALINAU, KALIMANTAN UTARA",8,148,11,159
https://kawalpemilu.org#65041,"SEMPAYANG, MALINAU BARAT, MALINAU, KALIMANTAN UTARA",1,176,16,192
https://kawalpemilu.org#65041,"SEMPAYANG, MALINAU BARAT, MALINAU, KALIMANTAN UTARA",2,177,1,4
https://kawalpemilu.org#65043,"DUMU MAHAK, SUNGAI BOH, MALINAU, KALIMANTAN UTARA",1,98,7,105
https://kawalpemilu.org#65043,"DUMU MAHAK, SUNGAI BOH, MALINAU, KALIMANTAN UTARA",2,125,2,127
https://kawalpemilu.org#65044,"LONG LEBUSAN, SUNGAI BOH, MALINAU, KALIMANTAN UTARA",1,222,2,224
https://kawalpemilu.org#65044,"LONG LEBUSAN, SUNGAI BOH, MALINAU, KALIMANTAN UTARA",2,191,1,192
https://kawalpemilu.org#65045,"MAHAK BARU, SUNGAI BOH, MALINAU, KALIMANTAN UTARA",1,200,3,203
https://kawalpemilu.org#65045,"MAHAK BARU, SUNGAI BOH, MALINAU, KALIMANTAN UTARA",2,188,5,193
https://kawalpemilu.org#65046,"AGUNG BARU, SUNGAI BOH, MALINAU, KALIMANTAN UTARA",1,193,3,196
https://kawalpemilu.org#65047,"DATA BARU, SUNGAI BOH, MALINAU, KALIMANTAN UTARA",1,115,1,116
https://kawalpemilu.org#85488,"LONG TOP, SUNGAI BOH, MALINAU, KALIMANTAN UTARA",1,35,1,36
https://kawalpemilu.org#65049,"LONG AMPUNG, KAYAN SELATAN, MALINAU, KALIMANTAN UTARA",1,138,6,144
https://kawalpemilu.org#65049,"LONG AMPUNG, KAYAN SELATAN, MALINAU, KALIMANTAN UTARA",2,156,1,157
https://kawalpemilu.org#65050,"METULANG, KAYAN SELATAN, MALINAU, KALIMANTAN UTARA",1,140,4,144
https://kawalpemilu.org#65051,"LIDUNG PAYAU, KAYAN SELATAN, MALINAU, KALIMANTAN UTARA",1,112,19,131
https://kawalpemilu.org#65051,"LIDUNG PAYAU, KAYAN SELATAN, MALINAU, KALIMANTAN UTARA",2,164,65,229
https://kawalpemilu.org#65052,"LONG URO, KAYAN SELATAN, MALINAU, KALIMANTAN UTARA",1,121,0,121
https://kawalpemilu.org#65053,"SUNGAI BARANG, KAYAN SELATAN, MALINAU, KALIMANTAN UTARA",1,162,1,163
https://kawalpemilu.org#65055,"LONG ALANGO, BAHAU HULU, MALINAU, KALIMANTAN UTARA",1,107,3,110
https://kawalpemilu.org#65055,"LONG ALANGO, BAHAU HULU, MALINAU, KALIMANTAN UTARA",2,169,1,170
https://kawalpemilu.org#65056,"LONG TEBULO, BAHAU HULU, MALINAU, KALIMANTAN UTARA",1,62,1,63
https://kawalpemilu.org#65057,"LONG ULI, BAHAU HULU, MALINAU, KALIMANTAN UTARA",1,108,9,117
https://kawalpemilu.org#65058,"LONG KEMUAT, BAHAU HULU, MALINAU, KALIMANTAN UTARA",1,103,0,103
https://kawalpemilu.org#65059,"LONG BERINI, BAHAU HULU, MALINAU, KALIMANTAN UTARA",1,96,3,99
https://kawalpemilu.org#65060,"APAU PING, BAHAU HULU, MALINAU, KALIMANTAN UTARA",1,161,10,171
https://kawalpemilu.org#65062,"LUNG BARANG, MENTARANG HULU, MALINAU, KALIMANTAN UTARA",1,150,12,162
https://kawalpemilu.org#65062,"LUNG BARANG, MENTARANG HULU, MALINAU, KALIMANTAN UTARA",2,28,0,28
https://kawalpemilu.org#65062,"LUNG BARANG, MENTARANG HULU, MALINAU, KALIMANTAN UTARA",3,19,2,21
https://kawalpemilu.org#65062,"LUNG BARANG, MENTARANG HULU, MALINAU, KALIMANTAN UTARA",4,30,0,30
https://kawalpemilu.org#65063,"LUNG PALA, MENTARANG HULU, MALINAU, KALIMANTAN UTARA",1,34,0,34
https://kawalpemilu.org#65064,"LUNG KEBINU, MENTARANG HULU, MALINAU, KALIMANTAN UTARA",1,57,0,57
https://kawalpemilu.org#65065,"LUNG MEKATIP, MENTARANG HULU, MALINAU, KALIMANTAN UTARA",1,39,0,39
https://kawalpemilu.org#65066,"LUNG SEMAMU, MENTARANG HULU, MALINAU, KALIMANTAN UTARA",1,39,2,41
https://kawalpemilu.org#65067,"LUNG SULIT, MENTARANG HULU, MALINAU, KALIMANTAN UTARA",1,48,0,48
https://kawalpemilu.org#65068,"LUNG SIMAU, MENTARANG HULU, MALINAU, KALIMANTAN UTARA",1,62,0,62
https://kawalpemilu.org#64995,"LONG ADIU, MALINAU SELATAN HILIR, MALINAU, KALIMANTAN UTARA",1,79,7,86
https://kawalpemilu.org#64996,"PUNAN LONG ADIU, MALINAU SELATAN HILIR, MALINAU, KALIMANTAN UTARA",1,63,0,63
https://kawalpemilu.org#64998,"BATU KAJANG, MALINAU SELATAN HILIR, MALINAU, KALIMANTAN UTARA",1,175,2,177
https://kawalpemilu.org#64998,"BATU KAJANG, MALINAU SELATAN HILIR, MALINAU, KALIMANTAN UTARA",2,78,6,84
https://kawalpemilu.org#64999,"GONG SOLOK, MALINAU SELATAN HILIR, MALINAU, KALIMANTAN UTARA",1,164,10,174
https://kawalpemilu.org#65000,"PUNAN GONG SOLOK, MALINAU SELATAN HILIR, MALINAU, KALIMANTAN UTARA",1,110,11,121
https://kawalpemilu.org#65000,"PUNAN GONG SOLOK, MALINAU SELATAN HILIR, MALINAU, KALIMANTAN UTARA",2,127,12,139
https://kawalpemilu.org#65015,"SETARAP, MALINAU SELATAN HILIR, MALINAU, KALIMANTAN UTARA",1,133,44,177
https://kawalpemilu.org#65016,"PUNAN SETARAP, MALINAU SELATAN HILIR, MALINAU, KALIMANTAN UTARA",1,105,6,111
https://kawalpemilu.org#65017,"SETULANG, MALINAU SELATAN HILIR, MALINAU, KALIMANTAN UTARA",1,176,10,186
https://kawalpemilu.org#65017,"SETULANG, MALINAU SELATAN HILIR, MALINAU, KALIMANTAN UTARA",2,163,8,171
https://kawalpemilu.org#65017,"SETULANG, MALINAU SELATAN HILIR, MALINAU, KALIMANTAN UTARA",3,172,11,183
https://kawalpemilu.org#65001,"HALANGA, MALINAU SELATAN HULU, MALINAU, KALIMANTAN UTARA",1,102,36,138
https://kawalpemilu.org#65002,"LONG JALAN, MALINAU SELATAN HULU, MALINAU, KALIMANTAN UTARA",1,93,14,107
https://kawalpemilu.org#65005,"LONG LAKE, MALINAU SELATAN HULU, MALINAU, KALIMANTAN UTARA",1,106,3,109
https://kawalpemilu.org#65005,"LONG LAKE, MALINAU SELATAN HULU, MALINAU, KALIMANTAN UTARA",2,45,0,45
https://kawalpemilu.org#65005,"LONG LAKE, MALINAU SELATAN HULU, MALINAU, KALIMANTAN UTARA",3,48,3,51
https://kawalpemilu.org#65007,"PUNAN MIRAU, MALINAU SELATAN HULU, MALINAU, KALIMANTAN UTARA",1,80,2,82
https://kawalpemilu.org#65008,"METUT, MALINAU SELATAN HULU, MALINAU, KALIMANTAN UTARA",1,191,4,195
https://kawalpemilu.org#65012,"LONG RAT, MALINAU SELATAN HULU, MALINAU, KALIMANTAN UTARA",1,67,8,75
https://kawalpemilu.org#85491,"TANJUNGNANGA, MALINAU SELATAN HULU, MALINAU, KALIMANTAN UTARA",1,197,22,219
https://kawalpemilu.org#85491,"TANJUNGNANGA, MALINAU SELATAN HULU, MALINAU, KALIMANTAN UTARA",2,207,23,230
https://kawalpemilu.org#89146,"NAHAKRAMO, MALINAU SELATAN HULU, MALINAU, KALIMANTAN UTARA",1,94,1,95
https://kawalpemilu.org#64957,"LONG NYAU, SUNGAI TUBU, MALINAU, KALIMANTAN UTARA",1,68,0,68
https://kawalpemilu.org#64958,"LONG TITI, SUNGAI TUBU, MALINAU, KALIMANTAN UTARA",1,91,1,92
https://kawalpemilu.org#64959,"RIAN TUBU, SUNGAI TUBU, MALINAU, KALIMANTAN UTARA",1,72,1,73
https://kawalpemilu.org#64959,"RIAN TUBU, SUNGAI TUBU, MALINAU, KALIMANTAN UTARA",2,27,1,28
https://kawalpemilu.org#64961,"LONG PADA, SUNGAI TUBU, MALINAU, KALIMANTAN UTARA",1,118,1,119
https://kawalpemilu.org#89149,"LONG RANAU, SUNGAI TUBU, MALINAU, KALIMANTAN UTARA",1,93,0,93
https://kawalpemilu.org#65633,"KARANG ANYAR, TARAKAN BARAT, KOTA TARAKAN, KALIMANTAN UTARA",1,107,98,205
https://kawalpemilu.org#65633,"KARANG ANYAR, TARAKAN BARAT, KOTA TARAKAN, KALIMANTAN UTARA",2,93,63,156
https://kawalpemilu.org#65633,"KARANG ANYAR, TARAKAN BARAT, KOTA TARAKAN, KALIMANTAN UTARA",3,133,25,158
https://kawalpemilu.org#65633,"KARANG ANYAR, TARAKAN BARAT, KOTA TARAKAN, KALIMANTAN UTARA",4,134,46,180
https://kawalpemilu.org#65633,"KARANG ANYAR, TARAKAN BARAT, KOTA TARAKAN, KALIMANTAN UTARA",5,116,67,183
https://kawalpemilu.org#65633,"KARANG ANYAR, TARAKAN BARAT, KOTA TARAKAN, KALIMANTAN UTARA",6,89,46,135
https://kawalpemilu.org#65633,"KARANG ANYAR, TARAKAN BARAT, KOTA TARAKAN, KALIMANTAN UTARA",7,80,42,122
https://kawalpemilu.org#65633,"KARANG ANYAR, TARAKAN BARAT, KOTA TARAKAN, KALIMANTAN UTARA",8,106,83,189
https://kawalpemilu.org#65633,"KARANG ANYAR, TARAKAN BARAT, KOTA TARAKAN, KALIMANTAN UTARA",9,102,43,145
https://kawalpemilu.org#65633,"KARANG ANYAR, TARAKAN BARAT, KOTA TARAKAN, KALIMANTAN UTARA",10,158,53,211
https://kawalpemilu.org#65633,"KARANG ANYAR, TARAKAN BARAT, KOTA TARAKAN, KALIMANTAN UTARA",11,108,32,140
https://kawalpemilu.org#65633,"KARANG ANYAR, TARAKAN BARAT, KOTA TARAKAN, KALIMANTAN UTARA",12,177,37,214
https://kawalpemilu.org#65633,"KARANG ANYAR, TARAKAN BARAT, KOTA TARAKAN, KALIMANTAN UTARA",13,189,51,240
https://kawalpemilu.org#65633,"KARANG ANYAR, TARAKAN BARAT, KOTA TARAKAN, KALIMANTAN UTARA",14,141,3,144
https://kawalpemilu.org#65633,"KARANG ANYAR, TARAKAN BARAT, KOTA TARAKAN, KALIMANTAN UTARA",15,160,23,183
https://kawalpemilu.org#65633,"KARANG ANYAR, TARAKAN BARAT, KOTA TARAKAN, KALIMANTAN UTARA",16,179,48,227
https://kawalpemilu.org#65633,"KARANG ANYAR, TARAKAN BARAT, KOTA TARAKAN, KALIMANTAN UTARA",17,0,0,0
https://kawalpemilu.org#65633,"KARANG ANYAR, TARAKAN BARAT, KOTA TARAKAN, KALIMANTAN UTARA",18,67,29,96
https://kawalpemilu.org#65633,"KARANG ANYAR, TARAKAN BARAT, KOTA TARAKAN, KALIMANTAN UTARA",19,150,7,157
https://kawalpemilu.org#65633,"KARANG ANYAR, TARAKAN BARAT, KOTA TARAKAN, KALIMANTAN UTARA",20,130,40,170
https://kawalpemilu.org#65633,"KARANG ANYAR, TARAKAN BARAT, KOTA TARAKAN, KALIMANTAN UTARA",21,129,51,180
https://kawalpemilu.org#65633,"KARANG ANYAR, TARAKAN BARAT, KOTA TARAKAN, KALIMANTAN UTARA",22,131,40,171
https://kawalpemilu.org#65633,"KARANG ANYAR, TARAKAN BARAT, KOTA TARAKAN, KALIMANTAN UTARA",23,152,59,211
https://kawalpemilu.org#65633,"KARANG ANYAR, TARAKAN BARAT, KOTA TARAKAN, KALIMANTAN UTARA",25,141,80,221
https://kawalpemilu.org#65633,"KARANG ANYAR, TARAKAN BARAT, KOTA TARAKAN, KALIMANTAN UTARA",26,135,45,180
https://kawalpemilu.org#65633,"KARANG ANYAR, TARAKAN BARAT, KOTA TARAKAN, KALIMANTAN UTARA",27,116,5,121
https://kawalpemilu.org#65633,"KARANG ANYAR, TARAKAN BARAT, KOTA TARAKAN, KALIMANTAN UTARA",28,153,50,203
https://kawalpemilu.org#65633,"KARANG ANYAR, TARAKAN BARAT, KOTA TARAKAN, KALIMANTAN UTARA",29,143,50,193
https://kawalpemilu.org#65633,"KARANG ANYAR, TARAKAN BARAT, KOTA TARAKAN, KALIMANTAN UTARA",30,124,123,247
https://kawalpemilu.org#65633,"KARANG ANYAR, TARAKAN BARAT, KOTA TARAKAN, KALIMANTAN UTARA",31,149,95,244
https://kawalpemilu.org#65633,"KARANG ANYAR, TARAKAN BARAT, KOTA TARAKAN, KALIMANTAN UTARA",32,133,69,202
https://kawalpemilu.org#65633,"KARANG ANYAR, TARAKAN BARAT, KOTA TARAKAN, KALIMANTAN UTARA",33,0,0,0
https://kawalpemilu.org#65633,"KARANG ANYAR, TARAKAN BARAT, KOTA TARAKAN, KALIMANTAN UTARA",34,125,46,171
https://kawalpemilu.org#65633,"KARANG ANYAR, TARAKAN BARAT, KOTA TARAKAN, KALIMANTAN UTARA",35,156,51,207
https://kawalpemilu.org#65633,"KARANG ANYAR, TARAKAN BARAT, KOTA TARAKAN, KALIMANTAN UTARA",36,118,81,199
https://kawalpemilu.org#65633,"KARANG ANYAR, TARAKAN BARAT, KOTA TARAKAN, KALIMANTAN UTARA",37,48,41,89
https://kawalpemilu.org#65633,"KARANG ANYAR, TARAKAN BARAT, KOTA TARAKAN, KALIMANTAN UTARA",38,128,83,211
https://kawalpemilu.org#65633,"KARANG ANYAR, TARAKAN BARAT, KOTA TARAKAN, KALIMANTAN UTARA",39,84,62,146
https://kawalpemilu.org#65633,"KARANG ANYAR, TARAKAN BARAT, KOTA TARAKAN, KALIMANTAN UTARA",40,135,74,209
https://kawalpemilu.org#65633,"KARANG ANYAR, TARAKAN BARAT, KOTA TARAKAN, KALIMANTAN UTARA",41,130,96,226
https://kawalpemilu.org#65633,"KARANG ANYAR, TARAKAN BARAT, KOTA TARAKAN, KALIMANTAN UTARA",42,66,49,115
https://kawalpemilu.org#65633,"KARANG ANYAR, TARAKAN BARAT, KOTA TARAKAN, KALIMANTAN UTARA",43,100,62,162
https://kawalpemilu.org#65633,"KARANG ANYAR, TARAKAN BARAT, KOTA TARAKAN, KALIMANTAN UTARA",44,184,84,268
https://kawalpemilu.org#65633,"KARANG ANYAR, TARAKAN BARAT, KOTA TARAKAN, KALIMANTAN UTARA",45,116,35,151
https://kawalpemilu.org#65633,"KARANG ANYAR, TARAKAN BARAT, KOTA TARAKAN, KALIMANTAN UTARA",46,107,49,156
https://kawalpemilu.org#65633,"KARANG ANYAR, TARAKAN BARAT, KOTA TARAKAN, KALIMANTAN UTARA",47,181,142,323
https://kawalpemilu.org#65633,"KARANG ANYAR, TARAKAN BARAT, KOTA TARAKAN, KALIMANTAN UTARA",48,182,117,299
https://kawalpemilu.org#65633,"KARANG ANYAR, TARAKAN BARAT, KOTA TARAKAN, KALIMANTAN UTARA",49,84,105,189
https://kawalpemilu.org#65633,"KARANG ANYAR, TARAKAN BARAT, KOTA TARAKAN, KALIMANTAN UTARA",50,102,81,183
https://kawalpemilu.org#65633,"KARANG ANYAR, TARAKAN BARAT, KOTA TARAKAN, KALIMANTAN UTARA",51,62,36,98
https://kawalpemilu.org#65633,"KARANG ANYAR, TARAKAN BARAT, KOTA TARAKAN, KALIMANTAN UTARA",52,108,23,131
https://kawalpemilu.org#65633,"KARANG ANYAR, TARAKAN BARAT, KOTA TARAKAN, KALIMANTAN UTARA",53,150,93,243
https://kawalpemilu.org#65633,"KARANG ANYAR, TARAKAN BARAT, KOTA TARAKAN, KALIMANTAN UTARA",54,146,63,209
https://kawalpemilu.org#65633,"KARANG ANYAR, TARAKAN BARAT, KOTA TARAKAN, KALIMANTAN UTARA",55,191,55,246
https://kawalpemilu.org#65633,"KARANG ANYAR, TARAKAN BARAT, KOTA TARAKAN, KALIMANTAN UTARA",56,182,49,231
https://kawalpemilu.org#65633,"KARANG ANYAR, TARAKAN BARAT, KOTA TARAKAN, KALIMANTAN UTARA",57,174,22,196
https://kawalpemilu.org#65633,"KARANG ANYAR, TARAKAN BARAT, KOTA TARAKAN, KALIMANTAN UTARA",58,176,16,192
https://kawalpemilu.org#65633,"KARANG ANYAR, TARAKAN BARAT, KOTA TARAKAN, KALIMANTAN UTARA",59,97,38,135
https://kawalpemilu.org#65633,"KARANG ANYAR, TARAKAN BARAT, KOTA TARAKAN, KALIMANTAN UTARA",60,96,43,139
https://kawalpemilu.org#65633,"KARANG ANYAR, TARAKAN BARAT, KOTA TARAKAN, KALIMANTAN UTARA",61,152,106,258
https://kawalpemilu.org#65633,"KARANG ANYAR, TARAKAN BARAT, KOTA TARAKAN, KALIMANTAN UTARA",62,147,90,237
https://kawalpemilu.org#65633,"KARANG ANYAR, TARAKAN BARAT, KOTA TARAKAN, KALIMANTAN UTARA",63,108,87,195
https://kawalpemilu.org#65633,"KARANG ANYAR, TARAKAN BARAT, KOTA TARAKAN, KALIMANTAN UTARA",64,79,83,162
https://kawalpemilu.org#65633,"KARANG ANYAR, TARAKAN BARAT, KOTA TARAKAN, KALIMANTAN UTARA",65,69,87,156
https://kawalpemilu.org#65633,"KARANG ANYAR, TARAKAN BARAT, KOTA TARAKAN, KALIMANTAN UTARA",66,137,107,7
https://kawalpemilu.org#65633,"KARANG ANYAR, TARAKAN BARAT, KOTA TARAKAN, KALIMANTAN UTARA",67,144,84,228
https://kawalpemilu.org#65633,"KARANG ANYAR, TARAKAN BARAT, KOTA TARAKAN, KALIMANTAN UTARA",68,149,55,204
https://kawalpemilu.org#65633,"KARANG ANYAR, TARAKAN BARAT, KOTA TARAKAN, KALIMANTAN UTARA",69,114,34,148
https://kawalpemilu.org#65633,"KARANG ANYAR, TARAKAN BARAT, KOTA TARAKAN, KALIMANTAN UTARA",70,172,8,180
https://kawalpemilu.org#65633,"KARANG ANYAR, TARAKAN BARAT, KOTA TARAKAN, KALIMANTAN UTARA",71,92,50,142
https://kawalpemilu.org#65633,"KARANG ANYAR, TARAKAN BARAT, KOTA TARAKAN, KALIMANTAN UTARA",72,91,57,148
https://kawalpemilu.org#65633,"KARANG ANYAR, TARAKAN BARAT, KOTA TARAKAN, KALIMANTAN UTARA",73,157,8,163
https://kawalpemilu.org#65633,"KARANG ANYAR, TARAKAN BARAT, KOTA TARAKAN, KALIMANTAN UTARA",74,164,8,172
https://kawalpemilu.org#65633,"KARANG ANYAR, TARAKAN BARAT, KOTA TARAKAN, KALIMANTAN UTARA",75,184,13,187
https://kawalpemilu.org#65633,"KARANG ANYAR, TARAKAN BARAT, KOTA TARAKAN, KALIMANTAN UTARA",76,177,13,190
https://kawalpemilu.org#65633,"KARANG ANYAR, TARAKAN BARAT, KOTA TARAKAN, KALIMANTAN UTARA",77,178,22,200
https://kawalpemilu.org#65633,"KARANG ANYAR, TARAKAN BARAT, KOTA TARAKAN, KALIMANTAN UTARA",78,166,23,189
https://kawalpemilu.org#65633,"KARANG ANYAR, TARAKAN BARAT, KOTA TARAKAN, KALIMANTAN UTARA",79,89,67,156
https://kawalpemilu.org#65633,"KARANG ANYAR, TARAKAN BARAT, KOTA TARAKAN, KALIMANTAN UTARA",80,119,31,150
https://kawalpemilu.org#65633,"KARANG ANYAR, TARAKAN BARAT, KOTA TARAKAN, KALIMANTAN UTARA",81,76,78,154
https://kawalpemilu.org#65633,"KARANG ANYAR, TARAKAN BARAT, KOTA TARAKAN, KALIMANTAN UTARA",82,118,76,194
https://kawalpemilu.org#65633,"KARANG ANYAR, TARAKAN BARAT, KOTA TARAKAN, KALIMANTAN UTARA",83,87,61,148
https://kawalpemilu.org#65633,"KARANG ANYAR, TARAKAN BARAT, KOTA TARAKAN, KALIMANTAN UTARA",84,0,0,0
https://kawalpemilu.org#65633,"KARANG ANYAR, TARAKAN BARAT, KOTA TARAKAN, KALIMANTAN UTARA",85,124,79,203
https://kawalpemilu.org#65633,"KARANG ANYAR, TARAKAN BARAT, KOTA TARAKAN, KALIMANTAN UTARA",86,101,52,153
https://kawalpemilu.org#65633,"KARANG ANYAR, TARAKAN BARAT, KOTA TARAKAN, KALIMANTAN UTARA",87,167,70,237
https://kawalpemilu.org#65633,"KARANG ANYAR, TARAKAN BARAT, KOTA TARAKAN, KALIMANTAN UTARA",88,140,64,204
https://kawalpemilu.org#65633,"KARANG ANYAR, TARAKAN BARAT, KOTA TARAKAN, KALIMANTAN UTARA",89,109,13,122
https://kawalpemilu.org#65634,"KARANG REJO, TARAKAN BARAT, KOTA TARAKAN, KALIMANTAN UTARA",1,131,105,236
https://kawalpemilu.org#65634,"KARANG REJO, TARAKAN BARAT, KOTA TARAKAN, KALIMANTAN UTARA",2,81,91,172
https://kawalpemilu.org#65634,"KARANG REJO, TARAKAN BARAT, KOTA TARAKAN, KALIMANTAN UTARA",3,104,96,200
https://kawalpemilu.org#65634,"KARANG REJO, TARAKAN BARAT, KOTA TARAKAN, KALIMANTAN UTARA",4,95,105,200
https://kawalpemilu.org#65634,"KARANG REJO, TARAKAN BARAT, KOTA TARAKAN, KALIMANTAN UTARA",5,93,63,156
https://kawalpemilu.org#65634,"KARANG REJO, TARAKAN BARAT, KOTA TARAKAN, KALIMANTAN UTARA",6,74,95,169
https://kawalpemilu.org#65634,"KARANG REJO, TARAKAN BARAT, KOTA TARAKAN, KALIMANTAN UTARA",7,95,67,162
https://kawalpemilu.org#65634,"KARANG REJO, TARAKAN BARAT, KOTA TARAKAN, KALIMANTAN UTARA",8,93,79,172
https://kawalpemilu.org#65634,"KARANG REJO, TARAKAN BARAT, KOTA TARAKAN, KALIMANTAN UTARA",9,92,109,201
https://kawalpemilu.org#65634,"KARANG REJO, TARAKAN BARAT, KOTA TARAKAN, KALIMANTAN UTARA",10,68,89,157
https://kawalpemilu.org#65634,"KARANG REJO, TARAKAN BARAT, KOTA TARAKAN, KALIMANTAN UTARA",11,114,82,196
https://kawalpemilu.org#65634,"KARANG REJO, TARAKAN BARAT, KOTA TARAKAN, KALIMANTAN UTARA",12,126,112,238
https://kawalpemilu.org#65634,"KARANG REJO, TARAKAN BARAT, KOTA TARAKAN, KALIMANTAN UTARA",13,89,76,165
https://kawalpemilu.org#65634,"KARANG REJO, TARAKAN BARAT, KOTA TARAKAN, KALIMANTAN UTARA",15,70,103,173
https://kawalpemilu.org#65634,"KARANG REJO, TARAKAN BARAT, KOTA TARAKAN, KALIMANTAN UTARA",16,107,122,229
https://kawalpemilu.org#65634,"KARANG REJO, TARAKAN BARAT, KOTA TARAKAN, KALIMANTAN UTARA",17,113,76,189
https://kawalpemilu.org#65634,"KARANG REJO, TARAKAN BARAT, KOTA TARAKAN, KALIMANTAN UTARA",18,130,89,219
https://kawalpemilu.org#65634,"KARANG REJO, TARAKAN BARAT, KOTA TARAKAN, KALIMANTAN UTARA",19,103,103,206
https://kawalpemilu.org#65634,"KARANG REJO, TARAKAN BARAT, KOTA TARAKAN, KALIMANTAN UTARA",20,141,83,224
https://kawalpemilu.org#65634,"KARANG REJO, TARAKAN BARAT, KOTA TARAKAN, KALIMANTAN UTARA",21,146,39,185
https://kawalpemilu.org#65635,"KARANG ANYAR PANTAI, TARAKAN BARAT, KOTA TARAKAN, KALIMANTAN UTARA",1,153,102,255
https://kawalpemilu.org#65635,"KARANG ANYAR PANTAI, TARAKAN BARAT, KOTA TARAKAN, KALIMANTAN UTARA",2,138,91,229
https://kawalpemilu.org#65635,"KARANG ANYAR PANTAI, TARAKAN BARAT, KOTA TARAKAN, KALIMANTAN UTARA",3,119,78,197
https://kawalpemilu.org#65635,"KARANG ANYAR PANTAI, TARAKAN BARAT, KOTA TARAKAN, KALIMANTAN UTARA",4,121,75,196
https://kawalpemilu.org#65635,"KARANG ANYAR PANTAI, TARAKAN BARAT, KOTA TARAKAN, KALIMANTAN UTARA",5,96,71,167
https://kawalpemilu.org#65635,"KARANG ANYAR PANTAI, TARAKAN BARAT, KOTA TARAKAN, KALIMANTAN UTARA",6,107,59,166
https://kawalpemilu.org#65635,"KARANG ANYAR PANTAI, TARAKAN BARAT, KOTA TARAKAN, KALIMANTAN UTARA",7,138,69,207
https://kawalpemilu.org#65635,"KARANG ANYAR PANTAI, TARAKAN BARAT, KOTA TARAKAN, KALIMANTAN UTARA",8,114,54,168
https://kawalpemilu.org#65635,"KARANG ANYAR PANTAI, TARAKAN BARAT, KOTA TARAKAN, KALIMANTAN UTARA",9,142,78,220
https://kawalpemilu.org#65635,"KARANG ANYAR PANTAI, TARAKAN BARAT, KOTA TARAKAN, KALIMANTAN UTARA",10,163,64,227
https://kawalpemilu.org#65635,"KARANG ANYAR PANTAI, TARAKAN BARAT, KOTA TARAKAN, KALIMANTAN UTARA",11,111,91,202
https://kawalpemilu.org#65635,"KARANG ANYAR PANTAI, TARAKAN BARAT, KOTA TARAKAN, KALIMANTAN UTARA",12,107,127,234
https://kawalpemilu.org#65635,"KARANG ANYAR PANTAI, TARAKAN BARAT, KOTA TARAKAN, KALIMANTAN UTARA",13,117,93,210
https://kawalpemilu.org#65635,"KARANG ANYAR PANTAI, TARAKAN BARAT, KOTA TARAKAN, KALIMANTAN UTARA",14,121,117,238
https://kawalpemilu.org#65635,"KARANG ANYAR PANTAI, TARAKAN BARAT, KOTA TARAKAN, KALIMANTAN UTARA",15,103,126,229
https://kawalpemilu.org#65635,"KARANG ANYAR PANTAI, TARAKAN BARAT, KOTA TARAKAN, KALIMANTAN UTARA",16,120,140,260
https://kawalpemilu.org#65635,"KARANG ANYAR PANTAI, TARAKAN BARAT, KOTA TARAKAN, KALIMANTAN UTARA",17,77,78,155
https://kawalpemilu.org#65635,"KARANG ANYAR PANTAI, TARAKAN BARAT, KOTA TARAKAN, KALIMANTAN UTARA",18,84,113,197
https://kawalpemilu.org#65635,"KARANG ANYAR PANTAI, TARAKAN BARAT, KOTA TARAKAN, KALIMANTAN UTARA",19,86,119,205
https://kawalpemilu.org#65635,"KARANG ANYAR PANTAI, TARAKAN BARAT, KOTA TARAKAN, KALIMANTAN UTARA",20,106,100,206
https://kawalpemilu.org#65635,"KARANG ANYAR PANTAI, TARAKAN BARAT, KOTA TARAKAN, KALIMANTAN UTARA",21,65,90,155
https://kawalpemilu.org#65635,"KARANG ANYAR PANTAI, TARAKAN BARAT, KOTA TARAKAN, KALIMANTAN UTARA",22,111,95,206
https://kawalpemilu.org#65635,"KARANG ANYAR PANTAI, TARAKAN BARAT, KOTA TARAKAN, KALIMANTAN UTARA",23,68,122,190
https://kawalpemilu.org#65635,"KARANG ANYAR PANTAI, TARAKAN BARAT, KOTA TARAKAN, KALIMANTAN UTARA",24,105,81,186
https://kawalpemilu.org#65635,"KARANG ANYAR PANTAI, TARAKAN BARAT, KOTA TARAKAN, KALIMANTAN UTARA",25,101,51,152
https://kawalpemilu.org#65635,"KARANG ANYAR PANTAI, TARAKAN BARAT, KOTA TARAKAN, KALIMANTAN UTARA",26,96,97,193
https://kawalpemilu.org#65635,"KARANG ANYAR PANTAI, TARAKAN BARAT, KOTA TARAKAN, KALIMANTAN UTARA",27,135,73,208
https://kawalpemilu.org#65635,"KARANG ANYAR PANTAI, TARAKAN BARAT, KOTA TARAKAN, KALIMANTAN UTARA",28,136,44,180
https://kawalpemilu.org#65635,"KARANG ANYAR PANTAI, TARAKAN BARAT, KOTA TARAKAN, KALIMANTAN UTARA",29,66,69,135
https://kawalpemilu.org#65635,"KARANG ANYAR PANTAI, TARAKAN BARAT, KOTA TARAKAN, KALIMANTAN UTARA",30,80,95,175
https://kawalpemilu.org#65635,"KARANG ANYAR PANTAI, TARAKAN BARAT, KOTA TARAKAN, KALIMANTAN UTARA",31,125,45,170
https://kawalpemilu.org#65635,"KARANG ANYAR PANTAI, TARAKAN BARAT, KOTA TARAKAN, KALIMANTAN UTARA",32,91,52,143
https://kawalpemilu.org#65635,"KARANG ANYAR PANTAI, TARAKAN BARAT, KOTA TARAKAN, KALIMANTAN UTARA",33,80,65,145
https://kawalpemilu.org#65635,"KARANG ANYAR PANTAI, TARAKAN BARAT, KOTA TARAKAN, KALIMANTAN UTARA",34,97,82,179
https://kawalpemilu.org#65635,"KARANG ANYAR PANTAI, TARAKAN BARAT, KOTA TARAKAN, KALIMANTAN UTARA",35,102,62,164
https://kawalpemilu.org#65635,"KARANG ANYAR PANTAI, TARAKAN BARAT, KOTA TARAKAN, KALIMANTAN UTARA",36,72,93,165
https://kawalpemilu.org#65635,"KARANG ANYAR PANTAI, TARAKAN BARAT, KOTA TARAKAN, KALIMANTAN UTARA",37,83,112,195
https://kawalpemilu.org#65635,"KARANG ANYAR PANTAI, TARAKAN BARAT, KOTA TARAKAN, KALIMANTAN UTARA",38,49,62,111
https://kawalpemilu.org#65635,"KARANG ANYAR PANTAI, TARAKAN BARAT, KOTA TARAKAN, KALIMANTAN UTARA",40,62,63,125
https://kawalpemilu.org#65635,"KARANG ANYAR PANTAI, TARAKAN BARAT, KOTA TARAKAN, KALIMANTAN UTARA",41,75,92,167
https://kawalpemilu.org#65635,"KARANG ANYAR PANTAI, TARAKAN BARAT, KOTA TARAKAN, KALIMANTAN UTARA",42,106,72,178
https://kawalpemilu.org#65635,"KARANG ANYAR PANTAI, TARAKAN BARAT, KOTA TARAKAN, KALIMANTAN UTARA",43,98,74,172
https://kawalpemilu.org#65635,"KARANG ANYAR PANTAI, TARAKAN BARAT, KOTA TARAKAN, KALIMANTAN UTARA",44,83,85,168
https://kawalpemilu.org#65635,"KARANG ANYAR PANTAI, TARAKAN BARAT, KOTA TARAKAN, KALIMANTAN UTARA",45,52,62,114
https://kawalpemilu.org#65635,"KARANG ANYAR PANTAI, TARAKAN BARAT, KOTA TARAKAN, KALIMANTAN UTARA",46,128,60,188
https://kawalpemilu.org#65635,"KARANG ANYAR PANTAI, TARAKAN BARAT, KOTA TARAKAN, KALIMANTAN UTARA",47,126,75,201
https://kawalpemilu.org#65635,"KARANG ANYAR PANTAI, TARAKAN BARAT, KOTA TARAKAN, KALIMANTAN UTARA",48,119,111,230
https://kawalpemilu.org#65635,"KARANG ANYAR PANTAI, TARAKAN BARAT, KOTA TARAKAN, KALIMANTAN UTARA",49,76,95,171
https://kawalpemilu.org#65635,"KARANG ANYAR PANTAI, TARAKAN BARAT, KOTA TARAKAN, KALIMANTAN UTARA",50,70,68,138
https://kawalpemilu.org#65635,"KARANG ANYAR PANTAI, TARAKAN BARAT, KOTA TARAKAN, KALIMANTAN UTARA",51,101,111,212
https://kawalpemilu.org#65635,"KARANG ANYAR PANTAI, TARAKAN BARAT, KOTA TARAKAN, KALIMANTAN UTARA",52,106,71,177
https://kawalpemilu.org#65635,"KARANG ANYAR PANTAI, TARAKAN BARAT, KOTA TARAKAN, KALIMANTAN UTARA",53,168,28,196
https://kawalpemilu.org#65635,"KARANG ANYAR PANTAI, TARAKAN BARAT, KOTA TARAKAN, KALIMANTAN UTARA",54,143,29,172
https://kawalpemilu.org#65635,"KARANG ANYAR PANTAI, TARAKAN BARAT, KOTA TARAKAN, KALIMANTAN UTARA",55,135,22,157
https://kawalpemilu.org#65635,"KARANG ANYAR PANTAI, TARAKAN BARAT, KOTA TARAKAN, KALIMANTAN UTARA",56,122,40,162
https://kawalpemilu.org#65635,"KARANG ANYAR PANTAI, TARAKAN BARAT, KOTA TARAKAN, KALIMANTAN UTARA",57,82,91,173
https://kawalpemilu.org#65635,"KARANG ANYAR PANTAI, TARAKAN BARAT, KOTA TARAKAN, KALIMANTAN UTARA",58,100,40,140
https://kawalpemilu.org#65635,"KARANG ANYAR PANTAI, TARAKAN BARAT, KOTA TARAKAN, KALIMANTAN UTARA",59,99,86,185
https://kawalpemilu.org#65635,"KARANG ANYAR PANTAI, TARAKAN BARAT, KOTA TARAKAN, KALIMANTAN UTARA",60,98,72,170
https://kawalpemilu.org#65635,"KARANG ANYAR PANTAI, TARAKAN BARAT, KOTA TARAKAN, KALIMANTAN UTARA",61,65,79,144
https://kawalpemilu.org#65636,"KARANG BALIK, TARAKAN BARAT, KOTA TARAKAN, KALIMANTAN UTARA",1,150,75,225
https://kawalpemilu.org#65636,"KARANG BALIK, TARAKAN BARAT, KOTA TARAKAN, KALIMANTAN UTARA",2,160,77,237
https://kawalpemilu.org#65636,"KARANG BALIK, TARAKAN BARAT, KOTA TARAKAN, KALIMANTAN UTARA",3,147,58,205
https://kawalpemilu.org#65636,"KARANG BALIK, TARAKAN BARAT, KOTA TARAKAN, KALIMANTAN UTARA",4,159,82,241
https://kawalpemilu.org#65636,"KARANG BALIK, TARAKAN BARAT, KOTA TARAKAN, KALIMANTAN UTARA",5,118,87,205
https://kawalpemilu.org#65636,"KARANG BALIK, TARAKAN BARAT, KOTA TARAKAN, KALIMANTAN UTARA",6,141,94,235
https://kawalpemilu.org#65636,"KARANG BALIK, TARAKAN BARAT, KOTA TARAKAN, KALIMANTAN UTARA",7,135,69,204
https://kawalpemilu.org#65636,"KARANG BALIK, TARAKAN BARAT, KOTA TARAKAN, KALIMANTAN UTARA",8,171,35,206
https://kawalpemilu.org#65636,"KARANG BALIK, TARAKAN BARAT, KOTA TARAKAN, KALIMANTAN UTARA",9,81,30,111
https://kawalpemilu.org#65636,"KARANG BALIK, TARAKAN BARAT, KOTA TARAKAN, KALIMANTAN UTARA",10,145,62,207
https://kawalpemilu.org#65636,"KARANG BALIK, TARAKAN BARAT, KOTA TARAKAN, KALIMANTAN UTARA",11,136,100,236
https://kawalpemilu.org#65636,"KARANG BALIK, TARAKAN BARAT, KOTA TARAKAN, KALIMANTAN UTARA",12,118,84,202
https://kawalpemilu.org#65636,"KARANG BALIK, TARAKAN BARAT, KOTA TARAKAN, KALIMANTAN UTARA",13,107,84,191
https://kawalpemilu.org#65636,"KARANG BALIK, TARAKAN BARAT, KOTA TARAKAN, KALIMANTAN UTARA",14,131,89,220
https://kawalpemilu.org#65636,"KARANG BALIK, TARAKAN BARAT, KOTA TARAKAN, KALIMANTAN UTARA",15,132,91,223
https://kawalpemilu.org#65636,"KARANG BALIK, TARAKAN BARAT, KOTA TARAKAN, KALIMANTAN UTARA",16,200,29,229
https://kawalpemilu.org#65636,"KARANG BALIK, TARAKAN BARAT, KOTA TARAKAN, KALIMANTAN UTARA",17,126,29,155
https://kawalpemilu.org#65636,"KARANG BALIK, TARAKAN BARAT, KOTA TARAKAN, KALIMANTAN UTARA",18,141,113,254
https://kawalpemilu.org#65636,"KARANG BALIK, TARAKAN BARAT, KOTA TARAKAN, KALIMANTAN UTARA",19,33,92,125
https://kawalpemilu.org#65636,"KARANG BALIK, TARAKAN BARAT, KOTA TARAKAN, KALIMANTAN UTARA",20,143,43,186
https://kawalpemilu.org#65636,"KARANG BALIK, TARAKAN BARAT, KOTA TARAKAN, KALIMANTAN UTARA",21,51,158,209
https://kawalpemilu.org#65636,"KARANG BALIK, TARAKAN BARAT, KOTA TARAKAN, KALIMANTAN UTARA",22,41,80,121
https://kawalpemilu.org#65637,"KARANG HARAPAN, TARAKAN BARAT, KOTA TARAKAN, KALIMANTAN UTARA",1,162,106,268
https://kawalpemilu.org#65637,"KARANG HARAPAN, TARAKAN BARAT, KOTA TARAKAN, KALIMANTAN UTARA",2,130,136,266
https://kawalpemilu.org#65637,"KARANG HARAPAN, TARAKAN BARAT, KOTA TARAKAN, KALIMANTAN UTARA",3,135,79,214
https://kawalpemilu.org#65637,"KARANG HARAPAN, TARAKAN BARAT, KOTA TARAKAN, KALIMANTAN UTARA",4,86,96,182
https://kawalpemilu.org#65637,"KARANG HARAPAN, TARAKAN BARAT, KOTA TARAKAN, KALIMANTAN UTARA",5,111,97,208
https://kawalpemilu.org#65637,"KARANG HARAPAN, TARAKAN BARAT, KOTA TARAKAN, KALIMANTAN UTARA",6,133,54,187
https://kawalpemilu.org#65637,"KARANG HARAPAN, TARAKAN BARAT, KOTA TARAKAN, KALIMANTAN UTARA",7,180,55,235
https://kawalpemilu.org#65637,"KARANG HARAPAN, TARAKAN BARAT, KOTA TARAKAN, KALIMANTAN UTARA",8,159,57,216
https://kawalpemilu.org#65637,"KARANG HARAPAN, TARAKAN BARAT, KOTA TARAKAN, KALIMANTAN UTARA",9,221,40,261
https://kawalpemilu.org#65637,"KARANG HARAPAN, TARAKAN BARAT, KOTA TARAKAN, KALIMANTAN UTARA",10,189,59,248
https://kawalpemilu.org#65637,"KARANG HARAPAN, TARAKAN BARAT, KOTA TARAKAN, KALIMANTAN UTARA",11,143,63,206
https://kawalpemilu.org#65637,"KARANG HARAPAN, TARAKAN BARAT, KOTA TARAKAN, KALIMANTAN UTARA",12,153,92,245
https://kawalpemilu.org#65637,"KARANG HARAPAN, TARAKAN BARAT, KOTA TARAKAN, KALIMANTAN UTARA",13,93,79,172
https://kawalpemilu.org#65637,"KARANG HARAPAN, TARAKAN BARAT, KOTA TARAKAN, KALIMANTAN UTARA",14,111,81,192
https://kawalpemilu.org#65637,"KARANG HARAPAN, TARAKAN BARAT, KOTA TARAKAN, KALIMANTAN UTARA",15,140,70,210
https://kawalpemilu.org#65637,"KARANG HARAPAN, TARAKAN BARAT, KOTA TARAKAN, KALIMANTAN UTARA",16,82,81,163
https://kawalpemilu.org#65637,"KARANG HARAPAN, TARAKAN BARAT, KOTA TARAKAN, KALIMANTAN UTARA",17,87,145,232
https://kawalpemilu.org#65637,"KARANG HARAPAN, TARAKAN BARAT, KOTA TARAKAN, KALIMANTAN UTARA",18,74,133,207
https://kawalpemilu.org#65637,"KARANG HARAPAN, TARAKAN BARAT, KOTA TARAKAN, KALIMANTAN UTARA",19,179,60,239
https://kawalpemilu.org#65637,"KARANG HARAPAN, TARAKAN BARAT, KOTA TARAKAN, KALIMANTAN UTARA",20,203,16,219
https://kawalpemilu.org#65637,"KARANG HARAPAN, TARAKAN BARAT, KOTA TARAKAN, KALIMANTAN UTARA",21,187,28,215
https://kawalpemilu.org#65637,"KARANG HARAPAN, TARAKAN BARAT, KOTA TARAKAN, KALIMANTAN UTARA",22,124,47,171
https://kawalpemilu.org#65637,"KARANG HARAPAN, TARAKAN BARAT, KOTA TARAKAN, KALIMANTAN UTARA",23,90,50,140
https://kawalpemilu.org#65637,"KARANG HARAPAN, TARAKAN BARAT, KOTA TARAKAN, KALIMANTAN UTARA",24,148,13,161
https://kawalpemilu.org#65637,"KARANG HARAPAN, TARAKAN BARAT, KOTA TARAKAN, KALIMANTAN UTARA",26,227,9,236
https://kawalpemilu.org#65637,"KARANG HARAPAN, TARAKAN BARAT, KOTA TARAKAN, KALIMANTAN UTARA",27,89,32,121
https://kawalpemilu.org#65637,"KARANG HARAPAN, TARAKAN BARAT, KOTA TARAKAN, KALIMANTAN UTARA",28,32,25,57
https://kawalpemilu.org#65637,"KARANG HARAPAN, TARAKAN BARAT, KOTA TARAKAN, KALIMANTAN UTARA",29,137,16,153
https://kawalpemilu.org#65639,"KAMPUNG I SKIP, TARAKAN TENGAH, KOTA TARAKAN, KALIMANTAN UTARA",1,140,107,247
https://kawalpemilu.org#65639,"KAMPUNG I SKIP, TARAKAN TENGAH, KOTA TARAKAN, KALIMANTAN UTARA",3,81,88,169
https://kawalpemilu.org#65639,"KAMPUNG I SKIP, TARAKAN TENGAH, KOTA TARAKAN, KALIMANTAN UTARA",4,71,69,140
https://kawalpemilu.org#65639,"KAMPUNG I SKIP, TARAKAN TENGAH, KOTA TARAKAN, KALIMANTAN UTARA",5,51,87,138
https://kawalpemilu.org#65639,"KAMPUNG I SKIP, TARAKAN TENGAH, KOTA TARAKAN, KALIMANTAN UTARA",6,98,121,219
https://kawalpemilu.org#65639,"KAMPUNG I SKIP, TARAKAN TENGAH, KOTA TARAKAN, KALIMANTAN UTARA",7,101,83,184
https://kawalpemilu.org#65639,"KAMPUNG I SKIP, TARAKAN TENGAH, KOTA TARAKAN, KALIMANTAN UTARA",8,175,97,272
https://kawalpemilu.org#65639,"KAMPUNG I SKIP, TARAKAN TENGAH, KOTA TARAKAN, KALIMANTAN UTARA",9,112,110,222
https://kawalpemilu.org#65639,"KAMPUNG I SKIP, TARAKAN TENGAH, KOTA TARAKAN, KALIMANTAN UTARA",10,121,91,212
https://kawalpemilu.org#65639,"KAMPUNG I SKIP, TARAKAN TENGAH, KOTA TARAKAN, KALIMANTAN UTARA",11,144,15,159
https://kawalpemilu.org#65639,"KAMPUNG I SKIP, TARAKAN TENGAH, KOTA TARAKAN, KALIMANTAN UTARA",12,126,115,241
https://kawalpemilu.org#65639,"KAMPUNG I SKIP, TARAKAN TENGAH, KOTA TARAKAN, KALIMANTAN UTARA",13,110,121,231
https://kawalpemilu.org#65639,"KAMPUNG I SKIP, TARAKAN TENGAH, KOTA TARAKAN, KALIMANTAN UTARA",14,116,131,247
https://kawalpemilu.org#65639,"KAMPUNG I SKIP, TARAKAN TENGAH, KOTA TARAKAN, KALIMANTAN UTARA",15,113,142,255
https://kawalpemilu.org#65639,"KAMPUNG I SKIP, TARAKAN TENGAH, KOTA TARAKAN, KALIMANTAN UTARA",16,99,101,200
https://kawalpemilu.org#65639,"KAMPUNG I SKIP, TARAKAN TENGAH, KOTA TARAKAN, KALIMANTAN UTARA",17,58,64,122
https://kawalpemilu.org#65639,"KAMPUNG I SKIP, TARAKAN TENGAH, KOTA TARAKAN, KALIMANTAN UTARA",18,61,60,121
https://kawalpemilu.org#65639,"KAMPUNG I SKIP, TARAKAN TENGAH, KOTA TARAKAN, KALIMANTAN UTARA",19,135,55,190
https://kawalpemilu.org#65639,"KAMPUNG I SKIP, TARAKAN TENGAH, KOTA TARAKAN, KALIMANTAN UTARA",20,103,29,132
https://kawalpemilu.org#65639,"KAMPUNG I SKIP, TARAKAN TENGAH, KOTA TARAKAN, KALIMANTAN UTARA",21,137,134,271
https://kawalpemilu.org#65639,"KAMPUNG I SKIP, TARAKAN TENGAH, KOTA TARAKAN, KALIMANTAN UTARA",22,113,123,236
https://kawalpemilu.org#65639,"KAMPUNG I SKIP, TARAKAN TENGAH, KOTA TARAKAN, KALIMANTAN UTARA",23,149,77,226
https://kawalpemilu.org#65639,"KAMPUNG I SKIP, TARAKAN TENGAH, KOTA TARAKAN, KALIMANTAN UTARA",24,103,118,220
https://kawalpemilu.org#65639,"KAMPUNG I SKIP, TARAKAN TENGAH, KOTA TARAKAN, KALIMANTAN UTARA",25,149,129,281
https://kawalpemilu.org#65639,"KAMPUNG I SKIP, TARAKAN TENGAH, KOTA TARAKAN, KALIMANTAN UTARA",26,104,77,181
https://kawalpemilu.org#65639,"KAMPUNG I SKIP, TARAKAN TENGAH, KOTA TARAKAN, KALIMANTAN UTARA",27,93,138,231
https://kawalpemilu.org#65639,"KAMPUNG I SKIP, TARAKAN TENGAH, KOTA TARAKAN, KALIMANTAN UTARA",28,207,64,271
https://kawalpemilu.org#65640,"PAMUSIAN, TARAKAN TENGAH, KOTA TARAKAN, KALIMANTAN UTARA",1,126,70,196
https://kawalpemilu.org#65640,"PAMUSIAN, TARAKAN TENGAH, KOTA TARAKAN, KALIMANTAN UTARA",2,110,55,165
https://kawalpemilu.org#65640,"PAMUSIAN, TARAKAN TENGAH, KOTA TARAKAN, KALIMANTAN UTARA",3,112,64,176
https://kawalpemilu.org#65640,"PAMUSIAN, TARAKAN TENGAH, KOTA TARAKAN, KALIMANTAN UTARA",4,113,57,170
https://kawalpemilu.org#65640,"PAMUSIAN, TARAKAN TENGAH, KOTA TARAKAN, KALIMANTAN UTARA",5,128,40,168
https://kawalpemilu.org#65640,"PAMUSIAN, TARAKAN TENGAH, KOTA TARAKAN, KALIMANTAN UTARA",6,152,32,184
https://kawalpemilu.org#65640,"PAMUSIAN, TARAKAN TENGAH, KOTA TARAKAN, KALIMANTAN UTARA",7,190,22,212
https://kawalpemilu.org#65640,"PAMUSIAN, TARAKAN TENGAH, KOTA TARAKAN, KALIMANTAN UTARA",8,149,44,193
https://kawalpemilu.org#65640,"PAMUSIAN, TARAKAN TENGAH, KOTA TARAKAN, KALIMANTAN UTARA",9,108,99,207
https://kawalpemilu.org#65640,"PAMUSIAN, TARAKAN TENGAH, KOTA TARAKAN, KALIMANTAN UTARA",10,81,71,152
https://kawalpemilu.org#65640,"PAMUSIAN, TARAKAN TENGAH, KOTA TARAKAN, KALIMANTAN UTARA",11,82,62,144
https://kawalpemilu.org#65640,"PAMUSIAN, TARAKAN TENGAH, KOTA TARAKAN, KALIMANTAN UTARA",12,109,79,188
https://kawalpemilu.org#65640,"PAMUSIAN, TARAKAN TENGAH, KOTA TARAKAN, KALIMANTAN UTARA",13,121,106,227
https://kawalpemilu.org#65640,"PAMUSIAN, TARAKAN TENGAH, KOTA TARAKAN, KALIMANTAN UTARA",14,97,66,163
https://kawalpemilu.org#65640,"PAMUSIAN, TARAKAN TENGAH, KOTA TARAKAN, KALIMANTAN UTARA",15,117,78,195
https://kawalpemilu.org#65640,"PAMUSIAN, TARAKAN TENGAH, KOTA TARAKAN, KALIMANTAN UTARA",16,44,46,90
https://kawalpemilu.org#65640,"PAMUSIAN, TARAKAN TENGAH, KOTA TARAKAN, KALIMANTAN UTARA",17,74,77,151
https://kawalpemilu.org#65640,"PAMUSIAN, TARAKAN TENGAH, KOTA TARAKAN, KALIMANTAN UTARA",18,93,88,181
https://kawalpemilu.org#65640,"PAMUSIAN, TARAKAN TENGAH, KOTA TARAKAN, KALIMANTAN UTARA",19,119,97,216
https://kawalpemilu.org#65640,"PAMUSIAN, TARAKAN TENGAH, KOTA TARAKAN, KALIMANTAN UTARA",20,119,87,206
https://kawalpemilu.org#65640,"PAMUSIAN, TARAKAN TENGAH, KOTA TARAKAN, KALIMANTAN UTARA",21,91,62,153
https://kawalpemilu.org#65640,"PAMUSIAN, TARAKAN TENGAH, KOTA TARAKAN, KALIMANTAN UTARA",22,103,51,154
https://kawalpemilu.org#65640,"PAMUSIAN, TARAKAN TENGAH, KOTA TARAKAN, KALIMANTAN UTARA",23,146,94,240
https://kawalpemilu.org#65640,"PAMUSIAN, TARAKAN TENGAH, KOTA TARAKAN, KALIMANTAN UTARA",24,118,87,205
https://kawalpemilu.org#65640,"PAMUSIAN, TARAKAN TENGAH, KOTA TARAKAN, KALIMANTAN UTARA",25,139,64,203
https://kawalpemilu.org#65640,"PAMUSIAN, TARAKAN TENGAH, KOTA TARAKAN, KALIMANTAN UTARA",26,103,56,159
https://kawalpemilu.org#65640,"PAMUSIAN, TARAKAN TENGAH, KOTA TARAKAN, KALIMANTAN UTARA",27,140,102,242
https://kawalpemilu.org#65640,"PAMUSIAN, TARAKAN TENGAH, KOTA TARAKAN, KALIMANTAN UTARA",28,101,74,175
https://kawalpemilu.org#65640,"PAMUSIAN, TARAKAN TENGAH, KOTA TARAKAN, KALIMANTAN UTARA",29,99,87,186
https://kawalpemilu.org#65640,"PAMUSIAN, TARAKAN TENGAH, KOTA TARAKAN, KALIMANTAN UTARA",30,89,70,159
https://kawalpemilu.org#65640,"PAMUSIAN, TARAKAN TENGAH, KOTA TARAKAN, KALIMANTAN UTARA",31,75,69,144
https://kawalpemilu.org#65640,"PAMUSIAN, TARAKAN TENGAH, KOTA TARAKAN, KALIMANTAN UTARA",32,101,54,155
https://kawalpemilu.org#65640,"PAMUSIAN, TARAKAN TENGAH, KOTA TARAKAN, KALIMANTAN UTARA",33,76,57,133
https://kawalpemilu.org#65640,"PAMUSIAN, TARAKAN TENGAH, KOTA TARAKAN, KALIMANTAN UTARA",34,101,47,148
https://kawalpemilu.org#65640,"PAMUSIAN, TARAKAN TENGAH, KOTA TARAKAN, KALIMANTAN UTARA",35,93,35,128
https://kawalpemilu.org#65640,"PAMUSIAN, TARAKAN TENGAH, KOTA TARAKAN, KALIMANTAN UTARA",36,99,159,258
https://kawalpemilu.org#65640,"PAMUSIAN, TARAKAN TENGAH, KOTA TARAKAN, KALIMANTAN UTARA",37,92,163,255
https://kawalpemilu.org#65640,"PAMUSIAN, TARAKAN TENGAH, KOTA TARAKAN, KALIMANTAN UTARA",38,184,16,200
https://kawalpemilu.org#65640,"PAMUSIAN, TARAKAN TENGAH, KOTA TARAKAN, KALIMANTAN UTARA",39,196,14,210
https://kawalpemilu.org#65640,"PAMUSIAN, TARAKAN TENGAH, KOTA TARAKAN, KALIMANTAN UTARA",40,129,101,230
https://kawalpemilu.org#65640,"PAMUSIAN, TARAKAN TENGAH, KOTA TARAKAN, KALIMANTAN UTARA",41,138,127,265
https://kawalpemilu.org#65640,"PAMUSIAN, TARAKAN TENGAH, KOTA TARAKAN, KALIMANTAN UTARA",42,137,104,241
https://kawalpemilu.org#65640,"PAMUSIAN, TARAKAN TENGAH, KOTA TARAKAN, KALIMANTAN UTARA",43,118,18,136
https://kawalpemilu.org#65640,"PAMUSIAN, TARAKAN TENGAH, KOTA TARAKAN, KALIMANTAN UTARA",44,114,57,171
https://kawalpemilu.org#65641,"SEBENGKOK, TARAKAN TENGAH, KOTA TARAKAN, KALIMANTAN UTARA",1,93,66,159
https://kawalpemilu.org#65641,"SEBENGKOK, TARAKAN TENGAH, KOTA TARAKAN, KALIMANTAN UTARA",2,91,118,209
https://kawalpemilu.org#65641,"SEBENGKOK, TARAKAN TENGAH, KOTA TARAKAN, KALIMANTAN UTARA",3,117,108,225
https://kawalpemilu.org#65641,"SEBENGKOK, TARAKAN TENGAH, KOTA TARAKAN, KALIMANTAN UTARA",4,155,112,267
https://kawalpemilu.org#65641,"SEBENGKOK, TARAKAN TENGAH, KOTA TARAKAN, KALIMANTAN UTARA",5,120,89,209
https://kawalpemilu.org#65641,"SEBENGKOK, TARAKAN TENGAH, KOTA TARAKAN, KALIMANTAN UTARA",6,82,30,112
https://kawalpemilu.org#65641,"SEBENGKOK, TARAKAN TENGAH, KOTA TARAKAN, KALIMANTAN UTARA",7,61,102,163
https://kawalpemilu.org#65641,"SEBENGKOK, TARAKAN TENGAH, KOTA TARAKAN, KALIMANTAN UTARA",8,77,112,189
https://kawalpemilu.org#65641,"SEBENGKOK, TARAKAN TENGAH, KOTA TARAKAN, KALIMANTAN UTARA",9,99,110,209
https://kawalpemilu.org#65641,"SEBENGKOK, TARAKAN TENGAH, KOTA TARAKAN, KALIMANTAN UTARA",10,141,121,262
https://kawalpemilu.org#65641,"SEBENGKOK, TARAKAN TENGAH, KOTA TARAKAN, KALIMANTAN UTARA",11,126,96,222
https://kawalpemilu.org#65641,"SEBENGKOK, TARAKAN TENGAH, KOTA TARAKAN, KALIMANTAN UTARA",12,107,89,196
https://kawalpemilu.org#65641,"SEBENGKOK, TARAKAN TENGAH, KOTA TARAKAN, KALIMANTAN UTARA",13,131,123,254
https://kawalpemilu.org#65641,"SEBENGKOK, TARAKAN TENGAH, KOTA TARAKAN, KALIMANTAN UTARA",14,56,80,136
https://kawalpemilu.org#65641,"SEBENGKOK, TARAKAN TENGAH, KOTA TARAKAN, KALIMANTAN UTARA",15,60,73,133
https://kawalpemilu.org#65641,"SEBENGKOK, TARAKAN TENGAH, KOTA TARAKAN, KALIMANTAN UTARA",16,103,176,279
https://kawalpemilu.org#65641,"SEBENGKOK, TARAKAN TENGAH, KOTA TARAKAN, KALIMANTAN UTARA",17,68,82,150
https://kawalpemilu.org#65641,"SEBENGKOK, TARAKAN TENGAH, KOTA TARAKAN, KALIMANTAN UTARA",18,73,63,136
https://kawalpemilu.org#65641,"SEBENGKOK, TARAKAN TENGAH, KOTA TARAKAN, KALIMANTAN UTARA",19,131,98,229
https://kawalpemilu.org#65641,"SEBENGKOK, TARAKAN TENGAH, KOTA TARAKAN, KALIMANTAN UTARA",20,82,95,177
https://kawalpemilu.org#65641,"SEBENGKOK, TARAKAN TENGAH, KOTA TARAKAN, KALIMANTAN UTARA",21,64,78,142
https://kawalpemilu.org#65641,"SEBENGKOK, TARAKAN TENGAH, KOTA TARAKAN, KALIMANTAN UTARA",22,104,133,237
https://kawalpemilu.org#65641,"SEBENGKOK, TARAKAN TENGAH, KOTA TARAKAN, KALIMANTAN UTARA",23,145,95,240
https://kawalpemilu.org#65641,"SEBENGKOK, TARAKAN TENGAH, KOTA TARAKAN, KALIMANTAN UTARA",24,118,114,232
https://kawalpemilu.org#65641,"SEBENGKOK, TARAKAN TENGAH, KOTA TARAKAN, KALIMANTAN UTARA",25,78,129,207
https://kawalpemilu.org#65641,"SEBENGKOK, TARAKAN TENGAH, KOTA TARAKAN, KALIMANTAN UTARA",26,58,117,175
https://kawalpemilu.org#65641,"SEBENGKOK, TARAKAN TENGAH, KOTA TARAKAN, KALIMANTAN UTARA",27,79,90,169
https://kawalpemilu.org#65641,"SEBENGKOK, TARAKAN TENGAH, KOTA TARAKAN, KALIMANTAN UTARA",28,83,99,182
https://kawalpemilu.org#65641,"SEBENGKOK, TARAKAN TENGAH, KOTA TARAKAN, KALIMANTAN UTARA",29,133,84,217
https://kawalpemilu.org#65641,"SEBENGKOK, TARAKAN TENGAH, KOTA TARAKAN, KALIMANTAN UTARA",30,59,73,132
https://kawalpemilu.org#65641,"SEBENGKOK, TARAKAN TENGAH, KOTA TARAKAN, KALIMANTAN UTARA",31,52,78,130
https://kawalpemilu.org#65641,"SEBENGKOK, TARAKAN TENGAH, KOTA TARAKAN, KALIMANTAN UTARA",32,81,74,155
https://kawalpemilu.org#65641,"SEBENGKOK, TARAKAN TENGAH, KOTA TARAKAN, KALIMANTAN UTARA",33,54,104,158
https://kawalpemilu.org#65641,"SEBENGKOK, TARAKAN TENGAH, KOTA TARAKAN, KALIMANTAN UTARA",34,114,83,197
https://kawalpemilu.org#65641,"SEBENGKOK, TARAKAN TENGAH, KOTA TARAKAN, KALIMANTAN UTARA",35,81,126,207
https://kawalpemilu.org#65641,"SEBENGKOK, TARAKAN TENGAH, KOTA TARAKAN, KALIMANTAN UTARA",36,109,79,188
https://kawalpemilu.org#65641,"SEBENGKOK, TARAKAN TENGAH, KOTA TARAKAN, KALIMANTAN UTARA",37,77,163,240
https://kawalpemilu.org#65641,"SEBENGKOK, TARAKAN TENGAH, KOTA TARAKAN, KALIMANTAN UTARA",38,125,175,300
https://kawalpemilu.org#65641,"SEBENGKOK, TARAKAN TENGAH, KOTA TARAKAN, KALIMANTAN UTARA",39,102,125,227
https://kawalpemilu.org#65641,"SEBENGKOK, TARAKAN TENGAH, KOTA TARAKAN, KALIMANTAN UTARA",40,173,76,249
https://kawalpemilu.org#65641,"SEBENGKOK, TARAKAN TENGAH, KOTA TARAKAN, KALIMANTAN UTARA",41,104,69,173
https://kawalpemilu.org#65641,"SEBENGKOK, TARAKAN TENGAH, KOTA TARAKAN, KALIMANTAN UTARA",42,85,112,197
https://kawalpemilu.org#65641,"SEBENGKOK, TARAKAN TENGAH, KOTA TARAKAN, KALIMANTAN UTARA",43,59,106,165
https://kawalpemilu.org#65641,"SEBENGKOK, TARAKAN TENGAH, KOTA TARAKAN, KALIMANTAN UTARA",44,74,82,156
https://kawalpemilu.org#65641,"SEBENGKOK, TARAKAN TENGAH, KOTA TARAKAN, KALIMANTAN UTARA",45,76,75,151
https://kawalpemilu.org#65641,"SEBENGKOK, TARAKAN TENGAH, KOTA TARAKAN, KALIMANTAN UTARA",46,100,125,225
https://kawalpemilu.org#65641,"SEBENGKOK, TARAKAN TENGAH, KOTA TARAKAN, KALIMANTAN UTARA",47,84,136,220
https://kawalpemilu.org#65642,"SELUMIT, TARAKAN TENGAH, KOTA TARAKAN, KALIMANTAN UTARA",1,97,89,186
https://kawalpemilu.org#65642,"SELUMIT, TARAKAN TENGAH, KOTA TARAKAN, KALIMANTAN UTARA",2,103,104,207
https://kawalpemilu.org#65642,"SELUMIT, TARAKAN TENGAH, KOTA TARAKAN, KALIMANTAN UTARA",3,128,67,195
https://kawalpemilu.org#65642,"SELUMIT, TARAKAN TENGAH, KOTA TARAKAN, KALIMANTAN UTARA",4,91,115,206
https://kawalpemilu.org#65642,"SELUMIT, TARAKAN TENGAH, KOTA TARAKAN, KALIMANTAN UTARA",5,73,80,153
https://kawalpemilu.org#65642,"SELUMIT, TARAKAN TENGAH, KOTA TARAKAN, KALIMANTAN UTARA",6,114,103,217
https://kawalpemilu.org#65642,"SELUMIT, TARAKAN TENGAH, KOTA TARAKAN, KALIMANTAN UTARA",7,76,80,156
https://kawalpemilu.org#65642,"SELUMIT, TARAKAN TENGAH, KOTA TARAKAN, KALIMANTAN UTARA",9,70,56,126
https://kawalpemilu.org#65642,"SELUMIT, TARAKAN TENGAH, KOTA TARAKAN, KALIMANTAN UTARA",10,70,53,123
https://kawalpemilu.org#65642,"SELUMIT, TARAKAN TENGAH, KOTA TARAKAN, KALIMANTAN UTARA",11,95,126,221
https://kawalpemilu.org#65642,"SELUMIT, TARAKAN TENGAH, KOTA TARAKAN, KALIMANTAN UTARA",12,91,92,183
https://kawalpemilu.org#65642,"SELUMIT, TARAKAN TENGAH, KOTA TARAKAN, KALIMANTAN UTARA",13,104,76,180
https://kawalpemilu.org#65642,"SELUMIT, TARAKAN TENGAH, KOTA TARAKAN, KALIMANTAN UTARA",14,70,63,133
https://kawalpemilu.org#65642,"SELUMIT, TARAKAN TENGAH, KOTA TARAKAN, KALIMANTAN UTARA",15,92,103,195
https://kawalpemilu.org#65642,"SELUMIT, TARAKAN TENGAH, KOTA TARAKAN, KALIMANTAN UTARA",16,56,64,120
https://kawalpemilu.org#65642,"SELUMIT, TARAKAN TENGAH, KOTA TARAKAN, KALIMANTAN UTARA",17,97,66,163
https://kawalpemilu.org#65642,"SELUMIT, TARAKAN TENGAH, KOTA TARAKAN, KALIMANTAN UTARA",18,65,49,114
https://kawalpemilu.org#65642,"SELUMIT, TARAKAN TENGAH, KOTA TARAKAN, KALIMANTAN UTARA",19,70,55,125
https://kawalpemilu.org#65642,"SELUMIT, TARAKAN TENGAH, KOTA TARAKAN, KALIMANTAN UTARA",20,71,64,135
https://kawalpemilu.org#65642,"SELUMIT, TARAKAN TENGAH, KOTA TARAKAN, KALIMANTAN UTARA",21,76,50,126
https://kawalpemilu.org#65642,"SELUMIT, TARAKAN TENGAH, KOTA TARAKAN, KALIMANTAN UTARA",22,95,71,166
https://kawalpemilu.org#65642,"SELUMIT, TARAKAN TENGAH, KOTA TARAKAN, KALIMANTAN UTARA",23,51,59,110
https://kawalpemilu.org#65643,"SELUMIT PANTAI, TARAKAN TENGAH, KOTA TARAKAN, KALIMANTAN UTARA",1,79,85,164
https://kawalpemilu.org#65643,"SELUMIT PANTAI, TARAKAN TENGAH, KOTA TARAKAN, KALIMANTAN UTARA",2,58,73,131
https://kawalpemilu.org#65643,"SELUMIT PANTAI, TARAKAN TENGAH, KOTA TARAKAN, KALIMANTAN UTARA",3,81,64,145
https://kawalpemilu.org#65643,"SELUMIT PANTAI, TARAKAN TENGAH, KOTA TARAKAN, KALIMANTAN UTARA",4,124,52,176
https://kawalpemilu.org#65643,"SELUMIT PANTAI, TARAKAN TENGAH, KOTA TARAKAN, KALIMANTAN UTARA",5,74,46,120
https://kawalpemilu.org#65643,"SELUMIT PANTAI, TARAKAN TENGAH, KOTA TARAKAN, KALIMANTAN UTARA",6,91,66,157
https://kawalpemilu.org#65643,"SELUMIT PANTAI, TARAKAN TENGAH, KOTA TARAKAN, KALIMANTAN UTARA",7,97,72,169
https://kawalpemilu.org#65643,"SELUMIT PANTAI, TARAKAN TENGAH, KOTA TARAKAN, KALIMANTAN UTARA",8,106,53,159
https://kawalpemilu.org#65643,"SELUMIT PANTAI, TARAKAN TENGAH, KOTA TARAKAN, KALIMANTAN UTARA",9,56,69,125
https://kawalpemilu.org#65643,"SELUMIT PANTAI, TARAKAN TENGAH, KOTA TARAKAN, KALIMANTAN UTARA",10,89,98,187
https://kawalpemilu.org#65643,"SELUMIT PANTAI, TARAKAN TENGAH, KOTA TARAKAN, KALIMANTAN UTARA",11,103,99,202
https://kawalpemilu.org#65643,"SELUMIT PANTAI, TARAKAN TENGAH, KOTA TARAKAN, KALIMANTAN UTARA",12,102,85,187
https://kawalpemilu.org#65643,"SELUMIT PANTAI, TARAKAN TENGAH, KOTA TARAKAN, KALIMANTAN UTARA",13,34,38,72
https://kawalpemilu.org#65643,"SELUMIT PANTAI, TARAKAN TENGAH, KOTA TARAKAN, KALIMANTAN UTARA",14,88,51,139
https://kawalpemilu.org#65643,"SELUMIT PANTAI, TARAKAN TENGAH, KOTA TARAKAN, KALIMANTAN UTARA",15,88,73,161
https://kawalpemilu.org#65643,"SELUMIT PANTAI, TARAKAN TENGAH, KOTA TARAKAN, KALIMANTAN UTARA",16,108,100,208
https://kawalpemilu.org#65643,"SELUMIT PANTAI, TARAKAN TENGAH, KOTA TARAKAN, KALIMANTAN UTARA",17,98,70,168
https://kawalpemilu.org#65643,"SELUMIT PANTAI, TARAKAN TENGAH, KOTA TARAKAN, KALIMANTAN UTARA",18,71,90,161
https://kawalpemilu.org#65643,"SELUMIT PANTAI, TARAKAN TENGAH, KOTA TARAKAN, KALIMANTAN UTARA",19,75,78,153
https://kawalpemilu.org#65643,"SELUMIT PANTAI, TARAKAN TENGAH, KOTA TARAKAN, KALIMANTAN UTARA",20,120,109,229
https://kawalpemilu.org#65643,"SELUMIT PANTAI, TARAKAN TENGAH, KOTA TARAKAN, KALIMANTAN UTARA",21,75,102,176
https://kawalpemilu.org#65643,"SELUMIT PANTAI, TARAKAN TENGAH, KOTA TARAKAN, KALIMANTAN UTARA",22,94,80,174
https://kawalpemilu.org#65643,"SELUMIT PANTAI, TARAKAN TENGAH, KOTA TARAKAN, KALIMANTAN UTARA",23,79,45,124
https://kawalpemilu.org#65643,"SELUMIT PANTAI, TARAKAN TENGAH, KOTA TARAKAN, KALIMANTAN UTARA",24,72,45,117
https://kawalpemilu.org#65643,"SELUMIT PANTAI, TARAKAN TENGAH, KOTA TARAKAN, KALIMANTAN UTARA",25,128,80,208
https://kawalpemilu.org#65643,"SELUMIT PANTAI, TARAKAN TENGAH, KOTA TARAKAN, KALIMANTAN UTARA",26,102,79,181
https://kawalpemilu.org#65643,"SELUMIT PANTAI, TARAKAN TENGAH, KOTA TARAKAN, KALIMANTAN UTARA",27,107,122,229
https://kawalpemilu.org#65643,"SELUMIT PANTAI, TARAKAN TENGAH, KOTA TARAKAN, KALIMANTAN UTARA",28,69,58,127
https://kawalpemilu.org#65643,"SELUMIT PANTAI, TARAKAN TENGAH, KOTA TARAKAN, KALIMANTAN UTARA",29,119,68,187
https://kawalpemilu.org#65643,"SELUMIT PANTAI, TARAKAN TENGAH, KOTA TARAKAN, KALIMANTAN UTARA",30,166,127,293
https://kawalpemilu.org#65643,"SELUMIT PANTAI, TARAKAN TENGAH, KOTA TARAKAN, KALIMANTAN UTARA",31,122,82,204
https://kawalpemilu.org#65643,"SELUMIT PANTAI, TARAKAN TENGAH, KOTA TARAKAN, KALIMANTAN UTARA",32,80,71,151
https://kawalpemilu.org#65643,"SELUMIT PANTAI, TARAKAN TENGAH, KOTA TARAKAN, KALIMANTAN UTARA",33,116,91,207
https://kawalpemilu.org#65643,"SELUMIT PANTAI, TARAKAN TENGAH, KOTA TARAKAN, KALIMANTAN UTARA",34,96,80,4
https://kawalpemilu.org#65643,"SELUMIT PANTAI, TARAKAN TENGAH, KOTA TARAKAN, KALIMANTAN UTARA",35,137,106,243
https://kawalpemilu.org#65643,"SELUMIT PANTAI, TARAKAN TENGAH, KOTA TARAKAN, KALIMANTAN UTARA",36,92,76,168
https://kawalpemilu.org#65643,"SELUMIT PANTAI, TARAKAN TENGAH, KOTA TARAKAN, KALIMANTAN UTARA",37,74,55,129
https://kawalpemilu.org#65643,"SELUMIT PANTAI, TARAKAN TENGAH, KOTA TARAKAN, KALIMANTAN UTARA",38,94,64,158
https://kawalpemilu.org#65643,"SELUMIT PANTAI, TARAKAN TENGAH, KOTA TARAKAN, KALIMANTAN UTARA",39,114,70,184
https://kawalpemilu.org#65643,"SELUMIT PANTAI, TARAKAN TENGAH, KOTA TARAKAN, KALIMANTAN UTARA",40,70,89,159
https://kawalpemilu.org#65643,"SELUMIT PANTAI, TARAKAN TENGAH, KOTA TARAKAN, KALIMANTAN UTARA",41,0,0,0
https://kawalpemilu.org#65643,"SELUMIT PANTAI, TARAKAN TENGAH, KOTA TARAKAN, KALIMANTAN UTARA",42,112,77,189
https://kawalpemilu.org#65643,"SELUMIT PANTAI, TARAKAN TENGAH, KOTA TARAKAN, KALIMANTAN UTARA",43,90,90,180
https://kawalpemilu.org#65643,"SELUMIT PANTAI, TARAKAN TENGAH, KOTA TARAKAN, KALIMANTAN UTARA",44,103,46,149
https://kawalpemilu.org#65643,"SELUMIT PANTAI, TARAKAN TENGAH, KOTA TARAKAN, KALIMANTAN UTARA",45,100,85,185
https://kawalpemilu.org#65643,"SELUMIT PANTAI, TARAKAN TENGAH, KOTA TARAKAN, KALIMANTAN UTARA",46,87,67,154
https://kawalpemilu.org#65643,"SELUMIT PANTAI, TARAKAN TENGAH, KOTA TARAKAN, KALIMANTAN UTARA",47,107,43,150
https://kawalpemilu.org#65643,"SELUMIT PANTAI, TARAKAN TENGAH, KOTA TARAKAN, KALIMANTAN UTARA",48,135,67,202
https://kawalpemilu.org#65643,"SELUMIT PANTAI, TARAKAN TENGAH, KOTA TARAKAN, KALIMANTAN UTARA",49,104,103,207
https://kawalpemilu.org#65643,"SELUMIT PANTAI, TARAKAN TENGAH, KOTA TARAKAN, KALIMANTAN UTARA",50,88,94,182
https://kawalpemilu.org#65643,"SELUMIT PANTAI, TARAKAN TENGAH, KOTA TARAKAN, KALIMANTAN UTARA",51,120,86,206
https://kawalpemilu.org#65643,"SELUMIT PANTAI, TARAKAN TENGAH, KOTA TARAKAN, KALIMANTAN UTARA",52,91,72,163
https://kawalpemilu.org#65643,"SELUMIT PANTAI, TARAKAN TENGAH, KOTA TARAKAN, KALIMANTAN UTARA",53,101,93,194
https://kawalpemilu.org#65643,"SELUMIT PANTAI, TARAKAN TENGAH, KOTA TARAKAN, KALIMANTAN UTARA",54,91,40,131
https://kawalpemilu.org#65645,"LINGKAS UJUNG, TARAKAN TIMUR, KOTA TARAKAN, KALIMANTAN UTARA",1,92,149,241
https://kawalpemilu.org#65645,"LINGKAS UJUNG, TARAKAN TIMUR, KOTA TARAKAN, KALIMANTAN UTARA",2,99,166,265
https://kawalpemilu.org#65645,"LINGKAS UJUNG, TARAKAN TIMUR, KOTA TARAKAN, KALIMANTAN UTARA",3,90,126,216
https://kawalpemilu.org#65645,"LINGKAS UJUNG, TARAKAN TIMUR, KOTA TARAKAN, KALIMANTAN UTARA",4,130,131,261
https://kawalpemilu.org#65645,"LINGKAS UJUNG, TARAKAN TIMUR, KOTA TARAKAN, KALIMANTAN UTARA",5,74,128,202
https://kawalpemilu.org#65645,"LINGKAS UJUNG, TARAKAN TIMUR, KOTA TARAKAN, KALIMANTAN UTARA",6,67,106,173
https://kawalpemilu.org#65645,"LINGKAS UJUNG, TARAKAN TIMUR, KOTA TARAKAN, KALIMANTAN UTARA",7,74,145,219
https://kawalpemilu.org#65645,"LINGKAS UJUNG, TARAKAN TIMUR, KOTA TARAKAN, KALIMANTAN UTARA",8,64,110,174
https://kawalpemilu.org#65645,"LINGKAS UJUNG, TARAKAN TIMUR, KOTA TARAKAN, KALIMANTAN UTARA",9,68,106,174
https://kawalpemilu.org#65645,"LINGKAS UJUNG, TARAKAN TIMUR, KOTA TARAKAN, KALIMANTAN UTARA",10,131,99,230
https://kawalpemilu.org#65645,"LINGKAS UJUNG, TARAKAN TIMUR, KOTA TARAKAN, KALIMANTAN UTARA",11,114,115,229
https://kawalpemilu.org#65645,"LINGKAS UJUNG, TARAKAN TIMUR, KOTA TARAKAN, KALIMANTAN UTARA",12,92,104,196
https://kawalpemilu.org#65645,"LINGKAS UJUNG, TARAKAN TIMUR, KOTA TARAKAN, KALIMANTAN UTARA",13,111,117,228
https://kawalpemilu.org#65645,"LINGKAS UJUNG, TARAKAN TIMUR, KOTA TARAKAN, KALIMANTAN UTARA",14,90,90,180
https://kawalpemilu.org#65645,"LINGKAS UJUNG, TARAKAN TIMUR, KOTA TARAKAN, KALIMANTAN UTARA",15,84,107,191
https://kawalpemilu.org#65645,"LINGKAS UJUNG, TARAKAN TIMUR, KOTA TARAKAN, KALIMANTAN UTARA",16,86,98,184
https://kawalpemilu.org#65645,"LINGKAS UJUNG, TARAKAN TIMUR, KOTA TARAKAN, KALIMANTAN UTARA",17,103,121,224
https://kawalpemilu.org#65645,"LINGKAS UJUNG, TARAKAN TIMUR, KOTA TARAKAN, KALIMANTAN UTARA",18,96,158,254
https://kawalpemilu.org#65645,"LINGKAS UJUNG, TARAKAN TIMUR, KOTA TARAKAN, KALIMANTAN UTARA",19,91,50,141
https://kawalpemilu.org#65645,"LINGKAS UJUNG, TARAKAN TIMUR, KOTA TARAKAN, KALIMANTAN UTARA",20,113,45,158
https://kawalpemilu.org#65645,"LINGKAS UJUNG, TARAKAN TIMUR, KOTA TARAKAN, KALIMANTAN UTARA",21,110,143,253
https://kawalpemilu.org#65645,"LINGKAS UJUNG, TARAKAN TIMUR, KOTA TARAKAN, KALIMANTAN UTARA",22,93,123,216
https://kawalpemilu.org#65645,"LINGKAS UJUNG, TARAKAN TIMUR, KOTA TARAKAN, KALIMANTAN UTARA",23,86,121,207
https://kawalpemilu.org#65645,"LINGKAS UJUNG, TARAKAN TIMUR, KOTA TARAKAN, KALIMANTAN UTARA",24,132,122,254
https://kawalpemilu.org#65645,"LINGKAS UJUNG, TARAKAN TIMUR, KOTA TARAKAN, KALIMANTAN UTARA",25,126,126,252
https://kawalpemilu.org#65645,"LINGKAS UJUNG, TARAKAN TIMUR, KOTA TARAKAN, KALIMANTAN UTARA",26,126,86,212
https://kawalpemilu.org#65645,"LINGKAS UJUNG, TARAKAN TIMUR, KOTA TARAKAN, KALIMANTAN UTARA",27,175,59,234
https://kawalpemilu.org#65645,"LINGKAS UJUNG, TARAKAN TIMUR, KOTA TARAKAN, KALIMANTAN UTARA",28,158,60,218
https://kawalpemilu.org#65645,"LINGKAS UJUNG, TARAKAN TIMUR, KOTA TARAKAN, KALIMANTAN UTARA",29,58,97,155
https://kawalpemilu.org#65645,"LINGKAS UJUNG, TARAKAN TIMUR, KOTA TARAKAN, KALIMANTAN UTARA",30,49,92,141
https://kawalpemilu.org#65645,"LINGKAS UJUNG, TARAKAN TIMUR, KOTA TARAKAN, KALIMANTAN UTARA",31,59,93,152
https://kawalpemilu.org#65646,"GUNUNG LINGKAS, TARAKAN TIMUR, KOTA TARAKAN, KALIMANTAN UTARA",1,140,109,249
https://kawalpemilu.org#65646,"GUNUNG LINGKAS, TARAKAN TIMUR, KOTA TARAKAN, KALIMANTAN UTARA",2,124,120,244
https://kawalpemilu.org#65646,"GUNUNG LINGKAS, TARAKAN TIMUR, KOTA TARAKAN, KALIMANTAN UTARA",3,104,116,220
https://kawalpemilu.org#65646,"GUNUNG LINGKAS, TARAKAN TIMUR, KOTA TARAKAN, KALIMANTAN UTARA",4,88,134,222
https://kawalpemilu.org#65646,"GUNUNG LINGKAS, TARAKAN TIMUR, KOTA TARAKAN, KALIMANTAN UTARA",5,92,144,236
https://kawalpemilu.org#65646,"GUNUNG LINGKAS, TARAKAN TIMUR, KOTA TARAKAN, KALIMANTAN UTARA",6,104,96,200
https://kawalpemilu.org#65646,"GUNUNG LINGKAS, TARAKAN TIMUR, KOTA TARAKAN, KALIMANTAN UTARA",7,88,114,202
https://kawalpemilu.org#65646,"GUNUNG LINGKAS, TARAKAN TIMUR, KOTA TARAKAN, KALIMANTAN UTARA",8,149,94,243
https://kawalpemilu.org#65646,"GUNUNG LINGKAS, TARAKAN TIMUR, KOTA TARAKAN, KALIMANTAN UTARA",9,111,72,183
https://kawalpemilu.org#65646,"GUNUNG LINGKAS, TARAKAN TIMUR, KOTA TARAKAN, KALIMANTAN UTARA",10,79,74,153
https://kawalpemilu.org#65646,"GUNUNG LINGKAS, TARAKAN TIMUR, KOTA TARAKAN, KALIMANTAN UTARA",11,119,91,210
https://kawalpemilu.org#65646,"GUNUNG LINGKAS, TARAKAN TIMUR, KOTA TARAKAN, KALIMANTAN UTARA",12,89,98,187
https://kawalpemilu.org#65646,"GUNUNG LINGKAS, TARAKAN TIMUR, KOTA TARAKAN, KALIMANTAN UTARA",13,102,51,153
https://kawalpemilu.org#65646,"GUNUNG LINGKAS, TARAKAN TIMUR, KOTA TARAKAN, KALIMANTAN UTARA",14,78,70,148
https://kawalpemilu.org#65646,"GUNUNG LINGKAS, TARAKAN TIMUR, KOTA TARAKAN, KALIMANTAN UTARA",15,125,95,220
https://kawalpemilu.org#65646,"GUNUNG LINGKAS, TARAKAN TIMUR, KOTA TARAKAN, KALIMANTAN UTARA",16,96,83,179
https://kawalpemilu.org#65646,"GUNUNG LINGKAS, TARAKAN TIMUR, KOTA TARAKAN, KALIMANTAN UTARA",17,122,142,264
https://kawalpemilu.org#65646,"GUNUNG LINGKAS, TARAKAN TIMUR, KOTA TARAKAN, KALIMANTAN UTARA",18,141,81,222
https://kawalpemilu.org#65646,"GUNUNG LINGKAS, TARAKAN TIMUR, KOTA TARAKAN, KALIMANTAN UTARA",19,84,94,178
https://kawalpemilu.org#65646,"GUNUNG LINGKAS, TARAKAN TIMUR, KOTA TARAKAN, KALIMANTAN UTARA",20,87,88,175
https://kawalpemilu.org#65646,"GUNUNG LINGKAS, TARAKAN TIMUR, KOTA TARAKAN, KALIMANTAN UTARA",21,89,53,142
https://kawalpemilu.org#65646,"GUNUNG LINGKAS, TARAKAN TIMUR, KOTA TARAKAN, KALIMANTAN UTARA",22,121,86,207
https://kawalpemilu.org#65646,"GUNUNG LINGKAS, TARAKAN TIMUR, KOTA TARAKAN, KALIMANTAN UTARA",23,115,88,203
https://kawalpemilu.org#65647,"KAMPUNG EMPAT, TARAKAN TIMUR, KOTA TARAKAN, KALIMANTAN UTARA",1,61,70,131
https://kawalpemilu.org#65647,"KAMPUNG EMPAT, TARAKAN TIMUR, KOTA TARAKAN, KALIMANTAN UTARA",2,88,50,138
https://kawalpemilu.org#65647,"KAMPUNG EMPAT, TARAKAN TIMUR, KOTA TARAKAN, KALIMANTAN UTARA",3,78,64,142
https://kawalpemilu.org#65647,"KAMPUNG EMPAT, TARAKAN TIMUR, KOTA TARAKAN, KALIMANTAN UTARA",4,85,74,159
https://kawalpemilu.org#65647,"KAMPUNG EMPAT, TARAKAN TIMUR, KOTA TARAKAN, KALIMANTAN UTARA",5,107,75,182
https://kawalpemilu.org#65647,"KAMPUNG EMPAT, TARAKAN TIMUR, KOTA TARAKAN, KALIMANTAN UTARA",6,110,45,155
https://kawalpemilu.org#65647,"KAMPUNG EMPAT, TARAKAN TIMUR, KOTA TARAKAN, KALIMANTAN UTARA",7,122,94,216
https://kawalpemilu.org#65647,"KAMPUNG EMPAT, TARAKAN TIMUR, KOTA TARAKAN, KALIMANTAN UTARA",8,81,90,171
https://kawalpemilu.org#65647,"KAMPUNG EMPAT, TARAKAN TIMUR, KOTA TARAKAN, KALIMANTAN UTARA",9,67,104,171
https://kawalpemilu.org#65647,"KAMPUNG EMPAT, TARAKAN TIMUR, KOTA TARAKAN, KALIMANTAN UTARA",10,100,83,183
https://kawalpemilu.org#65647,"KAMPUNG EMPAT, TARAKAN TIMUR, KOTA TARAKAN, KALIMANTAN UTARA",11,75,35,110
https://kawalpemilu.org#65647,"KAMPUNG EMPAT, TARAKAN TIMUR, KOTA TARAKAN, KALIMANTAN UTARA",12,98,71,169
https://kawalpemilu.org#65647,"KAMPUNG EMPAT, TARAKAN TIMUR, KOTA TARAKAN, KALIMANTAN UTARA",13,84,56,141
https://kawalpemilu.org#65647,"KAMPUNG EMPAT, TARAKAN TIMUR, KOTA TARAKAN, KALIMANTAN UTARA",14,64,61,125
https://kawalpemilu.org#65647,"KAMPUNG EMPAT, TARAKAN TIMUR, KOTA TARAKAN, KALIMANTAN UTARA",15,33,66,99
https://kawalpemilu.org#65647,"KAMPUNG EMPAT, TARAKAN TIMUR, KOTA TARAKAN, KALIMANTAN UTARA",16,44,39,83
https://kawalpemilu.org#65647,"KAMPUNG EMPAT, TARAKAN TIMUR, KOTA TARAKAN, KALIMANTAN UTARA",17,70,99,169
https://kawalpemilu.org#65647,"KAMPUNG EMPAT, TARAKAN TIMUR, KOTA TARAKAN, KALIMANTAN UTARA",18,82,72,154
https://kawalpemilu.org#65648,"KAMPUNG ENAM, TARAKAN TIMUR, KOTA TARAKAN, KALIMANTAN UTARA",1,153,56,209
https://kawalpemilu.org#65648,"KAMPUNG ENAM, TARAKAN TIMUR, KOTA TARAKAN, KALIMANTAN UTARA",2,129,90,219
https://kawalpemilu.org#65648,"KAMPUNG ENAM, TARAKAN TIMUR, KOTA TARAKAN, KALIMANTAN UTARA",4,132,84,216
https://kawalpemilu.org#65648,"KAMPUNG ENAM, TARAKAN TIMUR, KOTA TARAKAN, KALIMANTAN UTARA",5,134,94,228
https://kawalpemilu.org#65648,"KAMPUNG ENAM, TARAKAN TIMUR, KOTA TARAKAN, KALIMANTAN UTARA",6,96,55,151
https://kawalpemilu.org#65648,"KAMPUNG ENAM, TARAKAN TIMUR, KOTA TARAKAN, KALIMANTAN UTARA",7,162,107,269
https://kawalpemilu.org#65648,"KAMPUNG ENAM, TARAKAN TIMUR, KOTA TARAKAN, KALIMANTAN UTARA",8,179,86,265
https://kawalpemilu.org#65648,"KAMPUNG ENAM, TARAKAN TIMUR, KOTA TARAKAN, KALIMANTAN UTARA",9,137,104,241
https://kawalpemilu.org#65648,"KAMPUNG ENAM, TARAKAN TIMUR, KOTA TARAKAN, KALIMANTAN UTARA",10,106,92,198
https://kawalpemilu.org#65648,"KAMPUNG ENAM, TARAKAN TIMUR, KOTA TARAKAN, KALIMANTAN UTARA",11,95,109,204
https://kawalpemilu.org#65648,"KAMPUNG ENAM, TARAKAN TIMUR, KOTA TARAKAN, KALIMANTAN UTARA",12,90,65,155
https://kawalpemilu.org#65648,"KAMPUNG ENAM, TARAKAN TIMUR, KOTA TARAKAN, KALIMANTAN UTARA",13,104,91,195
https://kawalpemilu.org#65648,"KAMPUNG ENAM, TARAKAN TIMUR, KOTA TARAKAN, KALIMANTAN UTARA",14,203,34,237
https://kawalpemilu.org#65648,"KAMPUNG ENAM, TARAKAN TIMUR, KOTA TARAKAN, KALIMANTAN UTARA",15,171,49,220
https://kawalpemilu.org#65648,"KAMPUNG ENAM, TARAKAN TIMUR, KOTA TARAKAN, KALIMANTAN UTARA",16,243,11,254
https://kawalpemilu.org#65648,"KAMPUNG ENAM, TARAKAN TIMUR, KOTA TARAKAN, KALIMANTAN UTARA",17,178,70,248
https://kawalpemilu.org#65649,"MAMBURUNGAN, TARAKAN TIMUR, KOTA TARAKAN, KALIMANTAN UTARA",1,103,117,220
https://kawalpemilu.org#65649,"MAMBURUNGAN, TARAKAN TIMUR, KOTA TARAKAN, KALIMANTAN UTARA",2,86,118,204
https://kawalpemilu.org#65649,"MAMBURUNGAN, TARAKAN TIMUR, KOTA TARAKAN, KALIMANTAN UTARA",3,98,108,206
https://kawalpemilu.org#65649,"MAMBURUNGAN, TARAKAN TIMUR, KOTA TARAKAN, KALIMANTAN UTARA",4,98,140,238
https://kawalpemilu.org#65649,"MAMBURUNGAN, TARAKAN TIMUR, KOTA TARAKAN, KALIMANTAN UTARA",5,97,115,212
https://kawalpemilu.org#65649,"MAMBURUNGAN, TARAKAN TIMUR, KOTA TARAKAN, KALIMANTAN UTARA",6,65,102,167
https://kawalpemilu.org#65649,"MAMBURUNGAN, TARAKAN TIMUR, KOTA TARAKAN, KALIMANTAN UTARA",7,65,127,192
https://kawalpemilu.org#65649,"MAMBURUNGAN, TARAKAN TIMUR, KOTA TARAKAN, KALIMANTAN UTARA",8,53,98,151
https://kawalpemilu.org#65649,"MAMBURUNGAN, TARAKAN TIMUR, KOTA TARAKAN, KALIMANTAN UTARA",9,102,142,244
https://kawalpemilu.org#65649,"MAMBURUNGAN, TARAKAN TIMUR, KOTA TARAKAN, KALIMANTAN UTARA",10,71,113,184
https://kawalpemilu.org#65649,"MAMBURUNGAN, TARAKAN TIMUR, KOTA TARAKAN, KALIMANTAN UTARA",11,129,105,234
https://kawalpemilu.org#65649,"MAMBURUNGAN, TARAKAN TIMUR, KOTA TARAKAN, KALIMANTAN UTARA",12,151,116,267
https://kawalpemilu.org#65649,"MAMBURUNGAN, TARAKAN TIMUR, KOTA TARAKAN, KALIMANTAN UTARA",13,169,85,254
https://kawalpemilu.org#65649,"MAMBURUNGAN, TARAKAN TIMUR, KOTA TARAKAN, KALIMANTAN UTARA",14,66,193,259
https://kawalpemilu.org#65649,"MAMBURUNGAN, TARAKAN TIMUR, KOTA TARAKAN, KALIMANTAN UTARA",15,44,204,248
https://kawalpemilu.org#65649,"MAMBURUNGAN, TARAKAN TIMUR, KOTA TARAKAN, KALIMANTAN UTARA",16,39,227,266
https://kawalpemilu.org#65649,"MAMBURUNGAN, TARAKAN TIMUR, KOTA TARAKAN, KALIMANTAN UTARA",17,31,58,89
https://kawalpemilu.org#65649,"MAMBURUNGAN, TARAKAN TIMUR, KOTA TARAKAN, KALIMANTAN UTARA",18,178,66,244
https://kawalpemilu.org#65649,"MAMBURUNGAN, TARAKAN TIMUR, KOTA TARAKAN, KALIMANTAN UTARA",19,188,56,244
https://kawalpemilu.org#65649,"MAMBURUNGAN, TARAKAN TIMUR, KOTA TARAKAN, KALIMANTAN UTARA",20,145,52,197
https://kawalpemilu.org#65649,"MAMBURUNGAN, TARAKAN TIMUR, KOTA TARAKAN, KALIMANTAN UTARA",21,104,57,161
https://kawalpemilu.org#65649,"MAMBURUNGAN, TARAKAN TIMUR, KOTA TARAKAN, KALIMANTAN UTARA",22,154,78,232
https://kawalpemilu.org#65649,"MAMBURUNGAN, TARAKAN TIMUR, KOTA TARAKAN, KALIMANTAN UTARA",23,179,111,290
https://kawalpemilu.org#65649,"MAMBURUNGAN, TARAKAN TIMUR, KOTA TARAKAN, KALIMANTAN UTARA",24,116,101,217
https://kawalpemilu.org#65650,"PANTAI AMAL, TARAKAN TIMUR, KOTA TARAKAN, KALIMANTAN UTARA",1,103,75,178
https://kawalpemilu.org#65650,"PANTAI AMAL, TARAKAN TIMUR, KOTA TARAKAN, KALIMANTAN UTARA",2,129,75,204
https://kawalpemilu.org#65650,"PANTAI AMAL, TARAKAN TIMUR, KOTA TARAKAN, KALIMANTAN UTARA",3,71,67,138
https://kawalpemilu.org#65650,"PANTAI AMAL, TARAKAN TIMUR, KOTA TARAKAN, KALIMANTAN UTARA",4,209,64,273
https://kawalpemilu.org#65650,"PANTAI AMAL, TARAKAN TIMUR, KOTA TARAKAN, KALIMANTAN UTARA",5,136,31,167
https://kawalpemilu.org#65650,"PANTAI AMAL, TARAKAN TIMUR, KOTA TARAKAN, KALIMANTAN UTARA",6,164,55,219
https://kawalpemilu.org#65650,"PANTAI AMAL, TARAKAN TIMUR, KOTA TARAKAN, KALIMANTAN UTARA",7,201,43,244
https://kawalpemilu.org#65650,"PANTAI AMAL, TARAKAN TIMUR, KOTA TARAKAN, KALIMANTAN UTARA",8,180,36,216
https://kawalpemilu.org#65650,"PANTAI AMAL, TARAKAN TIMUR, KOTA TARAKAN, KALIMANTAN UTARA",9,171,31,202
https://kawalpemilu.org#65650,"PANTAI AMAL, TARAKAN TIMUR, KOTA TARAKAN, KALIMANTAN UTARA",10,182,37,219
https://kawalpemilu.org#65650,"PANTAI AMAL, TARAKAN TIMUR, KOTA TARAKAN, KALIMANTAN UTARA",11,180,67,247
https://kawalpemilu.org#65650,"PANTAI AMAL, TARAKAN TIMUR, KOTA TARAKAN, KALIMANTAN UTARA",12,172,54,226
https://kawalpemilu.org#65650,"PANTAI AMAL, TARAKAN TIMUR, KOTA TARAKAN, KALIMANTAN UTARA",13,196,23,219
https://kawalpemilu.org#65650,"PANTAI AMAL, TARAKAN TIMUR, KOTA TARAKAN, KALIMANTAN UTARA",14,160,49,209
https://kawalpemilu.org#65650,"PANTAI AMAL, TARAKAN TIMUR, KOTA TARAKAN, KALIMANTAN UTARA",15,170,94,264
https://kawalpemilu.org#65650,"PANTAI AMAL, TARAKAN TIMUR, KOTA TARAKAN, KALIMANTAN UTARA",16,97,89,186
https://kawalpemilu.org#65650,"PANTAI AMAL, TARAKAN TIMUR, KOTA TARAKAN, KALIMANTAN UTARA",17,92,27,119
https://kawalpemilu.org#65651,"MAMBURUNGAN TIMUR, TARAKAN TIMUR, KOTA TARAKAN, KALIMANTAN UTARA",1,33,78,111
https://kawalpemilu.org#65651,"MAMBURUNGAN TIMUR, TARAKAN TIMUR, KOTA TARAKAN, KALIMANTAN UTARA",2,76,117,193
https://kawalpemilu.org#65651,"MAMBURUNGAN TIMUR, TARAKAN TIMUR, KOTA TARAKAN, KALIMANTAN UTARA",3,24,108,132
https://kawalpemilu.org#65651,"MAMBURUNGAN TIMUR, TARAKAN TIMUR, KOTA TARAKAN, KALIMANTAN UTARA",4,24,172,196
https://kawalpemilu.org#65651,"MAMBURUNGAN TIMUR, TARAKAN TIMUR, KOTA TARAKAN, KALIMANTAN UTARA",5,24,89,113
https://kawalpemilu.org#65651,"MAMBURUNGAN TIMUR, TARAKAN TIMUR, KOTA TARAKAN, KALIMANTAN UTARA",6,80,137,217
https://kawalpemilu.org#65651,"MAMBURUNGAN TIMUR, TARAKAN TIMUR, KOTA TARAKAN, KALIMANTAN UTARA",7,39,228,267
https://kawalpemilu.org#65651,"MAMBURUNGAN TIMUR, TARAKAN TIMUR, KOTA TARAKAN, KALIMANTAN UTARA",8,40,220,260
https://kawalpemilu.org#65651,"MAMBURUNGAN TIMUR, TARAKAN TIMUR, KOTA TARAKAN, KALIMANTAN UTARA",9,12,265,277
https://kawalpemilu.org#65651,"MAMBURUNGAN TIMUR, TARAKAN TIMUR, KOTA TARAKAN, KALIMANTAN UTARA",10,3,256,259
https://kawalpemilu.org#65653,"JUATA LAUT, TARAKAN UTARA, KOTA TARAKAN, KALIMANTAN UTARA",1,137,99,236
https://kawalpemilu.org#65653,"JUATA LAUT, TARAKAN UTARA, KOTA TARAKAN, KALIMANTAN UTARA",2,136,98,234
https://kawalpemilu.org#65653,"JUATA LAUT, TARAKAN UTARA, KOTA TARAKAN, KALIMANTAN UTARA",3,139,88,227
https://kawalpemilu.org#65653,"JUATA LAUT, TARAKAN UTARA, KOTA TARAKAN, KALIMANTAN UTARA",4,134,67,201
https://kawalpemilu.org#65653,"JUATA LAUT, TARAKAN UTARA, KOTA TARAKAN, KALIMANTAN UTARA",5,147,134,281
https://kawalpemilu.org#65653,"JUATA LAUT, TARAKAN UTARA, KOTA TARAKAN, KALIMANTAN UTARA",6,121,90,211
https://kawalpemilu.org#65653,"JUATA LAUT, TARAKAN UTARA, KOTA TARAKAN, KALIMANTAN UTARA",7,110,85,195
https://kawalpemilu.org#65653,"JUATA LAUT, TARAKAN UTARA, KOTA TARAKAN, KALIMANTAN UTARA",8,111,94,205
https://kawalpemilu.org#65653,"JUATA LAUT, TARAKAN UTARA, KOTA TARAKAN, KALIMANTAN UTARA",9,116,62,178
https://kawalpemilu.org#65653,"JUATA LAUT, TARAKAN UTARA, KOTA TARAKAN, KALIMANTAN UTARA",10,88,75,163
https://kawalpemilu.org#65653,"JUATA LAUT, TARAKAN UTARA, KOTA TARAKAN, KALIMANTAN UTARA",11,107,76,183
https://kawalpemilu.org#65653,"JUATA LAUT, TARAKAN UTARA, KOTA TARAKAN, KALIMANTAN UTARA",12,153,81,234
https://kawalpemilu.org#65653,"JUATA LAUT, TARAKAN UTARA, KOTA TARAKAN, KALIMANTAN UTARA",13,154,62,216
https://kawalpemilu.org#65653,"JUATA LAUT, TARAKAN UTARA, KOTA TARAKAN, KALIMANTAN UTARA",14,185,90,275
https://kawalpemilu.org#65653,"JUATA LAUT, TARAKAN UTARA, KOTA TARAKAN, KALIMANTAN UTARA",15,158,93,251
https://kawalpemilu.org#65653,"JUATA LAUT, TARAKAN UTARA, KOTA TARAKAN, KALIMANTAN UTARA",16,120,114,234
https://kawalpemilu.org#65653,"JUATA LAUT, TARAKAN UTARA, KOTA TARAKAN, KALIMANTAN UTARA",17,112,100,212
https://kawalpemilu.org#65653,"JUATA LAUT, TARAKAN UTARA, KOTA TARAKAN, KALIMANTAN UTARA",18,125,82,207
https://kawalpemilu.org#65653,"JUATA LAUT, TARAKAN UTARA, KOTA TARAKAN, KALIMANTAN UTARA",19,114,75,189
https://kawalpemilu.org#65653,"JUATA LAUT, TARAKAN UTARA, KOTA TARAKAN, KALIMANTAN UTARA",20,127,65,192
https://kawalpemilu.org#65653,"JUATA LAUT, TARAKAN UTARA, KOTA TARAKAN, KALIMANTAN UTARA",21,227,11,239
https://kawalpemilu.org#65653,"JUATA LAUT, TARAKAN UTARA, KOTA TARAKAN, KALIMANTAN UTARA",22,260,21,281
https://kawalpemilu.org#65653,"JUATA LAUT, TARAKAN UTARA, KOTA TARAKAN, KALIMANTAN UTARA",23,204,9,213
https://kawalpemilu.org#65653,"JUATA LAUT, TARAKAN UTARA, KOTA TARAKAN, KALIMANTAN UTARA",24,226,11,237
https://kawalpemilu.org#65653,"JUATA LAUT, TARAKAN UTARA, KOTA TARAKAN, KALIMANTAN UTARA",25,201,23,224
https://kawalpemilu.org#65653,"JUATA LAUT, TARAKAN UTARA, KOTA TARAKAN, KALIMANTAN UTARA",26,101,109,210
https://kawalpemilu.org#65653,"JUATA LAUT, TARAKAN UTARA, KOTA TARAKAN, KALIMANTAN UTARA",27,113,98,211
https://kawalpemilu.org#65653,"JUATA LAUT, TARAKAN UTARA, KOTA TARAKAN, KALIMANTAN UTARA",28,112,91,203
https://kawalpemilu.org#65653,"JUATA LAUT, TARAKAN UTARA, KOTA TARAKAN, KALIMANTAN UTARA",29,123,83,206
https://kawalpemilu.org#65653,"JUATA LAUT, TARAKAN UTARA, KOTA TARAKAN, KALIMANTAN UTARA",30,99,94,193
https://kawalpemilu.org#65653,"JUATA LAUT, TARAKAN UTARA, KOTA TARAKAN, KALIMANTAN UTARA",31,139,64,203
https://kawalpemilu.org#65653,"JUATA LAUT, TARAKAN UTARA, KOTA TARAKAN, KALIMANTAN UTARA",32,136,41,177
https://kawalpemilu.org#65653,"JUATA LAUT, TARAKAN UTARA, KOTA TARAKAN, KALIMANTAN UTARA",33,173,5,178
https://kawalpemilu.org#65653,"JUATA LAUT, TARAKAN UTARA, KOTA TARAKAN, KALIMANTAN UTARA",34,155,3,158
https://kawalpemilu.org#65653,"JUATA LAUT, TARAKAN UTARA, KOTA TARAKAN, KALIMANTAN UTARA",35,151,7,158
https://kawalpemilu.org#65654,"JUATA PERMAI, TARAKAN UTARA, KOTA TARAKAN, KALIMANTAN UTARA",1,149,105,254
https://kawalpemilu.org#65654,"JUATA PERMAI, TARAKAN UTARA, KOTA TARAKAN, KALIMANTAN UTARA",2,113,91,204
https://kawalpemilu.org#65654,"JUATA PERMAI, TARAKAN UTARA, KOTA TARAKAN, KALIMANTAN UTARA",3,115,103,218
https://kawalpemilu.org#65654,"JUATA PERMAI, TARAKAN UTARA, KOTA TARAKAN, KALIMANTAN UTARA",4,165,77,242
https://kawalpemilu.org#65654,"JUATA PERMAI, TARAKAN UTARA, KOTA TARAKAN, KALIMANTAN UTARA",5,163,100,263
https://kawalpemilu.org#65654,"JUATA PERMAI, TARAKAN UTARA, KOTA TARAKAN, KALIMANTAN UTARA",6,161,66,227
https://kawalpemilu.org#65654,"JUATA PERMAI, TARAKAN UTARA, KOTA TARAKAN, KALIMANTAN UTARA",7,185,51,236
https://kawalpemilu.org#65654,"JUATA PERMAI, TARAKAN UTARA, KOTA TARAKAN, KALIMANTAN UTARA",8,182,48,230
https://kawalpemilu.org#65654,"JUATA PERMAI, TARAKAN UTARA, KOTA TARAKAN, KALIMANTAN UTARA",9,155,51,206
https://kawalpemilu.org#65654,"JUATA PERMAI, TARAKAN UTARA, KOTA TARAKAN, KALIMANTAN UTARA",10,129,75,204
https://kawalpemilu.org#65654,"JUATA PERMAI, TARAKAN UTARA, KOTA TARAKAN, KALIMANTAN UTARA",11,169,85,254
https://kawalpemilu.org#65654,"JUATA PERMAI, TARAKAN UTARA, KOTA TARAKAN, KALIMANTAN UTARA",12,122,77,199
https://kawalpemilu.org#65654,"JUATA PERMAI, TARAKAN UTARA, KOTA TARAKAN, KALIMANTAN UTARA",13,105,70,175
https://kawalpemilu.org#65654,"JUATA PERMAI, TARAKAN UTARA, KOTA TARAKAN, KALIMANTAN UTARA",14,119,50,169
https://kawalpemilu.org#65654,"JUATA PERMAI, TARAKAN UTARA, KOTA TARAKAN, KALIMANTAN UTARA",15,176,54,230
https://kawalpemilu.org#65654,"JUATA PERMAI, TARAKAN UTARA, KOTA TARAKAN, KALIMANTAN UTARA",16,115,92,207
https://kawalpemilu.org#65654,"JUATA PERMAI, TARAKAN UTARA, KOTA TARAKAN, KALIMANTAN UTARA",17,149,52,201
https://kawalpemilu.org#65654,"JUATA PERMAI, TARAKAN UTARA, KOTA TARAKAN, KALIMANTAN UTARA",18,224,28,252
https://kawalpemilu.org#65654,"JUATA PERMAI, TARAKAN UTARA, KOTA TARAKAN, KALIMANTAN UTARA",19,148,56,204
https://kawalpemilu.org#65654,"JUATA PERMAI, TARAKAN UTARA, KOTA TARAKAN, KALIMANTAN UTARA",20,146,52,198
https://kawalpemilu.org#65654,"JUATA PERMAI, TARAKAN UTARA, KOTA TARAKAN, KALIMANTAN UTARA",21,165,52,217
https://kawalpemilu.org#65654,"JUATA PERMAI, TARAKAN UTARA, KOTA TARAKAN, KALIMANTAN UTARA",22,155,36,191
https://kawalpemilu.org#65655,"JUATA KERIKIL, TARAKAN UTARA, KOTA TARAKAN, KALIMANTAN UTARA",1,119,53,172
https://kawalpemilu.org#65655,"JUATA KERIKIL, TARAKAN UTARA, KOTA TARAKAN, KALIMANTAN UTARA",2,102,62,164
https://kawalpemilu.org#65655,"JUATA KERIKIL, TARAKAN UTARA, KOTA TARAKAN, KALIMANTAN UTARA",3,112,51,163
https://kawalpemilu.org#65655,"JUATA KERIKIL, TARAKAN UTARA, KOTA TARAKAN, KALIMANTAN UTARA",4,96,59,155
https://kawalpemilu.org#65655,"JUATA KERIKIL, TARAKAN UTARA, KOTA TARAKAN, KALIMANTAN UTARA",5,65,52,117
https://kawalpemilu.org#65655,"JUATA KERIKIL, TARAKAN UTARA, KOTA TARAKAN, KALIMANTAN UTARA",6,73,54,127
https://kawalpemilu.org#65655,"JUATA KERIKIL, TARAKAN UTARA, KOTA TARAKAN, KALIMANTAN UTARA",7,97,62,159
https://kawalpemilu.org#65655,"JUATA KERIKIL, TARAKAN UTARA, KOTA TARAKAN, KALIMANTAN UTARA",8,130,64,194
https://kawalpemilu.org#65655,"JUATA KERIKIL, TARAKAN UTARA, KOTA TARAKAN, KALIMANTAN UTARA",9,129,69,198
https://kawalpemilu.org#65655,"JUATA KERIKIL, TARAKAN UTARA, KOTA TARAKAN, KALIMANTAN UTARA",10,211,34,245
https://kawalpemilu.org#65655,"JUATA KERIKIL, TARAKAN UTARA, KOTA TARAKAN, KALIMANTAN UTARA",11,114,57,171
https://kawalpemilu.org#65655,"JUATA KERIKIL, TARAKAN UTARA, KOTA TARAKAN, KALIMANTAN UTARA",12,170,65,235
https://kawalpemilu.org#65655,"JUATA KERIKIL, TARAKAN UTARA, KOTA TARAKAN, KALIMANTAN UTARA",13,144,54,198
https://kawalpemilu.org#65655,"JUATA KERIKIL, TARAKAN UTARA, KOTA TARAKAN, KALIMANTAN UTARA",14,22,134,156
https://kawalpemilu.org#65655,"JUATA KERIKIL, TARAKAN UTARA, KOTA TARAKAN, KALIMANTAN UTARA",15,145,79,224
https://kawalpemilu.org#65677,"TIDENG PALE, SESAYAP, TANA TIDUNG, KALIMANTAN UTARA",1,141,121,262
https://kawalpemilu.org#65677,"TIDENG PALE, SESAYAP, TANA TIDUNG, KALIMANTAN UTARA",2,156,114,270
https://kawalpemilu.org#65677,"TIDENG PALE, SESAYAP, TANA TIDUNG, KALIMANTAN UTARA",3,123,133,256
https://kawalpemilu.org#65677,"TIDENG PALE, SESAYAP, TANA TIDUNG, KALIMANTAN UTARA",4,154,132,286
https://kawalpemilu.org#65677,"TIDENG PALE, SESAYAP, TANA TIDUNG, KALIMANTAN UTARA",5,123,122,245
https://kawalpemilu.org#65677,"TIDENG PALE, SESAYAP, TANA TIDUNG, KALIMANTAN UTARA",6,128,91,219
https://kawalpemilu.org#65677,"TIDENG PALE, SESAYAP, TANA TIDUNG, KALIMANTAN UTARA",7,145,115,260
https://kawalpemilu.org#65677,"TIDENG PALE, SESAYAP, TANA TIDUNG, KALIMANTAN UTARA",8,138,110,248
https://kawalpemilu.org#65677,"TIDENG PALE, SESAYAP, TANA TIDUNG, KALIMANTAN UTARA",9,110,134,244
https://kawalpemilu.org#65677,"TIDENG PALE, SESAYAP, TANA TIDUNG, KALIMANTAN UTARA",10,80,90,170
https://kawalpemilu.org#65677,"TIDENG PALE, SESAYAP, TANA TIDUNG, KALIMANTAN UTARA",11,115,120,235
https://kawalpemilu.org#65678,"LIMBU SEDULUN, SESAYAP, TANA TIDUNG, KALIMANTAN UTARA",1,155,21,176
https://kawalpemilu.org#65678,"LIMBU SEDULUN, SESAYAP, TANA TIDUNG, KALIMANTAN UTARA",2,116,8,124
https://kawalpemilu.org#65681,"SEBIDAI, SESAYAP, TANA TIDUNG, KALIMANTAN UTARA",1,173,41,214
https://kawalpemilu.org#65681,"SEBIDAI, SESAYAP, TANA TIDUNG, KALIMANTAN UTARA",2,148,44,192
https://kawalpemilu.org#65685,"SEDULUN, SESAYAP, TANA TIDUNG, KALIMANTAN UTARA",1,191,15,206
https://kawalpemilu.org#65685,"SEDULUN, SESAYAP, TANA TIDUNG, KALIMANTAN UTARA",2,93,4,97
https://kawalpemilu.org#65686,"TIDENG PALE TIMUR, SESAYAP, TANA TIDUNG, KALIMANTAN UTARA",1,94,149,243
https://kawalpemilu.org#65686,"TIDENG PALE TIMUR, SESAYAP, TANA TIDUNG, KALIMANTAN UTARA",2,122,135,257
https://kawalpemilu.org#65686,"TIDENG PALE TIMUR, SESAYAP, TANA TIDUNG, KALIMANTAN UTARA",3,69,127,196
https://kawalpemilu.org#65686,"TIDENG PALE TIMUR, SESAYAP, TANA TIDUNG, KALIMANTAN UTARA",4,101,143,244
https://kawalpemilu.org#65686,"TIDENG PALE TIMUR, SESAYAP, TANA TIDUNG, KALIMANTAN UTARA",5,103,138,241
https://kawalpemilu.org#65687,"GUNAWAN, SESAYAP, TANA TIDUNG, KALIMANTAN UTARA",1,120,16,136
https://kawalpemilu.org#65687,"GUNAWAN, SESAYAP, TANA TIDUNG, KALIMANTAN UTARA",2,83,7,90
https://kawalpemilu.org#65688,"SEBAWANG, SESAYAP, TANA TIDUNG, KALIMANTAN UTARA",1,109,20,129
https://kawalpemilu.org#65690,"SESAYAP, SESAYAP HILIR, TANA TIDUNG, KALIMANTAN UTARA",1,115,74,189
https://kawalpemilu.org#65690,"SESAYAP, SESAYAP HILIR, TANA TIDUNG, KALIMANTAN UTARA",2,121,98,219
https://kawalpemilu.org#65690,"SESAYAP, SESAYAP HILIR, TANA TIDUNG, KALIMANTAN UTARA",3,130,95,225
https://kawalpemilu.org#65690,"SESAYAP, SESAYAP HILIR, TANA TIDUNG, KALIMANTAN UTARA",4,47,29,76
https://kawalpemilu.org#65690,"SESAYAP, SESAYAP HILIR, TANA TIDUNG, KALIMANTAN UTARA",5,30,37,67
https://kawalpemilu.org#65690,"SESAYAP, SESAYAP HILIR, TANA TIDUNG, KALIMANTAN UTARA",6,70,56,126
https://kawalpemilu.org#65691,"SENGKONG, SESAYAP HILIR, TANA TIDUNG, KALIMANTAN UTARA",1,141,84,225
https://kawalpemilu.org#65692,"BEBATU, SESAYAP HILIR, TANA TIDUNG, KALIMANTAN UTARA",1,147,82,229
https://kawalpemilu.org#65692,"BEBATU, SESAYAP HILIR, TANA TIDUNG, KALIMANTAN UTARA",2,120,102,222
https://kawalpemilu.org#65693,"BANDAN BIKIS, SESAYAP HILIR, TANA TIDUNG, KALIMANTAN UTARA",1,186,32,218
https://kawalpemilu.org#65695,"SEPALA DALUNG, SESAYAP HILIR, TANA TIDUNG, KALIMANTAN UTARA",1,157,97,254
https://kawalpemilu.org#65695,"SEPALA DALUNG, SESAYAP HILIR, TANA TIDUNG, KALIMANTAN UTARA",2,105,150,255
https://kawalpemilu.org#65695,"SEPALA DALUNG, SESAYAP HILIR, TANA TIDUNG, KALIMANTAN UTARA",3,80,49,129
https://kawalpemilu.org#65695,"SEPALA DALUNG, SESAYAP HILIR, TANA TIDUNG, KALIMANTAN UTARA",4,72,87,159
https://kawalpemilu.org#65696,"SELUDAU, SESAYAP HILIR, TANA TIDUNG, KALIMANTAN UTARA",1,115,26,141
https://kawalpemilu.org#65696,"SELUDAU, SESAYAP HILIR, TANA TIDUNG, KALIMANTAN UTARA",2,107,25,132
https://kawalpemilu.org#65697,"MENJELUTUNG, SESAYAP HILIR, TANA TIDUNG, KALIMANTAN UTARA",1,123,52,175
https://kawalpemilu.org#65697,"MENJELUTUNG, SESAYAP HILIR, TANA TIDUNG, KALIMANTAN UTARA",2,54,42,96
https://kawalpemilu.org#65697,"MENJELUTUNG, SESAYAP HILIR, TANA TIDUNG, KALIMANTAN UTARA",3,98,74,172
https://kawalpemilu.org#931072,"SESAYAP SELOR, SESAYAP HILIR, TANA TIDUNG, KALIMANTAN UTARA",1,98,53,151
https://kawalpemilu.org#931072,"SESAYAP SELOR, SESAYAP HILIR, TANA TIDUNG, KALIMANTAN UTARA",2,112,48,160
https://kawalpemilu.org#65699,"TANAH MERAH, TANA LIA, TANA TIDUNG, KALIMANTAN UTARA",1,105,62,167
https://kawalpemilu.org#65699,"TANAH MERAH, TANA LIA, TANA TIDUNG, KALIMANTAN UTARA",2,66,50,116
https://kawalpemilu.org#65699,"TANAH MERAH, TANA LIA, TANA TIDUNG, KALIMANTAN UTARA",3,54,15,69
https://kawalpemilu.org#65699,"TANAH MERAH, TANA LIA, TANA TIDUNG, KALIMANTAN UTARA",4,62,1,63
https://kawalpemilu.org#65699,"TANAH MERAH, TANA LIA, TANA TIDUNG, KALIMANTAN UTARA",5,109,58,167
https://kawalpemilu.org#65700,"TENGKU DACING, TANA LIA, TANA TIDUNG, KALIMANTAN UTARA",1,96,42,138
https://kawalpemilu.org#65700,"TENGKU DACING, TANA LIA, TANA TIDUNG, KALIMANTAN UTARA",2,103,44,147
https://kawalpemilu.org#65701,"SAMBUNGAN, TANA LIA, TANA TIDUNG, KALIMANTAN UTARA",1,112,97,209
https://kawalpemilu.org#931073,"TANAH MERAH BARAT, TANA LIA, TANA TIDUNG, KALIMANTAN UTARA",1,163,79,242
https://kawalpemilu.org#931073,"TANAH MERAH BARAT, TANA LIA, TANA TIDUNG, KALIMANTAN UTARA",2,146,65,211
https://kawalpemilu.org#931074,"SAMBUNGAN SELATAN, TANA LIA, TANA TIDUNG, KALIMANTAN UTARA",1,120,51,171
https://kawalpemilu.org#931074,"SAMBUNGAN SELATAN, TANA LIA, TANA TIDUNG, KALIMANTAN UTARA",2,113,43,156
https://kawalpemilu.org#65683,"KUJAU, BETAYAU, TANA TIDUNG, KALIMANTAN UTARA",1,158,13,171
https://kawalpemilu.org#65683,"KUJAU, BETAYAU, TANA TIDUNG, KALIMANTAN UTARA",2,81,19,100
https://kawalpemilu.org#65684,"BEBAKUNG, BETAYAU, TANA TIDUNG, KALIMANTAN UTARA",1,274,13,287
https://kawalpemilu.org#65694,"BUONG BARU, BETAYAU, TANA TIDUNG, KALIMANTAN UTARA",1,154,90,244
https://kawalpemilu.org#65694,"BUONG BARU, BETAYAU, TANA TIDUNG, KALIMANTAN UTARA",2,107,52,159
https://kawalpemilu.org#85505,"MENDUPO, BETAYAU, TANA TIDUNG, KALIMANTAN UTARA",1,118,7,125
https://kawalpemilu.org#89186,"MANING, BETAYAU, TANA TIDUNG, KALIMANTAN UTARA",1,197,44,241
https://kawalpemilu.org#89187,"PERIUK, BETAYAU, TANA TIDUNG, KALIMANTAN UTARA",1,80,4,84
https://kawalpemilu.org#928535,"BALAYAN ARI, MURUK RIAN, TANA TIDUNG, KALIMANTAN UTARA",1,79,5,84
https://kawalpemilu.org#928536,"RIAN RAYO, MURUK RIAN, TANA TIDUNG, KALIMANTAN UTARA",1,145,9,154
https://kawalpemilu.org#928537,"KAPUAK, MURUK RIAN, TANA TIDUNG, KALIMANTAN UTARA",1,113,13,126
https://kawalpemilu.org#928538,"SAPARI, MURUK RIAN, TANA TIDUNG, KALIMANTAN UTARA",1,135,11,146
https://kawalpemilu.org#929147,"SEPUTUK, MURUK RIAN, TANA TIDUNG, KALIMANTAN UTARA",1,207,12,219
https://kawalpemilu.org#929148,"RIAN, MURUK RIAN, TANA TIDUNG, KALIMANTAN UTARA",1,156,13,169
