Link KawalPemilu,Nama Kelurahan,Nomor TPS,Suara 01,Suara 02,Suara Sah
https://kawalpemilu.org#24996,"SUNGAILIAT, SUNGAILIAT, BANGKA, KEPULAUAN BANGKA BELITUNG",1,104,66,170
https://kawalpemilu.org#24996,"SUNGAILIAT, SUNGAILIAT, BANGKA, KEPULAUAN BANGKA BELITUNG",2,127,47,174
https://kawalpemilu.org#24996,"SUNGAILIAT, SUNGAILIAT, BANGKA, KEPULAUAN BANGKA BELITUNG",3,116,62,178
https://kawalpemilu.org#24996,"SUNGAILIAT, SUNGAILIAT, BANGKA, KEPULAUAN BANGKA BELITUNG",4,87,61,148
https://kawalpemilu.org#24996,"SUNGAILIAT, SUNGAILIAT, BANGKA, KEPULAUAN BANGKA BELITUNG",5,139,76,215
https://kawalpemilu.org#24996,"SUNGAILIAT, SUNGAILIAT, BANGKA, KEPULAUAN BANGKA BELITUNG",6,114,57,171
https://kawalpemilu.org#24996,"SUNGAILIAT, SUNGAILIAT, BANGKA, KEPULAUAN BANGKA BELITUNG",7,87,68,155
https://kawalpemilu.org#24996,"SUNGAILIAT, SUNGAILIAT, BANGKA, KEPULAUAN BANGKA BELITUNG",8,62,52,114
https://kawalpemilu.org#24996,"SUNGAILIAT, SUNGAILIAT, BANGKA, KEPULAUAN BANGKA BELITUNG",9,103,70,173
https://kawalpemilu.org#24996,"SUNGAILIAT, SUNGAILIAT, BANGKA, KEPULAUAN BANGKA BELITUNG",10,167,34,201
https://kawalpemilu.org#24996,"SUNGAILIAT, SUNGAILIAT, BANGKA, KEPULAUAN BANGKA BELITUNG",11,135,23,158
https://kawalpemilu.org#24996,"SUNGAILIAT, SUNGAILIAT, BANGKA, KEPULAUAN BANGKA BELITUNG",12,108,49,157
https://kawalpemilu.org#24996,"SUNGAILIAT, SUNGAILIAT, BANGKA, KEPULAUAN BANGKA BELITUNG",13,90,58,148
https://kawalpemilu.org#24996,"SUNGAILIAT, SUNGAILIAT, BANGKA, KEPULAUAN BANGKA BELITUNG",14,122,67,189
https://kawalpemilu.org#24996,"SUNGAILIAT, SUNGAILIAT, BANGKA, KEPULAUAN BANGKA BELITUNG",15,134,49,183
https://kawalpemilu.org#24996,"SUNGAILIAT, SUNGAILIAT, BANGKA, KEPULAUAN BANGKA BELITUNG",16,162,30,192
https://kawalpemilu.org#24996,"SUNGAILIAT, SUNGAILIAT, BANGKA, KEPULAUAN BANGKA BELITUNG",17,149,78,227
https://kawalpemilu.org#24996,"SUNGAILIAT, SUNGAILIAT, BANGKA, KEPULAUAN BANGKA BELITUNG",18,115,103,218
https://kawalpemilu.org#24996,"SUNGAILIAT, SUNGAILIAT, BANGKA, KEPULAUAN BANGKA BELITUNG",19,84,75,159
https://kawalpemilu.org#24996,"SUNGAILIAT, SUNGAILIAT, BANGKA, KEPULAUAN BANGKA BELITUNG",20,91,94,185
https://kawalpemilu.org#24996,"SUNGAILIAT, SUNGAILIAT, BANGKA, KEPULAUAN BANGKA BELITUNG",21,143,11,154
https://kawalpemilu.org#24996,"SUNGAILIAT, SUNGAILIAT, BANGKA, KEPULAUAN BANGKA BELITUNG",22,212,5,217
https://kawalpemilu.org#24996,"SUNGAILIAT, SUNGAILIAT, BANGKA, KEPULAUAN BANGKA BELITUNG",23,139,56,195
https://kawalpemilu.org#24996,"SUNGAILIAT, SUNGAILIAT, BANGKA, KEPULAUAN BANGKA BELITUNG",24,164,43,207
https://kawalpemilu.org#24996,"SUNGAILIAT, SUNGAILIAT, BANGKA, KEPULAUAN BANGKA BELITUNG",25,188,8,196
https://kawalpemilu.org#24996,"SUNGAILIAT, SUNGAILIAT, BANGKA, KEPULAUAN BANGKA BELITUNG",26,155,38,193
https://kawalpemilu.org#24996,"SUNGAILIAT, SUNGAILIAT, BANGKA, KEPULAUAN BANGKA BELITUNG",27,127,61,188
https://kawalpemilu.org#24996,"SUNGAILIAT, SUNGAILIAT, BANGKA, KEPULAUAN BANGKA BELITUNG",28,99,36,135
https://kawalpemilu.org#24996,"SUNGAILIAT, SUNGAILIAT, BANGKA, KEPULAUAN BANGKA BELITUNG",29,131,64,195
https://kawalpemilu.org#24996,"SUNGAILIAT, SUNGAILIAT, BANGKA, KEPULAUAN BANGKA BELITUNG",30,112,48,160
https://kawalpemilu.org#24996,"SUNGAILIAT, SUNGAILIAT, BANGKA, KEPULAUAN BANGKA BELITUNG",31,126,51,177
https://kawalpemilu.org#24996,"SUNGAILIAT, SUNGAILIAT, BANGKA, KEPULAUAN BANGKA BELITUNG",32,106,68,174
https://kawalpemilu.org#24996,"SUNGAILIAT, SUNGAILIAT, BANGKA, KEPULAUAN BANGKA BELITUNG",33,119,40,159
https://kawalpemilu.org#24996,"SUNGAILIAT, SUNGAILIAT, BANGKA, KEPULAUAN BANGKA BELITUNG",34,129,72,201
https://kawalpemilu.org#24996,"SUNGAILIAT, SUNGAILIAT, BANGKA, KEPULAUAN BANGKA BELITUNG",35,93,39,132
https://kawalpemilu.org#24996,"SUNGAILIAT, SUNGAILIAT, BANGKA, KEPULAUAN BANGKA BELITUNG",36,115,39,154
https://kawalpemilu.org#24996,"SUNGAILIAT, SUNGAILIAT, BANGKA, KEPULAUAN BANGKA BELITUNG",37,111,55,166
https://kawalpemilu.org#24996,"SUNGAILIAT, SUNGAILIAT, BANGKA, KEPULAUAN BANGKA BELITUNG",38,131,85,216
https://kawalpemilu.org#24996,"SUNGAILIAT, SUNGAILIAT, BANGKA, KEPULAUAN BANGKA BELITUNG",39,108,46,154
https://kawalpemilu.org#24996,"SUNGAILIAT, SUNGAILIAT, BANGKA, KEPULAUAN BANGKA BELITUNG",40,121,37,158
https://kawalpemilu.org#24996,"SUNGAILIAT, SUNGAILIAT, BANGKA, KEPULAUAN BANGKA BELITUNG",41,142,50,192
https://kawalpemilu.org#24996,"SUNGAILIAT, SUNGAILIAT, BANGKA, KEPULAUAN BANGKA BELITUNG",42,115,60,175
https://kawalpemilu.org#24996,"SUNGAILIAT, SUNGAILIAT, BANGKA, KEPULAUAN BANGKA BELITUNG",43,136,39,175
https://kawalpemilu.org#24996,"SUNGAILIAT, SUNGAILIAT, BANGKA, KEPULAUAN BANGKA BELITUNG",45,116,42,158
https://kawalpemilu.org#24996,"SUNGAILIAT, SUNGAILIAT, BANGKA, KEPULAUAN BANGKA BELITUNG",46,158,47,209
https://kawalpemilu.org#24996,"SUNGAILIAT, SUNGAILIAT, BANGKA, KEPULAUAN BANGKA BELITUNG",47,94,54,148
https://kawalpemilu.org#24996,"SUNGAILIAT, SUNGAILIAT, BANGKA, KEPULAUAN BANGKA BELITUNG",48,121,53,174
https://kawalpemilu.org#24996,"SUNGAILIAT, SUNGAILIAT, BANGKA, KEPULAUAN BANGKA BELITUNG",49,140,69,209
https://kawalpemilu.org#24996,"SUNGAILIAT, SUNGAILIAT, BANGKA, KEPULAUAN BANGKA BELITUNG",50,148,38,186
https://kawalpemilu.org#24996,"SUNGAILIAT, SUNGAILIAT, BANGKA, KEPULAUAN BANGKA BELITUNG",51,97,108,205
https://kawalpemilu.org#24996,"SUNGAILIAT, SUNGAILIAT, BANGKA, KEPULAUAN BANGKA BELITUNG",52,61,138,199
https://kawalpemilu.org#24996,"SUNGAILIAT, SUNGAILIAT, BANGKA, KEPULAUAN BANGKA BELITUNG",53,95,107,202
https://kawalpemilu.org#24996,"SUNGAILIAT, SUNGAILIAT, BANGKA, KEPULAUAN BANGKA BELITUNG",54,83,70,153
https://kawalpemilu.org#24996,"SUNGAILIAT, SUNGAILIAT, BANGKA, KEPULAUAN BANGKA BELITUNG",55,87,84,171
https://kawalpemilu.org#24996,"SUNGAILIAT, SUNGAILIAT, BANGKA, KEPULAUAN BANGKA BELITUNG",56,96,101,197
https://kawalpemilu.org#24996,"SUNGAILIAT, SUNGAILIAT, BANGKA, KEPULAUAN BANGKA BELITUNG",57,114,97,211
https://kawalpemilu.org#24996,"SUNGAILIAT, SUNGAILIAT, BANGKA, KEPULAUAN BANGKA BELITUNG",58,81,117,198
https://kawalpemilu.org#24996,"SUNGAILIAT, SUNGAILIAT, BANGKA, KEPULAUAN BANGKA BELITUNG",59,87,119,206
https://kawalpemilu.org#24996,"SUNGAILIAT, SUNGAILIAT, BANGKA, KEPULAUAN BANGKA BELITUNG",60,87,85,172
https://kawalpemilu.org#24997,"SRI MENANTI, SUNGAILIAT, BANGKA, KEPULAUAN BANGKA BELITUNG",1,127,106,233
https://kawalpemilu.org#24997,"SRI MENANTI, SUNGAILIAT, BANGKA, KEPULAUAN BANGKA BELITUNG",2,116,123,239
https://kawalpemilu.org#24997,"SRI MENANTI, SUNGAILIAT, BANGKA, KEPULAUAN BANGKA BELITUNG",3,135,106,241
https://kawalpemilu.org#24997,"SRI MENANTI, SUNGAILIAT, BANGKA, KEPULAUAN BANGKA BELITUNG",4,141,104,245
https://kawalpemilu.org#24997,"SRI MENANTI, SUNGAILIAT, BANGKA, KEPULAUAN BANGKA BELITUNG",5,127,83,210
https://kawalpemilu.org#24997,"SRI MENANTI, SUNGAILIAT, BANGKA, KEPULAUAN BANGKA BELITUNG",6,153,77,230
https://kawalpemilu.org#24997,"SRI MENANTI, SUNGAILIAT, BANGKA, KEPULAUAN BANGKA BELITUNG",7,93,114,207
https://kawalpemilu.org#24997,"SRI MENANTI, SUNGAILIAT, BANGKA, KEPULAUAN BANGKA BELITUNG",8,98,117,215
https://kawalpemilu.org#24997,"SRI MENANTI, SUNGAILIAT, BANGKA, KEPULAUAN BANGKA BELITUNG",9,139,88,227
https://kawalpemilu.org#24997,"SRI MENANTI, SUNGAILIAT, BANGKA, KEPULAUAN BANGKA BELITUNG",10,108,100,208
https://kawalpemilu.org#24997,"SRI MENANTI, SUNGAILIAT, BANGKA, KEPULAUAN BANGKA BELITUNG",11,102,92,194
https://kawalpemilu.org#24997,"SRI MENANTI, SUNGAILIAT, BANGKA, KEPULAUAN BANGKA BELITUNG",12,124,103,227
https://kawalpemilu.org#24997,"SRI MENANTI, SUNGAILIAT, BANGKA, KEPULAUAN BANGKA BELITUNG",13,129,68,197
https://kawalpemilu.org#24997,"SRI MENANTI, SUNGAILIAT, BANGKA, KEPULAUAN BANGKA BELITUNG",14,125,47,172
https://kawalpemilu.org#24997,"SRI MENANTI, SUNGAILIAT, BANGKA, KEPULAUAN BANGKA BELITUNG",15,124,71,195
https://kawalpemilu.org#24997,"SRI MENANTI, SUNGAILIAT, BANGKA, KEPULAUAN BANGKA BELITUNG",16,133,71,204
https://kawalpemilu.org#24997,"SRI MENANTI, SUNGAILIAT, BANGKA, KEPULAUAN BANGKA BELITUNG",17,140,95,235
https://kawalpemilu.org#24997,"SRI MENANTI, SUNGAILIAT, BANGKA, KEPULAUAN BANGKA BELITUNG",18,99,141,240
https://kawalpemilu.org#24997,"SRI MENANTI, SUNGAILIAT, BANGKA, KEPULAUAN BANGKA BELITUNG",19,114,127,241
https://kawalpemilu.org#24997,"SRI MENANTI, SUNGAILIAT, BANGKA, KEPULAUAN BANGKA BELITUNG",20,94,127,221
https://kawalpemilu.org#24997,"SRI MENANTI, SUNGAILIAT, BANGKA, KEPULAUAN BANGKA BELITUNG",21,130,126,256
https://kawalpemilu.org#24997,"SRI MENANTI, SUNGAILIAT, BANGKA, KEPULAUAN BANGKA BELITUNG",22,135,117,252
https://kawalpemilu.org#24997,"SRI MENANTI, SUNGAILIAT, BANGKA, KEPULAUAN BANGKA BELITUNG",23,126,116,242
https://kawalpemilu.org#24997,"SRI MENANTI, SUNGAILIAT, BANGKA, KEPULAUAN BANGKA BELITUNG",24,106,158,264
https://kawalpemilu.org#24997,"SRI MENANTI, SUNGAILIAT, BANGKA, KEPULAUAN BANGKA BELITUNG",25,120,127,247
https://kawalpemilu.org#24997,"SRI MENANTI, SUNGAILIAT, BANGKA, KEPULAUAN BANGKA BELITUNG",26,198,63,261
https://kawalpemilu.org#24997,"SRI MENANTI, SUNGAILIAT, BANGKA, KEPULAUAN BANGKA BELITUNG",27,139,109,244
https://kawalpemilu.org#24997,"SRI MENANTI, SUNGAILIAT, BANGKA, KEPULAUAN BANGKA BELITUNG",28,106,161,267
https://kawalpemilu.org#24997,"SRI MENANTI, SUNGAILIAT, BANGKA, KEPULAUAN BANGKA BELITUNG",29,115,138,253
https://kawalpemilu.org#24997,"SRI MENANTI, SUNGAILIAT, BANGKA, KEPULAUAN BANGKA BELITUNG",30,121,61,182
https://kawalpemilu.org#24997,"SRI MENANTI, SUNGAILIAT, BANGKA, KEPULAUAN BANGKA BELITUNG",31,107,58,165
https://kawalpemilu.org#24997,"SRI MENANTI, SUNGAILIAT, BANGKA, KEPULAUAN BANGKA BELITUNG",32,143,33,176
https://kawalpemilu.org#24998,"KUDAI, SUNGAILIAT, BANGKA, KEPULAUAN BANGKA BELITUNG",1,126,110,236
https://kawalpemilu.org#24998,"KUDAI, SUNGAILIAT, BANGKA, KEPULAUAN BANGKA BELITUNG",2,129,104,233
https://kawalpemilu.org#24998,"KUDAI, SUNGAILIAT, BANGKA, KEPULAUAN BANGKA BELITUNG",3,121,125,246
https://kawalpemilu.org#24998,"KUDAI, SUNGAILIAT, BANGKA, KEPULAUAN BANGKA BELITUNG",4,175,71,246
https://kawalpemilu.org#24998,"KUDAI, SUNGAILIAT, BANGKA, KEPULAUAN BANGKA BELITUNG",5,167,93,260
https://kawalpemilu.org#24998,"KUDAI, SUNGAILIAT, BANGKA, KEPULAUAN BANGKA BELITUNG",6,188,40,228
https://kawalpemilu.org#24998,"KUDAI, SUNGAILIAT, BANGKA, KEPULAUAN BANGKA BELITUNG",7,199,6,205
https://kawalpemilu.org#24998,"KUDAI, SUNGAILIAT, BANGKA, KEPULAUAN BANGKA BELITUNG",8,126,8,134
https://kawalpemilu.org#24998,"KUDAI, SUNGAILIAT, BANGKA, KEPULAUAN BANGKA BELITUNG",9,129,4,133
https://kawalpemilu.org#24998,"KUDAI, SUNGAILIAT, BANGKA, KEPULAUAN BANGKA BELITUNG",10,171,5,176
https://kawalpemilu.org#24998,"KUDAI, SUNGAILIAT, BANGKA, KEPULAUAN BANGKA BELITUNG",11,146,15,161
https://kawalpemilu.org#24998,"KUDAI, SUNGAILIAT, BANGKA, KEPULAUAN BANGKA BELITUNG",12,192,15,207
https://kawalpemilu.org#24998,"KUDAI, SUNGAILIAT, BANGKA, KEPULAUAN BANGKA BELITUNG",13,155,6,161
https://kawalpemilu.org#24998,"KUDAI, SUNGAILIAT, BANGKA, KEPULAUAN BANGKA BELITUNG",14,154,5,159
https://kawalpemilu.org#24998,"KUDAI, SUNGAILIAT, BANGKA, KEPULAUAN BANGKA BELITUNG",15,190,21,211
https://kawalpemilu.org#24999,"SINAR BARU, SUNGAILIAT, BANGKA, KEPULAUAN BANGKA BELITUNG",1,200,5,205
https://kawalpemilu.org#24999,"SINAR BARU, SUNGAILIAT, BANGKA, KEPULAUAN BANGKA BELITUNG",2,133,99,232
https://kawalpemilu.org#24999,"SINAR BARU, SUNGAILIAT, BANGKA, KEPULAUAN BANGKA BELITUNG",3,114,113,227
https://kawalpemilu.org#24999,"SINAR BARU, SUNGAILIAT, BANGKA, KEPULAUAN BANGKA BELITUNG",4,100,104,204
https://kawalpemilu.org#24999,"SINAR BARU, SUNGAILIAT, BANGKA, KEPULAUAN BANGKA BELITUNG",5,133,95,228
https://kawalpemilu.org#24999,"SINAR BARU, SUNGAILIAT, BANGKA, KEPULAUAN BANGKA BELITUNG",6,126,85,211
https://kawalpemilu.org#24999,"SINAR BARU, SUNGAILIAT, BANGKA, KEPULAUAN BANGKA BELITUNG",7,113,86,199
https://kawalpemilu.org#25000,"KENANGA, SUNGAILIAT, BANGKA, KEPULAUAN BANGKA BELITUNG",1,105,145,250
https://kawalpemilu.org#25000,"KENANGA, SUNGAILIAT, BANGKA, KEPULAUAN BANGKA BELITUNG",2,110,146,256
https://kawalpemilu.org#25000,"KENANGA, SUNGAILIAT, BANGKA, KEPULAUAN BANGKA BELITUNG",3,120,125,245
https://kawalpemilu.org#25000,"KENANGA, SUNGAILIAT, BANGKA, KEPULAUAN BANGKA BELITUNG",4,116,107,223
https://kawalpemilu.org#25000,"KENANGA, SUNGAILIAT, BANGKA, KEPULAUAN BANGKA BELITUNG",5,166,96,242
https://kawalpemilu.org#25000,"KENANGA, SUNGAILIAT, BANGKA, KEPULAUAN BANGKA BELITUNG",6,139,95,234
https://kawalpemilu.org#25000,"KENANGA, SUNGAILIAT, BANGKA, KEPULAUAN BANGKA BELITUNG",7,115,79,194
https://kawalpemilu.org#25000,"KENANGA, SUNGAILIAT, BANGKA, KEPULAUAN BANGKA BELITUNG",8,109,86,195
https://kawalpemilu.org#25000,"KENANGA, SUNGAILIAT, BANGKA, KEPULAUAN BANGKA BELITUNG",9,176,20,196
https://kawalpemilu.org#25000,"KENANGA, SUNGAILIAT, BANGKA, KEPULAUAN BANGKA BELITUNG",10,199,6,205
https://kawalpemilu.org#25000,"KENANGA, SUNGAILIAT, BANGKA, KEPULAUAN BANGKA BELITUNG",11,153,0,153
https://kawalpemilu.org#25000,"KENANGA, SUNGAILIAT, BANGKA, KEPULAUAN BANGKA BELITUNG",12,155,11,166
https://kawalpemilu.org#25000,"KENANGA, SUNGAILIAT, BANGKA, KEPULAUAN BANGKA BELITUNG",13,177,6,183
https://kawalpemilu.org#25000,"KENANGA, SUNGAILIAT, BANGKA, KEPULAUAN BANGKA BELITUNG",14,133,4,137
https://kawalpemilu.org#25000,"KENANGA, SUNGAILIAT, BANGKA, KEPULAUAN BANGKA BELITUNG",15,159,4,163
https://kawalpemilu.org#25000,"KENANGA, SUNGAILIAT, BANGKA, KEPULAUAN BANGKA BELITUNG",16,180,3,183
https://kawalpemilu.org#25001,"PARIT PADANG, SUNGAILIAT, BANGKA, KEPULAUAN BANGKA BELITUNG",1,83,150,233
https://kawalpemilu.org#25001,"PARIT PADANG, SUNGAILIAT, BANGKA, KEPULAUAN BANGKA BELITUNG",2,93,155,248
https://kawalpemilu.org#25001,"PARIT PADANG, SUNGAILIAT, BANGKA, KEPULAUAN BANGKA BELITUNG",4,92,144,236
https://kawalpemilu.org#25001,"PARIT PADANG, SUNGAILIAT, BANGKA, KEPULAUAN BANGKA BELITUNG",5,90,129,219
https://kawalpemilu.org#25001,"PARIT PADANG, SUNGAILIAT, BANGKA, KEPULAUAN BANGKA BELITUNG",6,87,196,283
https://kawalpemilu.org#25001,"PARIT PADANG, SUNGAILIAT, BANGKA, KEPULAUAN BANGKA BELITUNG",7,105,162,267
https://kawalpemilu.org#25001,"PARIT PADANG, SUNGAILIAT, BANGKA, KEPULAUAN BANGKA BELITUNG",8,80,152,232
https://kawalpemilu.org#25001,"PARIT PADANG, SUNGAILIAT, BANGKA, KEPULAUAN BANGKA BELITUNG",9,111,129,240
https://kawalpemilu.org#25001,"PARIT PADANG, SUNGAILIAT, BANGKA, KEPULAUAN BANGKA BELITUNG",10,65,188,253
https://kawalpemilu.org#25001,"PARIT PADANG, SUNGAILIAT, BANGKA, KEPULAUAN BANGKA BELITUNG",11,95,174,269
https://kawalpemilu.org#25001,"PARIT PADANG, SUNGAILIAT, BANGKA, KEPULAUAN BANGKA BELITUNG",12,94,161,255
https://kawalpemilu.org#25001,"PARIT PADANG, SUNGAILIAT, BANGKA, KEPULAUAN BANGKA BELITUNG",13,157,104,261
https://kawalpemilu.org#25001,"PARIT PADANG, SUNGAILIAT, BANGKA, KEPULAUAN BANGKA BELITUNG",14,164,117,281
https://kawalpemilu.org#25001,"PARIT PADANG, SUNGAILIAT, BANGKA, KEPULAUAN BANGKA BELITUNG",15,148,58,206
https://kawalpemilu.org#25001,"PARIT PADANG, SUNGAILIAT, BANGKA, KEPULAUAN BANGKA BELITUNG",16,165,75,240
https://kawalpemilu.org#25001,"PARIT PADANG, SUNGAILIAT, BANGKA, KEPULAUAN BANGKA BELITUNG",17,124,137,261
https://kawalpemilu.org#25001,"PARIT PADANG, SUNGAILIAT, BANGKA, KEPULAUAN BANGKA BELITUNG",18,153,69,222
https://kawalpemilu.org#25001,"PARIT PADANG, SUNGAILIAT, BANGKA, KEPULAUAN BANGKA BELITUNG",19,168,12,180
https://kawalpemilu.org#25001,"PARIT PADANG, SUNGAILIAT, BANGKA, KEPULAUAN BANGKA BELITUNG",20,113,50,163
https://kawalpemilu.org#25001,"PARIT PADANG, SUNGAILIAT, BANGKA, KEPULAUAN BANGKA BELITUNG",21,164,70,234
https://kawalpemilu.org#25001,"PARIT PADANG, SUNGAILIAT, BANGKA, KEPULAUAN BANGKA BELITUNG",22,145,51,196
https://kawalpemilu.org#25002,"REBO, SUNGAILIAT, BANGKA, KEPULAUAN BANGKA BELITUNG",1,196,16,212
https://kawalpemilu.org#25002,"REBO, SUNGAILIAT, BANGKA, KEPULAUAN BANGKA BELITUNG",2,191,8,199
https://kawalpemilu.org#25002,"REBO, SUNGAILIAT, BANGKA, KEPULAUAN BANGKA BELITUNG",3,194,7,201
https://kawalpemilu.org#25002,"REBO, SUNGAILIAT, BANGKA, KEPULAUAN BANGKA BELITUNG",4,175,3,178
https://kawalpemilu.org#25002,"REBO, SUNGAILIAT, BANGKA, KEPULAUAN BANGKA BELITUNG",5,199,2,201
https://kawalpemilu.org#25002,"REBO, SUNGAILIAT, BANGKA, KEPULAUAN BANGKA BELITUNG",6,188,6,194
https://kawalpemilu.org#25002,"REBO, SUNGAILIAT, BANGKA, KEPULAUAN BANGKA BELITUNG",7,151,11,162
https://kawalpemilu.org#25002,"REBO, SUNGAILIAT, BANGKA, KEPULAUAN BANGKA BELITUNG",8,190,5,195
https://kawalpemilu.org#25002,"REBO, SUNGAILIAT, BANGKA, KEPULAUAN BANGKA BELITUNG",9,148,109,257
https://kawalpemilu.org#25002,"REBO, SUNGAILIAT, BANGKA, KEPULAUAN BANGKA BELITUNG",10,103,143,246
https://kawalpemilu.org#25002,"REBO, SUNGAILIAT, BANGKA, KEPULAUAN BANGKA BELITUNG",11,118,139,257
https://kawalpemilu.org#25002,"REBO, SUNGAILIAT, BANGKA, KEPULAUAN BANGKA BELITUNG",12,166,75,241
https://kawalpemilu.org#929412,"SINAR JAYA JELUTUNG, SUNGAILIAT, BANGKA, KEPULAUAN BANGKA BELITUNG",1,199,68,267
https://kawalpemilu.org#929412,"SINAR JAYA JELUTUNG, SUNGAILIAT, BANGKA, KEPULAUAN BANGKA BELITUNG",2,162,68,230
https://kawalpemilu.org#929412,"SINAR JAYA JELUTUNG, SUNGAILIAT, BANGKA, KEPULAUAN BANGKA BELITUNG",3,177,72,249
https://kawalpemilu.org#929412,"SINAR JAYA JELUTUNG, SUNGAILIAT, BANGKA, KEPULAUAN BANGKA BELITUNG",4,181,61,242
https://kawalpemilu.org#929412,"SINAR JAYA JELUTUNG, SUNGAILIAT, BANGKA, KEPULAUAN BANGKA BELITUNG",5,136,106,242
https://kawalpemilu.org#929412,"SINAR JAYA JELUTUNG, SUNGAILIAT, BANGKA, KEPULAUAN BANGKA BELITUNG",6,165,97,262
https://kawalpemilu.org#929412,"SINAR JAYA JELUTUNG, SUNGAILIAT, BANGKA, KEPULAUAN BANGKA BELITUNG",7,152,109,261
https://kawalpemilu.org#929412,"SINAR JAYA JELUTUNG, SUNGAILIAT, BANGKA, KEPULAUAN BANGKA BELITUNG",8,114,119,233
https://kawalpemilu.org#929412,"SINAR JAYA JELUTUNG, SUNGAILIAT, BANGKA, KEPULAUAN BANGKA BELITUNG",9,105,100,205
https://kawalpemilu.org#929412,"SINAR JAYA JELUTUNG, SUNGAILIAT, BANGKA, KEPULAUAN BANGKA BELITUNG",10,128,102,230
https://kawalpemilu.org#929412,"SINAR JAYA JELUTUNG, SUNGAILIAT, BANGKA, KEPULAUAN BANGKA BELITUNG",11,97,109,206
https://kawalpemilu.org#929412,"SINAR JAYA JELUTUNG, SUNGAILIAT, BANGKA, KEPULAUAN BANGKA BELITUNG",12,133,84,217
https://kawalpemilu.org#929412,"SINAR JAYA JELUTUNG, SUNGAILIAT, BANGKA, KEPULAUAN BANGKA BELITUNG",13,185,11,196
https://kawalpemilu.org#929412,"SINAR JAYA JELUTUNG, SUNGAILIAT, BANGKA, KEPULAUAN BANGKA BELITUNG",14,199,4,203
https://kawalpemilu.org#929413,"MATRAS, SUNGAILIAT, BANGKA, KEPULAUAN BANGKA BELITUNG",1,173,40,213
https://kawalpemilu.org#929413,"MATRAS, SUNGAILIAT, BANGKA, KEPULAUAN BANGKA BELITUNG",2,182,34,216
https://kawalpemilu.org#929413,"MATRAS, SUNGAILIAT, BANGKA, KEPULAUAN BANGKA BELITUNG",3,135,134,269
https://kawalpemilu.org#929413,"MATRAS, SUNGAILIAT, BANGKA, KEPULAUAN BANGKA BELITUNG",4,136,102,238
https://kawalpemilu.org#929413,"MATRAS, SUNGAILIAT, BANGKA, KEPULAUAN BANGKA BELITUNG",5,136,85,221
https://kawalpemilu.org#929413,"MATRAS, SUNGAILIAT, BANGKA, KEPULAUAN BANGKA BELITUNG",6,162,59,221
https://kawalpemilu.org#929413,"MATRAS, SUNGAILIAT, BANGKA, KEPULAUAN BANGKA BELITUNG",7,142,58,200
https://kawalpemilu.org#929413,"MATRAS, SUNGAILIAT, BANGKA, KEPULAUAN BANGKA BELITUNG",8,125,82,207
https://kawalpemilu.org#929413,"MATRAS, SUNGAILIAT, BANGKA, KEPULAUAN BANGKA BELITUNG",9,195,6,201
https://kawalpemilu.org#929413,"MATRAS, SUNGAILIAT, BANGKA, KEPULAUAN BANGKA BELITUNG",10,170,44,214
https://kawalpemilu.org#929414,"JELITIK, SUNGAILIAT, BANGKA, KEPULAUAN BANGKA BELITUNG",1,171,4,175
https://kawalpemilu.org#929414,"JELITIK, SUNGAILIAT, BANGKA, KEPULAUAN BANGKA BELITUNG",2,174,7,181
https://kawalpemilu.org#929414,"JELITIK, SUNGAILIAT, BANGKA, KEPULAUAN BANGKA BELITUNG",3,145,3,148
https://kawalpemilu.org#929414,"JELITIK, SUNGAILIAT, BANGKA, KEPULAUAN BANGKA BELITUNG",4,194,13,207
https://kawalpemilu.org#929414,"JELITIK, SUNGAILIAT, BANGKA, KEPULAUAN BANGKA BELITUNG",5,137,77,214
https://kawalpemilu.org#929414,"JELITIK, SUNGAILIAT, BANGKA, KEPULAUAN BANGKA BELITUNG",6,167,67,234
https://kawalpemilu.org#929414,"JELITIK, SUNGAILIAT, BANGKA, KEPULAUAN BANGKA BELITUNG",7,167,69,236
https://kawalpemilu.org#929414,"JELITIK, SUNGAILIAT, BANGKA, KEPULAUAN BANGKA BELITUNG",8,137,88,225
https://kawalpemilu.org#929414,"JELITIK, SUNGAILIAT, BANGKA, KEPULAUAN BANGKA BELITUNG",9,174,94,268
https://kawalpemilu.org#929414,"JELITIK, SUNGAILIAT, BANGKA, KEPULAUAN BANGKA BELITUNG",10,229,13,242
https://kawalpemilu.org#929414,"JELITIK, SUNGAILIAT, BANGKA, KEPULAUAN BANGKA BELITUNG",11,225,4,229
https://kawalpemilu.org#929415,"SURYA TIMUR, SUNGAILIAT, BANGKA, KEPULAUAN BANGKA BELITUNG",1,147,63,210
https://kawalpemilu.org#929415,"SURYA TIMUR, SUNGAILIAT, BANGKA, KEPULAUAN BANGKA BELITUNG",2,134,70,204
https://kawalpemilu.org#929415,"SURYA TIMUR, SUNGAILIAT, BANGKA, KEPULAUAN BANGKA BELITUNG",3,146,45,191
https://kawalpemilu.org#929415,"SURYA TIMUR, SUNGAILIAT, BANGKA, KEPULAUAN BANGKA BELITUNG",4,148,68,216
https://kawalpemilu.org#929415,"SURYA TIMUR, SUNGAILIAT, BANGKA, KEPULAUAN BANGKA BELITUNG",5,92,154,246
https://kawalpemilu.org#929415,"SURYA TIMUR, SUNGAILIAT, BANGKA, KEPULAUAN BANGKA BELITUNG",6,209,13,222
https://kawalpemilu.org#929415,"SURYA TIMUR, SUNGAILIAT, BANGKA, KEPULAUAN BANGKA BELITUNG",7,167,43,210
https://kawalpemilu.org#929415,"SURYA TIMUR, SUNGAILIAT, BANGKA, KEPULAUAN BANGKA BELITUNG",8,140,60,200
https://kawalpemilu.org#929416,"LUBUK KELIK, SUNGAILIAT, BANGKA, KEPULAUAN BANGKA BELITUNG",1,104,146,250
https://kawalpemilu.org#929416,"LUBUK KELIK, SUNGAILIAT, BANGKA, KEPULAUAN BANGKA BELITUNG",2,154,61,215
https://kawalpemilu.org#929416,"LUBUK KELIK, SUNGAILIAT, BANGKA, KEPULAUAN BANGKA BELITUNG",3,174,8,182
https://kawalpemilu.org#929416,"LUBUK KELIK, SUNGAILIAT, BANGKA, KEPULAUAN BANGKA BELITUNG",4,95,57,152
https://kawalpemilu.org#929416,"LUBUK KELIK, SUNGAILIAT, BANGKA, KEPULAUAN BANGKA BELITUNG",5,149,14,163
https://kawalpemilu.org#929416,"LUBUK KELIK, SUNGAILIAT, BANGKA, KEPULAUAN BANGKA BELITUNG",6,142,19,161
https://kawalpemilu.org#929416,"LUBUK KELIK, SUNGAILIAT, BANGKA, KEPULAUAN BANGKA BELITUNG",7,136,49,185
https://kawalpemilu.org#929416,"LUBUK KELIK, SUNGAILIAT, BANGKA, KEPULAUAN BANGKA BELITUNG",8,30,43,73
https://kawalpemilu.org#929416,"LUBUK KELIK, SUNGAILIAT, BANGKA, KEPULAUAN BANGKA BELITUNG",9,78,134,212
https://kawalpemilu.org#929417,"BUKIT BETUNG, SUNGAILIAT, BANGKA, KEPULAUAN BANGKA BELITUNG",1,55,149,204
https://kawalpemilu.org#929417,"BUKIT BETUNG, SUNGAILIAT, BANGKA, KEPULAUAN BANGKA BELITUNG",2,80,120,200
https://kawalpemilu.org#929417,"BUKIT BETUNG, SUNGAILIAT, BANGKA, KEPULAUAN BANGKA BELITUNG",3,63,132,195
https://kawalpemilu.org#929417,"BUKIT BETUNG, SUNGAILIAT, BANGKA, KEPULAUAN BANGKA BELITUNG",4,86,109,195
https://kawalpemilu.org#929417,"BUKIT BETUNG, SUNGAILIAT, BANGKA, KEPULAUAN BANGKA BELITUNG",5,106,118,224
https://kawalpemilu.org#929417,"BUKIT BETUNG, SUNGAILIAT, BANGKA, KEPULAUAN BANGKA BELITUNG",6,80,142,222
https://kawalpemilu.org#929417,"BUKIT BETUNG, SUNGAILIAT, BANGKA, KEPULAUAN BANGKA BELITUNG",7,40,102,142
https://kawalpemilu.org#929417,"BUKIT BETUNG, SUNGAILIAT, BANGKA, KEPULAUAN BANGKA BELITUNG",8,58,113,171
https://kawalpemilu.org#929417,"BUKIT BETUNG, SUNGAILIAT, BANGKA, KEPULAUAN BANGKA BELITUNG",9,74,175,249
https://kawalpemilu.org#929417,"BUKIT BETUNG, SUNGAILIAT, BANGKA, KEPULAUAN BANGKA BELITUNG",10,80,159,239
https://kawalpemilu.org#929417,"BUKIT BETUNG, SUNGAILIAT, BANGKA, KEPULAUAN BANGKA BELITUNG",11,62,165,227
https://kawalpemilu.org#929417,"BUKIT BETUNG, SUNGAILIAT, BANGKA, KEPULAUAN BANGKA BELITUNG",12,48,116,164
https://kawalpemilu.org#929417,"BUKIT BETUNG, SUNGAILIAT, BANGKA, KEPULAUAN BANGKA BELITUNG",13,54,92,146
https://kawalpemilu.org#929417,"BUKIT BETUNG, SUNGAILIAT, BANGKA, KEPULAUAN BANGKA BELITUNG",14,56,109,165
https://kawalpemilu.org#929417,"BUKIT BETUNG, SUNGAILIAT, BANGKA, KEPULAUAN BANGKA BELITUNG",15,66,126,192
https://kawalpemilu.org#929417,"BUKIT BETUNG, SUNGAILIAT, BANGKA, KEPULAUAN BANGKA BELITUNG",16,63,134,197
https://kawalpemilu.org#929417,"BUKIT BETUNG, SUNGAILIAT, BANGKA, KEPULAUAN BANGKA BELITUNG",17,74,155,229
https://kawalpemilu.org#929417,"BUKIT BETUNG, SUNGAILIAT, BANGKA, KEPULAUAN BANGKA BELITUNG",18,58,119,177
https://kawalpemilu.org#929417,"BUKIT BETUNG, SUNGAILIAT, BANGKA, KEPULAUAN BANGKA BELITUNG",19,41,129,170
https://kawalpemilu.org#929417,"BUKIT BETUNG, SUNGAILIAT, BANGKA, KEPULAUAN BANGKA BELITUNG",20,64,164,228
https://kawalpemilu.org#929417,"BUKIT BETUNG, SUNGAILIAT, BANGKA, KEPULAUAN BANGKA BELITUNG",21,97,130,227
https://kawalpemilu.org#929417,"BUKIT BETUNG, SUNGAILIAT, BANGKA, KEPULAUAN BANGKA BELITUNG",22,78,141,219
https://kawalpemilu.org#25004,"KUTO PANJI, BELINYU, BANGKA, KEPULAUAN BANGKA BELITUNG",1,141,42,183
https://kawalpemilu.org#25004,"KUTO PANJI, BELINYU, BANGKA, KEPULAUAN BANGKA BELITUNG",2,134,74,208
https://kawalpemilu.org#25004,"KUTO PANJI, BELINYU, BANGKA, KEPULAUAN BANGKA BELITUNG",3,111,44,155
https://kawalpemilu.org#25004,"KUTO PANJI, BELINYU, BANGKA, KEPULAUAN BANGKA BELITUNG",4,81,66,147
https://kawalpemilu.org#25004,"KUTO PANJI, BELINYU, BANGKA, KEPULAUAN BANGKA BELITUNG",5,100,43,143
https://kawalpemilu.org#25004,"KUTO PANJI, BELINYU, BANGKA, KEPULAUAN BANGKA BELITUNG",6,98,26,124
https://kawalpemilu.org#25004,"KUTO PANJI, BELINYU, BANGKA, KEPULAUAN BANGKA BELITUNG",7,126,31,157
https://kawalpemilu.org#25004,"KUTO PANJI, BELINYU, BANGKA, KEPULAUAN BANGKA BELITUNG",8,110,35,145
https://kawalpemilu.org#25004,"KUTO PANJI, BELINYU, BANGKA, KEPULAUAN BANGKA BELITUNG",9,112,0,112
https://kawalpemilu.org#25004,"KUTO PANJI, BELINYU, BANGKA, KEPULAUAN BANGKA BELITUNG",10,81,2,83
https://kawalpemilu.org#25004,"KUTO PANJI, BELINYU, BANGKA, KEPULAUAN BANGKA BELITUNG",11,148,4,152
https://kawalpemilu.org#25004,"KUTO PANJI, BELINYU, BANGKA, KEPULAUAN BANGKA BELITUNG",12,106,2,108
https://kawalpemilu.org#25004,"KUTO PANJI, BELINYU, BANGKA, KEPULAUAN BANGKA BELITUNG",13,133,5,138
https://kawalpemilu.org#25004,"KUTO PANJI, BELINYU, BANGKA, KEPULAUAN BANGKA BELITUNG",14,118,1,119
https://kawalpemilu.org#25004,"KUTO PANJI, BELINYU, BANGKA, KEPULAUAN BANGKA BELITUNG",15,165,6,171
https://kawalpemilu.org#25004,"KUTO PANJI, BELINYU, BANGKA, KEPULAUAN BANGKA BELITUNG",16,134,2,136
https://kawalpemilu.org#25004,"KUTO PANJI, BELINYU, BANGKA, KEPULAUAN BANGKA BELITUNG",17,132,2,134
https://kawalpemilu.org#25004,"KUTO PANJI, BELINYU, BANGKA, KEPULAUAN BANGKA BELITUNG",18,185,10,195
https://kawalpemilu.org#25004,"KUTO PANJI, BELINYU, BANGKA, KEPULAUAN BANGKA BELITUNG",19,104,33,137
https://kawalpemilu.org#25004,"KUTO PANJI, BELINYU, BANGKA, KEPULAUAN BANGKA BELITUNG",20,107,44,151
https://kawalpemilu.org#25004,"KUTO PANJI, BELINYU, BANGKA, KEPULAUAN BANGKA BELITUNG",21,99,56,155
https://kawalpemilu.org#25004,"KUTO PANJI, BELINYU, BANGKA, KEPULAUAN BANGKA BELITUNG",22,94,37,131
https://kawalpemilu.org#25004,"KUTO PANJI, BELINYU, BANGKA, KEPULAUAN BANGKA BELITUNG",23,139,24,163
https://kawalpemilu.org#25004,"KUTO PANJI, BELINYU, BANGKA, KEPULAUAN BANGKA BELITUNG",24,146,43,189
https://kawalpemilu.org#25004,"KUTO PANJI, BELINYU, BANGKA, KEPULAUAN BANGKA BELITUNG",25,122,44,166
https://kawalpemilu.org#25004,"KUTO PANJI, BELINYU, BANGKA, KEPULAUAN BANGKA BELITUNG",26,148,37,185
https://kawalpemilu.org#25004,"KUTO PANJI, BELINYU, BANGKA, KEPULAUAN BANGKA BELITUNG",27,125,54,179
https://kawalpemilu.org#25005,"AIR JUKUNG, BELINYU, BANGKA, KEPULAUAN BANGKA BELITUNG",1,142,76,218
https://kawalpemilu.org#25005,"AIR JUKUNG, BELINYU, BANGKA, KEPULAUAN BANGKA BELITUNG",2,166,80,246
https://kawalpemilu.org#25005,"AIR JUKUNG, BELINYU, BANGKA, KEPULAUAN BANGKA BELITUNG",3,149,64,213
https://kawalpemilu.org#25005,"AIR JUKUNG, BELINYU, BANGKA, KEPULAUAN BANGKA BELITUNG",4,148,86,234
https://kawalpemilu.org#25005,"AIR JUKUNG, BELINYU, BANGKA, KEPULAUAN BANGKA BELITUNG",5,122,85,207
https://kawalpemilu.org#25005,"AIR JUKUNG, BELINYU, BANGKA, KEPULAUAN BANGKA BELITUNG",6,154,70,224
https://kawalpemilu.org#25005,"AIR JUKUNG, BELINYU, BANGKA, KEPULAUAN BANGKA BELITUNG",7,105,104,209
https://kawalpemilu.org#25005,"AIR JUKUNG, BELINYU, BANGKA, KEPULAUAN BANGKA BELITUNG",8,139,73,212
https://kawalpemilu.org#25005,"AIR JUKUNG, BELINYU, BANGKA, KEPULAUAN BANGKA BELITUNG",9,158,60,218
https://kawalpemilu.org#25005,"AIR JUKUNG, BELINYU, BANGKA, KEPULAUAN BANGKA BELITUNG",10,171,53,224
https://kawalpemilu.org#25005,"AIR JUKUNG, BELINYU, BANGKA, KEPULAUAN BANGKA BELITUNG",11,173,76,249
https://kawalpemilu.org#25006,"BUKIT KETOK, BELINYU, BANGKA, KEPULAUAN BANGKA BELITUNG",1,75,43,118
https://kawalpemilu.org#25006,"BUKIT KETOK, BELINYU, BANGKA, KEPULAUAN BANGKA BELITUNG",2,84,39,123
https://kawalpemilu.org#25006,"BUKIT KETOK, BELINYU, BANGKA, KEPULAUAN BANGKA BELITUNG",3,155,66,221
https://kawalpemilu.org#25006,"BUKIT KETOK, BELINYU, BANGKA, KEPULAUAN BANGKA BELITUNG",4,135,67,202
https://kawalpemilu.org#25006,"BUKIT KETOK, BELINYU, BANGKA, KEPULAUAN BANGKA BELITUNG",5,144,61,205
https://kawalpemilu.org#25006,"BUKIT KETOK, BELINYU, BANGKA, KEPULAUAN BANGKA BELITUNG",6,123,69,192
https://kawalpemilu.org#25006,"BUKIT KETOK, BELINYU, BANGKA, KEPULAUAN BANGKA BELITUNG",7,124,21,145
https://kawalpemilu.org#25006,"BUKIT KETOK, BELINYU, BANGKA, KEPULAUAN BANGKA BELITUNG",8,158,50,208
https://kawalpemilu.org#25006,"BUKIT KETOK, BELINYU, BANGKA, KEPULAUAN BANGKA BELITUNG",9,166,13,179
https://kawalpemilu.org#25006,"BUKIT KETOK, BELINYU, BANGKA, KEPULAUAN BANGKA BELITUNG",10,177,29,206
https://kawalpemilu.org#25006,"BUKIT KETOK, BELINYU, BANGKA, KEPULAUAN BANGKA BELITUNG",11,191,26,217
https://kawalpemilu.org#25006,"BUKIT KETOK, BELINYU, BANGKA, KEPULAUAN BANGKA BELITUNG",12,182,29,211
https://kawalpemilu.org#25007,"GUNUNG MUDA, BELINYU, BANGKA, KEPULAUAN BANGKA BELITUNG",1,160,9,169
https://kawalpemilu.org#25007,"GUNUNG MUDA, BELINYU, BANGKA, KEPULAUAN BANGKA BELITUNG",2,173,7,180
https://kawalpemilu.org#25007,"GUNUNG MUDA, BELINYU, BANGKA, KEPULAUAN BANGKA BELITUNG",3,158,32,190
https://kawalpemilu.org#25007,"GUNUNG MUDA, BELINYU, BANGKA, KEPULAUAN BANGKA BELITUNG",4,134,48,182
https://kawalpemilu.org#25007,"GUNUNG MUDA, BELINYU, BANGKA, KEPULAUAN BANGKA BELITUNG",5,129,43,172
https://kawalpemilu.org#25007,"GUNUNG MUDA, BELINYU, BANGKA, KEPULAUAN BANGKA BELITUNG",6,130,45,175
https://kawalpemilu.org#25007,"GUNUNG MUDA, BELINYU, BANGKA, KEPULAUAN BANGKA BELITUNG",7,163,51,214
https://kawalpemilu.org#25007,"GUNUNG MUDA, BELINYU, BANGKA, KEPULAUAN BANGKA BELITUNG",8,180,34,214
https://kawalpemilu.org#25007,"GUNUNG MUDA, BELINYU, BANGKA, KEPULAUAN BANGKA BELITUNG",9,149,69,218
https://kawalpemilu.org#25007,"GUNUNG MUDA, BELINYU, BANGKA, KEPULAUAN BANGKA BELITUNG",10,178,37,215
https://kawalpemilu.org#25007,"GUNUNG MUDA, BELINYU, BANGKA, KEPULAUAN BANGKA BELITUNG",11,168,27,195
https://kawalpemilu.org#25007,"GUNUNG MUDA, BELINYU, BANGKA, KEPULAUAN BANGKA BELITUNG",12,174,37,211
https://kawalpemilu.org#25007,"GUNUNG MUDA, BELINYU, BANGKA, KEPULAUAN BANGKA BELITUNG",13,177,16,193
https://kawalpemilu.org#25007,"GUNUNG MUDA, BELINYU, BANGKA, KEPULAUAN BANGKA BELITUNG",14,183,6,189
https://kawalpemilu.org#25007,"GUNUNG MUDA, BELINYU, BANGKA, KEPULAUAN BANGKA BELITUNG",15,160,26,186
https://kawalpemilu.org#25007,"GUNUNG MUDA, BELINYU, BANGKA, KEPULAUAN BANGKA BELITUNG",16,151,29,180
https://kawalpemilu.org#25008,"GUNUNG PELAWAN, BELINYU, BANGKA, KEPULAUAN BANGKA BELITUNG",1,156,32,188
https://kawalpemilu.org#25008,"GUNUNG PELAWAN, BELINYU, BANGKA, KEPULAUAN BANGKA BELITUNG",2,141,21,162
https://kawalpemilu.org#25008,"GUNUNG PELAWAN, BELINYU, BANGKA, KEPULAUAN BANGKA BELITUNG",3,155,7,162
https://kawalpemilu.org#25008,"GUNUNG PELAWAN, BELINYU, BANGKA, KEPULAUAN BANGKA BELITUNG",4,142,4,146
https://kawalpemilu.org#25008,"GUNUNG PELAWAN, BELINYU, BANGKA, KEPULAUAN BANGKA BELITUNG",5,168,23,191
https://kawalpemilu.org#25008,"GUNUNG PELAWAN, BELINYU, BANGKA, KEPULAUAN BANGKA BELITUNG",6,159,30,189
https://kawalpemilu.org#25008,"GUNUNG PELAWAN, BELINYU, BANGKA, KEPULAUAN BANGKA BELITUNG",7,186,16,202
https://kawalpemilu.org#25008,"GUNUNG PELAWAN, BELINYU, BANGKA, KEPULAUAN BANGKA BELITUNG",8,138,23,161
https://kawalpemilu.org#25008,"GUNUNG PELAWAN, BELINYU, BANGKA, KEPULAUAN BANGKA BELITUNG",9,141,15,156
https://kawalpemilu.org#25008,"GUNUNG PELAWAN, BELINYU, BANGKA, KEPULAUAN BANGKA BELITUNG",10,152,27,179
https://kawalpemilu.org#25008,"GUNUNG PELAWAN, BELINYU, BANGKA, KEPULAUAN BANGKA BELITUNG",11,153,23,176
https://kawalpemilu.org#25009,"RIDING PANJANG, BELINYU, BANGKA, KEPULAUAN BANGKA BELITUNG",1,208,36,244
https://kawalpemilu.org#25009,"RIDING PANJANG, BELINYU, BANGKA, KEPULAUAN BANGKA BELITUNG",2,134,37,171
https://kawalpemilu.org#25009,"RIDING PANJANG, BELINYU, BANGKA, KEPULAUAN BANGKA BELITUNG",3,193,41,234
https://kawalpemilu.org#25009,"RIDING PANJANG, BELINYU, BANGKA, KEPULAUAN BANGKA BELITUNG",4,191,51,242
https://kawalpemilu.org#25009,"RIDING PANJANG, BELINYU, BANGKA, KEPULAUAN BANGKA BELITUNG",5,127,7,134
https://kawalpemilu.org#25009,"RIDING PANJANG, BELINYU, BANGKA, KEPULAUAN BANGKA BELITUNG",6,174,48,222
https://kawalpemilu.org#25009,"RIDING PANJANG, BELINYU, BANGKA, KEPULAUAN BANGKA BELITUNG",7,157,8,165
https://kawalpemilu.org#25009,"RIDING PANJANG, BELINYU, BANGKA, KEPULAUAN BANGKA BELITUNG",8,184,18,202
https://kawalpemilu.org#25009,"RIDING PANJANG, BELINYU, BANGKA, KEPULAUAN BANGKA BELITUNG",9,125,23,148
https://kawalpemilu.org#25009,"RIDING PANJANG, BELINYU, BANGKA, KEPULAUAN BANGKA BELITUNG",10,159,13,172
https://kawalpemilu.org#25009,"RIDING PANJANG, BELINYU, BANGKA, KEPULAUAN BANGKA BELITUNG",11,101,12,113
https://kawalpemilu.org#25010,"LUMUT, BELINYU, BANGKA, KEPULAUAN BANGKA BELITUNG",1,81,54,135
https://kawalpemilu.org#25010,"LUMUT, BELINYU, BANGKA, KEPULAUAN BANGKA BELITUNG",2,128,29,157
https://kawalpemilu.org#25010,"LUMUT, BELINYU, BANGKA, KEPULAUAN BANGKA BELITUNG",3,144,3,147
https://kawalpemilu.org#25010,"LUMUT, BELINYU, BANGKA, KEPULAUAN BANGKA BELITUNG",4,95,1,96
https://kawalpemilu.org#25010,"LUMUT, BELINYU, BANGKA, KEPULAUAN BANGKA BELITUNG",5,95,3,98
https://kawalpemilu.org#25010,"LUMUT, BELINYU, BANGKA, KEPULAUAN BANGKA BELITUNG",6,96,6,102
https://kawalpemilu.org#25010,"LUMUT, BELINYU, BANGKA, KEPULAUAN BANGKA BELITUNG",7,96,1,97
https://kawalpemilu.org#25010,"LUMUT, BELINYU, BANGKA, KEPULAUAN BANGKA BELITUNG",8,117,39,156
https://kawalpemilu.org#25011,"BINTET, BELINYU, BANGKA, KEPULAUAN BANGKA BELITUNG",1,189,11,200
https://kawalpemilu.org#25011,"BINTET, BELINYU, BANGKA, KEPULAUAN BANGKA BELITUNG",2,162,20,182
https://kawalpemilu.org#25011,"BINTET, BELINYU, BANGKA, KEPULAUAN BANGKA BELITUNG",3,124,24,148
https://kawalpemilu.org#25011,"BINTET, BELINYU, BANGKA, KEPULAUAN BANGKA BELITUNG",4,121,13,134
https://kawalpemilu.org#25011,"BINTET, BELINYU, BANGKA, KEPULAUAN BANGKA BELITUNG",5,120,23,143
https://kawalpemilu.org#25011,"BINTET, BELINYU, BANGKA, KEPULAUAN BANGKA BELITUNG",6,122,5,127
https://kawalpemilu.org#25011,"BINTET, BELINYU, BANGKA, KEPULAUAN BANGKA BELITUNG",7,144,5,149
https://kawalpemilu.org#25011,"BINTET, BELINYU, BANGKA, KEPULAUAN BANGKA BELITUNG",8,146,1,147
https://kawalpemilu.org#25011,"BINTET, BELINYU, BANGKA, KEPULAUAN BANGKA BELITUNG",9,145,1,146
https://kawalpemilu.org#931113,"REMODONG INDAH, BELINYU, BANGKA, KEPULAUAN BANGKA BELITUNG",1,159,4,163
https://kawalpemilu.org#931113,"REMODONG INDAH, BELINYU, BANGKA, KEPULAUAN BANGKA BELITUNG",2,168,10,178
https://kawalpemilu.org#931113,"REMODONG INDAH, BELINYU, BANGKA, KEPULAUAN BANGKA BELITUNG",3,203,13,216
https://kawalpemilu.org#931113,"REMODONG INDAH, BELINYU, BANGKA, KEPULAUAN BANGKA BELITUNG",4,160,1,161
https://kawalpemilu.org#931113,"REMODONG INDAH, BELINYU, BANGKA, KEPULAUAN BANGKA BELITUNG",5,149,11,160
https://kawalpemilu.org#931113,"REMODONG INDAH, BELINYU, BANGKA, KEPULAUAN BANGKA BELITUNG",6,137,26,163
https://kawalpemilu.org#931113,"REMODONG INDAH, BELINYU, BANGKA, KEPULAUAN BANGKA BELITUNG",7,175,18,193
https://kawalpemilu.org#931114,"AIR ASAM, BELINYU, BANGKA, KEPULAUAN BANGKA BELITUNG",1,143,36,179
https://kawalpemilu.org#931114,"AIR ASAM, BELINYU, BANGKA, KEPULAUAN BANGKA BELITUNG",2,129,49,178
https://kawalpemilu.org#931114,"AIR ASAM, BELINYU, BANGKA, KEPULAUAN BANGKA BELITUNG",3,135,49,184
https://kawalpemilu.org#931114,"AIR ASAM, BELINYU, BANGKA, KEPULAUAN BANGKA BELITUNG",4,90,106,196
https://kawalpemilu.org#931114,"AIR ASAM, BELINYU, BANGKA, KEPULAUAN BANGKA BELITUNG",5,66,127,193
https://kawalpemilu.org#931114,"AIR ASAM, BELINYU, BANGKA, KEPULAUAN BANGKA BELITUNG",6,77,95,172
https://kawalpemilu.org#931114,"AIR ASAM, BELINYU, BANGKA, KEPULAUAN BANGKA BELITUNG",7,81,107,188
https://kawalpemilu.org#931114,"AIR ASAM, BELINYU, BANGKA, KEPULAUAN BANGKA BELITUNG",8,114,63,177
https://kawalpemilu.org#931114,"AIR ASAM, BELINYU, BANGKA, KEPULAUAN BANGKA BELITUNG",9,126,33,159
https://kawalpemilu.org#931115,"MANTUNG, BELINYU, BANGKA, KEPULAUAN BANGKA BELITUNG",1,148,78,226
https://kawalpemilu.org#931115,"MANTUNG, BELINYU, BANGKA, KEPULAUAN BANGKA BELITUNG",2,168,49,217
https://kawalpemilu.org#931115,"MANTUNG, BELINYU, BANGKA, KEPULAUAN BANGKA BELITUNG",3,184,47,231
https://kawalpemilu.org#931115,"MANTUNG, BELINYU, BANGKA, KEPULAUAN BANGKA BELITUNG",4,158,33,191
https://kawalpemilu.org#931115,"MANTUNG, BELINYU, BANGKA, KEPULAUAN BANGKA BELITUNG",5,176,49,225
https://kawalpemilu.org#931115,"MANTUNG, BELINYU, BANGKA, KEPULAUAN BANGKA BELITUNG",6,173,54,227
https://kawalpemilu.org#931115,"MANTUNG, BELINYU, BANGKA, KEPULAUAN BANGKA BELITUNG",7,124,67,191
https://kawalpemilu.org#931115,"MANTUNG, BELINYU, BANGKA, KEPULAUAN BANGKA BELITUNG",8,180,43,223
https://kawalpemilu.org#931115,"MANTUNG, BELINYU, BANGKA, KEPULAUAN BANGKA BELITUNG",9,164,32,196
https://kawalpemilu.org#931116,"BELINYU, BELINYU, BANGKA, KEPULAUAN BANGKA BELITUNG",1,119,0,119
https://kawalpemilu.org#931116,"BELINYU, BELINYU, BANGKA, KEPULAUAN BANGKA BELITUNG",2,92,15,107
https://kawalpemilu.org#931116,"BELINYU, BELINYU, BANGKA, KEPULAUAN BANGKA BELITUNG",3,127,5,132
https://kawalpemilu.org#931116,"BELINYU, BELINYU, BANGKA, KEPULAUAN BANGKA BELITUNG",4,181,3,184
https://kawalpemilu.org#931116,"BELINYU, BELINYU, BANGKA, KEPULAUAN BANGKA BELITUNG",5,117,73,190
https://kawalpemilu.org#931116,"BELINYU, BELINYU, BANGKA, KEPULAUAN BANGKA BELITUNG",6,72,55,127
https://kawalpemilu.org#931116,"BELINYU, BELINYU, BANGKA, KEPULAUAN BANGKA BELITUNG",7,114,64,178
https://kawalpemilu.org#931116,"BELINYU, BELINYU, BANGKA, KEPULAUAN BANGKA BELITUNG",8,125,65,190
https://kawalpemilu.org#931116,"BELINYU, BELINYU, BANGKA, KEPULAUAN BANGKA BELITUNG",9,91,34,125
https://kawalpemilu.org#931116,"BELINYU, BELINYU, BANGKA, KEPULAUAN BANGKA BELITUNG",10,102,38,140
https://kawalpemilu.org#931116,"BELINYU, BELINYU, BANGKA, KEPULAUAN BANGKA BELITUNG",11,98,46,144
https://kawalpemilu.org#931116,"BELINYU, BELINYU, BANGKA, KEPULAUAN BANGKA BELITUNG",12,101,36,137
https://kawalpemilu.org#931116,"BELINYU, BELINYU, BANGKA, KEPULAUAN BANGKA BELITUNG",13,98,54,152
https://kawalpemilu.org#931116,"BELINYU, BELINYU, BANGKA, KEPULAUAN BANGKA BELITUNG",14,103,63,166
https://kawalpemilu.org#931116,"BELINYU, BELINYU, BANGKA, KEPULAUAN BANGKA BELITUNG",15,102,52,154
https://kawalpemilu.org#931116,"BELINYU, BELINYU, BANGKA, KEPULAUAN BANGKA BELITUNG",16,76,59,135
https://kawalpemilu.org#931116,"BELINYU, BELINYU, BANGKA, KEPULAUAN BANGKA BELITUNG",17,81,54,135
https://kawalpemilu.org#931116,"BELINYU, BELINYU, BANGKA, KEPULAUAN BANGKA BELITUNG",18,114,42,156
https://kawalpemilu.org#931116,"BELINYU, BELINYU, BANGKA, KEPULAUAN BANGKA BELITUNG",19,82,15,97
https://kawalpemilu.org#25013,"BATU RUSA, MERAWANG, BANGKA, KEPULAUAN BANGKA BELITUNG",1,79,169,248
https://kawalpemilu.org#25013,"BATU RUSA, MERAWANG, BANGKA, KEPULAUAN BANGKA BELITUNG",2,84,150,234
https://kawalpemilu.org#25013,"BATU RUSA, MERAWANG, BANGKA, KEPULAUAN BANGKA BELITUNG",3,74,155,229
https://kawalpemilu.org#25013,"BATU RUSA, MERAWANG, BANGKA, KEPULAUAN BANGKA BELITUNG",4,70,165,235
https://kawalpemilu.org#25013,"BATU RUSA, MERAWANG, BANGKA, KEPULAUAN BANGKA BELITUNG",5,65,111,176
https://kawalpemilu.org#25013,"BATU RUSA, MERAWANG, BANGKA, KEPULAUAN BANGKA BELITUNG",6,100,106,206
https://kawalpemilu.org#25013,"BATU RUSA, MERAWANG, BANGKA, KEPULAUAN BANGKA BELITUNG",7,140,70,210
https://kawalpemilu.org#25013,"BATU RUSA, MERAWANG, BANGKA, KEPULAUAN BANGKA BELITUNG",8,139,52,191
https://kawalpemilu.org#25013,"BATU RUSA, MERAWANG, BANGKA, KEPULAUAN BANGKA BELITUNG",9,144,102,7
https://kawalpemilu.org#25013,"BATU RUSA, MERAWANG, BANGKA, KEPULAUAN BANGKA BELITUNG",10,114,127,241
https://kawalpemilu.org#25013,"BATU RUSA, MERAWANG, BANGKA, KEPULAUAN BANGKA BELITUNG",11,84,151,235
https://kawalpemilu.org#25013,"BATU RUSA, MERAWANG, BANGKA, KEPULAUAN BANGKA BELITUNG",12,116,92,208
https://kawalpemilu.org#25014,"BALUN IJUK, MERAWANG, BANGKA, KEPULAUAN BANGKA BELITUNG",1,162,96,258
https://kawalpemilu.org#25014,"BALUN IJUK, MERAWANG, BANGKA, KEPULAUAN BANGKA BELITUNG",2,91,150,241
https://kawalpemilu.org#25014,"BALUN IJUK, MERAWANG, BANGKA, KEPULAUAN BANGKA BELITUNG",3,59,205,264
https://kawalpemilu.org#25014,"BALUN IJUK, MERAWANG, BANGKA, KEPULAUAN BANGKA BELITUNG",4,49,182,231
https://kawalpemilu.org#25014,"BALUN IJUK, MERAWANG, BANGKA, KEPULAUAN BANGKA BELITUNG",5,48,219,267
https://kawalpemilu.org#25014,"BALUN IJUK, MERAWANG, BANGKA, KEPULAUAN BANGKA BELITUNG",6,56,182,238
https://kawalpemilu.org#25014,"BALUN IJUK, MERAWANG, BANGKA, KEPULAUAN BANGKA BELITUNG",7,53,217,270
https://kawalpemilu.org#25014,"BALUN IJUK, MERAWANG, BANGKA, KEPULAUAN BANGKA BELITUNG",8,46,163,209
https://kawalpemilu.org#25014,"BALUN IJUK, MERAWANG, BANGKA, KEPULAUAN BANGKA BELITUNG",9,75,172,247
https://kawalpemilu.org#25014,"BALUN IJUK, MERAWANG, BANGKA, KEPULAUAN BANGKA BELITUNG",10,91,188,279
https://kawalpemilu.org#25014,"BALUN IJUK, MERAWANG, BANGKA, KEPULAUAN BANGKA BELITUNG",11,85,190,275
https://kawalpemilu.org#25015,"RIDING PANJANG, MERAWANG, BANGKA, KEPULAUAN BANGKA BELITUNG",1,113,91,204
https://kawalpemilu.org#25015,"RIDING PANJANG, MERAWANG, BANGKA, KEPULAUAN BANGKA BELITUNG",2,71,127,198
https://kawalpemilu.org#25015,"RIDING PANJANG, MERAWANG, BANGKA, KEPULAUAN BANGKA BELITUNG",3,113,142,255
https://kawalpemilu.org#25015,"RIDING PANJANG, MERAWANG, BANGKA, KEPULAUAN BANGKA BELITUNG",4,159,5,164
https://kawalpemilu.org#25015,"RIDING PANJANG, MERAWANG, BANGKA, KEPULAUAN BANGKA BELITUNG",5,207,4,211
https://kawalpemilu.org#25015,"RIDING PANJANG, MERAWANG, BANGKA, KEPULAUAN BANGKA BELITUNG",6,96,5,101
https://kawalpemilu.org#25015,"RIDING PANJANG, MERAWANG, BANGKA, KEPULAUAN BANGKA BELITUNG",7,195,8,203
https://kawalpemilu.org#25015,"RIDING PANJANG, MERAWANG, BANGKA, KEPULAUAN BANGKA BELITUNG",8,109,98,207
https://kawalpemilu.org#25015,"RIDING PANJANG, MERAWANG, BANGKA, KEPULAUAN BANGKA BELITUNG",9,109,65,174
https://kawalpemilu.org#25016,"JURUNG, MERAWANG, BANGKA, KEPULAUAN BANGKA BELITUNG",1,142,89,231
https://kawalpemilu.org#25016,"JURUNG, MERAWANG, BANGKA, KEPULAUAN BANGKA BELITUNG",2,110,93,203
https://kawalpemilu.org#25016,"JURUNG, MERAWANG, BANGKA, KEPULAUAN BANGKA BELITUNG",3,141,75,216
https://kawalpemilu.org#25016,"JURUNG, MERAWANG, BANGKA, KEPULAUAN BANGKA BELITUNG",4,171,32,203
https://kawalpemilu.org#25016,"JURUNG, MERAWANG, BANGKA, KEPULAUAN BANGKA BELITUNG",5,154,27,181
https://kawalpemilu.org#25017,"KIMAK, MERAWANG, BANGKA, KEPULAUAN BANGKA BELITUNG",1,69,185,254
https://kawalpemilu.org#25017,"KIMAK, MERAWANG, BANGKA, KEPULAUAN BANGKA BELITUNG",2,44,198,242
https://kawalpemilu.org#25017,"KIMAK, MERAWANG, BANGKA, KEPULAUAN BANGKA BELITUNG",3,56,178,234
https://kawalpemilu.org#25017,"KIMAK, MERAWANG, BANGKA, KEPULAUAN BANGKA BELITUNG",4,58,188,246
https://kawalpemilu.org#25017,"KIMAK, MERAWANG, BANGKA, KEPULAUAN BANGKA BELITUNG",5,39,190,229
https://kawalpemilu.org#25017,"KIMAK, MERAWANG, BANGKA, KEPULAUAN BANGKA BELITUNG",6,53,178,231
https://kawalpemilu.org#25017,"KIMAK, MERAWANG, BANGKA, KEPULAUAN BANGKA BELITUNG",7,48,192,240
https://kawalpemilu.org#25017,"KIMAK, MERAWANG, BANGKA, KEPULAUAN BANGKA BELITUNG",8,46,197,243
https://kawalpemilu.org#25017,"KIMAK, MERAWANG, BANGKA, KEPULAUAN BANGKA BELITUNG",9,39,194,233
https://kawalpemilu.org#25018,"PAGARAWAN, MERAWANG, BANGKA, KEPULAUAN BANGKA BELITUNG",1,126,118,244
https://kawalpemilu.org#25018,"PAGARAWAN, MERAWANG, BANGKA, KEPULAUAN BANGKA BELITUNG",2,119,119,238
https://kawalpemilu.org#25018,"PAGARAWAN, MERAWANG, BANGKA, KEPULAUAN BANGKA BELITUNG",3,87,137,224
https://kawalpemilu.org#25018,"PAGARAWAN, MERAWANG, BANGKA, KEPULAUAN BANGKA BELITUNG",4,112,63,175
https://kawalpemilu.org#25018,"PAGARAWAN, MERAWANG, BANGKA, KEPULAUAN BANGKA BELITUNG",5,143,94,237
https://kawalpemilu.org#25018,"PAGARAWAN, MERAWANG, BANGKA, KEPULAUAN BANGKA BELITUNG",6,145,65,210
https://kawalpemilu.org#25018,"PAGARAWAN, MERAWANG, BANGKA, KEPULAUAN BANGKA BELITUNG",7,114,99,213
https://kawalpemilu.org#25018,"PAGARAWAN, MERAWANG, BANGKA, KEPULAUAN BANGKA BELITUNG",8,100,70,170
https://kawalpemilu.org#25018,"PAGARAWAN, MERAWANG, BANGKA, KEPULAUAN BANGKA BELITUNG",9,118,118,236
https://kawalpemilu.org#25018,"PAGARAWAN, MERAWANG, BANGKA, KEPULAUAN BANGKA BELITUNG",10,167,17,184
https://kawalpemilu.org#25018,"PAGARAWAN, MERAWANG, BANGKA, KEPULAUAN BANGKA BELITUNG",11,162,56,218
https://kawalpemilu.org#25018,"PAGARAWAN, MERAWANG, BANGKA, KEPULAUAN BANGKA BELITUNG",12,77,67,144
https://kawalpemilu.org#25019,"MERAWANG, MERAWANG, BANGKA, KEPULAUAN BANGKA BELITUNG",1,168,10,178
https://kawalpemilu.org#25019,"MERAWANG, MERAWANG, BANGKA, KEPULAUAN BANGKA BELITUNG",2,164,1,165
https://kawalpemilu.org#25019,"MERAWANG, MERAWANG, BANGKA, KEPULAUAN BANGKA BELITUNG",3,158,21,179
https://kawalpemilu.org#25019,"MERAWANG, MERAWANG, BANGKA, KEPULAUAN BANGKA BELITUNG",4,188,19,207
https://kawalpemilu.org#25019,"MERAWANG, MERAWANG, BANGKA, KEPULAUAN BANGKA BELITUNG",5,154,61,215
https://kawalpemilu.org#25019,"MERAWANG, MERAWANG, BANGKA, KEPULAUAN BANGKA BELITUNG",6,178,3,181
https://kawalpemilu.org#25020,"AIR ANYIR, MERAWANG, BANGKA, KEPULAUAN BANGKA BELITUNG",1,113,108,221
https://kawalpemilu.org#25020,"AIR ANYIR, MERAWANG, BANGKA, KEPULAUAN BANGKA BELITUNG",2,105,84,189
https://kawalpemilu.org#25020,"AIR ANYIR, MERAWANG, BANGKA, KEPULAUAN BANGKA BELITUNG",3,97,99,196
https://kawalpemilu.org#25020,"AIR ANYIR, MERAWANG, BANGKA, KEPULAUAN BANGKA BELITUNG",4,140,72,212
https://kawalpemilu.org#25020,"AIR ANYIR, MERAWANG, BANGKA, KEPULAUAN BANGKA BELITUNG",5,153,67,220
https://kawalpemilu.org#25020,"AIR ANYIR, MERAWANG, BANGKA, KEPULAUAN BANGKA BELITUNG",6,120,67,187
https://kawalpemilu.org#25021,"DWI MAKMUR, MERAWANG, BANGKA, KEPULAUAN BANGKA BELITUNG",1,137,0,137
https://kawalpemilu.org#25021,"DWI MAKMUR, MERAWANG, BANGKA, KEPULAUAN BANGKA BELITUNG",2,159,8,167
https://kawalpemilu.org#25021,"DWI MAKMUR, MERAWANG, BANGKA, KEPULAUAN BANGKA BELITUNG",3,150,6,156
https://kawalpemilu.org#25022,"JADA BAHRIN, MERAWANG, BANGKA, KEPULAUAN BANGKA BELITUNG",1,49,203,252
https://kawalpemilu.org#25022,"JADA BAHRIN, MERAWANG, BANGKA, KEPULAUAN BANGKA BELITUNG",2,38,206,244
https://kawalpemilu.org#25022,"JADA BAHRIN, MERAWANG, BANGKA, KEPULAUAN BANGKA BELITUNG",3,42,219,261
https://kawalpemilu.org#25022,"JADA BAHRIN, MERAWANG, BANGKA, KEPULAUAN BANGKA BELITUNG",4,61,146,207
https://kawalpemilu.org#25022,"JADA BAHRIN, MERAWANG, BANGKA, KEPULAUAN BANGKA BELITUNG",5,45,193,238
https://kawalpemilu.org#25024,"PETALING, MENDO BARAT, BANGKA, KEPULAUAN BANGKA BELITUNG",1,78,99,177
https://kawalpemilu.org#25024,"PETALING, MENDO BARAT, BANGKA, KEPULAUAN BANGKA BELITUNG",2,76,102,178
https://kawalpemilu.org#25024,"PETALING, MENDO BARAT, BANGKA, KEPULAUAN BANGKA BELITUNG",3,85,106,191
https://kawalpemilu.org#25024,"PETALING, MENDO BARAT, BANGKA, KEPULAUAN BANGKA BELITUNG",4,87,133,220
https://kawalpemilu.org#25024,"PETALING, MENDO BARAT, BANGKA, KEPULAUAN BANGKA BELITUNG",5,46,96,142
https://kawalpemilu.org#25024,"PETALING, MENDO BARAT, BANGKA, KEPULAUAN BANGKA BELITUNG",6,52,89,141
https://kawalpemilu.org#25024,"PETALING, MENDO BARAT, BANGKA, KEPULAUAN BANGKA BELITUNG",7,67,132,199
https://kawalpemilu.org#25024,"PETALING, MENDO BARAT, BANGKA, KEPULAUAN BANGKA BELITUNG",8,50,59,109
https://kawalpemilu.org#25024,"PETALING, MENDO BARAT, BANGKA, KEPULAUAN BANGKA BELITUNG",9,69,80,149
https://kawalpemilu.org#25024,"PETALING, MENDO BARAT, BANGKA, KEPULAUAN BANGKA BELITUNG",10,96,95,191
https://kawalpemilu.org#25024,"PETALING, MENDO BARAT, BANGKA, KEPULAUAN BANGKA BELITUNG",11,79,100,179
https://kawalpemilu.org#25025,"PENAGAN, MENDO BARAT, BANGKA, KEPULAUAN BANGKA BELITUNG",1,148,69,217
https://kawalpemilu.org#25025,"PENAGAN, MENDO BARAT, BANGKA, KEPULAUAN BANGKA BELITUNG",2,146,77,223
https://kawalpemilu.org#25025,"PENAGAN, MENDO BARAT, BANGKA, KEPULAUAN BANGKA BELITUNG",3,97,143,240
https://kawalpemilu.org#25025,"PENAGAN, MENDO BARAT, BANGKA, KEPULAUAN BANGKA BELITUNG",4,106,119,225
https://kawalpemilu.org#25025,"PENAGAN, MENDO BARAT, BANGKA, KEPULAUAN BANGKA BELITUNG",5,116,121,237
https://kawalpemilu.org#25025,"PENAGAN, MENDO BARAT, BANGKA, KEPULAUAN BANGKA BELITUNG",6,115,96,211
https://kawalpemilu.org#25025,"PENAGAN, MENDO BARAT, BANGKA, KEPULAUAN BANGKA BELITUNG",7,96,148,244
https://kawalpemilu.org#25025,"PENAGAN, MENDO BARAT, BANGKA, KEPULAUAN BANGKA BELITUNG",8,147,79,226
https://kawalpemilu.org#25025,"PENAGAN, MENDO BARAT, BANGKA, KEPULAUAN BANGKA BELITUNG",9,154,40,194
https://kawalpemilu.org#25025,"PENAGAN, MENDO BARAT, BANGKA, KEPULAUAN BANGKA BELITUNG",10,130,57,187
https://kawalpemilu.org#25025,"PENAGAN, MENDO BARAT, BANGKA, KEPULAUAN BANGKA BELITUNG",11,106,95,201
https://kawalpemilu.org#25025,"PENAGAN, MENDO BARAT, BANGKA, KEPULAUAN BANGKA BELITUNG",12,113,56,169
https://kawalpemilu.org#25025,"PENAGAN, MENDO BARAT, BANGKA, KEPULAUAN BANGKA BELITUNG",13,103,57,160
https://kawalpemilu.org#25025,"PENAGAN, MENDO BARAT, BANGKA, KEPULAUAN BANGKA BELITUNG",14,100,113,213
https://kawalpemilu.org#25026,"ZED, MENDO BARAT, BANGKA, KEPULAUAN BANGKA BELITUNG",1,17,186,203
https://kawalpemilu.org#25026,"ZED, MENDO BARAT, BANGKA, KEPULAUAN BANGKA BELITUNG",2,29,197,226
https://kawalpemilu.org#25026,"ZED, MENDO BARAT, BANGKA, KEPULAUAN BANGKA BELITUNG",3,20,209,229
https://kawalpemilu.org#25026,"ZED, MENDO BARAT, BANGKA, KEPULAUAN BANGKA BELITUNG",4,35,176,211
https://kawalpemilu.org#25026,"ZED, MENDO BARAT, BANGKA, KEPULAUAN BANGKA BELITUNG",5,48,181,229
https://kawalpemilu.org#25026,"ZED, MENDO BARAT, BANGKA, KEPULAUAN BANGKA BELITUNG",6,38,203,241
https://kawalpemilu.org#25026,"ZED, MENDO BARAT, BANGKA, KEPULAUAN BANGKA BELITUNG",7,54,173,227
https://kawalpemilu.org#25026,"ZED, MENDO BARAT, BANGKA, KEPULAUAN BANGKA BELITUNG",8,37,221,258
https://kawalpemilu.org#25027,"MENDO, MENDO BARAT, BANGKA, KEPULAUAN BANGKA BELITUNG",1,43,188,231
https://kawalpemilu.org#25027,"MENDO, MENDO BARAT, BANGKA, KEPULAUAN BANGKA BELITUNG",2,25,114,139
https://kawalpemilu.org#25027,"MENDO, MENDO BARAT, BANGKA, KEPULAUAN BANGKA BELITUNG",3,37,144,181
https://kawalpemilu.org#25027,"MENDO, MENDO BARAT, BANGKA, KEPULAUAN BANGKA BELITUNG",4,58,136,194
https://kawalpemilu.org#25027,"MENDO, MENDO BARAT, BANGKA, KEPULAUAN BANGKA BELITUNG",5,71,119,190
https://kawalpemilu.org#25027,"MENDO, MENDO BARAT, BANGKA, KEPULAUAN BANGKA BELITUNG",6,25,161,186
https://kawalpemilu.org#25027,"MENDO, MENDO BARAT, BANGKA, KEPULAUAN BANGKA BELITUNG",7,36,97,133
https://kawalpemilu.org#25028,"PAYA BENUA, MENDO BARAT, BANGKA, KEPULAUAN BANGKA BELITUNG",1,53,106,159
https://kawalpemilu.org#25028,"PAYA BENUA, MENDO BARAT, BANGKA, KEPULAUAN BANGKA BELITUNG",2,61,85,146
https://kawalpemilu.org#25028,"PAYA BENUA, MENDO BARAT, BANGKA, KEPULAUAN BANGKA BELITUNG",3,46,108,154
https://kawalpemilu.org#25028,"PAYA BENUA, MENDO BARAT, BANGKA, KEPULAUAN BANGKA BELITUNG",4,31,136,167
https://kawalpemilu.org#25028,"PAYA BENUA, MENDO BARAT, BANGKA, KEPULAUAN BANGKA BELITUNG",5,19,184,203
https://kawalpemilu.org#25028,"PAYA BENUA, MENDO BARAT, BANGKA, KEPULAUAN BANGKA BELITUNG",6,31,139,170
https://kawalpemilu.org#25028,"PAYA BENUA, MENDO BARAT, BANGKA, KEPULAUAN BANGKA BELITUNG",7,32,140,172
https://kawalpemilu.org#25028,"PAYA BENUA, MENDO BARAT, BANGKA, KEPULAUAN BANGKA BELITUNG",8,17,169,186
https://kawalpemilu.org#25028,"PAYA BENUA, MENDO BARAT, BANGKA, KEPULAUAN BANGKA BELITUNG",9,27,138,165
https://kawalpemilu.org#25028,"PAYA BENUA, MENDO BARAT, BANGKA, KEPULAUAN BANGKA BELITUNG",10,28,100,128
https://kawalpemilu.org#25028,"PAYA BENUA, MENDO BARAT, BANGKA, KEPULAUAN BANGKA BELITUNG",11,10,104,114
https://kawalpemilu.org#25028,"PAYA BENUA, MENDO BARAT, BANGKA, KEPULAUAN BANGKA BELITUNG",12,26,175,201
https://kawalpemilu.org#25028,"PAYA BENUA, MENDO BARAT, BANGKA, KEPULAUAN BANGKA BELITUNG",14,31,145,176
https://kawalpemilu.org#25028,"PAYA BENUA, MENDO BARAT, BANGKA, KEPULAUAN BANGKA BELITUNG",15,23,168,191
https://kawalpemilu.org#25029,"CENGKONG ABANG, MENDO BARAT, BANGKA, KEPULAUAN BANGKA BELITUNG",1,69,138,207
https://kawalpemilu.org#25029,"CENGKONG ABANG, MENDO BARAT, BANGKA, KEPULAUAN BANGKA BELITUNG",2,73,122,195
https://kawalpemilu.org#25029,"CENGKONG ABANG, MENDO BARAT, BANGKA, KEPULAUAN BANGKA BELITUNG",3,57,127,184
https://kawalpemilu.org#25029,"CENGKONG ABANG, MENDO BARAT, BANGKA, KEPULAUAN BANGKA BELITUNG",4,62,124,186
https://kawalpemilu.org#25029,"CENGKONG ABANG, MENDO BARAT, BANGKA, KEPULAUAN BANGKA BELITUNG",5,63,107,170
https://kawalpemilu.org#25029,"CENGKONG ABANG, MENDO BARAT, BANGKA, KEPULAUAN BANGKA BELITUNG",6,131,104,235
https://kawalpemilu.org#25029,"CENGKONG ABANG, MENDO BARAT, BANGKA, KEPULAUAN BANGKA BELITUNG",7,54,96,150
https://kawalpemilu.org#25029,"CENGKONG ABANG, MENDO BARAT, BANGKA, KEPULAUAN BANGKA BELITUNG",8,59,91,150
https://kawalpemilu.org#25029,"CENGKONG ABANG, MENDO BARAT, BANGKA, KEPULAUAN BANGKA BELITUNG",9,72,109,181
https://kawalpemilu.org#25029,"CENGKONG ABANG, MENDO BARAT, BANGKA, KEPULAUAN BANGKA BELITUNG",10,98,86,184
https://kawalpemilu.org#25030,"KACE, MENDO BARAT, BANGKA, KEPULAUAN BANGKA BELITUNG",1,95,92,187
https://kawalpemilu.org#25030,"KACE, MENDO BARAT, BANGKA, KEPULAUAN BANGKA BELITUNG",2,91,80,171
https://kawalpemilu.org#25030,"KACE, MENDO BARAT, BANGKA, KEPULAUAN BANGKA BELITUNG",3,83,102,185
https://kawalpemilu.org#25030,"KACE, MENDO BARAT, BANGKA, KEPULAUAN BANGKA BELITUNG",4,117,91,208
https://kawalpemilu.org#25030,"KACE, MENDO BARAT, BANGKA, KEPULAUAN BANGKA BELITUNG",5,104,84,188
https://kawalpemilu.org#25030,"KACE, MENDO BARAT, BANGKA, KEPULAUAN BANGKA BELITUNG",6,106,83,189
https://kawalpemilu.org#25030,"KACE, MENDO BARAT, BANGKA, KEPULAUAN BANGKA BELITUNG",7,75,97,172
https://kawalpemilu.org#25030,"KACE, MENDO BARAT, BANGKA, KEPULAUAN BANGKA BELITUNG",8,92,87,179
https://kawalpemilu.org#25030,"KACE, MENDO BARAT, BANGKA, KEPULAUAN BANGKA BELITUNG",9,61,101,162
https://kawalpemilu.org#25030,"KACE, MENDO BARAT, BANGKA, KEPULAUAN BANGKA BELITUNG",10,78,107,185
https://kawalpemilu.org#25030,"KACE, MENDO BARAT, BANGKA, KEPULAUAN BANGKA BELITUNG",11,88,82,170
https://kawalpemilu.org#25030,"KACE, MENDO BARAT, BANGKA, KEPULAUAN BANGKA BELITUNG",12,58,101,159
https://kawalpemilu.org#25030,"KACE, MENDO BARAT, BANGKA, KEPULAUAN BANGKA BELITUNG",13,80,85,165
https://kawalpemilu.org#25030,"KACE, MENDO BARAT, BANGKA, KEPULAUAN BANGKA BELITUNG",14,73,91,164
https://kawalpemilu.org#25030,"KACE, MENDO BARAT, BANGKA, KEPULAUAN BANGKA BELITUNG",15,58,73,131
https://kawalpemilu.org#25030,"KACE, MENDO BARAT, BANGKA, KEPULAUAN BANGKA BELITUNG",16,58,88,146
https://kawalpemilu.org#25030,"KACE, MENDO BARAT, BANGKA, KEPULAUAN BANGKA BELITUNG",17,87,86,173
https://kawalpemilu.org#25030,"KACE, MENDO BARAT, BANGKA, KEPULAUAN BANGKA BELITUNG",18,66,73,139
https://kawalpemilu.org#25030,"KACE, MENDO BARAT, BANGKA, KEPULAUAN BANGKA BELITUNG",19,82,115,197
https://kawalpemilu.org#25030,"KACE, MENDO BARAT, BANGKA, KEPULAUAN BANGKA BELITUNG",20,105,116,221
https://kawalpemilu.org#25031,"KEMUJA, MENDO BARAT, BANGKA, KEPULAUAN BANGKA BELITUNG",1,34,140,174
https://kawalpemilu.org#25031,"KEMUJA, MENDO BARAT, BANGKA, KEPULAUAN BANGKA BELITUNG",2,41,152,193
https://kawalpemilu.org#25031,"KEMUJA, MENDO BARAT, BANGKA, KEPULAUAN BANGKA BELITUNG",3,52,109,161
https://kawalpemilu.org#25031,"KEMUJA, MENDO BARAT, BANGKA, KEPULAUAN BANGKA BELITUNG",4,48,160,208
https://kawalpemilu.org#25031,"KEMUJA, MENDO BARAT, BANGKA, KEPULAUAN BANGKA BELITUNG",5,55,152,207
https://kawalpemilu.org#25031,"KEMUJA, MENDO BARAT, BANGKA, KEPULAUAN BANGKA BELITUNG",6,85,126,211
https://kawalpemilu.org#25031,"KEMUJA, MENDO BARAT, BANGKA, KEPULAUAN BANGKA BELITUNG",7,34,175,209
https://kawalpemilu.org#25031,"KEMUJA, MENDO BARAT, BANGKA, KEPULAUAN BANGKA BELITUNG",8,42,172,214
https://kawalpemilu.org#25031,"KEMUJA, MENDO BARAT, BANGKA, KEPULAUAN BANGKA BELITUNG",9,51,131,182
https://kawalpemilu.org#25031,"KEMUJA, MENDO BARAT, BANGKA, KEPULAUAN BANGKA BELITUNG",10,46,120,166
https://kawalpemilu.org#25031,"KEMUJA, MENDO BARAT, BANGKA, KEPULAUAN BANGKA BELITUNG",11,64,154,218
https://kawalpemilu.org#25031,"KEMUJA, MENDO BARAT, BANGKA, KEPULAUAN BANGKA BELITUNG",12,54,138,192
https://kawalpemilu.org#25031,"KEMUJA, MENDO BARAT, BANGKA, KEPULAUAN BANGKA BELITUNG",13,76,167,243
https://kawalpemilu.org#25031,"KEMUJA, MENDO BARAT, BANGKA, KEPULAUAN BANGKA BELITUNG",14,64,169,233
https://kawalpemilu.org#25032,"AIR DUREN, MENDO BARAT, BANGKA, KEPULAUAN BANGKA BELITUNG",1,28,167,195
https://kawalpemilu.org#25032,"AIR DUREN, MENDO BARAT, BANGKA, KEPULAUAN BANGKA BELITUNG",2,63,188,251
https://kawalpemilu.org#25032,"AIR DUREN, MENDO BARAT, BANGKA, KEPULAUAN BANGKA BELITUNG",3,100,102,202
https://kawalpemilu.org#25033,"KOTA KAPUR, MENDO BARAT, BANGKA, KEPULAUAN BANGKA BELITUNG",1,40,178,218
https://kawalpemilu.org#25033,"KOTA KAPUR, MENDO BARAT, BANGKA, KEPULAUAN BANGKA BELITUNG",2,33,146,179
https://kawalpemilu.org#25033,"KOTA KAPUR, MENDO BARAT, BANGKA, KEPULAUAN BANGKA BELITUNG",3,24,122,146
https://kawalpemilu.org#25033,"KOTA KAPUR, MENDO BARAT, BANGKA, KEPULAUAN BANGKA BELITUNG",4,64,161,225
https://kawalpemilu.org#25033,"KOTA KAPUR, MENDO BARAT, BANGKA, KEPULAUAN BANGKA BELITUNG",5,55,138,193
https://kawalpemilu.org#25033,"KOTA KAPUR, MENDO BARAT, BANGKA, KEPULAUAN BANGKA BELITUNG",6,57,176,233
https://kawalpemilu.org#25034,"AIR BULUH, MENDO BARAT, BANGKA, KEPULAUAN BANGKA BELITUNG",1,127,80,207
https://kawalpemilu.org#25034,"AIR BULUH, MENDO BARAT, BANGKA, KEPULAUAN BANGKA BELITUNG",2,157,62,219
https://kawalpemilu.org#25034,"AIR BULUH, MENDO BARAT, BANGKA, KEPULAUAN BANGKA BELITUNG",3,193,55,248
https://kawalpemilu.org#25034,"AIR BULUH, MENDO BARAT, BANGKA, KEPULAUAN BANGKA BELITUNG",4,154,49,203
https://kawalpemilu.org#25035,"RUKAM, MENDO BARAT, BANGKA, KEPULAUAN BANGKA BELITUNG",1,124,69,193
https://kawalpemilu.org#25035,"RUKAM, MENDO BARAT, BANGKA, KEPULAUAN BANGKA BELITUNG",2,126,72,198
https://kawalpemilu.org#25035,"RUKAM, MENDO BARAT, BANGKA, KEPULAUAN BANGKA BELITUNG",3,156,60,216
https://kawalpemilu.org#25036,"LABUH AIR PANDAN, MENDO BARAT, BANGKA, KEPULAUAN BANGKA BELITUNG",1,129,136,265
https://kawalpemilu.org#25036,"LABUH AIR PANDAN, MENDO BARAT, BANGKA, KEPULAUAN BANGKA BELITUNG",2,31,124,155
https://kawalpemilu.org#25036,"LABUH AIR PANDAN, MENDO BARAT, BANGKA, KEPULAUAN BANGKA BELITUNG",3,53,102,155
https://kawalpemilu.org#25036,"LABUH AIR PANDAN, MENDO BARAT, BANGKA, KEPULAUAN BANGKA BELITUNG",4,63,128,191
https://kawalpemilu.org#84842,"KACE TIMUR, MENDO BARAT, BANGKA, KEPULAUAN BANGKA BELITUNG",1,58,184,242
https://kawalpemilu.org#84842,"KACE TIMUR, MENDO BARAT, BANGKA, KEPULAUAN BANGKA BELITUNG",2,151,112,263
https://kawalpemilu.org#84842,"KACE TIMUR, MENDO BARAT, BANGKA, KEPULAUAN BANGKA BELITUNG",3,73,103,176
https://kawalpemilu.org#84842,"KACE TIMUR, MENDO BARAT, BANGKA, KEPULAUAN BANGKA BELITUNG",4,96,100,196
https://kawalpemilu.org#84842,"KACE TIMUR, MENDO BARAT, BANGKA, KEPULAUAN BANGKA BELITUNG",5,154,48,202
https://kawalpemilu.org#84842,"KACE TIMUR, MENDO BARAT, BANGKA, KEPULAUAN BANGKA BELITUNG",6,43,35,78
https://kawalpemilu.org#84842,"KACE TIMUR, MENDO BARAT, BANGKA, KEPULAUAN BANGKA BELITUNG",7,49,67,116
https://kawalpemilu.org#84842,"KACE TIMUR, MENDO BARAT, BANGKA, KEPULAUAN BANGKA BELITUNG",8,54,92,146
https://kawalpemilu.org#84843,"PETALING BANJAR, MENDO BARAT, BANGKA, KEPULAUAN BANGKA BELITUNG",1,59,115,174
https://kawalpemilu.org#84843,"PETALING BANJAR, MENDO BARAT, BANGKA, KEPULAUAN BANGKA BELITUNG",2,51,78,129
https://kawalpemilu.org#84843,"PETALING BANJAR, MENDO BARAT, BANGKA, KEPULAUAN BANGKA BELITUNG",3,65,105,170
https://kawalpemilu.org#84843,"PETALING BANJAR, MENDO BARAT, BANGKA, KEPULAUAN BANGKA BELITUNG",4,65,93,158
https://kawalpemilu.org#84843,"PETALING BANJAR, MENDO BARAT, BANGKA, KEPULAUAN BANGKA BELITUNG",5,61,103,164
https://kawalpemilu.org#84843,"PETALING BANJAR, MENDO BARAT, BANGKA, KEPULAUAN BANGKA BELITUNG",6,91,87,178
https://kawalpemilu.org#84843,"PETALING BANJAR, MENDO BARAT, BANGKA, KEPULAUAN BANGKA BELITUNG",7,90,116,206
https://kawalpemilu.org#84843,"PETALING BANJAR, MENDO BARAT, BANGKA, KEPULAUAN BANGKA BELITUNG",8,43,163,206
https://kawalpemilu.org#84843,"PETALING BANJAR, MENDO BARAT, BANGKA, KEPULAUAN BANGKA BELITUNG",9,62,156,218
https://kawalpemilu.org#84843,"PETALING BANJAR, MENDO BARAT, BANGKA, KEPULAUAN BANGKA BELITUNG",10,66,100,166
https://kawalpemilu.org#84843,"PETALING BANJAR, MENDO BARAT, BANGKA, KEPULAUAN BANGKA BELITUNG",11,49,130,179
https://kawalpemilu.org#84843,"PETALING BANJAR, MENDO BARAT, BANGKA, KEPULAUAN BANGKA BELITUNG",12,37,129,166
https://kawalpemilu.org#25038,"AIR RUAI, PEMALI, BANGKA, KEPULAUAN BANGKA BELITUNG",1,194,1,195
https://kawalpemilu.org#25038,"AIR RUAI, PEMALI, BANGKA, KEPULAUAN BANGKA BELITUNG",2,158,8,166
https://kawalpemilu.org#25038,"AIR RUAI, PEMALI, BANGKA, KEPULAUAN BANGKA BELITUNG",3,186,6,192
https://kawalpemilu.org#25038,"AIR RUAI, PEMALI, BANGKA, KEPULAUAN BANGKA BELITUNG",4,158,75,233
https://kawalpemilu.org#25038,"AIR RUAI, PEMALI, BANGKA, KEPULAUAN BANGKA BELITUNG",5,121,94,215
https://kawalpemilu.org#25038,"AIR RUAI, PEMALI, BANGKA, KEPULAUAN BANGKA BELITUNG",6,131,88,219
https://kawalpemilu.org#25038,"AIR RUAI, PEMALI, BANGKA, KEPULAUAN BANGKA BELITUNG",7,88,116,204
https://kawalpemilu.org#25038,"AIR RUAI, PEMALI, BANGKA, KEPULAUAN BANGKA BELITUNG",8,132,113,245
https://kawalpemilu.org#25038,"AIR RUAI, PEMALI, BANGKA, KEPULAUAN BANGKA BELITUNG",9,119,127,246
https://kawalpemilu.org#25038,"AIR RUAI, PEMALI, BANGKA, KEPULAUAN BANGKA BELITUNG",10,107,144,251
https://kawalpemilu.org#25038,"AIR RUAI, PEMALI, BANGKA, KEPULAUAN BANGKA BELITUNG",11,80,150,230
https://kawalpemilu.org#25038,"AIR RUAI, PEMALI, BANGKA, KEPULAUAN BANGKA BELITUNG",12,135,86,221
https://kawalpemilu.org#25038,"AIR RUAI, PEMALI, BANGKA, KEPULAUAN BANGKA BELITUNG",13,96,158,252
https://kawalpemilu.org#25038,"AIR RUAI, PEMALI, BANGKA, KEPULAUAN BANGKA BELITUNG",14,119,94,213
https://kawalpemilu.org#25038,"AIR RUAI, PEMALI, BANGKA, KEPULAUAN BANGKA BELITUNG",15,122,63,185
https://kawalpemilu.org#25038,"AIR RUAI, PEMALI, BANGKA, KEPULAUAN BANGKA BELITUNG",16,118,121,239
https://kawalpemilu.org#25038,"AIR RUAI, PEMALI, BANGKA, KEPULAUAN BANGKA BELITUNG",17,106,128,234
https://kawalpemilu.org#25038,"AIR RUAI, PEMALI, BANGKA, KEPULAUAN BANGKA BELITUNG",18,67,66,133
https://kawalpemilu.org#25039,"AIR DUREN, PEMALI, BANGKA, KEPULAUAN BANGKA BELITUNG",1,120,68,186
https://kawalpemilu.org#25039,"AIR DUREN, PEMALI, BANGKA, KEPULAUAN BANGKA BELITUNG",2,180,9,189
https://kawalpemilu.org#25039,"AIR DUREN, PEMALI, BANGKA, KEPULAUAN BANGKA BELITUNG",3,161,2,163
https://kawalpemilu.org#25039,"AIR DUREN, PEMALI, BANGKA, KEPULAUAN BANGKA BELITUNG",4,83,100,183
https://kawalpemilu.org#25039,"AIR DUREN, PEMALI, BANGKA, KEPULAUAN BANGKA BELITUNG",5,204,5,209
https://kawalpemilu.org#25039,"AIR DUREN, PEMALI, BANGKA, KEPULAUAN BANGKA BELITUNG",6,153,53,206
https://kawalpemilu.org#25039,"AIR DUREN, PEMALI, BANGKA, KEPULAUAN BANGKA BELITUNG",7,126,37,163
https://kawalpemilu.org#25039,"AIR DUREN, PEMALI, BANGKA, KEPULAUAN BANGKA BELITUNG",8,133,47,180
https://kawalpemilu.org#25039,"AIR DUREN, PEMALI, BANGKA, KEPULAUAN BANGKA BELITUNG",9,88,62,150
https://kawalpemilu.org#25039,"AIR DUREN, PEMALI, BANGKA, KEPULAUAN BANGKA BELITUNG",10,185,66,251
https://kawalpemilu.org#25040,"PENYAMUN, PEMALI, BANGKA, KEPULAUAN BANGKA BELITUNG",1,81,138,219
https://kawalpemilu.org#25040,"PENYAMUN, PEMALI, BANGKA, KEPULAUAN BANGKA BELITUNG",2,55,131,186
https://kawalpemilu.org#25040,"PENYAMUN, PEMALI, BANGKA, KEPULAUAN BANGKA BELITUNG",3,89,88,177
https://kawalpemilu.org#25040,"PENYAMUN, PEMALI, BANGKA, KEPULAUAN BANGKA BELITUNG",4,104,65,169
https://kawalpemilu.org#25040,"PENYAMUN, PEMALI, BANGKA, KEPULAUAN BANGKA BELITUNG",5,144,52,196
https://kawalpemilu.org#25040,"PENYAMUN, PEMALI, BANGKA, KEPULAUAN BANGKA BELITUNG",6,147,69,216
https://kawalpemilu.org#25040,"PENYAMUN, PEMALI, BANGKA, KEPULAUAN BANGKA BELITUNG",7,81,151,232
https://kawalpemilu.org#25040,"PENYAMUN, PEMALI, BANGKA, KEPULAUAN BANGKA BELITUNG",8,81,149,230
https://kawalpemilu.org#25040,"PENYAMUN, PEMALI, BANGKA, KEPULAUAN BANGKA BELITUNG",9,69,26,95
https://kawalpemilu.org#25040,"PENYAMUN, PEMALI, BANGKA, KEPULAUAN BANGKA BELITUNG",10,88,124,212
https://kawalpemilu.org#25040,"PENYAMUN, PEMALI, BANGKA, KEPULAUAN BANGKA BELITUNG",11,105,75,180
https://kawalpemilu.org#25040,"PENYAMUN, PEMALI, BANGKA, KEPULAUAN BANGKA BELITUNG",12,101,66,167
https://kawalpemilu.org#25040,"PENYAMUN, PEMALI, BANGKA, KEPULAUAN BANGKA BELITUNG",13,148,70,218
https://kawalpemilu.org#25040,"PENYAMUN, PEMALI, BANGKA, KEPULAUAN BANGKA BELITUNG",14,130,68,198
https://kawalpemilu.org#25041,"SEMPAN, PEMALI, BANGKA, KEPULAUAN BANGKA BELITUNG",1,68,148,216
https://kawalpemilu.org#25041,"SEMPAN, PEMALI, BANGKA, KEPULAUAN BANGKA BELITUNG",2,77,147,224
https://kawalpemilu.org#25041,"SEMPAN, PEMALI, BANGKA, KEPULAUAN BANGKA BELITUNG",3,82,174,256
https://kawalpemilu.org#25041,"SEMPAN, PEMALI, BANGKA, KEPULAUAN BANGKA BELITUNG",4,77,166,243
https://kawalpemilu.org#25041,"SEMPAN, PEMALI, BANGKA, KEPULAUAN BANGKA BELITUNG",5,90,178,268
https://kawalpemilu.org#25041,"SEMPAN, PEMALI, BANGKA, KEPULAUAN BANGKA BELITUNG",6,98,139,237
https://kawalpemilu.org#25041,"SEMPAN, PEMALI, BANGKA, KEPULAUAN BANGKA BELITUNG",7,87,160,247
https://kawalpemilu.org#25041,"SEMPAN, PEMALI, BANGKA, KEPULAUAN BANGKA BELITUNG",8,99,100,199
https://kawalpemilu.org#25041,"SEMPAN, PEMALI, BANGKA, KEPULAUAN BANGKA BELITUNG",9,65,140,205
https://kawalpemilu.org#25041,"SEMPAN, PEMALI, BANGKA, KEPULAUAN BANGKA BELITUNG",10,85,160,245
https://kawalpemilu.org#25042,"PEMALI, PEMALI, BANGKA, KEPULAUAN BANGKA BELITUNG",1,0,0,0
https://kawalpemilu.org#25042,"PEMALI, PEMALI, BANGKA, KEPULAUAN BANGKA BELITUNG",2,121,86,207
https://kawalpemilu.org#25042,"PEMALI, PEMALI, BANGKA, KEPULAUAN BANGKA BELITUNG",3,105,101,206
https://kawalpemilu.org#25042,"PEMALI, PEMALI, BANGKA, KEPULAUAN BANGKA BELITUNG",4,133,64,197
https://kawalpemilu.org#25042,"PEMALI, PEMALI, BANGKA, KEPULAUAN BANGKA BELITUNG",5,80,88,168
https://kawalpemilu.org#25042,"PEMALI, PEMALI, BANGKA, KEPULAUAN BANGKA BELITUNG",6,92,123,215
https://kawalpemilu.org#25042,"PEMALI, PEMALI, BANGKA, KEPULAUAN BANGKA BELITUNG",7,107,90,197
https://kawalpemilu.org#25042,"PEMALI, PEMALI, BANGKA, KEPULAUAN BANGKA BELITUNG",8,182,43,225
https://kawalpemilu.org#25042,"PEMALI, PEMALI, BANGKA, KEPULAUAN BANGKA BELITUNG",9,108,84,192
https://kawalpemilu.org#25042,"PEMALI, PEMALI, BANGKA, KEPULAUAN BANGKA BELITUNG",10,140,40,180
https://kawalpemilu.org#25042,"PEMALI, PEMALI, BANGKA, KEPULAUAN BANGKA BELITUNG",11,146,92,238
https://kawalpemilu.org#25042,"PEMALI, PEMALI, BANGKA, KEPULAUAN BANGKA BELITUNG",12,102,63,165
https://kawalpemilu.org#25042,"PEMALI, PEMALI, BANGKA, KEPULAUAN BANGKA BELITUNG",13,110,99,209
https://kawalpemilu.org#25042,"PEMALI, PEMALI, BANGKA, KEPULAUAN BANGKA BELITUNG",14,98,78,176
https://kawalpemilu.org#25043,"KARYA MAKMUR, PEMALI, BANGKA, KEPULAUAN BANGKA BELITUNG",1,96,117,213
https://kawalpemilu.org#25043,"KARYA MAKMUR, PEMALI, BANGKA, KEPULAUAN BANGKA BELITUNG",3,85,97,182
https://kawalpemilu.org#25043,"KARYA MAKMUR, PEMALI, BANGKA, KEPULAUAN BANGKA BELITUNG",4,113,90,203
https://kawalpemilu.org#25043,"KARYA MAKMUR, PEMALI, BANGKA, KEPULAUAN BANGKA BELITUNG",5,97,84,181
https://kawalpemilu.org#25043,"KARYA MAKMUR, PEMALI, BANGKA, KEPULAUAN BANGKA BELITUNG",6,96,90,186
https://kawalpemilu.org#25043,"KARYA MAKMUR, PEMALI, BANGKA, KEPULAUAN BANGKA BELITUNG",7,128,109,237
https://kawalpemilu.org#25043,"KARYA MAKMUR, PEMALI, BANGKA, KEPULAUAN BANGKA BELITUNG",8,86,111,111
https://kawalpemilu.org#25043,"KARYA MAKMUR, PEMALI, BANGKA, KEPULAUAN BANGKA BELITUNG",9,155,60,215
https://kawalpemilu.org#25043,"KARYA MAKMUR, PEMALI, BANGKA, KEPULAUAN BANGKA BELITUNG",10,100,123,223
https://kawalpemilu.org#25043,"KARYA MAKMUR, PEMALI, BANGKA, KEPULAUAN BANGKA BELITUNG",11,95,109,204
https://kawalpemilu.org#25043,"KARYA MAKMUR, PEMALI, BANGKA, KEPULAUAN BANGKA BELITUNG",12,97,96,193
https://kawalpemilu.org#25043,"KARYA MAKMUR, PEMALI, BANGKA, KEPULAUAN BANGKA BELITUNG",13,88,91,179
https://kawalpemilu.org#25043,"KARYA MAKMUR, PEMALI, BANGKA, KEPULAUAN BANGKA BELITUNG",14,88,87,175
https://kawalpemilu.org#25043,"KARYA MAKMUR, PEMALI, BANGKA, KEPULAUAN BANGKA BELITUNG",15,80,107,187
https://kawalpemilu.org#25043,"KARYA MAKMUR, PEMALI, BANGKA, KEPULAUAN BANGKA BELITUNG",16,111,76,187
https://kawalpemilu.org#25043,"KARYA MAKMUR, PEMALI, BANGKA, KEPULAUAN BANGKA BELITUNG",17,109,90,206
https://kawalpemilu.org#25043,"KARYA MAKMUR, PEMALI, BANGKA, KEPULAUAN BANGKA BELITUNG",18,106,90,196
https://kawalpemilu.org#25043,"KARYA MAKMUR, PEMALI, BANGKA, KEPULAUAN BANGKA BELITUNG",19,75,98,173
https://kawalpemilu.org#25045,"BAKAM, BAKAM, BANGKA, KEPULAUAN BANGKA BELITUNG",1,87,159,246
https://kawalpemilu.org#25045,"BAKAM, BAKAM, BANGKA, KEPULAUAN BANGKA BELITUNG",2,77,175,252
https://kawalpemilu.org#25045,"BAKAM, BAKAM, BANGKA, KEPULAUAN BANGKA BELITUNG",3,96,151,247
https://kawalpemilu.org#25045,"BAKAM, BAKAM, BANGKA, KEPULAUAN BANGKA BELITUNG",4,75,151,226
https://kawalpemilu.org#25045,"BAKAM, BAKAM, BANGKA, KEPULAUAN BANGKA BELITUNG",5,38,168,206
https://kawalpemilu.org#25046,"KAPUK, BAKAM, BANGKA, KEPULAUAN BANGKA BELITUNG",1,76,117,193
https://kawalpemilu.org#25046,"KAPUK, BAKAM, BANGKA, KEPULAUAN BANGKA BELITUNG",2,121,100,221
https://kawalpemilu.org#25046,"KAPUK, BAKAM, BANGKA, KEPULAUAN BANGKA BELITUNG",3,67,112,179
https://kawalpemilu.org#25046,"KAPUK, BAKAM, BANGKA, KEPULAUAN BANGKA BELITUNG",4,93,125,218
https://kawalpemilu.org#25047,"DALIL, BAKAM, BANGKA, KEPULAUAN BANGKA BELITUNG",1,88,143,231
https://kawalpemilu.org#25047,"DALIL, BAKAM, BANGKA, KEPULAUAN BANGKA BELITUNG",2,100,135,235
https://kawalpemilu.org#25047,"DALIL, BAKAM, BANGKA, KEPULAUAN BANGKA BELITUNG",3,111,118,229
https://kawalpemilu.org#25047,"DALIL, BAKAM, BANGKA, KEPULAUAN BANGKA BELITUNG",4,86,143,229
https://kawalpemilu.org#25047,"DALIL, BAKAM, BANGKA, KEPULAUAN BANGKA BELITUNG",5,75,153,228
https://kawalpemilu.org#25047,"DALIL, BAKAM, BANGKA, KEPULAUAN BANGKA BELITUNG",6,63,185,248
https://kawalpemilu.org#25047,"DALIL, BAKAM, BANGKA, KEPULAUAN BANGKA BELITUNG",7,108,140,248
https://kawalpemilu.org#25047,"DALIL, BAKAM, BANGKA, KEPULAUAN BANGKA BELITUNG",8,64,50,114
https://kawalpemilu.org#25047,"DALIL, BAKAM, BANGKA, KEPULAUAN BANGKA BELITUNG",9,102,52,154
https://kawalpemilu.org#25048,"NEKNANG, BAKAM, BANGKA, KEPULAUAN BANGKA BELITUNG",1,105,71,176
https://kawalpemilu.org#25048,"NEKNANG, BAKAM, BANGKA, KEPULAUAN BANGKA BELITUNG",2,112,90,202
https://kawalpemilu.org#25048,"NEKNANG, BAKAM, BANGKA, KEPULAUAN BANGKA BELITUNG",3,85,119,204
https://kawalpemilu.org#25048,"NEKNANG, BAKAM, BANGKA, KEPULAUAN BANGKA BELITUNG",4,83,71,154
https://kawalpemilu.org#25048,"NEKNANG, BAKAM, BANGKA, KEPULAUAN BANGKA BELITUNG",5,79,114,193
https://kawalpemilu.org#25048,"NEKNANG, BAKAM, BANGKA, KEPULAUAN BANGKA BELITUNG",6,109,91,200
https://kawalpemilu.org#25048,"NEKNANG, BAKAM, BANGKA, KEPULAUAN BANGKA BELITUNG",7,121,64,185
https://kawalpemilu.org#25048,"NEKNANG, BAKAM, BANGKA, KEPULAUAN BANGKA BELITUNG",8,106,54,160
https://kawalpemilu.org#25049,"TIANG TARAH, BAKAM, BANGKA, KEPULAUAN BANGKA BELITUNG",1,93,58,151
https://kawalpemilu.org#25049,"TIANG TARAH, BAKAM, BANGKA, KEPULAUAN BANGKA BELITUNG",2,80,60,140
https://kawalpemilu.org#25049,"TIANG TARAH, BAKAM, BANGKA, KEPULAUAN BANGKA BELITUNG",3,82,74,156
https://kawalpemilu.org#25049,"TIANG TARAH, BAKAM, BANGKA, KEPULAUAN BANGKA BELITUNG",4,77,63,140
https://kawalpemilu.org#25049,"TIANG TARAH, BAKAM, BANGKA, KEPULAUAN BANGKA BELITUNG",5,92,55,147
https://kawalpemilu.org#25049,"TIANG TARAH, BAKAM, BANGKA, KEPULAUAN BANGKA BELITUNG",6,93,58,151
https://kawalpemilu.org#25049,"TIANG TARAH, BAKAM, BANGKA, KEPULAUAN BANGKA BELITUNG",7,146,60,206
https://kawalpemilu.org#25050,"MANGKA, BAKAM, BANGKA, KEPULAUAN BANGKA BELITUNG",1,103,136,239
https://kawalpemilu.org#25050,"MANGKA, BAKAM, BANGKA, KEPULAUAN BANGKA BELITUNG",2,81,103,184
https://kawalpemilu.org#25050,"MANGKA, BAKAM, BANGKA, KEPULAUAN BANGKA BELITUNG",3,106,137,243
https://kawalpemilu.org#25051,"MABAT, BAKAM, BANGKA, KEPULAUAN BANGKA BELITUNG",1,36,122,158
https://kawalpemilu.org#25051,"MABAT, BAKAM, BANGKA, KEPULAUAN BANGKA BELITUNG",2,62,94,156
https://kawalpemilu.org#25051,"MABAT, BAKAM, BANGKA, KEPULAUAN BANGKA BELITUNG",3,51,114,165
https://kawalpemilu.org#25051,"MABAT, BAKAM, BANGKA, KEPULAUAN BANGKA BELITUNG",4,30,147,177
https://kawalpemilu.org#25051,"MABAT, BAKAM, BANGKA, KEPULAUAN BANGKA BELITUNG",5,35,139,174
https://kawalpemilu.org#25051,"MABAT, BAKAM, BANGKA, KEPULAUAN BANGKA BELITUNG",6,38,127,165
https://kawalpemilu.org#25052,"BUKIT LAYANG, BAKAM, BANGKA, KEPULAUAN BANGKA BELITUNG",1,51,127,178
https://kawalpemilu.org#25052,"BUKIT LAYANG, BAKAM, BANGKA, KEPULAUAN BANGKA BELITUNG",2,33,165,198
https://kawalpemilu.org#25052,"BUKIT LAYANG, BAKAM, BANGKA, KEPULAUAN BANGKA BELITUNG",3,29,168,197
https://kawalpemilu.org#25052,"BUKIT LAYANG, BAKAM, BANGKA, KEPULAUAN BANGKA BELITUNG",4,40,158,198
https://kawalpemilu.org#25052,"BUKIT LAYANG, BAKAM, BANGKA, KEPULAUAN BANGKA BELITUNG",5,45,191,236
https://kawalpemilu.org#25052,"BUKIT LAYANG, BAKAM, BANGKA, KEPULAUAN BANGKA BELITUNG",6,151,8,159
https://kawalpemilu.org#25052,"BUKIT LAYANG, BAKAM, BANGKA, KEPULAUAN BANGKA BELITUNG",7,140,66,206
https://kawalpemilu.org#25052,"BUKIT LAYANG, BAKAM, BANGKA, KEPULAUAN BANGKA BELITUNG",8,142,68,210
https://kawalpemilu.org#25052,"BUKIT LAYANG, BAKAM, BANGKA, KEPULAUAN BANGKA BELITUNG",9,109,67,176
https://kawalpemilu.org#25052,"BUKIT LAYANG, BAKAM, BANGKA, KEPULAUAN BANGKA BELITUNG",10,147,33,180
https://kawalpemilu.org#25052,"BUKIT LAYANG, BAKAM, BANGKA, KEPULAUAN BANGKA BELITUNG",11,150,39,189
https://kawalpemilu.org#25053,"MARAS SENANG, BAKAM, BANGKA, KEPULAUAN BANGKA BELITUNG",1,110,58,168
https://kawalpemilu.org#25053,"MARAS SENANG, BAKAM, BANGKA, KEPULAUAN BANGKA BELITUNG",2,106,71,177
https://kawalpemilu.org#25053,"MARAS SENANG, BAKAM, BANGKA, KEPULAUAN BANGKA BELITUNG",3,60,114,174
https://kawalpemilu.org#25055,"RIAU, RIAU SILIP, BANGKA, KEPULAUAN BANGKA BELITUNG",1,112,3,115
https://kawalpemilu.org#25055,"RIAU, RIAU SILIP, BANGKA, KEPULAUAN BANGKA BELITUNG",2,144,37,181
https://kawalpemilu.org#25055,"RIAU, RIAU SILIP, BANGKA, KEPULAUAN BANGKA BELITUNG",3,191,35,226
https://kawalpemilu.org#25055,"RIAU, RIAU SILIP, BANGKA, KEPULAUAN BANGKA BELITUNG",4,165,56,221
https://kawalpemilu.org#25055,"RIAU, RIAU SILIP, BANGKA, KEPULAUAN BANGKA BELITUNG",5,164,53,217
https://kawalpemilu.org#25055,"RIAU, RIAU SILIP, BANGKA, KEPULAUAN BANGKA BELITUNG",6,123,94,217
https://kawalpemilu.org#25055,"RIAU, RIAU SILIP, BANGKA, KEPULAUAN BANGKA BELITUNG",7,91,65,156
https://kawalpemilu.org#25055,"RIAU, RIAU SILIP, BANGKA, KEPULAUAN BANGKA BELITUNG",8,137,56,193
https://kawalpemilu.org#25055,"RIAU, RIAU SILIP, BANGKA, KEPULAUAN BANGKA BELITUNG",9,101,87,188
https://kawalpemilu.org#25055,"RIAU, RIAU SILIP, BANGKA, KEPULAUAN BANGKA BELITUNG",10,116,52,168
https://kawalpemilu.org#25056,"PANGKAL NIUR, RIAU SILIP, BANGKA, KEPULAUAN BANGKA BELITUNG",1,52,165,217
https://kawalpemilu.org#25056,"PANGKAL NIUR, RIAU SILIP, BANGKA, KEPULAUAN BANGKA BELITUNG",2,42,164,206
https://kawalpemilu.org#25056,"PANGKAL NIUR, RIAU SILIP, BANGKA, KEPULAUAN BANGKA BELITUNG",3,39,151,190
https://kawalpemilu.org#25056,"PANGKAL NIUR, RIAU SILIP, BANGKA, KEPULAUAN BANGKA BELITUNG",4,55,127,182
https://kawalpemilu.org#25056,"PANGKAL NIUR, RIAU SILIP, BANGKA, KEPULAUAN BANGKA BELITUNG",5,37,160,197
https://kawalpemilu.org#25056,"PANGKAL NIUR, RIAU SILIP, BANGKA, KEPULAUAN BANGKA BELITUNG",6,43,197,240
https://kawalpemilu.org#25056,"PANGKAL NIUR, RIAU SILIP, BANGKA, KEPULAUAN BANGKA BELITUNG",7,43,124,167
https://kawalpemilu.org#25056,"PANGKAL NIUR, RIAU SILIP, BANGKA, KEPULAUAN BANGKA BELITUNG",8,44,196,240
https://kawalpemilu.org#25056,"PANGKAL NIUR, RIAU SILIP, BANGKA, KEPULAUAN BANGKA BELITUNG",9,22,188,210
https://kawalpemilu.org#25056,"PANGKAL NIUR, RIAU SILIP, BANGKA, KEPULAUAN BANGKA BELITUNG",10,39,147,186
https://kawalpemilu.org#25057,"PUGUL, RIAU SILIP, BANGKA, KEPULAUAN BANGKA BELITUNG",1,153,56,209
https://kawalpemilu.org#25057,"PUGUL, RIAU SILIP, BANGKA, KEPULAUAN BANGKA BELITUNG",2,201,47,248
https://kawalpemilu.org#25057,"PUGUL, RIAU SILIP, BANGKA, KEPULAUAN BANGKA BELITUNG",3,184,49,233
https://kawalpemilu.org#25057,"PUGUL, RIAU SILIP, BANGKA, KEPULAUAN BANGKA BELITUNG",4,181,62,243
https://kawalpemilu.org#25057,"PUGUL, RIAU SILIP, BANGKA, KEPULAUAN BANGKA BELITUNG",5,174,53,227
https://kawalpemilu.org#25057,"PUGUL, RIAU SILIP, BANGKA, KEPULAUAN BANGKA BELITUNG",6,149,67,216
https://kawalpemilu.org#25057,"PUGUL, RIAU SILIP, BANGKA, KEPULAUAN BANGKA BELITUNG",7,171,37,208
https://kawalpemilu.org#25057,"PUGUL, RIAU SILIP, BANGKA, KEPULAUAN BANGKA BELITUNG",8,141,31,172
https://kawalpemilu.org#25057,"PUGUL, RIAU SILIP, BANGKA, KEPULAUAN BANGKA BELITUNG",9,151,60,211
https://kawalpemilu.org#25058,"CIT, RIAU SILIP, BANGKA, KEPULAUAN BANGKA BELITUNG",1,205,29,234
https://kawalpemilu.org#25058,"CIT, RIAU SILIP, BANGKA, KEPULAUAN BANGKA BELITUNG",2,148,98,246
https://kawalpemilu.org#25058,"CIT, RIAU SILIP, BANGKA, KEPULAUAN BANGKA BELITUNG",3,175,61,236
https://kawalpemilu.org#25058,"CIT, RIAU SILIP, BANGKA, KEPULAUAN BANGKA BELITUNG",4,197,46,243
https://kawalpemilu.org#25058,"CIT, RIAU SILIP, BANGKA, KEPULAUAN BANGKA BELITUNG",5,164,69,233
https://kawalpemilu.org#25058,"CIT, RIAU SILIP, BANGKA, KEPULAUAN BANGKA BELITUNG",6,191,58,249
https://kawalpemilu.org#25058,"CIT, RIAU SILIP, BANGKA, KEPULAUAN BANGKA BELITUNG",7,184,25,209
https://kawalpemilu.org#25058,"CIT, RIAU SILIP, BANGKA, KEPULAUAN BANGKA BELITUNG",8,156,40,196
https://kawalpemilu.org#25058,"CIT, RIAU SILIP, BANGKA, KEPULAUAN BANGKA BELITUNG",9,146,143,189
https://kawalpemilu.org#25058,"CIT, RIAU SILIP, BANGKA, KEPULAUAN BANGKA BELITUNG",10,136,78,214
https://kawalpemilu.org#25058,"CIT, RIAU SILIP, BANGKA, KEPULAUAN BANGKA BELITUNG",11,170,43,213
https://kawalpemilu.org#25058,"CIT, RIAU SILIP, BANGKA, KEPULAUAN BANGKA BELITUNG",12,131,24,155
https://kawalpemilu.org#25059,"DENIANG, RIAU SILIP, BANGKA, KEPULAUAN BANGKA BELITUNG",1,191,33,224
https://kawalpemilu.org#25059,"DENIANG, RIAU SILIP, BANGKA, KEPULAUAN BANGKA BELITUNG",2,200,44,244
https://kawalpemilu.org#25059,"DENIANG, RIAU SILIP, BANGKA, KEPULAUAN BANGKA BELITUNG",3,218,11,229
https://kawalpemilu.org#25059,"DENIANG, RIAU SILIP, BANGKA, KEPULAUAN BANGKA BELITUNG",4,217,3,220
https://kawalpemilu.org#25059,"DENIANG, RIAU SILIP, BANGKA, KEPULAUAN BANGKA BELITUNG",5,209,6,215
https://kawalpemilu.org#25059,"DENIANG, RIAU SILIP, BANGKA, KEPULAUAN BANGKA BELITUNG",6,224,14,238
https://kawalpemilu.org#25059,"DENIANG, RIAU SILIP, BANGKA, KEPULAUAN BANGKA BELITUNG",7,167,65,232
https://kawalpemilu.org#25060,"SILIP, RIAU SILIP, BANGKA, KEPULAUAN BANGKA BELITUNG",1,86,134,220
https://kawalpemilu.org#25060,"SILIP, RIAU SILIP, BANGKA, KEPULAUAN BANGKA BELITUNG",2,173,62,235
https://kawalpemilu.org#25060,"SILIP, RIAU SILIP, BANGKA, KEPULAUAN BANGKA BELITUNG",3,146,61,207
https://kawalpemilu.org#25060,"SILIP, RIAU SILIP, BANGKA, KEPULAUAN BANGKA BELITUNG",4,155,89,244
https://kawalpemilu.org#25060,"SILIP, RIAU SILIP, BANGKA, KEPULAUAN BANGKA BELITUNG",5,158,63,221
https://kawalpemilu.org#25060,"SILIP, RIAU SILIP, BANGKA, KEPULAUAN BANGKA BELITUNG",7,177,74,251
https://kawalpemilu.org#25061,"MAPUR, RIAU SILIP, BANGKA, KEPULAUAN BANGKA BELITUNG",1,195,43,238
https://kawalpemilu.org#25061,"MAPUR, RIAU SILIP, BANGKA, KEPULAUAN BANGKA BELITUNG",2,166,29,195
https://kawalpemilu.org#25061,"MAPUR, RIAU SILIP, BANGKA, KEPULAUAN BANGKA BELITUNG",3,240,33,273
https://kawalpemilu.org#25061,"MAPUR, RIAU SILIP, BANGKA, KEPULAUAN BANGKA BELITUNG",4,219,18,237
https://kawalpemilu.org#25061,"MAPUR, RIAU SILIP, BANGKA, KEPULAUAN BANGKA BELITUNG",5,209,66,275
https://kawalpemilu.org#25061,"MAPUR, RIAU SILIP, BANGKA, KEPULAUAN BANGKA BELITUNG",6,228,18,246
https://kawalpemilu.org#25062,"BANYU ASIN, RIAU SILIP, BANGKA, KEPULAUAN BANGKA BELITUNG",1,35,136,171
https://kawalpemilu.org#25062,"BANYU ASIN, RIAU SILIP, BANGKA, KEPULAUAN BANGKA BELITUNG",2,35,139,174
https://kawalpemilu.org#25062,"BANYU ASIN, RIAU SILIP, BANGKA, KEPULAUAN BANGKA BELITUNG",3,54,110,164
https://kawalpemilu.org#25062,"BANYU ASIN, RIAU SILIP, BANGKA, KEPULAUAN BANGKA BELITUNG",4,43,97,140
https://kawalpemilu.org#25062,"BANYU ASIN, RIAU SILIP, BANGKA, KEPULAUAN BANGKA BELITUNG",5,38,141,179
https://kawalpemilu.org#25062,"BANYU ASIN, RIAU SILIP, BANGKA, KEPULAUAN BANGKA BELITUNG",6,67,86,153
https://kawalpemilu.org#25063,"BERBURA, RIAU SILIP, BANGKA, KEPULAUAN BANGKA BELITUNG",1,112,47,159
https://kawalpemilu.org#25063,"BERBURA, RIAU SILIP, BANGKA, KEPULAUAN BANGKA BELITUNG",2,133,36,169
https://kawalpemilu.org#25063,"BERBURA, RIAU SILIP, BANGKA, KEPULAUAN BANGKA BELITUNG",3,126,19,145
https://kawalpemilu.org#25063,"BERBURA, RIAU SILIP, BANGKA, KEPULAUAN BANGKA BELITUNG",4,89,86,175
https://kawalpemilu.org#25063,"BERBURA, RIAU SILIP, BANGKA, KEPULAUAN BANGKA BELITUNG",5,93,158,251
https://kawalpemilu.org#25065,"PUDING BESAR, PUDING BESAR, BANGKA, KEPULAUAN BANGKA BELITUNG",1,32,186,218
https://kawalpemilu.org#25065,"PUDING BESAR, PUDING BESAR, BANGKA, KEPULAUAN BANGKA BELITUNG",2,43,194,237
https://kawalpemilu.org#25065,"PUDING BESAR, PUDING BESAR, BANGKA, KEPULAUAN BANGKA BELITUNG",3,49,194,243
https://kawalpemilu.org#25065,"PUDING BESAR, PUDING BESAR, BANGKA, KEPULAUAN BANGKA BELITUNG",4,50,192,242
https://kawalpemilu.org#25065,"PUDING BESAR, PUDING BESAR, BANGKA, KEPULAUAN BANGKA BELITUNG",5,74,173,247
https://kawalpemilu.org#25065,"PUDING BESAR, PUDING BESAR, BANGKA, KEPULAUAN BANGKA BELITUNG",6,43,205,248
https://kawalpemilu.org#25065,"PUDING BESAR, PUDING BESAR, BANGKA, KEPULAUAN BANGKA BELITUNG",7,62,168,230
https://kawalpemilu.org#25065,"PUDING BESAR, PUDING BESAR, BANGKA, KEPULAUAN BANGKA BELITUNG",8,73,172,245
https://kawalpemilu.org#25065,"PUDING BESAR, PUDING BESAR, BANGKA, KEPULAUAN BANGKA BELITUNG",9,61,197,258
https://kawalpemilu.org#25065,"PUDING BESAR, PUDING BESAR, BANGKA, KEPULAUAN BANGKA BELITUNG",10,44,152,195
https://kawalpemilu.org#25065,"PUDING BESAR, PUDING BESAR, BANGKA, KEPULAUAN BANGKA BELITUNG",11,53,169,222
https://kawalpemilu.org#25065,"PUDING BESAR, PUDING BESAR, BANGKA, KEPULAUAN BANGKA BELITUNG",12,61,180,241
https://kawalpemilu.org#25065,"PUDING BESAR, PUDING BESAR, BANGKA, KEPULAUAN BANGKA BELITUNG",13,48,175,223
https://kawalpemilu.org#25065,"PUDING BESAR, PUDING BESAR, BANGKA, KEPULAUAN BANGKA BELITUNG",14,60,184,244
https://kawalpemilu.org#25066,"LABU, PUDING BESAR, BANGKA, KEPULAUAN BANGKA BELITUNG",1,66,178,244
https://kawalpemilu.org#25066,"LABU, PUDING BESAR, BANGKA, KEPULAUAN BANGKA BELITUNG",2,53,186,239
https://kawalpemilu.org#25066,"LABU, PUDING BESAR, BANGKA, KEPULAUAN BANGKA BELITUNG",3,62,172,234
https://kawalpemilu.org#25066,"LABU, PUDING BESAR, BANGKA, KEPULAUAN BANGKA BELITUNG",4,71,164,235
https://kawalpemilu.org#25066,"LABU, PUDING BESAR, BANGKA, KEPULAUAN BANGKA BELITUNG",5,76,112,188
https://kawalpemilu.org#25066,"LABU, PUDING BESAR, BANGKA, KEPULAUAN BANGKA BELITUNG",6,63,155,218
https://kawalpemilu.org#25066,"LABU, PUDING BESAR, BANGKA, KEPULAUAN BANGKA BELITUNG",7,91,133,224
https://kawalpemilu.org#25067,"NIBUNG, PUDING BESAR, BANGKA, KEPULAUAN BANGKA BELITUNG",1,100,151,251
https://kawalpemilu.org#25067,"NIBUNG, PUDING BESAR, BANGKA, KEPULAUAN BANGKA BELITUNG",2,83,156,239
https://kawalpemilu.org#25067,"NIBUNG, PUDING BESAR, BANGKA, KEPULAUAN BANGKA BELITUNG",3,48,182,230
https://kawalpemilu.org#25067,"NIBUNG, PUDING BESAR, BANGKA, KEPULAUAN BANGKA BELITUNG",4,56,178,234
https://kawalpemilu.org#25067,"NIBUNG, PUDING BESAR, BANGKA, KEPULAUAN BANGKA BELITUNG",5,48,203,251
https://kawalpemilu.org#25067,"NIBUNG, PUDING BESAR, BANGKA, KEPULAUAN BANGKA BELITUNG",6,57,187,244
https://kawalpemilu.org#25067,"NIBUNG, PUDING BESAR, BANGKA, KEPULAUAN BANGKA BELITUNG",7,82,179,261
https://kawalpemilu.org#25068,"TANAH BAWAH, PUDING BESAR, BANGKA, KEPULAUAN BANGKA BELITUNG",1,72,113,185
https://kawalpemilu.org#25068,"TANAH BAWAH, PUDING BESAR, BANGKA, KEPULAUAN BANGKA BELITUNG",2,82,106,188
https://kawalpemilu.org#25068,"TANAH BAWAH, PUDING BESAR, BANGKA, KEPULAUAN BANGKA BELITUNG",3,70,96,166
https://kawalpemilu.org#25068,"TANAH BAWAH, PUDING BESAR, BANGKA, KEPULAUAN BANGKA BELITUNG",4,62,130,192
https://kawalpemilu.org#25068,"TANAH BAWAH, PUDING BESAR, BANGKA, KEPULAUAN BANGKA BELITUNG",5,101,85,186
https://kawalpemilu.org#25068,"TANAH BAWAH, PUDING BESAR, BANGKA, KEPULAUAN BANGKA BELITUNG",6,71,30,101
https://kawalpemilu.org#25069,"SAING, PUDING BESAR, BANGKA, KEPULAUAN BANGKA BELITUNG",1,86,83,169
https://kawalpemilu.org#25069,"SAING, PUDING BESAR, BANGKA, KEPULAUAN BANGKA BELITUNG",2,92,72,164
https://kawalpemilu.org#25069,"SAING, PUDING BESAR, BANGKA, KEPULAUAN BANGKA BELITUNG",3,103,64,167
https://kawalpemilu.org#25069,"SAING, PUDING BESAR, BANGKA, KEPULAUAN BANGKA BELITUNG",4,90,85,175
https://kawalpemilu.org#25069,"SAING, PUDING BESAR, BANGKA, KEPULAUAN BANGKA BELITUNG",5,92,79,171
https://kawalpemilu.org#25069,"SAING, PUDING BESAR, BANGKA, KEPULAUAN BANGKA BELITUNG",6,114,63,177
https://kawalpemilu.org#25070,"KOTA WARINGIN, PUDING BESAR, BANGKA, KEPULAUAN BANGKA BELITUNG",1,91,127,218
https://kawalpemilu.org#25070,"KOTA WARINGIN, PUDING BESAR, BANGKA, KEPULAUAN BANGKA BELITUNG",2,71,142,213
https://kawalpemilu.org#25070,"KOTA WARINGIN, PUDING BESAR, BANGKA, KEPULAUAN BANGKA BELITUNG",3,62,128,190
https://kawalpemilu.org#25070,"KOTA WARINGIN, PUDING BESAR, BANGKA, KEPULAUAN BANGKA BELITUNG",4,68,124,192
https://kawalpemilu.org#25070,"KOTA WARINGIN, PUDING BESAR, BANGKA, KEPULAUAN BANGKA BELITUNG",5,100,88,188
https://kawalpemilu.org#25070,"KOTA WARINGIN, PUDING BESAR, BANGKA, KEPULAUAN BANGKA BELITUNG",6,83,13,96
https://kawalpemilu.org#25070,"KOTA WARINGIN, PUDING BESAR, BANGKA, KEPULAUAN BANGKA BELITUNG",7,149,53,202
https://kawalpemilu.org#25070,"KOTA WARINGIN, PUDING BESAR, BANGKA, KEPULAUAN BANGKA BELITUNG",8,171,41,212
https://kawalpemilu.org#25071,"KAYU BESI, PUDING BESAR, BANGKA, KEPULAUAN BANGKA BELITUNG",1,45,180,225
https://kawalpemilu.org#25071,"KAYU BESI, PUDING BESAR, BANGKA, KEPULAUAN BANGKA BELITUNG",2,32,188,220
https://kawalpemilu.org#25071,"KAYU BESI, PUDING BESAR, BANGKA, KEPULAUAN BANGKA BELITUNG",3,45,164,209
https://kawalpemilu.org#25071,"KAYU BESI, PUDING BESAR, BANGKA, KEPULAUAN BANGKA BELITUNG",4,52,148,200
https://kawalpemilu.org#25071,"KAYU BESI, PUDING BESAR, BANGKA, KEPULAUAN BANGKA BELITUNG",5,103,121,224
https://kawalpemilu.org#25071,"KAYU BESI, PUDING BESAR, BANGKA, KEPULAUAN BANGKA BELITUNG",6,65,141,206
https://kawalpemilu.org#25074,"KOTA, TANJUNG PANDAN, BELITUNG, KEPULAUAN BANGKA BELITUNG",1,102,64,166
https://kawalpemilu.org#25074,"KOTA, TANJUNG PANDAN, BELITUNG, KEPULAUAN BANGKA BELITUNG",2,164,13,177
https://kawalpemilu.org#25074,"KOTA, TANJUNG PANDAN, BELITUNG, KEPULAUAN BANGKA BELITUNG",3,143,31,174
https://kawalpemilu.org#25074,"KOTA, TANJUNG PANDAN, BELITUNG, KEPULAUAN BANGKA BELITUNG",4,121,65,186
https://kawalpemilu.org#25074,"KOTA, TANJUNG PANDAN, BELITUNG, KEPULAUAN BANGKA BELITUNG",5,157,31,188
https://kawalpemilu.org#25074,"KOTA, TANJUNG PANDAN, BELITUNG, KEPULAUAN BANGKA BELITUNG",6,171,44,215
https://kawalpemilu.org#25074,"KOTA, TANJUNG PANDAN, BELITUNG, KEPULAUAN BANGKA BELITUNG",7,118,92,210
https://kawalpemilu.org#25074,"KOTA, TANJUNG PANDAN, BELITUNG, KEPULAUAN BANGKA BELITUNG",8,160,83,243
https://kawalpemilu.org#25074,"KOTA, TANJUNG PANDAN, BELITUNG, KEPULAUAN BANGKA BELITUNG",9,87,125,212
https://kawalpemilu.org#25074,"KOTA, TANJUNG PANDAN, BELITUNG, KEPULAUAN BANGKA BELITUNG",10,97,92,189
https://kawalpemilu.org#25074,"KOTA, TANJUNG PANDAN, BELITUNG, KEPULAUAN BANGKA BELITUNG",11,100,103,203
https://kawalpemilu.org#25074,"KOTA, TANJUNG PANDAN, BELITUNG, KEPULAUAN BANGKA BELITUNG",12,121,102,223
https://kawalpemilu.org#25075,"PARIT, TANJUNG PANDAN, BELITUNG, KEPULAUAN BANGKA BELITUNG",1,166,75,241
https://kawalpemilu.org#25075,"PARIT, TANJUNG PANDAN, BELITUNG, KEPULAUAN BANGKA BELITUNG",2,128,38,166
https://kawalpemilu.org#25075,"PARIT, TANJUNG PANDAN, BELITUNG, KEPULAUAN BANGKA BELITUNG",3,140,85,225
https://kawalpemilu.org#25075,"PARIT, TANJUNG PANDAN, BELITUNG, KEPULAUAN BANGKA BELITUNG",4,83,45,128
https://kawalpemilu.org#25075,"PARIT, TANJUNG PANDAN, BELITUNG, KEPULAUAN BANGKA BELITUNG",5,100,50,150
https://kawalpemilu.org#25075,"PARIT, TANJUNG PANDAN, BELITUNG, KEPULAUAN BANGKA BELITUNG",6,177,54,231
https://kawalpemilu.org#25075,"PARIT, TANJUNG PANDAN, BELITUNG, KEPULAUAN BANGKA BELITUNG",7,99,45,144
https://kawalpemilu.org#25075,"PARIT, TANJUNG PANDAN, BELITUNG, KEPULAUAN BANGKA BELITUNG",8,93,38,131
https://kawalpemilu.org#25075,"PARIT, TANJUNG PANDAN, BELITUNG, KEPULAUAN BANGKA BELITUNG",9,184,56,240
https://kawalpemilu.org#25075,"PARIT, TANJUNG PANDAN, BELITUNG, KEPULAUAN BANGKA BELITUNG",10,145,27,172
https://kawalpemilu.org#25075,"PARIT, TANJUNG PANDAN, BELITUNG, KEPULAUAN BANGKA BELITUNG",11,174,4,178
https://kawalpemilu.org#25075,"PARIT, TANJUNG PANDAN, BELITUNG, KEPULAUAN BANGKA BELITUNG",12,116,57,173
https://kawalpemilu.org#25075,"PARIT, TANJUNG PANDAN, BELITUNG, KEPULAUAN BANGKA BELITUNG",13,133,102,235
https://kawalpemilu.org#25075,"PARIT, TANJUNG PANDAN, BELITUNG, KEPULAUAN BANGKA BELITUNG",14,98,43,141
https://kawalpemilu.org#25075,"PARIT, TANJUNG PANDAN, BELITUNG, KEPULAUAN BANGKA BELITUNG",15,77,32,109
https://kawalpemilu.org#25075,"PARIT, TANJUNG PANDAN, BELITUNG, KEPULAUAN BANGKA BELITUNG",16,78,42,120
https://kawalpemilu.org#25075,"PARIT, TANJUNG PANDAN, BELITUNG, KEPULAUAN BANGKA BELITUNG",17,115,41,156
https://kawalpemilu.org#25075,"PARIT, TANJUNG PANDAN, BELITUNG, KEPULAUAN BANGKA BELITUNG",18,101,49,150
https://kawalpemilu.org#25075,"PARIT, TANJUNG PANDAN, BELITUNG, KEPULAUAN BANGKA BELITUNG",19,103,66,169
https://kawalpemilu.org#25076,"BULUH TUMBANG, TANJUNG PANDAN, BELITUNG, KEPULAUAN BANGKA BELITUNG",1,151,62,213
https://kawalpemilu.org#25076,"BULUH TUMBANG, TANJUNG PANDAN, BELITUNG, KEPULAUAN BANGKA BELITUNG",2,153,35,188
https://kawalpemilu.org#25076,"BULUH TUMBANG, TANJUNG PANDAN, BELITUNG, KEPULAUAN BANGKA BELITUNG",3,120,38,158
https://kawalpemilu.org#25076,"BULUH TUMBANG, TANJUNG PANDAN, BELITUNG, KEPULAUAN BANGKA BELITUNG",4,175,87,262
https://kawalpemilu.org#25076,"BULUH TUMBANG, TANJUNG PANDAN, BELITUNG, KEPULAUAN BANGKA BELITUNG",5,154,71,225
https://kawalpemilu.org#25076,"BULUH TUMBANG, TANJUNG PANDAN, BELITUNG, KEPULAUAN BANGKA BELITUNG",6,135,107,242
https://kawalpemilu.org#25076,"BULUH TUMBANG, TANJUNG PANDAN, BELITUNG, KEPULAUAN BANGKA BELITUNG",7,161,84,245
https://kawalpemilu.org#25076,"BULUH TUMBANG, TANJUNG PANDAN, BELITUNG, KEPULAUAN BANGKA BELITUNG",8,132,49,181
https://kawalpemilu.org#25076,"BULUH TUMBANG, TANJUNG PANDAN, BELITUNG, KEPULAUAN BANGKA BELITUNG",9,181,66,247
https://kawalpemilu.org#25076,"BULUH TUMBANG, TANJUNG PANDAN, BELITUNG, KEPULAUAN BANGKA BELITUNG",10,162,34,196
https://kawalpemilu.org#25076,"BULUH TUMBANG, TANJUNG PANDAN, BELITUNG, KEPULAUAN BANGKA BELITUNG",11,154,28,182
https://kawalpemilu.org#25077,"PERAWAS, TANJUNG PANDAN, BELITUNG, KEPULAUAN BANGKA BELITUNG",1,159,71,230
https://kawalpemilu.org#25077,"PERAWAS, TANJUNG PANDAN, BELITUNG, KEPULAUAN BANGKA BELITUNG",2,113,73,186
https://kawalpemilu.org#25077,"PERAWAS, TANJUNG PANDAN, BELITUNG, KEPULAUAN BANGKA BELITUNG",3,131,65,196
https://kawalpemilu.org#25077,"PERAWAS, TANJUNG PANDAN, BELITUNG, KEPULAUAN BANGKA BELITUNG",4,98,90,188
https://kawalpemilu.org#25077,"PERAWAS, TANJUNG PANDAN, BELITUNG, KEPULAUAN BANGKA BELITUNG",5,83,82,165
https://kawalpemilu.org#25077,"PERAWAS, TANJUNG PANDAN, BELITUNG, KEPULAUAN BANGKA BELITUNG",6,102,57,159
https://kawalpemilu.org#25077,"PERAWAS, TANJUNG PANDAN, BELITUNG, KEPULAUAN BANGKA BELITUNG",7,153,58,211
https://kawalpemilu.org#25077,"PERAWAS, TANJUNG PANDAN, BELITUNG, KEPULAUAN BANGKA BELITUNG",8,162,54,216
https://kawalpemilu.org#25077,"PERAWAS, TANJUNG PANDAN, BELITUNG, KEPULAUAN BANGKA BELITUNG",9,176,28,204
https://kawalpemilu.org#25077,"PERAWAS, TANJUNG PANDAN, BELITUNG, KEPULAUAN BANGKA BELITUNG",10,149,27,176
https://kawalpemilu.org#25077,"PERAWAS, TANJUNG PANDAN, BELITUNG, KEPULAUAN BANGKA BELITUNG",11,149,33,182
https://kawalpemilu.org#25077,"PERAWAS, TANJUNG PANDAN, BELITUNG, KEPULAUAN BANGKA BELITUNG",12,130,70,200
https://kawalpemilu.org#25077,"PERAWAS, TANJUNG PANDAN, BELITUNG, KEPULAUAN BANGKA BELITUNG",13,157,55,212
https://kawalpemilu.org#25078,"LESUNG BATANG, TANJUNG PANDAN, BELITUNG, KEPULAUAN BANGKA BELITUNG",1,97,88,185
https://kawalpemilu.org#25078,"LESUNG BATANG, TANJUNG PANDAN, BELITUNG, KEPULAUAN BANGKA BELITUNG",2,118,109,227
https://kawalpemilu.org#25078,"LESUNG BATANG, TANJUNG PANDAN, BELITUNG, KEPULAUAN BANGKA BELITUNG",3,175,71,246
https://kawalpemilu.org#25078,"LESUNG BATANG, TANJUNG PANDAN, BELITUNG, KEPULAUAN BANGKA BELITUNG",4,181,72,253
https://kawalpemilu.org#25078,"LESUNG BATANG, TANJUNG PANDAN, BELITUNG, KEPULAUAN BANGKA BELITUNG",5,187,75,262
https://kawalpemilu.org#25078,"LESUNG BATANG, TANJUNG PANDAN, BELITUNG, KEPULAUAN BANGKA BELITUNG",6,133,114,247
https://kawalpemilu.org#25078,"LESUNG BATANG, TANJUNG PANDAN, BELITUNG, KEPULAUAN BANGKA BELITUNG",7,143,107,250
https://kawalpemilu.org#25078,"LESUNG BATANG, TANJUNG PANDAN, BELITUNG, KEPULAUAN BANGKA BELITUNG",8,181,77,258
https://kawalpemilu.org#25078,"LESUNG BATANG, TANJUNG PANDAN, BELITUNG, KEPULAUAN BANGKA BELITUNG",9,144,103,247
https://kawalpemilu.org#25078,"LESUNG BATANG, TANJUNG PANDAN, BELITUNG, KEPULAUAN BANGKA BELITUNG",10,141,87,228
https://kawalpemilu.org#25078,"LESUNG BATANG, TANJUNG PANDAN, BELITUNG, KEPULAUAN BANGKA BELITUNG",11,153,62,215
https://kawalpemilu.org#25078,"LESUNG BATANG, TANJUNG PANDAN, BELITUNG, KEPULAUAN BANGKA BELITUNG",12,115,77,192
https://kawalpemilu.org#25078,"LESUNG BATANG, TANJUNG PANDAN, BELITUNG, KEPULAUAN BANGKA BELITUNG",13,147,71,218
https://kawalpemilu.org#25078,"LESUNG BATANG, TANJUNG PANDAN, BELITUNG, KEPULAUAN BANGKA BELITUNG",14,189,52,241
https://kawalpemilu.org#25078,"LESUNG BATANG, TANJUNG PANDAN, BELITUNG, KEPULAUAN BANGKA BELITUNG",15,145,83,228
https://kawalpemilu.org#25078,"LESUNG BATANG, TANJUNG PANDAN, BELITUNG, KEPULAUAN BANGKA BELITUNG",16,80,133,213
https://kawalpemilu.org#25078,"LESUNG BATANG, TANJUNG PANDAN, BELITUNG, KEPULAUAN BANGKA BELITUNG",17,88,116,204
https://kawalpemilu.org#25079,"PANGKAL LALANG, TANJUNG PANDAN, BELITUNG, KEPULAUAN BANGKA BELITUNG",1,141,108,249
https://kawalpemilu.org#25079,"PANGKAL LALANG, TANJUNG PANDAN, BELITUNG, KEPULAUAN BANGKA BELITUNG",2,147,89,236
https://kawalpemilu.org#25079,"PANGKAL LALANG, TANJUNG PANDAN, BELITUNG, KEPULAUAN BANGKA BELITUNG",3,165,78,243
https://kawalpemilu.org#25079,"PANGKAL LALANG, TANJUNG PANDAN, BELITUNG, KEPULAUAN BANGKA BELITUNG",4,156,95,251
https://kawalpemilu.org#25079,"PANGKAL LALANG, TANJUNG PANDAN, BELITUNG, KEPULAUAN BANGKA BELITUNG",5,146,98,244
https://kawalpemilu.org#25079,"PANGKAL LALANG, TANJUNG PANDAN, BELITUNG, KEPULAUAN BANGKA BELITUNG",6,146,91,237
https://kawalpemilu.org#25079,"PANGKAL LALANG, TANJUNG PANDAN, BELITUNG, KEPULAUAN BANGKA BELITUNG",7,157,99,256
https://kawalpemilu.org#25079,"PANGKAL LALANG, TANJUNG PANDAN, BELITUNG, KEPULAUAN BANGKA BELITUNG",8,141,108,249
https://kawalpemilu.org#25079,"PANGKAL LALANG, TANJUNG PANDAN, BELITUNG, KEPULAUAN BANGKA BELITUNG",9,118,104,222
https://kawalpemilu.org#25079,"PANGKAL LALANG, TANJUNG PANDAN, BELITUNG, KEPULAUAN BANGKA BELITUNG",10,132,95,227
https://kawalpemilu.org#25079,"PANGKAL LALANG, TANJUNG PANDAN, BELITUNG, KEPULAUAN BANGKA BELITUNG",11,136,90,226
https://kawalpemilu.org#25079,"PANGKAL LALANG, TANJUNG PANDAN, BELITUNG, KEPULAUAN BANGKA BELITUNG",12,152,81,233
https://kawalpemilu.org#25079,"PANGKAL LALANG, TANJUNG PANDAN, BELITUNG, KEPULAUAN BANGKA BELITUNG",13,123,102,225
https://kawalpemilu.org#25079,"PANGKAL LALANG, TANJUNG PANDAN, BELITUNG, KEPULAUAN BANGKA BELITUNG",14,128,109,237
https://kawalpemilu.org#25079,"PANGKAL LALANG, TANJUNG PANDAN, BELITUNG, KEPULAUAN BANGKA BELITUNG",15,101,96,197
https://kawalpemilu.org#25079,"PANGKAL LALANG, TANJUNG PANDAN, BELITUNG, KEPULAUAN BANGKA BELITUNG",16,144,91,235
https://kawalpemilu.org#25079,"PANGKAL LALANG, TANJUNG PANDAN, BELITUNG, KEPULAUAN BANGKA BELITUNG",17,141,104,245
https://kawalpemilu.org#25079,"PANGKAL LALANG, TANJUNG PANDAN, BELITUNG, KEPULAUAN BANGKA BELITUNG",18,137,98,235
https://kawalpemilu.org#25079,"PANGKAL LALANG, TANJUNG PANDAN, BELITUNG, KEPULAUAN BANGKA BELITUNG",19,158,71,229
https://kawalpemilu.org#25079,"PANGKAL LALANG, TANJUNG PANDAN, BELITUNG, KEPULAUAN BANGKA BELITUNG",20,112,98,210
https://kawalpemilu.org#25079,"PANGKAL LALANG, TANJUNG PANDAN, BELITUNG, KEPULAUAN BANGKA BELITUNG",21,68,75,143
https://kawalpemilu.org#25079,"PANGKAL LALANG, TANJUNG PANDAN, BELITUNG, KEPULAUAN BANGKA BELITUNG",22,155,96,251
https://kawalpemilu.org#25079,"PANGKAL LALANG, TANJUNG PANDAN, BELITUNG, KEPULAUAN BANGKA BELITUNG",23,116,88,204
https://kawalpemilu.org#25079,"PANGKAL LALANG, TANJUNG PANDAN, BELITUNG, KEPULAUAN BANGKA BELITUNG",24,146,48,194
https://kawalpemilu.org#25079,"PANGKAL LALANG, TANJUNG PANDAN, BELITUNG, KEPULAUAN BANGKA BELITUNG",25,143,52,195
https://kawalpemilu.org#25079,"PANGKAL LALANG, TANJUNG PANDAN, BELITUNG, KEPULAUAN BANGKA BELITUNG",26,119,67,186
https://kawalpemilu.org#25079,"PANGKAL LALANG, TANJUNG PANDAN, BELITUNG, KEPULAUAN BANGKA BELITUNG",27,141,92,233
https://kawalpemilu.org#25079,"PANGKAL LALANG, TANJUNG PANDAN, BELITUNG, KEPULAUAN BANGKA BELITUNG",28,121,106,227
https://kawalpemilu.org#25079,"PANGKAL LALANG, TANJUNG PANDAN, BELITUNG, KEPULAUAN BANGKA BELITUNG",29,139,71,210
https://kawalpemilu.org#25079,"PANGKAL LALANG, TANJUNG PANDAN, BELITUNG, KEPULAUAN BANGKA BELITUNG",30,147,91,238
https://kawalpemilu.org#25079,"PANGKAL LALANG, TANJUNG PANDAN, BELITUNG, KEPULAUAN BANGKA BELITUNG",31,134,95,229
https://kawalpemilu.org#25080,"DUKONG, TANJUNG PANDAN, BELITUNG, KEPULAUAN BANGKA BELITUNG",1,190,64,254
https://kawalpemilu.org#25080,"DUKONG, TANJUNG PANDAN, BELITUNG, KEPULAUAN BANGKA BELITUNG",2,183,41,224
https://kawalpemilu.org#25080,"DUKONG, TANJUNG PANDAN, BELITUNG, KEPULAUAN BANGKA BELITUNG",3,205,44,249
https://kawalpemilu.org#25080,"DUKONG, TANJUNG PANDAN, BELITUNG, KEPULAUAN BANGKA BELITUNG",4,172,78,250
https://kawalpemilu.org#25080,"DUKONG, TANJUNG PANDAN, BELITUNG, KEPULAUAN BANGKA BELITUNG",5,192,53,245
https://kawalpemilu.org#25080,"DUKONG, TANJUNG PANDAN, BELITUNG, KEPULAUAN BANGKA BELITUNG",6,176,61,237
https://kawalpemilu.org#25080,"DUKONG, TANJUNG PANDAN, BELITUNG, KEPULAUAN BANGKA BELITUNG",7,174,65,239
https://kawalpemilu.org#25080,"DUKONG, TANJUNG PANDAN, BELITUNG, KEPULAUAN BANGKA BELITUNG",8,185,50,235
https://kawalpemilu.org#25080,"DUKONG, TANJUNG PANDAN, BELITUNG, KEPULAUAN BANGKA BELITUNG",9,185,48,233
https://kawalpemilu.org#25080,"DUKONG, TANJUNG PANDAN, BELITUNG, KEPULAUAN BANGKA BELITUNG",10,169,64,233
https://kawalpemilu.org#25080,"DUKONG, TANJUNG PANDAN, BELITUNG, KEPULAUAN BANGKA BELITUNG",11,171,63,234
https://kawalpemilu.org#25080,"DUKONG, TANJUNG PANDAN, BELITUNG, KEPULAUAN BANGKA BELITUNG",12,180,60,240
https://kawalpemilu.org#25080,"DUKONG, TANJUNG PANDAN, BELITUNG, KEPULAUAN BANGKA BELITUNG",13,88,38,126
https://kawalpemilu.org#25081,"JURU SEBERANG, TANJUNG PANDAN, BELITUNG, KEPULAUAN BANGKA BELITUNG",1,153,68,221
https://kawalpemilu.org#25081,"JURU SEBERANG, TANJUNG PANDAN, BELITUNG, KEPULAUAN BANGKA BELITUNG",2,157,55,212
https://kawalpemilu.org#25081,"JURU SEBERANG, TANJUNG PANDAN, BELITUNG, KEPULAUAN BANGKA BELITUNG",3,168,48,216
https://kawalpemilu.org#25081,"JURU SEBERANG, TANJUNG PANDAN, BELITUNG, KEPULAUAN BANGKA BELITUNG",4,171,40,211
https://kawalpemilu.org#25081,"JURU SEBERANG, TANJUNG PANDAN, BELITUNG, KEPULAUAN BANGKA BELITUNG",5,178,26,204
https://kawalpemilu.org#25081,"JURU SEBERANG, TANJUNG PANDAN, BELITUNG, KEPULAUAN BANGKA BELITUNG",6,185,14,199
https://kawalpemilu.org#25081,"JURU SEBERANG, TANJUNG PANDAN, BELITUNG, KEPULAUAN BANGKA BELITUNG",7,175,26,201
https://kawalpemilu.org#25082,"TANJUNGPENDAM, TANJUNG PANDAN, BELITUNG, KEPULAUAN BANGKA BELITUNG",1,170,76,256
https://kawalpemilu.org#25082,"TANJUNGPENDAM, TANJUNG PANDAN, BELITUNG, KEPULAUAN BANGKA BELITUNG",2,170,50,220
https://kawalpemilu.org#25082,"TANJUNGPENDAM, TANJUNG PANDAN, BELITUNG, KEPULAUAN BANGKA BELITUNG",3,123,71,194
https://kawalpemilu.org#25082,"TANJUNGPENDAM, TANJUNG PANDAN, BELITUNG, KEPULAUAN BANGKA BELITUNG",4,154,65,219
https://kawalpemilu.org#25082,"TANJUNGPENDAM, TANJUNG PANDAN, BELITUNG, KEPULAUAN BANGKA BELITUNG",5,145,73,218
https://kawalpemilu.org#25082,"TANJUNGPENDAM, TANJUNG PANDAN, BELITUNG, KEPULAUAN BANGKA BELITUNG",6,129,84,213
https://kawalpemilu.org#25082,"TANJUNGPENDAM, TANJUNG PANDAN, BELITUNG, KEPULAUAN BANGKA BELITUNG",7,117,86,203
https://kawalpemilu.org#25082,"TANJUNGPENDAM, TANJUNG PANDAN, BELITUNG, KEPULAUAN BANGKA BELITUNG",8,132,94,226
https://kawalpemilu.org#25082,"TANJUNGPENDAM, TANJUNG PANDAN, BELITUNG, KEPULAUAN BANGKA BELITUNG",9,137,101,238
https://kawalpemilu.org#25082,"TANJUNGPENDAM, TANJUNG PANDAN, BELITUNG, KEPULAUAN BANGKA BELITUNG",10,138,81,219
https://kawalpemilu.org#25082,"TANJUNGPENDAM, TANJUNG PANDAN, BELITUNG, KEPULAUAN BANGKA BELITUNG",11,121,98,219
https://kawalpemilu.org#25082,"TANJUNGPENDAM, TANJUNG PANDAN, BELITUNG, KEPULAUAN BANGKA BELITUNG",12,150,94,244
https://kawalpemilu.org#25082,"TANJUNGPENDAM, TANJUNG PANDAN, BELITUNG, KEPULAUAN BANGKA BELITUNG",13,131,40,171
https://kawalpemilu.org#25082,"TANJUNGPENDAM, TANJUNG PANDAN, BELITUNG, KEPULAUAN BANGKA BELITUNG",14,137,50,187
https://kawalpemilu.org#25082,"TANJUNGPENDAM, TANJUNG PANDAN, BELITUNG, KEPULAUAN BANGKA BELITUNG",15,144,60,204
https://kawalpemilu.org#25083,"AIR SAGA, TANJUNG PANDAN, BELITUNG, KEPULAUAN BANGKA BELITUNG",1,153,49,202
https://kawalpemilu.org#25083,"AIR SAGA, TANJUNG PANDAN, BELITUNG, KEPULAUAN BANGKA BELITUNG",2,169,53,222
https://kawalpemilu.org#25083,"AIR SAGA, TANJUNG PANDAN, BELITUNG, KEPULAUAN BANGKA BELITUNG",3,165,96,261
https://kawalpemilu.org#25083,"AIR SAGA, TANJUNG PANDAN, BELITUNG, KEPULAUAN BANGKA BELITUNG",4,147,80,227
https://kawalpemilu.org#25083,"AIR SAGA, TANJUNG PANDAN, BELITUNG, KEPULAUAN BANGKA BELITUNG",5,145,87,232
https://kawalpemilu.org#25083,"AIR SAGA, TANJUNG PANDAN, BELITUNG, KEPULAUAN BANGKA BELITUNG",6,147,74,221
https://kawalpemilu.org#25083,"AIR SAGA, TANJUNG PANDAN, BELITUNG, KEPULAUAN BANGKA BELITUNG",7,159,54,213
https://kawalpemilu.org#25083,"AIR SAGA, TANJUNG PANDAN, BELITUNG, KEPULAUAN BANGKA BELITUNG",8,176,30,206
https://kawalpemilu.org#25083,"AIR SAGA, TANJUNG PANDAN, BELITUNG, KEPULAUAN BANGKA BELITUNG",9,155,48,203
https://kawalpemilu.org#25083,"AIR SAGA, TANJUNG PANDAN, BELITUNG, KEPULAUAN BANGKA BELITUNG",10,134,87,221
https://kawalpemilu.org#25083,"AIR SAGA, TANJUNG PANDAN, BELITUNG, KEPULAUAN BANGKA BELITUNG",11,105,79,184
https://kawalpemilu.org#25083,"AIR SAGA, TANJUNG PANDAN, BELITUNG, KEPULAUAN BANGKA BELITUNG",12,98,58,156
https://kawalpemilu.org#25083,"AIR SAGA, TANJUNG PANDAN, BELITUNG, KEPULAUAN BANGKA BELITUNG",13,142,47,189
https://kawalpemilu.org#25083,"AIR SAGA, TANJUNG PANDAN, BELITUNG, KEPULAUAN BANGKA BELITUNG",14,115,56,171
https://kawalpemilu.org#25083,"AIR SAGA, TANJUNG PANDAN, BELITUNG, KEPULAUAN BANGKA BELITUNG",15,73,44,117
https://kawalpemilu.org#25083,"AIR SAGA, TANJUNG PANDAN, BELITUNG, KEPULAUAN BANGKA BELITUNG",16,0,0,0
https://kawalpemilu.org#25083,"AIR SAGA, TANJUNG PANDAN, BELITUNG, KEPULAUAN BANGKA BELITUNG",17,202,52,254
https://kawalpemilu.org#25083,"AIR SAGA, TANJUNG PANDAN, BELITUNG, KEPULAUAN BANGKA BELITUNG",18,159,73,232
https://kawalpemilu.org#25083,"AIR SAGA, TANJUNG PANDAN, BELITUNG, KEPULAUAN BANGKA BELITUNG",19,148,80,228
https://kawalpemilu.org#25083,"AIR SAGA, TANJUNG PANDAN, BELITUNG, KEPULAUAN BANGKA BELITUNG",20,103,77,180
https://kawalpemilu.org#25083,"AIR SAGA, TANJUNG PANDAN, BELITUNG, KEPULAUAN BANGKA BELITUNG",21,133,57,190
https://kawalpemilu.org#25083,"AIR SAGA, TANJUNG PANDAN, BELITUNG, KEPULAUAN BANGKA BELITUNG",22,181,51,232
https://kawalpemilu.org#25083,"AIR SAGA, TANJUNG PANDAN, BELITUNG, KEPULAUAN BANGKA BELITUNG",23,121,65,186
https://kawalpemilu.org#25083,"AIR SAGA, TANJUNG PANDAN, BELITUNG, KEPULAUAN BANGKA BELITUNG",24,69,56,125
https://kawalpemilu.org#25083,"AIR SAGA, TANJUNG PANDAN, BELITUNG, KEPULAUAN BANGKA BELITUNG",25,98,31,129
https://kawalpemilu.org#25083,"AIR SAGA, TANJUNG PANDAN, BELITUNG, KEPULAUAN BANGKA BELITUNG",26,143,91,234
https://kawalpemilu.org#25083,"AIR SAGA, TANJUNG PANDAN, BELITUNG, KEPULAUAN BANGKA BELITUNG",27,131,64,195
https://kawalpemilu.org#25083,"AIR SAGA, TANJUNG PANDAN, BELITUNG, KEPULAUAN BANGKA BELITUNG",28,192,85,277
https://kawalpemilu.org#25083,"AIR SAGA, TANJUNG PANDAN, BELITUNG, KEPULAUAN BANGKA BELITUNG",29,136,63,199
https://kawalpemilu.org#25084,"PAAL SATU, TANJUNG PANDAN, BELITUNG, KEPULAUAN BANGKA BELITUNG",1,144,59,203
https://kawalpemilu.org#25084,"PAAL SATU, TANJUNG PANDAN, BELITUNG, KEPULAUAN BANGKA BELITUNG",2,129,83,212
https://kawalpemilu.org#25084,"PAAL SATU, TANJUNG PANDAN, BELITUNG, KEPULAUAN BANGKA BELITUNG",3,125,68,193
https://kawalpemilu.org#25084,"PAAL SATU, TANJUNG PANDAN, BELITUNG, KEPULAUAN BANGKA BELITUNG",4,165,98,263
https://kawalpemilu.org#25084,"PAAL SATU, TANJUNG PANDAN, BELITUNG, KEPULAUAN BANGKA BELITUNG",5,74,77,151
https://kawalpemilu.org#25084,"PAAL SATU, TANJUNG PANDAN, BELITUNG, KEPULAUAN BANGKA BELITUNG",6,103,23,126
https://kawalpemilu.org#25084,"PAAL SATU, TANJUNG PANDAN, BELITUNG, KEPULAUAN BANGKA BELITUNG",7,143,61,204
https://kawalpemilu.org#25084,"PAAL SATU, TANJUNG PANDAN, BELITUNG, KEPULAUAN BANGKA BELITUNG",8,83,70,153
https://kawalpemilu.org#25084,"PAAL SATU, TANJUNG PANDAN, BELITUNG, KEPULAUAN BANGKA BELITUNG",9,172,43,215
https://kawalpemilu.org#25084,"PAAL SATU, TANJUNG PANDAN, BELITUNG, KEPULAUAN BANGKA BELITUNG",10,112,50,162
https://kawalpemilu.org#25084,"PAAL SATU, TANJUNG PANDAN, BELITUNG, KEPULAUAN BANGKA BELITUNG",11,163,91,254
https://kawalpemilu.org#25084,"PAAL SATU, TANJUNG PANDAN, BELITUNG, KEPULAUAN BANGKA BELITUNG",12,119,26,145
https://kawalpemilu.org#25084,"PAAL SATU, TANJUNG PANDAN, BELITUNG, KEPULAUAN BANGKA BELITUNG",13,137,32,169
https://kawalpemilu.org#25084,"PAAL SATU, TANJUNG PANDAN, BELITUNG, KEPULAUAN BANGKA BELITUNG",14,203,28,231
https://kawalpemilu.org#25084,"PAAL SATU, TANJUNG PANDAN, BELITUNG, KEPULAUAN BANGKA BELITUNG",15,113,50,163
https://kawalpemilu.org#25084,"PAAL SATU, TANJUNG PANDAN, BELITUNG, KEPULAUAN BANGKA BELITUNG",16,119,55,174
https://kawalpemilu.org#25084,"PAAL SATU, TANJUNG PANDAN, BELITUNG, KEPULAUAN BANGKA BELITUNG",17,128,26,154
https://kawalpemilu.org#25084,"PAAL SATU, TANJUNG PANDAN, BELITUNG, KEPULAUAN BANGKA BELITUNG",18,115,28,143
https://kawalpemilu.org#25084,"PAAL SATU, TANJUNG PANDAN, BELITUNG, KEPULAUAN BANGKA BELITUNG",19,180,63,243
https://kawalpemilu.org#25084,"PAAL SATU, TANJUNG PANDAN, BELITUNG, KEPULAUAN BANGKA BELITUNG",20,197,64,261
https://kawalpemilu.org#25084,"PAAL SATU, TANJUNG PANDAN, BELITUNG, KEPULAUAN BANGKA BELITUNG",21,151,48,199
https://kawalpemilu.org#25084,"PAAL SATU, TANJUNG PANDAN, BELITUNG, KEPULAUAN BANGKA BELITUNG",22,143,85,228
https://kawalpemilu.org#25084,"PAAL SATU, TANJUNG PANDAN, BELITUNG, KEPULAUAN BANGKA BELITUNG",23,91,85,176
https://kawalpemilu.org#25084,"PAAL SATU, TANJUNG PANDAN, BELITUNG, KEPULAUAN BANGKA BELITUNG",24,127,33,160
https://kawalpemilu.org#25084,"PAAL SATU, TANJUNG PANDAN, BELITUNG, KEPULAUAN BANGKA BELITUNG",25,185,61,246
https://kawalpemilu.org#25084,"PAAL SATU, TANJUNG PANDAN, BELITUNG, KEPULAUAN BANGKA BELITUNG",26,167,45,212
https://kawalpemilu.org#25085,"AIR MERBAU, TANJUNG PANDAN, BELITUNG, KEPULAUAN BANGKA BELITUNG",1,160,83,243
https://kawalpemilu.org#25085,"AIR MERBAU, TANJUNG PANDAN, BELITUNG, KEPULAUAN BANGKA BELITUNG",2,149,94,243
https://kawalpemilu.org#25085,"AIR MERBAU, TANJUNG PANDAN, BELITUNG, KEPULAUAN BANGKA BELITUNG",3,154,99,253
https://kawalpemilu.org#25085,"AIR MERBAU, TANJUNG PANDAN, BELITUNG, KEPULAUAN BANGKA BELITUNG",4,159,79,238
https://kawalpemilu.org#25085,"AIR MERBAU, TANJUNG PANDAN, BELITUNG, KEPULAUAN BANGKA BELITUNG",5,180,39,219
https://kawalpemilu.org#25085,"AIR MERBAU, TANJUNG PANDAN, BELITUNG, KEPULAUAN BANGKA BELITUNG",6,171,44,215
https://kawalpemilu.org#25085,"AIR MERBAU, TANJUNG PANDAN, BELITUNG, KEPULAUAN BANGKA BELITUNG",7,127,109,236
https://kawalpemilu.org#25085,"AIR MERBAU, TANJUNG PANDAN, BELITUNG, KEPULAUAN BANGKA BELITUNG",8,116,60,176
https://kawalpemilu.org#25085,"AIR MERBAU, TANJUNG PANDAN, BELITUNG, KEPULAUAN BANGKA BELITUNG",9,131,123,254
https://kawalpemilu.org#25085,"AIR MERBAU, TANJUNG PANDAN, BELITUNG, KEPULAUAN BANGKA BELITUNG",10,167,98,265
https://kawalpemilu.org#25085,"AIR MERBAU, TANJUNG PANDAN, BELITUNG, KEPULAUAN BANGKA BELITUNG",11,155,126,281
https://kawalpemilu.org#25085,"AIR MERBAU, TANJUNG PANDAN, BELITUNG, KEPULAUAN BANGKA BELITUNG",12,191,49,240
https://kawalpemilu.org#25085,"AIR MERBAU, TANJUNG PANDAN, BELITUNG, KEPULAUAN BANGKA BELITUNG",13,165,48,213
https://kawalpemilu.org#25085,"AIR MERBAU, TANJUNG PANDAN, BELITUNG, KEPULAUAN BANGKA BELITUNG",14,173,54,227
https://kawalpemilu.org#25085,"AIR MERBAU, TANJUNG PANDAN, BELITUNG, KEPULAUAN BANGKA BELITUNG",15,160,45,205
https://kawalpemilu.org#25085,"AIR MERBAU, TANJUNG PANDAN, BELITUNG, KEPULAUAN BANGKA BELITUNG",16,83,33,116
https://kawalpemilu.org#84844,"AIK PELEMPANG JAYA, TANJUNG PANDAN, BELITUNG, KEPULAUAN BANGKA BELITUNG",1,129,20,149
https://kawalpemilu.org#84844,"AIK PELEMPANG JAYA, TANJUNG PANDAN, BELITUNG, KEPULAUAN BANGKA BELITUNG",2,117,46,163
https://kawalpemilu.org#84844,"AIK PELEMPANG JAYA, TANJUNG PANDAN, BELITUNG, KEPULAUAN BANGKA BELITUNG",3,89,30,119
https://kawalpemilu.org#84844,"AIK PELEMPANG JAYA, TANJUNG PANDAN, BELITUNG, KEPULAUAN BANGKA BELITUNG",4,115,50,165
https://kawalpemilu.org#84844,"AIK PELEMPANG JAYA, TANJUNG PANDAN, BELITUNG, KEPULAUAN BANGKA BELITUNG",5,175,62,237
https://kawalpemilu.org#84844,"AIK PELEMPANG JAYA, TANJUNG PANDAN, BELITUNG, KEPULAUAN BANGKA BELITUNG",6,157,69,226
https://kawalpemilu.org#84844,"AIK PELEMPANG JAYA, TANJUNG PANDAN, BELITUNG, KEPULAUAN BANGKA BELITUNG",7,81,111,192
https://kawalpemilu.org#84844,"AIK PELEMPANG JAYA, TANJUNG PANDAN, BELITUNG, KEPULAUAN BANGKA BELITUNG",8,94,146,240
https://kawalpemilu.org#84844,"AIK PELEMPANG JAYA, TANJUNG PANDAN, BELITUNG, KEPULAUAN BANGKA BELITUNG",9,71,84,155
https://kawalpemilu.org#84844,"AIK PELEMPANG JAYA, TANJUNG PANDAN, BELITUNG, KEPULAUAN BANGKA BELITUNG",10,101,35,136
https://kawalpemilu.org#84844,"AIK PELEMPANG JAYA, TANJUNG PANDAN, BELITUNG, KEPULAUAN BANGKA BELITUNG",11,128,49,177
https://kawalpemilu.org#84844,"AIK PELEMPANG JAYA, TANJUNG PANDAN, BELITUNG, KEPULAUAN BANGKA BELITUNG",12,93,31,124
https://kawalpemilu.org#84844,"AIK PELEMPANG JAYA, TANJUNG PANDAN, BELITUNG, KEPULAUAN BANGKA BELITUNG",13,118,72,190
https://kawalpemilu.org#84844,"AIK PELEMPANG JAYA, TANJUNG PANDAN, BELITUNG, KEPULAUAN BANGKA BELITUNG",14,86,51,137
https://kawalpemilu.org#84844,"AIK PELEMPANG JAYA, TANJUNG PANDAN, BELITUNG, KEPULAUAN BANGKA BELITUNG",15,131,30,161
https://kawalpemilu.org#84844,"AIK PELEMPANG JAYA, TANJUNG PANDAN, BELITUNG, KEPULAUAN BANGKA BELITUNG",16,193,27,220
https://kawalpemilu.org#84844,"AIK PELEMPANG JAYA, TANJUNG PANDAN, BELITUNG, KEPULAUAN BANGKA BELITUNG",17,144,33,177
https://kawalpemilu.org#84845,"AIK KETEKOK, TANJUNG PANDAN, BELITUNG, KEPULAUAN BANGKA BELITUNG",1,107,68,175
https://kawalpemilu.org#84845,"AIK KETEKOK, TANJUNG PANDAN, BELITUNG, KEPULAUAN BANGKA BELITUNG",2,129,69,198
https://kawalpemilu.org#84845,"AIK KETEKOK, TANJUNG PANDAN, BELITUNG, KEPULAUAN BANGKA BELITUNG",3,94,89,183
https://kawalpemilu.org#84845,"AIK KETEKOK, TANJUNG PANDAN, BELITUNG, KEPULAUAN BANGKA BELITUNG",4,105,73,178
https://kawalpemilu.org#84845,"AIK KETEKOK, TANJUNG PANDAN, BELITUNG, KEPULAUAN BANGKA BELITUNG",5,160,53,213
https://kawalpemilu.org#84845,"AIK KETEKOK, TANJUNG PANDAN, BELITUNG, KEPULAUAN BANGKA BELITUNG",6,152,77,229
https://kawalpemilu.org#84845,"AIK KETEKOK, TANJUNG PANDAN, BELITUNG, KEPULAUAN BANGKA BELITUNG",7,157,54,211
https://kawalpemilu.org#84845,"AIK KETEKOK, TANJUNG PANDAN, BELITUNG, KEPULAUAN BANGKA BELITUNG",8,161,59,220
https://kawalpemilu.org#84845,"AIK KETEKOK, TANJUNG PANDAN, BELITUNG, KEPULAUAN BANGKA BELITUNG",9,130,25,155
https://kawalpemilu.org#84845,"AIK KETEKOK, TANJUNG PANDAN, BELITUNG, KEPULAUAN BANGKA BELITUNG",10,148,77,225
https://kawalpemilu.org#84845,"AIK KETEKOK, TANJUNG PANDAN, BELITUNG, KEPULAUAN BANGKA BELITUNG",11,149,73,222
https://kawalpemilu.org#84845,"AIK KETEKOK, TANJUNG PANDAN, BELITUNG, KEPULAUAN BANGKA BELITUNG",12,157,69,226
https://kawalpemilu.org#84845,"AIK KETEKOK, TANJUNG PANDAN, BELITUNG, KEPULAUAN BANGKA BELITUNG",13,152,54,206
https://kawalpemilu.org#84845,"AIK KETEKOK, TANJUNG PANDAN, BELITUNG, KEPULAUAN BANGKA BELITUNG",14,144,69,213
https://kawalpemilu.org#84845,"AIK KETEKOK, TANJUNG PANDAN, BELITUNG, KEPULAUAN BANGKA BELITUNG",15,144,56,200
https://kawalpemilu.org#84846,"AIK RAYAK, TANJUNG PANDAN, BELITUNG, KEPULAUAN BANGKA BELITUNG",1,102,59,161
https://kawalpemilu.org#84846,"AIK RAYAK, TANJUNG PANDAN, BELITUNG, KEPULAUAN BANGKA BELITUNG",2,141,78,219
https://kawalpemilu.org#84846,"AIK RAYAK, TANJUNG PANDAN, BELITUNG, KEPULAUAN BANGKA BELITUNG",3,149,92,241
https://kawalpemilu.org#84846,"AIK RAYAK, TANJUNG PANDAN, BELITUNG, KEPULAUAN BANGKA BELITUNG",4,122,81,8
https://kawalpemilu.org#84846,"AIK RAYAK, TANJUNG PANDAN, BELITUNG, KEPULAUAN BANGKA BELITUNG",5,143,42,185
https://kawalpemilu.org#84846,"AIK RAYAK, TANJUNG PANDAN, BELITUNG, KEPULAUAN BANGKA BELITUNG",6,154,94,248
https://kawalpemilu.org#84846,"AIK RAYAK, TANJUNG PANDAN, BELITUNG, KEPULAUAN BANGKA BELITUNG",7,167,78,245
https://kawalpemilu.org#84846,"AIK RAYAK, TANJUNG PANDAN, BELITUNG, KEPULAUAN BANGKA BELITUNG",8,153,83,236
https://kawalpemilu.org#84846,"AIK RAYAK, TANJUNG PANDAN, BELITUNG, KEPULAUAN BANGKA BELITUNG",9,129,122,251
https://kawalpemilu.org#84846,"AIK RAYAK, TANJUNG PANDAN, BELITUNG, KEPULAUAN BANGKA BELITUNG",10,171,64,235
https://kawalpemilu.org#84846,"AIK RAYAK, TANJUNG PANDAN, BELITUNG, KEPULAUAN BANGKA BELITUNG",11,139,89,228
https://kawalpemilu.org#84846,"AIK RAYAK, TANJUNG PANDAN, BELITUNG, KEPULAUAN BANGKA BELITUNG",12,134,48,182
https://kawalpemilu.org#84846,"AIK RAYAK, TANJUNG PANDAN, BELITUNG, KEPULAUAN BANGKA BELITUNG",13,156,86,242
https://kawalpemilu.org#84846,"AIK RAYAK, TANJUNG PANDAN, BELITUNG, KEPULAUAN BANGKA BELITUNG",14,114,67,181
https://kawalpemilu.org#84846,"AIK RAYAK, TANJUNG PANDAN, BELITUNG, KEPULAUAN BANGKA BELITUNG",15,150,94,244
https://kawalpemilu.org#84846,"AIK RAYAK, TANJUNG PANDAN, BELITUNG, KEPULAUAN BANGKA BELITUNG",16,160,86,246
https://kawalpemilu.org#84846,"AIK RAYAK, TANJUNG PANDAN, BELITUNG, KEPULAUAN BANGKA BELITUNG",17,128,122,250
https://kawalpemilu.org#84846,"AIK RAYAK, TANJUNG PANDAN, BELITUNG, KEPULAUAN BANGKA BELITUNG",18,111,111,222
https://kawalpemilu.org#84846,"AIK RAYAK, TANJUNG PANDAN, BELITUNG, KEPULAUAN BANGKA BELITUNG",19,143,63,206
https://kawalpemilu.org#84846,"AIK RAYAK, TANJUNG PANDAN, BELITUNG, KEPULAUAN BANGKA BELITUNG",20,169,56,225
https://kawalpemilu.org#84846,"AIK RAYAK, TANJUNG PANDAN, BELITUNG, KEPULAUAN BANGKA BELITUNG",21,180,72,252
https://kawalpemilu.org#84846,"AIK RAYAK, TANJUNG PANDAN, BELITUNG, KEPULAUAN BANGKA BELITUNG",22,208,49,257
https://kawalpemilu.org#84846,"AIK RAYAK, TANJUNG PANDAN, BELITUNG, KEPULAUAN BANGKA BELITUNG",23,87,70,157
https://kawalpemilu.org#84846,"AIK RAYAK, TANJUNG PANDAN, BELITUNG, KEPULAUAN BANGKA BELITUNG",24,128,29,157
https://kawalpemilu.org#84846,"AIK RAYAK, TANJUNG PANDAN, BELITUNG, KEPULAUAN BANGKA BELITUNG",25,52,37,89
https://kawalpemilu.org#929418,"KAMPONG DAMAI, TANJUNG PANDAN, BELITUNG, KEPULAUAN BANGKA BELITUNG",1,155,27,182
https://kawalpemilu.org#929418,"KAMPONG DAMAI, TANJUNG PANDAN, BELITUNG, KEPULAUAN BANGKA BELITUNG",2,142,52,194
https://kawalpemilu.org#929418,"KAMPONG DAMAI, TANJUNG PANDAN, BELITUNG, KEPULAUAN BANGKA BELITUNG",3,134,45,179
https://kawalpemilu.org#929418,"KAMPONG DAMAI, TANJUNG PANDAN, BELITUNG, KEPULAUAN BANGKA BELITUNG",4,151,55,206
https://kawalpemilu.org#929418,"KAMPONG DAMAI, TANJUNG PANDAN, BELITUNG, KEPULAUAN BANGKA BELITUNG",5,129,47,176
https://kawalpemilu.org#929418,"KAMPONG DAMAI, TANJUNG PANDAN, BELITUNG, KEPULAUAN BANGKA BELITUNG",6,114,40,154
https://kawalpemilu.org#929418,"KAMPONG DAMAI, TANJUNG PANDAN, BELITUNG, KEPULAUAN BANGKA BELITUNG",7,135,71,206
https://kawalpemilu.org#929418,"KAMPONG DAMAI, TANJUNG PANDAN, BELITUNG, KEPULAUAN BANGKA BELITUNG",8,151,34,185
https://kawalpemilu.org#929418,"KAMPONG DAMAI, TANJUNG PANDAN, BELITUNG, KEPULAUAN BANGKA BELITUNG",9,148,65,213
https://kawalpemilu.org#929418,"KAMPONG DAMAI, TANJUNG PANDAN, BELITUNG, KEPULAUAN BANGKA BELITUNG",10,137,67,200
https://kawalpemilu.org#929418,"KAMPONG DAMAI, TANJUNG PANDAN, BELITUNG, KEPULAUAN BANGKA BELITUNG",11,177,56,233
https://kawalpemilu.org#929418,"KAMPONG DAMAI, TANJUNG PANDAN, BELITUNG, KEPULAUAN BANGKA BELITUNG",12,113,51,164
https://kawalpemilu.org#929418,"KAMPONG DAMAI, TANJUNG PANDAN, BELITUNG, KEPULAUAN BANGKA BELITUNG",13,65,37,102
https://kawalpemilu.org#25087,"MEMBALONG, MEMBALONG, BELITUNG, KEPULAUAN BANGKA BELITUNG",1,75,54,129
https://kawalpemilu.org#25087,"MEMBALONG, MEMBALONG, BELITUNG, KEPULAUAN BANGKA BELITUNG",2,77,55,132
https://kawalpemilu.org#25087,"MEMBALONG, MEMBALONG, BELITUNG, KEPULAUAN BANGKA BELITUNG",3,88,55,143
https://kawalpemilu.org#25087,"MEMBALONG, MEMBALONG, BELITUNG, KEPULAUAN BANGKA BELITUNG",4,106,28,134
https://kawalpemilu.org#25087,"MEMBALONG, MEMBALONG, BELITUNG, KEPULAUAN BANGKA BELITUNG",5,124,14,138
https://kawalpemilu.org#25087,"MEMBALONG, MEMBALONG, BELITUNG, KEPULAUAN BANGKA BELITUNG",6,131,9,140
https://kawalpemilu.org#25087,"MEMBALONG, MEMBALONG, BELITUNG, KEPULAUAN BANGKA BELITUNG",7,128,17,145
https://kawalpemilu.org#25087,"MEMBALONG, MEMBALONG, BELITUNG, KEPULAUAN BANGKA BELITUNG",8,120,21,141
https://kawalpemilu.org#25087,"MEMBALONG, MEMBALONG, BELITUNG, KEPULAUAN BANGKA BELITUNG",9,213,29,242
https://kawalpemilu.org#25087,"MEMBALONG, MEMBALONG, BELITUNG, KEPULAUAN BANGKA BELITUNG",10,243,24,267
https://kawalpemilu.org#25087,"MEMBALONG, MEMBALONG, BELITUNG, KEPULAUAN BANGKA BELITUNG",11,204,43,247
https://kawalpemilu.org#25087,"MEMBALONG, MEMBALONG, BELITUNG, KEPULAUAN BANGKA BELITUNG",12,191,52,243
https://kawalpemilu.org#25087,"MEMBALONG, MEMBALONG, BELITUNG, KEPULAUAN BANGKA BELITUNG",13,199,31,230
https://kawalpemilu.org#25087,"MEMBALONG, MEMBALONG, BELITUNG, KEPULAUAN BANGKA BELITUNG",14,197,37,234
https://kawalpemilu.org#25087,"MEMBALONG, MEMBALONG, BELITUNG, KEPULAUAN BANGKA BELITUNG",15,225,35,260
https://kawalpemilu.org#25087,"MEMBALONG, MEMBALONG, BELITUNG, KEPULAUAN BANGKA BELITUNG",16,225,42,267
https://kawalpemilu.org#25088,"PERPAT, MEMBALONG, BELITUNG, KEPULAUAN BANGKA BELITUNG",1,126,54,180
https://kawalpemilu.org#25088,"PERPAT, MEMBALONG, BELITUNG, KEPULAUAN BANGKA BELITUNG",2,143,30,173
https://kawalpemilu.org#25088,"PERPAT, MEMBALONG, BELITUNG, KEPULAUAN BANGKA BELITUNG",3,102,73,175
https://kawalpemilu.org#25088,"PERPAT, MEMBALONG, BELITUNG, KEPULAUAN BANGKA BELITUNG",4,135,35,170
https://kawalpemilu.org#25088,"PERPAT, MEMBALONG, BELITUNG, KEPULAUAN BANGKA BELITUNG",5,64,52,116
https://kawalpemilu.org#25088,"PERPAT, MEMBALONG, BELITUNG, KEPULAUAN BANGKA BELITUNG",6,122,69,191
https://kawalpemilu.org#25088,"PERPAT, MEMBALONG, BELITUNG, KEPULAUAN BANGKA BELITUNG",7,133,29,162
https://kawalpemilu.org#25089,"LASSAR, MEMBALONG, BELITUNG, KEPULAUAN BANGKA BELITUNG",1,114,52,166
https://kawalpemilu.org#25089,"LASSAR, MEMBALONG, BELITUNG, KEPULAUAN BANGKA BELITUNG",2,110,63,173
https://kawalpemilu.org#25089,"LASSAR, MEMBALONG, BELITUNG, KEPULAUAN BANGKA BELITUNG",3,144,20,164
https://kawalpemilu.org#25089,"LASSAR, MEMBALONG, BELITUNG, KEPULAUAN BANGKA BELITUNG",4,156,14,170
https://kawalpemilu.org#25089,"LASSAR, MEMBALONG, BELITUNG, KEPULAUAN BANGKA BELITUNG",5,183,30,213
https://kawalpemilu.org#25089,"LASSAR, MEMBALONG, BELITUNG, KEPULAUAN BANGKA BELITUNG",6,206,18,224
https://kawalpemilu.org#25089,"LASSAR, MEMBALONG, BELITUNG, KEPULAUAN BANGKA BELITUNG",7,175,31,206
https://kawalpemilu.org#25089,"LASSAR, MEMBALONG, BELITUNG, KEPULAUAN BANGKA BELITUNG",8,213,13,226
https://kawalpemilu.org#25089,"LASSAR, MEMBALONG, BELITUNG, KEPULAUAN BANGKA BELITUNG",9,203,21,224
https://kawalpemilu.org#25089,"LASSAR, MEMBALONG, BELITUNG, KEPULAUAN BANGKA BELITUNG",10,166,13,179
https://kawalpemilu.org#25089,"LASSAR, MEMBALONG, BELITUNG, KEPULAUAN BANGKA BELITUNG",11,157,7,164
https://kawalpemilu.org#25090,"SIMPANG RUSA, MEMBALONG, BELITUNG, KEPULAUAN BANGKA BELITUNG",1,211,48,259
https://kawalpemilu.org#25090,"SIMPANG RUSA, MEMBALONG, BELITUNG, KEPULAUAN BANGKA BELITUNG",2,168,81,249
https://kawalpemilu.org#25090,"SIMPANG RUSA, MEMBALONG, BELITUNG, KEPULAUAN BANGKA BELITUNG",3,209,41,250
https://kawalpemilu.org#25090,"SIMPANG RUSA, MEMBALONG, BELITUNG, KEPULAUAN BANGKA BELITUNG",4,248,15,263
https://kawalpemilu.org#25090,"SIMPANG RUSA, MEMBALONG, BELITUNG, KEPULAUAN BANGKA BELITUNG",5,167,30,197
https://kawalpemilu.org#25090,"SIMPANG RUSA, MEMBALONG, BELITUNG, KEPULAUAN BANGKA BELITUNG",6,162,20,182
https://kawalpemilu.org#25090,"SIMPANG RUSA, MEMBALONG, BELITUNG, KEPULAUAN BANGKA BELITUNG",7,178,66,244
https://kawalpemilu.org#25090,"SIMPANG RUSA, MEMBALONG, BELITUNG, KEPULAUAN BANGKA BELITUNG",8,192,53,245
https://kawalpemilu.org#25091,"KEMBIRI, MEMBALONG, BELITUNG, KEPULAUAN BANGKA BELITUNG",1,160,58,218
https://kawalpemilu.org#25091,"KEMBIRI, MEMBALONG, BELITUNG, KEPULAUAN BANGKA BELITUNG",2,188,52,240
https://kawalpemilu.org#25091,"KEMBIRI, MEMBALONG, BELITUNG, KEPULAUAN BANGKA BELITUNG",3,216,34,250
https://kawalpemilu.org#25091,"KEMBIRI, MEMBALONG, BELITUNG, KEPULAUAN BANGKA BELITUNG",4,187,44,231
https://kawalpemilu.org#25091,"KEMBIRI, MEMBALONG, BELITUNG, KEPULAUAN BANGKA BELITUNG",5,140,53,193
https://kawalpemilu.org#25091,"KEMBIRI, MEMBALONG, BELITUNG, KEPULAUAN BANGKA BELITUNG",6,198,33,231
https://kawalpemilu.org#25091,"KEMBIRI, MEMBALONG, BELITUNG, KEPULAUAN BANGKA BELITUNG",7,147,58,205
https://kawalpemilu.org#25091,"KEMBIRI, MEMBALONG, BELITUNG, KEPULAUAN BANGKA BELITUNG",8,146,84,230
https://kawalpemilu.org#25092,"BANTAN, MEMBALONG, BELITUNG, KEPULAUAN BANGKA BELITUNG",1,121,13,134
https://kawalpemilu.org#25092,"BANTAN, MEMBALONG, BELITUNG, KEPULAUAN BANGKA BELITUNG",2,116,18,134
https://kawalpemilu.org#25092,"BANTAN, MEMBALONG, BELITUNG, KEPULAUAN BANGKA BELITUNG",3,132,14,146
https://kawalpemilu.org#25092,"BANTAN, MEMBALONG, BELITUNG, KEPULAUAN BANGKA BELITUNG",4,120,24,144
https://kawalpemilu.org#25092,"BANTAN, MEMBALONG, BELITUNG, KEPULAUAN BANGKA BELITUNG",5,183,22,205
https://kawalpemilu.org#25092,"BANTAN, MEMBALONG, BELITUNG, KEPULAUAN BANGKA BELITUNG",6,177,13,190
https://kawalpemilu.org#25092,"BANTAN, MEMBALONG, BELITUNG, KEPULAUAN BANGKA BELITUNG",7,163,18,181
https://kawalpemilu.org#25092,"BANTAN, MEMBALONG, BELITUNG, KEPULAUAN BANGKA BELITUNG",8,142,34,176
https://kawalpemilu.org#25092,"BANTAN, MEMBALONG, BELITUNG, KEPULAUAN BANGKA BELITUNG",9,220,24,244
https://kawalpemilu.org#25093,"TANJUNG RUSA, MEMBALONG, BELITUNG, KEPULAUAN BANGKA BELITUNG",1,152,33,185
https://kawalpemilu.org#25093,"TANJUNG RUSA, MEMBALONG, BELITUNG, KEPULAUAN BANGKA BELITUNG",2,171,14,185
https://kawalpemilu.org#25093,"TANJUNG RUSA, MEMBALONG, BELITUNG, KEPULAUAN BANGKA BELITUNG",3,171,33,204
https://kawalpemilu.org#25093,"TANJUNG RUSA, MEMBALONG, BELITUNG, KEPULAUAN BANGKA BELITUNG",4,213,31,244
https://kawalpemilu.org#25093,"TANJUNG RUSA, MEMBALONG, BELITUNG, KEPULAUAN BANGKA BELITUNG",5,132,47,179
https://kawalpemilu.org#25093,"TANJUNG RUSA, MEMBALONG, BELITUNG, KEPULAUAN BANGKA BELITUNG",6,136,30,166
https://kawalpemilu.org#25093,"TANJUNG RUSA, MEMBALONG, BELITUNG, KEPULAUAN BANGKA BELITUNG",7,184,72,256
https://kawalpemilu.org#25094,"MENTIGI, MEMBALONG, BELITUNG, KEPULAUAN BANGKA BELITUNG",1,142,16,158
https://kawalpemilu.org#25094,"MENTIGI, MEMBALONG, BELITUNG, KEPULAUAN BANGKA BELITUNG",2,124,25,149
https://kawalpemilu.org#25094,"MENTIGI, MEMBALONG, BELITUNG, KEPULAUAN BANGKA BELITUNG",3,134,34,168
https://kawalpemilu.org#25094,"MENTIGI, MEMBALONG, BELITUNG, KEPULAUAN BANGKA BELITUNG",4,133,3,136
https://kawalpemilu.org#25094,"MENTIGI, MEMBALONG, BELITUNG, KEPULAUAN BANGKA BELITUNG",5,147,24,171
https://kawalpemilu.org#25094,"MENTIGI, MEMBALONG, BELITUNG, KEPULAUAN BANGKA BELITUNG",6,144,23,167
https://kawalpemilu.org#25095,"PULAU SELIU, MEMBALONG, BELITUNG, KEPULAUAN BANGKA BELITUNG",1,188,41,229
https://kawalpemilu.org#25095,"PULAU SELIU, MEMBALONG, BELITUNG, KEPULAUAN BANGKA BELITUNG",2,161,43,204
https://kawalpemilu.org#25095,"PULAU SELIU, MEMBALONG, BELITUNG, KEPULAUAN BANGKA BELITUNG",3,117,26,143
https://kawalpemilu.org#25095,"PULAU SELIU, MEMBALONG, BELITUNG, KEPULAUAN BANGKA BELITUNG",4,119,22,141
https://kawalpemilu.org#25096,"PULAU SUMEDANG, MEMBALONG, BELITUNG, KEPULAUAN BANGKA BELITUNG",1,141,15,156
https://kawalpemilu.org#25096,"PULAU SUMEDANG, MEMBALONG, BELITUNG, KEPULAUAN BANGKA BELITUNG",2,118,16,134
https://kawalpemilu.org#25097,"GUNUNG RITING, MEMBALONG, BELITUNG, KEPULAUAN BANGKA BELITUNG",1,108,38,146
https://kawalpemilu.org#25097,"GUNUNG RITING, MEMBALONG, BELITUNG, KEPULAUAN BANGKA BELITUNG",2,117,32,149
https://kawalpemilu.org#25097,"GUNUNG RITING, MEMBALONG, BELITUNG, KEPULAUAN BANGKA BELITUNG",3,209,33,242
https://kawalpemilu.org#25097,"GUNUNG RITING, MEMBALONG, BELITUNG, KEPULAUAN BANGKA BELITUNG",4,163,27,190
https://kawalpemilu.org#25097,"GUNUNG RITING, MEMBALONG, BELITUNG, KEPULAUAN BANGKA BELITUNG",5,152,25,177
https://kawalpemilu.org#25098,"PADANG KANDIS, MEMBALONG, BELITUNG, KEPULAUAN BANGKA BELITUNG",1,159,18,177
https://kawalpemilu.org#25098,"PADANG KANDIS, MEMBALONG, BELITUNG, KEPULAUAN BANGKA BELITUNG",2,154,19,173
https://kawalpemilu.org#25098,"PADANG KANDIS, MEMBALONG, BELITUNG, KEPULAUAN BANGKA BELITUNG",3,236,28,264
https://kawalpemilu.org#25098,"PADANG KANDIS, MEMBALONG, BELITUNG, KEPULAUAN BANGKA BELITUNG",4,206,27,233
https://kawalpemilu.org#25100,"SELAT NASIK, SELAT NASIK, BELITUNG, KEPULAUAN BANGKA BELITUNG",1,155,29,184
https://kawalpemilu.org#25100,"SELAT NASIK, SELAT NASIK, BELITUNG, KEPULAUAN BANGKA BELITUNG",2,171,36,207
https://kawalpemilu.org#25100,"SELAT NASIK, SELAT NASIK, BELITUNG, KEPULAUAN BANGKA BELITUNG",3,157,34,191
https://kawalpemilu.org#25100,"SELAT NASIK, SELAT NASIK, BELITUNG, KEPULAUAN BANGKA BELITUNG",4,142,43,185
https://kawalpemilu.org#25100,"SELAT NASIK, SELAT NASIK, BELITUNG, KEPULAUAN BANGKA BELITUNG",5,141,40,181
https://kawalpemilu.org#25100,"SELAT NASIK, SELAT NASIK, BELITUNG, KEPULAUAN BANGKA BELITUNG",6,118,49,167
https://kawalpemilu.org#25100,"SELAT NASIK, SELAT NASIK, BELITUNG, KEPULAUAN BANGKA BELITUNG",7,121,53,174
https://kawalpemilu.org#25100,"SELAT NASIK, SELAT NASIK, BELITUNG, KEPULAUAN BANGKA BELITUNG",8,124,46,170
https://kawalpemilu.org#25101,"PETALING, SELAT NASIK, BELITUNG, KEPULAUAN BANGKA BELITUNG",1,143,41,184
https://kawalpemilu.org#25101,"PETALING, SELAT NASIK, BELITUNG, KEPULAUAN BANGKA BELITUNG",2,138,75,213
https://kawalpemilu.org#25102,"SUAK GUAL, SELAT NASIK, BELITUNG, KEPULAUAN BANGKA BELITUNG",1,140,58,198
https://kawalpemilu.org#25102,"SUAK GUAL, SELAT NASIK, BELITUNG, KEPULAUAN BANGKA BELITUNG",2,125,62,187
https://kawalpemilu.org#25102,"SUAK GUAL, SELAT NASIK, BELITUNG, KEPULAUAN BANGKA BELITUNG",3,157,45,202
https://kawalpemilu.org#25103,"PULAU GERSIK, SELAT NASIK, BELITUNG, KEPULAUAN BANGKA BELITUNG",1,155,34,189
https://kawalpemilu.org#25103,"PULAU GERSIK, SELAT NASIK, BELITUNG, KEPULAUAN BANGKA BELITUNG",2,137,60,197
https://kawalpemilu.org#25103,"PULAU GERSIK, SELAT NASIK, BELITUNG, KEPULAUAN BANGKA BELITUNG",3,141,27,168
https://kawalpemilu.org#25103,"PULAU GERSIK, SELAT NASIK, BELITUNG, KEPULAUAN BANGKA BELITUNG",4,105,21,126
https://kawalpemilu.org#25103,"PULAU GERSIK, SELAT NASIK, BELITUNG, KEPULAUAN BANGKA BELITUNG",5,172,10,182
https://kawalpemilu.org#25103,"PULAU GERSIK, SELAT NASIK, BELITUNG, KEPULAUAN BANGKA BELITUNG",6,122,33,155
https://kawalpemilu.org#25103,"PULAU GERSIK, SELAT NASIK, BELITUNG, KEPULAUAN BANGKA BELITUNG",7,109,70,179
https://kawalpemilu.org#25103,"PULAU GERSIK, SELAT NASIK, BELITUNG, KEPULAUAN BANGKA BELITUNG",8,25,1,26
https://kawalpemilu.org#25103,"PULAU GERSIK, SELAT NASIK, BELITUNG, KEPULAUAN BANGKA BELITUNG",9,89,10,99
https://kawalpemilu.org#25105,"SIJUK, SIJUK, BELITUNG, KEPULAUAN BANGKA BELITUNG",1,104,75,179
https://kawalpemilu.org#25105,"SIJUK, SIJUK, BELITUNG, KEPULAUAN BANGKA BELITUNG",2,125,76,201
https://kawalpemilu.org#25105,"SIJUK, SIJUK, BELITUNG, KEPULAUAN BANGKA BELITUNG",3,142,44,186
https://kawalpemilu.org#25105,"SIJUK, SIJUK, BELITUNG, KEPULAUAN BANGKA BELITUNG",4,146,38,184
https://kawalpemilu.org#25105,"SIJUK, SIJUK, BELITUNG, KEPULAUAN BANGKA BELITUNG",5,76,27,103
https://kawalpemilu.org#25105,"SIJUK, SIJUK, BELITUNG, KEPULAUAN BANGKA BELITUNG",6,199,32,231
https://kawalpemilu.org#25105,"SIJUK, SIJUK, BELITUNG, KEPULAUAN BANGKA BELITUNG",7,172,51,223
https://kawalpemilu.org#25105,"SIJUK, SIJUK, BELITUNG, KEPULAUAN BANGKA BELITUNG",8,126,25,151
https://kawalpemilu.org#25105,"SIJUK, SIJUK, BELITUNG, KEPULAUAN BANGKA BELITUNG",9,142,36,178
https://kawalpemilu.org#25105,"SIJUK, SIJUK, BELITUNG, KEPULAUAN BANGKA BELITUNG",10,134,62,196
https://kawalpemilu.org#25105,"SIJUK, SIJUK, BELITUNG, KEPULAUAN BANGKA BELITUNG",11,128,48,176
https://kawalpemilu.org#25106,"BATU ITAM, SIJUK, BELITUNG, KEPULAUAN BANGKA BELITUNG",1,156,88,244
https://kawalpemilu.org#25106,"BATU ITAM, SIJUK, BELITUNG, KEPULAUAN BANGKA BELITUNG",2,152,61,213
https://kawalpemilu.org#25106,"BATU ITAM, SIJUK, BELITUNG, KEPULAUAN BANGKA BELITUNG",3,126,79,205
https://kawalpemilu.org#25106,"BATU ITAM, SIJUK, BELITUNG, KEPULAUAN BANGKA BELITUNG",4,166,44,210
https://kawalpemilu.org#25106,"BATU ITAM, SIJUK, BELITUNG, KEPULAUAN BANGKA BELITUNG",5,158,52,210
https://kawalpemilu.org#25106,"BATU ITAM, SIJUK, BELITUNG, KEPULAUAN BANGKA BELITUNG",6,161,49,210
https://kawalpemilu.org#25106,"BATU ITAM, SIJUK, BELITUNG, KEPULAUAN BANGKA BELITUNG",7,134,59,193
https://kawalpemilu.org#25107,"TERONG, SIJUK, BELITUNG, KEPULAUAN BANGKA BELITUNG",1,153,53,206
https://kawalpemilu.org#25107,"TERONG, SIJUK, BELITUNG, KEPULAUAN BANGKA BELITUNG",2,171,35,206
https://kawalpemilu.org#25107,"TERONG, SIJUK, BELITUNG, KEPULAUAN BANGKA BELITUNG",3,178,33,211
https://kawalpemilu.org#25107,"TERONG, SIJUK, BELITUNG, KEPULAUAN BANGKA BELITUNG",4,162,39,201
https://kawalpemilu.org#25107,"TERONG, SIJUK, BELITUNG, KEPULAUAN BANGKA BELITUNG",5,160,40,200
https://kawalpemilu.org#25107,"TERONG, SIJUK, BELITUNG, KEPULAUAN BANGKA BELITUNG",6,161,48,209
https://kawalpemilu.org#25107,"TERONG, SIJUK, BELITUNG, KEPULAUAN BANGKA BELITUNG",7,177,25,202
https://kawalpemilu.org#25107,"TERONG, SIJUK, BELITUNG, KEPULAUAN BANGKA BELITUNG",8,189,18,207
https://kawalpemilu.org#25108,"AIR SERUK, SIJUK, BELITUNG, KEPULAUAN BANGKA BELITUNG",1,159,84,243
https://kawalpemilu.org#25108,"AIR SERUK, SIJUK, BELITUNG, KEPULAUAN BANGKA BELITUNG",2,155,65,220
https://kawalpemilu.org#25108,"AIR SERUK, SIJUK, BELITUNG, KEPULAUAN BANGKA BELITUNG",3,84,89,173
https://kawalpemilu.org#25108,"AIR SERUK, SIJUK, BELITUNG, KEPULAUAN BANGKA BELITUNG",4,184,38,222
https://kawalpemilu.org#25108,"AIR SERUK, SIJUK, BELITUNG, KEPULAUAN BANGKA BELITUNG",5,89,82,171
https://kawalpemilu.org#25108,"AIR SERUK, SIJUK, BELITUNG, KEPULAUAN BANGKA BELITUNG",6,130,77,207
https://kawalpemilu.org#25108,"AIR SERUK, SIJUK, BELITUNG, KEPULAUAN BANGKA BELITUNG",7,163,63,226
https://kawalpemilu.org#25108,"AIR SERUK, SIJUK, BELITUNG, KEPULAUAN BANGKA BELITUNG",8,163,53,216
https://kawalpemilu.org#25108,"AIR SERUK, SIJUK, BELITUNG, KEPULAUAN BANGKA BELITUNG",9,155,71,226
https://kawalpemilu.org#25108,"AIR SERUK, SIJUK, BELITUNG, KEPULAUAN BANGKA BELITUNG",10,133,83,216
https://kawalpemilu.org#25108,"AIR SERUK, SIJUK, BELITUNG, KEPULAUAN BANGKA BELITUNG",11,163,59,222
https://kawalpemilu.org#25108,"AIR SERUK, SIJUK, BELITUNG, KEPULAUAN BANGKA BELITUNG",12,166,55,221
https://kawalpemilu.org#25108,"AIR SERUK, SIJUK, BELITUNG, KEPULAUAN BANGKA BELITUNG",13,158,72,230
https://kawalpemilu.org#25108,"AIR SERUK, SIJUK, BELITUNG, KEPULAUAN BANGKA BELITUNG",14,152,82,234
https://kawalpemilu.org#25108,"AIR SERUK, SIJUK, BELITUNG, KEPULAUAN BANGKA BELITUNG",15,140,63,203
https://kawalpemilu.org#25109,"TANJUNG BINGA, SIJUK, BELITUNG, KEPULAUAN BANGKA BELITUNG",1,203,46,249
https://kawalpemilu.org#25109,"TANJUNG BINGA, SIJUK, BELITUNG, KEPULAUAN BANGKA BELITUNG",2,199,41,240
https://kawalpemilu.org#25109,"TANJUNG BINGA, SIJUK, BELITUNG, KEPULAUAN BANGKA BELITUNG",3,168,72,240
https://kawalpemilu.org#25109,"TANJUNG BINGA, SIJUK, BELITUNG, KEPULAUAN BANGKA BELITUNG",4,175,53,228
https://kawalpemilu.org#25109,"TANJUNG BINGA, SIJUK, BELITUNG, KEPULAUAN BANGKA BELITUNG",5,191,54,245
https://kawalpemilu.org#25109,"TANJUNG BINGA, SIJUK, BELITUNG, KEPULAUAN BANGKA BELITUNG",6,210,36,246
https://kawalpemilu.org#25109,"TANJUNG BINGA, SIJUK, BELITUNG, KEPULAUAN BANGKA BELITUNG",7,197,44,241
https://kawalpemilu.org#25109,"TANJUNG BINGA, SIJUK, BELITUNG, KEPULAUAN BANGKA BELITUNG",8,211,37,248
https://kawalpemilu.org#25109,"TANJUNG BINGA, SIJUK, BELITUNG, KEPULAUAN BANGKA BELITUNG",9,227,26,253
https://kawalpemilu.org#25109,"TANJUNG BINGA, SIJUK, BELITUNG, KEPULAUAN BANGKA BELITUNG",10,223,18,241
https://kawalpemilu.org#25109,"TANJUNG BINGA, SIJUK, BELITUNG, KEPULAUAN BANGKA BELITUNG",11,226,17,243
https://kawalpemilu.org#25109,"TANJUNG BINGA, SIJUK, BELITUNG, KEPULAUAN BANGKA BELITUNG",12,214,28,242
https://kawalpemilu.org#25109,"TANJUNG BINGA, SIJUK, BELITUNG, KEPULAUAN BANGKA BELITUNG",13,224,0,224
https://kawalpemilu.org#25109,"TANJUNG BINGA, SIJUK, BELITUNG, KEPULAUAN BANGKA BELITUNG",14,216,22,238
https://kawalpemilu.org#25109,"TANJUNG BINGA, SIJUK, BELITUNG, KEPULAUAN BANGKA BELITUNG",15,202,39,241
https://kawalpemilu.org#25110,"AIR SELUMAR, SIJUK, BELITUNG, KEPULAUAN BANGKA BELITUNG",1,146,42,188
https://kawalpemilu.org#25110,"AIR SELUMAR, SIJUK, BELITUNG, KEPULAUAN BANGKA BELITUNG",2,176,57,233
https://kawalpemilu.org#25110,"AIR SELUMAR, SIJUK, BELITUNG, KEPULAUAN BANGKA BELITUNG",3,187,58,245
https://kawalpemilu.org#25110,"AIR SELUMAR, SIJUK, BELITUNG, KEPULAUAN BANGKA BELITUNG",4,171,57,228
https://kawalpemilu.org#25110,"AIR SELUMAR, SIJUK, BELITUNG, KEPULAUAN BANGKA BELITUNG",5,99,64,163
https://kawalpemilu.org#25110,"AIR SELUMAR, SIJUK, BELITUNG, KEPULAUAN BANGKA BELITUNG",6,147,48,195
https://kawalpemilu.org#25110,"AIR SELUMAR, SIJUK, BELITUNG, KEPULAUAN BANGKA BELITUNG",7,164,38,202
https://kawalpemilu.org#25110,"AIR SELUMAR, SIJUK, BELITUNG, KEPULAUAN BANGKA BELITUNG",8,126,59,185
https://kawalpemilu.org#25110,"AIR SELUMAR, SIJUK, BELITUNG, KEPULAUAN BANGKA BELITUNG",9,155,59,214
https://kawalpemilu.org#25111,"SUNGAI PADANG, SIJUK, BELITUNG, KEPULAUAN BANGKA BELITUNG",1,179,27,206
https://kawalpemilu.org#25111,"SUNGAI PADANG, SIJUK, BELITUNG, KEPULAUAN BANGKA BELITUNG",2,217,30,247
https://kawalpemilu.org#25111,"SUNGAI PADANG, SIJUK, BELITUNG, KEPULAUAN BANGKA BELITUNG",3,197,34,231
https://kawalpemilu.org#25111,"SUNGAI PADANG, SIJUK, BELITUNG, KEPULAUAN BANGKA BELITUNG",4,135,29,164
https://kawalpemilu.org#25111,"SUNGAI PADANG, SIJUK, BELITUNG, KEPULAUAN BANGKA BELITUNG",5,196,10,206
https://kawalpemilu.org#25111,"SUNGAI PADANG, SIJUK, BELITUNG, KEPULAUAN BANGKA BELITUNG",6,195,56,251
https://kawalpemilu.org#25111,"SUNGAI PADANG, SIJUK, BELITUNG, KEPULAUAN BANGKA BELITUNG",7,123,15,138
https://kawalpemilu.org#25112,"KECIPUT, SIJUK, BELITUNG, KEPULAUAN BANGKA BELITUNG",1,197,22,219
https://kawalpemilu.org#25112,"KECIPUT, SIJUK, BELITUNG, KEPULAUAN BANGKA BELITUNG",2,200,21,221
https://kawalpemilu.org#25112,"KECIPUT, SIJUK, BELITUNG, KEPULAUAN BANGKA BELITUNG",3,188,33,221
https://kawalpemilu.org#25112,"KECIPUT, SIJUK, BELITUNG, KEPULAUAN BANGKA BELITUNG",4,206,18,224
https://kawalpemilu.org#25112,"KECIPUT, SIJUK, BELITUNG, KEPULAUAN BANGKA BELITUNG",5,203,26,229
https://kawalpemilu.org#25112,"KECIPUT, SIJUK, BELITUNG, KEPULAUAN BANGKA BELITUNG",6,219,17,236
https://kawalpemilu.org#25112,"KECIPUT, SIJUK, BELITUNG, KEPULAUAN BANGKA BELITUNG",7,178,39,217
https://kawalpemilu.org#84847,"PELEPAK PUTE, SIJUK, BELITUNG, KEPULAUAN BANGKA BELITUNG",1,118,68,186
https://kawalpemilu.org#84847,"PELEPAK PUTE, SIJUK, BELITUNG, KEPULAUAN BANGKA BELITUNG",2,142,18,160
https://kawalpemilu.org#84847,"PELEPAK PUTE, SIJUK, BELITUNG, KEPULAUAN BANGKA BELITUNG",3,225,5,230
https://kawalpemilu.org#84847,"PELEPAK PUTE, SIJUK, BELITUNG, KEPULAUAN BANGKA BELITUNG",4,134,59,193
https://kawalpemilu.org#84847,"PELEPAK PUTE, SIJUK, BELITUNG, KEPULAUAN BANGKA BELITUNG",5,114,35,149
https://kawalpemilu.org#84847,"PELEPAK PUTE, SIJUK, BELITUNG, KEPULAUAN BANGKA BELITUNG",6,230,17,247
https://kawalpemilu.org#84848,"TANJONG TINGGI, SIJUK, BELITUNG, KEPULAUAN BANGKA BELITUNG",1,175,23,198
https://kawalpemilu.org#84848,"TANJONG TINGGI, SIJUK, BELITUNG, KEPULAUAN BANGKA BELITUNG",2,161,38,199
https://kawalpemilu.org#84848,"TANJONG TINGGI, SIJUK, BELITUNG, KEPULAUAN BANGKA BELITUNG",3,209,35,244
https://kawalpemilu.org#25114,"BADAU, BADAU, BELITUNG, KEPULAUAN BANGKA BELITUNG",1,138,49,187
https://kawalpemilu.org#25114,"BADAU, BADAU, BELITUNG, KEPULAUAN BANGKA BELITUNG",2,137,44,181
https://kawalpemilu.org#25114,"BADAU, BADAU, BELITUNG, KEPULAUAN BANGKA BELITUNG",3,130,51,181
https://kawalpemilu.org#25114,"BADAU, BADAU, BELITUNG, KEPULAUAN BANGKA BELITUNG",4,82,69,151
https://kawalpemilu.org#25114,"BADAU, BADAU, BELITUNG, KEPULAUAN BANGKA BELITUNG",5,101,43,144
https://kawalpemilu.org#25114,"BADAU, BADAU, BELITUNG, KEPULAUAN BANGKA BELITUNG",6,117,37,154
https://kawalpemilu.org#25114,"BADAU, BADAU, BELITUNG, KEPULAUAN BANGKA BELITUNG",7,147,33,180
https://kawalpemilu.org#25114,"BADAU, BADAU, BELITUNG, KEPULAUAN BANGKA BELITUNG",8,94,33,127
https://kawalpemilu.org#25114,"BADAU, BADAU, BELITUNG, KEPULAUAN BANGKA BELITUNG",9,141,36,177
https://kawalpemilu.org#25114,"BADAU, BADAU, BELITUNG, KEPULAUAN BANGKA BELITUNG",10,140,24,164
https://kawalpemilu.org#25114,"BADAU, BADAU, BELITUNG, KEPULAUAN BANGKA BELITUNG",11,132,51,183
https://kawalpemilu.org#25114,"BADAU, BADAU, BELITUNG, KEPULAUAN BANGKA BELITUNG",12,132,51,183
https://kawalpemilu.org#25114,"BADAU, BADAU, BELITUNG, KEPULAUAN BANGKA BELITUNG",13,209,34,243
https://kawalpemilu.org#25115,"AIR BATU BUDING, BADAU, BELITUNG, KEPULAUAN BANGKA BELITUNG",1,157,33,190
https://kawalpemilu.org#25115,"AIR BATU BUDING, BADAU, BELITUNG, KEPULAUAN BANGKA BELITUNG",2,129,52,181
https://kawalpemilu.org#25115,"AIR BATU BUDING, BADAU, BELITUNG, KEPULAUAN BANGKA BELITUNG",3,170,38,208
https://kawalpemilu.org#25115,"AIR BATU BUDING, BADAU, BELITUNG, KEPULAUAN BANGKA BELITUNG",4,112,47,159
https://kawalpemilu.org#25115,"AIR BATU BUDING, BADAU, BELITUNG, KEPULAUAN BANGKA BELITUNG",5,123,44,167
https://kawalpemilu.org#25116,"SUNGAI SAMAK, BADAU, BELITUNG, KEPULAUAN BANGKA BELITUNG",1,165,28,193
https://kawalpemilu.org#25116,"SUNGAI SAMAK, BADAU, BELITUNG, KEPULAUAN BANGKA BELITUNG",2,142,20,162
https://kawalpemilu.org#25116,"SUNGAI SAMAK, BADAU, BELITUNG, KEPULAUAN BANGKA BELITUNG",3,160,25,185
https://kawalpemilu.org#25116,"SUNGAI SAMAK, BADAU, BELITUNG, KEPULAUAN BANGKA BELITUNG",4,178,23,201
https://kawalpemilu.org#25116,"SUNGAI SAMAK, BADAU, BELITUNG, KEPULAUAN BANGKA BELITUNG",5,136,14,150
https://kawalpemilu.org#25116,"SUNGAI SAMAK, BADAU, BELITUNG, KEPULAUAN BANGKA BELITUNG",6,130,34,164
https://kawalpemilu.org#25116,"SUNGAI SAMAK, BADAU, BELITUNG, KEPULAUAN BANGKA BELITUNG",7,148,36,184
https://kawalpemilu.org#25116,"SUNGAI SAMAK, BADAU, BELITUNG, KEPULAUAN BANGKA BELITUNG",8,160,21,181
https://kawalpemilu.org#25117,"KACANG BUTOR, BADAU, BELITUNG, KEPULAUAN BANGKA BELITUNG",1,174,34,208
https://kawalpemilu.org#25117,"KACANG BUTOR, BADAU, BELITUNG, KEPULAUAN BANGKA BELITUNG",2,160,51,211
https://kawalpemilu.org#25117,"KACANG BUTOR, BADAU, BELITUNG, KEPULAUAN BANGKA BELITUNG",3,88,34,122
https://kawalpemilu.org#25117,"KACANG BUTOR, BADAU, BELITUNG, KEPULAUAN BANGKA BELITUNG",4,126,64,190
https://kawalpemilu.org#25117,"KACANG BUTOR, BADAU, BELITUNG, KEPULAUAN BANGKA BELITUNG",5,210,48,258
https://kawalpemilu.org#25117,"KACANG BUTOR, BADAU, BELITUNG, KEPULAUAN BANGKA BELITUNG",6,162,41,203
https://kawalpemilu.org#25117,"KACANG BUTOR, BADAU, BELITUNG, KEPULAUAN BANGKA BELITUNG",7,163,49,212
https://kawalpemilu.org#25117,"KACANG BUTOR, BADAU, BELITUNG, KEPULAUAN BANGKA BELITUNG",8,197,59,256
https://kawalpemilu.org#25118,"CERUCUK, BADAU, BELITUNG, KEPULAUAN BANGKA BELITUNG",1,137,35,172
https://kawalpemilu.org#25118,"CERUCUK, BADAU, BELITUNG, KEPULAUAN BANGKA BELITUNG",2,134,25,159
https://kawalpemilu.org#25118,"CERUCUK, BADAU, BELITUNG, KEPULAUAN BANGKA BELITUNG",3,132,36,168
https://kawalpemilu.org#25118,"CERUCUK, BADAU, BELITUNG, KEPULAUAN BANGKA BELITUNG",4,110,41,151
https://kawalpemilu.org#25118,"CERUCUK, BADAU, BELITUNG, KEPULAUAN BANGKA BELITUNG",5,133,19,152
https://kawalpemilu.org#25118,"CERUCUK, BADAU, BELITUNG, KEPULAUAN BANGKA BELITUNG",6,117,18,135
https://kawalpemilu.org#25118,"CERUCUK, BADAU, BELITUNG, KEPULAUAN BANGKA BELITUNG",7,152,31,183
https://kawalpemilu.org#25118,"CERUCUK, BADAU, BELITUNG, KEPULAUAN BANGKA BELITUNG",8,93,82,175
https://kawalpemilu.org#25119,"PEGANTUNGAN, BADAU, BELITUNG, KEPULAUAN BANGKA BELITUNG",1,122,37,159
https://kawalpemilu.org#25119,"PEGANTUNGAN, BADAU, BELITUNG, KEPULAUAN BANGKA BELITUNG",2,153,35,188
https://kawalpemilu.org#25119,"PEGANTUNGAN, BADAU, BELITUNG, KEPULAUAN BANGKA BELITUNG",3,142,47,189
https://kawalpemilu.org#25119,"PEGANTUNGAN, BADAU, BELITUNG, KEPULAUAN BANGKA BELITUNG",4,142,20,162
https://kawalpemilu.org#25119,"PEGANTUNGAN, BADAU, BELITUNG, KEPULAUAN BANGKA BELITUNG",5,90,8,98
https://kawalpemilu.org#25119,"PEGANTUNGAN, BADAU, BELITUNG, KEPULAUAN BANGKA BELITUNG",6,155,34,189
https://kawalpemilu.org#25119,"PEGANTUNGAN, BADAU, BELITUNG, KEPULAUAN BANGKA BELITUNG",7,128,18,146
https://kawalpemilu.org#87518,"IBUL, BADAU, BELITUNG, KEPULAUAN BANGKA BELITUNG",1,173,31,204
https://kawalpemilu.org#87518,"IBUL, BADAU, BELITUNG, KEPULAUAN BANGKA BELITUNG",2,183,24,207
https://kawalpemilu.org#87518,"IBUL, BADAU, BELITUNG, KEPULAUAN BANGKA BELITUNG",3,156,44,200
https://kawalpemilu.org#87518,"IBUL, BADAU, BELITUNG, KEPULAUAN BANGKA BELITUNG",4,147,35,182
https://kawalpemilu.org#25122,"TOBOALI, TOBOALI, BANGKA SELATAN, KEPULAUAN BANGKA BELITUNG",1,138,58,196
https://kawalpemilu.org#25122,"TOBOALI, TOBOALI, BANGKA SELATAN, KEPULAUAN BANGKA BELITUNG",2,118,15,133
https://kawalpemilu.org#25122,"TOBOALI, TOBOALI, BANGKA SELATAN, KEPULAUAN BANGKA BELITUNG",3,78,40,118
https://kawalpemilu.org#25122,"TOBOALI, TOBOALI, BANGKA SELATAN, KEPULAUAN BANGKA BELITUNG",4,69,73,142
https://kawalpemilu.org#25122,"TOBOALI, TOBOALI, BANGKA SELATAN, KEPULAUAN BANGKA BELITUNG",5,133,107,240
https://kawalpemilu.org#25122,"TOBOALI, TOBOALI, BANGKA SELATAN, KEPULAUAN BANGKA BELITUNG",6,114,125,239
https://kawalpemilu.org#25122,"TOBOALI, TOBOALI, BANGKA SELATAN, KEPULAUAN BANGKA BELITUNG",7,134,28,162
https://kawalpemilu.org#25122,"TOBOALI, TOBOALI, BANGKA SELATAN, KEPULAUAN BANGKA BELITUNG",8,99,61,160
https://kawalpemilu.org#25122,"TOBOALI, TOBOALI, BANGKA SELATAN, KEPULAUAN BANGKA BELITUNG",9,133,79,212
https://kawalpemilu.org#25122,"TOBOALI, TOBOALI, BANGKA SELATAN, KEPULAUAN BANGKA BELITUNG",10,122,43,165
https://kawalpemilu.org#25122,"TOBOALI, TOBOALI, BANGKA SELATAN, KEPULAUAN BANGKA BELITUNG",11,88,57,145
https://kawalpemilu.org#25122,"TOBOALI, TOBOALI, BANGKA SELATAN, KEPULAUAN BANGKA BELITUNG",12,135,70,205
https://kawalpemilu.org#25122,"TOBOALI, TOBOALI, BANGKA SELATAN, KEPULAUAN BANGKA BELITUNG",13,100,80,180
https://kawalpemilu.org#25122,"TOBOALI, TOBOALI, BANGKA SELATAN, KEPULAUAN BANGKA BELITUNG",14,120,109,229
https://kawalpemilu.org#25122,"TOBOALI, TOBOALI, BANGKA SELATAN, KEPULAUAN BANGKA BELITUNG",15,120,63,183
https://kawalpemilu.org#25122,"TOBOALI, TOBOALI, BANGKA SELATAN, KEPULAUAN BANGKA BELITUNG",16,117,76,193
https://kawalpemilu.org#25122,"TOBOALI, TOBOALI, BANGKA SELATAN, KEPULAUAN BANGKA BELITUNG",17,123,105,228
https://kawalpemilu.org#25122,"TOBOALI, TOBOALI, BANGKA SELATAN, KEPULAUAN BANGKA BELITUNG",18,132,64,196
https://kawalpemilu.org#25122,"TOBOALI, TOBOALI, BANGKA SELATAN, KEPULAUAN BANGKA BELITUNG",19,183,54,237
https://kawalpemilu.org#25122,"TOBOALI, TOBOALI, BANGKA SELATAN, KEPULAUAN BANGKA BELITUNG",20,121,61,182
https://kawalpemilu.org#25122,"TOBOALI, TOBOALI, BANGKA SELATAN, KEPULAUAN BANGKA BELITUNG",21,128,85,213
https://kawalpemilu.org#25122,"TOBOALI, TOBOALI, BANGKA SELATAN, KEPULAUAN BANGKA BELITUNG",22,118,77,195
https://kawalpemilu.org#25122,"TOBOALI, TOBOALI, BANGKA SELATAN, KEPULAUAN BANGKA BELITUNG",23,133,45,178
https://kawalpemilu.org#25122,"TOBOALI, TOBOALI, BANGKA SELATAN, KEPULAUAN BANGKA BELITUNG",24,121,105,226
https://kawalpemilu.org#25122,"TOBOALI, TOBOALI, BANGKA SELATAN, KEPULAUAN BANGKA BELITUNG",25,204,9,213
https://kawalpemilu.org#25122,"TOBOALI, TOBOALI, BANGKA SELATAN, KEPULAUAN BANGKA BELITUNG",26,77,59,136
https://kawalpemilu.org#25122,"TOBOALI, TOBOALI, BANGKA SELATAN, KEPULAUAN BANGKA BELITUNG",27,131,88,219
https://kawalpemilu.org#25122,"TOBOALI, TOBOALI, BANGKA SELATAN, KEPULAUAN BANGKA BELITUNG",28,200,41,241
https://kawalpemilu.org#25122,"TOBOALI, TOBOALI, BANGKA SELATAN, KEPULAUAN BANGKA BELITUNG",29,207,23,230
https://kawalpemilu.org#25122,"TOBOALI, TOBOALI, BANGKA SELATAN, KEPULAUAN BANGKA BELITUNG",30,86,79,165
https://kawalpemilu.org#25122,"TOBOALI, TOBOALI, BANGKA SELATAN, KEPULAUAN BANGKA BELITUNG",31,173,53,226
https://kawalpemilu.org#25122,"TOBOALI, TOBOALI, BANGKA SELATAN, KEPULAUAN BANGKA BELITUNG",32,116,74,190
https://kawalpemilu.org#25122,"TOBOALI, TOBOALI, BANGKA SELATAN, KEPULAUAN BANGKA BELITUNG",33,114,94,208
https://kawalpemilu.org#25122,"TOBOALI, TOBOALI, BANGKA SELATAN, KEPULAUAN BANGKA BELITUNG",34,164,46,210
https://kawalpemilu.org#25122,"TOBOALI, TOBOALI, BANGKA SELATAN, KEPULAUAN BANGKA BELITUNG",35,146,73,219
https://kawalpemilu.org#25122,"TOBOALI, TOBOALI, BANGKA SELATAN, KEPULAUAN BANGKA BELITUNG",36,86,101,187
https://kawalpemilu.org#25122,"TOBOALI, TOBOALI, BANGKA SELATAN, KEPULAUAN BANGKA BELITUNG",37,67,68,135
https://kawalpemilu.org#25122,"TOBOALI, TOBOALI, BANGKA SELATAN, KEPULAUAN BANGKA BELITUNG",38,56,46,102
https://kawalpemilu.org#25122,"TOBOALI, TOBOALI, BANGKA SELATAN, KEPULAUAN BANGKA BELITUNG",39,93,34,127
https://kawalpemilu.org#25122,"TOBOALI, TOBOALI, BANGKA SELATAN, KEPULAUAN BANGKA BELITUNG",40,73,82,155
https://kawalpemilu.org#25122,"TOBOALI, TOBOALI, BANGKA SELATAN, KEPULAUAN BANGKA BELITUNG",41,144,18,162
https://kawalpemilu.org#25122,"TOBOALI, TOBOALI, BANGKA SELATAN, KEPULAUAN BANGKA BELITUNG",42,63,44,107
https://kawalpemilu.org#25122,"TOBOALI, TOBOALI, BANGKA SELATAN, KEPULAUAN BANGKA BELITUNG",43,114,56,170
https://kawalpemilu.org#25122,"TOBOALI, TOBOALI, BANGKA SELATAN, KEPULAUAN BANGKA BELITUNG",44,117,20,137
https://kawalpemilu.org#25123,"TELADAN, TOBOALI, BANGKA SELATAN, KEPULAUAN BANGKA BELITUNG",1,140,5,145
https://kawalpemilu.org#25123,"TELADAN, TOBOALI, BANGKA SELATAN, KEPULAUAN BANGKA BELITUNG",2,146,12,158
https://kawalpemilu.org#25123,"TELADAN, TOBOALI, BANGKA SELATAN, KEPULAUAN BANGKA BELITUNG",3,199,8,207
https://kawalpemilu.org#25123,"TELADAN, TOBOALI, BANGKA SELATAN, KEPULAUAN BANGKA BELITUNG",4,140,34,174
https://kawalpemilu.org#25123,"TELADAN, TOBOALI, BANGKA SELATAN, KEPULAUAN BANGKA BELITUNG",5,212,20,232
https://kawalpemilu.org#25123,"TELADAN, TOBOALI, BANGKA SELATAN, KEPULAUAN BANGKA BELITUNG",6,71,66,137
https://kawalpemilu.org#25123,"TELADAN, TOBOALI, BANGKA SELATAN, KEPULAUAN BANGKA BELITUNG",7,91,45,136
https://kawalpemilu.org#25123,"TELADAN, TOBOALI, BANGKA SELATAN, KEPULAUAN BANGKA BELITUNG",8,184,66,250
https://kawalpemilu.org#25123,"TELADAN, TOBOALI, BANGKA SELATAN, KEPULAUAN BANGKA BELITUNG",9,158,18,176
https://kawalpemilu.org#25123,"TELADAN, TOBOALI, BANGKA SELATAN, KEPULAUAN BANGKA BELITUNG",10,112,59,171
https://kawalpemilu.org#25123,"TELADAN, TOBOALI, BANGKA SELATAN, KEPULAUAN BANGKA BELITUNG",11,170,25,195
https://kawalpemilu.org#25123,"TELADAN, TOBOALI, BANGKA SELATAN, KEPULAUAN BANGKA BELITUNG",12,88,99,187
https://kawalpemilu.org#25123,"TELADAN, TOBOALI, BANGKA SELATAN, KEPULAUAN BANGKA BELITUNG",13,73,116,189
https://kawalpemilu.org#25123,"TELADAN, TOBOALI, BANGKA SELATAN, KEPULAUAN BANGKA BELITUNG",14,102,99,201
https://kawalpemilu.org#25123,"TELADAN, TOBOALI, BANGKA SELATAN, KEPULAUAN BANGKA BELITUNG",15,142,92,234
https://kawalpemilu.org#25123,"TELADAN, TOBOALI, BANGKA SELATAN, KEPULAUAN BANGKA BELITUNG",16,154,97,251
https://kawalpemilu.org#25123,"TELADAN, TOBOALI, BANGKA SELATAN, KEPULAUAN BANGKA BELITUNG",17,107,88,195
https://kawalpemilu.org#25123,"TELADAN, TOBOALI, BANGKA SELATAN, KEPULAUAN BANGKA BELITUNG",18,153,76,229
https://kawalpemilu.org#25123,"TELADAN, TOBOALI, BANGKA SELATAN, KEPULAUAN BANGKA BELITUNG",19,150,71,221
https://kawalpemilu.org#25123,"TELADAN, TOBOALI, BANGKA SELATAN, KEPULAUAN BANGKA BELITUNG",20,132,96,228
https://kawalpemilu.org#25123,"TELADAN, TOBOALI, BANGKA SELATAN, KEPULAUAN BANGKA BELITUNG",21,166,84,250
https://kawalpemilu.org#25123,"TELADAN, TOBOALI, BANGKA SELATAN, KEPULAUAN BANGKA BELITUNG",22,150,101,251
https://kawalpemilu.org#25123,"TELADAN, TOBOALI, BANGKA SELATAN, KEPULAUAN BANGKA BELITUNG",23,150,111,261
https://kawalpemilu.org#25123,"TELADAN, TOBOALI, BANGKA SELATAN, KEPULAUAN BANGKA BELITUNG",24,141,104,245
https://kawalpemilu.org#25123,"TELADAN, TOBOALI, BANGKA SELATAN, KEPULAUAN BANGKA BELITUNG",25,130,128,258
https://kawalpemilu.org#25123,"TELADAN, TOBOALI, BANGKA SELATAN, KEPULAUAN BANGKA BELITUNG",26,94,99,193
https://kawalpemilu.org#25123,"TELADAN, TOBOALI, BANGKA SELATAN, KEPULAUAN BANGKA BELITUNG",27,134,122,256
https://kawalpemilu.org#25123,"TELADAN, TOBOALI, BANGKA SELATAN, KEPULAUAN BANGKA BELITUNG",28,182,89,271
https://kawalpemilu.org#25123,"TELADAN, TOBOALI, BANGKA SELATAN, KEPULAUAN BANGKA BELITUNG",29,205,75,280
https://kawalpemilu.org#25123,"TELADAN, TOBOALI, BANGKA SELATAN, KEPULAUAN BANGKA BELITUNG",30,140,117,257
https://kawalpemilu.org#25123,"TELADAN, TOBOALI, BANGKA SELATAN, KEPULAUAN BANGKA BELITUNG",31,75,53,128
https://kawalpemilu.org#25123,"TELADAN, TOBOALI, BANGKA SELATAN, KEPULAUAN BANGKA BELITUNG",32,190,117,307
https://kawalpemilu.org#25123,"TELADAN, TOBOALI, BANGKA SELATAN, KEPULAUAN BANGKA BELITUNG",33,132,137,269
https://kawalpemilu.org#25123,"TELADAN, TOBOALI, BANGKA SELATAN, KEPULAUAN BANGKA BELITUNG",34,63,113,175
https://kawalpemilu.org#25123,"TELADAN, TOBOALI, BANGKA SELATAN, KEPULAUAN BANGKA BELITUNG",35,117,8,125
https://kawalpemilu.org#25123,"TELADAN, TOBOALI, BANGKA SELATAN, KEPULAUAN BANGKA BELITUNG",36,117,61,178
https://kawalpemilu.org#25123,"TELADAN, TOBOALI, BANGKA SELATAN, KEPULAUAN BANGKA BELITUNG",37,99,96,195
https://kawalpemilu.org#25123,"TELADAN, TOBOALI, BANGKA SELATAN, KEPULAUAN BANGKA BELITUNG",38,101,98,207
https://kawalpemilu.org#25123,"TELADAN, TOBOALI, BANGKA SELATAN, KEPULAUAN BANGKA BELITUNG",39,109,85,194
https://kawalpemilu.org#25123,"TELADAN, TOBOALI, BANGKA SELATAN, KEPULAUAN BANGKA BELITUNG",40,97,82,179
https://kawalpemilu.org#25123,"TELADAN, TOBOALI, BANGKA SELATAN, KEPULAUAN BANGKA BELITUNG",41,83,60,143
https://kawalpemilu.org#25124,"TANJUNG KETAPANG, TOBOALI, BANGKA SELATAN, KEPULAUAN BANGKA BELITUNG",1,108,47,155
https://kawalpemilu.org#25124,"TANJUNG KETAPANG, TOBOALI, BANGKA SELATAN, KEPULAUAN BANGKA BELITUNG",2,148,53,201
https://kawalpemilu.org#25124,"TANJUNG KETAPANG, TOBOALI, BANGKA SELATAN, KEPULAUAN BANGKA BELITUNG",3,130,27,157
https://kawalpemilu.org#25124,"TANJUNG KETAPANG, TOBOALI, BANGKA SELATAN, KEPULAUAN BANGKA BELITUNG",4,129,13,142
https://kawalpemilu.org#25124,"TANJUNG KETAPANG, TOBOALI, BANGKA SELATAN, KEPULAUAN BANGKA BELITUNG",5,93,31,128
https://kawalpemilu.org#25124,"TANJUNG KETAPANG, TOBOALI, BANGKA SELATAN, KEPULAUAN BANGKA BELITUNG",6,167,12,179
https://kawalpemilu.org#25124,"TANJUNG KETAPANG, TOBOALI, BANGKA SELATAN, KEPULAUAN BANGKA BELITUNG",7,211,62,273
https://kawalpemilu.org#25124,"TANJUNG KETAPANG, TOBOALI, BANGKA SELATAN, KEPULAUAN BANGKA BELITUNG",8,183,64,247
https://kawalpemilu.org#25124,"TANJUNG KETAPANG, TOBOALI, BANGKA SELATAN, KEPULAUAN BANGKA BELITUNG",9,153,39,192
https://kawalpemilu.org#25124,"TANJUNG KETAPANG, TOBOALI, BANGKA SELATAN, KEPULAUAN BANGKA BELITUNG",10,148,56,204
https://kawalpemilu.org#25124,"TANJUNG KETAPANG, TOBOALI, BANGKA SELATAN, KEPULAUAN BANGKA BELITUNG",11,132,63,195
https://kawalpemilu.org#25124,"TANJUNG KETAPANG, TOBOALI, BANGKA SELATAN, KEPULAUAN BANGKA BELITUNG",12,123,72,195
https://kawalpemilu.org#25124,"TANJUNG KETAPANG, TOBOALI, BANGKA SELATAN, KEPULAUAN BANGKA BELITUNG",13,141,68,209
https://kawalpemilu.org#25124,"TANJUNG KETAPANG, TOBOALI, BANGKA SELATAN, KEPULAUAN BANGKA BELITUNG",14,126,60,186
https://kawalpemilu.org#25124,"TANJUNG KETAPANG, TOBOALI, BANGKA SELATAN, KEPULAUAN BANGKA BELITUNG",15,90,64,154
https://kawalpemilu.org#25124,"TANJUNG KETAPANG, TOBOALI, BANGKA SELATAN, KEPULAUAN BANGKA BELITUNG",16,164,45,209
https://kawalpemilu.org#25124,"TANJUNG KETAPANG, TOBOALI, BANGKA SELATAN, KEPULAUAN BANGKA BELITUNG",17,91,43,134
https://kawalpemilu.org#25124,"TANJUNG KETAPANG, TOBOALI, BANGKA SELATAN, KEPULAUAN BANGKA BELITUNG",18,164,68,232
https://kawalpemilu.org#25124,"TANJUNG KETAPANG, TOBOALI, BANGKA SELATAN, KEPULAUAN BANGKA BELITUNG",19,120,62,182
https://kawalpemilu.org#25124,"TANJUNG KETAPANG, TOBOALI, BANGKA SELATAN, KEPULAUAN BANGKA BELITUNG",20,120,102,222
https://kawalpemilu.org#25124,"TANJUNG KETAPANG, TOBOALI, BANGKA SELATAN, KEPULAUAN BANGKA BELITUNG",21,69,89,158
https://kawalpemilu.org#25124,"TANJUNG KETAPANG, TOBOALI, BANGKA SELATAN, KEPULAUAN BANGKA BELITUNG",22,106,65,171
https://kawalpemilu.org#25124,"TANJUNG KETAPANG, TOBOALI, BANGKA SELATAN, KEPULAUAN BANGKA BELITUNG",23,147,38,185
https://kawalpemilu.org#25124,"TANJUNG KETAPANG, TOBOALI, BANGKA SELATAN, KEPULAUAN BANGKA BELITUNG",24,80,17,97
https://kawalpemilu.org#25124,"TANJUNG KETAPANG, TOBOALI, BANGKA SELATAN, KEPULAUAN BANGKA BELITUNG",25,91,47,138
https://kawalpemilu.org#25124,"TANJUNG KETAPANG, TOBOALI, BANGKA SELATAN, KEPULAUAN BANGKA BELITUNG",26,146,49,195
https://kawalpemilu.org#25124,"TANJUNG KETAPANG, TOBOALI, BANGKA SELATAN, KEPULAUAN BANGKA BELITUNG",27,129,51,180
https://kawalpemilu.org#25124,"TANJUNG KETAPANG, TOBOALI, BANGKA SELATAN, KEPULAUAN BANGKA BELITUNG",28,119,47,166
https://kawalpemilu.org#25124,"TANJUNG KETAPANG, TOBOALI, BANGKA SELATAN, KEPULAUAN BANGKA BELITUNG",29,85,49,134
https://kawalpemilu.org#25124,"TANJUNG KETAPANG, TOBOALI, BANGKA SELATAN, KEPULAUAN BANGKA BELITUNG",30,109,57,166
https://kawalpemilu.org#25125,"SERDANG, TOBOALI, BANGKA SELATAN, KEPULAUAN BANGKA BELITUNG",1,166,83,249
https://kawalpemilu.org#25125,"SERDANG, TOBOALI, BANGKA SELATAN, KEPULAUAN BANGKA BELITUNG",2,113,71,184
https://kawalpemilu.org#25125,"SERDANG, TOBOALI, BANGKA SELATAN, KEPULAUAN BANGKA BELITUNG",3,176,52,228
https://kawalpemilu.org#25125,"SERDANG, TOBOALI, BANGKA SELATAN, KEPULAUAN BANGKA BELITUNG",4,124,100,224
https://kawalpemilu.org#25125,"SERDANG, TOBOALI, BANGKA SELATAN, KEPULAUAN BANGKA BELITUNG",5,93,122,215
https://kawalpemilu.org#25125,"SERDANG, TOBOALI, BANGKA SELATAN, KEPULAUAN BANGKA BELITUNG",6,118,130,248
https://kawalpemilu.org#25125,"SERDANG, TOBOALI, BANGKA SELATAN, KEPULAUAN BANGKA BELITUNG",7,206,33,239
https://kawalpemilu.org#25125,"SERDANG, TOBOALI, BANGKA SELATAN, KEPULAUAN BANGKA BELITUNG",8,126,63,189
https://kawalpemilu.org#25125,"SERDANG, TOBOALI, BANGKA SELATAN, KEPULAUAN BANGKA BELITUNG",9,174,28,202
https://kawalpemilu.org#25125,"SERDANG, TOBOALI, BANGKA SELATAN, KEPULAUAN BANGKA BELITUNG",11,97,93,190
https://kawalpemilu.org#25125,"SERDANG, TOBOALI, BANGKA SELATAN, KEPULAUAN BANGKA BELITUNG",12,138,55,193
https://kawalpemilu.org#25126,"JERIJI, TOBOALI, BANGKA SELATAN, KEPULAUAN BANGKA BELITUNG",1,49,150,199
https://kawalpemilu.org#25126,"JERIJI, TOBOALI, BANGKA SELATAN, KEPULAUAN BANGKA BELITUNG",2,62,175,237
https://kawalpemilu.org#25126,"JERIJI, TOBOALI, BANGKA SELATAN, KEPULAUAN BANGKA BELITUNG",3,57,195,252
https://kawalpemilu.org#25126,"JERIJI, TOBOALI, BANGKA SELATAN, KEPULAUAN BANGKA BELITUNG",4,62,149,211
https://kawalpemilu.org#25126,"JERIJI, TOBOALI, BANGKA SELATAN, KEPULAUAN BANGKA BELITUNG",5,41,194,235
https://kawalpemilu.org#25126,"JERIJI, TOBOALI, BANGKA SELATAN, KEPULAUAN BANGKA BELITUNG",6,45,177,222
https://kawalpemilu.org#25126,"JERIJI, TOBOALI, BANGKA SELATAN, KEPULAUAN BANGKA BELITUNG",7,39,77,116
https://kawalpemilu.org#25126,"JERIJI, TOBOALI, BANGKA SELATAN, KEPULAUAN BANGKA BELITUNG",8,30,68,98
https://kawalpemilu.org#25127,"BIKANG, TOBOALI, BANGKA SELATAN, KEPULAUAN BANGKA BELITUNG",1,161,103,264
https://kawalpemilu.org#25127,"BIKANG, TOBOALI, BANGKA SELATAN, KEPULAUAN BANGKA BELITUNG",2,130,104,234
https://kawalpemilu.org#25127,"BIKANG, TOBOALI, BANGKA SELATAN, KEPULAUAN BANGKA BELITUNG",3,146,89,235
https://kawalpemilu.org#25127,"BIKANG, TOBOALI, BANGKA SELATAN, KEPULAUAN BANGKA BELITUNG",4,121,66,187
https://kawalpemilu.org#25128,"GADUNG, TOBOALI, BANGKA SELATAN, KEPULAUAN BANGKA BELITUNG",1,101,93,194
https://kawalpemilu.org#25128,"GADUNG, TOBOALI, BANGKA SELATAN, KEPULAUAN BANGKA BELITUNG",2,111,128,239
https://kawalpemilu.org#25128,"GADUNG, TOBOALI, BANGKA SELATAN, KEPULAUAN BANGKA BELITUNG",3,116,89,205
https://kawalpemilu.org#25128,"GADUNG, TOBOALI, BANGKA SELATAN, KEPULAUAN BANGKA BELITUNG",4,129,91,220
https://kawalpemilu.org#25128,"GADUNG, TOBOALI, BANGKA SELATAN, KEPULAUAN BANGKA BELITUNG",5,105,105,210
https://kawalpemilu.org#25128,"GADUNG, TOBOALI, BANGKA SELATAN, KEPULAUAN BANGKA BELITUNG",6,135,87,222
https://kawalpemilu.org#25128,"GADUNG, TOBOALI, BANGKA SELATAN, KEPULAUAN BANGKA BELITUNG",7,107,80,187
https://kawalpemilu.org#25128,"GADUNG, TOBOALI, BANGKA SELATAN, KEPULAUAN BANGKA BELITUNG",8,76,131,207
https://kawalpemilu.org#25128,"GADUNG, TOBOALI, BANGKA SELATAN, KEPULAUAN BANGKA BELITUNG",9,139,113,252
https://kawalpemilu.org#25128,"GADUNG, TOBOALI, BANGKA SELATAN, KEPULAUAN BANGKA BELITUNG",10,129,119,248
https://kawalpemilu.org#25128,"GADUNG, TOBOALI, BANGKA SELATAN, KEPULAUAN BANGKA BELITUNG",11,162,52,214
https://kawalpemilu.org#25128,"GADUNG, TOBOALI, BANGKA SELATAN, KEPULAUAN BANGKA BELITUNG",12,187,46,233
https://kawalpemilu.org#25128,"GADUNG, TOBOALI, BANGKA SELATAN, KEPULAUAN BANGKA BELITUNG",13,129,72,201
https://kawalpemilu.org#25128,"GADUNG, TOBOALI, BANGKA SELATAN, KEPULAUAN BANGKA BELITUNG",14,132,79,211
https://kawalpemilu.org#25128,"GADUNG, TOBOALI, BANGKA SELATAN, KEPULAUAN BANGKA BELITUNG",15,75,71,146
https://kawalpemilu.org#25128,"GADUNG, TOBOALI, BANGKA SELATAN, KEPULAUAN BANGKA BELITUNG",16,86,117,203
https://kawalpemilu.org#25128,"GADUNG, TOBOALI, BANGKA SELATAN, KEPULAUAN BANGKA BELITUNG",17,154,102,256
https://kawalpemilu.org#25128,"GADUNG, TOBOALI, BANGKA SELATAN, KEPULAUAN BANGKA BELITUNG",18,73,57,130
https://kawalpemilu.org#25128,"GADUNG, TOBOALI, BANGKA SELATAN, KEPULAUAN BANGKA BELITUNG",19,63,91,154
https://kawalpemilu.org#25128,"GADUNG, TOBOALI, BANGKA SELATAN, KEPULAUAN BANGKA BELITUNG",20,94,71,165
https://kawalpemilu.org#25128,"GADUNG, TOBOALI, BANGKA SELATAN, KEPULAUAN BANGKA BELITUNG",21,154,55,209
https://kawalpemilu.org#25129,"RIAS, TOBOALI, BANGKA SELATAN, KEPULAUAN BANGKA BELITUNG",1,92,43,135
https://kawalpemilu.org#25129,"RIAS, TOBOALI, BANGKA SELATAN, KEPULAUAN BANGKA BELITUNG",2,168,51,219
https://kawalpemilu.org#25129,"RIAS, TOBOALI, BANGKA SELATAN, KEPULAUAN BANGKA BELITUNG",3,108,38,146
https://kawalpemilu.org#25129,"RIAS, TOBOALI, BANGKA SELATAN, KEPULAUAN BANGKA BELITUNG",4,162,42,204
https://kawalpemilu.org#25129,"RIAS, TOBOALI, BANGKA SELATAN, KEPULAUAN BANGKA BELITUNG",5,188,36,224
https://kawalpemilu.org#25129,"RIAS, TOBOALI, BANGKA SELATAN, KEPULAUAN BANGKA BELITUNG",6,123,26,149
https://kawalpemilu.org#25129,"RIAS, TOBOALI, BANGKA SELATAN, KEPULAUAN BANGKA BELITUNG",7,190,29,219
https://kawalpemilu.org#25129,"RIAS, TOBOALI, BANGKA SELATAN, KEPULAUAN BANGKA BELITUNG",8,177,30,207
https://kawalpemilu.org#25129,"RIAS, TOBOALI, BANGKA SELATAN, KEPULAUAN BANGKA BELITUNG",9,133,41,174
https://kawalpemilu.org#25129,"RIAS, TOBOALI, BANGKA SELATAN, KEPULAUAN BANGKA BELITUNG",10,199,56,255
https://kawalpemilu.org#25129,"RIAS, TOBOALI, BANGKA SELATAN, KEPULAUAN BANGKA BELITUNG",11,158,88,246
https://kawalpemilu.org#25129,"RIAS, TOBOALI, BANGKA SELATAN, KEPULAUAN BANGKA BELITUNG",12,158,59,217
https://kawalpemilu.org#25129,"RIAS, TOBOALI, BANGKA SELATAN, KEPULAUAN BANGKA BELITUNG",13,205,26,231
https://kawalpemilu.org#25129,"RIAS, TOBOALI, BANGKA SELATAN, KEPULAUAN BANGKA BELITUNG",14,198,22,220
https://kawalpemilu.org#25129,"RIAS, TOBOALI, BANGKA SELATAN, KEPULAUAN BANGKA BELITUNG",15,222,29,251
https://kawalpemilu.org#25129,"RIAS, TOBOALI, BANGKA SELATAN, KEPULAUAN BANGKA BELITUNG",16,136,47,183
https://kawalpemilu.org#25129,"RIAS, TOBOALI, BANGKA SELATAN, KEPULAUAN BANGKA BELITUNG",17,183,8,191
https://kawalpemilu.org#25129,"RIAS, TOBOALI, BANGKA SELATAN, KEPULAUAN BANGKA BELITUNG",18,150,39,189
https://kawalpemilu.org#25129,"RIAS, TOBOALI, BANGKA SELATAN, KEPULAUAN BANGKA BELITUNG",19,208,49,257
https://kawalpemilu.org#25129,"RIAS, TOBOALI, BANGKA SELATAN, KEPULAUAN BANGKA BELITUNG",20,120,89,209
https://kawalpemilu.org#25129,"RIAS, TOBOALI, BANGKA SELATAN, KEPULAUAN BANGKA BELITUNG",21,130,54,184
https://kawalpemilu.org#25129,"RIAS, TOBOALI, BANGKA SELATAN, KEPULAUAN BANGKA BELITUNG",22,99,34,133
https://kawalpemilu.org#25129,"RIAS, TOBOALI, BANGKA SELATAN, KEPULAUAN BANGKA BELITUNG",23,104,45,149
https://kawalpemilu.org#25130,"KEPOH, TOBOALI, BANGKA SELATAN, KEPULAUAN BANGKA BELITUNG",1,123,58,181
https://kawalpemilu.org#25130,"KEPOH, TOBOALI, BANGKA SELATAN, KEPULAUAN BANGKA BELITUNG",2,112,56,168
https://kawalpemilu.org#25130,"KEPOH, TOBOALI, BANGKA SELATAN, KEPULAUAN BANGKA BELITUNG",3,130,41,171
https://kawalpemilu.org#25130,"KEPOH, TOBOALI, BANGKA SELATAN, KEPULAUAN BANGKA BELITUNG",4,129,24,153
https://kawalpemilu.org#25130,"KEPOH, TOBOALI, BANGKA SELATAN, KEPULAUAN BANGKA BELITUNG",5,105,66,171
https://kawalpemilu.org#25130,"KEPOH, TOBOALI, BANGKA SELATAN, KEPULAUAN BANGKA BELITUNG",6,117,53,170
https://kawalpemilu.org#25130,"KEPOH, TOBOALI, BANGKA SELATAN, KEPULAUAN BANGKA BELITUNG",7,128,35,163
https://kawalpemilu.org#25130,"KEPOH, TOBOALI, BANGKA SELATAN, KEPULAUAN BANGKA BELITUNG",8,109,20,129
https://kawalpemilu.org#25131,"KEPOSANG, TOBOALI, BANGKA SELATAN, KEPULAUAN BANGKA BELITUNG",1,185,53,238
https://kawalpemilu.org#25131,"KEPOSANG, TOBOALI, BANGKA SELATAN, KEPULAUAN BANGKA BELITUNG",2,182,44,226
https://kawalpemilu.org#25131,"KEPOSANG, TOBOALI, BANGKA SELATAN, KEPULAUAN BANGKA BELITUNG",3,226,14,240
https://kawalpemilu.org#25131,"KEPOSANG, TOBOALI, BANGKA SELATAN, KEPULAUAN BANGKA BELITUNG",5,142,32,174
https://kawalpemilu.org#25131,"KEPOSANG, TOBOALI, BANGKA SELATAN, KEPULAUAN BANGKA BELITUNG",6,171,44,215
https://kawalpemilu.org#25131,"KEPOSANG, TOBOALI, BANGKA SELATAN, KEPULAUAN BANGKA BELITUNG",7,136,48,184
https://kawalpemilu.org#25131,"KEPOSANG, TOBOALI, BANGKA SELATAN, KEPULAUAN BANGKA BELITUNG",8,183,52,235
https://kawalpemilu.org#25131,"KEPOSANG, TOBOALI, BANGKA SELATAN, KEPULAUAN BANGKA BELITUNG",9,195,18,213
https://kawalpemilu.org#25131,"KEPOSANG, TOBOALI, BANGKA SELATAN, KEPULAUAN BANGKA BELITUNG",10,154,21,175
https://kawalpemilu.org#25131,"KEPOSANG, TOBOALI, BANGKA SELATAN, KEPULAUAN BANGKA BELITUNG",11,184,48,232
https://kawalpemilu.org#25131,"KEPOSANG, TOBOALI, BANGKA SELATAN, KEPULAUAN BANGKA BELITUNG",12,131,25,156
https://kawalpemilu.org#25131,"KEPOSANG, TOBOALI, BANGKA SELATAN, KEPULAUAN BANGKA BELITUNG",13,131,30,161
https://kawalpemilu.org#25131,"KEPOSANG, TOBOALI, BANGKA SELATAN, KEPULAUAN BANGKA BELITUNG",14,82,11,93
https://kawalpemilu.org#25132,"RINDIK, TOBOALI, BANGKA SELATAN, KEPULAUAN BANGKA BELITUNG",1,76,96,172
https://kawalpemilu.org#25132,"RINDIK, TOBOALI, BANGKA SELATAN, KEPULAUAN BANGKA BELITUNG",2,77,61,138
https://kawalpemilu.org#25132,"RINDIK, TOBOALI, BANGKA SELATAN, KEPULAUAN BANGKA BELITUNG",3,87,72,159
https://kawalpemilu.org#25132,"RINDIK, TOBOALI, BANGKA SELATAN, KEPULAUAN BANGKA BELITUNG",4,146,75,221
https://kawalpemilu.org#25132,"RINDIK, TOBOALI, BANGKA SELATAN, KEPULAUAN BANGKA BELITUNG",5,100,52,152
https://kawalpemilu.org#25134,"TANJUNG LABU, LEPAR PONGOK, BANGKA SELATAN, KEPULAUAN BANGKA BELITUNG",1,120,85,205
https://kawalpemilu.org#25134,"TANJUNG LABU, LEPAR PONGOK, BANGKA SELATAN, KEPULAUAN BANGKA BELITUNG",2,113,55,168
https://kawalpemilu.org#25134,"TANJUNG LABU, LEPAR PONGOK, BANGKA SELATAN, KEPULAUAN BANGKA BELITUNG",3,126,81,207
https://kawalpemilu.org#25134,"TANJUNG LABU, LEPAR PONGOK, BANGKA SELATAN, KEPULAUAN BANGKA BELITUNG",4,98,67,165
https://kawalpemilu.org#25134,"TANJUNG LABU, LEPAR PONGOK, BANGKA SELATAN, KEPULAUAN BANGKA BELITUNG",5,89,50,139
https://kawalpemilu.org#25134,"TANJUNG LABU, LEPAR PONGOK, BANGKA SELATAN, KEPULAUAN BANGKA BELITUNG",6,110,63,173
https://kawalpemilu.org#25134,"TANJUNG LABU, LEPAR PONGOK, BANGKA SELATAN, KEPULAUAN BANGKA BELITUNG",7,116,74,190
https://kawalpemilu.org#25135,"TANJUNG SANGKAR, LEPAR PONGOK, BANGKA SELATAN, KEPULAUAN BANGKA BELITUNG",1,209,41,250
https://kawalpemilu.org#25135,"TANJUNG SANGKAR, LEPAR PONGOK, BANGKA SELATAN, KEPULAUAN BANGKA BELITUNG",2,166,75,241
https://kawalpemilu.org#25135,"TANJUNG SANGKAR, LEPAR PONGOK, BANGKA SELATAN, KEPULAUAN BANGKA BELITUNG",3,145,62,207
https://kawalpemilu.org#25135,"TANJUNG SANGKAR, LEPAR PONGOK, BANGKA SELATAN, KEPULAUAN BANGKA BELITUNG",4,160,70,230
https://kawalpemilu.org#25135,"TANJUNG SANGKAR, LEPAR PONGOK, BANGKA SELATAN, KEPULAUAN BANGKA BELITUNG",5,138,68,206
https://kawalpemilu.org#25135,"TANJUNG SANGKAR, LEPAR PONGOK, BANGKA SELATAN, KEPULAUAN BANGKA BELITUNG",6,136,101,237
https://kawalpemilu.org#25137,"KUMBUNG, LEPAR PONGOK, BANGKA SELATAN, KEPULAUAN BANGKA BELITUNG",1,128,26,154
https://kawalpemilu.org#25137,"KUMBUNG, LEPAR PONGOK, BANGKA SELATAN, KEPULAUAN BANGKA BELITUNG",2,76,7,83
https://kawalpemilu.org#25137,"KUMBUNG, LEPAR PONGOK, BANGKA SELATAN, KEPULAUAN BANGKA BELITUNG",3,115,29,144
https://kawalpemilu.org#25138,"PENUTUK, LEPAR PONGOK, BANGKA SELATAN, KEPULAUAN BANGKA BELITUNG",1,108,150,258
https://kawalpemilu.org#25138,"PENUTUK, LEPAR PONGOK, BANGKA SELATAN, KEPULAUAN BANGKA BELITUNG",2,107,135,242
https://kawalpemilu.org#25138,"PENUTUK, LEPAR PONGOK, BANGKA SELATAN, KEPULAUAN BANGKA BELITUNG",3,82,158,240
https://kawalpemilu.org#25138,"PENUTUK, LEPAR PONGOK, BANGKA SELATAN, KEPULAUAN BANGKA BELITUNG",4,38,134,172
https://kawalpemilu.org#25138,"PENUTUK, LEPAR PONGOK, BANGKA SELATAN, KEPULAUAN BANGKA BELITUNG",5,25,74,99
https://kawalpemilu.org#25138,"PENUTUK, LEPAR PONGOK, BANGKA SELATAN, KEPULAUAN BANGKA BELITUNG",6,146,36,182
https://kawalpemilu.org#25138,"PENUTUK, LEPAR PONGOK, BANGKA SELATAN, KEPULAUAN BANGKA BELITUNG",7,124,141,265
https://kawalpemilu.org#25138,"PENUTUK, LEPAR PONGOK, BANGKA SELATAN, KEPULAUAN BANGKA BELITUNG",8,138,30,168
https://kawalpemilu.org#25141,"AIR GEGAS, AIR GEGAS, BANGKA SELATAN, KEPULAUAN BANGKA BELITUNG",1,193,25,218
https://kawalpemilu.org#25141,"AIR GEGAS, AIR GEGAS, BANGKA SELATAN, KEPULAUAN BANGKA BELITUNG",2,158,60,218
https://kawalpemilu.org#25141,"AIR GEGAS, AIR GEGAS, BANGKA SELATAN, KEPULAUAN BANGKA BELITUNG",3,98,73,171
https://kawalpemilu.org#25141,"AIR GEGAS, AIR GEGAS, BANGKA SELATAN, KEPULAUAN BANGKA BELITUNG",4,136,71,207
https://kawalpemilu.org#25141,"AIR GEGAS, AIR GEGAS, BANGKA SELATAN, KEPULAUAN BANGKA BELITUNG",5,104,97,201
https://kawalpemilu.org#25141,"AIR GEGAS, AIR GEGAS, BANGKA SELATAN, KEPULAUAN BANGKA BELITUNG",6,157,88,245
https://kawalpemilu.org#25141,"AIR GEGAS, AIR GEGAS, BANGKA SELATAN, KEPULAUAN BANGKA BELITUNG",7,103,89,192
https://kawalpemilu.org#25141,"AIR GEGAS, AIR GEGAS, BANGKA SELATAN, KEPULAUAN BANGKA BELITUNG",8,89,53,142
https://kawalpemilu.org#25141,"AIR GEGAS, AIR GEGAS, BANGKA SELATAN, KEPULAUAN BANGKA BELITUNG",9,29,161,190
https://kawalpemilu.org#25141,"AIR GEGAS, AIR GEGAS, BANGKA SELATAN, KEPULAUAN BANGKA BELITUNG",10,95,45,140
https://kawalpemilu.org#25141,"AIR GEGAS, AIR GEGAS, BANGKA SELATAN, KEPULAUAN BANGKA BELITUNG",11,90,58,148
https://kawalpemilu.org#25141,"AIR GEGAS, AIR GEGAS, BANGKA SELATAN, KEPULAUAN BANGKA BELITUNG",12,86,42,128
https://kawalpemilu.org#25141,"AIR GEGAS, AIR GEGAS, BANGKA SELATAN, KEPULAUAN BANGKA BELITUNG",13,86,64,150
https://kawalpemilu.org#25141,"AIR GEGAS, AIR GEGAS, BANGKA SELATAN, KEPULAUAN BANGKA BELITUNG",14,131,59,190
https://kawalpemilu.org#25142,"DELAS, AIR GEGAS, BANGKA SELATAN, KEPULAUAN BANGKA BELITUNG",1,48,165,213
https://kawalpemilu.org#25142,"DELAS, AIR GEGAS, BANGKA SELATAN, KEPULAUAN BANGKA BELITUNG",2,61,158,219
https://kawalpemilu.org#25142,"DELAS, AIR GEGAS, BANGKA SELATAN, KEPULAUAN BANGKA BELITUNG",3,70,147,217
https://kawalpemilu.org#25142,"DELAS, AIR GEGAS, BANGKA SELATAN, KEPULAUAN BANGKA BELITUNG",4,67,114,181
https://kawalpemilu.org#25142,"DELAS, AIR GEGAS, BANGKA SELATAN, KEPULAUAN BANGKA BELITUNG",5,86,104,190
https://kawalpemilu.org#25142,"DELAS, AIR GEGAS, BANGKA SELATAN, KEPULAUAN BANGKA BELITUNG",6,70,129,199
https://kawalpemilu.org#25142,"DELAS, AIR GEGAS, BANGKA SELATAN, KEPULAUAN BANGKA BELITUNG",7,52,136,188
https://kawalpemilu.org#25142,"DELAS, AIR GEGAS, BANGKA SELATAN, KEPULAUAN BANGKA BELITUNG",8,43,103,146
https://kawalpemilu.org#25142,"DELAS, AIR GEGAS, BANGKA SELATAN, KEPULAUAN BANGKA BELITUNG",9,67,142,209
https://kawalpemilu.org#25142,"DELAS, AIR GEGAS, BANGKA SELATAN, KEPULAUAN BANGKA BELITUNG",10,64,169,233
https://kawalpemilu.org#25142,"DELAS, AIR GEGAS, BANGKA SELATAN, KEPULAUAN BANGKA BELITUNG",11,74,53,127
https://kawalpemilu.org#25142,"DELAS, AIR GEGAS, BANGKA SELATAN, KEPULAUAN BANGKA BELITUNG",12,56,81,137
https://kawalpemilu.org#25142,"DELAS, AIR GEGAS, BANGKA SELATAN, KEPULAUAN BANGKA BELITUNG",13,41,94,135
https://kawalpemilu.org#25142,"DELAS, AIR GEGAS, BANGKA SELATAN, KEPULAUAN BANGKA BELITUNG",14,28,101,129
https://kawalpemilu.org#25142,"DELAS, AIR GEGAS, BANGKA SELATAN, KEPULAUAN BANGKA BELITUNG",15,43,73,116
https://kawalpemilu.org#25143,"PERGAM, AIR GEGAS, BANGKA SELATAN, KEPULAUAN BANGKA BELITUNG",2,90,46,136
https://kawalpemilu.org#25143,"PERGAM, AIR GEGAS, BANGKA SELATAN, KEPULAUAN BANGKA BELITUNG",3,122,33,155
https://kawalpemilu.org#25143,"PERGAM, AIR GEGAS, BANGKA SELATAN, KEPULAUAN BANGKA BELITUNG",4,80,73,153
https://kawalpemilu.org#25143,"PERGAM, AIR GEGAS, BANGKA SELATAN, KEPULAUAN BANGKA BELITUNG",6,123,32,155
https://kawalpemilu.org#25143,"PERGAM, AIR GEGAS, BANGKA SELATAN, KEPULAUAN BANGKA BELITUNG",7,100,56,156
https://kawalpemilu.org#25143,"PERGAM, AIR GEGAS, BANGKA SELATAN, KEPULAUAN BANGKA BELITUNG",8,100,53,153
https://kawalpemilu.org#25143,"PERGAM, AIR GEGAS, BANGKA SELATAN, KEPULAUAN BANGKA BELITUNG",9,121,70,191
https://kawalpemilu.org#25144,"BENCAH, AIR GEGAS, BANGKA SELATAN, KEPULAUAN BANGKA BELITUNG",1,106,118,224
https://kawalpemilu.org#25144,"BENCAH, AIR GEGAS, BANGKA SELATAN, KEPULAUAN BANGKA BELITUNG",2,128,109,237
https://kawalpemilu.org#25144,"BENCAH, AIR GEGAS, BANGKA SELATAN, KEPULAUAN BANGKA BELITUNG",3,95,133,228
https://kawalpemilu.org#25144,"BENCAH, AIR GEGAS, BANGKA SELATAN, KEPULAUAN BANGKA BELITUNG",4,99,118,217
https://kawalpemilu.org#25144,"BENCAH, AIR GEGAS, BANGKA SELATAN, KEPULAUAN BANGKA BELITUNG",5,87,123,210
https://kawalpemilu.org#25144,"BENCAH, AIR GEGAS, BANGKA SELATAN, KEPULAUAN BANGKA BELITUNG",6,119,120,239
https://kawalpemilu.org#25144,"BENCAH, AIR GEGAS, BANGKA SELATAN, KEPULAUAN BANGKA BELITUNG",7,89,61,150
https://kawalpemilu.org#25144,"BENCAH, AIR GEGAS, BANGKA SELATAN, KEPULAUAN BANGKA BELITUNG",8,58,115,173
https://kawalpemilu.org#25144,"BENCAH, AIR GEGAS, BANGKA SELATAN, KEPULAUAN BANGKA BELITUNG",9,75,87,162
https://kawalpemilu.org#25144,"BENCAH, AIR GEGAS, BANGKA SELATAN, KEPULAUAN BANGKA BELITUNG",10,125,99,224
https://kawalpemilu.org#25144,"BENCAH, AIR GEGAS, BANGKA SELATAN, KEPULAUAN BANGKA BELITUNG",11,103,134,237
https://kawalpemilu.org#25144,"BENCAH, AIR GEGAS, BANGKA SELATAN, KEPULAUAN BANGKA BELITUNG",12,173,95,268
https://kawalpemilu.org#25144,"BENCAH, AIR GEGAS, BANGKA SELATAN, KEPULAUAN BANGKA BELITUNG",13,155,68,223
https://kawalpemilu.org#25144,"BENCAH, AIR GEGAS, BANGKA SELATAN, KEPULAUAN BANGKA BELITUNG",14,199,42,241
https://kawalpemilu.org#25144,"BENCAH, AIR GEGAS, BANGKA SELATAN, KEPULAUAN BANGKA BELITUNG",15,77,85,162
https://kawalpemilu.org#25144,"BENCAH, AIR GEGAS, BANGKA SELATAN, KEPULAUAN BANGKA BELITUNG",16,73,94,167
https://kawalpemilu.org#25144,"BENCAH, AIR GEGAS, BANGKA SELATAN, KEPULAUAN BANGKA BELITUNG",17,101,76,177
https://kawalpemilu.org#25145,"NYELANDING, AIR GEGAS, BANGKA SELATAN, KEPULAUAN BANGKA BELITUNG",1,121,84,205
https://kawalpemilu.org#25145,"NYELANDING, AIR GEGAS, BANGKA SELATAN, KEPULAUAN BANGKA BELITUNG",2,94,110,204
https://kawalpemilu.org#25145,"NYELANDING, AIR GEGAS, BANGKA SELATAN, KEPULAUAN BANGKA BELITUNG",3,105,65,170
https://kawalpemilu.org#25145,"NYELANDING, AIR GEGAS, BANGKA SELATAN, KEPULAUAN BANGKA BELITUNG",4,120,77,197
https://kawalpemilu.org#25145,"NYELANDING, AIR GEGAS, BANGKA SELATAN, KEPULAUAN BANGKA BELITUNG",5,113,67,180
https://kawalpemilu.org#25145,"NYELANDING, AIR GEGAS, BANGKA SELATAN, KEPULAUAN BANGKA BELITUNG",6,99,43,142
https://kawalpemilu.org#25145,"NYELANDING, AIR GEGAS, BANGKA SELATAN, KEPULAUAN BANGKA BELITUNG",7,129,73,202
https://kawalpemilu.org#25145,"NYELANDING, AIR GEGAS, BANGKA SELATAN, KEPULAUAN BANGKA BELITUNG",8,103,64,167
https://kawalpemilu.org#25145,"NYELANDING, AIR GEGAS, BANGKA SELATAN, KEPULAUAN BANGKA BELITUNG",9,77,111,188
https://kawalpemilu.org#25145,"NYELANDING, AIR GEGAS, BANGKA SELATAN, KEPULAUAN BANGKA BELITUNG",10,106,65,171
https://kawalpemilu.org#25145,"NYELANDING, AIR GEGAS, BANGKA SELATAN, KEPULAUAN BANGKA BELITUNG",11,144,47,191
https://kawalpemilu.org#25145,"NYELANDING, AIR GEGAS, BANGKA SELATAN, KEPULAUAN BANGKA BELITUNG",12,131,49,180
https://kawalpemilu.org#25145,"NYELANDING, AIR GEGAS, BANGKA SELATAN, KEPULAUAN BANGKA BELITUNG",13,92,73,165
https://kawalpemilu.org#25145,"NYELANDING, AIR GEGAS, BANGKA SELATAN, KEPULAUAN BANGKA BELITUNG",14,114,79,193
https://kawalpemilu.org#25145,"NYELANDING, AIR GEGAS, BANGKA SELATAN, KEPULAUAN BANGKA BELITUNG",15,115,62,177
https://kawalpemilu.org#25146,"NANGKA, AIR GEGAS, BANGKA SELATAN, KEPULAUAN BANGKA BELITUNG",1,145,94,239
https://kawalpemilu.org#25146,"NANGKA, AIR GEGAS, BANGKA SELATAN, KEPULAUAN BANGKA BELITUNG",2,107,56,163
https://kawalpemilu.org#25146,"NANGKA, AIR GEGAS, BANGKA SELATAN, KEPULAUAN BANGKA BELITUNG",3,100,50,150
https://kawalpemilu.org#25146,"NANGKA, AIR GEGAS, BANGKA SELATAN, KEPULAUAN BANGKA BELITUNG",4,120,65,185
https://kawalpemilu.org#25146,"NANGKA, AIR GEGAS, BANGKA SELATAN, KEPULAUAN BANGKA BELITUNG",5,63,97,160
https://kawalpemilu.org#25146,"NANGKA, AIR GEGAS, BANGKA SELATAN, KEPULAUAN BANGKA BELITUNG",6,105,80,185
https://kawalpemilu.org#25146,"NANGKA, AIR GEGAS, BANGKA SELATAN, KEPULAUAN BANGKA BELITUNG",7,82,145,227
https://kawalpemilu.org#25146,"NANGKA, AIR GEGAS, BANGKA SELATAN, KEPULAUAN BANGKA BELITUNG",8,126,78,204
https://kawalpemilu.org#25146,"NANGKA, AIR GEGAS, BANGKA SELATAN, KEPULAUAN BANGKA BELITUNG",9,103,99,202
https://kawalpemilu.org#25147,"RANGGAS, AIR GEGAS, BANGKA SELATAN, KEPULAUAN BANGKA BELITUNG",1,183,82,265
https://kawalpemilu.org#25147,"RANGGAS, AIR GEGAS, BANGKA SELATAN, KEPULAUAN BANGKA BELITUNG",2,113,105,218
https://kawalpemilu.org#25147,"RANGGAS, AIR GEGAS, BANGKA SELATAN, KEPULAUAN BANGKA BELITUNG",3,133,90,223
https://kawalpemilu.org#25147,"RANGGAS, AIR GEGAS, BANGKA SELATAN, KEPULAUAN BANGKA BELITUNG",4,78,111,189
https://kawalpemilu.org#25147,"RANGGAS, AIR GEGAS, BANGKA SELATAN, KEPULAUAN BANGKA BELITUNG",5,88,127,215
https://kawalpemilu.org#25147,"RANGGAS, AIR GEGAS, BANGKA SELATAN, KEPULAUAN BANGKA BELITUNG",6,115,135,250
https://kawalpemilu.org#25147,"RANGGAS, AIR GEGAS, BANGKA SELATAN, KEPULAUAN BANGKA BELITUNG",7,170,89,259
https://kawalpemilu.org#25147,"RANGGAS, AIR GEGAS, BANGKA SELATAN, KEPULAUAN BANGKA BELITUNG",8,181,37,218
https://kawalpemilu.org#25147,"RANGGAS, AIR GEGAS, BANGKA SELATAN, KEPULAUAN BANGKA BELITUNG",9,71,29,100
https://kawalpemilu.org#25147,"RANGGAS, AIR GEGAS, BANGKA SELATAN, KEPULAUAN BANGKA BELITUNG",10,78,55,133
https://kawalpemilu.org#25148,"AIR BARA, AIR GEGAS, BANGKA SELATAN, KEPULAUAN BANGKA BELITUNG",1,115,114,229
https://kawalpemilu.org#25148,"AIR BARA, AIR GEGAS, BANGKA SELATAN, KEPULAUAN BANGKA BELITUNG",2,86,145,13
https://kawalpemilu.org#25148,"AIR BARA, AIR GEGAS, BANGKA SELATAN, KEPULAUAN BANGKA BELITUNG",3,85,136,221
https://kawalpemilu.org#25148,"AIR BARA, AIR GEGAS, BANGKA SELATAN, KEPULAUAN BANGKA BELITUNG",4,74,98,172
https://kawalpemilu.org#25148,"AIR BARA, AIR GEGAS, BANGKA SELATAN, KEPULAUAN BANGKA BELITUNG",5,93,108,201
https://kawalpemilu.org#25148,"AIR BARA, AIR GEGAS, BANGKA SELATAN, KEPULAUAN BANGKA BELITUNG",6,101,44,145
https://kawalpemilu.org#25148,"AIR BARA, AIR GEGAS, BANGKA SELATAN, KEPULAUAN BANGKA BELITUNG",7,94,24,118
https://kawalpemilu.org#25148,"AIR BARA, AIR GEGAS, BANGKA SELATAN, KEPULAUAN BANGKA BELITUNG",8,110,24,134
https://kawalpemilu.org#25148,"AIR BARA, AIR GEGAS, BANGKA SELATAN, KEPULAUAN BANGKA BELITUNG",9,150,26,176
https://kawalpemilu.org#25148,"AIR BARA, AIR GEGAS, BANGKA SELATAN, KEPULAUAN BANGKA BELITUNG",10,70,172,242
https://kawalpemilu.org#25148,"AIR BARA, AIR GEGAS, BANGKA SELATAN, KEPULAUAN BANGKA BELITUNG",11,56,112,168
https://kawalpemilu.org#25148,"AIR BARA, AIR GEGAS, BANGKA SELATAN, KEPULAUAN BANGKA BELITUNG",12,97,20,117
https://kawalpemilu.org#25149,"SIDOHARJO, AIR GEGAS, BANGKA SELATAN, KEPULAUAN BANGKA BELITUNG",1,151,38,189
https://kawalpemilu.org#25149,"SIDOHARJO, AIR GEGAS, BANGKA SELATAN, KEPULAUAN BANGKA BELITUNG",2,147,46,193
https://kawalpemilu.org#25149,"SIDOHARJO, AIR GEGAS, BANGKA SELATAN, KEPULAUAN BANGKA BELITUNG",3,170,46,216
https://kawalpemilu.org#25149,"SIDOHARJO, AIR GEGAS, BANGKA SELATAN, KEPULAUAN BANGKA BELITUNG",4,174,33,207
https://kawalpemilu.org#25149,"SIDOHARJO, AIR GEGAS, BANGKA SELATAN, KEPULAUAN BANGKA BELITUNG",5,170,42,212
https://kawalpemilu.org#25149,"SIDOHARJO, AIR GEGAS, BANGKA SELATAN, KEPULAUAN BANGKA BELITUNG",6,230,24,254
https://kawalpemilu.org#25149,"SIDOHARJO, AIR GEGAS, BANGKA SELATAN, KEPULAUAN BANGKA BELITUNG",7,210,30,240
https://kawalpemilu.org#25149,"SIDOHARJO, AIR GEGAS, BANGKA SELATAN, KEPULAUAN BANGKA BELITUNG",8,160,23,183
https://kawalpemilu.org#25149,"SIDOHARJO, AIR GEGAS, BANGKA SELATAN, KEPULAUAN BANGKA BELITUNG",9,166,23,189
https://kawalpemilu.org#25149,"SIDOHARJO, AIR GEGAS, BANGKA SELATAN, KEPULAUAN BANGKA BELITUNG",10,102,43,145
https://kawalpemilu.org#25149,"SIDOHARJO, AIR GEGAS, BANGKA SELATAN, KEPULAUAN BANGKA BELITUNG",11,183,28,211
https://kawalpemilu.org#25150,"TEPUS, AIR GEGAS, BANGKA SELATAN, KEPULAUAN BANGKA BELITUNG",1,192,70,262
https://kawalpemilu.org#25150,"TEPUS, AIR GEGAS, BANGKA SELATAN, KEPULAUAN BANGKA BELITUNG",2,193,36,229
https://kawalpemilu.org#25150,"TEPUS, AIR GEGAS, BANGKA SELATAN, KEPULAUAN BANGKA BELITUNG",3,176,29,205
https://kawalpemilu.org#25150,"TEPUS, AIR GEGAS, BANGKA SELATAN, KEPULAUAN BANGKA BELITUNG",4,149,57,206
https://kawalpemilu.org#25150,"TEPUS, AIR GEGAS, BANGKA SELATAN, KEPULAUAN BANGKA BELITUNG",5,207,44,251
https://kawalpemilu.org#25150,"TEPUS, AIR GEGAS, BANGKA SELATAN, KEPULAUAN BANGKA BELITUNG",6,151,20,171
https://kawalpemilu.org#25150,"TEPUS, AIR GEGAS, BANGKA SELATAN, KEPULAUAN BANGKA BELITUNG",7,99,12,111
https://kawalpemilu.org#25150,"TEPUS, AIR GEGAS, BANGKA SELATAN, KEPULAUAN BANGKA BELITUNG",8,192,49,241
https://kawalpemilu.org#25150,"TEPUS, AIR GEGAS, BANGKA SELATAN, KEPULAUAN BANGKA BELITUNG",9,153,39,192
https://kawalpemilu.org#25152,"JELUTUNG II, SIMPANG RIMBA, BANGKA SELATAN, KEPULAUAN BANGKA BELITUNG",1,148,19,167
https://kawalpemilu.org#25152,"JELUTUNG II, SIMPANG RIMBA, BANGKA SELATAN, KEPULAUAN BANGKA BELITUNG",2,173,46,219
https://kawalpemilu.org#25152,"JELUTUNG II, SIMPANG RIMBA, BANGKA SELATAN, KEPULAUAN BANGKA BELITUNG",3,126,26,152
https://kawalpemilu.org#25152,"JELUTUNG II, SIMPANG RIMBA, BANGKA SELATAN, KEPULAUAN BANGKA BELITUNG",4,90,150,240
https://kawalpemilu.org#25152,"JELUTUNG II, SIMPANG RIMBA, BANGKA SELATAN, KEPULAUAN BANGKA BELITUNG",5,105,95,200
https://kawalpemilu.org#25152,"JELUTUNG II, SIMPANG RIMBA, BANGKA SELATAN, KEPULAUAN BANGKA BELITUNG",6,153,98,251
https://kawalpemilu.org#25152,"JELUTUNG II, SIMPANG RIMBA, BANGKA SELATAN, KEPULAUAN BANGKA BELITUNG",7,99,90,189
https://kawalpemilu.org#25152,"JELUTUNG II, SIMPANG RIMBA, BANGKA SELATAN, KEPULAUAN BANGKA BELITUNG",8,80,112,192
https://kawalpemilu.org#25152,"JELUTUNG II, SIMPANG RIMBA, BANGKA SELATAN, KEPULAUAN BANGKA BELITUNG",9,85,102,187
https://kawalpemilu.org#25152,"JELUTUNG II, SIMPANG RIMBA, BANGKA SELATAN, KEPULAUAN BANGKA BELITUNG",10,128,112,240
https://kawalpemilu.org#25152,"JELUTUNG II, SIMPANG RIMBA, BANGKA SELATAN, KEPULAUAN BANGKA BELITUNG",11,94,15,109
https://kawalpemilu.org#25152,"JELUTUNG II, SIMPANG RIMBA, BANGKA SELATAN, KEPULAUAN BANGKA BELITUNG",12,105,20,125
https://kawalpemilu.org#25152,"JELUTUNG II, SIMPANG RIMBA, BANGKA SELATAN, KEPULAUAN BANGKA BELITUNG",13,111,67,178
https://kawalpemilu.org#25152,"JELUTUNG II, SIMPANG RIMBA, BANGKA SELATAN, KEPULAUAN BANGKA BELITUNG",14,67,74,141
https://kawalpemilu.org#25153,"GUDANG, SIMPANG RIMBA, BANGKA SELATAN, KEPULAUAN BANGKA BELITUNG",1,89,131,220
https://kawalpemilu.org#25153,"GUDANG, SIMPANG RIMBA, BANGKA SELATAN, KEPULAUAN BANGKA BELITUNG",2,113,105,218
https://kawalpemilu.org#25153,"GUDANG, SIMPANG RIMBA, BANGKA SELATAN, KEPULAUAN BANGKA BELITUNG",3,98,125,223
https://kawalpemilu.org#25153,"GUDANG, SIMPANG RIMBA, BANGKA SELATAN, KEPULAUAN BANGKA BELITUNG",4,111,111,222
https://kawalpemilu.org#25153,"GUDANG, SIMPANG RIMBA, BANGKA SELATAN, KEPULAUAN BANGKA BELITUNG",5,119,47,166
https://kawalpemilu.org#25154,"BANGKA KOTA, SIMPANG RIMBA, BANGKA SELATAN, KEPULAUAN BANGKA BELITUNG",1,167,87,254
https://kawalpemilu.org#25154,"BANGKA KOTA, SIMPANG RIMBA, BANGKA SELATAN, KEPULAUAN BANGKA BELITUNG",2,169,46,215
https://kawalpemilu.org#25154,"BANGKA KOTA, SIMPANG RIMBA, BANGKA SELATAN, KEPULAUAN BANGKA BELITUNG",3,171,69,240
https://kawalpemilu.org#25154,"BANGKA KOTA, SIMPANG RIMBA, BANGKA SELATAN, KEPULAUAN BANGKA BELITUNG",4,201,38,239
https://kawalpemilu.org#25154,"BANGKA KOTA, SIMPANG RIMBA, BANGKA SELATAN, KEPULAUAN BANGKA BELITUNG",5,210,48,258
https://kawalpemilu.org#25154,"BANGKA KOTA, SIMPANG RIMBA, BANGKA SELATAN, KEPULAUAN BANGKA BELITUNG",6,210,53,263
https://kawalpemilu.org#25154,"BANGKA KOTA, SIMPANG RIMBA, BANGKA SELATAN, KEPULAUAN BANGKA BELITUNG",7,197,39,236
https://kawalpemilu.org#25154,"BANGKA KOTA, SIMPANG RIMBA, BANGKA SELATAN, KEPULAUAN BANGKA BELITUNG",8,126,40,166
https://kawalpemilu.org#25154,"BANGKA KOTA, SIMPANG RIMBA, BANGKA SELATAN, KEPULAUAN BANGKA BELITUNG",9,132,43,175
https://kawalpemilu.org#25155,"RAJIK, SIMPANG RIMBA, BANGKA SELATAN, KEPULAUAN BANGKA BELITUNG",1,193,62,255
https://kawalpemilu.org#25155,"RAJIK, SIMPANG RIMBA, BANGKA SELATAN, KEPULAUAN BANGKA BELITUNG",2,182,48,230
https://kawalpemilu.org#25155,"RAJIK, SIMPANG RIMBA, BANGKA SELATAN, KEPULAUAN BANGKA BELITUNG",3,141,76,217
https://kawalpemilu.org#25155,"RAJIK, SIMPANG RIMBA, BANGKA SELATAN, KEPULAUAN BANGKA BELITUNG",4,206,65,271
https://kawalpemilu.org#25155,"RAJIK, SIMPANG RIMBA, BANGKA SELATAN, KEPULAUAN BANGKA BELITUNG",5,111,79,190
https://kawalpemilu.org#25155,"RAJIK, SIMPANG RIMBA, BANGKA SELATAN, KEPULAUAN BANGKA BELITUNG",6,131,106,237
https://kawalpemilu.org#25155,"RAJIK, SIMPANG RIMBA, BANGKA SELATAN, KEPULAUAN BANGKA BELITUNG",7,168,83,251
https://kawalpemilu.org#25155,"RAJIK, SIMPANG RIMBA, BANGKA SELATAN, KEPULAUAN BANGKA BELITUNG",8,195,46,241
https://kawalpemilu.org#25155,"RAJIK, SIMPANG RIMBA, BANGKA SELATAN, KEPULAUAN BANGKA BELITUNG",9,140,52,192
https://kawalpemilu.org#25155,"RAJIK, SIMPANG RIMBA, BANGKA SELATAN, KEPULAUAN BANGKA BELITUNG",10,93,42,135
https://kawalpemilu.org#25155,"RAJIK, SIMPANG RIMBA, BANGKA SELATAN, KEPULAUAN BANGKA BELITUNG",11,36,10,46
https://kawalpemilu.org#25156,"SEBAGIN, SIMPANG RIMBA, BANGKA SELATAN, KEPULAUAN BANGKA BELITUNG",1,169,46,215
https://kawalpemilu.org#25156,"SEBAGIN, SIMPANG RIMBA, BANGKA SELATAN, KEPULAUAN BANGKA BELITUNG",2,163,74,237
https://kawalpemilu.org#25156,"SEBAGIN, SIMPANG RIMBA, BANGKA SELATAN, KEPULAUAN BANGKA BELITUNG",3,115,70,185
https://kawalpemilu.org#25156,"SEBAGIN, SIMPANG RIMBA, BANGKA SELATAN, KEPULAUAN BANGKA BELITUNG",4,154,75,229
https://kawalpemilu.org#25156,"SEBAGIN, SIMPANG RIMBA, BANGKA SELATAN, KEPULAUAN BANGKA BELITUNG",5,184,71,255
https://kawalpemilu.org#25156,"SEBAGIN, SIMPANG RIMBA, BANGKA SELATAN, KEPULAUAN BANGKA BELITUNG",6,54,43,97
https://kawalpemilu.org#25157,"SIMPANG RIMBA, SIMPANG RIMBA, BANGKA SELATAN, KEPULAUAN BANGKA BELITUNG",1,197,40,237
https://kawalpemilu.org#25157,"SIMPANG RIMBA, SIMPANG RIMBA, BANGKA SELATAN, KEPULAUAN BANGKA BELITUNG",2,181,56,237
https://kawalpemilu.org#25157,"SIMPANG RIMBA, SIMPANG RIMBA, BANGKA SELATAN, KEPULAUAN BANGKA BELITUNG",3,237,15,252
https://kawalpemilu.org#25157,"SIMPANG RIMBA, SIMPANG RIMBA, BANGKA SELATAN, KEPULAUAN BANGKA BELITUNG",4,172,94,266
https://kawalpemilu.org#25157,"SIMPANG RIMBA, SIMPANG RIMBA, BANGKA SELATAN, KEPULAUAN BANGKA BELITUNG",5,153,53,206
https://kawalpemilu.org#25158,"PERMIS, SIMPANG RIMBA, BANGKA SELATAN, KEPULAUAN BANGKA BELITUNG",1,114,115,229
https://kawalpemilu.org#25158,"PERMIS, SIMPANG RIMBA, BANGKA SELATAN, KEPULAUAN BANGKA BELITUNG",2,148,64,212
https://kawalpemilu.org#25158,"PERMIS, SIMPANG RIMBA, BANGKA SELATAN, KEPULAUAN BANGKA BELITUNG",3,165,74,239
https://kawalpemilu.org#25158,"PERMIS, SIMPANG RIMBA, BANGKA SELATAN, KEPULAUAN BANGKA BELITUNG",5,136,86,222
https://kawalpemilu.org#25158,"PERMIS, SIMPANG RIMBA, BANGKA SELATAN, KEPULAUAN BANGKA BELITUNG",6,111,107,218
https://kawalpemilu.org#25158,"PERMIS, SIMPANG RIMBA, BANGKA SELATAN, KEPULAUAN BANGKA BELITUNG",7,122,127,249
https://kawalpemilu.org#25158,"PERMIS, SIMPANG RIMBA, BANGKA SELATAN, KEPULAUAN BANGKA BELITUNG",8,135,50,185
https://kawalpemilu.org#25158,"PERMIS, SIMPANG RIMBA, BANGKA SELATAN, KEPULAUAN BANGKA BELITUNG",9,86,73,159
https://kawalpemilu.org#25158,"PERMIS, SIMPANG RIMBA, BANGKA SELATAN, KEPULAUAN BANGKA BELITUNG",10,112,36,148
https://kawalpemilu.org#25158,"PERMIS, SIMPANG RIMBA, BANGKA SELATAN, KEPULAUAN BANGKA BELITUNG",11,143,76,219
https://kawalpemilu.org#25158,"PERMIS, SIMPANG RIMBA, BANGKA SELATAN, KEPULAUAN BANGKA BELITUNG",12,69,34,103
https://kawalpemilu.org#25160,"PAYUNG, PAYUNG, BANGKA SELATAN, KEPULAUAN BANGKA BELITUNG",1,168,107,275
https://kawalpemilu.org#25160,"PAYUNG, PAYUNG, BANGKA SELATAN, KEPULAUAN BANGKA BELITUNG",2,134,100,234
https://kawalpemilu.org#25160,"PAYUNG, PAYUNG, BANGKA SELATAN, KEPULAUAN BANGKA BELITUNG",3,119,132,251
https://kawalpemilu.org#25160,"PAYUNG, PAYUNG, BANGKA SELATAN, KEPULAUAN BANGKA BELITUNG",4,88,152,240
https://kawalpemilu.org#25160,"PAYUNG, PAYUNG, BANGKA SELATAN, KEPULAUAN BANGKA BELITUNG",5,135,80,215
https://kawalpemilu.org#25160,"PAYUNG, PAYUNG, BANGKA SELATAN, KEPULAUAN BANGKA BELITUNG",7,157,74,231
https://kawalpemilu.org#25160,"PAYUNG, PAYUNG, BANGKA SELATAN, KEPULAUAN BANGKA BELITUNG",8,97,54,151
https://kawalpemilu.org#25160,"PAYUNG, PAYUNG, BANGKA SELATAN, KEPULAUAN BANGKA BELITUNG",9,205,40,245
https://kawalpemilu.org#25160,"PAYUNG, PAYUNG, BANGKA SELATAN, KEPULAUAN BANGKA BELITUNG",10,94,102,196
https://kawalpemilu.org#25160,"PAYUNG, PAYUNG, BANGKA SELATAN, KEPULAUAN BANGKA BELITUNG",11,130,77,207
https://kawalpemilu.org#25160,"PAYUNG, PAYUNG, BANGKA SELATAN, KEPULAUAN BANGKA BELITUNG",12,100,31,131
https://kawalpemilu.org#25161,"MALIK, PAYUNG, BANGKA SELATAN, KEPULAUAN BANGKA BELITUNG",1,187,58,245
https://kawalpemilu.org#25161,"MALIK, PAYUNG, BANGKA SELATAN, KEPULAUAN BANGKA BELITUNG",2,158,70,228
https://kawalpemilu.org#25161,"MALIK, PAYUNG, BANGKA SELATAN, KEPULAUAN BANGKA BELITUNG",3,148,70,218
https://kawalpemilu.org#25161,"MALIK, PAYUNG, BANGKA SELATAN, KEPULAUAN BANGKA BELITUNG",4,104,48,152
https://kawalpemilu.org#25162,"SENGIR, PAYUNG, BANGKA SELATAN, KEPULAUAN BANGKA BELITUNG",1,95,144,239
https://kawalpemilu.org#25162,"SENGIR, PAYUNG, BANGKA SELATAN, KEPULAUAN BANGKA BELITUNG",2,71,165,236
https://kawalpemilu.org#25162,"SENGIR, PAYUNG, BANGKA SELATAN, KEPULAUAN BANGKA BELITUNG",3,70,151,221
https://kawalpemilu.org#25162,"SENGIR, PAYUNG, BANGKA SELATAN, KEPULAUAN BANGKA BELITUNG",4,68,137,205
https://kawalpemilu.org#25163,"PANGKAL BULUH, PAYUNG, BANGKA SELATAN, KEPULAUAN BANGKA BELITUNG",1,108,136,244
https://kawalpemilu.org#25163,"PANGKAL BULUH, PAYUNG, BANGKA SELATAN, KEPULAUAN BANGKA BELITUNG",2,94,163,257
https://kawalpemilu.org#25163,"PANGKAL BULUH, PAYUNG, BANGKA SELATAN, KEPULAUAN BANGKA BELITUNG",3,96,139,235
https://kawalpemilu.org#25163,"PANGKAL BULUH, PAYUNG, BANGKA SELATAN, KEPULAUAN BANGKA BELITUNG",4,104,107,211
https://kawalpemilu.org#25163,"PANGKAL BULUH, PAYUNG, BANGKA SELATAN, KEPULAUAN BANGKA BELITUNG",5,131,131,262
https://kawalpemilu.org#25163,"PANGKAL BULUH, PAYUNG, BANGKA SELATAN, KEPULAUAN BANGKA BELITUNG",6,107,159,266
https://kawalpemilu.org#25163,"PANGKAL BULUH, PAYUNG, BANGKA SELATAN, KEPULAUAN BANGKA BELITUNG",7,102,97,199
https://kawalpemilu.org#25164,"IRAT, PAYUNG, BANGKA SELATAN, KEPULAUAN BANGKA BELITUNG",1,122,75,197
https://kawalpemilu.org#25164,"IRAT, PAYUNG, BANGKA SELATAN, KEPULAUAN BANGKA BELITUNG",2,124,77,201
https://kawalpemilu.org#25164,"IRAT, PAYUNG, BANGKA SELATAN, KEPULAUAN BANGKA BELITUNG",3,128,113,241
https://kawalpemilu.org#25164,"IRAT, PAYUNG, BANGKA SELATAN, KEPULAUAN BANGKA BELITUNG",4,99,89,188
https://kawalpemilu.org#25165,"BEDENGUNG, PAYUNG, BANGKA SELATAN, KEPULAUAN BANGKA BELITUNG",1,94,115,209
https://kawalpemilu.org#25165,"BEDENGUNG, PAYUNG, BANGKA SELATAN, KEPULAUAN BANGKA BELITUNG",2,63,137,200
https://kawalpemilu.org#25165,"BEDENGUNG, PAYUNG, BANGKA SELATAN, KEPULAUAN BANGKA BELITUNG",3,39,169,208
https://kawalpemilu.org#25165,"BEDENGUNG, PAYUNG, BANGKA SELATAN, KEPULAUAN BANGKA BELITUNG",4,60,131,191
https://kawalpemilu.org#25165,"BEDENGUNG, PAYUNG, BANGKA SELATAN, KEPULAUAN BANGKA BELITUNG",5,104,118,222
https://kawalpemilu.org#25165,"BEDENGUNG, PAYUNG, BANGKA SELATAN, KEPULAUAN BANGKA BELITUNG",6,71,124,195
https://kawalpemilu.org#25165,"BEDENGUNG, PAYUNG, BANGKA SELATAN, KEPULAUAN BANGKA BELITUNG",7,72,139,211
https://kawalpemilu.org#25166,"NADUNG, PAYUNG, BANGKA SELATAN, KEPULAUAN BANGKA BELITUNG",1,131,69,200
https://kawalpemilu.org#25166,"NADUNG, PAYUNG, BANGKA SELATAN, KEPULAUAN BANGKA BELITUNG",2,78,106,184
https://kawalpemilu.org#25166,"NADUNG, PAYUNG, BANGKA SELATAN, KEPULAUAN BANGKA BELITUNG",3,96,118,214
https://kawalpemilu.org#25166,"NADUNG, PAYUNG, BANGKA SELATAN, KEPULAUAN BANGKA BELITUNG",4,131,54,185
https://kawalpemilu.org#25167,"RANGGUNG, PAYUNG, BANGKA SELATAN, KEPULAUAN BANGKA BELITUNG",1,105,98,203
https://kawalpemilu.org#25167,"RANGGUNG, PAYUNG, BANGKA SELATAN, KEPULAUAN BANGKA BELITUNG",2,132,76,208
https://kawalpemilu.org#25167,"RANGGUNG, PAYUNG, BANGKA SELATAN, KEPULAUAN BANGKA BELITUNG",3,111,109,220
https://kawalpemilu.org#25167,"RANGGUNG, PAYUNG, BANGKA SELATAN, KEPULAUAN BANGKA BELITUNG",4,115,119,234
https://kawalpemilu.org#25167,"RANGGUNG, PAYUNG, BANGKA SELATAN, KEPULAUAN BANGKA BELITUNG",5,112,103,215
https://kawalpemilu.org#25167,"RANGGUNG, PAYUNG, BANGKA SELATAN, KEPULAUAN BANGKA BELITUNG",6,119,68,8
https://kawalpemilu.org#25167,"RANGGUNG, PAYUNG, BANGKA SELATAN, KEPULAUAN BANGKA BELITUNG",7,112,107,219
https://kawalpemilu.org#25167,"RANGGUNG, PAYUNG, BANGKA SELATAN, KEPULAUAN BANGKA BELITUNG",8,83,83,166
https://kawalpemilu.org#25167,"RANGGUNG, PAYUNG, BANGKA SELATAN, KEPULAUAN BANGKA BELITUNG",9,98,70,168
https://kawalpemilu.org#25168,"PAKU, PAYUNG, BANGKA SELATAN, KEPULAUAN BANGKA BELITUNG",1,69,135,204
https://kawalpemilu.org#25168,"PAKU, PAYUNG, BANGKA SELATAN, KEPULAUAN BANGKA BELITUNG",2,71,118,189
https://kawalpemilu.org#25168,"PAKU, PAYUNG, BANGKA SELATAN, KEPULAUAN BANGKA BELITUNG",3,36,173,209
https://kawalpemilu.org#25168,"PAKU, PAYUNG, BANGKA SELATAN, KEPULAUAN BANGKA BELITUNG",4,146,74,220
https://kawalpemilu.org#25168,"PAKU, PAYUNG, BANGKA SELATAN, KEPULAUAN BANGKA BELITUNG",5,90,60,150
https://kawalpemilu.org#25168,"PAKU, PAYUNG, BANGKA SELATAN, KEPULAUAN BANGKA BELITUNG",6,56,105,161
https://kawalpemilu.org#25170,"SADAI, TUKAK SADAI, BANGKA SELATAN, KEPULAUAN BANGKA BELITUNG",1,121,77,198
https://kawalpemilu.org#25170,"SADAI, TUKAK SADAI, BANGKA SELATAN, KEPULAUAN BANGKA BELITUNG",2,151,56,207
https://kawalpemilu.org#25170,"SADAI, TUKAK SADAI, BANGKA SELATAN, KEPULAUAN BANGKA BELITUNG",3,111,59,170
https://kawalpemilu.org#25170,"SADAI, TUKAK SADAI, BANGKA SELATAN, KEPULAUAN BANGKA BELITUNG",4,118,71,189
https://kawalpemilu.org#25170,"SADAI, TUKAK SADAI, BANGKA SELATAN, KEPULAUAN BANGKA BELITUNG",5,179,59,238
https://kawalpemilu.org#25170,"SADAI, TUKAK SADAI, BANGKA SELATAN, KEPULAUAN BANGKA BELITUNG",6,132,62,194
https://kawalpemilu.org#25170,"SADAI, TUKAK SADAI, BANGKA SELATAN, KEPULAUAN BANGKA BELITUNG",7,100,45,145
https://kawalpemilu.org#25171,"TUKAK, TUKAK SADAI, BANGKA SELATAN, KEPULAUAN BANGKA BELITUNG",1,162,87,249
https://kawalpemilu.org#25171,"TUKAK, TUKAK SADAI, BANGKA SELATAN, KEPULAUAN BANGKA BELITUNG",2,128,97,225
https://kawalpemilu.org#25171,"TUKAK, TUKAK SADAI, BANGKA SELATAN, KEPULAUAN BANGKA BELITUNG",3,153,22,175
https://kawalpemilu.org#25172,"PASIR PUTIH, TUKAK SADAI, BANGKA SELATAN, KEPULAUAN BANGKA BELITUNG",1,158,63,221
https://kawalpemilu.org#25172,"PASIR PUTIH, TUKAK SADAI, BANGKA SELATAN, KEPULAUAN BANGKA BELITUNG",2,92,106,198
https://kawalpemilu.org#25172,"PASIR PUTIH, TUKAK SADAI, BANGKA SELATAN, KEPULAUAN BANGKA BELITUNG",4,88,50,138
https://kawalpemilu.org#25172,"PASIR PUTIH, TUKAK SADAI, BANGKA SELATAN, KEPULAUAN BANGKA BELITUNG",5,127,52,179
https://kawalpemilu.org#25172,"PASIR PUTIH, TUKAK SADAI, BANGKA SELATAN, KEPULAUAN BANGKA BELITUNG",6,168,52,220
https://kawalpemilu.org#25172,"PASIR PUTIH, TUKAK SADAI, BANGKA SELATAN, KEPULAUAN BANGKA BELITUNG",7,197,42,239
https://kawalpemilu.org#25172,"PASIR PUTIH, TUKAK SADAI, BANGKA SELATAN, KEPULAUAN BANGKA BELITUNG",8,203,45,248
https://kawalpemilu.org#25172,"PASIR PUTIH, TUKAK SADAI, BANGKA SELATAN, KEPULAUAN BANGKA BELITUNG",9,178,22,200
https://kawalpemilu.org#25172,"PASIR PUTIH, TUKAK SADAI, BANGKA SELATAN, KEPULAUAN BANGKA BELITUNG",10,145,34,179
https://kawalpemilu.org#25172,"PASIR PUTIH, TUKAK SADAI, BANGKA SELATAN, KEPULAUAN BANGKA BELITUNG",11,160,60,220
https://kawalpemilu.org#25173,"TIRAM, TUKAK SADAI, BANGKA SELATAN, KEPULAUAN BANGKA BELITUNG",1,205,34,239
https://kawalpemilu.org#25173,"TIRAM, TUKAK SADAI, BANGKA SELATAN, KEPULAUAN BANGKA BELITUNG",2,180,58,238
https://kawalpemilu.org#25173,"TIRAM, TUKAK SADAI, BANGKA SELATAN, KEPULAUAN BANGKA BELITUNG",3,120,68,188
https://kawalpemilu.org#25173,"TIRAM, TUKAK SADAI, BANGKA SELATAN, KEPULAUAN BANGKA BELITUNG",4,148,64,212
https://kawalpemilu.org#25173,"TIRAM, TUKAK SADAI, BANGKA SELATAN, KEPULAUAN BANGKA BELITUNG",5,94,55,149
https://kawalpemilu.org#25173,"TIRAM, TUKAK SADAI, BANGKA SELATAN, KEPULAUAN BANGKA BELITUNG",6,119,71,190
https://kawalpemilu.org#25174,"BUKIT TERAP, TUKAK SADAI, BANGKA SELATAN, KEPULAUAN BANGKA BELITUNG",1,76,120,196
https://kawalpemilu.org#25174,"BUKIT TERAP, TUKAK SADAI, BANGKA SELATAN, KEPULAUAN BANGKA BELITUNG",2,61,117,178
https://kawalpemilu.org#25174,"BUKIT TERAP, TUKAK SADAI, BANGKA SELATAN, KEPULAUAN BANGKA BELITUNG",3,170,77,247
https://kawalpemilu.org#25174,"BUKIT TERAP, TUKAK SADAI, BANGKA SELATAN, KEPULAUAN BANGKA BELITUNG",4,143,43,186
https://kawalpemilu.org#25174,"BUKIT TERAP, TUKAK SADAI, BANGKA SELATAN, KEPULAUAN BANGKA BELITUNG",5,114,53,167
https://kawalpemilu.org#25174,"BUKIT TERAP, TUKAK SADAI, BANGKA SELATAN, KEPULAUAN BANGKA BELITUNG",6,156,78,234
https://kawalpemilu.org#25174,"BUKIT TERAP, TUKAK SADAI, BANGKA SELATAN, KEPULAUAN BANGKA BELITUNG",7,113,44,157
https://kawalpemilu.org#25176,"BATU BETUMPANG, PULAU BESAR, BANGKA SELATAN, KEPULAUAN BANGKA BELITUNG",1,147,70,217
https://kawalpemilu.org#25176,"BATU BETUMPANG, PULAU BESAR, BANGKA SELATAN, KEPULAUAN BANGKA BELITUNG",2,142,73,215
https://kawalpemilu.org#25176,"BATU BETUMPANG, PULAU BESAR, BANGKA SELATAN, KEPULAUAN BANGKA BELITUNG",3,141,91,232
https://kawalpemilu.org#25176,"BATU BETUMPANG, PULAU BESAR, BANGKA SELATAN, KEPULAUAN BANGKA BELITUNG",4,112,61,173
https://kawalpemilu.org#25176,"BATU BETUMPANG, PULAU BESAR, BANGKA SELATAN, KEPULAUAN BANGKA BELITUNG",5,32,107,139
https://kawalpemilu.org#25176,"BATU BETUMPANG, PULAU BESAR, BANGKA SELATAN, KEPULAUAN BANGKA BELITUNG",6,82,98,180
https://kawalpemilu.org#25176,"BATU BETUMPANG, PULAU BESAR, BANGKA SELATAN, KEPULAUAN BANGKA BELITUNG",7,26,141,167
https://kawalpemilu.org#25176,"BATU BETUMPANG, PULAU BESAR, BANGKA SELATAN, KEPULAUAN BANGKA BELITUNG",8,200,44,244
https://kawalpemilu.org#25176,"BATU BETUMPANG, PULAU BESAR, BANGKA SELATAN, KEPULAUAN BANGKA BELITUNG",9,121,44,165
https://kawalpemilu.org#25176,"BATU BETUMPANG, PULAU BESAR, BANGKA SELATAN, KEPULAUAN BANGKA BELITUNG",10,77,57,134
https://kawalpemilu.org#25177,"SUKAJAYA, PULAU BESAR, BANGKA SELATAN, KEPULAUAN BANGKA BELITUNG",1,194,17,211
https://kawalpemilu.org#25177,"SUKAJAYA, PULAU BESAR, BANGKA SELATAN, KEPULAUAN BANGKA BELITUNG",2,140,64,204
https://kawalpemilu.org#25177,"SUKAJAYA, PULAU BESAR, BANGKA SELATAN, KEPULAUAN BANGKA BELITUNG",3,188,30,218
https://kawalpemilu.org#25178,"PANCA TUNGGAL, PULAU BESAR, BANGKA SELATAN, KEPULAUAN BANGKA BELITUNG",1,191,45,236
https://kawalpemilu.org#25178,"PANCA TUNGGAL, PULAU BESAR, BANGKA SELATAN, KEPULAUAN BANGKA BELITUNG",2,206,38,244
https://kawalpemilu.org#25178,"PANCA TUNGGAL, PULAU BESAR, BANGKA SELATAN, KEPULAUAN BANGKA BELITUNG",3,182,48,230
https://kawalpemilu.org#25179,"SUMBER JAYA PERMAI, PULAU BESAR, BANGKA SELATAN, KEPULAUAN BANGKA BELITUNG",1,184,32,216
https://kawalpemilu.org#25179,"SUMBER JAYA PERMAI, PULAU BESAR, BANGKA SELATAN, KEPULAUAN BANGKA BELITUNG",2,185,37,222
https://kawalpemilu.org#25179,"SUMBER JAYA PERMAI, PULAU BESAR, BANGKA SELATAN, KEPULAUAN BANGKA BELITUNG",3,164,28,192
https://kawalpemilu.org#25179,"SUMBER JAYA PERMAI, PULAU BESAR, BANGKA SELATAN, KEPULAUAN BANGKA BELITUNG",4,149,68,217
https://kawalpemilu.org#25179,"SUMBER JAYA PERMAI, PULAU BESAR, BANGKA SELATAN, KEPULAUAN BANGKA BELITUNG",5,131,37,168
https://kawalpemilu.org#25180,"FAJAR INDAH, PULAU BESAR, BANGKA SELATAN, KEPULAUAN BANGKA BELITUNG",1,179,54,233
https://kawalpemilu.org#25180,"FAJAR INDAH, PULAU BESAR, BANGKA SELATAN, KEPULAUAN BANGKA BELITUNG",2,172,57,229
https://kawalpemilu.org#25180,"FAJAR INDAH, PULAU BESAR, BANGKA SELATAN, KEPULAUAN BANGKA BELITUNG",3,177,49,226
https://kawalpemilu.org#25180,"FAJAR INDAH, PULAU BESAR, BANGKA SELATAN, KEPULAUAN BANGKA BELITUNG",4,167,77,244
https://kawalpemilu.org#25180,"FAJAR INDAH, PULAU BESAR, BANGKA SELATAN, KEPULAUAN BANGKA BELITUNG",5,199,38,237
https://kawalpemilu.org#25180,"FAJAR INDAH, PULAU BESAR, BANGKA SELATAN, KEPULAUAN BANGKA BELITUNG",6,145,35,180
https://kawalpemilu.org#25136,"PONGOK, KEPULAUAN PONGOK, BANGKA SELATAN, KEPULAUAN BANGKA BELITUNG",1,136,31,167
https://kawalpemilu.org#25136,"PONGOK, KEPULAUAN PONGOK, BANGKA SELATAN, KEPULAUAN BANGKA BELITUNG",2,139,46,185
https://kawalpemilu.org#25136,"PONGOK, KEPULAUAN PONGOK, BANGKA SELATAN, KEPULAUAN BANGKA BELITUNG",3,184,31,215
https://kawalpemilu.org#25136,"PONGOK, KEPULAUAN PONGOK, BANGKA SELATAN, KEPULAUAN BANGKA BELITUNG",4,175,31,206
https://kawalpemilu.org#25136,"PONGOK, KEPULAUAN PONGOK, BANGKA SELATAN, KEPULAUAN BANGKA BELITUNG",5,166,23,189
https://kawalpemilu.org#25136,"PONGOK, KEPULAUAN PONGOK, BANGKA SELATAN, KEPULAUAN BANGKA BELITUNG",6,133,27,160
https://kawalpemilu.org#25136,"PONGOK, KEPULAUAN PONGOK, BANGKA SELATAN, KEPULAUAN BANGKA BELITUNG",7,184,32,216
https://kawalpemilu.org#25136,"PONGOK, KEPULAUAN PONGOK, BANGKA SELATAN, KEPULAUAN BANGKA BELITUNG",8,187,36,223
https://kawalpemilu.org#25136,"PONGOK, KEPULAUAN PONGOK, BANGKA SELATAN, KEPULAUAN BANGKA BELITUNG",9,73,18,91
https://kawalpemilu.org#25136,"PONGOK, KEPULAUAN PONGOK, BANGKA SELATAN, KEPULAUAN BANGKA BELITUNG",10,43,20,63
https://kawalpemilu.org#25139,"CELAGEN, KEPULAUAN PONGOK, BANGKA SELATAN, KEPULAUAN BANGKA BELITUNG",1,211,35,246
https://kawalpemilu.org#25139,"CELAGEN, KEPULAUAN PONGOK, BANGKA SELATAN, KEPULAUAN BANGKA BELITUNG",2,193,37,230
https://kawalpemilu.org#25139,"CELAGEN, KEPULAUAN PONGOK, BANGKA SELATAN, KEPULAUAN BANGKA BELITUNG",3,216,43,259
https://kawalpemilu.org#25183,"KOBA, KOBA, BANGKA TENGAH, KEPULAUAN BANGKA BELITUNG",1,137,85,222
https://kawalpemilu.org#25183,"KOBA, KOBA, BANGKA TENGAH, KEPULAUAN BANGKA BELITUNG",2,108,123,231
https://kawalpemilu.org#25183,"KOBA, KOBA, BANGKA TENGAH, KEPULAUAN BANGKA BELITUNG",3,94,138,232
https://kawalpemilu.org#25183,"KOBA, KOBA, BANGKA TENGAH, KEPULAUAN BANGKA BELITUNG",4,117,136,253
https://kawalpemilu.org#25183,"KOBA, KOBA, BANGKA TENGAH, KEPULAUAN BANGKA BELITUNG",5,113,126,249
https://kawalpemilu.org#25183,"KOBA, KOBA, BANGKA TENGAH, KEPULAUAN BANGKA BELITUNG",6,152,95,247
https://kawalpemilu.org#25183,"KOBA, KOBA, BANGKA TENGAH, KEPULAUAN BANGKA BELITUNG",7,176,8,184
https://kawalpemilu.org#25183,"KOBA, KOBA, BANGKA TENGAH, KEPULAUAN BANGKA BELITUNG",8,171,7,178
https://kawalpemilu.org#25183,"KOBA, KOBA, BANGKA TENGAH, KEPULAUAN BANGKA BELITUNG",9,197,8,205
https://kawalpemilu.org#25183,"KOBA, KOBA, BANGKA TENGAH, KEPULAUAN BANGKA BELITUNG",10,176,18,194
https://kawalpemilu.org#25183,"KOBA, KOBA, BANGKA TENGAH, KEPULAUAN BANGKA BELITUNG",11,168,2,170
https://kawalpemilu.org#25183,"KOBA, KOBA, BANGKA TENGAH, KEPULAUAN BANGKA BELITUNG",12,163,112,3
https://kawalpemilu.org#25183,"KOBA, KOBA, BANGKA TENGAH, KEPULAUAN BANGKA BELITUNG",13,145,41,186
https://kawalpemilu.org#25183,"KOBA, KOBA, BANGKA TENGAH, KEPULAUAN BANGKA BELITUNG",14,152,25,177
https://kawalpemilu.org#25183,"KOBA, KOBA, BANGKA TENGAH, KEPULAUAN BANGKA BELITUNG",15,236,6,242
https://kawalpemilu.org#25183,"KOBA, KOBA, BANGKA TENGAH, KEPULAUAN BANGKA BELITUNG",16,149,12,161
https://kawalpemilu.org#25183,"KOBA, KOBA, BANGKA TENGAH, KEPULAUAN BANGKA BELITUNG",17,57,36,93
https://kawalpemilu.org#25184,"ARUNG DALAM, KOBA, BANGKA TENGAH, KEPULAUAN BANGKA BELITUNG",1,118,162,280
https://kawalpemilu.org#25184,"ARUNG DALAM, KOBA, BANGKA TENGAH, KEPULAUAN BANGKA BELITUNG",2,98,156,254
https://kawalpemilu.org#25184,"ARUNG DALAM, KOBA, BANGKA TENGAH, KEPULAUAN BANGKA BELITUNG",3,98,158,257
https://kawalpemilu.org#25184,"ARUNG DALAM, KOBA, BANGKA TENGAH, KEPULAUAN BANGKA BELITUNG",4,98,136,234
https://kawalpemilu.org#25184,"ARUNG DALAM, KOBA, BANGKA TENGAH, KEPULAUAN BANGKA BELITUNG",5,88,145,233
https://kawalpemilu.org#25184,"ARUNG DALAM, KOBA, BANGKA TENGAH, KEPULAUAN BANGKA BELITUNG",6,92,169,261
https://kawalpemilu.org#25184,"ARUNG DALAM, KOBA, BANGKA TENGAH, KEPULAUAN BANGKA BELITUNG",7,93,138,231
https://kawalpemilu.org#25184,"ARUNG DALAM, KOBA, BANGKA TENGAH, KEPULAUAN BANGKA BELITUNG",8,109,135,244
https://kawalpemilu.org#25185,"BEROK, KOBA, BANGKA TENGAH, KEPULAUAN BANGKA BELITUNG",1,102,100,202
https://kawalpemilu.org#25185,"BEROK, KOBA, BANGKA TENGAH, KEPULAUAN BANGKA BELITUNG",2,85,152,237
https://kawalpemilu.org#25185,"BEROK, KOBA, BANGKA TENGAH, KEPULAUAN BANGKA BELITUNG",3,133,147,280
https://kawalpemilu.org#25185,"BEROK, KOBA, BANGKA TENGAH, KEPULAUAN BANGKA BELITUNG",4,96,148,244
https://kawalpemilu.org#25185,"BEROK, KOBA, BANGKA TENGAH, KEPULAUAN BANGKA BELITUNG",5,110,151,261
https://kawalpemilu.org#25185,"BEROK, KOBA, BANGKA TENGAH, KEPULAUAN BANGKA BELITUNG",6,95,191,286
https://kawalpemilu.org#25186,"PADANG MULIA, KOBA, BANGKA TENGAH, KEPULAUAN BANGKA BELITUNG",1,107,131,238
https://kawalpemilu.org#25186,"PADANG MULIA, KOBA, BANGKA TENGAH, KEPULAUAN BANGKA BELITUNG",2,110,63,173
https://kawalpemilu.org#25186,"PADANG MULIA, KOBA, BANGKA TENGAH, KEPULAUAN BANGKA BELITUNG",3,123,121,244
https://kawalpemilu.org#25186,"PADANG MULIA, KOBA, BANGKA TENGAH, KEPULAUAN BANGKA BELITUNG",4,135,98,233
https://kawalpemilu.org#25186,"PADANG MULIA, KOBA, BANGKA TENGAH, KEPULAUAN BANGKA BELITUNG",5,142,95,237
https://kawalpemilu.org#25186,"PADANG MULIA, KOBA, BANGKA TENGAH, KEPULAUAN BANGKA BELITUNG",6,90,92,182
https://kawalpemilu.org#25186,"PADANG MULIA, KOBA, BANGKA TENGAH, KEPULAUAN BANGKA BELITUNG",7,148,77,225
https://kawalpemilu.org#25186,"PADANG MULIA, KOBA, BANGKA TENGAH, KEPULAUAN BANGKA BELITUNG",8,148,66,214
https://kawalpemilu.org#25186,"PADANG MULIA, KOBA, BANGKA TENGAH, KEPULAUAN BANGKA BELITUNG",9,206,55,261
https://kawalpemilu.org#25186,"PADANG MULIA, KOBA, BANGKA TENGAH, KEPULAUAN BANGKA BELITUNG",10,134,118,252
https://kawalpemilu.org#25186,"PADANG MULIA, KOBA, BANGKA TENGAH, KEPULAUAN BANGKA BELITUNG",11,134,82,216
https://kawalpemilu.org#25187,"SIMPANG PERLANG, KOBA, BANGKA TENGAH, KEPULAUAN BANGKA BELITUNG",1,142,102,244
https://kawalpemilu.org#25187,"SIMPANG PERLANG, KOBA, BANGKA TENGAH, KEPULAUAN BANGKA BELITUNG",2,223,19,242
https://kawalpemilu.org#25187,"SIMPANG PERLANG, KOBA, BANGKA TENGAH, KEPULAUAN BANGKA BELITUNG",3,125,86,211
https://kawalpemilu.org#25187,"SIMPANG PERLANG, KOBA, BANGKA TENGAH, KEPULAUAN BANGKA BELITUNG",4,106,100,206
https://kawalpemilu.org#25187,"SIMPANG PERLANG, KOBA, BANGKA TENGAH, KEPULAUAN BANGKA BELITUNG",5,165,62,227
https://kawalpemilu.org#25187,"SIMPANG PERLANG, KOBA, BANGKA TENGAH, KEPULAUAN BANGKA BELITUNG",6,178,88,266
https://kawalpemilu.org#25187,"SIMPANG PERLANG, KOBA, BANGKA TENGAH, KEPULAUAN BANGKA BELITUNG",7,109,102,211
https://kawalpemilu.org#25187,"SIMPANG PERLANG, KOBA, BANGKA TENGAH, KEPULAUAN BANGKA BELITUNG",8,207,70,277
https://kawalpemilu.org#25187,"SIMPANG PERLANG, KOBA, BANGKA TENGAH, KEPULAUAN BANGKA BELITUNG",9,192,47,239
https://kawalpemilu.org#25187,"SIMPANG PERLANG, KOBA, BANGKA TENGAH, KEPULAUAN BANGKA BELITUNG",10,147,84,231
https://kawalpemilu.org#25187,"SIMPANG PERLANG, KOBA, BANGKA TENGAH, KEPULAUAN BANGKA BELITUNG",11,150,50,200
https://kawalpemilu.org#25187,"SIMPANG PERLANG, KOBA, BANGKA TENGAH, KEPULAUAN BANGKA BELITUNG",12,188,46,234
https://kawalpemilu.org#25188,"NIBUNG, KOBA, BANGKA TENGAH, KEPULAUAN BANGKA BELITUNG",1,127,104,231
https://kawalpemilu.org#25188,"NIBUNG, KOBA, BANGKA TENGAH, KEPULAUAN BANGKA BELITUNG",2,89,104,193
https://kawalpemilu.org#25188,"NIBUNG, KOBA, BANGKA TENGAH, KEPULAUAN BANGKA BELITUNG",3,63,119,182
https://kawalpemilu.org#25188,"NIBUNG, KOBA, BANGKA TENGAH, KEPULAUAN BANGKA BELITUNG",4,54,140,194
https://kawalpemilu.org#25188,"NIBUNG, KOBA, BANGKA TENGAH, KEPULAUAN BANGKA BELITUNG",5,84,176,260
https://kawalpemilu.org#25188,"NIBUNG, KOBA, BANGKA TENGAH, KEPULAUAN BANGKA BELITUNG",6,103,141,244
https://kawalpemilu.org#25188,"NIBUNG, KOBA, BANGKA TENGAH, KEPULAUAN BANGKA BELITUNG",7,93,147,242
https://kawalpemilu.org#25188,"NIBUNG, KOBA, BANGKA TENGAH, KEPULAUAN BANGKA BELITUNG",8,177,88,265
https://kawalpemilu.org#25188,"NIBUNG, KOBA, BANGKA TENGAH, KEPULAUAN BANGKA BELITUNG",9,136,27,163
https://kawalpemilu.org#25188,"NIBUNG, KOBA, BANGKA TENGAH, KEPULAUAN BANGKA BELITUNG",10,157,78,235
https://kawalpemilu.org#25188,"NIBUNG, KOBA, BANGKA TENGAH, KEPULAUAN BANGKA BELITUNG",11,145,77,222
https://kawalpemilu.org#25188,"NIBUNG, KOBA, BANGKA TENGAH, KEPULAUAN BANGKA BELITUNG",12,138,80,218
https://kawalpemilu.org#25189,"KURAU  (TIMUR), KOBA, BANGKA TENGAH, KEPULAUAN BANGKA BELITUNG",1,115,96,211
https://kawalpemilu.org#25189,"KURAU  (TIMUR), KOBA, BANGKA TENGAH, KEPULAUAN BANGKA BELITUNG",2,126,106,232
https://kawalpemilu.org#25189,"KURAU  (TIMUR), KOBA, BANGKA TENGAH, KEPULAUAN BANGKA BELITUNG",3,140,91,231
https://kawalpemilu.org#25189,"KURAU  (TIMUR), KOBA, BANGKA TENGAH, KEPULAUAN BANGKA BELITUNG",4,121,111,232
https://kawalpemilu.org#25189,"KURAU  (TIMUR), KOBA, BANGKA TENGAH, KEPULAUAN BANGKA BELITUNG",5,128,95,223
https://kawalpemilu.org#25189,"KURAU  (TIMUR), KOBA, BANGKA TENGAH, KEPULAUAN BANGKA BELITUNG",6,128,125,253
https://kawalpemilu.org#25189,"KURAU  (TIMUR), KOBA, BANGKA TENGAH, KEPULAUAN BANGKA BELITUNG",7,183,80,263
https://kawalpemilu.org#25189,"KURAU  (TIMUR), KOBA, BANGKA TENGAH, KEPULAUAN BANGKA BELITUNG",8,39,51,90
https://kawalpemilu.org#25190,"GUNTUNG, KOBA, BANGKA TENGAH, KEPULAUAN BANGKA BELITUNG",1,71,132,203
https://kawalpemilu.org#25190,"GUNTUNG, KOBA, BANGKA TENGAH, KEPULAUAN BANGKA BELITUNG",2,69,129,198
https://kawalpemilu.org#25190,"GUNTUNG, KOBA, BANGKA TENGAH, KEPULAUAN BANGKA BELITUNG",3,65,44,109
https://kawalpemilu.org#25190,"GUNTUNG, KOBA, BANGKA TENGAH, KEPULAUAN BANGKA BELITUNG",4,78,129,207
https://kawalpemilu.org#25191,"PENYAK, KOBA, BANGKA TENGAH, KEPULAUAN BANGKA BELITUNG",1,97,91,188
https://kawalpemilu.org#25191,"PENYAK, KOBA, BANGKA TENGAH, KEPULAUAN BANGKA BELITUNG",2,119,100,219
https://kawalpemilu.org#25191,"PENYAK, KOBA, BANGKA TENGAH, KEPULAUAN BANGKA BELITUNG",3,141,103,244
https://kawalpemilu.org#25191,"PENYAK, KOBA, BANGKA TENGAH, KEPULAUAN BANGKA BELITUNG",4,119,102,221
https://kawalpemilu.org#25191,"PENYAK, KOBA, BANGKA TENGAH, KEPULAUAN BANGKA BELITUNG",5,133,113,246
https://kawalpemilu.org#25191,"PENYAK, KOBA, BANGKA TENGAH, KEPULAUAN BANGKA BELITUNG",6,137,71,208
https://kawalpemilu.org#25191,"PENYAK, KOBA, BANGKA TENGAH, KEPULAUAN BANGKA BELITUNG",8,85,113,198
https://kawalpemilu.org#25191,"PENYAK, KOBA, BANGKA TENGAH, KEPULAUAN BANGKA BELITUNG",9,153,83,236
https://kawalpemilu.org#25191,"PENYAK, KOBA, BANGKA TENGAH, KEPULAUAN BANGKA BELITUNG",11,107,71,178
https://kawalpemilu.org#25192,"TERENTANG III, KOBA, BANGKA TENGAH, KEPULAUAN BANGKA BELITUNG",1,154,94,248
https://kawalpemilu.org#25192,"TERENTANG III, KOBA, BANGKA TENGAH, KEPULAUAN BANGKA BELITUNG",2,96,126,222
https://kawalpemilu.org#25192,"TERENTANG III, KOBA, BANGKA TENGAH, KEPULAUAN BANGKA BELITUNG",3,87,106,193
https://kawalpemilu.org#25192,"TERENTANG III, KOBA, BANGKA TENGAH, KEPULAUAN BANGKA BELITUNG",4,146,128,274
https://kawalpemilu.org#25193,"KURAU BARAT, KOBA, BANGKA TENGAH, KEPULAUAN BANGKA BELITUNG",1,152,76,228
https://kawalpemilu.org#25193,"KURAU BARAT, KOBA, BANGKA TENGAH, KEPULAUAN BANGKA BELITUNG",2,195,44,239
https://kawalpemilu.org#25193,"KURAU BARAT, KOBA, BANGKA TENGAH, KEPULAUAN BANGKA BELITUNG",3,207,56,263
https://kawalpemilu.org#25193,"KURAU BARAT, KOBA, BANGKA TENGAH, KEPULAUAN BANGKA BELITUNG",4,141,120,261
https://kawalpemilu.org#25193,"KURAU BARAT, KOBA, BANGKA TENGAH, KEPULAUAN BANGKA BELITUNG",5,138,85,223
https://kawalpemilu.org#25195,"DUL, PANGKALAN BARU, BANGKA TENGAH, KEPULAUAN BANGKA BELITUNG",1,82,148,230
https://kawalpemilu.org#25195,"DUL, PANGKALAN BARU, BANGKA TENGAH, KEPULAUAN BANGKA BELITUNG",2,40,155,195
https://kawalpemilu.org#25195,"DUL, PANGKALAN BARU, BANGKA TENGAH, KEPULAUAN BANGKA BELITUNG",3,70,182,252
https://kawalpemilu.org#25195,"DUL, PANGKALAN BARU, BANGKA TENGAH, KEPULAUAN BANGKA BELITUNG",4,81,142,223
https://kawalpemilu.org#25195,"DUL, PANGKALAN BARU, BANGKA TENGAH, KEPULAUAN BANGKA BELITUNG",5,74,134,208
https://kawalpemilu.org#25195,"DUL, PANGKALAN BARU, BANGKA TENGAH, KEPULAUAN BANGKA BELITUNG",6,82,127,209
https://kawalpemilu.org#25195,"DUL, PANGKALAN BARU, BANGKA TENGAH, KEPULAUAN BANGKA BELITUNG",7,161,8,169
https://kawalpemilu.org#25195,"DUL, PANGKALAN BARU, BANGKA TENGAH, KEPULAUAN BANGKA BELITUNG",8,199,17,216
https://kawalpemilu.org#25195,"DUL, PANGKALAN BARU, BANGKA TENGAH, KEPULAUAN BANGKA BELITUNG",9,118,22,140
https://kawalpemilu.org#25195,"DUL, PANGKALAN BARU, BANGKA TENGAH, KEPULAUAN BANGKA BELITUNG",10,104,96,200
https://kawalpemilu.org#25195,"DUL, PANGKALAN BARU, BANGKA TENGAH, KEPULAUAN BANGKA BELITUNG",11,86,173,259
https://kawalpemilu.org#25195,"DUL, PANGKALAN BARU, BANGKA TENGAH, KEPULAUAN BANGKA BELITUNG",12,64,141,205
https://kawalpemilu.org#25195,"DUL, PANGKALAN BARU, BANGKA TENGAH, KEPULAUAN BANGKA BELITUNG",13,65,123,188
https://kawalpemilu.org#25195,"DUL, PANGKALAN BARU, BANGKA TENGAH, KEPULAUAN BANGKA BELITUNG",14,52,111,6
https://kawalpemilu.org#25195,"DUL, PANGKALAN BARU, BANGKA TENGAH, KEPULAUAN BANGKA BELITUNG",15,103,121,224
https://kawalpemilu.org#25195,"DUL, PANGKALAN BARU, BANGKA TENGAH, KEPULAUAN BANGKA BELITUNG",16,68,74,142
https://kawalpemilu.org#25195,"DUL, PANGKALAN BARU, BANGKA TENGAH, KEPULAUAN BANGKA BELITUNG",17,140,54,194
https://kawalpemilu.org#25195,"DUL, PANGKALAN BARU, BANGKA TENGAH, KEPULAUAN BANGKA BELITUNG",18,100,134,234
https://kawalpemilu.org#25196,"AIR MESU, PANGKALAN BARU, BANGKA TENGAH, KEPULAUAN BANGKA BELITUNG",1,98,146,244
https://kawalpemilu.org#25196,"AIR MESU, PANGKALAN BARU, BANGKA TENGAH, KEPULAUAN BANGKA BELITUNG",2,81,138,219
https://kawalpemilu.org#25196,"AIR MESU, PANGKALAN BARU, BANGKA TENGAH, KEPULAUAN BANGKA BELITUNG",3,87,143,230
https://kawalpemilu.org#25196,"AIR MESU, PANGKALAN BARU, BANGKA TENGAH, KEPULAUAN BANGKA BELITUNG",4,72,97,169
https://kawalpemilu.org#25196,"AIR MESU, PANGKALAN BARU, BANGKA TENGAH, KEPULAUAN BANGKA BELITUNG",5,103,114,217
https://kawalpemilu.org#25196,"AIR MESU, PANGKALAN BARU, BANGKA TENGAH, KEPULAUAN BANGKA BELITUNG",6,98,114,212
https://kawalpemilu.org#25196,"AIR MESU, PANGKALAN BARU, BANGKA TENGAH, KEPULAUAN BANGKA BELITUNG",7,98,154,252
https://kawalpemilu.org#25196,"AIR MESU, PANGKALAN BARU, BANGKA TENGAH, KEPULAUAN BANGKA BELITUNG",8,76,95,171
https://kawalpemilu.org#25197,"MANGKOL, PANGKALAN BARU, BANGKA TENGAH, KEPULAUAN BANGKA BELITUNG",1,112,83,195
https://kawalpemilu.org#25197,"MANGKOL, PANGKALAN BARU, BANGKA TENGAH, KEPULAUAN BANGKA BELITUNG",2,99,74,173
https://kawalpemilu.org#25197,"MANGKOL, PANGKALAN BARU, BANGKA TENGAH, KEPULAUAN BANGKA BELITUNG",3,115,65,180
https://kawalpemilu.org#25197,"MANGKOL, PANGKALAN BARU, BANGKA TENGAH, KEPULAUAN BANGKA BELITUNG",4,133,8,141
https://kawalpemilu.org#25197,"MANGKOL, PANGKALAN BARU, BANGKA TENGAH, KEPULAUAN BANGKA BELITUNG",5,123,32,155
https://kawalpemilu.org#25197,"MANGKOL, PANGKALAN BARU, BANGKA TENGAH, KEPULAUAN BANGKA BELITUNG",6,222,15,237
https://kawalpemilu.org#25197,"MANGKOL, PANGKALAN BARU, BANGKA TENGAH, KEPULAUAN BANGKA BELITUNG",7,107,55,162
https://kawalpemilu.org#25197,"MANGKOL, PANGKALAN BARU, BANGKA TENGAH, KEPULAUAN BANGKA BELITUNG",8,125,15,140
https://kawalpemilu.org#25197,"MANGKOL, PANGKALAN BARU, BANGKA TENGAH, KEPULAUAN BANGKA BELITUNG",9,96,48,144
https://kawalpemilu.org#25197,"MANGKOL, PANGKALAN BARU, BANGKA TENGAH, KEPULAUAN BANGKA BELITUNG",10,154,23,177
https://kawalpemilu.org#25197,"MANGKOL, PANGKALAN BARU, BANGKA TENGAH, KEPULAUAN BANGKA BELITUNG",11,125,51,176
https://kawalpemilu.org#25197,"MANGKOL, PANGKALAN BARU, BANGKA TENGAH, KEPULAUAN BANGKA BELITUNG",12,133,54,187
https://kawalpemilu.org#25197,"MANGKOL, PANGKALAN BARU, BANGKA TENGAH, KEPULAUAN BANGKA BELITUNG",13,129,2,131
https://kawalpemilu.org#25198,"TANJUNG GUNUNG, PANGKALAN BARU, BANGKA TENGAH, KEPULAUAN BANGKA BELITUNG",1,178,30,208
https://kawalpemilu.org#25198,"TANJUNG GUNUNG, PANGKALAN BARU, BANGKA TENGAH, KEPULAUAN BANGKA BELITUNG",2,199,24,223
https://kawalpemilu.org#25198,"TANJUNG GUNUNG, PANGKALAN BARU, BANGKA TENGAH, KEPULAUAN BANGKA BELITUNG",3,182,50,232
https://kawalpemilu.org#25198,"TANJUNG GUNUNG, PANGKALAN BARU, BANGKA TENGAH, KEPULAUAN BANGKA BELITUNG",4,180,80,260
https://kawalpemilu.org#25198,"TANJUNG GUNUNG, PANGKALAN BARU, BANGKA TENGAH, KEPULAUAN BANGKA BELITUNG",5,185,39,224
https://kawalpemilu.org#25198,"TANJUNG GUNUNG, PANGKALAN BARU, BANGKA TENGAH, KEPULAUAN BANGKA BELITUNG",6,182,42,225
https://kawalpemilu.org#25198,"TANJUNG GUNUNG, PANGKALAN BARU, BANGKA TENGAH, KEPULAUAN BANGKA BELITUNG",7,192,35,227
https://kawalpemilu.org#25198,"TANJUNG GUNUNG, PANGKALAN BARU, BANGKA TENGAH, KEPULAUAN BANGKA BELITUNG",8,184,59,243
https://kawalpemilu.org#25198,"TANJUNG GUNUNG, PANGKALAN BARU, BANGKA TENGAH, KEPULAUAN BANGKA BELITUNG",9,151,115,266
https://kawalpemilu.org#25199,"BENTENG, PANGKALAN BARU, BANGKA TENGAH, KEPULAUAN BANGKA BELITUNG",1,228,3,231
https://kawalpemilu.org#25199,"BENTENG, PANGKALAN BARU, BANGKA TENGAH, KEPULAUAN BANGKA BELITUNG",2,220,8,228
https://kawalpemilu.org#25199,"BENTENG, PANGKALAN BARU, BANGKA TENGAH, KEPULAUAN BANGKA BELITUNG",3,223,5,228
https://kawalpemilu.org#25199,"BENTENG, PANGKALAN BARU, BANGKA TENGAH, KEPULAUAN BANGKA BELITUNG",4,231,2,233
https://kawalpemilu.org#25199,"BENTENG, PANGKALAN BARU, BANGKA TENGAH, KEPULAUAN BANGKA BELITUNG",5,221,5,226
https://kawalpemilu.org#25199,"BENTENG, PANGKALAN BARU, BANGKA TENGAH, KEPULAUAN BANGKA BELITUNG",6,213,3,216
https://kawalpemilu.org#25199,"BENTENG, PANGKALAN BARU, BANGKA TENGAH, KEPULAUAN BANGKA BELITUNG",7,204,2,206
https://kawalpemilu.org#25200,"PADANG BARU, PANGKALAN BARU, BANGKA TENGAH, KEPULAUAN BANGKA BELITUNG",1,109,137,246
https://kawalpemilu.org#25200,"PADANG BARU, PANGKALAN BARU, BANGKA TENGAH, KEPULAUAN BANGKA BELITUNG",2,141,88,229
https://kawalpemilu.org#25200,"PADANG BARU, PANGKALAN BARU, BANGKA TENGAH, KEPULAUAN BANGKA BELITUNG",3,208,9,217
https://kawalpemilu.org#25200,"PADANG BARU, PANGKALAN BARU, BANGKA TENGAH, KEPULAUAN BANGKA BELITUNG",4,203,6,209
https://kawalpemilu.org#25200,"PADANG BARU, PANGKALAN BARU, BANGKA TENGAH, KEPULAUAN BANGKA BELITUNG",5,118,110,228
https://kawalpemilu.org#25200,"PADANG BARU, PANGKALAN BARU, BANGKA TENGAH, KEPULAUAN BANGKA BELITUNG",6,124,136,260
https://kawalpemilu.org#25201,"JERUK, PANGKALAN BARU, BANGKA TENGAH, KEPULAUAN BANGKA BELITUNG",1,216,35,251
https://kawalpemilu.org#25201,"JERUK, PANGKALAN BARU, BANGKA TENGAH, KEPULAUAN BANGKA BELITUNG",2,197,6,203
https://kawalpemilu.org#25201,"JERUK, PANGKALAN BARU, BANGKA TENGAH, KEPULAUAN BANGKA BELITUNG",3,224,6,230
https://kawalpemilu.org#25201,"JERUK, PANGKALAN BARU, BANGKA TENGAH, KEPULAUAN BANGKA BELITUNG",4,218,12,230
https://kawalpemilu.org#25201,"JERUK, PANGKALAN BARU, BANGKA TENGAH, KEPULAUAN BANGKA BELITUNG",5,198,38,236
https://kawalpemilu.org#25201,"JERUK, PANGKALAN BARU, BANGKA TENGAH, KEPULAUAN BANGKA BELITUNG",6,188,26,214
https://kawalpemilu.org#25202,"BELULUK, PANGKALAN BARU, BANGKA TENGAH, KEPULAUAN BANGKA BELITUNG",1,202,11,213
https://kawalpemilu.org#25202,"BELULUK, PANGKALAN BARU, BANGKA TENGAH, KEPULAUAN BANGKA BELITUNG",2,122,124,246
https://kawalpemilu.org#25202,"BELULUK, PANGKALAN BARU, BANGKA TENGAH, KEPULAUAN BANGKA BELITUNG",3,139,90,229
https://kawalpemilu.org#25202,"BELULUK, PANGKALAN BARU, BANGKA TENGAH, KEPULAUAN BANGKA BELITUNG",4,160,82,142
https://kawalpemilu.org#25202,"BELULUK, PANGKALAN BARU, BANGKA TENGAH, KEPULAUAN BANGKA BELITUNG",5,135,86,221
https://kawalpemilu.org#25202,"BELULUK, PANGKALAN BARU, BANGKA TENGAH, KEPULAUAN BANGKA BELITUNG",6,228,4,232
https://kawalpemilu.org#25202,"BELULUK, PANGKALAN BARU, BANGKA TENGAH, KEPULAUAN BANGKA BELITUNG",7,190,12,202
https://kawalpemilu.org#25202,"BELULUK, PANGKALAN BARU, BANGKA TENGAH, KEPULAUAN BANGKA BELITUNG",8,243,3,246
https://kawalpemilu.org#25202,"BELULUK, PANGKALAN BARU, BANGKA TENGAH, KEPULAUAN BANGKA BELITUNG",9,131,98,229
https://kawalpemilu.org#25202,"BELULUK, PANGKALAN BARU, BANGKA TENGAH, KEPULAUAN BANGKA BELITUNG",10,92,18,110
https://kawalpemilu.org#25202,"BELULUK, PANGKALAN BARU, BANGKA TENGAH, KEPULAUAN BANGKA BELITUNG",11,118,39,157
https://kawalpemilu.org#25203,"PEDINDANG, PANGKALAN BARU, BANGKA TENGAH, KEPULAUAN BANGKA BELITUNG",1,125,132,257
https://kawalpemilu.org#25203,"PEDINDANG, PANGKALAN BARU, BANGKA TENGAH, KEPULAUAN BANGKA BELITUNG",2,160,92,252
https://kawalpemilu.org#25203,"PEDINDANG, PANGKALAN BARU, BANGKA TENGAH, KEPULAUAN BANGKA BELITUNG",3,249,14,263
https://kawalpemilu.org#25203,"PEDINDANG, PANGKALAN BARU, BANGKA TENGAH, KEPULAUAN BANGKA BELITUNG",4,242,12,254
https://kawalpemilu.org#25203,"PEDINDANG, PANGKALAN BARU, BANGKA TENGAH, KEPULAUAN BANGKA BELITUNG",5,127,103,230
https://kawalpemilu.org#25203,"PEDINDANG, PANGKALAN BARU, BANGKA TENGAH, KEPULAUAN BANGKA BELITUNG",6,147,40,187
https://kawalpemilu.org#25203,"PEDINDANG, PANGKALAN BARU, BANGKA TENGAH, KEPULAUAN BANGKA BELITUNG",7,174,12,186
https://kawalpemilu.org#25204,"BATU BELUBANG, PANGKALAN BARU, BANGKA TENGAH, KEPULAUAN BANGKA BELITUNG",1,210,54,264
https://kawalpemilu.org#25204,"BATU BELUBANG, PANGKALAN BARU, BANGKA TENGAH, KEPULAUAN BANGKA BELITUNG",2,182,30,212
https://kawalpemilu.org#25204,"BATU BELUBANG, PANGKALAN BARU, BANGKA TENGAH, KEPULAUAN BANGKA BELITUNG",3,129,98,227
https://kawalpemilu.org#25204,"BATU BELUBANG, PANGKALAN BARU, BANGKA TENGAH, KEPULAUAN BANGKA BELITUNG",4,126,94,220
https://kawalpemilu.org#25204,"BATU BELUBANG, PANGKALAN BARU, BANGKA TENGAH, KEPULAUAN BANGKA BELITUNG",5,151,103,254
https://kawalpemilu.org#25204,"BATU BELUBANG, PANGKALAN BARU, BANGKA TENGAH, KEPULAUAN BANGKA BELITUNG",6,216,22,238
https://kawalpemilu.org#25204,"BATU BELUBANG, PANGKALAN BARU, BANGKA TENGAH, KEPULAUAN BANGKA BELITUNG",7,197,47,244
https://kawalpemilu.org#25204,"BATU BELUBANG, PANGKALAN BARU, BANGKA TENGAH, KEPULAUAN BANGKA BELITUNG",8,172,45,217
https://kawalpemilu.org#25204,"BATU BELUBANG, PANGKALAN BARU, BANGKA TENGAH, KEPULAUAN BANGKA BELITUNG",9,140,40,180
https://kawalpemilu.org#84849,"AIR MESU TIMUR, PANGKALAN BARU, BANGKA TENGAH, KEPULAUAN BANGKA BELITUNG",1,109,153,262
https://kawalpemilu.org#84849,"AIR MESU TIMUR, PANGKALAN BARU, BANGKA TENGAH, KEPULAUAN BANGKA BELITUNG",2,77,150,227
https://kawalpemilu.org#84849,"AIR MESU TIMUR, PANGKALAN BARU, BANGKA TENGAH, KEPULAUAN BANGKA BELITUNG",3,78,139,217
https://kawalpemilu.org#84849,"AIR MESU TIMUR, PANGKALAN BARU, BANGKA TENGAH, KEPULAUAN BANGKA BELITUNG",4,79,180,259
https://kawalpemilu.org#84849,"AIR MESU TIMUR, PANGKALAN BARU, BANGKA TENGAH, KEPULAUAN BANGKA BELITUNG",5,75,157,232
https://kawalpemilu.org#84849,"AIR MESU TIMUR, PANGKALAN BARU, BANGKA TENGAH, KEPULAUAN BANGKA BELITUNG",6,93,123,216
https://kawalpemilu.org#84849,"AIR MESU TIMUR, PANGKALAN BARU, BANGKA TENGAH, KEPULAUAN BANGKA BELITUNG",7,38,64,102
https://kawalpemilu.org#84850,"KEBINTIK, PANGKALAN BARU, BANGKA TENGAH, KEPULAUAN BANGKA BELITUNG",1,184,10,194
https://kawalpemilu.org#84850,"KEBINTIK, PANGKALAN BARU, BANGKA TENGAH, KEPULAUAN BANGKA BELITUNG",2,203,5,208
https://kawalpemilu.org#84850,"KEBINTIK, PANGKALAN BARU, BANGKA TENGAH, KEPULAUAN BANGKA BELITUNG",3,172,46,218
https://kawalpemilu.org#84850,"KEBINTIK, PANGKALAN BARU, BANGKA TENGAH, KEPULAUAN BANGKA BELITUNG",4,151,52,203
https://kawalpemilu.org#84850,"KEBINTIK, PANGKALAN BARU, BANGKA TENGAH, KEPULAUAN BANGKA BELITUNG",5,128,12,140
https://kawalpemilu.org#25206,"SUNGAI SELAN, SUNGAI SELAN, BANGKA TENGAH, KEPULAUAN BANGKA BELITUNG",1,159,76,135
https://kawalpemilu.org#25206,"SUNGAI SELAN, SUNGAI SELAN, BANGKA TENGAH, KEPULAUAN BANGKA BELITUNG",2,169,47,216
https://kawalpemilu.org#25206,"SUNGAI SELAN, SUNGAI SELAN, BANGKA TENGAH, KEPULAUAN BANGKA BELITUNG",3,175,53,228
https://kawalpemilu.org#25206,"SUNGAI SELAN, SUNGAI SELAN, BANGKA TENGAH, KEPULAUAN BANGKA BELITUNG",4,144,70,214
https://kawalpemilu.org#25206,"SUNGAI SELAN, SUNGAI SELAN, BANGKA TENGAH, KEPULAUAN BANGKA BELITUNG",5,178,47,225
https://kawalpemilu.org#25206,"SUNGAI SELAN, SUNGAI SELAN, BANGKA TENGAH, KEPULAUAN BANGKA BELITUNG",6,194,46,240
https://kawalpemilu.org#25206,"SUNGAI SELAN, SUNGAI SELAN, BANGKA TENGAH, KEPULAUAN BANGKA BELITUNG",7,161,48,209
https://kawalpemilu.org#25206,"SUNGAI SELAN, SUNGAI SELAN, BANGKA TENGAH, KEPULAUAN BANGKA BELITUNG",8,162,34,201
https://kawalpemilu.org#25206,"SUNGAI SELAN, SUNGAI SELAN, BANGKA TENGAH, KEPULAUAN BANGKA BELITUNG",9,172,59,231
https://kawalpemilu.org#25206,"SUNGAI SELAN, SUNGAI SELAN, BANGKA TENGAH, KEPULAUAN BANGKA BELITUNG",10,157,34,191
https://kawalpemilu.org#25206,"SUNGAI SELAN, SUNGAI SELAN, BANGKA TENGAH, KEPULAUAN BANGKA BELITUNG",11,157,58,215
https://kawalpemilu.org#25206,"SUNGAI SELAN, SUNGAI SELAN, BANGKA TENGAH, KEPULAUAN BANGKA BELITUNG",12,157,61,218
https://kawalpemilu.org#25206,"SUNGAI SELAN, SUNGAI SELAN, BANGKA TENGAH, KEPULAUAN BANGKA BELITUNG",13,84,58,142
https://kawalpemilu.org#25206,"SUNGAI SELAN, SUNGAI SELAN, BANGKA TENGAH, KEPULAUAN BANGKA BELITUNG",14,151,75,226
https://kawalpemilu.org#25206,"SUNGAI SELAN, SUNGAI SELAN, BANGKA TENGAH, KEPULAUAN BANGKA BELITUNG",15,177,53,230
https://kawalpemilu.org#25206,"SUNGAI SELAN, SUNGAI SELAN, BANGKA TENGAH, KEPULAUAN BANGKA BELITUNG",16,155,63,218
https://kawalpemilu.org#25206,"SUNGAI SELAN, SUNGAI SELAN, BANGKA TENGAH, KEPULAUAN BANGKA BELITUNG",17,181,39,220
https://kawalpemilu.org#25206,"SUNGAI SELAN, SUNGAI SELAN, BANGKA TENGAH, KEPULAUAN BANGKA BELITUNG",18,103,50,153
https://kawalpemilu.org#25206,"SUNGAI SELAN, SUNGAI SELAN, BANGKA TENGAH, KEPULAUAN BANGKA BELITUNG",19,98,62,160
https://kawalpemilu.org#25206,"SUNGAI SELAN, SUNGAI SELAN, BANGKA TENGAH, KEPULAUAN BANGKA BELITUNG",20,179,38,217
https://kawalpemilu.org#25207,"KERANTAI, SUNGAI SELAN, BANGKA TENGAH, KEPULAUAN BANGKA BELITUNG",1,132,57,189
https://kawalpemilu.org#25207,"KERANTAI, SUNGAI SELAN, BANGKA TENGAH, KEPULAUAN BANGKA BELITUNG",2,127,72,199
https://kawalpemilu.org#25207,"KERANTAI, SUNGAI SELAN, BANGKA TENGAH, KEPULAUAN BANGKA BELITUNG",3,96,81,177
https://kawalpemilu.org#25208,"KERETAK, SUNGAI SELAN, BANGKA TENGAH, KEPULAUAN BANGKA BELITUNG",1,108,109,217
https://kawalpemilu.org#25208,"KERETAK, SUNGAI SELAN, BANGKA TENGAH, KEPULAUAN BANGKA BELITUNG",2,90,112,202
https://kawalpemilu.org#25208,"KERETAK, SUNGAI SELAN, BANGKA TENGAH, KEPULAUAN BANGKA BELITUNG",3,105,107,212
https://kawalpemilu.org#25208,"KERETAK, SUNGAI SELAN, BANGKA TENGAH, KEPULAUAN BANGKA BELITUNG",4,120,117,237
https://kawalpemilu.org#25208,"KERETAK, SUNGAI SELAN, BANGKA TENGAH, KEPULAUAN BANGKA BELITUNG",5,105,106,211
https://kawalpemilu.org#25208,"KERETAK, SUNGAI SELAN, BANGKA TENGAH, KEPULAUAN BANGKA BELITUNG",6,142,80,245
https://kawalpemilu.org#25208,"KERETAK, SUNGAI SELAN, BANGKA TENGAH, KEPULAUAN BANGKA BELITUNG",7,137,33,170
https://kawalpemilu.org#25208,"KERETAK, SUNGAI SELAN, BANGKA TENGAH, KEPULAUAN BANGKA BELITUNG",8,92,21,113
https://kawalpemilu.org#25209,"LAMPUR, SUNGAI SELAN, BANGKA TENGAH, KEPULAUAN BANGKA BELITUNG",1,152,31,183
https://kawalpemilu.org#25209,"LAMPUR, SUNGAI SELAN, BANGKA TENGAH, KEPULAUAN BANGKA BELITUNG",2,142,94,236
https://kawalpemilu.org#25209,"LAMPUR, SUNGAI SELAN, BANGKA TENGAH, KEPULAUAN BANGKA BELITUNG",3,148,83,231
https://kawalpemilu.org#25209,"LAMPUR, SUNGAI SELAN, BANGKA TENGAH, KEPULAUAN BANGKA BELITUNG",4,123,109,232
https://kawalpemilu.org#25209,"LAMPUR, SUNGAI SELAN, BANGKA TENGAH, KEPULAUAN BANGKA BELITUNG",5,128,62,190
https://kawalpemilu.org#25209,"LAMPUR, SUNGAI SELAN, BANGKA TENGAH, KEPULAUAN BANGKA BELITUNG",6,122,63,185
https://kawalpemilu.org#25209,"LAMPUR, SUNGAI SELAN, BANGKA TENGAH, KEPULAUAN BANGKA BELITUNG",7,162,61,223
https://kawalpemilu.org#25209,"LAMPUR, SUNGAI SELAN, BANGKA TENGAH, KEPULAUAN BANGKA BELITUNG",8,182,50,232
https://kawalpemilu.org#25209,"LAMPUR, SUNGAI SELAN, BANGKA TENGAH, KEPULAUAN BANGKA BELITUNG",9,141,58,199
https://kawalpemilu.org#25209,"LAMPUR, SUNGAI SELAN, BANGKA TENGAH, KEPULAUAN BANGKA BELITUNG",10,146,73,219
https://kawalpemilu.org#25209,"LAMPUR, SUNGAI SELAN, BANGKA TENGAH, KEPULAUAN BANGKA BELITUNG",11,207,34,241
https://kawalpemilu.org#25209,"LAMPUR, SUNGAI SELAN, BANGKA TENGAH, KEPULAUAN BANGKA BELITUNG",12,119,40,159
https://kawalpemilu.org#25209,"LAMPUR, SUNGAI SELAN, BANGKA TENGAH, KEPULAUAN BANGKA BELITUNG",13,128,58,186
https://kawalpemilu.org#25210,"SARANG MANDI, SUNGAI SELAN, BANGKA TENGAH, KEPULAUAN BANGKA BELITUNG",1,168,64,232
https://kawalpemilu.org#25210,"SARANG MANDI, SUNGAI SELAN, BANGKA TENGAH, KEPULAUAN BANGKA BELITUNG",2,148,60,208
https://kawalpemilu.org#25210,"SARANG MANDI, SUNGAI SELAN, BANGKA TENGAH, KEPULAUAN BANGKA BELITUNG",3,172,69,241
https://kawalpemilu.org#25210,"SARANG MANDI, SUNGAI SELAN, BANGKA TENGAH, KEPULAUAN BANGKA BELITUNG",4,153,65,218
https://kawalpemilu.org#25210,"SARANG MANDI, SUNGAI SELAN, BANGKA TENGAH, KEPULAUAN BANGKA BELITUNG",5,120,104,224
https://kawalpemilu.org#25210,"SARANG MANDI, SUNGAI SELAN, BANGKA TENGAH, KEPULAUAN BANGKA BELITUNG",6,144,81,225
https://kawalpemilu.org#25211,"MUNGGU, SUNGAI SELAN, BANGKA TENGAH, KEPULAUAN BANGKA BELITUNG",1,201,61,262
https://kawalpemilu.org#25211,"MUNGGU, SUNGAI SELAN, BANGKA TENGAH, KEPULAUAN BANGKA BELITUNG",2,123,133,256
https://kawalpemilu.org#25211,"MUNGGU, SUNGAI SELAN, BANGKA TENGAH, KEPULAUAN BANGKA BELITUNG",3,146,98,244
https://kawalpemilu.org#25211,"MUNGGU, SUNGAI SELAN, BANGKA TENGAH, KEPULAUAN BANGKA BELITUNG",4,134,89,223
https://kawalpemilu.org#25211,"MUNGGU, SUNGAI SELAN, BANGKA TENGAH, KEPULAUAN BANGKA BELITUNG",5,186,24,210
https://kawalpemilu.org#25211,"MUNGGU, SUNGAI SELAN, BANGKA TENGAH, KEPULAUAN BANGKA BELITUNG",6,148,111,259
https://kawalpemilu.org#25212,"KEMINGKING, SUNGAI SELAN, BANGKA TENGAH, KEPULAUAN BANGKA BELITUNG",1,162,78,240
https://kawalpemilu.org#25212,"KEMINGKING, SUNGAI SELAN, BANGKA TENGAH, KEPULAUAN BANGKA BELITUNG",2,102,59,161
https://kawalpemilu.org#25212,"KEMINGKING, SUNGAI SELAN, BANGKA TENGAH, KEPULAUAN BANGKA BELITUNG",3,161,86,247
https://kawalpemilu.org#25212,"KEMINGKING, SUNGAI SELAN, BANGKA TENGAH, KEPULAUAN BANGKA BELITUNG",4,138,102,240
https://kawalpemilu.org#25212,"KEMINGKING, SUNGAI SELAN, BANGKA TENGAH, KEPULAUAN BANGKA BELITUNG",5,85,49,134
https://kawalpemilu.org#25212,"KEMINGKING, SUNGAI SELAN, BANGKA TENGAH, KEPULAUAN BANGKA BELITUNG",6,96,57,153
https://kawalpemilu.org#25213,"SUNGAI SELAN ATAS, SUNGAI SELAN, BANGKA TENGAH, KEPULAUAN BANGKA BELITUNG",1,162,62,224
https://kawalpemilu.org#25213,"SUNGAI SELAN ATAS, SUNGAI SELAN, BANGKA TENGAH, KEPULAUAN BANGKA BELITUNG",2,181,62,243
https://kawalpemilu.org#25213,"SUNGAI SELAN ATAS, SUNGAI SELAN, BANGKA TENGAH, KEPULAUAN BANGKA BELITUNG",3,205,46,251
https://kawalpemilu.org#25213,"SUNGAI SELAN ATAS, SUNGAI SELAN, BANGKA TENGAH, KEPULAUAN BANGKA BELITUNG",4,155,58,213
https://kawalpemilu.org#25213,"SUNGAI SELAN ATAS, SUNGAI SELAN, BANGKA TENGAH, KEPULAUAN BANGKA BELITUNG",5,146,57,203
https://kawalpemilu.org#25213,"SUNGAI SELAN ATAS, SUNGAI SELAN, BANGKA TENGAH, KEPULAUAN BANGKA BELITUNG",6,166,54,220
https://kawalpemilu.org#25213,"SUNGAI SELAN ATAS, SUNGAI SELAN, BANGKA TENGAH, KEPULAUAN BANGKA BELITUNG",7,186,58,244
https://kawalpemilu.org#25214,"TANJUNG PURA, SUNGAI SELAN, BANGKA TENGAH, KEPULAUAN BANGKA BELITUNG",1,135,113,248
https://kawalpemilu.org#25214,"TANJUNG PURA, SUNGAI SELAN, BANGKA TENGAH, KEPULAUAN BANGKA BELITUNG",2,197,54,251
https://kawalpemilu.org#25214,"TANJUNG PURA, SUNGAI SELAN, BANGKA TENGAH, KEPULAUAN BANGKA BELITUNG",3,193,33,226
https://kawalpemilu.org#25215,"RAMADHON, SUNGAI SELAN, BANGKA TENGAH, KEPULAUAN BANGKA BELITUNG",1,126,95,221
https://kawalpemilu.org#25215,"RAMADHON, SUNGAI SELAN, BANGKA TENGAH, KEPULAUAN BANGKA BELITUNG",2,153,64,217
https://kawalpemilu.org#25215,"RAMADHON, SUNGAI SELAN, BANGKA TENGAH, KEPULAUAN BANGKA BELITUNG",3,130,33,163
https://kawalpemilu.org#25215,"RAMADHON, SUNGAI SELAN, BANGKA TENGAH, KEPULAUAN BANGKA BELITUNG",4,115,37,152
https://kawalpemilu.org#25215,"RAMADHON, SUNGAI SELAN, BANGKA TENGAH, KEPULAUAN BANGKA BELITUNG",5,122,58,180
https://kawalpemilu.org#25215,"RAMADHON, SUNGAI SELAN, BANGKA TENGAH, KEPULAUAN BANGKA BELITUNG",6,101,78,179
https://kawalpemilu.org#25216,"KERAKAS, SUNGAI SELAN, BANGKA TENGAH, KEPULAUAN BANGKA BELITUNG",1,143,74,217
https://kawalpemilu.org#25216,"KERAKAS, SUNGAI SELAN, BANGKA TENGAH, KEPULAUAN BANGKA BELITUNG",2,160,61,221
https://kawalpemilu.org#25216,"KERAKAS, SUNGAI SELAN, BANGKA TENGAH, KEPULAUAN BANGKA BELITUNG",3,176,63,239
https://kawalpemilu.org#25216,"KERAKAS, SUNGAI SELAN, BANGKA TENGAH, KEPULAUAN BANGKA BELITUNG",4,83,77,160
https://kawalpemilu.org#84851,"MELABUN, SUNGAI SELAN, BANGKA TENGAH, KEPULAUAN BANGKA BELITUNG",1,134,71,205
https://kawalpemilu.org#84851,"MELABUN, SUNGAI SELAN, BANGKA TENGAH, KEPULAUAN BANGKA BELITUNG",2,81,80,161
https://kawalpemilu.org#84851,"MELABUN, SUNGAI SELAN, BANGKA TENGAH, KEPULAUAN BANGKA BELITUNG",3,116,53,169
https://kawalpemilu.org#84852,"KERETAK ATAS, SUNGAI SELAN, BANGKA TENGAH, KEPULAUAN BANGKA BELITUNG",1,141,93,234
https://kawalpemilu.org#84852,"KERETAK ATAS, SUNGAI SELAN, BANGKA TENGAH, KEPULAUAN BANGKA BELITUNG",2,101,134,235
https://kawalpemilu.org#84852,"KERETAK ATAS, SUNGAI SELAN, BANGKA TENGAH, KEPULAUAN BANGKA BELITUNG",3,107,100,207
https://kawalpemilu.org#84852,"KERETAK ATAS, SUNGAI SELAN, BANGKA TENGAH, KEPULAUAN BANGKA BELITUNG",4,90,90,180
https://kawalpemilu.org#84852,"KERETAK ATAS, SUNGAI SELAN, BANGKA TENGAH, KEPULAUAN BANGKA BELITUNG",5,128,111,239
https://kawalpemilu.org#25218,"SIMPANG KATIS, SIMPANG KATIS, BANGKA TENGAH, KEPULAUAN BANGKA BELITUNG",1,145,98,243
https://kawalpemilu.org#25218,"SIMPANG KATIS, SIMPANG KATIS, BANGKA TENGAH, KEPULAUAN BANGKA BELITUNG",2,99,107,206
https://kawalpemilu.org#25218,"SIMPANG KATIS, SIMPANG KATIS, BANGKA TENGAH, KEPULAUAN BANGKA BELITUNG",3,114,88,202
https://kawalpemilu.org#25218,"SIMPANG KATIS, SIMPANG KATIS, BANGKA TENGAH, KEPULAUAN BANGKA BELITUNG",4,102,108,210
https://kawalpemilu.org#25218,"SIMPANG KATIS, SIMPANG KATIS, BANGKA TENGAH, KEPULAUAN BANGKA BELITUNG",5,129,122,251
https://kawalpemilu.org#25218,"SIMPANG KATIS, SIMPANG KATIS, BANGKA TENGAH, KEPULAUAN BANGKA BELITUNG",6,92,135,227
https://kawalpemilu.org#25218,"SIMPANG KATIS, SIMPANG KATIS, BANGKA TENGAH, KEPULAUAN BANGKA BELITUNG",7,165,63,228
https://kawalpemilu.org#25219,"CELUAK, SIMPANG KATIS, BANGKA TENGAH, KEPULAUAN BANGKA BELITUNG",2,79,165,244
https://kawalpemilu.org#25219,"CELUAK, SIMPANG KATIS, BANGKA TENGAH, KEPULAUAN BANGKA BELITUNG",3,65,176,241
https://kawalpemilu.org#25219,"CELUAK, SIMPANG KATIS, BANGKA TENGAH, KEPULAUAN BANGKA BELITUNG",4,94,158,252
https://kawalpemilu.org#25219,"CELUAK, SIMPANG KATIS, BANGKA TENGAH, KEPULAUAN BANGKA BELITUNG",5,18,74,92
https://kawalpemilu.org#25219,"CELUAK, SIMPANG KATIS, BANGKA TENGAH, KEPULAUAN BANGKA BELITUNG",6,65,168,233
https://kawalpemilu.org#25220,"SUNGKAP, SIMPANG KATIS, BANGKA TENGAH, KEPULAUAN BANGKA BELITUNG",1,59,169,228
https://kawalpemilu.org#25220,"SUNGKAP, SIMPANG KATIS, BANGKA TENGAH, KEPULAUAN BANGKA BELITUNG",2,32,161,193
https://kawalpemilu.org#25220,"SUNGKAP, SIMPANG KATIS, BANGKA TENGAH, KEPULAUAN BANGKA BELITUNG",3,50,145,195
https://kawalpemilu.org#25220,"SUNGKAP, SIMPANG KATIS, BANGKA TENGAH, KEPULAUAN BANGKA BELITUNG",4,104,120,224
https://kawalpemilu.org#25220,"SUNGKAP, SIMPANG KATIS, BANGKA TENGAH, KEPULAUAN BANGKA BELITUNG",5,72,148,220
https://kawalpemilu.org#25220,"SUNGKAP, SIMPANG KATIS, BANGKA TENGAH, KEPULAUAN BANGKA BELITUNG",6,88,172,260
https://kawalpemilu.org#25220,"SUNGKAP, SIMPANG KATIS, BANGKA TENGAH, KEPULAUAN BANGKA BELITUNG",7,70,160,230
https://kawalpemilu.org#25221,"BERUAS, SIMPANG KATIS, BANGKA TENGAH, KEPULAUAN BANGKA BELITUNG",1,126,105,231
https://kawalpemilu.org#25221,"BERUAS, SIMPANG KATIS, BANGKA TENGAH, KEPULAUAN BANGKA BELITUNG",2,53,167,220
https://kawalpemilu.org#25221,"BERUAS, SIMPANG KATIS, BANGKA TENGAH, KEPULAUAN BANGKA BELITUNG",3,116,110,226
https://kawalpemilu.org#25221,"BERUAS, SIMPANG KATIS, BANGKA TENGAH, KEPULAUAN BANGKA BELITUNG",4,103,128,231
https://kawalpemilu.org#25221,"BERUAS, SIMPANG KATIS, BANGKA TENGAH, KEPULAUAN BANGKA BELITUNG",5,145,45,189
https://kawalpemilu.org#25222,"PUPUT, SIMPANG KATIS, BANGKA TENGAH, KEPULAUAN BANGKA BELITUNG",1,129,91,220
https://kawalpemilu.org#25222,"PUPUT, SIMPANG KATIS, BANGKA TENGAH, KEPULAUAN BANGKA BELITUNG",2,89,130,219
https://kawalpemilu.org#25222,"PUPUT, SIMPANG KATIS, BANGKA TENGAH, KEPULAUAN BANGKA BELITUNG",3,95,146,241
https://kawalpemilu.org#25222,"PUPUT, SIMPANG KATIS, BANGKA TENGAH, KEPULAUAN BANGKA BELITUNG",4,67,183,250
https://kawalpemilu.org#25222,"PUPUT, SIMPANG KATIS, BANGKA TENGAH, KEPULAUAN BANGKA BELITUNG",5,119,98,217
https://kawalpemilu.org#25222,"PUPUT, SIMPANG KATIS, BANGKA TENGAH, KEPULAUAN BANGKA BELITUNG",6,93,159,252
https://kawalpemilu.org#25223,"TERU, SIMPANG KATIS, BANGKA TENGAH, KEPULAUAN BANGKA BELITUNG",1,98,125,223
https://kawalpemilu.org#25223,"TERU, SIMPANG KATIS, BANGKA TENGAH, KEPULAUAN BANGKA BELITUNG",2,97,131,228
https://kawalpemilu.org#25223,"TERU, SIMPANG KATIS, BANGKA TENGAH, KEPULAUAN BANGKA BELITUNG",3,90,145,235
https://kawalpemilu.org#25223,"TERU, SIMPANG KATIS, BANGKA TENGAH, KEPULAUAN BANGKA BELITUNG",4,110,108,218
https://kawalpemilu.org#25223,"TERU, SIMPANG KATIS, BANGKA TENGAH, KEPULAUAN BANGKA BELITUNG",5,145,81,126
https://kawalpemilu.org#25223,"TERU, SIMPANG KATIS, BANGKA TENGAH, KEPULAUAN BANGKA BELITUNG",6,90,112,202
https://kawalpemilu.org#25223,"TERU, SIMPANG KATIS, BANGKA TENGAH, KEPULAUAN BANGKA BELITUNG",7,110,78,188
https://kawalpemilu.org#25224,"TERAK, SIMPANG KATIS, BANGKA TENGAH, KEPULAUAN BANGKA BELITUNG",1,106,94,200
https://kawalpemilu.org#25224,"TERAK, SIMPANG KATIS, BANGKA TENGAH, KEPULAUAN BANGKA BELITUNG",2,100,109,209
https://kawalpemilu.org#25224,"TERAK, SIMPANG KATIS, BANGKA TENGAH, KEPULAUAN BANGKA BELITUNG",3,67,143,210
https://kawalpemilu.org#25224,"TERAK, SIMPANG KATIS, BANGKA TENGAH, KEPULAUAN BANGKA BELITUNG",4,175,49,224
https://kawalpemilu.org#25224,"TERAK, SIMPANG KATIS, BANGKA TENGAH, KEPULAUAN BANGKA BELITUNG",5,85,111,196
https://kawalpemilu.org#25224,"TERAK, SIMPANG KATIS, BANGKA TENGAH, KEPULAUAN BANGKA BELITUNG",6,98,128,226
https://kawalpemilu.org#25224,"TERAK, SIMPANG KATIS, BANGKA TENGAH, KEPULAUAN BANGKA BELITUNG",7,119,123,242
https://kawalpemilu.org#25224,"TERAK, SIMPANG KATIS, BANGKA TENGAH, KEPULAUAN BANGKA BELITUNG",8,122,66,188
https://kawalpemilu.org#25224,"TERAK, SIMPANG KATIS, BANGKA TENGAH, KEPULAUAN BANGKA BELITUNG",9,107,109,216
https://kawalpemilu.org#25224,"TERAK, SIMPANG KATIS, BANGKA TENGAH, KEPULAUAN BANGKA BELITUNG",10,92,142,234
https://kawalpemilu.org#25224,"TERAK, SIMPANG KATIS, BANGKA TENGAH, KEPULAUAN BANGKA BELITUNG",11,82,117,199
https://kawalpemilu.org#25224,"TERAK, SIMPANG KATIS, BANGKA TENGAH, KEPULAUAN BANGKA BELITUNG",12,130,78,208
https://kawalpemilu.org#25225,"PASIR GARAM, SIMPANG KATIS, BANGKA TENGAH, KEPULAUAN BANGKA BELITUNG",1,162,71,233
https://kawalpemilu.org#25225,"PASIR GARAM, SIMPANG KATIS, BANGKA TENGAH, KEPULAUAN BANGKA BELITUNG",2,160,69,229
https://kawalpemilu.org#25225,"PASIR GARAM, SIMPANG KATIS, BANGKA TENGAH, KEPULAUAN BANGKA BELITUNG",3,172,35,207
https://kawalpemilu.org#25225,"PASIR GARAM, SIMPANG KATIS, BANGKA TENGAH, KEPULAUAN BANGKA BELITUNG",4,229,26,255
https://kawalpemilu.org#25225,"PASIR GARAM, SIMPANG KATIS, BANGKA TENGAH, KEPULAUAN BANGKA BELITUNG",5,156,57,213
https://kawalpemilu.org#25225,"PASIR GARAM, SIMPANG KATIS, BANGKA TENGAH, KEPULAUAN BANGKA BELITUNG",6,175,48,223
https://kawalpemilu.org#25226,"KATIS, SIMPANG KATIS, BANGKA TENGAH, KEPULAUAN BANGKA BELITUNG",1,89,92,181
https://kawalpemilu.org#25226,"KATIS, SIMPANG KATIS, BANGKA TENGAH, KEPULAUAN BANGKA BELITUNG",2,97,92,189
https://kawalpemilu.org#25226,"KATIS, SIMPANG KATIS, BANGKA TENGAH, KEPULAUAN BANGKA BELITUNG",3,118,78,196
https://kawalpemilu.org#25226,"KATIS, SIMPANG KATIS, BANGKA TENGAH, KEPULAUAN BANGKA BELITUNG",4,92,112,204
https://kawalpemilu.org#25227,"PINANG SEBATANG, SIMPANG KATIS, BANGKA TENGAH, KEPULAUAN BANGKA BELITUNG",1,45,181,226
https://kawalpemilu.org#25227,"PINANG SEBATANG, SIMPANG KATIS, BANGKA TENGAH, KEPULAUAN BANGKA BELITUNG",2,36,176,212
https://kawalpemilu.org#25227,"PINANG SEBATANG, SIMPANG KATIS, BANGKA TENGAH, KEPULAUAN BANGKA BELITUNG",3,37,173,210
https://kawalpemilu.org#25227,"PINANG SEBATANG, SIMPANG KATIS, BANGKA TENGAH, KEPULAUAN BANGKA BELITUNG",4,50,164,214
https://kawalpemilu.org#25229,"NAMANG, NAMANG, BANGKA TENGAH, KEPULAUAN BANGKA BELITUNG",1,59,165,224
https://kawalpemilu.org#25229,"NAMANG, NAMANG, BANGKA TENGAH, KEPULAUAN BANGKA BELITUNG",2,73,163,236
https://kawalpemilu.org#25229,"NAMANG, NAMANG, BANGKA TENGAH, KEPULAUAN BANGKA BELITUNG",3,80,146,226
https://kawalpemilu.org#25229,"NAMANG, NAMANG, BANGKA TENGAH, KEPULAUAN BANGKA BELITUNG",4,103,113,216
https://kawalpemilu.org#25229,"NAMANG, NAMANG, BANGKA TENGAH, KEPULAUAN BANGKA BELITUNG",5,63,114,177
https://kawalpemilu.org#25229,"NAMANG, NAMANG, BANGKA TENGAH, KEPULAUAN BANGKA BELITUNG",6,43,171,214
https://kawalpemilu.org#25229,"NAMANG, NAMANG, BANGKA TENGAH, KEPULAUAN BANGKA BELITUNG",7,107,129,236
https://kawalpemilu.org#25230,"CAMBAI, NAMANG, BANGKA TENGAH, KEPULAUAN BANGKA BELITUNG",1,138,103,241
https://kawalpemilu.org#25230,"CAMBAI, NAMANG, BANGKA TENGAH, KEPULAUAN BANGKA BELITUNG",2,112,116,228
https://kawalpemilu.org#25230,"CAMBAI, NAMANG, BANGKA TENGAH, KEPULAUAN BANGKA BELITUNG",3,113,103,216
https://kawalpemilu.org#25230,"CAMBAI, NAMANG, BANGKA TENGAH, KEPULAUAN BANGKA BELITUNG",4,107,114,221
https://kawalpemilu.org#25231,"KAYU BESI, NAMANG, BANGKA TENGAH, KEPULAUAN BANGKA BELITUNG",1,227,2,229
https://kawalpemilu.org#25231,"KAYU BESI, NAMANG, BANGKA TENGAH, KEPULAUAN BANGKA BELITUNG",2,195,5,200
https://kawalpemilu.org#25231,"KAYU BESI, NAMANG, BANGKA TENGAH, KEPULAUAN BANGKA BELITUNG",3,202,3,205
https://kawalpemilu.org#25231,"KAYU BESI, NAMANG, BANGKA TENGAH, KEPULAUAN BANGKA BELITUNG",4,210,3,213
https://kawalpemilu.org#25231,"KAYU BESI, NAMANG, BANGKA TENGAH, KEPULAUAN BANGKA BELITUNG",5,201,9,210
https://kawalpemilu.org#25232,"JELUTUNG, NAMANG, BANGKA TENGAH, KEPULAUAN BANGKA BELITUNG",1,72,160,232
https://kawalpemilu.org#25232,"JELUTUNG, NAMANG, BANGKA TENGAH, KEPULAUAN BANGKA BELITUNG",3,65,162,227
https://kawalpemilu.org#25232,"JELUTUNG, NAMANG, BANGKA TENGAH, KEPULAUAN BANGKA BELITUNG",4,68,176,244
https://kawalpemilu.org#25232,"JELUTUNG, NAMANG, BANGKA TENGAH, KEPULAUAN BANGKA BELITUNG",5,80,155,235
https://kawalpemilu.org#25232,"JELUTUNG, NAMANG, BANGKA TENGAH, KEPULAUAN BANGKA BELITUNG",6,73,165,238
https://kawalpemilu.org#25232,"JELUTUNG, NAMANG, BANGKA TENGAH, KEPULAUAN BANGKA BELITUNG",7,46,197,243
https://kawalpemilu.org#25233,"BELILIK, NAMANG, BANGKA TENGAH, KEPULAUAN BANGKA BELITUNG",1,96,122,218
https://kawalpemilu.org#25233,"BELILIK, NAMANG, BANGKA TENGAH, KEPULAUAN BANGKA BELITUNG",2,77,160,237
https://kawalpemilu.org#25233,"BELILIK, NAMANG, BANGKA TENGAH, KEPULAUAN BANGKA BELITUNG",3,101,141,242
https://kawalpemilu.org#25233,"BELILIK, NAMANG, BANGKA TENGAH, KEPULAUAN BANGKA BELITUNG",4,91,122,213
https://kawalpemilu.org#25233,"BELILIK, NAMANG, BANGKA TENGAH, KEPULAUAN BANGKA BELITUNG",5,85,128,213
https://kawalpemilu.org#25233,"BELILIK, NAMANG, BANGKA TENGAH, KEPULAUAN BANGKA BELITUNG",6,79,112,191
https://kawalpemilu.org#25234,"BASKARA BAKTI, NAMANG, BANGKA TENGAH, KEPULAUAN BANGKA BELITUNG",1,151,92,243
https://kawalpemilu.org#25234,"BASKARA BAKTI, NAMANG, BANGKA TENGAH, KEPULAUAN BANGKA BELITUNG",2,114,112,226
https://kawalpemilu.org#25234,"BASKARA BAKTI, NAMANG, BANGKA TENGAH, KEPULAUAN BANGKA BELITUNG",3,198,48,246
https://kawalpemilu.org#25234,"BASKARA BAKTI, NAMANG, BANGKA TENGAH, KEPULAUAN BANGKA BELITUNG",4,127,113,240
https://kawalpemilu.org#25234,"BASKARA BAKTI, NAMANG, BANGKA TENGAH, KEPULAUAN BANGKA BELITUNG",5,158,89,247
https://kawalpemilu.org#25235,"BUKIT KIJANG, NAMANG, BANGKA TENGAH, KEPULAUAN BANGKA BELITUNG",1,125,97,222
https://kawalpemilu.org#25235,"BUKIT KIJANG, NAMANG, BANGKA TENGAH, KEPULAUAN BANGKA BELITUNG",2,88,115,203
https://kawalpemilu.org#25235,"BUKIT KIJANG, NAMANG, BANGKA TENGAH, KEPULAUAN BANGKA BELITUNG",3,130,75,205
https://kawalpemilu.org#84853,"CAMBAI SELATAN, NAMANG, BANGKA TENGAH, KEPULAUAN BANGKA BELITUNG",1,113,102,215
https://kawalpemilu.org#84853,"CAMBAI SELATAN, NAMANG, BANGKA TENGAH, KEPULAUAN BANGKA BELITUNG",2,127,96,223
https://kawalpemilu.org#84853,"CAMBAI SELATAN, NAMANG, BANGKA TENGAH, KEPULAUAN BANGKA BELITUNG",3,100,114,214
https://kawalpemilu.org#84853,"CAMBAI SELATAN, NAMANG, BANGKA TENGAH, KEPULAUAN BANGKA BELITUNG",4,113,116,229
https://kawalpemilu.org#25237,"PERLANG, LUBUK BESAR, BANGKA TENGAH, KEPULAUAN BANGKA BELITUNG",1,108,117,225
https://kawalpemilu.org#25237,"PERLANG, LUBUK BESAR, BANGKA TENGAH, KEPULAUAN BANGKA BELITUNG",2,114,86,200
https://kawalpemilu.org#25237,"PERLANG, LUBUK BESAR, BANGKA TENGAH, KEPULAUAN BANGKA BELITUNG",3,125,96,221
https://kawalpemilu.org#25237,"PERLANG, LUBUK BESAR, BANGKA TENGAH, KEPULAUAN BANGKA BELITUNG",4,125,73,198
https://kawalpemilu.org#25237,"PERLANG, LUBUK BESAR, BANGKA TENGAH, KEPULAUAN BANGKA BELITUNG",5,117,82,199
https://kawalpemilu.org#25237,"PERLANG, LUBUK BESAR, BANGKA TENGAH, KEPULAUAN BANGKA BELITUNG",6,138,97,235
https://kawalpemilu.org#25237,"PERLANG, LUBUK BESAR, BANGKA TENGAH, KEPULAUAN BANGKA BELITUNG",7,127,105,232
https://kawalpemilu.org#25237,"PERLANG, LUBUK BESAR, BANGKA TENGAH, KEPULAUAN BANGKA BELITUNG",8,116,116,232
https://kawalpemilu.org#25237,"PERLANG, LUBUK BESAR, BANGKA TENGAH, KEPULAUAN BANGKA BELITUNG",9,102,125,227
https://kawalpemilu.org#25237,"PERLANG, LUBUK BESAR, BANGKA TENGAH, KEPULAUAN BANGKA BELITUNG",10,171,68,239
https://kawalpemilu.org#25237,"PERLANG, LUBUK BESAR, BANGKA TENGAH, KEPULAUAN BANGKA BELITUNG",11,43,45,88
https://kawalpemilu.org#25237,"PERLANG, LUBUK BESAR, BANGKA TENGAH, KEPULAUAN BANGKA BELITUNG",12,223,9,232
https://kawalpemilu.org#25237,"PERLANG, LUBUK BESAR, BANGKA TENGAH, KEPULAUAN BANGKA BELITUNG",13,135,9,144
https://kawalpemilu.org#25237,"PERLANG, LUBUK BESAR, BANGKA TENGAH, KEPULAUAN BANGKA BELITUNG",14,121,68,189
https://kawalpemilu.org#25237,"PERLANG, LUBUK BESAR, BANGKA TENGAH, KEPULAUAN BANGKA BELITUNG",15,100,122,222
https://kawalpemilu.org#25237,"PERLANG, LUBUK BESAR, BANGKA TENGAH, KEPULAUAN BANGKA BELITUNG",16,191,53,244
https://kawalpemilu.org#25237,"PERLANG, LUBUK BESAR, BANGKA TENGAH, KEPULAUAN BANGKA BELITUNG",17,129,87,216
https://kawalpemilu.org#25237,"PERLANG, LUBUK BESAR, BANGKA TENGAH, KEPULAUAN BANGKA BELITUNG",18,133,16,149
https://kawalpemilu.org#25238,"BATU BERIGA, LUBUK BESAR, BANGKA TENGAH, KEPULAUAN BANGKA BELITUNG",1,177,46,223
https://kawalpemilu.org#25238,"BATU BERIGA, LUBUK BESAR, BANGKA TENGAH, KEPULAUAN BANGKA BELITUNG",2,173,65,238
https://kawalpemilu.org#25238,"BATU BERIGA, LUBUK BESAR, BANGKA TENGAH, KEPULAUAN BANGKA BELITUNG",3,174,56,230
https://kawalpemilu.org#25238,"BATU BERIGA, LUBUK BESAR, BANGKA TENGAH, KEPULAUAN BANGKA BELITUNG",4,118,77,195
https://kawalpemilu.org#25238,"BATU BERIGA, LUBUK BESAR, BANGKA TENGAH, KEPULAUAN BANGKA BELITUNG",5,169,33,202
https://kawalpemilu.org#25238,"BATU BERIGA, LUBUK BESAR, BANGKA TENGAH, KEPULAUAN BANGKA BELITUNG",6,135,56,191
https://kawalpemilu.org#25239,"LUBUK BESAR, LUBUK BESAR, BANGKA TENGAH, KEPULAUAN BANGKA BELITUNG",1,166,68,234
https://kawalpemilu.org#25239,"LUBUK BESAR, LUBUK BESAR, BANGKA TENGAH, KEPULAUAN BANGKA BELITUNG",2,173,48,221
https://kawalpemilu.org#25239,"LUBUK BESAR, LUBUK BESAR, BANGKA TENGAH, KEPULAUAN BANGKA BELITUNG",3,170,54,224
https://kawalpemilu.org#25239,"LUBUK BESAR, LUBUK BESAR, BANGKA TENGAH, KEPULAUAN BANGKA BELITUNG",4,161,65,226
https://kawalpemilu.org#25239,"LUBUK BESAR, LUBUK BESAR, BANGKA TENGAH, KEPULAUAN BANGKA BELITUNG",5,134,33,167
https://kawalpemilu.org#25239,"LUBUK BESAR, LUBUK BESAR, BANGKA TENGAH, KEPULAUAN BANGKA BELITUNG",6,133,47,180
https://kawalpemilu.org#25239,"LUBUK BESAR, LUBUK BESAR, BANGKA TENGAH, KEPULAUAN BANGKA BELITUNG",7,103,57,160
https://kawalpemilu.org#25239,"LUBUK BESAR, LUBUK BESAR, BANGKA TENGAH, KEPULAUAN BANGKA BELITUNG",8,196,29,225
https://kawalpemilu.org#25239,"LUBUK BESAR, LUBUK BESAR, BANGKA TENGAH, KEPULAUAN BANGKA BELITUNG",9,159,17,176
https://kawalpemilu.org#25239,"LUBUK BESAR, LUBUK BESAR, BANGKA TENGAH, KEPULAUAN BANGKA BELITUNG",10,168,53,221
https://kawalpemilu.org#25239,"LUBUK BESAR, LUBUK BESAR, BANGKA TENGAH, KEPULAUAN BANGKA BELITUNG",11,149,22,171
https://kawalpemilu.org#25239,"LUBUK BESAR, LUBUK BESAR, BANGKA TENGAH, KEPULAUAN BANGKA BELITUNG",12,170,31,201
https://kawalpemilu.org#25239,"LUBUK BESAR, LUBUK BESAR, BANGKA TENGAH, KEPULAUAN BANGKA BELITUNG",13,154,24,178
https://kawalpemilu.org#25239,"LUBUK BESAR, LUBUK BESAR, BANGKA TENGAH, KEPULAUAN BANGKA BELITUNG",14,134,44,178
https://kawalpemilu.org#25239,"LUBUK BESAR, LUBUK BESAR, BANGKA TENGAH, KEPULAUAN BANGKA BELITUNG",15,134,87,221
https://kawalpemilu.org#25239,"LUBUK BESAR, LUBUK BESAR, BANGKA TENGAH, KEPULAUAN BANGKA BELITUNG",16,140,18,158
https://kawalpemilu.org#25240,"KULUR, LUBUK BESAR, BANGKA TENGAH, KEPULAUAN BANGKA BELITUNG",1,168,69,237
https://kawalpemilu.org#25240,"KULUR, LUBUK BESAR, BANGKA TENGAH, KEPULAUAN BANGKA BELITUNG",2,125,88,213
https://kawalpemilu.org#25240,"KULUR, LUBUK BESAR, BANGKA TENGAH, KEPULAUAN BANGKA BELITUNG",3,119,112,231
https://kawalpemilu.org#25240,"KULUR, LUBUK BESAR, BANGKA TENGAH, KEPULAUAN BANGKA BELITUNG",4,98,11,109
https://kawalpemilu.org#25240,"KULUR, LUBUK BESAR, BANGKA TENGAH, KEPULAUAN BANGKA BELITUNG",5,162,76,238
https://kawalpemilu.org#25240,"KULUR, LUBUK BESAR, BANGKA TENGAH, KEPULAUAN BANGKA BELITUNG",6,97,77,174
https://kawalpemilu.org#25240,"KULUR, LUBUK BESAR, BANGKA TENGAH, KEPULAUAN BANGKA BELITUNG",7,121,132,253
https://kawalpemilu.org#25241,"LUBUK LINGKUK, LUBUK BESAR, BANGKA TENGAH, KEPULAUAN BANGKA BELITUNG",1,201,53,254
https://kawalpemilu.org#25241,"LUBUK LINGKUK, LUBUK BESAR, BANGKA TENGAH, KEPULAUAN BANGKA BELITUNG",2,180,52,232
https://kawalpemilu.org#25241,"LUBUK LINGKUK, LUBUK BESAR, BANGKA TENGAH, KEPULAUAN BANGKA BELITUNG",3,178,40,218
https://kawalpemilu.org#25241,"LUBUK LINGKUK, LUBUK BESAR, BANGKA TENGAH, KEPULAUAN BANGKA BELITUNG",4,155,33,188
https://kawalpemilu.org#25241,"LUBUK LINGKUK, LUBUK BESAR, BANGKA TENGAH, KEPULAUAN BANGKA BELITUNG",5,138,38,176
https://kawalpemilu.org#25241,"LUBUK LINGKUK, LUBUK BESAR, BANGKA TENGAH, KEPULAUAN BANGKA BELITUNG",6,150,57,207
https://kawalpemilu.org#25242,"LUBUK PABRIK, LUBUK BESAR, BANGKA TENGAH, KEPULAUAN BANGKA BELITUNG",1,197,40,237
https://kawalpemilu.org#25242,"LUBUK PABRIK, LUBUK BESAR, BANGKA TENGAH, KEPULAUAN BANGKA BELITUNG",2,158,31,189
https://kawalpemilu.org#25242,"LUBUK PABRIK, LUBUK BESAR, BANGKA TENGAH, KEPULAUAN BANGKA BELITUNG",3,131,50,181
https://kawalpemilu.org#25242,"LUBUK PABRIK, LUBUK BESAR, BANGKA TENGAH, KEPULAUAN BANGKA BELITUNG",4,136,24,160
https://kawalpemilu.org#25242,"LUBUK PABRIK, LUBUK BESAR, BANGKA TENGAH, KEPULAUAN BANGKA BELITUNG",5,190,21,211
https://kawalpemilu.org#25242,"LUBUK PABRIK, LUBUK BESAR, BANGKA TENGAH, KEPULAUAN BANGKA BELITUNG",6,220,31,251
https://kawalpemilu.org#25242,"LUBUK PABRIK, LUBUK BESAR, BANGKA TENGAH, KEPULAUAN BANGKA BELITUNG",7,163,26,189
https://kawalpemilu.org#25242,"LUBUK PABRIK, LUBUK BESAR, BANGKA TENGAH, KEPULAUAN BANGKA BELITUNG",8,203,37,240
https://kawalpemilu.org#25242,"LUBUK PABRIK, LUBUK BESAR, BANGKA TENGAH, KEPULAUAN BANGKA BELITUNG",9,151,33,184
https://kawalpemilu.org#25242,"LUBUK PABRIK, LUBUK BESAR, BANGKA TENGAH, KEPULAUAN BANGKA BELITUNG",10,181,16,197
https://kawalpemilu.org#25242,"LUBUK PABRIK, LUBUK BESAR, BANGKA TENGAH, KEPULAUAN BANGKA BELITUNG",11,129,15,144
https://kawalpemilu.org#25242,"LUBUK PABRIK, LUBUK BESAR, BANGKA TENGAH, KEPULAUAN BANGKA BELITUNG",12,100,16,116
https://kawalpemilu.org#25242,"LUBUK PABRIK, LUBUK BESAR, BANGKA TENGAH, KEPULAUAN BANGKA BELITUNG",13,153,94,202
https://kawalpemilu.org#25243,"TRUBUS, LUBUK BESAR, BANGKA TENGAH, KEPULAUAN BANGKA BELITUNG",1,230,5,235
https://kawalpemilu.org#25243,"TRUBUS, LUBUK BESAR, BANGKA TENGAH, KEPULAUAN BANGKA BELITUNG",2,220,2,222
https://kawalpemilu.org#25243,"TRUBUS, LUBUK BESAR, BANGKA TENGAH, KEPULAUAN BANGKA BELITUNG",3,224,8,232
https://kawalpemilu.org#25243,"TRUBUS, LUBUK BESAR, BANGKA TENGAH, KEPULAUAN BANGKA BELITUNG",4,216,19,235
https://kawalpemilu.org#25244,"KULUR ILIR, LUBUK BESAR, BANGKA TENGAH, KEPULAUAN BANGKA BELITUNG",1,101,138,239
https://kawalpemilu.org#25244,"KULUR ILIR, LUBUK BESAR, BANGKA TENGAH, KEPULAUAN BANGKA BELITUNG",2,143,115,258
https://kawalpemilu.org#25244,"KULUR ILIR, LUBUK BESAR, BANGKA TENGAH, KEPULAUAN BANGKA BELITUNG",3,156,84,240
https://kawalpemilu.org#25244,"KULUR ILIR, LUBUK BESAR, BANGKA TENGAH, KEPULAUAN BANGKA BELITUNG",4,101,82,183
https://kawalpemilu.org#25244,"KULUR ILIR, LUBUK BESAR, BANGKA TENGAH, KEPULAUAN BANGKA BELITUNG",5,109,76,185
https://kawalpemilu.org#87364,"BELIMBING, LUBUK BESAR, BANGKA TENGAH, KEPULAUAN BANGKA BELITUNG",1,158,59,217
https://kawalpemilu.org#87364,"BELIMBING, LUBUK BESAR, BANGKA TENGAH, KEPULAUAN BANGKA BELITUNG",2,59,109,168
https://kawalpemilu.org#87364,"BELIMBING, LUBUK BESAR, BANGKA TENGAH, KEPULAUAN BANGKA BELITUNG",3,124,74,198
https://kawalpemilu.org#25247,"TANJUNG, MUNTOK, BANGKA BARAT, KEPULAUAN BANGKA BELITUNG",2,152,64,216
https://kawalpemilu.org#25247,"TANJUNG, MUNTOK, BANGKA BARAT, KEPULAUAN BANGKA BELITUNG",3,88,82,170
https://kawalpemilu.org#25247,"TANJUNG, MUNTOK, BANGKA BARAT, KEPULAUAN BANGKA BELITUNG",4,65,124,189
https://kawalpemilu.org#25247,"TANJUNG, MUNTOK, BANGKA BARAT, KEPULAUAN BANGKA BELITUNG",5,76,77,153
https://kawalpemilu.org#25247,"TANJUNG, MUNTOK, BANGKA BARAT, KEPULAUAN BANGKA BELITUNG",6,50,78,128
https://kawalpemilu.org#25247,"TANJUNG, MUNTOK, BANGKA BARAT, KEPULAUAN BANGKA BELITUNG",7,106,89,195
https://kawalpemilu.org#25247,"TANJUNG, MUNTOK, BANGKA BARAT, KEPULAUAN BANGKA BELITUNG",8,63,144,207
https://kawalpemilu.org#25247,"TANJUNG, MUNTOK, BANGKA BARAT, KEPULAUAN BANGKA BELITUNG",9,109,104,213
https://kawalpemilu.org#25247,"TANJUNG, MUNTOK, BANGKA BARAT, KEPULAUAN BANGKA BELITUNG",10,84,120,204
https://kawalpemilu.org#25247,"TANJUNG, MUNTOK, BANGKA BARAT, KEPULAUAN BANGKA BELITUNG",11,115,16,131
https://kawalpemilu.org#25247,"TANJUNG, MUNTOK, BANGKA BARAT, KEPULAUAN BANGKA BELITUNG",12,115,10,125
https://kawalpemilu.org#25247,"TANJUNG, MUNTOK, BANGKA BARAT, KEPULAUAN BANGKA BELITUNG",13,104,79,183
https://kawalpemilu.org#25247,"TANJUNG, MUNTOK, BANGKA BARAT, KEPULAUAN BANGKA BELITUNG",14,77,94,171
https://kawalpemilu.org#25247,"TANJUNG, MUNTOK, BANGKA BARAT, KEPULAUAN BANGKA BELITUNG",15,106,84,190
https://kawalpemilu.org#25247,"TANJUNG, MUNTOK, BANGKA BARAT, KEPULAUAN BANGKA BELITUNG",17,143,66,209
https://kawalpemilu.org#25247,"TANJUNG, MUNTOK, BANGKA BARAT, KEPULAUAN BANGKA BELITUNG",18,124,124,248
https://kawalpemilu.org#25247,"TANJUNG, MUNTOK, BANGKA BARAT, KEPULAUAN BANGKA BELITUNG",19,68,70,138
https://kawalpemilu.org#25247,"TANJUNG, MUNTOK, BANGKA BARAT, KEPULAUAN BANGKA BELITUNG",20,96,84,180
https://kawalpemilu.org#25247,"TANJUNG, MUNTOK, BANGKA BARAT, KEPULAUAN BANGKA BELITUNG",21,79,107,186
https://kawalpemilu.org#25247,"TANJUNG, MUNTOK, BANGKA BARAT, KEPULAUAN BANGKA BELITUNG",22,87,105,192
https://kawalpemilu.org#25247,"TANJUNG, MUNTOK, BANGKA BARAT, KEPULAUAN BANGKA BELITUNG",23,95,109,204
https://kawalpemilu.org#25247,"TANJUNG, MUNTOK, BANGKA BARAT, KEPULAUAN BANGKA BELITUNG",24,122,80,202
https://kawalpemilu.org#25247,"TANJUNG, MUNTOK, BANGKA BARAT, KEPULAUAN BANGKA BELITUNG",25,105,61,166
https://kawalpemilu.org#25247,"TANJUNG, MUNTOK, BANGKA BARAT, KEPULAUAN BANGKA BELITUNG",26,132,47,179
https://kawalpemilu.org#25247,"TANJUNG, MUNTOK, BANGKA BARAT, KEPULAUAN BANGKA BELITUNG",27,104,46,150
https://kawalpemilu.org#25247,"TANJUNG, MUNTOK, BANGKA BARAT, KEPULAUAN BANGKA BELITUNG",28,133,29,161
https://kawalpemilu.org#25247,"TANJUNG, MUNTOK, BANGKA BARAT, KEPULAUAN BANGKA BELITUNG",29,113,28,141
https://kawalpemilu.org#25247,"TANJUNG, MUNTOK, BANGKA BARAT, KEPULAUAN BANGKA BELITUNG",30,0,0,0
https://kawalpemilu.org#25247,"TANJUNG, MUNTOK, BANGKA BARAT, KEPULAUAN BANGKA BELITUNG",32,134,70,204
https://kawalpemilu.org#25247,"TANJUNG, MUNTOK, BANGKA BARAT, KEPULAUAN BANGKA BELITUNG",33,135,85,220
https://kawalpemilu.org#25247,"TANJUNG, MUNTOK, BANGKA BARAT, KEPULAUAN BANGKA BELITUNG",34,72,96,168
https://kawalpemilu.org#25247,"TANJUNG, MUNTOK, BANGKA BARAT, KEPULAUAN BANGKA BELITUNG",35,110,69,179
https://kawalpemilu.org#25247,"TANJUNG, MUNTOK, BANGKA BARAT, KEPULAUAN BANGKA BELITUNG",36,135,74,209
https://kawalpemilu.org#25247,"TANJUNG, MUNTOK, BANGKA BARAT, KEPULAUAN BANGKA BELITUNG",37,152,64,216
https://kawalpemilu.org#25247,"TANJUNG, MUNTOK, BANGKA BARAT, KEPULAUAN BANGKA BELITUNG",38,157,89,246
https://kawalpemilu.org#25247,"TANJUNG, MUNTOK, BANGKA BARAT, KEPULAUAN BANGKA BELITUNG",40,82,152,234
https://kawalpemilu.org#25247,"TANJUNG, MUNTOK, BANGKA BARAT, KEPULAUAN BANGKA BELITUNG",41,105,82,187
https://kawalpemilu.org#25248,"SUNGAI DAENG, MUNTOK, BANGKA BARAT, KEPULAUAN BANGKA BELITUNG",1,57,102,159
https://kawalpemilu.org#25248,"SUNGAI DAENG, MUNTOK, BANGKA BARAT, KEPULAUAN BANGKA BELITUNG",2,106,104,210
https://kawalpemilu.org#25248,"SUNGAI DAENG, MUNTOK, BANGKA BARAT, KEPULAUAN BANGKA BELITUNG",3,105,68,173
https://kawalpemilu.org#25248,"SUNGAI DAENG, MUNTOK, BANGKA BARAT, KEPULAUAN BANGKA BELITUNG",4,187,22,209
https://kawalpemilu.org#25248,"SUNGAI DAENG, MUNTOK, BANGKA BARAT, KEPULAUAN BANGKA BELITUNG",5,137,60,197
https://kawalpemilu.org#25248,"SUNGAI DAENG, MUNTOK, BANGKA BARAT, KEPULAUAN BANGKA BELITUNG",6,113,66,179
https://kawalpemilu.org#25248,"SUNGAI DAENG, MUNTOK, BANGKA BARAT, KEPULAUAN BANGKA BELITUNG",7,128,74,202
https://kawalpemilu.org#25248,"SUNGAI DAENG, MUNTOK, BANGKA BARAT, KEPULAUAN BANGKA BELITUNG",8,108,109,217
https://kawalpemilu.org#25248,"SUNGAI DAENG, MUNTOK, BANGKA BARAT, KEPULAUAN BANGKA BELITUNG",9,104,87,191
https://kawalpemilu.org#25248,"SUNGAI DAENG, MUNTOK, BANGKA BARAT, KEPULAUAN BANGKA BELITUNG",10,124,142,266
https://kawalpemilu.org#25248,"SUNGAI DAENG, MUNTOK, BANGKA BARAT, KEPULAUAN BANGKA BELITUNG",11,145,84,229
https://kawalpemilu.org#25248,"SUNGAI DAENG, MUNTOK, BANGKA BARAT, KEPULAUAN BANGKA BELITUNG",12,145,90,235
https://kawalpemilu.org#25248,"SUNGAI DAENG, MUNTOK, BANGKA BARAT, KEPULAUAN BANGKA BELITUNG",13,119,102,221
https://kawalpemilu.org#25248,"SUNGAI DAENG, MUNTOK, BANGKA BARAT, KEPULAUAN BANGKA BELITUNG",14,135,87,222
https://kawalpemilu.org#25248,"SUNGAI DAENG, MUNTOK, BANGKA BARAT, KEPULAUAN BANGKA BELITUNG",15,131,96,227
https://kawalpemilu.org#25248,"SUNGAI DAENG, MUNTOK, BANGKA BARAT, KEPULAUAN BANGKA BELITUNG",16,143,96,239
https://kawalpemilu.org#25248,"SUNGAI DAENG, MUNTOK, BANGKA BARAT, KEPULAUAN BANGKA BELITUNG",17,133,66,199
https://kawalpemilu.org#25248,"SUNGAI DAENG, MUNTOK, BANGKA BARAT, KEPULAUAN BANGKA BELITUNG",18,85,75,160
https://kawalpemilu.org#25248,"SUNGAI DAENG, MUNTOK, BANGKA BARAT, KEPULAUAN BANGKA BELITUNG",19,127,119,246
https://kawalpemilu.org#25248,"SUNGAI DAENG, MUNTOK, BANGKA BARAT, KEPULAUAN BANGKA BELITUNG",20,194,24,218
https://kawalpemilu.org#25248,"SUNGAI DAENG, MUNTOK, BANGKA BARAT, KEPULAUAN BANGKA BELITUNG",21,82,51,133
https://kawalpemilu.org#25248,"SUNGAI DAENG, MUNTOK, BANGKA BARAT, KEPULAUAN BANGKA BELITUNG",22,111,35,136
https://kawalpemilu.org#25248,"SUNGAI DAENG, MUNTOK, BANGKA BARAT, KEPULAUAN BANGKA BELITUNG",23,108,77,185
https://kawalpemilu.org#25248,"SUNGAI DAENG, MUNTOK, BANGKA BARAT, KEPULAUAN BANGKA BELITUNG",24,88,42,130
https://kawalpemilu.org#25249,"SUNGAI BARU, MUNTOK, BANGKA BARAT, KEPULAUAN BANGKA BELITUNG",1,117,133,250
https://kawalpemilu.org#25249,"SUNGAI BARU, MUNTOK, BANGKA BARAT, KEPULAUAN BANGKA BELITUNG",2,107,86,193
https://kawalpemilu.org#25249,"SUNGAI BARU, MUNTOK, BANGKA BARAT, KEPULAUAN BANGKA BELITUNG",3,141,108,249
https://kawalpemilu.org#25249,"SUNGAI BARU, MUNTOK, BANGKA BARAT, KEPULAUAN BANGKA BELITUNG",4,85,121,206
https://kawalpemilu.org#25249,"SUNGAI BARU, MUNTOK, BANGKA BARAT, KEPULAUAN BANGKA BELITUNG",5,130,87,217
https://kawalpemilu.org#25249,"SUNGAI BARU, MUNTOK, BANGKA BARAT, KEPULAUAN BANGKA BELITUNG",6,109,89,198
https://kawalpemilu.org#25249,"SUNGAI BARU, MUNTOK, BANGKA BARAT, KEPULAUAN BANGKA BELITUNG",7,116,80,196
https://kawalpemilu.org#25249,"SUNGAI BARU, MUNTOK, BANGKA BARAT, KEPULAUAN BANGKA BELITUNG",8,131,95,226
https://kawalpemilu.org#25249,"SUNGAI BARU, MUNTOK, BANGKA BARAT, KEPULAUAN BANGKA BELITUNG",9,109,118,227
https://kawalpemilu.org#25249,"SUNGAI BARU, MUNTOK, BANGKA BARAT, KEPULAUAN BANGKA BELITUNG",10,79,113,192
https://kawalpemilu.org#25249,"SUNGAI BARU, MUNTOK, BANGKA BARAT, KEPULAUAN BANGKA BELITUNG",11,93,102,195
https://kawalpemilu.org#25249,"SUNGAI BARU, MUNTOK, BANGKA BARAT, KEPULAUAN BANGKA BELITUNG",12,119,97,216
https://kawalpemilu.org#25249,"SUNGAI BARU, MUNTOK, BANGKA BARAT, KEPULAUAN BANGKA BELITUNG",13,119,115,234
https://kawalpemilu.org#25249,"SUNGAI BARU, MUNTOK, BANGKA BARAT, KEPULAUAN BANGKA BELITUNG",14,92,151,243
https://kawalpemilu.org#25249,"SUNGAI BARU, MUNTOK, BANGKA BARAT, KEPULAUAN BANGKA BELITUNG",15,133,86,219
https://kawalpemilu.org#25249,"SUNGAI BARU, MUNTOK, BANGKA BARAT, KEPULAUAN BANGKA BELITUNG",16,115,94,209
https://kawalpemilu.org#25250,"AIR PUTIH, MUNTOK, BANGKA BARAT, KEPULAUAN BANGKA BELITUNG",1,137,67,204
https://kawalpemilu.org#25250,"AIR PUTIH, MUNTOK, BANGKA BARAT, KEPULAUAN BANGKA BELITUNG",2,107,90,197
https://kawalpemilu.org#25250,"AIR PUTIH, MUNTOK, BANGKA BARAT, KEPULAUAN BANGKA BELITUNG",3,119,78,197
https://kawalpemilu.org#25250,"AIR PUTIH, MUNTOK, BANGKA BARAT, KEPULAUAN BANGKA BELITUNG",4,149,16,165
https://kawalpemilu.org#25250,"AIR PUTIH, MUNTOK, BANGKA BARAT, KEPULAUAN BANGKA BELITUNG",5,140,14,154
https://kawalpemilu.org#25250,"AIR PUTIH, MUNTOK, BANGKA BARAT, KEPULAUAN BANGKA BELITUNG",6,100,59,159
https://kawalpemilu.org#25250,"AIR PUTIH, MUNTOK, BANGKA BARAT, KEPULAUAN BANGKA BELITUNG",7,154,20,174
https://kawalpemilu.org#25250,"AIR PUTIH, MUNTOK, BANGKA BARAT, KEPULAUAN BANGKA BELITUNG",8,152,17,169
https://kawalpemilu.org#25250,"AIR PUTIH, MUNTOK, BANGKA BARAT, KEPULAUAN BANGKA BELITUNG",9,118,80,198
https://kawalpemilu.org#25251,"AIR BELO, MUNTOK, BANGKA BARAT, KEPULAUAN BANGKA BELITUNG",1,150,45,195
https://kawalpemilu.org#25251,"AIR BELO, MUNTOK, BANGKA BARAT, KEPULAUAN BANGKA BELITUNG",2,151,58,209
https://kawalpemilu.org#25251,"AIR BELO, MUNTOK, BANGKA BARAT, KEPULAUAN BANGKA BELITUNG",3,125,106,231
https://kawalpemilu.org#25251,"AIR BELO, MUNTOK, BANGKA BARAT, KEPULAUAN BANGKA BELITUNG",4,156,30,186
https://kawalpemilu.org#25251,"AIR BELO, MUNTOK, BANGKA BARAT, KEPULAUAN BANGKA BELITUNG",5,131,110,241
https://kawalpemilu.org#25251,"AIR BELO, MUNTOK, BANGKA BARAT, KEPULAUAN BANGKA BELITUNG",6,149,66,215
https://kawalpemilu.org#25251,"AIR BELO, MUNTOK, BANGKA BARAT, KEPULAUAN BANGKA BELITUNG",7,158,62,220
https://kawalpemilu.org#25251,"AIR BELO, MUNTOK, BANGKA BARAT, KEPULAUAN BANGKA BELITUNG",8,146,51,197
https://kawalpemilu.org#25251,"AIR BELO, MUNTOK, BANGKA BARAT, KEPULAUAN BANGKA BELITUNG",9,133,76,209
https://kawalpemilu.org#25251,"AIR BELO, MUNTOK, BANGKA BARAT, KEPULAUAN BANGKA BELITUNG",10,127,106,233
https://kawalpemilu.org#25252,"BELO LAUT, MUNTOK, BANGKA BARAT, KEPULAUAN BANGKA BELITUNG",1,163,91,254
https://kawalpemilu.org#25252,"BELO LAUT, MUNTOK, BANGKA BARAT, KEPULAUAN BANGKA BELITUNG",2,76,144,220
https://kawalpemilu.org#25252,"BELO LAUT, MUNTOK, BANGKA BARAT, KEPULAUAN BANGKA BELITUNG",3,141,110,251
https://kawalpemilu.org#25252,"BELO LAUT, MUNTOK, BANGKA BARAT, KEPULAUAN BANGKA BELITUNG",4,102,98,200
https://kawalpemilu.org#25252,"BELO LAUT, MUNTOK, BANGKA BARAT, KEPULAUAN BANGKA BELITUNG",5,97,63,160
https://kawalpemilu.org#25252,"BELO LAUT, MUNTOK, BANGKA BARAT, KEPULAUAN BANGKA BELITUNG",6,159,80,239
https://kawalpemilu.org#25252,"BELO LAUT, MUNTOK, BANGKA BARAT, KEPULAUAN BANGKA BELITUNG",7,158,89,247
https://kawalpemilu.org#25252,"BELO LAUT, MUNTOK, BANGKA BARAT, KEPULAUAN BANGKA BELITUNG",8,140,111,251
https://kawalpemilu.org#25252,"BELO LAUT, MUNTOK, BANGKA BARAT, KEPULAUAN BANGKA BELITUNG",9,128,78,206
https://kawalpemilu.org#25252,"BELO LAUT, MUNTOK, BANGKA BARAT, KEPULAUAN BANGKA BELITUNG",10,160,111,271
https://kawalpemilu.org#25252,"BELO LAUT, MUNTOK, BANGKA BARAT, KEPULAUAN BANGKA BELITUNG",11,131,129,260
https://kawalpemilu.org#25252,"BELO LAUT, MUNTOK, BANGKA BARAT, KEPULAUAN BANGKA BELITUNG",12,120,132,252
https://kawalpemilu.org#25252,"BELO LAUT, MUNTOK, BANGKA BARAT, KEPULAUAN BANGKA BELITUNG",13,171,73,244
https://kawalpemilu.org#25252,"BELO LAUT, MUNTOK, BANGKA BARAT, KEPULAUAN BANGKA BELITUNG",14,185,61,246
https://kawalpemilu.org#25252,"BELO LAUT, MUNTOK, BANGKA BARAT, KEPULAUAN BANGKA BELITUNG",15,142,101,243
https://kawalpemilu.org#25252,"BELO LAUT, MUNTOK, BANGKA BARAT, KEPULAUAN BANGKA BELITUNG",16,180,80,260
https://kawalpemilu.org#25252,"BELO LAUT, MUNTOK, BANGKA BARAT, KEPULAUAN BANGKA BELITUNG",17,110,70,180
https://kawalpemilu.org#25252,"BELO LAUT, MUNTOK, BANGKA BARAT, KEPULAUAN BANGKA BELITUNG",18,104,58,162
https://kawalpemilu.org#25252,"BELO LAUT, MUNTOK, BANGKA BARAT, KEPULAUAN BANGKA BELITUNG",19,112,46,158
https://kawalpemilu.org#25252,"BELO LAUT, MUNTOK, BANGKA BARAT, KEPULAUAN BANGKA BELITUNG",20,166,59,225
https://kawalpemilu.org#25252,"BELO LAUT, MUNTOK, BANGKA BARAT, KEPULAUAN BANGKA BELITUNG",21,183,65,248
https://kawalpemilu.org#25252,"BELO LAUT, MUNTOK, BANGKA BARAT, KEPULAUAN BANGKA BELITUNG",22,93,78,171
https://kawalpemilu.org#25252,"BELO LAUT, MUNTOK, BANGKA BARAT, KEPULAUAN BANGKA BELITUNG",23,167,71,238
https://kawalpemilu.org#25252,"BELO LAUT, MUNTOK, BANGKA BARAT, KEPULAUAN BANGKA BELITUNG",24,139,18,157
https://kawalpemilu.org#25252,"BELO LAUT, MUNTOK, BANGKA BARAT, KEPULAUAN BANGKA BELITUNG",25,138,9,147
https://kawalpemilu.org#25252,"BELO LAUT, MUNTOK, BANGKA BARAT, KEPULAUAN BANGKA BELITUNG",26,130,53,183
https://kawalpemilu.org#25252,"BELO LAUT, MUNTOK, BANGKA BARAT, KEPULAUAN BANGKA BELITUNG",27,156,39,195
https://kawalpemilu.org#25252,"BELO LAUT, MUNTOK, BANGKA BARAT, KEPULAUAN BANGKA BELITUNG",28,165,88,253
https://kawalpemilu.org#25252,"BELO LAUT, MUNTOK, BANGKA BARAT, KEPULAUAN BANGKA BELITUNG",29,132,54,186
https://kawalpemilu.org#25252,"BELO LAUT, MUNTOK, BANGKA BARAT, KEPULAUAN BANGKA BELITUNG",30,89,44,133
https://kawalpemilu.org#25253,"AIR LIMAU, MUNTOK, BANGKA BARAT, KEPULAUAN BANGKA BELITUNG",1,176,38,214
https://kawalpemilu.org#25253,"AIR LIMAU, MUNTOK, BANGKA BARAT, KEPULAUAN BANGKA BELITUNG",2,178,25,203
https://kawalpemilu.org#25253,"AIR LIMAU, MUNTOK, BANGKA BARAT, KEPULAUAN BANGKA BELITUNG",3,160,47,207
https://kawalpemilu.org#25253,"AIR LIMAU, MUNTOK, BANGKA BARAT, KEPULAUAN BANGKA BELITUNG",4,165,42,207
https://kawalpemilu.org#25253,"AIR LIMAU, MUNTOK, BANGKA BARAT, KEPULAUAN BANGKA BELITUNG",5,172,18,190
https://kawalpemilu.org#25255,"PELANGAS, SIMPANG TERITIP, BANGKA BARAT, KEPULAUAN BANGKA BELITUNG",1,145,108,253
https://kawalpemilu.org#25255,"PELANGAS, SIMPANG TERITIP, BANGKA BARAT, KEPULAUAN BANGKA BELITUNG",2,142,98,240
https://kawalpemilu.org#25255,"PELANGAS, SIMPANG TERITIP, BANGKA BARAT, KEPULAUAN BANGKA BELITUNG",3,158,104,262
https://kawalpemilu.org#25255,"PELANGAS, SIMPANG TERITIP, BANGKA BARAT, KEPULAUAN BANGKA BELITUNG",4,197,42,239
https://kawalpemilu.org#25255,"PELANGAS, SIMPANG TERITIP, BANGKA BARAT, KEPULAUAN BANGKA BELITUNG",5,219,9,228
https://kawalpemilu.org#25256,"KUNDI, SIMPANG TERITIP, BANGKA BARAT, KEPULAUAN BANGKA BELITUNG",2,154,91,245
https://kawalpemilu.org#25256,"KUNDI, SIMPANG TERITIP, BANGKA BARAT, KEPULAUAN BANGKA BELITUNG",3,147,109,256
https://kawalpemilu.org#25256,"KUNDI, SIMPANG TERITIP, BANGKA BARAT, KEPULAUAN BANGKA BELITUNG",4,127,112,239
https://kawalpemilu.org#25256,"KUNDI, SIMPANG TERITIP, BANGKA BARAT, KEPULAUAN BANGKA BELITUNG",5,148,98,246
https://kawalpemilu.org#25256,"KUNDI, SIMPANG TERITIP, BANGKA BARAT, KEPULAUAN BANGKA BELITUNG",6,150,96,246
https://kawalpemilu.org#25257,"MAYANG, SIMPANG TERITIP, BANGKA BARAT, KEPULAUAN BANGKA BELITUNG",1,166,50,216
https://kawalpemilu.org#25257,"MAYANG, SIMPANG TERITIP, BANGKA BARAT, KEPULAUAN BANGKA BELITUNG",2,148,65,213
https://kawalpemilu.org#25257,"MAYANG, SIMPANG TERITIP, BANGKA BARAT, KEPULAUAN BANGKA BELITUNG",3,127,67,194
https://kawalpemilu.org#25257,"MAYANG, SIMPANG TERITIP, BANGKA BARAT, KEPULAUAN BANGKA BELITUNG",4,151,53,204
https://kawalpemilu.org#25257,"MAYANG, SIMPANG TERITIP, BANGKA BARAT, KEPULAUAN BANGKA BELITUNG",5,129,51,180
https://kawalpemilu.org#25257,"MAYANG, SIMPANG TERITIP, BANGKA BARAT, KEPULAUAN BANGKA BELITUNG",6,142,35,177
https://kawalpemilu.org#25257,"MAYANG, SIMPANG TERITIP, BANGKA BARAT, KEPULAUAN BANGKA BELITUNG",7,129,46,175
https://kawalpemilu.org#25258,"PERADONG, SIMPANG TERITIP, BANGKA BARAT, KEPULAUAN BANGKA BELITUNG",1,128,102,230
https://kawalpemilu.org#25258,"PERADONG, SIMPANG TERITIP, BANGKA BARAT, KEPULAUAN BANGKA BELITUNG",2,151,63,214
https://kawalpemilu.org#25258,"PERADONG, SIMPANG TERITIP, BANGKA BARAT, KEPULAUAN BANGKA BELITUNG",3,173,52,225
https://kawalpemilu.org#25258,"PERADONG, SIMPANG TERITIP, BANGKA BARAT, KEPULAUAN BANGKA BELITUNG",4,106,81,187
https://kawalpemilu.org#25258,"PERADONG, SIMPANG TERITIP, BANGKA BARAT, KEPULAUAN BANGKA BELITUNG",5,93,35,128
https://kawalpemilu.org#25259,"AIR NYATOH, SIMPANG TERITIP, BANGKA BARAT, KEPULAUAN BANGKA BELITUNG",1,145,79,224
https://kawalpemilu.org#25259,"AIR NYATOH, SIMPANG TERITIP, BANGKA BARAT, KEPULAUAN BANGKA BELITUNG",2,148,99,247
https://kawalpemilu.org#25259,"AIR NYATOH, SIMPANG TERITIP, BANGKA BARAT, KEPULAUAN BANGKA BELITUNG",3,155,80,235
https://kawalpemilu.org#25259,"AIR NYATOH, SIMPANG TERITIP, BANGKA BARAT, KEPULAUAN BANGKA BELITUNG",4,112,97,209
https://kawalpemilu.org#25259,"AIR NYATOH, SIMPANG TERITIP, BANGKA BARAT, KEPULAUAN BANGKA BELITUNG",5,164,68,232
https://kawalpemilu.org#25259,"AIR NYATOH, SIMPANG TERITIP, BANGKA BARAT, KEPULAUAN BANGKA BELITUNG",6,140,78,218
https://kawalpemilu.org#25259,"AIR NYATOH, SIMPANG TERITIP, BANGKA BARAT, KEPULAUAN BANGKA BELITUNG",7,142,68,210
https://kawalpemilu.org#25260,"BERANG, SIMPANG TERITIP, BANGKA BARAT, KEPULAUAN BANGKA BELITUNG",1,131,93,224
https://kawalpemilu.org#25260,"BERANG, SIMPANG TERITIP, BANGKA BARAT, KEPULAUAN BANGKA BELITUNG",3,127,94,221
https://kawalpemilu.org#25260,"BERANG, SIMPANG TERITIP, BANGKA BARAT, KEPULAUAN BANGKA BELITUNG",4,133,54,184
https://kawalpemilu.org#25260,"BERANG, SIMPANG TERITIP, BANGKA BARAT, KEPULAUAN BANGKA BELITUNG",5,151,41,192
https://kawalpemilu.org#25260,"BERANG, SIMPANG TERITIP, BANGKA BARAT, KEPULAUAN BANGKA BELITUNG",6,214,43,257
https://kawalpemilu.org#25260,"BERANG, SIMPANG TERITIP, BANGKA BARAT, KEPULAUAN BANGKA BELITUNG",7,158,30,188
https://kawalpemilu.org#25260,"BERANG, SIMPANG TERITIP, BANGKA BARAT, KEPULAUAN BANGKA BELITUNG",8,104,89,193
https://kawalpemilu.org#25260,"BERANG, SIMPANG TERITIP, BANGKA BARAT, KEPULAUAN BANGKA BELITUNG",9,130,26,156
https://kawalpemilu.org#25260,"BERANG, SIMPANG TERITIP, BANGKA BARAT, KEPULAUAN BANGKA BELITUNG",10,122,44,166
https://kawalpemilu.org#25261,"SIMPANG TIGA, SIMPANG TERITIP, BANGKA BARAT, KEPULAUAN BANGKA BELITUNG",1,142,114,256
https://kawalpemilu.org#25261,"SIMPANG TIGA, SIMPANG TERITIP, BANGKA BARAT, KEPULAUAN BANGKA BELITUNG",3,90,130,220
https://kawalpemilu.org#25261,"SIMPANG TIGA, SIMPANG TERITIP, BANGKA BARAT, KEPULAUAN BANGKA BELITUNG",4,105,117,222
https://kawalpemilu.org#25261,"SIMPANG TIGA, SIMPANG TERITIP, BANGKA BARAT, KEPULAUAN BANGKA BELITUNG",5,114,98,212
https://kawalpemilu.org#25262,"RAMBAT, SIMPANG TERITIP, BANGKA BARAT, KEPULAUAN BANGKA BELITUNG",1,167,9,176
https://kawalpemilu.org#25262,"RAMBAT, SIMPANG TERITIP, BANGKA BARAT, KEPULAUAN BANGKA BELITUNG",2,191,35,226
https://kawalpemilu.org#25262,"RAMBAT, SIMPANG TERITIP, BANGKA BARAT, KEPULAUAN BANGKA BELITUNG",3,147,52,199
https://kawalpemilu.org#25263,"SIMPANG GONG, SIMPANG TERITIP, BANGKA BARAT, KEPULAUAN BANGKA BELITUNG",1,130,62,192
https://kawalpemilu.org#25263,"SIMPANG GONG, SIMPANG TERITIP, BANGKA BARAT, KEPULAUAN BANGKA BELITUNG",2,134,78,212
https://kawalpemilu.org#25263,"SIMPANG GONG, SIMPANG TERITIP, BANGKA BARAT, KEPULAUAN BANGKA BELITUNG",3,173,73,246
https://kawalpemilu.org#25263,"SIMPANG GONG, SIMPANG TERITIP, BANGKA BARAT, KEPULAUAN BANGKA BELITUNG",4,48,34,82
https://kawalpemilu.org#25264,"IBUL, SIMPANG TERITIP, BANGKA BARAT, KEPULAUAN BANGKA BELITUNG",1,154,94,248
https://kawalpemilu.org#25264,"IBUL, SIMPANG TERITIP, BANGKA BARAT, KEPULAUAN BANGKA BELITUNG",2,130,101,231
https://kawalpemilu.org#25264,"IBUL, SIMPANG TERITIP, BANGKA BARAT, KEPULAUAN BANGKA BELITUNG",3,100,122,222
https://kawalpemilu.org#25264,"IBUL, SIMPANG TERITIP, BANGKA BARAT, KEPULAUAN BANGKA BELITUNG",4,135,91,226
https://kawalpemilu.org#25264,"IBUL, SIMPANG TERITIP, BANGKA BARAT, KEPULAUAN BANGKA BELITUNG",5,148,21,169
https://kawalpemilu.org#25264,"IBUL, SIMPANG TERITIP, BANGKA BARAT, KEPULAUAN BANGKA BELITUNG",6,70,38,108
https://kawalpemilu.org#25264,"IBUL, SIMPANG TERITIP, BANGKA BARAT, KEPULAUAN BANGKA BELITUNG",7,121,87,208
https://kawalpemilu.org#25264,"IBUL, SIMPANG TERITIP, BANGKA BARAT, KEPULAUAN BANGKA BELITUNG",8,139,71,210
https://kawalpemilu.org#25265,"PANGEK, SIMPANG TERITIP, BANGKA BARAT, KEPULAUAN BANGKA BELITUNG",1,163,59,222
https://kawalpemilu.org#25265,"PANGEK, SIMPANG TERITIP, BANGKA BARAT, KEPULAUAN BANGKA BELITUNG",2,111,86,197
https://kawalpemilu.org#25265,"PANGEK, SIMPANG TERITIP, BANGKA BARAT, KEPULAUAN BANGKA BELITUNG",3,129,93,222
https://kawalpemilu.org#25265,"PANGEK, SIMPANG TERITIP, BANGKA BARAT, KEPULAUAN BANGKA BELITUNG",4,129,89,218
https://kawalpemilu.org#25265,"PANGEK, SIMPANG TERITIP, BANGKA BARAT, KEPULAUAN BANGKA BELITUNG",5,155,75,230
https://kawalpemilu.org#25265,"PANGEK, SIMPANG TERITIP, BANGKA BARAT, KEPULAUAN BANGKA BELITUNG",6,156,65,221
https://kawalpemilu.org#25266,"BUKIT TERAK, SIMPANG TERITIP, BANGKA BARAT, KEPULAUAN BANGKA BELITUNG",1,117,122,239
https://kawalpemilu.org#25266,"BUKIT TERAK, SIMPANG TERITIP, BANGKA BARAT, KEPULAUAN BANGKA BELITUNG",2,108,118,226
https://kawalpemilu.org#25266,"BUKIT TERAK, SIMPANG TERITIP, BANGKA BARAT, KEPULAUAN BANGKA BELITUNG",3,99,130,229
https://kawalpemilu.org#25266,"BUKIT TERAK, SIMPANG TERITIP, BANGKA BARAT, KEPULAUAN BANGKA BELITUNG",4,107,132,233
https://kawalpemilu.org#25266,"BUKIT TERAK, SIMPANG TERITIP, BANGKA BARAT, KEPULAUAN BANGKA BELITUNG",5,114,110,224
https://kawalpemilu.org#25267,"AIR MENDUYUNG, SIMPANG TERITIP, BANGKA BARAT, KEPULAUAN BANGKA BELITUNG",1,220,14,234
https://kawalpemilu.org#25267,"AIR MENDUYUNG, SIMPANG TERITIP, BANGKA BARAT, KEPULAUAN BANGKA BELITUNG",2,55,88,143
https://kawalpemilu.org#25267,"AIR MENDUYUNG, SIMPANG TERITIP, BANGKA BARAT, KEPULAUAN BANGKA BELITUNG",3,108,82,190
https://kawalpemilu.org#25267,"AIR MENDUYUNG, SIMPANG TERITIP, BANGKA BARAT, KEPULAUAN BANGKA BELITUNG",4,126,80,206
https://kawalpemilu.org#25267,"AIR MENDUYUNG, SIMPANG TERITIP, BANGKA BARAT, KEPULAUAN BANGKA BELITUNG",5,120,104,224
https://kawalpemilu.org#25269,"JEBUS, JEBUS, BANGKA BARAT, KEPULAUAN BANGKA BELITUNG",1,107,140,247
https://kawalpemilu.org#25269,"JEBUS, JEBUS, BANGKA BARAT, KEPULAUAN BANGKA BELITUNG",2,67,165,232
https://kawalpemilu.org#25269,"JEBUS, JEBUS, BANGKA BARAT, KEPULAUAN BANGKA BELITUNG",3,87,136,223
https://kawalpemilu.org#25269,"JEBUS, JEBUS, BANGKA BARAT, KEPULAUAN BANGKA BELITUNG",4,211,21,232
https://kawalpemilu.org#25269,"JEBUS, JEBUS, BANGKA BARAT, KEPULAUAN BANGKA BELITUNG",5,190,81,271
https://kawalpemilu.org#25269,"JEBUS, JEBUS, BANGKA BARAT, KEPULAUAN BANGKA BELITUNG",6,186,52,238
https://kawalpemilu.org#25269,"JEBUS, JEBUS, BANGKA BARAT, KEPULAUAN BANGKA BELITUNG",7,174,62,236
https://kawalpemilu.org#25270,"SUNGAI BULUH, JEBUS, BANGKA BARAT, KEPULAUAN BANGKA BELITUNG",1,45,144,189
https://kawalpemilu.org#25270,"SUNGAI BULUH, JEBUS, BANGKA BARAT, KEPULAUAN BANGKA BELITUNG",2,52,153,205
https://kawalpemilu.org#25270,"SUNGAI BULUH, JEBUS, BANGKA BARAT, KEPULAUAN BANGKA BELITUNG",3,72,141,213
https://kawalpemilu.org#25270,"SUNGAI BULUH, JEBUS, BANGKA BARAT, KEPULAUAN BANGKA BELITUNG",4,187,54,241
https://kawalpemilu.org#25271,"TUMBAK PETAR, JEBUS, BANGKA BARAT, KEPULAUAN BANGKA BELITUNG",1,96,103,199
https://kawalpemilu.org#25271,"TUMBAK PETAR, JEBUS, BANGKA BARAT, KEPULAUAN BANGKA BELITUNG",2,115,73,188
https://kawalpemilu.org#25271,"TUMBAK PETAR, JEBUS, BANGKA BARAT, KEPULAUAN BANGKA BELITUNG",3,96,118,214
https://kawalpemilu.org#25271,"TUMBAK PETAR, JEBUS, BANGKA BARAT, KEPULAUAN BANGKA BELITUNG",4,80,130,210
https://kawalpemilu.org#25271,"TUMBAK PETAR, JEBUS, BANGKA BARAT, KEPULAUAN BANGKA BELITUNG",5,102,135,237
https://kawalpemilu.org#25271,"TUMBAK PETAR, JEBUS, BANGKA BARAT, KEPULAUAN BANGKA BELITUNG",6,118,126,244
https://kawalpemilu.org#25271,"TUMBAK PETAR, JEBUS, BANGKA BARAT, KEPULAUAN BANGKA BELITUNG",7,148,88,236
https://kawalpemilu.org#25272,"LIMBUNG, JEBUS, BANGKA BARAT, KEPULAUAN BANGKA BELITUNG",1,162,90,252
https://kawalpemilu.org#25272,"LIMBUNG, JEBUS, BANGKA BARAT, KEPULAUAN BANGKA BELITUNG",2,142,120,262
https://kawalpemilu.org#25273,"RUKAM, JEBUS, BANGKA BARAT, KEPULAUAN BANGKA BELITUNG",1,159,109,268
https://kawalpemilu.org#25273,"RUKAM, JEBUS, BANGKA BARAT, KEPULAUAN BANGKA BELITUNG",2,192,71,263
https://kawalpemilu.org#25273,"RUKAM, JEBUS, BANGKA BARAT, KEPULAUAN BANGKA BELITUNG",3,217,38,255
https://kawalpemilu.org#25274,"RANGGI ASAM, JEBUS, BANGKA BARAT, KEPULAUAN BANGKA BELITUNG",1,156,108,264
https://kawalpemilu.org#25274,"RANGGI ASAM, JEBUS, BANGKA BARAT, KEPULAUAN BANGKA BELITUNG",2,155,70,225
https://kawalpemilu.org#25274,"RANGGI ASAM, JEBUS, BANGKA BARAT, KEPULAUAN BANGKA BELITUNG",3,190,78,268
https://kawalpemilu.org#25274,"RANGGI ASAM, JEBUS, BANGKA BARAT, KEPULAUAN BANGKA BELITUNG",4,189,87,276
https://kawalpemilu.org#25274,"RANGGI ASAM, JEBUS, BANGKA BARAT, KEPULAUAN BANGKA BELITUNG",5,140,114,254
https://kawalpemilu.org#25274,"RANGGI ASAM, JEBUS, BANGKA BARAT, KEPULAUAN BANGKA BELITUNG",6,181,92,273
https://kawalpemilu.org#25275,"KETAP, JEBUS, BANGKA BARAT, KEPULAUAN BANGKA BELITUNG",1,155,93,248
https://kawalpemilu.org#25275,"KETAP, JEBUS, BANGKA BARAT, KEPULAUAN BANGKA BELITUNG",2,173,91,264
https://kawalpemilu.org#25275,"KETAP, JEBUS, BANGKA BARAT, KEPULAUAN BANGKA BELITUNG",3,166,74,240
https://kawalpemilu.org#25275,"KETAP, JEBUS, BANGKA BARAT, KEPULAUAN BANGKA BELITUNG",4,154,2,156
https://kawalpemilu.org#25275,"KETAP, JEBUS, BANGKA BARAT, KEPULAUAN BANGKA BELITUNG",5,152,23,175
https://kawalpemilu.org#25276,"MISLAK, JEBUS, BANGKA BARAT, KEPULAUAN BANGKA BELITUNG",1,153,90,243
https://kawalpemilu.org#25276,"MISLAK, JEBUS, BANGKA BARAT, KEPULAUAN BANGKA BELITUNG",2,169,78,247
https://kawalpemilu.org#25276,"MISLAK, JEBUS, BANGKA BARAT, KEPULAUAN BANGKA BELITUNG",3,162,90,252
https://kawalpemilu.org#25276,"MISLAK, JEBUS, BANGKA BARAT, KEPULAUAN BANGKA BELITUNG",4,161,96,257
https://kawalpemilu.org#25277,"PEBUAR, JEBUS, BANGKA BARAT, KEPULAUAN BANGKA BELITUNG",1,86,84,170
https://kawalpemilu.org#25277,"PEBUAR, JEBUS, BANGKA BARAT, KEPULAUAN BANGKA BELITUNG",2,73,131,204
https://kawalpemilu.org#25277,"PEBUAR, JEBUS, BANGKA BARAT, KEPULAUAN BANGKA BELITUNG",3,173,68,241
https://kawalpemilu.org#25278,"SINAR MANIK, JEBUS, BANGKA BARAT, KEPULAUAN BANGKA BELITUNG",1,166,81,247
https://kawalpemilu.org#25278,"SINAR MANIK, JEBUS, BANGKA BARAT, KEPULAUAN BANGKA BELITUNG",2,138,94,232
https://kawalpemilu.org#25278,"SINAR MANIK, JEBUS, BANGKA BARAT, KEPULAUAN BANGKA BELITUNG",3,146,62,208
https://kawalpemilu.org#25278,"SINAR MANIK, JEBUS, BANGKA BARAT, KEPULAUAN BANGKA BELITUNG",4,161,41,202
https://kawalpemilu.org#25278,"SINAR MANIK, JEBUS, BANGKA BARAT, KEPULAUAN BANGKA BELITUNG",5,180,67,247
https://kawalpemilu.org#25278,"SINAR MANIK, JEBUS, BANGKA BARAT, KEPULAUAN BANGKA BELITUNG",6,165,69,234
https://kawalpemilu.org#25279,"AIR KUANG, JEBUS, BANGKA BARAT, KEPULAUAN BANGKA BELITUNG",1,215,54,269
https://kawalpemilu.org#25279,"AIR KUANG, JEBUS, BANGKA BARAT, KEPULAUAN BANGKA BELITUNG",2,181,84,265
https://kawalpemilu.org#25279,"AIR KUANG, JEBUS, BANGKA BARAT, KEPULAUAN BANGKA BELITUNG",3,113,61,174
https://kawalpemilu.org#25279,"AIR KUANG, JEBUS, BANGKA BARAT, KEPULAUAN BANGKA BELITUNG",4,167,71,238
https://kawalpemilu.org#25279,"AIR KUANG, JEBUS, BANGKA BARAT, KEPULAUAN BANGKA BELITUNG",5,123,60,183
https://kawalpemilu.org#25279,"AIR KUANG, JEBUS, BANGKA BARAT, KEPULAUAN BANGKA BELITUNG",6,204,50,254
https://kawalpemilu.org#25281,"KELAPA, KELAPA, BANGKA BARAT, KEPULAUAN BANGKA BELITUNG",1,110,84,194
https://kawalpemilu.org#25281,"KELAPA, KELAPA, BANGKA BARAT, KEPULAUAN BANGKA BELITUNG",2,165,60,225
https://kawalpemilu.org#25281,"KELAPA, KELAPA, BANGKA BARAT, KEPULAUAN BANGKA BELITUNG",3,162,64,226
https://kawalpemilu.org#25281,"KELAPA, KELAPA, BANGKA BARAT, KEPULAUAN BANGKA BELITUNG",4,148,70,218
https://kawalpemilu.org#25281,"KELAPA, KELAPA, BANGKA BARAT, KEPULAUAN BANGKA BELITUNG",5,148,67,215
https://kawalpemilu.org#25281,"KELAPA, KELAPA, BANGKA BARAT, KEPULAUAN BANGKA BELITUNG",6,162,48,210
https://kawalpemilu.org#25281,"KELAPA, KELAPA, BANGKA BARAT, KEPULAUAN BANGKA BELITUNG",7,112,87,199
https://kawalpemilu.org#25281,"KELAPA, KELAPA, BANGKA BARAT, KEPULAUAN BANGKA BELITUNG",8,97,83,180
https://kawalpemilu.org#25281,"KELAPA, KELAPA, BANGKA BARAT, KEPULAUAN BANGKA BELITUNG",9,90,110,200
https://kawalpemilu.org#25281,"KELAPA, KELAPA, BANGKA BARAT, KEPULAUAN BANGKA BELITUNG",10,159,57,216
https://kawalpemilu.org#25281,"KELAPA, KELAPA, BANGKA BARAT, KEPULAUAN BANGKA BELITUNG",11,101,102,203
https://kawalpemilu.org#25281,"KELAPA, KELAPA, BANGKA BARAT, KEPULAUAN BANGKA BELITUNG",12,96,94,190
https://kawalpemilu.org#25281,"KELAPA, KELAPA, BANGKA BARAT, KEPULAUAN BANGKA BELITUNG",13,122,67,189
https://kawalpemilu.org#25281,"KELAPA, KELAPA, BANGKA BARAT, KEPULAUAN BANGKA BELITUNG",14,113,100,213
https://kawalpemilu.org#25281,"KELAPA, KELAPA, BANGKA BARAT, KEPULAUAN BANGKA BELITUNG",15,106,119,225
https://kawalpemilu.org#25281,"KELAPA, KELAPA, BANGKA BARAT, KEPULAUAN BANGKA BELITUNG",16,99,111,210
https://kawalpemilu.org#25281,"KELAPA, KELAPA, BANGKA BARAT, KEPULAUAN BANGKA BELITUNG",17,101,101,202
https://kawalpemilu.org#25281,"KELAPA, KELAPA, BANGKA BARAT, KEPULAUAN BANGKA BELITUNG",18,114,98,212
https://kawalpemilu.org#25281,"KELAPA, KELAPA, BANGKA BARAT, KEPULAUAN BANGKA BELITUNG",19,86,109,195
https://kawalpemilu.org#25282,"MANCUNG, KELAPA, BANGKA BARAT, KEPULAUAN BANGKA BELITUNG",1,185,73,258
https://kawalpemilu.org#25282,"MANCUNG, KELAPA, BANGKA BARAT, KEPULAUAN BANGKA BELITUNG",2,171,67,238
https://kawalpemilu.org#25282,"MANCUNG, KELAPA, BANGKA BARAT, KEPULAUAN BANGKA BELITUNG",3,212,59,271
https://kawalpemilu.org#25282,"MANCUNG, KELAPA, BANGKA BARAT, KEPULAUAN BANGKA BELITUNG",4,171,74,245
https://kawalpemilu.org#25283,"KAYU ARANG, KELAPA, BANGKA BARAT, KEPULAUAN BANGKA BELITUNG",1,193,59,252
https://kawalpemilu.org#25283,"KAYU ARANG, KELAPA, BANGKA BARAT, KEPULAUAN BANGKA BELITUNG",2,152,74,226
https://kawalpemilu.org#25283,"KAYU ARANG, KELAPA, BANGKA BARAT, KEPULAUAN BANGKA BELITUNG",3,184,54,238
https://kawalpemilu.org#25283,"KAYU ARANG, KELAPA, BANGKA BARAT, KEPULAUAN BANGKA BELITUNG",4,122,88,210
https://kawalpemilu.org#25283,"KAYU ARANG, KELAPA, BANGKA BARAT, KEPULAUAN BANGKA BELITUNG",5,57,108,165
https://kawalpemilu.org#25284,"PUSUK, KELAPA, BANGKA BARAT, KEPULAUAN BANGKA BELITUNG",1,98,131,229
https://kawalpemilu.org#25284,"PUSUK, KELAPA, BANGKA BARAT, KEPULAUAN BANGKA BELITUNG",2,116,130,246
https://kawalpemilu.org#25284,"PUSUK, KELAPA, BANGKA BARAT, KEPULAUAN BANGKA BELITUNG",3,118,121,239
https://kawalpemilu.org#25284,"PUSUK, KELAPA, BANGKA BARAT, KEPULAUAN BANGKA BELITUNG",4,162,88,250
https://kawalpemilu.org#25284,"PUSUK, KELAPA, BANGKA BARAT, KEPULAUAN BANGKA BELITUNG",5,191,69,260
https://kawalpemilu.org#25285,"DENDANG, KELAPA, BANGKA BARAT, KEPULAUAN BANGKA BELITUNG",1,132,96,228
https://kawalpemilu.org#25285,"DENDANG, KELAPA, BANGKA BARAT, KEPULAUAN BANGKA BELITUNG",2,90,127,217
https://kawalpemilu.org#25285,"DENDANG, KELAPA, BANGKA BARAT, KEPULAUAN BANGKA BELITUNG",3,91,176,267
https://kawalpemilu.org#25285,"DENDANG, KELAPA, BANGKA BARAT, KEPULAUAN BANGKA BELITUNG",4,120,134,254
https://kawalpemilu.org#25285,"DENDANG, KELAPA, BANGKA BARAT, KEPULAUAN BANGKA BELITUNG",5,122,149,271
https://kawalpemilu.org#25285,"DENDANG, KELAPA, BANGKA BARAT, KEPULAUAN BANGKA BELITUNG",6,157,115,272
https://kawalpemilu.org#25285,"DENDANG, KELAPA, BANGKA BARAT, KEPULAUAN BANGKA BELITUNG",7,191,59,250
https://kawalpemilu.org#25285,"DENDANG, KELAPA, BANGKA BARAT, KEPULAUAN BANGKA BELITUNG",8,149,88,237
https://kawalpemilu.org#25285,"DENDANG, KELAPA, BANGKA BARAT, KEPULAUAN BANGKA BELITUNG",9,155,76,231
https://kawalpemilu.org#25285,"DENDANG, KELAPA, BANGKA BARAT, KEPULAUAN BANGKA BELITUNG",10,180,39,219
https://kawalpemilu.org#25285,"DENDANG, KELAPA, BANGKA BARAT, KEPULAUAN BANGKA BELITUNG",11,137,34,171
https://kawalpemilu.org#25285,"DENDANG, KELAPA, BANGKA BARAT, KEPULAUAN BANGKA BELITUNG",12,148,47,195
https://kawalpemilu.org#25286,"KACUNG, KELAPA, BANGKA BARAT, KEPULAUAN BANGKA BELITUNG",1,161,78,239
https://kawalpemilu.org#25286,"KACUNG, KELAPA, BANGKA BARAT, KEPULAUAN BANGKA BELITUNG",2,179,98,277
https://kawalpemilu.org#25286,"KACUNG, KELAPA, BANGKA BARAT, KEPULAUAN BANGKA BELITUNG",3,179,94,273
https://kawalpemilu.org#25286,"KACUNG, KELAPA, BANGKA BARAT, KEPULAUAN BANGKA BELITUNG",4,127,70,197
https://kawalpemilu.org#25286,"KACUNG, KELAPA, BANGKA BARAT, KEPULAUAN BANGKA BELITUNG",5,158,56,214
https://kawalpemilu.org#25286,"KACUNG, KELAPA, BANGKA BARAT, KEPULAUAN BANGKA BELITUNG",6,161,90,251
https://kawalpemilu.org#25287,"SINAR SARI, KELAPA, BANGKA BARAT, KEPULAUAN BANGKA BELITUNG",1,154,85,239
https://kawalpemilu.org#25287,"SINAR SARI, KELAPA, BANGKA BARAT, KEPULAUAN BANGKA BELITUNG",2,190,56,246
https://kawalpemilu.org#25287,"SINAR SARI, KELAPA, BANGKA BARAT, KEPULAUAN BANGKA BELITUNG",3,150,59,209
https://kawalpemilu.org#25287,"SINAR SARI, KELAPA, BANGKA BARAT, KEPULAUAN BANGKA BELITUNG",4,145,94,239
https://kawalpemilu.org#25288,"BERUAS, KELAPA, BANGKA BARAT, KEPULAUAN BANGKA BELITUNG",1,144,108,252
https://kawalpemilu.org#25288,"BERUAS, KELAPA, BANGKA BARAT, KEPULAUAN BANGKA BELITUNG",2,226,42,268
https://kawalpemilu.org#25288,"BERUAS, KELAPA, BANGKA BARAT, KEPULAUAN BANGKA BELITUNG",3,202,63,265
https://kawalpemilu.org#25288,"BERUAS, KELAPA, BANGKA BARAT, KEPULAUAN BANGKA BELITUNG",4,200,73,273
https://kawalpemilu.org#25289,"TEBING, KELAPA, BANGKA BARAT, KEPULAUAN BANGKA BELITUNG",1,134,134,268
https://kawalpemilu.org#25289,"TEBING, KELAPA, BANGKA BARAT, KEPULAUAN BANGKA BELITUNG",2,206,67,273
https://kawalpemilu.org#25289,"TEBING, KELAPA, BANGKA BARAT, KEPULAUAN BANGKA BELITUNG",3,167,106,273
https://kawalpemilu.org#25290,"AIR BULIN, KELAPA, BANGKA BARAT, KEPULAUAN BANGKA BELITUNG",1,182,40,222
https://kawalpemilu.org#25290,"AIR BULIN, KELAPA, BANGKA BARAT, KEPULAUAN BANGKA BELITUNG",2,131,127,258
https://kawalpemilu.org#25290,"AIR BULIN, KELAPA, BANGKA BARAT, KEPULAUAN BANGKA BELITUNG",3,197,46,243
https://kawalpemilu.org#25290,"AIR BULIN, KELAPA, BANGKA BARAT, KEPULAUAN BANGKA BELITUNG",4,161,28,189
https://kawalpemilu.org#25290,"AIR BULIN, KELAPA, BANGKA BARAT, KEPULAUAN BANGKA BELITUNG",5,188,54,242
https://kawalpemilu.org#25291,"TERENTANG, KELAPA, BANGKA BARAT, KEPULAUAN BANGKA BELITUNG",1,181,44,225
https://kawalpemilu.org#25291,"TERENTANG, KELAPA, BANGKA BARAT, KEPULAUAN BANGKA BELITUNG",2,175,37,212
https://kawalpemilu.org#25291,"TERENTANG, KELAPA, BANGKA BARAT, KEPULAUAN BANGKA BELITUNG",3,112,49,161
https://kawalpemilu.org#25291,"TERENTANG, KELAPA, BANGKA BARAT, KEPULAUAN BANGKA BELITUNG",4,158,75,233
https://kawalpemilu.org#25291,"TERENTANG, KELAPA, BANGKA BARAT, KEPULAUAN BANGKA BELITUNG",5,165,57,222
https://kawalpemilu.org#25291,"TERENTANG, KELAPA, BANGKA BARAT, KEPULAUAN BANGKA BELITUNG",6,96,35,131
https://kawalpemilu.org#25291,"TERENTANG, KELAPA, BANGKA BARAT, KEPULAUAN BANGKA BELITUNG",7,163,84,247
https://kawalpemilu.org#25292,"TUGANG, KELAPA, BANGKA BARAT, KEPULAUAN BANGKA BELITUNG",1,142,104,246
https://kawalpemilu.org#25292,"TUGANG, KELAPA, BANGKA BARAT, KEPULAUAN BANGKA BELITUNG",2,143,106,249
https://kawalpemilu.org#25292,"TUGANG, KELAPA, BANGKA BARAT, KEPULAUAN BANGKA BELITUNG",3,196,57,253
https://kawalpemilu.org#25292,"TUGANG, KELAPA, BANGKA BARAT, KEPULAUAN BANGKA BELITUNG",4,169,69,238
https://kawalpemilu.org#25292,"TUGANG, KELAPA, BANGKA BARAT, KEPULAUAN BANGKA BELITUNG",5,125,126,251
https://kawalpemilu.org#25292,"TUGANG, KELAPA, BANGKA BARAT, KEPULAUAN BANGKA BELITUNG",6,117,11,128
https://kawalpemilu.org#25292,"TUGANG, KELAPA, BANGKA BARAT, KEPULAUAN BANGKA BELITUNG",7,183,43,226
https://kawalpemilu.org#25292,"TUGANG, KELAPA, BANGKA BARAT, KEPULAUAN BANGKA BELITUNG",8,198,59,257
https://kawalpemilu.org#25293,"TUIK, KELAPA, BANGKA BARAT, KEPULAUAN BANGKA BELITUNG",1,74,142,216
https://kawalpemilu.org#25293,"TUIK, KELAPA, BANGKA BARAT, KEPULAUAN BANGKA BELITUNG",2,94,124,218
https://kawalpemilu.org#25294,"PANGKAL BERAS, KELAPA, BANGKA BARAT, KEPULAUAN BANGKA BELITUNG",1,103,93,196
https://kawalpemilu.org#25294,"PANGKAL BERAS, KELAPA, BANGKA BARAT, KEPULAUAN BANGKA BELITUNG",2,68,110,178
https://kawalpemilu.org#25294,"PANGKAL BERAS, KELAPA, BANGKA BARAT, KEPULAUAN BANGKA BELITUNG",3,215,44,259
https://kawalpemilu.org#25294,"PANGKAL BERAS, KELAPA, BANGKA BARAT, KEPULAUAN BANGKA BELITUNG",4,101,68,169
https://kawalpemilu.org#25294,"PANGKAL BERAS, KELAPA, BANGKA BARAT, KEPULAUAN BANGKA BELITUNG",5,47,29,76
https://kawalpemilu.org#25294,"PANGKAL BERAS, KELAPA, BANGKA BARAT, KEPULAUAN BANGKA BELITUNG",6,75,98,173
https://kawalpemilu.org#25296,"TEMPILANG, TEMPILANG, BANGKA BARAT, KEPULAUAN BANGKA BELITUNG",1,185,82,267
https://kawalpemilu.org#25296,"TEMPILANG, TEMPILANG, BANGKA BARAT, KEPULAUAN BANGKA BELITUNG",2,201,80,281
https://kawalpemilu.org#25296,"TEMPILANG, TEMPILANG, BANGKA BARAT, KEPULAUAN BANGKA BELITUNG",3,182,67,249
https://kawalpemilu.org#25296,"TEMPILANG, TEMPILANG, BANGKA BARAT, KEPULAUAN BANGKA BELITUNG",4,130,32,162
https://kawalpemilu.org#25296,"TEMPILANG, TEMPILANG, BANGKA BARAT, KEPULAUAN BANGKA BELITUNG",5,152,52,204
https://kawalpemilu.org#25296,"TEMPILANG, TEMPILANG, BANGKA BARAT, KEPULAUAN BANGKA BELITUNG",6,117,59,176
https://kawalpemilu.org#25296,"TEMPILANG, TEMPILANG, BANGKA BARAT, KEPULAUAN BANGKA BELITUNG",7,106,47,153
https://kawalpemilu.org#25296,"TEMPILANG, TEMPILANG, BANGKA BARAT, KEPULAUAN BANGKA BELITUNG",8,159,45,204
https://kawalpemilu.org#25296,"TEMPILANG, TEMPILANG, BANGKA BARAT, KEPULAUAN BANGKA BELITUNG",9,152,44,196
https://kawalpemilu.org#25296,"TEMPILANG, TEMPILANG, BANGKA BARAT, KEPULAUAN BANGKA BELITUNG",10,142,69,211
https://kawalpemilu.org#25296,"TEMPILANG, TEMPILANG, BANGKA BARAT, KEPULAUAN BANGKA BELITUNG",11,215,35,250
https://kawalpemilu.org#25296,"TEMPILANG, TEMPILANG, BANGKA BARAT, KEPULAUAN BANGKA BELITUNG",12,210,50,260
https://kawalpemilu.org#25297,"TANJUNG NIUR, TEMPILANG, BANGKA BARAT, KEPULAUAN BANGKA BELITUNG",1,182,52,234
https://kawalpemilu.org#25297,"TANJUNG NIUR, TEMPILANG, BANGKA BARAT, KEPULAUAN BANGKA BELITUNG",2,178,54,232
https://kawalpemilu.org#25297,"TANJUNG NIUR, TEMPILANG, BANGKA BARAT, KEPULAUAN BANGKA BELITUNG",3,180,51,231
https://kawalpemilu.org#25297,"TANJUNG NIUR, TEMPILANG, BANGKA BARAT, KEPULAUAN BANGKA BELITUNG",4,165,51,216
https://kawalpemilu.org#25297,"TANJUNG NIUR, TEMPILANG, BANGKA BARAT, KEPULAUAN BANGKA BELITUNG",5,171,52,223
https://kawalpemilu.org#25297,"TANJUNG NIUR, TEMPILANG, BANGKA BARAT, KEPULAUAN BANGKA BELITUNG",6,180,56,236
https://kawalpemilu.org#25297,"TANJUNG NIUR, TEMPILANG, BANGKA BARAT, KEPULAUAN BANGKA BELITUNG",7,136,49,185
https://kawalpemilu.org#25297,"TANJUNG NIUR, TEMPILANG, BANGKA BARAT, KEPULAUAN BANGKA BELITUNG",8,181,33,214
https://kawalpemilu.org#25297,"TANJUNG NIUR, TEMPILANG, BANGKA BARAT, KEPULAUAN BANGKA BELITUNG",9,68,26,94
https://kawalpemilu.org#25298,"SANGKU, TEMPILANG, BANGKA BARAT, KEPULAUAN BANGKA BELITUNG",1,175,70,245
https://kawalpemilu.org#25298,"SANGKU, TEMPILANG, BANGKA BARAT, KEPULAUAN BANGKA BELITUNG",2,141,106,247
https://kawalpemilu.org#25298,"SANGKU, TEMPILANG, BANGKA BARAT, KEPULAUAN BANGKA BELITUNG",3,106,113,219
https://kawalpemilu.org#25298,"SANGKU, TEMPILANG, BANGKA BARAT, KEPULAUAN BANGKA BELITUNG",4,136,139,275
https://kawalpemilu.org#25298,"SANGKU, TEMPILANG, BANGKA BARAT, KEPULAUAN BANGKA BELITUNG",5,139,45,184
https://kawalpemilu.org#25298,"SANGKU, TEMPILANG, BANGKA BARAT, KEPULAUAN BANGKA BELITUNG",6,114,31,145
https://kawalpemilu.org#25298,"SANGKU, TEMPILANG, BANGKA BARAT, KEPULAUAN BANGKA BELITUNG",7,62,48,110
https://kawalpemilu.org#25299,"BUYAN KELUMBI, TEMPILANG, BANGKA BARAT, KEPULAUAN BANGKA BELITUNG",1,130,115,245
https://kawalpemilu.org#25299,"BUYAN KELUMBI, TEMPILANG, BANGKA BARAT, KEPULAUAN BANGKA BELITUNG",2,125,144,269
https://kawalpemilu.org#25299,"BUYAN KELUMBI, TEMPILANG, BANGKA BARAT, KEPULAUAN BANGKA BELITUNG",3,49,144,193
https://kawalpemilu.org#25299,"BUYAN KELUMBI, TEMPILANG, BANGKA BARAT, KEPULAUAN BANGKA BELITUNG",4,105,136,241
https://kawalpemilu.org#25300,"PENYAMPAK, TEMPILANG, BANGKA BARAT, KEPULAUAN BANGKA BELITUNG",1,107,137,244
https://kawalpemilu.org#25300,"PENYAMPAK, TEMPILANG, BANGKA BARAT, KEPULAUAN BANGKA BELITUNG",2,80,106,186
https://kawalpemilu.org#25300,"PENYAMPAK, TEMPILANG, BANGKA BARAT, KEPULAUAN BANGKA BELITUNG",3,100,115,215
https://kawalpemilu.org#25300,"PENYAMPAK, TEMPILANG, BANGKA BARAT, KEPULAUAN BANGKA BELITUNG",4,109,87,196
https://kawalpemilu.org#25300,"PENYAMPAK, TEMPILANG, BANGKA BARAT, KEPULAUAN BANGKA BELITUNG",5,151,95,246
https://kawalpemilu.org#25300,"PENYAMPAK, TEMPILANG, BANGKA BARAT, KEPULAUAN BANGKA BELITUNG",6,89,98,187
https://kawalpemilu.org#25300,"PENYAMPAK, TEMPILANG, BANGKA BARAT, KEPULAUAN BANGKA BELITUNG",7,79,97,176
https://kawalpemilu.org#25300,"PENYAMPAK, TEMPILANG, BANGKA BARAT, KEPULAUAN BANGKA BELITUNG",8,109,115,224
https://kawalpemilu.org#25301,"BENTENG KOTA, TEMPILANG, BANGKA BARAT, KEPULAUAN BANGKA BELITUNG",1,170,63,233
https://kawalpemilu.org#25301,"BENTENG KOTA, TEMPILANG, BANGKA BARAT, KEPULAUAN BANGKA BELITUNG",2,191,64,255
https://kawalpemilu.org#25301,"BENTENG KOTA, TEMPILANG, BANGKA BARAT, KEPULAUAN BANGKA BELITUNG",3,144,64,213
https://kawalpemilu.org#25301,"BENTENG KOTA, TEMPILANG, BANGKA BARAT, KEPULAUAN BANGKA BELITUNG",4,144,78,222
https://kawalpemilu.org#25301,"BENTENG KOTA, TEMPILANG, BANGKA BARAT, KEPULAUAN BANGKA BELITUNG",5,182,55,237
https://kawalpemilu.org#25301,"BENTENG KOTA, TEMPILANG, BANGKA BARAT, KEPULAUAN BANGKA BELITUNG",6,174,74,248
https://kawalpemilu.org#25301,"BENTENG KOTA, TEMPILANG, BANGKA BARAT, KEPULAUAN BANGKA BELITUNG",7,199,55,254
https://kawalpemilu.org#25301,"BENTENG KOTA, TEMPILANG, BANGKA BARAT, KEPULAUAN BANGKA BELITUNG",8,183,57,240
https://kawalpemilu.org#25301,"BENTENG KOTA, TEMPILANG, BANGKA BARAT, KEPULAUAN BANGKA BELITUNG",9,185,55,240
https://kawalpemilu.org#25302,"AIR LINTANG, TEMPILANG, BANGKA BARAT, KEPULAUAN BANGKA BELITUNG",1,195,41,236
https://kawalpemilu.org#25302,"AIR LINTANG, TEMPILANG, BANGKA BARAT, KEPULAUAN BANGKA BELITUNG",2,166,50,216
https://kawalpemilu.org#25302,"AIR LINTANG, TEMPILANG, BANGKA BARAT, KEPULAUAN BANGKA BELITUNG",3,165,52,217
https://kawalpemilu.org#25302,"AIR LINTANG, TEMPILANG, BANGKA BARAT, KEPULAUAN BANGKA BELITUNG",4,183,72,255
https://kawalpemilu.org#25302,"AIR LINTANG, TEMPILANG, BANGKA BARAT, KEPULAUAN BANGKA BELITUNG",5,182,55,237
https://kawalpemilu.org#25302,"AIR LINTANG, TEMPILANG, BANGKA BARAT, KEPULAUAN BANGKA BELITUNG",6,190,42,232
https://kawalpemilu.org#25302,"AIR LINTANG, TEMPILANG, BANGKA BARAT, KEPULAUAN BANGKA BELITUNG",7,185,48,233
https://kawalpemilu.org#25302,"AIR LINTANG, TEMPILANG, BANGKA BARAT, KEPULAUAN BANGKA BELITUNG",8,176,60,236
https://kawalpemilu.org#25302,"AIR LINTANG, TEMPILANG, BANGKA BARAT, KEPULAUAN BANGKA BELITUNG",9,201,37,238
https://kawalpemilu.org#25302,"AIR LINTANG, TEMPILANG, BANGKA BARAT, KEPULAUAN BANGKA BELITUNG",10,170,52,222
https://kawalpemilu.org#25302,"AIR LINTANG, TEMPILANG, BANGKA BARAT, KEPULAUAN BANGKA BELITUNG",11,140,36,176
https://kawalpemilu.org#25303,"SINAR SURYA, TEMPILANG, BANGKA BARAT, KEPULAUAN BANGKA BELITUNG",1,215,38,253
https://kawalpemilu.org#25303,"SINAR SURYA, TEMPILANG, BANGKA BARAT, KEPULAUAN BANGKA BELITUNG",2,190,44,234
https://kawalpemilu.org#25303,"SINAR SURYA, TEMPILANG, BANGKA BARAT, KEPULAUAN BANGKA BELITUNG",3,160,42,202
https://kawalpemilu.org#25303,"SINAR SURYA, TEMPILANG, BANGKA BARAT, KEPULAUAN BANGKA BELITUNG",4,194,54,248
https://kawalpemilu.org#25303,"SINAR SURYA, TEMPILANG, BANGKA BARAT, KEPULAUAN BANGKA BELITUNG",5,169,64,233
https://kawalpemilu.org#25304,"SIMPANG YUL, TEMPILANG, BANGKA BARAT, KEPULAUAN BANGKA BELITUNG",1,52,139,191
https://kawalpemilu.org#25304,"SIMPANG YUL, TEMPILANG, BANGKA BARAT, KEPULAUAN BANGKA BELITUNG",2,23,162,185
https://kawalpemilu.org#25304,"SIMPANG YUL, TEMPILANG, BANGKA BARAT, KEPULAUAN BANGKA BELITUNG",3,74,154,228
https://kawalpemilu.org#25304,"SIMPANG YUL, TEMPILANG, BANGKA BARAT, KEPULAUAN BANGKA BELITUNG",4,71,167,238
https://kawalpemilu.org#25304,"SIMPANG YUL, TEMPILANG, BANGKA BARAT, KEPULAUAN BANGKA BELITUNG",5,58,194,252
https://kawalpemilu.org#25304,"SIMPANG YUL, TEMPILANG, BANGKA BARAT, KEPULAUAN BANGKA BELITUNG",6,58,208,266
https://kawalpemilu.org#25304,"SIMPANG YUL, TEMPILANG, BANGKA BARAT, KEPULAUAN BANGKA BELITUNG",7,92,100,192
https://kawalpemilu.org#25304,"SIMPANG YUL, TEMPILANG, BANGKA BARAT, KEPULAUAN BANGKA BELITUNG",8,112,66,178
https://kawalpemilu.org#25304,"SIMPANG YUL, TEMPILANG, BANGKA BARAT, KEPULAUAN BANGKA BELITUNG",9,41,102,143
https://kawalpemilu.org#25306,"SEKAR BIRU, PARITTIGA, BANGKA BARAT, KEPULAUAN BANGKA BELITUNG",1,144,102,246
https://kawalpemilu.org#25306,"SEKAR BIRU, PARITTIGA, BANGKA BARAT, KEPULAUAN BANGKA BELITUNG",2,148,46,194
https://kawalpemilu.org#25306,"SEKAR BIRU, PARITTIGA, BANGKA BARAT, KEPULAUAN BANGKA BELITUNG",3,166,43,209
https://kawalpemilu.org#25306,"SEKAR BIRU, PARITTIGA, BANGKA BARAT, KEPULAUAN BANGKA BELITUNG",4,147,73,220
https://kawalpemilu.org#25306,"SEKAR BIRU, PARITTIGA, BANGKA BARAT, KEPULAUAN BANGKA BELITUNG",5,160,84,244
https://kawalpemilu.org#25306,"SEKAR BIRU, PARITTIGA, BANGKA BARAT, KEPULAUAN BANGKA BELITUNG",6,163,62,225
https://kawalpemilu.org#25306,"SEKAR BIRU, PARITTIGA, BANGKA BARAT, KEPULAUAN BANGKA BELITUNG",7,154,79,233
https://kawalpemilu.org#25306,"SEKAR BIRU, PARITTIGA, BANGKA BARAT, KEPULAUAN BANGKA BELITUNG",8,151,88,239
https://kawalpemilu.org#25306,"SEKAR BIRU, PARITTIGA, BANGKA BARAT, KEPULAUAN BANGKA BELITUNG",9,149,70,219
https://kawalpemilu.org#25306,"SEKAR BIRU, PARITTIGA, BANGKA BARAT, KEPULAUAN BANGKA BELITUNG",10,147,67,214
https://kawalpemilu.org#25307,"TELAK, PARITTIGA, BANGKA BARAT, KEPULAUAN BANGKA BELITUNG",1,113,153,266
https://kawalpemilu.org#25307,"TELAK, PARITTIGA, BANGKA BARAT, KEPULAUAN BANGKA BELITUNG",2,146,126,272
https://kawalpemilu.org#25307,"TELAK, PARITTIGA, BANGKA BARAT, KEPULAUAN BANGKA BELITUNG",3,165,100,265
https://kawalpemilu.org#25307,"TELAK, PARITTIGA, BANGKA BARAT, KEPULAUAN BANGKA BELITUNG",4,199,57,256
https://kawalpemilu.org#25308,"CUPAT, PARITTIGA, BANGKA BARAT, KEPULAUAN BANGKA BELITUNG",1,197,14,211
https://kawalpemilu.org#25308,"CUPAT, PARITTIGA, BANGKA BARAT, KEPULAUAN BANGKA BELITUNG",2,215,19,234
https://kawalpemilu.org#25308,"CUPAT, PARITTIGA, BANGKA BARAT, KEPULAUAN BANGKA BELITUNG",3,206,41,247
https://kawalpemilu.org#25308,"CUPAT, PARITTIGA, BANGKA BARAT, KEPULAUAN BANGKA BELITUNG",4,212,40,252
https://kawalpemilu.org#25308,"CUPAT, PARITTIGA, BANGKA BARAT, KEPULAUAN BANGKA BELITUNG",5,180,23,203
https://kawalpemilu.org#25308,"CUPAT, PARITTIGA, BANGKA BARAT, KEPULAUAN BANGKA BELITUNG",6,131,15,146
https://kawalpemilu.org#25308,"CUPAT, PARITTIGA, BANGKA BARAT, KEPULAUAN BANGKA BELITUNG",7,129,46,175
https://kawalpemilu.org#25308,"CUPAT, PARITTIGA, BANGKA BARAT, KEPULAUAN BANGKA BELITUNG",8,142,28,170
https://kawalpemilu.org#25308,"CUPAT, PARITTIGA, BANGKA BARAT, KEPULAUAN BANGKA BELITUNG",9,142,23,165
https://kawalpemilu.org#25308,"CUPAT, PARITTIGA, BANGKA BARAT, KEPULAUAN BANGKA BELITUNG",10,163,26,189
https://kawalpemilu.org#25308,"CUPAT, PARITTIGA, BANGKA BARAT, KEPULAUAN BANGKA BELITUNG",11,150,39,189
https://kawalpemilu.org#25308,"CUPAT, PARITTIGA, BANGKA BARAT, KEPULAUAN BANGKA BELITUNG",12,115,8,123
https://kawalpemilu.org#25308,"CUPAT, PARITTIGA, BANGKA BARAT, KEPULAUAN BANGKA BELITUNG",13,131,68,199
https://kawalpemilu.org#25309,"BAKIT, PARITTIGA, BANGKA BARAT, KEPULAUAN BANGKA BELITUNG",1,167,48,215
https://kawalpemilu.org#25309,"BAKIT, PARITTIGA, BANGKA BARAT, KEPULAUAN BANGKA BELITUNG",2,171,55,226
https://kawalpemilu.org#25309,"BAKIT, PARITTIGA, BANGKA BARAT, KEPULAUAN BANGKA BELITUNG",3,200,9,209
https://kawalpemilu.org#25309,"BAKIT, PARITTIGA, BANGKA BARAT, KEPULAUAN BANGKA BELITUNG",4,203,19,222
https://kawalpemilu.org#25309,"BAKIT, PARITTIGA, BANGKA BARAT, KEPULAUAN BANGKA BELITUNG",5,33,8,41
https://kawalpemilu.org#25310,"PUPUT, PARITTIGA, BANGKA BARAT, KEPULAUAN BANGKA BELITUNG",1,194,1,195
https://kawalpemilu.org#25310,"PUPUT, PARITTIGA, BANGKA BARAT, KEPULAUAN BANGKA BELITUNG",2,199,13,212
https://kawalpemilu.org#25310,"PUPUT, PARITTIGA, BANGKA BARAT, KEPULAUAN BANGKA BELITUNG",3,198,7,205
https://kawalpemilu.org#25310,"PUPUT, PARITTIGA, BANGKA BARAT, KEPULAUAN BANGKA BELITUNG",4,206,3,209
https://kawalpemilu.org#25310,"PUPUT, PARITTIGA, BANGKA BARAT, KEPULAUAN BANGKA BELITUNG",5,196,3,199
https://kawalpemilu.org#25310,"PUPUT, PARITTIGA, BANGKA BARAT, KEPULAUAN BANGKA BELITUNG",6,206,10,216
https://kawalpemilu.org#25310,"PUPUT, PARITTIGA, BANGKA BARAT, KEPULAUAN BANGKA BELITUNG",7,110,100,210
https://kawalpemilu.org#25310,"PUPUT, PARITTIGA, BANGKA BARAT, KEPULAUAN BANGKA BELITUNG",8,115,98,6
https://kawalpemilu.org#25310,"PUPUT, PARITTIGA, BANGKA BARAT, KEPULAUAN BANGKA BELITUNG",9,135,70,205
https://kawalpemilu.org#25310,"PUPUT, PARITTIGA, BANGKA BARAT, KEPULAUAN BANGKA BELITUNG",10,172,0,172
https://kawalpemilu.org#25310,"PUPUT, PARITTIGA, BANGKA BARAT, KEPULAUAN BANGKA BELITUNG",11,142,1,143
https://kawalpemilu.org#25310,"PUPUT, PARITTIGA, BANGKA BARAT, KEPULAUAN BANGKA BELITUNG",12,144,2,146
https://kawalpemilu.org#25310,"PUPUT, PARITTIGA, BANGKA BARAT, KEPULAUAN BANGKA BELITUNG",13,196,33,229
https://kawalpemilu.org#25310,"PUPUT, PARITTIGA, BANGKA BARAT, KEPULAUAN BANGKA BELITUNG",14,82,89,171
https://kawalpemilu.org#25311,"AIR GANTANG, PARITTIGA, BANGKA BARAT, KEPULAUAN BANGKA BELITUNG",1,226,6,232
https://kawalpemilu.org#25311,"AIR GANTANG, PARITTIGA, BANGKA BARAT, KEPULAUAN BANGKA BELITUNG",2,221,41,262
https://kawalpemilu.org#25311,"AIR GANTANG, PARITTIGA, BANGKA BARAT, KEPULAUAN BANGKA BELITUNG",3,158,75,233
https://kawalpemilu.org#25311,"AIR GANTANG, PARITTIGA, BANGKA BARAT, KEPULAUAN BANGKA BELITUNG",4,124,91,215
https://kawalpemilu.org#25311,"AIR GANTANG, PARITTIGA, BANGKA BARAT, KEPULAUAN BANGKA BELITUNG",5,134,94,228
https://kawalpemilu.org#25311,"AIR GANTANG, PARITTIGA, BANGKA BARAT, KEPULAUAN BANGKA BELITUNG",6,171,65,236
https://kawalpemilu.org#25311,"AIR GANTANG, PARITTIGA, BANGKA BARAT, KEPULAUAN BANGKA BELITUNG",7,189,14,203
https://kawalpemilu.org#25311,"AIR GANTANG, PARITTIGA, BANGKA BARAT, KEPULAUAN BANGKA BELITUNG",8,169,36,205
https://kawalpemilu.org#25311,"AIR GANTANG, PARITTIGA, BANGKA BARAT, KEPULAUAN BANGKA BELITUNG",9,228,29,257
https://kawalpemilu.org#25311,"AIR GANTANG, PARITTIGA, BANGKA BARAT, KEPULAUAN BANGKA BELITUNG",10,123,65,188
https://kawalpemilu.org#25312,"KELABAT, PARITTIGA, BANGKA BARAT, KEPULAUAN BANGKA BELITUNG",1,163,43,206
https://kawalpemilu.org#25312,"KELABAT, PARITTIGA, BANGKA BARAT, KEPULAUAN BANGKA BELITUNG",2,156,49,205
https://kawalpemilu.org#25312,"KELABAT, PARITTIGA, BANGKA BARAT, KEPULAUAN BANGKA BELITUNG",3,151,8,159
https://kawalpemilu.org#25312,"KELABAT, PARITTIGA, BANGKA BARAT, KEPULAUAN BANGKA BELITUNG",4,159,22,181
https://kawalpemilu.org#25312,"KELABAT, PARITTIGA, BANGKA BARAT, KEPULAUAN BANGKA BELITUNG",6,204,17,221
https://kawalpemilu.org#25312,"KELABAT, PARITTIGA, BANGKA BARAT, KEPULAUAN BANGKA BELITUNG",7,156,19,175
https://kawalpemilu.org#25312,"KELABAT, PARITTIGA, BANGKA BARAT, KEPULAUAN BANGKA BELITUNG",8,173,29,202
https://kawalpemilu.org#25313,"KAPIT, PARITTIGA, BANGKA BARAT, KEPULAUAN BANGKA BELITUNG",1,176,63,239
https://kawalpemilu.org#25313,"KAPIT, PARITTIGA, BANGKA BARAT, KEPULAUAN BANGKA BELITUNG",2,137,84,221
https://kawalpemilu.org#25313,"KAPIT, PARITTIGA, BANGKA BARAT, KEPULAUAN BANGKA BELITUNG",3,150,48,198
https://kawalpemilu.org#25313,"KAPIT, PARITTIGA, BANGKA BARAT, KEPULAUAN BANGKA BELITUNG",4,180,33,213
https://kawalpemilu.org#25314,"SEMULUT, PARITTIGA, BANGKA BARAT, KEPULAUAN BANGKA BELITUNG",1,145,84,229
https://kawalpemilu.org#25314,"SEMULUT, PARITTIGA, BANGKA BARAT, KEPULAUAN BANGKA BELITUNG",2,143,101,244
https://kawalpemilu.org#25314,"SEMULUT, PARITTIGA, BANGKA BARAT, KEPULAUAN BANGKA BELITUNG",3,127,108,235
https://kawalpemilu.org#25314,"SEMULUT, PARITTIGA, BANGKA BARAT, KEPULAUAN BANGKA BELITUNG",4,100,156,256
https://kawalpemilu.org#25314,"SEMULUT, PARITTIGA, BANGKA BARAT, KEPULAUAN BANGKA BELITUNG",5,71,150,221
https://kawalpemilu.org#25314,"SEMULUT, PARITTIGA, BANGKA BARAT, KEPULAUAN BANGKA BELITUNG",6,123,120,243
https://kawalpemilu.org#25315,"TELUK LIMAU, PARITTIGA, BANGKA BARAT, KEPULAUAN BANGKA BELITUNG",1,207,2,209
https://kawalpemilu.org#25315,"TELUK LIMAU, PARITTIGA, BANGKA BARAT, KEPULAUAN BANGKA BELITUNG",2,171,31,202
https://kawalpemilu.org#25315,"TELUK LIMAU, PARITTIGA, BANGKA BARAT, KEPULAUAN BANGKA BELITUNG",3,206,34,240
https://kawalpemilu.org#25315,"TELUK LIMAU, PARITTIGA, BANGKA BARAT, KEPULAUAN BANGKA BELITUNG",4,188,36,224
https://kawalpemilu.org#25315,"TELUK LIMAU, PARITTIGA, BANGKA BARAT, KEPULAUAN BANGKA BELITUNG",5,212,37,249
https://kawalpemilu.org#25315,"TELUK LIMAU, PARITTIGA, BANGKA BARAT, KEPULAUAN BANGKA BELITUNG",6,183,64,247
https://kawalpemilu.org#25315,"TELUK LIMAU, PARITTIGA, BANGKA BARAT, KEPULAUAN BANGKA BELITUNG",7,151,48,199
https://kawalpemilu.org#25315,"TELUK LIMAU, PARITTIGA, BANGKA BARAT, KEPULAUAN BANGKA BELITUNG",8,184,20,204
https://kawalpemilu.org#25315,"TELUK LIMAU, PARITTIGA, BANGKA BARAT, KEPULAUAN BANGKA BELITUNG",9,187,7,194
https://kawalpemilu.org#25318,"LALANG JAYA, MANGGAR, BELITUNG TIMUR, KEPULAUAN BANGKA BELITUNG",1,220,31,251
https://kawalpemilu.org#25318,"LALANG JAYA, MANGGAR, BELITUNG TIMUR, KEPULAUAN BANGKA BELITUNG",2,127,57,184
https://kawalpemilu.org#25318,"LALANG JAYA, MANGGAR, BELITUNG TIMUR, KEPULAUAN BANGKA BELITUNG",3,174,40,214
https://kawalpemilu.org#25318,"LALANG JAYA, MANGGAR, BELITUNG TIMUR, KEPULAUAN BANGKA BELITUNG",4,163,66,229
https://kawalpemilu.org#25318,"LALANG JAYA, MANGGAR, BELITUNG TIMUR, KEPULAUAN BANGKA BELITUNG",5,200,54,254
https://kawalpemilu.org#25318,"LALANG JAYA, MANGGAR, BELITUNG TIMUR, KEPULAUAN BANGKA BELITUNG",6,183,51,234
https://kawalpemilu.org#25318,"LALANG JAYA, MANGGAR, BELITUNG TIMUR, KEPULAUAN BANGKA BELITUNG",7,143,75,218
https://kawalpemilu.org#25318,"LALANG JAYA, MANGGAR, BELITUNG TIMUR, KEPULAUAN BANGKA BELITUNG",8,183,56,139
https://kawalpemilu.org#25318,"LALANG JAYA, MANGGAR, BELITUNG TIMUR, KEPULAUAN BANGKA BELITUNG",9,155,51,206
https://kawalpemilu.org#25319,"KURNIA JAYA, MANGGAR, BELITUNG TIMUR, KEPULAUAN BANGKA BELITUNG",1,183,41,224
https://kawalpemilu.org#25319,"KURNIA JAYA, MANGGAR, BELITUNG TIMUR, KEPULAUAN BANGKA BELITUNG",2,173,53,226
https://kawalpemilu.org#25319,"KURNIA JAYA, MANGGAR, BELITUNG TIMUR, KEPULAUAN BANGKA BELITUNG",3,179,44,223
https://kawalpemilu.org#25319,"KURNIA JAYA, MANGGAR, BELITUNG TIMUR, KEPULAUAN BANGKA BELITUNG",4,160,36,196
https://kawalpemilu.org#25319,"KURNIA JAYA, MANGGAR, BELITUNG TIMUR, KEPULAUAN BANGKA BELITUNG",5,132,59,191
https://kawalpemilu.org#25319,"KURNIA JAYA, MANGGAR, BELITUNG TIMUR, KEPULAUAN BANGKA BELITUNG",6,183,44,227
https://kawalpemilu.org#25319,"KURNIA JAYA, MANGGAR, BELITUNG TIMUR, KEPULAUAN BANGKA BELITUNG",7,158,58,216
https://kawalpemilu.org#25319,"KURNIA JAYA, MANGGAR, BELITUNG TIMUR, KEPULAUAN BANGKA BELITUNG",8,198,38,236
https://kawalpemilu.org#25319,"KURNIA JAYA, MANGGAR, BELITUNG TIMUR, KEPULAUAN BANGKA BELITUNG",9,191,40,231
https://kawalpemilu.org#25319,"KURNIA JAYA, MANGGAR, BELITUNG TIMUR, KEPULAUAN BANGKA BELITUNG",10,129,55,184
https://kawalpemilu.org#25319,"KURNIA JAYA, MANGGAR, BELITUNG TIMUR, KEPULAUAN BANGKA BELITUNG",11,183,44,227
https://kawalpemilu.org#25319,"KURNIA JAYA, MANGGAR, BELITUNG TIMUR, KEPULAUAN BANGKA BELITUNG",12,194,55,249
https://kawalpemilu.org#25319,"KURNIA JAYA, MANGGAR, BELITUNG TIMUR, KEPULAUAN BANGKA BELITUNG",13,170,50,220
https://kawalpemilu.org#25319,"KURNIA JAYA, MANGGAR, BELITUNG TIMUR, KEPULAUAN BANGKA BELITUNG",14,163,52,215
https://kawalpemilu.org#25320,"PADANG, MANGGAR, BELITUNG TIMUR, KEPULAUAN BANGKA BELITUNG",1,198,52,250
https://kawalpemilu.org#25320,"PADANG, MANGGAR, BELITUNG TIMUR, KEPULAUAN BANGKA BELITUNG",2,212,44,256
https://kawalpemilu.org#25320,"PADANG, MANGGAR, BELITUNG TIMUR, KEPULAUAN BANGKA BELITUNG",3,173,63,236
https://kawalpemilu.org#25320,"PADANG, MANGGAR, BELITUNG TIMUR, KEPULAUAN BANGKA BELITUNG",4,198,61,259
https://kawalpemilu.org#25320,"PADANG, MANGGAR, BELITUNG TIMUR, KEPULAUAN BANGKA BELITUNG",5,188,65,253
https://kawalpemilu.org#25320,"PADANG, MANGGAR, BELITUNG TIMUR, KEPULAUAN BANGKA BELITUNG",6,121,54,175
https://kawalpemilu.org#25320,"PADANG, MANGGAR, BELITUNG TIMUR, KEPULAUAN BANGKA BELITUNG",7,162,65,227
https://kawalpemilu.org#25320,"PADANG, MANGGAR, BELITUNG TIMUR, KEPULAUAN BANGKA BELITUNG",8,147,75,222
https://kawalpemilu.org#25320,"PADANG, MANGGAR, BELITUNG TIMUR, KEPULAUAN BANGKA BELITUNG",9,141,84,225
https://kawalpemilu.org#25320,"PADANG, MANGGAR, BELITUNG TIMUR, KEPULAUAN BANGKA BELITUNG",10,126,41,167
https://kawalpemilu.org#25320,"PADANG, MANGGAR, BELITUNG TIMUR, KEPULAUAN BANGKA BELITUNG",11,180,43,223
https://kawalpemilu.org#25320,"PADANG, MANGGAR, BELITUNG TIMUR, KEPULAUAN BANGKA BELITUNG",12,170,99,269
https://kawalpemilu.org#25320,"PADANG, MANGGAR, BELITUNG TIMUR, KEPULAUAN BANGKA BELITUNG",13,171,59,230
https://kawalpemilu.org#25320,"PADANG, MANGGAR, BELITUNG TIMUR, KEPULAUAN BANGKA BELITUNG",14,183,72,255
https://kawalpemilu.org#25320,"PADANG, MANGGAR, BELITUNG TIMUR, KEPULAUAN BANGKA BELITUNG",15,170,77,247
https://kawalpemilu.org#25320,"PADANG, MANGGAR, BELITUNG TIMUR, KEPULAUAN BANGKA BELITUNG",16,144,53,197
https://kawalpemilu.org#25320,"PADANG, MANGGAR, BELITUNG TIMUR, KEPULAUAN BANGKA BELITUNG",17,129,41,170
https://kawalpemilu.org#25320,"PADANG, MANGGAR, BELITUNG TIMUR, KEPULAUAN BANGKA BELITUNG",18,64,24,88
https://kawalpemilu.org#25321,"KELUBI, MANGGAR, BELITUNG TIMUR, KEPULAUAN BANGKA BELITUNG",1,164,63,227
https://kawalpemilu.org#25321,"KELUBI, MANGGAR, BELITUNG TIMUR, KEPULAUAN BANGKA BELITUNG",2,150,45,195
https://kawalpemilu.org#25321,"KELUBI, MANGGAR, BELITUNG TIMUR, KEPULAUAN BANGKA BELITUNG",3,124,74,198
https://kawalpemilu.org#25321,"KELUBI, MANGGAR, BELITUNG TIMUR, KEPULAUAN BANGKA BELITUNG",4,180,34,214
https://kawalpemilu.org#25321,"KELUBI, MANGGAR, BELITUNG TIMUR, KEPULAUAN BANGKA BELITUNG",5,108,88,196
https://kawalpemilu.org#25321,"KELUBI, MANGGAR, BELITUNG TIMUR, KEPULAUAN BANGKA BELITUNG",6,175,37,212
https://kawalpemilu.org#25321,"KELUBI, MANGGAR, BELITUNG TIMUR, KEPULAUAN BANGKA BELITUNG",7,169,41,210
https://kawalpemilu.org#25321,"KELUBI, MANGGAR, BELITUNG TIMUR, KEPULAUAN BANGKA BELITUNG",8,151,30,181
https://kawalpemilu.org#25322,"LALANG, MANGGAR, BELITUNG TIMUR, KEPULAUAN BANGKA BELITUNG",1,154,79,233
https://kawalpemilu.org#25322,"LALANG, MANGGAR, BELITUNG TIMUR, KEPULAUAN BANGKA BELITUNG",2,122,54,176
https://kawalpemilu.org#25322,"LALANG, MANGGAR, BELITUNG TIMUR, KEPULAUAN BANGKA BELITUNG",3,184,41,225
https://kawalpemilu.org#25322,"LALANG, MANGGAR, BELITUNG TIMUR, KEPULAUAN BANGKA BELITUNG",4,169,58,227
https://kawalpemilu.org#25322,"LALANG, MANGGAR, BELITUNG TIMUR, KEPULAUAN BANGKA BELITUNG",5,171,38,209
https://kawalpemilu.org#25322,"LALANG, MANGGAR, BELITUNG TIMUR, KEPULAUAN BANGKA BELITUNG",6,153,53,206
https://kawalpemilu.org#25322,"LALANG, MANGGAR, BELITUNG TIMUR, KEPULAUAN BANGKA BELITUNG",7,168,65,233
https://kawalpemilu.org#25322,"LALANG, MANGGAR, BELITUNG TIMUR, KEPULAUAN BANGKA BELITUNG",8,149,74,223
https://kawalpemilu.org#25322,"LALANG, MANGGAR, BELITUNG TIMUR, KEPULAUAN BANGKA BELITUNG",9,164,47,211
https://kawalpemilu.org#25322,"LALANG, MANGGAR, BELITUNG TIMUR, KEPULAUAN BANGKA BELITUNG",10,187,51,238
https://kawalpemilu.org#25322,"LALANG, MANGGAR, BELITUNG TIMUR, KEPULAUAN BANGKA BELITUNG",11,170,73,243
https://kawalpemilu.org#25322,"LALANG, MANGGAR, BELITUNG TIMUR, KEPULAUAN BANGKA BELITUNG",12,175,57,232
https://kawalpemilu.org#25322,"LALANG, MANGGAR, BELITUNG TIMUR, KEPULAUAN BANGKA BELITUNG",13,165,70,235
https://kawalpemilu.org#25323,"BARU, MANGGAR, BELITUNG TIMUR, KEPULAUAN BANGKA BELITUNG",1,176,38,214
https://kawalpemilu.org#25323,"BARU, MANGGAR, BELITUNG TIMUR, KEPULAUAN BANGKA BELITUNG",2,195,49,244
https://kawalpemilu.org#25323,"BARU, MANGGAR, BELITUNG TIMUR, KEPULAUAN BANGKA BELITUNG",3,171,56,227
https://kawalpemilu.org#25323,"BARU, MANGGAR, BELITUNG TIMUR, KEPULAUAN BANGKA BELITUNG",4,190,32,222
https://kawalpemilu.org#25323,"BARU, MANGGAR, BELITUNG TIMUR, KEPULAUAN BANGKA BELITUNG",5,215,21,236
https://kawalpemilu.org#25323,"BARU, MANGGAR, BELITUNG TIMUR, KEPULAUAN BANGKA BELITUNG",6,200,26,226
https://kawalpemilu.org#25323,"BARU, MANGGAR, BELITUNG TIMUR, KEPULAUAN BANGKA BELITUNG",7,157,38,157
https://kawalpemilu.org#25323,"BARU, MANGGAR, BELITUNG TIMUR, KEPULAUAN BANGKA BELITUNG",8,166,44,210
https://kawalpemilu.org#25323,"BARU, MANGGAR, BELITUNG TIMUR, KEPULAUAN BANGKA BELITUNG",9,150,52,202
https://kawalpemilu.org#25323,"BARU, MANGGAR, BELITUNG TIMUR, KEPULAUAN BANGKA BELITUNG",10,184,24,208
https://kawalpemilu.org#25323,"BARU, MANGGAR, BELITUNG TIMUR, KEPULAUAN BANGKA BELITUNG",11,169,48,217
https://kawalpemilu.org#25323,"BARU, MANGGAR, BELITUNG TIMUR, KEPULAUAN BANGKA BELITUNG",12,201,39,240
https://kawalpemilu.org#25323,"BARU, MANGGAR, BELITUNG TIMUR, KEPULAUAN BANGKA BELITUNG",13,204,45,249
https://kawalpemilu.org#25323,"BARU, MANGGAR, BELITUNG TIMUR, KEPULAUAN BANGKA BELITUNG",14,173,38,211
https://kawalpemilu.org#25323,"BARU, MANGGAR, BELITUNG TIMUR, KEPULAUAN BANGKA BELITUNG",15,185,10,195
https://kawalpemilu.org#25323,"BARU, MANGGAR, BELITUNG TIMUR, KEPULAUAN BANGKA BELITUNG",16,190,6,196
https://kawalpemilu.org#25323,"BARU, MANGGAR, BELITUNG TIMUR, KEPULAUAN BANGKA BELITUNG",17,153,31,184
https://kawalpemilu.org#25323,"BARU, MANGGAR, BELITUNG TIMUR, KEPULAUAN BANGKA BELITUNG",18,154,51,205
https://kawalpemilu.org#25323,"BARU, MANGGAR, BELITUNG TIMUR, KEPULAUAN BANGKA BELITUNG",19,190,8,198
https://kawalpemilu.org#25323,"BARU, MANGGAR, BELITUNG TIMUR, KEPULAUAN BANGKA BELITUNG",20,183,52,235
https://kawalpemilu.org#25323,"BARU, MANGGAR, BELITUNG TIMUR, KEPULAUAN BANGKA BELITUNG",21,158,52,210
https://kawalpemilu.org#25323,"BARU, MANGGAR, BELITUNG TIMUR, KEPULAUAN BANGKA BELITUNG",22,129,94,223
https://kawalpemilu.org#25323,"BARU, MANGGAR, BELITUNG TIMUR, KEPULAUAN BANGKA BELITUNG",23,182,23,205
https://kawalpemilu.org#25323,"BARU, MANGGAR, BELITUNG TIMUR, KEPULAUAN BANGKA BELITUNG",24,158,14,173
https://kawalpemilu.org#25324,"BUKU LIMAU, MANGGAR, BELITUNG TIMUR, KEPULAUAN BANGKA BELITUNG",1,180,52,232
https://kawalpemilu.org#25324,"BUKU LIMAU, MANGGAR, BELITUNG TIMUR, KEPULAUAN BANGKA BELITUNG",2,154,60,214
https://kawalpemilu.org#25325,"MEKAR JAYA, MANGGAR, BELITUNG TIMUR, KEPULAUAN BANGKA BELITUNG",1,176,46,222
https://kawalpemilu.org#25325,"MEKAR JAYA, MANGGAR, BELITUNG TIMUR, KEPULAUAN BANGKA BELITUNG",2,204,31,235
https://kawalpemilu.org#25325,"MEKAR JAYA, MANGGAR, BELITUNG TIMUR, KEPULAUAN BANGKA BELITUNG",3,140,20,160
https://kawalpemilu.org#25325,"MEKAR JAYA, MANGGAR, BELITUNG TIMUR, KEPULAUAN BANGKA BELITUNG",4,167,23,190
https://kawalpemilu.org#25325,"MEKAR JAYA, MANGGAR, BELITUNG TIMUR, KEPULAUAN BANGKA BELITUNG",5,147,67,214
https://kawalpemilu.org#25325,"MEKAR JAYA, MANGGAR, BELITUNG TIMUR, KEPULAUAN BANGKA BELITUNG",6,167,57,224
https://kawalpemilu.org#25325,"MEKAR JAYA, MANGGAR, BELITUNG TIMUR, KEPULAUAN BANGKA BELITUNG",7,127,56,183
https://kawalpemilu.org#25325,"MEKAR JAYA, MANGGAR, BELITUNG TIMUR, KEPULAUAN BANGKA BELITUNG",8,110,62,172
https://kawalpemilu.org#25325,"MEKAR JAYA, MANGGAR, BELITUNG TIMUR, KEPULAUAN BANGKA BELITUNG",9,144,35,179
https://kawalpemilu.org#25326,"BENTAIAN JAYA, MANGGAR, BELITUNG TIMUR, KEPULAUAN BANGKA BELITUNG",1,199,38,237
https://kawalpemilu.org#25326,"BENTAIAN JAYA, MANGGAR, BELITUNG TIMUR, KEPULAUAN BANGKA BELITUNG",2,175,42,217
https://kawalpemilu.org#25326,"BENTAIAN JAYA, MANGGAR, BELITUNG TIMUR, KEPULAUAN BANGKA BELITUNG",3,148,59,207
https://kawalpemilu.org#25326,"BENTAIAN JAYA, MANGGAR, BELITUNG TIMUR, KEPULAUAN BANGKA BELITUNG",4,191,45,236
https://kawalpemilu.org#25328,"GANTUNG, GANTUNG, BELITUNG TIMUR, KEPULAUAN BANGKA BELITUNG",1,187,51,238
https://kawalpemilu.org#25328,"GANTUNG, GANTUNG, BELITUNG TIMUR, KEPULAUAN BANGKA BELITUNG",2,161,65,226
https://kawalpemilu.org#25328,"GANTUNG, GANTUNG, BELITUNG TIMUR, KEPULAUAN BANGKA BELITUNG",3,182,39,221
https://kawalpemilu.org#25328,"GANTUNG, GANTUNG, BELITUNG TIMUR, KEPULAUAN BANGKA BELITUNG",4,155,67,222
https://kawalpemilu.org#25328,"GANTUNG, GANTUNG, BELITUNG TIMUR, KEPULAUAN BANGKA BELITUNG",5,176,58,234
https://kawalpemilu.org#25328,"GANTUNG, GANTUNG, BELITUNG TIMUR, KEPULAUAN BANGKA BELITUNG",6,167,22,189
https://kawalpemilu.org#25328,"GANTUNG, GANTUNG, BELITUNG TIMUR, KEPULAUAN BANGKA BELITUNG",7,187,33,220
https://kawalpemilu.org#25328,"GANTUNG, GANTUNG, BELITUNG TIMUR, KEPULAUAN BANGKA BELITUNG",8,134,45,179
https://kawalpemilu.org#25328,"GANTUNG, GANTUNG, BELITUNG TIMUR, KEPULAUAN BANGKA BELITUNG",9,156,31,187
https://kawalpemilu.org#25328,"GANTUNG, GANTUNG, BELITUNG TIMUR, KEPULAUAN BANGKA BELITUNG",10,193,21,214
https://kawalpemilu.org#25328,"GANTUNG, GANTUNG, BELITUNG TIMUR, KEPULAUAN BANGKA BELITUNG",11,169,29,198
https://kawalpemilu.org#25328,"GANTUNG, GANTUNG, BELITUNG TIMUR, KEPULAUAN BANGKA BELITUNG",12,181,40,221
https://kawalpemilu.org#25328,"GANTUNG, GANTUNG, BELITUNG TIMUR, KEPULAUAN BANGKA BELITUNG",13,191,24,215
https://kawalpemilu.org#25328,"GANTUNG, GANTUNG, BELITUNG TIMUR, KEPULAUAN BANGKA BELITUNG",14,160,37,197
https://kawalpemilu.org#25329,"SELINSING, GANTUNG, BELITUNG TIMUR, KEPULAUAN BANGKA BELITUNG",1,140,23,163
https://kawalpemilu.org#25329,"SELINSING, GANTUNG, BELITUNG TIMUR, KEPULAUAN BANGKA BELITUNG",2,163,55,218
https://kawalpemilu.org#25329,"SELINSING, GANTUNG, BELITUNG TIMUR, KEPULAUAN BANGKA BELITUNG",3,136,25,161
https://kawalpemilu.org#25329,"SELINSING, GANTUNG, BELITUNG TIMUR, KEPULAUAN BANGKA BELITUNG",4,192,46,238
https://kawalpemilu.org#25329,"SELINSING, GANTUNG, BELITUNG TIMUR, KEPULAUAN BANGKA BELITUNG",5,150,63,213
https://kawalpemilu.org#25329,"SELINSING, GANTUNG, BELITUNG TIMUR, KEPULAUAN BANGKA BELITUNG",6,213,27,240
https://kawalpemilu.org#25329,"SELINSING, GANTUNG, BELITUNG TIMUR, KEPULAUAN BANGKA BELITUNG",7,158,24,182
https://kawalpemilu.org#25329,"SELINSING, GANTUNG, BELITUNG TIMUR, KEPULAUAN BANGKA BELITUNG",8,157,29,186
https://kawalpemilu.org#25329,"SELINSING, GANTUNG, BELITUNG TIMUR, KEPULAUAN BANGKA BELITUNG",9,202,33,235
https://kawalpemilu.org#25329,"SELINSING, GANTUNG, BELITUNG TIMUR, KEPULAUAN BANGKA BELITUNG",10,175,59,234
https://kawalpemilu.org#25329,"SELINSING, GANTUNG, BELITUNG TIMUR, KEPULAUAN BANGKA BELITUNG",11,189,60,249
https://kawalpemilu.org#25329,"SELINSING, GANTUNG, BELITUNG TIMUR, KEPULAUAN BANGKA BELITUNG",12,213,31,244
https://kawalpemilu.org#25329,"SELINSING, GANTUNG, BELITUNG TIMUR, KEPULAUAN BANGKA BELITUNG",13,182,35,217
https://kawalpemilu.org#25329,"SELINSING, GANTUNG, BELITUNG TIMUR, KEPULAUAN BANGKA BELITUNG",14,137,15,152
https://kawalpemilu.org#25329,"SELINSING, GANTUNG, BELITUNG TIMUR, KEPULAUAN BANGKA BELITUNG",15,169,19,188
https://kawalpemilu.org#25330,"JANGKAR ASAM, GANTUNG, BELITUNG TIMUR, KEPULAUAN BANGKA BELITUNG",1,202,27,229
https://kawalpemilu.org#25330,"JANGKAR ASAM, GANTUNG, BELITUNG TIMUR, KEPULAUAN BANGKA BELITUNG",2,198,37,235
https://kawalpemilu.org#25330,"JANGKAR ASAM, GANTUNG, BELITUNG TIMUR, KEPULAUAN BANGKA BELITUNG",3,198,31,229
https://kawalpemilu.org#25330,"JANGKAR ASAM, GANTUNG, BELITUNG TIMUR, KEPULAUAN BANGKA BELITUNG",4,198,40,238
https://kawalpemilu.org#25331,"LILANGAN, GANTUNG, BELITUNG TIMUR, KEPULAUAN BANGKA BELITUNG",1,171,51,222
https://kawalpemilu.org#25331,"LILANGAN, GANTUNG, BELITUNG TIMUR, KEPULAUAN BANGKA BELITUNG",2,178,39,217
https://kawalpemilu.org#25331,"LILANGAN, GANTUNG, BELITUNG TIMUR, KEPULAUAN BANGKA BELITUNG",3,141,65,206
https://kawalpemilu.org#25331,"LILANGAN, GANTUNG, BELITUNG TIMUR, KEPULAUAN BANGKA BELITUNG",4,184,49,233
https://kawalpemilu.org#25331,"LILANGAN, GANTUNG, BELITUNG TIMUR, KEPULAUAN BANGKA BELITUNG",5,193,43,236
https://kawalpemilu.org#25331,"LILANGAN, GANTUNG, BELITUNG TIMUR, KEPULAUAN BANGKA BELITUNG",6,184,26,210
https://kawalpemilu.org#25331,"LILANGAN, GANTUNG, BELITUNG TIMUR, KEPULAUAN BANGKA BELITUNG",7,153,38,191
https://kawalpemilu.org#25331,"LILANGAN, GANTUNG, BELITUNG TIMUR, KEPULAUAN BANGKA BELITUNG",8,186,47,233
https://kawalpemilu.org#25331,"LILANGAN, GANTUNG, BELITUNG TIMUR, KEPULAUAN BANGKA BELITUNG",9,210,24,234
https://kawalpemilu.org#25332,"LENGGANG, GANTUNG, BELITUNG TIMUR, KEPULAUAN BANGKA BELITUNG",1,192,52,244
https://kawalpemilu.org#25332,"LENGGANG, GANTUNG, BELITUNG TIMUR, KEPULAUAN BANGKA BELITUNG",2,192,44,236
https://kawalpemilu.org#25332,"LENGGANG, GANTUNG, BELITUNG TIMUR, KEPULAUAN BANGKA BELITUNG",3,189,31,220
https://kawalpemilu.org#25332,"LENGGANG, GANTUNG, BELITUNG TIMUR, KEPULAUAN BANGKA BELITUNG",4,133,24,157
https://kawalpemilu.org#25332,"LENGGANG, GANTUNG, BELITUNG TIMUR, KEPULAUAN BANGKA BELITUNG",5,164,65,229
https://kawalpemilu.org#25332,"LENGGANG, GANTUNG, BELITUNG TIMUR, KEPULAUAN BANGKA BELITUNG",6,167,51,218
https://kawalpemilu.org#25332,"LENGGANG, GANTUNG, BELITUNG TIMUR, KEPULAUAN BANGKA BELITUNG",7,163,42,205
https://kawalpemilu.org#25332,"LENGGANG, GANTUNG, BELITUNG TIMUR, KEPULAUAN BANGKA BELITUNG",8,194,24,218
https://kawalpemilu.org#25332,"LENGGANG, GANTUNG, BELITUNG TIMUR, KEPULAUAN BANGKA BELITUNG",9,119,21,140
https://kawalpemilu.org#25332,"LENGGANG, GANTUNG, BELITUNG TIMUR, KEPULAUAN BANGKA BELITUNG",10,144,53,197
https://kawalpemilu.org#25332,"LENGGANG, GANTUNG, BELITUNG TIMUR, KEPULAUAN BANGKA BELITUNG",11,168,61,229
https://kawalpemilu.org#25333,"BATU PENYU, GANTUNG, BELITUNG TIMUR, KEPULAUAN BANGKA BELITUNG",1,187,47,234
https://kawalpemilu.org#25333,"BATU PENYU, GANTUNG, BELITUNG TIMUR, KEPULAUAN BANGKA BELITUNG",2,199,47,246
https://kawalpemilu.org#25333,"BATU PENYU, GANTUNG, BELITUNG TIMUR, KEPULAUAN BANGKA BELITUNG",3,204,36,236
https://kawalpemilu.org#25333,"BATU PENYU, GANTUNG, BELITUNG TIMUR, KEPULAUAN BANGKA BELITUNG",4,183,37,220
https://kawalpemilu.org#25333,"BATU PENYU, GANTUNG, BELITUNG TIMUR, KEPULAUAN BANGKA BELITUNG",5,215,17,232
https://kawalpemilu.org#25333,"BATU PENYU, GANTUNG, BELITUNG TIMUR, KEPULAUAN BANGKA BELITUNG",6,193,53,246
https://kawalpemilu.org#25333,"BATU PENYU, GANTUNG, BELITUNG TIMUR, KEPULAUAN BANGKA BELITUNG",7,182,52,234
https://kawalpemilu.org#25333,"BATU PENYU, GANTUNG, BELITUNG TIMUR, KEPULAUAN BANGKA BELITUNG",8,191,24,215
https://kawalpemilu.org#25333,"BATU PENYU, GANTUNG, BELITUNG TIMUR, KEPULAUAN BANGKA BELITUNG",9,174,45,219
https://kawalpemilu.org#25333,"BATU PENYU, GANTUNG, BELITUNG TIMUR, KEPULAUAN BANGKA BELITUNG",10,197,49,246
https://kawalpemilu.org#25333,"BATU PENYU, GANTUNG, BELITUNG TIMUR, KEPULAUAN BANGKA BELITUNG",11,187,45,232
https://kawalpemilu.org#25333,"BATU PENYU, GANTUNG, BELITUNG TIMUR, KEPULAUAN BANGKA BELITUNG",12,218,12,230
https://kawalpemilu.org#25333,"BATU PENYU, GANTUNG, BELITUNG TIMUR, KEPULAUAN BANGKA BELITUNG",13,61,31,92
https://kawalpemilu.org#25334,"LIMBONGAN, GANTUNG, BELITUNG TIMUR, KEPULAUAN BANGKA BELITUNG",1,200,28,228
https://kawalpemilu.org#25334,"LIMBONGAN, GANTUNG, BELITUNG TIMUR, KEPULAUAN BANGKA BELITUNG",2,187,18,205
https://kawalpemilu.org#25334,"LIMBONGAN, GANTUNG, BELITUNG TIMUR, KEPULAUAN BANGKA BELITUNG",3,201,21,222
https://kawalpemilu.org#25334,"LIMBONGAN, GANTUNG, BELITUNG TIMUR, KEPULAUAN BANGKA BELITUNG",4,203,20,223
https://kawalpemilu.org#25336,"DENDANG, DENDANG, BELITUNG TIMUR, KEPULAUAN BANGKA BELITUNG",1,213,32,245
https://kawalpemilu.org#25336,"DENDANG, DENDANG, BELITUNG TIMUR, KEPULAUAN BANGKA BELITUNG",2,181,41,222
https://kawalpemilu.org#25336,"DENDANG, DENDANG, BELITUNG TIMUR, KEPULAUAN BANGKA BELITUNG",3,198,46,244
https://kawalpemilu.org#25336,"DENDANG, DENDANG, BELITUNG TIMUR, KEPULAUAN BANGKA BELITUNG",4,145,81,226
https://kawalpemilu.org#25336,"DENDANG, DENDANG, BELITUNG TIMUR, KEPULAUAN BANGKA BELITUNG",5,184,53,237
https://kawalpemilu.org#25337,"JANGKANG, DENDANG, BELITUNG TIMUR, KEPULAUAN BANGKA BELITUNG",1,201,48,249
https://kawalpemilu.org#25337,"JANGKANG, DENDANG, BELITUNG TIMUR, KEPULAUAN BANGKA BELITUNG",2,156,66,222
https://kawalpemilu.org#25337,"JANGKANG, DENDANG, BELITUNG TIMUR, KEPULAUAN BANGKA BELITUNG",3,145,47,192
https://kawalpemilu.org#25337,"JANGKANG, DENDANG, BELITUNG TIMUR, KEPULAUAN BANGKA BELITUNG",4,148,62,210
https://kawalpemilu.org#25337,"JANGKANG, DENDANG, BELITUNG TIMUR, KEPULAUAN BANGKA BELITUNG",5,148,63,211
https://kawalpemilu.org#25337,"JANGKANG, DENDANG, BELITUNG TIMUR, KEPULAUAN BANGKA BELITUNG",6,164,46,210
https://kawalpemilu.org#25337,"JANGKANG, DENDANG, BELITUNG TIMUR, KEPULAUAN BANGKA BELITUNG",7,140,39,179
https://kawalpemilu.org#25337,"JANGKANG, DENDANG, BELITUNG TIMUR, KEPULAUAN BANGKA BELITUNG",8,64,19,83
https://kawalpemilu.org#25337,"JANGKANG, DENDANG, BELITUNG TIMUR, KEPULAUAN BANGKA BELITUNG",9,174,40,214
https://kawalpemilu.org#25337,"JANGKANG, DENDANG, BELITUNG TIMUR, KEPULAUAN BANGKA BELITUNG",10,184,50,234
https://kawalpemilu.org#25338,"NYURUK, DENDANG, BELITUNG TIMUR, KEPULAUAN BANGKA BELITUNG",1,153,38,191
https://kawalpemilu.org#25338,"NYURUK, DENDANG, BELITUNG TIMUR, KEPULAUAN BANGKA BELITUNG",2,127,54,181
https://kawalpemilu.org#25338,"NYURUK, DENDANG, BELITUNG TIMUR, KEPULAUAN BANGKA BELITUNG",3,130,34,164
https://kawalpemilu.org#25338,"NYURUK, DENDANG, BELITUNG TIMUR, KEPULAUAN BANGKA BELITUNG",4,166,48,214
https://kawalpemilu.org#25338,"NYURUK, DENDANG, BELITUNG TIMUR, KEPULAUAN BANGKA BELITUNG",5,115,64,179
https://kawalpemilu.org#25338,"NYURUK, DENDANG, BELITUNG TIMUR, KEPULAUAN BANGKA BELITUNG",6,137,66,203
https://kawalpemilu.org#25338,"NYURUK, DENDANG, BELITUNG TIMUR, KEPULAUAN BANGKA BELITUNG",7,164,38,202
https://kawalpemilu.org#25338,"NYURUK, DENDANG, BELITUNG TIMUR, KEPULAUAN BANGKA BELITUNG",8,158,45,203
https://kawalpemilu.org#25338,"NYURUK, DENDANG, BELITUNG TIMUR, KEPULAUAN BANGKA BELITUNG",9,220,63,283
https://kawalpemilu.org#25338,"NYURUK, DENDANG, BELITUNG TIMUR, KEPULAUAN BANGKA BELITUNG",10,110,34,144
https://kawalpemilu.org#25339,"BALOK, DENDANG, BELITUNG TIMUR, KEPULAUAN BANGKA BELITUNG",1,231,33,264
https://kawalpemilu.org#25339,"BALOK, DENDANG, BELITUNG TIMUR, KEPULAUAN BANGKA BELITUNG",2,173,64,237
https://kawalpemilu.org#25339,"BALOK, DENDANG, BELITUNG TIMUR, KEPULAUAN BANGKA BELITUNG",3,148,90,238
https://kawalpemilu.org#25339,"BALOK, DENDANG, BELITUNG TIMUR, KEPULAUAN BANGKA BELITUNG",4,164,91,255
https://kawalpemilu.org#25339,"BALOK, DENDANG, BELITUNG TIMUR, KEPULAUAN BANGKA BELITUNG",5,149,31,180
https://kawalpemilu.org#25339,"BALOK, DENDANG, BELITUNG TIMUR, KEPULAUAN BANGKA BELITUNG",6,118,50,168
https://kawalpemilu.org#25341,"MENTAWAK, KELAPA KAMPIT, BELITUNG TIMUR, KEPULAUAN BANGKA BELITUNG",1,102,99,201
https://kawalpemilu.org#25341,"MENTAWAK, KELAPA KAMPIT, BELITUNG TIMUR, KEPULAUAN BANGKA BELITUNG",2,164,85,249
https://kawalpemilu.org#25341,"MENTAWAK, KELAPA KAMPIT, BELITUNG TIMUR, KEPULAUAN BANGKA BELITUNG",3,124,82,206
https://kawalpemilu.org#25341,"MENTAWAK, KELAPA KAMPIT, BELITUNG TIMUR, KEPULAUAN BANGKA BELITUNG",4,144,79,223
https://kawalpemilu.org#25341,"MENTAWAK, KELAPA KAMPIT, BELITUNG TIMUR, KEPULAUAN BANGKA BELITUNG",5,116,85,201
https://kawalpemilu.org#25341,"MENTAWAK, KELAPA KAMPIT, BELITUNG TIMUR, KEPULAUAN BANGKA BELITUNG",6,110,69,179
https://kawalpemilu.org#25341,"MENTAWAK, KELAPA KAMPIT, BELITUNG TIMUR, KEPULAUAN BANGKA BELITUNG",7,154,68,222
https://kawalpemilu.org#25341,"MENTAWAK, KELAPA KAMPIT, BELITUNG TIMUR, KEPULAUAN BANGKA BELITUNG",8,118,110,228
https://kawalpemilu.org#25341,"MENTAWAK, KELAPA KAMPIT, BELITUNG TIMUR, KEPULAUAN BANGKA BELITUNG",9,166,84,250
https://kawalpemilu.org#25341,"MENTAWAK, KELAPA KAMPIT, BELITUNG TIMUR, KEPULAUAN BANGKA BELITUNG",10,140,50,190
https://kawalpemilu.org#25341,"MENTAWAK, KELAPA KAMPIT, BELITUNG TIMUR, KEPULAUAN BANGKA BELITUNG",11,160,40,200
https://kawalpemilu.org#25341,"MENTAWAK, KELAPA KAMPIT, BELITUNG TIMUR, KEPULAUAN BANGKA BELITUNG",12,102,49,151
https://kawalpemilu.org#25342,"SENYUBUK, KELAPA KAMPIT, BELITUNG TIMUR, KEPULAUAN BANGKA BELITUNG",1,162,80,242
https://kawalpemilu.org#25342,"SENYUBUK, KELAPA KAMPIT, BELITUNG TIMUR, KEPULAUAN BANGKA BELITUNG",2,154,81,235
https://kawalpemilu.org#25342,"SENYUBUK, KELAPA KAMPIT, BELITUNG TIMUR, KEPULAUAN BANGKA BELITUNG",3,149,98,247
https://kawalpemilu.org#25342,"SENYUBUK, KELAPA KAMPIT, BELITUNG TIMUR, KEPULAUAN BANGKA BELITUNG",4,191,39,230
https://kawalpemilu.org#25342,"SENYUBUK, KELAPA KAMPIT, BELITUNG TIMUR, KEPULAUAN BANGKA BELITUNG",5,145,85,230
https://kawalpemilu.org#25342,"SENYUBUK, KELAPA KAMPIT, BELITUNG TIMUR, KEPULAUAN BANGKA BELITUNG",6,133,80,213
https://kawalpemilu.org#25342,"SENYUBUK, KELAPA KAMPIT, BELITUNG TIMUR, KEPULAUAN BANGKA BELITUNG",7,160,70,230
https://kawalpemilu.org#25342,"SENYUBUK, KELAPA KAMPIT, BELITUNG TIMUR, KEPULAUAN BANGKA BELITUNG",8,165,61,226
https://kawalpemilu.org#25342,"SENYUBUK, KELAPA KAMPIT, BELITUNG TIMUR, KEPULAUAN BANGKA BELITUNG",9,146,65,211
https://kawalpemilu.org#25342,"SENYUBUK, KELAPA KAMPIT, BELITUNG TIMUR, KEPULAUAN BANGKA BELITUNG",10,176,65,241
https://kawalpemilu.org#25342,"SENYUBUK, KELAPA KAMPIT, BELITUNG TIMUR, KEPULAUAN BANGKA BELITUNG",11,177,33,210
https://kawalpemilu.org#25343,"CENDIL, KELAPA KAMPIT, BELITUNG TIMUR, KEPULAUAN BANGKA BELITUNG",1,186,31,217
https://kawalpemilu.org#25343,"CENDIL, KELAPA KAMPIT, BELITUNG TIMUR, KEPULAUAN BANGKA BELITUNG",2,213,43,256
https://kawalpemilu.org#25343,"CENDIL, KELAPA KAMPIT, BELITUNG TIMUR, KEPULAUAN BANGKA BELITUNG",3,134,32,166
https://kawalpemilu.org#25343,"CENDIL, KELAPA KAMPIT, BELITUNG TIMUR, KEPULAUAN BANGKA BELITUNG",4,201,31,232
https://kawalpemilu.org#25343,"CENDIL, KELAPA KAMPIT, BELITUNG TIMUR, KEPULAUAN BANGKA BELITUNG",5,126,65,191
https://kawalpemilu.org#25344,"BUDING, KELAPA KAMPIT, BELITUNG TIMUR, KEPULAUAN BANGKA BELITUNG",1,139,59,198
https://kawalpemilu.org#25344,"BUDING, KELAPA KAMPIT, BELITUNG TIMUR, KEPULAUAN BANGKA BELITUNG",2,105,79,184
https://kawalpemilu.org#25344,"BUDING, KELAPA KAMPIT, BELITUNG TIMUR, KEPULAUAN BANGKA BELITUNG",3,126,80,206
https://kawalpemilu.org#25344,"BUDING, KELAPA KAMPIT, BELITUNG TIMUR, KEPULAUAN BANGKA BELITUNG",4,171,64,235
https://kawalpemilu.org#25344,"BUDING, KELAPA KAMPIT, BELITUNG TIMUR, KEPULAUAN BANGKA BELITUNG",5,175,75,250
https://kawalpemilu.org#25344,"BUDING, KELAPA KAMPIT, BELITUNG TIMUR, KEPULAUAN BANGKA BELITUNG",6,192,37,229
https://kawalpemilu.org#25344,"BUDING, KELAPA KAMPIT, BELITUNG TIMUR, KEPULAUAN BANGKA BELITUNG",7,176,52,228
https://kawalpemilu.org#25344,"BUDING, KELAPA KAMPIT, BELITUNG TIMUR, KEPULAUAN BANGKA BELITUNG",8,179,72,251
https://kawalpemilu.org#25345,"MAYANG, KELAPA KAMPIT, BELITUNG TIMUR, KEPULAUAN BANGKA BELITUNG",1,183,52,235
https://kawalpemilu.org#25345,"MAYANG, KELAPA KAMPIT, BELITUNG TIMUR, KEPULAUAN BANGKA BELITUNG",2,189,61,250
https://kawalpemilu.org#25345,"MAYANG, KELAPA KAMPIT, BELITUNG TIMUR, KEPULAUAN BANGKA BELITUNG",3,159,52,211
https://kawalpemilu.org#25345,"MAYANG, KELAPA KAMPIT, BELITUNG TIMUR, KEPULAUAN BANGKA BELITUNG",4,161,81,242
https://kawalpemilu.org#25345,"MAYANG, KELAPA KAMPIT, BELITUNG TIMUR, KEPULAUAN BANGKA BELITUNG",5,120,90,210
https://kawalpemilu.org#25345,"MAYANG, KELAPA KAMPIT, BELITUNG TIMUR, KEPULAUAN BANGKA BELITUNG",6,184,44,228
https://kawalpemilu.org#25345,"MAYANG, KELAPA KAMPIT, BELITUNG TIMUR, KEPULAUAN BANGKA BELITUNG",7,199,60,259
https://kawalpemilu.org#25345,"MAYANG, KELAPA KAMPIT, BELITUNG TIMUR, KEPULAUAN BANGKA BELITUNG",8,235,35,270
https://kawalpemilu.org#25346,"PEMBAHARUAN, KELAPA KAMPIT, BELITUNG TIMUR, KEPULAUAN BANGKA BELITUNG",1,169,43,212
https://kawalpemilu.org#25346,"PEMBAHARUAN, KELAPA KAMPIT, BELITUNG TIMUR, KEPULAUAN BANGKA BELITUNG",2,136,57,193
https://kawalpemilu.org#25346,"PEMBAHARUAN, KELAPA KAMPIT, BELITUNG TIMUR, KEPULAUAN BANGKA BELITUNG",3,103,45,148
https://kawalpemilu.org#25346,"PEMBAHARUAN, KELAPA KAMPIT, BELITUNG TIMUR, KEPULAUAN BANGKA BELITUNG",4,79,51,130
https://kawalpemilu.org#25346,"PEMBAHARUAN, KELAPA KAMPIT, BELITUNG TIMUR, KEPULAUAN BANGKA BELITUNG",5,132,32,164
https://kawalpemilu.org#25346,"PEMBAHARUAN, KELAPA KAMPIT, BELITUNG TIMUR, KEPULAUAN BANGKA BELITUNG",6,160,39,199
https://kawalpemilu.org#25346,"PEMBAHARUAN, KELAPA KAMPIT, BELITUNG TIMUR, KEPULAUAN BANGKA BELITUNG",7,131,55,186
https://kawalpemilu.org#25346,"PEMBAHARUAN, KELAPA KAMPIT, BELITUNG TIMUR, KEPULAUAN BANGKA BELITUNG",8,100,8,108
https://kawalpemilu.org#25346,"PEMBAHARUAN, KELAPA KAMPIT, BELITUNG TIMUR, KEPULAUAN BANGKA BELITUNG",9,126,39,165
https://kawalpemilu.org#25346,"PEMBAHARUAN, KELAPA KAMPIT, BELITUNG TIMUR, KEPULAUAN BANGKA BELITUNG",10,112,51,163
https://kawalpemilu.org#25346,"PEMBAHARUAN, KELAPA KAMPIT, BELITUNG TIMUR, KEPULAUAN BANGKA BELITUNG",11,90,60,150
https://kawalpemilu.org#25348,"AIR KELIK, DAMAR, BELITUNG TIMUR, KEPULAUAN BANGKA BELITUNG",1,177,46,223
https://kawalpemilu.org#25348,"AIR KELIK, DAMAR, BELITUNG TIMUR, KEPULAUAN BANGKA BELITUNG",2,142,43,185
https://kawalpemilu.org#25348,"AIR KELIK, DAMAR, BELITUNG TIMUR, KEPULAUAN BANGKA BELITUNG",3,201,33,234
https://kawalpemilu.org#25348,"AIR KELIK, DAMAR, BELITUNG TIMUR, KEPULAUAN BANGKA BELITUNG",4,176,41,217
https://kawalpemilu.org#25348,"AIR KELIK, DAMAR, BELITUNG TIMUR, KEPULAUAN BANGKA BELITUNG",5,138,28,166
https://kawalpemilu.org#25348,"AIR KELIK, DAMAR, BELITUNG TIMUR, KEPULAUAN BANGKA BELITUNG",6,124,53,177
https://kawalpemilu.org#25349,"MEMPAYA, DAMAR, BELITUNG TIMUR, KEPULAUAN BANGKA BELITUNG",1,200,44,244
https://kawalpemilu.org#25349,"MEMPAYA, DAMAR, BELITUNG TIMUR, KEPULAUAN BANGKA BELITUNG",2,177,52,229
https://kawalpemilu.org#25349,"MEMPAYA, DAMAR, BELITUNG TIMUR, KEPULAUAN BANGKA BELITUNG",3,181,56,237
https://kawalpemilu.org#25349,"MEMPAYA, DAMAR, BELITUNG TIMUR, KEPULAUAN BANGKA BELITUNG",4,157,41,198
https://kawalpemilu.org#25349,"MEMPAYA, DAMAR, BELITUNG TIMUR, KEPULAUAN BANGKA BELITUNG",5,224,43,267
https://kawalpemilu.org#25349,"MEMPAYA, DAMAR, BELITUNG TIMUR, KEPULAUAN BANGKA BELITUNG",6,202,45,247
https://kawalpemilu.org#25350,"BURONG MANDI, DAMAR, BELITUNG TIMUR, KEPULAUAN BANGKA BELITUNG",1,214,20,234
https://kawalpemilu.org#25350,"BURONG MANDI, DAMAR, BELITUNG TIMUR, KEPULAUAN BANGKA BELITUNG",2,211,13,244
https://kawalpemilu.org#25350,"BURONG MANDI, DAMAR, BELITUNG TIMUR, KEPULAUAN BANGKA BELITUNG",3,188,19,207
https://kawalpemilu.org#25350,"BURONG MANDI, DAMAR, BELITUNG TIMUR, KEPULAUAN BANGKA BELITUNG",4,194,41,235
https://kawalpemilu.org#25351,"MENGKUBANG, DAMAR, BELITUNG TIMUR, KEPULAUAN BANGKA BELITUNG",1,165,38,203
https://kawalpemilu.org#25351,"MENGKUBANG, DAMAR, BELITUNG TIMUR, KEPULAUAN BANGKA BELITUNG",2,166,21,187
https://kawalpemilu.org#25351,"MENGKUBANG, DAMAR, BELITUNG TIMUR, KEPULAUAN BANGKA BELITUNG",3,140,27,167
https://kawalpemilu.org#25351,"MENGKUBANG, DAMAR, BELITUNG TIMUR, KEPULAUAN BANGKA BELITUNG",4,181,51,232
https://kawalpemilu.org#25351,"MENGKUBANG, DAMAR, BELITUNG TIMUR, KEPULAUAN BANGKA BELITUNG",5,147,65,212
https://kawalpemilu.org#25351,"MENGKUBANG, DAMAR, BELITUNG TIMUR, KEPULAUAN BANGKA BELITUNG",6,198,41,239
https://kawalpemilu.org#25351,"MENGKUBANG, DAMAR, BELITUNG TIMUR, KEPULAUAN BANGKA BELITUNG",7,191,54,245
https://kawalpemilu.org#25351,"MENGKUBANG, DAMAR, BELITUNG TIMUR, KEPULAUAN BANGKA BELITUNG",8,190,38,228
https://kawalpemilu.org#25351,"MENGKUBANG, DAMAR, BELITUNG TIMUR, KEPULAUAN BANGKA BELITUNG",9,171,51,222
https://kawalpemilu.org#25352,"SUKAMANDI, DAMAR, BELITUNG TIMUR, KEPULAUAN BANGKA BELITUNG",1,205,31,236
https://kawalpemilu.org#25352,"SUKAMANDI, DAMAR, BELITUNG TIMUR, KEPULAUAN BANGKA BELITUNG",2,188,42,230
https://kawalpemilu.org#25352,"SUKAMANDI, DAMAR, BELITUNG TIMUR, KEPULAUAN BANGKA BELITUNG",3,177,63,240
https://kawalpemilu.org#25352,"SUKAMANDI, DAMAR, BELITUNG TIMUR, KEPULAUAN BANGKA BELITUNG",4,191,47,238
https://kawalpemilu.org#25352,"SUKAMANDI, DAMAR, BELITUNG TIMUR, KEPULAUAN BANGKA BELITUNG",5,183,39,222
https://kawalpemilu.org#25352,"SUKAMANDI, DAMAR, BELITUNG TIMUR, KEPULAUAN BANGKA BELITUNG",6,202,43,245
https://kawalpemilu.org#25352,"SUKAMANDI, DAMAR, BELITUNG TIMUR, KEPULAUAN BANGKA BELITUNG",7,190,27,217
https://kawalpemilu.org#25352,"SUKAMANDI, DAMAR, BELITUNG TIMUR, KEPULAUAN BANGKA BELITUNG",8,175,25,200
https://kawalpemilu.org#25352,"SUKAMANDI, DAMAR, BELITUNG TIMUR, KEPULAUAN BANGKA BELITUNG",9,167,33,200
https://kawalpemilu.org#25352,"SUKAMANDI, DAMAR, BELITUNG TIMUR, KEPULAUAN BANGKA BELITUNG",10,135,24,159
https://kawalpemilu.org#25354,"SIMPANG TIGA, SIMPANG RENGGIANG, BELITUNG TIMUR, KEPULAUAN BANGKA BELITUNG",1,189,65,254
https://kawalpemilu.org#25354,"SIMPANG TIGA, SIMPANG RENGGIANG, BELITUNG TIMUR, KEPULAUAN BANGKA BELITUNG",2,195,53,248
https://kawalpemilu.org#25354,"SIMPANG TIGA, SIMPANG RENGGIANG, BELITUNG TIMUR, KEPULAUAN BANGKA BELITUNG",3,154,44,198
https://kawalpemilu.org#25354,"SIMPANG TIGA, SIMPANG RENGGIANG, BELITUNG TIMUR, KEPULAUAN BANGKA BELITUNG",4,168,49,217
https://kawalpemilu.org#25355,"RENGGIANG, SIMPANG RENGGIANG, BELITUNG TIMUR, KEPULAUAN BANGKA BELITUNG",1,158,38,196
https://kawalpemilu.org#25355,"RENGGIANG, SIMPANG RENGGIANG, BELITUNG TIMUR, KEPULAUAN BANGKA BELITUNG",2,199,41,240
https://kawalpemilu.org#25355,"RENGGIANG, SIMPANG RENGGIANG, BELITUNG TIMUR, KEPULAUAN BANGKA BELITUNG",3,135,26,161
https://kawalpemilu.org#25355,"RENGGIANG, SIMPANG RENGGIANG, BELITUNG TIMUR, KEPULAUAN BANGKA BELITUNG",4,152,28,180
https://kawalpemilu.org#25355,"RENGGIANG, SIMPANG RENGGIANG, BELITUNG TIMUR, KEPULAUAN BANGKA BELITUNG",5,174,22,196
https://kawalpemilu.org#25355,"RENGGIANG, SIMPANG RENGGIANG, BELITUNG TIMUR, KEPULAUAN BANGKA BELITUNG",6,166,29,195
https://kawalpemilu.org#25356,"AIK MADU, SIMPANG RENGGIANG, BELITUNG TIMUR, KEPULAUAN BANGKA BELITUNG",1,197,47,244
https://kawalpemilu.org#25356,"AIK MADU, SIMPANG RENGGIANG, BELITUNG TIMUR, KEPULAUAN BANGKA BELITUNG",2,134,38,172
https://kawalpemilu.org#25356,"AIK MADU, SIMPANG RENGGIANG, BELITUNG TIMUR, KEPULAUAN BANGKA BELITUNG",3,199,22,221
https://kawalpemilu.org#25357,"LINTANG, SIMPANG RENGGIANG, BELITUNG TIMUR, KEPULAUAN BANGKA BELITUNG",1,190,68,258
https://kawalpemilu.org#25357,"LINTANG, SIMPANG RENGGIANG, BELITUNG TIMUR, KEPULAUAN BANGKA BELITUNG",2,176,60,236
https://kawalpemilu.org#25357,"LINTANG, SIMPANG RENGGIANG, BELITUNG TIMUR, KEPULAUAN BANGKA BELITUNG",3,178,68,246
https://kawalpemilu.org#25357,"LINTANG, SIMPANG RENGGIANG, BELITUNG TIMUR, KEPULAUAN BANGKA BELITUNG",4,165,89,254
https://kawalpemilu.org#25357,"LINTANG, SIMPANG RENGGIANG, BELITUNG TIMUR, KEPULAUAN BANGKA BELITUNG",5,186,68,254
https://kawalpemilu.org#25357,"LINTANG, SIMPANG RENGGIANG, BELITUNG TIMUR, KEPULAUAN BANGKA BELITUNG",6,197,43,240
https://kawalpemilu.org#25357,"LINTANG, SIMPANG RENGGIANG, BELITUNG TIMUR, KEPULAUAN BANGKA BELITUNG",7,172,49,221
https://kawalpemilu.org#25357,"LINTANG, SIMPANG RENGGIANG, BELITUNG TIMUR, KEPULAUAN BANGKA BELITUNG",8,229,31,260
https://kawalpemilu.org#25359,"SIMPANG PESAK, SIMPANG PESAK, BELITUNG TIMUR, KEPULAUAN BANGKA BELITUNG",1,211,55,266
https://kawalpemilu.org#25359,"SIMPANG PESAK, SIMPANG PESAK, BELITUNG TIMUR, KEPULAUAN BANGKA BELITUNG",2,198,61,259
https://kawalpemilu.org#25359,"SIMPANG PESAK, SIMPANG PESAK, BELITUNG TIMUR, KEPULAUAN BANGKA BELITUNG",3,173,86,259
https://kawalpemilu.org#25359,"SIMPANG PESAK, SIMPANG PESAK, BELITUNG TIMUR, KEPULAUAN BANGKA BELITUNG",4,174,80,254
https://kawalpemilu.org#25359,"SIMPANG PESAK, SIMPANG PESAK, BELITUNG TIMUR, KEPULAUAN BANGKA BELITUNG",5,216,29,245
https://kawalpemilu.org#25359,"SIMPANG PESAK, SIMPANG PESAK, BELITUNG TIMUR, KEPULAUAN BANGKA BELITUNG",6,197,46,243
https://kawalpemilu.org#25359,"SIMPANG PESAK, SIMPANG PESAK, BELITUNG TIMUR, KEPULAUAN BANGKA BELITUNG",7,182,52,234
https://kawalpemilu.org#25359,"SIMPANG PESAK, SIMPANG PESAK, BELITUNG TIMUR, KEPULAUAN BANGKA BELITUNG",8,204,31,235
https://kawalpemilu.org#25359,"SIMPANG PESAK, SIMPANG PESAK, BELITUNG TIMUR, KEPULAUAN BANGKA BELITUNG",9,218,29,247
https://kawalpemilu.org#25360,"TANJUNG BATU ITAM, SIMPANG PESAK, BELITUNG TIMUR, KEPULAUAN BANGKA BELITUNG",1,180,27,207
https://kawalpemilu.org#25360,"TANJUNG BATU ITAM, SIMPANG PESAK, BELITUNG TIMUR, KEPULAUAN BANGKA BELITUNG",2,194,52,246
https://kawalpemilu.org#25360,"TANJUNG BATU ITAM, SIMPANG PESAK, BELITUNG TIMUR, KEPULAUAN BANGKA BELITUNG",3,218,25,243
https://kawalpemilu.org#25360,"TANJUNG BATU ITAM, SIMPANG PESAK, BELITUNG TIMUR, KEPULAUAN BANGKA BELITUNG",4,218,23,241
https://kawalpemilu.org#25360,"TANJUNG BATU ITAM, SIMPANG PESAK, BELITUNG TIMUR, KEPULAUAN BANGKA BELITUNG",5,149,23,172
https://kawalpemilu.org#25361,"TANJUNG KELUMPANG, SIMPANG PESAK, BELITUNG TIMUR, KEPULAUAN BANGKA BELITUNG",1,176,33,209
https://kawalpemilu.org#25361,"TANJUNG KELUMPANG, SIMPANG PESAK, BELITUNG TIMUR, KEPULAUAN BANGKA BELITUNG",2,181,54,235
https://kawalpemilu.org#25361,"TANJUNG KELUMPANG, SIMPANG PESAK, BELITUNG TIMUR, KEPULAUAN BANGKA BELITUNG",3,197,33,230
https://kawalpemilu.org#25361,"TANJUNG KELUMPANG, SIMPANG PESAK, BELITUNG TIMUR, KEPULAUAN BANGKA BELITUNG",4,192,34,226
https://kawalpemilu.org#25361,"TANJUNG KELUMPANG, SIMPANG PESAK, BELITUNG TIMUR, KEPULAUAN BANGKA BELITUNG",5,57,38,95
https://kawalpemilu.org#25361,"TANJUNG KELUMPANG, SIMPANG PESAK, BELITUNG TIMUR, KEPULAUAN BANGKA BELITUNG",6,25,60,85
https://kawalpemilu.org#25362,"DUKONG, SIMPANG PESAK, BELITUNG TIMUR, KEPULAUAN BANGKA BELITUNG",1,179,37,216
https://kawalpemilu.org#25362,"DUKONG, SIMPANG PESAK, BELITUNG TIMUR, KEPULAUAN BANGKA BELITUNG",2,121,39,160
https://kawalpemilu.org#25362,"DUKONG, SIMPANG PESAK, BELITUNG TIMUR, KEPULAUAN BANGKA BELITUNG",3,141,61,202
https://kawalpemilu.org#25368,"SEMABUNG LAMA, BUKITINTAN, KOTA PANGKALPINANG, KEPULAUAN BANGKA BELITUNG",1,220,6,226
https://kawalpemilu.org#25368,"SEMABUNG LAMA, BUKITINTAN, KOTA PANGKALPINANG, KEPULAUAN BANGKA BELITUNG",2,106,98,204
https://kawalpemilu.org#25368,"SEMABUNG LAMA, BUKITINTAN, KOTA PANGKALPINANG, KEPULAUAN BANGKA BELITUNG",3,121,113,234
https://kawalpemilu.org#25368,"SEMABUNG LAMA, BUKITINTAN, KOTA PANGKALPINANG, KEPULAUAN BANGKA BELITUNG",4,102,109,211
https://kawalpemilu.org#25368,"SEMABUNG LAMA, BUKITINTAN, KOTA PANGKALPINANG, KEPULAUAN BANGKA BELITUNG",5,126,119,245
https://kawalpemilu.org#25368,"SEMABUNG LAMA, BUKITINTAN, KOTA PANGKALPINANG, KEPULAUAN BANGKA BELITUNG",6,117,137,254
https://kawalpemilu.org#25368,"SEMABUNG LAMA, BUKITINTAN, KOTA PANGKALPINANG, KEPULAUAN BANGKA BELITUNG",7,167,74,241
https://kawalpemilu.org#25368,"SEMABUNG LAMA, BUKITINTAN, KOTA PANGKALPINANG, KEPULAUAN BANGKA BELITUNG",8,225,49,274
https://kawalpemilu.org#25368,"SEMABUNG LAMA, BUKITINTAN, KOTA PANGKALPINANG, KEPULAUAN BANGKA BELITUNG",9,102,136,238
https://kawalpemilu.org#25368,"SEMABUNG LAMA, BUKITINTAN, KOTA PANGKALPINANG, KEPULAUAN BANGKA BELITUNG",10,110,134,244
https://kawalpemilu.org#25368,"SEMABUNG LAMA, BUKITINTAN, KOTA PANGKALPINANG, KEPULAUAN BANGKA BELITUNG",11,112,152,264
https://kawalpemilu.org#25368,"SEMABUNG LAMA, BUKITINTAN, KOTA PANGKALPINANG, KEPULAUAN BANGKA BELITUNG",12,122,117,239
https://kawalpemilu.org#25368,"SEMABUNG LAMA, BUKITINTAN, KOTA PANGKALPINANG, KEPULAUAN BANGKA BELITUNG",13,207,24,231
https://kawalpemilu.org#25368,"SEMABUNG LAMA, BUKITINTAN, KOTA PANGKALPINANG, KEPULAUAN BANGKA BELITUNG",14,225,13,238
https://kawalpemilu.org#25368,"SEMABUNG LAMA, BUKITINTAN, KOTA PANGKALPINANG, KEPULAUAN BANGKA BELITUNG",15,220,14,234
https://kawalpemilu.org#25368,"SEMABUNG LAMA, BUKITINTAN, KOTA PANGKALPINANG, KEPULAUAN BANGKA BELITUNG",16,235,10,245
https://kawalpemilu.org#25368,"SEMABUNG LAMA, BUKITINTAN, KOTA PANGKALPINANG, KEPULAUAN BANGKA BELITUNG",17,183,7,190
https://kawalpemilu.org#25370,"BACANG, BUKITINTAN, KOTA PANGKALPINANG, KEPULAUAN BANGKA BELITUNG",1,253,5,258
https://kawalpemilu.org#25370,"BACANG, BUKITINTAN, KOTA PANGKALPINANG, KEPULAUAN BANGKA BELITUNG",2,254,22,276
https://kawalpemilu.org#25370,"BACANG, BUKITINTAN, KOTA PANGKALPINANG, KEPULAUAN BANGKA BELITUNG",3,108,118,226
https://kawalpemilu.org#25370,"BACANG, BUKITINTAN, KOTA PANGKALPINANG, KEPULAUAN BANGKA BELITUNG",4,137,15,152
https://kawalpemilu.org#25370,"BACANG, BUKITINTAN, KOTA PANGKALPINANG, KEPULAUAN BANGKA BELITUNG",5,207,28,235
https://kawalpemilu.org#25370,"BACANG, BUKITINTAN, KOTA PANGKALPINANG, KEPULAUAN BANGKA BELITUNG",6,211,7,218
https://kawalpemilu.org#25370,"BACANG, BUKITINTAN, KOTA PANGKALPINANG, KEPULAUAN BANGKA BELITUNG",7,148,14,162
https://kawalpemilu.org#25370,"BACANG, BUKITINTAN, KOTA PANGKALPINANG, KEPULAUAN BANGKA BELITUNG",8,139,141,280
https://kawalpemilu.org#25370,"BACANG, BUKITINTAN, KOTA PANGKALPINANG, KEPULAUAN BANGKA BELITUNG",9,211,46,257
https://kawalpemilu.org#25370,"BACANG, BUKITINTAN, KOTA PANGKALPINANG, KEPULAUAN BANGKA BELITUNG",10,214,48,262
https://kawalpemilu.org#25370,"BACANG, BUKITINTAN, KOTA PANGKALPINANG, KEPULAUAN BANGKA BELITUNG",11,120,134,254
https://kawalpemilu.org#25370,"BACANG, BUKITINTAN, KOTA PANGKALPINANG, KEPULAUAN BANGKA BELITUNG",12,113,72,185
https://kawalpemilu.org#25370,"BACANG, BUKITINTAN, KOTA PANGKALPINANG, KEPULAUAN BANGKA BELITUNG",13,143,42,185
https://kawalpemilu.org#25371,"AIR ITAM, BUKITINTAN, KOTA PANGKALPINANG, KEPULAUAN BANGKA BELITUNG",1,91,87,178
https://kawalpemilu.org#25371,"AIR ITAM, BUKITINTAN, KOTA PANGKALPINANG, KEPULAUAN BANGKA BELITUNG",2,68,123,191
https://kawalpemilu.org#25371,"AIR ITAM, BUKITINTAN, KOTA PANGKALPINANG, KEPULAUAN BANGKA BELITUNG",3,108,158,266
https://kawalpemilu.org#25371,"AIR ITAM, BUKITINTAN, KOTA PANGKALPINANG, KEPULAUAN BANGKA BELITUNG",4,85,174,259
https://kawalpemilu.org#25371,"AIR ITAM, BUKITINTAN, KOTA PANGKALPINANG, KEPULAUAN BANGKA BELITUNG",5,72,144,216
https://kawalpemilu.org#25371,"AIR ITAM, BUKITINTAN, KOTA PANGKALPINANG, KEPULAUAN BANGKA BELITUNG",6,62,155,217
https://kawalpemilu.org#25371,"AIR ITAM, BUKITINTAN, KOTA PANGKALPINANG, KEPULAUAN BANGKA BELITUNG",7,109,157,266
https://kawalpemilu.org#25371,"AIR ITAM, BUKITINTAN, KOTA PANGKALPINANG, KEPULAUAN BANGKA BELITUNG",8,81,142,223
https://kawalpemilu.org#25371,"AIR ITAM, BUKITINTAN, KOTA PANGKALPINANG, KEPULAUAN BANGKA BELITUNG",9,99,120,219
https://kawalpemilu.org#25371,"AIR ITAM, BUKITINTAN, KOTA PANGKALPINANG, KEPULAUAN BANGKA BELITUNG",10,81,175,256
https://kawalpemilu.org#25371,"AIR ITAM, BUKITINTAN, KOTA PANGKALPINANG, KEPULAUAN BANGKA BELITUNG",11,121,124,245
https://kawalpemilu.org#25371,"AIR ITAM, BUKITINTAN, KOTA PANGKALPINANG, KEPULAUAN BANGKA BELITUNG",12,71,132,203
https://kawalpemilu.org#25371,"AIR ITAM, BUKITINTAN, KOTA PANGKALPINANG, KEPULAUAN BANGKA BELITUNG",13,91,124,215
https://kawalpemilu.org#25371,"AIR ITAM, BUKITINTAN, KOTA PANGKALPINANG, KEPULAUAN BANGKA BELITUNG",14,71,117,188
https://kawalpemilu.org#25392,"PASIR PUTIH, BUKITINTAN, KOTA PANGKALPINANG, KEPULAUAN BANGKA BELITUNG",1,151,29,180
https://kawalpemilu.org#25392,"PASIR PUTIH, BUKITINTAN, KOTA PANGKALPINANG, KEPULAUAN BANGKA BELITUNG",2,126,38,164
https://kawalpemilu.org#25392,"PASIR PUTIH, BUKITINTAN, KOTA PANGKALPINANG, KEPULAUAN BANGKA BELITUNG",3,169,70,239
https://kawalpemilu.org#25392,"PASIR PUTIH, BUKITINTAN, KOTA PANGKALPINANG, KEPULAUAN BANGKA BELITUNG",5,202,23,225
https://kawalpemilu.org#25392,"PASIR PUTIH, BUKITINTAN, KOTA PANGKALPINANG, KEPULAUAN BANGKA BELITUNG",6,153,38,191
https://kawalpemilu.org#25392,"PASIR PUTIH, BUKITINTAN, KOTA PANGKALPINANG, KEPULAUAN BANGKA BELITUNG",7,161,83,244
https://kawalpemilu.org#25392,"PASIR PUTIH, BUKITINTAN, KOTA PANGKALPINANG, KEPULAUAN BANGKA BELITUNG",8,220,23,243
https://kawalpemilu.org#25392,"PASIR PUTIH, BUKITINTAN, KOTA PANGKALPINANG, KEPULAUAN BANGKA BELITUNG",9,184,35,219
https://kawalpemilu.org#25392,"PASIR PUTIH, BUKITINTAN, KOTA PANGKALPINANG, KEPULAUAN BANGKA BELITUNG",10,181,27,208
https://kawalpemilu.org#25392,"PASIR PUTIH, BUKITINTAN, KOTA PANGKALPINANG, KEPULAUAN BANGKA BELITUNG",11,195,55,250
https://kawalpemilu.org#25392,"PASIR PUTIH, BUKITINTAN, KOTA PANGKALPINANG, KEPULAUAN BANGKA BELITUNG",12,170,35,205
https://kawalpemilu.org#87523,"TEMBERAN, BUKITINTAN, KOTA PANGKALPINANG, KEPULAUAN BANGKA BELITUNG",1,152,117,269
https://kawalpemilu.org#87523,"TEMBERAN, BUKITINTAN, KOTA PANGKALPINANG, KEPULAUAN BANGKA BELITUNG",2,146,119,265
https://kawalpemilu.org#87523,"TEMBERAN, BUKITINTAN, KOTA PANGKALPINANG, KEPULAUAN BANGKA BELITUNG",3,155,136,291
https://kawalpemilu.org#87523,"TEMBERAN, BUKITINTAN, KOTA PANGKALPINANG, KEPULAUAN BANGKA BELITUNG",4,81,211,292
https://kawalpemilu.org#87523,"TEMBERAN, BUKITINTAN, KOTA PANGKALPINANG, KEPULAUAN BANGKA BELITUNG",5,103,107,210
https://kawalpemilu.org#87523,"TEMBERAN, BUKITINTAN, KOTA PANGKALPINANG, KEPULAUAN BANGKA BELITUNG",6,99,125,224
https://kawalpemilu.org#87523,"TEMBERAN, BUKITINTAN, KOTA PANGKALPINANG, KEPULAUAN BANGKA BELITUNG",7,159,89,248
https://kawalpemilu.org#87523,"TEMBERAN, BUKITINTAN, KOTA PANGKALPINANG, KEPULAUAN BANGKA BELITUNG",8,110,169,279
https://kawalpemilu.org#87523,"TEMBERAN, BUKITINTAN, KOTA PANGKALPINANG, KEPULAUAN BANGKA BELITUNG",9,134,151,285
https://kawalpemilu.org#87525,"SINAR BULAN, BUKITINTAN, KOTA PANGKALPINANG, KEPULAUAN BANGKA BELITUNG",1,128,115,243
https://kawalpemilu.org#87525,"SINAR BULAN, BUKITINTAN, KOTA PANGKALPINANG, KEPULAUAN BANGKA BELITUNG",2,146,98,244
https://kawalpemilu.org#87525,"SINAR BULAN, BUKITINTAN, KOTA PANGKALPINANG, KEPULAUAN BANGKA BELITUNG",3,226,26,252
https://kawalpemilu.org#87525,"SINAR BULAN, BUKITINTAN, KOTA PANGKALPINANG, KEPULAUAN BANGKA BELITUNG",4,199,35,234
https://kawalpemilu.org#87525,"SINAR BULAN, BUKITINTAN, KOTA PANGKALPINANG, KEPULAUAN BANGKA BELITUNG",5,186,32,218
https://kawalpemilu.org#87525,"SINAR BULAN, BUKITINTAN, KOTA PANGKALPINANG, KEPULAUAN BANGKA BELITUNG",6,138,113,251
https://kawalpemilu.org#87525,"SINAR BULAN, BUKITINTAN, KOTA PANGKALPINANG, KEPULAUAN BANGKA BELITUNG",7,114,125,239
https://kawalpemilu.org#87525,"SINAR BULAN, BUKITINTAN, KOTA PANGKALPINANG, KEPULAUAN BANGKA BELITUNG",8,114,108,222
https://kawalpemilu.org#87525,"SINAR BULAN, BUKITINTAN, KOTA PANGKALPINANG, KEPULAUAN BANGKA BELITUNG",9,111,151,262
https://kawalpemilu.org#87525,"SINAR BULAN, BUKITINTAN, KOTA PANGKALPINANG, KEPULAUAN BANGKA BELITUNG",10,168,100,268
https://kawalpemilu.org#87525,"SINAR BULAN, BUKITINTAN, KOTA PANGKALPINANG, KEPULAUAN BANGKA BELITUNG",11,110,152,262
https://kawalpemilu.org#87525,"SINAR BULAN, BUKITINTAN, KOTA PANGKALPINANG, KEPULAUAN BANGKA BELITUNG",12,98,121,219
https://kawalpemilu.org#87526,"AIR MAWAR, BUKITINTAN, KOTA PANGKALPINANG, KEPULAUAN BANGKA BELITUNG",1,158,82,240
https://kawalpemilu.org#87526,"AIR MAWAR, BUKITINTAN, KOTA PANGKALPINANG, KEPULAUAN BANGKA BELITUNG",2,159,64,223
https://kawalpemilu.org#87526,"AIR MAWAR, BUKITINTAN, KOTA PANGKALPINANG, KEPULAUAN BANGKA BELITUNG",3,235,17,252
https://kawalpemilu.org#87526,"AIR MAWAR, BUKITINTAN, KOTA PANGKALPINANG, KEPULAUAN BANGKA BELITUNG",4,147,81,230
https://kawalpemilu.org#87526,"AIR MAWAR, BUKITINTAN, KOTA PANGKALPINANG, KEPULAUAN BANGKA BELITUNG",5,196,33,229
https://kawalpemilu.org#87526,"AIR MAWAR, BUKITINTAN, KOTA PANGKALPINANG, KEPULAUAN BANGKA BELITUNG",6,157,6,163
https://kawalpemilu.org#87526,"AIR MAWAR, BUKITINTAN, KOTA PANGKALPINANG, KEPULAUAN BANGKA BELITUNG",7,176,37,213
https://kawalpemilu.org#87526,"AIR MAWAR, BUKITINTAN, KOTA PANGKALPINANG, KEPULAUAN BANGKA BELITUNG",8,125,21,146
https://kawalpemilu.org#25373,"OPAS INDAH, TAMAN SARI, KOTA PANGKALPINANG, KEPULAUAN BANGKA BELITUNG",1,58,50,108
https://kawalpemilu.org#25373,"OPAS INDAH, TAMAN SARI, KOTA PANGKALPINANG, KEPULAUAN BANGKA BELITUNG",2,87,157,244
https://kawalpemilu.org#25373,"OPAS INDAH, TAMAN SARI, KOTA PANGKALPINANG, KEPULAUAN BANGKA BELITUNG",3,132,78,210
https://kawalpemilu.org#25373,"OPAS INDAH, TAMAN SARI, KOTA PANGKALPINANG, KEPULAUAN BANGKA BELITUNG",4,115,100,215
https://kawalpemilu.org#25373,"OPAS INDAH, TAMAN SARI, KOTA PANGKALPINANG, KEPULAUAN BANGKA BELITUNG",5,106,120,226
https://kawalpemilu.org#25373,"OPAS INDAH, TAMAN SARI, KOTA PANGKALPINANG, KEPULAUAN BANGKA BELITUNG",6,110,125,235
https://kawalpemilu.org#25373,"OPAS INDAH, TAMAN SARI, KOTA PANGKALPINANG, KEPULAUAN BANGKA BELITUNG",7,99,111,210
https://kawalpemilu.org#25373,"OPAS INDAH, TAMAN SARI, KOTA PANGKALPINANG, KEPULAUAN BANGKA BELITUNG",8,85,94,179
https://kawalpemilu.org#25373,"OPAS INDAH, TAMAN SARI, KOTA PANGKALPINANG, KEPULAUAN BANGKA BELITUNG",9,108,118,226
https://kawalpemilu.org#25373,"OPAS INDAH, TAMAN SARI, KOTA PANGKALPINANG, KEPULAUAN BANGKA BELITUNG",10,111,86,197
https://kawalpemilu.org#25373,"OPAS INDAH, TAMAN SARI, KOTA PANGKALPINANG, KEPULAUAN BANGKA BELITUNG",11,127,93,220
https://kawalpemilu.org#25373,"OPAS INDAH, TAMAN SARI, KOTA PANGKALPINANG, KEPULAUAN BANGKA BELITUNG",12,85,115,200
https://kawalpemilu.org#25373,"OPAS INDAH, TAMAN SARI, KOTA PANGKALPINANG, KEPULAUAN BANGKA BELITUNG",13,91,86,177
https://kawalpemilu.org#25374,"GEDUNG NASIONAL, TAMAN SARI, KOTA PANGKALPINANG, KEPULAUAN BANGKA BELITUNG",1,79,99,178
https://kawalpemilu.org#25374,"GEDUNG NASIONAL, TAMAN SARI, KOTA PANGKALPINANG, KEPULAUAN BANGKA BELITUNG",2,107,126,233
https://kawalpemilu.org#25374,"GEDUNG NASIONAL, TAMAN SARI, KOTA PANGKALPINANG, KEPULAUAN BANGKA BELITUNG",3,64,130,194
https://kawalpemilu.org#25374,"GEDUNG NASIONAL, TAMAN SARI, KOTA PANGKALPINANG, KEPULAUAN BANGKA BELITUNG",4,158,101,259
https://kawalpemilu.org#25374,"GEDUNG NASIONAL, TAMAN SARI, KOTA PANGKALPINANG, KEPULAUAN BANGKA BELITUNG",5,168,9,177
https://kawalpemilu.org#25374,"GEDUNG NASIONAL, TAMAN SARI, KOTA PANGKALPINANG, KEPULAUAN BANGKA BELITUNG",6,138,37,175
https://kawalpemilu.org#25374,"GEDUNG NASIONAL, TAMAN SARI, KOTA PANGKALPINANG, KEPULAUAN BANGKA BELITUNG",7,95,87,182
https://kawalpemilu.org#25374,"GEDUNG NASIONAL, TAMAN SARI, KOTA PANGKALPINANG, KEPULAUAN BANGKA BELITUNG",8,117,140,257
https://kawalpemilu.org#25374,"GEDUNG NASIONAL, TAMAN SARI, KOTA PANGKALPINANG, KEPULAUAN BANGKA BELITUNG",9,94,119,213
https://kawalpemilu.org#25375,"BATIN TIKAL, TAMAN SARI, KOTA PANGKALPINANG, KEPULAUAN BANGKA BELITUNG",1,71,62,133
https://kawalpemilu.org#25375,"BATIN TIKAL, TAMAN SARI, KOTA PANGKALPINANG, KEPULAUAN BANGKA BELITUNG",2,64,90,154
https://kawalpemilu.org#25375,"BATIN TIKAL, TAMAN SARI, KOTA PANGKALPINANG, KEPULAUAN BANGKA BELITUNG",3,79,67,146
https://kawalpemilu.org#25375,"BATIN TIKAL, TAMAN SARI, KOTA PANGKALPINANG, KEPULAUAN BANGKA BELITUNG",4,78,115,193
https://kawalpemilu.org#25375,"BATIN TIKAL, TAMAN SARI, KOTA PANGKALPINANG, KEPULAUAN BANGKA BELITUNG",5,39,84,123
https://kawalpemilu.org#25375,"BATIN TIKAL, TAMAN SARI, KOTA PANGKALPINANG, KEPULAUAN BANGKA BELITUNG",6,75,112,187
https://kawalpemilu.org#25375,"BATIN TIKAL, TAMAN SARI, KOTA PANGKALPINANG, KEPULAUAN BANGKA BELITUNG",7,92,129,221
https://kawalpemilu.org#25375,"BATIN TIKAL, TAMAN SARI, KOTA PANGKALPINANG, KEPULAUAN BANGKA BELITUNG",8,45,53,98
https://kawalpemilu.org#25375,"BATIN TIKAL, TAMAN SARI, KOTA PANGKALPINANG, KEPULAUAN BANGKA BELITUNG",9,128,46,174
https://kawalpemilu.org#25375,"BATIN TIKAL, TAMAN SARI, KOTA PANGKALPINANG, KEPULAUAN BANGKA BELITUNG",10,7,30,37
https://kawalpemilu.org#25375,"BATIN TIKAL, TAMAN SARI, KOTA PANGKALPINANG, KEPULAUAN BANGKA BELITUNG",11,72,49,121
https://kawalpemilu.org#25375,"BATIN TIKAL, TAMAN SARI, KOTA PANGKALPINANG, KEPULAUAN BANGKA BELITUNG",12,62,67,129
https://kawalpemilu.org#25375,"BATIN TIKAL, TAMAN SARI, KOTA PANGKALPINANG, KEPULAUAN BANGKA BELITUNG",13,53,61,114
https://kawalpemilu.org#25376,"RAWA BANGUN, TAMAN SARI, KOTA PANGKALPINANG, KEPULAUAN BANGKA BELITUNG",1,85,108,193
https://kawalpemilu.org#25376,"RAWA BANGUN, TAMAN SARI, KOTA PANGKALPINANG, KEPULAUAN BANGKA BELITUNG",2,74,87,161
https://kawalpemilu.org#25376,"RAWA BANGUN, TAMAN SARI, KOTA PANGKALPINANG, KEPULAUAN BANGKA BELITUNG",3,59,93,152
https://kawalpemilu.org#25376,"RAWA BANGUN, TAMAN SARI, KOTA PANGKALPINANG, KEPULAUAN BANGKA BELITUNG",4,86,106,192
https://kawalpemilu.org#25376,"RAWA BANGUN, TAMAN SARI, KOTA PANGKALPINANG, KEPULAUAN BANGKA BELITUNG",5,78,127,205
https://kawalpemilu.org#25376,"RAWA BANGUN, TAMAN SARI, KOTA PANGKALPINANG, KEPULAUAN BANGKA BELITUNG",6,91,117,208
https://kawalpemilu.org#25376,"RAWA BANGUN, TAMAN SARI, KOTA PANGKALPINANG, KEPULAUAN BANGKA BELITUNG",7,76,119,195
https://kawalpemilu.org#25376,"RAWA BANGUN, TAMAN SARI, KOTA PANGKALPINANG, KEPULAUAN BANGKA BELITUNG",8,76,110,186
https://kawalpemilu.org#25376,"RAWA BANGUN, TAMAN SARI, KOTA PANGKALPINANG, KEPULAUAN BANGKA BELITUNG",9,87,116,203
https://kawalpemilu.org#87522,"KEJAKSAAN, TAMAN SARI, KOTA PANGKALPINANG, KEPULAUAN BANGKA BELITUNG",1,129,107,236
https://kawalpemilu.org#87522,"KEJAKSAAN, TAMAN SARI, KOTA PANGKALPINANG, KEPULAUAN BANGKA BELITUNG",2,116,115,231
https://kawalpemilu.org#87522,"KEJAKSAAN, TAMAN SARI, KOTA PANGKALPINANG, KEPULAUAN BANGKA BELITUNG",3,65,92,157
https://kawalpemilu.org#87522,"KEJAKSAAN, TAMAN SARI, KOTA PANGKALPINANG, KEPULAUAN BANGKA BELITUNG",4,68,102,170
https://kawalpemilu.org#87522,"KEJAKSAAN, TAMAN SARI, KOTA PANGKALPINANG, KEPULAUAN BANGKA BELITUNG",5,80,138,218
https://kawalpemilu.org#87522,"KEJAKSAAN, TAMAN SARI, KOTA PANGKALPINANG, KEPULAUAN BANGKA BELITUNG",6,106,145,251
https://kawalpemilu.org#87522,"KEJAKSAAN, TAMAN SARI, KOTA PANGKALPINANG, KEPULAUAN BANGKA BELITUNG",7,142,119,261
https://kawalpemilu.org#87522,"KEJAKSAAN, TAMAN SARI, KOTA PANGKALPINANG, KEPULAUAN BANGKA BELITUNG",8,125,144,269
https://kawalpemilu.org#87522,"KEJAKSAAN, TAMAN SARI, KOTA PANGKALPINANG, KEPULAUAN BANGKA BELITUNG",9,90,143,233
https://kawalpemilu.org#87522,"KEJAKSAAN, TAMAN SARI, KOTA PANGKALPINANG, KEPULAUAN BANGKA BELITUNG",10,105,99,204
https://kawalpemilu.org#87522,"KEJAKSAAN, TAMAN SARI, KOTA PANGKALPINANG, KEPULAUAN BANGKA BELITUNG",11,92,142,234
https://kawalpemilu.org#87522,"KEJAKSAAN, TAMAN SARI, KOTA PANGKALPINANG, KEPULAUAN BANGKA BELITUNG",12,98,120,218
https://kawalpemilu.org#87522,"KEJAKSAAN, TAMAN SARI, KOTA PANGKALPINANG, KEPULAUAN BANGKA BELITUNG",13,95,104,199
https://kawalpemilu.org#87522,"KEJAKSAAN, TAMAN SARI, KOTA PANGKALPINANG, KEPULAUAN BANGKA BELITUNG",14,110,133,243
https://kawalpemilu.org#87522,"KEJAKSAAN, TAMAN SARI, KOTA PANGKALPINANG, KEPULAUAN BANGKA BELITUNG",15,123,118,241
https://kawalpemilu.org#87522,"KEJAKSAAN, TAMAN SARI, KOTA PANGKALPINANG, KEPULAUAN BANGKA BELITUNG",16,80,94,174
https://kawalpemilu.org#87522,"KEJAKSAAN, TAMAN SARI, KOTA PANGKALPINANG, KEPULAUAN BANGKA BELITUNG",17,100,125,225
https://kawalpemilu.org#87522,"KEJAKSAAN, TAMAN SARI, KOTA PANGKALPINANG, KEPULAUAN BANGKA BELITUNG",18,30,113,143
https://kawalpemilu.org#25381,"PASIR GARAM, PANGKAL BALAM, KOTA PANGKALPINANG, KEPULAUAN BANGKA BELITUNG",1,132,4,136
https://kawalpemilu.org#25381,"PASIR GARAM, PANGKAL BALAM, KOTA PANGKALPINANG, KEPULAUAN BANGKA BELITUNG",2,190,22,212
https://kawalpemilu.org#25381,"PASIR GARAM, PANGKAL BALAM, KOTA PANGKALPINANG, KEPULAUAN BANGKA BELITUNG",3,221,1,222
https://kawalpemilu.org#25381,"PASIR GARAM, PANGKAL BALAM, KOTA PANGKALPINANG, KEPULAUAN BANGKA BELITUNG",4,203,24,227
https://kawalpemilu.org#25381,"PASIR GARAM, PANGKAL BALAM, KOTA PANGKALPINANG, KEPULAUAN BANGKA BELITUNG",5,167,21,188
https://kawalpemilu.org#25381,"PASIR GARAM, PANGKAL BALAM, KOTA PANGKALPINANG, KEPULAUAN BANGKA BELITUNG",6,74,96,170
https://kawalpemilu.org#25381,"PASIR GARAM, PANGKAL BALAM, KOTA PANGKALPINANG, KEPULAUAN BANGKA BELITUNG",7,133,43,176
https://kawalpemilu.org#25381,"PASIR GARAM, PANGKAL BALAM, KOTA PANGKALPINANG, KEPULAUAN BANGKA BELITUNG",8,142,2,144
https://kawalpemilu.org#25381,"PASIR GARAM, PANGKAL BALAM, KOTA PANGKALPINANG, KEPULAUAN BANGKA BELITUNG",9,53,102,155
https://kawalpemilu.org#25382,"LONTONG PANCUR, PANGKAL BALAM, KOTA PANGKALPINANG, KEPULAUAN BANGKA BELITUNG",1,148,52,200
https://kawalpemilu.org#25382,"LONTONG PANCUR, PANGKAL BALAM, KOTA PANGKALPINANG, KEPULAUAN BANGKA BELITUNG",2,127,44,171
https://kawalpemilu.org#25382,"LONTONG PANCUR, PANGKAL BALAM, KOTA PANGKALPINANG, KEPULAUAN BANGKA BELITUNG",3,120,83,203
https://kawalpemilu.org#25382,"LONTONG PANCUR, PANGKAL BALAM, KOTA PANGKALPINANG, KEPULAUAN BANGKA BELITUNG",4,100,76,176
https://kawalpemilu.org#25382,"LONTONG PANCUR, PANGKAL BALAM, KOTA PANGKALPINANG, KEPULAUAN BANGKA BELITUNG",5,103,49,152
https://kawalpemilu.org#25382,"LONTONG PANCUR, PANGKAL BALAM, KOTA PANGKALPINANG, KEPULAUAN BANGKA BELITUNG",6,125,103,228
https://kawalpemilu.org#25382,"LONTONG PANCUR, PANGKAL BALAM, KOTA PANGKALPINANG, KEPULAUAN BANGKA BELITUNG",7,111,102,213
https://kawalpemilu.org#25382,"LONTONG PANCUR, PANGKAL BALAM, KOTA PANGKALPINANG, KEPULAUAN BANGKA BELITUNG",8,101,77,178
https://kawalpemilu.org#25382,"LONTONG PANCUR, PANGKAL BALAM, KOTA PANGKALPINANG, KEPULAUAN BANGKA BELITUNG",9,100,60,160
https://kawalpemilu.org#25382,"LONTONG PANCUR, PANGKAL BALAM, KOTA PANGKALPINANG, KEPULAUAN BANGKA BELITUNG",10,107,44,151
https://kawalpemilu.org#25382,"LONTONG PANCUR, PANGKAL BALAM, KOTA PANGKALPINANG, KEPULAUAN BANGKA BELITUNG",11,99,104,203
https://kawalpemilu.org#25382,"LONTONG PANCUR, PANGKAL BALAM, KOTA PANGKALPINANG, KEPULAUAN BANGKA BELITUNG",12,116,84,200
https://kawalpemilu.org#25382,"LONTONG PANCUR, PANGKAL BALAM, KOTA PANGKALPINANG, KEPULAUAN BANGKA BELITUNG",13,98,103,201
https://kawalpemilu.org#25382,"LONTONG PANCUR, PANGKAL BALAM, KOTA PANGKALPINANG, KEPULAUAN BANGKA BELITUNG",14,131,76,207
https://kawalpemilu.org#25382,"LONTONG PANCUR, PANGKAL BALAM, KOTA PANGKALPINANG, KEPULAUAN BANGKA BELITUNG",15,110,68,178
https://kawalpemilu.org#25382,"LONTONG PANCUR, PANGKAL BALAM, KOTA PANGKALPINANG, KEPULAUAN BANGKA BELITUNG",16,117,83,200
https://kawalpemilu.org#25382,"LONTONG PANCUR, PANGKAL BALAM, KOTA PANGKALPINANG, KEPULAUAN BANGKA BELITUNG",17,124,86,210
https://kawalpemilu.org#25383,"KETAPANG, PANGKAL BALAM, KOTA PANGKALPINANG, KEPULAUAN BANGKA BELITUNG",1,97,106,203
https://kawalpemilu.org#25383,"KETAPANG, PANGKAL BALAM, KOTA PANGKALPINANG, KEPULAUAN BANGKA BELITUNG",2,173,26,199
https://kawalpemilu.org#25383,"KETAPANG, PANGKAL BALAM, KOTA PANGKALPINANG, KEPULAUAN BANGKA BELITUNG",3,92,107,199
https://kawalpemilu.org#25383,"KETAPANG, PANGKAL BALAM, KOTA PANGKALPINANG, KEPULAUAN BANGKA BELITUNG",4,108,96,204
https://kawalpemilu.org#25383,"KETAPANG, PANGKAL BALAM, KOTA PANGKALPINANG, KEPULAUAN BANGKA BELITUNG",5,174,13,187
https://kawalpemilu.org#25383,"KETAPANG, PANGKAL BALAM, KOTA PANGKALPINANG, KEPULAUAN BANGKA BELITUNG",6,147,99,246
https://kawalpemilu.org#25383,"KETAPANG, PANGKAL BALAM, KOTA PANGKALPINANG, KEPULAUAN BANGKA BELITUNG",7,104,82,186
https://kawalpemilu.org#25383,"KETAPANG, PANGKAL BALAM, KOTA PANGKALPINANG, KEPULAUAN BANGKA BELITUNG",8,126,74,200
https://kawalpemilu.org#25383,"KETAPANG, PANGKAL BALAM, KOTA PANGKALPINANG, KEPULAUAN BANGKA BELITUNG",9,132,108,240
https://kawalpemilu.org#25383,"KETAPANG, PANGKAL BALAM, KOTA PANGKALPINANG, KEPULAUAN BANGKA BELITUNG",10,129,79,208
https://kawalpemilu.org#25383,"KETAPANG, PANGKAL BALAM, KOTA PANGKALPINANG, KEPULAUAN BANGKA BELITUNG",11,152,73,225
https://kawalpemilu.org#25383,"KETAPANG, PANGKAL BALAM, KOTA PANGKALPINANG, KEPULAUAN BANGKA BELITUNG",12,105,60,165
https://kawalpemilu.org#25384,"AMPUI, PANGKAL BALAM, KOTA PANGKALPINANG, KEPULAUAN BANGKA BELITUNG",1,129,88,217
https://kawalpemilu.org#25384,"AMPUI, PANGKAL BALAM, KOTA PANGKALPINANG, KEPULAUAN BANGKA BELITUNG",2,103,100,203
https://kawalpemilu.org#25384,"AMPUI, PANGKAL BALAM, KOTA PANGKALPINANG, KEPULAUAN BANGKA BELITUNG",3,100,101,201
https://kawalpemilu.org#25384,"AMPUI, PANGKAL BALAM, KOTA PANGKALPINANG, KEPULAUAN BANGKA BELITUNG",4,100,112,212
https://kawalpemilu.org#25384,"AMPUI, PANGKAL BALAM, KOTA PANGKALPINANG, KEPULAUAN BANGKA BELITUNG",5,79,108,187
https://kawalpemilu.org#25384,"AMPUI, PANGKAL BALAM, KOTA PANGKALPINANG, KEPULAUAN BANGKA BELITUNG",6,109,81,190
https://kawalpemilu.org#25384,"AMPUI, PANGKAL BALAM, KOTA PANGKALPINANG, KEPULAUAN BANGKA BELITUNG",7,133,115,248
https://kawalpemilu.org#25384,"AMPUI, PANGKAL BALAM, KOTA PANGKALPINANG, KEPULAUAN BANGKA BELITUNG",8,110,96,206
https://kawalpemilu.org#25384,"AMPUI, PANGKAL BALAM, KOTA PANGKALPINANG, KEPULAUAN BANGKA BELITUNG",9,136,66,202
https://kawalpemilu.org#25385,"REJO SARI, PANGKAL BALAM, KOTA PANGKALPINANG, KEPULAUAN BANGKA BELITUNG",1,125,102,227
https://kawalpemilu.org#25385,"REJO SARI, PANGKAL BALAM, KOTA PANGKALPINANG, KEPULAUAN BANGKA BELITUNG",2,108,95,203
https://kawalpemilu.org#25385,"REJO SARI, PANGKAL BALAM, KOTA PANGKALPINANG, KEPULAUAN BANGKA BELITUNG",3,115,72,187
https://kawalpemilu.org#25385,"REJO SARI, PANGKAL BALAM, KOTA PANGKALPINANG, KEPULAUAN BANGKA BELITUNG",4,131,124,255
https://kawalpemilu.org#25385,"REJO SARI, PANGKAL BALAM, KOTA PANGKALPINANG, KEPULAUAN BANGKA BELITUNG",5,117,123,240
https://kawalpemilu.org#25385,"REJO SARI, PANGKAL BALAM, KOTA PANGKALPINANG, KEPULAUAN BANGKA BELITUNG",6,121,70,191
https://kawalpemilu.org#25385,"REJO SARI, PANGKAL BALAM, KOTA PANGKALPINANG, KEPULAUAN BANGKA BELITUNG",7,104,72,176
https://kawalpemilu.org#25385,"REJO SARI, PANGKAL BALAM, KOTA PANGKALPINANG, KEPULAUAN BANGKA BELITUNG",8,122,88,210
https://kawalpemilu.org#25385,"REJO SARI, PANGKAL BALAM, KOTA PANGKALPINANG, KEPULAUAN BANGKA BELITUNG",9,155,79,234
https://kawalpemilu.org#25385,"REJO SARI, PANGKAL BALAM, KOTA PANGKALPINANG, KEPULAUAN BANGKA BELITUNG",10,158,89,247
https://kawalpemilu.org#25385,"REJO SARI, PANGKAL BALAM, KOTA PANGKALPINANG, KEPULAUAN BANGKA BELITUNG",11,109,100,209
https://kawalpemilu.org#25385,"REJO SARI, PANGKAL BALAM, KOTA PANGKALPINANG, KEPULAUAN BANGKA BELITUNG",12,145,79,224
https://kawalpemilu.org#25385,"REJO SARI, PANGKAL BALAM, KOTA PANGKALPINANG, KEPULAUAN BANGKA BELITUNG",13,112,110,222
https://kawalpemilu.org#25389,"PINTU AIR, RANGKUI, KOTA PANGKALPINANG, KEPULAUAN BANGKA BELITUNG",1,126,108,234
https://kawalpemilu.org#25389,"PINTU AIR, RANGKUI, KOTA PANGKALPINANG, KEPULAUAN BANGKA BELITUNG",2,86,158,244
https://kawalpemilu.org#25389,"PINTU AIR, RANGKUI, KOTA PANGKALPINANG, KEPULAUAN BANGKA BELITUNG",3,121,140,261
https://kawalpemilu.org#25389,"PINTU AIR, RANGKUI, KOTA PANGKALPINANG, KEPULAUAN BANGKA BELITUNG",4,110,109,219
https://kawalpemilu.org#25389,"PINTU AIR, RANGKUI, KOTA PANGKALPINANG, KEPULAUAN BANGKA BELITUNG",5,119,137,256
https://kawalpemilu.org#25389,"PINTU AIR, RANGKUI, KOTA PANGKALPINANG, KEPULAUAN BANGKA BELITUNG",6,123,134,257
https://kawalpemilu.org#25389,"PINTU AIR, RANGKUI, KOTA PANGKALPINANG, KEPULAUAN BANGKA BELITUNG",7,107,146,253
https://kawalpemilu.org#25389,"PINTU AIR, RANGKUI, KOTA PANGKALPINANG, KEPULAUAN BANGKA BELITUNG",8,121,110,231
https://kawalpemilu.org#25389,"PINTU AIR, RANGKUI, KOTA PANGKALPINANG, KEPULAUAN BANGKA BELITUNG",9,114,158,272
https://kawalpemilu.org#25389,"PINTU AIR, RANGKUI, KOTA PANGKALPINANG, KEPULAUAN BANGKA BELITUNG",10,108,102,210
https://kawalpemilu.org#25389,"PINTU AIR, RANGKUI, KOTA PANGKALPINANG, KEPULAUAN BANGKA BELITUNG",11,107,132,239
https://kawalpemilu.org#25389,"PINTU AIR, RANGKUI, KOTA PANGKALPINANG, KEPULAUAN BANGKA BELITUNG",12,68,76,144
https://kawalpemilu.org#25390,"BINTANG, RANGKUI, KOTA PANGKALPINANG, KEPULAUAN BANGKA BELITUNG",1,163,5,168
https://kawalpemilu.org#25390,"BINTANG, RANGKUI, KOTA PANGKALPINANG, KEPULAUAN BANGKA BELITUNG",2,173,2,175
https://kawalpemilu.org#25390,"BINTANG, RANGKUI, KOTA PANGKALPINANG, KEPULAUAN BANGKA BELITUNG",3,173,4,177
https://kawalpemilu.org#25390,"BINTANG, RANGKUI, KOTA PANGKALPINANG, KEPULAUAN BANGKA BELITUNG",4,156,2,158
https://kawalpemilu.org#25390,"BINTANG, RANGKUI, KOTA PANGKALPINANG, KEPULAUAN BANGKA BELITUNG",5,156,4,160
https://kawalpemilu.org#25390,"BINTANG, RANGKUI, KOTA PANGKALPINANG, KEPULAUAN BANGKA BELITUNG",6,166,8,174
https://kawalpemilu.org#25390,"BINTANG, RANGKUI, KOTA PANGKALPINANG, KEPULAUAN BANGKA BELITUNG",7,173,2,175
https://kawalpemilu.org#25390,"BINTANG, RANGKUI, KOTA PANGKALPINANG, KEPULAUAN BANGKA BELITUNG",8,134,3,137
https://kawalpemilu.org#25390,"BINTANG, RANGKUI, KOTA PANGKALPINANG, KEPULAUAN BANGKA BELITUNG",9,164,1,165
https://kawalpemilu.org#25390,"BINTANG, RANGKUI, KOTA PANGKALPINANG, KEPULAUAN BANGKA BELITUNG",10,152,2,154
https://kawalpemilu.org#25393,"MASJID JAMIK, RANGKUI, KOTA PANGKALPINANG, KEPULAUAN BANGKA BELITUNG",1,98,132,230
https://kawalpemilu.org#25393,"MASJID JAMIK, RANGKUI, KOTA PANGKALPINANG, KEPULAUAN BANGKA BELITUNG",2,159,48,207
https://kawalpemilu.org#25393,"MASJID JAMIK, RANGKUI, KOTA PANGKALPINANG, KEPULAUAN BANGKA BELITUNG",3,81,127,208
https://kawalpemilu.org#25393,"MASJID JAMIK, RANGKUI, KOTA PANGKALPINANG, KEPULAUAN BANGKA BELITUNG",4,157,70,227
https://kawalpemilu.org#25393,"MASJID JAMIK, RANGKUI, KOTA PANGKALPINANG, KEPULAUAN BANGKA BELITUNG",5,106,85,191
https://kawalpemilu.org#25393,"MASJID JAMIK, RANGKUI, KOTA PANGKALPINANG, KEPULAUAN BANGKA BELITUNG",6,129,18,147
https://kawalpemilu.org#25393,"MASJID JAMIK, RANGKUI, KOTA PANGKALPINANG, KEPULAUAN BANGKA BELITUNG",7,80,138,218
https://kawalpemilu.org#25394,"ASAM, RANGKUI, KOTA PANGKALPINANG, KEPULAUAN BANGKA BELITUNG",1,26,202,228
https://kawalpemilu.org#25394,"ASAM, RANGKUI, KOTA PANGKALPINANG, KEPULAUAN BANGKA BELITUNG",2,117,116,233
https://kawalpemilu.org#25394,"ASAM, RANGKUI, KOTA PANGKALPINANG, KEPULAUAN BANGKA BELITUNG",3,111,123,234
https://kawalpemilu.org#25394,"ASAM, RANGKUI, KOTA PANGKALPINANG, KEPULAUAN BANGKA BELITUNG",4,151,106,257
https://kawalpemilu.org#25394,"ASAM, RANGKUI, KOTA PANGKALPINANG, KEPULAUAN BANGKA BELITUNG",5,126,125,251
https://kawalpemilu.org#25394,"ASAM, RANGKUI, KOTA PANGKALPINANG, KEPULAUAN BANGKA BELITUNG",6,186,40,226
https://kawalpemilu.org#25394,"ASAM, RANGKUI, KOTA PANGKALPINANG, KEPULAUAN BANGKA BELITUNG",7,185,54,239
https://kawalpemilu.org#25394,"ASAM, RANGKUI, KOTA PANGKALPINANG, KEPULAUAN BANGKA BELITUNG",8,153,67,220
https://kawalpemilu.org#25395,"MELINTANG, RANGKUI, KOTA PANGKALPINANG, KEPULAUAN BANGKA BELITUNG",1,120,85,205
https://kawalpemilu.org#25395,"MELINTANG, RANGKUI, KOTA PANGKALPINANG, KEPULAUAN BANGKA BELITUNG",2,107,115,222
https://kawalpemilu.org#25395,"MELINTANG, RANGKUI, KOTA PANGKALPINANG, KEPULAUAN BANGKA BELITUNG",3,103,96,199
https://kawalpemilu.org#25395,"MELINTANG, RANGKUI, KOTA PANGKALPINANG, KEPULAUAN BANGKA BELITUNG",4,140,92,232
https://kawalpemilu.org#25395,"MELINTANG, RANGKUI, KOTA PANGKALPINANG, KEPULAUAN BANGKA BELITUNG",5,112,98,210
https://kawalpemilu.org#25395,"MELINTANG, RANGKUI, KOTA PANGKALPINANG, KEPULAUAN BANGKA BELITUNG",6,111,82,193
https://kawalpemilu.org#25395,"MELINTANG, RANGKUI, KOTA PANGKALPINANG, KEPULAUAN BANGKA BELITUNG",7,64,130,194
https://kawalpemilu.org#25395,"MELINTANG, RANGKUI, KOTA PANGKALPINANG, KEPULAUAN BANGKA BELITUNG",8,99,34,133
https://kawalpemilu.org#25395,"MELINTANG, RANGKUI, KOTA PANGKALPINANG, KEPULAUAN BANGKA BELITUNG",9,177,93,270
https://kawalpemilu.org#25395,"MELINTANG, RANGKUI, KOTA PANGKALPINANG, KEPULAUAN BANGKA BELITUNG",10,61,87,148
https://kawalpemilu.org#25396,"PARIT LALANG, RANGKUI, KOTA PANGKALPINANG, KEPULAUAN BANGKA BELITUNG",1,175,12,187
https://kawalpemilu.org#25396,"PARIT LALANG, RANGKUI, KOTA PANGKALPINANG, KEPULAUAN BANGKA BELITUNG",2,162,40,202
https://kawalpemilu.org#25396,"PARIT LALANG, RANGKUI, KOTA PANGKALPINANG, KEPULAUAN BANGKA BELITUNG",3,100,133,233
https://kawalpemilu.org#25396,"PARIT LALANG, RANGKUI, KOTA PANGKALPINANG, KEPULAUAN BANGKA BELITUNG",4,99,140,239
https://kawalpemilu.org#25396,"PARIT LALANG, RANGKUI, KOTA PANGKALPINANG, KEPULAUAN BANGKA BELITUNG",5,99,113,212
https://kawalpemilu.org#25396,"PARIT LALANG, RANGKUI, KOTA PANGKALPINANG, KEPULAUAN BANGKA BELITUNG",6,143,127,270
https://kawalpemilu.org#25396,"PARIT LALANG, RANGKUI, KOTA PANGKALPINANG, KEPULAUAN BANGKA BELITUNG",7,87,121,208
https://kawalpemilu.org#25396,"PARIT LALANG, RANGKUI, KOTA PANGKALPINANG, KEPULAUAN BANGKA BELITUNG",8,123,108,231
https://kawalpemilu.org#25396,"PARIT LALANG, RANGKUI, KOTA PANGKALPINANG, KEPULAUAN BANGKA BELITUNG",9,114,93,207
https://kawalpemilu.org#25396,"PARIT LALANG, RANGKUI, KOTA PANGKALPINANG, KEPULAUAN BANGKA BELITUNG",10,110,131,241
https://kawalpemilu.org#25396,"PARIT LALANG, RANGKUI, KOTA PANGKALPINANG, KEPULAUAN BANGKA BELITUNG",11,116,111,227
https://kawalpemilu.org#25396,"PARIT LALANG, RANGKUI, KOTA PANGKALPINANG, KEPULAUAN BANGKA BELITUNG",12,132,139,271
https://kawalpemilu.org#25396,"PARIT LALANG, RANGKUI, KOTA PANGKALPINANG, KEPULAUAN BANGKA BELITUNG",13,145,128,273
https://kawalpemilu.org#25396,"PARIT LALANG, RANGKUI, KOTA PANGKALPINANG, KEPULAUAN BANGKA BELITUNG",14,137,110,247
https://kawalpemilu.org#25396,"PARIT LALANG, RANGKUI, KOTA PANGKALPINANG, KEPULAUAN BANGKA BELITUNG",15,134,123,257
https://kawalpemilu.org#25396,"PARIT LALANG, RANGKUI, KOTA PANGKALPINANG, KEPULAUAN BANGKA BELITUNG",16,152,95,247
https://kawalpemilu.org#25396,"PARIT LALANG, RANGKUI, KOTA PANGKALPINANG, KEPULAUAN BANGKA BELITUNG",17,156,80,236
https://kawalpemilu.org#25397,"KERAMAT, RANGKUI, KOTA PANGKALPINANG, KEPULAUAN BANGKA BELITUNG",1,103,134,237
https://kawalpemilu.org#25397,"KERAMAT, RANGKUI, KOTA PANGKALPINANG, KEPULAUAN BANGKA BELITUNG",2,127,117,244
https://kawalpemilu.org#25397,"KERAMAT, RANGKUI, KOTA PANGKALPINANG, KEPULAUAN BANGKA BELITUNG",3,108,125,233
https://kawalpemilu.org#25397,"KERAMAT, RANGKUI, KOTA PANGKALPINANG, KEPULAUAN BANGKA BELITUNG",4,91,148,239
https://kawalpemilu.org#25397,"KERAMAT, RANGKUI, KOTA PANGKALPINANG, KEPULAUAN BANGKA BELITUNG",5,74,160,234
https://kawalpemilu.org#25397,"KERAMAT, RANGKUI, KOTA PANGKALPINANG, KEPULAUAN BANGKA BELITUNG",6,77,144,191
https://kawalpemilu.org#25397,"KERAMAT, RANGKUI, KOTA PANGKALPINANG, KEPULAUAN BANGKA BELITUNG",7,65,122,187
https://kawalpemilu.org#25397,"KERAMAT, RANGKUI, KOTA PANGKALPINANG, KEPULAUAN BANGKA BELITUNG",8,118,125,243
https://kawalpemilu.org#25397,"KERAMAT, RANGKUI, KOTA PANGKALPINANG, KEPULAUAN BANGKA BELITUNG",9,126,101,227
https://kawalpemilu.org#25397,"KERAMAT, RANGKUI, KOTA PANGKALPINANG, KEPULAUAN BANGKA BELITUNG",10,110,125,235
https://kawalpemilu.org#25397,"KERAMAT, RANGKUI, KOTA PANGKALPINANG, KEPULAUAN BANGKA BELITUNG",11,69,113,182
https://kawalpemilu.org#25397,"KERAMAT, RANGKUI, KOTA PANGKALPINANG, KEPULAUAN BANGKA BELITUNG",12,124,119,243
https://kawalpemilu.org#25397,"KERAMAT, RANGKUI, KOTA PANGKALPINANG, KEPULAUAN BANGKA BELITUNG",13,109,144,253
https://kawalpemilu.org#25397,"KERAMAT, RANGKUI, KOTA PANGKALPINANG, KEPULAUAN BANGKA BELITUNG",14,129,109,238
https://kawalpemilu.org#25397,"KERAMAT, RANGKUI, KOTA PANGKALPINANG, KEPULAUAN BANGKA BELITUNG",15,127,117,244
https://kawalpemilu.org#25397,"KERAMAT, RANGKUI, KOTA PANGKALPINANG, KEPULAUAN BANGKA BELITUNG",16,106,118,224
https://kawalpemilu.org#25397,"KERAMAT, RANGKUI, KOTA PANGKALPINANG, KEPULAUAN BANGKA BELITUNG",17,101,74,175
https://kawalpemilu.org#25397,"KERAMAT, RANGKUI, KOTA PANGKALPINANG, KEPULAUAN BANGKA BELITUNG",18,54,68,122
https://kawalpemilu.org#25397,"KERAMAT, RANGKUI, KOTA PANGKALPINANG, KEPULAUAN BANGKA BELITUNG",19,42,51,93
https://kawalpemilu.org#25397,"KERAMAT, RANGKUI, KOTA PANGKALPINANG, KEPULAUAN BANGKA BELITUNG",20,52,102,154
https://kawalpemilu.org#25397,"KERAMAT, RANGKUI, KOTA PANGKALPINANG, KEPULAUAN BANGKA BELITUNG",21,47,47,94
https://kawalpemilu.org#84854,"GAJAH MADA, RANGKUI, KOTA PANGKALPINANG, KEPULAUAN BANGKA BELITUNG",1,96,203,299
https://kawalpemilu.org#84854,"GAJAH MADA, RANGKUI, KOTA PANGKALPINANG, KEPULAUAN BANGKA BELITUNG",2,103,163,266
https://kawalpemilu.org#84854,"GAJAH MADA, RANGKUI, KOTA PANGKALPINANG, KEPULAUAN BANGKA BELITUNG",3,96,101,197
https://kawalpemilu.org#84854,"GAJAH MADA, RANGKUI, KOTA PANGKALPINANG, KEPULAUAN BANGKA BELITUNG",4,110,96,206
https://kawalpemilu.org#84854,"GAJAH MADA, RANGKUI, KOTA PANGKALPINANG, KEPULAUAN BANGKA BELITUNG",5,161,110,271
https://kawalpemilu.org#84854,"GAJAH MADA, RANGKUI, KOTA PANGKALPINANG, KEPULAUAN BANGKA BELITUNG",6,132,153,285
https://kawalpemilu.org#84854,"GAJAH MADA, RANGKUI, KOTA PANGKALPINANG, KEPULAUAN BANGKA BELITUNG",7,124,144,268
https://kawalpemilu.org#84854,"GAJAH MADA, RANGKUI, KOTA PANGKALPINANG, KEPULAUAN BANGKA BELITUNG",8,160,98,258
https://kawalpemilu.org#84854,"GAJAH MADA, RANGKUI, KOTA PANGKALPINANG, KEPULAUAN BANGKA BELITUNG",9,118,134,252
https://kawalpemilu.org#25399,"TAMAN BUNGA, GERUNGGANG, KOTA PANGKALPINANG, KEPULAUAN BANGKA BELITUNG",1,92,137,229
https://kawalpemilu.org#25399,"TAMAN BUNGA, GERUNGGANG, KOTA PANGKALPINANG, KEPULAUAN BANGKA BELITUNG",2,154,64,218
https://kawalpemilu.org#25399,"TAMAN BUNGA, GERUNGGANG, KOTA PANGKALPINANG, KEPULAUAN BANGKA BELITUNG",3,126,69,195
https://kawalpemilu.org#25399,"TAMAN BUNGA, GERUNGGANG, KOTA PANGKALPINANG, KEPULAUAN BANGKA BELITUNG",4,127,110,237
https://kawalpemilu.org#25399,"TAMAN BUNGA, GERUNGGANG, KOTA PANGKALPINANG, KEPULAUAN BANGKA BELITUNG",5,111,113,224
https://kawalpemilu.org#25399,"TAMAN BUNGA, GERUNGGANG, KOTA PANGKALPINANG, KEPULAUAN BANGKA BELITUNG",6,122,103,225
https://kawalpemilu.org#25399,"TAMAN BUNGA, GERUNGGANG, KOTA PANGKALPINANG, KEPULAUAN BANGKA BELITUNG",7,108,120,228
https://kawalpemilu.org#25399,"TAMAN BUNGA, GERUNGGANG, KOTA PANGKALPINANG, KEPULAUAN BANGKA BELITUNG",8,72,183,255
https://kawalpemilu.org#25399,"TAMAN BUNGA, GERUNGGANG, KOTA PANGKALPINANG, KEPULAUAN BANGKA BELITUNG",9,101,158,259
https://kawalpemilu.org#25399,"TAMAN BUNGA, GERUNGGANG, KOTA PANGKALPINANG, KEPULAUAN BANGKA BELITUNG",10,78,135,213
https://kawalpemilu.org#25399,"TAMAN BUNGA, GERUNGGANG, KOTA PANGKALPINANG, KEPULAUAN BANGKA BELITUNG",11,64,110,174
https://kawalpemilu.org#25399,"TAMAN BUNGA, GERUNGGANG, KOTA PANGKALPINANG, KEPULAUAN BANGKA BELITUNG",12,104,132,236
https://kawalpemilu.org#25400,"BUKITMERAPIN, GERUNGGANG, KOTA PANGKALPINANG, KEPULAUAN BANGKA BELITUNG",1,121,107,228
https://kawalpemilu.org#25400,"BUKITMERAPIN, GERUNGGANG, KOTA PANGKALPINANG, KEPULAUAN BANGKA BELITUNG",2,107,110,217
https://kawalpemilu.org#25400,"BUKITMERAPIN, GERUNGGANG, KOTA PANGKALPINANG, KEPULAUAN BANGKA BELITUNG",3,104,121,225
https://kawalpemilu.org#25400,"BUKITMERAPIN, GERUNGGANG, KOTA PANGKALPINANG, KEPULAUAN BANGKA BELITUNG",4,65,137,202
https://kawalpemilu.org#25400,"BUKITMERAPIN, GERUNGGANG, KOTA PANGKALPINANG, KEPULAUAN BANGKA BELITUNG",5,137,139,276
https://kawalpemilu.org#25400,"BUKITMERAPIN, GERUNGGANG, KOTA PANGKALPINANG, KEPULAUAN BANGKA BELITUNG",6,92,173,265
https://kawalpemilu.org#25400,"BUKITMERAPIN, GERUNGGANG, KOTA PANGKALPINANG, KEPULAUAN BANGKA BELITUNG",7,101,106,207
https://kawalpemilu.org#25400,"BUKITMERAPIN, GERUNGGANG, KOTA PANGKALPINANG, KEPULAUAN BANGKA BELITUNG",8,90,120,210
https://kawalpemilu.org#25400,"BUKITMERAPIN, GERUNGGANG, KOTA PANGKALPINANG, KEPULAUAN BANGKA BELITUNG",9,97,88,185
https://kawalpemilu.org#25400,"BUKITMERAPIN, GERUNGGANG, KOTA PANGKALPINANG, KEPULAUAN BANGKA BELITUNG",10,45,98,143
https://kawalpemilu.org#25400,"BUKITMERAPIN, GERUNGGANG, KOTA PANGKALPINANG, KEPULAUAN BANGKA BELITUNG",11,77,79,156
https://kawalpemilu.org#25400,"BUKITMERAPIN, GERUNGGANG, KOTA PANGKALPINANG, KEPULAUAN BANGKA BELITUNG",12,86,128,214
https://kawalpemilu.org#25400,"BUKITMERAPIN, GERUNGGANG, KOTA PANGKALPINANG, KEPULAUAN BANGKA BELITUNG",13,108,122,230
https://kawalpemilu.org#25400,"BUKITMERAPIN, GERUNGGANG, KOTA PANGKALPINANG, KEPULAUAN BANGKA BELITUNG",14,85,135,220
https://kawalpemilu.org#25400,"BUKITMERAPIN, GERUNGGANG, KOTA PANGKALPINANG, KEPULAUAN BANGKA BELITUNG",15,98,107,205
https://kawalpemilu.org#25400,"BUKITMERAPIN, GERUNGGANG, KOTA PANGKALPINANG, KEPULAUAN BANGKA BELITUNG",16,86,113,199
https://kawalpemilu.org#25400,"BUKITMERAPIN, GERUNGGANG, KOTA PANGKALPINANG, KEPULAUAN BANGKA BELITUNG",17,96,152,248
https://kawalpemilu.org#25400,"BUKITMERAPIN, GERUNGGANG, KOTA PANGKALPINANG, KEPULAUAN BANGKA BELITUNG",18,105,133,238
https://kawalpemilu.org#25400,"BUKITMERAPIN, GERUNGGANG, KOTA PANGKALPINANG, KEPULAUAN BANGKA BELITUNG",19,90,134,224
https://kawalpemilu.org#25400,"BUKITMERAPIN, GERUNGGANG, KOTA PANGKALPINANG, KEPULAUAN BANGKA BELITUNG",20,83,131,214
https://kawalpemilu.org#25400,"BUKITMERAPIN, GERUNGGANG, KOTA PANGKALPINANG, KEPULAUAN BANGKA BELITUNG",21,64,107,171
https://kawalpemilu.org#25400,"BUKITMERAPIN, GERUNGGANG, KOTA PANGKALPINANG, KEPULAUAN BANGKA BELITUNG",22,56,147,203
https://kawalpemilu.org#25400,"BUKITMERAPIN, GERUNGGANG, KOTA PANGKALPINANG, KEPULAUAN BANGKA BELITUNG",23,93,160,253
https://kawalpemilu.org#25400,"BUKITMERAPIN, GERUNGGANG, KOTA PANGKALPINANG, KEPULAUAN BANGKA BELITUNG",24,89,124,213
https://kawalpemilu.org#25402,"BUKITSARI, GERUNGGANG, KOTA PANGKALPINANG, KEPULAUAN BANGKA BELITUNG",1,119,120,239
https://kawalpemilu.org#25402,"BUKITSARI, GERUNGGANG, KOTA PANGKALPINANG, KEPULAUAN BANGKA BELITUNG",2,125,100,225
https://kawalpemilu.org#25402,"BUKITSARI, GERUNGGANG, KOTA PANGKALPINANG, KEPULAUAN BANGKA BELITUNG",3,118,111,229
https://kawalpemilu.org#25402,"BUKITSARI, GERUNGGANG, KOTA PANGKALPINANG, KEPULAUAN BANGKA BELITUNG",4,116,116,232
https://kawalpemilu.org#25402,"BUKITSARI, GERUNGGANG, KOTA PANGKALPINANG, KEPULAUAN BANGKA BELITUNG",5,108,146,254
https://kawalpemilu.org#25402,"BUKITSARI, GERUNGGANG, KOTA PANGKALPINANG, KEPULAUAN BANGKA BELITUNG",6,134,113,247
https://kawalpemilu.org#25402,"BUKITSARI, GERUNGGANG, KOTA PANGKALPINANG, KEPULAUAN BANGKA BELITUNG",7,100,142,242
https://kawalpemilu.org#25402,"BUKITSARI, GERUNGGANG, KOTA PANGKALPINANG, KEPULAUAN BANGKA BELITUNG",8,104,125,229
https://kawalpemilu.org#25402,"BUKITSARI, GERUNGGANG, KOTA PANGKALPINANG, KEPULAUAN BANGKA BELITUNG",9,120,105,225
https://kawalpemilu.org#25402,"BUKITSARI, GERUNGGANG, KOTA PANGKALPINANG, KEPULAUAN BANGKA BELITUNG",10,127,88,215
https://kawalpemilu.org#25402,"BUKITSARI, GERUNGGANG, KOTA PANGKALPINANG, KEPULAUAN BANGKA BELITUNG",11,108,141,249
https://kawalpemilu.org#25402,"BUKITSARI, GERUNGGANG, KOTA PANGKALPINANG, KEPULAUAN BANGKA BELITUNG",12,72,91,163
https://kawalpemilu.org#25402,"BUKITSARI, GERUNGGANG, KOTA PANGKALPINANG, KEPULAUAN BANGKA BELITUNG",13,73,61,134
https://kawalpemilu.org#25403,"TUATUNU INDAH, GERUNGGANG, KOTA PANGKALPINANG, KEPULAUAN BANGKA BELITUNG",1,37,152,189
https://kawalpemilu.org#25403,"TUATUNU INDAH, GERUNGGANG, KOTA PANGKALPINANG, KEPULAUAN BANGKA BELITUNG",2,29,155,184
https://kawalpemilu.org#25403,"TUATUNU INDAH, GERUNGGANG, KOTA PANGKALPINANG, KEPULAUAN BANGKA BELITUNG",3,33,148,181
https://kawalpemilu.org#25403,"TUATUNU INDAH, GERUNGGANG, KOTA PANGKALPINANG, KEPULAUAN BANGKA BELITUNG",4,13,155,168
https://kawalpemilu.org#25403,"TUATUNU INDAH, GERUNGGANG, KOTA PANGKALPINANG, KEPULAUAN BANGKA BELITUNG",5,20,174,194
https://kawalpemilu.org#25403,"TUATUNU INDAH, GERUNGGANG, KOTA PANGKALPINANG, KEPULAUAN BANGKA BELITUNG",6,18,156,174
https://kawalpemilu.org#25403,"TUATUNU INDAH, GERUNGGANG, KOTA PANGKALPINANG, KEPULAUAN BANGKA BELITUNG",7,37,157,194
https://kawalpemilu.org#25403,"TUATUNU INDAH, GERUNGGANG, KOTA PANGKALPINANG, KEPULAUAN BANGKA BELITUNG",8,28,161,189
https://kawalpemilu.org#25403,"TUATUNU INDAH, GERUNGGANG, KOTA PANGKALPINANG, KEPULAUAN BANGKA BELITUNG",9,13,179,192
https://kawalpemilu.org#25403,"TUATUNU INDAH, GERUNGGANG, KOTA PANGKALPINANG, KEPULAUAN BANGKA BELITUNG",10,22,178,200
https://kawalpemilu.org#25403,"TUATUNU INDAH, GERUNGGANG, KOTA PANGKALPINANG, KEPULAUAN BANGKA BELITUNG",11,18,134,152
https://kawalpemilu.org#25403,"TUATUNU INDAH, GERUNGGANG, KOTA PANGKALPINANG, KEPULAUAN BANGKA BELITUNG",12,35,195,230
https://kawalpemilu.org#25403,"TUATUNU INDAH, GERUNGGANG, KOTA PANGKALPINANG, KEPULAUAN BANGKA BELITUNG",13,45,180,225
https://kawalpemilu.org#25403,"TUATUNU INDAH, GERUNGGANG, KOTA PANGKALPINANG, KEPULAUAN BANGKA BELITUNG",14,33,184,217
https://kawalpemilu.org#25403,"TUATUNU INDAH, GERUNGGANG, KOTA PANGKALPINANG, KEPULAUAN BANGKA BELITUNG",15,31,163,194
https://kawalpemilu.org#25403,"TUATUNU INDAH, GERUNGGANG, KOTA PANGKALPINANG, KEPULAUAN BANGKA BELITUNG",16,130,70,200
https://kawalpemilu.org#25403,"TUATUNU INDAH, GERUNGGANG, KOTA PANGKALPINANG, KEPULAUAN BANGKA BELITUNG",17,54,119,173
https://kawalpemilu.org#25403,"TUATUNU INDAH, GERUNGGANG, KOTA PANGKALPINANG, KEPULAUAN BANGKA BELITUNG",18,48,149,197
https://kawalpemilu.org#25403,"TUATUNU INDAH, GERUNGGANG, KOTA PANGKALPINANG, KEPULAUAN BANGKA BELITUNG",19,80,108,188
https://kawalpemilu.org#25403,"TUATUNU INDAH, GERUNGGANG, KOTA PANGKALPINANG, KEPULAUAN BANGKA BELITUNG",20,61,130,191
https://kawalpemilu.org#25403,"TUATUNU INDAH, GERUNGGANG, KOTA PANGKALPINANG, KEPULAUAN BANGKA BELITUNG",21,58,81,139
https://kawalpemilu.org#25403,"TUATUNU INDAH, GERUNGGANG, KOTA PANGKALPINANG, KEPULAUAN BANGKA BELITUNG",22,77,97,174
https://kawalpemilu.org#25404,"KACANG PEDANG, GERUNGGANG, KOTA PANGKALPINANG, KEPULAUAN BANGKA BELITUNG",1,69,101,170
https://kawalpemilu.org#25404,"KACANG PEDANG, GERUNGGANG, KOTA PANGKALPINANG, KEPULAUAN BANGKA BELITUNG",2,90,128,218
https://kawalpemilu.org#25404,"KACANG PEDANG, GERUNGGANG, KOTA PANGKALPINANG, KEPULAUAN BANGKA BELITUNG",3,65,99,164
https://kawalpemilu.org#25404,"KACANG PEDANG, GERUNGGANG, KOTA PANGKALPINANG, KEPULAUAN BANGKA BELITUNG",4,100,162,262
https://kawalpemilu.org#25404,"KACANG PEDANG, GERUNGGANG, KOTA PANGKALPINANG, KEPULAUAN BANGKA BELITUNG",5,92,206,298
https://kawalpemilu.org#25404,"KACANG PEDANG, GERUNGGANG, KOTA PANGKALPINANG, KEPULAUAN BANGKA BELITUNG",6,89,151,240
https://kawalpemilu.org#25404,"KACANG PEDANG, GERUNGGANG, KOTA PANGKALPINANG, KEPULAUAN BANGKA BELITUNG",7,80,163,243
https://kawalpemilu.org#25404,"KACANG PEDANG, GERUNGGANG, KOTA PANGKALPINANG, KEPULAUAN BANGKA BELITUNG",8,88,148,236
https://kawalpemilu.org#25404,"KACANG PEDANG, GERUNGGANG, KOTA PANGKALPINANG, KEPULAUAN BANGKA BELITUNG",9,68,158,226
https://kawalpemilu.org#25404,"KACANG PEDANG, GERUNGGANG, KOTA PANGKALPINANG, KEPULAUAN BANGKA BELITUNG",10,106,163,269
https://kawalpemilu.org#25404,"KACANG PEDANG, GERUNGGANG, KOTA PANGKALPINANG, KEPULAUAN BANGKA BELITUNG",11,123,142,265
https://kawalpemilu.org#25404,"KACANG PEDANG, GERUNGGANG, KOTA PANGKALPINANG, KEPULAUAN BANGKA BELITUNG",12,87,136,223
https://kawalpemilu.org#25404,"KACANG PEDANG, GERUNGGANG, KOTA PANGKALPINANG, KEPULAUAN BANGKA BELITUNG",13,82,119,201
https://kawalpemilu.org#25404,"KACANG PEDANG, GERUNGGANG, KOTA PANGKALPINANG, KEPULAUAN BANGKA BELITUNG",14,63,131,194
https://kawalpemilu.org#25404,"KACANG PEDANG, GERUNGGANG, KOTA PANGKALPINANG, KEPULAUAN BANGKA BELITUNG",15,65,134,199
https://kawalpemilu.org#25404,"KACANG PEDANG, GERUNGGANG, KOTA PANGKALPINANG, KEPULAUAN BANGKA BELITUNG",16,60,145,205
https://kawalpemilu.org#25404,"KACANG PEDANG, GERUNGGANG, KOTA PANGKALPINANG, KEPULAUAN BANGKA BELITUNG",17,104,177,281
https://kawalpemilu.org#25404,"KACANG PEDANG, GERUNGGANG, KOTA PANGKALPINANG, KEPULAUAN BANGKA BELITUNG",18,93,178,271
https://kawalpemilu.org#84855,"AIR KEPALA TUJUH, GERUNGGANG, KOTA PANGKALPINANG, KEPULAUAN BANGKA BELITUNG",1,91,137,228
https://kawalpemilu.org#84855,"AIR KEPALA TUJUH, GERUNGGANG, KOTA PANGKALPINANG, KEPULAUAN BANGKA BELITUNG",2,109,116,225
https://kawalpemilu.org#84855,"AIR KEPALA TUJUH, GERUNGGANG, KOTA PANGKALPINANG, KEPULAUAN BANGKA BELITUNG",3,50,97,147
https://kawalpemilu.org#84855,"AIR KEPALA TUJUH, GERUNGGANG, KOTA PANGKALPINANG, KEPULAUAN BANGKA BELITUNG",4,69,115,184
https://kawalpemilu.org#84855,"AIR KEPALA TUJUH, GERUNGGANG, KOTA PANGKALPINANG, KEPULAUAN BANGKA BELITUNG",5,120,134,254
https://kawalpemilu.org#84855,"AIR KEPALA TUJUH, GERUNGGANG, KOTA PANGKALPINANG, KEPULAUAN BANGKA BELITUNG",6,17,80,97
https://kawalpemilu.org#84855,"AIR KEPALA TUJUH, GERUNGGANG, KOTA PANGKALPINANG, KEPULAUAN BANGKA BELITUNG",7,98,147,245
https://kawalpemilu.org#84855,"AIR KEPALA TUJUH, GERUNGGANG, KOTA PANGKALPINANG, KEPULAUAN BANGKA BELITUNG",8,79,152,231
https://kawalpemilu.org#84855,"AIR KEPALA TUJUH, GERUNGGANG, KOTA PANGKALPINANG, KEPULAUAN BANGKA BELITUNG",9,88,151,239
https://kawalpemilu.org#84855,"AIR KEPALA TUJUH, GERUNGGANG, KOTA PANGKALPINANG, KEPULAUAN BANGKA BELITUNG",10,91,156,247
https://kawalpemilu.org#84855,"AIR KEPALA TUJUH, GERUNGGANG, KOTA PANGKALPINANG, KEPULAUAN BANGKA BELITUNG",11,59,177,236
https://kawalpemilu.org#84855,"AIR KEPALA TUJUH, GERUNGGANG, KOTA PANGKALPINANG, KEPULAUAN BANGKA BELITUNG",12,132,103,235
https://kawalpemilu.org#84855,"AIR KEPALA TUJUH, GERUNGGANG, KOTA PANGKALPINANG, KEPULAUAN BANGKA BELITUNG",13,32,81,113
https://kawalpemilu.org#25378,"SELINDUNG BARU, GABEK, KOTA PANGKALPINANG, KEPULAUAN BANGKA BELITUNG",2,87,113,200
https://kawalpemilu.org#25378,"SELINDUNG BARU, GABEK, KOTA PANGKALPINANG, KEPULAUAN BANGKA BELITUNG",3,93,141,234
https://kawalpemilu.org#25378,"SELINDUNG BARU, GABEK, KOTA PANGKALPINANG, KEPULAUAN BANGKA BELITUNG",4,139,114,253
https://kawalpemilu.org#25378,"SELINDUNG BARU, GABEK, KOTA PANGKALPINANG, KEPULAUAN BANGKA BELITUNG",5,90,140,230
https://kawalpemilu.org#25378,"SELINDUNG BARU, GABEK, KOTA PANGKALPINANG, KEPULAUAN BANGKA BELITUNG",6,0,0,121
https://kawalpemilu.org#25378,"SELINDUNG BARU, GABEK, KOTA PANGKALPINANG, KEPULAUAN BANGKA BELITUNG",7,116,141,257
https://kawalpemilu.org#25378,"SELINDUNG BARU, GABEK, KOTA PANGKALPINANG, KEPULAUAN BANGKA BELITUNG",8,99,136,235
https://kawalpemilu.org#25378,"SELINDUNG BARU, GABEK, KOTA PANGKALPINANG, KEPULAUAN BANGKA BELITUNG",9,131,114,245
https://kawalpemilu.org#25378,"SELINDUNG BARU, GABEK, KOTA PANGKALPINANG, KEPULAUAN BANGKA BELITUNG",10,107,110,117
https://kawalpemilu.org#25378,"SELINDUNG BARU, GABEK, KOTA PANGKALPINANG, KEPULAUAN BANGKA BELITUNG",11,74,123,197
https://kawalpemilu.org#25378,"SELINDUNG BARU, GABEK, KOTA PANGKALPINANG, KEPULAUAN BANGKA BELITUNG",12,74,107,181
https://kawalpemilu.org#25378,"SELINDUNG BARU, GABEK, KOTA PANGKALPINANG, KEPULAUAN BANGKA BELITUNG",13,92,103,195
https://kawalpemilu.org#25386,"AIR SALEMBA, GABEK, KOTA PANGKALPINANG, KEPULAUAN BANGKA BELITUNG",1,163,114,277
https://kawalpemilu.org#25386,"AIR SALEMBA, GABEK, KOTA PANGKALPINANG, KEPULAUAN BANGKA BELITUNG",2,171,69,240
https://kawalpemilu.org#25386,"AIR SALEMBA, GABEK, KOTA PANGKALPINANG, KEPULAUAN BANGKA BELITUNG",3,162,83,245
https://kawalpemilu.org#25386,"AIR SALEMBA, GABEK, KOTA PANGKALPINANG, KEPULAUAN BANGKA BELITUNG",4,193,51,244
https://kawalpemilu.org#25386,"AIR SALEMBA, GABEK, KOTA PANGKALPINANG, KEPULAUAN BANGKA BELITUNG",5,165,47,212
https://kawalpemilu.org#25386,"AIR SALEMBA, GABEK, KOTA PANGKALPINANG, KEPULAUAN BANGKA BELITUNG",6,206,11,217
https://kawalpemilu.org#25386,"AIR SALEMBA, GABEK, KOTA PANGKALPINANG, KEPULAUAN BANGKA BELITUNG",7,205,62,267
https://kawalpemilu.org#25386,"AIR SALEMBA, GABEK, KOTA PANGKALPINANG, KEPULAUAN BANGKA BELITUNG",8,181,53,234
https://kawalpemilu.org#25387,"SELINDUNG, GABEK, KOTA PANGKALPINANG, KEPULAUAN BANGKA BELITUNG",1,82,104,186
https://kawalpemilu.org#25387,"SELINDUNG, GABEK, KOTA PANGKALPINANG, KEPULAUAN BANGKA BELITUNG",2,97,105,202
https://kawalpemilu.org#25387,"SELINDUNG, GABEK, KOTA PANGKALPINANG, KEPULAUAN BANGKA BELITUNG",3,119,122,241
https://kawalpemilu.org#25387,"SELINDUNG, GABEK, KOTA PANGKALPINANG, KEPULAUAN BANGKA BELITUNG",4,109,79,188
https://kawalpemilu.org#25387,"SELINDUNG, GABEK, KOTA PANGKALPINANG, KEPULAUAN BANGKA BELITUNG",5,155,112,267
https://kawalpemilu.org#25387,"SELINDUNG, GABEK, KOTA PANGKALPINANG, KEPULAUAN BANGKA BELITUNG",6,99,121,220
https://kawalpemilu.org#25387,"SELINDUNG, GABEK, KOTA PANGKALPINANG, KEPULAUAN BANGKA BELITUNG",7,111,114,225
https://kawalpemilu.org#25387,"SELINDUNG, GABEK, KOTA PANGKALPINANG, KEPULAUAN BANGKA BELITUNG",8,112,106,218
https://kawalpemilu.org#25387,"SELINDUNG, GABEK, KOTA PANGKALPINANG, KEPULAUAN BANGKA BELITUNG",9,66,144,210
https://kawalpemilu.org#25387,"SELINDUNG, GABEK, KOTA PANGKALPINANG, KEPULAUAN BANGKA BELITUNG",10,117,158,275
https://kawalpemilu.org#25387,"SELINDUNG, GABEK, KOTA PANGKALPINANG, KEPULAUAN BANGKA BELITUNG",11,92,130,222
https://kawalpemilu.org#25387,"SELINDUNG, GABEK, KOTA PANGKALPINANG, KEPULAUAN BANGKA BELITUNG",12,101,130,231
https://kawalpemilu.org#25387,"SELINDUNG, GABEK, KOTA PANGKALPINANG, KEPULAUAN BANGKA BELITUNG",13,106,121,227
https://kawalpemilu.org#25387,"SELINDUNG, GABEK, KOTA PANGKALPINANG, KEPULAUAN BANGKA BELITUNG",14,87,212,299
https://kawalpemilu.org#84856,"GABEK SATU, GABEK, KOTA PANGKALPINANG, KEPULAUAN BANGKA BELITUNG",1,89,142,231
https://kawalpemilu.org#84856,"GABEK SATU, GABEK, KOTA PANGKALPINANG, KEPULAUAN BANGKA BELITUNG",2,92,124,216
https://kawalpemilu.org#84856,"GABEK SATU, GABEK, KOTA PANGKALPINANG, KEPULAUAN BANGKA BELITUNG",3,99,120,219
https://kawalpemilu.org#84856,"GABEK SATU, GABEK, KOTA PANGKALPINANG, KEPULAUAN BANGKA BELITUNG",4,111,131,242
https://kawalpemilu.org#84856,"GABEK SATU, GABEK, KOTA PANGKALPINANG, KEPULAUAN BANGKA BELITUNG",5,133,119,252
https://kawalpemilu.org#84856,"GABEK SATU, GABEK, KOTA PANGKALPINANG, KEPULAUAN BANGKA BELITUNG",6,95,118,213
https://kawalpemilu.org#84856,"GABEK SATU, GABEK, KOTA PANGKALPINANG, KEPULAUAN BANGKA BELITUNG",7,104,147,251
https://kawalpemilu.org#84856,"GABEK SATU, GABEK, KOTA PANGKALPINANG, KEPULAUAN BANGKA BELITUNG",8,115,111,226
https://kawalpemilu.org#84856,"GABEK SATU, GABEK, KOTA PANGKALPINANG, KEPULAUAN BANGKA BELITUNG",9,112,137,249
https://kawalpemilu.org#84856,"GABEK SATU, GABEK, KOTA PANGKALPINANG, KEPULAUAN BANGKA BELITUNG",10,118,116,234
https://kawalpemilu.org#84856,"GABEK SATU, GABEK, KOTA PANGKALPINANG, KEPULAUAN BANGKA BELITUNG",11,93,128,221
https://kawalpemilu.org#84856,"GABEK SATU, GABEK, KOTA PANGKALPINANG, KEPULAUAN BANGKA BELITUNG",12,85,136,221
https://kawalpemilu.org#84857,"GABEK DUA, GABEK, KOTA PANGKALPINANG, KEPULAUAN BANGKA BELITUNG",1,88,133,221
https://kawalpemilu.org#84857,"GABEK DUA, GABEK, KOTA PANGKALPINANG, KEPULAUAN BANGKA BELITUNG",2,76,113,189
https://kawalpemilu.org#84857,"GABEK DUA, GABEK, KOTA PANGKALPINANG, KEPULAUAN BANGKA BELITUNG",3,165,62,227
https://kawalpemilu.org#84857,"GABEK DUA, GABEK, KOTA PANGKALPINANG, KEPULAUAN BANGKA BELITUNG",4,77,85,162
https://kawalpemilu.org#84857,"GABEK DUA, GABEK, KOTA PANGKALPINANG, KEPULAUAN BANGKA BELITUNG",5,188,72,260
https://kawalpemilu.org#84857,"GABEK DUA, GABEK, KOTA PANGKALPINANG, KEPULAUAN BANGKA BELITUNG",6,116,123,239
https://kawalpemilu.org#84857,"GABEK DUA, GABEK, KOTA PANGKALPINANG, KEPULAUAN BANGKA BELITUNG",7,110,116,226
https://kawalpemilu.org#84857,"GABEK DUA, GABEK, KOTA PANGKALPINANG, KEPULAUAN BANGKA BELITUNG",8,102,143,245
https://kawalpemilu.org#84857,"GABEK DUA, GABEK, KOTA PANGKALPINANG, KEPULAUAN BANGKA BELITUNG",9,108,117,225
https://kawalpemilu.org#84857,"GABEK DUA, GABEK, KOTA PANGKALPINANG, KEPULAUAN BANGKA BELITUNG",10,124,108,232
https://kawalpemilu.org#84857,"GABEK DUA, GABEK, KOTA PANGKALPINANG, KEPULAUAN BANGKA BELITUNG",11,144,80,224
https://kawalpemilu.org#84857,"GABEK DUA, GABEK, KOTA PANGKALPINANG, KEPULAUAN BANGKA BELITUNG",12,180,15,195
https://kawalpemilu.org#84857,"GABEK DUA, GABEK, KOTA PANGKALPINANG, KEPULAUAN BANGKA BELITUNG",13,120,120,240
https://kawalpemilu.org#84857,"GABEK DUA, GABEK, KOTA PANGKALPINANG, KEPULAUAN BANGKA BELITUNG",14,86,71,157
https://kawalpemilu.org#84857,"GABEK DUA, GABEK, KOTA PANGKALPINANG, KEPULAUAN BANGKA BELITUNG",15,123,105,228
https://kawalpemilu.org#84857,"GABEK DUA, GABEK, KOTA PANGKALPINANG, KEPULAUAN BANGKA BELITUNG",16,67,87,154
https://kawalpemilu.org#84857,"GABEK DUA, GABEK, KOTA PANGKALPINANG, KEPULAUAN BANGKA BELITUNG",17,72,94,166
https://kawalpemilu.org#84858,"JERAMBAH GANTUNG, GABEK, KOTA PANGKALPINANG, KEPULAUAN BANGKA BELITUNG",1,141,88,229
https://kawalpemilu.org#84858,"JERAMBAH GANTUNG, GABEK, KOTA PANGKALPINANG, KEPULAUAN BANGKA BELITUNG",2,232,5,237
https://kawalpemilu.org#84858,"JERAMBAH GANTUNG, GABEK, KOTA PANGKALPINANG, KEPULAUAN BANGKA BELITUNG",3,137,120,257
https://kawalpemilu.org#84858,"JERAMBAH GANTUNG, GABEK, KOTA PANGKALPINANG, KEPULAUAN BANGKA BELITUNG",4,119,109,228
https://kawalpemilu.org#84858,"JERAMBAH GANTUNG, GABEK, KOTA PANGKALPINANG, KEPULAUAN BANGKA BELITUNG",5,61,142,203
https://kawalpemilu.org#84858,"JERAMBAH GANTUNG, GABEK, KOTA PANGKALPINANG, KEPULAUAN BANGKA BELITUNG",6,134,123,257
https://kawalpemilu.org#84858,"JERAMBAH GANTUNG, GABEK, KOTA PANGKALPINANG, KEPULAUAN BANGKA BELITUNG",7,98,127,225
https://kawalpemilu.org#84858,"JERAMBAH GANTUNG, GABEK, KOTA PANGKALPINANG, KEPULAUAN BANGKA BELITUNG",8,65,89,154
https://kawalpemilu.org#84858,"JERAMBAH GANTUNG, GABEK, KOTA PANGKALPINANG, KEPULAUAN BANGKA BELITUNG",9,145,75,220
https://kawalpemilu.org#84858,"JERAMBAH GANTUNG, GABEK, KOTA PANGKALPINANG, KEPULAUAN BANGKA BELITUNG",10,135,74,0
https://kawalpemilu.org#84858,"JERAMBAH GANTUNG, GABEK, KOTA PANGKALPINANG, KEPULAUAN BANGKA BELITUNG",11,74,87,161
https://kawalpemilu.org#25367,"SEMABUNG BARU, GIRIMAYA, KOTA PANGKALPINANG, KEPULAUAN BANGKA BELITUNG",1,174,38,212
https://kawalpemilu.org#25367,"SEMABUNG BARU, GIRIMAYA, KOTA PANGKALPINANG, KEPULAUAN BANGKA BELITUNG",2,124,89,213
https://kawalpemilu.org#25367,"SEMABUNG BARU, GIRIMAYA, KOTA PANGKALPINANG, KEPULAUAN BANGKA BELITUNG",3,112,107,219
https://kawalpemilu.org#25367,"SEMABUNG BARU, GIRIMAYA, KOTA PANGKALPINANG, KEPULAUAN BANGKA BELITUNG",4,119,117,236
https://kawalpemilu.org#25367,"SEMABUNG BARU, GIRIMAYA, KOTA PANGKALPINANG, KEPULAUAN BANGKA BELITUNG",5,121,102,223
https://kawalpemilu.org#25367,"SEMABUNG BARU, GIRIMAYA, KOTA PANGKALPINANG, KEPULAUAN BANGKA BELITUNG",6,165,46,211
https://kawalpemilu.org#25367,"SEMABUNG BARU, GIRIMAYA, KOTA PANGKALPINANG, KEPULAUAN BANGKA BELITUNG",7,119,91,210
https://kawalpemilu.org#25367,"SEMABUNG BARU, GIRIMAYA, KOTA PANGKALPINANG, KEPULAUAN BANGKA BELITUNG",8,84,115,199
https://kawalpemilu.org#25367,"SEMABUNG BARU, GIRIMAYA, KOTA PANGKALPINANG, KEPULAUAN BANGKA BELITUNG",9,121,110,231
https://kawalpemilu.org#25367,"SEMABUNG BARU, GIRIMAYA, KOTA PANGKALPINANG, KEPULAUAN BANGKA BELITUNG",10,176,20,196
https://kawalpemilu.org#25367,"SEMABUNG BARU, GIRIMAYA, KOTA PANGKALPINANG, KEPULAUAN BANGKA BELITUNG",11,150,27,177
https://kawalpemilu.org#25367,"SEMABUNG BARU, GIRIMAYA, KOTA PANGKALPINANG, KEPULAUAN BANGKA BELITUNG",12,151,20,171
https://kawalpemilu.org#25369,"SRIWIJAYA, GIRIMAYA, KOTA PANGKALPINANG, KEPULAUAN BANGKA BELITUNG",1,93,142,235
https://kawalpemilu.org#25369,"SRIWIJAYA, GIRIMAYA, KOTA PANGKALPINANG, KEPULAUAN BANGKA BELITUNG",2,113,80,193
https://kawalpemilu.org#25369,"SRIWIJAYA, GIRIMAYA, KOTA PANGKALPINANG, KEPULAUAN BANGKA BELITUNG",3,93,113,206
https://kawalpemilu.org#25369,"SRIWIJAYA, GIRIMAYA, KOTA PANGKALPINANG, KEPULAUAN BANGKA BELITUNG",4,137,57,194
https://kawalpemilu.org#25369,"SRIWIJAYA, GIRIMAYA, KOTA PANGKALPINANG, KEPULAUAN BANGKA BELITUNG",5,168,87,255
https://kawalpemilu.org#25369,"SRIWIJAYA, GIRIMAYA, KOTA PANGKALPINANG, KEPULAUAN BANGKA BELITUNG",6,94,35,129
https://kawalpemilu.org#25369,"SRIWIJAYA, GIRIMAYA, KOTA PANGKALPINANG, KEPULAUAN BANGKA BELITUNG",7,54,61,115
https://kawalpemilu.org#25369,"SRIWIJAYA, GIRIMAYA, KOTA PANGKALPINANG, KEPULAUAN BANGKA BELITUNG",8,94,86,180
https://kawalpemilu.org#25369,"SRIWIJAYA, GIRIMAYA, KOTA PANGKALPINANG, KEPULAUAN BANGKA BELITUNG",9,96,75,171
https://kawalpemilu.org#25369,"SRIWIJAYA, GIRIMAYA, KOTA PANGKALPINANG, KEPULAUAN BANGKA BELITUNG",10,108,74,182
https://kawalpemilu.org#25369,"SRIWIJAYA, GIRIMAYA, KOTA PANGKALPINANG, KEPULAUAN BANGKA BELITUNG",11,104,121,225
https://kawalpemilu.org#25369,"SRIWIJAYA, GIRIMAYA, KOTA PANGKALPINANG, KEPULAUAN BANGKA BELITUNG",12,74,108,182
https://kawalpemilu.org#25391,"PASAR PADI, GIRIMAYA, KOTA PANGKALPINANG, KEPULAUAN BANGKA BELITUNG",1,158,7,165
https://kawalpemilu.org#25391,"PASAR PADI, GIRIMAYA, KOTA PANGKALPINANG, KEPULAUAN BANGKA BELITUNG",2,180,18,198
https://kawalpemilu.org#25391,"PASAR PADI, GIRIMAYA, KOTA PANGKALPINANG, KEPULAUAN BANGKA BELITUNG",3,222,28,250
https://kawalpemilu.org#25391,"PASAR PADI, GIRIMAYA, KOTA PANGKALPINANG, KEPULAUAN BANGKA BELITUNG",4,185,6,191
https://kawalpemilu.org#25391,"PASAR PADI, GIRIMAYA, KOTA PANGKALPINANG, KEPULAUAN BANGKA BELITUNG",5,182,65,247
https://kawalpemilu.org#84859,"BATU INTAN, GIRIMAYA, KOTA PANGKALPINANG, KEPULAUAN BANGKA BELITUNG",1,177,2,179
https://kawalpemilu.org#84859,"BATU INTAN, GIRIMAYA, KOTA PANGKALPINANG, KEPULAUAN BANGKA BELITUNG",2,195,3,198
https://kawalpemilu.org#84859,"BATU INTAN, GIRIMAYA, KOTA PANGKALPINANG, KEPULAUAN BANGKA BELITUNG",3,169,6,175
https://kawalpemilu.org#84859,"BATU INTAN, GIRIMAYA, KOTA PANGKALPINANG, KEPULAUAN BANGKA BELITUNG",4,203,8,211
https://kawalpemilu.org#84859,"BATU INTAN, GIRIMAYA, KOTA PANGKALPINANG, KEPULAUAN BANGKA BELITUNG",5,186,8,194
https://kawalpemilu.org#84859,"BATU INTAN, GIRIMAYA, KOTA PANGKALPINANG, KEPULAUAN BANGKA BELITUNG",6,176,66,242
https://kawalpemilu.org#84859,"BATU INTAN, GIRIMAYA, KOTA PANGKALPINANG, KEPULAUAN BANGKA BELITUNG",7,236,5,241
https://kawalpemilu.org#84859,"BATU INTAN, GIRIMAYA, KOTA PANGKALPINANG, KEPULAUAN BANGKA BELITUNG",8,136,74,210
https://kawalpemilu.org#84860,"BUKITBESAR, GIRIMAYA, KOTA PANGKALPINANG, KEPULAUAN BANGKA BELITUNG",1,193,38,231
https://kawalpemilu.org#84860,"BUKITBESAR, GIRIMAYA, KOTA PANGKALPINANG, KEPULAUAN BANGKA BELITUNG",2,114,140,254
https://kawalpemilu.org#84860,"BUKITBESAR, GIRIMAYA, KOTA PANGKALPINANG, KEPULAUAN BANGKA BELITUNG",3,95,150,245
https://kawalpemilu.org#84860,"BUKITBESAR, GIRIMAYA, KOTA PANGKALPINANG, KEPULAUAN BANGKA BELITUNG",4,140,127,267
https://kawalpemilu.org#84860,"BUKITBESAR, GIRIMAYA, KOTA PANGKALPINANG, KEPULAUAN BANGKA BELITUNG",5,124,132,256
https://kawalpemilu.org#84860,"BUKITBESAR, GIRIMAYA, KOTA PANGKALPINANG, KEPULAUAN BANGKA BELITUNG",6,151,86,237
https://kawalpemilu.org#84860,"BUKITBESAR, GIRIMAYA, KOTA PANGKALPINANG, KEPULAUAN BANGKA BELITUNG",7,102,148,250
https://kawalpemilu.org#84860,"BUKITBESAR, GIRIMAYA, KOTA PANGKALPINANG, KEPULAUAN BANGKA BELITUNG",8,112,120,232
https://kawalpemilu.org#84860,"BUKITBESAR, GIRIMAYA, KOTA PANGKALPINANG, KEPULAUAN BANGKA BELITUNG",9,221,5,226
https://kawalpemilu.org#84860,"BUKITBESAR, GIRIMAYA, KOTA PANGKALPINANG, KEPULAUAN BANGKA BELITUNG",10,113,131,244
https://kawalpemilu.org#84860,"BUKITBESAR, GIRIMAYA, KOTA PANGKALPINANG, KEPULAUAN BANGKA BELITUNG",11,138,90,228
https://kawalpemilu.org#84860,"BUKITBESAR, GIRIMAYA, KOTA PANGKALPINANG, KEPULAUAN BANGKA BELITUNG",12,171,46,217
https://kawalpemilu.org#84860,"BUKITBESAR, GIRIMAYA, KOTA PANGKALPINANG, KEPULAUAN BANGKA BELITUNG",13,115,126,241
https://kawalpemilu.org#84860,"BUKITBESAR, GIRIMAYA, KOTA PANGKALPINANG, KEPULAUAN BANGKA BELITUNG",14,106,125,3
